PokerStars Game #59937793578:  Hold'em No Limit ($0.25/$0.50) - 2009/07/01 0:00:00 ET
Table 'QOgaEqMcJ73pcUMMxoisUg' 6-max Seat #5 is the button
Seat 1: RFefXIDyFvNtJLq+CloCzA ($42.95 in chips)
Seat 2: qsObMEIlRO22OlS867m/lw ($17.85 in chips)
Seat 3: wUZNozoIDYf+16hp4nn6dw ($22.60 in chips)
Seat 4: gdb5VNZ4Chf1Hioo7N/jsA ($187.45 in chips)
Seat 5: HoaSQCRso+nEyO5DUhGduw ($70.85 in chips)
Seat 6: s83dnhZ6VC53vY0/f6OV/g ($40.90 in chips)
s83dnhZ6VC53vY0/f6OV/g: posts small blind $0.25
RFefXIDyFvNtJLq+CloCzA: posts big blind $0.50
*** HOLE CARDS ***
qsObMEIlRO22OlS867m/lw: folds
wUZNozoIDYf+16hp4nn6dw: folds
gdb5VNZ4Chf1Hioo7N/jsA: folds
HoaSQCRso+nEyO5DUhGduw: raises $1.50 to $2
s83dnhZ6VC53vY0/f6OV/g: folds
RFefXIDyFvNtJLq+CloCzA: folds
gdb5VNZ4Chf1Hioo7N/jsA leaves the table
HoaSQCRso+nEyO5DUhGduw collected $1.25 from pot
*** SUMMARY ***
Total pot $1.25 | Rake $0
Seat 1: RFefXIDyFvNtJLq+CloCzA (big blind) folded before Flop
Seat 2: qsObMEIlRO22OlS867m/lw folded before Flop (didn't bet)
Seat 3: wUZNozoIDYf+16hp4nn6dw folded before Flop (didn't bet)
Seat 4: gdb5VNZ4Chf1Hioo7N/jsA folded before Flop (didn't bet)
Seat 5: HoaSQCRso+nEyO5DUhGduw (button) collected ($1.25)
Seat 6: s83dnhZ6VC53vY0/f6OV/g (small blind) folded before Flop



PokerStars Game #59937795962:  Hold'em No Limit ($0.25/$0.50) - 2009/07/01 0:00:02 ET
Table 'iq+aXfWVQRdV0u8SRTYUEg' 9-max Seat #3 is the button
Seat 1: McPJctgiiz9IXq3OttAeOA ($13.35 in chips)
Seat 3: itOQCm2+5ujaA68I6hPvfg ($123 in chips)
Seat 4: +Z4e6ELfE9slw801LJ3vAw ($16.50 in chips)
Seat 5: MZo49KUcOZcn7g/WRL0Vqw ($43.65 in chips)
Seat 6: 8qvUviDc+VoNV1cmSHjjLw ($30.90 in chips)
Seat 8: s6ecbIEOOhj8S+E0MinQpQ ($31.80 in chips)
Seat 9: bXpVeaSTPBFSPJmeXxO7nw ($9.75 in chips)
+Z4e6ELfE9slw801LJ3vAw: posts small blind $0.25
MZo49KUcOZcn7g/WRL0Vqw: posts big blind $0.50
SKnJuWHScqetA/qG5p+wCg: sits out
*** HOLE CARDS ***
8qvUviDc+VoNV1cmSHjjLw: folds
s6ecbIEOOhj8S+E0MinQpQ: folds
bXpVeaSTPBFSPJmeXxO7nw: folds
McPJctgiiz9IXq3OttAeOA: folds
itOQCm2+5ujaA68I6hPvfg: folds
+Z4e6ELfE9slw801LJ3vAw: raises $1 to $1.50
s6ecbIEOOhj8S+E0MinQpQ said, "did you panic"
MZo49KUcOZcn7g/WRL0Vqw: calls $1
*** FLOP *** [2d 5d 7h]
+Z4e6ELfE9slw801LJ3vAw: bets $1.50
MZo49KUcOZcn7g/WRL0Vqw: raises $4.50 to $6
+Z4e6ELfE9slw801LJ3vAw: folds
MZo49KUcOZcn7g/WRL0Vqw collected $5.75 from pot
MZo49KUcOZcn7g/WRL0Vqw: doesn't show hand
*** SUMMARY ***
Total pot $6 | Rake $0.25
Board [2d 5d 7h]
Seat 1: McPJctgiiz9IXq3OttAeOA folded before Flop (didn't bet)
Seat 3: itOQCm2+5ujaA68I6hPvfg (button) folded before Flop (didn't bet)
Seat 4: +Z4e6ELfE9slw801LJ3vAw (small blind) folded on the Flop
Seat 5: MZo49KUcOZcn7g/WRL0Vqw (big blind) collected ($5.75)
Seat 6: 8qvUviDc+VoNV1cmSHjjLw folded before Flop (didn't bet)
Seat 8: s6ecbIEOOhj8S+E0MinQpQ folded before Flop (didn't bet)
Seat 9: bXpVeaSTPBFSPJmeXxO7nw folded before Flop (didn't bet)



PokerStars Game #59937796506:  Hold'em No Limit ($0.25/$0.50) - 2009/07/01 0:00:03 ET
Table 'E7bWJ45aoFXRpyRv2gw+Ig' 2-max Seat #2 is the button
Seat 1: FRkiRasEGlHUeLrEl+k/nA ($50.20 in chips)
Seat 2: 3Wro85I7472vJ4Wkpneo9A ($75.75 in chips)
3Wro85I7472vJ4Wkpneo9A: posts small blind $0.25
FRkiRasEGlHUeLrEl+k/nA: posts big blind $0.50
*** HOLE CARDS ***
3Wro85I7472vJ4Wkpneo9A: folds
FRkiRasEGlHUeLrEl+k/nA collected $0.50 from pot
FRkiRasEGlHUeLrEl+k/nA: doesn't show hand
*** SUMMARY ***
Total pot $0.50 | Rake $0
Seat 1: FRkiRasEGlHUeLrEl+k/nA (big blind) collected ($0.50)
Seat 2: 3Wro85I7472vJ4Wkpneo9A (button) (small blind) folded before Flop



PokerStars Game #59937797158:  Hold'em No Limit ($0.25/$0.50) - 2009/07/01 0:00:04 ET
Table '+dXkOAQyS8j9PQZusUTMpg' 2-max Seat #1 is the button
Seat 1: XFa6sBGjP2gxoIvxR3fZIg ($79.45 in chips)
Seat 2: 5IBeOgaApY1Bvzv2P8X4EA ($24.50 in chips)
XFa6sBGjP2gxoIvxR3fZIg: posts small blind $0.25
5IBeOgaApY1Bvzv2P8X4EA: posts big blind $0.50
*** HOLE CARDS ***
XFa6sBGjP2gxoIvxR3fZIg: raises $1 to $1.50
5IBeOgaApY1Bvzv2P8X4EA: folds
XFa6sBGjP2gxoIvxR3fZIg collected $1 from pot
*** SUMMARY ***
Total pot $1 | Rake $0
Seat 1: XFa6sBGjP2gxoIvxR3fZIg (button) (small blind) collected ($1)
Seat 2: 5IBeOgaApY1Bvzv2P8X4EA (big blind) folded before Flop



PokerStars Game #59937798704:  Hold'em No Limit ($0.25/$0.50) - 2009/07/01 0:00:06 ET
Table 'kgbJRsxfv64KrErDRBAkcw' 6-max Seat #4 is the button
Seat 1: YmWlPGOKFuJSoJZPW8a8IA ($84.30 in chips)
Seat 2: F1u6k1bk7IyWqKsK5pFybg ($98.70 in chips)
Seat 3: T0Gx/FcQ5VH9u7XaOMX97A ($61.95 in chips)
Seat 4: qanMEqjABjWxC/JgQ/0l7w ($50 in chips)
Seat 5: SlTdlH14u+KVVINgxMwt+Q ($74.80 in chips)
Seat 6: DDfYzIrYT0t5R/hAJngtsg ($19.75 in chips)
SlTdlH14u+KVVINgxMwt+Q: posts small blind $0.25
DDfYzIrYT0t5R/hAJngtsg: posts big blind $0.50
*** HOLE CARDS ***
YmWlPGOKFuJSoJZPW8a8IA: folds
F1u6k1bk7IyWqKsK5pFybg: folds
T0Gx/FcQ5VH9u7XaOMX97A: folds
qanMEqjABjWxC/JgQ/0l7w: raises $1 to $1.50
SlTdlH14u+KVVINgxMwt+Q: folds
DDfYzIrYT0t5R/hAJngtsg: calls $1
*** FLOP *** [Th 5c 3s]
DDfYzIrYT0t5R/hAJngtsg: checks
qanMEqjABjWxC/JgQ/0l7w: bets $2.50
DDfYzIrYT0t5R/hAJngtsg: calls $2.50
*** TURN *** [Th 5c 3s] [4d]
DDfYzIrYT0t5R/hAJngtsg: checks
qanMEqjABjWxC/JgQ/0l7w: checks
*** RIVER *** [Th 5c 3s 4d] [7h]
DDfYzIrYT0t5R/hAJngtsg: checks
qanMEqjABjWxC/JgQ/0l7w: bets $5.50
DDfYzIrYT0t5R/hAJngtsg: calls $5.50
*** SHOW DOWN ***
qanMEqjABjWxC/JgQ/0l7w: shows [Kd 2d] (high card King)
DDfYzIrYT0t5R/hAJngtsg: shows [Qd Qh] (a pair of Queens)
DDfYzIrYT0t5R/hAJngtsg collected $18.35 from pot
*** SUMMARY ***
Total pot $19.25 | Rake $0.90
Board [Th 5c 3s 4d 7h]
Seat 1: YmWlPGOKFuJSoJZPW8a8IA folded before Flop (didn't bet)
Seat 2: F1u6k1bk7IyWqKsK5pFybg folded before Flop (didn't bet)
Seat 3: T0Gx/FcQ5VH9u7XaOMX97A folded before Flop (didn't bet)
Seat 4: qanMEqjABjWxC/JgQ/0l7w (button) showed [Kd 2d] and lost with high card King
Seat 5: SlTdlH14u+KVVINgxMwt+Q (small blind) folded before Flop
Seat 6: DDfYzIrYT0t5R/hAJngtsg (big blind) showed [Qd Qh] and won ($18.35) with a pair of Queens



PokerStars Game #59937799518:  Hold'em No Limit ($0.25/$0.50) - 2009/07/01 0:00:07 ET
Table 'c/CRn+68J3Y8KxD5g1ek2Q' 2-max Seat #2 is the button
Seat 1: 46qCyJ6evTkHo9al5sBMNA ($330.15 in chips)
Seat 2: BypVLsYQt3ePFm2xQL/dOA ($59.20 in chips)
BypVLsYQt3ePFm2xQL/dOA: posts small blind $0.25
46qCyJ6evTkHo9al5sBMNA: posts big blind $0.50
*** HOLE CARDS ***
BypVLsYQt3ePFm2xQL/dOA: raises $0.50 to $1
46qCyJ6evTkHo9al5sBMNA: folds
BypVLsYQt3ePFm2xQL/dOA collected $1 from pot
BypVLsYQt3ePFm2xQL/dOA: doesn't show hand
*** SUMMARY ***
Total pot $1 | Rake $0
Seat 1: 46qCyJ6evTkHo9al5sBMNA (big blind) folded before Flop
Seat 2: BypVLsYQt3ePFm2xQL/dOA (button) (small blind) collected ($1)



PokerStars Game #59937799386:  Hold'em No Limit ($0.25/$0.50) - 2009/07/01 0:00:07 ET
Table 'SsXEKOwKN+jE3etfusqUqA' 2-max Seat #1 is the button
Seat 1: 618rKeLrz/avGNOLULHHVQ ($131.45 in chips)
Seat 2: XfRhywXA6Br+jID1oGeo8A ($66.30 in chips)
618rKeLrz/avGNOLULHHVQ: posts small blind $0.25
XfRhywXA6Br+jID1oGeo8A: posts big blind $0.50
*** HOLE CARDS ***
618rKeLrz/avGNOLULHHVQ: raises $1 to $1.50
XfRhywXA6Br+jID1oGeo8A: folds
618rKeLrz/avGNOLULHHVQ collected $1 from pot
618rKeLrz/avGNOLULHHVQ: doesn't show hand
*** SUMMARY ***
Total pot $1 | Rake $0
Seat 1: 618rKeLrz/avGNOLULHHVQ (button) (small blind) collected ($1)
Seat 2: XfRhywXA6Br+jID1oGeo8A (big blind) folded before Flop



PokerStars Game #59937799284:  Hold'em No Limit ($0.25/$0.50) - 2009/07/01 0:00:07 ET
Table '5EmHi+fnatGQQShcNmzOZQ' 6-max Seat #4 is the button
Seat 1: SwPczQo3cOtwEzhJrfO2cQ ($17.75 in chips)
Seat 3: J8dF2sYMvXUmAGUuSW9kwg ($39.85 in chips)
Seat 4: mFTuMjESuBcXHQ1ePkg/8A ($21.40 in chips)
Seat 5: kxPhs4ePFqMy52CInAJ2aw ($73.30 in chips)
Seat 6: 686aeHikcJlgKkSuIFdcXQ ($113.05 in chips)
kxPhs4ePFqMy52CInAJ2aw: posts small blind $0.25
686aeHikcJlgKkSuIFdcXQ: posts big blind $0.50
*** HOLE CARDS ***
SwPczQo3cOtwEzhJrfO2cQ: folds
J8dF2sYMvXUmAGUuSW9kwg: folds
mFTuMjESuBcXHQ1ePkg/8A: folds
kxPhs4ePFqMy52CInAJ2aw: raises $1.50 to $2
686aeHikcJlgKkSuIFdcXQ: folds
kxPhs4ePFqMy52CInAJ2aw collected $1 from pot
kxPhs4ePFqMy52CInAJ2aw: doesn't show hand
*** SUMMARY ***
Total pot $1 | Rake $0
Seat 1: SwPczQo3cOtwEzhJrfO2cQ folded before Flop (didn't bet)
Seat 3: J8dF2sYMvXUmAGUuSW9kwg folded before Flop (didn't bet)
Seat 4: mFTuMjESuBcXHQ1ePkg/8A (button) folded before Flop (didn't bet)
Seat 5: kxPhs4ePFqMy52CInAJ2aw (small blind) collected ($1)
Seat 6: 686aeHikcJlgKkSuIFdcXQ (big blind) folded before Flop



PokerStars Game #59937800784:  Hold'em No Limit ($0.25/$0.50) - 2009/07/01 0:00:09 ET
Table 'E7bWJ45aoFXRpyRv2gw+Ig' 2-max Seat #1 is the button
Seat 1: FRkiRasEGlHUeLrEl+k/nA ($50.45 in chips)
Seat 2: 3Wro85I7472vJ4Wkpneo9A ($75.50 in chips)
FRkiRasEGlHUeLrEl+k/nA: posts small blind $0.25
3Wro85I7472vJ4Wkpneo9A: posts big blind $0.50
*** HOLE CARDS ***
FRkiRasEGlHUeLrEl+k/nA: folds
3Wro85I7472vJ4Wkpneo9A collected $0.50 from pot
3Wro85I7472vJ4Wkpneo9A: doesn't show hand
*** SUMMARY ***
Total pot $0.50 | Rake $0
Seat 1: FRkiRasEGlHUeLrEl+k/nA (button) (small blind) folded before Flop
Seat 2: 3Wro85I7472vJ4Wkpneo9A (big blind) collected ($0.50)



PokerStars Game #59937801440:  Hold'em No Limit ($0.25/$0.50) - 2009/07/01 0:00:10 ET
Table 'lSisgp6H7Fg1hH5VfjEjYQ' 9-max Seat #4 is the button
Seat 1: pEW8B6uXbdR47kfljMQ3+Q ($38.55 in chips)
Seat 2: UrcnkQOiLVk8BlKDPJSy7Q ($53.10 in chips)
Seat 3: RjBdQ6w31rgcy0o24VLR6w ($10.45 in chips)
Seat 4: nvw9yQKhJT56lA9k+TLdhw ($14.40 in chips)
Seat 5: mSD1pginDsyHG5PDfqzphw ($12.60 in chips)
Seat 6: +k7T5ocke8UwavtgUHm+Cg ($22.60 in chips)
Seat 7: xyQ4CeZa3ug3ompz+5xSTg ($54.05 in chips)
Seat 9: 5JJVDlaiMnB004o/RqbZZQ ($28.75 in chips)
mSD1pginDsyHG5PDfqzphw: posts small blind $0.25
+k7T5ocke8UwavtgUHm+Cg: posts big blind $0.50
*** HOLE CARDS ***
xyQ4CeZa3ug3ompz+5xSTg: folds
5JJVDlaiMnB004o/RqbZZQ: folds
pEW8B6uXbdR47kfljMQ3+Q: folds
UrcnkQOiLVk8BlKDPJSy7Q: folds
RjBdQ6w31rgcy0o24VLR6w: folds
nvw9yQKhJT56lA9k+TLdhw: folds
conman0814 has returned
mSD1pginDsyHG5PDfqzphw: folds
+k7T5ocke8UwavtgUHm+Cg collected $0.50 from pot
+k7T5ocke8UwavtgUHm+Cg: doesn't show hand
*** SUMMARY ***
Total pot $0.50 | Rake $0
Seat 1: pEW8B6uXbdR47kfljMQ3+Q folded before Flop (didn't bet)
Seat 2: UrcnkQOiLVk8BlKDPJSy7Q folded before Flop (didn't bet)
Seat 3: RjBdQ6w31rgcy0o24VLR6w folded before Flop (didn't bet)
Seat 4: nvw9yQKhJT56lA9k+TLdhw (button) folded before Flop (didn't bet)
Seat 5: mSD1pginDsyHG5PDfqzphw (small blind) folded before Flop
Seat 6: +k7T5ocke8UwavtgUHm+Cg (big blind) collected ($0.50)
Seat 7: xyQ4CeZa3ug3ompz+5xSTg folded before Flop (didn't bet)
Seat 9: 5JJVDlaiMnB004o/RqbZZQ folded before Flop (didn't bet)



PokerStars Game #59937802864:  Hold'em No Limit ($0.25/$0.50) - 2009/07/01 0:00:12 ET
Table '+dXkOAQyS8j9PQZusUTMpg' 2-max Seat #2 is the button
Seat 1: XFa6sBGjP2gxoIvxR3fZIg ($79.95 in chips)
Seat 2: 5IBeOgaApY1Bvzv2P8X4EA ($24 in chips)
5IBeOgaApY1Bvzv2P8X4EA: posts small blind $0.25
XFa6sBGjP2gxoIvxR3fZIg: posts big blind $0.50
*** HOLE CARDS ***
5IBeOgaApY1Bvzv2P8X4EA: raises $0.50 to $1
XFa6sBGjP2gxoIvxR3fZIg: calls $0.50
*** FLOP *** [Qs 5h 4s]
XFa6sBGjP2gxoIvxR3fZIg: checks
5IBeOgaApY1Bvzv2P8X4EA: bets $1
XFa6sBGjP2gxoIvxR3fZIg: calls $1
*** TURN *** [Qs 5h 4s] [Th]
XFa6sBGjP2gxoIvxR3fZIg: checks
5IBeOgaApY1Bvzv2P8X4EA: bets $2
XFa6sBGjP2gxoIvxR3fZIg: calls $2
*** RIVER *** [Qs 5h 4s Th] [2h]
XFa6sBGjP2gxoIvxR3fZIg: checks
5IBeOgaApY1Bvzv2P8X4EA: bets $4.25
XFa6sBGjP2gxoIvxR3fZIg: folds
5IBeOgaApY1Bvzv2P8X4EA collected $7.65 from pot
*** SUMMARY ***
Total pot $8 | Rake $0.35
Board [Qs 5h 4s Th 2h]
Seat 1: XFa6sBGjP2gxoIvxR3fZIg (big blind) folded on the River
Seat 2: 5IBeOgaApY1Bvzv2P8X4EA (button) (small blind) collected ($7.65)



PokerStars Game #59937803930:  Hold'em No Limit ($0.25/$0.50) - 2009/07/01 0:00:13 ET
Table 'SsXEKOwKN+jE3etfusqUqA' 2-max Seat #2 is the button
Seat 1: 618rKeLrz/avGNOLULHHVQ ($131.95 in chips)
Seat 2: XfRhywXA6Br+jID1oGeo8A ($65.80 in chips)
XfRhywXA6Br+jID1oGeo8A: posts small blind $0.25
618rKeLrz/avGNOLULHHVQ: posts big blind $0.50
*** HOLE CARDS ***
XfRhywXA6Br+jID1oGeo8A: folds
618rKeLrz/avGNOLULHHVQ collected $0.50 from pot
618rKeLrz/avGNOLULHHVQ: doesn't show hand
*** SUMMARY ***
Total pot $0.50 | Rake $0
Seat 1: 618rKeLrz/avGNOLULHHVQ (big blind) collected ($0.50)
Seat 2: XfRhywXA6Br+jID1oGeo8A (button) (small blind) folded before Flop



PokerStars Game #59937803962:  Hold'em No Limit ($0.25/$0.50) - 2009/07/01 0:00:14 ET
Table 'Vdlc9wqYcHTUhtdyN7CuJw' 2-max Seat #1 is the button
Seat 1: yBO+mXB6m/rCft2ErwGf/Q ($66.70 in chips)
Seat 2: sa0qgETiL3HNbdfGlnKHTA ($48.75 in chips)
yBO+mXB6m/rCft2ErwGf/Q: posts small blind $0.25
sa0qgETiL3HNbdfGlnKHTA: posts big blind $0.50
*** HOLE CARDS ***
yBO+mXB6m/rCft2ErwGf/Q: raises $1 to $1.50
sa0qgETiL3HNbdfGlnKHTA: folds
yBO+mXB6m/rCft2ErwGf/Q collected $1 from pot
*** SUMMARY ***
Total pot $1 | Rake $0
Seat 1: yBO+mXB6m/rCft2ErwGf/Q (button) (small blind) collected ($1)
Seat 2: sa0qgETiL3HNbdfGlnKHTA (big blind) folded before Flop



PokerStars Game #59937804440:  Hold'em No Limit ($0.25/$0.50) - 2009/07/01 0:00:14 ET
Table 'xF8jB4xHn8EO5Ubk5BCoMA' 2-max Seat #1 is the button
Seat 1: P14AOaDo+y7OmxYFDCcbtA ($46.75 in chips)
Seat 2: 4kWQxGbT5FZ1dkPd1bE45Q ($58.90 in chips)
P14AOaDo+y7OmxYFDCcbtA: posts small blind $0.25
4kWQxGbT5FZ1dkPd1bE45Q: posts big blind $0.50
*** HOLE CARDS ***
P14AOaDo+y7OmxYFDCcbtA: folds
4kWQxGbT5FZ1dkPd1bE45Q collected $0.50 from pot
4kWQxGbT5FZ1dkPd1bE45Q: doesn't show hand
*** SUMMARY ***
Total pot $0.50 | Rake $0
Seat 1: P14AOaDo+y7OmxYFDCcbtA (button) (small blind) folded before Flop
Seat 2: 4kWQxGbT5FZ1dkPd1bE45Q (big blind) collected ($0.50)



PokerStars Game #59937804472:  Hold'em No Limit ($0.25/$0.50) - 2009/07/01 0:00:14 ET
Table 'GfL/No5u5PoEnU39lP5pQg' 6-max Seat #6 is the button
Seat 1: T0Gx/FcQ5VH9u7XaOMX97A ($50 in chips)
Seat 2: uVwggSetzp7d+eVgowO3vg ($22.30 in chips)
Seat 3: YmWlPGOKFuJSoJZPW8a8IA ($70 in chips)
Seat 4: yqM0AD7MZQd/cEtKdDQY1A ($39.40 in chips)
Seat 5: fDiswuKb270PAYXkTIYC3g ($22.10 in chips)
Seat 6: 5EiAo0XuFchfJkhvFPvoog ($65.95 in chips)
T0Gx/FcQ5VH9u7XaOMX97A: posts small blind $0.25
uVwggSetzp7d+eVgowO3vg: posts big blind $0.50
*** HOLE CARDS ***
YmWlPGOKFuJSoJZPW8a8IA: folds
yqM0AD7MZQd/cEtKdDQY1A: calls $0.50
fDiswuKb270PAYXkTIYC3g: calls $0.50
5EiAo0XuFchfJkhvFPvoog: folds
T0Gx/FcQ5VH9u7XaOMX97A: calls $0.25
uVwggSetzp7d+eVgowO3vg: checks
*** FLOP *** [4c 7s 6h]
T0Gx/FcQ5VH9u7XaOMX97A: checks
uVwggSetzp7d+eVgowO3vg: checks
yqM0AD7MZQd/cEtKdDQY1A: checks
fDiswuKb270PAYXkTIYC3g: bets $1.50
T0Gx/FcQ5VH9u7XaOMX97A: folds
uVwggSetzp7d+eVgowO3vg: folds
yqM0AD7MZQd/cEtKdDQY1A: folds
fDiswuKb270PAYXkTIYC3g collected $1.90 from pot
*** SUMMARY ***
Total pot $2 | Rake $0.10
Board [4c 7s 6h]
Seat 1: T0Gx/FcQ5VH9u7XaOMX97A (small blind) folded on the Flop
Seat 2: uVwggSetzp7d+eVgowO3vg (big blind) folded on the Flop
Seat 3: YmWlPGOKFuJSoJZPW8a8IA folded before Flop (didn't bet)
Seat 4: yqM0AD7MZQd/cEtKdDQY1A folded on the Flop
Seat 5: fDiswuKb270PAYXkTIYC3g collected ($1.90)
Seat 6: 5EiAo0XuFchfJkhvFPvoog (button) folded before Flop (didn't bet)



PokerStars Game #59937804580:  Hold'em No Limit ($0.25/$0.50) - 2009/07/01 0:00:14 ET
Table 'X6IRCRTh+20gjz8aubWnwA' 9-max Seat #2 is the button
Seat 1: YPo1oggovmqSREegekaQYw ($10.70 in chips)
Seat 2: RjBdQ6w31rgcy0o24VLR6w ($11.45 in chips)
Seat 3: mSD1pginDsyHG5PDfqzphw ($10.25 in chips)
Seat 4: uw9QayAAxLM3Hb+HR7mSkg ($10 in chips)
Seat 5: aT3lRsb9BkkYp2fkD3LEtQ ($81.65 in chips)
Seat 7: VBnpbzn0dIveV55qKvciew ($73.20 in chips)
Seat 8: BPMN9sOItJw6vWq3kypaYg ($23.50 in chips)
Seat 9: M+7+BTmX5vZatHVuoRB1nA ($78.40 in chips)
mSD1pginDsyHG5PDfqzphw: posts small blind $0.25
uw9QayAAxLM3Hb+HR7mSkg: posts big blind $0.50
*** HOLE CARDS ***
aT3lRsb9BkkYp2fkD3LEtQ: folds
VBnpbzn0dIveV55qKvciew: calls $0.50
BPMN9sOItJw6vWq3kypaYg: calls $0.50
M+7+BTmX5vZatHVuoRB1nA: calls $0.50
YPo1oggovmqSREegekaQYw: folds
RjBdQ6w31rgcy0o24VLR6w: folds
mSD1pginDsyHG5PDfqzphw: folds
uw9QayAAxLM3Hb+HR7mSkg: checks
*** FLOP *** [8d 5c 3s]
uw9QayAAxLM3Hb+HR7mSkg: checks
/6In1zC3WtgwxDcueWzZWg joins the table at seat #6
VBnpbzn0dIveV55qKvciew: bets $1.50
BPMN9sOItJw6vWq3kypaYg: folds
M+7+BTmX5vZatHVuoRB1nA: calls $1.50
uw9QayAAxLM3Hb+HR7mSkg: folds
*** TURN *** [8d 5c 3s] [9d]
VBnpbzn0dIveV55qKvciew: bets $3
M+7+BTmX5vZatHVuoRB1nA: calls $3
*** RIVER *** [8d 5c 3s 9d] [Jd]
VBnpbzn0dIveV55qKvciew: checks
M+7+BTmX5vZatHVuoRB1nA: checks
*** SHOW DOWN ***
VBnpbzn0dIveV55qKvciew: shows [6c 6d] (a pair of Sixes)
M+7+BTmX5vZatHVuoRB1nA: shows [Ah 8h] (a pair of Eights)
M+7+BTmX5vZatHVuoRB1nA collected $10.70 from pot
*** SUMMARY ***
Total pot $11.25 | Rake $0.55
Board [8d 5c 3s 9d Jd]
Seat 1: YPo1oggovmqSREegekaQYw folded before Flop (didn't bet)
Seat 2: RjBdQ6w31rgcy0o24VLR6w (button) folded before Flop (didn't bet)
Seat 3: mSD1pginDsyHG5PDfqzphw (small blind) folded before Flop
Seat 4: uw9QayAAxLM3Hb+HR7mSkg (big blind) folded on the Flop
Seat 5: aT3lRsb9BkkYp2fkD3LEtQ folded before Flop (didn't bet)
Seat 7: VBnpbzn0dIveV55qKvciew showed [6c 6d] and lost with a pair of Sixes
Seat 8: BPMN9sOItJw6vWq3kypaYg folded on the Flop
Seat 9: M+7+BTmX5vZatHVuoRB1nA showed [Ah 8h] and won ($10.70) with a pair of Eights



PokerStars Game #59937804652:  Hold'em No Limit ($0.25/$0.50) - 2009/07/01 0:00:15 ET
Table 'BCN5su+SsXiy1zRMJi0SJw' 6-max Seat #3 is the button
Seat 1: 5EiAo0XuFchfJkhvFPvoog ($100.20 in chips)
Seat 2: QfV2JJlmEKgD5jYPV+a33A ($160.90 in chips)
Seat 3: yrJsFKWv+ttHooqghxDx3A ($5.30 in chips)
Seat 4: 6Wb8PlO2kM4fnSim7p4Mrw ($12.10 in chips)
Seat 5: TTx3CHxyi0SObcHyMJRp5w ($34.75 in chips)
Seat 6: zHXshyreKwJVq3N3U+K9uQ ($52.80 in chips)
6Wb8PlO2kM4fnSim7p4Mrw: posts small blind $0.25
TTx3CHxyi0SObcHyMJRp5w: posts big blind $0.50
*** HOLE CARDS ***
zHXshyreKwJVq3N3U+K9uQ: folds
5EiAo0XuFchfJkhvFPvoog: folds
QfV2JJlmEKgD5jYPV+a33A: folds
yrJsFKWv+ttHooqghxDx3A: folds
6Wb8PlO2kM4fnSim7p4Mrw: calls $0.25
TTx3CHxyi0SObcHyMJRp5w: checks
*** FLOP *** [7d 4c 3d]
6Wb8PlO2kM4fnSim7p4Mrw: bets $0.50
TTx3CHxyi0SObcHyMJRp5w: folds
6Wb8PlO2kM4fnSim7p4Mrw collected $0.95 from pot
*** SUMMARY ***
Total pot $1 | Rake $0.05
Board [7d 4c 3d]
Seat 1: 5EiAo0XuFchfJkhvFPvoog folded before Flop (didn't bet)
Seat 2: QfV2JJlmEKgD5jYPV+a33A folded before Flop (didn't bet)
Seat 3: yrJsFKWv+ttHooqghxDx3A (button) folded before Flop (didn't bet)
Seat 4: 6Wb8PlO2kM4fnSim7p4Mrw (small blind) collected ($0.95)
Seat 5: TTx3CHxyi0SObcHyMJRp5w (big blind) folded on the Flop
Seat 6: zHXshyreKwJVq3N3U+K9uQ folded before Flop (didn't bet)



PokerStars Game #59937804922:  Hold'em No Limit ($0.25/$0.50) - 2009/07/01 0:00:15 ET
Table 'lpxYasB1ClBSgTpCCITwhQ' 9-max Seat #8 is the button
Seat 1: ceq82/EkjUd/GFbf0YwGmA ($36.80 in chips)
Seat 2: 5JJVDlaiMnB004o/RqbZZQ ($22.15 in chips)
Seat 3: E2518gp4aFz1+kAgmGqeEg ($9.95 in chips)
Seat 6: YPo1oggovmqSREegekaQYw ($14.25 in chips)
Seat 7: zE9cVigS2nW/Ljy4K4bUQA ($30 in chips)
Seat 8: o6JyUkbzCDw8tUabqtmnlg ($27.45 in chips)
Seat 9: mSD1pginDsyHG5PDfqzphw ($10 in chips)
mSD1pginDsyHG5PDfqzphw: posts small blind $0.25
ceq82/EkjUd/GFbf0YwGmA: posts big blind $0.50
k1f0lS7tlMHCLGs0JT34Tg: sits out
bXpVeaSTPBFSPJmeXxO7nw: sits out
*** HOLE CARDS ***
5JJVDlaiMnB004o/RqbZZQ: calls $0.50
E2518gp4aFz1+kAgmGqeEg: folds
YPo1oggovmqSREegekaQYw: folds
zE9cVigS2nW/Ljy4K4bUQA: folds
o6JyUkbzCDw8tUabqtmnlg: folds
mSD1pginDsyHG5PDfqzphw: calls $0.25
ceq82/EkjUd/GFbf0YwGmA: checks
*** FLOP *** [Qc 3s 6c]
mSD1pginDsyHG5PDfqzphw: checks
ceq82/EkjUd/GFbf0YwGmA: checks
5JJVDlaiMnB004o/RqbZZQ: checks
*** TURN *** [Qc 3s 6c] [4c]
mSD1pginDsyHG5PDfqzphw: checks
ceq82/EkjUd/GFbf0YwGmA: checks
5JJVDlaiMnB004o/RqbZZQ: checks
*** RIVER *** [Qc 3s 6c 4c] [9s]
mSD1pginDsyHG5PDfqzphw: checks
ceq82/EkjUd/GFbf0YwGmA: checks
5JJVDlaiMnB004o/RqbZZQ: checks
*** SHOW DOWN ***
mSD1pginDsyHG5PDfqzphw: shows [8h 7h] (high card Queen)
ceq82/EkjUd/GFbf0YwGmA: shows [3h Tc] (a pair of Threes)
5JJVDlaiMnB004o/RqbZZQ: mucks hand
ceq82/EkjUd/GFbf0YwGmA collected $1.45 from pot
*** SUMMARY ***
Total pot $1.50 | Rake $0.05
Board [Qc 3s 6c 4c 9s]
Seat 1: ceq82/EkjUd/GFbf0YwGmA (big blind) showed [3h Tc] and won ($1.45) with a pair of Threes
Seat 2: 5JJVDlaiMnB004o/RqbZZQ mucked
Seat 3: E2518gp4aFz1+kAgmGqeEg folded before Flop (didn't bet)
Seat 6: YPo1oggovmqSREegekaQYw folded before Flop (didn't bet)
Seat 7: zE9cVigS2nW/Ljy4K4bUQA folded before Flop (didn't bet)
Seat 8: o6JyUkbzCDw8tUabqtmnlg (button) folded before Flop (didn't bet)
Seat 9: mSD1pginDsyHG5PDfqzphw (small blind) showed [8h 7h] and lost with high card Queen



PokerStars Game #59937805188:  Hold'em No Limit ($0.25/$0.50) - 2009/07/01 0:00:15 ET
Table 'E7bWJ45aoFXRpyRv2gw+Ig' 2-max Seat #2 is the button
Seat 1: FRkiRasEGlHUeLrEl+k/nA ($50.20 in chips)
Seat 2: 3Wro85I7472vJ4Wkpneo9A ($75.75 in chips)
3Wro85I7472vJ4Wkpneo9A: posts small blind $0.25
FRkiRasEGlHUeLrEl+k/nA: posts big blind $0.50
*** HOLE CARDS ***
3Wro85I7472vJ4Wkpneo9A: folds
FRkiRasEGlHUeLrEl+k/nA collected $0.50 from pot
*** SUMMARY ***
Total pot $0.50 | Rake $0
Seat 1: FRkiRasEGlHUeLrEl+k/nA (big blind) collected ($0.50)
Seat 2: 3Wro85I7472vJ4Wkpneo9A (button) (small blind) folded before Flop



PokerStars Game #59937806078:  Hold'em No Limit ($0.25/$0.50) - 2009/07/01 0:00:16 ET
Table 'c/CRn+68J3Y8KxD5g1ek2Q' 2-max Seat #1 is the button
Seat 1: 46qCyJ6evTkHo9al5sBMNA ($329.65 in chips)
Seat 2: BypVLsYQt3ePFm2xQL/dOA ($59.70 in chips)
46qCyJ6evTkHo9al5sBMNA: posts small blind $0.25
BypVLsYQt3ePFm2xQL/dOA: posts big blind $0.50
*** HOLE CARDS ***
46qCyJ6evTkHo9al5sBMNA: folds
BypVLsYQt3ePFm2xQL/dOA collected $0.50 from pot
BypVLsYQt3ePFm2xQL/dOA: doesn't show hand
*** SUMMARY ***
Total pot $0.50 | Rake $0
Seat 1: 46qCyJ6evTkHo9al5sBMNA (button) (small blind) folded before Flop
Seat 2: BypVLsYQt3ePFm2xQL/dOA (big blind) collected ($0.50)



PokerStars Game #59937806534:  Hold'em No Limit ($0.25/$0.50) - 2009/07/01 0:00:17 ET
Table 'MJxeZCzYELxiIsyUZyT0jw' 6-max Seat #1 is the button
Seat 1: iKPos8JI094Tomq4tDSgnQ ($19.70 in chips)
Seat 2: r6H1GiZ6QIpMTDhyodKuRQ ($64.05 in chips)
Seat 3: JQZew0FjzS19kTjeNtrE+A ($57.65 in chips)
Seat 4: lP7Q6pewz4C2RsAfKsjdWw ($28.40 in chips)
Seat 5: VO2eih4OVj7FCQGPfUoW8A ($61.85 in chips)
Seat 6: TTx3CHxyi0SObcHyMJRp5w ($42.45 in chips)
r6H1GiZ6QIpMTDhyodKuRQ: posts small blind $0.25
JQZew0FjzS19kTjeNtrE+A: posts big blind $0.50
*** HOLE CARDS ***
lP7Q6pewz4C2RsAfKsjdWw: calls $0.50
VO2eih4OVj7FCQGPfUoW8A: folds
TTx3CHxyi0SObcHyMJRp5w: folds
iKPos8JI094Tomq4tDSgnQ: calls $0.50
r6H1GiZ6QIpMTDhyodKuRQ: calls $0.25
JQZew0FjzS19kTjeNtrE+A: checks
*** FLOP *** [8c Qc Ah]
r6H1GiZ6QIpMTDhyodKuRQ: checks
JQZew0FjzS19kTjeNtrE+A: checks
lP7Q6pewz4C2RsAfKsjdWw: checks
iKPos8JI094Tomq4tDSgnQ: checks
*** TURN *** [8c Qc Ah] [2c]
r6H1GiZ6QIpMTDhyodKuRQ: bets $1
JQZew0FjzS19kTjeNtrE+A: folds
lP7Q6pewz4C2RsAfKsjdWw: calls $1
iKPos8JI094Tomq4tDSgnQ: folds
*** RIVER *** [8c Qc Ah 2c] [7c]
r6H1GiZ6QIpMTDhyodKuRQ: checks
lP7Q6pewz4C2RsAfKsjdWw: checks
*** SHOW DOWN ***
r6H1GiZ6QIpMTDhyodKuRQ: shows [Ad Kd] (a pair of Aces)
lP7Q6pewz4C2RsAfKsjdWw: mucks hand
r6H1GiZ6QIpMTDhyodKuRQ collected $3.85 from pot
*** SUMMARY ***
Total pot $4 | Rake $0.15
Board [8c Qc Ah 2c 7c]
Seat 1: iKPos8JI094Tomq4tDSgnQ (button) folded on the Turn
Seat 2: r6H1GiZ6QIpMTDhyodKuRQ (small blind) showed [Ad Kd] and won ($3.85) with a pair of Aces
Seat 3: JQZew0FjzS19kTjeNtrE+A (big blind) folded on the Turn
Seat 4: lP7Q6pewz4C2RsAfKsjdWw mucked
Seat 5: VO2eih4OVj7FCQGPfUoW8A folded before Flop (didn't bet)
Seat 6: TTx3CHxyi0SObcHyMJRp5w folded before Flop (didn't bet)



PokerStars Game #59937806996:  Hold'em No Limit ($0.25/$0.50) - 2009/07/01 0:00:18 ET
Table 'hSTs/dUsYLgJQuF2Onp0MQ' 6-max Seat #3 is the button
Seat 1: lWwl5C/UZOsWNubdUqghZw ($71.95 in chips)
Seat 2: gdb5VNZ4Chf1Hioo7N/jsA ($50 in chips)
Seat 3: vQOrJuXbLC3UZDVklY9bOA ($13.50 in chips)
Seat 4: L0aIPg7qefDQjdJo3HCVEA ($12.45 in chips)
Seat 5: 686aeHikcJlgKkSuIFdcXQ ($62.15 in chips)
Seat 6: +laPa9P7BjZKKnR0n+OmvA ($11.60 in chips)
L0aIPg7qefDQjdJo3HCVEA: posts small blind $0.25
686aeHikcJlgKkSuIFdcXQ: posts big blind $0.50
*** HOLE CARDS ***
+laPa9P7BjZKKnR0n+OmvA: folds
lWwl5C/UZOsWNubdUqghZw: folds
gdb5VNZ4Chf1Hioo7N/jsA: folds
gdb5VNZ4Chf1Hioo7N/jsA leaves the table
vQOrJuXbLC3UZDVklY9bOA: folds
L0aIPg7qefDQjdJo3HCVEA: raises $0.50 to $1
686aeHikcJlgKkSuIFdcXQ: folds
L0aIPg7qefDQjdJo3HCVEA collected $1 from pot
*** SUMMARY ***
Total pot $1 | Rake $0
Seat 1: lWwl5C/UZOsWNubdUqghZw folded before Flop (didn't bet)
Seat 2: gdb5VNZ4Chf1Hioo7N/jsA folded before Flop (didn't bet)
Seat 3: vQOrJuXbLC3UZDVklY9bOA (button) folded before Flop (didn't bet)
Seat 4: L0aIPg7qefDQjdJo3HCVEA (small blind) collected ($1)
Seat 5: 686aeHikcJlgKkSuIFdcXQ (big blind) folded before Flop
Seat 6: +laPa9P7BjZKKnR0n+OmvA folded before Flop (didn't bet)



PokerStars Game #59937807822:  Hold'em No Limit ($0.25/$0.50) - 2009/07/01 0:00:19 ET
Table 'EiNh8p/wGJ1FP575iMFnqg' 9-max Seat #7 is the button
Seat 1: r3ZqM1Mi0W3y4hOdssE+Sg ($42.85 in chips)
Seat 2: avsQkZXsRKnWa7gkjVNvog ($27.70 in chips)
Seat 3: GszS/McxOSUnOET7MBoHqA ($57.50 in chips)
Seat 4: pk8aA8qMBEL6zXqSyfVXMA ($80.80 in chips)
Seat 5: M+7+BTmX5vZatHVuoRB1nA ($93.50 in chips)
Seat 6: YPo1oggovmqSREegekaQYw ($14.75 in chips)
Seat 7: Wj7mKnRFR90j40wWUu2+Og ($24.75 in chips)
Seat 8: C7LqTSTGrMSBCecHvwQAOQ ($55.55 in chips)
Seat 9: OMwFJ4pF0xk2Ru/AJiFeFw ($74.15 in chips)
C7LqTSTGrMSBCecHvwQAOQ: posts small blind $0.25
OMwFJ4pF0xk2Ru/AJiFeFw: posts big blind $0.50
*** HOLE CARDS ***
r3ZqM1Mi0W3y4hOdssE+Sg: calls $0.50
avsQkZXsRKnWa7gkjVNvog: folds
GszS/McxOSUnOET7MBoHqA: folds
pk8aA8qMBEL6zXqSyfVXMA: folds
M+7+BTmX5vZatHVuoRB1nA: folds
YPo1oggovmqSREegekaQYw: folds
Wj7mKnRFR90j40wWUu2+Og: calls $0.50
C7LqTSTGrMSBCecHvwQAOQ: folds
OMwFJ4pF0xk2Ru/AJiFeFw: checks
*** FLOP *** [Ah 5s Ac]
OMwFJ4pF0xk2Ru/AJiFeFw: checks
r3ZqM1Mi0W3y4hOdssE+Sg: checks
Wj7mKnRFR90j40wWUu2+Og: checks
*** TURN *** [Ah 5s Ac] [7h]
OMwFJ4pF0xk2Ru/AJiFeFw: checks
r3ZqM1Mi0W3y4hOdssE+Sg: checks
Wj7mKnRFR90j40wWUu2+Og: bets $1.50
OMwFJ4pF0xk2Ru/AJiFeFw: folds
r3ZqM1Mi0W3y4hOdssE+Sg: folds
Wj7mKnRFR90j40wWUu2+Og collected $1.70 from pot
*** SUMMARY ***
Total pot $1.75 | Rake $0.05
Board [Ah 5s Ac 7h]
Seat 1: r3ZqM1Mi0W3y4hOdssE+Sg folded on the Turn
Seat 2: avsQkZXsRKnWa7gkjVNvog folded before Flop (didn't bet)
Seat 3: GszS/McxOSUnOET7MBoHqA folded before Flop (didn't bet)
Seat 4: pk8aA8qMBEL6zXqSyfVXMA folded before Flop (didn't bet)
Seat 5: M+7+BTmX5vZatHVuoRB1nA folded before Flop (didn't bet)
Seat 6: YPo1oggovmqSREegekaQYw folded before Flop (didn't bet)
Seat 7: Wj7mKnRFR90j40wWUu2+Og (button) collected ($1.70)
Seat 8: C7LqTSTGrMSBCecHvwQAOQ (small blind) folded before Flop
Seat 9: OMwFJ4pF0xk2Ru/AJiFeFw (big blind) folded on the Turn



PokerStars Game #59937808130:  Hold'em No Limit ($0.25/$0.50) - 2009/07/01 0:00:20 ET
Table 'SsXEKOwKN+jE3etfusqUqA' 2-max Seat #1 is the button
Seat 1: 618rKeLrz/avGNOLULHHVQ ($132.20 in chips)
Seat 2: XfRhywXA6Br+jID1oGeo8A ($65.55 in chips)
618rKeLrz/avGNOLULHHVQ: posts small blind $0.25
XfRhywXA6Br+jID1oGeo8A: posts big blind $0.50
*** HOLE CARDS ***
618rKeLrz/avGNOLULHHVQ: folds
XfRhywXA6Br+jID1oGeo8A collected $0.50 from pot
*** SUMMARY ***
Total pot $0.50 | Rake $0
Seat 1: 618rKeLrz/avGNOLULHHVQ (button) (small blind) folded before Flop
Seat 2: XfRhywXA6Br+jID1oGeo8A (big blind) collected ($0.50)



PokerStars Game #59937809392:  Hold'em No Limit ($0.25/$0.50) - 2009/07/01 0:00:21 ET
Table 'E7bWJ45aoFXRpyRv2gw+Ig' 2-max Seat #1 is the button
Seat 1: FRkiRasEGlHUeLrEl+k/nA ($50.45 in chips)
Seat 2: 3Wro85I7472vJ4Wkpneo9A ($75.50 in chips)
FRkiRasEGlHUeLrEl+k/nA: posts small blind $0.25
3Wro85I7472vJ4Wkpneo9A: posts big blind $0.50
*** HOLE CARDS ***
FRkiRasEGlHUeLrEl+k/nA: raises $1 to $1.50
3Wro85I7472vJ4Wkpneo9A: folds
FRkiRasEGlHUeLrEl+k/nA collected $1 from pot
FRkiRasEGlHUeLrEl+k/nA: doesn't show hand
*** SUMMARY ***
Total pot $1 | Rake $0
Seat 1: FRkiRasEGlHUeLrEl+k/nA (button) (small blind) collected ($1)
Seat 2: 3Wro85I7472vJ4Wkpneo9A (big blind) folded before Flop



PokerStars Game #59937809762:  Hold'em No Limit ($0.25/$0.50) - 2009/07/01 0:00:22 ET
Table 'Vdlc9wqYcHTUhtdyN7CuJw' 2-max Seat #2 is the button
Seat 1: yBO+mXB6m/rCft2ErwGf/Q ($67.20 in chips)
Seat 2: sa0qgETiL3HNbdfGlnKHTA ($48.25 in chips)
sa0qgETiL3HNbdfGlnKHTA: posts small blind $0.25
yBO+mXB6m/rCft2ErwGf/Q: posts big blind $0.50
*** HOLE CARDS ***
sa0qgETiL3HNbdfGlnKHTA: raises $0.50 to $1
yBO+mXB6m/rCft2ErwGf/Q: calls $0.50
*** FLOP *** [5d Jh 4c]
yBO+mXB6m/rCft2ErwGf/Q: checks
sa0qgETiL3HNbdfGlnKHTA: checks
*** TURN *** [5d Jh 4c] [9d]
yBO+mXB6m/rCft2ErwGf/Q: checks
sa0qgETiL3HNbdfGlnKHTA: checks
*** RIVER *** [5d Jh 4c 9d] [2s]
yBO+mXB6m/rCft2ErwGf/Q: bets $0.50
sa0qgETiL3HNbdfGlnKHTA: raises $0.50 to $1
yBO+mXB6m/rCft2ErwGf/Q: calls $0.50
*** SHOW DOWN ***
sa0qgETiL3HNbdfGlnKHTA: shows [9h 8d] (a pair of Nines)
yBO+mXB6m/rCft2ErwGf/Q: mucks hand
sa0qgETiL3HNbdfGlnKHTA collected $3.85 from pot
*** SUMMARY ***
Total pot $4 | Rake $0.15
Board [5d Jh 4c 9d 2s]
Seat 1: yBO+mXB6m/rCft2ErwGf/Q (big blind) mucked
Seat 2: sa0qgETiL3HNbdfGlnKHTA (button) (small blind) showed [9h 8d] and won ($3.85) with a pair of Nines



PokerStars Game #59937811610:  Hold'em No Limit ($0.25/$0.50) - 2009/07/01 0:00:24 ET
Table 'c/CRn+68J3Y8KxD5g1ek2Q' 2-max Seat #2 is the button
Seat 1: 46qCyJ6evTkHo9al5sBMNA ($329.40 in chips)
Seat 2: BypVLsYQt3ePFm2xQL/dOA ($59.95 in chips)
BypVLsYQt3ePFm2xQL/dOA: posts small blind $0.25
46qCyJ6evTkHo9al5sBMNA: posts big blind $0.50
*** HOLE CARDS ***
BypVLsYQt3ePFm2xQL/dOA: raises $0.50 to $1
46qCyJ6evTkHo9al5sBMNA: folds
BypVLsYQt3ePFm2xQL/dOA collected $1 from pot
BypVLsYQt3ePFm2xQL/dOA: doesn't show hand
*** SUMMARY ***
Total pot $1 | Rake $0
Seat 1: 46qCyJ6evTkHo9al5sBMNA (big blind) folded before Flop
Seat 2: BypVLsYQt3ePFm2xQL/dOA (button) (small blind) collected ($1)



PokerStars Game #59937811042:  Hold'em No Limit ($0.25/$0.50) - 2009/07/01 0:00:24 ET
Table 'xF8jB4xHn8EO5Ubk5BCoMA' 2-max Seat #2 is the button
Seat 1: P14AOaDo+y7OmxYFDCcbtA ($46.50 in chips)
Seat 2: 4kWQxGbT5FZ1dkPd1bE45Q ($59.15 in chips)
4kWQxGbT5FZ1dkPd1bE45Q: posts small blind $0.25
P14AOaDo+y7OmxYFDCcbtA: posts big blind $0.50
*** HOLE CARDS ***
4kWQxGbT5FZ1dkPd1bE45Q: raises $1 to $1.50
P14AOaDo+y7OmxYFDCcbtA: raises $2.50 to $4
4kWQxGbT5FZ1dkPd1bE45Q: calls $2.50
*** FLOP *** [9s Th 4c]
P14AOaDo+y7OmxYFDCcbtA: bets $3.50
4kWQxGbT5FZ1dkPd1bE45Q: calls $3.50
*** TURN *** [9s Th 4c] [Ts]
P14AOaDo+y7OmxYFDCcbtA: checks
4kWQxGbT5FZ1dkPd1bE45Q: checks
*** RIVER *** [9s Th 4c Ts] [2h]
P14AOaDo+y7OmxYFDCcbtA: bets $10
4kWQxGbT5FZ1dkPd1bE45Q: calls $10
*** SHOW DOWN ***
P14AOaDo+y7OmxYFDCcbtA: shows [Kh Kd] (two pair, Kings and Tens)
4kWQxGbT5FZ1dkPd1bE45Q: mucks hand
P14AOaDo+y7OmxYFDCcbtA collected $34.50 from pot
*** SUMMARY ***
Total pot $35 | Rake $0.50
Board [9s Th 4c Ts 2h]
Seat 1: P14AOaDo+y7OmxYFDCcbtA (big blind) showed [Kh Kd] and won ($34.50) with two pair, Kings and Tens
Seat 2: 4kWQxGbT5FZ1dkPd1bE45Q (button) (small blind) mucked



PokerStars Game #59937812350:  Hold'em No Limit ($0.25/$0.50) - 2009/07/01 0:00:25 ET
Table 'SsXEKOwKN+jE3etfusqUqA' 2-max Seat #2 is the button
Seat 1: 618rKeLrz/avGNOLULHHVQ ($131.95 in chips)
Seat 2: XfRhywXA6Br+jID1oGeo8A ($65.80 in chips)
XfRhywXA6Br+jID1oGeo8A: posts small blind $0.25
618rKeLrz/avGNOLULHHVQ: posts big blind $0.50
*** HOLE CARDS ***
XfRhywXA6Br+jID1oGeo8A: raises $1 to $1.50
618rKeLrz/avGNOLULHHVQ: folds
XfRhywXA6Br+jID1oGeo8A collected $1 from pot
XfRhywXA6Br+jID1oGeo8A: doesn't show hand
*** SUMMARY ***
Total pot $1 | Rake $0
Seat 1: 618rKeLrz/avGNOLULHHVQ (big blind) folded before Flop
Seat 2: XfRhywXA6Br+jID1oGeo8A (button) (small blind) collected ($1)



PokerStars Game #59937812206:  Hold'em No Limit ($0.25/$0.50) - 2009/07/01 0:00:25 ET
Table 'QOgaEqMcJ73pcUMMxoisUg' 6-max Seat #6 is the button
Seat 1: RFefXIDyFvNtJLq+CloCzA ($42.45 in chips)
Seat 2: qsObMEIlRO22OlS867m/lw ($17.85 in chips)
Seat 3: wUZNozoIDYf+16hp4nn6dw ($22.60 in chips)
Seat 5: HoaSQCRso+nEyO5DUhGduw ($71.60 in chips)
Seat 6: s83dnhZ6VC53vY0/f6OV/g ($40.65 in chips)
RFefXIDyFvNtJLq+CloCzA: posts small blind $0.25
qsObMEIlRO22OlS867m/lw: posts big blind $0.50
*** HOLE CARDS ***
wUZNozoIDYf+16hp4nn6dw: raises $0.50 to $1
HoaSQCRso+nEyO5DUhGduw: folds
s83dnhZ6VC53vY0/f6OV/g: folds
RFefXIDyFvNtJLq+CloCzA: folds
qsObMEIlRO22OlS867m/lw: calls $0.50
*** FLOP *** [Td Js 5s]
qsObMEIlRO22OlS867m/lw: bets $1
wUZNozoIDYf+16hp4nn6dw: raises $3.50 to $4.50
L5e2lrPLQm1Pqx30IIZ/Fw joins the table at seat #4
qsObMEIlRO22OlS867m/lw: folds
wUZNozoIDYf+16hp4nn6dw collected $4.05 from pot
*** SUMMARY ***
Total pot $4.25 | Rake $0.20
Board [Td Js 5s]
Seat 1: RFefXIDyFvNtJLq+CloCzA (small blind) folded before Flop
Seat 2: qsObMEIlRO22OlS867m/lw (big blind) folded on the Flop
Seat 3: wUZNozoIDYf+16hp4nn6dw collected ($4.05)
Seat 5: HoaSQCRso+nEyO5DUhGduw folded before Flop (didn't bet)
Seat 6: s83dnhZ6VC53vY0/f6OV/g (button) folded before Flop (didn't bet)



PokerStars Game #59937812714:  Hold'em No Limit ($0.25/$0.50) - 2009/07/01 0:00:26 ET
Table 'E7bWJ45aoFXRpyRv2gw+Ig99gCy/CZQwPIjZWH+BguQg' Seat #4 is the button
Seat 2: kRW/BJrCe7hgq0UAAxWNHw ($18.55 in chips)
Seat 4: 9/8QXm7VUNlfTP1JPRq+pw ($43.35 in chips)
Seat 5: pk8aA8qMBEL6zXqSyfVXMA ($73.50 in chips)
Seat 6: OcnLOMVFdy23jXnoTyaO5Q ($231.95 in chips)
Seat 7: E2518gp4aFz1+kAgmGqeEg ($14.80 in chips)
Seat 8: ystKwkVOKtKLw0I3tZowOA ($11 in chips)
Seat 9: ZP+WvqeXyNFZItMmcD3rlQ ($66.15 in chips)
pk8aA8qMBEL6zXqSyfVXMA: posts small blind $0.25
OcnLOMVFdy23jXnoTyaO5Q: posts big blind $0.50
*** HOLE CARDS ***
OcnLOMVFdy23jXnoTyaO5Q said, "n1"
E2518gp4aFz1+kAgmGqeEg: folds
ystKwkVOKtKLw0I3tZowOA: folds
ZP+WvqeXyNFZItMmcD3rlQ: folds
nclined leaves the table
ZP+WvqeXyNFZItMmcD3rlQ leaves the table
kRW/BJrCe7hgq0UAAxWNHw: folds
9/8QXm7VUNlfTP1JPRq+pw: folds
pk8aA8qMBEL6zXqSyfVXMA said, "if i try to raise that my hand is face up don't you thihnk?"
pk8aA8qMBEL6zXqSyfVXMA: folds
OcnLOMVFdy23jXnoTyaO5Q collected $0.50 from pot
OcnLOMVFdy23jXnoTyaO5Q: doesn't show hand
*** SUMMARY ***
Total pot $0.50 | Rake $0
Seat 2: kRW/BJrCe7hgq0UAAxWNHw folded before Flop (didn't bet)
Seat 4: 9/8QXm7VUNlfTP1JPRq+pw (button) folded before Flop (didn't bet)
Seat 5: pk8aA8qMBEL6zXqSyfVXMA (small blind) folded before Flop
Seat 6: OcnLOMVFdy23jXnoTyaO5Q (big blind) collected ($0.50)
Seat 7: E2518gp4aFz1+kAgmGqeEg folded before Flop (didn't bet)
Seat 8: ystKwkVOKtKLw0I3tZowOA folded before Flop (didn't bet)
Seat 9: ZP+WvqeXyNFZItMmcD3rlQ folded before Flop (didn't bet)



PokerStars Game #59937813118:  Hold'em No Limit ($0.25/$0.50) - 2009/07/01 0:00:26 ET
Table 'tpZbcIvqh/6WmfR/i5IE3A' 9-max Seat #7 is the button
Seat 1: nV/P1jFY/CFMXOLWu7pYmA ($15.45 in chips)
Seat 2: M+7+BTmX5vZatHVuoRB1nA ($51.20 in chips)
Seat 3: 3w0FbBQAKwQODwenKwZxXw ($68.20 in chips)
Seat 4: zE9cVigS2nW/Ljy4K4bUQA ($30 in chips)
Seat 5: 9r7ZoBbAJj5IeyZ0q9BdzA ($13.70 in chips)
Seat 6: E2518gp4aFz1+kAgmGqeEg ($11.45 in chips)
Seat 7: wIZ377kjl2fHFGnS93o6bw ($15.95 in chips)
Seat 8: bXpVeaSTPBFSPJmeXxO7nw ($10.10 in chips)
bXpVeaSTPBFSPJmeXxO7nw: posts small blind $0.25
nV/P1jFY/CFMXOLWu7pYmA: posts big blind $0.50
*** HOLE CARDS ***
M+7+BTmX5vZatHVuoRB1nA: folds
3w0FbBQAKwQODwenKwZxXw: folds
zE9cVigS2nW/Ljy4K4bUQA: folds
9r7ZoBbAJj5IeyZ0q9BdzA: folds
E2518gp4aFz1+kAgmGqeEg: raises $1.50 to $2
wIZ377kjl2fHFGnS93o6bw: folds
bXpVeaSTPBFSPJmeXxO7nw: folds
nV/P1jFY/CFMXOLWu7pYmA: folds
E2518gp4aFz1+kAgmGqeEg collected $1.25 from pot
E2518gp4aFz1+kAgmGqeEg: doesn't show hand
*** SUMMARY ***
Total pot $1.25 | Rake $0
Seat 1: nV/P1jFY/CFMXOLWu7pYmA (big blind) folded before Flop
Seat 2: M+7+BTmX5vZatHVuoRB1nA folded before Flop (didn't bet)
Seat 3: 3w0FbBQAKwQODwenKwZxXw folded before Flop (didn't bet)
Seat 4: zE9cVigS2nW/Ljy4K4bUQA folded before Flop (didn't bet)
Seat 5: 9r7ZoBbAJj5IeyZ0q9BdzA folded before Flop (didn't bet)
Seat 6: E2518gp4aFz1+kAgmGqeEg collected ($1.25)
Seat 7: wIZ377kjl2fHFGnS93o6bw (button) folded before Flop (didn't bet)
Seat 8: bXpVeaSTPBFSPJmeXxO7nw (small blind) folded before Flop



PokerStars Game #59937814962:  Hold'em No Limit ($0.25/$0.50) - 2009/07/01 0:00:29 ET
Table '+z1aekfHkpp09pc8F9aViw' 6-max Seat #4 is the button
Seat 1: lWwl5C/UZOsWNubdUqghZw ($50 in chips)
Seat 2: VuB2GN0h94yY+QbuI2Mybg ($28.95 in chips)
Seat 3: uUznlIMFnRUvwrBhYF73KA ($52.40 in chips)
Seat 4: OCrv7ObFH4/s2lv7rYOnsQ ($21.70 in chips)
Seat 5: crjGpJEzSZgD38FoE3VMGg ($63.15 in chips)
Seat 6: 686aeHikcJlgKkSuIFdcXQ ($68.65 in chips)
crjGpJEzSZgD38FoE3VMGg: posts small blind $0.25
686aeHikcJlgKkSuIFdcXQ: posts big blind $0.50
*** HOLE CARDS ***
lWwl5C/UZOsWNubdUqghZw: folds
VuB2GN0h94yY+QbuI2Mybg: calls $0.50
uUznlIMFnRUvwrBhYF73KA: raises $0.50 to $1
OCrv7ObFH4/s2lv7rYOnsQ: folds
crjGpJEzSZgD38FoE3VMGg: folds
686aeHikcJlgKkSuIFdcXQ: folds
VuB2GN0h94yY+QbuI2Mybg: calls $0.50
*** FLOP *** [Th As Ts]
VuB2GN0h94yY+QbuI2Mybg: checks
uUznlIMFnRUvwrBhYF73KA: checks
*** TURN *** [Th As Ts] [2h]
VuB2GN0h94yY+QbuI2Mybg: checks
uUznlIMFnRUvwrBhYF73KA: checks
*** RIVER *** [Th As Ts 2h] [7d]
VuB2GN0h94yY+QbuI2Mybg: bets $2
uUznlIMFnRUvwrBhYF73KA: raises $4 to $6
VuB2GN0h94yY+QbuI2Mybg: folds
uUznlIMFnRUvwrBhYF73KA collected $6.45 from pot
*** SUMMARY ***
Total pot $6.75 | Rake $0.30
Board [Th As Ts 2h 7d]
Seat 1: lWwl5C/UZOsWNubdUqghZw folded before Flop (didn't bet)
Seat 2: VuB2GN0h94yY+QbuI2Mybg folded on the River
Seat 3: uUznlIMFnRUvwrBhYF73KA collected ($6.45)
Seat 4: OCrv7ObFH4/s2lv7rYOnsQ (button) folded before Flop (didn't bet)
Seat 5: crjGpJEzSZgD38FoE3VMGg (small blind) folded before Flop
Seat 6: 686aeHikcJlgKkSuIFdcXQ (big blind) folded before Flop



PokerStars Game #59937814702:  Hold'em No Limit ($0.25/$0.50) - 2009/07/01 0:00:29 ET
Table 'E7bWJ45aoFXRpyRv2gw+Ig' 2-max Seat #2 is the button
Seat 1: FRkiRasEGlHUeLrEl+k/nA ($50.95 in chips)
Seat 2: 3Wro85I7472vJ4Wkpneo9A ($75 in chips)
3Wro85I7472vJ4Wkpneo9A: posts small blind $0.25
FRkiRasEGlHUeLrEl+k/nA: posts big blind $0.50
*** HOLE CARDS ***
3Wro85I7472vJ4Wkpneo9A: raises $1 to $1.50
FRkiRasEGlHUeLrEl+k/nA: calls $1
*** FLOP *** [9h Qh 9c]
FRkiRasEGlHUeLrEl+k/nA: checks
3Wro85I7472vJ4Wkpneo9A: bets $2
FRkiRasEGlHUeLrEl+k/nA: folds
3Wro85I7472vJ4Wkpneo9A collected $2.85 from pot
3Wro85I7472vJ4Wkpneo9A: doesn't show hand
*** SUMMARY ***
Total pot $3 | Rake $0.15
Board [9h Qh 9c]
Seat 1: FRkiRasEGlHUeLrEl+k/nA (big blind) folded on the Flop
Seat 2: 3Wro85I7472vJ4Wkpneo9A (button) (small blind) collected ($2.85)



PokerStars Game #59937815156:  Hold'em No Limit ($0.25/$0.50) - 2009/07/01 0:00:29 ET
Table '37qXEp3oe+er5q4CZip9eQ' 6-max Seat #2 is the button
Seat 2: g12O9qXTybyo2C0B2bXgjg ($17.45 in chips)
Seat 3: Rt6KgtZ8YaJoTc3FPim00w ($111.35 in chips)
Seat 4: L0aIPg7qefDQjdJo3HCVEA ($11.05 in chips)
Seat 5: VOmI0x4dDPnTESZd5B4d1Q ($33 in chips)
Seat 6: f7zPpUQp9hHZgqhEvrUWQw ($56.65 in chips)
Rt6KgtZ8YaJoTc3FPim00w: posts small blind $0.25
L0aIPg7qefDQjdJo3HCVEA: posts big blind $0.50
*** HOLE CARDS ***
VOmI0x4dDPnTESZd5B4d1Q: folds
f7zPpUQp9hHZgqhEvrUWQw: folds
g12O9qXTybyo2C0B2bXgjg: calls $0.50
Rt6KgtZ8YaJoTc3FPim00w: folds
L0aIPg7qefDQjdJo3HCVEA: checks
*** FLOP *** [8s Td 4h]
L0aIPg7qefDQjdJo3HCVEA: checks
g12O9qXTybyo2C0B2bXgjg: bets $1.50
L0aIPg7qefDQjdJo3HCVEA: folds
g12O9qXTybyo2C0B2bXgjg collected $1.20 from pot
*** SUMMARY ***
Total pot $1.25 | Rake $0.05
Board [8s Td 4h]
Seat 2: g12O9qXTybyo2C0B2bXgjg (button) collected ($1.20)
Seat 3: Rt6KgtZ8YaJoTc3FPim00w (small blind) folded before Flop
Seat 4: L0aIPg7qefDQjdJo3HCVEA (big blind) folded on the Flop
Seat 5: VOmI0x4dDPnTESZd5B4d1Q folded before Flop (didn't bet)
Seat 6: f7zPpUQp9hHZgqhEvrUWQw folded before Flop (didn't bet)



PokerStars Game #59937815440:  Hold'em No Limit ($0.25/$0.50) - 2009/07/01 0:00:30 ET
Table '5EmHi+fnatGQQShcNmzOZQ' 6-max Seat #5 is the button
Seat 1: SwPczQo3cOtwEzhJrfO2cQ ($17.75 in chips)
Seat 3: J8dF2sYMvXUmAGUuSW9kwg ($39.85 in chips)
Seat 4: mFTuMjESuBcXHQ1ePkg/8A ($21.40 in chips)
Seat 5: kxPhs4ePFqMy52CInAJ2aw ($73.80 in chips)
Seat 6: 686aeHikcJlgKkSuIFdcXQ ($112.55 in chips)
686aeHikcJlgKkSuIFdcXQ: posts small blind $0.25
SwPczQo3cOtwEzhJrfO2cQ: posts big blind $0.50
*** HOLE CARDS ***
J8dF2sYMvXUmAGUuSW9kwg: folds
mFTuMjESuBcXHQ1ePkg/8A: calls $0.50
kxPhs4ePFqMy52CInAJ2aw: folds
686aeHikcJlgKkSuIFdcXQ: folds
SwPczQo3cOtwEzhJrfO2cQ: checks
*** FLOP *** [Ts Qh 7h]
SwPczQo3cOtwEzhJrfO2cQ: checks
mFTuMjESuBcXHQ1ePkg/8A: checks
*** TURN *** [Ts Qh 7h] [3d]
SwPczQo3cOtwEzhJrfO2cQ: checks
mFTuMjESuBcXHQ1ePkg/8A: bets $0.50
SwPczQo3cOtwEzhJrfO2cQ: folds
mFTuMjESuBcXHQ1ePkg/8A collected $1.20 from pot
mFTuMjESuBcXHQ1ePkg/8A: doesn't show hand
*** SUMMARY ***
Total pot $1.25 | Rake $0.05
Board [Ts Qh 7h 3d]
Seat 1: SwPczQo3cOtwEzhJrfO2cQ (big blind) folded on the Turn
Seat 3: J8dF2sYMvXUmAGUuSW9kwg folded before Flop (didn't bet)
Seat 4: mFTuMjESuBcXHQ1ePkg/8A collected ($1.20)
Seat 5: kxPhs4ePFqMy52CInAJ2aw (button) folded before Flop (didn't bet)
Seat 6: 686aeHikcJlgKkSuIFdcXQ (small blind) folded before Flop



PokerStars Game #59937816232:  Hold'em No Limit ($0.25/$0.50) - 2009/07/01 0:00:31 ET
Table 'raOT4/ipuZgzjfKHC+jD9g' 2-max Seat #1 is the button
Seat 1: IuwLemwLhc9fvrwBGs0AMA ($4 in chips)
Seat 2: Udr5juWSWUgTu1NlRhjMdA ($10.95 in chips)
IuwLemwLhc9fvrwBGs0AMA: posts small blind $0.25
Udr5juWSWUgTu1NlRhjMdA: posts big blind $0.50
*** HOLE CARDS ***
IuwLemwLhc9fvrwBGs0AMA: folds
Udr5juWSWUgTu1NlRhjMdA collected $0.50 from pot
Udr5juWSWUgTu1NlRhjMdA: doesn't show hand
*** SUMMARY ***
Total pot $0.50 | Rake $0
Seat 1: IuwLemwLhc9fvrwBGs0AMA (button) (small blind) folded before Flop
Seat 2: Udr5juWSWUgTu1NlRhjMdA (big blind) collected ($0.50)



PokerStars Game #59937817314:  Hold'em No Limit ($0.25/$0.50) - 2009/07/01 0:00:32 ET
Table 'lSisgp6H7Fg1hH5VfjEjYQ' 9-max Seat #5 is the button
Seat 1: pEW8B6uXbdR47kfljMQ3+Q ($38.55 in chips)
Seat 2: UrcnkQOiLVk8BlKDPJSy7Q ($53.10 in chips)
Seat 3: RjBdQ6w31rgcy0o24VLR6w ($10.45 in chips)
Seat 4: nvw9yQKhJT56lA9k+TLdhw ($14.40 in chips)
Seat 5: mSD1pginDsyHG5PDfqzphw ($12.35 in chips)
Seat 6: +k7T5ocke8UwavtgUHm+Cg ($22.85 in chips)
Seat 7: xyQ4CeZa3ug3ompz+5xSTg ($54.05 in chips)
Seat 9: 5JJVDlaiMnB004o/RqbZZQ ($28.75 in chips)
+k7T5ocke8UwavtgUHm+Cg: posts small blind $0.25
xyQ4CeZa3ug3ompz+5xSTg: posts big blind $0.50
conman0814: sits out
*** HOLE CARDS ***
5JJVDlaiMnB004o/RqbZZQ: folds
pEW8B6uXbdR47kfljMQ3+Q: folds
UrcnkQOiLVk8BlKDPJSy7Q: folds
RjBdQ6w31rgcy0o24VLR6w: folds
nvw9yQKhJT56lA9k+TLdhw: folds
mSD1pginDsyHG5PDfqzphw: folds
+k7T5ocke8UwavtgUHm+Cg: calls $0.25
xyQ4CeZa3ug3ompz+5xSTg: checks
*** FLOP *** [Ks 8d 9s]
+k7T5ocke8UwavtgUHm+Cg: bets $1
xyQ4CeZa3ug3ompz+5xSTg: calls $1
*** TURN *** [Ks 8d 9s] [7d]
+k7T5ocke8UwavtgUHm+Cg: bets $3
xyQ4CeZa3ug3ompz+5xSTg: raises $9.50 to $12.50
+k7T5ocke8UwavtgUHm+Cg: calls $9.50
*** RIVER *** [Ks 8d 9s 7d] [4h]
+k7T5ocke8UwavtgUHm+Cg: checks
xyQ4CeZa3ug3ompz+5xSTg: bets $13
+k7T5ocke8UwavtgUHm+Cg: calls $8.85 and is all-in
*** SHOW DOWN ***
xyQ4CeZa3ug3ompz+5xSTg: shows [Jd Tc] (a straight, Seven to Jack)
+k7T5ocke8UwavtgUHm+Cg: mucks hand
xyQ4CeZa3ug3ompz+5xSTg collected $43.50 from pot
*** SUMMARY ***
Total pot $45.70 | Rake $2.20
Board [Ks 8d 9s 7d 4h]
Seat 1: pEW8B6uXbdR47kfljMQ3+Q folded before Flop (didn't bet)
Seat 2: UrcnkQOiLVk8BlKDPJSy7Q folded before Flop (didn't bet)
Seat 3: RjBdQ6w31rgcy0o24VLR6w folded before Flop (didn't bet)
Seat 4: nvw9yQKhJT56lA9k+TLdhw folded before Flop (didn't bet)
Seat 5: mSD1pginDsyHG5PDfqzphw (button) folded before Flop (didn't bet)
Seat 6: +k7T5ocke8UwavtgUHm+Cg (small blind) mucked
Seat 7: xyQ4CeZa3ug3ompz+5xSTg (big blind) showed [Jd Tc] and won ($43.50) with a straight, Seven to Jack
Seat 9: 5JJVDlaiMnB004o/RqbZZQ folded before Flop (didn't bet)



PokerStars Game #59937818196:  Hold'em No Limit ($0.25/$0.50) - 2009/07/01 0:00:33 ET
Table 'SsXEKOwKN+jE3etfusqUqA' 2-max Seat #1 is the button
Seat 1: 618rKeLrz/avGNOLULHHVQ ($131.45 in chips)
Seat 2: XfRhywXA6Br+jID1oGeo8A ($66.30 in chips)
618rKeLrz/avGNOLULHHVQ: posts small blind $0.25
XfRhywXA6Br+jID1oGeo8A: posts big blind $0.50
*** HOLE CARDS ***
618rKeLrz/avGNOLULHHVQ: raises $1 to $1.50
XfRhywXA6Br+jID1oGeo8A: folds
618rKeLrz/avGNOLULHHVQ collected $1 from pot
618rKeLrz/avGNOLULHHVQ: doesn't show hand
*** SUMMARY ***
Total pot $1 | Rake $0
Seat 1: 618rKeLrz/avGNOLULHHVQ (button) (small blind) collected ($1)
Seat 2: XfRhywXA6Br+jID1oGeo8A (big blind) folded before Flop



PokerStars Game #59937818264:  Hold'em No Limit ($0.25/$0.50) - 2009/07/01 0:00:34 ET
Table 'BCN5su+SsXiy1zRMJi0SJw' 6-max Seat #4 is the button
Seat 1: 5EiAo0XuFchfJkhvFPvoog ($100.20 in chips)
Seat 2: QfV2JJlmEKgD5jYPV+a33A ($160.90 in chips)
Seat 3: yrJsFKWv+ttHooqghxDx3A ($5.30 in chips)
Seat 4: 6Wb8PlO2kM4fnSim7p4Mrw ($12.55 in chips)
Seat 5: TTx3CHxyi0SObcHyMJRp5w ($34.25 in chips)
Seat 6: zHXshyreKwJVq3N3U+K9uQ ($52.80 in chips)
TTx3CHxyi0SObcHyMJRp5w: posts small blind $0.25
zHXshyreKwJVq3N3U+K9uQ: posts big blind $0.50
*** HOLE CARDS ***
5EiAo0XuFchfJkhvFPvoog: folds
QfV2JJlmEKgD5jYPV+a33A: raises $1.50 to $2
yrJsFKWv+ttHooqghxDx3A: folds
6Wb8PlO2kM4fnSim7p4Mrw: folds
TTx3CHxyi0SObcHyMJRp5w: folds
zHXshyreKwJVq3N3U+K9uQ: folds
QfV2JJlmEKgD5jYPV+a33A collected $1.25 from pot
*** SUMMARY ***
Total pot $1.25 | Rake $0
Seat 1: 5EiAo0XuFchfJkhvFPvoog folded before Flop (didn't bet)
Seat 2: QfV2JJlmEKgD5jYPV+a33A collected ($1.25)
Seat 3: yrJsFKWv+ttHooqghxDx3A folded before Flop (didn't bet)
Seat 4: 6Wb8PlO2kM4fnSim7p4Mrw (button) folded before Flop (didn't bet)
Seat 5: TTx3CHxyi0SObcHyMJRp5w (small blind) folded before Flop
Seat 6: zHXshyreKwJVq3N3U+K9uQ (big blind) folded before Flop



PokerStars Game #59937819534:  Hold'em No Limit ($0.25/$0.50) - 2009/07/01 0:00:35 ET
Table 'c/CRn+68J3Y8KxD5g1ek2Q' 2-max Seat #1 is the button
Seat 1: 46qCyJ6evTkHo9al5sBMNA ($328.90 in chips)
Seat 2: BypVLsYQt3ePFm2xQL/dOA ($60.45 in chips)
46qCyJ6evTkHo9al5sBMNA: posts small blind $0.25
BypVLsYQt3ePFm2xQL/dOA: posts big blind $0.50
*** HOLE CARDS ***
46qCyJ6evTkHo9al5sBMNA: folds
BypVLsYQt3ePFm2xQL/dOA collected $0.50 from pot
BypVLsYQt3ePFm2xQL/dOA: doesn't show hand
*** SUMMARY ***
Total pot $0.50 | Rake $0
Seat 1: 46qCyJ6evTkHo9al5sBMNA (button) (small blind) folded before Flop
Seat 2: BypVLsYQt3ePFm2xQL/dOA (big blind) collected ($0.50)



PokerStars Game #59937820868:  Hold'em No Limit ($0.25/$0.50) - 2009/07/01 0:00:37 ET
Table 'raOT4/ipuZgzjfKHC+jD9g' 2-max Seat #2 is the button
Seat 1: IuwLemwLhc9fvrwBGs0AMA ($3.75 in chips)
Seat 2: Udr5juWSWUgTu1NlRhjMdA ($11.20 in chips)
Udr5juWSWUgTu1NlRhjMdA: posts small blind $0.25
IuwLemwLhc9fvrwBGs0AMA: posts big blind $0.50
*** HOLE CARDS ***
Udr5juWSWUgTu1NlRhjMdA: raises $0.50 to $1
IuwLemwLhc9fvrwBGs0AMA: raises $2.75 to $3.75 and is all-in
Udr5juWSWUgTu1NlRhjMdA: calls $2.75
*** FLOP *** [7s 4s 3d]
*** TURN *** [7s 4s 3d] [Qs]
*** RIVER *** [7s 4s 3d Qs] [3c]
*** SHOW DOWN ***
IuwLemwLhc9fvrwBGs0AMA: shows [Ts Ah] (a pair of Threes)
Udr5juWSWUgTu1NlRhjMdA: shows [3s Ks] (a flush, King high)
Udr5juWSWUgTu1NlRhjMdA collected $7.15 from pot
*** SUMMARY ***
Total pot $7.50 | Rake $0.35
Board [7s 4s 3d Qs 3c]
Seat 1: IuwLemwLhc9fvrwBGs0AMA (big blind) showed [Ts Ah] and lost with a pair of Threes
Seat 2: Udr5juWSWUgTu1NlRhjMdA (button) (small blind) showed [3s Ks] and won ($7.15) with a flush, King high



PokerStars Game #59937823208:  Hold'em No Limit ($0.25/$0.50) - 2009/07/01 0:00:40 ET
Table 'mTxf8gPLgffN3Iwfm7Icfg' 2-max Seat #2 is the button
Seat 1: Do9Rlu1R5u/AcRtMTl8SYg ($68.70 in chips)
Seat 2: EMc5LPgVaded4Qc77vm0fw ($47.90 in chips)
EMc5LPgVaded4Qc77vm0fw: posts small blind $0.25
Do9Rlu1R5u/AcRtMTl8SYg: posts big blind $0.50
*** HOLE CARDS ***
EMc5LPgVaded4Qc77vm0fw: raises $1.50 to $2
Do9Rlu1R5u/AcRtMTl8SYg: folds
EMc5LPgVaded4Qc77vm0fw collected $1 from pot
EMc5LPgVaded4Qc77vm0fw: doesn't show hand
*** SUMMARY ***
Total pot $1 | Rake $0
Seat 1: Do9Rlu1R5u/AcRtMTl8SYg (big blind) folded before Flop
Seat 2: EMc5LPgVaded4Qc77vm0fw (button) (small blind) collected ($1)



PokerStars Game #59937823492:  Hold'em No Limit ($0.25/$0.50) - 2009/07/01 0:00:41 ET
Table 'SsXEKOwKN+jE3etfusqUqA' 2-max Seat #2 is the button
Seat 1: 618rKeLrz/avGNOLULHHVQ ($131.95 in chips)
Seat 2: XfRhywXA6Br+jID1oGeo8A ($65.80 in chips)
XfRhywXA6Br+jID1oGeo8A: posts small blind $0.25
618rKeLrz/avGNOLULHHVQ: posts big blind $0.50
*** HOLE CARDS ***
XfRhywXA6Br+jID1oGeo8A: folds
618rKeLrz/avGNOLULHHVQ collected $0.50 from pot
618rKeLrz/avGNOLULHHVQ: doesn't show hand
*** SUMMARY ***
Total pot $0.50 | Rake $0
Seat 1: 618rKeLrz/avGNOLULHHVQ (big blind) collected ($0.50)
Seat 2: XfRhywXA6Br+jID1oGeo8A (button) (small blind) folded before Flop



PokerStars Game #59937824110:  Hold'em No Limit ($0.25/$0.50) - 2009/07/01 0:00:42 ET
Table 'c/CRn+68J3Y8KxD5g1ek2Q' 2-max Seat #2 is the button
Seat 1: 46qCyJ6evTkHo9al5sBMNA ($328.65 in chips)
Seat 2: BypVLsYQt3ePFm2xQL/dOA ($60.70 in chips)
BypVLsYQt3ePFm2xQL/dOA: posts small blind $0.25
46qCyJ6evTkHo9al5sBMNA: posts big blind $0.50
*** HOLE CARDS ***
BypVLsYQt3ePFm2xQL/dOA: raises $0.50 to $1
46qCyJ6evTkHo9al5sBMNA: calls $0.50
*** FLOP *** [6c 4h 6s]
46qCyJ6evTkHo9al5sBMNA: checks
BypVLsYQt3ePFm2xQL/dOA: bets $3
46qCyJ6evTkHo9al5sBMNA: folds
BypVLsYQt3ePFm2xQL/dOA collected $1.90 from pot
BypVLsYQt3ePFm2xQL/dOA: doesn't show hand
*** SUMMARY ***
Total pot $2 | Rake $0.10
Board [6c 4h 6s]
Seat 1: 46qCyJ6evTkHo9al5sBMNA (big blind) folded on the Flop
Seat 2: BypVLsYQt3ePFm2xQL/dOA (button) (small blind) collected ($1.90)



PokerStars Game #59937824854:  Hold'em No Limit ($0.25/$0.50) - 2009/07/01 0:00:43 ET
Table 'E7bWJ45aoFXRpyRv2gw+Ig' 2-max Seat #1 is the button
Seat 1: FRkiRasEGlHUeLrEl+k/nA ($50 in chips)
Seat 2: 3Wro85I7472vJ4Wkpneo9A ($76.35 in chips)
FRkiRasEGlHUeLrEl+k/nA: posts small blind $0.25
3Wro85I7472vJ4Wkpneo9A: posts big blind $0.50
*** HOLE CARDS ***
FRkiRasEGlHUeLrEl+k/nA: raises $1 to $1.50
3Wro85I7472vJ4Wkpneo9A: folds
FRkiRasEGlHUeLrEl+k/nA collected $1 from pot
*** SUMMARY ***
Total pot $1 | Rake $0
Seat 1: FRkiRasEGlHUeLrEl+k/nA (button) (small blind) collected ($1)
Seat 2: 3Wro85I7472vJ4Wkpneo9A (big blind) folded before Flop



PokerStars Game #59937825014:  Hold'em No Limit ($0.25/$0.50) - 2009/07/01 0:00:43 ET
Table 'YsnnHkamRzYqMOr2FlLY4w' 6-max Seat #3 is the button
Seat 1: crjGpJEzSZgD38FoE3VMGg ($55.30 in chips)
Seat 2: 2dIa62hMcn6g73rbkt9NwA ($63.60 in chips)
Seat 3: I+pG2m/dD5iYdbg9qx572g ($21.80 in chips)
Seat 4: 7Fue572p4ZIC85AJMQvaQw ($45 in chips)
Seat 5: lcQ7uuLf+WLGGy4Ve6VKKA ($46.25 in chips)
Seat 6: YmWlPGOKFuJSoJZPW8a8IA ($50 in chips)
7Fue572p4ZIC85AJMQvaQw: posts small blind $0.25
lcQ7uuLf+WLGGy4Ve6VKKA: posts big blind $0.50
*** HOLE CARDS ***
YmWlPGOKFuJSoJZPW8a8IA: raises $1 to $1.50
crjGpJEzSZgD38FoE3VMGg: folds
2dIa62hMcn6g73rbkt9NwA: folds
I+pG2m/dD5iYdbg9qx572g: folds
7Fue572p4ZIC85AJMQvaQw: calls $1.25
lcQ7uuLf+WLGGy4Ve6VKKA: calls $1
*** FLOP *** [Qs 9d 9c]
7Fue572p4ZIC85AJMQvaQw: checks
lcQ7uuLf+WLGGy4Ve6VKKA: checks
YmWlPGOKFuJSoJZPW8a8IA: checks
*** TURN *** [Qs 9d 9c] [Kh]
7Fue572p4ZIC85AJMQvaQw: bets $0.50
lcQ7uuLf+WLGGy4Ve6VKKA: folds
YmWlPGOKFuJSoJZPW8a8IA: folds
7Fue572p4ZIC85AJMQvaQw collected $4.30 from pot
*** SUMMARY ***
Total pot $4.50 | Rake $0.20
Board [Qs 9d 9c Kh]
Seat 1: crjGpJEzSZgD38FoE3VMGg folded before Flop (didn't bet)
Seat 2: 2dIa62hMcn6g73rbkt9NwA folded before Flop (didn't bet)
Seat 3: I+pG2m/dD5iYdbg9qx572g (button) folded before Flop (didn't bet)
Seat 4: 7Fue572p4ZIC85AJMQvaQw (small blind) collected ($4.30)
Seat 5: lcQ7uuLf+WLGGy4Ve6VKKA (big blind) folded on the Turn
Seat 6: YmWlPGOKFuJSoJZPW8a8IA folded on the Turn



PokerStars Game #59937825240:  Hold'em No Limit ($0.25/$0.50) - 2009/07/01 0:00:43 ET
Table 'QOgaEqMcJ73pcUMMxoisUgErOuyGLI5PT3G5MnpHgC/g' Seat #3 is the button
Seat 1: k6GJzKs7T7qvQggW9g8Pdw ($50.05 in chips)
Seat 2: RjBdQ6w31rgcy0o24VLR6w ($8.75 in chips)
Seat 3: xZCXQSXlrZkp3pZizzVXCw ($49 in chips)
Seat 5: JwvquocWfhTVApN5t47LgA ($51.30 in chips)
Seat 6: zE9cVigS2nW/Ljy4K4bUQA ($32.10 in chips)
Seat 8: ajP1NjIMdqQfpMbzHzvejw ($52.80 in chips)
Seat 9: J0W5D97jl5VLky+IoPvDeA ($68.55 in chips)
U7aZzIYWjv3SL30KtikLbw will be allowed to play after the button
JwvquocWfhTVApN5t47LgA: posts small blind $0.25
zE9cVigS2nW/Ljy4K4bUQA: posts big blind $0.50
90Wb75h3W1BRpbqVnuk8gw: sits out
*** HOLE CARDS ***
ajP1NjIMdqQfpMbzHzvejw: folds
J0W5D97jl5VLky+IoPvDeA: folds
k6GJzKs7T7qvQggW9g8Pdw: calls $0.50
RjBdQ6w31rgcy0o24VLR6w: folds
xZCXQSXlrZkp3pZizzVXCw: folds
JwvquocWfhTVApN5t47LgA: folds
zE9cVigS2nW/Ljy4K4bUQA: checks
*** FLOP *** [3c Kd Tc]
zE9cVigS2nW/Ljy4K4bUQA: checks
k6GJzKs7T7qvQggW9g8Pdw: checks
*** TURN *** [3c Kd Tc] [Qs]
zE9cVigS2nW/Ljy4K4bUQA: checks
k6GJzKs7T7qvQggW9g8Pdw: checks
*** RIVER *** [3c Kd Tc Qs] [3h]
zE9cVigS2nW/Ljy4K4bUQA: checks
k6GJzKs7T7qvQggW9g8Pdw: checks
*** SHOW DOWN ***
zE9cVigS2nW/Ljy4K4bUQA: shows [7h Jd] (a pair of Threes)
k6GJzKs7T7qvQggW9g8Pdw: shows [4c Ac] (a pair of Threes - Ace kicker)
k6GJzKs7T7qvQggW9g8Pdw collected $1.20 from pot
*** SUMMARY ***
Total pot $1.25 | Rake $0.05
Board [3c Kd Tc Qs 3h]
Seat 1: k6GJzKs7T7qvQggW9g8Pdw showed [4c Ac] and won ($1.20) with a pair of Threes
Seat 2: RjBdQ6w31rgcy0o24VLR6w folded before Flop (didn't bet)
Seat 3: xZCXQSXlrZkp3pZizzVXCw (button) folded before Flop (didn't bet)
Seat 5: JwvquocWfhTVApN5t47LgA (small blind) folded before Flop
Seat 6: zE9cVigS2nW/Ljy4K4bUQA (big blind) showed [7h Jd] and lost with a pair of Threes
Seat 8: ajP1NjIMdqQfpMbzHzvejw folded before Flop (didn't bet)
Seat 9: J0W5D97jl5VLky+IoPvDeA folded before Flop (didn't bet)



PokerStars Game #59937827698:  Hold'em No Limit ($0.25/$0.50) - 2009/07/01 0:00:47 ET
Table 'SsXEKOwKN+jE3etfusqUqA' 2-max Seat #1 is the button
Seat 1: 618rKeLrz/avGNOLULHHVQ ($132.20 in chips)
Seat 2: XfRhywXA6Br+jID1oGeo8A ($65.55 in chips)
618rKeLrz/avGNOLULHHVQ: posts small blind $0.25
XfRhywXA6Br+jID1oGeo8A: posts big blind $0.50
*** HOLE CARDS ***
618rKeLrz/avGNOLULHHVQ: raises $1 to $1.50
XfRhywXA6Br+jID1oGeo8A: calls $1
*** FLOP *** [5s Kh 4h]
XfRhywXA6Br+jID1oGeo8A: checks
618rKeLrz/avGNOLULHHVQ: checks
*** TURN *** [5s Kh 4h] [Jh]
XfRhywXA6Br+jID1oGeo8A: checks
618rKeLrz/avGNOLULHHVQ: bets $1.50
XfRhywXA6Br+jID1oGeo8A: folds
618rKeLrz/avGNOLULHHVQ collected $2.85 from pot
618rKeLrz/avGNOLULHHVQ: doesn't show hand
*** SUMMARY ***
Total pot $3 | Rake $0.15
Board [5s Kh 4h Jh]
Seat 1: 618rKeLrz/avGNOLULHHVQ (button) (small blind) collected ($2.85)
Seat 2: XfRhywXA6Br+jID1oGeo8A (big blind) folded on the Turn



PokerStars Game #59937828326:  Hold'em No Limit ($0.25/$0.50) - 2009/07/01 0:00:47 ET
Table 'ibNfFy0bCzuBaUORla0aGw' 9-max Seat #2 is the button
Seat 1: xZCXQSXlrZkp3pZizzVXCw ($61.70 in chips)
Seat 2: 90Wb75h3W1BRpbqVnuk8gw ($50 in chips)
Seat 3: dDaHs3X8+fe3bIkRU0cbrw ($23.95 in chips)
Seat 4: YBN054X4blmis+B2bBlC0g ($22.95 in chips)
Seat 5: FRv75HO8CUsRZ1byEz06mQ ($12.50 in chips)
Seat 6: BmYrv3ec2k5d6pQq6iNaZw ($67 in chips)
Seat 7: mSD1pginDsyHG5PDfqzphw ($10 in chips)
Seat 8: xUrN9TWLq4m5V+OXY7KUUA ($50.50 in chips)
Seat 9: WpvT3OUSiZlpvs+mPXFqtQ ($8 in chips)
dDaHs3X8+fe3bIkRU0cbrw: posts small blind $0.25
YBN054X4blmis+B2bBlC0g: posts big blind $0.50
xZCXQSXlrZkp3pZizzVXCw: posts small & big blinds $0.75
*** HOLE CARDS ***
FRv75HO8CUsRZ1byEz06mQ: raises $1 to $1.50
BmYrv3ec2k5d6pQq6iNaZw: folds
mSD1pginDsyHG5PDfqzphw: folds
xUrN9TWLq4m5V+OXY7KUUA: folds
WpvT3OUSiZlpvs+mPXFqtQ: folds
xZCXQSXlrZkp3pZizzVXCw: folds
90Wb75h3W1BRpbqVnuk8gw: folds
dDaHs3X8+fe3bIkRU0cbrw: folds
YBN054X4blmis+B2bBlC0g: folds
FRv75HO8CUsRZ1byEz06mQ collected $2 from pot
*** SUMMARY ***
Total pot $2 | Rake $0
Seat 1: xZCXQSXlrZkp3pZizzVXCw folded before Flop
Seat 2: 90Wb75h3W1BRpbqVnuk8gw (button) folded before Flop (didn't bet)
Seat 3: dDaHs3X8+fe3bIkRU0cbrw (small blind) folded before Flop
Seat 4: YBN054X4blmis+B2bBlC0g (big blind) folded before Flop
Seat 5: FRv75HO8CUsRZ1byEz06mQ collected ($2)
Seat 6: BmYrv3ec2k5d6pQq6iNaZw folded before Flop (didn't bet)
Seat 7: mSD1pginDsyHG5PDfqzphw folded before Flop (didn't bet)
Seat 8: xUrN9TWLq4m5V+OXY7KUUA folded before Flop (didn't bet)
Seat 9: WpvT3OUSiZlpvs+mPXFqtQ folded before Flop (didn't bet)



PokerStars Game #59937829284:  Hold'em No Limit ($0.25/$0.50) - 2009/07/01 0:00:49 ET
Table 'mTxf8gPLgffN3Iwfm7Icfg' 2-max Seat #1 is the button
Seat 1: Do9Rlu1R5u/AcRtMTl8SYg ($68.20 in chips)
Seat 2: EMc5LPgVaded4Qc77vm0fw ($48.40 in chips)
Do9Rlu1R5u/AcRtMTl8SYg: posts small blind $0.25
EMc5LPgVaded4Qc77vm0fw: posts big blind $0.50
*** HOLE CARDS ***
Do9Rlu1R5u/AcRtMTl8SYg: folds
EMc5LPgVaded4Qc77vm0fw collected $0.50 from pot
EMc5LPgVaded4Qc77vm0fw: doesn't show hand
*** SUMMARY ***
Total pot $0.50 | Rake $0
Seat 1: Do9Rlu1R5u/AcRtMTl8SYg (button) (small blind) folded before Flop
Seat 2: EMc5LPgVaded4Qc77vm0fw (big blind) collected ($0.50)



PokerStars Game #59937829062:  Hold'em No Limit ($0.25/$0.50) - 2009/07/01 0:00:49 ET
Table 'iq+aXfWVQRdV0u8SRTYUEg' 9-max Seat #4 is the button
Seat 1: McPJctgiiz9IXq3OttAeOA ($13.35 in chips)
Seat 3: itOQCm2+5ujaA68I6hPvfg ($123 in chips)
Seat 4: +Z4e6ELfE9slw801LJ3vAw ($13.50 in chips)
Seat 5: MZo49KUcOZcn7g/WRL0Vqw ($46.40 in chips)
Seat 6: 8qvUviDc+VoNV1cmSHjjLw ($30.90 in chips)
Seat 8: s6ecbIEOOhj8S+E0MinQpQ ($31.80 in chips)
Seat 9: bXpVeaSTPBFSPJmeXxO7nw ($9.75 in chips)
MZo49KUcOZcn7g/WRL0Vqw: posts small blind $0.25
8qvUviDc+VoNV1cmSHjjLw: posts big blind $0.50
SKnJuWHScqetA/qG5p+wCg: sits out
*** HOLE CARDS ***
s6ecbIEOOhj8S+E0MinQpQ: folds
bXpVeaSTPBFSPJmeXxO7nw: calls $0.50
McPJctgiiz9IXq3OttAeOA: folds
itOQCm2+5ujaA68I6hPvfg: folds
+Z4e6ELfE9slw801LJ3vAw: folds
s6ecbIEOOhj8S+E0MinQpQ leaves the table
MZo49KUcOZcn7g/WRL0Vqw: calls $0.25
8qvUviDc+VoNV1cmSHjjLw: checks
*** FLOP *** [3c Ac 6h]
MZo49KUcOZcn7g/WRL0Vqw: checks
8qvUviDc+VoNV1cmSHjjLw: checks
k1f0lS7tlMHCLGs0JT34Tg joins the table at seat #8
bXpVeaSTPBFSPJmeXxO7nw: bets $1
MZo49KUcOZcn7g/WRL0Vqw: calls $1
8qvUviDc+VoNV1cmSHjjLw: folds
*** TURN *** [3c Ac 6h] [7d]
MZo49KUcOZcn7g/WRL0Vqw: checks
bXpVeaSTPBFSPJmeXxO7nw: checks
*** RIVER *** [3c Ac 6h 7d] [4d]
MZo49KUcOZcn7g/WRL0Vqw: checks
bXpVeaSTPBFSPJmeXxO7nw: bets $1
MZo49KUcOZcn7g/WRL0Vqw: folds
bXpVeaSTPBFSPJmeXxO7nw collected $3.35 from pot
bXpVeaSTPBFSPJmeXxO7nw: doesn't show hand
*** SUMMARY ***
Total pot $3.50 | Rake $0.15
Board [3c Ac 6h 7d 4d]
Seat 1: McPJctgiiz9IXq3OttAeOA folded before Flop (didn't bet)
Seat 3: itOQCm2+5ujaA68I6hPvfg folded before Flop (didn't bet)
Seat 4: +Z4e6ELfE9slw801LJ3vAw (button) folded before Flop (didn't bet)
Seat 5: MZo49KUcOZcn7g/WRL0Vqw (small blind) folded on the River
Seat 6: 8qvUviDc+VoNV1cmSHjjLw (big blind) folded on the Flop
Seat 8: s6ecbIEOOhj8S+E0MinQpQ folded before Flop (didn't bet)
Seat 9: bXpVeaSTPBFSPJmeXxO7nw collected ($3.35)



PokerStars Game #59937830840:  Hold'em No Limit ($0.25/$0.50) - 2009/07/01 0:00:51 ET
Table 'kgbJRsxfv64KrErDRBAkcw' 6-max Seat #5 is the button
Seat 1: YmWlPGOKFuJSoJZPW8a8IA ($84.30 in chips)
Seat 2: F1u6k1bk7IyWqKsK5pFybg ($98.70 in chips)
Seat 3: T0Gx/FcQ5VH9u7XaOMX97A ($61.95 in chips)
Seat 4: qanMEqjABjWxC/JgQ/0l7w ($50 in chips)
Seat 5: SlTdlH14u+KVVINgxMwt+Q ($74.55 in chips)
Seat 6: DDfYzIrYT0t5R/hAJngtsg ($28.60 in chips)
DDfYzIrYT0t5R/hAJngtsg: posts small blind $0.25
YmWlPGOKFuJSoJZPW8a8IA: posts big blind $0.50
*** HOLE CARDS ***
F1u6k1bk7IyWqKsK5pFybg: folds
T0Gx/FcQ5VH9u7XaOMX97A: folds
qanMEqjABjWxC/JgQ/0l7w: folds
SlTdlH14u+KVVINgxMwt+Q: raises $1 to $1.50
DDfYzIrYT0t5R/hAJngtsg: calls $1.25
YmWlPGOKFuJSoJZPW8a8IA: calls $1
*** FLOP *** [Tc Kh 4c]
DDfYzIrYT0t5R/hAJngtsg: checks
YmWlPGOKFuJSoJZPW8a8IA: checks
SlTdlH14u+KVVINgxMwt+Q: checks
*** TURN *** [Tc Kh 4c] [9c]
DDfYzIrYT0t5R/hAJngtsg: bets $0.50
YmWlPGOKFuJSoJZPW8a8IA: folds
SlTdlH14u+KVVINgxMwt+Q: calls $0.50
*** RIVER *** [Tc Kh 4c 9c] [Kc]
DDfYzIrYT0t5R/hAJngtsg: bets $0.50
SlTdlH14u+KVVINgxMwt+Q: raises $0.50 to $1
DDfYzIrYT0t5R/hAJngtsg: calls $0.50
*** SHOW DOWN ***
SlTdlH14u+KVVINgxMwt+Q: shows [8c Qd] (a flush, King high)
DDfYzIrYT0t5R/hAJngtsg: mucks hand
SlTdlH14u+KVVINgxMwt+Q collected $7.15 from pot
*** SUMMARY ***
Total pot $7.50 | Rake $0.35
Board [Tc Kh 4c 9c Kc]
Seat 1: YmWlPGOKFuJSoJZPW8a8IA (big blind) folded on the Turn
Seat 2: F1u6k1bk7IyWqKsK5pFybg folded before Flop (didn't bet)
Seat 3: T0Gx/FcQ5VH9u7XaOMX97A folded before Flop (didn't bet)
Seat 4: qanMEqjABjWxC/JgQ/0l7w folded before Flop (didn't bet)
Seat 5: SlTdlH14u+KVVINgxMwt+Q (button) showed [8c Qd] and won ($7.15) with a flush, King high
Seat 6: DDfYzIrYT0t5R/hAJngtsg (small blind) mucked



PokerStars Game #59937830806:  Hold'em No Limit ($0.25/$0.50) - 2009/07/01 0:00:51 ET
Table 'E7bWJ45aoFXRpyRv2gw+Ig' 2-max Seat #2 is the button
Seat 1: FRkiRasEGlHUeLrEl+k/nA ($50.50 in chips)
Seat 2: 3Wro85I7472vJ4Wkpneo9A ($75.85 in chips)
3Wro85I7472vJ4Wkpneo9A: posts small blind $0.25
FRkiRasEGlHUeLrEl+k/nA: posts big blind $0.50
*** HOLE CARDS ***
3Wro85I7472vJ4Wkpneo9A: raises $1 to $1.50
FRkiRasEGlHUeLrEl+k/nA: folds
3Wro85I7472vJ4Wkpneo9A collected $1 from pot
3Wro85I7472vJ4Wkpneo9A: doesn't show hand
*** SUMMARY ***
Total pot $1 | Rake $0
Seat 1: FRkiRasEGlHUeLrEl+k/nA (big blind) folded before Flop
Seat 2: 3Wro85I7472vJ4Wkpneo9A (button) (small blind) collected ($1)



PokerStars Game #59937832004:  Hold'em No Limit ($0.25/$0.50) - 2009/07/01 0:00:53 ET
Table '+dXkOAQyS8j9PQZusUTMpg' 2-max Seat #1 is the button
Seat 1: XFa6sBGjP2gxoIvxR3fZIg ($75.95 in chips)
Seat 2: 5IBeOgaApY1Bvzv2P8X4EA ($27.65 in chips)
XFa6sBGjP2gxoIvxR3fZIg: posts small blind $0.25
5IBeOgaApY1Bvzv2P8X4EA: posts big blind $0.50
*** HOLE CARDS ***
XFa6sBGjP2gxoIvxR3fZIg: raises $1 to $1.50
5IBeOgaApY1Bvzv2P8X4EA: folds
XFa6sBGjP2gxoIvxR3fZIg collected $1 from pot
*** SUMMARY ***
Total pot $1 | Rake $0
Seat 1: XFa6sBGjP2gxoIvxR3fZIg (button) (small blind) collected ($1)
Seat 2: 5IBeOgaApY1Bvzv2P8X4EA (big blind) folded before Flop



PokerStars Game #59937833110:  Hold'em No Limit ($0.25/$0.50) - 2009/07/01 0:00:54 ET
Table 'mTxf8gPLgffN3Iwfm7Icfg' 2-max Seat #2 is the button
Seat 1: Do9Rlu1R5u/AcRtMTl8SYg ($67.95 in chips)
Seat 2: EMc5LPgVaded4Qc77vm0fw ($48.65 in chips)
EMc5LPgVaded4Qc77vm0fw: posts small blind $0.25
Do9Rlu1R5u/AcRtMTl8SYg: posts big blind $0.50
*** HOLE CARDS ***
EMc5LPgVaded4Qc77vm0fw: folds
Do9Rlu1R5u/AcRtMTl8SYg collected $0.50 from pot
Do9Rlu1R5u/AcRtMTl8SYg: doesn't show hand
*** SUMMARY ***
Total pot $0.50 | Rake $0
Seat 1: Do9Rlu1R5u/AcRtMTl8SYg (big blind) collected ($0.50)
Seat 2: EMc5LPgVaded4Qc77vm0fw (button) (small blind) folded before Flop



PokerStars Game #59937833562:  Hold'em No Limit ($0.25/$0.50) - 2009/07/01 0:00:55 ET
Table 'GfL/No5u5PoEnU39lP5pQg' 6-max Seat #1 is the button
Seat 1: T0Gx/FcQ5VH9u7XaOMX97A ($50 in chips)
Seat 2: uVwggSetzp7d+eVgowO3vg ($21.80 in chips)
Seat 3: YmWlPGOKFuJSoJZPW8a8IA ($70 in chips)
Seat 4: yqM0AD7MZQd/cEtKdDQY1A ($38.90 in chips)
Seat 5: fDiswuKb270PAYXkTIYC3g ($23.50 in chips)
Seat 6: 5EiAo0XuFchfJkhvFPvoog ($65.95 in chips)
uVwggSetzp7d+eVgowO3vg: posts small blind $0.25
YmWlPGOKFuJSoJZPW8a8IA: posts big blind $0.50
*** HOLE CARDS ***
yqM0AD7MZQd/cEtKdDQY1A: raises $0.50 to $1
fDiswuKb270PAYXkTIYC3g: calls $1
5EiAo0XuFchfJkhvFPvoog: folds
T0Gx/FcQ5VH9u7XaOMX97A: folds
uVwggSetzp7d+eVgowO3vg: calls $0.75
YmWlPGOKFuJSoJZPW8a8IA: calls $0.50
*** FLOP *** [6s 3s 8d]
uVwggSetzp7d+eVgowO3vg: checks
YmWlPGOKFuJSoJZPW8a8IA: bets $2.50
yqM0AD7MZQd/cEtKdDQY1A: calls $2.50
fDiswuKb270PAYXkTIYC3g: raises $7.50 to $10
uVwggSetzp7d+eVgowO3vg: folds
YmWlPGOKFuJSoJZPW8a8IA: raises $15 to $25
yqM0AD7MZQd/cEtKdDQY1A: folds
fDiswuKb270PAYXkTIYC3g: calls $12.50 and is all-in
*** TURN *** [6s 3s 8d] [5c]
*** RIVER *** [6s 3s 8d 5c] [Qc]
*** SHOW DOWN ***
YmWlPGOKFuJSoJZPW8a8IA: shows [6c 6d] (three of a kind, Sixes)
fDiswuKb270PAYXkTIYC3g: shows [Ah As] (a pair of Aces)
YmWlPGOKFuJSoJZPW8a8IA collected $48.95 from pot
*** SUMMARY ***
Total pot $51.50 | Rake $2.55
Board [6s 3s 8d 5c Qc]
Seat 1: T0Gx/FcQ5VH9u7XaOMX97A (button) folded before Flop (didn't bet)
Seat 2: uVwggSetzp7d+eVgowO3vg (small blind) folded on the Flop
Seat 3: YmWlPGOKFuJSoJZPW8a8IA (big blind) showed [6c 6d] and won ($48.95) with three of a kind, Sixes
Seat 4: yqM0AD7MZQd/cEtKdDQY1A folded on the Flop
Seat 5: fDiswuKb270PAYXkTIYC3g showed [Ah As] and lost with a pair of Aces
Seat 6: 5EiAo0XuFchfJkhvFPvoog folded before Flop (didn't bet)



PokerStars Game #59937834334:  Hold'em No Limit ($0.25/$0.50) - 2009/07/01 0:00:56 ET
Table 'QOgaEqMcJ73pcUMMxoisUg' 6-max Seat #1 is the button
Seat 1: RFefXIDyFvNtJLq+CloCzA ($42.20 in chips)
Seat 2: qsObMEIlRO22OlS867m/lw ($15.85 in chips)
Seat 3: wUZNozoIDYf+16hp4nn6dw ($24.65 in chips)
Seat 5: HoaSQCRso+nEyO5DUhGduw ($71.60 in chips)
Seat 6: s83dnhZ6VC53vY0/f6OV/g ($40.65 in chips)
qsObMEIlRO22OlS867m/lw: posts small blind $0.25
wUZNozoIDYf+16hp4nn6dw: posts big blind $0.50
L5e2lrPLQm1Pqx30IIZ/Fw: sits out
*** HOLE CARDS ***
HoaSQCRso+nEyO5DUhGduw: folds
s83dnhZ6VC53vY0/f6OV/g: folds
RFefXIDyFvNtJLq+CloCzA: raises $2 to $2.50
qsObMEIlRO22OlS867m/lw: folds
wUZNozoIDYf+16hp4nn6dw: calls $2
*** FLOP *** [2s 7c Th]
wUZNozoIDYf+16hp4nn6dw: checks
RFefXIDyFvNtJLq+CloCzA: bets $4.25
wUZNozoIDYf+16hp4nn6dw: folds
RFefXIDyFvNtJLq+CloCzA collected $5 from pot
*** SUMMARY ***
Total pot $5.25 | Rake $0.25
Board [2s 7c Th]
Seat 1: RFefXIDyFvNtJLq+CloCzA (button) collected ($5)
Seat 2: qsObMEIlRO22OlS867m/lw (small blind) folded before Flop
Seat 3: wUZNozoIDYf+16hp4nn6dw (big blind) folded on the Flop
Seat 5: HoaSQCRso+nEyO5DUhGduw folded before Flop (didn't bet)
Seat 6: s83dnhZ6VC53vY0/f6OV/g folded before Flop (didn't bet)



PokerStars Game #59937836498:  Hold'em No Limit ($0.25/$0.50) - 2009/07/01 0:00:59 ET
Table 'NCiXr0d5CEKBQr/cZgLhbA' 9-max Seat #5 is the button
Seat 1: RjBdQ6w31rgcy0o24VLR6w ($9.25 in chips)
Seat 2: ulxuJchBV9iguXg0FUonfg ($31.20 in chips)
Seat 3: xZCXQSXlrZkp3pZizzVXCw ($54.15 in chips)
Seat 4: CL4d+tvzcd4utdQxlPLOmg ($34.90 in chips)
Seat 5: zE9cVigS2nW/Ljy4K4bUQA ($30.45 in chips)
Seat 6: SKnJuWHScqetA/qG5p+wCg ($32.05 in chips)
Seat 7: EltNhVR1POPXhu/1E62t3A ($9.50 in chips)
Seat 8: E2518gp4aFz1+kAgmGqeEg ($11.70 in chips)
Seat 9: WpvT3OUSiZlpvs+mPXFqtQ ($7.45 in chips)
SKnJuWHScqetA/qG5p+wCg: posts small blind $0.25
EltNhVR1POPXhu/1E62t3A: posts big blind $0.50
*** HOLE CARDS ***
E2518gp4aFz1+kAgmGqeEg: folds
WpvT3OUSiZlpvs+mPXFqtQ: folds
RjBdQ6w31rgcy0o24VLR6w: folds
ulxuJchBV9iguXg0FUonfg: folds
xZCXQSXlrZkp3pZizzVXCw: raises $1 to $1.50
CL4d+tvzcd4utdQxlPLOmg: folds
zE9cVigS2nW/Ljy4K4bUQA: raises $3.50 to $5
SKnJuWHScqetA/qG5p+wCg: folds
EltNhVR1POPXhu/1E62t3A: folds
xZCXQSXlrZkp3pZizzVXCw: folds
zE9cVigS2nW/Ljy4K4bUQA collected $3.75 from pot
*** SUMMARY ***
Total pot $3.75 | Rake $0
Seat 1: RjBdQ6w31rgcy0o24VLR6w folded before Flop (didn't bet)
Seat 2: ulxuJchBV9iguXg0FUonfg folded before Flop (didn't bet)
Seat 3: xZCXQSXlrZkp3pZizzVXCw folded before Flop
Seat 4: CL4d+tvzcd4utdQxlPLOmg folded before Flop (didn't bet)
Seat 5: zE9cVigS2nW/Ljy4K4bUQA (button) collected ($3.75)
Seat 6: SKnJuWHScqetA/qG5p+wCg (small blind) folded before Flop
Seat 7: EltNhVR1POPXhu/1E62t3A (big blind) folded before Flop
Seat 8: E2518gp4aFz1+kAgmGqeEg folded before Flop (didn't bet)
Seat 9: WpvT3OUSiZlpvs+mPXFqtQ folded before Flop (didn't bet)



PokerStars Game #59937837650:  Hold'em No Limit ($0.25/$0.50) - 2009/07/01 0:01:00 ET
Table 'mTxf8gPLgffN3Iwfm7Icfg' 2-max Seat #1 is the button
Seat 1: Do9Rlu1R5u/AcRtMTl8SYg ($68.20 in chips)
Seat 2: EMc5LPgVaded4Qc77vm0fw ($48.40 in chips)
Do9Rlu1R5u/AcRtMTl8SYg: posts small blind $0.25
EMc5LPgVaded4Qc77vm0fw: posts big blind $0.50
*** HOLE CARDS ***
Do9Rlu1R5u/AcRtMTl8SYg: raises $1 to $1.50
EMc5LPgVaded4Qc77vm0fw: calls $1
*** FLOP *** [Td 5s 2h]
EMc5LPgVaded4Qc77vm0fw: bets $1.50
Do9Rlu1R5u/AcRtMTl8SYg: calls $1.50
*** TURN *** [Td 5s 2h] [Ks]
EMc5LPgVaded4Qc77vm0fw: bets $2.50
Do9Rlu1R5u/AcRtMTl8SYg: calls $2.50
*** RIVER *** [Td 5s 2h Ks] [Ah]
EMc5LPgVaded4Qc77vm0fw: bets $4
Do9Rlu1R5u/AcRtMTl8SYg: folds
EMc5LPgVaded4Qc77vm0fw collected $10.50 from pot
EMc5LPgVaded4Qc77vm0fw: doesn't show hand
*** SUMMARY ***
Total pot $11 | Rake $0.50
Board [Td 5s 2h Ks Ah]
Seat 1: Do9Rlu1R5u/AcRtMTl8SYg (button) (small blind) folded on the River
Seat 2: EMc5LPgVaded4Qc77vm0fw (big blind) collected ($10.50)



PokerStars Game #59937837658:  Hold'em No Limit ($0.25/$0.50) - 2009/07/01 0:01:00 ET
Table '+dXkOAQyS8j9PQZusUTMpg' 2-max Seat #2 is the button
Seat 1: XFa6sBGjP2gxoIvxR3fZIg ($76.45 in chips)
Seat 2: 5IBeOgaApY1Bvzv2P8X4EA ($27.15 in chips)
5IBeOgaApY1Bvzv2P8X4EA: posts small blind $0.25
XFa6sBGjP2gxoIvxR3fZIg: posts big blind $0.50
*** HOLE CARDS ***
5IBeOgaApY1Bvzv2P8X4EA: folds
XFa6sBGjP2gxoIvxR3fZIg collected $0.50 from pot
XFa6sBGjP2gxoIvxR3fZIg: doesn't show hand
*** SUMMARY ***
Total pot $0.50 | Rake $0
Seat 1: XFa6sBGjP2gxoIvxR3fZIg (big blind) collected ($0.50)
Seat 2: 5IBeOgaApY1Bvzv2P8X4EA (button) (small blind) folded before Flop



PokerStars Game #59937838006:  Hold'em No Limit ($0.25/$0.50) - 2009/07/01 0:01:01 ET
Table 'E7bWJ45aoFXRpyRv2gw+Ig' 2-max Seat #1 is the button
Seat 1: FRkiRasEGlHUeLrEl+k/nA ($50 in chips)
Seat 2: 3Wro85I7472vJ4Wkpneo9A ($76.35 in chips)
FRkiRasEGlHUeLrEl+k/nA: posts small blind $0.25
3Wro85I7472vJ4Wkpneo9A: posts big blind $0.50
*** HOLE CARDS ***
FRkiRasEGlHUeLrEl+k/nA: folds
3Wro85I7472vJ4Wkpneo9A collected $0.50 from pot
3Wro85I7472vJ4Wkpneo9A: doesn't show hand
*** SUMMARY ***
Total pot $0.50 | Rake $0
Seat 1: FRkiRasEGlHUeLrEl+k/nA (button) (small blind) folded before Flop
Seat 2: 3Wro85I7472vJ4Wkpneo9A (big blind) collected ($0.50)



PokerStars Game #59937838976:  Hold'em No Limit ($0.25/$0.50) - 2009/07/01 0:01:02 ET
Table 'eMxdLyFDf28E0wit6gm3Uw' 6-max Seat #1 is the button
Seat 1: tnD/64LagZ9qPaeOQVjVZg ($10.50 in chips)
Seat 2: jwuKQ1S3U4NnzMQn3E3dgw ($68.40 in chips)
Seat 3: DzX7XiDmCFpp796ywj9jOg ($47.65 in chips)
Seat 4: crjGpJEzSZgD38FoE3VMGg ($50 in chips)
Seat 5: X0X97o2fDAPiGx6o1gahsw ($56.15 in chips)
Seat 6: L0aIPg7qefDQjdJo3HCVEA ($8.25 in chips)
jwuKQ1S3U4NnzMQn3E3dgw: posts small blind $0.25
DzX7XiDmCFpp796ywj9jOg: posts big blind $0.50
*** HOLE CARDS ***
crjGpJEzSZgD38FoE3VMGg: folds
X0X97o2fDAPiGx6o1gahsw: folds
L0aIPg7qefDQjdJo3HCVEA: folds
tnD/64LagZ9qPaeOQVjVZg: folds
jwuKQ1S3U4NnzMQn3E3dgw: calls $0.25
DzX7XiDmCFpp796ywj9jOg: checks
*** FLOP *** [7d Ac 9d]
jwuKQ1S3U4NnzMQn3E3dgw: checks
DzX7XiDmCFpp796ywj9jOg: checks
*** TURN *** [7d Ac 9d] [3s]
jwuKQ1S3U4NnzMQn3E3dgw: checks
DzX7XiDmCFpp796ywj9jOg: checks
*** RIVER *** [7d Ac 9d 3s] [2h]
jwuKQ1S3U4NnzMQn3E3dgw: bets $1.50
DzX7XiDmCFpp796ywj9jOg: calls $1.50
*** SHOW DOWN ***
jwuKQ1S3U4NnzMQn3E3dgw: shows [4d Kh] (high card Ace)
DzX7XiDmCFpp796ywj9jOg: shows [3d 2s] (two pair, Threes and Deuces)
DzX7XiDmCFpp796ywj9jOg collected $3.85 from pot
DzX7XiDmCFpp796ywj9jOg is sitting out
*** SUMMARY ***
Total pot $4 | Rake $0.15
Board [7d Ac 9d 3s 2h]
Seat 1: tnD/64LagZ9qPaeOQVjVZg (button) folded before Flop (didn't bet)
Seat 2: jwuKQ1S3U4NnzMQn3E3dgw (small blind) showed [4d Kh] and lost with high card Ace
Seat 3: DzX7XiDmCFpp796ywj9jOg (big blind) showed [3d 2s] and won ($3.85) with two pair, Threes and Deuces
Seat 4: crjGpJEzSZgD38FoE3VMGg folded before Flop (didn't bet)
Seat 5: X0X97o2fDAPiGx6o1gahsw folded before Flop (didn't bet)
Seat 6: L0aIPg7qefDQjdJo3HCVEA folded before Flop (didn't bet)



PokerStars Game #59937838562:  Hold'em No Limit ($0.25/$0.50) - 2009/07/01 0:01:02 ET
Table '5EmHi+fnatGQQShcNmzOZQ' 6-max Seat #6 is the button
Seat 1: SwPczQo3cOtwEzhJrfO2cQ ($17.25 in chips)
Seat 3: J8dF2sYMvXUmAGUuSW9kwg ($39.85 in chips)
Seat 4: mFTuMjESuBcXHQ1ePkg/8A ($22.10 in chips)
Seat 5: kxPhs4ePFqMy52CInAJ2aw ($73.80 in chips)
Seat 6: 686aeHikcJlgKkSuIFdcXQ ($112.30 in chips)
SwPczQo3cOtwEzhJrfO2cQ: posts small blind $0.25
J8dF2sYMvXUmAGUuSW9kwg: posts big blind $0.50
*** HOLE CARDS ***
mFTuMjESuBcXHQ1ePkg/8A: calls $0.50
kxPhs4ePFqMy52CInAJ2aw: folds
686aeHikcJlgKkSuIFdcXQ: folds
SwPczQo3cOtwEzhJrfO2cQ: folds
J8dF2sYMvXUmAGUuSW9kwg: checks
*** FLOP *** [4s 3c Qh]
J8dF2sYMvXUmAGUuSW9kwg: checks
mFTuMjESuBcXHQ1ePkg/8A: checks
*** TURN *** [4s 3c Qh] [9d]
J8dF2sYMvXUmAGUuSW9kwg: checks
mFTuMjESuBcXHQ1ePkg/8A: checks
*** RIVER *** [4s 3c Qh 9d] [Th]
J8dF2sYMvXUmAGUuSW9kwg: checks
mFTuMjESuBcXHQ1ePkg/8A: bets $0.50
J8dF2sYMvXUmAGUuSW9kwg: folds
mFTuMjESuBcXHQ1ePkg/8A collected $1.20 from pot
mFTuMjESuBcXHQ1ePkg/8A: doesn't show hand
*** SUMMARY ***
Total pot $1.25 | Rake $0.05
Board [4s 3c Qh 9d Th]
Seat 1: SwPczQo3cOtwEzhJrfO2cQ (small blind) folded before Flop
Seat 3: J8dF2sYMvXUmAGUuSW9kwg (big blind) folded on the River
Seat 4: mFTuMjESuBcXHQ1ePkg/8A collected ($1.20)
Seat 5: kxPhs4ePFqMy52CInAJ2aw folded before Flop (didn't bet)
Seat 6: 686aeHikcJlgKkSuIFdcXQ (button) folded before Flop (didn't bet)



PokerStars Game #59937839812:  Hold'em No Limit ($0.25/$0.50) - 2009/07/01 0:01:03 ET
Table 'MJxeZCzYELxiIsyUZyT0jw' 6-max Seat #2 is the button
Seat 1: iKPos8JI094Tomq4tDSgnQ ($19.20 in chips)
Seat 2: r6H1GiZ6QIpMTDhyodKuRQ ($66.40 in chips)
Seat 3: JQZew0FjzS19kTjeNtrE+A ($57.15 in chips)
Seat 4: lP7Q6pewz4C2RsAfKsjdWw ($26.90 in chips)
Seat 5: VO2eih4OVj7FCQGPfUoW8A ($61.85 in chips)
Seat 6: TTx3CHxyi0SObcHyMJRp5w ($42.45 in chips)
JQZew0FjzS19kTjeNtrE+A: posts small blind $0.25
lP7Q6pewz4C2RsAfKsjdWw: posts big blind $0.50
*** HOLE CARDS ***
VO2eih4OVj7FCQGPfUoW8A: folds
TTx3CHxyi0SObcHyMJRp5w: folds
iKPos8JI094Tomq4tDSgnQ: raises $1.50 to $2
r6H1GiZ6QIpMTDhyodKuRQ: folds
JQZew0FjzS19kTjeNtrE+A: folds
lP7Q6pewz4C2RsAfKsjdWw: calls $1.50
*** FLOP *** [2c Ac 6h]
lP7Q6pewz4C2RsAfKsjdWw: checks
iKPos8JI094Tomq4tDSgnQ: bets $2
lP7Q6pewz4C2RsAfKsjdWw: folds
iKPos8JI094Tomq4tDSgnQ collected $4.05 from pot
*** SUMMARY ***
Total pot $4.25 | Rake $0.20
Board [2c Ac 6h]
Seat 1: iKPos8JI094Tomq4tDSgnQ collected ($4.05)
Seat 2: r6H1GiZ6QIpMTDhyodKuRQ (button) folded before Flop (didn't bet)
Seat 3: JQZew0FjzS19kTjeNtrE+A (small blind) folded before Flop
Seat 4: lP7Q6pewz4C2RsAfKsjdWw (big blind) folded on the Flop
Seat 5: VO2eih4OVj7FCQGPfUoW8A folded before Flop (didn't bet)
Seat 6: TTx3CHxyi0SObcHyMJRp5w folded before Flop (didn't bet)



PokerStars Game #59937839306:  Hold'em No Limit ($0.25/$0.50) - 2009/07/01 0:01:03 ET
Table 'SsXEKOwKN+jE3etfusqUqA' 2-max Seat #2 is the button
Seat 1: 618rKeLrz/avGNOLULHHVQ ($133.55 in chips)
Seat 2: XfRhywXA6Br+jID1oGeo8A ($64.05 in chips)
XfRhywXA6Br+jID1oGeo8A: posts small blind $0.25
618rKeLrz/avGNOLULHHVQ: posts big blind $0.50
*** HOLE CARDS ***
XfRhywXA6Br+jID1oGeo8A: raises $1 to $1.50
618rKeLrz/avGNOLULHHVQ: raises $3.50 to $5
XfRhywXA6Br+jID1oGeo8A: calls $3.50
*** FLOP *** [Qd 3s 9d]
618rKeLrz/avGNOLULHHVQ: bets $7
XfRhywXA6Br+jID1oGeo8A: folds
618rKeLrz/avGNOLULHHVQ collected $9.50 from pot
618rKeLrz/avGNOLULHHVQ: doesn't show hand
*** SUMMARY ***
Total pot $10 | Rake $0.50
Board [Qd 3s 9d]
Seat 1: 618rKeLrz/avGNOLULHHVQ (big blind) collected ($9.50)
Seat 2: XfRhywXA6Br+jID1oGeo8A (button) (small blind) folded on the Flop



PokerStars Game #59937839972:  Hold'em No Limit ($0.25/$0.50) - 2009/07/01 0:01:04 ET
Table 'Vdlc9wqYcHTUhtdyN7CuJw' 2-max Seat #1 is the button
Seat 1: yBO+mXB6m/rCft2ErwGf/Q ($65.20 in chips)
Seat 2: sa0qgETiL3HNbdfGlnKHTA ($50.10 in chips)
yBO+mXB6m/rCft2ErwGf/Q: posts small blind $0.25
sa0qgETiL3HNbdfGlnKHTA: posts big blind $0.50
*** HOLE CARDS ***
yBO+mXB6m/rCft2ErwGf/Q: folds
sa0qgETiL3HNbdfGlnKHTA collected $0.50 from pot
sa0qgETiL3HNbdfGlnKHTA: doesn't show hand
*** SUMMARY ***
Total pot $0.50 | Rake $0
Seat 1: yBO+mXB6m/rCft2ErwGf/Q (button) (small blind) folded before Flop
Seat 2: sa0qgETiL3HNbdfGlnKHTA (big blind) collected ($0.50)



PokerStars Game #59937840420:  Hold'em No Limit ($0.25/$0.50) - 2009/07/01 0:01:04 ET
Table 'lpxYasB1ClBSgTpCCITwhQ' 9-max Seat #9 is the button
Seat 1: ceq82/EkjUd/GFbf0YwGmA ($37.75 in chips)
Seat 2: 5JJVDlaiMnB004o/RqbZZQ ($21.65 in chips)
Seat 3: E2518gp4aFz1+kAgmGqeEg ($9.95 in chips)
Seat 6: YPo1oggovmqSREegekaQYw ($14.25 in chips)
Seat 7: zE9cVigS2nW/Ljy4K4bUQA ($30 in chips)
Seat 8: o6JyUkbzCDw8tUabqtmnlg ($27.45 in chips)
Seat 9: mSD1pginDsyHG5PDfqzphw ($10 in chips)
ceq82/EkjUd/GFbf0YwGmA: posts small blind $0.25
5JJVDlaiMnB004o/RqbZZQ: posts big blind $0.50
k1f0lS7tlMHCLGs0JT34Tg: sits out
bXpVeaSTPBFSPJmeXxO7nw: sits out
*** HOLE CARDS ***
E2518gp4aFz1+kAgmGqeEg: folds
YPo1oggovmqSREegekaQYw: raises $0.50 to $1
zE9cVigS2nW/Ljy4K4bUQA: calls $1
o6JyUkbzCDw8tUabqtmnlg: folds
mSD1pginDsyHG5PDfqzphw: folds
ceq82/EkjUd/GFbf0YwGmA: folds
5JJVDlaiMnB004o/RqbZZQ: folds
*** FLOP *** [Qc Td 9h]
YPo1oggovmqSREegekaQYw: checks
zE9cVigS2nW/Ljy4K4bUQA: checks
*** TURN *** [Qc Td 9h] [Ad]
YPo1oggovmqSREegekaQYw: checks
zE9cVigS2nW/Ljy4K4bUQA: checks
*** RIVER *** [Qc Td 9h Ad] [Qh]
YPo1oggovmqSREegekaQYw: bets $1.50
zE9cVigS2nW/Ljy4K4bUQA: calls $1.50
*** SHOW DOWN ***
YPo1oggovmqSREegekaQYw: shows [Jc Ac] (two pair, Aces and Queens)
zE9cVigS2nW/Ljy4K4bUQA: mucks hand
YPo1oggovmqSREegekaQYw collected $5.50 from pot
*** SUMMARY ***
Total pot $5.75 | Rake $0.25
Board [Qc Td 9h Ad Qh]
Seat 1: ceq82/EkjUd/GFbf0YwGmA (small blind) folded before Flop
Seat 2: 5JJVDlaiMnB004o/RqbZZQ (big blind) folded before Flop
Seat 3: E2518gp4aFz1+kAgmGqeEg folded before Flop (didn't bet)
Seat 6: YPo1oggovmqSREegekaQYw showed [Jc Ac] and won ($5.50) with two pair, Aces and Queens
Seat 7: zE9cVigS2nW/Ljy4K4bUQA mucked
Seat 8: o6JyUkbzCDw8tUabqtmnlg folded before Flop (didn't bet)
Seat 9: mSD1pginDsyHG5PDfqzphw (button) folded before Flop (didn't bet)



PokerStars Game #59937840652:  Hold'em No Limit ($0.25/$0.50) - 2009/07/01 0:01:05 ET
Table 'c/CRn+68J3Y8KxD5g1ek2Q' 2-max Seat #1 is the button
Seat 1: 46qCyJ6evTkHo9al5sBMNA ($327.65 in chips)
Seat 2: BypVLsYQt3ePFm2xQL/dOA ($61.60 in chips)
46qCyJ6evTkHo9al5sBMNA: posts small blind $0.25
BypVLsYQt3ePFm2xQL/dOA: posts big blind $0.50
*** HOLE CARDS ***
46qCyJ6evTkHo9al5sBMNA: raises $1 to $1.50
BypVLsYQt3ePFm2xQL/dOA: raises $5 to $6.50
46qCyJ6evTkHo9al5sBMNA: folds
BypVLsYQt3ePFm2xQL/dOA collected $3 from pot
BypVLsYQt3ePFm2xQL/dOA: doesn't show hand
*** SUMMARY ***
Total pot $3 | Rake $0
Seat 1: 46qCyJ6evTkHo9al5sBMNA (button) (small blind) folded before Flop
Seat 2: BypVLsYQt3ePFm2xQL/dOA (big blind) collected ($3)



PokerStars Game #59937841128:  Hold'em No Limit ($0.25/$0.50) - 2009/07/01 0:01:05 ET
Table 'tpZbcIvqh/6WmfR/i5IE3A' 9-max Seat #8 is the button
Seat 1: nV/P1jFY/CFMXOLWu7pYmA ($14.95 in chips)
Seat 2: M+7+BTmX5vZatHVuoRB1nA ($51.20 in chips)
Seat 3: 3w0FbBQAKwQODwenKwZxXw ($68.20 in chips)
Seat 4: zE9cVigS2nW/Ljy4K4bUQA ($30 in chips)
Seat 5: 9r7ZoBbAJj5IeyZ0q9BdzA ($13.70 in chips)
Seat 6: E2518gp4aFz1+kAgmGqeEg ($12.20 in chips)
Seat 7: wIZ377kjl2fHFGnS93o6bw ($15.95 in chips)
Seat 8: bXpVeaSTPBFSPJmeXxO7nw ($9.85 in chips)
nV/P1jFY/CFMXOLWu7pYmA: posts small blind $0.25
M+7+BTmX5vZatHVuoRB1nA: posts big blind $0.50
*** HOLE CARDS ***
3w0FbBQAKwQODwenKwZxXw: folds
zE9cVigS2nW/Ljy4K4bUQA: folds
9r7ZoBbAJj5IeyZ0q9BdzA: folds
E2518gp4aFz1+kAgmGqeEg: folds
wIZ377kjl2fHFGnS93o6bw: folds
bXpVeaSTPBFSPJmeXxO7nw: folds
nV/P1jFY/CFMXOLWu7pYmA: calls $0.25
M+7+BTmX5vZatHVuoRB1nA: checks
*** FLOP *** [7s 2s Qs]
nV/P1jFY/CFMXOLWu7pYmA: checks
M+7+BTmX5vZatHVuoRB1nA: checks
*** TURN *** [7s 2s Qs] [6d]
nV/P1jFY/CFMXOLWu7pYmA: checks
M+7+BTmX5vZatHVuoRB1nA: checks
*** RIVER *** [7s 2s Qs 6d] [Jc]
nV/P1jFY/CFMXOLWu7pYmA: checks
M+7+BTmX5vZatHVuoRB1nA: bets $1
nV/P1jFY/CFMXOLWu7pYmA: folds
M+7+BTmX5vZatHVuoRB1nA collected $0.95 from pot
*** SUMMARY ***
Total pot $1 | Rake $0.05
Board [7s 2s Qs 6d Jc]
Seat 1: nV/P1jFY/CFMXOLWu7pYmA (small blind) folded on the River
Seat 2: M+7+BTmX5vZatHVuoRB1nA (big blind) collected ($0.95)
Seat 3: 3w0FbBQAKwQODwenKwZxXw folded before Flop (didn't bet)
Seat 4: zE9cVigS2nW/Ljy4K4bUQA folded before Flop (didn't bet)
Seat 5: 9r7ZoBbAJj5IeyZ0q9BdzA folded before Flop (didn't bet)
Seat 6: E2518gp4aFz1+kAgmGqeEg folded before Flop (didn't bet)
Seat 7: wIZ377kjl2fHFGnS93o6bw folded before Flop (didn't bet)
Seat 8: bXpVeaSTPBFSPJmeXxO7nw (button) folded before Flop (didn't bet)



PokerStars Game #59937841378:  Hold'em No Limit ($0.25/$0.50) - 2009/07/01 0:01:06 ET
Table 'hSTs/dUsYLgJQuF2Onp0MQ' 6-max Seat #4 is the button
Seat 1: lWwl5C/UZOsWNubdUqghZw ($71.95 in chips)
Seat 3: vQOrJuXbLC3UZDVklY9bOA ($13.50 in chips)
Seat 4: L0aIPg7qefDQjdJo3HCVEA ($12.95 in chips)
Seat 5: 686aeHikcJlgKkSuIFdcXQ ($61.65 in chips)
Seat 6: +laPa9P7BjZKKnR0n+OmvA ($11.60 in chips)
686aeHikcJlgKkSuIFdcXQ: posts small blind $0.25
+laPa9P7BjZKKnR0n+OmvA: posts big blind $0.50
*** HOLE CARDS ***
lWwl5C/UZOsWNubdUqghZw: folds
vQOrJuXbLC3UZDVklY9bOA: raises $1 to $1.50
L0aIPg7qefDQjdJo3HCVEA: raises $11.45 to $12.95 and is all-in
686aeHikcJlgKkSuIFdcXQ: folds
+laPa9P7BjZKKnR0n+OmvA: folds
vQOrJuXbLC3UZDVklY9bOA: folds
L0aIPg7qefDQjdJo3HCVEA collected $3.75 from pot
*** SUMMARY ***
Total pot $3.75 | Rake $0
Seat 1: lWwl5C/UZOsWNubdUqghZw folded before Flop (didn't bet)
Seat 3: vQOrJuXbLC3UZDVklY9bOA folded before Flop
Seat 4: L0aIPg7qefDQjdJo3HCVEA (button) collected ($3.75)
Seat 5: 686aeHikcJlgKkSuIFdcXQ (small blind) folded before Flop
Seat 6: +laPa9P7BjZKKnR0n+OmvA (big blind) folded before Flop



PokerStars Game #59937842208:  Hold'em No Limit ($0.25/$0.50) - 2009/07/01 0:01:07 ET
Table 'E7bWJ45aoFXRpyRv2gw+Ig' 2-max Seat #2 is the button
Seat 1: FRkiRasEGlHUeLrEl+k/nA ($50 in chips)
Seat 2: 3Wro85I7472vJ4Wkpneo9A ($76.60 in chips)
3Wro85I7472vJ4Wkpneo9A: posts small blind $0.25
FRkiRasEGlHUeLrEl+k/nA: posts big blind $0.50
*** HOLE CARDS ***
3Wro85I7472vJ4Wkpneo9A: calls $0.25
FRkiRasEGlHUeLrEl+k/nA: checks
*** FLOP *** [5h 9d Jh]
FRkiRasEGlHUeLrEl+k/nA: checks
3Wro85I7472vJ4Wkpneo9A: bets $1
FRkiRasEGlHUeLrEl+k/nA: calls $1
*** TURN *** [5h 9d Jh] [5d]
FRkiRasEGlHUeLrEl+k/nA: checks
3Wro85I7472vJ4Wkpneo9A: checks
*** RIVER *** [5h 9d Jh 5d] [Jd]
FRkiRasEGlHUeLrEl+k/nA: checks
3Wro85I7472vJ4Wkpneo9A: checks
*** SHOW DOWN ***
FRkiRasEGlHUeLrEl+k/nA: shows [9s 3s] (two pair, Jacks and Nines)
3Wro85I7472vJ4Wkpneo9A: mucks hand
FRkiRasEGlHUeLrEl+k/nA collected $2.90 from pot
*** SUMMARY ***
Total pot $3 | Rake $0.10
Board [5h 9d Jh 5d Jd]
Seat 1: FRkiRasEGlHUeLrEl+k/nA (big blind) showed [9s 3s] and won ($2.90) with two pair, Jacks and Nines
Seat 2: 3Wro85I7472vJ4Wkpneo9A (button) (small blind) mucked



PokerStars Game #59937842034:  Hold'em No Limit ($0.25/$0.50) - 2009/07/01 0:01:07 ET
Table '+dXkOAQyS8j9PQZusUTMpg' 2-max Seat #1 is the button
Seat 1: XFa6sBGjP2gxoIvxR3fZIg ($76.70 in chips)
Seat 2: 5IBeOgaApY1Bvzv2P8X4EA ($26.90 in chips)
XFa6sBGjP2gxoIvxR3fZIg: posts small blind $0.25
5IBeOgaApY1Bvzv2P8X4EA: posts big blind $0.50
*** HOLE CARDS ***
XFa6sBGjP2gxoIvxR3fZIg: raises $1 to $1.50
5IBeOgaApY1Bvzv2P8X4EA: calls $1
*** FLOP *** [7c 8c 9c]
5IBeOgaApY1Bvzv2P8X4EA: bets $1
XFa6sBGjP2gxoIvxR3fZIg: raises $3 to $4
5IBeOgaApY1Bvzv2P8X4EA: calls $3
*** TURN *** [7c 8c 9c] [Kd]
5IBeOgaApY1Bvzv2P8X4EA: checks
XFa6sBGjP2gxoIvxR3fZIg: checks
*** RIVER *** [7c 8c 9c Kd] [7h]
5IBeOgaApY1Bvzv2P8X4EA: bets $2
XFa6sBGjP2gxoIvxR3fZIg: folds
5IBeOgaApY1Bvzv2P8X4EA collected $10.50 from pot
5IBeOgaApY1Bvzv2P8X4EA: doesn't show hand
*** SUMMARY ***
Total pot $11 | Rake $0.50
Board [7c 8c 9c Kd 7h]
Seat 1: XFa6sBGjP2gxoIvxR3fZIg (button) (small blind) folded on the River
Seat 2: 5IBeOgaApY1Bvzv2P8X4EA (big blind) collected ($10.50)



PokerStars Game #59937845508:  Hold'em No Limit ($0.25/$0.50) - 2009/07/01 0:01:12 ET
Table 'Vdlc9wqYcHTUhtdyN7CuJw' 2-max Seat #2 is the button
Seat 1: yBO+mXB6m/rCft2ErwGf/Q ($64.95 in chips)
Seat 2: sa0qgETiL3HNbdfGlnKHTA ($50.35 in chips)
sa0qgETiL3HNbdfGlnKHTA: posts small blind $0.25
yBO+mXB6m/rCft2ErwGf/Q: posts big blind $0.50
*** HOLE CARDS ***
sa0qgETiL3HNbdfGlnKHTA: raises $1 to $1.50
yBO+mXB6m/rCft2ErwGf/Q: calls $1
*** FLOP *** [9d 2c Tc]
yBO+mXB6m/rCft2ErwGf/Q: checks
sa0qgETiL3HNbdfGlnKHTA: bets $1
yBO+mXB6m/rCft2ErwGf/Q: folds
sa0qgETiL3HNbdfGlnKHTA collected $2.85 from pot
sa0qgETiL3HNbdfGlnKHTA: doesn't show hand
*** SUMMARY ***
Total pot $3 | Rake $0.15
Board [9d 2c Tc]
Seat 1: yBO+mXB6m/rCft2ErwGf/Q (big blind) folded on the Flop
Seat 2: sa0qgETiL3HNbdfGlnKHTA (button) (small blind) collected ($2.85)



PokerStars Game #59937848890:  Hold'em No Limit ($0.25/$0.50) - 2009/07/01 0:01:16 ET
Table 'BCN5su+SsXiy1zRMJi0SJw' 6-max Seat #6 is the button
Seat 1: 5EiAo0XuFchfJkhvFPvoog ($99.70 in chips)
Seat 2: QfV2JJlmEKgD5jYPV+a33A ($161.65 in chips)
Seat 3: yrJsFKWv+ttHooqghxDx3A ($6.05 in chips)
Seat 4: 6Wb8PlO2kM4fnSim7p4Mrw ($12.55 in chips)
Seat 5: TTx3CHxyi0SObcHyMJRp5w ($34 in chips)
Seat 6: zHXshyreKwJVq3N3U+K9uQ ($52.05 in chips)
5EiAo0XuFchfJkhvFPvoog: posts small blind $0.25
QfV2JJlmEKgD5jYPV+a33A: posts big blind $0.50
*** HOLE CARDS ***
yrJsFKWv+ttHooqghxDx3A: folds
6Wb8PlO2kM4fnSim7p4Mrw: calls $0.50
TTx3CHxyi0SObcHyMJRp5w: calls $0.50
zHXshyreKwJVq3N3U+K9uQ: folds
5EiAo0XuFchfJkhvFPvoog: folds
QfV2JJlmEKgD5jYPV+a33A: checks
*** FLOP *** [9s 6d Tc]
QfV2JJlmEKgD5jYPV+a33A: checks
6Wb8PlO2kM4fnSim7p4Mrw: bets $0.50
TTx3CHxyi0SObcHyMJRp5w: raises $1 to $1.50
QfV2JJlmEKgD5jYPV+a33A: folds
6Wb8PlO2kM4fnSim7p4Mrw: calls $1
*** TURN *** [9s 6d Tc] [8s]
6Wb8PlO2kM4fnSim7p4Mrw: checks
TTx3CHxyi0SObcHyMJRp5w: checks
*** RIVER *** [9s 6d Tc 8s] [Kc]
6Wb8PlO2kM4fnSim7p4Mrw: checks
TTx3CHxyi0SObcHyMJRp5w: bets $2.50
6Wb8PlO2kM4fnSim7p4Mrw: folds
TTx3CHxyi0SObcHyMJRp5w collected $4.55 from pot
TTx3CHxyi0SObcHyMJRp5w: doesn't show hand
*** SUMMARY ***
Total pot $4.75 | Rake $0.20
Board [9s 6d Tc 8s Kc]
Seat 1: 5EiAo0XuFchfJkhvFPvoog (small blind) folded before Flop
Seat 2: QfV2JJlmEKgD5jYPV+a33A (big blind) folded on the Flop
Seat 3: yrJsFKWv+ttHooqghxDx3A folded before Flop (didn't bet)
Seat 4: 6Wb8PlO2kM4fnSim7p4Mrw folded on the River
Seat 5: TTx3CHxyi0SObcHyMJRp5w collected ($4.55)
Seat 6: zHXshyreKwJVq3N3U+K9uQ (button) folded before Flop (didn't bet)



PokerStars Game #59937850606:  Hold'em No Limit ($0.25/$0.50) - 2009/07/01 0:01:18 ET
Table '+z1aekfHkpp09pc8F9aViw' 6-max Seat #5 is the button
Seat 1: lWwl5C/UZOsWNubdUqghZw ($50 in chips)
Seat 2: VuB2GN0h94yY+QbuI2Mybg ($25.95 in chips)
Seat 3: uUznlIMFnRUvwrBhYF73KA ($55.85 in chips)
Seat 4: OCrv7ObFH4/s2lv7rYOnsQ ($21.70 in chips)
Seat 5: crjGpJEzSZgD38FoE3VMGg ($62.90 in chips)
Seat 6: 686aeHikcJlgKkSuIFdcXQ ($68.15 in chips)
686aeHikcJlgKkSuIFdcXQ: posts small blind $0.25
lWwl5C/UZOsWNubdUqghZw: posts big blind $0.50
*** HOLE CARDS ***
VuB2GN0h94yY+QbuI2Mybg: calls $0.50
uUznlIMFnRUvwrBhYF73KA: calls $0.50
OCrv7ObFH4/s2lv7rYOnsQ: folds
crjGpJEzSZgD38FoE3VMGg: folds
686aeHikcJlgKkSuIFdcXQ: folds
lWwl5C/UZOsWNubdUqghZw: checks
*** FLOP *** [Ad Jh 5d]
lWwl5C/UZOsWNubdUqghZw: checks
VuB2GN0h94yY+QbuI2Mybg: checks
uUznlIMFnRUvwrBhYF73KA: checks
*** TURN *** [Ad Jh 5d] [Qh]
lWwl5C/UZOsWNubdUqghZw: checks
VuB2GN0h94yY+QbuI2Mybg: checks
uUznlIMFnRUvwrBhYF73KA: checks
*** RIVER *** [Ad Jh 5d Qh] [3h]
lWwl5C/UZOsWNubdUqghZw: checks
VuB2GN0h94yY+QbuI2Mybg: checks
uUznlIMFnRUvwrBhYF73KA: bets $2.50
lWwl5C/UZOsWNubdUqghZw: folds
VuB2GN0h94yY+QbuI2Mybg: folds
uUznlIMFnRUvwrBhYF73KA collected $1.70 from pot
*** SUMMARY ***
Total pot $1.75 | Rake $0.05
Board [Ad Jh 5d Qh 3h]
Seat 1: lWwl5C/UZOsWNubdUqghZw (big blind) folded on the River
Seat 2: VuB2GN0h94yY+QbuI2Mybg folded on the River
Seat 3: uUznlIMFnRUvwrBhYF73KA collected ($1.70)
Seat 4: OCrv7ObFH4/s2lv7rYOnsQ folded before Flop (didn't bet)
Seat 5: crjGpJEzSZgD38FoE3VMGg (button) folded before Flop (didn't bet)
Seat 6: 686aeHikcJlgKkSuIFdcXQ (small blind) folded before Flop



PokerStars Game #59937851174:  Hold'em No Limit ($0.25/$0.50) - 2009/07/01 0:01:19 ET
Table 'SsXEKOwKN+jE3etfusqUqA' 2-max Seat #1 is the button
Seat 1: 618rKeLrz/avGNOLULHHVQ ($138.05 in chips)
Seat 2: XfRhywXA6Br+jID1oGeo8A ($59.05 in chips)
618rKeLrz/avGNOLULHHVQ: posts small blind $0.25
XfRhywXA6Br+jID1oGeo8A: posts big blind $0.50
*** HOLE CARDS ***
618rKeLrz/avGNOLULHHVQ: folds
XfRhywXA6Br+jID1oGeo8A collected $0.50 from pot
*** SUMMARY ***
Total pot $0.50 | Rake $0
Seat 1: 618rKeLrz/avGNOLULHHVQ (button) (small blind) folded before Flop
Seat 2: XfRhywXA6Br+jID1oGeo8A (big blind) collected ($0.50)



PokerStars Game #59937851744:  Hold'em No Limit ($0.25/$0.50) - 2009/07/01 0:01:20 ET
Table 'YsnnHkamRzYqMOr2FlLY4w' 6-max Seat #4 is the button
Seat 1: crjGpJEzSZgD38FoE3VMGg ($55.30 in chips)
Seat 2: 2dIa62hMcn6g73rbkt9NwA ($63.60 in chips)
Seat 3: I+pG2m/dD5iYdbg9qx572g ($21.80 in chips)
Seat 4: 7Fue572p4ZIC85AJMQvaQw ($47.80 in chips)
Seat 5: lcQ7uuLf+WLGGy4Ve6VKKA ($44.75 in chips)
Seat 6: YmWlPGOKFuJSoJZPW8a8IA ($50 in chips)
lcQ7uuLf+WLGGy4Ve6VKKA: posts small blind $0.25
YmWlPGOKFuJSoJZPW8a8IA: posts big blind $0.50
*** HOLE CARDS ***
crjGpJEzSZgD38FoE3VMGg: folds
2dIa62hMcn6g73rbkt9NwA: folds
I+pG2m/dD5iYdbg9qx572g: folds
7Fue572p4ZIC85AJMQvaQw: folds
lcQ7uuLf+WLGGy4Ve6VKKA: calls $0.25
YmWlPGOKFuJSoJZPW8a8IA: checks
*** FLOP *** [7s Ac 8d]
lcQ7uuLf+WLGGy4Ve6VKKA: checks
YmWlPGOKFuJSoJZPW8a8IA: checks
*** TURN *** [7s Ac 8d] [4h]
lcQ7uuLf+WLGGy4Ve6VKKA: checks
YmWlPGOKFuJSoJZPW8a8IA: checks
*** RIVER *** [7s Ac 8d 4h] [4s]
lcQ7uuLf+WLGGy4Ve6VKKA: checks
YmWlPGOKFuJSoJZPW8a8IA: bets $1
lcQ7uuLf+WLGGy4Ve6VKKA: folds
YmWlPGOKFuJSoJZPW8a8IA collected $0.95 from pot
YmWlPGOKFuJSoJZPW8a8IA: doesn't show hand
*** SUMMARY ***
Total pot $1 | Rake $0.05
Board [7s Ac 8d 4h 4s]
Seat 1: crjGpJEzSZgD38FoE3VMGg folded before Flop (didn't bet)
Seat 2: 2dIa62hMcn6g73rbkt9NwA folded before Flop (didn't bet)
Seat 3: I+pG2m/dD5iYdbg9qx572g folded before Flop (didn't bet)
Seat 4: 7Fue572p4ZIC85AJMQvaQw (button) folded before Flop (didn't bet)
Seat 5: lcQ7uuLf+WLGGy4Ve6VKKA (small blind) folded on the River
Seat 6: YmWlPGOKFuJSoJZPW8a8IA (big blind) collected ($0.95)



PokerStars Game #59937852796:  Hold'em No Limit ($0.25/$0.50) - 2009/07/01 0:01:22 ET
Table 'raOT4/ipuZgzjfKHC+jD9g' 2-max Seat #1 is the button
Seat 1: IuwLemwLhc9fvrwBGs0AMA ($10 in chips)
Seat 2: Udr5juWSWUgTu1NlRhjMdA ($14.60 in chips)
IuwLemwLhc9fvrwBGs0AMA: posts small blind $0.25
Udr5juWSWUgTu1NlRhjMdA: posts big blind $0.50
*** HOLE CARDS ***
IuwLemwLhc9fvrwBGs0AMA: raises $0.50 to $1
Udr5juWSWUgTu1NlRhjMdA: calls $0.50
*** FLOP *** [Ad 8c 5d]
Udr5juWSWUgTu1NlRhjMdA: checks
IuwLemwLhc9fvrwBGs0AMA: bets $1
Udr5juWSWUgTu1NlRhjMdA: folds
IuwLemwLhc9fvrwBGs0AMA collected $1.90 from pot
*** SUMMARY ***
Total pot $2 | Rake $0.10
Board [Ad 8c 5d]
Seat 1: IuwLemwLhc9fvrwBGs0AMA (button) (small blind) collected ($1.90)
Seat 2: Udr5juWSWUgTu1NlRhjMdA (big blind) folded on the Flop



PokerStars Game #59937853894:  Hold'em No Limit ($0.25/$0.50) - 2009/07/01 0:01:23 ET
Table 'c/CRn+68J3Y8KxD5g1ek2Q' 2-max Seat #2 is the button
Seat 1: 46qCyJ6evTkHo9al5sBMNA ($326.15 in chips)
Seat 2: BypVLsYQt3ePFm2xQL/dOA ($63.10 in chips)
BypVLsYQt3ePFm2xQL/dOA: posts small blind $0.25
46qCyJ6evTkHo9al5sBMNA: posts big blind $0.50
*** HOLE CARDS ***
BypVLsYQt3ePFm2xQL/dOA: raises $0.50 to $1
46qCyJ6evTkHo9al5sBMNA: calls $0.50
*** FLOP *** [7d Js Qc]
46qCyJ6evTkHo9al5sBMNA: checks
BypVLsYQt3ePFm2xQL/dOA: checks
*** TURN *** [7d Js Qc] [9h]
46qCyJ6evTkHo9al5sBMNA: bets $2
BypVLsYQt3ePFm2xQL/dOA: raises $5.50 to $7.50
46qCyJ6evTkHo9al5sBMNA: calls $5.50
*** RIVER *** [7d Js Qc 9h] [6c]
46qCyJ6evTkHo9al5sBMNA: checks
BypVLsYQt3ePFm2xQL/dOA: bets $16.50
46qCyJ6evTkHo9al5sBMNA: folds
BypVLsYQt3ePFm2xQL/dOA collected $16.50 from pot
BypVLsYQt3ePFm2xQL/dOA: doesn't show hand
*** SUMMARY ***
Total pot $17 | Rake $0.50
Board [7d Js Qc 9h 6c]
Seat 1: 46qCyJ6evTkHo9al5sBMNA (big blind) folded on the River
Seat 2: BypVLsYQt3ePFm2xQL/dOA (button) (small blind) collected ($16.50)



PokerStars Game #59937855298:  Hold'em No Limit ($0.25/$0.50) - 2009/07/01 0:01:25 ET
Table 'SsXEKOwKN+jE3etfusqUqA' 2-max Seat #2 is the button
Seat 1: 618rKeLrz/avGNOLULHHVQ ($137.80 in chips)
Seat 2: XfRhywXA6Br+jID1oGeo8A ($59.30 in chips)
XfRhywXA6Br+jID1oGeo8A: posts small blind $0.25
618rKeLrz/avGNOLULHHVQ: posts big blind $0.50
*** HOLE CARDS ***
XfRhywXA6Br+jID1oGeo8A: folds
618rKeLrz/avGNOLULHHVQ collected $0.50 from pot
618rKeLrz/avGNOLULHHVQ: doesn't show hand
*** SUMMARY ***
Total pot $0.50 | Rake $0
Seat 1: 618rKeLrz/avGNOLULHHVQ (big blind) collected ($0.50)
Seat 2: XfRhywXA6Br+jID1oGeo8A (button) (small blind) folded before Flop



PokerStars Game #59937856248:  Hold'em No Limit ($0.25/$0.50) - 2009/07/01 0:01:26 ET
Table 'X6IRCRTh+20gjz8aubWnwA' 9-max Seat #3 is the button
Seat 1: YPo1oggovmqSREegekaQYw ($10.70 in chips)
Seat 2: RjBdQ6w31rgcy0o24VLR6w ($11.45 in chips)
Seat 3: mSD1pginDsyHG5PDfqzphw ($10 in chips)
Seat 4: uw9QayAAxLM3Hb+HR7mSkg ($9.50 in chips)
Seat 5: aT3lRsb9BkkYp2fkD3LEtQ ($81.65 in chips)
Seat 7: VBnpbzn0dIveV55qKvciew ($68.20 in chips)
Seat 8: BPMN9sOItJw6vWq3kypaYg ($23 in chips)
Seat 9: M+7+BTmX5vZatHVuoRB1nA ($84.10 in chips)
uw9QayAAxLM3Hb+HR7mSkg: posts small blind $0.25
aT3lRsb9BkkYp2fkD3LEtQ: posts big blind $0.50
/6In1zC3WtgwxDcueWzZWg: sits out
*** HOLE CARDS ***
VBnpbzn0dIveV55qKvciew: folds
BPMN9sOItJw6vWq3kypaYg: folds
M+7+BTmX5vZatHVuoRB1nA: raises $1 to $1.50
YPo1oggovmqSREegekaQYw: folds
RjBdQ6w31rgcy0o24VLR6w: folds
mSD1pginDsyHG5PDfqzphw: folds
uw9QayAAxLM3Hb+HR7mSkg: folds
aT3lRsb9BkkYp2fkD3LEtQ: folds
M+7+BTmX5vZatHVuoRB1nA collected $1.25 from pot
M+7+BTmX5vZatHVuoRB1nA: doesn't show hand
*** SUMMARY ***
Total pot $1.25 | Rake $0
Seat 1: YPo1oggovmqSREegekaQYw folded before Flop (didn't bet)
Seat 2: RjBdQ6w31rgcy0o24VLR6w folded before Flop (didn't bet)
Seat 3: mSD1pginDsyHG5PDfqzphw (button) folded before Flop (didn't bet)
Seat 4: uw9QayAAxLM3Hb+HR7mSkg (small blind) folded before Flop
Seat 5: aT3lRsb9BkkYp2fkD3LEtQ (big blind) folded before Flop
Seat 7: VBnpbzn0dIveV55qKvciew folded before Flop (didn't bet)
Seat 8: BPMN9sOItJw6vWq3kypaYg folded before Flop (didn't bet)
Seat 9: M+7+BTmX5vZatHVuoRB1nA collected ($1.25)



PokerStars Game #59937856600:  Hold'em No Limit ($0.25/$0.50) - 2009/07/01 0:01:27 ET
Table 'QOgaEqMcJ73pcUMMxoisUgErOuyGLI5PT3G5MnpHgC/g Seat #5 is the button
Seat 1: k6GJzKs7T7qvQggW9g8Pdw ($50.75 in chips)
Seat 2: RjBdQ6w31rgcy0o24VLR6w ($8.75 in chips)
Seat 3: xZCXQSXlrZkp3pZizzVXCw ($49 in chips)
Seat 4: U7aZzIYWjv3SL30KtikLbw ($48.75 in chips)
Seat 5: JwvquocWfhTVApN5t47LgA ($51.05 in chips)
Seat 6: zE9cVigS2nW/Ljy4K4bUQA ($31.60 in chips)
Seat 7: 90Wb75h3W1BRpbqVnuk8gw ($50 in chips)
Seat 8: ajP1NjIMdqQfpMbzHzvejw ($52.80 in chips)
Seat 9: J0W5D97jl5VLky+IoPvDeA ($68.55 in chips)
zE9cVigS2nW/Ljy4K4bUQA: posts small blind $0.25
90Wb75h3W1BRpbqVnuk8gw: posts big blind $0.50
U7aZzIYWjv3SL30KtikLbw: posts big blind $0.50
*** HOLE CARDS ***
ajP1NjIMdqQfpMbzHzvejw: folds
J0W5D97jl5VLky+IoPvDeA: folds
k6GJzKs7T7qvQggW9g8Pdw: folds
RjBdQ6w31rgcy0o24VLR6w: folds
xZCXQSXlrZkp3pZizzVXCw: folds
U7aZzIYWjv3SL30KtikLbw: checks
JwvquocWfhTVApN5t47LgA: folds
zE9cVigS2nW/Ljy4K4bUQA: folds
90Wb75h3W1BRpbqVnuk8gw: checks
*** FLOP *** [5s Kh Ts]
90Wb75h3W1BRpbqVnuk8gw: checks
U7aZzIYWjv3SL30KtikLbw: bets $1
90Wb75h3W1BRpbqVnuk8gw: folds
U7aZzIYWjv3SL30KtikLbw collected $1.20 from pot
*** SUMMARY ***
Total pot $1.25 | Rake $0.05
Board [5s Kh Ts]
Seat 1: k6GJzKs7T7qvQggW9g8Pdw folded before Flop (didn't bet)
Seat 2: RjBdQ6w31rgcy0o24VLR6w folded before Flop (didn't bet)
Seat 3: xZCXQSXlrZkp3pZizzVXCw folded before Flop (didn't bet)
Seat 4: U7aZzIYWjv3SL30KtikLbw collected ($1.20)
Seat 5: JwvquocWfhTVApN5t47LgA (button) folded before Flop (didn't bet)
Seat 6: zE9cVigS2nW/Ljy4K4bUQA (small blind) folded before Flop
Seat 7: 90Wb75h3W1BRpbqVnuk8gw (big blind) folded on the Flop
Seat 8: ajP1NjIMdqQfpMbzHzvejw folded before Flop (didn't bet)
Seat 9: J0W5D97jl5VLky+IoPvDeA folded before Flop (didn't bet)



PokerStars Game #59937857674:  Hold'em No Limit ($0.25/$0.50) - 2009/07/01 0:01:28 ET
Table 'EiNh8p/wGJ1FP575iMFnqg' 9-max Seat #8 is the button
Seat 1: r3ZqM1Mi0W3y4hOdssE+Sg ($42.35 in chips)
Seat 2: avsQkZXsRKnWa7gkjVNvog ($27.70 in chips)
Seat 3: GszS/McxOSUnOET7MBoHqA ($57.50 in chips)
Seat 4: pk8aA8qMBEL6zXqSyfVXMA ($80.80 in chips)
Seat 5: M+7+BTmX5vZatHVuoRB1nA ($93.50 in chips)
Seat 6: YPo1oggovmqSREegekaQYw ($14.75 in chips)
Seat 7: Wj7mKnRFR90j40wWUu2+Og ($25.95 in chips)
Seat 8: C7LqTSTGrMSBCecHvwQAOQ ($55.30 in chips)
Seat 9: OMwFJ4pF0xk2Ru/AJiFeFw ($73.65 in chips)
OMwFJ4pF0xk2Ru/AJiFeFw: posts small blind $0.25
r3ZqM1Mi0W3y4hOdssE+Sg: posts big blind $0.50
*** HOLE CARDS ***
avsQkZXsRKnWa7gkjVNvog: folds
GszS/McxOSUnOET7MBoHqA: folds
pk8aA8qMBEL6zXqSyfVXMA: folds
M+7+BTmX5vZatHVuoRB1nA: folds
YPo1oggovmqSREegekaQYw: folds
Wj7mKnRFR90j40wWUu2+Og: raises $1 to $1.50
C7LqTSTGrMSBCecHvwQAOQ: folds
OMwFJ4pF0xk2Ru/AJiFeFw: folds
r3ZqM1Mi0W3y4hOdssE+Sg: folds
Wj7mKnRFR90j40wWUu2+Og collected $1.25 from pot
Wj7mKnRFR90j40wWUu2+Og: doesn't show hand
*** SUMMARY ***
Total pot $1.25 | Rake $0
Seat 1: r3ZqM1Mi0W3y4hOdssE+Sg (big blind) folded before Flop
Seat 2: avsQkZXsRKnWa7gkjVNvog folded before Flop (didn't bet)
Seat 3: GszS/McxOSUnOET7MBoHqA folded before Flop (didn't bet)
Seat 4: pk8aA8qMBEL6zXqSyfVXMA folded before Flop (didn't bet)
Seat 5: M+7+BTmX5vZatHVuoRB1nA folded before Flop (didn't bet)
Seat 6: YPo1oggovmqSREegekaQYw folded before Flop (didn't bet)
Seat 7: Wj7mKnRFR90j40wWUu2+Og collected ($1.25)
Seat 8: C7LqTSTGrMSBCecHvwQAOQ (button) folded before Flop (didn't bet)
Seat 9: OMwFJ4pF0xk2Ru/AJiFeFw (small blind) folded before Flop



PokerStars Game #59937857478:  Hold'em No Limit ($0.25/$0.50) - 2009/07/01 0:01:28 ET
Table 'MJxeZCzYELxiIsyUZyT0jw' 6-max Seat #3 is the button
Seat 1: iKPos8JI094Tomq4tDSgnQ ($21.25 in chips)
Seat 2: r6H1GiZ6QIpMTDhyodKuRQ ($66.40 in chips)
Seat 3: JQZew0FjzS19kTjeNtrE+A ($56.90 in chips)
Seat 4: lP7Q6pewz4C2RsAfKsjdWw ($24.90 in chips)
Seat 6: TTx3CHxyi0SObcHyMJRp5w ($42.45 in chips)
lP7Q6pewz4C2RsAfKsjdWw: posts small blind $0.25
VO2eih4OVj7FCQGPfUoW8A: is sitting out
TTx3CHxyi0SObcHyMJRp5w: posts big blind $0.50
*** HOLE CARDS ***
VO2eih4OVj7FCQGPfUoW8A leaves the table
iKPos8JI094Tomq4tDSgnQ: folds
r6H1GiZ6QIpMTDhyodKuRQ: raises $1.50 to $2
JQZew0FjzS19kTjeNtrE+A: folds
lP7Q6pewz4C2RsAfKsjdWw: folds
TTx3CHxyi0SObcHyMJRp5w: folds
r6H1GiZ6QIpMTDhyodKuRQ collected $1.25 from pot
*** SUMMARY ***
Total pot $1.25 | Rake $0
Seat 1: iKPos8JI094Tomq4tDSgnQ folded before Flop (didn't bet)
Seat 2: r6H1GiZ6QIpMTDhyodKuRQ collected ($1.25)
Seat 3: JQZew0FjzS19kTjeNtrE+A (button) folded before Flop (didn't bet)
Seat 4: lP7Q6pewz4C2RsAfKsjdWw (small blind) folded before Flop
Seat 6: TTx3CHxyi0SObcHyMJRp5w (big blind) folded before Flop



PokerStars Game #59937857282:  Hold'em No Limit ($0.25/$0.50) - 2009/07/01 0:01:28 ET
Table 'Vdlc9wqYcHTUhtdyN7CuJw' 2-max Seat #1 is the button
Seat 1: yBO+mXB6m/rCft2ErwGf/Q ($63.45 in chips)
Seat 2: sa0qgETiL3HNbdfGlnKHTA ($51.70 in chips)
yBO+mXB6m/rCft2ErwGf/Q: posts small blind $0.25
sa0qgETiL3HNbdfGlnKHTA: posts big blind $0.50
*** HOLE CARDS ***
yBO+mXB6m/rCft2ErwGf/Q: calls $0.25
sa0qgETiL3HNbdfGlnKHTA: checks
*** FLOP *** [5h 7s Qd]
sa0qgETiL3HNbdfGlnKHTA: checks
yBO+mXB6m/rCft2ErwGf/Q: checks
*** TURN *** [5h 7s Qd] [Ah]
sa0qgETiL3HNbdfGlnKHTA: checks
yBO+mXB6m/rCft2ErwGf/Q: checks
*** RIVER *** [5h 7s Qd Ah] [6c]
sa0qgETiL3HNbdfGlnKHTA: checks
yBO+mXB6m/rCft2ErwGf/Q: checks
*** SHOW DOWN ***
sa0qgETiL3HNbdfGlnKHTA: shows [2c Th] (high card Ace)
yBO+mXB6m/rCft2ErwGf/Q: shows [Jc 5c] (a pair of Fives)
yBO+mXB6m/rCft2ErwGf/Q collected $0.95 from pot
*** SUMMARY ***
Total pot $1 | Rake $0.05
Board [5h 7s Qd Ah 6c]
Seat 1: yBO+mXB6m/rCft2ErwGf/Q (button) (small blind) showed [Jc 5c] and won ($0.95) with a pair of Fives
Seat 2: sa0qgETiL3HNbdfGlnKHTA (big blind) showed [2c Th] and lost with high card Ace



PokerStars Game #59937858642:  Hold'em No Limit ($0.25/$0.50) - 2009/07/01 0:01:30 ET
Table 'E7bWJ45aoFXRpyRv2gw+Ig' 2-max Seat #1 is the button
Seat 1: FRkiRasEGlHUeLrEl+k/nA ($51.40 in chips)
Seat 2: 3Wro85I7472vJ4Wkpneo9A ($75.10 in chips)
FRkiRasEGlHUeLrEl+k/nA: posts small blind $0.25
3Wro85I7472vJ4Wkpneo9A: posts big blind $0.50
*** HOLE CARDS ***
FRkiRasEGlHUeLrEl+k/nA: folds
3Wro85I7472vJ4Wkpneo9A collected $0.50 from pot
3Wro85I7472vJ4Wkpneo9A: doesn't show hand
*** SUMMARY ***
Total pot $0.50 | Rake $0
Seat 1: FRkiRasEGlHUeLrEl+k/nA (button) (small blind) folded before Flop
Seat 2: 3Wro85I7472vJ4Wkpneo9A (big blind) collected ($0.50)



PokerStars Game #59937858598:  Hold'em No Limit ($0.25/$0.50) - 2009/07/01 0:01:30 ET
Table 'ibNfFy0bCzuBaUORla0aGw' 9-max Seat #3 is the button
Seat 1: xZCXQSXlrZkp3pZizzVXCw ($60.95 in chips)
Seat 2: 90Wb75h3W1BRpbqVnuk8gw ($50 in chips)
Seat 3: dDaHs3X8+fe3bIkRU0cbrw ($23.70 in chips)
Seat 4: YBN054X4blmis+B2bBlC0g ($22.45 in chips)
Seat 5: FRv75HO8CUsRZ1byEz06mQ ($14 in chips)
Seat 6: BmYrv3ec2k5d6pQq6iNaZw ($67 in chips)
Seat 7: mSD1pginDsyHG5PDfqzphw ($10 in chips)
Seat 8: xUrN9TWLq4m5V+OXY7KUUA ($50.50 in chips)
Seat 9: WpvT3OUSiZlpvs+mPXFqtQ ($8 in chips)
YBN054X4blmis+B2bBlC0g: posts small blind $0.25
FRv75HO8CUsRZ1byEz06mQ: posts big blind $0.50
*** HOLE CARDS ***
BmYrv3ec2k5d6pQq6iNaZw: folds
mSD1pginDsyHG5PDfqzphw: folds
xUrN9TWLq4m5V+OXY7KUUA: folds
WpvT3OUSiZlpvs+mPXFqtQ: folds
xZCXQSXlrZkp3pZizzVXCw: folds
90Wb75h3W1BRpbqVnuk8gw: folds
dDaHs3X8+fe3bIkRU0cbrw: raises $1 to $1.50
YBN054X4blmis+B2bBlC0g: folds
FRv75HO8CUsRZ1byEz06mQ: calls $1
*** FLOP *** [8s 3h Kd]
FRv75HO8CUsRZ1byEz06mQ: bets $3
dDaHs3X8+fe3bIkRU0cbrw: folds
FRv75HO8CUsRZ1byEz06mQ collected $3.10 from pot
*** SUMMARY ***
Total pot $3.25 | Rake $0.15
Board [8s 3h Kd]
Seat 1: xZCXQSXlrZkp3pZizzVXCw folded before Flop (didn't bet)
Seat 2: 90Wb75h3W1BRpbqVnuk8gw folded before Flop (didn't bet)
Seat 3: dDaHs3X8+fe3bIkRU0cbrw (button) folded on the Flop
Seat 4: YBN054X4blmis+B2bBlC0g (small blind) folded before Flop
Seat 5: FRv75HO8CUsRZ1byEz06mQ (big blind) collected ($3.10)
Seat 6: BmYrv3ec2k5d6pQq6iNaZw folded before Flop (didn't bet)
Seat 7: mSD1pginDsyHG5PDfqzphw folded before Flop (didn't bet)
Seat 8: xUrN9TWLq4m5V+OXY7KUUA folded before Flop (didn't bet)
Seat 9: WpvT3OUSiZlpvs+mPXFqtQ folded before Flop (didn't bet)



PokerStars Game #59937859480:  Hold'em No Limit ($0.25/$0.50) - 2009/07/01 0:01:31 ET
Table 'SsXEKOwKN+jE3etfusqUqA' 2-max Seat #1 is the button
Seat 1: 618rKeLrz/avGNOLULHHVQ ($138.05 in chips)
Seat 2: XfRhywXA6Br+jID1oGeo8A ($59.05 in chips)
618rKeLrz/avGNOLULHHVQ: posts small blind $0.25
XfRhywXA6Br+jID1oGeo8A: posts big blind $0.50
*** HOLE CARDS ***
618rKeLrz/avGNOLULHHVQ: raises $1 to $1.50
XfRhywXA6Br+jID1oGeo8A: calls $1
*** FLOP *** [6d 9h 3c]
XfRhywXA6Br+jID1oGeo8A: checks
618rKeLrz/avGNOLULHHVQ: bets $2.50
XfRhywXA6Br+jID1oGeo8A: calls $2.50
*** TURN *** [6d 9h 3c] [Kc]
XfRhywXA6Br+jID1oGeo8A: checks
618rKeLrz/avGNOLULHHVQ: bets $7.50
XfRhywXA6Br+jID1oGeo8A: raises $47.55 to $55.05 and is all-in
618rKeLrz/avGNOLULHHVQ: calls $47.55
*** RIVER *** [6d 9h 3c Kc] [9d]
*** SHOW DOWN ***
XfRhywXA6Br+jID1oGeo8A: shows [9c Ks] (a full house, Nines full of Kings)
618rKeLrz/avGNOLULHHVQ: mucks hand
XfRhywXA6Br+jID1oGeo8A collected $117.60 from pot
*** SUMMARY ***
Total pot $118.10 | Rake $0.50
Board [6d 9h 3c Kc 9d]
Seat 1: 618rKeLrz/avGNOLULHHVQ (button) (small blind) mucked
Seat 2: XfRhywXA6Br+jID1oGeo8A (big blind) showed [9c Ks] and won ($117.60) with a full house, Nines full of Kings



PokerStars Game #59937862136:  Hold'em No Limit ($0.25/$0.50) - 2009/07/01 0:01:34 ET
Table 'mTxf8gPLgffN3Iwfm7Icfg' 2-max Seat #2 is the button
Seat 1: Do9Rlu1R5u/AcRtMTl8SYg ($62.70 in chips)
Seat 2: EMc5LPgVaded4Qc77vm0fw ($53.40 in chips)
EMc5LPgVaded4Qc77vm0fw: posts small blind $0.25
Do9Rlu1R5u/AcRtMTl8SYg: posts big blind $0.50
*** HOLE CARDS ***
EMc5LPgVaded4Qc77vm0fw: folds
Do9Rlu1R5u/AcRtMTl8SYg collected $0.50 from pot
*** SUMMARY ***
Total pot $0.50 | Rake $0
Seat 1: Do9Rlu1R5u/AcRtMTl8SYg (big blind) collected ($0.50)
Seat 2: EMc5LPgVaded4Qc77vm0fw (button) (small blind) folded before Flop



PokerStars Game #59937862970:  Hold'em No Limit ($0.25/$0.50) - 2009/07/01 0:01:36 ET
Table 'lSisgp6H7Fg1hH5VfjEjYQ' 9-max Seat #7 is the button
Seat 1: pEW8B6uXbdR47kfljMQ3+Q ($38.55 in chips)
Seat 2: UrcnkQOiLVk8BlKDPJSy7Q ($53.10 in chips)
Seat 3: RjBdQ6w31rgcy0o24VLR6w ($10.45 in chips)
Seat 4: nvw9yQKhJT56lA9k+TLdhw ($14.40 in chips)
Seat 5: mSD1pginDsyHG5PDfqzphw ($12.35 in chips)
Seat 7: xyQ4CeZa3ug3ompz+5xSTg ($74.70 in chips)
Seat 9: 5JJVDlaiMnB004o/RqbZZQ ($28.75 in chips)
conman0814 will be allowed to play after the button
conman0814 was removed from the table for failing to post
5JJVDlaiMnB004o/RqbZZQ: posts small blind $0.25
pEW8B6uXbdR47kfljMQ3+Q: posts big blind $0.50
*** HOLE CARDS ***
UrcnkQOiLVk8BlKDPJSy7Q: folds
+k7T5ocke8UwavtgUHm+Cg has returned
RjBdQ6w31rgcy0o24VLR6w: folds
nvw9yQKhJT56lA9k+TLdhw: folds
mSD1pginDsyHG5PDfqzphw: folds
xyQ4CeZa3ug3ompz+5xSTg: folds
bXpVeaSTPBFSPJmeXxO7nw joins the table at seat #8
5JJVDlaiMnB004o/RqbZZQ: folds
pEW8B6uXbdR47kfljMQ3+Q collected $0.50 from pot
pEW8B6uXbdR47kfljMQ3+Q: doesn't show hand
*** SUMMARY ***
Total pot $0.50 | Rake $0
Seat 1: pEW8B6uXbdR47kfljMQ3+Q (big blind) collected ($0.50)
Seat 2: UrcnkQOiLVk8BlKDPJSy7Q folded before Flop (didn't bet)
Seat 3: RjBdQ6w31rgcy0o24VLR6w folded before Flop (didn't bet)
Seat 4: nvw9yQKhJT56lA9k+TLdhw folded before Flop (didn't bet)
Seat 5: mSD1pginDsyHG5PDfqzphw folded before Flop (didn't bet)
Seat 7: xyQ4CeZa3ug3ompz+5xSTg (button) folded before Flop (didn't bet)
Seat 9: 5JJVDlaiMnB004o/RqbZZQ (small blind) folded before Flop



PokerStars Game #59937864206:  Hold'em No Limit ($0.25/$0.50) - 2009/07/01 0:01:37 ET
Table '5EmHi+fnatGQQShcNmzOZQ' 6-max Seat #1 is the button
Seat 1: SwPczQo3cOtwEzhJrfO2cQ ($17 in chips)
Seat 3: J8dF2sYMvXUmAGUuSW9kwg ($39.35 in chips)
Seat 4: mFTuMjESuBcXHQ1ePkg/8A ($22.80 in chips)
Seat 5: kxPhs4ePFqMy52CInAJ2aw ($73.80 in chips)
Seat 6: 686aeHikcJlgKkSuIFdcXQ ($112.30 in chips)
J8dF2sYMvXUmAGUuSW9kwg: posts small blind $0.25
mFTuMjESuBcXHQ1ePkg/8A: posts big blind $0.50
*** HOLE CARDS ***
kxPhs4ePFqMy52CInAJ2aw: folds
686aeHikcJlgKkSuIFdcXQ: folds
SwPczQo3cOtwEzhJrfO2cQ: calls $0.50
J8dF2sYMvXUmAGUuSW9kwg: calls $0.25
mFTuMjESuBcXHQ1ePkg/8A: checks
*** FLOP *** [Kc 3s 3h]
J8dF2sYMvXUmAGUuSW9kwg: checks
mFTuMjESuBcXHQ1ePkg/8A: checks
SwPczQo3cOtwEzhJrfO2cQ: checks
*** TURN *** [Kc 3s 3h] [5h]
J8dF2sYMvXUmAGUuSW9kwg: checks
mFTuMjESuBcXHQ1ePkg/8A: checks
SwPczQo3cOtwEzhJrfO2cQ: checks
*** RIVER *** [Kc 3s 3h 5h] [Kd]
J8dF2sYMvXUmAGUuSW9kwg: checks
mFTuMjESuBcXHQ1ePkg/8A: bets $0.50
SwPczQo3cOtwEzhJrfO2cQ: raises $1 to $1.50
J8dF2sYMvXUmAGUuSW9kwg: folds
mFTuMjESuBcXHQ1ePkg/8A: folds
SwPczQo3cOtwEzhJrfO2cQ collected $2.40 from pot
*** SUMMARY ***
Total pot $2.50 | Rake $0.10
Board [Kc 3s 3h 5h Kd]
Seat 1: SwPczQo3cOtwEzhJrfO2cQ (button) collected ($2.40)
Seat 3: J8dF2sYMvXUmAGUuSW9kwg (small blind) folded on the River
Seat 4: mFTuMjESuBcXHQ1ePkg/8A (big blind) folded on the River
Seat 5: kxPhs4ePFqMy52CInAJ2aw folded before Flop (didn't bet)
Seat 6: 686aeHikcJlgKkSuIFdcXQ folded before Flop (didn't bet)



PokerStars Game #59937864340:  Hold'em No Limit ($0.25/$0.50) - 2009/07/01 0:01:38 ET
Table 'QOgaEqMcJ73pcUMMxoisUg' 6-max Seat #2 is the button
Seat 1: RFefXIDyFvNtJLq+CloCzA ($44.70 in chips)
Seat 2: qsObMEIlRO22OlS867m/lw ($15.60 in chips)
Seat 3: wUZNozoIDYf+16hp4nn6dw ($22.15 in chips)
Seat 4: L5e2lrPLQm1Pqx30IIZ/Fw ($10 in chips)
Seat 5: HoaSQCRso+nEyO5DUhGduw ($71.60 in chips)
Seat 6: s83dnhZ6VC53vY0/f6OV/g ($40.65 in chips)
wUZNozoIDYf+16hp4nn6dw: posts small blind $0.25
L5e2lrPLQm1Pqx30IIZ/Fw: posts big blind $0.50
*** HOLE CARDS ***
HoaSQCRso+nEyO5DUhGduw: raises $1 to $1.50
s83dnhZ6VC53vY0/f6OV/g: folds
RFefXIDyFvNtJLq+CloCzA: folds
qsObMEIlRO22OlS867m/lw: folds
wUZNozoIDYf+16hp4nn6dw: folds
L5e2lrPLQm1Pqx30IIZ/Fw: folds
HoaSQCRso+nEyO5DUhGduw collected $1.25 from pot
*** SUMMARY ***
Total pot $1.25 | Rake $0
Seat 1: RFefXIDyFvNtJLq+CloCzA folded before Flop (didn't bet)
Seat 2: qsObMEIlRO22OlS867m/lw (button) folded before Flop (didn't bet)
Seat 3: wUZNozoIDYf+16hp4nn6dw (small blind) folded before Flop
Seat 4: L5e2lrPLQm1Pqx30IIZ/Fw (big blind) folded before Flop
Seat 5: HoaSQCRso+nEyO5DUhGduw collected ($1.25)
Seat 6: s83dnhZ6VC53vY0/f6OV/g folded before Flop (didn't bet)



PokerStars Game #59937864524:  Hold'em No Limit ($0.25/$0.50) - 2009/07/01 0:01:38 ET
Table 'E7bWJ45aoFXRpyRv2gw+Ig' 2-max Seat #2 is the button
Seat 1: FRkiRasEGlHUeLrEl+k/nA ($51.15 in chips)
Seat 2: 3Wro85I7472vJ4Wkpneo9A ($75.35 in chips)
3Wro85I7472vJ4Wkpneo9A: posts small blind $0.25
FRkiRasEGlHUeLrEl+k/nA: posts big blind $0.50
*** HOLE CARDS ***
3Wro85I7472vJ4Wkpneo9A: raises $1 to $1.50
FRkiRasEGlHUeLrEl+k/nA: folds
3Wro85I7472vJ4Wkpneo9A collected $1 from pot
3Wro85I7472vJ4Wkpneo9A: doesn't show hand
*** SUMMARY ***
Total pot $1 | Rake $0
Seat 1: FRkiRasEGlHUeLrEl+k/nA (big blind) folded before Flop
Seat 2: 3Wro85I7472vJ4Wkpneo9A (button) (small blind) collected ($1)



PokerStars Game #59937866386:  Hold'em No Limit ($0.25/$0.50) - 2009/07/01 0:01:40 ET
Table 'mTxf8gPLgffN3Iwfm7Icfg' 2-max Seat #1 is the button
Seat 1: Do9Rlu1R5u/AcRtMTl8SYg ($62.95 in chips)
Seat 2: EMc5LPgVaded4Qc77vm0fw ($53.15 in chips)
Do9Rlu1R5u/AcRtMTl8SYg: posts small blind $0.25
EMc5LPgVaded4Qc77vm0fw: posts big blind $0.50
*** HOLE CARDS ***
Do9Rlu1R5u/AcRtMTl8SYg: folds
EMc5LPgVaded4Qc77vm0fw collected $0.50 from pot
EMc5LPgVaded4Qc77vm0fw: doesn't show hand
*** SUMMARY ***
Total pot $0.50 | Rake $0
Seat 1: Do9Rlu1R5u/AcRtMTl8SYg (button) (small blind) folded before Flop
Seat 2: EMc5LPgVaded4Qc77vm0fw (big blind) collected ($0.50)



PokerStars Game #59937866064:  Hold'em No Limit ($0.25/$0.50) - 2009/07/01 0:01:40 ET
Table 'raOT4/ipuZgzjfKHC+jD9g' 2-max Seat #2 is the button
Seat 1: IuwLemwLhc9fvrwBGs0AMA ($10.90 in chips)
Seat 2: Udr5juWSWUgTu1NlRhjMdA ($13.60 in chips)
Udr5juWSWUgTu1NlRhjMdA: posts small blind $0.25
IuwLemwLhc9fvrwBGs0AMA: posts big blind $0.50
*** HOLE CARDS ***
Udr5juWSWUgTu1NlRhjMdA: raises $0.50 to $1
IuwLemwLhc9fvrwBGs0AMA: calls $0.50
*** FLOP *** [4h Jh Tc]
IuwLemwLhc9fvrwBGs0AMA: checks
Udr5juWSWUgTu1NlRhjMdA: bets $1
IuwLemwLhc9fvrwBGs0AMA: folds
Udr5juWSWUgTu1NlRhjMdA collected $1.90 from pot
Udr5juWSWUgTu1NlRhjMdA: doesn't show hand
*** SUMMARY ***
Total pot $2 | Rake $0.10
Board [4h Jh Tc]
Seat 1: IuwLemwLhc9fvrwBGs0AMA (big blind) folded on the Flop
Seat 2: Udr5juWSWUgTu1NlRhjMdA (button) (small blind) collected ($1.90)



PokerStars Game #59937869438:  Hold'em No Limit ($0.25/$0.50) - 2009/07/01 0:01:45 ET
Table '+dXkOAQyS8j9PQZusUTMpg' 2-max Seat #2 is the button
Seat 1: XFa6sBGjP2gxoIvxR3fZIg ($71.20 in chips)
Seat 2: 5IBeOgaApY1Bvzv2P8X4EA ($31.90 in chips)
5IBeOgaApY1Bvzv2P8X4EA: posts small blind $0.25
XFa6sBGjP2gxoIvxR3fZIg: posts big blind $0.50
*** HOLE CARDS ***
5IBeOgaApY1Bvzv2P8X4EA: calls $0.25
XFa6sBGjP2gxoIvxR3fZIg: raises $2 to $2.50
5IBeOgaApY1Bvzv2P8X4EA: raises $11 to $13.50
XFa6sBGjP2gxoIvxR3fZIg: folds
5IBeOgaApY1Bvzv2P8X4EA collected $5 from pot
5IBeOgaApY1Bvzv2P8X4EA: doesn't show hand
*** SUMMARY ***
Total pot $5 | Rake $0
Seat 1: XFa6sBGjP2gxoIvxR3fZIg (big blind) folded before Flop
Seat 2: 5IBeOgaApY1Bvzv2P8X4EA (button) (small blind) collected ($5)



PokerStars Game #59937869640:  Hold'em No Limit ($0.25/$0.50) - 2009/07/01 0:01:45 ET
Table 'kgbJRsxfv64KrErDRBAkcw' 6-max Seat #6 is the button
Seat 1: YmWlPGOKFuJSoJZPW8a8IA ($82.80 in chips)
Seat 3: T0Gx/FcQ5VH9u7XaOMX97A ($61.95 in chips)
Seat 4: qanMEqjABjWxC/JgQ/0l7w ($50 in chips)
Seat 5: SlTdlH14u+KVVINgxMwt+Q ($78.70 in chips)
Seat 6: DDfYzIrYT0t5R/hAJngtsg ($25.60 in chips)
YmWlPGOKFuJSoJZPW8a8IA: posts small blind $0.25
F1u6k1bk7IyWqKsK5pFybg: is sitting out
T0Gx/FcQ5VH9u7XaOMX97A: posts big blind $0.50
*** HOLE CARDS ***
F1u6k1bk7IyWqKsK5pFybg leaves the table
qanMEqjABjWxC/JgQ/0l7w: folds
SlTdlH14u+KVVINgxMwt+Q: calls $0.50
DDfYzIrYT0t5R/hAJngtsg: calls $0.50
YmWlPGOKFuJSoJZPW8a8IA: folds
T0Gx/FcQ5VH9u7XaOMX97A: checks
*** FLOP *** [8d 5s Qh]
T0Gx/FcQ5VH9u7XaOMX97A: checks
SlTdlH14u+KVVINgxMwt+Q: bets $1
DDfYzIrYT0t5R/hAJngtsg: calls $1
T0Gx/FcQ5VH9u7XaOMX97A: folds
*** TURN *** [8d 5s Qh] [Th]
SlTdlH14u+KVVINgxMwt+Q: bets $0.50
DDfYzIrYT0t5R/hAJngtsg: calls $0.50
*** RIVER *** [8d 5s Qh Th] [Td]
SlTdlH14u+KVVINgxMwt+Q: checks
DDfYzIrYT0t5R/hAJngtsg: bets $2.50
SlTdlH14u+KVVINgxMwt+Q: folds
DDfYzIrYT0t5R/hAJngtsg collected $4.55 from pot
Q+thC23WCv1kJUJtH/+4Jw joins the table at seat #2
*** SUMMARY ***
Total pot $4.75 | Rake $0.20
Board [8d 5s Qh Th Td]
Seat 1: YmWlPGOKFuJSoJZPW8a8IA (small blind) folded before Flop
Seat 3: T0Gx/FcQ5VH9u7XaOMX97A (big blind) folded on the Flop
Seat 4: qanMEqjABjWxC/JgQ/0l7w folded before Flop (didn't bet)
Seat 5: SlTdlH14u+KVVINgxMwt+Q folded on the River
Seat 6: DDfYzIrYT0t5R/hAJngtsg (button) collected ($4.55)



PokerStars Game #59937870576:  Hold'em No Limit ($0.25/$0.50) - 2009/07/01 0:01:46 ET
Table 'iq+aXfWVQRdV0u8SRTYUEg' 9-max Seat #5 is the button
Seat 1: McPJctgiiz9IXq3OttAeOA ($13.35 in chips)
Seat 3: itOQCm2+5ujaA68I6hPvfg ($123 in chips)
Seat 4: +Z4e6ELfE9slw801LJ3vAw ($13.50 in chips)
Seat 5: MZo49KUcOZcn7g/WRL0Vqw ($44.90 in chips)
Seat 6: 8qvUviDc+VoNV1cmSHjjLw ($30.40 in chips)
Seat 7: SKnJuWHScqetA/qG5p+wCg ($30 in chips)
Seat 9: bXpVeaSTPBFSPJmeXxO7nw ($11.60 in chips)
8qvUviDc+VoNV1cmSHjjLw: posts small blind $0.25
SKnJuWHScqetA/qG5p+wCg: posts big blind $0.50
k1f0lS7tlMHCLGs0JT34Tg: sits out
*** HOLE CARDS ***
bXpVeaSTPBFSPJmeXxO7nw: folds
McPJctgiiz9IXq3OttAeOA: calls $0.50
itOQCm2+5ujaA68I6hPvfg: folds
+Z4e6ELfE9slw801LJ3vAw: folds
MZo49KUcOZcn7g/WRL0Vqw: folds
8qvUviDc+VoNV1cmSHjjLw: calls $0.25
SKnJuWHScqetA/qG5p+wCg: checks
*** FLOP *** [8s 3s 2s]
8qvUviDc+VoNV1cmSHjjLw: checks
SKnJuWHScqetA/qG5p+wCg: checks
McPJctgiiz9IXq3OttAeOA: bets $0.50
8qvUviDc+VoNV1cmSHjjLw: folds
SKnJuWHScqetA/qG5p+wCg: folds
McPJctgiiz9IXq3OttAeOA collected $1.45 from pot
McPJctgiiz9IXq3OttAeOA: doesn't show hand
*** SUMMARY ***
Total pot $1.50 | Rake $0.05
Board [8s 3s 2s]
Seat 1: McPJctgiiz9IXq3OttAeOA collected ($1.45)
Seat 3: itOQCm2+5ujaA68I6hPvfg folded before Flop (didn't bet)
Seat 4: +Z4e6ELfE9slw801LJ3vAw folded before Flop (didn't bet)
Seat 5: MZo49KUcOZcn7g/WRL0Vqw (button) folded before Flop (didn't bet)
Seat 6: 8qvUviDc+VoNV1cmSHjjLw (small blind) folded on the Flop
Seat 7: SKnJuWHScqetA/qG5p+wCg (big blind) folded on the Flop
Seat 9: bXpVeaSTPBFSPJmeXxO7nw folded before Flop (didn't bet)



PokerStars Game #59937870720:  Hold'em No Limit ($0.25/$0.50) - 2009/07/01 0:01:47 ET
Table 'E7bWJ45aoFXRpyRv2gw+Ig' 2-max Seat #1 is the button
Seat 1: FRkiRasEGlHUeLrEl+k/nA ($50.65 in chips)
Seat 2: 3Wro85I7472vJ4Wkpneo9A ($75.85 in chips)
FRkiRasEGlHUeLrEl+k/nA: posts small blind $0.25
3Wro85I7472vJ4Wkpneo9A: posts big blind $0.50
*** HOLE CARDS ***
FRkiRasEGlHUeLrEl+k/nA: folds
3Wro85I7472vJ4Wkpneo9A collected $0.50 from pot
3Wro85I7472vJ4Wkpneo9A: doesn't show hand
*** SUMMARY ***
Total pot $0.50 | Rake $0
Seat 1: FRkiRasEGlHUeLrEl+k/nA (button) (small blind) folded before Flop
Seat 2: 3Wro85I7472vJ4Wkpneo9A (big blind) collected ($0.50)



PokerStars Game #59937870994:  Hold'em No Limit ($0.25/$0.50) - 2009/07/01 0:01:47 ET
Table 'mTxf8gPLgffN3Iwfm7Icfg' 2-max Seat #2 is the button
Seat 1: Do9Rlu1R5u/AcRtMTl8SYg ($62.70 in chips)
Seat 2: EMc5LPgVaded4Qc77vm0fw ($53.40 in chips)
EMc5LPgVaded4Qc77vm0fw: posts small blind $0.25
Do9Rlu1R5u/AcRtMTl8SYg: posts big blind $0.50
*** HOLE CARDS ***
EMc5LPgVaded4Qc77vm0fw: raises $1.50 to $2
Do9Rlu1R5u/AcRtMTl8SYg: folds
EMc5LPgVaded4Qc77vm0fw collected $1 from pot
EMc5LPgVaded4Qc77vm0fw: doesn't show hand
*** SUMMARY ***
Total pot $1 | Rake $0
Seat 1: Do9Rlu1R5u/AcRtMTl8SYg (big blind) folded before Flop
Seat 2: EMc5LPgVaded4Qc77vm0fw (button) (small blind) collected ($1)



PokerStars Game #59937870846:  Hold'em No Limit ($0.25/$0.50) - 2009/07/01 0:01:47 ET
Table 'MJxeZCzYELxiIsyUZyT0jw' 6-max Seat #4 is the button
Seat 1: iKPos8JI094Tomq4tDSgnQ ($21.25 in chips)
Seat 2: r6H1GiZ6QIpMTDhyodKuRQ ($67.15 in chips)
Seat 3: JQZew0FjzS19kTjeNtrE+A ($56.90 in chips)
Seat 4: lP7Q6pewz4C2RsAfKsjdWw ($24.65 in chips)
Seat 6: TTx3CHxyi0SObcHyMJRp5w ($41.95 in chips)
TTx3CHxyi0SObcHyMJRp5w: posts small blind $0.25
iKPos8JI094Tomq4tDSgnQ: posts big blind $0.50
*** HOLE CARDS ***
r6H1GiZ6QIpMTDhyodKuRQ: calls $0.50
JQZew0FjzS19kTjeNtrE+A: calls $0.50
lP7Q6pewz4C2RsAfKsjdWw: calls $0.50
TTx3CHxyi0SObcHyMJRp5w: folds
iKPos8JI094Tomq4tDSgnQ: checks
*** FLOP *** [6d 8d Th]
iKPos8JI094Tomq4tDSgnQ: checks
r6H1GiZ6QIpMTDhyodKuRQ: checks
JQZew0FjzS19kTjeNtrE+A: checks
lP7Q6pewz4C2RsAfKsjdWw: checks
*** TURN *** [6d 8d Th] [3c]
iKPos8JI094Tomq4tDSgnQ: checks
r6H1GiZ6QIpMTDhyodKuRQ: checks
JQZew0FjzS19kTjeNtrE+A: checks
lP7Q6pewz4C2RsAfKsjdWw: bets $1.50
iKPos8JI094Tomq4tDSgnQ: folds
r6H1GiZ6QIpMTDhyodKuRQ: folds
JQZew0FjzS19kTjeNtrE+A: folds
lP7Q6pewz4C2RsAfKsjdWw collected $2.15 from pot
lP7Q6pewz4C2RsAfKsjdWw: doesn't show hand
*** SUMMARY ***
Total pot $2.25 | Rake $0.10
Board [6d 8d Th 3c]
Seat 1: iKPos8JI094Tomq4tDSgnQ (big blind) folded on the Turn
Seat 2: r6H1GiZ6QIpMTDhyodKuRQ folded on the Turn
Seat 3: JQZew0FjzS19kTjeNtrE+A folded on the Turn
Seat 4: lP7Q6pewz4C2RsAfKsjdWw (button) collected ($2.15)
Seat 6: TTx3CHxyi0SObcHyMJRp5w (small blind) folded before Flop



PokerStars Game #59937872882:  Hold'em No Limit ($0.25/$0.50) - 2009/07/01 0:01:50 ET
Table 'X6IRCRTh+20gjz8aubWnwA' 9-max Seat #4 is the button
Seat 1: YPo1oggovmqSREegekaQYw ($10.70 in chips)
Seat 2: RjBdQ6w31rgcy0o24VLR6w ($11.45 in chips)
Seat 3: mSD1pginDsyHG5PDfqzphw ($10 in chips)
Seat 4: uw9QayAAxLM3Hb+HR7mSkg ($9.25 in chips)
Seat 5: aT3lRsb9BkkYp2fkD3LEtQ ($81.15 in chips)
Seat 6: /6In1zC3WtgwxDcueWzZWg ($50 in chips)
Seat 7: VBnpbzn0dIveV55qKvciew ($68.20 in chips)
Seat 8: BPMN9sOItJw6vWq3kypaYg ($23 in chips)
Seat 9: M+7+BTmX5vZatHVuoRB1nA ($84.85 in chips)
aT3lRsb9BkkYp2fkD3LEtQ: posts small blind $0.25
/6In1zC3WtgwxDcueWzZWg: posts big blind $0.50
*** HOLE CARDS ***
VBnpbzn0dIveV55qKvciew: folds
BPMN9sOItJw6vWq3kypaYg: raises $1 to $1.50
M+7+BTmX5vZatHVuoRB1nA: folds
YPo1oggovmqSREegekaQYw: folds
RjBdQ6w31rgcy0o24VLR6w: folds
mSD1pginDsyHG5PDfqzphw: folds
uw9QayAAxLM3Hb+HR7mSkg: folds
aT3lRsb9BkkYp2fkD3LEtQ: calls $1.25
/6In1zC3WtgwxDcueWzZWg: folds
*** FLOP *** [3h Ad 4h]
aT3lRsb9BkkYp2fkD3LEtQ: checks
BPMN9sOItJw6vWq3kypaYg: bets $2
aT3lRsb9BkkYp2fkD3LEtQ: calls $2
*** TURN *** [3h Ad 4h] [7s]
aT3lRsb9BkkYp2fkD3LEtQ: checks
BPMN9sOItJw6vWq3kypaYg: bets $2
aT3lRsb9BkkYp2fkD3LEtQ: folds
BPMN9sOItJw6vWq3kypaYg collected $7.15 from pot
*** SUMMARY ***
Total pot $7.50 | Rake $0.35
Board [3h Ad 4h 7s]
Seat 1: YPo1oggovmqSREegekaQYw folded before Flop (didn't bet)
Seat 2: RjBdQ6w31rgcy0o24VLR6w folded before Flop (didn't bet)
Seat 3: mSD1pginDsyHG5PDfqzphw folded before Flop (didn't bet)
Seat 4: uw9QayAAxLM3Hb+HR7mSkg (button) folded before Flop (didn't bet)
Seat 5: aT3lRsb9BkkYp2fkD3LEtQ (small blind) folded on the Turn
Seat 6: /6In1zC3WtgwxDcueWzZWg (big blind) folded before Flop
Seat 7: VBnpbzn0dIveV55qKvciew folded before Flop (didn't bet)
Seat 8: BPMN9sOItJw6vWq3kypaYg collected ($7.15)
Seat 9: M+7+BTmX5vZatHVuoRB1nA folded before Flop (didn't bet)



PokerStars Game #59937874796:  Hold'em No Limit ($0.25/$0.50) - 2009/07/01 0:01:52 ET
Table 'E7bWJ45aoFXRpyRv2gw+Ig' 2-max Seat #2 is the button
Seat 1: FRkiRasEGlHUeLrEl+k/nA ($50.40 in chips)
Seat 2: 3Wro85I7472vJ4Wkpneo9A ($76.10 in chips)
3Wro85I7472vJ4Wkpneo9A: posts small blind $0.25
FRkiRasEGlHUeLrEl+k/nA: posts big blind $0.50
*** HOLE CARDS ***
3Wro85I7472vJ4Wkpneo9A: calls $0.25
FRkiRasEGlHUeLrEl+k/nA: raises $1.50 to $2
3Wro85I7472vJ4Wkpneo9A: calls $1.50
*** FLOP *** [9h Tc 9s]
FRkiRasEGlHUeLrEl+k/nA: checks
3Wro85I7472vJ4Wkpneo9A: checks
*** TURN *** [9h Tc 9s] [3c]
FRkiRasEGlHUeLrEl+k/nA: checks
3Wro85I7472vJ4Wkpneo9A: checks
*** RIVER *** [9h Tc 9s 3c] [Ts]
FRkiRasEGlHUeLrEl+k/nA: checks
3Wro85I7472vJ4Wkpneo9A: checks
*** SHOW DOWN ***
FRkiRasEGlHUeLrEl+k/nA: shows [7s Ad] (two pair, Tens and Nines)
3Wro85I7472vJ4Wkpneo9A: mucks hand
FRkiRasEGlHUeLrEl+k/nA collected $3.80 from pot
*** SUMMARY ***
Total pot $4 | Rake $0.20
Board [9h Tc 9s 3c Ts]
Seat 1: FRkiRasEGlHUeLrEl+k/nA (big blind) showed [7s Ad] and won ($3.80) with two pair, Tens and Nines
Seat 2: 3Wro85I7472vJ4Wkpneo9A (button) (small blind) mucked



PokerStars Game #59937876396:  Hold'em No Limit ($0.25/$0.50) - 2009/07/01 0:01:55 ET
Table 'mTxf8gPLgffN3Iwfm7Icfg' 2-max Seat #1 is the button
Seat 1: Do9Rlu1R5u/AcRtMTl8SYg ($62.20 in chips)
Seat 2: EMc5LPgVaded4Qc77vm0fw ($53.90 in chips)
Do9Rlu1R5u/AcRtMTl8SYg: posts small blind $0.25
EMc5LPgVaded4Qc77vm0fw: posts big blind $0.50
*** HOLE CARDS ***
Do9Rlu1R5u/AcRtMTl8SYg: folds
EMc5LPgVaded4Qc77vm0fw collected $0.50 from pot
EMc5LPgVaded4Qc77vm0fw: doesn't show hand
*** SUMMARY ***
Total pot $0.50 | Rake $0
Seat 1: Do9Rlu1R5u/AcRtMTl8SYg (button) (small blind) folded before Flop
Seat 2: EMc5LPgVaded4Qc77vm0fw (big blind) collected ($0.50)



PokerStars Game #59937879496:  Hold'em No Limit ($0.25/$0.50) - 2009/07/01 0:01:58 ET
Table 'lpxYasB1ClBSgTpCCITwhQ' 9-max Seat #1 is the button
Seat 1: ceq82/EkjUd/GFbf0YwGmA ($37.50 in chips)
Seat 2: 5JJVDlaiMnB004o/RqbZZQ ($21.15 in chips)
Seat 3: E2518gp4aFz1+kAgmGqeEg ($9.95 in chips)
Seat 6: YPo1oggovmqSREegekaQYw ($17.25 in chips)
Seat 7: zE9cVigS2nW/Ljy4K4bUQA ($30 in chips)
Seat 8: o6JyUkbzCDw8tUabqtmnlg ($27.45 in chips)
Seat 9: mSD1pginDsyHG5PDfqzphw ($10 in chips)
5JJVDlaiMnB004o/RqbZZQ: posts small blind $0.25
E2518gp4aFz1+kAgmGqeEg: posts big blind $0.50
k1f0lS7tlMHCLGs0JT34Tg: sits out
bXpVeaSTPBFSPJmeXxO7nw: sits out
*** HOLE CARDS ***
YPo1oggovmqSREegekaQYw: folds
zE9cVigS2nW/Ljy4K4bUQA: folds
o6JyUkbzCDw8tUabqtmnlg: folds
mSD1pginDsyHG5PDfqzphw: folds
ceq82/EkjUd/GFbf0YwGmA: folds
5JJVDlaiMnB004o/RqbZZQ: raises $1 to $1.50
E2518gp4aFz1+kAgmGqeEg: folds
5JJVDlaiMnB004o/RqbZZQ collected $1 from pot
*** SUMMARY ***
Total pot $1 | Rake $0
Seat 1: ceq82/EkjUd/GFbf0YwGmA (button) folded before Flop (didn't bet)
Seat 2: 5JJVDlaiMnB004o/RqbZZQ (small blind) collected ($1)
Seat 3: E2518gp4aFz1+kAgmGqeEg (big blind) folded before Flop
Seat 6: YPo1oggovmqSREegekaQYw folded before Flop (didn't bet)
Seat 7: zE9cVigS2nW/Ljy4K4bUQA folded before Flop (didn't bet)
Seat 8: o6JyUkbzCDw8tUabqtmnlg folded before Flop (didn't bet)
Seat 9: mSD1pginDsyHG5PDfqzphw folded before Flop (didn't bet)



PokerStars Game #59937880282:  Hold'em No Limit ($0.25/$0.50) - 2009/07/01 0:01:58 ET
Table 'tpZbcIvqh/6WmfR/i5IE3A' 9-max Seat #1 is the button
Seat 1: nV/P1jFY/CFMXOLWu7pYmA ($14.45 in chips)
Seat 2: M+7+BTmX5vZatHVuoRB1nA ($51.65 in chips)
Seat 3: 3w0FbBQAKwQODwenKwZxXw ($68.20 in chips)
Seat 4: zE9cVigS2nW/Ljy4K4bUQA ($30 in chips)
Seat 5: 9r7ZoBbAJj5IeyZ0q9BdzA ($13.70 in chips)
Seat 6: E2518gp4aFz1+kAgmGqeEg ($12.20 in chips)
Seat 7: wIZ377kjl2fHFGnS93o6bw ($15.95 in chips)
Seat 8: bXpVeaSTPBFSPJmeXxO7nw ($9.85 in chips)
M+7+BTmX5vZatHVuoRB1nA: posts small blind $0.25
3w0FbBQAKwQODwenKwZxXw: posts big blind $0.50
*** HOLE CARDS ***
zE9cVigS2nW/Ljy4K4bUQA: folds
9r7ZoBbAJj5IeyZ0q9BdzA: folds
E2518gp4aFz1+kAgmGqeEg: folds
wIZ377kjl2fHFGnS93o6bw: folds
bXpVeaSTPBFSPJmeXxO7nw: folds
nV/P1jFY/CFMXOLWu7pYmA: folds
M+7+BTmX5vZatHVuoRB1nA: folds
3w0FbBQAKwQODwenKwZxXw collected $0.50 from pot
*** SUMMARY ***
Total pot $0.50 | Rake $0
Seat 1: nV/P1jFY/CFMXOLWu7pYmA (button) folded before Flop (didn't bet)
Seat 2: M+7+BTmX5vZatHVuoRB1nA (small blind) folded before Flop
Seat 3: 3w0FbBQAKwQODwenKwZxXw (big blind) collected ($0.50)
Seat 4: zE9cVigS2nW/Ljy4K4bUQA folded before Flop (didn't bet)
Seat 5: 9r7ZoBbAJj5IeyZ0q9BdzA folded before Flop (didn't bet)
Seat 6: E2518gp4aFz1+kAgmGqeEg folded before Flop (didn't bet)
Seat 7: wIZ377kjl2fHFGnS93o6bw folded before Flop (didn't bet)
Seat 8: bXpVeaSTPBFSPJmeXxO7nw folded before Flop (didn't bet)



PokerStars Game #59937882208:  Hold'em No Limit ($0.25/$0.50) - 2009/07/01 0:02:00 ET
Table 'Vdlc9wqYcHTUhtdyN7CuJw' 2-max Seat #2 is the button
Seat 1: yBO+mXB6m/rCft2ErwGf/Q ($63.90 in chips)
Seat 2: sa0qgETiL3HNbdfGlnKHTA ($51.20 in chips)
sa0qgETiL3HNbdfGlnKHTA: posts small blind $0.25
yBO+mXB6m/rCft2ErwGf/Q: posts big blind $0.50
*** HOLE CARDS ***
sa0qgETiL3HNbdfGlnKHTA: folds
yBO+mXB6m/rCft2ErwGf/Q collected $0.50 from pot
*** SUMMARY ***
Total pot $0.50 | Rake $0
Seat 1: yBO+mXB6m/rCft2ErwGf/Q (big blind) collected ($0.50)
Seat 2: sa0qgETiL3HNbdfGlnKHTA (button) (small blind) folded before Flop



PokerStars Game #59937882758:  Hold'em No Limit ($0.25/$0.50) - 2009/07/01 0:02:01 ET
Table 'mTxf8gPLgffN3Iwfm7Icfg' 2-max Seat #2 is the button
Seat 1: Do9Rlu1R5u/AcRtMTl8SYg ($61.95 in chips)
Seat 2: EMc5LPgVaded4Qc77vm0fw ($54.15 in chips)
EMc5LPgVaded4Qc77vm0fw: posts small blind $0.25
Do9Rlu1R5u/AcRtMTl8SYg: posts big blind $0.50
*** HOLE CARDS ***
EMc5LPgVaded4Qc77vm0fw: raises $1 to $1.50
Do9Rlu1R5u/AcRtMTl8SYg: folds
EMc5LPgVaded4Qc77vm0fw collected $1 from pot
EMc5LPgVaded4Qc77vm0fw: doesn't show hand
*** SUMMARY ***
Total pot $1 | Rake $0
Seat 1: Do9Rlu1R5u/AcRtMTl8SYg (big blind) folded before Flop
Seat 2: EMc5LPgVaded4Qc77vm0fw (button) (small blind) collected ($1)



PokerStars Game #59937882628:  Hold'em No Limit ($0.25/$0.50) - 2009/07/01 0:02:01 ET
Table 'lSisgp6H7Fg1hH5VfjEjYQ' 9-max Seat #9 is the button
Seat 1: pEW8B6uXbdR47kfljMQ3+Q ($38.80 in chips)
Seat 2: UrcnkQOiLVk8BlKDPJSy7Q ($53.10 in chips)
Seat 3: RjBdQ6w31rgcy0o24VLR6w ($10.45 in chips)
Seat 4: nvw9yQKhJT56lA9k+TLdhw ($14.40 in chips)
Seat 5: mSD1pginDsyHG5PDfqzphw ($12.35 in chips)
Seat 6: +k7T5ocke8UwavtgUHm+Cg ($30 in chips)
Seat 7: xyQ4CeZa3ug3ompz+5xSTg ($74.70 in chips)
Seat 9: 5JJVDlaiMnB004o/RqbZZQ ($28.50 in chips)
pEW8B6uXbdR47kfljMQ3+Q: posts small blind $0.25
UrcnkQOiLVk8BlKDPJSy7Q: posts big blind $0.50
bXpVeaSTPBFSPJmeXxO7nw: sits out
*** HOLE CARDS ***
RjBdQ6w31rgcy0o24VLR6w: folds
nvw9yQKhJT56lA9k+TLdhw: folds
mSD1pginDsyHG5PDfqzphw: folds
+k7T5ocke8UwavtgUHm+Cg: folds
xyQ4CeZa3ug3ompz+5xSTg: folds
5JJVDlaiMnB004o/RqbZZQ: folds
pEW8B6uXbdR47kfljMQ3+Q: folds
UrcnkQOiLVk8BlKDPJSy7Q collected $0.50 from pot
UrcnkQOiLVk8BlKDPJSy7Q: doesn't show hand
*** SUMMARY ***
Total pot $0.50 | Rake $0
Seat 1: pEW8B6uXbdR47kfljMQ3+Q (small blind) folded before Flop
Seat 2: UrcnkQOiLVk8BlKDPJSy7Q (big blind) collected ($0.50)
Seat 3: RjBdQ6w31rgcy0o24VLR6w folded before Flop (didn't bet)
Seat 4: nvw9yQKhJT56lA9k+TLdhw folded before Flop (didn't bet)
Seat 5: mSD1pginDsyHG5PDfqzphw folded before Flop (didn't bet)
Seat 6: +k7T5ocke8UwavtgUHm+Cg folded before Flop (didn't bet)
Seat 7: xyQ4CeZa3ug3ompz+5xSTg folded before Flop (didn't bet)
Seat 9: 5JJVDlaiMnB004o/RqbZZQ (button) folded before Flop (didn't bet)



PokerStars Game #59937883822:  Hold'em No Limit ($0.25/$0.50) - 2009/07/01 0:02:03 ET
Table '+dXkOAQyS8j9PQZusUTMpg' 2-max Seat #1 is the button
Seat 1: XFa6sBGjP2gxoIvxR3fZIg ($68.70 in chips)
Seat 2: 5IBeOgaApY1Bvzv2P8X4EA ($34.40 in chips)
XFa6sBGjP2gxoIvxR3fZIg: posts small blind $0.25
5IBeOgaApY1Bvzv2P8X4EA: posts big blind $0.50
*** HOLE CARDS ***
XFa6sBGjP2gxoIvxR3fZIg: raises $1 to $1.50
5IBeOgaApY1Bvzv2P8X4EA: folds
XFa6sBGjP2gxoIvxR3fZIg collected $1 from pot
XFa6sBGjP2gxoIvxR3fZIg: doesn't show hand
*** SUMMARY ***
Total pot $1 | Rake $0
Seat 1: XFa6sBGjP2gxoIvxR3fZIg (button) (small blind) collected ($1)
Seat 2: 5IBeOgaApY1Bvzv2P8X4EA (big blind) folded before Flop



PokerStars Game #59937884214:  Hold'em No Limit ($0.25/$0.50) - 2009/07/01 0:02:03 ET
Table 'raOT4/ipuZgzjfKHC+jD9g' 2-max Seat #1 is the button
Seat 1: IuwLemwLhc9fvrwBGs0AMA ($9.90 in chips)
Seat 2: Udr5juWSWUgTu1NlRhjMdA ($14.50 in chips)
IuwLemwLhc9fvrwBGs0AMA: posts small blind $0.25
Udr5juWSWUgTu1NlRhjMdA: posts big blind $0.50
*** HOLE CARDS ***
IuwLemwLhc9fvrwBGs0AMA: folds
Udr5juWSWUgTu1NlRhjMdA collected $0.50 from pot
Udr5juWSWUgTu1NlRhjMdA: doesn't show hand
*** SUMMARY ***
Total pot $0.50 | Rake $0
Seat 1: IuwLemwLhc9fvrwBGs0AMA (button) (small blind) folded before Flop
Seat 2: Udr5juWSWUgTu1NlRhjMdA (big blind) collected ($0.50)



PokerStars Game #59937884904:  Hold'em No Limit ($0.25/$0.50) - 2009/07/01 0:02:04 ET
Table 'SsXEKOwKN+jE3etfusqUqA' 2-max Seat #2 is the button
Seat 1: 618rKeLrz/avGNOLULHHVQ ($79 in chips)
Seat 2: XfRhywXA6Br+jID1oGeo8A ($117.60 in chips)
XfRhywXA6Br+jID1oGeo8A: posts small blind $0.25
618rKeLrz/avGNOLULHHVQ: posts big blind $0.50
*** HOLE CARDS ***
XfRhywXA6Br+jID1oGeo8A: calls $0.25
618rKeLrz/avGNOLULHHVQ: checks
*** FLOP *** [Ad 3c 3h]
618rKeLrz/avGNOLULHHVQ: checks
XfRhywXA6Br+jID1oGeo8A: checks
*** TURN *** [Ad 3c 3h] [Ks]
618rKeLrz/avGNOLULHHVQ: checks
XfRhywXA6Br+jID1oGeo8A: checks
*** RIVER *** [Ad 3c 3h Ks] [Qh]
618rKeLrz/avGNOLULHHVQ: checks
XfRhywXA6Br+jID1oGeo8A: bets $0.50
618rKeLrz/avGNOLULHHVQ: folds
618rKeLrz/avGNOLULHHVQ said, "wp.."
XfRhywXA6Br+jID1oGeo8A collected $0.95 from pot
XfRhywXA6Br+jID1oGeo8A: doesn't show hand
*** SUMMARY ***
Total pot $1 | Rake $0.05
Board [Ad 3c 3h Ks Qh]
Seat 1: 618rKeLrz/avGNOLULHHVQ (big blind) folded on the River
Seat 2: XfRhywXA6Br+jID1oGeo8A (button) (small blind) collected ($0.95)



PokerStars Game #59937885046:  Hold'em No Limit ($0.25/$0.50) - 2009/07/01 0:02:04 ET
Table 'QOgaEqMcJ73pcUMMxoisUg' 6-max Seat #3 is the button
Seat 1: RFefXIDyFvNtJLq+CloCzA ($44.70 in chips)
Seat 2: qsObMEIlRO22OlS867m/lw ($15.60 in chips)
Seat 3: wUZNozoIDYf+16hp4nn6dw ($21.90 in chips)
Seat 4: L5e2lrPLQm1Pqx30IIZ/Fw ($9.50 in chips)
Seat 5: HoaSQCRso+nEyO5DUhGduw ($72.35 in chips)
Seat 6: s83dnhZ6VC53vY0/f6OV/g ($40.65 in chips)
L5e2lrPLQm1Pqx30IIZ/Fw: posts small blind $0.25
HoaSQCRso+nEyO5DUhGduw: posts big blind $0.50
*** HOLE CARDS ***
s83dnhZ6VC53vY0/f6OV/g: folds
RFefXIDyFvNtJLq+CloCzA: raises $0.75 to $1.25
qsObMEIlRO22OlS867m/lw: folds
wUZNozoIDYf+16hp4nn6dw: calls $1.25
qsObMEIlRO22OlS867m/lw leaves the table
L5e2lrPLQm1Pqx30IIZ/Fw: folds
HoaSQCRso+nEyO5DUhGduw: folds
*** FLOP *** [6d 8d 7d]
RFefXIDyFvNtJLq+CloCzA: checks
wUZNozoIDYf+16hp4nn6dw: bets $0.50
RFefXIDyFvNtJLq+CloCzA: calls $0.50
*** TURN *** [6d 8d 7d] [As]
RFefXIDyFvNtJLq+CloCzA: checks
wUZNozoIDYf+16hp4nn6dw: bets $0.50
RFefXIDyFvNtJLq+CloCzA: calls $0.50
*** RIVER *** [6d 8d 7d As] [4s]
RFefXIDyFvNtJLq+CloCzA: checks
wUZNozoIDYf+16hp4nn6dw: bets $5
RFefXIDyFvNtJLq+CloCzA: folds
wUZNozoIDYf+16hp4nn6dw collected $5 from pot
*** SUMMARY ***
Total pot $5.25 | Rake $0.25
Board [6d 8d 7d As 4s]
Seat 1: RFefXIDyFvNtJLq+CloCzA folded on the River
Seat 2: qsObMEIlRO22OlS867m/lw folded before Flop (didn't bet)
Seat 3: wUZNozoIDYf+16hp4nn6dw (button) collected ($5)
Seat 4: L5e2lrPLQm1Pqx30IIZ/Fw (small blind) folded before Flop
Seat 5: HoaSQCRso+nEyO5DUhGduw (big blind) folded before Flop
Seat 6: s83dnhZ6VC53vY0/f6OV/g folded before Flop (didn't bet)



PokerStars Game #59937884798:  Hold'em No Limit ($0.25/$0.50) - 2009/07/01 0:02:04 ET
Table 'NCiXr0d5CEKBQr/cZgLhbA' 9-max Seat #6 is the button
Seat 1: RjBdQ6w31rgcy0o24VLR6w ($9.25 in chips)
Seat 2: ulxuJchBV9iguXg0FUonfg ($31.20 in chips)
Seat 3: xZCXQSXlrZkp3pZizzVXCw ($52.65 in chips)
Seat 4: CL4d+tvzcd4utdQxlPLOmg ($34.90 in chips)
Seat 5: zE9cVigS2nW/Ljy4K4bUQA ($32.70 in chips)
Seat 6: SKnJuWHScqetA/qG5p+wCg ($31.80 in chips)
Seat 7: EltNhVR1POPXhu/1E62t3A ($9 in chips)
Seat 8: E2518gp4aFz1+kAgmGqeEg ($11.70 in chips)
Seat 9: WpvT3OUSiZlpvs+mPXFqtQ ($7.45 in chips)
EltNhVR1POPXhu/1E62t3A: posts small blind $0.25
E2518gp4aFz1+kAgmGqeEg: posts big blind $0.50
*** HOLE CARDS ***
WpvT3OUSiZlpvs+mPXFqtQ: folds
RjBdQ6w31rgcy0o24VLR6w: folds
ulxuJchBV9iguXg0FUonfg: calls $0.50
xZCXQSXlrZkp3pZizzVXCw: raises $2 to $2.50
CL4d+tvzcd4utdQxlPLOmg: folds
zE9cVigS2nW/Ljy4K4bUQA: folds
SKnJuWHScqetA/qG5p+wCg: folds
EltNhVR1POPXhu/1E62t3A: folds
E2518gp4aFz1+kAgmGqeEg: folds
ulxuJchBV9iguXg0FUonfg: calls $2
*** FLOP *** [5h 6d 9d]
ulxuJchBV9iguXg0FUonfg: checks
xZCXQSXlrZkp3pZizzVXCw: bets $3.50
ulxuJchBV9iguXg0FUonfg: folds
xZCXQSXlrZkp3pZizzVXCw collected $5.50 from pot
*** SUMMARY ***
Total pot $5.75 | Rake $0.25
Board [5h 6d 9d]
Seat 1: RjBdQ6w31rgcy0o24VLR6w folded before Flop (didn't bet)
Seat 2: ulxuJchBV9iguXg0FUonfg folded on the Flop
Seat 3: xZCXQSXlrZkp3pZizzVXCw collected ($5.50)
Seat 4: CL4d+tvzcd4utdQxlPLOmg folded before Flop (didn't bet)
Seat 5: zE9cVigS2nW/Ljy4K4bUQA folded before Flop (didn't bet)
Seat 6: SKnJuWHScqetA/qG5p+wCg (button) folded before Flop (didn't bet)
Seat 7: EltNhVR1POPXhu/1E62t3A (small blind) folded before Flop
Seat 8: E2518gp4aFz1+kAgmGqeEg (big blind) folded before Flop
Seat 9: WpvT3OUSiZlpvs+mPXFqtQ folded before Flop (didn't bet)



PokerStars Game #59937884964:  Hold'em No Limit ($0.25/$0.50) - 2009/07/01 0:02:04 ET
Table 'hSTs/dUsYLgJQuF2Onp0MQ' 6-max Seat #5 is the button
Seat 1: lWwl5C/UZOsWNubdUqghZw ($71.95 in chips)
Seat 3: vQOrJuXbLC3UZDVklY9bOA ($12 in chips)
Seat 4: L0aIPg7qefDQjdJo3HCVEA ($15.20 in chips)
Seat 5: 686aeHikcJlgKkSuIFdcXQ ($61.40 in chips)
Seat 6: +laPa9P7BjZKKnR0n+OmvA ($11.10 in chips)
+laPa9P7BjZKKnR0n+OmvA: posts small blind $0.25
lWwl5C/UZOsWNubdUqghZw: posts big blind $0.50
*** HOLE CARDS ***
vQOrJuXbLC3UZDVklY9bOA: folds
L0aIPg7qefDQjdJo3HCVEA: folds
686aeHikcJlgKkSuIFdcXQ: folds
+laPa9P7BjZKKnR0n+OmvA: raises $0.50 to $1
lWwl5C/UZOsWNubdUqghZw: calls $0.50
*** FLOP *** [4s Jc 3h]
+laPa9P7BjZKKnR0n+OmvA: bets $1.50
lWwl5C/UZOsWNubdUqghZw: folds
+laPa9P7BjZKKnR0n+OmvA collected $1.90 from pot
*** SUMMARY ***
Total pot $2 | Rake $0.10
Board [4s Jc 3h]
Seat 1: lWwl5C/UZOsWNubdUqghZw (big blind) folded on the Flop
Seat 3: vQOrJuXbLC3UZDVklY9bOA folded before Flop (didn't bet)
Seat 4: L0aIPg7qefDQjdJo3HCVEA folded before Flop (didn't bet)
Seat 5: 686aeHikcJlgKkSuIFdcXQ (button) folded before Flop (didn't bet)
Seat 6: +laPa9P7BjZKKnR0n+OmvA (small blind) collected ($1.90)



PokerStars Game #59937884706:  Hold'em No Limit ($0.25/$0.50) - 2009/07/01 0:02:04 ET
Table 'GfL/No5u5PoEnU39lP5pQg' 6-max Seat #2 is the button
Seat 1: T0Gx/FcQ5VH9u7XaOMX97A ($50 in chips)
Seat 2: uVwggSetzp7d+eVgowO3vg ($20.80 in chips)
Seat 3: YmWlPGOKFuJSoJZPW8a8IA ($95.45 in chips)
Seat 4: yqM0AD7MZQd/cEtKdDQY1A ($35.40 in chips)
Seat 6: 5EiAo0XuFchfJkhvFPvoog ($65.95 in chips)
YmWlPGOKFuJSoJZPW8a8IA: posts small blind $0.25
yqM0AD7MZQd/cEtKdDQY1A: posts big blind $0.50
*** HOLE CARDS ***
5EiAo0XuFchfJkhvFPvoog: folds
T0Gx/FcQ5VH9u7XaOMX97A: raises $1 to $1.50
uVwggSetzp7d+eVgowO3vg: folds
YmWlPGOKFuJSoJZPW8a8IA: folds
yqM0AD7MZQd/cEtKdDQY1A: folds
T0Gx/FcQ5VH9u7XaOMX97A collected $1.25 from pot
T0Gx/FcQ5VH9u7XaOMX97A: doesn't show hand
*** SUMMARY ***
Total pot $1.25 | Rake $0
Seat 1: T0Gx/FcQ5VH9u7XaOMX97A collected ($1.25)
Seat 2: uVwggSetzp7d+eVgowO3vg (button) folded before Flop (didn't bet)
Seat 3: YmWlPGOKFuJSoJZPW8a8IA (small blind) folded before Flop
Seat 4: yqM0AD7MZQd/cEtKdDQY1A (big blind) folded before Flop
Seat 6: 5EiAo0XuFchfJkhvFPvoog folded before Flop (didn't bet)



PokerStars Game #59937885688:  Hold'em No Limit ($0.25/$0.50) - 2009/07/01 0:02:05 ET
Table 'EiNh8p/wGJ1FP575iMFnqg' 9-max Seat #9 is the button
Seat 1: r3ZqM1Mi0W3y4hOdssE+Sg ($41.85 in chips)
Seat 2: avsQkZXsRKnWa7gkjVNvog ($27.70 in chips)
Seat 3: GszS/McxOSUnOET7MBoHqA ($57.50 in chips)
Seat 4: pk8aA8qMBEL6zXqSyfVXMA ($80.80 in chips)
Seat 5: M+7+BTmX5vZatHVuoRB1nA ($93.50 in chips)
Seat 6: YPo1oggovmqSREegekaQYw ($14.75 in chips)
Seat 7: Wj7mKnRFR90j40wWUu2+Og ($26.70 in chips)
Seat 8: C7LqTSTGrMSBCecHvwQAOQ ($55.30 in chips)
Seat 9: OMwFJ4pF0xk2Ru/AJiFeFw ($73.40 in chips)
r3ZqM1Mi0W3y4hOdssE+Sg: posts small blind $0.25
avsQkZXsRKnWa7gkjVNvog: posts big blind $0.50
*** HOLE CARDS ***
GszS/McxOSUnOET7MBoHqA: folds
pk8aA8qMBEL6zXqSyfVXMA: folds
M+7+BTmX5vZatHVuoRB1nA: folds
YPo1oggovmqSREegekaQYw: folds
Wj7mKnRFR90j40wWUu2+Og: folds
C7LqTSTGrMSBCecHvwQAOQ: folds
OMwFJ4pF0xk2Ru/AJiFeFw: folds
r3ZqM1Mi0W3y4hOdssE+Sg: calls $0.25
avsQkZXsRKnWa7gkjVNvog: checks
*** FLOP *** [9h 4s 3s]
r3ZqM1Mi0W3y4hOdssE+Sg: checks
avsQkZXsRKnWa7gkjVNvog: bets $1
r3ZqM1Mi0W3y4hOdssE+Sg: folds
avsQkZXsRKnWa7gkjVNvog collected $0.95 from pot
*** SUMMARY ***
Total pot $1 | Rake $0.05
Board [9h 4s 3s]
Seat 1: r3ZqM1Mi0W3y4hOdssE+Sg (small blind) folded on the Flop
Seat 2: avsQkZXsRKnWa7gkjVNvog (big blind) collected ($0.95)
Seat 3: GszS/McxOSUnOET7MBoHqA folded before Flop (didn't bet)
Seat 4: pk8aA8qMBEL6zXqSyfVXMA folded before Flop (didn't bet)
Seat 5: M+7+BTmX5vZatHVuoRB1nA folded before Flop (didn't bet)
Seat 6: YPo1oggovmqSREegekaQYw folded before Flop (didn't bet)
Seat 7: Wj7mKnRFR90j40wWUu2+Og folded before Flop (didn't bet)
Seat 8: C7LqTSTGrMSBCecHvwQAOQ folded before Flop (didn't bet)
Seat 9: OMwFJ4pF0xk2Ru/AJiFeFw (button) folded before Flop (didn't bet)



PokerStars Game #59937887370:  Hold'em No Limit ($0.25/$0.50) - 2009/07/01 0:02:08 ET
Table 'c/CRn+68J3Y8KxD5g1ek2Q' 2-max Seat #1 is the button
Seat 1: 46qCyJ6evTkHo9al5sBMNA ($317.65 in chips)
Seat 2: BypVLsYQt3ePFm2xQL/dOA ($71.10 in chips)
46qCyJ6evTkHo9al5sBMNA: posts small blind $0.25
BypVLsYQt3ePFm2xQL/dOA: posts big blind $0.50
*** HOLE CARDS ***
46qCyJ6evTkHo9al5sBMNA: folds
BypVLsYQt3ePFm2xQL/dOA collected $0.50 from pot
BypVLsYQt3ePFm2xQL/dOA: doesn't show hand
*** SUMMARY ***
Total pot $0.50 | Rake $0
Seat 1: 46qCyJ6evTkHo9al5sBMNA (button) (small blind) folded before Flop
Seat 2: BypVLsYQt3ePFm2xQL/dOA (big blind) collected ($0.50)



PokerStars Game #59937887156:  Hold'em No Limit ($0.25/$0.50) - 2009/07/01 0:02:08 ET
Table 'Vdlc9wqYcHTUhtdyN7CuJw' 2-max Seat #1 is the button
Seat 1: yBO+mXB6m/rCft2ErwGf/Q ($64.15 in chips)
Seat 2: sa0qgETiL3HNbdfGlnKHTA ($50.95 in chips)
yBO+mXB6m/rCft2ErwGf/Q: posts small blind $0.25
sa0qgETiL3HNbdfGlnKHTA: posts big blind $0.50
*** HOLE CARDS ***
yBO+mXB6m/rCft2ErwGf/Q: calls $0.25
sa0qgETiL3HNbdfGlnKHTA: raises $1 to $1.50
yBO+mXB6m/rCft2ErwGf/Q: folds
sa0qgETiL3HNbdfGlnKHTA collected $1 from pot
*** SUMMARY ***
Total pot $1 | Rake $0
Seat 1: yBO+mXB6m/rCft2ErwGf/Q (button) (small blind) folded before Flop
Seat 2: sa0qgETiL3HNbdfGlnKHTA (big blind) collected ($1)



PokerStars Game #59937888514:  Hold'em No Limit ($0.25/$0.50) - 2009/07/01 0:02:09 ET
Table 'mTxf8gPLgffN3Iwfm7Icfg' 2-max Seat #1 is the button
Seat 1: Do9Rlu1R5u/AcRtMTl8SYg ($61.45 in chips)
Seat 2: EMc5LPgVaded4Qc77vm0fw ($54.65 in chips)
Do9Rlu1R5u/AcRtMTl8SYg: posts small blind $0.25
EMc5LPgVaded4Qc77vm0fw: posts big blind $0.50
*** HOLE CARDS ***
Do9Rlu1R5u/AcRtMTl8SYg: raises $1 to $1.50
EMc5LPgVaded4Qc77vm0fw: calls $1
*** FLOP *** [As 4c 7s]
EMc5LPgVaded4Qc77vm0fw: checks
Do9Rlu1R5u/AcRtMTl8SYg: bets $2
EMc5LPgVaded4Qc77vm0fw: calls $2
*** TURN *** [As 4c 7s] [Kc]
EMc5LPgVaded4Qc77vm0fw: checks
Do9Rlu1R5u/AcRtMTl8SYg: bets $4
EMc5LPgVaded4Qc77vm0fw: folds
Do9Rlu1R5u/AcRtMTl8SYg collected $6.70 from pot
Do9Rlu1R5u/AcRtMTl8SYg: doesn't show hand
*** SUMMARY ***
Total pot $7 | Rake $0.30
Board [As 4c 7s Kc]
Seat 1: Do9Rlu1R5u/AcRtMTl8SYg (button) (small blind) collected ($6.70)
Seat 2: EMc5LPgVaded4Qc77vm0fw (big blind) folded on the Turn



PokerStars Game #59937889066:  Hold'em No Limit ($0.25/$0.50) - 2009/07/01 0:02:10 ET
Table '+dXkOAQyS8j9PQZusUTMpg' 2-max Seat #2 is the button
Seat 1: XFa6sBGjP2gxoIvxR3fZIg ($69.20 in chips)
Seat 2: 5IBeOgaApY1Bvzv2P8X4EA ($33.90 in chips)
5IBeOgaApY1Bvzv2P8X4EA: posts small blind $0.25
XFa6sBGjP2gxoIvxR3fZIg: posts big blind $0.50
*** HOLE CARDS ***
5IBeOgaApY1Bvzv2P8X4EA: calls $0.25
XFa6sBGjP2gxoIvxR3fZIg: checks
*** FLOP *** [Qc 6c 4s]
XFa6sBGjP2gxoIvxR3fZIg: checks
5IBeOgaApY1Bvzv2P8X4EA: bets $0.50
XFa6sBGjP2gxoIvxR3fZIg: calls $0.50
*** TURN *** [Qc 6c 4s] [2h]
XFa6sBGjP2gxoIvxR3fZIg: checks
5IBeOgaApY1Bvzv2P8X4EA: bets $1.50
XFa6sBGjP2gxoIvxR3fZIg: calls $1.50
*** RIVER *** [Qc 6c 4s 2h] [5c]
XFa6sBGjP2gxoIvxR3fZIg: checks
5IBeOgaApY1Bvzv2P8X4EA: bets $3
XFa6sBGjP2gxoIvxR3fZIg: raises $8 to $11
5IBeOgaApY1Bvzv2P8X4EA: calls $8
*** SHOW DOWN ***
XFa6sBGjP2gxoIvxR3fZIg: shows [3h 2s] (a straight, Deuce to Six)
5IBeOgaApY1Bvzv2P8X4EA: mucks hand
XFa6sBGjP2gxoIvxR3fZIg collected $26.50 from pot
*** SUMMARY ***
Total pot $27 | Rake $0.50
Board [Qc 6c 4s 2h 5c]
Seat 1: XFa6sBGjP2gxoIvxR3fZIg (big blind) showed [3h 2s] and won ($26.50) with a straight, Deuce to Six
Seat 2: 5IBeOgaApY1Bvzv2P8X4EA (button) (small blind) mucked



PokerStars Game #59937889182:  Hold'em No Limit ($0.25/$0.50) - 2009/07/01 0:02:10 ET
Table 'raOT4/ipuZgzjfKHC+jD9g' 2-max Seat #2 is the button
Seat 1: IuwLemwLhc9fvrwBGs0AMA ($9.65 in chips)
Seat 2: Udr5juWSWUgTu1NlRhjMdA ($14.75 in chips)
Udr5juWSWUgTu1NlRhjMdA: posts small blind $0.25
IuwLemwLhc9fvrwBGs0AMA: posts big blind $0.50
*** HOLE CARDS ***
Udr5juWSWUgTu1NlRhjMdA: calls $0.25
IuwLemwLhc9fvrwBGs0AMA: checks
*** FLOP *** [7c 7s Ah]
IuwLemwLhc9fvrwBGs0AMA: checks
Udr5juWSWUgTu1NlRhjMdA: checks
*** TURN *** [7c 7s Ah] [Js]
IuwLemwLhc9fvrwBGs0AMA: checks
Udr5juWSWUgTu1NlRhjMdA: checks
*** RIVER *** [7c 7s Ah Js] [3s]
IuwLemwLhc9fvrwBGs0AMA: checks
Udr5juWSWUgTu1NlRhjMdA: checks
*** SHOW DOWN ***
IuwLemwLhc9fvrwBGs0AMA: shows [9d 8d] (a pair of Sevens)
Udr5juWSWUgTu1NlRhjMdA: shows [Kc 2d] (a pair of Sevens - Ace+King kicker)
Udr5juWSWUgTu1NlRhjMdA collected $0.95 from pot
*** SUMMARY ***
Total pot $1 | Rake $0.05
Board [7c 7s Ah Js 3s]
Seat 1: IuwLemwLhc9fvrwBGs0AMA (big blind) showed [9d 8d] and lost with a pair of Sevens
Seat 2: Udr5juWSWUgTu1NlRhjMdA (button) (small blind) showed [Kc 2d] and won ($0.95) with a pair of Sevens



PokerStars Game #59937890162:  Hold'em No Limit ($0.25/$0.50) - 2009/07/01 0:02:12 ET
Table '37qXEp3oe+er5q4CZip9eQ' 6-max Seat #3 is the button
Seat 2: g12O9qXTybyo2C0B2bXgjg ($18.15 in chips)
Seat 3: Rt6KgtZ8YaJoTc3FPim00w ($111.10 in chips)
Seat 4: L0aIPg7qefDQjdJo3HCVEA ($10.55 in chips)
Seat 5: VOmI0x4dDPnTESZd5B4d1Q ($33 in chips)
Seat 6: f7zPpUQp9hHZgqhEvrUWQw ($56.65 in chips)
L0aIPg7qefDQjdJo3HCVEA: posts small blind $0.25
VOmI0x4dDPnTESZd5B4d1Q: posts big blind $0.50
*** HOLE CARDS ***
f7zPpUQp9hHZgqhEvrUWQw: folds
g12O9qXTybyo2C0B2bXgjg: calls $0.50
Rt6KgtZ8YaJoTc3FPim00w: raises $1.50 to $2
L0aIPg7qefDQjdJo3HCVEA: folds
VOmI0x4dDPnTESZd5B4d1Q: calls $1.50
g12O9qXTybyo2C0B2bXgjg: calls $1.50
*** FLOP *** [7h Th 6c]
VOmI0x4dDPnTESZd5B4d1Q: checks
g12O9qXTybyo2C0B2bXgjg: checks
Rt6KgtZ8YaJoTc3FPim00w: checks
*** TURN *** [7h Th 6c] [9c]
VOmI0x4dDPnTESZd5B4d1Q: checks
4qceN3NM3S463h+TT4UvGQ joins the table at seat #1
g12O9qXTybyo2C0B2bXgjg: bets $2.50
Rt6KgtZ8YaJoTc3FPim00w: folds
VOmI0x4dDPnTESZd5B4d1Q: folds
g12O9qXTybyo2C0B2bXgjg collected $5.95 from pot
*** SUMMARY ***
Total pot $6.25 | Rake $0.30
Board [7h Th 6c 9c]
Seat 2: g12O9qXTybyo2C0B2bXgjg collected ($5.95)
Seat 3: Rt6KgtZ8YaJoTc3FPim00w (button) folded on the Turn
Seat 4: L0aIPg7qefDQjdJo3HCVEA (small blind) folded before Flop
Seat 5: VOmI0x4dDPnTESZd5B4d1Q (big blind) folded on the Turn
Seat 6: f7zPpUQp9hHZgqhEvrUWQw folded before Flop (didn't bet)



PokerStars Game #59937891880:  Hold'em No Limit ($0.25/$0.50) - 2009/07/01 0:02:14 ET
Table 'c/CRn+68J3Y8KxD5g1ek2Q' 2-max Seat #2 is the button
Seat 1: 46qCyJ6evTkHo9al5sBMNA ($317.40 in chips)
Seat 2: BypVLsYQt3ePFm2xQL/dOA ($71.35 in chips)
BypVLsYQt3ePFm2xQL/dOA: posts small blind $0.25
46qCyJ6evTkHo9al5sBMNA: posts big blind $0.50
*** HOLE CARDS ***
BypVLsYQt3ePFm2xQL/dOA: raises $0.50 to $1
46qCyJ6evTkHo9al5sBMNA: raises $1.50 to $2.50
BypVLsYQt3ePFm2xQL/dOA: folds
46qCyJ6evTkHo9al5sBMNA collected $2 from pot
46qCyJ6evTkHo9al5sBMNA: doesn't show hand
*** SUMMARY ***
Total pot $2 | Rake $0
Seat 1: 46qCyJ6evTkHo9al5sBMNA (big blind) collected ($2)
Seat 2: BypVLsYQt3ePFm2xQL/dOA (button) (small blind) folded before Flop



PokerStars Game #59937892252:  Hold'em No Limit ($0.25/$0.50) - 2009/07/01 0:02:14 ET
Table 'YsnnHkamRzYqMOr2FlLY4w' 6-max Seat #5 is the button
Seat 1: crjGpJEzSZgD38FoE3VMGg ($55.30 in chips)
Seat 2: 2dIa62hMcn6g73rbkt9NwA ($63.60 in chips)
Seat 3: I+pG2m/dD5iYdbg9qx572g ($21.80 in chips)
Seat 4: 7Fue572p4ZIC85AJMQvaQw ($47.80 in chips)
Seat 5: lcQ7uuLf+WLGGy4Ve6VKKA ($44.25 in chips)
Seat 6: YmWlPGOKFuJSoJZPW8a8IA ($50.45 in chips)
YmWlPGOKFuJSoJZPW8a8IA: posts small blind $0.25
crjGpJEzSZgD38FoE3VMGg: posts big blind $0.50
*** HOLE CARDS ***
2dIa62hMcn6g73rbkt9NwA: folds
I+pG2m/dD5iYdbg9qx572g: raises $1 to $1.50
7Fue572p4ZIC85AJMQvaQw: folds
lcQ7uuLf+WLGGy4Ve6VKKA: folds
YmWlPGOKFuJSoJZPW8a8IA: calls $1.25
crjGpJEzSZgD38FoE3VMGg: folds
*** FLOP *** [Js 2d 3d]
YmWlPGOKFuJSoJZPW8a8IA: checks
I+pG2m/dD5iYdbg9qx572g: bets $1
YmWlPGOKFuJSoJZPW8a8IA: folds
I+pG2m/dD5iYdbg9qx572g collected $3.35 from pot
I+pG2m/dD5iYdbg9qx572g: doesn't show hand
*** SUMMARY ***
Total pot $3.50 | Rake $0.15
Board [Js 2d 3d]
Seat 1: crjGpJEzSZgD38FoE3VMGg (big blind) folded before Flop
Seat 2: 2dIa62hMcn6g73rbkt9NwA folded before Flop (didn't bet)
Seat 3: I+pG2m/dD5iYdbg9qx572g collected ($3.35)
Seat 4: 7Fue572p4ZIC85AJMQvaQw folded before Flop (didn't bet)
Seat 5: lcQ7uuLf+WLGGy4Ve6VKKA (button) folded before Flop (didn't bet)
Seat 6: YmWlPGOKFuJSoJZPW8a8IA (small blind) folded on the Flop



PokerStars Game #59937894640:  Hold'em No Limit ($0.25/$0.50) - 2009/07/01 0:02:18 ET
Table 'BCN5su+SsXiy1zRMJi0SJw' 6-max Seat #1 is the button
Seat 1: 5EiAo0XuFchfJkhvFPvoog ($99.45 in chips)
Seat 2: QfV2JJlmEKgD5jYPV+a33A ($161.15 in chips)
Seat 3: yrJsFKWv+ttHooqghxDx3A ($6.05 in chips)
Seat 4: 6Wb8PlO2kM4fnSim7p4Mrw ($10.55 in chips)
Seat 5: TTx3CHxyi0SObcHyMJRp5w ($36.55 in chips)
Seat 6: zHXshyreKwJVq3N3U+K9uQ ($52.05 in chips)
QfV2JJlmEKgD5jYPV+a33A: posts small blind $0.25
yrJsFKWv+ttHooqghxDx3A: posts big blind $0.50
*** HOLE CARDS ***
6Wb8PlO2kM4fnSim7p4Mrw: calls $0.50
TTx3CHxyi0SObcHyMJRp5w: folds
zHXshyreKwJVq3N3U+K9uQ: folds
5EiAo0XuFchfJkhvFPvoog: folds
QfV2JJlmEKgD5jYPV+a33A: folds
yrJsFKWv+ttHooqghxDx3A: checks
*** FLOP *** [8s Ah 7h]
yrJsFKWv+ttHooqghxDx3A: checks
6Wb8PlO2kM4fnSim7p4Mrw: bets $0.50
yrJsFKWv+ttHooqghxDx3A: folds
6Wb8PlO2kM4fnSim7p4Mrw collected $1.20 from pot
*** SUMMARY ***
Total pot $1.25 | Rake $0.05
Board [8s Ah 7h]
Seat 1: 5EiAo0XuFchfJkhvFPvoog (button) folded before Flop (didn't bet)
Seat 2: QfV2JJlmEKgD5jYPV+a33A (small blind) folded before Flop
Seat 3: yrJsFKWv+ttHooqghxDx3A (big blind) folded on the Flop
Seat 4: 6Wb8PlO2kM4fnSim7p4Mrw collected ($1.20)
Seat 5: TTx3CHxyi0SObcHyMJRp5w folded before Flop (didn't bet)
Seat 6: zHXshyreKwJVq3N3U+K9uQ folded before Flop (didn't bet)



PokerStars Game #59937895462:  Hold'em No Limit ($0.25/$0.50) - 2009/07/01 0:02:19 ET
Table 'E7bWJ45aoFXRpyRv2gw+Ig' 2-max Seat #1 is the button
Seat 1: FRkiRasEGlHUeLrEl+k/nA ($52.20 in chips)
Seat 2: 3Wro85I7472vJ4Wkpneo9A ($74.10 in chips)
FRkiRasEGlHUeLrEl+k/nA: posts small blind $0.25
3Wro85I7472vJ4Wkpneo9A: posts big blind $0.50
*** HOLE CARDS ***
FRkiRasEGlHUeLrEl+k/nA: folds
3Wro85I7472vJ4Wkpneo9A collected $0.50 from pot
3Wro85I7472vJ4Wkpneo9A: doesn't show hand
*** SUMMARY ***
Total pot $0.50 | Rake $0
Seat 1: FRkiRasEGlHUeLrEl+k/nA (button) (small blind) folded before Flop
Seat 2: 3Wro85I7472vJ4Wkpneo9A (big blind) collected ($0.50)



PokerStars Game #59937897746:  Hold'em No Limit ($0.25/$0.50) - 2009/07/01 0:02:22 ET
Table 'lpxYasB1ClBSgTpCCITwhQ' 9-max Seat #2 is the button
Seat 1: ceq82/EkjUd/GFbf0YwGmA ($37.50 in chips)
Seat 2: 5JJVDlaiMnB004o/RqbZZQ ($21.65 in chips)
Seat 3: E2518gp4aFz1+kAgmGqeEg ($11 in chips)
Seat 4: k1f0lS7tlMHCLGs0JT34Tg ($10 in chips)
Seat 6: YPo1oggovmqSREegekaQYw ($17.25 in chips)
Seat 7: zE9cVigS2nW/Ljy4K4bUQA ($30 in chips)
Seat 8: o6JyUkbzCDw8tUabqtmnlg ($27.45 in chips)
Seat 9: mSD1pginDsyHG5PDfqzphw ($10 in chips)
E2518gp4aFz1+kAgmGqeEg: posts small blind $0.25
k1f0lS7tlMHCLGs0JT34Tg: posts big blind $0.50
bXpVeaSTPBFSPJmeXxO7nw: sits out
*** HOLE CARDS ***
YPo1oggovmqSREegekaQYw: folds
zE9cVigS2nW/Ljy4K4bUQA: raises $1 to $1.50
o6JyUkbzCDw8tUabqtmnlg: folds
mSD1pginDsyHG5PDfqzphw: folds
ceq82/EkjUd/GFbf0YwGmA: folds
5JJVDlaiMnB004o/RqbZZQ: raises $1.50 to $3
E2518gp4aFz1+kAgmGqeEg: folds
k1f0lS7tlMHCLGs0JT34Tg: folds
zE9cVigS2nW/Ljy4K4bUQA: calls $1.50
*** FLOP *** [9c Js Ks]
zE9cVigS2nW/Ljy4K4bUQA: checks
5JJVDlaiMnB004o/RqbZZQ: bets $2.50
zE9cVigS2nW/Ljy4K4bUQA: raises $24.50 to $27 and is all-in
5JJVDlaiMnB004o/RqbZZQ: calls $16.15 and is all-in
*** TURN *** [9c Js Ks] [Ac]
*** RIVER *** [9c Js Ks Ac] [Th]
*** SHOW DOWN ***
zE9cVigS2nW/Ljy4K4bUQA: shows [Kh Ad] (two pair, Aces and Kings)
5JJVDlaiMnB004o/RqbZZQ: shows [As Ah] (three of a kind, Aces)
5JJVDlaiMnB004o/RqbZZQ collected $41.90 from pot
*** SUMMARY ***
Total pot $44.05 | Rake $2.15
Board [9c Js Ks Ac Th]
Seat 1: ceq82/EkjUd/GFbf0YwGmA folded before Flop (didn't bet)
Seat 2: 5JJVDlaiMnB004o/RqbZZQ (button) showed [As Ah] and won ($41.90) with three of a kind, Aces
Seat 3: E2518gp4aFz1+kAgmGqeEg (small blind) folded before Flop
Seat 4: k1f0lS7tlMHCLGs0JT34Tg (big blind) folded before Flop
Seat 6: YPo1oggovmqSREegekaQYw folded before Flop (didn't bet)
Seat 7: zE9cVigS2nW/Ljy4K4bUQA showed [Kh Ad] and lost with two pair, Aces and Kings
Seat 8: o6JyUkbzCDw8tUabqtmnlg folded before Flop (didn't bet)
Seat 9: mSD1pginDsyHG5PDfqzphw folded before Flop (didn't bet)



PokerStars Game #59937897616:  Hold'em No Limit ($0.25/$0.50) - 2009/07/01 0:02:22 ET
Table 'QOgaEqMcJ73pcUMMxoisUgErOuyGLI5PT3G5MnpHgC/g Seat #6 is the button
Seat 1: k6GJzKs7T7qvQggW9g8Pdw ($50.75 in chips)
Seat 2: RjBdQ6w31rgcy0o24VLR6w ($8.75 in chips)
Seat 3: xZCXQSXlrZkp3pZizzVXCw ($49 in chips)
Seat 4: U7aZzIYWjv3SL30KtikLbw ($49.45 in chips)
Seat 5: JwvquocWfhTVApN5t47LgA ($51.05 in chips)
Seat 6: zE9cVigS2nW/Ljy4K4bUQA ($31.35 in chips)
Seat 7: 90Wb75h3W1BRpbqVnuk8gw ($50 in chips)
Seat 8: ajP1NjIMdqQfpMbzHzvejw ($52.80 in chips)
Seat 9: J0W5D97jl5VLky+IoPvDeA ($68.55 in chips)
90Wb75h3W1BRpbqVnuk8gw: posts small blind $0.25
ajP1NjIMdqQfpMbzHzvejw: posts big blind $0.50
*** HOLE CARDS ***
J0W5D97jl5VLky+IoPvDeA: folds
k6GJzKs7T7qvQggW9g8Pdw: calls $0.50
RjBdQ6w31rgcy0o24VLR6w: folds
xZCXQSXlrZkp3pZizzVXCw: folds
U7aZzIYWjv3SL30KtikLbw: folds
JwvquocWfhTVApN5t47LgA: folds
zE9cVigS2nW/Ljy4K4bUQA: folds
90Wb75h3W1BRpbqVnuk8gw: calls $0.25
ajP1NjIMdqQfpMbzHzvejw: checks
*** FLOP *** [2d 6h 8d]
90Wb75h3W1BRpbqVnuk8gw: bets $1.50
ajP1NjIMdqQfpMbzHzvejw: calls $1.50
k6GJzKs7T7qvQggW9g8Pdw: calls $1.50
*** TURN *** [2d 6h 8d] [Jc]
90Wb75h3W1BRpbqVnuk8gw: bets $4
ajP1NjIMdqQfpMbzHzvejw: calls $4
k6GJzKs7T7qvQggW9g8Pdw: folds
*** RIVER *** [2d 6h 8d Jc] [Jd]
90Wb75h3W1BRpbqVnuk8gw: checks
ajP1NjIMdqQfpMbzHzvejw: bets $8
90Wb75h3W1BRpbqVnuk8gw: calls $8
*** SHOW DOWN ***
ajP1NjIMdqQfpMbzHzvejw: shows [7s 9d] (a pair of Jacks)
90Wb75h3W1BRpbqVnuk8gw: shows [8c Ac] (two pair, Jacks and Eights)
90Wb75h3W1BRpbqVnuk8gw collected $28.55 from pot
*** SUMMARY ***
Total pot $30 | Rake $1.45
Board [2d 6h 8d Jc Jd]
Seat 1: k6GJzKs7T7qvQggW9g8Pdw folded on the Turn
Seat 2: RjBdQ6w31rgcy0o24VLR6w folded before Flop (didn't bet)
Seat 3: xZCXQSXlrZkp3pZizzVXCw folded before Flop (didn't bet)
Seat 4: U7aZzIYWjv3SL30KtikLbw folded before Flop (didn't bet)
Seat 5: JwvquocWfhTVApN5t47LgA folded before Flop (didn't bet)
Seat 6: zE9cVigS2nW/Ljy4K4bUQA (button) folded before Flop (didn't bet)
Seat 7: 90Wb75h3W1BRpbqVnuk8gw (small blind) showed [8c Ac] and won ($28.55) with two pair, Jacks and Eights
Seat 8: ajP1NjIMdqQfpMbzHzvejw (big blind) showed [7s 9d] and lost with a pair of Jacks
Seat 9: J0W5D97jl5VLky+IoPvDeA folded before Flop (didn't bet)



PokerStars Game #59937898392:  Hold'em No Limit ($0.25/$0.50) - 2009/07/01 0:02:23 ET
Table 'GfL/No5u5PoEnU39lP5pQg' 6-max Seat #3 is the button
Seat 1: T0Gx/FcQ5VH9u7XaOMX97A ($50.75 in chips)
Seat 2: uVwggSetzp7d+eVgowO3vg ($20.80 in chips)
Seat 3: YmWlPGOKFuJSoJZPW8a8IA ($95.20 in chips)
Seat 4: yqM0AD7MZQd/cEtKdDQY1A ($34.90 in chips)
Seat 6: 5EiAo0XuFchfJkhvFPvoog ($65.95 in chips)
yqM0AD7MZQd/cEtKdDQY1A: posts small blind $0.25
5EiAo0XuFchfJkhvFPvoog: posts big blind $0.50
*** HOLE CARDS ***
fDiswuKb270PAYXkTIYC3g has returned
T0Gx/FcQ5VH9u7XaOMX97A: folds
uVwggSetzp7d+eVgowO3vg: folds
YmWlPGOKFuJSoJZPW8a8IA: raises $1 to $1.50
yqM0AD7MZQd/cEtKdDQY1A: folds
5EiAo0XuFchfJkhvFPvoog: folds
YmWlPGOKFuJSoJZPW8a8IA collected $1.25 from pot
YmWlPGOKFuJSoJZPW8a8IA: doesn't show hand
*** SUMMARY ***
Total pot $1.25 | Rake $0
Seat 1: T0Gx/FcQ5VH9u7XaOMX97A folded before Flop (didn't bet)
Seat 2: uVwggSetzp7d+eVgowO3vg folded before Flop (didn't bet)
Seat 3: YmWlPGOKFuJSoJZPW8a8IA (button) collected ($1.25)
Seat 4: yqM0AD7MZQd/cEtKdDQY1A (small blind) folded before Flop
Seat 6: 5EiAo0XuFchfJkhvFPvoog (big blind) folded before Flop



PokerStars Game #59937898548:  Hold'em No Limit ($0.25/$0.50) - 2009/07/01 0:02:23 ET
Table 'Vdlc9wqYcHTUhtdyN7CuJw' 2-max Seat #2 is the button
Seat 1: yBO+mXB6m/rCft2ErwGf/Q ($63.65 in chips)
Seat 2: sa0qgETiL3HNbdfGlnKHTA ($51.45 in chips)
sa0qgETiL3HNbdfGlnKHTA: posts small blind $0.25
yBO+mXB6m/rCft2ErwGf/Q: posts big blind $0.50
*** HOLE CARDS ***
sa0qgETiL3HNbdfGlnKHTA: raises $1 to $1.50
yBO+mXB6m/rCft2ErwGf/Q: calls $1
*** FLOP *** [8d 4h Ah]
yBO+mXB6m/rCft2ErwGf/Q: checks
sa0qgETiL3HNbdfGlnKHTA: checks
*** TURN *** [8d 4h Ah] [7h]
yBO+mXB6m/rCft2ErwGf/Q: checks
sa0qgETiL3HNbdfGlnKHTA: checks
*** RIVER *** [8d 4h Ah 7h] [5c]
yBO+mXB6m/rCft2ErwGf/Q: checks
sa0qgETiL3HNbdfGlnKHTA: checks
*** SHOW DOWN ***
yBO+mXB6m/rCft2ErwGf/Q: shows [3c 4d] (a pair of Fours)
sa0qgETiL3HNbdfGlnKHTA: mucks hand
yBO+mXB6m/rCft2ErwGf/Q collected $2.85 from pot
*** SUMMARY ***
Total pot $3 | Rake $0.15
Board [8d 4h Ah 7h 5c]
Seat 1: yBO+mXB6m/rCft2ErwGf/Q (big blind) showed [3c 4d] and won ($2.85) with a pair of Fours
Seat 2: sa0qgETiL3HNbdfGlnKHTA (button) (small blind) mucked



PokerStars Game #59937900002:  Hold'em No Limit ($0.25/$0.50) - 2009/07/01 0:02:25 ET
Table 'E7bWJ45aoFXRpyRv2gw+Ig' 2-max Seat #2 is the button
Seat 1: FRkiRasEGlHUeLrEl+k/nA ($51.95 in chips)
Seat 2: 3Wro85I7472vJ4Wkpneo9A ($74.35 in chips)
3Wro85I7472vJ4Wkpneo9A: posts small blind $0.25
FRkiRasEGlHUeLrEl+k/nA: posts big blind $0.50
*** HOLE CARDS ***
3Wro85I7472vJ4Wkpneo9A: calls $0.25
FRkiRasEGlHUeLrEl+k/nA: raises $1.50 to $2
3Wro85I7472vJ4Wkpneo9A: folds
FRkiRasEGlHUeLrEl+k/nA collected $1 from pot
*** SUMMARY ***
Total pot $1 | Rake $0
Seat 1: FRkiRasEGlHUeLrEl+k/nA (big blind) collected ($1)
Seat 2: 3Wro85I7472vJ4Wkpneo9A (button) (small blind) folded before Flop



PokerStars Game #59937900200:  Hold'em No Limit ($0.25/$0.50) - 2009/07/01 0:02:26 ET
Table 'SsXEKOwKN+jE3etfusqUqA' 2-max Seat #1 is the button
Seat 1: 618rKeLrz/avGNOLULHHVQ ($78.50 in chips)
Seat 2: XfRhywXA6Br+jID1oGeo8A ($118.05 in chips)
618rKeLrz/avGNOLULHHVQ: posts small blind $0.25
XfRhywXA6Br+jID1oGeo8A: posts big blind $0.50
*** HOLE CARDS ***
618rKeLrz/avGNOLULHHVQ said, "only aces call"
618rKeLrz/avGNOLULHHVQ said, "but wp"
618rKeLrz/avGNOLULHHVQ: raises $1 to $1.50
XfRhywXA6Br+jID1oGeo8A: folds
618rKeLrz/avGNOLULHHVQ collected $1 from pot
618rKeLrz/avGNOLULHHVQ: doesn't show hand
*** SUMMARY ***
Total pot $1 | Rake $0
Seat 1: 618rKeLrz/avGNOLULHHVQ (button) (small blind) collected ($1)
Seat 2: XfRhywXA6Br+jID1oGeo8A (big blind) folded before Flop



PokerStars Game #59937900626:  Hold'em No Limit ($0.25/$0.50) - 2009/07/01 0:02:26 ET
Table 'tpZbcIvqh/6WmfR/i5IE3A' 9-max Seat #2 is the button
Seat 1: nV/P1jFY/CFMXOLWu7pYmA ($14.45 in chips)
Seat 2: M+7+BTmX5vZatHVuoRB1nA ($51.40 in chips)
Seat 3: 3w0FbBQAKwQODwenKwZxXw ($68.45 in chips)
Seat 4: zE9cVigS2nW/Ljy4K4bUQA ($30 in chips)
Seat 5: 9r7ZoBbAJj5IeyZ0q9BdzA ($13.70 in chips)
Seat 6: E2518gp4aFz1+kAgmGqeEg ($12.20 in chips)
Seat 7: wIZ377kjl2fHFGnS93o6bw ($15.95 in chips)
Seat 8: bXpVeaSTPBFSPJmeXxO7nw ($9.85 in chips)
3w0FbBQAKwQODwenKwZxXw: posts small blind $0.25
zE9cVigS2nW/Ljy4K4bUQA: posts big blind $0.50
*** HOLE CARDS ***
9r7ZoBbAJj5IeyZ0q9BdzA: calls $0.50
E2518gp4aFz1+kAgmGqeEg: folds
wIZ377kjl2fHFGnS93o6bw: calls $0.50
bXpVeaSTPBFSPJmeXxO7nw: folds
nV/P1jFY/CFMXOLWu7pYmA: folds
M+7+BTmX5vZatHVuoRB1nA: calls $0.50
3w0FbBQAKwQODwenKwZxXw: calls $0.25
zE9cVigS2nW/Ljy4K4bUQA: checks
*** FLOP *** [8h 2h 5d]
3w0FbBQAKwQODwenKwZxXw: bets $2
zE9cVigS2nW/Ljy4K4bUQA: folds
9r7ZoBbAJj5IeyZ0q9BdzA: folds
wIZ377kjl2fHFGnS93o6bw: folds
M+7+BTmX5vZatHVuoRB1nA: calls $2
*** TURN *** [8h 2h 5d] [9c]
3w0FbBQAKwQODwenKwZxXw: bets $3
M+7+BTmX5vZatHVuoRB1nA: calls $3
*** RIVER *** [8h 2h 5d 9c] [8d]
3w0FbBQAKwQODwenKwZxXw: checks
M+7+BTmX5vZatHVuoRB1nA: checks
*** SHOW DOWN ***
3w0FbBQAKwQODwenKwZxXw: shows [Ts Tc] (two pair, Tens and Eights)
M+7+BTmX5vZatHVuoRB1nA: mucks hand
3w0FbBQAKwQODwenKwZxXw collected $11.90 from pot
*** SUMMARY ***
Total pot $12.50 | Rake $0.60
Board [8h 2h 5d 9c 8d]
Seat 1: nV/P1jFY/CFMXOLWu7pYmA folded before Flop (didn't bet)
Seat 2: M+7+BTmX5vZatHVuoRB1nA (button) mucked
Seat 3: 3w0FbBQAKwQODwenKwZxXw (small blind) showed [Ts Tc] and won ($11.90) with two pair, Tens and Eights
Seat 4: zE9cVigS2nW/Ljy4K4bUQA (big blind) folded on the Flop
Seat 5: 9r7ZoBbAJj5IeyZ0q9BdzA folded on the Flop
Seat 6: E2518gp4aFz1+kAgmGqeEg folded before Flop (didn't bet)
Seat 7: wIZ377kjl2fHFGnS93o6bw folded on the Flop
Seat 8: bXpVeaSTPBFSPJmeXxO7nw folded before Flop (didn't bet)



PokerStars Game #59937901166:  Hold'em No Limit ($0.25/$0.50) - 2009/07/01 0:02:27 ET
Table 'c/CRn+68J3Y8KxD5g1ek2Q' 2-max Seat #1 is the button
Seat 1: 46qCyJ6evTkHo9al5sBMNA ($318.40 in chips)
Seat 2: BypVLsYQt3ePFm2xQL/dOA ($70.35 in chips)
46qCyJ6evTkHo9al5sBMNA: posts small blind $0.25
BypVLsYQt3ePFm2xQL/dOA: posts big blind $0.50
*** HOLE CARDS ***
46qCyJ6evTkHo9al5sBMNA: raises $1.50 to $2
BypVLsYQt3ePFm2xQL/dOA: calls $1.50
*** FLOP *** [3h 7h Kd]
BypVLsYQt3ePFm2xQL/dOA: checks
46qCyJ6evTkHo9al5sBMNA: bets $2.50
BypVLsYQt3ePFm2xQL/dOA: folds
46qCyJ6evTkHo9al5sBMNA collected $3.80 from pot
46qCyJ6evTkHo9al5sBMNA: doesn't show hand
*** SUMMARY ***
Total pot $4 | Rake $0.20
Board [3h 7h Kd]
Seat 1: 46qCyJ6evTkHo9al5sBMNA (button) (small blind) collected ($3.80)
Seat 2: BypVLsYQt3ePFm2xQL/dOA (big blind) folded on the Flop



PokerStars Game #59937902132:  Hold'em No Limit ($0.25/$0.50) - 2009/07/01 0:02:28 ET
Table 'lSisgp6H7Fg1hH5VfjEjYQ' 9-max Seat #1 is the button
Seat 1: pEW8B6uXbdR47kfljMQ3+Q ($38.55 in chips)
Seat 2: UrcnkQOiLVk8BlKDPJSy7Q ($53.35 in chips)
Seat 3: RjBdQ6w31rgcy0o24VLR6w ($10.45 in chips)
Seat 4: nvw9yQKhJT56lA9k+TLdhw ($14.40 in chips)
Seat 5: mSD1pginDsyHG5PDfqzphw ($12.35 in chips)
Seat 6: +k7T5ocke8UwavtgUHm+Cg ($30 in chips)
Seat 7: xyQ4CeZa3ug3ompz+5xSTg ($74.70 in chips)
Seat 9: 5JJVDlaiMnB004o/RqbZZQ ($28.50 in chips)
UrcnkQOiLVk8BlKDPJSy7Q: posts small blind $0.25
RjBdQ6w31rgcy0o24VLR6w: posts big blind $0.50
bXpVeaSTPBFSPJmeXxO7nw: sits out
*** HOLE CARDS ***
nvw9yQKhJT56lA9k+TLdhw: calls $0.50
mSD1pginDsyHG5PDfqzphw: folds
+k7T5ocke8UwavtgUHm+Cg: folds
xyQ4CeZa3ug3ompz+5xSTg: folds
5JJVDlaiMnB004o/RqbZZQ: folds
pEW8B6uXbdR47kfljMQ3+Q: folds
UrcnkQOiLVk8BlKDPJSy7Q: folds
RjBdQ6w31rgcy0o24VLR6w: checks
*** FLOP *** [9c 8s Qs]
RjBdQ6w31rgcy0o24VLR6w: bets $1
nvw9yQKhJT56lA9k+TLdhw: calls $1
*** TURN *** [9c 8s Qs] [Ts]
RjBdQ6w31rgcy0o24VLR6w: bets $1.50
nvw9yQKhJT56lA9k+TLdhw: calls $1.50
*** RIVER *** [9c 8s Qs Ts] [5h]
RjBdQ6w31rgcy0o24VLR6w: bets $3.50
nvw9yQKhJT56lA9k+TLdhw: folds
RjBdQ6w31rgcy0o24VLR6w collected $5.95 from pot
RjBdQ6w31rgcy0o24VLR6w: doesn't show hand
*** SUMMARY ***
Total pot $6.25 | Rake $0.30
Board [9c 8s Qs Ts 5h]
Seat 1: pEW8B6uXbdR47kfljMQ3+Q (button) folded before Flop (didn't bet)
Seat 2: UrcnkQOiLVk8BlKDPJSy7Q (small blind) folded before Flop
Seat 3: RjBdQ6w31rgcy0o24VLR6w (big blind) collected ($5.95)
Seat 4: nvw9yQKhJT56lA9k+TLdhw folded on the River
Seat 5: mSD1pginDsyHG5PDfqzphw folded before Flop (didn't bet)
Seat 6: +k7T5ocke8UwavtgUHm+Cg folded before Flop (didn't bet)
Seat 7: xyQ4CeZa3ug3ompz+5xSTg folded before Flop (didn't bet)
Seat 9: 5JJVDlaiMnB004o/RqbZZQ folded before Flop (didn't bet)



PokerStars Game #59937904724:  Hold'em No Limit ($0.25/$0.50) - 2009/07/01 0:02:32 ET
Table 'ibNfFy0bCzuBaUORla0aGw' 9-max Seat #4 is the button
Seat 1: xZCXQSXlrZkp3pZizzVXCw ($60.95 in chips)
Seat 2: 90Wb75h3W1BRpbqVnuk8gw ($50 in chips)
Seat 3: dDaHs3X8+fe3bIkRU0cbrw ($22.20 in chips)
Seat 4: YBN054X4blmis+B2bBlC0g ($22.20 in chips)
Seat 5: FRv75HO8CUsRZ1byEz06mQ ($15.60 in chips)
Seat 6: BmYrv3ec2k5d6pQq6iNaZw ($67 in chips)
Seat 7: mSD1pginDsyHG5PDfqzphw ($10 in chips)
Seat 8: xUrN9TWLq4m5V+OXY7KUUA ($50.50 in chips)
Seat 9: WpvT3OUSiZlpvs+mPXFqtQ ($8 in chips)
FRv75HO8CUsRZ1byEz06mQ: posts small blind $0.25
BmYrv3ec2k5d6pQq6iNaZw: posts big blind $0.50
*** HOLE CARDS ***
mSD1pginDsyHG5PDfqzphw: folds
xUrN9TWLq4m5V+OXY7KUUA: folds
WpvT3OUSiZlpvs+mPXFqtQ: folds
xZCXQSXlrZkp3pZizzVXCw: raises $1 to $1.50
90Wb75h3W1BRpbqVnuk8gw: folds
dDaHs3X8+fe3bIkRU0cbrw: calls $1.50
YBN054X4blmis+B2bBlC0g: folds
FRv75HO8CUsRZ1byEz06mQ: folds
BmYrv3ec2k5d6pQq6iNaZw: folds
*** FLOP *** [Jd 5s Qd]
xZCXQSXlrZkp3pZizzVXCw: bets $2.50
dDaHs3X8+fe3bIkRU0cbrw: raises $4.50 to $7
xZCXQSXlrZkp3pZizzVXCw: folds
dDaHs3X8+fe3bIkRU0cbrw collected $8.35 from pot
*** SUMMARY ***
Total pot $8.75 | Rake $0.40
Board [Jd 5s Qd]
Seat 1: xZCXQSXlrZkp3pZizzVXCw folded on the Flop
Seat 2: 90Wb75h3W1BRpbqVnuk8gw folded before Flop (didn't bet)
Seat 3: dDaHs3X8+fe3bIkRU0cbrw collected ($8.35)
Seat 4: YBN054X4blmis+B2bBlC0g (button) folded before Flop (didn't bet)
Seat 5: FRv75HO8CUsRZ1byEz06mQ (small blind) folded before Flop
Seat 6: BmYrv3ec2k5d6pQq6iNaZw (big blind) folded before Flop
Seat 7: mSD1pginDsyHG5PDfqzphw folded before Flop (didn't bet)
Seat 8: xUrN9TWLq4m5V+OXY7KUUA folded before Flop (didn't bet)
Seat 9: WpvT3OUSiZlpvs+mPXFqtQ folded before Flop (didn't bet)



PokerStars Game #59937905216:  Hold'em No Limit ($0.25/$0.50) - 2009/07/01 0:02:33 ET
Table 'mTxf8gPLgffN3Iwfm7Icfg' 2-max Seat #2 is the button
Seat 1: Do9Rlu1R5u/AcRtMTl8SYg ($64.65 in chips)
Seat 2: EMc5LPgVaded4Qc77vm0fw ($51.15 in chips)
EMc5LPgVaded4Qc77vm0fw: posts small blind $0.25
Do9Rlu1R5u/AcRtMTl8SYg: posts big blind $0.50
*** HOLE CARDS ***
EMc5LPgVaded4Qc77vm0fw: raises $1.50 to $2
Do9Rlu1R5u/AcRtMTl8SYg: folds
EMc5LPgVaded4Qc77vm0fw collected $1 from pot
EMc5LPgVaded4Qc77vm0fw: doesn't show hand
*** SUMMARY ***
Total pot $1 | Rake $0
Seat 1: Do9Rlu1R5u/AcRtMTl8SYg (big blind) folded before Flop
Seat 2: EMc5LPgVaded4Qc77vm0fw (button) (small blind) collected ($1)



PokerStars Game #59937906786:  Hold'em No Limit ($0.25/$0.50) - 2009/07/01 0:02:35 ET
Table 'SsXEKOwKN+jE3etfusqUqA' 2-max Seat #2 is the button
Seat 1: 618rKeLrz/avGNOLULHHVQ ($79 in chips)
Seat 2: XfRhywXA6Br+jID1oGeo8A ($117.55 in chips)
XfRhywXA6Br+jID1oGeo8A: posts small blind $0.25
618rKeLrz/avGNOLULHHVQ: posts big blind $0.50
*** HOLE CARDS ***
XfRhywXA6Br+jID1oGeo8A: raises $0.50 to $1
618rKeLrz/avGNOLULHHVQ: calls $0.50
*** FLOP *** [9c 2h 9h]
618rKeLrz/avGNOLULHHVQ: checks
XfRhywXA6Br+jID1oGeo8A: checks
*** TURN *** [9c 2h 9h] [Ts]
618rKeLrz/avGNOLULHHVQ: bets $0.50
XfRhywXA6Br+jID1oGeo8A: calls $0.50
*** RIVER *** [9c 2h 9h Ts] [4c]
618rKeLrz/avGNOLULHHVQ: bets $2
XfRhywXA6Br+jID1oGeo8A: folds
618rKeLrz/avGNOLULHHVQ collected $2.90 from pot
618rKeLrz/avGNOLULHHVQ: doesn't show hand
*** SUMMARY ***
Total pot $3 | Rake $0.10
Board [9c 2h 9h Ts 4c]
Seat 1: 618rKeLrz/avGNOLULHHVQ (big blind) collected ($2.90)
Seat 2: XfRhywXA6Br+jID1oGeo8A (button) (small blind) folded on the River



PokerStars Game #59937906700:  Hold'em No Limit ($0.25/$0.50) - 2009/07/01 0:02:35 ET
Table 'raOT4/ipuZgzjfKHC+jD9g' 2-max Seat #1 is the button
Seat 1: IuwLemwLhc9fvrwBGs0AMA ($9.15 in chips)
Seat 2: Udr5juWSWUgTu1NlRhjMdA ($15.20 in chips)
IuwLemwLhc9fvrwBGs0AMA: posts small blind $0.25
Udr5juWSWUgTu1NlRhjMdA: posts big blind $0.50
*** HOLE CARDS ***
IuwLemwLhc9fvrwBGs0AMA: raises $1.50 to $2
Udr5juWSWUgTu1NlRhjMdA: folds
IuwLemwLhc9fvrwBGs0AMA collected $1 from pot
IuwLemwLhc9fvrwBGs0AMA: doesn't show hand
*** SUMMARY ***
Total pot $1 | Rake $0
Seat 1: IuwLemwLhc9fvrwBGs0AMA (button) (small blind) collected ($1)
Seat 2: Udr5juWSWUgTu1NlRhjMdA (big blind) folded before Flop



PokerStars Game #59937907764:  Hold'em No Limit ($0.25/$0.50) - 2009/07/01 0:02:36 ET
Table '5EmHi+fnatGQQShcNmzOZQ' 6-max Seat #3 is the button
Seat 1: SwPczQo3cOtwEzhJrfO2cQ ($18.40 in chips)
Seat 3: J8dF2sYMvXUmAGUuSW9kwg ($38.85 in chips)
Seat 4: mFTuMjESuBcXHQ1ePkg/8A ($21.80 in chips)
Seat 5: kxPhs4ePFqMy52CInAJ2aw ($73.80 in chips)
Seat 6: 686aeHikcJlgKkSuIFdcXQ ($112.30 in chips)
mFTuMjESuBcXHQ1ePkg/8A: posts small blind $0.25
kxPhs4ePFqMy52CInAJ2aw: posts big blind $0.50
*** HOLE CARDS ***
686aeHikcJlgKkSuIFdcXQ: folds
SwPczQo3cOtwEzhJrfO2cQ has timed out
SwPczQo3cOtwEzhJrfO2cQ: folds
SwPczQo3cOtwEzhJrfO2cQ is sitting out
J8dF2sYMvXUmAGUuSW9kwg: calls $0.50
mFTuMjESuBcXHQ1ePkg/8A: folds
kxPhs4ePFqMy52CInAJ2aw: checks
*** FLOP *** [8c 6d 3s]
SwPczQo3cOtwEzhJrfO2cQ has returned
kxPhs4ePFqMy52CInAJ2aw: checks
J8dF2sYMvXUmAGUuSW9kwg: bets $1
kxPhs4ePFqMy52CInAJ2aw: folds
J8dF2sYMvXUmAGUuSW9kwg collected $1.20 from pot
*** SUMMARY ***
Total pot $1.25 | Rake $0.05
Board [8c 6d 3s]
Seat 1: SwPczQo3cOtwEzhJrfO2cQ folded before Flop (didn't bet)
Seat 3: J8dF2sYMvXUmAGUuSW9kwg (button) collected ($1.20)
Seat 4: mFTuMjESuBcXHQ1ePkg/8A (small blind) folded before Flop
Seat 5: kxPhs4ePFqMy52CInAJ2aw (big blind) folded on the Flop
Seat 6: 686aeHikcJlgKkSuIFdcXQ folded before Flop (didn't bet)



PokerStars Game #59937907340:  Hold'em No Limit ($0.25/$0.50) - 2009/07/01 0:02:36 ET
Table 'kgbJRsxfv64KrErDRBAkcw' 6-max Seat #1 is the button
Seat 1: YmWlPGOKFuJSoJZPW8a8IA ($82.55 in chips)
Seat 3: T0Gx/FcQ5VH9u7XaOMX97A ($61.45 in chips)
Seat 4: qanMEqjABjWxC/JgQ/0l7w ($50 in chips)
Seat 5: SlTdlH14u+KVVINgxMwt+Q ($76.70 in chips)
Seat 6: DDfYzIrYT0t5R/hAJngtsg ($28.15 in chips)
Q+thC23WCv1kJUJtH/+4Jw will be allowed to play after the button
T0Gx/FcQ5VH9u7XaOMX97A: posts small blind $0.25
qanMEqjABjWxC/JgQ/0l7w: posts big blind $0.50
*** HOLE CARDS ***
SlTdlH14u+KVVINgxMwt+Q: folds
DDfYzIrYT0t5R/hAJngtsg: calls $0.50
YmWlPGOKFuJSoJZPW8a8IA: folds
T0Gx/FcQ5VH9u7XaOMX97A: calls $0.25
qanMEqjABjWxC/JgQ/0l7w: checks
*** FLOP *** [Qs Td Ah]
T0Gx/FcQ5VH9u7XaOMX97A: checks
qanMEqjABjWxC/JgQ/0l7w: checks
DDfYzIrYT0t5R/hAJngtsg: checks
*** TURN *** [Qs Td Ah] [2h]
T0Gx/FcQ5VH9u7XaOMX97A: checks
qanMEqjABjWxC/JgQ/0l7w: checks
DDfYzIrYT0t5R/hAJngtsg: checks
*** RIVER *** [Qs Td Ah 2h] [Ks]
T0Gx/FcQ5VH9u7XaOMX97A: checks
qanMEqjABjWxC/JgQ/0l7w: checks
DDfYzIrYT0t5R/hAJngtsg: checks
*** SHOW DOWN ***
T0Gx/FcQ5VH9u7XaOMX97A: shows [4s 4h] (a pair of Fours)
qanMEqjABjWxC/JgQ/0l7w: mucks hand
DDfYzIrYT0t5R/hAJngtsg: mucks hand
T0Gx/FcQ5VH9u7XaOMX97A collected $1.45 from pot
*** SUMMARY ***
Total pot $1.50 | Rake $0.05
Board [Qs Td Ah 2h Ks]
Seat 1: YmWlPGOKFuJSoJZPW8a8IA (button) folded before Flop (didn't bet)
Seat 3: T0Gx/FcQ5VH9u7XaOMX97A (small blind) showed [4s 4h] and won ($1.45) with a pair of Fours
Seat 4: qanMEqjABjWxC/JgQ/0l7w (big blind) mucked
Seat 5: SlTdlH14u+KVVINgxMwt+Q folded before Flop (didn't bet)
Seat 6: DDfYzIrYT0t5R/hAJngtsg mucked



PokerStars Game #59937908128:  Hold'em No Limit ($0.25/$0.50) - 2009/07/01 0:02:37 ET
Table 'E7bWJ45aoFXRpyRv2gw+Ig' 2-max Seat #1 is the button
Seat 1: FRkiRasEGlHUeLrEl+k/nA ($52.45 in chips)
Seat 2: 3Wro85I7472vJ4Wkpneo9A ($73.85 in chips)
FRkiRasEGlHUeLrEl+k/nA: posts small blind $0.25
3Wro85I7472vJ4Wkpneo9A: posts big blind $0.50
*** HOLE CARDS ***
FRkiRasEGlHUeLrEl+k/nA: calls $0.25
3Wro85I7472vJ4Wkpneo9A: checks
*** FLOP *** [3s As 6s]
3Wro85I7472vJ4Wkpneo9A: bets $1
FRkiRasEGlHUeLrEl+k/nA: calls $1
*** TURN *** [3s As 6s] [Td]
3Wro85I7472vJ4Wkpneo9A: checks
FRkiRasEGlHUeLrEl+k/nA: checks
*** RIVER *** [3s As 6s Td] [4c]
3Wro85I7472vJ4Wkpneo9A: checks
FRkiRasEGlHUeLrEl+k/nA: checks
*** SHOW DOWN ***
3Wro85I7472vJ4Wkpneo9A: shows [2d Jc] (high card Ace)
FRkiRasEGlHUeLrEl+k/nA: shows [Qs 8d] (high card Ace - Queen kicker)
FRkiRasEGlHUeLrEl+k/nA collected $2.90 from pot
*** SUMMARY ***
Total pot $3 | Rake $0.10
Board [3s As 6s Td 4c]
Seat 1: FRkiRasEGlHUeLrEl+k/nA (button) (small blind) showed [Qs 8d] and won ($2.90) with high card Ace
Seat 2: 3Wro85I7472vJ4Wkpneo9A (big blind) showed [2d Jc] and lost with high card Ace



PokerStars Game #59937908034:  Hold'em No Limit ($0.25/$0.50) - 2009/07/01 0:02:37 ET
Table 'iq+aXfWVQRdV0u8SRTYUEg' 9-max Seat #6 is the button
Seat 1: McPJctgiiz9IXq3OttAeOA ($14.30 in chips)
Seat 3: itOQCm2+5ujaA68I6hPvfg ($123 in chips)
Seat 4: +Z4e6ELfE9slw801LJ3vAw ($13.50 in chips)
Seat 5: MZo49KUcOZcn7g/WRL0Vqw ($44.90 in chips)
Seat 6: 8qvUviDc+VoNV1cmSHjjLw ($29.90 in chips)
Seat 7: SKnJuWHScqetA/qG5p+wCg ($30 in chips)
Seat 8: k1f0lS7tlMHCLGs0JT34Tg ($10 in chips)
Seat 9: bXpVeaSTPBFSPJmeXxO7nw ($11.60 in chips)
SKnJuWHScqetA/qG5p+wCg: posts small blind $0.25
k1f0lS7tlMHCLGs0JT34Tg: posts big blind $0.50
*** HOLE CARDS ***
bXpVeaSTPBFSPJmeXxO7nw: folds
McPJctgiiz9IXq3OttAeOA: raises $0.50 to $1
itOQCm2+5ujaA68I6hPvfg: folds
+Z4e6ELfE9slw801LJ3vAw: calls $1
MZo49KUcOZcn7g/WRL0Vqw: folds
8qvUviDc+VoNV1cmSHjjLw: folds
SKnJuWHScqetA/qG5p+wCg: folds
k1f0lS7tlMHCLGs0JT34Tg: raises $0.50 to $1.50
McPJctgiiz9IXq3OttAeOA: raises $0.50 to $2
+Z4e6ELfE9slw801LJ3vAw: calls $1
k1f0lS7tlMHCLGs0JT34Tg: raises $0.50 to $2.50
McPJctgiiz9IXq3OttAeOA: raises $1.50 to $4
+Z4e6ELfE9slw801LJ3vAw: raises $9.50 to $13.50 and is all-in
k1f0lS7tlMHCLGs0JT34Tg: calls $7.50 and is all-in
McPJctgiiz9IXq3OttAeOA: calls $9.50
*** FLOP *** [2d 3d 2s]
*** TURN *** [2d 3d 2s] [4s]
*** RIVER *** [2d 3d 2s 4s] [Ah]
*** SHOW DOWN ***
McPJctgiiz9IXq3OttAeOA: shows [Ks Kd] (two pair, Kings and Deuces)
+Z4e6ELfE9slw801LJ3vAw: mucks hand
McPJctgiiz9IXq3OttAeOA collected $6.65 from side pot
k1f0lS7tlMHCLGs0JT34Tg: shows [As Ac] (a full house, Aces full of Deuces)
k1f0lS7tlMHCLGs0JT34Tg collected $28.75 from main pot
*** SUMMARY ***
Total pot $37.25 Main pot $28.75. Side pot $6.65. | Rake $1.85
Board [2d 3d 2s 4s Ah]
Seat 1: McPJctgiiz9IXq3OttAeOA showed [Ks Kd] and won ($6.65) with two pair, Kings and Deuces
Seat 3: itOQCm2+5ujaA68I6hPvfg folded before Flop (didn't bet)
Seat 4: +Z4e6ELfE9slw801LJ3vAw mucked
Seat 5: MZo49KUcOZcn7g/WRL0Vqw folded before Flop (didn't bet)
Seat 6: 8qvUviDc+VoNV1cmSHjjLw (button) folded before Flop (didn't bet)
Seat 7: SKnJuWHScqetA/qG5p+wCg (small blind) folded before Flop
Seat 8: k1f0lS7tlMHCLGs0JT34Tg (big blind) showed [As Ac] and won ($28.75) with a full house, Aces full of Deuces
Seat 9: bXpVeaSTPBFSPJmeXxO7nw folded before Flop (didn't bet)



PokerStars Game #59937908878:  Hold'em No Limit ($0.25/$0.50) - 2009/07/01 0:02:38 ET
Table 'GfL/No5u5PoEnU39lP5pQg' 6-max Seat #4 is the button
Seat 1: T0Gx/FcQ5VH9u7XaOMX97A ($50.75 in chips)
Seat 2: uVwggSetzp7d+eVgowO3vg ($20.80 in chips)
Seat 3: YmWlPGOKFuJSoJZPW8a8IA ($95.95 in chips)
Seat 4: yqM0AD7MZQd/cEtKdDQY1A ($34.65 in chips)
Seat 6: 5EiAo0XuFchfJkhvFPvoog ($65.45 in chips)
fDiswuKb270PAYXkTIYC3g will be allowed to play after the button
5EiAo0XuFchfJkhvFPvoog: posts small blind $0.25
T0Gx/FcQ5VH9u7XaOMX97A: posts big blind $0.50
*** HOLE CARDS ***
uVwggSetzp7d+eVgowO3vg: folds
YmWlPGOKFuJSoJZPW8a8IA: folds
yqM0AD7MZQd/cEtKdDQY1A: folds
fDiswuKb270PAYXkTIYC3g said, "what do you do?"
5EiAo0XuFchfJkhvFPvoog: folds
T0Gx/FcQ5VH9u7XaOMX97A collected $0.50 from pot
T0Gx/FcQ5VH9u7XaOMX97A: doesn't show hand
*** SUMMARY ***
Total pot $0.50 | Rake $0
Seat 1: T0Gx/FcQ5VH9u7XaOMX97A (big blind) collected ($0.50)
Seat 2: uVwggSetzp7d+eVgowO3vg folded before Flop (didn't bet)
Seat 3: YmWlPGOKFuJSoJZPW8a8IA folded before Flop (didn't bet)
Seat 4: yqM0AD7MZQd/cEtKdDQY1A (button) folded before Flop (didn't bet)
Seat 6: 5EiAo0XuFchfJkhvFPvoog (small blind) folded before Flop



PokerStars Game #59937909618:  Hold'em No Limit ($0.25/$0.50) - 2009/07/01 0:02:39 ET
Table '+dXkOAQyS8j9PQZusUTMpg' 2-max Seat #1 is the button
Seat 1: XFa6sBGjP2gxoIvxR3fZIg ($82.20 in chips)
Seat 2: 5IBeOgaApY1Bvzv2P8X4EA ($20.40 in chips)
XFa6sBGjP2gxoIvxR3fZIg: posts small blind $0.25
5IBeOgaApY1Bvzv2P8X4EA: posts big blind $0.50
*** HOLE CARDS ***
5IBeOgaApY1Bvzv2P8X4EA said, "nh"
XFa6sBGjP2gxoIvxR3fZIg: folds
5IBeOgaApY1Bvzv2P8X4EA collected $0.50 from pot
5IBeOgaApY1Bvzv2P8X4EA: doesn't show hand
*** SUMMARY ***
Total pot $0.50 | Rake $0
Seat 1: XFa6sBGjP2gxoIvxR3fZIg (button) (small blind) folded before Flop
Seat 2: 5IBeOgaApY1Bvzv2P8X4EA (big blind) collected ($0.50)



PokerStars Game #59937911810:  Hold'em No Limit ($0.25/$0.50) - 2009/07/01 0:02:42 ET
Table 'mTxf8gPLgffN3Iwfm7Icfg' 2-max Seat #1 is the button
Seat 1: Do9Rlu1R5u/AcRtMTl8SYg ($64.15 in chips)
Seat 2: EMc5LPgVaded4Qc77vm0fw ($51.65 in chips)
Do9Rlu1R5u/AcRtMTl8SYg: posts small blind $0.25
EMc5LPgVaded4Qc77vm0fw: posts big blind $0.50
*** HOLE CARDS ***
Do9Rlu1R5u/AcRtMTl8SYg: calls $0.25
EMc5LPgVaded4Qc77vm0fw: checks
*** FLOP *** [As Qs 9c]
EMc5LPgVaded4Qc77vm0fw: checks
Do9Rlu1R5u/AcRtMTl8SYg: checks
*** TURN *** [As Qs 9c] [8c]
EMc5LPgVaded4Qc77vm0fw: bets $1
Do9Rlu1R5u/AcRtMTl8SYg: folds
EMc5LPgVaded4Qc77vm0fw collected $0.95 from pot
EMc5LPgVaded4Qc77vm0fw: doesn't show hand
*** SUMMARY ***
Total pot $1 | Rake $0.05
Board [As Qs 9c 8c]
Seat 1: Do9Rlu1R5u/AcRtMTl8SYg (button) (small blind) folded on the Turn
Seat 2: EMc5LPgVaded4Qc77vm0fw (big blind) collected ($0.95)



PokerStars Game #59937913460:  Hold'em No Limit ($0.25/$0.50) - 2009/07/01 0:02:44 ET
Table 'MJxeZCzYELxiIsyUZyT0jw' 6-max Seat #6 is the button
Seat 1: iKPos8JI094Tomq4tDSgnQ ($20.75 in chips)
Seat 2: r6H1GiZ6QIpMTDhyodKuRQ ($66.65 in chips)
Seat 3: JQZew0FjzS19kTjeNtrE+A ($56.40 in chips)
Seat 4: lP7Q6pewz4C2RsAfKsjdWw ($26.30 in chips)
Seat 6: TTx3CHxyi0SObcHyMJRp5w ($41.70 in chips)
iKPos8JI094Tomq4tDSgnQ: posts small blind $0.25
r6H1GiZ6QIpMTDhyodKuRQ: posts big blind $0.50
*** HOLE CARDS ***
JQZew0FjzS19kTjeNtrE+A: raises $1.50 to $2
lP7Q6pewz4C2RsAfKsjdWw: folds
TTx3CHxyi0SObcHyMJRp5w: folds
iKPos8JI094Tomq4tDSgnQ: folds
r6H1GiZ6QIpMTDhyodKuRQ: folds
JQZew0FjzS19kTjeNtrE+A collected $1.25 from pot
*** SUMMARY ***
Total pot $1.25 | Rake $0
Seat 1: iKPos8JI094Tomq4tDSgnQ (small blind) folded before Flop
Seat 2: r6H1GiZ6QIpMTDhyodKuRQ (big blind) folded before Flop
Seat 3: JQZew0FjzS19kTjeNtrE+A collected ($1.25)
Seat 4: lP7Q6pewz4C2RsAfKsjdWw folded before Flop (didn't bet)
Seat 6: TTx3CHxyi0SObcHyMJRp5w (button) folded before Flop (didn't bet)



PokerStars Game #59937914730:  Hold'em No Limit ($0.25/$0.50) - 2009/07/01 0:02:46 ET
Table 'eMxdLyFDf28E0wit6gm3Uw' 6-max Seat #2 is the button
Seat 1: tnD/64LagZ9qPaeOQVjVZg ($10.50 in chips)
Seat 2: jwuKQ1S3U4NnzMQn3E3dgw ($66.40 in chips)
Seat 4: crjGpJEzSZgD38FoE3VMGg ($50 in chips)
Seat 5: X0X97o2fDAPiGx6o1gahsw ($56.15 in chips)
Seat 6: L0aIPg7qefDQjdJo3HCVEA ($8.25 in chips)
crjGpJEzSZgD38FoE3VMGg: posts small blind $0.25
X0X97o2fDAPiGx6o1gahsw: posts big blind $0.50
*** HOLE CARDS ***
DzX7XiDmCFpp796ywj9jOg leaves the table
L0aIPg7qefDQjdJo3HCVEA: folds
tnD/64LagZ9qPaeOQVjVZg: folds
jwuKQ1S3U4NnzMQn3E3dgw: calls $0.50
crjGpJEzSZgD38FoE3VMGg: folds
X0X97o2fDAPiGx6o1gahsw: checks
*** FLOP *** [8s 8h Qd]
X0X97o2fDAPiGx6o1gahsw: checks
jwuKQ1S3U4NnzMQn3E3dgw: checks
*** TURN *** [8s 8h Qd] [Jc]
X0X97o2fDAPiGx6o1gahsw: bets $1.50
jwuKQ1S3U4NnzMQn3E3dgw: folds
X0X97o2fDAPiGx6o1gahsw collected $1.20 from pot
*** SUMMARY ***
Total pot $1.25 | Rake $0.05
Board [8s 8h Qd Jc]
Seat 1: tnD/64LagZ9qPaeOQVjVZg folded before Flop (didn't bet)
Seat 2: jwuKQ1S3U4NnzMQn3E3dgw (button) folded on the Turn
Seat 4: crjGpJEzSZgD38FoE3VMGg (small blind) folded before Flop
Seat 5: X0X97o2fDAPiGx6o1gahsw (big blind) collected ($1.20)
Seat 6: L0aIPg7qefDQjdJo3HCVEA folded before Flop (didn't bet)



PokerStars Game #59937914394:  Hold'em No Limit ($0.25/$0.50) - 2009/07/01 0:02:46 ET
Table '+dXkOAQyS8j9PQZusUTMpg' 2-max Seat #2 is the button
Seat 1: XFa6sBGjP2gxoIvxR3fZIg ($81.95 in chips)
Seat 2: 5IBeOgaApY1Bvzv2P8X4EA ($20.65 in chips)
5IBeOgaApY1Bvzv2P8X4EA: posts small blind $0.25
XFa6sBGjP2gxoIvxR3fZIg: posts big blind $0.50
*** HOLE CARDS ***
5IBeOgaApY1Bvzv2P8X4EA: folds
XFa6sBGjP2gxoIvxR3fZIg said, "it sure was"
XFa6sBGjP2gxoIvxR3fZIg collected $0.50 from pot
*** SUMMARY ***
Total pot $0.50 | Rake $0
Seat 1: XFa6sBGjP2gxoIvxR3fZIg (big blind) collected ($0.50)
Seat 2: 5IBeOgaApY1Bvzv2P8X4EA (button) (small blind) folded before Flop



PokerStars Game #59937916350:  Hold'em No Limit ($0.25/$0.50) - 2009/07/01 0:02:48 ET
Table 'YsnnHkamRzYqMOr2FlLY4w' 6-max Seat #6 is the button
Seat 1: crjGpJEzSZgD38FoE3VMGg ($54.80 in chips)
Seat 2: 2dIa62hMcn6g73rbkt9NwA ($63.60 in chips)
Seat 3: I+pG2m/dD5iYdbg9qx572g ($23.65 in chips)
Seat 4: 7Fue572p4ZIC85AJMQvaQw ($47.80 in chips)
Seat 5: lcQ7uuLf+WLGGy4Ve6VKKA ($44.25 in chips)
Seat 6: YmWlPGOKFuJSoJZPW8a8IA ($50 in chips)
crjGpJEzSZgD38FoE3VMGg: posts small blind $0.25
2dIa62hMcn6g73rbkt9NwA: posts big blind $0.50
*** HOLE CARDS ***
I+pG2m/dD5iYdbg9qx572g: folds
7Fue572p4ZIC85AJMQvaQw: calls $0.50
lcQ7uuLf+WLGGy4Ve6VKKA: calls $0.50
YmWlPGOKFuJSoJZPW8a8IA: folds
crjGpJEzSZgD38FoE3VMGg: calls $0.25
2dIa62hMcn6g73rbkt9NwA: checks
*** FLOP *** [4s 8s Ks]
crjGpJEzSZgD38FoE3VMGg: checks
2dIa62hMcn6g73rbkt9NwA: checks
7Fue572p4ZIC85AJMQvaQw: bets $0.50
lcQ7uuLf+WLGGy4Ve6VKKA: calls $0.50
crjGpJEzSZgD38FoE3VMGg: folds
2dIa62hMcn6g73rbkt9NwA: calls $0.50
*** TURN *** [4s 8s Ks] [Ah]
2dIa62hMcn6g73rbkt9NwA: checks
7Fue572p4ZIC85AJMQvaQw: checks
lcQ7uuLf+WLGGy4Ve6VKKA: bets $1
2dIa62hMcn6g73rbkt9NwA: folds
7Fue572p4ZIC85AJMQvaQw: calls $1
*** RIVER *** [4s 8s Ks Ah] [Th]
7Fue572p4ZIC85AJMQvaQw: checks
lcQ7uuLf+WLGGy4Ve6VKKA: checks
*** SHOW DOWN ***
7Fue572p4ZIC85AJMQvaQw: shows [2c 5c] (high card Ace)
lcQ7uuLf+WLGGy4Ve6VKKA: shows [Jh As] (a pair of Aces)
lcQ7uuLf+WLGGy4Ve6VKKA collected $5.25 from pot
*** SUMMARY ***
Total pot $5.50 | Rake $0.25
Board [4s 8s Ks Ah Th]
Seat 1: crjGpJEzSZgD38FoE3VMGg (small blind) folded on the Flop
Seat 2: 2dIa62hMcn6g73rbkt9NwA (big blind) folded on the Turn
Seat 3: I+pG2m/dD5iYdbg9qx572g folded before Flop (didn't bet)
Seat 4: 7Fue572p4ZIC85AJMQvaQw showed [2c 5c] and lost with high card Ace
Seat 5: lcQ7uuLf+WLGGy4Ve6VKKA showed [Jh As] and won ($5.25) with a pair of Aces
Seat 6: YmWlPGOKFuJSoJZPW8a8IA (button) folded before Flop (didn't bet)



PokerStars Game #59937916748:  Hold'em No Limit ($0.25/$0.50) - 2009/07/01 0:02:49 ET
Table 'raOT4/ipuZgzjfKHC+jD9g' 2-max Seat #2 is the button
Seat 1: IuwLemwLhc9fvrwBGs0AMA ($9.65 in chips)
Seat 2: Udr5juWSWUgTu1NlRhjMdA ($14.70 in chips)
Udr5juWSWUgTu1NlRhjMdA: posts small blind $0.25
IuwLemwLhc9fvrwBGs0AMA: posts big blind $0.50
*** HOLE CARDS ***
Udr5juWSWUgTu1NlRhjMdA: folds
IuwLemwLhc9fvrwBGs0AMA collected $0.50 from pot
*** SUMMARY ***
Total pot $0.50 | Rake $0
Seat 1: IuwLemwLhc9fvrwBGs0AMA (big blind) collected ($0.50)
Seat 2: Udr5juWSWUgTu1NlRhjMdA (button) (small blind) folded before Flop



PokerStars Game #59937917444:  Hold'em No Limit ($0.25/$0.50) - 2009/07/01 0:02:50 ET
Table 'c/CRn+68J3Y8KxD5g1ek2Q' 2-max Seat #2 is the button
Seat 1: 46qCyJ6evTkHo9al5sBMNA ($320.20 in chips)
Seat 2: BypVLsYQt3ePFm2xQL/dOA ($68.35 in chips)
BypVLsYQt3ePFm2xQL/dOA: posts small blind $0.25
46qCyJ6evTkHo9al5sBMNA: posts big blind $0.50
*** HOLE CARDS ***
BypVLsYQt3ePFm2xQL/dOA: raises $1 to $1.50
46qCyJ6evTkHo9al5sBMNA: folds
BypVLsYQt3ePFm2xQL/dOA collected $1 from pot
BypVLsYQt3ePFm2xQL/dOA: doesn't show hand
*** SUMMARY ***
Total pot $1 | Rake $0
Seat 1: 46qCyJ6evTkHo9al5sBMNA (big blind) folded before Flop
Seat 2: BypVLsYQt3ePFm2xQL/dOA (button) (small blind) collected ($1)



PokerStars Game #59937917080:  Hold'em No Limit ($0.25/$0.50) - 2009/07/01 0:02:50 ET
Table 'EiNh8p/wGJ1FP575iMFnqg' 9-max Seat #1 is the button
Seat 1: r3ZqM1Mi0W3y4hOdssE+Sg ($41.35 in chips)
Seat 2: avsQkZXsRKnWa7gkjVNvog ($28.15 in chips)
Seat 3: GszS/McxOSUnOET7MBoHqA ($57.50 in chips)
Seat 4: pk8aA8qMBEL6zXqSyfVXMA ($80.80 in chips)
Seat 5: M+7+BTmX5vZatHVuoRB1nA ($93.50 in chips)
Seat 6: YPo1oggovmqSREegekaQYw ($14.75 in chips)
Seat 7: Wj7mKnRFR90j40wWUu2+Og ($26.70 in chips)
Seat 8: C7LqTSTGrMSBCecHvwQAOQ ($55.30 in chips)
Seat 9: OMwFJ4pF0xk2Ru/AJiFeFw ($73.40 in chips)
avsQkZXsRKnWa7gkjVNvog: posts small blind $0.25
GszS/McxOSUnOET7MBoHqA: posts big blind $0.50
*** HOLE CARDS ***
pk8aA8qMBEL6zXqSyfVXMA: folds
M+7+BTmX5vZatHVuoRB1nA: folds
YPo1oggovmqSREegekaQYw: folds
Wj7mKnRFR90j40wWUu2+Og: calls $0.50
C7LqTSTGrMSBCecHvwQAOQ: folds
OMwFJ4pF0xk2Ru/AJiFeFw: folds
r3ZqM1Mi0W3y4hOdssE+Sg: folds
avsQkZXsRKnWa7gkjVNvog: folds
GszS/McxOSUnOET7MBoHqA: checks
*** FLOP *** [Ac Qd 7d]
GszS/McxOSUnOET7MBoHqA: checks
Wj7mKnRFR90j40wWUu2+Og: checks
*** TURN *** [Ac Qd 7d] [Ks]
GszS/McxOSUnOET7MBoHqA: checks
Wj7mKnRFR90j40wWUu2+Og: bets $1
GszS/McxOSUnOET7MBoHqA: folds
Wj7mKnRFR90j40wWUu2+Og collected $1.20 from pot
*** SUMMARY ***
Total pot $1.25 | Rake $0.05
Board [Ac Qd 7d Ks]
Seat 1: r3ZqM1Mi0W3y4hOdssE+Sg (button) folded before Flop (didn't bet)
Seat 2: avsQkZXsRKnWa7gkjVNvog (small blind) folded before Flop
Seat 3: GszS/McxOSUnOET7MBoHqA (big blind) folded on the Turn
Seat 4: pk8aA8qMBEL6zXqSyfVXMA folded before Flop (didn't bet)
Seat 5: M+7+BTmX5vZatHVuoRB1nA folded before Flop (didn't bet)
Seat 6: YPo1oggovmqSREegekaQYw folded before Flop (didn't bet)
Seat 7: Wj7mKnRFR90j40wWUu2+Og collected ($1.20)
Seat 8: C7LqTSTGrMSBCecHvwQAOQ folded before Flop (didn't bet)
Seat 9: OMwFJ4pF0xk2Ru/AJiFeFw folded before Flop (didn't bet)



PokerStars Game #59937919034:  Hold'em No Limit ($0.25/$0.50) - 2009/07/01 0:02:52 ET
Table 'SsXEKOwKN+jE3etfusqUqA' 2-max Seat #1 is the button
Seat 1: 618rKeLrz/avGNOLULHHVQ ($80.40 in chips)
Seat 2: XfRhywXA6Br+jID1oGeo8A ($116.05 in chips)
618rKeLrz/avGNOLULHHVQ: posts small blind $0.25
XfRhywXA6Br+jID1oGeo8A: posts big blind $0.50
*** HOLE CARDS ***
618rKeLrz/avGNOLULHHVQ: folds
XfRhywXA6Br+jID1oGeo8A collected $0.50 from pot
*** SUMMARY ***
Total pot $0.50 | Rake $0
Seat 1: 618rKeLrz/avGNOLULHHVQ (button) (small blind) folded before Flop
Seat 2: XfRhywXA6Br+jID1oGeo8A (big blind) collected ($0.50)



PokerStars Game #59937918712:  Hold'em No Limit ($0.25/$0.50) - 2009/07/01 0:02:52 ET
Table '+dXkOAQyS8j9PQZusUTMpg' 2-max Seat #1 is the button
Seat 1: XFa6sBGjP2gxoIvxR3fZIg ($82.20 in chips)
Seat 2: 5IBeOgaApY1Bvzv2P8X4EA ($20.40 in chips)
XFa6sBGjP2gxoIvxR3fZIg: posts small blind $0.25
5IBeOgaApY1Bvzv2P8X4EA: posts big blind $0.50
*** HOLE CARDS ***
XFa6sBGjP2gxoIvxR3fZIg: raises $1 to $1.50
5IBeOgaApY1Bvzv2P8X4EA: calls $1
*** FLOP *** [2d 3h Th]
5IBeOgaApY1Bvzv2P8X4EA: checks
XFa6sBGjP2gxoIvxR3fZIg: checks
*** TURN *** [2d 3h Th] [9s]
5IBeOgaApY1Bvzv2P8X4EA: checks
XFa6sBGjP2gxoIvxR3fZIg: bets $1.50
5IBeOgaApY1Bvzv2P8X4EA: raises $2.50 to $4
XFa6sBGjP2gxoIvxR3fZIg: calls $2.50
*** RIVER *** [2d 3h Th 9s] [4s]
5IBeOgaApY1Bvzv2P8X4EA: bets $4.50
XFa6sBGjP2gxoIvxR3fZIg: calls $4.50
*** SHOW DOWN ***
5IBeOgaApY1Bvzv2P8X4EA: shows [Ks 6c] (high card King)
XFa6sBGjP2gxoIvxR3fZIg: shows [8c 9c] (a pair of Nines)
XFa6sBGjP2gxoIvxR3fZIg collected $19.50 from pot
*** SUMMARY ***
Total pot $20 | Rake $0.50
Board [2d 3h Th 9s 4s]
Seat 1: XFa6sBGjP2gxoIvxR3fZIg (button) (small blind) showed [8c 9c] and won ($19.50) with a pair of Nines
Seat 2: 5IBeOgaApY1Bvzv2P8X4EA (big blind) showed [Ks 6c] and lost with high card King



PokerStars Game #59937919532:  Hold'em No Limit ($0.25/$0.50) - 2009/07/01 0:02:53 ET
Table 'GfL/No5u5PoEnU39lP5pQg' 6-max Seat #6 is the button
Seat 1: T0Gx/FcQ5VH9u7XaOMX97A ($51 in chips)
Seat 2: uVwggSetzp7d+eVgowO3vg ($20.80 in chips)
Seat 3: YmWlPGOKFuJSoJZPW8a8IA ($95.95 in chips)
Seat 4: yqM0AD7MZQd/cEtKdDQY1A ($34.65 in chips)
Seat 5: fDiswuKb270PAYXkTIYC3g ($20 in chips)
Seat 6: 5EiAo0XuFchfJkhvFPvoog ($65.20 in chips)
T0Gx/FcQ5VH9u7XaOMX97A: posts small blind $0.25
uVwggSetzp7d+eVgowO3vg: posts big blind $0.50
fDiswuKb270PAYXkTIYC3g: posts small & big blinds $0.75
*** HOLE CARDS ***
YmWlPGOKFuJSoJZPW8a8IA: folds
yqM0AD7MZQd/cEtKdDQY1A: folds
fDiswuKb270PAYXkTIYC3g: checks
5EiAo0XuFchfJkhvFPvoog: calls $0.50
T0Gx/FcQ5VH9u7XaOMX97A: raises $2.50 to $3
uVwggSetzp7d+eVgowO3vg: folds
fDiswuKb270PAYXkTIYC3g: folds
5EiAo0XuFchfJkhvFPvoog: calls $2.50
*** FLOP *** [2h 3s 8c]
fDiswuKb270PAYXkTIYC3g leaves the table
T0Gx/FcQ5VH9u7XaOMX97A: bets $4
5EiAo0XuFchfJkhvFPvoog: folds
T0Gx/FcQ5VH9u7XaOMX97A collected $6.90 from pot
T0Gx/FcQ5VH9u7XaOMX97A: doesn't show hand
*** SUMMARY ***
Total pot $7.25 | Rake $0.35
Board [2h 3s 8c]
Seat 1: T0Gx/FcQ5VH9u7XaOMX97A (small blind) collected ($6.90)
Seat 2: uVwggSetzp7d+eVgowO3vg (big blind) folded before Flop
Seat 3: YmWlPGOKFuJSoJZPW8a8IA folded before Flop (didn't bet)
Seat 4: yqM0AD7MZQd/cEtKdDQY1A folded before Flop (didn't bet)
Seat 5: fDiswuKb270PAYXkTIYC3g folded before Flop
Seat 6: 5EiAo0XuFchfJkhvFPvoog (button) folded on the Flop



PokerStars Game #59937920018:  Hold'em No Limit ($0.25/$0.50) - 2009/07/01 0:02:54 ET
Table 'QOgaEqMcJ73pcUMMxoisUg' 6-max Seat #4 is the button
Seat 1: RFefXIDyFvNtJLq+CloCzA ($42.45 in chips)
Seat 3: wUZNozoIDYf+16hp4nn6dw ($24.65 in chips)
Seat 4: L5e2lrPLQm1Pqx30IIZ/Fw ($9.25 in chips)
Seat 5: HoaSQCRso+nEyO5DUhGduw ($71.85 in chips)
Seat 6: s83dnhZ6VC53vY0/f6OV/g ($40.65 in chips)
HoaSQCRso+nEyO5DUhGduw: posts small blind $0.25
s83dnhZ6VC53vY0/f6OV/g: posts big blind $0.50
*** HOLE CARDS ***
RFefXIDyFvNtJLq+CloCzA: folds
wUZNozoIDYf+16hp4nn6dw: calls $0.50
L5e2lrPLQm1Pqx30IIZ/Fw: folds
HoaSQCRso+nEyO5DUhGduw: folds
s83dnhZ6VC53vY0/f6OV/g: checks
*** FLOP *** [Jh 2h 8d]
s83dnhZ6VC53vY0/f6OV/g: checks
wUZNozoIDYf+16hp4nn6dw: checks
*** TURN *** [Jh 2h 8d] [Tc]
s83dnhZ6VC53vY0/f6OV/g: bets $1
wUZNozoIDYf+16hp4nn6dw: folds
s83dnhZ6VC53vY0/f6OV/g collected $1.20 from pot
*** SUMMARY ***
Total pot $1.25 | Rake $0.05
Board [Jh 2h 8d Tc]
Seat 1: RFefXIDyFvNtJLq+CloCzA folded before Flop (didn't bet)
Seat 3: wUZNozoIDYf+16hp4nn6dw folded on the Turn
Seat 4: L5e2lrPLQm1Pqx30IIZ/Fw (button) folded before Flop (didn't bet)
Seat 5: HoaSQCRso+nEyO5DUhGduw (small blind) folded before Flop
Seat 6: s83dnhZ6VC53vY0/f6OV/g (big blind) collected ($1.20)



PokerStars Game #59937920824:  Hold'em No Limit ($0.25/$0.50) - 2009/07/01 0:02:55 ET
Table 'X6IRCRTh+20gjz8aubWnwA' 9-max Seat #5 is the button
Seat 1: YPo1oggovmqSREegekaQYw ($10.70 in chips)
Seat 2: RjBdQ6w31rgcy0o24VLR6w ($11.45 in chips)
Seat 3: mSD1pginDsyHG5PDfqzphw ($10 in chips)
Seat 4: uw9QayAAxLM3Hb+HR7mSkg ($9.25 in chips)
Seat 5: aT3lRsb9BkkYp2fkD3LEtQ ($77.65 in chips)
Seat 6: /6In1zC3WtgwxDcueWzZWg ($49.50 in chips)
Seat 7: VBnpbzn0dIveV55qKvciew ($68.20 in chips)
Seat 8: BPMN9sOItJw6vWq3kypaYg ($26.65 in chips)
Seat 9: M+7+BTmX5vZatHVuoRB1nA ($84.85 in chips)
/6In1zC3WtgwxDcueWzZWg: posts small blind $0.25
VBnpbzn0dIveV55qKvciew: posts big blind $0.50
*** HOLE CARDS ***
BPMN9sOItJw6vWq3kypaYg: folds
M+7+BTmX5vZatHVuoRB1nA: folds
YPo1oggovmqSREegekaQYw: folds
RjBdQ6w31rgcy0o24VLR6w: folds
mSD1pginDsyHG5PDfqzphw: folds
uw9QayAAxLM3Hb+HR7mSkg: folds
aT3lRsb9BkkYp2fkD3LEtQ: raises $0.50 to $1
/6In1zC3WtgwxDcueWzZWg: folds
VBnpbzn0dIveV55qKvciew: calls $0.50
*** FLOP *** [Ad 7h 5d]
VBnpbzn0dIveV55qKvciew: bets $0.50
aT3lRsb9BkkYp2fkD3LEtQ: calls $0.50
*** TURN *** [Ad 7h 5d] [3h]
VBnpbzn0dIveV55qKvciew: bets $2
aT3lRsb9BkkYp2fkD3LEtQ: calls $2
*** RIVER *** [Ad 7h 5d 3h] [Jc]
VBnpbzn0dIveV55qKvciew: bets $4.50
aT3lRsb9BkkYp2fkD3LEtQ: calls $4.50
*** SHOW DOWN ***
VBnpbzn0dIveV55qKvciew: shows [7d 9d] (a pair of Sevens)
aT3lRsb9BkkYp2fkD3LEtQ: shows [6c Js] (a pair of Jacks)
aT3lRsb9BkkYp2fkD3LEtQ collected $15.50 from pot
*** SUMMARY ***
Total pot $16.25 | Rake $0.75
Board [Ad 7h 5d 3h Jc]
Seat 1: YPo1oggovmqSREegekaQYw folded before Flop (didn't bet)
Seat 2: RjBdQ6w31rgcy0o24VLR6w folded before Flop (didn't bet)
Seat 3: mSD1pginDsyHG5PDfqzphw folded before Flop (didn't bet)
Seat 4: uw9QayAAxLM3Hb+HR7mSkg folded before Flop (didn't bet)
Seat 5: aT3lRsb9BkkYp2fkD3LEtQ (button) showed [6c Js] and won ($15.50) with a pair of Jacks
Seat 6: /6In1zC3WtgwxDcueWzZWg (small blind) folded before Flop
Seat 7: VBnpbzn0dIveV55qKvciew (big blind) showed [7d 9d] and lost with a pair of Sevens
Seat 8: BPMN9sOItJw6vWq3kypaYg folded before Flop (didn't bet)
Seat 9: M+7+BTmX5vZatHVuoRB1nA folded before Flop (didn't bet)



PokerStars Game #59937922494:  Hold'em No Limit ($0.25/$0.50) - 2009/07/01 0:02:57 ET
Table 'raOT4/ipuZgzjfKHC+jD9g' 2-max Seat #1 is the button
Seat 1: IuwLemwLhc9fvrwBGs0AMA ($9.90 in chips)
Seat 2: Udr5juWSWUgTu1NlRhjMdA ($14.45 in chips)
IuwLemwLhc9fvrwBGs0AMA: posts small blind $0.25
Udr5juWSWUgTu1NlRhjMdA: posts big blind $0.50
*** HOLE CARDS ***
IuwLemwLhc9fvrwBGs0AMA: raises $0.50 to $1
Udr5juWSWUgTu1NlRhjMdA: calls $0.50
*** FLOP *** [As Ad 4d]
Udr5juWSWUgTu1NlRhjMdA: checks
IuwLemwLhc9fvrwBGs0AMA: checks
*** TURN *** [As Ad 4d] [Kc]
Udr5juWSWUgTu1NlRhjMdA: checks
IuwLemwLhc9fvrwBGs0AMA: bets $1
Udr5juWSWUgTu1NlRhjMdA: folds
IuwLemwLhc9fvrwBGs0AMA collected $1.90 from pot
*** SUMMARY ***
Total pot $2 | Rake $0.10
Board [As Ad 4d Kc]
Seat 1: IuwLemwLhc9fvrwBGs0AMA (button) (small blind) collected ($1.90)
Seat 2: Udr5juWSWUgTu1NlRhjMdA (big blind) folded on the Turn



PokerStars Game #59937923284:  Hold'em No Limit ($0.25/$0.50) - 2009/07/01 0:02:58 ET
Table 'SsXEKOwKN+jE3etfusqUqA' 2-max Seat #2 is the button
Seat 1: 618rKeLrz/avGNOLULHHVQ ($80.15 in chips)
Seat 2: XfRhywXA6Br+jID1oGeo8A ($116.30 in chips)
XfRhywXA6Br+jID1oGeo8A: posts small blind $0.25
618rKeLrz/avGNOLULHHVQ: posts big blind $0.50
*** HOLE CARDS ***
XfRhywXA6Br+jID1oGeo8A: raises $1 to $1.50
618rKeLrz/avGNOLULHHVQ: raises $3.50 to $5
XfRhywXA6Br+jID1oGeo8A: calls $3.50
*** FLOP *** [7h Qd 4d]
618rKeLrz/avGNOLULHHVQ: bets $7
XfRhywXA6Br+jID1oGeo8A: folds
618rKeLrz/avGNOLULHHVQ collected $9.50 from pot
618rKeLrz/avGNOLULHHVQ: doesn't show hand
*** SUMMARY ***
Total pot $10 | Rake $0.50
Board [7h Qd 4d]
Seat 1: 618rKeLrz/avGNOLULHHVQ (big blind) collected ($9.50)
Seat 2: XfRhywXA6Br+jID1oGeo8A (button) (small blind) folded on the Flop



PokerStars Game #59937923736:  Hold'em No Limit ($0.25/$0.50) - 2009/07/01 0:02:59 ET
Table '+z1aekfHkpp09pc8F9aViw' 6-max Seat #6 is the button
Seat 1: lWwl5C/UZOsWNubdUqghZw ($50 in chips)
Seat 2: VuB2GN0h94yY+QbuI2Mybg ($25.45 in chips)
Seat 3: uUznlIMFnRUvwrBhYF73KA ($57.05 in chips)
Seat 4: OCrv7ObFH4/s2lv7rYOnsQ ($21.70 in chips)
Seat 5: crjGpJEzSZgD38FoE3VMGg ($62.90 in chips)
Seat 6: 686aeHikcJlgKkSuIFdcXQ ($67.90 in chips)
lWwl5C/UZOsWNubdUqghZw: posts small blind $0.25
VuB2GN0h94yY+QbuI2Mybg: posts big blind $0.50
*** HOLE CARDS ***
uUznlIMFnRUvwrBhYF73KA: folds
OCrv7ObFH4/s2lv7rYOnsQ: raises $1.50 to $2
crjGpJEzSZgD38FoE3VMGg: folds
686aeHikcJlgKkSuIFdcXQ: folds
lWwl5C/UZOsWNubdUqghZw: folds
VuB2GN0h94yY+QbuI2Mybg: folds
OCrv7ObFH4/s2lv7rYOnsQ collected $1.25 from pot
*** SUMMARY ***
Total pot $1.25 | Rake $0
Seat 1: lWwl5C/UZOsWNubdUqghZw (small blind) folded before Flop
Seat 2: VuB2GN0h94yY+QbuI2Mybg (big blind) folded before Flop
Seat 3: uUznlIMFnRUvwrBhYF73KA folded before Flop (didn't bet)
Seat 4: OCrv7ObFH4/s2lv7rYOnsQ collected ($1.25)
Seat 5: crjGpJEzSZgD38FoE3VMGg folded before Flop (didn't bet)
Seat 6: 686aeHikcJlgKkSuIFdcXQ (button) folded before Flop (didn't bet)



PokerStars Game #59937925600:  Hold'em No Limit ($0.25/$0.50) - 2009/07/01 0:03:01 ET
Table 'c/CRn+68J3Y8KxD5g1ek2Q' 2-max Seat #1 is the button
Seat 1: 46qCyJ6evTkHo9al5sBMNA ($319.70 in chips)
Seat 2: BypVLsYQt3ePFm2xQL/dOA ($68.85 in chips)
46qCyJ6evTkHo9al5sBMNA: posts small blind $0.25
BypVLsYQt3ePFm2xQL/dOA: posts big blind $0.50
*** HOLE CARDS ***
46qCyJ6evTkHo9al5sBMNA: raises $0.50 to $1
BypVLsYQt3ePFm2xQL/dOA: raises $5 to $6
46qCyJ6evTkHo9al5sBMNA: calls $5
*** FLOP *** [9h 5h 8d]
BypVLsYQt3ePFm2xQL/dOA: checks
46qCyJ6evTkHo9al5sBMNA: bets $5
BypVLsYQt3ePFm2xQL/dOA: calls $5
*** TURN *** [9h 5h 8d] [Ts]
BypVLsYQt3ePFm2xQL/dOA: checks
46qCyJ6evTkHo9al5sBMNA: checks
*** RIVER *** [9h 5h 8d Ts] [Qc]
BypVLsYQt3ePFm2xQL/dOA: checks
46qCyJ6evTkHo9al5sBMNA: checks
*** SHOW DOWN ***
BypVLsYQt3ePFm2xQL/dOA: shows [As 6d] (high card Ace)
46qCyJ6evTkHo9al5sBMNA: shows [3s 3h] (a pair of Threes)
46qCyJ6evTkHo9al5sBMNA collected $21.50 from pot
*** SUMMARY ***
Total pot $22 | Rake $0.50
Board [9h 5h 8d Ts Qc]
Seat 1: 46qCyJ6evTkHo9al5sBMNA (button) (small blind) showed [3s 3h] and won ($21.50) with a pair of Threes
Seat 2: BypVLsYQt3ePFm2xQL/dOA (big blind) showed [As 6d] and lost with high card Ace



PokerStars Game #59937925168:  Hold'em No Limit ($0.25/$0.50) - 2009/07/01 0:03:01 ET
Table 'NCiXr0d5CEKBQr/cZgLhbA' 9-max Seat #7 is the button
Seat 1: RjBdQ6w31rgcy0o24VLR6w ($9.25 in chips)
Seat 2: ulxuJchBV9iguXg0FUonfg ($28.70 in chips)
Seat 3: xZCXQSXlrZkp3pZizzVXCw ($55.65 in chips)
Seat 4: CL4d+tvzcd4utdQxlPLOmg ($34.90 in chips)
Seat 5: zE9cVigS2nW/Ljy4K4bUQA ($32.70 in chips)
Seat 6: SKnJuWHScqetA/qG5p+wCg ($31.80 in chips)
Seat 7: EltNhVR1POPXhu/1E62t3A ($8.75 in chips)
Seat 8: E2518gp4aFz1+kAgmGqeEg ($11.20 in chips)
Seat 9: WpvT3OUSiZlpvs+mPXFqtQ ($7.45 in chips)
E2518gp4aFz1+kAgmGqeEg: posts small blind $0.25
WpvT3OUSiZlpvs+mPXFqtQ: posts big blind $0.50
*** HOLE CARDS ***
RjBdQ6w31rgcy0o24VLR6w: folds
ulxuJchBV9iguXg0FUonfg: calls $0.50
xZCXQSXlrZkp3pZizzVXCw: folds
CL4d+tvzcd4utdQxlPLOmg: calls $0.50
zE9cVigS2nW/Ljy4K4bUQA: folds
SKnJuWHScqetA/qG5p+wCg: folds
EltNhVR1POPXhu/1E62t3A: raises $1 to $1.50
E2518gp4aFz1+kAgmGqeEg: folds
WpvT3OUSiZlpvs+mPXFqtQ: folds
ulxuJchBV9iguXg0FUonfg: calls $1
CL4d+tvzcd4utdQxlPLOmg: calls $1
*** FLOP *** [As 5d 6s]
ulxuJchBV9iguXg0FUonfg: checks
CL4d+tvzcd4utdQxlPLOmg: bets $3
EltNhVR1POPXhu/1E62t3A: folds
ulxuJchBV9iguXg0FUonfg: calls $3
*** TURN *** [As 5d 6s] [Ks]
ulxuJchBV9iguXg0FUonfg: checks
CL4d+tvzcd4utdQxlPLOmg: checks
*** RIVER *** [As 5d 6s Ks] [8c]
ulxuJchBV9iguXg0FUonfg: checks
CL4d+tvzcd4utdQxlPLOmg: checks
*** SHOW DOWN ***
ulxuJchBV9iguXg0FUonfg: shows [Ac Ts] (a pair of Aces)
CL4d+tvzcd4utdQxlPLOmg: mucks hand
ulxuJchBV9iguXg0FUonfg collected $10.70 from pot
*** SUMMARY ***
Total pot $11.25 | Rake $0.55
Board [As 5d 6s Ks 8c]
Seat 1: RjBdQ6w31rgcy0o24VLR6w folded before Flop (didn't bet)
Seat 2: ulxuJchBV9iguXg0FUonfg showed [Ac Ts] and won ($10.70) with a pair of Aces
Seat 3: xZCXQSXlrZkp3pZizzVXCw folded before Flop (didn't bet)
Seat 4: CL4d+tvzcd4utdQxlPLOmg mucked
Seat 5: zE9cVigS2nW/Ljy4K4bUQA folded before Flop (didn't bet)
Seat 6: SKnJuWHScqetA/qG5p+wCg folded before Flop (didn't bet)
Seat 7: EltNhVR1POPXhu/1E62t3A (button) folded on the Flop
Seat 8: E2518gp4aFz1+kAgmGqeEg (small blind) folded before Flop
Seat 9: WpvT3OUSiZlpvs+mPXFqtQ (big blind) folded before Flop



PokerStars Game #59937925154:  Hold'em No Limit ($0.25/$0.50) - 2009/07/01 0:03:01 ET
Table 'MJxeZCzYELxiIsyUZyT0jw' 6-max Seat #1 is the button
Seat 1: iKPos8JI094Tomq4tDSgnQ ($20.50 in chips)
Seat 2: r6H1GiZ6QIpMTDhyodKuRQ ($66.15 in chips)
Seat 3: JQZew0FjzS19kTjeNtrE+A ($57.15 in chips)
Seat 4: lP7Q6pewz4C2RsAfKsjdWw ($26.30 in chips)
Seat 6: TTx3CHxyi0SObcHyMJRp5w ($41.70 in chips)
r6H1GiZ6QIpMTDhyodKuRQ: posts small blind $0.25
JQZew0FjzS19kTjeNtrE+A: posts big blind $0.50
*** HOLE CARDS ***
lP7Q6pewz4C2RsAfKsjdWw: calls $0.50
TTx3CHxyi0SObcHyMJRp5w: folds
iKPos8JI094Tomq4tDSgnQ: folds
r6H1GiZ6QIpMTDhyodKuRQ: calls $0.25
JQZew0FjzS19kTjeNtrE+A: checks
*** FLOP *** [7h Th 4s]
r6H1GiZ6QIpMTDhyodKuRQ: checks
JQZew0FjzS19kTjeNtrE+A: bets $1.50
lP7Q6pewz4C2RsAfKsjdWw: folds
r6H1GiZ6QIpMTDhyodKuRQ: folds
JQZew0FjzS19kTjeNtrE+A collected $1.45 from pot
*** SUMMARY ***
Total pot $1.50 | Rake $0.05
Board [7h Th 4s]
Seat 1: iKPos8JI094Tomq4tDSgnQ (button) folded before Flop (didn't bet)
Seat 2: r6H1GiZ6QIpMTDhyodKuRQ (small blind) folded on the Flop
Seat 3: JQZew0FjzS19kTjeNtrE+A (big blind) collected ($1.45)
Seat 4: lP7Q6pewz4C2RsAfKsjdWw folded on the Flop
Seat 6: TTx3CHxyi0SObcHyMJRp5w folded before Flop (didn't bet)



PokerStars Game #59937926738:  Hold'em No Limit ($0.25/$0.50) - 2009/07/01 0:03:03 ET
Table 'E7bWJ45aoFXRpyRv2gw+Ig' 2-max Seat #2 is the button
Seat 1: FRkiRasEGlHUeLrEl+k/nA ($53.85 in chips)
Seat 2: 3Wro85I7472vJ4Wkpneo9A ($72.35 in chips)
3Wro85I7472vJ4Wkpneo9A: posts small blind $0.25
FRkiRasEGlHUeLrEl+k/nA: posts big blind $0.50
*** HOLE CARDS ***
3Wro85I7472vJ4Wkpneo9A: calls $0.25
FRkiRasEGlHUeLrEl+k/nA: checks
*** FLOP *** [Kd Qc Qh]
FRkiRasEGlHUeLrEl+k/nA: checks
3Wro85I7472vJ4Wkpneo9A: bets $1
FRkiRasEGlHUeLrEl+k/nA: folds
3Wro85I7472vJ4Wkpneo9A collected $0.95 from pot
3Wro85I7472vJ4Wkpneo9A: doesn't show hand
*** SUMMARY ***
Total pot $1 | Rake $0.05
Board [Kd Qc Qh]
Seat 1: FRkiRasEGlHUeLrEl+k/nA (big blind) folded on the Flop
Seat 2: 3Wro85I7472vJ4Wkpneo9A (button) (small blind) collected ($0.95)



PokerStars Game #59937926824:  Hold'em No Limit ($0.25/$0.50) - 2009/07/01 0:03:03 ET
Table 'mTxf8gPLgffN3Iwfm7Icfg' 2-max Seat #2 is the button
Seat 1: Do9Rlu1R5u/AcRtMTl8SYg ($63.65 in chips)
Seat 2: EMc5LPgVaded4Qc77vm0fw ($52.10 in chips)
EMc5LPgVaded4Qc77vm0fw: posts small blind $0.25
Do9Rlu1R5u/AcRtMTl8SYg: posts big blind $0.50
*** HOLE CARDS ***
EMc5LPgVaded4Qc77vm0fw: calls $0.25
Do9Rlu1R5u/AcRtMTl8SYg: checks
*** FLOP *** [Jd 9c Ts]
Do9Rlu1R5u/AcRtMTl8SYg: checks
EMc5LPgVaded4Qc77vm0fw: checks
*** TURN *** [Jd 9c Ts] [Qc]
Do9Rlu1R5u/AcRtMTl8SYg: checks
EMc5LPgVaded4Qc77vm0fw: checks
*** RIVER *** [Jd 9c Ts Qc] [6d]
Do9Rlu1R5u/AcRtMTl8SYg: checks
EMc5LPgVaded4Qc77vm0fw: checks
*** SHOW DOWN ***
Do9Rlu1R5u/AcRtMTl8SYg: shows [4h 7h] (high card Queen)
EMc5LPgVaded4Qc77vm0fw: shows [5s 9s] (a pair of Nines)
EMc5LPgVaded4Qc77vm0fw collected $0.95 from pot
*** SUMMARY ***
Total pot $1 | Rake $0.05
Board [Jd 9c Ts Qc 6d]
Seat 1: Do9Rlu1R5u/AcRtMTl8SYg (big blind) showed [4h 7h] and lost with high card Queen
Seat 2: EMc5LPgVaded4Qc77vm0fw (button) (small blind) showed [5s 9s] and won ($0.95) with a pair of Nines



PokerStars Game #59937928160:  Hold'em No Limit ($0.25/$0.50) - 2009/07/01 0:03:05 ET
Table 'BCN5su+SsXiy1zRMJi0SJw' 6-max Seat #3 is the button
Seat 1: 5EiAo0XuFchfJkhvFPvoog ($100.20 in chips)
Seat 2: QfV2JJlmEKgD5jYPV+a33A ($160.90 in chips)
Seat 3: yrJsFKWv+ttHooqghxDx3A ($5.30 in chips)
Seat 4: 6Wb8PlO2kM4fnSim7p4Mrw ($10.75 in chips)
Seat 5: TTx3CHxyi0SObcHyMJRp5w ($36.55 in chips)
Seat 6: zHXshyreKwJVq3N3U+K9uQ ($52.05 in chips)
6Wb8PlO2kM4fnSim7p4Mrw: posts small blind $0.25
TTx3CHxyi0SObcHyMJRp5w: posts big blind $0.50
*** HOLE CARDS ***
zHXshyreKwJVq3N3U+K9uQ: folds
5EiAo0XuFchfJkhvFPvoog: folds
QfV2JJlmEKgD5jYPV+a33A: raises $1 to $1.50
yrJsFKWv+ttHooqghxDx3A: calls $1.50
6Wb8PlO2kM4fnSim7p4Mrw: folds
TTx3CHxyi0SObcHyMJRp5w: calls $1
*** FLOP *** [8s Qc 8h]
TTx3CHxyi0SObcHyMJRp5w: bets $1.50
QfV2JJlmEKgD5jYPV+a33A: folds
yrJsFKWv+ttHooqghxDx3A: folds
TTx3CHxyi0SObcHyMJRp5w collected $4.55 from pot
TTx3CHxyi0SObcHyMJRp5w: doesn't show hand
*** SUMMARY ***
Total pot $4.75 | Rake $0.20
Board [8s Qc 8h]
Seat 1: 5EiAo0XuFchfJkhvFPvoog folded before Flop (didn't bet)
Seat 2: QfV2JJlmEKgD5jYPV+a33A folded on the Flop
Seat 3: yrJsFKWv+ttHooqghxDx3A (button) folded on the Flop
Seat 4: 6Wb8PlO2kM4fnSim7p4Mrw (small blind) folded before Flop
Seat 5: TTx3CHxyi0SObcHyMJRp5w (big blind) collected ($4.55)
Seat 6: zHXshyreKwJVq3N3U+K9uQ folded before Flop (didn't bet)



PokerStars Game #59937929262:  Hold'em No Limit ($0.25/$0.50) - 2009/07/01 0:03:06 ET
Table 'Vdlc9wqYcHTUhtdyN7CuJw' 2-max Seat #1 is the button
Seat 1: yBO+mXB6m/rCft2ErwGf/Q ($65 in chips)
Seat 2: sa0qgETiL3HNbdfGlnKHTA ($49.95 in chips)
yBO+mXB6m/rCft2ErwGf/Q: posts small blind $0.25
sa0qgETiL3HNbdfGlnKHTA: posts big blind $0.50
*** HOLE CARDS ***
yBO+mXB6m/rCft2ErwGf/Q: raises $1 to $1.50
sa0qgETiL3HNbdfGlnKHTA: folds
yBO+mXB6m/rCft2ErwGf/Q collected $1 from pot
*** SUMMARY ***
Total pot $1 | Rake $0
Seat 1: yBO+mXB6m/rCft2ErwGf/Q (button) (small blind) collected ($1)
Seat 2: sa0qgETiL3HNbdfGlnKHTA (big blind) folded before Flop



PokerStars Game #59937934942:  Hold'em No Limit ($0.25/$0.50) - 2009/07/01 0:03:14 ET
Table 'kgbJRsxfv64KrErDRBAkcw' 6-max Seat #3 is the button
Seat 1: YmWlPGOKFuJSoJZPW8a8IA ($82.55 in chips)
Seat 3: T0Gx/FcQ5VH9u7XaOMX97A ($62.40 in chips)
Seat 4: qanMEqjABjWxC/JgQ/0l7w ($50 in chips)
Seat 5: SlTdlH14u+KVVINgxMwt+Q ($76.70 in chips)
Seat 6: DDfYzIrYT0t5R/hAJngtsg ($27.65 in chips)
qanMEqjABjWxC/JgQ/0l7w: posts small blind $0.25
SlTdlH14u+KVVINgxMwt+Q: posts big blind $0.50
Q+thC23WCv1kJUJtH/+4Jw: sits out
*** HOLE CARDS ***
DDfYzIrYT0t5R/hAJngtsg: raises $0.50 to $1
YmWlPGOKFuJSoJZPW8a8IA: folds
T0Gx/FcQ5VH9u7XaOMX97A: folds
qanMEqjABjWxC/JgQ/0l7w: raises $3 to $4
SlTdlH14u+KVVINgxMwt+Q: folds
DDfYzIrYT0t5R/hAJngtsg: folds
qanMEqjABjWxC/JgQ/0l7w collected $2.50 from pot
*** SUMMARY ***
Total pot $2.50 | Rake $0
Seat 1: YmWlPGOKFuJSoJZPW8a8IA folded before Flop (didn't bet)
Seat 3: T0Gx/FcQ5VH9u7XaOMX97A (button) folded before Flop (didn't bet)
Seat 4: qanMEqjABjWxC/JgQ/0l7w (small blind) collected ($2.50)
Seat 5: SlTdlH14u+KVVINgxMwt+Q (big blind) folded before Flop
Seat 6: DDfYzIrYT0t5R/hAJngtsg folded before Flop



PokerStars Game #59937935656:  Hold'em No Limit ($0.25/$0.50) - 2009/07/01 0:03:15 ET
Table 'SsXEKOwKN+jE3etfusqUqA' 2-max Seat #1 is the button
Seat 1: 618rKeLrz/avGNOLULHHVQ ($84.65 in chips)
Seat 2: XfRhywXA6Br+jID1oGeo8A ($111.30 in chips)
618rKeLrz/avGNOLULHHVQ: posts small blind $0.25
XfRhywXA6Br+jID1oGeo8A: posts big blind $0.50
*** HOLE CARDS ***
618rKeLrz/avGNOLULHHVQ: raises $1 to $1.50
XfRhywXA6Br+jID1oGeo8A: calls $1
*** FLOP *** [7d Td 8s]
XfRhywXA6Br+jID1oGeo8A: checks
618rKeLrz/avGNOLULHHVQ: bets $2
XfRhywXA6Br+jID1oGeo8A: calls $2
*** TURN *** [7d Td 8s] [Ac]
XfRhywXA6Br+jID1oGeo8A: checks
618rKeLrz/avGNOLULHHVQ: bets $5
XfRhywXA6Br+jID1oGeo8A: raises $5 to $10
618rKeLrz/avGNOLULHHVQ: raises $15 to $25
XfRhywXA6Br+jID1oGeo8A: raises $82.80 to $107.80 and is all-in
618rKeLrz/avGNOLULHHVQ: folds
XfRhywXA6Br+jID1oGeo8A collected $56.50 from pot
XfRhywXA6Br+jID1oGeo8A: doesn't show hand
*** SUMMARY ***
Total pot $57 | Rake $0.50
Board [7d Td 8s Ac]
Seat 1: 618rKeLrz/avGNOLULHHVQ (button) (small blind) folded on the Turn
Seat 2: XfRhywXA6Br+jID1oGeo8A (big blind) collected ($56.50)



PokerStars Game #59937937086:  Hold'em No Limit ($0.25/$0.50) - 2009/07/01 0:03:17 ET
Table '5EmHi+fnatGQQShcNmzOZQ' 6-max Seat #4 is the button
Seat 1: SwPczQo3cOtwEzhJrfO2cQ ($18.40 in chips)
Seat 3: J8dF2sYMvXUmAGUuSW9kwg ($39.55 in chips)
Seat 4: mFTuMjESuBcXHQ1ePkg/8A ($21.55 in chips)
Seat 5: kxPhs4ePFqMy52CInAJ2aw ($73.30 in chips)
Seat 6: 686aeHikcJlgKkSuIFdcXQ ($112.30 in chips)
kxPhs4ePFqMy52CInAJ2aw: posts small blind $0.25
686aeHikcJlgKkSuIFdcXQ: posts big blind $0.50
*** HOLE CARDS ***
SwPczQo3cOtwEzhJrfO2cQ: calls $0.50
J8dF2sYMvXUmAGUuSW9kwg: folds
mFTuMjESuBcXHQ1ePkg/8A: raises $1 to $1.50
kxPhs4ePFqMy52CInAJ2aw: folds
686aeHikcJlgKkSuIFdcXQ: folds
SwPczQo3cOtwEzhJrfO2cQ: calls $1
*** FLOP *** [Jc 4d 6h]
SwPczQo3cOtwEzhJrfO2cQ: bets $1.50
mFTuMjESuBcXHQ1ePkg/8A: folds
SwPczQo3cOtwEzhJrfO2cQ collected $3.60 from pot
*** SUMMARY ***
Total pot $3.75 | Rake $0.15
Board [Jc 4d 6h]
Seat 1: SwPczQo3cOtwEzhJrfO2cQ collected ($3.60)
Seat 3: J8dF2sYMvXUmAGUuSW9kwg folded before Flop (didn't bet)
Seat 4: mFTuMjESuBcXHQ1ePkg/8A (button) folded on the Flop
Seat 5: kxPhs4ePFqMy52CInAJ2aw (small blind) folded before Flop
Seat 6: 686aeHikcJlgKkSuIFdcXQ (big blind) folded before Flop



PokerStars Game #59937937894:  Hold'em No Limit ($0.25/$0.50) - 2009/07/01 0:03:18 ET
Table 'E7bWJ45aoFXRpyRv2gw+Ig' 2-max Seat #1 is the button
Seat 1: FRkiRasEGlHUeLrEl+k/nA ($53.35 in chips)
Seat 2: 3Wro85I7472vJ4Wkpneo9A ($72.80 in chips)
FRkiRasEGlHUeLrEl+k/nA: posts small blind $0.25
3Wro85I7472vJ4Wkpneo9A: posts big blind $0.50
*** HOLE CARDS ***
FRkiRasEGlHUeLrEl+k/nA: calls $0.25
3Wro85I7472vJ4Wkpneo9A: checks
*** FLOP *** [7d 9d 7h]
3Wro85I7472vJ4Wkpneo9A: bets $1
FRkiRasEGlHUeLrEl+k/nA: folds
3Wro85I7472vJ4Wkpneo9A collected $0.95 from pot
3Wro85I7472vJ4Wkpneo9A: doesn't show hand
*** SUMMARY ***
Total pot $1 | Rake $0.05
Board [7d 9d 7h]
Seat 1: FRkiRasEGlHUeLrEl+k/nA (button) (small blind) folded on the Flop
Seat 2: 3Wro85I7472vJ4Wkpneo9A (big blind) collected ($0.95)



PokerStars Game #59937937626:  Hold'em No Limit ($0.25/$0.50) - 2009/07/01 0:03:18 ET
Table 'Vdlc9wqYcHTUhtdyN7CuJw' 2-max Seat #2 is the button
Seat 1: yBO+mXB6m/rCft2ErwGf/Q ($65.50 in chips)
Seat 2: sa0qgETiL3HNbdfGlnKHTA ($49.45 in chips)
sa0qgETiL3HNbdfGlnKHTA: posts small blind $0.25
yBO+mXB6m/rCft2ErwGf/Q: posts big blind $0.50
*** HOLE CARDS ***
sa0qgETiL3HNbdfGlnKHTA: raises $0.50 to $1
yBO+mXB6m/rCft2ErwGf/Q: calls $0.50
*** FLOP *** [8h 7c 2s]
yBO+mXB6m/rCft2ErwGf/Q: checks
sa0qgETiL3HNbdfGlnKHTA: checks
*** TURN *** [8h 7c 2s] [5d]
yBO+mXB6m/rCft2ErwGf/Q: checks
sa0qgETiL3HNbdfGlnKHTA: checks
*** RIVER *** [8h 7c 2s 5d] [Tc]
yBO+mXB6m/rCft2ErwGf/Q: bets $0.50
sa0qgETiL3HNbdfGlnKHTA: folds
yBO+mXB6m/rCft2ErwGf/Q collected $1.90 from pot
*** SUMMARY ***
Total pot $2 | Rake $0.10
Board [8h 7c 2s 5d Tc]
Seat 1: yBO+mXB6m/rCft2ErwGf/Q (big blind) collected ($1.90)
Seat 2: sa0qgETiL3HNbdfGlnKHTA (button) (small blind) folded on the River



PokerStars Game #59937938058:  Hold'em No Limit ($0.25/$0.50) - 2009/07/01 0:03:18 ET
Table 'lSisgp6H7Fg1hH5VfjEjYQ' 9-max Seat #2 is the button
Seat 1: pEW8B6uXbdR47kfljMQ3+Q ($38.55 in chips)
Seat 2: UrcnkQOiLVk8BlKDPJSy7Q ($53.10 in chips)
Seat 3: RjBdQ6w31rgcy0o24VLR6w ($13.40 in chips)
Seat 4: nvw9yQKhJT56lA9k+TLdhw ($11.40 in chips)
Seat 5: mSD1pginDsyHG5PDfqzphw ($12.35 in chips)
Seat 6: +k7T5ocke8UwavtgUHm+Cg ($30 in chips)
Seat 7: xyQ4CeZa3ug3ompz+5xSTg ($74.70 in chips)
Seat 9: 5JJVDlaiMnB004o/RqbZZQ ($28.50 in chips)
RjBdQ6w31rgcy0o24VLR6w: posts small blind $0.25
nvw9yQKhJT56lA9k+TLdhw: posts big blind $0.50
bXpVeaSTPBFSPJmeXxO7nw: sits out
*** HOLE CARDS ***
mSD1pginDsyHG5PDfqzphw: folds
+k7T5ocke8UwavtgUHm+Cg: folds
xyQ4CeZa3ug3ompz+5xSTg: folds
5JJVDlaiMnB004o/RqbZZQ: folds
pEW8B6uXbdR47kfljMQ3+Q: folds
UrcnkQOiLVk8BlKDPJSy7Q: raises $1.50 to $2
RjBdQ6w31rgcy0o24VLR6w: folds
nvw9yQKhJT56lA9k+TLdhw: folds
UrcnkQOiLVk8BlKDPJSy7Q collected $1.25 from pot
UrcnkQOiLVk8BlKDPJSy7Q: doesn't show hand
*** SUMMARY ***
Total pot $1.25 | Rake $0
Seat 1: pEW8B6uXbdR47kfljMQ3+Q folded before Flop (didn't bet)
Seat 2: UrcnkQOiLVk8BlKDPJSy7Q (button) collected ($1.25)
Seat 3: RjBdQ6w31rgcy0o24VLR6w (small blind) folded before Flop
Seat 4: nvw9yQKhJT56lA9k+TLdhw (big blind) folded before Flop
Seat 5: mSD1pginDsyHG5PDfqzphw folded before Flop (didn't bet)
Seat 6: +k7T5ocke8UwavtgUHm+Cg folded before Flop (didn't bet)
Seat 7: xyQ4CeZa3ug3ompz+5xSTg folded before Flop (didn't bet)
Seat 9: 5JJVDlaiMnB004o/RqbZZQ folded before Flop (didn't bet)



PokerStars Game #59937938168:  Hold'em No Limit ($0.25/$0.50) - 2009/07/01 0:03:19 ET
Table '+dXkOAQyS8j9PQZusUTMpg' 2-max Seat #2 is the button
Seat 1: XFa6sBGjP2gxoIvxR3fZIg ($91.70 in chips)
Seat 2: 5IBeOgaApY1Bvzv2P8X4EA ($10.40 in chips)
5IBeOgaApY1Bvzv2P8X4EA: posts small blind $0.25
XFa6sBGjP2gxoIvxR3fZIg: posts big blind $0.50
*** HOLE CARDS ***
5IBeOgaApY1Bvzv2P8X4EA: folds
XFa6sBGjP2gxoIvxR3fZIg collected $0.50 from pot
XFa6sBGjP2gxoIvxR3fZIg: doesn't show hand
*** SUMMARY ***
Total pot $0.50 | Rake $0
Seat 1: XFa6sBGjP2gxoIvxR3fZIg (big blind) collected ($0.50)
Seat 2: 5IBeOgaApY1Bvzv2P8X4EA (button) (small blind) folded before Flop



PokerStars Game #59937938268:  Hold'em No Limit ($0.25/$0.50) - 2009/07/01 0:03:19 ET
Table 'raOT4/ipuZgzjfKHC+jD9g' 2-max Seat #2 is the button
Seat 1: IuwLemwLhc9fvrwBGs0AMA ($10.80 in chips)
Seat 2: Udr5juWSWUgTu1NlRhjMdA ($13.45 in chips)
Udr5juWSWUgTu1NlRhjMdA: posts small blind $0.25
IuwLemwLhc9fvrwBGs0AMA: posts big blind $0.50
*** HOLE CARDS ***
Udr5juWSWUgTu1NlRhjMdA: folds
IuwLemwLhc9fvrwBGs0AMA collected $0.50 from pot
IuwLemwLhc9fvrwBGs0AMA: doesn't show hand
*** SUMMARY ***
Total pot $0.50 | Rake $0
Seat 1: IuwLemwLhc9fvrwBGs0AMA (big blind) collected ($0.50)
Seat 2: Udr5juWSWUgTu1NlRhjMdA (button) (small blind) folded before Flop



PokerStars Game #59937941736:  Hold'em No Limit ($0.25/$0.50) - 2009/07/01 0:03:24 ET
Table 'mTxf8gPLgffN3Iwfm7Icfg' 2-max Seat #1 is the button
Seat 1: Do9Rlu1R5u/AcRtMTl8SYg ($63.15 in chips)
Seat 2: EMc5LPgVaded4Qc77vm0fw ($52.55 in chips)
Do9Rlu1R5u/AcRtMTl8SYg: posts small blind $0.25
EMc5LPgVaded4Qc77vm0fw: posts big blind $0.50
*** HOLE CARDS ***
Do9Rlu1R5u/AcRtMTl8SYg: folds
EMc5LPgVaded4Qc77vm0fw collected $0.50 from pot
EMc5LPgVaded4Qc77vm0fw: doesn't show hand
*** SUMMARY ***
Total pot $0.50 | Rake $0
Seat 1: Do9Rlu1R5u/AcRtMTl8SYg (button) (small blind) folded before Flop
Seat 2: EMc5LPgVaded4Qc77vm0fw (big blind) collected ($0.50)



PokerStars Game #59937941952:  Hold'em No Limit ($0.25/$0.50) - 2009/07/01 0:03:24 ET
Table 'QOgaEqMcJ73pcUMMxoisUg' 6-max Seat #5 is the button
Seat 1: RFefXIDyFvNtJLq+CloCzA ($42.45 in chips)
Seat 3: wUZNozoIDYf+16hp4nn6dw ($24.15 in chips)
Seat 4: L5e2lrPLQm1Pqx30IIZ/Fw ($9.25 in chips)
Seat 5: HoaSQCRso+nEyO5DUhGduw ($71.60 in chips)
Seat 6: s83dnhZ6VC53vY0/f6OV/g ($41.35 in chips)
s83dnhZ6VC53vY0/f6OV/g: posts small blind $0.25
RFefXIDyFvNtJLq+CloCzA: posts big blind $0.50
*** HOLE CARDS ***
wUZNozoIDYf+16hp4nn6dw: calls $0.50
L5e2lrPLQm1Pqx30IIZ/Fw: folds
HoaSQCRso+nEyO5DUhGduw: raises $1 to $1.50
s83dnhZ6VC53vY0/f6OV/g: folds
RFefXIDyFvNtJLq+CloCzA: folds
wUZNozoIDYf+16hp4nn6dw: calls $1
*** FLOP *** [5h 5d 8c]
wUZNozoIDYf+16hp4nn6dw: checks
HoaSQCRso+nEyO5DUhGduw: bets $1.50
wUZNozoIDYf+16hp4nn6dw: calls $1.50
*** TURN *** [5h 5d 8c] [2d]
wUZNozoIDYf+16hp4nn6dw: checks
HoaSQCRso+nEyO5DUhGduw: bets $3
wUZNozoIDYf+16hp4nn6dw: calls $3
*** RIVER *** [5h 5d 8c 2d] [Kh]
wUZNozoIDYf+16hp4nn6dw: checks
HoaSQCRso+nEyO5DUhGduw: checks
*** SHOW DOWN ***
wUZNozoIDYf+16hp4nn6dw: shows [8s 3s] (two pair, Eights and Fives)
HoaSQCRso+nEyO5DUhGduw: shows [Ad 8h] (two pair, Eights and Fives - Ace kicker)
HoaSQCRso+nEyO5DUhGduw collected $12.15 from pot
*** SUMMARY ***
Total pot $12.75 | Rake $0.60
Board [5h 5d 8c 2d Kh]
Seat 1: RFefXIDyFvNtJLq+CloCzA (big blind) folded before Flop
Seat 3: wUZNozoIDYf+16hp4nn6dw showed [8s 3s] and lost with two pair, Eights and Fives
Seat 4: L5e2lrPLQm1Pqx30IIZ/Fw folded before Flop (didn't bet)
Seat 5: HoaSQCRso+nEyO5DUhGduw (button) showed [Ad 8h] and won ($12.15) with two pair, Eights and Fives
Seat 6: s83dnhZ6VC53vY0/f6OV/g (small blind) folded before Flop



PokerStars Game #59937943078:  Hold'em No Limit ($0.25/$0.50) - 2009/07/01 0:03:25 ET
Table 'raOT4/ipuZgzjfKHC+jD9g' 2-max Seat #1 is the button
Seat 1: IuwLemwLhc9fvrwBGs0AMA ($11.05 in chips)
Seat 2: Udr5juWSWUgTu1NlRhjMdA ($13.20 in chips)
IuwLemwLhc9fvrwBGs0AMA: posts small blind $0.25
Udr5juWSWUgTu1NlRhjMdA: posts big blind $0.50
*** HOLE CARDS ***
IuwLemwLhc9fvrwBGs0AMA: calls $0.25
Udr5juWSWUgTu1NlRhjMdA: raises $1 to $1.50
IuwLemwLhc9fvrwBGs0AMA: calls $1
*** FLOP *** [7d 4h Jh]
Udr5juWSWUgTu1NlRhjMdA: bets $2
IuwLemwLhc9fvrwBGs0AMA: folds
Udr5juWSWUgTu1NlRhjMdA collected $2.85 from pot
Udr5juWSWUgTu1NlRhjMdA: doesn't show hand
*** SUMMARY ***
Total pot $3 | Rake $0.15
Board [7d 4h Jh]
Seat 1: IuwLemwLhc9fvrwBGs0AMA (button) (small blind) folded on the Flop
Seat 2: Udr5juWSWUgTu1NlRhjMdA (big blind) collected ($2.85)



PokerStars Game #59937943198:  Hold'em No Limit ($0.25/$0.50) - 2009/07/01 0:03:26 ET
Table '+dXkOAQyS8j9PQZusUTMpg' 2-max Seat #1 is the button
Seat 1: XFa6sBGjP2gxoIvxR3fZIg ($91.95 in chips)
Seat 2: 5IBeOgaApY1Bvzv2P8X4EA ($10.15 in chips)
XFa6sBGjP2gxoIvxR3fZIg: posts small blind $0.25
5IBeOgaApY1Bvzv2P8X4EA: posts big blind $0.50
*** HOLE CARDS ***
XFa6sBGjP2gxoIvxR3fZIg: calls $0.25
5IBeOgaApY1Bvzv2P8X4EA: checks
*** FLOP *** [Qh 3c 7h]
5IBeOgaApY1Bvzv2P8X4EA: checks
XFa6sBGjP2gxoIvxR3fZIg: bets $1
5IBeOgaApY1Bvzv2P8X4EA: calls $1
*** TURN *** [Qh 3c 7h] [8c]
5IBeOgaApY1Bvzv2P8X4EA: checks
XFa6sBGjP2gxoIvxR3fZIg: bets $2.50
5IBeOgaApY1Bvzv2P8X4EA: calls $2.50
*** RIVER *** [Qh 3c 7h 8c] [3s]
5IBeOgaApY1Bvzv2P8X4EA: checks
XFa6sBGjP2gxoIvxR3fZIg: bets $65
5IBeOgaApY1Bvzv2P8X4EA: folds
XFa6sBGjP2gxoIvxR3fZIg collected $7.65 from pot
*** SUMMARY ***
Total pot $8 | Rake $0.35
Board [Qh 3c 7h 8c 3s]
Seat 1: XFa6sBGjP2gxoIvxR3fZIg (button) (small blind) collected ($7.65)
Seat 2: 5IBeOgaApY1Bvzv2P8X4EA (big blind) folded on the River



PokerStars Game #59937945288:  Hold'em No Limit ($0.25/$0.50) - 2009/07/01 0:03:28 ET
Table 'tpZbcIvqh/6WmfR/i5IE3A' 9-max Seat #3 is the button
Seat 1: nV/P1jFY/CFMXOLWu7pYmA ($14.45 in chips)
Seat 2: M+7+BTmX5vZatHVuoRB1nA ($45.90 in chips)
Seat 3: 3w0FbBQAKwQODwenKwZxXw ($74.85 in chips)
Seat 4: zE9cVigS2nW/Ljy4K4bUQA ($30 in chips)
Seat 5: 9r7ZoBbAJj5IeyZ0q9BdzA ($13.20 in chips)
Seat 6: E2518gp4aFz1+kAgmGqeEg ($12.20 in chips)
Seat 7: wIZ377kjl2fHFGnS93o6bw ($15.45 in chips)
Seat 8: bXpVeaSTPBFSPJmeXxO7nw ($9.85 in chips)
zE9cVigS2nW/Ljy4K4bUQA: posts small blind $0.25
9r7ZoBbAJj5IeyZ0q9BdzA: posts big blind $0.50
*** HOLE CARDS ***
E2518gp4aFz1+kAgmGqeEg: folds
wIZ377kjl2fHFGnS93o6bw: calls $0.50
bXpVeaSTPBFSPJmeXxO7nw: folds
nV/P1jFY/CFMXOLWu7pYmA: folds
M+7+BTmX5vZatHVuoRB1nA: folds
3w0FbBQAKwQODwenKwZxXw: calls $0.50
zE9cVigS2nW/Ljy4K4bUQA: folds
9r7ZoBbAJj5IeyZ0q9BdzA: checks
*** FLOP *** [5d Jh 6s]
9r7ZoBbAJj5IeyZ0q9BdzA: checks
wIZ377kjl2fHFGnS93o6bw: checks
3w0FbBQAKwQODwenKwZxXw: checks
*** TURN *** [5d Jh 6s] [Td]
9r7ZoBbAJj5IeyZ0q9BdzA: checks
wIZ377kjl2fHFGnS93o6bw: bets $0.50
3w0FbBQAKwQODwenKwZxXw: calls $0.50
9r7ZoBbAJj5IeyZ0q9BdzA: calls $0.50
*** RIVER *** [5d Jh 6s Td] [Qh]
9r7ZoBbAJj5IeyZ0q9BdzA: checks
wIZ377kjl2fHFGnS93o6bw: checks
3w0FbBQAKwQODwenKwZxXw: bets $2.50
9r7ZoBbAJj5IeyZ0q9BdzA: folds
wIZ377kjl2fHFGnS93o6bw: folds
3w0FbBQAKwQODwenKwZxXw collected $3.10 from pot
*** SUMMARY ***
Total pot $3.25 | Rake $0.15
Board [5d Jh 6s Td Qh]
Seat 1: nV/P1jFY/CFMXOLWu7pYmA folded before Flop (didn't bet)
Seat 2: M+7+BTmX5vZatHVuoRB1nA folded before Flop (didn't bet)
Seat 3: 3w0FbBQAKwQODwenKwZxXw (button) collected ($3.10)
Seat 4: zE9cVigS2nW/Ljy4K4bUQA (small blind) folded before Flop
Seat 5: 9r7ZoBbAJj5IeyZ0q9BdzA (big blind) folded on the River
Seat 6: E2518gp4aFz1+kAgmGqeEg folded before Flop (didn't bet)
Seat 7: wIZ377kjl2fHFGnS93o6bw folded on the River
Seat 8: bXpVeaSTPBFSPJmeXxO7nw folded before Flop (didn't bet)



PokerStars Game #59937945666:  Hold'em No Limit ($0.25/$0.50) - 2009/07/01 0:03:29 ET
Table 'ibNfFy0bCzuBaUORla0aGw' 9-max Seat #5 is the button
Seat 1: xZCXQSXlrZkp3pZizzVXCw ($56.95 in chips)
Seat 2: 90Wb75h3W1BRpbqVnuk8gw ($50 in chips)
Seat 3: dDaHs3X8+fe3bIkRU0cbrw ($26.55 in chips)
Seat 4: YBN054X4blmis+B2bBlC0g ($22.20 in chips)
Seat 5: FRv75HO8CUsRZ1byEz06mQ ($15.35 in chips)
Seat 6: BmYrv3ec2k5d6pQq6iNaZw ($66.50 in chips)
Seat 7: mSD1pginDsyHG5PDfqzphw ($10 in chips)
Seat 8: xUrN9TWLq4m5V+OXY7KUUA ($50.50 in chips)
Seat 9: WpvT3OUSiZlpvs+mPXFqtQ ($8 in chips)
BmYrv3ec2k5d6pQq6iNaZw: posts small blind $0.25
mSD1pginDsyHG5PDfqzphw: posts big blind $0.50
*** HOLE CARDS ***
xUrN9TWLq4m5V+OXY7KUUA: folds
WpvT3OUSiZlpvs+mPXFqtQ: raises $1.50 to $2
xZCXQSXlrZkp3pZizzVXCw: folds
90Wb75h3W1BRpbqVnuk8gw: folds
dDaHs3X8+fe3bIkRU0cbrw: folds
YBN054X4blmis+B2bBlC0g: folds
FRv75HO8CUsRZ1byEz06mQ: folds
BmYrv3ec2k5d6pQq6iNaZw: folds
mSD1pginDsyHG5PDfqzphw: folds
WpvT3OUSiZlpvs+mPXFqtQ collected $1.25 from pot
*** SUMMARY ***
Total pot $1.25 | Rake $0
Seat 1: xZCXQSXlrZkp3pZizzVXCw folded before Flop (didn't bet)
Seat 2: 90Wb75h3W1BRpbqVnuk8gw folded before Flop (didn't bet)
Seat 3: dDaHs3X8+fe3bIkRU0cbrw folded before Flop (didn't bet)
Seat 4: YBN054X4blmis+B2bBlC0g folded before Flop (didn't bet)
Seat 5: FRv75HO8CUsRZ1byEz06mQ (button) folded before Flop (didn't bet)
Seat 6: BmYrv3ec2k5d6pQq6iNaZw (small blind) folded before Flop
Seat 7: mSD1pginDsyHG5PDfqzphw (big blind) folded before Flop
Seat 8: xUrN9TWLq4m5V+OXY7KUUA folded before Flop (didn't bet)
Seat 9: WpvT3OUSiZlpvs+mPXFqtQ collected ($1.25)



PokerStars Game #59937946450:  Hold'em No Limit ($0.25/$0.50) - 2009/07/01 0:03:30 ET
Table 'MJxeZCzYELxiIsyUZyT0jw' 6-max Seat #2 is the button
Seat 1: iKPos8JI094Tomq4tDSgnQ ($20.50 in chips)
Seat 2: r6H1GiZ6QIpMTDhyodKuRQ ($65.65 in chips)
Seat 3: JQZew0FjzS19kTjeNtrE+A ($58.10 in chips)
Seat 4: lP7Q6pewz4C2RsAfKsjdWw ($25.80 in chips)
Seat 6: TTx3CHxyi0SObcHyMJRp5w ($41.70 in chips)
JQZew0FjzS19kTjeNtrE+A: posts small blind $0.25
lP7Q6pewz4C2RsAfKsjdWw: posts big blind $0.50
*** HOLE CARDS ***
TTx3CHxyi0SObcHyMJRp5w: folds
iKPos8JI094Tomq4tDSgnQ: raises $0.50 to $1
r6H1GiZ6QIpMTDhyodKuRQ: folds
JQZew0FjzS19kTjeNtrE+A: calls $0.75
lP7Q6pewz4C2RsAfKsjdWw: calls $0.50
*** FLOP *** [8d Qs 7s]
JQZew0FjzS19kTjeNtrE+A: checks
3jvoOXNtXE90w2BdfNZwZQ joins the table at seat #5
lP7Q6pewz4C2RsAfKsjdWw: checks
iKPos8JI094Tomq4tDSgnQ: bets $2
JQZew0FjzS19kTjeNtrE+A: calls $2
lP7Q6pewz4C2RsAfKsjdWw: folds
*** TURN *** [8d Qs 7s] [8c]
JQZew0FjzS19kTjeNtrE+A: checks
iKPos8JI094Tomq4tDSgnQ: checks
*** RIVER *** [8d Qs 7s 8c] [Ks]
JQZew0FjzS19kTjeNtrE+A: bets $4
iKPos8JI094Tomq4tDSgnQ: raises $13.50 to $17.50 and is all-in
JQZew0FjzS19kTjeNtrE+A: folds
iKPos8JI094Tomq4tDSgnQ collected $14.30 from pot
iKPos8JI094Tomq4tDSgnQ: shows [2s As] (a flush, Ace high)
*** SUMMARY ***
Total pot $15 | Rake $0.70
Board [8d Qs 7s 8c Ks]
Seat 1: iKPos8JI094Tomq4tDSgnQ collected ($14.30)
Seat 2: r6H1GiZ6QIpMTDhyodKuRQ (button) folded before Flop (didn't bet)
Seat 3: JQZew0FjzS19kTjeNtrE+A (small blind) folded on the River
Seat 4: lP7Q6pewz4C2RsAfKsjdWw (big blind) folded on the Flop
Seat 6: TTx3CHxyi0SObcHyMJRp5w folded before Flop (didn't bet)



PokerStars Game #59937946042:  Hold'em No Limit ($0.25/$0.50) - 2009/07/01 0:03:30 ET
Table 'mTxf8gPLgffN3Iwfm7Icfg' 2-max Seat #2 is the button
Seat 1: Do9Rlu1R5u/AcRtMTl8SYg ($62.90 in chips)
Seat 2: EMc5LPgVaded4Qc77vm0fw ($52.80 in chips)
EMc5LPgVaded4Qc77vm0fw: posts small blind $0.25
Do9Rlu1R5u/AcRtMTl8SYg: posts big blind $0.50
*** HOLE CARDS ***
EMc5LPgVaded4Qc77vm0fw: raises $1 to $1.50
Do9Rlu1R5u/AcRtMTl8SYg: folds
EMc5LPgVaded4Qc77vm0fw collected $1 from pot
EMc5LPgVaded4Qc77vm0fw: doesn't show hand
*** SUMMARY ***
Total pot $1 | Rake $0
Seat 1: Do9Rlu1R5u/AcRtMTl8SYg (big blind) folded before Flop
Seat 2: EMc5LPgVaded4Qc77vm0fw (button) (small blind) collected ($1)



PokerStars Game #59937948138:  Hold'em No Limit ($0.25/$0.50) - 2009/07/01 0:03:32 ET
Table 'iq+aXfWVQRdV0u8SRTYUEg' 9-max Seat #7 is the button
Seat 1: McPJctgiiz9IXq3OttAeOA ($7.45 in chips)
Seat 3: itOQCm2+5ujaA68I6hPvfg ($123 in chips)
Seat 5: MZo49KUcOZcn7g/WRL0Vqw ($44.90 in chips)
Seat 6: 8qvUviDc+VoNV1cmSHjjLw ($29.90 in chips)
Seat 7: SKnJuWHScqetA/qG5p+wCg ($30 in chips)
Seat 8: k1f0lS7tlMHCLGs0JT34Tg ($28.75 in chips)
Seat 9: bXpVeaSTPBFSPJmeXxO7nw ($11.60 in chips)
k1f0lS7tlMHCLGs0JT34Tg: posts small blind $0.25
bXpVeaSTPBFSPJmeXxO7nw: posts big blind $0.50
*** HOLE CARDS ***
McPJctgiiz9IXq3OttAeOA: folds
itOQCm2+5ujaA68I6hPvfg: folds
+Z4e6ELfE9slw801LJ3vAw leaves the table
MZo49KUcOZcn7g/WRL0Vqw: raises $2.50 to $3
8qvUviDc+VoNV1cmSHjjLw: folds
SKnJuWHScqetA/qG5p+wCg: folds
k1f0lS7tlMHCLGs0JT34Tg: raises $2.50 to $5.50
bXpVeaSTPBFSPJmeXxO7nw: folds
MZo49KUcOZcn7g/WRL0Vqw: calls $2.50
*** FLOP *** [8c 4h Jd]
k1f0lS7tlMHCLGs0JT34Tg: bets $2
MZo49KUcOZcn7g/WRL0Vqw: raises $7 to $9
k1f0lS7tlMHCLGs0JT34Tg: raises $7 to $16
MZo49KUcOZcn7g/WRL0Vqw: raises $7 to $23
6XkTu4ahxzHnvjjc1R8YjQ joins the table at seat #4
k1f0lS7tlMHCLGs0JT34Tg: raises $0.25 to $23.25 and is all-in
MZo49KUcOZcn7g/WRL0Vqw: calls $0.25
*** TURN *** [8c 4h Jd] [2s]
*** RIVER *** [8c 4h Jd 2s] [4d]
*** SHOW DOWN ***
k1f0lS7tlMHCLGs0JT34Tg: shows [As Ah] (two pair, Aces and Fours)
MZo49KUcOZcn7g/WRL0Vqw: shows [4c 4s] (four of a kind, Fours)
MZo49KUcOZcn7g/WRL0Vqw collected $55.15 from pot
*** SUMMARY ***
Total pot $58 | Rake $2.85
Board [8c 4h Jd 2s 4d]
Seat 1: McPJctgiiz9IXq3OttAeOA folded before Flop (didn't bet)
Seat 3: itOQCm2+5ujaA68I6hPvfg folded before Flop (didn't bet)
Seat 5: MZo49KUcOZcn7g/WRL0Vqw showed [4c 4s] and won ($55.15) with four of a kind, Fours
Seat 6: 8qvUviDc+VoNV1cmSHjjLw folded before Flop (didn't bet)
Seat 7: SKnJuWHScqetA/qG5p+wCg (button) folded before Flop (didn't bet)
Seat 8: k1f0lS7tlMHCLGs0JT34Tg (small blind) showed [As Ah] and lost with two pair, Aces and Fours
Seat 9: bXpVeaSTPBFSPJmeXxO7nw (big blind) folded before Flop



PokerStars Game #59937949572:  Hold'em No Limit ($0.25/$0.50) - 2009/07/01 0:03:34 ET
Table 'QOgaEqMcJ73pcUMMxoisUgErOuyGLI5PT3G5MnpHgC/g Seat #7 is the button
Seat 1: k6GJzKs7T7qvQggW9g8Pdw ($48.75 in chips)
Seat 2: RjBdQ6w31rgcy0o24VLR6w ($8.75 in chips)
Seat 3: xZCXQSXlrZkp3pZizzVXCw ($49 in chips)
Seat 4: U7aZzIYWjv3SL30KtikLbw ($49.45 in chips)
Seat 5: JwvquocWfhTVApN5t47LgA ($51.05 in chips)
Seat 6: zE9cVigS2nW/Ljy4K4bUQA ($31.35 in chips)
Seat 7: 90Wb75h3W1BRpbqVnuk8gw ($64.55 in chips)
Seat 8: ajP1NjIMdqQfpMbzHzvejw ($38.80 in chips)
Seat 9: J0W5D97jl5VLky+IoPvDeA ($68.55 in chips)
ajP1NjIMdqQfpMbzHzvejw: posts small blind $0.25
J0W5D97jl5VLky+IoPvDeA: posts big blind $0.50
*** HOLE CARDS ***
k6GJzKs7T7qvQggW9g8Pdw: folds
RjBdQ6w31rgcy0o24VLR6w: folds
xZCXQSXlrZkp3pZizzVXCw: folds
U7aZzIYWjv3SL30KtikLbw: folds
JwvquocWfhTVApN5t47LgA: folds
zE9cVigS2nW/Ljy4K4bUQA: folds
90Wb75h3W1BRpbqVnuk8gw: raises $1.50 to $2
ajP1NjIMdqQfpMbzHzvejw: raises $3.50 to $5.50
J0W5D97jl5VLky+IoPvDeA: folds
90Wb75h3W1BRpbqVnuk8gw: folds
ajP1NjIMdqQfpMbzHzvejw collected $4.50 from pot
*** SUMMARY ***
Total pot $4.50 | Rake $0
Seat 1: k6GJzKs7T7qvQggW9g8Pdw folded before Flop (didn't bet)
Seat 2: RjBdQ6w31rgcy0o24VLR6w folded before Flop (didn't bet)
Seat 3: xZCXQSXlrZkp3pZizzVXCw folded before Flop (didn't bet)
Seat 4: U7aZzIYWjv3SL30KtikLbw folded before Flop (didn't bet)
Seat 5: JwvquocWfhTVApN5t47LgA folded before Flop (didn't bet)
Seat 6: zE9cVigS2nW/Ljy4K4bUQA folded before Flop (didn't bet)
Seat 7: 90Wb75h3W1BRpbqVnuk8gw (button) folded before Flop
Seat 8: ajP1NjIMdqQfpMbzHzvejw (small blind) collected ($4.50)
Seat 9: J0W5D97jl5VLky+IoPvDeA (big blind) folded before Flop



PokerStars Game #59937949834:  Hold'em No Limit ($0.25/$0.50) - 2009/07/01 0:03:35 ET
Table 'lpxYasB1ClBSgTpCCITwhQ' 9-max Seat #3 is the button
Seat 1: ceq82/EkjUd/GFbf0YwGmA ($37.50 in chips)
Seat 2: 5JJVDlaiMnB004o/RqbZZQ ($41.90 in chips)
Seat 3: E2518gp4aFz1+kAgmGqeEg ($10.75 in chips)
Seat 4: k1f0lS7tlMHCLGs0JT34Tg ($9.50 in chips)
Seat 5: bXpVeaSTPBFSPJmeXxO7nw ($10 in chips)
Seat 6: YPo1oggovmqSREegekaQYw ($17.25 in chips)
Seat 7: zE9cVigS2nW/Ljy4K4bUQA ($30 in chips)
Seat 8: o6JyUkbzCDw8tUabqtmnlg ($27.45 in chips)
Seat 9: mSD1pginDsyHG5PDfqzphw ($10 in chips)
k1f0lS7tlMHCLGs0JT34Tg: posts small blind $0.25
bXpVeaSTPBFSPJmeXxO7nw: posts big blind $0.50
*** HOLE CARDS ***
YPo1oggovmqSREegekaQYw: folds
zE9cVigS2nW/Ljy4K4bUQA: folds
o6JyUkbzCDw8tUabqtmnlg: calls $0.50
mSD1pginDsyHG5PDfqzphw: folds
ceq82/EkjUd/GFbf0YwGmA: raises $0.50 to $1
5JJVDlaiMnB004o/RqbZZQ has timed out
5JJVDlaiMnB004o/RqbZZQ: folds
5JJVDlaiMnB004o/RqbZZQ is sitting out
E2518gp4aFz1+kAgmGqeEg: folds
k1f0lS7tlMHCLGs0JT34Tg: folds
bXpVeaSTPBFSPJmeXxO7nw: folds
o6JyUkbzCDw8tUabqtmnlg: calls $0.50
*** FLOP *** [4d 2h 8c]
o6JyUkbzCDw8tUabqtmnlg: bets $2
ceq82/EkjUd/GFbf0YwGmA: raises $4 to $6
o6JyUkbzCDw8tUabqtmnlg: folds
ceq82/EkjUd/GFbf0YwGmA collected $6.45 from pot
ceq82/EkjUd/GFbf0YwGmA: doesn't show hand
*** SUMMARY ***
Total pot $6.75 | Rake $0.30
Board [4d 2h 8c]
Seat 1: ceq82/EkjUd/GFbf0YwGmA collected ($6.45)
Seat 2: 5JJVDlaiMnB004o/RqbZZQ folded before Flop (didn't bet)
Seat 3: E2518gp4aFz1+kAgmGqeEg (button) folded before Flop (didn't bet)
Seat 4: k1f0lS7tlMHCLGs0JT34Tg (small blind) folded before Flop
Seat 5: bXpVeaSTPBFSPJmeXxO7nw (big blind) folded before Flop
Seat 6: YPo1oggovmqSREegekaQYw folded before Flop (didn't bet)
Seat 7: zE9cVigS2nW/Ljy4K4bUQA folded before Flop (didn't bet)
Seat 8: o6JyUkbzCDw8tUabqtmnlg folded on the Flop
Seat 9: mSD1pginDsyHG5PDfqzphw folded before Flop (didn't bet)



PokerStars Game #59937950802:  Hold'em No Limit ($0.25/$0.50) - 2009/07/01 0:03:36 ET
Table 'kgbJRsxfv64KrErDRBAkcw' 6-max Seat #4 is the button
Seat 1: YmWlPGOKFuJSoJZPW8a8IA ($82.55 in chips)
Seat 3: T0Gx/FcQ5VH9u7XaOMX97A ($62.40 in chips)
Seat 4: qanMEqjABjWxC/JgQ/0l7w ($51.50 in chips)
Seat 5: SlTdlH14u+KVVINgxMwt+Q ($76.20 in chips)
Seat 6: DDfYzIrYT0t5R/hAJngtsg ($26.65 in chips)
SlTdlH14u+KVVINgxMwt+Q: posts small blind $0.25
DDfYzIrYT0t5R/hAJngtsg: posts big blind $0.50
Q+thC23WCv1kJUJtH/+4Jw: sits out
*** HOLE CARDS ***
YmWlPGOKFuJSoJZPW8a8IA: folds
T0Gx/FcQ5VH9u7XaOMX97A: folds
qanMEqjABjWxC/JgQ/0l7w: raises $1 to $1.50
SlTdlH14u+KVVINgxMwt+Q: calls $1.25
DDfYzIrYT0t5R/hAJngtsg: calls $1
*** FLOP *** [Td 9d 4d]
SlTdlH14u+KVVINgxMwt+Q: checks
DDfYzIrYT0t5R/hAJngtsg: checks
qanMEqjABjWxC/JgQ/0l7w: bets $2.50
SlTdlH14u+KVVINgxMwt+Q: folds
DDfYzIrYT0t5R/hAJngtsg: folds
qanMEqjABjWxC/JgQ/0l7w collected $4.30 from pot
*** SUMMARY ***
Total pot $4.50 | Rake $0.20
Board [Td 9d 4d]
Seat 1: YmWlPGOKFuJSoJZPW8a8IA folded before Flop (didn't bet)
Seat 3: T0Gx/FcQ5VH9u7XaOMX97A folded before Flop (didn't bet)
Seat 4: qanMEqjABjWxC/JgQ/0l7w (button) collected ($4.30)
Seat 5: SlTdlH14u+KVVINgxMwt+Q (small blind) folded on the Flop
Seat 6: DDfYzIrYT0t5R/hAJngtsg (big blind) folded on the Flop



PokerStars Game #59937950874:  Hold'em No Limit ($0.25/$0.50) - 2009/07/01 0:03:36 ET
Table '+z1aekfHkpp09pc8F9aViw' 6-max Seat #1 is the button
Seat 1: lWwl5C/UZOsWNubdUqghZw ($50 in chips)
Seat 2: VuB2GN0h94yY+QbuI2Mybg ($24.95 in chips)
Seat 3: uUznlIMFnRUvwrBhYF73KA ($57.05 in chips)
Seat 4: OCrv7ObFH4/s2lv7rYOnsQ ($22.45 in chips)
Seat 5: crjGpJEzSZgD38FoE3VMGg ($62.90 in chips)
Seat 6: 686aeHikcJlgKkSuIFdcXQ ($67.90 in chips)
VuB2GN0h94yY+QbuI2Mybg: posts small blind $0.25
uUznlIMFnRUvwrBhYF73KA: posts big blind $0.50
*** HOLE CARDS ***
OCrv7ObFH4/s2lv7rYOnsQ: calls $0.50
crjGpJEzSZgD38FoE3VMGg: folds
686aeHikcJlgKkSuIFdcXQ: folds
lWwl5C/UZOsWNubdUqghZw: folds
VuB2GN0h94yY+QbuI2Mybg: calls $0.25
uUznlIMFnRUvwrBhYF73KA: checks
*** FLOP *** [2h Kd 8d]
VuB2GN0h94yY+QbuI2Mybg: checks
uUznlIMFnRUvwrBhYF73KA: bets $1.50
OCrv7ObFH4/s2lv7rYOnsQ: calls $1.50
VuB2GN0h94yY+QbuI2Mybg: folds
*** TURN *** [2h Kd 8d] [Qc]
uUznlIMFnRUvwrBhYF73KA: checks
OCrv7ObFH4/s2lv7rYOnsQ: checks
*** RIVER *** [2h Kd 8d Qc] [5h]
uUznlIMFnRUvwrBhYF73KA: bets $4
OCrv7ObFH4/s2lv7rYOnsQ: calls $4
*** SHOW DOWN ***
uUznlIMFnRUvwrBhYF73KA: shows [8h 7h] (a pair of Eights)
OCrv7ObFH4/s2lv7rYOnsQ: mucks hand
uUznlIMFnRUvwrBhYF73KA collected $11.90 from pot
*** SUMMARY ***
Total pot $12.50 | Rake $0.60
Board [2h Kd 8d Qc 5h]
Seat 1: lWwl5C/UZOsWNubdUqghZw (button) folded before Flop (didn't bet)
Seat 2: VuB2GN0h94yY+QbuI2Mybg (small blind) folded on the Flop
Seat 3: uUznlIMFnRUvwrBhYF73KA (big blind) showed [8h 7h] and won ($11.90) with a pair of Eights
Seat 4: OCrv7ObFH4/s2lv7rYOnsQ mucked
Seat 5: crjGpJEzSZgD38FoE3VMGg folded before Flop (didn't bet)
Seat 6: 686aeHikcJlgKkSuIFdcXQ folded before Flop (didn't bet)



PokerStars Game #59937950914:  Hold'em No Limit ($0.25/$0.50) - 2009/07/01 0:03:36 ET
Table 'E7bWJ45aoFXRpyRv2gw+Ig' 2-max Seat #2 is the button
Seat 1: FRkiRasEGlHUeLrEl+k/nA ($52.85 in chips)
Seat 2: 3Wro85I7472vJ4Wkpneo9A ($73.25 in chips)
3Wro85I7472vJ4Wkpneo9A: posts small blind $0.25
FRkiRasEGlHUeLrEl+k/nA: posts big blind $0.50
*** HOLE CARDS ***
3Wro85I7472vJ4Wkpneo9A: raises $1 to $1.50
FRkiRasEGlHUeLrEl+k/nA: calls $1
*** FLOP *** [2s 2h Td]
FRkiRasEGlHUeLrEl+k/nA: checks
3Wro85I7472vJ4Wkpneo9A: checks
*** TURN *** [2s 2h Td] [Jd]
FRkiRasEGlHUeLrEl+k/nA: checks
3Wro85I7472vJ4Wkpneo9A: bets $2
FRkiRasEGlHUeLrEl+k/nA: calls $2
*** RIVER *** [2s 2h Td Jd] [4c]
FRkiRasEGlHUeLrEl+k/nA: checks
3Wro85I7472vJ4Wkpneo9A: bets $4
FRkiRasEGlHUeLrEl+k/nA: calls $4
*** SHOW DOWN ***
3Wro85I7472vJ4Wkpneo9A: shows [Qd 9c] (a pair of Deuces)
FRkiRasEGlHUeLrEl+k/nA: shows [Ts 6s] (two pair, Tens and Deuces)
FRkiRasEGlHUeLrEl+k/nA collected $14.50 from pot
*** SUMMARY ***
Total pot $15 | Rake $0.50
Board [2s 2h Td Jd 4c]
Seat 1: FRkiRasEGlHUeLrEl+k/nA (big blind) showed [Ts 6s] and won ($14.50) with two pair, Tens and Deuces
Seat 2: 3Wro85I7472vJ4Wkpneo9A (button) (small blind) showed [Qd 9c] and lost with a pair of Deuces



PokerStars Game #59937951262:  Hold'em No Limit ($0.25/$0.50) - 2009/07/01 0:03:37 ET
Table 'BCN5su+SsXiy1zRMJi0SJw' 6-max Seat #4 is the button
Seat 1: 5EiAo0XuFchfJkhvFPvoog ($100.20 in chips)
Seat 2: QfV2JJlmEKgD5jYPV+a33A ($159.40 in chips)
Seat 3: yrJsFKWv+ttHooqghxDx3A ($3.80 in chips)
Seat 4: 6Wb8PlO2kM4fnSim7p4Mrw ($10.50 in chips)
Seat 5: TTx3CHxyi0SObcHyMJRp5w ($39.60 in chips)
Seat 6: zHXshyreKwJVq3N3U+K9uQ ($52.05 in chips)
TTx3CHxyi0SObcHyMJRp5w: posts small blind $0.25
zHXshyreKwJVq3N3U+K9uQ: posts big blind $0.50
*** HOLE CARDS ***
5EiAo0XuFchfJkhvFPvoog: folds
QfV2JJlmEKgD5jYPV+a33A: folds
yrJsFKWv+ttHooqghxDx3A: folds
6Wb8PlO2kM4fnSim7p4Mrw: raises $0.50 to $1
TTx3CHxyi0SObcHyMJRp5w: folds
zHXshyreKwJVq3N3U+K9uQ: folds
6Wb8PlO2kM4fnSim7p4Mrw collected $1.25 from pot
*** SUMMARY ***
Total pot $1.25 | Rake $0
Seat 1: 5EiAo0XuFchfJkhvFPvoog folded before Flop (didn't bet)
Seat 2: QfV2JJlmEKgD5jYPV+a33A folded before Flop (didn't bet)
Seat 3: yrJsFKWv+ttHooqghxDx3A folded before Flop (didn't bet)
Seat 4: 6Wb8PlO2kM4fnSim7p4Mrw (button) collected ($1.25)
Seat 5: TTx3CHxyi0SObcHyMJRp5w (small blind) folded before Flop
Seat 6: zHXshyreKwJVq3N3U+K9uQ (big blind) folded before Flop



PokerStars Game #59937952214:  Hold'em No Limit ($0.25/$0.50) - 2009/07/01 0:03:38 ET
Table 'hSTs/dUsYLgJQuF2Onp0MQ' 6-max Seat #6 is the button
Seat 1: lWwl5C/UZOsWNubdUqghZw ($70.95 in chips)
Seat 3: vQOrJuXbLC3UZDVklY9bOA ($12 in chips)
Seat 4: L0aIPg7qefDQjdJo3HCVEA ($15.20 in chips)
Seat 5: 686aeHikcJlgKkSuIFdcXQ ($61.40 in chips)
Seat 6: +laPa9P7BjZKKnR0n+OmvA ($12 in chips)
lWwl5C/UZOsWNubdUqghZw: posts small blind $0.25
vQOrJuXbLC3UZDVklY9bOA: posts big blind $0.50
*** HOLE CARDS ***
L0aIPg7qefDQjdJo3HCVEA: folds
686aeHikcJlgKkSuIFdcXQ: folds
+laPa9P7BjZKKnR0n+OmvA: folds
lWwl5C/UZOsWNubdUqghZw: folds
vQOrJuXbLC3UZDVklY9bOA collected $0.50 from pot
*** SUMMARY ***
Total pot $0.50 | Rake $0
Seat 1: lWwl5C/UZOsWNubdUqghZw (small blind) folded before Flop
Seat 3: vQOrJuXbLC3UZDVklY9bOA (big blind) collected ($0.50)
Seat 4: L0aIPg7qefDQjdJo3HCVEA folded before Flop (didn't bet)
Seat 5: 686aeHikcJlgKkSuIFdcXQ folded before Flop (didn't bet)
Seat 6: +laPa9P7BjZKKnR0n+OmvA (button) folded before Flop (didn't bet)



PokerStars Game #59937953032:  Hold'em No Limit ($0.25/$0.50) - 2009/07/01 0:03:39 ET
Table '37qXEp3oe+er5q4CZip9eQ' 6-max Seat #4 is the button
Seat 1: 4qceN3NM3S463h+TT4UvGQ ($14.30 in chips)
Seat 2: g12O9qXTybyo2C0B2bXgjg ($22.10 in chips)
Seat 3: Rt6KgtZ8YaJoTc3FPim00w ($109.10 in chips)
Seat 4: L0aIPg7qefDQjdJo3HCVEA ($10.30 in chips)
Seat 5: VOmI0x4dDPnTESZd5B4d1Q ($31 in chips)
Seat 6: f7zPpUQp9hHZgqhEvrUWQw ($56.65 in chips)
VOmI0x4dDPnTESZd5B4d1Q: posts small blind $0.25
f7zPpUQp9hHZgqhEvrUWQw: posts big blind $0.50
4qceN3NM3S463h+TT4UvGQ: posts big blind $0.50
*** HOLE CARDS ***
4qceN3NM3S463h+TT4UvGQ: checks
g12O9qXTybyo2C0B2bXgjg: raises $1 to $1.50
Rt6KgtZ8YaJoTc3FPim00w: folds
L0aIPg7qefDQjdJo3HCVEA: folds
VOmI0x4dDPnTESZd5B4d1Q: folds
f7zPpUQp9hHZgqhEvrUWQw: folds
4qceN3NM3S463h+TT4UvGQ: calls $1
*** FLOP *** [2s Tc Qh]
4qceN3NM3S463h+TT4UvGQ: checks
g12O9qXTybyo2C0B2bXgjg: bets $2
4qceN3NM3S463h+TT4UvGQ: folds
g12O9qXTybyo2C0B2bXgjg collected $3.60 from pot
*** SUMMARY ***
Total pot $3.75 | Rake $0.15
Board [2s Tc Qh]
Seat 1: 4qceN3NM3S463h+TT4UvGQ folded on the Flop
Seat 2: g12O9qXTybyo2C0B2bXgjg collected ($3.60)
Seat 3: Rt6KgtZ8YaJoTc3FPim00w folded before Flop (didn't bet)
Seat 4: L0aIPg7qefDQjdJo3HCVEA (button) folded before Flop (didn't bet)
Seat 5: VOmI0x4dDPnTESZd5B4d1Q (small blind) folded before Flop
Seat 6: f7zPpUQp9hHZgqhEvrUWQw (big blind) folded before Flop



PokerStars Game #59937952796:  Hold'em No Limit ($0.25/$0.50) - 2009/07/01 0:03:39 ET
Table 'Vdlc9wqYcHTUhtdyN7CuJw' 2-max Seat #1 is the button
Seat 1: yBO+mXB6m/rCft2ErwGf/Q ($66.40 in chips)
Seat 2: sa0qgETiL3HNbdfGlnKHTA ($48.45 in chips)
yBO+mXB6m/rCft2ErwGf/Q: posts small blind $0.25
sa0qgETiL3HNbdfGlnKHTA: posts big blind $0.50
*** HOLE CARDS ***
yBO+mXB6m/rCft2ErwGf/Q: calls $0.25
sa0qgETiL3HNbdfGlnKHTA: raises $1 to $1.50
yBO+mXB6m/rCft2ErwGf/Q: calls $1
*** FLOP *** [7c 2h Ac]
sa0qgETiL3HNbdfGlnKHTA: bets $1.50
yBO+mXB6m/rCft2ErwGf/Q: calls $1.50
*** TURN *** [7c 2h Ac] [9c]
sa0qgETiL3HNbdfGlnKHTA: bets $2.50
yBO+mXB6m/rCft2ErwGf/Q: folds
sa0qgETiL3HNbdfGlnKHTA collected $5.75 from pot
sa0qgETiL3HNbdfGlnKHTA: doesn't show hand
*** SUMMARY ***
Total pot $6 | Rake $0.25
Board [7c 2h Ac 9c]
Seat 1: yBO+mXB6m/rCft2ErwGf/Q (button) (small blind) folded on the Turn
Seat 2: sa0qgETiL3HNbdfGlnKHTA (big blind) collected ($5.75)



PokerStars Game #59937954194:  Hold'em No Limit ($0.25/$0.50) - 2009/07/01 0:03:41 ET
Table 'mTxf8gPLgffN3Iwfm7Icfg' 2-max Seat #1 is the button
Seat 1: Do9Rlu1R5u/AcRtMTl8SYg ($62.40 in chips)
Seat 2: EMc5LPgVaded4Qc77vm0fw ($53.30 in chips)
Do9Rlu1R5u/AcRtMTl8SYg: posts small blind $0.25
EMc5LPgVaded4Qc77vm0fw: posts big blind $0.50
*** HOLE CARDS ***
Do9Rlu1R5u/AcRtMTl8SYg: folds
EMc5LPgVaded4Qc77vm0fw collected $0.50 from pot
EMc5LPgVaded4Qc77vm0fw: doesn't show hand
*** SUMMARY ***
Total pot $0.50 | Rake $0
Seat 1: Do9Rlu1R5u/AcRtMTl8SYg (button) (small blind) folded before Flop
Seat 2: EMc5LPgVaded4Qc77vm0fw (big blind) collected ($0.50)



PokerStars Game #59937956698:  Hold'em No Limit ($0.25/$0.50) - 2009/07/01 0:03:44 ET
Table 'SsXEKOwKN+jE3etfusqUqA' 2-max Seat #2 is the button
Seat 1: 618rKeLrz/avGNOLULHHVQ ($56.15 in chips)
Seat 2: XfRhywXA6Br+jID1oGeo8A ($139.30 in chips)
XfRhywXA6Br+jID1oGeo8A: posts small blind $0.25
618rKeLrz/avGNOLULHHVQ: posts big blind $0.50
*** HOLE CARDS ***
XfRhywXA6Br+jID1oGeo8A: folds
618rKeLrz/avGNOLULHHVQ collected $0.50 from pot
618rKeLrz/avGNOLULHHVQ: doesn't show hand
*** SUMMARY ***
Total pot $0.50 | Rake $0
Seat 1: 618rKeLrz/avGNOLULHHVQ (big blind) collected ($0.50)
Seat 2: XfRhywXA6Br+jID1oGeo8A (button) (small blind) folded before Flop



PokerStars Game #59937956754:  Hold'em No Limit ($0.25/$0.50) - 2009/07/01 0:03:44 ET
Table 'raOT4/ipuZgzjfKHC+jD9g' 2-max Seat #2 is the button
Seat 1: IuwLemwLhc9fvrwBGs0AMA ($9.55 in chips)
Seat 2: Udr5juWSWUgTu1NlRhjMdA ($14.55 in chips)
Udr5juWSWUgTu1NlRhjMdA: posts small blind $0.25
IuwLemwLhc9fvrwBGs0AMA: posts big blind $0.50
*** HOLE CARDS ***
Udr5juWSWUgTu1NlRhjMdA: folds
IuwLemwLhc9fvrwBGs0AMA collected $0.50 from pot
*** SUMMARY ***
Total pot $0.50 | Rake $0
Seat 1: IuwLemwLhc9fvrwBGs0AMA (big blind) collected ($0.50)
Seat 2: Udr5juWSWUgTu1NlRhjMdA (button) (small blind) folded before Flop



PokerStars Game #59937958510:  Hold'em No Limit ($0.25/$0.50) - 2009/07/01 0:03:47 ET
Table 'otvGDROEDdqsabxskT79qg' 9-max Seat #2 is the button
Seat 1: LM/g4VPDfD+0JhpH9Q/3fw ($26.55 in chips)
Seat 2: cCjTzH9jio8607WzjcfXlg ($51.60 in chips)
Seat 3: +k7T5ocke8UwavtgUHm+Cg ($52.85 in chips)
Seat 4: MG90wfSJZnOejs/KD3vlQQ ($50 in chips)
Seat 5: YPo1oggovmqSREegekaQYw ($12.25 in chips)
Seat 6: 5JJVDlaiMnB004o/RqbZZQ ($31.80 in chips)
Seat 7: C7+tBppJrKgd/r+tuKUIpA ($39.85 in chips)
Seat 8: NnQCepdIR/AOUQn1yhYx6Q ($9.25 in chips)
Seat 9: KcY3X8YpD74Kw1RHkx/g4A ($39.35 in chips)
+k7T5ocke8UwavtgUHm+Cg: posts small blind $0.25
MG90wfSJZnOejs/KD3vlQQ: posts big blind $0.50
*** HOLE CARDS ***
YPo1oggovmqSREegekaQYw: folds
5JJVDlaiMnB004o/RqbZZQ has timed out
5JJVDlaiMnB004o/RqbZZQ: folds
5JJVDlaiMnB004o/RqbZZQ is sitting out
C7+tBppJrKgd/r+tuKUIpA: calls $0.50
NnQCepdIR/AOUQn1yhYx6Q: folds
KcY3X8YpD74Kw1RHkx/g4A: folds
LM/g4VPDfD+0JhpH9Q/3fw: folds
cCjTzH9jio8607WzjcfXlg: calls $0.50
+k7T5ocke8UwavtgUHm+Cg: calls $0.25
MG90wfSJZnOejs/KD3vlQQ: checks
*** FLOP *** [8c Ts 9s]
+k7T5ocke8UwavtgUHm+Cg: checks
MG90wfSJZnOejs/KD3vlQQ: checks
C7+tBppJrKgd/r+tuKUIpA: checks
cCjTzH9jio8607WzjcfXlg: checks
*** TURN *** [8c Ts 9s] [Kc]
+k7T5ocke8UwavtgUHm+Cg: checks
MG90wfSJZnOejs/KD3vlQQ: checks
C7+tBppJrKgd/r+tuKUIpA: checks
cCjTzH9jio8607WzjcfXlg: checks
*** RIVER *** [8c Ts 9s Kc] [Qc]
+k7T5ocke8UwavtgUHm+Cg: checks
MG90wfSJZnOejs/KD3vlQQ: checks
C7+tBppJrKgd/r+tuKUIpA: bets $1.50
cCjTzH9jio8607WzjcfXlg: folds
+k7T5ocke8UwavtgUHm+Cg: folds
MG90wfSJZnOejs/KD3vlQQ: folds
C7+tBppJrKgd/r+tuKUIpA collected $1.90 from pot
*** SUMMARY ***
Total pot $2 | Rake $0.10
Board [8c Ts 9s Kc Qc]
Seat 1: LM/g4VPDfD+0JhpH9Q/3fw folded before Flop (didn't bet)
Seat 2: cCjTzH9jio8607WzjcfXlg (button) folded on the River
Seat 3: +k7T5ocke8UwavtgUHm+Cg (small blind) folded on the River
Seat 4: MG90wfSJZnOejs/KD3vlQQ (big blind) folded on the River
Seat 5: YPo1oggovmqSREegekaQYw folded before Flop (didn't bet)
Seat 6: 5JJVDlaiMnB004o/RqbZZQ folded before Flop (didn't bet)
Seat 7: C7+tBppJrKgd/r+tuKUIpA collected ($1.90)
Seat 8: NnQCepdIR/AOUQn1yhYx6Q folded before Flop (didn't bet)
Seat 9: KcY3X8YpD74Kw1RHkx/g4A folded before Flop (didn't bet)



PokerStars Game #59937959248:  Hold'em No Limit ($0.25/$0.50) - 2009/07/01 0:03:48 ET
Table 'mTxf8gPLgffN3Iwfm7Icfg' 2-max Seat #2 is the button
Seat 1: Do9Rlu1R5u/AcRtMTl8SYg ($62.15 in chips)
Seat 2: EMc5LPgVaded4Qc77vm0fw ($53.55 in chips)
EMc5LPgVaded4Qc77vm0fw: posts small blind $0.25
Do9Rlu1R5u/AcRtMTl8SYg: posts big blind $0.50
*** HOLE CARDS ***
EMc5LPgVaded4Qc77vm0fw: raises $1.50 to $2
Do9Rlu1R5u/AcRtMTl8SYg: folds
EMc5LPgVaded4Qc77vm0fw collected $1 from pot
EMc5LPgVaded4Qc77vm0fw: doesn't show hand
*** SUMMARY ***
Total pot $1 | Rake $0
Seat 1: Do9Rlu1R5u/AcRtMTl8SYg (big blind) folded before Flop
Seat 2: EMc5LPgVaded4Qc77vm0fw (button) (small blind) collected ($1)



PokerStars Game #59937959860:  Hold'em No Limit ($0.25/$0.50) - 2009/07/01 0:03:49 ET
Table 'oxUN1yBuOHNrPf4xoy4aXw' 2-max Seat #2 is the button
Seat 1: ndd1nfncBkWNitBnsfCoVQ ($49.85 in chips)
Seat 2: Tf2f1DMF33jxTU3s+z95kA ($15.75 in chips)
Tf2f1DMF33jxTU3s+z95kA: posts small blind $0.25
ndd1nfncBkWNitBnsfCoVQ: posts big blind $0.50
*** HOLE CARDS ***
Tf2f1DMF33jxTU3s+z95kA: raises $1.50 to $2
ndd1nfncBkWNitBnsfCoVQ: raises $4 to $6
Tf2f1DMF33jxTU3s+z95kA: raises $9.75 to $15.75 and is all-in
ndd1nfncBkWNitBnsfCoVQ: calls $9.75
*** FLOP *** [Qd Kh 9h]
*** TURN *** [Qd Kh 9h] [Qs]
*** RIVER *** [Qd Kh 9h Qs] [3d]
*** SHOW DOWN ***
ndd1nfncBkWNitBnsfCoVQ: shows [Kd Ah] (two pair, Kings and Queens)
Tf2f1DMF33jxTU3s+z95kA: mucks hand
ndd1nfncBkWNitBnsfCoVQ collected $31 from pot
*** SUMMARY ***
Total pot $31.50 | Rake $0.50
Board [Qd Kh 9h Qs 3d]
Seat 1: ndd1nfncBkWNitBnsfCoVQ (big blind) showed [Kd Ah] and won ($31) with two pair, Kings and Queens
Seat 2: Tf2f1DMF33jxTU3s+z95kA (button) (small blind) mucked



PokerStars Game #59937961184:  Hold'em No Limit ($0.25/$0.50) - 2009/07/01 0:03:50 ET
Table 'SsXEKOwKN+jE3etfusqUqA' 2-max Seat #1 is the button
Seat 1: 618rKeLrz/avGNOLULHHVQ ($56.40 in chips)
Seat 2: XfRhywXA6Br+jID1oGeo8A ($139.05 in chips)
618rKeLrz/avGNOLULHHVQ: posts small blind $0.25
XfRhywXA6Br+jID1oGeo8A: posts big blind $0.50
*** HOLE CARDS ***
618rKeLrz/avGNOLULHHVQ: raises $0.50 to $1
XfRhywXA6Br+jID1oGeo8A: calls $0.50
*** FLOP *** [6c Qh Ah]
XfRhywXA6Br+jID1oGeo8A: checks
618rKeLrz/avGNOLULHHVQ: bets $1
XfRhywXA6Br+jID1oGeo8A: calls $1
*** TURN *** [6c Qh Ah] [3d]
XfRhywXA6Br+jID1oGeo8A: checks
618rKeLrz/avGNOLULHHVQ: bets $2.50
XfRhywXA6Br+jID1oGeo8A: raises $5 to $7.50
618rKeLrz/avGNOLULHHVQ: raises $44.50 to $52
XfRhywXA6Br+jID1oGeo8A: calls $44.50
*** RIVER *** [6c Qh Ah 3d] [Qd]
XfRhywXA6Br+jID1oGeo8A: checks
618rKeLrz/avGNOLULHHVQ: bets $2.40 and is all-in
XfRhywXA6Br+jID1oGeo8A: calls $2.40
*** SHOW DOWN ***
618rKeLrz/avGNOLULHHVQ: shows [7s 8s] (a pair of Queens)
XfRhywXA6Br+jID1oGeo8A: shows [3h 6h] (two pair, Queens and Sixes)
XfRhywXA6Br+jID1oGeo8A collected $112.30 from pot
*** SUMMARY ***
Total pot $112.80 | Rake $0.50
Board [6c Qh Ah 3d Qd]
Seat 1: 618rKeLrz/avGNOLULHHVQ (button) (small blind) showed [7s 8s] and lost with a pair of Queens
Seat 2: XfRhywXA6Br+jID1oGeo8A (big blind) showed [3h 6h] and won ($112.30) with two pair, Queens and Sixes



PokerStars Game #59937961302:  Hold'em No Limit ($0.25/$0.50) - 2009/07/01 0:03:50 ET
Table 'raOT4/ipuZgzjfKHC+jD9g' 2-max Seat #1 is the button
Seat 1: IuwLemwLhc9fvrwBGs0AMA ($9.80 in chips)
Seat 2: Udr5juWSWUgTu1NlRhjMdA ($14.30 in chips)
IuwLemwLhc9fvrwBGs0AMA: posts small blind $0.25
Udr5juWSWUgTu1NlRhjMdA: posts big blind $0.50
*** HOLE CARDS ***
IuwLemwLhc9fvrwBGs0AMA: raises $1 to $1.50
Udr5juWSWUgTu1NlRhjMdA: folds
IuwLemwLhc9fvrwBGs0AMA collected $1 from pot
*** SUMMARY ***
Total pot $1 | Rake $0
Seat 1: IuwLemwLhc9fvrwBGs0AMA (button) (small blind) collected ($1)
Seat 2: Udr5juWSWUgTu1NlRhjMdA (big blind) folded before Flop



PokerStars Game #59937960806:  Hold'em No Limit ($0.25/$0.50) - 2009/07/01 0:03:50 ET
Table 'EiNh8p/wGJ1FP575iMFnqg' 9-max Seat #2 is the button
Seat 1: r3ZqM1Mi0W3y4hOdssE+Sg ($41.35 in chips)
Seat 2: avsQkZXsRKnWa7gkjVNvog ($27.90 in chips)
Seat 3: GszS/McxOSUnOET7MBoHqA ($57 in chips)
Seat 4: pk8aA8qMBEL6zXqSyfVXMA ($80.80 in chips)
Seat 5: M+7+BTmX5vZatHVuoRB1nA ($93.50 in chips)
Seat 6: YPo1oggovmqSREegekaQYw ($14.75 in chips)
Seat 7: Wj7mKnRFR90j40wWUu2+Og ($27.40 in chips)
Seat 8: C7LqTSTGrMSBCecHvwQAOQ ($55.30 in chips)
Seat 9: OMwFJ4pF0xk2Ru/AJiFeFw ($73.40 in chips)
GszS/McxOSUnOET7MBoHqA: posts small blind $0.25
pk8aA8qMBEL6zXqSyfVXMA: posts big blind $0.50
*** HOLE CARDS ***
M+7+BTmX5vZatHVuoRB1nA: folds
YPo1oggovmqSREegekaQYw: folds
Wj7mKnRFR90j40wWUu2+Og: calls $0.50
C7LqTSTGrMSBCecHvwQAOQ: folds
OMwFJ4pF0xk2Ru/AJiFeFw: calls $0.50
r3ZqM1Mi0W3y4hOdssE+Sg: calls $0.50
avsQkZXsRKnWa7gkjVNvog: folds
GszS/McxOSUnOET7MBoHqA: calls $0.25
pk8aA8qMBEL6zXqSyfVXMA: checks
*** FLOP *** [Kd As 9s]
GszS/McxOSUnOET7MBoHqA: checks
pk8aA8qMBEL6zXqSyfVXMA: checks
Wj7mKnRFR90j40wWUu2+Og: checks
OMwFJ4pF0xk2Ru/AJiFeFw: checks
r3ZqM1Mi0W3y4hOdssE+Sg: bets $2
GszS/McxOSUnOET7MBoHqA: folds
pk8aA8qMBEL6zXqSyfVXMA: folds
Wj7mKnRFR90j40wWUu2+Og: folds
OMwFJ4pF0xk2Ru/AJiFeFw: folds
r3ZqM1Mi0W3y4hOdssE+Sg collected $2.40 from pot
*** SUMMARY ***
Total pot $2.50 | Rake $0.10
Board [Kd As 9s]
Seat 1: r3ZqM1Mi0W3y4hOdssE+Sg collected ($2.40)
Seat 2: avsQkZXsRKnWa7gkjVNvog (button) folded before Flop (didn't bet)
Seat 3: GszS/McxOSUnOET7MBoHqA (small blind) folded on the Flop
Seat 4: pk8aA8qMBEL6zXqSyfVXMA (big blind) folded on the Flop
Seat 5: M+7+BTmX5vZatHVuoRB1nA folded before Flop (didn't bet)
Seat 6: YPo1oggovmqSREegekaQYw folded before Flop (didn't bet)
Seat 7: Wj7mKnRFR90j40wWUu2+Og folded on the Flop
Seat 8: C7LqTSTGrMSBCecHvwQAOQ folded before Flop (didn't bet)
Seat 9: OMwFJ4pF0xk2Ru/AJiFeFw folded on the Flop



PokerStars Game #59937961726:  Hold'em No Limit ($0.25/$0.50) - 2009/07/01 0:03:51 ET
Table 'BCN5su+SsXiy1zRMJi0SJw' 6-max Seat #5 is the button
Seat 2: QfV2JJlmEKgD5jYPV+a33A ($159.40 in chips)
Seat 3: yrJsFKWv+ttHooqghxDx3A ($3.80 in chips)
Seat 4: 6Wb8PlO2kM4fnSim7p4Mrw ($11.25 in chips)
Seat 5: TTx3CHxyi0SObcHyMJRp5w ($39.35 in chips)
Seat 6: zHXshyreKwJVq3N3U+K9uQ ($51.55 in chips)
zHXshyreKwJVq3N3U+K9uQ: posts small blind $0.25
5EiAo0XuFchfJkhvFPvoog: is sitting out
QfV2JJlmEKgD5jYPV+a33A: posts big blind $0.50
*** HOLE CARDS ***
yrJsFKWv+ttHooqghxDx3A: folds
5EiAo0XuFchfJkhvFPvoog leaves the table
6Wb8PlO2kM4fnSim7p4Mrw: folds
TTx3CHxyi0SObcHyMJRp5w: folds
zHXshyreKwJVq3N3U+K9uQ: folds
QfV2JJlmEKgD5jYPV+a33A collected $0.50 from pot
QfV2JJlmEKgD5jYPV+a33A: doesn't show hand
*** SUMMARY ***
Total pot $0.50 | Rake $0
Seat 2: QfV2JJlmEKgD5jYPV+a33A (big blind) collected ($0.50)
Seat 3: yrJsFKWv+ttHooqghxDx3A folded before Flop (didn't bet)
Seat 4: 6Wb8PlO2kM4fnSim7p4Mrw folded before Flop (didn't bet)
Seat 5: TTx3CHxyi0SObcHyMJRp5w (button) folded before Flop (didn't bet)
Seat 6: zHXshyreKwJVq3N3U+K9uQ (small blind) folded before Flop



PokerStars Game #59937962122:  Hold'em No Limit ($0.25/$0.50) - 2009/07/01 0:03:52 ET
Table '5EmHi+fnatGQQShcNmzOZQ' 6-max Seat #5 is the button
Seat 1: SwPczQo3cOtwEzhJrfO2cQ ($20.50 in chips)
Seat 3: J8dF2sYMvXUmAGUuSW9kwg ($39.55 in chips)
Seat 4: mFTuMjESuBcXHQ1ePkg/8A ($20.05 in chips)
Seat 5: kxPhs4ePFqMy52CInAJ2aw ($73.05 in chips)
Seat 6: 686aeHikcJlgKkSuIFdcXQ ($111.80 in chips)
686aeHikcJlgKkSuIFdcXQ: posts small blind $0.25
SwPczQo3cOtwEzhJrfO2cQ: posts big blind $0.50
*** HOLE CARDS ***
J8dF2sYMvXUmAGUuSW9kwg: calls $0.50
mFTuMjESuBcXHQ1ePkg/8A: folds
kxPhs4ePFqMy52CInAJ2aw: folds
686aeHikcJlgKkSuIFdcXQ: calls $0.25
SwPczQo3cOtwEzhJrfO2cQ: checks
*** FLOP *** [2s 6s As]
686aeHikcJlgKkSuIFdcXQ: checks
APwvTk5XojDXGoQLb4O5iA has returned
SwPczQo3cOtwEzhJrfO2cQ: checks
J8dF2sYMvXUmAGUuSW9kwg: bets $1
686aeHikcJlgKkSuIFdcXQ: calls $1
SwPczQo3cOtwEzhJrfO2cQ: folds
*** TURN *** [2s 6s As] [2c]
686aeHikcJlgKkSuIFdcXQ: checks
J8dF2sYMvXUmAGUuSW9kwg: checks
*** RIVER *** [2s 6s As 2c] [Qd]
686aeHikcJlgKkSuIFdcXQ: checks
J8dF2sYMvXUmAGUuSW9kwg: bets $2
686aeHikcJlgKkSuIFdcXQ: calls $2
*** SHOW DOWN ***
J8dF2sYMvXUmAGUuSW9kwg: shows [Qc 4c] (two pair, Queens and Deuces)
686aeHikcJlgKkSuIFdcXQ: shows [Ad 4d] (two pair, Aces and Deuces)
686aeHikcJlgKkSuIFdcXQ collected $7.15 from pot
*** SUMMARY ***
Total pot $7.50 | Rake $0.35
Board [2s 6s As 2c Qd]
Seat 1: SwPczQo3cOtwEzhJrfO2cQ (big blind) folded on the Flop
Seat 3: J8dF2sYMvXUmAGUuSW9kwg showed [Qc 4c] and lost with two pair, Queens and Deuces
Seat 4: mFTuMjESuBcXHQ1ePkg/8A folded before Flop (didn't bet)
Seat 5: kxPhs4ePFqMy52CInAJ2aw (button) folded before Flop (didn't bet)
Seat 6: 686aeHikcJlgKkSuIFdcXQ (small blind) showed [Ad 4d] and won ($7.15) with two pair, Aces and Deuces



PokerStars Game #59937964344:  Hold'em No Limit ($0.25/$0.50) - 2009/07/01 0:03:55 ET
Table 'GfL/No5u5PoEnU39lP5pQg' 6-max Seat #1 is the button
Seat 1: T0Gx/FcQ5VH9u7XaOMX97A ($54.90 in chips)
Seat 2: uVwggSetzp7d+eVgowO3vg ($20.30 in chips)
Seat 3: YmWlPGOKFuJSoJZPW8a8IA ($95.95 in chips)
Seat 4: yqM0AD7MZQd/cEtKdDQY1A ($34.65 in chips)
Seat 6: 5EiAo0XuFchfJkhvFPvoog ($62.20 in chips)
uVwggSetzp7d+eVgowO3vg: posts small blind $0.25
YmWlPGOKFuJSoJZPW8a8IA: posts big blind $0.50
*** HOLE CARDS ***
yqM0AD7MZQd/cEtKdDQY1A: folds
5EiAo0XuFchfJkhvFPvoog: folds
T0Gx/FcQ5VH9u7XaOMX97A: raises $1 to $1.50
uVwggSetzp7d+eVgowO3vg: calls $1.25
YmWlPGOKFuJSoJZPW8a8IA: raises $5.50 to $7
T0Gx/FcQ5VH9u7XaOMX97A: folds
uVwggSetzp7d+eVgowO3vg: folds
YmWlPGOKFuJSoJZPW8a8IA collected $4.50 from pot
YmWlPGOKFuJSoJZPW8a8IA: doesn't show hand
*** SUMMARY ***
Total pot $4.50 | Rake $0
Seat 1: T0Gx/FcQ5VH9u7XaOMX97A (button) folded before Flop
Seat 2: uVwggSetzp7d+eVgowO3vg (small blind) folded before Flop
Seat 3: YmWlPGOKFuJSoJZPW8a8IA (big blind) collected ($4.50)
Seat 4: yqM0AD7MZQd/cEtKdDQY1A folded before Flop (didn't bet)
Seat 6: 5EiAo0XuFchfJkhvFPvoog folded before Flop (didn't bet)



PokerStars Game #59937964678:  Hold'em No Limit ($0.25/$0.50) - 2009/07/01 0:03:55 ET
Table 'YsnnHkamRzYqMOr2FlLY4w' 6-max Seat #1 is the button
Seat 1: crjGpJEzSZgD38FoE3VMGg ($54.30 in chips)
Seat 2: 2dIa62hMcn6g73rbkt9NwA ($62.60 in chips)
Seat 3: I+pG2m/dD5iYdbg9qx572g ($23.65 in chips)
Seat 4: 7Fue572p4ZIC85AJMQvaQw ($45.80 in chips)
Seat 5: lcQ7uuLf+WLGGy4Ve6VKKA ($47.50 in chips)
Seat 6: YmWlPGOKFuJSoJZPW8a8IA ($50 in chips)
2dIa62hMcn6g73rbkt9NwA: posts small blind $0.25
I+pG2m/dD5iYdbg9qx572g: posts big blind $0.50
*** HOLE CARDS ***
7Fue572p4ZIC85AJMQvaQw: folds
lcQ7uuLf+WLGGy4Ve6VKKA: folds
YmWlPGOKFuJSoJZPW8a8IA: raises $1 to $1.50
crjGpJEzSZgD38FoE3VMGg: folds
2dIa62hMcn6g73rbkt9NwA: folds
I+pG2m/dD5iYdbg9qx572g: calls $1
*** FLOP *** [5d 3d Qc]
I+pG2m/dD5iYdbg9qx572g: bets $1.50
YmWlPGOKFuJSoJZPW8a8IA: folds
I+pG2m/dD5iYdbg9qx572g collected $3.10 from pot
I+pG2m/dD5iYdbg9qx572g: doesn't show hand
*** SUMMARY ***
Total pot $3.25 | Rake $0.15
Board [5d 3d Qc]
Seat 1: crjGpJEzSZgD38FoE3VMGg (button) folded before Flop (didn't bet)
Seat 2: 2dIa62hMcn6g73rbkt9NwA (small blind) folded before Flop
Seat 3: I+pG2m/dD5iYdbg9qx572g (big blind) collected ($3.10)
Seat 4: 7Fue572p4ZIC85AJMQvaQw folded before Flop (didn't bet)
Seat 5: lcQ7uuLf+WLGGy4Ve6VKKA folded before Flop (didn't bet)
Seat 6: YmWlPGOKFuJSoJZPW8a8IA folded on the Flop



PokerStars Game #59937966476:  Hold'em No Limit ($0.25/$0.50) - 2009/07/01 0:03:58 ET
Table 'c/CRn+68J3Y8KxD5g1ek2Q' 2-max Seat #2 is the button
Seat 1: 46qCyJ6evTkHo9al5sBMNA ($330.20 in chips)
Seat 2: BypVLsYQt3ePFm2xQL/dOA ($57.85 in chips)
BypVLsYQt3ePFm2xQL/dOA: posts small blind $0.25
46qCyJ6evTkHo9al5sBMNA: posts big blind $0.50
*** HOLE CARDS ***
BypVLsYQt3ePFm2xQL/dOA: raises $2 to $2.50
46qCyJ6evTkHo9al5sBMNA: folds
BypVLsYQt3ePFm2xQL/dOA collected $1 from pot
BypVLsYQt3ePFm2xQL/dOA: doesn't show hand
*** SUMMARY ***
Total pot $1 | Rake $0
Seat 1: 46qCyJ6evTkHo9al5sBMNA (big blind) folded before Flop
Seat 2: BypVLsYQt3ePFm2xQL/dOA (button) (small blind) collected ($1)



PokerStars Game #59937967080:  Hold'em No Limit ($0.25/$0.50) - 2009/07/01 0:03:58 ET
Table 'eMxdLyFDf28E0wit6gm3Uw' 6-max Seat #4 is the button
Seat 1: tnD/64LagZ9qPaeOQVjVZg ($10.50 in chips)
Seat 2: jwuKQ1S3U4NnzMQn3E3dgw ($65.90 in chips)
Seat 4: crjGpJEzSZgD38FoE3VMGg ($50 in chips)
Seat 5: X0X97o2fDAPiGx6o1gahsw ($56.85 in chips)
Seat 6: L0aIPg7qefDQjdJo3HCVEA ($8.25 in chips)
X0X97o2fDAPiGx6o1gahsw: posts small blind $0.25
L0aIPg7qefDQjdJo3HCVEA: posts big blind $0.50
*** HOLE CARDS ***
tnD/64LagZ9qPaeOQVjVZg: folds
jwuKQ1S3U4NnzMQn3E3dgw: folds
crjGpJEzSZgD38FoE3VMGg: folds
X0X97o2fDAPiGx6o1gahsw: calls $0.25
L0aIPg7qefDQjdJo3HCVEA: checks
*** FLOP *** [Jd 5c 8c]
X0X97o2fDAPiGx6o1gahsw: bets $0.75
L0aIPg7qefDQjdJo3HCVEA: folds
X0X97o2fDAPiGx6o1gahsw collected $0.95 from pot
*** SUMMARY ***
Total pot $1 | Rake $0.05
Board [Jd 5c 8c]
Seat 1: tnD/64LagZ9qPaeOQVjVZg folded before Flop (didn't bet)
Seat 2: jwuKQ1S3U4NnzMQn3E3dgw folded before Flop (didn't bet)
Seat 4: crjGpJEzSZgD38FoE3VMGg (button) folded before Flop (didn't bet)
Seat 5: X0X97o2fDAPiGx6o1gahsw (small blind) collected ($0.95)
Seat 6: L0aIPg7qefDQjdJo3HCVEA (big blind) folded on the Flop



PokerStars Game #59937969008:  Hold'em No Limit ($0.25/$0.50) - 2009/07/01 0:04:01 ET
Table 'mTxf8gPLgffN3Iwfm7Icfg' 2-max Seat #1 is the button
Seat 1: Do9Rlu1R5u/AcRtMTl8SYg ($61.65 in chips)
Seat 2: EMc5LPgVaded4Qc77vm0fw ($54.05 in chips)
Do9Rlu1R5u/AcRtMTl8SYg: posts small blind $0.25
EMc5LPgVaded4Qc77vm0fw: posts big blind $0.50
*** HOLE CARDS ***
Do9Rlu1R5u/AcRtMTl8SYg: raises $1 to $1.50
EMc5LPgVaded4Qc77vm0fw: calls $1
*** FLOP *** [2s Ts 6s]
EMc5LPgVaded4Qc77vm0fw: bets $2
Do9Rlu1R5u/AcRtMTl8SYg: raises $4 to $6
EMc5LPgVaded4Qc77vm0fw: calls $4
*** TURN *** [2s Ts 6s] [Qs]
EMc5LPgVaded4Qc77vm0fw: checks
Do9Rlu1R5u/AcRtMTl8SYg: checks
*** RIVER *** [2s Ts 6s Qs] [2c]
EMc5LPgVaded4Qc77vm0fw: bets $6.50
Do9Rlu1R5u/AcRtMTl8SYg: raises $11.50 to $18
EMc5LPgVaded4Qc77vm0fw: folds
Do9Rlu1R5u/AcRtMTl8SYg collected $27.50 from pot
Do9Rlu1R5u/AcRtMTl8SYg: doesn't show hand
*** SUMMARY ***
Total pot $28 | Rake $0.50
Board [2s Ts 6s Qs 2c]
Seat 1: Do9Rlu1R5u/AcRtMTl8SYg (button) (small blind) collected ($27.50)
Seat 2: EMc5LPgVaded4Qc77vm0fw (big blind) folded on the River



PokerStars Game #59937969042:  Hold'em No Limit ($0.25/$0.50) - 2009/07/01 0:04:01 ET
Table 'raOT4/ipuZgzjfKHC+jD9g' 2-max Seat #2 is the button
Seat 1: IuwLemwLhc9fvrwBGs0AMA ($10.30 in chips)
Seat 2: Udr5juWSWUgTu1NlRhjMdA ($13.80 in chips)
Udr5juWSWUgTu1NlRhjMdA: posts small blind $0.25
IuwLemwLhc9fvrwBGs0AMA: posts big blind $0.50
*** HOLE CARDS ***
Udr5juWSWUgTu1NlRhjMdA: calls $0.25
IuwLemwLhc9fvrwBGs0AMA: checks
*** FLOP *** [As 4h 3d]
IuwLemwLhc9fvrwBGs0AMA: checks
Udr5juWSWUgTu1NlRhjMdA: checks
*** TURN *** [As 4h 3d] [7c]
IuwLemwLhc9fvrwBGs0AMA: checks
Udr5juWSWUgTu1NlRhjMdA: bets $0.50
IuwLemwLhc9fvrwBGs0AMA: calls $0.50
*** RIVER *** [As 4h 3d 7c] [9d]
IuwLemwLhc9fvrwBGs0AMA: checks
Udr5juWSWUgTu1NlRhjMdA: checks
*** SHOW DOWN ***
IuwLemwLhc9fvrwBGs0AMA: shows [7d 6c] (a pair of Sevens)
Udr5juWSWUgTu1NlRhjMdA: mucks hand
IuwLemwLhc9fvrwBGs0AMA collected $1.95 from pot
*** SUMMARY ***
Total pot $2 | Rake $0.05
Board [As 4h 3d 7c 9d]
Seat 1: IuwLemwLhc9fvrwBGs0AMA (big blind) showed [7d 6c] and won ($1.95) with a pair of Sevens
Seat 2: Udr5juWSWUgTu1NlRhjMdA (button) (small blind) mucked



PokerStars Game #59937969118:  Hold'em No Limit ($0.25/$0.50) - 2009/07/01 0:04:01 ET
Table 'lSisgp6H7Fg1hH5VfjEjYQ' 9-max Seat #3 is the button
Seat 1: pEW8B6uXbdR47kfljMQ3+Q ($38.55 in chips)
Seat 2: UrcnkQOiLVk8BlKDPJSy7Q ($53.85 in chips)
Seat 3: RjBdQ6w31rgcy0o24VLR6w ($13.15 in chips)
Seat 4: nvw9yQKhJT56lA9k+TLdhw ($10.90 in chips)
Seat 5: mSD1pginDsyHG5PDfqzphw ($12.35 in chips)
Seat 6: +k7T5ocke8UwavtgUHm+Cg ($30 in chips)
Seat 7: xyQ4CeZa3ug3ompz+5xSTg ($74.70 in chips)
Seat 9: 5JJVDlaiMnB004o/RqbZZQ ($28.50 in chips)
nvw9yQKhJT56lA9k+TLdhw: posts small blind $0.25
mSD1pginDsyHG5PDfqzphw: posts big blind $0.50
bXpVeaSTPBFSPJmeXxO7nw: sits out
*** HOLE CARDS ***
+k7T5ocke8UwavtgUHm+Cg: folds
xyQ4CeZa3ug3ompz+5xSTg: folds
5JJVDlaiMnB004o/RqbZZQ: folds
pEW8B6uXbdR47kfljMQ3+Q: calls $0.50
UrcnkQOiLVk8BlKDPJSy7Q: folds
RjBdQ6w31rgcy0o24VLR6w: folds
nvw9yQKhJT56lA9k+TLdhw: calls $0.25
mSD1pginDsyHG5PDfqzphw: checks
*** FLOP *** [2s 4c Qc]
nvw9yQKhJT56lA9k+TLdhw: checks
mSD1pginDsyHG5PDfqzphw: checks
pEW8B6uXbdR47kfljMQ3+Q: checks
*** TURN *** [2s 4c Qc] [6s]
nvw9yQKhJT56lA9k+TLdhw: bets $0.50
mSD1pginDsyHG5PDfqzphw: calls $0.50
pEW8B6uXbdR47kfljMQ3+Q: raises $1 to $1.50
nvw9yQKhJT56lA9k+TLdhw: folds
mSD1pginDsyHG5PDfqzphw: folds
pEW8B6uXbdR47kfljMQ3+Q collected $2.90 from pot
pEW8B6uXbdR47kfljMQ3+Q: doesn't show hand
*** SUMMARY ***
Total pot $3 | Rake $0.10
Board [2s 4c Qc 6s]
Seat 1: pEW8B6uXbdR47kfljMQ3+Q collected ($2.90)
Seat 2: UrcnkQOiLVk8BlKDPJSy7Q folded before Flop (didn't bet)
Seat 3: RjBdQ6w31rgcy0o24VLR6w (button) folded before Flop (didn't bet)
Seat 4: nvw9yQKhJT56lA9k+TLdhw (small blind) folded on the Turn
Seat 5: mSD1pginDsyHG5PDfqzphw (big blind) folded on the Turn
Seat 6: +k7T5ocke8UwavtgUHm+Cg folded before Flop (didn't bet)
Seat 7: xyQ4CeZa3ug3ompz+5xSTg folded before Flop (didn't bet)
Seat 9: 5JJVDlaiMnB004o/RqbZZQ folded before Flop (didn't bet)



PokerStars Game #59937969954:  Hold'em No Limit ($0.25/$0.50) - 2009/07/01 0:04:02 ET
Table 'BCN5su+SsXiy1zRMJi0SJw' 6-max Seat #6 is the button
Seat 2: QfV2JJlmEKgD5jYPV+a33A ($159.65 in chips)
Seat 3: yrJsFKWv+ttHooqghxDx3A ($3.80 in chips)
Seat 4: 6Wb8PlO2kM4fnSim7p4Mrw ($11.25 in chips)
Seat 5: TTx3CHxyi0SObcHyMJRp5w ($39.35 in chips)
Seat 6: zHXshyreKwJVq3N3U+K9uQ ($51.30 in chips)
QfV2JJlmEKgD5jYPV+a33A: posts small blind $0.25
yrJsFKWv+ttHooqghxDx3A: posts big blind $0.50
*** HOLE CARDS ***
6Wb8PlO2kM4fnSim7p4Mrw: folds
TTx3CHxyi0SObcHyMJRp5w: folds
zHXshyreKwJVq3N3U+K9uQ: folds
QfV2JJlmEKgD5jYPV+a33A: folds
yrJsFKWv+ttHooqghxDx3A collected $0.50 from pot
*** SUMMARY ***
Total pot $0.50 | Rake $0
Seat 2: QfV2JJlmEKgD5jYPV+a33A (small blind) folded before Flop
Seat 3: yrJsFKWv+ttHooqghxDx3A (big blind) collected ($0.50)
Seat 4: 6Wb8PlO2kM4fnSim7p4Mrw folded before Flop (didn't bet)
Seat 5: TTx3CHxyi0SObcHyMJRp5w folded before Flop (didn't bet)
Seat 6: zHXshyreKwJVq3N3U+K9uQ (button) folded before Flop (didn't bet)



PokerStars Game #59937970138:  Hold'em No Limit ($0.25/$0.50) - 2009/07/01 0:04:02 ET
Table 'kgbJRsxfv64KrErDRBAkcw' 6-max Seat #5 is the button
Seat 1: YmWlPGOKFuJSoJZPW8a8IA ($82.55 in chips)
Seat 3: T0Gx/FcQ5VH9u7XaOMX97A ($62.40 in chips)
Seat 4: qanMEqjABjWxC/JgQ/0l7w ($54.30 in chips)
Seat 5: SlTdlH14u+KVVINgxMwt+Q ($74.70 in chips)
Seat 6: DDfYzIrYT0t5R/hAJngtsg ($25.15 in chips)
DDfYzIrYT0t5R/hAJngtsg: posts small blind $0.25
YmWlPGOKFuJSoJZPW8a8IA: posts big blind $0.50
Q+thC23WCv1kJUJtH/+4Jw: sits out
*** HOLE CARDS ***
T0Gx/FcQ5VH9u7XaOMX97A: folds
qanMEqjABjWxC/JgQ/0l7w: folds
SlTdlH14u+KVVINgxMwt+Q: folds
DDfYzIrYT0t5R/hAJngtsg: calls $0.25
YmWlPGOKFuJSoJZPW8a8IA: checks
*** FLOP *** [4s 8c Ts]
DDfYzIrYT0t5R/hAJngtsg: checks
YmWlPGOKFuJSoJZPW8a8IA: checks
*** TURN *** [4s 8c Ts] [7h]
DDfYzIrYT0t5R/hAJngtsg: checks
YmWlPGOKFuJSoJZPW8a8IA: checks
*** RIVER *** [4s 8c Ts 7h] [8h]
DDfYzIrYT0t5R/hAJngtsg: bets $0.50
YmWlPGOKFuJSoJZPW8a8IA: folds
DDfYzIrYT0t5R/hAJngtsg collected $0.95 from pot
DDfYzIrYT0t5R/hAJngtsg: doesn't show hand
*** SUMMARY ***
Total pot $1 | Rake $0.05
Board [4s 8c Ts 7h 8h]
Seat 1: YmWlPGOKFuJSoJZPW8a8IA (big blind) folded on the River
Seat 3: T0Gx/FcQ5VH9u7XaOMX97A folded before Flop (didn't bet)
Seat 4: qanMEqjABjWxC/JgQ/0l7w folded before Flop (didn't bet)
Seat 5: SlTdlH14u+KVVINgxMwt+Q (button) folded before Flop (didn't bet)
Seat 6: DDfYzIrYT0t5R/hAJngtsg (small blind) collected ($0.95)



PokerStars Game #59937973064:  Hold'em No Limit ($0.25/$0.50) - 2009/07/01 0:04:06 ET
Table 'E7bWJ45aoFXRpyRv2gw+Ig' 2-max Seat #1 is the button
Seat 1: FRkiRasEGlHUeLrEl+k/nA ($59.85 in chips)
Seat 2: 3Wro85I7472vJ4Wkpneo9A ($65.75 in chips)
FRkiRasEGlHUeLrEl+k/nA: posts small blind $0.25
3Wro85I7472vJ4Wkpneo9A: posts big blind $0.50
*** HOLE CARDS ***
FRkiRasEGlHUeLrEl+k/nA: raises $1.50 to $2
3Wro85I7472vJ4Wkpneo9A: folds
FRkiRasEGlHUeLrEl+k/nA collected $1 from pot
*** SUMMARY ***
Total pot $1 | Rake $0
Seat 1: FRkiRasEGlHUeLrEl+k/nA (button) (small blind) collected ($1)
Seat 2: 3Wro85I7472vJ4Wkpneo9A (big blind) folded before Flop



PokerStars Game #59937972862:  Hold'em No Limit ($0.25/$0.50) - 2009/07/01 0:04:06 ET
Table 'c/CRn+68J3Y8KxD5g1ek2Q' 2-max Seat #1 is the button
Seat 1: 46qCyJ6evTkHo9al5sBMNA ($329.70 in chips)
Seat 2: BypVLsYQt3ePFm2xQL/dOA ($58.35 in chips)
46qCyJ6evTkHo9al5sBMNA: posts small blind $0.25
BypVLsYQt3ePFm2xQL/dOA: posts big blind $0.50
*** HOLE CARDS ***
46qCyJ6evTkHo9al5sBMNA: folds
BypVLsYQt3ePFm2xQL/dOA collected $0.50 from pot
BypVLsYQt3ePFm2xQL/dOA: doesn't show hand
*** SUMMARY ***
Total pot $0.50 | Rake $0
Seat 1: 46qCyJ6evTkHo9al5sBMNA (button) (small blind) folded before Flop
Seat 2: BypVLsYQt3ePFm2xQL/dOA (big blind) collected ($0.50)



PokerStars Game #59937974386:  Hold'em No Limit ($0.25/$0.50) - 2009/07/01 0:04:08 ET
Table 'hSTs/dUsYLgJQuF2Onp0MQ' 6-max Seat #1 is the button
Seat 1: lWwl5C/UZOsWNubdUqghZw ($70.70 in chips)
Seat 3: vQOrJuXbLC3UZDVklY9bOA ($12.25 in chips)
Seat 4: L0aIPg7qefDQjdJo3HCVEA ($15.20 in chips)
Seat 5: 686aeHikcJlgKkSuIFdcXQ ($61.40 in chips)
Seat 6: +laPa9P7BjZKKnR0n+OmvA ($12 in chips)
vQOrJuXbLC3UZDVklY9bOA: posts small blind $0.25
L0aIPg7qefDQjdJo3HCVEA: posts big blind $0.50
*** HOLE CARDS ***
686aeHikcJlgKkSuIFdcXQ: folds
+laPa9P7BjZKKnR0n+OmvA: folds
lWwl5C/UZOsWNubdUqghZw: raises $1.25 to $1.75
vQOrJuXbLC3UZDVklY9bOA: folds
L0aIPg7qefDQjdJo3HCVEA: folds
lWwl5C/UZOsWNubdUqghZw collected $1.25 from pot
*** SUMMARY ***
Total pot $1.25 | Rake $0
Seat 1: lWwl5C/UZOsWNubdUqghZw (button) collected ($1.25)
Seat 3: vQOrJuXbLC3UZDVklY9bOA (small blind) folded before Flop
Seat 4: L0aIPg7qefDQjdJo3HCVEA (big blind) folded before Flop
Seat 5: 686aeHikcJlgKkSuIFdcXQ folded before Flop (didn't bet)
Seat 6: +laPa9P7BjZKKnR0n+OmvA folded before Flop (didn't bet)



PokerStars Game #59937977184:  Hold'em No Limit ($0.25/$0.50) - 2009/07/01 0:04:12 ET
Table 'c/CRn+68J3Y8KxD5g1ek2Q' 2-max Seat #2 is the button
Seat 1: 46qCyJ6evTkHo9al5sBMNA ($329.45 in chips)
Seat 2: BypVLsYQt3ePFm2xQL/dOA ($58.60 in chips)
BypVLsYQt3ePFm2xQL/dOA: posts small blind $0.25
46qCyJ6evTkHo9al5sBMNA: posts big blind $0.50
*** HOLE CARDS ***
BypVLsYQt3ePFm2xQL/dOA: raises $1 to $1.50
46qCyJ6evTkHo9al5sBMNA: folds
BypVLsYQt3ePFm2xQL/dOA collected $1 from pot
BypVLsYQt3ePFm2xQL/dOA: doesn't show hand
*** SUMMARY ***
Total pot $1 | Rake $0
Seat 1: 46qCyJ6evTkHo9al5sBMNA (big blind) folded before Flop
Seat 2: BypVLsYQt3ePFm2xQL/dOA (button) (small blind) collected ($1)



PokerStars Game #59937977892:  Hold'em No Limit ($0.25/$0.50) - 2009/07/01 0:04:13 ET
Table '+dXkOAQyS8j9PQZusUTMpg' 2-max Seat #2 is the button
Seat 1: XFa6sBGjP2gxoIvxR3fZIg ($95.60 in chips)
Seat 2: 5IBeOgaApY1Bvzv2P8X4EA ($21.15 in chips)
5IBeOgaApY1Bvzv2P8X4EA: posts small blind $0.25
XFa6sBGjP2gxoIvxR3fZIg: posts big blind $0.50
*** HOLE CARDS ***
5IBeOgaApY1Bvzv2P8X4EA: folds
XFa6sBGjP2gxoIvxR3fZIg collected $0.50 from pot
*** SUMMARY ***
Total pot $0.50 | Rake $0
Seat 1: XFa6sBGjP2gxoIvxR3fZIg (big blind) collected ($0.50)
Seat 2: 5IBeOgaApY1Bvzv2P8X4EA (button) (small blind) folded before Flop



PokerStars Game #59937978146:  Hold'em No Limit ($0.25/$0.50) - 2009/07/01 0:04:14 ET
Table 'Vdlc9wqYcHTUhtdyN7CuJw' 2-max Seat #2 is the button
Seat 1: yBO+mXB6m/rCft2ErwGf/Q ($63.40 in chips)
Seat 2: sa0qgETiL3HNbdfGlnKHTA ($51.20 in chips)
sa0qgETiL3HNbdfGlnKHTA: posts small blind $0.25
yBO+mXB6m/rCft2ErwGf/Q: posts big blind $0.50
*** HOLE CARDS ***
sa0qgETiL3HNbdfGlnKHTA: folds
yBO+mXB6m/rCft2ErwGf/Q collected $0.50 from pot
*** SUMMARY ***
Total pot $0.50 | Rake $0
Seat 1: yBO+mXB6m/rCft2ErwGf/Q (big blind) collected ($0.50)
Seat 2: sa0qgETiL3HNbdfGlnKHTA (button) (small blind) folded before Flop



PokerStars Game #59937978710:  Hold'em No Limit ($0.25/$0.50) - 2009/07/01 0:04:14 ET
Table 'BCN5su+SsXiy1zRMJi0SJw' 6-max Seat #2 is the button
Seat 2: QfV2JJlmEKgD5jYPV+a33A ($159.40 in chips)
Seat 3: yrJsFKWv+ttHooqghxDx3A ($4.05 in chips)
Seat 4: 6Wb8PlO2kM4fnSim7p4Mrw ($11.25 in chips)
Seat 5: TTx3CHxyi0SObcHyMJRp5w ($39.35 in chips)
Seat 6: zHXshyreKwJVq3N3U+K9uQ ($51.30 in chips)
yrJsFKWv+ttHooqghxDx3A: posts small blind $0.25
6Wb8PlO2kM4fnSim7p4Mrw: posts big blind $0.50
*** HOLE CARDS ***
TTx3CHxyi0SObcHyMJRp5w: folds
zHXshyreKwJVq3N3U+K9uQ: folds
QfV2JJlmEKgD5jYPV+a33A: folds
yrJsFKWv+ttHooqghxDx3A: calls $0.25
WyeokAqR0q9nADSkWpbxHw joins the table at seat #1
6Wb8PlO2kM4fnSim7p4Mrw: checks
*** FLOP *** [8s 8d 3c]
yrJsFKWv+ttHooqghxDx3A: checks
6Wb8PlO2kM4fnSim7p4Mrw: bets $0.50
yrJsFKWv+ttHooqghxDx3A: calls $0.50
*** TURN *** [8s 8d 3c] [7s]
yrJsFKWv+ttHooqghxDx3A: checks
6Wb8PlO2kM4fnSim7p4Mrw: bets $0.50
yrJsFKWv+ttHooqghxDx3A: calls $0.50
*** RIVER *** [8s 8d 3c 7s] [6c]
yrJsFKWv+ttHooqghxDx3A: checks
6Wb8PlO2kM4fnSim7p4Mrw: bets $2
yrJsFKWv+ttHooqghxDx3A: raises $0.55 to $2.55 and is all-in
6Wb8PlO2kM4fnSim7p4Mrw: calls $0.55
*** SHOW DOWN ***
yrJsFKWv+ttHooqghxDx3A: shows [5d 8h] (three of a kind, Eights)
6Wb8PlO2kM4fnSim7p4Mrw: shows [Ts 9d] (a straight, Six to Ten)
6Wb8PlO2kM4fnSim7p4Mrw collected $7.70 from pot
*** SUMMARY ***
Total pot $8.10 | Rake $0.40
Board [8s 8d 3c 7s 6c]
Seat 2: QfV2JJlmEKgD5jYPV+a33A (button) folded before Flop (didn't bet)
Seat 3: yrJsFKWv+ttHooqghxDx3A (small blind) showed [5d 8h] and lost with three of a kind, Eights
Seat 4: 6Wb8PlO2kM4fnSim7p4Mrw (big blind) showed [Ts 9d] and won ($7.70) with a straight, Six to Ten
Seat 5: TTx3CHxyi0SObcHyMJRp5w folded before Flop (didn't bet)
Seat 6: zHXshyreKwJVq3N3U+K9uQ folded before Flop (didn't bet)



PokerStars Game #59937980146:  Hold'em No Limit ($0.25/$0.50) - 2009/07/01 0:04:16 ET
Table 'E7bWJ45aoFXRpyRv2gw+Ig' 2-max Seat #2 is the button
Seat 1: FRkiRasEGlHUeLrEl+k/nA ($60.35 in chips)
Seat 2: 3Wro85I7472vJ4Wkpneo9A ($65.25 in chips)
3Wro85I7472vJ4Wkpneo9A: posts small blind $0.25
FRkiRasEGlHUeLrEl+k/nA: posts big blind $0.50
*** HOLE CARDS ***
3Wro85I7472vJ4Wkpneo9A: folds
FRkiRasEGlHUeLrEl+k/nA collected $0.50 from pot
FRkiRasEGlHUeLrEl+k/nA: doesn't show hand
*** SUMMARY ***
Total pot $0.50 | Rake $0
Seat 1: FRkiRasEGlHUeLrEl+k/nA (big blind) collected ($0.50)
Seat 2: 3Wro85I7472vJ4Wkpneo9A (button) (small blind) folded before Flop



PokerStars Game #59937980878:  Hold'em No Limit ($0.25/$0.50) - 2009/07/01 0:04:17 ET
Table 'QOgaEqMcJ73pcUMMxoisUgErOuyGLI5PT3G5MnpHgC/g Seat #8 is the button
Seat 1: k6GJzKs7T7qvQggW9g8Pdw ($48.75 in chips)
Seat 2: RjBdQ6w31rgcy0o24VLR6w ($8.75 in chips)
Seat 3: xZCXQSXlrZkp3pZizzVXCw ($49 in chips)
Seat 4: U7aZzIYWjv3SL30KtikLbw ($49.45 in chips)
Seat 5: JwvquocWfhTVApN5t47LgA ($51.05 in chips)
Seat 6: zE9cVigS2nW/Ljy4K4bUQA ($31.35 in chips)
Seat 7: 90Wb75h3W1BRpbqVnuk8gw ($62.55 in chips)
Seat 8: ajP1NjIMdqQfpMbzHzvejw ($41.30 in chips)
Seat 9: J0W5D97jl5VLky+IoPvDeA ($68.05 in chips)
J0W5D97jl5VLky+IoPvDeA: posts small blind $0.25
k6GJzKs7T7qvQggW9g8Pdw: posts big blind $0.50
*** HOLE CARDS ***
RjBdQ6w31rgcy0o24VLR6w: raises $1.50 to $2
xZCXQSXlrZkp3pZizzVXCw: folds
U7aZzIYWjv3SL30KtikLbw: folds
JwvquocWfhTVApN5t47LgA: folds
zE9cVigS2nW/Ljy4K4bUQA: folds
90Wb75h3W1BRpbqVnuk8gw: folds
ajP1NjIMdqQfpMbzHzvejw: folds
J0W5D97jl5VLky+IoPvDeA: folds
k6GJzKs7T7qvQggW9g8Pdw: folds
RjBdQ6w31rgcy0o24VLR6w collected $1.25 from pot
*** SUMMARY ***
Total pot $1.25 | Rake $0
Seat 1: k6GJzKs7T7qvQggW9g8Pdw (big blind) folded before Flop
Seat 2: RjBdQ6w31rgcy0o24VLR6w collected ($1.25)
Seat 3: xZCXQSXlrZkp3pZizzVXCw folded before Flop (didn't bet)
Seat 4: U7aZzIYWjv3SL30KtikLbw folded before Flop (didn't bet)
Seat 5: JwvquocWfhTVApN5t47LgA folded before Flop (didn't bet)
Seat 6: zE9cVigS2nW/Ljy4K4bUQA folded before Flop (didn't bet)
Seat 7: 90Wb75h3W1BRpbqVnuk8gw folded before Flop (didn't bet)
Seat 8: ajP1NjIMdqQfpMbzHzvejw (button) folded before Flop (didn't bet)
Seat 9: J0W5D97jl5VLky+IoPvDeA (small blind) folded before Flop



PokerStars Game #59937981814:  Hold'em No Limit ($0.25/$0.50) - 2009/07/01 0:04:19 ET
Table 'QOgaEqMcJ73pcUMMxoisUg' 6-max Seat #6 is the button
Seat 1: RFefXIDyFvNtJLq+CloCzA ($41.95 in chips)
Seat 3: wUZNozoIDYf+16hp4nn6dw ($18.15 in chips)
Seat 4: L5e2lrPLQm1Pqx30IIZ/Fw ($9.25 in chips)
Seat 5: HoaSQCRso+nEyO5DUhGduw ($77.75 in chips)
Seat 6: s83dnhZ6VC53vY0/f6OV/g ($41.10 in chips)
RFefXIDyFvNtJLq+CloCzA: posts small blind $0.25
wUZNozoIDYf+16hp4nn6dw: posts big blind $0.50
*** HOLE CARDS ***
L5e2lrPLQm1Pqx30IIZ/Fw: folds
HoaSQCRso+nEyO5DUhGduw: calls $0.50
s83dnhZ6VC53vY0/f6OV/g: raises $2 to $2.50
RFefXIDyFvNtJLq+CloCzA: folds
RFefXIDyFvNtJLq+CloCzA is disconnected
wUZNozoIDYf+16hp4nn6dw: folds
HoaSQCRso+nEyO5DUhGduw: folds
s83dnhZ6VC53vY0/f6OV/g collected $1.75 from pot
s83dnhZ6VC53vY0/f6OV/g: doesn't show hand
RFefXIDyFvNtJLq+CloCzA is connected
*** SUMMARY ***
Total pot $1.75 | Rake $0
Seat 1: RFefXIDyFvNtJLq+CloCzA (small blind) folded before Flop
Seat 3: wUZNozoIDYf+16hp4nn6dw (big blind) folded before Flop
Seat 4: L5e2lrPLQm1Pqx30IIZ/Fw folded before Flop (didn't bet)
Seat 5: HoaSQCRso+nEyO5DUhGduw folded before Flop
Seat 6: s83dnhZ6VC53vY0/f6OV/g (button) collected ($1.75)



PokerStars Game #59937982950:  Hold'em No Limit ($0.25/$0.50) - 2009/07/01 0:04:20 ET
Table 'c/CRn+68J3Y8KxD5g1ek2Q' 2-max Seat #1 is the button
Seat 1: 46qCyJ6evTkHo9al5sBMNA ($328.95 in chips)
Seat 2: BypVLsYQt3ePFm2xQL/dOA ($59.10 in chips)
46qCyJ6evTkHo9al5sBMNA: posts small blind $0.25
BypVLsYQt3ePFm2xQL/dOA: posts big blind $0.50
*** HOLE CARDS ***
46qCyJ6evTkHo9al5sBMNA: raises $1 to $1.50
BypVLsYQt3ePFm2xQL/dOA: raises $7 to $8.50
46qCyJ6evTkHo9al5sBMNA: folds
BypVLsYQt3ePFm2xQL/dOA collected $3 from pot
*** SUMMARY ***
Total pot $3 | Rake $0
Seat 1: 46qCyJ6evTkHo9al5sBMNA (button) (small blind) folded before Flop
Seat 2: BypVLsYQt3ePFm2xQL/dOA (big blind) collected ($3)



PokerStars Game #59937982742:  Hold'em No Limit ($0.25/$0.50) - 2009/07/01 0:04:20 ET
Table '+dXkOAQyS8j9PQZusUTMpg' 2-max Seat #1 is the button
Seat 1: XFa6sBGjP2gxoIvxR3fZIg ($95.85 in chips)
Seat 2: 5IBeOgaApY1Bvzv2P8X4EA ($20.90 in chips)
XFa6sBGjP2gxoIvxR3fZIg: posts small blind $0.25
5IBeOgaApY1Bvzv2P8X4EA: posts big blind $0.50
*** HOLE CARDS ***
XFa6sBGjP2gxoIvxR3fZIg: raises $1 to $1.50
5IBeOgaApY1Bvzv2P8X4EA: calls $1
*** FLOP *** [Td Ah 3h]
5IBeOgaApY1Bvzv2P8X4EA: checks
XFa6sBGjP2gxoIvxR3fZIg: checks
*** TURN *** [Td Ah 3h] [Qs]
5IBeOgaApY1Bvzv2P8X4EA: bets $1
XFa6sBGjP2gxoIvxR3fZIg: folds
5IBeOgaApY1Bvzv2P8X4EA collected $2.85 from pot
5IBeOgaApY1Bvzv2P8X4EA: doesn't show hand
*** SUMMARY ***
Total pot $3 | Rake $0.15
Board [Td Ah 3h Qs]
Seat 1: XFa6sBGjP2gxoIvxR3fZIg (button) (small blind) folded on the Turn
Seat 2: 5IBeOgaApY1Bvzv2P8X4EA (big blind) collected ($2.85)



PokerStars Game #59937983260:  Hold'em No Limit ($0.25/$0.50) - 2009/07/01 0:04:21 ET
Table 'SsXEKOwKN+jE3etfusqUqA' 2-max Seat #2 is the button
Seat 1: 618rKeLrz/avGNOLULHHVQ ($50 in chips)
Seat 2: XfRhywXA6Br+jID1oGeo8A ($194.95 in chips)
XfRhywXA6Br+jID1oGeo8A: posts small blind $0.25
618rKeLrz/avGNOLULHHVQ: posts big blind $0.50
*** HOLE CARDS ***
XfRhywXA6Br+jID1oGeo8A: raises $1 to $1.50
618rKeLrz/avGNOLULHHVQ said, "ffs. nice hand"
618rKeLrz/avGNOLULHHVQ: raises $3 to $4.50
XfRhywXA6Br+jID1oGeo8A: calls $3
*** FLOP *** [9d Ts 8c]
618rKeLrz/avGNOLULHHVQ: bets $3
XfRhywXA6Br+jID1oGeo8A: raises $33.50 to $36.50
618rKeLrz/avGNOLULHHVQ: folds
XfRhywXA6Br+jID1oGeo8A collected $14.50 from pot
XfRhywXA6Br+jID1oGeo8A: doesn't show hand
*** SUMMARY ***
Total pot $15 | Rake $0.50
Board [9d Ts 8c]
Seat 1: 618rKeLrz/avGNOLULHHVQ (big blind) folded on the Flop
Seat 2: XfRhywXA6Br+jID1oGeo8A (button) (small blind) collected ($14.50)



PokerStars Game #59937984738:  Hold'em No Limit ($0.25/$0.50) - 2009/07/01 0:04:23 ET
Table 'E7bWJ45aoFXRpyRv2gw+Ig' 2-max Seat #1 is the button
Seat 1: FRkiRasEGlHUeLrEl+k/nA ($60.60 in chips)
Seat 2: 3Wro85I7472vJ4Wkpneo9A ($65 in chips)
FRkiRasEGlHUeLrEl+k/nA: posts small blind $0.25
3Wro85I7472vJ4Wkpneo9A: posts big blind $0.50
*** HOLE CARDS ***
FRkiRasEGlHUeLrEl+k/nA: folds
3Wro85I7472vJ4Wkpneo9A collected $0.50 from pot
3Wro85I7472vJ4Wkpneo9A: doesn't show hand
*** SUMMARY ***
Total pot $0.50 | Rake $0
Seat 1: FRkiRasEGlHUeLrEl+k/nA (button) (small blind) folded before Flop
Seat 2: 3Wro85I7472vJ4Wkpneo9A (big blind) collected ($0.50)



PokerStars Game #59937985354:  Hold'em No Limit ($0.25/$0.50) - 2009/07/01 0:04:24 ET
Table 'Vdlc9wqYcHTUhtdyN7CuJw' 2-max Seat #1 is the button
Seat 1: yBO+mXB6m/rCft2ErwGf/Q ($63.65 in chips)
Seat 2: sa0qgETiL3HNbdfGlnKHTA ($50.95 in chips)
yBO+mXB6m/rCft2ErwGf/Q: posts small blind $0.25
sa0qgETiL3HNbdfGlnKHTA: posts big blind $0.50
*** HOLE CARDS ***
yBO+mXB6m/rCft2ErwGf/Q: raises $1.50 to $2
sa0qgETiL3HNbdfGlnKHTA: folds
yBO+mXB6m/rCft2ErwGf/Q collected $1 from pot
*** SUMMARY ***
Total pot $1 | Rake $0
Seat 1: yBO+mXB6m/rCft2ErwGf/Q (button) (small blind) collected ($1)
Seat 2: sa0qgETiL3HNbdfGlnKHTA (big blind) folded before Flop



PokerStars Game #59937987732:  Hold'em No Limit ($0.25/$0.50) - 2009/07/01 0:04:27 ET
Table 'ibNfFy0bCzuBaUORla0aGw' 9-max Seat #6 is the button
Seat 1: xZCXQSXlrZkp3pZizzVXCw ($56.95 in chips)
Seat 2: 90Wb75h3W1BRpbqVnuk8gw ($50 in chips)
Seat 3: dDaHs3X8+fe3bIkRU0cbrw ($26.55 in chips)
Seat 4: YBN054X4blmis+B2bBlC0g ($22.20 in chips)
Seat 5: FRv75HO8CUsRZ1byEz06mQ ($15.35 in chips)
Seat 6: BmYrv3ec2k5d6pQq6iNaZw ($66.25 in chips)
Seat 7: mSD1pginDsyHG5PDfqzphw ($10 in chips)
Seat 8: xUrN9TWLq4m5V+OXY7KUUA ($50.50 in chips)
Seat 9: WpvT3OUSiZlpvs+mPXFqtQ ($8.75 in chips)
mSD1pginDsyHG5PDfqzphw: posts small blind $0.25
xUrN9TWLq4m5V+OXY7KUUA: posts big blind $0.50
*** HOLE CARDS ***
WpvT3OUSiZlpvs+mPXFqtQ: raises $1.50 to $2
xZCXQSXlrZkp3pZizzVXCw: folds
90Wb75h3W1BRpbqVnuk8gw: folds
dDaHs3X8+fe3bIkRU0cbrw: folds
YBN054X4blmis+B2bBlC0g: folds
FRv75HO8CUsRZ1byEz06mQ: folds
BmYrv3ec2k5d6pQq6iNaZw: folds
mSD1pginDsyHG5PDfqzphw: folds
xUrN9TWLq4m5V+OXY7KUUA: folds
WpvT3OUSiZlpvs+mPXFqtQ collected $1.25 from pot
*** SUMMARY ***
Total pot $1.25 | Rake $0
Seat 1: xZCXQSXlrZkp3pZizzVXCw folded before Flop (didn't bet)
Seat 2: 90Wb75h3W1BRpbqVnuk8gw folded before Flop (didn't bet)
Seat 3: dDaHs3X8+fe3bIkRU0cbrw folded before Flop (didn't bet)
Seat 4: YBN054X4blmis+B2bBlC0g folded before Flop (didn't bet)
Seat 5: FRv75HO8CUsRZ1byEz06mQ folded before Flop (didn't bet)
Seat 6: BmYrv3ec2k5d6pQq6iNaZw (button) folded before Flop (didn't bet)
Seat 7: mSD1pginDsyHG5PDfqzphw (small blind) folded before Flop
Seat 8: xUrN9TWLq4m5V+OXY7KUUA (big blind) folded before Flop
Seat 9: WpvT3OUSiZlpvs+mPXFqtQ collected ($1.25)



PokerStars Game #59937988462:  Hold'em No Limit ($0.25/$0.50) - 2009/07/01 0:04:28 ET
Table 'GfL/No5u5PoEnU39lP5pQg' 6-max Seat #2 is the button
Seat 1: T0Gx/FcQ5VH9u7XaOMX97A ($53.40 in chips)
Seat 2: uVwggSetzp7d+eVgowO3vg ($18.80 in chips)
Seat 3: YmWlPGOKFuJSoJZPW8a8IA ($98.95 in chips)
Seat 4: yqM0AD7MZQd/cEtKdDQY1A ($34.65 in chips)
Seat 6: 5EiAo0XuFchfJkhvFPvoog ($62.20 in chips)
YmWlPGOKFuJSoJZPW8a8IA: posts small blind $0.25
yqM0AD7MZQd/cEtKdDQY1A: posts big blind $0.50
*** HOLE CARDS ***
5EiAo0XuFchfJkhvFPvoog: folds
T0Gx/FcQ5VH9u7XaOMX97A: folds
uVwggSetzp7d+eVgowO3vg: calls $0.50
YmWlPGOKFuJSoJZPW8a8IA: folds
yqM0AD7MZQd/cEtKdDQY1A: checks
*** FLOP *** [9d 7d 8d]
yqM0AD7MZQd/cEtKdDQY1A: checks
uVwggSetzp7d+eVgowO3vg: checks
*** TURN *** [9d 7d 8d] [7h]
yqM0AD7MZQd/cEtKdDQY1A: checks
uVwggSetzp7d+eVgowO3vg: bets $1.50
yqM0AD7MZQd/cEtKdDQY1A: folds
uVwggSetzp7d+eVgowO3vg collected $1.20 from pot
*** SUMMARY ***
Total pot $1.25 | Rake $0.05
Board [9d 7d 8d 7h]
Seat 1: T0Gx/FcQ5VH9u7XaOMX97A folded before Flop (didn't bet)
Seat 2: uVwggSetzp7d+eVgowO3vg (button) collected ($1.20)
Seat 3: YmWlPGOKFuJSoJZPW8a8IA (small blind) folded before Flop
Seat 4: yqM0AD7MZQd/cEtKdDQY1A (big blind) folded on the Turn
Seat 6: 5EiAo0XuFchfJkhvFPvoog folded before Flop (didn't bet)



PokerStars Game #59937988816:  Hold'em No Limit ($0.25/$0.50) - 2009/07/01 0:04:28 ET
Table 'E7bWJ45aoFXRpyRv2gw+Ig' 2-max Seat #2 is the button
Seat 1: FRkiRasEGlHUeLrEl+k/nA ($60.35 in chips)
Seat 2: 3Wro85I7472vJ4Wkpneo9A ($65.25 in chips)
3Wro85I7472vJ4Wkpneo9A: posts small blind $0.25
FRkiRasEGlHUeLrEl+k/nA: posts big blind $0.50
*** HOLE CARDS ***
3Wro85I7472vJ4Wkpneo9A: calls $0.25
FRkiRasEGlHUeLrEl+k/nA: checks
*** FLOP *** [Jd 5h 3s]
FRkiRasEGlHUeLrEl+k/nA: checks
3Wro85I7472vJ4Wkpneo9A: bets $1
FRkiRasEGlHUeLrEl+k/nA: calls $1
*** TURN *** [Jd 5h 3s] [Ks]
FRkiRasEGlHUeLrEl+k/nA: checks
3Wro85I7472vJ4Wkpneo9A: bets $2
FRkiRasEGlHUeLrEl+k/nA: raises $3.50 to $5.50
3Wro85I7472vJ4Wkpneo9A: calls $3.50
*** RIVER *** [Jd 5h 3s Ks] [Ts]
FRkiRasEGlHUeLrEl+k/nA: bets $8.50
3Wro85I7472vJ4Wkpneo9A: folds
FRkiRasEGlHUeLrEl+k/nA collected $13.50 from pot
FRkiRasEGlHUeLrEl+k/nA: doesn't show hand
*** SUMMARY ***
Total pot $14 | Rake $0.50
Board [Jd 5h 3s Ks Ts]
Seat 1: FRkiRasEGlHUeLrEl+k/nA (big blind) collected ($13.50)
Seat 2: 3Wro85I7472vJ4Wkpneo9A (button) (small blind) folded on the River



PokerStars Game #59937989998:  Hold'em No Limit ($0.25/$0.50) - 2009/07/01 0:04:30 ET
Table 'raOT4/ipuZgzjfKHC+jD9g' 2-max Seat #1 is the button
Seat 1: IuwLemwLhc9fvrwBGs0AMA ($11.25 in chips)
Seat 2: Udr5juWSWUgTu1NlRhjMdA ($12.80 in chips)
IuwLemwLhc9fvrwBGs0AMA: posts small blind $0.25
Udr5juWSWUgTu1NlRhjMdA: posts big blind $0.50
*** HOLE CARDS ***
IuwLemwLhc9fvrwBGs0AMA: calls $0.25
Udr5juWSWUgTu1NlRhjMdA: checks
*** FLOP *** [3s 3h 2c]
Udr5juWSWUgTu1NlRhjMdA: checks
IuwLemwLhc9fvrwBGs0AMA: checks
*** TURN *** [3s 3h 2c] [As]
Udr5juWSWUgTu1NlRhjMdA: checks
IuwLemwLhc9fvrwBGs0AMA: bets $0.50
Udr5juWSWUgTu1NlRhjMdA: calls $0.50
*** RIVER *** [3s 3h 2c As] [2s]
Udr5juWSWUgTu1NlRhjMdA: checks
IuwLemwLhc9fvrwBGs0AMA: bets $1.50
Udr5juWSWUgTu1NlRhjMdA: folds
IuwLemwLhc9fvrwBGs0AMA collected $1.95 from pot
*** SUMMARY ***
Total pot $2 | Rake $0.05
Board [3s 3h 2c As 2s]
Seat 1: IuwLemwLhc9fvrwBGs0AMA (button) (small blind) collected ($1.95)
Seat 2: Udr5juWSWUgTu1NlRhjMdA (big blind) folded on the River



PokerStars Game #59937990100:  Hold'em No Limit ($0.25/$0.50) - 2009/07/01 0:04:30 ET
Table '37qXEp3oe+er5q4CZip9eQ' 6-max Seat #5 is the button
Seat 1: 4qceN3NM3S463h+TT4UvGQ ($12.80 in chips)
Seat 2: g12O9qXTybyo2C0B2bXgjg ($24.20 in chips)
Seat 3: Rt6KgtZ8YaJoTc3FPim00w ($109.10 in chips)
Seat 4: L0aIPg7qefDQjdJo3HCVEA ($10.30 in chips)
Seat 5: VOmI0x4dDPnTESZd5B4d1Q ($30.75 in chips)
Seat 6: f7zPpUQp9hHZgqhEvrUWQw ($56.15 in chips)
f7zPpUQp9hHZgqhEvrUWQw: posts small blind $0.25
4qceN3NM3S463h+TT4UvGQ: posts big blind $0.50
*** HOLE CARDS ***
g12O9qXTybyo2C0B2bXgjg: folds
Rt6KgtZ8YaJoTc3FPim00w: folds
L0aIPg7qefDQjdJo3HCVEA: folds
VOmI0x4dDPnTESZd5B4d1Q: folds
f7zPpUQp9hHZgqhEvrUWQw: folds
4qceN3NM3S463h+TT4UvGQ collected $0.50 from pot
*** SUMMARY ***
Total pot $0.50 | Rake $0
Seat 1: 4qceN3NM3S463h+TT4UvGQ (big blind) collected ($0.50)
Seat 2: g12O9qXTybyo2C0B2bXgjg folded before Flop (didn't bet)
Seat 3: Rt6KgtZ8YaJoTc3FPim00w folded before Flop (didn't bet)
Seat 4: L0aIPg7qefDQjdJo3HCVEA folded before Flop (didn't bet)
Seat 5: VOmI0x4dDPnTESZd5B4d1Q (button) folded before Flop (didn't bet)
Seat 6: f7zPpUQp9hHZgqhEvrUWQw (small blind) folded before Flop



PokerStars Game #59937989858:  Hold'em No Limit ($0.25/$0.50) - 2009/07/01 0:04:30 ET
Table 'YsnnHkamRzYqMOr2FlLY4w' 6-max Seat #2 is the button
Seat 1: crjGpJEzSZgD38FoE3VMGg ($54.30 in chips)
Seat 2: 2dIa62hMcn6g73rbkt9NwA ($62.35 in chips)
Seat 3: I+pG2m/dD5iYdbg9qx572g ($25.25 in chips)
Seat 4: 7Fue572p4ZIC85AJMQvaQw ($45.80 in chips)
Seat 5: lcQ7uuLf+WLGGy4Ve6VKKA ($47.50 in chips)
Seat 6: YmWlPGOKFuJSoJZPW8a8IA ($50 in chips)
I+pG2m/dD5iYdbg9qx572g: posts small blind $0.25
7Fue572p4ZIC85AJMQvaQw: posts big blind $0.50
*** HOLE CARDS ***
lcQ7uuLf+WLGGy4Ve6VKKA: raises $0.50 to $1
YmWlPGOKFuJSoJZPW8a8IA: folds
crjGpJEzSZgD38FoE3VMGg: raises $3.50 to $4.50
2dIa62hMcn6g73rbkt9NwA: folds
I+pG2m/dD5iYdbg9qx572g: folds
7Fue572p4ZIC85AJMQvaQw: calls $4
lcQ7uuLf+WLGGy4Ve6VKKA: folds
*** FLOP *** [3h 5h 2h]
7Fue572p4ZIC85AJMQvaQw: checks
crjGpJEzSZgD38FoE3VMGg: checks
*** TURN *** [3h 5h 2h] [7h]
7Fue572p4ZIC85AJMQvaQw: checks
crjGpJEzSZgD38FoE3VMGg: checks
*** RIVER *** [3h 5h 2h 7h] [As]
7Fue572p4ZIC85AJMQvaQw: bets $1.50
crjGpJEzSZgD38FoE3VMGg: calls $1.50
*** SHOW DOWN ***
7Fue572p4ZIC85AJMQvaQw: shows [5c 5d] (three of a kind, Fives)
crjGpJEzSZgD38FoE3VMGg: mucks hand
7Fue572p4ZIC85AJMQvaQw collected $12.65 from pot
*** SUMMARY ***
Total pot $13.25 | Rake $0.60
Board [3h 5h 2h 7h As]
Seat 1: crjGpJEzSZgD38FoE3VMGg mucked
Seat 2: 2dIa62hMcn6g73rbkt9NwA (button) folded before Flop (didn't bet)
Seat 3: I+pG2m/dD5iYdbg9qx572g (small blind) folded before Flop
Seat 4: 7Fue572p4ZIC85AJMQvaQw (big blind) showed [5c 5d] and won ($12.65) with three of a kind, Fives
Seat 5: lcQ7uuLf+WLGGy4Ve6VKKA folded before Flop
Seat 6: YmWlPGOKFuJSoJZPW8a8IA folded before Flop (didn't bet)



PokerStars Game #59937991200:  Hold'em No Limit ($0.25/$0.50) - 2009/07/01 0:04:32 ET
Table 'tyR5AZNKV8Aadbrnrnlg7g' 6-max Seat #3 is the button
Seat 1: R+KjpH/wSjDLhtIy9+edNA ($37.35 in chips)
Seat 2: 58zdeSBSuSFX/qZfhc7YmA ($33.50 in chips)
Seat 3: jUhx+m+V7qfbLZTjgwZByg ($45.25 in chips)
Seat 4: Rt6KgtZ8YaJoTc3FPim00w ($50 in chips)
Seat 5: EIg3r3fRFKG2HhgpDlIJHg ($12.05 in chips)
Seat 6: DMQLAmut/l19xN5STQndFg ($18.40 in chips)
Rt6KgtZ8YaJoTc3FPim00w: posts small blind $0.25
EIg3r3fRFKG2HhgpDlIJHg: posts big blind $0.50
*** HOLE CARDS ***
DMQLAmut/l19xN5STQndFg: raises $1 to $1.50
R+KjpH/wSjDLhtIy9+edNA: folds
58zdeSBSuSFX/qZfhc7YmA: calls $1.50
jUhx+m+V7qfbLZTjgwZByg: folds
Rt6KgtZ8YaJoTc3FPim00w: folds
EIg3r3fRFKG2HhgpDlIJHg: calls $1
*** FLOP *** [Js 7c 4c]
EIg3r3fRFKG2HhgpDlIJHg: checks
DMQLAmut/l19xN5STQndFg: bets $3
58zdeSBSuSFX/qZfhc7YmA: folds
EIg3r3fRFKG2HhgpDlIJHg: folds
DMQLAmut/l19xN5STQndFg collected $4.55 from pot
DMQLAmut/l19xN5STQndFg: doesn't show hand
*** SUMMARY ***
Total pot $4.75 | Rake $0.20
Board [Js 7c 4c]
Seat 1: R+KjpH/wSjDLhtIy9+edNA folded before Flop (didn't bet)
Seat 2: 58zdeSBSuSFX/qZfhc7YmA folded on the Flop
Seat 3: jUhx+m+V7qfbLZTjgwZByg (button) folded before Flop (didn't bet)
Seat 4: Rt6KgtZ8YaJoTc3FPim00w (small blind) folded before Flop
Seat 5: EIg3r3fRFKG2HhgpDlIJHg (big blind) folded on the Flop
Seat 6: DMQLAmut/l19xN5STQndFg collected ($4.55)



PokerStars Game #59937991658:  Hold'em No Limit ($0.25/$0.50) - 2009/07/01 0:04:32 ET
Table 'Vdlc9wqYcHTUhtdyN7CuJw' 2-max Seat #2 is the button
Seat 1: yBO+mXB6m/rCft2ErwGf/Q ($64.15 in chips)
Seat 2: sa0qgETiL3HNbdfGlnKHTA ($50.45 in chips)
sa0qgETiL3HNbdfGlnKHTA: posts small blind $0.25
yBO+mXB6m/rCft2ErwGf/Q: posts big blind $0.50
*** HOLE CARDS ***
sa0qgETiL3HNbdfGlnKHTA: raises $0.50 to $1
yBO+mXB6m/rCft2ErwGf/Q: calls $0.50
*** FLOP *** [7c Kd Ac]
yBO+mXB6m/rCft2ErwGf/Q: checks
sa0qgETiL3HNbdfGlnKHTA: bets $0.50
yBO+mXB6m/rCft2ErwGf/Q: calls $0.50
*** TURN *** [7c Kd Ac] [2h]
yBO+mXB6m/rCft2ErwGf/Q: checks
sa0qgETiL3HNbdfGlnKHTA: checks
*** RIVER *** [7c Kd Ac 2h] [4d]
yBO+mXB6m/rCft2ErwGf/Q: bets $0.50
sa0qgETiL3HNbdfGlnKHTA: calls $0.50
*** SHOW DOWN ***
yBO+mXB6m/rCft2ErwGf/Q: shows [Td Kh] (a pair of Kings)
sa0qgETiL3HNbdfGlnKHTA: mucks hand
yBO+mXB6m/rCft2ErwGf/Q collected $3.85 from pot
*** SUMMARY ***
Total pot $4 | Rake $0.15
Board [7c Kd Ac 2h 4d]
Seat 1: yBO+mXB6m/rCft2ErwGf/Q (big blind) showed [Td Kh] and won ($3.85) with a pair of Kings
Seat 2: sa0qgETiL3HNbdfGlnKHTA (button) (small blind) mucked



PokerStars Game #59937993278:  Hold'em No Limit ($0.25/$0.50) - 2009/07/01 0:04:35 ET
Table '+dXkOAQyS8j9PQZusUTMpg' 2-max Seat #2 is the button
Seat 1: XFa6sBGjP2gxoIvxR3fZIg ($94.35 in chips)
Seat 2: 5IBeOgaApY1Bvzv2P8X4EA ($22.25 in chips)
5IBeOgaApY1Bvzv2P8X4EA: posts small blind $0.25
XFa6sBGjP2gxoIvxR3fZIg: posts big blind $0.50
*** HOLE CARDS ***
5IBeOgaApY1Bvzv2P8X4EA: calls $0.25
XFa6sBGjP2gxoIvxR3fZIg: checks
*** FLOP *** [6d Jd 8s]
XFa6sBGjP2gxoIvxR3fZIg: bets $1
5IBeOgaApY1Bvzv2P8X4EA: folds
XFa6sBGjP2gxoIvxR3fZIg collected $0.95 from pot
XFa6sBGjP2gxoIvxR3fZIg: doesn't show hand
*** SUMMARY ***
Total pot $1 | Rake $0.05
Board [6d Jd 8s]
Seat 1: XFa6sBGjP2gxoIvxR3fZIg (big blind) collected ($0.95)
Seat 2: 5IBeOgaApY1Bvzv2P8X4EA (button) (small blind) folded on the Flop



PokerStars Game #59937994868:  Hold'em No Limit ($0.25/$0.50) - 2009/07/01 0:04:37 ET
Table 'c/CRn+68J3Y8KxD5g1ek2Q' 2-max Seat #2 is the button
Seat 1: 46qCyJ6evTkHo9al5sBMNA ($327.45 in chips)
Seat 2: BypVLsYQt3ePFm2xQL/dOA ($60.60 in chips)
BypVLsYQt3ePFm2xQL/dOA: posts small blind $0.25
46qCyJ6evTkHo9al5sBMNA: posts big blind $0.50
*** HOLE CARDS ***
BypVLsYQt3ePFm2xQL/dOA: raises $0.50 to $1
46qCyJ6evTkHo9al5sBMNA: folds
BypVLsYQt3ePFm2xQL/dOA collected $1 from pot
BypVLsYQt3ePFm2xQL/dOA: doesn't show hand
*** SUMMARY ***
Total pot $1 | Rake $0
Seat 1: 46qCyJ6evTkHo9al5sBMNA (big blind) folded before Flop
Seat 2: BypVLsYQt3ePFm2xQL/dOA (button) (small blind) collected ($1)



PokerStars Game #59937996234:  Hold'em No Limit ($0.25/$0.50) - 2009/07/01 0:04:38 ET
Table 'kgbJRsxfv64KrErDRBAkcw' 6-max Seat #6 is the button
Seat 1: YmWlPGOKFuJSoJZPW8a8IA ($82.05 in chips)
Seat 2: Q+thC23WCv1kJUJtH/+4Jw ($25 in chips)
Seat 3: T0Gx/FcQ5VH9u7XaOMX97A ($62.40 in chips)
Seat 4: qanMEqjABjWxC/JgQ/0l7w ($54.30 in chips)
Seat 5: SlTdlH14u+KVVINgxMwt+Q ($74.70 in chips)
Seat 6: DDfYzIrYT0t5R/hAJngtsg ($25.60 in chips)
YmWlPGOKFuJSoJZPW8a8IA: posts small blind $0.25
Q+thC23WCv1kJUJtH/+4Jw: posts big blind $0.50
*** HOLE CARDS ***
T0Gx/FcQ5VH9u7XaOMX97A: folds
qanMEqjABjWxC/JgQ/0l7w: raises $1 to $1.50
SlTdlH14u+KVVINgxMwt+Q: folds
DDfYzIrYT0t5R/hAJngtsg: calls $1.50
YmWlPGOKFuJSoJZPW8a8IA: folds
Q+thC23WCv1kJUJtH/+4Jw: folds
*** FLOP *** [3c 8s 2c]
qanMEqjABjWxC/JgQ/0l7w: bets $2.50
DDfYzIrYT0t5R/hAJngtsg: folds
qanMEqjABjWxC/JgQ/0l7w collected $3.60 from pot
*** SUMMARY ***
Total pot $3.75 | Rake $0.15
Board [3c 8s 2c]
Seat 1: YmWlPGOKFuJSoJZPW8a8IA (small blind) folded before Flop
Seat 2: Q+thC23WCv1kJUJtH/+4Jw (big blind) folded before Flop
Seat 3: T0Gx/FcQ5VH9u7XaOMX97A folded before Flop (didn't bet)
Seat 4: qanMEqjABjWxC/JgQ/0l7w collected ($3.60)
Seat 5: SlTdlH14u+KVVINgxMwt+Q folded before Flop (didn't bet)
Seat 6: DDfYzIrYT0t5R/hAJngtsg (button) folded on the Flop



PokerStars Game #59938000716:  Hold'em No Limit ($0.25/$0.50) - 2009/07/01 0:04:44 ET
Table 'X6IRCRTh+20gjz8aubWnwA' 9-max Seat #6 is the button
Seat 1: YPo1oggovmqSREegekaQYw ($10.70 in chips)
Seat 2: RjBdQ6w31rgcy0o24VLR6w ($11.45 in chips)
Seat 3: mSD1pginDsyHG5PDfqzphw ($10 in chips)
Seat 4: uw9QayAAxLM3Hb+HR7mSkg ($9.25 in chips)
Seat 5: aT3lRsb9BkkYp2fkD3LEtQ ($85.15 in chips)
Seat 6: /6In1zC3WtgwxDcueWzZWg ($49.25 in chips)
Seat 7: VBnpbzn0dIveV55qKvciew ($60.20 in chips)
Seat 8: BPMN9sOItJw6vWq3kypaYg ($26.65 in chips)
Seat 9: M+7+BTmX5vZatHVuoRB1nA ($84.85 in chips)
VBnpbzn0dIveV55qKvciew: posts small blind $0.25
BPMN9sOItJw6vWq3kypaYg: posts big blind $0.50
*** HOLE CARDS ***
M+7+BTmX5vZatHVuoRB1nA: folds
YPo1oggovmqSREegekaQYw: raises $0.50 to $1
RjBdQ6w31rgcy0o24VLR6w: folds
mSD1pginDsyHG5PDfqzphw: folds
uw9QayAAxLM3Hb+HR7mSkg: raises $8.25 to $9.25 and is all-in
aT3lRsb9BkkYp2fkD3LEtQ: folds
/6In1zC3WtgwxDcueWzZWg: folds
VBnpbzn0dIveV55qKvciew: folds
BPMN9sOItJw6vWq3kypaYg: folds
YPo1oggovmqSREegekaQYw: folds
uw9QayAAxLM3Hb+HR7mSkg collected $2.75 from pot
uw9QayAAxLM3Hb+HR7mSkg: doesn't show hand
*** SUMMARY ***
Total pot $2.75 | Rake $0
Seat 1: YPo1oggovmqSREegekaQYw folded before Flop
Seat 2: RjBdQ6w31rgcy0o24VLR6w folded before Flop (didn't bet)
Seat 3: mSD1pginDsyHG5PDfqzphw folded before Flop (didn't bet)
Seat 4: uw9QayAAxLM3Hb+HR7mSkg collected ($2.75)
Seat 5: aT3lRsb9BkkYp2fkD3LEtQ folded before Flop (didn't bet)
Seat 6: /6In1zC3WtgwxDcueWzZWg (button) folded before Flop (didn't bet)
Seat 7: VBnpbzn0dIveV55qKvciew (small blind) folded before Flop
Seat 8: BPMN9sOItJw6vWq3kypaYg (big blind) folded before Flop
Seat 9: M+7+BTmX5vZatHVuoRB1nA folded before Flop (didn't bet)



PokerStars Game #59938001308:  Hold'em No Limit ($0.25/$0.50) - 2009/07/01 0:04:45 ET
Table 'c/CRn+68J3Y8KxD5g1ek2Q' 2-max Seat #1 is the button
Seat 1: 46qCyJ6evTkHo9al5sBMNA ($326.95 in chips)
Seat 2: BypVLsYQt3ePFm2xQL/dOA ($61.10 in chips)
46qCyJ6evTkHo9al5sBMNA: posts small blind $0.25
BypVLsYQt3ePFm2xQL/dOA: posts big blind $0.50
*** HOLE CARDS ***
46qCyJ6evTkHo9al5sBMNA: folds
BypVLsYQt3ePFm2xQL/dOA collected $0.50 from pot
BypVLsYQt3ePFm2xQL/dOA: doesn't show hand
*** SUMMARY ***
Total pot $0.50 | Rake $0
Seat 1: 46qCyJ6evTkHo9al5sBMNA (button) (small blind) folded before Flop
Seat 2: BypVLsYQt3ePFm2xQL/dOA (big blind) collected ($0.50)



PokerStars Game #59938002118:  Hold'em No Limit ($0.25/$0.50) - 2009/07/01 0:04:46 ET
Table 'mTxf8gPLgffN3Iwfm7Icfg' 2-max Seat #2 is the button
Seat 1: Do9Rlu1R5u/AcRtMTl8SYg ($75.15 in chips)
Seat 2: EMc5LPgVaded4Qc77vm0fw ($40.05 in chips)
EMc5LPgVaded4Qc77vm0fw: posts small blind $0.25
Do9Rlu1R5u/AcRtMTl8SYg: posts big blind $0.50
*** HOLE CARDS ***
EMc5LPgVaded4Qc77vm0fw: raises $1.50 to $2
Do9Rlu1R5u/AcRtMTl8SYg: folds
EMc5LPgVaded4Qc77vm0fw collected $1 from pot
EMc5LPgVaded4Qc77vm0fw: doesn't show hand
*** SUMMARY ***
Total pot $1 | Rake $0
Seat 1: Do9Rlu1R5u/AcRtMTl8SYg (big blind) folded before Flop
Seat 2: EMc5LPgVaded4Qc77vm0fw (button) (small blind) collected ($1)



PokerStars Game #59938002784:  Hold'em No Limit ($0.25/$0.50) - 2009/07/01 0:04:47 ET
Table 'SsXEKOwKN+jE3etfusqUqA' 2-max Seat #1 is the button
Seat 1: 618rKeLrz/avGNOLULHHVQ ($50 in chips)
Seat 2: XfRhywXA6Br+jID1oGeo8A ($201.95 in chips)
618rKeLrz/avGNOLULHHVQ: posts small blind $0.25
XfRhywXA6Br+jID1oGeo8A: posts big blind $0.50
*** HOLE CARDS ***
618rKeLrz/avGNOLULHHVQ said, "im so raping u, skillwise"
618rKeLrz/avGNOLULHHVQ said, "lcker"
618rKeLrz/avGNOLULHHVQ: raises $1 to $1.50
XfRhywXA6Br+jID1oGeo8A: folds
618rKeLrz/avGNOLULHHVQ collected $1 from pot
618rKeLrz/avGNOLULHHVQ: doesn't show hand
*** SUMMARY ***
Total pot $1 | Rake $0
Seat 1: 618rKeLrz/avGNOLULHHVQ (button) (small blind) collected ($1)
Seat 2: XfRhywXA6Br+jID1oGeo8A (big blind) folded before Flop



PokerStars Game #59938004632:  Hold'em No Limit ($0.25/$0.50) - 2009/07/01 0:04:50 ET
Table '+dXkOAQyS8j9PQZusUTMpg' 2-max Seat #1 is the button
Seat 1: XFa6sBGjP2gxoIvxR3fZIg ($94.80 in chips)
Seat 2: 5IBeOgaApY1Bvzv2P8X4EA ($21.75 in chips)
XFa6sBGjP2gxoIvxR3fZIg: posts small blind $0.25
5IBeOgaApY1Bvzv2P8X4EA: posts big blind $0.50
*** HOLE CARDS ***
XFa6sBGjP2gxoIvxR3fZIg: raises $1 to $1.50
5IBeOgaApY1Bvzv2P8X4EA: calls $1
*** FLOP *** [9h 2c Td]
5IBeOgaApY1Bvzv2P8X4EA: checks
XFa6sBGjP2gxoIvxR3fZIg: checks
*** TURN *** [9h 2c Td] [8c]
5IBeOgaApY1Bvzv2P8X4EA: bets $1
XFa6sBGjP2gxoIvxR3fZIg: raises $2.50 to $3.50
5IBeOgaApY1Bvzv2P8X4EA: calls $2.50
*** RIVER *** [9h 2c Td 8c] [9s]
5IBeOgaApY1Bvzv2P8X4EA: checks
XFa6sBGjP2gxoIvxR3fZIg: checks
*** SHOW DOWN ***
5IBeOgaApY1Bvzv2P8X4EA: shows [8h 7h] (two pair, Nines and Eights)
XFa6sBGjP2gxoIvxR3fZIg: mucks hand
5IBeOgaApY1Bvzv2P8X4EA collected $9.55 from pot
*** SUMMARY ***
Total pot $10 | Rake $0.45
Board [9h 2c Td 8c 9s]
Seat 1: XFa6sBGjP2gxoIvxR3fZIg (button) (small blind) mucked
Seat 2: 5IBeOgaApY1Bvzv2P8X4EA (big blind) showed [8h 7h] and won ($9.55) with two pair, Nines and Eights



PokerStars Game #59938005158:  Hold'em No Limit ($0.25/$0.50) - 2009/07/01 0:04:50 ET
Table 'hSTs/dUsYLgJQuF2Onp0MQ' 6-max Seat #3 is the button
Seat 1: lWwl5C/UZOsWNubdUqghZw ($71.45 in chips)
Seat 3: vQOrJuXbLC3UZDVklY9bOA ($12 in chips)
Seat 4: L0aIPg7qefDQjdJo3HCVEA ($14.70 in chips)
Seat 5: 686aeHikcJlgKkSuIFdcXQ ($61.40 in chips)
Seat 6: +laPa9P7BjZKKnR0n+OmvA ($12 in chips)
L0aIPg7qefDQjdJo3HCVEA: posts small blind $0.25
686aeHikcJlgKkSuIFdcXQ: posts big blind $0.50
*** HOLE CARDS ***
+laPa9P7BjZKKnR0n+OmvA: folds
lWwl5C/UZOsWNubdUqghZw: folds
vQOrJuXbLC3UZDVklY9bOA: calls $0.50
L0aIPg7qefDQjdJo3HCVEA: folds
686aeHikcJlgKkSuIFdcXQ: checks
*** FLOP *** [Qc Qs 6s]
686aeHikcJlgKkSuIFdcXQ: checks
vQOrJuXbLC3UZDVklY9bOA: checks
*** TURN *** [Qc Qs 6s] [9s]
686aeHikcJlgKkSuIFdcXQ: checks
vQOrJuXbLC3UZDVklY9bOA: bets $1
686aeHikcJlgKkSuIFdcXQ: folds
vQOrJuXbLC3UZDVklY9bOA collected $1.20 from pot
*** SUMMARY ***
Total pot $1.25 | Rake $0.05
Board [Qc Qs 6s 9s]
Seat 1: lWwl5C/UZOsWNubdUqghZw folded before Flop (didn't bet)
Seat 3: vQOrJuXbLC3UZDVklY9bOA (button) collected ($1.20)
Seat 4: L0aIPg7qefDQjdJo3HCVEA (small blind) folded before Flop
Seat 5: 686aeHikcJlgKkSuIFdcXQ (big blind) folded on the Turn
Seat 6: +laPa9P7BjZKKnR0n+OmvA folded before Flop (didn't bet)



PokerStars Game #59938006058:  Hold'em No Limit ($0.25/$0.50) - 2009/07/01 0:04:52 ET
Table 'BCN5su+SsXiy1zRMJi0SJw' 6-max Seat #4 is the button
Seat 2: QfV2JJlmEKgD5jYPV+a33A ($159.40 in chips)
Seat 4: 6Wb8PlO2kM4fnSim7p4Mrw ($14.90 in chips)
Seat 5: TTx3CHxyi0SObcHyMJRp5w ($39.35 in chips)
Seat 6: zHXshyreKwJVq3N3U+K9uQ ($51.30 in chips)
TTx3CHxyi0SObcHyMJRp5w: posts small blind $0.25
zHXshyreKwJVq3N3U+K9uQ: posts big blind $0.50
WyeokAqR0q9nADSkWpbxHw: sits out
*** HOLE CARDS ***
QfV2JJlmEKgD5jYPV+a33A: folds
6Wb8PlO2kM4fnSim7p4Mrw: folds
TTx3CHxyi0SObcHyMJRp5w: folds
zHXshyreKwJVq3N3U+K9uQ collected $0.50 from pot
zHXshyreKwJVq3N3U+K9uQ: doesn't show hand
*** SUMMARY ***
Total pot $0.50 | Rake $0
Seat 2: QfV2JJlmEKgD5jYPV+a33A folded before Flop (didn't bet)
Seat 4: 6Wb8PlO2kM4fnSim7p4Mrw (button) folded before Flop (didn't bet)
Seat 5: TTx3CHxyi0SObcHyMJRp5w (small blind) folded before Flop
Seat 6: zHXshyreKwJVq3N3U+K9uQ (big blind) collected ($0.50)



PokerStars Game #59938007264:  Hold'em No Limit ($0.25/$0.50) - 2009/07/01 0:04:53 ET
Table 'c/CRn+68J3Y8KxD5g1ek2Q' 2-max Seat #2 is the button
Seat 1: 46qCyJ6evTkHo9al5sBMNA ($326.70 in chips)
Seat 2: BypVLsYQt3ePFm2xQL/dOA ($61.35 in chips)
BypVLsYQt3ePFm2xQL/dOA: posts small blind $0.25
46qCyJ6evTkHo9al5sBMNA: posts big blind $0.50
*** HOLE CARDS ***
BypVLsYQt3ePFm2xQL/dOA: raises $0.50 to $1
46qCyJ6evTkHo9al5sBMNA: folds
BypVLsYQt3ePFm2xQL/dOA collected $1 from pot
BypVLsYQt3ePFm2xQL/dOA: doesn't show hand
*** SUMMARY ***
Total pot $1 | Rake $0
Seat 1: 46qCyJ6evTkHo9al5sBMNA (big blind) folded before Flop
Seat 2: BypVLsYQt3ePFm2xQL/dOA (button) (small blind) collected ($1)



PokerStars Game #59938006920:  Hold'em No Limit ($0.25/$0.50) - 2009/07/01 0:04:53 ET
Table '5EmHi+fnatGQQShcNmzOZQ' 6-max Seat #6 is the button
Seat 1: SwPczQo3cOtwEzhJrfO2cQ ($20 in chips)
Seat 2: APwvTk5XojDXGoQLb4O5iA ($25.80 in chips)
Seat 3: J8dF2sYMvXUmAGUuSW9kwg ($36.05 in chips)
Seat 4: mFTuMjESuBcXHQ1ePkg/8A ($20.05 in chips)
Seat 5: kxPhs4ePFqMy52CInAJ2aw ($73.05 in chips)
Seat 6: 686aeHikcJlgKkSuIFdcXQ ($115.45 in chips)
SwPczQo3cOtwEzhJrfO2cQ: posts small blind $0.25
APwvTk5XojDXGoQLb4O5iA: posts big blind $0.50
*** HOLE CARDS ***
J8dF2sYMvXUmAGUuSW9kwg: folds
mFTuMjESuBcXHQ1ePkg/8A: calls $0.50
kxPhs4ePFqMy52CInAJ2aw: folds
686aeHikcJlgKkSuIFdcXQ: folds
SwPczQo3cOtwEzhJrfO2cQ: calls $0.25
APwvTk5XojDXGoQLb4O5iA: checks
*** FLOP *** [3s 7h Ac]
SwPczQo3cOtwEzhJrfO2cQ: bets $0.50
APwvTk5XojDXGoQLb4O5iA: folds
mFTuMjESuBcXHQ1ePkg/8A: calls $0.50
*** TURN *** [3s 7h Ac] [5c]
SwPczQo3cOtwEzhJrfO2cQ: bets $0.50
mFTuMjESuBcXHQ1ePkg/8A: raises $0.50 to $1
SwPczQo3cOtwEzhJrfO2cQ: calls $0.50
*** RIVER *** [3s 7h Ac 5c] [Jh]
SwPczQo3cOtwEzhJrfO2cQ: bets $0.50
mFTuMjESuBcXHQ1ePkg/8A: folds
SwPczQo3cOtwEzhJrfO2cQ collected $4.30 from pot
*** SUMMARY ***
Total pot $4.50 | Rake $0.20
Board [3s 7h Ac 5c Jh]
Seat 1: SwPczQo3cOtwEzhJrfO2cQ (small blind) collected ($4.30)
Seat 2: APwvTk5XojDXGoQLb4O5iA (big blind) folded on the Flop
Seat 3: J8dF2sYMvXUmAGUuSW9kwg folded before Flop (didn't bet)
Seat 4: mFTuMjESuBcXHQ1ePkg/8A folded on the River
Seat 5: kxPhs4ePFqMy52CInAJ2aw folded before Flop (didn't bet)
Seat 6: 686aeHikcJlgKkSuIFdcXQ (button) folded before Flop (didn't bet)



PokerStars Game #59938008860:  Hold'em No Limit ($0.25/$0.50) - 2009/07/01 0:04:55 ET
Table 'MJxeZCzYELxiIsyUZyT0jw' 6-max Seat #3 is the button
Seat 1: iKPos8JI094Tomq4tDSgnQ ($27.80 in chips)
Seat 2: r6H1GiZ6QIpMTDhyodKuRQ ($65.65 in chips)
Seat 3: JQZew0FjzS19kTjeNtrE+A ($51.10 in chips)
Seat 4: lP7Q6pewz4C2RsAfKsjdWw ($24.80 in chips)
Seat 5: 3jvoOXNtXE90w2BdfNZwZQ ($50 in chips)
Seat 6: TTx3CHxyi0SObcHyMJRp5w ($41.70 in chips)
lP7Q6pewz4C2RsAfKsjdWw: posts small blind $0.25
3jvoOXNtXE90w2BdfNZwZQ: posts big blind $0.50
*** HOLE CARDS ***
TTx3CHxyi0SObcHyMJRp5w: folds
iKPos8JI094Tomq4tDSgnQ: folds
r6H1GiZ6QIpMTDhyodKuRQ: folds
JQZew0FjzS19kTjeNtrE+A: raises $2 to $2.50
lP7Q6pewz4C2RsAfKsjdWw: folds
3jvoOXNtXE90w2BdfNZwZQ: folds
JQZew0FjzS19kTjeNtrE+A collected $1.25 from pot
*** SUMMARY ***
Total pot $1.25 | Rake $0
Seat 1: iKPos8JI094Tomq4tDSgnQ folded before Flop (didn't bet)
Seat 2: r6H1GiZ6QIpMTDhyodKuRQ folded before Flop (didn't bet)
Seat 3: JQZew0FjzS19kTjeNtrE+A (button) collected ($1.25)
Seat 4: lP7Q6pewz4C2RsAfKsjdWw (small blind) folded before Flop
Seat 5: 3jvoOXNtXE90w2BdfNZwZQ (big blind) folded before Flop
Seat 6: TTx3CHxyi0SObcHyMJRp5w folded before Flop (didn't bet)



PokerStars Game #59938008232:  Hold'em No Limit ($0.25/$0.50) - 2009/07/01 0:04:55 ET
Table 'tpZbcIvqh/6WmfR/i5IE3A' 9-max Seat #4 is the button
Seat 1: nV/P1jFY/CFMXOLWu7pYmA ($14.45 in chips)
Seat 2: M+7+BTmX5vZatHVuoRB1nA ($45.90 in chips)
Seat 3: 3w0FbBQAKwQODwenKwZxXw ($76.95 in chips)
Seat 4: zE9cVigS2nW/Ljy4K4bUQA ($30 in chips)
Seat 5: 9r7ZoBbAJj5IeyZ0q9BdzA ($12.20 in chips)
Seat 6: E2518gp4aFz1+kAgmGqeEg ($12.20 in chips)
Seat 7: wIZ377kjl2fHFGnS93o6bw ($14.45 in chips)
Seat 8: bXpVeaSTPBFSPJmeXxO7nw ($9.85 in chips)
9r7ZoBbAJj5IeyZ0q9BdzA: posts small blind $0.25
E2518gp4aFz1+kAgmGqeEg: posts big blind $0.50
*** HOLE CARDS ***
wIZ377kjl2fHFGnS93o6bw: folds
bXpVeaSTPBFSPJmeXxO7nw: raises $1 to $1.50
nV/P1jFY/CFMXOLWu7pYmA: folds
M+7+BTmX5vZatHVuoRB1nA: folds
3w0FbBQAKwQODwenKwZxXw: folds
zE9cVigS2nW/Ljy4K4bUQA: folds
9r7ZoBbAJj5IeyZ0q9BdzA: folds
E2518gp4aFz1+kAgmGqeEg: folds
bXpVeaSTPBFSPJmeXxO7nw collected $1.25 from pot
bXpVeaSTPBFSPJmeXxO7nw: doesn't show hand
*** SUMMARY ***
Total pot $1.25 | Rake $0
Seat 1: nV/P1jFY/CFMXOLWu7pYmA folded before Flop (didn't bet)
Seat 2: M+7+BTmX5vZatHVuoRB1nA folded before Flop (didn't bet)
Seat 3: 3w0FbBQAKwQODwenKwZxXw folded before Flop (didn't bet)
Seat 4: zE9cVigS2nW/Ljy4K4bUQA (button) folded before Flop (didn't bet)
Seat 5: 9r7ZoBbAJj5IeyZ0q9BdzA (small blind) folded before Flop
Seat 6: E2518gp4aFz1+kAgmGqeEg (big blind) folded before Flop
Seat 7: wIZ377kjl2fHFGnS93o6bw folded before Flop (didn't bet)
Seat 8: bXpVeaSTPBFSPJmeXxO7nw collected ($1.25)



PokerStars Game #59938008582:  Hold'em No Limit ($0.25/$0.50) - 2009/07/01 0:04:55 ET
Table 'lpxYasB1ClBSgTpCCITwhQ' 9-max Seat #4 is the button
Seat 1: ceq82/EkjUd/GFbf0YwGmA ($40.95 in chips)
Seat 3: E2518gp4aFz1+kAgmGqeEg ($10.75 in chips)
Seat 4: k1f0lS7tlMHCLGs0JT34Tg ($9.25 in chips)
Seat 5: bXpVeaSTPBFSPJmeXxO7nw ($9.50 in chips)
Seat 6: YPo1oggovmqSREegekaQYw ($17.25 in chips)
Seat 7: zE9cVigS2nW/Ljy4K4bUQA ($30 in chips)
Seat 8: o6JyUkbzCDw8tUabqtmnlg ($24.45 in chips)
Seat 9: mSD1pginDsyHG5PDfqzphw ($10 in chips)
bXpVeaSTPBFSPJmeXxO7nw: posts small blind $0.25
YPo1oggovmqSREegekaQYw: posts big blind $0.50
*** HOLE CARDS ***
zE9cVigS2nW/Ljy4K4bUQA: folds
o6JyUkbzCDw8tUabqtmnlg: folds
mSD1pginDsyHG5PDfqzphw: raises $1 to $1.50
ceq82/EkjUd/GFbf0YwGmA: folds
E2518gp4aFz1+kAgmGqeEg: folds
k1f0lS7tlMHCLGs0JT34Tg: folds
bXpVeaSTPBFSPJmeXxO7nw: folds
YPo1oggovmqSREegekaQYw: folds
mSD1pginDsyHG5PDfqzphw collected $1.25 from pot
mSD1pginDsyHG5PDfqzphw: doesn't show hand
*** SUMMARY ***
Total pot $1.25 | Rake $0
Seat 1: ceq82/EkjUd/GFbf0YwGmA folded before Flop (didn't bet)
Seat 3: E2518gp4aFz1+kAgmGqeEg folded before Flop (didn't bet)
Seat 4: k1f0lS7tlMHCLGs0JT34Tg (button) folded before Flop (didn't bet)
Seat 5: bXpVeaSTPBFSPJmeXxO7nw (small blind) folded before Flop
Seat 6: YPo1oggovmqSREegekaQYw (big blind) folded before Flop
Seat 7: zE9cVigS2nW/Ljy4K4bUQA folded before Flop (didn't bet)
Seat 8: o6JyUkbzCDw8tUabqtmnlg folded before Flop (didn't bet)
Seat 9: mSD1pginDsyHG5PDfqzphw collected ($1.25)



PokerStars Game #59938009170:  Hold'em No Limit ($0.25/$0.50) - 2009/07/01 0:04:56 ET
Table 'QOgaEqMcJ73pcUMMxoisUgErOuyGLI5PT3G5MnpHgC/g Seat #9 is the button
Seat 1: k6GJzKs7T7qvQggW9g8Pdw ($48.25 in chips)
Seat 2: RjBdQ6w31rgcy0o24VLR6w ($9.50 in chips)
Seat 3: xZCXQSXlrZkp3pZizzVXCw ($49 in chips)
Seat 4: U7aZzIYWjv3SL30KtikLbw ($49.45 in chips)
Seat 5: JwvquocWfhTVApN5t47LgA ($51.05 in chips)
Seat 6: zE9cVigS2nW/Ljy4K4bUQA ($31.35 in chips)
Seat 7: 90Wb75h3W1BRpbqVnuk8gw ($62.55 in chips)
Seat 8: ajP1NjIMdqQfpMbzHzvejw ($41.30 in chips)
Seat 9: J0W5D97jl5VLky+IoPvDeA ($67.80 in chips)
k6GJzKs7T7qvQggW9g8Pdw: posts small blind $0.25
RjBdQ6w31rgcy0o24VLR6w: posts big blind $0.50
*** HOLE CARDS ***
xZCXQSXlrZkp3pZizzVXCw: folds
U7aZzIYWjv3SL30KtikLbw: calls $0.50
JwvquocWfhTVApN5t47LgA: folds
zE9cVigS2nW/Ljy4K4bUQA: folds
90Wb75h3W1BRpbqVnuk8gw: folds
ajP1NjIMdqQfpMbzHzvejw: folds
J0W5D97jl5VLky+IoPvDeA: folds
k6GJzKs7T7qvQggW9g8Pdw: calls $0.25
RjBdQ6w31rgcy0o24VLR6w: checks
*** FLOP *** [Ad Jd Js]
k6GJzKs7T7qvQggW9g8Pdw: checks
RjBdQ6w31rgcy0o24VLR6w: bets $1
U7aZzIYWjv3SL30KtikLbw: folds
k6GJzKs7T7qvQggW9g8Pdw: folds
RjBdQ6w31rgcy0o24VLR6w collected $1.45 from pot
*** SUMMARY ***
Total pot $1.50 | Rake $0.05
Board [Ad Jd Js]
Seat 1: k6GJzKs7T7qvQggW9g8Pdw (small blind) folded on the Flop
Seat 2: RjBdQ6w31rgcy0o24VLR6w (big blind) collected ($1.45)
Seat 3: xZCXQSXlrZkp3pZizzVXCw folded before Flop (didn't bet)
Seat 4: U7aZzIYWjv3SL30KtikLbw folded on the Flop
Seat 5: JwvquocWfhTVApN5t47LgA folded before Flop (didn't bet)
Seat 6: zE9cVigS2nW/Ljy4K4bUQA folded before Flop (didn't bet)
Seat 7: 90Wb75h3W1BRpbqVnuk8gw folded before Flop (didn't bet)
Seat 8: ajP1NjIMdqQfpMbzHzvejw folded before Flop (didn't bet)
Seat 9: J0W5D97jl5VLky+IoPvDeA (button) folded before Flop (didn't bet)



PokerStars Game #59938009654:  Hold'em No Limit ($0.25/$0.50) - 2009/07/01 0:04:57 ET
Table 'kgbJRsxfv64KrErDRBAkcw' 6-max Seat #1 is the button
Seat 1: YmWlPGOKFuJSoJZPW8a8IA ($81.80 in chips)
Seat 2: Q+thC23WCv1kJUJtH/+4Jw ($24.50 in chips)
Seat 3: T0Gx/FcQ5VH9u7XaOMX97A ($62.40 in chips)
Seat 4: qanMEqjABjWxC/JgQ/0l7w ($56.40 in chips)
Seat 5: SlTdlH14u+KVVINgxMwt+Q ($74.70 in chips)
Seat 6: DDfYzIrYT0t5R/hAJngtsg ($24.10 in chips)
Q+thC23WCv1kJUJtH/+4Jw: posts small blind $0.25
T0Gx/FcQ5VH9u7XaOMX97A: posts big blind $0.50
*** HOLE CARDS ***
qanMEqjABjWxC/JgQ/0l7w: folds
SlTdlH14u+KVVINgxMwt+Q: folds
DDfYzIrYT0t5R/hAJngtsg: calls $0.50
YmWlPGOKFuJSoJZPW8a8IA: folds
Q+thC23WCv1kJUJtH/+4Jw: calls $0.25
T0Gx/FcQ5VH9u7XaOMX97A: checks
*** FLOP *** [8c 7h Tc]
Q+thC23WCv1kJUJtH/+4Jw: checks
T0Gx/FcQ5VH9u7XaOMX97A: checks
DDfYzIrYT0t5R/hAJngtsg: bets $0.50
Q+thC23WCv1kJUJtH/+4Jw: raises $1.50 to $2
T0Gx/FcQ5VH9u7XaOMX97A: folds
DDfYzIrYT0t5R/hAJngtsg: calls $1.50
*** TURN *** [8c 7h Tc] [Qh]
Q+thC23WCv1kJUJtH/+4Jw: bets $3
DDfYzIrYT0t5R/hAJngtsg: folds
Q+thC23WCv1kJUJtH/+4Jw collected $5.25 from pot
*** SUMMARY ***
Total pot $5.50 | Rake $0.25
Board [8c 7h Tc Qh]
Seat 1: YmWlPGOKFuJSoJZPW8a8IA (button) folded before Flop (didn't bet)
Seat 2: Q+thC23WCv1kJUJtH/+4Jw (small blind) collected ($5.25)
Seat 3: T0Gx/FcQ5VH9u7XaOMX97A (big blind) folded on the Flop
Seat 4: qanMEqjABjWxC/JgQ/0l7w folded before Flop (didn't bet)
Seat 5: SlTdlH14u+KVVINgxMwt+Q folded before Flop (didn't bet)
Seat 6: DDfYzIrYT0t5R/hAJngtsg folded on the Turn



PokerStars Game #59938010202:  Hold'em No Limit ($0.25/$0.50) - 2009/07/01 0:04:57 ET
Table 'SsXEKOwKN+jE3etfusqUqA' 2-max Seat #2 is the button
Seat 1: 618rKeLrz/avGNOLULHHVQ ($50.50 in chips)
Seat 2: XfRhywXA6Br+jID1oGeo8A ($201.45 in chips)
XfRhywXA6Br+jID1oGeo8A: posts small blind $0.25
618rKeLrz/avGNOLULHHVQ: posts big blind $0.50
*** HOLE CARDS ***
XfRhywXA6Br+jID1oGeo8A: folds
618rKeLrz/avGNOLULHHVQ collected $0.50 from pot
618rKeLrz/avGNOLULHHVQ: doesn't show hand
*** SUMMARY ***
Total pot $0.50 | Rake $0
Seat 1: 618rKeLrz/avGNOLULHHVQ (big blind) collected ($0.50)
Seat 2: XfRhywXA6Br+jID1oGeo8A (button) (small blind) folded before Flop



PokerStars Game #59938010820:  Hold'em No Limit ($0.25/$0.50) - 2009/07/01 0:04:58 ET
Table 'GfL/No5u5PoEnU39lP5pQg' 6-max Seat #3 is the button
Seat 1: T0Gx/FcQ5VH9u7XaOMX97A ($53.40 in chips)
Seat 2: uVwggSetzp7d+eVgowO3vg ($19.50 in chips)
Seat 3: YmWlPGOKFuJSoJZPW8a8IA ($98.70 in chips)
Seat 4: yqM0AD7MZQd/cEtKdDQY1A ($34.15 in chips)
yqM0AD7MZQd/cEtKdDQY1A: posts small blind $0.25
5EiAo0XuFchfJkhvFPvoog: is sitting out
T0Gx/FcQ5VH9u7XaOMX97A: posts big blind $0.50
*** HOLE CARDS ***
5EiAo0XuFchfJkhvFPvoog leaves the table
uVwggSetzp7d+eVgowO3vg: folds
YmWlPGOKFuJSoJZPW8a8IA: raises $1 to $1.50
yqM0AD7MZQd/cEtKdDQY1A: folds
T0Gx/FcQ5VH9u7XaOMX97A: folds
YmWlPGOKFuJSoJZPW8a8IA collected $1.25 from pot
YmWlPGOKFuJSoJZPW8a8IA: doesn't show hand
*** SUMMARY ***
Total pot $1.25 | Rake $0
Seat 1: T0Gx/FcQ5VH9u7XaOMX97A (big blind) folded before Flop
Seat 2: uVwggSetzp7d+eVgowO3vg folded before Flop (didn't bet)
Seat 3: YmWlPGOKFuJSoJZPW8a8IA (button) collected ($1.25)
Seat 4: yqM0AD7MZQd/cEtKdDQY1A (small blind) folded before Flop



PokerStars Game #59938011128:  Hold'em No Limit ($0.25/$0.50) - 2009/07/01 0:04:59 ET
Table 'mTxf8gPLgffN3Iwfm7Icfg' 2-max Seat #1 is the button
Seat 1: Do9Rlu1R5u/AcRtMTl8SYg ($74.65 in chips)
Seat 2: EMc5LPgVaded4Qc77vm0fw ($40.55 in chips)
Do9Rlu1R5u/AcRtMTl8SYg: posts small blind $0.25
EMc5LPgVaded4Qc77vm0fw: posts big blind $0.50
*** HOLE CARDS ***
Do9Rlu1R5u/AcRtMTl8SYg: raises $1 to $1.50
EMc5LPgVaded4Qc77vm0fw: calls $1
*** FLOP *** [3c 5s 8s]
EMc5LPgVaded4Qc77vm0fw: bets $2
Do9Rlu1R5u/AcRtMTl8SYg: folds
EMc5LPgVaded4Qc77vm0fw collected $2.85 from pot
EMc5LPgVaded4Qc77vm0fw: doesn't show hand
*** SUMMARY ***
Total pot $3 | Rake $0.15
Board [3c 5s 8s]
Seat 1: Do9Rlu1R5u/AcRtMTl8SYg (button) (small blind) folded on the Flop
Seat 2: EMc5LPgVaded4Qc77vm0fw (big blind) collected ($2.85)



PokerStars Game #59938012660:  Hold'em No Limit ($0.25/$0.50) - 2009/07/01 0:05:01 ET
Table 'c/CRn+68J3Y8KxD5g1ek2Q' 2-max Seat #1 is the button
Seat 1: 46qCyJ6evTkHo9al5sBMNA ($326.20 in chips)
Seat 2: BypVLsYQt3ePFm2xQL/dOA ($61.85 in chips)
46qCyJ6evTkHo9al5sBMNA: posts small blind $0.25
BypVLsYQt3ePFm2xQL/dOA: posts big blind $0.50
*** HOLE CARDS ***
46qCyJ6evTkHo9al5sBMNA: raises $1 to $1.50
BypVLsYQt3ePFm2xQL/dOA: raises $8 to $9.50
46qCyJ6evTkHo9al5sBMNA: calls $8
*** FLOP *** [Jc 3d 3h]
BypVLsYQt3ePFm2xQL/dOA: bets $10.50
46qCyJ6evTkHo9al5sBMNA: folds
BypVLsYQt3ePFm2xQL/dOA collected $18.50 from pot
BypVLsYQt3ePFm2xQL/dOA: doesn't show hand
*** SUMMARY ***
Total pot $19 | Rake $0.50
Board [Jc 3d 3h]
Seat 1: 46qCyJ6evTkHo9al5sBMNA (button) (small blind) folded on the Flop
Seat 2: BypVLsYQt3ePFm2xQL/dOA (big blind) collected ($18.50)



PokerStars Game #59938013356:  Hold'em No Limit ($0.25/$0.50) - 2009/07/01 0:05:02 ET
Table 'BCN5su+SsXiy1zRMJi0SJw' 6-max Seat #5 is the button
Seat 1: WyeokAqR0q9nADSkWpbxHw ($35 in chips)
Seat 2: QfV2JJlmEKgD5jYPV+a33A ($159.40 in chips)
Seat 4: 6Wb8PlO2kM4fnSim7p4Mrw ($14.90 in chips)
Seat 5: TTx3CHxyi0SObcHyMJRp5w ($39.10 in chips)
Seat 6: zHXshyreKwJVq3N3U+K9uQ ($51.55 in chips)
zHXshyreKwJVq3N3U+K9uQ: posts small blind $0.25
WyeokAqR0q9nADSkWpbxHw: posts big blind $0.50
*** HOLE CARDS ***
yrJsFKWv+ttHooqghxDx3A said, "that is fucin disgusting"
QfV2JJlmEKgD5jYPV+a33A: folds
6Wb8PlO2kM4fnSim7p4Mrw: raises $0.50 to $1
TTx3CHxyi0SObcHyMJRp5w: folds
zHXshyreKwJVq3N3U+K9uQ: folds
WyeokAqR0q9nADSkWpbxHw: calls $0.50
*** FLOP *** [Ks Qd Jc]
yrJsFKWv+ttHooqghxDx3A said, "this place is for morons"
WyeokAqR0q9nADSkWpbxHw: checks
6Wb8PlO2kM4fnSim7p4Mrw: bets $0.50
WyeokAqR0q9nADSkWpbxHw: calls $0.50
*** TURN *** [Ks Qd Jc] [6s]
yrJsFKWv+ttHooqghxDx3A said, "I am done back to reality"
WyeokAqR0q9nADSkWpbxHw: checks
yrJsFKWv+ttHooqghxDx3A leaves the table
6Wb8PlO2kM4fnSim7p4Mrw: bets $0.50
WyeokAqR0q9nADSkWpbxHw: calls $0.50
*** RIVER *** [Ks Qd Jc 6s] [Ac]
WyeokAqR0q9nADSkWpbxHw: bets $0.50
6Wb8PlO2kM4fnSim7p4Mrw: raises $2 to $2.50
WyeokAqR0q9nADSkWpbxHw: calls $2
*** SHOW DOWN ***
6Wb8PlO2kM4fnSim7p4Mrw: shows [9h 9c] (a pair of Nines)
WyeokAqR0q9nADSkWpbxHw: shows [Ts Jh] (a straight, Ten to Ace)
WyeokAqR0q9nADSkWpbxHw collected $8.80 from pot
*** SUMMARY ***
Total pot $9.25 | Rake $0.45
Board [Ks Qd Jc 6s Ac]
Seat 1: WyeokAqR0q9nADSkWpbxHw (big blind) showed [Ts Jh] and won ($8.80) with a straight, Ten to Ace
Seat 2: QfV2JJlmEKgD5jYPV+a33A folded before Flop (didn't bet)
Seat 4: 6Wb8PlO2kM4fnSim7p4Mrw showed [9h 9c] and lost with a pair of Nines
Seat 5: TTx3CHxyi0SObcHyMJRp5w (button) folded before Flop (didn't bet)
Seat 6: zHXshyreKwJVq3N3U+K9uQ (small blind) folded before Flop



PokerStars Game #59938014088:  Hold'em No Limit ($0.25/$0.50) - 2009/07/01 0:05:03 ET
Table 'QOgaEqMcJ73pcUMMxoisUg' 6-max Seat #1 is the button
Seat 1: RFefXIDyFvNtJLq+CloCzA ($41.70 in chips)
Seat 3: wUZNozoIDYf+16hp4nn6dw ($17.65 in chips)
Seat 4: L5e2lrPLQm1Pqx30IIZ/Fw ($9.25 in chips)
Seat 5: HoaSQCRso+nEyO5DUhGduw ($77.25 in chips)
Seat 6: s83dnhZ6VC53vY0/f6OV/g ($42.35 in chips)
wUZNozoIDYf+16hp4nn6dw: posts small blind $0.25
L5e2lrPLQm1Pqx30IIZ/Fw: posts big blind $0.50
*** HOLE CARDS ***
HoaSQCRso+nEyO5DUhGduw: calls $0.50
s83dnhZ6VC53vY0/f6OV/g: folds
RFefXIDyFvNtJLq+CloCzA: folds
wUZNozoIDYf+16hp4nn6dw: raises $0.50 to $1
L5e2lrPLQm1Pqx30IIZ/Fw: folds
HoaSQCRso+nEyO5DUhGduw: calls $0.50
*** FLOP *** [Td 5d 3c]
L5e2lrPLQm1Pqx30IIZ/Fw leaves the table
wUZNozoIDYf+16hp4nn6dw: bets $2
HoaSQCRso+nEyO5DUhGduw: raises $2.50 to $4.50
wUZNozoIDYf+16hp4nn6dw: calls $2.50
*** TURN *** [Td 5d 3c] [Jh]
wUZNozoIDYf+16hp4nn6dw: checks
HoaSQCRso+nEyO5DUhGduw: bets $4
wUZNozoIDYf+16hp4nn6dw: calls $4
*** RIVER *** [Td 5d 3c Jh] [Ad]
wUZNozoIDYf+16hp4nn6dw: bets $5
HoaSQCRso+nEyO5DUhGduw: calls $5
*** SHOW DOWN ***
wUZNozoIDYf+16hp4nn6dw: shows [Qc Ah] (a pair of Aces)
HoaSQCRso+nEyO5DUhGduw: mucks hand
wUZNozoIDYf+16hp4nn6dw collected $28.10 from pot
*** SUMMARY ***
Total pot $29.50 | Rake $1.40
Board [Td 5d 3c Jh Ad]
Seat 1: RFefXIDyFvNtJLq+CloCzA (button) folded before Flop (didn't bet)
Seat 3: wUZNozoIDYf+16hp4nn6dw (small blind) showed [Qc Ah] and won ($28.10) with a pair of Aces
Seat 4: L5e2lrPLQm1Pqx30IIZ/Fw (big blind) folded before Flop
Seat 5: HoaSQCRso+nEyO5DUhGduw mucked
Seat 6: s83dnhZ6VC53vY0/f6OV/g folded before Flop (didn't bet)



PokerStars Game #59938014250:  Hold'em No Limit ($0.25/$0.50) - 2009/07/01 0:05:03 ET
Table '0AhP5FLi4ySROVJ/ycT1Qw' 2-max Seat #1 is the button
Seat 1: VzCjk9xTOs+nLWp67vramg ($64.50 in chips)
Seat 2: 46qCyJ6evTkHo9al5sBMNA ($146.20 in chips)
VzCjk9xTOs+nLWp67vramg: posts small blind $0.25
46qCyJ6evTkHo9al5sBMNA: posts big blind $0.50
*** HOLE CARDS ***
VzCjk9xTOs+nLWp67vramg: folds
46qCyJ6evTkHo9al5sBMNA collected $0.50 from pot
46qCyJ6evTkHo9al5sBMNA: doesn't show hand
*** SUMMARY ***
Total pot $0.50 | Rake $0
Seat 1: VzCjk9xTOs+nLWp67vramg (button) (small blind) folded before Flop
Seat 2: 46qCyJ6evTkHo9al5sBMNA (big blind) collected ($0.50)



PokerStars Game #59938014536:  Hold'em No Limit ($0.25/$0.50) - 2009/07/01 0:05:03 ET
Table 'SsXEKOwKN+jE3etfusqUqA' 2-max Seat #1 is the button
Seat 1: 618rKeLrz/avGNOLULHHVQ ($50.75 in chips)
Seat 2: XfRhywXA6Br+jID1oGeo8A ($201.20 in chips)
618rKeLrz/avGNOLULHHVQ: posts small blind $0.25
XfRhywXA6Br+jID1oGeo8A: posts big blind $0.50
*** HOLE CARDS ***
618rKeLrz/avGNOLULHHVQ: raises $1 to $1.50
XfRhywXA6Br+jID1oGeo8A: calls $1
*** FLOP *** [Tc Ts Ad]
XfRhywXA6Br+jID1oGeo8A: checks
618rKeLrz/avGNOLULHHVQ: bets $2
XfRhywXA6Br+jID1oGeo8A: calls $2
*** TURN *** [Tc Ts Ad] [3d]
XfRhywXA6Br+jID1oGeo8A: checks
618rKeLrz/avGNOLULHHVQ: checks
*** RIVER *** [Tc Ts Ad 3d] [Ah]
XfRhywXA6Br+jID1oGeo8A: checks
618rKeLrz/avGNOLULHHVQ: bets $8.50
XfRhywXA6Br+jID1oGeo8A: folds
618rKeLrz/avGNOLULHHVQ collected $6.70 from pot
618rKeLrz/avGNOLULHHVQ: doesn't show hand
*** SUMMARY ***
Total pot $7 | Rake $0.30
Board [Tc Ts Ad 3d Ah]
Seat 1: 618rKeLrz/avGNOLULHHVQ (button) (small blind) collected ($6.70)
Seat 2: XfRhywXA6Br+jID1oGeo8A (big blind) folded on the River



PokerStars Game #59938014344:  Hold'em No Limit ($0.25/$0.50) - 2009/07/01 0:05:03 ET
Table '37qXEp3oe+er5q4CZip9eQ' 6-max Seat #6 is the button
Seat 1: 4qceN3NM3S463h+TT4UvGQ ($13.05 in chips)
Seat 2: g12O9qXTybyo2C0B2bXgjg ($24.20 in chips)
Seat 3: Rt6KgtZ8YaJoTc3FPim00w ($109.10 in chips)
Seat 4: L0aIPg7qefDQjdJo3HCVEA ($10.30 in chips)
Seat 5: VOmI0x4dDPnTESZd5B4d1Q ($30.75 in chips)
Seat 6: f7zPpUQp9hHZgqhEvrUWQw ($55.90 in chips)
4qceN3NM3S463h+TT4UvGQ: posts small blind $0.25
g12O9qXTybyo2C0B2bXgjg: posts big blind $0.50
*** HOLE CARDS ***
Rt6KgtZ8YaJoTc3FPim00w: folds
L0aIPg7qefDQjdJo3HCVEA: folds
VOmI0x4dDPnTESZd5B4d1Q: folds
f7zPpUQp9hHZgqhEvrUWQw: folds
4qceN3NM3S463h+TT4UvGQ: raises $0.50 to $1
g12O9qXTybyo2C0B2bXgjg: calls $0.50
*** FLOP *** [8c 5d Qd]
4qceN3NM3S463h+TT4UvGQ: bets $1
g12O9qXTybyo2C0B2bXgjg: calls $1
*** TURN *** [8c 5d Qd] [3c]
4qceN3NM3S463h+TT4UvGQ: bets $1.50
g12O9qXTybyo2C0B2bXgjg: calls $1.50
*** RIVER *** [8c 5d Qd 3c] [9h]
4qceN3NM3S463h+TT4UvGQ: checks
g12O9qXTybyo2C0B2bXgjg: checks
*** SHOW DOWN ***
4qceN3NM3S463h+TT4UvGQ: shows [Kd Jc] (high card King)
g12O9qXTybyo2C0B2bXgjg: shows [5h Ac] (a pair of Fives)
g12O9qXTybyo2C0B2bXgjg collected $6.70 from pot
*** SUMMARY ***
Total pot $7 | Rake $0.30
Board [8c 5d Qd 3c 9h]
Seat 1: 4qceN3NM3S463h+TT4UvGQ (small blind) showed [Kd Jc] and lost with high card King
Seat 2: g12O9qXTybyo2C0B2bXgjg (big blind) showed [5h Ac] and won ($6.70) with a pair of Fives
Seat 3: Rt6KgtZ8YaJoTc3FPim00w folded before Flop (didn't bet)
Seat 4: L0aIPg7qefDQjdJo3HCVEA folded before Flop (didn't bet)
Seat 5: VOmI0x4dDPnTESZd5B4d1Q folded before Flop (didn't bet)
Seat 6: f7zPpUQp9hHZgqhEvrUWQw (button) folded before Flop (didn't bet)



PokerStars Game #59938015300:  Hold'em No Limit ($0.25/$0.50) - 2009/07/01 0:05:04 ET
Table 'Vdlc9wqYcHTUhtdyN7CuJw' 2-max Seat #1 is the button
Seat 1: yBO+mXB6m/rCft2ErwGf/Q ($66 in chips)
Seat 2: sa0qgETiL3HNbdfGlnKHTA ($48.45 in chips)
yBO+mXB6m/rCft2ErwGf/Q: posts small blind $0.25
sa0qgETiL3HNbdfGlnKHTA: posts big blind $0.50
*** HOLE CARDS ***
yBO+mXB6m/rCft2ErwGf/Q: folds
sa0qgETiL3HNbdfGlnKHTA collected $0.50 from pot
sa0qgETiL3HNbdfGlnKHTA: doesn't show hand
*** SUMMARY ***
Total pot $0.50 | Rake $0
Seat 1: yBO+mXB6m/rCft2ErwGf/Q (button) (small blind) folded before Flop
Seat 2: sa0qgETiL3HNbdfGlnKHTA (big blind) collected ($0.50)



PokerStars Game #59938015260:  Hold'em No Limit ($0.25/$0.50) - 2009/07/01 0:05:04 ET
Table 'raOT4/ipuZgzjfKHC+jD9g' 2-max Seat #2 is the button
Seat 1: IuwLemwLhc9fvrwBGs0AMA ($12.20 in chips)
Seat 2: Udr5juWSWUgTu1NlRhjMdA ($11.80 in chips)
Udr5juWSWUgTu1NlRhjMdA: posts small blind $0.25
IuwLemwLhc9fvrwBGs0AMA: posts big blind $0.50
*** HOLE CARDS ***
Udr5juWSWUgTu1NlRhjMdA: raises $1 to $1.50
IuwLemwLhc9fvrwBGs0AMA: folds
Udr5juWSWUgTu1NlRhjMdA collected $1 from pot
Udr5juWSWUgTu1NlRhjMdA: doesn't show hand
*** SUMMARY ***
Total pot $1 | Rake $0
Seat 1: IuwLemwLhc9fvrwBGs0AMA (big blind) folded before Flop
Seat 2: Udr5juWSWUgTu1NlRhjMdA (button) (small blind) collected ($1)



PokerStars Game #59938015324:  Hold'em No Limit ($0.25/$0.50) - 2009/07/01 0:05:04 ET
Table 'EiNh8p/wGJ1FP575iMFnqg' 9-max Seat #3 is the button
Seat 1: r3ZqM1Mi0W3y4hOdssE+Sg ($43.25 in chips)
Seat 2: avsQkZXsRKnWa7gkjVNvog ($27.90 in chips)
Seat 3: GszS/McxOSUnOET7MBoHqA ($56.50 in chips)
Seat 4: pk8aA8qMBEL6zXqSyfVXMA ($80.30 in chips)
Seat 5: M+7+BTmX5vZatHVuoRB1nA ($93.50 in chips)
Seat 6: YPo1oggovmqSREegekaQYw ($14.75 in chips)
Seat 7: Wj7mKnRFR90j40wWUu2+Og ($26.90 in chips)
Seat 8: C7LqTSTGrMSBCecHvwQAOQ ($55.30 in chips)
Seat 9: OMwFJ4pF0xk2Ru/AJiFeFw ($72.90 in chips)
pk8aA8qMBEL6zXqSyfVXMA: posts small blind $0.25
M+7+BTmX5vZatHVuoRB1nA: posts big blind $0.50
*** HOLE CARDS ***
YPo1oggovmqSREegekaQYw: folds
Wj7mKnRFR90j40wWUu2+Og: folds
C7LqTSTGrMSBCecHvwQAOQ: raises $0.50 to $1
OMwFJ4pF0xk2Ru/AJiFeFw: folds
r3ZqM1Mi0W3y4hOdssE+Sg: folds
avsQkZXsRKnWa7gkjVNvog: folds
GszS/McxOSUnOET7MBoHqA: calls $1
pk8aA8qMBEL6zXqSyfVXMA: folds
M+7+BTmX5vZatHVuoRB1nA: calls $0.50
*** FLOP *** [2c 9d Ac]
M+7+BTmX5vZatHVuoRB1nA: checks
C7LqTSTGrMSBCecHvwQAOQ: folds
C7LqTSTGrMSBCecHvwQAOQ leaves the table
GszS/McxOSUnOET7MBoHqA: checks
*** TURN *** [2c 9d Ac] [3s]
M+7+BTmX5vZatHVuoRB1nA: checks
GszS/McxOSUnOET7MBoHqA: bets $1.50
M+7+BTmX5vZatHVuoRB1nA: folds
GszS/McxOSUnOET7MBoHqA collected $3.10 from pot
*** SUMMARY ***
Total pot $3.25 | Rake $0.15
Board [2c 9d Ac 3s]
Seat 1: r3ZqM1Mi0W3y4hOdssE+Sg folded before Flop (didn't bet)
Seat 2: avsQkZXsRKnWa7gkjVNvog folded before Flop (didn't bet)
Seat 3: GszS/McxOSUnOET7MBoHqA (button) collected ($3.10)
Seat 4: pk8aA8qMBEL6zXqSyfVXMA (small blind) folded before Flop
Seat 5: M+7+BTmX5vZatHVuoRB1nA (big blind) folded on the Turn
Seat 6: YPo1oggovmqSREegekaQYw folded before Flop (didn't bet)
Seat 7: Wj7mKnRFR90j40wWUu2+Og folded before Flop (didn't bet)
Seat 8: C7LqTSTGrMSBCecHvwQAOQ folded on the Flop
Seat 9: OMwFJ4pF0xk2Ru/AJiFeFw folded before Flop (didn't bet)



PokerStars Game #59938015824:  Hold'em No Limit ($0.25/$0.50) - 2009/07/01 0:05:05 ET
Table 'ibNfFy0bCzuBaUORla0aGw' 9-max Seat #7 is the button
Seat 1: xZCXQSXlrZkp3pZizzVXCw ($56.95 in chips)
Seat 2: 90Wb75h3W1BRpbqVnuk8gw ($50 in chips)
Seat 3: dDaHs3X8+fe3bIkRU0cbrw ($26.55 in chips)
Seat 4: YBN054X4blmis+B2bBlC0g ($22.20 in chips)
Seat 5: FRv75HO8CUsRZ1byEz06mQ ($15.35 in chips)
Seat 6: BmYrv3ec2k5d6pQq6iNaZw ($66.25 in chips)
Seat 7: mSD1pginDsyHG5PDfqzphw ($10 in chips)
Seat 8: xUrN9TWLq4m5V+OXY7KUUA ($50 in chips)
Seat 9: WpvT3OUSiZlpvs+mPXFqtQ ($9.50 in chips)
xUrN9TWLq4m5V+OXY7KUUA: posts small blind $0.25
WpvT3OUSiZlpvs+mPXFqtQ: posts big blind $0.50
*** HOLE CARDS ***
xZCXQSXlrZkp3pZizzVXCw: folds
90Wb75h3W1BRpbqVnuk8gw: folds
dDaHs3X8+fe3bIkRU0cbrw: raises $1 to $1.50
YBN054X4blmis+B2bBlC0g: folds
FRv75HO8CUsRZ1byEz06mQ: folds
BmYrv3ec2k5d6pQq6iNaZw: folds
YBN054X4blmis+B2bBlC0g is sitting out
mSD1pginDsyHG5PDfqzphw: folds
xUrN9TWLq4m5V+OXY7KUUA: folds
WpvT3OUSiZlpvs+mPXFqtQ: folds
dDaHs3X8+fe3bIkRU0cbrw collected $1.25 from pot
*** SUMMARY ***
Total pot $1.25 | Rake $0
Seat 1: xZCXQSXlrZkp3pZizzVXCw folded before Flop (didn't bet)
Seat 2: 90Wb75h3W1BRpbqVnuk8gw folded before Flop (didn't bet)
Seat 3: dDaHs3X8+fe3bIkRU0cbrw collected ($1.25)
Seat 4: YBN054X4blmis+B2bBlC0g folded before Flop (didn't bet)
Seat 5: FRv75HO8CUsRZ1byEz06mQ folded before Flop (didn't bet)
Seat 6: BmYrv3ec2k5d6pQq6iNaZw folded before Flop (didn't bet)
Seat 7: mSD1pginDsyHG5PDfqzphw (button) folded before Flop (didn't bet)
Seat 8: xUrN9TWLq4m5V+OXY7KUUA (small blind) folded before Flop
Seat 9: WpvT3OUSiZlpvs+mPXFqtQ (big blind) folded before Flop



PokerStars Game #59938015832:  Hold'em No Limit ($0.25/$0.50) - 2009/07/01 0:05:05 ET
Table 'eMxdLyFDf28E0wit6gm3Uw' 6-max Seat #5 is the button
Seat 1: tnD/64LagZ9qPaeOQVjVZg ($10.50 in chips)
Seat 2: jwuKQ1S3U4NnzMQn3E3dgw ($65.90 in chips)
Seat 4: crjGpJEzSZgD38FoE3VMGg ($50 in chips)
Seat 5: X0X97o2fDAPiGx6o1gahsw ($57.30 in chips)
Seat 6: L0aIPg7qefDQjdJo3HCVEA ($7.75 in chips)
L0aIPg7qefDQjdJo3HCVEA: posts small blind $0.25
tnD/64LagZ9qPaeOQVjVZg: posts big blind $0.50
*** HOLE CARDS ***
jwuKQ1S3U4NnzMQn3E3dgw: folds
crjGpJEzSZgD38FoE3VMGg: folds
X0X97o2fDAPiGx6o1gahsw: raises $1.50 to $2
L0aIPg7qefDQjdJo3HCVEA: folds
tnD/64LagZ9qPaeOQVjVZg: folds
X0X97o2fDAPiGx6o1gahsw collected $1.25 from pot
*** SUMMARY ***
Total pot $1.25 | Rake $0
Seat 1: tnD/64LagZ9qPaeOQVjVZg (big blind) folded before Flop
Seat 2: jwuKQ1S3U4NnzMQn3E3dgw folded before Flop (didn't bet)
Seat 4: crjGpJEzSZgD38FoE3VMGg folded before Flop (didn't bet)
Seat 5: X0X97o2fDAPiGx6o1gahsw (button) collected ($1.25)
Seat 6: L0aIPg7qefDQjdJo3HCVEA (small blind) folded before Flop



PokerStars Game #59938015654:  Hold'em No Limit ($0.25/$0.50) - 2009/07/01 0:05:05 ET
Table 'otvGDROEDdqsabxskT79qg' 9-max Seat #3 is the button
Seat 1: LM/g4VPDfD+0JhpH9Q/3fw ($26.55 in chips)
Seat 2: cCjTzH9jio8607WzjcfXlg ($51.10 in chips)
Seat 3: +k7T5ocke8UwavtgUHm+Cg ($52.35 in chips)
Seat 4: MG90wfSJZnOejs/KD3vlQQ ($50 in chips)
Seat 5: YPo1oggovmqSREegekaQYw ($12.25 in chips)
Seat 7: C7+tBppJrKgd/r+tuKUIpA ($41.25 in chips)
Seat 8: NnQCepdIR/AOUQn1yhYx6Q ($9.25 in chips)
Seat 9: KcY3X8YpD74Kw1RHkx/g4A ($39.35 in chips)
MG90wfSJZnOejs/KD3vlQQ: posts small blind $0.25
YPo1oggovmqSREegekaQYw: posts big blind $0.50
*** HOLE CARDS ***
C7+tBppJrKgd/r+tuKUIpA: calls $0.50
NnQCepdIR/AOUQn1yhYx6Q: folds
KcY3X8YpD74Kw1RHkx/g4A: calls $0.50
LM/g4VPDfD+0JhpH9Q/3fw: folds
cCjTzH9jio8607WzjcfXlg: calls $0.50
+k7T5ocke8UwavtgUHm+Cg: folds
MG90wfSJZnOejs/KD3vlQQ: calls $0.25
YPo1oggovmqSREegekaQYw: checks
*** FLOP *** [5s 7s 5c]
MG90wfSJZnOejs/KD3vlQQ: checks
YPo1oggovmqSREegekaQYw: checks
C7+tBppJrKgd/r+tuKUIpA: checks
KcY3X8YpD74Kw1RHkx/g4A: checks
cCjTzH9jio8607WzjcfXlg: bets $0.50
MG90wfSJZnOejs/KD3vlQQ: folds
YPo1oggovmqSREegekaQYw: folds
C7+tBppJrKgd/r+tuKUIpA: calls $0.50
KcY3X8YpD74Kw1RHkx/g4A: folds
*** TURN *** [5s 7s 5c] [Jh]
C7+tBppJrKgd/r+tuKUIpA: checks
cCjTzH9jio8607WzjcfXlg: bets $1
C7+tBppJrKgd/r+tuKUIpA: calls $1
*** RIVER *** [5s 7s 5c Jh] [Qs]
C7+tBppJrKgd/r+tuKUIpA: bets $2
cCjTzH9jio8607WzjcfXlg: calls $2
*** SHOW DOWN ***
C7+tBppJrKgd/r+tuKUIpA: shows [As 4s] (a flush, Ace high)
cCjTzH9jio8607WzjcfXlg: mucks hand
C7+tBppJrKgd/r+tuKUIpA collected $9.05 from pot
*** SUMMARY ***
Total pot $9.50 | Rake $0.45
Board [5s 7s 5c Jh Qs]
Seat 1: LM/g4VPDfD+0JhpH9Q/3fw folded before Flop (didn't bet)
Seat 2: cCjTzH9jio8607WzjcfXlg mucked
Seat 3: +k7T5ocke8UwavtgUHm+Cg (button) folded before Flop (didn't bet)
Seat 4: MG90wfSJZnOejs/KD3vlQQ (small blind) folded on the Flop
Seat 5: YPo1oggovmqSREegekaQYw (big blind) folded on the Flop
Seat 7: C7+tBppJrKgd/r+tuKUIpA showed [As 4s] and won ($9.05) with a flush, Ace high
Seat 8: NnQCepdIR/AOUQn1yhYx6Q folded before Flop (didn't bet)
Seat 9: KcY3X8YpD74Kw1RHkx/g4A folded on the Flop



PokerStars Game #59938017558:  Hold'em No Limit ($0.25/$0.50) - 2009/07/01 0:05:08 ET
Table 'tyR5AZNKV8Aadbrnrnlg7g' 6-max Seat #4 is the button
Seat 1: R+KjpH/wSjDLhtIy9+edNA ($37.35 in chips)
Seat 2: 58zdeSBSuSFX/qZfhc7YmA ($32 in chips)
Seat 3: jUhx+m+V7qfbLZTjgwZByg ($45.25 in chips)
Seat 4: Rt6KgtZ8YaJoTc3FPim00w ($50 in chips)
Seat 5: EIg3r3fRFKG2HhgpDlIJHg ($10.55 in chips)
Seat 6: DMQLAmut/l19xN5STQndFg ($21.45 in chips)
EIg3r3fRFKG2HhgpDlIJHg: posts small blind $0.25
DMQLAmut/l19xN5STQndFg: posts big blind $0.50
*** HOLE CARDS ***
R+KjpH/wSjDLhtIy9+edNA: folds
58zdeSBSuSFX/qZfhc7YmA: calls $0.50
jUhx+m+V7qfbLZTjgwZByg: folds
Rt6KgtZ8YaJoTc3FPim00w: folds
EIg3r3fRFKG2HhgpDlIJHg: calls $0.25
DMQLAmut/l19xN5STQndFg: checks
*** FLOP *** [Jd 5d 8d]
EIg3r3fRFKG2HhgpDlIJHg: checks
DMQLAmut/l19xN5STQndFg: checks
58zdeSBSuSFX/qZfhc7YmA: bets $2
EIg3r3fRFKG2HhgpDlIJHg: folds
DMQLAmut/l19xN5STQndFg: folds
58zdeSBSuSFX/qZfhc7YmA collected $1.45 from pot
*** SUMMARY ***
Total pot $1.50 | Rake $0.05
Board [Jd 5d 8d]
Seat 1: R+KjpH/wSjDLhtIy9+edNA folded before Flop (didn't bet)
Seat 2: 58zdeSBSuSFX/qZfhc7YmA collected ($1.45)
Seat 3: jUhx+m+V7qfbLZTjgwZByg folded before Flop (didn't bet)
Seat 4: Rt6KgtZ8YaJoTc3FPim00w (button) folded before Flop (didn't bet)
Seat 5: EIg3r3fRFKG2HhgpDlIJHg (small blind) folded on the Flop
Seat 6: DMQLAmut/l19xN5STQndFg (big blind) folded on the Flop



PokerStars Game #59938018444:  Hold'em No Limit ($0.25/$0.50) - 2009/07/01 0:05:09 ET
Table '0AhP5FLi4ySROVJ/ycT1Qw' 2-max Seat #2 is the button
Seat 1: VzCjk9xTOs+nLWp67vramg ($64.25 in chips)
Seat 2: 46qCyJ6evTkHo9al5sBMNA ($146.45 in chips)
46qCyJ6evTkHo9al5sBMNA: posts small blind $0.25
VzCjk9xTOs+nLWp67vramg: posts big blind $0.50
*** HOLE CARDS ***
46qCyJ6evTkHo9al5sBMNA: raises $1 to $1.50
VzCjk9xTOs+nLWp67vramg: calls $1
*** FLOP *** [Ad 7h 9s]
VzCjk9xTOs+nLWp67vramg: checks
46qCyJ6evTkHo9al5sBMNA: checks
*** TURN *** [Ad 7h 9s] [3s]
VzCjk9xTOs+nLWp67vramg: checks
46qCyJ6evTkHo9al5sBMNA: bets $2
VzCjk9xTOs+nLWp67vramg: folds
46qCyJ6evTkHo9al5sBMNA collected $2.85 from pot
46qCyJ6evTkHo9al5sBMNA: doesn't show hand
*** SUMMARY ***
Total pot $3 | Rake $0.15
Board [Ad 7h 9s 3s]
Seat 1: VzCjk9xTOs+nLWp67vramg (big blind) folded on the Turn
Seat 2: 46qCyJ6evTkHo9al5sBMNA (button) (small blind) collected ($2.85)



PokerStars Game #59938021286:  Hold'em No Limit ($0.25/$0.50) - 2009/07/01 0:05:13 ET
Table 'E7bWJ45aoFXRpyRv2gw+Ig' 2-max Seat #1 is the button
Seat 1: FRkiRasEGlHUeLrEl+k/nA ($66.85 in chips)
Seat 2: 3Wro85I7472vJ4Wkpneo9A ($58.25 in chips)
FRkiRasEGlHUeLrEl+k/nA: posts small blind $0.25
3Wro85I7472vJ4Wkpneo9A: posts big blind $0.50
*** HOLE CARDS ***
FRkiRasEGlHUeLrEl+k/nA: calls $0.25
3Wro85I7472vJ4Wkpneo9A: checks
*** FLOP *** [4h 3c Th]
3Wro85I7472vJ4Wkpneo9A: checks
FRkiRasEGlHUeLrEl+k/nA: bets $1
3Wro85I7472vJ4Wkpneo9A: folds
FRkiRasEGlHUeLrEl+k/nA collected $0.95 from pot
FRkiRasEGlHUeLrEl+k/nA: doesn't show hand
*** SUMMARY ***
Total pot $1 | Rake $0.05
Board [4h 3c Th]
Seat 1: FRkiRasEGlHUeLrEl+k/nA (button) (small blind) collected ($0.95)
Seat 2: 3Wro85I7472vJ4Wkpneo9A (big blind) folded on the Flop



PokerStars Game #59938021118:  Hold'em No Limit ($0.25/$0.50) - 2009/07/01 0:05:13 ET
Table 'Vdlc9wqYcHTUhtdyN7CuJw' 2-max Seat #2 is the button
Seat 1: yBO+mXB6m/rCft2ErwGf/Q ($65.75 in chips)
Seat 2: sa0qgETiL3HNbdfGlnKHTA ($48.70 in chips)
sa0qgETiL3HNbdfGlnKHTA: posts small blind $0.25
yBO+mXB6m/rCft2ErwGf/Q: posts big blind $0.50
*** HOLE CARDS ***
sa0qgETiL3HNbdfGlnKHTA: raises $1 to $1.50
yBO+mXB6m/rCft2ErwGf/Q: folds
sa0qgETiL3HNbdfGlnKHTA collected $1 from pot
sa0qgETiL3HNbdfGlnKHTA: doesn't show hand
*** SUMMARY ***
Total pot $1 | Rake $0
Seat 1: yBO+mXB6m/rCft2ErwGf/Q (big blind) folded before Flop
Seat 2: sa0qgETiL3HNbdfGlnKHTA (button) (small blind) collected ($1)



PokerStars Game #59938021288:  Hold'em No Limit ($0.25/$0.50) - 2009/07/01 0:05:13 ET
Table '+z1aekfHkpp09pc8F9aViw' 6-max Seat #2 is the button
Seat 1: lWwl5C/UZOsWNubdUqghZw ($50 in chips)
Seat 2: VuB2GN0h94yY+QbuI2Mybg ($24.45 in chips)
Seat 3: uUznlIMFnRUvwrBhYF73KA ($62.95 in chips)
Seat 4: OCrv7ObFH4/s2lv7rYOnsQ ($16.45 in chips)
Seat 5: crjGpJEzSZgD38FoE3VMGg ($62.90 in chips)
Seat 6: 686aeHikcJlgKkSuIFdcXQ ($67.90 in chips)
uUznlIMFnRUvwrBhYF73KA: posts small blind $0.25
OCrv7ObFH4/s2lv7rYOnsQ: posts big blind $0.50
*** HOLE CARDS ***
crjGpJEzSZgD38FoE3VMGg: folds
686aeHikcJlgKkSuIFdcXQ: folds
lWwl5C/UZOsWNubdUqghZw: folds
VuB2GN0h94yY+QbuI2Mybg: calls $0.50
uUznlIMFnRUvwrBhYF73KA: calls $0.25
OCrv7ObFH4/s2lv7rYOnsQ: checks
*** FLOP *** [9c 4h 3d]
uUznlIMFnRUvwrBhYF73KA: bets $1.50
OCrv7ObFH4/s2lv7rYOnsQ: calls $1.50
VuB2GN0h94yY+QbuI2Mybg: folds
*** TURN *** [9c 4h 3d] [9h]
uUznlIMFnRUvwrBhYF73KA: bets $3
OCrv7ObFH4/s2lv7rYOnsQ: calls $3
*** RIVER *** [9c 4h 3d 9h] [2c]
uUznlIMFnRUvwrBhYF73KA: bets $3
OCrv7ObFH4/s2lv7rYOnsQ: raises $8.45 to $11.45 and is all-in
uUznlIMFnRUvwrBhYF73KA: folds
OCrv7ObFH4/s2lv7rYOnsQ collected $15.70 from pot
*** SUMMARY ***
Total pot $16.50 | Rake $0.80
Board [9c 4h 3d 9h 2c]
Seat 1: lWwl5C/UZOsWNubdUqghZw folded before Flop (didn't bet)
Seat 2: VuB2GN0h94yY+QbuI2Mybg (button) folded on the Flop
Seat 3: uUznlIMFnRUvwrBhYF73KA (small blind) folded on the River
Seat 4: OCrv7ObFH4/s2lv7rYOnsQ (big blind) collected ($15.70)
Seat 5: crjGpJEzSZgD38FoE3VMGg folded before Flop (didn't bet)
Seat 6: 686aeHikcJlgKkSuIFdcXQ folded before Flop (didn't bet)



PokerStars Game #59938022514:  Hold'em No Limit ($0.25/$0.50) - 2009/07/01 0:05:14 ET
Table '+dXkOAQyS8j9PQZusUTMpg' 2-max Seat #2 is the button
Seat 1: XFa6sBGjP2gxoIvxR3fZIg ($89.80 in chips)
Seat 2: 5IBeOgaApY1Bvzv2P8X4EA ($26.30 in chips)
5IBeOgaApY1Bvzv2P8X4EA: posts small blind $0.25
XFa6sBGjP2gxoIvxR3fZIg: posts big blind $0.50
*** HOLE CARDS ***
5IBeOgaApY1Bvzv2P8X4EA: raises $1 to $1.50
XFa6sBGjP2gxoIvxR3fZIg: folds
5IBeOgaApY1Bvzv2P8X4EA collected $1 from pot
5IBeOgaApY1Bvzv2P8X4EA: doesn't show hand
*** SUMMARY ***
Total pot $1 | Rake $0
Seat 1: XFa6sBGjP2gxoIvxR3fZIg (big blind) folded before Flop
Seat 2: 5IBeOgaApY1Bvzv2P8X4EA (button) (small blind) collected ($1)



PokerStars Game #59938022772:  Hold'em No Limit ($0.25/$0.50) - 2009/07/01 0:05:15 ET
Table 'raOT4/ipuZgzjfKHC+jD9g' 2-max Seat #1 is the button
Seat 1: IuwLemwLhc9fvrwBGs0AMA ($11.70 in chips)
Seat 2: Udr5juWSWUgTu1NlRhjMdA ($12.30 in chips)
IuwLemwLhc9fvrwBGs0AMA: posts small blind $0.25
Udr5juWSWUgTu1NlRhjMdA: posts big blind $0.50
*** HOLE CARDS ***
IuwLemwLhc9fvrwBGs0AMA: raises $0.50 to $1
Udr5juWSWUgTu1NlRhjMdA: folds
IuwLemwLhc9fvrwBGs0AMA collected $1 from pot
*** SUMMARY ***
Total pot $1 | Rake $0
Seat 1: IuwLemwLhc9fvrwBGs0AMA (button) (small blind) collected ($1)
Seat 2: Udr5juWSWUgTu1NlRhjMdA (big blind) folded before Flop



PokerStars Game #59938023066:  Hold'em No Limit ($0.25/$0.50) - 2009/07/01 0:05:15 ET
Table 'GfL/No5u5PoEnU39lP5pQg' 6-max Seat #4 is the button
Seat 1: T0Gx/FcQ5VH9u7XaOMX97A ($52.90 in chips)
Seat 2: uVwggSetzp7d+eVgowO3vg ($19.50 in chips)
Seat 3: YmWlPGOKFuJSoJZPW8a8IA ($99.45 in chips)
Seat 4: yqM0AD7MZQd/cEtKdDQY1A ($33.90 in chips)
T0Gx/FcQ5VH9u7XaOMX97A: posts small blind $0.25
uVwggSetzp7d+eVgowO3vg: posts big blind $0.50
*** HOLE CARDS ***
YmWlPGOKFuJSoJZPW8a8IA: folds
yqM0AD7MZQd/cEtKdDQY1A: calls $0.50
T0Gx/FcQ5VH9u7XaOMX97A: folds
uVwggSetzp7d+eVgowO3vg: checks
*** FLOP *** [3s Qs Jd]
T0Gx/FcQ5VH9u7XaOMX97A leaves the table
uVwggSetzp7d+eVgowO3vg: checks
yqM0AD7MZQd/cEtKdDQY1A: bets $1
uVwggSetzp7d+eVgowO3vg: folds
yqM0AD7MZQd/cEtKdDQY1A collected $1.20 from pot
*** SUMMARY ***
Total pot $1.25 | Rake $0.05
Board [3s Qs Jd]
Seat 1: T0Gx/FcQ5VH9u7XaOMX97A (small blind) folded before Flop
Seat 2: uVwggSetzp7d+eVgowO3vg (big blind) folded on the Flop
Seat 3: YmWlPGOKFuJSoJZPW8a8IA folded before Flop (didn't bet)
Seat 4: yqM0AD7MZQd/cEtKdDQY1A (button) collected ($1.20)



PokerStars Game #59938024968:  Hold'em No Limit ($0.25/$0.50) - 2009/07/01 0:05:18 ET
Table 'MJxeZCzYELxiIsyUZyT0jw' 6-max Seat #4 is the button
Seat 1: iKPos8JI094Tomq4tDSgnQ ($27.80 in chips)
Seat 2: r6H1GiZ6QIpMTDhyodKuRQ ($65.65 in chips)
Seat 3: JQZew0FjzS19kTjeNtrE+A ($51.85 in chips)
Seat 4: lP7Q6pewz4C2RsAfKsjdWw ($24.55 in chips)
Seat 5: 3jvoOXNtXE90w2BdfNZwZQ ($50 in chips)
Seat 6: TTx3CHxyi0SObcHyMJRp5w ($41.70 in chips)
3jvoOXNtXE90w2BdfNZwZQ: posts small blind $0.25
TTx3CHxyi0SObcHyMJRp5w: posts big blind $0.50
*** HOLE CARDS ***
iKPos8JI094Tomq4tDSgnQ: calls $0.50
r6H1GiZ6QIpMTDhyodKuRQ: folds
JQZew0FjzS19kTjeNtrE+A: folds
lP7Q6pewz4C2RsAfKsjdWw: folds
3jvoOXNtXE90w2BdfNZwZQ: calls $0.25
TTx3CHxyi0SObcHyMJRp5w: checks
*** FLOP *** [3s 2h 2c]
3jvoOXNtXE90w2BdfNZwZQ: checks
TTx3CHxyi0SObcHyMJRp5w: checks
iKPos8JI094Tomq4tDSgnQ: checks
*** TURN *** [3s 2h 2c] [3c]
3jvoOXNtXE90w2BdfNZwZQ: checks
TTx3CHxyi0SObcHyMJRp5w: checks
iKPos8JI094Tomq4tDSgnQ: bets $1
3jvoOXNtXE90w2BdfNZwZQ: folds
TTx3CHxyi0SObcHyMJRp5w: folds
iKPos8JI094Tomq4tDSgnQ collected $1.45 from pot
*** SUMMARY ***
Total pot $1.50 | Rake $0.05
Board [3s 2h 2c 3c]
Seat 1: iKPos8JI094Tomq4tDSgnQ collected ($1.45)
Seat 2: r6H1GiZ6QIpMTDhyodKuRQ folded before Flop (didn't bet)
Seat 3: JQZew0FjzS19kTjeNtrE+A folded before Flop (didn't bet)
Seat 4: lP7Q6pewz4C2RsAfKsjdWw (button) folded before Flop (didn't bet)
Seat 5: 3jvoOXNtXE90w2BdfNZwZQ (small blind) folded on the Turn
Seat 6: TTx3CHxyi0SObcHyMJRp5w (big blind) folded on the Turn



PokerStars Game #59938025122:  Hold'em No Limit ($0.25/$0.50) - 2009/07/01 0:05:18 ET
Table 'tpZbcIvqh/6WmfR/i5IE3A' 9-max Seat #5 is the button
Seat 1: nV/P1jFY/CFMXOLWu7pYmA ($14.45 in chips)
Seat 2: M+7+BTmX5vZatHVuoRB1nA ($45.90 in chips)
Seat 3: 3w0FbBQAKwQODwenKwZxXw ($76.95 in chips)
Seat 4: zE9cVigS2nW/Ljy4K4bUQA ($30 in chips)
Seat 5: 9r7ZoBbAJj5IeyZ0q9BdzA ($11.95 in chips)
Seat 6: E2518gp4aFz1+kAgmGqeEg ($11.70 in chips)
Seat 7: wIZ377kjl2fHFGnS93o6bw ($14.45 in chips)
Seat 8: bXpVeaSTPBFSPJmeXxO7nw ($10.60 in chips)
E2518gp4aFz1+kAgmGqeEg: posts small blind $0.25
wIZ377kjl2fHFGnS93o6bw: posts big blind $0.50
*** HOLE CARDS ***
bXpVeaSTPBFSPJmeXxO7nw: folds
nV/P1jFY/CFMXOLWu7pYmA: folds
M+7+BTmX5vZatHVuoRB1nA: folds
3w0FbBQAKwQODwenKwZxXw: folds
zE9cVigS2nW/Ljy4K4bUQA: folds
9r7ZoBbAJj5IeyZ0q9BdzA: calls $0.50
E2518gp4aFz1+kAgmGqeEg: calls $0.25
wIZ377kjl2fHFGnS93o6bw: checks
*** FLOP *** [Js 8s Qh]
E2518gp4aFz1+kAgmGqeEg: checks
wIZ377kjl2fHFGnS93o6bw: checks
9r7ZoBbAJj5IeyZ0q9BdzA: bets $1
E2518gp4aFz1+kAgmGqeEg: folds
wIZ377kjl2fHFGnS93o6bw: folds
9r7ZoBbAJj5IeyZ0q9BdzA collected $1.45 from pot
*** SUMMARY ***
Total pot $1.50 | Rake $0.05
Board [Js 8s Qh]
Seat 1: nV/P1jFY/CFMXOLWu7pYmA folded before Flop (didn't bet)
Seat 2: M+7+BTmX5vZatHVuoRB1nA folded before Flop (didn't bet)
Seat 3: 3w0FbBQAKwQODwenKwZxXw folded before Flop (didn't bet)
Seat 4: zE9cVigS2nW/Ljy4K4bUQA folded before Flop (didn't bet)
Seat 5: 9r7ZoBbAJj5IeyZ0q9BdzA (button) collected ($1.45)
Seat 6: E2518gp4aFz1+kAgmGqeEg (small blind) folded on the Flop
Seat 7: wIZ377kjl2fHFGnS93o6bw (big blind) folded on the Flop
Seat 8: bXpVeaSTPBFSPJmeXxO7nw folded before Flop (didn't bet)



PokerStars Game #59938026142:  Hold'em No Limit ($0.25/$0.50) - 2009/07/01 0:05:19 ET
Table 'YsnnHkamRzYqMOr2FlLY4w' 6-max Seat #3 is the button
Seat 1: crjGpJEzSZgD38FoE3VMGg ($50 in chips)
Seat 2: 2dIa62hMcn6g73rbkt9NwA ($62.35 in chips)
Seat 3: I+pG2m/dD5iYdbg9qx572g ($25 in chips)
Seat 4: 7Fue572p4ZIC85AJMQvaQw ($52.45 in chips)
Seat 5: lcQ7uuLf+WLGGy4Ve6VKKA ($46.50 in chips)
Seat 6: YmWlPGOKFuJSoJZPW8a8IA ($50 in chips)
7Fue572p4ZIC85AJMQvaQw: posts small blind $0.25
lcQ7uuLf+WLGGy4Ve6VKKA: posts big blind $0.50
*** HOLE CARDS ***
YmWlPGOKFuJSoJZPW8a8IA: folds
crjGpJEzSZgD38FoE3VMGg: folds
2dIa62hMcn6g73rbkt9NwA: folds
I+pG2m/dD5iYdbg9qx572g: folds
7Fue572p4ZIC85AJMQvaQw: calls $0.25
lcQ7uuLf+WLGGy4Ve6VKKA: checks
*** FLOP *** [5h Js 8s]
7Fue572p4ZIC85AJMQvaQw: checks
lcQ7uuLf+WLGGy4Ve6VKKA: bets $1
7Fue572p4ZIC85AJMQvaQw: calls $1
*** TURN *** [5h Js 8s] [6s]
7Fue572p4ZIC85AJMQvaQw: checks
lcQ7uuLf+WLGGy4Ve6VKKA: checks
*** RIVER *** [5h Js 8s 6s] [9s]
7Fue572p4ZIC85AJMQvaQw: checks
2dIa62hMcn6g73rbkt9NwA leaves the table
lcQ7uuLf+WLGGy4Ve6VKKA: checks
*** SHOW DOWN ***
7Fue572p4ZIC85AJMQvaQw: shows [3s Qs] (a flush, Queen high)
lcQ7uuLf+WLGGy4Ve6VKKA: mucks hand
7Fue572p4ZIC85AJMQvaQw collected $2.90 from pot
*** SUMMARY ***
Total pot $3 | Rake $0.10
Board [5h Js 8s 6s 9s]
Seat 1: crjGpJEzSZgD38FoE3VMGg folded before Flop (didn't bet)
Seat 2: 2dIa62hMcn6g73rbkt9NwA folded before Flop (didn't bet)
Seat 3: I+pG2m/dD5iYdbg9qx572g (button) folded before Flop (didn't bet)
Seat 4: 7Fue572p4ZIC85AJMQvaQw (small blind) showed [3s Qs] and won ($2.90) with a flush, Queen high
Seat 5: lcQ7uuLf+WLGGy4Ve6VKKA (big blind) mucked
Seat 6: YmWlPGOKFuJSoJZPW8a8IA folded before Flop (didn't bet)



PokerStars Game #59938027566:  Hold'em No Limit ($0.25/$0.50) - 2009/07/01 0:05:21 ET
Table 'mTxf8gPLgffN3Iwfm7Icfg' 2-max Seat #2 is the button
Seat 1: Do9Rlu1R5u/AcRtMTl8SYg ($73.15 in chips)
Seat 2: EMc5LPgVaded4Qc77vm0fw ($41.90 in chips)
EMc5LPgVaded4Qc77vm0fw: posts small blind $0.25
Do9Rlu1R5u/AcRtMTl8SYg: posts big blind $0.50
*** HOLE CARDS ***
EMc5LPgVaded4Qc77vm0fw: raises $1 to $1.50
Do9Rlu1R5u/AcRtMTl8SYg: folds
EMc5LPgVaded4Qc77vm0fw collected $1 from pot
EMc5LPgVaded4Qc77vm0fw: doesn't show hand
*** SUMMARY ***
Total pot $1 | Rake $0
Seat 1: Do9Rlu1R5u/AcRtMTl8SYg (big blind) folded before Flop
Seat 2: EMc5LPgVaded4Qc77vm0fw (button) (small blind) collected ($1)



PokerStars Game #59938027084:  Hold'em No Limit ($0.25/$0.50) - 2009/07/01 0:05:21 ET
Table 'NCiXr0d5CEKBQr/cZgLhbA' 9-max Seat #8 is the button
Seat 1: RjBdQ6w31rgcy0o24VLR6w ($9.25 in chips)
Seat 2: ulxuJchBV9iguXg0FUonfg ($34.90 in chips)
Seat 3: xZCXQSXlrZkp3pZizzVXCw ($55.65 in chips)
Seat 4: CL4d+tvzcd4utdQxlPLOmg ($30.40 in chips)
Seat 5: zE9cVigS2nW/Ljy4K4bUQA ($32.70 in chips)
Seat 6: SKnJuWHScqetA/qG5p+wCg ($31.80 in chips)
Seat 7: EltNhVR1POPXhu/1E62t3A ($7.25 in chips)
Seat 8: E2518gp4aFz1+kAgmGqeEg ($10.95 in chips)
Seat 9: WpvT3OUSiZlpvs+mPXFqtQ ($6.95 in chips)
WpvT3OUSiZlpvs+mPXFqtQ: posts small blind $0.25
RjBdQ6w31rgcy0o24VLR6w: posts big blind $0.50
*** HOLE CARDS ***
ulxuJchBV9iguXg0FUonfg: folds
xZCXQSXlrZkp3pZizzVXCw: folds
CL4d+tvzcd4utdQxlPLOmg: folds
zE9cVigS2nW/Ljy4K4bUQA: folds
SKnJuWHScqetA/qG5p+wCg: folds
EltNhVR1POPXhu/1E62t3A: folds
E2518gp4aFz1+kAgmGqeEg: folds
WpvT3OUSiZlpvs+mPXFqtQ: raises $6.45 to $6.95 and is all-in
RjBdQ6w31rgcy0o24VLR6w: folds
WpvT3OUSiZlpvs+mPXFqtQ collected $1 from pot
*** SUMMARY ***
Total pot $1 | Rake $0
Seat 1: RjBdQ6w31rgcy0o24VLR6w (big blind) folded before Flop
Seat 2: ulxuJchBV9iguXg0FUonfg folded before Flop (didn't bet)
Seat 3: xZCXQSXlrZkp3pZizzVXCw folded before Flop (didn't bet)
Seat 4: CL4d+tvzcd4utdQxlPLOmg folded before Flop (didn't bet)
Seat 5: zE9cVigS2nW/Ljy4K4bUQA folded before Flop (didn't bet)
Seat 6: SKnJuWHScqetA/qG5p+wCg folded before Flop (didn't bet)
Seat 7: EltNhVR1POPXhu/1E62t3A folded before Flop (didn't bet)
Seat 8: E2518gp4aFz1+kAgmGqeEg (button) folded before Flop (didn't bet)
Seat 9: WpvT3OUSiZlpvs+mPXFqtQ (small blind) collected ($1)



PokerStars Game #59938027656:  Hold'em No Limit ($0.25/$0.50) - 2009/07/01 0:05:22 ET
Table 'Vdlc9wqYcHTUhtdyN7CuJw' 2-max Seat #1 is the button
Seat 1: yBO+mXB6m/rCft2ErwGf/Q ($65.25 in chips)
Seat 2: sa0qgETiL3HNbdfGlnKHTA ($49.20 in chips)
yBO+mXB6m/rCft2ErwGf/Q: posts small blind $0.25
sa0qgETiL3HNbdfGlnKHTA: posts big blind $0.50
*** HOLE CARDS ***
yBO+mXB6m/rCft2ErwGf/Q: folds
sa0qgETiL3HNbdfGlnKHTA collected $0.50 from pot
sa0qgETiL3HNbdfGlnKHTA: doesn't show hand
*** SUMMARY ***
Total pot $0.50 | Rake $0
Seat 1: yBO+mXB6m/rCft2ErwGf/Q (button) (small blind) folded before Flop
Seat 2: sa0qgETiL3HNbdfGlnKHTA (big blind) collected ($0.50)



PokerStars Game #59938028694:  Hold'em No Limit ($0.25/$0.50) - 2009/07/01 0:05:23 ET
Table '+dXkOAQyS8j9PQZusUTMpg' 2-max Seat #1 is the button
Seat 1: XFa6sBGjP2gxoIvxR3fZIg ($89.30 in chips)
Seat 2: 5IBeOgaApY1Bvzv2P8X4EA ($26.80 in chips)
XFa6sBGjP2gxoIvxR3fZIg: posts small blind $0.25
5IBeOgaApY1Bvzv2P8X4EA: posts big blind $0.50
*** HOLE CARDS ***
XFa6sBGjP2gxoIvxR3fZIg: raises $1 to $1.50
5IBeOgaApY1Bvzv2P8X4EA: raises $3 to $4.50
XFa6sBGjP2gxoIvxR3fZIg: calls $3
*** FLOP *** [As 4d Ah]
5IBeOgaApY1Bvzv2P8X4EA: checks
XFa6sBGjP2gxoIvxR3fZIg: checks
*** TURN *** [As 4d Ah] [4c]
5IBeOgaApY1Bvzv2P8X4EA: checks
XFa6sBGjP2gxoIvxR3fZIg: checks
*** RIVER *** [As 4d Ah 4c] [3c]
5IBeOgaApY1Bvzv2P8X4EA: bets $2
XFa6sBGjP2gxoIvxR3fZIg: folds
5IBeOgaApY1Bvzv2P8X4EA collected $8.55 from pot
5IBeOgaApY1Bvzv2P8X4EA: doesn't show hand
*** SUMMARY ***
Total pot $9 | Rake $0.45
Board [As 4d Ah 4c 3c]
Seat 1: XFa6sBGjP2gxoIvxR3fZIg (button) (small blind) folded on the River
Seat 2: 5IBeOgaApY1Bvzv2P8X4EA (big blind) collected ($8.55)



PokerStars Game #59938029732:  Hold'em No Limit ($0.25/$0.50) - 2009/07/01 0:05:24 ET
Table 'lSisgp6H7Fg1hH5VfjEjYQ' 9-max Seat #4 is the button
Seat 1: pEW8B6uXbdR47kfljMQ3+Q ($40.45 in chips)
Seat 2: UrcnkQOiLVk8BlKDPJSy7Q ($53.85 in chips)
Seat 3: RjBdQ6w31rgcy0o24VLR6w ($13.15 in chips)
Seat 4: nvw9yQKhJT56lA9k+TLdhw ($9.90 in chips)
Seat 5: mSD1pginDsyHG5PDfqzphw ($11.35 in chips)
Seat 6: +k7T5ocke8UwavtgUHm+Cg ($30 in chips)
Seat 7: xyQ4CeZa3ug3ompz+5xSTg ($74.70 in chips)
Seat 9: 5JJVDlaiMnB004o/RqbZZQ ($28.50 in chips)
mSD1pginDsyHG5PDfqzphw: posts small blind $0.25
+k7T5ocke8UwavtgUHm+Cg: posts big blind $0.50
bXpVeaSTPBFSPJmeXxO7nw: sits out
*** HOLE CARDS ***
xyQ4CeZa3ug3ompz+5xSTg: folds
5JJVDlaiMnB004o/RqbZZQ: folds
pEW8B6uXbdR47kfljMQ3+Q: folds
UrcnkQOiLVk8BlKDPJSy7Q: folds
RjBdQ6w31rgcy0o24VLR6w: folds
nvw9yQKhJT56lA9k+TLdhw: raises $1.50 to $2
mSD1pginDsyHG5PDfqzphw: folds
+k7T5ocke8UwavtgUHm+Cg: calls $1.50
*** FLOP *** [Qs 8d 7d]
+k7T5ocke8UwavtgUHm+Cg: checks
nvw9yQKhJT56lA9k+TLdhw: bets $2
+k7T5ocke8UwavtgUHm+Cg: folds
nvw9yQKhJT56lA9k+TLdhw collected $4.05 from pot
*** SUMMARY ***
Total pot $4.25 | Rake $0.20
Board [Qs 8d 7d]
Seat 1: pEW8B6uXbdR47kfljMQ3+Q folded before Flop (didn't bet)
Seat 2: UrcnkQOiLVk8BlKDPJSy7Q folded before Flop (didn't bet)
Seat 3: RjBdQ6w31rgcy0o24VLR6w folded before Flop (didn't bet)
Seat 4: nvw9yQKhJT56lA9k+TLdhw (button) collected ($4.05)
Seat 5: mSD1pginDsyHG5PDfqzphw (small blind) folded before Flop
Seat 6: +k7T5ocke8UwavtgUHm+Cg (big blind) folded on the Flop
Seat 7: xyQ4CeZa3ug3ompz+5xSTg folded before Flop (didn't bet)
Seat 9: 5JJVDlaiMnB004o/RqbZZQ folded before Flop (didn't bet)



PokerStars Game #59938030274:  Hold'em No Limit ($0.25/$0.50) - 2009/07/01 0:05:25 ET
Table 'raOT4/ipuZgzjfKHC+jD9g' 2-max Seat #2 is the button
Seat 1: IuwLemwLhc9fvrwBGs0AMA ($12.20 in chips)
Seat 2: Udr5juWSWUgTu1NlRhjMdA ($11.80 in chips)
Udr5juWSWUgTu1NlRhjMdA: posts small blind $0.25
IuwLemwLhc9fvrwBGs0AMA: posts big blind $0.50
*** HOLE CARDS ***
Udr5juWSWUgTu1NlRhjMdA: calls $0.25
IuwLemwLhc9fvrwBGs0AMA: checks
*** FLOP *** [Th 7c 9s]
IuwLemwLhc9fvrwBGs0AMA: checks
Udr5juWSWUgTu1NlRhjMdA: checks
*** TURN *** [Th 7c 9s] [5s]
IuwLemwLhc9fvrwBGs0AMA: checks
Udr5juWSWUgTu1NlRhjMdA: checks
*** RIVER *** [Th 7c 9s 5s] [9c]
IuwLemwLhc9fvrwBGs0AMA: bets $1
Udr5juWSWUgTu1NlRhjMdA: folds
IuwLemwLhc9fvrwBGs0AMA collected $0.95 from pot
*** SUMMARY ***
Total pot $1 | Rake $0.05
Board [Th 7c 9s 5s 9c]
Seat 1: IuwLemwLhc9fvrwBGs0AMA (big blind) collected ($0.95)
Seat 2: Udr5juWSWUgTu1NlRhjMdA (button) (small blind) folded on the River



PokerStars Game #59938032510:  Hold'em No Limit ($0.25/$0.50) - 2009/07/01 0:05:28 ET
Table 'E7bWJ45aoFXRpyRv2gw+Ig' 2-max Seat #2 is the button
Seat 1: FRkiRasEGlHUeLrEl+k/nA ($67.30 in chips)
Seat 2: 3Wro85I7472vJ4Wkpneo9A ($57.75 in chips)
3Wro85I7472vJ4Wkpneo9A: posts small blind $0.25
FRkiRasEGlHUeLrEl+k/nA: posts big blind $0.50
*** HOLE CARDS ***
3Wro85I7472vJ4Wkpneo9A: calls $0.25
FRkiRasEGlHUeLrEl+k/nA: checks
*** FLOP *** [9c Tc Th]
FRkiRasEGlHUeLrEl+k/nA: checks
3Wro85I7472vJ4Wkpneo9A: checks
*** TURN *** [9c Tc Th] [5d]
FRkiRasEGlHUeLrEl+k/nA: checks
3Wro85I7472vJ4Wkpneo9A: checks
*** RIVER *** [9c Tc Th 5d] [5c]
FRkiRasEGlHUeLrEl+k/nA: checks
3Wro85I7472vJ4Wkpneo9A: checks
*** SHOW DOWN ***
FRkiRasEGlHUeLrEl+k/nA: shows [6h Qh] (two pair, Tens and Fives)
3Wro85I7472vJ4Wkpneo9A: shows [Ks 8d] (two pair, Tens and Fives - King kicker)
3Wro85I7472vJ4Wkpneo9A collected $0.95 from pot
*** SUMMARY ***
Total pot $1 | Rake $0.05
Board [9c Tc Th 5d 5c]
Seat 1: FRkiRasEGlHUeLrEl+k/nA (big blind) showed [6h Qh] and lost with two pair, Tens and Fives
Seat 2: 3Wro85I7472vJ4Wkpneo9A (button) (small blind) showed [Ks 8d] and won ($0.95) with two pair, Tens and Fives



PokerStars Game #59938033436:  Hold'em No Limit ($0.25/$0.50) - 2009/07/01 0:05:29 ET
Table 'mTxf8gPLgffN3Iwfm7Icfg' 2-max Seat #1 is the button
Seat 1: Do9Rlu1R5u/AcRtMTl8SYg ($72.65 in chips)
Seat 2: EMc5LPgVaded4Qc77vm0fw ($42.40 in chips)
Do9Rlu1R5u/AcRtMTl8SYg: posts small blind $0.25
EMc5LPgVaded4Qc77vm0fw: posts big blind $0.50
*** HOLE CARDS ***
Do9Rlu1R5u/AcRtMTl8SYg: folds
EMc5LPgVaded4Qc77vm0fw collected $0.50 from pot
EMc5LPgVaded4Qc77vm0fw: doesn't show hand
*** SUMMARY ***
Total pot $0.50 | Rake $0
Seat 1: Do9Rlu1R5u/AcRtMTl8SYg (button) (small blind) folded before Flop
Seat 2: EMc5LPgVaded4Qc77vm0fw (big blind) collected ($0.50)



PokerStars Game #59938033596:  Hold'em No Limit ($0.25/$0.50) - 2009/07/01 0:05:30 ET
Table 'Vdlc9wqYcHTUhtdyN7CuJw' 2-max Seat #2 is the button
Seat 1: yBO+mXB6m/rCft2ErwGf/Q ($65 in chips)
Seat 2: sa0qgETiL3HNbdfGlnKHTA ($49.45 in chips)
sa0qgETiL3HNbdfGlnKHTA: posts small blind $0.25
yBO+mXB6m/rCft2ErwGf/Q: posts big blind $0.50
*** HOLE CARDS ***
sa0qgETiL3HNbdfGlnKHTA: raises $0.50 to $1
yBO+mXB6m/rCft2ErwGf/Q: calls $0.50
*** FLOP *** [4h Kd Qh]
yBO+mXB6m/rCft2ErwGf/Q: checks
sa0qgETiL3HNbdfGlnKHTA: bets $1
yBO+mXB6m/rCft2ErwGf/Q: folds
sa0qgETiL3HNbdfGlnKHTA collected $1.90 from pot
*** SUMMARY ***
Total pot $2 | Rake $0.10
Board [4h Kd Qh]
Seat 1: yBO+mXB6m/rCft2ErwGf/Q (big blind) folded on the Flop
Seat 2: sa0qgETiL3HNbdfGlnKHTA (button) (small blind) collected ($1.90)



PokerStars Game #59938034702:  Hold'em No Limit ($0.25/$0.50) - 2009/07/01 0:05:31 ET
Table 'c/CRn+68J3Y8KxD5g1ek2Q' 2-max Seat #2 is the button
Seat 1: 46qCyJ6evTkHo9al5sBMNA ($316.70 in chips)
Seat 2: BypVLsYQt3ePFm2xQL/dOA ($70.85 in chips)
BypVLsYQt3ePFm2xQL/dOA: posts small blind $0.25
46qCyJ6evTkHo9al5sBMNA: posts big blind $0.50
*** HOLE CARDS ***
BypVLsYQt3ePFm2xQL/dOA: raises $1 to $1.50
46qCyJ6evTkHo9al5sBMNA: folds
BypVLsYQt3ePFm2xQL/dOA collected $1 from pot
BypVLsYQt3ePFm2xQL/dOA: doesn't show hand
*** SUMMARY ***
Total pot $1 | Rake $0
Seat 1: 46qCyJ6evTkHo9al5sBMNA (big blind) folded before Flop
Seat 2: BypVLsYQt3ePFm2xQL/dOA (button) (small blind) collected ($1)



PokerStars Game #59938034332:  Hold'em No Limit ($0.25/$0.50) - 2009/07/01 0:05:31 ET
Table 'lpxYasB1ClBSgTpCCITwhQ' 9-max Seat #5 is the button
Seat 1: ceq82/EkjUd/GFbf0YwGmA ($40.95 in chips)
Seat 3: E2518gp4aFz1+kAgmGqeEg ($10.75 in chips)
Seat 4: k1f0lS7tlMHCLGs0JT34Tg ($9.25 in chips)
Seat 5: bXpVeaSTPBFSPJmeXxO7nw ($9.25 in chips)
Seat 6: YPo1oggovmqSREegekaQYw ($16.75 in chips)
Seat 7: zE9cVigS2nW/Ljy4K4bUQA ($30 in chips)
Seat 8: o6JyUkbzCDw8tUabqtmnlg ($24.45 in chips)
Seat 9: mSD1pginDsyHG5PDfqzphw ($10.75 in chips)
YPo1oggovmqSREegekaQYw: posts small blind $0.25
zE9cVigS2nW/Ljy4K4bUQA: posts big blind $0.50
*** HOLE CARDS ***
o6JyUkbzCDw8tUabqtmnlg: folds
mSD1pginDsyHG5PDfqzphw: folds
ceq82/EkjUd/GFbf0YwGmA: folds
E2518gp4aFz1+kAgmGqeEg: folds
k1f0lS7tlMHCLGs0JT34Tg: folds
bXpVeaSTPBFSPJmeXxO7nw: folds
YPo1oggovmqSREegekaQYw: raises $1 to $1.50
zE9cVigS2nW/Ljy4K4bUQA: calls $1
*** FLOP *** [3s Qh 6c]
YPo1oggovmqSREegekaQYw: bets $2
zE9cVigS2nW/Ljy4K4bUQA: folds
YPo1oggovmqSREegekaQYw collected $2.85 from pot
YPo1oggovmqSREegekaQYw: doesn't show hand
*** SUMMARY ***
Total pot $3 | Rake $0.15
Board [3s Qh 6c]
Seat 1: ceq82/EkjUd/GFbf0YwGmA folded before Flop (didn't bet)
Seat 3: E2518gp4aFz1+kAgmGqeEg folded before Flop (didn't bet)
Seat 4: k1f0lS7tlMHCLGs0JT34Tg folded before Flop (didn't bet)
Seat 5: bXpVeaSTPBFSPJmeXxO7nw (button) folded before Flop (didn't bet)
Seat 6: YPo1oggovmqSREegekaQYw (small blind) collected ($2.85)
Seat 7: zE9cVigS2nW/Ljy4K4bUQA (big blind) folded on the Flop
Seat 8: o6JyUkbzCDw8tUabqtmnlg folded before Flop (didn't bet)
Seat 9: mSD1pginDsyHG5PDfqzphw folded before Flop (didn't bet)



PokerStars Game #59938035222:  Hold'em No Limit ($0.25/$0.50) - 2009/07/01 0:05:32 ET
Table 'SsXEKOwKN+jE3etfusqUqA' 2-max Seat #2 is the button
Seat 1: 618rKeLrz/avGNOLULHHVQ ($53.95 in chips)
Seat 2: XfRhywXA6Br+jID1oGeo8A ($197.70 in chips)
XfRhywXA6Br+jID1oGeo8A: posts small blind $0.25
618rKeLrz/avGNOLULHHVQ: posts big blind $0.50
*** HOLE CARDS ***
XfRhywXA6Br+jID1oGeo8A: folds
618rKeLrz/avGNOLULHHVQ collected $0.50 from pot
618rKeLrz/avGNOLULHHVQ: doesn't show hand
*** SUMMARY ***
Total pot $0.50 | Rake $0
Seat 1: 618rKeLrz/avGNOLULHHVQ (big blind) collected ($0.50)
Seat 2: XfRhywXA6Br+jID1oGeo8A (button) (small blind) folded before Flop



PokerStars Game #59938035332:  Hold'em No Limit ($0.25/$0.50) - 2009/07/01 0:05:32 ET
Table 'X6IRCRTh+20gjz8aubWnwA' 9-max Seat #7 is the button
Seat 1: YPo1oggovmqSREegekaQYw ($9.70 in chips)
Seat 2: RjBdQ6w31rgcy0o24VLR6w ($11.45 in chips)
Seat 3: mSD1pginDsyHG5PDfqzphw ($10 in chips)
Seat 4: uw9QayAAxLM3Hb+HR7mSkg ($11 in chips)
Seat 5: aT3lRsb9BkkYp2fkD3LEtQ ($85.15 in chips)
Seat 6: /6In1zC3WtgwxDcueWzZWg ($49.25 in chips)
Seat 7: VBnpbzn0dIveV55qKvciew ($59.95 in chips)
Seat 8: BPMN9sOItJw6vWq3kypaYg ($26.15 in chips)
Seat 9: M+7+BTmX5vZatHVuoRB1nA ($84.85 in chips)
BPMN9sOItJw6vWq3kypaYg: posts small blind $0.25
M+7+BTmX5vZatHVuoRB1nA: posts big blind $0.50
*** HOLE CARDS ***
YPo1oggovmqSREegekaQYw: folds
RjBdQ6w31rgcy0o24VLR6w: folds
mSD1pginDsyHG5PDfqzphw: folds
uw9QayAAxLM3Hb+HR7mSkg: folds
aT3lRsb9BkkYp2fkD3LEtQ: folds
/6In1zC3WtgwxDcueWzZWg: raises $1 to $1.50
VBnpbzn0dIveV55qKvciew: folds
BPMN9sOItJw6vWq3kypaYg: calls $1.25
M+7+BTmX5vZatHVuoRB1nA: folds
*** FLOP *** [3s 9h Ks]
BPMN9sOItJw6vWq3kypaYg: checks
/6In1zC3WtgwxDcueWzZWg: bets $2
BPMN9sOItJw6vWq3kypaYg: folds
/6In1zC3WtgwxDcueWzZWg collected $3.35 from pot
/6In1zC3WtgwxDcueWzZWg: doesn't show hand
*** SUMMARY ***
Total pot $3.50 | Rake $0.15
Board [3s 9h Ks]
Seat 1: YPo1oggovmqSREegekaQYw folded before Flop (didn't bet)
Seat 2: RjBdQ6w31rgcy0o24VLR6w folded before Flop (didn't bet)
Seat 3: mSD1pginDsyHG5PDfqzphw folded before Flop (didn't bet)
Seat 4: uw9QayAAxLM3Hb+HR7mSkg folded before Flop (didn't bet)
Seat 5: aT3lRsb9BkkYp2fkD3LEtQ folded before Flop (didn't bet)
Seat 6: /6In1zC3WtgwxDcueWzZWg collected ($3.35)
Seat 7: VBnpbzn0dIveV55qKvciew (button) folded before Flop (didn't bet)
Seat 8: BPMN9sOItJw6vWq3kypaYg (small blind) folded on the Flop
Seat 9: M+7+BTmX5vZatHVuoRB1nA (big blind) folded before Flop



PokerStars Game #59938037372:  Hold'em No Limit ($0.25/$0.50) - 2009/07/01 0:05:35 ET
Table '0AhP5FLi4ySROVJ/ycT1Qw' 2-max Seat #1 is the button
Seat 1: VzCjk9xTOs+nLWp67vramg ($62.75 in chips)
Seat 2: 46qCyJ6evTkHo9al5sBMNA ($147.80 in chips)
VzCjk9xTOs+nLWp67vramg: posts small blind $0.25
46qCyJ6evTkHo9al5sBMNA: posts big blind $0.50
*** HOLE CARDS ***
VzCjk9xTOs+nLWp67vramg: folds
46qCyJ6evTkHo9al5sBMNA collected $0.50 from pot
46qCyJ6evTkHo9al5sBMNA: doesn't show hand
*** SUMMARY ***
Total pot $0.50 | Rake $0
Seat 1: VzCjk9xTOs+nLWp67vramg (button) (small blind) folded before Flop
Seat 2: 46qCyJ6evTkHo9al5sBMNA (big blind) collected ($0.50)



PokerStars Game #59938037776:  Hold'em No Limit ($0.25/$0.50) - 2009/07/01 0:05:36 ET
Table 'mTxf8gPLgffN3Iwfm7Icfg' 2-max Seat #2 is the button
Seat 1: Do9Rlu1R5u/AcRtMTl8SYg ($72.40 in chips)
Seat 2: EMc5LPgVaded4Qc77vm0fw ($42.65 in chips)
EMc5LPgVaded4Qc77vm0fw: posts small blind $0.25
Do9Rlu1R5u/AcRtMTl8SYg: posts big blind $0.50
*** HOLE CARDS ***
EMc5LPgVaded4Qc77vm0fw: raises $1 to $1.50
Do9Rlu1R5u/AcRtMTl8SYg: folds
EMc5LPgVaded4Qc77vm0fw collected $1 from pot
EMc5LPgVaded4Qc77vm0fw: doesn't show hand
*** SUMMARY ***
Total pot $1 | Rake $0
Seat 1: Do9Rlu1R5u/AcRtMTl8SYg (big blind) folded before Flop
Seat 2: EMc5LPgVaded4Qc77vm0fw (button) (small blind) collected ($1)



PokerStars Game #59938038464:  Hold'em No Limit ($0.25/$0.50) - 2009/07/01 0:05:36 ET
Table 'eMxdLyFDf28E0wit6gm3Uw' 6-max Seat #6 is the button
Seat 1: tnD/64LagZ9qPaeOQVjVZg ($10 in chips)
Seat 2: jwuKQ1S3U4NnzMQn3E3dgw ($65.90 in chips)
Seat 4: crjGpJEzSZgD38FoE3VMGg ($50 in chips)
Seat 5: X0X97o2fDAPiGx6o1gahsw ($58.05 in chips)
Seat 6: L0aIPg7qefDQjdJo3HCVEA ($7.50 in chips)
tnD/64LagZ9qPaeOQVjVZg: posts small blind $0.25
jwuKQ1S3U4NnzMQn3E3dgw: posts big blind $0.50
*** HOLE CARDS ***
crjGpJEzSZgD38FoE3VMGg: folds
X0X97o2fDAPiGx6o1gahsw: raises $1.50 to $2
L0aIPg7qefDQjdJo3HCVEA: folds
tnD/64LagZ9qPaeOQVjVZg: folds
jwuKQ1S3U4NnzMQn3E3dgw: folds
X0X97o2fDAPiGx6o1gahsw collected $1.25 from pot
*** SUMMARY ***
Total pot $1.25 | Rake $0
Seat 1: tnD/64LagZ9qPaeOQVjVZg (small blind) folded before Flop
Seat 2: jwuKQ1S3U4NnzMQn3E3dgw (big blind) folded before Flop
Seat 4: crjGpJEzSZgD38FoE3VMGg folded before Flop (didn't bet)
Seat 5: X0X97o2fDAPiGx6o1gahsw collected ($1.25)
Seat 6: L0aIPg7qefDQjdJo3HCVEA (button) folded before Flop (didn't bet)



PokerStars Game #59938038852:  Hold'em No Limit ($0.25/$0.50) - 2009/07/01 0:05:37 ET
Table 'kgbJRsxfv64KrErDRBAkcw' 6-max Seat #2 is the button
Seat 1: YmWlPGOKFuJSoJZPW8a8IA ($81.80 in chips)
Seat 2: Q+thC23WCv1kJUJtH/+4Jw ($27.25 in chips)
Seat 3: T0Gx/FcQ5VH9u7XaOMX97A ($61.90 in chips)
Seat 4: qanMEqjABjWxC/JgQ/0l7w ($56.40 in chips)
Seat 5: SlTdlH14u+KVVINgxMwt+Q ($74.70 in chips)
Seat 6: DDfYzIrYT0t5R/hAJngtsg ($21.60 in chips)
T0Gx/FcQ5VH9u7XaOMX97A: posts small blind $0.25
qanMEqjABjWxC/JgQ/0l7w: posts big blind $0.50
*** HOLE CARDS ***
SlTdlH14u+KVVINgxMwt+Q: raises $1.50 to $2
DDfYzIrYT0t5R/hAJngtsg: folds
YmWlPGOKFuJSoJZPW8a8IA: folds
Q+thC23WCv1kJUJtH/+4Jw: folds
T0Gx/FcQ5VH9u7XaOMX97A: folds
qanMEqjABjWxC/JgQ/0l7w: calls $1.50
*** FLOP *** [4s Jh 3c]
qanMEqjABjWxC/JgQ/0l7w: checks
SlTdlH14u+KVVINgxMwt+Q: bets $2.50
qanMEqjABjWxC/JgQ/0l7w: calls $2.50
*** TURN *** [4s Jh 3c] [Qs]
qanMEqjABjWxC/JgQ/0l7w: checks
SlTdlH14u+KVVINgxMwt+Q: checks
*** RIVER *** [4s Jh 3c Qs] [6s]
qanMEqjABjWxC/JgQ/0l7w: checks
SlTdlH14u+KVVINgxMwt+Q: checks
*** SHOW DOWN ***
qanMEqjABjWxC/JgQ/0l7w: shows [Ts Td] (a pair of Tens)
SlTdlH14u+KVVINgxMwt+Q: mucks hand
qanMEqjABjWxC/JgQ/0l7w collected $8.80 from pot
*** SUMMARY ***
Total pot $9.25 | Rake $0.45
Board [4s Jh 3c Qs 6s]
Seat 1: YmWlPGOKFuJSoJZPW8a8IA folded before Flop (didn't bet)
Seat 2: Q+thC23WCv1kJUJtH/+4Jw (button) folded before Flop (didn't bet)
Seat 3: T0Gx/FcQ5VH9u7XaOMX97A (small blind) folded before Flop
Seat 4: qanMEqjABjWxC/JgQ/0l7w (big blind) showed [Ts Td] and won ($8.80) with a pair of Tens
Seat 5: SlTdlH14u+KVVINgxMwt+Q mucked
Seat 6: DDfYzIrYT0t5R/hAJngtsg folded before Flop (didn't bet)



PokerStars Game #59938039676:  Hold'em No Limit ($0.25/$0.50) - 2009/07/01 0:05:38 ET
Table 'tyR5AZNKV8Aadbrnrnlg7g' 6-max Seat #5 is the button
Seat 1: R+KjpH/wSjDLhtIy9+edNA ($37.35 in chips)
Seat 2: 58zdeSBSuSFX/qZfhc7YmA ($32.95 in chips)
Seat 3: jUhx+m+V7qfbLZTjgwZByg ($45.25 in chips)
Seat 4: Rt6KgtZ8YaJoTc3FPim00w ($50 in chips)
Seat 5: EIg3r3fRFKG2HhgpDlIJHg ($10.05 in chips)
Seat 6: DMQLAmut/l19xN5STQndFg ($20.95 in chips)
DMQLAmut/l19xN5STQndFg: posts small blind $0.25
R+KjpH/wSjDLhtIy9+edNA: posts big blind $0.50
*** HOLE CARDS ***
58zdeSBSuSFX/qZfhc7YmA: folds
jUhx+m+V7qfbLZTjgwZByg: calls $0.50
Rt6KgtZ8YaJoTc3FPim00w: folds
EIg3r3fRFKG2HhgpDlIJHg: calls $0.50
DMQLAmut/l19xN5STQndFg: calls $0.25
R+KjpH/wSjDLhtIy9+edNA: checks
*** FLOP *** [7d 3c 3d]
DMQLAmut/l19xN5STQndFg: checks
R+KjpH/wSjDLhtIy9+edNA: bets $1
jUhx+m+V7qfbLZTjgwZByg: folds
EIg3r3fRFKG2HhgpDlIJHg: folds
DMQLAmut/l19xN5STQndFg: folds
R+KjpH/wSjDLhtIy9+edNA collected $1.90 from pot
R+KjpH/wSjDLhtIy9+edNA: doesn't show hand
*** SUMMARY ***
Total pot $2 | Rake $0.10
Board [7d 3c 3d]
Seat 1: R+KjpH/wSjDLhtIy9+edNA (big blind) collected ($1.90)
Seat 2: 58zdeSBSuSFX/qZfhc7YmA folded before Flop (didn't bet)
Seat 3: jUhx+m+V7qfbLZTjgwZByg folded on the Flop
Seat 4: Rt6KgtZ8YaJoTc3FPim00w folded before Flop (didn't bet)
Seat 5: EIg3r3fRFKG2HhgpDlIJHg (button) folded on the Flop
Seat 6: DMQLAmut/l19xN5STQndFg (small blind) folded on the Flop



PokerStars Game #59938039748:  Hold'em No Limit ($0.25/$0.50) - 2009/07/01 0:05:38 ET
Table 'ibNfFy0bCzuBaUORla0aGw' 9-max Seat #8 is the button
Seat 1: xZCXQSXlrZkp3pZizzVXCw ($56.95 in chips)
Seat 2: 90Wb75h3W1BRpbqVnuk8gw ($50 in chips)
Seat 3: dDaHs3X8+fe3bIkRU0cbrw ($27.30 in chips)
Seat 5: FRv75HO8CUsRZ1byEz06mQ ($15.35 in chips)
Seat 6: BmYrv3ec2k5d6pQq6iNaZw ($66.25 in chips)
Seat 7: mSD1pginDsyHG5PDfqzphw ($10 in chips)
Seat 8: xUrN9TWLq4m5V+OXY7KUUA ($50 in chips)
Seat 9: WpvT3OUSiZlpvs+mPXFqtQ ($9 in chips)
WpvT3OUSiZlpvs+mPXFqtQ: posts small blind $0.25
xZCXQSXlrZkp3pZizzVXCw: posts big blind $0.50
*** HOLE CARDS ***
90Wb75h3W1BRpbqVnuk8gw: folds
dDaHs3X8+fe3bIkRU0cbrw: folds
FRv75HO8CUsRZ1byEz06mQ: folds
BmYrv3ec2k5d6pQq6iNaZw: folds
mSD1pginDsyHG5PDfqzphw: folds
xUrN9TWLq4m5V+OXY7KUUA: folds
WpvT3OUSiZlpvs+mPXFqtQ: folds
xZCXQSXlrZkp3pZizzVXCw collected $0.50 from pot
xZCXQSXlrZkp3pZizzVXCw: doesn't show hand
*** SUMMARY ***
Total pot $0.50 | Rake $0
Seat 1: xZCXQSXlrZkp3pZizzVXCw (big blind) collected ($0.50)
Seat 2: 90Wb75h3W1BRpbqVnuk8gw folded before Flop (didn't bet)
Seat 3: dDaHs3X8+fe3bIkRU0cbrw folded before Flop (didn't bet)
Seat 5: FRv75HO8CUsRZ1byEz06mQ folded before Flop (didn't bet)
Seat 6: BmYrv3ec2k5d6pQq6iNaZw folded before Flop (didn't bet)
Seat 7: mSD1pginDsyHG5PDfqzphw folded before Flop (didn't bet)
Seat 8: xUrN9TWLq4m5V+OXY7KUUA (button) folded before Flop (didn't bet)
Seat 9: WpvT3OUSiZlpvs+mPXFqtQ (small blind) folded before Flop



PokerStars Game #59938041254:  Hold'em No Limit ($0.25/$0.50) - 2009/07/01 0:05:40 ET
Table 'c/CRn+68J3Y8KxD5g1ek2Q' 2-max Seat #1 is the button
Seat 1: 46qCyJ6evTkHo9al5sBMNA ($316.20 in chips)
Seat 2: BypVLsYQt3ePFm2xQL/dOA ($71.35 in chips)
46qCyJ6evTkHo9al5sBMNA: posts small blind $0.25
BypVLsYQt3ePFm2xQL/dOA: posts big blind $0.50
*** HOLE CARDS ***
46qCyJ6evTkHo9al5sBMNA: folds
BypVLsYQt3ePFm2xQL/dOA collected $0.50 from pot
BypVLsYQt3ePFm2xQL/dOA: doesn't show hand
*** SUMMARY ***
Total pot $0.50 | Rake $0
Seat 1: 46qCyJ6evTkHo9al5sBMNA (button) (small blind) folded before Flop
Seat 2: BypVLsYQt3ePFm2xQL/dOA (big blind) collected ($0.50)



PokerStars Game #59938042682:  Hold'em No Limit ($0.25/$0.50) - 2009/07/01 0:05:42 ET
Table '0AhP5FLi4ySROVJ/ycT1Qw' 2-max Seat #2 is the button
Seat 1: VzCjk9xTOs+nLWp67vramg ($62.50 in chips)
Seat 2: 46qCyJ6evTkHo9al5sBMNA ($148.05 in chips)
46qCyJ6evTkHo9al5sBMNA: posts small blind $0.25
VzCjk9xTOs+nLWp67vramg: posts big blind $0.50
*** HOLE CARDS ***
46qCyJ6evTkHo9al5sBMNA: raises $1 to $1.50
VzCjk9xTOs+nLWp67vramg: calls $1
*** FLOP *** [3s Jc 7s]
VzCjk9xTOs+nLWp67vramg: bets $2
46qCyJ6evTkHo9al5sBMNA: folds
VzCjk9xTOs+nLWp67vramg collected $2.85 from pot
*** SUMMARY ***
Total pot $3 | Rake $0.15
Board [3s Jc 7s]
Seat 1: VzCjk9xTOs+nLWp67vramg (big blind) collected ($2.85)
Seat 2: 46qCyJ6evTkHo9al5sBMNA (button) (small blind) folded on the Flop



PokerStars Game #59938043314:  Hold'em No Limit ($0.25/$0.50) - 2009/07/01 0:05:43 ET
Table 'EiNh8p/wGJ1FP575iMFnqg' 9-max Seat #4 is the button
Seat 1: r3ZqM1Mi0W3y4hOdssE+Sg ($43.25 in chips)
Seat 2: avsQkZXsRKnWa7gkjVNvog ($27.90 in chips)
Seat 3: GszS/McxOSUnOET7MBoHqA ($58.60 in chips)
Seat 4: pk8aA8qMBEL6zXqSyfVXMA ($80.05 in chips)
Seat 5: M+7+BTmX5vZatHVuoRB1nA ($92.50 in chips)
Seat 6: YPo1oggovmqSREegekaQYw ($14.75 in chips)
Seat 7: Wj7mKnRFR90j40wWUu2+Og ($26.90 in chips)
Seat 9: OMwFJ4pF0xk2Ru/AJiFeFw ($72.90 in chips)
M+7+BTmX5vZatHVuoRB1nA: posts small blind $0.25
YPo1oggovmqSREegekaQYw: posts big blind $0.50
*** HOLE CARDS ***
Wj7mKnRFR90j40wWUu2+Og: folds
OMwFJ4pF0xk2Ru/AJiFeFw: folds
r3ZqM1Mi0W3y4hOdssE+Sg: folds
avsQkZXsRKnWa7gkjVNvog: folds
GszS/McxOSUnOET7MBoHqA: raises $0.50 to $1
pk8aA8qMBEL6zXqSyfVXMA: folds
M+7+BTmX5vZatHVuoRB1nA: calls $0.75
YPo1oggovmqSREegekaQYw: calls $0.50
*** FLOP *** [Tc Ah 5d]
M+7+BTmX5vZatHVuoRB1nA: checks
YPo1oggovmqSREegekaQYw: checks
GszS/McxOSUnOET7MBoHqA: checks
*** TURN *** [Tc Ah 5d] [7d]
M+7+BTmX5vZatHVuoRB1nA: bets $1
YPo1oggovmqSREegekaQYw: folds
GszS/McxOSUnOET7MBoHqA: calls $1
*** RIVER *** [Tc Ah 5d 7d] [Ad]
M+7+BTmX5vZatHVuoRB1nA: bets $1.50
GszS/McxOSUnOET7MBoHqA: raises $3 to $4.50
M+7+BTmX5vZatHVuoRB1nA: folds
GszS/McxOSUnOET7MBoHqA collected $7.65 from pot
*** SUMMARY ***
Total pot $8 | Rake $0.35
Board [Tc Ah 5d 7d Ad]
Seat 1: r3ZqM1Mi0W3y4hOdssE+Sg folded before Flop (didn't bet)
Seat 2: avsQkZXsRKnWa7gkjVNvog folded before Flop (didn't bet)
Seat 3: GszS/McxOSUnOET7MBoHqA collected ($7.65)
Seat 4: pk8aA8qMBEL6zXqSyfVXMA (button) folded before Flop (didn't bet)
Seat 5: M+7+BTmX5vZatHVuoRB1nA (small blind) folded on the River
Seat 6: YPo1oggovmqSREegekaQYw (big blind) folded on the Turn
Seat 7: Wj7mKnRFR90j40wWUu2+Og folded before Flop (didn't bet)
Seat 9: OMwFJ4pF0xk2Ru/AJiFeFw folded before Flop (didn't bet)



PokerStars Game #59938046022:  Hold'em No Limit ($0.25/$0.50) - 2009/07/01 0:05:47 ET
Table 'mTxf8gPLgffN3Iwfm7Icfg' 2-max Seat #1 is the button
Seat 1: Do9Rlu1R5u/AcRtMTl8SYg ($71.90 in chips)
Seat 2: EMc5LPgVaded4Qc77vm0fw ($43.15 in chips)
Do9Rlu1R5u/AcRtMTl8SYg: posts small blind $0.25
EMc5LPgVaded4Qc77vm0fw: posts big blind $0.50
*** HOLE CARDS ***
Do9Rlu1R5u/AcRtMTl8SYg: raises $1 to $1.50
EMc5LPgVaded4Qc77vm0fw: calls $1
*** FLOP *** [5h 3s Jd]
EMc5LPgVaded4Qc77vm0fw: checks
Do9Rlu1R5u/AcRtMTl8SYg: checks
*** TURN *** [5h 3s Jd] [8d]
EMc5LPgVaded4Qc77vm0fw: bets $2.50
Do9Rlu1R5u/AcRtMTl8SYg: folds
EMc5LPgVaded4Qc77vm0fw collected $2.85 from pot
EMc5LPgVaded4Qc77vm0fw: doesn't show hand
*** SUMMARY ***
Total pot $3 | Rake $0.15
Board [5h 3s Jd 8d]
Seat 1: Do9Rlu1R5u/AcRtMTl8SYg (button) (small blind) folded on the Turn
Seat 2: EMc5LPgVaded4Qc77vm0fw (big blind) collected ($2.85)



PokerStars Game #59938045988:  Hold'em No Limit ($0.25/$0.50) - 2009/07/01 0:05:47 ET
Table 'c/CRn+68J3Y8KxD5g1ek2Q' 2-max Seat #2 is the button
Seat 1: 46qCyJ6evTkHo9al5sBMNA ($315.95 in chips)
Seat 2: BypVLsYQt3ePFm2xQL/dOA ($71.60 in chips)
BypVLsYQt3ePFm2xQL/dOA: posts small blind $0.25
46qCyJ6evTkHo9al5sBMNA: posts big blind $0.50
*** HOLE CARDS ***
BypVLsYQt3ePFm2xQL/dOA: raises $0.50 to $1
46qCyJ6evTkHo9al5sBMNA: raises $3 to $4
BypVLsYQt3ePFm2xQL/dOA: folds
46qCyJ6evTkHo9al5sBMNA collected $2 from pot
46qCyJ6evTkHo9al5sBMNA: doesn't show hand
*** SUMMARY ***
Total pot $2 | Rake $0
Seat 1: 46qCyJ6evTkHo9al5sBMNA (big blind) collected ($2)
Seat 2: BypVLsYQt3ePFm2xQL/dOA (button) (small blind) folded before Flop



PokerStars Game #59938046312:  Hold'em No Limit ($0.25/$0.50) - 2009/07/01 0:05:47 ET
Table 'hSTs/dUsYLgJQuF2Onp0MQ' 6-max Seat #4 is the button
Seat 1: lWwl5C/UZOsWNubdUqghZw ($71.45 in chips)
Seat 3: vQOrJuXbLC3UZDVklY9bOA ($12.70 in chips)
Seat 4: L0aIPg7qefDQjdJo3HCVEA ($14.45 in chips)
Seat 5: 686aeHikcJlgKkSuIFdcXQ ($60.90 in chips)
Seat 6: +laPa9P7BjZKKnR0n+OmvA ($12 in chips)
686aeHikcJlgKkSuIFdcXQ: posts small blind $0.25
+laPa9P7BjZKKnR0n+OmvA: posts big blind $0.50
*** HOLE CARDS ***
lWwl5C/UZOsWNubdUqghZw: folds
vQOrJuXbLC3UZDVklY9bOA: raises $1.50 to $2
L0aIPg7qefDQjdJo3HCVEA: folds
686aeHikcJlgKkSuIFdcXQ: folds
+laPa9P7BjZKKnR0n+OmvA: folds
vQOrJuXbLC3UZDVklY9bOA collected $1.25 from pot
*** SUMMARY ***
Total pot $1.25 | Rake $0
Seat 1: lWwl5C/UZOsWNubdUqghZw folded before Flop (didn't bet)
Seat 3: vQOrJuXbLC3UZDVklY9bOA collected ($1.25)
Seat 4: L0aIPg7qefDQjdJo3HCVEA (button) folded before Flop (didn't bet)
Seat 5: 686aeHikcJlgKkSuIFdcXQ (small blind) folded before Flop
Seat 6: +laPa9P7BjZKKnR0n+OmvA (big blind) folded before Flop



PokerStars Game #59938046712:  Hold'em No Limit ($0.25/$0.50) - 2009/07/01 0:05:48 ET
Table 'SsXEKOwKN+jE3etfusqUqA' 2-max Seat #1 is the button
Seat 1: 618rKeLrz/avGNOLULHHVQ ($54.20 in chips)
Seat 2: XfRhywXA6Br+jID1oGeo8A ($197.45 in chips)
618rKeLrz/avGNOLULHHVQ: posts small blind $0.25
XfRhywXA6Br+jID1oGeo8A: posts big blind $0.50
*** HOLE CARDS ***
618rKeLrz/avGNOLULHHVQ: raises $1 to $1.50
XfRhywXA6Br+jID1oGeo8A: folds
618rKeLrz/avGNOLULHHVQ collected $1 from pot
618rKeLrz/avGNOLULHHVQ: doesn't show hand
*** SUMMARY ***
Total pot $1 | Rake $0
Seat 1: 618rKeLrz/avGNOLULHHVQ (button) (small blind) collected ($1)
Seat 2: XfRhywXA6Br+jID1oGeo8A (big blind) folded before Flop



PokerStars Game #59938048304:  Hold'em No Limit ($0.25/$0.50) - 2009/07/01 0:05:50 ET
Table 'E7bWJ45aoFXRpyRv2gw+Ig' 2-max Seat #1 is the button
Seat 1: FRkiRasEGlHUeLrEl+k/nA ($66.80 in chips)
Seat 2: 3Wro85I7472vJ4Wkpneo9A ($58.20 in chips)
FRkiRasEGlHUeLrEl+k/nA: posts small blind $0.25
3Wro85I7472vJ4Wkpneo9A: posts big blind $0.50
*** HOLE CARDS ***
FRkiRasEGlHUeLrEl+k/nA: folds
3Wro85I7472vJ4Wkpneo9A collected $0.50 from pot
3Wro85I7472vJ4Wkpneo9A: doesn't show hand
*** SUMMARY ***
Total pot $0.50 | Rake $0
Seat 1: FRkiRasEGlHUeLrEl+k/nA (button) (small blind) folded before Flop
Seat 2: 3Wro85I7472vJ4Wkpneo9A (big blind) collected ($0.50)



PokerStars Game #59938048488:  Hold'em No Limit ($0.25/$0.50) - 2009/07/01 0:05:50 ET
Table 'raOT4/ipuZgzjfKHC+jD9g' 2-max Seat #1 is the button
Seat 1: IuwLemwLhc9fvrwBGs0AMA ($12.65 in chips)
Seat 2: Udr5juWSWUgTu1NlRhjMdA ($11.30 in chips)
IuwLemwLhc9fvrwBGs0AMA: posts small blind $0.25
Udr5juWSWUgTu1NlRhjMdA: posts big blind $0.50
*** HOLE CARDS ***
IuwLemwLhc9fvrwBGs0AMA: folds
Udr5juWSWUgTu1NlRhjMdA collected $0.50 from pot
Udr5juWSWUgTu1NlRhjMdA: doesn't show hand
*** SUMMARY ***
Total pot $0.50 | Rake $0
Seat 1: IuwLemwLhc9fvrwBGs0AMA (button) (small blind) folded before Flop
Seat 2: Udr5juWSWUgTu1NlRhjMdA (big blind) collected ($0.50)



PokerStars Game #59938049388:  Hold'em No Limit ($0.25/$0.50) - 2009/07/01 0:05:51 ET
Table 'QOgaEqMcJ73pcUMMxoisUgErOuyGLI5PT3G5MnpHgC/g Seat #1 is the button
Seat 1: k6GJzKs7T7qvQggW9g8Pdw ($47.75 in chips)
Seat 2: RjBdQ6w31rgcy0o24VLR6w ($10.45 in chips)
Seat 3: xZCXQSXlrZkp3pZizzVXCw ($49 in chips)
Seat 4: U7aZzIYWjv3SL30KtikLbw ($48.95 in chips)
Seat 5: JwvquocWfhTVApN5t47LgA ($51.05 in chips)
Seat 6: zE9cVigS2nW/Ljy4K4bUQA ($31.35 in chips)
Seat 7: 90Wb75h3W1BRpbqVnuk8gw ($62.55 in chips)
Seat 8: ajP1NjIMdqQfpMbzHzvejw ($41.30 in chips)
Seat 9: J0W5D97jl5VLky+IoPvDeA ($67.80 in chips)
RjBdQ6w31rgcy0o24VLR6w: posts small blind $0.25
xZCXQSXlrZkp3pZizzVXCw: posts big blind $0.50
*** HOLE CARDS ***
U7aZzIYWjv3SL30KtikLbw: folds
JwvquocWfhTVApN5t47LgA: folds
zE9cVigS2nW/Ljy4K4bUQA: folds
90Wb75h3W1BRpbqVnuk8gw: folds
ajP1NjIMdqQfpMbzHzvejw: folds
J0W5D97jl5VLky+IoPvDeA: folds
k6GJzKs7T7qvQggW9g8Pdw: folds
RjBdQ6w31rgcy0o24VLR6w: raises $1.50 to $2
xZCXQSXlrZkp3pZizzVXCw: folds
RjBdQ6w31rgcy0o24VLR6w collected $1 from pot
*** SUMMARY ***
Total pot $1 | Rake $0
Seat 1: k6GJzKs7T7qvQggW9g8Pdw (button) folded before Flop (didn't bet)
Seat 2: RjBdQ6w31rgcy0o24VLR6w (small blind) collected ($1)
Seat 3: xZCXQSXlrZkp3pZizzVXCw (big blind) folded before Flop
Seat 4: U7aZzIYWjv3SL30KtikLbw folded before Flop (didn't bet)
Seat 5: JwvquocWfhTVApN5t47LgA folded before Flop (didn't bet)
Seat 6: zE9cVigS2nW/Ljy4K4bUQA folded before Flop (didn't bet)
Seat 7: 90Wb75h3W1BRpbqVnuk8gw folded before Flop (didn't bet)
Seat 8: ajP1NjIMdqQfpMbzHzvejw folded before Flop (didn't bet)
Seat 9: J0W5D97jl5VLky+IoPvDeA folded before Flop (didn't bet)



PokerStars Game #59938049870:  Hold'em No Limit ($0.25/$0.50) - 2009/07/01 0:05:52 ET
Table '5EmHi+fnatGQQShcNmzOZQ' 6-max Seat #1 is the button
Seat 1: SwPczQo3cOtwEzhJrfO2cQ ($22.30 in chips)
Seat 2: APwvTk5XojDXGoQLb4O5iA ($25.30 in chips)
Seat 3: J8dF2sYMvXUmAGUuSW9kwg ($36.05 in chips)
Seat 4: mFTuMjESuBcXHQ1ePkg/8A ($18.05 in chips)
Seat 5: kxPhs4ePFqMy52CInAJ2aw ($73.05 in chips)
Seat 6: 686aeHikcJlgKkSuIFdcXQ ($115.45 in chips)
APwvTk5XojDXGoQLb4O5iA: posts small blind $0.25
J8dF2sYMvXUmAGUuSW9kwg: posts big blind $0.50
*** HOLE CARDS ***
mFTuMjESuBcXHQ1ePkg/8A: raises $0.50 to $1
kxPhs4ePFqMy52CInAJ2aw: folds
686aeHikcJlgKkSuIFdcXQ: folds
SwPczQo3cOtwEzhJrfO2cQ: folds
APwvTk5XojDXGoQLb4O5iA: folds
J8dF2sYMvXUmAGUuSW9kwg: calls $0.50
*** FLOP *** [Jc 3h Jh]
J8dF2sYMvXUmAGUuSW9kwg: checks
mFTuMjESuBcXHQ1ePkg/8A: checks
*** TURN *** [Jc 3h Jh] [7c]
J8dF2sYMvXUmAGUuSW9kwg: checks
mFTuMjESuBcXHQ1ePkg/8A: checks
*** RIVER *** [Jc 3h Jh 7c] [4h]
J8dF2sYMvXUmAGUuSW9kwg: checks
mFTuMjESuBcXHQ1ePkg/8A: bets $1
J8dF2sYMvXUmAGUuSW9kwg: folds
mFTuMjESuBcXHQ1ePkg/8A collected $2.15 from pot
mFTuMjESuBcXHQ1ePkg/8A: doesn't show hand
*** SUMMARY ***
Total pot $2.25 | Rake $0.10
Board [Jc 3h Jh 7c 4h]
Seat 1: SwPczQo3cOtwEzhJrfO2cQ (button) folded before Flop (didn't bet)
Seat 2: APwvTk5XojDXGoQLb4O5iA (small blind) folded before Flop
Seat 3: J8dF2sYMvXUmAGUuSW9kwg (big blind) folded on the River
Seat 4: mFTuMjESuBcXHQ1ePkg/8A collected ($2.15)
Seat 5: kxPhs4ePFqMy52CInAJ2aw folded before Flop (didn't bet)
Seat 6: 686aeHikcJlgKkSuIFdcXQ folded before Flop (didn't bet)



PokerStars Game #59938050672:  Hold'em No Limit ($0.25/$0.50) - 2009/07/01 0:05:53 ET
Table 'BCN5su+SsXiy1zRMJi0SJw' 6-max Seat #6 is the button
Seat 1: WyeokAqR0q9nADSkWpbxHw ($39.30 in chips)
Seat 2: QfV2JJlmEKgD5jYPV+a33A ($159.40 in chips)
Seat 4: 6Wb8PlO2kM4fnSim7p4Mrw ($10.40 in chips)
Seat 5: TTx3CHxyi0SObcHyMJRp5w ($39.10 in chips)
Seat 6: zHXshyreKwJVq3N3U+K9uQ ($51.30 in chips)
WyeokAqR0q9nADSkWpbxHw: posts small blind $0.25
QfV2JJlmEKgD5jYPV+a33A: posts big blind $0.50
*** HOLE CARDS ***
6Wb8PlO2kM4fnSim7p4Mrw: calls $0.50
TTx3CHxyi0SObcHyMJRp5w: folds
zHXshyreKwJVq3N3U+K9uQ: folds
WyeokAqR0q9nADSkWpbxHw: folds
QfV2JJlmEKgD5jYPV+a33A: checks
*** FLOP *** [6d Ac 9s]
QfV2JJlmEKgD5jYPV+a33A: checks
6Wb8PlO2kM4fnSim7p4Mrw: bets $0.50
QfV2JJlmEKgD5jYPV+a33A: folds
6Wb8PlO2kM4fnSim7p4Mrw collected $1.20 from pot
*** SUMMARY ***
Total pot $1.25 | Rake $0.05
Board [6d Ac 9s]
Seat 1: WyeokAqR0q9nADSkWpbxHw (small blind) folded before Flop
Seat 2: QfV2JJlmEKgD5jYPV+a33A (big blind) folded on the Flop
Seat 4: 6Wb8PlO2kM4fnSim7p4Mrw collected ($1.20)
Seat 5: TTx3CHxyi0SObcHyMJRp5w folded before Flop (didn't bet)
Seat 6: zHXshyreKwJVq3N3U+K9uQ (button) folded before Flop (didn't bet)



PokerStars Game #59938050972:  Hold'em No Limit ($0.25/$0.50) - 2009/07/01 0:05:53 ET
Table 'YsnnHkamRzYqMOr2FlLY4w' 6-max Seat #4 is the button
Seat 1: crjGpJEzSZgD38FoE3VMGg ($50 in chips)
Seat 3: I+pG2m/dD5iYdbg9qx572g ($25 in chips)
Seat 4: 7Fue572p4ZIC85AJMQvaQw ($53.85 in chips)
Seat 5: lcQ7uuLf+WLGGy4Ve6VKKA ($45 in chips)
Seat 6: YmWlPGOKFuJSoJZPW8a8IA ($50 in chips)
lcQ7uuLf+WLGGy4Ve6VKKA: posts small blind $0.25
YmWlPGOKFuJSoJZPW8a8IA: posts big blind $0.50
*** HOLE CARDS ***
crjGpJEzSZgD38FoE3VMGg: folds
I+pG2m/dD5iYdbg9qx572g: folds
7Fue572p4ZIC85AJMQvaQw: folds
lcQ7uuLf+WLGGy4Ve6VKKA: calls $0.25
YmWlPGOKFuJSoJZPW8a8IA: raises $1.50 to $2
lcQ7uuLf+WLGGy4Ve6VKKA: calls $1.50
*** FLOP *** [9c 7d Kc]
lcQ7uuLf+WLGGy4Ve6VKKA: checks
YmWlPGOKFuJSoJZPW8a8IA: bets $2
lcQ7uuLf+WLGGy4Ve6VKKA: calls $2
*** TURN *** [9c 7d Kc] [3s]
lcQ7uuLf+WLGGy4Ve6VKKA: checks
YmWlPGOKFuJSoJZPW8a8IA: bets $5
lcQ7uuLf+WLGGy4Ve6VKKA: folds
YmWlPGOKFuJSoJZPW8a8IA collected $7.65 from pot
YmWlPGOKFuJSoJZPW8a8IA: doesn't show hand
*** SUMMARY ***
Total pot $8 | Rake $0.35
Board [9c 7d Kc 3s]
Seat 1: crjGpJEzSZgD38FoE3VMGg folded before Flop (didn't bet)
Seat 3: I+pG2m/dD5iYdbg9qx572g folded before Flop (didn't bet)
Seat 4: 7Fue572p4ZIC85AJMQvaQw (button) folded before Flop (didn't bet)
Seat 5: lcQ7uuLf+WLGGy4Ve6VKKA (small blind) folded on the Turn
Seat 6: YmWlPGOKFuJSoJZPW8a8IA (big blind) collected ($7.65)



PokerStars Game #59938051210:  Hold'em No Limit ($0.25/$0.50) - 2009/07/01 0:05:54 ET
Table 'SsXEKOwKN+jE3etfusqUqA' 2-max Seat #2 is the button
Seat 1: 618rKeLrz/avGNOLULHHVQ ($54.70 in chips)
Seat 2: XfRhywXA6Br+jID1oGeo8A ($196.95 in chips)
XfRhywXA6Br+jID1oGeo8A: posts small blind $0.25
618rKeLrz/avGNOLULHHVQ: posts big blind $0.50
*** HOLE CARDS ***
XfRhywXA6Br+jID1oGeo8A: raises $0.50 to $1
618rKeLrz/avGNOLULHHVQ: raises $3.50 to $4.50
XfRhywXA6Br+jID1oGeo8A: calls $3.50
*** FLOP *** [6s 4c 9c]
618rKeLrz/avGNOLULHHVQ: bets $5
XfRhywXA6Br+jID1oGeo8A: calls $5
*** TURN *** [6s 4c 9c] [Ks]
618rKeLrz/avGNOLULHHVQ: bets $11
XfRhywXA6Br+jID1oGeo8A: calls $11
*** RIVER *** [6s 4c 9c Ks] [2c]
618rKeLrz/avGNOLULHHVQ: bets $22
XfRhywXA6Br+jID1oGeo8A: folds
618rKeLrz/avGNOLULHHVQ collected $40.50 from pot
618rKeLrz/avGNOLULHHVQ: doesn't show hand
*** SUMMARY ***
Total pot $41 | Rake $0.50
Board [6s 4c 9c Ks 2c]
Seat 1: 618rKeLrz/avGNOLULHHVQ (big blind) collected ($40.50)
Seat 2: XfRhywXA6Br+jID1oGeo8A (button) (small blind) folded on the River



PokerStars Game #59938052464:  Hold'em No Limit ($0.25/$0.50) - 2009/07/01 0:05:56 ET
Table 'E7bWJ45aoFXRpyRv2gw+Ig' 2-max Seat #2 is the button
Seat 1: FRkiRasEGlHUeLrEl+k/nA ($66.55 in chips)
Seat 2: 3Wro85I7472vJ4Wkpneo9A ($58.45 in chips)
3Wro85I7472vJ4Wkpneo9A: posts small blind $0.25
FRkiRasEGlHUeLrEl+k/nA: posts big blind $0.50
*** HOLE CARDS ***
3Wro85I7472vJ4Wkpneo9A: calls $0.25
FRkiRasEGlHUeLrEl+k/nA: checks
*** FLOP *** [Js Qc 5s]
FRkiRasEGlHUeLrEl+k/nA: checks
3Wro85I7472vJ4Wkpneo9A: bets $1
FRkiRasEGlHUeLrEl+k/nA: folds
3Wro85I7472vJ4Wkpneo9A collected $0.95 from pot
3Wro85I7472vJ4Wkpneo9A: doesn't show hand
*** SUMMARY ***
Total pot $1 | Rake $0.05
Board [Js Qc 5s]
Seat 1: FRkiRasEGlHUeLrEl+k/nA (big blind) folded on the Flop
Seat 2: 3Wro85I7472vJ4Wkpneo9A (button) (small blind) collected ($0.95)



PokerStars Game #59938052774:  Hold'em No Limit ($0.25/$0.50) - 2009/07/01 0:05:56 ET
Table '37qXEp3oe+er5q4CZip9eQ' 6-max Seat #1 is the button
Seat 1: 4qceN3NM3S463h+TT4UvGQ ($9.55 in chips)
Seat 2: g12O9qXTybyo2C0B2bXgjg ($27.40 in chips)
Seat 3: Rt6KgtZ8YaJoTc3FPim00w ($109.10 in chips)
Seat 4: L0aIPg7qefDQjdJo3HCVEA ($10.30 in chips)
Seat 5: VOmI0x4dDPnTESZd5B4d1Q ($30.75 in chips)
Seat 6: f7zPpUQp9hHZgqhEvrUWQw ($55.90 in chips)
g12O9qXTybyo2C0B2bXgjg: posts small blind $0.25
Rt6KgtZ8YaJoTc3FPim00w: posts big blind $0.50
*** HOLE CARDS ***
L0aIPg7qefDQjdJo3HCVEA: folds
VOmI0x4dDPnTESZd5B4d1Q: folds
f7zPpUQp9hHZgqhEvrUWQw: folds
4qceN3NM3S463h+TT4UvGQ: calls $0.50
g12O9qXTybyo2C0B2bXgjg: calls $0.25
Rt6KgtZ8YaJoTc3FPim00w: checks
*** FLOP *** [7s 6c 8d]
g12O9qXTybyo2C0B2bXgjg: checks
Rt6KgtZ8YaJoTc3FPim00w: bets $1
4qceN3NM3S463h+TT4UvGQ: raises $1.50 to $2.50
g12O9qXTybyo2C0B2bXgjg: calls $2.50
Rt6KgtZ8YaJoTc3FPim00w: folds
*** TURN *** [7s 6c 8d] [7c]
g12O9qXTybyo2C0B2bXgjg: checks
4qceN3NM3S463h+TT4UvGQ: bets $6.55 and is all-in
g12O9qXTybyo2C0B2bXgjg: calls $6.55
*** RIVER *** [7s 6c 8d 7c] [Qs]
*** SHOW DOWN ***
g12O9qXTybyo2C0B2bXgjg: shows [9d 7h] (three of a kind, Sevens)
4qceN3NM3S463h+TT4UvGQ: mucks hand
g12O9qXTybyo2C0B2bXgjg collected $19.60 from pot
*** SUMMARY ***
Total pot $20.60 | Rake $1
Board [7s 6c 8d 7c Qs]
Seat 1: 4qceN3NM3S463h+TT4UvGQ (button) mucked
Seat 2: g12O9qXTybyo2C0B2bXgjg (small blind) showed [9d 7h] and won ($19.60) with three of a kind, Sevens
Seat 3: Rt6KgtZ8YaJoTc3FPim00w (big blind) folded on the Flop
Seat 4: L0aIPg7qefDQjdJo3HCVEA folded before Flop (didn't bet)
Seat 5: VOmI0x4dDPnTESZd5B4d1Q folded before Flop (didn't bet)
Seat 6: f7zPpUQp9hHZgqhEvrUWQw folded before Flop (didn't bet)



PokerStars Game #59938052400:  Hold'em No Limit ($0.25/$0.50) - 2009/07/01 0:05:56 ET
Table 'MJxeZCzYELxiIsyUZyT0jw' 6-max Seat #5 is the button
Seat 1: iKPos8JI094Tomq4tDSgnQ ($28.75 in chips)
Seat 2: r6H1GiZ6QIpMTDhyodKuRQ ($65.65 in chips)
Seat 3: JQZew0FjzS19kTjeNtrE+A ($51.85 in chips)
Seat 4: lP7Q6pewz4C2RsAfKsjdWw ($24.55 in chips)
Seat 5: 3jvoOXNtXE90w2BdfNZwZQ ($50 in chips)
Seat 6: TTx3CHxyi0SObcHyMJRp5w ($41.20 in chips)
TTx3CHxyi0SObcHyMJRp5w: posts small blind $0.25
iKPos8JI094Tomq4tDSgnQ: posts big blind $0.50
*** HOLE CARDS ***
r6H1GiZ6QIpMTDhyodKuRQ: folds
JQZew0FjzS19kTjeNtrE+A: folds
lP7Q6pewz4C2RsAfKsjdWw: calls $0.50
3jvoOXNtXE90w2BdfNZwZQ: folds
TTx3CHxyi0SObcHyMJRp5w: calls $0.25
iKPos8JI094Tomq4tDSgnQ: checks
*** FLOP *** [4d Ks Jd]
TTx3CHxyi0SObcHyMJRp5w: checks
iKPos8JI094Tomq4tDSgnQ: checks
lP7Q6pewz4C2RsAfKsjdWw: bets $1.50
TTx3CHxyi0SObcHyMJRp5w: folds
iKPos8JI094Tomq4tDSgnQ: folds
lP7Q6pewz4C2RsAfKsjdWw collected $1.45 from pot
lP7Q6pewz4C2RsAfKsjdWw: doesn't show hand
*** SUMMARY ***
Total pot $1.50 | Rake $0.05
Board [4d Ks Jd]
Seat 1: iKPos8JI094Tomq4tDSgnQ (big blind) folded on the Flop
Seat 2: r6H1GiZ6QIpMTDhyodKuRQ folded before Flop (didn't bet)
Seat 3: JQZew0FjzS19kTjeNtrE+A folded before Flop (didn't bet)
Seat 4: lP7Q6pewz4C2RsAfKsjdWw collected ($1.45)
Seat 5: 3jvoOXNtXE90w2BdfNZwZQ (button) folded before Flop (didn't bet)
Seat 6: TTx3CHxyi0SObcHyMJRp5w (small blind) folded on the Flop



PokerStars Game #59938053278:  Hold'em No Limit ($0.25/$0.50) - 2009/07/01 0:05:57 ET
Table 'raOT4/ipuZgzjfKHC+jD9g' 2-max Seat #2 is the button
Seat 1: IuwLemwLhc9fvrwBGs0AMA ($12.40 in chips)
Seat 2: Udr5juWSWUgTu1NlRhjMdA ($11.55 in chips)
Udr5juWSWUgTu1NlRhjMdA: posts small blind $0.25
IuwLemwLhc9fvrwBGs0AMA: posts big blind $0.50
*** HOLE CARDS ***
Udr5juWSWUgTu1NlRhjMdA: raises $0.50 to $1
IuwLemwLhc9fvrwBGs0AMA: calls $0.50
*** FLOP *** [5d Kh Ks]
IuwLemwLhc9fvrwBGs0AMA: checks
Udr5juWSWUgTu1NlRhjMdA: checks
*** TURN *** [5d Kh Ks] [5s]
IuwLemwLhc9fvrwBGs0AMA: checks
Udr5juWSWUgTu1NlRhjMdA: bets $1
IuwLemwLhc9fvrwBGs0AMA: folds
Udr5juWSWUgTu1NlRhjMdA collected $1.90 from pot
Udr5juWSWUgTu1NlRhjMdA: doesn't show hand
*** SUMMARY ***
Total pot $2 | Rake $0.10
Board [5d Kh Ks 5s]
Seat 1: IuwLemwLhc9fvrwBGs0AMA (big blind) folded on the Turn
Seat 2: Udr5juWSWUgTu1NlRhjMdA (button) (small blind) collected ($1.90)



PokerStars Game #59938053174:  Hold'em No Limit ($0.25/$0.50) - 2009/07/01 0:05:57 ET
Table 'tpZbcIvqh/6WmfR/i5IE3A' 9-max Seat #6 is the button
Seat 1: nV/P1jFY/CFMXOLWu7pYmA ($14.45 in chips)
Seat 2: M+7+BTmX5vZatHVuoRB1nA ($45.90 in chips)
Seat 3: 3w0FbBQAKwQODwenKwZxXw ($76.95 in chips)
Seat 4: zE9cVigS2nW/Ljy4K4bUQA ($30 in chips)
Seat 5: 9r7ZoBbAJj5IeyZ0q9BdzA ($12.90 in chips)
Seat 6: E2518gp4aFz1+kAgmGqeEg ($11.20 in chips)
Seat 7: wIZ377kjl2fHFGnS93o6bw ($13.95 in chips)
Seat 8: bXpVeaSTPBFSPJmeXxO7nw ($10.60 in chips)
wIZ377kjl2fHFGnS93o6bw: posts small blind $0.25
bXpVeaSTPBFSPJmeXxO7nw: posts big blind $0.50
*** HOLE CARDS ***
nV/P1jFY/CFMXOLWu7pYmA: folds
M+7+BTmX5vZatHVuoRB1nA: folds
3w0FbBQAKwQODwenKwZxXw: raises $0.50 to $1
zE9cVigS2nW/Ljy4K4bUQA: folds
9r7ZoBbAJj5IeyZ0q9BdzA: folds
E2518gp4aFz1+kAgmGqeEg: folds
wIZ377kjl2fHFGnS93o6bw: folds
bXpVeaSTPBFSPJmeXxO7nw: folds
3w0FbBQAKwQODwenKwZxXw collected $1.25 from pot
*** SUMMARY ***
Total pot $1.25 | Rake $0
Seat 1: nV/P1jFY/CFMXOLWu7pYmA folded before Flop (didn't bet)
Seat 2: M+7+BTmX5vZatHVuoRB1nA folded before Flop (didn't bet)
Seat 3: 3w0FbBQAKwQODwenKwZxXw collected ($1.25)
Seat 4: zE9cVigS2nW/Ljy4K4bUQA folded before Flop (didn't bet)
Seat 5: 9r7ZoBbAJj5IeyZ0q9BdzA folded before Flop (didn't bet)
Seat 6: E2518gp4aFz1+kAgmGqeEg (button) folded before Flop (didn't bet)
Seat 7: wIZ377kjl2fHFGnS93o6bw (small blind) folded before Flop
Seat 8: bXpVeaSTPBFSPJmeXxO7nw (big blind) folded before Flop



PokerStars Game #59938054332:  Hold'em No Limit ($0.25/$0.50) - 2009/07/01 0:05:58 ET
Table 'NCiXr0d5CEKBQr/cZgLhbA' 9-max Seat #9 is the button
Seat 1: RjBdQ6w31rgcy0o24VLR6w ($8.75 in chips)
Seat 2: ulxuJchBV9iguXg0FUonfg ($34.90 in chips)
Seat 3: xZCXQSXlrZkp3pZizzVXCw ($55.65 in chips)
Seat 4: CL4d+tvzcd4utdQxlPLOmg ($30.40 in chips)
Seat 5: zE9cVigS2nW/Ljy4K4bUQA ($32.70 in chips)
Seat 6: SKnJuWHScqetA/qG5p+wCg ($31.80 in chips)
Seat 7: EltNhVR1POPXhu/1E62t3A ($7.25 in chips)
Seat 8: E2518gp4aFz1+kAgmGqeEg ($10.95 in chips)
Seat 9: WpvT3OUSiZlpvs+mPXFqtQ ($7.45 in chips)
RjBdQ6w31rgcy0o24VLR6w: posts small blind $0.25
ulxuJchBV9iguXg0FUonfg: posts big blind $0.50
*** HOLE CARDS ***
xZCXQSXlrZkp3pZizzVXCw: folds
CL4d+tvzcd4utdQxlPLOmg: folds
zE9cVigS2nW/Ljy4K4bUQA: folds
SKnJuWHScqetA/qG5p+wCg: folds
EltNhVR1POPXhu/1E62t3A: calls $0.50
E2518gp4aFz1+kAgmGqeEg: folds
WpvT3OUSiZlpvs+mPXFqtQ: folds
RjBdQ6w31rgcy0o24VLR6w: folds
ulxuJchBV9iguXg0FUonfg: checks
*** FLOP *** [5h Ah Jc]
ulxuJchBV9iguXg0FUonfg: checks
EltNhVR1POPXhu/1E62t3A: checks
*** TURN *** [5h Ah Jc] [8h]
ulxuJchBV9iguXg0FUonfg: checks
EltNhVR1POPXhu/1E62t3A: checks
*** RIVER *** [5h Ah Jc 8h] [7s]
ulxuJchBV9iguXg0FUonfg: bets $0.50
EltNhVR1POPXhu/1E62t3A: calls $0.50
*** SHOW DOWN ***
ulxuJchBV9iguXg0FUonfg: shows [Kd 8d] (a pair of Eights)
EltNhVR1POPXhu/1E62t3A: mucks hand
ulxuJchBV9iguXg0FUonfg collected $2.15 from pot
*** SUMMARY ***
Total pot $2.25 | Rake $0.10
Board [5h Ah Jc 8h 7s]
Seat 1: RjBdQ6w31rgcy0o24VLR6w (small blind) folded before Flop
Seat 2: ulxuJchBV9iguXg0FUonfg (big blind) showed [Kd 8d] and won ($2.15) with a pair of Eights
Seat 3: xZCXQSXlrZkp3pZizzVXCw folded before Flop (didn't bet)
Seat 4: CL4d+tvzcd4utdQxlPLOmg folded before Flop (didn't bet)
Seat 5: zE9cVigS2nW/Ljy4K4bUQA folded before Flop (didn't bet)
Seat 6: SKnJuWHScqetA/qG5p+wCg folded before Flop (didn't bet)
Seat 7: EltNhVR1POPXhu/1E62t3A mucked
Seat 8: E2518gp4aFz1+kAgmGqeEg folded before Flop (didn't bet)
Seat 9: WpvT3OUSiZlpvs+mPXFqtQ (button) folded before Flop (didn't bet)



PokerStars Game #59938055286:  Hold'em No Limit ($0.25/$0.50) - 2009/07/01 0:05:59 ET
Table '0AhP5FLi4ySROVJ/ycT1Qw' 2-max Seat #1 is the button
Seat 1: VzCjk9xTOs+nLWp67vramg ($63.85 in chips)
Seat 2: 46qCyJ6evTkHo9al5sBMNA ($146.55 in chips)
VzCjk9xTOs+nLWp67vramg: posts small blind $0.25
46qCyJ6evTkHo9al5sBMNA: posts big blind $0.50
*** HOLE CARDS ***
VzCjk9xTOs+nLWp67vramg: raises $1 to $1.50
46qCyJ6evTkHo9al5sBMNA: raises $3 to $4.50
VzCjk9xTOs+nLWp67vramg: calls $3
*** FLOP *** [9s Ks 4d]
46qCyJ6evTkHo9al5sBMNA: bets $5
VzCjk9xTOs+nLWp67vramg: calls $5
*** TURN *** [9s Ks 4d] [6c]
46qCyJ6evTkHo9al5sBMNA: checks
VzCjk9xTOs+nLWp67vramg: bets $13
46qCyJ6evTkHo9al5sBMNA: folds
VzCjk9xTOs+nLWp67vramg collected $18.50 from pot
*** SUMMARY ***
Total pot $19 | Rake $0.50
Board [9s Ks 4d 6c]
Seat 1: VzCjk9xTOs+nLWp67vramg (button) (small blind) collected ($18.50)
Seat 2: 46qCyJ6evTkHo9al5sBMNA (big blind) folded on the Turn



PokerStars Game #59938055078:  Hold'em No Limit ($0.25/$0.50) - 2009/07/01 0:05:59 ET
Table '+dXkOAQyS8j9PQZusUTMpg' 2-max Seat #2 is the button
Seat 1: XFa6sBGjP2gxoIvxR3fZIg ($84.80 in chips)
Seat 2: 5IBeOgaApY1Bvzv2P8X4EA ($30.85 in chips)
5IBeOgaApY1Bvzv2P8X4EA: posts small blind $0.25
XFa6sBGjP2gxoIvxR3fZIg: posts big blind $0.50
*** HOLE CARDS ***
5IBeOgaApY1Bvzv2P8X4EA: raises $0.50 to $1
XFa6sBGjP2gxoIvxR3fZIg: raises $3.50 to $4.50
5IBeOgaApY1Bvzv2P8X4EA: calls $3.50
*** FLOP *** [2d Th Ac]
XFa6sBGjP2gxoIvxR3fZIg: bets $6
5IBeOgaApY1Bvzv2P8X4EA: calls $6
*** TURN *** [2d Th Ac] [Kc]
XFa6sBGjP2gxoIvxR3fZIg: checks
5IBeOgaApY1Bvzv2P8X4EA: checks
*** RIVER *** [2d Th Ac Kc] [7h]
XFa6sBGjP2gxoIvxR3fZIg: checks
5IBeOgaApY1Bvzv2P8X4EA: checks
*** SHOW DOWN ***
XFa6sBGjP2gxoIvxR3fZIg: shows [4c 4d] (a pair of Fours)
5IBeOgaApY1Bvzv2P8X4EA: shows [Tc Qs] (a pair of Tens)
5IBeOgaApY1Bvzv2P8X4EA collected $20.50 from pot
*** SUMMARY ***
Total pot $21 | Rake $0.50
Board [2d Th Ac Kc 7h]
Seat 1: XFa6sBGjP2gxoIvxR3fZIg (big blind) showed [4c 4d] and lost with a pair of Fours
Seat 2: 5IBeOgaApY1Bvzv2P8X4EA (button) (small blind) showed [Tc Qs] and won ($20.50) with a pair of Tens



PokerStars Game #59938055822:  Hold'em No Limit ($0.25/$0.50) - 2009/07/01 0:06:00 ET
Table 'c/CRn+68J3Y8KxD5g1ek2Q' 2-max Seat #1 is the button
Seat 1: 46qCyJ6evTkHo9al5sBMNA ($316.95 in chips)
Seat 2: BypVLsYQt3ePFm2xQL/dOA ($70.60 in chips)
46qCyJ6evTkHo9al5sBMNA: posts small blind $0.25
BypVLsYQt3ePFm2xQL/dOA: posts big blind $0.50
*** HOLE CARDS ***
46qCyJ6evTkHo9al5sBMNA: folds
BypVLsYQt3ePFm2xQL/dOA collected $0.50 from pot
BypVLsYQt3ePFm2xQL/dOA: doesn't show hand
*** SUMMARY ***
Total pot $0.50 | Rake $0
Seat 1: 46qCyJ6evTkHo9al5sBMNA (button) (small blind) folded before Flop
Seat 2: BypVLsYQt3ePFm2xQL/dOA (big blind) collected ($0.50)



PokerStars Game #59938055914:  Hold'em No Limit ($0.25/$0.50) - 2009/07/01 0:06:00 ET
Table 'ibNfFy0bCzuBaUORla0aGw' 9-max Seat #9 is the button
Seat 1: xZCXQSXlrZkp3pZizzVXCw ($57.20 in chips)
Seat 2: 90Wb75h3W1BRpbqVnuk8gw ($50 in chips)
Seat 3: dDaHs3X8+fe3bIkRU0cbrw ($27.30 in chips)
Seat 5: FRv75HO8CUsRZ1byEz06mQ ($15.35 in chips)
Seat 6: BmYrv3ec2k5d6pQq6iNaZw ($66.25 in chips)
Seat 7: mSD1pginDsyHG5PDfqzphw ($10 in chips)
Seat 8: xUrN9TWLq4m5V+OXY7KUUA ($50 in chips)
Seat 9: WpvT3OUSiZlpvs+mPXFqtQ ($8.75 in chips)
xZCXQSXlrZkp3pZizzVXCw: posts small blind $0.25
90Wb75h3W1BRpbqVnuk8gw: posts big blind $0.50
*** HOLE CARDS ***
dDaHs3X8+fe3bIkRU0cbrw: folds
FRv75HO8CUsRZ1byEz06mQ: folds
BmYrv3ec2k5d6pQq6iNaZw: folds
mSD1pginDsyHG5PDfqzphw: folds
xUrN9TWLq4m5V+OXY7KUUA: folds
WpvT3OUSiZlpvs+mPXFqtQ: folds
YBN054X4blmis+B2bBlC0g has returned
xZCXQSXlrZkp3pZizzVXCw: folds
90Wb75h3W1BRpbqVnuk8gw collected $0.50 from pot
*** SUMMARY ***
Total pot $0.50 | Rake $0
Seat 1: xZCXQSXlrZkp3pZizzVXCw (small blind) folded before Flop
Seat 2: 90Wb75h3W1BRpbqVnuk8gw (big blind) collected ($0.50)
Seat 3: dDaHs3X8+fe3bIkRU0cbrw folded before Flop (didn't bet)
Seat 5: FRv75HO8CUsRZ1byEz06mQ folded before Flop (didn't bet)
Seat 6: BmYrv3ec2k5d6pQq6iNaZw folded before Flop (didn't bet)
Seat 7: mSD1pginDsyHG5PDfqzphw folded before Flop (didn't bet)
Seat 8: xUrN9TWLq4m5V+OXY7KUUA folded before Flop (didn't bet)
Seat 9: WpvT3OUSiZlpvs+mPXFqtQ (button) folded before Flop (didn't bet)



PokerStars Game #59938060234:  Hold'em No Limit ($0.25/$0.50) - 2009/07/01 0:06:06 ET
Table 'lpxYasB1ClBSgTpCCITwhQ' 9-max Seat #6 is the button
Seat 1: ceq82/EkjUd/GFbf0YwGmA ($40.95 in chips)
Seat 3: E2518gp4aFz1+kAgmGqeEg ($10.75 in chips)
Seat 4: k1f0lS7tlMHCLGs0JT34Tg ($9.25 in chips)
Seat 5: bXpVeaSTPBFSPJmeXxO7nw ($9.25 in chips)
Seat 6: YPo1oggovmqSREegekaQYw ($18.10 in chips)
Seat 7: zE9cVigS2nW/Ljy4K4bUQA ($30 in chips)
Seat 8: o6JyUkbzCDw8tUabqtmnlg ($24.45 in chips)
Seat 9: mSD1pginDsyHG5PDfqzphw ($10.75 in chips)
zE9cVigS2nW/Ljy4K4bUQA: posts small blind $0.25
o6JyUkbzCDw8tUabqtmnlg: posts big blind $0.50
*** HOLE CARDS ***
mSD1pginDsyHG5PDfqzphw: folds
ceq82/EkjUd/GFbf0YwGmA: folds
E2518gp4aFz1+kAgmGqeEg: folds
k1f0lS7tlMHCLGs0JT34Tg: calls $0.50
bXpVeaSTPBFSPJmeXxO7nw: folds
YPo1oggovmqSREegekaQYw: folds
zE9cVigS2nW/Ljy4K4bUQA: folds
o6JyUkbzCDw8tUabqtmnlg: checks
*** FLOP *** [9s Qh Qd]
o6JyUkbzCDw8tUabqtmnlg: checks
k1f0lS7tlMHCLGs0JT34Tg: bets $0.50
o6JyUkbzCDw8tUabqtmnlg: raises $0.50 to $1
k1f0lS7tlMHCLGs0JT34Tg: calls $0.50
*** TURN *** [9s Qh Qd] [Td]
o6JyUkbzCDw8tUabqtmnlg: checks
k1f0lS7tlMHCLGs0JT34Tg: checks
*** RIVER *** [9s Qh Qd Td] [Ad]
o6JyUkbzCDw8tUabqtmnlg: bets $2
k1f0lS7tlMHCLGs0JT34Tg: folds
o6JyUkbzCDw8tUabqtmnlg collected $3.10 from pot
o6JyUkbzCDw8tUabqtmnlg: doesn't show hand
*** SUMMARY ***
Total pot $3.25 | Rake $0.15
Board [9s Qh Qd Td Ad]
Seat 1: ceq82/EkjUd/GFbf0YwGmA folded before Flop (didn't bet)
Seat 3: E2518gp4aFz1+kAgmGqeEg folded before Flop (didn't bet)
Seat 4: k1f0lS7tlMHCLGs0JT34Tg folded on the River
Seat 5: bXpVeaSTPBFSPJmeXxO7nw folded before Flop (didn't bet)
Seat 6: YPo1oggovmqSREegekaQYw (button) folded before Flop (didn't bet)
Seat 7: zE9cVigS2nW/Ljy4K4bUQA (small blind) folded before Flop
Seat 8: o6JyUkbzCDw8tUabqtmnlg (big blind) collected ($3.10)
Seat 9: mSD1pginDsyHG5PDfqzphw folded before Flop (didn't bet)



PokerStars Game #59938060520:  Hold'em No Limit ($0.25/$0.50) - 2009/07/01 0:06:07 ET
Table 'mTxf8gPLgffN3Iwfm7Icfg' 2-max Seat #2 is the button
Seat 1: Do9Rlu1R5u/AcRtMTl8SYg ($70.40 in chips)
Seat 2: EMc5LPgVaded4Qc77vm0fw ($44.50 in chips)
EMc5LPgVaded4Qc77vm0fw: posts small blind $0.25
Do9Rlu1R5u/AcRtMTl8SYg: posts big blind $0.50
*** HOLE CARDS ***
EMc5LPgVaded4Qc77vm0fw: folds
Do9Rlu1R5u/AcRtMTl8SYg collected $0.50 from pot
Do9Rlu1R5u/AcRtMTl8SYg: doesn't show hand
*** SUMMARY ***
Total pot $0.50 | Rake $0
Seat 1: Do9Rlu1R5u/AcRtMTl8SYg (big blind) collected ($0.50)
Seat 2: EMc5LPgVaded4Qc77vm0fw (button) (small blind) folded before Flop



PokerStars Game #59938060662:  Hold'em No Limit ($0.25/$0.50) - 2009/07/01 0:06:07 ET
Table 'c/CRn+68J3Y8KxD5g1ek2Q' 2-max Seat #2 is the button
Seat 1: 46qCyJ6evTkHo9al5sBMNA ($316.70 in chips)
Seat 2: BypVLsYQt3ePFm2xQL/dOA ($70.85 in chips)
BypVLsYQt3ePFm2xQL/dOA: posts small blind $0.25
46qCyJ6evTkHo9al5sBMNA: posts big blind $0.50
*** HOLE CARDS ***
BypVLsYQt3ePFm2xQL/dOA: calls $0.25
46qCyJ6evTkHo9al5sBMNA: checks
*** FLOP *** [3c Ks Ts]
46qCyJ6evTkHo9al5sBMNA: checks
BypVLsYQt3ePFm2xQL/dOA: bets $0.50
46qCyJ6evTkHo9al5sBMNA: calls $0.50
*** TURN *** [3c Ks Ts] [4s]
46qCyJ6evTkHo9al5sBMNA: checks
BypVLsYQt3ePFm2xQL/dOA: bets $0.50
46qCyJ6evTkHo9al5sBMNA: calls $0.50
*** RIVER *** [3c Ks Ts 4s] [6d]
46qCyJ6evTkHo9al5sBMNA: checks
BypVLsYQt3ePFm2xQL/dOA: bets $1
46qCyJ6evTkHo9al5sBMNA: folds
BypVLsYQt3ePFm2xQL/dOA collected $2.90 from pot
BypVLsYQt3ePFm2xQL/dOA: doesn't show hand
*** SUMMARY ***
Total pot $3 | Rake $0.10
Board [3c Ks Ts 4s 6d]
Seat 1: 46qCyJ6evTkHo9al5sBMNA (big blind) folded on the River
Seat 2: BypVLsYQt3ePFm2xQL/dOA (button) (small blind) collected ($2.90)



PokerStars Game #59938062174:  Hold'em No Limit ($0.25/$0.50) - 2009/07/01 0:06:09 ET
Table 'lSisgp6H7Fg1hH5VfjEjYQ' 9-max Seat #5 is the button
Seat 1: pEW8B6uXbdR47kfljMQ3+Q ($40.45 in chips)
Seat 2: UrcnkQOiLVk8BlKDPJSy7Q ($53.85 in chips)
Seat 3: RjBdQ6w31rgcy0o24VLR6w ($13.15 in chips)
Seat 4: nvw9yQKhJT56lA9k+TLdhw ($11.95 in chips)
Seat 5: mSD1pginDsyHG5PDfqzphw ($11.10 in chips)
Seat 6: +k7T5ocke8UwavtgUHm+Cg ($28 in chips)
Seat 7: xyQ4CeZa3ug3ompz+5xSTg ($74.70 in chips)
Seat 9: 5JJVDlaiMnB004o/RqbZZQ ($28.50 in chips)
+k7T5ocke8UwavtgUHm+Cg: posts small blind $0.25
xyQ4CeZa3ug3ompz+5xSTg: posts big blind $0.50
bXpVeaSTPBFSPJmeXxO7nw: sits out
*** HOLE CARDS ***
5JJVDlaiMnB004o/RqbZZQ: raises $1.50 to $2
pEW8B6uXbdR47kfljMQ3+Q: folds
UrcnkQOiLVk8BlKDPJSy7Q: folds
RjBdQ6w31rgcy0o24VLR6w: folds
nvw9yQKhJT56lA9k+TLdhw: folds
mSD1pginDsyHG5PDfqzphw: raises $9.10 to $11.10 and is all-in
+k7T5ocke8UwavtgUHm+Cg: folds
xyQ4CeZa3ug3ompz+5xSTg: folds
5JJVDlaiMnB004o/RqbZZQ: calls $9.10
*** FLOP *** [4h Ah 8s]
*** TURN *** [4h Ah 8s] [9h]
*** RIVER *** [4h Ah 8s 9h] [Qc]
*** SHOW DOWN ***
5JJVDlaiMnB004o/RqbZZQ: shows [As Qh] (two pair, Aces and Queens)
mSD1pginDsyHG5PDfqzphw: mucks hand
5JJVDlaiMnB004o/RqbZZQ collected $21.85 from pot
*** SUMMARY ***
Total pot $22.95 | Rake $1.10
Board [4h Ah 8s 9h Qc]
Seat 1: pEW8B6uXbdR47kfljMQ3+Q folded before Flop (didn't bet)
Seat 2: UrcnkQOiLVk8BlKDPJSy7Q folded before Flop (didn't bet)
Seat 3: RjBdQ6w31rgcy0o24VLR6w folded before Flop (didn't bet)
Seat 4: nvw9yQKhJT56lA9k+TLdhw folded before Flop (didn't bet)
Seat 5: mSD1pginDsyHG5PDfqzphw (button) mucked
Seat 6: +k7T5ocke8UwavtgUHm+Cg (small blind) folded before Flop
Seat 7: xyQ4CeZa3ug3ompz+5xSTg (big blind) folded before Flop
Seat 9: 5JJVDlaiMnB004o/RqbZZQ showed [As Qh] and won ($21.85) with two pair, Aces and Queens



PokerStars Game #59938062568:  Hold'em No Limit ($0.25/$0.50) - 2009/07/01 0:06:10 ET
Table 'E7bWJ45aoFXRpyRv2gw+Ig' 2-max Seat #1 is the button
Seat 1: FRkiRasEGlHUeLrEl+k/nA ($66.05 in chips)
Seat 2: 3Wro85I7472vJ4Wkpneo9A ($58.90 in chips)
FRkiRasEGlHUeLrEl+k/nA: posts small blind $0.25
3Wro85I7472vJ4Wkpneo9A: posts big blind $0.50
*** HOLE CARDS ***
FRkiRasEGlHUeLrEl+k/nA: raises $1 to $1.50
3Wro85I7472vJ4Wkpneo9A: calls $1
*** FLOP *** [Qc 6s 9d]
3Wro85I7472vJ4Wkpneo9A: checks
FRkiRasEGlHUeLrEl+k/nA: bets $1.50
3Wro85I7472vJ4Wkpneo9A: raises $3.50 to $5
FRkiRasEGlHUeLrEl+k/nA: folds
3Wro85I7472vJ4Wkpneo9A collected $5.75 from pot
3Wro85I7472vJ4Wkpneo9A: doesn't show hand
*** SUMMARY ***
Total pot $6 | Rake $0.25
Board [Qc 6s 9d]
Seat 1: FRkiRasEGlHUeLrEl+k/nA (button) (small blind) folded on the Flop
Seat 2: 3Wro85I7472vJ4Wkpneo9A (big blind) collected ($5.75)



PokerStars Game #59938064818:  Hold'em No Limit ($0.25/$0.50) - 2009/07/01 0:06:13 ET
Table 'mTxf8gPLgffN3Iwfm7Icfg' 2-max Seat #1 is the button
Seat 1: Do9Rlu1R5u/AcRtMTl8SYg ($70.65 in chips)
Seat 2: EMc5LPgVaded4Qc77vm0fw ($44.25 in chips)
Do9Rlu1R5u/AcRtMTl8SYg: posts small blind $0.25
EMc5LPgVaded4Qc77vm0fw: posts big blind $0.50
*** HOLE CARDS ***
Do9Rlu1R5u/AcRtMTl8SYg: folds
EMc5LPgVaded4Qc77vm0fw collected $0.50 from pot
EMc5LPgVaded4Qc77vm0fw: doesn't show hand
*** SUMMARY ***
Total pot $0.50 | Rake $0
Seat 1: Do9Rlu1R5u/AcRtMTl8SYg (button) (small blind) folded before Flop
Seat 2: EMc5LPgVaded4Qc77vm0fw (big blind) collected ($0.50)



PokerStars Game #59938064790:  Hold'em No Limit ($0.25/$0.50) - 2009/07/01 0:06:13 ET
Table 'oxUN1yBuOHNrPf4xoy4aXw' 2-max Seat #1 is the button
Seat 1: ndd1nfncBkWNitBnsfCoVQ ($65.10 in chips)
Seat 2: mba14ZHNZ0/GoMe+gAVYmw ($40 in chips)
ndd1nfncBkWNitBnsfCoVQ: posts small blind $0.25
mba14ZHNZ0/GoMe+gAVYmw: posts big blind $0.50
*** HOLE CARDS ***
ndd1nfncBkWNitBnsfCoVQ: raises $1 to $1.50
mba14ZHNZ0/GoMe+gAVYmw: folds
ndd1nfncBkWNitBnsfCoVQ collected $1 from pot
ndd1nfncBkWNitBnsfCoVQ: doesn't show hand
*** SUMMARY ***
Total pot $1 | Rake $0
Seat 1: ndd1nfncBkWNitBnsfCoVQ (button) (small blind) collected ($1)
Seat 2: mba14ZHNZ0/GoMe+gAVYmw (big blind) folded before Flop



PokerStars Game #59938064810:  Hold'em No Limit ($0.25/$0.50) - 2009/07/01 0:06:13 ET
Table 'otvGDROEDdqsabxskT79qg' 9-max Seat #4 is the button
Seat 1: LM/g4VPDfD+0JhpH9Q/3fw ($26.55 in chips)
Seat 2: cCjTzH9jio8607WzjcfXlg ($47.10 in chips)
Seat 3: +k7T5ocke8UwavtgUHm+Cg ($52.35 in chips)
Seat 4: MG90wfSJZnOejs/KD3vlQQ ($50 in chips)
Seat 5: YPo1oggovmqSREegekaQYw ($11.75 in chips)
Seat 7: C7+tBppJrKgd/r+tuKUIpA ($46.30 in chips)
Seat 8: NnQCepdIR/AOUQn1yhYx6Q ($9.25 in chips)
Seat 9: KcY3X8YpD74Kw1RHkx/g4A ($38.85 in chips)
YPo1oggovmqSREegekaQYw: posts small blind $0.25
C7+tBppJrKgd/r+tuKUIpA: posts big blind $0.50
*** HOLE CARDS ***
NnQCepdIR/AOUQn1yhYx6Q: folds
KcY3X8YpD74Kw1RHkx/g4A: folds
LM/g4VPDfD+0JhpH9Q/3fw: folds
cCjTzH9jio8607WzjcfXlg: folds
+k7T5ocke8UwavtgUHm+Cg: folds
MG90wfSJZnOejs/KD3vlQQ: raises $1 to $1.50
YPo1oggovmqSREegekaQYw: raises $2.50 to $4
C7+tBppJrKgd/r+tuKUIpA: calls $3.50
NnQCepdIR/AOUQn1yhYx6Q leaves the table
MG90wfSJZnOejs/KD3vlQQ: folds
*** FLOP *** [Ks 3c Jd]
YPo1oggovmqSREegekaQYw: checks
C7+tBppJrKgd/r+tuKUIpA: checks
*** TURN *** [Ks 3c Jd] [3h]
YPo1oggovmqSREegekaQYw: bets $4
C7+tBppJrKgd/r+tuKUIpA: folds
YPo1oggovmqSREegekaQYw collected $9.05 from pot
*** SUMMARY ***
Total pot $9.50 | Rake $0.45
Board [Ks 3c Jd 3h]
Seat 1: LM/g4VPDfD+0JhpH9Q/3fw folded before Flop (didn't bet)
Seat 2: cCjTzH9jio8607WzjcfXlg folded before Flop (didn't bet)
Seat 3: +k7T5ocke8UwavtgUHm+Cg folded before Flop (didn't bet)
Seat 4: MG90wfSJZnOejs/KD3vlQQ (button) folded before Flop
Seat 5: YPo1oggovmqSREegekaQYw (small blind) collected ($9.05)
Seat 7: C7+tBppJrKgd/r+tuKUIpA (big blind) folded on the Turn
Seat 8: NnQCepdIR/AOUQn1yhYx6Q folded before Flop (didn't bet)
Seat 9: KcY3X8YpD74Kw1RHkx/g4A folded before Flop (didn't bet)



PokerStars Game #59938065824:  Hold'em No Limit ($0.25/$0.50) - 2009/07/01 0:06:14 ET
Table 'tyR5AZNKV8Aadbrnrnlg7g' 6-max Seat #6 is the button
Seat 1: R+KjpH/wSjDLhtIy9+edNA ($38.75 in chips)
Seat 2: 58zdeSBSuSFX/qZfhc7YmA ($32.95 in chips)
Seat 3: jUhx+m+V7qfbLZTjgwZByg ($44.75 in chips)
Seat 4: Rt6KgtZ8YaJoTc3FPim00w ($50 in chips)
Seat 5: EIg3r3fRFKG2HhgpDlIJHg ($9.55 in chips)
Seat 6: DMQLAmut/l19xN5STQndFg ($20.45 in chips)
R+KjpH/wSjDLhtIy9+edNA: posts small blind $0.25
58zdeSBSuSFX/qZfhc7YmA: posts big blind $0.50
*** HOLE CARDS ***
jUhx+m+V7qfbLZTjgwZByg: folds
Rt6KgtZ8YaJoTc3FPim00w: folds
EIg3r3fRFKG2HhgpDlIJHg: calls $0.50
DMQLAmut/l19xN5STQndFg: calls $0.50
R+KjpH/wSjDLhtIy9+edNA: calls $0.25
58zdeSBSuSFX/qZfhc7YmA: checks
*** FLOP *** [5h Qs 5s]
R+KjpH/wSjDLhtIy9+edNA: checks
58zdeSBSuSFX/qZfhc7YmA: checks
EIg3r3fRFKG2HhgpDlIJHg: bets $1
DMQLAmut/l19xN5STQndFg: folds
R+KjpH/wSjDLhtIy9+edNA: folds
58zdeSBSuSFX/qZfhc7YmA: folds
EIg3r3fRFKG2HhgpDlIJHg collected $1.90 from pot
*** SUMMARY ***
Total pot $2 | Rake $0.10
Board [5h Qs 5s]
Seat 1: R+KjpH/wSjDLhtIy9+edNA (small blind) folded on the Flop
Seat 2: 58zdeSBSuSFX/qZfhc7YmA (big blind) folded on the Flop
Seat 3: jUhx+m+V7qfbLZTjgwZByg folded before Flop (didn't bet)
Seat 4: Rt6KgtZ8YaJoTc3FPim00w folded before Flop (didn't bet)
Seat 5: EIg3r3fRFKG2HhgpDlIJHg collected ($1.90)
Seat 6: DMQLAmut/l19xN5STQndFg (button) folded on the Flop



PokerStars Game #59938065360:  Hold'em No Limit ($0.25/$0.50) - 2009/07/01 0:06:14 ET
Table 'QOgaEqMcJ73pcUMMxoisUg' 6-max Seat #3 is the button
Seat 1: RFefXIDyFvNtJLq+CloCzA ($41.70 in chips)
Seat 3: wUZNozoIDYf+16hp4nn6dw ($31.25 in chips)
Seat 5: HoaSQCRso+nEyO5DUhGduw ($62.75 in chips)
Seat 6: s83dnhZ6VC53vY0/f6OV/g ($42.35 in chips)
HoaSQCRso+nEyO5DUhGduw: posts small blind $0.25
s83dnhZ6VC53vY0/f6OV/g: posts big blind $0.50
*** HOLE CARDS ***
RFefXIDyFvNtJLq+CloCzA: folds
wUZNozoIDYf+16hp4nn6dw: calls $0.50
HoaSQCRso+nEyO5DUhGduw: raises $1.50 to $2
s83dnhZ6VC53vY0/f6OV/g: calls $1.50
wUZNozoIDYf+16hp4nn6dw: calls $1.50
*** FLOP *** [7s 3h As]
HoaSQCRso+nEyO5DUhGduw: bets $3
s83dnhZ6VC53vY0/f6OV/g: raises $5 to $8
wUZNozoIDYf+16hp4nn6dw: folds
HoaSQCRso+nEyO5DUhGduw: folds
s83dnhZ6VC53vY0/f6OV/g collected $11.45 from pot
*** SUMMARY ***
Total pot $12 | Rake $0.55
Board [7s 3h As]
Seat 1: RFefXIDyFvNtJLq+CloCzA folded before Flop (didn't bet)
Seat 3: wUZNozoIDYf+16hp4nn6dw (button) folded on the Flop
Seat 5: HoaSQCRso+nEyO5DUhGduw (small blind) folded on the Flop
Seat 6: s83dnhZ6VC53vY0/f6OV/g (big blind) collected ($11.45)



PokerStars Game #59938067036:  Hold'em No Limit ($0.25/$0.50) - 2009/07/01 0:06:16 ET
Table 'X6IRCRTh+20gjz8aubWnwA' 9-max Seat #8 is the button
Seat 1: YPo1oggovmqSREegekaQYw ($9.70 in chips)
Seat 2: RjBdQ6w31rgcy0o24VLR6w ($11.45 in chips)
Seat 3: mSD1pginDsyHG5PDfqzphw ($10 in chips)
Seat 4: uw9QayAAxLM3Hb+HR7mSkg ($11 in chips)
Seat 5: aT3lRsb9BkkYp2fkD3LEtQ ($85.15 in chips)
Seat 6: /6In1zC3WtgwxDcueWzZWg ($51.10 in chips)
Seat 7: VBnpbzn0dIveV55qKvciew ($59.95 in chips)
Seat 8: BPMN9sOItJw6vWq3kypaYg ($24.65 in chips)
Seat 9: M+7+BTmX5vZatHVuoRB1nA ($84.35 in chips)
M+7+BTmX5vZatHVuoRB1nA: posts small blind $0.25
YPo1oggovmqSREegekaQYw: posts big blind $0.50
*** HOLE CARDS ***
RjBdQ6w31rgcy0o24VLR6w: folds
mSD1pginDsyHG5PDfqzphw: folds
uw9QayAAxLM3Hb+HR7mSkg: folds
aT3lRsb9BkkYp2fkD3LEtQ: folds
/6In1zC3WtgwxDcueWzZWg: folds
VBnpbzn0dIveV55qKvciew: folds
BPMN9sOItJw6vWq3kypaYg: folds
M+7+BTmX5vZatHVuoRB1nA: folds
YPo1oggovmqSREegekaQYw collected $0.50 from pot
YPo1oggovmqSREegekaQYw: doesn't show hand
*** SUMMARY ***
Total pot $0.50 | Rake $0
Seat 1: YPo1oggovmqSREegekaQYw (big blind) collected ($0.50)
Seat 2: RjBdQ6w31rgcy0o24VLR6w folded before Flop (didn't bet)
Seat 3: mSD1pginDsyHG5PDfqzphw folded before Flop (didn't bet)
Seat 4: uw9QayAAxLM3Hb+HR7mSkg folded before Flop (didn't bet)
Seat 5: aT3lRsb9BkkYp2fkD3LEtQ folded before Flop (didn't bet)
Seat 6: /6In1zC3WtgwxDcueWzZWg folded before Flop (didn't bet)
Seat 7: VBnpbzn0dIveV55qKvciew folded before Flop (didn't bet)
Seat 8: BPMN9sOItJw6vWq3kypaYg (button) folded before Flop (didn't bet)
Seat 9: M+7+BTmX5vZatHVuoRB1nA (small blind) folded before Flop



PokerStars Game #59938067590:  Hold'em No Limit ($0.25/$0.50) - 2009/07/01 0:06:17 ET
Table 'kgbJRsxfv64KrErDRBAkcw' 6-max Seat #3 is the button
Seat 1: YmWlPGOKFuJSoJZPW8a8IA ($81.80 in chips)
Seat 2: Q+thC23WCv1kJUJtH/+4Jw ($27.25 in chips)
Seat 3: T0Gx/FcQ5VH9u7XaOMX97A ($61.65 in chips)
Seat 4: qanMEqjABjWxC/JgQ/0l7w ($60.70 in chips)
Seat 5: SlTdlH14u+KVVINgxMwt+Q ($70.20 in chips)
Seat 6: DDfYzIrYT0t5R/hAJngtsg ($21.60 in chips)
qanMEqjABjWxC/JgQ/0l7w: posts small blind $0.25
SlTdlH14u+KVVINgxMwt+Q: posts big blind $0.50
*** HOLE CARDS ***
DDfYzIrYT0t5R/hAJngtsg: calls $0.50
YmWlPGOKFuJSoJZPW8a8IA: calls $0.50
Q+thC23WCv1kJUJtH/+4Jw: folds
T0Gx/FcQ5VH9u7XaOMX97A: folds
qanMEqjABjWxC/JgQ/0l7w: raises $2.50 to $3
SlTdlH14u+KVVINgxMwt+Q: folds
DDfYzIrYT0t5R/hAJngtsg: folds
YmWlPGOKFuJSoJZPW8a8IA: folds
qanMEqjABjWxC/JgQ/0l7w collected $2 from pot
*** SUMMARY ***
Total pot $2 | Rake $0
Seat 1: YmWlPGOKFuJSoJZPW8a8IA folded before Flop
Seat 2: Q+thC23WCv1kJUJtH/+4Jw folded before Flop (didn't bet)
Seat 3: T0Gx/FcQ5VH9u7XaOMX97A (button) folded before Flop (didn't bet)
Seat 4: qanMEqjABjWxC/JgQ/0l7w (small blind) collected ($2)
Seat 5: SlTdlH14u+KVVINgxMwt+Q (big blind) folded before Flop
Seat 6: DDfYzIrYT0t5R/hAJngtsg folded before Flop



PokerStars Game #59938069128:  Hold'em No Limit ($0.25/$0.50) - 2009/07/01 0:06:19 ET
Table 'mTxf8gPLgffN3Iwfm7Icfg' 2-max Seat #2 is the button
Seat 1: Do9Rlu1R5u/AcRtMTl8SYg ($70.40 in chips)
Seat 2: EMc5LPgVaded4Qc77vm0fw ($44.50 in chips)
EMc5LPgVaded4Qc77vm0fw: posts small blind $0.25
Do9Rlu1R5u/AcRtMTl8SYg: posts big blind $0.50
*** HOLE CARDS ***
EMc5LPgVaded4Qc77vm0fw: calls $0.25
Do9Rlu1R5u/AcRtMTl8SYg: checks
*** FLOP *** [3s Td 6s]
Do9Rlu1R5u/AcRtMTl8SYg: checks
EMc5LPgVaded4Qc77vm0fw: checks
*** TURN *** [3s Td 6s] [Ad]
Do9Rlu1R5u/AcRtMTl8SYg: checks
EMc5LPgVaded4Qc77vm0fw: checks
*** RIVER *** [3s Td 6s Ad] [Qh]
Do9Rlu1R5u/AcRtMTl8SYg: bets $0.50
EMc5LPgVaded4Qc77vm0fw: calls $0.50
*** SHOW DOWN ***
Do9Rlu1R5u/AcRtMTl8SYg: shows [2d Qs] (a pair of Queens)
EMc5LPgVaded4Qc77vm0fw: mucks hand
Do9Rlu1R5u/AcRtMTl8SYg collected $1.95 from pot
*** SUMMARY ***
Total pot $2 | Rake $0.05
Board [3s Td 6s Ad Qh]
Seat 1: Do9Rlu1R5u/AcRtMTl8SYg (big blind) showed [2d Qs] and won ($1.95) with a pair of Queens
Seat 2: EMc5LPgVaded4Qc77vm0fw (button) (small blind) mucked



PokerStars Game #59938069050:  Hold'em No Limit ($0.25/$0.50) - 2009/07/01 0:06:19 ET
Table 'Vdlc9wqYcHTUhtdyN7CuJw' 2-max Seat #1 is the button
Seat 1: yBO+mXB6m/rCft2ErwGf/Q ($64 in chips)
Seat 2: sa0qgETiL3HNbdfGlnKHTA ($50.35 in chips)
yBO+mXB6m/rCft2ErwGf/Q: posts small blind $0.25
sa0qgETiL3HNbdfGlnKHTA: posts big blind $0.50
*** HOLE CARDS ***
yBO+mXB6m/rCft2ErwGf/Q: raises $1 to $1.50
sa0qgETiL3HNbdfGlnKHTA: raises $3 to $4.50
yBO+mXB6m/rCft2ErwGf/Q: calls $3
*** FLOP *** [Qd 7h Kc]
sa0qgETiL3HNbdfGlnKHTA: bets $2
yBO+mXB6m/rCft2ErwGf/Q: calls $2
*** TURN *** [Qd 7h Kc] [3d]
sa0qgETiL3HNbdfGlnKHTA: checks
yBO+mXB6m/rCft2ErwGf/Q: bets $3
sa0qgETiL3HNbdfGlnKHTA: raises $3 to $6
yBO+mXB6m/rCft2ErwGf/Q: calls $3
*** RIVER *** [Qd 7h Kc 3d] [Qs]
sa0qgETiL3HNbdfGlnKHTA: bets $6.50
yBO+mXB6m/rCft2ErwGf/Q: calls $6.50
*** SHOW DOWN ***
sa0qgETiL3HNbdfGlnKHTA: shows [As Qc] (three of a kind, Queens)
yBO+mXB6m/rCft2ErwGf/Q: shows [Ks 8s] (two pair, Kings and Queens)
sa0qgETiL3HNbdfGlnKHTA collected $37.50 from pot
*** SUMMARY ***
Total pot $38 | Rake $0.50
Board [Qd 7h Kc 3d Qs]
Seat 1: yBO+mXB6m/rCft2ErwGf/Q (button) (small blind) showed [Ks 8s] and lost with two pair, Kings and Queens
Seat 2: sa0qgETiL3HNbdfGlnKHTA (big blind) showed [As Qc] and won ($37.50) with three of a kind, Queens



PokerStars Game #59938069184:  Hold'em No Limit ($0.25/$0.50) - 2009/07/01 0:06:19 ET
Table 'raOT4/ipuZgzjfKHC+jD9g' 2-max Seat #1 is the button
Seat 1: IuwLemwLhc9fvrwBGs0AMA ($11.40 in chips)
Seat 2: Udr5juWSWUgTu1NlRhjMdA ($12.45 in chips)
IuwLemwLhc9fvrwBGs0AMA: posts small blind $0.25
Udr5juWSWUgTu1NlRhjMdA: posts big blind $0.50
*** HOLE CARDS ***
IuwLemwLhc9fvrwBGs0AMA: folds
Udr5juWSWUgTu1NlRhjMdA collected $0.50 from pot
Udr5juWSWUgTu1NlRhjMdA: doesn't show hand
*** SUMMARY ***
Total pot $0.50 | Rake $0
Seat 1: IuwLemwLhc9fvrwBGs0AMA (button) (small blind) folded before Flop
Seat 2: Udr5juWSWUgTu1NlRhjMdA (big blind) collected ($0.50)



PokerStars Game #59938070152:  Hold'em No Limit ($0.25/$0.50) - 2009/07/01 0:06:20 ET
Table 'oxUN1yBuOHNrPf4xoy4aXw' 2-max Seat #2 is the button
Seat 1: ndd1nfncBkWNitBnsfCoVQ ($65.60 in chips)
Seat 2: mba14ZHNZ0/GoMe+gAVYmw ($39.50 in chips)
mba14ZHNZ0/GoMe+gAVYmw: posts small blind $0.25
ndd1nfncBkWNitBnsfCoVQ: posts big blind $0.50
*** HOLE CARDS ***
mba14ZHNZ0/GoMe+gAVYmw: raises $0.50 to $1
ndd1nfncBkWNitBnsfCoVQ: calls $0.50
*** FLOP *** [2c 7d 8d]
ndd1nfncBkWNitBnsfCoVQ: checks
mba14ZHNZ0/GoMe+gAVYmw: bets $1.50
ndd1nfncBkWNitBnsfCoVQ: raises $3.50 to $5
mba14ZHNZ0/GoMe+gAVYmw: calls $3.50
*** TURN *** [2c 7d 8d] [9d]
ndd1nfncBkWNitBnsfCoVQ: bets $8
mba14ZHNZ0/GoMe+gAVYmw: folds
ndd1nfncBkWNitBnsfCoVQ collected $11.50 from pot
ndd1nfncBkWNitBnsfCoVQ: doesn't show hand
*** SUMMARY ***
Total pot $12 | Rake $0.50
Board [2c 7d 8d 9d]
Seat 1: ndd1nfncBkWNitBnsfCoVQ (big blind) collected ($11.50)
Seat 2: mba14ZHNZ0/GoMe+gAVYmw (button) (small blind) folded on the Turn



PokerStars Game #59938070746:  Hold'em No Limit ($0.25/$0.50) - 2009/07/01 0:06:21 ET
Table 'tpZbcIvqh/6WmfR/i5IE3A' 9-max Seat #7 is the button
Seat 1: nV/P1jFY/CFMXOLWu7pYmA ($14.45 in chips)
Seat 2: M+7+BTmX5vZatHVuoRB1nA ($45.90 in chips)
Seat 3: 3w0FbBQAKwQODwenKwZxXw ($77.70 in chips)
Seat 4: zE9cVigS2nW/Ljy4K4bUQA ($30 in chips)
Seat 5: 9r7ZoBbAJj5IeyZ0q9BdzA ($12.90 in chips)
Seat 6: E2518gp4aFz1+kAgmGqeEg ($11.20 in chips)
Seat 7: wIZ377kjl2fHFGnS93o6bw ($13.70 in chips)
Seat 8: bXpVeaSTPBFSPJmeXxO7nw ($10.10 in chips)
bXpVeaSTPBFSPJmeXxO7nw: posts small blind $0.25
nV/P1jFY/CFMXOLWu7pYmA: posts big blind $0.50
*** HOLE CARDS ***
M+7+BTmX5vZatHVuoRB1nA: folds
3w0FbBQAKwQODwenKwZxXw: folds
zE9cVigS2nW/Ljy4K4bUQA: raises $1 to $1.50
9r7ZoBbAJj5IeyZ0q9BdzA: folds
E2518gp4aFz1+kAgmGqeEg: folds
wIZ377kjl2fHFGnS93o6bw: folds
bXpVeaSTPBFSPJmeXxO7nw: folds
nV/P1jFY/CFMXOLWu7pYmA: folds
zE9cVigS2nW/Ljy4K4bUQA collected $1.25 from pot
zE9cVigS2nW/Ljy4K4bUQA: doesn't show hand
*** SUMMARY ***
Total pot $1.25 | Rake $0
Seat 1: nV/P1jFY/CFMXOLWu7pYmA (big blind) folded before Flop
Seat 2: M+7+BTmX5vZatHVuoRB1nA folded before Flop (didn't bet)
Seat 3: 3w0FbBQAKwQODwenKwZxXw folded before Flop (didn't bet)
Seat 4: zE9cVigS2nW/Ljy4K4bUQA collected ($1.25)
Seat 5: 9r7ZoBbAJj5IeyZ0q9BdzA folded before Flop (didn't bet)
Seat 6: E2518gp4aFz1+kAgmGqeEg folded before Flop (didn't bet)
Seat 7: wIZ377kjl2fHFGnS93o6bw (button) folded before Flop (didn't bet)
Seat 8: bXpVeaSTPBFSPJmeXxO7nw (small blind) folded before Flop



PokerStars Game #59938070622:  Hold'em No Limit ($0.25/$0.50) - 2009/07/01 0:06:21 ET
Table 'BCN5su+SsXiy1zRMJi0SJw' 6-max Seat #1 is the button
Seat 1: WyeokAqR0q9nADSkWpbxHw ($39.05 in chips)
Seat 2: QfV2JJlmEKgD5jYPV+a33A ($158.90 in chips)
Seat 4: 6Wb8PlO2kM4fnSim7p4Mrw ($11.10 in chips)
Seat 5: TTx3CHxyi0SObcHyMJRp5w ($39.10 in chips)
Seat 6: zHXshyreKwJVq3N3U+K9uQ ($51.30 in chips)
QfV2JJlmEKgD5jYPV+a33A: posts small blind $0.25
6Wb8PlO2kM4fnSim7p4Mrw: posts big blind $0.50
*** HOLE CARDS ***
TTx3CHxyi0SObcHyMJRp5w: folds
zHXshyreKwJVq3N3U+K9uQ: folds
WyeokAqR0q9nADSkWpbxHw: folds
QfV2JJlmEKgD5jYPV+a33A: folds
6Wb8PlO2kM4fnSim7p4Mrw collected $0.50 from pot
*** SUMMARY ***
Total pot $0.50 | Rake $0
Seat 1: WyeokAqR0q9nADSkWpbxHw (button) folded before Flop (didn't bet)
Seat 2: QfV2JJlmEKgD5jYPV+a33A (small blind) folded before Flop
Seat 4: 6Wb8PlO2kM4fnSim7p4Mrw (big blind) collected ($0.50)
Seat 5: TTx3CHxyi0SObcHyMJRp5w folded before Flop (didn't bet)
Seat 6: zHXshyreKwJVq3N3U+K9uQ folded before Flop (didn't bet)



PokerStars Game #59938070854:  Hold'em No Limit ($0.25/$0.50) - 2009/07/01 0:06:21 ET
Table 'eMxdLyFDf28E0wit6gm3Uw' 6-max Seat #1 is the button
Seat 1: tnD/64LagZ9qPaeOQVjVZg ($10 in chips)
Seat 2: jwuKQ1S3U4NnzMQn3E3dgw ($65.40 in chips)
Seat 4: crjGpJEzSZgD38FoE3VMGg ($50 in chips)
Seat 5: X0X97o2fDAPiGx6o1gahsw ($58.80 in chips)
Seat 6: L0aIPg7qefDQjdJo3HCVEA ($7.50 in chips)
jwuKQ1S3U4NnzMQn3E3dgw: posts small blind $0.25
crjGpJEzSZgD38FoE3VMGg: posts big blind $0.50
*** HOLE CARDS ***
X0X97o2fDAPiGx6o1gahsw: folds
L0aIPg7qefDQjdJo3HCVEA: folds
tnD/64LagZ9qPaeOQVjVZg: raises $9.50 to $10 and is all-in
jwuKQ1S3U4NnzMQn3E3dgw: folds
crjGpJEzSZgD38FoE3VMGg: folds
tnD/64LagZ9qPaeOQVjVZg collected $1.25 from pot
*** SUMMARY ***
Total pot $1.25 | Rake $0
Seat 1: tnD/64LagZ9qPaeOQVjVZg (button) collected ($1.25)
Seat 2: jwuKQ1S3U4NnzMQn3E3dgw (small blind) folded before Flop
Seat 4: crjGpJEzSZgD38FoE3VMGg (big blind) folded before Flop
Seat 5: X0X97o2fDAPiGx6o1gahsw folded before Flop (didn't bet)
Seat 6: L0aIPg7qefDQjdJo3HCVEA folded before Flop (didn't bet)



PokerStars Game #59938073964:  Hold'em No Limit ($0.25/$0.50) - 2009/07/01 0:06:26 ET
Table 'raOT4/ipuZgzjfKHC+jD9g' 2-max Seat #2 is the button
Seat 1: IuwLemwLhc9fvrwBGs0AMA ($11.15 in chips)
Seat 2: Udr5juWSWUgTu1NlRhjMdA ($12.70 in chips)
Udr5juWSWUgTu1NlRhjMdA: posts small blind $0.25
IuwLemwLhc9fvrwBGs0AMA: posts big blind $0.50
*** HOLE CARDS ***
Udr5juWSWUgTu1NlRhjMdA: folds
IuwLemwLhc9fvrwBGs0AMA collected $0.50 from pot
*** SUMMARY ***
Total pot $0.50 | Rake $0
Seat 1: IuwLemwLhc9fvrwBGs0AMA (big blind) collected ($0.50)
Seat 2: Udr5juWSWUgTu1NlRhjMdA (button) (small blind) folded before Flop



PokerStars Game #59938077730:  Hold'em No Limit ($0.25/$0.50) - 2009/07/01 0:06:31 ET
Table '+dXkOAQyS8j9PQZusUTMpg' 2-max Seat #1 is the button
Seat 1: XFa6sBGjP2gxoIvxR3fZIg ($74.30 in chips)
Seat 2: 5IBeOgaApY1Bvzv2P8X4EA ($40.85 in chips)
XFa6sBGjP2gxoIvxR3fZIg: posts small blind $0.25
5IBeOgaApY1Bvzv2P8X4EA: posts big blind $0.50
*** HOLE CARDS ***
XFa6sBGjP2gxoIvxR3fZIg: raises $1 to $1.50
5IBeOgaApY1Bvzv2P8X4EA: folds
XFa6sBGjP2gxoIvxR3fZIg collected $1 from pot
XFa6sBGjP2gxoIvxR3fZIg: doesn't show hand
*** SUMMARY ***
Total pot $1 | Rake $0
Seat 1: XFa6sBGjP2gxoIvxR3fZIg (button) (small blind) collected ($1)
Seat 2: 5IBeOgaApY1Bvzv2P8X4EA (big blind) folded before Flop



PokerStars Game #59938077650:  Hold'em No Limit ($0.25/$0.50) - 2009/07/01 0:06:31 ET
Table 'QOgaEqMcJ73pcUMMxoisUgErOuyGLI5PT3G5MnpHgC/g Seat #2 is the button
Seat 1: k6GJzKs7T7qvQggW9g8Pdw ($47.75 in chips)
Seat 2: RjBdQ6w31rgcy0o24VLR6w ($10.95 in chips)
Seat 3: xZCXQSXlrZkp3pZizzVXCw ($50 in chips)
Seat 4: U7aZzIYWjv3SL30KtikLbw ($48.95 in chips)
Seat 5: JwvquocWfhTVApN5t47LgA ($51.05 in chips)
Seat 6: zE9cVigS2nW/Ljy4K4bUQA ($31.35 in chips)
Seat 7: 90Wb75h3W1BRpbqVnuk8gw ($62.55 in chips)
Seat 8: ajP1NjIMdqQfpMbzHzvejw ($41.30 in chips)
Seat 9: J0W5D97jl5VLky+IoPvDeA ($67.80 in chips)
xZCXQSXlrZkp3pZizzVXCw: posts small blind $0.25
U7aZzIYWjv3SL30KtikLbw: posts big blind $0.50
*** HOLE CARDS ***
JwvquocWfhTVApN5t47LgA: folds
zE9cVigS2nW/Ljy4K4bUQA: folds
90Wb75h3W1BRpbqVnuk8gw: folds
ajP1NjIMdqQfpMbzHzvejw: folds
J0W5D97jl5VLky+IoPvDeA: folds
k6GJzKs7T7qvQggW9g8Pdw: folds
ajP1NjIMdqQfpMbzHzvejw leaves the table
RjBdQ6w31rgcy0o24VLR6w: folds
xZCXQSXlrZkp3pZizzVXCw: raises $1 to $1.50
U7aZzIYWjv3SL30KtikLbw: folds
xZCXQSXlrZkp3pZizzVXCw collected $1 from pot
*** SUMMARY ***
Total pot $1 | Rake $0
Seat 1: k6GJzKs7T7qvQggW9g8Pdw folded before Flop (didn't bet)
Seat 2: RjBdQ6w31rgcy0o24VLR6w (button) folded before Flop (didn't bet)
Seat 3: xZCXQSXlrZkp3pZizzVXCw (small blind) collected ($1)
Seat 4: U7aZzIYWjv3SL30KtikLbw (big blind) folded before Flop
Seat 5: JwvquocWfhTVApN5t47LgA folded before Flop (didn't bet)
Seat 6: zE9cVigS2nW/Ljy4K4bUQA folded before Flop (didn't bet)
Seat 7: 90Wb75h3W1BRpbqVnuk8gw folded before Flop (didn't bet)
Seat 8: ajP1NjIMdqQfpMbzHzvejw folded before Flop (didn't bet)
Seat 9: J0W5D97jl5VLky+IoPvDeA folded before Flop (didn't bet)



PokerStars Game #59938079496:  Hold'em No Limit ($0.25/$0.50) - 2009/07/01 0:06:33 ET
Table 'E7bWJ45aoFXRpyRv2gw+Ig' 2-max Seat #2 is the button
Seat 1: FRkiRasEGlHUeLrEl+k/nA ($63.05 in chips)
Seat 2: 3Wro85I7472vJ4Wkpneo9A ($61.65 in chips)
3Wro85I7472vJ4Wkpneo9A: posts small blind $0.25
FRkiRasEGlHUeLrEl+k/nA: posts big blind $0.50
*** HOLE CARDS ***
3Wro85I7472vJ4Wkpneo9A: folds
FRkiRasEGlHUeLrEl+k/nA collected $0.50 from pot
FRkiRasEGlHUeLrEl+k/nA: doesn't show hand
*** SUMMARY ***
Total pot $0.50 | Rake $0
Seat 1: FRkiRasEGlHUeLrEl+k/nA (big blind) collected ($0.50)
Seat 2: 3Wro85I7472vJ4Wkpneo9A (button) (small blind) folded before Flop



PokerStars Game #59938079098:  Hold'em No Limit ($0.25/$0.50) - 2009/07/01 0:06:33 ET
Table 'raOT4/ipuZgzjfKHC+jD9g' 2-max Seat #1 is the button
Seat 1: IuwLemwLhc9fvrwBGs0AMA ($11.40 in chips)
Seat 2: Udr5juWSWUgTu1NlRhjMdA ($12.45 in chips)
IuwLemwLhc9fvrwBGs0AMA: posts small blind $0.25
Udr5juWSWUgTu1NlRhjMdA: posts big blind $0.50
*** HOLE CARDS ***
IuwLemwLhc9fvrwBGs0AMA: folds
Udr5juWSWUgTu1NlRhjMdA collected $0.50 from pot
Udr5juWSWUgTu1NlRhjMdA: doesn't show hand
*** SUMMARY ***
Total pot $0.50 | Rake $0
Seat 1: IuwLemwLhc9fvrwBGs0AMA (button) (small blind) folded before Flop
Seat 2: Udr5juWSWUgTu1NlRhjMdA (big blind) collected ($0.50)



PokerStars Game #59938079188:  Hold'em No Limit ($0.25/$0.50) - 2009/07/01 0:06:33 ET
Table '5EmHi+fnatGQQShcNmzOZQ' 6-max Seat #2 is the button
Seat 1: SwPczQo3cOtwEzhJrfO2cQ ($22.30 in chips)
Seat 2: APwvTk5XojDXGoQLb4O5iA ($25.05 in chips)
Seat 3: J8dF2sYMvXUmAGUuSW9kwg ($35.05 in chips)
Seat 4: mFTuMjESuBcXHQ1ePkg/8A ($19.20 in chips)
Seat 5: kxPhs4ePFqMy52CInAJ2aw ($73.05 in chips)
Seat 6: 686aeHikcJlgKkSuIFdcXQ ($115.45 in chips)
J8dF2sYMvXUmAGUuSW9kwg: posts small blind $0.25
mFTuMjESuBcXHQ1ePkg/8A: posts big blind $0.50
*** HOLE CARDS ***
kxPhs4ePFqMy52CInAJ2aw: folds
686aeHikcJlgKkSuIFdcXQ: folds
SwPczQo3cOtwEzhJrfO2cQ: folds
APwvTk5XojDXGoQLb4O5iA: calls $0.50
J8dF2sYMvXUmAGUuSW9kwg: calls $0.25
mFTuMjESuBcXHQ1ePkg/8A: raises $1.50 to $2
APwvTk5XojDXGoQLb4O5iA: calls $1.50
J8dF2sYMvXUmAGUuSW9kwg: folds
*** FLOP *** [6h Ad 5h]
mFTuMjESuBcXHQ1ePkg/8A: checks
APwvTk5XojDXGoQLb4O5iA: bets $1.50
mFTuMjESuBcXHQ1ePkg/8A: folds
APwvTk5XojDXGoQLb4O5iA collected $4.30 from pot
*** SUMMARY ***
Total pot $4.50 | Rake $0.20
Board [6h Ad 5h]
Seat 1: SwPczQo3cOtwEzhJrfO2cQ folded before Flop (didn't bet)
Seat 2: APwvTk5XojDXGoQLb4O5iA (button) collected ($4.30)
Seat 3: J8dF2sYMvXUmAGUuSW9kwg (small blind) folded before Flop
Seat 4: mFTuMjESuBcXHQ1ePkg/8A (big blind) folded on the Flop
Seat 5: kxPhs4ePFqMy52CInAJ2aw folded before Flop (didn't bet)
Seat 6: 686aeHikcJlgKkSuIFdcXQ folded before Flop (didn't bet)



PokerStars Game #59938079094:  Hold'em No Limit ($0.25/$0.50) - 2009/07/01 0:06:33 ET
Table 'kgbJRsxfv64KrErDRBAkcw' 6-max Seat #4 is the button
Seat 1: YmWlPGOKFuJSoJZPW8a8IA ($81.30 in chips)
Seat 2: Q+thC23WCv1kJUJtH/+4Jw ($27.25 in chips)
Seat 3: T0Gx/FcQ5VH9u7XaOMX97A ($61.65 in chips)
Seat 4: qanMEqjABjWxC/JgQ/0l7w ($62.20 in chips)
Seat 5: SlTdlH14u+KVVINgxMwt+Q ($69.70 in chips)
Seat 6: DDfYzIrYT0t5R/hAJngtsg ($21.10 in chips)
SlTdlH14u+KVVINgxMwt+Q: posts small blind $0.25
DDfYzIrYT0t5R/hAJngtsg: posts big blind $0.50
*** HOLE CARDS ***
YmWlPGOKFuJSoJZPW8a8IA: folds
Q+thC23WCv1kJUJtH/+4Jw: calls $0.50
T0Gx/FcQ5VH9u7XaOMX97A: folds
qanMEqjABjWxC/JgQ/0l7w: folds
SlTdlH14u+KVVINgxMwt+Q: folds
DDfYzIrYT0t5R/hAJngtsg: checks
*** FLOP *** [3s 2h 5c]
DDfYzIrYT0t5R/hAJngtsg: checks
Q+thC23WCv1kJUJtH/+4Jw: checks
*** TURN *** [3s 2h 5c] [8h]
DDfYzIrYT0t5R/hAJngtsg: checks
Q+thC23WCv1kJUJtH/+4Jw: bets $1
DDfYzIrYT0t5R/hAJngtsg: calls $1
*** RIVER *** [3s 2h 5c 8h] [4s]
DDfYzIrYT0t5R/hAJngtsg: checks
Q+thC23WCv1kJUJtH/+4Jw: bets $1.50
DDfYzIrYT0t5R/hAJngtsg: folds
Q+thC23WCv1kJUJtH/+4Jw collected $3.10 from pot
*** SUMMARY ***
Total pot $3.25 | Rake $0.15
Board [3s 2h 5c 8h 4s]
Seat 1: YmWlPGOKFuJSoJZPW8a8IA folded before Flop (didn't bet)
Seat 2: Q+thC23WCv1kJUJtH/+4Jw collected ($3.10)
Seat 3: T0Gx/FcQ5VH9u7XaOMX97A folded before Flop (didn't bet)
Seat 4: qanMEqjABjWxC/JgQ/0l7w (button) folded before Flop (didn't bet)
Seat 5: SlTdlH14u+KVVINgxMwt+Q (small blind) folded before Flop
Seat 6: DDfYzIrYT0t5R/hAJngtsg (big blind) folded on the River



PokerStars Game #59938080746:  Hold'em No Limit ($0.25/$0.50) - 2009/07/01 0:06:35 ET
Table '3FhG0gl3kMX3wBEEqj+wnQ' 9-max Seat #7 is the button
Seat 1: e0J9pdCNUDTCG031RnXqLA ($33 in chips)
Seat 2: 4dl3YNqZ6Houm2jZAzDmRg ($17.70 in chips)
Seat 3: bXpVeaSTPBFSPJmeXxO7nw ($10.75 in chips)
Seat 4: bz4LMfV0GGl/MJ/ABXuPmg ($20.40 in chips)
Seat 5: avsQkZXsRKnWa7gkjVNvog ($32.50 in chips)
Seat 6: 5JJVDlaiMnB004o/RqbZZQ ($26.75 in chips)
Seat 7: 6XkTu4ahxzHnvjjc1R8YjQ ($9.25 in chips)
Seat 8: j3K/Jujr7PY4ZM2RZvlH6A ($53.20 in chips)
Seat 9: tzoXBDwkkPV/XPJPkf963Q ($13.85 in chips)
j3K/Jujr7PY4ZM2RZvlH6A: posts small blind $0.25
tzoXBDwkkPV/XPJPkf963Q: posts big blind $0.50
*** HOLE CARDS ***
e0J9pdCNUDTCG031RnXqLA: folds
4dl3YNqZ6Houm2jZAzDmRg: calls $0.50
bXpVeaSTPBFSPJmeXxO7nw: folds
bz4LMfV0GGl/MJ/ABXuPmg: calls $0.50
avsQkZXsRKnWa7gkjVNvog: folds
5JJVDlaiMnB004o/RqbZZQ: folds
6XkTu4ahxzHnvjjc1R8YjQ: folds
j3K/Jujr7PY4ZM2RZvlH6A: folds
tzoXBDwkkPV/XPJPkf963Q: checks
*** FLOP *** [Kh 4c Qs]
tzoXBDwkkPV/XPJPkf963Q: checks
4dl3YNqZ6Houm2jZAzDmRg: checks
bz4LMfV0GGl/MJ/ABXuPmg: checks
*** TURN *** [Kh 4c Qs] [2d]
tzoXBDwkkPV/XPJPkf963Q: checks
4dl3YNqZ6Houm2jZAzDmRg: bets $1
bz4LMfV0GGl/MJ/ABXuPmg: calls $1
tzoXBDwkkPV/XPJPkf963Q: folds
*** RIVER *** [Kh 4c Qs 2d] [7c]
4dl3YNqZ6Houm2jZAzDmRg: bets $1.50
bz4LMfV0GGl/MJ/ABXuPmg: folds
4dl3YNqZ6Houm2jZAzDmRg collected $3.60 from pot
*** SUMMARY ***
Total pot $3.75 | Rake $0.15
Board [Kh 4c Qs 2d 7c]
Seat 1: e0J9pdCNUDTCG031RnXqLA folded before Flop (didn't bet)
Seat 2: 4dl3YNqZ6Houm2jZAzDmRg collected ($3.60)
Seat 3: bXpVeaSTPBFSPJmeXxO7nw folded before Flop (didn't bet)
Seat 4: bz4LMfV0GGl/MJ/ABXuPmg folded on the River
Seat 5: avsQkZXsRKnWa7gkjVNvog folded before Flop (didn't bet)
Seat 6: 5JJVDlaiMnB004o/RqbZZQ folded before Flop (didn't bet)
Seat 7: 6XkTu4ahxzHnvjjc1R8YjQ (button) folded before Flop (didn't bet)
Seat 8: j3K/Jujr7PY4ZM2RZvlH6A (small blind) folded before Flop
Seat 9: tzoXBDwkkPV/XPJPkf963Q (big blind) folded on the Turn



PokerStars Game #59938080938:  Hold'em No Limit ($0.25/$0.50) - 2009/07/01 0:06:35 ET
Table 'hSTs/dUsYLgJQuF2Onp0MQ' 6-max Seat #5 is the button
Seat 1: lWwl5C/UZOsWNubdUqghZw ($71.45 in chips)
Seat 3: vQOrJuXbLC3UZDVklY9bOA ($13.45 in chips)
Seat 4: L0aIPg7qefDQjdJo3HCVEA ($14.45 in chips)
Seat 5: 686aeHikcJlgKkSuIFdcXQ ($60.65 in chips)
Seat 6: +laPa9P7BjZKKnR0n+OmvA ($11.50 in chips)
+laPa9P7BjZKKnR0n+OmvA: posts small blind $0.25
lWwl5C/UZOsWNubdUqghZw: posts big blind $0.50
*** HOLE CARDS ***
vQOrJuXbLC3UZDVklY9bOA: folds
L0aIPg7qefDQjdJo3HCVEA: folds
686aeHikcJlgKkSuIFdcXQ: folds
fyJOjf+Vdie/rpWb1WExIg joins the table at seat #2
+laPa9P7BjZKKnR0n+OmvA: raises $1 to $1.50
lWwl5C/UZOsWNubdUqghZw: folds
+laPa9P7BjZKKnR0n+OmvA collected $1 from pot
*** SUMMARY ***
Total pot $1 | Rake $0
Seat 1: lWwl5C/UZOsWNubdUqghZw (big blind) folded before Flop
Seat 3: vQOrJuXbLC3UZDVklY9bOA folded before Flop (didn't bet)
Seat 4: L0aIPg7qefDQjdJo3HCVEA folded before Flop (didn't bet)
Seat 5: 686aeHikcJlgKkSuIFdcXQ (button) folded before Flop (didn't bet)
Seat 6: +laPa9P7BjZKKnR0n+OmvA (small blind) collected ($1)



PokerStars Game #59938081880:  Hold'em No Limit ($0.25/$0.50) - 2009/07/01 0:06:36 ET
Table 'YsnnHkamRzYqMOr2FlLY4w' 6-max Seat #5 is the button
Seat 1: crjGpJEzSZgD38FoE3VMGg ($50 in chips)
Seat 3: I+pG2m/dD5iYdbg9qx572g ($25 in chips)
Seat 4: 7Fue572p4ZIC85AJMQvaQw ($53.85 in chips)
Seat 5: lcQ7uuLf+WLGGy4Ve6VKKA ($41 in chips)
Seat 6: YmWlPGOKFuJSoJZPW8a8IA ($53.65 in chips)
YmWlPGOKFuJSoJZPW8a8IA: posts small blind $0.25
crjGpJEzSZgD38FoE3VMGg: posts big blind $0.50
*** HOLE CARDS ***
I+pG2m/dD5iYdbg9qx572g: folds
7Fue572p4ZIC85AJMQvaQw: folds
lcQ7uuLf+WLGGy4Ve6VKKA: folds
YmWlPGOKFuJSoJZPW8a8IA: folds
crjGpJEzSZgD38FoE3VMGg collected $0.50 from pot
crjGpJEzSZgD38FoE3VMGg: doesn't show hand
*** SUMMARY ***
Total pot $0.50 | Rake $0
Seat 1: crjGpJEzSZgD38FoE3VMGg (big blind) collected ($0.50)
Seat 3: I+pG2m/dD5iYdbg9qx572g folded before Flop (didn't bet)
Seat 4: 7Fue572p4ZIC85AJMQvaQw folded before Flop (didn't bet)
Seat 5: lcQ7uuLf+WLGGy4Ve6VKKA (button) folded before Flop (didn't bet)
Seat 6: YmWlPGOKFuJSoJZPW8a8IA (small blind) folded before Flop



PokerStars Game #59938082904:  Hold'em No Limit ($0.25/$0.50) - 2009/07/01 0:06:38 ET
Table '+dXkOAQyS8j9PQZusUTMpg' 2-max Seat #2 is the button
Seat 1: XFa6sBGjP2gxoIvxR3fZIg ($74.80 in chips)
Seat 2: 5IBeOgaApY1Bvzv2P8X4EA ($40.35 in chips)
5IBeOgaApY1Bvzv2P8X4EA: posts small blind $0.25
XFa6sBGjP2gxoIvxR3fZIg: posts big blind $0.50
*** HOLE CARDS ***
5IBeOgaApY1Bvzv2P8X4EA: calls $0.25
XFa6sBGjP2gxoIvxR3fZIg: raises $2 to $2.50
5IBeOgaApY1Bvzv2P8X4EA: calls $2
*** FLOP *** [Jd 3d 7h]
XFa6sBGjP2gxoIvxR3fZIg: bets $3.50
5IBeOgaApY1Bvzv2P8X4EA: calls $3.50
*** TURN *** [Jd 3d 7h] [Qs]
XFa6sBGjP2gxoIvxR3fZIg: checks
5IBeOgaApY1Bvzv2P8X4EA: checks
*** RIVER *** [Jd 3d 7h Qs] [2s]
XFa6sBGjP2gxoIvxR3fZIg: checks
5IBeOgaApY1Bvzv2P8X4EA: checks
*** SHOW DOWN ***
XFa6sBGjP2gxoIvxR3fZIg: shows [7s Ad] (a pair of Sevens)
5IBeOgaApY1Bvzv2P8X4EA: shows [9d 9c] (a pair of Nines)
5IBeOgaApY1Bvzv2P8X4EA collected $11.50 from pot
*** SUMMARY ***
Total pot $12 | Rake $0.50
Board [Jd 3d 7h Qs 2s]
Seat 1: XFa6sBGjP2gxoIvxR3fZIg (big blind) showed [7s Ad] and lost with a pair of Sevens
Seat 2: 5IBeOgaApY1Bvzv2P8X4EA (button) (small blind) showed [9d 9c] and won ($11.50) with a pair of Nines



PokerStars Game #59938083502:  Hold'em No Limit ($0.25/$0.50) - 2009/07/01 0:06:39 ET
Table 'SsXEKOwKN+jE3etfusqUqA' 2-max Seat #1 is the button
Seat 1: 618rKeLrz/avGNOLULHHVQ ($74.70 in chips)
Seat 2: XfRhywXA6Br+jID1oGeo8A ($176.45 in chips)
618rKeLrz/avGNOLULHHVQ: posts small blind $0.25
XfRhywXA6Br+jID1oGeo8A: posts big blind $0.50
*** HOLE CARDS ***
618rKeLrz/avGNOLULHHVQ: raises $1 to $1.50
XfRhywXA6Br+jID1oGeo8A: calls $1
*** FLOP *** [5h Ac Ts]
XfRhywXA6Br+jID1oGeo8A: checks
618rKeLrz/avGNOLULHHVQ: bets $1.50
XfRhywXA6Br+jID1oGeo8A: folds
618rKeLrz/avGNOLULHHVQ collected $2.85 from pot
618rKeLrz/avGNOLULHHVQ: doesn't show hand
*** SUMMARY ***
Total pot $3 | Rake $0.15
Board [5h Ac Ts]
Seat 1: 618rKeLrz/avGNOLULHHVQ (button) (small blind) collected ($2.85)
Seat 2: XfRhywXA6Br+jID1oGeo8A (big blind) folded on the Flop



PokerStars Game #59938084216:  Hold'em No Limit ($0.25/$0.50) - 2009/07/01 0:06:40 ET
Table 'E7bWJ45aoFXRpyRv2gw+Ig' 2-max Seat #1 is the button
Seat 1: FRkiRasEGlHUeLrEl+k/nA ($63.30 in chips)
Seat 2: 3Wro85I7472vJ4Wkpneo9A ($61.40 in chips)
FRkiRasEGlHUeLrEl+k/nA: posts small blind $0.25
3Wro85I7472vJ4Wkpneo9A: posts big blind $0.50
*** HOLE CARDS ***
FRkiRasEGlHUeLrEl+k/nA: folds
3Wro85I7472vJ4Wkpneo9A collected $0.50 from pot
3Wro85I7472vJ4Wkpneo9A: doesn't show hand
*** SUMMARY ***
Total pot $0.50 | Rake $0
Seat 1: FRkiRasEGlHUeLrEl+k/nA (button) (small blind) folded before Flop
Seat 2: 3Wro85I7472vJ4Wkpneo9A (big blind) collected ($0.50)



PokerStars Game #59938084114:  Hold'em No Limit ($0.25/$0.50) - 2009/07/01 0:06:40 ET
Table 'mTxf8gPLgffN3Iwfm7Icfg' 2-max Seat #1 is the button
Seat 1: Do9Rlu1R5u/AcRtMTl8SYg ($71.35 in chips)
Seat 2: EMc5LPgVaded4Qc77vm0fw ($43.50 in chips)
Do9Rlu1R5u/AcRtMTl8SYg: posts small blind $0.25
EMc5LPgVaded4Qc77vm0fw: posts big blind $0.50
*** HOLE CARDS ***
Do9Rlu1R5u/AcRtMTl8SYg: raises $1 to $1.50
EMc5LPgVaded4Qc77vm0fw: calls $1
*** FLOP *** [Jh Qs As]
EMc5LPgVaded4Qc77vm0fw: checks
Do9Rlu1R5u/AcRtMTl8SYg: bets $2
EMc5LPgVaded4Qc77vm0fw: calls $2
*** TURN *** [Jh Qs As] [Jd]
EMc5LPgVaded4Qc77vm0fw: checks
Do9Rlu1R5u/AcRtMTl8SYg: checks
*** RIVER *** [Jh Qs As Jd] [Td]
EMc5LPgVaded4Qc77vm0fw: bets $3
Do9Rlu1R5u/AcRtMTl8SYg: folds
EMc5LPgVaded4Qc77vm0fw collected $6.70 from pot
EMc5LPgVaded4Qc77vm0fw: doesn't show hand
*** SUMMARY ***
Total pot $7 | Rake $0.30
Board [Jh Qs As Jd Td]
Seat 1: Do9Rlu1R5u/AcRtMTl8SYg (button) (small blind) folded on the River
Seat 2: EMc5LPgVaded4Qc77vm0fw (big blind) collected ($6.70)



PokerStars Game #59938085742:  Hold'em No Limit ($0.25/$0.50) - 2009/07/01 0:06:42 ET
Table 'c/CRn+68J3Y8KxD5g1ek2Q' 2-max Seat #1 is the button
Seat 1: 46qCyJ6evTkHo9al5sBMNA ($315.20 in chips)
Seat 2: BypVLsYQt3ePFm2xQL/dOA ($72.25 in chips)
46qCyJ6evTkHo9al5sBMNA: posts small blind $0.25
BypVLsYQt3ePFm2xQL/dOA: posts big blind $0.50
*** HOLE CARDS ***
46qCyJ6evTkHo9al5sBMNA: folds
BypVLsYQt3ePFm2xQL/dOA collected $0.50 from pot
BypVLsYQt3ePFm2xQL/dOA: doesn't show hand
*** SUMMARY ***
Total pot $0.50 | Rake $0
Seat 1: 46qCyJ6evTkHo9al5sBMNA (button) (small blind) folded before Flop
Seat 2: BypVLsYQt3ePFm2xQL/dOA (big blind) collected ($0.50)



PokerStars Game #59938085968:  Hold'em No Limit ($0.25/$0.50) - 2009/07/01 0:06:42 ET
Table 'MJxeZCzYELxiIsyUZyT0jw' 6-max Seat #6 is the button
Seat 1: iKPos8JI094Tomq4tDSgnQ ($28.25 in chips)
Seat 2: r6H1GiZ6QIpMTDhyodKuRQ ($65.65 in chips)
Seat 3: JQZew0FjzS19kTjeNtrE+A ($51.85 in chips)
Seat 4: lP7Q6pewz4C2RsAfKsjdWw ($25.50 in chips)
Seat 5: 3jvoOXNtXE90w2BdfNZwZQ ($50 in chips)
Seat 6: TTx3CHxyi0SObcHyMJRp5w ($40.70 in chips)
iKPos8JI094Tomq4tDSgnQ: posts small blind $0.25
r6H1GiZ6QIpMTDhyodKuRQ: posts big blind $0.50
*** HOLE CARDS ***
JQZew0FjzS19kTjeNtrE+A: calls $0.50
lP7Q6pewz4C2RsAfKsjdWw: folds
3jvoOXNtXE90w2BdfNZwZQ: raises $2 to $2.50
TTx3CHxyi0SObcHyMJRp5w: folds
iKPos8JI094Tomq4tDSgnQ: folds
r6H1GiZ6QIpMTDhyodKuRQ: folds
JQZew0FjzS19kTjeNtrE+A: calls $2
*** FLOP *** [6d Jh Ks]
JQZew0FjzS19kTjeNtrE+A: checks
3jvoOXNtXE90w2BdfNZwZQ: bets $3
JQZew0FjzS19kTjeNtrE+A: folds
3jvoOXNtXE90w2BdfNZwZQ collected $5.50 from pot
3jvoOXNtXE90w2BdfNZwZQ: doesn't show hand
*** SUMMARY ***
Total pot $5.75 | Rake $0.25
Board [6d Jh Ks]
Seat 1: iKPos8JI094Tomq4tDSgnQ (small blind) folded before Flop
Seat 2: r6H1GiZ6QIpMTDhyodKuRQ (big blind) folded before Flop
Seat 3: JQZew0FjzS19kTjeNtrE+A folded on the Flop
Seat 4: lP7Q6pewz4C2RsAfKsjdWw folded before Flop (didn't bet)
Seat 5: 3jvoOXNtXE90w2BdfNZwZQ collected ($5.50)
Seat 6: TTx3CHxyi0SObcHyMJRp5w (button) folded before Flop (didn't bet)



PokerStars Game #59938085978:  Hold'em No Limit ($0.25/$0.50) - 2009/07/01 0:06:42 ET
Table 'tyR5AZNKV8Aadbrnrnlg7g' 6-max Seat #1 is the button
Seat 1: R+KjpH/wSjDLhtIy9+edNA ($38.25 in chips)
Seat 2: 58zdeSBSuSFX/qZfhc7YmA ($32.45 in chips)
Seat 3: jUhx+m+V7qfbLZTjgwZByg ($44.75 in chips)
Seat 4: Rt6KgtZ8YaJoTc3FPim00w ($50 in chips)
Seat 5: EIg3r3fRFKG2HhgpDlIJHg ($10.95 in chips)
Seat 6: DMQLAmut/l19xN5STQndFg ($19.95 in chips)
58zdeSBSuSFX/qZfhc7YmA: posts small blind $0.25
jUhx+m+V7qfbLZTjgwZByg: posts big blind $0.50
*** HOLE CARDS ***
Rt6KgtZ8YaJoTc3FPim00w: folds
EIg3r3fRFKG2HhgpDlIJHg: calls $0.50
DMQLAmut/l19xN5STQndFg: raises $1.50 to $2
R+KjpH/wSjDLhtIy9+edNA: calls $2
58zdeSBSuSFX/qZfhc7YmA: folds
jUhx+m+V7qfbLZTjgwZByg: folds
EIg3r3fRFKG2HhgpDlIJHg: calls $1.50
*** FLOP *** [Tc Ts 9s]
EIg3r3fRFKG2HhgpDlIJHg: checks
DMQLAmut/l19xN5STQndFg: bets $2
R+KjpH/wSjDLhtIy9+edNA: folds
EIg3r3fRFKG2HhgpDlIJHg: raises $2 to $4
DMQLAmut/l19xN5STQndFg: calls $2
*** TURN *** [Tc Ts 9s] [5d]
EIg3r3fRFKG2HhgpDlIJHg: bets $4
DMQLAmut/l19xN5STQndFg: folds
EIg3r3fRFKG2HhgpDlIJHg collected $14.05 from pot
*** SUMMARY ***
Total pot $14.75 | Rake $0.70
Board [Tc Ts 9s 5d]
Seat 1: R+KjpH/wSjDLhtIy9+edNA (button) folded on the Flop
Seat 2: 58zdeSBSuSFX/qZfhc7YmA (small blind) folded before Flop
Seat 3: jUhx+m+V7qfbLZTjgwZByg (big blind) folded before Flop
Seat 4: Rt6KgtZ8YaJoTc3FPim00w folded before Flop (didn't bet)
Seat 5: EIg3r3fRFKG2HhgpDlIJHg collected ($14.05)
Seat 6: DMQLAmut/l19xN5STQndFg folded on the Turn



PokerStars Game #59938085942:  Hold'em No Limit ($0.25/$0.50) - 2009/07/01 0:06:42 ET
Table 'EiNh8p/wGJ1FP575iMFnqg' 9-max Seat #5 is the button
Seat 1: r3ZqM1Mi0W3y4hOdssE+Sg ($43.25 in chips)
Seat 2: avsQkZXsRKnWa7gkjVNvog ($27.90 in chips)
Seat 3: GszS/McxOSUnOET7MBoHqA ($62.75 in chips)
Seat 4: pk8aA8qMBEL6zXqSyfVXMA ($80.05 in chips)
Seat 5: M+7+BTmX5vZatHVuoRB1nA ($89 in chips)
Seat 6: YPo1oggovmqSREegekaQYw ($13.75 in chips)
Seat 9: OMwFJ4pF0xk2Ru/AJiFeFw ($72.90 in chips)
YPo1oggovmqSREegekaQYw: posts small blind $0.25
Wj7mKnRFR90j40wWUu2+Og: is sitting out
OMwFJ4pF0xk2Ru/AJiFeFw: posts big blind $0.50
*** HOLE CARDS ***
r3ZqM1Mi0W3y4hOdssE+Sg: folds
avsQkZXsRKnWa7gkjVNvog: folds
GszS/McxOSUnOET7MBoHqA: folds
pk8aA8qMBEL6zXqSyfVXMA: folds
M+7+BTmX5vZatHVuoRB1nA: folds
YPo1oggovmqSREegekaQYw: calls $0.25
OMwFJ4pF0xk2Ru/AJiFeFw: checks
*** FLOP *** [Jc 3d 4d]
YPo1oggovmqSREegekaQYw: checks
OMwFJ4pF0xk2Ru/AJiFeFw: checks
*** TURN *** [Jc 3d 4d] [Ks]
YPo1oggovmqSREegekaQYw: checks
OMwFJ4pF0xk2Ru/AJiFeFw: checks
*** RIVER *** [Jc 3d 4d Ks] [5c]
KrPAGRACBg+w0M//SXe8Ag joins the table at seat #8
YPo1oggovmqSREegekaQYw: checks
OMwFJ4pF0xk2Ru/AJiFeFw: checks
*** SHOW DOWN ***
YPo1oggovmqSREegekaQYw: shows [Qc 3c] (a pair of Threes)
OMwFJ4pF0xk2Ru/AJiFeFw: mucks hand
YPo1oggovmqSREegekaQYw collected $0.95 from pot
*** SUMMARY ***
Total pot $1 | Rake $0.05
Board [Jc 3d 4d Ks 5c]
Seat 1: r3ZqM1Mi0W3y4hOdssE+Sg folded before Flop (didn't bet)
Seat 2: avsQkZXsRKnWa7gkjVNvog folded before Flop (didn't bet)
Seat 3: GszS/McxOSUnOET7MBoHqA folded before Flop (didn't bet)
Seat 4: pk8aA8qMBEL6zXqSyfVXMA folded before Flop (didn't bet)
Seat 5: M+7+BTmX5vZatHVuoRB1nA (button) folded before Flop (didn't bet)
Seat 6: YPo1oggovmqSREegekaQYw (small blind) showed [Qc 3c] and won ($0.95) with a pair of Threes
Seat 9: OMwFJ4pF0xk2Ru/AJiFeFw (big blind) mucked



PokerStars Game #59938086916:  Hold'em No Limit ($0.25/$0.50) - 2009/07/01 0:06:43 ET
Table 'X6IRCRTh+20gjz8aubWnwA' 9-max Seat #9 is the button
Seat 1: YPo1oggovmqSREegekaQYw ($9.95 in chips)
Seat 2: RjBdQ6w31rgcy0o24VLR6w ($11.45 in chips)
Seat 3: mSD1pginDsyHG5PDfqzphw ($10 in chips)
Seat 4: uw9QayAAxLM3Hb+HR7mSkg ($11 in chips)
Seat 5: aT3lRsb9BkkYp2fkD3LEtQ ($85.15 in chips)
Seat 6: /6In1zC3WtgwxDcueWzZWg ($51.10 in chips)
Seat 7: VBnpbzn0dIveV55qKvciew ($59.95 in chips)
Seat 8: BPMN9sOItJw6vWq3kypaYg ($24.65 in chips)
Seat 9: M+7+BTmX5vZatHVuoRB1nA ($84.10 in chips)
YPo1oggovmqSREegekaQYw: posts small blind $0.25
RjBdQ6w31rgcy0o24VLR6w: posts big blind $0.50
*** HOLE CARDS ***
mSD1pginDsyHG5PDfqzphw: folds
uw9QayAAxLM3Hb+HR7mSkg: folds
aT3lRsb9BkkYp2fkD3LEtQ: folds
/6In1zC3WtgwxDcueWzZWg: folds
VBnpbzn0dIveV55qKvciew: folds
BPMN9sOItJw6vWq3kypaYg: folds
M+7+BTmX5vZatHVuoRB1nA: folds
YPo1oggovmqSREegekaQYw: calls $0.25
RjBdQ6w31rgcy0o24VLR6w: checks
*** FLOP *** [5c 2s 6d]
YPo1oggovmqSREegekaQYw: checks
RjBdQ6w31rgcy0o24VLR6w: checks
*** TURN *** [5c 2s 6d] [7h]
YPo1oggovmqSREegekaQYw: checks
RjBdQ6w31rgcy0o24VLR6w: checks
*** RIVER *** [5c 2s 6d 7h] [8h]
YPo1oggovmqSREegekaQYw: checks
RjBdQ6w31rgcy0o24VLR6w: bets $1
YPo1oggovmqSREegekaQYw: folds
RjBdQ6w31rgcy0o24VLR6w collected $0.95 from pot
RjBdQ6w31rgcy0o24VLR6w: doesn't show hand
*** SUMMARY ***
Total pot $1 | Rake $0.05
Board [5c 2s 6d 7h 8h]
Seat 1: YPo1oggovmqSREegekaQYw (small blind) folded on the River
Seat 2: RjBdQ6w31rgcy0o24VLR6w (big blind) collected ($0.95)
Seat 3: mSD1pginDsyHG5PDfqzphw folded before Flop (didn't bet)
Seat 4: uw9QayAAxLM3Hb+HR7mSkg folded before Flop (didn't bet)
Seat 5: aT3lRsb9BkkYp2fkD3LEtQ folded before Flop (didn't bet)
Seat 6: /6In1zC3WtgwxDcueWzZWg folded before Flop (didn't bet)
Seat 7: VBnpbzn0dIveV55qKvciew folded before Flop (didn't bet)
Seat 8: BPMN9sOItJw6vWq3kypaYg folded before Flop (didn't bet)
Seat 9: M+7+BTmX5vZatHVuoRB1nA (button) folded before Flop (didn't bet)



PokerStars Game #59938088292:  Hold'em No Limit ($0.25/$0.50) - 2009/07/01 0:06:45 ET
Table 'oxUN1yBuOHNrPf4xoy4aXw' 2-max Seat #1 is the button
Seat 1: ndd1nfncBkWNitBnsfCoVQ ($71.10 in chips)
Seat 2: mba14ZHNZ0/GoMe+gAVYmw ($33.50 in chips)
ndd1nfncBkWNitBnsfCoVQ: posts small blind $0.25
mba14ZHNZ0/GoMe+gAVYmw: posts big blind $0.50
*** HOLE CARDS ***
ndd1nfncBkWNitBnsfCoVQ: folds
mba14ZHNZ0/GoMe+gAVYmw collected $0.50 from pot
*** SUMMARY ***
Total pot $0.50 | Rake $0
Seat 1: ndd1nfncBkWNitBnsfCoVQ (button) (small blind) folded before Flop
Seat 2: mba14ZHNZ0/GoMe+gAVYmw (big blind) collected ($0.50)



PokerStars Game #59938088936:  Hold'em No Limit ($0.25/$0.50) - 2009/07/01 0:06:46 ET
Table 'E7bWJ45aoFXRpyRv2gw+Ig' 2-max Seat #2 is the button
Seat 1: FRkiRasEGlHUeLrEl+k/nA ($63.05 in chips)
Seat 2: 3Wro85I7472vJ4Wkpneo9A ($61.65 in chips)
3Wro85I7472vJ4Wkpneo9A: posts small blind $0.25
FRkiRasEGlHUeLrEl+k/nA: posts big blind $0.50
*** HOLE CARDS ***
3Wro85I7472vJ4Wkpneo9A: folds
FRkiRasEGlHUeLrEl+k/nA collected $0.50 from pot
*** SUMMARY ***
Total pot $0.50 | Rake $0
Seat 1: FRkiRasEGlHUeLrEl+k/nA (big blind) collected ($0.50)
Seat 2: 3Wro85I7472vJ4Wkpneo9A (button) (small blind) folded before Flop



PokerStars Game #59938089986:  Hold'em No Limit ($0.25/$0.50) - 2009/07/01 0:06:48 ET
Table '0AhP5FLi4ySROVJ/ycT1Qw' 2-max Seat #2 is the button
Seat 1: VzCjk9xTOs+nLWp67vramg ($72.85 in chips)
Seat 2: 46qCyJ6evTkHo9al5sBMNA ($137.05 in chips)
46qCyJ6evTkHo9al5sBMNA: posts small blind $0.25
VzCjk9xTOs+nLWp67vramg: posts big blind $0.50
*** HOLE CARDS ***
46qCyJ6evTkHo9al5sBMNA: raises $1.50 to $2
VzCjk9xTOs+nLWp67vramg: folds
46qCyJ6evTkHo9al5sBMNA collected $1 from pot
46qCyJ6evTkHo9al5sBMNA: doesn't show hand
*** SUMMARY ***
Total pot $1 | Rake $0
Seat 1: VzCjk9xTOs+nLWp67vramg (big blind) folded before Flop
Seat 2: 46qCyJ6evTkHo9al5sBMNA (button) (small blind) collected ($1)



PokerStars Game #59938090538:  Hold'em No Limit ($0.25/$0.50) - 2009/07/01 0:06:48 ET
Table 'raOT4/ipuZgzjfKHC+jD9g' 2-max Seat #2 is the button
Seat 1: IuwLemwLhc9fvrwBGs0AMA ($11.15 in chips)
Seat 2: Udr5juWSWUgTu1NlRhjMdA ($12.70 in chips)
Udr5juWSWUgTu1NlRhjMdA: posts small blind $0.25
IuwLemwLhc9fvrwBGs0AMA: posts big blind $0.50
*** HOLE CARDS ***
Udr5juWSWUgTu1NlRhjMdA: calls $0.25
IuwLemwLhc9fvrwBGs0AMA: checks
*** FLOP *** [Jh Ah 5s]
IuwLemwLhc9fvrwBGs0AMA: checks
Udr5juWSWUgTu1NlRhjMdA: checks
*** TURN *** [Jh Ah 5s] [4c]
IuwLemwLhc9fvrwBGs0AMA: bets $1
Udr5juWSWUgTu1NlRhjMdA: folds
IuwLemwLhc9fvrwBGs0AMA collected $0.95 from pot
*** SUMMARY ***
Total pot $1 | Rake $0.05
Board [Jh Ah 5s 4c]
Seat 1: IuwLemwLhc9fvrwBGs0AMA (big blind) collected ($0.95)
Seat 2: Udr5juWSWUgTu1NlRhjMdA (button) (small blind) folded on the Turn



PokerStars Game #59938090358:  Hold'em No Limit ($0.25/$0.50) - 2009/07/01 0:06:48 ET
Table 'lSisgp6H7Fg1hH5VfjEjYQ' 9-max Seat #6 is the button
Seat 1: pEW8B6uXbdR47kfljMQ3+Q ($40.45 in chips)
Seat 2: UrcnkQOiLVk8BlKDPJSy7Q ($53.85 in chips)
Seat 3: RjBdQ6w31rgcy0o24VLR6w ($13.15 in chips)
Seat 4: nvw9yQKhJT56lA9k+TLdhw ($11.95 in chips)
Seat 5: mSD1pginDsyHG5PDfqzphw ($10 in chips)
Seat 6: +k7T5ocke8UwavtgUHm+Cg ($27.75 in chips)
Seat 7: xyQ4CeZa3ug3ompz+5xSTg ($74.20 in chips)
Seat 8: bXpVeaSTPBFSPJmeXxO7nw ($10 in chips)
Seat 9: 5JJVDlaiMnB004o/RqbZZQ ($39.25 in chips)
xyQ4CeZa3ug3ompz+5xSTg: posts small blind $0.25
bXpVeaSTPBFSPJmeXxO7nw: posts big blind $0.50
*** HOLE CARDS ***
5JJVDlaiMnB004o/RqbZZQ: folds
pEW8B6uXbdR47kfljMQ3+Q: folds
UrcnkQOiLVk8BlKDPJSy7Q: folds
RjBdQ6w31rgcy0o24VLR6w: folds
nvw9yQKhJT56lA9k+TLdhw: raises $1 to $1.50
mSD1pginDsyHG5PDfqzphw: folds
+k7T5ocke8UwavtgUHm+Cg: folds
xyQ4CeZa3ug3ompz+5xSTg: folds
bXpVeaSTPBFSPJmeXxO7nw: folds
nvw9yQKhJT56lA9k+TLdhw collected $1.25 from pot
*** SUMMARY ***
Total pot $1.25 | Rake $0
Seat 1: pEW8B6uXbdR47kfljMQ3+Q folded before Flop (didn't bet)
Seat 2: UrcnkQOiLVk8BlKDPJSy7Q folded before Flop (didn't bet)
Seat 3: RjBdQ6w31rgcy0o24VLR6w folded before Flop (didn't bet)
Seat 4: nvw9yQKhJT56lA9k+TLdhw collected ($1.25)
Seat 5: mSD1pginDsyHG5PDfqzphw folded before Flop (didn't bet)
Seat 6: +k7T5ocke8UwavtgUHm+Cg (button) folded before Flop (didn't bet)
Seat 7: xyQ4CeZa3ug3ompz+5xSTg (small blind) folded before Flop
Seat 8: bXpVeaSTPBFSPJmeXxO7nw (big blind) folded before Flop
Seat 9: 5JJVDlaiMnB004o/RqbZZQ folded before Flop (didn't bet)



PokerStars Game #59938090660:  Hold'em No Limit ($0.25/$0.50) - 2009/07/01 0:06:49 ET
Table 'NCiXr0d5CEKBQr/cZgLhbA' 9-max Seat #1 is the button
Seat 1: RjBdQ6w31rgcy0o24VLR6w ($8.50 in chips)
Seat 2: ulxuJchBV9iguXg0FUonfg ($36.05 in chips)
Seat 3: xZCXQSXlrZkp3pZizzVXCw ($55.65 in chips)
Seat 4: CL4d+tvzcd4utdQxlPLOmg ($30.40 in chips)
Seat 5: zE9cVigS2nW/Ljy4K4bUQA ($32.70 in chips)
Seat 6: SKnJuWHScqetA/qG5p+wCg ($31.80 in chips)
Seat 7: EltNhVR1POPXhu/1E62t3A ($6.25 in chips)
Seat 8: E2518gp4aFz1+kAgmGqeEg ($10.95 in chips)
Seat 9: WpvT3OUSiZlpvs+mPXFqtQ ($7.45 in chips)
ulxuJchBV9iguXg0FUonfg: posts small blind $0.25
xZCXQSXlrZkp3pZizzVXCw: posts big blind $0.50
*** HOLE CARDS ***
CL4d+tvzcd4utdQxlPLOmg: calls $0.50
zE9cVigS2nW/Ljy4K4bUQA: folds
SKnJuWHScqetA/qG5p+wCg: folds
EltNhVR1POPXhu/1E62t3A: calls $0.50
E2518gp4aFz1+kAgmGqeEg: raises $10.45 to $10.95 and is all-in
WpvT3OUSiZlpvs+mPXFqtQ: folds
RjBdQ6w31rgcy0o24VLR6w: folds
ulxuJchBV9iguXg0FUonfg: folds
xZCXQSXlrZkp3pZizzVXCw: folds
CL4d+tvzcd4utdQxlPLOmg: folds
EltNhVR1POPXhu/1E62t3A: calls $5.75 and is all-in
*** FLOP *** [9d 7s 4d]
*** TURN *** [9d 7s 4d] [Ah]
*** RIVER *** [9d 7s 4d Ah] [8c]
*** SHOW DOWN ***
EltNhVR1POPXhu/1E62t3A: shows [Qd 3d] (high card Ace)
E2518gp4aFz1+kAgmGqeEg: shows [Ac Kh] (a pair of Aces)
E2518gp4aFz1+kAgmGqeEg collected $13.10 from pot
E2518gp4aFz1+kAgmGqeEg is sitting out
*** SUMMARY ***
Total pot $13.75 | Rake $0.65
Board [9d 7s 4d Ah 8c]
Seat 1: RjBdQ6w31rgcy0o24VLR6w (button) folded before Flop (didn't bet)
Seat 2: ulxuJchBV9iguXg0FUonfg (small blind) folded before Flop
Seat 3: xZCXQSXlrZkp3pZizzVXCw (big blind) folded before Flop
Seat 4: CL4d+tvzcd4utdQxlPLOmg folded before Flop
Seat 5: zE9cVigS2nW/Ljy4K4bUQA folded before Flop (didn't bet)
Seat 6: SKnJuWHScqetA/qG5p+wCg folded before Flop (didn't bet)
Seat 7: EltNhVR1POPXhu/1E62t3A showed [Qd 3d] and lost with high card Ace
Seat 8: E2518gp4aFz1+kAgmGqeEg showed [Ac Kh] and won ($13.10) with a pair of Aces
Seat 9: WpvT3OUSiZlpvs+mPXFqtQ folded before Flop (didn't bet)



PokerStars Game #59938091070:  Hold'em No Limit ($0.25/$0.50) - 2009/07/01 0:06:49 ET
Table 'c/CRn+68J3Y8KxD5g1ek2Q' 2-max Seat #2 is the button
Seat 1: 46qCyJ6evTkHo9al5sBMNA ($314.95 in chips)
Seat 2: BypVLsYQt3ePFm2xQL/dOA ($72.50 in chips)
BypVLsYQt3ePFm2xQL/dOA: posts small blind $0.25
46qCyJ6evTkHo9al5sBMNA: posts big blind $0.50
*** HOLE CARDS ***
BypVLsYQt3ePFm2xQL/dOA: raises $1 to $1.50
46qCyJ6evTkHo9al5sBMNA: folds
BypVLsYQt3ePFm2xQL/dOA collected $1 from pot
BypVLsYQt3ePFm2xQL/dOA: doesn't show hand
*** SUMMARY ***
Total pot $1 | Rake $0
Seat 1: 46qCyJ6evTkHo9al5sBMNA (big blind) folded before Flop
Seat 2: BypVLsYQt3ePFm2xQL/dOA (button) (small blind) collected ($1)



PokerStars Game #59938092236:  Hold'em No Limit ($0.25/$0.50) - 2009/07/01 0:06:51 ET
Table 'SsXEKOwKN+jE3etfusqUqA' 2-max Seat #2 is the button
Seat 1: 618rKeLrz/avGNOLULHHVQ ($76.05 in chips)
Seat 2: XfRhywXA6Br+jID1oGeo8A ($174.95 in chips)
XfRhywXA6Br+jID1oGeo8A: posts small blind $0.25
618rKeLrz/avGNOLULHHVQ: posts big blind $0.50
*** HOLE CARDS ***
XfRhywXA6Br+jID1oGeo8A: folds
618rKeLrz/avGNOLULHHVQ collected $0.50 from pot
618rKeLrz/avGNOLULHHVQ: doesn't show hand
*** SUMMARY ***
Total pot $0.50 | Rake $0
Seat 1: 618rKeLrz/avGNOLULHHVQ (big blind) collected ($0.50)
Seat 2: XfRhywXA6Br+jID1oGeo8A (button) (small blind) folded before Flop



PokerStars Game #59938092580:  Hold'em No Limit ($0.25/$0.50) - 2009/07/01 0:06:51 ET
Table 'QOgaEqMcJ73pcUMMxoisUg' 6-max Seat #5 is the button
Seat 1: RFefXIDyFvNtJLq+CloCzA ($41.70 in chips)
Seat 3: wUZNozoIDYf+16hp4nn6dw ($29.25 in chips)
Seat 5: HoaSQCRso+nEyO5DUhGduw ($57.75 in chips)
Seat 6: s83dnhZ6VC53vY0/f6OV/g ($48.80 in chips)
s83dnhZ6VC53vY0/f6OV/g: posts small blind $0.25
RFefXIDyFvNtJLq+CloCzA: posts big blind $0.50
*** HOLE CARDS ***
wUZNozoIDYf+16hp4nn6dw: folds
HoaSQCRso+nEyO5DUhGduw: folds
s83dnhZ6VC53vY0/f6OV/g: raises $0.50 to $1
RFefXIDyFvNtJLq+CloCzA: raises $3 to $4
s83dnhZ6VC53vY0/f6OV/g: folds
zAcsDhG/T128Vn7XGVSgKg joins the table at seat #4
RFefXIDyFvNtJLq+CloCzA collected $2 from pot
*** SUMMARY ***
Total pot $2 | Rake $0
Seat 1: RFefXIDyFvNtJLq+CloCzA (big blind) collected ($2)
Seat 3: wUZNozoIDYf+16hp4nn6dw folded before Flop (didn't bet)
Seat 5: HoaSQCRso+nEyO5DUhGduw (button) folded before Flop (didn't bet)
Seat 6: s83dnhZ6VC53vY0/f6OV/g (small blind) folded before Flop



PokerStars Game #59938092948:  Hold'em No Limit ($0.25/$0.50) - 2009/07/01 0:06:52 ET
Table 'ibNfFy0bCzuBaUORla0aGw' 9-max Seat #1 is the button
Seat 1: xZCXQSXlrZkp3pZizzVXCw ($56.95 in chips)
Seat 2: 90Wb75h3W1BRpbqVnuk8gw ($50.25 in chips)
Seat 3: dDaHs3X8+fe3bIkRU0cbrw ($27.30 in chips)
Seat 4: YBN054X4blmis+B2bBlC0g ($22.20 in chips)
Seat 5: FRv75HO8CUsRZ1byEz06mQ ($15.35 in chips)
Seat 6: BmYrv3ec2k5d6pQq6iNaZw ($66.25 in chips)
Seat 7: mSD1pginDsyHG5PDfqzphw ($10 in chips)
Seat 8: xUrN9TWLq4m5V+OXY7KUUA ($50 in chips)
Seat 9: WpvT3OUSiZlpvs+mPXFqtQ ($8.75 in chips)
90Wb75h3W1BRpbqVnuk8gw: posts small blind $0.25
dDaHs3X8+fe3bIkRU0cbrw: posts big blind $0.50
*** HOLE CARDS ***
YBN054X4blmis+B2bBlC0g: calls $0.50
FRv75HO8CUsRZ1byEz06mQ: folds
BmYrv3ec2k5d6pQq6iNaZw: raises $0.50 to $1
mSD1pginDsyHG5PDfqzphw: folds
xUrN9TWLq4m5V+OXY7KUUA: folds
WpvT3OUSiZlpvs+mPXFqtQ: folds
xZCXQSXlrZkp3pZizzVXCw: folds
90Wb75h3W1BRpbqVnuk8gw: folds
dDaHs3X8+fe3bIkRU0cbrw: folds
YBN054X4blmis+B2bBlC0g: calls $0.50
*** FLOP *** [4d Kd 2c]
YBN054X4blmis+B2bBlC0g: checks
BmYrv3ec2k5d6pQq6iNaZw: bets $2
YBN054X4blmis+B2bBlC0g: folds
BmYrv3ec2k5d6pQq6iNaZw collected $2.65 from pot
*** SUMMARY ***
Total pot $2.75 | Rake $0.10
Board [4d Kd 2c]
Seat 1: xZCXQSXlrZkp3pZizzVXCw (button) folded before Flop (didn't bet)
Seat 2: 90Wb75h3W1BRpbqVnuk8gw (small blind) folded before Flop
Seat 3: dDaHs3X8+fe3bIkRU0cbrw (big blind) folded before Flop
Seat 4: YBN054X4blmis+B2bBlC0g folded on the Flop
Seat 5: FRv75HO8CUsRZ1byEz06mQ folded before Flop (didn't bet)
Seat 6: BmYrv3ec2k5d6pQq6iNaZw collected ($2.65)
Seat 7: mSD1pginDsyHG5PDfqzphw folded before Flop (didn't bet)
Seat 8: xUrN9TWLq4m5V+OXY7KUUA folded before Flop (didn't bet)
Seat 9: WpvT3OUSiZlpvs+mPXFqtQ folded before Flop (didn't bet)



PokerStars Game #59938092866:  Hold'em No Limit ($0.25/$0.50) - 2009/07/01 0:06:52 ET
Table 'YsnnHkamRzYqMOr2FlLY4w' 6-max Seat #6 is the button
Seat 1: crjGpJEzSZgD38FoE3VMGg ($50.25 in chips)
Seat 3: I+pG2m/dD5iYdbg9qx572g ($25 in chips)
Seat 4: 7Fue572p4ZIC85AJMQvaQw ($53.85 in chips)
Seat 5: lcQ7uuLf+WLGGy4Ve6VKKA ($41 in chips)
Seat 6: YmWlPGOKFuJSoJZPW8a8IA ($53.40 in chips)
crjGpJEzSZgD38FoE3VMGg: posts small blind $0.25
I+pG2m/dD5iYdbg9qx572g: posts big blind $0.50
*** HOLE CARDS ***
7Fue572p4ZIC85AJMQvaQw: folds
lcQ7uuLf+WLGGy4Ve6VKKA: calls $0.50
YmWlPGOKFuJSoJZPW8a8IA: folds
crjGpJEzSZgD38FoE3VMGg: folds
vnRgOasQNKOR7gLXwRQ+ww joins the table at seat #2
I+pG2m/dD5iYdbg9qx572g: checks
*** FLOP *** [6s Jh 8d]
I+pG2m/dD5iYdbg9qx572g: checks
lcQ7uuLf+WLGGy4Ve6VKKA: checks
*** TURN *** [6s Jh 8d] [8c]
I+pG2m/dD5iYdbg9qx572g: bets $1
lcQ7uuLf+WLGGy4Ve6VKKA: calls $1
*** RIVER *** [6s Jh 8d 8c] [Ad]
I+pG2m/dD5iYdbg9qx572g: checks
lcQ7uuLf+WLGGy4Ve6VKKA: checks
*** SHOW DOWN ***
I+pG2m/dD5iYdbg9qx572g: shows [Kc 2d] (a pair of Eights)
lcQ7uuLf+WLGGy4Ve6VKKA: shows [4h 4s] (two pair, Eights and Fours)
lcQ7uuLf+WLGGy4Ve6VKKA collected $3.10 from pot
*** SUMMARY ***
Total pot $3.25 | Rake $0.15
Board [6s Jh 8d 8c Ad]
Seat 1: crjGpJEzSZgD38FoE3VMGg (small blind) folded before Flop
Seat 3: I+pG2m/dD5iYdbg9qx572g (big blind) showed [Kc 2d] and lost with a pair of Eights
Seat 4: 7Fue572p4ZIC85AJMQvaQw folded before Flop (didn't bet)
Seat 5: lcQ7uuLf+WLGGy4Ve6VKKA showed [4h 4s] and won ($3.10) with two pair, Eights and Fours
Seat 6: YmWlPGOKFuJSoJZPW8a8IA (button) folded before Flop (didn't bet)



PokerStars Game #59938093814:  Hold'em No Limit ($0.25/$0.50) - 2009/07/01 0:06:53 ET
Table 'E7bWJ45aoFXRpyRv2gw+Ig' 2-max Seat #1 is the button
Seat 1: FRkiRasEGlHUeLrEl+k/nA ($63.30 in chips)
Seat 2: 3Wro85I7472vJ4Wkpneo9A ($61.40 in chips)
FRkiRasEGlHUeLrEl+k/nA: posts small blind $0.25
3Wro85I7472vJ4Wkpneo9A: posts big blind $0.50
*** HOLE CARDS ***
FRkiRasEGlHUeLrEl+k/nA: raises $1 to $1.50
3Wro85I7472vJ4Wkpneo9A: raises $3.50 to $5
FRkiRasEGlHUeLrEl+k/nA: calls $3.50
*** FLOP *** [3h 8h Jd]
3Wro85I7472vJ4Wkpneo9A: bets $7
FRkiRasEGlHUeLrEl+k/nA: calls $7
*** TURN *** [3h 8h Jd] [2d]
3Wro85I7472vJ4Wkpneo9A: checks
FRkiRasEGlHUeLrEl+k/nA: bets $14
3Wro85I7472vJ4Wkpneo9A: folds
FRkiRasEGlHUeLrEl+k/nA collected $23.50 from pot
FRkiRasEGlHUeLrEl+k/nA: doesn't show hand
*** SUMMARY ***
Total pot $24 | Rake $0.50
Board [3h 8h Jd 2d]
Seat 1: FRkiRasEGlHUeLrEl+k/nA (button) (small blind) collected ($23.50)
Seat 2: 3Wro85I7472vJ4Wkpneo9A (big blind) folded on the Turn



PokerStars Game #59938094022:  Hold'em No Limit ($0.25/$0.50) - 2009/07/01 0:06:53 ET
Table 'oxUN1yBuOHNrPf4xoy4aXw' 2-max Seat #2 is the button
Seat 1: ndd1nfncBkWNitBnsfCoVQ ($70.85 in chips)
Seat 2: mba14ZHNZ0/GoMe+gAVYmw ($33.75 in chips)
mba14ZHNZ0/GoMe+gAVYmw: posts small blind $0.25
ndd1nfncBkWNitBnsfCoVQ: posts big blind $0.50
*** HOLE CARDS ***
mba14ZHNZ0/GoMe+gAVYmw: calls $0.25
ndd1nfncBkWNitBnsfCoVQ: checks
*** FLOP *** [8h 2s Jc]
ndd1nfncBkWNitBnsfCoVQ: checks
mba14ZHNZ0/GoMe+gAVYmw: bets $5.50
ndd1nfncBkWNitBnsfCoVQ: folds
mba14ZHNZ0/GoMe+gAVYmw collected $0.95 from pot
mba14ZHNZ0/GoMe+gAVYmw: doesn't show hand
*** SUMMARY ***
Total pot $1 | Rake $0.05
Board [8h 2s Jc]
Seat 1: ndd1nfncBkWNitBnsfCoVQ (big blind) folded on the Flop
Seat 2: mba14ZHNZ0/GoMe+gAVYmw (button) (small blind) collected ($0.95)



PokerStars Game #59938094344:  Hold'em No Limit ($0.25/$0.50) - 2009/07/01 0:06:54 ET
Table '+z1aekfHkpp09pc8F9aViw' 6-max Seat #3 is the button
Seat 1: lWwl5C/UZOsWNubdUqghZw ($50 in chips)
Seat 2: VuB2GN0h94yY+QbuI2Mybg ($23.95 in chips)
Seat 3: uUznlIMFnRUvwrBhYF73KA ($54.95 in chips)
Seat 4: OCrv7ObFH4/s2lv7rYOnsQ ($24.15 in chips)
Seat 5: crjGpJEzSZgD38FoE3VMGg ($62.90 in chips)
Seat 6: 686aeHikcJlgKkSuIFdcXQ ($67.90 in chips)
OCrv7ObFH4/s2lv7rYOnsQ: posts small blind $0.25
crjGpJEzSZgD38FoE3VMGg: posts big blind $0.50
*** HOLE CARDS ***
686aeHikcJlgKkSuIFdcXQ: raises $1.50 to $2
lWwl5C/UZOsWNubdUqghZw: folds
VuB2GN0h94yY+QbuI2Mybg: folds
uUznlIMFnRUvwrBhYF73KA: folds
uUznlIMFnRUvwrBhYF73KA is sitting out
OCrv7ObFH4/s2lv7rYOnsQ: calls $1.75
uUznlIMFnRUvwrBhYF73KA has returned
uUznlIMFnRUvwrBhYF73KA is sitting out
crjGpJEzSZgD38FoE3VMGg: folds
*** FLOP *** [2d Jh 2h]
OCrv7ObFH4/s2lv7rYOnsQ: bets $2
686aeHikcJlgKkSuIFdcXQ: raises $5 to $7
OCrv7ObFH4/s2lv7rYOnsQ: folds
686aeHikcJlgKkSuIFdcXQ collected $8.10 from pot
*** SUMMARY ***
Total pot $8.50 | Rake $0.40
Board [2d Jh 2h]
Seat 1: lWwl5C/UZOsWNubdUqghZw folded before Flop (didn't bet)
Seat 2: VuB2GN0h94yY+QbuI2Mybg folded before Flop (didn't bet)
Seat 3: uUznlIMFnRUvwrBhYF73KA (button) folded before Flop (didn't bet)
Seat 4: OCrv7ObFH4/s2lv7rYOnsQ (small blind) folded on the Flop
Seat 5: crjGpJEzSZgD38FoE3VMGg (big blind) folded before Flop
Seat 6: 686aeHikcJlgKkSuIFdcXQ collected ($8.10)



PokerStars Game #59938095884:  Hold'em No Limit ($0.25/$0.50) - 2009/07/01 0:06:56 ET
Table '0AhP5FLi4ySROVJ/ycT1Qw' 2-max Seat #1 is the button
Seat 1: VzCjk9xTOs+nLWp67vramg ($72.35 in chips)
Seat 2: 46qCyJ6evTkHo9al5sBMNA ($137.55 in chips)
VzCjk9xTOs+nLWp67vramg: posts small blind $0.25
46qCyJ6evTkHo9al5sBMNA: posts big blind $0.50
*** HOLE CARDS ***
VzCjk9xTOs+nLWp67vramg: raises $1 to $1.50
46qCyJ6evTkHo9al5sBMNA: folds
VzCjk9xTOs+nLWp67vramg collected $1 from pot
*** SUMMARY ***
Total pot $1 | Rake $0
Seat 1: VzCjk9xTOs+nLWp67vramg (button) (small blind) collected ($1)
Seat 2: 46qCyJ6evTkHo9al5sBMNA (big blind) folded before Flop



PokerStars Game #59938095670:  Hold'em No Limit ($0.25/$0.50) - 2009/07/01 0:06:56 ET
Table 'tpZbcIvqh/6WmfR/i5IE3A' 9-max Seat #8 is the button
Seat 1: nV/P1jFY/CFMXOLWu7pYmA ($13.95 in chips)
Seat 2: M+7+BTmX5vZatHVuoRB1nA ($45.90 in chips)
Seat 3: 3w0FbBQAKwQODwenKwZxXw ($77.70 in chips)
Seat 4: zE9cVigS2nW/Ljy4K4bUQA ($30.75 in chips)
Seat 5: 9r7ZoBbAJj5IeyZ0q9BdzA ($12.90 in chips)
Seat 6: E2518gp4aFz1+kAgmGqeEg ($11.20 in chips)
Seat 7: wIZ377kjl2fHFGnS93o6bw ($13.70 in chips)
Seat 8: bXpVeaSTPBFSPJmeXxO7nw ($9.85 in chips)
nV/P1jFY/CFMXOLWu7pYmA: posts small blind $0.25
M+7+BTmX5vZatHVuoRB1nA: posts big blind $0.50
*** HOLE CARDS ***
3w0FbBQAKwQODwenKwZxXw: folds
zE9cVigS2nW/Ljy4K4bUQA: folds
9r7ZoBbAJj5IeyZ0q9BdzA: folds
E2518gp4aFz1+kAgmGqeEg: folds
wIZ377kjl2fHFGnS93o6bw: folds
bXpVeaSTPBFSPJmeXxO7nw: folds
nV/P1jFY/CFMXOLWu7pYmA: folds
M+7+BTmX5vZatHVuoRB1nA collected $0.50 from pot
M+7+BTmX5vZatHVuoRB1nA: doesn't show hand
*** SUMMARY ***
Total pot $0.50 | Rake $0
Seat 1: nV/P1jFY/CFMXOLWu7pYmA (small blind) folded before Flop
Seat 2: M+7+BTmX5vZatHVuoRB1nA (big blind) collected ($0.50)
Seat 3: 3w0FbBQAKwQODwenKwZxXw folded before Flop (didn't bet)
Seat 4: zE9cVigS2nW/Ljy4K4bUQA folded before Flop (didn't bet)
Seat 5: 9r7ZoBbAJj5IeyZ0q9BdzA folded before Flop (didn't bet)
Seat 6: E2518gp4aFz1+kAgmGqeEg folded before Flop (didn't bet)
Seat 7: wIZ377kjl2fHFGnS93o6bw folded before Flop (didn't bet)
Seat 8: bXpVeaSTPBFSPJmeXxO7nw (button) folded before Flop (didn't bet)



PokerStars Game #59938097024:  Hold'em No Limit ($0.25/$0.50) - 2009/07/01 0:06:58 ET
Table 'c/CRn+68J3Y8KxD5g1ek2Q' 2-max Seat #1 is the button
Seat 1: 46qCyJ6evTkHo9al5sBMNA ($314.45 in chips)
Seat 2: BypVLsYQt3ePFm2xQL/dOA ($73 in chips)
46qCyJ6evTkHo9al5sBMNA: posts small blind $0.25
BypVLsYQt3ePFm2xQL/dOA: posts big blind $0.50
*** HOLE CARDS ***
46qCyJ6evTkHo9al5sBMNA: folds
BypVLsYQt3ePFm2xQL/dOA collected $0.50 from pot
BypVLsYQt3ePFm2xQL/dOA: doesn't show hand
*** SUMMARY ***
Total pot $0.50 | Rake $0
Seat 1: 46qCyJ6evTkHo9al5sBMNA (button) (small blind) folded before Flop
Seat 2: BypVLsYQt3ePFm2xQL/dOA (big blind) collected ($0.50)



PokerStars Game #59938097532:  Hold'em No Limit ($0.25/$0.50) - 2009/07/01 0:06:58 ET
Table 'SsXEKOwKN+jE3etfusqUqA' 2-max Seat #1 is the button
Seat 1: 618rKeLrz/avGNOLULHHVQ ($76.30 in chips)
Seat 2: XfRhywXA6Br+jID1oGeo8A ($174.70 in chips)
618rKeLrz/avGNOLULHHVQ: posts small blind $0.25
XfRhywXA6Br+jID1oGeo8A: posts big blind $0.50
*** HOLE CARDS ***
618rKeLrz/avGNOLULHHVQ: calls $0.25
XfRhywXA6Br+jID1oGeo8A: checks
*** FLOP *** [6d 2h 4s]
XfRhywXA6Br+jID1oGeo8A: checks
618rKeLrz/avGNOLULHHVQ: bets $0.50
XfRhywXA6Br+jID1oGeo8A: calls $0.50
*** TURN *** [6d 2h 4s] [8h]
XfRhywXA6Br+jID1oGeo8A: checks
618rKeLrz/avGNOLULHHVQ: bets $0.50
XfRhywXA6Br+jID1oGeo8A: calls $0.50
*** RIVER *** [6d 2h 4s 8h] [5c]
XfRhywXA6Br+jID1oGeo8A: checks
618rKeLrz/avGNOLULHHVQ: checks
*** SHOW DOWN ***
XfRhywXA6Br+jID1oGeo8A: shows [3h 7d] (a straight, Four to Eight)
618rKeLrz/avGNOLULHHVQ: mucks hand
XfRhywXA6Br+jID1oGeo8A collected $2.90 from pot
*** SUMMARY ***
Total pot $3 | Rake $0.10
Board [6d 2h 4s 8h 5c]
Seat 1: 618rKeLrz/avGNOLULHHVQ (button) (small blind) mucked
Seat 2: XfRhywXA6Br+jID1oGeo8A (big blind) showed [3h 7d] and won ($2.90) with a straight, Four to Eight



PokerStars Game #59938098278:  Hold'em No Limit ($0.25/$0.50) - 2009/07/01 0:06:59 ET
Table 'Vdlc9wqYcHTUhtdyN7CuJw' 2-max Seat #2 is the button
Seat 1: yBO+mXB6m/rCft2ErwGf/Q ($45 in chips)
Seat 2: sa0qgETiL3HNbdfGlnKHTA ($68.85 in chips)
sa0qgETiL3HNbdfGlnKHTA: posts small blind $0.25
yBO+mXB6m/rCft2ErwGf/Q: posts big blind $0.50
*** HOLE CARDS ***
sa0qgETiL3HNbdfGlnKHTA: raises $0.50 to $1
yBO+mXB6m/rCft2ErwGf/Q: raises $3 to $4
sa0qgETiL3HNbdfGlnKHTA: folds
yBO+mXB6m/rCft2ErwGf/Q collected $2 from pot
*** SUMMARY ***
Total pot $2 | Rake $0
Seat 1: yBO+mXB6m/rCft2ErwGf/Q (big blind) collected ($2)
Seat 2: sa0qgETiL3HNbdfGlnKHTA (button) (small blind) folded before Flop



PokerStars Game #59938098356:  Hold'em No Limit ($0.25/$0.50) - 2009/07/01 0:06:59 ET
Table '+dXkOAQyS8j9PQZusUTMpg' 2-max Seat #1 is the button
Seat 1: XFa6sBGjP2gxoIvxR3fZIg ($68.80 in chips)
Seat 2: 5IBeOgaApY1Bvzv2P8X4EA ($45.85 in chips)
XFa6sBGjP2gxoIvxR3fZIg: posts small blind $0.25
5IBeOgaApY1Bvzv2P8X4EA: posts big blind $0.50
*** HOLE CARDS ***
XFa6sBGjP2gxoIvxR3fZIg: raises $1 to $1.50
5IBeOgaApY1Bvzv2P8X4EA: folds
XFa6sBGjP2gxoIvxR3fZIg collected $1 from pot
XFa6sBGjP2gxoIvxR3fZIg: doesn't show hand
*** SUMMARY ***
Total pot $1 | Rake $0
Seat 1: XFa6sBGjP2gxoIvxR3fZIg (button) (small blind) collected ($1)
Seat 2: 5IBeOgaApY1Bvzv2P8X4EA (big blind) folded before Flop



PokerStars Game #59938100998:  Hold'em No Limit ($0.25/$0.50) - 2009/07/01 0:07:03 ET
Table 'lpxYasB1ClBSgTpCCITwhQ' 9-max Seat #7 is the button
Seat 1: ceq82/EkjUd/GFbf0YwGmA ($40.95 in chips)
Seat 3: E2518gp4aFz1+kAgmGqeEg ($10.75 in chips)
Seat 4: k1f0lS7tlMHCLGs0JT34Tg ($7.75 in chips)
Seat 5: bXpVeaSTPBFSPJmeXxO7nw ($9.25 in chips)
Seat 6: YPo1oggovmqSREegekaQYw ($18.10 in chips)
Seat 7: zE9cVigS2nW/Ljy4K4bUQA ($30 in chips)
Seat 8: o6JyUkbzCDw8tUabqtmnlg ($26.05 in chips)
Seat 9: mSD1pginDsyHG5PDfqzphw ($10.75 in chips)
o6JyUkbzCDw8tUabqtmnlg: posts small blind $0.25
mSD1pginDsyHG5PDfqzphw: posts big blind $0.50
*** HOLE CARDS ***
ceq82/EkjUd/GFbf0YwGmA: folds
E2518gp4aFz1+kAgmGqeEg: folds
k1f0lS7tlMHCLGs0JT34Tg: folds
bXpVeaSTPBFSPJmeXxO7nw: folds
YPo1oggovmqSREegekaQYw: folds
zE9cVigS2nW/Ljy4K4bUQA: folds
o6JyUkbzCDw8tUabqtmnlg: calls $0.25
mSD1pginDsyHG5PDfqzphw: raises $1.50 to $2
o6JyUkbzCDw8tUabqtmnlg: folds
mSD1pginDsyHG5PDfqzphw collected $1 from pot
mSD1pginDsyHG5PDfqzphw: doesn't show hand
*** SUMMARY ***
Total pot $1 | Rake $0
Seat 1: ceq82/EkjUd/GFbf0YwGmA folded before Flop (didn't bet)
Seat 3: E2518gp4aFz1+kAgmGqeEg folded before Flop (didn't bet)
Seat 4: k1f0lS7tlMHCLGs0JT34Tg folded before Flop (didn't bet)
Seat 5: bXpVeaSTPBFSPJmeXxO7nw folded before Flop (didn't bet)
Seat 6: YPo1oggovmqSREegekaQYw folded before Flop (didn't bet)
Seat 7: zE9cVigS2nW/Ljy4K4bUQA (button) folded before Flop (didn't bet)
Seat 8: o6JyUkbzCDw8tUabqtmnlg (small blind) folded before Flop
Seat 9: mSD1pginDsyHG5PDfqzphw (big blind) collected ($1)



PokerStars Game #59938101442:  Hold'em No Limit ($0.25/$0.50) - 2009/07/01 0:07:04 ET
Table 'c/CRn+68J3Y8KxD5g1ek2Q' 2-max Seat #2 is the button
Seat 1: 46qCyJ6evTkHo9al5sBMNA ($314.20 in chips)
Seat 2: BypVLsYQt3ePFm2xQL/dOA ($73.25 in chips)
BypVLsYQt3ePFm2xQL/dOA: posts small blind $0.25
46qCyJ6evTkHo9al5sBMNA: posts big blind $0.50
*** HOLE CARDS ***
BypVLsYQt3ePFm2xQL/dOA: raises $1 to $1.50
46qCyJ6evTkHo9al5sBMNA: calls $1
*** FLOP *** [4d 5d 2s]
46qCyJ6evTkHo9al5sBMNA: checks
BypVLsYQt3ePFm2xQL/dOA: checks
*** TURN *** [4d 5d 2s] [9h]
46qCyJ6evTkHo9al5sBMNA: checks
BypVLsYQt3ePFm2xQL/dOA: checks
*** RIVER *** [4d 5d 2s 9h] [7h]
46qCyJ6evTkHo9al5sBMNA: checks
BypVLsYQt3ePFm2xQL/dOA: checks
*** SHOW DOWN ***
46qCyJ6evTkHo9al5sBMNA: shows [Ks Td] (high card King)
BypVLsYQt3ePFm2xQL/dOA: shows [Qd 2h] (a pair of Deuces)
BypVLsYQt3ePFm2xQL/dOA collected $2.85 from pot
*** SUMMARY ***
Total pot $3 | Rake $0.15
Board [4d 5d 2s 9h 7h]
Seat 1: 46qCyJ6evTkHo9al5sBMNA (big blind) showed [Ks Td] and lost with high card King
Seat 2: BypVLsYQt3ePFm2xQL/dOA (button) (small blind) showed [Qd 2h] and won ($2.85) with a pair of Deuces



PokerStars Game #59938102768:  Hold'em No Limit ($0.25/$0.50) - 2009/07/01 0:07:05 ET
Table '0AhP5FLi4ySROVJ/ycT1Qw' 2-max Seat #2 is the button
Seat 1: VzCjk9xTOs+nLWp67vramg ($72.85 in chips)
Seat 2: 46qCyJ6evTkHo9al5sBMNA ($137.05 in chips)
46qCyJ6evTkHo9al5sBMNA: posts small blind $0.25
VzCjk9xTOs+nLWp67vramg: posts big blind $0.50
*** HOLE CARDS ***
46qCyJ6evTkHo9al5sBMNA: raises $1 to $1.50
VzCjk9xTOs+nLWp67vramg: calls $1
*** FLOP *** [Ts 8h Ad]
VzCjk9xTOs+nLWp67vramg: bets $2
46qCyJ6evTkHo9al5sBMNA: folds
VzCjk9xTOs+nLWp67vramg collected $2.85 from pot
*** SUMMARY ***
Total pot $3 | Rake $0.15
Board [Ts 8h Ad]
Seat 1: VzCjk9xTOs+nLWp67vramg (big blind) collected ($2.85)
Seat 2: 46qCyJ6evTkHo9al5sBMNA (button) (small blind) folded on the Flop



PokerStars Game #59938104474:  Hold'em No Limit ($0.25/$0.50) - 2009/07/01 0:07:08 ET
Table '+dXkOAQyS8j9PQZusUTMpg' 2-max Seat #2 is the button
Seat 1: XFa6sBGjP2gxoIvxR3fZIg ($69.30 in chips)
Seat 2: 5IBeOgaApY1Bvzv2P8X4EA ($45.35 in chips)
5IBeOgaApY1Bvzv2P8X4EA: posts small blind $0.25
XFa6sBGjP2gxoIvxR3fZIg: posts big blind $0.50
*** HOLE CARDS ***
5IBeOgaApY1Bvzv2P8X4EA: folds
XFa6sBGjP2gxoIvxR3fZIg collected $0.50 from pot
XFa6sBGjP2gxoIvxR3fZIg: doesn't show hand
*** SUMMARY ***
Total pot $0.50 | Rake $0
Seat 1: XFa6sBGjP2gxoIvxR3fZIg (big blind) collected ($0.50)
Seat 2: 5IBeOgaApY1Bvzv2P8X4EA (button) (small blind) folded before Flop



PokerStars Game #59938105586:  Hold'em No Limit ($0.25/$0.50) - 2009/07/01 0:07:09 ET
Table '37qXEp3oe+er5q4CZip9eQ' 6-max Seat #2 is the button
Seat 2: g12O9qXTybyo2C0B2bXgjg ($37.45 in chips)
Seat 3: Rt6KgtZ8YaJoTc3FPim00w ($107.60 in chips)
Seat 4: L0aIPg7qefDQjdJo3HCVEA ($10.30 in chips)
Seat 5: VOmI0x4dDPnTESZd5B4d1Q ($30.75 in chips)
Seat 6: f7zPpUQp9hHZgqhEvrUWQw ($55.90 in chips)
Rt6KgtZ8YaJoTc3FPim00w: posts small blind $0.25
L0aIPg7qefDQjdJo3HCVEA: posts big blind $0.50
*** HOLE CARDS ***
4qceN3NM3S463h+TT4UvGQ leaves the table
VOmI0x4dDPnTESZd5B4d1Q: folds
f7zPpUQp9hHZgqhEvrUWQw: folds
g12O9qXTybyo2C0B2bXgjg: folds
Rt6KgtZ8YaJoTc3FPim00w: raises $1 to $1.50
L0aIPg7qefDQjdJo3HCVEA: folds
Rt6KgtZ8YaJoTc3FPim00w collected $1 from pot
*** SUMMARY ***
Total pot $1 | Rake $0
Seat 2: g12O9qXTybyo2C0B2bXgjg (button) folded before Flop (didn't bet)
Seat 3: Rt6KgtZ8YaJoTc3FPim00w (small blind) collected ($1)
Seat 4: L0aIPg7qefDQjdJo3HCVEA (big blind) folded before Flop
Seat 5: VOmI0x4dDPnTESZd5B4d1Q folded before Flop (didn't bet)
Seat 6: f7zPpUQp9hHZgqhEvrUWQw folded before Flop (didn't bet)



PokerStars Game #59938109454:  Hold'em No Limit ($0.25/$0.50) - 2009/07/01 0:07:14 ET
Table 'Vdlc9wqYcHTUhtdyN7CuJw' 2-max Seat #1 is the button
Seat 1: yBO+mXB6m/rCft2ErwGf/Q ($46 in chips)
Seat 2: sa0qgETiL3HNbdfGlnKHTA ($67.85 in chips)
yBO+mXB6m/rCft2ErwGf/Q: posts small blind $0.25
sa0qgETiL3HNbdfGlnKHTA: posts big blind $0.50
*** HOLE CARDS ***
yBO+mXB6m/rCft2ErwGf/Q: calls $0.25
sa0qgETiL3HNbdfGlnKHTA: checks
*** FLOP *** [4h Jh Ks]
sa0qgETiL3HNbdfGlnKHTA: checks
yBO+mXB6m/rCft2ErwGf/Q: checks
*** TURN *** [4h Jh Ks] [Td]
sa0qgETiL3HNbdfGlnKHTA: checks
yBO+mXB6m/rCft2ErwGf/Q: checks
*** RIVER *** [4h Jh Ks Td] [4c]
sa0qgETiL3HNbdfGlnKHTA: bets $1
yBO+mXB6m/rCft2ErwGf/Q: folds
sa0qgETiL3HNbdfGlnKHTA collected $0.95 from pot
sa0qgETiL3HNbdfGlnKHTA: doesn't show hand
*** SUMMARY ***
Total pot $1 | Rake $0.05
Board [4h Jh Ks Td 4c]
Seat 1: yBO+mXB6m/rCft2ErwGf/Q (button) (small blind) folded on the River
Seat 2: sa0qgETiL3HNbdfGlnKHTA (big blind) collected ($0.95)



PokerStars Game #59938109448:  Hold'em No Limit ($0.25/$0.50) - 2009/07/01 0:07:14 ET
Table 'oxUN1yBuOHNrPf4xoy4aXw' 2-max Seat #1 is the button
Seat 1: ndd1nfncBkWNitBnsfCoVQ ($70.35 in chips)
Seat 2: mba14ZHNZ0/GoMe+gAVYmw ($34.20 in chips)
ndd1nfncBkWNitBnsfCoVQ: posts small blind $0.25
mba14ZHNZ0/GoMe+gAVYmw: posts big blind $0.50
*** HOLE CARDS ***
ndd1nfncBkWNitBnsfCoVQ: raises $1 to $1.50
mba14ZHNZ0/GoMe+gAVYmw: calls $1
*** FLOP *** [Ah 6c Qs]
mba14ZHNZ0/GoMe+gAVYmw: checks
ndd1nfncBkWNitBnsfCoVQ: checks
*** TURN *** [Ah 6c Qs] [6s]
mba14ZHNZ0/GoMe+gAVYmw: checks
ndd1nfncBkWNitBnsfCoVQ: checks
*** RIVER *** [Ah 6c Qs 6s] [Kc]
mba14ZHNZ0/GoMe+gAVYmw: bets $0.50
ndd1nfncBkWNitBnsfCoVQ: calls $0.50
*** SHOW DOWN ***
mba14ZHNZ0/GoMe+gAVYmw: shows [7h Kd] (two pair, Kings and Sixes)
ndd1nfncBkWNitBnsfCoVQ: mucks hand
mba14ZHNZ0/GoMe+gAVYmw collected $3.85 from pot
*** SUMMARY ***
Total pot $4 | Rake $0.15
Board [Ah 6c Qs 6s Kc]
Seat 1: ndd1nfncBkWNitBnsfCoVQ (button) (small blind) mucked
Seat 2: mba14ZHNZ0/GoMe+gAVYmw (big blind) showed [7h Kd] and won ($3.85) with two pair, Kings and Sixes



PokerStars Game #59938109724:  Hold'em No Limit ($0.25/$0.50) - 2009/07/01 0:07:15 ET
Table '+dXkOAQyS8j9PQZusUTMpg' 2-max Seat #1 is the button
Seat 1: XFa6sBGjP2gxoIvxR3fZIg ($69.55 in chips)
Seat 2: 5IBeOgaApY1Bvzv2P8X4EA ($45.10 in chips)
XFa6sBGjP2gxoIvxR3fZIg: posts small blind $0.25
5IBeOgaApY1Bvzv2P8X4EA: posts big blind $0.50
*** HOLE CARDS ***
XFa6sBGjP2gxoIvxR3fZIg: raises $1 to $1.50
5IBeOgaApY1Bvzv2P8X4EA: folds
XFa6sBGjP2gxoIvxR3fZIg collected $1 from pot
*** SUMMARY ***
Total pot $1 | Rake $0
Seat 1: XFa6sBGjP2gxoIvxR3fZIg (button) (small blind) collected ($1)
Seat 2: 5IBeOgaApY1Bvzv2P8X4EA (big blind) folded before Flop



PokerStars Game #59938110782:  Hold'em No Limit ($0.25/$0.50) - 2009/07/01 0:07:16 ET
Table 'kgbJRsxfv64KrErDRBAkcw' 6-max Seat #5 is the button
Seat 1: YmWlPGOKFuJSoJZPW8a8IA ($81.30 in chips)
Seat 2: Q+thC23WCv1kJUJtH/+4Jw ($28.85 in chips)
Seat 3: T0Gx/FcQ5VH9u7XaOMX97A ($61.65 in chips)
Seat 4: qanMEqjABjWxC/JgQ/0l7w ($62.20 in chips)
Seat 5: SlTdlH14u+KVVINgxMwt+Q ($69.45 in chips)
Seat 6: DDfYzIrYT0t5R/hAJngtsg ($19.60 in chips)
DDfYzIrYT0t5R/hAJngtsg: posts small blind $0.25
YmWlPGOKFuJSoJZPW8a8IA: posts big blind $0.50
*** HOLE CARDS ***
Q+thC23WCv1kJUJtH/+4Jw: folds
T0Gx/FcQ5VH9u7XaOMX97A: folds
qanMEqjABjWxC/JgQ/0l7w: folds
SlTdlH14u+KVVINgxMwt+Q: raises $1 to $1.50
DDfYzIrYT0t5R/hAJngtsg: calls $1.25
YmWlPGOKFuJSoJZPW8a8IA: folds
*** FLOP *** [4s 5h 9s]
DDfYzIrYT0t5R/hAJngtsg: checks
SlTdlH14u+KVVINgxMwt+Q: checks
*** TURN *** [4s 5h 9s] [Qd]
DDfYzIrYT0t5R/hAJngtsg: bets $1.50
SlTdlH14u+KVVINgxMwt+Q: folds
DDfYzIrYT0t5R/hAJngtsg collected $3.35 from pot
*** SUMMARY ***
Total pot $3.50 | Rake $0.15
Board [4s 5h 9s Qd]
Seat 1: YmWlPGOKFuJSoJZPW8a8IA (big blind) folded before Flop
Seat 2: Q+thC23WCv1kJUJtH/+4Jw folded before Flop (didn't bet)
Seat 3: T0Gx/FcQ5VH9u7XaOMX97A folded before Flop (didn't bet)
Seat 4: qanMEqjABjWxC/JgQ/0l7w folded before Flop (didn't bet)
Seat 5: SlTdlH14u+KVVINgxMwt+Q (button) folded on the Turn
Seat 6: DDfYzIrYT0t5R/hAJngtsg (small blind) collected ($3.35)



PokerStars Game #59938110960:  Hold'em No Limit ($0.25/$0.50) - 2009/07/01 0:07:16 ET
Table 'BCN5su+SsXiy1zRMJi0SJw' 6-max Seat #4 is the button
Seat 1: WyeokAqR0q9nADSkWpbxHw ($40.90 in chips)
Seat 2: QfV2JJlmEKgD5jYPV+a33A ($158.65 in chips)
Seat 4: 6Wb8PlO2kM4fnSim7p4Mrw ($10.35 in chips)
Seat 5: TTx3CHxyi0SObcHyMJRp5w ($40 in chips)
Seat 6: zHXshyreKwJVq3N3U+K9uQ ($51.30 in chips)
TTx3CHxyi0SObcHyMJRp5w: posts small blind $0.25
zHXshyreKwJVq3N3U+K9uQ: posts big blind $0.50
*** HOLE CARDS ***
L309C3uyA1tkWSOh/QvjHw joins the table at seat #3
WyeokAqR0q9nADSkWpbxHw: folds
QfV2JJlmEKgD5jYPV+a33A: folds
6Wb8PlO2kM4fnSim7p4Mrw: calls $0.50
TTx3CHxyi0SObcHyMJRp5w: calls $0.25
zHXshyreKwJVq3N3U+K9uQ: checks
*** FLOP *** [Ks 3s 4d]
TTx3CHxyi0SObcHyMJRp5w: bets $1
zHXshyreKwJVq3N3U+K9uQ: folds
zHXshyreKwJVq3N3U+K9uQ is sitting out
6Wb8PlO2kM4fnSim7p4Mrw: calls $1
*** TURN *** [Ks 3s 4d] [5d]
TTx3CHxyi0SObcHyMJRp5w: bets $2
6Wb8PlO2kM4fnSim7p4Mrw: calls $2
*** RIVER *** [Ks 3s 4d 5d] [2s]
TTx3CHxyi0SObcHyMJRp5w: bets $1
6Wb8PlO2kM4fnSim7p4Mrw: raises $1 to $2
TTx3CHxyi0SObcHyMJRp5w: calls $1
*** SHOW DOWN ***
6Wb8PlO2kM4fnSim7p4Mrw: shows [Kc Ad] (a straight, Ace to Five)
TTx3CHxyi0SObcHyMJRp5w: mucks hand
6Wb8PlO2kM4fnSim7p4Mrw collected $10.95 from pot
*** SUMMARY ***
Total pot $11.50 | Rake $0.55
Board [Ks 3s 4d 5d 2s]
Seat 1: WyeokAqR0q9nADSkWpbxHw folded before Flop (didn't bet)
Seat 2: QfV2JJlmEKgD5jYPV+a33A folded before Flop (didn't bet)
Seat 4: 6Wb8PlO2kM4fnSim7p4Mrw (button) showed [Kc Ad] and won ($10.95) with a straight, Ace to Five
Seat 5: TTx3CHxyi0SObcHyMJRp5w (small blind) mucked
Seat 6: zHXshyreKwJVq3N3U+K9uQ (big blind) folded on the Flop



PokerStars Game #59938111162:  Hold'em No Limit ($0.25/$0.50) - 2009/07/01 0:07:17 ET
Table 'eMxdLyFDf28E0wit6gm3Uw' 6-max Seat #2 is the button
Seat 1: tnD/64LagZ9qPaeOQVjVZg ($10.75 in chips)
Seat 2: jwuKQ1S3U4NnzMQn3E3dgw ($65.15 in chips)
Seat 4: crjGpJEzSZgD38FoE3VMGg ($50 in chips)
Seat 5: X0X97o2fDAPiGx6o1gahsw ($58.80 in chips)
Seat 6: L0aIPg7qefDQjdJo3HCVEA ($7.50 in chips)
crjGpJEzSZgD38FoE3VMGg: posts small blind $0.25
X0X97o2fDAPiGx6o1gahsw: posts big blind $0.50
*** HOLE CARDS ***
L0aIPg7qefDQjdJo3HCVEA: folds
tnD/64LagZ9qPaeOQVjVZg: folds
jwuKQ1S3U4NnzMQn3E3dgw: folds
crjGpJEzSZgD38FoE3VMGg: raises $1.50 to $2
X0X97o2fDAPiGx6o1gahsw: folds
crjGpJEzSZgD38FoE3VMGg collected $1 from pot
*** SUMMARY ***
Total pot $1 | Rake $0
Seat 1: tnD/64LagZ9qPaeOQVjVZg folded before Flop (didn't bet)
Seat 2: jwuKQ1S3U4NnzMQn3E3dgw (button) folded before Flop (didn't bet)
Seat 4: crjGpJEzSZgD38FoE3VMGg (small blind) collected ($1)
Seat 5: X0X97o2fDAPiGx6o1gahsw (big blind) folded before Flop
Seat 6: L0aIPg7qefDQjdJo3HCVEA folded before Flop (didn't bet)



PokerStars Game #59938112946:  Hold'em No Limit ($0.25/$0.50) - 2009/07/01 0:07:19 ET
Table 'mTxf8gPLgffN3Iwfm7Icfg' 2-max Seat #2 is the button
Seat 1: Do9Rlu1R5u/AcRtMTl8SYg ($67.85 in chips)
Seat 2: EMc5LPgVaded4Qc77vm0fw ($46.70 in chips)
EMc5LPgVaded4Qc77vm0fw: posts small blind $0.25
Do9Rlu1R5u/AcRtMTl8SYg: posts big blind $0.50
*** HOLE CARDS ***
EMc5LPgVaded4Qc77vm0fw: raises $1.50 to $2
Do9Rlu1R5u/AcRtMTl8SYg: folds
EMc5LPgVaded4Qc77vm0fw collected $1 from pot
EMc5LPgVaded4Qc77vm0fw: doesn't show hand
*** SUMMARY ***
Total pot $1 | Rake $0
Seat 1: Do9Rlu1R5u/AcRtMTl8SYg (big blind) folded before Flop
Seat 2: EMc5LPgVaded4Qc77vm0fw (button) (small blind) collected ($1)



PokerStars Game #59938113170:  Hold'em No Limit ($0.25/$0.50) - 2009/07/01 0:07:20 ET
Table 'SsXEKOwKN+jE3etfusqUqA' 2-max Seat #2 is the button
Seat 1: 618rKeLrz/avGNOLULHHVQ ($74.80 in chips)
Seat 2: XfRhywXA6Br+jID1oGeo8A ($176.10 in chips)
XfRhywXA6Br+jID1oGeo8A: posts small blind $0.25
618rKeLrz/avGNOLULHHVQ: posts big blind $0.50
*** HOLE CARDS ***
XfRhywXA6Br+jID1oGeo8A: raises $0.50 to $1
618rKeLrz/avGNOLULHHVQ: raises $3.50 to $4.50
XfRhywXA6Br+jID1oGeo8A: raises $12 to $16.50
618rKeLrz/avGNOLULHHVQ: raises $58.30 to $74.80 and is all-in
XfRhywXA6Br+jID1oGeo8A: calls $58.30
*** FLOP *** [8h Kc 4h]
*** TURN *** [8h Kc 4h] [Jc]
*** RIVER *** [8h Kc 4h Jc] [3c]
*** SHOW DOWN ***
618rKeLrz/avGNOLULHHVQ: shows [Ad Th] (high card Ace)
XfRhywXA6Br+jID1oGeo8A: shows [Qs Qd] (a pair of Queens)
XfRhywXA6Br+jID1oGeo8A collected $149.10 from pot
*** SUMMARY ***
Total pot $149.60 | Rake $0.50
Board [8h Kc 4h Jc 3c]
Seat 1: 618rKeLrz/avGNOLULHHVQ (big blind) showed [Ad Th] and lost with high card Ace
Seat 2: XfRhywXA6Br+jID1oGeo8A (button) (small blind) showed [Qs Qd] and won ($149.10) with a pair of Queens



PokerStars Game #59938113286:  Hold'em No Limit ($0.25/$0.50) - 2009/07/01 0:07:20 ET
Table 'QOgaEqMcJ73pcUMMxoisUg' 6-max Seat #6 is the button
Seat 1: RFefXIDyFvNtJLq+CloCzA ($42.70 in chips)
Seat 3: wUZNozoIDYf+16hp4nn6dw ($29.25 in chips)
Seat 5: HoaSQCRso+nEyO5DUhGduw ($57.75 in chips)
Seat 6: s83dnhZ6VC53vY0/f6OV/g ($47.80 in chips)
RFefXIDyFvNtJLq+CloCzA: posts small blind $0.25
wUZNozoIDYf+16hp4nn6dw: posts big blind $0.50
zAcsDhG/T128Vn7XGVSgKg: sits out
*** HOLE CARDS ***
HoaSQCRso+nEyO5DUhGduw: folds
s83dnhZ6VC53vY0/f6OV/g: folds
RFefXIDyFvNtJLq+CloCzA: raises $2 to $2.50
wUZNozoIDYf+16hp4nn6dw: folds
RFefXIDyFvNtJLq+CloCzA collected $1 from pot
*** SUMMARY ***
Total pot $1 | Rake $0
Seat 1: RFefXIDyFvNtJLq+CloCzA (small blind) collected ($1)
Seat 3: wUZNozoIDYf+16hp4nn6dw (big blind) folded before Flop
Seat 5: HoaSQCRso+nEyO5DUhGduw folded before Flop (didn't bet)
Seat 6: s83dnhZ6VC53vY0/f6OV/g (button) folded before Flop (didn't bet)



PokerStars Game #59938113810:  Hold'em No Limit ($0.25/$0.50) - 2009/07/01 0:07:21 ET
Table 'raOT4/ipuZgzjfKHC+jD9g' 2-max Seat #1 is the button
Seat 1: IuwLemwLhc9fvrwBGs0AMA ($11.60 in chips)
Seat 2: Udr5juWSWUgTu1NlRhjMdA ($12.20 in chips)
IuwLemwLhc9fvrwBGs0AMA: posts small blind $0.25
Udr5juWSWUgTu1NlRhjMdA: posts big blind $0.50
*** HOLE CARDS ***
IuwLemwLhc9fvrwBGs0AMA: raises $0.50 to $1
Udr5juWSWUgTu1NlRhjMdA: folds
IuwLemwLhc9fvrwBGs0AMA collected $1 from pot
*** SUMMARY ***
Total pot $1 | Rake $0
Seat 1: IuwLemwLhc9fvrwBGs0AMA (button) (small blind) collected ($1)
Seat 2: Udr5juWSWUgTu1NlRhjMdA (big blind) folded before Flop



PokerStars Game #59938114414:  Hold'em No Limit ($0.25/$0.50) - 2009/07/01 0:07:21 ET
Table 'otvGDROEDdqsabxskT79qg' 9-max Seat #5 is the button
Seat 1: LM/g4VPDfD+0JhpH9Q/3fw ($26.55 in chips)
Seat 2: cCjTzH9jio8607WzjcfXlg ($47.10 in chips)
Seat 3: +k7T5ocke8UwavtgUHm+Cg ($52.35 in chips)
Seat 4: MG90wfSJZnOejs/KD3vlQQ ($50 in chips)
Seat 5: YPo1oggovmqSREegekaQYw ($16.80 in chips)
Seat 7: C7+tBppJrKgd/r+tuKUIpA ($42.30 in chips)
Seat 9: KcY3X8YpD74Kw1RHkx/g4A ($38.85 in chips)
C7+tBppJrKgd/r+tuKUIpA: posts small blind $0.25
KcY3X8YpD74Kw1RHkx/g4A: posts big blind $0.50
*** HOLE CARDS ***
LM/g4VPDfD+0JhpH9Q/3fw: calls $0.50
WpvT3OUSiZlpvs+mPXFqtQ joins the table at seat #8
cCjTzH9jio8607WzjcfXlg: calls $0.50
+k7T5ocke8UwavtgUHm+Cg: folds
MG90wfSJZnOejs/KD3vlQQ: folds
YPo1oggovmqSREegekaQYw: folds
C7+tBppJrKgd/r+tuKUIpA: calls $0.25
KcY3X8YpD74Kw1RHkx/g4A: checks
*** FLOP *** [4s Th 5c]
C7+tBppJrKgd/r+tuKUIpA: checks
KcY3X8YpD74Kw1RHkx/g4A: checks
LM/g4VPDfD+0JhpH9Q/3fw: bets $1
cCjTzH9jio8607WzjcfXlg: folds
C7+tBppJrKgd/r+tuKUIpA: calls $1
KcY3X8YpD74Kw1RHkx/g4A: folds
*** TURN *** [4s Th 5c] [9d]
C7+tBppJrKgd/r+tuKUIpA: checks
LM/g4VPDfD+0JhpH9Q/3fw: bets $2
C7+tBppJrKgd/r+tuKUIpA: calls $2
*** RIVER *** [4s Th 5c 9d] [5d]
C7+tBppJrKgd/r+tuKUIpA: checks
LM/g4VPDfD+0JhpH9Q/3fw: checks
*** SHOW DOWN ***
C7+tBppJrKgd/r+tuKUIpA: shows [Td Ks] (two pair, Tens and Fives)
LM/g4VPDfD+0JhpH9Q/3fw: shows [Qs Qh] (two pair, Queens and Fives)
LM/g4VPDfD+0JhpH9Q/3fw collected $7.65 from pot
*** SUMMARY ***
Total pot $8 | Rake $0.35
Board [4s Th 5c 9d 5d]
Seat 1: LM/g4VPDfD+0JhpH9Q/3fw showed [Qs Qh] and won ($7.65) with two pair, Queens and Fives
Seat 2: cCjTzH9jio8607WzjcfXlg folded on the Flop
Seat 3: +k7T5ocke8UwavtgUHm+Cg folded before Flop (didn't bet)
Seat 4: MG90wfSJZnOejs/KD3vlQQ folded before Flop (didn't bet)
Seat 5: YPo1oggovmqSREegekaQYw (button) folded before Flop (didn't bet)
Seat 7: C7+tBppJrKgd/r+tuKUIpA (small blind) showed [Td Ks] and lost with two pair, Tens and Fives
Seat 9: KcY3X8YpD74Kw1RHkx/g4A (big blind) folded on the Flop



PokerStars Game #59938115236:  Hold'em No Limit ($0.25/$0.50) - 2009/07/01 0:07:23 ET
Table '+dXkOAQyS8j9PQZusUTMpg' 2-max Seat #2 is the button
Seat 1: XFa6sBGjP2gxoIvxR3fZIg ($70.05 in chips)
Seat 2: 5IBeOgaApY1Bvzv2P8X4EA ($44.60 in chips)
5IBeOgaApY1Bvzv2P8X4EA: posts small blind $0.25
XFa6sBGjP2gxoIvxR3fZIg: posts big blind $0.50
*** HOLE CARDS ***
5IBeOgaApY1Bvzv2P8X4EA: calls $0.25
XFa6sBGjP2gxoIvxR3fZIg: raises $2 to $2.50
5IBeOgaApY1Bvzv2P8X4EA: calls $2
*** FLOP *** [4c 9s Qd]
XFa6sBGjP2gxoIvxR3fZIg: checks
5IBeOgaApY1Bvzv2P8X4EA: checks
*** TURN *** [4c 9s Qd] [8s]
XFa6sBGjP2gxoIvxR3fZIg: checks
5IBeOgaApY1Bvzv2P8X4EA: bets $2
XFa6sBGjP2gxoIvxR3fZIg: calls $2
*** RIVER *** [4c 9s Qd 8s] [2c]
XFa6sBGjP2gxoIvxR3fZIg: checks
5IBeOgaApY1Bvzv2P8X4EA: bets $4.50
XFa6sBGjP2gxoIvxR3fZIg: folds
5IBeOgaApY1Bvzv2P8X4EA collected $8.60 from pot
5IBeOgaApY1Bvzv2P8X4EA: doesn't show hand
*** SUMMARY ***
Total pot $9 | Rake $0.40
Board [4c 9s Qd 8s 2c]
Seat 1: XFa6sBGjP2gxoIvxR3fZIg (big blind) folded on the River
Seat 2: 5IBeOgaApY1Bvzv2P8X4EA (button) (small blind) collected ($8.60)



PokerStars Game #59938115994:  Hold'em No Limit ($0.25/$0.50) - 2009/07/01 0:07:24 ET
Table '5EmHi+fnatGQQShcNmzOZQ' 6-max Seat #3 is the button
Seat 1: SwPczQo3cOtwEzhJrfO2cQ ($22.30 in chips)
Seat 2: APwvTk5XojDXGoQLb4O5iA ($27.35 in chips)
Seat 3: J8dF2sYMvXUmAGUuSW9kwg ($34.55 in chips)
Seat 4: mFTuMjESuBcXHQ1ePkg/8A ($17.20 in chips)
Seat 5: kxPhs4ePFqMy52CInAJ2aw ($73.05 in chips)
Seat 6: 686aeHikcJlgKkSuIFdcXQ ($115.45 in chips)
mFTuMjESuBcXHQ1ePkg/8A: posts small blind $0.25
kxPhs4ePFqMy52CInAJ2aw: posts big blind $0.50
*** HOLE CARDS ***
686aeHikcJlgKkSuIFdcXQ: folds
SwPczQo3cOtwEzhJrfO2cQ: folds
APwvTk5XojDXGoQLb4O5iA: folds
J8dF2sYMvXUmAGUuSW9kwg: folds
mFTuMjESuBcXHQ1ePkg/8A: calls $0.25
kxPhs4ePFqMy52CInAJ2aw: checks
*** FLOP *** [8d 9d 7d]
mFTuMjESuBcXHQ1ePkg/8A: checks
kxPhs4ePFqMy52CInAJ2aw: checks
*** TURN *** [8d 9d 7d] [8c]
mFTuMjESuBcXHQ1ePkg/8A: checks
kxPhs4ePFqMy52CInAJ2aw: checks
*** RIVER *** [8d 9d 7d 8c] [As]
mFTuMjESuBcXHQ1ePkg/8A: bets $1.50
kxPhs4ePFqMy52CInAJ2aw: folds
mFTuMjESuBcXHQ1ePkg/8A collected $0.95 from pot
mFTuMjESuBcXHQ1ePkg/8A: doesn't show hand
*** SUMMARY ***
Total pot $1 | Rake $0.05
Board [8d 9d 7d 8c As]
Seat 1: SwPczQo3cOtwEzhJrfO2cQ folded before Flop (didn't bet)
Seat 2: APwvTk5XojDXGoQLb4O5iA folded before Flop (didn't bet)
Seat 3: J8dF2sYMvXUmAGUuSW9kwg (button) folded before Flop (didn't bet)
Seat 4: mFTuMjESuBcXHQ1ePkg/8A (small blind) collected ($0.95)
Seat 5: kxPhs4ePFqMy52CInAJ2aw (big blind) folded on the River
Seat 6: 686aeHikcJlgKkSuIFdcXQ folded before Flop (didn't bet)



PokerStars Game #59938116730:  Hold'em No Limit ($0.25/$0.50) - 2009/07/01 0:07:25 ET
Table 'MJxeZCzYELxiIsyUZyT0jw' 6-max Seat #1 is the button
Seat 1: iKPos8JI094Tomq4tDSgnQ ($28 in chips)
Seat 2: r6H1GiZ6QIpMTDhyodKuRQ ($65.15 in chips)
Seat 3: JQZew0FjzS19kTjeNtrE+A ($50 in chips)
Seat 4: lP7Q6pewz4C2RsAfKsjdWw ($25.50 in chips)
Seat 5: 3jvoOXNtXE90w2BdfNZwZQ ($53 in chips)
Seat 6: TTx3CHxyi0SObcHyMJRp5w ($40.70 in chips)
r6H1GiZ6QIpMTDhyodKuRQ: posts small blind $0.25
JQZew0FjzS19kTjeNtrE+A: posts big blind $0.50
*** HOLE CARDS ***
lP7Q6pewz4C2RsAfKsjdWw: calls $0.50
3jvoOXNtXE90w2BdfNZwZQ: folds
TTx3CHxyi0SObcHyMJRp5w: folds
iKPos8JI094Tomq4tDSgnQ: raises $1.50 to $2
r6H1GiZ6QIpMTDhyodKuRQ: folds
JQZew0FjzS19kTjeNtrE+A: folds
lP7Q6pewz4C2RsAfKsjdWw: calls $1.50
*** FLOP *** [Ad Qd 5h]
lP7Q6pewz4C2RsAfKsjdWw: checks
iKPos8JI094Tomq4tDSgnQ: checks
*** TURN *** [Ad Qd 5h] [7d]
lP7Q6pewz4C2RsAfKsjdWw: bets $1.50
iKPos8JI094Tomq4tDSgnQ: calls $1.50
*** RIVER *** [Ad Qd 5h 7d] [3c]
lP7Q6pewz4C2RsAfKsjdWw: bets $6
iKPos8JI094Tomq4tDSgnQ: raises $10 to $16
lP7Q6pewz4C2RsAfKsjdWw: folds
iKPos8JI094Tomq4tDSgnQ collected $18.80 from pot
iKPos8JI094Tomq4tDSgnQ: shows [Ac As] (three of a kind, Aces)
*** SUMMARY ***
Total pot $19.75 | Rake $0.95
Board [Ad Qd 5h 7d 3c]
Seat 1: iKPos8JI094Tomq4tDSgnQ (button) collected ($18.80)
Seat 2: r6H1GiZ6QIpMTDhyodKuRQ (small blind) folded before Flop
Seat 3: JQZew0FjzS19kTjeNtrE+A (big blind) folded before Flop
Seat 4: lP7Q6pewz4C2RsAfKsjdWw folded on the River
Seat 5: 3jvoOXNtXE90w2BdfNZwZQ folded before Flop (didn't bet)
Seat 6: TTx3CHxyi0SObcHyMJRp5w folded before Flop (didn't bet)



PokerStars Game #59938117232:  Hold'em No Limit ($0.25/$0.50) - 2009/07/01 0:07:25 ET
Table 'QOgaEqMcJ73pcUMMxoisUgErOuyGLI5PT3G5MnpHgC/g Seat #3 is the button
Seat 1: k6GJzKs7T7qvQggW9g8Pdw ($47.75 in chips)
Seat 2: RjBdQ6w31rgcy0o24VLR6w ($10.95 in chips)
Seat 3: xZCXQSXlrZkp3pZizzVXCw ($50.50 in chips)
Seat 4: U7aZzIYWjv3SL30KtikLbw ($48.45 in chips)
Seat 5: JwvquocWfhTVApN5t47LgA ($51.05 in chips)
Seat 6: zE9cVigS2nW/Ljy4K4bUQA ($31.35 in chips)
Seat 7: 90Wb75h3W1BRpbqVnuk8gw ($62.55 in chips)
Seat 9: J0W5D97jl5VLky+IoPvDeA ($67.80 in chips)
U7aZzIYWjv3SL30KtikLbw: posts small blind $0.25
JwvquocWfhTVApN5t47LgA: posts big blind $0.50
*** HOLE CARDS ***
g4k0NXISyLCqaSWZDBjfEg joins the table at seat #8
zE9cVigS2nW/Ljy4K4bUQA: folds
90Wb75h3W1BRpbqVnuk8gw: folds
J0W5D97jl5VLky+IoPvDeA: folds
k6GJzKs7T7qvQggW9g8Pdw: calls $0.50
RjBdQ6w31rgcy0o24VLR6w: folds
xZCXQSXlrZkp3pZizzVXCw: folds
U7aZzIYWjv3SL30KtikLbw: calls $0.25
JwvquocWfhTVApN5t47LgA: checks
*** FLOP *** [8d Kc Js]
U7aZzIYWjv3SL30KtikLbw: checks
JwvquocWfhTVApN5t47LgA: checks
k6GJzKs7T7qvQggW9g8Pdw: bets $1
U7aZzIYWjv3SL30KtikLbw: folds
JwvquocWfhTVApN5t47LgA: folds
k6GJzKs7T7qvQggW9g8Pdw collected $1.45 from pot
k6GJzKs7T7qvQggW9g8Pdw: doesn't show hand
*** SUMMARY ***
Total pot $1.50 | Rake $0.05
Board [8d Kc Js]
Seat 1: k6GJzKs7T7qvQggW9g8Pdw collected ($1.45)
Seat 2: RjBdQ6w31rgcy0o24VLR6w folded before Flop (didn't bet)
Seat 3: xZCXQSXlrZkp3pZizzVXCw (button) folded before Flop (didn't bet)
Seat 4: U7aZzIYWjv3SL30KtikLbw (small blind) folded on the Flop
Seat 5: JwvquocWfhTVApN5t47LgA (big blind) folded on the Flop
Seat 6: zE9cVigS2nW/Ljy4K4bUQA folded before Flop (didn't bet)
Seat 7: 90Wb75h3W1BRpbqVnuk8gw folded before Flop (didn't bet)
Seat 9: J0W5D97jl5VLky+IoPvDeA folded before Flop (didn't bet)



PokerStars Game #59938118098:  Hold'em No Limit ($0.25/$0.50) - 2009/07/01 0:07:26 ET
Table 'mTxf8gPLgffN3Iwfm7Icfg' 2-max Seat #1 is the button
Seat 1: Do9Rlu1R5u/AcRtMTl8SYg ($67.35 in chips)
Seat 2: EMc5LPgVaded4Qc77vm0fw ($47.20 in chips)
Do9Rlu1R5u/AcRtMTl8SYg: posts small blind $0.25
EMc5LPgVaded4Qc77vm0fw: posts big blind $0.50
*** HOLE CARDS ***
Do9Rlu1R5u/AcRtMTl8SYg: folds
EMc5LPgVaded4Qc77vm0fw collected $0.50 from pot
EMc5LPgVaded4Qc77vm0fw: doesn't show hand
*** SUMMARY ***
Total pot $0.50 | Rake $0
Seat 1: Do9Rlu1R5u/AcRtMTl8SYg (button) (small blind) folded before Flop
Seat 2: EMc5LPgVaded4Qc77vm0fw (big blind) collected ($0.50)



PokerStars Game #59938119860:  Hold'em No Limit ($0.25/$0.50) - 2009/07/01 0:07:29 ET
Table 'EiNh8p/wGJ1FP575iMFnqg' 9-max Seat #6 is the button
Seat 1: r3ZqM1Mi0W3y4hOdssE+Sg ($43.25 in chips)
Seat 2: avsQkZXsRKnWa7gkjVNvog ($27.90 in chips)
Seat 3: GszS/McxOSUnOET7MBoHqA ($62.75 in chips)
Seat 4: pk8aA8qMBEL6zXqSyfVXMA ($80.05 in chips)
Seat 5: M+7+BTmX5vZatHVuoRB1nA ($89 in chips)
Seat 6: YPo1oggovmqSREegekaQYw ($14.20 in chips)
Seat 9: OMwFJ4pF0xk2Ru/AJiFeFw ($72.40 in chips)
KrPAGRACBg+w0M//SXe8Ag will be allowed to play after the button
OMwFJ4pF0xk2Ru/AJiFeFw: posts small blind $0.25
r3ZqM1Mi0W3y4hOdssE+Sg: posts big blind $0.50
*** HOLE CARDS ***
avsQkZXsRKnWa7gkjVNvog: folds
GszS/McxOSUnOET7MBoHqA: raises $0.50 to $1
avsQkZXsRKnWa7gkjVNvog leaves the table
pk8aA8qMBEL6zXqSyfVXMA: folds
M+7+BTmX5vZatHVuoRB1nA: folds
YPo1oggovmqSREegekaQYw: folds
OMwFJ4pF0xk2Ru/AJiFeFw: folds
r3ZqM1Mi0W3y4hOdssE+Sg: calls $0.50
*** FLOP *** [Js 9c Th]
r3ZqM1Mi0W3y4hOdssE+Sg: checks
sSAA879uXOGR+8Mf3zLa6Q joins the table at seat #2
GszS/McxOSUnOET7MBoHqA: bets $1
r3ZqM1Mi0W3y4hOdssE+Sg: calls $1
*** TURN *** [Js 9c Th] [8d]
r3ZqM1Mi0W3y4hOdssE+Sg: checks
GszS/McxOSUnOET7MBoHqA: bets $1.50
r3ZqM1Mi0W3y4hOdssE+Sg: calls $1.50
*** RIVER *** [Js 9c Th 8d] [9h]
r3ZqM1Mi0W3y4hOdssE+Sg: checks
GszS/McxOSUnOET7MBoHqA: bets $5
r3ZqM1Mi0W3y4hOdssE+Sg: calls $5
*** SHOW DOWN ***
GszS/McxOSUnOET7MBoHqA: shows [Kd Qh] (a straight, Nine to King)
r3ZqM1Mi0W3y4hOdssE+Sg: mucks hand
GszS/McxOSUnOET7MBoHqA collected $16.45 from pot
*** SUMMARY ***
Total pot $17.25 | Rake $0.80
Board [Js 9c Th 8d 9h]
Seat 1: r3ZqM1Mi0W3y4hOdssE+Sg (big blind) mucked
Seat 2: avsQkZXsRKnWa7gkjVNvog folded before Flop (didn't bet)
Seat 3: GszS/McxOSUnOET7MBoHqA showed [Kd Qh] and won ($16.45) with a straight, Nine to King
Seat 4: pk8aA8qMBEL6zXqSyfVXMA folded before Flop (didn't bet)
Seat 5: M+7+BTmX5vZatHVuoRB1nA folded before Flop (didn't bet)
Seat 6: YPo1oggovmqSREegekaQYw (button) folded before Flop (didn't bet)
Seat 9: OMwFJ4pF0xk2Ru/AJiFeFw (small blind) folded before Flop



PokerStars Game #59938120720:  Hold'em No Limit ($0.25/$0.50) - 2009/07/01 0:07:30 ET
Table 'raOT4/ipuZgzjfKHC+jD9g' 2-max Seat #2 is the button
Seat 1: IuwLemwLhc9fvrwBGs0AMA ($12.10 in chips)
Seat 2: Udr5juWSWUgTu1NlRhjMdA ($11.70 in chips)
Udr5juWSWUgTu1NlRhjMdA: posts small blind $0.25
IuwLemwLhc9fvrwBGs0AMA: posts big blind $0.50
*** HOLE CARDS ***
Udr5juWSWUgTu1NlRhjMdA: folds
IuwLemwLhc9fvrwBGs0AMA collected $0.50 from pot
*** SUMMARY ***
Total pot $0.50 | Rake $0
Seat 1: IuwLemwLhc9fvrwBGs0AMA (big blind) collected ($0.50)
Seat 2: Udr5juWSWUgTu1NlRhjMdA (button) (small blind) folded before Flop



PokerStars Game #59938121642:  Hold'em No Limit ($0.25/$0.50) - 2009/07/01 0:07:31 ET
Table 'lpxYasB1ClBSgTpCCITwhQ' 9-max Seat #8 is the button
Seat 1: ceq82/EkjUd/GFbf0YwGmA ($40.95 in chips)
Seat 3: E2518gp4aFz1+kAgmGqeEg ($10.75 in chips)
Seat 4: k1f0lS7tlMHCLGs0JT34Tg ($10 in chips)
Seat 5: bXpVeaSTPBFSPJmeXxO7nw ($9.25 in chips)
Seat 6: YPo1oggovmqSREegekaQYw ($18.10 in chips)
Seat 7: zE9cVigS2nW/Ljy4K4bUQA ($30 in chips)
Seat 8: o6JyUkbzCDw8tUabqtmnlg ($25.55 in chips)
Seat 9: mSD1pginDsyHG5PDfqzphw ($11.25 in chips)
mSD1pginDsyHG5PDfqzphw: posts small blind $0.25
ceq82/EkjUd/GFbf0YwGmA: posts big blind $0.50
*** HOLE CARDS ***
E2518gp4aFz1+kAgmGqeEg: folds
k1f0lS7tlMHCLGs0JT34Tg: calls $0.50
bXpVeaSTPBFSPJmeXxO7nw: folds
YPo1oggovmqSREegekaQYw: folds
zE9cVigS2nW/Ljy4K4bUQA: folds
o6JyUkbzCDw8tUabqtmnlg: calls $0.50
mSD1pginDsyHG5PDfqzphw: folds
ceq82/EkjUd/GFbf0YwGmA: checks
*** FLOP *** [Qd Ts 7s]
ceq82/EkjUd/GFbf0YwGmA: checks
k1f0lS7tlMHCLGs0JT34Tg: bets $1
o6JyUkbzCDw8tUabqtmnlg: calls $1
ceq82/EkjUd/GFbf0YwGmA: folds
*** TURN *** [Qd Ts 7s] [2c]
k1f0lS7tlMHCLGs0JT34Tg: bets $1
o6JyUkbzCDw8tUabqtmnlg: calls $1
*** RIVER *** [Qd Ts 7s 2c] [3s]
k1f0lS7tlMHCLGs0JT34Tg: checks
o6JyUkbzCDw8tUabqtmnlg: checks
*** SHOW DOWN ***
k1f0lS7tlMHCLGs0JT34Tg: shows [Qc 5c] (a pair of Queens)
o6JyUkbzCDw8tUabqtmnlg: mucks hand
k1f0lS7tlMHCLGs0JT34Tg collected $5.50 from pot
*** SUMMARY ***
Total pot $5.75 | Rake $0.25
Board [Qd Ts 7s 2c 3s]
Seat 1: ceq82/EkjUd/GFbf0YwGmA (big blind) folded on the Flop
Seat 3: E2518gp4aFz1+kAgmGqeEg folded before Flop (didn't bet)
Seat 4: k1f0lS7tlMHCLGs0JT34Tg showed [Qc 5c] and won ($5.50) with a pair of Queens
Seat 5: bXpVeaSTPBFSPJmeXxO7nw folded before Flop (didn't bet)
Seat 6: YPo1oggovmqSREegekaQYw folded before Flop (didn't bet)
Seat 7: zE9cVigS2nW/Ljy4K4bUQA folded before Flop (didn't bet)
Seat 8: o6JyUkbzCDw8tUabqtmnlg (button) mucked
Seat 9: mSD1pginDsyHG5PDfqzphw (small blind) folded before Flop



PokerStars Game #59938121234:  Hold'em No Limit ($0.25/$0.50) - 2009/07/01 0:07:31 ET
Table 'lSisgp6H7Fg1hH5VfjEjYQ' 9-max Seat #7 is the button
Seat 1: pEW8B6uXbdR47kfljMQ3+Q ($40.45 in chips)
Seat 2: UrcnkQOiLVk8BlKDPJSy7Q ($53.85 in chips)
Seat 3: RjBdQ6w31rgcy0o24VLR6w ($13.15 in chips)
Seat 4: nvw9yQKhJT56lA9k+TLdhw ($12.70 in chips)
Seat 5: mSD1pginDsyHG5PDfqzphw ($10 in chips)
Seat 6: +k7T5ocke8UwavtgUHm+Cg ($27.75 in chips)
Seat 7: xyQ4CeZa3ug3ompz+5xSTg ($73.95 in chips)
Seat 8: bXpVeaSTPBFSPJmeXxO7nw ($9.50 in chips)
Seat 9: 5JJVDlaiMnB004o/RqbZZQ ($39.25 in chips)
bXpVeaSTPBFSPJmeXxO7nw: posts small blind $0.25
5JJVDlaiMnB004o/RqbZZQ: posts big blind $0.50
*** HOLE CARDS ***
pEW8B6uXbdR47kfljMQ3+Q: folds
UrcnkQOiLVk8BlKDPJSy7Q: folds
RjBdQ6w31rgcy0o24VLR6w: folds
nvw9yQKhJT56lA9k+TLdhw: raises $0.50 to $1
mSD1pginDsyHG5PDfqzphw: folds
+k7T5ocke8UwavtgUHm+Cg: calls $1
xyQ4CeZa3ug3ompz+5xSTg: folds
bXpVeaSTPBFSPJmeXxO7nw: raises $8.50 to $9.50 and is all-in
5JJVDlaiMnB004o/RqbZZQ: folds
nvw9yQKhJT56lA9k+TLdhw: folds
+k7T5ocke8UwavtgUHm+Cg: calls $8.50
*** FLOP *** [Qs 4c 2s]
*** TURN *** [Qs 4c 2s] [9d]
*** RIVER *** [Qs 4c 2s 9d] [Jc]
*** SHOW DOWN ***
bXpVeaSTPBFSPJmeXxO7nw: shows [6d 6h] (a pair of Sixes)
+k7T5ocke8UwavtgUHm+Cg: mucks hand
bXpVeaSTPBFSPJmeXxO7nw collected $19.50 from pot
*** SUMMARY ***
Total pot $20.50 | Rake $1
Board [Qs 4c 2s 9d Jc]
Seat 1: pEW8B6uXbdR47kfljMQ3+Q folded before Flop (didn't bet)
Seat 2: UrcnkQOiLVk8BlKDPJSy7Q folded before Flop (didn't bet)
Seat 3: RjBdQ6w31rgcy0o24VLR6w folded before Flop (didn't bet)
Seat 4: nvw9yQKhJT56lA9k+TLdhw folded before Flop
Seat 5: mSD1pginDsyHG5PDfqzphw folded before Flop (didn't bet)
Seat 6: +k7T5ocke8UwavtgUHm+Cg mucked
Seat 7: xyQ4CeZa3ug3ompz+5xSTg (button) folded before Flop (didn't bet)
Seat 8: bXpVeaSTPBFSPJmeXxO7nw (small blind) showed [6d 6h] and won ($19.50) with a pair of Sixes
Seat 9: 5JJVDlaiMnB004o/RqbZZQ (big blind) folded before Flop



PokerStars Game #59938121396:  Hold'em No Limit ($0.25/$0.50) - 2009/07/01 0:07:31 ET
Table '3FhG0gl3kMX3wBEEqj+wnQ' 9-max Seat #8 is the button
Seat 1: e0J9pdCNUDTCG031RnXqLA ($33 in chips)
Seat 2: 4dl3YNqZ6Houm2jZAzDmRg ($19.80 in chips)
Seat 3: bXpVeaSTPBFSPJmeXxO7nw ($10.75 in chips)
Seat 4: bz4LMfV0GGl/MJ/ABXuPmg ($18.90 in chips)
Seat 5: avsQkZXsRKnWa7gkjVNvog ($32.50 in chips)
Seat 6: 5JJVDlaiMnB004o/RqbZZQ ($26.75 in chips)
Seat 7: 6XkTu4ahxzHnvjjc1R8YjQ ($9.25 in chips)
Seat 8: j3K/Jujr7PY4ZM2RZvlH6A ($52.95 in chips)
Seat 9: tzoXBDwkkPV/XPJPkf963Q ($13.35 in chips)
tzoXBDwkkPV/XPJPkf963Q: posts small blind $0.25
e0J9pdCNUDTCG031RnXqLA: posts big blind $0.50
*** HOLE CARDS ***
4dl3YNqZ6Houm2jZAzDmRg: raises $1 to $1.50
bXpVeaSTPBFSPJmeXxO7nw: folds
bz4LMfV0GGl/MJ/ABXuPmg: folds
avsQkZXsRKnWa7gkjVNvog: folds
5JJVDlaiMnB004o/RqbZZQ: folds
6XkTu4ahxzHnvjjc1R8YjQ: folds
j3K/Jujr7PY4ZM2RZvlH6A: folds
tzoXBDwkkPV/XPJPkf963Q: folds
e0J9pdCNUDTCG031RnXqLA: calls $1
*** FLOP *** [4s 4h 6h]
e0J9pdCNUDTCG031RnXqLA: checks
4dl3YNqZ6Houm2jZAzDmRg: bets $1.50
e0J9pdCNUDTCG031RnXqLA: raises $1.50 to $3
4dl3YNqZ6Houm2jZAzDmRg: calls $1.50
*** TURN *** [4s 4h 6h] [8h]
avsQkZXsRKnWa7gkjVNvog leaves the table
e0J9pdCNUDTCG031RnXqLA: bets $4
XNMDwbXt/Q4jM99AXnbJDw joins the table at seat #5
4dl3YNqZ6Houm2jZAzDmRg: raises $7 to $11
e0J9pdCNUDTCG031RnXqLA: folds
4dl3YNqZ6Houm2jZAzDmRg collected $16.45 from pot
*** SUMMARY ***
Total pot $17.25 | Rake $0.80
Board [4s 4h 6h 8h]
Seat 1: e0J9pdCNUDTCG031RnXqLA (big blind) folded on the Turn
Seat 2: 4dl3YNqZ6Houm2jZAzDmRg collected ($16.45)
Seat 3: bXpVeaSTPBFSPJmeXxO7nw folded before Flop (didn't bet)
Seat 4: bz4LMfV0GGl/MJ/ABXuPmg folded before Flop (didn't bet)
Seat 5: avsQkZXsRKnWa7gkjVNvog folded before Flop (didn't bet)
Seat 6: 5JJVDlaiMnB004o/RqbZZQ folded before Flop (didn't bet)
Seat 7: 6XkTu4ahxzHnvjjc1R8YjQ folded before Flop (didn't bet)
Seat 8: j3K/Jujr7PY4ZM2RZvlH6A (button) folded before Flop (didn't bet)
Seat 9: tzoXBDwkkPV/XPJPkf963Q (small blind) folded before Flop



PokerStars Game #59938122078:  Hold'em No Limit ($0.25/$0.50) - 2009/07/01 0:07:32 ET
Table 'mTxf8gPLgffN3Iwfm7Icfg' 2-max Seat #2 is the button
Seat 1: Do9Rlu1R5u/AcRtMTl8SYg ($67.10 in chips)
Seat 2: EMc5LPgVaded4Qc77vm0fw ($47.45 in chips)
EMc5LPgVaded4Qc77vm0fw: posts small blind $0.25
Do9Rlu1R5u/AcRtMTl8SYg: posts big blind $0.50
*** HOLE CARDS ***
EMc5LPgVaded4Qc77vm0fw: folds
Do9Rlu1R5u/AcRtMTl8SYg collected $0.50 from pot
Do9Rlu1R5u/AcRtMTl8SYg: doesn't show hand
*** SUMMARY ***
Total pot $0.50 | Rake $0
Seat 1: Do9Rlu1R5u/AcRtMTl8SYg (big blind) collected ($0.50)
Seat 2: EMc5LPgVaded4Qc77vm0fw (button) (small blind) folded before Flop



PokerStars Game #59938122596:  Hold'em No Limit ($0.25/$0.50) - 2009/07/01 0:07:33 ET
Table 'hSTs/dUsYLgJQuF2Onp0MQ' 6-max Seat #6 is the button
Seat 1: lWwl5C/UZOsWNubdUqghZw ($70.95 in chips)
Seat 2: fyJOjf+Vdie/rpWb1WExIg ($15 in chips)
Seat 3: vQOrJuXbLC3UZDVklY9bOA ($13.45 in chips)
Seat 4: L0aIPg7qefDQjdJo3HCVEA ($14.45 in chips)
Seat 5: 686aeHikcJlgKkSuIFdcXQ ($60.65 in chips)
Seat 6: +laPa9P7BjZKKnR0n+OmvA ($12 in chips)
lWwl5C/UZOsWNubdUqghZw: posts small blind $0.25
fyJOjf+Vdie/rpWb1WExIg: posts big blind $0.50
*** HOLE CARDS ***
vQOrJuXbLC3UZDVklY9bOA: raises $1 to $1.50
L0aIPg7qefDQjdJo3HCVEA: folds
686aeHikcJlgKkSuIFdcXQ: folds
+laPa9P7BjZKKnR0n+OmvA: folds
lWwl5C/UZOsWNubdUqghZw: folds
fyJOjf+Vdie/rpWb1WExIg: calls $1
*** FLOP *** [9h Jd 3d]
fyJOjf+Vdie/rpWb1WExIg: bets $0.50
vQOrJuXbLC3UZDVklY9bOA: calls $0.50
*** TURN *** [9h Jd 3d] [4c]
fyJOjf+Vdie/rpWb1WExIg: checks
vQOrJuXbLC3UZDVklY9bOA: checks
*** RIVER *** [9h Jd 3d 4c] [8c]
fyJOjf+Vdie/rpWb1WExIg: bets $2.50
vQOrJuXbLC3UZDVklY9bOA: folds
fyJOjf+Vdie/rpWb1WExIg collected $4.05 from pot
*** SUMMARY ***
Total pot $4.25 | Rake $0.20
Board [9h Jd 3d 4c 8c]
Seat 1: lWwl5C/UZOsWNubdUqghZw (small blind) folded before Flop
Seat 2: fyJOjf+Vdie/rpWb1WExIg (big blind) collected ($4.05)
Seat 3: vQOrJuXbLC3UZDVklY9bOA folded on the River
Seat 4: L0aIPg7qefDQjdJo3HCVEA folded before Flop (didn't bet)
Seat 5: 686aeHikcJlgKkSuIFdcXQ folded before Flop (didn't bet)
Seat 6: +laPa9P7BjZKKnR0n+OmvA (button) folded before Flop (didn't bet)



PokerStars Game #59938123640:  Hold'em No Limit ($0.25/$0.50) - 2009/07/01 0:07:34 ET
Table 'oxUN1yBuOHNrPf4xoy4aXw' 2-max Seat #2 is the button
Seat 1: ndd1nfncBkWNitBnsfCoVQ ($68.35 in chips)
Seat 2: mba14ZHNZ0/GoMe+gAVYmw ($36.05 in chips)
mba14ZHNZ0/GoMe+gAVYmw: posts small blind $0.25
ndd1nfncBkWNitBnsfCoVQ: posts big blind $0.50
*** HOLE CARDS ***
mba14ZHNZ0/GoMe+gAVYmw: calls $0.25
ndd1nfncBkWNitBnsfCoVQ: checks
*** FLOP *** [2d 5c 9s]
ndd1nfncBkWNitBnsfCoVQ: checks
mba14ZHNZ0/GoMe+gAVYmw: checks
*** TURN *** [2d 5c 9s] [5s]
ndd1nfncBkWNitBnsfCoVQ: checks
mba14ZHNZ0/GoMe+gAVYmw: bets $0.50
ndd1nfncBkWNitBnsfCoVQ: folds
mba14ZHNZ0/GoMe+gAVYmw collected $0.95 from pot
mba14ZHNZ0/GoMe+gAVYmw: doesn't show hand
*** SUMMARY ***
Total pot $1 | Rake $0.05
Board [2d 5c 9s 5s]
Seat 1: ndd1nfncBkWNitBnsfCoVQ (big blind) folded on the Turn
Seat 2: mba14ZHNZ0/GoMe+gAVYmw (button) (small blind) collected ($0.95)



PokerStars Game #59938124110:  Hold'em No Limit ($0.25/$0.50) - 2009/07/01 0:07:35 ET
Table 'tpZbcIvqh/6WmfR/i5IE3A' 9-max Seat #1 is the button
Seat 1: nV/P1jFY/CFMXOLWu7pYmA ($13.70 in chips)
Seat 2: M+7+BTmX5vZatHVuoRB1nA ($46.15 in chips)
Seat 3: 3w0FbBQAKwQODwenKwZxXw ($77.70 in chips)
Seat 4: zE9cVigS2nW/Ljy4K4bUQA ($30.75 in chips)
Seat 5: 9r7ZoBbAJj5IeyZ0q9BdzA ($12.90 in chips)
Seat 6: E2518gp4aFz1+kAgmGqeEg ($11.20 in chips)
Seat 7: wIZ377kjl2fHFGnS93o6bw ($13.70 in chips)
Seat 8: bXpVeaSTPBFSPJmeXxO7nw ($9.85 in chips)
M+7+BTmX5vZatHVuoRB1nA: posts small blind $0.25
3w0FbBQAKwQODwenKwZxXw: posts big blind $0.50
*** HOLE CARDS ***
zE9cVigS2nW/Ljy4K4bUQA: folds
9r7ZoBbAJj5IeyZ0q9BdzA: folds
E2518gp4aFz1+kAgmGqeEg: folds
wIZ377kjl2fHFGnS93o6bw: folds
bXpVeaSTPBFSPJmeXxO7nw: folds
nV/P1jFY/CFMXOLWu7pYmA: folds
M+7+BTmX5vZatHVuoRB1nA: folds
3w0FbBQAKwQODwenKwZxXw collected $0.50 from pot
*** SUMMARY ***
Total pot $0.50 | Rake $0
Seat 1: nV/P1jFY/CFMXOLWu7pYmA (button) folded before Flop (didn't bet)
Seat 2: M+7+BTmX5vZatHVuoRB1nA (small blind) folded before Flop
Seat 3: 3w0FbBQAKwQODwenKwZxXw (big blind) collected ($0.50)
Seat 4: zE9cVigS2nW/Ljy4K4bUQA folded before Flop (didn't bet)
Seat 5: 9r7ZoBbAJj5IeyZ0q9BdzA folded before Flop (didn't bet)
Seat 6: E2518gp4aFz1+kAgmGqeEg folded before Flop (didn't bet)
Seat 7: wIZ377kjl2fHFGnS93o6bw folded before Flop (didn't bet)
Seat 8: bXpVeaSTPBFSPJmeXxO7nw folded before Flop (didn't bet)



PokerStars Game #59938125106:  Hold'em No Limit ($0.25/$0.50) - 2009/07/01 0:07:36 ET
Table 'c/CRn+68J3Y8KxD5g1ek2Q' 2-max Seat #1 is the button
Seat 1: 46qCyJ6evTkHo9al5sBMNA ($312.70 in chips)
Seat 2: BypVLsYQt3ePFm2xQL/dOA ($74.60 in chips)
46qCyJ6evTkHo9al5sBMNA: posts small blind $0.25
BypVLsYQt3ePFm2xQL/dOA: posts big blind $0.50
*** HOLE CARDS ***
46qCyJ6evTkHo9al5sBMNA: folds
BypVLsYQt3ePFm2xQL/dOA collected $0.50 from pot
BypVLsYQt3ePFm2xQL/dOA: doesn't show hand
*** SUMMARY ***
Total pot $0.50 | Rake $0
Seat 1: 46qCyJ6evTkHo9al5sBMNA (button) (small blind) folded before Flop
Seat 2: BypVLsYQt3ePFm2xQL/dOA (big blind) collected ($0.50)



PokerStars Game #59938125442:  Hold'em No Limit ($0.25/$0.50) - 2009/07/01 0:07:37 ET
Table 'raOT4/ipuZgzjfKHC+jD9g' 2-max Seat #1 is the button
Seat 1: IuwLemwLhc9fvrwBGs0AMA ($12.35 in chips)
Seat 2: Udr5juWSWUgTu1NlRhjMdA ($11.45 in chips)
IuwLemwLhc9fvrwBGs0AMA: posts small blind $0.25
Udr5juWSWUgTu1NlRhjMdA: posts big blind $0.50
*** HOLE CARDS ***
IuwLemwLhc9fvrwBGs0AMA: raises $0.50 to $1
Udr5juWSWUgTu1NlRhjMdA: folds
IuwLemwLhc9fvrwBGs0AMA collected $1 from pot
*** SUMMARY ***
Total pot $1 | Rake $0
Seat 1: IuwLemwLhc9fvrwBGs0AMA (button) (small blind) collected ($1)
Seat 2: Udr5juWSWUgTu1NlRhjMdA (big blind) folded before Flop



PokerStars Game #59938126358:  Hold'em No Limit ($0.25/$0.50) - 2009/07/01 0:07:38 ET
Table 'Vdlc9wqYcHTUhtdyN7CuJw' 2-max Seat #2 is the button
Seat 1: yBO+mXB6m/rCft2ErwGf/Q ($45.50 in chips)
Seat 2: sa0qgETiL3HNbdfGlnKHTA ($68.30 in chips)
sa0qgETiL3HNbdfGlnKHTA: posts small blind $0.25
yBO+mXB6m/rCft2ErwGf/Q: posts big blind $0.50
*** HOLE CARDS ***
sa0qgETiL3HNbdfGlnKHTA: raises $0.50 to $1
yBO+mXB6m/rCft2ErwGf/Q: folds
sa0qgETiL3HNbdfGlnKHTA collected $1 from pot
sa0qgETiL3HNbdfGlnKHTA: doesn't show hand
*** SUMMARY ***
Total pot $1 | Rake $0
Seat 1: yBO+mXB6m/rCft2ErwGf/Q (big blind) folded before Flop
Seat 2: sa0qgETiL3HNbdfGlnKHTA (button) (small blind) collected ($1)



PokerStars Game #59938126974:  Hold'em No Limit ($0.25/$0.50) - 2009/07/01 0:07:39 ET
Table 'kgbJRsxfv64KrErDRBAkcw' 6-max Seat #6 is the button
Seat 1: YmWlPGOKFuJSoJZPW8a8IA ($80.80 in chips)
Seat 2: Q+thC23WCv1kJUJtH/+4Jw ($28.85 in chips)
Seat 3: T0Gx/FcQ5VH9u7XaOMX97A ($61.65 in chips)
Seat 4: qanMEqjABjWxC/JgQ/0l7w ($62.20 in chips)
Seat 5: SlTdlH14u+KVVINgxMwt+Q ($67.95 in chips)
Seat 6: DDfYzIrYT0t5R/hAJngtsg ($21.45 in chips)
YmWlPGOKFuJSoJZPW8a8IA: posts small blind $0.25
Q+thC23WCv1kJUJtH/+4Jw: posts big blind $0.50
*** HOLE CARDS ***
T0Gx/FcQ5VH9u7XaOMX97A: folds
qanMEqjABjWxC/JgQ/0l7w: folds
SlTdlH14u+KVVINgxMwt+Q: folds
DDfYzIrYT0t5R/hAJngtsg: calls $0.50
YmWlPGOKFuJSoJZPW8a8IA: folds
Q+thC23WCv1kJUJtH/+4Jw: checks
*** FLOP *** [6c 9h 5s]
Q+thC23WCv1kJUJtH/+4Jw: bets $1
DDfYzIrYT0t5R/hAJngtsg: raises $1 to $2
Q+thC23WCv1kJUJtH/+4Jw: calls $1
*** TURN *** [6c 9h 5s] [5d]
Q+thC23WCv1kJUJtH/+4Jw: checks
DDfYzIrYT0t5R/hAJngtsg: checks
*** RIVER *** [6c 9h 5s 5d] [Ah]
Q+thC23WCv1kJUJtH/+4Jw: checks
DDfYzIrYT0t5R/hAJngtsg: checks
*** SHOW DOWN ***
Q+thC23WCv1kJUJtH/+4Jw: shows [9s Kd] (two pair, Nines and Fives)
DDfYzIrYT0t5R/hAJngtsg: shows [Ac 9c] (two pair, Aces and Nines)
DDfYzIrYT0t5R/hAJngtsg collected $5 from pot
*** SUMMARY ***
Total pot $5.25 | Rake $0.25
Board [6c 9h 5s 5d Ah]
Seat 1: YmWlPGOKFuJSoJZPW8a8IA (small blind) folded before Flop
Seat 2: Q+thC23WCv1kJUJtH/+4Jw (big blind) showed [9s Kd] and lost with two pair, Nines and Fives
Seat 3: T0Gx/FcQ5VH9u7XaOMX97A folded before Flop (didn't bet)
Seat 4: qanMEqjABjWxC/JgQ/0l7w folded before Flop (didn't bet)
Seat 5: SlTdlH14u+KVVINgxMwt+Q folded before Flop (didn't bet)
Seat 6: DDfYzIrYT0t5R/hAJngtsg (button) showed [Ac 9c] and won ($5) with two pair, Aces and Nines



PokerStars Game #59938127990:  Hold'em No Limit ($0.25/$0.50) - 2009/07/01 0:07:40 ET
Table 'E7bWJ45aoFXRpyRv2gw+Ig' 2-max Seat #2 is the button
Seat 1: FRkiRasEGlHUeLrEl+k/nA ($74.80 in chips)
Seat 2: 3Wro85I7472vJ4Wkpneo9A ($49.40 in chips)
3Wro85I7472vJ4Wkpneo9A: posts small blind $0.25
FRkiRasEGlHUeLrEl+k/nA: posts big blind $0.50
*** HOLE CARDS ***
3Wro85I7472vJ4Wkpneo9A: folds
FRkiRasEGlHUeLrEl+k/nA collected $0.50 from pot
FRkiRasEGlHUeLrEl+k/nA: doesn't show hand
*** SUMMARY ***
Total pot $0.50 | Rake $0
Seat 1: FRkiRasEGlHUeLrEl+k/nA (big blind) collected ($0.50)
Seat 2: 3Wro85I7472vJ4Wkpneo9A (button) (small blind) folded before Flop



PokerStars Game #59938127966:  Hold'em No Limit ($0.25/$0.50) - 2009/07/01 0:07:40 ET
Table '+z1aekfHkpp09pc8F9aViw' 6-max Seat #4 is the button
Seat 1: lWwl5C/UZOsWNubdUqghZw ($50 in chips)
Seat 2: VuB2GN0h94yY+QbuI2Mybg ($23.95 in chips)
Seat 4: OCrv7ObFH4/s2lv7rYOnsQ ($20.15 in chips)
Seat 5: crjGpJEzSZgD38FoE3VMGg ($62.40 in chips)
Seat 6: 686aeHikcJlgKkSuIFdcXQ ($72 in chips)
crjGpJEzSZgD38FoE3VMGg: posts small blind $0.25
686aeHikcJlgKkSuIFdcXQ: posts big blind $0.50
*** HOLE CARDS ***
lWwl5C/UZOsWNubdUqghZw: folds
VuB2GN0h94yY+QbuI2Mybg: calls $0.50
OCrv7ObFH4/s2lv7rYOnsQ: calls $0.50
crjGpJEzSZgD38FoE3VMGg: folds
686aeHikcJlgKkSuIFdcXQ: checks
*** FLOP *** [Qc 3c 7s]
686aeHikcJlgKkSuIFdcXQ: checks
VuB2GN0h94yY+QbuI2Mybg: checks
OCrv7ObFH4/s2lv7rYOnsQ: bets $1.50
686aeHikcJlgKkSuIFdcXQ: folds
VuB2GN0h94yY+QbuI2Mybg: calls $1.50
*** TURN *** [Qc 3c 7s] [4s]
VuB2GN0h94yY+QbuI2Mybg: checks
OCrv7ObFH4/s2lv7rYOnsQ: bets $5
VuB2GN0h94yY+QbuI2Mybg: calls $5
*** RIVER *** [Qc 3c 7s 4s] [8s]
VuB2GN0h94yY+QbuI2Mybg: checks
OCrv7ObFH4/s2lv7rYOnsQ: checks
*** SHOW DOWN ***
VuB2GN0h94yY+QbuI2Mybg: shows [Ah 7d] (a pair of Sevens)
OCrv7ObFH4/s2lv7rYOnsQ: shows [3h 7h] (two pair, Sevens and Threes)
OCrv7ObFH4/s2lv7rYOnsQ collected $14.05 from pot
*** SUMMARY ***
Total pot $14.75 | Rake $0.70
Board [Qc 3c 7s 4s 8s]
Seat 1: lWwl5C/UZOsWNubdUqghZw folded before Flop (didn't bet)
Seat 2: VuB2GN0h94yY+QbuI2Mybg showed [Ah 7d] and lost with a pair of Sevens
Seat 4: OCrv7ObFH4/s2lv7rYOnsQ (button) showed [3h 7h] and won ($14.05) with two pair, Sevens and Threes
Seat 5: crjGpJEzSZgD38FoE3VMGg (small blind) folded before Flop
Seat 6: 686aeHikcJlgKkSuIFdcXQ (big blind) folded on the Flop



PokerStars Game #59938128040:  Hold'em No Limit ($0.25/$0.50) - 2009/07/01 0:07:40 ET
Table 'YsnnHkamRzYqMOr2FlLY4w' 6-max Seat #1 is the button
Seat 1: crjGpJEzSZgD38FoE3VMGg ($50 in chips)
Seat 3: I+pG2m/dD5iYdbg9qx572g ($23.50 in chips)
Seat 4: 7Fue572p4ZIC85AJMQvaQw ($53.85 in chips)
Seat 5: lcQ7uuLf+WLGGy4Ve6VKKA ($42.60 in chips)
Seat 6: YmWlPGOKFuJSoJZPW8a8IA ($53.40 in chips)
vnRgOasQNKOR7gLXwRQ+ww will be allowed to play after the button
I+pG2m/dD5iYdbg9qx572g: posts small blind $0.25
7Fue572p4ZIC85AJMQvaQw: posts big blind $0.50
*** HOLE CARDS ***
lcQ7uuLf+WLGGy4Ve6VKKA: calls $0.50
YmWlPGOKFuJSoJZPW8a8IA: folds
crjGpJEzSZgD38FoE3VMGg: folds
I+pG2m/dD5iYdbg9qx572g: folds
7Fue572p4ZIC85AJMQvaQw: checks
*** FLOP *** [9s 4c 7d]
7Fue572p4ZIC85AJMQvaQw: checks
lcQ7uuLf+WLGGy4Ve6VKKA: bets $0.50
7Fue572p4ZIC85AJMQvaQw: calls $0.50
*** TURN *** [9s 4c 7d] [Ah]
7Fue572p4ZIC85AJMQvaQw: checks
lcQ7uuLf+WLGGy4Ve6VKKA: checks
*** RIVER *** [9s 4c 7d Ah] [8s]
7Fue572p4ZIC85AJMQvaQw: bets $1
lcQ7uuLf+WLGGy4Ve6VKKA: calls $1
*** SHOW DOWN ***
7Fue572p4ZIC85AJMQvaQw: shows [Kc Ks] (a pair of Kings)
lcQ7uuLf+WLGGy4Ve6VKKA: mucks hand
7Fue572p4ZIC85AJMQvaQw collected $4.05 from pot
*** SUMMARY ***
Total pot $4.25 | Rake $0.20
Board [9s 4c 7d Ah 8s]
Seat 1: crjGpJEzSZgD38FoE3VMGg (button) folded before Flop (didn't bet)
Seat 3: I+pG2m/dD5iYdbg9qx572g (small blind) folded before Flop
Seat 4: 7Fue572p4ZIC85AJMQvaQw (big blind) showed [Kc Ks] and won ($4.05) with a pair of Kings
Seat 5: lcQ7uuLf+WLGGy4Ve6VKKA mucked
Seat 6: YmWlPGOKFuJSoJZPW8a8IA folded before Flop (didn't bet)



PokerStars Game #59938129070:  Hold'em No Limit ($0.25/$0.50) - 2009/07/01 0:07:42 ET
Table 'mTxf8gPLgffN3Iwfm7Icfg' 2-max Seat #1 is the button
Seat 1: Do9Rlu1R5u/AcRtMTl8SYg ($67.35 in chips)
Seat 2: EMc5LPgVaded4Qc77vm0fw ($47.20 in chips)
Do9Rlu1R5u/AcRtMTl8SYg: posts small blind $0.25
EMc5LPgVaded4Qc77vm0fw: posts big blind $0.50
*** HOLE CARDS ***
Do9Rlu1R5u/AcRtMTl8SYg: folds
EMc5LPgVaded4Qc77vm0fw collected $0.50 from pot
EMc5LPgVaded4Qc77vm0fw: doesn't show hand
*** SUMMARY ***
Total pot $0.50 | Rake $0
Seat 1: Do9Rlu1R5u/AcRtMTl8SYg (button) (small blind) folded before Flop
Seat 2: EMc5LPgVaded4Qc77vm0fw (big blind) collected ($0.50)



PokerStars Game #59938129780:  Hold'em No Limit ($0.25/$0.50) - 2009/07/01 0:07:43 ET
Table 'tyR5AZNKV8Aadbrnrnlg7g' 6-max Seat #2 is the button
Seat 1: R+KjpH/wSjDLhtIy9+edNA ($36.25 in chips)
Seat 2: 58zdeSBSuSFX/qZfhc7YmA ($32.20 in chips)
Seat 3: jUhx+m+V7qfbLZTjgwZByg ($44.25 in chips)
Seat 4: Rt6KgtZ8YaJoTc3FPim00w ($50 in chips)
Seat 5: EIg3r3fRFKG2HhgpDlIJHg ($19 in chips)
Seat 6: DMQLAmut/l19xN5STQndFg ($13.95 in chips)
jUhx+m+V7qfbLZTjgwZByg: posts small blind $0.25
Rt6KgtZ8YaJoTc3FPim00w: posts big blind $0.50
*** HOLE CARDS ***
EIg3r3fRFKG2HhgpDlIJHg: calls $0.50
DMQLAmut/l19xN5STQndFg: raises $1.50 to $2
R+KjpH/wSjDLhtIy9+edNA: folds
58zdeSBSuSFX/qZfhc7YmA: folds
jUhx+m+V7qfbLZTjgwZByg: folds
Rt6KgtZ8YaJoTc3FPim00w: folds
EIg3r3fRFKG2HhgpDlIJHg: calls $1.50
*** FLOP *** [Ts Kh Kc]
EIg3r3fRFKG2HhgpDlIJHg: bets $1.50
DMQLAmut/l19xN5STQndFg: calls $1.50
*** TURN *** [Ts Kh Kc] [Qh]
EIg3r3fRFKG2HhgpDlIJHg: bets $3.50
DMQLAmut/l19xN5STQndFg: raises $3.50 to $7
EIg3r3fRFKG2HhgpDlIJHg: calls $3.50
*** RIVER *** [Ts Kh Kc Qh] [Qs]
EIg3r3fRFKG2HhgpDlIJHg: checks
DMQLAmut/l19xN5STQndFg: checks
*** SHOW DOWN ***
EIg3r3fRFKG2HhgpDlIJHg: shows [8h Qd] (a full house, Queens full of Kings)
DMQLAmut/l19xN5STQndFg: mucks hand
EIg3r3fRFKG2HhgpDlIJHg collected $20.70 from pot
*** SUMMARY ***
Total pot $21.75 | Rake $1.05
Board [Ts Kh Kc Qh Qs]
Seat 1: R+KjpH/wSjDLhtIy9+edNA folded before Flop (didn't bet)
Seat 2: 58zdeSBSuSFX/qZfhc7YmA (button) folded before Flop (didn't bet)
Seat 3: jUhx+m+V7qfbLZTjgwZByg (small blind) folded before Flop
Seat 4: Rt6KgtZ8YaJoTc3FPim00w (big blind) folded before Flop
Seat 5: EIg3r3fRFKG2HhgpDlIJHg showed [8h Qd] and won ($20.70) with a full house, Queens full of Kings
Seat 6: DMQLAmut/l19xN5STQndFg mucked



PokerStars Game #59938130256:  Hold'em No Limit ($0.25/$0.50) - 2009/07/01 0:07:43 ET
Table 'X6IRCRTh+20gjz8aubWnwA' 9-max Seat #1 is the button
Seat 1: YPo1oggovmqSREegekaQYw ($9.45 in chips)
Seat 2: RjBdQ6w31rgcy0o24VLR6w ($11.90 in chips)
Seat 3: mSD1pginDsyHG5PDfqzphw ($10 in chips)
Seat 4: uw9QayAAxLM3Hb+HR7mSkg ($11 in chips)
Seat 5: aT3lRsb9BkkYp2fkD3LEtQ ($85.15 in chips)
Seat 6: /6In1zC3WtgwxDcueWzZWg ($51.10 in chips)
Seat 7: VBnpbzn0dIveV55qKvciew ($59.95 in chips)
Seat 8: BPMN9sOItJw6vWq3kypaYg ($24.65 in chips)
Seat 9: M+7+BTmX5vZatHVuoRB1nA ($84.10 in chips)
RjBdQ6w31rgcy0o24VLR6w: posts small blind $0.25
mSD1pginDsyHG5PDfqzphw: posts big blind $0.50
*** HOLE CARDS ***
uw9QayAAxLM3Hb+HR7mSkg: folds
aT3lRsb9BkkYp2fkD3LEtQ: calls $0.50
/6In1zC3WtgwxDcueWzZWg: raises $1.50 to $2
VBnpbzn0dIveV55qKvciew: folds
BPMN9sOItJw6vWq3kypaYg: folds
M+7+BTmX5vZatHVuoRB1nA: folds
YPo1oggovmqSREegekaQYw: folds
RjBdQ6w31rgcy0o24VLR6w: folds
mSD1pginDsyHG5PDfqzphw: folds
aT3lRsb9BkkYp2fkD3LEtQ: calls $1.50
*** FLOP *** [Jh As Ad]
aT3lRsb9BkkYp2fkD3LEtQ: checks
/6In1zC3WtgwxDcueWzZWg: checks
*** TURN *** [Jh As Ad] [2h]
aT3lRsb9BkkYp2fkD3LEtQ: bets $2
/6In1zC3WtgwxDcueWzZWg: calls $2
*** RIVER *** [Jh As Ad 2h] [9d]
aT3lRsb9BkkYp2fkD3LEtQ: bets $2.50
/6In1zC3WtgwxDcueWzZWg: raises $2.50 to $5
aT3lRsb9BkkYp2fkD3LEtQ: folds
/6In1zC3WtgwxDcueWzZWg collected $13.10 from pot
*** SUMMARY ***
Total pot $13.75 | Rake $0.65
Board [Jh As Ad 2h 9d]
Seat 1: YPo1oggovmqSREegekaQYw (button) folded before Flop (didn't bet)
Seat 2: RjBdQ6w31rgcy0o24VLR6w (small blind) folded before Flop
Seat 3: mSD1pginDsyHG5PDfqzphw (big blind) folded before Flop
Seat 4: uw9QayAAxLM3Hb+HR7mSkg folded before Flop (didn't bet)
Seat 5: aT3lRsb9BkkYp2fkD3LEtQ folded on the River
Seat 6: /6In1zC3WtgwxDcueWzZWg collected ($13.10)
Seat 7: VBnpbzn0dIveV55qKvciew folded before Flop (didn't bet)
Seat 8: BPMN9sOItJw6vWq3kypaYg folded before Flop (didn't bet)
Seat 9: M+7+BTmX5vZatHVuoRB1nA folded before Flop (didn't bet)



PokerStars Game #59938132180:  Hold'em No Limit ($0.25/$0.50) - 2009/07/01 0:07:46 ET
Table 'E7bWJ45aoFXRpyRv2gw+Ig' 2-max Seat #1 is the button
Seat 1: FRkiRasEGlHUeLrEl+k/nA ($75.05 in chips)
Seat 2: 3Wro85I7472vJ4Wkpneo9A ($49.15 in chips)
FRkiRasEGlHUeLrEl+k/nA: posts small blind $0.25
3Wro85I7472vJ4Wkpneo9A: posts big blind $0.50
*** HOLE CARDS ***
FRkiRasEGlHUeLrEl+k/nA: raises $1 to $1.50
3Wro85I7472vJ4Wkpneo9A: folds
FRkiRasEGlHUeLrEl+k/nA collected $1 from pot
FRkiRasEGlHUeLrEl+k/nA: doesn't show hand
*** SUMMARY ***
Total pot $1 | Rake $0
Seat 1: FRkiRasEGlHUeLrEl+k/nA (button) (small blind) collected ($1)
Seat 2: 3Wro85I7472vJ4Wkpneo9A (big blind) folded before Flop



PokerStars Game #59938131852:  Hold'em No Limit ($0.25/$0.50) - 2009/07/01 0:07:46 ET
Table 'c/CRn+68J3Y8KxD5g1ek2Q' 2-max Seat #2 is the button
Seat 1: 46qCyJ6evTkHo9al5sBMNA ($312.45 in chips)
Seat 2: BypVLsYQt3ePFm2xQL/dOA ($74.85 in chips)
BypVLsYQt3ePFm2xQL/dOA: posts small blind $0.25
46qCyJ6evTkHo9al5sBMNA: posts big blind $0.50
*** HOLE CARDS ***
BypVLsYQt3ePFm2xQL/dOA: raises $0.50 to $1
46qCyJ6evTkHo9al5sBMNA: folds
BypVLsYQt3ePFm2xQL/dOA collected $1 from pot
BypVLsYQt3ePFm2xQL/dOA: doesn't show hand
*** SUMMARY ***
Total pot $1 | Rake $0
Seat 1: 46qCyJ6evTkHo9al5sBMNA (big blind) folded before Flop
Seat 2: BypVLsYQt3ePFm2xQL/dOA (button) (small blind) collected ($1)



PokerStars Game #59938131970:  Hold'em No Limit ($0.25/$0.50) - 2009/07/01 0:07:46 ET
Table 'raOT4/ipuZgzjfKHC+jD9g' 2-max Seat #2 is the button
Seat 1: IuwLemwLhc9fvrwBGs0AMA ($12.85 in chips)
Seat 2: Udr5juWSWUgTu1NlRhjMdA ($10.95 in chips)
Udr5juWSWUgTu1NlRhjMdA: posts small blind $0.25
IuwLemwLhc9fvrwBGs0AMA: posts big blind $0.50
*** HOLE CARDS ***
Udr5juWSWUgTu1NlRhjMdA: raises $0.50 to $1
IuwLemwLhc9fvrwBGs0AMA: folds
Udr5juWSWUgTu1NlRhjMdA collected $1 from pot
Udr5juWSWUgTu1NlRhjMdA: doesn't show hand
*** SUMMARY ***
Total pot $1 | Rake $0
Seat 1: IuwLemwLhc9fvrwBGs0AMA (big blind) folded before Flop
Seat 2: Udr5juWSWUgTu1NlRhjMdA (button) (small blind) collected ($1)



PokerStars Game #59938132946:  Hold'em No Limit ($0.25/$0.50) - 2009/07/01 0:07:47 ET
Table 'Vdlc9wqYcHTUhtdyN7CuJw' 2-max Seat #1 is the button
Seat 1: yBO+mXB6m/rCft2ErwGf/Q ($45 in chips)
Seat 2: sa0qgETiL3HNbdfGlnKHTA ($68.80 in chips)
yBO+mXB6m/rCft2ErwGf/Q: posts small blind $0.25
sa0qgETiL3HNbdfGlnKHTA: posts big blind $0.50
*** HOLE CARDS ***
yBO+mXB6m/rCft2ErwGf/Q: raises $1.50 to $2
sa0qgETiL3HNbdfGlnKHTA: raises $3 to $5
yBO+mXB6m/rCft2ErwGf/Q: raises $40 to $45 and is all-in
sa0qgETiL3HNbdfGlnKHTA: calls $40
*** FLOP *** [4d Th 2h]
*** TURN *** [4d Th 2h] [3d]
*** RIVER *** [4d Th 2h 3d] [Kh]
*** SHOW DOWN ***
sa0qgETiL3HNbdfGlnKHTA: shows [5d 5h] (a pair of Fives)
yBO+mXB6m/rCft2ErwGf/Q: shows [As Kd] (a pair of Kings)
yBO+mXB6m/rCft2ErwGf/Q collected $89.50 from pot
*** SUMMARY ***
Total pot $90 | Rake $0.50
Board [4d Th 2h 3d Kh]
Seat 1: yBO+mXB6m/rCft2ErwGf/Q (button) (small blind) showed [As Kd] and won ($89.50) with a pair of Kings
Seat 2: sa0qgETiL3HNbdfGlnKHTA (big blind) showed [5d 5h] and lost with a pair of Fives



PokerStars Game #59938134588:  Hold'em No Limit ($0.25/$0.50) - 2009/07/01 0:07:49 ET
Table 'ibNfFy0bCzuBaUORla0aGw' 9-max Seat #2 is the button
Seat 1: xZCXQSXlrZkp3pZizzVXCw ($56.95 in chips)
Seat 2: 90Wb75h3W1BRpbqVnuk8gw ($50 in chips)
Seat 3: dDaHs3X8+fe3bIkRU0cbrw ($26.80 in chips)
Seat 4: YBN054X4blmis+B2bBlC0g ($21.20 in chips)
Seat 5: FRv75HO8CUsRZ1byEz06mQ ($15.35 in chips)
Seat 6: BmYrv3ec2k5d6pQq6iNaZw ($67.90 in chips)
Seat 7: mSD1pginDsyHG5PDfqzphw ($10 in chips)
Seat 8: xUrN9TWLq4m5V+OXY7KUUA ($50 in chips)
Seat 9: WpvT3OUSiZlpvs+mPXFqtQ ($8.75 in chips)
dDaHs3X8+fe3bIkRU0cbrw: posts small blind $0.25
YBN054X4blmis+B2bBlC0g: posts big blind $0.50
*** HOLE CARDS ***
FRv75HO8CUsRZ1byEz06mQ: folds
BmYrv3ec2k5d6pQq6iNaZw: folds
mSD1pginDsyHG5PDfqzphw: folds
xUrN9TWLq4m5V+OXY7KUUA: folds
WpvT3OUSiZlpvs+mPXFqtQ: folds
xZCXQSXlrZkp3pZizzVXCw: folds
90Wb75h3W1BRpbqVnuk8gw: folds
dDaHs3X8+fe3bIkRU0cbrw: calls $0.25
YBN054X4blmis+B2bBlC0g: raises $3 to $3.50
dDaHs3X8+fe3bIkRU0cbrw: folds
YBN054X4blmis+B2bBlC0g collected $1 from pot
*** SUMMARY ***
Total pot $1 | Rake $0
Seat 1: xZCXQSXlrZkp3pZizzVXCw folded before Flop (didn't bet)
Seat 2: 90Wb75h3W1BRpbqVnuk8gw (button) folded before Flop (didn't bet)
Seat 3: dDaHs3X8+fe3bIkRU0cbrw (small blind) folded before Flop
Seat 4: YBN054X4blmis+B2bBlC0g (big blind) collected ($1)
Seat 5: FRv75HO8CUsRZ1byEz06mQ folded before Flop (didn't bet)
Seat 6: BmYrv3ec2k5d6pQq6iNaZw folded before Flop (didn't bet)
Seat 7: mSD1pginDsyHG5PDfqzphw folded before Flop (didn't bet)
Seat 8: xUrN9TWLq4m5V+OXY7KUUA folded before Flop (didn't bet)
Seat 9: WpvT3OUSiZlpvs+mPXFqtQ folded before Flop (didn't bet)



PokerStars Game #59938134936:  Hold'em No Limit ($0.25/$0.50) - 2009/07/01 0:07:50 ET
Table 'QOgaEqMcJ73pcUMMxoisUg' 6-max Seat #1 is the button
Seat 1: RFefXIDyFvNtJLq+CloCzA ($43.20 in chips)
Seat 3: wUZNozoIDYf+16hp4nn6dw ($28.75 in chips)
Seat 4: zAcsDhG/T128Vn7XGVSgKg ($50 in chips)
Seat 5: HoaSQCRso+nEyO5DUhGduw ($57.75 in chips)
Seat 6: s83dnhZ6VC53vY0/f6OV/g ($47.80 in chips)
wUZNozoIDYf+16hp4nn6dw: posts small blind $0.25
zAcsDhG/T128Vn7XGVSgKg: posts big blind $0.50
*** HOLE CARDS ***
HoaSQCRso+nEyO5DUhGduw: folds
s83dnhZ6VC53vY0/f6OV/g: folds
RFefXIDyFvNtJLq+CloCzA: folds
Im2p1Nt83UKSqv5c9frm4Q joins the table at seat #2
wUZNozoIDYf+16hp4nn6dw: raises $2 to $2.50
zAcsDhG/T128Vn7XGVSgKg: raises $5.50 to $8
wUZNozoIDYf+16hp4nn6dw: raises $5.50 to $13.50
zAcsDhG/T128Vn7XGVSgKg: calls $5.50
*** FLOP *** [3h Kh 4d]
wUZNozoIDYf+16hp4nn6dw: bets $5
zAcsDhG/T128Vn7XGVSgKg: folds
wUZNozoIDYf+16hp4nn6dw collected $25.65 from pot
*** SUMMARY ***
Total pot $27 | Rake $1.35
Board [3h Kh 4d]
Seat 1: RFefXIDyFvNtJLq+CloCzA (button) folded before Flop (didn't bet)
Seat 3: wUZNozoIDYf+16hp4nn6dw (small blind) collected ($25.65)
Seat 4: zAcsDhG/T128Vn7XGVSgKg (big blind) folded on the Flop
Seat 5: HoaSQCRso+nEyO5DUhGduw folded before Flop (didn't bet)
Seat 6: s83dnhZ6VC53vY0/f6OV/g folded before Flop (didn't bet)



PokerStars Game #59938134720:  Hold'em No Limit ($0.25/$0.50) - 2009/07/01 0:07:50 ET
Table 'mTxf8gPLgffN3Iwfm7Icfg' 2-max Seat #2 is the button
Seat 1: Do9Rlu1R5u/AcRtMTl8SYg ($67.10 in chips)
Seat 2: EMc5LPgVaded4Qc77vm0fw ($47.45 in chips)
EMc5LPgVaded4Qc77vm0fw: posts small blind $0.25
Do9Rlu1R5u/AcRtMTl8SYg: posts big blind $0.50
*** HOLE CARDS ***
EMc5LPgVaded4Qc77vm0fw: raises $1.50 to $2
Do9Rlu1R5u/AcRtMTl8SYg: folds
EMc5LPgVaded4Qc77vm0fw collected $1 from pot
EMc5LPgVaded4Qc77vm0fw: doesn't show hand
*** SUMMARY ***
Total pot $1 | Rake $0
Seat 1: Do9Rlu1R5u/AcRtMTl8SYg (big blind) folded before Flop
Seat 2: EMc5LPgVaded4Qc77vm0fw (button) (small blind) collected ($1)



PokerStars Game #59938136660:  Hold'em No Limit ($0.25/$0.50) - 2009/07/01 0:07:52 ET
Table 'SsXEKOwKN+jE3etfusqUqA' 2-max Seat #1 is the button
Seat 1: 618rKeLrz/avGNOLULHHVQ ($50 in chips)
Seat 2: XfRhywXA6Br+jID1oGeo8A ($250.40 in chips)
618rKeLrz/avGNOLULHHVQ: posts small blind $0.25
XfRhywXA6Br+jID1oGeo8A: posts big blind $0.50
*** HOLE CARDS ***
618rKeLrz/avGNOLULHHVQ: raises $1 to $1.50
XfRhywXA6Br+jID1oGeo8A: folds
618rKeLrz/avGNOLULHHVQ collected $1 from pot
618rKeLrz/avGNOLULHHVQ: doesn't show hand
*** SUMMARY ***
Total pot $1 | Rake $0
Seat 1: 618rKeLrz/avGNOLULHHVQ (button) (small blind) collected ($1)
Seat 2: XfRhywXA6Br+jID1oGeo8A (big blind) folded before Flop



PokerStars Game #59938136758:  Hold'em No Limit ($0.25/$0.50) - 2009/07/01 0:07:52 ET
Table '+dXkOAQyS8j9PQZusUTMpg' 2-max Seat #1 is the button
Seat 1: XFa6sBGjP2gxoIvxR3fZIg ($65.55 in chips)
Seat 2: 5IBeOgaApY1Bvzv2P8X4EA ($48.70 in chips)
XFa6sBGjP2gxoIvxR3fZIg: posts small blind $0.25
5IBeOgaApY1Bvzv2P8X4EA: posts big blind $0.50
*** HOLE CARDS ***
XFa6sBGjP2gxoIvxR3fZIg: raises $1 to $1.50
5IBeOgaApY1Bvzv2P8X4EA: raises $2.50 to $4
XFa6sBGjP2gxoIvxR3fZIg: calls $2.50
*** FLOP *** [4d 4s Td]
5IBeOgaApY1Bvzv2P8X4EA: checks
XFa6sBGjP2gxoIvxR3fZIg: bets $5.50
5IBeOgaApY1Bvzv2P8X4EA: folds
XFa6sBGjP2gxoIvxR3fZIg collected $7.60 from pot
XFa6sBGjP2gxoIvxR3fZIg: doesn't show hand
*** SUMMARY ***
Total pot $8 | Rake $0.40
Board [4d 4s Td]
Seat 1: XFa6sBGjP2gxoIvxR3fZIg (button) (small blind) collected ($7.60)
Seat 2: 5IBeOgaApY1Bvzv2P8X4EA (big blind) folded on the Flop



PokerStars Game #59938137462:  Hold'em No Limit ($0.25/$0.50) - 2009/07/01 0:07:53 ET
Table 'raOT4/ipuZgzjfKHC+jD9g' 2-max Seat #1 is the button
Seat 1: IuwLemwLhc9fvrwBGs0AMA ($12.35 in chips)
Seat 2: Udr5juWSWUgTu1NlRhjMdA ($11.45 in chips)
IuwLemwLhc9fvrwBGs0AMA: posts small blind $0.25
Udr5juWSWUgTu1NlRhjMdA: posts big blind $0.50
*** HOLE CARDS ***
IuwLemwLhc9fvrwBGs0AMA: folds
Udr5juWSWUgTu1NlRhjMdA collected $0.50 from pot
Udr5juWSWUgTu1NlRhjMdA: doesn't show hand
*** SUMMARY ***
Total pot $0.50 | Rake $0
Seat 1: IuwLemwLhc9fvrwBGs0AMA (button) (small blind) folded before Flop
Seat 2: Udr5juWSWUgTu1NlRhjMdA (big blind) collected ($0.50)



PokerStars Game #59938137056:  Hold'em No Limit ($0.25/$0.50) - 2009/07/01 0:07:53 ET
Table 'oxUN1yBuOHNrPf4xoy4aXw' 2-max Seat #1 is the button
Seat 1: ndd1nfncBkWNitBnsfCoVQ ($67.85 in chips)
Seat 2: mba14ZHNZ0/GoMe+gAVYmw ($36.50 in chips)
ndd1nfncBkWNitBnsfCoVQ: posts small blind $0.25
mba14ZHNZ0/GoMe+gAVYmw: posts big blind $0.50
*** HOLE CARDS ***
ndd1nfncBkWNitBnsfCoVQ: raises $1 to $1.50
mba14ZHNZ0/GoMe+gAVYmw: folds
ndd1nfncBkWNitBnsfCoVQ collected $1 from pot
ndd1nfncBkWNitBnsfCoVQ: doesn't show hand
*** SUMMARY ***
Total pot $1 | Rake $0
Seat 1: ndd1nfncBkWNitBnsfCoVQ (button) (small blind) collected ($1)
Seat 2: mba14ZHNZ0/GoMe+gAVYmw (big blind) folded before Flop



PokerStars Game #59938137966:  Hold'em No Limit ($0.25/$0.50) - 2009/07/01 0:07:54 ET
Table 'E7bWJ45aoFXRpyRv2gw+Ig' 2-max Seat #2 is the button
Seat 1: FRkiRasEGlHUeLrEl+k/nA ($75.55 in chips)
Seat 2: 3Wro85I7472vJ4Wkpneo9A ($48.65 in chips)
3Wro85I7472vJ4Wkpneo9A: posts small blind $0.25
FRkiRasEGlHUeLrEl+k/nA: posts big blind $0.50
*** HOLE CARDS ***
3Wro85I7472vJ4Wkpneo9A: raises $1 to $1.50
FRkiRasEGlHUeLrEl+k/nA: folds
3Wro85I7472vJ4Wkpneo9A collected $1 from pot
3Wro85I7472vJ4Wkpneo9A: doesn't show hand
*** SUMMARY ***
Total pot $1 | Rake $0
Seat 1: FRkiRasEGlHUeLrEl+k/nA (big blind) folded before Flop
Seat 2: 3Wro85I7472vJ4Wkpneo9A (button) (small blind) collected ($1)



PokerStars Game #59938138192:  Hold'em No Limit ($0.25/$0.50) - 2009/07/01 0:07:54 ET
Table 'BCN5su+SsXiy1zRMJi0SJw' 6-max Seat #5 is the button
Seat 1: WyeokAqR0q9nADSkWpbxHw ($40.90 in chips)
Seat 2: QfV2JJlmEKgD5jYPV+a33A ($158.65 in chips)
Seat 4: 6Wb8PlO2kM4fnSim7p4Mrw ($15.80 in chips)
Seat 5: TTx3CHxyi0SObcHyMJRp5w ($34.50 in chips)
WyeokAqR0q9nADSkWpbxHw: posts small blind $0.25
QfV2JJlmEKgD5jYPV+a33A: posts big blind $0.50
L309C3uyA1tkWSOh/QvjHw: sits out
*** HOLE CARDS ***
6Wb8PlO2kM4fnSim7p4Mrw: calls $0.50
TTx3CHxyi0SObcHyMJRp5w: calls $0.50
WyeokAqR0q9nADSkWpbxHw: folds
QfV2JJlmEKgD5jYPV+a33A: raises $2.50 to $3
6Wb8PlO2kM4fnSim7p4Mrw: folds
TTx3CHxyi0SObcHyMJRp5w: folds
QfV2JJlmEKgD5jYPV+a33A collected $1.75 from pot
QfV2JJlmEKgD5jYPV+a33A: doesn't show hand
*** SUMMARY ***
Total pot $1.75 | Rake $0
Seat 1: WyeokAqR0q9nADSkWpbxHw (small blind) folded before Flop
Seat 2: QfV2JJlmEKgD5jYPV+a33A (big blind) collected ($1.75)
Seat 4: 6Wb8PlO2kM4fnSim7p4Mrw folded before Flop
Seat 5: TTx3CHxyi0SObcHyMJRp5w (button) folded before Flop



PokerStars Game #59938139940:  Hold'em No Limit ($0.25/$0.50) - 2009/07/01 0:07:57 ET
Table 'mTxf8gPLgffN3Iwfm7Icfg' 2-max Seat #1 is the button
Seat 1: Do9Rlu1R5u/AcRtMTl8SYg ($66.60 in chips)
Seat 2: EMc5LPgVaded4Qc77vm0fw ($47.95 in chips)
Do9Rlu1R5u/AcRtMTl8SYg: posts small blind $0.25
EMc5LPgVaded4Qc77vm0fw: posts big blind $0.50
*** HOLE CARDS ***
Do9Rlu1R5u/AcRtMTl8SYg: raises $1 to $1.50
EMc5LPgVaded4Qc77vm0fw: calls $1
*** FLOP *** [9d Ks Th]
EMc5LPgVaded4Qc77vm0fw: checks
Do9Rlu1R5u/AcRtMTl8SYg: bets $2
EMc5LPgVaded4Qc77vm0fw: calls $2
*** TURN *** [9d Ks Th] [2h]
EMc5LPgVaded4Qc77vm0fw: checks
Do9Rlu1R5u/AcRtMTl8SYg: bets $5.50
EMc5LPgVaded4Qc77vm0fw: folds
Do9Rlu1R5u/AcRtMTl8SYg collected $6.70 from pot
Do9Rlu1R5u/AcRtMTl8SYg: doesn't show hand
*** SUMMARY ***
Total pot $7 | Rake $0.30
Board [9d Ks Th 2h]
Seat 1: Do9Rlu1R5u/AcRtMTl8SYg (button) (small blind) collected ($6.70)
Seat 2: EMc5LPgVaded4Qc77vm0fw (big blind) folded on the Turn



PokerStars Game #59938140834:  Hold'em No Limit ($0.25/$0.50) - 2009/07/01 0:07:58 ET
Table 'm95HVfesC/VPgfGEjPuaIA' 2-max Seat #2 is the button
Seat 1: Fp/oksNpipCrD2MJ2pH20g ($10 in chips)
Seat 2: iY+tB5vLpLxiq0ifAZ7TNQ ($19.40 in chips)
iY+tB5vLpLxiq0ifAZ7TNQ: posts small blind $0.25
Fp/oksNpipCrD2MJ2pH20g: posts big blind $0.50
*** HOLE CARDS ***
iY+tB5vLpLxiq0ifAZ7TNQ: folds
Fp/oksNpipCrD2MJ2pH20g collected $0.50 from pot
Fp/oksNpipCrD2MJ2pH20g: doesn't show hand
*** SUMMARY ***
Total pot $0.50 | Rake $0
Seat 1: Fp/oksNpipCrD2MJ2pH20g (big blind) collected ($0.50)
Seat 2: iY+tB5vLpLxiq0ifAZ7TNQ (button) (small blind) folded before Flop



PokerStars Game #59938141450:  Hold'em No Limit ($0.25/$0.50) - 2009/07/01 0:07:59 ET
Table 'c/CRn+68J3Y8KxD5g1ek2Q' 2-max Seat #1 is the button
Seat 1: 46qCyJ6evTkHo9al5sBMNA ($311.95 in chips)
Seat 2: BypVLsYQt3ePFm2xQL/dOA ($75.35 in chips)
46qCyJ6evTkHo9al5sBMNA: posts small blind $0.25
BypVLsYQt3ePFm2xQL/dOA: posts big blind $0.50
*** HOLE CARDS ***
46qCyJ6evTkHo9al5sBMNA: folds
BypVLsYQt3ePFm2xQL/dOA collected $0.50 from pot
BypVLsYQt3ePFm2xQL/dOA: doesn't show hand
*** SUMMARY ***
Total pot $0.50 | Rake $0
Seat 1: 46qCyJ6evTkHo9al5sBMNA (button) (small blind) folded before Flop
Seat 2: BypVLsYQt3ePFm2xQL/dOA (big blind) collected ($0.50)



PokerStars Game #59938142118:  Hold'em No Limit ($0.25/$0.50) - 2009/07/01 0:08:00 ET
Table 'SsXEKOwKN+jE3etfusqUqA' 2-max Seat #2 is the button
Seat 1: 618rKeLrz/avGNOLULHHVQ ($50.50 in chips)
Seat 2: XfRhywXA6Br+jID1oGeo8A ($249.90 in chips)
XfRhywXA6Br+jID1oGeo8A: posts small blind $0.25
618rKeLrz/avGNOLULHHVQ: posts big blind $0.50
*** HOLE CARDS ***
XfRhywXA6Br+jID1oGeo8A: folds
618rKeLrz/avGNOLULHHVQ collected $0.50 from pot
618rKeLrz/avGNOLULHHVQ: doesn't show hand
*** SUMMARY ***
Total pot $0.50 | Rake $0
Seat 1: 618rKeLrz/avGNOLULHHVQ (big blind) collected ($0.50)
Seat 2: XfRhywXA6Br+jID1oGeo8A (button) (small blind) folded before Flop



PokerStars Game #59938142702:  Hold'em No Limit ($0.25/$0.50) - 2009/07/01 0:08:01 ET
Table 'raOT4/ipuZgzjfKHC+jD9g' 2-max Seat #2 is the button
Seat 1: IuwLemwLhc9fvrwBGs0AMA ($12.10 in chips)
Seat 2: Udr5juWSWUgTu1NlRhjMdA ($11.70 in chips)
Udr5juWSWUgTu1NlRhjMdA: posts small blind $0.25
IuwLemwLhc9fvrwBGs0AMA: posts big blind $0.50
*** HOLE CARDS ***
Udr5juWSWUgTu1NlRhjMdA: calls $0.25
IuwLemwLhc9fvrwBGs0AMA: checks
*** FLOP *** [3h 9h 8h]
IuwLemwLhc9fvrwBGs0AMA: checks
Udr5juWSWUgTu1NlRhjMdA: bets $1
IuwLemwLhc9fvrwBGs0AMA: folds
Udr5juWSWUgTu1NlRhjMdA collected $0.95 from pot
Udr5juWSWUgTu1NlRhjMdA: doesn't show hand
*** SUMMARY ***
Total pot $1 | Rake $0.05
Board [3h 9h 8h]
Seat 1: IuwLemwLhc9fvrwBGs0AMA (big blind) folded on the Flop
Seat 2: Udr5juWSWUgTu1NlRhjMdA (button) (small blind) collected ($0.95)



PokerStars Game #59938142908:  Hold'em No Limit ($0.25/$0.50) - 2009/07/01 0:08:01 ET
Table 'oxUN1yBuOHNrPf4xoy4aXw' 2-max Seat #2 is the button
Seat 1: ndd1nfncBkWNitBnsfCoVQ ($68.35 in chips)
Seat 2: mba14ZHNZ0/GoMe+gAVYmw ($36 in chips)
mba14ZHNZ0/GoMe+gAVYmw: posts small blind $0.25
ndd1nfncBkWNitBnsfCoVQ: posts big blind $0.50
*** HOLE CARDS ***
mba14ZHNZ0/GoMe+gAVYmw: calls $0.25
ndd1nfncBkWNitBnsfCoVQ: checks
*** FLOP *** [8c 4c Qs]
ndd1nfncBkWNitBnsfCoVQ: checks
mba14ZHNZ0/GoMe+gAVYmw: checks
*** TURN *** [8c 4c Qs] [Jc]
ndd1nfncBkWNitBnsfCoVQ: checks
mba14ZHNZ0/GoMe+gAVYmw: checks
*** RIVER *** [8c 4c Qs Jc] [3h]
ndd1nfncBkWNitBnsfCoVQ: checks
mba14ZHNZ0/GoMe+gAVYmw: checks
*** SHOW DOWN ***
ndd1nfncBkWNitBnsfCoVQ: shows [5s Td] (high card Queen)
mba14ZHNZ0/GoMe+gAVYmw: shows [Kc 6h] (high card King)
mba14ZHNZ0/GoMe+gAVYmw collected $0.95 from pot
*** SUMMARY ***
Total pot $1 | Rake $0.05
Board [8c 4c Qs Jc 3h]
Seat 1: ndd1nfncBkWNitBnsfCoVQ (big blind) showed [5s Td] and lost with high card Queen
Seat 2: mba14ZHNZ0/GoMe+gAVYmw (button) (small blind) showed [Kc 6h] and won ($0.95) with high card King



PokerStars Game #59938143772:  Hold'em No Limit ($0.25/$0.50) - 2009/07/01 0:08:02 ET
Table 'E7bWJ45aoFXRpyRv2gw+Ig' 2-max Seat #1 is the button
Seat 1: FRkiRasEGlHUeLrEl+k/nA ($75.05 in chips)
Seat 2: 3Wro85I7472vJ4Wkpneo9A ($49.15 in chips)
FRkiRasEGlHUeLrEl+k/nA: posts small blind $0.25
3Wro85I7472vJ4Wkpneo9A: posts big blind $0.50
*** HOLE CARDS ***
FRkiRasEGlHUeLrEl+k/nA: raises $1 to $1.50
3Wro85I7472vJ4Wkpneo9A: folds
FRkiRasEGlHUeLrEl+k/nA collected $1 from pot
FRkiRasEGlHUeLrEl+k/nA: doesn't show hand
*** SUMMARY ***
Total pot $1 | Rake $0
Seat 1: FRkiRasEGlHUeLrEl+k/nA (button) (small blind) collected ($1)
Seat 2: 3Wro85I7472vJ4Wkpneo9A (big blind) folded before Flop



PokerStars Game #59938145228:  Hold'em No Limit ($0.25/$0.50) - 2009/07/01 0:08:04 ET
Table 'tpZbcIvqh/6WmfR/i5IE3A' 9-max Seat #2 is the button
Seat 1: nV/P1jFY/CFMXOLWu7pYmA ($13.70 in chips)
Seat 2: M+7+BTmX5vZatHVuoRB1nA ($45.90 in chips)
Seat 3: 3w0FbBQAKwQODwenKwZxXw ($77.95 in chips)
Seat 4: zE9cVigS2nW/Ljy4K4bUQA ($30.75 in chips)
Seat 5: 9r7ZoBbAJj5IeyZ0q9BdzA ($12.90 in chips)
Seat 6: E2518gp4aFz1+kAgmGqeEg ($11.20 in chips)
Seat 7: wIZ377kjl2fHFGnS93o6bw ($13.70 in chips)
Seat 8: bXpVeaSTPBFSPJmeXxO7nw ($9.85 in chips)
3w0FbBQAKwQODwenKwZxXw: posts small blind $0.25
zE9cVigS2nW/Ljy4K4bUQA: posts big blind $0.50
*** HOLE CARDS ***
9r7ZoBbAJj5IeyZ0q9BdzA: folds
E2518gp4aFz1+kAgmGqeEg: folds
wIZ377kjl2fHFGnS93o6bw: calls $0.50
bXpVeaSTPBFSPJmeXxO7nw: folds
nV/P1jFY/CFMXOLWu7pYmA: folds
M+7+BTmX5vZatHVuoRB1nA: raises $1.50 to $2
3w0FbBQAKwQODwenKwZxXw: folds
zE9cVigS2nW/Ljy4K4bUQA: folds
wIZ377kjl2fHFGnS93o6bw: calls $1.50
*** FLOP *** [9c 4c 2c]
wIZ377kjl2fHFGnS93o6bw: checks
M+7+BTmX5vZatHVuoRB1nA: checks
*** TURN *** [9c 4c 2c] [6s]
wIZ377kjl2fHFGnS93o6bw: bets $1
M+7+BTmX5vZatHVuoRB1nA: calls $1
*** RIVER *** [9c 4c 2c 6s] [Js]
wIZ377kjl2fHFGnS93o6bw: bets $3
M+7+BTmX5vZatHVuoRB1nA: folds
wIZ377kjl2fHFGnS93o6bw collected $6.45 from pot
*** SUMMARY ***
Total pot $6.75 | Rake $0.30
Board [9c 4c 2c 6s Js]
Seat 1: nV/P1jFY/CFMXOLWu7pYmA folded before Flop (didn't bet)
Seat 2: M+7+BTmX5vZatHVuoRB1nA (button) folded on the River
Seat 3: 3w0FbBQAKwQODwenKwZxXw (small blind) folded before Flop
Seat 4: zE9cVigS2nW/Ljy4K4bUQA (big blind) folded before Flop
Seat 5: 9r7ZoBbAJj5IeyZ0q9BdzA folded before Flop (didn't bet)
Seat 6: E2518gp4aFz1+kAgmGqeEg folded before Flop (didn't bet)
Seat 7: wIZ377kjl2fHFGnS93o6bw collected ($6.45)
Seat 8: bXpVeaSTPBFSPJmeXxO7nw folded before Flop (didn't bet)



PokerStars Game #59938145738:  Hold'em No Limit ($0.25/$0.50) - 2009/07/01 0:08:05 ET
Table 'm95HVfesC/VPgfGEjPuaIA' 2-max Seat #1 is the button
Seat 1: Fp/oksNpipCrD2MJ2pH20g ($10.25 in chips)
Seat 2: iY+tB5vLpLxiq0ifAZ7TNQ ($19.15 in chips)
Fp/oksNpipCrD2MJ2pH20g: posts small blind $0.25
iY+tB5vLpLxiq0ifAZ7TNQ: posts big blind $0.50
*** HOLE CARDS ***
Fp/oksNpipCrD2MJ2pH20g: raises $1 to $1.50
iY+tB5vLpLxiq0ifAZ7TNQ: calls $1
*** FLOP *** [Ac Td 2c]
iY+tB5vLpLxiq0ifAZ7TNQ: checks
Fp/oksNpipCrD2MJ2pH20g: bets $1.50
iY+tB5vLpLxiq0ifAZ7TNQ: folds
Fp/oksNpipCrD2MJ2pH20g collected $2.85 from pot
Fp/oksNpipCrD2MJ2pH20g: doesn't show hand
*** SUMMARY ***
Total pot $3 | Rake $0.15
Board [Ac Td 2c]
Seat 1: Fp/oksNpipCrD2MJ2pH20g (button) (small blind) collected ($2.85)
Seat 2: iY+tB5vLpLxiq0ifAZ7TNQ (big blind) folded on the Flop



PokerStars Game #59938146218:  Hold'em No Limit ($0.25/$0.50) - 2009/07/01 0:08:05 ET
Table 'eMxdLyFDf28E0wit6gm3Uw' 6-max Seat #4 is the button
Seat 1: tnD/64LagZ9qPaeOQVjVZg ($10.75 in chips)
Seat 2: jwuKQ1S3U4NnzMQn3E3dgw ($65.15 in chips)
Seat 4: crjGpJEzSZgD38FoE3VMGg ($50.50 in chips)
Seat 5: X0X97o2fDAPiGx6o1gahsw ($58.30 in chips)
Seat 6: L0aIPg7qefDQjdJo3HCVEA ($7.50 in chips)
X0X97o2fDAPiGx6o1gahsw: posts small blind $0.25
L0aIPg7qefDQjdJo3HCVEA: posts big blind $0.50
*** HOLE CARDS ***
tnD/64LagZ9qPaeOQVjVZg: raises $10.25 to $10.75 and is all-in
jwuKQ1S3U4NnzMQn3E3dgw: folds
crjGpJEzSZgD38FoE3VMGg: folds
X0X97o2fDAPiGx6o1gahsw: folds
L0aIPg7qefDQjdJo3HCVEA: folds
tnD/64LagZ9qPaeOQVjVZg collected $1.25 from pot
*** SUMMARY ***
Total pot $1.25 | Rake $0
Seat 1: tnD/64LagZ9qPaeOQVjVZg collected ($1.25)
Seat 2: jwuKQ1S3U4NnzMQn3E3dgw folded before Flop (didn't bet)
Seat 4: crjGpJEzSZgD38FoE3VMGg (button) folded before Flop (didn't bet)
Seat 5: X0X97o2fDAPiGx6o1gahsw (small blind) folded before Flop
Seat 6: L0aIPg7qefDQjdJo3HCVEA (big blind) folded before Flop



PokerStars Game #59938147408:  Hold'em No Limit ($0.25/$0.50) - 2009/07/01 0:08:07 ET
Table 'c/CRn+68J3Y8KxD5g1ek2Q' 2-max Seat #2 is the button
Seat 1: 46qCyJ6evTkHo9al5sBMNA ($311.70 in chips)
Seat 2: BypVLsYQt3ePFm2xQL/dOA ($75.60 in chips)
BypVLsYQt3ePFm2xQL/dOA: posts small blind $0.25
46qCyJ6evTkHo9al5sBMNA: posts big blind $0.50
*** HOLE CARDS ***
BypVLsYQt3ePFm2xQL/dOA: calls $0.25
46qCyJ6evTkHo9al5sBMNA: checks
*** FLOP *** [9d Qc 4c]
46qCyJ6evTkHo9al5sBMNA: checks
BypVLsYQt3ePFm2xQL/dOA: checks
*** TURN *** [9d Qc 4c] [Ad]
46qCyJ6evTkHo9al5sBMNA: bets $1.50
BypVLsYQt3ePFm2xQL/dOA: calls $1.50
*** RIVER *** [9d Qc 4c Ad] [8d]
46qCyJ6evTkHo9al5sBMNA: bets $3
BypVLsYQt3ePFm2xQL/dOA: folds
46qCyJ6evTkHo9al5sBMNA collected $3.85 from pot
*** SUMMARY ***
Total pot $4 | Rake $0.15
Board [9d Qc 4c Ad 8d]
Seat 1: 46qCyJ6evTkHo9al5sBMNA (big blind) collected ($3.85)
Seat 2: BypVLsYQt3ePFm2xQL/dOA (button) (small blind) folded on the River



PokerStars Game #59938147026:  Hold'em No Limit ($0.25/$0.50) - 2009/07/01 0:08:07 ET
Table 'SsXEKOwKN+jE3etfusqUqA' 2-max Seat #1 is the button
Seat 1: 618rKeLrz/avGNOLULHHVQ ($50.75 in chips)
Seat 2: XfRhywXA6Br+jID1oGeo8A ($249.65 in chips)
618rKeLrz/avGNOLULHHVQ: posts small blind $0.25
XfRhywXA6Br+jID1oGeo8A: posts big blind $0.50
*** HOLE CARDS ***
618rKeLrz/avGNOLULHHVQ: folds
XfRhywXA6Br+jID1oGeo8A collected $0.50 from pot
*** SUMMARY ***
Total pot $0.50 | Rake $0
Seat 1: 618rKeLrz/avGNOLULHHVQ (button) (small blind) folded before Flop
Seat 2: XfRhywXA6Br+jID1oGeo8A (big blind) collected ($0.50)



PokerStars Game #59938148494:  Hold'em No Limit ($0.25/$0.50) - 2009/07/01 0:08:09 ET
Table 'NCiXr0d5CEKBQr/cZgLhbA' 9-max Seat #2 is the button
Seat 1: RjBdQ6w31rgcy0o24VLR6w ($8.50 in chips)
Seat 2: ulxuJchBV9iguXg0FUonfg ($35.80 in chips)
Seat 3: xZCXQSXlrZkp3pZizzVXCw ($55.15 in chips)
Seat 4: CL4d+tvzcd4utdQxlPLOmg ($29.90 in chips)
Seat 5: zE9cVigS2nW/Ljy4K4bUQA ($32.70 in chips)
Seat 6: SKnJuWHScqetA/qG5p+wCg ($31.80 in chips)
Seat 9: WpvT3OUSiZlpvs+mPXFqtQ ($7.45 in chips)
xZCXQSXlrZkp3pZizzVXCw: posts small blind $0.25
CL4d+tvzcd4utdQxlPLOmg: posts big blind $0.50
*** HOLE CARDS ***
EltNhVR1POPXhu/1E62t3A has returned
E2518gp4aFz1+kAgmGqeEg leaves the table
zE9cVigS2nW/Ljy4K4bUQA: folds
SKnJuWHScqetA/qG5p+wCg: folds
WpvT3OUSiZlpvs+mPXFqtQ: raises $1 to $1.50
RjBdQ6w31rgcy0o24VLR6w: folds
ulxuJchBV9iguXg0FUonfg: folds
1MJUKc3cc0QmUoz1JZLR2w joins the table at seat #8
xZCXQSXlrZkp3pZizzVXCw: folds
CL4d+tvzcd4utdQxlPLOmg: folds
WpvT3OUSiZlpvs+mPXFqtQ collected $1.25 from pot
*** SUMMARY ***
Total pot $1.25 | Rake $0
Seat 1: RjBdQ6w31rgcy0o24VLR6w folded before Flop (didn't bet)
Seat 2: ulxuJchBV9iguXg0FUonfg (button) folded before Flop (didn't bet)
Seat 3: xZCXQSXlrZkp3pZizzVXCw (small blind) folded before Flop
Seat 4: CL4d+tvzcd4utdQxlPLOmg (big blind) folded before Flop
Seat 5: zE9cVigS2nW/Ljy4K4bUQA folded before Flop (didn't bet)
Seat 6: SKnJuWHScqetA/qG5p+wCg folded before Flop (didn't bet)
Seat 9: WpvT3OUSiZlpvs+mPXFqtQ collected ($1.25)



PokerStars Game #59938149778:  Hold'em No Limit ($0.25/$0.50) - 2009/07/01 0:08:10 ET
Table 'E7bWJ45aoFXRpyRv2gw+Ig' 2-max Seat #2 is the button
Seat 1: FRkiRasEGlHUeLrEl+k/nA ($75.55 in chips)
Seat 2: 3Wro85I7472vJ4Wkpneo9A ($48.65 in chips)
3Wro85I7472vJ4Wkpneo9A: posts small blind $0.25
FRkiRasEGlHUeLrEl+k/nA: posts big blind $0.50
*** HOLE CARDS ***
3Wro85I7472vJ4Wkpneo9A: calls $0.25
FRkiRasEGlHUeLrEl+k/nA: checks
*** FLOP *** [8d 9h 7c]
FRkiRasEGlHUeLrEl+k/nA: checks
3Wro85I7472vJ4Wkpneo9A: bets $1
FRkiRasEGlHUeLrEl+k/nA: folds
3Wro85I7472vJ4Wkpneo9A collected $0.95 from pot
3Wro85I7472vJ4Wkpneo9A: doesn't show hand
*** SUMMARY ***
Total pot $1 | Rake $0.05
Board [8d 9h 7c]
Seat 1: FRkiRasEGlHUeLrEl+k/nA (big blind) folded on the Flop
Seat 2: 3Wro85I7472vJ4Wkpneo9A (button) (small blind) collected ($0.95)



PokerStars Game #59938149676:  Hold'em No Limit ($0.25/$0.50) - 2009/07/01 0:08:10 ET
Table '+dXkOAQyS8j9PQZusUTMpg' 2-max Seat #2 is the button
Seat 1: XFa6sBGjP2gxoIvxR3fZIg ($69.15 in chips)
Seat 2: 5IBeOgaApY1Bvzv2P8X4EA ($44.70 in chips)
5IBeOgaApY1Bvzv2P8X4EA: posts small blind $0.25
XFa6sBGjP2gxoIvxR3fZIg: posts big blind $0.50
*** HOLE CARDS ***
5IBeOgaApY1Bvzv2P8X4EA: folds
XFa6sBGjP2gxoIvxR3fZIg collected $0.50 from pot
XFa6sBGjP2gxoIvxR3fZIg: doesn't show hand
*** SUMMARY ***
Total pot $0.50 | Rake $0
Seat 1: XFa6sBGjP2gxoIvxR3fZIg (big blind) collected ($0.50)
Seat 2: 5IBeOgaApY1Bvzv2P8X4EA (button) (small blind) folded before Flop



PokerStars Game #59938151500:  Hold'em No Limit ($0.25/$0.50) - 2009/07/01 0:08:13 ET
Table 'SsXEKOwKN+jE3etfusqUqA' 2-max Seat #2 is the button
Seat 1: 618rKeLrz/avGNOLULHHVQ ($50.50 in chips)
Seat 2: XfRhywXA6Br+jID1oGeo8A ($249.90 in chips)
XfRhywXA6Br+jID1oGeo8A: posts small blind $0.25
618rKeLrz/avGNOLULHHVQ: posts big blind $0.50
*** HOLE CARDS ***
XfRhywXA6Br+jID1oGeo8A: calls $0.25
618rKeLrz/avGNOLULHHVQ: raises $1.50 to $2
XfRhywXA6Br+jID1oGeo8A: folds
618rKeLrz/avGNOLULHHVQ collected $1 from pot
618rKeLrz/avGNOLULHHVQ: doesn't show hand
*** SUMMARY ***
Total pot $1 | Rake $0
Seat 1: 618rKeLrz/avGNOLULHHVQ (big blind) collected ($1)
Seat 2: XfRhywXA6Br+jID1oGeo8A (button) (small blind) folded before Flop



PokerStars Game #59938152678:  Hold'em No Limit ($0.25/$0.50) - 2009/07/01 0:08:14 ET
Table 'Vdlc9wqYcHTUhtdyN7CuJw' 2-max Seat #2 is the button
Seat 1: yBO+mXB6m/rCft2ErwGf/Q ($89.50 in chips)
Seat 2: sa0qgETiL3HNbdfGlnKHTA ($23.80 in chips)
sa0qgETiL3HNbdfGlnKHTA: posts small blind $0.25
yBO+mXB6m/rCft2ErwGf/Q: posts big blind $0.50
*** HOLE CARDS ***
sa0qgETiL3HNbdfGlnKHTA said, "increible"
sa0qgETiL3HNbdfGlnKHTA: raises $1.50 to $2
yBO+mXB6m/rCft2ErwGf/Q: folds
sa0qgETiL3HNbdfGlnKHTA collected $1 from pot
sa0qgETiL3HNbdfGlnKHTA: doesn't show hand
*** SUMMARY ***
Total pot $1 | Rake $0
Seat 1: yBO+mXB6m/rCft2ErwGf/Q (big blind) folded before Flop
Seat 2: sa0qgETiL3HNbdfGlnKHTA (button) (small blind) collected ($1)



PokerStars Game #59938153164:  Hold'em No Limit ($0.25/$0.50) - 2009/07/01 0:08:15 ET
Table 'kgbJRsxfv64KrErDRBAkcw' 6-max Seat #1 is the button
Seat 1: YmWlPGOKFuJSoJZPW8a8IA ($80.55 in chips)
Seat 2: Q+thC23WCv1kJUJtH/+4Jw ($26.35 in chips)
Seat 3: T0Gx/FcQ5VH9u7XaOMX97A ($61.65 in chips)
Seat 4: qanMEqjABjWxC/JgQ/0l7w ($62.20 in chips)
Seat 5: SlTdlH14u+KVVINgxMwt+Q ($67.95 in chips)
Seat 6: DDfYzIrYT0t5R/hAJngtsg ($23.95 in chips)
Q+thC23WCv1kJUJtH/+4Jw: posts small blind $0.25
T0Gx/FcQ5VH9u7XaOMX97A: posts big blind $0.50
*** HOLE CARDS ***
qanMEqjABjWxC/JgQ/0l7w: folds
SlTdlH14u+KVVINgxMwt+Q: raises $1.50 to $2
DDfYzIrYT0t5R/hAJngtsg: calls $2
YmWlPGOKFuJSoJZPW8a8IA: folds
Q+thC23WCv1kJUJtH/+4Jw: folds
T0Gx/FcQ5VH9u7XaOMX97A: raises $6.50 to $8.50
SlTdlH14u+KVVINgxMwt+Q: folds
DDfYzIrYT0t5R/hAJngtsg: folds
T0Gx/FcQ5VH9u7XaOMX97A collected $6.25 from pot
T0Gx/FcQ5VH9u7XaOMX97A: doesn't show hand
*** SUMMARY ***
Total pot $6.25 | Rake $0
Seat 1: YmWlPGOKFuJSoJZPW8a8IA (button) folded before Flop (didn't bet)
Seat 2: Q+thC23WCv1kJUJtH/+4Jw (small blind) folded before Flop
Seat 3: T0Gx/FcQ5VH9u7XaOMX97A (big blind) collected ($6.25)
Seat 4: qanMEqjABjWxC/JgQ/0l7w folded before Flop (didn't bet)
Seat 5: SlTdlH14u+KVVINgxMwt+Q folded before Flop
Seat 6: DDfYzIrYT0t5R/hAJngtsg folded before Flop



PokerStars Game #59938154240:  Hold'em No Limit ($0.25/$0.50) - 2009/07/01 0:08:17 ET
Table '+dXkOAQyS8j9PQZusUTMpg' 2-max Seat #1 is the button
Seat 1: XFa6sBGjP2gxoIvxR3fZIg ($69.40 in chips)
Seat 2: 5IBeOgaApY1Bvzv2P8X4EA ($44.45 in chips)
XFa6sBGjP2gxoIvxR3fZIg: posts small blind $0.25
5IBeOgaApY1Bvzv2P8X4EA: posts big blind $0.50
*** HOLE CARDS ***
XFa6sBGjP2gxoIvxR3fZIg: raises $1 to $1.50
5IBeOgaApY1Bvzv2P8X4EA: folds
XFa6sBGjP2gxoIvxR3fZIg collected $1 from pot
XFa6sBGjP2gxoIvxR3fZIg: doesn't show hand
*** SUMMARY ***
Total pot $1 | Rake $0
Seat 1: XFa6sBGjP2gxoIvxR3fZIg (button) (small blind) collected ($1)
Seat 2: 5IBeOgaApY1Bvzv2P8X4EA (big blind) folded before Flop



PokerStars Game #59938155572:  Hold'em No Limit ($0.25/$0.50) - 2009/07/01 0:08:18 ET
Table 'BCN5su+SsXiy1zRMJi0SJw' 6-max Seat #1 is the button
Seat 1: WyeokAqR0q9nADSkWpbxHw ($40.65 in chips)
Seat 2: QfV2JJlmEKgD5jYPV+a33A ($159.90 in chips)
Seat 3: L309C3uyA1tkWSOh/QvjHw ($20 in chips)
Seat 4: 6Wb8PlO2kM4fnSim7p4Mrw ($15.30 in chips)
Seat 5: TTx3CHxyi0SObcHyMJRp5w ($34 in chips)
QfV2JJlmEKgD5jYPV+a33A: posts small blind $0.25
L309C3uyA1tkWSOh/QvjHw: posts big blind $0.50
*** HOLE CARDS ***
6Wb8PlO2kM4fnSim7p4Mrw: folds
TTx3CHxyi0SObcHyMJRp5w: folds
WyeokAqR0q9nADSkWpbxHw: folds
QfV2JJlmEKgD5jYPV+a33A: folds
L309C3uyA1tkWSOh/QvjHw collected $0.50 from pot
*** SUMMARY ***
Total pot $0.50 | Rake $0
Seat 1: WyeokAqR0q9nADSkWpbxHw (button) folded before Flop (didn't bet)
Seat 2: QfV2JJlmEKgD5jYPV+a33A (small blind) folded before Flop
Seat 3: L309C3uyA1tkWSOh/QvjHw (big blind) collected ($0.50)
Seat 4: 6Wb8PlO2kM4fnSim7p4Mrw folded before Flop (didn't bet)
Seat 5: TTx3CHxyi0SObcHyMJRp5w folded before Flop (didn't bet)



PokerStars Game #59938155946:  Hold'em No Limit ($0.25/$0.50) - 2009/07/01 0:08:19 ET
Table '5EmHi+fnatGQQShcNmzOZQ' 6-max Seat #4 is the button
Seat 1: SwPczQo3cOtwEzhJrfO2cQ ($22.30 in chips)
Seat 2: APwvTk5XojDXGoQLb4O5iA ($27.35 in chips)
Seat 3: J8dF2sYMvXUmAGUuSW9kwg ($34.55 in chips)
Seat 4: mFTuMjESuBcXHQ1ePkg/8A ($17.65 in chips)
Seat 5: kxPhs4ePFqMy52CInAJ2aw ($72.55 in chips)
Seat 6: 686aeHikcJlgKkSuIFdcXQ ($115.45 in chips)
kxPhs4ePFqMy52CInAJ2aw: posts small blind $0.25
686aeHikcJlgKkSuIFdcXQ: posts big blind $0.50
*** HOLE CARDS ***
SwPczQo3cOtwEzhJrfO2cQ: calls $0.50
APwvTk5XojDXGoQLb4O5iA has timed out
APwvTk5XojDXGoQLb4O5iA: folds
APwvTk5XojDXGoQLb4O5iA is sitting out
J8dF2sYMvXUmAGUuSW9kwg: folds
mFTuMjESuBcXHQ1ePkg/8A: folds
kxPhs4ePFqMy52CInAJ2aw: raises $2.50 to $3
APwvTk5XojDXGoQLb4O5iA has returned
686aeHikcJlgKkSuIFdcXQ: folds
SwPczQo3cOtwEzhJrfO2cQ: calls $2.50
*** FLOP *** [Js 8c 4c]
kxPhs4ePFqMy52CInAJ2aw: checks
SwPczQo3cOtwEzhJrfO2cQ: checks
*** TURN *** [Js 8c 4c] [5h]
kxPhs4ePFqMy52CInAJ2aw: checks
SwPczQo3cOtwEzhJrfO2cQ: bets $2
kxPhs4ePFqMy52CInAJ2aw: folds
SwPczQo3cOtwEzhJrfO2cQ collected $6.20 from pot
*** SUMMARY ***
Total pot $6.50 | Rake $0.30
Board [Js 8c 4c 5h]
Seat 1: SwPczQo3cOtwEzhJrfO2cQ collected ($6.20)
Seat 2: APwvTk5XojDXGoQLb4O5iA folded before Flop (didn't bet)
Seat 3: J8dF2sYMvXUmAGUuSW9kwg folded before Flop (didn't bet)
Seat 4: mFTuMjESuBcXHQ1ePkg/8A (button) folded before Flop (didn't bet)
Seat 5: kxPhs4ePFqMy52CInAJ2aw (small blind) folded on the Turn
Seat 6: 686aeHikcJlgKkSuIFdcXQ (big blind) folded before Flop



PokerStars Game #59938157790:  Hold'em No Limit ($0.25/$0.50) - 2009/07/01 0:08:21 ET
Table 'm95HVfesC/VPgfGEjPuaIA' 2-max Seat #2 is the button
Seat 1: Fp/oksNpipCrD2MJ2pH20g ($11.60 in chips)
Seat 2: iY+tB5vLpLxiq0ifAZ7TNQ ($17.65 in chips)
iY+tB5vLpLxiq0ifAZ7TNQ: posts small blind $0.25
Fp/oksNpipCrD2MJ2pH20g: posts big blind $0.50
*** HOLE CARDS ***
iY+tB5vLpLxiq0ifAZ7TNQ: calls $0.25
Fp/oksNpipCrD2MJ2pH20g: checks
*** FLOP *** [As Kh 2s]
Fp/oksNpipCrD2MJ2pH20g: bets $0.50
iY+tB5vLpLxiq0ifAZ7TNQ: calls $0.50
*** TURN *** [As Kh 2s] [Ad]
Fp/oksNpipCrD2MJ2pH20g: checks
iY+tB5vLpLxiq0ifAZ7TNQ: bets $1
Fp/oksNpipCrD2MJ2pH20g: folds
iY+tB5vLpLxiq0ifAZ7TNQ collected $1.95 from pot
iY+tB5vLpLxiq0ifAZ7TNQ: doesn't show hand
*** SUMMARY ***
Total pot $2 | Rake $0.05
Board [As Kh 2s Ad]
Seat 1: Fp/oksNpipCrD2MJ2pH20g (big blind) folded on the Turn
Seat 2: iY+tB5vLpLxiq0ifAZ7TNQ (button) (small blind) collected ($1.95)



PokerStars Game #59938158564:  Hold'em No Limit ($0.25/$0.50) - 2009/07/01 0:08:22 ET
Table 'mTxf8gPLgffN3Iwfm7Icfg' 2-max Seat #2 is the button
Seat 1: Do9Rlu1R5u/AcRtMTl8SYg ($69.80 in chips)
Seat 2: EMc5LPgVaded4Qc77vm0fw ($44.45 in chips)
EMc5LPgVaded4Qc77vm0fw: posts small blind $0.25
Do9Rlu1R5u/AcRtMTl8SYg: posts big blind $0.50
*** HOLE CARDS ***
EMc5LPgVaded4Qc77vm0fw: folds
Do9Rlu1R5u/AcRtMTl8SYg collected $0.50 from pot
Do9Rlu1R5u/AcRtMTl8SYg: doesn't show hand
*** SUMMARY ***
Total pot $0.50 | Rake $0
Seat 1: Do9Rlu1R5u/AcRtMTl8SYg (big blind) collected ($0.50)
Seat 2: EMc5LPgVaded4Qc77vm0fw (button) (small blind) folded before Flop



PokerStars Game #59938158366:  Hold'em No Limit ($0.25/$0.50) - 2009/07/01 0:08:22 ET
Table 'SsXEKOwKN+jE3etfusqUqA' 2-max Seat #1 is the button
Seat 1: 618rKeLrz/avGNOLULHHVQ ($51 in chips)
Seat 2: XfRhywXA6Br+jID1oGeo8A ($249.40 in chips)
618rKeLrz/avGNOLULHHVQ: posts small blind $0.25
XfRhywXA6Br+jID1oGeo8A: posts big blind $0.50
*** HOLE CARDS ***
618rKeLrz/avGNOLULHHVQ: folds
XfRhywXA6Br+jID1oGeo8A collected $0.50 from pot
*** SUMMARY ***
Total pot $0.50 | Rake $0
Seat 1: 618rKeLrz/avGNOLULHHVQ (button) (small blind) folded before Flop
Seat 2: XfRhywXA6Br+jID1oGeo8A (big blind) collected ($0.50)



PokerStars Game #59938158558:  Hold'em No Limit ($0.25/$0.50) - 2009/07/01 0:08:22 ET
Table 'QOgaEqMcJ73pcUMMxoisUgErOuyGLI5PT3G5MnpHgC/g Seat #4 is the button
Seat 1: k6GJzKs7T7qvQggW9g8Pdw ($48.70 in chips)
Seat 2: RjBdQ6w31rgcy0o24VLR6w ($10.95 in chips)
Seat 3: xZCXQSXlrZkp3pZizzVXCw ($50.50 in chips)
Seat 4: U7aZzIYWjv3SL30KtikLbw ($47.95 in chips)
Seat 5: JwvquocWfhTVApN5t47LgA ($50.55 in chips)
Seat 6: zE9cVigS2nW/Ljy4K4bUQA ($31.35 in chips)
Seat 7: 90Wb75h3W1BRpbqVnuk8gw ($62.55 in chips)
Seat 9: J0W5D97jl5VLky+IoPvDeA ($67.80 in chips)
JwvquocWfhTVApN5t47LgA: posts small blind $0.25
zE9cVigS2nW/Ljy4K4bUQA: posts big blind $0.50
g4k0NXISyLCqaSWZDBjfEg: sits out
*** HOLE CARDS ***
90Wb75h3W1BRpbqVnuk8gw: folds
J0W5D97jl5VLky+IoPvDeA: folds
k6GJzKs7T7qvQggW9g8Pdw: calls $0.50
RjBdQ6w31rgcy0o24VLR6w: folds
xZCXQSXlrZkp3pZizzVXCw: folds
U7aZzIYWjv3SL30KtikLbw: calls $0.50
JwvquocWfhTVApN5t47LgA: calls $0.25
zE9cVigS2nW/Ljy4K4bUQA: checks
*** FLOP *** [Ts Td 7d]
JwvquocWfhTVApN5t47LgA: checks
zE9cVigS2nW/Ljy4K4bUQA: checks
k6GJzKs7T7qvQggW9g8Pdw: checks
U7aZzIYWjv3SL30KtikLbw: checks
*** TURN *** [Ts Td 7d] [Ad]
JwvquocWfhTVApN5t47LgA: checks
zE9cVigS2nW/Ljy4K4bUQA: checks
k6GJzKs7T7qvQggW9g8Pdw: bets $2
U7aZzIYWjv3SL30KtikLbw: folds
JwvquocWfhTVApN5t47LgA: folds
zE9cVigS2nW/Ljy4K4bUQA: calls $2
*** RIVER *** [Ts Td 7d Ad] [3h]
zE9cVigS2nW/Ljy4K4bUQA: checks
k6GJzKs7T7qvQggW9g8Pdw: bets $5.50
zE9cVigS2nW/Ljy4K4bUQA: calls $5.50
*** SHOW DOWN ***
k6GJzKs7T7qvQggW9g8Pdw: shows [Tc Qh] (three of a kind, Tens)
zE9cVigS2nW/Ljy4K4bUQA: mucks hand
k6GJzKs7T7qvQggW9g8Pdw collected $16.20 from pot
*** SUMMARY ***
Total pot $17 | Rake $0.80
Board [Ts Td 7d Ad 3h]
Seat 1: k6GJzKs7T7qvQggW9g8Pdw showed [Tc Qh] and won ($16.20) with three of a kind, Tens
Seat 2: RjBdQ6w31rgcy0o24VLR6w folded before Flop (didn't bet)
Seat 3: xZCXQSXlrZkp3pZizzVXCw folded before Flop (didn't bet)
Seat 4: U7aZzIYWjv3SL30KtikLbw (button) folded on the Turn
Seat 5: JwvquocWfhTVApN5t47LgA (small blind) folded on the Turn
Seat 6: zE9cVigS2nW/Ljy4K4bUQA (big blind) mucked
Seat 7: 90Wb75h3W1BRpbqVnuk8gw folded before Flop (didn't bet)
Seat 9: J0W5D97jl5VLky+IoPvDeA folded before Flop (didn't bet)



PokerStars Game #59938160244:  Hold'em No Limit ($0.25/$0.50) - 2009/07/01 0:08:25 ET
Table '+dXkOAQyS8j9PQZusUTMpg' 2-max Seat #2 is the button
Seat 1: XFa6sBGjP2gxoIvxR3fZIg ($69.90 in chips)
Seat 2: 5IBeOgaApY1Bvzv2P8X4EA ($43.95 in chips)
5IBeOgaApY1Bvzv2P8X4EA: posts small blind $0.25
XFa6sBGjP2gxoIvxR3fZIg: posts big blind $0.50
*** HOLE CARDS ***
5IBeOgaApY1Bvzv2P8X4EA: folds
XFa6sBGjP2gxoIvxR3fZIg collected $0.50 from pot
XFa6sBGjP2gxoIvxR3fZIg: doesn't show hand
*** SUMMARY ***
Total pot $0.50 | Rake $0
Seat 1: XFa6sBGjP2gxoIvxR3fZIg (big blind) collected ($0.50)
Seat 2: 5IBeOgaApY1Bvzv2P8X4EA (button) (small blind) folded before Flop



PokerStars Game #59938161468:  Hold'em No Limit ($0.25/$0.50) - 2009/07/01 0:08:26 ET
Table 'Vdlc9wqYcHTUhtdyN7CuJw' 2-max Seat #1 is the button
Seat 1: yBO+mXB6m/rCft2ErwGf/Q ($89 in chips)
Seat 2: sa0qgETiL3HNbdfGlnKHTA ($24.30 in chips)
yBO+mXB6m/rCft2ErwGf/Q: posts small blind $0.25
sa0qgETiL3HNbdfGlnKHTA: posts big blind $0.50
*** HOLE CARDS ***
yBO+mXB6m/rCft2ErwGf/Q: raises $1.50 to $2
sa0qgETiL3HNbdfGlnKHTA: calls $1.50
*** FLOP *** [5s Jh Td]
sa0qgETiL3HNbdfGlnKHTA: checks
yBO+mXB6m/rCft2ErwGf/Q: bets $4.50
sa0qgETiL3HNbdfGlnKHTA: folds
yBO+mXB6m/rCft2ErwGf/Q collected $3.80 from pot
*** SUMMARY ***
Total pot $4 | Rake $0.20
Board [5s Jh Td]
Seat 1: yBO+mXB6m/rCft2ErwGf/Q (button) (small blind) collected ($3.80)
Seat 2: sa0qgETiL3HNbdfGlnKHTA (big blind) folded on the Flop



PokerStars Game #59938161864:  Hold'em No Limit ($0.25/$0.50) - 2009/07/01 0:08:27 ET
Table 'E7bWJ45aoFXRpyRv2gw+Ig' 2-max Seat #1 is the button
Seat 1: FRkiRasEGlHUeLrEl+k/nA ($75.05 in chips)
Seat 2: 3Wro85I7472vJ4Wkpneo9A ($49.10 in chips)
FRkiRasEGlHUeLrEl+k/nA: posts small blind $0.25
3Wro85I7472vJ4Wkpneo9A: posts big blind $0.50
*** HOLE CARDS ***
FRkiRasEGlHUeLrEl+k/nA: raises $1 to $1.50
3Wro85I7472vJ4Wkpneo9A: folds
FRkiRasEGlHUeLrEl+k/nA collected $1 from pot
*** SUMMARY ***
Total pot $1 | Rake $0
Seat 1: FRkiRasEGlHUeLrEl+k/nA (button) (small blind) collected ($1)
Seat 2: 3Wro85I7472vJ4Wkpneo9A (big blind) folded before Flop



PokerStars Game #59938161686:  Hold'em No Limit ($0.25/$0.50) - 2009/07/01 0:08:27 ET
Table '37qXEp3oe+er5q4CZip9eQ' 6-max Seat #3 is the button
Seat 2: g12O9qXTybyo2C0B2bXgjg ($37.45 in chips)
Seat 3: Rt6KgtZ8YaJoTc3FPim00w ($108.10 in chips)
Seat 4: L0aIPg7qefDQjdJo3HCVEA ($9.80 in chips)
Seat 5: VOmI0x4dDPnTESZd5B4d1Q ($30.75 in chips)
Seat 6: f7zPpUQp9hHZgqhEvrUWQw ($55.90 in chips)
L0aIPg7qefDQjdJo3HCVEA: posts small blind $0.25
VOmI0x4dDPnTESZd5B4d1Q: posts big blind $0.50
*** HOLE CARDS ***
f7zPpUQp9hHZgqhEvrUWQw: folds
g12O9qXTybyo2C0B2bXgjg: raises $1 to $1.50
Rt6KgtZ8YaJoTc3FPim00w: folds
L0aIPg7qefDQjdJo3HCVEA: raises $8.30 to $9.80 and is all-in
VOmI0x4dDPnTESZd5B4d1Q: folds
g12O9qXTybyo2C0B2bXgjg: calls $8.30
*** FLOP *** [As 3h Ts]
*** TURN *** [As 3h Ts] [9h]
*** RIVER *** [As 3h Ts 9h] [6s]
*** SHOW DOWN ***
L0aIPg7qefDQjdJo3HCVEA: shows [Ac Jh] (a pair of Aces)
g12O9qXTybyo2C0B2bXgjg: mucks hand
L0aIPg7qefDQjdJo3HCVEA collected $19.10 from pot
*** SUMMARY ***
Total pot $20.10 | Rake $1
Board [As 3h Ts 9h 6s]
Seat 2: g12O9qXTybyo2C0B2bXgjg mucked
Seat 3: Rt6KgtZ8YaJoTc3FPim00w (button) folded before Flop (didn't bet)
Seat 4: L0aIPg7qefDQjdJo3HCVEA (small blind) showed [Ac Jh] and won ($19.10) with a pair of Aces
Seat 5: VOmI0x4dDPnTESZd5B4d1Q (big blind) folded before Flop
Seat 6: f7zPpUQp9hHZgqhEvrUWQw folded before Flop (didn't bet)



PokerStars Game #59938162344:  Hold'em No Limit ($0.25/$0.50) - 2009/07/01 0:08:28 ET
Table 'YsnnHkamRzYqMOr2FlLY4w' 6-max Seat #3 is the button
Seat 1: crjGpJEzSZgD38FoE3VMGg ($50 in chips)
Seat 3: I+pG2m/dD5iYdbg9qx572g ($23.25 in chips)
Seat 4: 7Fue572p4ZIC85AJMQvaQw ($55.90 in chips)
Seat 5: lcQ7uuLf+WLGGy4Ve6VKKA ($40.60 in chips)
Seat 6: YmWlPGOKFuJSoJZPW8a8IA ($53.40 in chips)
7Fue572p4ZIC85AJMQvaQw: posts small blind $0.25
lcQ7uuLf+WLGGy4Ve6VKKA: posts big blind $0.50
vnRgOasQNKOR7gLXwRQ+ww: sits out
*** HOLE CARDS ***
YmWlPGOKFuJSoJZPW8a8IA: folds
crjGpJEzSZgD38FoE3VMGg: raises $1.50 to $2
I+pG2m/dD5iYdbg9qx572g: calls $2
7Fue572p4ZIC85AJMQvaQw: calls $1.75
lcQ7uuLf+WLGGy4Ve6VKKA: folds
*** FLOP *** [3d Jc Tc]
7Fue572p4ZIC85AJMQvaQw: checks
crjGpJEzSZgD38FoE3VMGg: checks
I+pG2m/dD5iYdbg9qx572g: checks
*** TURN *** [3d Jc Tc] [3c]
7Fue572p4ZIC85AJMQvaQw: checks
crjGpJEzSZgD38FoE3VMGg: checks
I+pG2m/dD5iYdbg9qx572g: checks
*** RIVER *** [3d Jc Tc 3c] [5c]
7Fue572p4ZIC85AJMQvaQw: bets $0.50
crjGpJEzSZgD38FoE3VMGg: raises $5 to $5.50
I+pG2m/dD5iYdbg9qx572g: folds
7Fue572p4ZIC85AJMQvaQw: folds
crjGpJEzSZgD38FoE3VMGg collected $7.15 from pot
crjGpJEzSZgD38FoE3VMGg: doesn't show hand
*** SUMMARY ***
Total pot $7.50 | Rake $0.35
Board [3d Jc Tc 3c 5c]
Seat 1: crjGpJEzSZgD38FoE3VMGg collected ($7.15)
Seat 3: I+pG2m/dD5iYdbg9qx572g (button) folded on the River
Seat 4: 7Fue572p4ZIC85AJMQvaQw (small blind) folded on the River
Seat 5: lcQ7uuLf+WLGGy4Ve6VKKA (big blind) folded before Flop
Seat 6: YmWlPGOKFuJSoJZPW8a8IA folded before Flop (didn't bet)



PokerStars Game #59938162708:  Hold'em No Limit ($0.25/$0.50) - 2009/07/01 0:08:28 ET
Table 'mTxf8gPLgffN3Iwfm7Icfg' 2-max Seat #1 is the button
Seat 1: Do9Rlu1R5u/AcRtMTl8SYg ($70.05 in chips)
Seat 2: EMc5LPgVaded4Qc77vm0fw ($44.20 in chips)
Do9Rlu1R5u/AcRtMTl8SYg: posts small blind $0.25
EMc5LPgVaded4Qc77vm0fw: posts big blind $0.50
*** HOLE CARDS ***
Do9Rlu1R5u/AcRtMTl8SYg: raises $1 to $1.50
EMc5LPgVaded4Qc77vm0fw: raises $4 to $5.50
Do9Rlu1R5u/AcRtMTl8SYg: folds
EMc5LPgVaded4Qc77vm0fw collected $3 from pot
EMc5LPgVaded4Qc77vm0fw: doesn't show hand
*** SUMMARY ***
Total pot $3 | Rake $0
Seat 1: Do9Rlu1R5u/AcRtMTl8SYg (button) (small blind) folded before Flop
Seat 2: EMc5LPgVaded4Qc77vm0fw (big blind) collected ($3)



PokerStars Game #59938162504:  Hold'em No Limit ($0.25/$0.50) - 2009/07/01 0:08:28 ET
Table 'SsXEKOwKN+jE3etfusqUqA' 2-max Seat #2 is the button
Seat 1: 618rKeLrz/avGNOLULHHVQ ($50.75 in chips)
Seat 2: XfRhywXA6Br+jID1oGeo8A ($249.65 in chips)
XfRhywXA6Br+jID1oGeo8A: posts small blind $0.25
618rKeLrz/avGNOLULHHVQ: posts big blind $0.50
*** HOLE CARDS ***
XfRhywXA6Br+jID1oGeo8A: folds
618rKeLrz/avGNOLULHHVQ collected $0.50 from pot
618rKeLrz/avGNOLULHHVQ: doesn't show hand
*** SUMMARY ***
Total pot $0.50 | Rake $0
Seat 1: 618rKeLrz/avGNOLULHHVQ (big blind) collected ($0.50)
Seat 2: XfRhywXA6Br+jID1oGeo8A (button) (small blind) folded before Flop



PokerStars Game #59938162624:  Hold'em No Limit ($0.25/$0.50) - 2009/07/01 0:08:28 ET
Table 'otvGDROEDdqsabxskT79qg' 9-max Seat #7 is the button
Seat 1: LM/g4VPDfD+0JhpH9Q/3fw ($30.70 in chips)
Seat 2: cCjTzH9jio8607WzjcfXlg ($46.60 in chips)
Seat 3: +k7T5ocke8UwavtgUHm+Cg ($52.35 in chips)
Seat 4: MG90wfSJZnOejs/KD3vlQQ ($50 in chips)
Seat 5: YPo1oggovmqSREegekaQYw ($16.80 in chips)
Seat 7: C7+tBppJrKgd/r+tuKUIpA ($38.80 in chips)
Seat 9: KcY3X8YpD74Kw1RHkx/g4A ($38.35 in chips)
WpvT3OUSiZlpvs+mPXFqtQ will be allowed to play after the button
KcY3X8YpD74Kw1RHkx/g4A: posts small blind $0.25
LM/g4VPDfD+0JhpH9Q/3fw: posts big blind $0.50
*** HOLE CARDS ***
cCjTzH9jio8607WzjcfXlg: folds
+k7T5ocke8UwavtgUHm+Cg: folds
MG90wfSJZnOejs/KD3vlQQ: folds
YPo1oggovmqSREegekaQYw: folds
C7+tBppJrKgd/r+tuKUIpA: calls $0.50
KcY3X8YpD74Kw1RHkx/g4A: folds
LM/g4VPDfD+0JhpH9Q/3fw: checks
*** FLOP *** [5c Ah 9h]
LM/g4VPDfD+0JhpH9Q/3fw: bets $0.50
C7+tBppJrKgd/r+tuKUIpA: calls $0.50
*** TURN *** [5c Ah 9h] [2h]
LM/g4VPDfD+0JhpH9Q/3fw: bets $0.50
C7+tBppJrKgd/r+tuKUIpA: calls $0.50
*** RIVER *** [5c Ah 9h 2h] [7d]
LM/g4VPDfD+0JhpH9Q/3fw: bets $0.50
C7+tBppJrKgd/r+tuKUIpA: calls $0.50
*** SHOW DOWN ***
LM/g4VPDfD+0JhpH9Q/3fw: shows [9c Th] (a pair of Nines)
C7+tBppJrKgd/r+tuKUIpA: shows [Ac Jd] (a pair of Aces)
C7+tBppJrKgd/r+tuKUIpA collected $4.05 from pot
*** SUMMARY ***
Total pot $4.25 | Rake $0.20
Board [5c Ah 9h 2h 7d]
Seat 1: LM/g4VPDfD+0JhpH9Q/3fw (big blind) showed [9c Th] and lost with a pair of Nines
Seat 2: cCjTzH9jio8607WzjcfXlg folded before Flop (didn't bet)
Seat 3: +k7T5ocke8UwavtgUHm+Cg folded before Flop (didn't bet)
Seat 4: MG90wfSJZnOejs/KD3vlQQ folded before Flop (didn't bet)
Seat 5: YPo1oggovmqSREegekaQYw folded before Flop (didn't bet)
Seat 7: C7+tBppJrKgd/r+tuKUIpA (button) showed [Ac Jd] and won ($4.05) with a pair of Aces
Seat 9: KcY3X8YpD74Kw1RHkx/g4A (small blind) folded before Flop



PokerStars Game #59938164656:  Hold'em No Limit ($0.25/$0.50) - 2009/07/01 0:08:31 ET
Table '+dXkOAQyS8j9PQZusUTMpg' 2-max Seat #1 is the button
Seat 1: XFa6sBGjP2gxoIvxR3fZIg ($70.15 in chips)
Seat 2: 5IBeOgaApY1Bvzv2P8X4EA ($43.70 in chips)
XFa6sBGjP2gxoIvxR3fZIg: posts small blind $0.25
5IBeOgaApY1Bvzv2P8X4EA: posts big blind $0.50
*** HOLE CARDS ***
XFa6sBGjP2gxoIvxR3fZIg: raises $1 to $1.50
5IBeOgaApY1Bvzv2P8X4EA: calls $1
*** FLOP *** [4d Jh 9s]
5IBeOgaApY1Bvzv2P8X4EA: bets $1.50
XFa6sBGjP2gxoIvxR3fZIg: calls $1.50
*** TURN *** [4d Jh 9s] [7s]
5IBeOgaApY1Bvzv2P8X4EA: bets $3.50
XFa6sBGjP2gxoIvxR3fZIg: raises $8 to $11.50
5IBeOgaApY1Bvzv2P8X4EA: folds
XFa6sBGjP2gxoIvxR3fZIg collected $12.50 from pot
XFa6sBGjP2gxoIvxR3fZIg: doesn't show hand
*** SUMMARY ***
Total pot $13 | Rake $0.50
Board [4d Jh 9s 7s]
Seat 1: XFa6sBGjP2gxoIvxR3fZIg (button) (small blind) collected ($12.50)
Seat 2: 5IBeOgaApY1Bvzv2P8X4EA (big blind) folded on the Turn



PokerStars Game #59938164716:  Hold'em No Limit ($0.25/$0.50) - 2009/07/01 0:08:31 ET
Table 'Nz0Vr7WMHL2g5Uk7dDZjpw' 9-max Seat #8 is the button
Seat 1: tLkxo7JgV+WWI0UBw44K5A ($105.60 in chips)
Seat 2: YPo1oggovmqSREegekaQYw ($21.35 in chips)
Seat 3: 4QTiNH5fteLgJjx/s6Hy6A ($16.35 in chips)
Seat 4: 5JJVDlaiMnB004o/RqbZZQ ($27.75 in chips)
Seat 5: WGW0DgjBUXs1ylURHG8vnQ ($18.90 in chips)
Seat 6: k1f0lS7tlMHCLGs0JT34Tg ($9.25 in chips)
Seat 7: KPLH0gELgFe2OuAnhJFI5w ($24.95 in chips)
Seat 8: HkZI6g4zl83TDTA7SRspmQ ($18.75 in chips)
Seat 9: Ak2W6V2TDVIQrvSAy4eD7Q ($8.70 in chips)
Ak2W6V2TDVIQrvSAy4eD7Q: posts small blind $0.25
tLkxo7JgV+WWI0UBw44K5A: posts big blind $0.50
*** HOLE CARDS ***
YPo1oggovmqSREegekaQYw: folds
4QTiNH5fteLgJjx/s6Hy6A: folds
5JJVDlaiMnB004o/RqbZZQ: folds
WGW0DgjBUXs1ylURHG8vnQ: calls $0.50
k1f0lS7tlMHCLGs0JT34Tg: folds
KPLH0gELgFe2OuAnhJFI5w: calls $0.50
HkZI6g4zl83TDTA7SRspmQ: folds
Ak2W6V2TDVIQrvSAy4eD7Q: calls $0.25
tLkxo7JgV+WWI0UBw44K5A: checks
*** FLOP *** [2s 5c 4s]
Ak2W6V2TDVIQrvSAy4eD7Q: bets $8
tLkxo7JgV+WWI0UBw44K5A: folds
WGW0DgjBUXs1ylURHG8vnQ: folds
KPLH0gELgFe2OuAnhJFI5w: folds
Ak2W6V2TDVIQrvSAy4eD7Q collected $1.90 from pot
*** SUMMARY ***
Total pot $2 | Rake $0.10
Board [2s 5c 4s]
Seat 1: tLkxo7JgV+WWI0UBw44K5A (big blind) folded on the Flop
Seat 2: YPo1oggovmqSREegekaQYw folded before Flop (didn't bet)
Seat 3: 4QTiNH5fteLgJjx/s6Hy6A folded before Flop (didn't bet)
Seat 4: 5JJVDlaiMnB004o/RqbZZQ folded before Flop (didn't bet)
Seat 5: WGW0DgjBUXs1ylURHG8vnQ folded on the Flop
Seat 6: k1f0lS7tlMHCLGs0JT34Tg folded before Flop (didn't bet)
Seat 7: KPLH0gELgFe2OuAnhJFI5w folded on the Flop
Seat 8: HkZI6g4zl83TDTA7SRspmQ (button) folded before Flop (didn't bet)
Seat 9: Ak2W6V2TDVIQrvSAy4eD7Q (small blind) collected ($1.90)



PokerStars Game #59938165710:  Hold'em No Limit ($0.25/$0.50) - 2009/07/01 0:08:32 ET
Table 'lSisgp6H7Fg1hH5VfjEjYQ' 9-max Seat #8 is the button
Seat 1: pEW8B6uXbdR47kfljMQ3+Q ($40.45 in chips)
Seat 2: UrcnkQOiLVk8BlKDPJSy7Q ($53.85 in chips)
Seat 3: RjBdQ6w31rgcy0o24VLR6w ($13.15 in chips)
Seat 4: nvw9yQKhJT56lA9k+TLdhw ($11.70 in chips)
Seat 5: mSD1pginDsyHG5PDfqzphw ($10 in chips)
Seat 6: +k7T5ocke8UwavtgUHm+Cg ($18.25 in chips)
Seat 7: xyQ4CeZa3ug3ompz+5xSTg ($73.95 in chips)
Seat 8: bXpVeaSTPBFSPJmeXxO7nw ($19.50 in chips)
Seat 9: 5JJVDlaiMnB004o/RqbZZQ ($38.75 in chips)
5JJVDlaiMnB004o/RqbZZQ: posts small blind $0.25
pEW8B6uXbdR47kfljMQ3+Q: posts big blind $0.50
*** HOLE CARDS ***
UrcnkQOiLVk8BlKDPJSy7Q: folds
RjBdQ6w31rgcy0o24VLR6w: folds
nvw9yQKhJT56lA9k+TLdhw: folds
mSD1pginDsyHG5PDfqzphw: folds
+k7T5ocke8UwavtgUHm+Cg: calls $0.50
xyQ4CeZa3ug3ompz+5xSTg: folds
bXpVeaSTPBFSPJmeXxO7nw: folds
5JJVDlaiMnB004o/RqbZZQ: calls $0.25
pEW8B6uXbdR47kfljMQ3+Q: checks
*** FLOP *** [2d 8s Ah]
5JJVDlaiMnB004o/RqbZZQ: checks
pEW8B6uXbdR47kfljMQ3+Q: checks
+k7T5ocke8UwavtgUHm+Cg: checks
*** TURN *** [2d 8s Ah] [7h]
5JJVDlaiMnB004o/RqbZZQ: checks
pEW8B6uXbdR47kfljMQ3+Q: checks
+k7T5ocke8UwavtgUHm+Cg: checks
*** RIVER *** [2d 8s Ah 7h] [As]
5JJVDlaiMnB004o/RqbZZQ: bets $0.50
pEW8B6uXbdR47kfljMQ3+Q: folds
+k7T5ocke8UwavtgUHm+Cg: folds
5JJVDlaiMnB004o/RqbZZQ collected $1.45 from pot
*** SUMMARY ***
Total pot $1.50 | Rake $0.05
Board [2d 8s Ah 7h As]
Seat 1: pEW8B6uXbdR47kfljMQ3+Q (big blind) folded on the River
Seat 2: UrcnkQOiLVk8BlKDPJSy7Q folded before Flop (didn't bet)
Seat 3: RjBdQ6w31rgcy0o24VLR6w folded before Flop (didn't bet)
Seat 4: nvw9yQKhJT56lA9k+TLdhw folded before Flop (didn't bet)
Seat 5: mSD1pginDsyHG5PDfqzphw folded before Flop (didn't bet)
Seat 6: +k7T5ocke8UwavtgUHm+Cg folded on the River
Seat 7: xyQ4CeZa3ug3ompz+5xSTg folded before Flop (didn't bet)
Seat 8: bXpVeaSTPBFSPJmeXxO7nw (button) folded before Flop (didn't bet)
Seat 9: 5JJVDlaiMnB004o/RqbZZQ (small blind) collected ($1.45)



PokerStars Game #59938166252:  Hold'em No Limit ($0.25/$0.50) - 2009/07/01 0:08:33 ET
Table 'lpxYasB1ClBSgTpCCITwhQ' 9-max Seat #9 is the button
Seat 1: ceq82/EkjUd/GFbf0YwGmA ($40.45 in chips)
Seat 3: E2518gp4aFz1+kAgmGqeEg ($10.75 in chips)
Seat 4: k1f0lS7tlMHCLGs0JT34Tg ($13 in chips)
Seat 5: bXpVeaSTPBFSPJmeXxO7nw ($9.25 in chips)
Seat 6: YPo1oggovmqSREegekaQYw ($18.10 in chips)
Seat 7: zE9cVigS2nW/Ljy4K4bUQA ($30 in chips)
Seat 8: o6JyUkbzCDw8tUabqtmnlg ($23.05 in chips)
Seat 9: mSD1pginDsyHG5PDfqzphw ($11 in chips)
ceq82/EkjUd/GFbf0YwGmA: posts small blind $0.25
E2518gp4aFz1+kAgmGqeEg: posts big blind $0.50
*** HOLE CARDS ***
k1f0lS7tlMHCLGs0JT34Tg: folds
bXpVeaSTPBFSPJmeXxO7nw: folds
YPo1oggovmqSREegekaQYw: folds
zE9cVigS2nW/Ljy4K4bUQA: folds
o6JyUkbzCDw8tUabqtmnlg: folds
mSD1pginDsyHG5PDfqzphw: folds
ceq82/EkjUd/GFbf0YwGmA: raises $0.50 to $1
E2518gp4aFz1+kAgmGqeEg: folds
ceq82/EkjUd/GFbf0YwGmA collected $1 from pot
ceq82/EkjUd/GFbf0YwGmA: doesn't show hand
*** SUMMARY ***
Total pot $1 | Rake $0
Seat 1: ceq82/EkjUd/GFbf0YwGmA (small blind) collected ($1)
Seat 3: E2518gp4aFz1+kAgmGqeEg (big blind) folded before Flop
Seat 4: k1f0lS7tlMHCLGs0JT34Tg folded before Flop (didn't bet)
Seat 5: bXpVeaSTPBFSPJmeXxO7nw folded before Flop (didn't bet)
Seat 6: YPo1oggovmqSREegekaQYw folded before Flop (didn't bet)
Seat 7: zE9cVigS2nW/Ljy4K4bUQA folded before Flop (didn't bet)
Seat 8: o6JyUkbzCDw8tUabqtmnlg folded before Flop (didn't bet)
Seat 9: mSD1pginDsyHG5PDfqzphw (button) folded before Flop (didn't bet)



PokerStars Game #59938166936:  Hold'em No Limit ($0.25/$0.50) - 2009/07/01 0:08:34 ET
Table 'EiNh8p/wGJ1FP575iMFnqg' 9-max Seat #9 is the button
Seat 1: r3ZqM1Mi0W3y4hOdssE+Sg ($34.75 in chips)
Seat 2: sSAA879uXOGR+8Mf3zLa6Q ($10 in chips)
Seat 3: GszS/McxOSUnOET7MBoHqA ($70.70 in chips)
Seat 4: pk8aA8qMBEL6zXqSyfVXMA ($80.05 in chips)
Seat 5: M+7+BTmX5vZatHVuoRB1nA ($89 in chips)
Seat 6: YPo1oggovmqSREegekaQYw ($14.20 in chips)
Seat 8: KrPAGRACBg+w0M//SXe8Ag ($10 in chips)
Seat 9: OMwFJ4pF0xk2Ru/AJiFeFw ($72.15 in chips)
r3ZqM1Mi0W3y4hOdssE+Sg: posts small blind $0.25
sSAA879uXOGR+8Mf3zLa6Q: posts big blind $0.50
KrPAGRACBg+w0M//SXe8Ag: posts big blind $0.50
*** HOLE CARDS ***
GszS/McxOSUnOET7MBoHqA: raises $0.50 to $1
pk8aA8qMBEL6zXqSyfVXMA: folds
M+7+BTmX5vZatHVuoRB1nA: folds
YPo1oggovmqSREegekaQYw: calls $1
KrPAGRACBg+w0M//SXe8Ag: calls $0.50
OMwFJ4pF0xk2Ru/AJiFeFw: folds
r3ZqM1Mi0W3y4hOdssE+Sg: folds
sSAA879uXOGR+8Mf3zLa6Q: calls $0.50
*** FLOP *** [Kd 3h 8d]
sSAA879uXOGR+8Mf3zLa6Q: checks
GszS/McxOSUnOET7MBoHqA: checks
YPo1oggovmqSREegekaQYw: bets $2.50
KrPAGRACBg+w0M//SXe8Ag: folds
sSAA879uXOGR+8Mf3zLa6Q: folds
GszS/McxOSUnOET7MBoHqA: folds
YPo1oggovmqSREegekaQYw collected $4.05 from pot
YPo1oggovmqSREegekaQYw: doesn't show hand
*** SUMMARY ***
Total pot $4.25 | Rake $0.20
Board [Kd 3h 8d]
Seat 1: r3ZqM1Mi0W3y4hOdssE+Sg (small blind) folded before Flop
Seat 2: sSAA879uXOGR+8Mf3zLa6Q (big blind) folded on the Flop
Seat 3: GszS/McxOSUnOET7MBoHqA folded on the Flop
Seat 4: pk8aA8qMBEL6zXqSyfVXMA folded before Flop (didn't bet)
Seat 5: M+7+BTmX5vZatHVuoRB1nA folded before Flop (didn't bet)
Seat 6: YPo1oggovmqSREegekaQYw collected ($4.05)
Seat 8: KrPAGRACBg+w0M//SXe8Ag folded on the Flop
Seat 9: OMwFJ4pF0xk2Ru/AJiFeFw (button) folded before Flop (didn't bet)



PokerStars Game #59938166726:  Hold'em No Limit ($0.25/$0.50) - 2009/07/01 0:08:34 ET
Table '3FhG0gl3kMX3wBEEqj+wnQ' 9-max Seat #9 is the button
Seat 1: e0J9pdCNUDTCG031RnXqLA ($24.50 in chips)
Seat 2: 4dl3YNqZ6Houm2jZAzDmRg ($27.75 in chips)
Seat 3: bXpVeaSTPBFSPJmeXxO7nw ($10.75 in chips)
Seat 4: bz4LMfV0GGl/MJ/ABXuPmg ($18.90 in chips)
Seat 6: 5JJVDlaiMnB004o/RqbZZQ ($26.75 in chips)
Seat 7: 6XkTu4ahxzHnvjjc1R8YjQ ($9.25 in chips)
Seat 8: j3K/Jujr7PY4ZM2RZvlH6A ($52.95 in chips)
Seat 9: tzoXBDwkkPV/XPJPkf963Q ($13.10 in chips)
e0J9pdCNUDTCG031RnXqLA: posts small blind $0.25
4dl3YNqZ6Houm2jZAzDmRg: posts big blind $0.50
XNMDwbXt/Q4jM99AXnbJDw: sits out
*** HOLE CARDS ***
bXpVeaSTPBFSPJmeXxO7nw: folds
bz4LMfV0GGl/MJ/ABXuPmg: calls $0.50
5JJVDlaiMnB004o/RqbZZQ: folds
6XkTu4ahxzHnvjjc1R8YjQ: folds
j3K/Jujr7PY4ZM2RZvlH6A: raises $1.50 to $2
tzoXBDwkkPV/XPJPkf963Q: folds
e0J9pdCNUDTCG031RnXqLA: folds
4dl3YNqZ6Houm2jZAzDmRg: folds
bz4LMfV0GGl/MJ/ABXuPmg: calls $1.50
*** FLOP *** [Js 7s Tc]
bz4LMfV0GGl/MJ/ABXuPmg: checks
j3K/Jujr7PY4ZM2RZvlH6A: bets $3.50
bz4LMfV0GGl/MJ/ABXuPmg: folds
j3K/Jujr7PY4ZM2RZvlH6A collected $4.55 from pot
j3K/Jujr7PY4ZM2RZvlH6A: doesn't show hand
*** SUMMARY ***
Total pot $4.75 | Rake $0.20
Board [Js 7s Tc]
Seat 1: e0J9pdCNUDTCG031RnXqLA (small blind) folded before Flop
Seat 2: 4dl3YNqZ6Houm2jZAzDmRg (big blind) folded before Flop
Seat 3: bXpVeaSTPBFSPJmeXxO7nw folded before Flop (didn't bet)
Seat 4: bz4LMfV0GGl/MJ/ABXuPmg folded on the Flop
Seat 6: 5JJVDlaiMnB004o/RqbZZQ folded before Flop (didn't bet)
Seat 7: 6XkTu4ahxzHnvjjc1R8YjQ folded before Flop (didn't bet)
Seat 8: j3K/Jujr7PY4ZM2RZvlH6A collected ($4.55)
Seat 9: tzoXBDwkkPV/XPJPkf963Q (button) folded before Flop (didn't bet)



PokerStars Game #59938166774:  Hold'em No Limit ($0.25/$0.50) - 2009/07/01 0:08:34 ET
Table 'SsXEKOwKN+jE3etfusqUqA' 2-max Seat #1 is the button
Seat 1: 618rKeLrz/avGNOLULHHVQ ($51 in chips)
Seat 2: XfRhywXA6Br+jID1oGeo8A ($249.40 in chips)
618rKeLrz/avGNOLULHHVQ: posts small blind $0.25
XfRhywXA6Br+jID1oGeo8A: posts big blind $0.50
*** HOLE CARDS ***
618rKeLrz/avGNOLULHHVQ: raises $1 to $1.50
XfRhywXA6Br+jID1oGeo8A said, "gotta go to bed but ur so easy money"
XfRhywXA6Br+jID1oGeo8A: folds
618rKeLrz/avGNOLULHHVQ said, "no please"
618rKeLrz/avGNOLULHHVQ collected $1 from pot
618rKeLrz/avGNOLULHHVQ: doesn't show hand
*** SUMMARY ***
Total pot $1 | Rake $0
Seat 1: 618rKeLrz/avGNOLULHHVQ (button) (small blind) collected ($1)
Seat 2: XfRhywXA6Br+jID1oGeo8A (big blind) folded before Flop



PokerStars Game #59938167826:  Hold'em No Limit ($0.25/$0.50) - 2009/07/01 0:08:35 ET
Table 'c/CRn+68J3Y8KxD5g1ek2Q' 2-max Seat #1 is the button
Seat 1: 46qCyJ6evTkHo9al5sBMNA ($313.55 in chips)
Seat 2: BypVLsYQt3ePFm2xQL/dOA ($73.60 in chips)
46qCyJ6evTkHo9al5sBMNA: posts small blind $0.25
BypVLsYQt3ePFm2xQL/dOA: posts big blind $0.50
*** HOLE CARDS ***
46qCyJ6evTkHo9al5sBMNA: raises $1 to $1.50
BypVLsYQt3ePFm2xQL/dOA: calls $1
*** FLOP *** [Td Kh Ac]
BypVLsYQt3ePFm2xQL/dOA: bets $1.50
46qCyJ6evTkHo9al5sBMNA: calls $1.50
*** TURN *** [Td Kh Ac] [5d]
BypVLsYQt3ePFm2xQL/dOA: bets $2.50
46qCyJ6evTkHo9al5sBMNA: folds
BypVLsYQt3ePFm2xQL/dOA collected $5.75 from pot
BypVLsYQt3ePFm2xQL/dOA: doesn't show hand
*** SUMMARY ***
Total pot $6 | Rake $0.25
Board [Td Kh Ac 5d]
Seat 1: 46qCyJ6evTkHo9al5sBMNA (button) (small blind) folded on the Turn
Seat 2: BypVLsYQt3ePFm2xQL/dOA (big blind) collected ($5.75)



PokerStars Game #59938168396:  Hold'em No Limit ($0.25/$0.50) - 2009/07/01 0:08:36 ET
Table 'E7bWJ45aoFXRpyRv2gw+Ig' 2-max Seat #2 is the button
Seat 1: FRkiRasEGlHUeLrEl+k/nA ($75.55 in chips)
Seat 2: 3Wro85I7472vJ4Wkpneo9A ($48.60 in chips)
3Wro85I7472vJ4Wkpneo9A: posts small blind $0.25
FRkiRasEGlHUeLrEl+k/nA: posts big blind $0.50
*** HOLE CARDS ***
3Wro85I7472vJ4Wkpneo9A: calls $0.25
FRkiRasEGlHUeLrEl+k/nA: checks
*** FLOP *** [Kd 7h 5h]
FRkiRasEGlHUeLrEl+k/nA: checks
3Wro85I7472vJ4Wkpneo9A: checks
*** TURN *** [Kd 7h 5h] [Kc]
FRkiRasEGlHUeLrEl+k/nA: checks
3Wro85I7472vJ4Wkpneo9A: bets $1
FRkiRasEGlHUeLrEl+k/nA: calls $1
*** RIVER *** [Kd 7h 5h Kc] [6h]
FRkiRasEGlHUeLrEl+k/nA: checks
3Wro85I7472vJ4Wkpneo9A: bets $2.50
FRkiRasEGlHUeLrEl+k/nA: folds
3Wro85I7472vJ4Wkpneo9A collected $2.90 from pot
3Wro85I7472vJ4Wkpneo9A: doesn't show hand
*** SUMMARY ***
Total pot $3 | Rake $0.10
Board [Kd 7h 5h Kc 6h]
Seat 1: FRkiRasEGlHUeLrEl+k/nA (big blind) folded on the River
Seat 2: 3Wro85I7472vJ4Wkpneo9A (button) (small blind) collected ($2.90)



PokerStars Game #59938170030:  Hold'em No Limit ($0.25/$0.50) - 2009/07/01 0:08:38 ET
Table 'tyR5AZNKV8Aadbrnrnlg7g' 6-max Seat #3 is the button
Seat 1: R+KjpH/wSjDLhtIy9+edNA ($36.25 in chips)
Seat 2: 58zdeSBSuSFX/qZfhc7YmA ($32.20 in chips)
Seat 3: jUhx+m+V7qfbLZTjgwZByg ($44 in chips)
Seat 4: Rt6KgtZ8YaJoTc3FPim00w ($50 in chips)
Seat 5: EIg3r3fRFKG2HhgpDlIJHg ($29.20 in chips)
Seat 6: DMQLAmut/l19xN5STQndFg ($3.45 in chips)
Rt6KgtZ8YaJoTc3FPim00w: posts small blind $0.25
EIg3r3fRFKG2HhgpDlIJHg: posts big blind $0.50
*** HOLE CARDS ***
DMQLAmut/l19xN5STQndFg: calls $0.50
R+KjpH/wSjDLhtIy9+edNA: folds
58zdeSBSuSFX/qZfhc7YmA: folds
jUhx+m+V7qfbLZTjgwZByg: calls $0.50
Rt6KgtZ8YaJoTc3FPim00w: folds
EIg3r3fRFKG2HhgpDlIJHg: checks
*** FLOP *** [6h Ad Qh]
EIg3r3fRFKG2HhgpDlIJHg: checks
DMQLAmut/l19xN5STQndFg: bets $2.95 and is all-in
jUhx+m+V7qfbLZTjgwZByg: calls $2.95
EIg3r3fRFKG2HhgpDlIJHg: folds
*** TURN *** [6h Ad Qh] [2d]
*** RIVER *** [6h Ad Qh 2d] [6s]
*** SHOW DOWN ***
DMQLAmut/l19xN5STQndFg: shows [Jd 7d] (a pair of Sixes)
jUhx+m+V7qfbLZTjgwZByg: shows [4h Ah] (two pair, Aces and Sixes)
jUhx+m+V7qfbLZTjgwZByg collected $7.30 from pot
*** SUMMARY ***
Total pot $7.65 | Rake $0.35
Board [6h Ad Qh 2d 6s]
Seat 1: R+KjpH/wSjDLhtIy9+edNA folded before Flop (didn't bet)
Seat 2: 58zdeSBSuSFX/qZfhc7YmA folded before Flop (didn't bet)
Seat 3: jUhx+m+V7qfbLZTjgwZByg (button) showed [4h Ah] and won ($7.30) with two pair, Aces and Sixes
Seat 4: Rt6KgtZ8YaJoTc3FPim00w (small blind) folded before Flop
Seat 5: EIg3r3fRFKG2HhgpDlIJHg (big blind) folded on the Flop
Seat 6: DMQLAmut/l19xN5STQndFg showed [Jd 7d] and lost with a pair of Sixes



PokerStars Game #59938171080:  Hold'em No Limit ($0.25/$0.50) - 2009/07/01 0:08:40 ET
Table 'hSTs/dUsYLgJQuF2Onp0MQ' 6-max Seat #1 is the button
Seat 1: lWwl5C/UZOsWNubdUqghZw ($70.70 in chips)
Seat 2: fyJOjf+Vdie/rpWb1WExIg ($17.05 in chips)
Seat 3: vQOrJuXbLC3UZDVklY9bOA ($11.45 in chips)
Seat 4: L0aIPg7qefDQjdJo3HCVEA ($14.45 in chips)
Seat 5: 686aeHikcJlgKkSuIFdcXQ ($60.65 in chips)
Seat 6: +laPa9P7BjZKKnR0n+OmvA ($12 in chips)
fyJOjf+Vdie/rpWb1WExIg: posts small blind $0.25
vQOrJuXbLC3UZDVklY9bOA: posts big blind $0.50
*** HOLE CARDS ***
L0aIPg7qefDQjdJo3HCVEA: folds
686aeHikcJlgKkSuIFdcXQ: folds
+laPa9P7BjZKKnR0n+OmvA: raises $1 to $1.50
lWwl5C/UZOsWNubdUqghZw: folds
fyJOjf+Vdie/rpWb1WExIg: folds
vQOrJuXbLC3UZDVklY9bOA: calls $1
*** FLOP *** [7c Kc Ad]
vQOrJuXbLC3UZDVklY9bOA: checks
+laPa9P7BjZKKnR0n+OmvA: bets $3.50
vQOrJuXbLC3UZDVklY9bOA: raises $6.45 to $9.95 and is all-in
+laPa9P7BjZKKnR0n+OmvA: calls $6.45
*** TURN *** [7c Kc Ad] [9d]
*** RIVER *** [7c Kc Ad 9d] [Jh]
*** SHOW DOWN ***
vQOrJuXbLC3UZDVklY9bOA: shows [Ah Qc] (a pair of Aces)
+laPa9P7BjZKKnR0n+OmvA: mucks hand
vQOrJuXbLC3UZDVklY9bOA collected $22 from pot
*** SUMMARY ***
Total pot $23.15 | Rake $1.15
Board [7c Kc Ad 9d Jh]
Seat 1: lWwl5C/UZOsWNubdUqghZw (button) folded before Flop (didn't bet)
Seat 2: fyJOjf+Vdie/rpWb1WExIg (small blind) folded before Flop
Seat 3: vQOrJuXbLC3UZDVklY9bOA (big blind) showed [Ah Qc] and won ($22) with a pair of Aces
Seat 4: L0aIPg7qefDQjdJo3HCVEA folded before Flop (didn't bet)
Seat 5: 686aeHikcJlgKkSuIFdcXQ folded before Flop (didn't bet)
Seat 6: +laPa9P7BjZKKnR0n+OmvA mucked



PokerStars Game #59938171746:  Hold'em No Limit ($0.25/$0.50) - 2009/07/01 0:08:41 ET
Table 'm95HVfesC/VPgfGEjPuaIA' 2-max Seat #1 is the button
Seat 1: Fp/oksNpipCrD2MJ2pH20g ($10.60 in chips)
Seat 2: iY+tB5vLpLxiq0ifAZ7TNQ ($18.60 in chips)
Fp/oksNpipCrD2MJ2pH20g: posts small blind $0.25
iY+tB5vLpLxiq0ifAZ7TNQ: posts big blind $0.50
*** HOLE CARDS ***
Fp/oksNpipCrD2MJ2pH20g: folds
iY+tB5vLpLxiq0ifAZ7TNQ collected $0.50 from pot
iY+tB5vLpLxiq0ifAZ7TNQ: shows [2d 3s] (high card Three)
*** SUMMARY ***
Total pot $0.50 | Rake $0
Seat 1: Fp/oksNpipCrD2MJ2pH20g (button) (small blind) folded before Flop
Seat 2: iY+tB5vLpLxiq0ifAZ7TNQ (big blind) collected ($0.50)



PokerStars Game #59938171920:  Hold'em No Limit ($0.25/$0.50) - 2009/07/01 0:08:41 ET
Table '+z1aekfHkpp09pc8F9aViw' 6-max Seat #5 is the button
Seat 1: lWwl5C/UZOsWNubdUqghZw ($50 in chips)
Seat 2: VuB2GN0h94yY+QbuI2Mybg ($16.95 in chips)
Seat 4: OCrv7ObFH4/s2lv7rYOnsQ ($27.20 in chips)
Seat 5: crjGpJEzSZgD38FoE3VMGg ($62.15 in chips)
Seat 6: 686aeHikcJlgKkSuIFdcXQ ($71.50 in chips)
686aeHikcJlgKkSuIFdcXQ: posts small blind $0.25
lWwl5C/UZOsWNubdUqghZw: posts big blind $0.50
*** HOLE CARDS ***
VuB2GN0h94yY+QbuI2Mybg: calls $0.50
OCrv7ObFH4/s2lv7rYOnsQ: folds
crjGpJEzSZgD38FoE3VMGg: folds
686aeHikcJlgKkSuIFdcXQ: folds
lWwl5C/UZOsWNubdUqghZw: checks
*** FLOP *** [4s 6c Jc]
lWwl5C/UZOsWNubdUqghZw: checks
VuB2GN0h94yY+QbuI2Mybg: checks
*** TURN *** [4s 6c Jc] [Jh]
lWwl5C/UZOsWNubdUqghZw: bets $0.75
VuB2GN0h94yY+QbuI2Mybg: folds
lWwl5C/UZOsWNubdUqghZw collected $1.20 from pot
*** SUMMARY ***
Total pot $1.25 | Rake $0.05
Board [4s 6c Jc Jh]
Seat 1: lWwl5C/UZOsWNubdUqghZw (big blind) collected ($1.20)
Seat 2: VuB2GN0h94yY+QbuI2Mybg folded on the Turn
Seat 4: OCrv7ObFH4/s2lv7rYOnsQ folded before Flop (didn't bet)
Seat 5: crjGpJEzSZgD38FoE3VMGg (button) folded before Flop (didn't bet)
Seat 6: 686aeHikcJlgKkSuIFdcXQ (small blind) folded before Flop



PokerStars Game #59938173198:  Hold'em No Limit ($0.25/$0.50) - 2009/07/01 0:08:43 ET
Table 'kgbJRsxfv64KrErDRBAkcw' 6-max Seat #2 is the button
Seat 1: YmWlPGOKFuJSoJZPW8a8IA ($80.55 in chips)
Seat 2: Q+thC23WCv1kJUJtH/+4Jw ($26.10 in chips)
Seat 3: T0Gx/FcQ5VH9u7XaOMX97A ($65.90 in chips)
Seat 4: qanMEqjABjWxC/JgQ/0l7w ($62.20 in chips)
Seat 5: SlTdlH14u+KVVINgxMwt+Q ($65.95 in chips)
Seat 6: DDfYzIrYT0t5R/hAJngtsg ($21.95 in chips)
T0Gx/FcQ5VH9u7XaOMX97A: posts small blind $0.25
qanMEqjABjWxC/JgQ/0l7w: posts big blind $0.50
*** HOLE CARDS ***
SlTdlH14u+KVVINgxMwt+Q: folds
DDfYzIrYT0t5R/hAJngtsg: calls $0.50
SlTdlH14u+KVVINgxMwt+Q leaves the table
+Pf9jTVizYlIo+woPvptfA joins the table at seat #5
YmWlPGOKFuJSoJZPW8a8IA: folds
Q+thC23WCv1kJUJtH/+4Jw: calls $0.50
T0Gx/FcQ5VH9u7XaOMX97A: calls $0.25
qanMEqjABjWxC/JgQ/0l7w: checks
*** FLOP *** [Ah Jd Ks]
T0Gx/FcQ5VH9u7XaOMX97A: checks
qanMEqjABjWxC/JgQ/0l7w: checks
DDfYzIrYT0t5R/hAJngtsg: checks
Q+thC23WCv1kJUJtH/+4Jw: bets $1
T0Gx/FcQ5VH9u7XaOMX97A: folds
qanMEqjABjWxC/JgQ/0l7w: folds
DDfYzIrYT0t5R/hAJngtsg: folds
Q+thC23WCv1kJUJtH/+4Jw collected $1.90 from pot
*** SUMMARY ***
Total pot $2 | Rake $0.10
Board [Ah Jd Ks]
Seat 1: YmWlPGOKFuJSoJZPW8a8IA folded before Flop (didn't bet)
Seat 2: Q+thC23WCv1kJUJtH/+4Jw (button) collected ($1.90)
Seat 3: T0Gx/FcQ5VH9u7XaOMX97A (small blind) folded on the Flop
Seat 4: qanMEqjABjWxC/JgQ/0l7w (big blind) folded on the Flop
Seat 5: SlTdlH14u+KVVINgxMwt+Q folded before Flop (didn't bet)
Seat 6: DDfYzIrYT0t5R/hAJngtsg folded on the Flop



PokerStars Game #59938173686:  Hold'em No Limit ($0.25/$0.50) - 2009/07/01 0:08:44 ET
Table 'mTxf8gPLgffN3Iwfm7Icfg' 2-max Seat #2 is the button
Seat 1: Do9Rlu1R5u/AcRtMTl8SYg ($68.55 in chips)
Seat 2: EMc5LPgVaded4Qc77vm0fw ($45.70 in chips)
EMc5LPgVaded4Qc77vm0fw: posts small blind $0.25
Do9Rlu1R5u/AcRtMTl8SYg: posts big blind $0.50
*** HOLE CARDS ***
EMc5LPgVaded4Qc77vm0fw: raises $1 to $1.50
Do9Rlu1R5u/AcRtMTl8SYg: folds
EMc5LPgVaded4Qc77vm0fw collected $1 from pot
EMc5LPgVaded4Qc77vm0fw: doesn't show hand
*** SUMMARY ***
Total pot $1 | Rake $0
Seat 1: Do9Rlu1R5u/AcRtMTl8SYg (big blind) folded before Flop
Seat 2: EMc5LPgVaded4Qc77vm0fw (button) (small blind) collected ($1)



PokerStars Game #59938174292:  Hold'em No Limit ($0.25/$0.50) - 2009/07/01 0:08:44 ET
Table 'QOgaEqMcJ73pcUMMxoisUg' 6-max Seat #3 is the button
Seat 1: RFefXIDyFvNtJLq+CloCzA ($43.20 in chips)
Seat 3: wUZNozoIDYf+16hp4nn6dw ($40.90 in chips)
Seat 4: zAcsDhG/T128Vn7XGVSgKg ($50 in chips)
Seat 5: HoaSQCRso+nEyO5DUhGduw ($57.75 in chips)
Seat 6: s83dnhZ6VC53vY0/f6OV/g ($47.80 in chips)
zAcsDhG/T128Vn7XGVSgKg: posts small blind $0.25
HoaSQCRso+nEyO5DUhGduw: posts big blind $0.50
Im2p1Nt83UKSqv5c9frm4Q: sits out
*** HOLE CARDS ***
s83dnhZ6VC53vY0/f6OV/g: raises $1.50 to $2
RFefXIDyFvNtJLq+CloCzA: folds
wUZNozoIDYf+16hp4nn6dw: folds
zAcsDhG/T128Vn7XGVSgKg: folds
HoaSQCRso+nEyO5DUhGduw: folds
s83dnhZ6VC53vY0/f6OV/g collected $1.25 from pot
*** SUMMARY ***
Total pot $1.25 | Rake $0
Seat 1: RFefXIDyFvNtJLq+CloCzA folded before Flop (didn't bet)
Seat 3: wUZNozoIDYf+16hp4nn6dw (button) folded before Flop (didn't bet)
Seat 4: zAcsDhG/T128Vn7XGVSgKg (small blind) folded before Flop
Seat 5: HoaSQCRso+nEyO5DUhGduw (big blind) folded before Flop
Seat 6: s83dnhZ6VC53vY0/f6OV/g collected ($1.25)



PokerStars Game #59938175144:  Hold'em No Limit ($0.25/$0.50) - 2009/07/01 0:08:46 ET
Table 'ibNfFy0bCzuBaUORla0aGw' 9-max Seat #3 is the button
Seat 1: xZCXQSXlrZkp3pZizzVXCw ($56.95 in chips)
Seat 2: 90Wb75h3W1BRpbqVnuk8gw ($50 in chips)
Seat 3: dDaHs3X8+fe3bIkRU0cbrw ($26.30 in chips)
Seat 4: YBN054X4blmis+B2bBlC0g ($21.70 in chips)
Seat 5: FRv75HO8CUsRZ1byEz06mQ ($15.35 in chips)
Seat 6: BmYrv3ec2k5d6pQq6iNaZw ($67.90 in chips)
Seat 7: mSD1pginDsyHG5PDfqzphw ($10 in chips)
Seat 8: xUrN9TWLq4m5V+OXY7KUUA ($50 in chips)
Seat 9: WpvT3OUSiZlpvs+mPXFqtQ ($8.75 in chips)
YBN054X4blmis+B2bBlC0g: posts small blind $0.25
FRv75HO8CUsRZ1byEz06mQ: posts big blind $0.50
*** HOLE CARDS ***
BmYrv3ec2k5d6pQq6iNaZw: folds
mSD1pginDsyHG5PDfqzphw: folds
xUrN9TWLq4m5V+OXY7KUUA: folds
WpvT3OUSiZlpvs+mPXFqtQ: folds
xZCXQSXlrZkp3pZizzVXCw: folds
90Wb75h3W1BRpbqVnuk8gw: folds
dDaHs3X8+fe3bIkRU0cbrw: folds
YBN054X4blmis+B2bBlC0g: folds
FRv75HO8CUsRZ1byEz06mQ collected $0.50 from pot
*** SUMMARY ***
Total pot $0.50 | Rake $0
Seat 1: xZCXQSXlrZkp3pZizzVXCw folded before Flop (didn't bet)
Seat 2: 90Wb75h3W1BRpbqVnuk8gw folded before Flop (didn't bet)
Seat 3: dDaHs3X8+fe3bIkRU0cbrw (button) folded before Flop (didn't bet)
Seat 4: YBN054X4blmis+B2bBlC0g (small blind) folded before Flop
Seat 5: FRv75HO8CUsRZ1byEz06mQ (big blind) collected ($0.50)
Seat 6: BmYrv3ec2k5d6pQq6iNaZw folded before Flop (didn't bet)
Seat 7: mSD1pginDsyHG5PDfqzphw folded before Flop (didn't bet)
Seat 8: xUrN9TWLq4m5V+OXY7KUUA folded before Flop (didn't bet)
Seat 9: WpvT3OUSiZlpvs+mPXFqtQ folded before Flop (didn't bet)



PokerStars Game #59938175600:  Hold'em No Limit ($0.25/$0.50) - 2009/07/01 0:08:46 ET
Table 'Vdlc9wqYcHTUhtdyN7CuJw' 2-max Seat #2 is the button
Seat 1: yBO+mXB6m/rCft2ErwGf/Q ($90.80 in chips)
Seat 2: sa0qgETiL3HNbdfGlnKHTA ($22.30 in chips)
sa0qgETiL3HNbdfGlnKHTA: posts small blind $0.25
yBO+mXB6m/rCft2ErwGf/Q: posts big blind $0.50
*** HOLE CARDS ***
sa0qgETiL3HNbdfGlnKHTA: raises $0.50 to $1
yBO+mXB6m/rCft2ErwGf/Q: calls $0.50
*** FLOP *** [8c Qd 6h]
yBO+mXB6m/rCft2ErwGf/Q: checks
sa0qgETiL3HNbdfGlnKHTA: checks
*** TURN *** [8c Qd 6h] [Qh]
yBO+mXB6m/rCft2ErwGf/Q: bets $1.50
sa0qgETiL3HNbdfGlnKHTA: calls $1.50
*** RIVER *** [8c Qd 6h Qh] [9c]
yBO+mXB6m/rCft2ErwGf/Q: bets $1.50
sa0qgETiL3HNbdfGlnKHTA: calls $1.50
*** SHOW DOWN ***
yBO+mXB6m/rCft2ErwGf/Q: shows [9d 8s] (two pair, Queens and Nines)
sa0qgETiL3HNbdfGlnKHTA: mucks hand
yBO+mXB6m/rCft2ErwGf/Q collected $7.65 from pot
*** SUMMARY ***
Total pot $8 | Rake $0.35
Board [8c Qd 6h Qh 9c]
Seat 1: yBO+mXB6m/rCft2ErwGf/Q (big blind) showed [9d 8s] and won ($7.65) with two pair, Queens and Nines
Seat 2: sa0qgETiL3HNbdfGlnKHTA (button) (small blind) mucked



PokerStars Game #59938176378:  Hold'em No Limit ($0.25/$0.50) - 2009/07/01 0:08:47 ET
Table 'm95HVfesC/VPgfGEjPuaIA' 2-max Seat #2 is the button
Seat 1: Fp/oksNpipCrD2MJ2pH20g ($10.35 in chips)
Seat 2: iY+tB5vLpLxiq0ifAZ7TNQ ($18.85 in chips)
iY+tB5vLpLxiq0ifAZ7TNQ: posts small blind $0.25
Fp/oksNpipCrD2MJ2pH20g: posts big blind $0.50
*** HOLE CARDS ***
iY+tB5vLpLxiq0ifAZ7TNQ: folds
Fp/oksNpipCrD2MJ2pH20g collected $0.50 from pot
Fp/oksNpipCrD2MJ2pH20g: doesn't show hand
*** SUMMARY ***
Total pot $0.50 | Rake $0
Seat 1: Fp/oksNpipCrD2MJ2pH20g (big blind) collected ($0.50)
Seat 2: iY+tB5vLpLxiq0ifAZ7TNQ (button) (small blind) folded before Flop



PokerStars Game #59938176128:  Hold'em No Limit ($0.25/$0.50) - 2009/07/01 0:08:47 ET
Table 'SsXEKOwKN+jE3etfusqUqA' 2-max Seat #2 is the button
Seat 1: 618rKeLrz/avGNOLULHHVQ ($51.50 in chips)
Seat 2: XfRhywXA6Br+jID1oGeo8A ($248.90 in chips)
XfRhywXA6Br+jID1oGeo8A: posts small blind $0.25
618rKeLrz/avGNOLULHHVQ: posts big blind $0.50
*** HOLE CARDS ***
618rKeLrz/avGNOLULHHVQ said, "dont u dare hit and run"
XfRhywXA6Br+jID1oGeo8A: folds
618rKeLrz/avGNOLULHHVQ said, "uve been lucky :/"
618rKeLrz/avGNOLULHHVQ collected $0.50 from pot
618rKeLrz/avGNOLULHHVQ: doesn't show hand
*** SUMMARY ***
Total pot $0.50 | Rake $0
Seat 1: 618rKeLrz/avGNOLULHHVQ (big blind) collected ($0.50)
Seat 2: XfRhywXA6Br+jID1oGeo8A (button) (small blind) folded before Flop



PokerStars Game #59938176508:  Hold'em No Limit ($0.25/$0.50) - 2009/07/01 0:08:47 ET
Table 'tpZbcIvqh/6WmfR/i5IE3A' 9-max Seat #3 is the button
Seat 1: nV/P1jFY/CFMXOLWu7pYmA ($13.70 in chips)
Seat 2: M+7+BTmX5vZatHVuoRB1nA ($42.90 in chips)
Seat 3: 3w0FbBQAKwQODwenKwZxXw ($77.70 in chips)
Seat 4: zE9cVigS2nW/Ljy4K4bUQA ($30.25 in chips)
Seat 5: 9r7ZoBbAJj5IeyZ0q9BdzA ($12.90 in chips)
Seat 6: E2518gp4aFz1+kAgmGqeEg ($11.20 in chips)
Seat 7: wIZ377kjl2fHFGnS93o6bw ($17.15 in chips)
Seat 8: bXpVeaSTPBFSPJmeXxO7nw ($9.85 in chips)
zE9cVigS2nW/Ljy4K4bUQA: posts small blind $0.25
9r7ZoBbAJj5IeyZ0q9BdzA: posts big blind $0.50
*** HOLE CARDS ***
E2518gp4aFz1+kAgmGqeEg: folds
wIZ377kjl2fHFGnS93o6bw: folds
bXpVeaSTPBFSPJmeXxO7nw: folds
nV/P1jFY/CFMXOLWu7pYmA: folds
M+7+BTmX5vZatHVuoRB1nA: folds
3w0FbBQAKwQODwenKwZxXw: calls $0.50
zE9cVigS2nW/Ljy4K4bUQA: folds
9r7ZoBbAJj5IeyZ0q9BdzA: checks
*** FLOP *** [8d 6h Jd]
9r7ZoBbAJj5IeyZ0q9BdzA: checks
3w0FbBQAKwQODwenKwZxXw: checks
*** TURN *** [8d 6h Jd] [Jh]
9r7ZoBbAJj5IeyZ0q9BdzA: checks
3w0FbBQAKwQODwenKwZxXw: bets $1
9r7ZoBbAJj5IeyZ0q9BdzA: folds
3w0FbBQAKwQODwenKwZxXw collected $1.20 from pot
*** SUMMARY ***
Total pot $1.25 | Rake $0.05
Board [8d 6h Jd Jh]
Seat 1: nV/P1jFY/CFMXOLWu7pYmA folded before Flop (didn't bet)
Seat 2: M+7+BTmX5vZatHVuoRB1nA folded before Flop (didn't bet)
Seat 3: 3w0FbBQAKwQODwenKwZxXw (button) collected ($1.20)
Seat 4: zE9cVigS2nW/Ljy4K4bUQA (small blind) folded before Flop
Seat 5: 9r7ZoBbAJj5IeyZ0q9BdzA (big blind) folded on the Turn
Seat 6: E2518gp4aFz1+kAgmGqeEg folded before Flop (didn't bet)
Seat 7: wIZ377kjl2fHFGnS93o6bw folded before Flop (didn't bet)
Seat 8: bXpVeaSTPBFSPJmeXxO7nw folded before Flop (didn't bet)



PokerStars Game #59938176474:  Hold'em No Limit ($0.25/$0.50) - 2009/07/01 0:08:47 ET
Table 'BCN5su+SsXiy1zRMJi0SJw' 6-max Seat #2 is the button
Seat 1: WyeokAqR0q9nADSkWpbxHw ($40.65 in chips)
Seat 2: QfV2JJlmEKgD5jYPV+a33A ($159.65 in chips)
Seat 3: L309C3uyA1tkWSOh/QvjHw ($20.25 in chips)
Seat 4: 6Wb8PlO2kM4fnSim7p4Mrw ($15.30 in chips)
Seat 5: TTx3CHxyi0SObcHyMJRp5w ($34 in chips)
L309C3uyA1tkWSOh/QvjHw: posts small blind $0.25
6Wb8PlO2kM4fnSim7p4Mrw: posts big blind $0.50
*** HOLE CARDS ***
TTx3CHxyi0SObcHyMJRp5w: folds
WyeokAqR0q9nADSkWpbxHw: folds
QfV2JJlmEKgD5jYPV+a33A: folds
L309C3uyA1tkWSOh/QvjHw: calls $0.25
6Wb8PlO2kM4fnSim7p4Mrw: checks
*** FLOP *** [Ac 6h Qs]
L309C3uyA1tkWSOh/QvjHw: bets $0.50
6Wb8PlO2kM4fnSim7p4Mrw: folds
L309C3uyA1tkWSOh/QvjHw collected $0.95 from pot
*** SUMMARY ***
Total pot $1 | Rake $0.05
Board [Ac 6h Qs]
Seat 1: WyeokAqR0q9nADSkWpbxHw folded before Flop (didn't bet)
Seat 2: QfV2JJlmEKgD5jYPV+a33A (button) folded before Flop (didn't bet)
Seat 3: L309C3uyA1tkWSOh/QvjHw (small blind) collected ($0.95)
Seat 4: 6Wb8PlO2kM4fnSim7p4Mrw (big blind) folded on the Flop
Seat 5: TTx3CHxyi0SObcHyMJRp5w folded before Flop (didn't bet)



PokerStars Game #59938179326:  Hold'em No Limit ($0.25/$0.50) - 2009/07/01 0:08:51 ET
Table 'eMxdLyFDf28E0wit6gm3Uw' 6-max Seat #5 is the button
Seat 1: tnD/64LagZ9qPaeOQVjVZg ($11.50 in chips)
Seat 2: jwuKQ1S3U4NnzMQn3E3dgw ($65.15 in chips)
Seat 4: crjGpJEzSZgD38FoE3VMGg ($50.50 in chips)
Seat 5: X0X97o2fDAPiGx6o1gahsw ($58.05 in chips)
Seat 6: L0aIPg7qefDQjdJo3HCVEA ($7 in chips)
L0aIPg7qefDQjdJo3HCVEA: posts small blind $0.25
tnD/64LagZ9qPaeOQVjVZg: posts big blind $0.50
*** HOLE CARDS ***
dZcLsEI8iXkobBduRJ45Yw joins the table at seat #3
jwuKQ1S3U4NnzMQn3E3dgw: calls $0.50
crjGpJEzSZgD38FoE3VMGg: folds
X0X97o2fDAPiGx6o1gahsw: folds
L0aIPg7qefDQjdJo3HCVEA: folds
tnD/64LagZ9qPaeOQVjVZg: checks
*** FLOP *** [Jh 3c 8d]
tnD/64LagZ9qPaeOQVjVZg: checks
jwuKQ1S3U4NnzMQn3E3dgw: checks
*** TURN *** [Jh 3c 8d] [Qd]
tnD/64LagZ9qPaeOQVjVZg: bets $2
jwuKQ1S3U4NnzMQn3E3dgw: folds
tnD/64LagZ9qPaeOQVjVZg collected $1.20 from pot
*** SUMMARY ***
Total pot $1.25 | Rake $0.05
Board [Jh 3c 8d Qd]
Seat 1: tnD/64LagZ9qPaeOQVjVZg (big blind) collected ($1.20)
Seat 2: jwuKQ1S3U4NnzMQn3E3dgw folded on the Turn
Seat 4: crjGpJEzSZgD38FoE3VMGg folded before Flop (didn't bet)
Seat 5: X0X97o2fDAPiGx6o1gahsw (button) folded before Flop (didn't bet)
Seat 6: L0aIPg7qefDQjdJo3HCVEA (small blind) folded before Flop



PokerStars Game #59938179040:  Hold'em No Limit ($0.25/$0.50) - 2009/07/01 0:08:51 ET
Table 'raOT4/ipuZgzjfKHC+jD9g' 2-max Seat #1 is the button
Seat 1: IuwLemwLhc9fvrwBGs0AMA ($11.60 in chips)
Seat 2: Udr5juWSWUgTu1NlRhjMdA ($12.15 in chips)
IuwLemwLhc9fvrwBGs0AMA: posts small blind $0.25
Udr5juWSWUgTu1NlRhjMdA: posts big blind $0.50
*** HOLE CARDS ***
IuwLemwLhc9fvrwBGs0AMA: raises $1.50 to $2
Udr5juWSWUgTu1NlRhjMdA: folds
IuwLemwLhc9fvrwBGs0AMA collected $1 from pot
*** SUMMARY ***
Total pot $1 | Rake $0
Seat 1: IuwLemwLhc9fvrwBGs0AMA (button) (small blind) collected ($1)
Seat 2: Udr5juWSWUgTu1NlRhjMdA (big blind) folded before Flop



PokerStars Game #59938180708:  Hold'em No Limit ($0.25/$0.50) - 2009/07/01 0:08:53 ET
Table 'SsXEKOwKN+jE3etfusqUqA' 2-max Seat #1 is the button
Seat 1: 618rKeLrz/avGNOLULHHVQ ($51.75 in chips)
Seat 2: XfRhywXA6Br+jID1oGeo8A ($248.65 in chips)
618rKeLrz/avGNOLULHHVQ: posts small blind $0.25
XfRhywXA6Br+jID1oGeo8A: posts big blind $0.50
*** HOLE CARDS ***
618rKeLrz/avGNOLULHHVQ: raises $1 to $1.50
XfRhywXA6Br+jID1oGeo8A: raises $2.50 to $4
618rKeLrz/avGNOLULHHVQ said, "i mean, i cud rape u in time"
618rKeLrz/avGNOLULHHVQ: calls $2.50
*** FLOP *** [6s 2s Kh]
XfRhywXA6Br+jID1oGeo8A: bets $3.50
618rKeLrz/avGNOLULHHVQ: calls $3.50
*** TURN *** [6s 2s Kh] [3d]
XfRhywXA6Br+jID1oGeo8A: checks
618rKeLrz/avGNOLULHHVQ: checks
*** RIVER *** [6s 2s Kh 3d] [Ks]
XfRhywXA6Br+jID1oGeo8A: checks
618rKeLrz/avGNOLULHHVQ: checks
*** SHOW DOWN ***
XfRhywXA6Br+jID1oGeo8A: shows [Ac Kc] (three of a kind, Kings)
618rKeLrz/avGNOLULHHVQ: mucks hand
XfRhywXA6Br+jID1oGeo8A collected $14.50 from pot
*** SUMMARY ***
Total pot $15 | Rake $0.50
Board [6s 2s Kh 3d Ks]
Seat 1: 618rKeLrz/avGNOLULHHVQ (button) (small blind) mucked
Seat 2: XfRhywXA6Br+jID1oGeo8A (big blind) showed [Ac Kc] and won ($14.50) with three of a kind, Kings



PokerStars Game #59938181722:  Hold'em No Limit ($0.25/$0.50) - 2009/07/01 0:08:54 ET
Table 'm95HVfesC/VPgfGEjPuaIA' 2-max Seat #1 is the button
Seat 1: Fp/oksNpipCrD2MJ2pH20g ($10.60 in chips)
Seat 2: iY+tB5vLpLxiq0ifAZ7TNQ ($18.60 in chips)
Fp/oksNpipCrD2MJ2pH20g: posts small blind $0.25
iY+tB5vLpLxiq0ifAZ7TNQ: posts big blind $0.50
*** HOLE CARDS ***
Fp/oksNpipCrD2MJ2pH20g: folds
iY+tB5vLpLxiq0ifAZ7TNQ collected $0.50 from pot
iY+tB5vLpLxiq0ifAZ7TNQ: doesn't show hand
*** SUMMARY ***
Total pot $0.50 | Rake $0
Seat 1: Fp/oksNpipCrD2MJ2pH20g (button) (small blind) folded before Flop
Seat 2: iY+tB5vLpLxiq0ifAZ7TNQ (big blind) collected ($0.50)



PokerStars Game #59938182098:  Hold'em No Limit ($0.25/$0.50) - 2009/07/01 0:08:55 ET
Table 'mTxf8gPLgffN3Iwfm7Icfg' 2-max Seat #1 is the button
Seat 1: Do9Rlu1R5u/AcRtMTl8SYg ($68.05 in chips)
Seat 2: EMc5LPgVaded4Qc77vm0fw ($46.20 in chips)
Do9Rlu1R5u/AcRtMTl8SYg: posts small blind $0.25
EMc5LPgVaded4Qc77vm0fw: posts big blind $0.50
*** HOLE CARDS ***
Do9Rlu1R5u/AcRtMTl8SYg: folds
EMc5LPgVaded4Qc77vm0fw collected $0.50 from pot
EMc5LPgVaded4Qc77vm0fw: doesn't show hand
*** SUMMARY ***
Total pot $0.50 | Rake $0
Seat 1: Do9Rlu1R5u/AcRtMTl8SYg (button) (small blind) folded before Flop
Seat 2: EMc5LPgVaded4Qc77vm0fw (big blind) collected ($0.50)



PokerStars Game #59938182858:  Hold'em No Limit ($0.25/$0.50) - 2009/07/01 0:08:56 ET
Table 'X6IRCRTh+20gjz8aubWnwA' 9-max Seat #2 is the button
Seat 1: YPo1oggovmqSREegekaQYw ($9.45 in chips)
Seat 2: RjBdQ6w31rgcy0o24VLR6w ($11.65 in chips)
Seat 3: mSD1pginDsyHG5PDfqzphw ($10 in chips)
Seat 4: uw9QayAAxLM3Hb+HR7mSkg ($11 in chips)
Seat 5: aT3lRsb9BkkYp2fkD3LEtQ ($78.65 in chips)
Seat 6: /6In1zC3WtgwxDcueWzZWg ($57.70 in chips)
Seat 7: VBnpbzn0dIveV55qKvciew ($59.95 in chips)
Seat 8: BPMN9sOItJw6vWq3kypaYg ($24.65 in chips)
Seat 9: M+7+BTmX5vZatHVuoRB1nA ($84.10 in chips)
mSD1pginDsyHG5PDfqzphw: posts small blind $0.25
uw9QayAAxLM3Hb+HR7mSkg: posts big blind $0.50
*** HOLE CARDS ***
aT3lRsb9BkkYp2fkD3LEtQ: folds
/6In1zC3WtgwxDcueWzZWg: folds
aT3lRsb9BkkYp2fkD3LEtQ leaves the table
VBnpbzn0dIveV55qKvciew: calls $0.50
BPMN9sOItJw6vWq3kypaYg: calls $0.50
M+7+BTmX5vZatHVuoRB1nA: folds
YPo1oggovmqSREegekaQYw: folds
RjBdQ6w31rgcy0o24VLR6w: folds
mSD1pginDsyHG5PDfqzphw: calls $0.25
uw9QayAAxLM3Hb+HR7mSkg: checks
*** FLOP *** [8d 9s As]
mSD1pginDsyHG5PDfqzphw: checks
uw9QayAAxLM3Hb+HR7mSkg: checks
VBnpbzn0dIveV55qKvciew: bets $1
BPMN9sOItJw6vWq3kypaYg: calls $1
L5e2lrPLQm1Pqx30IIZ/Fw joins the table at seat #5
mSD1pginDsyHG5PDfqzphw: folds
uw9QayAAxLM3Hb+HR7mSkg: folds
*** TURN *** [8d 9s As] [2s]
VBnpbzn0dIveV55qKvciew: bets $2.50
BPMN9sOItJw6vWq3kypaYg: raises $7.50 to $10
VBnpbzn0dIveV55qKvciew: folds
BPMN9sOItJw6vWq3kypaYg collected $8.60 from pot
*** SUMMARY ***
Total pot $9 | Rake $0.40
Board [8d 9s As 2s]
Seat 1: YPo1oggovmqSREegekaQYw folded before Flop (didn't bet)
Seat 2: RjBdQ6w31rgcy0o24VLR6w (button) folded before Flop (didn't bet)
Seat 3: mSD1pginDsyHG5PDfqzphw (small blind) folded on the Flop
Seat 4: uw9QayAAxLM3Hb+HR7mSkg (big blind) folded on the Flop
Seat 5: aT3lRsb9BkkYp2fkD3LEtQ folded before Flop (didn't bet)
Seat 6: /6In1zC3WtgwxDcueWzZWg folded before Flop (didn't bet)
Seat 7: VBnpbzn0dIveV55qKvciew folded on the Turn
Seat 8: BPMN9sOItJw6vWq3kypaYg collected ($8.60)
Seat 9: M+7+BTmX5vZatHVuoRB1nA folded before Flop (didn't bet)



PokerStars Game #59938186228:  Hold'em No Limit ($0.25/$0.50) - 2009/07/01 0:09:01 ET
Table 'm95HVfesC/VPgfGEjPuaIA' 2-max Seat #2 is the button
Seat 1: Fp/oksNpipCrD2MJ2pH20g ($10.35 in chips)
Seat 2: iY+tB5vLpLxiq0ifAZ7TNQ ($18.85 in chips)
iY+tB5vLpLxiq0ifAZ7TNQ: posts small blind $0.25
Fp/oksNpipCrD2MJ2pH20g: posts big blind $0.50
*** HOLE CARDS ***
iY+tB5vLpLxiq0ifAZ7TNQ: calls $0.25
Fp/oksNpipCrD2MJ2pH20g: checks
*** FLOP *** [6s 5c Kc]
Fp/oksNpipCrD2MJ2pH20g: bets $1
iY+tB5vLpLxiq0ifAZ7TNQ: raises $17.35 to $18.35 and is all-in
Fp/oksNpipCrD2MJ2pH20g: folds
iY+tB5vLpLxiq0ifAZ7TNQ collected $2.90 from pot
iY+tB5vLpLxiq0ifAZ7TNQ: doesn't show hand
*** SUMMARY ***
Total pot $3 | Rake $0.10
Board [6s 5c Kc]
Seat 1: Fp/oksNpipCrD2MJ2pH20g (big blind) folded on the Flop
Seat 2: iY+tB5vLpLxiq0ifAZ7TNQ (button) (small blind) collected ($2.90)



PokerStars Game #59938186600:  Hold'em No Limit ($0.25/$0.50) - 2009/07/01 0:09:01 ET
Table 'raOT4/ipuZgzjfKHC+jD9g' 2-max Seat #2 is the button
Seat 1: IuwLemwLhc9fvrwBGs0AMA ($12.10 in chips)
Seat 2: Udr5juWSWUgTu1NlRhjMdA ($11.65 in chips)
Udr5juWSWUgTu1NlRhjMdA: posts small blind $0.25
IuwLemwLhc9fvrwBGs0AMA: posts big blind $0.50
*** HOLE CARDS ***
Udr5juWSWUgTu1NlRhjMdA: raises $1 to $1.50
IuwLemwLhc9fvrwBGs0AMA: calls $1
*** FLOP *** [Kd 3d Js]
IuwLemwLhc9fvrwBGs0AMA: bets $1
Udr5juWSWUgTu1NlRhjMdA: calls $1
*** TURN *** [Kd 3d Js] [4h]
IuwLemwLhc9fvrwBGs0AMA: bets $2
Udr5juWSWUgTu1NlRhjMdA: raises $7.15 to $9.15 and is all-in
IuwLemwLhc9fvrwBGs0AMA: folds
Udr5juWSWUgTu1NlRhjMdA collected $8.60 from pot
Udr5juWSWUgTu1NlRhjMdA: doesn't show hand
*** SUMMARY ***
Total pot $9 | Rake $0.40
Board [Kd 3d Js 4h]
Seat 1: IuwLemwLhc9fvrwBGs0AMA (big blind) folded on the Turn
Seat 2: Udr5juWSWUgTu1NlRhjMdA (button) (small blind) collected ($8.60)



PokerStars Game #59938186236:  Hold'em No Limit ($0.25/$0.50) - 2009/07/01 0:09:01 ET
Table 'MJxeZCzYELxiIsyUZyT0jw' 6-max Seat #2 is the button
Seat 1: iKPos8JI094Tomq4tDSgnQ ($37.30 in chips)
Seat 2: r6H1GiZ6QIpMTDhyodKuRQ ($64.90 in chips)
Seat 3: JQZew0FjzS19kTjeNtrE+A ($50 in chips)
Seat 4: lP7Q6pewz4C2RsAfKsjdWw ($16 in chips)
Seat 5: 3jvoOXNtXE90w2BdfNZwZQ ($53 in chips)
Seat 6: TTx3CHxyi0SObcHyMJRp5w ($40.70 in chips)
JQZew0FjzS19kTjeNtrE+A: posts small blind $0.25
lP7Q6pewz4C2RsAfKsjdWw: posts big blind $0.50
*** HOLE CARDS ***
3jvoOXNtXE90w2BdfNZwZQ: folds
TTx3CHxyi0SObcHyMJRp5w: folds
iKPos8JI094Tomq4tDSgnQ: calls $0.50
r6H1GiZ6QIpMTDhyodKuRQ: folds
JQZew0FjzS19kTjeNtrE+A: folds
lP7Q6pewz4C2RsAfKsjdWw: checks
*** FLOP *** [9s 8h Qd]
lP7Q6pewz4C2RsAfKsjdWw: checks
iKPos8JI094Tomq4tDSgnQ: checks
*** TURN *** [9s 8h Qd] [Ad]
lP7Q6pewz4C2RsAfKsjdWw: bets $1.50
iKPos8JI094Tomq4tDSgnQ: folds
lP7Q6pewz4C2RsAfKsjdWw collected $1.20 from pot
lP7Q6pewz4C2RsAfKsjdWw: doesn't show hand
*** SUMMARY ***
Total pot $1.25 | Rake $0.05
Board [9s 8h Qd Ad]
Seat 1: iKPos8JI094Tomq4tDSgnQ folded on the Turn
Seat 2: r6H1GiZ6QIpMTDhyodKuRQ (button) folded before Flop (didn't bet)
Seat 3: JQZew0FjzS19kTjeNtrE+A (small blind) folded before Flop
Seat 4: lP7Q6pewz4C2RsAfKsjdWw (big blind) collected ($1.20)
Seat 5: 3jvoOXNtXE90w2BdfNZwZQ folded before Flop (didn't bet)
Seat 6: TTx3CHxyi0SObcHyMJRp5w folded before Flop (didn't bet)



PokerStars Game #59938187022:  Hold'em No Limit ($0.25/$0.50) - 2009/07/01 0:09:02 ET
Table 'mTxf8gPLgffN3Iwfm7Icfg' 2-max Seat #2 is the button
Seat 1: Do9Rlu1R5u/AcRtMTl8SYg ($67.80 in chips)
Seat 2: EMc5LPgVaded4Qc77vm0fw ($46.45 in chips)
EMc5LPgVaded4Qc77vm0fw: posts small blind $0.25
Do9Rlu1R5u/AcRtMTl8SYg: posts big blind $0.50
*** HOLE CARDS ***
EMc5LPgVaded4Qc77vm0fw: raises $1.50 to $2
Do9Rlu1R5u/AcRtMTl8SYg: folds
EMc5LPgVaded4Qc77vm0fw collected $1 from pot
EMc5LPgVaded4Qc77vm0fw: doesn't show hand
*** SUMMARY ***
Total pot $1 | Rake $0
Seat 1: Do9Rlu1R5u/AcRtMTl8SYg (big blind) folded before Flop
Seat 2: EMc5LPgVaded4Qc77vm0fw (button) (small blind) collected ($1)



PokerStars Game #59938188310:  Hold'em No Limit ($0.25/$0.50) - 2009/07/01 0:09:04 ET
Table 'E7bWJ45aoFXRpyRv2gw+Ig' 2-max Seat #1 is the button
Seat 1: FRkiRasEGlHUeLrEl+k/nA ($74.05 in chips)
Seat 2: 3Wro85I7472vJ4Wkpneo9A ($50 in chips)
FRkiRasEGlHUeLrEl+k/nA: posts small blind $0.25
3Wro85I7472vJ4Wkpneo9A: posts big blind $0.50
*** HOLE CARDS ***
FRkiRasEGlHUeLrEl+k/nA: raises $1 to $1.50
3Wro85I7472vJ4Wkpneo9A: folds
FRkiRasEGlHUeLrEl+k/nA collected $1 from pot
FRkiRasEGlHUeLrEl+k/nA: doesn't show hand
*** SUMMARY ***
Total pot $1 | Rake $0
Seat 1: FRkiRasEGlHUeLrEl+k/nA (button) (small blind) collected ($1)
Seat 2: 3Wro85I7472vJ4Wkpneo9A (big blind) folded before Flop



PokerStars Game #59938189080:  Hold'em No Limit ($0.25/$0.50) - 2009/07/01 0:09:05 ET
Table 'c/CRn+68J3Y8KxD5g1ek2Q' 2-max Seat #2 is the button
Seat 1: 46qCyJ6evTkHo9al5sBMNA ($310.55 in chips)
Seat 2: BypVLsYQt3ePFm2xQL/dOA ($76.35 in chips)
BypVLsYQt3ePFm2xQL/dOA: posts small blind $0.25
46qCyJ6evTkHo9al5sBMNA: posts big blind $0.50
*** HOLE CARDS ***
BypVLsYQt3ePFm2xQL/dOA: raises $0.50 to $1
46qCyJ6evTkHo9al5sBMNA: folds
BypVLsYQt3ePFm2xQL/dOA collected $1 from pot
BypVLsYQt3ePFm2xQL/dOA: doesn't show hand
*** SUMMARY ***
Total pot $1 | Rake $0
Seat 1: 46qCyJ6evTkHo9al5sBMNA (big blind) folded before Flop
Seat 2: BypVLsYQt3ePFm2xQL/dOA (button) (small blind) collected ($1)



PokerStars Game #59938191806:  Hold'em No Limit ($0.25/$0.50) - 2009/07/01 0:09:08 ET
Table 'ibNfFy0bCzuBaUORla0aGw' 9-max Seat #4 is the button
Seat 1: xZCXQSXlrZkp3pZizzVXCw ($56.95 in chips)
Seat 2: 90Wb75h3W1BRpbqVnuk8gw ($50 in chips)
Seat 3: dDaHs3X8+fe3bIkRU0cbrw ($26.30 in chips)
Seat 4: YBN054X4blmis+B2bBlC0g ($21.45 in chips)
Seat 5: FRv75HO8CUsRZ1byEz06mQ ($15.60 in chips)
Seat 6: BmYrv3ec2k5d6pQq6iNaZw ($67.90 in chips)
Seat 7: mSD1pginDsyHG5PDfqzphw ($10 in chips)
Seat 8: xUrN9TWLq4m5V+OXY7KUUA ($50 in chips)
Seat 9: WpvT3OUSiZlpvs+mPXFqtQ ($8.75 in chips)
FRv75HO8CUsRZ1byEz06mQ: posts small blind $0.25
BmYrv3ec2k5d6pQq6iNaZw: posts big blind $0.50
*** HOLE CARDS ***
mSD1pginDsyHG5PDfqzphw: folds
xUrN9TWLq4m5V+OXY7KUUA: folds
WpvT3OUSiZlpvs+mPXFqtQ: folds
xZCXQSXlrZkp3pZizzVXCw: folds
90Wb75h3W1BRpbqVnuk8gw: raises $1.50 to $2
dDaHs3X8+fe3bIkRU0cbrw: folds
YBN054X4blmis+B2bBlC0g: calls $2
FRv75HO8CUsRZ1byEz06mQ: folds
BmYrv3ec2k5d6pQq6iNaZw: folds
*** FLOP *** [Tc 4s 3d]
90Wb75h3W1BRpbqVnuk8gw: bets $2.50
YBN054X4blmis+B2bBlC0g: folds
90Wb75h3W1BRpbqVnuk8gw collected $4.55 from pot
*** SUMMARY ***
Total pot $4.75 | Rake $0.20
Board [Tc 4s 3d]
Seat 1: xZCXQSXlrZkp3pZizzVXCw folded before Flop (didn't bet)
Seat 2: 90Wb75h3W1BRpbqVnuk8gw collected ($4.55)
Seat 3: dDaHs3X8+fe3bIkRU0cbrw folded before Flop (didn't bet)
Seat 4: YBN054X4blmis+B2bBlC0g (button) folded on the Flop
Seat 5: FRv75HO8CUsRZ1byEz06mQ (small blind) folded before Flop
Seat 6: BmYrv3ec2k5d6pQq6iNaZw (big blind) folded before Flop
Seat 7: mSD1pginDsyHG5PDfqzphw folded before Flop (didn't bet)
Seat 8: xUrN9TWLq4m5V+OXY7KUUA folded before Flop (didn't bet)
Seat 9: WpvT3OUSiZlpvs+mPXFqtQ folded before Flop (didn't bet)



PokerStars Game #59938192308:  Hold'em No Limit ($0.25/$0.50) - 2009/07/01 0:09:09 ET
Table 'tyR5AZNKV8Aadbrnrnlg7g' 6-max Seat #4 is the button
Seat 1: R+KjpH/wSjDLhtIy9+edNA ($36.25 in chips)
Seat 2: 58zdeSBSuSFX/qZfhc7YmA ($32.20 in chips)
Seat 3: jUhx+m+V7qfbLZTjgwZByg ($47.85 in chips)
Seat 4: Rt6KgtZ8YaJoTc3FPim00w ($50 in chips)
Seat 5: EIg3r3fRFKG2HhgpDlIJHg ($28.70 in chips)
Seat 6: DMQLAmut/l19xN5STQndFg ($10 in chips)
EIg3r3fRFKG2HhgpDlIJHg: posts small blind $0.25
DMQLAmut/l19xN5STQndFg: posts big blind $0.50
*** HOLE CARDS ***
R+KjpH/wSjDLhtIy9+edNA: folds
58zdeSBSuSFX/qZfhc7YmA: raises $0.50 to $1
jUhx+m+V7qfbLZTjgwZByg: folds
Rt6KgtZ8YaJoTc3FPim00w: folds
EIg3r3fRFKG2HhgpDlIJHg: calls $0.75
DMQLAmut/l19xN5STQndFg: calls $0.50
*** FLOP *** [7d 6h Ts]
EIg3r3fRFKG2HhgpDlIJHg: bets $2
DMQLAmut/l19xN5STQndFg: calls $2
58zdeSBSuSFX/qZfhc7YmA: folds
*** TURN *** [7d 6h Ts] [2d]
EIg3r3fRFKG2HhgpDlIJHg: bets $2.50
DMQLAmut/l19xN5STQndFg: calls $2.50
*** RIVER *** [7d 6h Ts 2d] [5c]
EIg3r3fRFKG2HhgpDlIJHg: bets $2
DMQLAmut/l19xN5STQndFg: calls $2
*** SHOW DOWN ***
EIg3r3fRFKG2HhgpDlIJHg: shows [Kd Td] (a pair of Tens)
DMQLAmut/l19xN5STQndFg: mucks hand
EIg3r3fRFKG2HhgpDlIJHg collected $15.25 from pot
*** SUMMARY ***
Total pot $16 | Rake $0.75
Board [7d 6h Ts 2d 5c]
Seat 1: R+KjpH/wSjDLhtIy9+edNA folded before Flop (didn't bet)
Seat 2: 58zdeSBSuSFX/qZfhc7YmA folded on the Flop
Seat 3: jUhx+m+V7qfbLZTjgwZByg folded before Flop (didn't bet)
Seat 4: Rt6KgtZ8YaJoTc3FPim00w (button) folded before Flop (didn't bet)
Seat 5: EIg3r3fRFKG2HhgpDlIJHg (small blind) showed [Kd Td] and won ($15.25) with a pair of Tens
Seat 6: DMQLAmut/l19xN5STQndFg (big blind) mucked



PokerStars Game #59938192470:  Hold'em No Limit ($0.25/$0.50) - 2009/07/01 0:09:09 ET
Table 'lpxYasB1ClBSgTpCCITwhQ' 9-max Seat #1 is the button
Seat 1: ceq82/EkjUd/GFbf0YwGmA ($40.95 in chips)
Seat 3: E2518gp4aFz1+kAgmGqeEg ($10.25 in chips)
Seat 4: k1f0lS7tlMHCLGs0JT34Tg ($13 in chips)
Seat 5: bXpVeaSTPBFSPJmeXxO7nw ($9.25 in chips)
Seat 6: YPo1oggovmqSREegekaQYw ($18.10 in chips)
Seat 7: zE9cVigS2nW/Ljy4K4bUQA ($30 in chips)
Seat 8: o6JyUkbzCDw8tUabqtmnlg ($23.05 in chips)
Seat 9: mSD1pginDsyHG5PDfqzphw ($11 in chips)
E2518gp4aFz1+kAgmGqeEg: posts small blind $0.25
k1f0lS7tlMHCLGs0JT34Tg: posts big blind $0.50
*** HOLE CARDS ***
bXpVeaSTPBFSPJmeXxO7nw: folds
YPo1oggovmqSREegekaQYw: folds
zE9cVigS2nW/Ljy4K4bUQA: folds
o6JyUkbzCDw8tUabqtmnlg: folds
mSD1pginDsyHG5PDfqzphw: folds
ceq82/EkjUd/GFbf0YwGmA: raises $0.50 to $1
E2518gp4aFz1+kAgmGqeEg: folds
k1f0lS7tlMHCLGs0JT34Tg: calls $0.50
*** FLOP *** [Qh 7c 8h]
k1f0lS7tlMHCLGs0JT34Tg: checks
ceq82/EkjUd/GFbf0YwGmA: bets $1.50
k1f0lS7tlMHCLGs0JT34Tg: folds
ceq82/EkjUd/GFbf0YwGmA collected $2.15 from pot
ceq82/EkjUd/GFbf0YwGmA: doesn't show hand
*** SUMMARY ***
Total pot $2.25 | Rake $0.10
Board [Qh 7c 8h]
Seat 1: ceq82/EkjUd/GFbf0YwGmA (button) collected ($2.15)
Seat 3: E2518gp4aFz1+kAgmGqeEg (small blind) folded before Flop
Seat 4: k1f0lS7tlMHCLGs0JT34Tg (big blind) folded on the Flop
Seat 5: bXpVeaSTPBFSPJmeXxO7nw folded before Flop (didn't bet)
Seat 6: YPo1oggovmqSREegekaQYw folded before Flop (didn't bet)
Seat 7: zE9cVigS2nW/Ljy4K4bUQA folded before Flop (didn't bet)
Seat 8: o6JyUkbzCDw8tUabqtmnlg folded before Flop (didn't bet)
Seat 9: mSD1pginDsyHG5PDfqzphw folded before Flop (didn't bet)



PokerStars Game #59938193794:  Hold'em No Limit ($0.25/$0.50) - 2009/07/01 0:09:11 ET
Table 'mTxf8gPLgffN3Iwfm7Icfg' 2-max Seat #1 is the button
Seat 1: Do9Rlu1R5u/AcRtMTl8SYg ($67.30 in chips)
Seat 2: EMc5LPgVaded4Qc77vm0fw ($46.95 in chips)
Do9Rlu1R5u/AcRtMTl8SYg: posts small blind $0.25
EMc5LPgVaded4Qc77vm0fw: posts big blind $0.50
*** HOLE CARDS ***
Do9Rlu1R5u/AcRtMTl8SYg: raises $1 to $1.50
EMc5LPgVaded4Qc77vm0fw: folds
Do9Rlu1R5u/AcRtMTl8SYg collected $1 from pot
Do9Rlu1R5u/AcRtMTl8SYg: doesn't show hand
*** SUMMARY ***
Total pot $1 | Rake $0
Seat 1: Do9Rlu1R5u/AcRtMTl8SYg (button) (small blind) collected ($1)
Seat 2: EMc5LPgVaded4Qc77vm0fw (big blind) folded before Flop



PokerStars Game #59938193686:  Hold'em No Limit ($0.25/$0.50) - 2009/07/01 0:09:11 ET
Table '+dXkOAQyS8j9PQZusUTMpg' 2-max Seat #2 is the button
Seat 1: XFa6sBGjP2gxoIvxR3fZIg ($76.15 in chips)
Seat 2: 5IBeOgaApY1Bvzv2P8X4EA ($37.20 in chips)
5IBeOgaApY1Bvzv2P8X4EA: posts small blind $0.25
XFa6sBGjP2gxoIvxR3fZIg: posts big blind $0.50
*** HOLE CARDS ***
5IBeOgaApY1Bvzv2P8X4EA: folds
XFa6sBGjP2gxoIvxR3fZIg collected $0.50 from pot
XFa6sBGjP2gxoIvxR3fZIg: doesn't show hand
*** SUMMARY ***
Total pot $0.50 | Rake $0
Seat 1: XFa6sBGjP2gxoIvxR3fZIg (big blind) collected ($0.50)
Seat 2: 5IBeOgaApY1Bvzv2P8X4EA (button) (small blind) folded before Flop



PokerStars Game #59938194642:  Hold'em No Limit ($0.25/$0.50) - 2009/07/01 0:09:13 ET
Table 'c/CRn+68J3Y8KxD5g1ek2Q' 2-max Seat #1 is the button
Seat 1: 46qCyJ6evTkHo9al5sBMNA ($310.05 in chips)
Seat 2: BypVLsYQt3ePFm2xQL/dOA ($76.85 in chips)
46qCyJ6evTkHo9al5sBMNA: posts small blind $0.25
BypVLsYQt3ePFm2xQL/dOA: posts big blind $0.50
*** HOLE CARDS ***
46qCyJ6evTkHo9al5sBMNA: raises $1 to $1.50
BypVLsYQt3ePFm2xQL/dOA: calls $1
*** FLOP *** [Ac 7h 4d]
BypVLsYQt3ePFm2xQL/dOA: checks
46qCyJ6evTkHo9al5sBMNA: checks
*** TURN *** [Ac 7h 4d] [8c]
BypVLsYQt3ePFm2xQL/dOA: bets $1.50
46qCyJ6evTkHo9al5sBMNA: raises $5.50 to $7
BypVLsYQt3ePFm2xQL/dOA: calls $5.50
*** RIVER *** [Ac 7h 4d 8c] [Th]
BypVLsYQt3ePFm2xQL/dOA: checks
46qCyJ6evTkHo9al5sBMNA: bets $13.50
BypVLsYQt3ePFm2xQL/dOA: calls $13.50
*** SHOW DOWN ***
46qCyJ6evTkHo9al5sBMNA: shows [8h Ad] (two pair, Aces and Eights)
BypVLsYQt3ePFm2xQL/dOA: mucks hand
46qCyJ6evTkHo9al5sBMNA collected $43.50 from pot
*** SUMMARY ***
Total pot $44 | Rake $0.50
Board [Ac 7h 4d 8c Th]
Seat 1: 46qCyJ6evTkHo9al5sBMNA (button) (small blind) showed [8h Ad] and won ($43.50) with two pair, Aces and Eights
Seat 2: BypVLsYQt3ePFm2xQL/dOA (big blind) mucked



PokerStars Game #59938195958:  Hold'em No Limit ($0.25/$0.50) - 2009/07/01 0:09:14 ET
Table 'E7bWJ45aoFXRpyRv2gw+Ig' 2-max Seat #2 is the button
Seat 1: FRkiRasEGlHUeLrEl+k/nA ($74.55 in chips)
Seat 2: 3Wro85I7472vJ4Wkpneo9A ($49.50 in chips)
3Wro85I7472vJ4Wkpneo9A: posts small blind $0.25
FRkiRasEGlHUeLrEl+k/nA: posts big blind $0.50
*** HOLE CARDS ***
3Wro85I7472vJ4Wkpneo9A: raises $1 to $1.50
FRkiRasEGlHUeLrEl+k/nA: calls $1
*** FLOP *** [9h Kh 4h]
FRkiRasEGlHUeLrEl+k/nA: checks
3Wro85I7472vJ4Wkpneo9A: bets $2
FRkiRasEGlHUeLrEl+k/nA: folds
3Wro85I7472vJ4Wkpneo9A collected $2.85 from pot
3Wro85I7472vJ4Wkpneo9A: doesn't show hand
*** SUMMARY ***
Total pot $3 | Rake $0.15
Board [9h Kh 4h]
Seat 1: FRkiRasEGlHUeLrEl+k/nA (big blind) folded on the Flop
Seat 2: 3Wro85I7472vJ4Wkpneo9A (button) (small blind) collected ($2.85)



PokerStars Game #59938196014:  Hold'em No Limit ($0.25/$0.50) - 2009/07/01 0:09:14 ET
Table 'otvGDROEDdqsabxskT79qg' 9-max Seat #9 is the button
Seat 1: LM/g4VPDfD+0JhpH9Q/3fw ($28.70 in chips)
Seat 2: cCjTzH9jio8607WzjcfXlg ($46.60 in chips)
Seat 3: +k7T5ocke8UwavtgUHm+Cg ($52.35 in chips)
Seat 4: MG90wfSJZnOejs/KD3vlQQ ($50 in chips)
Seat 5: YPo1oggovmqSREegekaQYw ($16.80 in chips)
Seat 7: C7+tBppJrKgd/r+tuKUIpA ($40.85 in chips)
Seat 9: KcY3X8YpD74Kw1RHkx/g4A ($38.10 in chips)
LM/g4VPDfD+0JhpH9Q/3fw: posts small blind $0.25
cCjTzH9jio8607WzjcfXlg: posts big blind $0.50
WpvT3OUSiZlpvs+mPXFqtQ: sits out
*** HOLE CARDS ***
+k7T5ocke8UwavtgUHm+Cg: folds
MG90wfSJZnOejs/KD3vlQQ: folds
YPo1oggovmqSREegekaQYw: folds
C7+tBppJrKgd/r+tuKUIpA: folds
KcY3X8YpD74Kw1RHkx/g4A: folds
LM/g4VPDfD+0JhpH9Q/3fw: calls $0.25
cCjTzH9jio8607WzjcfXlg: checks
*** FLOP *** [9s 3h Ah]
LM/g4VPDfD+0JhpH9Q/3fw: checks
cCjTzH9jio8607WzjcfXlg: checks
*** TURN *** [9s 3h Ah] [Ks]
LM/g4VPDfD+0JhpH9Q/3fw: checks
cCjTzH9jio8607WzjcfXlg: checks
*** RIVER *** [9s 3h Ah Ks] [Qh]
LM/g4VPDfD+0JhpH9Q/3fw: bets $2
cCjTzH9jio8607WzjcfXlg: folds
LM/g4VPDfD+0JhpH9Q/3fw collected $0.95 from pot
LM/g4VPDfD+0JhpH9Q/3fw: doesn't show hand
*** SUMMARY ***
Total pot $1 | Rake $0.05
Board [9s 3h Ah Ks Qh]
Seat 1: LM/g4VPDfD+0JhpH9Q/3fw (small blind) collected ($0.95)
Seat 2: cCjTzH9jio8607WzjcfXlg (big blind) folded on the River
Seat 3: +k7T5ocke8UwavtgUHm+Cg folded before Flop (didn't bet)
Seat 4: MG90wfSJZnOejs/KD3vlQQ folded before Flop (didn't bet)
Seat 5: YPo1oggovmqSREegekaQYw folded before Flop (didn't bet)
Seat 7: C7+tBppJrKgd/r+tuKUIpA folded before Flop (didn't bet)
Seat 9: KcY3X8YpD74Kw1RHkx/g4A (button) folded before Flop (didn't bet)



PokerStars Game #59938195668:  Hold'em No Limit ($0.25/$0.50) - 2009/07/01 0:09:14 ET
Table '37qXEp3oe+er5q4CZip9eQ' 6-max Seat #4 is the button
Seat 2: g12O9qXTybyo2C0B2bXgjg ($27.65 in chips)
Seat 3: Rt6KgtZ8YaJoTc3FPim00w ($108.10 in chips)
Seat 4: L0aIPg7qefDQjdJo3HCVEA ($19.10 in chips)
Seat 5: VOmI0x4dDPnTESZd5B4d1Q ($30.25 in chips)
Seat 6: f7zPpUQp9hHZgqhEvrUWQw ($55.90 in chips)
VOmI0x4dDPnTESZd5B4d1Q: posts small blind $0.25
f7zPpUQp9hHZgqhEvrUWQw: posts big blind $0.50
*** HOLE CARDS ***
g12O9qXTybyo2C0B2bXgjg: folds
oqOqoO2AyCZenUghCxMDxw joins the table at seat #1
Rt6KgtZ8YaJoTc3FPim00w: raises $1 to $1.50
L0aIPg7qefDQjdJo3HCVEA: folds
VOmI0x4dDPnTESZd5B4d1Q: calls $1.25
f7zPpUQp9hHZgqhEvrUWQw: folds
*** FLOP *** [4h Qc Jc]
VOmI0x4dDPnTESZd5B4d1Q: checks
Rt6KgtZ8YaJoTc3FPim00w: bets $2.50
VOmI0x4dDPnTESZd5B4d1Q: calls $2.50
*** TURN *** [4h Qc Jc] [5s]
VOmI0x4dDPnTESZd5B4d1Q: checks
Rt6KgtZ8YaJoTc3FPim00w: bets $6
VOmI0x4dDPnTESZd5B4d1Q: calls $6
*** RIVER *** [4h Qc Jc 5s] [9s]
VOmI0x4dDPnTESZd5B4d1Q: checks
Rt6KgtZ8YaJoTc3FPim00w: checks
*** SHOW DOWN ***
VOmI0x4dDPnTESZd5B4d1Q: shows [Ks Qh] (a pair of Queens)
Rt6KgtZ8YaJoTc3FPim00w: mucks hand
VOmI0x4dDPnTESZd5B4d1Q collected $19.50 from pot
*** SUMMARY ***
Total pot $20.50 | Rake $1
Board [4h Qc Jc 5s 9s]
Seat 2: g12O9qXTybyo2C0B2bXgjg folded before Flop (didn't bet)
Seat 3: Rt6KgtZ8YaJoTc3FPim00w mucked
Seat 4: L0aIPg7qefDQjdJo3HCVEA (button) folded before Flop (didn't bet)
Seat 5: VOmI0x4dDPnTESZd5B4d1Q (small blind) showed [Ks Qh] and won ($19.50) with a pair of Queens
Seat 6: f7zPpUQp9hHZgqhEvrUWQw (big blind) folded before Flop



PokerStars Game #59938197970:  Hold'em No Limit ($0.25/$0.50) - 2009/07/01 0:09:17 ET
Table 'QOgaEqMcJ73pcUMMxoisUg' 6-max Seat #4 is the button
Seat 1: RFefXIDyFvNtJLq+CloCzA ($43.20 in chips)
Seat 3: wUZNozoIDYf+16hp4nn6dw ($40.90 in chips)
Seat 4: zAcsDhG/T128Vn7XGVSgKg ($50 in chips)
Seat 5: HoaSQCRso+nEyO5DUhGduw ($57.25 in chips)
Seat 6: s83dnhZ6VC53vY0/f6OV/g ($48.55 in chips)
HoaSQCRso+nEyO5DUhGduw: posts small blind $0.25
s83dnhZ6VC53vY0/f6OV/g: posts big blind $0.50
Im2p1Nt83UKSqv5c9frm4Q: sits out
*** HOLE CARDS ***
RFefXIDyFvNtJLq+CloCzA: folds
wUZNozoIDYf+16hp4nn6dw: calls $0.50
zAcsDhG/T128Vn7XGVSgKg: raises $2 to $2.50
HoaSQCRso+nEyO5DUhGduw: folds
s83dnhZ6VC53vY0/f6OV/g: folds
wUZNozoIDYf+16hp4nn6dw: calls $2
*** FLOP *** [Qs 4c 9d]
wUZNozoIDYf+16hp4nn6dw: checks
zAcsDhG/T128Vn7XGVSgKg: bets $3.50
wUZNozoIDYf+16hp4nn6dw: calls $3.50
*** TURN *** [Qs 4c 9d] [Ac]
wUZNozoIDYf+16hp4nn6dw: bets $2
zAcsDhG/T128Vn7XGVSgKg: calls $2
*** RIVER *** [Qs 4c 9d Ac] [8c]
wUZNozoIDYf+16hp4nn6dw: bets $19.50
zAcsDhG/T128Vn7XGVSgKg: folds
wUZNozoIDYf+16hp4nn6dw collected $15.95 from pot
*** SUMMARY ***
Total pot $16.75 | Rake $0.80
Board [Qs 4c 9d Ac 8c]
Seat 1: RFefXIDyFvNtJLq+CloCzA folded before Flop (didn't bet)
Seat 3: wUZNozoIDYf+16hp4nn6dw collected ($15.95)
Seat 4: zAcsDhG/T128Vn7XGVSgKg (button) folded on the River
Seat 5: HoaSQCRso+nEyO5DUhGduw (small blind) folded before Flop
Seat 6: s83dnhZ6VC53vY0/f6OV/g (big blind) folded before Flop



PokerStars Game #59938197694:  Hold'em No Limit ($0.25/$0.50) - 2009/07/01 0:09:17 ET
Table 'NCiXr0d5CEKBQr/cZgLhbA' 9-max Seat #3 is the button
Seat 1: RjBdQ6w31rgcy0o24VLR6w ($8.50 in chips)
Seat 2: ulxuJchBV9iguXg0FUonfg ($35.80 in chips)
Seat 3: xZCXQSXlrZkp3pZizzVXCw ($54.90 in chips)
Seat 4: CL4d+tvzcd4utdQxlPLOmg ($29.40 in chips)
Seat 5: zE9cVigS2nW/Ljy4K4bUQA ($32.70 in chips)
Seat 6: SKnJuWHScqetA/qG5p+wCg ($31.80 in chips)
Seat 7: EltNhVR1POPXhu/1E62t3A ($15 in chips)
Seat 8: 1MJUKc3cc0QmUoz1JZLR2w ($50 in chips)
Seat 9: WpvT3OUSiZlpvs+mPXFqtQ ($8.20 in chips)
CL4d+tvzcd4utdQxlPLOmg: posts small blind $0.25
zE9cVigS2nW/Ljy4K4bUQA: posts big blind $0.50
1MJUKc3cc0QmUoz1JZLR2w: posts big blind $0.50
*** HOLE CARDS ***
SKnJuWHScqetA/qG5p+wCg: folds
EltNhVR1POPXhu/1E62t3A: raises $1 to $1.50
1MJUKc3cc0QmUoz1JZLR2w: calls $1
WpvT3OUSiZlpvs+mPXFqtQ: folds
RjBdQ6w31rgcy0o24VLR6w: folds
ulxuJchBV9iguXg0FUonfg: folds
xZCXQSXlrZkp3pZizzVXCw: folds
CL4d+tvzcd4utdQxlPLOmg: folds
zE9cVigS2nW/Ljy4K4bUQA: folds
*** FLOP *** [Jc 3s 7s]
EltNhVR1POPXhu/1E62t3A: bets $2
1MJUKc3cc0QmUoz1JZLR2w: calls $2
*** TURN *** [Jc 3s 7s] [Kc]
EltNhVR1POPXhu/1E62t3A: bets $2.50
1MJUKc3cc0QmUoz1JZLR2w: calls $2.50
*** RIVER *** [Jc 3s 7s Kc] [4c]
EltNhVR1POPXhu/1E62t3A: bets $2
1MJUKc3cc0QmUoz1JZLR2w: raises $5.50 to $7.50
EltNhVR1POPXhu/1E62t3A: raises $1.50 to $9 and is all-in
1MJUKc3cc0QmUoz1JZLR2w: calls $1.50
*** SHOW DOWN ***
EltNhVR1POPXhu/1E62t3A: shows [Qd Kh] (a pair of Kings)
1MJUKc3cc0QmUoz1JZLR2w: shows [5c 7c] (a flush, King high)
1MJUKc3cc0QmUoz1JZLR2w collected $29.25 from pot
*** SUMMARY ***
Total pot $30.75 | Rake $1.50
Board [Jc 3s 7s Kc 4c]
Seat 1: RjBdQ6w31rgcy0o24VLR6w folded before Flop (didn't bet)
Seat 2: ulxuJchBV9iguXg0FUonfg folded before Flop (didn't bet)
Seat 3: xZCXQSXlrZkp3pZizzVXCw (button) folded before Flop (didn't bet)
Seat 4: CL4d+tvzcd4utdQxlPLOmg (small blind) folded before Flop
Seat 5: zE9cVigS2nW/Ljy4K4bUQA (big blind) folded before Flop
Seat 6: SKnJuWHScqetA/qG5p+wCg folded before Flop (didn't bet)
Seat 7: EltNhVR1POPXhu/1E62t3A showed [Qd Kh] and lost with a pair of Kings
Seat 8: 1MJUKc3cc0QmUoz1JZLR2w showed [5c 7c] and won ($29.25) with a flush, King high
Seat 9: WpvT3OUSiZlpvs+mPXFqtQ folded before Flop (didn't bet)



PokerStars Game #59938197886:  Hold'em No Limit ($0.25/$0.50) - 2009/07/01 0:09:17 ET
Table '+dXkOAQyS8j9PQZusUTMpg' 2-max Seat #1 is the button
Seat 1: XFa6sBGjP2gxoIvxR3fZIg ($76.40 in chips)
Seat 2: 5IBeOgaApY1Bvzv2P8X4EA ($36.95 in chips)
XFa6sBGjP2gxoIvxR3fZIg: posts small blind $0.25
5IBeOgaApY1Bvzv2P8X4EA: posts big blind $0.50
*** HOLE CARDS ***
XFa6sBGjP2gxoIvxR3fZIg: raises $1 to $1.50
5IBeOgaApY1Bvzv2P8X4EA: calls $1
*** FLOP *** [As Jc 7s]
5IBeOgaApY1Bvzv2P8X4EA: checks
XFa6sBGjP2gxoIvxR3fZIg: bets $2
5IBeOgaApY1Bvzv2P8X4EA: folds
XFa6sBGjP2gxoIvxR3fZIg collected $2.85 from pot
XFa6sBGjP2gxoIvxR3fZIg: doesn't show hand
*** SUMMARY ***
Total pot $3 | Rake $0.15
Board [As Jc 7s]
Seat 1: XFa6sBGjP2gxoIvxR3fZIg (button) (small blind) collected ($2.85)
Seat 2: 5IBeOgaApY1Bvzv2P8X4EA (big blind) folded on the Flop



PokerStars Game #59938198194:  Hold'em No Limit ($0.25/$0.50) - 2009/07/01 0:09:17 ET
Table 'Nz0Vr7WMHL2g5Uk7dDZjpw' 9-max Seat #9 is the button
Seat 1: tLkxo7JgV+WWI0UBw44K5A ($105.10 in chips)
Seat 3: 4QTiNH5fteLgJjx/s6Hy6A ($16.35 in chips)
Seat 4: 5JJVDlaiMnB004o/RqbZZQ ($27.75 in chips)
Seat 5: WGW0DgjBUXs1ylURHG8vnQ ($18.40 in chips)
Seat 6: k1f0lS7tlMHCLGs0JT34Tg ($9.25 in chips)
Seat 7: KPLH0gELgFe2OuAnhJFI5w ($24.45 in chips)
Seat 8: HkZI6g4zl83TDTA7SRspmQ ($18.75 in chips)
Seat 9: Ak2W6V2TDVIQrvSAy4eD7Q ($10.10 in chips)
tLkxo7JgV+WWI0UBw44K5A: posts small blind $0.25
YPo1oggovmqSREegekaQYw: is sitting out
4QTiNH5fteLgJjx/s6Hy6A: posts big blind $0.50
*** HOLE CARDS ***
5JJVDlaiMnB004o/RqbZZQ: folds
WGW0DgjBUXs1ylURHG8vnQ: calls $0.50
k1f0lS7tlMHCLGs0JT34Tg has timed out
k1f0lS7tlMHCLGs0JT34Tg: folds
k1f0lS7tlMHCLGs0JT34Tg is sitting out
KPLH0gELgFe2OuAnhJFI5w: folds
HkZI6g4zl83TDTA7SRspmQ: folds
Ak2W6V2TDVIQrvSAy4eD7Q: raises $9.60 to $10.10 and is all-in
tLkxo7JgV+WWI0UBw44K5A: folds
4QTiNH5fteLgJjx/s6Hy6A: folds
WGW0DgjBUXs1ylURHG8vnQ: folds
Ak2W6V2TDVIQrvSAy4eD7Q collected $1.75 from pot
*** SUMMARY ***
Total pot $1.75 | Rake $0
Seat 1: tLkxo7JgV+WWI0UBw44K5A (small blind) folded before Flop
Seat 3: 4QTiNH5fteLgJjx/s6Hy6A (big blind) folded before Flop
Seat 4: 5JJVDlaiMnB004o/RqbZZQ folded before Flop (didn't bet)
Seat 5: WGW0DgjBUXs1ylURHG8vnQ folded before Flop
Seat 6: k1f0lS7tlMHCLGs0JT34Tg folded before Flop (didn't bet)
Seat 7: KPLH0gELgFe2OuAnhJFI5w folded before Flop (didn't bet)
Seat 8: HkZI6g4zl83TDTA7SRspmQ folded before Flop (didn't bet)
Seat 9: Ak2W6V2TDVIQrvSAy4eD7Q (button) collected ($1.75)



PokerStars Game #59938198504:  Hold'em No Limit ($0.25/$0.50) - 2009/07/01 0:09:18 ET
Table 'PALRfuH85dr5IkDfdv6new' 9-max Seat #2 is the button
Seat 1: SKnJuWHScqetA/qG5p+wCg ($33 in chips)
Seat 2: 9r7ZoBbAJj5IeyZ0q9BdzA ($23.90 in chips)
Seat 3: 50QWoELmpmHFrFIlWMJo9g ($94.45 in chips)
Seat 4: /gaxz7F0MIjSN3t7ZPKwAA ($41.85 in chips)
Seat 5: jSSGUXdNFAZA3QCvTcUMQw ($43.05 in chips)
Seat 6: EiWj2MAl8RNcPhTkzz24Mw ($27.90 in chips)
Seat 7: 3NcyXvr39gnK+KbTq7ezyA ($33.45 in chips)
Seat 8: NkS+CseUKx4XHszWq0PXEQ ($43.10 in chips)
Seat 9: CIrAX/m6o7jYmKOAjJXv4Q ($25.05 in chips)
50QWoELmpmHFrFIlWMJo9g: posts small blind $0.25
/gaxz7F0MIjSN3t7ZPKwAA: posts big blind $0.50
*** HOLE CARDS ***
jSSGUXdNFAZA3QCvTcUMQw: folds
EiWj2MAl8RNcPhTkzz24Mw: folds
3NcyXvr39gnK+KbTq7ezyA: folds
NkS+CseUKx4XHszWq0PXEQ: folds
CIrAX/m6o7jYmKOAjJXv4Q: folds
SKnJuWHScqetA/qG5p+wCg: folds
9r7ZoBbAJj5IeyZ0q9BdzA: folds
50QWoELmpmHFrFIlWMJo9g: folds
/gaxz7F0MIjSN3t7ZPKwAA collected $0.50 from pot
*** SUMMARY ***
Total pot $0.50 | Rake $0
Seat 1: SKnJuWHScqetA/qG5p+wCg folded before Flop (didn't bet)
Seat 2: 9r7ZoBbAJj5IeyZ0q9BdzA (button) folded before Flop (didn't bet)
Seat 3: 50QWoELmpmHFrFIlWMJo9g (small blind) folded before Flop
Seat 4: /gaxz7F0MIjSN3t7ZPKwAA (big blind) collected ($0.50)
Seat 5: jSSGUXdNFAZA3QCvTcUMQw folded before Flop (didn't bet)
Seat 6: EiWj2MAl8RNcPhTkzz24Mw folded before Flop (didn't bet)
Seat 7: 3NcyXvr39gnK+KbTq7ezyA folded before Flop (didn't bet)
Seat 8: NkS+CseUKx4XHszWq0PXEQ folded before Flop (didn't bet)
Seat 9: CIrAX/m6o7jYmKOAjJXv4Q folded before Flop (didn't bet)



PokerStars Game #59938200254:  Hold'em No Limit ($0.25/$0.50) - 2009/07/01 0:09:20 ET
Table 'mTxf8gPLgffN3Iwfm7Icfg' 2-max Seat #2 is the button
Seat 1: Do9Rlu1R5u/AcRtMTl8SYg ($67.80 in chips)
Seat 2: EMc5LPgVaded4Qc77vm0fw ($46.45 in chips)
EMc5LPgVaded4Qc77vm0fw: posts small blind $0.25
Do9Rlu1R5u/AcRtMTl8SYg: posts big blind $0.50
*** HOLE CARDS ***
EMc5LPgVaded4Qc77vm0fw: raises $1 to $1.50
Do9Rlu1R5u/AcRtMTl8SYg: folds
EMc5LPgVaded4Qc77vm0fw collected $1 from pot
EMc5LPgVaded4Qc77vm0fw: doesn't show hand
*** SUMMARY ***
Total pot $1 | Rake $0
Seat 1: Do9Rlu1R5u/AcRtMTl8SYg (big blind) folded before Flop
Seat 2: EMc5LPgVaded4Qc77vm0fw (button) (small blind) collected ($1)



PokerStars Game #59938199816:  Hold'em No Limit ($0.25/$0.50) - 2009/07/01 0:09:20 ET
Table 'm95HVfesC/VPgfGEjPuaIA' 2-max Seat #1 is the button
Seat 1: Fp/oksNpipCrD2MJ2pH20g ($8.85 in chips)
Seat 2: iY+tB5vLpLxiq0ifAZ7TNQ ($20.25 in chips)
Fp/oksNpipCrD2MJ2pH20g: posts small blind $0.25
iY+tB5vLpLxiq0ifAZ7TNQ: posts big blind $0.50
*** HOLE CARDS ***
Fp/oksNpipCrD2MJ2pH20g: raises $1 to $1.50
iY+tB5vLpLxiq0ifAZ7TNQ: folds
Fp/oksNpipCrD2MJ2pH20g collected $1 from pot
Fp/oksNpipCrD2MJ2pH20g: doesn't show hand
*** SUMMARY ***
Total pot $1 | Rake $0
Seat 1: Fp/oksNpipCrD2MJ2pH20g (button) (small blind) collected ($1)
Seat 2: iY+tB5vLpLxiq0ifAZ7TNQ (big blind) folded before Flop



PokerStars Game #59938199720:  Hold'em No Limit ($0.25/$0.50) - 2009/07/01 0:09:20 ET
Table 'kgbJRsxfv64KrErDRBAkcw' 6-max Seat #3 is the button
Seat 1: YmWlPGOKFuJSoJZPW8a8IA ($80.55 in chips)
Seat 2: Q+thC23WCv1kJUJtH/+4Jw ($27.50 in chips)
Seat 3: T0Gx/FcQ5VH9u7XaOMX97A ($65.40 in chips)
Seat 4: qanMEqjABjWxC/JgQ/0l7w ($61.70 in chips)
Seat 5: +Pf9jTVizYlIo+woPvptfA ($50 in chips)
Seat 6: DDfYzIrYT0t5R/hAJngtsg ($21.45 in chips)
qanMEqjABjWxC/JgQ/0l7w: posts small blind $0.25
+Pf9jTVizYlIo+woPvptfA: posts big blind $0.50
*** HOLE CARDS ***
DDfYzIrYT0t5R/hAJngtsg: calls $0.50
YmWlPGOKFuJSoJZPW8a8IA: folds
Q+thC23WCv1kJUJtH/+4Jw: folds
T0Gx/FcQ5VH9u7XaOMX97A: folds
qanMEqjABjWxC/JgQ/0l7w: calls $0.25
+Pf9jTVizYlIo+woPvptfA: checks
*** FLOP *** [8d Ks 5c]
qanMEqjABjWxC/JgQ/0l7w: checks
+Pf9jTVizYlIo+woPvptfA: checks
DDfYzIrYT0t5R/hAJngtsg: checks
*** TURN *** [8d Ks 5c] [2c]
qanMEqjABjWxC/JgQ/0l7w: checks
+Pf9jTVizYlIo+woPvptfA: checks
DDfYzIrYT0t5R/hAJngtsg: checks
*** RIVER *** [8d Ks 5c 2c] [Qs]
qanMEqjABjWxC/JgQ/0l7w: checks
+Pf9jTVizYlIo+woPvptfA: checks
DDfYzIrYT0t5R/hAJngtsg: bets $1.50
qanMEqjABjWxC/JgQ/0l7w: folds
+Pf9jTVizYlIo+woPvptfA: folds
DDfYzIrYT0t5R/hAJngtsg collected $1.45 from pot
DDfYzIrYT0t5R/hAJngtsg: doesn't show hand
*** SUMMARY ***
Total pot $1.50 | Rake $0.05
Board [8d Ks 5c 2c Qs]
Seat 1: YmWlPGOKFuJSoJZPW8a8IA folded before Flop (didn't bet)
Seat 2: Q+thC23WCv1kJUJtH/+4Jw folded before Flop (didn't bet)
Seat 3: T0Gx/FcQ5VH9u7XaOMX97A (button) folded before Flop (didn't bet)
Seat 4: qanMEqjABjWxC/JgQ/0l7w (small blind) folded on the River
Seat 5: +Pf9jTVizYlIo+woPvptfA (big blind) folded on the River
Seat 6: DDfYzIrYT0t5R/hAJngtsg collected ($1.45)



PokerStars Game #59938200924:  Hold'em No Limit ($0.25/$0.50) - 2009/07/01 0:09:21 ET
Table 'SsXEKOwKN+jE3etfusqUqA' 2-max Seat #2 is the button
Seat 1: 618rKeLrz/avGNOLULHHVQ ($50 in chips)
Seat 2: XfRhywXA6Br+jID1oGeo8A ($255.65 in chips)
XfRhywXA6Br+jID1oGeo8A: posts small blind $0.25
618rKeLrz/avGNOLULHHVQ: posts big blind $0.50
*** HOLE CARDS ***
618rKeLrz/avGNOLULHHVQ said, "see"
XfRhywXA6Br+jID1oGeo8A: folds
618rKeLrz/avGNOLULHHVQ collected $0.50 from pot
618rKeLrz/avGNOLULHHVQ: doesn't show hand
*** SUMMARY ***
Total pot $0.50 | Rake $0
Seat 1: 618rKeLrz/avGNOLULHHVQ (big blind) collected ($0.50)
Seat 2: XfRhywXA6Br+jID1oGeo8A (button) (small blind) folded before Flop



PokerStars Game #59938200842:  Hold'em No Limit ($0.25/$0.50) - 2009/07/01 0:09:21 ET
Table 'EiNh8p/wGJ1FP575iMFnqg' 9-max Seat #1 is the button
Seat 1: r3ZqM1Mi0W3y4hOdssE+Sg ($34.50 in chips)
Seat 2: sSAA879uXOGR+8Mf3zLa6Q ($9 in chips)
Seat 3: GszS/McxOSUnOET7MBoHqA ($69.70 in chips)
Seat 4: pk8aA8qMBEL6zXqSyfVXMA ($80.05 in chips)
Seat 5: M+7+BTmX5vZatHVuoRB1nA ($89 in chips)
Seat 6: YPo1oggovmqSREegekaQYw ($17.25 in chips)
Seat 8: KrPAGRACBg+w0M//SXe8Ag ($9 in chips)
Seat 9: OMwFJ4pF0xk2Ru/AJiFeFw ($72.15 in chips)
sSAA879uXOGR+8Mf3zLa6Q: posts small blind $0.25
GszS/McxOSUnOET7MBoHqA: posts big blind $0.50
*** HOLE CARDS ***
Wj7mKnRFR90j40wWUu2+Og has returned
pk8aA8qMBEL6zXqSyfVXMA: raises $1.50 to $2
M+7+BTmX5vZatHVuoRB1nA: folds
YPo1oggovmqSREegekaQYw: folds
KrPAGRACBg+w0M//SXe8Ag: folds
OMwFJ4pF0xk2Ru/AJiFeFw: folds
r3ZqM1Mi0W3y4hOdssE+Sg: folds
sSAA879uXOGR+8Mf3zLa6Q: calls $1.75
GszS/McxOSUnOET7MBoHqA: calls $1.50
*** FLOP *** [6h Jd Kd]
sSAA879uXOGR+8Mf3zLa6Q: checks
GszS/McxOSUnOET7MBoHqA: checks
pk8aA8qMBEL6zXqSyfVXMA: checks
*** TURN *** [6h Jd Kd] [Ts]
sSAA879uXOGR+8Mf3zLa6Q: checks
GszS/McxOSUnOET7MBoHqA: bets $3.50
pk8aA8qMBEL6zXqSyfVXMA: calls $3.50
sSAA879uXOGR+8Mf3zLa6Q: calls $3.50
*** RIVER *** [6h Jd Kd Ts] [3c]
sSAA879uXOGR+8Mf3zLa6Q: checks
GszS/McxOSUnOET7MBoHqA: bets $9
pk8aA8qMBEL6zXqSyfVXMA: calls $9
sSAA879uXOGR+8Mf3zLa6Q: calls $3.50 and is all-in
*** SHOW DOWN ***
GszS/McxOSUnOET7MBoHqA: shows [Js Kc] (two pair, Kings and Jacks)
pk8aA8qMBEL6zXqSyfVXMA: shows [Td Tc] (three of a kind, Tens)
pk8aA8qMBEL6zXqSyfVXMA collected $10.45 from side pot
sSAA879uXOGR+8Mf3zLa6Q: mucks hand
pk8aA8qMBEL6zXqSyfVXMA collected $25.70 from main pot
*** SUMMARY ***
Total pot $38 Main pot $25.70. Side pot $10.45. | Rake $1.85
Board [6h Jd Kd Ts 3c]
Seat 1: r3ZqM1Mi0W3y4hOdssE+Sg (button) folded before Flop (didn't bet)
Seat 2: sSAA879uXOGR+8Mf3zLa6Q (small blind) mucked
Seat 3: GszS/McxOSUnOET7MBoHqA (big blind) showed [Js Kc] and lost with two pair, Kings and Jacks
Seat 4: pk8aA8qMBEL6zXqSyfVXMA showed [Td Tc] and won ($36.15) with three of a kind, Tens
Seat 5: M+7+BTmX5vZatHVuoRB1nA folded before Flop (didn't bet)
Seat 6: YPo1oggovmqSREegekaQYw folded before Flop (didn't bet)
Seat 8: KrPAGRACBg+w0M//SXe8Ag folded before Flop (didn't bet)
Seat 9: OMwFJ4pF0xk2Ru/AJiFeFw folded before Flop (didn't bet)



PokerStars Game #59938202166:  Hold'em No Limit ($0.25/$0.50) - 2009/07/01 0:09:23 ET
Table '3FhG0gl3kMX3wBEEqj+wnQ' 9-max Seat #1 is the button
Seat 1: e0J9pdCNUDTCG031RnXqLA ($24.25 in chips)
Seat 2: 4dl3YNqZ6Houm2jZAzDmRg ($27.25 in chips)
Seat 3: bXpVeaSTPBFSPJmeXxO7nw ($10.75 in chips)
Seat 4: bz4LMfV0GGl/MJ/ABXuPmg ($16.90 in chips)
Seat 6: 5JJVDlaiMnB004o/RqbZZQ ($26.75 in chips)
Seat 7: 6XkTu4ahxzHnvjjc1R8YjQ ($9.25 in chips)
Seat 8: j3K/Jujr7PY4ZM2RZvlH6A ($55.50 in chips)
Seat 9: tzoXBDwkkPV/XPJPkf963Q ($13.10 in chips)
4dl3YNqZ6Houm2jZAzDmRg: posts small blind $0.25
bXpVeaSTPBFSPJmeXxO7nw: posts big blind $0.50
XNMDwbXt/Q4jM99AXnbJDw: sits out
*** HOLE CARDS ***
bz4LMfV0GGl/MJ/ABXuPmg: folds
5JJVDlaiMnB004o/RqbZZQ: folds
6XkTu4ahxzHnvjjc1R8YjQ: folds
j3K/Jujr7PY4ZM2RZvlH6A: raises $1 to $1.50
tzoXBDwkkPV/XPJPkf963Q: folds
e0J9pdCNUDTCG031RnXqLA: folds
4dl3YNqZ6Houm2jZAzDmRg: calls $1.25
bXpVeaSTPBFSPJmeXxO7nw: folds
*** FLOP *** [7c 9s Tc]
4dl3YNqZ6Houm2jZAzDmRg: checks
j3K/Jujr7PY4ZM2RZvlH6A: bets $3
4dl3YNqZ6Houm2jZAzDmRg: folds
j3K/Jujr7PY4ZM2RZvlH6A collected $3.35 from pot
j3K/Jujr7PY4ZM2RZvlH6A: doesn't show hand
*** SUMMARY ***
Total pot $3.50 | Rake $0.15
Board [7c 9s Tc]
Seat 1: e0J9pdCNUDTCG031RnXqLA (button) folded before Flop (didn't bet)
Seat 2: 4dl3YNqZ6Houm2jZAzDmRg (small blind) folded on the Flop
Seat 3: bXpVeaSTPBFSPJmeXxO7nw (big blind) folded before Flop
Seat 4: bz4LMfV0GGl/MJ/ABXuPmg folded before Flop (didn't bet)
Seat 6: 5JJVDlaiMnB004o/RqbZZQ folded before Flop (didn't bet)
Seat 7: 6XkTu4ahxzHnvjjc1R8YjQ folded before Flop (didn't bet)
Seat 8: j3K/Jujr7PY4ZM2RZvlH6A collected ($3.35)
Seat 9: tzoXBDwkkPV/XPJPkf963Q folded before Flop (didn't bet)



PokerStars Game #59938203050:  Hold'em No Limit ($0.25/$0.50) - 2009/07/01 0:09:24 ET
Table 'YsnnHkamRzYqMOr2FlLY4w' 6-max Seat #4 is the button
Seat 1: crjGpJEzSZgD38FoE3VMGg ($54.65 in chips)
Seat 3: I+pG2m/dD5iYdbg9qx572g ($21.25 in chips)
Seat 4: 7Fue572p4ZIC85AJMQvaQw ($53.40 in chips)
Seat 5: lcQ7uuLf+WLGGy4Ve6VKKA ($40.10 in chips)
Seat 6: YmWlPGOKFuJSoJZPW8a8IA ($53.40 in chips)
lcQ7uuLf+WLGGy4Ve6VKKA: posts small blind $0.25
YmWlPGOKFuJSoJZPW8a8IA: posts big blind $0.50
vnRgOasQNKOR7gLXwRQ+ww: sits out
*** HOLE CARDS ***
crjGpJEzSZgD38FoE3VMGg: folds
I+pG2m/dD5iYdbg9qx572g: folds
7Fue572p4ZIC85AJMQvaQw: folds
lcQ7uuLf+WLGGy4Ve6VKKA: folds
YmWlPGOKFuJSoJZPW8a8IA collected $0.50 from pot
YmWlPGOKFuJSoJZPW8a8IA: doesn't show hand
*** SUMMARY ***
Total pot $0.50 | Rake $0
Seat 1: crjGpJEzSZgD38FoE3VMGg folded before Flop (didn't bet)
Seat 3: I+pG2m/dD5iYdbg9qx572g folded before Flop (didn't bet)
Seat 4: 7Fue572p4ZIC85AJMQvaQw (button) folded before Flop (didn't bet)
Seat 5: lcQ7uuLf+WLGGy4Ve6VKKA (small blind) folded before Flop
Seat 6: YmWlPGOKFuJSoJZPW8a8IA (big blind) collected ($0.50)



PokerStars Game #59938203498:  Hold'em No Limit ($0.25/$0.50) - 2009/07/01 0:09:25 ET
Table 'BCN5su+SsXiy1zRMJi0SJw' 6-max Seat #3 is the button
Seat 1: WyeokAqR0q9nADSkWpbxHw ($40.65 in chips)
Seat 2: QfV2JJlmEKgD5jYPV+a33A ($159.65 in chips)
Seat 3: L309C3uyA1tkWSOh/QvjHw ($20.70 in chips)
Seat 4: 6Wb8PlO2kM4fnSim7p4Mrw ($14.80 in chips)
Seat 5: TTx3CHxyi0SObcHyMJRp5w ($34 in chips)
6Wb8PlO2kM4fnSim7p4Mrw: posts small blind $0.25
TTx3CHxyi0SObcHyMJRp5w: posts big blind $0.50
*** HOLE CARDS ***
WyeokAqR0q9nADSkWpbxHw: folds
QfV2JJlmEKgD5jYPV+a33A: folds
L309C3uyA1tkWSOh/QvjHw: calls $0.50
6Wb8PlO2kM4fnSim7p4Mrw: calls $0.25
TTx3CHxyi0SObcHyMJRp5w: checks
*** FLOP *** [Ks 3d 2s]
6Wb8PlO2kM4fnSim7p4Mrw: checks
TTx3CHxyi0SObcHyMJRp5w: checks
L309C3uyA1tkWSOh/QvjHw: bets $0.50
6Wb8PlO2kM4fnSim7p4Mrw: folds
TTx3CHxyi0SObcHyMJRp5w: folds
L309C3uyA1tkWSOh/QvjHw collected $1.45 from pot
*** SUMMARY ***
Total pot $1.50 | Rake $0.05
Board [Ks 3d 2s]
Seat 1: WyeokAqR0q9nADSkWpbxHw folded before Flop (didn't bet)
Seat 2: QfV2JJlmEKgD5jYPV+a33A folded before Flop (didn't bet)
Seat 3: L309C3uyA1tkWSOh/QvjHw (button) collected ($1.45)
Seat 4: 6Wb8PlO2kM4fnSim7p4Mrw (small blind) folded on the Flop
Seat 5: TTx3CHxyi0SObcHyMJRp5w (big blind) folded on the Flop



PokerStars Game #59938203946:  Hold'em No Limit ($0.25/$0.50) - 2009/07/01 0:09:25 ET
Table '+z1aekfHkpp09pc8F9aViw' 6-max Seat #6 is the button
Seat 1: lWwl5C/UZOsWNubdUqghZw ($50.70 in chips)
Seat 2: VuB2GN0h94yY+QbuI2Mybg ($16.45 in chips)
Seat 4: OCrv7ObFH4/s2lv7rYOnsQ ($27.20 in chips)
Seat 5: crjGpJEzSZgD38FoE3VMGg ($62.15 in chips)
Seat 6: 686aeHikcJlgKkSuIFdcXQ ($71.25 in chips)
lWwl5C/UZOsWNubdUqghZw: posts small blind $0.25
VuB2GN0h94yY+QbuI2Mybg: posts big blind $0.50
*** HOLE CARDS ***
uUznlIMFnRUvwrBhYF73KA has returned
OCrv7ObFH4/s2lv7rYOnsQ: calls $0.50
crjGpJEzSZgD38FoE3VMGg: folds
686aeHikcJlgKkSuIFdcXQ: folds
lWwl5C/UZOsWNubdUqghZw is disconnected
lWwl5C/UZOsWNubdUqghZw is connected
lWwl5C/UZOsWNubdUqghZw: folds
VuB2GN0h94yY+QbuI2Mybg: checks
*** FLOP *** [2s Ad 4d]
VuB2GN0h94yY+QbuI2Mybg: checks
OCrv7ObFH4/s2lv7rYOnsQ: bets $1
VuB2GN0h94yY+QbuI2Mybg: folds
OCrv7ObFH4/s2lv7rYOnsQ collected $1.20 from pot
*** SUMMARY ***
Total pot $1.25 | Rake $0.05
Board [2s Ad 4d]
Seat 1: lWwl5C/UZOsWNubdUqghZw (small blind) folded before Flop
Seat 2: VuB2GN0h94yY+QbuI2Mybg (big blind) folded on the Flop
Seat 4: OCrv7ObFH4/s2lv7rYOnsQ collected ($1.20)
Seat 5: crjGpJEzSZgD38FoE3VMGg folded before Flop (didn't bet)
Seat 6: 686aeHikcJlgKkSuIFdcXQ (button) folded before Flop (didn't bet)



PokerStars Game #59938205154:  Hold'em No Limit ($0.25/$0.50) - 2009/07/01 0:09:27 ET
Table 'mTxf8gPLgffN3Iwfm7Icfg' 2-max Seat #1 is the button
Seat 1: Do9Rlu1R5u/AcRtMTl8SYg ($67.30 in chips)
Seat 2: EMc5LPgVaded4Qc77vm0fw ($46.95 in chips)
Do9Rlu1R5u/AcRtMTl8SYg: posts small blind $0.25
EMc5LPgVaded4Qc77vm0fw: posts big blind $0.50
*** HOLE CARDS ***
Do9Rlu1R5u/AcRtMTl8SYg: folds
EMc5LPgVaded4Qc77vm0fw collected $0.50 from pot
EMc5LPgVaded4Qc77vm0fw: doesn't show hand
*** SUMMARY ***
Total pot $0.50 | Rake $0
Seat 1: Do9Rlu1R5u/AcRtMTl8SYg (button) (small blind) folded before Flop
Seat 2: EMc5LPgVaded4Qc77vm0fw (big blind) collected ($0.50)



PokerStars Game #59938205224:  Hold'em No Limit ($0.25/$0.50) - 2009/07/01 0:09:27 ET
Table 'SsXEKOwKN+jE3etfusqUqA' 2-max Seat #1 is the button
Seat 1: 618rKeLrz/avGNOLULHHVQ ($50.25 in chips)
Seat 2: XfRhywXA6Br+jID1oGeo8A ($255.40 in chips)
618rKeLrz/avGNOLULHHVQ: posts small blind $0.25
XfRhywXA6Br+jID1oGeo8A: posts big blind $0.50
*** HOLE CARDS ***
618rKeLrz/avGNOLULHHVQ: raises $1 to $1.50
XfRhywXA6Br+jID1oGeo8A: calls $1
*** FLOP *** [8s 8h 2s]
XfRhywXA6Br+jID1oGeo8A: checks
618rKeLrz/avGNOLULHHVQ: checks
*** TURN *** [8s 8h 2s] [Td]
XfRhywXA6Br+jID1oGeo8A: checks
618rKeLrz/avGNOLULHHVQ: checks
*** RIVER *** [8s 8h 2s Td] [9h]
XfRhywXA6Br+jID1oGeo8A: checks
618rKeLrz/avGNOLULHHVQ: bets $1.50
XfRhywXA6Br+jID1oGeo8A: calls $1.50
*** SHOW DOWN ***
618rKeLrz/avGNOLULHHVQ: shows [7c Tc] (two pair, Tens and Eights)
XfRhywXA6Br+jID1oGeo8A: mucks hand
618rKeLrz/avGNOLULHHVQ collected $5.75 from pot
*** SUMMARY ***
Total pot $6 | Rake $0.25
Board [8s 8h 2s Td 9h]
Seat 1: 618rKeLrz/avGNOLULHHVQ (button) (small blind) showed [7c Tc] and won ($5.75) with two pair, Tens and Eights
Seat 2: XfRhywXA6Br+jID1oGeo8A (big blind) mucked



PokerStars Game #59938205700:  Hold'em No Limit ($0.25/$0.50) - 2009/07/01 0:09:28 ET
Table 'MJxeZCzYELxiIsyUZyT0jw' 6-max Seat #3 is the button
Seat 1: iKPos8JI094Tomq4tDSgnQ ($36.80 in chips)
Seat 2: r6H1GiZ6QIpMTDhyodKuRQ ($64.90 in chips)
Seat 3: JQZew0FjzS19kTjeNtrE+A ($50 in chips)
Seat 4: lP7Q6pewz4C2RsAfKsjdWw ($16.70 in chips)
Seat 5: 3jvoOXNtXE90w2BdfNZwZQ ($53 in chips)
Seat 6: TTx3CHxyi0SObcHyMJRp5w ($40.70 in chips)
lP7Q6pewz4C2RsAfKsjdWw: posts small blind $0.25
3jvoOXNtXE90w2BdfNZwZQ: posts big blind $0.50
*** HOLE CARDS ***
TTx3CHxyi0SObcHyMJRp5w: calls $0.50
iKPos8JI094Tomq4tDSgnQ: folds
r6H1GiZ6QIpMTDhyodKuRQ: folds
JQZew0FjzS19kTjeNtrE+A: folds
lP7Q6pewz4C2RsAfKsjdWw: calls $0.25
3jvoOXNtXE90w2BdfNZwZQ: checks
*** FLOP *** [As 6s 7s]
lP7Q6pewz4C2RsAfKsjdWw: checks
3jvoOXNtXE90w2BdfNZwZQ: checks
TTx3CHxyi0SObcHyMJRp5w: checks
*** TURN *** [As 6s 7s] [2h]
lP7Q6pewz4C2RsAfKsjdWw: bets $2
3jvoOXNtXE90w2BdfNZwZQ: folds
TTx3CHxyi0SObcHyMJRp5w: folds
lP7Q6pewz4C2RsAfKsjdWw collected $1.45 from pot
lP7Q6pewz4C2RsAfKsjdWw: doesn't show hand
*** SUMMARY ***
Total pot $1.50 | Rake $0.05
Board [As 6s 7s 2h]
Seat 1: iKPos8JI094Tomq4tDSgnQ folded before Flop (didn't bet)
Seat 2: r6H1GiZ6QIpMTDhyodKuRQ folded before Flop (didn't bet)
Seat 3: JQZew0FjzS19kTjeNtrE+A (button) folded before Flop (didn't bet)
Seat 4: lP7Q6pewz4C2RsAfKsjdWw (small blind) collected ($1.45)
Seat 5: 3jvoOXNtXE90w2BdfNZwZQ (big blind) folded on the Turn
Seat 6: TTx3CHxyi0SObcHyMJRp5w folded on the Turn



PokerStars Game #59938206184:  Hold'em No Limit ($0.25/$0.50) - 2009/07/01 0:09:29 ET
Table 'm95HVfesC/VPgfGEjPuaIA' 2-max Seat #2 is the button
Seat 1: Fp/oksNpipCrD2MJ2pH20g ($9.35 in chips)
Seat 2: iY+tB5vLpLxiq0ifAZ7TNQ ($19.75 in chips)
iY+tB5vLpLxiq0ifAZ7TNQ: posts small blind $0.25
Fp/oksNpipCrD2MJ2pH20g: posts big blind $0.50
*** HOLE CARDS ***
iY+tB5vLpLxiq0ifAZ7TNQ: raises $19.25 to $19.75 and is all-in
Fp/oksNpipCrD2MJ2pH20g: calls $8.85 and is all-in
*** FLOP *** [7s Kd Kh]
*** TURN *** [7s Kd Kh] [6d]
*** RIVER *** [7s Kd Kh 6d] [5c]
*** SHOW DOWN ***
Fp/oksNpipCrD2MJ2pH20g: shows [Qc Ac] (a pair of Kings)
iY+tB5vLpLxiq0ifAZ7TNQ: shows [Kc 2h] (three of a kind, Kings)
iY+tB5vLpLxiq0ifAZ7TNQ collected $18.20 from pot
*** SUMMARY ***
Total pot $18.70 | Rake $0.50
Board [7s Kd Kh 6d 5c]
Seat 1: Fp/oksNpipCrD2MJ2pH20g (big blind) showed [Qc Ac] and lost with a pair of Kings
Seat 2: iY+tB5vLpLxiq0ifAZ7TNQ (button) (small blind) showed [Kc 2h] and won ($18.20) with three of a kind, Kings



PokerStars Game #59938206870:  Hold'em No Limit ($0.25/$0.50) - 2009/07/01 0:09:30 ET
Table 'lSisgp6H7Fg1hH5VfjEjYQ' 9-max Seat #9 is the button
Seat 1: pEW8B6uXbdR47kfljMQ3+Q ($39.95 in chips)
Seat 2: UrcnkQOiLVk8BlKDPJSy7Q ($53.85 in chips)
Seat 3: RjBdQ6w31rgcy0o24VLR6w ($13.15 in chips)
Seat 4: nvw9yQKhJT56lA9k+TLdhw ($11.70 in chips)
Seat 5: mSD1pginDsyHG5PDfqzphw ($10 in chips)
Seat 6: +k7T5ocke8UwavtgUHm+Cg ($17.75 in chips)
Seat 7: xyQ4CeZa3ug3ompz+5xSTg ($73.95 in chips)
Seat 8: bXpVeaSTPBFSPJmeXxO7nw ($19.50 in chips)
Seat 9: 5JJVDlaiMnB004o/RqbZZQ ($39.70 in chips)
pEW8B6uXbdR47kfljMQ3+Q: posts small blind $0.25
UrcnkQOiLVk8BlKDPJSy7Q: posts big blind $0.50
*** HOLE CARDS ***
RjBdQ6w31rgcy0o24VLR6w: folds
nvw9yQKhJT56lA9k+TLdhw: folds
mSD1pginDsyHG5PDfqzphw: raises $1 to $1.50
+k7T5ocke8UwavtgUHm+Cg: calls $1.50
xyQ4CeZa3ug3ompz+5xSTg: folds
bXpVeaSTPBFSPJmeXxO7nw: folds
5JJVDlaiMnB004o/RqbZZQ: folds
pEW8B6uXbdR47kfljMQ3+Q: folds
UrcnkQOiLVk8BlKDPJSy7Q: folds
*** FLOP *** [9h Ac Ts]
mSD1pginDsyHG5PDfqzphw: bets $2
+k7T5ocke8UwavtgUHm+Cg: raises $2 to $4
mSD1pginDsyHG5PDfqzphw: folds
+k7T5ocke8UwavtgUHm+Cg collected $7.40 from pot
+k7T5ocke8UwavtgUHm+Cg: doesn't show hand
*** SUMMARY ***
Total pot $7.75 | Rake $0.35
Board [9h Ac Ts]
Seat 1: pEW8B6uXbdR47kfljMQ3+Q (small blind) folded before Flop
Seat 2: UrcnkQOiLVk8BlKDPJSy7Q (big blind) folded before Flop
Seat 3: RjBdQ6w31rgcy0o24VLR6w folded before Flop (didn't bet)
Seat 4: nvw9yQKhJT56lA9k+TLdhw folded before Flop (didn't bet)
Seat 5: mSD1pginDsyHG5PDfqzphw folded on the Flop
Seat 6: +k7T5ocke8UwavtgUHm+Cg collected ($7.40)
Seat 7: xyQ4CeZa3ug3ompz+5xSTg folded before Flop (didn't bet)
Seat 8: bXpVeaSTPBFSPJmeXxO7nw folded before Flop (didn't bet)
Seat 9: 5JJVDlaiMnB004o/RqbZZQ (button) folded before Flop (didn't bet)



PokerStars Game #59938208036:  Hold'em No Limit ($0.25/$0.50) - 2009/07/01 0:09:31 ET
Table 'E7bWJ45aoFXRpyRv2gw+Ig' 2-max Seat #1 is the button
Seat 1: FRkiRasEGlHUeLrEl+k/nA ($73.05 in chips)
Seat 2: 3Wro85I7472vJ4Wkpneo9A ($50.85 in chips)
FRkiRasEGlHUeLrEl+k/nA: posts small blind $0.25
3Wro85I7472vJ4Wkpneo9A: posts big blind $0.50
*** HOLE CARDS ***
FRkiRasEGlHUeLrEl+k/nA: raises $1 to $1.50
3Wro85I7472vJ4Wkpneo9A: folds
FRkiRasEGlHUeLrEl+k/nA collected $1 from pot
FRkiRasEGlHUeLrEl+k/nA: doesn't show hand
*** SUMMARY ***
Total pot $1 | Rake $0
Seat 1: FRkiRasEGlHUeLrEl+k/nA (button) (small blind) collected ($1)
Seat 2: 3Wro85I7472vJ4Wkpneo9A (big blind) folded before Flop



PokerStars Game #59938207712:  Hold'em No Limit ($0.25/$0.50) - 2009/07/01 0:09:31 ET
Table 'Vdlc9wqYcHTUhtdyN7CuJw' 2-max Seat #1 is the button
Seat 1: yBO+mXB6m/rCft2ErwGf/Q ($94.45 in chips)
Seat 2: sa0qgETiL3HNbdfGlnKHTA ($18.30 in chips)
yBO+mXB6m/rCft2ErwGf/Q: posts small blind $0.25
sa0qgETiL3HNbdfGlnKHTA: posts big blind $0.50
*** HOLE CARDS ***
yBO+mXB6m/rCft2ErwGf/Q: calls $0.25
sa0qgETiL3HNbdfGlnKHTA: checks
*** FLOP *** [6h Ac Th]
sa0qgETiL3HNbdfGlnKHTA: checks
yBO+mXB6m/rCft2ErwGf/Q: bets $0.50
sa0qgETiL3HNbdfGlnKHTA: folds
yBO+mXB6m/rCft2ErwGf/Q collected $0.95 from pot
*** SUMMARY ***
Total pot $1 | Rake $0.05
Board [6h Ac Th]
Seat 1: yBO+mXB6m/rCft2ErwGf/Q (button) (small blind) collected ($0.95)
Seat 2: sa0qgETiL3HNbdfGlnKHTA (big blind) folded on the Flop



PokerStars Game #59938207568:  Hold'em No Limit ($0.25/$0.50) - 2009/07/01 0:09:31 ET
Table '5EmHi+fnatGQQShcNmzOZQ' 6-max Seat #5 is the button
Seat 1: SwPczQo3cOtwEzhJrfO2cQ ($25.50 in chips)
Seat 2: APwvTk5XojDXGoQLb4O5iA ($27.35 in chips)
Seat 3: J8dF2sYMvXUmAGUuSW9kwg ($34.55 in chips)
Seat 4: mFTuMjESuBcXHQ1ePkg/8A ($17.65 in chips)
Seat 5: kxPhs4ePFqMy52CInAJ2aw ($69.55 in chips)
Seat 6: 686aeHikcJlgKkSuIFdcXQ ($114.95 in chips)
686aeHikcJlgKkSuIFdcXQ: posts small blind $0.25
SwPczQo3cOtwEzhJrfO2cQ: posts big blind $0.50
*** HOLE CARDS ***
APwvTk5XojDXGoQLb4O5iA: folds
J8dF2sYMvXUmAGUuSW9kwg: folds
mFTuMjESuBcXHQ1ePkg/8A: raises $1 to $1.50
kxPhs4ePFqMy52CInAJ2aw: folds
686aeHikcJlgKkSuIFdcXQ: folds
SwPczQo3cOtwEzhJrfO2cQ: calls $1
*** FLOP *** [3d 4d 8c]
SwPczQo3cOtwEzhJrfO2cQ: checks
mFTuMjESuBcXHQ1ePkg/8A: bets $1.50
SwPczQo3cOtwEzhJrfO2cQ: calls $1.50
*** TURN *** [3d 4d 8c] [Kd]
SwPczQo3cOtwEzhJrfO2cQ: checks
mFTuMjESuBcXHQ1ePkg/8A: bets $2.50
SwPczQo3cOtwEzhJrfO2cQ: folds
mFTuMjESuBcXHQ1ePkg/8A collected $5.95 from pot
mFTuMjESuBcXHQ1ePkg/8A: doesn't show hand
*** SUMMARY ***
Total pot $6.25 | Rake $0.30
Board [3d 4d 8c Kd]
Seat 1: SwPczQo3cOtwEzhJrfO2cQ (big blind) folded on the Turn
Seat 2: APwvTk5XojDXGoQLb4O5iA folded before Flop (didn't bet)
Seat 3: J8dF2sYMvXUmAGUuSW9kwg folded before Flop (didn't bet)
Seat 4: mFTuMjESuBcXHQ1ePkg/8A collected ($5.95)
Seat 5: kxPhs4ePFqMy52CInAJ2aw (button) folded before Flop (didn't bet)
Seat 6: 686aeHikcJlgKkSuIFdcXQ (small blind) folded before Flop



PokerStars Game #59938208530:  Hold'em No Limit ($0.25/$0.50) - 2009/07/01 0:09:32 ET
Table '+dXkOAQyS8j9PQZusUTMpg' 2-max Seat #2 is the button
Seat 1: XFa6sBGjP2gxoIvxR3fZIg ($77.75 in chips)
Seat 2: 5IBeOgaApY1Bvzv2P8X4EA ($35.45 in chips)
5IBeOgaApY1Bvzv2P8X4EA: posts small blind $0.25
XFa6sBGjP2gxoIvxR3fZIg: posts big blind $0.50
*** HOLE CARDS ***
5IBeOgaApY1Bvzv2P8X4EA: folds
XFa6sBGjP2gxoIvxR3fZIg collected $0.50 from pot
XFa6sBGjP2gxoIvxR3fZIg: doesn't show hand
*** SUMMARY ***
Total pot $0.50 | Rake $0
Seat 1: XFa6sBGjP2gxoIvxR3fZIg (big blind) collected ($0.50)
Seat 2: 5IBeOgaApY1Bvzv2P8X4EA (button) (small blind) folded before Flop



PokerStars Game #59938209236:  Hold'em No Limit ($0.25/$0.50) - 2009/07/01 0:09:33 ET
Table 'mTxf8gPLgffN3Iwfm7Icfg' 2-max Seat #2 is the button
Seat 1: Do9Rlu1R5u/AcRtMTl8SYg ($67.05 in chips)
Seat 2: EMc5LPgVaded4Qc77vm0fw ($47.20 in chips)
EMc5LPgVaded4Qc77vm0fw: posts small blind $0.25
Do9Rlu1R5u/AcRtMTl8SYg: posts big blind $0.50
*** HOLE CARDS ***
EMc5LPgVaded4Qc77vm0fw: calls $0.25
Do9Rlu1R5u/AcRtMTl8SYg: checks
*** FLOP *** [4s Kh As]
Do9Rlu1R5u/AcRtMTl8SYg: checks
EMc5LPgVaded4Qc77vm0fw: bets $1
Do9Rlu1R5u/AcRtMTl8SYg: folds
EMc5LPgVaded4Qc77vm0fw collected $0.95 from pot
EMc5LPgVaded4Qc77vm0fw: doesn't show hand
*** SUMMARY ***
Total pot $1 | Rake $0.05
Board [4s Kh As]
Seat 1: Do9Rlu1R5u/AcRtMTl8SYg (big blind) folded on the Flop
Seat 2: EMc5LPgVaded4Qc77vm0fw (button) (small blind) collected ($0.95)



PokerStars Game #59938209178:  Hold'em No Limit ($0.25/$0.50) - 2009/07/01 0:09:33 ET
Table 'raOT4/ipuZgzjfKHC+jD9g' 2-max Seat #1 is the button
Seat 1: IuwLemwLhc9fvrwBGs0AMA ($7.60 in chips)
Seat 2: Udr5juWSWUgTu1NlRhjMdA ($15.75 in chips)
IuwLemwLhc9fvrwBGs0AMA: posts small blind $0.25
Udr5juWSWUgTu1NlRhjMdA: posts big blind $0.50
*** HOLE CARDS ***
IuwLemwLhc9fvrwBGs0AMA: raises $1 to $1.50
Udr5juWSWUgTu1NlRhjMdA: folds
IuwLemwLhc9fvrwBGs0AMA collected $1 from pot
IuwLemwLhc9fvrwBGs0AMA: doesn't show hand
*** SUMMARY ***
Total pot $1 | Rake $0
Seat 1: IuwLemwLhc9fvrwBGs0AMA (button) (small blind) collected ($1)
Seat 2: Udr5juWSWUgTu1NlRhjMdA (big blind) folded before Flop



PokerStars Game #59938208994:  Hold'em No Limit ($0.25/$0.50) - 2009/07/01 0:09:33 ET
Table 'PALRfuH85dr5IkDfdv6new' 9-max Seat #3 is the button
Seat 1: SKnJuWHScqetA/qG5p+wCg ($33 in chips)
Seat 2: 9r7ZoBbAJj5IeyZ0q9BdzA ($23.90 in chips)
Seat 3: 50QWoELmpmHFrFIlWMJo9g ($94.20 in chips)
Seat 4: /gaxz7F0MIjSN3t7ZPKwAA ($42.10 in chips)
Seat 5: jSSGUXdNFAZA3QCvTcUMQw ($43.05 in chips)
Seat 6: EiWj2MAl8RNcPhTkzz24Mw ($27.90 in chips)
Seat 7: 3NcyXvr39gnK+KbTq7ezyA ($33.45 in chips)
Seat 8: NkS+CseUKx4XHszWq0PXEQ ($43.10 in chips)
Seat 9: CIrAX/m6o7jYmKOAjJXv4Q ($25.05 in chips)
/gaxz7F0MIjSN3t7ZPKwAA: posts small blind $0.25
jSSGUXdNFAZA3QCvTcUMQw: posts big blind $0.50
*** HOLE CARDS ***
EiWj2MAl8RNcPhTkzz24Mw: folds
3NcyXvr39gnK+KbTq7ezyA: calls $0.50
NkS+CseUKx4XHszWq0PXEQ: folds
CIrAX/m6o7jYmKOAjJXv4Q: folds
SKnJuWHScqetA/qG5p+wCg: folds
9r7ZoBbAJj5IeyZ0q9BdzA: calls $0.50
50QWoELmpmHFrFIlWMJo9g: folds
/gaxz7F0MIjSN3t7ZPKwAA: calls $0.25
jSSGUXdNFAZA3QCvTcUMQw: checks
*** FLOP *** [Jh As Qs]
/gaxz7F0MIjSN3t7ZPKwAA: checks
jSSGUXdNFAZA3QCvTcUMQw: checks
3NcyXvr39gnK+KbTq7ezyA: bets $1.50
9r7ZoBbAJj5IeyZ0q9BdzA: folds
/gaxz7F0MIjSN3t7ZPKwAA: folds
jSSGUXdNFAZA3QCvTcUMQw: folds
3NcyXvr39gnK+KbTq7ezyA collected $1.90 from pot
*** SUMMARY ***
Total pot $2 | Rake $0.10
Board [Jh As Qs]
Seat 1: SKnJuWHScqetA/qG5p+wCg folded before Flop (didn't bet)
Seat 2: 9r7ZoBbAJj5IeyZ0q9BdzA folded on the Flop
Seat 3: 50QWoELmpmHFrFIlWMJo9g (button) folded before Flop (didn't bet)
Seat 4: /gaxz7F0MIjSN3t7ZPKwAA (small blind) folded on the Flop
Seat 5: jSSGUXdNFAZA3QCvTcUMQw (big blind) folded on the Flop
Seat 6: EiWj2MAl8RNcPhTkzz24Mw folded before Flop (didn't bet)
Seat 7: 3NcyXvr39gnK+KbTq7ezyA collected ($1.90)
Seat 8: NkS+CseUKx4XHszWq0PXEQ folded before Flop (didn't bet)
Seat 9: CIrAX/m6o7jYmKOAjJXv4Q folded before Flop (didn't bet)



PokerStars Game #59938210582:  Hold'em No Limit ($0.25/$0.50) - 2009/07/01 0:09:35 ET
Table 'YsnnHkamRzYqMOr2FlLY4w' 6-max Seat #5 is the button
Seat 1: crjGpJEzSZgD38FoE3VMGg ($54.65 in chips)
Seat 3: I+pG2m/dD5iYdbg9qx572g ($21.25 in chips)
Seat 4: 7Fue572p4ZIC85AJMQvaQw ($53.40 in chips)
Seat 5: lcQ7uuLf+WLGGy4Ve6VKKA ($39.85 in chips)
Seat 6: YmWlPGOKFuJSoJZPW8a8IA ($53.65 in chips)
YmWlPGOKFuJSoJZPW8a8IA: posts small blind $0.25
crjGpJEzSZgD38FoE3VMGg: posts big blind $0.50
vnRgOasQNKOR7gLXwRQ+ww: sits out
*** HOLE CARDS ***
I+pG2m/dD5iYdbg9qx572g: folds
7Fue572p4ZIC85AJMQvaQw: calls $0.50
lcQ7uuLf+WLGGy4Ve6VKKA: calls $0.50
YmWlPGOKFuJSoJZPW8a8IA: folds
crjGpJEzSZgD38FoE3VMGg: checks
*** FLOP *** [Js Kc As]
crjGpJEzSZgD38FoE3VMGg: checks
7Fue572p4ZIC85AJMQvaQw: checks
lcQ7uuLf+WLGGy4Ve6VKKA: checks
*** TURN *** [Js Kc As] [4c]
crjGpJEzSZgD38FoE3VMGg: checks
7Fue572p4ZIC85AJMQvaQw: bets $0.50
lcQ7uuLf+WLGGy4Ve6VKKA: raises $1.50 to $2
crjGpJEzSZgD38FoE3VMGg: folds
7Fue572p4ZIC85AJMQvaQw: calls $1.50
*** RIVER *** [Js Kc As 4c] [7h]
7Fue572p4ZIC85AJMQvaQw: checks
lcQ7uuLf+WLGGy4Ve6VKKA: bets $2.50
7Fue572p4ZIC85AJMQvaQw: folds
lcQ7uuLf+WLGGy4Ve6VKKA collected $5.50 from pot
lcQ7uuLf+WLGGy4Ve6VKKA: doesn't show hand
*** SUMMARY ***
Total pot $5.75 | Rake $0.25
Board [Js Kc As 4c 7h]
Seat 1: crjGpJEzSZgD38FoE3VMGg (big blind) folded on the Turn
Seat 3: I+pG2m/dD5iYdbg9qx572g folded before Flop (didn't bet)
Seat 4: 7Fue572p4ZIC85AJMQvaQw folded on the River
Seat 5: lcQ7uuLf+WLGGy4Ve6VKKA (button) collected ($5.50)
Seat 6: YmWlPGOKFuJSoJZPW8a8IA (small blind) folded before Flop



PokerStars Game #59938213210:  Hold'em No Limit ($0.25/$0.50) - 2009/07/01 0:09:39 ET
Table '+dXkOAQyS8j9PQZusUTMpg' 2-max Seat #1 is the button
Seat 1: XFa6sBGjP2gxoIvxR3fZIg ($78 in chips)
Seat 2: 5IBeOgaApY1Bvzv2P8X4EA ($35.20 in chips)
XFa6sBGjP2gxoIvxR3fZIg: posts small blind $0.25
5IBeOgaApY1Bvzv2P8X4EA: posts big blind $0.50
*** HOLE CARDS ***
XFa6sBGjP2gxoIvxR3fZIg: raises $1 to $1.50
5IBeOgaApY1Bvzv2P8X4EA: raises $2 to $3.50
XFa6sBGjP2gxoIvxR3fZIg: calls $2
*** FLOP *** [9c 7d 6c]
5IBeOgaApY1Bvzv2P8X4EA: bets $2.50
XFa6sBGjP2gxoIvxR3fZIg: calls $2.50
*** TURN *** [9c 7d 6c] [Jh]
5IBeOgaApY1Bvzv2P8X4EA: bets $4.50
XFa6sBGjP2gxoIvxR3fZIg: folds
5IBeOgaApY1Bvzv2P8X4EA collected $11.50 from pot
5IBeOgaApY1Bvzv2P8X4EA: doesn't show hand
*** SUMMARY ***
Total pot $12 | Rake $0.50
Board [9c 7d 6c Jh]
Seat 1: XFa6sBGjP2gxoIvxR3fZIg (button) (small blind) folded on the Turn
Seat 2: 5IBeOgaApY1Bvzv2P8X4EA (big blind) collected ($11.50)



PokerStars Game #59938214110:  Hold'em No Limit ($0.25/$0.50) - 2009/07/01 0:09:40 ET
Table 'E7bWJ45aoFXRpyRv2gw+Ig' 2-max Seat #2 is the button
Seat 1: FRkiRasEGlHUeLrEl+k/nA ($73.55 in chips)
Seat 2: 3Wro85I7472vJ4Wkpneo9A ($50.35 in chips)
3Wro85I7472vJ4Wkpneo9A: posts small blind $0.25
FRkiRasEGlHUeLrEl+k/nA: posts big blind $0.50
*** HOLE CARDS ***
3Wro85I7472vJ4Wkpneo9A: calls $0.25
FRkiRasEGlHUeLrEl+k/nA: checks
*** FLOP *** [4d 2h 8h]
FRkiRasEGlHUeLrEl+k/nA: checks
3Wro85I7472vJ4Wkpneo9A: bets $1
FRkiRasEGlHUeLrEl+k/nA: calls $1
*** TURN *** [4d 2h 8h] [6d]
FRkiRasEGlHUeLrEl+k/nA: checks
3Wro85I7472vJ4Wkpneo9A: checks
*** RIVER *** [4d 2h 8h 6d] [2s]
FRkiRasEGlHUeLrEl+k/nA: checks
3Wro85I7472vJ4Wkpneo9A: checks
*** SHOW DOWN ***
FRkiRasEGlHUeLrEl+k/nA: shows [4s Qh] (two pair, Fours and Deuces)
3Wro85I7472vJ4Wkpneo9A: mucks hand
FRkiRasEGlHUeLrEl+k/nA collected $2.90 from pot
*** SUMMARY ***
Total pot $3 | Rake $0.10
Board [4d 2h 8h 6d 2s]
Seat 1: FRkiRasEGlHUeLrEl+k/nA (big blind) showed [4s Qh] and won ($2.90) with two pair, Fours and Deuces
Seat 2: 3Wro85I7472vJ4Wkpneo9A (button) (small blind) mucked



PokerStars Game #59938219132:  Hold'em No Limit ($0.25/$0.50) - 2009/07/01 0:09:47 ET
Table 'SsXEKOwKN+jE3etfusqUqA' 2-max Seat #2 is the button
Seat 1: 618rKeLrz/avGNOLULHHVQ ($53 in chips)
Seat 2: XfRhywXA6Br+jID1oGeo8A ($252.40 in chips)
XfRhywXA6Br+jID1oGeo8A: posts small blind $0.25
618rKeLrz/avGNOLULHHVQ: posts big blind $0.50
*** HOLE CARDS ***
XfRhywXA6Br+jID1oGeo8A: folds
618rKeLrz/avGNOLULHHVQ collected $0.50 from pot
618rKeLrz/avGNOLULHHVQ: doesn't show hand
*** SUMMARY ***
Total pot $0.50 | Rake $0
Seat 1: 618rKeLrz/avGNOLULHHVQ (big blind) collected ($0.50)
Seat 2: XfRhywXA6Br+jID1oGeo8A (button) (small blind) folded before Flop



PokerStars Game #59938219058:  Hold'em No Limit ($0.25/$0.50) - 2009/07/01 0:09:47 ET
Table 'raOT4/ipuZgzjfKHC+jD9g' 2-max Seat #2 is the button
Seat 1: IuwLemwLhc9fvrwBGs0AMA ($8.10 in chips)
Seat 2: Udr5juWSWUgTu1NlRhjMdA ($15.25 in chips)
Udr5juWSWUgTu1NlRhjMdA: posts small blind $0.25
IuwLemwLhc9fvrwBGs0AMA: posts big blind $0.50
*** HOLE CARDS ***
Udr5juWSWUgTu1NlRhjMdA: folds
IuwLemwLhc9fvrwBGs0AMA collected $0.50 from pot
*** SUMMARY ***
Total pot $0.50 | Rake $0
Seat 1: IuwLemwLhc9fvrwBGs0AMA (big blind) collected ($0.50)
Seat 2: Udr5juWSWUgTu1NlRhjMdA (button) (small blind) folded before Flop



PokerStars Game #59938219572:  Hold'em No Limit ($0.25/$0.50) - 2009/07/01 0:09:48 ET
Table 'c/CRn+68J3Y8KxD5g1ek2Q' 2-max Seat #2 is the button
Seat 1: 46qCyJ6evTkHo9al5sBMNA ($331.55 in chips)
Seat 2: BypVLsYQt3ePFm2xQL/dOA ($54.85 in chips)
BypVLsYQt3ePFm2xQL/dOA: posts small blind $0.25
46qCyJ6evTkHo9al5sBMNA: posts big blind $0.50
*** HOLE CARDS ***
BypVLsYQt3ePFm2xQL/dOA: raises $0.50 to $1
46qCyJ6evTkHo9al5sBMNA: folds
BypVLsYQt3ePFm2xQL/dOA collected $1 from pot
BypVLsYQt3ePFm2xQL/dOA: doesn't show hand
*** SUMMARY ***
Total pot $1 | Rake $0
Seat 1: 46qCyJ6evTkHo9al5sBMNA (big blind) folded before Flop
Seat 2: BypVLsYQt3ePFm2xQL/dOA (button) (small blind) collected ($1)



PokerStars Game #59938219644:  Hold'em No Limit ($0.25/$0.50) - 2009/07/01 0:09:48 ET
Table 'otvGDROEDdqsabxskT79qg' 9-max Seat #1 is the button
Seat 1: LM/g4VPDfD+0JhpH9Q/3fw ($29.15 in chips)
Seat 2: cCjTzH9jio8607WzjcfXlg ($46.10 in chips)
Seat 3: +k7T5ocke8UwavtgUHm+Cg ($52.35 in chips)
Seat 4: MG90wfSJZnOejs/KD3vlQQ ($50 in chips)
Seat 5: YPo1oggovmqSREegekaQYw ($16.80 in chips)
Seat 7: C7+tBppJrKgd/r+tuKUIpA ($40.85 in chips)
Seat 9: KcY3X8YpD74Kw1RHkx/g4A ($38.10 in chips)
cCjTzH9jio8607WzjcfXlg: posts small blind $0.25
+k7T5ocke8UwavtgUHm+Cg: posts big blind $0.50
WpvT3OUSiZlpvs+mPXFqtQ: sits out
*** HOLE CARDS ***
MG90wfSJZnOejs/KD3vlQQ: folds
YPo1oggovmqSREegekaQYw: raises $0.50 to $1
C7+tBppJrKgd/r+tuKUIpA: folds
KcY3X8YpD74Kw1RHkx/g4A: folds
LM/g4VPDfD+0JhpH9Q/3fw: folds
cCjTzH9jio8607WzjcfXlg: folds
+k7T5ocke8UwavtgUHm+Cg: calls $0.50
*** FLOP *** [Jh 9h Js]
+k7T5ocke8UwavtgUHm+Cg: bets $1
YPo1oggovmqSREegekaQYw: raises $2 to $3
+k7T5ocke8UwavtgUHm+Cg: calls $2
*** TURN *** [Jh 9h Js] [3d]
+k7T5ocke8UwavtgUHm+Cg: checks
YPo1oggovmqSREegekaQYw: bets $12.80 and is all-in
+k7T5ocke8UwavtgUHm+Cg: calls $12.80
*** RIVER *** [Jh 9h Js 3d] [4c]
*** SHOW DOWN ***
+k7T5ocke8UwavtgUHm+Cg: shows [8d Jd] (three of a kind, Jacks)
YPo1oggovmqSREegekaQYw: shows [Jc Ac] (three of a kind, Jacks - Ace kicker)
YPo1oggovmqSREegekaQYw collected $32.20 from pot
*** SUMMARY ***
Total pot $33.85 | Rake $1.65
Board [Jh 9h Js 3d 4c]
Seat 1: LM/g4VPDfD+0JhpH9Q/3fw (button) folded before Flop (didn't bet)
Seat 2: cCjTzH9jio8607WzjcfXlg (small blind) folded before Flop
Seat 3: +k7T5ocke8UwavtgUHm+Cg (big blind) showed [8d Jd] and lost with three of a kind, Jacks
Seat 4: MG90wfSJZnOejs/KD3vlQQ folded before Flop (didn't bet)
Seat 5: YPo1oggovmqSREegekaQYw showed [Jc Ac] and won ($32.20) with three of a kind, Jacks
Seat 7: C7+tBppJrKgd/r+tuKUIpA folded before Flop (didn't bet)
Seat 9: KcY3X8YpD74Kw1RHkx/g4A folded before Flop (didn't bet)



PokerStars Game #59938219892:  Hold'em No Limit ($0.25/$0.50) - 2009/07/01 0:09:48 ET
Table 'tpZbcIvqh/6WmfR/i5IE3A' 9-max Seat #4 is the button
Seat 1: nV/P1jFY/CFMXOLWu7pYmA ($13.70 in chips)
Seat 2: M+7+BTmX5vZatHVuoRB1nA ($42.90 in chips)
Seat 3: 3w0FbBQAKwQODwenKwZxXw ($78.40 in chips)
Seat 4: zE9cVigS2nW/Ljy4K4bUQA ($30 in chips)
Seat 5: 9r7ZoBbAJj5IeyZ0q9BdzA ($12.40 in chips)
Seat 6: E2518gp4aFz1+kAgmGqeEg ($11.20 in chips)
Seat 7: wIZ377kjl2fHFGnS93o6bw ($17.15 in chips)
Seat 8: bXpVeaSTPBFSPJmeXxO7nw ($9.85 in chips)
9r7ZoBbAJj5IeyZ0q9BdzA: posts small blind $0.25
E2518gp4aFz1+kAgmGqeEg: posts big blind $0.50
*** HOLE CARDS ***
wIZ377kjl2fHFGnS93o6bw: folds
bXpVeaSTPBFSPJmeXxO7nw: folds
nV/P1jFY/CFMXOLWu7pYmA: folds
M+7+BTmX5vZatHVuoRB1nA: folds
3w0FbBQAKwQODwenKwZxXw: folds
zE9cVigS2nW/Ljy4K4bUQA: raises $1 to $1.50
9r7ZoBbAJj5IeyZ0q9BdzA: folds
E2518gp4aFz1+kAgmGqeEg: folds
zE9cVigS2nW/Ljy4K4bUQA collected $1.25 from pot
zE9cVigS2nW/Ljy4K4bUQA: doesn't show hand
*** SUMMARY ***
Total pot $1.25 | Rake $0
Seat 1: nV/P1jFY/CFMXOLWu7pYmA folded before Flop (didn't bet)
Seat 2: M+7+BTmX5vZatHVuoRB1nA folded before Flop (didn't bet)
Seat 3: 3w0FbBQAKwQODwenKwZxXw folded before Flop (didn't bet)
Seat 4: zE9cVigS2nW/Ljy4K4bUQA (button) collected ($1.25)
Seat 5: 9r7ZoBbAJj5IeyZ0q9BdzA (small blind) folded before Flop
Seat 6: E2518gp4aFz1+kAgmGqeEg (big blind) folded before Flop
Seat 7: wIZ377kjl2fHFGnS93o6bw folded before Flop (didn't bet)
Seat 8: bXpVeaSTPBFSPJmeXxO7nw folded before Flop (didn't bet)



PokerStars Game #59938220520:  Hold'em No Limit ($0.25/$0.50) - 2009/07/01 0:09:49 ET
Table 'Vdlc9wqYcHTUhtdyN7CuJw' 2-max Seat #2 is the button
Seat 1: yBO+mXB6m/rCft2ErwGf/Q ($94.90 in chips)
Seat 2: sa0qgETiL3HNbdfGlnKHTA ($17.80 in chips)
sa0qgETiL3HNbdfGlnKHTA: posts small blind $0.25
yBO+mXB6m/rCft2ErwGf/Q: posts big blind $0.50
*** HOLE CARDS ***
sa0qgETiL3HNbdfGlnKHTA: folds
yBO+mXB6m/rCft2ErwGf/Q collected $0.50 from pot
*** SUMMARY ***
Total pot $0.50 | Rake $0
Seat 1: yBO+mXB6m/rCft2ErwGf/Q (big blind) collected ($0.50)
Seat 2: sa0qgETiL3HNbdfGlnKHTA (button) (small blind) folded before Flop



PokerStars Game #59938221792:  Hold'em No Limit ($0.25/$0.50) - 2009/07/01 0:09:51 ET
Table 'mTxf8gPLgffN3Iwfm7Icfg' 2-max Seat #1 is the button
Seat 1: Do9Rlu1R5u/AcRtMTl8SYg ($66.55 in chips)
Seat 2: EMc5LPgVaded4Qc77vm0fw ($47.65 in chips)
Do9Rlu1R5u/AcRtMTl8SYg: posts small blind $0.25
EMc5LPgVaded4Qc77vm0fw: posts big blind $0.50
*** HOLE CARDS ***
Do9Rlu1R5u/AcRtMTl8SYg: folds
EMc5LPgVaded4Qc77vm0fw collected $0.50 from pot
EMc5LPgVaded4Qc77vm0fw: doesn't show hand
*** SUMMARY ***
Total pot $0.50 | Rake $0
Seat 1: Do9Rlu1R5u/AcRtMTl8SYg (button) (small blind) folded before Flop
Seat 2: EMc5LPgVaded4Qc77vm0fw (big blind) collected ($0.50)



PokerStars Game #59938223500:  Hold'em No Limit ($0.25/$0.50) - 2009/07/01 0:09:53 ET
Table 'SsXEKOwKN+jE3etfusqUqA' 2-max Seat #1 is the button
Seat 1: 618rKeLrz/avGNOLULHHVQ ($53.25 in chips)
Seat 2: XfRhywXA6Br+jID1oGeo8A ($252.15 in chips)
618rKeLrz/avGNOLULHHVQ: posts small blind $0.25
XfRhywXA6Br+jID1oGeo8A: posts big blind $0.50
*** HOLE CARDS ***
618rKeLrz/avGNOLULHHVQ: folds
XfRhywXA6Br+jID1oGeo8A collected $0.50 from pot
*** SUMMARY ***
Total pot $0.50 | Rake $0
Seat 1: 618rKeLrz/avGNOLULHHVQ (button) (small blind) folded before Flop
Seat 2: XfRhywXA6Br+jID1oGeo8A (big blind) collected ($0.50)



PokerStars Game #59938223750:  Hold'em No Limit ($0.25/$0.50) - 2009/07/01 0:09:53 ET
Table 'raOT4/ipuZgzjfKHC+jD9g' 2-max Seat #1 is the button
Seat 1: IuwLemwLhc9fvrwBGs0AMA ($8.35 in chips)
Seat 2: Udr5juWSWUgTu1NlRhjMdA ($15 in chips)
IuwLemwLhc9fvrwBGs0AMA: posts small blind $0.25
Udr5juWSWUgTu1NlRhjMdA: posts big blind $0.50
*** HOLE CARDS ***
IuwLemwLhc9fvrwBGs0AMA: folds
Udr5juWSWUgTu1NlRhjMdA collected $0.50 from pot
Udr5juWSWUgTu1NlRhjMdA: doesn't show hand
*** SUMMARY ***
Total pot $0.50 | Rake $0
Seat 1: IuwLemwLhc9fvrwBGs0AMA (button) (small blind) folded before Flop
Seat 2: Udr5juWSWUgTu1NlRhjMdA (big blind) collected ($0.50)



PokerStars Game #59938224032:  Hold'em No Limit ($0.25/$0.50) - 2009/07/01 0:09:54 ET
Table 'tyR5AZNKV8Aadbrnrnlg7g' 6-max Seat #5 is the button
Seat 1: R+KjpH/wSjDLhtIy9+edNA ($36.25 in chips)
Seat 2: 58zdeSBSuSFX/qZfhc7YmA ($31.20 in chips)
Seat 3: jUhx+m+V7qfbLZTjgwZByg ($47.85 in chips)
Seat 4: Rt6KgtZ8YaJoTc3FPim00w ($50 in chips)
Seat 5: EIg3r3fRFKG2HhgpDlIJHg ($36.45 in chips)
Seat 6: DMQLAmut/l19xN5STQndFg ($2.50 in chips)
DMQLAmut/l19xN5STQndFg: posts small blind $0.25
R+KjpH/wSjDLhtIy9+edNA: posts big blind $0.50
*** HOLE CARDS ***
58zdeSBSuSFX/qZfhc7YmA: folds
jUhx+m+V7qfbLZTjgwZByg: folds
Rt6KgtZ8YaJoTc3FPim00w: raises $1 to $1.50
EIg3r3fRFKG2HhgpDlIJHg: folds
DMQLAmut/l19xN5STQndFg: raises $1 to $2.50 and is all-in
R+KjpH/wSjDLhtIy9+edNA: folds
Rt6KgtZ8YaJoTc3FPim00w: calls $1
*** FLOP *** [8d 5s Ts]
*** TURN *** [8d 5s Ts] [Kd]
*** RIVER *** [8d 5s Ts Kd] [7c]
*** SHOW DOWN ***
DMQLAmut/l19xN5STQndFg: shows [Qs Jd] (high card King)
Rt6KgtZ8YaJoTc3FPim00w: shows [Kh Ad] (a pair of Kings)
Rt6KgtZ8YaJoTc3FPim00w collected $5.25 from pot
*** SUMMARY ***
Total pot $5.50 | Rake $0.25
Board [8d 5s Ts Kd 7c]
Seat 1: R+KjpH/wSjDLhtIy9+edNA (big blind) folded before Flop
Seat 2: 58zdeSBSuSFX/qZfhc7YmA folded before Flop (didn't bet)
Seat 3: jUhx+m+V7qfbLZTjgwZByg folded before Flop (didn't bet)
Seat 4: Rt6KgtZ8YaJoTc3FPim00w showed [Kh Ad] and won ($5.25) with a pair of Kings
Seat 5: EIg3r3fRFKG2HhgpDlIJHg (button) folded before Flop (didn't bet)
Seat 6: DMQLAmut/l19xN5STQndFg (small blind) showed [Qs Jd] and lost with high card King



PokerStars Game #59938225210:  Hold'em No Limit ($0.25/$0.50) - 2009/07/01 0:09:55 ET
Table 'Vdlc9wqYcHTUhtdyN7CuJw' 2-max Seat #1 is the button
Seat 1: yBO+mXB6m/rCft2ErwGf/Q ($95.15 in chips)
Seat 2: sa0qgETiL3HNbdfGlnKHTA ($17.55 in chips)
yBO+mXB6m/rCft2ErwGf/Q: posts small blind $0.25
sa0qgETiL3HNbdfGlnKHTA: posts big blind $0.50
*** HOLE CARDS ***
yBO+mXB6m/rCft2ErwGf/Q: calls $0.25
sa0qgETiL3HNbdfGlnKHTA: checks
*** FLOP *** [3s Qh Jc]
sa0qgETiL3HNbdfGlnKHTA: checks
yBO+mXB6m/rCft2ErwGf/Q: checks
*** TURN *** [3s Qh Jc] [Jh]
sa0qgETiL3HNbdfGlnKHTA: checks
yBO+mXB6m/rCft2ErwGf/Q: checks
*** RIVER *** [3s Qh Jc Jh] [2d]
sa0qgETiL3HNbdfGlnKHTA: checks
yBO+mXB6m/rCft2ErwGf/Q: bets $0.50
sa0qgETiL3HNbdfGlnKHTA: folds
yBO+mXB6m/rCft2ErwGf/Q collected $0.95 from pot
*** SUMMARY ***
Total pot $1 | Rake $0.05
Board [3s Qh Jc Jh 2d]
Seat 1: yBO+mXB6m/rCft2ErwGf/Q (button) (small blind) collected ($0.95)
Seat 2: sa0qgETiL3HNbdfGlnKHTA (big blind) folded on the River



PokerStars Game #59938224644:  Hold'em No Limit ($0.25/$0.50) - 2009/07/01 0:09:55 ET
Table 'BCN5su+SsXiy1zRMJi0SJw' 6-max Seat #4 is the button
Seat 1: WyeokAqR0q9nADSkWpbxHw ($40.65 in chips)
Seat 2: QfV2JJlmEKgD5jYPV+a33A ($159.65 in chips)
Seat 3: L309C3uyA1tkWSOh/QvjHw ($21.65 in chips)
Seat 4: 6Wb8PlO2kM4fnSim7p4Mrw ($14.30 in chips)
Seat 5: TTx3CHxyi0SObcHyMJRp5w ($33.50 in chips)
TTx3CHxyi0SObcHyMJRp5w: posts small blind $0.25
WyeokAqR0q9nADSkWpbxHw: posts big blind $0.50
*** HOLE CARDS ***
QfV2JJlmEKgD5jYPV+a33A: raises $1.50 to $2
L309C3uyA1tkWSOh/QvjHw: folds
6Wb8PlO2kM4fnSim7p4Mrw: raises $1.50 to $3.50
TTx3CHxyi0SObcHyMJRp5w: folds
WyeokAqR0q9nADSkWpbxHw: folds
QfV2JJlmEKgD5jYPV+a33A: calls $1.50
*** FLOP *** [Js 4d Td]
QfV2JJlmEKgD5jYPV+a33A: checks
6Wb8PlO2kM4fnSim7p4Mrw: bets $2
QfV2JJlmEKgD5jYPV+a33A: raises $10 to $12
6Wb8PlO2kM4fnSim7p4Mrw: calls $8.80 and is all-in
*** TURN *** [Js 4d Td] [2c]
*** RIVER *** [Js 4d Td 2c] [5d]
*** SHOW DOWN ***
QfV2JJlmEKgD5jYPV+a33A: shows [Jd 9d] (a flush, Jack high)
6Wb8PlO2kM4fnSim7p4Mrw: mucks hand
QfV2JJlmEKgD5jYPV+a33A collected $27.90 from pot
*** SUMMARY ***
Total pot $29.35 | Rake $1.45
Board [Js 4d Td 2c 5d]
Seat 1: WyeokAqR0q9nADSkWpbxHw (big blind) folded before Flop
Seat 2: QfV2JJlmEKgD5jYPV+a33A showed [Jd 9d] and won ($27.90) with a flush, Jack high
Seat 3: L309C3uyA1tkWSOh/QvjHw folded before Flop (didn't bet)
Seat 4: 6Wb8PlO2kM4fnSim7p4Mrw (button) mucked
Seat 5: TTx3CHxyi0SObcHyMJRp5w (small blind) folded before Flop



PokerStars Game #59938226146:  Hold'em No Limit ($0.25/$0.50) - 2009/07/01 0:09:57 ET
Table 'mTxf8gPLgffN3Iwfm7Icfg' 2-max Seat #2 is the button
Seat 1: Do9Rlu1R5u/AcRtMTl8SYg ($66.30 in chips)
Seat 2: EMc5LPgVaded4Qc77vm0fw ($47.90 in chips)
EMc5LPgVaded4Qc77vm0fw: posts small blind $0.25
Do9Rlu1R5u/AcRtMTl8SYg: posts big blind $0.50
*** HOLE CARDS ***
EMc5LPgVaded4Qc77vm0fw: folds
Do9Rlu1R5u/AcRtMTl8SYg collected $0.50 from pot
Do9Rlu1R5u/AcRtMTl8SYg: doesn't show hand
*** SUMMARY ***
Total pot $0.50 | Rake $0
Seat 1: Do9Rlu1R5u/AcRtMTl8SYg (big blind) collected ($0.50)
Seat 2: EMc5LPgVaded4Qc77vm0fw (button) (small blind) folded before Flop



PokerStars Game #59938226562:  Hold'em No Limit ($0.25/$0.50) - 2009/07/01 0:09:57 ET
Table 'c/CRn+68J3Y8KxD5g1ek2Q' 2-max Seat #1 is the button
Seat 1: 46qCyJ6evTkHo9al5sBMNA ($331.05 in chips)
Seat 2: BypVLsYQt3ePFm2xQL/dOA ($55.35 in chips)
46qCyJ6evTkHo9al5sBMNA: posts small blind $0.25
BypVLsYQt3ePFm2xQL/dOA: posts big blind $0.50
*** HOLE CARDS ***
46qCyJ6evTkHo9al5sBMNA: raises $1 to $1.50
BypVLsYQt3ePFm2xQL/dOA: calls $1
*** FLOP *** [3h 8c Jh]
BypVLsYQt3ePFm2xQL/dOA: checks
46qCyJ6evTkHo9al5sBMNA: checks
*** TURN *** [3h 8c Jh] [Qd]
BypVLsYQt3ePFm2xQL/dOA: checks
46qCyJ6evTkHo9al5sBMNA: checks
*** RIVER *** [3h 8c Jh Qd] [7d]
BypVLsYQt3ePFm2xQL/dOA: checks
46qCyJ6evTkHo9al5sBMNA: checks
*** SHOW DOWN ***
BypVLsYQt3ePFm2xQL/dOA: shows [Kd 6d] (high card King)
46qCyJ6evTkHo9al5sBMNA: shows [6s Ad] (high card Ace)
46qCyJ6evTkHo9al5sBMNA collected $2.85 from pot
*** SUMMARY ***
Total pot $3 | Rake $0.15
Board [3h 8c Jh Qd 7d]
Seat 1: 46qCyJ6evTkHo9al5sBMNA (button) (small blind) showed [6s Ad] and won ($2.85) with high card Ace
Seat 2: BypVLsYQt3ePFm2xQL/dOA (big blind) showed [Kd 6d] and lost with high card King



PokerStars Game #59938227262:  Hold'em No Limit ($0.25/$0.50) - 2009/07/01 0:09:58 ET
Table '3FhG0gl3kMX3wBEEqj+wnQ' 9-max Seat #2 is the button
Seat 1: e0J9pdCNUDTCG031RnXqLA ($24.25 in chips)
Seat 2: 4dl3YNqZ6Houm2jZAzDmRg ($25.75 in chips)
Seat 3: bXpVeaSTPBFSPJmeXxO7nw ($10.25 in chips)
Seat 4: bz4LMfV0GGl/MJ/ABXuPmg ($16.90 in chips)
Seat 6: 5JJVDlaiMnB004o/RqbZZQ ($26.75 in chips)
Seat 7: 6XkTu4ahxzHnvjjc1R8YjQ ($9.25 in chips)
Seat 8: j3K/Jujr7PY4ZM2RZvlH6A ($57.35 in chips)
Seat 9: tzoXBDwkkPV/XPJPkf963Q ($13.10 in chips)
bXpVeaSTPBFSPJmeXxO7nw: posts small blind $0.25
bz4LMfV0GGl/MJ/ABXuPmg: posts big blind $0.50
XNMDwbXt/Q4jM99AXnbJDw: sits out
*** HOLE CARDS ***
5JJVDlaiMnB004o/RqbZZQ: folds
6XkTu4ahxzHnvjjc1R8YjQ: folds
j3K/Jujr7PY4ZM2RZvlH6A: folds
tzoXBDwkkPV/XPJPkf963Q: calls $0.50
e0J9pdCNUDTCG031RnXqLA: calls $0.50
4dl3YNqZ6Houm2jZAzDmRg: folds
bXpVeaSTPBFSPJmeXxO7nw: folds
bz4LMfV0GGl/MJ/ABXuPmg: checks
*** FLOP *** [Th 9c 6h]
bz4LMfV0GGl/MJ/ABXuPmg: checks
tzoXBDwkkPV/XPJPkf963Q: checks
e0J9pdCNUDTCG031RnXqLA: bets $1.75
bz4LMfV0GGl/MJ/ABXuPmg: folds
tzoXBDwkkPV/XPJPkf963Q: folds
e0J9pdCNUDTCG031RnXqLA collected $1.70 from pot
e0J9pdCNUDTCG031RnXqLA: doesn't show hand
*** SUMMARY ***
Total pot $1.75 | Rake $0.05
Board [Th 9c 6h]
Seat 1: e0J9pdCNUDTCG031RnXqLA collected ($1.70)
Seat 2: 4dl3YNqZ6Houm2jZAzDmRg (button) folded before Flop (didn't bet)
Seat 3: bXpVeaSTPBFSPJmeXxO7nw (small blind) folded before Flop
Seat 4: bz4LMfV0GGl/MJ/ABXuPmg (big blind) folded on the Flop
Seat 6: 5JJVDlaiMnB004o/RqbZZQ folded before Flop (didn't bet)
Seat 7: 6XkTu4ahxzHnvjjc1R8YjQ folded before Flop (didn't bet)
Seat 8: j3K/Jujr7PY4ZM2RZvlH6A folded before Flop (didn't bet)
Seat 9: tzoXBDwkkPV/XPJPkf963Q folded on the Flop



PokerStars Game #59938227716:  Hold'em No Limit ($0.25/$0.50) - 2009/07/01 0:09:59 ET
Table 'SsXEKOwKN+jE3etfusqUqA' 2-max Seat #2 is the button
Seat 1: 618rKeLrz/avGNOLULHHVQ ($53 in chips)
Seat 2: XfRhywXA6Br+jID1oGeo8A ($252.40 in chips)
XfRhywXA6Br+jID1oGeo8A: posts small blind $0.25
618rKeLrz/avGNOLULHHVQ: posts big blind $0.50
*** HOLE CARDS ***
XfRhywXA6Br+jID1oGeo8A: raises $1 to $1.50
618rKeLrz/avGNOLULHHVQ: raises $3.50 to $5
XfRhywXA6Br+jID1oGeo8A: calls $3.50
*** FLOP *** [4d Kd Qc]
618rKeLrz/avGNOLULHHVQ: bets $5
XfRhywXA6Br+jID1oGeo8A: calls $5
*** TURN *** [4d Kd Qc] [4s]
618rKeLrz/avGNOLULHHVQ: bets $11
618rKeLrz/avGNOLULHHVQ said, "call air?"
XfRhywXA6Br+jID1oGeo8A: calls $11
*** RIVER *** [4d Kd Qc 4s] [Qh]
618rKeLrz/avGNOLULHHVQ said, "maybe hit?"
618rKeLrz/avGNOLULHHVQ: bets $32 and is all-in
XfRhywXA6Br+jID1oGeo8A: calls $32
*** SHOW DOWN ***
618rKeLrz/avGNOLULHHVQ: shows [Ks Ah] (two pair, Kings and Queens)
XfRhywXA6Br+jID1oGeo8A: shows [6d 4c] (a full house, Fours full of Queens)
XfRhywXA6Br+jID1oGeo8A collected $105.50 from pot
618rKeLrz/avGNOLULHHVQ said, "ur general strategy"
*** SUMMARY ***
Total pot $106 | Rake $0.50
Board [4d Kd Qc 4s Qh]
Seat 1: 618rKeLrz/avGNOLULHHVQ (big blind) showed [Ks Ah] and lost with two pair, Kings and Queens
Seat 2: XfRhywXA6Br+jID1oGeo8A (button) (small blind) showed [6d 4c] and won ($105.50) with a full house, Fours full of Queens



PokerStars Game #59938228698:  Hold'em No Limit ($0.25/$0.50) - 2009/07/01 0:10:00 ET
Table 'hSTs/dUsYLgJQuF2Onp0MQ' 6-max Seat #2 is the button
Seat 1: lWwl5C/UZOsWNubdUqghZw ($70.70 in chips)
Seat 2: fyJOjf+Vdie/rpWb1WExIg ($16.80 in chips)
Seat 3: vQOrJuXbLC3UZDVklY9bOA ($22 in chips)
Seat 4: L0aIPg7qefDQjdJo3HCVEA ($14.45 in chips)
Seat 5: 686aeHikcJlgKkSuIFdcXQ ($60.65 in chips)
Seat 6: +laPa9P7BjZKKnR0n+OmvA ($0.55 in chips)
vQOrJuXbLC3UZDVklY9bOA: posts small blind $0.25
L0aIPg7qefDQjdJo3HCVEA: posts big blind $0.50
*** HOLE CARDS ***
686aeHikcJlgKkSuIFdcXQ: folds
lWwl5C/UZOsWNubdUqghZw is disconnected
+laPa9P7BjZKKnR0n+OmvA: raises $0.05 to $0.55 and is all-in
lWwl5C/UZOsWNubdUqghZw is connected
lWwl5C/UZOsWNubdUqghZw: folds
fyJOjf+Vdie/rpWb1WExIg: raises $1.45 to $2
vQOrJuXbLC3UZDVklY9bOA: folds
L0aIPg7qefDQjdJo3HCVEA: folds
*** FLOP *** [Kd Js As]
*** TURN *** [Kd Js As] [6s]
*** RIVER *** [Kd Js As 6s] [8s]
*** SHOW DOWN ***
+laPa9P7BjZKKnR0n+OmvA: shows [9s Ah] (a flush, Ace high)
fyJOjf+Vdie/rpWb1WExIg: mucks hand
+laPa9P7BjZKKnR0n+OmvA collected $1.80 from pot
*** SUMMARY ***
Total pot $1.85 | Rake $0.05
Board [Kd Js As 6s 8s]
Seat 1: lWwl5C/UZOsWNubdUqghZw folded before Flop (didn't bet)
Seat 2: fyJOjf+Vdie/rpWb1WExIg (button) mucked
Seat 3: vQOrJuXbLC3UZDVklY9bOA (small blind) folded before Flop
Seat 4: L0aIPg7qefDQjdJo3HCVEA (big blind) folded before Flop
Seat 5: 686aeHikcJlgKkSuIFdcXQ folded before Flop (didn't bet)
Seat 6: +laPa9P7BjZKKnR0n+OmvA showed [9s Ah] and won ($1.80) with a flush, Ace high



PokerStars Game #59938229558:  Hold'em No Limit ($0.25/$0.50) - 2009/07/01 0:10:01 ET
Table 'MJxeZCzYELxiIsyUZyT0jw' 6-max Seat #4 is the button
Seat 1: iKPos8JI094Tomq4tDSgnQ ($36.80 in chips)
Seat 2: r6H1GiZ6QIpMTDhyodKuRQ ($64.90 in chips)
Seat 3: JQZew0FjzS19kTjeNtrE+A ($50 in chips)
Seat 4: lP7Q6pewz4C2RsAfKsjdWw ($17.65 in chips)
Seat 5: 3jvoOXNtXE90w2BdfNZwZQ ($52.50 in chips)
Seat 6: TTx3CHxyi0SObcHyMJRp5w ($40.20 in chips)
3jvoOXNtXE90w2BdfNZwZQ: posts small blind $0.25
TTx3CHxyi0SObcHyMJRp5w: posts big blind $0.50
*** HOLE CARDS ***
iKPos8JI094Tomq4tDSgnQ: folds
r6H1GiZ6QIpMTDhyodKuRQ: folds
JQZew0FjzS19kTjeNtrE+A: raises $1.50 to $2
lP7Q6pewz4C2RsAfKsjdWw: raises $1.50 to $3.50
3jvoOXNtXE90w2BdfNZwZQ: folds
TTx3CHxyi0SObcHyMJRp5w: folds
JQZew0FjzS19kTjeNtrE+A: calls $1.50
*** FLOP *** [Td 5h 5c]
JQZew0FjzS19kTjeNtrE+A: checks
lP7Q6pewz4C2RsAfKsjdWw: checks
*** TURN *** [Td 5h 5c] [2h]
JQZew0FjzS19kTjeNtrE+A: checks
lP7Q6pewz4C2RsAfKsjdWw: bets $4
JQZew0FjzS19kTjeNtrE+A: folds
lP7Q6pewz4C2RsAfKsjdWw collected $7.40 from pot
lP7Q6pewz4C2RsAfKsjdWw: doesn't show hand
*** SUMMARY ***
Total pot $7.75 | Rake $0.35
Board [Td 5h 5c 2h]
Seat 1: iKPos8JI094Tomq4tDSgnQ folded before Flop (didn't bet)
Seat 2: r6H1GiZ6QIpMTDhyodKuRQ folded before Flop (didn't bet)
Seat 3: JQZew0FjzS19kTjeNtrE+A folded on the Turn
Seat 4: lP7Q6pewz4C2RsAfKsjdWw (button) collected ($7.40)
Seat 5: 3jvoOXNtXE90w2BdfNZwZQ (small blind) folded before Flop
Seat 6: TTx3CHxyi0SObcHyMJRp5w (big blind) folded before Flop



PokerStars Game #59938229224:  Hold'em No Limit ($0.25/$0.50) - 2009/07/01 0:10:01 ET
Table 'raOT4/ipuZgzjfKHC+jD9g' 2-max Seat #2 is the button
Seat 1: IuwLemwLhc9fvrwBGs0AMA ($8.10 in chips)
Seat 2: Udr5juWSWUgTu1NlRhjMdA ($15.25 in chips)
Udr5juWSWUgTu1NlRhjMdA: posts small blind $0.25
IuwLemwLhc9fvrwBGs0AMA: posts big blind $0.50
*** HOLE CARDS ***
Udr5juWSWUgTu1NlRhjMdA: folds
IuwLemwLhc9fvrwBGs0AMA collected $0.50 from pot
*** SUMMARY ***
Total pot $0.50 | Rake $0
Seat 1: IuwLemwLhc9fvrwBGs0AMA (big blind) collected ($0.50)
Seat 2: Udr5juWSWUgTu1NlRhjMdA (button) (small blind) folded before Flop



PokerStars Game #59938230068:  Hold'em No Limit ($0.25/$0.50) - 2009/07/01 0:10:02 ET
Table 'E7bWJ45aoFXRpyRv2gw+Ig' 2-max Seat #1 is the button
Seat 1: FRkiRasEGlHUeLrEl+k/nA ($74.95 in chips)
Seat 2: 3Wro85I7472vJ4Wkpneo9A ($48.85 in chips)
FRkiRasEGlHUeLrEl+k/nA: posts small blind $0.25
3Wro85I7472vJ4Wkpneo9A: posts big blind $0.50
*** HOLE CARDS ***
FRkiRasEGlHUeLrEl+k/nA: folds
3Wro85I7472vJ4Wkpneo9A collected $0.50 from pot
3Wro85I7472vJ4Wkpneo9A: doesn't show hand
*** SUMMARY ***
Total pot $0.50 | Rake $0
Seat 1: FRkiRasEGlHUeLrEl+k/nA (button) (small blind) folded before Flop
Seat 2: 3Wro85I7472vJ4Wkpneo9A (big blind) collected ($0.50)



PokerStars Game #59938230374:  Hold'em No Limit ($0.25/$0.50) - 2009/07/01 0:10:03 ET
Table 'mTxf8gPLgffN3Iwfm7Icfg' 2-max Seat #1 is the button
Seat 1: Do9Rlu1R5u/AcRtMTl8SYg ($66.55 in chips)
Seat 2: EMc5LPgVaded4Qc77vm0fw ($47.65 in chips)
Do9Rlu1R5u/AcRtMTl8SYg: posts small blind $0.25
EMc5LPgVaded4Qc77vm0fw: posts big blind $0.50
*** HOLE CARDS ***
Do9Rlu1R5u/AcRtMTl8SYg: raises $1 to $1.50
EMc5LPgVaded4Qc77vm0fw: folds
Do9Rlu1R5u/AcRtMTl8SYg collected $1 from pot
Do9Rlu1R5u/AcRtMTl8SYg: doesn't show hand
*** SUMMARY ***
Total pot $1 | Rake $0
Seat 1: Do9Rlu1R5u/AcRtMTl8SYg (button) (small blind) collected ($1)
Seat 2: EMc5LPgVaded4Qc77vm0fw (big blind) folded before Flop



PokerStars Game #59938230656:  Hold'em No Limit ($0.25/$0.50) - 2009/07/01 0:10:03 ET
Table 'Nz0Vr7WMHL2g5Uk7dDZjpw' 9-max Seat #1 is the button
Seat 1: tLkxo7JgV+WWI0UBw44K5A ($104.85 in chips)
Seat 3: 4QTiNH5fteLgJjx/s6Hy6A ($15.85 in chips)
Seat 4: 5JJVDlaiMnB004o/RqbZZQ ($27.75 in chips)
Seat 5: WGW0DgjBUXs1ylURHG8vnQ ($17.90 in chips)
Seat 7: KPLH0gELgFe2OuAnhJFI5w ($24.45 in chips)
Seat 8: HkZI6g4zl83TDTA7SRspmQ ($18.75 in chips)
Seat 9: Ak2W6V2TDVIQrvSAy4eD7Q ($11.35 in chips)
4QTiNH5fteLgJjx/s6Hy6A: posts small blind $0.25
5JJVDlaiMnB004o/RqbZZQ: posts big blind $0.50
*** HOLE CARDS ***
WGW0DgjBUXs1ylURHG8vnQ: folds
KPLH0gELgFe2OuAnhJFI5w: calls $0.50
HkZI6g4zl83TDTA7SRspmQ: calls $0.50
Ak2W6V2TDVIQrvSAy4eD7Q: folds
k1f0lS7tlMHCLGs0JT34Tg has returned
tLkxo7JgV+WWI0UBw44K5A: folds
4QTiNH5fteLgJjx/s6Hy6A: raises $1 to $1.50
5JJVDlaiMnB004o/RqbZZQ: folds
KPLH0gELgFe2OuAnhJFI5w: calls $1
HkZI6g4zl83TDTA7SRspmQ: calls $1
*** FLOP *** [2h 4s Kd]
4QTiNH5fteLgJjx/s6Hy6A: bets $2
KPLH0gELgFe2OuAnhJFI5w: folds
HkZI6g4zl83TDTA7SRspmQ: folds
4QTiNH5fteLgJjx/s6Hy6A collected $4.75 from pot
*** SUMMARY ***
Total pot $5 | Rake $0.25
Board [2h 4s Kd]
Seat 1: tLkxo7JgV+WWI0UBw44K5A (button) folded before Flop (didn't bet)
Seat 3: 4QTiNH5fteLgJjx/s6Hy6A (small blind) collected ($4.75)
Seat 4: 5JJVDlaiMnB004o/RqbZZQ (big blind) folded before Flop
Seat 5: WGW0DgjBUXs1ylURHG8vnQ folded before Flop (didn't bet)
Seat 7: KPLH0gELgFe2OuAnhJFI5w folded on the Flop
Seat 8: HkZI6g4zl83TDTA7SRspmQ folded on the Flop
Seat 9: Ak2W6V2TDVIQrvSAy4eD7Q folded before Flop (didn't bet)



PokerStars Game #59938231942:  Hold'em No Limit ($0.25/$0.50) - 2009/07/01 0:10:05 ET
Table 'ibNfFy0bCzuBaUORla0aGw' 9-max Seat #5 is the button
Seat 1: xZCXQSXlrZkp3pZizzVXCw ($56.95 in chips)
Seat 2: 90Wb75h3W1BRpbqVnuk8gw ($52.55 in chips)
Seat 3: dDaHs3X8+fe3bIkRU0cbrw ($26.30 in chips)
Seat 4: YBN054X4blmis+B2bBlC0g ($19.45 in chips)
Seat 5: FRv75HO8CUsRZ1byEz06mQ ($15.35 in chips)
Seat 6: BmYrv3ec2k5d6pQq6iNaZw ($67.40 in chips)
Seat 7: mSD1pginDsyHG5PDfqzphw ($10 in chips)
Seat 8: xUrN9TWLq4m5V+OXY7KUUA ($50 in chips)
Seat 9: WpvT3OUSiZlpvs+mPXFqtQ ($8.75 in chips)
BmYrv3ec2k5d6pQq6iNaZw: posts small blind $0.25
mSD1pginDsyHG5PDfqzphw: posts big blind $0.50
*** HOLE CARDS ***
xUrN9TWLq4m5V+OXY7KUUA: folds
WpvT3OUSiZlpvs+mPXFqtQ: folds
xZCXQSXlrZkp3pZizzVXCw: folds
90Wb75h3W1BRpbqVnuk8gw: folds
dDaHs3X8+fe3bIkRU0cbrw: folds
YBN054X4blmis+B2bBlC0g: folds
FRv75HO8CUsRZ1byEz06mQ: folds
BmYrv3ec2k5d6pQq6iNaZw: calls $0.25
mSD1pginDsyHG5PDfqzphw: checks
*** FLOP *** [8h Th 4s]
BmYrv3ec2k5d6pQq6iNaZw: bets $1.50
mSD1pginDsyHG5PDfqzphw: folds
BmYrv3ec2k5d6pQq6iNaZw collected $0.95 from pot
*** SUMMARY ***
Total pot $1 | Rake $0.05
Board [8h Th 4s]
Seat 1: xZCXQSXlrZkp3pZizzVXCw folded before Flop (didn't bet)
Seat 2: 90Wb75h3W1BRpbqVnuk8gw folded before Flop (didn't bet)
Seat 3: dDaHs3X8+fe3bIkRU0cbrw folded before Flop (didn't bet)
Seat 4: YBN054X4blmis+B2bBlC0g folded before Flop (didn't bet)
Seat 5: FRv75HO8CUsRZ1byEz06mQ (button) folded before Flop (didn't bet)
Seat 6: BmYrv3ec2k5d6pQq6iNaZw (small blind) collected ($0.95)
Seat 7: mSD1pginDsyHG5PDfqzphw (big blind) folded on the Flop
Seat 8: xUrN9TWLq4m5V+OXY7KUUA folded before Flop (didn't bet)
Seat 9: WpvT3OUSiZlpvs+mPXFqtQ folded before Flop (didn't bet)



PokerStars Game #59938232778:  Hold'em No Limit ($0.25/$0.50) - 2009/07/01 0:10:06 ET
Table 'kgbJRsxfv64KrErDRBAkcw' 6-max Seat #4 is the button
Seat 1: YmWlPGOKFuJSoJZPW8a8IA ($80.55 in chips)
Seat 2: Q+thC23WCv1kJUJtH/+4Jw ($27.50 in chips)
Seat 3: T0Gx/FcQ5VH9u7XaOMX97A ($65.40 in chips)
Seat 4: qanMEqjABjWxC/JgQ/0l7w ($61.20 in chips)
Seat 5: +Pf9jTVizYlIo+woPvptfA ($50 in chips)
Seat 6: DDfYzIrYT0t5R/hAJngtsg ($22.40 in chips)
+Pf9jTVizYlIo+woPvptfA: posts small blind $0.25
DDfYzIrYT0t5R/hAJngtsg: posts big blind $0.50
*** HOLE CARDS ***
YmWlPGOKFuJSoJZPW8a8IA: folds
Q+thC23WCv1kJUJtH/+4Jw: folds
T0Gx/FcQ5VH9u7XaOMX97A: raises $1 to $1.50
qanMEqjABjWxC/JgQ/0l7w: raises $4.50 to $6
+Pf9jTVizYlIo+woPvptfA: folds
DDfYzIrYT0t5R/hAJngtsg: folds
T0Gx/FcQ5VH9u7XaOMX97A: folds
qanMEqjABjWxC/JgQ/0l7w collected $3.75 from pot
*** SUMMARY ***
Total pot $3.75 | Rake $0
Seat 1: YmWlPGOKFuJSoJZPW8a8IA folded before Flop (didn't bet)
Seat 2: Q+thC23WCv1kJUJtH/+4Jw folded before Flop (didn't bet)
Seat 3: T0Gx/FcQ5VH9u7XaOMX97A folded before Flop
Seat 4: qanMEqjABjWxC/JgQ/0l7w (button) collected ($3.75)
Seat 5: +Pf9jTVizYlIo+woPvptfA (small blind) folded before Flop
Seat 6: DDfYzIrYT0t5R/hAJngtsg (big blind) folded before Flop



PokerStars Game #59938233418:  Hold'em No Limit ($0.25/$0.50) - 2009/07/01 0:10:07 ET
Table 'raOT4/ipuZgzjfKHC+jD9g' 2-max Seat #1 is the button
Seat 1: IuwLemwLhc9fvrwBGs0AMA ($8.35 in chips)
Seat 2: Udr5juWSWUgTu1NlRhjMdA ($15 in chips)
IuwLemwLhc9fvrwBGs0AMA: posts small blind $0.25
Udr5juWSWUgTu1NlRhjMdA: posts big blind $0.50
*** HOLE CARDS ***
IuwLemwLhc9fvrwBGs0AMA: folds
Udr5juWSWUgTu1NlRhjMdA collected $0.50 from pot
Udr5juWSWUgTu1NlRhjMdA: doesn't show hand
*** SUMMARY ***
Total pot $0.50 | Rake $0
Seat 1: IuwLemwLhc9fvrwBGs0AMA (button) (small blind) folded before Flop
Seat 2: Udr5juWSWUgTu1NlRhjMdA (big blind) collected ($0.50)



PokerStars Game #59938233326:  Hold'em No Limit ($0.25/$0.50) - 2009/07/01 0:10:07 ET
Table 'eMxdLyFDf28E0wit6gm3Uw' 6-max Seat #6 is the button
Seat 1: tnD/64LagZ9qPaeOQVjVZg ($12.20 in chips)
Seat 2: jwuKQ1S3U4NnzMQn3E3dgw ($64.65 in chips)
Seat 4: crjGpJEzSZgD38FoE3VMGg ($50.50 in chips)
Seat 5: X0X97o2fDAPiGx6o1gahsw ($58.05 in chips)
Seat 6: L0aIPg7qefDQjdJo3HCVEA ($6.75 in chips)
tnD/64LagZ9qPaeOQVjVZg: posts small blind $0.25
jwuKQ1S3U4NnzMQn3E3dgw: posts big blind $0.50
dZcLsEI8iXkobBduRJ45Yw: sits out
*** HOLE CARDS ***
crjGpJEzSZgD38FoE3VMGg: folds
X0X97o2fDAPiGx6o1gahsw: folds
L0aIPg7qefDQjdJo3HCVEA: raises $0.50 to $1
tnD/64LagZ9qPaeOQVjVZg: folds
jwuKQ1S3U4NnzMQn3E3dgw: folds
L0aIPg7qefDQjdJo3HCVEA collected $1.25 from pot
*** SUMMARY ***
Total pot $1.25 | Rake $0
Seat 1: tnD/64LagZ9qPaeOQVjVZg (small blind) folded before Flop
Seat 2: jwuKQ1S3U4NnzMQn3E3dgw (big blind) folded before Flop
Seat 4: crjGpJEzSZgD38FoE3VMGg folded before Flop (didn't bet)
Seat 5: X0X97o2fDAPiGx6o1gahsw folded before Flop (didn't bet)
Seat 6: L0aIPg7qefDQjdJo3HCVEA (button) collected ($1.25)



PokerStars Game #59938233848:  Hold'em No Limit ($0.25/$0.50) - 2009/07/01 0:10:08 ET
Table 'lSisgp6H7Fg1hH5VfjEjYQ' 9-max Seat #1 is the button
Seat 1: pEW8B6uXbdR47kfljMQ3+Q ($39.70 in chips)
Seat 2: UrcnkQOiLVk8BlKDPJSy7Q ($53.35 in chips)
Seat 4: nvw9yQKhJT56lA9k+TLdhw ($11.70 in chips)
Seat 5: mSD1pginDsyHG5PDfqzphw ($10 in chips)
Seat 6: +k7T5ocke8UwavtgUHm+Cg ($21.65 in chips)
Seat 7: xyQ4CeZa3ug3ompz+5xSTg ($73.95 in chips)
Seat 8: bXpVeaSTPBFSPJmeXxO7nw ($19.50 in chips)
Seat 9: 5JJVDlaiMnB004o/RqbZZQ ($39.70 in chips)
UrcnkQOiLVk8BlKDPJSy7Q: posts small blind $0.25
RjBdQ6w31rgcy0o24VLR6w: is sitting out
nvw9yQKhJT56lA9k+TLdhw: posts big blind $0.50
*** HOLE CARDS ***
RjBdQ6w31rgcy0o24VLR6w leaves the table
mSD1pginDsyHG5PDfqzphw: folds
+k7T5ocke8UwavtgUHm+Cg: folds
xyQ4CeZa3ug3ompz+5xSTg: folds
bXpVeaSTPBFSPJmeXxO7nw: folds
5JJVDlaiMnB004o/RqbZZQ: raises $1 to $1.50
pEW8B6uXbdR47kfljMQ3+Q: folds
UrcnkQOiLVk8BlKDPJSy7Q: calls $1.25
nvw9yQKhJT56lA9k+TLdhw: folds
*** FLOP *** [Kh Jd Td]
UrcnkQOiLVk8BlKDPJSy7Q: checks
5JJVDlaiMnB004o/RqbZZQ: bets $2
UrcnkQOiLVk8BlKDPJSy7Q: folds
5JJVDlaiMnB004o/RqbZZQ collected $3.35 from pot
*** SUMMARY ***
Total pot $3.50 | Rake $0.15
Board [Kh Jd Td]
Seat 1: pEW8B6uXbdR47kfljMQ3+Q (button) folded before Flop (didn't bet)
Seat 2: UrcnkQOiLVk8BlKDPJSy7Q (small blind) folded on the Flop
Seat 4: nvw9yQKhJT56lA9k+TLdhw (big blind) folded before Flop
Seat 5: mSD1pginDsyHG5PDfqzphw folded before Flop (didn't bet)
Seat 6: +k7T5ocke8UwavtgUHm+Cg folded before Flop (didn't bet)
Seat 7: xyQ4CeZa3ug3ompz+5xSTg folded before Flop (didn't bet)
Seat 8: bXpVeaSTPBFSPJmeXxO7nw folded before Flop (didn't bet)
Seat 9: 5JJVDlaiMnB004o/RqbZZQ collected ($3.35)



PokerStars Game #59938234480:  Hold'em No Limit ($0.25/$0.50) - 2009/07/01 0:10:09 ET
Table 'E7bWJ45aoFXRpyRv2gw+Ig' 2-max Seat #2 is the button
Seat 1: FRkiRasEGlHUeLrEl+k/nA ($74.70 in chips)
Seat 2: 3Wro85I7472vJ4Wkpneo9A ($49.10 in chips)
3Wro85I7472vJ4Wkpneo9A: posts small blind $0.25
FRkiRasEGlHUeLrEl+k/nA: posts big blind $0.50
*** HOLE CARDS ***
3Wro85I7472vJ4Wkpneo9A: calls $0.25
FRkiRasEGlHUeLrEl+k/nA: checks
*** FLOP *** [5s Qc 6c]
FRkiRasEGlHUeLrEl+k/nA: checks
3Wro85I7472vJ4Wkpneo9A: checks
*** TURN *** [5s Qc 6c] [Kd]
FRkiRasEGlHUeLrEl+k/nA: checks
3Wro85I7472vJ4Wkpneo9A: checks
*** RIVER *** [5s Qc 6c Kd] [8c]
FRkiRasEGlHUeLrEl+k/nA: checks
3Wro85I7472vJ4Wkpneo9A: bets $1
FRkiRasEGlHUeLrEl+k/nA: folds
3Wro85I7472vJ4Wkpneo9A collected $0.95 from pot
3Wro85I7472vJ4Wkpneo9A: doesn't show hand
*** SUMMARY ***
Total pot $1 | Rake $0.05
Board [5s Qc 6c Kd 8c]
Seat 1: FRkiRasEGlHUeLrEl+k/nA (big blind) folded on the River
Seat 2: 3Wro85I7472vJ4Wkpneo9A (button) (small blind) collected ($0.95)



PokerStars Game #59938235590:  Hold'em No Limit ($0.25/$0.50) - 2009/07/01 0:10:10 ET
Table 'mTxf8gPLgffN3Iwfm7Icfg' 2-max Seat #2 is the button
Seat 1: Do9Rlu1R5u/AcRtMTl8SYg ($67.05 in chips)
Seat 2: EMc5LPgVaded4Qc77vm0fw ($47.15 in chips)
EMc5LPgVaded4Qc77vm0fw: posts small blind $0.25
Do9Rlu1R5u/AcRtMTl8SYg: posts big blind $0.50
*** HOLE CARDS ***
EMc5LPgVaded4Qc77vm0fw: raises $1 to $1.50
Do9Rlu1R5u/AcRtMTl8SYg: folds
EMc5LPgVaded4Qc77vm0fw collected $1 from pot
EMc5LPgVaded4Qc77vm0fw: doesn't show hand
*** SUMMARY ***
Total pot $1 | Rake $0
Seat 1: Do9Rlu1R5u/AcRtMTl8SYg (big blind) folded before Flop
Seat 2: EMc5LPgVaded4Qc77vm0fw (button) (small blind) collected ($1)



PokerStars Game #59938237128:  Hold'em No Limit ($0.25/$0.50) - 2009/07/01 0:10:12 ET
Table '+dXkOAQyS8j9PQZusUTMpg' 2-max Seat #2 is the button
Seat 1: XFa6sBGjP2gxoIvxR3fZIg ($72 in chips)
Seat 2: 5IBeOgaApY1Bvzv2P8X4EA ($40.70 in chips)
5IBeOgaApY1Bvzv2P8X4EA: posts small blind $0.25
XFa6sBGjP2gxoIvxR3fZIg: posts big blind $0.50
*** HOLE CARDS ***
5IBeOgaApY1Bvzv2P8X4EA: calls $0.25
XFa6sBGjP2gxoIvxR3fZIg: checks
*** FLOP *** [5c Qc Qs]
XFa6sBGjP2gxoIvxR3fZIg: checks
5IBeOgaApY1Bvzv2P8X4EA: checks
*** TURN *** [5c Qc Qs] [2h]
XFa6sBGjP2gxoIvxR3fZIg: bets $1
5IBeOgaApY1Bvzv2P8X4EA: folds
XFa6sBGjP2gxoIvxR3fZIg collected $0.95 from pot
XFa6sBGjP2gxoIvxR3fZIg: doesn't show hand
*** SUMMARY ***
Total pot $1 | Rake $0.05
Board [5c Qc Qs 2h]
Seat 1: XFa6sBGjP2gxoIvxR3fZIg (big blind) collected ($0.95)
Seat 2: 5IBeOgaApY1Bvzv2P8X4EA (button) (small blind) folded on the Turn



PokerStars Game #59938238086:  Hold'em No Limit ($0.25/$0.50) - 2009/07/01 0:10:14 ET
Table 'raOT4/ipuZgzjfKHC+jD9g' 2-max Seat #2 is the button
Seat 1: IuwLemwLhc9fvrwBGs0AMA ($8.10 in chips)
Seat 2: Udr5juWSWUgTu1NlRhjMdA ($15.25 in chips)
Udr5juWSWUgTu1NlRhjMdA: posts small blind $0.25
IuwLemwLhc9fvrwBGs0AMA: posts big blind $0.50
*** HOLE CARDS ***
Udr5juWSWUgTu1NlRhjMdA: raises $0.50 to $1
IuwLemwLhc9fvrwBGs0AMA: calls $0.50
*** FLOP *** [6s 2c 9c]
IuwLemwLhc9fvrwBGs0AMA: bets $1
Udr5juWSWUgTu1NlRhjMdA: folds
IuwLemwLhc9fvrwBGs0AMA collected $1.90 from pot
*** SUMMARY ***
Total pot $2 | Rake $0.10
Board [6s 2c 9c]
Seat 1: IuwLemwLhc9fvrwBGs0AMA (big blind) collected ($1.90)
Seat 2: Udr5juWSWUgTu1NlRhjMdA (button) (small blind) folded on the Flop



PokerStars Game #59938240840:  Hold'em No Limit ($0.25/$0.50) - 2009/07/01 0:10:18 ET
Table 'mTxf8gPLgffN3Iwfm7Icfg' 2-max Seat #1 is the button
Seat 1: Do9Rlu1R5u/AcRtMTl8SYg ($66.55 in chips)
Seat 2: EMc5LPgVaded4Qc77vm0fw ($47.65 in chips)
Do9Rlu1R5u/AcRtMTl8SYg: posts small blind $0.25
EMc5LPgVaded4Qc77vm0fw: posts big blind $0.50
*** HOLE CARDS ***
Do9Rlu1R5u/AcRtMTl8SYg: folds
EMc5LPgVaded4Qc77vm0fw collected $0.50 from pot
EMc5LPgVaded4Qc77vm0fw: doesn't show hand
*** SUMMARY ***
Total pot $0.50 | Rake $0
Seat 1: Do9Rlu1R5u/AcRtMTl8SYg (button) (small blind) folded before Flop
Seat 2: EMc5LPgVaded4Qc77vm0fw (big blind) collected ($0.50)



PokerStars Game #59938240754:  Hold'em No Limit ($0.25/$0.50) - 2009/07/01 0:10:18 ET
Table 'c/CRn+68J3Y8KxD5g1ek2Q' 2-max Seat #2 is the button
Seat 1: 46qCyJ6evTkHo9al5sBMNA ($332.40 in chips)
Seat 2: BypVLsYQt3ePFm2xQL/dOA ($53.85 in chips)
BypVLsYQt3ePFm2xQL/dOA: posts small blind $0.25
46qCyJ6evTkHo9al5sBMNA: posts big blind $0.50
*** HOLE CARDS ***
BypVLsYQt3ePFm2xQL/dOA: raises $1 to $1.50
46qCyJ6evTkHo9al5sBMNA: folds
BypVLsYQt3ePFm2xQL/dOA collected $1 from pot
BypVLsYQt3ePFm2xQL/dOA: doesn't show hand
*** SUMMARY ***
Total pot $1 | Rake $0
Seat 1: 46qCyJ6evTkHo9al5sBMNA (big blind) folded before Flop
Seat 2: BypVLsYQt3ePFm2xQL/dOA (button) (small blind) collected ($1)



PokerStars Game #59938242118:  Hold'em No Limit ($0.25/$0.50) - 2009/07/01 0:10:19 ET
Table 'QOgaEqMcJ73pcUMMxoisUgErOuyGLI5PT3G5MnpHgC/g Seat #5 is the button
Seat 1: k6GJzKs7T7qvQggW9g8Pdw ($56.90 in chips)
Seat 2: RjBdQ6w31rgcy0o24VLR6w ($10.95 in chips)
Seat 3: xZCXQSXlrZkp3pZizzVXCw ($50.50 in chips)
Seat 4: U7aZzIYWjv3SL30KtikLbw ($47.45 in chips)
Seat 5: JwvquocWfhTVApN5t47LgA ($50.05 in chips)
Seat 6: zE9cVigS2nW/Ljy4K4bUQA ($30 in chips)
Seat 7: 90Wb75h3W1BRpbqVnuk8gw ($62.55 in chips)
Seat 9: J0W5D97jl5VLky+IoPvDeA ($67.80 in chips)
zE9cVigS2nW/Ljy4K4bUQA: posts small blind $0.25
90Wb75h3W1BRpbqVnuk8gw: posts big blind $0.50
g4k0NXISyLCqaSWZDBjfEg: sits out
*** HOLE CARDS ***
J0W5D97jl5VLky+IoPvDeA: folds
k6GJzKs7T7qvQggW9g8Pdw: folds
RjBdQ6w31rgcy0o24VLR6w: folds
xZCXQSXlrZkp3pZizzVXCw: folds
U7aZzIYWjv3SL30KtikLbw: folds
JwvquocWfhTVApN5t47LgA: raises $0.50 to $1
zE9cVigS2nW/Ljy4K4bUQA: folds
90Wb75h3W1BRpbqVnuk8gw: calls $0.50
*** FLOP *** [9h 8s 6c]
90Wb75h3W1BRpbqVnuk8gw: checks
JwvquocWfhTVApN5t47LgA: bets $1
90Wb75h3W1BRpbqVnuk8gw: raises $4 to $5
JwvquocWfhTVApN5t47LgA: calls $4
*** TURN *** [9h 8s 6c] [Kd]
90Wb75h3W1BRpbqVnuk8gw: bets $8
JwvquocWfhTVApN5t47LgA: folds
90Wb75h3W1BRpbqVnuk8gw collected $11.65 from pot
*** SUMMARY ***
Total pot $12.25 | Rake $0.60
Board [9h 8s 6c Kd]
Seat 1: k6GJzKs7T7qvQggW9g8Pdw folded before Flop (didn't bet)
Seat 2: RjBdQ6w31rgcy0o24VLR6w folded before Flop (didn't bet)
Seat 3: xZCXQSXlrZkp3pZizzVXCw folded before Flop (didn't bet)
Seat 4: U7aZzIYWjv3SL30KtikLbw folded before Flop (didn't bet)
Seat 5: JwvquocWfhTVApN5t47LgA (button) folded on the Turn
Seat 6: zE9cVigS2nW/Ljy4K4bUQA (small blind) folded before Flop
Seat 7: 90Wb75h3W1BRpbqVnuk8gw (big blind) collected ($11.65)
Seat 9: J0W5D97jl5VLky+IoPvDeA folded before Flop (didn't bet)



PokerStars Game #59938243838:  Hold'em No Limit ($0.25/$0.50) - 2009/07/01 0:10:22 ET
Table '5EmHi+fnatGQQShcNmzOZQ' 6-max Seat #6 is the button
Seat 1: SwPczQo3cOtwEzhJrfO2cQ ($22.50 in chips)
Seat 2: APwvTk5XojDXGoQLb4O5iA ($27.35 in chips)
Seat 3: J8dF2sYMvXUmAGUuSW9kwg ($34.55 in chips)
Seat 4: mFTuMjESuBcXHQ1ePkg/8A ($20.60 in chips)
Seat 5: kxPhs4ePFqMy52CInAJ2aw ($69.55 in chips)
Seat 6: 686aeHikcJlgKkSuIFdcXQ ($114.70 in chips)
SwPczQo3cOtwEzhJrfO2cQ: posts small blind $0.25
APwvTk5XojDXGoQLb4O5iA: posts big blind $0.50
*** HOLE CARDS ***
J8dF2sYMvXUmAGUuSW9kwg: raises $1 to $1.50
mFTuMjESuBcXHQ1ePkg/8A: calls $1.50
kxPhs4ePFqMy52CInAJ2aw: folds
686aeHikcJlgKkSuIFdcXQ: folds
SwPczQo3cOtwEzhJrfO2cQ: folds
APwvTk5XojDXGoQLb4O5iA: folds
*** FLOP *** [5d 6d 2h]
J8dF2sYMvXUmAGUuSW9kwg: bets $2.50
mFTuMjESuBcXHQ1ePkg/8A: calls $2.50
*** TURN *** [5d 6d 2h] [2s]
J8dF2sYMvXUmAGUuSW9kwg: bets $5
mFTuMjESuBcXHQ1ePkg/8A: calls $5
*** RIVER *** [5d 6d 2h 2s] [Ad]
J8dF2sYMvXUmAGUuSW9kwg: checks
mFTuMjESuBcXHQ1ePkg/8A: bets $6.50
J8dF2sYMvXUmAGUuSW9kwg: folds
mFTuMjESuBcXHQ1ePkg/8A collected $17.85 from pot
mFTuMjESuBcXHQ1ePkg/8A: doesn't show hand
*** SUMMARY ***
Total pot $18.75 | Rake $0.90
Board [5d 6d 2h 2s Ad]
Seat 1: SwPczQo3cOtwEzhJrfO2cQ (small blind) folded before Flop
Seat 2: APwvTk5XojDXGoQLb4O5iA (big blind) folded before Flop
Seat 3: J8dF2sYMvXUmAGUuSW9kwg folded on the River
Seat 4: mFTuMjESuBcXHQ1ePkg/8A collected ($17.85)
Seat 5: kxPhs4ePFqMy52CInAJ2aw folded before Flop (didn't bet)
Seat 6: 686aeHikcJlgKkSuIFdcXQ (button) folded before Flop (didn't bet)



PokerStars Game #59938243744:  Hold'em No Limit ($0.25/$0.50) - 2009/07/01 0:10:22 ET
Table '37qXEp3oe+er5q4CZip9eQ' 6-max Seat #5 is the button
Seat 1: oqOqoO2AyCZenUghCxMDxw ($50 in chips)
Seat 2: g12O9qXTybyo2C0B2bXgjg ($27.65 in chips)
Seat 3: Rt6KgtZ8YaJoTc3FPim00w ($98.10 in chips)
Seat 4: L0aIPg7qefDQjdJo3HCVEA ($19.10 in chips)
Seat 5: VOmI0x4dDPnTESZd5B4d1Q ($39.75 in chips)
Seat 6: f7zPpUQp9hHZgqhEvrUWQw ($55.40 in chips)
f7zPpUQp9hHZgqhEvrUWQw: posts small blind $0.25
oqOqoO2AyCZenUghCxMDxw: posts big blind $0.50
*** HOLE CARDS ***
g12O9qXTybyo2C0B2bXgjg: folds
Rt6KgtZ8YaJoTc3FPim00w: folds
L0aIPg7qefDQjdJo3HCVEA: raises $0.50 to $1
VOmI0x4dDPnTESZd5B4d1Q: folds
f7zPpUQp9hHZgqhEvrUWQw: folds
oqOqoO2AyCZenUghCxMDxw: calls $0.50
*** FLOP *** [9d As Kd]
oqOqoO2AyCZenUghCxMDxw: checks
L0aIPg7qefDQjdJo3HCVEA: checks
*** TURN *** [9d As Kd] [7s]
oqOqoO2AyCZenUghCxMDxw: checks
L0aIPg7qefDQjdJo3HCVEA: checks
*** RIVER *** [9d As Kd 7s] [Ts]
oqOqoO2AyCZenUghCxMDxw: checks
L0aIPg7qefDQjdJo3HCVEA: checks
*** SHOW DOWN ***
oqOqoO2AyCZenUghCxMDxw: shows [5d 3d] (high card Ace)
L0aIPg7qefDQjdJo3HCVEA: shows [9c Jc] (a pair of Nines)
L0aIPg7qefDQjdJo3HCVEA collected $2.15 from pot
*** SUMMARY ***
Total pot $2.25 | Rake $0.10
Board [9d As Kd 7s Ts]
Seat 1: oqOqoO2AyCZenUghCxMDxw (big blind) showed [5d 3d] and lost with high card Ace
Seat 2: g12O9qXTybyo2C0B2bXgjg folded before Flop (didn't bet)
Seat 3: Rt6KgtZ8YaJoTc3FPim00w folded before Flop (didn't bet)
Seat 4: L0aIPg7qefDQjdJo3HCVEA showed [9c Jc] and won ($2.15) with a pair of Nines
Seat 5: VOmI0x4dDPnTESZd5B4d1Q (button) folded before Flop (didn't bet)
Seat 6: f7zPpUQp9hHZgqhEvrUWQw (small blind) folded before Flop



PokerStars Game #59938245028:  Hold'em No Limit ($0.25/$0.50) - 2009/07/01 0:10:23 ET
Table 'mTxf8gPLgffN3Iwfm7Icfg' 2-max Seat #2 is the button
Seat 1: Do9Rlu1R5u/AcRtMTl8SYg ($66.30 in chips)
Seat 2: EMc5LPgVaded4Qc77vm0fw ($47.90 in chips)
EMc5LPgVaded4Qc77vm0fw: posts small blind $0.25
Do9Rlu1R5u/AcRtMTl8SYg: posts big blind $0.50
*** HOLE CARDS ***
EMc5LPgVaded4Qc77vm0fw: folds
Do9Rlu1R5u/AcRtMTl8SYg collected $0.50 from pot
Do9Rlu1R5u/AcRtMTl8SYg: doesn't show hand
*** SUMMARY ***
Total pot $0.50 | Rake $0
Seat 1: Do9Rlu1R5u/AcRtMTl8SYg (big blind) collected ($0.50)
Seat 2: EMc5LPgVaded4Qc77vm0fw (button) (small blind) folded before Flop



PokerStars Game #59938245026:  Hold'em No Limit ($0.25/$0.50) - 2009/07/01 0:10:23 ET
Table 'Vdlc9wqYcHTUhtdyN7CuJw' 2-max Seat #2 is the button
Seat 1: yBO+mXB6m/rCft2ErwGf/Q ($95.60 in chips)
Seat 2: sa0qgETiL3HNbdfGlnKHTA ($17.05 in chips)
sa0qgETiL3HNbdfGlnKHTA: posts small blind $0.25
yBO+mXB6m/rCft2ErwGf/Q: posts big blind $0.50
*** HOLE CARDS ***
sa0qgETiL3HNbdfGlnKHTA: raises $0.50 to $1
yBO+mXB6m/rCft2ErwGf/Q: calls $0.50
*** FLOP *** [Ac 9d Ah]
yBO+mXB6m/rCft2ErwGf/Q: checks
sa0qgETiL3HNbdfGlnKHTA: bets $1.50
yBO+mXB6m/rCft2ErwGf/Q: folds
sa0qgETiL3HNbdfGlnKHTA collected $1.90 from pot
sa0qgETiL3HNbdfGlnKHTA: doesn't show hand
*** SUMMARY ***
Total pot $2 | Rake $0.10
Board [Ac 9d Ah]
Seat 1: yBO+mXB6m/rCft2ErwGf/Q (big blind) folded on the Flop
Seat 2: sa0qgETiL3HNbdfGlnKHTA (button) (small blind) collected ($1.90)



PokerStars Game #59938245674:  Hold'em No Limit ($0.25/$0.50) - 2009/07/01 0:10:24 ET
Table 'tpZbcIvqh/6WmfR/i5IE3A' 9-max Seat #5 is the button
Seat 1: nV/P1jFY/CFMXOLWu7pYmA ($13.70 in chips)
Seat 2: M+7+BTmX5vZatHVuoRB1nA ($42.90 in chips)
Seat 3: 3w0FbBQAKwQODwenKwZxXw ($78.40 in chips)
Seat 4: zE9cVigS2nW/Ljy4K4bUQA ($30.75 in chips)
Seat 5: 9r7ZoBbAJj5IeyZ0q9BdzA ($12.15 in chips)
Seat 6: E2518gp4aFz1+kAgmGqeEg ($10.70 in chips)
Seat 7: wIZ377kjl2fHFGnS93o6bw ($17.15 in chips)
Seat 8: bXpVeaSTPBFSPJmeXxO7nw ($9.85 in chips)
E2518gp4aFz1+kAgmGqeEg: posts small blind $0.25
wIZ377kjl2fHFGnS93o6bw: posts big blind $0.50
*** HOLE CARDS ***
bXpVeaSTPBFSPJmeXxO7nw: folds
nV/P1jFY/CFMXOLWu7pYmA: folds
M+7+BTmX5vZatHVuoRB1nA: folds
3w0FbBQAKwQODwenKwZxXw: folds
zE9cVigS2nW/Ljy4K4bUQA: raises $1 to $1.50
9r7ZoBbAJj5IeyZ0q9BdzA: calls $1.50
E2518gp4aFz1+kAgmGqeEg: folds
wIZ377kjl2fHFGnS93o6bw: calls $1
*** FLOP *** [4h 2c Kd]
wIZ377kjl2fHFGnS93o6bw: checks
zE9cVigS2nW/Ljy4K4bUQA: checks
9r7ZoBbAJj5IeyZ0q9BdzA: bets $1.50
wIZ377kjl2fHFGnS93o6bw: folds
zE9cVigS2nW/Ljy4K4bUQA: folds
9r7ZoBbAJj5IeyZ0q9BdzA collected $4.55 from pot
9r7ZoBbAJj5IeyZ0q9BdzA: doesn't show hand
*** SUMMARY ***
Total pot $4.75 | Rake $0.20
Board [4h 2c Kd]
Seat 1: nV/P1jFY/CFMXOLWu7pYmA folded before Flop (didn't bet)
Seat 2: M+7+BTmX5vZatHVuoRB1nA folded before Flop (didn't bet)
Seat 3: 3w0FbBQAKwQODwenKwZxXw folded before Flop (didn't bet)
Seat 4: zE9cVigS2nW/Ljy4K4bUQA folded on the Flop
Seat 5: 9r7ZoBbAJj5IeyZ0q9BdzA (button) collected ($4.55)
Seat 6: E2518gp4aFz1+kAgmGqeEg (small blind) folded before Flop
Seat 7: wIZ377kjl2fHFGnS93o6bw (big blind) folded on the Flop
Seat 8: bXpVeaSTPBFSPJmeXxO7nw folded before Flop (didn't bet)



PokerStars Game #59938245848:  Hold'em No Limit ($0.25/$0.50) - 2009/07/01 0:10:25 ET
Table 'c/CRn+68J3Y8KxD5g1ek2Q' 2-max Seat #1 is the button
Seat 1: 46qCyJ6evTkHo9al5sBMNA ($331.90 in chips)
Seat 2: BypVLsYQt3ePFm2xQL/dOA ($54.35 in chips)
46qCyJ6evTkHo9al5sBMNA: posts small blind $0.25
BypVLsYQt3ePFm2xQL/dOA: posts big blind $0.50
*** HOLE CARDS ***
46qCyJ6evTkHo9al5sBMNA: raises $1 to $1.50
BypVLsYQt3ePFm2xQL/dOA: raises $4 to $5.50
46qCyJ6evTkHo9al5sBMNA: calls $4
*** FLOP *** [6d 5c 8d]
BypVLsYQt3ePFm2xQL/dOA: bets $15
46qCyJ6evTkHo9al5sBMNA: folds
BypVLsYQt3ePFm2xQL/dOA collected $10.50 from pot
BypVLsYQt3ePFm2xQL/dOA: doesn't show hand
*** SUMMARY ***
Total pot $11 | Rake $0.50
Board [6d 5c 8d]
Seat 1: 46qCyJ6evTkHo9al5sBMNA (button) (small blind) folded on the Flop
Seat 2: BypVLsYQt3ePFm2xQL/dOA (big blind) collected ($10.50)



PokerStars Game #59938246196:  Hold'em No Limit ($0.25/$0.50) - 2009/07/01 0:10:25 ET
Table 'tyR5AZNKV8Aadbrnrnlg7g' 6-max Seat #1 is the button
Seat 1: R+KjpH/wSjDLhtIy9+edNA ($35.75 in chips)
Seat 2: 58zdeSBSuSFX/qZfhc7YmA ($31.20 in chips)
Seat 3: jUhx+m+V7qfbLZTjgwZByg ($47.85 in chips)
Seat 4: Rt6KgtZ8YaJoTc3FPim00w ($52.75 in chips)
Seat 5: EIg3r3fRFKG2HhgpDlIJHg ($36.45 in chips)
58zdeSBSuSFX/qZfhc7YmA: posts small blind $0.25
jUhx+m+V7qfbLZTjgwZByg: posts big blind $0.50
*** HOLE CARDS ***
DMQLAmut/l19xN5STQndFg has returned
Rt6KgtZ8YaJoTc3FPim00w: raises $1 to $1.50
EIg3r3fRFKG2HhgpDlIJHg: calls $1.50
R+KjpH/wSjDLhtIy9+edNA: calls $1.50
58zdeSBSuSFX/qZfhc7YmA: folds
jUhx+m+V7qfbLZTjgwZByg: folds
*** FLOP *** [7s Jc Ts]
Rt6KgtZ8YaJoTc3FPim00w: checks
EIg3r3fRFKG2HhgpDlIJHg: bets $2
R+KjpH/wSjDLhtIy9+edNA: calls $2
Rt6KgtZ8YaJoTc3FPim00w: folds
*** TURN *** [7s Jc Ts] [2c]
EIg3r3fRFKG2HhgpDlIJHg: checks
R+KjpH/wSjDLhtIy9+edNA: bets $5
EIg3r3fRFKG2HhgpDlIJHg: calls $5
*** RIVER *** [7s Jc Ts 2c] [7c]
EIg3r3fRFKG2HhgpDlIJHg: checks
R+KjpH/wSjDLhtIy9+edNA: bets $10
EIg3r3fRFKG2HhgpDlIJHg: calls $10
*** SHOW DOWN ***
R+KjpH/wSjDLhtIy9+edNA: shows [Td Ad] (two pair, Tens and Sevens)
EIg3r3fRFKG2HhgpDlIJHg: mucks hand
R+KjpH/wSjDLhtIy9+edNA collected $37.35 from pot
*** SUMMARY ***
Total pot $39.25 | Rake $1.90
Board [7s Jc Ts 2c 7c]
Seat 1: R+KjpH/wSjDLhtIy9+edNA (button) showed [Td Ad] and won ($37.35) with two pair, Tens and Sevens
Seat 2: 58zdeSBSuSFX/qZfhc7YmA (small blind) folded before Flop
Seat 3: jUhx+m+V7qfbLZTjgwZByg (big blind) folded before Flop
Seat 4: Rt6KgtZ8YaJoTc3FPim00w folded on the Flop
Seat 5: EIg3r3fRFKG2HhgpDlIJHg mucked



PokerStars Game #59938246922:  Hold'em No Limit ($0.25/$0.50) - 2009/07/01 0:10:26 ET
Table 'kgbJRsxfv64KrErDRBAkcw' 6-max Seat #5 is the button
Seat 1: YmWlPGOKFuJSoJZPW8a8IA ($80.55 in chips)
Seat 2: Q+thC23WCv1kJUJtH/+4Jw ($27.50 in chips)
Seat 3: T0Gx/FcQ5VH9u7XaOMX97A ($63.90 in chips)
Seat 4: qanMEqjABjWxC/JgQ/0l7w ($63.45 in chips)
Seat 5: +Pf9jTVizYlIo+woPvptfA ($50 in chips)
Seat 6: DDfYzIrYT0t5R/hAJngtsg ($21.90 in chips)
DDfYzIrYT0t5R/hAJngtsg: posts small blind $0.25
YmWlPGOKFuJSoJZPW8a8IA: posts big blind $0.50
*** HOLE CARDS ***
Q+thC23WCv1kJUJtH/+4Jw: folds
T0Gx/FcQ5VH9u7XaOMX97A: raises $1 to $1.50
qanMEqjABjWxC/JgQ/0l7w: folds
+Pf9jTVizYlIo+woPvptfA: calls $1.50
DDfYzIrYT0t5R/hAJngtsg: folds
YmWlPGOKFuJSoJZPW8a8IA: folds
*** FLOP *** [8s 5c 2c]
T0Gx/FcQ5VH9u7XaOMX97A: bets $2.50
+Pf9jTVizYlIo+woPvptfA: folds
T0Gx/FcQ5VH9u7XaOMX97A collected $3.60 from pot
T0Gx/FcQ5VH9u7XaOMX97A: doesn't show hand
*** SUMMARY ***
Total pot $3.75 | Rake $0.15
Board [8s 5c 2c]
Seat 1: YmWlPGOKFuJSoJZPW8a8IA (big blind) folded before Flop
Seat 2: Q+thC23WCv1kJUJtH/+4Jw folded before Flop (didn't bet)
Seat 3: T0Gx/FcQ5VH9u7XaOMX97A collected ($3.60)
Seat 4: qanMEqjABjWxC/JgQ/0l7w folded before Flop (didn't bet)
Seat 5: +Pf9jTVizYlIo+woPvptfA (button) folded on the Flop
Seat 6: DDfYzIrYT0t5R/hAJngtsg (small blind) folded before Flop



PokerStars Game #59938247594:  Hold'em No Limit ($0.25/$0.50) - 2009/07/01 0:10:27 ET
Table 'QOgaEqMcJ73pcUMMxoisUg' 6-max Seat #5 is the button
Seat 1: RFefXIDyFvNtJLq+CloCzA ($43.20 in chips)
Seat 3: wUZNozoIDYf+16hp4nn6dw ($48.85 in chips)
Seat 4: zAcsDhG/T128Vn7XGVSgKg ($50 in chips)
Seat 5: HoaSQCRso+nEyO5DUhGduw ($57 in chips)
Seat 6: s83dnhZ6VC53vY0/f6OV/g ($48.05 in chips)
s83dnhZ6VC53vY0/f6OV/g: posts small blind $0.25
RFefXIDyFvNtJLq+CloCzA: posts big blind $0.50
Im2p1Nt83UKSqv5c9frm4Q: sits out
*** HOLE CARDS ***
wUZNozoIDYf+16hp4nn6dw: folds
zAcsDhG/T128Vn7XGVSgKg: folds
HoaSQCRso+nEyO5DUhGduw: folds
s83dnhZ6VC53vY0/f6OV/g: calls $0.25
RFefXIDyFvNtJLq+CloCzA: checks
*** FLOP *** [5s 7d 3d]
s83dnhZ6VC53vY0/f6OV/g: bets $1
RFefXIDyFvNtJLq+CloCzA: folds
s83dnhZ6VC53vY0/f6OV/g collected $0.95 from pot
*** SUMMARY ***
Total pot $1 | Rake $0.05
Board [5s 7d 3d]
Seat 1: RFefXIDyFvNtJLq+CloCzA (big blind) folded on the Flop
Seat 3: wUZNozoIDYf+16hp4nn6dw folded before Flop (didn't bet)
Seat 4: zAcsDhG/T128Vn7XGVSgKg folded before Flop (didn't bet)
Seat 5: HoaSQCRso+nEyO5DUhGduw (button) folded before Flop (didn't bet)
Seat 6: s83dnhZ6VC53vY0/f6OV/g (small blind) collected ($0.95)



PokerStars Game #59938247324:  Hold'em No Limit ($0.25/$0.50) - 2009/07/01 0:10:27 ET
Table 'PALRfuH85dr5IkDfdv6new' 9-max Seat #4 is the button
Seat 1: SKnJuWHScqetA/qG5p+wCg ($33 in chips)
Seat 2: 9r7ZoBbAJj5IeyZ0q9BdzA ($23.40 in chips)
Seat 3: 50QWoELmpmHFrFIlWMJo9g ($94.20 in chips)
Seat 4: /gaxz7F0MIjSN3t7ZPKwAA ($41.60 in chips)
Seat 5: jSSGUXdNFAZA3QCvTcUMQw ($42.55 in chips)
Seat 6: EiWj2MAl8RNcPhTkzz24Mw ($27.90 in chips)
Seat 7: 3NcyXvr39gnK+KbTq7ezyA ($34.85 in chips)
Seat 8: NkS+CseUKx4XHszWq0PXEQ ($43.10 in chips)
Seat 9: CIrAX/m6o7jYmKOAjJXv4Q ($25.05 in chips)
jSSGUXdNFAZA3QCvTcUMQw: posts small blind $0.25
EiWj2MAl8RNcPhTkzz24Mw: posts big blind $0.50
*** HOLE CARDS ***
3NcyXvr39gnK+KbTq7ezyA: folds
NkS+CseUKx4XHszWq0PXEQ: folds
CIrAX/m6o7jYmKOAjJXv4Q: folds
SKnJuWHScqetA/qG5p+wCg: folds
9r7ZoBbAJj5IeyZ0q9BdzA: folds
50QWoELmpmHFrFIlWMJo9g: folds
/gaxz7F0MIjSN3t7ZPKwAA: folds
jSSGUXdNFAZA3QCvTcUMQw: calls $0.25
EiWj2MAl8RNcPhTkzz24Mw: checks
*** FLOP *** [Jd Kd 8s]
jSSGUXdNFAZA3QCvTcUMQw: checks
EiWj2MAl8RNcPhTkzz24Mw: checks
*** TURN *** [Jd Kd 8s] [Th]
jSSGUXdNFAZA3QCvTcUMQw: checks
EiWj2MAl8RNcPhTkzz24Mw: checks
*** RIVER *** [Jd Kd 8s Th] [Td]
jSSGUXdNFAZA3QCvTcUMQw: bets $1
EiWj2MAl8RNcPhTkzz24Mw: folds
jSSGUXdNFAZA3QCvTcUMQw collected $0.95 from pot
jSSGUXdNFAZA3QCvTcUMQw: doesn't show hand
*** SUMMARY ***
Total pot $1 | Rake $0.05
Board [Jd Kd 8s Th Td]
Seat 1: SKnJuWHScqetA/qG5p+wCg folded before Flop (didn't bet)
Seat 2: 9r7ZoBbAJj5IeyZ0q9BdzA folded before Flop (didn't bet)
Seat 3: 50QWoELmpmHFrFIlWMJo9g folded before Flop (didn't bet)
Seat 4: /gaxz7F0MIjSN3t7ZPKwAA (button) folded before Flop (didn't bet)
Seat 5: jSSGUXdNFAZA3QCvTcUMQw (small blind) collected ($0.95)
Seat 6: EiWj2MAl8RNcPhTkzz24Mw (big blind) folded on the River
Seat 7: 3NcyXvr39gnK+KbTq7ezyA folded before Flop (didn't bet)
Seat 8: NkS+CseUKx4XHszWq0PXEQ folded before Flop (didn't bet)
Seat 9: CIrAX/m6o7jYmKOAjJXv4Q folded before Flop (didn't bet)



PokerStars Game #59938248744:  Hold'em No Limit ($0.25/$0.50) - 2009/07/01 0:10:29 ET
Table '+dXkOAQyS8j9PQZusUTMpg' 2-max Seat #1 is the button
Seat 1: XFa6sBGjP2gxoIvxR3fZIg ($72.45 in chips)
Seat 2: 5IBeOgaApY1Bvzv2P8X4EA ($40.20 in chips)
XFa6sBGjP2gxoIvxR3fZIg: posts small blind $0.25
5IBeOgaApY1Bvzv2P8X4EA: posts big blind $0.50
*** HOLE CARDS ***
XFa6sBGjP2gxoIvxR3fZIg: raises $1 to $1.50
5IBeOgaApY1Bvzv2P8X4EA: folds
XFa6sBGjP2gxoIvxR3fZIg collected $1 from pot
*** SUMMARY ***
Total pot $1 | Rake $0
Seat 1: XFa6sBGjP2gxoIvxR3fZIg (button) (small blind) collected ($1)
Seat 2: 5IBeOgaApY1Bvzv2P8X4EA (big blind) folded before Flop



PokerStars Game #59938249374:  Hold'em No Limit ($0.25/$0.50) - 2009/07/01 0:10:30 ET
Table 'mTxf8gPLgffN3Iwfm7Icfg' 2-max Seat #1 is the button
Seat 1: Do9Rlu1R5u/AcRtMTl8SYg ($66.55 in chips)
Seat 2: EMc5LPgVaded4Qc77vm0fw ($47.65 in chips)
Do9Rlu1R5u/AcRtMTl8SYg: posts small blind $0.25
EMc5LPgVaded4Qc77vm0fw: posts big blind $0.50
*** HOLE CARDS ***
Do9Rlu1R5u/AcRtMTl8SYg: raises $1 to $1.50
EMc5LPgVaded4Qc77vm0fw: calls $1
*** FLOP *** [Jh Qh 2h]
EMc5LPgVaded4Qc77vm0fw: bets $2
Do9Rlu1R5u/AcRtMTl8SYg: folds
EMc5LPgVaded4Qc77vm0fw collected $2.85 from pot
EMc5LPgVaded4Qc77vm0fw: doesn't show hand
*** SUMMARY ***
Total pot $3 | Rake $0.15
Board [Jh Qh 2h]
Seat 1: Do9Rlu1R5u/AcRtMTl8SYg (button) (small blind) folded on the Flop
Seat 2: EMc5LPgVaded4Qc77vm0fw (big blind) collected ($2.85)



PokerStars Game #59938250932:  Hold'em No Limit ($0.25/$0.50) - 2009/07/01 0:10:32 ET
Table 'X6IRCRTh+20gjz8aubWnwA' 9-max Seat #3 is the button
Seat 1: YPo1oggovmqSREegekaQYw ($9.45 in chips)
Seat 2: RjBdQ6w31rgcy0o24VLR6w ($11.65 in chips)
Seat 3: mSD1pginDsyHG5PDfqzphw ($10 in chips)
Seat 4: uw9QayAAxLM3Hb+HR7mSkg ($10.50 in chips)
Seat 5: L5e2lrPLQm1Pqx30IIZ/Fw ($10 in chips)
Seat 6: /6In1zC3WtgwxDcueWzZWg ($57.70 in chips)
Seat 7: VBnpbzn0dIveV55qKvciew ($55.95 in chips)
Seat 8: BPMN9sOItJw6vWq3kypaYg ($29.25 in chips)
Seat 9: M+7+BTmX5vZatHVuoRB1nA ($84.10 in chips)
uw9QayAAxLM3Hb+HR7mSkg: posts small blind $0.25
L5e2lrPLQm1Pqx30IIZ/Fw: posts big blind $0.50
*** HOLE CARDS ***
/6In1zC3WtgwxDcueWzZWg: folds
VBnpbzn0dIveV55qKvciew: raises $1 to $1.50
BPMN9sOItJw6vWq3kypaYg: folds
M+7+BTmX5vZatHVuoRB1nA: folds
YPo1oggovmqSREegekaQYw: folds
RjBdQ6w31rgcy0o24VLR6w: folds
mSD1pginDsyHG5PDfqzphw: folds
uw9QayAAxLM3Hb+HR7mSkg: folds
L5e2lrPLQm1Pqx30IIZ/Fw: folds
VBnpbzn0dIveV55qKvciew collected $1.25 from pot
*** SUMMARY ***
Total pot $1.25 | Rake $0
Seat 1: YPo1oggovmqSREegekaQYw folded before Flop (didn't bet)
Seat 2: RjBdQ6w31rgcy0o24VLR6w folded before Flop (didn't bet)
Seat 3: mSD1pginDsyHG5PDfqzphw (button) folded before Flop (didn't bet)
Seat 4: uw9QayAAxLM3Hb+HR7mSkg (small blind) folded before Flop
Seat 5: L5e2lrPLQm1Pqx30IIZ/Fw (big blind) folded before Flop
Seat 6: /6In1zC3WtgwxDcueWzZWg folded before Flop (didn't bet)
Seat 7: VBnpbzn0dIveV55qKvciew collected ($1.25)
Seat 8: BPMN9sOItJw6vWq3kypaYg folded before Flop (didn't bet)
Seat 9: M+7+BTmX5vZatHVuoRB1nA folded before Flop (didn't bet)



PokerStars Game #59938252366:  Hold'em No Limit ($0.25/$0.50) - 2009/07/01 0:10:34 ET
Table 'raOT4/ipuZgzjfKHC+jD9g' 2-max Seat #1 is the button
Seat 1: IuwLemwLhc9fvrwBGs0AMA ($9 in chips)
Seat 2: Udr5juWSWUgTu1NlRhjMdA ($14.25 in chips)
IuwLemwLhc9fvrwBGs0AMA: posts small blind $0.25
Udr5juWSWUgTu1NlRhjMdA: posts big blind $0.50
*** HOLE CARDS ***
IuwLemwLhc9fvrwBGs0AMA: calls $0.25
Udr5juWSWUgTu1NlRhjMdA: raises $1 to $1.50
IuwLemwLhc9fvrwBGs0AMA: calls $1
*** FLOP *** [Ah Jh Qc]
Udr5juWSWUgTu1NlRhjMdA: checks
IuwLemwLhc9fvrwBGs0AMA: bets $3
Udr5juWSWUgTu1NlRhjMdA: folds
IuwLemwLhc9fvrwBGs0AMA collected $2.85 from pot
*** SUMMARY ***
Total pot $3 | Rake $0.15
Board [Ah Jh Qc]
Seat 1: IuwLemwLhc9fvrwBGs0AMA (button) (small blind) collected ($2.85)
Seat 2: Udr5juWSWUgTu1NlRhjMdA (big blind) folded on the Flop



PokerStars Game #59938252978:  Hold'em No Limit ($0.25/$0.50) - 2009/07/01 0:10:35 ET
Table 'E7bWJ45aoFXRpyRv2gw+Ig' 2-max Seat #1 is the button
Seat 1: FRkiRasEGlHUeLrEl+k/nA ($74.20 in chips)
Seat 2: 3Wro85I7472vJ4Wkpneo9A ($49.55 in chips)
FRkiRasEGlHUeLrEl+k/nA: posts small blind $0.25
3Wro85I7472vJ4Wkpneo9A: posts big blind $0.50
*** HOLE CARDS ***
FRkiRasEGlHUeLrEl+k/nA: raises $1 to $1.50
3Wro85I7472vJ4Wkpneo9A: folds
FRkiRasEGlHUeLrEl+k/nA collected $1 from pot
FRkiRasEGlHUeLrEl+k/nA: doesn't show hand
*** SUMMARY ***
Total pot $1 | Rake $0
Seat 1: FRkiRasEGlHUeLrEl+k/nA (button) (small blind) collected ($1)
Seat 2: 3Wro85I7472vJ4Wkpneo9A (big blind) folded before Flop



PokerStars Game #59938254798:  Hold'em No Limit ($0.25/$0.50) - 2009/07/01 0:10:37 ET
Table 'SsXEKOwKN+jE3etfusqUqA' 2-max Seat #1 is the button
Seat 1: 618rKeLrz/avGNOLULHHVQ ($3.70 in chips)
Seat 2: XfRhywXA6Br+jID1oGeo8A ($304.90 in chips)
618rKeLrz/avGNOLULHHVQ: posts small blind $0.25
XfRhywXA6Br+jID1oGeo8A: posts big blind $0.50
*** HOLE CARDS ***
618rKeLrz/avGNOLULHHVQ said, "yup"
618rKeLrz/avGNOLULHHVQ said, "call ur 4s"
618rKeLrz/avGNOLULHHVQ said, "oh well"
618rKeLrz/avGNOLULHHVQ said, "im busto now"
618rKeLrz/avGNOLULHHVQ said, "nh"
618rKeLrz/avGNOLULHHVQ: raises $3.20 to $3.70 and is all-in
XfRhywXA6Br+jID1oGeo8A: folds
618rKeLrz/avGNOLULHHVQ collected $1 from pot
618rKeLrz/avGNOLULHHVQ: doesn't show hand
*** SUMMARY ***
Total pot $1 | Rake $0
Seat 1: 618rKeLrz/avGNOLULHHVQ (button) (small blind) collected ($1)
Seat 2: XfRhywXA6Br+jID1oGeo8A (big blind) folded before Flop



PokerStars Game #59938254530:  Hold'em No Limit ($0.25/$0.50) - 2009/07/01 0:10:37 ET
Table '+dXkOAQyS8j9PQZusUTMpg' 2-max Seat #2 is the button
Seat 1: XFa6sBGjP2gxoIvxR3fZIg ($72.95 in chips)
Seat 2: 5IBeOgaApY1Bvzv2P8X4EA ($39.70 in chips)
5IBeOgaApY1Bvzv2P8X4EA: posts small blind $0.25
XFa6sBGjP2gxoIvxR3fZIg: posts big blind $0.50
*** HOLE CARDS ***
5IBeOgaApY1Bvzv2P8X4EA: raises $1 to $1.50
XFa6sBGjP2gxoIvxR3fZIg: folds
5IBeOgaApY1Bvzv2P8X4EA collected $1 from pot
5IBeOgaApY1Bvzv2P8X4EA: doesn't show hand
*** SUMMARY ***
Total pot $1 | Rake $0
Seat 1: XFa6sBGjP2gxoIvxR3fZIg (big blind) folded before Flop
Seat 2: 5IBeOgaApY1Bvzv2P8X4EA (button) (small blind) collected ($1)



PokerStars Game #59938254484:  Hold'em No Limit ($0.25/$0.50) - 2009/07/01 0:10:37 ET
Table '+z1aekfHkpp09pc8F9aViw' 6-max Seat #1 is the button
Seat 1: lWwl5C/UZOsWNubdUqghZw ($50.45 in chips)
Seat 2: VuB2GN0h94yY+QbuI2Mybg ($15.95 in chips)
Seat 3: uUznlIMFnRUvwrBhYF73KA ($54.95 in chips)
Seat 4: OCrv7ObFH4/s2lv7rYOnsQ ($27.90 in chips)
Seat 5: crjGpJEzSZgD38FoE3VMGg ($62.15 in chips)
Seat 6: 686aeHikcJlgKkSuIFdcXQ ($71.25 in chips)
VuB2GN0h94yY+QbuI2Mybg: posts small blind $0.25
uUznlIMFnRUvwrBhYF73KA: posts big blind $0.50
*** HOLE CARDS ***
OCrv7ObFH4/s2lv7rYOnsQ: calls $0.50
crjGpJEzSZgD38FoE3VMGg: raises $2 to $2.50
686aeHikcJlgKkSuIFdcXQ: folds
lWwl5C/UZOsWNubdUqghZw: folds
VuB2GN0h94yY+QbuI2Mybg: folds
uUznlIMFnRUvwrBhYF73KA: folds
OCrv7ObFH4/s2lv7rYOnsQ: calls $2
*** FLOP *** [Td 3h Js]
OCrv7ObFH4/s2lv7rYOnsQ: checks
crjGpJEzSZgD38FoE3VMGg: bets $3
OCrv7ObFH4/s2lv7rYOnsQ: folds
crjGpJEzSZgD38FoE3VMGg collected $5.50 from pot
*** SUMMARY ***
Total pot $5.75 | Rake $0.25
Board [Td 3h Js]
Seat 1: lWwl5C/UZOsWNubdUqghZw (button) folded before Flop (didn't bet)
Seat 2: VuB2GN0h94yY+QbuI2Mybg (small blind) folded before Flop
Seat 3: uUznlIMFnRUvwrBhYF73KA (big blind) folded before Flop
Seat 4: OCrv7ObFH4/s2lv7rYOnsQ folded on the Flop
Seat 5: crjGpJEzSZgD38FoE3VMGg collected ($5.50)
Seat 6: 686aeHikcJlgKkSuIFdcXQ folded before Flop (didn't bet)



PokerStars Game #59938254578:  Hold'em No Limit ($0.25/$0.50) - 2009/07/01 0:10:37 ET
Table '3FhG0gl3kMX3wBEEqj+wnQ' 9-max Seat #3 is the button
Seat 1: e0J9pdCNUDTCG031RnXqLA ($25.45 in chips)
Seat 2: 4dl3YNqZ6Houm2jZAzDmRg ($25.75 in chips)
Seat 3: bXpVeaSTPBFSPJmeXxO7nw ($10 in chips)
Seat 4: bz4LMfV0GGl/MJ/ABXuPmg ($16.40 in chips)
Seat 5: XNMDwbXt/Q4jM99AXnbJDw ($50 in chips)
Seat 6: 5JJVDlaiMnB004o/RqbZZQ ($26.75 in chips)
Seat 7: 6XkTu4ahxzHnvjjc1R8YjQ ($9.25 in chips)
Seat 8: j3K/Jujr7PY4ZM2RZvlH6A ($57.35 in chips)
Seat 9: tzoXBDwkkPV/XPJPkf963Q ($12.60 in chips)
bz4LMfV0GGl/MJ/ABXuPmg: posts small blind $0.25
XNMDwbXt/Q4jM99AXnbJDw: posts big blind $0.50
*** HOLE CARDS ***
5JJVDlaiMnB004o/RqbZZQ: folds
6XkTu4ahxzHnvjjc1R8YjQ: raises $1 to $1.50
j3K/Jujr7PY4ZM2RZvlH6A: folds
tzoXBDwkkPV/XPJPkf963Q: folds
e0J9pdCNUDTCG031RnXqLA: folds
4dl3YNqZ6Houm2jZAzDmRg: folds
bXpVeaSTPBFSPJmeXxO7nw: folds
bz4LMfV0GGl/MJ/ABXuPmg: calls $1.25
XNMDwbXt/Q4jM99AXnbJDw: folds
*** FLOP *** [5h 9h 3c]
bz4LMfV0GGl/MJ/ABXuPmg: checks
6XkTu4ahxzHnvjjc1R8YjQ: bets $2.50
bz4LMfV0GGl/MJ/ABXuPmg: folds
6XkTu4ahxzHnvjjc1R8YjQ collected $3.35 from pot
*** SUMMARY ***
Total pot $3.50 | Rake $0.15
Board [5h 9h 3c]
Seat 1: e0J9pdCNUDTCG031RnXqLA folded before Flop (didn't bet)
Seat 2: 4dl3YNqZ6Houm2jZAzDmRg folded before Flop (didn't bet)
Seat 3: bXpVeaSTPBFSPJmeXxO7nw (button) folded before Flop (didn't bet)
Seat 4: bz4LMfV0GGl/MJ/ABXuPmg (small blind) folded on the Flop
Seat 5: XNMDwbXt/Q4jM99AXnbJDw (big blind) folded before Flop
Seat 6: 5JJVDlaiMnB004o/RqbZZQ folded before Flop (didn't bet)
Seat 7: 6XkTu4ahxzHnvjjc1R8YjQ collected ($3.35)
Seat 8: j3K/Jujr7PY4ZM2RZvlH6A folded before Flop (didn't bet)
Seat 9: tzoXBDwkkPV/XPJPkf963Q folded before Flop (didn't bet)



PokerStars Game #59938256026:  Hold'em No Limit ($0.25/$0.50) - 2009/07/01 0:10:39 ET
Table 'ibNfFy0bCzuBaUORla0aGw' 9-max Seat #6 is the button
Seat 1: xZCXQSXlrZkp3pZizzVXCw ($56.95 in chips)
Seat 2: 90Wb75h3W1BRpbqVnuk8gw ($52.55 in chips)
Seat 3: dDaHs3X8+fe3bIkRU0cbrw ($26.30 in chips)
Seat 4: YBN054X4blmis+B2bBlC0g ($19.45 in chips)
Seat 5: FRv75HO8CUsRZ1byEz06mQ ($15.35 in chips)
Seat 6: BmYrv3ec2k5d6pQq6iNaZw ($67.85 in chips)
Seat 7: mSD1pginDsyHG5PDfqzphw ($10 in chips)
Seat 8: xUrN9TWLq4m5V+OXY7KUUA ($50 in chips)
Seat 9: WpvT3OUSiZlpvs+mPXFqtQ ($8.75 in chips)
mSD1pginDsyHG5PDfqzphw: posts small blind $0.25
xUrN9TWLq4m5V+OXY7KUUA: posts big blind $0.50
*** HOLE CARDS ***
WpvT3OUSiZlpvs+mPXFqtQ: folds
xZCXQSXlrZkp3pZizzVXCw: folds
90Wb75h3W1BRpbqVnuk8gw: folds
dDaHs3X8+fe3bIkRU0cbrw: folds
YBN054X4blmis+B2bBlC0g: calls $0.50
FRv75HO8CUsRZ1byEz06mQ: folds
BmYrv3ec2k5d6pQq6iNaZw: folds
mSD1pginDsyHG5PDfqzphw: folds
xUrN9TWLq4m5V+OXY7KUUA: checks
*** FLOP *** [Ts 4d 4c]
xUrN9TWLq4m5V+OXY7KUUA: checks
YBN054X4blmis+B2bBlC0g: checks
*** TURN *** [Ts 4d 4c] [Ad]
xUrN9TWLq4m5V+OXY7KUUA: checks
YBN054X4blmis+B2bBlC0g: checks
*** RIVER *** [Ts 4d 4c Ad] [2d]
xUrN9TWLq4m5V+OXY7KUUA: bets $1
YBN054X4blmis+B2bBlC0g: raises $1 to $2
xUrN9TWLq4m5V+OXY7KUUA: folds
YBN054X4blmis+B2bBlC0g collected $3.10 from pot
*** SUMMARY ***
Total pot $3.25 | Rake $0.15
Board [Ts 4d 4c Ad 2d]
Seat 1: xZCXQSXlrZkp3pZizzVXCw folded before Flop (didn't bet)
Seat 2: 90Wb75h3W1BRpbqVnuk8gw folded before Flop (didn't bet)
Seat 3: dDaHs3X8+fe3bIkRU0cbrw folded before Flop (didn't bet)
Seat 4: YBN054X4blmis+B2bBlC0g collected ($3.10)
Seat 5: FRv75HO8CUsRZ1byEz06mQ folded before Flop (didn't bet)
Seat 6: BmYrv3ec2k5d6pQq6iNaZw (button) folded before Flop (didn't bet)
Seat 7: mSD1pginDsyHG5PDfqzphw (small blind) folded before Flop
Seat 8: xUrN9TWLq4m5V+OXY7KUUA (big blind) folded on the River
Seat 9: WpvT3OUSiZlpvs+mPXFqtQ folded before Flop (didn't bet)



PokerStars Game #59938257090:  Hold'em No Limit ($0.25/$0.50) - 2009/07/01 0:10:41 ET
Table 'NCiXr0d5CEKBQr/cZgLhbA' 9-max Seat #4 is the button
Seat 1: RjBdQ6w31rgcy0o24VLR6w ($8.50 in chips)
Seat 2: ulxuJchBV9iguXg0FUonfg ($35.80 in chips)
Seat 3: xZCXQSXlrZkp3pZizzVXCw ($54.90 in chips)
Seat 4: CL4d+tvzcd4utdQxlPLOmg ($29.15 in chips)
Seat 5: zE9cVigS2nW/Ljy4K4bUQA ($32.20 in chips)
Seat 6: SKnJuWHScqetA/qG5p+wCg ($31.80 in chips)
Seat 8: 1MJUKc3cc0QmUoz1JZLR2w ($64.25 in chips)
Seat 9: WpvT3OUSiZlpvs+mPXFqtQ ($8.20 in chips)
zE9cVigS2nW/Ljy4K4bUQA: posts small blind $0.25
SKnJuWHScqetA/qG5p+wCg: posts big blind $0.50
*** HOLE CARDS ***
1MJUKc3cc0QmUoz1JZLR2w: folds
WpvT3OUSiZlpvs+mPXFqtQ: folds
RjBdQ6w31rgcy0o24VLR6w: folds
ulxuJchBV9iguXg0FUonfg: folds
EltNhVR1POPXhu/1E62t3A leaves the table
xZCXQSXlrZkp3pZizzVXCw: raises $1 to $1.50
CL4d+tvzcd4utdQxlPLOmg: folds
zE9cVigS2nW/Ljy4K4bUQA: folds
SKnJuWHScqetA/qG5p+wCg: folds
xZCXQSXlrZkp3pZizzVXCw collected $1.25 from pot
*** SUMMARY ***
Total pot $1.25 | Rake $0
Seat 1: RjBdQ6w31rgcy0o24VLR6w folded before Flop (didn't bet)
Seat 2: ulxuJchBV9iguXg0FUonfg folded before Flop (didn't bet)
Seat 3: xZCXQSXlrZkp3pZizzVXCw collected ($1.25)
Seat 4: CL4d+tvzcd4utdQxlPLOmg (button) folded before Flop (didn't bet)
Seat 5: zE9cVigS2nW/Ljy4K4bUQA (small blind) folded before Flop
Seat 6: SKnJuWHScqetA/qG5p+wCg (big blind) folded before Flop
Seat 8: 1MJUKc3cc0QmUoz1JZLR2w folded before Flop (didn't bet)
Seat 9: WpvT3OUSiZlpvs+mPXFqtQ folded before Flop (didn't bet)



PokerStars Game #59938259112:  Hold'em No Limit ($0.25/$0.50) - 2009/07/01 0:10:43 ET
Table 'Nz0Vr7WMHL2g5Uk7dDZjpw' 9-max Seat #3 is the button
Seat 1: tLkxo7JgV+WWI0UBw44K5A ($104.85 in chips)
Seat 3: 4QTiNH5fteLgJjx/s6Hy6A ($19.10 in chips)
Seat 4: 5JJVDlaiMnB004o/RqbZZQ ($27.25 in chips)
Seat 5: WGW0DgjBUXs1ylURHG8vnQ ($17.90 in chips)
Seat 6: k1f0lS7tlMHCLGs0JT34Tg ($9.25 in chips)
Seat 7: KPLH0gELgFe2OuAnhJFI5w ($22.95 in chips)
Seat 8: HkZI6g4zl83TDTA7SRspmQ ($17.25 in chips)
Seat 9: Ak2W6V2TDVIQrvSAy4eD7Q ($11.35 in chips)
5JJVDlaiMnB004o/RqbZZQ: posts small blind $0.25
WGW0DgjBUXs1ylURHG8vnQ: posts big blind $0.50
*** HOLE CARDS ***
k1f0lS7tlMHCLGs0JT34Tg: folds
KPLH0gELgFe2OuAnhJFI5w: calls $0.50
HkZI6g4zl83TDTA7SRspmQ: folds
Ak2W6V2TDVIQrvSAy4eD7Q: raises $10.85 to $11.35 and is all-in
tLkxo7JgV+WWI0UBw44K5A: folds
4QTiNH5fteLgJjx/s6Hy6A: calls $11.35
5JJVDlaiMnB004o/RqbZZQ: folds
WGW0DgjBUXs1ylURHG8vnQ: folds
KPLH0gELgFe2OuAnhJFI5w: folds
*** FLOP *** [3s Qh 5c]
*** TURN *** [3s Qh 5c] [Qd]
*** RIVER *** [3s Qh 5c Qd] [2s]
*** SHOW DOWN ***
Ak2W6V2TDVIQrvSAy4eD7Q: shows [3d 3h] (a full house, Threes full of Queens)
4QTiNH5fteLgJjx/s6Hy6A: mucks hand
Ak2W6V2TDVIQrvSAy4eD7Q collected $22.80 from pot
*** SUMMARY ***
Total pot $23.95 | Rake $1.15
Board [3s Qh 5c Qd 2s]
Seat 1: tLkxo7JgV+WWI0UBw44K5A folded before Flop (didn't bet)
Seat 3: 4QTiNH5fteLgJjx/s6Hy6A (button) mucked
Seat 4: 5JJVDlaiMnB004o/RqbZZQ (small blind) folded before Flop
Seat 5: WGW0DgjBUXs1ylURHG8vnQ (big blind) folded before Flop
Seat 6: k1f0lS7tlMHCLGs0JT34Tg folded before Flop (didn't bet)
Seat 7: KPLH0gELgFe2OuAnhJFI5w folded before Flop
Seat 8: HkZI6g4zl83TDTA7SRspmQ folded before Flop (didn't bet)
Seat 9: Ak2W6V2TDVIQrvSAy4eD7Q showed [3d 3h] and won ($22.80) with a full house, Threes full of Queens



PokerStars Game #59938258742:  Hold'em No Limit ($0.25/$0.50) - 2009/07/01 0:10:43 ET
Table 'E7bWJ45aoFXRpyRv2gw+Ig' 2-max Seat #2 is the button
Seat 1: FRkiRasEGlHUeLrEl+k/nA ($74.70 in chips)
Seat 2: 3Wro85I7472vJ4Wkpneo9A ($49.05 in chips)
3Wro85I7472vJ4Wkpneo9A: posts small blind $0.25
FRkiRasEGlHUeLrEl+k/nA: posts big blind $0.50
*** HOLE CARDS ***
3Wro85I7472vJ4Wkpneo9A: raises $1 to $1.50
FRkiRasEGlHUeLrEl+k/nA: calls $1
*** FLOP *** [8c 5s Th]
FRkiRasEGlHUeLrEl+k/nA: checks
3Wro85I7472vJ4Wkpneo9A: checks
*** TURN *** [8c 5s Th] [7d]
FRkiRasEGlHUeLrEl+k/nA: bets $1
3Wro85I7472vJ4Wkpneo9A: folds
FRkiRasEGlHUeLrEl+k/nA collected $2.85 from pot
FRkiRasEGlHUeLrEl+k/nA: doesn't show hand
*** SUMMARY ***
Total pot $3 | Rake $0.15
Board [8c 5s Th 7d]
Seat 1: FRkiRasEGlHUeLrEl+k/nA (big blind) collected ($2.85)
Seat 2: 3Wro85I7472vJ4Wkpneo9A (button) (small blind) folded on the Turn



PokerStars Game #59938260358:  Hold'em No Limit ($0.25/$0.50) - 2009/07/01 0:10:45 ET
Table '+dXkOAQyS8j9PQZusUTMpg' 2-max Seat #1 is the button
Seat 1: XFa6sBGjP2gxoIvxR3fZIg ($72.45 in chips)
Seat 2: 5IBeOgaApY1Bvzv2P8X4EA ($40.20 in chips)
XFa6sBGjP2gxoIvxR3fZIg: posts small blind $0.25
5IBeOgaApY1Bvzv2P8X4EA: posts big blind $0.50
*** HOLE CARDS ***
XFa6sBGjP2gxoIvxR3fZIg: raises $1 to $1.50
5IBeOgaApY1Bvzv2P8X4EA: folds
XFa6sBGjP2gxoIvxR3fZIg collected $1 from pot
*** SUMMARY ***
Total pot $1 | Rake $0
Seat 1: XFa6sBGjP2gxoIvxR3fZIg (button) (small blind) collected ($1)
Seat 2: 5IBeOgaApY1Bvzv2P8X4EA (big blind) folded before Flop



PokerStars Game #59938259968:  Hold'em No Limit ($0.25/$0.50) - 2009/07/01 0:10:45 ET
Table 'otvGDROEDdqsabxskT79qg' 9-max Seat #2 is the button
Seat 1: LM/g4VPDfD+0JhpH9Q/3fw ($29.15 in chips)
Seat 2: cCjTzH9jio8607WzjcfXlg ($45.85 in chips)
Seat 3: +k7T5ocke8UwavtgUHm+Cg ($35.55 in chips)
Seat 4: MG90wfSJZnOejs/KD3vlQQ ($50 in chips)
Seat 5: YPo1oggovmqSREegekaQYw ($32.20 in chips)
Seat 7: C7+tBppJrKgd/r+tuKUIpA ($40.85 in chips)
Seat 9: KcY3X8YpD74Kw1RHkx/g4A ($38.10 in chips)
+k7T5ocke8UwavtgUHm+Cg: posts small blind $0.25
MG90wfSJZnOejs/KD3vlQQ: posts big blind $0.50
WpvT3OUSiZlpvs+mPXFqtQ: sits out
*** HOLE CARDS ***
YPo1oggovmqSREegekaQYw: folds
C7+tBppJrKgd/r+tuKUIpA: folds
KcY3X8YpD74Kw1RHkx/g4A: folds
LM/g4VPDfD+0JhpH9Q/3fw: calls $0.50
cCjTzH9jio8607WzjcfXlg: calls $0.50
+k7T5ocke8UwavtgUHm+Cg: calls $0.25
MG90wfSJZnOejs/KD3vlQQ: checks
*** FLOP *** [Ts Td 9d]
+k7T5ocke8UwavtgUHm+Cg: bets $1
MG90wfSJZnOejs/KD3vlQQ: folds
LM/g4VPDfD+0JhpH9Q/3fw: calls $1
cCjTzH9jio8607WzjcfXlg: calls $1
*** TURN *** [Ts Td 9d] [9s]
+k7T5ocke8UwavtgUHm+Cg: bets $3
LM/g4VPDfD+0JhpH9Q/3fw: folds
cCjTzH9jio8607WzjcfXlg: raises $3 to $6
+k7T5ocke8UwavtgUHm+Cg: calls $3
*** RIVER *** [Ts Td 9d 9s] [Jh]
+k7T5ocke8UwavtgUHm+Cg: checks
cCjTzH9jio8607WzjcfXlg: bets $38.35 and is all-in
+k7T5ocke8UwavtgUHm+Cg: calls $28.05 and is all-in
*** SHOW DOWN ***
cCjTzH9jio8607WzjcfXlg: shows [Ah Ac] (two pair, Aces and Tens)
+k7T5ocke8UwavtgUHm+Cg: shows [8h Th] (a full house, Tens full of Nines)
+k7T5ocke8UwavtgUHm+Cg collected $70.10 from pot
*** SUMMARY ***
Total pot $73.10 | Rake $3
Board [Ts Td 9d 9s Jh]
Seat 1: LM/g4VPDfD+0JhpH9Q/3fw folded on the Turn
Seat 2: cCjTzH9jio8607WzjcfXlg (button) showed [Ah Ac] and lost with two pair, Aces and Tens
Seat 3: +k7T5ocke8UwavtgUHm+Cg (small blind) showed [8h Th] and won ($70.10) with a full house, Tens full of Nines
Seat 4: MG90wfSJZnOejs/KD3vlQQ (big blind) folded on the Flop
Seat 5: YPo1oggovmqSREegekaQYw folded before Flop (didn't bet)
Seat 7: C7+tBppJrKgd/r+tuKUIpA folded before Flop (didn't bet)
Seat 9: KcY3X8YpD74Kw1RHkx/g4A folded before Flop (didn't bet)



PokerStars Game #59938261860:  Hold'em No Limit ($0.25/$0.50) - 2009/07/01 0:10:47 ET
Table 'YsnnHkamRzYqMOr2FlLY4w' 6-max Seat #6 is the button
Seat 1: crjGpJEzSZgD38FoE3VMGg ($54.15 in chips)
Seat 2: vnRgOasQNKOR7gLXwRQ+ww ($50 in chips)
Seat 3: I+pG2m/dD5iYdbg9qx572g ($21.25 in chips)
Seat 4: 7Fue572p4ZIC85AJMQvaQw ($50.90 in chips)
Seat 5: lcQ7uuLf+WLGGy4Ve6VKKA ($42.85 in chips)
Seat 6: YmWlPGOKFuJSoJZPW8a8IA ($53.40 in chips)
crjGpJEzSZgD38FoE3VMGg: posts small blind $0.25
vnRgOasQNKOR7gLXwRQ+ww: posts big blind $0.50
*** HOLE CARDS ***
I+pG2m/dD5iYdbg9qx572g: folds
7Fue572p4ZIC85AJMQvaQw: raises $0.50 to $1
lcQ7uuLf+WLGGy4Ve6VKKA: calls $1
YmWlPGOKFuJSoJZPW8a8IA: raises $4.25 to $5.25
crjGpJEzSZgD38FoE3VMGg: raises $8.25 to $13.50
vnRgOasQNKOR7gLXwRQ+ww: folds
7Fue572p4ZIC85AJMQvaQw: folds
lcQ7uuLf+WLGGy4Ve6VKKA: folds
YmWlPGOKFuJSoJZPW8a8IA: folds
crjGpJEzSZgD38FoE3VMGg collected $13 from pot
crjGpJEzSZgD38FoE3VMGg: doesn't show hand
*** SUMMARY ***
Total pot $13 | Rake $0
Seat 1: crjGpJEzSZgD38FoE3VMGg (small blind) collected ($13)
Seat 2: vnRgOasQNKOR7gLXwRQ+ww (big blind) folded before Flop
Seat 3: I+pG2m/dD5iYdbg9qx572g folded before Flop (didn't bet)
Seat 4: 7Fue572p4ZIC85AJMQvaQw folded before Flop
Seat 5: lcQ7uuLf+WLGGy4Ve6VKKA folded before Flop
Seat 6: YmWlPGOKFuJSoJZPW8a8IA (button) folded before Flop



PokerStars Game #59938261448:  Hold'em No Limit ($0.25/$0.50) - 2009/07/01 0:10:47 ET
Table 'mTxf8gPLgffN3Iwfm7Icfg' 2-max Seat #2 is the button
Seat 1: Do9Rlu1R5u/AcRtMTl8SYg ($65.05 in chips)
Seat 2: EMc5LPgVaded4Qc77vm0fw ($49 in chips)
EMc5LPgVaded4Qc77vm0fw: posts small blind $0.25
Do9Rlu1R5u/AcRtMTl8SYg: posts big blind $0.50
*** HOLE CARDS ***
EMc5LPgVaded4Qc77vm0fw: raises $1.50 to $2
Do9Rlu1R5u/AcRtMTl8SYg: folds
EMc5LPgVaded4Qc77vm0fw collected $1 from pot
EMc5LPgVaded4Qc77vm0fw: doesn't show hand
*** SUMMARY ***
Total pot $1 | Rake $0
Seat 1: Do9Rlu1R5u/AcRtMTl8SYg (big blind) folded before Flop
Seat 2: EMc5LPgVaded4Qc77vm0fw (button) (small blind) collected ($1)



PokerStars Game #59938261730:  Hold'em No Limit ($0.25/$0.50) - 2009/07/01 0:10:47 ET
Table 'c/CRn+68J3Y8KxD5g1ek2Q' 2-max Seat #2 is the button
Seat 1: 46qCyJ6evTkHo9al5sBMNA ($326.40 in chips)
Seat 2: BypVLsYQt3ePFm2xQL/dOA ($59.35 in chips)
BypVLsYQt3ePFm2xQL/dOA: posts small blind $0.25
46qCyJ6evTkHo9al5sBMNA: posts big blind $0.50
*** HOLE CARDS ***
BypVLsYQt3ePFm2xQL/dOA: raises $1.50 to $2
46qCyJ6evTkHo9al5sBMNA: folds
BypVLsYQt3ePFm2xQL/dOA collected $1 from pot
BypVLsYQt3ePFm2xQL/dOA: doesn't show hand
*** SUMMARY ***
Total pot $1 | Rake $0
Seat 1: 46qCyJ6evTkHo9al5sBMNA (big blind) folded before Flop
Seat 2: BypVLsYQt3ePFm2xQL/dOA (button) (small blind) collected ($1)



PokerStars Game #59938261828:  Hold'em No Limit ($0.25/$0.50) - 2009/07/01 0:10:47 ET
Table 'Vdlc9wqYcHTUhtdyN7CuJw' 2-max Seat #1 is the button
Seat 1: yBO+mXB6m/rCft2ErwGf/Q ($94.60 in chips)
Seat 2: sa0qgETiL3HNbdfGlnKHTA ($17.95 in chips)
yBO+mXB6m/rCft2ErwGf/Q: posts small blind $0.25
sa0qgETiL3HNbdfGlnKHTA: posts big blind $0.50
*** HOLE CARDS ***
yBO+mXB6m/rCft2ErwGf/Q: raises $0.50 to $1
sa0qgETiL3HNbdfGlnKHTA: calls $0.50
*** FLOP *** [Qc Ah Qh]
sa0qgETiL3HNbdfGlnKHTA: bets $1.50
yBO+mXB6m/rCft2ErwGf/Q: calls $1.50
*** TURN *** [Qc Ah Qh] [6c]
sa0qgETiL3HNbdfGlnKHTA: checks
yBO+mXB6m/rCft2ErwGf/Q: checks
*** RIVER *** [Qc Ah Qh 6c] [2c]
sa0qgETiL3HNbdfGlnKHTA: checks
yBO+mXB6m/rCft2ErwGf/Q: bets $2
sa0qgETiL3HNbdfGlnKHTA: calls $2
*** SHOW DOWN ***
yBO+mXB6m/rCft2ErwGf/Q: shows [9h 7h] (a pair of Queens)
sa0qgETiL3HNbdfGlnKHTA: shows [Ac 5h] (two pair, Aces and Queens)
sa0qgETiL3HNbdfGlnKHTA collected $8.60 from pot
*** SUMMARY ***
Total pot $9 | Rake $0.40
Board [Qc Ah Qh 6c 2c]
Seat 1: yBO+mXB6m/rCft2ErwGf/Q (button) (small blind) showed [9h 7h] and lost with a pair of Queens
Seat 2: sa0qgETiL3HNbdfGlnKHTA (big blind) showed [Ac 5h] and won ($8.60) with two pair, Aces and Queens



PokerStars Game #59938262420:  Hold'em No Limit ($0.25/$0.50) - 2009/07/01 0:10:48 ET
Table 'lSisgp6H7Fg1hH5VfjEjYQ' 9-max Seat #2 is the button
Seat 1: pEW8B6uXbdR47kfljMQ3+Q ($39.70 in chips)
Seat 2: UrcnkQOiLVk8BlKDPJSy7Q ($51.85 in chips)
Seat 4: nvw9yQKhJT56lA9k+TLdhw ($11.20 in chips)
Seat 5: mSD1pginDsyHG5PDfqzphw ($10 in chips)
Seat 6: +k7T5ocke8UwavtgUHm+Cg ($21.65 in chips)
Seat 7: xyQ4CeZa3ug3ompz+5xSTg ($73.95 in chips)
Seat 8: bXpVeaSTPBFSPJmeXxO7nw ($19.50 in chips)
Seat 9: 5JJVDlaiMnB004o/RqbZZQ ($41.55 in chips)
nvw9yQKhJT56lA9k+TLdhw: posts small blind $0.25
mSD1pginDsyHG5PDfqzphw: posts big blind $0.50
*** HOLE CARDS ***
+k7T5ocke8UwavtgUHm+Cg: raises $2 to $2.50
xyQ4CeZa3ug3ompz+5xSTg: folds
bXpVeaSTPBFSPJmeXxO7nw: folds
5JJVDlaiMnB004o/RqbZZQ: folds
pEW8B6uXbdR47kfljMQ3+Q: folds
aTkyjTh3w5YLWiIERupZOA joins the table at seat #3
UrcnkQOiLVk8BlKDPJSy7Q: folds
nvw9yQKhJT56lA9k+TLdhw: folds
mSD1pginDsyHG5PDfqzphw: folds
+k7T5ocke8UwavtgUHm+Cg collected $1.25 from pot
+k7T5ocke8UwavtgUHm+Cg: doesn't show hand
*** SUMMARY ***
Total pot $1.25 | Rake $0
Seat 1: pEW8B6uXbdR47kfljMQ3+Q folded before Flop (didn't bet)
Seat 2: UrcnkQOiLVk8BlKDPJSy7Q (button) folded before Flop (didn't bet)
Seat 4: nvw9yQKhJT56lA9k+TLdhw (small blind) folded before Flop
Seat 5: mSD1pginDsyHG5PDfqzphw (big blind) folded before Flop
Seat 6: +k7T5ocke8UwavtgUHm+Cg collected ($1.25)
Seat 7: xyQ4CeZa3ug3ompz+5xSTg folded before Flop (didn't bet)
Seat 8: bXpVeaSTPBFSPJmeXxO7nw folded before Flop (didn't bet)
Seat 9: 5JJVDlaiMnB004o/RqbZZQ folded before Flop (didn't bet)



PokerStars Game #59938263082:  Hold'em No Limit ($0.25/$0.50) - 2009/07/01 0:10:49 ET
Table 'eMxdLyFDf28E0wit6gm3Uw' 6-max Seat #1 is the button
Seat 1: tnD/64LagZ9qPaeOQVjVZg ($11.95 in chips)
Seat 2: jwuKQ1S3U4NnzMQn3E3dgw ($64.15 in chips)
Seat 3: dZcLsEI8iXkobBduRJ45Yw ($12 in chips)
Seat 4: crjGpJEzSZgD38FoE3VMGg ($50.50 in chips)
Seat 5: X0X97o2fDAPiGx6o1gahsw ($58.05 in chips)
Seat 6: L0aIPg7qefDQjdJo3HCVEA ($7.50 in chips)
jwuKQ1S3U4NnzMQn3E3dgw: posts small blind $0.25
dZcLsEI8iXkobBduRJ45Yw: posts big blind $0.50
*** HOLE CARDS ***
crjGpJEzSZgD38FoE3VMGg: folds
X0X97o2fDAPiGx6o1gahsw: folds
L0aIPg7qefDQjdJo3HCVEA: raises $0.50 to $1
tnD/64LagZ9qPaeOQVjVZg: folds
jwuKQ1S3U4NnzMQn3E3dgw: folds
dZcLsEI8iXkobBduRJ45Yw: calls $0.50
*** FLOP *** [6c 2d Kd]
dZcLsEI8iXkobBduRJ45Yw: checks
L0aIPg7qefDQjdJo3HCVEA: bets $1
dZcLsEI8iXkobBduRJ45Yw: calls $1
*** TURN *** [6c 2d Kd] [3d]
dZcLsEI8iXkobBduRJ45Yw: checks
L0aIPg7qefDQjdJo3HCVEA: bets $5.50 and is all-in
dZcLsEI8iXkobBduRJ45Yw: calls $5.50
*** RIVER *** [6c 2d Kd 3d] [Jd]
*** SHOW DOWN ***
dZcLsEI8iXkobBduRJ45Yw: shows [Kc 2c] (two pair, Kings and Deuces)
L0aIPg7qefDQjdJo3HCVEA: mucks hand
dZcLsEI8iXkobBduRJ45Yw collected $14.50 from pot
*** SUMMARY ***
Total pot $15.25 | Rake $0.75
Board [6c 2d Kd 3d Jd]
Seat 1: tnD/64LagZ9qPaeOQVjVZg (button) folded before Flop (didn't bet)
Seat 2: jwuKQ1S3U4NnzMQn3E3dgw (small blind) folded before Flop
Seat 3: dZcLsEI8iXkobBduRJ45Yw (big blind) showed [Kc 2c] and won ($14.50) with two pair, Kings and Deuces
Seat 4: crjGpJEzSZgD38FoE3VMGg folded before Flop (didn't bet)
Seat 5: X0X97o2fDAPiGx6o1gahsw folded before Flop (didn't bet)
Seat 6: L0aIPg7qefDQjdJo3HCVEA mucked



PokerStars Game #59938264656:  Hold'em No Limit ($0.25/$0.50) - 2009/07/01 0:10:51 ET
Table 'BCN5su+SsXiy1zRMJi0SJw' 6-max Seat #5 is the button
Seat 1: WyeokAqR0q9nADSkWpbxHw ($40.15 in chips)
Seat 2: QfV2JJlmEKgD5jYPV+a33A ($173.25 in chips)
Seat 3: L309C3uyA1tkWSOh/QvjHw ($21.65 in chips)
Seat 5: TTx3CHxyi0SObcHyMJRp5w ($33.25 in chips)
WyeokAqR0q9nADSkWpbxHw: posts small blind $0.25
QfV2JJlmEKgD5jYPV+a33A: posts big blind $0.50
*** HOLE CARDS ***
L309C3uyA1tkWSOh/QvjHw: folds
TTx3CHxyi0SObcHyMJRp5w: folds
WyeokAqR0q9nADSkWpbxHw: folds
QfV2JJlmEKgD5jYPV+a33A collected $0.50 from pot
QfV2JJlmEKgD5jYPV+a33A: doesn't show hand
*** SUMMARY ***
Total pot $0.50 | Rake $0
Seat 1: WyeokAqR0q9nADSkWpbxHw (small blind) folded before Flop
Seat 2: QfV2JJlmEKgD5jYPV+a33A (big blind) collected ($0.50)
Seat 3: L309C3uyA1tkWSOh/QvjHw folded before Flop (didn't bet)
Seat 5: TTx3CHxyi0SObcHyMJRp5w (button) folded before Flop (didn't bet)



PokerStars Game #59938266060:  Hold'em No Limit ($0.25/$0.50) - 2009/07/01 0:10:53 ET
Table 'hSTs/dUsYLgJQuF2Onp0MQ' 6-max Seat #3 is the button
Seat 1: lWwl5C/UZOsWNubdUqghZw ($70.70 in chips)
Seat 2: fyJOjf+Vdie/rpWb1WExIg ($16.25 in chips)
Seat 3: vQOrJuXbLC3UZDVklY9bOA ($21.75 in chips)
Seat 4: L0aIPg7qefDQjdJo3HCVEA ($13.95 in chips)
Seat 5: 686aeHikcJlgKkSuIFdcXQ ($60.65 in chips)
Seat 6: +laPa9P7BjZKKnR0n+OmvA ($1.80 in chips)
L0aIPg7qefDQjdJo3HCVEA: posts small blind $0.25
686aeHikcJlgKkSuIFdcXQ: posts big blind $0.50
*** HOLE CARDS ***
+laPa9P7BjZKKnR0n+OmvA: raises $1.30 to $1.80 and is all-in
lWwl5C/UZOsWNubdUqghZw: folds
fyJOjf+Vdie/rpWb1WExIg: folds
vQOrJuXbLC3UZDVklY9bOA: calls $1.80
L0aIPg7qefDQjdJo3HCVEA: folds
686aeHikcJlgKkSuIFdcXQ: folds
*** FLOP *** [3h 7h 9s]
*** TURN *** [3h 7h 9s] [Ts]
*** RIVER *** [3h 7h 9s Ts] [Ad]
*** SHOW DOWN ***
+laPa9P7BjZKKnR0n+OmvA: shows [3s 3c] (three of a kind, Threes)
vQOrJuXbLC3UZDVklY9bOA: mucks hand
+laPa9P7BjZKKnR0n+OmvA collected $4.15 from pot
*** SUMMARY ***
Total pot $4.35 | Rake $0.20
Board [3h 7h 9s Ts Ad]
Seat 1: lWwl5C/UZOsWNubdUqghZw folded before Flop (didn't bet)
Seat 2: fyJOjf+Vdie/rpWb1WExIg folded before Flop (didn't bet)
Seat 3: vQOrJuXbLC3UZDVklY9bOA (button) mucked
Seat 4: L0aIPg7qefDQjdJo3HCVEA (small blind) folded before Flop
Seat 5: 686aeHikcJlgKkSuIFdcXQ (big blind) folded before Flop
Seat 6: +laPa9P7BjZKKnR0n+OmvA showed [3s 3c] and won ($4.15) with three of a kind, Threes



PokerStars Game #59938266110:  Hold'em No Limit ($0.25/$0.50) - 2009/07/01 0:10:54 ET
Table 'mTxf8gPLgffN3Iwfm7Icfg' 2-max Seat #1 is the button
Seat 1: Do9Rlu1R5u/AcRtMTl8SYg ($64.55 in chips)
Seat 2: EMc5LPgVaded4Qc77vm0fw ($49.50 in chips)
Do9Rlu1R5u/AcRtMTl8SYg: posts small blind $0.25
EMc5LPgVaded4Qc77vm0fw: posts big blind $0.50
*** HOLE CARDS ***
Do9Rlu1R5u/AcRtMTl8SYg: raises $1 to $1.50
EMc5LPgVaded4Qc77vm0fw: calls $1
*** FLOP *** [7h 5d Ah]
EMc5LPgVaded4Qc77vm0fw: checks
Do9Rlu1R5u/AcRtMTl8SYg: checks
*** TURN *** [7h 5d Ah] [8h]
EMc5LPgVaded4Qc77vm0fw: checks
Do9Rlu1R5u/AcRtMTl8SYg: checks
*** RIVER *** [7h 5d Ah 8h] [Td]
EMc5LPgVaded4Qc77vm0fw: checks
Do9Rlu1R5u/AcRtMTl8SYg: checks
*** SHOW DOWN ***
EMc5LPgVaded4Qc77vm0fw: shows [4s Qs] (high card Ace)
Do9Rlu1R5u/AcRtMTl8SYg: shows [9c Qh] (high card Ace - Queen+Ten+Nine kicker)
Do9Rlu1R5u/AcRtMTl8SYg collected $2.85 from pot
*** SUMMARY ***
Total pot $3 | Rake $0.15
Board [7h 5d Ah 8h Td]
Seat 1: Do9Rlu1R5u/AcRtMTl8SYg (button) (small blind) showed [9c Qh] and won ($2.85) with high card Ace
Seat 2: EMc5LPgVaded4Qc77vm0fw (big blind) showed [4s Qs] and lost with high card Ace



PokerStars Game #59938266642:  Hold'em No Limit ($0.25/$0.50) - 2009/07/01 0:10:54 ET
Table '+dXkOAQyS8j9PQZusUTMpg' 2-max Seat #2 is the button
Seat 1: XFa6sBGjP2gxoIvxR3fZIg ($72.95 in chips)
Seat 2: 5IBeOgaApY1Bvzv2P8X4EA ($39.70 in chips)
5IBeOgaApY1Bvzv2P8X4EA: posts small blind $0.25
XFa6sBGjP2gxoIvxR3fZIg: posts big blind $0.50
*** HOLE CARDS ***
5IBeOgaApY1Bvzv2P8X4EA: folds
XFa6sBGjP2gxoIvxR3fZIg collected $0.50 from pot
*** SUMMARY ***
Total pot $0.50 | Rake $0
Seat 1: XFa6sBGjP2gxoIvxR3fZIg (big blind) collected ($0.50)
Seat 2: 5IBeOgaApY1Bvzv2P8X4EA (button) (small blind) folded before Flop



PokerStars Game #59938266860:  Hold'em No Limit ($0.25/$0.50) - 2009/07/01 0:10:55 ET
Table 'c/CRn+68J3Y8KxD5g1ek2Q' 2-max Seat #1 is the button
Seat 1: 46qCyJ6evTkHo9al5sBMNA ($325.90 in chips)
Seat 2: BypVLsYQt3ePFm2xQL/dOA ($59.85 in chips)
46qCyJ6evTkHo9al5sBMNA: posts small blind $0.25
BypVLsYQt3ePFm2xQL/dOA: posts big blind $0.50
*** HOLE CARDS ***
46qCyJ6evTkHo9al5sBMNA: raises $1 to $1.50
BypVLsYQt3ePFm2xQL/dOA: calls $1
*** FLOP *** [4h 9s 2c]
BypVLsYQt3ePFm2xQL/dOA: checks
46qCyJ6evTkHo9al5sBMNA: checks
*** TURN *** [4h 9s 2c] [Js]
BypVLsYQt3ePFm2xQL/dOA: checks
46qCyJ6evTkHo9al5sBMNA: checks
*** RIVER *** [4h 9s 2c Js] [Qd]
BypVLsYQt3ePFm2xQL/dOA: checks
46qCyJ6evTkHo9al5sBMNA: checks
*** SHOW DOWN ***
BypVLsYQt3ePFm2xQL/dOA: shows [Kc 6d] (high card King)
46qCyJ6evTkHo9al5sBMNA: shows [Td Ac] (high card Ace)
46qCyJ6evTkHo9al5sBMNA collected $2.85 from pot
*** SUMMARY ***
Total pot $3 | Rake $0.15
Board [4h 9s 2c Js Qd]
Seat 1: 46qCyJ6evTkHo9al5sBMNA (button) (small blind) showed [Td Ac] and won ($2.85) with high card Ace
Seat 2: BypVLsYQt3ePFm2xQL/dOA (big blind) showed [Kc 6d] and lost with high card King



PokerStars Game #59938266836:  Hold'em No Limit ($0.25/$0.50) - 2009/07/01 0:10:55 ET
Table 'MJxeZCzYELxiIsyUZyT0jw' 6-max Seat #5 is the button
Seat 1: iKPos8JI094Tomq4tDSgnQ ($36.80 in chips)
Seat 2: r6H1GiZ6QIpMTDhyodKuRQ ($64.90 in chips)
Seat 3: JQZew0FjzS19kTjeNtrE+A ($50 in chips)
Seat 4: lP7Q6pewz4C2RsAfKsjdWw ($21.55 in chips)
Seat 5: 3jvoOXNtXE90w2BdfNZwZQ ($52.25 in chips)
Seat 6: TTx3CHxyi0SObcHyMJRp5w ($39.70 in chips)
TTx3CHxyi0SObcHyMJRp5w: posts small blind $0.25
iKPos8JI094Tomq4tDSgnQ: posts big blind $0.50
*** HOLE CARDS ***
r6H1GiZ6QIpMTDhyodKuRQ: folds
JQZew0FjzS19kTjeNtrE+A: folds
lP7Q6pewz4C2RsAfKsjdWw: calls $0.50
3jvoOXNtXE90w2BdfNZwZQ: raises $2 to $2.50
TTx3CHxyi0SObcHyMJRp5w: folds
iKPos8JI094Tomq4tDSgnQ: folds
lP7Q6pewz4C2RsAfKsjdWw: folds
3jvoOXNtXE90w2BdfNZwZQ collected $1.75 from pot
3jvoOXNtXE90w2BdfNZwZQ: doesn't show hand
*** SUMMARY ***
Total pot $1.75 | Rake $0
Seat 1: iKPos8JI094Tomq4tDSgnQ (big blind) folded before Flop
Seat 2: r6H1GiZ6QIpMTDhyodKuRQ folded before Flop (didn't bet)
Seat 3: JQZew0FjzS19kTjeNtrE+A folded before Flop (didn't bet)
Seat 4: lP7Q6pewz4C2RsAfKsjdWw folded before Flop
Seat 5: 3jvoOXNtXE90w2BdfNZwZQ (button) collected ($1.75)
Seat 6: TTx3CHxyi0SObcHyMJRp5w (small blind) folded before Flop



PokerStars Game #59938267308:  Hold'em No Limit ($0.25/$0.50) - 2009/07/01 0:10:55 ET
Table 'QOgaEqMcJ73pcUMMxoisUg' 6-max Seat #6 is the button
Seat 1: RFefXIDyFvNtJLq+CloCzA ($42.70 in chips)
Seat 2: Im2p1Nt83UKSqv5c9frm4Q ($50 in chips)
Seat 3: wUZNozoIDYf+16hp4nn6dw ($48.85 in chips)
Seat 4: zAcsDhG/T128Vn7XGVSgKg ($50 in chips)
Seat 5: HoaSQCRso+nEyO5DUhGduw ($57 in chips)
Seat 6: s83dnhZ6VC53vY0/f6OV/g ($48.50 in chips)
RFefXIDyFvNtJLq+CloCzA: posts small blind $0.25
Im2p1Nt83UKSqv5c9frm4Q: posts big blind $0.50
*** HOLE CARDS ***
wUZNozoIDYf+16hp4nn6dw: raises $2 to $2.50
zAcsDhG/T128Vn7XGVSgKg: folds
HoaSQCRso+nEyO5DUhGduw: folds
s83dnhZ6VC53vY0/f6OV/g: folds
RFefXIDyFvNtJLq+CloCzA: folds
Im2p1Nt83UKSqv5c9frm4Q: folds
wUZNozoIDYf+16hp4nn6dw collected $1.25 from pot
*** SUMMARY ***
Total pot $1.25 | Rake $0
Seat 1: RFefXIDyFvNtJLq+CloCzA (small blind) folded before Flop
Seat 2: Im2p1Nt83UKSqv5c9frm4Q (big blind) folded before Flop
Seat 3: wUZNozoIDYf+16hp4nn6dw collected ($1.25)
Seat 4: zAcsDhG/T128Vn7XGVSgKg folded before Flop (didn't bet)
Seat 5: HoaSQCRso+nEyO5DUhGduw folded before Flop (didn't bet)
Seat 6: s83dnhZ6VC53vY0/f6OV/g (button) folded before Flop (didn't bet)



PokerStars Game #59938270700:  Hold'em No Limit ($0.25/$0.50) - 2009/07/01 0:11:00 ET
Table 'kgbJRsxfv64KrErDRBAkcw' 6-max Seat #6 is the button
Seat 1: YmWlPGOKFuJSoJZPW8a8IA ($80.05 in chips)
Seat 2: Q+thC23WCv1kJUJtH/+4Jw ($27.50 in chips)
Seat 3: T0Gx/FcQ5VH9u7XaOMX97A ($66 in chips)
Seat 4: qanMEqjABjWxC/JgQ/0l7w ($63.45 in chips)
Seat 5: +Pf9jTVizYlIo+woPvptfA ($50 in chips)
Seat 6: DDfYzIrYT0t5R/hAJngtsg ($21.65 in chips)
YmWlPGOKFuJSoJZPW8a8IA: posts small blind $0.25
Q+thC23WCv1kJUJtH/+4Jw: posts big blind $0.50
*** HOLE CARDS ***
T0Gx/FcQ5VH9u7XaOMX97A: folds
qanMEqjABjWxC/JgQ/0l7w: folds
+Pf9jTVizYlIo+woPvptfA: folds
DDfYzIrYT0t5R/hAJngtsg: calls $0.50
YmWlPGOKFuJSoJZPW8a8IA: folds
Q+thC23WCv1kJUJtH/+4Jw: checks
*** FLOP *** [Th Qs Ac]
Q+thC23WCv1kJUJtH/+4Jw: checks
DDfYzIrYT0t5R/hAJngtsg: checks
*** TURN *** [Th Qs Ac] [Ts]
Q+thC23WCv1kJUJtH/+4Jw: checks
DDfYzIrYT0t5R/hAJngtsg: bets $1.50
Q+thC23WCv1kJUJtH/+4Jw: folds
DDfYzIrYT0t5R/hAJngtsg collected $1.20 from pot
DDfYzIrYT0t5R/hAJngtsg: doesn't show hand
*** SUMMARY ***
Total pot $1.25 | Rake $0.05
Board [Th Qs Ac Ts]
Seat 1: YmWlPGOKFuJSoJZPW8a8IA (small blind) folded before Flop
Seat 2: Q+thC23WCv1kJUJtH/+4Jw (big blind) folded on the Turn
Seat 3: T0Gx/FcQ5VH9u7XaOMX97A folded before Flop (didn't bet)
Seat 4: qanMEqjABjWxC/JgQ/0l7w folded before Flop (didn't bet)
Seat 5: +Pf9jTVizYlIo+woPvptfA folded before Flop (didn't bet)
Seat 6: DDfYzIrYT0t5R/hAJngtsg (button) collected ($1.20)



PokerStars Game #59938271376:  Hold'em No Limit ($0.25/$0.50) - 2009/07/01 0:11:01 ET
Table 'E7bWJ45aoFXRpyRv2gw+Ig' 2-max Seat #1 is the button
Seat 1: FRkiRasEGlHUeLrEl+k/nA ($76.05 in chips)
Seat 2: 3Wro85I7472vJ4Wkpneo9A ($47.55 in chips)
FRkiRasEGlHUeLrEl+k/nA: posts small blind $0.25
3Wro85I7472vJ4Wkpneo9A: posts big blind $0.50
*** HOLE CARDS ***
FRkiRasEGlHUeLrEl+k/nA: raises $1 to $1.50
3Wro85I7472vJ4Wkpneo9A: folds
FRkiRasEGlHUeLrEl+k/nA collected $1 from pot
FRkiRasEGlHUeLrEl+k/nA: doesn't show hand
*** SUMMARY ***
Total pot $1 | Rake $0
Seat 1: FRkiRasEGlHUeLrEl+k/nA (button) (small blind) collected ($1)
Seat 2: 3Wro85I7472vJ4Wkpneo9A (big blind) folded before Flop



PokerStars Game #59938271674:  Hold'em No Limit ($0.25/$0.50) - 2009/07/01 0:11:02 ET
Table 'raOT4/ipuZgzjfKHC+jD9g' 2-max Seat #2 is the button
Seat 1: IuwLemwLhc9fvrwBGs0AMA ($10.35 in chips)
Seat 2: Udr5juWSWUgTu1NlRhjMdA ($12.75 in chips)
Udr5juWSWUgTu1NlRhjMdA: posts small blind $0.25
IuwLemwLhc9fvrwBGs0AMA: posts big blind $0.50
*** HOLE CARDS ***
Udr5juWSWUgTu1NlRhjMdA: folds
IuwLemwLhc9fvrwBGs0AMA collected $0.50 from pot
*** SUMMARY ***
Total pot $0.50 | Rake $0
Seat 1: IuwLemwLhc9fvrwBGs0AMA (big blind) collected ($0.50)
Seat 2: Udr5juWSWUgTu1NlRhjMdA (button) (small blind) folded before Flop



PokerStars Game #59938273276:  Hold'em No Limit ($0.25/$0.50) - 2009/07/01 0:11:04 ET
Table 'BCN5su+SsXiy1zRMJi0SJw' 6-max Seat #1 is the button
Seat 1: WyeokAqR0q9nADSkWpbxHw ($39.90 in chips)
Seat 2: QfV2JJlmEKgD5jYPV+a33A ($173.50 in chips)
Seat 3: L309C3uyA1tkWSOh/QvjHw ($21.65 in chips)
Seat 5: TTx3CHxyi0SObcHyMJRp5w ($33.25 in chips)
QfV2JJlmEKgD5jYPV+a33A: posts small blind $0.25
L309C3uyA1tkWSOh/QvjHw: posts big blind $0.50
*** HOLE CARDS ***
TTx3CHxyi0SObcHyMJRp5w: folds
WyeokAqR0q9nADSkWpbxHw: calls $0.50
QfV2JJlmEKgD5jYPV+a33A: folds
L309C3uyA1tkWSOh/QvjHw: checks
*** FLOP *** [3c Th 8d]
L309C3uyA1tkWSOh/QvjHw: checks
WyeokAqR0q9nADSkWpbxHw: checks
*** TURN *** [3c Th 8d] [9d]
L309C3uyA1tkWSOh/QvjHw: checks
WyeokAqR0q9nADSkWpbxHw: bets $0.50
L309C3uyA1tkWSOh/QvjHw: folds
WyeokAqR0q9nADSkWpbxHw collected $1.20 from pot
*** SUMMARY ***
Total pot $1.25 | Rake $0.05
Board [3c Th 8d 9d]
Seat 1: WyeokAqR0q9nADSkWpbxHw (button) collected ($1.20)
Seat 2: QfV2JJlmEKgD5jYPV+a33A (small blind) folded before Flop
Seat 3: L309C3uyA1tkWSOh/QvjHw (big blind) folded on the Turn
Seat 5: TTx3CHxyi0SObcHyMJRp5w folded before Flop (didn't bet)



PokerStars Game #59938275940:  Hold'em No Limit ($0.25/$0.50) - 2009/07/01 0:11:08 ET
Table '+dXkOAQyS8j9PQZusUTMpg' 2-max Seat #1 is the button
Seat 1: XFa6sBGjP2gxoIvxR3fZIg ($73.20 in chips)
Seat 2: 5IBeOgaApY1Bvzv2P8X4EA ($39.45 in chips)
XFa6sBGjP2gxoIvxR3fZIg: posts small blind $0.25
5IBeOgaApY1Bvzv2P8X4EA: posts big blind $0.50
*** HOLE CARDS ***
XFa6sBGjP2gxoIvxR3fZIg: raises $1 to $1.50
5IBeOgaApY1Bvzv2P8X4EA: folds
XFa6sBGjP2gxoIvxR3fZIg collected $1 from pot
XFa6sBGjP2gxoIvxR3fZIg: doesn't show hand
*** SUMMARY ***
Total pot $1 | Rake $0
Seat 1: XFa6sBGjP2gxoIvxR3fZIg (button) (small blind) collected ($1)
Seat 2: 5IBeOgaApY1Bvzv2P8X4EA (big blind) folded before Flop



PokerStars Game #59938276280:  Hold'em No Limit ($0.25/$0.50) - 2009/07/01 0:11:08 ET
Table 'raOT4/ipuZgzjfKHC+jD9g' 2-max Seat #1 is the button
Seat 1: IuwLemwLhc9fvrwBGs0AMA ($10.60 in chips)
Seat 2: Udr5juWSWUgTu1NlRhjMdA ($12.50 in chips)
IuwLemwLhc9fvrwBGs0AMA: posts small blind $0.25
Udr5juWSWUgTu1NlRhjMdA: posts big blind $0.50
*** HOLE CARDS ***
IuwLemwLhc9fvrwBGs0AMA: folds
Udr5juWSWUgTu1NlRhjMdA collected $0.50 from pot
Udr5juWSWUgTu1NlRhjMdA: doesn't show hand
*** SUMMARY ***
Total pot $0.50 | Rake $0
Seat 1: IuwLemwLhc9fvrwBGs0AMA (button) (small blind) folded before Flop
Seat 2: Udr5juWSWUgTu1NlRhjMdA (big blind) collected ($0.50)



PokerStars Game #59938276744:  Hold'em No Limit ($0.25/$0.50) - 2009/07/01 0:11:09 ET
Table 'X6IRCRTh+20gjz8aubWnwA' 9-max Seat #4 is the button
Seat 1: YPo1oggovmqSREegekaQYw ($9.45 in chips)
Seat 2: RjBdQ6w31rgcy0o24VLR6w ($11.65 in chips)
Seat 3: mSD1pginDsyHG5PDfqzphw ($10 in chips)
Seat 4: uw9QayAAxLM3Hb+HR7mSkg ($10.25 in chips)
Seat 5: L5e2lrPLQm1Pqx30IIZ/Fw ($10 in chips)
Seat 6: /6In1zC3WtgwxDcueWzZWg ($57.70 in chips)
Seat 7: VBnpbzn0dIveV55qKvciew ($56.70 in chips)
Seat 8: BPMN9sOItJw6vWq3kypaYg ($29.25 in chips)
Seat 9: M+7+BTmX5vZatHVuoRB1nA ($84.10 in chips)
L5e2lrPLQm1Pqx30IIZ/Fw: posts small blind $0.25
/6In1zC3WtgwxDcueWzZWg: posts big blind $0.50
*** HOLE CARDS ***
VBnpbzn0dIveV55qKvciew: folds
BPMN9sOItJw6vWq3kypaYg: folds
M+7+BTmX5vZatHVuoRB1nA: folds
YPo1oggovmqSREegekaQYw: folds
RjBdQ6w31rgcy0o24VLR6w: folds
mSD1pginDsyHG5PDfqzphw: folds
uw9QayAAxLM3Hb+HR7mSkg: folds
L5e2lrPLQm1Pqx30IIZ/Fw: raises $1.50 to $2
/6In1zC3WtgwxDcueWzZWg: folds
L5e2lrPLQm1Pqx30IIZ/Fw collected $1 from pot
*** SUMMARY ***
Total pot $1 | Rake $0
Seat 1: YPo1oggovmqSREegekaQYw folded before Flop (didn't bet)
Seat 2: RjBdQ6w31rgcy0o24VLR6w folded before Flop (didn't bet)
Seat 3: mSD1pginDsyHG5PDfqzphw folded before Flop (didn't bet)
Seat 4: uw9QayAAxLM3Hb+HR7mSkg (button) folded before Flop (didn't bet)
Seat 5: L5e2lrPLQm1Pqx30IIZ/Fw (small blind) collected ($1)
Seat 6: /6In1zC3WtgwxDcueWzZWg (big blind) folded before Flop
Seat 7: VBnpbzn0dIveV55qKvciew folded before Flop (didn't bet)
Seat 8: BPMN9sOItJw6vWq3kypaYg folded before Flop (didn't bet)
Seat 9: M+7+BTmX5vZatHVuoRB1nA folded before Flop (didn't bet)



PokerStars Game #59938277758:  Hold'em No Limit ($0.25/$0.50) - 2009/07/01 0:11:10 ET
Table 'E7bWJ45aoFXRpyRv2gw+Ig' 2-max Seat #2 is the button
Seat 1: FRkiRasEGlHUeLrEl+k/nA ($76.55 in chips)
Seat 2: 3Wro85I7472vJ4Wkpneo9A ($47.05 in chips)
3Wro85I7472vJ4Wkpneo9A: posts small blind $0.25
FRkiRasEGlHUeLrEl+k/nA: posts big blind $0.50
*** HOLE CARDS ***
3Wro85I7472vJ4Wkpneo9A: raises $1 to $1.50
FRkiRasEGlHUeLrEl+k/nA: calls $1
*** FLOP *** [4s 6d 7h]
FRkiRasEGlHUeLrEl+k/nA: checks
3Wro85I7472vJ4Wkpneo9A: bets $2
FRkiRasEGlHUeLrEl+k/nA: calls $2
*** TURN *** [4s 6d 7h] [Th]
FRkiRasEGlHUeLrEl+k/nA: checks
3Wro85I7472vJ4Wkpneo9A: checks
*** RIVER *** [4s 6d 7h Th] [Td]
FRkiRasEGlHUeLrEl+k/nA: bets $1
3Wro85I7472vJ4Wkpneo9A: calls $1
*** SHOW DOWN ***
FRkiRasEGlHUeLrEl+k/nA: shows [5c 4d] (two pair, Tens and Fours)
3Wro85I7472vJ4Wkpneo9A: mucks hand
FRkiRasEGlHUeLrEl+k/nA collected $8.60 from pot
*** SUMMARY ***
Total pot $9 | Rake $0.40
Board [4s 6d 7h Th Td]
Seat 1: FRkiRasEGlHUeLrEl+k/nA (big blind) showed [5c 4d] and won ($8.60) with two pair, Tens and Fours
Seat 2: 3Wro85I7472vJ4Wkpneo9A (button) (small blind) mucked



PokerStars Game #59938278780:  Hold'em No Limit ($0.25/$0.50) - 2009/07/01 0:11:12 ET
Table 'tpZbcIvqh/6WmfR/i5IE3A' 9-max Seat #6 is the button
Seat 1: nV/P1jFY/CFMXOLWu7pYmA ($13.70 in chips)
Seat 2: M+7+BTmX5vZatHVuoRB1nA ($42.90 in chips)
Seat 3: 3w0FbBQAKwQODwenKwZxXw ($78.40 in chips)
Seat 4: zE9cVigS2nW/Ljy4K4bUQA ($30 in chips)
Seat 5: 9r7ZoBbAJj5IeyZ0q9BdzA ($15.20 in chips)
Seat 6: E2518gp4aFz1+kAgmGqeEg ($10.45 in chips)
Seat 7: wIZ377kjl2fHFGnS93o6bw ($15.65 in chips)
wIZ377kjl2fHFGnS93o6bw: posts small blind $0.25
bXpVeaSTPBFSPJmeXxO7nw: is sitting out
nV/P1jFY/CFMXOLWu7pYmA: posts big blind $0.50
*** HOLE CARDS ***
M+7+BTmX5vZatHVuoRB1nA: folds
3w0FbBQAKwQODwenKwZxXw: folds
zE9cVigS2nW/Ljy4K4bUQA: raises $1 to $1.50
9r7ZoBbAJj5IeyZ0q9BdzA: folds
E2518gp4aFz1+kAgmGqeEg: folds
wIZ377kjl2fHFGnS93o6bw: calls $1.25
nV/P1jFY/CFMXOLWu7pYmA: folds
*** FLOP *** [2c 8d 7s]
wIZ377kjl2fHFGnS93o6bw: checks
zE9cVigS2nW/Ljy4K4bUQA: bets $2
wIZ377kjl2fHFGnS93o6bw: folds
zE9cVigS2nW/Ljy4K4bUQA collected $3.35 from pot
zE9cVigS2nW/Ljy4K4bUQA: doesn't show hand
*** SUMMARY ***
Total pot $3.50 | Rake $0.15
Board [2c 8d 7s]
Seat 1: nV/P1jFY/CFMXOLWu7pYmA (big blind) folded before Flop
Seat 2: M+7+BTmX5vZatHVuoRB1nA folded before Flop (didn't bet)
Seat 3: 3w0FbBQAKwQODwenKwZxXw folded before Flop (didn't bet)
Seat 4: zE9cVigS2nW/Ljy4K4bUQA collected ($3.35)
Seat 5: 9r7ZoBbAJj5IeyZ0q9BdzA folded before Flop (didn't bet)
Seat 6: E2518gp4aFz1+kAgmGqeEg (button) folded before Flop (didn't bet)
Seat 7: wIZ377kjl2fHFGnS93o6bw (small blind) folded on the Flop



PokerStars Game #59938279506:  Hold'em No Limit ($0.25/$0.50) - 2009/07/01 0:11:13 ET
Table '3FhG0gl3kMX3wBEEqj+wnQ' 9-max Seat #4 is the button
Seat 1: e0J9pdCNUDTCG031RnXqLA ($25.45 in chips)
Seat 2: 4dl3YNqZ6Houm2jZAzDmRg ($25.75 in chips)
Seat 3: bXpVeaSTPBFSPJmeXxO7nw ($10 in chips)
Seat 4: bz4LMfV0GGl/MJ/ABXuPmg ($14.90 in chips)
Seat 5: XNMDwbXt/Q4jM99AXnbJDw ($49.50 in chips)
Seat 6: 5JJVDlaiMnB004o/RqbZZQ ($26.75 in chips)
Seat 7: 6XkTu4ahxzHnvjjc1R8YjQ ($11.10 in chips)
Seat 8: j3K/Jujr7PY4ZM2RZvlH6A ($57.35 in chips)
Seat 9: tzoXBDwkkPV/XPJPkf963Q ($12.60 in chips)
XNMDwbXt/Q4jM99AXnbJDw: posts small blind $0.25
5JJVDlaiMnB004o/RqbZZQ: posts big blind $0.50
*** HOLE CARDS ***
6XkTu4ahxzHnvjjc1R8YjQ: folds
j3K/Jujr7PY4ZM2RZvlH6A: folds
tzoXBDwkkPV/XPJPkf963Q: calls $0.50
e0J9pdCNUDTCG031RnXqLA: folds
4dl3YNqZ6Houm2jZAzDmRg: folds
bXpVeaSTPBFSPJmeXxO7nw: folds
bz4LMfV0GGl/MJ/ABXuPmg: calls $0.50
XNMDwbXt/Q4jM99AXnbJDw: folds
5JJVDlaiMnB004o/RqbZZQ: checks
*** FLOP *** [Ah 5d 4h]
5JJVDlaiMnB004o/RqbZZQ: checks
tzoXBDwkkPV/XPJPkf963Q: checks
bz4LMfV0GGl/MJ/ABXuPmg: checks
*** TURN *** [Ah 5d 4h] [Qc]
5JJVDlaiMnB004o/RqbZZQ: checks
tzoXBDwkkPV/XPJPkf963Q: bets $0.50
bz4LMfV0GGl/MJ/ABXuPmg: folds
5JJVDlaiMnB004o/RqbZZQ: folds
tzoXBDwkkPV/XPJPkf963Q collected $1.70 from pot
*** SUMMARY ***
Total pot $1.75 | Rake $0.05
Board [Ah 5d 4h Qc]
Seat 1: e0J9pdCNUDTCG031RnXqLA folded before Flop (didn't bet)
Seat 2: 4dl3YNqZ6Houm2jZAzDmRg folded before Flop (didn't bet)
Seat 3: bXpVeaSTPBFSPJmeXxO7nw folded before Flop (didn't bet)
Seat 4: bz4LMfV0GGl/MJ/ABXuPmg (button) folded on the Turn
Seat 5: XNMDwbXt/Q4jM99AXnbJDw (small blind) folded before Flop
Seat 6: 5JJVDlaiMnB004o/RqbZZQ (big blind) folded on the Turn
Seat 7: 6XkTu4ahxzHnvjjc1R8YjQ folded before Flop (didn't bet)
Seat 8: j3K/Jujr7PY4ZM2RZvlH6A folded before Flop (didn't bet)
Seat 9: tzoXBDwkkPV/XPJPkf963Q collected ($1.70)



PokerStars Game #59938280786:  Hold'em No Limit ($0.25/$0.50) - 2009/07/01 0:11:14 ET
Table 'c/CRn+68J3Y8KxD5g1ek2Q' 2-max Seat #2 is the button
Seat 1: 46qCyJ6evTkHo9al5sBMNA ($327.25 in chips)
Seat 2: BypVLsYQt3ePFm2xQL/dOA ($58.35 in chips)
BypVLsYQt3ePFm2xQL/dOA: posts small blind $0.25
46qCyJ6evTkHo9al5sBMNA: posts big blind $0.50
*** HOLE CARDS ***
BypVLsYQt3ePFm2xQL/dOA: raises $1 to $1.50
46qCyJ6evTkHo9al5sBMNA: calls $1
*** FLOP *** [6h 6d As]
46qCyJ6evTkHo9al5sBMNA: checks
BypVLsYQt3ePFm2xQL/dOA: bets $3.50
46qCyJ6evTkHo9al5sBMNA: folds
BypVLsYQt3ePFm2xQL/dOA collected $2.85 from pot
BypVLsYQt3ePFm2xQL/dOA: doesn't show hand
*** SUMMARY ***
Total pot $3 | Rake $0.15
Board [6h 6d As]
Seat 1: 46qCyJ6evTkHo9al5sBMNA (big blind) folded on the Flop
Seat 2: BypVLsYQt3ePFm2xQL/dOA (button) (small blind) collected ($2.85)



PokerStars Game #59938280742:  Hold'em No Limit ($0.25/$0.50) - 2009/07/01 0:11:14 ET
Table 'raOT4/ipuZgzjfKHC+jD9g' 2-max Seat #2 is the button
Seat 1: IuwLemwLhc9fvrwBGs0AMA ($10.35 in chips)
Seat 2: Udr5juWSWUgTu1NlRhjMdA ($12.75 in chips)
Udr5juWSWUgTu1NlRhjMdA: posts small blind $0.25
IuwLemwLhc9fvrwBGs0AMA: posts big blind $0.50
*** HOLE CARDS ***
Udr5juWSWUgTu1NlRhjMdA: calls $0.25
IuwLemwLhc9fvrwBGs0AMA: checks
*** FLOP *** [9d 7s 6c]
IuwLemwLhc9fvrwBGs0AMA: checks
Udr5juWSWUgTu1NlRhjMdA: checks
*** TURN *** [9d 7s 6c] [8s]
IuwLemwLhc9fvrwBGs0AMA: checks
Udr5juWSWUgTu1NlRhjMdA: bets $0.50
IuwLemwLhc9fvrwBGs0AMA: calls $0.50
*** RIVER *** [9d 7s 6c 8s] [Qd]
IuwLemwLhc9fvrwBGs0AMA: checks
Udr5juWSWUgTu1NlRhjMdA: checks
*** SHOW DOWN ***
IuwLemwLhc9fvrwBGs0AMA: shows [5d Jc] (a straight, Five to Nine)
Udr5juWSWUgTu1NlRhjMdA: mucks hand
IuwLemwLhc9fvrwBGs0AMA collected $1.95 from pot
*** SUMMARY ***
Total pot $2 | Rake $0.05
Board [9d 7s 6c 8s Qd]
Seat 1: IuwLemwLhc9fvrwBGs0AMA (big blind) showed [5d Jc] and won ($1.95) with a straight, Five to Nine
Seat 2: Udr5juWSWUgTu1NlRhjMdA (button) (small blind) mucked



PokerStars Game #59938280176:  Hold'em No Limit ($0.25/$0.50) - 2009/07/01 0:11:14 ET
Table 'lSisgp6H7Fg1hH5VfjEjYQ' 9-max Seat #4 is the button
Seat 1: pEW8B6uXbdR47kfljMQ3+Q ($39.70 in chips)
Seat 2: UrcnkQOiLVk8BlKDPJSy7Q ($51.85 in chips)
Seat 4: nvw9yQKhJT56lA9k+TLdhw ($10.95 in chips)
Seat 5: mSD1pginDsyHG5PDfqzphw ($10 in chips)
Seat 6: +k7T5ocke8UwavtgUHm+Cg ($22.40 in chips)
Seat 7: xyQ4CeZa3ug3ompz+5xSTg ($73.95 in chips)
Seat 8: bXpVeaSTPBFSPJmeXxO7nw ($19.50 in chips)
Seat 9: 5JJVDlaiMnB004o/RqbZZQ ($41.55 in chips)
mSD1pginDsyHG5PDfqzphw: posts small blind $0.25
+k7T5ocke8UwavtgUHm+Cg: posts big blind $0.50
aTkyjTh3w5YLWiIERupZOA: sits out
*** HOLE CARDS ***
xyQ4CeZa3ug3ompz+5xSTg: folds
xyQ4CeZa3ug3ompz+5xSTg leaves the table
bXpVeaSTPBFSPJmeXxO7nw: folds
5JJVDlaiMnB004o/RqbZZQ: folds
pEW8B6uXbdR47kfljMQ3+Q: folds
UrcnkQOiLVk8BlKDPJSy7Q: folds
nvw9yQKhJT56lA9k+TLdhw: folds
mSD1pginDsyHG5PDfqzphw: folds
+k7T5ocke8UwavtgUHm+Cg collected $0.50 from pot
+k7T5ocke8UwavtgUHm+Cg: doesn't show hand
*** SUMMARY ***
Total pot $0.50 | Rake $0
Seat 1: pEW8B6uXbdR47kfljMQ3+Q folded before Flop (didn't bet)
Seat 2: UrcnkQOiLVk8BlKDPJSy7Q folded before Flop (didn't bet)
Seat 4: nvw9yQKhJT56lA9k+TLdhw (button) folded before Flop (didn't bet)
Seat 5: mSD1pginDsyHG5PDfqzphw (small blind) folded before Flop
Seat 6: +k7T5ocke8UwavtgUHm+Cg (big blind) collected ($0.50)
Seat 7: xyQ4CeZa3ug3ompz+5xSTg folded before Flop (didn't bet)
Seat 8: bXpVeaSTPBFSPJmeXxO7nw folded before Flop (didn't bet)
Seat 9: 5JJVDlaiMnB004o/RqbZZQ folded before Flop (didn't bet)



PokerStars Game #59938281386:  Hold'em No Limit ($0.25/$0.50) - 2009/07/01 0:11:15 ET
Table 'mTxf8gPLgffN3Iwfm7Icfg' 2-max Seat #2 is the button
Seat 1: Do9Rlu1R5u/AcRtMTl8SYg ($65.90 in chips)
Seat 2: EMc5LPgVaded4Qc77vm0fw ($48 in chips)
EMc5LPgVaded4Qc77vm0fw: posts small blind $0.25
Do9Rlu1R5u/AcRtMTl8SYg: posts big blind $0.50
*** HOLE CARDS ***
EMc5LPgVaded4Qc77vm0fw: raises $1.50 to $2
Do9Rlu1R5u/AcRtMTl8SYg: folds
EMc5LPgVaded4Qc77vm0fw collected $1 from pot
EMc5LPgVaded4Qc77vm0fw: doesn't show hand
*** SUMMARY ***
Total pot $1 | Rake $0
Seat 1: Do9Rlu1R5u/AcRtMTl8SYg (big blind) folded before Flop
Seat 2: EMc5LPgVaded4Qc77vm0fw (button) (small blind) collected ($1)



PokerStars Game #59938281338:  Hold'em No Limit ($0.25/$0.50) - 2009/07/01 0:11:15 ET
Table 'PALRfuH85dr5IkDfdv6new' 9-max Seat #5 is the button
Seat 1: SKnJuWHScqetA/qG5p+wCg ($33 in chips)
Seat 2: 9r7ZoBbAJj5IeyZ0q9BdzA ($23.40 in chips)
Seat 3: 50QWoELmpmHFrFIlWMJo9g ($94.20 in chips)
Seat 4: /gaxz7F0MIjSN3t7ZPKwAA ($41.60 in chips)
Seat 5: jSSGUXdNFAZA3QCvTcUMQw ($43 in chips)
Seat 6: EiWj2MAl8RNcPhTkzz24Mw ($27.40 in chips)
Seat 7: 3NcyXvr39gnK+KbTq7ezyA ($34.85 in chips)
Seat 8: NkS+CseUKx4XHszWq0PXEQ ($43.10 in chips)
Seat 9: CIrAX/m6o7jYmKOAjJXv4Q ($25.05 in chips)
EiWj2MAl8RNcPhTkzz24Mw: posts small blind $0.25
3NcyXvr39gnK+KbTq7ezyA: posts big blind $0.50
*** HOLE CARDS ***
NkS+CseUKx4XHszWq0PXEQ: folds
CIrAX/m6o7jYmKOAjJXv4Q: calls $0.50
SKnJuWHScqetA/qG5p+wCg: folds
9r7ZoBbAJj5IeyZ0q9BdzA: calls $0.50
50QWoELmpmHFrFIlWMJo9g: folds
/gaxz7F0MIjSN3t7ZPKwAA: calls $0.50
jSSGUXdNFAZA3QCvTcUMQw: folds
EiWj2MAl8RNcPhTkzz24Mw: calls $0.25
3NcyXvr39gnK+KbTq7ezyA: checks
*** FLOP *** [Td Ad Ks]
EiWj2MAl8RNcPhTkzz24Mw: checks
3NcyXvr39gnK+KbTq7ezyA: checks
CIrAX/m6o7jYmKOAjJXv4Q: checks
9r7ZoBbAJj5IeyZ0q9BdzA: bets $1
/gaxz7F0MIjSN3t7ZPKwAA: raises $3 to $4
EiWj2MAl8RNcPhTkzz24Mw: folds
3NcyXvr39gnK+KbTq7ezyA: folds
CIrAX/m6o7jYmKOAjJXv4Q: calls $4
9r7ZoBbAJj5IeyZ0q9BdzA: calls $3
*** TURN *** [Td Ad Ks] [4d]
CIrAX/m6o7jYmKOAjJXv4Q: checks
9r7ZoBbAJj5IeyZ0q9BdzA: checks
/gaxz7F0MIjSN3t7ZPKwAA: checks
*** RIVER *** [Td Ad Ks 4d] [4s]
CIrAX/m6o7jYmKOAjJXv4Q: bets $5
9r7ZoBbAJj5IeyZ0q9BdzA: calls $5
/gaxz7F0MIjSN3t7ZPKwAA: folds
*** SHOW DOWN ***
CIrAX/m6o7jYmKOAjJXv4Q: shows [9d Kd] (a flush, Ace high)
9r7ZoBbAJj5IeyZ0q9BdzA: mucks hand
CIrAX/m6o7jYmKOAjJXv4Q collected $23.35 from pot
*** SUMMARY ***
Total pot $24.50 | Rake $1.15
Board [Td Ad Ks 4d 4s]
Seat 1: SKnJuWHScqetA/qG5p+wCg folded before Flop (didn't bet)
Seat 2: 9r7ZoBbAJj5IeyZ0q9BdzA mucked
Seat 3: 50QWoELmpmHFrFIlWMJo9g folded before Flop (didn't bet)
Seat 4: /gaxz7F0MIjSN3t7ZPKwAA folded on the River
Seat 5: jSSGUXdNFAZA3QCvTcUMQw (button) folded before Flop (didn't bet)
Seat 6: EiWj2MAl8RNcPhTkzz24Mw (small blind) folded on the Flop
Seat 7: 3NcyXvr39gnK+KbTq7ezyA (big blind) folded on the Flop
Seat 8: NkS+CseUKx4XHszWq0PXEQ folded before Flop (didn't bet)
Seat 9: CIrAX/m6o7jYmKOAjJXv4Q showed [9d Kd] and won ($23.35) with a flush, Ace high



PokerStars Game #59938281928:  Hold'em No Limit ($0.25/$0.50) - 2009/07/01 0:11:16 ET
Table '+dXkOAQyS8j9PQZusUTMpg' 2-max Seat #2 is the button
Seat 1: XFa6sBGjP2gxoIvxR3fZIg ($73.70 in chips)
Seat 2: 5IBeOgaApY1Bvzv2P8X4EA ($38.95 in chips)
5IBeOgaApY1Bvzv2P8X4EA: posts small blind $0.25
XFa6sBGjP2gxoIvxR3fZIg: posts big blind $0.50
*** HOLE CARDS ***
5IBeOgaApY1Bvzv2P8X4EA: raises $1.50 to $2
XFa6sBGjP2gxoIvxR3fZIg: calls $1.50
*** FLOP *** [8d 2d 9s]
XFa6sBGjP2gxoIvxR3fZIg: checks
5IBeOgaApY1Bvzv2P8X4EA: checks
*** TURN *** [8d 2d 9s] [Qc]
XFa6sBGjP2gxoIvxR3fZIg: checks
5IBeOgaApY1Bvzv2P8X4EA: bets $2.50
XFa6sBGjP2gxoIvxR3fZIg: calls $2.50
*** RIVER *** [8d 2d 9s Qc] [3c]
5IBeOgaApY1Bvzv2P8X4EA said, ";D"
XFa6sBGjP2gxoIvxR3fZIg: checks
5IBeOgaApY1Bvzv2P8X4EA: bets $7.50
XFa6sBGjP2gxoIvxR3fZIg said, "time for a hero call?"
5IBeOgaApY1Bvzv2P8X4EA said, "yes"
5IBeOgaApY1Bvzv2P8X4EA said, ":D"
XFa6sBGjP2gxoIvxR3fZIg said, "well, why not then"
XFa6sBGjP2gxoIvxR3fZIg: calls $7.50
*** SHOW DOWN ***
5IBeOgaApY1Bvzv2P8X4EA: shows [Ts Kd] (high card King)
XFa6sBGjP2gxoIvxR3fZIg: shows [Ah Jc] (high card Ace)
XFa6sBGjP2gxoIvxR3fZIg collected $23.50 from pot
*** SUMMARY ***
Total pot $24 | Rake $0.50
Board [8d 2d 9s Qc 3c]
Seat 1: XFa6sBGjP2gxoIvxR3fZIg (big blind) showed [Ah Jc] and won ($23.50) with high card Ace
Seat 2: 5IBeOgaApY1Bvzv2P8X4EA (button) (small blind) showed [Ts Kd] and lost with high card King



PokerStars Game #59938285842:  Hold'em No Limit ($0.25/$0.50) - 2009/07/01 0:11:21 ET
Table 'MJxeZCzYELxiIsyUZyT0jw' 6-max Seat #6 is the button
Seat 1: iKPos8JI094Tomq4tDSgnQ ($36.30 in chips)
Seat 2: r6H1GiZ6QIpMTDhyodKuRQ ($64.90 in chips)
Seat 3: JQZew0FjzS19kTjeNtrE+A ($50 in chips)
Seat 4: lP7Q6pewz4C2RsAfKsjdWw ($21.05 in chips)
Seat 5: 3jvoOXNtXE90w2BdfNZwZQ ($53.50 in chips)
Seat 6: TTx3CHxyi0SObcHyMJRp5w ($39.45 in chips)
iKPos8JI094Tomq4tDSgnQ: posts small blind $0.25
r6H1GiZ6QIpMTDhyodKuRQ: posts big blind $0.50
*** HOLE CARDS ***
JQZew0FjzS19kTjeNtrE+A: raises $1.50 to $2
lP7Q6pewz4C2RsAfKsjdWw: folds
3jvoOXNtXE90w2BdfNZwZQ: folds
TTx3CHxyi0SObcHyMJRp5w: folds
iKPos8JI094Tomq4tDSgnQ: folds
r6H1GiZ6QIpMTDhyodKuRQ: folds
JQZew0FjzS19kTjeNtrE+A collected $1.25 from pot
*** SUMMARY ***
Total pot $1.25 | Rake $0
Seat 1: iKPos8JI094Tomq4tDSgnQ (small blind) folded before Flop
Seat 2: r6H1GiZ6QIpMTDhyodKuRQ (big blind) folded before Flop
Seat 3: JQZew0FjzS19kTjeNtrE+A collected ($1.25)
Seat 4: lP7Q6pewz4C2RsAfKsjdWw folded before Flop (didn't bet)
Seat 5: 3jvoOXNtXE90w2BdfNZwZQ folded before Flop (didn't bet)
Seat 6: TTx3CHxyi0SObcHyMJRp5w (button) folded before Flop (didn't bet)



PokerStars Game #59938285960:  Hold'em No Limit ($0.25/$0.50) - 2009/07/01 0:11:22 ET
Table 'Vdlc9wqYcHTUhtdyN7CuJw' 2-max Seat #2 is the button
Seat 1: yBO+mXB6m/rCft2ErwGf/Q ($90.10 in chips)
Seat 2: sa0qgETiL3HNbdfGlnKHTA ($22.05 in chips)
sa0qgETiL3HNbdfGlnKHTA: posts small blind $0.25
yBO+mXB6m/rCft2ErwGf/Q: posts big blind $0.50
*** HOLE CARDS ***
sa0qgETiL3HNbdfGlnKHTA: raises $0.50 to $1
yBO+mXB6m/rCft2ErwGf/Q: calls $0.50
*** FLOP *** [3s Qc Kd]
yBO+mXB6m/rCft2ErwGf/Q: checks
sa0qgETiL3HNbdfGlnKHTA: checks
*** TURN *** [3s Qc Kd] [2c]
yBO+mXB6m/rCft2ErwGf/Q: checks
sa0qgETiL3HNbdfGlnKHTA: bets $0.50
yBO+mXB6m/rCft2ErwGf/Q: folds
sa0qgETiL3HNbdfGlnKHTA collected $1.90 from pot
sa0qgETiL3HNbdfGlnKHTA: doesn't show hand
*** SUMMARY ***
Total pot $2 | Rake $0.10
Board [3s Qc Kd 2c]
Seat 1: yBO+mXB6m/rCft2ErwGf/Q (big blind) folded on the Turn
Seat 2: sa0qgETiL3HNbdfGlnKHTA (button) (small blind) collected ($1.90)



PokerStars Game #59938287750:  Hold'em No Limit ($0.25/$0.50) - 2009/07/01 0:11:24 ET
Table 'mTxf8gPLgffN3Iwfm7Icfg' 2-max Seat #1 is the button
Seat 1: Do9Rlu1R5u/AcRtMTl8SYg ($65.40 in chips)
Seat 2: EMc5LPgVaded4Qc77vm0fw ($48.50 in chips)
Do9Rlu1R5u/AcRtMTl8SYg: posts small blind $0.25
EMc5LPgVaded4Qc77vm0fw: posts big blind $0.50
*** HOLE CARDS ***
Do9Rlu1R5u/AcRtMTl8SYg: raises $1 to $1.50
EMc5LPgVaded4Qc77vm0fw: raises $3 to $4.50
Do9Rlu1R5u/AcRtMTl8SYg: calls $3
*** FLOP *** [2h 6s Jd]
EMc5LPgVaded4Qc77vm0fw: bets $5
Do9Rlu1R5u/AcRtMTl8SYg: folds
EMc5LPgVaded4Qc77vm0fw collected $8.55 from pot
EMc5LPgVaded4Qc77vm0fw: doesn't show hand
*** SUMMARY ***
Total pot $9 | Rake $0.45
Board [2h 6s Jd]
Seat 1: Do9Rlu1R5u/AcRtMTl8SYg (button) (small blind) folded on the Flop
Seat 2: EMc5LPgVaded4Qc77vm0fw (big blind) collected ($8.55)



PokerStars Game #59938288332:  Hold'em No Limit ($0.25/$0.50) - 2009/07/01 0:11:25 ET
Table '5EmHi+fnatGQQShcNmzOZQ' 6-max Seat #1 is the button
Seat 1: SwPczQo3cOtwEzhJrfO2cQ ($22.25 in chips)
Seat 2: APwvTk5XojDXGoQLb4O5iA ($26.85 in chips)
Seat 3: J8dF2sYMvXUmAGUuSW9kwg ($25.55 in chips)
Seat 4: mFTuMjESuBcXHQ1ePkg/8A ($29.45 in chips)
Seat 5: kxPhs4ePFqMy52CInAJ2aw ($69.55 in chips)
Seat 6: 686aeHikcJlgKkSuIFdcXQ ($114.70 in chips)
APwvTk5XojDXGoQLb4O5iA: posts small blind $0.25
J8dF2sYMvXUmAGUuSW9kwg: posts big blind $0.50
*** HOLE CARDS ***
mFTuMjESuBcXHQ1ePkg/8A: folds
kxPhs4ePFqMy52CInAJ2aw: folds
686aeHikcJlgKkSuIFdcXQ: folds
SwPczQo3cOtwEzhJrfO2cQ: folds
APwvTk5XojDXGoQLb4O5iA: calls $0.25
J8dF2sYMvXUmAGUuSW9kwg: checks
*** FLOP *** [Qd 7h Th]
APwvTk5XojDXGoQLb4O5iA: bets $0.50
J8dF2sYMvXUmAGUuSW9kwg: calls $0.50
*** TURN *** [Qd 7h Th] [9d]
APwvTk5XojDXGoQLb4O5iA: bets $1
J8dF2sYMvXUmAGUuSW9kwg: calls $1
*** RIVER *** [Qd 7h Th 9d] [Ah]
APwvTk5XojDXGoQLb4O5iA: bets $2
J8dF2sYMvXUmAGUuSW9kwg: calls $2
*** SHOW DOWN ***
APwvTk5XojDXGoQLb4O5iA: shows [As 4s] (a pair of Aces)
J8dF2sYMvXUmAGUuSW9kwg: mucks hand
APwvTk5XojDXGoQLb4O5iA collected $7.65 from pot
*** SUMMARY ***
Total pot $8 | Rake $0.35
Board [Qd 7h Th 9d Ah]
Seat 1: SwPczQo3cOtwEzhJrfO2cQ (button) folded before Flop (didn't bet)
Seat 2: APwvTk5XojDXGoQLb4O5iA (small blind) showed [As 4s] and won ($7.65) with a pair of Aces
Seat 3: J8dF2sYMvXUmAGUuSW9kwg (big blind) mucked
Seat 4: mFTuMjESuBcXHQ1ePkg/8A folded before Flop (didn't bet)
Seat 5: kxPhs4ePFqMy52CInAJ2aw folded before Flop (didn't bet)
Seat 6: 686aeHikcJlgKkSuIFdcXQ folded before Flop (didn't bet)



PokerStars Game #59938289672:  Hold'em No Limit ($0.25/$0.50) - 2009/07/01 0:11:27 ET
Table 'tyR5AZNKV8Aadbrnrnlg7g' 6-max Seat #2 is the button
Seat 1: R+KjpH/wSjDLhtIy9+edNA ($54.60 in chips)
Seat 2: 58zdeSBSuSFX/qZfhc7YmA ($30.95 in chips)
Seat 3: jUhx+m+V7qfbLZTjgwZByg ($47.35 in chips)
Seat 4: Rt6KgtZ8YaJoTc3FPim00w ($51.25 in chips)
Seat 5: EIg3r3fRFKG2HhgpDlIJHg ($17.95 in chips)
Seat 6: DMQLAmut/l19xN5STQndFg ($10 in chips)
jUhx+m+V7qfbLZTjgwZByg: posts small blind $0.25
Rt6KgtZ8YaJoTc3FPim00w: posts big blind $0.50
*** HOLE CARDS ***
EIg3r3fRFKG2HhgpDlIJHg: raises $1.50 to $2
DMQLAmut/l19xN5STQndFg: calls $2
R+KjpH/wSjDLhtIy9+edNA: folds
58zdeSBSuSFX/qZfhc7YmA: folds
jUhx+m+V7qfbLZTjgwZByg: folds
Rt6KgtZ8YaJoTc3FPim00w: folds
*** FLOP *** [Th 3h Js]
EIg3r3fRFKG2HhgpDlIJHg: bets $2
DMQLAmut/l19xN5STQndFg: folds
EIg3r3fRFKG2HhgpDlIJHg collected $4.55 from pot
*** SUMMARY ***
Total pot $4.75 | Rake $0.20
Board [Th 3h Js]
Seat 1: R+KjpH/wSjDLhtIy9+edNA folded before Flop (didn't bet)
Seat 2: 58zdeSBSuSFX/qZfhc7YmA (button) folded before Flop (didn't bet)
Seat 3: jUhx+m+V7qfbLZTjgwZByg (small blind) folded before Flop
Seat 4: Rt6KgtZ8YaJoTc3FPim00w (big blind) folded before Flop
Seat 5: EIg3r3fRFKG2HhgpDlIJHg collected ($4.55)
Seat 6: DMQLAmut/l19xN5STQndFg folded on the Flop



PokerStars Game #59938290650:  Hold'em No Limit ($0.25/$0.50) - 2009/07/01 0:11:28 ET
Table 'BCN5su+SsXiy1zRMJi0SJw' 6-max Seat #2 is the button
Seat 1: WyeokAqR0q9nADSkWpbxHw ($40.60 in chips)
Seat 2: QfV2JJlmEKgD5jYPV+a33A ($173.25 in chips)
Seat 3: L309C3uyA1tkWSOh/QvjHw ($21.15 in chips)
Seat 5: TTx3CHxyi0SObcHyMJRp5w ($33.25 in chips)
L309C3uyA1tkWSOh/QvjHw: posts small blind $0.25
TTx3CHxyi0SObcHyMJRp5w: posts big blind $0.50
*** HOLE CARDS ***
WyeokAqR0q9nADSkWpbxHw: folds
QfV2JJlmEKgD5jYPV+a33A: folds
L309C3uyA1tkWSOh/QvjHw: folds
TTx3CHxyi0SObcHyMJRp5w collected $0.50 from pot
TTx3CHxyi0SObcHyMJRp5w: doesn't show hand
*** SUMMARY ***
Total pot $0.50 | Rake $0
Seat 1: WyeokAqR0q9nADSkWpbxHw folded before Flop (didn't bet)
Seat 2: QfV2JJlmEKgD5jYPV+a33A (button) folded before Flop (didn't bet)
Seat 3: L309C3uyA1tkWSOh/QvjHw (small blind) folded before Flop
Seat 5: TTx3CHxyi0SObcHyMJRp5w (big blind) collected ($0.50)



PokerStars Game #59938291368:  Hold'em No Limit ($0.25/$0.50) - 2009/07/01 0:11:29 ET
Table '+z1aekfHkpp09pc8F9aViw' 6-max Seat #2 is the button
Seat 1: lWwl5C/UZOsWNubdUqghZw ($50.45 in chips)
Seat 2: VuB2GN0h94yY+QbuI2Mybg ($15.70 in chips)
Seat 3: uUznlIMFnRUvwrBhYF73KA ($54.45 in chips)
Seat 4: OCrv7ObFH4/s2lv7rYOnsQ ($25.40 in chips)
Seat 5: crjGpJEzSZgD38FoE3VMGg ($65.15 in chips)
Seat 6: 686aeHikcJlgKkSuIFdcXQ ($71.25 in chips)
uUznlIMFnRUvwrBhYF73KA: posts small blind $0.25
OCrv7ObFH4/s2lv7rYOnsQ: posts big blind $0.50
*** HOLE CARDS ***
crjGpJEzSZgD38FoE3VMGg: folds
686aeHikcJlgKkSuIFdcXQ: folds
lWwl5C/UZOsWNubdUqghZw: folds
VuB2GN0h94yY+QbuI2Mybg: calls $0.50
uUznlIMFnRUvwrBhYF73KA: raises $1.50 to $2
OCrv7ObFH4/s2lv7rYOnsQ: calls $1.50
VuB2GN0h94yY+QbuI2Mybg: calls $1.50
*** FLOP *** [Js 9d Ad]
uUznlIMFnRUvwrBhYF73KA: bets $3
OCrv7ObFH4/s2lv7rYOnsQ: folds
VuB2GN0h94yY+QbuI2Mybg: calls $3
*** TURN *** [Js 9d Ad] [3s]
uUznlIMFnRUvwrBhYF73KA: checks
VuB2GN0h94yY+QbuI2Mybg: bets $10.70 and is all-in
uUznlIMFnRUvwrBhYF73KA: folds
VuB2GN0h94yY+QbuI2Mybg collected $11.45 from pot
VuB2GN0h94yY+QbuI2Mybg: doesn't show hand
*** SUMMARY ***
Total pot $12 | Rake $0.55
Board [Js 9d Ad 3s]
Seat 1: lWwl5C/UZOsWNubdUqghZw folded before Flop (didn't bet)
Seat 2: VuB2GN0h94yY+QbuI2Mybg (button) collected ($11.45)
Seat 3: uUznlIMFnRUvwrBhYF73KA (small blind) folded on the Turn
Seat 4: OCrv7ObFH4/s2lv7rYOnsQ (big blind) folded on the Flop
Seat 5: crjGpJEzSZgD38FoE3VMGg folded before Flop (didn't bet)
Seat 6: 686aeHikcJlgKkSuIFdcXQ folded before Flop (didn't bet)



PokerStars Game #59938292090:  Hold'em No Limit ($0.25/$0.50) - 2009/07/01 0:11:30 ET
Table 'c/CRn+68J3Y8KxD5g1ek2Q' 2-max Seat #1 is the button
Seat 1: 46qCyJ6evTkHo9al5sBMNA ($325.75 in chips)
Seat 2: BypVLsYQt3ePFm2xQL/dOA ($59.70 in chips)
46qCyJ6evTkHo9al5sBMNA: posts small blind $0.25
BypVLsYQt3ePFm2xQL/dOA: posts big blind $0.50
*** HOLE CARDS ***
46qCyJ6evTkHo9al5sBMNA: folds
BypVLsYQt3ePFm2xQL/dOA collected $0.50 from pot
BypVLsYQt3ePFm2xQL/dOA: doesn't show hand
*** SUMMARY ***
Total pot $0.50 | Rake $0
Seat 1: 46qCyJ6evTkHo9al5sBMNA (button) (small blind) folded before Flop
Seat 2: BypVLsYQt3ePFm2xQL/dOA (big blind) collected ($0.50)



PokerStars Game #59938292666:  Hold'em No Limit ($0.25/$0.50) - 2009/07/01 0:11:31 ET
Table 'kgbJRsxfv64KrErDRBAkcw' 6-max Seat #1 is the button
Seat 1: YmWlPGOKFuJSoJZPW8a8IA ($79.80 in chips)
Seat 2: Q+thC23WCv1kJUJtH/+4Jw ($27 in chips)
Seat 3: T0Gx/FcQ5VH9u7XaOMX97A ($66 in chips)
Seat 4: qanMEqjABjWxC/JgQ/0l7w ($63.45 in chips)
Seat 5: +Pf9jTVizYlIo+woPvptfA ($50 in chips)
Seat 6: DDfYzIrYT0t5R/hAJngtsg ($22.35 in chips)
Q+thC23WCv1kJUJtH/+4Jw: posts small blind $0.25
T0Gx/FcQ5VH9u7XaOMX97A: posts big blind $0.50
*** HOLE CARDS ***
qanMEqjABjWxC/JgQ/0l7w: folds
+Pf9jTVizYlIo+woPvptfA: raises $1.50 to $2
DDfYzIrYT0t5R/hAJngtsg: calls $2
YmWlPGOKFuJSoJZPW8a8IA: folds
Q+thC23WCv1kJUJtH/+4Jw: calls $1.75
T0Gx/FcQ5VH9u7XaOMX97A: folds
*** FLOP *** [Td Kd 6c]
Q+thC23WCv1kJUJtH/+4Jw: checks
+Pf9jTVizYlIo+woPvptfA: checks
DDfYzIrYT0t5R/hAJngtsg: checks
*** TURN *** [Td Kd 6c] [2d]
Q+thC23WCv1kJUJtH/+4Jw: bets $3.50
+Pf9jTVizYlIo+woPvptfA: folds
DDfYzIrYT0t5R/hAJngtsg: folds
Q+thC23WCv1kJUJtH/+4Jw collected $6.20 from pot
*** SUMMARY ***
Total pot $6.50 | Rake $0.30
Board [Td Kd 6c 2d]
Seat 1: YmWlPGOKFuJSoJZPW8a8IA (button) folded before Flop (didn't bet)
Seat 2: Q+thC23WCv1kJUJtH/+4Jw (small blind) collected ($6.20)
Seat 3: T0Gx/FcQ5VH9u7XaOMX97A (big blind) folded before Flop
Seat 4: qanMEqjABjWxC/JgQ/0l7w folded before Flop (didn't bet)
Seat 5: +Pf9jTVizYlIo+woPvptfA folded on the Turn
Seat 6: DDfYzIrYT0t5R/hAJngtsg folded on the Turn



PokerStars Game #59938292728:  Hold'em No Limit ($0.25/$0.50) - 2009/07/01 0:11:31 ET
Table 'NCiXr0d5CEKBQr/cZgLhbA' 9-max Seat #5 is the button
Seat 1: RjBdQ6w31rgcy0o24VLR6w ($8.50 in chips)
Seat 2: ulxuJchBV9iguXg0FUonfg ($35.80 in chips)
Seat 3: xZCXQSXlrZkp3pZizzVXCw ($55.65 in chips)
Seat 4: CL4d+tvzcd4utdQxlPLOmg ($29.15 in chips)
Seat 5: zE9cVigS2nW/Ljy4K4bUQA ($31.95 in chips)
Seat 6: SKnJuWHScqetA/qG5p+wCg ($31.30 in chips)
Seat 8: 1MJUKc3cc0QmUoz1JZLR2w ($64.25 in chips)
Seat 9: WpvT3OUSiZlpvs+mPXFqtQ ($8.20 in chips)
SKnJuWHScqetA/qG5p+wCg: posts small blind $0.25
1MJUKc3cc0QmUoz1JZLR2w: posts big blind $0.50
*** HOLE CARDS ***
WpvT3OUSiZlpvs+mPXFqtQ: folds
RjBdQ6w31rgcy0o24VLR6w: folds
ulxuJchBV9iguXg0FUonfg: folds
xZCXQSXlrZkp3pZizzVXCw: folds
M+7+BTmX5vZatHVuoRB1nA joins the table at seat #7
CL4d+tvzcd4utdQxlPLOmg: folds
zE9cVigS2nW/Ljy4K4bUQA: raises $1 to $1.50
SKnJuWHScqetA/qG5p+wCg: folds
1MJUKc3cc0QmUoz1JZLR2w: calls $1
*** FLOP *** [Ac 3s Ks]
1MJUKc3cc0QmUoz1JZLR2w: checks
zE9cVigS2nW/Ljy4K4bUQA: bets $2
1MJUKc3cc0QmUoz1JZLR2w: raises $3.50 to $5.50
zE9cVigS2nW/Ljy4K4bUQA: folds
1MJUKc3cc0QmUoz1JZLR2w collected $6.90 from pot
*** SUMMARY ***
Total pot $7.25 | Rake $0.35
Board [Ac 3s Ks]
Seat 1: RjBdQ6w31rgcy0o24VLR6w folded before Flop (didn't bet)
Seat 2: ulxuJchBV9iguXg0FUonfg folded before Flop (didn't bet)
Seat 3: xZCXQSXlrZkp3pZizzVXCw folded before Flop (didn't bet)
Seat 4: CL4d+tvzcd4utdQxlPLOmg folded before Flop (didn't bet)
Seat 5: zE9cVigS2nW/Ljy4K4bUQA (button) folded on the Flop
Seat 6: SKnJuWHScqetA/qG5p+wCg (small blind) folded before Flop
Seat 8: 1MJUKc3cc0QmUoz1JZLR2w (big blind) collected ($6.90)
Seat 9: WpvT3OUSiZlpvs+mPXFqtQ folded before Flop (didn't bet)



PokerStars Game #59938295566:  Hold'em No Limit ($0.25/$0.50) - 2009/07/01 0:11:35 ET
Table 'm95HVfesC/VPgfGEjPuaIA' 2-max Seat #1 is the button
Seat 1: Fp/oksNpipCrD2MJ2pH20g ($10 in chips)
Seat 2: Ag6DvxX4vbRheqsv2zXKTQ ($25 in chips)
Fp/oksNpipCrD2MJ2pH20g: posts small blind $0.25
Ag6DvxX4vbRheqsv2zXKTQ: posts big blind $0.50
*** HOLE CARDS ***
Fp/oksNpipCrD2MJ2pH20g: raises $1.50 to $2
Ag6DvxX4vbRheqsv2zXKTQ: folds
Fp/oksNpipCrD2MJ2pH20g collected $1 from pot
Fp/oksNpipCrD2MJ2pH20g: doesn't show hand
*** SUMMARY ***
Total pot $1 | Rake $0
Seat 1: Fp/oksNpipCrD2MJ2pH20g (button) (small blind) collected ($1)
Seat 2: Ag6DvxX4vbRheqsv2zXKTQ (big blind) folded before Flop



PokerStars Game #59938296898:  Hold'em No Limit ($0.25/$0.50) - 2009/07/01 0:11:37 ET
Table 'E7bWJ45aoFXRpyRv2gw+Ig' 2-max Seat #1 is the button
Seat 1: FRkiRasEGlHUeLrEl+k/nA ($80.65 in chips)
Seat 2: 3Wro85I7472vJ4Wkpneo9A ($42.55 in chips)
FRkiRasEGlHUeLrEl+k/nA: posts small blind $0.25
3Wro85I7472vJ4Wkpneo9A: posts big blind $0.50
*** HOLE CARDS ***
FRkiRasEGlHUeLrEl+k/nA: raises $1 to $1.50
3Wro85I7472vJ4Wkpneo9A: calls $1
*** FLOP *** [4h 5c Kc]
3Wro85I7472vJ4Wkpneo9A: bets $2
FRkiRasEGlHUeLrEl+k/nA: calls $2
*** TURN *** [4h 5c Kc] [Jh]
3Wro85I7472vJ4Wkpneo9A: checks
FRkiRasEGlHUeLrEl+k/nA: bets $4
3Wro85I7472vJ4Wkpneo9A: folds
FRkiRasEGlHUeLrEl+k/nA collected $6.70 from pot
FRkiRasEGlHUeLrEl+k/nA: doesn't show hand
*** SUMMARY ***
Total pot $7 | Rake $0.30
Board [4h 5c Kc Jh]
Seat 1: FRkiRasEGlHUeLrEl+k/nA (button) (small blind) collected ($6.70)
Seat 2: 3Wro85I7472vJ4Wkpneo9A (big blind) folded on the Turn



PokerStars Game #59938297876:  Hold'em No Limit ($0.25/$0.50) - 2009/07/01 0:11:38 ET
Table 'c/CRn+68J3Y8KxD5g1ek2Q' 2-max Seat #2 is the button
Seat 1: 46qCyJ6evTkHo9al5sBMNA ($325.50 in chips)
Seat 2: BypVLsYQt3ePFm2xQL/dOA ($59.95 in chips)
BypVLsYQt3ePFm2xQL/dOA: posts small blind $0.25
46qCyJ6evTkHo9al5sBMNA: posts big blind $0.50
*** HOLE CARDS ***
BypVLsYQt3ePFm2xQL/dOA: raises $1.50 to $2
46qCyJ6evTkHo9al5sBMNA: folds
BypVLsYQt3ePFm2xQL/dOA collected $1 from pot
BypVLsYQt3ePFm2xQL/dOA: doesn't show hand
*** SUMMARY ***
Total pot $1 | Rake $0
Seat 1: 46qCyJ6evTkHo9al5sBMNA (big blind) folded before Flop
Seat 2: BypVLsYQt3ePFm2xQL/dOA (button) (small blind) collected ($1)



PokerStars Game #59938297640:  Hold'em No Limit ($0.25/$0.50) - 2009/07/01 0:11:38 ET
Table 'QOgaEqMcJ73pcUMMxoisUg' 6-max Seat #1 is the button
Seat 1: RFefXIDyFvNtJLq+CloCzA ($42.45 in chips)
Seat 2: Im2p1Nt83UKSqv5c9frm4Q ($50 in chips)
Seat 3: wUZNozoIDYf+16hp4nn6dw ($49.60 in chips)
Seat 4: zAcsDhG/T128Vn7XGVSgKg ($50 in chips)
Seat 5: HoaSQCRso+nEyO5DUhGduw ($57 in chips)
Seat 6: s83dnhZ6VC53vY0/f6OV/g ($48.50 in chips)
Im2p1Nt83UKSqv5c9frm4Q: posts small blind $0.25
wUZNozoIDYf+16hp4nn6dw: posts big blind $0.50
*** HOLE CARDS ***
zAcsDhG/T128Vn7XGVSgKg: folds
HoaSQCRso+nEyO5DUhGduw: raises $1 to $1.50
s83dnhZ6VC53vY0/f6OV/g: folds
RFefXIDyFvNtJLq+CloCzA: folds
Im2p1Nt83UKSqv5c9frm4Q: folds
wUZNozoIDYf+16hp4nn6dw: folds
HoaSQCRso+nEyO5DUhGduw collected $1.25 from pot
*** SUMMARY ***
Total pot $1.25 | Rake $0
Seat 1: RFefXIDyFvNtJLq+CloCzA (button) folded before Flop (didn't bet)
Seat 2: Im2p1Nt83UKSqv5c9frm4Q (small blind) folded before Flop
Seat 3: wUZNozoIDYf+16hp4nn6dw (big blind) folded before Flop
Seat 4: zAcsDhG/T128Vn7XGVSgKg folded before Flop (didn't bet)
Seat 5: HoaSQCRso+nEyO5DUhGduw collected ($1.25)
Seat 6: s83dnhZ6VC53vY0/f6OV/g folded before Flop (didn't bet)



PokerStars Game #59938297732:  Hold'em No Limit ($0.25/$0.50) - 2009/07/01 0:11:38 ET
Table 'BCN5su+SsXiy1zRMJi0SJw' 6-max Seat #3 is the button
Seat 1: WyeokAqR0q9nADSkWpbxHw ($40.60 in chips)
Seat 2: QfV2JJlmEKgD5jYPV+a33A ($173.25 in chips)
Seat 3: L309C3uyA1tkWSOh/QvjHw ($20.90 in chips)
Seat 5: TTx3CHxyi0SObcHyMJRp5w ($33.50 in chips)
TTx3CHxyi0SObcHyMJRp5w: posts small blind $0.25
WyeokAqR0q9nADSkWpbxHw: posts big blind $0.50
*** HOLE CARDS ***
QfV2JJlmEKgD5jYPV+a33A: folds
L309C3uyA1tkWSOh/QvjHw: folds
TTx3CHxyi0SObcHyMJRp5w: folds
WyeokAqR0q9nADSkWpbxHw collected $0.50 from pot
*** SUMMARY ***
Total pot $0.50 | Rake $0
Seat 1: WyeokAqR0q9nADSkWpbxHw (big blind) collected ($0.50)
Seat 2: QfV2JJlmEKgD5jYPV+a33A folded before Flop (didn't bet)
Seat 3: L309C3uyA1tkWSOh/QvjHw (button) folded before Flop (didn't bet)
Seat 5: TTx3CHxyi0SObcHyMJRp5w (small blind) folded before Flop



PokerStars Game #59938297352:  Hold'em No Limit ($0.25/$0.50) - 2009/07/01 0:11:38 ET
Table 'X6IRCRTh+20gjz8aubWnwA' 9-max Seat #5 is the button
Seat 1: YPo1oggovmqSREegekaQYw ($9.45 in chips)
Seat 2: RjBdQ6w31rgcy0o24VLR6w ($11.65 in chips)
Seat 3: mSD1pginDsyHG5PDfqzphw ($10 in chips)
Seat 4: uw9QayAAxLM3Hb+HR7mSkg ($10.25 in chips)
Seat 5: L5e2lrPLQm1Pqx30IIZ/Fw ($10.50 in chips)
Seat 6: /6In1zC3WtgwxDcueWzZWg ($57.20 in chips)
Seat 7: VBnpbzn0dIveV55qKvciew ($56.70 in chips)
Seat 8: BPMN9sOItJw6vWq3kypaYg ($29.25 in chips)
Seat 9: M+7+BTmX5vZatHVuoRB1nA ($84.10 in chips)
/6In1zC3WtgwxDcueWzZWg: posts small blind $0.25
VBnpbzn0dIveV55qKvciew: posts big blind $0.50
*** HOLE CARDS ***
BPMN9sOItJw6vWq3kypaYg: folds
M+7+BTmX5vZatHVuoRB1nA: folds
YPo1oggovmqSREegekaQYw: folds
RjBdQ6w31rgcy0o24VLR6w: folds
mSD1pginDsyHG5PDfqzphw: folds
uw9QayAAxLM3Hb+HR7mSkg: folds
L5e2lrPLQm1Pqx30IIZ/Fw: raises $1 to $1.50
/6In1zC3WtgwxDcueWzZWg: folds
VBnpbzn0dIveV55qKvciew: folds
L5e2lrPLQm1Pqx30IIZ/Fw collected $1.25 from pot
*** SUMMARY ***
Total pot $1.25 | Rake $0
Seat 1: YPo1oggovmqSREegekaQYw folded before Flop (didn't bet)
Seat 2: RjBdQ6w31rgcy0o24VLR6w folded before Flop (didn't bet)
Seat 3: mSD1pginDsyHG5PDfqzphw folded before Flop (didn't bet)
Seat 4: uw9QayAAxLM3Hb+HR7mSkg folded before Flop (didn't bet)
Seat 5: L5e2lrPLQm1Pqx30IIZ/Fw (button) collected ($1.25)
Seat 6: /6In1zC3WtgwxDcueWzZWg (small blind) folded before Flop
Seat 7: VBnpbzn0dIveV55qKvciew (big blind) folded before Flop
Seat 8: BPMN9sOItJw6vWq3kypaYg folded before Flop (didn't bet)
Seat 9: M+7+BTmX5vZatHVuoRB1nA folded before Flop (didn't bet)



PokerStars Game #59938298496:  Hold'em No Limit ($0.25/$0.50) - 2009/07/01 0:11:39 ET
Table 'MJxeZCzYELxiIsyUZyT0jw' 6-max Seat #1 is the button
Seat 1: iKPos8JI094Tomq4tDSgnQ ($36.05 in chips)
Seat 2: r6H1GiZ6QIpMTDhyodKuRQ ($64.40 in chips)
Seat 3: JQZew0FjzS19kTjeNtrE+A ($50.75 in chips)
Seat 4: lP7Q6pewz4C2RsAfKsjdWw ($21.05 in chips)
Seat 5: 3jvoOXNtXE90w2BdfNZwZQ ($53.50 in chips)
Seat 6: TTx3CHxyi0SObcHyMJRp5w ($42.70 in chips)
r6H1GiZ6QIpMTDhyodKuRQ: posts small blind $0.25
JQZew0FjzS19kTjeNtrE+A: posts big blind $0.50
*** HOLE CARDS ***
lP7Q6pewz4C2RsAfKsjdWw: calls $0.50
3jvoOXNtXE90w2BdfNZwZQ: folds
TTx3CHxyi0SObcHyMJRp5w: folds
iKPos8JI094Tomq4tDSgnQ: raises $0.50 to $1
r6H1GiZ6QIpMTDhyodKuRQ: folds
JQZew0FjzS19kTjeNtrE+A: folds
lP7Q6pewz4C2RsAfKsjdWw: calls $0.50
*** FLOP *** [Ad 6h Kh]
lP7Q6pewz4C2RsAfKsjdWw: checks
iKPos8JI094Tomq4tDSgnQ: bets $1
lP7Q6pewz4C2RsAfKsjdWw: calls $1
*** TURN *** [Ad 6h Kh] [Js]
lP7Q6pewz4C2RsAfKsjdWw: checks
iKPos8JI094Tomq4tDSgnQ: checks
*** RIVER *** [Ad 6h Kh Js] [6d]
lP7Q6pewz4C2RsAfKsjdWw: checks
iKPos8JI094Tomq4tDSgnQ: checks
*** SHOW DOWN ***
lP7Q6pewz4C2RsAfKsjdWw: shows [Ac 4c] (two pair, Aces and Sixes)
iKPos8JI094Tomq4tDSgnQ: mucks hand
lP7Q6pewz4C2RsAfKsjdWw collected $4.55 from pot
*** SUMMARY ***
Total pot $4.75 | Rake $0.20
Board [Ad 6h Kh Js 6d]
Seat 1: iKPos8JI094Tomq4tDSgnQ (button) mucked
Seat 2: r6H1GiZ6QIpMTDhyodKuRQ (small blind) folded before Flop
Seat 3: JQZew0FjzS19kTjeNtrE+A (big blind) folded before Flop
Seat 4: lP7Q6pewz4C2RsAfKsjdWw showed [Ac 4c] and won ($4.55) with two pair, Aces and Sixes
Seat 5: 3jvoOXNtXE90w2BdfNZwZQ folded before Flop (didn't bet)
Seat 6: TTx3CHxyi0SObcHyMJRp5w folded before Flop (didn't bet)



PokerStars Game #59938302152:  Hold'em No Limit ($0.25/$0.50) - 2009/07/01 0:11:45 ET
Table 'lSisgp6H7Fg1hH5VfjEjYQ' 9-max Seat #5 is the button
Seat 1: pEW8B6uXbdR47kfljMQ3+Q ($39.70 in chips)
Seat 2: UrcnkQOiLVk8BlKDPJSy7Q ($51.85 in chips)
Seat 3: aTkyjTh3w5YLWiIERupZOA ($30 in chips)
Seat 4: nvw9yQKhJT56lA9k+TLdhw ($10.95 in chips)
Seat 5: mSD1pginDsyHG5PDfqzphw ($10 in chips)
Seat 6: +k7T5ocke8UwavtgUHm+Cg ($22.65 in chips)
Seat 9: 5JJVDlaiMnB004o/RqbZZQ ($41.55 in chips)
+k7T5ocke8UwavtgUHm+Cg: posts small blind $0.25
bXpVeaSTPBFSPJmeXxO7nw: is sitting out
5JJVDlaiMnB004o/RqbZZQ: posts big blind $0.50
aTkyjTh3w5YLWiIERupZOA: posts big blind $0.50
*** HOLE CARDS ***
pEW8B6uXbdR47kfljMQ3+Q: folds
dGw5MBstXyXhWHHVFOWOFA joins the table at seat #7
bXpVeaSTPBFSPJmeXxO7nw leaves the table
UrcnkQOiLVk8BlKDPJSy7Q: folds
aTkyjTh3w5YLWiIERupZOA: checks
nvw9yQKhJT56lA9k+TLdhw: folds
mSD1pginDsyHG5PDfqzphw: folds
+k7T5ocke8UwavtgUHm+Cg: calls $0.25
5JJVDlaiMnB004o/RqbZZQ: checks
*** FLOP *** [3c Jh 3h]
+k7T5ocke8UwavtgUHm+Cg: checks
5JJVDlaiMnB004o/RqbZZQ: checks
aTkyjTh3w5YLWiIERupZOA: bets $1
+k7T5ocke8UwavtgUHm+Cg: folds
5JJVDlaiMnB004o/RqbZZQ: folds
aTkyjTh3w5YLWiIERupZOA collected $1.45 from pot
*** SUMMARY ***
Total pot $1.50 | Rake $0.05
Board [3c Jh 3h]
Seat 1: pEW8B6uXbdR47kfljMQ3+Q folded before Flop (didn't bet)
Seat 2: UrcnkQOiLVk8BlKDPJSy7Q folded before Flop (didn't bet)
Seat 3: aTkyjTh3w5YLWiIERupZOA collected ($1.45)
Seat 4: nvw9yQKhJT56lA9k+TLdhw folded before Flop (didn't bet)
Seat 5: mSD1pginDsyHG5PDfqzphw (button) folded before Flop (didn't bet)
Seat 6: +k7T5ocke8UwavtgUHm+Cg (small blind) folded on the Flop
Seat 9: 5JJVDlaiMnB004o/RqbZZQ (big blind) folded on the Flop



PokerStars Game #59938302612:  Hold'em No Limit ($0.25/$0.50) - 2009/07/01 0:11:45 ET
Table 'raOT4/ipuZgzjfKHC+jD9g' 2-max Seat #1 is the button
Seat 1: IuwLemwLhc9fvrwBGs0AMA ($11.30 in chips)
Seat 2: Udr5juWSWUgTu1NlRhjMdA ($11.75 in chips)
IuwLemwLhc9fvrwBGs0AMA: posts small blind $0.25
Udr5juWSWUgTu1NlRhjMdA: posts big blind $0.50
*** HOLE CARDS ***
IuwLemwLhc9fvrwBGs0AMA: calls $0.25
Udr5juWSWUgTu1NlRhjMdA: checks
*** FLOP *** [8s 7h 7d]
Udr5juWSWUgTu1NlRhjMdA: checks
IuwLemwLhc9fvrwBGs0AMA: checks
*** TURN *** [8s 7h 7d] [2c]
Udr5juWSWUgTu1NlRhjMdA: checks
IuwLemwLhc9fvrwBGs0AMA: checks
*** RIVER *** [8s 7h 7d 2c] [3h]
Udr5juWSWUgTu1NlRhjMdA: bets $0.50
IuwLemwLhc9fvrwBGs0AMA: calls $0.50
*** SHOW DOWN ***
Udr5juWSWUgTu1NlRhjMdA: shows [Th Kc] (a pair of Sevens)
IuwLemwLhc9fvrwBGs0AMA: shows [4h 4s] (two pair, Sevens and Fours)
IuwLemwLhc9fvrwBGs0AMA collected $1.95 from pot
*** SUMMARY ***
Total pot $2 | Rake $0.05
Board [8s 7h 7d 2c 3h]
Seat 1: IuwLemwLhc9fvrwBGs0AMA (button) (small blind) showed [4h 4s] and won ($1.95) with two pair, Sevens and Fours
Seat 2: Udr5juWSWUgTu1NlRhjMdA (big blind) showed [Th Kc] and lost with a pair of Sevens



PokerStars Game #59938303168:  Hold'em No Limit ($0.25/$0.50) - 2009/07/01 0:11:46 ET
Table 'Nz0Vr7WMHL2g5Uk7dDZjpw' 9-max Seat #4 is the button
Seat 1: tLkxo7JgV+WWI0UBw44K5A ($104.85 in chips)
Seat 3: 4QTiNH5fteLgJjx/s6Hy6A ($7.75 in chips)
Seat 4: 5JJVDlaiMnB004o/RqbZZQ ($27 in chips)
Seat 5: WGW0DgjBUXs1ylURHG8vnQ ($17.40 in chips)
Seat 6: k1f0lS7tlMHCLGs0JT34Tg ($9.25 in chips)
Seat 7: KPLH0gELgFe2OuAnhJFI5w ($22.45 in chips)
Seat 8: HkZI6g4zl83TDTA7SRspmQ ($17.25 in chips)
Seat 9: Ak2W6V2TDVIQrvSAy4eD7Q ($22.80 in chips)
WGW0DgjBUXs1ylURHG8vnQ: posts small blind $0.25
k1f0lS7tlMHCLGs0JT34Tg: posts big blind $0.50
*** HOLE CARDS ***
KPLH0gELgFe2OuAnhJFI5w: folds
HkZI6g4zl83TDTA7SRspmQ: folds
Ak2W6V2TDVIQrvSAy4eD7Q: folds
tLkxo7JgV+WWI0UBw44K5A: folds
4QTiNH5fteLgJjx/s6Hy6A: raises $0.50 to $1
5JJVDlaiMnB004o/RqbZZQ: folds
WGW0DgjBUXs1ylURHG8vnQ: folds
k1f0lS7tlMHCLGs0JT34Tg: calls $0.50
*** FLOP *** [7h 3c 5h]
k1f0lS7tlMHCLGs0JT34Tg: checks
4QTiNH5fteLgJjx/s6Hy6A: bets $1.50
k1f0lS7tlMHCLGs0JT34Tg: folds
4QTiNH5fteLgJjx/s6Hy6A collected $2.15 from pot
*** SUMMARY ***
Total pot $2.25 | Rake $0.10
Board [7h 3c 5h]
Seat 1: tLkxo7JgV+WWI0UBw44K5A folded before Flop (didn't bet)
Seat 3: 4QTiNH5fteLgJjx/s6Hy6A collected ($2.15)
Seat 4: 5JJVDlaiMnB004o/RqbZZQ (button) folded before Flop (didn't bet)
Seat 5: WGW0DgjBUXs1ylURHG8vnQ (small blind) folded before Flop
Seat 6: k1f0lS7tlMHCLGs0JT34Tg (big blind) folded on the Flop
Seat 7: KPLH0gELgFe2OuAnhJFI5w folded before Flop (didn't bet)
Seat 8: HkZI6g4zl83TDTA7SRspmQ folded before Flop (didn't bet)
Seat 9: Ak2W6V2TDVIQrvSAy4eD7Q folded before Flop (didn't bet)



PokerStars Game #59938304034:  Hold'em No Limit ($0.25/$0.50) - 2009/07/01 0:11:47 ET
Table 'm95HVfesC/VPgfGEjPuaIA' 2-max Seat #2 is the button
Seat 1: Fp/oksNpipCrD2MJ2pH20g ($10.50 in chips)
Seat 2: Ag6DvxX4vbRheqsv2zXKTQ ($24.50 in chips)
Ag6DvxX4vbRheqsv2zXKTQ: posts small blind $0.25
Fp/oksNpipCrD2MJ2pH20g: posts big blind $0.50
*** HOLE CARDS ***
Ag6DvxX4vbRheqsv2zXKTQ: raises $1.50 to $2
Fp/oksNpipCrD2MJ2pH20g: calls $1.50
*** FLOP *** [2c 5h 3s]
Fp/oksNpipCrD2MJ2pH20g: checks
Ag6DvxX4vbRheqsv2zXKTQ: bets $3
Fp/oksNpipCrD2MJ2pH20g: folds
Ag6DvxX4vbRheqsv2zXKTQ collected $3.80 from pot
*** SUMMARY ***
Total pot $4 | Rake $0.20
Board [2c 5h 3s]
Seat 1: Fp/oksNpipCrD2MJ2pH20g (big blind) folded on the Flop
Seat 2: Ag6DvxX4vbRheqsv2zXKTQ (button) (small blind) collected ($3.80)



PokerStars Game #59938303836:  Hold'em No Limit ($0.25/$0.50) - 2009/07/01 0:11:47 ET
Table 'c/CRn+68J3Y8KxD5g1ek2Q' 2-max Seat #1 is the button
Seat 1: 46qCyJ6evTkHo9al5sBMNA ($325 in chips)
Seat 2: BypVLsYQt3ePFm2xQL/dOA ($60.45 in chips)
46qCyJ6evTkHo9al5sBMNA: posts small blind $0.25
BypVLsYQt3ePFm2xQL/dOA: posts big blind $0.50
*** HOLE CARDS ***
46qCyJ6evTkHo9al5sBMNA: folds
BypVLsYQt3ePFm2xQL/dOA collected $0.50 from pot
BypVLsYQt3ePFm2xQL/dOA: doesn't show hand
*** SUMMARY ***
Total pot $0.50 | Rake $0
Seat 1: 46qCyJ6evTkHo9al5sBMNA (button) (small blind) folded before Flop
Seat 2: BypVLsYQt3ePFm2xQL/dOA (big blind) collected ($0.50)



PokerStars Game #59938305300:  Hold'em No Limit ($0.25/$0.50) - 2009/07/01 0:11:49 ET
Table 'mTxf8gPLgffN3Iwfm7Icfg' 2-max Seat #2 is the button
Seat 1: Do9Rlu1R5u/AcRtMTl8SYg ($60.90 in chips)
Seat 2: EMc5LPgVaded4Qc77vm0fw ($52.55 in chips)
EMc5LPgVaded4Qc77vm0fw: posts small blind $0.25
Do9Rlu1R5u/AcRtMTl8SYg: posts big blind $0.50
*** HOLE CARDS ***
EMc5LPgVaded4Qc77vm0fw: folds
Do9Rlu1R5u/AcRtMTl8SYg collected $0.50 from pot
Do9Rlu1R5u/AcRtMTl8SYg: doesn't show hand
*** SUMMARY ***
Total pot $0.50 | Rake $0
Seat 1: Do9Rlu1R5u/AcRtMTl8SYg (big blind) collected ($0.50)
Seat 2: EMc5LPgVaded4Qc77vm0fw (button) (small blind) folded before Flop



PokerStars Game #59938305194:  Hold'em No Limit ($0.25/$0.50) - 2009/07/01 0:11:49 ET
Table 'tpZbcIvqh/6WmfR/i5IE3A' 9-max Seat #7 is the button
Seat 1: nV/P1jFY/CFMXOLWu7pYmA ($13.20 in chips)
Seat 2: M+7+BTmX5vZatHVuoRB1nA ($42.90 in chips)
Seat 3: 3w0FbBQAKwQODwenKwZxXw ($78.40 in chips)
Seat 4: zE9cVigS2nW/Ljy4K4bUQA ($31.85 in chips)
Seat 5: 9r7ZoBbAJj5IeyZ0q9BdzA ($15.20 in chips)
Seat 6: E2518gp4aFz1+kAgmGqeEg ($10.45 in chips)
Seat 7: wIZ377kjl2fHFGnS93o6bw ($14.15 in chips)
darkshade77 was removed from the table for failing to post
nV/P1jFY/CFMXOLWu7pYmA: posts small blind $0.25
M+7+BTmX5vZatHVuoRB1nA: posts big blind $0.50
*** HOLE CARDS ***
3w0FbBQAKwQODwenKwZxXw: folds
zE9cVigS2nW/Ljy4K4bUQA: folds
9r7ZoBbAJj5IeyZ0q9BdzA: folds
E2518gp4aFz1+kAgmGqeEg: raises $1 to $1.50
wIZ377kjl2fHFGnS93o6bw: folds
nV/P1jFY/CFMXOLWu7pYmA: calls $1.25
M+7+BTmX5vZatHVuoRB1nA: folds
*** FLOP *** [4s 7c 3c]
nV/P1jFY/CFMXOLWu7pYmA: checks
E2518gp4aFz1+kAgmGqeEg: bets $1.50
nV/P1jFY/CFMXOLWu7pYmA: raises $2.50 to $4
bXpVeaSTPBFSPJmeXxO7nw leaves the table
E2518gp4aFz1+kAgmGqeEg: raises $4.95 to $8.95 and is all-in
nV/P1jFY/CFMXOLWu7pYmA: calls $4.95
*** TURN *** [4s 7c 3c] [Th]
*** RIVER *** [4s 7c 3c Th] [2d]
*** SHOW DOWN ***
nV/P1jFY/CFMXOLWu7pYmA: shows [Jd Jh] (a pair of Jacks)
E2518gp4aFz1+kAgmGqeEg: shows [Qh Qc] (a pair of Queens)
E2518gp4aFz1+kAgmGqeEg collected $20.35 from pot
E2518gp4aFz1+kAgmGqeEg is sitting out
*** SUMMARY ***
Total pot $21.40 | Rake $1.05
Board [4s 7c 3c Th 2d]
Seat 1: nV/P1jFY/CFMXOLWu7pYmA (small blind) showed [Jd Jh] and lost with a pair of Jacks
Seat 2: M+7+BTmX5vZatHVuoRB1nA (big blind) folded before Flop
Seat 3: 3w0FbBQAKwQODwenKwZxXw folded before Flop (didn't bet)
Seat 4: zE9cVigS2nW/Ljy4K4bUQA folded before Flop (didn't bet)
Seat 5: 9r7ZoBbAJj5IeyZ0q9BdzA folded before Flop (didn't bet)
Seat 6: E2518gp4aFz1+kAgmGqeEg showed [Qh Qc] and won ($20.35) with a pair of Queens
Seat 7: wIZ377kjl2fHFGnS93o6bw (button) folded before Flop (didn't bet)



PokerStars Game #59938305210:  Hold'em No Limit ($0.25/$0.50) - 2009/07/01 0:11:49 ET
Table 'BCN5su+SsXiy1zRMJi0SJw' 6-max Seat #5 is the button
Seat 1: WyeokAqR0q9nADSkWpbxHw ($40.85 in chips)
Seat 2: QfV2JJlmEKgD5jYPV+a33A ($173.25 in chips)
Seat 3: L309C3uyA1tkWSOh/QvjHw ($20.90 in chips)
Seat 5: TTx3CHxyi0SObcHyMJRp5w ($33.25 in chips)
WyeokAqR0q9nADSkWpbxHw: posts small blind $0.25
QfV2JJlmEKgD5jYPV+a33A: posts big blind $0.50
*** HOLE CARDS ***
L309C3uyA1tkWSOh/QvjHw: folds
TTx3CHxyi0SObcHyMJRp5w: folds
WyeokAqR0q9nADSkWpbxHw: calls $0.25
QfV2JJlmEKgD5jYPV+a33A: checks
*** FLOP *** [Th 5s Tc]
zHXshyreKwJVq3N3U+K9uQ leaves the table
WyeokAqR0q9nADSkWpbxHw: checks
QfV2JJlmEKgD5jYPV+a33A: bets $0.50
WyeokAqR0q9nADSkWpbxHw: calls $0.50
*** TURN *** [Th 5s Tc] [Jc]
WyeokAqR0q9nADSkWpbxHw: checks
QfV2JJlmEKgD5jYPV+a33A: bets $1.50
WyeokAqR0q9nADSkWpbxHw: raises $1.50 to $3
QfV2JJlmEKgD5jYPV+a33A: calls $1.50
*** RIVER *** [Th 5s Tc Jc] [Ts]
WyeokAqR0q9nADSkWpbxHw: checks
QfV2JJlmEKgD5jYPV+a33A: bets $4.50
WyeokAqR0q9nADSkWpbxHw: folds
QfV2JJlmEKgD5jYPV+a33A collected $7.65 from pot
QfV2JJlmEKgD5jYPV+a33A: doesn't show hand
*** SUMMARY ***
Total pot $8 | Rake $0.35
Board [Th 5s Tc Jc Ts]
Seat 1: WyeokAqR0q9nADSkWpbxHw (small blind) folded on the River
Seat 2: QfV2JJlmEKgD5jYPV+a33A (big blind) collected ($7.65)
Seat 3: L309C3uyA1tkWSOh/QvjHw folded before Flop (didn't bet)
Seat 5: TTx3CHxyi0SObcHyMJRp5w (button) folded before Flop (didn't bet)



PokerStars Game #59938306112:  Hold'em No Limit ($0.25/$0.50) - 2009/07/01 0:11:50 ET
Table 'Vdlc9wqYcHTUhtdyN7CuJw' 2-max Seat #1 is the button
Seat 1: yBO+mXB6m/rCft2ErwGf/Q ($89.10 in chips)
Seat 2: sa0qgETiL3HNbdfGlnKHTA ($22.95 in chips)
yBO+mXB6m/rCft2ErwGf/Q: posts small blind $0.25
sa0qgETiL3HNbdfGlnKHTA: posts big blind $0.50
*** HOLE CARDS ***
yBO+mXB6m/rCft2ErwGf/Q: folds
sa0qgETiL3HNbdfGlnKHTA collected $0.50 from pot
sa0qgETiL3HNbdfGlnKHTA: doesn't show hand
*** SUMMARY ***
Total pot $0.50 | Rake $0
Seat 1: yBO+mXB6m/rCft2ErwGf/Q (button) (small blind) folded before Flop
Seat 2: sa0qgETiL3HNbdfGlnKHTA (big blind) collected ($0.50)



PokerStars Game #59938307594:  Hold'em No Limit ($0.25/$0.50) - 2009/07/01 0:11:52 ET
Table 'ibNfFy0bCzuBaUORla0aGw' 9-max Seat #7 is the button
Seat 1: xZCXQSXlrZkp3pZizzVXCw ($56.95 in chips)
Seat 2: 90Wb75h3W1BRpbqVnuk8gw ($52.55 in chips)
Seat 3: dDaHs3X8+fe3bIkRU0cbrw ($26.30 in chips)
Seat 4: YBN054X4blmis+B2bBlC0g ($21.05 in chips)
Seat 5: FRv75HO8CUsRZ1byEz06mQ ($15.35 in chips)
Seat 6: BmYrv3ec2k5d6pQq6iNaZw ($67.85 in chips)
Seat 7: mSD1pginDsyHG5PDfqzphw ($10 in chips)
Seat 8: xUrN9TWLq4m5V+OXY7KUUA ($50 in chips)
Seat 9: WpvT3OUSiZlpvs+mPXFqtQ ($8.75 in chips)
xUrN9TWLq4m5V+OXY7KUUA: posts small blind $0.25
WpvT3OUSiZlpvs+mPXFqtQ: posts big blind $0.50
*** HOLE CARDS ***
xZCXQSXlrZkp3pZizzVXCw: raises $1 to $1.50
90Wb75h3W1BRpbqVnuk8gw: folds
dDaHs3X8+fe3bIkRU0cbrw: folds
YBN054X4blmis+B2bBlC0g: folds
FRv75HO8CUsRZ1byEz06mQ: calls $1.50
BmYrv3ec2k5d6pQq6iNaZw: folds
mSD1pginDsyHG5PDfqzphw: raises $8.50 to $10 and is all-in
xUrN9TWLq4m5V+OXY7KUUA: folds
WpvT3OUSiZlpvs+mPXFqtQ: folds
xZCXQSXlrZkp3pZizzVXCw: folds
FRv75HO8CUsRZ1byEz06mQ: folds
mSD1pginDsyHG5PDfqzphw collected $5.25 from pot
*** SUMMARY ***
Total pot $5.25 | Rake $0
Seat 1: xZCXQSXlrZkp3pZizzVXCw folded before Flop
Seat 2: 90Wb75h3W1BRpbqVnuk8gw folded before Flop (didn't bet)
Seat 3: dDaHs3X8+fe3bIkRU0cbrw folded before Flop (didn't bet)
Seat 4: YBN054X4blmis+B2bBlC0g folded before Flop (didn't bet)
Seat 5: FRv75HO8CUsRZ1byEz06mQ folded before Flop
Seat 6: BmYrv3ec2k5d6pQq6iNaZw folded before Flop (didn't bet)
Seat 7: mSD1pginDsyHG5PDfqzphw (button) collected ($5.25)
Seat 8: xUrN9TWLq4m5V+OXY7KUUA (small blind) folded before Flop
Seat 9: WpvT3OUSiZlpvs+mPXFqtQ (big blind) folded before Flop



PokerStars Game #59938307902:  Hold'em No Limit ($0.25/$0.50) - 2009/07/01 0:11:53 ET
Table 'hSTs/dUsYLgJQuF2Onp0MQ' 6-max Seat #4 is the button
Seat 1: lWwl5C/UZOsWNubdUqghZw ($70.70 in chips)
Seat 2: fyJOjf+Vdie/rpWb1WExIg ($16.25 in chips)
Seat 3: vQOrJuXbLC3UZDVklY9bOA ($19.95 in chips)
Seat 4: L0aIPg7qefDQjdJo3HCVEA ($13.70 in chips)
Seat 5: 686aeHikcJlgKkSuIFdcXQ ($60.15 in chips)
Seat 6: +laPa9P7BjZKKnR0n+OmvA ($4.15 in chips)
686aeHikcJlgKkSuIFdcXQ: posts small blind $0.25
+laPa9P7BjZKKnR0n+OmvA: posts big blind $0.50
*** HOLE CARDS ***
lWwl5C/UZOsWNubdUqghZw: folds
fyJOjf+Vdie/rpWb1WExIg: folds
vQOrJuXbLC3UZDVklY9bOA: folds
L0aIPg7qefDQjdJo3HCVEA: folds
686aeHikcJlgKkSuIFdcXQ: folds
+laPa9P7BjZKKnR0n+OmvA collected $0.50 from pot
*** SUMMARY ***
Total pot $0.50 | Rake $0
Seat 1: lWwl5C/UZOsWNubdUqghZw folded before Flop (didn't bet)
Seat 2: fyJOjf+Vdie/rpWb1WExIg folded before Flop (didn't bet)
Seat 3: vQOrJuXbLC3UZDVklY9bOA folded before Flop (didn't bet)
Seat 4: L0aIPg7qefDQjdJo3HCVEA (button) folded before Flop (didn't bet)
Seat 5: 686aeHikcJlgKkSuIFdcXQ (small blind) folded before Flop
Seat 6: +laPa9P7BjZKKnR0n+OmvA (big blind) collected ($0.50)



PokerStars Game #59938308886:  Hold'em No Limit ($0.25/$0.50) - 2009/07/01 0:11:54 ET
Table 'c/CRn+68J3Y8KxD5g1ek2Q' 2-max Seat #2 is the button
Seat 1: 46qCyJ6evTkHo9al5sBMNA ($324.75 in chips)
Seat 2: BypVLsYQt3ePFm2xQL/dOA ($60.70 in chips)
BypVLsYQt3ePFm2xQL/dOA: posts small blind $0.25
46qCyJ6evTkHo9al5sBMNA: posts big blind $0.50
*** HOLE CARDS ***
BypVLsYQt3ePFm2xQL/dOA: raises $1.50 to $2
46qCyJ6evTkHo9al5sBMNA: folds
BypVLsYQt3ePFm2xQL/dOA collected $1 from pot
BypVLsYQt3ePFm2xQL/dOA: doesn't show hand
*** SUMMARY ***
Total pot $1 | Rake $0
Seat 1: 46qCyJ6evTkHo9al5sBMNA (big blind) folded before Flop
Seat 2: BypVLsYQt3ePFm2xQL/dOA (button) (small blind) collected ($1)



PokerStars Game #59938309802:  Hold'em No Limit ($0.25/$0.50) - 2009/07/01 0:11:55 ET
Table 'mTxf8gPLgffN3Iwfm7Icfg' 2-max Seat #1 is the button
Seat 1: Do9Rlu1R5u/AcRtMTl8SYg ($61.15 in chips)
Seat 2: EMc5LPgVaded4Qc77vm0fw ($52.30 in chips)
Do9Rlu1R5u/AcRtMTl8SYg: posts small blind $0.25
EMc5LPgVaded4Qc77vm0fw: posts big blind $0.50
*** HOLE CARDS ***
Do9Rlu1R5u/AcRtMTl8SYg: folds
EMc5LPgVaded4Qc77vm0fw collected $0.50 from pot
EMc5LPgVaded4Qc77vm0fw: doesn't show hand
*** SUMMARY ***
Total pot $0.50 | Rake $0
Seat 1: Do9Rlu1R5u/AcRtMTl8SYg (button) (small blind) folded before Flop
Seat 2: EMc5LPgVaded4Qc77vm0fw (big blind) collected ($0.50)



PokerStars Game #59938310622:  Hold'em No Limit ($0.25/$0.50) - 2009/07/01 0:11:56 ET
Table 'tyR5AZNKV8Aadbrnrnlg7g' 6-max Seat #3 is the button
Seat 1: R+KjpH/wSjDLhtIy9+edNA ($54.60 in chips)
Seat 2: 58zdeSBSuSFX/qZfhc7YmA ($30.95 in chips)
Seat 3: jUhx+m+V7qfbLZTjgwZByg ($47.10 in chips)
Seat 4: Rt6KgtZ8YaJoTc3FPim00w ($50.75 in chips)
Seat 5: EIg3r3fRFKG2HhgpDlIJHg ($20.50 in chips)
Seat 6: DMQLAmut/l19xN5STQndFg ($8 in chips)
Rt6KgtZ8YaJoTc3FPim00w: posts small blind $0.25
EIg3r3fRFKG2HhgpDlIJHg: posts big blind $0.50
*** HOLE CARDS ***
DMQLAmut/l19xN5STQndFg: calls $0.50
R+KjpH/wSjDLhtIy9+edNA: calls $0.50
58zdeSBSuSFX/qZfhc7YmA: calls $0.50
jUhx+m+V7qfbLZTjgwZByg: folds
Rt6KgtZ8YaJoTc3FPim00w: folds
EIg3r3fRFKG2HhgpDlIJHg: checks
*** FLOP *** [Jh 7s Th]
EIg3r3fRFKG2HhgpDlIJHg: checks
DMQLAmut/l19xN5STQndFg: checks
R+KjpH/wSjDLhtIy9+edNA: checks
58zdeSBSuSFX/qZfhc7YmA: checks
*** TURN *** [Jh 7s Th] [Ad]
EIg3r3fRFKG2HhgpDlIJHg: checks
DMQLAmut/l19xN5STQndFg: checks
R+KjpH/wSjDLhtIy9+edNA: checks
58zdeSBSuSFX/qZfhc7YmA: bets $2
EIg3r3fRFKG2HhgpDlIJHg: folds
DMQLAmut/l19xN5STQndFg: folds
R+KjpH/wSjDLhtIy9+edNA: folds
58zdeSBSuSFX/qZfhc7YmA collected $2.15 from pot
*** SUMMARY ***
Total pot $2.25 | Rake $0.10
Board [Jh 7s Th Ad]
Seat 1: R+KjpH/wSjDLhtIy9+edNA folded on the Turn
Seat 2: 58zdeSBSuSFX/qZfhc7YmA collected ($2.15)
Seat 3: jUhx+m+V7qfbLZTjgwZByg (button) folded before Flop (didn't bet)
Seat 4: Rt6KgtZ8YaJoTc3FPim00w (small blind) folded before Flop
Seat 5: EIg3r3fRFKG2HhgpDlIJHg (big blind) folded on the Turn
Seat 6: DMQLAmut/l19xN5STQndFg folded on the Turn



PokerStars Game #59938311054:  Hold'em No Limit ($0.25/$0.50) - 2009/07/01 0:11:57 ET
Table 'Vdlc9wqYcHTUhtdyN7CuJw' 2-max Seat #2 is the button
Seat 1: yBO+mXB6m/rCft2ErwGf/Q ($88.85 in chips)
Seat 2: sa0qgETiL3HNbdfGlnKHTA ($23.20 in chips)
sa0qgETiL3HNbdfGlnKHTA: posts small blind $0.25
yBO+mXB6m/rCft2ErwGf/Q: posts big blind $0.50
*** HOLE CARDS ***
sa0qgETiL3HNbdfGlnKHTA: raises $1 to $1.50
yBO+mXB6m/rCft2ErwGf/Q: folds
sa0qgETiL3HNbdfGlnKHTA collected $1 from pot
sa0qgETiL3HNbdfGlnKHTA: doesn't show hand
*** SUMMARY ***
Total pot $1 | Rake $0
Seat 1: yBO+mXB6m/rCft2ErwGf/Q (big blind) folded before Flop
Seat 2: sa0qgETiL3HNbdfGlnKHTA (button) (small blind) collected ($1)



PokerStars Game #59938311140:  Hold'em No Limit ($0.25/$0.50) - 2009/07/01 0:11:57 ET
Table 'YsnnHkamRzYqMOr2FlLY4w' 6-max Seat #1 is the button
Seat 1: crjGpJEzSZgD38FoE3VMGg ($61.90 in chips)
Seat 2: vnRgOasQNKOR7gLXwRQ+ww ($50 in chips)
Seat 4: 7Fue572p4ZIC85AJMQvaQw ($49.90 in chips)
Seat 5: lcQ7uuLf+WLGGy4Ve6VKKA ($41.85 in chips)
Seat 6: YmWlPGOKFuJSoJZPW8a8IA ($50 in chips)
vnRgOasQNKOR7gLXwRQ+ww: posts small blind $0.25
I+pG2m/dD5iYdbg9qx572g: is sitting out
7Fue572p4ZIC85AJMQvaQw: posts big blind $0.50
*** HOLE CARDS ***
I+pG2m/dD5iYdbg9qx572g leaves the table
lcQ7uuLf+WLGGy4Ve6VKKA: calls $0.50
YmWlPGOKFuJSoJZPW8a8IA: folds
crjGpJEzSZgD38FoE3VMGg: folds
vnRgOasQNKOR7gLXwRQ+ww: folds
7Fue572p4ZIC85AJMQvaQw: checks
*** FLOP *** [8h 5c 9c]
7Fue572p4ZIC85AJMQvaQw: bets $0.50
lcQ7uuLf+WLGGy4Ve6VKKA: calls $0.50
*** TURN *** [8h 5c 9c] [5d]
7Fue572p4ZIC85AJMQvaQw: checks
lcQ7uuLf+WLGGy4Ve6VKKA: bets $1
7Fue572p4ZIC85AJMQvaQw: calls $1
*** RIVER *** [8h 5c 9c 5d] [9s]
7Fue572p4ZIC85AJMQvaQw: checks
lcQ7uuLf+WLGGy4Ve6VKKA: checks
*** SHOW DOWN ***
7Fue572p4ZIC85AJMQvaQw: shows [6h 8s] (two pair, Nines and Eights)
lcQ7uuLf+WLGGy4Ve6VKKA: mucks hand
7Fue572p4ZIC85AJMQvaQw collected $4.05 from pot
*** SUMMARY ***
Total pot $4.25 | Rake $0.20
Board [8h 5c 9c 5d 9s]
Seat 1: crjGpJEzSZgD38FoE3VMGg (button) folded before Flop (didn't bet)
Seat 2: vnRgOasQNKOR7gLXwRQ+ww (small blind) folded before Flop
Seat 4: 7Fue572p4ZIC85AJMQvaQw (big blind) showed [6h 8s] and won ($4.05) with two pair, Nines and Eights
Seat 5: lcQ7uuLf+WLGGy4Ve6VKKA mucked
Seat 6: YmWlPGOKFuJSoJZPW8a8IA folded before Flop (didn't bet)



PokerStars Game #59938313670:  Hold'em No Limit ($0.25/$0.50) - 2009/07/01 0:12:01 ET
Table 'mTxf8gPLgffN3Iwfm7Icfg' 2-max Seat #2 is the button
Seat 1: Do9Rlu1R5u/AcRtMTl8SYg ($60.90 in chips)
Seat 2: EMc5LPgVaded4Qc77vm0fw ($52.55 in chips)
EMc5LPgVaded4Qc77vm0fw: posts small blind $0.25
Do9Rlu1R5u/AcRtMTl8SYg: posts big blind $0.50
*** HOLE CARDS ***
EMc5LPgVaded4Qc77vm0fw: calls $0.25
Do9Rlu1R5u/AcRtMTl8SYg: checks
*** FLOP *** [7s 2c 6d]
Do9Rlu1R5u/AcRtMTl8SYg: bets $1
EMc5LPgVaded4Qc77vm0fw: folds
Do9Rlu1R5u/AcRtMTl8SYg collected $0.95 from pot
*** SUMMARY ***
Total pot $1 | Rake $0.05
Board [7s 2c 6d]
Seat 1: Do9Rlu1R5u/AcRtMTl8SYg (big blind) collected ($0.95)
Seat 2: EMc5LPgVaded4Qc77vm0fw (button) (small blind) folded on the Flop



PokerStars Game #59938314236:  Hold'em No Limit ($0.25/$0.50) - 2009/07/01 0:12:02 ET
Table 'E7bWJ45aoFXRpyRv2gw+Ig' 2-max Seat #2 is the button
Seat 1: FRkiRasEGlHUeLrEl+k/nA ($83.85 in chips)
Seat 2: 3Wro85I7472vJ4Wkpneo9A ($39.05 in chips)
3Wro85I7472vJ4Wkpneo9A: posts small blind $0.25
FRkiRasEGlHUeLrEl+k/nA: posts big blind $0.50
*** HOLE CARDS ***
3Wro85I7472vJ4Wkpneo9A: calls $0.25
FRkiRasEGlHUeLrEl+k/nA: raises $2 to $2.50
3Wro85I7472vJ4Wkpneo9A: raises $5 to $7.50
FRkiRasEGlHUeLrEl+k/nA: folds
3Wro85I7472vJ4Wkpneo9A collected $5 from pot
3Wro85I7472vJ4Wkpneo9A: doesn't show hand
*** SUMMARY ***
Total pot $5 | Rake $0
Seat 1: FRkiRasEGlHUeLrEl+k/nA (big blind) folded before Flop
Seat 2: 3Wro85I7472vJ4Wkpneo9A (button) (small blind) collected ($5)



PokerStars Game #59938315118:  Hold'em No Limit ($0.25/$0.50) - 2009/07/01 0:12:03 ET
Table 'm95HVfesC/VPgfGEjPuaIA' 2-max Seat #1 is the button
Seat 1: Fp/oksNpipCrD2MJ2pH20g ($8.50 in chips)
Seat 2: Ag6DvxX4vbRheqsv2zXKTQ ($26.30 in chips)
Fp/oksNpipCrD2MJ2pH20g: posts small blind $0.25
Ag6DvxX4vbRheqsv2zXKTQ: posts big blind $0.50
*** HOLE CARDS ***
Fp/oksNpipCrD2MJ2pH20g: raises $1 to $1.50
Ag6DvxX4vbRheqsv2zXKTQ: calls $1
*** FLOP *** [3h 9d 8c]
Ag6DvxX4vbRheqsv2zXKTQ: checks
Fp/oksNpipCrD2MJ2pH20g: bets $7 and is all-in
Ag6DvxX4vbRheqsv2zXKTQ: calls $7
*** TURN *** [3h 9d 8c] [Jh]
*** RIVER *** [3h 9d 8c Jh] [6s]
*** SHOW DOWN ***
Ag6DvxX4vbRheqsv2zXKTQ: shows [9s Kh] (a pair of Nines)
Fp/oksNpipCrD2MJ2pH20g: shows [7c Tc] (a straight, Seven to Jack)
Fp/oksNpipCrD2MJ2pH20g collected $16.50 from pot
*** SUMMARY ***
Total pot $17 | Rake $0.50
Board [3h 9d 8c Jh 6s]
Seat 1: Fp/oksNpipCrD2MJ2pH20g (button) (small blind) showed [7c Tc] and won ($16.50) with a straight, Seven to Jack
Seat 2: Ag6DvxX4vbRheqsv2zXKTQ (big blind) showed [9s Kh] and lost with a pair of Nines



PokerStars Game #59938315228:  Hold'em No Limit ($0.25/$0.50) - 2009/07/01 0:12:03 ET
Table 'QOgaEqMcJ73pcUMMxoisUg' 6-max Seat #2 is the button
Seat 1: RFefXIDyFvNtJLq+CloCzA ($42.45 in chips)
Seat 2: Im2p1Nt83UKSqv5c9frm4Q ($50 in chips)
Seat 3: wUZNozoIDYf+16hp4nn6dw ($49.10 in chips)
Seat 4: zAcsDhG/T128Vn7XGVSgKg ($50 in chips)
Seat 5: HoaSQCRso+nEyO5DUhGduw ($57.75 in chips)
Seat 6: s83dnhZ6VC53vY0/f6OV/g ($48.50 in chips)
wUZNozoIDYf+16hp4nn6dw: posts small blind $0.25
zAcsDhG/T128Vn7XGVSgKg: posts big blind $0.50
*** HOLE CARDS ***
HoaSQCRso+nEyO5DUhGduw: folds
s83dnhZ6VC53vY0/f6OV/g: folds
RFefXIDyFvNtJLq+CloCzA: folds
HoaSQCRso+nEyO5DUhGduw leaves the table
Im2p1Nt83UKSqv5c9frm4Q: folds
wUZNozoIDYf+16hp4nn6dw: calls $0.25
zAcsDhG/T128Vn7XGVSgKg: checks
*** FLOP *** [5d 6h Qc]
wUZNozoIDYf+16hp4nn6dw: checks
zAcsDhG/T128Vn7XGVSgKg: bets $1
wUZNozoIDYf+16hp4nn6dw: calls $1
*** TURN *** [5d 6h Qc] [7c]
wUZNozoIDYf+16hp4nn6dw: checks
zAcsDhG/T128Vn7XGVSgKg: bets $2.50
wUZNozoIDYf+16hp4nn6dw: calls $2.50
*** RIVER *** [5d 6h Qc 7c] [Kc]
wUZNozoIDYf+16hp4nn6dw: checks
zAcsDhG/T128Vn7XGVSgKg: bets $7
wUZNozoIDYf+16hp4nn6dw: calls $7
*** SHOW DOWN ***
zAcsDhG/T128Vn7XGVSgKg: shows [3c 4h] (a straight, Three to Seven)
wUZNozoIDYf+16hp4nn6dw: mucks hand
zAcsDhG/T128Vn7XGVSgKg collected $20.95 from pot
*** SUMMARY ***
Total pot $22 | Rake $1.05
Board [5d 6h Qc 7c Kc]
Seat 1: RFefXIDyFvNtJLq+CloCzA folded before Flop (didn't bet)
Seat 2: Im2p1Nt83UKSqv5c9frm4Q (button) folded before Flop (didn't bet)
Seat 3: wUZNozoIDYf+16hp4nn6dw (small blind) mucked
Seat 4: zAcsDhG/T128Vn7XGVSgKg (big blind) showed [3c 4h] and won ($20.95) with a straight, Three to Seven
Seat 5: HoaSQCRso+nEyO5DUhGduw folded before Flop (didn't bet)
Seat 6: s83dnhZ6VC53vY0/f6OV/g folded before Flop (didn't bet)



PokerStars Game #59938316966:  Hold'em No Limit ($0.25/$0.50) - 2009/07/01 0:12:06 ET
Table '37qXEp3oe+er5q4CZip9eQ' 6-max Seat #6 is the button
Seat 1: oqOqoO2AyCZenUghCxMDxw ($50 in chips)
Seat 2: g12O9qXTybyo2C0B2bXgjg ($27.65 in chips)
Seat 3: Rt6KgtZ8YaJoTc3FPim00w ($98.10 in chips)
Seat 4: L0aIPg7qefDQjdJo3HCVEA ($20.25 in chips)
Seat 5: VOmI0x4dDPnTESZd5B4d1Q ($39.75 in chips)
Seat 6: f7zPpUQp9hHZgqhEvrUWQw ($55.15 in chips)
oqOqoO2AyCZenUghCxMDxw: posts small blind $0.25
g12O9qXTybyo2C0B2bXgjg: posts big blind $0.50
*** HOLE CARDS ***
Rt6KgtZ8YaJoTc3FPim00w: raises $1 to $1.50
L0aIPg7qefDQjdJo3HCVEA: folds
VOmI0x4dDPnTESZd5B4d1Q: folds
f7zPpUQp9hHZgqhEvrUWQw: calls $1.50
oqOqoO2AyCZenUghCxMDxw: folds
g12O9qXTybyo2C0B2bXgjg: folds
*** FLOP *** [2c 8d 2s]
Rt6KgtZ8YaJoTc3FPim00w: bets $2.50
f7zPpUQp9hHZgqhEvrUWQw: folds
Rt6KgtZ8YaJoTc3FPim00w collected $3.60 from pot
*** SUMMARY ***
Total pot $3.75 | Rake $0.15
Board [2c 8d 2s]
Seat 1: oqOqoO2AyCZenUghCxMDxw (small blind) folded before Flop
Seat 2: g12O9qXTybyo2C0B2bXgjg (big blind) folded before Flop
Seat 3: Rt6KgtZ8YaJoTc3FPim00w collected ($3.60)
Seat 4: L0aIPg7qefDQjdJo3HCVEA folded before Flop (didn't bet)
Seat 5: VOmI0x4dDPnTESZd5B4d1Q folded before Flop (didn't bet)
Seat 6: f7zPpUQp9hHZgqhEvrUWQw (button) folded on the Flop



PokerStars Game #59938316952:  Hold'em No Limit ($0.25/$0.50) - 2009/07/01 0:12:06 ET
Table 'c/CRn+68J3Y8KxD5g1ek2Q' 2-max Seat #1 is the button
Seat 1: 46qCyJ6evTkHo9al5sBMNA ($324.25 in chips)
Seat 2: BypVLsYQt3ePFm2xQL/dOA ($61.20 in chips)
46qCyJ6evTkHo9al5sBMNA: posts small blind $0.25
BypVLsYQt3ePFm2xQL/dOA: posts big blind $0.50
*** HOLE CARDS ***
46qCyJ6evTkHo9al5sBMNA: folds
BypVLsYQt3ePFm2xQL/dOA collected $0.50 from pot
BypVLsYQt3ePFm2xQL/dOA: doesn't show hand
*** SUMMARY ***
Total pot $0.50 | Rake $0
Seat 1: 46qCyJ6evTkHo9al5sBMNA (button) (small blind) folded before Flop
Seat 2: BypVLsYQt3ePFm2xQL/dOA (big blind) collected ($0.50)



PokerStars Game #59938317776:  Hold'em No Limit ($0.25/$0.50) - 2009/07/01 0:12:07 ET
Table 'Vdlc9wqYcHTUhtdyN7CuJw' 2-max Seat #1 is the button
Seat 1: yBO+mXB6m/rCft2ErwGf/Q ($88.35 in chips)
Seat 2: sa0qgETiL3HNbdfGlnKHTA ($23.70 in chips)
yBO+mXB6m/rCft2ErwGf/Q: posts small blind $0.25
sa0qgETiL3HNbdfGlnKHTA: posts big blind $0.50
*** HOLE CARDS ***
yBO+mXB6m/rCft2ErwGf/Q: calls $0.25
sa0qgETiL3HNbdfGlnKHTA: checks
*** FLOP *** [Jc Tc 4d]
sa0qgETiL3HNbdfGlnKHTA: bets $1.50
yBO+mXB6m/rCft2ErwGf/Q: folds
sa0qgETiL3HNbdfGlnKHTA collected $0.95 from pot
sa0qgETiL3HNbdfGlnKHTA: doesn't show hand
*** SUMMARY ***
Total pot $1 | Rake $0.05
Board [Jc Tc 4d]
Seat 1: yBO+mXB6m/rCft2ErwGf/Q (button) (small blind) folded on the Flop
Seat 2: sa0qgETiL3HNbdfGlnKHTA (big blind) collected ($0.95)



PokerStars Game #59938319242:  Hold'em No Limit ($0.25/$0.50) - 2009/07/01 0:12:09 ET
Table 'QOgaEqMcJ73pcUMMxoisUgErOuyGLI5PT3G5MnpHgC/g Seat #6 is the button
Seat 1: k6GJzKs7T7qvQggW9g8Pdw ($56.90 in chips)
Seat 2: RjBdQ6w31rgcy0o24VLR6w ($10.95 in chips)
Seat 3: xZCXQSXlrZkp3pZizzVXCw ($50.50 in chips)
Seat 4: U7aZzIYWjv3SL30KtikLbw ($47.45 in chips)
Seat 5: JwvquocWfhTVApN5t47LgA ($44.05 in chips)
Seat 6: zE9cVigS2nW/Ljy4K4bUQA ($30 in chips)
Seat 7: 90Wb75h3W1BRpbqVnuk8gw ($68.20 in chips)
Seat 8: g4k0NXISyLCqaSWZDBjfEg ($50 in chips)
Seat 9: J0W5D97jl5VLky+IoPvDeA ($67.80 in chips)
90Wb75h3W1BRpbqVnuk8gw: posts small blind $0.25
g4k0NXISyLCqaSWZDBjfEg: posts big blind $0.50
*** HOLE CARDS ***
J0W5D97jl5VLky+IoPvDeA: folds
k6GJzKs7T7qvQggW9g8Pdw has timed out
k6GJzKs7T7qvQggW9g8Pdw: folds
k6GJzKs7T7qvQggW9g8Pdw is sitting out
RjBdQ6w31rgcy0o24VLR6w: folds
xZCXQSXlrZkp3pZizzVXCw: folds
U7aZzIYWjv3SL30KtikLbw: raises $1 to $1.50
JwvquocWfhTVApN5t47LgA: folds
zE9cVigS2nW/Ljy4K4bUQA: folds
90Wb75h3W1BRpbqVnuk8gw: folds
g4k0NXISyLCqaSWZDBjfEg: folds
k6GJzKs7T7qvQggW9g8Pdw has returned
U7aZzIYWjv3SL30KtikLbw collected $1.25 from pot
*** SUMMARY ***
Total pot $1.25 | Rake $0
Seat 1: k6GJzKs7T7qvQggW9g8Pdw folded before Flop (didn't bet)
Seat 2: RjBdQ6w31rgcy0o24VLR6w folded before Flop (didn't bet)
Seat 3: xZCXQSXlrZkp3pZizzVXCw folded before Flop (didn't bet)
Seat 4: U7aZzIYWjv3SL30KtikLbw collected ($1.25)
Seat 5: JwvquocWfhTVApN5t47LgA folded before Flop (didn't bet)
Seat 6: zE9cVigS2nW/Ljy4K4bUQA (button) folded before Flop (didn't bet)
Seat 7: 90Wb75h3W1BRpbqVnuk8gw (small blind) folded before Flop
Seat 8: g4k0NXISyLCqaSWZDBjfEg (big blind) folded before Flop
Seat 9: J0W5D97jl5VLky+IoPvDeA folded before Flop (didn't bet)



PokerStars Game #59938319910:  Hold'em No Limit ($0.25/$0.50) - 2009/07/01 0:12:10 ET
Table '3FhG0gl3kMX3wBEEqj+wnQ' 9-max Seat #5 is the button
Seat 1: e0J9pdCNUDTCG031RnXqLA ($25.45 in chips)
Seat 2: 4dl3YNqZ6Houm2jZAzDmRg ($25.75 in chips)
Seat 3: bXpVeaSTPBFSPJmeXxO7nw ($10 in chips)
Seat 4: bz4LMfV0GGl/MJ/ABXuPmg ($14.40 in chips)
Seat 5: XNMDwbXt/Q4jM99AXnbJDw ($49.25 in chips)
Seat 6: 5JJVDlaiMnB004o/RqbZZQ ($26.25 in chips)
Seat 8: j3K/Jujr7PY4ZM2RZvlH6A ($57.35 in chips)
Seat 9: tzoXBDwkkPV/XPJPkf963Q ($13.80 in chips)
5JJVDlaiMnB004o/RqbZZQ: posts small blind $0.25
6XkTu4ahxzHnvjjc1R8YjQ: is sitting out
j3K/Jujr7PY4ZM2RZvlH6A: posts big blind $0.50
*** HOLE CARDS ***
tzoXBDwkkPV/XPJPkf963Q: folds
e0J9pdCNUDTCG031RnXqLA: folds
4dl3YNqZ6Houm2jZAzDmRg: folds
bXpVeaSTPBFSPJmeXxO7nw: folds
bz4LMfV0GGl/MJ/ABXuPmg: folds
XNMDwbXt/Q4jM99AXnbJDw: raises $0.50 to $1
5JJVDlaiMnB004o/RqbZZQ: folds
6XkTu4ahxzHnvjjc1R8YjQ leaves the table
j3K/Jujr7PY4ZM2RZvlH6A: raises $3.50 to $4.50
mSD1pginDsyHG5PDfqzphw joins the table at seat #7
XNMDwbXt/Q4jM99AXnbJDw: folds
j3K/Jujr7PY4ZM2RZvlH6A collected $2.25 from pot
j3K/Jujr7PY4ZM2RZvlH6A: doesn't show hand
*** SUMMARY ***
Total pot $2.25 | Rake $0
Seat 1: e0J9pdCNUDTCG031RnXqLA folded before Flop (didn't bet)
Seat 2: 4dl3YNqZ6Houm2jZAzDmRg folded before Flop (didn't bet)
Seat 3: bXpVeaSTPBFSPJmeXxO7nw folded before Flop (didn't bet)
Seat 4: bz4LMfV0GGl/MJ/ABXuPmg folded before Flop (didn't bet)
Seat 5: XNMDwbXt/Q4jM99AXnbJDw (button) folded before Flop
Seat 6: 5JJVDlaiMnB004o/RqbZZQ (small blind) folded before Flop
Seat 8: j3K/Jujr7PY4ZM2RZvlH6A (big blind) collected ($2.25)
Seat 9: tzoXBDwkkPV/XPJPkf963Q folded before Flop (didn't bet)



PokerStars Game #59938323226:  Hold'em No Limit ($0.25/$0.50) - 2009/07/01 0:12:14 ET
Table 'mTxf8gPLgffN3Iwfm7Icfg' 2-max Seat #1 is the button
Seat 1: Do9Rlu1R5u/AcRtMTl8SYg ($61.35 in chips)
Seat 2: EMc5LPgVaded4Qc77vm0fw ($52.05 in chips)
Do9Rlu1R5u/AcRtMTl8SYg: posts small blind $0.25
EMc5LPgVaded4Qc77vm0fw: posts big blind $0.50
*** HOLE CARDS ***
Do9Rlu1R5u/AcRtMTl8SYg: calls $0.25
EMc5LPgVaded4Qc77vm0fw: raises $1.50 to $2
Do9Rlu1R5u/AcRtMTl8SYg: folds
EMc5LPgVaded4Qc77vm0fw collected $1 from pot
EMc5LPgVaded4Qc77vm0fw: doesn't show hand
*** SUMMARY ***
Total pot $1 | Rake $0
Seat 1: Do9Rlu1R5u/AcRtMTl8SYg (button) (small blind) folded before Flop
Seat 2: EMc5LPgVaded4Qc77vm0fw (big blind) collected ($1)



PokerStars Game #59938322954:  Hold'em No Limit ($0.25/$0.50) - 2009/07/01 0:12:14 ET
Table 'c/CRn+68J3Y8KxD5g1ek2Q' 2-max Seat #2 is the button
Seat 1: 46qCyJ6evTkHo9al5sBMNA ($324 in chips)
Seat 2: BypVLsYQt3ePFm2xQL/dOA ($61.45 in chips)
BypVLsYQt3ePFm2xQL/dOA: posts small blind $0.25
46qCyJ6evTkHo9al5sBMNA: posts big blind $0.50
*** HOLE CARDS ***
BypVLsYQt3ePFm2xQL/dOA: raises $2 to $2.50
46qCyJ6evTkHo9al5sBMNA: calls $2
*** FLOP *** [Qc Kc Qh]
46qCyJ6evTkHo9al5sBMNA: checks
BypVLsYQt3ePFm2xQL/dOA: bets $4.50
46qCyJ6evTkHo9al5sBMNA: calls $4.50
*** TURN *** [Qc Kc Qh] [9c]
46qCyJ6evTkHo9al5sBMNA: checks
BypVLsYQt3ePFm2xQL/dOA: checks
*** RIVER *** [Qc Kc Qh 9c] [5c]
46qCyJ6evTkHo9al5sBMNA: checks
BypVLsYQt3ePFm2xQL/dOA: bets $10.50
46qCyJ6evTkHo9al5sBMNA: folds
BypVLsYQt3ePFm2xQL/dOA collected $13.50 from pot
BypVLsYQt3ePFm2xQL/dOA: doesn't show hand
*** SUMMARY ***
Total pot $14 | Rake $0.50
Board [Qc Kc Qh 9c 5c]
Seat 1: 46qCyJ6evTkHo9al5sBMNA (big blind) folded on the River
Seat 2: BypVLsYQt3ePFm2xQL/dOA (button) (small blind) collected ($13.50)



PokerStars Game #59938322850:  Hold'em No Limit ($0.25/$0.50) - 2009/07/01 0:12:14 ET
Table 'X6IRCRTh+20gjz8aubWnwA' 9-max Seat #6 is the button
Seat 1: YPo1oggovmqSREegekaQYw ($9.45 in chips)
Seat 2: RjBdQ6w31rgcy0o24VLR6w ($11.65 in chips)
Seat 3: mSD1pginDsyHG5PDfqzphw ($10 in chips)
Seat 4: uw9QayAAxLM3Hb+HR7mSkg ($10.25 in chips)
Seat 5: L5e2lrPLQm1Pqx30IIZ/Fw ($11.25 in chips)
Seat 6: /6In1zC3WtgwxDcueWzZWg ($56.95 in chips)
Seat 7: VBnpbzn0dIveV55qKvciew ($56.20 in chips)
Seat 8: BPMN9sOItJw6vWq3kypaYg ($29.25 in chips)
Seat 9: M+7+BTmX5vZatHVuoRB1nA ($84.10 in chips)
VBnpbzn0dIveV55qKvciew: posts small blind $0.25
BPMN9sOItJw6vWq3kypaYg: posts big blind $0.50
*** HOLE CARDS ***
M+7+BTmX5vZatHVuoRB1nA: folds
YPo1oggovmqSREegekaQYw: folds
RjBdQ6w31rgcy0o24VLR6w: folds
mSD1pginDsyHG5PDfqzphw: folds
uw9QayAAxLM3Hb+HR7mSkg: folds
L5e2lrPLQm1Pqx30IIZ/Fw: raises $1 to $1.50
/6In1zC3WtgwxDcueWzZWg: folds
VBnpbzn0dIveV55qKvciew: folds
BPMN9sOItJw6vWq3kypaYg: calls $1
*** FLOP *** [Jh Qd 8c]
BPMN9sOItJw6vWq3kypaYg: checks
L5e2lrPLQm1Pqx30IIZ/Fw: checks
*** TURN *** [Jh Qd 8c] [Js]
BPMN9sOItJw6vWq3kypaYg: checks
L5e2lrPLQm1Pqx30IIZ/Fw: bets $2
BPMN9sOItJw6vWq3kypaYg: folds
L5e2lrPLQm1Pqx30IIZ/Fw collected $3.10 from pot
*** SUMMARY ***
Total pot $3.25 | Rake $0.15
Board [Jh Qd 8c Js]
Seat 1: YPo1oggovmqSREegekaQYw folded before Flop (didn't bet)
Seat 2: RjBdQ6w31rgcy0o24VLR6w folded before Flop (didn't bet)
Seat 3: mSD1pginDsyHG5PDfqzphw folded before Flop (didn't bet)
Seat 4: uw9QayAAxLM3Hb+HR7mSkg folded before Flop (didn't bet)
Seat 5: L5e2lrPLQm1Pqx30IIZ/Fw collected ($3.10)
Seat 6: /6In1zC3WtgwxDcueWzZWg (button) folded before Flop (didn't bet)
Seat 7: VBnpbzn0dIveV55qKvciew (small blind) folded before Flop
Seat 8: BPMN9sOItJw6vWq3kypaYg (big blind) folded on the Turn
Seat 9: M+7+BTmX5vZatHVuoRB1nA folded before Flop (didn't bet)



PokerStars Game #59938324990:  Hold'em No Limit ($0.25/$0.50) - 2009/07/01 0:12:17 ET
Table 'MJxeZCzYELxiIsyUZyT0jw' 6-max Seat #2 is the button
Seat 1: iKPos8JI094Tomq4tDSgnQ ($34.05 in chips)
Seat 2: r6H1GiZ6QIpMTDhyodKuRQ ($64.15 in chips)
Seat 3: JQZew0FjzS19kTjeNtrE+A ($50.25 in chips)
Seat 4: lP7Q6pewz4C2RsAfKsjdWw ($23.60 in chips)
Seat 5: 3jvoOXNtXE90w2BdfNZwZQ ($53.50 in chips)
Seat 6: TTx3CHxyi0SObcHyMJRp5w ($42.70 in chips)
JQZew0FjzS19kTjeNtrE+A: posts small blind $0.25
lP7Q6pewz4C2RsAfKsjdWw: posts big blind $0.50
*** HOLE CARDS ***
3jvoOXNtXE90w2BdfNZwZQ: raises $1.50 to $2
TTx3CHxyi0SObcHyMJRp5w: calls $2
iKPos8JI094Tomq4tDSgnQ: folds
r6H1GiZ6QIpMTDhyodKuRQ: folds
JQZew0FjzS19kTjeNtrE+A: folds
lP7Q6pewz4C2RsAfKsjdWw: folds
*** FLOP *** [7d 8c 8d]
3jvoOXNtXE90w2BdfNZwZQ: checks
TTx3CHxyi0SObcHyMJRp5w: checks
*** TURN *** [7d 8c 8d] [4d]
3jvoOXNtXE90w2BdfNZwZQ: checks
TTx3CHxyi0SObcHyMJRp5w: bets $2
3jvoOXNtXE90w2BdfNZwZQ: calls $2
*** RIVER *** [7d 8c 8d 4d] [6c]
3jvoOXNtXE90w2BdfNZwZQ: checks
TTx3CHxyi0SObcHyMJRp5w: bets $2.50
3jvoOXNtXE90w2BdfNZwZQ: calls $2.50
*** SHOW DOWN ***
TTx3CHxyi0SObcHyMJRp5w: shows [Ks Kd] (two pair, Kings and Eights)
3jvoOXNtXE90w2BdfNZwZQ: mucks hand
TTx3CHxyi0SObcHyMJRp5w collected $13.10 from pot
*** SUMMARY ***
Total pot $13.75 | Rake $0.65
Board [7d 8c 8d 4d 6c]
Seat 1: iKPos8JI094Tomq4tDSgnQ folded before Flop (didn't bet)
Seat 2: r6H1GiZ6QIpMTDhyodKuRQ (button) folded before Flop (didn't bet)
Seat 3: JQZew0FjzS19kTjeNtrE+A (small blind) folded before Flop
Seat 4: lP7Q6pewz4C2RsAfKsjdWw (big blind) folded before Flop
Seat 5: 3jvoOXNtXE90w2BdfNZwZQ mucked
Seat 6: TTx3CHxyi0SObcHyMJRp5w showed [Ks Kd] and won ($13.10) with two pair, Kings and Eights



PokerStars Game #59938329020:  Hold'em No Limit ($0.25/$0.50) - 2009/07/01 0:12:23 ET
Table 'kgbJRsxfv64KrErDRBAkcw' 6-max Seat #2 is the button
Seat 1: YmWlPGOKFuJSoJZPW8a8IA ($79.80 in chips)
Seat 2: Q+thC23WCv1kJUJtH/+4Jw ($31.20 in chips)
Seat 3: T0Gx/FcQ5VH9u7XaOMX97A ($65.50 in chips)
Seat 4: qanMEqjABjWxC/JgQ/0l7w ($63.45 in chips)
Seat 5: +Pf9jTVizYlIo+woPvptfA ($50 in chips)
Seat 6: DDfYzIrYT0t5R/hAJngtsg ($20.35 in chips)
T0Gx/FcQ5VH9u7XaOMX97A: posts small blind $0.25
qanMEqjABjWxC/JgQ/0l7w: posts big blind $0.50
*** HOLE CARDS ***
+Pf9jTVizYlIo+woPvptfA: folds
DDfYzIrYT0t5R/hAJngtsg: calls $0.50
YmWlPGOKFuJSoJZPW8a8IA: folds
Q+thC23WCv1kJUJtH/+4Jw: folds
T0Gx/FcQ5VH9u7XaOMX97A: folds
qanMEqjABjWxC/JgQ/0l7w: checks
*** FLOP *** [Kd 4s 4d]
qanMEqjABjWxC/JgQ/0l7w: checks
DDfYzIrYT0t5R/hAJngtsg: checks
*** TURN *** [Kd 4s 4d] [9s]
qanMEqjABjWxC/JgQ/0l7w: checks
DDfYzIrYT0t5R/hAJngtsg: bets $0.50
qanMEqjABjWxC/JgQ/0l7w: folds
DDfYzIrYT0t5R/hAJngtsg collected $1.20 from pot
DDfYzIrYT0t5R/hAJngtsg: doesn't show hand
*** SUMMARY ***
Total pot $1.25 | Rake $0.05
Board [Kd 4s 4d 9s]
Seat 1: YmWlPGOKFuJSoJZPW8a8IA folded before Flop (didn't bet)
Seat 2: Q+thC23WCv1kJUJtH/+4Jw (button) folded before Flop (didn't bet)
Seat 3: T0Gx/FcQ5VH9u7XaOMX97A (small blind) folded before Flop
Seat 4: qanMEqjABjWxC/JgQ/0l7w (big blind) folded on the Turn
Seat 5: +Pf9jTVizYlIo+woPvptfA folded before Flop (didn't bet)
Seat 6: DDfYzIrYT0t5R/hAJngtsg collected ($1.20)



PokerStars Game #59938330006:  Hold'em No Limit ($0.25/$0.50) - 2009/07/01 0:12:24 ET
Table 'm95HVfesC/VPgfGEjPuaIA' 2-max Seat #2 is the button
Seat 1: Fp/oksNpipCrD2MJ2pH20g ($16.50 in chips)
Seat 2: Ag6DvxX4vbRheqsv2zXKTQ ($17.80 in chips)
Ag6DvxX4vbRheqsv2zXKTQ: posts small blind $0.25
Fp/oksNpipCrD2MJ2pH20g: posts big blind $0.50
*** HOLE CARDS ***
Ag6DvxX4vbRheqsv2zXKTQ: folds
Fp/oksNpipCrD2MJ2pH20g collected $0.50 from pot
Fp/oksNpipCrD2MJ2pH20g: doesn't show hand
*** SUMMARY ***
Total pot $0.50 | Rake $0
Seat 1: Fp/oksNpipCrD2MJ2pH20g (big blind) collected ($0.50)
Seat 2: Ag6DvxX4vbRheqsv2zXKTQ (button) (small blind) folded before Flop



PokerStars Game #59938330388:  Hold'em No Limit ($0.25/$0.50) - 2009/07/01 0:12:25 ET
Table 'E7bWJ45aoFXRpyRv2gw+Ig' 2-max Seat #1 is the button
Seat 1: FRkiRasEGlHUeLrEl+k/nA ($81.35 in chips)
Seat 2: 3Wro85I7472vJ4Wkpneo9A ($41.55 in chips)
FRkiRasEGlHUeLrEl+k/nA: posts small blind $0.25
3Wro85I7472vJ4Wkpneo9A: posts big blind $0.50
*** HOLE CARDS ***
FRkiRasEGlHUeLrEl+k/nA: folds
3Wro85I7472vJ4Wkpneo9A collected $0.50 from pot
3Wro85I7472vJ4Wkpneo9A: doesn't show hand
*** SUMMARY ***
Total pot $0.50 | Rake $0
Seat 1: FRkiRasEGlHUeLrEl+k/nA (button) (small blind) folded before Flop
Seat 2: 3Wro85I7472vJ4Wkpneo9A (big blind) collected ($0.50)



PokerStars Game #59938331958:  Hold'em No Limit ($0.25/$0.50) - 2009/07/01 0:12:27 ET
Table 'Vdlc9wqYcHTUhtdyN7CuJw' 2-max Seat #2 is the button
Seat 1: yBO+mXB6m/rCft2ErwGf/Q ($87.85 in chips)
Seat 2: sa0qgETiL3HNbdfGlnKHTA ($24.15 in chips)
sa0qgETiL3HNbdfGlnKHTA: posts small blind $0.25
yBO+mXB6m/rCft2ErwGf/Q: posts big blind $0.50
*** HOLE CARDS ***
sa0qgETiL3HNbdfGlnKHTA: folds
yBO+mXB6m/rCft2ErwGf/Q collected $0.50 from pot
*** SUMMARY ***
Total pot $0.50 | Rake $0
Seat 1: yBO+mXB6m/rCft2ErwGf/Q (big blind) collected ($0.50)
Seat 2: sa0qgETiL3HNbdfGlnKHTA (button) (small blind) folded before Flop



PokerStars Game #59938332144:  Hold'em No Limit ($0.25/$0.50) - 2009/07/01 0:12:27 ET
Table 'raOT4/ipuZgzjfKHC+jD9g' 2-max Seat #2 is the button
Seat 1: IuwLemwLhc9fvrwBGs0AMA ($12.25 in chips)
Seat 2: Udr5juWSWUgTu1NlRhjMdA ($10.75 in chips)
Udr5juWSWUgTu1NlRhjMdA: posts small blind $0.25
IuwLemwLhc9fvrwBGs0AMA: posts big blind $0.50
*** HOLE CARDS ***
Udr5juWSWUgTu1NlRhjMdA: raises $0.50 to $1
IuwLemwLhc9fvrwBGs0AMA: folds
Udr5juWSWUgTu1NlRhjMdA collected $1 from pot
Udr5juWSWUgTu1NlRhjMdA: doesn't show hand
*** SUMMARY ***
Total pot $1 | Rake $0
Seat 1: IuwLemwLhc9fvrwBGs0AMA (big blind) folded before Flop
Seat 2: Udr5juWSWUgTu1NlRhjMdA (button) (small blind) collected ($1)



PokerStars Game #59938334442:  Hold'em No Limit ($0.25/$0.50) - 2009/07/01 0:12:30 ET
Table 'mTxf8gPLgffN3Iwfm7Icfg' 2-max Seat #2 is the button
Seat 1: Do9Rlu1R5u/AcRtMTl8SYg ($60.85 in chips)
Seat 2: EMc5LPgVaded4Qc77vm0fw ($52.55 in chips)
EMc5LPgVaded4Qc77vm0fw: posts small blind $0.25
Do9Rlu1R5u/AcRtMTl8SYg: posts big blind $0.50
*** HOLE CARDS ***
EMc5LPgVaded4Qc77vm0fw: raises $1 to $1.50
Do9Rlu1R5u/AcRtMTl8SYg: folds
EMc5LPgVaded4Qc77vm0fw collected $1 from pot
EMc5LPgVaded4Qc77vm0fw: doesn't show hand
*** SUMMARY ***
Total pot $1 | Rake $0
Seat 1: Do9Rlu1R5u/AcRtMTl8SYg (big blind) folded before Flop
Seat 2: EMc5LPgVaded4Qc77vm0fw (button) (small blind) collected ($1)



PokerStars Game #59938334414:  Hold'em No Limit ($0.25/$0.50) - 2009/07/01 0:12:30 ET
Table 'm95HVfesC/VPgfGEjPuaIA' 2-max Seat #1 is the button
Seat 1: Fp/oksNpipCrD2MJ2pH20g ($16.75 in chips)
Seat 2: Ag6DvxX4vbRheqsv2zXKTQ ($17.55 in chips)
Fp/oksNpipCrD2MJ2pH20g: posts small blind $0.25
Ag6DvxX4vbRheqsv2zXKTQ: posts big blind $0.50
*** HOLE CARDS ***
Fp/oksNpipCrD2MJ2pH20g: calls $0.25
Ag6DvxX4vbRheqsv2zXKTQ: checks
*** FLOP *** [Qs 3s 2c]
Ag6DvxX4vbRheqsv2zXKTQ: checks
Fp/oksNpipCrD2MJ2pH20g: checks
*** TURN *** [Qs 3s 2c] [Ah]
Ag6DvxX4vbRheqsv2zXKTQ: checks
Fp/oksNpipCrD2MJ2pH20g: checks
*** RIVER *** [Qs 3s 2c Ah] [Kc]
Ag6DvxX4vbRheqsv2zXKTQ: checks
Fp/oksNpipCrD2MJ2pH20g: checks
*** SHOW DOWN ***
Ag6DvxX4vbRheqsv2zXKTQ: shows [4d Td] (high card Ace)
Fp/oksNpipCrD2MJ2pH20g: shows [7d Jd] (high card Ace - King+Queen+Jack kicker)
Fp/oksNpipCrD2MJ2pH20g collected $0.95 from pot
*** SUMMARY ***
Total pot $1 | Rake $0.05
Board [Qs 3s 2c Ah Kc]
Seat 1: Fp/oksNpipCrD2MJ2pH20g (button) (small blind) showed [7d Jd] and won ($0.95) with high card Ace
Seat 2: Ag6DvxX4vbRheqsv2zXKTQ (big blind) showed [4d Td] and lost with high card Ace



PokerStars Game #59938334772:  Hold'em No Limit ($0.25/$0.50) - 2009/07/01 0:12:31 ET
Table 'E7bWJ45aoFXRpyRv2gw+Ig' 2-max Seat #2 is the button
Seat 1: FRkiRasEGlHUeLrEl+k/nA ($81.10 in chips)
Seat 2: 3Wro85I7472vJ4Wkpneo9A ($41.80 in chips)
3Wro85I7472vJ4Wkpneo9A: posts small blind $0.25
FRkiRasEGlHUeLrEl+k/nA: posts big blind $0.50
*** HOLE CARDS ***
3Wro85I7472vJ4Wkpneo9A: folds
FRkiRasEGlHUeLrEl+k/nA collected $0.50 from pot
FRkiRasEGlHUeLrEl+k/nA: doesn't show hand
*** SUMMARY ***
Total pot $0.50 | Rake $0
Seat 1: FRkiRasEGlHUeLrEl+k/nA (big blind) collected ($0.50)
Seat 2: 3Wro85I7472vJ4Wkpneo9A (button) (small blind) folded before Flop



PokerStars Game #59938335604:  Hold'em No Limit ($0.25/$0.50) - 2009/07/01 0:12:32 ET
Table '+dXkOAQyS8j9PQZusUTMpg' 2-max Seat #1 is the button
Seat 1: XFa6sBGjP2gxoIvxR3fZIg ($85.20 in chips)
Seat 2: 5IBeOgaApY1Bvzv2P8X4EA ($26.95 in chips)
XFa6sBGjP2gxoIvxR3fZIg: posts small blind $0.25
5IBeOgaApY1Bvzv2P8X4EA: posts big blind $0.50
*** HOLE CARDS ***
5IBeOgaApY1Bvzv2P8X4EA said, "hahahahahahahaha"
XFa6sBGjP2gxoIvxR3fZIg: raises $1 to $1.50
5IBeOgaApY1Bvzv2P8X4EA: folds
XFa6sBGjP2gxoIvxR3fZIg collected $1 from pot
*** SUMMARY ***
Total pot $1 | Rake $0
Seat 1: XFa6sBGjP2gxoIvxR3fZIg (button) (small blind) collected ($1)
Seat 2: 5IBeOgaApY1Bvzv2P8X4EA (big blind) folded before Flop



PokerStars Game #59938335898:  Hold'em No Limit ($0.25/$0.50) - 2009/07/01 0:12:33 ET
Table 'Vdlc9wqYcHTUhtdyN7CuJw' 2-max Seat #1 is the button
Seat 1: yBO+mXB6m/rCft2ErwGf/Q ($88.10 in chips)
Seat 2: sa0qgETiL3HNbdfGlnKHTA ($23.90 in chips)
yBO+mXB6m/rCft2ErwGf/Q: posts small blind $0.25
sa0qgETiL3HNbdfGlnKHTA: posts big blind $0.50
*** HOLE CARDS ***
yBO+mXB6m/rCft2ErwGf/Q: raises $1.50 to $2
sa0qgETiL3HNbdfGlnKHTA: calls $1.50
*** FLOP *** [Th 2c 5s]
sa0qgETiL3HNbdfGlnKHTA: checks
yBO+mXB6m/rCft2ErwGf/Q: bets $1
sa0qgETiL3HNbdfGlnKHTA: calls $1
*** TURN *** [Th 2c 5s] [Js]
sa0qgETiL3HNbdfGlnKHTA: checks
yBO+mXB6m/rCft2ErwGf/Q: bets $2
sa0qgETiL3HNbdfGlnKHTA: calls $2
*** RIVER *** [Th 2c 5s Js] [8h]
sa0qgETiL3HNbdfGlnKHTA: checks
yBO+mXB6m/rCft2ErwGf/Q: checks
*** SHOW DOWN ***
sa0qgETiL3HNbdfGlnKHTA: shows [Jc Qd] (a pair of Jacks)
yBO+mXB6m/rCft2ErwGf/Q: mucks hand
sa0qgETiL3HNbdfGlnKHTA collected $9.55 from pot
*** SUMMARY ***
Total pot $10 | Rake $0.45
Board [Th 2c 5s Js 8h]
Seat 1: yBO+mXB6m/rCft2ErwGf/Q (button) (small blind) mucked
Seat 2: sa0qgETiL3HNbdfGlnKHTA (big blind) showed [Jc Qd] and won ($9.55) with a pair of Jacks



PokerStars Game #59938336474:  Hold'em No Limit ($0.25/$0.50) - 2009/07/01 0:12:33 ET
Table 'PALRfuH85dr5IkDfdv6new' 9-max Seat #6 is the button
Seat 1: SKnJuWHScqetA/qG5p+wCg ($33 in chips)
Seat 2: 9r7ZoBbAJj5IeyZ0q9BdzA ($13.90 in chips)
Seat 3: 50QWoELmpmHFrFIlWMJo9g ($94.20 in chips)
Seat 4: /gaxz7F0MIjSN3t7ZPKwAA ($37.10 in chips)
Seat 5: jSSGUXdNFAZA3QCvTcUMQw ($43 in chips)
Seat 6: EiWj2MAl8RNcPhTkzz24Mw ($26.90 in chips)
Seat 7: 3NcyXvr39gnK+KbTq7ezyA ($34.35 in chips)
Seat 8: NkS+CseUKx4XHszWq0PXEQ ($43.10 in chips)
Seat 9: CIrAX/m6o7jYmKOAjJXv4Q ($38.90 in chips)
3NcyXvr39gnK+KbTq7ezyA: posts small blind $0.25
NkS+CseUKx4XHszWq0PXEQ: posts big blind $0.50
*** HOLE CARDS ***
CIrAX/m6o7jYmKOAjJXv4Q: calls $0.50
SKnJuWHScqetA/qG5p+wCg: folds
9r7ZoBbAJj5IeyZ0q9BdzA: folds
50QWoELmpmHFrFIlWMJo9g: folds
/gaxz7F0MIjSN3t7ZPKwAA: folds
jSSGUXdNFAZA3QCvTcUMQw: folds
EiWj2MAl8RNcPhTkzz24Mw: folds
3NcyXvr39gnK+KbTq7ezyA: folds
NkS+CseUKx4XHszWq0PXEQ: checks
*** FLOP *** [Ts 3h 8h]
NkS+CseUKx4XHszWq0PXEQ: checks
CIrAX/m6o7jYmKOAjJXv4Q: checks
*** TURN *** [Ts 3h 8h] [8s]
NkS+CseUKx4XHszWq0PXEQ: checks
CIrAX/m6o7jYmKOAjJXv4Q: checks
*** RIVER *** [Ts 3h 8h 8s] [Kd]
NkS+CseUKx4XHszWq0PXEQ: checks
CIrAX/m6o7jYmKOAjJXv4Q: bets $1
NkS+CseUKx4XHszWq0PXEQ: folds
CIrAX/m6o7jYmKOAjJXv4Q collected $1.20 from pot
*** SUMMARY ***
Total pot $1.25 | Rake $0.05
Board [Ts 3h 8h 8s Kd]
Seat 1: SKnJuWHScqetA/qG5p+wCg folded before Flop (didn't bet)
Seat 2: 9r7ZoBbAJj5IeyZ0q9BdzA folded before Flop (didn't bet)
Seat 3: 50QWoELmpmHFrFIlWMJo9g folded before Flop (didn't bet)
Seat 4: /gaxz7F0MIjSN3t7ZPKwAA folded before Flop (didn't bet)
Seat 5: jSSGUXdNFAZA3QCvTcUMQw folded before Flop (didn't bet)
Seat 6: EiWj2MAl8RNcPhTkzz24Mw (button) folded before Flop (didn't bet)
Seat 7: 3NcyXvr39gnK+KbTq7ezyA (small blind) folded before Flop
Seat 8: NkS+CseUKx4XHszWq0PXEQ (big blind) folded on the River
Seat 9: CIrAX/m6o7jYmKOAjJXv4Q collected ($1.20)



PokerStars Game #59938336768:  Hold'em No Limit ($0.25/$0.50) - 2009/07/01 0:12:34 ET
Table '5EmHi+fnatGQQShcNmzOZQ' 6-max Seat #2 is the button
Seat 1: SwPczQo3cOtwEzhJrfO2cQ ($22.25 in chips)
Seat 2: APwvTk5XojDXGoQLb4O5iA ($30.50 in chips)
Seat 3: J8dF2sYMvXUmAGUuSW9kwg ($21.55 in chips)
Seat 4: mFTuMjESuBcXHQ1ePkg/8A ($29.45 in chips)
Seat 5: kxPhs4ePFqMy52CInAJ2aw ($69.55 in chips)
Seat 6: 686aeHikcJlgKkSuIFdcXQ ($114.70 in chips)
J8dF2sYMvXUmAGUuSW9kwg: posts small blind $0.25
mFTuMjESuBcXHQ1ePkg/8A: posts big blind $0.50
*** HOLE CARDS ***
kxPhs4ePFqMy52CInAJ2aw: folds
686aeHikcJlgKkSuIFdcXQ: folds
SwPczQo3cOtwEzhJrfO2cQ: calls $0.50
APwvTk5XojDXGoQLb4O5iA: calls $0.50
J8dF2sYMvXUmAGUuSW9kwg: calls $0.25
mFTuMjESuBcXHQ1ePkg/8A: checks
*** FLOP *** [4s 2h Jd]
J8dF2sYMvXUmAGUuSW9kwg: bets $1.50
mFTuMjESuBcXHQ1ePkg/8A: folds
SwPczQo3cOtwEzhJrfO2cQ: folds
APwvTk5XojDXGoQLb4O5iA: folds
J8dF2sYMvXUmAGUuSW9kwg collected $1.90 from pot
J8dF2sYMvXUmAGUuSW9kwg: doesn't show hand
*** SUMMARY ***
Total pot $2 | Rake $0.10
Board [4s 2h Jd]
Seat 1: SwPczQo3cOtwEzhJrfO2cQ folded on the Flop
Seat 2: APwvTk5XojDXGoQLb4O5iA (button) folded on the Flop
Seat 3: J8dF2sYMvXUmAGUuSW9kwg (small blind) collected ($1.90)
Seat 4: mFTuMjESuBcXHQ1ePkg/8A (big blind) folded on the Flop
Seat 5: kxPhs4ePFqMy52CInAJ2aw folded before Flop (didn't bet)
Seat 6: 686aeHikcJlgKkSuIFdcXQ folded before Flop (didn't bet)



PokerStars Game #59938338250:  Hold'em No Limit ($0.25/$0.50) - 2009/07/01 0:12:36 ET
Table 'Nz0Vr7WMHL2g5Uk7dDZjpw' 9-max Seat #5 is the button
Seat 1: tLkxo7JgV+WWI0UBw44K5A ($104.85 in chips)
Seat 3: 4QTiNH5fteLgJjx/s6Hy6A ($8.90 in chips)
Seat 4: 5JJVDlaiMnB004o/RqbZZQ ($27 in chips)
Seat 5: WGW0DgjBUXs1ylURHG8vnQ ($17.15 in chips)
Seat 6: k1f0lS7tlMHCLGs0JT34Tg ($8.25 in chips)
Seat 7: KPLH0gELgFe2OuAnhJFI5w ($22.45 in chips)
Seat 8: HkZI6g4zl83TDTA7SRspmQ ($17.25 in chips)
Seat 9: Ak2W6V2TDVIQrvSAy4eD7Q ($22.80 in chips)
k1f0lS7tlMHCLGs0JT34Tg: posts small blind $0.25
KPLH0gELgFe2OuAnhJFI5w: posts big blind $0.50
*** HOLE CARDS ***
HkZI6g4zl83TDTA7SRspmQ: folds
Ak2W6V2TDVIQrvSAy4eD7Q: raises $1 to $1.50
tLkxo7JgV+WWI0UBw44K5A: folds
4QTiNH5fteLgJjx/s6Hy6A: calls $1.50
5JJVDlaiMnB004o/RqbZZQ: folds
WGW0DgjBUXs1ylURHG8vnQ: folds
k1f0lS7tlMHCLGs0JT34Tg: folds
KPLH0gELgFe2OuAnhJFI5w: folds
*** FLOP *** [7h 7s Qh]
Ak2W6V2TDVIQrvSAy4eD7Q: bets $2
4QTiNH5fteLgJjx/s6Hy6A: folds
Ak2W6V2TDVIQrvSAy4eD7Q collected $3.60 from pot
*** SUMMARY ***
Total pot $3.75 | Rake $0.15
Board [7h 7s Qh]
Seat 1: tLkxo7JgV+WWI0UBw44K5A folded before Flop (didn't bet)
Seat 3: 4QTiNH5fteLgJjx/s6Hy6A folded on the Flop
Seat 4: 5JJVDlaiMnB004o/RqbZZQ folded before Flop (didn't bet)
Seat 5: WGW0DgjBUXs1ylURHG8vnQ (button) folded before Flop (didn't bet)
Seat 6: k1f0lS7tlMHCLGs0JT34Tg (small blind) folded before Flop
Seat 7: KPLH0gELgFe2OuAnhJFI5w (big blind) folded before Flop
Seat 8: HkZI6g4zl83TDTA7SRspmQ folded before Flop (didn't bet)
Seat 9: Ak2W6V2TDVIQrvSAy4eD7Q collected ($3.60)



PokerStars Game #59938338944:  Hold'em No Limit ($0.25/$0.50) - 2009/07/01 0:12:37 ET
Table 'E7bWJ45aoFXRpyRv2gw+Ig' 2-max Seat #1 is the button
Seat 1: FRkiRasEGlHUeLrEl+k/nA ($81.35 in chips)
Seat 2: 3Wro85I7472vJ4Wkpneo9A ($41.55 in chips)
FRkiRasEGlHUeLrEl+k/nA: posts small blind $0.25
3Wro85I7472vJ4Wkpneo9A: posts big blind $0.50
*** HOLE CARDS ***
FRkiRasEGlHUeLrEl+k/nA: folds
3Wro85I7472vJ4Wkpneo9A collected $0.50 from pot
3Wro85I7472vJ4Wkpneo9A: doesn't show hand
*** SUMMARY ***
Total pot $0.50 | Rake $0
Seat 1: FRkiRasEGlHUeLrEl+k/nA (button) (small blind) folded before Flop
Seat 2: 3Wro85I7472vJ4Wkpneo9A (big blind) collected ($0.50)



PokerStars Game #59938340274:  Hold'em No Limit ($0.25/$0.50) - 2009/07/01 0:12:39 ET
Table 'ZYwMb9E6tY50Qm+iNbXRYw' 2-max Seat #2 is the button
Seat 1: DXLfRb8KDZWmrztw2bwtFw ($34.45 in chips)
Seat 2: 16tvT7AYgZ2LgiGFcvFKQg ($3.90 in chips)
16tvT7AYgZ2LgiGFcvFKQg: posts small blind $0.25
DXLfRb8KDZWmrztw2bwtFw: posts big blind $0.50
*** HOLE CARDS ***
16tvT7AYgZ2LgiGFcvFKQg: raises $0.50 to $1
DXLfRb8KDZWmrztw2bwtFw: raises $0.50 to $1.50
16tvT7AYgZ2LgiGFcvFKQg: calls $0.50
*** FLOP *** [Kc 2s 3d]
DXLfRb8KDZWmrztw2bwtFw: bets $1.50
16tvT7AYgZ2LgiGFcvFKQg: folds
DXLfRb8KDZWmrztw2bwtFw collected $2.85 from pot
*** SUMMARY ***
Total pot $3 | Rake $0.15
Board [Kc 2s 3d]
Seat 1: DXLfRb8KDZWmrztw2bwtFw (big blind) collected ($2.85)
Seat 2: 16tvT7AYgZ2LgiGFcvFKQg (button) (small blind) folded on the Flop



PokerStars Game #59938340620:  Hold'em No Limit ($0.25/$0.50) - 2009/07/01 0:12:39 ET
Table 'mTxf8gPLgffN3Iwfm7Icfg' 2-max Seat #1 is the button
Seat 1: Do9Rlu1R5u/AcRtMTl8SYg ($60.35 in chips)
Seat 2: EMc5LPgVaded4Qc77vm0fw ($53.05 in chips)
Do9Rlu1R5u/AcRtMTl8SYg: posts small blind $0.25
EMc5LPgVaded4Qc77vm0fw: posts big blind $0.50
*** HOLE CARDS ***
Do9Rlu1R5u/AcRtMTl8SYg: folds
EMc5LPgVaded4Qc77vm0fw collected $0.50 from pot
EMc5LPgVaded4Qc77vm0fw: doesn't show hand
*** SUMMARY ***
Total pot $0.50 | Rake $0
Seat 1: Do9Rlu1R5u/AcRtMTl8SYg (button) (small blind) folded before Flop
Seat 2: EMc5LPgVaded4Qc77vm0fw (big blind) collected ($0.50)



PokerStars Game #59938340604:  Hold'em No Limit ($0.25/$0.50) - 2009/07/01 0:12:39 ET
Table 'raOT4/ipuZgzjfKHC+jD9g' 2-max Seat #1 is the button
Seat 1: IuwLemwLhc9fvrwBGs0AMA ($11.75 in chips)
Seat 2: Udr5juWSWUgTu1NlRhjMdA ($11.25 in chips)
IuwLemwLhc9fvrwBGs0AMA: posts small blind $0.25
Udr5juWSWUgTu1NlRhjMdA: posts big blind $0.50
*** HOLE CARDS ***
IuwLemwLhc9fvrwBGs0AMA: raises $0.50 to $1
Udr5juWSWUgTu1NlRhjMdA: folds
IuwLemwLhc9fvrwBGs0AMA collected $1 from pot
*** SUMMARY ***
Total pot $1 | Rake $0
Seat 1: IuwLemwLhc9fvrwBGs0AMA (button) (small blind) collected ($1)
Seat 2: Udr5juWSWUgTu1NlRhjMdA (big blind) folded before Flop



PokerStars Game #59938341056:  Hold'em No Limit ($0.25/$0.50) - 2009/07/01 0:12:40 ET
Table '3FhG0gl3kMX3wBEEqj+wnQ' 9-max Seat #6 is the button
Seat 1: e0J9pdCNUDTCG031RnXqLA ($25.45 in chips)
Seat 2: 4dl3YNqZ6Houm2jZAzDmRg ($25.75 in chips)
Seat 3: bXpVeaSTPBFSPJmeXxO7nw ($10 in chips)
Seat 4: bz4LMfV0GGl/MJ/ABXuPmg ($14.40 in chips)
Seat 5: XNMDwbXt/Q4jM99AXnbJDw ($48.25 in chips)
Seat 6: 5JJVDlaiMnB004o/RqbZZQ ($26 in chips)
Seat 8: j3K/Jujr7PY4ZM2RZvlH6A ($58.60 in chips)
Seat 9: tzoXBDwkkPV/XPJPkf963Q ($13.80 in chips)
mSD1pginDsyHG5PDfqzphw will be allowed to play after the button
j3K/Jujr7PY4ZM2RZvlH6A: posts small blind $0.25
tzoXBDwkkPV/XPJPkf963Q: posts big blind $0.50
*** HOLE CARDS ***
e0J9pdCNUDTCG031RnXqLA: folds
4dl3YNqZ6Houm2jZAzDmRg: calls $0.50
bXpVeaSTPBFSPJmeXxO7nw: folds
bz4LMfV0GGl/MJ/ABXuPmg: calls $0.50
XNMDwbXt/Q4jM99AXnbJDw: raises $2.50 to $3
5JJVDlaiMnB004o/RqbZZQ: folds
j3K/Jujr7PY4ZM2RZvlH6A: folds
tzoXBDwkkPV/XPJPkf963Q: folds
4dl3YNqZ6Houm2jZAzDmRg: folds
bz4LMfV0GGl/MJ/ABXuPmg: folds
XNMDwbXt/Q4jM99AXnbJDw collected $2.25 from pot
XNMDwbXt/Q4jM99AXnbJDw: doesn't show hand
*** SUMMARY ***
Total pot $2.25 | Rake $0
Seat 1: e0J9pdCNUDTCG031RnXqLA folded before Flop (didn't bet)
Seat 2: 4dl3YNqZ6Houm2jZAzDmRg folded before Flop
Seat 3: bXpVeaSTPBFSPJmeXxO7nw folded before Flop (didn't bet)
Seat 4: bz4LMfV0GGl/MJ/ABXuPmg folded before Flop
Seat 5: XNMDwbXt/Q4jM99AXnbJDw collected ($2.25)
Seat 6: 5JJVDlaiMnB004o/RqbZZQ (button) folded before Flop (didn't bet)
Seat 8: j3K/Jujr7PY4ZM2RZvlH6A (small blind) folded before Flop
Seat 9: tzoXBDwkkPV/XPJPkf963Q (big blind) folded before Flop



PokerStars Game #59938341546:  Hold'em No Limit ($0.25/$0.50) - 2009/07/01 0:12:41 ET
Table 'hSTs/dUsYLgJQuF2Onp0MQ' 6-max Seat #5 is the button
Seat 1: lWwl5C/UZOsWNubdUqghZw ($70.70 in chips)
Seat 2: fyJOjf+Vdie/rpWb1WExIg ($16.25 in chips)
Seat 3: vQOrJuXbLC3UZDVklY9bOA ($19.95 in chips)
Seat 4: L0aIPg7qefDQjdJo3HCVEA ($13.70 in chips)
Seat 5: 686aeHikcJlgKkSuIFdcXQ ($59.90 in chips)
Seat 6: +laPa9P7BjZKKnR0n+OmvA ($4.40 in chips)
+laPa9P7BjZKKnR0n+OmvA: posts small blind $0.25
lWwl5C/UZOsWNubdUqghZw: posts big blind $0.50
*** HOLE CARDS ***
fyJOjf+Vdie/rpWb1WExIg: folds
vQOrJuXbLC3UZDVklY9bOA: folds
lWwl5C/UZOsWNubdUqghZw is disconnected
L0aIPg7qefDQjdJo3HCVEA: raises $0.50 to $1
686aeHikcJlgKkSuIFdcXQ: folds
+laPa9P7BjZKKnR0n+OmvA: folds
fyJOjf+Vdie/rpWb1WExIg leaves the table
lWwl5C/UZOsWNubdUqghZw is connected
lWwl5C/UZOsWNubdUqghZw: folds
L0aIPg7qefDQjdJo3HCVEA collected $1.25 from pot
*** SUMMARY ***
Total pot $1.25 | Rake $0
Seat 1: lWwl5C/UZOsWNubdUqghZw (big blind) folded before Flop
Seat 2: fyJOjf+Vdie/rpWb1WExIg folded before Flop (didn't bet)
Seat 3: vQOrJuXbLC3UZDVklY9bOA folded before Flop (didn't bet)
Seat 4: L0aIPg7qefDQjdJo3HCVEA collected ($1.25)
Seat 5: 686aeHikcJlgKkSuIFdcXQ (button) folded before Flop (didn't bet)
Seat 6: +laPa9P7BjZKKnR0n+OmvA (small blind) folded before Flop



PokerStars Game #59938342754:  Hold'em No Limit ($0.25/$0.50) - 2009/07/01 0:12:42 ET
Table 'tyR5AZNKV8Aadbrnrnlg7g' 6-max Seat #4 is the button
Seat 1: R+KjpH/wSjDLhtIy9+edNA ($54.10 in chips)
Seat 2: 58zdeSBSuSFX/qZfhc7YmA ($32.60 in chips)
Seat 3: jUhx+m+V7qfbLZTjgwZByg ($47.10 in chips)
Seat 4: Rt6KgtZ8YaJoTc3FPim00w ($50.50 in chips)
Seat 5: EIg3r3fRFKG2HhgpDlIJHg ($20 in chips)
Seat 6: DMQLAmut/l19xN5STQndFg ($7.50 in chips)
EIg3r3fRFKG2HhgpDlIJHg: posts small blind $0.25
DMQLAmut/l19xN5STQndFg: posts big blind $0.50
*** HOLE CARDS ***
R+KjpH/wSjDLhtIy9+edNA: folds
58zdeSBSuSFX/qZfhc7YmA: calls $0.50
jUhx+m+V7qfbLZTjgwZByg: calls $0.50
Rt6KgtZ8YaJoTc3FPim00w: folds
EIg3r3fRFKG2HhgpDlIJHg: calls $0.25
DMQLAmut/l19xN5STQndFg: checks
*** FLOP *** [2s 5h 7c]
EIg3r3fRFKG2HhgpDlIJHg: checks
DMQLAmut/l19xN5STQndFg: checks
58zdeSBSuSFX/qZfhc7YmA: bets $1
jUhx+m+V7qfbLZTjgwZByg: folds
EIg3r3fRFKG2HhgpDlIJHg: calls $1
DMQLAmut/l19xN5STQndFg: calls $1
*** TURN *** [2s 5h 7c] [6d]
EIg3r3fRFKG2HhgpDlIJHg: checks
DMQLAmut/l19xN5STQndFg: checks
58zdeSBSuSFX/qZfhc7YmA: checks
*** RIVER *** [2s 5h 7c 6d] [3d]
EIg3r3fRFKG2HhgpDlIJHg: checks
DMQLAmut/l19xN5STQndFg: bets $3
58zdeSBSuSFX/qZfhc7YmA: folds
EIg3r3fRFKG2HhgpDlIJHg: folds
DMQLAmut/l19xN5STQndFg collected $4.80 from pot
DMQLAmut/l19xN5STQndFg: doesn't show hand
*** SUMMARY ***
Total pot $5 | Rake $0.20
Board [2s 5h 7c 6d 3d]
Seat 1: R+KjpH/wSjDLhtIy9+edNA folded before Flop (didn't bet)
Seat 2: 58zdeSBSuSFX/qZfhc7YmA folded on the River
Seat 3: jUhx+m+V7qfbLZTjgwZByg folded on the Flop
Seat 4: Rt6KgtZ8YaJoTc3FPim00w (button) folded before Flop (didn't bet)
Seat 5: EIg3r3fRFKG2HhgpDlIJHg (small blind) folded on the River
Seat 6: DMQLAmut/l19xN5STQndFg (big blind) collected ($4.80)



PokerStars Game #59938343560:  Hold'em No Limit ($0.25/$0.50) - 2009/07/01 0:12:43 ET
Table 'lSisgp6H7Fg1hH5VfjEjYQ' 9-max Seat #6 is the button
Seat 1: pEW8B6uXbdR47kfljMQ3+Q ($39.70 in chips)
Seat 2: UrcnkQOiLVk8BlKDPJSy7Q ($51.85 in chips)
Seat 3: aTkyjTh3w5YLWiIERupZOA ($30.95 in chips)
Seat 4: nvw9yQKhJT56lA9k+TLdhw ($10.95 in chips)
Seat 5: mSD1pginDsyHG5PDfqzphw ($10 in chips)
Seat 6: +k7T5ocke8UwavtgUHm+Cg ($22.15 in chips)
Seat 9: 5JJVDlaiMnB004o/RqbZZQ ($41.05 in chips)
dGw5MBstXyXhWHHVFOWOFA will be allowed to play after the button
5JJVDlaiMnB004o/RqbZZQ: posts small blind $0.25
pEW8B6uXbdR47kfljMQ3+Q: posts big blind $0.50
*** HOLE CARDS ***
UrcnkQOiLVk8BlKDPJSy7Q: folds
aTkyjTh3w5YLWiIERupZOA: folds
nvw9yQKhJT56lA9k+TLdhw: raises $1 to $1.50
mSD1pginDsyHG5PDfqzphw: folds
+k7T5ocke8UwavtgUHm+Cg: folds
5JJVDlaiMnB004o/RqbZZQ: folds
a4JDWmpFQkL10XfAyuF51A joins the table at seat #8
pEW8B6uXbdR47kfljMQ3+Q: folds
nvw9yQKhJT56lA9k+TLdhw collected $1.25 from pot
*** SUMMARY ***
Total pot $1.25 | Rake $0
Seat 1: pEW8B6uXbdR47kfljMQ3+Q (big blind) folded before Flop
Seat 2: UrcnkQOiLVk8BlKDPJSy7Q folded before Flop (didn't bet)
Seat 3: aTkyjTh3w5YLWiIERupZOA folded before Flop (didn't bet)
Seat 4: nvw9yQKhJT56lA9k+TLdhw collected ($1.25)
Seat 5: mSD1pginDsyHG5PDfqzphw folded before Flop (didn't bet)
Seat 6: +k7T5ocke8UwavtgUHm+Cg (button) folded before Flop (didn't bet)
Seat 9: 5JJVDlaiMnB004o/RqbZZQ (small blind) folded before Flop



PokerStars Game #59938343144:  Hold'em No Limit ($0.25/$0.50) - 2009/07/01 0:12:43 ET
Table 'E7bWJ45aoFXRpyRv2gw+Ig' 2-max Seat #2 is the button
Seat 1: FRkiRasEGlHUeLrEl+k/nA ($81.10 in chips)
Seat 2: 3Wro85I7472vJ4Wkpneo9A ($41.80 in chips)
3Wro85I7472vJ4Wkpneo9A: posts small blind $0.25
FRkiRasEGlHUeLrEl+k/nA: posts big blind $0.50
*** HOLE CARDS ***
3Wro85I7472vJ4Wkpneo9A: calls $0.25
FRkiRasEGlHUeLrEl+k/nA: checks
*** FLOP *** [Kd Qs 6h]
FRkiRasEGlHUeLrEl+k/nA: checks
3Wro85I7472vJ4Wkpneo9A: bets $1
FRkiRasEGlHUeLrEl+k/nA: folds
3Wro85I7472vJ4Wkpneo9A collected $0.95 from pot
3Wro85I7472vJ4Wkpneo9A: doesn't show hand
*** SUMMARY ***
Total pot $1 | Rake $0.05
Board [Kd Qs 6h]
Seat 1: FRkiRasEGlHUeLrEl+k/nA (big blind) folded on the Flop
Seat 2: 3Wro85I7472vJ4Wkpneo9A (button) (small blind) collected ($0.95)



PokerStars Game #59938343334:  Hold'em No Limit ($0.25/$0.50) - 2009/07/01 0:12:43 ET
Table '+dXkOAQyS8j9PQZusUTMpg' 2-max Seat #2 is the button
Seat 1: XFa6sBGjP2gxoIvxR3fZIg ($85.70 in chips)
Seat 2: 5IBeOgaApY1Bvzv2P8X4EA ($26.45 in chips)
5IBeOgaApY1Bvzv2P8X4EA: posts small blind $0.25
XFa6sBGjP2gxoIvxR3fZIg: posts big blind $0.50
*** HOLE CARDS ***
5IBeOgaApY1Bvzv2P8X4EA: raises $1 to $1.50
XFa6sBGjP2gxoIvxR3fZIg said, "damn IÃ¯Â¿Â½m good"
XFa6sBGjP2gxoIvxR3fZIg: folds
5IBeOgaApY1Bvzv2P8X4EA collected $1 from pot
5IBeOgaApY1Bvzv2P8X4EA: doesn't show hand
*** SUMMARY ***
Total pot $1 | Rake $0
Seat 1: XFa6sBGjP2gxoIvxR3fZIg (big blind) folded before Flop
Seat 2: 5IBeOgaApY1Bvzv2P8X4EA (button) (small blind) collected ($1)



PokerStars Game #59938343436:  Hold'em No Limit ($0.25/$0.50) - 2009/07/01 0:12:43 ET
Table 'YsnnHkamRzYqMOr2FlLY4w' 6-max Seat #2 is the button
Seat 1: crjGpJEzSZgD38FoE3VMGg ($61.90 in chips)
Seat 2: vnRgOasQNKOR7gLXwRQ+ww ($50 in chips)
Seat 4: 7Fue572p4ZIC85AJMQvaQw ($51.95 in chips)
Seat 5: lcQ7uuLf+WLGGy4Ve6VKKA ($39.85 in chips)
Seat 6: YmWlPGOKFuJSoJZPW8a8IA ($50 in chips)
7Fue572p4ZIC85AJMQvaQw: posts small blind $0.25
lcQ7uuLf+WLGGy4Ve6VKKA: posts big blind $0.50
*** HOLE CARDS ***
YmWlPGOKFuJSoJZPW8a8IA: folds
crjGpJEzSZgD38FoE3VMGg: folds
vnRgOasQNKOR7gLXwRQ+ww: folds
7Fue572p4ZIC85AJMQvaQw: folds
lcQ7uuLf+WLGGy4Ve6VKKA collected $0.50 from pot
lcQ7uuLf+WLGGy4Ve6VKKA: doesn't show hand
*** SUMMARY ***
Total pot $0.50 | Rake $0
Seat 1: crjGpJEzSZgD38FoE3VMGg folded before Flop (didn't bet)
Seat 2: vnRgOasQNKOR7gLXwRQ+ww (button) folded before Flop (didn't bet)
Seat 4: 7Fue572p4ZIC85AJMQvaQw (small blind) folded before Flop
Seat 5: lcQ7uuLf+WLGGy4Ve6VKKA (big blind) collected ($0.50)
Seat 6: YmWlPGOKFuJSoJZPW8a8IA folded before Flop (didn't bet)



PokerStars Game #59938344810:  Hold'em No Limit ($0.25/$0.50) - 2009/07/01 0:12:45 ET
Table 'mTxf8gPLgffN3Iwfm7Icfg' 2-max Seat #2 is the button
Seat 1: Do9Rlu1R5u/AcRtMTl8SYg ($60.10 in chips)
Seat 2: EMc5LPgVaded4Qc77vm0fw ($53.30 in chips)
EMc5LPgVaded4Qc77vm0fw: posts small blind $0.25
Do9Rlu1R5u/AcRtMTl8SYg: posts big blind $0.50
*** HOLE CARDS ***
EMc5LPgVaded4Qc77vm0fw: folds
Do9Rlu1R5u/AcRtMTl8SYg collected $0.50 from pot
Do9Rlu1R5u/AcRtMTl8SYg: doesn't show hand
*** SUMMARY ***
Total pot $0.50 | Rake $0
Seat 1: Do9Rlu1R5u/AcRtMTl8SYg (big blind) collected ($0.50)
Seat 2: EMc5LPgVaded4Qc77vm0fw (button) (small blind) folded before Flop



PokerStars Game #59938346148:  Hold'em No Limit ($0.25/$0.50) - 2009/07/01 0:12:47 ET
Table 'T/PgNWqVyY6lkldcBVXYJQ' 6-max Seat #2 is the button
Seat 1: +Pf9jTVizYlIo+woPvptfA ($53.20 in chips)
Seat 2: oZAeY5rVqNGgt8yyQ0pxbA ($29.80 in chips)
Seat 3: L3OcNO1bgdqDI46j67KQPQ ($50 in chips)
Seat 4: jxMvxeUUL9UU0V6wVU+Iyw ($14.95 in chips)
Seat 5: vVQBckETtigfb5mAcyK0OA ($62.75 in chips)
Seat 6: cDzbog6kwmJp+LBeBq+iMQ ($10.60 in chips)
L3OcNO1bgdqDI46j67KQPQ: posts small blind $0.25
jxMvxeUUL9UU0V6wVU+Iyw: posts big blind $0.50
*** HOLE CARDS ***
vVQBckETtigfb5mAcyK0OA: calls $0.50
cDzbog6kwmJp+LBeBq+iMQ: calls $0.50
vVQBckETtigfb5mAcyK0OA said, "WHAT DO THEY GO 4"
jxMvxeUUL9UU0V6wVU+Iyw said, "You alone or with someone"
vVQBckETtigfb5mAcyK0OA said, "YOURS"
+Pf9jTVizYlIo+woPvptfA: folds
oZAeY5rVqNGgt8yyQ0pxbA: raises $1.50 to $2
jxMvxeUUL9UU0V6wVU+Iyw said, "1/2 decent seat is about $50"
L3OcNO1bgdqDI46j67KQPQ: folds
jxMvxeUUL9UU0V6wVU+Iyw: raises $1.50 to $3.50
vVQBckETtigfb5mAcyK0OA: folds
vVQBckETtigfb5mAcyK0OA said, "NOT TO BAD"
cDzbog6kwmJp+LBeBq+iMQ: calls $3
oZAeY5rVqNGgt8yyQ0pxbA: calls $1.50
*** FLOP *** [Th Jd Qs]
jxMvxeUUL9UU0V6wVU+Iyw: bets $11.45 and is all-in
cDzbog6kwmJp+LBeBq+iMQ: calls $7.10 and is all-in
vVQBckETtigfb5mAcyK0OA said, "U GOT THE NUTS"
jxMvxeUUL9UU0V6wVU+Iyw said, "Plus it's the C Day."
oZAeY5rVqNGgt8yyQ0pxbA: folds
*** TURN *** [Th Jd Qs] [5d]
*** RIVER *** [Th Jd Qs 5d] [4h]
*** SHOW DOWN ***
jxMvxeUUL9UU0V6wVU+Iyw: shows [Kc Ts] (a pair of Tens)
cDzbog6kwmJp+LBeBq+iMQ: shows [6s Jc] (a pair of Jacks)
cDzbog6kwmJp+LBeBq+iMQ collected $24.25 from pot
*** SUMMARY ***
Total pot $25.45 | Rake $1.20
Board [Th Jd Qs 5d 4h]
Seat 1: +Pf9jTVizYlIo+woPvptfA folded before Flop (didn't bet)
Seat 2: oZAeY5rVqNGgt8yyQ0pxbA (button) folded on the Flop
Seat 3: L3OcNO1bgdqDI46j67KQPQ (small blind) folded before Flop
Seat 4: jxMvxeUUL9UU0V6wVU+Iyw (big blind) showed [Kc Ts] and lost with a pair of Tens
Seat 5: vVQBckETtigfb5mAcyK0OA folded before Flop
Seat 6: cDzbog6kwmJp+LBeBq+iMQ showed [6s Jc] and won ($24.25) with a pair of Jacks



PokerStars Game #59938348240:  Hold'em No Limit ($0.25/$0.50) - 2009/07/01 0:12:50 ET
Table 'eMxdLyFDf28E0wit6gm3Uw' 6-max Seat #2 is the button
Seat 1: tnD/64LagZ9qPaeOQVjVZg ($11.95 in chips)
Seat 2: jwuKQ1S3U4NnzMQn3E3dgw ($63.90 in chips)
Seat 3: dZcLsEI8iXkobBduRJ45Yw ($19 in chips)
Seat 5: X0X97o2fDAPiGx6o1gahsw ($58.05 in chips)
Seat 6: L0aIPg7qefDQjdJo3HCVEA ($10 in chips)
dZcLsEI8iXkobBduRJ45Yw: posts small blind $0.25
crjGpJEzSZgD38FoE3VMGg: is sitting out
X0X97o2fDAPiGx6o1gahsw: posts big blind $0.50
*** HOLE CARDS ***
crjGpJEzSZgD38FoE3VMGg leaves the table
L0aIPg7qefDQjdJo3HCVEA: folds
tnD/64LagZ9qPaeOQVjVZg: folds
jwuKQ1S3U4NnzMQn3E3dgw: raises $1.50 to $2
dZcLsEI8iXkobBduRJ45Yw: calls $1.75
X0X97o2fDAPiGx6o1gahsw: folds
*** FLOP *** [5h 3d 6d]
dZcLsEI8iXkobBduRJ45Yw: checks
jwuKQ1S3U4NnzMQn3E3dgw: bets $4.50
dZcLsEI8iXkobBduRJ45Yw: folds
jwuKQ1S3U4NnzMQn3E3dgw collected $4.30 from pot
*** SUMMARY ***
Total pot $4.50 | Rake $0.20
Board [5h 3d 6d]
Seat 1: tnD/64LagZ9qPaeOQVjVZg folded before Flop (didn't bet)
Seat 2: jwuKQ1S3U4NnzMQn3E3dgw (button) collected ($4.30)
Seat 3: dZcLsEI8iXkobBduRJ45Yw (small blind) folded on the Flop
Seat 5: X0X97o2fDAPiGx6o1gahsw (big blind) folded before Flop
Seat 6: L0aIPg7qefDQjdJo3HCVEA folded before Flop (didn't bet)



PokerStars Game #59938348364:  Hold'em No Limit ($0.25/$0.50) - 2009/07/01 0:12:50 ET
Table 'ibNfFy0bCzuBaUORla0aGw' 9-max Seat #8 is the button
Seat 1: xZCXQSXlrZkp3pZizzVXCw ($55.45 in chips)
Seat 2: 90Wb75h3W1BRpbqVnuk8gw ($52.55 in chips)
Seat 3: dDaHs3X8+fe3bIkRU0cbrw ($26.30 in chips)
Seat 4: YBN054X4blmis+B2bBlC0g ($21.05 in chips)
Seat 5: FRv75HO8CUsRZ1byEz06mQ ($13.85 in chips)
Seat 6: BmYrv3ec2k5d6pQq6iNaZw ($67.85 in chips)
Seat 7: mSD1pginDsyHG5PDfqzphw ($13.75 in chips)
Seat 8: xUrN9TWLq4m5V+OXY7KUUA ($50 in chips)
Seat 9: WpvT3OUSiZlpvs+mPXFqtQ ($8.25 in chips)
WpvT3OUSiZlpvs+mPXFqtQ: posts small blind $0.25
xZCXQSXlrZkp3pZizzVXCw: posts big blind $0.50
*** HOLE CARDS ***
90Wb75h3W1BRpbqVnuk8gw: folds
dDaHs3X8+fe3bIkRU0cbrw: folds
YBN054X4blmis+B2bBlC0g: folds
FRv75HO8CUsRZ1byEz06mQ: folds
BmYrv3ec2k5d6pQq6iNaZw: folds
mSD1pginDsyHG5PDfqzphw: folds
xUrN9TWLq4m5V+OXY7KUUA: folds
WpvT3OUSiZlpvs+mPXFqtQ: folds
xZCXQSXlrZkp3pZizzVXCw collected $0.50 from pot
*** SUMMARY ***
Total pot $0.50 | Rake $0
Seat 1: xZCXQSXlrZkp3pZizzVXCw (big blind) collected ($0.50)
Seat 2: 90Wb75h3W1BRpbqVnuk8gw folded before Flop (didn't bet)
Seat 3: dDaHs3X8+fe3bIkRU0cbrw folded before Flop (didn't bet)
Seat 4: YBN054X4blmis+B2bBlC0g folded before Flop (didn't bet)
Seat 5: FRv75HO8CUsRZ1byEz06mQ folded before Flop (didn't bet)
Seat 6: BmYrv3ec2k5d6pQq6iNaZw folded before Flop (didn't bet)
Seat 7: mSD1pginDsyHG5PDfqzphw folded before Flop (didn't bet)
Seat 8: xUrN9TWLq4m5V+OXY7KUUA (button) folded before Flop (didn't bet)
Seat 9: WpvT3OUSiZlpvs+mPXFqtQ (small blind) folded before Flop



PokerStars Game #59938349106:  Hold'em No Limit ($0.25/$0.50) - 2009/07/01 0:12:51 ET
Table 'mTxf8gPLgffN3Iwfm7Icfg' 2-max Seat #1 is the button
Seat 1: Do9Rlu1R5u/AcRtMTl8SYg ($60.35 in chips)
Seat 2: EMc5LPgVaded4Qc77vm0fw ($53.05 in chips)
Do9Rlu1R5u/AcRtMTl8SYg: posts small blind $0.25
EMc5LPgVaded4Qc77vm0fw: posts big blind $0.50
*** HOLE CARDS ***
Do9Rlu1R5u/AcRtMTl8SYg: folds
EMc5LPgVaded4Qc77vm0fw collected $0.50 from pot
EMc5LPgVaded4Qc77vm0fw: doesn't show hand
*** SUMMARY ***
Total pot $0.50 | Rake $0
Seat 1: Do9Rlu1R5u/AcRtMTl8SYg (button) (small blind) folded before Flop
Seat 2: EMc5LPgVaded4Qc77vm0fw (big blind) collected ($0.50)



PokerStars Game #59938348800:  Hold'em No Limit ($0.25/$0.50) - 2009/07/01 0:12:51 ET
Table 'raOT4/ipuZgzjfKHC+jD9g' 2-max Seat #2 is the button
Seat 1: IuwLemwLhc9fvrwBGs0AMA ($12.25 in chips)
Seat 2: Udr5juWSWUgTu1NlRhjMdA ($10.75 in chips)
Udr5juWSWUgTu1NlRhjMdA: posts small blind $0.25
IuwLemwLhc9fvrwBGs0AMA: posts big blind $0.50
*** HOLE CARDS ***
Udr5juWSWUgTu1NlRhjMdA: calls $0.25
IuwLemwLhc9fvrwBGs0AMA: checks
*** FLOP *** [Ks Tc 4d]
IuwLemwLhc9fvrwBGs0AMA: bets $0.50
Udr5juWSWUgTu1NlRhjMdA: folds
IuwLemwLhc9fvrwBGs0AMA collected $0.95 from pot
*** SUMMARY ***
Total pot $1 | Rake $0.05
Board [Ks Tc 4d]
Seat 1: IuwLemwLhc9fvrwBGs0AMA (big blind) collected ($0.95)
Seat 2: Udr5juWSWUgTu1NlRhjMdA (button) (small blind) folded on the Flop



PokerStars Game #59938348664:  Hold'em No Limit ($0.25/$0.50) - 2009/07/01 0:12:51 ET
Table 'NCiXr0d5CEKBQr/cZgLhbA' 9-max Seat #6 is the button
Seat 1: RjBdQ6w31rgcy0o24VLR6w ($8.50 in chips)
Seat 2: ulxuJchBV9iguXg0FUonfg ($35.80 in chips)
Seat 3: xZCXQSXlrZkp3pZizzVXCw ($55.65 in chips)
Seat 4: CL4d+tvzcd4utdQxlPLOmg ($29.15 in chips)
Seat 5: zE9cVigS2nW/Ljy4K4bUQA ($30 in chips)
Seat 6: SKnJuWHScqetA/qG5p+wCg ($31.05 in chips)
Seat 8: 1MJUKc3cc0QmUoz1JZLR2w ($67.65 in chips)
Seat 9: WpvT3OUSiZlpvs+mPXFqtQ ($8.20 in chips)
M+7+BTmX5vZatHVuoRB1nA will be allowed to play after the button
1MJUKc3cc0QmUoz1JZLR2w: posts small blind $0.25
WpvT3OUSiZlpvs+mPXFqtQ: posts big blind $0.50
*** HOLE CARDS ***
RjBdQ6w31rgcy0o24VLR6w: folds
ulxuJchBV9iguXg0FUonfg: folds
xZCXQSXlrZkp3pZizzVXCw: folds
CL4d+tvzcd4utdQxlPLOmg: folds
zE9cVigS2nW/Ljy4K4bUQA: folds
SKnJuWHScqetA/qG5p+wCg: folds
1MJUKc3cc0QmUoz1JZLR2w: folds
WpvT3OUSiZlpvs+mPXFqtQ collected $0.50 from pot
WpvT3OUSiZlpvs+mPXFqtQ: doesn't show hand
*** SUMMARY ***
Total pot $0.50 | Rake $0
Seat 1: RjBdQ6w31rgcy0o24VLR6w folded before Flop (didn't bet)
Seat 2: ulxuJchBV9iguXg0FUonfg folded before Flop (didn't bet)
Seat 3: xZCXQSXlrZkp3pZizzVXCw folded before Flop (didn't bet)
Seat 4: CL4d+tvzcd4utdQxlPLOmg folded before Flop (didn't bet)
Seat 5: zE9cVigS2nW/Ljy4K4bUQA folded before Flop (didn't bet)
Seat 6: SKnJuWHScqetA/qG5p+wCg (button) folded before Flop (didn't bet)
Seat 8: 1MJUKc3cc0QmUoz1JZLR2w (small blind) folded before Flop
Seat 9: WpvT3OUSiZlpvs+mPXFqtQ (big blind) collected ($0.50)



PokerStars Game #59938350786:  Hold'em No Limit ($0.25/$0.50) - 2009/07/01 0:12:54 ET
Table 'ZYwMb9E6tY50Qm+iNbXRYw' 2-max Seat #1 is the button
Seat 1: DXLfRb8KDZWmrztw2bwtFw ($35.80 in chips)
Seat 2: 16tvT7AYgZ2LgiGFcvFKQg ($2.40 in chips)
DXLfRb8KDZWmrztw2bwtFw: posts small blind $0.25
16tvT7AYgZ2LgiGFcvFKQg: posts big blind $0.50
*** HOLE CARDS ***
DXLfRb8KDZWmrztw2bwtFw: calls $0.25
16tvT7AYgZ2LgiGFcvFKQg: raises $1.90 to $2.40 and is all-in
DXLfRb8KDZWmrztw2bwtFw: calls $1.90
*** FLOP *** [Jc 2s Th]
*** TURN *** [Jc 2s Th] [3c]
*** RIVER *** [Jc 2s Th 3c] [Qs]
*** SHOW DOWN ***
16tvT7AYgZ2LgiGFcvFKQg: shows [Tc Qh] (two pair, Queens and Tens)
DXLfRb8KDZWmrztw2bwtFw: mucks hand
16tvT7AYgZ2LgiGFcvFKQg collected $4.60 from pot
*** SUMMARY ***
Total pot $4.80 | Rake $0.20
Board [Jc 2s Th 3c Qs]
Seat 1: DXLfRb8KDZWmrztw2bwtFw (button) (small blind) mucked
Seat 2: 16tvT7AYgZ2LgiGFcvFKQg (big blind) showed [Tc Qh] and won ($4.60) with two pair, Queens and Tens



PokerStars Game #59938352992:  Hold'em No Limit ($0.25/$0.50) - 2009/07/01 0:12:57 ET
Table 'c/CRn+68J3Y8KxD5g1ek2Q' 2-max Seat #1 is the button
Seat 1: 46qCyJ6evTkHo9al5sBMNA ($317 in chips)
Seat 2: BypVLsYQt3ePFm2xQL/dOA ($67.95 in chips)
46qCyJ6evTkHo9al5sBMNA: posts small blind $0.25
BypVLsYQt3ePFm2xQL/dOA: posts big blind $0.50
*** HOLE CARDS ***
46qCyJ6evTkHo9al5sBMNA: folds
BypVLsYQt3ePFm2xQL/dOA collected $0.50 from pot
BypVLsYQt3ePFm2xQL/dOA: doesn't show hand
*** SUMMARY ***
Total pot $0.50 | Rake $0
Seat 1: 46qCyJ6evTkHo9al5sBMNA (button) (small blind) folded before Flop
Seat 2: BypVLsYQt3ePFm2xQL/dOA (big blind) collected ($0.50)



PokerStars Game #59938353382:  Hold'em No Limit ($0.25/$0.50) - 2009/07/01 0:12:57 ET
Table 'YsnnHkamRzYqMOr2FlLY4w' 6-max Seat #4 is the button
Seat 1: crjGpJEzSZgD38FoE3VMGg ($61.90 in chips)
Seat 2: vnRgOasQNKOR7gLXwRQ+ww ($50 in chips)
Seat 4: 7Fue572p4ZIC85AJMQvaQw ($51.70 in chips)
Seat 5: lcQ7uuLf+WLGGy4Ve6VKKA ($40.10 in chips)
lcQ7uuLf+WLGGy4Ve6VKKA: posts small blind $0.25
YmWlPGOKFuJSoJZPW8a8IA: is sitting out
crjGpJEzSZgD38FoE3VMGg: posts big blind $0.50
*** HOLE CARDS ***
vnRgOasQNKOR7gLXwRQ+ww: folds
YmWlPGOKFuJSoJZPW8a8IA leaves the table
7Fue572p4ZIC85AJMQvaQw: folds
lcQ7uuLf+WLGGy4Ve6VKKA: calls $0.25
crjGpJEzSZgD38FoE3VMGg: checks
*** FLOP *** [Qc 2c 8s]
lcQ7uuLf+WLGGy4Ve6VKKA: checks
crjGpJEzSZgD38FoE3VMGg: checks
*** TURN *** [Qc 2c 8s] [Tc]
lcQ7uuLf+WLGGy4Ve6VKKA: bets $1
crjGpJEzSZgD38FoE3VMGg: folds
lcQ7uuLf+WLGGy4Ve6VKKA collected $0.95 from pot
lcQ7uuLf+WLGGy4Ve6VKKA: doesn't show hand
*** SUMMARY ***
Total pot $1 | Rake $0.05
Board [Qc 2c 8s Tc]
Seat 1: crjGpJEzSZgD38FoE3VMGg (big blind) folded on the Turn
Seat 2: vnRgOasQNKOR7gLXwRQ+ww folded before Flop (didn't bet)
Seat 4: 7Fue572p4ZIC85AJMQvaQw (button) folded before Flop (didn't bet)
Seat 5: lcQ7uuLf+WLGGy4Ve6VKKA (small blind) collected ($0.95)



PokerStars Game #59938353892:  Hold'em No Limit ($0.25/$0.50) - 2009/07/01 0:12:58 ET
Table 'mTxf8gPLgffN3Iwfm7Icfg' 2-max Seat #2 is the button
Seat 1: Do9Rlu1R5u/AcRtMTl8SYg ($60.10 in chips)
Seat 2: EMc5LPgVaded4Qc77vm0fw ($53.30 in chips)
EMc5LPgVaded4Qc77vm0fw: posts small blind $0.25
Do9Rlu1R5u/AcRtMTl8SYg: posts big blind $0.50
*** HOLE CARDS ***
EMc5LPgVaded4Qc77vm0fw: raises $1 to $1.50
Do9Rlu1R5u/AcRtMTl8SYg: folds
EMc5LPgVaded4Qc77vm0fw collected $1 from pot
EMc5LPgVaded4Qc77vm0fw: doesn't show hand
*** SUMMARY ***
Total pot $1 | Rake $0
Seat 1: Do9Rlu1R5u/AcRtMTl8SYg (big blind) folded before Flop
Seat 2: EMc5LPgVaded4Qc77vm0fw (button) (small blind) collected ($1)



PokerStars Game #59938353776:  Hold'em No Limit ($0.25/$0.50) - 2009/07/01 0:12:58 ET
Table '+dXkOAQyS8j9PQZusUTMpg' 2-max Seat #1 is the button
Seat 1: XFa6sBGjP2gxoIvxR3fZIg ($85.20 in chips)
Seat 2: 5IBeOgaApY1Bvzv2P8X4EA ($26.95 in chips)
XFa6sBGjP2gxoIvxR3fZIg: posts small blind $0.25
5IBeOgaApY1Bvzv2P8X4EA: posts big blind $0.50
*** HOLE CARDS ***
XFa6sBGjP2gxoIvxR3fZIg: folds
5IBeOgaApY1Bvzv2P8X4EA collected $0.50 from pot
5IBeOgaApY1Bvzv2P8X4EA: doesn't show hand
*** SUMMARY ***
Total pot $0.50 | Rake $0
Seat 1: XFa6sBGjP2gxoIvxR3fZIg (button) (small blind) folded before Flop
Seat 2: 5IBeOgaApY1Bvzv2P8X4EA (big blind) collected ($0.50)



PokerStars Game #59938355326:  Hold'em No Limit ($0.25/$0.50) - 2009/07/01 0:13:00 ET
Table 'E7bWJ45aoFXRpyRv2gw+Ig' 2-max Seat #1 is the button
Seat 1: FRkiRasEGlHUeLrEl+k/nA ($80.60 in chips)
Seat 2: 3Wro85I7472vJ4Wkpneo9A ($42.25 in chips)
FRkiRasEGlHUeLrEl+k/nA: posts small blind $0.25
3Wro85I7472vJ4Wkpneo9A: posts big blind $0.50
*** HOLE CARDS ***
FRkiRasEGlHUeLrEl+k/nA: raises $1 to $1.50
3Wro85I7472vJ4Wkpneo9A: folds
FRkiRasEGlHUeLrEl+k/nA collected $1 from pot
*** SUMMARY ***
Total pot $1 | Rake $0
Seat 1: FRkiRasEGlHUeLrEl+k/nA (button) (small blind) collected ($1)
Seat 2: 3Wro85I7472vJ4Wkpneo9A (big blind) folded before Flop



PokerStars Game #59938355804:  Hold'em No Limit ($0.25/$0.50) - 2009/07/01 0:13:01 ET
Table 'm95HVfesC/VPgfGEjPuaIA' 2-max Seat #2 is the button
Seat 1: Fp/oksNpipCrD2MJ2pH20g ($17.20 in chips)
Seat 2: Ag6DvxX4vbRheqsv2zXKTQ ($17.05 in chips)
Ag6DvxX4vbRheqsv2zXKTQ: posts small blind $0.25
Fp/oksNpipCrD2MJ2pH20g: posts big blind $0.50
*** HOLE CARDS ***
Ag6DvxX4vbRheqsv2zXKTQ: folds
Fp/oksNpipCrD2MJ2pH20g collected $0.50 from pot
Fp/oksNpipCrD2MJ2pH20g: doesn't show hand
*** SUMMARY ***
Total pot $0.50 | Rake $0
Seat 1: Fp/oksNpipCrD2MJ2pH20g (big blind) collected ($0.50)
Seat 2: Ag6DvxX4vbRheqsv2zXKTQ (button) (small blind) folded before Flop



PokerStars Game #59938355514:  Hold'em No Limit ($0.25/$0.50) - 2009/07/01 0:13:01 ET
Table 'kgbJRsxfv64KrErDRBAkcw' 6-max Seat #3 is the button
Seat 1: YmWlPGOKFuJSoJZPW8a8IA ($79.80 in chips)
Seat 2: Q+thC23WCv1kJUJtH/+4Jw ($31.20 in chips)
Seat 3: T0Gx/FcQ5VH9u7XaOMX97A ($65.25 in chips)
Seat 4: qanMEqjABjWxC/JgQ/0l7w ($62.95 in chips)
Seat 5: +Pf9jTVizYlIo+woPvptfA ($50 in chips)
Seat 6: DDfYzIrYT0t5R/hAJngtsg ($21.05 in chips)
qanMEqjABjWxC/JgQ/0l7w: posts small blind $0.25
+Pf9jTVizYlIo+woPvptfA: posts big blind $0.50
*** HOLE CARDS ***
DDfYzIrYT0t5R/hAJngtsg: raises $0.50 to $1
YmWlPGOKFuJSoJZPW8a8IA: raises $3 to $4
Q+thC23WCv1kJUJtH/+4Jw: folds
T0Gx/FcQ5VH9u7XaOMX97A: folds
qanMEqjABjWxC/JgQ/0l7w: folds
+Pf9jTVizYlIo+woPvptfA: folds
DDfYzIrYT0t5R/hAJngtsg: folds
YmWlPGOKFuJSoJZPW8a8IA collected $2.75 from pot
YmWlPGOKFuJSoJZPW8a8IA: doesn't show hand
*** SUMMARY ***
Total pot $2.75 | Rake $0
Seat 1: YmWlPGOKFuJSoJZPW8a8IA collected ($2.75)
Seat 2: Q+thC23WCv1kJUJtH/+4Jw folded before Flop (didn't bet)
Seat 3: T0Gx/FcQ5VH9u7XaOMX97A (button) folded before Flop (didn't bet)
Seat 4: qanMEqjABjWxC/JgQ/0l7w (small blind) folded before Flop
Seat 5: +Pf9jTVizYlIo+woPvptfA (big blind) folded before Flop
Seat 6: DDfYzIrYT0t5R/hAJngtsg folded before Flop



PokerStars Game #59938356334:  Hold'em No Limit ($0.25/$0.50) - 2009/07/01 0:13:02 ET
Table '+z1aekfHkpp09pc8F9aViw' 6-max Seat #3 is the button
Seat 1: lWwl5C/UZOsWNubdUqghZw ($50.45 in chips)
Seat 2: VuB2GN0h94yY+QbuI2Mybg ($22.15 in chips)
Seat 3: uUznlIMFnRUvwrBhYF73KA ($49.45 in chips)
Seat 4: OCrv7ObFH4/s2lv7rYOnsQ ($23.40 in chips)
Seat 5: crjGpJEzSZgD38FoE3VMGg ($65.15 in chips)
Seat 6: 686aeHikcJlgKkSuIFdcXQ ($71.25 in chips)
OCrv7ObFH4/s2lv7rYOnsQ: posts small blind $0.25
crjGpJEzSZgD38FoE3VMGg: posts big blind $0.50
*** HOLE CARDS ***
686aeHikcJlgKkSuIFdcXQ: folds
lWwl5C/UZOsWNubdUqghZw is disconnected
lWwl5C/UZOsWNubdUqghZw has timed out while disconnected
lWwl5C/UZOsWNubdUqghZw: folds
lWwl5C/UZOsWNubdUqghZw is sitting out
VuB2GN0h94yY+QbuI2Mybg: calls $0.50
uUznlIMFnRUvwrBhYF73KA: folds
OCrv7ObFH4/s2lv7rYOnsQ: calls $0.25
lWwl5C/UZOsWNubdUqghZw is connected
crjGpJEzSZgD38FoE3VMGg: checks
*** FLOP *** [3d Ac Jd]
OCrv7ObFH4/s2lv7rYOnsQ: checks
crjGpJEzSZgD38FoE3VMGg: checks
VuB2GN0h94yY+QbuI2Mybg: checks
*** TURN *** [3d Ac Jd] [9h]
OCrv7ObFH4/s2lv7rYOnsQ: bets $1
crjGpJEzSZgD38FoE3VMGg: folds
VuB2GN0h94yY+QbuI2Mybg: folds
OCrv7ObFH4/s2lv7rYOnsQ collected $1.45 from pot
*** SUMMARY ***
Total pot $1.50 | Rake $0.05
Board [3d Ac Jd 9h]
Seat 1: lWwl5C/UZOsWNubdUqghZw folded before Flop (didn't bet)
Seat 2: VuB2GN0h94yY+QbuI2Mybg folded on the Turn
Seat 3: uUznlIMFnRUvwrBhYF73KA (button) folded before Flop (didn't bet)
Seat 4: OCrv7ObFH4/s2lv7rYOnsQ (small blind) collected ($1.45)
Seat 5: crjGpJEzSZgD38FoE3VMGg (big blind) folded on the Turn
Seat 6: 686aeHikcJlgKkSuIFdcXQ folded before Flop (didn't bet)



PokerStars Game #59938357048:  Hold'em No Limit ($0.25/$0.50) - 2009/07/01 0:13:03 ET
Table 'QOgaEqMcJ73pcUMMxoisUg' 6-max Seat #3 is the button
Seat 1: RFefXIDyFvNtJLq+CloCzA ($42.45 in chips)
Seat 2: Im2p1Nt83UKSqv5c9frm4Q ($50 in chips)
Seat 3: wUZNozoIDYf+16hp4nn6dw ($38.10 in chips)
Seat 4: zAcsDhG/T128Vn7XGVSgKg ($59.95 in chips)
Seat 6: s83dnhZ6VC53vY0/f6OV/g ($48.50 in chips)
zAcsDhG/T128Vn7XGVSgKg: posts small blind $0.25
s83dnhZ6VC53vY0/f6OV/g: posts big blind $0.50
*** HOLE CARDS ***
RFefXIDyFvNtJLq+CloCzA: folds
Im2p1Nt83UKSqv5c9frm4Q: folds
wUZNozoIDYf+16hp4nn6dw: folds
zAcsDhG/T128Vn7XGVSgKg: folds
s83dnhZ6VC53vY0/f6OV/g collected $0.50 from pot
*** SUMMARY ***
Total pot $0.50 | Rake $0
Seat 1: RFefXIDyFvNtJLq+CloCzA folded before Flop (didn't bet)
Seat 2: Im2p1Nt83UKSqv5c9frm4Q folded before Flop (didn't bet)
Seat 3: wUZNozoIDYf+16hp4nn6dw (button) folded before Flop (didn't bet)
Seat 4: zAcsDhG/T128Vn7XGVSgKg (small blind) folded before Flop
Seat 6: s83dnhZ6VC53vY0/f6OV/g (big blind) collected ($0.50)



PokerStars Game #59938357880:  Hold'em No Limit ($0.25/$0.50) - 2009/07/01 0:13:04 ET
Table 'c/CRn+68J3Y8KxD5g1ek2Q' 2-max Seat #2 is the button
Seat 1: 46qCyJ6evTkHo9al5sBMNA ($316.75 in chips)
Seat 2: BypVLsYQt3ePFm2xQL/dOA ($68.20 in chips)
BypVLsYQt3ePFm2xQL/dOA: posts small blind $0.25
46qCyJ6evTkHo9al5sBMNA: posts big blind $0.50
*** HOLE CARDS ***
BypVLsYQt3ePFm2xQL/dOA: raises $1.50 to $2
46qCyJ6evTkHo9al5sBMNA: calls $1.50
*** FLOP *** [Kh 7d 5h]
46qCyJ6evTkHo9al5sBMNA: checks
BypVLsYQt3ePFm2xQL/dOA: bets $2.50
46qCyJ6evTkHo9al5sBMNA: folds
BypVLsYQt3ePFm2xQL/dOA collected $3.80 from pot
BypVLsYQt3ePFm2xQL/dOA: doesn't show hand
*** SUMMARY ***
Total pot $4 | Rake $0.20
Board [Kh 7d 5h]
Seat 1: 46qCyJ6evTkHo9al5sBMNA (big blind) folded on the Flop
Seat 2: BypVLsYQt3ePFm2xQL/dOA (button) (small blind) collected ($3.80)



PokerStars Game #59938358474:  Hold'em No Limit ($0.25/$0.50) - 2009/07/01 0:13:05 ET
Table '+dXkOAQyS8j9PQZusUTMpg' 2-max Seat #2 is the button
Seat 1: XFa6sBGjP2gxoIvxR3fZIg ($84.95 in chips)
Seat 2: 5IBeOgaApY1Bvzv2P8X4EA ($27.20 in chips)
5IBeOgaApY1Bvzv2P8X4EA: posts small blind $0.25
XFa6sBGjP2gxoIvxR3fZIg: posts big blind $0.50
*** HOLE CARDS ***
5IBeOgaApY1Bvzv2P8X4EA said, "jajajajajja"
5IBeOgaApY1Bvzv2P8X4EA: folds
XFa6sBGjP2gxoIvxR3fZIg collected $0.50 from pot
XFa6sBGjP2gxoIvxR3fZIg: doesn't show hand
*** SUMMARY ***
Total pot $0.50 | Rake $0
Seat 1: XFa6sBGjP2gxoIvxR3fZIg (big blind) collected ($0.50)
Seat 2: 5IBeOgaApY1Bvzv2P8X4EA (button) (small blind) folded before Flop



PokerStars Game #59938359836:  Hold'em No Limit ($0.25/$0.50) - 2009/07/01 0:13:07 ET
Table 'mTxf8gPLgffN3Iwfm7Icfg' 2-max Seat #1 is the button
Seat 1: Do9Rlu1R5u/AcRtMTl8SYg ($59.60 in chips)
Seat 2: EMc5LPgVaded4Qc77vm0fw ($53.80 in chips)
Do9Rlu1R5u/AcRtMTl8SYg: posts small blind $0.25
EMc5LPgVaded4Qc77vm0fw: posts big blind $0.50
*** HOLE CARDS ***
Do9Rlu1R5u/AcRtMTl8SYg: raises $1 to $1.50
EMc5LPgVaded4Qc77vm0fw: calls $1
*** FLOP *** [3c 9s 6s]
EMc5LPgVaded4Qc77vm0fw: checks
Do9Rlu1R5u/AcRtMTl8SYg: checks
*** TURN *** [3c 9s 6s] [Ks]
EMc5LPgVaded4Qc77vm0fw: bets $2.50
Do9Rlu1R5u/AcRtMTl8SYg: folds
EMc5LPgVaded4Qc77vm0fw collected $2.85 from pot
EMc5LPgVaded4Qc77vm0fw: doesn't show hand
*** SUMMARY ***
Total pot $3 | Rake $0.15
Board [3c 9s 6s Ks]
Seat 1: Do9Rlu1R5u/AcRtMTl8SYg (button) (small blind) folded on the Turn
Seat 2: EMc5LPgVaded4Qc77vm0fw (big blind) collected ($2.85)



PokerStars Game #59938359834:  Hold'em No Limit ($0.25/$0.50) - 2009/07/01 0:13:07 ET
Table 'm95HVfesC/VPgfGEjPuaIA' 2-max Seat #1 is the button
Seat 1: Fp/oksNpipCrD2MJ2pH20g ($17.45 in chips)
Seat 2: Ag6DvxX4vbRheqsv2zXKTQ ($16.80 in chips)
Fp/oksNpipCrD2MJ2pH20g: posts small blind $0.25
Ag6DvxX4vbRheqsv2zXKTQ: posts big blind $0.50
*** HOLE CARDS ***
Fp/oksNpipCrD2MJ2pH20g: calls $0.25
Ag6DvxX4vbRheqsv2zXKTQ: checks
*** FLOP *** [Qd 2s 7c]
Ag6DvxX4vbRheqsv2zXKTQ: checks
Fp/oksNpipCrD2MJ2pH20g: checks
*** TURN *** [Qd 2s 7c] [6h]
Ag6DvxX4vbRheqsv2zXKTQ: bets $1
Fp/oksNpipCrD2MJ2pH20g: folds
Ag6DvxX4vbRheqsv2zXKTQ collected $0.95 from pot
*** SUMMARY ***
Total pot $1 | Rake $0.05
Board [Qd 2s 7c 6h]
Seat 1: Fp/oksNpipCrD2MJ2pH20g (button) (small blind) folded on the Turn
Seat 2: Ag6DvxX4vbRheqsv2zXKTQ (big blind) collected ($0.95)



PokerStars Game #59938360154:  Hold'em No Limit ($0.25/$0.50) - 2009/07/01 0:13:07 ET
Table 'raOT4/ipuZgzjfKHC+jD9g' 2-max Seat #1 is the button
Seat 1: IuwLemwLhc9fvrwBGs0AMA ($12.70 in chips)
Seat 2: Udr5juWSWUgTu1NlRhjMdA ($10.25 in chips)
IuwLemwLhc9fvrwBGs0AMA: posts small blind $0.25
Udr5juWSWUgTu1NlRhjMdA: posts big blind $0.50
*** HOLE CARDS ***
IuwLemwLhc9fvrwBGs0AMA: folds
Udr5juWSWUgTu1NlRhjMdA collected $0.50 from pot
Udr5juWSWUgTu1NlRhjMdA: doesn't show hand
*** SUMMARY ***
Total pot $0.50 | Rake $0
Seat 1: IuwLemwLhc9fvrwBGs0AMA (button) (small blind) folded before Flop
Seat 2: Udr5juWSWUgTu1NlRhjMdA (big blind) collected ($0.50)



PokerStars Game #59938360722:  Hold'em No Limit ($0.25/$0.50) - 2009/07/01 0:13:08 ET
Table 'Vdlc9wqYcHTUhtdyN7CuJw' 2-max Seat #2 is the button
Seat 1: yBO+mXB6m/rCft2ErwGf/Q ($83.10 in chips)
Seat 2: sa0qgETiL3HNbdfGlnKHTA ($28.45 in chips)
sa0qgETiL3HNbdfGlnKHTA: posts small blind $0.25
yBO+mXB6m/rCft2ErwGf/Q: posts big blind $0.50
*** HOLE CARDS ***
sa0qgETiL3HNbdfGlnKHTA: raises $1 to $1.50
yBO+mXB6m/rCft2ErwGf/Q: folds
sa0qgETiL3HNbdfGlnKHTA collected $1 from pot
sa0qgETiL3HNbdfGlnKHTA: doesn't show hand
*** SUMMARY ***
Total pot $1 | Rake $0
Seat 1: yBO+mXB6m/rCft2ErwGf/Q (big blind) folded before Flop
Seat 2: sa0qgETiL3HNbdfGlnKHTA (button) (small blind) collected ($1)



PokerStars Game #59938360412:  Hold'em No Limit ($0.25/$0.50) - 2009/07/01 0:13:08 ET
Table '3FhG0gl3kMX3wBEEqj+wnQ' 9-max Seat #8 is the button
Seat 1: e0J9pdCNUDTCG031RnXqLA ($25.45 in chips)
Seat 2: 4dl3YNqZ6Houm2jZAzDmRg ($25.25 in chips)
Seat 3: bXpVeaSTPBFSPJmeXxO7nw ($10 in chips)
Seat 4: bz4LMfV0GGl/MJ/ABXuPmg ($13.90 in chips)
Seat 5: XNMDwbXt/Q4jM99AXnbJDw ($50 in chips)
Seat 6: 5JJVDlaiMnB004o/RqbZZQ ($26 in chips)
Seat 8: j3K/Jujr7PY4ZM2RZvlH6A ($58.35 in chips)
Seat 9: tzoXBDwkkPV/XPJPkf963Q ($13.30 in chips)
tzoXBDwkkPV/XPJPkf963Q: posts small blind $0.25
e0J9pdCNUDTCG031RnXqLA: posts big blind $0.50
mSD1pginDsyHG5PDfqzphw: sits out
*** HOLE CARDS ***
4dl3YNqZ6Houm2jZAzDmRg: folds
bXpVeaSTPBFSPJmeXxO7nw: folds
bz4LMfV0GGl/MJ/ABXuPmg: calls $0.50
XNMDwbXt/Q4jM99AXnbJDw: folds
5JJVDlaiMnB004o/RqbZZQ: folds
j3K/Jujr7PY4ZM2RZvlH6A: raises $1 to $1.50
tzoXBDwkkPV/XPJPkf963Q: folds
e0J9pdCNUDTCG031RnXqLA: folds
bz4LMfV0GGl/MJ/ABXuPmg: calls $1
*** FLOP *** [8d Jh Jd]
bz4LMfV0GGl/MJ/ABXuPmg: checks
j3K/Jujr7PY4ZM2RZvlH6A: bets $2.50
bz4LMfV0GGl/MJ/ABXuPmg: calls $2.50
*** TURN *** [8d Jh Jd] [7c]
bz4LMfV0GGl/MJ/ABXuPmg: checks
j3K/Jujr7PY4ZM2RZvlH6A: bets $5.50
bz4LMfV0GGl/MJ/ABXuPmg: calls $5.50
*** RIVER *** [8d Jh Jd 7c] [Qh]
bz4LMfV0GGl/MJ/ABXuPmg: bets $4.40 and is all-in
j3K/Jujr7PY4ZM2RZvlH6A: calls $4.40
*** SHOW DOWN ***
bz4LMfV0GGl/MJ/ABXuPmg: shows [Ks Kc] (two pair, Kings and Jacks)
j3K/Jujr7PY4ZM2RZvlH6A: mucks hand
bz4LMfV0GGl/MJ/ABXuPmg collected $27.20 from pot
*** SUMMARY ***
Total pot $28.55 | Rake $1.35
Board [8d Jh Jd 7c Qh]
Seat 1: e0J9pdCNUDTCG031RnXqLA (big blind) folded before Flop
Seat 2: 4dl3YNqZ6Houm2jZAzDmRg folded before Flop (didn't bet)
Seat 3: bXpVeaSTPBFSPJmeXxO7nw folded before Flop (didn't bet)
Seat 4: bz4LMfV0GGl/MJ/ABXuPmg showed [Ks Kc] and won ($27.20) with two pair, Kings and Jacks
Seat 5: XNMDwbXt/Q4jM99AXnbJDw folded before Flop (didn't bet)
Seat 6: 5JJVDlaiMnB004o/RqbZZQ folded before Flop (didn't bet)
Seat 8: j3K/Jujr7PY4ZM2RZvlH6A (button) mucked
Seat 9: tzoXBDwkkPV/XPJPkf963Q (small blind) folded before Flop



PokerStars Game #59938361340:  Hold'em No Limit ($0.25/$0.50) - 2009/07/01 0:13:09 ET
Table 'E7bWJ45aoFXRpyRv2gw+Ig' 2-max Seat #2 is the button
Seat 1: FRkiRasEGlHUeLrEl+k/nA ($81.10 in chips)
Seat 2: 3Wro85I7472vJ4Wkpneo9A ($41.75 in chips)
3Wro85I7472vJ4Wkpneo9A: posts small blind $0.25
FRkiRasEGlHUeLrEl+k/nA: posts big blind $0.50
*** HOLE CARDS ***
3Wro85I7472vJ4Wkpneo9A: raises $1 to $1.50
FRkiRasEGlHUeLrEl+k/nA: folds
3Wro85I7472vJ4Wkpneo9A collected $1 from pot
3Wro85I7472vJ4Wkpneo9A: doesn't show hand
*** SUMMARY ***
Total pot $1 | Rake $0
Seat 1: FRkiRasEGlHUeLrEl+k/nA (big blind) folded before Flop
Seat 2: 3Wro85I7472vJ4Wkpneo9A (button) (small blind) collected ($1)



PokerStars Game #59938362264:  Hold'em No Limit ($0.25/$0.50) - 2009/07/01 0:13:10 ET
Table 'MJxeZCzYELxiIsyUZyT0jw' 6-max Seat #3 is the button
Seat 1: iKPos8JI094Tomq4tDSgnQ ($34.05 in chips)
Seat 2: r6H1GiZ6QIpMTDhyodKuRQ ($64.15 in chips)
Seat 3: JQZew0FjzS19kTjeNtrE+A ($50 in chips)
Seat 4: lP7Q6pewz4C2RsAfKsjdWw ($23.10 in chips)
Seat 5: 3jvoOXNtXE90w2BdfNZwZQ ($50 in chips)
Seat 6: TTx3CHxyi0SObcHyMJRp5w ($49.30 in chips)
lP7Q6pewz4C2RsAfKsjdWw: posts small blind $0.25
3jvoOXNtXE90w2BdfNZwZQ: posts big blind $0.50
*** HOLE CARDS ***
TTx3CHxyi0SObcHyMJRp5w: folds
iKPos8JI094Tomq4tDSgnQ: folds
r6H1GiZ6QIpMTDhyodKuRQ: folds
JQZew0FjzS19kTjeNtrE+A: folds
lP7Q6pewz4C2RsAfKsjdWw: calls $0.25
3jvoOXNtXE90w2BdfNZwZQ: checks
*** FLOP *** [As 7h 3c]
lP7Q6pewz4C2RsAfKsjdWw: checks
3jvoOXNtXE90w2BdfNZwZQ: bets $1
lP7Q6pewz4C2RsAfKsjdWw: calls $1
*** TURN *** [As 7h 3c] [5d]
lP7Q6pewz4C2RsAfKsjdWw: checks
3jvoOXNtXE90w2BdfNZwZQ: bets $2.50
lP7Q6pewz4C2RsAfKsjdWw: folds
3jvoOXNtXE90w2BdfNZwZQ collected $2.90 from pot
3jvoOXNtXE90w2BdfNZwZQ: doesn't show hand
*** SUMMARY ***
Total pot $3 | Rake $0.10
Board [As 7h 3c 5d]
Seat 1: iKPos8JI094Tomq4tDSgnQ folded before Flop (didn't bet)
Seat 2: r6H1GiZ6QIpMTDhyodKuRQ folded before Flop (didn't bet)
Seat 3: JQZew0FjzS19kTjeNtrE+A (button) folded before Flop (didn't bet)
Seat 4: lP7Q6pewz4C2RsAfKsjdWw (small blind) folded on the Turn
Seat 5: 3jvoOXNtXE90w2BdfNZwZQ (big blind) collected ($2.90)
Seat 6: TTx3CHxyi0SObcHyMJRp5w folded before Flop (didn't bet)



PokerStars Game #59938363298:  Hold'em No Limit ($0.25/$0.50) - 2009/07/01 0:13:12 ET
Table '+dXkOAQyS8j9PQZusUTMpg' 2-max Seat #1 is the button
Seat 1: XFa6sBGjP2gxoIvxR3fZIg ($85.20 in chips)
Seat 2: 5IBeOgaApY1Bvzv2P8X4EA ($26.95 in chips)
XFa6sBGjP2gxoIvxR3fZIg: posts small blind $0.25
5IBeOgaApY1Bvzv2P8X4EA: posts big blind $0.50
*** HOLE CARDS ***
5IBeOgaApY1Bvzv2P8X4EA said, "was to high"
XFa6sBGjP2gxoIvxR3fZIg: raises $1 to $1.50
5IBeOgaApY1Bvzv2P8X4EA said, ":s"
5IBeOgaApY1Bvzv2P8X4EA: folds
XFa6sBGjP2gxoIvxR3fZIg collected $1 from pot
*** SUMMARY ***
Total pot $1 | Rake $0
Seat 1: XFa6sBGjP2gxoIvxR3fZIg (button) (small blind) collected ($1)
Seat 2: 5IBeOgaApY1Bvzv2P8X4EA (big blind) folded before Flop



PokerStars Game #59938364840:  Hold'em No Limit ($0.25/$0.50) - 2009/07/01 0:13:14 ET
Table '5EmHi+fnatGQQShcNmzOZQ' 6-max Seat #3 is the button
Seat 1: SwPczQo3cOtwEzhJrfO2cQ ($21.75 in chips)
Seat 2: APwvTk5XojDXGoQLb4O5iA ($30 in chips)
Seat 3: J8dF2sYMvXUmAGUuSW9kwg ($22.95 in chips)
Seat 4: mFTuMjESuBcXHQ1ePkg/8A ($28.95 in chips)
Seat 5: kxPhs4ePFqMy52CInAJ2aw ($69.55 in chips)
Seat 6: 686aeHikcJlgKkSuIFdcXQ ($114.70 in chips)
mFTuMjESuBcXHQ1ePkg/8A: posts small blind $0.25
kxPhs4ePFqMy52CInAJ2aw: posts big blind $0.50
*** HOLE CARDS ***
686aeHikcJlgKkSuIFdcXQ: folds
SwPczQo3cOtwEzhJrfO2cQ: raises $0.50 to $1
APwvTk5XojDXGoQLb4O5iA: calls $1
J8dF2sYMvXUmAGUuSW9kwg: calls $1
mFTuMjESuBcXHQ1ePkg/8A: folds
kxPhs4ePFqMy52CInAJ2aw: calls $0.50
*** FLOP *** [Jh 6c 8s]
mFTuMjESuBcXHQ1ePkg/8A leaves the table
kxPhs4ePFqMy52CInAJ2aw: checks
SwPczQo3cOtwEzhJrfO2cQ: bets $1
wOyVV9M/oyiw3YaOjNZ05w joins the table at seat #4
APwvTk5XojDXGoQLb4O5iA: folds
J8dF2sYMvXUmAGUuSW9kwg: calls $1
kxPhs4ePFqMy52CInAJ2aw: folds
*** TURN *** [Jh 6c 8s] [8h]
SwPczQo3cOtwEzhJrfO2cQ: bets $1
J8dF2sYMvXUmAGUuSW9kwg: calls $1
*** RIVER *** [Jh 6c 8s 8h] [Kh]
SwPczQo3cOtwEzhJrfO2cQ: bets $2
J8dF2sYMvXUmAGUuSW9kwg: calls $2
*** SHOW DOWN ***
SwPczQo3cOtwEzhJrfO2cQ: shows [Kd Js] (two pair, Kings and Jacks)
J8dF2sYMvXUmAGUuSW9kwg: mucks hand
SwPczQo3cOtwEzhJrfO2cQ collected $11.70 from pot
*** SUMMARY ***
Total pot $12.25 | Rake $0.55
Board [Jh 6c 8s 8h Kh]
Seat 1: SwPczQo3cOtwEzhJrfO2cQ showed [Kd Js] and won ($11.70) with two pair, Kings and Jacks
Seat 2: APwvTk5XojDXGoQLb4O5iA folded on the Flop
Seat 3: J8dF2sYMvXUmAGUuSW9kwg (button) mucked
Seat 4: mFTuMjESuBcXHQ1ePkg/8A (small blind) folded before Flop
Seat 5: kxPhs4ePFqMy52CInAJ2aw (big blind) folded on the Flop
Seat 6: 686aeHikcJlgKkSuIFdcXQ folded before Flop (didn't bet)



PokerStars Game #59938365066:  Hold'em No Limit ($0.25/$0.50) - 2009/07/01 0:13:14 ET
Table 'lSisgp6H7Fg1hH5VfjEjYQ' 9-max Seat #9 is the button
Seat 1: pEW8B6uXbdR47kfljMQ3+Q ($39.20 in chips)
Seat 2: UrcnkQOiLVk8BlKDPJSy7Q ($51.85 in chips)
Seat 3: aTkyjTh3w5YLWiIERupZOA ($30.95 in chips)
Seat 4: nvw9yQKhJT56lA9k+TLdhw ($11.70 in chips)
Seat 5: mSD1pginDsyHG5PDfqzphw ($10 in chips)
Seat 6: +k7T5ocke8UwavtgUHm+Cg ($22.15 in chips)
Seat 7: dGw5MBstXyXhWHHVFOWOFA ($50 in chips)
Seat 8: a4JDWmpFQkL10XfAyuF51A ($30 in chips)
Seat 9: 5JJVDlaiMnB004o/RqbZZQ ($40.80 in chips)
pEW8B6uXbdR47kfljMQ3+Q: posts small blind $0.25
UrcnkQOiLVk8BlKDPJSy7Q: posts big blind $0.50
dGw5MBstXyXhWHHVFOWOFA: posts big blind $0.50
a4JDWmpFQkL10XfAyuF51A: posts big blind $0.50
*** HOLE CARDS ***
aTkyjTh3w5YLWiIERupZOA: raises $1 to $1.50
nvw9yQKhJT56lA9k+TLdhw: folds
mSD1pginDsyHG5PDfqzphw: folds
+k7T5ocke8UwavtgUHm+Cg: folds
dGw5MBstXyXhWHHVFOWOFA: calls $1
a4JDWmpFQkL10XfAyuF51A: folds
5JJVDlaiMnB004o/RqbZZQ: folds
pEW8B6uXbdR47kfljMQ3+Q: folds
UrcnkQOiLVk8BlKDPJSy7Q: folds
*** FLOP *** [Td 9s 8s]
aTkyjTh3w5YLWiIERupZOA: bets $1.50
dGw5MBstXyXhWHHVFOWOFA: calls $1.50
*** TURN *** [Td 9s 8s] [5h]
aTkyjTh3w5YLWiIERupZOA: checks
dGw5MBstXyXhWHHVFOWOFA: bets $4
aTkyjTh3w5YLWiIERupZOA: calls $4
*** RIVER *** [Td 9s 8s 5h] [Kd]
aTkyjTh3w5YLWiIERupZOA: checks
dGw5MBstXyXhWHHVFOWOFA: checks
*** SHOW DOWN ***
aTkyjTh3w5YLWiIERupZOA: shows [7c 8c] (a pair of Eights)
dGw5MBstXyXhWHHVFOWOFA: mucks hand
aTkyjTh3w5YLWiIERupZOA collected $14.55 from pot
*** SUMMARY ***
Total pot $15.25 | Rake $0.70
Board [Td 9s 8s 5h Kd]
Seat 1: pEW8B6uXbdR47kfljMQ3+Q (small blind) folded before Flop
Seat 2: UrcnkQOiLVk8BlKDPJSy7Q (big blind) folded before Flop
Seat 3: aTkyjTh3w5YLWiIERupZOA showed [7c 8c] and won ($14.55) with a pair of Eights
Seat 4: nvw9yQKhJT56lA9k+TLdhw folded before Flop (didn't bet)
Seat 5: mSD1pginDsyHG5PDfqzphw folded before Flop (didn't bet)
Seat 6: +k7T5ocke8UwavtgUHm+Cg folded before Flop (didn't bet)
Seat 7: dGw5MBstXyXhWHHVFOWOFA mucked
Seat 8: a4JDWmpFQkL10XfAyuF51A folded before Flop
Seat 9: 5JJVDlaiMnB004o/RqbZZQ (button) folded before Flop (didn't bet)



PokerStars Game #59938365274:  Hold'em No Limit ($0.25/$0.50) - 2009/07/01 0:13:15 ET
Table 'ZYwMb9E6tY50Qm+iNbXRYw' 2-max Seat #2 is the button
Seat 1: DXLfRb8KDZWmrztw2bwtFw ($33.40 in chips)
Seat 2: 16tvT7AYgZ2LgiGFcvFKQg ($4.60 in chips)
16tvT7AYgZ2LgiGFcvFKQg: posts small blind $0.25
DXLfRb8KDZWmrztw2bwtFw: posts big blind $0.50
*** HOLE CARDS ***
16tvT7AYgZ2LgiGFcvFKQg: raises $0.50 to $1
DXLfRb8KDZWmrztw2bwtFw: folds
16tvT7AYgZ2LgiGFcvFKQg collected $1 from pot
16tvT7AYgZ2LgiGFcvFKQg: doesn't show hand
*** SUMMARY ***
Total pot $1 | Rake $0
Seat 1: DXLfRb8KDZWmrztw2bwtFw (big blind) folded before Flop
Seat 2: 16tvT7AYgZ2LgiGFcvFKQg (button) (small blind) collected ($1)



PokerStars Game #59938366322:  Hold'em No Limit ($0.25/$0.50) - 2009/07/01 0:13:16 ET
Table '37qXEp3oe+er5q4CZip9eQ' 6-max Seat #1 is the button
Seat 1: oqOqoO2AyCZenUghCxMDxw ($50 in chips)
Seat 2: g12O9qXTybyo2C0B2bXgjg ($27.15 in chips)
Seat 3: Rt6KgtZ8YaJoTc3FPim00w ($100.20 in chips)
Seat 4: L0aIPg7qefDQjdJo3HCVEA ($20.25 in chips)
Seat 5: VOmI0x4dDPnTESZd5B4d1Q ($39.75 in chips)
Seat 6: f7zPpUQp9hHZgqhEvrUWQw ($53.65 in chips)
g12O9qXTybyo2C0B2bXgjg: posts small blind $0.25
Rt6KgtZ8YaJoTc3FPim00w: posts big blind $0.50
*** HOLE CARDS ***
L0aIPg7qefDQjdJo3HCVEA: folds
VOmI0x4dDPnTESZd5B4d1Q: calls $0.50
f7zPpUQp9hHZgqhEvrUWQw: folds
oqOqoO2AyCZenUghCxMDxw: calls $0.50
g12O9qXTybyo2C0B2bXgjg: raises $1 to $1.50
Rt6KgtZ8YaJoTc3FPim00w: folds
VOmI0x4dDPnTESZd5B4d1Q: calls $1
oqOqoO2AyCZenUghCxMDxw: calls $1
*** FLOP *** [6h Kh Tc]
g12O9qXTybyo2C0B2bXgjg: bets $2
VOmI0x4dDPnTESZd5B4d1Q: folds
oqOqoO2AyCZenUghCxMDxw: folds
g12O9qXTybyo2C0B2bXgjg collected $4.75 from pot
*** SUMMARY ***
Total pot $5 | Rake $0.25
Board [6h Kh Tc]
Seat 1: oqOqoO2AyCZenUghCxMDxw (button) folded on the Flop
Seat 2: g12O9qXTybyo2C0B2bXgjg (small blind) collected ($4.75)
Seat 3: Rt6KgtZ8YaJoTc3FPim00w (big blind) folded before Flop
Seat 4: L0aIPg7qefDQjdJo3HCVEA folded before Flop (didn't bet)
Seat 5: VOmI0x4dDPnTESZd5B4d1Q folded on the Flop
Seat 6: f7zPpUQp9hHZgqhEvrUWQw folded before Flop (didn't bet)



PokerStars Game #59938366448:  Hold'em No Limit ($0.25/$0.50) - 2009/07/01 0:13:16 ET
Table 'Nz0Vr7WMHL2g5Uk7dDZjpw' 9-max Seat #6 is the button
Seat 1: tLkxo7JgV+WWI0UBw44K5A ($104.85 in chips)
Seat 3: 4QTiNH5fteLgJjx/s6Hy6A ($7.40 in chips)
Seat 4: 5JJVDlaiMnB004o/RqbZZQ ($27 in chips)
Seat 5: WGW0DgjBUXs1ylURHG8vnQ ($17.15 in chips)
Seat 6: k1f0lS7tlMHCLGs0JT34Tg ($8 in chips)
Seat 7: KPLH0gELgFe2OuAnhJFI5w ($21.95 in chips)
Seat 8: HkZI6g4zl83TDTA7SRspmQ ($17.25 in chips)
Seat 9: Ak2W6V2TDVIQrvSAy4eD7Q ($24.90 in chips)
KPLH0gELgFe2OuAnhJFI5w: posts small blind $0.25
HkZI6g4zl83TDTA7SRspmQ: posts big blind $0.50
*** HOLE CARDS ***
Ak2W6V2TDVIQrvSAy4eD7Q: folds
tLkxo7JgV+WWI0UBw44K5A: folds
4QTiNH5fteLgJjx/s6Hy6A: folds
5JJVDlaiMnB004o/RqbZZQ: folds
WGW0DgjBUXs1ylURHG8vnQ: calls $0.50
k1f0lS7tlMHCLGs0JT34Tg: folds
KPLH0gELgFe2OuAnhJFI5w: calls $0.25
HkZI6g4zl83TDTA7SRspmQ: checks
*** FLOP *** [3c Jh Qc]
KPLH0gELgFe2OuAnhJFI5w: checks
HkZI6g4zl83TDTA7SRspmQ: checks
WGW0DgjBUXs1ylURHG8vnQ: bets $0.50
KPLH0gELgFe2OuAnhJFI5w: folds
HkZI6g4zl83TDTA7SRspmQ: folds
WGW0DgjBUXs1ylURHG8vnQ collected $1.45 from pot
WGW0DgjBUXs1ylURHG8vnQ: doesn't show hand
*** SUMMARY ***
Total pot $1.50 | Rake $0.05
Board [3c Jh Qc]
Seat 1: tLkxo7JgV+WWI0UBw44K5A folded before Flop (didn't bet)
Seat 3: 4QTiNH5fteLgJjx/s6Hy6A folded before Flop (didn't bet)
Seat 4: 5JJVDlaiMnB004o/RqbZZQ folded before Flop (didn't bet)
Seat 5: WGW0DgjBUXs1ylURHG8vnQ collected ($1.45)
Seat 6: k1f0lS7tlMHCLGs0JT34Tg (button) folded before Flop (didn't bet)
Seat 7: KPLH0gELgFe2OuAnhJFI5w (small blind) folded on the Flop
Seat 8: HkZI6g4zl83TDTA7SRspmQ (big blind) folded on the Flop
Seat 9: Ak2W6V2TDVIQrvSAy4eD7Q folded before Flop (didn't bet)



PokerStars Game #59938367066:  Hold'em No Limit ($0.25/$0.50) - 2009/07/01 0:13:17 ET
Table 'raOT4/ipuZgzjfKHC+jD9g' 2-max Seat #2 is the button
Seat 1: IuwLemwLhc9fvrwBGs0AMA ($12.45 in chips)
Seat 2: Udr5juWSWUgTu1NlRhjMdA ($10.50 in chips)
Udr5juWSWUgTu1NlRhjMdA: posts small blind $0.25
IuwLemwLhc9fvrwBGs0AMA: posts big blind $0.50
*** HOLE CARDS ***
Udr5juWSWUgTu1NlRhjMdA: folds
IuwLemwLhc9fvrwBGs0AMA collected $0.50 from pot
*** SUMMARY ***
Total pot $0.50 | Rake $0
Seat 1: IuwLemwLhc9fvrwBGs0AMA (big blind) collected ($0.50)
Seat 2: Udr5juWSWUgTu1NlRhjMdA (button) (small blind) folded before Flop



PokerStars Game #59938368510:  Hold'em No Limit ($0.25/$0.50) - 2009/07/01 0:13:19 ET
Table '+dXkOAQyS8j9PQZusUTMpg' 2-max Seat #2 is the button
Seat 1: XFa6sBGjP2gxoIvxR3fZIg ($85.70 in chips)
Seat 2: 5IBeOgaApY1Bvzv2P8X4EA ($26.45 in chips)
5IBeOgaApY1Bvzv2P8X4EA: posts small blind $0.25
XFa6sBGjP2gxoIvxR3fZIg: posts big blind $0.50
*** HOLE CARDS ***
5IBeOgaApY1Bvzv2P8X4EA: folds
XFa6sBGjP2gxoIvxR3fZIg collected $0.50 from pot
*** SUMMARY ***
Total pot $0.50 | Rake $0
Seat 1: XFa6sBGjP2gxoIvxR3fZIg (big blind) collected ($0.50)
Seat 2: 5IBeOgaApY1Bvzv2P8X4EA (button) (small blind) folded before Flop



PokerStars Game #59938368442:  Hold'em No Limit ($0.25/$0.50) - 2009/07/01 0:13:19 ET
Table 'QOgaEqMcJ73pcUMMxoisUg' 6-max Seat #4 is the button
Seat 1: RFefXIDyFvNtJLq+CloCzA ($42.45 in chips)
Seat 2: Im2p1Nt83UKSqv5c9frm4Q ($50 in chips)
Seat 3: wUZNozoIDYf+16hp4nn6dw ($38.10 in chips)
Seat 4: zAcsDhG/T128Vn7XGVSgKg ($59.70 in chips)
Seat 6: s83dnhZ6VC53vY0/f6OV/g ($48.75 in chips)
s83dnhZ6VC53vY0/f6OV/g: posts small blind $0.25
RFefXIDyFvNtJLq+CloCzA: posts big blind $0.50
*** HOLE CARDS ***
Im2p1Nt83UKSqv5c9frm4Q: folds
wUZNozoIDYf+16hp4nn6dw: calls $0.50
zAcsDhG/T128Vn7XGVSgKg: raises $2 to $2.50
s83dnhZ6VC53vY0/f6OV/g: folds
RFefXIDyFvNtJLq+CloCzA: folds
wUZNozoIDYf+16hp4nn6dw: calls $2
*** FLOP *** [Ks 8c 9c]
wUZNozoIDYf+16hp4nn6dw: checks
zAcsDhG/T128Vn7XGVSgKg: bets $3
wUZNozoIDYf+16hp4nn6dw: raises $3 to $6
zAcsDhG/T128Vn7XGVSgKg: folds
wUZNozoIDYf+16hp4nn6dw collected $11.20 from pot
*** SUMMARY ***
Total pot $11.75 | Rake $0.55
Board [Ks 8c 9c]
Seat 1: RFefXIDyFvNtJLq+CloCzA (big blind) folded before Flop
Seat 2: Im2p1Nt83UKSqv5c9frm4Q folded before Flop (didn't bet)
Seat 3: wUZNozoIDYf+16hp4nn6dw collected ($11.20)
Seat 4: zAcsDhG/T128Vn7XGVSgKg (button) folded on the Flop
Seat 6: s83dnhZ6VC53vY0/f6OV/g (small blind) folded before Flop



PokerStars Game #59938369022:  Hold'em No Limit ($0.25/$0.50) - 2009/07/01 0:13:20 ET
Table 'QOgaEqMcJ73pcUMMxoisUgErOuyGLI5PT3G5MnpHgC/g Seat #7 is the button
Seat 1: k6GJzKs7T7qvQggW9g8Pdw ($56.90 in chips)
Seat 2: RjBdQ6w31rgcy0o24VLR6w ($10.95 in chips)
Seat 3: xZCXQSXlrZkp3pZizzVXCw ($50.50 in chips)
Seat 4: U7aZzIYWjv3SL30KtikLbw ($48.20 in chips)
Seat 5: JwvquocWfhTVApN5t47LgA ($44.05 in chips)
Seat 6: zE9cVigS2nW/Ljy4K4bUQA ($30 in chips)
Seat 7: 90Wb75h3W1BRpbqVnuk8gw ($67.95 in chips)
Seat 8: g4k0NXISyLCqaSWZDBjfEg ($50 in chips)
Seat 9: J0W5D97jl5VLky+IoPvDeA ($67.80 in chips)
g4k0NXISyLCqaSWZDBjfEg: posts small blind $0.25
J0W5D97jl5VLky+IoPvDeA: posts big blind $0.50
*** HOLE CARDS ***
k6GJzKs7T7qvQggW9g8Pdw: calls $0.50
RjBdQ6w31rgcy0o24VLR6w: folds
xZCXQSXlrZkp3pZizzVXCw: folds
U7aZzIYWjv3SL30KtikLbw: raises $2.70 to $3.20
JwvquocWfhTVApN5t47LgA: folds
zE9cVigS2nW/Ljy4K4bUQA: folds
90Wb75h3W1BRpbqVnuk8gw: folds
g4k0NXISyLCqaSWZDBjfEg: folds
J0W5D97jl5VLky+IoPvDeA: folds
k6GJzKs7T7qvQggW9g8Pdw: calls $2.70
*** FLOP *** [5h 6c Kc]
k6GJzKs7T7qvQggW9g8Pdw: checks
U7aZzIYWjv3SL30KtikLbw: bets $2
k6GJzKs7T7qvQggW9g8Pdw: raises $8 to $10
U7aZzIYWjv3SL30KtikLbw: raises $18 to $28
k6GJzKs7T7qvQggW9g8Pdw: calls $18
*** TURN *** [5h 6c Kc] [7h]
k6GJzKs7T7qvQggW9g8Pdw: checks
U7aZzIYWjv3SL30KtikLbw: bets $17 and is all-in
k6GJzKs7T7qvQggW9g8Pdw: calls $17
*** RIVER *** [5h 6c Kc 7h] [9s]
*** SHOW DOWN ***
k6GJzKs7T7qvQggW9g8Pdw: shows [7c 9c] (two pair, Nines and Sevens)
U7aZzIYWjv3SL30KtikLbw: mucks hand
k6GJzKs7T7qvQggW9g8Pdw collected $94.15 from pot
*** SUMMARY ***
Total pot $97.15 | Rake $3
Board [5h 6c Kc 7h 9s]
Seat 1: k6GJzKs7T7qvQggW9g8Pdw showed [7c 9c] and won ($94.15) with two pair, Nines and Sevens
Seat 2: RjBdQ6w31rgcy0o24VLR6w folded before Flop (didn't bet)
Seat 3: xZCXQSXlrZkp3pZizzVXCw folded before Flop (didn't bet)
Seat 4: U7aZzIYWjv3SL30KtikLbw mucked
Seat 5: JwvquocWfhTVApN5t47LgA folded before Flop (didn't bet)
Seat 6: zE9cVigS2nW/Ljy4K4bUQA folded before Flop (didn't bet)
Seat 7: 90Wb75h3W1BRpbqVnuk8gw (button) folded before Flop (didn't bet)
Seat 8: g4k0NXISyLCqaSWZDBjfEg (small blind) folded before Flop
Seat 9: J0W5D97jl5VLky+IoPvDeA (big blind) folded before Flop



PokerStars Game #59938369198:  Hold'em No Limit ($0.25/$0.50) - 2009/07/01 0:13:20 ET
Table 'Vdlc9wqYcHTUhtdyN7CuJw' 2-max Seat #1 is the button
Seat 1: yBO+mXB6m/rCft2ErwGf/Q ($82.60 in chips)
Seat 2: sa0qgETiL3HNbdfGlnKHTA ($28.95 in chips)
yBO+mXB6m/rCft2ErwGf/Q: posts small blind $0.25
sa0qgETiL3HNbdfGlnKHTA: posts big blind $0.50
*** HOLE CARDS ***
yBO+mXB6m/rCft2ErwGf/Q: calls $0.25
sa0qgETiL3HNbdfGlnKHTA: raises $1.50 to $2
yBO+mXB6m/rCft2ErwGf/Q: folds
sa0qgETiL3HNbdfGlnKHTA collected $1 from pot
sa0qgETiL3HNbdfGlnKHTA: doesn't show hand
*** SUMMARY ***
Total pot $1 | Rake $0
Seat 1: yBO+mXB6m/rCft2ErwGf/Q (button) (small blind) folded before Flop
Seat 2: sa0qgETiL3HNbdfGlnKHTA (big blind) collected ($1)



PokerStars Game #59938369750:  Hold'em No Limit ($0.25/$0.50) - 2009/07/01 0:13:21 ET
Table 'E7bWJ45aoFXRpyRv2gw+Ig' 2-max Seat #1 is the button
Seat 1: FRkiRasEGlHUeLrEl+k/nA ($80.60 in chips)
Seat 2: 3Wro85I7472vJ4Wkpneo9A ($42.25 in chips)
FRkiRasEGlHUeLrEl+k/nA: posts small blind $0.25
3Wro85I7472vJ4Wkpneo9A: posts big blind $0.50
*** HOLE CARDS ***
FRkiRasEGlHUeLrEl+k/nA: raises $1 to $1.50
3Wro85I7472vJ4Wkpneo9A: folds
FRkiRasEGlHUeLrEl+k/nA collected $1 from pot
*** SUMMARY ***
Total pot $1 | Rake $0
Seat 1: FRkiRasEGlHUeLrEl+k/nA (button) (small blind) collected ($1)
Seat 2: 3Wro85I7472vJ4Wkpneo9A (big blind) folded before Flop



PokerStars Game #59938370060:  Hold'em No Limit ($0.25/$0.50) - 2009/07/01 0:13:21 ET
Table 'm95HVfesC/VPgfGEjPuaIA' 2-max Seat #2 is the button
Seat 1: Fp/oksNpipCrD2MJ2pH20g ($16.95 in chips)
Seat 2: Ag6DvxX4vbRheqsv2zXKTQ ($17.25 in chips)
Ag6DvxX4vbRheqsv2zXKTQ: posts small blind $0.25
Fp/oksNpipCrD2MJ2pH20g: posts big blind $0.50
*** HOLE CARDS ***
Ag6DvxX4vbRheqsv2zXKTQ: raises $1 to $1.50
Fp/oksNpipCrD2MJ2pH20g: raises $15.45 to $16.95 and is all-in
Ag6DvxX4vbRheqsv2zXKTQ: folds
Fp/oksNpipCrD2MJ2pH20g collected $3 from pot
Fp/oksNpipCrD2MJ2pH20g: doesn't show hand
*** SUMMARY ***
Total pot $3 | Rake $0
Seat 1: Fp/oksNpipCrD2MJ2pH20g (big blind) collected ($3)
Seat 2: Ag6DvxX4vbRheqsv2zXKTQ (button) (small blind) folded before Flop



PokerStars Game #59938370124:  Hold'em No Limit ($0.25/$0.50) - 2009/07/01 0:13:21 ET
Table 'c/CRn+68J3Y8KxD5g1ek2Q' 2-max Seat #1 is the button
Seat 1: 46qCyJ6evTkHo9al5sBMNA ($314.75 in chips)
Seat 2: BypVLsYQt3ePFm2xQL/dOA ($70 in chips)
46qCyJ6evTkHo9al5sBMNA: posts small blind $0.25
BypVLsYQt3ePFm2xQL/dOA: posts big blind $0.50
*** HOLE CARDS ***
46qCyJ6evTkHo9al5sBMNA: raises $1.50 to $2
BypVLsYQt3ePFm2xQL/dOA: calls $1.50
*** FLOP *** [2s Tc 8h]
BypVLsYQt3ePFm2xQL/dOA: checks
46qCyJ6evTkHo9al5sBMNA: bets $2.50
BypVLsYQt3ePFm2xQL/dOA: folds
46qCyJ6evTkHo9al5sBMNA collected $3.80 from pot
46qCyJ6evTkHo9al5sBMNA: doesn't show hand
*** SUMMARY ***
Total pot $4 | Rake $0.20
Board [2s Tc 8h]
Seat 1: 46qCyJ6evTkHo9al5sBMNA (button) (small blind) collected ($3.80)
Seat 2: BypVLsYQt3ePFm2xQL/dOA (big blind) folded on the Flop



PokerStars Game #59938369886:  Hold'em No Limit ($0.25/$0.50) - 2009/07/01 0:13:21 ET
Table 'BCN5su+SsXiy1zRMJi0SJw' 6-max Seat #1 is the button
Seat 1: WyeokAqR0q9nADSkWpbxHw ($36.85 in chips)
Seat 2: QfV2JJlmEKgD5jYPV+a33A ($176.90 in chips)
Seat 3: L309C3uyA1tkWSOh/QvjHw ($20.90 in chips)
Seat 5: TTx3CHxyi0SObcHyMJRp5w ($33.25 in chips)
QfV2JJlmEKgD5jYPV+a33A: posts small blind $0.25
L309C3uyA1tkWSOh/QvjHw: posts big blind $0.50
*** HOLE CARDS ***
TTx3CHxyi0SObcHyMJRp5w: folds
WyeokAqR0q9nADSkWpbxHw: folds
QfV2JJlmEKgD5jYPV+a33A: raises $1.50 to $2
L309C3uyA1tkWSOh/QvjHw: folds
QfV2JJlmEKgD5jYPV+a33A collected $1 from pot
QfV2JJlmEKgD5jYPV+a33A: doesn't show hand
*** SUMMARY ***
Total pot $1 | Rake $0
Seat 1: WyeokAqR0q9nADSkWpbxHw (button) folded before Flop (didn't bet)
Seat 2: QfV2JJlmEKgD5jYPV+a33A (small blind) collected ($1)
Seat 3: L309C3uyA1tkWSOh/QvjHw (big blind) folded before Flop
Seat 5: TTx3CHxyi0SObcHyMJRp5w folded before Flop (didn't bet)



PokerStars Game #59938370886:  Hold'em No Limit ($0.25/$0.50) - 2009/07/01 0:13:22 ET
Table 'PALRfuH85dr5IkDfdv6new' 9-max Seat #7 is the button
Seat 1: SKnJuWHScqetA/qG5p+wCg ($33 in chips)
Seat 2: 9r7ZoBbAJj5IeyZ0q9BdzA ($13.90 in chips)
Seat 3: 50QWoELmpmHFrFIlWMJo9g ($94.20 in chips)
Seat 4: /gaxz7F0MIjSN3t7ZPKwAA ($37.10 in chips)
Seat 5: jSSGUXdNFAZA3QCvTcUMQw ($43 in chips)
Seat 6: EiWj2MAl8RNcPhTkzz24Mw ($26.90 in chips)
Seat 7: 3NcyXvr39gnK+KbTq7ezyA ($34.10 in chips)
Seat 8: NkS+CseUKx4XHszWq0PXEQ ($42.60 in chips)
Seat 9: CIrAX/m6o7jYmKOAjJXv4Q ($39.60 in chips)
NkS+CseUKx4XHszWq0PXEQ: posts small blind $0.25
CIrAX/m6o7jYmKOAjJXv4Q: posts big blind $0.50
*** HOLE CARDS ***
SKnJuWHScqetA/qG5p+wCg: folds
9r7ZoBbAJj5IeyZ0q9BdzA: folds
50QWoELmpmHFrFIlWMJo9g: folds
/gaxz7F0MIjSN3t7ZPKwAA: folds
jSSGUXdNFAZA3QCvTcUMQw: folds
EiWj2MAl8RNcPhTkzz24Mw: folds
3NcyXvr39gnK+KbTq7ezyA: calls $0.50
NkS+CseUKx4XHszWq0PXEQ: folds
CIrAX/m6o7jYmKOAjJXv4Q: checks
*** FLOP *** [4s 8h 7h]
CIrAX/m6o7jYmKOAjJXv4Q: checks
3NcyXvr39gnK+KbTq7ezyA: bets $0.50
CIrAX/m6o7jYmKOAjJXv4Q: calls $0.50
*** TURN *** [4s 8h 7h] [Ts]
CIrAX/m6o7jYmKOAjJXv4Q: checks
3NcyXvr39gnK+KbTq7ezyA: checks
*** RIVER *** [4s 8h 7h Ts] [Kh]
CIrAX/m6o7jYmKOAjJXv4Q: checks
3NcyXvr39gnK+KbTq7ezyA: checks
*** SHOW DOWN ***
CIrAX/m6o7jYmKOAjJXv4Q: shows [6s 2c] (high card King)
3NcyXvr39gnK+KbTq7ezyA: shows [4h 6d] (a pair of Fours)
3NcyXvr39gnK+KbTq7ezyA collected $2.15 from pot
*** SUMMARY ***
Total pot $2.25 | Rake $0.10
Board [4s 8h 7h Ts Kh]
Seat 1: SKnJuWHScqetA/qG5p+wCg folded before Flop (didn't bet)
Seat 2: 9r7ZoBbAJj5IeyZ0q9BdzA folded before Flop (didn't bet)
Seat 3: 50QWoELmpmHFrFIlWMJo9g folded before Flop (didn't bet)
Seat 4: /gaxz7F0MIjSN3t7ZPKwAA folded before Flop (didn't bet)
Seat 5: jSSGUXdNFAZA3QCvTcUMQw folded before Flop (didn't bet)
Seat 6: EiWj2MAl8RNcPhTkzz24Mw folded before Flop (didn't bet)
Seat 7: 3NcyXvr39gnK+KbTq7ezyA (button) showed [4h 6d] and won ($2.15) with a pair of Fours
Seat 8: NkS+CseUKx4XHszWq0PXEQ (small blind) folded before Flop
Seat 9: CIrAX/m6o7jYmKOAjJXv4Q (big blind) showed [6s 2c] and lost with high card King



PokerStars Game #59938370752:  Hold'em No Limit ($0.25/$0.50) - 2009/07/01 0:13:22 ET
Table 'ZYwMb9E6tY50Qm+iNbXRYw' 2-max Seat #1 is the button
Seat 1: DXLfRb8KDZWmrztw2bwtFw ($32.90 in chips)
Seat 2: 16tvT7AYgZ2LgiGFcvFKQg ($5.10 in chips)
DXLfRb8KDZWmrztw2bwtFw: posts small blind $0.25
16tvT7AYgZ2LgiGFcvFKQg: posts big blind $0.50
*** HOLE CARDS ***
DXLfRb8KDZWmrztw2bwtFw: calls $0.25
16tvT7AYgZ2LgiGFcvFKQg: raises $1 to $1.50
DXLfRb8KDZWmrztw2bwtFw: calls $1
*** FLOP *** [As Jd Js]
16tvT7AYgZ2LgiGFcvFKQg: bets $3.60 and is all-in
DXLfRb8KDZWmrztw2bwtFw: folds
16tvT7AYgZ2LgiGFcvFKQg collected $2.85 from pot
*** SUMMARY ***
Total pot $3 | Rake $0.15
Board [As Jd Js]
Seat 1: DXLfRb8KDZWmrztw2bwtFw (button) (small blind) folded on the Flop
Seat 2: 16tvT7AYgZ2LgiGFcvFKQg (big blind) collected ($2.85)



PokerStars Game #59938371840:  Hold'em No Limit ($0.25/$0.50) - 2009/07/01 0:13:24 ET
Table 'raOT4/ipuZgzjfKHC+jD9g' 2-max Seat #1 is the button
Seat 1: IuwLemwLhc9fvrwBGs0AMA ($12.70 in chips)
Seat 2: Udr5juWSWUgTu1NlRhjMdA ($10.25 in chips)
IuwLemwLhc9fvrwBGs0AMA: posts small blind $0.25
Udr5juWSWUgTu1NlRhjMdA: posts big blind $0.50
*** HOLE CARDS ***
IuwLemwLhc9fvrwBGs0AMA: folds
Udr5juWSWUgTu1NlRhjMdA collected $0.50 from pot
Udr5juWSWUgTu1NlRhjMdA: doesn't show hand
*** SUMMARY ***
Total pot $0.50 | Rake $0
Seat 1: IuwLemwLhc9fvrwBGs0AMA (button) (small blind) folded before Flop
Seat 2: Udr5juWSWUgTu1NlRhjMdA (big blind) collected ($0.50)



PokerStars Game #59938371992:  Hold'em No Limit ($0.25/$0.50) - 2009/07/01 0:13:24 ET
Table 'kgbJRsxfv64KrErDRBAkcw' 6-max Seat #4 is the button
Seat 1: YmWlPGOKFuJSoJZPW8a8IA ($81.55 in chips)
Seat 2: Q+thC23WCv1kJUJtH/+4Jw ($31.20 in chips)
Seat 3: T0Gx/FcQ5VH9u7XaOMX97A ($65.25 in chips)
Seat 4: qanMEqjABjWxC/JgQ/0l7w ($62.70 in chips)
Seat 5: +Pf9jTVizYlIo+woPvptfA ($50 in chips)
Seat 6: DDfYzIrYT0t5R/hAJngtsg ($20.05 in chips)
+Pf9jTVizYlIo+woPvptfA: posts small blind $0.25
DDfYzIrYT0t5R/hAJngtsg: posts big blind $0.50
*** HOLE CARDS ***
YmWlPGOKFuJSoJZPW8a8IA: folds
Q+thC23WCv1kJUJtH/+4Jw: folds
T0Gx/FcQ5VH9u7XaOMX97A: folds
qanMEqjABjWxC/JgQ/0l7w: folds
+Pf9jTVizYlIo+woPvptfA: folds
DDfYzIrYT0t5R/hAJngtsg collected $0.50 from pot
*** SUMMARY ***
Total pot $0.50 | Rake $0
Seat 1: YmWlPGOKFuJSoJZPW8a8IA folded before Flop (didn't bet)
Seat 2: Q+thC23WCv1kJUJtH/+4Jw folded before Flop (didn't bet)
Seat 3: T0Gx/FcQ5VH9u7XaOMX97A folded before Flop (didn't bet)
Seat 4: qanMEqjABjWxC/JgQ/0l7w (button) folded before Flop (didn't bet)
Seat 5: +Pf9jTVizYlIo+woPvptfA (small blind) folded before Flop
Seat 6: DDfYzIrYT0t5R/hAJngtsg (big blind) collected ($0.50)



PokerStars Game #59938371862:  Hold'em No Limit ($0.25/$0.50) - 2009/07/01 0:13:24 ET
Table 'NCiXr0d5CEKBQr/cZgLhbA' 9-max Seat #8 is the button
Seat 1: RjBdQ6w31rgcy0o24VLR6w ($8.50 in chips)
Seat 2: ulxuJchBV9iguXg0FUonfg ($35.80 in chips)
Seat 3: xZCXQSXlrZkp3pZizzVXCw ($55.65 in chips)
Seat 4: CL4d+tvzcd4utdQxlPLOmg ($29.15 in chips)
Seat 5: zE9cVigS2nW/Ljy4K4bUQA ($30 in chips)
Seat 6: SKnJuWHScqetA/qG5p+wCg ($31.05 in chips)
Seat 8: 1MJUKc3cc0QmUoz1JZLR2w ($67.40 in chips)
Seat 9: WpvT3OUSiZlpvs+mPXFqtQ ($8.45 in chips)
WpvT3OUSiZlpvs+mPXFqtQ: posts small blind $0.25
RjBdQ6w31rgcy0o24VLR6w: posts big blind $0.50
M+7+BTmX5vZatHVuoRB1nA: sits out
*** HOLE CARDS ***
ulxuJchBV9iguXg0FUonfg: raises $1 to $1.50
xZCXQSXlrZkp3pZizzVXCw: folds
CL4d+tvzcd4utdQxlPLOmg: folds
zE9cVigS2nW/Ljy4K4bUQA: folds
SKnJuWHScqetA/qG5p+wCg: folds
1MJUKc3cc0QmUoz1JZLR2w: calls $1.50
WpvT3OUSiZlpvs+mPXFqtQ: folds
RjBdQ6w31rgcy0o24VLR6w: folds
*** FLOP *** [4d 9h 6s]
ulxuJchBV9iguXg0FUonfg: checks
1MJUKc3cc0QmUoz1JZLR2w: checks
*** TURN *** [4d 9h 6s] [8d]
ulxuJchBV9iguXg0FUonfg: bets $1
1MJUKc3cc0QmUoz1JZLR2w: calls $1
*** RIVER *** [4d 9h 6s 8d] [Kd]
ulxuJchBV9iguXg0FUonfg: checks
1MJUKc3cc0QmUoz1JZLR2w: checks
*** SHOW DOWN ***
ulxuJchBV9iguXg0FUonfg: shows [Ac Js] (high card Ace)
1MJUKc3cc0QmUoz1JZLR2w: shows [Ah Qd] (high card Ace - King+Queen kicker)
1MJUKc3cc0QmUoz1JZLR2w collected $5.50 from pot
*** SUMMARY ***
Total pot $5.75 | Rake $0.25
Board [4d 9h 6s 8d Kd]
Seat 1: RjBdQ6w31rgcy0o24VLR6w (big blind) folded before Flop
Seat 2: ulxuJchBV9iguXg0FUonfg showed [Ac Js] and lost with high card Ace
Seat 3: xZCXQSXlrZkp3pZizzVXCw folded before Flop (didn't bet)
Seat 4: CL4d+tvzcd4utdQxlPLOmg folded before Flop (didn't bet)
Seat 5: zE9cVigS2nW/Ljy4K4bUQA folded before Flop (didn't bet)
Seat 6: SKnJuWHScqetA/qG5p+wCg folded before Flop (didn't bet)
Seat 8: 1MJUKc3cc0QmUoz1JZLR2w (button) showed [Ah Qd] and won ($5.50) with high card Ace
Seat 9: WpvT3OUSiZlpvs+mPXFqtQ (small blind) folded before Flop



PokerStars Game #59938371900:  Hold'em No Limit ($0.25/$0.50) - 2009/07/01 0:13:24 ET
Table 'ibNfFy0bCzuBaUORla0aGw' 9-max Seat #9 is the button
Seat 1: xZCXQSXlrZkp3pZizzVXCw ($55.70 in chips)
Seat 2: 90Wb75h3W1BRpbqVnuk8gw ($52.55 in chips)
Seat 3: dDaHs3X8+fe3bIkRU0cbrw ($26.30 in chips)
Seat 4: YBN054X4blmis+B2bBlC0g ($21.05 in chips)
Seat 5: FRv75HO8CUsRZ1byEz06mQ ($13.85 in chips)
Seat 6: BmYrv3ec2k5d6pQq6iNaZw ($67.85 in chips)
Seat 7: mSD1pginDsyHG5PDfqzphw ($13.75 in chips)
Seat 8: xUrN9TWLq4m5V+OXY7KUUA ($50 in chips)
Seat 9: WpvT3OUSiZlpvs+mPXFqtQ ($8 in chips)
xZCXQSXlrZkp3pZizzVXCw: posts small blind $0.25
90Wb75h3W1BRpbqVnuk8gw: posts big blind $0.50
*** HOLE CARDS ***
dDaHs3X8+fe3bIkRU0cbrw: calls $0.50
YBN054X4blmis+B2bBlC0g: folds
FRv75HO8CUsRZ1byEz06mQ: calls $0.50
BmYrv3ec2k5d6pQq6iNaZw: folds
mSD1pginDsyHG5PDfqzphw: raises $2 to $2.50
xUrN9TWLq4m5V+OXY7KUUA: folds
WpvT3OUSiZlpvs+mPXFqtQ: folds
xZCXQSXlrZkp3pZizzVXCw: folds
90Wb75h3W1BRpbqVnuk8gw: folds
dDaHs3X8+fe3bIkRU0cbrw: folds
FRv75HO8CUsRZ1byEz06mQ: folds
mSD1pginDsyHG5PDfqzphw collected $2.25 from pot
*** SUMMARY ***
Total pot $2.25 | Rake $0
Seat 1: xZCXQSXlrZkp3pZizzVXCw (small blind) folded before Flop
Seat 2: 90Wb75h3W1BRpbqVnuk8gw (big blind) folded before Flop
Seat 3: dDaHs3X8+fe3bIkRU0cbrw folded before Flop
Seat 4: YBN054X4blmis+B2bBlC0g folded before Flop (didn't bet)
Seat 5: FRv75HO8CUsRZ1byEz06mQ folded before Flop
Seat 6: BmYrv3ec2k5d6pQq6iNaZw folded before Flop (didn't bet)
Seat 7: mSD1pginDsyHG5PDfqzphw collected ($2.25)
Seat 8: xUrN9TWLq4m5V+OXY7KUUA folded before Flop (didn't bet)
Seat 9: WpvT3OUSiZlpvs+mPXFqtQ (button) folded before Flop (didn't bet)



PokerStars Game #59938373028:  Hold'em No Limit ($0.25/$0.50) - 2009/07/01 0:13:25 ET
Table '+dXkOAQyS8j9PQZusUTMpg' 2-max Seat #1 is the button
Seat 1: XFa6sBGjP2gxoIvxR3fZIg ($85.95 in chips)
Seat 2: 5IBeOgaApY1Bvzv2P8X4EA ($26.20 in chips)
XFa6sBGjP2gxoIvxR3fZIg: posts small blind $0.25
5IBeOgaApY1Bvzv2P8X4EA: posts big blind $0.50
*** HOLE CARDS ***
XFa6sBGjP2gxoIvxR3fZIg said, "ThatÃ¯Â¿Â½s what pretty much made me suspicous"
XFa6sBGjP2gxoIvxR3fZIg: raises $1 to $1.50
5IBeOgaApY1Bvzv2P8X4EA: calls $1
*** FLOP *** [Th 8h 8d]
5IBeOgaApY1Bvzv2P8X4EA: checks
XFa6sBGjP2gxoIvxR3fZIg: checks
*** TURN *** [Th 8h 8d] [Ah]
5IBeOgaApY1Bvzv2P8X4EA: bets $1
XFa6sBGjP2gxoIvxR3fZIg: folds
5IBeOgaApY1Bvzv2P8X4EA collected $2.85 from pot
*** SUMMARY ***
Total pot $3 | Rake $0.15
Board [Th 8h 8d Ah]
Seat 1: XFa6sBGjP2gxoIvxR3fZIg (button) (small blind) folded on the Turn
Seat 2: 5IBeOgaApY1Bvzv2P8X4EA (big blind) collected ($2.85)



PokerStars Game #59938373770:  Hold'em No Limit ($0.25/$0.50) - 2009/07/01 0:13:26 ET
Table 'X6IRCRTh+20gjz8aubWnwA' 9-max Seat #7 is the button
Seat 1: YPo1oggovmqSREegekaQYw ($9.45 in chips)
Seat 2: RjBdQ6w31rgcy0o24VLR6w ($11.65 in chips)
Seat 3: mSD1pginDsyHG5PDfqzphw ($10 in chips)
Seat 4: uw9QayAAxLM3Hb+HR7mSkg ($10.25 in chips)
Seat 5: L5e2lrPLQm1Pqx30IIZ/Fw ($12.85 in chips)
Seat 6: /6In1zC3WtgwxDcueWzZWg ($56.95 in chips)
Seat 7: VBnpbzn0dIveV55qKvciew ($55.95 in chips)
Seat 8: BPMN9sOItJw6vWq3kypaYg ($27.75 in chips)
Seat 9: M+7+BTmX5vZatHVuoRB1nA ($84.10 in chips)
BPMN9sOItJw6vWq3kypaYg: posts small blind $0.25
M+7+BTmX5vZatHVuoRB1nA: posts big blind $0.50
*** HOLE CARDS ***
YPo1oggovmqSREegekaQYw: folds
YPo1oggovmqSREegekaQYw leaves the table
RjBdQ6w31rgcy0o24VLR6w: folds
mSD1pginDsyHG5PDfqzphw: folds
uw9QayAAxLM3Hb+HR7mSkg: folds
L5e2lrPLQm1Pqx30IIZ/Fw: folds
DSM67hHHq1XFoEOi9p8Alw joins the table at seat #1
/6In1zC3WtgwxDcueWzZWg: raises $0.50 to $1
VBnpbzn0dIveV55qKvciew: folds
BPMN9sOItJw6vWq3kypaYg: folds
M+7+BTmX5vZatHVuoRB1nA: calls $0.50
*** FLOP *** [2c Kd 9h]
M+7+BTmX5vZatHVuoRB1nA: checks
/6In1zC3WtgwxDcueWzZWg: checks
*** TURN *** [2c Kd 9h] [9s]
M+7+BTmX5vZatHVuoRB1nA: checks
/6In1zC3WtgwxDcueWzZWg: checks
*** RIVER *** [2c Kd 9h 9s] [Jc]
M+7+BTmX5vZatHVuoRB1nA: checks
/6In1zC3WtgwxDcueWzZWg: bets $2
M+7+BTmX5vZatHVuoRB1nA: folds
/6In1zC3WtgwxDcueWzZWg collected $2.15 from pot
/6In1zC3WtgwxDcueWzZWg: doesn't show hand
*** SUMMARY ***
Total pot $2.25 | Rake $0.10
Board [2c Kd 9h 9s Jc]
Seat 1: YPo1oggovmqSREegekaQYw folded before Flop (didn't bet)
Seat 2: RjBdQ6w31rgcy0o24VLR6w folded before Flop (didn't bet)
Seat 3: mSD1pginDsyHG5PDfqzphw folded before Flop (didn't bet)
Seat 4: uw9QayAAxLM3Hb+HR7mSkg folded before Flop (didn't bet)
Seat 5: L5e2lrPLQm1Pqx30IIZ/Fw folded before Flop (didn't bet)
Seat 6: /6In1zC3WtgwxDcueWzZWg collected ($2.15)
Seat 7: VBnpbzn0dIveV55qKvciew (button) folded before Flop (didn't bet)
Seat 8: BPMN9sOItJw6vWq3kypaYg (small blind) folded before Flop
Seat 9: M+7+BTmX5vZatHVuoRB1nA (big blind) folded on the River



PokerStars Game #59938374414:  Hold'em No Limit ($0.25/$0.50) - 2009/07/01 0:13:27 ET
Table 'YsnnHkamRzYqMOr2FlLY4w' 6-max Seat #5 is the button
Seat 1: crjGpJEzSZgD38FoE3VMGg ($61.40 in chips)
Seat 2: vnRgOasQNKOR7gLXwRQ+ww ($50 in chips)
Seat 4: 7Fue572p4ZIC85AJMQvaQw ($51.70 in chips)
Seat 5: lcQ7uuLf+WLGGy4Ve6VKKA ($40.55 in chips)
crjGpJEzSZgD38FoE3VMGg: posts small blind $0.25
vnRgOasQNKOR7gLXwRQ+ww: posts big blind $0.50
*** HOLE CARDS ***
7Fue572p4ZIC85AJMQvaQw: folds
lcQ7uuLf+WLGGy4Ve6VKKA: folds
crjGpJEzSZgD38FoE3VMGg: raises $1.50 to $2
lcQ7uuLf+WLGGy4Ve6VKKA leaves the table
vnRgOasQNKOR7gLXwRQ+ww: folds
crjGpJEzSZgD38FoE3VMGg collected $1 from pot
crjGpJEzSZgD38FoE3VMGg: doesn't show hand
*** SUMMARY ***
Total pot $1 | Rake $0
Seat 1: crjGpJEzSZgD38FoE3VMGg (small blind) collected ($1)
Seat 2: vnRgOasQNKOR7gLXwRQ+ww (big blind) folded before Flop
Seat 4: 7Fue572p4ZIC85AJMQvaQw folded before Flop (didn't bet)
Seat 5: lcQ7uuLf+WLGGy4Ve6VKKA (button) folded before Flop (didn't bet)



PokerStars Game #59938374104:  Hold'em No Limit ($0.25/$0.50) - 2009/07/01 0:13:27 ET
Table 'mTxf8gPLgffN3Iwfm7Icfg' 2-max Seat #2 is the button
Seat 1: Do9Rlu1R5u/AcRtMTl8SYg ($58.10 in chips)
Seat 2: EMc5LPgVaded4Qc77vm0fw ($55.15 in chips)
EMc5LPgVaded4Qc77vm0fw: posts small blind $0.25
Do9Rlu1R5u/AcRtMTl8SYg: posts big blind $0.50
*** HOLE CARDS ***
EMc5LPgVaded4Qc77vm0fw: folds
Do9Rlu1R5u/AcRtMTl8SYg collected $0.50 from pot
Do9Rlu1R5u/AcRtMTl8SYg: doesn't show hand
*** SUMMARY ***
Total pot $0.50 | Rake $0
Seat 1: Do9Rlu1R5u/AcRtMTl8SYg (big blind) collected ($0.50)
Seat 2: EMc5LPgVaded4Qc77vm0fw (button) (small blind) folded before Flop



PokerStars Game #59938375680:  Hold'em No Limit ($0.25/$0.50) - 2009/07/01 0:13:29 ET
Table 'E7bWJ45aoFXRpyRv2gw+Ig' 2-max Seat #2 is the button
Seat 1: FRkiRasEGlHUeLrEl+k/nA ($81.10 in chips)
Seat 2: 3Wro85I7472vJ4Wkpneo9A ($41.75 in chips)
3Wro85I7472vJ4Wkpneo9A: posts small blind $0.25
FRkiRasEGlHUeLrEl+k/nA: posts big blind $0.50
*** HOLE CARDS ***
3Wro85I7472vJ4Wkpneo9A: folds
FRkiRasEGlHUeLrEl+k/nA collected $0.50 from pot
*** SUMMARY ***
Total pot $0.50 | Rake $0
Seat 1: FRkiRasEGlHUeLrEl+k/nA (big blind) collected ($0.50)
Seat 2: 3Wro85I7472vJ4Wkpneo9A (button) (small blind) folded before Flop



PokerStars Game #59938376118:  Hold'em No Limit ($0.25/$0.50) - 2009/07/01 0:13:30 ET
Table 'raOT4/ipuZgzjfKHC+jD9g' 2-max Seat #2 is the button
Seat 1: IuwLemwLhc9fvrwBGs0AMA ($12.45 in chips)
Seat 2: Udr5juWSWUgTu1NlRhjMdA ($10.50 in chips)
Udr5juWSWUgTu1NlRhjMdA: posts small blind $0.25
IuwLemwLhc9fvrwBGs0AMA: posts big blind $0.50
*** HOLE CARDS ***
Udr5juWSWUgTu1NlRhjMdA: calls $0.25
IuwLemwLhc9fvrwBGs0AMA: checks
*** FLOP *** [9h 2c Jh]
IuwLemwLhc9fvrwBGs0AMA: bets $1
Udr5juWSWUgTu1NlRhjMdA: folds
IuwLemwLhc9fvrwBGs0AMA collected $0.95 from pot
*** SUMMARY ***
Total pot $1 | Rake $0.05
Board [9h 2c Jh]
Seat 1: IuwLemwLhc9fvrwBGs0AMA (big blind) collected ($0.95)
Seat 2: Udr5juWSWUgTu1NlRhjMdA (button) (small blind) folded on the Flop



PokerStars Game #59938376656:  Hold'em No Limit ($0.25/$0.50) - 2009/07/01 0:13:31 ET
Table 'Vdlc9wqYcHTUhtdyN7CuJw' 2-max Seat #2 is the button
Seat 1: yBO+mXB6m/rCft2ErwGf/Q ($82.10 in chips)
Seat 2: sa0qgETiL3HNbdfGlnKHTA ($29.45 in chips)
sa0qgETiL3HNbdfGlnKHTA: posts small blind $0.25
yBO+mXB6m/rCft2ErwGf/Q: posts big blind $0.50
*** HOLE CARDS ***
sa0qgETiL3HNbdfGlnKHTA: raises $1 to $1.50
yBO+mXB6m/rCft2ErwGf/Q: calls $1
*** FLOP *** [2s 9h 6s]
yBO+mXB6m/rCft2ErwGf/Q: checks
sa0qgETiL3HNbdfGlnKHTA: checks
*** TURN *** [2s 9h 6s] [Qh]
yBO+mXB6m/rCft2ErwGf/Q: checks
sa0qgETiL3HNbdfGlnKHTA: checks
*** RIVER *** [2s 9h 6s Qh] [9d]
yBO+mXB6m/rCft2ErwGf/Q: bets $0.50
sa0qgETiL3HNbdfGlnKHTA: calls $0.50
*** SHOW DOWN ***
yBO+mXB6m/rCft2ErwGf/Q: shows [5d Ah] (a pair of Nines)
sa0qgETiL3HNbdfGlnKHTA: shows [3h 2d] (two pair, Nines and Deuces)
sa0qgETiL3HNbdfGlnKHTA collected $3.85 from pot
*** SUMMARY ***
Total pot $4 | Rake $0.15
Board [2s 9h 6s Qh 9d]
Seat 1: yBO+mXB6m/rCft2ErwGf/Q (big blind) showed [5d Ah] and lost with a pair of Nines
Seat 2: sa0qgETiL3HNbdfGlnKHTA (button) (small blind) showed [3h 2d] and won ($3.85) with two pair, Nines and Deuces



PokerStars Game #59938377954:  Hold'em No Limit ($0.25/$0.50) - 2009/07/01 0:13:32 ET
Table 'm95HVfesC/VPgfGEjPuaIA' 2-max Seat #1 is the button
Seat 1: Fp/oksNpipCrD2MJ2pH20g ($18.45 in chips)
Seat 2: Ag6DvxX4vbRheqsv2zXKTQ ($15.75 in chips)
Fp/oksNpipCrD2MJ2pH20g: posts small blind $0.25
Ag6DvxX4vbRheqsv2zXKTQ: posts big blind $0.50
*** HOLE CARDS ***
Fp/oksNpipCrD2MJ2pH20g: folds
Ag6DvxX4vbRheqsv2zXKTQ collected $0.50 from pot
*** SUMMARY ***
Total pot $0.50 | Rake $0
Seat 1: Fp/oksNpipCrD2MJ2pH20g (button) (small blind) folded before Flop
Seat 2: Ag6DvxX4vbRheqsv2zXKTQ (big blind) collected ($0.50)



PokerStars Game #59938378172:  Hold'em No Limit ($0.25/$0.50) - 2009/07/01 0:13:33 ET
Table 'mTxf8gPLgffN3Iwfm7Icfg' 2-max Seat #1 is the button
Seat 1: Do9Rlu1R5u/AcRtMTl8SYg ($58.35 in chips)
Seat 2: EMc5LPgVaded4Qc77vm0fw ($54.90 in chips)
Do9Rlu1R5u/AcRtMTl8SYg: posts small blind $0.25
EMc5LPgVaded4Qc77vm0fw: posts big blind $0.50
*** HOLE CARDS ***
Do9Rlu1R5u/AcRtMTl8SYg: folds
EMc5LPgVaded4Qc77vm0fw collected $0.50 from pot
EMc5LPgVaded4Qc77vm0fw: doesn't show hand
*** SUMMARY ***
Total pot $0.50 | Rake $0
Seat 1: Do9Rlu1R5u/AcRtMTl8SYg (button) (small blind) folded before Flop
Seat 2: EMc5LPgVaded4Qc77vm0fw (big blind) collected ($0.50)



PokerStars Game #59938380404:  Hold'em No Limit ($0.25/$0.50) - 2009/07/01 0:13:36 ET
Table 'E7bWJ45aoFXRpyRv2gw+Ig' 2-max Seat #1 is the button
Seat 1: FRkiRasEGlHUeLrEl+k/nA ($81.35 in chips)
Seat 2: 3Wro85I7472vJ4Wkpneo9A ($41.50 in chips)
FRkiRasEGlHUeLrEl+k/nA: posts small blind $0.25
3Wro85I7472vJ4Wkpneo9A: posts big blind $0.50
*** HOLE CARDS ***
FRkiRasEGlHUeLrEl+k/nA: raises $1 to $1.50
3Wro85I7472vJ4Wkpneo9A: raises $3.50 to $5
FRkiRasEGlHUeLrEl+k/nA: calls $3.50
*** FLOP *** [7d 2h 2s]
3Wro85I7472vJ4Wkpneo9A: bets $7
FRkiRasEGlHUeLrEl+k/nA: calls $7
*** TURN *** [7d 2h 2s] [5c]
3Wro85I7472vJ4Wkpneo9A: checks
FRkiRasEGlHUeLrEl+k/nA: bets $17.50
3Wro85I7472vJ4Wkpneo9A: raises $12 to $29.50 and is all-in
FRkiRasEGlHUeLrEl+k/nA: calls $12
*** RIVER *** [7d 2h 2s 5c] [8c]
*** SHOW DOWN ***
3Wro85I7472vJ4Wkpneo9A: shows [2c Kc] (three of a kind, Deuces)
FRkiRasEGlHUeLrEl+k/nA: mucks hand
3Wro85I7472vJ4Wkpneo9A collected $82.50 from pot
*** SUMMARY ***
Total pot $83 | Rake $0.50
Board [7d 2h 2s 5c 8c]
Seat 1: FRkiRasEGlHUeLrEl+k/nA (button) (small blind) mucked
Seat 2: 3Wro85I7472vJ4Wkpneo9A (big blind) showed [2c Kc] and won ($82.50) with three of a kind, Deuces



PokerStars Game #59938381800:  Hold'em No Limit ($0.25/$0.50) - 2009/07/01 0:13:38 ET
Table 'ZYwMb9E6tY50Qm+iNbXRYw' 2-max Seat #2 is the button
Seat 1: DXLfRb8KDZWmrztw2bwtFw ($31.40 in chips)
Seat 2: 16tvT7AYgZ2LgiGFcvFKQg ($6.45 in chips)
16tvT7AYgZ2LgiGFcvFKQg: posts small blind $0.25
DXLfRb8KDZWmrztw2bwtFw: posts big blind $0.50
*** HOLE CARDS ***
16tvT7AYgZ2LgiGFcvFKQg: calls $0.25
DXLfRb8KDZWmrztw2bwtFw: checks
*** FLOP *** [5d 2h 8h]
DXLfRb8KDZWmrztw2bwtFw: bets $1
16tvT7AYgZ2LgiGFcvFKQg: calls $1
*** TURN *** [5d 2h 8h] [Qd]
DXLfRb8KDZWmrztw2bwtFw: bets $2
16tvT7AYgZ2LgiGFcvFKQg: calls $2
*** RIVER *** [5d 2h 8h Qd] [Td]
DXLfRb8KDZWmrztw2bwtFw: bets $3
16tvT7AYgZ2LgiGFcvFKQg: calls $2.95 and is all-in
*** SHOW DOWN ***
DXLfRb8KDZWmrztw2bwtFw: shows [6h 2d] (a pair of Deuces)
16tvT7AYgZ2LgiGFcvFKQg: shows [7d 9d] (a flush, Queen high)
16tvT7AYgZ2LgiGFcvFKQg collected $12.40 from pot
*** SUMMARY ***
Total pot $12.90 | Rake $0.50
Board [5d 2h 8h Qd Td]
Seat 1: DXLfRb8KDZWmrztw2bwtFw (big blind) showed [6h 2d] and lost with a pair of Deuces
Seat 2: 16tvT7AYgZ2LgiGFcvFKQg (button) (small blind) showed [7d 9d] and won ($12.40) with a flush, Queen high



PokerStars Game #59938382348:  Hold'em No Limit ($0.25/$0.50) - 2009/07/01 0:13:39 ET
Table 'mTxf8gPLgffN3Iwfm7Icfg' 2-max Seat #2 is the button
Seat 1: Do9Rlu1R5u/AcRtMTl8SYg ($58.10 in chips)
Seat 2: EMc5LPgVaded4Qc77vm0fw ($55.15 in chips)
EMc5LPgVaded4Qc77vm0fw: posts small blind $0.25
Do9Rlu1R5u/AcRtMTl8SYg: posts big blind $0.50
*** HOLE CARDS ***
EMc5LPgVaded4Qc77vm0fw: raises $1.50 to $2
Do9Rlu1R5u/AcRtMTl8SYg: folds
EMc5LPgVaded4Qc77vm0fw collected $1 from pot
EMc5LPgVaded4Qc77vm0fw: doesn't show hand
*** SUMMARY ***
Total pot $1 | Rake $0
Seat 1: Do9Rlu1R5u/AcRtMTl8SYg (big blind) folded before Flop
Seat 2: EMc5LPgVaded4Qc77vm0fw (button) (small blind) collected ($1)



PokerStars Game #59938382492:  Hold'em No Limit ($0.25/$0.50) - 2009/07/01 0:13:39 ET
Table 'm95HVfesC/VPgfGEjPuaIA' 2-max Seat #2 is the button
Seat 1: Fp/oksNpipCrD2MJ2pH20g ($18.20 in chips)
Seat 2: Ag6DvxX4vbRheqsv2zXKTQ ($16 in chips)
Ag6DvxX4vbRheqsv2zXKTQ: posts small blind $0.25
Fp/oksNpipCrD2MJ2pH20g: posts big blind $0.50
*** HOLE CARDS ***
Ag6DvxX4vbRheqsv2zXKTQ: folds
Fp/oksNpipCrD2MJ2pH20g collected $0.50 from pot
Fp/oksNpipCrD2MJ2pH20g: doesn't show hand
*** SUMMARY ***
Total pot $0.50 | Rake $0
Seat 1: Fp/oksNpipCrD2MJ2pH20g (big blind) collected ($0.50)
Seat 2: Ag6DvxX4vbRheqsv2zXKTQ (button) (small blind) folded before Flop



PokerStars Game #59938385600:  Hold'em No Limit ($0.25/$0.50) - 2009/07/01 0:13:43 ET
Table 'c/CRn+68J3Y8KxD5g1ek2Q' 2-max Seat #2 is the button
Seat 1: 46qCyJ6evTkHo9al5sBMNA ($316.55 in chips)
Seat 2: BypVLsYQt3ePFm2xQL/dOA ($68 in chips)
BypVLsYQt3ePFm2xQL/dOA: posts small blind $0.25
46qCyJ6evTkHo9al5sBMNA: posts big blind $0.50
*** HOLE CARDS ***
BypVLsYQt3ePFm2xQL/dOA: raises $1 to $1.50
46qCyJ6evTkHo9al5sBMNA: folds
BypVLsYQt3ePFm2xQL/dOA collected $1 from pot
BypVLsYQt3ePFm2xQL/dOA: doesn't show hand
*** SUMMARY ***
Total pot $1 | Rake $0
Seat 1: 46qCyJ6evTkHo9al5sBMNA (big blind) folded before Flop
Seat 2: BypVLsYQt3ePFm2xQL/dOA (button) (small blind) collected ($1)



PokerStars Game #59938385746:  Hold'em No Limit ($0.25/$0.50) - 2009/07/01 0:13:43 ET
Table 'BCN5su+SsXiy1zRMJi0SJw' 6-max Seat #2 is the button
Seat 1: WyeokAqR0q9nADSkWpbxHw ($36.85 in chips)
Seat 2: QfV2JJlmEKgD5jYPV+a33A ($177.40 in chips)
Seat 3: L309C3uyA1tkWSOh/QvjHw ($20.40 in chips)
Seat 5: TTx3CHxyi0SObcHyMJRp5w ($33.25 in chips)
L309C3uyA1tkWSOh/QvjHw: posts small blind $0.25
TTx3CHxyi0SObcHyMJRp5w: posts big blind $0.50
*** HOLE CARDS ***
WyeokAqR0q9nADSkWpbxHw: folds
QfV2JJlmEKgD5jYPV+a33A: folds
L309C3uyA1tkWSOh/QvjHw: calls $0.25
TTx3CHxyi0SObcHyMJRp5w: checks
*** FLOP *** [3d Qd Ks]
L309C3uyA1tkWSOh/QvjHw: checks
TTx3CHxyi0SObcHyMJRp5w: checks
*** TURN *** [3d Qd Ks] [Qc]
L309C3uyA1tkWSOh/QvjHw: checks
TTx3CHxyi0SObcHyMJRp5w: checks
*** RIVER *** [3d Qd Ks Qc] [9c]
L309C3uyA1tkWSOh/QvjHw: checks
TTx3CHxyi0SObcHyMJRp5w: checks
*** SHOW DOWN ***
L309C3uyA1tkWSOh/QvjHw: shows [4c 4d] (two pair, Queens and Fours)
TTx3CHxyi0SObcHyMJRp5w: mucks hand
L309C3uyA1tkWSOh/QvjHw collected $0.95 from pot
*** SUMMARY ***
Total pot $1 | Rake $0.05
Board [3d Qd Ks Qc 9c]
Seat 1: WyeokAqR0q9nADSkWpbxHw folded before Flop (didn't bet)
Seat 2: QfV2JJlmEKgD5jYPV+a33A (button) folded before Flop (didn't bet)
Seat 3: L309C3uyA1tkWSOh/QvjHw (small blind) showed [4c 4d] and won ($0.95) with two pair, Queens and Fours
Seat 5: TTx3CHxyi0SObcHyMJRp5w (big blind) mucked



PokerStars Game #59938386758:  Hold'em No Limit ($0.25/$0.50) - 2009/07/01 0:13:45 ET
Table 'm95HVfesC/VPgfGEjPuaIA' 2-max Seat #1 is the button
Seat 1: Fp/oksNpipCrD2MJ2pH20g ($18.45 in chips)
Seat 2: Ag6DvxX4vbRheqsv2zXKTQ ($15.75 in chips)
Fp/oksNpipCrD2MJ2pH20g: posts small blind $0.25
Ag6DvxX4vbRheqsv2zXKTQ: posts big blind $0.50
*** HOLE CARDS ***
Fp/oksNpipCrD2MJ2pH20g: folds
Ag6DvxX4vbRheqsv2zXKTQ collected $0.50 from pot
*** SUMMARY ***
Total pot $0.50 | Rake $0
Seat 1: Fp/oksNpipCrD2MJ2pH20g (button) (small blind) folded before Flop
Seat 2: Ag6DvxX4vbRheqsv2zXKTQ (big blind) collected ($0.50)



PokerStars Game #59938387842:  Hold'em No Limit ($0.25/$0.50) - 2009/07/01 0:13:46 ET
Table 'kgbJRsxfv64KrErDRBAkcw' 6-max Seat #5 is the button
Seat 2: Q+thC23WCv1kJUJtH/+4Jw ($31.20 in chips)
Seat 3: T0Gx/FcQ5VH9u7XaOMX97A ($65.25 in chips)
Seat 4: qanMEqjABjWxC/JgQ/0l7w ($62.70 in chips)
Seat 5: +Pf9jTVizYlIo+woPvptfA ($50 in chips)
Seat 6: DDfYzIrYT0t5R/hAJngtsg ($20.30 in chips)
DDfYzIrYT0t5R/hAJngtsg: posts small blind $0.25
YmWlPGOKFuJSoJZPW8a8IA: is sitting out
Q+thC23WCv1kJUJtH/+4Jw: posts big blind $0.50
*** HOLE CARDS ***
T0Gx/FcQ5VH9u7XaOMX97A: raises $1 to $1.50
YmWlPGOKFuJSoJZPW8a8IA leaves the table
qanMEqjABjWxC/JgQ/0l7w: folds
+Pf9jTVizYlIo+woPvptfA: folds
DDfYzIrYT0t5R/hAJngtsg: calls $1.25
Q+thC23WCv1kJUJtH/+4Jw: folds
*** FLOP *** [Qs 5c 9s]
DDfYzIrYT0t5R/hAJngtsg: checks
T0Gx/FcQ5VH9u7XaOMX97A: bets $2
DDfYzIrYT0t5R/hAJngtsg: calls $2
*** TURN *** [Qs 5c 9s] [2c]
DDfYzIrYT0t5R/hAJngtsg: checks
T0Gx/FcQ5VH9u7XaOMX97A: checks
*** RIVER *** [Qs 5c 9s 2c] [3s]
DDfYzIrYT0t5R/hAJngtsg: checks
T0Gx/FcQ5VH9u7XaOMX97A: checks
*** SHOW DOWN ***
DDfYzIrYT0t5R/hAJngtsg: shows [8d Qd] (a pair of Queens)
T0Gx/FcQ5VH9u7XaOMX97A: mucks hand
DDfYzIrYT0t5R/hAJngtsg collected $7.15 from pot
*** SUMMARY ***
Total pot $7.50 | Rake $0.35
Board [Qs 5c 9s 2c 3s]
Seat 2: Q+thC23WCv1kJUJtH/+4Jw (big blind) folded before Flop
Seat 3: T0Gx/FcQ5VH9u7XaOMX97A mucked
Seat 4: qanMEqjABjWxC/JgQ/0l7w folded before Flop (didn't bet)
Seat 5: +Pf9jTVizYlIo+woPvptfA (button) folded before Flop (didn't bet)
Seat 6: DDfYzIrYT0t5R/hAJngtsg (small blind) showed [8d Qd] and won ($7.15) with a pair of Queens



PokerStars Game #59938389168:  Hold'em No Limit ($0.25/$0.50) - 2009/07/01 0:13:48 ET
Table '+dXkOAQyS8j9PQZusUTMpg' 2-max Seat #2 is the button
Seat 1: XFa6sBGjP2gxoIvxR3fZIg ($84.45 in chips)
Seat 2: 5IBeOgaApY1Bvzv2P8X4EA ($27.55 in chips)
5IBeOgaApY1Bvzv2P8X4EA: posts small blind $0.25
XFa6sBGjP2gxoIvxR3fZIg: posts big blind $0.50
*** HOLE CARDS ***
5IBeOgaApY1Bvzv2P8X4EA: calls $0.25
XFa6sBGjP2gxoIvxR3fZIg: checks
*** FLOP *** [5h 4h Ah]
XFa6sBGjP2gxoIvxR3fZIg: checks
5IBeOgaApY1Bvzv2P8X4EA: bets $1
XFa6sBGjP2gxoIvxR3fZIg: calls $1
*** TURN *** [5h 4h Ah] [Ks]
XFa6sBGjP2gxoIvxR3fZIg: checks
5IBeOgaApY1Bvzv2P8X4EA: bets $1.50
XFa6sBGjP2gxoIvxR3fZIg: raises $4.50 to $6
5IBeOgaApY1Bvzv2P8X4EA: calls $4.50
*** RIVER *** [5h 4h Ah Ks] [2h]
XFa6sBGjP2gxoIvxR3fZIg: checks
5IBeOgaApY1Bvzv2P8X4EA: checks
*** SHOW DOWN ***
XFa6sBGjP2gxoIvxR3fZIg: shows [9h 8s] (a flush, Ace high)
5IBeOgaApY1Bvzv2P8X4EA: mucks hand
XFa6sBGjP2gxoIvxR3fZIg collected $14.50 from pot
*** SUMMARY ***
Total pot $15 | Rake $0.50
Board [5h 4h Ah Ks 2h]
Seat 1: XFa6sBGjP2gxoIvxR3fZIg (big blind) showed [9h 8s] and won ($14.50) with a flush, Ace high
Seat 2: 5IBeOgaApY1Bvzv2P8X4EA (button) (small blind) mucked



PokerStars Game #59938389414:  Hold'em No Limit ($0.25/$0.50) - 2009/07/01 0:13:49 ET
Table 'mTxf8gPLgffN3Iwfm7Icfg' 2-max Seat #1 is the button
Seat 1: Do9Rlu1R5u/AcRtMTl8SYg ($57.60 in chips)
Seat 2: EMc5LPgVaded4Qc77vm0fw ($55.65 in chips)
Do9Rlu1R5u/AcRtMTl8SYg: posts small blind $0.25
EMc5LPgVaded4Qc77vm0fw: posts big blind $0.50
*** HOLE CARDS ***
Do9Rlu1R5u/AcRtMTl8SYg: raises $1 to $1.50
EMc5LPgVaded4Qc77vm0fw: calls $1
*** FLOP *** [9s Ts Qc]
EMc5LPgVaded4Qc77vm0fw: checks
Do9Rlu1R5u/AcRtMTl8SYg: bets $2
EMc5LPgVaded4Qc77vm0fw: folds
Do9Rlu1R5u/AcRtMTl8SYg collected $2.85 from pot
Do9Rlu1R5u/AcRtMTl8SYg: doesn't show hand
*** SUMMARY ***
Total pot $3 | Rake $0.15
Board [9s Ts Qc]
Seat 1: Do9Rlu1R5u/AcRtMTl8SYg (button) (small blind) collected ($2.85)
Seat 2: EMc5LPgVaded4Qc77vm0fw (big blind) folded on the Flop



PokerStars Game #59938390872:  Hold'em No Limit ($0.25/$0.50) - 2009/07/01 0:13:51 ET
Table 'raOT4/ipuZgzjfKHC+jD9g' 2-max Seat #1 is the button
Seat 1: IuwLemwLhc9fvrwBGs0AMA ($12.90 in chips)
Seat 2: Udr5juWSWUgTu1NlRhjMdA ($10 in chips)
IuwLemwLhc9fvrwBGs0AMA: posts small blind $0.25
Udr5juWSWUgTu1NlRhjMdA: posts big blind $0.50
*** HOLE CARDS ***
IuwLemwLhc9fvrwBGs0AMA: calls $0.25
Udr5juWSWUgTu1NlRhjMdA: checks
*** FLOP *** [5c 6s Kc]
Udr5juWSWUgTu1NlRhjMdA: checks
IuwLemwLhc9fvrwBGs0AMA: checks
*** TURN *** [5c 6s Kc] [2h]
Udr5juWSWUgTu1NlRhjMdA: checks
IuwLemwLhc9fvrwBGs0AMA: bets $1
Udr5juWSWUgTu1NlRhjMdA: folds
IuwLemwLhc9fvrwBGs0AMA collected $0.95 from pot
*** SUMMARY ***
Total pot $1 | Rake $0.05
Board [5c 6s Kc 2h]
Seat 1: IuwLemwLhc9fvrwBGs0AMA (button) (small blind) collected ($0.95)
Seat 2: Udr5juWSWUgTu1NlRhjMdA (big blind) folded on the Turn



PokerStars Game #59938391508:  Hold'em No Limit ($0.25/$0.50) - 2009/07/01 0:13:52 ET
Table 'm95HVfesC/VPgfGEjPuaIA' 2-max Seat #2 is the button
Seat 1: Fp/oksNpipCrD2MJ2pH20g ($18.20 in chips)
Seat 2: Ag6DvxX4vbRheqsv2zXKTQ ($16 in chips)
Ag6DvxX4vbRheqsv2zXKTQ: posts small blind $0.25
Fp/oksNpipCrD2MJ2pH20g: posts big blind $0.50
*** HOLE CARDS ***
Ag6DvxX4vbRheqsv2zXKTQ: folds
Fp/oksNpipCrD2MJ2pH20g collected $0.50 from pot
Fp/oksNpipCrD2MJ2pH20g: doesn't show hand
*** SUMMARY ***
Total pot $0.50 | Rake $0
Seat 1: Fp/oksNpipCrD2MJ2pH20g (big blind) collected ($0.50)
Seat 2: Ag6DvxX4vbRheqsv2zXKTQ (button) (small blind) folded before Flop



PokerStars Game #59938391904:  Hold'em No Limit ($0.25/$0.50) - 2009/07/01 0:13:52 ET
Table 'c/CRn+68J3Y8KxD5g1ek2Q' 2-max Seat #1 is the button
Seat 1: 46qCyJ6evTkHo9al5sBMNA ($316.05 in chips)
Seat 2: BypVLsYQt3ePFm2xQL/dOA ($68.50 in chips)
46qCyJ6evTkHo9al5sBMNA: posts small blind $0.25
BypVLsYQt3ePFm2xQL/dOA: posts big blind $0.50
*** HOLE CARDS ***
46qCyJ6evTkHo9al5sBMNA: folds
BypVLsYQt3ePFm2xQL/dOA collected $0.50 from pot
BypVLsYQt3ePFm2xQL/dOA: doesn't show hand
*** SUMMARY ***
Total pot $0.50 | Rake $0
Seat 1: 46qCyJ6evTkHo9al5sBMNA (button) (small blind) folded before Flop
Seat 2: BypVLsYQt3ePFm2xQL/dOA (big blind) collected ($0.50)



PokerStars Game #59938392084:  Hold'em No Limit ($0.25/$0.50) - 2009/07/01 0:13:52 ET
Table 'MJxeZCzYELxiIsyUZyT0jw' 6-max Seat #4 is the button
Seat 1: iKPos8JI094Tomq4tDSgnQ ($34.05 in chips)
Seat 2: r6H1GiZ6QIpMTDhyodKuRQ ($64.15 in chips)
Seat 3: JQZew0FjzS19kTjeNtrE+A ($50 in chips)
Seat 4: lP7Q6pewz4C2RsAfKsjdWw ($21.60 in chips)
Seat 5: 3jvoOXNtXE90w2BdfNZwZQ ($51.40 in chips)
Seat 6: TTx3CHxyi0SObcHyMJRp5w ($49.30 in chips)
3jvoOXNtXE90w2BdfNZwZQ: posts small blind $0.25
TTx3CHxyi0SObcHyMJRp5w: posts big blind $0.50
*** HOLE CARDS ***
iKPos8JI094Tomq4tDSgnQ: folds
r6H1GiZ6QIpMTDhyodKuRQ: calls $0.50
JQZew0FjzS19kTjeNtrE+A: folds
lP7Q6pewz4C2RsAfKsjdWw: folds
3jvoOXNtXE90w2BdfNZwZQ: folds
TTx3CHxyi0SObcHyMJRp5w: checks
*** FLOP *** [Qh Js 4c]
TTx3CHxyi0SObcHyMJRp5w: checks
r6H1GiZ6QIpMTDhyodKuRQ: checks
*** TURN *** [Qh Js 4c] [Qd]
TTx3CHxyi0SObcHyMJRp5w: checks
r6H1GiZ6QIpMTDhyodKuRQ: checks
*** RIVER *** [Qh Js 4c Qd] [Ks]
TTx3CHxyi0SObcHyMJRp5w: bets $0.50
r6H1GiZ6QIpMTDhyodKuRQ: calls $0.50
*** SHOW DOWN ***
TTx3CHxyi0SObcHyMJRp5w: shows [7d 6d] (a pair of Queens)
r6H1GiZ6QIpMTDhyodKuRQ: shows [2s 2d] (two pair, Queens and Deuces)
r6H1GiZ6QIpMTDhyodKuRQ collected $2.15 from pot
*** SUMMARY ***
Total pot $2.25 | Rake $0.10
Board [Qh Js 4c Qd Ks]
Seat 1: iKPos8JI094Tomq4tDSgnQ folded before Flop (didn't bet)
Seat 2: r6H1GiZ6QIpMTDhyodKuRQ showed [2s 2d] and won ($2.15) with two pair, Queens and Deuces
Seat 3: JQZew0FjzS19kTjeNtrE+A folded before Flop (didn't bet)
Seat 4: lP7Q6pewz4C2RsAfKsjdWw (button) folded before Flop (didn't bet)
Seat 5: 3jvoOXNtXE90w2BdfNZwZQ (small blind) folded before Flop
Seat 6: TTx3CHxyi0SObcHyMJRp5w (big blind) showed [7d 6d] and lost with a pair of Queens



PokerStars Game #59938393426:  Hold'em No Limit ($0.25/$0.50) - 2009/07/01 0:13:54 ET
Table 'Nz0Vr7WMHL2g5Uk7dDZjpw' 9-max Seat #7 is the button
Seat 1: tLkxo7JgV+WWI0UBw44K5A ($104.85 in chips)
Seat 3: 4QTiNH5fteLgJjx/s6Hy6A ($7.40 in chips)
Seat 4: 5JJVDlaiMnB004o/RqbZZQ ($27 in chips)
Seat 5: WGW0DgjBUXs1ylURHG8vnQ ($18.10 in chips)
Seat 6: k1f0lS7tlMHCLGs0JT34Tg ($8 in chips)
Seat 7: KPLH0gELgFe2OuAnhJFI5w ($21.45 in chips)
Seat 8: HkZI6g4zl83TDTA7SRspmQ ($16.75 in chips)
Seat 9: Ak2W6V2TDVIQrvSAy4eD7Q ($24.90 in chips)
HkZI6g4zl83TDTA7SRspmQ: posts small blind $0.25
Ak2W6V2TDVIQrvSAy4eD7Q: posts big blind $0.50
*** HOLE CARDS ***
tLkxo7JgV+WWI0UBw44K5A: raises $1 to $1.50
4QTiNH5fteLgJjx/s6Hy6A: folds
5JJVDlaiMnB004o/RqbZZQ: folds
WGW0DgjBUXs1ylURHG8vnQ: folds
k1f0lS7tlMHCLGs0JT34Tg: folds
KPLH0gELgFe2OuAnhJFI5w: folds
HkZI6g4zl83TDTA7SRspmQ: folds
Ak2W6V2TDVIQrvSAy4eD7Q: calls $1
*** FLOP *** [3c 9s Kc]
Ak2W6V2TDVIQrvSAy4eD7Q: checks
tLkxo7JgV+WWI0UBw44K5A: bets $2
Ak2W6V2TDVIQrvSAy4eD7Q: calls $2
*** TURN *** [3c 9s Kc] [7c]
Ak2W6V2TDVIQrvSAy4eD7Q: bets $4
tLkxo7JgV+WWI0UBw44K5A: folds
Ak2W6V2TDVIQrvSAy4eD7Q collected $6.90 from pot
Ak2W6V2TDVIQrvSAy4eD7Q: doesn't show hand
*** SUMMARY ***
Total pot $7.25 | Rake $0.35
Board [3c 9s Kc 7c]
Seat 1: tLkxo7JgV+WWI0UBw44K5A folded on the Turn
Seat 3: 4QTiNH5fteLgJjx/s6Hy6A folded before Flop (didn't bet)
Seat 4: 5JJVDlaiMnB004o/RqbZZQ folded before Flop (didn't bet)
Seat 5: WGW0DgjBUXs1ylURHG8vnQ folded before Flop (didn't bet)
Seat 6: k1f0lS7tlMHCLGs0JT34Tg folded before Flop (didn't bet)
Seat 7: KPLH0gELgFe2OuAnhJFI5w (button) folded before Flop (didn't bet)
Seat 8: HkZI6g4zl83TDTA7SRspmQ (small blind) folded before Flop
Seat 9: Ak2W6V2TDVIQrvSAy4eD7Q (big blind) collected ($6.90)



PokerStars Game #59938394052:  Hold'em No Limit ($0.25/$0.50) - 2009/07/01 0:13:55 ET
Table 'tyR5AZNKV8Aadbrnrnlg7g' 6-max Seat #5 is the button
Seat 1: R+KjpH/wSjDLhtIy9+edNA ($54.10 in chips)
Seat 2: 58zdeSBSuSFX/qZfhc7YmA ($31.10 in chips)
Seat 3: jUhx+m+V7qfbLZTjgwZByg ($46.60 in chips)
Seat 4: Rt6KgtZ8YaJoTc3FPim00w ($50.50 in chips)
Seat 5: EIg3r3fRFKG2HhgpDlIJHg ($18.50 in chips)
Seat 6: DMQLAmut/l19xN5STQndFg ($10.80 in chips)
DMQLAmut/l19xN5STQndFg: posts small blind $0.25
R+KjpH/wSjDLhtIy9+edNA: posts big blind $0.50
*** HOLE CARDS ***
58zdeSBSuSFX/qZfhc7YmA: folds
jUhx+m+V7qfbLZTjgwZByg: folds
Rt6KgtZ8YaJoTc3FPim00w: folds
EIg3r3fRFKG2HhgpDlIJHg: calls $0.50
DMQLAmut/l19xN5STQndFg: folds
R+KjpH/wSjDLhtIy9+edNA: checks
*** FLOP *** [2h 4d 2s]
R+KjpH/wSjDLhtIy9+edNA: bets $1
EIg3r3fRFKG2HhgpDlIJHg: calls $1
*** TURN *** [2h 4d 2s] [Jc]
R+KjpH/wSjDLhtIy9+edNA: checks
EIg3r3fRFKG2HhgpDlIJHg: bets $1
R+KjpH/wSjDLhtIy9+edNA: folds
EIg3r3fRFKG2HhgpDlIJHg collected $3.10 from pot
*** SUMMARY ***
Total pot $3.25 | Rake $0.15
Board [2h 4d 2s Jc]
Seat 1: R+KjpH/wSjDLhtIy9+edNA (big blind) folded on the Turn
Seat 2: 58zdeSBSuSFX/qZfhc7YmA folded before Flop (didn't bet)
Seat 3: jUhx+m+V7qfbLZTjgwZByg folded before Flop (didn't bet)
Seat 4: Rt6KgtZ8YaJoTc3FPim00w folded before Flop (didn't bet)
Seat 5: EIg3r3fRFKG2HhgpDlIJHg (button) collected ($3.10)
Seat 6: DMQLAmut/l19xN5STQndFg (small blind) folded before Flop



PokerStars Game #59938395362:  Hold'em No Limit ($0.25/$0.50) - 2009/07/01 0:13:57 ET
Table 'm95HVfesC/VPgfGEjPuaIA' 2-max Seat #1 is the button
Seat 1: Fp/oksNpipCrD2MJ2pH20g ($18.45 in chips)
Seat 2: Ag6DvxX4vbRheqsv2zXKTQ ($15.75 in chips)
Fp/oksNpipCrD2MJ2pH20g: posts small blind $0.25
Ag6DvxX4vbRheqsv2zXKTQ: posts big blind $0.50
*** HOLE CARDS ***
Fp/oksNpipCrD2MJ2pH20g: raises $1 to $1.50
Ag6DvxX4vbRheqsv2zXKTQ: calls $1
*** FLOP *** [Ac 4c 8d]
Ag6DvxX4vbRheqsv2zXKTQ: checks
Fp/oksNpipCrD2MJ2pH20g: bets $1.50
Ag6DvxX4vbRheqsv2zXKTQ: folds
Fp/oksNpipCrD2MJ2pH20g collected $2.85 from pot
Fp/oksNpipCrD2MJ2pH20g: doesn't show hand
*** SUMMARY ***
Total pot $3 | Rake $0.15
Board [Ac 4c 8d]
Seat 1: Fp/oksNpipCrD2MJ2pH20g (button) (small blind) collected ($2.85)
Seat 2: Ag6DvxX4vbRheqsv2zXKTQ (big blind) folded on the Flop



PokerStars Game #59938395252:  Hold'em No Limit ($0.25/$0.50) - 2009/07/01 0:13:57 ET
Table 'Vdlc9wqYcHTUhtdyN7CuJw' 2-max Seat #1 is the button
Seat 1: yBO+mXB6m/rCft2ErwGf/Q ($80.10 in chips)
Seat 2: sa0qgETiL3HNbdfGlnKHTA ($31.30 in chips)
yBO+mXB6m/rCft2ErwGf/Q: posts small blind $0.25
sa0qgETiL3HNbdfGlnKHTA: posts big blind $0.50
*** HOLE CARDS ***
yBO+mXB6m/rCft2ErwGf/Q: folds
sa0qgETiL3HNbdfGlnKHTA collected $0.50 from pot
sa0qgETiL3HNbdfGlnKHTA: doesn't show hand
*** SUMMARY ***
Total pot $0.50 | Rake $0
Seat 1: yBO+mXB6m/rCft2ErwGf/Q (button) (small blind) folded before Flop
Seat 2: sa0qgETiL3HNbdfGlnKHTA (big blind) collected ($0.50)



PokerStars Game #59938396544:  Hold'em No Limit ($0.25/$0.50) - 2009/07/01 0:13:59 ET
Table 'c/CRn+68J3Y8KxD5g1ek2Q' 2-max Seat #2 is the button
Seat 1: 46qCyJ6evTkHo9al5sBMNA ($315.80 in chips)
Seat 2: BypVLsYQt3ePFm2xQL/dOA ($68.75 in chips)
BypVLsYQt3ePFm2xQL/dOA: posts small blind $0.25
46qCyJ6evTkHo9al5sBMNA: posts big blind $0.50
*** HOLE CARDS ***
BypVLsYQt3ePFm2xQL/dOA: raises $1 to $1.50
46qCyJ6evTkHo9al5sBMNA: folds
BypVLsYQt3ePFm2xQL/dOA collected $1 from pot
BypVLsYQt3ePFm2xQL/dOA: doesn't show hand
*** SUMMARY ***
Total pot $1 | Rake $0
Seat 1: 46qCyJ6evTkHo9al5sBMNA (big blind) folded before Flop
Seat 2: BypVLsYQt3ePFm2xQL/dOA (button) (small blind) collected ($1)



PokerStars Game #59938396388:  Hold'em No Limit ($0.25/$0.50) - 2009/07/01 0:13:59 ET
Table 'T/PgNWqVyY6lkldcBVXYJQ' 6-max Seat #3 is the button
Seat 1: +Pf9jTVizYlIo+woPvptfA ($53.20 in chips)
Seat 2: oZAeY5rVqNGgt8yyQ0pxbA ($26.30 in chips)
Seat 3: L3OcNO1bgdqDI46j67KQPQ ($50 in chips)
Seat 4: jxMvxeUUL9UU0V6wVU+Iyw ($4.35 in chips)
Seat 5: vVQBckETtigfb5mAcyK0OA ($62.25 in chips)
Seat 6: cDzbog6kwmJp+LBeBq+iMQ ($24.25 in chips)
jxMvxeUUL9UU0V6wVU+Iyw: posts small blind $0.25
vVQBckETtigfb5mAcyK0OA: posts big blind $0.50
*** HOLE CARDS ***
vVQBckETtigfb5mAcyK0OA said, "LOL"
cDzbog6kwmJp+LBeBq+iMQ: calls $0.50
+Pf9jTVizYlIo+woPvptfA: folds
oZAeY5rVqNGgt8yyQ0pxbA: calls $0.50
L3OcNO1bgdqDI46j67KQPQ: raises $2.50 to $3
jxMvxeUUL9UU0V6wVU+Iyw: folds
vVQBckETtigfb5mAcyK0OA: folds
cDzbog6kwmJp+LBeBq+iMQ: calls $2.50
oZAeY5rVqNGgt8yyQ0pxbA: calls $2.50
*** FLOP *** [Jd 6c 3c]
jxMvxeUUL9UU0V6wVU+Iyw said, "Story of my life"
vVQBckETtigfb5mAcyK0OA said, "I AM SINGLE"
cDzbog6kwmJp+LBeBq+iMQ: checks
oZAeY5rVqNGgt8yyQ0pxbA: checks
L3OcNO1bgdqDI46j67KQPQ: bets $7
vVQBckETtigfb5mAcyK0OA said, "WAS MARRIED FOR 10 YEARS"
jxMvxeUUL9UU0V6wVU+Iyw said, "same.  call me if you want. 647-883-5535"
cDzbog6kwmJp+LBeBq+iMQ: folds
oZAeY5rVqNGgt8yyQ0pxbA: folds
L3OcNO1bgdqDI46j67KQPQ collected $9.30 from pot
L3OcNO1bgdqDI46j67KQPQ: doesn't show hand
*** SUMMARY ***
Total pot $9.75 | Rake $0.45
Board [Jd 6c 3c]
Seat 1: +Pf9jTVizYlIo+woPvptfA folded before Flop (didn't bet)
Seat 2: oZAeY5rVqNGgt8yyQ0pxbA folded on the Flop
Seat 3: L3OcNO1bgdqDI46j67KQPQ (button) collected ($9.30)
Seat 4: jxMvxeUUL9UU0V6wVU+Iyw (small blind) folded before Flop
Seat 5: vVQBckETtigfb5mAcyK0OA (big blind) folded before Flop
Seat 6: cDzbog6kwmJp+LBeBq+iMQ folded on the Flop



PokerStars Game #59938397756:  Hold'em No Limit ($0.25/$0.50) - 2009/07/01 0:14:01 ET
Table 'ZYwMb9E6tY50Qm+iNbXRYw' 2-max Seat #1 is the button
Seat 1: DXLfRb8KDZWmrztw2bwtFw ($24.95 in chips)
Seat 2: 16tvT7AYgZ2LgiGFcvFKQg ($12.40 in chips)
DXLfRb8KDZWmrztw2bwtFw: posts small blind $0.25
16tvT7AYgZ2LgiGFcvFKQg: posts big blind $0.50
*** HOLE CARDS ***
DXLfRb8KDZWmrztw2bwtFw: calls $0.25
16tvT7AYgZ2LgiGFcvFKQg: checks
*** FLOP *** [9s 6c 9d]
16tvT7AYgZ2LgiGFcvFKQg: bets $0.50
DXLfRb8KDZWmrztw2bwtFw: calls $0.50
*** TURN *** [9s 6c 9d] [6h]
16tvT7AYgZ2LgiGFcvFKQg: bets $0.50
DXLfRb8KDZWmrztw2bwtFw: calls $0.50
*** RIVER *** [9s 6c 9d 6h] [4c]
16tvT7AYgZ2LgiGFcvFKQg: bets $0.50
DXLfRb8KDZWmrztw2bwtFw: folds
16tvT7AYgZ2LgiGFcvFKQg collected $2.90 from pot
*** SUMMARY ***
Total pot $3 | Rake $0.10
Board [9s 6c 9d 6h 4c]
Seat 1: DXLfRb8KDZWmrztw2bwtFw (button) (small blind) folded on the River
Seat 2: 16tvT7AYgZ2LgiGFcvFKQg (big blind) collected ($2.90)



PokerStars Game #59938397736:  Hold'em No Limit ($0.25/$0.50) - 2009/07/01 0:14:01 ET
Table '37qXEp3oe+er5q4CZip9eQ' 6-max Seat #2 is the button
Seat 1: oqOqoO2AyCZenUghCxMDxw ($50 in chips)
Seat 2: g12O9qXTybyo2C0B2bXgjg ($30.40 in chips)
Seat 3: Rt6KgtZ8YaJoTc3FPim00w ($99.70 in chips)
Seat 5: VOmI0x4dDPnTESZd5B4d1Q ($38.25 in chips)
Seat 6: f7zPpUQp9hHZgqhEvrUWQw ($53.65 in chips)
Rt6KgtZ8YaJoTc3FPim00w: posts small blind $0.25
L0aIPg7qefDQjdJo3HCVEA: is sitting out
L0aIPg7qefDQjdJo3HCVEA leaves the table
VOmI0x4dDPnTESZd5B4d1Q: posts big blind $0.50
*** HOLE CARDS ***
f7zPpUQp9hHZgqhEvrUWQw: folds
oqOqoO2AyCZenUghCxMDxw: raises $1 to $1.50
g12O9qXTybyo2C0B2bXgjg: calls $1.50
Rt6KgtZ8YaJoTc3FPim00w: folds
VOmI0x4dDPnTESZd5B4d1Q: calls $1
*** FLOP *** [8c 9d Kd]
VOmI0x4dDPnTESZd5B4d1Q: checks
oqOqoO2AyCZenUghCxMDxw: checks
g12O9qXTybyo2C0B2bXgjg: checks
*** TURN *** [8c 9d Kd] [6s]
VOmI0x4dDPnTESZd5B4d1Q: checks
oqOqoO2AyCZenUghCxMDxw: checks
g12O9qXTybyo2C0B2bXgjg: checks
*** RIVER *** [8c 9d Kd 6s] [4d]
VOmI0x4dDPnTESZd5B4d1Q: bets $5
oqOqoO2AyCZenUghCxMDxw: folds
g12O9qXTybyo2C0B2bXgjg: folds
VOmI0x4dDPnTESZd5B4d1Q collected $4.55 from pot
*** SUMMARY ***
Total pot $4.75 | Rake $0.20
Board [8c 9d Kd 6s 4d]
Seat 1: oqOqoO2AyCZenUghCxMDxw folded on the River
Seat 2: g12O9qXTybyo2C0B2bXgjg (button) folded on the River
Seat 3: Rt6KgtZ8YaJoTc3FPim00w (small blind) folded before Flop
Seat 5: VOmI0x4dDPnTESZd5B4d1Q (big blind) collected ($4.55)
Seat 6: f7zPpUQp9hHZgqhEvrUWQw folded before Flop (didn't bet)



PokerStars Game #59938400318:  Hold'em No Limit ($0.25/$0.50) - 2009/07/01 0:14:05 ET
Table 'QOgaEqMcJ73pcUMMxoisUg' 6-max Seat #6 is the button
Seat 1: RFefXIDyFvNtJLq+CloCzA ($41.95 in chips)
Seat 2: Im2p1Nt83UKSqv5c9frm4Q ($50 in chips)
Seat 3: wUZNozoIDYf+16hp4nn6dw ($43.80 in chips)
Seat 4: zAcsDhG/T128Vn7XGVSgKg ($54.20 in chips)
Seat 6: s83dnhZ6VC53vY0/f6OV/g ($48.50 in chips)
RFefXIDyFvNtJLq+CloCzA: posts small blind $0.25
Im2p1Nt83UKSqv5c9frm4Q: posts big blind $0.50
*** HOLE CARDS ***
wUZNozoIDYf+16hp4nn6dw: calls $0.50
zAcsDhG/T128Vn7XGVSgKg: folds
s83dnhZ6VC53vY0/f6OV/g: folds
RFefXIDyFvNtJLq+CloCzA: folds
Im2p1Nt83UKSqv5c9frm4Q: checks
*** FLOP *** [Th Kc 4c]
Im2p1Nt83UKSqv5c9frm4Q: checks
wUZNozoIDYf+16hp4nn6dw: bets $2
Im2p1Nt83UKSqv5c9frm4Q: folds
wUZNozoIDYf+16hp4nn6dw collected $1.20 from pot
*** SUMMARY ***
Total pot $1.25 | Rake $0.05
Board [Th Kc 4c]
Seat 1: RFefXIDyFvNtJLq+CloCzA (small blind) folded before Flop
Seat 2: Im2p1Nt83UKSqv5c9frm4Q (big blind) folded on the Flop
Seat 3: wUZNozoIDYf+16hp4nn6dw collected ($1.20)
Seat 4: zAcsDhG/T128Vn7XGVSgKg folded before Flop (didn't bet)
Seat 6: s83dnhZ6VC53vY0/f6OV/g (button) folded before Flop (didn't bet)



PokerStars Game #59938400428:  Hold'em No Limit ($0.25/$0.50) - 2009/07/01 0:14:05 ET
Table 'Vdlc9wqYcHTUhtdyN7CuJw' 2-max Seat #2 is the button
Seat 1: yBO+mXB6m/rCft2ErwGf/Q ($79.85 in chips)
Seat 2: sa0qgETiL3HNbdfGlnKHTA ($31.55 in chips)
sa0qgETiL3HNbdfGlnKHTA: posts small blind $0.25
yBO+mXB6m/rCft2ErwGf/Q: posts big blind $0.50
*** HOLE CARDS ***
sa0qgETiL3HNbdfGlnKHTA: raises $0.50 to $1
yBO+mXB6m/rCft2ErwGf/Q: calls $0.50
*** FLOP *** [2c Jd 5h]
yBO+mXB6m/rCft2ErwGf/Q: checks
sa0qgETiL3HNbdfGlnKHTA: bets $1
yBO+mXB6m/rCft2ErwGf/Q: calls $1
*** TURN *** [2c Jd 5h] [8h]
yBO+mXB6m/rCft2ErwGf/Q: checks
sa0qgETiL3HNbdfGlnKHTA: bets $2.50
yBO+mXB6m/rCft2ErwGf/Q: calls $2.50
*** RIVER *** [2c Jd 5h 8h] [9d]
yBO+mXB6m/rCft2ErwGf/Q: checks
sa0qgETiL3HNbdfGlnKHTA: bets $5.50
yBO+mXB6m/rCft2ErwGf/Q: calls $5.50
*** SHOW DOWN ***
sa0qgETiL3HNbdfGlnKHTA: shows [9c Jc] (two pair, Jacks and Nines)
yBO+mXB6m/rCft2ErwGf/Q: shows [Jh 7c] (a pair of Jacks)
sa0qgETiL3HNbdfGlnKHTA collected $19.50 from pot
*** SUMMARY ***
Total pot $20 | Rake $0.50
Board [2c Jd 5h 8h 9d]
Seat 1: yBO+mXB6m/rCft2ErwGf/Q (big blind) showed [Jh 7c] and lost with a pair of Jacks
Seat 2: sa0qgETiL3HNbdfGlnKHTA (button) (small blind) showed [9c Jc] and won ($19.50) with two pair, Jacks and Nines



PokerStars Game #59938400988:  Hold'em No Limit ($0.25/$0.50) - 2009/07/01 0:14:06 ET
Table 'hSTs/dUsYLgJQuF2Onp0MQ' 6-max Seat #6 is the button
Seat 1: lWwl5C/UZOsWNubdUqghZw ($70.20 in chips)
Seat 3: vQOrJuXbLC3UZDVklY9bOA ($19.95 in chips)
Seat 4: L0aIPg7qefDQjdJo3HCVEA ($14.45 in chips)
Seat 5: 686aeHikcJlgKkSuIFdcXQ ($59.90 in chips)
Seat 6: +laPa9P7BjZKKnR0n+OmvA ($4.15 in chips)
lWwl5C/UZOsWNubdUqghZw: posts small blind $0.25
vQOrJuXbLC3UZDVklY9bOA: posts big blind $0.50
*** HOLE CARDS ***
L0aIPg7qefDQjdJo3HCVEA: folds
686aeHikcJlgKkSuIFdcXQ: folds
+laPa9P7BjZKKnR0n+OmvA: folds
lWwl5C/UZOsWNubdUqghZw: folds
vQOrJuXbLC3UZDVklY9bOA collected $0.50 from pot
vQOrJuXbLC3UZDVklY9bOA: doesn't show hand
*** SUMMARY ***
Total pot $0.50 | Rake $0
Seat 1: lWwl5C/UZOsWNubdUqghZw (small blind) folded before Flop
Seat 3: vQOrJuXbLC3UZDVklY9bOA (big blind) collected ($0.50)
Seat 4: L0aIPg7qefDQjdJo3HCVEA folded before Flop (didn't bet)
Seat 5: 686aeHikcJlgKkSuIFdcXQ folded before Flop (didn't bet)
Seat 6: +laPa9P7BjZKKnR0n+OmvA (button) folded before Flop (didn't bet)



PokerStars Game #59938402462:  Hold'em No Limit ($0.25/$0.50) - 2009/07/01 0:14:08 ET
Table 'c/CRn+68J3Y8KxD5g1ek2Q' 2-max Seat #1 is the button
Seat 1: 46qCyJ6evTkHo9al5sBMNA ($315.30 in chips)
Seat 2: BypVLsYQt3ePFm2xQL/dOA ($69.25 in chips)
46qCyJ6evTkHo9al5sBMNA: posts small blind $0.25
BypVLsYQt3ePFm2xQL/dOA: posts big blind $0.50
*** HOLE CARDS ***
46qCyJ6evTkHo9al5sBMNA: raises $1.50 to $2
BypVLsYQt3ePFm2xQL/dOA: raises $3.50 to $5.50
46qCyJ6evTkHo9al5sBMNA: calls $3.50
*** FLOP *** [Qh 9d 4c]
BypVLsYQt3ePFm2xQL/dOA: bets $5.50
46qCyJ6evTkHo9al5sBMNA: calls $5.50
*** TURN *** [Qh 9d 4c] [Qc]
BypVLsYQt3ePFm2xQL/dOA: checks
46qCyJ6evTkHo9al5sBMNA: checks
*** RIVER *** [Qh 9d 4c Qc] [Jh]
BypVLsYQt3ePFm2xQL/dOA: bets $12
46qCyJ6evTkHo9al5sBMNA: calls $12
*** SHOW DOWN ***
BypVLsYQt3ePFm2xQL/dOA: shows [Kh Kc] (two pair, Kings and Queens)
46qCyJ6evTkHo9al5sBMNA: mucks hand
BypVLsYQt3ePFm2xQL/dOA collected $45.50 from pot
*** SUMMARY ***
Total pot $46 | Rake $0.50
Board [Qh 9d 4c Qc Jh]
Seat 1: 46qCyJ6evTkHo9al5sBMNA (button) (small blind) mucked
Seat 2: BypVLsYQt3ePFm2xQL/dOA (big blind) showed [Kh Kc] and won ($45.50) with two pair, Kings and Queens



PokerStars Game #59938403746:  Hold'em No Limit ($0.25/$0.50) - 2009/07/01 0:14:10 ET
Table 'mTxf8gPLgffN3Iwfm7Icfg' 2-max Seat #2 is the button
Seat 1: Do9Rlu1R5u/AcRtMTl8SYg ($58.95 in chips)
Seat 2: EMc5LPgVaded4Qc77vm0fw ($54.15 in chips)
EMc5LPgVaded4Qc77vm0fw: posts small blind $0.25
Do9Rlu1R5u/AcRtMTl8SYg: posts big blind $0.50
*** HOLE CARDS ***
EMc5LPgVaded4Qc77vm0fw: raises $1.50 to $2
Do9Rlu1R5u/AcRtMTl8SYg: calls $1.50
*** FLOP *** [Ac Tc 7s]
Do9Rlu1R5u/AcRtMTl8SYg: checks
EMc5LPgVaded4Qc77vm0fw: bets $2
Do9Rlu1R5u/AcRtMTl8SYg: folds
EMc5LPgVaded4Qc77vm0fw collected $3.80 from pot
EMc5LPgVaded4Qc77vm0fw: doesn't show hand
*** SUMMARY ***
Total pot $4 | Rake $0.20
Board [Ac Tc 7s]
Seat 1: Do9Rlu1R5u/AcRtMTl8SYg (big blind) folded on the Flop
Seat 2: EMc5LPgVaded4Qc77vm0fw (button) (small blind) collected ($3.80)



PokerStars Game #59938404916:  Hold'em No Limit ($0.25/$0.50) - 2009/07/01 0:14:11 ET
Table 'm95HVfesC/VPgfGEjPuaIA' 2-max Seat #2 is the button
Seat 1: Fp/oksNpipCrD2MJ2pH20g ($19.80 in chips)
Seat 2: Ag6DvxX4vbRheqsv2zXKTQ ($14.25 in chips)
Ag6DvxX4vbRheqsv2zXKTQ: posts small blind $0.25
Fp/oksNpipCrD2MJ2pH20g: posts big blind $0.50
*** HOLE CARDS ***
Ag6DvxX4vbRheqsv2zXKTQ: folds
Fp/oksNpipCrD2MJ2pH20g collected $0.50 from pot
Fp/oksNpipCrD2MJ2pH20g: doesn't show hand
*** SUMMARY ***
Total pot $0.50 | Rake $0
Seat 1: Fp/oksNpipCrD2MJ2pH20g (big blind) collected ($0.50)
Seat 2: Ag6DvxX4vbRheqsv2zXKTQ (button) (small blind) folded before Flop



PokerStars Game #59938404862:  Hold'em No Limit ($0.25/$0.50) - 2009/07/01 0:14:11 ET
Table '3FhG0gl3kMX3wBEEqj+wnQ' 9-max Seat #9 is the button
Seat 1: e0J9pdCNUDTCG031RnXqLA ($24.95 in chips)
Seat 2: 4dl3YNqZ6Houm2jZAzDmRg ($25.25 in chips)
Seat 3: bXpVeaSTPBFSPJmeXxO7nw ($10 in chips)
Seat 4: bz4LMfV0GGl/MJ/ABXuPmg ($27.20 in chips)
Seat 5: XNMDwbXt/Q4jM99AXnbJDw ($50 in chips)
Seat 6: 5JJVDlaiMnB004o/RqbZZQ ($26 in chips)
Seat 8: j3K/Jujr7PY4ZM2RZvlH6A ($44.45 in chips)
Seat 9: tzoXBDwkkPV/XPJPkf963Q ($13.05 in chips)
e0J9pdCNUDTCG031RnXqLA: posts small blind $0.25
4dl3YNqZ6Houm2jZAzDmRg: posts big blind $0.50
mSD1pginDsyHG5PDfqzphw: sits out
*** HOLE CARDS ***
bXpVeaSTPBFSPJmeXxO7nw: folds
bz4LMfV0GGl/MJ/ABXuPmg: folds
XNMDwbXt/Q4jM99AXnbJDw: folds
5JJVDlaiMnB004o/RqbZZQ: folds
j3K/Jujr7PY4ZM2RZvlH6A: raises $2 to $2.50
tzoXBDwkkPV/XPJPkf963Q: folds
e0J9pdCNUDTCG031RnXqLA: folds
4dl3YNqZ6Houm2jZAzDmRg: folds
j3K/Jujr7PY4ZM2RZvlH6A collected $1.25 from pot
j3K/Jujr7PY4ZM2RZvlH6A: doesn't show hand
*** SUMMARY ***
Total pot $1.25 | Rake $0
Seat 1: e0J9pdCNUDTCG031RnXqLA (small blind) folded before Flop
Seat 2: 4dl3YNqZ6Houm2jZAzDmRg (big blind) folded before Flop
Seat 3: bXpVeaSTPBFSPJmeXxO7nw folded before Flop (didn't bet)
Seat 4: bz4LMfV0GGl/MJ/ABXuPmg folded before Flop (didn't bet)
Seat 5: XNMDwbXt/Q4jM99AXnbJDw folded before Flop (didn't bet)
Seat 6: 5JJVDlaiMnB004o/RqbZZQ folded before Flop (didn't bet)
Seat 8: j3K/Jujr7PY4ZM2RZvlH6A collected ($1.25)
Seat 9: tzoXBDwkkPV/XPJPkf963Q (button) folded before Flop (didn't bet)



PokerStars Game #59938404610:  Hold'em No Limit ($0.25/$0.50) - 2009/07/01 0:14:11 ET
Table 'PALRfuH85dr5IkDfdv6new' 9-max Seat #8 is the button
Seat 1: SKnJuWHScqetA/qG5p+wCg ($33 in chips)
Seat 2: 9r7ZoBbAJj5IeyZ0q9BdzA ($13.90 in chips)
Seat 3: 50QWoELmpmHFrFIlWMJo9g ($94.20 in chips)
Seat 4: /gaxz7F0MIjSN3t7ZPKwAA ($37.10 in chips)
Seat 5: jSSGUXdNFAZA3QCvTcUMQw ($43 in chips)
Seat 6: EiWj2MAl8RNcPhTkzz24Mw ($26.90 in chips)
Seat 7: 3NcyXvr39gnK+KbTq7ezyA ($35.25 in chips)
Seat 8: NkS+CseUKx4XHszWq0PXEQ ($42.35 in chips)
Seat 9: CIrAX/m6o7jYmKOAjJXv4Q ($38.60 in chips)
CIrAX/m6o7jYmKOAjJXv4Q: posts small blind $0.25
SKnJuWHScqetA/qG5p+wCg: posts big blind $0.50
*** HOLE CARDS ***
9r7ZoBbAJj5IeyZ0q9BdzA: folds
50QWoELmpmHFrFIlWMJo9g: folds
/gaxz7F0MIjSN3t7ZPKwAA: calls $0.50
jSSGUXdNFAZA3QCvTcUMQw: folds
EiWj2MAl8RNcPhTkzz24Mw: raises $1.50 to $2
3NcyXvr39gnK+KbTq7ezyA: folds
NkS+CseUKx4XHszWq0PXEQ: folds
CIrAX/m6o7jYmKOAjJXv4Q: folds
SKnJuWHScqetA/qG5p+wCg: folds
/gaxz7F0MIjSN3t7ZPKwAA: calls $1.50
*** FLOP *** [2c 8d 2h]
/gaxz7F0MIjSN3t7ZPKwAA: bets $2.50
EiWj2MAl8RNcPhTkzz24Mw: raises $3.50 to $6
/gaxz7F0MIjSN3t7ZPKwAA: calls $3.50
*** TURN *** [2c 8d 2h] [4h]
/gaxz7F0MIjSN3t7ZPKwAA: checks
EiWj2MAl8RNcPhTkzz24Mw: bets $18.90 and is all-in
/gaxz7F0MIjSN3t7ZPKwAA: folds
EiWj2MAl8RNcPhTkzz24Mw collected $15.95 from pot
EiWj2MAl8RNcPhTkzz24Mw: doesn't show hand
*** SUMMARY ***
Total pot $16.75 | Rake $0.80
Board [2c 8d 2h 4h]
Seat 1: SKnJuWHScqetA/qG5p+wCg (big blind) folded before Flop
Seat 2: 9r7ZoBbAJj5IeyZ0q9BdzA folded before Flop (didn't bet)
Seat 3: 50QWoELmpmHFrFIlWMJo9g folded before Flop (didn't bet)
Seat 4: /gaxz7F0MIjSN3t7ZPKwAA folded on the Turn
Seat 5: jSSGUXdNFAZA3QCvTcUMQw folded before Flop (didn't bet)
Seat 6: EiWj2MAl8RNcPhTkzz24Mw collected ($15.95)
Seat 7: 3NcyXvr39gnK+KbTq7ezyA folded before Flop (didn't bet)
Seat 8: NkS+CseUKx4XHszWq0PXEQ (button) folded before Flop (didn't bet)
Seat 9: CIrAX/m6o7jYmKOAjJXv4Q (small blind) folded before Flop



PokerStars Game #59938405522:  Hold'em No Limit ($0.25/$0.50) - 2009/07/01 0:14:12 ET
Table 'eMxdLyFDf28E0wit6gm3Uw' 6-max Seat #3 is the button
Seat 1: tnD/64LagZ9qPaeOQVjVZg ($11.95 in chips)
Seat 2: jwuKQ1S3U4NnzMQn3E3dgw ($66.20 in chips)
Seat 3: dZcLsEI8iXkobBduRJ45Yw ($17 in chips)
Seat 5: X0X97o2fDAPiGx6o1gahsw ($57.55 in chips)
Seat 6: L0aIPg7qefDQjdJo3HCVEA ($10 in chips)
X0X97o2fDAPiGx6o1gahsw: posts small blind $0.25
L0aIPg7qefDQjdJo3HCVEA: posts big blind $0.50
*** HOLE CARDS ***
tnD/64LagZ9qPaeOQVjVZg: folds
jwuKQ1S3U4NnzMQn3E3dgw: raises $1.50 to $2
dZcLsEI8iXkobBduRJ45Yw: folds
X0X97o2fDAPiGx6o1gahsw: calls $1.75
L0aIPg7qefDQjdJo3HCVEA: folds
*** FLOP *** [9d Qh 5s]
X0X97o2fDAPiGx6o1gahsw: checks
jwuKQ1S3U4NnzMQn3E3dgw: bets $6
X0X97o2fDAPiGx6o1gahsw: folds
jwuKQ1S3U4NnzMQn3E3dgw collected $4.30 from pot
*** SUMMARY ***
Total pot $4.50 | Rake $0.20
Board [9d Qh 5s]
Seat 1: tnD/64LagZ9qPaeOQVjVZg folded before Flop (didn't bet)
Seat 2: jwuKQ1S3U4NnzMQn3E3dgw collected ($4.30)
Seat 3: dZcLsEI8iXkobBduRJ45Yw (button) folded before Flop (didn't bet)
Seat 5: X0X97o2fDAPiGx6o1gahsw (small blind) folded on the Flop
Seat 6: L0aIPg7qefDQjdJo3HCVEA (big blind) folded before Flop



PokerStars Game #59938409202:  Hold'em No Limit ($0.25/$0.50) - 2009/07/01 0:14:17 ET
Table 'BCN5su+SsXiy1zRMJi0SJw' 6-max Seat #3 is the button
Seat 1: WyeokAqR0q9nADSkWpbxHw ($36.85 in chips)
Seat 2: QfV2JJlmEKgD5jYPV+a33A ($177.40 in chips)
Seat 3: L309C3uyA1tkWSOh/QvjHw ($20.85 in chips)
Seat 5: TTx3CHxyi0SObcHyMJRp5w ($32.75 in chips)
TTx3CHxyi0SObcHyMJRp5w: posts small blind $0.25
WyeokAqR0q9nADSkWpbxHw: posts big blind $0.50
*** HOLE CARDS ***
QfV2JJlmEKgD5jYPV+a33A: raises $1 to $1.50
L309C3uyA1tkWSOh/QvjHw: folds
TTx3CHxyi0SObcHyMJRp5w: folds
WyeokAqR0q9nADSkWpbxHw: calls $1
*** FLOP *** [9s 2c Js]
WyeokAqR0q9nADSkWpbxHw: checks
QfV2JJlmEKgD5jYPV+a33A: bets $3
WyeokAqR0q9nADSkWpbxHw: folds
QfV2JJlmEKgD5jYPV+a33A collected $3.10 from pot
QfV2JJlmEKgD5jYPV+a33A: doesn't show hand
*** SUMMARY ***
Total pot $3.25 | Rake $0.15
Board [9s 2c Js]
Seat 1: WyeokAqR0q9nADSkWpbxHw (big blind) folded on the Flop
Seat 2: QfV2JJlmEKgD5jYPV+a33A collected ($3.10)
Seat 3: L309C3uyA1tkWSOh/QvjHw (button) folded before Flop (didn't bet)
Seat 5: TTx3CHxyi0SObcHyMJRp5w (small blind) folded before Flop



PokerStars Game #59938410068:  Hold'em No Limit ($0.25/$0.50) - 2009/07/01 0:14:19 ET
Table 'ZYwMb9E6tY50Qm+iNbXRYw' 2-max Seat #2 is the button
Seat 1: DXLfRb8KDZWmrztw2bwtFw ($23.45 in chips)
Seat 2: 16tvT7AYgZ2LgiGFcvFKQg ($13.80 in chips)
16tvT7AYgZ2LgiGFcvFKQg: posts small blind $0.25
DXLfRb8KDZWmrztw2bwtFw: posts big blind $0.50
*** HOLE CARDS ***
16tvT7AYgZ2LgiGFcvFKQg: calls $0.25
DXLfRb8KDZWmrztw2bwtFw: checks
*** FLOP *** [Td Kd 8d]
DXLfRb8KDZWmrztw2bwtFw: checks
16tvT7AYgZ2LgiGFcvFKQg: checks
*** TURN *** [Td Kd 8d] [9c]
DXLfRb8KDZWmrztw2bwtFw: checks
16tvT7AYgZ2LgiGFcvFKQg: bets $0.50
DXLfRb8KDZWmrztw2bwtFw: calls $0.50
*** RIVER *** [Td Kd 8d 9c] [8h]
DXLfRb8KDZWmrztw2bwtFw: checks
16tvT7AYgZ2LgiGFcvFKQg: checks
*** SHOW DOWN ***
DXLfRb8KDZWmrztw2bwtFw: shows [Qs 9d] (two pair, Nines and Eights)
16tvT7AYgZ2LgiGFcvFKQg: shows [Tc 4h] (two pair, Tens and Eights)
16tvT7AYgZ2LgiGFcvFKQg collected $1.95 from pot
*** SUMMARY ***
Total pot $2 | Rake $0.05
Board [Td Kd 8d 9c 8h]
Seat 1: DXLfRb8KDZWmrztw2bwtFw (big blind) showed [Qs 9d] and lost with two pair, Nines and Eights
Seat 2: 16tvT7AYgZ2LgiGFcvFKQg (button) (small blind) showed [Tc 4h] and won ($1.95) with two pair, Tens and Eights



PokerStars Game #59938410488:  Hold'em No Limit ($0.25/$0.50) - 2009/07/01 0:14:19 ET
Table 'raOT4/ipuZgzjfKHC+jD9g' 2-max Seat #2 is the button
Seat 1: IuwLemwLhc9fvrwBGs0AMA ($13.35 in chips)
Seat 2: Udr5juWSWUgTu1NlRhjMdA ($9.50 in chips)
Udr5juWSWUgTu1NlRhjMdA: posts small blind $0.25
IuwLemwLhc9fvrwBGs0AMA: posts big blind $0.50
*** HOLE CARDS ***
Udr5juWSWUgTu1NlRhjMdA: folds
IuwLemwLhc9fvrwBGs0AMA collected $0.50 from pot
*** SUMMARY ***
Total pot $0.50 | Rake $0
Seat 1: IuwLemwLhc9fvrwBGs0AMA (big blind) collected ($0.50)
Seat 2: Udr5juWSWUgTu1NlRhjMdA (button) (small blind) folded before Flop



PokerStars Game #59938411084:  Hold'em No Limit ($0.25/$0.50) - 2009/07/01 0:14:20 ET
Table 'm95HVfesC/VPgfGEjPuaIA' 2-max Seat #1 is the button
Seat 1: Fp/oksNpipCrD2MJ2pH20g ($20.05 in chips)
Seat 2: Ag6DvxX4vbRheqsv2zXKTQ ($14 in chips)
Fp/oksNpipCrD2MJ2pH20g: posts small blind $0.25
Ag6DvxX4vbRheqsv2zXKTQ: posts big blind $0.50
*** HOLE CARDS ***
Fp/oksNpipCrD2MJ2pH20g: folds
Ag6DvxX4vbRheqsv2zXKTQ collected $0.50 from pot
*** SUMMARY ***
Total pot $0.50 | Rake $0
Seat 1: Fp/oksNpipCrD2MJ2pH20g (button) (small blind) folded before Flop
Seat 2: Ag6DvxX4vbRheqsv2zXKTQ (big blind) collected ($0.50)



PokerStars Game #59938412562:  Hold'em No Limit ($0.25/$0.50) - 2009/07/01 0:14:22 ET
Table 'lSisgp6H7Fg1hH5VfjEjYQ' 9-max Seat #1 is the button
Seat 1: pEW8B6uXbdR47kfljMQ3+Q ($38.95 in chips)
Seat 2: UrcnkQOiLVk8BlKDPJSy7Q ($51.35 in chips)
Seat 3: aTkyjTh3w5YLWiIERupZOA ($38.50 in chips)
Seat 4: nvw9yQKhJT56lA9k+TLdhw ($11.70 in chips)
Seat 5: mSD1pginDsyHG5PDfqzphw ($10 in chips)
Seat 6: +k7T5ocke8UwavtgUHm+Cg ($22.15 in chips)
Seat 7: dGw5MBstXyXhWHHVFOWOFA ($43 in chips)
Seat 8: a4JDWmpFQkL10XfAyuF51A ($29.50 in chips)
Seat 9: 5JJVDlaiMnB004o/RqbZZQ ($40.80 in chips)
UrcnkQOiLVk8BlKDPJSy7Q: posts small blind $0.25
aTkyjTh3w5YLWiIERupZOA: posts big blind $0.50
*** HOLE CARDS ***
nvw9yQKhJT56lA9k+TLdhw: folds
mSD1pginDsyHG5PDfqzphw: folds
+k7T5ocke8UwavtgUHm+Cg: folds
dGw5MBstXyXhWHHVFOWOFA: raises $1.50 to $2
a4JDWmpFQkL10XfAyuF51A: folds
5JJVDlaiMnB004o/RqbZZQ: folds
pEW8B6uXbdR47kfljMQ3+Q: folds
UrcnkQOiLVk8BlKDPJSy7Q: folds
aTkyjTh3w5YLWiIERupZOA: folds
dGw5MBstXyXhWHHVFOWOFA collected $1.25 from pot
dGw5MBstXyXhWHHVFOWOFA: doesn't show hand
*** SUMMARY ***
Total pot $1.25 | Rake $0
Seat 1: pEW8B6uXbdR47kfljMQ3+Q (button) folded before Flop (didn't bet)
Seat 2: UrcnkQOiLVk8BlKDPJSy7Q (small blind) folded before Flop
Seat 3: aTkyjTh3w5YLWiIERupZOA (big blind) folded before Flop
Seat 4: nvw9yQKhJT56lA9k+TLdhw folded before Flop (didn't bet)
Seat 5: mSD1pginDsyHG5PDfqzphw folded before Flop (didn't bet)
Seat 6: +k7T5ocke8UwavtgUHm+Cg folded before Flop (didn't bet)
Seat 7: dGw5MBstXyXhWHHVFOWOFA collected ($1.25)
Seat 8: a4JDWmpFQkL10XfAyuF51A folded before Flop (didn't bet)
Seat 9: 5JJVDlaiMnB004o/RqbZZQ folded before Flop (didn't bet)



PokerStars Game #59938413358:  Hold'em No Limit ($0.25/$0.50) - 2009/07/01 0:14:23 ET
Table '5EmHi+fnatGQQShcNmzOZQ' 6-max Seat #5 is the button
Seat 1: SwPczQo3cOtwEzhJrfO2cQ ($28.45 in chips)
Seat 2: APwvTk5XojDXGoQLb4O5iA ($29 in chips)
Seat 3: J8dF2sYMvXUmAGUuSW9kwg ($17.95 in chips)
Seat 5: kxPhs4ePFqMy52CInAJ2aw ($68.55 in chips)
Seat 6: 686aeHikcJlgKkSuIFdcXQ ($114.70 in chips)
686aeHikcJlgKkSuIFdcXQ: posts small blind $0.25
SwPczQo3cOtwEzhJrfO2cQ: posts big blind $0.50
wOyVV9M/oyiw3YaOjNZ05w: sits out
*** HOLE CARDS ***
APwvTk5XojDXGoQLb4O5iA: folds
J8dF2sYMvXUmAGUuSW9kwg: calls $0.50
kxPhs4ePFqMy52CInAJ2aw: folds
686aeHikcJlgKkSuIFdcXQ: calls $0.25
SwPczQo3cOtwEzhJrfO2cQ: checks
*** FLOP *** [4c 6s 4s]
686aeHikcJlgKkSuIFdcXQ: checks
SwPczQo3cOtwEzhJrfO2cQ: checks
J8dF2sYMvXUmAGUuSW9kwg: checks
*** TURN *** [4c 6s 4s] [4d]
686aeHikcJlgKkSuIFdcXQ: bets $1.50
SwPczQo3cOtwEzhJrfO2cQ: folds
J8dF2sYMvXUmAGUuSW9kwg: calls $1.50
*** RIVER *** [4c 6s 4s 4d] [Ac]
686aeHikcJlgKkSuIFdcXQ: bets $112.70 and is all-in
J8dF2sYMvXUmAGUuSW9kwg: calls $15.95 and is all-in
*** SHOW DOWN ***
686aeHikcJlgKkSuIFdcXQ: shows [6h 6c] (a full house, Sixes full of Fours)
J8dF2sYMvXUmAGUuSW9kwg: mucks hand
686aeHikcJlgKkSuIFdcXQ collected $34.60 from pot
*** SUMMARY ***
Total pot $36.40 | Rake $1.80
Board [4c 6s 4s 4d Ac]
Seat 1: SwPczQo3cOtwEzhJrfO2cQ (big blind) folded on the Turn
Seat 2: APwvTk5XojDXGoQLb4O5iA folded before Flop (didn't bet)
Seat 3: J8dF2sYMvXUmAGUuSW9kwg mucked
Seat 5: kxPhs4ePFqMy52CInAJ2aw (button) folded before Flop (didn't bet)
Seat 6: 686aeHikcJlgKkSuIFdcXQ (small blind) showed [6h 6c] and won ($34.60) with a full house, Sixes full of Fours



PokerStars Game #59938413440:  Hold'em No Limit ($0.25/$0.50) - 2009/07/01 0:14:23 ET
Table 'kgbJRsxfv64KrErDRBAkcw' 6-max Seat #6 is the button
Seat 2: Q+thC23WCv1kJUJtH/+4Jw ($30.70 in chips)
Seat 3: T0Gx/FcQ5VH9u7XaOMX97A ($61.75 in chips)
Seat 4: qanMEqjABjWxC/JgQ/0l7w ($62.70 in chips)
Seat 5: +Pf9jTVizYlIo+woPvptfA ($50 in chips)
Seat 6: DDfYzIrYT0t5R/hAJngtsg ($23.95 in chips)
Q+thC23WCv1kJUJtH/+4Jw: posts small blind $0.25
T0Gx/FcQ5VH9u7XaOMX97A: posts big blind $0.50
*** HOLE CARDS ***
qanMEqjABjWxC/JgQ/0l7w: folds
+Pf9jTVizYlIo+woPvptfA: folds
DDfYzIrYT0t5R/hAJngtsg: raises $1.50 to $2
Q+thC23WCv1kJUJtH/+4Jw: folds
T0Gx/FcQ5VH9u7XaOMX97A: folds
DDfYzIrYT0t5R/hAJngtsg collected $1.25 from pot
*** SUMMARY ***
Total pot $1.25 | Rake $0
Seat 2: Q+thC23WCv1kJUJtH/+4Jw (small blind) folded before Flop
Seat 3: T0Gx/FcQ5VH9u7XaOMX97A (big blind) folded before Flop
Seat 4: qanMEqjABjWxC/JgQ/0l7w folded before Flop (didn't bet)
Seat 5: +Pf9jTVizYlIo+woPvptfA folded before Flop (didn't bet)
Seat 6: DDfYzIrYT0t5R/hAJngtsg (button) collected ($1.25)



PokerStars Game #59938415262:  Hold'em No Limit ($0.25/$0.50) - 2009/07/01 0:14:26 ET
Table 'm95HVfesC/VPgfGEjPuaIA' 2-max Seat #2 is the button
Seat 1: Fp/oksNpipCrD2MJ2pH20g ($19.80 in chips)
Seat 2: Ag6DvxX4vbRheqsv2zXKTQ ($14.25 in chips)
Ag6DvxX4vbRheqsv2zXKTQ: posts small blind $0.25
Fp/oksNpipCrD2MJ2pH20g: posts big blind $0.50
*** HOLE CARDS ***
Ag6DvxX4vbRheqsv2zXKTQ: folds
Fp/oksNpipCrD2MJ2pH20g collected $0.50 from pot
Fp/oksNpipCrD2MJ2pH20g: doesn't show hand
*** SUMMARY ***
Total pot $0.50 | Rake $0
Seat 1: Fp/oksNpipCrD2MJ2pH20g (big blind) collected ($0.50)
Seat 2: Ag6DvxX4vbRheqsv2zXKTQ (button) (small blind) folded before Flop



PokerStars Game #59938415414:  Hold'em No Limit ($0.25/$0.50) - 2009/07/01 0:14:26 ET
Table 'raOT4/ipuZgzjfKHC+jD9g' 2-max Seat #1 is the button
Seat 1: IuwLemwLhc9fvrwBGs0AMA ($13.60 in chips)
Seat 2: Udr5juWSWUgTu1NlRhjMdA ($9.25 in chips)
IuwLemwLhc9fvrwBGs0AMA: posts small blind $0.25
Udr5juWSWUgTu1NlRhjMdA: posts big blind $0.50
*** HOLE CARDS ***
IuwLemwLhc9fvrwBGs0AMA: folds
Udr5juWSWUgTu1NlRhjMdA collected $0.50 from pot
Udr5juWSWUgTu1NlRhjMdA: doesn't show hand
*** SUMMARY ***
Total pot $0.50 | Rake $0
Seat 1: IuwLemwLhc9fvrwBGs0AMA (button) (small blind) folded before Flop
Seat 2: Udr5juWSWUgTu1NlRhjMdA (big blind) collected ($0.50)



PokerStars Game #59938415308:  Hold'em No Limit ($0.25/$0.50) - 2009/07/01 0:14:26 ET
Table 'NCiXr0d5CEKBQr/cZgLhbA' 9-max Seat #9 is the button
Seat 1: RjBdQ6w31rgcy0o24VLR6w ($8 in chips)
Seat 2: ulxuJchBV9iguXg0FUonfg ($33.30 in chips)
Seat 3: xZCXQSXlrZkp3pZizzVXCw ($55.65 in chips)
Seat 4: CL4d+tvzcd4utdQxlPLOmg ($29.15 in chips)
Seat 5: zE9cVigS2nW/Ljy4K4bUQA ($30 in chips)
Seat 6: SKnJuWHScqetA/qG5p+wCg ($31.05 in chips)
Seat 8: 1MJUKc3cc0QmUoz1JZLR2w ($70.40 in chips)
Seat 9: WpvT3OUSiZlpvs+mPXFqtQ ($8.20 in chips)
RjBdQ6w31rgcy0o24VLR6w: posts small blind $0.25
ulxuJchBV9iguXg0FUonfg: posts big blind $0.50
M+7+BTmX5vZatHVuoRB1nA: sits out
*** HOLE CARDS ***
xZCXQSXlrZkp3pZizzVXCw: folds
CL4d+tvzcd4utdQxlPLOmg: folds
zE9cVigS2nW/Ljy4K4bUQA: folds
SKnJuWHScqetA/qG5p+wCg: folds
1MJUKc3cc0QmUoz1JZLR2w: raises $2 to $2.50
WpvT3OUSiZlpvs+mPXFqtQ: folds
RjBdQ6w31rgcy0o24VLR6w: folds
ulxuJchBV9iguXg0FUonfg: calls $2
*** FLOP *** [Qh 9c 7c]
ulxuJchBV9iguXg0FUonfg: checks
1MJUKc3cc0QmUoz1JZLR2w: bets $5
ulxuJchBV9iguXg0FUonfg: calls $5
*** TURN *** [Qh 9c 7c] [6d]
ulxuJchBV9iguXg0FUonfg: checks
1MJUKc3cc0QmUoz1JZLR2w: checks
*** RIVER *** [Qh 9c 7c 6d] [8c]
ulxuJchBV9iguXg0FUonfg: bets $7.50
1MJUKc3cc0QmUoz1JZLR2w said, "nh"
1MJUKc3cc0QmUoz1JZLR2w: folds
ulxuJchBV9iguXg0FUonfg collected $14.50 from pot
*** SUMMARY ***
Total pot $15.25 | Rake $0.75
Board [Qh 9c 7c 6d 8c]
Seat 1: RjBdQ6w31rgcy0o24VLR6w (small blind) folded before Flop
Seat 2: ulxuJchBV9iguXg0FUonfg (big blind) collected ($14.50)
Seat 3: xZCXQSXlrZkp3pZizzVXCw folded before Flop (didn't bet)
Seat 4: CL4d+tvzcd4utdQxlPLOmg folded before Flop (didn't bet)
Seat 5: zE9cVigS2nW/Ljy4K4bUQA folded before Flop (didn't bet)
Seat 6: SKnJuWHScqetA/qG5p+wCg folded before Flop (didn't bet)
Seat 8: 1MJUKc3cc0QmUoz1JZLR2w folded on the River
Seat 9: WpvT3OUSiZlpvs+mPXFqtQ (button) folded before Flop (didn't bet)



PokerStars Game #59938416184:  Hold'em No Limit ($0.25/$0.50) - 2009/07/01 0:14:27 ET
Table 'mTxf8gPLgffN3Iwfm7Icfg' 2-max Seat #1 is the button
Seat 1: Do9Rlu1R5u/AcRtMTl8SYg ($56.95 in chips)
Seat 2: EMc5LPgVaded4Qc77vm0fw ($55.95 in chips)
Do9Rlu1R5u/AcRtMTl8SYg: posts small blind $0.25
EMc5LPgVaded4Qc77vm0fw: posts big blind $0.50
*** HOLE CARDS ***
Do9Rlu1R5u/AcRtMTl8SYg: calls $0.25
EMc5LPgVaded4Qc77vm0fw: checks
*** FLOP *** [7s 5c Ks]
EMc5LPgVaded4Qc77vm0fw: checks
Do9Rlu1R5u/AcRtMTl8SYg: checks
*** TURN *** [7s 5c Ks] [8h]
EMc5LPgVaded4Qc77vm0fw: checks
Do9Rlu1R5u/AcRtMTl8SYg: checks
*** RIVER *** [7s 5c Ks 8h] [3h]
EMc5LPgVaded4Qc77vm0fw: bets $1
Do9Rlu1R5u/AcRtMTl8SYg: folds
EMc5LPgVaded4Qc77vm0fw collected $0.95 from pot
EMc5LPgVaded4Qc77vm0fw: doesn't show hand
*** SUMMARY ***
Total pot $1 | Rake $0.05
Board [7s 5c Ks 8h 3h]
Seat 1: Do9Rlu1R5u/AcRtMTl8SYg (button) (small blind) folded on the River
Seat 2: EMc5LPgVaded4Qc77vm0fw (big blind) collected ($0.95)



PokerStars Game #59938415900:  Hold'em No Limit ($0.25/$0.50) - 2009/07/01 0:14:27 ET
Table '+dXkOAQyS8j9PQZusUTMpg' 2-max Seat #1 is the button
Seat 1: XFa6sBGjP2gxoIvxR3fZIg ($91.45 in chips)
Seat 2: 5IBeOgaApY1Bvzv2P8X4EA ($20.05 in chips)
XFa6sBGjP2gxoIvxR3fZIg: posts small blind $0.25
5IBeOgaApY1Bvzv2P8X4EA: posts big blind $0.50
*** HOLE CARDS ***
XFa6sBGjP2gxoIvxR3fZIg: folds
5IBeOgaApY1Bvzv2P8X4EA collected $0.50 from pot
5IBeOgaApY1Bvzv2P8X4EA: doesn't show hand
*** SUMMARY ***
Total pot $0.50 | Rake $0
Seat 1: XFa6sBGjP2gxoIvxR3fZIg (button) (small blind) folded before Flop
Seat 2: 5IBeOgaApY1Bvzv2P8X4EA (big blind) collected ($0.50)



PokerStars Game #59938416032:  Hold'em No Limit ($0.25/$0.50) - 2009/07/01 0:14:27 ET
Table '+z1aekfHkpp09pc8F9aViw' 6-max Seat #4 is the button
Seat 2: VuB2GN0h94yY+QbuI2Mybg ($21.65 in chips)
Seat 3: uUznlIMFnRUvwrBhYF73KA ($49.45 in chips)
Seat 4: OCrv7ObFH4/s2lv7rYOnsQ ($24.35 in chips)
Seat 5: crjGpJEzSZgD38FoE3VMGg ($64.65 in chips)
Seat 6: 686aeHikcJlgKkSuIFdcXQ ($71.25 in chips)
crjGpJEzSZgD38FoE3VMGg: posts small blind $0.25
686aeHikcJlgKkSuIFdcXQ: posts big blind $0.50
*** HOLE CARDS ***
VuB2GN0h94yY+QbuI2Mybg: folds
uUznlIMFnRUvwrBhYF73KA: calls $0.50
OCrv7ObFH4/s2lv7rYOnsQ: calls $0.50
crjGpJEzSZgD38FoE3VMGg: folds
686aeHikcJlgKkSuIFdcXQ: checks
*** FLOP *** [Kh Th Qh]
686aeHikcJlgKkSuIFdcXQ: checks
uUznlIMFnRUvwrBhYF73KA: bets $2
OCrv7ObFH4/s2lv7rYOnsQ: calls $2
686aeHikcJlgKkSuIFdcXQ: folds
*** TURN *** [Kh Th Qh] [9d]
uUznlIMFnRUvwrBhYF73KA: checks
OCrv7ObFH4/s2lv7rYOnsQ: bets $3
uUznlIMFnRUvwrBhYF73KA: raises $3 to $6
OCrv7ObFH4/s2lv7rYOnsQ: calls $3
*** RIVER *** [Kh Th Qh 9d] [8s]
uUznlIMFnRUvwrBhYF73KA: checks
OCrv7ObFH4/s2lv7rYOnsQ: checks
*** SHOW DOWN ***
uUznlIMFnRUvwrBhYF73KA: shows [Jd 8c] (a straight, Nine to King)
OCrv7ObFH4/s2lv7rYOnsQ: mucks hand
uUznlIMFnRUvwrBhYF73KA collected $16.90 from pot
*** SUMMARY ***
Total pot $17.75 | Rake $0.85
Board [Kh Th Qh 9d 8s]
Seat 2: VuB2GN0h94yY+QbuI2Mybg folded before Flop (didn't bet)
Seat 3: uUznlIMFnRUvwrBhYF73KA showed [Jd 8c] and won ($16.90) with a straight, Nine to King
Seat 4: OCrv7ObFH4/s2lv7rYOnsQ (button) mucked
Seat 5: crjGpJEzSZgD38FoE3VMGg (small blind) folded before Flop
Seat 6: 686aeHikcJlgKkSuIFdcXQ (big blind) folded on the Flop



PokerStars Game #59938416780:  Hold'em No Limit ($0.25/$0.50) - 2009/07/01 0:14:28 ET
Table 'X6IRCRTh+20gjz8aubWnwA' 9-max Seat #8 is the button
Seat 1: DSM67hHHq1XFoEOi9p8Alw ($50 in chips)
Seat 2: RjBdQ6w31rgcy0o24VLR6w ($11.65 in chips)
Seat 3: mSD1pginDsyHG5PDfqzphw ($10 in chips)
Seat 4: uw9QayAAxLM3Hb+HR7mSkg ($10.25 in chips)
Seat 5: L5e2lrPLQm1Pqx30IIZ/Fw ($12.85 in chips)
Seat 6: /6In1zC3WtgwxDcueWzZWg ($58.10 in chips)
Seat 7: VBnpbzn0dIveV55qKvciew ($55.95 in chips)
Seat 8: BPMN9sOItJw6vWq3kypaYg ($27.50 in chips)
Seat 9: M+7+BTmX5vZatHVuoRB1nA ($83.10 in chips)
M+7+BTmX5vZatHVuoRB1nA: posts small blind $0.25
DSM67hHHq1XFoEOi9p8Alw: posts big blind $0.50
*** HOLE CARDS ***
RjBdQ6w31rgcy0o24VLR6w: folds
mSD1pginDsyHG5PDfqzphw: folds
uw9QayAAxLM3Hb+HR7mSkg: folds
L5e2lrPLQm1Pqx30IIZ/Fw: folds
/6In1zC3WtgwxDcueWzZWg: folds
VBnpbzn0dIveV55qKvciew: folds
BPMN9sOItJw6vWq3kypaYg: calls $0.50
M+7+BTmX5vZatHVuoRB1nA: calls $0.25
DSM67hHHq1XFoEOi9p8Alw: checks
*** FLOP *** [Kh As 4c]
M+7+BTmX5vZatHVuoRB1nA: checks
DSM67hHHq1XFoEOi9p8Alw: checks
BPMN9sOItJw6vWq3kypaYg: checks
*** TURN *** [Kh As 4c] [Kc]
M+7+BTmX5vZatHVuoRB1nA: checks
DSM67hHHq1XFoEOi9p8Alw: checks
BPMN9sOItJw6vWq3kypaYg: checks
*** RIVER *** [Kh As 4c Kc] [Ad]
M+7+BTmX5vZatHVuoRB1nA: checks
DSM67hHHq1XFoEOi9p8Alw: bets $0.50
BPMN9sOItJw6vWq3kypaYg: calls $0.50
M+7+BTmX5vZatHVuoRB1nA: folds
*** SHOW DOWN ***
DSM67hHHq1XFoEOi9p8Alw: shows [2h Ks] (a full house, Kings full of Aces)
BPMN9sOItJw6vWq3kypaYg: mucks hand
DSM67hHHq1XFoEOi9p8Alw collected $2.40 from pot
*** SUMMARY ***
Total pot $2.50 | Rake $0.10
Board [Kh As 4c Kc Ad]
Seat 1: DSM67hHHq1XFoEOi9p8Alw (big blind) showed [2h Ks] and won ($2.40) with a full house, Kings full of Aces
Seat 2: RjBdQ6w31rgcy0o24VLR6w folded before Flop (didn't bet)
Seat 3: mSD1pginDsyHG5PDfqzphw folded before Flop (didn't bet)
Seat 4: uw9QayAAxLM3Hb+HR7mSkg folded before Flop (didn't bet)
Seat 5: L5e2lrPLQm1Pqx30IIZ/Fw folded before Flop (didn't bet)
Seat 6: /6In1zC3WtgwxDcueWzZWg folded before Flop (didn't bet)
Seat 7: VBnpbzn0dIveV55qKvciew folded before Flop (didn't bet)
Seat 8: BPMN9sOItJw6vWq3kypaYg (button) mucked
Seat 9: M+7+BTmX5vZatHVuoRB1nA (small blind) folded on the River



PokerStars Game #59938416818:  Hold'em No Limit ($0.25/$0.50) - 2009/07/01 0:14:28 ET
Table 'tyR5AZNKV8Aadbrnrnlg7g' 6-max Seat #6 is the button
Seat 1: R+KjpH/wSjDLhtIy9+edNA ($52.60 in chips)
Seat 2: 58zdeSBSuSFX/qZfhc7YmA ($31.10 in chips)
Seat 3: jUhx+m+V7qfbLZTjgwZByg ($46.60 in chips)
Seat 4: Rt6KgtZ8YaJoTc3FPim00w ($50.50 in chips)
Seat 5: EIg3r3fRFKG2HhgpDlIJHg ($20.10 in chips)
Seat 6: DMQLAmut/l19xN5STQndFg ($10.55 in chips)
R+KjpH/wSjDLhtIy9+edNA: posts small blind $0.25
58zdeSBSuSFX/qZfhc7YmA: posts big blind $0.50
*** HOLE CARDS ***
jUhx+m+V7qfbLZTjgwZByg: folds
Rt6KgtZ8YaJoTc3FPim00w: folds
EIg3r3fRFKG2HhgpDlIJHg: calls $0.50
DMQLAmut/l19xN5STQndFg: raises $1.50 to $2
R+KjpH/wSjDLhtIy9+edNA: folds
58zdeSBSuSFX/qZfhc7YmA: folds
EIg3r3fRFKG2HhgpDlIJHg: calls $1.50
*** FLOP *** [8d 3c 5d]
EIg3r3fRFKG2HhgpDlIJHg: checks
DMQLAmut/l19xN5STQndFg: bets $2
EIg3r3fRFKG2HhgpDlIJHg: calls $2
*** TURN *** [8d 3c 5d] [Ah]
EIg3r3fRFKG2HhgpDlIJHg: checks
DMQLAmut/l19xN5STQndFg: bets $2.50
EIg3r3fRFKG2HhgpDlIJHg: calls $2.50
*** RIVER *** [8d 3c 5d Ah] [Tc]
EIg3r3fRFKG2HhgpDlIJHg: checks
DMQLAmut/l19xN5STQndFg: bets $4.05 and is all-in
EIg3r3fRFKG2HhgpDlIJHg: folds
DMQLAmut/l19xN5STQndFg collected $13.10 from pot
DMQLAmut/l19xN5STQndFg: doesn't show hand
*** SUMMARY ***
Total pot $13.75 | Rake $0.65
Board [8d 3c 5d Ah Tc]
Seat 1: R+KjpH/wSjDLhtIy9+edNA (small blind) folded before Flop
Seat 2: 58zdeSBSuSFX/qZfhc7YmA (big blind) folded before Flop
Seat 3: jUhx+m+V7qfbLZTjgwZByg folded before Flop (didn't bet)
Seat 4: Rt6KgtZ8YaJoTc3FPim00w folded before Flop (didn't bet)
Seat 5: EIg3r3fRFKG2HhgpDlIJHg folded on the River
Seat 6: DMQLAmut/l19xN5STQndFg (button) collected ($13.10)



PokerStars Game #59938419406:  Hold'em No Limit ($0.25/$0.50) - 2009/07/01 0:14:32 ET
Table 'm95HVfesC/VPgfGEjPuaIA' 2-max Seat #1 is the button
Seat 1: Fp/oksNpipCrD2MJ2pH20g ($20.05 in chips)
Seat 2: Ag6DvxX4vbRheqsv2zXKTQ ($25 in chips)
Fp/oksNpipCrD2MJ2pH20g: posts small blind $0.25
Ag6DvxX4vbRheqsv2zXKTQ: posts big blind $0.50
*** HOLE CARDS ***
Fp/oksNpipCrD2MJ2pH20g: folds
Ag6DvxX4vbRheqsv2zXKTQ collected $0.50 from pot
*** SUMMARY ***
Total pot $0.50 | Rake $0
Seat 1: Fp/oksNpipCrD2MJ2pH20g (button) (small blind) folded before Flop
Seat 2: Ag6DvxX4vbRheqsv2zXKTQ (big blind) collected ($0.50)



PokerStars Game #59938420466:  Hold'em No Limit ($0.25/$0.50) - 2009/07/01 0:14:33 ET
Table 'MJxeZCzYELxiIsyUZyT0jw' 6-max Seat #5 is the button
Seat 1: iKPos8JI094Tomq4tDSgnQ ($34.05 in chips)
Seat 2: r6H1GiZ6QIpMTDhyodKuRQ ($65.30 in chips)
Seat 3: JQZew0FjzS19kTjeNtrE+A ($50 in chips)
Seat 4: lP7Q6pewz4C2RsAfKsjdWw ($21.60 in chips)
Seat 5: 3jvoOXNtXE90w2BdfNZwZQ ($51.15 in chips)
Seat 6: TTx3CHxyi0SObcHyMJRp5w ($48.30 in chips)
TTx3CHxyi0SObcHyMJRp5w: posts small blind $0.25
iKPos8JI094Tomq4tDSgnQ: posts big blind $0.50
*** HOLE CARDS ***
r6H1GiZ6QIpMTDhyodKuRQ: folds
JQZew0FjzS19kTjeNtrE+A: folds
lP7Q6pewz4C2RsAfKsjdWw: folds
3jvoOXNtXE90w2BdfNZwZQ: folds
TTx3CHxyi0SObcHyMJRp5w: calls $0.25
iKPos8JI094Tomq4tDSgnQ: checks
*** FLOP *** [2d Kd 5c]
TTx3CHxyi0SObcHyMJRp5w: checks
iKPos8JI094Tomq4tDSgnQ: bets $0.50
TTx3CHxyi0SObcHyMJRp5w: folds
iKPos8JI094Tomq4tDSgnQ collected $0.95 from pot
*** SUMMARY ***
Total pot $1 | Rake $0.05
Board [2d Kd 5c]
Seat 1: iKPos8JI094Tomq4tDSgnQ (big blind) collected ($0.95)
Seat 2: r6H1GiZ6QIpMTDhyodKuRQ folded before Flop (didn't bet)
Seat 3: JQZew0FjzS19kTjeNtrE+A folded before Flop (didn't bet)
Seat 4: lP7Q6pewz4C2RsAfKsjdWw folded before Flop (didn't bet)
Seat 5: 3jvoOXNtXE90w2BdfNZwZQ (button) folded before Flop (didn't bet)
Seat 6: TTx3CHxyi0SObcHyMJRp5w (small blind) folded on the Flop



PokerStars Game #59938421562:  Hold'em No Limit ($0.25/$0.50) - 2009/07/01 0:14:35 ET
Table '3FhG0gl3kMX3wBEEqj+wnQ' 9-max Seat #1 is the button
Seat 1: e0J9pdCNUDTCG031RnXqLA ($24.70 in chips)
Seat 2: 4dl3YNqZ6Houm2jZAzDmRg ($24.75 in chips)
Seat 4: bz4LMfV0GGl/MJ/ABXuPmg ($27.20 in chips)
Seat 5: XNMDwbXt/Q4jM99AXnbJDw ($50 in chips)
Seat 6: 5JJVDlaiMnB004o/RqbZZQ ($26 in chips)
Seat 8: j3K/Jujr7PY4ZM2RZvlH6A ($45.20 in chips)
Seat 9: tzoXBDwkkPV/XPJPkf963Q ($13.05 in chips)
4dl3YNqZ6Houm2jZAzDmRg: posts small blind $0.25
bXpVeaSTPBFSPJmeXxO7nw: is sitting out
bz4LMfV0GGl/MJ/ABXuPmg: posts big blind $0.50
mSD1pginDsyHG5PDfqzphw: sits out
*** HOLE CARDS ***
XNMDwbXt/Q4jM99AXnbJDw: folds
bXpVeaSTPBFSPJmeXxO7nw leaves the table
5JJVDlaiMnB004o/RqbZZQ: folds
j3K/Jujr7PY4ZM2RZvlH6A: raises $0.50 to $1
tzoXBDwkkPV/XPJPkf963Q: calls $1
e0J9pdCNUDTCG031RnXqLA: calls $1
4dl3YNqZ6Houm2jZAzDmRg: folds
bz4LMfV0GGl/MJ/ABXuPmg: folds
*** FLOP *** [Ad 7s 7c]
dennisa joins the table at seat #3
j3K/Jujr7PY4ZM2RZvlH6A: checks
tzoXBDwkkPV/XPJPkf963Q: bets $0.50
e0J9pdCNUDTCG031RnXqLA: calls $0.50
j3K/Jujr7PY4ZM2RZvlH6A: folds
*** TURN *** [Ad 7s 7c] [6c]
tzoXBDwkkPV/XPJPkf963Q: bets $0.50
e0J9pdCNUDTCG031RnXqLA: calls $0.50
*** RIVER *** [Ad 7s 7c 6c] [2c]
tzoXBDwkkPV/XPJPkf963Q: bets $0.50
e0J9pdCNUDTCG031RnXqLA: calls $0.50
*** SHOW DOWN ***
tzoXBDwkkPV/XPJPkf963Q: shows [Jh Ac] (two pair, Aces and Sevens)
e0J9pdCNUDTCG031RnXqLA: mucks hand
tzoXBDwkkPV/XPJPkf963Q collected $6.45 from pot
*** SUMMARY ***
Total pot $6.75 | Rake $0.30
Board [Ad 7s 7c 6c 2c]
Seat 1: e0J9pdCNUDTCG031RnXqLA (button) mucked
Seat 2: 4dl3YNqZ6Houm2jZAzDmRg (small blind) folded before Flop
Seat 4: bz4LMfV0GGl/MJ/ABXuPmg (big blind) folded before Flop
Seat 5: XNMDwbXt/Q4jM99AXnbJDw folded before Flop (didn't bet)
Seat 6: 5JJVDlaiMnB004o/RqbZZQ folded before Flop (didn't bet)
Seat 8: j3K/Jujr7PY4ZM2RZvlH6A folded on the Flop
Seat 9: tzoXBDwkkPV/XPJPkf963Q showed [Jh Ac] and won ($6.45) with two pair, Aces and Sevens



PokerStars Game #59938421618:  Hold'em No Limit ($0.25/$0.50) - 2009/07/01 0:14:35 ET
Table 'ZYwMb9E6tY50Qm+iNbXRYw' 2-max Seat #1 is the button
Seat 1: DXLfRb8KDZWmrztw2bwtFw ($22.45 in chips)
Seat 2: 16tvT7AYgZ2LgiGFcvFKQg ($14.75 in chips)
DXLfRb8KDZWmrztw2bwtFw: posts small blind $0.25
16tvT7AYgZ2LgiGFcvFKQg: posts big blind $0.50
*** HOLE CARDS ***
DXLfRb8KDZWmrztw2bwtFw: calls $0.25
16tvT7AYgZ2LgiGFcvFKQg: checks
*** FLOP *** [Th Td 5h]
16tvT7AYgZ2LgiGFcvFKQg: bets $0.50
DXLfRb8KDZWmrztw2bwtFw: calls $0.50
*** TURN *** [Th Td 5h] [5c]
16tvT7AYgZ2LgiGFcvFKQg: bets $0.50
DXLfRb8KDZWmrztw2bwtFw: raises $1.50 to $2
16tvT7AYgZ2LgiGFcvFKQg: calls $1.50
*** RIVER *** [Th Td 5h 5c] [7c]
16tvT7AYgZ2LgiGFcvFKQg: checks
DXLfRb8KDZWmrztw2bwtFw: bets $2
16tvT7AYgZ2LgiGFcvFKQg: calls $2
*** SHOW DOWN ***
DXLfRb8KDZWmrztw2bwtFw: shows [5d Kd] (a full house, Fives full of Tens)
16tvT7AYgZ2LgiGFcvFKQg: shows [5s 6c] (a full house, Fives full of Tens)
16tvT7AYgZ2LgiGFcvFKQg collected $4.80 from pot
DXLfRb8KDZWmrztw2bwtFw collected $4.75 from pot
*** SUMMARY ***
Total pot $10 | Rake $0.45
Board [Th Td 5h 5c 7c]
Seat 1: DXLfRb8KDZWmrztw2bwtFw (button) (small blind) showed [5d Kd] and won ($4.75) with a full house, Fives full of Tens
Seat 2: 16tvT7AYgZ2LgiGFcvFKQg (big blind) showed [5s 6c] and won ($4.80) with a full house, Fives full of Tens



PokerStars Game #59938421856:  Hold'em No Limit ($0.25/$0.50) - 2009/07/01 0:14:35 ET
Table 'raOT4/ipuZgzjfKHC+jD9g' 2-max Seat #2 is the button
Seat 1: IuwLemwLhc9fvrwBGs0AMA ($13.35 in chips)
Seat 2: Udr5juWSWUgTu1NlRhjMdA ($9.50 in chips)
Udr5juWSWUgTu1NlRhjMdA: posts small blind $0.25
IuwLemwLhc9fvrwBGs0AMA: posts big blind $0.50
*** HOLE CARDS ***
Udr5juWSWUgTu1NlRhjMdA: raises $1 to $1.50
IuwLemwLhc9fvrwBGs0AMA: folds
Udr5juWSWUgTu1NlRhjMdA collected $1 from pot
Udr5juWSWUgTu1NlRhjMdA: doesn't show hand
*** SUMMARY ***
Total pot $1 | Rake $0
Seat 1: IuwLemwLhc9fvrwBGs0AMA (big blind) folded before Flop
Seat 2: Udr5juWSWUgTu1NlRhjMdA (button) (small blind) collected ($1)



PokerStars Game #59938421298:  Hold'em No Limit ($0.25/$0.50) - 2009/07/01 0:14:35 ET
Table 'ibNfFy0bCzuBaUORla0aGw' 9-max Seat #1 is the button
Seat 1: xZCXQSXlrZkp3pZizzVXCw ($55.45 in chips)
Seat 2: 90Wb75h3W1BRpbqVnuk8gw ($52.05 in chips)
Seat 3: dDaHs3X8+fe3bIkRU0cbrw ($25.80 in chips)
Seat 4: YBN054X4blmis+B2bBlC0g ($21.05 in chips)
Seat 5: FRv75HO8CUsRZ1byEz06mQ ($13.35 in chips)
Seat 6: BmYrv3ec2k5d6pQq6iNaZw ($67.85 in chips)
Seat 7: mSD1pginDsyHG5PDfqzphw ($15.50 in chips)
Seat 8: xUrN9TWLq4m5V+OXY7KUUA ($50 in chips)
Seat 9: WpvT3OUSiZlpvs+mPXFqtQ ($8 in chips)
90Wb75h3W1BRpbqVnuk8gw: posts small blind $0.25
dDaHs3X8+fe3bIkRU0cbrw: posts big blind $0.50
*** HOLE CARDS ***
YBN054X4blmis+B2bBlC0g: folds
FRv75HO8CUsRZ1byEz06mQ: folds
BmYrv3ec2k5d6pQq6iNaZw: folds
mSD1pginDsyHG5PDfqzphw: folds
xUrN9TWLq4m5V+OXY7KUUA: folds
WpvT3OUSiZlpvs+mPXFqtQ: folds
xZCXQSXlrZkp3pZizzVXCw: folds
90Wb75h3W1BRpbqVnuk8gw: folds
dDaHs3X8+fe3bIkRU0cbrw collected $0.50 from pot
*** SUMMARY ***
Total pot $0.50 | Rake $0
Seat 1: xZCXQSXlrZkp3pZizzVXCw (button) folded before Flop (didn't bet)
Seat 2: 90Wb75h3W1BRpbqVnuk8gw (small blind) folded before Flop
Seat 3: dDaHs3X8+fe3bIkRU0cbrw (big blind) collected ($0.50)
Seat 4: YBN054X4blmis+B2bBlC0g folded before Flop (didn't bet)
Seat 5: FRv75HO8CUsRZ1byEz06mQ folded before Flop (didn't bet)
Seat 6: BmYrv3ec2k5d6pQq6iNaZw folded before Flop (didn't bet)
Seat 7: mSD1pginDsyHG5PDfqzphw folded before Flop (didn't bet)
Seat 8: xUrN9TWLq4m5V+OXY7KUUA folded before Flop (didn't bet)
Seat 9: WpvT3OUSiZlpvs+mPXFqtQ folded before Flop (didn't bet)



PokerStars Game #59938422032:  Hold'em No Limit ($0.25/$0.50) - 2009/07/01 0:14:36 ET
Table 'hSTs/dUsYLgJQuF2Onp0MQ' 6-max Seat #1 is the button
Seat 1: lWwl5C/UZOsWNubdUqghZw ($69.95 in chips)
Seat 3: vQOrJuXbLC3UZDVklY9bOA ($20.20 in chips)
Seat 4: L0aIPg7qefDQjdJo3HCVEA ($14.45 in chips)
Seat 5: 686aeHikcJlgKkSuIFdcXQ ($59.90 in chips)
Seat 6: +laPa9P7BjZKKnR0n+OmvA ($4.15 in chips)
vQOrJuXbLC3UZDVklY9bOA: posts small blind $0.25
L0aIPg7qefDQjdJo3HCVEA: posts big blind $0.50
*** HOLE CARDS ***
686aeHikcJlgKkSuIFdcXQ: folds
+laPa9P7BjZKKnR0n+OmvA: folds
gSCZnZGMgaRWmRw5txyZIA joins the table at seat #2
lWwl5C/UZOsWNubdUqghZw: raises $1.25 to $1.75
vQOrJuXbLC3UZDVklY9bOA: folds
L0aIPg7qefDQjdJo3HCVEA: folds
lWwl5C/UZOsWNubdUqghZw collected $1.25 from pot
*** SUMMARY ***
Total pot $1.25 | Rake $0
Seat 1: lWwl5C/UZOsWNubdUqghZw (button) collected ($1.25)
Seat 3: vQOrJuXbLC3UZDVklY9bOA (small blind) folded before Flop
Seat 4: L0aIPg7qefDQjdJo3HCVEA (big blind) folded before Flop
Seat 5: 686aeHikcJlgKkSuIFdcXQ folded before Flop (didn't bet)
Seat 6: +laPa9P7BjZKKnR0n+OmvA folded before Flop (didn't bet)



PokerStars Game #59938424304:  Hold'em No Limit ($0.25/$0.50) - 2009/07/01 0:14:39 ET
Table 'm95HVfesC/VPgfGEjPuaIA' 2-max Seat #2 is the button
Seat 1: Fp/oksNpipCrD2MJ2pH20g ($19.80 in chips)
Seat 2: Ag6DvxX4vbRheqsv2zXKTQ ($25.25 in chips)
Ag6DvxX4vbRheqsv2zXKTQ: posts small blind $0.25
Fp/oksNpipCrD2MJ2pH20g: posts big blind $0.50
*** HOLE CARDS ***
Ag6DvxX4vbRheqsv2zXKTQ: calls $0.25
Fp/oksNpipCrD2MJ2pH20g: checks
*** FLOP *** [4h 3c Kd]
Fp/oksNpipCrD2MJ2pH20g: bets $0.50
Ag6DvxX4vbRheqsv2zXKTQ: calls $0.50
*** TURN *** [4h 3c Kd] [Qh]
Fp/oksNpipCrD2MJ2pH20g: checks
Ag6DvxX4vbRheqsv2zXKTQ: checks
*** RIVER *** [4h 3c Kd Qh] [Ac]
Fp/oksNpipCrD2MJ2pH20g: bets $1
Ag6DvxX4vbRheqsv2zXKTQ: raises $2 to $3
Fp/oksNpipCrD2MJ2pH20g: folds
Ag6DvxX4vbRheqsv2zXKTQ collected $3.85 from pot
Ag6DvxX4vbRheqsv2zXKTQ: shows [Th Js] (a straight, Ten to Ace)
*** SUMMARY ***
Total pot $4 | Rake $0.15
Board [4h 3c Kd Qh Ac]
Seat 1: Fp/oksNpipCrD2MJ2pH20g (big blind) folded on the River
Seat 2: Ag6DvxX4vbRheqsv2zXKTQ (button) (small blind) collected ($3.85)



PokerStars Game #59938424376:  Hold'em No Limit ($0.25/$0.50) - 2009/07/01 0:14:39 ET
Table 'QOgaEqMcJ73pcUMMxoisUgErOuyGLI5PT3G5MnpHgC/g Seat #8 is the button
Seat 1: k6GJzKs7T7qvQggW9g8Pdw ($102.85 in chips)
Seat 2: RjBdQ6w31rgcy0o24VLR6w ($10.95 in chips)
Seat 3: xZCXQSXlrZkp3pZizzVXCw ($50.50 in chips)
Seat 5: JwvquocWfhTVApN5t47LgA ($44.05 in chips)
Seat 6: zE9cVigS2nW/Ljy4K4bUQA ($30 in chips)
Seat 7: 90Wb75h3W1BRpbqVnuk8gw ($67.95 in chips)
Seat 8: g4k0NXISyLCqaSWZDBjfEg ($50 in chips)
Seat 9: J0W5D97jl5VLky+IoPvDeA ($67.30 in chips)
J0W5D97jl5VLky+IoPvDeA: posts small blind $0.25
k6GJzKs7T7qvQggW9g8Pdw: posts big blind $0.50
*** HOLE CARDS ***
kuszo joins the table at seat #4
RjBdQ6w31rgcy0o24VLR6w: folds
xZCXQSXlrZkp3pZizzVXCw: folds
JwvquocWfhTVApN5t47LgA: folds
zE9cVigS2nW/Ljy4K4bUQA: folds
90Wb75h3W1BRpbqVnuk8gw: raises $1.50 to $2
g4k0NXISyLCqaSWZDBjfEg: folds
J0W5D97jl5VLky+IoPvDeA: folds
k6GJzKs7T7qvQggW9g8Pdw: calls $1.50
*** FLOP *** [3c 6d 3h]
k6GJzKs7T7qvQggW9g8Pdw: checks
90Wb75h3W1BRpbqVnuk8gw: bets $2.50
k6GJzKs7T7qvQggW9g8Pdw: calls $2.50
*** TURN *** [3c 6d 3h] [Qd]
k6GJzKs7T7qvQggW9g8Pdw: checks
90Wb75h3W1BRpbqVnuk8gw: checks
*** RIVER *** [3c 6d 3h Qd] [7s]
k6GJzKs7T7qvQggW9g8Pdw: bets $3.50
90Wb75h3W1BRpbqVnuk8gw: calls $3.50
*** SHOW DOWN ***
k6GJzKs7T7qvQggW9g8Pdw: shows [7c 5c] (two pair, Sevens and Threes)
90Wb75h3W1BRpbqVnuk8gw: shows [5d 7d] (two pair, Sevens and Threes)
k6GJzKs7T7qvQggW9g8Pdw collected $7.75 from pot
90Wb75h3W1BRpbqVnuk8gw collected $7.75 from pot
*** SUMMARY ***
Total pot $16.25 | Rake $0.75
Board [3c 6d 3h Qd 7s]
Seat 1: k6GJzKs7T7qvQggW9g8Pdw (big blind) showed [7c 5c] and won ($7.75) with two pair, Sevens and Threes
Seat 2: RjBdQ6w31rgcy0o24VLR6w folded before Flop (didn't bet)
Seat 3: xZCXQSXlrZkp3pZizzVXCw folded before Flop (didn't bet)
Seat 5: JwvquocWfhTVApN5t47LgA folded before Flop (didn't bet)
Seat 6: zE9cVigS2nW/Ljy4K4bUQA folded before Flop (didn't bet)
Seat 7: 90Wb75h3W1BRpbqVnuk8gw showed [5d 7d] and won ($7.75) with two pair, Sevens and Threes
Seat 8: g4k0NXISyLCqaSWZDBjfEg (button) folded before Flop (didn't bet)
Seat 9: J0W5D97jl5VLky+IoPvDeA (small blind) folded before Flop



PokerStars Game #59938425288:  Hold'em No Limit ($0.25/$0.50) - 2009/07/01 0:14:40 ET
Table 'Vdlc9wqYcHTUhtdyN7CuJw' 2-max Seat #1 is the button
Seat 1: yBO+mXB6m/rCft2ErwGf/Q ($69.85 in chips)
Seat 2: sa0qgETiL3HNbdfGlnKHTA ($41.05 in chips)
yBO+mXB6m/rCft2ErwGf/Q: posts small blind $0.25
sa0qgETiL3HNbdfGlnKHTA: posts big blind $0.50
*** HOLE CARDS ***
yBO+mXB6m/rCft2ErwGf/Q: raises $1 to $1.50
sa0qgETiL3HNbdfGlnKHTA: calls $1
*** FLOP *** [8d Qd Qs]
sa0qgETiL3HNbdfGlnKHTA: checks
yBO+mXB6m/rCft2ErwGf/Q: bets $1.50
sa0qgETiL3HNbdfGlnKHTA: folds
yBO+mXB6m/rCft2ErwGf/Q collected $2.85 from pot
*** SUMMARY ***
Total pot $3 | Rake $0.15
Board [8d Qd Qs]
Seat 1: yBO+mXB6m/rCft2ErwGf/Q (button) (small blind) collected ($2.85)
Seat 2: sa0qgETiL3HNbdfGlnKHTA (big blind) folded on the Flop



PokerStars Game #59938425972:  Hold'em No Limit ($0.25/$0.50) - 2009/07/01 0:14:41 ET
Table '+dXkOAQyS8j9PQZusUTMpg' 2-max Seat #2 is the button
Seat 1: XFa6sBGjP2gxoIvxR3fZIg ($91.20 in chips)
Seat 2: 5IBeOgaApY1Bvzv2P8X4EA ($20.30 in chips)
5IBeOgaApY1Bvzv2P8X4EA: posts small blind $0.25
XFa6sBGjP2gxoIvxR3fZIg: posts big blind $0.50
*** HOLE CARDS ***
5IBeOgaApY1Bvzv2P8X4EA: folds
XFa6sBGjP2gxoIvxR3fZIg collected $0.50 from pot
*** SUMMARY ***
Total pot $0.50 | Rake $0
Seat 1: XFa6sBGjP2gxoIvxR3fZIg (big blind) collected ($0.50)
Seat 2: 5IBeOgaApY1Bvzv2P8X4EA (button) (small blind) folded before Flop



PokerStars Game #59938425536:  Hold'em No Limit ($0.25/$0.50) - 2009/07/01 0:14:41 ET
Table 'QOgaEqMcJ73pcUMMxoisUg' 6-max Seat #1 is the button
Seat 1: RFefXIDyFvNtJLq+CloCzA ($41.70 in chips)
Seat 2: Im2p1Nt83UKSqv5c9frm4Q ($50 in chips)
Seat 3: wUZNozoIDYf+16hp4nn6dw ($44.50 in chips)
Seat 4: zAcsDhG/T128Vn7XGVSgKg ($54.20 in chips)
Seat 6: s83dnhZ6VC53vY0/f6OV/g ($48.50 in chips)
Im2p1Nt83UKSqv5c9frm4Q: posts small blind $0.25
wUZNozoIDYf+16hp4nn6dw: posts big blind $0.50
*** HOLE CARDS ***
zAcsDhG/T128Vn7XGVSgKg: folds
s83dnhZ6VC53vY0/f6OV/g: folds
RFefXIDyFvNtJLq+CloCzA: folds
Im2p1Nt83UKSqv5c9frm4Q: folds
wUZNozoIDYf+16hp4nn6dw collected $0.50 from pot
*** SUMMARY ***
Total pot $0.50 | Rake $0
Seat 1: RFefXIDyFvNtJLq+CloCzA (button) folded before Flop (didn't bet)
Seat 2: Im2p1Nt83UKSqv5c9frm4Q (small blind) folded before Flop
Seat 3: wUZNozoIDYf+16hp4nn6dw (big blind) collected ($0.50)
Seat 4: zAcsDhG/T128Vn7XGVSgKg folded before Flop (didn't bet)
Seat 6: s83dnhZ6VC53vY0/f6OV/g folded before Flop (didn't bet)



PokerStars Game #59938426720:  Hold'em No Limit ($0.25/$0.50) - 2009/07/01 0:14:42 ET
Table 'E7bWJ45aoFXRpyRv2gw+Ig' 2-max Seat #2 is the button
Seat 1: FRkiRasEGlHUeLrEl+k/nA ($50 in chips)
Seat 2: 3Wro85I7472vJ4Wkpneo9A ($82.50 in chips)
FRkiRasEGlHUeLrEl+k/nA said, "......."
3Wro85I7472vJ4Wkpneo9A: posts small blind $0.25
FRkiRasEGlHUeLrEl+k/nA: posts big blind $0.50
*** HOLE CARDS ***
3Wro85I7472vJ4Wkpneo9A: calls $0.25
FRkiRasEGlHUeLrEl+k/nA: raises $1 to $1.50
FRkiRasEGlHUeLrEl+k/nA said, "nh"
3Wro85I7472vJ4Wkpneo9A: calls $1
*** FLOP *** [Jd 2h Ks]
FRkiRasEGlHUeLrEl+k/nA: bets $1
3Wro85I7472vJ4Wkpneo9A: folds
FRkiRasEGlHUeLrEl+k/nA collected $2.85 from pot
FRkiRasEGlHUeLrEl+k/nA: doesn't show hand
*** SUMMARY ***
Total pot $3 | Rake $0.15
Board [Jd 2h Ks]
Seat 1: FRkiRasEGlHUeLrEl+k/nA (big blind) collected ($2.85)
Seat 2: 3Wro85I7472vJ4Wkpneo9A (button) (small blind) folded on the Flop



PokerStars Game #59938426776:  Hold'em No Limit ($0.25/$0.50) - 2009/07/01 0:14:42 ET
Table 'Nz0Vr7WMHL2g5Uk7dDZjpw' 9-max Seat #8 is the button
Seat 1: tLkxo7JgV+WWI0UBw44K5A ($101.35 in chips)
Seat 3: 4QTiNH5fteLgJjx/s6Hy6A ($7.40 in chips)
Seat 4: 5JJVDlaiMnB004o/RqbZZQ ($27 in chips)
Seat 5: WGW0DgjBUXs1ylURHG8vnQ ($18.10 in chips)
Seat 6: k1f0lS7tlMHCLGs0JT34Tg ($8 in chips)
Seat 7: KPLH0gELgFe2OuAnhJFI5w ($21.45 in chips)
Seat 8: HkZI6g4zl83TDTA7SRspmQ ($16.50 in chips)
Seat 9: Ak2W6V2TDVIQrvSAy4eD7Q ($28.30 in chips)
Ak2W6V2TDVIQrvSAy4eD7Q: posts small blind $0.25
tLkxo7JgV+WWI0UBw44K5A: posts big blind $0.50
*** HOLE CARDS ***
4QTiNH5fteLgJjx/s6Hy6A: calls $0.50
5JJVDlaiMnB004o/RqbZZQ: raises $1.50 to $2
WGW0DgjBUXs1ylURHG8vnQ: folds
k1f0lS7tlMHCLGs0JT34Tg: folds
KPLH0gELgFe2OuAnhJFI5w: folds
HkZI6g4zl83TDTA7SRspmQ: folds
Ak2W6V2TDVIQrvSAy4eD7Q: folds
tLkxo7JgV+WWI0UBw44K5A: folds
4QTiNH5fteLgJjx/s6Hy6A: folds
5JJVDlaiMnB004o/RqbZZQ collected $1.75 from pot
*** SUMMARY ***
Total pot $1.75 | Rake $0
Seat 1: tLkxo7JgV+WWI0UBw44K5A (big blind) folded before Flop
Seat 3: 4QTiNH5fteLgJjx/s6Hy6A folded before Flop
Seat 4: 5JJVDlaiMnB004o/RqbZZQ collected ($1.75)
Seat 5: WGW0DgjBUXs1ylURHG8vnQ folded before Flop (didn't bet)
Seat 6: k1f0lS7tlMHCLGs0JT34Tg folded before Flop (didn't bet)
Seat 7: KPLH0gELgFe2OuAnhJFI5w folded before Flop (didn't bet)
Seat 8: HkZI6g4zl83TDTA7SRspmQ (button) folded before Flop (didn't bet)
Seat 9: Ak2W6V2TDVIQrvSAy4eD7Q (small blind) folded before Flop



PokerStars Game #59938427054:  Hold'em No Limit ($0.25/$0.50) - 2009/07/01 0:14:43 ET
Table 'kgbJRsxfv64KrErDRBAkcw' 6-max Seat #2 is the button
Seat 2: Q+thC23WCv1kJUJtH/+4Jw ($30.45 in chips)
Seat 3: T0Gx/FcQ5VH9u7XaOMX97A ($61.25 in chips)
Seat 4: qanMEqjABjWxC/JgQ/0l7w ($62.70 in chips)
Seat 5: +Pf9jTVizYlIo+woPvptfA ($50 in chips)
Seat 6: DDfYzIrYT0t5R/hAJngtsg ($24.70 in chips)
T0Gx/FcQ5VH9u7XaOMX97A: posts small blind $0.25
qanMEqjABjWxC/JgQ/0l7w: posts big blind $0.50
*** HOLE CARDS ***
+Pf9jTVizYlIo+woPvptfA: folds
DDfYzIrYT0t5R/hAJngtsg: raises $0.50 to $1
Q+thC23WCv1kJUJtH/+4Jw: folds
T0Gx/FcQ5VH9u7XaOMX97A: folds
qanMEqjABjWxC/JgQ/0l7w: folds
DDfYzIrYT0t5R/hAJngtsg collected $1.25 from pot
*** SUMMARY ***
Total pot $1.25 | Rake $0
Seat 2: Q+thC23WCv1kJUJtH/+4Jw (button) folded before Flop (didn't bet)
Seat 3: T0Gx/FcQ5VH9u7XaOMX97A (small blind) folded before Flop
Seat 4: qanMEqjABjWxC/JgQ/0l7w (big blind) folded before Flop
Seat 5: +Pf9jTVizYlIo+woPvptfA folded before Flop (didn't bet)
Seat 6: DDfYzIrYT0t5R/hAJngtsg collected ($1.25)



PokerStars Game #59938427780:  Hold'em No Limit ($0.25/$0.50) - 2009/07/01 0:14:44 ET
Table 'c/CRn+68J3Y8KxD5g1ek2Q' 2-max Seat #2 is the button
Seat 1: 46qCyJ6evTkHo9al5sBMNA ($292.30 in chips)
Seat 2: BypVLsYQt3ePFm2xQL/dOA ($91.75 in chips)
BypVLsYQt3ePFm2xQL/dOA: posts small blind $0.25
46qCyJ6evTkHo9al5sBMNA: posts big blind $0.50
*** HOLE CARDS ***
BypVLsYQt3ePFm2xQL/dOA: raises $1 to $1.50
46qCyJ6evTkHo9al5sBMNA: folds
BypVLsYQt3ePFm2xQL/dOA collected $1 from pot
BypVLsYQt3ePFm2xQL/dOA: doesn't show hand
*** SUMMARY ***
Total pot $1 | Rake $0
Seat 1: 46qCyJ6evTkHo9al5sBMNA (big blind) folded before Flop
Seat 2: BypVLsYQt3ePFm2xQL/dOA (button) (small blind) collected ($1)



PokerStars Game #59938428902:  Hold'em No Limit ($0.25/$0.50) - 2009/07/01 0:14:45 ET
Table 'raOT4/ipuZgzjfKHC+jD9g' 2-max Seat #1 is the button
Seat 1: IuwLemwLhc9fvrwBGs0AMA ($12.85 in chips)
Seat 2: Udr5juWSWUgTu1NlRhjMdA ($10 in chips)
IuwLemwLhc9fvrwBGs0AMA: posts small blind $0.25
Udr5juWSWUgTu1NlRhjMdA: posts big blind $0.50
*** HOLE CARDS ***
IuwLemwLhc9fvrwBGs0AMA: raises $1 to $1.50
Udr5juWSWUgTu1NlRhjMdA: folds
IuwLemwLhc9fvrwBGs0AMA collected $1 from pot
IuwLemwLhc9fvrwBGs0AMA: doesn't show hand
*** SUMMARY ***
Total pot $1 | Rake $0
Seat 1: IuwLemwLhc9fvrwBGs0AMA (button) (small blind) collected ($1)
Seat 2: Udr5juWSWUgTu1NlRhjMdA (big blind) folded before Flop



PokerStars Game #59938429212:  Hold'em No Limit ($0.25/$0.50) - 2009/07/01 0:14:46 ET
Table 'mTxf8gPLgffN3Iwfm7Icfg' 2-max Seat #2 is the button
Seat 1: Do9Rlu1R5u/AcRtMTl8SYg ($56.45 in chips)
Seat 2: EMc5LPgVaded4Qc77vm0fw ($56.40 in chips)
EMc5LPgVaded4Qc77vm0fw: posts small blind $0.25
Do9Rlu1R5u/AcRtMTl8SYg: posts big blind $0.50
*** HOLE CARDS ***
EMc5LPgVaded4Qc77vm0fw: raises $1 to $1.50
Do9Rlu1R5u/AcRtMTl8SYg: calls $1
*** FLOP *** [9c Jh 2s]
Do9Rlu1R5u/AcRtMTl8SYg: checks
EMc5LPgVaded4Qc77vm0fw: checks
*** TURN *** [9c Jh 2s] [Qs]
Do9Rlu1R5u/AcRtMTl8SYg: bets $2
EMc5LPgVaded4Qc77vm0fw: calls $2
*** RIVER *** [9c Jh 2s Qs] [5s]
Do9Rlu1R5u/AcRtMTl8SYg: bets $3.50
EMc5LPgVaded4Qc77vm0fw: folds
Do9Rlu1R5u/AcRtMTl8SYg collected $6.70 from pot
Do9Rlu1R5u/AcRtMTl8SYg: doesn't show hand
*** SUMMARY ***
Total pot $7 | Rake $0.30
Board [9c Jh 2s Qs 5s]
Seat 1: Do9Rlu1R5u/AcRtMTl8SYg (big blind) collected ($6.70)
Seat 2: EMc5LPgVaded4Qc77vm0fw (button) (small blind) folded on the River



PokerStars Game #59938430392:  Hold'em No Limit ($0.25/$0.50) - 2009/07/01 0:14:47 ET
Table '+dXkOAQyS8j9PQZusUTMpg' 2-max Seat #1 is the button
Seat 1: XFa6sBGjP2gxoIvxR3fZIg ($91.45 in chips)
Seat 2: 5IBeOgaApY1Bvzv2P8X4EA ($20.05 in chips)
XFa6sBGjP2gxoIvxR3fZIg: posts small blind $0.25
5IBeOgaApY1Bvzv2P8X4EA: posts big blind $0.50
*** HOLE CARDS ***
XFa6sBGjP2gxoIvxR3fZIg: raises $1 to $1.50
5IBeOgaApY1Bvzv2P8X4EA: folds
XFa6sBGjP2gxoIvxR3fZIg collected $1 from pot
XFa6sBGjP2gxoIvxR3fZIg: doesn't show hand
*** SUMMARY ***
Total pot $1 | Rake $0
Seat 1: XFa6sBGjP2gxoIvxR3fZIg (button) (small blind) collected ($1)
Seat 2: 5IBeOgaApY1Bvzv2P8X4EA (big blind) folded before Flop



PokerStars Game #59938430128:  Hold'em No Limit ($0.25/$0.50) - 2009/07/01 0:14:47 ET
Table 'T/PgNWqVyY6lkldcBVXYJQ' 6-max Seat #4 is the button
Seat 1: +Pf9jTVizYlIo+woPvptfA ($53.20 in chips)
Seat 2: oZAeY5rVqNGgt8yyQ0pxbA ($23.30 in chips)
Seat 3: L3OcNO1bgdqDI46j67KQPQ ($56.30 in chips)
Seat 4: jxMvxeUUL9UU0V6wVU+Iyw ($4.10 in chips)
Seat 5: vVQBckETtigfb5mAcyK0OA ($61.75 in chips)
Seat 6: cDzbog6kwmJp+LBeBq+iMQ ($21.25 in chips)
vVQBckETtigfb5mAcyK0OA: posts small blind $0.25
cDzbog6kwmJp+LBeBq+iMQ: posts big blind $0.50
*** HOLE CARDS ***
+Pf9jTVizYlIo+woPvptfA: folds
oZAeY5rVqNGgt8yyQ0pxbA: folds
jxMvxeUUL9UU0V6wVU+Iyw said, "tickets are very good"
L3OcNO1bgdqDI46j67KQPQ: folds
jxMvxeUUL9UU0V6wVU+Iyw: folds
vVQBckETtigfb5mAcyK0OA said, "BUT SHE DIDNT LIKE IT WHEN I WOULDNT COME HOME FOR A FEW DAYS AT A TIME LOL"
vVQBckETtigfb5mAcyK0OA: calls $0.25
cDzbog6kwmJp+LBeBq+iMQ: checks
*** FLOP *** [4d 8d 3s]
vVQBckETtigfb5mAcyK0OA: checks
cDzbog6kwmJp+LBeBq+iMQ: checks
*** TURN *** [4d 8d 3s] [Ah]
vVQBckETtigfb5mAcyK0OA: bets $0.50
cDzbog6kwmJp+LBeBq+iMQ: calls $0.50
*** RIVER *** [4d 8d 3s Ah] [8h]
vVQBckETtigfb5mAcyK0OA: checks
cDzbog6kwmJp+LBeBq+iMQ: checks
*** SHOW DOWN ***
vVQBckETtigfb5mAcyK0OA: shows [Jd 6d] (a pair of Eights)
cDzbog6kwmJp+LBeBq+iMQ: shows [Qs 2h] (a pair of Eights - Ace+Queen kicker)
cDzbog6kwmJp+LBeBq+iMQ collected $1.95 from pot
*** SUMMARY ***
Total pot $2 | Rake $0.05
Board [4d 8d 3s Ah 8h]
Seat 1: +Pf9jTVizYlIo+woPvptfA folded before Flop (didn't bet)
Seat 2: oZAeY5rVqNGgt8yyQ0pxbA folded before Flop (didn't bet)
Seat 3: L3OcNO1bgdqDI46j67KQPQ folded before Flop (didn't bet)
Seat 4: jxMvxeUUL9UU0V6wVU+Iyw (button) folded before Flop (didn't bet)
Seat 5: vVQBckETtigfb5mAcyK0OA (small blind) showed [Jd 6d] and lost with a pair of Eights
Seat 6: cDzbog6kwmJp+LBeBq+iMQ (big blind) showed [Qs 2h] and won ($1.95) with a pair of Eights



PokerStars Game #59938431614:  Hold'em No Limit ($0.25/$0.50) - 2009/07/01 0:14:49 ET
Table 'BCN5su+SsXiy1zRMJi0SJw' 6-max Seat #5 is the button
Seat 1: WyeokAqR0q9nADSkWpbxHw ($35.35 in chips)
Seat 2: QfV2JJlmEKgD5jYPV+a33A ($179 in chips)
Seat 3: L309C3uyA1tkWSOh/QvjHw ($20.85 in chips)
Seat 5: TTx3CHxyi0SObcHyMJRp5w ($32.50 in chips)
WyeokAqR0q9nADSkWpbxHw: posts small blind $0.25
QfV2JJlmEKgD5jYPV+a33A: posts big blind $0.50
*** HOLE CARDS ***
L309C3uyA1tkWSOh/QvjHw: folds
TTx3CHxyi0SObcHyMJRp5w: folds
WyeokAqR0q9nADSkWpbxHw: folds
QfV2JJlmEKgD5jYPV+a33A collected $0.50 from pot
QfV2JJlmEKgD5jYPV+a33A: doesn't show hand
*** SUMMARY ***
Total pot $0.50 | Rake $0
Seat 1: WyeokAqR0q9nADSkWpbxHw (small blind) folded before Flop
Seat 2: QfV2JJlmEKgD5jYPV+a33A (big blind) collected ($0.50)
Seat 3: L309C3uyA1tkWSOh/QvjHw folded before Flop (didn't bet)
Seat 5: TTx3CHxyi0SObcHyMJRp5w (button) folded before Flop (didn't bet)



PokerStars Game #59938433736:  Hold'em No Limit ($0.25/$0.50) - 2009/07/01 0:14:52 ET
Table 'c/CRn+68J3Y8KxD5g1ek2Q' 2-max Seat #1 is the button
Seat 1: 46qCyJ6evTkHo9al5sBMNA ($291.80 in chips)
Seat 2: BypVLsYQt3ePFm2xQL/dOA ($92.25 in chips)
46qCyJ6evTkHo9al5sBMNA: posts small blind $0.25
BypVLsYQt3ePFm2xQL/dOA: posts big blind $0.50
*** HOLE CARDS ***
46qCyJ6evTkHo9al5sBMNA: folds
BypVLsYQt3ePFm2xQL/dOA collected $0.50 from pot
BypVLsYQt3ePFm2xQL/dOA: doesn't show hand
*** SUMMARY ***
Total pot $0.50 | Rake $0
Seat 1: 46qCyJ6evTkHo9al5sBMNA (button) (small blind) folded before Flop
Seat 2: BypVLsYQt3ePFm2xQL/dOA (big blind) collected ($0.50)



PokerStars Game #59938436104:  Hold'em No Limit ($0.25/$0.50) - 2009/07/01 0:14:55 ET
Table 'ZYwMb9E6tY50Qm+iNbXRYw' 2-max Seat #2 is the button
Seat 1: DXLfRb8KDZWmrztw2bwtFw ($22.20 in chips)
Seat 2: 16tvT7AYgZ2LgiGFcvFKQg ($14.55 in chips)
16tvT7AYgZ2LgiGFcvFKQg: posts small blind $0.25
DXLfRb8KDZWmrztw2bwtFw: posts big blind $0.50
*** HOLE CARDS ***
16tvT7AYgZ2LgiGFcvFKQg: calls $0.25
DXLfRb8KDZWmrztw2bwtFw: checks
*** FLOP *** [Jd Ah 9d]
DXLfRb8KDZWmrztw2bwtFw: checks
16tvT7AYgZ2LgiGFcvFKQg: bets $0.50
DXLfRb8KDZWmrztw2bwtFw: folds
16tvT7AYgZ2LgiGFcvFKQg collected $0.95 from pot
16tvT7AYgZ2LgiGFcvFKQg: doesn't show hand
*** SUMMARY ***
Total pot $1 | Rake $0.05
Board [Jd Ah 9d]
Seat 1: DXLfRb8KDZWmrztw2bwtFw (big blind) folded on the Flop
Seat 2: 16tvT7AYgZ2LgiGFcvFKQg (button) (small blind) collected ($0.95)



PokerStars Game #59938435896:  Hold'em No Limit ($0.25/$0.50) - 2009/07/01 0:14:55 ET
Table 'raOT4/ipuZgzjfKHC+jD9g' 2-max Seat #2 is the button
Seat 1: IuwLemwLhc9fvrwBGs0AMA ($13.35 in chips)
Seat 2: Udr5juWSWUgTu1NlRhjMdA ($9.50 in chips)
Udr5juWSWUgTu1NlRhjMdA: posts small blind $0.25
IuwLemwLhc9fvrwBGs0AMA: posts big blind $0.50
*** HOLE CARDS ***
Udr5juWSWUgTu1NlRhjMdA: folds
IuwLemwLhc9fvrwBGs0AMA collected $0.50 from pot
*** SUMMARY ***
Total pot $0.50 | Rake $0
Seat 1: IuwLemwLhc9fvrwBGs0AMA (big blind) collected ($0.50)
Seat 2: Udr5juWSWUgTu1NlRhjMdA (button) (small blind) folded before Flop



PokerStars Game #59938436334:  Hold'em No Limit ($0.25/$0.50) - 2009/07/01 0:14:56 ET
Table '+dXkOAQyS8j9PQZusUTMpg' 2-max Seat #2 is the button
Seat 1: XFa6sBGjP2gxoIvxR3fZIg ($91.95 in chips)
Seat 2: 5IBeOgaApY1Bvzv2P8X4EA ($19.55 in chips)
5IBeOgaApY1Bvzv2P8X4EA: posts small blind $0.25
XFa6sBGjP2gxoIvxR3fZIg: posts big blind $0.50
*** HOLE CARDS ***
5IBeOgaApY1Bvzv2P8X4EA: raises $1 to $1.50
XFa6sBGjP2gxoIvxR3fZIg: folds
5IBeOgaApY1Bvzv2P8X4EA collected $1 from pot
5IBeOgaApY1Bvzv2P8X4EA: doesn't show hand
*** SUMMARY ***
Total pot $1 | Rake $0
Seat 1: XFa6sBGjP2gxoIvxR3fZIg (big blind) folded before Flop
Seat 2: 5IBeOgaApY1Bvzv2P8X4EA (button) (small blind) collected ($1)



PokerStars Game #59938438030:  Hold'em No Limit ($0.25/$0.50) - 2009/07/01 0:14:58 ET
Table 'BCN5su+SsXiy1zRMJi0SJw' 6-max Seat #1 is the button
Seat 1: WyeokAqR0q9nADSkWpbxHw ($35.10 in chips)
Seat 2: QfV2JJlmEKgD5jYPV+a33A ($179.25 in chips)
Seat 3: L309C3uyA1tkWSOh/QvjHw ($20.85 in chips)
Seat 5: TTx3CHxyi0SObcHyMJRp5w ($32.50 in chips)
QfV2JJlmEKgD5jYPV+a33A: posts small blind $0.25
L309C3uyA1tkWSOh/QvjHw: posts big blind $0.50
*** HOLE CARDS ***
TTx3CHxyi0SObcHyMJRp5w: folds
WyeokAqR0q9nADSkWpbxHw: folds
WyeokAqR0q9nADSkWpbxHw leaves the table
QfV2JJlmEKgD5jYPV+a33A: raises $1 to $1.50
L309C3uyA1tkWSOh/QvjHw: folds
QfV2JJlmEKgD5jYPV+a33A collected $1 from pot
QfV2JJlmEKgD5jYPV+a33A: doesn't show hand
*** SUMMARY ***
Total pot $1 | Rake $0
Seat 1: WyeokAqR0q9nADSkWpbxHw (button) folded before Flop (didn't bet)
Seat 2: QfV2JJlmEKgD5jYPV+a33A (small blind) collected ($1)
Seat 3: L309C3uyA1tkWSOh/QvjHw (big blind) folded before Flop
Seat 5: TTx3CHxyi0SObcHyMJRp5w folded before Flop (didn't bet)



PokerStars Game #59938438306:  Hold'em No Limit ($0.25/$0.50) - 2009/07/01 0:14:59 ET
Table 'lSisgp6H7Fg1hH5VfjEjYQ' 9-max Seat #2 is the button
Seat 1: pEW8B6uXbdR47kfljMQ3+Q ($38.95 in chips)
Seat 2: UrcnkQOiLVk8BlKDPJSy7Q ($51.10 in chips)
Seat 3: aTkyjTh3w5YLWiIERupZOA ($38 in chips)
Seat 4: nvw9yQKhJT56lA9k+TLdhw ($11.70 in chips)
Seat 5: mSD1pginDsyHG5PDfqzphw ($10 in chips)
Seat 6: +k7T5ocke8UwavtgUHm+Cg ($22.15 in chips)
Seat 7: dGw5MBstXyXhWHHVFOWOFA ($43.75 in chips)
Seat 8: a4JDWmpFQkL10XfAyuF51A ($29.50 in chips)
Seat 9: 5JJVDlaiMnB004o/RqbZZQ ($40.80 in chips)
aTkyjTh3w5YLWiIERupZOA: posts small blind $0.25
nvw9yQKhJT56lA9k+TLdhw: posts big blind $0.50
*** HOLE CARDS ***
mSD1pginDsyHG5PDfqzphw: folds
+k7T5ocke8UwavtgUHm+Cg: folds
dGw5MBstXyXhWHHVFOWOFA: folds
a4JDWmpFQkL10XfAyuF51A: calls $0.50
5JJVDlaiMnB004o/RqbZZQ: folds
pEW8B6uXbdR47kfljMQ3+Q: folds
UrcnkQOiLVk8BlKDPJSy7Q: folds
aTkyjTh3w5YLWiIERupZOA: folds
nvw9yQKhJT56lA9k+TLdhw: checks
*** FLOP *** [Kc 7h Td]
nvw9yQKhJT56lA9k+TLdhw: checks
a4JDWmpFQkL10XfAyuF51A: bets $1.50
nvw9yQKhJT56lA9k+TLdhw: raises $1.50 to $3
a4JDWmpFQkL10XfAyuF51A: folds
nvw9yQKhJT56lA9k+TLdhw collected $4.05 from pot
*** SUMMARY ***
Total pot $4.25 | Rake $0.20
Board [Kc 7h Td]
Seat 1: pEW8B6uXbdR47kfljMQ3+Q folded before Flop (didn't bet)
Seat 2: UrcnkQOiLVk8BlKDPJSy7Q (button) folded before Flop (didn't bet)
Seat 3: aTkyjTh3w5YLWiIERupZOA (small blind) folded before Flop
Seat 4: nvw9yQKhJT56lA9k+TLdhw (big blind) collected ($4.05)
Seat 5: mSD1pginDsyHG5PDfqzphw folded before Flop (didn't bet)
Seat 6: +k7T5ocke8UwavtgUHm+Cg folded before Flop (didn't bet)
Seat 7: dGw5MBstXyXhWHHVFOWOFA folded before Flop (didn't bet)
Seat 8: a4JDWmpFQkL10XfAyuF51A folded on the Flop
Seat 9: 5JJVDlaiMnB004o/RqbZZQ folded before Flop (didn't bet)



PokerStars Game #59938438520:  Hold'em No Limit ($0.25/$0.50) - 2009/07/01 0:14:59 ET
Table 'c/CRn+68J3Y8KxD5g1ek2Q' 2-max Seat #2 is the button
Seat 1: 46qCyJ6evTkHo9al5sBMNA ($291.55 in chips)
Seat 2: BypVLsYQt3ePFm2xQL/dOA ($92.50 in chips)
BypVLsYQt3ePFm2xQL/dOA: posts small blind $0.25
46qCyJ6evTkHo9al5sBMNA: posts big blind $0.50
*** HOLE CARDS ***
BypVLsYQt3ePFm2xQL/dOA: raises $1 to $1.50
46qCyJ6evTkHo9al5sBMNA: raises $3.50 to $5
BypVLsYQt3ePFm2xQL/dOA: folds
46qCyJ6evTkHo9al5sBMNA collected $3 from pot
46qCyJ6evTkHo9al5sBMNA: doesn't show hand
*** SUMMARY ***
Total pot $3 | Rake $0
Seat 1: 46qCyJ6evTkHo9al5sBMNA (big blind) collected ($3)
Seat 2: BypVLsYQt3ePFm2xQL/dOA (button) (small blind) folded before Flop



PokerStars Game #59938439586:  Hold'em No Limit ($0.25/$0.50) - 2009/07/01 0:15:00 ET
Table 'MJxeZCzYELxiIsyUZyT0jw' 6-max Seat #6 is the button
Seat 1: iKPos8JI094Tomq4tDSgnQ ($34.50 in chips)
Seat 2: r6H1GiZ6QIpMTDhyodKuRQ ($65.30 in chips)
Seat 3: JQZew0FjzS19kTjeNtrE+A ($50 in chips)
Seat 4: lP7Q6pewz4C2RsAfKsjdWw ($21.60 in chips)
Seat 5: 3jvoOXNtXE90w2BdfNZwZQ ($51.15 in chips)
Seat 6: TTx3CHxyi0SObcHyMJRp5w ($47.80 in chips)
iKPos8JI094Tomq4tDSgnQ: posts small blind $0.25
r6H1GiZ6QIpMTDhyodKuRQ: posts big blind $0.50
*** HOLE CARDS ***
JQZew0FjzS19kTjeNtrE+A: folds
lP7Q6pewz4C2RsAfKsjdWw: folds
3jvoOXNtXE90w2BdfNZwZQ: folds
TTx3CHxyi0SObcHyMJRp5w: folds
iKPos8JI094Tomq4tDSgnQ: raises $1.50 to $2
r6H1GiZ6QIpMTDhyodKuRQ: folds
iKPos8JI094Tomq4tDSgnQ collected $1 from pot
*** SUMMARY ***
Total pot $1 | Rake $0
Seat 1: iKPos8JI094Tomq4tDSgnQ (small blind) collected ($1)
Seat 2: r6H1GiZ6QIpMTDhyodKuRQ (big blind) folded before Flop
Seat 3: JQZew0FjzS19kTjeNtrE+A folded before Flop (didn't bet)
Seat 4: lP7Q6pewz4C2RsAfKsjdWw folded before Flop (didn't bet)
Seat 5: 3jvoOXNtXE90w2BdfNZwZQ folded before Flop (didn't bet)
Seat 6: TTx3CHxyi0SObcHyMJRp5w (button) folded before Flop (didn't bet)



PokerStars Game #59938440228:  Hold'em No Limit ($0.25/$0.50) - 2009/07/01 0:15:01 ET
Table 'E7bWJ45aoFXRpyRv2gw+Ig' 2-max Seat #1 is the button
Seat 1: FRkiRasEGlHUeLrEl+k/nA ($51.35 in chips)
Seat 2: 3Wro85I7472vJ4Wkpneo9A ($81 in chips)
FRkiRasEGlHUeLrEl+k/nA: posts small blind $0.25
3Wro85I7472vJ4Wkpneo9A: posts big blind $0.50
*** HOLE CARDS ***
FRkiRasEGlHUeLrEl+k/nA: raises $1 to $1.50
3Wro85I7472vJ4Wkpneo9A: calls $1
*** FLOP *** [3s 9h 2d]
3Wro85I7472vJ4Wkpneo9A: bets $2
FRkiRasEGlHUeLrEl+k/nA: raises $3 to $5
3Wro85I7472vJ4Wkpneo9A: calls $3
*** TURN *** [3s 9h 2d] [6d]
3Wro85I7472vJ4Wkpneo9A: checks
FRkiRasEGlHUeLrEl+k/nA: bets $7.50
3Wro85I7472vJ4Wkpneo9A: raises $11 to $18.50
FRkiRasEGlHUeLrEl+k/nA: calls $11
*** RIVER *** [3s 9h 2d 6d] [8s]
3Wro85I7472vJ4Wkpneo9A: bets $27
FRkiRasEGlHUeLrEl+k/nA: calls $26.35 and is all-in
*** SHOW DOWN ***
3Wro85I7472vJ4Wkpneo9A: shows [3d 3c] (three of a kind, Threes)
FRkiRasEGlHUeLrEl+k/nA: mucks hand
3Wro85I7472vJ4Wkpneo9A collected $102.20 from pot
*** SUMMARY ***
Total pot $102.70 | Rake $0.50
Board [3s 9h 2d 6d 8s]
Seat 1: FRkiRasEGlHUeLrEl+k/nA (button) (small blind) mucked
Seat 2: 3Wro85I7472vJ4Wkpneo9A (big blind) showed [3d 3c] and won ($102.20) with three of a kind, Threes



PokerStars Game #59938440162:  Hold'em No Limit ($0.25/$0.50) - 2009/07/01 0:15:01 ET
Table 'raOT4/ipuZgzjfKHC+jD9g' 2-max Seat #1 is the button
Seat 1: IuwLemwLhc9fvrwBGs0AMA ($13.60 in chips)
Seat 2: Udr5juWSWUgTu1NlRhjMdA ($9.25 in chips)
IuwLemwLhc9fvrwBGs0AMA: posts small blind $0.25
Udr5juWSWUgTu1NlRhjMdA: posts big blind $0.50
*** HOLE CARDS ***
IuwLemwLhc9fvrwBGs0AMA: raises $0.50 to $1
Udr5juWSWUgTu1NlRhjMdA: calls $0.50
*** FLOP *** [7h Ks 5h]
Udr5juWSWUgTu1NlRhjMdA: checks
IuwLemwLhc9fvrwBGs0AMA: checks
*** TURN *** [7h Ks 5h] [9h]
Udr5juWSWUgTu1NlRhjMdA: checks
IuwLemwLhc9fvrwBGs0AMA: checks
*** RIVER *** [7h Ks 5h 9h] [6c]
Udr5juWSWUgTu1NlRhjMdA: checks
IuwLemwLhc9fvrwBGs0AMA: checks
*** SHOW DOWN ***
Udr5juWSWUgTu1NlRhjMdA: shows [Jh 5c] (a pair of Fives)
IuwLemwLhc9fvrwBGs0AMA: mucks hand
Udr5juWSWUgTu1NlRhjMdA collected $1.90 from pot
*** SUMMARY ***
Total pot $2 | Rake $0.10
Board [7h Ks 5h 9h 6c]
Seat 1: IuwLemwLhc9fvrwBGs0AMA (button) (small blind) mucked
Seat 2: Udr5juWSWUgTu1NlRhjMdA (big blind) showed [Jh 5c] and won ($1.90) with a pair of Fives



PokerStars Game #59938439818:  Hold'em No Limit ($0.25/$0.50) - 2009/07/01 0:15:01 ET
Table 'ibNfFy0bCzuBaUORla0aGw' 9-max Seat #2 is the button
Seat 1: xZCXQSXlrZkp3pZizzVXCw ($55.45 in chips)
Seat 2: 90Wb75h3W1BRpbqVnuk8gw ($51.80 in chips)
Seat 3: dDaHs3X8+fe3bIkRU0cbrw ($26.05 in chips)
Seat 4: YBN054X4blmis+B2bBlC0g ($21.05 in chips)
Seat 5: FRv75HO8CUsRZ1byEz06mQ ($13.35 in chips)
Seat 6: BmYrv3ec2k5d6pQq6iNaZw ($67.85 in chips)
Seat 7: mSD1pginDsyHG5PDfqzphw ($15.50 in chips)
Seat 8: xUrN9TWLq4m5V+OXY7KUUA ($50 in chips)
Seat 9: WpvT3OUSiZlpvs+mPXFqtQ ($8 in chips)
dDaHs3X8+fe3bIkRU0cbrw: posts small blind $0.25
YBN054X4blmis+B2bBlC0g: posts big blind $0.50
*** HOLE CARDS ***
FRv75HO8CUsRZ1byEz06mQ: folds
BmYrv3ec2k5d6pQq6iNaZw: folds
mSD1pginDsyHG5PDfqzphw: folds
xUrN9TWLq4m5V+OXY7KUUA: folds
WpvT3OUSiZlpvs+mPXFqtQ: folds
xZCXQSXlrZkp3pZizzVXCw: folds
90Wb75h3W1BRpbqVnuk8gw: folds
dDaHs3X8+fe3bIkRU0cbrw: calls $0.25
YBN054X4blmis+B2bBlC0g: checks
*** FLOP *** [9h Kc As]
dDaHs3X8+fe3bIkRU0cbrw: checks
YBN054X4blmis+B2bBlC0g: checks
*** TURN *** [9h Kc As] [4c]
dDaHs3X8+fe3bIkRU0cbrw: checks
YBN054X4blmis+B2bBlC0g: checks
*** RIVER *** [9h Kc As 4c] [7d]
dDaHs3X8+fe3bIkRU0cbrw: checks
YBN054X4blmis+B2bBlC0g: checks
*** SHOW DOWN ***
dDaHs3X8+fe3bIkRU0cbrw: shows [Js 6d] (high card Ace)
YBN054X4blmis+B2bBlC0g: mucks hand
dDaHs3X8+fe3bIkRU0cbrw collected $0.95 from pot
*** SUMMARY ***
Total pot $1 | Rake $0.05
Board [9h Kc As 4c 7d]
Seat 1: xZCXQSXlrZkp3pZizzVXCw folded before Flop (didn't bet)
Seat 2: 90Wb75h3W1BRpbqVnuk8gw (button) folded before Flop (didn't bet)
Seat 3: dDaHs3X8+fe3bIkRU0cbrw (small blind) showed [Js 6d] and won ($0.95) with high card Ace
Seat 4: YBN054X4blmis+B2bBlC0g (big blind) mucked
Seat 5: FRv75HO8CUsRZ1byEz06mQ folded before Flop (didn't bet)
Seat 6: BmYrv3ec2k5d6pQq6iNaZw folded before Flop (didn't bet)
Seat 7: mSD1pginDsyHG5PDfqzphw folded before Flop (didn't bet)
Seat 8: xUrN9TWLq4m5V+OXY7KUUA folded before Flop (didn't bet)
Seat 9: WpvT3OUSiZlpvs+mPXFqtQ folded before Flop (didn't bet)



PokerStars Game #59938440148:  Hold'em No Limit ($0.25/$0.50) - 2009/07/01 0:15:01 ET
Table 'kgbJRsxfv64KrErDRBAkcw' 6-max Seat #3 is the button
Seat 2: Q+thC23WCv1kJUJtH/+4Jw ($30.45 in chips)
Seat 3: T0Gx/FcQ5VH9u7XaOMX97A ($61 in chips)
Seat 4: qanMEqjABjWxC/JgQ/0l7w ($62.20 in chips)
Seat 5: +Pf9jTVizYlIo+woPvptfA ($50 in chips)
Seat 6: DDfYzIrYT0t5R/hAJngtsg ($25.45 in chips)
qanMEqjABjWxC/JgQ/0l7w: posts small blind $0.25
+Pf9jTVizYlIo+woPvptfA: posts big blind $0.50
*** HOLE CARDS ***
DDfYzIrYT0t5R/hAJngtsg: calls $0.50
Q+thC23WCv1kJUJtH/+4Jw: raises $1.50 to $2
T0Gx/FcQ5VH9u7XaOMX97A: folds
N7O9jUEx2YiQn1+yRYTHmw joins the table at seat #1
qanMEqjABjWxC/JgQ/0l7w: folds
+Pf9jTVizYlIo+woPvptfA: folds
DDfYzIrYT0t5R/hAJngtsg: calls $1.50
*** FLOP *** [4h Kh Ad]
DDfYzIrYT0t5R/hAJngtsg: checks
Q+thC23WCv1kJUJtH/+4Jw: bets $3
DDfYzIrYT0t5R/hAJngtsg: folds
Q+thC23WCv1kJUJtH/+4Jw collected $4.55 from pot
*** SUMMARY ***
Total pot $4.75 | Rake $0.20
Board [4h Kh Ad]
Seat 2: Q+thC23WCv1kJUJtH/+4Jw collected ($4.55)
Seat 3: T0Gx/FcQ5VH9u7XaOMX97A (button) folded before Flop (didn't bet)
Seat 4: qanMEqjABjWxC/JgQ/0l7w (small blind) folded before Flop
Seat 5: +Pf9jTVizYlIo+woPvptfA (big blind) folded before Flop
Seat 6: DDfYzIrYT0t5R/hAJngtsg folded on the Flop



PokerStars Game #59938440922:  Hold'em No Limit ($0.25/$0.50) - 2009/07/01 0:15:02 ET
Table 'm95HVfesC/VPgfGEjPuaIA' 2-max Seat #1 is the button
Seat 1: Fp/oksNpipCrD2MJ2pH20g ($17.80 in chips)
Seat 2: Ag6DvxX4vbRheqsv2zXKTQ ($27.10 in chips)
Fp/oksNpipCrD2MJ2pH20g: posts small blind $0.25
Ag6DvxX4vbRheqsv2zXKTQ: posts big blind $0.50
*** HOLE CARDS ***
Fp/oksNpipCrD2MJ2pH20g: raises $1.50 to $2
Ag6DvxX4vbRheqsv2zXKTQ: folds
Fp/oksNpipCrD2MJ2pH20g collected $1 from pot
Fp/oksNpipCrD2MJ2pH20g: doesn't show hand
*** SUMMARY ***
Total pot $1 | Rake $0
Seat 1: Fp/oksNpipCrD2MJ2pH20g (button) (small blind) collected ($1)
Seat 2: Ag6DvxX4vbRheqsv2zXKTQ (big blind) folded before Flop



PokerStars Game #59938441362:  Hold'em No Limit ($0.25/$0.50) - 2009/07/01 0:15:03 ET
Table '+dXkOAQyS8j9PQZusUTMpg' 2-max Seat #1 is the button
Seat 1: XFa6sBGjP2gxoIvxR3fZIg ($91.45 in chips)
Seat 2: 5IBeOgaApY1Bvzv2P8X4EA ($20.05 in chips)
XFa6sBGjP2gxoIvxR3fZIg: posts small blind $0.25
5IBeOgaApY1Bvzv2P8X4EA: posts big blind $0.50
*** HOLE CARDS ***
XFa6sBGjP2gxoIvxR3fZIg: raises $1 to $1.50
5IBeOgaApY1Bvzv2P8X4EA: folds
XFa6sBGjP2gxoIvxR3fZIg collected $1 from pot
XFa6sBGjP2gxoIvxR3fZIg: doesn't show hand
*** SUMMARY ***
Total pot $1 | Rake $0
Seat 1: XFa6sBGjP2gxoIvxR3fZIg (button) (small blind) collected ($1)
Seat 2: 5IBeOgaApY1Bvzv2P8X4EA (big blind) folded before Flop



PokerStars Game #59938441432:  Hold'em No Limit ($0.25/$0.50) - 2009/07/01 0:15:03 ET
Table 'QOgaEqMcJ73pcUMMxoisUg' 6-max Seat #2 is the button
Seat 1: RFefXIDyFvNtJLq+CloCzA ($41.70 in chips)
Seat 2: Im2p1Nt83UKSqv5c9frm4Q ($50 in chips)
Seat 3: wUZNozoIDYf+16hp4nn6dw ($44.75 in chips)
Seat 4: zAcsDhG/T128Vn7XGVSgKg ($54.20 in chips)
Seat 6: s83dnhZ6VC53vY0/f6OV/g ($48.50 in chips)
wUZNozoIDYf+16hp4nn6dw: posts small blind $0.25
zAcsDhG/T128Vn7XGVSgKg: posts big blind $0.50
*** HOLE CARDS ***
s83dnhZ6VC53vY0/f6OV/g: folds
RFefXIDyFvNtJLq+CloCzA: folds
Im2p1Nt83UKSqv5c9frm4Q: folds
wUZNozoIDYf+16hp4nn6dw: calls $0.25
zAcsDhG/T128Vn7XGVSgKg: checks
*** FLOP *** [Ad Kd 6c]
wUZNozoIDYf+16hp4nn6dw: checks
zAcsDhG/T128Vn7XGVSgKg: bets $1
wUZNozoIDYf+16hp4nn6dw: folds
zAcsDhG/T128Vn7XGVSgKg collected $0.95 from pot
*** SUMMARY ***
Total pot $1 | Rake $0.05
Board [Ad Kd 6c]
Seat 1: RFefXIDyFvNtJLq+CloCzA folded before Flop (didn't bet)
Seat 2: Im2p1Nt83UKSqv5c9frm4Q (button) folded before Flop (didn't bet)
Seat 3: wUZNozoIDYf+16hp4nn6dw (small blind) folded on the Flop
Seat 4: zAcsDhG/T128Vn7XGVSgKg (big blind) collected ($0.95)
Seat 6: s83dnhZ6VC53vY0/f6OV/g folded before Flop (didn't bet)



PokerStars Game #59938441580:  Hold'em No Limit ($0.25/$0.50) - 2009/07/01 0:15:03 ET
Table 'PALRfuH85dr5IkDfdv6new' 9-max Seat #9 is the button
Seat 1: SKnJuWHScqetA/qG5p+wCg ($32.50 in chips)
Seat 2: 9r7ZoBbAJj5IeyZ0q9BdzA ($13.90 in chips)
Seat 3: 50QWoELmpmHFrFIlWMJo9g ($94.20 in chips)
Seat 4: /gaxz7F0MIjSN3t7ZPKwAA ($29.10 in chips)
Seat 5: jSSGUXdNFAZA3QCvTcUMQw ($43 in chips)
Seat 6: EiWj2MAl8RNcPhTkzz24Mw ($34.85 in chips)
Seat 7: 3NcyXvr39gnK+KbTq7ezyA ($35.25 in chips)
Seat 8: NkS+CseUKx4XHszWq0PXEQ ($42.35 in chips)
Seat 9: CIrAX/m6o7jYmKOAjJXv4Q ($38.35 in chips)
SKnJuWHScqetA/qG5p+wCg: posts small blind $0.25
9r7ZoBbAJj5IeyZ0q9BdzA: posts big blind $0.50
*** HOLE CARDS ***
50QWoELmpmHFrFIlWMJo9g: raises $1 to $1.50
/gaxz7F0MIjSN3t7ZPKwAA: raises $1.50 to $3
jSSGUXdNFAZA3QCvTcUMQw: folds
EiWj2MAl8RNcPhTkzz24Mw: folds
3NcyXvr39gnK+KbTq7ezyA: folds
NkS+CseUKx4XHszWq0PXEQ: folds
CIrAX/m6o7jYmKOAjJXv4Q: folds
SKnJuWHScqetA/qG5p+wCg: folds
9r7ZoBbAJj5IeyZ0q9BdzA: folds
50QWoELmpmHFrFIlWMJo9g: calls $1.50
*** FLOP *** [9s 4c Ah]
50QWoELmpmHFrFIlWMJo9g: checks
/gaxz7F0MIjSN3t7ZPKwAA: bets $3
50QWoELmpmHFrFIlWMJo9g: folds
/gaxz7F0MIjSN3t7ZPKwAA collected $6.45 from pot
*** SUMMARY ***
Total pot $6.75 | Rake $0.30
Board [9s 4c Ah]
Seat 1: SKnJuWHScqetA/qG5p+wCg (small blind) folded before Flop
Seat 2: 9r7ZoBbAJj5IeyZ0q9BdzA (big blind) folded before Flop
Seat 3: 50QWoELmpmHFrFIlWMJo9g folded on the Flop
Seat 4: /gaxz7F0MIjSN3t7ZPKwAA collected ($6.45)
Seat 5: jSSGUXdNFAZA3QCvTcUMQw folded before Flop (didn't bet)
Seat 6: EiWj2MAl8RNcPhTkzz24Mw folded before Flop (didn't bet)
Seat 7: 3NcyXvr39gnK+KbTq7ezyA folded before Flop (didn't bet)
Seat 8: NkS+CseUKx4XHszWq0PXEQ folded before Flop (didn't bet)
Seat 9: CIrAX/m6o7jYmKOAjJXv4Q (button) folded before Flop (didn't bet)



PokerStars Game #59938442354:  Hold'em No Limit ($0.25/$0.50) - 2009/07/01 0:15:04 ET
Table '37qXEp3oe+er5q4CZip9eQ' 6-max Seat #3 is the button
Seat 1: oqOqoO2AyCZenUghCxMDxw ($50 in chips)
Seat 2: g12O9qXTybyo2C0B2bXgjg ($28.90 in chips)
Seat 3: Rt6KgtZ8YaJoTc3FPim00w ($99.45 in chips)
Seat 5: VOmI0x4dDPnTESZd5B4d1Q ($41.30 in chips)
Seat 6: f7zPpUQp9hHZgqhEvrUWQw ($53.65 in chips)
AYb7QG0KzyicbOC0ZROE3Q will be allowed to play after the button
VOmI0x4dDPnTESZd5B4d1Q: posts small blind $0.25
f7zPpUQp9hHZgqhEvrUWQw: posts big blind $0.50
*** HOLE CARDS ***
oqOqoO2AyCZenUghCxMDxw: folds
g12O9qXTybyo2C0B2bXgjg: raises $1 to $1.50
Rt6KgtZ8YaJoTc3FPim00w: folds
VOmI0x4dDPnTESZd5B4d1Q: folds
f7zPpUQp9hHZgqhEvrUWQw: folds
g12O9qXTybyo2C0B2bXgjg collected $1.25 from pot
*** SUMMARY ***
Total pot $1.25 | Rake $0
Seat 1: oqOqoO2AyCZenUghCxMDxw folded before Flop (didn't bet)
Seat 2: g12O9qXTybyo2C0B2bXgjg collected ($1.25)
Seat 3: Rt6KgtZ8YaJoTc3FPim00w (button) folded before Flop (didn't bet)
Seat 5: VOmI0x4dDPnTESZd5B4d1Q (small blind) folded before Flop
Seat 6: f7zPpUQp9hHZgqhEvrUWQw (big blind) folded before Flop



PokerStars Game #59938442552:  Hold'em No Limit ($0.25/$0.50) - 2009/07/01 0:15:05 ET
Table 'eMxdLyFDf28E0wit6gm3Uw' 6-max Seat #5 is the button
Seat 1: tnD/64LagZ9qPaeOQVjVZg ($11.95 in chips)
Seat 2: jwuKQ1S3U4NnzMQn3E3dgw ($68.50 in chips)
Seat 3: dZcLsEI8iXkobBduRJ45Yw ($17 in chips)
Seat 5: X0X97o2fDAPiGx6o1gahsw ($55.55 in chips)
Seat 6: L0aIPg7qefDQjdJo3HCVEA ($9.50 in chips)
L0aIPg7qefDQjdJo3HCVEA: posts small blind $0.25
tnD/64LagZ9qPaeOQVjVZg: posts big blind $0.50
*** HOLE CARDS ***
jwuKQ1S3U4NnzMQn3E3dgw: calls $0.50
dZcLsEI8iXkobBduRJ45Yw: folds
X0X97o2fDAPiGx6o1gahsw: folds
L0aIPg7qefDQjdJo3HCVEA: folds
tnD/64LagZ9qPaeOQVjVZg: checks
*** FLOP *** [Qs 7s 6c]
tnD/64LagZ9qPaeOQVjVZg: checks
jwuKQ1S3U4NnzMQn3E3dgw: bets $2.50
tnD/64LagZ9qPaeOQVjVZg: folds
jwuKQ1S3U4NnzMQn3E3dgw collected $1.20 from pot
*** SUMMARY ***
Total pot $1.25 | Rake $0.05
Board [Qs 7s 6c]
Seat 1: tnD/64LagZ9qPaeOQVjVZg (big blind) folded on the Flop
Seat 2: jwuKQ1S3U4NnzMQn3E3dgw collected ($1.20)
Seat 3: dZcLsEI8iXkobBduRJ45Yw folded before Flop (didn't bet)
Seat 5: X0X97o2fDAPiGx6o1gahsw (button) folded before Flop (didn't bet)
Seat 6: L0aIPg7qefDQjdJo3HCVEA (small blind) folded before Flop



PokerStars Game #59938445054:  Hold'em No Limit ($0.25/$0.50) - 2009/07/01 0:15:08 ET
Table 'ZYwMb9E6tY50Qm+iNbXRYw' 2-max Seat #1 is the button
Seat 1: DXLfRb8KDZWmrztw2bwtFw ($21.70 in chips)
Seat 2: 16tvT7AYgZ2LgiGFcvFKQg ($15 in chips)
DXLfRb8KDZWmrztw2bwtFw: posts small blind $0.25
16tvT7AYgZ2LgiGFcvFKQg: posts big blind $0.50
*** HOLE CARDS ***
DXLfRb8KDZWmrztw2bwtFw said, "you are one big fisher"
DXLfRb8KDZWmrztw2bwtFw: calls $0.25
16tvT7AYgZ2LgiGFcvFKQg: checks
*** FLOP *** [Ac 6d Qs]
16tvT7AYgZ2LgiGFcvFKQg: checks
DXLfRb8KDZWmrztw2bwtFw: checks
*** TURN *** [Ac 6d Qs] [4d]
16tvT7AYgZ2LgiGFcvFKQg said, "And what are you"
16tvT7AYgZ2LgiGFcvFKQg: bets $0.50
DXLfRb8KDZWmrztw2bwtFw: calls $0.50
*** RIVER *** [Ac 6d Qs 4d] [4h]
16tvT7AYgZ2LgiGFcvFKQg: bets $0.50
DXLfRb8KDZWmrztw2bwtFw: folds
16tvT7AYgZ2LgiGFcvFKQg collected $1.95 from pot
16tvT7AYgZ2LgiGFcvFKQg: doesn't show hand
*** SUMMARY ***
Total pot $2 | Rake $0.05
Board [Ac 6d Qs 4d 4h]
Seat 1: DXLfRb8KDZWmrztw2bwtFw (button) (small blind) folded on the River
Seat 2: 16tvT7AYgZ2LgiGFcvFKQg (big blind) collected ($1.95)



PokerStars Game #59938446730:  Hold'em No Limit ($0.25/$0.50) - 2009/07/01 0:15:11 ET
Table 'm95HVfesC/VPgfGEjPuaIA' 2-max Seat #2 is the button
Seat 1: Fp/oksNpipCrD2MJ2pH20g ($18.30 in chips)
Seat 2: Ag6DvxX4vbRheqsv2zXKTQ ($26.60 in chips)
Ag6DvxX4vbRheqsv2zXKTQ: posts small blind $0.25
Fp/oksNpipCrD2MJ2pH20g: posts big blind $0.50
*** HOLE CARDS ***
Ag6DvxX4vbRheqsv2zXKTQ: calls $0.25
Fp/oksNpipCrD2MJ2pH20g: checks
*** FLOP *** [3h Qs 8c]
Fp/oksNpipCrD2MJ2pH20g: bets $0.50
Ag6DvxX4vbRheqsv2zXKTQ: calls $0.50
*** TURN *** [3h Qs 8c] [4d]
Fp/oksNpipCrD2MJ2pH20g: checks
Ag6DvxX4vbRheqsv2zXKTQ: checks
*** RIVER *** [3h Qs 8c 4d] [2c]
Fp/oksNpipCrD2MJ2pH20g: bets $0.50
Ag6DvxX4vbRheqsv2zXKTQ: folds
Fp/oksNpipCrD2MJ2pH20g collected $1.95 from pot
Fp/oksNpipCrD2MJ2pH20g: doesn't show hand
*** SUMMARY ***
Total pot $2 | Rake $0.05
Board [3h Qs 8c 4d 2c]
Seat 1: Fp/oksNpipCrD2MJ2pH20g (big blind) collected ($1.95)
Seat 2: Ag6DvxX4vbRheqsv2zXKTQ (button) (small blind) folded on the River



PokerStars Game #59938446582:  Hold'em No Limit ($0.25/$0.50) - 2009/07/01 0:15:11 ET
Table '+dXkOAQyS8j9PQZusUTMpg' 2-max Seat #2 is the button
Seat 1: XFa6sBGjP2gxoIvxR3fZIg ($91.95 in chips)
Seat 2: 5IBeOgaApY1Bvzv2P8X4EA ($19.55 in chips)
5IBeOgaApY1Bvzv2P8X4EA: posts small blind $0.25
XFa6sBGjP2gxoIvxR3fZIg: posts big blind $0.50
*** HOLE CARDS ***
5IBeOgaApY1Bvzv2P8X4EA: calls $0.25
XFa6sBGjP2gxoIvxR3fZIg: raises $2 to $2.50
5IBeOgaApY1Bvzv2P8X4EA: raises $3 to $5.50
XFa6sBGjP2gxoIvxR3fZIg: raises $86.45 to $91.95 and is all-in
5IBeOgaApY1Bvzv2P8X4EA: calls $14.05 and is all-in
*** FLOP *** [2c Qd 9h]
*** TURN *** [2c Qd 9h] [Jc]
*** RIVER *** [2c Qd 9h Jc] [Js]
*** SHOW DOWN ***
XFa6sBGjP2gxoIvxR3fZIg: shows [Ac Tc] (a pair of Jacks)
5IBeOgaApY1Bvzv2P8X4EA: shows [Kd Qs] (two pair, Queens and Jacks)
5IBeOgaApY1Bvzv2P8X4EA collected $38.60 from pot
*** SUMMARY ***
Total pot $39.10 | Rake $0.50
Board [2c Qd 9h Jc Js]
Seat 1: XFa6sBGjP2gxoIvxR3fZIg (big blind) showed [Ac Tc] and lost with a pair of Jacks
Seat 2: 5IBeOgaApY1Bvzv2P8X4EA (button) (small blind) showed [Kd Qs] and won ($38.60) with two pair, Queens and Jacks



PokerStars Game #59938447250:  Hold'em No Limit ($0.25/$0.50) - 2009/07/01 0:15:12 ET
Table 'hSTs/dUsYLgJQuF2Onp0MQ' 6-max Seat #3 is the button
Seat 1: lWwl5C/UZOsWNubdUqghZw ($70.70 in chips)
Seat 2: gSCZnZGMgaRWmRw5txyZIA ($14.15 in chips)
Seat 3: vQOrJuXbLC3UZDVklY9bOA ($19.95 in chips)
Seat 4: L0aIPg7qefDQjdJo3HCVEA ($13.95 in chips)
Seat 5: 686aeHikcJlgKkSuIFdcXQ ($59.90 in chips)
Seat 6: +laPa9P7BjZKKnR0n+OmvA ($4.15 in chips)
L0aIPg7qefDQjdJo3HCVEA: posts small blind $0.25
686aeHikcJlgKkSuIFdcXQ: posts big blind $0.50
gSCZnZGMgaRWmRw5txyZIA: posts big blind $0.50
*** HOLE CARDS ***
+laPa9P7BjZKKnR0n+OmvA: raises $0.50 to $1
lWwl5C/UZOsWNubdUqghZw: raises $3.25 to $4.25
gSCZnZGMgaRWmRw5txyZIA: folds
vQOrJuXbLC3UZDVklY9bOA: folds
L0aIPg7qefDQjdJo3HCVEA: folds
686aeHikcJlgKkSuIFdcXQ: folds
+laPa9P7BjZKKnR0n+OmvA: calls $3.15 and is all-in
*** FLOP *** [7d Kd 4c]
*** TURN *** [7d Kd 4c] [9h]
*** RIVER *** [7d Kd 4c 9h] [8c]
*** SHOW DOWN ***
+laPa9P7BjZKKnR0n+OmvA: shows [Ac Ad] (a pair of Aces)
lWwl5C/UZOsWNubdUqghZw: mucks hand
+laPa9P7BjZKKnR0n+OmvA collected $9.10 from pot
+laPa9P7BjZKKnR0n+OmvA is sitting out
*** SUMMARY ***
Total pot $9.55 | Rake $0.45
Board [7d Kd 4c 9h 8c]
Seat 1: lWwl5C/UZOsWNubdUqghZw mucked
Seat 2: gSCZnZGMgaRWmRw5txyZIA folded before Flop
Seat 3: vQOrJuXbLC3UZDVklY9bOA (button) folded before Flop (didn't bet)
Seat 4: L0aIPg7qefDQjdJo3HCVEA (small blind) folded before Flop
Seat 5: 686aeHikcJlgKkSuIFdcXQ (big blind) folded before Flop
Seat 6: +laPa9P7BjZKKnR0n+OmvA showed [Ac Ad] and won ($9.10) with a pair of Aces



PokerStars Game #59938448522:  Hold'em No Limit ($0.25/$0.50) - 2009/07/01 0:15:13 ET
Table 'Nz0Vr7WMHL2g5Uk7dDZjpw' 9-max Seat #9 is the button
Seat 1: tLkxo7JgV+WWI0UBw44K5A ($100.85 in chips)
Seat 3: 4QTiNH5fteLgJjx/s6Hy6A ($6.90 in chips)
Seat 4: 5JJVDlaiMnB004o/RqbZZQ ($28.25 in chips)
Seat 5: WGW0DgjBUXs1ylURHG8vnQ ($18.10 in chips)
Seat 6: k1f0lS7tlMHCLGs0JT34Tg ($8 in chips)
Seat 7: KPLH0gELgFe2OuAnhJFI5w ($21.45 in chips)
Seat 8: HkZI6g4zl83TDTA7SRspmQ ($16.50 in chips)
Seat 9: Ak2W6V2TDVIQrvSAy4eD7Q ($28.05 in chips)
tLkxo7JgV+WWI0UBw44K5A: posts small blind $0.25
4QTiNH5fteLgJjx/s6Hy6A: posts big blind $0.50
*** HOLE CARDS ***
YPo1oggovmqSREegekaQYw leaves the table
5JJVDlaiMnB004o/RqbZZQ: folds
XNMDwbXt/Q4jM99AXnbJDw joins the table at seat #2
WGW0DgjBUXs1ylURHG8vnQ: folds
k1f0lS7tlMHCLGs0JT34Tg: calls $0.50
KPLH0gELgFe2OuAnhJFI5w: folds
HkZI6g4zl83TDTA7SRspmQ: calls $0.50
Ak2W6V2TDVIQrvSAy4eD7Q: calls $0.50
tLkxo7JgV+WWI0UBw44K5A: calls $0.25
4QTiNH5fteLgJjx/s6Hy6A: checks
*** FLOP *** [3c 3h Qs]
tLkxo7JgV+WWI0UBw44K5A: bets $1.50
4QTiNH5fteLgJjx/s6Hy6A: folds
k1f0lS7tlMHCLGs0JT34Tg: folds
HkZI6g4zl83TDTA7SRspmQ: folds
Ak2W6V2TDVIQrvSAy4eD7Q: folds
tLkxo7JgV+WWI0UBw44K5A collected $2.40 from pot
*** SUMMARY ***
Total pot $2.50 | Rake $0.10
Board [3c 3h Qs]
Seat 1: tLkxo7JgV+WWI0UBw44K5A (small blind) collected ($2.40)
Seat 3: 4QTiNH5fteLgJjx/s6Hy6A (big blind) folded on the Flop
Seat 4: 5JJVDlaiMnB004o/RqbZZQ folded before Flop (didn't bet)
Seat 5: WGW0DgjBUXs1ylURHG8vnQ folded before Flop (didn't bet)
Seat 6: k1f0lS7tlMHCLGs0JT34Tg folded on the Flop
Seat 7: KPLH0gELgFe2OuAnhJFI5w folded before Flop (didn't bet)
Seat 8: HkZI6g4zl83TDTA7SRspmQ folded on the Flop
Seat 9: Ak2W6V2TDVIQrvSAy4eD7Q (button) folded on the Flop



PokerStars Game #59938448758:  Hold'em No Limit ($0.25/$0.50) - 2009/07/01 0:15:14 ET
Table 'c/CRn+68J3Y8KxD5g1ek2Q' 2-max Seat #1 is the button
Seat 1: 46qCyJ6evTkHo9al5sBMNA ($293.05 in chips)
Seat 2: BypVLsYQt3ePFm2xQL/dOA ($91 in chips)
46qCyJ6evTkHo9al5sBMNA: posts small blind $0.25
BypVLsYQt3ePFm2xQL/dOA: posts big blind $0.50
*** HOLE CARDS ***
46qCyJ6evTkHo9al5sBMNA: raises $1 to $1.50
BypVLsYQt3ePFm2xQL/dOA: folds
46qCyJ6evTkHo9al5sBMNA collected $1 from pot
*** SUMMARY ***
Total pot $1 | Rake $0
Seat 1: 46qCyJ6evTkHo9al5sBMNA (button) (small blind) collected ($1)
Seat 2: BypVLsYQt3ePFm2xQL/dOA (big blind) folded before Flop



PokerStars Game #59938450750:  Hold'em No Limit ($0.25/$0.50) - 2009/07/01 0:15:17 ET
Table 'mTxf8gPLgffN3Iwfm7Icfg' 2-max Seat #1 is the button
Seat 1: Do9Rlu1R5u/AcRtMTl8SYg ($59.65 in chips)
Seat 2: EMc5LPgVaded4Qc77vm0fw ($52.90 in chips)
Do9Rlu1R5u/AcRtMTl8SYg: posts small blind $0.25
EMc5LPgVaded4Qc77vm0fw: posts big blind $0.50
*** HOLE CARDS ***
Do9Rlu1R5u/AcRtMTl8SYg: folds
EMc5LPgVaded4Qc77vm0fw collected $0.50 from pot
EMc5LPgVaded4Qc77vm0fw: doesn't show hand
*** SUMMARY ***
Total pot $0.50 | Rake $0
Seat 1: Do9Rlu1R5u/AcRtMTl8SYg (button) (small blind) folded before Flop
Seat 2: EMc5LPgVaded4Qc77vm0fw (big blind) collected ($0.50)



PokerStars Game #59938451668:  Hold'em No Limit ($0.25/$0.50) - 2009/07/01 0:15:18 ET
Table '5EmHi+fnatGQQShcNmzOZQ' 6-max Seat #6 is the button
Seat 1: SwPczQo3cOtwEzhJrfO2cQ ($27.95 in chips)
Seat 2: APwvTk5XojDXGoQLb4O5iA ($29 in chips)
Seat 5: kxPhs4ePFqMy52CInAJ2aw ($68.55 in chips)
Seat 6: 686aeHikcJlgKkSuIFdcXQ ($131.35 in chips)
SwPczQo3cOtwEzhJrfO2cQ: posts small blind $0.25
APwvTk5XojDXGoQLb4O5iA: posts big blind $0.50
wOyVV9M/oyiw3YaOjNZ05w: sits out
*** HOLE CARDS ***
J8dF2sYMvXUmAGUuSW9kwg leaves the table
kxPhs4ePFqMy52CInAJ2aw: raises $1.50 to $2
686aeHikcJlgKkSuIFdcXQ: folds
SwPczQo3cOtwEzhJrfO2cQ: folds
APwvTk5XojDXGoQLb4O5iA: folds
kxPhs4ePFqMy52CInAJ2aw collected $1.25 from pot
kxPhs4ePFqMy52CInAJ2aw: doesn't show hand
*** SUMMARY ***
Total pot $1.25 | Rake $0
Seat 1: SwPczQo3cOtwEzhJrfO2cQ (small blind) folded before Flop
Seat 2: APwvTk5XojDXGoQLb4O5iA (big blind) folded before Flop
Seat 5: kxPhs4ePFqMy52CInAJ2aw collected ($1.25)
Seat 6: 686aeHikcJlgKkSuIFdcXQ (button) folded before Flop (didn't bet)



PokerStars Game #59938452936:  Hold'em No Limit ($0.25/$0.50) - 2009/07/01 0:15:20 ET
Table '3FhG0gl3kMX3wBEEqj+wnQ' 9-max Seat #2 is the button
Seat 1: e0J9pdCNUDTCG031RnXqLA ($22.20 in chips)
Seat 2: 4dl3YNqZ6Houm2jZAzDmRg ($24.50 in chips)
Seat 4: bz4LMfV0GGl/MJ/ABXuPmg ($26.70 in chips)
Seat 5: XNMDwbXt/Q4jM99AXnbJDw ($50 in chips)
Seat 6: 5JJVDlaiMnB004o/RqbZZQ ($26 in chips)
Seat 8: j3K/Jujr7PY4ZM2RZvlH6A ($44.20 in chips)
Seat 9: tzoXBDwkkPV/XPJPkf963Q ($17 in chips)
dennisa will be allowed to play after the button
bz4LMfV0GGl/MJ/ABXuPmg: posts small blind $0.25
XNMDwbXt/Q4jM99AXnbJDw: posts big blind $0.50
mSD1pginDsyHG5PDfqzphw: sits out
*** HOLE CARDS ***
5JJVDlaiMnB004o/RqbZZQ: folds
j3K/Jujr7PY4ZM2RZvlH6A: folds
tzoXBDwkkPV/XPJPkf963Q: calls $0.50
e0J9pdCNUDTCG031RnXqLA: folds
4dl3YNqZ6Houm2jZAzDmRg: folds
bz4LMfV0GGl/MJ/ABXuPmg: calls $0.25
XNMDwbXt/Q4jM99AXnbJDw: raises $2 to $2.50
tzoXBDwkkPV/XPJPkf963Q: folds
bz4LMfV0GGl/MJ/ABXuPmg: folds
XNMDwbXt/Q4jM99AXnbJDw collected $1.50 from pot
XNMDwbXt/Q4jM99AXnbJDw: doesn't show hand
*** SUMMARY ***
Total pot $1.50 | Rake $0
Seat 1: e0J9pdCNUDTCG031RnXqLA folded before Flop (didn't bet)
Seat 2: 4dl3YNqZ6Houm2jZAzDmRg (button) folded before Flop (didn't bet)
Seat 4: bz4LMfV0GGl/MJ/ABXuPmg (small blind) folded before Flop
Seat 5: XNMDwbXt/Q4jM99AXnbJDw (big blind) collected ($1.50)
Seat 6: 5JJVDlaiMnB004o/RqbZZQ folded before Flop (didn't bet)
Seat 8: j3K/Jujr7PY4ZM2RZvlH6A folded before Flop (didn't bet)
Seat 9: tzoXBDwkkPV/XPJPkf963Q folded before Flop



PokerStars Game #59938455126:  Hold'em No Limit ($0.25/$0.50) - 2009/07/01 0:15:23 ET
Table 'mTxf8gPLgffN3Iwfm7Icfg' 2-max Seat #2 is the button
Seat 1: Do9Rlu1R5u/AcRtMTl8SYg ($59.40 in chips)
Seat 2: EMc5LPgVaded4Qc77vm0fw ($53.15 in chips)
EMc5LPgVaded4Qc77vm0fw: posts small blind $0.25
Do9Rlu1R5u/AcRtMTl8SYg: posts big blind $0.50
*** HOLE CARDS ***
EMc5LPgVaded4Qc77vm0fw: folds
Do9Rlu1R5u/AcRtMTl8SYg collected $0.50 from pot
Do9Rlu1R5u/AcRtMTl8SYg: doesn't show hand
*** SUMMARY ***
Total pot $0.50 | Rake $0
Seat 1: Do9Rlu1R5u/AcRtMTl8SYg (big blind) collected ($0.50)
Seat 2: EMc5LPgVaded4Qc77vm0fw (button) (small blind) folded before Flop



PokerStars Game #59938455692:  Hold'em No Limit ($0.25/$0.50) - 2009/07/01 0:15:24 ET
Table 'X6IRCRTh+20gjz8aubWnwA' 9-max Seat #9 is the button
Seat 1: DSM67hHHq1XFoEOi9p8Alw ($51.40 in chips)
Seat 2: RjBdQ6w31rgcy0o24VLR6w ($11.65 in chips)
Seat 3: mSD1pginDsyHG5PDfqzphw ($10 in chips)
Seat 4: uw9QayAAxLM3Hb+HR7mSkg ($10.25 in chips)
Seat 5: L5e2lrPLQm1Pqx30IIZ/Fw ($12.85 in chips)
Seat 6: /6In1zC3WtgwxDcueWzZWg ($58.10 in chips)
Seat 7: VBnpbzn0dIveV55qKvciew ($55.95 in chips)
Seat 8: BPMN9sOItJw6vWq3kypaYg ($26.50 in chips)
Seat 9: M+7+BTmX5vZatHVuoRB1nA ($82.60 in chips)
DSM67hHHq1XFoEOi9p8Alw: posts small blind $0.25
RjBdQ6w31rgcy0o24VLR6w: posts big blind $0.50
*** HOLE CARDS ***
mSD1pginDsyHG5PDfqzphw: folds
uw9QayAAxLM3Hb+HR7mSkg: folds
L5e2lrPLQm1Pqx30IIZ/Fw: folds
/6In1zC3WtgwxDcueWzZWg: folds
VBnpbzn0dIveV55qKvciew: raises $1 to $1.50
BPMN9sOItJw6vWq3kypaYg: folds
M+7+BTmX5vZatHVuoRB1nA: folds
DSM67hHHq1XFoEOi9p8Alw: folds
RjBdQ6w31rgcy0o24VLR6w: folds
VBnpbzn0dIveV55qKvciew collected $1.25 from pot
*** SUMMARY ***
Total pot $1.25 | Rake $0
Seat 1: DSM67hHHq1XFoEOi9p8Alw (small blind) folded before Flop
Seat 2: RjBdQ6w31rgcy0o24VLR6w (big blind) folded before Flop
Seat 3: mSD1pginDsyHG5PDfqzphw folded before Flop (didn't bet)
Seat 4: uw9QayAAxLM3Hb+HR7mSkg folded before Flop (didn't bet)
Seat 5: L5e2lrPLQm1Pqx30IIZ/Fw folded before Flop (didn't bet)
Seat 6: /6In1zC3WtgwxDcueWzZWg folded before Flop (didn't bet)
Seat 7: VBnpbzn0dIveV55qKvciew collected ($1.25)
Seat 8: BPMN9sOItJw6vWq3kypaYg folded before Flop (didn't bet)
Seat 9: M+7+BTmX5vZatHVuoRB1nA (button) folded before Flop (didn't bet)



PokerStars Game #59938456658:  Hold'em No Limit ($0.25/$0.50) - 2009/07/01 0:15:25 ET
Table 'c/CRn+68J3Y8KxD5g1ek2Q' 2-max Seat #2 is the button
Seat 1: 46qCyJ6evTkHo9al5sBMNA ($293.55 in chips)
Seat 2: BypVLsYQt3ePFm2xQL/dOA ($90.50 in chips)
BypVLsYQt3ePFm2xQL/dOA: posts small blind $0.25
46qCyJ6evTkHo9al5sBMNA: posts big blind $0.50
*** HOLE CARDS ***
BypVLsYQt3ePFm2xQL/dOA: raises $1 to $1.50
46qCyJ6evTkHo9al5sBMNA: folds
BypVLsYQt3ePFm2xQL/dOA collected $1 from pot
BypVLsYQt3ePFm2xQL/dOA: doesn't show hand
*** SUMMARY ***
Total pot $1 | Rake $0
Seat 1: 46qCyJ6evTkHo9al5sBMNA (big blind) folded before Flop
Seat 2: BypVLsYQt3ePFm2xQL/dOA (button) (small blind) collected ($1)



PokerStars Game #59938456246:  Hold'em No Limit ($0.25/$0.50) - 2009/07/01 0:15:25 ET
Table 'T/PgNWqVyY6lkldcBVXYJQ' 6-max Seat #5 is the button
Seat 1: +Pf9jTVizYlIo+woPvptfA ($53.20 in chips)
Seat 2: oZAeY5rVqNGgt8yyQ0pxbA ($23.30 in chips)
Seat 3: L3OcNO1bgdqDI46j67KQPQ ($56.30 in chips)
Seat 4: jxMvxeUUL9UU0V6wVU+Iyw ($4.10 in chips)
Seat 5: vVQBckETtigfb5mAcyK0OA ($60.75 in chips)
Seat 6: cDzbog6kwmJp+LBeBq+iMQ ($22.20 in chips)
cDzbog6kwmJp+LBeBq+iMQ: posts small blind $0.25
+Pf9jTVizYlIo+woPvptfA: posts big blind $0.50
*** HOLE CARDS ***
jxMvxeUUL9UU0V6wVU+Iyw said, "? So your a dude then?"
oZAeY5rVqNGgt8yyQ0pxbA: folds
vVQBckETtigfb5mAcyK0OA said, "HE CALLS ANY THING"
L3OcNO1bgdqDI46j67KQPQ: folds
jxMvxeUUL9UU0V6wVU+Iyw: raises $3.60 to $4.10 and is all-in
vVQBckETtigfb5mAcyK0OA: folds
vVQBckETtigfb5mAcyK0OA said, "38"
vVQBckETtigfb5mAcyK0OA said, "U"
cDzbog6kwmJp+LBeBq+iMQ: folds
+Pf9jTVizYlIo+woPvptfA: folds
jxMvxeUUL9UU0V6wVU+Iyw collected $1.25 from pot
jxMvxeUUL9UU0V6wVU+Iyw: doesn't show hand
*** SUMMARY ***
Total pot $1.25 | Rake $0
Seat 1: +Pf9jTVizYlIo+woPvptfA (big blind) folded before Flop
Seat 2: oZAeY5rVqNGgt8yyQ0pxbA folded before Flop (didn't bet)
Seat 3: L3OcNO1bgdqDI46j67KQPQ folded before Flop (didn't bet)
Seat 4: jxMvxeUUL9UU0V6wVU+Iyw collected ($1.25)
Seat 5: vVQBckETtigfb5mAcyK0OA (button) folded before Flop (didn't bet)
Seat 6: cDzbog6kwmJp+LBeBq+iMQ (small blind) folded before Flop



PokerStars Game #59938458236:  Hold'em No Limit ($0.25/$0.50) - 2009/07/01 0:15:27 ET
Table 'kgbJRsxfv64KrErDRBAkcw' 6-max Seat #4 is the button
Seat 1: N7O9jUEx2YiQn1+yRYTHmw ($25 in chips)
Seat 2: Q+thC23WCv1kJUJtH/+4Jw ($33 in chips)
Seat 3: T0Gx/FcQ5VH9u7XaOMX97A ($61 in chips)
Seat 4: qanMEqjABjWxC/JgQ/0l7w ($61.95 in chips)
Seat 5: +Pf9jTVizYlIo+woPvptfA ($50 in chips)
Seat 6: DDfYzIrYT0t5R/hAJngtsg ($23.45 in chips)
+Pf9jTVizYlIo+woPvptfA: posts small blind $0.25
DDfYzIrYT0t5R/hAJngtsg: posts big blind $0.50
N7O9jUEx2YiQn1+yRYTHmw: posts big blind $0.50
*** HOLE CARDS ***
N7O9jUEx2YiQn1+yRYTHmw: checks
Q+thC23WCv1kJUJtH/+4Jw: folds
T0Gx/FcQ5VH9u7XaOMX97A: folds
qanMEqjABjWxC/JgQ/0l7w: raises $2 to $2.50
+Pf9jTVizYlIo+woPvptfA: folds
DDfYzIrYT0t5R/hAJngtsg: calls $2
N7O9jUEx2YiQn1+yRYTHmw: folds
*** FLOP *** [2h Jd 7h]
DDfYzIrYT0t5R/hAJngtsg: bets $1
qanMEqjABjWxC/JgQ/0l7w: calls $1
*** TURN *** [2h Jd 7h] [6d]
DDfYzIrYT0t5R/hAJngtsg: bets $1.50
qanMEqjABjWxC/JgQ/0l7w: folds
DDfYzIrYT0t5R/hAJngtsg collected $7.40 from pot
DDfYzIrYT0t5R/hAJngtsg: doesn't show hand
*** SUMMARY ***
Total pot $7.75 | Rake $0.35
Board [2h Jd 7h 6d]
Seat 1: N7O9jUEx2YiQn1+yRYTHmw folded before Flop
Seat 2: Q+thC23WCv1kJUJtH/+4Jw folded before Flop (didn't bet)
Seat 3: T0Gx/FcQ5VH9u7XaOMX97A folded before Flop (didn't bet)
Seat 4: qanMEqjABjWxC/JgQ/0l7w (button) folded on the Turn
Seat 5: +Pf9jTVizYlIo+woPvptfA (small blind) folded before Flop
Seat 6: DDfYzIrYT0t5R/hAJngtsg (big blind) collected ($7.40)



PokerStars Game #59938457750:  Hold'em No Limit ($0.25/$0.50) - 2009/07/01 0:15:27 ET
Table '37qXEp3oe+er5q4CZip9eQ' 6-max Seat #5 is the button
Seat 1: oqOqoO2AyCZenUghCxMDxw ($50 in chips)
Seat 2: g12O9qXTybyo2C0B2bXgjg ($29.65 in chips)
Seat 3: Rt6KgtZ8YaJoTc3FPim00w ($99.45 in chips)
Seat 4: AYb7QG0KzyicbOC0ZROE3Q ($10 in chips)
Seat 5: VOmI0x4dDPnTESZd5B4d1Q ($41.05 in chips)
Seat 6: f7zPpUQp9hHZgqhEvrUWQw ($53.15 in chips)
f7zPpUQp9hHZgqhEvrUWQw: posts small blind $0.25
oqOqoO2AyCZenUghCxMDxw: posts big blind $0.50
AYb7QG0KzyicbOC0ZROE3Q: posts big blind $0.50
*** HOLE CARDS ***
g12O9qXTybyo2C0B2bXgjg: folds
Rt6KgtZ8YaJoTc3FPim00w: folds
AYb7QG0KzyicbOC0ZROE3Q: checks
VOmI0x4dDPnTESZd5B4d1Q: folds
f7zPpUQp9hHZgqhEvrUWQw: raises $1.50 to $2
oqOqoO2AyCZenUghCxMDxw: folds
AYb7QG0KzyicbOC0ZROE3Q: folds
f7zPpUQp9hHZgqhEvrUWQw collected $1.50 from pot
*** SUMMARY ***
Total pot $1.50 | Rake $0
Seat 1: oqOqoO2AyCZenUghCxMDxw (big blind) folded before Flop
Seat 2: g12O9qXTybyo2C0B2bXgjg folded before Flop (didn't bet)
Seat 3: Rt6KgtZ8YaJoTc3FPim00w folded before Flop (didn't bet)
Seat 4: AYb7QG0KzyicbOC0ZROE3Q folded before Flop
Seat 5: VOmI0x4dDPnTESZd5B4d1Q (button) folded before Flop (didn't bet)
Seat 6: f7zPpUQp9hHZgqhEvrUWQw (small blind) collected ($1.50)



PokerStars Game #59938458302:  Hold'em No Limit ($0.25/$0.50) - 2009/07/01 0:15:28 ET
Table 'MJxeZCzYELxiIsyUZyT0jw' 6-max Seat #1 is the button
Seat 1: iKPos8JI094Tomq4tDSgnQ ($35 in chips)
Seat 2: r6H1GiZ6QIpMTDhyodKuRQ ($64.80 in chips)
Seat 3: JQZew0FjzS19kTjeNtrE+A ($50 in chips)
Seat 4: lP7Q6pewz4C2RsAfKsjdWw ($21.60 in chips)
Seat 5: 3jvoOXNtXE90w2BdfNZwZQ ($51.15 in chips)
Seat 6: TTx3CHxyi0SObcHyMJRp5w ($47.80 in chips)
r6H1GiZ6QIpMTDhyodKuRQ: posts small blind $0.25
JQZew0FjzS19kTjeNtrE+A: posts big blind $0.50
*** HOLE CARDS ***
lP7Q6pewz4C2RsAfKsjdWw: calls $0.50
3jvoOXNtXE90w2BdfNZwZQ: folds
TTx3CHxyi0SObcHyMJRp5w: folds
iKPos8JI094Tomq4tDSgnQ: raises $3.50 to $4
r6H1GiZ6QIpMTDhyodKuRQ: folds
JQZew0FjzS19kTjeNtrE+A: folds
lP7Q6pewz4C2RsAfKsjdWw: folds
iKPos8JI094Tomq4tDSgnQ collected $1.75 from pot
*** SUMMARY ***
Total pot $1.75 | Rake $0
Seat 1: iKPos8JI094Tomq4tDSgnQ (button) collected ($1.75)
Seat 2: r6H1GiZ6QIpMTDhyodKuRQ (small blind) folded before Flop
Seat 3: JQZew0FjzS19kTjeNtrE+A (big blind) folded before Flop
Seat 4: lP7Q6pewz4C2RsAfKsjdWw folded before Flop
Seat 5: 3jvoOXNtXE90w2BdfNZwZQ folded before Flop (didn't bet)
Seat 6: TTx3CHxyi0SObcHyMJRp5w folded before Flop (didn't bet)



PokerStars Game #59938459092:  Hold'em No Limit ($0.25/$0.50) - 2009/07/01 0:15:29 ET
Table 'm95HVfesC/VPgfGEjPuaIA' 2-max Seat #1 is the button
Seat 1: Fp/oksNpipCrD2MJ2pH20g ($19.25 in chips)
Seat 2: Ag6DvxX4vbRheqsv2zXKTQ ($25.60 in chips)
Fp/oksNpipCrD2MJ2pH20g: posts small blind $0.25
Ag6DvxX4vbRheqsv2zXKTQ: posts big blind $0.50
*** HOLE CARDS ***
Fp/oksNpipCrD2MJ2pH20g: calls $0.25
Ag6DvxX4vbRheqsv2zXKTQ: checks
*** FLOP *** [Jh 8d Js]
Ag6DvxX4vbRheqsv2zXKTQ: checks
Fp/oksNpipCrD2MJ2pH20g: checks
*** TURN *** [Jh 8d Js] [9h]
Ag6DvxX4vbRheqsv2zXKTQ: checks
Fp/oksNpipCrD2MJ2pH20g: checks
*** RIVER *** [Jh 8d Js 9h] [Kc]
Ag6DvxX4vbRheqsv2zXKTQ: checks
Fp/oksNpipCrD2MJ2pH20g: checks
*** SHOW DOWN ***
Ag6DvxX4vbRheqsv2zXKTQ: shows [4c 7c] (a pair of Jacks)
Fp/oksNpipCrD2MJ2pH20g: shows [Qc 6h] (a pair of Jacks - King+Queen kicker)
Fp/oksNpipCrD2MJ2pH20g collected $0.95 from pot
*** SUMMARY ***
Total pot $1 | Rake $0.05
Board [Jh 8d Js 9h Kc]
Seat 1: Fp/oksNpipCrD2MJ2pH20g (button) (small blind) showed [Qc 6h] and won ($0.95) with a pair of Jacks
Seat 2: Ag6DvxX4vbRheqsv2zXKTQ (big blind) showed [4c 7c] and lost with a pair of Jacks



PokerStars Game #59938459146:  Hold'em No Limit ($0.25/$0.50) - 2009/07/01 0:15:29 ET
Table 'PALRfuH85dr5IkDfdv6new' 9-max Seat #1 is the button
Seat 1: SKnJuWHScqetA/qG5p+wCg ($32.25 in chips)
Seat 2: 9r7ZoBbAJj5IeyZ0q9BdzA ($13.40 in chips)
Seat 3: 50QWoELmpmHFrFIlWMJo9g ($91.20 in chips)
Seat 4: /gaxz7F0MIjSN3t7ZPKwAA ($32.55 in chips)
Seat 5: jSSGUXdNFAZA3QCvTcUMQw ($43 in chips)
Seat 6: EiWj2MAl8RNcPhTkzz24Mw ($34.85 in chips)
Seat 7: 3NcyXvr39gnK+KbTq7ezyA ($35.25 in chips)
Seat 8: NkS+CseUKx4XHszWq0PXEQ ($42.35 in chips)
Seat 9: CIrAX/m6o7jYmKOAjJXv4Q ($38.35 in chips)
9r7ZoBbAJj5IeyZ0q9BdzA: posts small blind $0.25
50QWoELmpmHFrFIlWMJo9g: posts big blind $0.50
*** HOLE CARDS ***
/gaxz7F0MIjSN3t7ZPKwAA: folds
jSSGUXdNFAZA3QCvTcUMQw: raises $1.50 to $2
EiWj2MAl8RNcPhTkzz24Mw: folds
3NcyXvr39gnK+KbTq7ezyA: folds
NkS+CseUKx4XHszWq0PXEQ: raises $3 to $5
CIrAX/m6o7jYmKOAjJXv4Q: folds
SKnJuWHScqetA/qG5p+wCg: folds
9r7ZoBbAJj5IeyZ0q9BdzA: folds
50QWoELmpmHFrFIlWMJo9g: folds
jSSGUXdNFAZA3QCvTcUMQw: folds
NkS+CseUKx4XHszWq0PXEQ collected $4.75 from pot
*** SUMMARY ***
Total pot $4.75 | Rake $0
Seat 1: SKnJuWHScqetA/qG5p+wCg (button) folded before Flop (didn't bet)
Seat 2: 9r7ZoBbAJj5IeyZ0q9BdzA (small blind) folded before Flop
Seat 3: 50QWoELmpmHFrFIlWMJo9g (big blind) folded before Flop
Seat 4: /gaxz7F0MIjSN3t7ZPKwAA folded before Flop (didn't bet)
Seat 5: jSSGUXdNFAZA3QCvTcUMQw folded before Flop
Seat 6: EiWj2MAl8RNcPhTkzz24Mw folded before Flop (didn't bet)
Seat 7: 3NcyXvr39gnK+KbTq7ezyA folded before Flop (didn't bet)
Seat 8: NkS+CseUKx4XHszWq0PXEQ collected ($4.75)
Seat 9: CIrAX/m6o7jYmKOAjJXv4Q folded before Flop (didn't bet)



PokerStars Game #59938459826:  Hold'em No Limit ($0.25/$0.50) - 2009/07/01 0:15:30 ET
Table 'ZYwMb9E6tY50Qm+iNbXRYw' 2-max Seat #2 is the button
Seat 1: DXLfRb8KDZWmrztw2bwtFw ($20.70 in chips)
Seat 2: 16tvT7AYgZ2LgiGFcvFKQg ($15.95 in chips)
16tvT7AYgZ2LgiGFcvFKQg: posts small blind $0.25
DXLfRb8KDZWmrztw2bwtFw: posts big blind $0.50
*** HOLE CARDS ***
16tvT7AYgZ2LgiGFcvFKQg: calls $0.25
DXLfRb8KDZWmrztw2bwtFw: checks
*** FLOP *** [Js 6d Qc]
DXLfRb8KDZWmrztw2bwtFw: checks
16tvT7AYgZ2LgiGFcvFKQg: bets $0.50
DXLfRb8KDZWmrztw2bwtFw: folds
16tvT7AYgZ2LgiGFcvFKQg collected $0.95 from pot
*** SUMMARY ***
Total pot $1 | Rake $0.05
Board [Js 6d Qc]
Seat 1: DXLfRb8KDZWmrztw2bwtFw (big blind) folded on the Flop
Seat 2: 16tvT7AYgZ2LgiGFcvFKQg (button) (small blind) collected ($0.95)



PokerStars Game #59938460320:  Hold'em No Limit ($0.25/$0.50) - 2009/07/01 0:15:30 ET
Table 'mTxf8gPLgffN3Iwfm7Icfg' 2-max Seat #1 is the button
Seat 1: Do9Rlu1R5u/AcRtMTl8SYg ($59.65 in chips)
Seat 2: EMc5LPgVaded4Qc77vm0fw ($52.90 in chips)
Do9Rlu1R5u/AcRtMTl8SYg: posts small blind $0.25
EMc5LPgVaded4Qc77vm0fw: posts big blind $0.50
*** HOLE CARDS ***
Do9Rlu1R5u/AcRtMTl8SYg: folds
EMc5LPgVaded4Qc77vm0fw collected $0.50 from pot
EMc5LPgVaded4Qc77vm0fw: doesn't show hand
*** SUMMARY ***
Total pot $0.50 | Rake $0
Seat 1: Do9Rlu1R5u/AcRtMTl8SYg (button) (small blind) folded before Flop
Seat 2: EMc5LPgVaded4Qc77vm0fw (big blind) collected ($0.50)



PokerStars Game #59938460090:  Hold'em No Limit ($0.25/$0.50) - 2009/07/01 0:15:30 ET
Table 'raOT4/ipuZgzjfKHC+jD9g' 2-max Seat #2 is the button
Seat 1: IuwLemwLhc9fvrwBGs0AMA ($12.60 in chips)
Seat 2: Udr5juWSWUgTu1NlRhjMdA ($10.15 in chips)
Udr5juWSWUgTu1NlRhjMdA: posts small blind $0.25
IuwLemwLhc9fvrwBGs0AMA: posts big blind $0.50
*** HOLE CARDS ***
Udr5juWSWUgTu1NlRhjMdA: calls $0.25
IuwLemwLhc9fvrwBGs0AMA: checks
*** FLOP *** [8s 9c Td]
IuwLemwLhc9fvrwBGs0AMA: checks
Udr5juWSWUgTu1NlRhjMdA: checks
*** TURN *** [8s 9c Td] [3d]
IuwLemwLhc9fvrwBGs0AMA: bets $0.50
Udr5juWSWUgTu1NlRhjMdA: calls $0.50
*** RIVER *** [8s 9c Td 3d] [5d]
IuwLemwLhc9fvrwBGs0AMA: bets $0.50
Udr5juWSWUgTu1NlRhjMdA: calls $0.50
*** SHOW DOWN ***
IuwLemwLhc9fvrwBGs0AMA: shows [7d Ts] (a pair of Tens)
Udr5juWSWUgTu1NlRhjMdA: mucks hand
IuwLemwLhc9fvrwBGs0AMA collected $2.90 from pot
*** SUMMARY ***
Total pot $3 | Rake $0.10
Board [8s 9c Td 3d 5d]
Seat 1: IuwLemwLhc9fvrwBGs0AMA (big blind) showed [7d Ts] and won ($2.90) with a pair of Tens
Seat 2: Udr5juWSWUgTu1NlRhjMdA (button) (small blind) mucked



PokerStars Game #59938459926:  Hold'em No Limit ($0.25/$0.50) - 2009/07/01 0:15:30 ET
Table 'tyR5AZNKV8Aadbrnrnlg7g' 6-max Seat #1 is the button
Seat 1: R+KjpH/wSjDLhtIy9+edNA ($52.35 in chips)
Seat 2: 58zdeSBSuSFX/qZfhc7YmA ($30.60 in chips)
Seat 3: jUhx+m+V7qfbLZTjgwZByg ($46.60 in chips)
Seat 4: Rt6KgtZ8YaJoTc3FPim00w ($50.50 in chips)
Seat 5: EIg3r3fRFKG2HhgpDlIJHg ($13.60 in chips)
Seat 6: DMQLAmut/l19xN5STQndFg ($17.15 in chips)
58zdeSBSuSFX/qZfhc7YmA: posts small blind $0.25
jUhx+m+V7qfbLZTjgwZByg: posts big blind $0.50
*** HOLE CARDS ***
Rt6KgtZ8YaJoTc3FPim00w: folds
EIg3r3fRFKG2HhgpDlIJHg: calls $0.50
DMQLAmut/l19xN5STQndFg: calls $0.50
R+KjpH/wSjDLhtIy9+edNA: folds
58zdeSBSuSFX/qZfhc7YmA: raises $1 to $1.50
jUhx+m+V7qfbLZTjgwZByg: folds
EIg3r3fRFKG2HhgpDlIJHg: calls $1
DMQLAmut/l19xN5STQndFg: calls $1
*** FLOP *** [2d 8c Tc]
58zdeSBSuSFX/qZfhc7YmA: bets $4.50
EIg3r3fRFKG2HhgpDlIJHg: folds
DMQLAmut/l19xN5STQndFg: folds
58zdeSBSuSFX/qZfhc7YmA collected $4.75 from pot
*** SUMMARY ***
Total pot $5 | Rake $0.25
Board [2d 8c Tc]
Seat 1: R+KjpH/wSjDLhtIy9+edNA (button) folded before Flop (didn't bet)
Seat 2: 58zdeSBSuSFX/qZfhc7YmA (small blind) collected ($4.75)
Seat 3: jUhx+m+V7qfbLZTjgwZByg (big blind) folded before Flop
Seat 4: Rt6KgtZ8YaJoTc3FPim00w folded before Flop (didn't bet)
Seat 5: EIg3r3fRFKG2HhgpDlIJHg folded on the Flop
Seat 6: DMQLAmut/l19xN5STQndFg folded on the Flop



PokerStars Game #59938461002:  Hold'em No Limit ($0.25/$0.50) - 2009/07/01 0:15:31 ET
Table '5EmHi+fnatGQQShcNmzOZQ' 6-max Seat #1 is the button
Seat 1: SwPczQo3cOtwEzhJrfO2cQ ($27.70 in chips)
Seat 2: APwvTk5XojDXGoQLb4O5iA ($28.50 in chips)
Seat 4: wOyVV9M/oyiw3YaOjNZ05w ($50 in chips)
Seat 5: kxPhs4ePFqMy52CInAJ2aw ($69.30 in chips)
Seat 6: 686aeHikcJlgKkSuIFdcXQ ($131.35 in chips)
APwvTk5XojDXGoQLb4O5iA: posts small blind $0.25
wOyVV9M/oyiw3YaOjNZ05w: posts big blind $0.50
*** HOLE CARDS ***
L9qfLYXrczhAPd/VckgsWw joins the table at seat #3
kxPhs4ePFqMy52CInAJ2aw: raises $1.50 to $2
686aeHikcJlgKkSuIFdcXQ: calls $2
SwPczQo3cOtwEzhJrfO2cQ: folds
APwvTk5XojDXGoQLb4O5iA has timed out
APwvTk5XojDXGoQLb4O5iA: folds
APwvTk5XojDXGoQLb4O5iA is sitting out
APwvTk5XojDXGoQLb4O5iA has returned
wOyVV9M/oyiw3YaOjNZ05w: folds
*** FLOP *** [8c 4h Ts]
kxPhs4ePFqMy52CInAJ2aw: bets $3
686aeHikcJlgKkSuIFdcXQ: calls $3
*** TURN *** [8c 4h Ts] [8h]
kxPhs4ePFqMy52CInAJ2aw: bets $7
686aeHikcJlgKkSuIFdcXQ: calls $7
*** RIVER *** [8c 4h Ts 8h] [Kh]
kxPhs4ePFqMy52CInAJ2aw: bets $16
686aeHikcJlgKkSuIFdcXQ: raises $103.35 to $119.35 and is all-in
kxPhs4ePFqMy52CInAJ2aw: folds
686aeHikcJlgKkSuIFdcXQ collected $54.75 from pot
*** SUMMARY ***
Total pot $56.75 | Rake $2
Board [8c 4h Ts 8h Kh]
Seat 1: SwPczQo3cOtwEzhJrfO2cQ (button) folded before Flop (didn't bet)
Seat 2: APwvTk5XojDXGoQLb4O5iA (small blind) folded before Flop
Seat 4: wOyVV9M/oyiw3YaOjNZ05w (big blind) folded before Flop
Seat 5: kxPhs4ePFqMy52CInAJ2aw folded on the River
Seat 6: 686aeHikcJlgKkSuIFdcXQ collected ($54.75)



PokerStars Game #59938462962:  Hold'em No Limit ($0.25/$0.50) - 2009/07/01 0:15:34 ET
Table '+dXkOAQyS8j9PQZusUTMpg' 2-max Seat #1 is the button
Seat 1: XFa6sBGjP2gxoIvxR3fZIg ($72.40 in chips)
Seat 2: 5IBeOgaApY1Bvzv2P8X4EA ($38.60 in chips)
XFa6sBGjP2gxoIvxR3fZIg: posts small blind $0.25
5IBeOgaApY1Bvzv2P8X4EA: posts big blind $0.50
*** HOLE CARDS ***
XFa6sBGjP2gxoIvxR3fZIg: raises $1 to $1.50
5IBeOgaApY1Bvzv2P8X4EA: raises $1.50 to $3
XFa6sBGjP2gxoIvxR3fZIg: calls $1.50
*** FLOP *** [Tc 7s 9h]
5IBeOgaApY1Bvzv2P8X4EA said, "lucky me"
5IBeOgaApY1Bvzv2P8X4EA: bets $2
XFa6sBGjP2gxoIvxR3fZIg said, "sometimes you have to be"
XFa6sBGjP2gxoIvxR3fZIg: raises $6.50 to $8.50
5IBeOgaApY1Bvzv2P8X4EA: calls $6.50
*** TURN *** [Tc 7s 9h] [Jh]
5IBeOgaApY1Bvzv2P8X4EA: checks
XFa6sBGjP2gxoIvxR3fZIg: bets $15
5IBeOgaApY1Bvzv2P8X4EA: folds
XFa6sBGjP2gxoIvxR3fZIg collected $22.50 from pot
*** SUMMARY ***
Total pot $23 | Rake $0.50
Board [Tc 7s 9h Jh]
Seat 1: XFa6sBGjP2gxoIvxR3fZIg (button) (small blind) collected ($22.50)
Seat 2: 5IBeOgaApY1Bvzv2P8X4EA (big blind) folded on the Turn



PokerStars Game #59938464180:  Hold'em No Limit ($0.25/$0.50) - 2009/07/01 0:15:36 ET
Table 'mTxf8gPLgffN3Iwfm7Icfg' 2-max Seat #2 is the button
Seat 1: Do9Rlu1R5u/AcRtMTl8SYg ($59.40 in chips)
Seat 2: EMc5LPgVaded4Qc77vm0fw ($53.15 in chips)
EMc5LPgVaded4Qc77vm0fw: posts small blind $0.25
Do9Rlu1R5u/AcRtMTl8SYg: posts big blind $0.50
*** HOLE CARDS ***
EMc5LPgVaded4Qc77vm0fw: raises $1 to $1.50
Do9Rlu1R5u/AcRtMTl8SYg: folds
EMc5LPgVaded4Qc77vm0fw collected $1 from pot
EMc5LPgVaded4Qc77vm0fw: doesn't show hand
*** SUMMARY ***
Total pot $1 | Rake $0
Seat 1: Do9Rlu1R5u/AcRtMTl8SYg (big blind) folded before Flop
Seat 2: EMc5LPgVaded4Qc77vm0fw (button) (small blind) collected ($1)



PokerStars Game #59938466650:  Hold'em No Limit ($0.25/$0.50) - 2009/07/01 0:15:39 ET
Table 'QOgaEqMcJ73pcUMMxoisUg' 6-max Seat #3 is the button
Seat 1: RFefXIDyFvNtJLq+CloCzA ($41.70 in chips)
Seat 2: Im2p1Nt83UKSqv5c9frm4Q ($50 in chips)
Seat 3: wUZNozoIDYf+16hp4nn6dw ($44.25 in chips)
Seat 4: zAcsDhG/T128Vn7XGVSgKg ($54.65 in chips)
Seat 6: s83dnhZ6VC53vY0/f6OV/g ($48.50 in chips)
zAcsDhG/T128Vn7XGVSgKg: posts small blind $0.25
s83dnhZ6VC53vY0/f6OV/g: posts big blind $0.50
*** HOLE CARDS ***
RFefXIDyFvNtJLq+CloCzA: folds
Im2p1Nt83UKSqv5c9frm4Q: folds
wUZNozoIDYf+16hp4nn6dw: calls $0.50
zAcsDhG/T128Vn7XGVSgKg: folds
s83dnhZ6VC53vY0/f6OV/g: checks
*** FLOP *** [4s 7s Kc]
s83dnhZ6VC53vY0/f6OV/g: checks
wUZNozoIDYf+16hp4nn6dw: bets $2
s83dnhZ6VC53vY0/f6OV/g: folds
wUZNozoIDYf+16hp4nn6dw collected $1.20 from pot
*** SUMMARY ***
Total pot $1.25 | Rake $0.05
Board [4s 7s Kc]
Seat 1: RFefXIDyFvNtJLq+CloCzA folded before Flop (didn't bet)
Seat 2: Im2p1Nt83UKSqv5c9frm4Q folded before Flop (didn't bet)
Seat 3: wUZNozoIDYf+16hp4nn6dw (button) collected ($1.20)
Seat 4: zAcsDhG/T128Vn7XGVSgKg (small blind) folded before Flop
Seat 6: s83dnhZ6VC53vY0/f6OV/g (big blind) folded on the Flop



PokerStars Game #59938467000:  Hold'em No Limit ($0.25/$0.50) - 2009/07/01 0:15:40 ET
Table 'ZYwMb9E6tY50Qm+iNbXRYw' 2-max Seat #1 is the button
Seat 1: DXLfRb8KDZWmrztw2bwtFw ($20.20 in chips)
Seat 2: 16tvT7AYgZ2LgiGFcvFKQg ($16.40 in chips)
DXLfRb8KDZWmrztw2bwtFw: posts small blind $0.25
16tvT7AYgZ2LgiGFcvFKQg: posts big blind $0.50
*** HOLE CARDS ***
DXLfRb8KDZWmrztw2bwtFw said, "you bet all the time im not"
DXLfRb8KDZWmrztw2bwtFw: calls $0.25
16tvT7AYgZ2LgiGFcvFKQg: checks
*** FLOP *** [Qs 2d Kc]
16tvT7AYgZ2LgiGFcvFKQg: checks
DXLfRb8KDZWmrztw2bwtFw: checks
*** TURN *** [Qs 2d Kc] [8h]
16tvT7AYgZ2LgiGFcvFKQg: checks
DXLfRb8KDZWmrztw2bwtFw: checks
*** RIVER *** [Qs 2d Kc 8h] [9s]
16tvT7AYgZ2LgiGFcvFKQg: checks
DXLfRb8KDZWmrztw2bwtFw: checks
*** SHOW DOWN ***
16tvT7AYgZ2LgiGFcvFKQg: shows [4c 3s] (high card King)
DXLfRb8KDZWmrztw2bwtFw: shows [4h 4s] (a pair of Fours)
DXLfRb8KDZWmrztw2bwtFw collected $0.95 from pot
*** SUMMARY ***
Total pot $1 | Rake $0.05
Board [Qs 2d Kc 8h 9s]
Seat 1: DXLfRb8KDZWmrztw2bwtFw (button) (small blind) showed [4h 4s] and won ($0.95) with a pair of Fours
Seat 2: 16tvT7AYgZ2LgiGFcvFKQg (big blind) showed [4c 3s] and lost with high card King



PokerStars Game #59938470072:  Hold'em No Limit ($0.25/$0.50) - 2009/07/01 0:15:44 ET
Table 'c/CRn+68J3Y8KxD5g1ek2Q' 2-max Seat #1 is the button
Seat 1: 46qCyJ6evTkHo9al5sBMNA ($293.05 in chips)
Seat 2: BypVLsYQt3ePFm2xQL/dOA ($91 in chips)
46qCyJ6evTkHo9al5sBMNA: posts small blind $0.25
BypVLsYQt3ePFm2xQL/dOA: posts big blind $0.50
*** HOLE CARDS ***
46qCyJ6evTkHo9al5sBMNA: folds
BypVLsYQt3ePFm2xQL/dOA collected $0.50 from pot
BypVLsYQt3ePFm2xQL/dOA: doesn't show hand
*** SUMMARY ***
Total pot $0.50 | Rake $0
Seat 1: 46qCyJ6evTkHo9al5sBMNA (button) (small blind) folded before Flop
Seat 2: BypVLsYQt3ePFm2xQL/dOA (big blind) collected ($0.50)



PokerStars Game #59938470674:  Hold'em No Limit ($0.25/$0.50) - 2009/07/01 0:15:45 ET
Table 'mTxf8gPLgffN3Iwfm7Icfg' 2-max Seat #1 is the button
Seat 1: Do9Rlu1R5u/AcRtMTl8SYg ($58.90 in chips)
Seat 2: EMc5LPgVaded4Qc77vm0fw ($53.65 in chips)
Do9Rlu1R5u/AcRtMTl8SYg: posts small blind $0.25
EMc5LPgVaded4Qc77vm0fw: posts big blind $0.50
*** HOLE CARDS ***
Do9Rlu1R5u/AcRtMTl8SYg: raises $1 to $1.50
EMc5LPgVaded4Qc77vm0fw: folds
Do9Rlu1R5u/AcRtMTl8SYg collected $1 from pot
Do9Rlu1R5u/AcRtMTl8SYg: doesn't show hand
*** SUMMARY ***
Total pot $1 | Rake $0
Seat 1: Do9Rlu1R5u/AcRtMTl8SYg (button) (small blind) collected ($1)
Seat 2: EMc5LPgVaded4Qc77vm0fw (big blind) folded before Flop



PokerStars Game #59938471146:  Hold'em No Limit ($0.25/$0.50) - 2009/07/01 0:15:46 ET
Table 'NCiXr0d5CEKBQr/cZgLhbA' 9-max Seat #1 is the button
Seat 1: RjBdQ6w31rgcy0o24VLR6w ($10 in chips)
Seat 2: ulxuJchBV9iguXg0FUonfg ($40.30 in chips)
Seat 3: xZCXQSXlrZkp3pZizzVXCw ($55.65 in chips)
Seat 4: CL4d+tvzcd4utdQxlPLOmg ($29.15 in chips)
Seat 5: zE9cVigS2nW/Ljy4K4bUQA ($30 in chips)
Seat 6: SKnJuWHScqetA/qG5p+wCg ($31.05 in chips)
Seat 8: 1MJUKc3cc0QmUoz1JZLR2w ($62.90 in chips)
Seat 9: WpvT3OUSiZlpvs+mPXFqtQ ($8.20 in chips)
ulxuJchBV9iguXg0FUonfg: posts small blind $0.25
xZCXQSXlrZkp3pZizzVXCw: posts big blind $0.50
M+7+BTmX5vZatHVuoRB1nA: sits out
*** HOLE CARDS ***
CL4d+tvzcd4utdQxlPLOmg: folds
ulxuJchBV9iguXg0FUonfg said, "ty"
zE9cVigS2nW/Ljy4K4bUQA: folds
SKnJuWHScqetA/qG5p+wCg: folds
1MJUKc3cc0QmUoz1JZLR2w: calls $0.50
WpvT3OUSiZlpvs+mPXFqtQ: folds
RjBdQ6w31rgcy0o24VLR6w: folds
ulxuJchBV9iguXg0FUonfg: folds
xZCXQSXlrZkp3pZizzVXCw: checks
*** FLOP *** [Th Tc 7s]
xZCXQSXlrZkp3pZizzVXCw: checks
1MJUKc3cc0QmUoz1JZLR2w: checks
*** TURN *** [Th Tc 7s] [Ks]
xZCXQSXlrZkp3pZizzVXCw is disconnected
xZCXQSXlrZkp3pZizzVXCw has timed out while disconnected
xZCXQSXlrZkp3pZizzVXCw: checks
1MJUKc3cc0QmUoz1JZLR2w: bets $1.50
xZCXQSXlrZkp3pZizzVXCw is connected
xZCXQSXlrZkp3pZizzVXCw: folds
1MJUKc3cc0QmUoz1JZLR2w collected $1.20 from pot
*** SUMMARY ***
Total pot $1.25 | Rake $0.05
Board [Th Tc 7s Ks]
Seat 1: RjBdQ6w31rgcy0o24VLR6w (button) folded before Flop (didn't bet)
Seat 2: ulxuJchBV9iguXg0FUonfg (small blind) folded before Flop
Seat 3: xZCXQSXlrZkp3pZizzVXCw (big blind) folded on the Turn
Seat 4: CL4d+tvzcd4utdQxlPLOmg folded before Flop (didn't bet)
Seat 5: zE9cVigS2nW/Ljy4K4bUQA folded before Flop (didn't bet)
Seat 6: SKnJuWHScqetA/qG5p+wCg folded before Flop (didn't bet)
Seat 8: 1MJUKc3cc0QmUoz1JZLR2w collected ($1.20)
Seat 9: WpvT3OUSiZlpvs+mPXFqtQ folded before Flop (didn't bet)



PokerStars Game #59938471694:  Hold'em No Limit ($0.25/$0.50) - 2009/07/01 0:15:47 ET
Table 'lSisgp6H7Fg1hH5VfjEjYQ' 9-max Seat #3 is the button
Seat 1: pEW8B6uXbdR47kfljMQ3+Q ($38.95 in chips)
Seat 2: UrcnkQOiLVk8BlKDPJSy7Q ($51.10 in chips)
Seat 3: aTkyjTh3w5YLWiIERupZOA ($37.75 in chips)
Seat 4: nvw9yQKhJT56lA9k+TLdhw ($13.75 in chips)
Seat 5: mSD1pginDsyHG5PDfqzphw ($10 in chips)
Seat 6: +k7T5ocke8UwavtgUHm+Cg ($22.15 in chips)
Seat 7: dGw5MBstXyXhWHHVFOWOFA ($43.75 in chips)
Seat 8: a4JDWmpFQkL10XfAyuF51A ($27.50 in chips)
Seat 9: 5JJVDlaiMnB004o/RqbZZQ ($40.80 in chips)
nvw9yQKhJT56lA9k+TLdhw: posts small blind $0.25
mSD1pginDsyHG5PDfqzphw: posts big blind $0.50
*** HOLE CARDS ***
+k7T5ocke8UwavtgUHm+Cg: folds
dGw5MBstXyXhWHHVFOWOFA: folds
a4JDWmpFQkL10XfAyuF51A: folds
5JJVDlaiMnB004o/RqbZZQ: folds
pEW8B6uXbdR47kfljMQ3+Q is disconnected
pEW8B6uXbdR47kfljMQ3+Q is connected
pEW8B6uXbdR47kfljMQ3+Q: folds
UrcnkQOiLVk8BlKDPJSy7Q: folds
aTkyjTh3w5YLWiIERupZOA: folds
nvw9yQKhJT56lA9k+TLdhw: folds
mSD1pginDsyHG5PDfqzphw collected $0.50 from pot
mSD1pginDsyHG5PDfqzphw: doesn't show hand
*** SUMMARY ***
Total pot $0.50 | Rake $0
Seat 1: pEW8B6uXbdR47kfljMQ3+Q folded before Flop (didn't bet)
Seat 2: UrcnkQOiLVk8BlKDPJSy7Q folded before Flop (didn't bet)
Seat 3: aTkyjTh3w5YLWiIERupZOA (button) folded before Flop (didn't bet)
Seat 4: nvw9yQKhJT56lA9k+TLdhw (small blind) folded before Flop
Seat 5: mSD1pginDsyHG5PDfqzphw (big blind) collected ($0.50)
Seat 6: +k7T5ocke8UwavtgUHm+Cg folded before Flop (didn't bet)
Seat 7: dGw5MBstXyXhWHHVFOWOFA folded before Flop (didn't bet)
Seat 8: a4JDWmpFQkL10XfAyuF51A folded before Flop (didn't bet)
Seat 9: 5JJVDlaiMnB004o/RqbZZQ folded before Flop (didn't bet)



PokerStars Game #59938473400:  Hold'em No Limit ($0.25/$0.50) - 2009/07/01 0:15:49 ET
Table 'm95HVfesC/VPgfGEjPuaIA' 2-max Seat #2 is the button
Seat 1: Fp/oksNpipCrD2MJ2pH20g ($19.70 in chips)
Seat 2: Ag6DvxX4vbRheqsv2zXKTQ ($25.10 in chips)
Ag6DvxX4vbRheqsv2zXKTQ: posts small blind $0.25
Fp/oksNpipCrD2MJ2pH20g: posts big blind $0.50
*** HOLE CARDS ***
Ag6DvxX4vbRheqsv2zXKTQ: calls $0.25
Fp/oksNpipCrD2MJ2pH20g: checks
*** FLOP *** [2c 4d 9h]
Fp/oksNpipCrD2MJ2pH20g: bets $0.50
Ag6DvxX4vbRheqsv2zXKTQ: calls $0.50
*** TURN *** [2c 4d 9h] [Ts]
Fp/oksNpipCrD2MJ2pH20g: checks
Ag6DvxX4vbRheqsv2zXKTQ: bets $1.50
Fp/oksNpipCrD2MJ2pH20g: folds
Ag6DvxX4vbRheqsv2zXKTQ collected $1.95 from pot
*** SUMMARY ***
Total pot $2 | Rake $0.05
Board [2c 4d 9h Ts]
Seat 1: Fp/oksNpipCrD2MJ2pH20g (big blind) folded on the Turn
Seat 2: Ag6DvxX4vbRheqsv2zXKTQ (button) (small blind) collected ($1.95)



PokerStars Game #59938474206:  Hold'em No Limit ($0.25/$0.50) - 2009/07/01 0:15:50 ET
Table 'T/PgNWqVyY6lkldcBVXYJQ' 6-max Seat #6 is the button
Seat 1: +Pf9jTVizYlIo+woPvptfA ($52.70 in chips)
Seat 2: oZAeY5rVqNGgt8yyQ0pxbA ($23.30 in chips)
Seat 3: L3OcNO1bgdqDI46j67KQPQ ($56.30 in chips)
Seat 4: jxMvxeUUL9UU0V6wVU+Iyw ($4.85 in chips)
Seat 5: vVQBckETtigfb5mAcyK0OA ($60.75 in chips)
Seat 6: cDzbog6kwmJp+LBeBq+iMQ ($21.95 in chips)
+Pf9jTVizYlIo+woPvptfA: posts small blind $0.25
oZAeY5rVqNGgt8yyQ0pxbA: posts big blind $0.50
*** HOLE CARDS ***
L3OcNO1bgdqDI46j67KQPQ: folds
jxMvxeUUL9UU0V6wVU+Iyw: raises $4.35 to $4.85 and is all-in
vVQBckETtigfb5mAcyK0OA: folds
jxMvxeUUL9UU0V6wVU+Iyw said, "I'm tired and tired."
jxMvxeUUL9UU0V6wVU+Iyw said, "43"
vVQBckETtigfb5mAcyK0OA said, "LOL"
cDzbog6kwmJp+LBeBq+iMQ: calls $4.85
+Pf9jTVizYlIo+woPvptfA: folds
oZAeY5rVqNGgt8yyQ0pxbA: folds
*** FLOP *** [Td 3c 6d]
*** TURN *** [Td 3c 6d] [Qc]
vVQBckETtigfb5mAcyK0OA said, "I NEW HE WOULD CALL"
*** RIVER *** [Td 3c 6d Qc] [Tc]
*** SHOW DOWN ***
jxMvxeUUL9UU0V6wVU+Iyw: shows [Ac Ah] (two pair, Aces and Tens)
cDzbog6kwmJp+LBeBq+iMQ: mucks hand
vVQBckETtigfb5mAcyK0OA said, "SWEET"
jxMvxeUUL9UU0V6wVU+Iyw collected $9.95 from pot
*** SUMMARY ***
Total pot $10.45 | Rake $0.50
Board [Td 3c 6d Qc Tc]
Seat 1: +Pf9jTVizYlIo+woPvptfA (small blind) folded before Flop
Seat 2: oZAeY5rVqNGgt8yyQ0pxbA (big blind) folded before Flop
Seat 3: L3OcNO1bgdqDI46j67KQPQ folded before Flop (didn't bet)
Seat 4: jxMvxeUUL9UU0V6wVU+Iyw showed [Ac Ah] and won ($9.95) with two pair, Aces and Tens
Seat 5: vVQBckETtigfb5mAcyK0OA folded before Flop (didn't bet)
Seat 6: cDzbog6kwmJp+LBeBq+iMQ (button) mucked



PokerStars Game #59938474812:  Hold'em No Limit ($0.25/$0.50) - 2009/07/01 0:15:51 ET
Table '3FhG0gl3kMX3wBEEqj+wnQ' 9-max Seat #4 is the button
Seat 1: e0J9pdCNUDTCG031RnXqLA ($22.20 in chips)
Seat 2: 4dl3YNqZ6Houm2jZAzDmRg ($24.50 in chips)
Seat 4: bz4LMfV0GGl/MJ/ABXuPmg ($26.20 in chips)
Seat 5: XNMDwbXt/Q4jM99AXnbJDw ($51 in chips)
Seat 6: 5JJVDlaiMnB004o/RqbZZQ ($26 in chips)
Seat 8: j3K/Jujr7PY4ZM2RZvlH6A ($44.20 in chips)
Seat 9: tzoXBDwkkPV/XPJPkf963Q ($16.50 in chips)
XNMDwbXt/Q4jM99AXnbJDw: posts small blind $0.25
5JJVDlaiMnB004o/RqbZZQ: posts big blind $0.50
mSD1pginDsyHG5PDfqzphw: sits out
dennisa: sits out
*** HOLE CARDS ***
j3K/Jujr7PY4ZM2RZvlH6A: raises $1.50 to $2
tzoXBDwkkPV/XPJPkf963Q: folds
e0J9pdCNUDTCG031RnXqLA: folds
4dl3YNqZ6Houm2jZAzDmRg: folds
bz4LMfV0GGl/MJ/ABXuPmg: folds
XNMDwbXt/Q4jM99AXnbJDw: calls $1.75
5JJVDlaiMnB004o/RqbZZQ: folds
*** FLOP *** [5h Th 5s]
XNMDwbXt/Q4jM99AXnbJDw: checks
j3K/Jujr7PY4ZM2RZvlH6A: bets $2.50
XNMDwbXt/Q4jM99AXnbJDw: calls $2.50
*** TURN *** [5h Th 5s] [9h]
XNMDwbXt/Q4jM99AXnbJDw: bets $5
j3K/Jujr7PY4ZM2RZvlH6A: folds
XNMDwbXt/Q4jM99AXnbJDw collected $9.05 from pot
XNMDwbXt/Q4jM99AXnbJDw: doesn't show hand
*** SUMMARY ***
Total pot $9.50 | Rake $0.45
Board [5h Th 5s 9h]
Seat 1: e0J9pdCNUDTCG031RnXqLA folded before Flop (didn't bet)
Seat 2: 4dl3YNqZ6Houm2jZAzDmRg folded before Flop (didn't bet)
Seat 4: bz4LMfV0GGl/MJ/ABXuPmg (button) folded before Flop (didn't bet)
Seat 5: XNMDwbXt/Q4jM99AXnbJDw (small blind) collected ($9.05)
Seat 6: 5JJVDlaiMnB004o/RqbZZQ (big blind) folded before Flop
Seat 8: j3K/Jujr7PY4ZM2RZvlH6A folded on the Turn
Seat 9: tzoXBDwkkPV/XPJPkf963Q folded before Flop (didn't bet)



PokerStars Game #59938474686:  Hold'em No Limit ($0.25/$0.50) - 2009/07/01 0:15:51 ET
Table 'c/CRn+68J3Y8KxD5g1ek2Q' 2-max Seat #2 is the button
Seat 1: 46qCyJ6evTkHo9al5sBMNA ($292.80 in chips)
Seat 2: BypVLsYQt3ePFm2xQL/dOA ($91.25 in chips)
BypVLsYQt3ePFm2xQL/dOA: posts small blind $0.25
46qCyJ6evTkHo9al5sBMNA: posts big blind $0.50
*** HOLE CARDS ***
BypVLsYQt3ePFm2xQL/dOA: raises $1 to $1.50
46qCyJ6evTkHo9al5sBMNA: folds
BypVLsYQt3ePFm2xQL/dOA collected $1 from pot
BypVLsYQt3ePFm2xQL/dOA: doesn't show hand
*** SUMMARY ***
Total pot $1 | Rake $0
Seat 1: 46qCyJ6evTkHo9al5sBMNA (big blind) folded before Flop
Seat 2: BypVLsYQt3ePFm2xQL/dOA (button) (small blind) collected ($1)



PokerStars Game #59938475616:  Hold'em No Limit ($0.25/$0.50) - 2009/07/01 0:15:52 ET
Table 'ibNfFy0bCzuBaUORla0aGw' 9-max Seat #3 is the button
Seat 1: xZCXQSXlrZkp3pZizzVXCw ($55.45 in chips)
Seat 2: 90Wb75h3W1BRpbqVnuk8gw ($51.80 in chips)
Seat 3: dDaHs3X8+fe3bIkRU0cbrw ($26.50 in chips)
Seat 4: YBN054X4blmis+B2bBlC0g ($20.55 in chips)
Seat 5: FRv75HO8CUsRZ1byEz06mQ ($13.35 in chips)
Seat 6: BmYrv3ec2k5d6pQq6iNaZw ($67.85 in chips)
Seat 7: mSD1pginDsyHG5PDfqzphw ($15.50 in chips)
Seat 8: xUrN9TWLq4m5V+OXY7KUUA ($50 in chips)
Seat 9: WpvT3OUSiZlpvs+mPXFqtQ ($8 in chips)
YBN054X4blmis+B2bBlC0g: posts small blind $0.25
FRv75HO8CUsRZ1byEz06mQ: posts big blind $0.50
*** HOLE CARDS ***
BmYrv3ec2k5d6pQq6iNaZw: folds
mSD1pginDsyHG5PDfqzphw: folds
xUrN9TWLq4m5V+OXY7KUUA: folds
WpvT3OUSiZlpvs+mPXFqtQ: folds
xZCXQSXlrZkp3pZizzVXCw has timed out while being disconnected
xZCXQSXlrZkp3pZizzVXCw: folds
xZCXQSXlrZkp3pZizzVXCw is sitting out
90Wb75h3W1BRpbqVnuk8gw: raises $1.50 to $2
dDaHs3X8+fe3bIkRU0cbrw: folds
YBN054X4blmis+B2bBlC0g: calls $1.75
FRv75HO8CUsRZ1byEz06mQ: folds
*** FLOP *** [5h Qc Jc]
xZCXQSXlrZkp3pZizzVXCw is disconnected
YBN054X4blmis+B2bBlC0g: checks
xZCXQSXlrZkp3pZizzVXCw is connected
90Wb75h3W1BRpbqVnuk8gw: bets $2.50
YBN054X4blmis+B2bBlC0g: folds
90Wb75h3W1BRpbqVnuk8gw collected $4.30 from pot
*** SUMMARY ***
Total pot $4.50 | Rake $0.20
Board [5h Qc Jc]
Seat 1: xZCXQSXlrZkp3pZizzVXCw folded before Flop (didn't bet)
Seat 2: 90Wb75h3W1BRpbqVnuk8gw collected ($4.30)
Seat 3: dDaHs3X8+fe3bIkRU0cbrw (button) folded before Flop (didn't bet)
Seat 4: YBN054X4blmis+B2bBlC0g (small blind) folded on the Flop
Seat 5: FRv75HO8CUsRZ1byEz06mQ (big blind) folded before Flop
Seat 6: BmYrv3ec2k5d6pQq6iNaZw folded before Flop (didn't bet)
Seat 7: mSD1pginDsyHG5PDfqzphw folded before Flop (didn't bet)
Seat 8: xUrN9TWLq4m5V+OXY7KUUA folded before Flop (didn't bet)
Seat 9: WpvT3OUSiZlpvs+mPXFqtQ folded before Flop (didn't bet)



PokerStars Game #59938477010:  Hold'em No Limit ($0.25/$0.50) - 2009/07/01 0:15:54 ET
Table 'X6IRCRTh+20gjz8aubWnwA' 9-max Seat #1 is the button
Seat 1: DSM67hHHq1XFoEOi9p8Alw ($51.15 in chips)
Seat 2: RjBdQ6w31rgcy0o24VLR6w ($11.15 in chips)
Seat 3: mSD1pginDsyHG5PDfqzphw ($10 in chips)
Seat 4: uw9QayAAxLM3Hb+HR7mSkg ($10.25 in chips)
Seat 5: L5e2lrPLQm1Pqx30IIZ/Fw ($12.85 in chips)
Seat 6: /6In1zC3WtgwxDcueWzZWg ($58.10 in chips)
Seat 7: VBnpbzn0dIveV55qKvciew ($56.70 in chips)
Seat 8: BPMN9sOItJw6vWq3kypaYg ($26.50 in chips)
Seat 9: M+7+BTmX5vZatHVuoRB1nA ($82.60 in chips)
RjBdQ6w31rgcy0o24VLR6w: posts small blind $0.25
mSD1pginDsyHG5PDfqzphw: posts big blind $0.50
*** HOLE CARDS ***
uw9QayAAxLM3Hb+HR7mSkg: folds
L5e2lrPLQm1Pqx30IIZ/Fw: raises $1.50 to $2
/6In1zC3WtgwxDcueWzZWg: folds
VBnpbzn0dIveV55qKvciew: calls $2
BPMN9sOItJw6vWq3kypaYg: folds
M+7+BTmX5vZatHVuoRB1nA: folds
DSM67hHHq1XFoEOi9p8Alw has timed out
DSM67hHHq1XFoEOi9p8Alw: folds
DSM67hHHq1XFoEOi9p8Alw is sitting out
RjBdQ6w31rgcy0o24VLR6w: folds
mSD1pginDsyHG5PDfqzphw: folds
*** FLOP *** [2d 7d 4d]
L5e2lrPLQm1Pqx30IIZ/Fw: bets $10.85 and is all-in
VBnpbzn0dIveV55qKvciew: folds
L5e2lrPLQm1Pqx30IIZ/Fw collected $4.55 from pot
*** SUMMARY ***
Total pot $4.75 | Rake $0.20
Board [2d 7d 4d]
Seat 1: DSM67hHHq1XFoEOi9p8Alw (button) folded before Flop (didn't bet)
Seat 2: RjBdQ6w31rgcy0o24VLR6w (small blind) folded before Flop
Seat 3: mSD1pginDsyHG5PDfqzphw (big blind) folded before Flop
Seat 4: uw9QayAAxLM3Hb+HR7mSkg folded before Flop (didn't bet)
Seat 5: L5e2lrPLQm1Pqx30IIZ/Fw collected ($4.55)
Seat 6: /6In1zC3WtgwxDcueWzZWg folded before Flop (didn't bet)
Seat 7: VBnpbzn0dIveV55qKvciew folded on the Flop
Seat 8: BPMN9sOItJw6vWq3kypaYg folded before Flop (didn't bet)
Seat 9: M+7+BTmX5vZatHVuoRB1nA folded before Flop (didn't bet)



PokerStars Game #59938477344:  Hold'em No Limit ($0.25/$0.50) - 2009/07/01 0:15:55 ET
Table 'mTxf8gPLgffN3Iwfm7Icfg' 2-max Seat #2 is the button
Seat 1: Do9Rlu1R5u/AcRtMTl8SYg ($59.40 in chips)
Seat 2: EMc5LPgVaded4Qc77vm0fw ($53.15 in chips)
EMc5LPgVaded4Qc77vm0fw: posts small blind $0.25
Do9Rlu1R5u/AcRtMTl8SYg: posts big blind $0.50
*** HOLE CARDS ***
EMc5LPgVaded4Qc77vm0fw: raises $1 to $1.50
Do9Rlu1R5u/AcRtMTl8SYg: folds
EMc5LPgVaded4Qc77vm0fw collected $1 from pot
EMc5LPgVaded4Qc77vm0fw: doesn't show hand
*** SUMMARY ***
Total pot $1 | Rake $0
Seat 1: Do9Rlu1R5u/AcRtMTl8SYg (big blind) folded before Flop
Seat 2: EMc5LPgVaded4Qc77vm0fw (button) (small blind) collected ($1)



PokerStars Game #59938478356:  Hold'em No Limit ($0.25/$0.50) - 2009/07/01 0:15:56 ET
Table '37qXEp3oe+er5q4CZip9eQ' 6-max Seat #6 is the button
Seat 1: oqOqoO2AyCZenUghCxMDxw ($50 in chips)
Seat 2: g12O9qXTybyo2C0B2bXgjg ($29.65 in chips)
Seat 3: Rt6KgtZ8YaJoTc3FPim00w ($99.45 in chips)
Seat 4: AYb7QG0KzyicbOC0ZROE3Q ($9.50 in chips)
Seat 5: VOmI0x4dDPnTESZd5B4d1Q ($41.05 in chips)
Seat 6: f7zPpUQp9hHZgqhEvrUWQw ($54.15 in chips)
oqOqoO2AyCZenUghCxMDxw: posts small blind $0.25
g12O9qXTybyo2C0B2bXgjg: posts big blind $0.50
*** HOLE CARDS ***
Rt6KgtZ8YaJoTc3FPim00w: folds
AYb7QG0KzyicbOC0ZROE3Q: calls $0.50
VOmI0x4dDPnTESZd5B4d1Q: folds
f7zPpUQp9hHZgqhEvrUWQw: raises $2 to $2.50
oqOqoO2AyCZenUghCxMDxw: folds
g12O9qXTybyo2C0B2bXgjg: folds
AYb7QG0KzyicbOC0ZROE3Q: calls $2
*** FLOP *** [4c 9h Ts]
AYb7QG0KzyicbOC0ZROE3Q: checks
f7zPpUQp9hHZgqhEvrUWQw: checks
*** TURN *** [4c 9h Ts] [Kc]
AYb7QG0KzyicbOC0ZROE3Q: checks
f7zPpUQp9hHZgqhEvrUWQw: checks
*** RIVER *** [4c 9h Ts Kc] [Qh]
AYb7QG0KzyicbOC0ZROE3Q: bets $7 and is all-in
f7zPpUQp9hHZgqhEvrUWQw: folds
AYb7QG0KzyicbOC0ZROE3Q collected $5.50 from pot
*** SUMMARY ***
Total pot $5.75 | Rake $0.25
Board [4c 9h Ts Kc Qh]
Seat 1: oqOqoO2AyCZenUghCxMDxw (small blind) folded before Flop
Seat 2: g12O9qXTybyo2C0B2bXgjg (big blind) folded before Flop
Seat 3: Rt6KgtZ8YaJoTc3FPim00w folded before Flop (didn't bet)
Seat 4: AYb7QG0KzyicbOC0ZROE3Q collected ($5.50)
Seat 5: VOmI0x4dDPnTESZd5B4d1Q folded before Flop (didn't bet)
Seat 6: f7zPpUQp9hHZgqhEvrUWQw (button) folded on the River



PokerStars Game #59938478058:  Hold'em No Limit ($0.25/$0.50) - 2009/07/01 0:15:56 ET
Table 'eMxdLyFDf28E0wit6gm3Uw' 6-max Seat #6 is the button
Seat 1: tnD/64LagZ9qPaeOQVjVZg ($11.45 in chips)
Seat 2: jwuKQ1S3U4NnzMQn3E3dgw ($69.20 in chips)
Seat 3: dZcLsEI8iXkobBduRJ45Yw ($17 in chips)
Seat 5: X0X97o2fDAPiGx6o1gahsw ($55.55 in chips)
Seat 6: L0aIPg7qefDQjdJo3HCVEA ($9.25 in chips)
tnD/64LagZ9qPaeOQVjVZg: posts small blind $0.25
jwuKQ1S3U4NnzMQn3E3dgw: posts big blind $0.50
*** HOLE CARDS ***
dZcLsEI8iXkobBduRJ45Yw: folds
X0X97o2fDAPiGx6o1gahsw: folds
L0aIPg7qefDQjdJo3HCVEA: folds
tnD/64LagZ9qPaeOQVjVZg: raises $10.95 to $11.45 and is all-in
jwuKQ1S3U4NnzMQn3E3dgw: folds
tnD/64LagZ9qPaeOQVjVZg collected $1 from pot
*** SUMMARY ***
Total pot $1 | Rake $0
Seat 1: tnD/64LagZ9qPaeOQVjVZg (small blind) collected ($1)
Seat 2: jwuKQ1S3U4NnzMQn3E3dgw (big blind) folded before Flop
Seat 3: dZcLsEI8iXkobBduRJ45Yw folded before Flop (didn't bet)
Seat 5: X0X97o2fDAPiGx6o1gahsw folded before Flop (didn't bet)
Seat 6: L0aIPg7qefDQjdJo3HCVEA (button) folded before Flop (didn't bet)



PokerStars Game #59938479762:  Hold'em No Limit ($0.25/$0.50) - 2009/07/01 0:15:58 ET
Table 'MJxeZCzYELxiIsyUZyT0jw' 6-max Seat #2 is the button
Seat 1: iKPos8JI094Tomq4tDSgnQ ($36.25 in chips)
Seat 2: r6H1GiZ6QIpMTDhyodKuRQ ($64.55 in chips)
Seat 3: JQZew0FjzS19kTjeNtrE+A ($50 in chips)
Seat 4: lP7Q6pewz4C2RsAfKsjdWw ($21.10 in chips)
Seat 5: 3jvoOXNtXE90w2BdfNZwZQ ($51.15 in chips)
Seat 6: TTx3CHxyi0SObcHyMJRp5w ($47.80 in chips)
JQZew0FjzS19kTjeNtrE+A: posts small blind $0.25
lP7Q6pewz4C2RsAfKsjdWw: posts big blind $0.50
*** HOLE CARDS ***
3jvoOXNtXE90w2BdfNZwZQ: folds
TTx3CHxyi0SObcHyMJRp5w: folds
iKPos8JI094Tomq4tDSgnQ: folds
r6H1GiZ6QIpMTDhyodKuRQ: raises $1.50 to $2
JQZew0FjzS19kTjeNtrE+A: folds
lP7Q6pewz4C2RsAfKsjdWw: folds
r6H1GiZ6QIpMTDhyodKuRQ collected $1.25 from pot
*** SUMMARY ***
Total pot $1.25 | Rake $0
Seat 1: iKPos8JI094Tomq4tDSgnQ folded before Flop (didn't bet)
Seat 2: r6H1GiZ6QIpMTDhyodKuRQ (button) collected ($1.25)
Seat 3: JQZew0FjzS19kTjeNtrE+A (small blind) folded before Flop
Seat 4: lP7Q6pewz4C2RsAfKsjdWw (big blind) folded before Flop
Seat 5: 3jvoOXNtXE90w2BdfNZwZQ folded before Flop (didn't bet)
Seat 6: TTx3CHxyi0SObcHyMJRp5w folded before Flop (didn't bet)



PokerStars Game #59938479674:  Hold'em No Limit ($0.25/$0.50) - 2009/07/01 0:15:58 ET
Table 'ZYwMb9E6tY50Qm+iNbXRYw' 2-max Seat #2 is the button
Seat 1: DXLfRb8KDZWmrztw2bwtFw ($20.65 in chips)
Seat 2: 16tvT7AYgZ2LgiGFcvFKQg ($15.90 in chips)
16tvT7AYgZ2LgiGFcvFKQg: posts small blind $0.25
DXLfRb8KDZWmrztw2bwtFw: posts big blind $0.50
*** HOLE CARDS ***
16tvT7AYgZ2LgiGFcvFKQg: calls $0.25
DXLfRb8KDZWmrztw2bwtFw: checks
*** FLOP *** [Kh 5h Th]
DXLfRb8KDZWmrztw2bwtFw: checks
16tvT7AYgZ2LgiGFcvFKQg: checks
*** TURN *** [Kh 5h Th] [Jd]
DXLfRb8KDZWmrztw2bwtFw: checks
16tvT7AYgZ2LgiGFcvFKQg: checks
*** RIVER *** [Kh 5h Th Jd] [7d]
DXLfRb8KDZWmrztw2bwtFw: checks
16tvT7AYgZ2LgiGFcvFKQg: checks
*** SHOW DOWN ***
DXLfRb8KDZWmrztw2bwtFw: shows [4h Qs] (high card King)
16tvT7AYgZ2LgiGFcvFKQg: mucks hand
DXLfRb8KDZWmrztw2bwtFw collected $0.95 from pot
*** SUMMARY ***
Total pot $1 | Rake $0.05
Board [Kh 5h Th Jd 7d]
Seat 1: DXLfRb8KDZWmrztw2bwtFw (big blind) showed [4h Qs] and won ($0.95) with high card King
Seat 2: 16tvT7AYgZ2LgiGFcvFKQg (button) (small blind) mucked



PokerStars Game #59938480486:  Hold'em No Limit ($0.25/$0.50) - 2009/07/01 0:16:00 ET
Table 'c/CRn+68J3Y8KxD5g1ek2Q' 2-max Seat #1 is the button
Seat 1: 46qCyJ6evTkHo9al5sBMNA ($292.30 in chips)
Seat 2: BypVLsYQt3ePFm2xQL/dOA ($91.75 in chips)
46qCyJ6evTkHo9al5sBMNA: posts small blind $0.25
BypVLsYQt3ePFm2xQL/dOA: posts big blind $0.50
*** HOLE CARDS ***
46qCyJ6evTkHo9al5sBMNA: raises $1 to $1.50
BypVLsYQt3ePFm2xQL/dOA: raises $6 to $7.50
46qCyJ6evTkHo9al5sBMNA: calls $6
*** FLOP *** [6d Ks 5s]
BypVLsYQt3ePFm2xQL/dOA: checks
46qCyJ6evTkHo9al5sBMNA: bets $7
BypVLsYQt3ePFm2xQL/dOA: calls $7
*** TURN *** [6d Ks 5s] [4c]
BypVLsYQt3ePFm2xQL/dOA: checks
46qCyJ6evTkHo9al5sBMNA: checks
*** RIVER *** [6d Ks 5s 4c] [Ts]
BypVLsYQt3ePFm2xQL/dOA: bets $26.50
46qCyJ6evTkHo9al5sBMNA: folds
BypVLsYQt3ePFm2xQL/dOA collected $28.50 from pot
BypVLsYQt3ePFm2xQL/dOA: doesn't show hand
*** SUMMARY ***
Total pot $29 | Rake $0.50
Board [6d Ks 5s 4c Ts]
Seat 1: 46qCyJ6evTkHo9al5sBMNA (button) (small blind) folded on the River
Seat 2: BypVLsYQt3ePFm2xQL/dOA (big blind) collected ($28.50)



PokerStars Game #59938480736:  Hold'em No Limit ($0.25/$0.50) - 2009/07/01 0:16:00 ET
Table 'PALRfuH85dr5IkDfdv6new' 9-max Seat #2 is the button
Seat 1: SKnJuWHScqetA/qG5p+wCg ($32.25 in chips)
Seat 2: 9r7ZoBbAJj5IeyZ0q9BdzA ($13.15 in chips)
Seat 3: 50QWoELmpmHFrFIlWMJo9g ($90.70 in chips)
Seat 5: jSSGUXdNFAZA3QCvTcUMQw ($41 in chips)
Seat 6: EiWj2MAl8RNcPhTkzz24Mw ($34.85 in chips)
Seat 7: 3NcyXvr39gnK+KbTq7ezyA ($35.25 in chips)
Seat 8: NkS+CseUKx4XHszWq0PXEQ ($45.10 in chips)
Seat 9: CIrAX/m6o7jYmKOAjJXv4Q ($38.35 in chips)
50QWoELmpmHFrFIlWMJo9g: posts small blind $0.25
/gaxz7F0MIjSN3t7ZPKwAA: is sitting out
jSSGUXdNFAZA3QCvTcUMQw: posts big blind $0.50
*** HOLE CARDS ***
EiWj2MAl8RNcPhTkzz24Mw: calls $0.50
3NcyXvr39gnK+KbTq7ezyA: folds
NkS+CseUKx4XHszWq0PXEQ: folds
CIrAX/m6o7jYmKOAjJXv4Q: calls $0.50
SKnJuWHScqetA/qG5p+wCg: folds
9r7ZoBbAJj5IeyZ0q9BdzA: calls $0.50
50QWoELmpmHFrFIlWMJo9g: calls $0.25
/gaxz7F0MIjSN3t7ZPKwAA leaves the table
jSSGUXdNFAZA3QCvTcUMQw: checks
*** FLOP *** [9c 5s 9h]
50QWoELmpmHFrFIlWMJo9g: checks
jSSGUXdNFAZA3QCvTcUMQw: checks
EiWj2MAl8RNcPhTkzz24Mw: checks
CIrAX/m6o7jYmKOAjJXv4Q: checks
9r7ZoBbAJj5IeyZ0q9BdzA: bets $0.50
50QWoELmpmHFrFIlWMJo9g: folds
jSSGUXdNFAZA3QCvTcUMQw: folds
EiWj2MAl8RNcPhTkzz24Mw: calls $0.50
CIrAX/m6o7jYmKOAjJXv4Q: calls $0.50
*** TURN *** [9c 5s 9h] [8c]
EiWj2MAl8RNcPhTkzz24Mw: checks
crackmyn*ts joins the table at seat #4
crackmyn*ts leaves the table
CIrAX/m6o7jYmKOAjJXv4Q: checks
9r7ZoBbAJj5IeyZ0q9BdzA: checks
*** RIVER *** [9c 5s 9h 8c] [9s]
EiWj2MAl8RNcPhTkzz24Mw: checks
CIrAX/m6o7jYmKOAjJXv4Q: checks
9r7ZoBbAJj5IeyZ0q9BdzA: checks
*** SHOW DOWN ***
EiWj2MAl8RNcPhTkzz24Mw: shows [7h 7d] (a full house, Nines full of Sevens)
CIrAX/m6o7jYmKOAjJXv4Q: mucks hand
9r7ZoBbAJj5IeyZ0q9BdzA: mucks hand
EiWj2MAl8RNcPhTkzz24Mw collected $3.85 from pot
*** SUMMARY ***
Total pot $4 | Rake $0.15
Board [9c 5s 9h 8c 9s]
Seat 1: SKnJuWHScqetA/qG5p+wCg folded before Flop (didn't bet)
Seat 2: 9r7ZoBbAJj5IeyZ0q9BdzA (button) mucked
Seat 3: 50QWoELmpmHFrFIlWMJo9g (small blind) folded on the Flop
Seat 5: jSSGUXdNFAZA3QCvTcUMQw (big blind) folded on the Flop
Seat 6: EiWj2MAl8RNcPhTkzz24Mw showed [7h 7d] and won ($3.85) with a full house, Nines full of Sevens
Seat 7: 3NcyXvr39gnK+KbTq7ezyA folded before Flop (didn't bet)
Seat 8: NkS+CseUKx4XHszWq0PXEQ folded before Flop (didn't bet)
Seat 9: CIrAX/m6o7jYmKOAjJXv4Q mucked



PokerStars Game #59938481852:  Hold'em No Limit ($0.25/$0.50) - 2009/07/01 0:16:01 ET
Table 'kgbJRsxfv64KrErDRBAkcw' 6-max Seat #5 is the button
Seat 1: N7O9jUEx2YiQn1+yRYTHmw ($24.50 in chips)
Seat 2: Q+thC23WCv1kJUJtH/+4Jw ($33 in chips)
Seat 3: T0Gx/FcQ5VH9u7XaOMX97A ($61 in chips)
Seat 4: qanMEqjABjWxC/JgQ/0l7w ($58.45 in chips)
Seat 5: +Pf9jTVizYlIo+woPvptfA ($50 in chips)
Seat 6: DDfYzIrYT0t5R/hAJngtsg ($27.35 in chips)
DDfYzIrYT0t5R/hAJngtsg: posts small blind $0.25
N7O9jUEx2YiQn1+yRYTHmw: posts big blind $0.50
*** HOLE CARDS ***
Q+thC23WCv1kJUJtH/+4Jw: raises $1.50 to $2
T0Gx/FcQ5VH9u7XaOMX97A: folds
qanMEqjABjWxC/JgQ/0l7w: folds
+Pf9jTVizYlIo+woPvptfA: folds
DDfYzIrYT0t5R/hAJngtsg: calls $1.75
N7O9jUEx2YiQn1+yRYTHmw: folds
*** FLOP *** [Kc 9c Ad]
DDfYzIrYT0t5R/hAJngtsg: checks
Q+thC23WCv1kJUJtH/+4Jw: checks
*** TURN *** [Kc 9c Ad] [4s]
DDfYzIrYT0t5R/hAJngtsg: bets $1
Q+thC23WCv1kJUJtH/+4Jw: raises $3 to $4
DDfYzIrYT0t5R/hAJngtsg: calls $3
*** RIVER *** [Kc 9c Ad 4s] [2d]
DDfYzIrYT0t5R/hAJngtsg: checks
Q+thC23WCv1kJUJtH/+4Jw: bets $6
DDfYzIrYT0t5R/hAJngtsg: folds
Q+thC23WCv1kJUJtH/+4Jw collected $11.90 from pot
*** SUMMARY ***
Total pot $12.50 | Rake $0.60
Board [Kc 9c Ad 4s 2d]
Seat 1: N7O9jUEx2YiQn1+yRYTHmw (big blind) folded before Flop
Seat 2: Q+thC23WCv1kJUJtH/+4Jw collected ($11.90)
Seat 3: T0Gx/FcQ5VH9u7XaOMX97A folded before Flop (didn't bet)
Seat 4: qanMEqjABjWxC/JgQ/0l7w folded before Flop (didn't bet)
Seat 5: +Pf9jTVizYlIo+woPvptfA (button) folded before Flop (didn't bet)
Seat 6: DDfYzIrYT0t5R/hAJngtsg (small blind) folded on the River



PokerStars Game #59938482000:  Hold'em No Limit ($0.25/$0.50) - 2009/07/01 0:16:02 ET
Table 'mTxf8gPLgffN3Iwfm7Icfg' 2-max Seat #1 is the button
Seat 1: Do9Rlu1R5u/AcRtMTl8SYg ($58.90 in chips)
Seat 2: EMc5LPgVaded4Qc77vm0fw ($53.65 in chips)
Do9Rlu1R5u/AcRtMTl8SYg: posts small blind $0.25
EMc5LPgVaded4Qc77vm0fw: posts big blind $0.50
*** HOLE CARDS ***
Do9Rlu1R5u/AcRtMTl8SYg: calls $0.25
EMc5LPgVaded4Qc77vm0fw: raises $1.50 to $2
Do9Rlu1R5u/AcRtMTl8SYg: calls $1.50
*** FLOP *** [8s 7s Kh]
EMc5LPgVaded4Qc77vm0fw: bets $2.50
Do9Rlu1R5u/AcRtMTl8SYg: folds
EMc5LPgVaded4Qc77vm0fw collected $3.80 from pot
EMc5LPgVaded4Qc77vm0fw: doesn't show hand
*** SUMMARY ***
Total pot $4 | Rake $0.20
Board [8s 7s Kh]
Seat 1: Do9Rlu1R5u/AcRtMTl8SYg (button) (small blind) folded on the Flop
Seat 2: EMc5LPgVaded4Qc77vm0fw (big blind) collected ($3.80)



PokerStars Game #59938483530:  Hold'em No Limit ($0.25/$0.50) - 2009/07/01 0:16:04 ET
Table 'Nz0Vr7WMHL2g5Uk7dDZjpw' 9-max Seat #1 is the button
Seat 1: tLkxo7JgV+WWI0UBw44K5A ($102.75 in chips)
Seat 3: 4QTiNH5fteLgJjx/s6Hy6A ($6.40 in chips)
Seat 4: 5JJVDlaiMnB004o/RqbZZQ ($28.25 in chips)
Seat 5: WGW0DgjBUXs1ylURHG8vnQ ($18.10 in chips)
Seat 6: k1f0lS7tlMHCLGs0JT34Tg ($7.50 in chips)
Seat 7: KPLH0gELgFe2OuAnhJFI5w ($21.45 in chips)
Seat 8: HkZI6g4zl83TDTA7SRspmQ ($16 in chips)
Seat 9: Ak2W6V2TDVIQrvSAy4eD7Q ($27.55 in chips)
XNMDwbXt/Q4jM99AXnbJDw will be allowed to play after the button
4QTiNH5fteLgJjx/s6Hy6A: posts small blind $0.25
5JJVDlaiMnB004o/RqbZZQ: posts big blind $0.50
*** HOLE CARDS ***
WGW0DgjBUXs1ylURHG8vnQ: folds
k1f0lS7tlMHCLGs0JT34Tg: folds
KPLH0gELgFe2OuAnhJFI5w: folds
HkZI6g4zl83TDTA7SRspmQ: calls $0.50
Ak2W6V2TDVIQrvSAy4eD7Q: folds
tLkxo7JgV+WWI0UBw44K5A: raises $1.50 to $2
4QTiNH5fteLgJjx/s6Hy6A: folds
5JJVDlaiMnB004o/RqbZZQ: folds
HkZI6g4zl83TDTA7SRspmQ: calls $1.50
*** FLOP *** [Kc Tc Ts]
HkZI6g4zl83TDTA7SRspmQ: checks
tLkxo7JgV+WWI0UBw44K5A: bets $3.50
HkZI6g4zl83TDTA7SRspmQ: calls $3.50
*** TURN *** [Kc Tc Ts] [9c]
HkZI6g4zl83TDTA7SRspmQ: checks
tLkxo7JgV+WWI0UBw44K5A: checks
*** RIVER *** [Kc Tc Ts 9c] [7d]
HkZI6g4zl83TDTA7SRspmQ: bets $10.50 and is all-in
tLkxo7JgV+WWI0UBw44K5A: folds
HkZI6g4zl83TDTA7SRspmQ collected $11.20 from pot
*** SUMMARY ***
Total pot $11.75 | Rake $0.55
Board [Kc Tc Ts 9c 7d]
Seat 1: tLkxo7JgV+WWI0UBw44K5A (button) folded on the River
Seat 3: 4QTiNH5fteLgJjx/s6Hy6A (small blind) folded before Flop
Seat 4: 5JJVDlaiMnB004o/RqbZZQ (big blind) folded before Flop
Seat 5: WGW0DgjBUXs1ylURHG8vnQ folded before Flop (didn't bet)
Seat 6: k1f0lS7tlMHCLGs0JT34Tg folded before Flop (didn't bet)
Seat 7: KPLH0gELgFe2OuAnhJFI5w folded before Flop (didn't bet)
Seat 8: HkZI6g4zl83TDTA7SRspmQ collected ($11.20)
Seat 9: Ak2W6V2TDVIQrvSAy4eD7Q folded before Flop (didn't bet)



PokerStars Game #59938484058:  Hold'em No Limit ($0.25/$0.50) - 2009/07/01 0:16:05 ET
Table 'raOT4/ipuZgzjfKHC+jD9g' 2-max Seat #1 is the button
Seat 1: IuwLemwLhc9fvrwBGs0AMA ($14 in chips)
Seat 2: Udr5juWSWUgTu1NlRhjMdA ($8.65 in chips)
IuwLemwLhc9fvrwBGs0AMA: posts small blind $0.25
Udr5juWSWUgTu1NlRhjMdA: posts big blind $0.50
*** HOLE CARDS ***
IuwLemwLhc9fvrwBGs0AMA: raises $1 to $1.50
Udr5juWSWUgTu1NlRhjMdA: raises $7.15 to $8.65 and is all-in
IuwLemwLhc9fvrwBGs0AMA: folds
Udr5juWSWUgTu1NlRhjMdA collected $3 from pot
Udr5juWSWUgTu1NlRhjMdA: doesn't show hand
*** SUMMARY ***
Total pot $3 | Rake $0
Seat 1: IuwLemwLhc9fvrwBGs0AMA (button) (small blind) folded before Flop
Seat 2: Udr5juWSWUgTu1NlRhjMdA (big blind) collected ($3)



PokerStars Game #59938486080:  Hold'em No Limit ($0.25/$0.50) - 2009/07/01 0:16:08 ET
Table 'm95HVfesC/VPgfGEjPuaIA' 2-max Seat #1 is the button
Seat 1: Fp/oksNpipCrD2MJ2pH20g ($18.70 in chips)
Seat 2: Ag6DvxX4vbRheqsv2zXKTQ ($26.05 in chips)
Fp/oksNpipCrD2MJ2pH20g: posts small blind $0.25
Ag6DvxX4vbRheqsv2zXKTQ: posts big blind $0.50
*** HOLE CARDS ***
Fp/oksNpipCrD2MJ2pH20g: folds
Ag6DvxX4vbRheqsv2zXKTQ collected $0.50 from pot
*** SUMMARY ***
Total pot $0.50 | Rake $0
Seat 1: Fp/oksNpipCrD2MJ2pH20g (button) (small blind) folded before Flop
Seat 2: Ag6DvxX4vbRheqsv2zXKTQ (big blind) collected ($0.50)



PokerStars Game #59938487320:  Hold'em No Limit ($0.25/$0.50) - 2009/07/01 0:16:09 ET
Table 'QOgaEqMcJ73pcUMMxoisUg' 6-max Seat #4 is the button
Seat 1: RFefXIDyFvNtJLq+CloCzA ($41.70 in chips)
Seat 2: Im2p1Nt83UKSqv5c9frm4Q ($50 in chips)
Seat 3: wUZNozoIDYf+16hp4nn6dw ($44.95 in chips)
Seat 4: zAcsDhG/T128Vn7XGVSgKg ($54.40 in chips)
Seat 6: s83dnhZ6VC53vY0/f6OV/g ($48 in chips)
s83dnhZ6VC53vY0/f6OV/g: posts small blind $0.25
RFefXIDyFvNtJLq+CloCzA: posts big blind $0.50
*** HOLE CARDS ***
Im2p1Nt83UKSqv5c9frm4Q: folds
wUZNozoIDYf+16hp4nn6dw: raises $0.50 to $1
zAcsDhG/T128Vn7XGVSgKg: folds
s83dnhZ6VC53vY0/f6OV/g: calls $0.75
RFefXIDyFvNtJLq+CloCzA: folds
*** FLOP *** [Qs 6s Ac]
s83dnhZ6VC53vY0/f6OV/g: checks
wUZNozoIDYf+16hp4nn6dw: bets $3
s83dnhZ6VC53vY0/f6OV/g: folds
wUZNozoIDYf+16hp4nn6dw collected $2.40 from pot
*** SUMMARY ***
Total pot $2.50 | Rake $0.10
Board [Qs 6s Ac]
Seat 1: RFefXIDyFvNtJLq+CloCzA (big blind) folded before Flop
Seat 2: Im2p1Nt83UKSqv5c9frm4Q folded before Flop (didn't bet)
Seat 3: wUZNozoIDYf+16hp4nn6dw collected ($2.40)
Seat 4: zAcsDhG/T128Vn7XGVSgKg (button) folded before Flop (didn't bet)
Seat 6: s83dnhZ6VC53vY0/f6OV/g (small blind) folded on the Flop



PokerStars Game #59938488426:  Hold'em No Limit ($0.25/$0.50) - 2009/07/01 0:16:11 ET
Table '+z1aekfHkpp09pc8F9aViw' 6-max Seat #5 is the button
Seat 2: VuB2GN0h94yY+QbuI2Mybg ($21.65 in chips)
Seat 3: uUznlIMFnRUvwrBhYF73KA ($57.85 in chips)
Seat 4: OCrv7ObFH4/s2lv7rYOnsQ ($15.85 in chips)
Seat 5: crjGpJEzSZgD38FoE3VMGg ($64.40 in chips)
Seat 6: 686aeHikcJlgKkSuIFdcXQ ($70.75 in chips)
686aeHikcJlgKkSuIFdcXQ: posts small blind $0.25
VuB2GN0h94yY+QbuI2Mybg: posts big blind $0.50
*** HOLE CARDS ***
uUznlIMFnRUvwrBhYF73KA: raises $1 to $1.50
OCrv7ObFH4/s2lv7rYOnsQ: folds
OCrv7ObFH4/s2lv7rYOnsQ leaves the table
crjGpJEzSZgD38FoE3VMGg: folds
686aeHikcJlgKkSuIFdcXQ: folds
VuB2GN0h94yY+QbuI2Mybg: folds
lWwl5C/UZOsWNubdUqghZw is disconnected
uUznlIMFnRUvwrBhYF73KA collected $1.25 from pot
*** SUMMARY ***
Total pot $1.25 | Rake $0
Seat 2: VuB2GN0h94yY+QbuI2Mybg (big blind) folded before Flop
Seat 3: uUznlIMFnRUvwrBhYF73KA collected ($1.25)
Seat 4: OCrv7ObFH4/s2lv7rYOnsQ folded before Flop (didn't bet)
Seat 5: crjGpJEzSZgD38FoE3VMGg (button) folded before Flop (didn't bet)
Seat 6: 686aeHikcJlgKkSuIFdcXQ (small blind) folded before Flop



PokerStars Game #59938491176:  Hold'em No Limit ($0.25/$0.50) - 2009/07/01 0:16:15 ET
Table 'm95HVfesC/VPgfGEjPuaIA' 2-max Seat #2 is the button
Seat 1: Fp/oksNpipCrD2MJ2pH20g ($18.45 in chips)
Seat 2: Ag6DvxX4vbRheqsv2zXKTQ ($26.30 in chips)
Ag6DvxX4vbRheqsv2zXKTQ: posts small blind $0.25
Fp/oksNpipCrD2MJ2pH20g: posts big blind $0.50
*** HOLE CARDS ***
Ag6DvxX4vbRheqsv2zXKTQ: folds
Fp/oksNpipCrD2MJ2pH20g collected $0.50 from pot
Fp/oksNpipCrD2MJ2pH20g: doesn't show hand
*** SUMMARY ***
Total pot $0.50 | Rake $0
Seat 1: Fp/oksNpipCrD2MJ2pH20g (big blind) collected ($0.50)
Seat 2: Ag6DvxX4vbRheqsv2zXKTQ (button) (small blind) folded before Flop



PokerStars Game #59938491458:  Hold'em No Limit ($0.25/$0.50) - 2009/07/01 0:16:15 ET
Table 'tyR5AZNKV8Aadbrnrnlg7g' 6-max Seat #2 is the button
Seat 1: R+KjpH/wSjDLhtIy9+edNA ($52.35 in chips)
Seat 2: 58zdeSBSuSFX/qZfhc7YmA ($33.85 in chips)
Seat 3: jUhx+m+V7qfbLZTjgwZByg ($46.10 in chips)
Seat 4: Rt6KgtZ8YaJoTc3FPim00w ($50.50 in chips)
Seat 5: EIg3r3fRFKG2HhgpDlIJHg ($12.10 in chips)
Seat 6: DMQLAmut/l19xN5STQndFg ($15.65 in chips)
jUhx+m+V7qfbLZTjgwZByg: posts small blind $0.25
Rt6KgtZ8YaJoTc3FPim00w: posts big blind $0.50
*** HOLE CARDS ***
EIg3r3fRFKG2HhgpDlIJHg: folds
DMQLAmut/l19xN5STQndFg: folds
R+KjpH/wSjDLhtIy9+edNA: folds
58zdeSBSuSFX/qZfhc7YmA: folds
jUhx+m+V7qfbLZTjgwZByg: calls $0.25
Rt6KgtZ8YaJoTc3FPim00w: raises $1.50 to $2
jUhx+m+V7qfbLZTjgwZByg: folds
Rt6KgtZ8YaJoTc3FPim00w collected $1 from pot
Rt6KgtZ8YaJoTc3FPim00w: doesn't show hand
*** SUMMARY ***
Total pot $1 | Rake $0
Seat 1: R+KjpH/wSjDLhtIy9+edNA folded before Flop (didn't bet)
Seat 2: 58zdeSBSuSFX/qZfhc7YmA (button) folded before Flop (didn't bet)
Seat 3: jUhx+m+V7qfbLZTjgwZByg (small blind) folded before Flop
Seat 4: Rt6KgtZ8YaJoTc3FPim00w (big blind) collected ($1)
Seat 5: EIg3r3fRFKG2HhgpDlIJHg folded before Flop (didn't bet)
Seat 6: DMQLAmut/l19xN5STQndFg folded before Flop (didn't bet)



PokerStars Game #59938492316:  Hold'em No Limit ($0.25/$0.50) - 2009/07/01 0:16:17 ET
Table 'ZYwMb9E6tY50Qm+iNbXRYw' 2-max Seat #1 is the button
Seat 1: DXLfRb8KDZWmrztw2bwtFw ($21.10 in chips)
Seat 2: 16tvT7AYgZ2LgiGFcvFKQg ($15.40 in chips)
DXLfRb8KDZWmrztw2bwtFw: posts small blind $0.25
16tvT7AYgZ2LgiGFcvFKQg: posts big blind $0.50
*** HOLE CARDS ***
DXLfRb8KDZWmrztw2bwtFw: folds
16tvT7AYgZ2LgiGFcvFKQg collected $0.50 from pot
16tvT7AYgZ2LgiGFcvFKQg: doesn't show hand
*** SUMMARY ***
Total pot $0.50 | Rake $0
Seat 1: DXLfRb8KDZWmrztw2bwtFw (button) (small blind) folded before Flop
Seat 2: 16tvT7AYgZ2LgiGFcvFKQg (big blind) collected ($0.50)



PokerStars Game #59938492262:  Hold'em No Limit ($0.25/$0.50) - 2009/07/01 0:16:17 ET
Table 'lSisgp6H7Fg1hH5VfjEjYQ' 9-max Seat #4 is the button
Seat 1: pEW8B6uXbdR47kfljMQ3+Q ($38.95 in chips)
Seat 2: UrcnkQOiLVk8BlKDPJSy7Q ($51.10 in chips)
Seat 3: aTkyjTh3w5YLWiIERupZOA ($37.75 in chips)
Seat 4: nvw9yQKhJT56lA9k+TLdhw ($13.50 in chips)
Seat 5: mSD1pginDsyHG5PDfqzphw ($10.25 in chips)
Seat 6: +k7T5ocke8UwavtgUHm+Cg ($22.15 in chips)
Seat 7: dGw5MBstXyXhWHHVFOWOFA ($43.75 in chips)
Seat 8: a4JDWmpFQkL10XfAyuF51A ($27.50 in chips)
Seat 9: 5JJVDlaiMnB004o/RqbZZQ ($40.80 in chips)
mSD1pginDsyHG5PDfqzphw: posts small blind $0.25
+k7T5ocke8UwavtgUHm+Cg: posts big blind $0.50
*** HOLE CARDS ***
dGw5MBstXyXhWHHVFOWOFA: folds
a4JDWmpFQkL10XfAyuF51A: folds
5JJVDlaiMnB004o/RqbZZQ: folds
pEW8B6uXbdR47kfljMQ3+Q: folds
UrcnkQOiLVk8BlKDPJSy7Q: folds
aTkyjTh3w5YLWiIERupZOA: folds
nvw9yQKhJT56lA9k+TLdhw: raises $1 to $1.50
mSD1pginDsyHG5PDfqzphw: folds
+k7T5ocke8UwavtgUHm+Cg: folds
nvw9yQKhJT56lA9k+TLdhw collected $1.25 from pot
*** SUMMARY ***
Total pot $1.25 | Rake $0
Seat 1: pEW8B6uXbdR47kfljMQ3+Q folded before Flop (didn't bet)
Seat 2: UrcnkQOiLVk8BlKDPJSy7Q folded before Flop (didn't bet)
Seat 3: aTkyjTh3w5YLWiIERupZOA folded before Flop (didn't bet)
Seat 4: nvw9yQKhJT56lA9k+TLdhw (button) collected ($1.25)
Seat 5: mSD1pginDsyHG5PDfqzphw (small blind) folded before Flop
Seat 6: +k7T5ocke8UwavtgUHm+Cg (big blind) folded before Flop
Seat 7: dGw5MBstXyXhWHHVFOWOFA folded before Flop (didn't bet)
Seat 8: a4JDWmpFQkL10XfAyuF51A folded before Flop (didn't bet)
Seat 9: 5JJVDlaiMnB004o/RqbZZQ folded before Flop (didn't bet)



PokerStars Game #59938494434:  Hold'em No Limit ($0.25/$0.50) - 2009/07/01 0:16:20 ET
Table 'raOT4/ipuZgzjfKHC+jD9g' 2-max Seat #2 is the button
Seat 1: IuwLemwLhc9fvrwBGs0AMA ($12.50 in chips)
Seat 2: Udr5juWSWUgTu1NlRhjMdA ($10.15 in chips)
Udr5juWSWUgTu1NlRhjMdA: posts small blind $0.25
IuwLemwLhc9fvrwBGs0AMA: posts big blind $0.50
*** HOLE CARDS ***
Udr5juWSWUgTu1NlRhjMdA: folds
IuwLemwLhc9fvrwBGs0AMA collected $0.50 from pot
*** SUMMARY ***
Total pot $0.50 | Rake $0
Seat 1: IuwLemwLhc9fvrwBGs0AMA (big blind) collected ($0.50)
Seat 2: Udr5juWSWUgTu1NlRhjMdA (button) (small blind) folded before Flop



PokerStars Game #59938495574:  Hold'em No Limit ($0.25/$0.50) - 2009/07/01 0:16:21 ET
Table 'm95HVfesC/VPgfGEjPuaIA' 2-max Seat #1 is the button
Seat 1: Fp/oksNpipCrD2MJ2pH20g ($18.70 in chips)
Seat 2: Ag6DvxX4vbRheqsv2zXKTQ ($26.05 in chips)
Fp/oksNpipCrD2MJ2pH20g: posts small blind $0.25
Ag6DvxX4vbRheqsv2zXKTQ: posts big blind $0.50
*** HOLE CARDS ***
Fp/oksNpipCrD2MJ2pH20g: raises $1 to $1.50
Ag6DvxX4vbRheqsv2zXKTQ: calls $1
*** FLOP *** [Qh 7s 2c]
Ag6DvxX4vbRheqsv2zXKTQ: checks
Fp/oksNpipCrD2MJ2pH20g: bets $1.50
Ag6DvxX4vbRheqsv2zXKTQ: calls $1.50
*** TURN *** [Qh 7s 2c] [Td]
Ag6DvxX4vbRheqsv2zXKTQ: bets $1
Fp/oksNpipCrD2MJ2pH20g: calls $1
*** RIVER *** [Qh 7s 2c Td] [Ts]
Ag6DvxX4vbRheqsv2zXKTQ: checks
Fp/oksNpipCrD2MJ2pH20g: checks
*** SHOW DOWN ***
Ag6DvxX4vbRheqsv2zXKTQ: shows [Jc Qs] (two pair, Queens and Tens)
Fp/oksNpipCrD2MJ2pH20g: mucks hand
Ag6DvxX4vbRheqsv2zXKTQ collected $7.65 from pot
*** SUMMARY ***
Total pot $8 | Rake $0.35
Board [Qh 7s 2c Td Ts]
Seat 1: Fp/oksNpipCrD2MJ2pH20g (button) (small blind) mucked
Seat 2: Ag6DvxX4vbRheqsv2zXKTQ (big blind) showed [Jc Qs] and won ($7.65) with two pair, Queens and Tens



PokerStars Game #59938495572:  Hold'em No Limit ($0.25/$0.50) - 2009/07/01 0:16:21 ET
Table 'MJxeZCzYELxiIsyUZyT0jw' 6-max Seat #3 is the button
Seat 1: iKPos8JI094Tomq4tDSgnQ ($36.25 in chips)
Seat 2: r6H1GiZ6QIpMTDhyodKuRQ ($65.30 in chips)
Seat 3: JQZew0FjzS19kTjeNtrE+A ($50 in chips)
Seat 4: lP7Q6pewz4C2RsAfKsjdWw ($20.60 in chips)
Seat 5: 3jvoOXNtXE90w2BdfNZwZQ ($51.15 in chips)
Seat 6: TTx3CHxyi0SObcHyMJRp5w ($47.80 in chips)
lP7Q6pewz4C2RsAfKsjdWw: posts small blind $0.25
3jvoOXNtXE90w2BdfNZwZQ: posts big blind $0.50
*** HOLE CARDS ***
TTx3CHxyi0SObcHyMJRp5w: folds
iKPos8JI094Tomq4tDSgnQ: calls $0.50
r6H1GiZ6QIpMTDhyodKuRQ: folds
JQZew0FjzS19kTjeNtrE+A: calls $0.50
lP7Q6pewz4C2RsAfKsjdWw: raises $1.50 to $2
3jvoOXNtXE90w2BdfNZwZQ: calls $1.50
iKPos8JI094Tomq4tDSgnQ: calls $1.50
JQZew0FjzS19kTjeNtrE+A: calls $1.50
*** FLOP *** [4c 9h 3s]
lP7Q6pewz4C2RsAfKsjdWw: bets $3
3jvoOXNtXE90w2BdfNZwZQ: folds
iKPos8JI094Tomq4tDSgnQ: folds
JQZew0FjzS19kTjeNtrE+A: calls $3
*** TURN *** [4c 9h 3s] [5s]
lP7Q6pewz4C2RsAfKsjdWw: bets $15.60 and is all-in
JQZew0FjzS19kTjeNtrE+A: folds
lP7Q6pewz4C2RsAfKsjdWw collected $13.35 from pot
lP7Q6pewz4C2RsAfKsjdWw: doesn't show hand
*** SUMMARY ***
Total pot $14 | Rake $0.65
Board [4c 9h 3s 5s]
Seat 1: iKPos8JI094Tomq4tDSgnQ folded on the Flop
Seat 2: r6H1GiZ6QIpMTDhyodKuRQ folded before Flop (didn't bet)
Seat 3: JQZew0FjzS19kTjeNtrE+A (button) folded on the Turn
Seat 4: lP7Q6pewz4C2RsAfKsjdWw (small blind) collected ($13.35)
Seat 5: 3jvoOXNtXE90w2BdfNZwZQ (big blind) folded on the Flop
Seat 6: TTx3CHxyi0SObcHyMJRp5w folded before Flop (didn't bet)



PokerStars Game #59938495580:  Hold'em No Limit ($0.25/$0.50) - 2009/07/01 0:16:21 ET
Table 'hSTs/dUsYLgJQuF2Onp0MQ' 6-max Seat #4 is the button
Seat 2: gSCZnZGMgaRWmRw5txyZIA ($13.65 in chips)
Seat 3: vQOrJuXbLC3UZDVklY9bOA ($19.95 in chips)
Seat 4: L0aIPg7qefDQjdJo3HCVEA ($13.70 in chips)
Seat 5: 686aeHikcJlgKkSuIFdcXQ ($59.40 in chips)
686aeHikcJlgKkSuIFdcXQ: posts small blind $0.25
lWwl5C/UZOsWNubdUqghZw is disconnected
lWwl5C/UZOsWNubdUqghZw has timed out while disconnected
lWwl5C/UZOsWNubdUqghZw: is sitting out
gSCZnZGMgaRWmRw5txyZIA: posts big blind $0.50
*** HOLE CARDS ***
lWwl5C/UZOsWNubdUqghZw is connected
vQOrJuXbLC3UZDVklY9bOA: folds
lWwl5C/UZOsWNubdUqghZw leaves the table
L0aIPg7qefDQjdJo3HCVEA: folds
686aeHikcJlgKkSuIFdcXQ: folds
gSCZnZGMgaRWmRw5txyZIA collected $0.50 from pot
*** SUMMARY ***
Total pot $0.50 | Rake $0
Seat 2: gSCZnZGMgaRWmRw5txyZIA (big blind) collected ($0.50)
Seat 3: vQOrJuXbLC3UZDVklY9bOA folded before Flop (didn't bet)
Seat 4: L0aIPg7qefDQjdJo3HCVEA (button) folded before Flop (didn't bet)
Seat 5: 686aeHikcJlgKkSuIFdcXQ (small blind) folded before Flop



PokerStars Game #59938495624:  Hold'em No Limit ($0.25/$0.50) - 2009/07/01 0:16:22 ET
Table 'E7bWJ45aoFXRpyRv2gw+Ig' 2-max Seat #2 is the button
Seat 1: FRkiRasEGlHUeLrEl+k/nA ($50 in chips)
Seat 2: 3Wro85I7472vJ4Wkpneo9A ($131.85 in chips)
3Wro85I7472vJ4Wkpneo9A: posts small blind $0.25
FRkiRasEGlHUeLrEl+k/nA: posts big blind $0.50
*** HOLE CARDS ***
3Wro85I7472vJ4Wkpneo9A: calls $0.25
FRkiRasEGlHUeLrEl+k/nA: checks
*** FLOP *** [6c 2s 6s]
FRkiRasEGlHUeLrEl+k/nA: checks
3Wro85I7472vJ4Wkpneo9A: checks
*** TURN *** [6c 2s 6s] [Tc]
FRkiRasEGlHUeLrEl+k/nA: checks
3Wro85I7472vJ4Wkpneo9A: checks
*** RIVER *** [6c 2s 6s Tc] [5s]
FRkiRasEGlHUeLrEl+k/nA: bets $1
3Wro85I7472vJ4Wkpneo9A: folds
FRkiRasEGlHUeLrEl+k/nA collected $0.95 from pot
FRkiRasEGlHUeLrEl+k/nA: doesn't show hand
*** SUMMARY ***
Total pot $1 | Rake $0.05
Board [6c 2s 6s Tc 5s]
Seat 1: FRkiRasEGlHUeLrEl+k/nA (big blind) collected ($0.95)
Seat 2: 3Wro85I7472vJ4Wkpneo9A (button) (small blind) folded on the River



PokerStars Game #59938496498:  Hold'em No Limit ($0.25/$0.50) - 2009/07/01 0:16:23 ET
Table 'ZYwMb9E6tY50Qm+iNbXRYw' 2-max Seat #2 is the button
Seat 1: DXLfRb8KDZWmrztw2bwtFw ($20.85 in chips)
Seat 2: 16tvT7AYgZ2LgiGFcvFKQg ($15.65 in chips)
16tvT7AYgZ2LgiGFcvFKQg: posts small blind $0.25
DXLfRb8KDZWmrztw2bwtFw: posts big blind $0.50
*** HOLE CARDS ***
16tvT7AYgZ2LgiGFcvFKQg: raises $0.50 to $1
DXLfRb8KDZWmrztw2bwtFw: calls $0.50
*** FLOP *** [2d Jd Kh]
DXLfRb8KDZWmrztw2bwtFw: bets $2
16tvT7AYgZ2LgiGFcvFKQg: folds
DXLfRb8KDZWmrztw2bwtFw collected $1.90 from pot
DXLfRb8KDZWmrztw2bwtFw: doesn't show hand
*** SUMMARY ***
Total pot $2 | Rake $0.10
Board [2d Jd Kh]
Seat 1: DXLfRb8KDZWmrztw2bwtFw (big blind) collected ($1.90)
Seat 2: 16tvT7AYgZ2LgiGFcvFKQg (button) (small blind) folded on the Flop



PokerStars Game #59938498012:  Hold'em No Limit ($0.25/$0.50) - 2009/07/01 0:16:25 ET
Table 'T/PgNWqVyY6lkldcBVXYJQ' 6-max Seat #1 is the button
Seat 1: +Pf9jTVizYlIo+woPvptfA ($52.45 in chips)
Seat 2: oZAeY5rVqNGgt8yyQ0pxbA ($22.80 in chips)
Seat 3: L3OcNO1bgdqDI46j67KQPQ ($56.30 in chips)
Seat 4: jxMvxeUUL9UU0V6wVU+Iyw ($9.95 in chips)
Seat 5: vVQBckETtigfb5mAcyK0OA ($60.75 in chips)
Seat 6: cDzbog6kwmJp+LBeBq+iMQ ($17.10 in chips)
oZAeY5rVqNGgt8yyQ0pxbA: posts small blind $0.25
L3OcNO1bgdqDI46j67KQPQ: posts big blind $0.50
*** HOLE CARDS ***
jxMvxeUUL9UU0V6wVU+Iyw: folds
vVQBckETtigfb5mAcyK0OA: folds
cDzbog6kwmJp+LBeBq+iMQ: folds
+Pf9jTVizYlIo+woPvptfA: folds
oZAeY5rVqNGgt8yyQ0pxbA: folds
vVQBckETtigfb5mAcyK0OA said, "FIGURES WHEN U WAS SHORT $$"
jxMvxeUUL9UU0V6wVU+Iyw said, "Can't go all in forever.  so what is it??"
L3OcNO1bgdqDI46j67KQPQ collected $0.50 from pot
L3OcNO1bgdqDI46j67KQPQ: doesn't show hand
*** SUMMARY ***
Total pot $0.50 | Rake $0
Seat 1: +Pf9jTVizYlIo+woPvptfA (button) folded before Flop (didn't bet)
Seat 2: oZAeY5rVqNGgt8yyQ0pxbA (small blind) folded before Flop
Seat 3: L3OcNO1bgdqDI46j67KQPQ (big blind) collected ($0.50)
Seat 4: jxMvxeUUL9UU0V6wVU+Iyw folded before Flop (didn't bet)
Seat 5: vVQBckETtigfb5mAcyK0OA folded before Flop (didn't bet)
Seat 6: cDzbog6kwmJp+LBeBq+iMQ folded before Flop (didn't bet)



PokerStars Game #59938499022:  Hold'em No Limit ($0.25/$0.50) - 2009/07/01 0:16:26 ET
Table 'raOT4/ipuZgzjfKHC+jD9g' 2-max Seat #1 is the button
Seat 1: IuwLemwLhc9fvrwBGs0AMA ($12.75 in chips)
Seat 2: Udr5juWSWUgTu1NlRhjMdA ($9.90 in chips)
IuwLemwLhc9fvrwBGs0AMA: posts small blind $0.25
Udr5juWSWUgTu1NlRhjMdA: posts big blind $0.50
*** HOLE CARDS ***
IuwLemwLhc9fvrwBGs0AMA: folds
Udr5juWSWUgTu1NlRhjMdA collected $0.50 from pot
Udr5juWSWUgTu1NlRhjMdA: doesn't show hand
*** SUMMARY ***
Total pot $0.50 | Rake $0
Seat 1: IuwLemwLhc9fvrwBGs0AMA (button) (small blind) folded before Flop
Seat 2: Udr5juWSWUgTu1NlRhjMdA (big blind) collected ($0.50)



PokerStars Game #59938500858:  Hold'em No Limit ($0.25/$0.50) - 2009/07/01 0:16:29 ET
Table '+dXkOAQyS8j9PQZusUTMpg' 2-max Seat #2 is the button
Seat 1: XFa6sBGjP2gxoIvxR3fZIg ($83.40 in chips)
Seat 2: 5IBeOgaApY1Bvzv2P8X4EA ($27.10 in chips)
5IBeOgaApY1Bvzv2P8X4EA: posts small blind $0.25
XFa6sBGjP2gxoIvxR3fZIg: posts big blind $0.50
*** HOLE CARDS ***
5IBeOgaApY1Bvzv2P8X4EA: folds
XFa6sBGjP2gxoIvxR3fZIg said, "I know I had my share today"
XFa6sBGjP2gxoIvxR3fZIg collected $0.50 from pot
*** SUMMARY ***
Total pot $0.50 | Rake $0
Seat 1: XFa6sBGjP2gxoIvxR3fZIg (big blind) collected ($0.50)
Seat 2: 5IBeOgaApY1Bvzv2P8X4EA (button) (small blind) folded before Flop



PokerStars Game #59938502364:  Hold'em No Limit ($0.25/$0.50) - 2009/07/01 0:16:31 ET
Table 'mTxf8gPLgffN3Iwfm7Icfg' 2-max Seat #2 is the button
Seat 1: Do9Rlu1R5u/AcRtMTl8SYg ($56.90 in chips)
Seat 2: EMc5LPgVaded4Qc77vm0fw ($55.45 in chips)
EMc5LPgVaded4Qc77vm0fw: posts small blind $0.25
Do9Rlu1R5u/AcRtMTl8SYg: posts big blind $0.50
*** HOLE CARDS ***
EMc5LPgVaded4Qc77vm0fw: folds
Do9Rlu1R5u/AcRtMTl8SYg collected $0.50 from pot
Do9Rlu1R5u/AcRtMTl8SYg: doesn't show hand
*** SUMMARY ***
Total pot $0.50 | Rake $0
Seat 1: Do9Rlu1R5u/AcRtMTl8SYg (big blind) collected ($0.50)
Seat 2: EMc5LPgVaded4Qc77vm0fw (button) (small blind) folded before Flop



PokerStars Game #59938503912:  Hold'em No Limit ($0.25/$0.50) - 2009/07/01 0:16:34 ET
Table 'ZYwMb9E6tY50Qm+iNbXRYw' 2-max Seat #1 is the button
Seat 1: DXLfRb8KDZWmrztw2bwtFw ($21.75 in chips)
Seat 2: 16tvT7AYgZ2LgiGFcvFKQg ($14.65 in chips)
DXLfRb8KDZWmrztw2bwtFw: posts small blind $0.25
16tvT7AYgZ2LgiGFcvFKQg: posts big blind $0.50
*** HOLE CARDS ***
DXLfRb8KDZWmrztw2bwtFw: folds
16tvT7AYgZ2LgiGFcvFKQg collected $0.50 from pot
16tvT7AYgZ2LgiGFcvFKQg: doesn't show hand
*** SUMMARY ***
Total pot $0.50 | Rake $0
Seat 1: DXLfRb8KDZWmrztw2bwtFw (button) (small blind) folded before Flop
Seat 2: 16tvT7AYgZ2LgiGFcvFKQg (big blind) collected ($0.50)



PokerStars Game #59938504782:  Hold'em No Limit ($0.25/$0.50) - 2009/07/01 0:16:35 ET
Table '+dXkOAQyS8j9PQZusUTMpg' 2-max Seat #1 is the button
Seat 1: XFa6sBGjP2gxoIvxR3fZIg ($83.65 in chips)
Seat 2: 5IBeOgaApY1Bvzv2P8X4EA ($26.85 in chips)
XFa6sBGjP2gxoIvxR3fZIg: posts small blind $0.25
5IBeOgaApY1Bvzv2P8X4EA: posts big blind $0.50
*** HOLE CARDS ***
XFa6sBGjP2gxoIvxR3fZIg: raises $1 to $1.50
5IBeOgaApY1Bvzv2P8X4EA: raises $1.50 to $3
XFa6sBGjP2gxoIvxR3fZIg: raises $43.50 to $46.50
5IBeOgaApY1Bvzv2P8X4EA: folds
XFa6sBGjP2gxoIvxR3fZIg collected $6 from pot
XFa6sBGjP2gxoIvxR3fZIg: doesn't show hand
*** SUMMARY ***
Total pot $6 | Rake $0
Seat 1: XFa6sBGjP2gxoIvxR3fZIg (button) (small blind) collected ($6)
Seat 2: 5IBeOgaApY1Bvzv2P8X4EA (big blind) folded before Flop



PokerStars Game #59938505694:  Hold'em No Limit ($0.25/$0.50) - 2009/07/01 0:16:36 ET
Table '3FhG0gl3kMX3wBEEqj+wnQ' 9-max Seat #5 is the button
Seat 1: e0J9pdCNUDTCG031RnXqLA ($22.20 in chips)
Seat 2: 4dl3YNqZ6Houm2jZAzDmRg ($24.50 in chips)
Seat 4: bz4LMfV0GGl/MJ/ABXuPmg ($26.20 in chips)
Seat 5: XNMDwbXt/Q4jM99AXnbJDw ($55.55 in chips)
Seat 6: 5JJVDlaiMnB004o/RqbZZQ ($25.50 in chips)
Seat 7: mSD1pginDsyHG5PDfqzphw ($10 in chips)
Seat 8: j3K/Jujr7PY4ZM2RZvlH6A ($39.70 in chips)
Seat 9: tzoXBDwkkPV/XPJPkf963Q ($16.50 in chips)
5JJVDlaiMnB004o/RqbZZQ: posts small blind $0.25
mSD1pginDsyHG5PDfqzphw: posts big blind $0.50
dennisa: sits out
*** HOLE CARDS ***
j3K/Jujr7PY4ZM2RZvlH6A: folds
tzoXBDwkkPV/XPJPkf963Q: calls $0.50
e0J9pdCNUDTCG031RnXqLA: raises $0.50 to $1
4dl3YNqZ6Houm2jZAzDmRg: folds
bz4LMfV0GGl/MJ/ABXuPmg: folds
XNMDwbXt/Q4jM99AXnbJDw: folds
5JJVDlaiMnB004o/RqbZZQ: calls $0.75
mSD1pginDsyHG5PDfqzphw: folds
tzoXBDwkkPV/XPJPkf963Q: calls $0.50
*** FLOP *** [2s 3c 5h]
5JJVDlaiMnB004o/RqbZZQ: checks
tzoXBDwkkPV/XPJPkf963Q: checks
e0J9pdCNUDTCG031RnXqLA: bets $2.20
5JJVDlaiMnB004o/RqbZZQ: folds
tzoXBDwkkPV/XPJPkf963Q: calls $2.20
*** TURN *** [2s 3c 5h] [Jc]
tzoXBDwkkPV/XPJPkf963Q: checks
e0J9pdCNUDTCG031RnXqLA: bets $3.50
tzoXBDwkkPV/XPJPkf963Q: calls $3.50
*** RIVER *** [2s 3c 5h Jc] [4s]
tzoXBDwkkPV/XPJPkf963Q: checks
e0J9pdCNUDTCG031RnXqLA: bets $9.80
tzoXBDwkkPV/XPJPkf963Q: calls $9.80 and is all-in
*** SHOW DOWN ***
e0J9pdCNUDTCG031RnXqLA: shows [As Tc] (a straight, Ace to Five)
tzoXBDwkkPV/XPJPkf963Q: shows [6s 4d] (a straight, Deuce to Six)
tzoXBDwkkPV/XPJPkf963Q collected $32.85 from pot
*** SUMMARY ***
Total pot $34.50 | Rake $1.65
Board [2s 3c 5h Jc 4s]
Seat 1: e0J9pdCNUDTCG031RnXqLA showed [As Tc] and lost with a straight, Ace to Five
Seat 2: 4dl3YNqZ6Houm2jZAzDmRg folded before Flop (didn't bet)
Seat 4: bz4LMfV0GGl/MJ/ABXuPmg folded before Flop (didn't bet)
Seat 5: XNMDwbXt/Q4jM99AXnbJDw (button) folded before Flop (didn't bet)
Seat 6: 5JJVDlaiMnB004o/RqbZZQ (small blind) folded on the Flop
Seat 7: mSD1pginDsyHG5PDfqzphw (big blind) folded before Flop
Seat 8: j3K/Jujr7PY4ZM2RZvlH6A folded before Flop (didn't bet)
Seat 9: tzoXBDwkkPV/XPJPkf963Q showed [6s 4d] and won ($32.85) with a straight, Deuce to Six



PokerStars Game #59938506204:  Hold'em No Limit ($0.25/$0.50) - 2009/07/01 0:16:37 ET
Table 'mTxf8gPLgffN3Iwfm7Icfg' 2-max Seat #1 is the button
Seat 1: Do9Rlu1R5u/AcRtMTl8SYg ($57.15 in chips)
Seat 2: EMc5LPgVaded4Qc77vm0fw ($55.20 in chips)
Do9Rlu1R5u/AcRtMTl8SYg: posts small blind $0.25
EMc5LPgVaded4Qc77vm0fw: posts big blind $0.50
*** HOLE CARDS ***
Do9Rlu1R5u/AcRtMTl8SYg: folds
EMc5LPgVaded4Qc77vm0fw collected $0.50 from pot
EMc5LPgVaded4Qc77vm0fw: doesn't show hand
*** SUMMARY ***
Total pot $0.50 | Rake $0
Seat 1: Do9Rlu1R5u/AcRtMTl8SYg (button) (small blind) folded before Flop
Seat 2: EMc5LPgVaded4Qc77vm0fw (big blind) collected ($0.50)



PokerStars Game #59938507694:  Hold'em No Limit ($0.25/$0.50) - 2009/07/01 0:16:39 ET
Table 'QOgaEqMcJ73pcUMMxoisUg' 6-max Seat #6 is the button
Seat 1: RFefXIDyFvNtJLq+CloCzA ($41.20 in chips)
Seat 2: Im2p1Nt83UKSqv5c9frm4Q ($50 in chips)
Seat 3: wUZNozoIDYf+16hp4nn6dw ($46.35 in chips)
Seat 4: zAcsDhG/T128Vn7XGVSgKg ($54.40 in chips)
Seat 6: s83dnhZ6VC53vY0/f6OV/g ($47 in chips)
RFefXIDyFvNtJLq+CloCzA: posts small blind $0.25
Im2p1Nt83UKSqv5c9frm4Q: posts big blind $0.50
*** HOLE CARDS ***
wUZNozoIDYf+16hp4nn6dw: calls $0.50
zAcsDhG/T128Vn7XGVSgKg: folds
s83dnhZ6VC53vY0/f6OV/g: folds
RFefXIDyFvNtJLq+CloCzA: folds
Im2p1Nt83UKSqv5c9frm4Q: checks
*** FLOP *** [Qh Jc 6c]
Im2p1Nt83UKSqv5c9frm4Q: checks
wUZNozoIDYf+16hp4nn6dw: checks
*** TURN *** [Qh Jc 6c] [9c]
Im2p1Nt83UKSqv5c9frm4Q: checks
wUZNozoIDYf+16hp4nn6dw: bets $1.50
Im2p1Nt83UKSqv5c9frm4Q: folds
wUZNozoIDYf+16hp4nn6dw collected $1.20 from pot
*** SUMMARY ***
Total pot $1.25 | Rake $0.05
Board [Qh Jc 6c 9c]
Seat 1: RFefXIDyFvNtJLq+CloCzA (small blind) folded before Flop
Seat 2: Im2p1Nt83UKSqv5c9frm4Q (big blind) folded on the Turn
Seat 3: wUZNozoIDYf+16hp4nn6dw collected ($1.20)
Seat 4: zAcsDhG/T128Vn7XGVSgKg folded before Flop (didn't bet)
Seat 6: s83dnhZ6VC53vY0/f6OV/g (button) folded before Flop (didn't bet)



PokerStars Game #59938508162:  Hold'em No Limit ($0.25/$0.50) - 2009/07/01 0:16:40 ET
Table 'ZYwMb9E6tY50Qm+iNbXRYw' 2-max Seat #2 is the button
Seat 1: DXLfRb8KDZWmrztw2bwtFw ($21.50 in chips)
Seat 2: 16tvT7AYgZ2LgiGFcvFKQg ($14.90 in chips)
16tvT7AYgZ2LgiGFcvFKQg: posts small blind $0.25
DXLfRb8KDZWmrztw2bwtFw: posts big blind $0.50
*** HOLE CARDS ***
16tvT7AYgZ2LgiGFcvFKQg: raises $1 to $1.50
DXLfRb8KDZWmrztw2bwtFw: folds
16tvT7AYgZ2LgiGFcvFKQg collected $1 from pot
*** SUMMARY ***
Total pot $1 | Rake $0
Seat 1: DXLfRb8KDZWmrztw2bwtFw (big blind) folded before Flop
Seat 2: 16tvT7AYgZ2LgiGFcvFKQg (button) (small blind) collected ($1)



PokerStars Game #59938509078:  Hold'em No Limit ($0.25/$0.50) - 2009/07/01 0:16:41 ET
Table 'raOT4/ipuZgzjfKHC+jD9g' 2-max Seat #2 is the button
Seat 1: IuwLemwLhc9fvrwBGs0AMA ($12.50 in chips)
Seat 2: Udr5juWSWUgTu1NlRhjMdA ($10.15 in chips)
Udr5juWSWUgTu1NlRhjMdA: posts small blind $0.25
IuwLemwLhc9fvrwBGs0AMA: posts big blind $0.50
*** HOLE CARDS ***
Udr5juWSWUgTu1NlRhjMdA: raises $1 to $1.50
IuwLemwLhc9fvrwBGs0AMA: folds
Udr5juWSWUgTu1NlRhjMdA collected $1 from pot
Udr5juWSWUgTu1NlRhjMdA: doesn't show hand
*** SUMMARY ***
Total pot $1 | Rake $0
Seat 1: IuwLemwLhc9fvrwBGs0AMA (big blind) folded before Flop
Seat 2: Udr5juWSWUgTu1NlRhjMdA (button) (small blind) collected ($1)



PokerStars Game #59938508954:  Hold'em No Limit ($0.25/$0.50) - 2009/07/01 0:16:41 ET
Table 'tyR5AZNKV8Aadbrnrnlg7g' 6-max Seat #3 is the button
Seat 1: R+KjpH/wSjDLhtIy9+edNA ($52.35 in chips)
Seat 2: 58zdeSBSuSFX/qZfhc7YmA ($33.85 in chips)
Seat 3: jUhx+m+V7qfbLZTjgwZByg ($45.60 in chips)
Seat 4: Rt6KgtZ8YaJoTc3FPim00w ($51 in chips)
Seat 5: EIg3r3fRFKG2HhgpDlIJHg ($12.10 in chips)
Seat 6: DMQLAmut/l19xN5STQndFg ($15.65 in chips)
Rt6KgtZ8YaJoTc3FPim00w: posts small blind $0.25
EIg3r3fRFKG2HhgpDlIJHg: posts big blind $0.50
*** HOLE CARDS ***
DMQLAmut/l19xN5STQndFg has timed out
DMQLAmut/l19xN5STQndFg: folds
DMQLAmut/l19xN5STQndFg is sitting out
R+KjpH/wSjDLhtIy9+edNA: folds
58zdeSBSuSFX/qZfhc7YmA: folds
DMQLAmut/l19xN5STQndFg has returned
jUhx+m+V7qfbLZTjgwZByg: calls $0.50
Rt6KgtZ8YaJoTc3FPim00w: calls $0.25
EIg3r3fRFKG2HhgpDlIJHg: checks
*** FLOP *** [5h Qc 6s]
Rt6KgtZ8YaJoTc3FPim00w: checks
EIg3r3fRFKG2HhgpDlIJHg: bets $1
jUhx+m+V7qfbLZTjgwZByg: calls $1
Rt6KgtZ8YaJoTc3FPim00w: calls $1
*** TURN *** [5h Qc 6s] [5d]
Rt6KgtZ8YaJoTc3FPim00w: checks
EIg3r3fRFKG2HhgpDlIJHg: bets $0.50
jUhx+m+V7qfbLZTjgwZByg: raises $2 to $2.50
Rt6KgtZ8YaJoTc3FPim00w: raises $5.50 to $8
EIg3r3fRFKG2HhgpDlIJHg: calls $7.50
jUhx+m+V7qfbLZTjgwZByg: calls $5.50
*** RIVER *** [5h Qc 6s 5d] [9c]
Rt6KgtZ8YaJoTc3FPim00w: bets $20
EIg3r3fRFKG2HhgpDlIJHg: folds
jUhx+m+V7qfbLZTjgwZByg: calls $20
*** SHOW DOWN ***
Rt6KgtZ8YaJoTc3FPim00w: shows [As 5s] (three of a kind, Fives)
jUhx+m+V7qfbLZTjgwZByg: shows [5c Tc] (three of a kind, Fives - lower kicker)
Rt6KgtZ8YaJoTc3FPim00w collected $65.50 from pot
*** SUMMARY ***
Total pot $68.50 | Rake $3
Board [5h Qc 6s 5d 9c]
Seat 1: R+KjpH/wSjDLhtIy9+edNA folded before Flop (didn't bet)
Seat 2: 58zdeSBSuSFX/qZfhc7YmA folded before Flop (didn't bet)
Seat 3: jUhx+m+V7qfbLZTjgwZByg (button) showed [5c Tc] and lost with three of a kind, Fives
Seat 4: Rt6KgtZ8YaJoTc3FPim00w (small blind) showed [As 5s] and won ($65.50) with three of a kind, Fives
Seat 5: EIg3r3fRFKG2HhgpDlIJHg (big blind) folded on the River
Seat 6: DMQLAmut/l19xN5STQndFg folded before Flop (didn't bet)



PokerStars Game #59938509452:  Hold'em No Limit ($0.25/$0.50) - 2009/07/01 0:16:42 ET
Table 'T/PgNWqVyY6lkldcBVXYJQ' 6-max Seat #2 is the button
Seat 1: +Pf9jTVizYlIo+woPvptfA ($52.45 in chips)
Seat 2: oZAeY5rVqNGgt8yyQ0pxbA ($22.55 in chips)
Seat 3: L3OcNO1bgdqDI46j67KQPQ ($56.55 in chips)
Seat 4: jxMvxeUUL9UU0V6wVU+Iyw ($9.95 in chips)
Seat 5: vVQBckETtigfb5mAcyK0OA ($60.75 in chips)
Seat 6: cDzbog6kwmJp+LBeBq+iMQ ($17.10 in chips)
L3OcNO1bgdqDI46j67KQPQ: posts small blind $0.25
cDzbog6kwmJp+LBeBq+iMQ said, "knew*"
jxMvxeUUL9UU0V6wVU+Iyw: posts big blind $0.50
*** HOLE CARDS ***
vVQBckETtigfb5mAcyK0OA: calls $0.50
cDzbog6kwmJp+LBeBq+iMQ: folds
+Pf9jTVizYlIo+woPvptfA: folds
oZAeY5rVqNGgt8yyQ0pxbA: calls $0.50
L3OcNO1bgdqDI46j67KQPQ: calls $0.25
cDzbog6kwmJp+LBeBq+iMQ said, "and why dont you kill the caps lock... ****ing obscene"
jxMvxeUUL9UU0V6wVU+Iyw: raises $9.45 to $9.95 and is all-in
vVQBckETtigfb5mAcyK0OA: folds
oZAeY5rVqNGgt8yyQ0pxbA: folds
vVQBckETtigfb5mAcyK0OA said, "I LIKE IT LOL"
L3OcNO1bgdqDI46j67KQPQ: folds
jxMvxeUUL9UU0V6wVU+Iyw collected $2 from pot
jxMvxeUUL9UU0V6wVU+Iyw: doesn't show hand
*** SUMMARY ***
Total pot $2 | Rake $0
Seat 1: +Pf9jTVizYlIo+woPvptfA folded before Flop (didn't bet)
Seat 2: oZAeY5rVqNGgt8yyQ0pxbA (button) folded before Flop
Seat 3: L3OcNO1bgdqDI46j67KQPQ (small blind) folded before Flop
Seat 4: jxMvxeUUL9UU0V6wVU+Iyw (big blind) collected ($2)
Seat 5: vVQBckETtigfb5mAcyK0OA folded before Flop
Seat 6: cDzbog6kwmJp+LBeBq+iMQ folded before Flop (didn't bet)



PokerStars Game #59938509486:  Hold'em No Limit ($0.25/$0.50) - 2009/07/01 0:16:42 ET
Table 'E7bWJ45aoFXRpyRv2gw+Ig' 2-max Seat #1 is the button
Seat 1: FRkiRasEGlHUeLrEl+k/nA ($50.45 in chips)
Seat 2: 3Wro85I7472vJ4Wkpneo9A ($131.35 in chips)
FRkiRasEGlHUeLrEl+k/nA: posts small blind $0.25
3Wro85I7472vJ4Wkpneo9A: posts big blind $0.50
*** HOLE CARDS ***
FRkiRasEGlHUeLrEl+k/nA: folds
3Wro85I7472vJ4Wkpneo9A collected $0.50 from pot
3Wro85I7472vJ4Wkpneo9A: doesn't show hand
*** SUMMARY ***
Total pot $0.50 | Rake $0
Seat 1: FRkiRasEGlHUeLrEl+k/nA (button) (small blind) folded before Flop
Seat 2: 3Wro85I7472vJ4Wkpneo9A (big blind) collected ($0.50)



PokerStars Game #59938509724:  Hold'em No Limit ($0.25/$0.50) - 2009/07/01 0:16:42 ET
Table 'X6IRCRTh+20gjz8aubWnwA' 9-max Seat #2 is the button
Seat 2: RjBdQ6w31rgcy0o24VLR6w ($10.90 in chips)
Seat 3: mSD1pginDsyHG5PDfqzphw ($10 in chips)
Seat 4: uw9QayAAxLM3Hb+HR7mSkg ($10.25 in chips)
Seat 5: L5e2lrPLQm1Pqx30IIZ/Fw ($15.40 in chips)
Seat 6: /6In1zC3WtgwxDcueWzZWg ($58.10 in chips)
Seat 7: VBnpbzn0dIveV55qKvciew ($54.70 in chips)
Seat 8: BPMN9sOItJw6vWq3kypaYg ($26.50 in chips)
Seat 9: M+7+BTmX5vZatHVuoRB1nA ($82.60 in chips)
mSD1pginDsyHG5PDfqzphw: posts small blind $0.25
uw9QayAAxLM3Hb+HR7mSkg: posts big blind $0.50
*** HOLE CARDS ***
L5e2lrPLQm1Pqx30IIZ/Fw: folds
/6In1zC3WtgwxDcueWzZWg: folds
VBnpbzn0dIveV55qKvciew: folds
BPMN9sOItJw6vWq3kypaYg: folds
M+7+BTmX5vZatHVuoRB1nA: folds
RjBdQ6w31rgcy0o24VLR6w: folds
mSD1pginDsyHG5PDfqzphw: folds
uw9QayAAxLM3Hb+HR7mSkg collected $0.50 from pot
uw9QayAAxLM3Hb+HR7mSkg: doesn't show hand
*** SUMMARY ***
Total pot $0.50 | Rake $0
Seat 2: RjBdQ6w31rgcy0o24VLR6w (button) folded before Flop (didn't bet)
Seat 3: mSD1pginDsyHG5PDfqzphw (small blind) folded before Flop
Seat 4: uw9QayAAxLM3Hb+HR7mSkg (big blind) collected ($0.50)
Seat 5: L5e2lrPLQm1Pqx30IIZ/Fw folded before Flop (didn't bet)
Seat 6: /6In1zC3WtgwxDcueWzZWg folded before Flop (didn't bet)
Seat 7: VBnpbzn0dIveV55qKvciew folded before Flop (didn't bet)
Seat 8: BPMN9sOItJw6vWq3kypaYg folded before Flop (didn't bet)
Seat 9: M+7+BTmX5vZatHVuoRB1nA folded before Flop (didn't bet)



PokerStars Game #59938510296:  Hold'em No Limit ($0.25/$0.50) - 2009/07/01 0:16:43 ET
Table 'mTxf8gPLgffN3Iwfm7Icfg' 2-max Seat #2 is the button
Seat 1: Do9Rlu1R5u/AcRtMTl8SYg ($56.90 in chips)
Seat 2: EMc5LPgVaded4Qc77vm0fw ($55.45 in chips)
EMc5LPgVaded4Qc77vm0fw: posts small blind $0.25
Do9Rlu1R5u/AcRtMTl8SYg: posts big blind $0.50
*** HOLE CARDS ***
EMc5LPgVaded4Qc77vm0fw: raises $1.50 to $2
Do9Rlu1R5u/AcRtMTl8SYg: calls $1.50
*** FLOP *** [5d Th 8d]
Do9Rlu1R5u/AcRtMTl8SYg: checks
EMc5LPgVaded4Qc77vm0fw: checks
*** TURN *** [5d Th 8d] [6c]
Do9Rlu1R5u/AcRtMTl8SYg: bets $3
EMc5LPgVaded4Qc77vm0fw: calls $3
*** RIVER *** [5d Th 8d 6c] [9c]
Do9Rlu1R5u/AcRtMTl8SYg: checks
EMc5LPgVaded4Qc77vm0fw: bets $6
Do9Rlu1R5u/AcRtMTl8SYg: raises $6 to $12
EMc5LPgVaded4Qc77vm0fw: raises $27 to $39
Do9Rlu1R5u/AcRtMTl8SYg: raises $12.90 to $51.90 and is all-in
EMc5LPgVaded4Qc77vm0fw: calls $11.45 and is all-in
*** SHOW DOWN ***
Do9Rlu1R5u/AcRtMTl8SYg: shows [7c 7s] (a straight, Six to Ten)
EMc5LPgVaded4Qc77vm0fw: shows [Qh Js] (a straight, Eight to Queen)
EMc5LPgVaded4Qc77vm0fw collected $110.40 from pot
*** SUMMARY ***
Total pot $110.90 | Rake $0.50
Board [5d Th 8d 6c 9c]
Seat 1: Do9Rlu1R5u/AcRtMTl8SYg (big blind) showed [7c 7s] and lost with a straight, Six to Ten
Seat 2: EMc5LPgVaded4Qc77vm0fw (button) (small blind) showed [Qh Js] and won ($110.40) with a straight, Eight to Queen



PokerStars Game #59938511036:  Hold'em No Limit ($0.25/$0.50) - 2009/07/01 0:16:44 ET
Table 'm95HVfesC/VPgfGEjPuaIA' 2-max Seat #2 is the button
Seat 1: Fp/oksNpipCrD2MJ2pH20g ($14.70 in chips)
Seat 2: Ag6DvxX4vbRheqsv2zXKTQ ($29.70 in chips)
Ag6DvxX4vbRheqsv2zXKTQ: posts small blind $0.25
Fp/oksNpipCrD2MJ2pH20g: posts big blind $0.50
*** HOLE CARDS ***
Ag6DvxX4vbRheqsv2zXKTQ: folds
Fp/oksNpipCrD2MJ2pH20g collected $0.50 from pot
Fp/oksNpipCrD2MJ2pH20g: doesn't show hand
*** SUMMARY ***
Total pot $0.50 | Rake $0
Seat 1: Fp/oksNpipCrD2MJ2pH20g (big blind) collected ($0.50)
Seat 2: Ag6DvxX4vbRheqsv2zXKTQ (button) (small blind) folded before Flop



PokerStars Game #59938511644:  Hold'em No Limit ($0.25/$0.50) - 2009/07/01 0:16:45 ET
Table 'c/CRn+68J3Y8KxD5g1ek2Q' 2-max Seat #2 is the button
Seat 1: 46qCyJ6evTkHo9al5sBMNA ($277.80 in chips)
Seat 2: BypVLsYQt3ePFm2xQL/dOA ($105.75 in chips)
BypVLsYQt3ePFm2xQL/dOA: posts small blind $0.25
46qCyJ6evTkHo9al5sBMNA: posts big blind $0.50
*** HOLE CARDS ***
BypVLsYQt3ePFm2xQL/dOA: raises $1 to $1.50
46qCyJ6evTkHo9al5sBMNA: raises $3.50 to $5
BypVLsYQt3ePFm2xQL/dOA: folds
46qCyJ6evTkHo9al5sBMNA collected $3 from pot
46qCyJ6evTkHo9al5sBMNA: doesn't show hand
*** SUMMARY ***
Total pot $3 | Rake $0
Seat 1: 46qCyJ6evTkHo9al5sBMNA (big blind) collected ($3)
Seat 2: BypVLsYQt3ePFm2xQL/dOA (button) (small blind) folded before Flop



PokerStars Game #59938511764:  Hold'em No Limit ($0.25/$0.50) - 2009/07/01 0:16:45 ET
Table 'kgbJRsxfv64KrErDRBAkcw' 6-max Seat #6 is the button
Seat 1: N7O9jUEx2YiQn1+yRYTHmw ($24 in chips)
Seat 2: Q+thC23WCv1kJUJtH/+4Jw ($38.90 in chips)
Seat 3: T0Gx/FcQ5VH9u7XaOMX97A ($61 in chips)
Seat 4: qanMEqjABjWxC/JgQ/0l7w ($58.45 in chips)
Seat 5: +Pf9jTVizYlIo+woPvptfA ($50 in chips)
Seat 6: DDfYzIrYT0t5R/hAJngtsg ($21.35 in chips)
N7O9jUEx2YiQn1+yRYTHmw: posts small blind $0.25
Q+thC23WCv1kJUJtH/+4Jw: posts big blind $0.50
*** HOLE CARDS ***
T0Gx/FcQ5VH9u7XaOMX97A: folds
qanMEqjABjWxC/JgQ/0l7w: folds
+Pf9jTVizYlIo+woPvptfA: folds
DDfYzIrYT0t5R/hAJngtsg: calls $0.50
N7O9jUEx2YiQn1+yRYTHmw: calls $0.25
Q+thC23WCv1kJUJtH/+4Jw: checks
*** FLOP *** [5d 7s 9d]
N7O9jUEx2YiQn1+yRYTHmw: bets $1
Q+thC23WCv1kJUJtH/+4Jw: folds
DDfYzIrYT0t5R/hAJngtsg: calls $1
*** TURN *** [5d 7s 9d] [2s]
N7O9jUEx2YiQn1+yRYTHmw: bets $1
DDfYzIrYT0t5R/hAJngtsg: raises $1.50 to $2.50
N7O9jUEx2YiQn1+yRYTHmw: calls $1.50
*** RIVER *** [5d 7s 9d 2s] [4c]
N7O9jUEx2YiQn1+yRYTHmw: checks
DDfYzIrYT0t5R/hAJngtsg: bets $3
N7O9jUEx2YiQn1+yRYTHmw: folds
DDfYzIrYT0t5R/hAJngtsg collected $8.10 from pot
DDfYzIrYT0t5R/hAJngtsg: doesn't show hand
*** SUMMARY ***
Total pot $8.50 | Rake $0.40
Board [5d 7s 9d 2s 4c]
Seat 1: N7O9jUEx2YiQn1+yRYTHmw (small blind) folded on the River
Seat 2: Q+thC23WCv1kJUJtH/+4Jw (big blind) folded on the Flop
Seat 3: T0Gx/FcQ5VH9u7XaOMX97A folded before Flop (didn't bet)
Seat 4: qanMEqjABjWxC/JgQ/0l7w folded before Flop (didn't bet)
Seat 5: +Pf9jTVizYlIo+woPvptfA folded before Flop (didn't bet)
Seat 6: DDfYzIrYT0t5R/hAJngtsg (button) collected ($8.10)



PokerStars Game #59938513408:  Hold'em No Limit ($0.25/$0.50) - 2009/07/01 0:16:47 ET
Table '37qXEp3oe+er5q4CZip9eQ' 6-max Seat #1 is the button
Seat 1: oqOqoO2AyCZenUghCxMDxw ($50 in chips)
Seat 2: g12O9qXTybyo2C0B2bXgjg ($29.15 in chips)
Seat 3: Rt6KgtZ8YaJoTc3FPim00w ($99.45 in chips)
Seat 4: AYb7QG0KzyicbOC0ZROE3Q ($12.50 in chips)
Seat 5: VOmI0x4dDPnTESZd5B4d1Q ($41.05 in chips)
Seat 6: f7zPpUQp9hHZgqhEvrUWQw ($51.65 in chips)
g12O9qXTybyo2C0B2bXgjg: posts small blind $0.25
Rt6KgtZ8YaJoTc3FPim00w: posts big blind $0.50
*** HOLE CARDS ***
AYb7QG0KzyicbOC0ZROE3Q: folds
VOmI0x4dDPnTESZd5B4d1Q: folds
f7zPpUQp9hHZgqhEvrUWQw: folds
oqOqoO2AyCZenUghCxMDxw: folds
g12O9qXTybyo2C0B2bXgjg: calls $0.25
Rt6KgtZ8YaJoTc3FPim00w: raises $1.50 to $2
g12O9qXTybyo2C0B2bXgjg: calls $1.50
*** FLOP *** [3s 3d 5s]
g12O9qXTybyo2C0B2bXgjg: checks
Rt6KgtZ8YaJoTc3FPim00w: bets $2.50
g12O9qXTybyo2C0B2bXgjg: raises $3.50 to $6
Rt6KgtZ8YaJoTc3FPim00w: folds
g12O9qXTybyo2C0B2bXgjg collected $8.60 from pot
*** SUMMARY ***
Total pot $9 | Rake $0.40
Board [3s 3d 5s]
Seat 1: oqOqoO2AyCZenUghCxMDxw (button) folded before Flop (didn't bet)
Seat 2: g12O9qXTybyo2C0B2bXgjg (small blind) collected ($8.60)
Seat 3: Rt6KgtZ8YaJoTc3FPim00w (big blind) folded on the Flop
Seat 4: AYb7QG0KzyicbOC0ZROE3Q folded before Flop (didn't bet)
Seat 5: VOmI0x4dDPnTESZd5B4d1Q folded before Flop (didn't bet)
Seat 6: f7zPpUQp9hHZgqhEvrUWQw folded before Flop (didn't bet)



PokerStars Game #59938513308:  Hold'em No Limit ($0.25/$0.50) - 2009/07/01 0:16:47 ET
Table 'ZYwMb9E6tY50Qm+iNbXRYw' 2-max Seat #1 is the button
Seat 1: DXLfRb8KDZWmrztw2bwtFw ($21 in chips)
Seat 2: 16tvT7AYgZ2LgiGFcvFKQg ($15.40 in chips)
DXLfRb8KDZWmrztw2bwtFw: posts small blind $0.25
16tvT7AYgZ2LgiGFcvFKQg: posts big blind $0.50
*** HOLE CARDS ***
DXLfRb8KDZWmrztw2bwtFw: raises $1 to $1.50
16tvT7AYgZ2LgiGFcvFKQg: calls $1
*** FLOP *** [Ks 7h 9h]
16tvT7AYgZ2LgiGFcvFKQg: checks
DXLfRb8KDZWmrztw2bwtFw: bets $2
16tvT7AYgZ2LgiGFcvFKQg: calls $2
*** TURN *** [Ks 7h 9h] [5h]
16tvT7AYgZ2LgiGFcvFKQg: checks
DXLfRb8KDZWmrztw2bwtFw: checks
*** RIVER *** [Ks 7h 9h 5h] [3c]
16tvT7AYgZ2LgiGFcvFKQg: bets $2
DXLfRb8KDZWmrztw2bwtFw: calls $2
*** SHOW DOWN ***
16tvT7AYgZ2LgiGFcvFKQg: shows [8s Js] (high card King)
DXLfRb8KDZWmrztw2bwtFw: shows [Ac 5s] (a pair of Fives)
DXLfRb8KDZWmrztw2bwtFw collected $10.50 from pot
*** SUMMARY ***
Total pot $11 | Rake $0.50
Board [Ks 7h 9h 5h 3c]
Seat 1: DXLfRb8KDZWmrztw2bwtFw (button) (small blind) showed [Ac 5s] and won ($10.50) with a pair of Fives
Seat 2: 16tvT7AYgZ2LgiGFcvFKQg (big blind) showed [8s Js] and lost with high card King



PokerStars Game #59938513858:  Hold'em No Limit ($0.25/$0.50) - 2009/07/01 0:16:48 ET
Table 'E7bWJ45aoFXRpyRv2gw+Ig' 2-max Seat #2 is the button
Seat 1: FRkiRasEGlHUeLrEl+k/nA ($50.20 in chips)
Seat 2: 3Wro85I7472vJ4Wkpneo9A ($131.60 in chips)
3Wro85I7472vJ4Wkpneo9A: posts small blind $0.25
FRkiRasEGlHUeLrEl+k/nA: posts big blind $0.50
*** HOLE CARDS ***
3Wro85I7472vJ4Wkpneo9A: raises $1 to $1.50
FRkiRasEGlHUeLrEl+k/nA: calls $1
*** FLOP *** [Kh 9c 8d]
FRkiRasEGlHUeLrEl+k/nA: checks
3Wro85I7472vJ4Wkpneo9A: bets $2
FRkiRasEGlHUeLrEl+k/nA: calls $2
*** TURN *** [Kh 9c 8d] [Th]
FRkiRasEGlHUeLrEl+k/nA: checks
3Wro85I7472vJ4Wkpneo9A: checks
*** RIVER *** [Kh 9c 8d Th] [9d]
FRkiRasEGlHUeLrEl+k/nA: bets $1.50
3Wro85I7472vJ4Wkpneo9A: calls $1.50
*** SHOW DOWN ***
FRkiRasEGlHUeLrEl+k/nA: shows [7c 6h] (a straight, Six to Ten)
3Wro85I7472vJ4Wkpneo9A: mucks hand
FRkiRasEGlHUeLrEl+k/nA collected $9.55 from pot
*** SUMMARY ***
Total pot $10 | Rake $0.45
Board [Kh 9c 8d Th 9d]
Seat 1: FRkiRasEGlHUeLrEl+k/nA (big blind) showed [7c 6h] and won ($9.55) with a straight, Six to Ten
Seat 2: 3Wro85I7472vJ4Wkpneo9A (button) (small blind) mucked



PokerStars Game #59938515030:  Hold'em No Limit ($0.25/$0.50) - 2009/07/01 0:16:49 ET
Table 'm95HVfesC/VPgfGEjPuaIA' 2-max Seat #1 is the button
Seat 1: Fp/oksNpipCrD2MJ2pH20g ($14.95 in chips)
Seat 2: Ag6DvxX4vbRheqsv2zXKTQ ($29.45 in chips)
Fp/oksNpipCrD2MJ2pH20g: posts small blind $0.25
Ag6DvxX4vbRheqsv2zXKTQ: posts big blind $0.50
*** HOLE CARDS ***
Fp/oksNpipCrD2MJ2pH20g: folds
Ag6DvxX4vbRheqsv2zXKTQ collected $0.50 from pot
*** SUMMARY ***
Total pot $0.50 | Rake $0
Seat 1: Fp/oksNpipCrD2MJ2pH20g (button) (small blind) folded before Flop
Seat 2: Ag6DvxX4vbRheqsv2zXKTQ (big blind) collected ($0.50)



PokerStars Game #59938516160:  Hold'em No Limit ($0.25/$0.50) - 2009/07/01 0:16:51 ET
Table '+dXkOAQyS8j9PQZusUTMpg' 2-max Seat #2 is the button
Seat 1: XFa6sBGjP2gxoIvxR3fZIg ($86.65 in chips)
Seat 2: 5IBeOgaApY1Bvzv2P8X4EA ($23.85 in chips)
5IBeOgaApY1Bvzv2P8X4EA: posts small blind $0.25
XFa6sBGjP2gxoIvxR3fZIg: posts big blind $0.50
*** HOLE CARDS ***
5IBeOgaApY1Bvzv2P8X4EA: folds
XFa6sBGjP2gxoIvxR3fZIg collected $0.50 from pot
XFa6sBGjP2gxoIvxR3fZIg: shows [Qd Qh] (a pair of Queens)
*** SUMMARY ***
Total pot $0.50 | Rake $0
Seat 1: XFa6sBGjP2gxoIvxR3fZIg (big blind) collected ($0.50)
Seat 2: 5IBeOgaApY1Bvzv2P8X4EA (button) (small blind) folded before Flop



PokerStars Game #59938517058:  Hold'em No Limit ($0.25/$0.50) - 2009/07/01 0:16:52 ET
Table 'raOT4/ipuZgzjfKHC+jD9g' 2-max Seat #1 is the button
Seat 1: IuwLemwLhc9fvrwBGs0AMA ($12 in chips)
Seat 2: Udr5juWSWUgTu1NlRhjMdA ($10.65 in chips)
IuwLemwLhc9fvrwBGs0AMA: posts small blind $0.25
Udr5juWSWUgTu1NlRhjMdA: posts big blind $0.50
*** HOLE CARDS ***
IuwLemwLhc9fvrwBGs0AMA: folds
Udr5juWSWUgTu1NlRhjMdA collected $0.50 from pot
Udr5juWSWUgTu1NlRhjMdA: doesn't show hand
*** SUMMARY ***
Total pot $0.50 | Rake $0
Seat 1: IuwLemwLhc9fvrwBGs0AMA (button) (small blind) folded before Flop
Seat 2: Udr5juWSWUgTu1NlRhjMdA (big blind) collected ($0.50)



PokerStars Game #59938519432:  Hold'em No Limit ($0.25/$0.50) - 2009/07/01 0:16:56 ET
Table 'm95HVfesC/VPgfGEjPuaIA' 2-max Seat #2 is the button
Seat 1: Fp/oksNpipCrD2MJ2pH20g ($14.70 in chips)
Seat 2: Ag6DvxX4vbRheqsv2zXKTQ ($29.70 in chips)
Ag6DvxX4vbRheqsv2zXKTQ: posts small blind $0.25
Fp/oksNpipCrD2MJ2pH20g: posts big blind $0.50
*** HOLE CARDS ***
Ag6DvxX4vbRheqsv2zXKTQ: raises $1 to $1.50
Fp/oksNpipCrD2MJ2pH20g: folds
Ag6DvxX4vbRheqsv2zXKTQ collected $1 from pot
*** SUMMARY ***
Total pot $1 | Rake $0
Seat 1: Fp/oksNpipCrD2MJ2pH20g (big blind) folded before Flop
Seat 2: Ag6DvxX4vbRheqsv2zXKTQ (button) (small blind) collected ($1)



PokerStars Game #59938519796:  Hold'em No Limit ($0.25/$0.50) - 2009/07/01 0:16:56 ET
Table 'eMxdLyFDf28E0wit6gm3Uw' 6-max Seat #1 is the button
Seat 1: tnD/64LagZ9qPaeOQVjVZg ($11.95 in chips)
Seat 2: jwuKQ1S3U4NnzMQn3E3dgw ($68.70 in chips)
Seat 3: dZcLsEI8iXkobBduRJ45Yw ($17 in chips)
Seat 5: X0X97o2fDAPiGx6o1gahsw ($55.55 in chips)
Seat 6: L0aIPg7qefDQjdJo3HCVEA ($9.25 in chips)
jwuKQ1S3U4NnzMQn3E3dgw: posts small blind $0.25
dZcLsEI8iXkobBduRJ45Yw: posts big blind $0.50
*** HOLE CARDS ***
X0X97o2fDAPiGx6o1gahsw is disconnected
X0X97o2fDAPiGx6o1gahsw is connected
X0X97o2fDAPiGx6o1gahsw: calls $0.50
L0aIPg7qefDQjdJo3HCVEA: folds
tnD/64LagZ9qPaeOQVjVZg: raises $11.45 to $11.95 and is all-in
QM93o65lI8kLzmiB/BILlA joins the table at seat #4
jwuKQ1S3U4NnzMQn3E3dgw: folds
dZcLsEI8iXkobBduRJ45Yw: folds
X0X97o2fDAPiGx6o1gahsw: folds
tnD/64LagZ9qPaeOQVjVZg collected $1.75 from pot
*** SUMMARY ***
Total pot $1.75 | Rake $0
Seat 1: tnD/64LagZ9qPaeOQVjVZg (button) collected ($1.75)
Seat 2: jwuKQ1S3U4NnzMQn3E3dgw (small blind) folded before Flop
Seat 3: dZcLsEI8iXkobBduRJ45Yw (big blind) folded before Flop
Seat 5: X0X97o2fDAPiGx6o1gahsw folded before Flop
Seat 6: L0aIPg7qefDQjdJo3HCVEA folded before Flop (didn't bet)



PokerStars Game #59938520174:  Hold'em No Limit ($0.25/$0.50) - 2009/07/01 0:16:57 ET
Table '+dXkOAQyS8j9PQZusUTMpg' 2-max Seat #1 is the button
Seat 1: XFa6sBGjP2gxoIvxR3fZIg ($86.90 in chips)
Seat 2: 5IBeOgaApY1Bvzv2P8X4EA ($23.60 in chips)
XFa6sBGjP2gxoIvxR3fZIg: posts small blind $0.25
5IBeOgaApY1Bvzv2P8X4EA: posts big blind $0.50
*** HOLE CARDS ***
XFa6sBGjP2gxoIvxR3fZIg: raises $1 to $1.50
5IBeOgaApY1Bvzv2P8X4EA: calls $1
*** FLOP *** [3s Qc Ts]
5IBeOgaApY1Bvzv2P8X4EA: checks
XFa6sBGjP2gxoIvxR3fZIg: bets $2
5IBeOgaApY1Bvzv2P8X4EA: raises $3.50 to $5.50
XFa6sBGjP2gxoIvxR3fZIg: calls $3.50
*** TURN *** [3s Qc Ts] [4d]
5IBeOgaApY1Bvzv2P8X4EA: bets $16.60 and is all-in
XFa6sBGjP2gxoIvxR3fZIg: folds
5IBeOgaApY1Bvzv2P8X4EA collected $13.50 from pot
5IBeOgaApY1Bvzv2P8X4EA: doesn't show hand
*** SUMMARY ***
Total pot $14 | Rake $0.50
Board [3s Qc Ts 4d]
Seat 1: XFa6sBGjP2gxoIvxR3fZIg (button) (small blind) folded on the Turn
Seat 2: 5IBeOgaApY1Bvzv2P8X4EA (big blind) collected ($13.50)



PokerStars Game #59938521520:  Hold'em No Limit ($0.25/$0.50) - 2009/07/01 0:16:59 ET
Table 'lSisgp6H7Fg1hH5VfjEjYQ' 9-max Seat #5 is the button
Seat 1: pEW8B6uXbdR47kfljMQ3+Q ($38.95 in chips)
Seat 2: UrcnkQOiLVk8BlKDPJSy7Q ($51.10 in chips)
Seat 3: aTkyjTh3w5YLWiIERupZOA ($37.75 in chips)
Seat 4: nvw9yQKhJT56lA9k+TLdhw ($14.25 in chips)
Seat 5: mSD1pginDsyHG5PDfqzphw ($10 in chips)
Seat 6: +k7T5ocke8UwavtgUHm+Cg ($21.65 in chips)
Seat 7: dGw5MBstXyXhWHHVFOWOFA ($43.75 in chips)
Seat 8: a4JDWmpFQkL10XfAyuF51A ($27.50 in chips)
Seat 9: 5JJVDlaiMnB004o/RqbZZQ ($40.80 in chips)
+k7T5ocke8UwavtgUHm+Cg: posts small blind $0.25
dGw5MBstXyXhWHHVFOWOFA: posts big blind $0.50
*** HOLE CARDS ***
a4JDWmpFQkL10XfAyuF51A: folds
5JJVDlaiMnB004o/RqbZZQ: folds
pEW8B6uXbdR47kfljMQ3+Q: folds
UrcnkQOiLVk8BlKDPJSy7Q: folds
aTkyjTh3w5YLWiIERupZOA: folds
nvw9yQKhJT56lA9k+TLdhw: raises $1 to $1.50
mSD1pginDsyHG5PDfqzphw: folds
+k7T5ocke8UwavtgUHm+Cg: calls $1.25
dGw5MBstXyXhWHHVFOWOFA: folds
*** FLOP *** [5d 6h Kh]
+k7T5ocke8UwavtgUHm+Cg: checks
nvw9yQKhJT56lA9k+TLdhw: bets $1.50
+k7T5ocke8UwavtgUHm+Cg: calls $1.50
*** TURN *** [5d 6h Kh] [Qh]
+k7T5ocke8UwavtgUHm+Cg: checks
nvw9yQKhJT56lA9k+TLdhw: checks
*** RIVER *** [5d 6h Kh Qh] [Td]
+k7T5ocke8UwavtgUHm+Cg: bets $2
nvw9yQKhJT56lA9k+TLdhw: folds
+k7T5ocke8UwavtgUHm+Cg collected $6.20 from pot
+k7T5ocke8UwavtgUHm+Cg: doesn't show hand
*** SUMMARY ***
Total pot $6.50 | Rake $0.30
Board [5d 6h Kh Qh Td]
Seat 1: pEW8B6uXbdR47kfljMQ3+Q folded before Flop (didn't bet)
Seat 2: UrcnkQOiLVk8BlKDPJSy7Q folded before Flop (didn't bet)
Seat 3: aTkyjTh3w5YLWiIERupZOA folded before Flop (didn't bet)
Seat 4: nvw9yQKhJT56lA9k+TLdhw folded on the River
Seat 5: mSD1pginDsyHG5PDfqzphw (button) folded before Flop (didn't bet)
Seat 6: +k7T5ocke8UwavtgUHm+Cg (small blind) collected ($6.20)
Seat 7: dGw5MBstXyXhWHHVFOWOFA (big blind) folded before Flop
Seat 8: a4JDWmpFQkL10XfAyuF51A folded before Flop (didn't bet)
Seat 9: 5JJVDlaiMnB004o/RqbZZQ folded before Flop (didn't bet)



PokerStars Game #59938521862:  Hold'em No Limit ($0.25/$0.50) - 2009/07/01 0:16:59 ET
Table '+z1aekfHkpp09pc8F9aViw' 6-max Seat #6 is the button
Seat 2: VuB2GN0h94yY+QbuI2Mybg ($21.15 in chips)
Seat 3: uUznlIMFnRUvwrBhYF73KA ($58.60 in chips)
Seat 5: crjGpJEzSZgD38FoE3VMGg ($64.40 in chips)
Seat 6: 686aeHikcJlgKkSuIFdcXQ ($70.50 in chips)
VuB2GN0h94yY+QbuI2Mybg: posts small blind $0.25
lWwl5C/UZOsWNubdUqghZw is connected
uUznlIMFnRUvwrBhYF73KA: posts big blind $0.50
*** HOLE CARDS ***
lWwl5C/UZOsWNubdUqghZw leaves the table
crjGpJEzSZgD38FoE3VMGg: folds
686aeHikcJlgKkSuIFdcXQ: raises $1 to $1.50
VuB2GN0h94yY+QbuI2Mybg: folds
uUznlIMFnRUvwrBhYF73KA: calls $1
*** FLOP *** [Qh Tc Jd]
wOyVV9M/oyiw3YaOjNZ05w joins the table at seat #1
uUznlIMFnRUvwrBhYF73KA: bets $1.50
686aeHikcJlgKkSuIFdcXQ: calls $1.50
*** TURN *** [Qh Tc Jd] [8h]
uUznlIMFnRUvwrBhYF73KA: bets $2.50
686aeHikcJlgKkSuIFdcXQ: calls $2.50
*** RIVER *** [Qh Tc Jd 8h] [9h]
uUznlIMFnRUvwrBhYF73KA: bets $5
686aeHikcJlgKkSuIFdcXQ: calls $5
*** SHOW DOWN ***
uUznlIMFnRUvwrBhYF73KA: shows [As 2s] (a straight, Eight to Queen)
686aeHikcJlgKkSuIFdcXQ: shows [Jc Ah] (a straight, Eight to Queen)
uUznlIMFnRUvwrBhYF73KA collected $10.15 from pot
686aeHikcJlgKkSuIFdcXQ collected $10.10 from pot
*** SUMMARY ***
Total pot $21.25 | Rake $1
Board [Qh Tc Jd 8h 9h]
Seat 2: VuB2GN0h94yY+QbuI2Mybg (small blind) folded before Flop
Seat 3: uUznlIMFnRUvwrBhYF73KA (big blind) showed [As 2s] and won ($10.15) with a straight, Eight to Queen
Seat 5: crjGpJEzSZgD38FoE3VMGg folded before Flop (didn't bet)
Seat 6: 686aeHikcJlgKkSuIFdcXQ (button) showed [Jc Ah] and won ($10.10) with a straight, Eight to Queen



PokerStars Game #59938522384:  Hold'em No Limit ($0.25/$0.50) - 2009/07/01 0:17:00 ET
Table 'raOT4/ipuZgzjfKHC+jD9g' 2-max Seat #2 is the button
Seat 1: IuwLemwLhc9fvrwBGs0AMA ($11.75 in chips)
Seat 2: Udr5juWSWUgTu1NlRhjMdA ($10.90 in chips)
Udr5juWSWUgTu1NlRhjMdA: posts small blind $0.25
IuwLemwLhc9fvrwBGs0AMA: posts big blind $0.50
*** HOLE CARDS ***
Udr5juWSWUgTu1NlRhjMdA: calls $0.25
IuwLemwLhc9fvrwBGs0AMA: checks
*** FLOP *** [8c 5s 2h]
IuwLemwLhc9fvrwBGs0AMA: bets $0.50
Udr5juWSWUgTu1NlRhjMdA: folds
IuwLemwLhc9fvrwBGs0AMA collected $0.95 from pot
*** SUMMARY ***
Total pot $1 | Rake $0.05
Board [8c 5s 2h]
Seat 1: IuwLemwLhc9fvrwBGs0AMA (big blind) collected ($0.95)
Seat 2: Udr5juWSWUgTu1NlRhjMdA (button) (small blind) folded on the Flop



PokerStars Game #59938522672:  Hold'em No Limit ($0.25/$0.50) - 2009/07/01 0:17:00 ET
Table 'X6IRCRTh+20gjz8aubWnwA' 9-max Seat #3 is the button
Seat 2: RjBdQ6w31rgcy0o24VLR6w ($10.90 in chips)
Seat 3: mSD1pginDsyHG5PDfqzphw ($10 in chips)
Seat 4: uw9QayAAxLM3Hb+HR7mSkg ($10.50 in chips)
Seat 6: /6In1zC3WtgwxDcueWzZWg ($58.10 in chips)
Seat 7: VBnpbzn0dIveV55qKvciew ($54.70 in chips)
Seat 8: BPMN9sOItJw6vWq3kypaYg ($26.50 in chips)
Seat 9: M+7+BTmX5vZatHVuoRB1nA ($82.60 in chips)
uw9QayAAxLM3Hb+HR7mSkg: posts small blind $0.25
L5e2lrPLQm1Pqx30IIZ/Fw: is sitting out
/6In1zC3WtgwxDcueWzZWg: posts big blind $0.50
*** HOLE CARDS ***
VBnpbzn0dIveV55qKvciew: folds
L5e2lrPLQm1Pqx30IIZ/Fw leaves the table
BPMN9sOItJw6vWq3kypaYg: calls $0.50
M+7+BTmX5vZatHVuoRB1nA: folds
RjBdQ6w31rgcy0o24VLR6w: folds
mSD1pginDsyHG5PDfqzphw: folds
uw9QayAAxLM3Hb+HR7mSkg: folds
/6In1zC3WtgwxDcueWzZWg: checks
*** FLOP *** [7h 9d 8h]
/6In1zC3WtgwxDcueWzZWg: checks
BPMN9sOItJw6vWq3kypaYg: bets $0.50
QtFsO51ArDuQ44+KvR2jow joins the table at seat #5
/6In1zC3WtgwxDcueWzZWg: folds
BPMN9sOItJw6vWq3kypaYg collected $1.20 from pot
*** SUMMARY ***
Total pot $1.25 | Rake $0.05
Board [7h 9d 8h]
Seat 2: RjBdQ6w31rgcy0o24VLR6w folded before Flop (didn't bet)
Seat 3: mSD1pginDsyHG5PDfqzphw (button) folded before Flop (didn't bet)
Seat 4: uw9QayAAxLM3Hb+HR7mSkg (small blind) folded before Flop
Seat 6: /6In1zC3WtgwxDcueWzZWg (big blind) folded on the Flop
Seat 7: VBnpbzn0dIveV55qKvciew folded before Flop (didn't bet)
Seat 8: BPMN9sOItJw6vWq3kypaYg collected ($1.20)
Seat 9: M+7+BTmX5vZatHVuoRB1nA folded before Flop (didn't bet)



PokerStars Game #59938525404:  Hold'em No Limit ($0.25/$0.50) - 2009/07/01 0:17:04 ET
Table 'm95HVfesC/VPgfGEjPuaIA' 2-max Seat #1 is the button
Seat 1: Fp/oksNpipCrD2MJ2pH20g ($14.20 in chips)
Seat 2: Ag6DvxX4vbRheqsv2zXKTQ ($30.20 in chips)
Fp/oksNpipCrD2MJ2pH20g: posts small blind $0.25
Ag6DvxX4vbRheqsv2zXKTQ: posts big blind $0.50
*** HOLE CARDS ***
Fp/oksNpipCrD2MJ2pH20g: raises $1 to $1.50
Ag6DvxX4vbRheqsv2zXKTQ: folds
Fp/oksNpipCrD2MJ2pH20g collected $1 from pot
Fp/oksNpipCrD2MJ2pH20g: doesn't show hand
*** SUMMARY ***
Total pot $1 | Rake $0
Seat 1: Fp/oksNpipCrD2MJ2pH20g (button) (small blind) collected ($1)
Seat 2: Ag6DvxX4vbRheqsv2zXKTQ (big blind) folded before Flop



PokerStars Game #59938525798:  Hold'em No Limit ($0.25/$0.50) - 2009/07/01 0:17:05 ET
Table 'Nz0Vr7WMHL2g5Uk7dDZjpw' 9-max Seat #3 is the button
Seat 1: tLkxo7JgV+WWI0UBw44K5A ($97.25 in chips)
Seat 3: 4QTiNH5fteLgJjx/s6Hy6A ($6.15 in chips)
Seat 4: 5JJVDlaiMnB004o/RqbZZQ ($27.75 in chips)
Seat 5: WGW0DgjBUXs1ylURHG8vnQ ($18.10 in chips)
Seat 6: k1f0lS7tlMHCLGs0JT34Tg ($10 in chips)
Seat 7: KPLH0gELgFe2OuAnhJFI5w ($21.45 in chips)
Seat 8: HkZI6g4zl83TDTA7SRspmQ ($21.70 in chips)
Seat 9: Ak2W6V2TDVIQrvSAy4eD7Q ($27.55 in chips)
5JJVDlaiMnB004o/RqbZZQ: posts small blind $0.25
WGW0DgjBUXs1ylURHG8vnQ: posts big blind $0.50
XNMDwbXt/Q4jM99AXnbJDw: sits out
*** HOLE CARDS ***
k1f0lS7tlMHCLGs0JT34Tg: calls $0.50
KPLH0gELgFe2OuAnhJFI5w: calls $0.50
HkZI6g4zl83TDTA7SRspmQ: folds
Ak2W6V2TDVIQrvSAy4eD7Q: raises $2 to $2.50
tLkxo7JgV+WWI0UBw44K5A: folds
4QTiNH5fteLgJjx/s6Hy6A: calls $2.50
5JJVDlaiMnB004o/RqbZZQ: folds
WGW0DgjBUXs1ylURHG8vnQ: folds
k1f0lS7tlMHCLGs0JT34Tg: calls $2
KPLH0gELgFe2OuAnhJFI5w: folds
*** FLOP *** [Ah 6d Qs]
k1f0lS7tlMHCLGs0JT34Tg: checks
Ak2W6V2TDVIQrvSAy4eD7Q: bets $4
4QTiNH5fteLgJjx/s6Hy6A: calls $3.65 and is all-in
k1f0lS7tlMHCLGs0JT34Tg: folds
*** TURN *** [Ah 6d Qs] [2h]
*** RIVER *** [Ah 6d Qs 2h] [5h]
*** SHOW DOWN ***
Ak2W6V2TDVIQrvSAy4eD7Q: shows [Ac 8c] (a pair of Aces)
4QTiNH5fteLgJjx/s6Hy6A: shows [4h Qh] (a flush, Ace high)
4QTiNH5fteLgJjx/s6Hy6A collected $15.30 from pot
*** SUMMARY ***
Total pot $16.05 | Rake $0.75
Board [Ah 6d Qs 2h 5h]
Seat 1: tLkxo7JgV+WWI0UBw44K5A folded before Flop (didn't bet)
Seat 3: 4QTiNH5fteLgJjx/s6Hy6A (button) showed [4h Qh] and won ($15.30) with a flush, Ace high
Seat 4: 5JJVDlaiMnB004o/RqbZZQ (small blind) folded before Flop
Seat 5: WGW0DgjBUXs1ylURHG8vnQ (big blind) folded before Flop
Seat 6: k1f0lS7tlMHCLGs0JT34Tg folded on the Flop
Seat 7: KPLH0gELgFe2OuAnhJFI5w folded before Flop
Seat 8: HkZI6g4zl83TDTA7SRspmQ folded before Flop (didn't bet)
Seat 9: Ak2W6V2TDVIQrvSAy4eD7Q showed [Ac 8c] and lost with a pair of Aces



PokerStars Game #59938526836:  Hold'em No Limit ($0.25/$0.50) - 2009/07/01 0:17:06 ET
Table 'ZYwMb9E6tY50Qm+iNbXRYw' 2-max Seat #2 is the button
Seat 1: DXLfRb8KDZWmrztw2bwtFw ($26 in chips)
Seat 2: 16tvT7AYgZ2LgiGFcvFKQg ($9.90 in chips)
16tvT7AYgZ2LgiGFcvFKQg: posts small blind $0.25
DXLfRb8KDZWmrztw2bwtFw: posts big blind $0.50
*** HOLE CARDS ***
16tvT7AYgZ2LgiGFcvFKQg: raises $0.50 to $1
DXLfRb8KDZWmrztw2bwtFw: folds
16tvT7AYgZ2LgiGFcvFKQg collected $1 from pot
16tvT7AYgZ2LgiGFcvFKQg: doesn't show hand
*** SUMMARY ***
Total pot $1 | Rake $0
Seat 1: DXLfRb8KDZWmrztw2bwtFw (big blind) folded before Flop
Seat 2: 16tvT7AYgZ2LgiGFcvFKQg (button) (small blind) collected ($1)



PokerStars Game #59938527338:  Hold'em No Limit ($0.25/$0.50) - 2009/07/01 0:17:07 ET
Table 'PALRfuH85dr5IkDfdv6new' 9-max Seat #3 is the button
Seat 1: SKnJuWHScqetA/qG5p+wCg ($32.25 in chips)
Seat 2: 9r7ZoBbAJj5IeyZ0q9BdzA ($12.15 in chips)
Seat 3: 50QWoELmpmHFrFIlWMJo9g ($90.20 in chips)
Seat 5: jSSGUXdNFAZA3QCvTcUMQw ($40.50 in chips)
Seat 6: EiWj2MAl8RNcPhTkzz24Mw ($37.70 in chips)
Seat 7: 3NcyXvr39gnK+KbTq7ezyA ($35.25 in chips)
Seat 8: NkS+CseUKx4XHszWq0PXEQ ($45.10 in chips)
Seat 9: CIrAX/m6o7jYmKOAjJXv4Q ($37.35 in chips)
jSSGUXdNFAZA3QCvTcUMQw: posts small blind $0.25
EiWj2MAl8RNcPhTkzz24Mw: posts big blind $0.50
*** HOLE CARDS ***
3NcyXvr39gnK+KbTq7ezyA: folds
NkS+CseUKx4XHszWq0PXEQ: folds
CIrAX/m6o7jYmKOAjJXv4Q: folds
SKnJuWHScqetA/qG5p+wCg: folds
9r7ZoBbAJj5IeyZ0q9BdzA: folds
50QWoELmpmHFrFIlWMJo9g: folds
jSSGUXdNFAZA3QCvTcUMQw: calls $0.25
EiWj2MAl8RNcPhTkzz24Mw: checks
*** FLOP *** [9c 9h Qd]
jSSGUXdNFAZA3QCvTcUMQw: checks
UqQTn9qxH/IQXP1PWD7Gwg joins the table at seat #4
EiWj2MAl8RNcPhTkzz24Mw: checks
*** TURN *** [9c 9h Qd] [3s]
jSSGUXdNFAZA3QCvTcUMQw: checks
EiWj2MAl8RNcPhTkzz24Mw: checks
*** RIVER *** [9c 9h Qd 3s] [5h]
jSSGUXdNFAZA3QCvTcUMQw: bets $1
EiWj2MAl8RNcPhTkzz24Mw: folds
jSSGUXdNFAZA3QCvTcUMQw collected $0.95 from pot
jSSGUXdNFAZA3QCvTcUMQw: doesn't show hand
*** SUMMARY ***
Total pot $1 | Rake $0.05
Board [9c 9h Qd 3s 5h]
Seat 1: SKnJuWHScqetA/qG5p+wCg folded before Flop (didn't bet)
Seat 2: 9r7ZoBbAJj5IeyZ0q9BdzA folded before Flop (didn't bet)
Seat 3: 50QWoELmpmHFrFIlWMJo9g (button) folded before Flop (didn't bet)
Seat 5: jSSGUXdNFAZA3QCvTcUMQw (small blind) collected ($0.95)
Seat 6: EiWj2MAl8RNcPhTkzz24Mw (big blind) folded on the River
Seat 7: 3NcyXvr39gnK+KbTq7ezyA folded before Flop (didn't bet)
Seat 8: NkS+CseUKx4XHszWq0PXEQ folded before Flop (didn't bet)
Seat 9: CIrAX/m6o7jYmKOAjJXv4Q folded before Flop (didn't bet)



PokerStars Game #59938530730:  Hold'em No Limit ($0.25/$0.50) - 2009/07/01 0:17:12 ET
Table 'm95HVfesC/VPgfGEjPuaIA' 2-max Seat #2 is the button
Seat 1: Fp/oksNpipCrD2MJ2pH20g ($14.70 in chips)
Seat 2: Ag6DvxX4vbRheqsv2zXKTQ ($29.70 in chips)
Ag6DvxX4vbRheqsv2zXKTQ: posts small blind $0.25
Fp/oksNpipCrD2MJ2pH20g: posts big blind $0.50
*** HOLE CARDS ***
Ag6DvxX4vbRheqsv2zXKTQ: calls $0.25
Fp/oksNpipCrD2MJ2pH20g: checks
*** FLOP *** [4s Ac Ad]
Fp/oksNpipCrD2MJ2pH20g: bets $0.50
Ag6DvxX4vbRheqsv2zXKTQ: calls $0.50
*** TURN *** [4s Ac Ad] [Qd]
Fp/oksNpipCrD2MJ2pH20g: checks
Ag6DvxX4vbRheqsv2zXKTQ: bets $1
Fp/oksNpipCrD2MJ2pH20g: folds
Ag6DvxX4vbRheqsv2zXKTQ collected $1.95 from pot
*** SUMMARY ***
Total pot $2 | Rake $0.05
Board [4s Ac Ad Qd]
Seat 1: Fp/oksNpipCrD2MJ2pH20g (big blind) folded on the Turn
Seat 2: Ag6DvxX4vbRheqsv2zXKTQ (button) (small blind) collected ($1.95)



PokerStars Game #59938531596:  Hold'em No Limit ($0.25/$0.50) - 2009/07/01 0:17:13 ET
Table 'E7bWJ45aoFXRpyRv2gw+Ig' 2-max Seat #1 is the button
Seat 1: FRkiRasEGlHUeLrEl+k/nA ($54.75 in chips)
Seat 2: 3Wro85I7472vJ4Wkpneo9A ($126.60 in chips)
FRkiRasEGlHUeLrEl+k/nA: posts small blind $0.25
3Wro85I7472vJ4Wkpneo9A: posts big blind $0.50
*** HOLE CARDS ***
FRkiRasEGlHUeLrEl+k/nA: folds
3Wro85I7472vJ4Wkpneo9A collected $0.50 from pot
3Wro85I7472vJ4Wkpneo9A: doesn't show hand
*** SUMMARY ***
Total pot $0.50 | Rake $0
Seat 1: FRkiRasEGlHUeLrEl+k/nA (button) (small blind) folded before Flop
Seat 2: 3Wro85I7472vJ4Wkpneo9A (big blind) collected ($0.50)



PokerStars Game #59938531632:  Hold'em No Limit ($0.25/$0.50) - 2009/07/01 0:17:14 ET
Table 'ZYwMb9E6tY50Qm+iNbXRYw' 2-max Seat #1 is the button
Seat 1: DXLfRb8KDZWmrztw2bwtFw ($25.50 in chips)
Seat 2: 16tvT7AYgZ2LgiGFcvFKQg ($10.40 in chips)
DXLfRb8KDZWmrztw2bwtFw: posts small blind $0.25
16tvT7AYgZ2LgiGFcvFKQg: posts big blind $0.50
*** HOLE CARDS ***
DXLfRb8KDZWmrztw2bwtFw: calls $0.25
16tvT7AYgZ2LgiGFcvFKQg: checks
*** FLOP *** [7s 2s Ah]
16tvT7AYgZ2LgiGFcvFKQg: bets $0.50
DXLfRb8KDZWmrztw2bwtFw: raises $1 to $1.50
16tvT7AYgZ2LgiGFcvFKQg: calls $1
*** TURN *** [7s 2s Ah] [As]
16tvT7AYgZ2LgiGFcvFKQg: checks
DXLfRb8KDZWmrztw2bwtFw: bets $1.50
16tvT7AYgZ2LgiGFcvFKQg: calls $1.50
*** RIVER *** [7s 2s Ah As] [6d]
16tvT7AYgZ2LgiGFcvFKQg: checks
DXLfRb8KDZWmrztw2bwtFw: checks
*** SHOW DOWN ***
16tvT7AYgZ2LgiGFcvFKQg: shows [Tc 7h] (two pair, Aces and Sevens)
DXLfRb8KDZWmrztw2bwtFw: shows [Ks 7c] (two pair, Aces and Sevens - King kicker)
DXLfRb8KDZWmrztw2bwtFw collected $6.70 from pot
*** SUMMARY ***
Total pot $7 | Rake $0.30
Board [7s 2s Ah As 6d]
Seat 1: DXLfRb8KDZWmrztw2bwtFw (button) (small blind) showed [Ks 7c] and won ($6.70) with two pair, Aces and Sevens
Seat 2: 16tvT7AYgZ2LgiGFcvFKQg (big blind) showed [Tc 7h] and lost with two pair, Aces and Sevens



PokerStars Game #59938532692:  Hold'em No Limit ($0.25/$0.50) - 2009/07/01 0:17:15 ET
Table 'raOT4/ipuZgzjfKHC+jD9g' 2-max Seat #1 is the button
Seat 1: IuwLemwLhc9fvrwBGs0AMA ($12.20 in chips)
Seat 2: Udr5juWSWUgTu1NlRhjMdA ($10.40 in chips)
IuwLemwLhc9fvrwBGs0AMA: posts small blind $0.25
Udr5juWSWUgTu1NlRhjMdA: posts big blind $0.50
*** HOLE CARDS ***
IuwLemwLhc9fvrwBGs0AMA: folds
Udr5juWSWUgTu1NlRhjMdA collected $0.50 from pot
Udr5juWSWUgTu1NlRhjMdA: doesn't show hand
*** SUMMARY ***
Total pot $0.50 | Rake $0
Seat 1: IuwLemwLhc9fvrwBGs0AMA (button) (small blind) folded before Flop
Seat 2: Udr5juWSWUgTu1NlRhjMdA (big blind) collected ($0.50)



PokerStars Game #59938535630:  Hold'em No Limit ($0.25/$0.50) - 2009/07/01 0:17:19 ET
Table 'E7bWJ45aoFXRpyRv2gw+Ig' 2-max Seat #2 is the button
Seat 1: FRkiRasEGlHUeLrEl+k/nA ($54.50 in chips)
Seat 2: 3Wro85I7472vJ4Wkpneo9A ($126.85 in chips)
3Wro85I7472vJ4Wkpneo9A: posts small blind $0.25
FRkiRasEGlHUeLrEl+k/nA: posts big blind $0.50
*** HOLE CARDS ***
3Wro85I7472vJ4Wkpneo9A: calls $0.25
FRkiRasEGlHUeLrEl+k/nA: raises $2 to $2.50
3Wro85I7472vJ4Wkpneo9A: calls $2
*** FLOP *** [Jh 9h Kc]
FRkiRasEGlHUeLrEl+k/nA: bets $2
3Wro85I7472vJ4Wkpneo9A: calls $2
*** TURN *** [Jh 9h Kc] [6h]
FRkiRasEGlHUeLrEl+k/nA: checks
3Wro85I7472vJ4Wkpneo9A: checks
*** RIVER *** [Jh 9h Kc 6h] [9d]
FRkiRasEGlHUeLrEl+k/nA: checks
3Wro85I7472vJ4Wkpneo9A: checks
*** SHOW DOWN ***
FRkiRasEGlHUeLrEl+k/nA: shows [7c 7h] (two pair, Nines and Sevens)
3Wro85I7472vJ4Wkpneo9A: mucks hand
FRkiRasEGlHUeLrEl+k/nA collected $8.60 from pot
*** SUMMARY ***
Total pot $9 | Rake $0.40
Board [Jh 9h Kc 6h 9d]
Seat 1: FRkiRasEGlHUeLrEl+k/nA (big blind) showed [7c 7h] and won ($8.60) with two pair, Nines and Sevens
Seat 2: 3Wro85I7472vJ4Wkpneo9A (button) (small blind) mucked



PokerStars Game #59938535406:  Hold'em No Limit ($0.25/$0.50) - 2009/07/01 0:17:19 ET
Table 'IeNZOZQ4T6oiaHqFeo6yIA' 2-max Seat #2 is the button
Seat 1: ndd1nfncBkWNitBnsfCoVQ ($54.60 in chips)
Seat 2: A91IUl5JaZROhtfCtnnwYw ($33.65 in chips)
A91IUl5JaZROhtfCtnnwYw: posts small blind $0.25
ndd1nfncBkWNitBnsfCoVQ: posts big blind $0.50
*** HOLE CARDS ***
A91IUl5JaZROhtfCtnnwYw: calls $0.25
ndd1nfncBkWNitBnsfCoVQ: checks
*** FLOP *** [8c 8h 5d]
ndd1nfncBkWNitBnsfCoVQ: bets $1
A91IUl5JaZROhtfCtnnwYw: calls $1
*** TURN *** [8c 8h 5d] [Kc]
ndd1nfncBkWNitBnsfCoVQ: bets $2.50
A91IUl5JaZROhtfCtnnwYw: calls $2.50
*** RIVER *** [8c 8h 5d Kc] [Ks]
ndd1nfncBkWNitBnsfCoVQ: checks
A91IUl5JaZROhtfCtnnwYw: bets $4
ndd1nfncBkWNitBnsfCoVQ: calls $4
*** SHOW DOWN ***
A91IUl5JaZROhtfCtnnwYw: shows [5s Jc] (two pair, Kings and Eights)
ndd1nfncBkWNitBnsfCoVQ: shows [Qh 5h] (two pair, Kings and Eights - Queen kicker)
ndd1nfncBkWNitBnsfCoVQ collected $15.50 from pot
*** SUMMARY ***
Total pot $16 | Rake $0.50
Board [8c 8h 5d Kc Ks]
Seat 1: ndd1nfncBkWNitBnsfCoVQ (big blind) showed [Qh 5h] and won ($15.50) with two pair, Kings and Eights
Seat 2: A91IUl5JaZROhtfCtnnwYw (button) (small blind) showed [5s Jc] and lost with two pair, Kings and Eights



PokerStars Game #59938536110:  Hold'em No Limit ($0.25/$0.50) - 2009/07/01 0:17:20 ET
Table 'ibNfFy0bCzuBaUORla0aGw' 9-max Seat #4 is the button
Seat 2: 90Wb75h3W1BRpbqVnuk8gw ($54.10 in chips)
Seat 3: dDaHs3X8+fe3bIkRU0cbrw ($26.50 in chips)
Seat 4: YBN054X4blmis+B2bBlC0g ($18.55 in chips)
Seat 5: FRv75HO8CUsRZ1byEz06mQ ($12.85 in chips)
Seat 6: BmYrv3ec2k5d6pQq6iNaZw ($67.85 in chips)
Seat 7: mSD1pginDsyHG5PDfqzphw ($15.50 in chips)
Seat 8: xUrN9TWLq4m5V+OXY7KUUA ($50 in chips)
Seat 9: WpvT3OUSiZlpvs+mPXFqtQ ($8 in chips)
FRv75HO8CUsRZ1byEz06mQ: posts small blind $0.25
BmYrv3ec2k5d6pQq6iNaZw: posts big blind $0.50
*** HOLE CARDS ***
mSD1pginDsyHG5PDfqzphw: folds
xUrN9TWLq4m5V+OXY7KUUA: folds
WpvT3OUSiZlpvs+mPXFqtQ: folds
90Wb75h3W1BRpbqVnuk8gw: folds
dDaHs3X8+fe3bIkRU0cbrw: folds
YBN054X4blmis+B2bBlC0g: folds
FRv75HO8CUsRZ1byEz06mQ: folds
BmYrv3ec2k5d6pQq6iNaZw collected $0.50 from pot
*** SUMMARY ***
Total pot $0.50 | Rake $0
Seat 2: 90Wb75h3W1BRpbqVnuk8gw folded before Flop (didn't bet)
Seat 3: dDaHs3X8+fe3bIkRU0cbrw folded before Flop (didn't bet)
Seat 4: YBN054X4blmis+B2bBlC0g (button) folded before Flop (didn't bet)
Seat 5: FRv75HO8CUsRZ1byEz06mQ (small blind) folded before Flop
Seat 6: BmYrv3ec2k5d6pQq6iNaZw (big blind) collected ($0.50)
Seat 7: mSD1pginDsyHG5PDfqzphw folded before Flop (didn't bet)
Seat 8: xUrN9TWLq4m5V+OXY7KUUA folded before Flop (didn't bet)
Seat 9: WpvT3OUSiZlpvs+mPXFqtQ folded before Flop (didn't bet)



PokerStars Game #59938536300:  Hold'em No Limit ($0.25/$0.50) - 2009/07/01 0:17:21 ET
Table '5EmHi+fnatGQQShcNmzOZQ' 6-max Seat #2 is the button
Seat 1: SwPczQo3cOtwEzhJrfO2cQ ($27.70 in chips)
Seat 2: APwvTk5XojDXGoQLb4O5iA ($28.25 in chips)
Seat 4: wOyVV9M/oyiw3YaOjNZ05w ($50 in chips)
Seat 5: kxPhs4ePFqMy52CInAJ2aw ($50 in chips)
Seat 6: 686aeHikcJlgKkSuIFdcXQ ($158.10 in chips)
L9qfLYXrczhAPd/VckgsWw will be allowed to play after the button
wOyVV9M/oyiw3YaOjNZ05w: posts small blind $0.25
kxPhs4ePFqMy52CInAJ2aw: posts big blind $0.50
*** HOLE CARDS ***
686aeHikcJlgKkSuIFdcXQ: folds
SwPczQo3cOtwEzhJrfO2cQ: folds
APwvTk5XojDXGoQLb4O5iA has timed out
APwvTk5XojDXGoQLb4O5iA: folds
APwvTk5XojDXGoQLb4O5iA is sitting out
wOyVV9M/oyiw3YaOjNZ05w: raises $1.50 to $2
kxPhs4ePFqMy52CInAJ2aw: folds
wOyVV9M/oyiw3YaOjNZ05w collected $1 from pot
wOyVV9M/oyiw3YaOjNZ05w: doesn't show hand
*** SUMMARY ***
Total pot $1 | Rake $0
Seat 1: SwPczQo3cOtwEzhJrfO2cQ folded before Flop (didn't bet)
Seat 2: APwvTk5XojDXGoQLb4O5iA (button) folded before Flop (didn't bet)
Seat 4: wOyVV9M/oyiw3YaOjNZ05w (small blind) collected ($1)
Seat 5: kxPhs4ePFqMy52CInAJ2aw (big blind) folded before Flop
Seat 6: 686aeHikcJlgKkSuIFdcXQ folded before Flop (didn't bet)



PokerStars Game #59938537952:  Hold'em No Limit ($0.25/$0.50) - 2009/07/01 0:17:23 ET
Table '+dXkOAQyS8j9PQZusUTMpg' 2-max Seat #2 is the button
Seat 1: XFa6sBGjP2gxoIvxR3fZIg ($79.90 in chips)
Seat 2: 5IBeOgaApY1Bvzv2P8X4EA ($30.10 in chips)
5IBeOgaApY1Bvzv2P8X4EA: posts small blind $0.25
XFa6sBGjP2gxoIvxR3fZIg: posts big blind $0.50
*** HOLE CARDS ***
5IBeOgaApY1Bvzv2P8X4EA: folds
XFa6sBGjP2gxoIvxR3fZIg collected $0.50 from pot
XFa6sBGjP2gxoIvxR3fZIg: doesn't show hand
*** SUMMARY ***
Total pot $0.50 | Rake $0
Seat 1: XFa6sBGjP2gxoIvxR3fZIg (big blind) collected ($0.50)
Seat 2: 5IBeOgaApY1Bvzv2P8X4EA (button) (small blind) folded before Flop



PokerStars Game #59938538562:  Hold'em No Limit ($0.25/$0.50) - 2009/07/01 0:17:24 ET
Table 'raOT4/ipuZgzjfKHC+jD9g' 2-max Seat #2 is the button
Seat 1: IuwLemwLhc9fvrwBGs0AMA ($11.95 in chips)
Seat 2: Udr5juWSWUgTu1NlRhjMdA ($10.65 in chips)
Udr5juWSWUgTu1NlRhjMdA: posts small blind $0.25
IuwLemwLhc9fvrwBGs0AMA: posts big blind $0.50
*** HOLE CARDS ***
Udr5juWSWUgTu1NlRhjMdA: calls $0.25
IuwLemwLhc9fvrwBGs0AMA: checks
*** FLOP *** [Kc Ad 9h]
IuwLemwLhc9fvrwBGs0AMA: bets $1
Udr5juWSWUgTu1NlRhjMdA: folds
IuwLemwLhc9fvrwBGs0AMA collected $0.95 from pot
*** SUMMARY ***
Total pot $1 | Rake $0.05
Board [Kc Ad 9h]
Seat 1: IuwLemwLhc9fvrwBGs0AMA (big blind) collected ($0.95)
Seat 2: Udr5juWSWUgTu1NlRhjMdA (button) (small blind) folded on the Flop



PokerStars Game #59938539238:  Hold'em No Limit ($0.25/$0.50) - 2009/07/01 0:17:25 ET
Table 'T/PgNWqVyY6lkldcBVXYJQ' 6-max Seat #3 is the button
Seat 1: +Pf9jTVizYlIo+woPvptfA ($52.45 in chips)
Seat 2: oZAeY5rVqNGgt8yyQ0pxbA ($22.05 in chips)
Seat 3: L3OcNO1bgdqDI46j67KQPQ ($56.05 in chips)
Seat 4: jxMvxeUUL9UU0V6wVU+Iyw ($11.45 in chips)
Seat 5: vVQBckETtigfb5mAcyK0OA ($60.25 in chips)
Seat 6: cDzbog6kwmJp+LBeBq+iMQ ($17.10 in chips)
jxMvxeUUL9UU0V6wVU+Iyw: posts small blind $0.25
vVQBckETtigfb5mAcyK0OA: posts big blind $0.50
*** HOLE CARDS ***
jxMvxeUUL9UU0V6wVU+Iyw said, "Where is Fredonia anyway?"
cDzbog6kwmJp+LBeBq+iMQ: folds
+Pf9jTVizYlIo+woPvptfA: folds
oZAeY5rVqNGgt8yyQ0pxbA: folds
L3OcNO1bgdqDI46j67KQPQ: folds
jxMvxeUUL9UU0V6wVU+Iyw: folds
vVQBckETtigfb5mAcyK0OA said, "I WILL BUST U SOON ANY HOW"
vVQBckETtigfb5mAcyK0OA collected $0.50 from pot
*** SUMMARY ***
Total pot $0.50 | Rake $0
Seat 1: +Pf9jTVizYlIo+woPvptfA folded before Flop (didn't bet)
Seat 2: oZAeY5rVqNGgt8yyQ0pxbA folded before Flop (didn't bet)
Seat 3: L3OcNO1bgdqDI46j67KQPQ (button) folded before Flop (didn't bet)
Seat 4: jxMvxeUUL9UU0V6wVU+Iyw (small blind) folded before Flop
Seat 5: vVQBckETtigfb5mAcyK0OA (big blind) collected ($0.50)
Seat 6: cDzbog6kwmJp+LBeBq+iMQ folded before Flop (didn't bet)



PokerStars Game #59938540804:  Hold'em No Limit ($0.25/$0.50) - 2009/07/01 0:17:27 ET
Table 'MJxeZCzYELxiIsyUZyT0jw' 6-max Seat #4 is the button
Seat 1: iKPos8JI094Tomq4tDSgnQ ($34.25 in chips)
Seat 2: r6H1GiZ6QIpMTDhyodKuRQ ($65.30 in chips)
Seat 3: JQZew0FjzS19kTjeNtrE+A ($50 in chips)
Seat 4: lP7Q6pewz4C2RsAfKsjdWw ($28.95 in chips)
Seat 5: 3jvoOXNtXE90w2BdfNZwZQ ($50 in chips)
Seat 6: TTx3CHxyi0SObcHyMJRp5w ($47.80 in chips)
3jvoOXNtXE90w2BdfNZwZQ: posts small blind $0.25
TTx3CHxyi0SObcHyMJRp5w: posts big blind $0.50
*** HOLE CARDS ***
iKPos8JI094Tomq4tDSgnQ: raises $0.50 to $1
r6H1GiZ6QIpMTDhyodKuRQ: folds
JQZew0FjzS19kTjeNtrE+A: folds
lP7Q6pewz4C2RsAfKsjdWw: folds
3jvoOXNtXE90w2BdfNZwZQ: folds
TTx3CHxyi0SObcHyMJRp5w: folds
iKPos8JI094Tomq4tDSgnQ collected $1.25 from pot
*** SUMMARY ***
Total pot $1.25 | Rake $0
Seat 1: iKPos8JI094Tomq4tDSgnQ collected ($1.25)
Seat 2: r6H1GiZ6QIpMTDhyodKuRQ folded before Flop (didn't bet)
Seat 3: JQZew0FjzS19kTjeNtrE+A folded before Flop (didn't bet)
Seat 4: lP7Q6pewz4C2RsAfKsjdWw (button) folded before Flop (didn't bet)
Seat 5: 3jvoOXNtXE90w2BdfNZwZQ (small blind) folded before Flop
Seat 6: TTx3CHxyi0SObcHyMJRp5w (big blind) folded before Flop



PokerStars Game #59938542210:  Hold'em No Limit ($0.25/$0.50) - 2009/07/01 0:17:29 ET
Table '+dXkOAQyS8j9PQZusUTMpg' 2-max Seat #1 is the button
Seat 1: XFa6sBGjP2gxoIvxR3fZIg ($80.15 in chips)
Seat 2: 5IBeOgaApY1Bvzv2P8X4EA ($29.85 in chips)
XFa6sBGjP2gxoIvxR3fZIg: posts small blind $0.25
5IBeOgaApY1Bvzv2P8X4EA: posts big blind $0.50
*** HOLE CARDS ***
XFa6sBGjP2gxoIvxR3fZIg: raises $1 to $1.50
5IBeOgaApY1Bvzv2P8X4EA: raises $2 to $3.50
XFa6sBGjP2gxoIvxR3fZIg: calls $2
*** FLOP *** [7h 3h Kh]
5IBeOgaApY1Bvzv2P8X4EA: checks
XFa6sBGjP2gxoIvxR3fZIg: bets $5
5IBeOgaApY1Bvzv2P8X4EA: calls $5
*** TURN *** [7h 3h Kh] [8d]
5IBeOgaApY1Bvzv2P8X4EA: checks
XFa6sBGjP2gxoIvxR3fZIg: bets $24
5IBeOgaApY1Bvzv2P8X4EA said, "what do you have?"
XFa6sBGjP2gxoIvxR3fZIg said, "two cards"
5IBeOgaApY1Bvzv2P8X4EA said, "mmm"
5IBeOgaApY1Bvzv2P8X4EA: calls $21.35 and is all-in
*** RIVER *** [7h 3h Kh 8d] [4h]
*** SHOW DOWN ***
5IBeOgaApY1Bvzv2P8X4EA: shows [Ah 5s] (a flush, Ace high)
XFa6sBGjP2gxoIvxR3fZIg: mucks hand
5IBeOgaApY1Bvzv2P8X4EA collected $59.20 from pot
*** SUMMARY ***
Total pot $59.70 | Rake $0.50
Board [7h 3h Kh 8d 4h]
Seat 1: XFa6sBGjP2gxoIvxR3fZIg (button) (small blind) mucked
Seat 2: 5IBeOgaApY1Bvzv2P8X4EA (big blind) showed [Ah 5s] and won ($59.20) with a flush, Ace high



PokerStars Game #59938544644:  Hold'em No Limit ($0.25/$0.50) - 2009/07/01 0:17:32 ET
Table 'ZYwMb9E6tY50Qm+iNbXRYw' 2-max Seat #2 is the button
Seat 1: DXLfRb8KDZWmrztw2bwtFw ($28.70 in chips)
Seat 2: 16tvT7AYgZ2LgiGFcvFKQg ($6.90 in chips)
16tvT7AYgZ2LgiGFcvFKQg: posts small blind $0.25
DXLfRb8KDZWmrztw2bwtFw: posts big blind $0.50
*** HOLE CARDS ***
16tvT7AYgZ2LgiGFcvFKQg: raises $0.50 to $1
DXLfRb8KDZWmrztw2bwtFw: raises $3 to $4
16tvT7AYgZ2LgiGFcvFKQg: raises $2.90 to $6.90 and is all-in
DXLfRb8KDZWmrztw2bwtFw: calls $2.90
*** FLOP *** [8s 9c 3d]
*** TURN *** [8s 9c 3d] [2s]
*** RIVER *** [8s 9c 3d 2s] [3s]
*** SHOW DOWN ***
DXLfRb8KDZWmrztw2bwtFw: shows [Kc Qd] (a pair of Threes)
16tvT7AYgZ2LgiGFcvFKQg: shows [Tc 9h] (two pair, Nines and Threes)
16tvT7AYgZ2LgiGFcvFKQg collected $13.30 from pot
*** SUMMARY ***
Total pot $13.80 | Rake $0.50
Board [8s 9c 3d 2s 3s]
Seat 1: DXLfRb8KDZWmrztw2bwtFw (big blind) showed [Kc Qd] and lost with a pair of Threes
Seat 2: 16tvT7AYgZ2LgiGFcvFKQg (button) (small blind) showed [Tc 9h] and won ($13.30) with two pair, Nines and Threes



PokerStars Game #59938544630:  Hold'em No Limit ($0.25/$0.50) - 2009/07/01 0:17:32 ET
Table 'NCiXr0d5CEKBQr/cZgLhbA' 9-max Seat #2 is the button
Seat 1: RjBdQ6w31rgcy0o24VLR6w ($10 in chips)
Seat 2: ulxuJchBV9iguXg0FUonfg ($40.05 in chips)
Seat 3: xZCXQSXlrZkp3pZizzVXCw ($55.15 in chips)
Seat 4: CL4d+tvzcd4utdQxlPLOmg ($29.15 in chips)
Seat 5: zE9cVigS2nW/Ljy4K4bUQA ($30 in chips)
Seat 6: SKnJuWHScqetA/qG5p+wCg ($31.05 in chips)
Seat 8: 1MJUKc3cc0QmUoz1JZLR2w ($63.60 in chips)
Seat 9: WpvT3OUSiZlpvs+mPXFqtQ ($8.20 in chips)
xZCXQSXlrZkp3pZizzVXCw: posts small blind $0.25
CL4d+tvzcd4utdQxlPLOmg: posts big blind $0.50
M+7+BTmX5vZatHVuoRB1nA: sits out
*** HOLE CARDS ***
zE9cVigS2nW/Ljy4K4bUQA: folds
SKnJuWHScqetA/qG5p+wCg: folds
1MJUKc3cc0QmUoz1JZLR2w: folds
WpvT3OUSiZlpvs+mPXFqtQ: folds
RjBdQ6w31rgcy0o24VLR6w: folds
ulxuJchBV9iguXg0FUonfg: folds
xZCXQSXlrZkp3pZizzVXCw: folds
CL4d+tvzcd4utdQxlPLOmg collected $0.50 from pot
*** SUMMARY ***
Total pot $0.50 | Rake $0
Seat 1: RjBdQ6w31rgcy0o24VLR6w folded before Flop (didn't bet)
Seat 2: ulxuJchBV9iguXg0FUonfg (button) folded before Flop (didn't bet)
Seat 3: xZCXQSXlrZkp3pZizzVXCw (small blind) folded before Flop
Seat 4: CL4d+tvzcd4utdQxlPLOmg (big blind) collected ($0.50)
Seat 5: zE9cVigS2nW/Ljy4K4bUQA folded before Flop (didn't bet)
Seat 6: SKnJuWHScqetA/qG5p+wCg folded before Flop (didn't bet)
Seat 8: 1MJUKc3cc0QmUoz1JZLR2w folded before Flop (didn't bet)
Seat 9: WpvT3OUSiZlpvs+mPXFqtQ folded before Flop (didn't bet)



PokerStars Game #59938545346:  Hold'em No Limit ($0.25/$0.50) - 2009/07/01 0:17:33 ET
Table 'QOgaEqMcJ73pcUMMxoisUg' 6-max Seat #1 is the button
Seat 1: RFefXIDyFvNtJLq+CloCzA ($40.95 in chips)
Seat 2: Im2p1Nt83UKSqv5c9frm4Q ($50 in chips)
Seat 3: wUZNozoIDYf+16hp4nn6dw ($47.05 in chips)
Seat 4: zAcsDhG/T128Vn7XGVSgKg ($54.40 in chips)
Seat 6: s83dnhZ6VC53vY0/f6OV/g ($47 in chips)
Im2p1Nt83UKSqv5c9frm4Q: posts small blind $0.25
wUZNozoIDYf+16hp4nn6dw: posts big blind $0.50
*** HOLE CARDS ***
zAcsDhG/T128Vn7XGVSgKg: folds
s83dnhZ6VC53vY0/f6OV/g: folds
RFefXIDyFvNtJLq+CloCzA: folds
Im2p1Nt83UKSqv5c9frm4Q: folds
wUZNozoIDYf+16hp4nn6dw collected $0.50 from pot
*** SUMMARY ***
Total pot $0.50 | Rake $0
Seat 1: RFefXIDyFvNtJLq+CloCzA (button) folded before Flop (didn't bet)
Seat 2: Im2p1Nt83UKSqv5c9frm4Q (small blind) folded before Flop
Seat 3: wUZNozoIDYf+16hp4nn6dw (big blind) collected ($0.50)
Seat 4: zAcsDhG/T128Vn7XGVSgKg folded before Flop (didn't bet)
Seat 6: s83dnhZ6VC53vY0/f6OV/g folded before Flop (didn't bet)



PokerStars Game #59938545822:  Hold'em No Limit ($0.25/$0.50) - 2009/07/01 0:17:34 ET
Table 'm95HVfesC/VPgfGEjPuaIA' 2-max Seat #1 is the button
Seat 1: Fp/oksNpipCrD2MJ2pH20g ($13.70 in chips)
Seat 2: Ag6DvxX4vbRheqsv2zXKTQ ($30.65 in chips)
Fp/oksNpipCrD2MJ2pH20g: posts small blind $0.25
Ag6DvxX4vbRheqsv2zXKTQ: posts big blind $0.50
*** HOLE CARDS ***
Fp/oksNpipCrD2MJ2pH20g: raises $0.50 to $1
Ag6DvxX4vbRheqsv2zXKTQ: folds
Fp/oksNpipCrD2MJ2pH20g collected $1 from pot
Fp/oksNpipCrD2MJ2pH20g: doesn't show hand
*** SUMMARY ***
Total pot $1 | Rake $0
Seat 1: Fp/oksNpipCrD2MJ2pH20g (button) (small blind) collected ($1)
Seat 2: Ag6DvxX4vbRheqsv2zXKTQ (big blind) folded before Flop



PokerStars Game #59938547344:  Hold'em No Limit ($0.25/$0.50) - 2009/07/01 0:17:36 ET
Table 'kgbJRsxfv64KrErDRBAkcw' 6-max Seat #1 is the button
Seat 1: N7O9jUEx2YiQn1+yRYTHmw ($20 in chips)
Seat 2: Q+thC23WCv1kJUJtH/+4Jw ($38.40 in chips)
Seat 3: T0Gx/FcQ5VH9u7XaOMX97A ($61 in chips)
Seat 4: qanMEqjABjWxC/JgQ/0l7w ($58.45 in chips)
Seat 5: +Pf9jTVizYlIo+woPvptfA ($50 in chips)
Seat 6: DDfYzIrYT0t5R/hAJngtsg ($25.45 in chips)
Q+thC23WCv1kJUJtH/+4Jw: posts small blind $0.25
T0Gx/FcQ5VH9u7XaOMX97A: posts big blind $0.50
*** HOLE CARDS ***
qanMEqjABjWxC/JgQ/0l7w: folds
+Pf9jTVizYlIo+woPvptfA: folds
DDfYzIrYT0t5R/hAJngtsg: calls $0.50
N7O9jUEx2YiQn1+yRYTHmw: calls $0.50
Q+thC23WCv1kJUJtH/+4Jw: calls $0.25
T0Gx/FcQ5VH9u7XaOMX97A: checks
*** FLOP *** [4d 4s Tc]
Q+thC23WCv1kJUJtH/+4Jw: bets $1.50
T0Gx/FcQ5VH9u7XaOMX97A: folds
DDfYzIrYT0t5R/hAJngtsg: folds
N7O9jUEx2YiQn1+yRYTHmw: folds
Q+thC23WCv1kJUJtH/+4Jw collected $1.90 from pot
*** SUMMARY ***
Total pot $2 | Rake $0.10
Board [4d 4s Tc]
Seat 1: N7O9jUEx2YiQn1+yRYTHmw (button) folded on the Flop
Seat 2: Q+thC23WCv1kJUJtH/+4Jw (small blind) collected ($1.90)
Seat 3: T0Gx/FcQ5VH9u7XaOMX97A (big blind) folded on the Flop
Seat 4: qanMEqjABjWxC/JgQ/0l7w folded before Flop (didn't bet)
Seat 5: +Pf9jTVizYlIo+woPvptfA folded before Flop (didn't bet)
Seat 6: DDfYzIrYT0t5R/hAJngtsg folded on the Flop



PokerStars Game #59938548654:  Hold'em No Limit ($0.25/$0.50) - 2009/07/01 0:17:38 ET
Table 'c/CRn+68J3Y8KxD5g1ek2Q' 2-max Seat #1 is the button
Seat 1: 46qCyJ6evTkHo9al5sBMNA ($279.30 in chips)
Seat 2: BypVLsYQt3ePFm2xQL/dOA ($104.25 in chips)
46qCyJ6evTkHo9al5sBMNA: posts small blind $0.25
BypVLsYQt3ePFm2xQL/dOA: posts big blind $0.50
*** HOLE CARDS ***
46qCyJ6evTkHo9al5sBMNA: folds
BypVLsYQt3ePFm2xQL/dOA collected $0.50 from pot
BypVLsYQt3ePFm2xQL/dOA: doesn't show hand
*** SUMMARY ***
Total pot $0.50 | Rake $0
Seat 1: 46qCyJ6evTkHo9al5sBMNA (button) (small blind) folded before Flop
Seat 2: BypVLsYQt3ePFm2xQL/dOA (big blind) collected ($0.50)



PokerStars Game #59938549206:  Hold'em No Limit ($0.25/$0.50) - 2009/07/01 0:17:39 ET
Table 'raOT4/ipuZgzjfKHC+jD9g' 2-max Seat #1 is the button
Seat 1: IuwLemwLhc9fvrwBGs0AMA ($12.40 in chips)
Seat 2: Udr5juWSWUgTu1NlRhjMdA ($10.15 in chips)
IuwLemwLhc9fvrwBGs0AMA: posts small blind $0.25
Udr5juWSWUgTu1NlRhjMdA: posts big blind $0.50
*** HOLE CARDS ***
IuwLemwLhc9fvrwBGs0AMA: calls $0.25
Udr5juWSWUgTu1NlRhjMdA: checks
*** FLOP *** [Js 9d 4c]
Udr5juWSWUgTu1NlRhjMdA: bets $0.50
IuwLemwLhc9fvrwBGs0AMA: calls $0.50
*** TURN *** [Js 9d 4c] [Jh]
Udr5juWSWUgTu1NlRhjMdA: checks
IuwLemwLhc9fvrwBGs0AMA: checks
*** RIVER *** [Js 9d 4c Jh] [Ks]
Udr5juWSWUgTu1NlRhjMdA: checks
IuwLemwLhc9fvrwBGs0AMA: checks
*** SHOW DOWN ***
Udr5juWSWUgTu1NlRhjMdA: shows [2s Th] (a pair of Jacks)
IuwLemwLhc9fvrwBGs0AMA: shows [6s 9h] (two pair, Jacks and Nines)
IuwLemwLhc9fvrwBGs0AMA collected $1.95 from pot
*** SUMMARY ***
Total pot $2 | Rake $0.05
Board [Js 9d 4c Jh Ks]
Seat 1: IuwLemwLhc9fvrwBGs0AMA (button) (small blind) showed [6s 9h] and won ($1.95) with two pair, Jacks and Nines
Seat 2: Udr5juWSWUgTu1NlRhjMdA (big blind) showed [2s Th] and lost with a pair of Jacks



PokerStars Game #59938549664:  Hold'em No Limit ($0.25/$0.50) - 2009/07/01 0:17:40 ET
Table 'ibNfFy0bCzuBaUORla0aGw' 9-max Seat #5 is the button
Seat 2: 90Wb75h3W1BRpbqVnuk8gw ($54.10 in chips)
Seat 3: dDaHs3X8+fe3bIkRU0cbrw ($26.50 in chips)
Seat 4: YBN054X4blmis+B2bBlC0g ($18.55 in chips)
Seat 5: FRv75HO8CUsRZ1byEz06mQ ($12.60 in chips)
Seat 6: BmYrv3ec2k5d6pQq6iNaZw ($68.10 in chips)
Seat 8: xUrN9TWLq4m5V+OXY7KUUA ($50 in chips)
Seat 9: WpvT3OUSiZlpvs+mPXFqtQ ($8 in chips)
BmYrv3ec2k5d6pQq6iNaZw: posts small blind $0.25
mSD1pginDsyHG5PDfqzphw: is sitting out
xUrN9TWLq4m5V+OXY7KUUA: posts big blind $0.50
*** HOLE CARDS ***
mSD1pginDsyHG5PDfqzphw leaves the table
WpvT3OUSiZlpvs+mPXFqtQ: folds
90Wb75h3W1BRpbqVnuk8gw: folds
dDaHs3X8+fe3bIkRU0cbrw: raises $1 to $1.50
YBN054X4blmis+B2bBlC0g: folds
FRv75HO8CUsRZ1byEz06mQ: folds
9r7ZoBbAJj5IeyZ0q9BdzA joins the table at seat #7
BmYrv3ec2k5d6pQq6iNaZw: folds
xUrN9TWLq4m5V+OXY7KUUA: folds
dDaHs3X8+fe3bIkRU0cbrw collected $1.25 from pot
*** SUMMARY ***
Total pot $1.25 | Rake $0
Seat 2: 90Wb75h3W1BRpbqVnuk8gw folded before Flop (didn't bet)
Seat 3: dDaHs3X8+fe3bIkRU0cbrw collected ($1.25)
Seat 4: YBN054X4blmis+B2bBlC0g folded before Flop (didn't bet)
Seat 5: FRv75HO8CUsRZ1byEz06mQ (button) folded before Flop (didn't bet)
Seat 6: BmYrv3ec2k5d6pQq6iNaZw (small blind) folded before Flop
Seat 8: xUrN9TWLq4m5V+OXY7KUUA (big blind) folded before Flop
Seat 9: WpvT3OUSiZlpvs+mPXFqtQ folded before Flop (didn't bet)



PokerStars Game #59938551276:  Hold'em No Limit ($0.25/$0.50) - 2009/07/01 0:17:42 ET
Table 'm95HVfesC/VPgfGEjPuaIA' 2-max Seat #2 is the button
Seat 1: Fp/oksNpipCrD2MJ2pH20g ($14.20 in chips)
Seat 2: Ag6DvxX4vbRheqsv2zXKTQ ($30.15 in chips)
Ag6DvxX4vbRheqsv2zXKTQ: posts small blind $0.25
Fp/oksNpipCrD2MJ2pH20g: posts big blind $0.50
*** HOLE CARDS ***
Ag6DvxX4vbRheqsv2zXKTQ: folds
Fp/oksNpipCrD2MJ2pH20g collected $0.50 from pot
Fp/oksNpipCrD2MJ2pH20g: doesn't show hand
*** SUMMARY ***
Total pot $0.50 | Rake $0
Seat 1: Fp/oksNpipCrD2MJ2pH20g (big blind) collected ($0.50)
Seat 2: Ag6DvxX4vbRheqsv2zXKTQ (button) (small blind) folded before Flop



PokerStars Game #59938552542:  Hold'em No Limit ($0.25/$0.50) - 2009/07/01 0:17:44 ET
Table '37qXEp3oe+er5q4CZip9eQ' 6-max Seat #2 is the button
Seat 1: oqOqoO2AyCZenUghCxMDxw ($50 in chips)
Seat 2: g12O9qXTybyo2C0B2bXgjg ($33.25 in chips)
Seat 3: Rt6KgtZ8YaJoTc3FPim00w ($94.95 in chips)
Seat 4: AYb7QG0KzyicbOC0ZROE3Q ($12.50 in chips)
Seat 5: VOmI0x4dDPnTESZd5B4d1Q ($41.05 in chips)
Seat 6: f7zPpUQp9hHZgqhEvrUWQw ($51.65 in chips)
Rt6KgtZ8YaJoTc3FPim00w: posts small blind $0.25
AYb7QG0KzyicbOC0ZROE3Q: posts big blind $0.50
*** HOLE CARDS ***
VOmI0x4dDPnTESZd5B4d1Q: folds
f7zPpUQp9hHZgqhEvrUWQw: folds
oqOqoO2AyCZenUghCxMDxw: folds
g12O9qXTybyo2C0B2bXgjg: folds
Rt6KgtZ8YaJoTc3FPim00w: raises $1 to $1.50
AYb7QG0KzyicbOC0ZROE3Q: calls $1
*** FLOP *** [Qc 4h 6s]
Rt6KgtZ8YaJoTc3FPim00w: bets $2
AYb7QG0KzyicbOC0ZROE3Q: calls $2
*** TURN *** [Qc 4h 6s] [Kh]
Rt6KgtZ8YaJoTc3FPim00w: bets $91.45 and is all-in
AYb7QG0KzyicbOC0ZROE3Q: folds
Rt6KgtZ8YaJoTc3FPim00w collected $6.70 from pot
*** SUMMARY ***
Total pot $7 | Rake $0.30
Board [Qc 4h 6s Kh]
Seat 1: oqOqoO2AyCZenUghCxMDxw folded before Flop (didn't bet)
Seat 2: g12O9qXTybyo2C0B2bXgjg (button) folded before Flop (didn't bet)
Seat 3: Rt6KgtZ8YaJoTc3FPim00w (small blind) collected ($6.70)
Seat 4: AYb7QG0KzyicbOC0ZROE3Q (big blind) folded on the Turn
Seat 5: VOmI0x4dDPnTESZd5B4d1Q folded before Flop (didn't bet)
Seat 6: f7zPpUQp9hHZgqhEvrUWQw folded before Flop (didn't bet)



PokerStars Game #59938552710:  Hold'em No Limit ($0.25/$0.50) - 2009/07/01 0:17:44 ET
Table 'MJxeZCzYELxiIsyUZyT0jw' 6-max Seat #5 is the button
Seat 1: iKPos8JI094Tomq4tDSgnQ ($35 in chips)
Seat 2: r6H1GiZ6QIpMTDhyodKuRQ ($65.30 in chips)
Seat 3: JQZew0FjzS19kTjeNtrE+A ($50 in chips)
Seat 4: lP7Q6pewz4C2RsAfKsjdWw ($28.95 in chips)
Seat 5: 3jvoOXNtXE90w2BdfNZwZQ ($50 in chips)
Seat 6: TTx3CHxyi0SObcHyMJRp5w ($47.30 in chips)
TTx3CHxyi0SObcHyMJRp5w: posts small blind $0.25
iKPos8JI094Tomq4tDSgnQ: posts big blind $0.50
*** HOLE CARDS ***
r6H1GiZ6QIpMTDhyodKuRQ: raises $1.50 to $2
JQZew0FjzS19kTjeNtrE+A: folds
lP7Q6pewz4C2RsAfKsjdWw: folds
3jvoOXNtXE90w2BdfNZwZQ: folds
TTx3CHxyi0SObcHyMJRp5w: calls $1.75
iKPos8JI094Tomq4tDSgnQ: folds
*** FLOP *** [As 7c 4h]
TTx3CHxyi0SObcHyMJRp5w: checks
r6H1GiZ6QIpMTDhyodKuRQ: checks
*** TURN *** [As 7c 4h] [Jc]
TTx3CHxyi0SObcHyMJRp5w: bets $1
r6H1GiZ6QIpMTDhyodKuRQ: calls $1
*** RIVER *** [As 7c 4h Jc] [8h]
TTx3CHxyi0SObcHyMJRp5w: bets $2.50
r6H1GiZ6QIpMTDhyodKuRQ: folds
TTx3CHxyi0SObcHyMJRp5w collected $6.20 from pot
TTx3CHxyi0SObcHyMJRp5w: doesn't show hand
*** SUMMARY ***
Total pot $6.50 | Rake $0.30
Board [As 7c 4h Jc 8h]
Seat 1: iKPos8JI094Tomq4tDSgnQ (big blind) folded before Flop
Seat 2: r6H1GiZ6QIpMTDhyodKuRQ folded on the River
Seat 3: JQZew0FjzS19kTjeNtrE+A folded before Flop (didn't bet)
Seat 4: lP7Q6pewz4C2RsAfKsjdWw folded before Flop (didn't bet)
Seat 5: 3jvoOXNtXE90w2BdfNZwZQ (button) folded before Flop (didn't bet)
Seat 6: TTx3CHxyi0SObcHyMJRp5w (small blind) collected ($6.20)



PokerStars Game #59938553356:  Hold'em No Limit ($0.25/$0.50) - 2009/07/01 0:17:45 ET
Table 'T/PgNWqVyY6lkldcBVXYJQ' 6-max Seat #4 is the button
Seat 1: +Pf9jTVizYlIo+woPvptfA ($52.45 in chips)
Seat 2: oZAeY5rVqNGgt8yyQ0pxbA ($22.05 in chips)
Seat 3: L3OcNO1bgdqDI46j67KQPQ ($56.05 in chips)
Seat 4: jxMvxeUUL9UU0V6wVU+Iyw ($11.20 in chips)
Seat 5: vVQBckETtigfb5mAcyK0OA ($60.50 in chips)
Seat 6: cDzbog6kwmJp+LBeBq+iMQ ($17.10 in chips)
vVQBckETtigfb5mAcyK0OA: posts small blind $0.25
cDzbog6kwmJp+LBeBq+iMQ: posts big blind $0.50
*** HOLE CARDS ***
cDzbog6kwmJp+LBeBq+iMQ said, "NY"
+Pf9jTVizYlIo+woPvptfA: raises $1.50 to $2
oZAeY5rVqNGgt8yyQ0pxbA: folds
L3OcNO1bgdqDI46j67KQPQ: folds
jxMvxeUUL9UU0V6wVU+Iyw said, "Ahhh. North or South"
jxMvxeUUL9UU0V6wVU+Iyw: folds
vVQBckETtigfb5mAcyK0OA: folds
cDzbog6kwmJp+LBeBq+iMQ: calls $1.50
*** FLOP *** [9s 6d Td]
cDzbog6kwmJp+LBeBq+iMQ said, "western"
jxMvxeUUL9UU0V6wVU+Iyw said, "Seeing as I am familiar with Buffalo only"
cDzbog6kwmJp+LBeBq+iMQ said, "very close"
cDzbog6kwmJp+LBeBq+iMQ said, "45 minutes south"
cDzbog6kwmJp+LBeBq+iMQ: checks
+Pf9jTVizYlIo+woPvptfA: checks
*** TURN *** [9s 6d Td] [Tc]
jxMvxeUUL9UU0V6wVU+Iyw said, "Nice. close to PA?"
cDzbog6kwmJp+LBeBq+iMQ: checks
+Pf9jTVizYlIo+woPvptfA: checks
*** RIVER *** [9s 6d Td Tc] [Js]
cDzbog6kwmJp+LBeBq+iMQ said, "closer to erie than buffalo actually"
cDzbog6kwmJp+LBeBq+iMQ: checks
+Pf9jTVizYlIo+woPvptfA: checks
*** SHOW DOWN ***
cDzbog6kwmJp+LBeBq+iMQ: shows [Qc 2c] (a pair of Tens)
+Pf9jTVizYlIo+woPvptfA: shows [3d 3c] (two pair, Tens and Threes)
+Pf9jTVizYlIo+woPvptfA collected $4.05 from pot
*** SUMMARY ***
Total pot $4.25 | Rake $0.20
Board [9s 6d Td Tc Js]
Seat 1: +Pf9jTVizYlIo+woPvptfA showed [3d 3c] and won ($4.05) with two pair, Tens and Threes
Seat 2: oZAeY5rVqNGgt8yyQ0pxbA folded before Flop (didn't bet)
Seat 3: L3OcNO1bgdqDI46j67KQPQ folded before Flop (didn't bet)
Seat 4: jxMvxeUUL9UU0V6wVU+Iyw (button) folded before Flop (didn't bet)
Seat 5: vVQBckETtigfb5mAcyK0OA (small blind) folded before Flop
Seat 6: cDzbog6kwmJp+LBeBq+iMQ (big blind) showed [Qc 2c] and lost with a pair of Tens



PokerStars Game #59938552956:  Hold'em No Limit ($0.25/$0.50) - 2009/07/01 0:17:45 ET
Table 'X6IRCRTh+20gjz8aubWnwA' 9-max Seat #4 is the button
Seat 2: RjBdQ6w31rgcy0o24VLR6w ($10.90 in chips)
Seat 3: mSD1pginDsyHG5PDfqzphw ($10 in chips)
Seat 4: uw9QayAAxLM3Hb+HR7mSkg ($10.25 in chips)
Seat 6: /6In1zC3WtgwxDcueWzZWg ($57.60 in chips)
Seat 7: VBnpbzn0dIveV55qKvciew ($54.70 in chips)
Seat 8: BPMN9sOItJw6vWq3kypaYg ($27.20 in chips)
Seat 9: M+7+BTmX5vZatHVuoRB1nA ($82.60 in chips)
QtFsO51ArDuQ44+KvR2jow will be allowed to play after the button
/6In1zC3WtgwxDcueWzZWg: posts small blind $0.25
VBnpbzn0dIveV55qKvciew: posts big blind $0.50
*** HOLE CARDS ***
BPMN9sOItJw6vWq3kypaYg: folds
M+7+BTmX5vZatHVuoRB1nA: folds
RjBdQ6w31rgcy0o24VLR6w: folds
BPMN9sOItJw6vWq3kypaYg is sitting out
mSD1pginDsyHG5PDfqzphw: folds
uw9QayAAxLM3Hb+HR7mSkg: folds
BPMN9sOItJw6vWq3kypaYg leaves the table
/6In1zC3WtgwxDcueWzZWg: raises $1 to $1.50
VBnpbzn0dIveV55qKvciew: folds
/6In1zC3WtgwxDcueWzZWg collected $1 from pot
/6In1zC3WtgwxDcueWzZWg: doesn't show hand
*** SUMMARY ***
Total pot $1 | Rake $0
Seat 2: RjBdQ6w31rgcy0o24VLR6w folded before Flop (didn't bet)
Seat 3: mSD1pginDsyHG5PDfqzphw folded before Flop (didn't bet)
Seat 4: uw9QayAAxLM3Hb+HR7mSkg (button) folded before Flop (didn't bet)
Seat 6: /6In1zC3WtgwxDcueWzZWg (small blind) collected ($1)
Seat 7: VBnpbzn0dIveV55qKvciew (big blind) folded before Flop
Seat 8: BPMN9sOItJw6vWq3kypaYg folded before Flop (didn't bet)
Seat 9: M+7+BTmX5vZatHVuoRB1nA folded before Flop (didn't bet)



PokerStars Game #59938553312:  Hold'em No Limit ($0.25/$0.50) - 2009/07/01 0:17:45 ET
Table 'c/CRn+68J3Y8KxD5g1ek2Q' 2-max Seat #2 is the button
Seat 1: 46qCyJ6evTkHo9al5sBMNA ($279.05 in chips)
Seat 2: BypVLsYQt3ePFm2xQL/dOA ($104.50 in chips)
BypVLsYQt3ePFm2xQL/dOA: posts small blind $0.25
46qCyJ6evTkHo9al5sBMNA: posts big blind $0.50
*** HOLE CARDS ***
BypVLsYQt3ePFm2xQL/dOA: raises $1 to $1.50
46qCyJ6evTkHo9al5sBMNA: folds
BypVLsYQt3ePFm2xQL/dOA collected $1 from pot
BypVLsYQt3ePFm2xQL/dOA: doesn't show hand
*** SUMMARY ***
Total pot $1 | Rake $0
Seat 1: 46qCyJ6evTkHo9al5sBMNA (big blind) folded before Flop
Seat 2: BypVLsYQt3ePFm2xQL/dOA (button) (small blind) collected ($1)



PokerStars Game #59938555702:  Hold'em No Limit ($0.25/$0.50) - 2009/07/01 0:17:48 ET
Table 'mTxf8gPLgffN3Iwfm7Icfg' 2-max Seat #1 is the button
Seat 1: Do9Rlu1R5u/AcRtMTl8SYg ($50 in chips)
Seat 2: EMc5LPgVaded4Qc77vm0fw ($110.40 in chips)
Do9Rlu1R5u/AcRtMTl8SYg: posts small blind $0.25
EMc5LPgVaded4Qc77vm0fw: posts big blind $0.50
*** HOLE CARDS ***
Do9Rlu1R5u/AcRtMTl8SYg: folds
EMc5LPgVaded4Qc77vm0fw collected $0.50 from pot
EMc5LPgVaded4Qc77vm0fw: doesn't show hand
*** SUMMARY ***
Total pot $0.50 | Rake $0
Seat 1: Do9Rlu1R5u/AcRtMTl8SYg (button) (small blind) folded before Flop
Seat 2: EMc5LPgVaded4Qc77vm0fw (big blind) collected ($0.50)



PokerStars Game #59938556120:  Hold'em No Limit ($0.25/$0.50) - 2009/07/01 0:17:49 ET
Table '3FhG0gl3kMX3wBEEqj+wnQ' 9-max Seat #6 is the button
Seat 1: e0J9pdCNUDTCG031RnXqLA ($5.70 in chips)
Seat 2: 4dl3YNqZ6Houm2jZAzDmRg ($24.50 in chips)
Seat 4: bz4LMfV0GGl/MJ/ABXuPmg ($26.20 in chips)
Seat 5: XNMDwbXt/Q4jM99AXnbJDw ($55.55 in chips)
Seat 6: 5JJVDlaiMnB004o/RqbZZQ ($24.50 in chips)
Seat 7: mSD1pginDsyHG5PDfqzphw ($10 in chips)
Seat 8: j3K/Jujr7PY4ZM2RZvlH6A ($39.70 in chips)
Seat 9: tzoXBDwkkPV/XPJPkf963Q ($32.85 in chips)
mSD1pginDsyHG5PDfqzphw: posts small blind $0.25
j3K/Jujr7PY4ZM2RZvlH6A: posts big blind $0.50
dennisa: sits out
*** HOLE CARDS ***
tzoXBDwkkPV/XPJPkf963Q: folds
e0J9pdCNUDTCG031RnXqLA: raises $0.50 to $1
4dl3YNqZ6Houm2jZAzDmRg: folds
bz4LMfV0GGl/MJ/ABXuPmg: folds
XNMDwbXt/Q4jM99AXnbJDw: folds
5JJVDlaiMnB004o/RqbZZQ has timed out
5JJVDlaiMnB004o/RqbZZQ: folds
5JJVDlaiMnB004o/RqbZZQ is sitting out
5JJVDlaiMnB004o/RqbZZQ has returned
tzoXBDwkkPV/XPJPkf963Q said, "Bye all"
mSD1pginDsyHG5PDfqzphw: folds
tzoXBDwkkPV/XPJPkf963Q leaves the table
j3K/Jujr7PY4ZM2RZvlH6A: calls $0.50
*** FLOP *** [7d Qc 5h]
j3K/Jujr7PY4ZM2RZvlH6A: bets $1
e0J9pdCNUDTCG031RnXqLA: folds
L5e2lrPLQm1Pqx30IIZ/Fw joins the table at seat #9
j3K/Jujr7PY4ZM2RZvlH6A collected $2.15 from pot
j3K/Jujr7PY4ZM2RZvlH6A: doesn't show hand
*** SUMMARY ***
Total pot $2.25 | Rake $0.10
Board [7d Qc 5h]
Seat 1: e0J9pdCNUDTCG031RnXqLA folded on the Flop
Seat 2: 4dl3YNqZ6Houm2jZAzDmRg folded before Flop (didn't bet)
Seat 4: bz4LMfV0GGl/MJ/ABXuPmg folded before Flop (didn't bet)
Seat 5: XNMDwbXt/Q4jM99AXnbJDw folded before Flop (didn't bet)
Seat 6: 5JJVDlaiMnB004o/RqbZZQ (button) folded before Flop (didn't bet)
Seat 7: mSD1pginDsyHG5PDfqzphw (small blind) folded before Flop
Seat 8: j3K/Jujr7PY4ZM2RZvlH6A (big blind) collected ($2.15)
Seat 9: tzoXBDwkkPV/XPJPkf963Q folded before Flop (didn't bet)



PokerStars Game #59938556996:  Hold'em No Limit ($0.25/$0.50) - 2009/07/01 0:17:50 ET
Table 'ZYwMb9E6tY50Qm+iNbXRYw' 2-max Seat #1 is the button
Seat 1: DXLfRb8KDZWmrztw2bwtFw ($21.80 in chips)
Seat 2: 16tvT7AYgZ2LgiGFcvFKQg ($13.30 in chips)
DXLfRb8KDZWmrztw2bwtFw: posts small blind $0.25
16tvT7AYgZ2LgiGFcvFKQg: posts big blind $0.50
*** HOLE CARDS ***
DXLfRb8KDZWmrztw2bwtFw said, "so lucky"
DXLfRb8KDZWmrztw2bwtFw: calls $0.25
16tvT7AYgZ2LgiGFcvFKQg: checks
*** FLOP *** [3d Kc Ad]
16tvT7AYgZ2LgiGFcvFKQg: checks
DXLfRb8KDZWmrztw2bwtFw: checks
*** TURN *** [3d Kc Ad] [Td]
16tvT7AYgZ2LgiGFcvFKQg: checks
DXLfRb8KDZWmrztw2bwtFw: checks
*** RIVER *** [3d Kc Ad Td] [2d]
16tvT7AYgZ2LgiGFcvFKQg: checks
DXLfRb8KDZWmrztw2bwtFw: checks
*** SHOW DOWN ***
16tvT7AYgZ2LgiGFcvFKQg: shows [Qd Js] (a flush, Ace high)
DXLfRb8KDZWmrztw2bwtFw: mucks hand
16tvT7AYgZ2LgiGFcvFKQg collected $0.95 from pot
*** SUMMARY ***
Total pot $1 | Rake $0.05
Board [3d Kc Ad Td 2d]
Seat 1: DXLfRb8KDZWmrztw2bwtFw (button) (small blind) mucked
Seat 2: 16tvT7AYgZ2LgiGFcvFKQg (big blind) showed [Qd Js] and won ($0.95) with a flush, Ace high



PokerStars Game #59938556456:  Hold'em No Limit ($0.25/$0.50) - 2009/07/01 0:17:50 ET
Table 'm95HVfesC/VPgfGEjPuaIA' 2-max Seat #1 is the button
Seat 1: Fp/oksNpipCrD2MJ2pH20g ($14.45 in chips)
Seat 2: Ag6DvxX4vbRheqsv2zXKTQ ($29.90 in chips)
Fp/oksNpipCrD2MJ2pH20g: posts small blind $0.25
Ag6DvxX4vbRheqsv2zXKTQ: posts big blind $0.50
*** HOLE CARDS ***
Fp/oksNpipCrD2MJ2pH20g: calls $0.25
Ag6DvxX4vbRheqsv2zXKTQ: checks
*** FLOP *** [7d 9c 2h]
Ag6DvxX4vbRheqsv2zXKTQ: checks
Fp/oksNpipCrD2MJ2pH20g: checks
*** TURN *** [7d 9c 2h] [Td]
Ag6DvxX4vbRheqsv2zXKTQ: checks
Fp/oksNpipCrD2MJ2pH20g: checks
*** RIVER *** [7d 9c 2h Td] [9h]
Ag6DvxX4vbRheqsv2zXKTQ: checks
Fp/oksNpipCrD2MJ2pH20g: checks
*** SHOW DOWN ***
Ag6DvxX4vbRheqsv2zXKTQ: shows [Qh 6h] (a pair of Nines)
Fp/oksNpipCrD2MJ2pH20g: shows [Qd 7c] (two pair, Nines and Sevens)
Fp/oksNpipCrD2MJ2pH20g collected $0.95 from pot
*** SUMMARY ***
Total pot $1 | Rake $0.05
Board [7d 9c 2h Td 9h]
Seat 1: Fp/oksNpipCrD2MJ2pH20g (button) (small blind) showed [Qd 7c] and won ($0.95) with two pair, Nines and Sevens
Seat 2: Ag6DvxX4vbRheqsv2zXKTQ (big blind) showed [Qh 6h] and lost with a pair of Nines



PokerStars Game #59938557664:  Hold'em No Limit ($0.25/$0.50) - 2009/07/01 0:17:51 ET
Table 'E7bWJ45aoFXRpyRv2gw+Ig' 2-max Seat #1 is the button
Seat 1: FRkiRasEGlHUeLrEl+k/nA ($58.60 in chips)
Seat 2: 3Wro85I7472vJ4Wkpneo9A ($122.35 in chips)
FRkiRasEGlHUeLrEl+k/nA: posts small blind $0.25
3Wro85I7472vJ4Wkpneo9A: posts big blind $0.50
*** HOLE CARDS ***
FRkiRasEGlHUeLrEl+k/nA: calls $0.25
3Wro85I7472vJ4Wkpneo9A: checks
*** FLOP *** [6h 5s 3c]
3Wro85I7472vJ4Wkpneo9A: bets $1
FRkiRasEGlHUeLrEl+k/nA: folds
3Wro85I7472vJ4Wkpneo9A collected $0.95 from pot
3Wro85I7472vJ4Wkpneo9A: doesn't show hand
*** SUMMARY ***
Total pot $1 | Rake $0.05
Board [6h 5s 3c]
Seat 1: FRkiRasEGlHUeLrEl+k/nA (button) (small blind) folded on the Flop
Seat 2: 3Wro85I7472vJ4Wkpneo9A (big blind) collected ($0.95)



PokerStars Game #59938557364:  Hold'em No Limit ($0.25/$0.50) - 2009/07/01 0:17:51 ET
Table 'hSTs/dUsYLgJQuF2Onp0MQ' 6-max Seat #5 is the button
Seat 2: gSCZnZGMgaRWmRw5txyZIA ($13.90 in chips)
Seat 3: vQOrJuXbLC3UZDVklY9bOA ($19.95 in chips)
Seat 4: L0aIPg7qefDQjdJo3HCVEA ($13.70 in chips)
Seat 5: 686aeHikcJlgKkSuIFdcXQ ($59.15 in chips)
gSCZnZGMgaRWmRw5txyZIA: posts small blind $0.25
vQOrJuXbLC3UZDVklY9bOA: posts big blind $0.50
*** HOLE CARDS ***
L0aIPg7qefDQjdJo3HCVEA: folds
686aeHikcJlgKkSuIFdcXQ: raises $1 to $1.50
gSCZnZGMgaRWmRw5txyZIA: folds
vQOrJuXbLC3UZDVklY9bOA: calls $1
*** FLOP *** [Ts Kd 6d]
vQOrJuXbLC3UZDVklY9bOA: checks
686aeHikcJlgKkSuIFdcXQ: bets $3
+laPa9P7BjZKKnR0n+OmvA has returned
vQOrJuXbLC3UZDVklY9bOA: folds
686aeHikcJlgKkSuIFdcXQ collected $3.10 from pot
*** SUMMARY ***
Total pot $3.25 | Rake $0.15
Board [Ts Kd 6d]
Seat 2: gSCZnZGMgaRWmRw5txyZIA (small blind) folded before Flop
Seat 3: vQOrJuXbLC3UZDVklY9bOA (big blind) folded on the Flop
Seat 4: L0aIPg7qefDQjdJo3HCVEA folded before Flop (didn't bet)
Seat 5: 686aeHikcJlgKkSuIFdcXQ (button) collected ($3.10)



PokerStars Game #59938559860:  Hold'em No Limit ($0.25/$0.50) - 2009/07/01 0:17:54 ET
Table 'mTxf8gPLgffN3Iwfm7Icfg' 2-max Seat #2 is the button
Seat 1: Do9Rlu1R5u/AcRtMTl8SYg ($50 in chips)
Seat 2: EMc5LPgVaded4Qc77vm0fw ($110.65 in chips)
EMc5LPgVaded4Qc77vm0fw: posts small blind $0.25
Do9Rlu1R5u/AcRtMTl8SYg: posts big blind $0.50
*** HOLE CARDS ***
EMc5LPgVaded4Qc77vm0fw: raises $1 to $1.50
Do9Rlu1R5u/AcRtMTl8SYg: folds
Do9Rlu1R5u/AcRtMTl8SYg said, "nh"
EMc5LPgVaded4Qc77vm0fw collected $1 from pot
EMc5LPgVaded4Qc77vm0fw: doesn't show hand
*** SUMMARY ***
Total pot $1 | Rake $0
Seat 1: Do9Rlu1R5u/AcRtMTl8SYg (big blind) folded before Flop
Seat 2: EMc5LPgVaded4Qc77vm0fw (button) (small blind) collected ($1)



PokerStars Game #59938559756:  Hold'em No Limit ($0.25/$0.50) - 2009/07/01 0:17:54 ET
Table 'c/CRn+68J3Y8KxD5g1ek2Q' 2-max Seat #1 is the button
Seat 1: 46qCyJ6evTkHo9al5sBMNA ($278.55 in chips)
Seat 2: BypVLsYQt3ePFm2xQL/dOA ($105 in chips)
46qCyJ6evTkHo9al5sBMNA: posts small blind $0.25
BypVLsYQt3ePFm2xQL/dOA: posts big blind $0.50
*** HOLE CARDS ***
46qCyJ6evTkHo9al5sBMNA: folds
BypVLsYQt3ePFm2xQL/dOA collected $0.50 from pot
BypVLsYQt3ePFm2xQL/dOA: doesn't show hand
*** SUMMARY ***
Total pot $0.50 | Rake $0
Seat 1: 46qCyJ6evTkHo9al5sBMNA (button) (small blind) folded before Flop
Seat 2: BypVLsYQt3ePFm2xQL/dOA (big blind) collected ($0.50)



PokerStars Game #59938561170:  Hold'em No Limit ($0.25/$0.50) - 2009/07/01 0:17:56 ET
Table 'IeNZOZQ4T6oiaHqFeo6yIA' 2-max Seat #1 is the button
Seat 1: ndd1nfncBkWNitBnsfCoVQ ($62.10 in chips)
Seat 2: A91IUl5JaZROhtfCtnnwYw ($25.65 in chips)
ndd1nfncBkWNitBnsfCoVQ: posts small blind $0.25
A91IUl5JaZROhtfCtnnwYw: posts big blind $0.50
*** HOLE CARDS ***
ndd1nfncBkWNitBnsfCoVQ: raises $1 to $1.50
A91IUl5JaZROhtfCtnnwYw: calls $1
*** FLOP *** [Jc 4h 8s]
A91IUl5JaZROhtfCtnnwYw: checks
ndd1nfncBkWNitBnsfCoVQ: checks
*** TURN *** [Jc 4h 8s] [9c]
A91IUl5JaZROhtfCtnnwYw: checks
ndd1nfncBkWNitBnsfCoVQ: checks
*** RIVER *** [Jc 4h 8s 9c] [7c]
A91IUl5JaZROhtfCtnnwYw: checks
ndd1nfncBkWNitBnsfCoVQ: checks
*** SHOW DOWN ***
A91IUl5JaZROhtfCtnnwYw: shows [2d Ks] (high card King)
ndd1nfncBkWNitBnsfCoVQ: shows [5c As] (high card Ace)
ndd1nfncBkWNitBnsfCoVQ collected $2.85 from pot
*** SUMMARY ***
Total pot $3 | Rake $0.15
Board [Jc 4h 8s 9c 7c]
Seat 1: ndd1nfncBkWNitBnsfCoVQ (button) (small blind) showed [5c As] and won ($2.85) with high card Ace
Seat 2: A91IUl5JaZROhtfCtnnwYw (big blind) showed [2d Ks] and lost with high card King



PokerStars Game #59938562274:  Hold'em No Limit ($0.25/$0.50) - 2009/07/01 0:17:58 ET
Table 'PALRfuH85dr5IkDfdv6new' 9-max Seat #5 is the button
Seat 1: SKnJuWHScqetA/qG5p+wCg ($32.25 in chips)
Seat 2: 9r7ZoBbAJj5IeyZ0q9BdzA ($12.15 in chips)
Seat 3: 50QWoELmpmHFrFIlWMJo9g ($90.20 in chips)
Seat 4: UqQTn9qxH/IQXP1PWD7Gwg ($30 in chips)
Seat 5: jSSGUXdNFAZA3QCvTcUMQw ($40.95 in chips)
Seat 6: EiWj2MAl8RNcPhTkzz24Mw ($37.20 in chips)
Seat 7: 3NcyXvr39gnK+KbTq7ezyA ($35.25 in chips)
Seat 8: NkS+CseUKx4XHszWq0PXEQ ($45.10 in chips)
Seat 9: CIrAX/m6o7jYmKOAjJXv4Q ($37.35 in chips)
EiWj2MAl8RNcPhTkzz24Mw: posts small blind $0.25
3NcyXvr39gnK+KbTq7ezyA: posts big blind $0.50
UqQTn9qxH/IQXP1PWD7Gwg: posts big blind $0.50
*** HOLE CARDS ***
NkS+CseUKx4XHszWq0PXEQ: folds
CIrAX/m6o7jYmKOAjJXv4Q: folds
SKnJuWHScqetA/qG5p+wCg: folds
9r7ZoBbAJj5IeyZ0q9BdzA: calls $0.50
50QWoELmpmHFrFIlWMJo9g: folds
UqQTn9qxH/IQXP1PWD7Gwg: raises $1.50 to $2
jSSGUXdNFAZA3QCvTcUMQw: folds
EiWj2MAl8RNcPhTkzz24Mw: folds
3NcyXvr39gnK+KbTq7ezyA: folds
9r7ZoBbAJj5IeyZ0q9BdzA: calls $1.50
*** FLOP *** [5h 2c 4s]
9r7ZoBbAJj5IeyZ0q9BdzA: bets $1
UqQTn9qxH/IQXP1PWD7Gwg: raises $3 to $4
9r7ZoBbAJj5IeyZ0q9BdzA: folds
UqQTn9qxH/IQXP1PWD7Gwg collected $6.45 from pot
*** SUMMARY ***
Total pot $6.75 | Rake $0.30
Board [5h 2c 4s]
Seat 1: SKnJuWHScqetA/qG5p+wCg folded before Flop (didn't bet)
Seat 2: 9r7ZoBbAJj5IeyZ0q9BdzA folded on the Flop
Seat 3: 50QWoELmpmHFrFIlWMJo9g folded before Flop (didn't bet)
Seat 4: UqQTn9qxH/IQXP1PWD7Gwg collected ($6.45)
Seat 5: jSSGUXdNFAZA3QCvTcUMQw (button) folded before Flop (didn't bet)
Seat 6: EiWj2MAl8RNcPhTkzz24Mw (small blind) folded before Flop
Seat 7: 3NcyXvr39gnK+KbTq7ezyA (big blind) folded before Flop
Seat 8: NkS+CseUKx4XHszWq0PXEQ folded before Flop (didn't bet)
Seat 9: CIrAX/m6o7jYmKOAjJXv4Q folded before Flop (didn't bet)



PokerStars Game #59938562826:  Hold'em No Limit ($0.25/$0.50) - 2009/07/01 0:17:59 ET
Table 'QOgaEqMcJ73pcUMMxoisUg' 6-max Seat #2 is the button
Seat 1: RFefXIDyFvNtJLq+CloCzA ($40.95 in chips)
Seat 2: Im2p1Nt83UKSqv5c9frm4Q ($50 in chips)
Seat 3: wUZNozoIDYf+16hp4nn6dw ($47.30 in chips)
Seat 4: zAcsDhG/T128Vn7XGVSgKg ($54.40 in chips)
Seat 6: s83dnhZ6VC53vY0/f6OV/g ($47 in chips)
wUZNozoIDYf+16hp4nn6dw: posts small blind $0.25
zAcsDhG/T128Vn7XGVSgKg: posts big blind $0.50
*** HOLE CARDS ***
s83dnhZ6VC53vY0/f6OV/g: raises $1.50 to $2
RFefXIDyFvNtJLq+CloCzA: folds
Im2p1Nt83UKSqv5c9frm4Q: folds
wUZNozoIDYf+16hp4nn6dw: calls $1.75
zAcsDhG/T128Vn7XGVSgKg: folds
*** FLOP *** [9s Qh 6h]
wUZNozoIDYf+16hp4nn6dw: checks
s83dnhZ6VC53vY0/f6OV/g: checks
*** TURN *** [9s Qh 6h] [Jc]
wUZNozoIDYf+16hp4nn6dw: checks
s83dnhZ6VC53vY0/f6OV/g: bets $3
wUZNozoIDYf+16hp4nn6dw: folds
s83dnhZ6VC53vY0/f6OV/g collected $4.30 from pot
*** SUMMARY ***
Total pot $4.50 | Rake $0.20
Board [9s Qh 6h Jc]
Seat 1: RFefXIDyFvNtJLq+CloCzA folded before Flop (didn't bet)
Seat 2: Im2p1Nt83UKSqv5c9frm4Q (button) folded before Flop (didn't bet)
Seat 3: wUZNozoIDYf+16hp4nn6dw (small blind) folded on the Turn
Seat 4: zAcsDhG/T128Vn7XGVSgKg (big blind) folded before Flop
Seat 6: s83dnhZ6VC53vY0/f6OV/g collected ($4.30)



PokerStars Game #59938563956:  Hold'em No Limit ($0.25/$0.50) - 2009/07/01 0:18:01 ET
Table 'c/CRn+68J3Y8KxD5g1ek2Q' 2-max Seat #2 is the button
Seat 1: 46qCyJ6evTkHo9al5sBMNA ($278.30 in chips)
Seat 2: BypVLsYQt3ePFm2xQL/dOA ($105.25 in chips)
BypVLsYQt3ePFm2xQL/dOA: posts small blind $0.25
46qCyJ6evTkHo9al5sBMNA: posts big blind $0.50
*** HOLE CARDS ***
BypVLsYQt3ePFm2xQL/dOA: raises $1 to $1.50
46qCyJ6evTkHo9al5sBMNA: folds
BypVLsYQt3ePFm2xQL/dOA collected $1 from pot
BypVLsYQt3ePFm2xQL/dOA: doesn't show hand
*** SUMMARY ***
Total pot $1 | Rake $0
Seat 1: 46qCyJ6evTkHo9al5sBMNA (big blind) folded before Flop
Seat 2: BypVLsYQt3ePFm2xQL/dOA (button) (small blind) collected ($1)



PokerStars Game #59938564906:  Hold'em No Limit ($0.25/$0.50) - 2009/07/01 0:18:02 ET
Table 'Nz0Vr7WMHL2g5Uk7dDZjpw' 9-max Seat #4 is the button
Seat 1: tLkxo7JgV+WWI0UBw44K5A ($97.25 in chips)
Seat 3: 4QTiNH5fteLgJjx/s6Hy6A ($15.30 in chips)
Seat 4: 5JJVDlaiMnB004o/RqbZZQ ($27.50 in chips)
Seat 5: WGW0DgjBUXs1ylURHG8vnQ ($17.60 in chips)
Seat 6: k1f0lS7tlMHCLGs0JT34Tg ($10 in chips)
Seat 7: KPLH0gELgFe2OuAnhJFI5w ($20.95 in chips)
Seat 8: HkZI6g4zl83TDTA7SRspmQ ($21.70 in chips)
Seat 9: Ak2W6V2TDVIQrvSAy4eD7Q ($21.40 in chips)
WGW0DgjBUXs1ylURHG8vnQ: posts small blind $0.25
k1f0lS7tlMHCLGs0JT34Tg: posts big blind $0.50
XNMDwbXt/Q4jM99AXnbJDw: sits out
*** HOLE CARDS ***
KPLH0gELgFe2OuAnhJFI5w: calls $0.50
HkZI6g4zl83TDTA7SRspmQ: folds
Ak2W6V2TDVIQrvSAy4eD7Q: folds
tLkxo7JgV+WWI0UBw44K5A has timed out
tLkxo7JgV+WWI0UBw44K5A: folds
tLkxo7JgV+WWI0UBw44K5A is sitting out
4QTiNH5fteLgJjx/s6Hy6A: calls $0.50
5JJVDlaiMnB004o/RqbZZQ has timed out
5JJVDlaiMnB004o/RqbZZQ: folds
5JJVDlaiMnB004o/RqbZZQ is sitting out
5JJVDlaiMnB004o/RqbZZQ has returned
WGW0DgjBUXs1ylURHG8vnQ: calls $0.25
k1f0lS7tlMHCLGs0JT34Tg: checks
*** FLOP *** [2d 3d 9d]
WGW0DgjBUXs1ylURHG8vnQ: bets $0.50
k1f0lS7tlMHCLGs0JT34Tg: folds
KPLH0gELgFe2OuAnhJFI5w: folds
4QTiNH5fteLgJjx/s6Hy6A: raises $1 to $1.50
WGW0DgjBUXs1ylURHG8vnQ: calls $1
*** TURN *** [2d 3d 9d] [Kc]
WGW0DgjBUXs1ylURHG8vnQ: checks
4QTiNH5fteLgJjx/s6Hy6A: bets $2
WGW0DgjBUXs1ylURHG8vnQ: calls $2
*** RIVER *** [2d 3d 9d Kc] [8s]
WGW0DgjBUXs1ylURHG8vnQ: checks
4QTiNH5fteLgJjx/s6Hy6A: bets $3
WGW0DgjBUXs1ylURHG8vnQ: folds
4QTiNH5fteLgJjx/s6Hy6A collected $8.60 from pot
*** SUMMARY ***
Total pot $9 | Rake $0.40
Board [2d 3d 9d Kc 8s]
Seat 1: tLkxo7JgV+WWI0UBw44K5A folded before Flop (didn't bet)
Seat 3: 4QTiNH5fteLgJjx/s6Hy6A collected ($8.60)
Seat 4: 5JJVDlaiMnB004o/RqbZZQ (button) folded before Flop (didn't bet)
Seat 5: WGW0DgjBUXs1ylURHG8vnQ (small blind) folded on the River
Seat 6: k1f0lS7tlMHCLGs0JT34Tg (big blind) folded on the Flop
Seat 7: KPLH0gELgFe2OuAnhJFI5w folded on the Flop
Seat 8: HkZI6g4zl83TDTA7SRspmQ folded before Flop (didn't bet)
Seat 9: Ak2W6V2TDVIQrvSAy4eD7Q folded before Flop (didn't bet)



PokerStars Game #59938565750:  Hold'em No Limit ($0.25/$0.50) - 2009/07/01 0:18:03 ET
Table 'raOT4/ipuZgzjfKHC+jD9g' 2-max Seat #2 is the button
Seat 1: IuwLemwLhc9fvrwBGs0AMA ($13.35 in chips)
Seat 2: Udr5juWSWUgTu1NlRhjMdA ($9.15 in chips)
Udr5juWSWUgTu1NlRhjMdA: posts small blind $0.25
IuwLemwLhc9fvrwBGs0AMA: posts big blind $0.50
*** HOLE CARDS ***
Udr5juWSWUgTu1NlRhjMdA: folds
IuwLemwLhc9fvrwBGs0AMA collected $0.50 from pot
IuwLemwLhc9fvrwBGs0AMA: doesn't show hand
*** SUMMARY ***
Total pot $0.50 | Rake $0
Seat 1: IuwLemwLhc9fvrwBGs0AMA (big blind) collected ($0.50)
Seat 2: Udr5juWSWUgTu1NlRhjMdA (button) (small blind) folded before Flop



PokerStars Game #59938566172:  Hold'em No Limit ($0.25/$0.50) - 2009/07/01 0:18:03 ET
Table 'kgbJRsxfv64KrErDRBAkcw' 6-max Seat #2 is the button
Seat 1: N7O9jUEx2YiQn1+yRYTHmw ($19.50 in chips)
Seat 2: Q+thC23WCv1kJUJtH/+4Jw ($39.80 in chips)
Seat 3: T0Gx/FcQ5VH9u7XaOMX97A ($60.50 in chips)
Seat 4: qanMEqjABjWxC/JgQ/0l7w ($58.45 in chips)
Seat 5: +Pf9jTVizYlIo+woPvptfA ($50 in chips)
Seat 6: DDfYzIrYT0t5R/hAJngtsg ($24.95 in chips)
T0Gx/FcQ5VH9u7XaOMX97A: posts small blind $0.25
qanMEqjABjWxC/JgQ/0l7w: posts big blind $0.50
*** HOLE CARDS ***
+Pf9jTVizYlIo+woPvptfA: folds
DDfYzIrYT0t5R/hAJngtsg: raises $1 to $1.50
N7O9jUEx2YiQn1+yRYTHmw: folds
Q+thC23WCv1kJUJtH/+4Jw: folds
T0Gx/FcQ5VH9u7XaOMX97A: folds
qanMEqjABjWxC/JgQ/0l7w: calls $1
*** FLOP *** [Qd 6c 4h]
qanMEqjABjWxC/JgQ/0l7w: checks
DDfYzIrYT0t5R/hAJngtsg: checks
*** TURN *** [Qd 6c 4h] [3c]
qanMEqjABjWxC/JgQ/0l7w: checks
DDfYzIrYT0t5R/hAJngtsg: bets $1
qanMEqjABjWxC/JgQ/0l7w: folds
DDfYzIrYT0t5R/hAJngtsg collected $3.10 from pot
*** SUMMARY ***
Total pot $3.25 | Rake $0.15
Board [Qd 6c 4h 3c]
Seat 1: N7O9jUEx2YiQn1+yRYTHmw folded before Flop (didn't bet)
Seat 2: Q+thC23WCv1kJUJtH/+4Jw (button) folded before Flop (didn't bet)
Seat 3: T0Gx/FcQ5VH9u7XaOMX97A (small blind) folded before Flop
Seat 4: qanMEqjABjWxC/JgQ/0l7w (big blind) folded on the Turn
Seat 5: +Pf9jTVizYlIo+woPvptfA folded before Flop (didn't bet)
Seat 6: DDfYzIrYT0t5R/hAJngtsg collected ($3.10)



PokerStars Game #59938566306:  Hold'em No Limit ($0.25/$0.50) - 2009/07/01 0:18:04 ET
Table 'mTxf8gPLgffN3Iwfm7Icfg' 2-max Seat #1 is the button
Seat 1: Do9Rlu1R5u/AcRtMTl8SYg ($50 in chips)
Seat 2: EMc5LPgVaded4Qc77vm0fw ($111.15 in chips)
Do9Rlu1R5u/AcRtMTl8SYg: posts small blind $0.25
EMc5LPgVaded4Qc77vm0fw: posts big blind $0.50
*** HOLE CARDS ***
Do9Rlu1R5u/AcRtMTl8SYg: raises $1 to $1.50
EMc5LPgVaded4Qc77vm0fw: raises $4 to $5.50
Do9Rlu1R5u/AcRtMTl8SYg: folds
EMc5LPgVaded4Qc77vm0fw collected $3 from pot
EMc5LPgVaded4Qc77vm0fw: doesn't show hand
*** SUMMARY ***
Total pot $3 | Rake $0
Seat 1: Do9Rlu1R5u/AcRtMTl8SYg (button) (small blind) folded before Flop
Seat 2: EMc5LPgVaded4Qc77vm0fw (big blind) collected ($3)



PokerStars Game #59938566688:  Hold'em No Limit ($0.25/$0.50) - 2009/07/01 0:18:04 ET
Table 'NCiXr0d5CEKBQr/cZgLhbA' 9-max Seat #3 is the button
Seat 1: RjBdQ6w31rgcy0o24VLR6w ($10 in chips)
Seat 2: ulxuJchBV9iguXg0FUonfg ($40.05 in chips)
Seat 3: xZCXQSXlrZkp3pZizzVXCw ($54.90 in chips)
Seat 4: CL4d+tvzcd4utdQxlPLOmg ($29.40 in chips)
Seat 5: zE9cVigS2nW/Ljy4K4bUQA ($30 in chips)
Seat 6: SKnJuWHScqetA/qG5p+wCg ($31.05 in chips)
Seat 8: 1MJUKc3cc0QmUoz1JZLR2w ($63.60 in chips)
Seat 9: WpvT3OUSiZlpvs+mPXFqtQ ($8.20 in chips)
CL4d+tvzcd4utdQxlPLOmg: posts small blind $0.25
zE9cVigS2nW/Ljy4K4bUQA: posts big blind $0.50
M+7+BTmX5vZatHVuoRB1nA: sits out
*** HOLE CARDS ***
SKnJuWHScqetA/qG5p+wCg: folds
1MJUKc3cc0QmUoz1JZLR2w: calls $0.50
WpvT3OUSiZlpvs+mPXFqtQ: folds
RjBdQ6w31rgcy0o24VLR6w: folds
ulxuJchBV9iguXg0FUonfg: folds
xZCXQSXlrZkp3pZizzVXCw: folds
CL4d+tvzcd4utdQxlPLOmg: calls $0.25
zE9cVigS2nW/Ljy4K4bUQA: checks
*** FLOP *** [2d 6c Tc]
CL4d+tvzcd4utdQxlPLOmg: bets $0.75
zE9cVigS2nW/Ljy4K4bUQA: folds
1MJUKc3cc0QmUoz1JZLR2w: calls $0.75
*** TURN *** [2d 6c Tc] [3h]
CL4d+tvzcd4utdQxlPLOmg: bets $1.50
1MJUKc3cc0QmUoz1JZLR2w: folds
CL4d+tvzcd4utdQxlPLOmg collected $2.90 from pot
*** SUMMARY ***
Total pot $3 | Rake $0.10
Board [2d 6c Tc 3h]
Seat 1: RjBdQ6w31rgcy0o24VLR6w folded before Flop (didn't bet)
Seat 2: ulxuJchBV9iguXg0FUonfg folded before Flop (didn't bet)
Seat 3: xZCXQSXlrZkp3pZizzVXCw (button) folded before Flop (didn't bet)
Seat 4: CL4d+tvzcd4utdQxlPLOmg (small blind) collected ($2.90)
Seat 5: zE9cVigS2nW/Ljy4K4bUQA (big blind) folded on the Flop
Seat 6: SKnJuWHScqetA/qG5p+wCg folded before Flop (didn't bet)
Seat 8: 1MJUKc3cc0QmUoz1JZLR2w folded on the Turn
Seat 9: WpvT3OUSiZlpvs+mPXFqtQ folded before Flop (didn't bet)



PokerStars Game #59938566598:  Hold'em No Limit ($0.25/$0.50) - 2009/07/01 0:18:04 ET
Table 'lSisgp6H7Fg1hH5VfjEjYQ' 9-max Seat #6 is the button
Seat 1: pEW8B6uXbdR47kfljMQ3+Q ($38.95 in chips)
Seat 2: UrcnkQOiLVk8BlKDPJSy7Q ($51.10 in chips)
Seat 3: aTkyjTh3w5YLWiIERupZOA ($37.75 in chips)
Seat 4: nvw9yQKhJT56lA9k+TLdhw ($11.25 in chips)
Seat 5: mSD1pginDsyHG5PDfqzphw ($10 in chips)
Seat 6: +k7T5ocke8UwavtgUHm+Cg ($24.85 in chips)
Seat 7: dGw5MBstXyXhWHHVFOWOFA ($43.25 in chips)
Seat 8: a4JDWmpFQkL10XfAyuF51A ($27.50 in chips)
Seat 9: 5JJVDlaiMnB004o/RqbZZQ ($40.80 in chips)
dGw5MBstXyXhWHHVFOWOFA: posts small blind $0.25
a4JDWmpFQkL10XfAyuF51A: posts big blind $0.50
*** HOLE CARDS ***
5JJVDlaiMnB004o/RqbZZQ: folds
pEW8B6uXbdR47kfljMQ3+Q: folds
UrcnkQOiLVk8BlKDPJSy7Q: folds
aTkyjTh3w5YLWiIERupZOA: folds
nvw9yQKhJT56lA9k+TLdhw: folds
mSD1pginDsyHG5PDfqzphw: folds
+k7T5ocke8UwavtgUHm+Cg: raises $1 to $1.50
dGw5MBstXyXhWHHVFOWOFA: folds
a4JDWmpFQkL10XfAyuF51A: calls $1
*** FLOP *** [Qs 3c 7c]
a4JDWmpFQkL10XfAyuF51A: checks
+k7T5ocke8UwavtgUHm+Cg: bets $3
a4JDWmpFQkL10XfAyuF51A: folds
+k7T5ocke8UwavtgUHm+Cg collected $3.10 from pot
+k7T5ocke8UwavtgUHm+Cg: doesn't show hand
*** SUMMARY ***
Total pot $3.25 | Rake $0.15
Board [Qs 3c 7c]
Seat 1: pEW8B6uXbdR47kfljMQ3+Q folded before Flop (didn't bet)
Seat 2: UrcnkQOiLVk8BlKDPJSy7Q folded before Flop (didn't bet)
Seat 3: aTkyjTh3w5YLWiIERupZOA folded before Flop (didn't bet)
Seat 4: nvw9yQKhJT56lA9k+TLdhw folded before Flop (didn't bet)
Seat 5: mSD1pginDsyHG5PDfqzphw folded before Flop (didn't bet)
Seat 6: +k7T5ocke8UwavtgUHm+Cg (button) collected ($3.10)
Seat 7: dGw5MBstXyXhWHHVFOWOFA (small blind) folded before Flop
Seat 8: a4JDWmpFQkL10XfAyuF51A (big blind) folded on the Flop
Seat 9: 5JJVDlaiMnB004o/RqbZZQ folded before Flop (didn't bet)



PokerStars Game #59938566986:  Hold'em No Limit ($0.25/$0.50) - 2009/07/01 0:18:05 ET
Table '5EmHi+fnatGQQShcNmzOZQ' 6-max Seat #4 is the button
Seat 1: SwPczQo3cOtwEzhJrfO2cQ ($27.70 in chips)
Seat 3: L9qfLYXrczhAPd/VckgsWw ($30 in chips)
Seat 4: wOyVV9M/oyiw3YaOjNZ05w ($50.50 in chips)
Seat 5: kxPhs4ePFqMy52CInAJ2aw ($49.50 in chips)
Seat 6: 686aeHikcJlgKkSuIFdcXQ ($158.10 in chips)
kxPhs4ePFqMy52CInAJ2aw: posts small blind $0.25
686aeHikcJlgKkSuIFdcXQ: posts big blind $0.50
L9qfLYXrczhAPd/VckgsWw: posts big blind $0.50
*** HOLE CARDS ***
SwPczQo3cOtwEzhJrfO2cQ: folds
L9qfLYXrczhAPd/VckgsWw: checks
wOyVV9M/oyiw3YaOjNZ05w: raises $2 to $2.50
kxPhs4ePFqMy52CInAJ2aw: folds
686aeHikcJlgKkSuIFdcXQ: folds
L9qfLYXrczhAPd/VckgsWw: calls $2
*** FLOP *** [Ac Ad 3s]
L9qfLYXrczhAPd/VckgsWw: checks
wOyVV9M/oyiw3YaOjNZ05w: bets $2.75
L9qfLYXrczhAPd/VckgsWw: calls $2.75
*** TURN *** [Ac Ad 3s] [Ts]
APwvTk5XojDXGoQLb4O5iA has returned
L9qfLYXrczhAPd/VckgsWw: checks
wOyVV9M/oyiw3YaOjNZ05w: checks
*** RIVER *** [Ac Ad 3s Ts] [Qc]
L9qfLYXrczhAPd/VckgsWw: bets $4
wOyVV9M/oyiw3YaOjNZ05w: raises $26.75 to $30.75
L9qfLYXrczhAPd/VckgsWw: calls $20.75 and is all-in
*** SHOW DOWN ***
wOyVV9M/oyiw3YaOjNZ05w: shows [Kc Jh] (a straight, Ten to Ace)
L9qfLYXrczhAPd/VckgsWw: shows [Ah Qs] (a full house, Aces full of Queens)
L9qfLYXrczhAPd/VckgsWw collected $58.75 from pot
*** SUMMARY ***
Total pot $60.75 | Rake $2
Board [Ac Ad 3s Ts Qc]
Seat 1: SwPczQo3cOtwEzhJrfO2cQ folded before Flop (didn't bet)
Seat 3: L9qfLYXrczhAPd/VckgsWw showed [Ah Qs] and won ($58.75) with a full house, Aces full of Queens
Seat 4: wOyVV9M/oyiw3YaOjNZ05w (button) showed [Kc Jh] and lost with a straight, Ten to Ace
Seat 5: kxPhs4ePFqMy52CInAJ2aw (small blind) folded before Flop
Seat 6: 686aeHikcJlgKkSuIFdcXQ (big blind) folded before Flop



PokerStars Game #59938566984:  Hold'em No Limit ($0.25/$0.50) - 2009/07/01 0:18:05 ET
Table 'E7bWJ45aoFXRpyRv2gw+Ig' 2-max Seat #2 is the button
Seat 1: FRkiRasEGlHUeLrEl+k/nA ($58.10 in chips)
Seat 2: 3Wro85I7472vJ4Wkpneo9A ($122.80 in chips)
3Wro85I7472vJ4Wkpneo9A: posts small blind $0.25
FRkiRasEGlHUeLrEl+k/nA: posts big blind $0.50
*** HOLE CARDS ***
3Wro85I7472vJ4Wkpneo9A: raises $1 to $1.50
FRkiRasEGlHUeLrEl+k/nA: calls $1
*** FLOP *** [5h 8s Jh]
FRkiRasEGlHUeLrEl+k/nA: checks
3Wro85I7472vJ4Wkpneo9A: checks
*** TURN *** [5h 8s Jh] [7c]
FRkiRasEGlHUeLrEl+k/nA: bets $1.50
3Wro85I7472vJ4Wkpneo9A: calls $1.50
*** RIVER *** [5h 8s Jh 7c] [3c]
FRkiRasEGlHUeLrEl+k/nA: bets $6
3Wro85I7472vJ4Wkpneo9A: folds
FRkiRasEGlHUeLrEl+k/nA collected $5.75 from pot
FRkiRasEGlHUeLrEl+k/nA: doesn't show hand
*** SUMMARY ***
Total pot $6 | Rake $0.25
Board [5h 8s Jh 7c 3c]
Seat 1: FRkiRasEGlHUeLrEl+k/nA (big blind) collected ($5.75)
Seat 2: 3Wro85I7472vJ4Wkpneo9A (button) (small blind) folded on the River



PokerStars Game #59938568816:  Hold'em No Limit ($0.25/$0.50) - 2009/07/01 0:18:08 ET
Table 'ZYwMb9E6tY50Qm+iNbXRYw' 2-max Seat #2 is the button
Seat 1: DXLfRb8KDZWmrztw2bwtFw ($21.30 in chips)
Seat 2: 16tvT7AYgZ2LgiGFcvFKQg ($13.75 in chips)
16tvT7AYgZ2LgiGFcvFKQg: posts small blind $0.25
DXLfRb8KDZWmrztw2bwtFw: posts big blind $0.50
*** HOLE CARDS ***
16tvT7AYgZ2LgiGFcvFKQg: calls $0.25
DXLfRb8KDZWmrztw2bwtFw: checks
*** FLOP *** [8s Ad 4c]
DXLfRb8KDZWmrztw2bwtFw: bets $1.50
16tvT7AYgZ2LgiGFcvFKQg: raises $1.50 to $3
DXLfRb8KDZWmrztw2bwtFw: calls $1.50
*** TURN *** [8s Ad 4c] [6s]
DXLfRb8KDZWmrztw2bwtFw: bets $1
16tvT7AYgZ2LgiGFcvFKQg: raises $9.25 to $10.25 and is all-in
DXLfRb8KDZWmrztw2bwtFw: calls $9.25
*** RIVER *** [8s Ad 4c 6s] [2c]
*** SHOW DOWN ***
DXLfRb8KDZWmrztw2bwtFw: shows [7c Ah] (a pair of Aces)
16tvT7AYgZ2LgiGFcvFKQg: shows [4h 8h] (two pair, Eights and Fours)
16tvT7AYgZ2LgiGFcvFKQg collected $27 from pot
*** SUMMARY ***
Total pot $27.50 | Rake $0.50
Board [8s Ad 4c 6s 2c]
Seat 1: DXLfRb8KDZWmrztw2bwtFw (big blind) showed [7c Ah] and lost with a pair of Aces
Seat 2: 16tvT7AYgZ2LgiGFcvFKQg (button) (small blind) showed [4h 8h] and won ($27) with two pair, Eights and Fours



PokerStars Game #59938570084:  Hold'em No Limit ($0.25/$0.50) - 2009/07/01 0:18:09 ET
Table 'c/CRn+68J3Y8KxD5g1ek2Q' 2-max Seat #1 is the button
Seat 1: 46qCyJ6evTkHo9al5sBMNA ($277.80 in chips)
Seat 2: BypVLsYQt3ePFm2xQL/dOA ($105.75 in chips)
46qCyJ6evTkHo9al5sBMNA: posts small blind $0.25
BypVLsYQt3ePFm2xQL/dOA: posts big blind $0.50
*** HOLE CARDS ***
46qCyJ6evTkHo9al5sBMNA: raises $1 to $1.50
BypVLsYQt3ePFm2xQL/dOA: calls $1
*** FLOP *** [Jh Ks Qh]
BypVLsYQt3ePFm2xQL/dOA: checks
46qCyJ6evTkHo9al5sBMNA: checks
*** TURN *** [Jh Ks Qh] [8s]
BypVLsYQt3ePFm2xQL/dOA: bets $2.50
46qCyJ6evTkHo9al5sBMNA: calls $2.50
*** RIVER *** [Jh Ks Qh 8s] [3h]
BypVLsYQt3ePFm2xQL/dOA: bets $9.50
46qCyJ6evTkHo9al5sBMNA: folds
BypVLsYQt3ePFm2xQL/dOA collected $7.65 from pot
BypVLsYQt3ePFm2xQL/dOA: doesn't show hand
*** SUMMARY ***
Total pot $8 | Rake $0.35
Board [Jh Ks Qh 8s 3h]
Seat 1: 46qCyJ6evTkHo9al5sBMNA (button) (small blind) folded on the River
Seat 2: BypVLsYQt3ePFm2xQL/dOA (big blind) collected ($7.65)



PokerStars Game #59938569598:  Hold'em No Limit ($0.25/$0.50) - 2009/07/01 0:18:09 ET
Table 'tyR5AZNKV8Aadbrnrnlg7g' 6-max Seat #4 is the button
Seat 1: R+KjpH/wSjDLhtIy9+edNA ($52.35 in chips)
Seat 2: 58zdeSBSuSFX/qZfhc7YmA ($33.85 in chips)
Seat 3: jUhx+m+V7qfbLZTjgwZByg ($16.10 in chips)
Seat 4: Rt6KgtZ8YaJoTc3FPim00w ($87 in chips)
Seat 5: EIg3r3fRFKG2HhgpDlIJHg ($2.60 in chips)
Seat 6: DMQLAmut/l19xN5STQndFg ($15.65 in chips)
EIg3r3fRFKG2HhgpDlIJHg: posts small blind $0.25
DMQLAmut/l19xN5STQndFg: posts big blind $0.50
*** HOLE CARDS ***
R+KjpH/wSjDLhtIy9+edNA: folds
58zdeSBSuSFX/qZfhc7YmA: folds
jUhx+m+V7qfbLZTjgwZByg: raises $1.50 to $2
Rt6KgtZ8YaJoTc3FPim00w: folds
EIg3r3fRFKG2HhgpDlIJHg: folds
DMQLAmut/l19xN5STQndFg: calls $1.50
*** FLOP *** [4s Jd 6h]
DMQLAmut/l19xN5STQndFg: checks
jUhx+m+V7qfbLZTjgwZByg: bets $2
DMQLAmut/l19xN5STQndFg: calls $2
*** TURN *** [4s Jd 6h] [Jh]
DMQLAmut/l19xN5STQndFg: bets $4
jUhx+m+V7qfbLZTjgwZByg: calls $4
*** RIVER *** [4s Jd 6h Jh] [6d]
DMQLAmut/l19xN5STQndFg: checks
jUhx+m+V7qfbLZTjgwZByg: checks
*** SHOW DOWN ***
DMQLAmut/l19xN5STQndFg: shows [Ts 9s] (two pair, Jacks and Sixes)
jUhx+m+V7qfbLZTjgwZByg: shows [9h Ah] (two pair, Jacks and Sixes - Ace kicker)
jUhx+m+V7qfbLZTjgwZByg collected $15.50 from pot
*** SUMMARY ***
Total pot $16.25 | Rake $0.75
Board [4s Jd 6h Jh 6d]
Seat 1: R+KjpH/wSjDLhtIy9+edNA folded before Flop (didn't bet)
Seat 2: 58zdeSBSuSFX/qZfhc7YmA folded before Flop (didn't bet)
Seat 3: jUhx+m+V7qfbLZTjgwZByg showed [9h Ah] and won ($15.50) with two pair, Jacks and Sixes
Seat 4: Rt6KgtZ8YaJoTc3FPim00w (button) folded before Flop (didn't bet)
Seat 5: EIg3r3fRFKG2HhgpDlIJHg (small blind) folded before Flop
Seat 6: DMQLAmut/l19xN5STQndFg (big blind) showed [Ts 9s] and lost with two pair, Jacks and Sixes



PokerStars Game #59938570628:  Hold'em No Limit ($0.25/$0.50) - 2009/07/01 0:18:10 ET
Table 'raOT4/ipuZgzjfKHC+jD9g' 2-max Seat #1 is the button
Seat 1: IuwLemwLhc9fvrwBGs0AMA ($13.60 in chips)
Seat 2: Udr5juWSWUgTu1NlRhjMdA ($8.90 in chips)
IuwLemwLhc9fvrwBGs0AMA: posts small blind $0.25
Udr5juWSWUgTu1NlRhjMdA: posts big blind $0.50
*** HOLE CARDS ***
IuwLemwLhc9fvrwBGs0AMA: raises $0.50 to $1
Udr5juWSWUgTu1NlRhjMdA: raises $7.90 to $8.90 and is all-in
IuwLemwLhc9fvrwBGs0AMA: folds
Udr5juWSWUgTu1NlRhjMdA collected $2 from pot
Udr5juWSWUgTu1NlRhjMdA: doesn't show hand
*** SUMMARY ***
Total pot $2 | Rake $0
Seat 1: IuwLemwLhc9fvrwBGs0AMA (button) (small blind) folded before Flop
Seat 2: Udr5juWSWUgTu1NlRhjMdA (big blind) collected ($2)



PokerStars Game #59938571442:  Hold'em No Limit ($0.25/$0.50) - 2009/07/01 0:18:12 ET
Table 'm95HVfesC/VPgfGEjPuaIA' 2-max Seat #2 is the button
Seat 1: Fp/oksNpipCrD2MJ2pH20g ($14.90 in chips)
Seat 2: Ag6DvxX4vbRheqsv2zXKTQ ($29.40 in chips)
Ag6DvxX4vbRheqsv2zXKTQ: posts small blind $0.25
Fp/oksNpipCrD2MJ2pH20g: posts big blind $0.50
*** HOLE CARDS ***
Ag6DvxX4vbRheqsv2zXKTQ: folds
Fp/oksNpipCrD2MJ2pH20g collected $0.50 from pot
Fp/oksNpipCrD2MJ2pH20g: doesn't show hand
*** SUMMARY ***
Total pot $0.50 | Rake $0
Seat 1: Fp/oksNpipCrD2MJ2pH20g (big blind) collected ($0.50)
Seat 2: Ag6DvxX4vbRheqsv2zXKTQ (button) (small blind) folded before Flop



PokerStars Game #59938572122:  Hold'em No Limit ($0.25/$0.50) - 2009/07/01 0:18:13 ET
Table 'ibNfFy0bCzuBaUORla0aGw' 9-max Seat #6 is the button
Seat 2: 90Wb75h3W1BRpbqVnuk8gw ($54.10 in chips)
Seat 3: dDaHs3X8+fe3bIkRU0cbrw ($27.25 in chips)
Seat 4: YBN054X4blmis+B2bBlC0g ($18.55 in chips)
Seat 5: FRv75HO8CUsRZ1byEz06mQ ($12.60 in chips)
Seat 6: BmYrv3ec2k5d6pQq6iNaZw ($67.85 in chips)
Seat 8: xUrN9TWLq4m5V+OXY7KUUA ($50 in chips)
Seat 9: WpvT3OUSiZlpvs+mPXFqtQ ($8 in chips)
9r7ZoBbAJj5IeyZ0q9BdzA will be allowed to play after the button
xUrN9TWLq4m5V+OXY7KUUA: posts small blind $0.25
WpvT3OUSiZlpvs+mPXFqtQ: posts big blind $0.50
*** HOLE CARDS ***
90Wb75h3W1BRpbqVnuk8gw: folds
dDaHs3X8+fe3bIkRU0cbrw: folds
YBN054X4blmis+B2bBlC0g: folds
FRv75HO8CUsRZ1byEz06mQ: raises $0.50 to $1
BmYrv3ec2k5d6pQq6iNaZw: folds
xUrN9TWLq4m5V+OXY7KUUA: folds
WpvT3OUSiZlpvs+mPXFqtQ: raises $1.50 to $2.50
FRv75HO8CUsRZ1byEz06mQ: calls $1.50
*** FLOP *** [5h Tc 5c]
WpvT3OUSiZlpvs+mPXFqtQ: checks
FRv75HO8CUsRZ1byEz06mQ: checks
*** TURN *** [5h Tc 5c] [7d]
WpvT3OUSiZlpvs+mPXFqtQ: checks
FRv75HO8CUsRZ1byEz06mQ: checks
*** RIVER *** [5h Tc 5c 7d] [Jd]
WpvT3OUSiZlpvs+mPXFqtQ: bets $2.50
FRv75HO8CUsRZ1byEz06mQ: folds
WpvT3OUSiZlpvs+mPXFqtQ collected $5 from pot
*** SUMMARY ***
Total pot $5.25 | Rake $0.25
Board [5h Tc 5c 7d Jd]
Seat 2: 90Wb75h3W1BRpbqVnuk8gw folded before Flop (didn't bet)
Seat 3: dDaHs3X8+fe3bIkRU0cbrw folded before Flop (didn't bet)
Seat 4: YBN054X4blmis+B2bBlC0g folded before Flop (didn't bet)
Seat 5: FRv75HO8CUsRZ1byEz06mQ folded on the River
Seat 6: BmYrv3ec2k5d6pQq6iNaZw (button) folded before Flop (didn't bet)
Seat 8: xUrN9TWLq4m5V+OXY7KUUA (small blind) folded before Flop
Seat 9: WpvT3OUSiZlpvs+mPXFqtQ (big blind) collected ($5)



PokerStars Game #59938573454:  Hold'em No Limit ($0.25/$0.50) - 2009/07/01 0:18:15 ET
Table 'X6IRCRTh+20gjz8aubWnwA' 9-max Seat #6 is the button
Seat 2: RjBdQ6w31rgcy0o24VLR6w ($10.90 in chips)
Seat 3: mSD1pginDsyHG5PDfqzphw ($10 in chips)
Seat 4: uw9QayAAxLM3Hb+HR7mSkg ($10.25 in chips)
Seat 5: QtFsO51ArDuQ44+KvR2jow ($30 in chips)
Seat 6: /6In1zC3WtgwxDcueWzZWg ($58.10 in chips)
Seat 7: VBnpbzn0dIveV55qKvciew ($54.20 in chips)
Seat 9: M+7+BTmX5vZatHVuoRB1nA ($82.60 in chips)
VBnpbzn0dIveV55qKvciew: posts small blind $0.25
M+7+BTmX5vZatHVuoRB1nA: posts big blind $0.50
QtFsO51ArDuQ44+KvR2jow: posts big blind $0.50
*** HOLE CARDS ***
RjBdQ6w31rgcy0o24VLR6w: folds
robben2006 joins the table at seat #8
mSD1pginDsyHG5PDfqzphw: folds
uw9QayAAxLM3Hb+HR7mSkg: folds
QtFsO51ArDuQ44+KvR2jow: checks
/6In1zC3WtgwxDcueWzZWg: folds
VBnpbzn0dIveV55qKvciew: folds
M+7+BTmX5vZatHVuoRB1nA: checks
*** FLOP *** [Ad 7s Kc]
M+7+BTmX5vZatHVuoRB1nA: checks
QtFsO51ArDuQ44+KvR2jow: bets $1.50
M+7+BTmX5vZatHVuoRB1nA: folds
QtFsO51ArDuQ44+KvR2jow collected $1.20 from pot
*** SUMMARY ***
Total pot $1.25 | Rake $0.05
Board [Ad 7s Kc]
Seat 2: RjBdQ6w31rgcy0o24VLR6w folded before Flop (didn't bet)
Seat 3: mSD1pginDsyHG5PDfqzphw folded before Flop (didn't bet)
Seat 4: uw9QayAAxLM3Hb+HR7mSkg folded before Flop (didn't bet)
Seat 5: QtFsO51ArDuQ44+KvR2jow collected ($1.20)
Seat 6: /6In1zC3WtgwxDcueWzZWg (button) folded before Flop (didn't bet)
Seat 7: VBnpbzn0dIveV55qKvciew (small blind) folded before Flop
Seat 9: M+7+BTmX5vZatHVuoRB1nA (big blind) folded on the Flop



PokerStars Game #59938573896:  Hold'em No Limit ($0.25/$0.50) - 2009/07/01 0:18:15 ET
Table 'mTxf8gPLgffN3Iwfm7Icfg' 2-max Seat #2 is the button
Seat 1: Do9Rlu1R5u/AcRtMTl8SYg ($50 in chips)
Seat 2: EMc5LPgVaded4Qc77vm0fw ($112.65 in chips)
EMc5LPgVaded4Qc77vm0fw: posts small blind $0.25
Do9Rlu1R5u/AcRtMTl8SYg: posts big blind $0.50
*** HOLE CARDS ***
EMc5LPgVaded4Qc77vm0fw: folds
Do9Rlu1R5u/AcRtMTl8SYg collected $0.50 from pot
EMc5LPgVaded4Qc77vm0fw said, "ty"
Do9Rlu1R5u/AcRtMTl8SYg: doesn't show hand
*** SUMMARY ***
Total pot $0.50 | Rake $0
Seat 1: Do9Rlu1R5u/AcRtMTl8SYg (big blind) collected ($0.50)
Seat 2: EMc5LPgVaded4Qc77vm0fw (button) (small blind) folded before Flop



PokerStars Game #59938575678:  Hold'em No Limit ($0.25/$0.50) - 2009/07/01 0:18:18 ET
Table 'm95HVfesC/VPgfGEjPuaIA' 2-max Seat #1 is the button
Seat 1: Fp/oksNpipCrD2MJ2pH20g ($15.15 in chips)
Seat 2: Ag6DvxX4vbRheqsv2zXKTQ ($29.15 in chips)
Fp/oksNpipCrD2MJ2pH20g: posts small blind $0.25
Ag6DvxX4vbRheqsv2zXKTQ: posts big blind $0.50
*** HOLE CARDS ***
Fp/oksNpipCrD2MJ2pH20g: folds
Ag6DvxX4vbRheqsv2zXKTQ collected $0.50 from pot
*** SUMMARY ***
Total pot $0.50 | Rake $0
Seat 1: Fp/oksNpipCrD2MJ2pH20g (button) (small blind) folded before Flop
Seat 2: Ag6DvxX4vbRheqsv2zXKTQ (big blind) collected ($0.50)



PokerStars Game #59938575966:  Hold'em No Limit ($0.25/$0.50) - 2009/07/01 0:18:18 ET
Table 'eMxdLyFDf28E0wit6gm3Uw' 6-max Seat #2 is the button
Seat 1: tnD/64LagZ9qPaeOQVjVZg ($13.20 in chips)
Seat 2: jwuKQ1S3U4NnzMQn3E3dgw ($68.45 in chips)
Seat 3: dZcLsEI8iXkobBduRJ45Yw ($16.50 in chips)
Seat 4: QM93o65lI8kLzmiB/BILlA ($30 in chips)
Seat 5: X0X97o2fDAPiGx6o1gahsw ($55.05 in chips)
Seat 6: L0aIPg7qefDQjdJo3HCVEA ($9.25 in chips)
dZcLsEI8iXkobBduRJ45Yw: posts small blind $0.25
QM93o65lI8kLzmiB/BILlA: posts big blind $0.50
*** HOLE CARDS ***
X0X97o2fDAPiGx6o1gahsw: raises $1.50 to $2
L0aIPg7qefDQjdJo3HCVEA: folds
tnD/64LagZ9qPaeOQVjVZg: folds
jwuKQ1S3U4NnzMQn3E3dgw: folds
dZcLsEI8iXkobBduRJ45Yw: folds
QM93o65lI8kLzmiB/BILlA: calls $1.50
*** FLOP *** [Qd Ah Js]
QM93o65lI8kLzmiB/BILlA: checks
X0X97o2fDAPiGx6o1gahsw: checks
*** TURN *** [Qd Ah Js] [Kd]
QM93o65lI8kLzmiB/BILlA: checks
X0X97o2fDAPiGx6o1gahsw: checks
*** RIVER *** [Qd Ah Js Kd] [8h]
QM93o65lI8kLzmiB/BILlA: checks
X0X97o2fDAPiGx6o1gahsw: bets $2
QM93o65lI8kLzmiB/BILlA: folds
X0X97o2fDAPiGx6o1gahsw collected $4.05 from pot
*** SUMMARY ***
Total pot $4.25 | Rake $0.20
Board [Qd Ah Js Kd 8h]
Seat 1: tnD/64LagZ9qPaeOQVjVZg folded before Flop (didn't bet)
Seat 2: jwuKQ1S3U4NnzMQn3E3dgw (button) folded before Flop (didn't bet)
Seat 3: dZcLsEI8iXkobBduRJ45Yw (small blind) folded before Flop
Seat 4: QM93o65lI8kLzmiB/BILlA (big blind) folded on the River
Seat 5: X0X97o2fDAPiGx6o1gahsw collected ($4.05)
Seat 6: L0aIPg7qefDQjdJo3HCVEA folded before Flop (didn't bet)



PokerStars Game #59938577818:  Hold'em No Limit ($0.25/$0.50) - 2009/07/01 0:18:21 ET
Table 'mTxf8gPLgffN3Iwfm7Icfg' 2-max Seat #1 is the button
Seat 1: Do9Rlu1R5u/AcRtMTl8SYg ($50.25 in chips)
Seat 2: EMc5LPgVaded4Qc77vm0fw ($112.40 in chips)
Do9Rlu1R5u/AcRtMTl8SYg: posts small blind $0.25
EMc5LPgVaded4Qc77vm0fw: posts big blind $0.50
*** HOLE CARDS ***
Do9Rlu1R5u/AcRtMTl8SYg: raises $1 to $1.50
EMc5LPgVaded4Qc77vm0fw: calls $1
*** FLOP *** [8c 5d Kh]
EMc5LPgVaded4Qc77vm0fw: checks
Do9Rlu1R5u/AcRtMTl8SYg: bets $2
EMc5LPgVaded4Qc77vm0fw: folds
Do9Rlu1R5u/AcRtMTl8SYg collected $2.85 from pot
Do9Rlu1R5u/AcRtMTl8SYg: doesn't show hand
*** SUMMARY ***
Total pot $3 | Rake $0.15
Board [8c 5d Kh]
Seat 1: Do9Rlu1R5u/AcRtMTl8SYg (button) (small blind) collected ($2.85)
Seat 2: EMc5LPgVaded4Qc77vm0fw (big blind) folded on the Flop



PokerStars Game #59938578190:  Hold'em No Limit ($0.25/$0.50) - 2009/07/01 0:18:22 ET
Table 'fx6MqwfYAj/Rt86hBz2L3Q' 9-max Seat #4 is the button
Seat 1: uW08L3aflsgdboc6oTbC3Q ($35.05 in chips)
Seat 2: C3rGXblctNcWI6JYPHhaEg ($15 in chips)
Seat 3: iadBi5AEt7gTBXbDSSnMYQ ($49 in chips)
Seat 4: gPEN9Zp33YTm/mu9/SYP1w ($29.40 in chips)
Seat 6: VelaednozEGCpceHSFUsAg ($19.30 in chips)
Seat 7: bkXkL3pmapikPQQRNPZSEA ($9.50 in chips)
Seat 8: 6ol/q1A4zYU6qXbZnTzPfQ ($14.30 in chips)
Seat 9: NumwTCp9zWfI3q1AFfSt7Q ($10.95 in chips)
mad_b74 will be allowed to play after the button
VelaednozEGCpceHSFUsAg: posts small blind $0.25
bkXkL3pmapikPQQRNPZSEA: posts big blind $0.50
C3rGXblctNcWI6JYPHhaEg: posts big blind $0.50
*** HOLE CARDS ***
6ol/q1A4zYU6qXbZnTzPfQ: folds
NumwTCp9zWfI3q1AFfSt7Q: calls $0.50
uW08L3aflsgdboc6oTbC3Q: folds
C3rGXblctNcWI6JYPHhaEg: checks
iadBi5AEt7gTBXbDSSnMYQ: folds
gPEN9Zp33YTm/mu9/SYP1w: calls $0.50
VelaednozEGCpceHSFUsAg: folds
bkXkL3pmapikPQQRNPZSEA: checks
*** FLOP *** [6c Qd 4c]
bkXkL3pmapikPQQRNPZSEA: checks
NumwTCp9zWfI3q1AFfSt7Q: checks
C3rGXblctNcWI6JYPHhaEg: checks
gPEN9Zp33YTm/mu9/SYP1w: bets $1
bkXkL3pmapikPQQRNPZSEA: folds
NumwTCp9zWfI3q1AFfSt7Q: calls $1
C3rGXblctNcWI6JYPHhaEg: folds
*** TURN *** [6c Qd 4c] [Ts]
NumwTCp9zWfI3q1AFfSt7Q: checks
gPEN9Zp33YTm/mu9/SYP1w: bets $9
NumwTCp9zWfI3q1AFfSt7Q: folds
gPEN9Zp33YTm/mu9/SYP1w collected $4.05 from pot
*** SUMMARY ***
Total pot $4.25 | Rake $0.20
Board [6c Qd 4c Ts]
Seat 1: uW08L3aflsgdboc6oTbC3Q folded before Flop (didn't bet)
Seat 2: C3rGXblctNcWI6JYPHhaEg folded on the Flop
Seat 3: iadBi5AEt7gTBXbDSSnMYQ folded before Flop (didn't bet)
Seat 4: gPEN9Zp33YTm/mu9/SYP1w (button) collected ($4.05)
Seat 6: VelaednozEGCpceHSFUsAg (small blind) folded before Flop
Seat 7: bkXkL3pmapikPQQRNPZSEA (big blind) folded on the Flop
Seat 8: 6ol/q1A4zYU6qXbZnTzPfQ folded before Flop (didn't bet)
Seat 9: NumwTCp9zWfI3q1AFfSt7Q folded on the Turn



PokerStars Game #59938579278:  Hold'em No Limit ($0.25/$0.50) - 2009/07/01 0:18:23 ET
Table 'IeNZOZQ4T6oiaHqFeo6yIA' 2-max Seat #2 is the button
Seat 1: ndd1nfncBkWNitBnsfCoVQ ($63.45 in chips)
Seat 2: A91IUl5JaZROhtfCtnnwYw ($24.15 in chips)
A91IUl5JaZROhtfCtnnwYw: posts small blind $0.25
ndd1nfncBkWNitBnsfCoVQ: posts big blind $0.50
*** HOLE CARDS ***
A91IUl5JaZROhtfCtnnwYw: calls $0.25
ndd1nfncBkWNitBnsfCoVQ: checks
*** FLOP *** [5h 4s Ks]
ndd1nfncBkWNitBnsfCoVQ: checks
A91IUl5JaZROhtfCtnnwYw: bets $0.50
ndd1nfncBkWNitBnsfCoVQ: calls $0.50
*** TURN *** [5h 4s Ks] [Ad]
ndd1nfncBkWNitBnsfCoVQ: checks
A91IUl5JaZROhtfCtnnwYw: checks
*** RIVER *** [5h 4s Ks Ad] [6c]
ndd1nfncBkWNitBnsfCoVQ: checks
A91IUl5JaZROhtfCtnnwYw: checks
*** SHOW DOWN ***
ndd1nfncBkWNitBnsfCoVQ: shows [4c 3h] (a pair of Fours)
A91IUl5JaZROhtfCtnnwYw: shows [Qc Qs] (a pair of Queens)
A91IUl5JaZROhtfCtnnwYw collected $1.95 from pot
*** SUMMARY ***
Total pot $2 | Rake $0.05
Board [5h 4s Ks Ad 6c]
Seat 1: ndd1nfncBkWNitBnsfCoVQ (big blind) showed [4c 3h] and lost with a pair of Fours
Seat 2: A91IUl5JaZROhtfCtnnwYw (button) (small blind) showed [Qc Qs] and won ($1.95) with a pair of Queens



PokerStars Game #59938579974:  Hold'em No Limit ($0.25/$0.50) - 2009/07/01 0:18:24 ET
Table 'm95HVfesC/VPgfGEjPuaIA' 2-max Seat #2 is the button
Seat 1: Fp/oksNpipCrD2MJ2pH20g ($14.90 in chips)
Seat 2: Ag6DvxX4vbRheqsv2zXKTQ ($29.40 in chips)
Ag6DvxX4vbRheqsv2zXKTQ: posts small blind $0.25
Fp/oksNpipCrD2MJ2pH20g: posts big blind $0.50
*** HOLE CARDS ***
Ag6DvxX4vbRheqsv2zXKTQ: raises $0.50 to $1
Fp/oksNpipCrD2MJ2pH20g: calls $0.50
*** FLOP *** [5c 4h Js]
Fp/oksNpipCrD2MJ2pH20g: checks
Ag6DvxX4vbRheqsv2zXKTQ: bets $1.50
Fp/oksNpipCrD2MJ2pH20g: folds
Ag6DvxX4vbRheqsv2zXKTQ collected $1.90 from pot
*** SUMMARY ***
Total pot $2 | Rake $0.10
Board [5c 4h Js]
Seat 1: Fp/oksNpipCrD2MJ2pH20g (big blind) folded on the Flop
Seat 2: Ag6DvxX4vbRheqsv2zXKTQ (button) (small blind) collected ($1.90)



PokerStars Game #59938581516:  Hold'em No Limit ($0.25/$0.50) - 2009/07/01 0:18:26 ET
Table 'raOT4/ipuZgzjfKHC+jD9g' 2-max Seat #2 is the button
Seat 1: IuwLemwLhc9fvrwBGs0AMA ($12.60 in chips)
Seat 2: Udr5juWSWUgTu1NlRhjMdA ($9.90 in chips)
Udr5juWSWUgTu1NlRhjMdA: posts small blind $0.25
IuwLemwLhc9fvrwBGs0AMA: posts big blind $0.50
*** HOLE CARDS ***
Udr5juWSWUgTu1NlRhjMdA: folds
IuwLemwLhc9fvrwBGs0AMA collected $0.50 from pot
IuwLemwLhc9fvrwBGs0AMA: doesn't show hand
*** SUMMARY ***
Total pot $0.50 | Rake $0
Seat 1: IuwLemwLhc9fvrwBGs0AMA (big blind) collected ($0.50)
Seat 2: Udr5juWSWUgTu1NlRhjMdA (button) (small blind) folded before Flop



PokerStars Game #59938582098:  Hold'em No Limit ($0.25/$0.50) - 2009/07/01 0:18:27 ET
Table '+z1aekfHkpp09pc8F9aViw' 6-max Seat #2 is the button
Seat 2: VuB2GN0h94yY+QbuI2Mybg ($20.90 in chips)
Seat 3: uUznlIMFnRUvwrBhYF73KA ($58.25 in chips)
Seat 5: crjGpJEzSZgD38FoE3VMGg ($64.40 in chips)
Seat 6: 686aeHikcJlgKkSuIFdcXQ ($70.10 in chips)
uUznlIMFnRUvwrBhYF73KA: posts small blind $0.25
crjGpJEzSZgD38FoE3VMGg: posts big blind $0.50
wOyVV9M/oyiw3YaOjNZ05w: sits out
*** HOLE CARDS ***
686aeHikcJlgKkSuIFdcXQ: folds
VuB2GN0h94yY+QbuI2Mybg: calls $0.50
uUznlIMFnRUvwrBhYF73KA: calls $0.25
Waltluv66 joins the table at seat #4
crjGpJEzSZgD38FoE3VMGg: checks
*** FLOP *** [Jh 7h Tc]
uUznlIMFnRUvwrBhYF73KA: bets $1.50
crjGpJEzSZgD38FoE3VMGg: calls $1.50
VuB2GN0h94yY+QbuI2Mybg: folds
*** TURN *** [Jh 7h Tc] [6d]
VuB2GN0h94yY+QbuI2Mybg leaves the table
uUznlIMFnRUvwrBhYF73KA: checks
crjGpJEzSZgD38FoE3VMGg: bets $3
uUznlIMFnRUvwrBhYF73KA: raises $3.50 to $6.50
crjGpJEzSZgD38FoE3VMGg: folds
stickyart joins the table at seat #2
uUznlIMFnRUvwrBhYF73KA collected $10 from pot
*** SUMMARY ***
Total pot $10.50 | Rake $0.50
Board [Jh 7h Tc 6d]
Seat 2: VuB2GN0h94yY+QbuI2Mybg (button) folded on the Flop
Seat 3: uUznlIMFnRUvwrBhYF73KA (small blind) collected ($10)
Seat 5: crjGpJEzSZgD38FoE3VMGg (big blind) folded on the Turn
Seat 6: 686aeHikcJlgKkSuIFdcXQ folded before Flop (didn't bet)



