PokerStars Game #59940954198:  Hold'em No Limit ($0.25/$0.50) - 2009/07/01 1:21:29 ET
Table 'ofnd8S4IdIPph1Cbn+x7hA' 2-max Seat #2 is the button
Seat 1: PY4NvRocCFPfSIHKbh0euQ ($25.95 in chips)
Seat 2: l5WbyJ/iWYjpeCC6GCYY6w ($67.75 in chips)
l5WbyJ/iWYjpeCC6GCYY6w: posts small blind $0.25
PY4NvRocCFPfSIHKbh0euQ: posts big blind $0.50
*** HOLE CARDS ***
l5WbyJ/iWYjpeCC6GCYY6w: calls $0.25
PY4NvRocCFPfSIHKbh0euQ: checks
*** FLOP *** [9d Th Qs]
PY4NvRocCFPfSIHKbh0euQ: bets $0.50
l5WbyJ/iWYjpeCC6GCYY6w: folds
PY4NvRocCFPfSIHKbh0euQ collected $0.95 from pot
*** SUMMARY ***
Total pot $1 | Rake $0.05
Board [9d Th Qs]
Seat 1: PY4NvRocCFPfSIHKbh0euQ (big blind) collected ($0.95)
Seat 2: l5WbyJ/iWYjpeCC6GCYY6w (button) (small blind) folded on the Flop



PokerStars Game #59940955670:  Hold'em No Limit ($0.25/$0.50) - 2009/07/01 1:21:31 ET
Table 'Nz0Vr7WMHL2g5Uk7dDZjpw' 9-max Seat #8 is the button
Seat 3: hoglu9inkgs6zN573/bJag ($7.20 in chips)
Seat 4: E2518gp4aFz1+kAgmGqeEg ($13 in chips)
Seat 5: WGW0DgjBUXs1ylURHG8vnQ ($14.50 in chips)
Seat 6: 997ViqAtWn1FPjJqcffwcA ($58.05 in chips)
Seat 7: KPLH0gELgFe2OuAnhJFI5w ($22.70 in chips)
Seat 8: aoL+R/61Kxmw69ypuPrWAQ ($29.30 in chips)
Seat 9: mSD1pginDsyHG5PDfqzphw ($10 in chips)
mSD1pginDsyHG5PDfqzphw: posts small blind $0.25
gsyXT42WLEcOS4DdEk2wlw: is sitting out
hoglu9inkgs6zN573/bJag: posts big blind $0.50
*** HOLE CARDS ***
E2518gp4aFz1+kAgmGqeEg: folds
gsyXT42WLEcOS4DdEk2wlw leaves the table
WGW0DgjBUXs1ylURHG8vnQ: calls $0.50
997ViqAtWn1FPjJqcffwcA: folds
KPLH0gELgFe2OuAnhJFI5w: calls $0.50
aoL+R/61Kxmw69ypuPrWAQ: calls $0.50
mSD1pginDsyHG5PDfqzphw: folds
hoglu9inkgs6zN573/bJag: checks
*** FLOP *** [2c 9s 8s]
hoglu9inkgs6zN573/bJag: checks
SegjDnMxWMujiD57ESNL+g joins the table at seat #2
WGW0DgjBUXs1ylURHG8vnQ: checks
KPLH0gELgFe2OuAnhJFI5w: checks
aoL+R/61Kxmw69ypuPrWAQ: checks
*** TURN *** [2c 9s 8s] [Kc]
hoglu9inkgs6zN573/bJag: checks
WGW0DgjBUXs1ylURHG8vnQ: bets $0.50
KPLH0gELgFe2OuAnhJFI5w: calls $0.50
aoL+R/61Kxmw69ypuPrWAQ: calls $0.50
hoglu9inkgs6zN573/bJag: calls $0.50
*** RIVER *** [2c 9s 8s Kc] [4s]
hoglu9inkgs6zN573/bJag: checks
WGW0DgjBUXs1ylURHG8vnQ: bets $0.50
KPLH0gELgFe2OuAnhJFI5w: calls $0.50
aoL+R/61Kxmw69ypuPrWAQ: folds
hoglu9inkgs6zN573/bJag: folds
*** SHOW DOWN ***
WGW0DgjBUXs1ylURHG8vnQ: shows [Ad 4d] (a pair of Fours)
KPLH0gELgFe2OuAnhJFI5w: shows [Kd 5d] (a pair of Kings)
KPLH0gELgFe2OuAnhJFI5w collected $5 from pot
*** SUMMARY ***
Total pot $5.25 | Rake $0.25
Board [2c 9s 8s Kc 4s]
Seat 3: hoglu9inkgs6zN573/bJag (big blind) folded on the River
Seat 4: E2518gp4aFz1+kAgmGqeEg folded before Flop (didn't bet)
Seat 5: WGW0DgjBUXs1ylURHG8vnQ showed [Ad 4d] and lost with a pair of Fours
Seat 6: 997ViqAtWn1FPjJqcffwcA folded before Flop (didn't bet)
Seat 7: KPLH0gELgFe2OuAnhJFI5w showed [Kd 5d] and won ($5) with a pair of Kings
Seat 8: aoL+R/61Kxmw69ypuPrWAQ (button) folded on the River
Seat 9: mSD1pginDsyHG5PDfqzphw (small blind) folded before Flop



PokerStars Game #59940955926:  Hold'em No Limit ($0.25/$0.50) - 2009/07/01 1:21:32 ET
Table 'PALRfuH85dr5IkDfdv6new' 9-max Seat #2 is the button
Seat 1: v/4aX0ejnaIFK4ftDk2Lyg ($48 in chips)
Seat 2: 1aXjSbrubyQKHeauooF5Wg ($41.40 in chips)
Seat 4: mZNMJI1mY40XTC0U7GZakA ($56.80 in chips)
Seat 5: XcLXSUMHSpshK/7Lh0M4Vg ($10 in chips)
Seat 6: ottZQkg1UDWk85BtBzGJzg ($47.35 in chips)
Seat 7: 3NcyXvr39gnK+KbTq7ezyA ($59.65 in chips)
Seat 8: NkS+CseUKx4XHszWq0PXEQ ($75.95 in chips)
Seat 9: viwBDtJsY6JfsFOdBAyJIQ ($9.95 in chips)
fr8888: is sitting out
mZNMJI1mY40XTC0U7GZakA: posts small blind $0.25
XcLXSUMHSpshK/7Lh0M4Vg: posts big blind $0.50
*** HOLE CARDS ***
ottZQkg1UDWk85BtBzGJzg: folds
3NcyXvr39gnK+KbTq7ezyA: calls $0.50
NkS+CseUKx4XHszWq0PXEQ: folds
fr8888 leaves the table
viwBDtJsY6JfsFOdBAyJIQ: folds
v/4aX0ejnaIFK4ftDk2Lyg: folds
1aXjSbrubyQKHeauooF5Wg: folds
mZNMJI1mY40XTC0U7GZakA: raises $2.50 to $3
XcLXSUMHSpshK/7Lh0M4Vg: folds
gsyXT42WLEcOS4DdEk2wlw joins the table at seat #3
3NcyXvr39gnK+KbTq7ezyA: calls $2.50
*** FLOP *** [Qh 2h 5s]
mZNMJI1mY40XTC0U7GZakA: bets $5
3NcyXvr39gnK+KbTq7ezyA: folds
mZNMJI1mY40XTC0U7GZakA collected $6.20 from pot
mZNMJI1mY40XTC0U7GZakA: doesn't show hand
*** SUMMARY ***
Total pot $6.50 | Rake $0.30
Board [Qh 2h 5s]
Seat 1: v/4aX0ejnaIFK4ftDk2Lyg folded before Flop (didn't bet)
Seat 2: 1aXjSbrubyQKHeauooF5Wg (button) folded before Flop (didn't bet)
Seat 4: mZNMJI1mY40XTC0U7GZakA (small blind) collected ($6.20)
Seat 5: XcLXSUMHSpshK/7Lh0M4Vg (big blind) folded before Flop
Seat 6: ottZQkg1UDWk85BtBzGJzg folded before Flop (didn't bet)
Seat 7: 3NcyXvr39gnK+KbTq7ezyA folded on the Flop
Seat 8: NkS+CseUKx4XHszWq0PXEQ folded before Flop (didn't bet)
Seat 9: viwBDtJsY6JfsFOdBAyJIQ folded before Flop (didn't bet)



PokerStars Game #59940956334:  Hold'em No Limit ($0.25/$0.50) - 2009/07/01 1:21:32 ET
Table '+z1aekfHkpp09pc8F9aViw' 6-max Seat #4 is the button
Seat 1: 7zFtlEn2NxyROFkJdZA/yg ($50 in chips)
Seat 2: OZ6OtYh5Y53MCH/p0QTn5g ($50 in chips)
Seat 3: uUznlIMFnRUvwrBhYF73KA ($156.90 in chips)
Seat 4: RowCSpSURHTOL/dcjg/Iug ($90 in chips)
Seat 6: GUnvMULl2qFOO1yenu1UBw ($50 in chips)
2igtJLmvIZ+HqX4XPgMPZA will be allowed to play after the button
GUnvMULl2qFOO1yenu1UBw: posts small blind $0.25
7zFtlEn2NxyROFkJdZA/yg: posts big blind $0.50
*** HOLE CARDS ***
OZ6OtYh5Y53MCH/p0QTn5g: raises $1.50 to $2
uUznlIMFnRUvwrBhYF73KA: calls $2
RowCSpSURHTOL/dcjg/Iug: folds
GUnvMULl2qFOO1yenu1UBw: folds
7zFtlEn2NxyROFkJdZA/yg: folds
*** FLOP *** [2s 6c 7s]
OZ6OtYh5Y53MCH/p0QTn5g: bets $3.50
uUznlIMFnRUvwrBhYF73KA: raises $3.50 to $7
OZ6OtYh5Y53MCH/p0QTn5g: raises $10 to $17
uUznlIMFnRUvwrBhYF73KA: calls $10
*** TURN *** [2s 6c 7s] [Td]
OZ6OtYh5Y53MCH/p0QTn5g: bets $31 and is all-in
uUznlIMFnRUvwrBhYF73KA: folds
OZ6OtYh5Y53MCH/p0QTn5g collected $36.85 from pot
OZ6OtYh5Y53MCH/p0QTn5g: doesn't show hand
*** SUMMARY ***
Total pot $38.75 | Rake $1.90
Board [2s 6c 7s Td]
Seat 1: 7zFtlEn2NxyROFkJdZA/yg (big blind) folded before Flop
Seat 2: OZ6OtYh5Y53MCH/p0QTn5g collected ($36.85)
Seat 3: uUznlIMFnRUvwrBhYF73KA folded on the Turn
Seat 4: RowCSpSURHTOL/dcjg/Iug (button) folded before Flop (didn't bet)
Seat 6: GUnvMULl2qFOO1yenu1UBw (small blind) folded before Flop



PokerStars Game #59940956628:  Hold'em No Limit ($0.25/$0.50) - 2009/07/01 1:21:33 ET
Table '+dXkOAQyS8j9PQZusUTMpg' 2-max Seat #2 is the button
Seat 1: Teld4PDKla7C8/Wfu2DSkg ($56.55 in chips)
Seat 2: +zI4bP23YIjMkUHqeN2xfw ($22.60 in chips)
+zI4bP23YIjMkUHqeN2xfw: posts small blind $0.25
Teld4PDKla7C8/Wfu2DSkg: posts big blind $0.50
*** HOLE CARDS ***
+zI4bP23YIjMkUHqeN2xfw: folds
Teld4PDKla7C8/Wfu2DSkg collected $0.50 from pot
*** SUMMARY ***
Total pot $0.50 | Rake $0
Seat 1: Teld4PDKla7C8/Wfu2DSkg (big blind) collected ($0.50)
Seat 2: +zI4bP23YIjMkUHqeN2xfw (button) (small blind) folded before Flop



PokerStars Game #59940958582:  Hold'em No Limit ($0.25/$0.50) - 2009/07/01 1:21:36 ET
Table 'ibNfFy0bCzuBaUORla0aGw' 9-max Seat #7 is the button
Seat 1: xZCXQSXlrZkp3pZizzVXCw ($50.55 in chips)
Seat 2: 90Wb75h3W1BRpbqVnuk8gw ($50.75 in chips)
Seat 3: AjV5McH1KMMclY26QdLM5w ($27.10 in chips)
Seat 5: GIJAc9kPrLZHLSX8Q6i99w ($27.30 in chips)
Seat 6: H8cPaCtX7d6meGUVSM5sxw ($55.75 in chips)
Seat 7: HZkVla4kK2SI42CVrPZ/ig ($13 in chips)
Seat 8: Ja2jdidjip2UeJnRzmzAAQ ($49.50 in chips)
Seat 9: pFtzb1sR4b0d1aw6aIRgDg ($56.50 in chips)
Ja2jdidjip2UeJnRzmzAAQ: posts small blind $0.25
pFtzb1sR4b0d1aw6aIRgDg: posts big blind $0.50
nhDtFZ2uuvm5hDKG7ZVEpA: sits out
*** HOLE CARDS ***
xZCXQSXlrZkp3pZizzVXCw: folds
90Wb75h3W1BRpbqVnuk8gw: folds
AjV5McH1KMMclY26QdLM5w: folds
GIJAc9kPrLZHLSX8Q6i99w: calls $0.50
H8cPaCtX7d6meGUVSM5sxw: folds
HZkVla4kK2SI42CVrPZ/ig: folds
Ja2jdidjip2UeJnRzmzAAQ: calls $0.25
pFtzb1sR4b0d1aw6aIRgDg: checks
*** FLOP *** [2s 2c 7d]
Ja2jdidjip2UeJnRzmzAAQ: checks
pFtzb1sR4b0d1aw6aIRgDg: checks
GIJAc9kPrLZHLSX8Q6i99w: checks
*** TURN *** [2s 2c 7d] [2h]
Ja2jdidjip2UeJnRzmzAAQ: checks
pFtzb1sR4b0d1aw6aIRgDg: checks
GIJAc9kPrLZHLSX8Q6i99w: checks
*** RIVER *** [2s 2c 7d 2h] [Ad]
Ja2jdidjip2UeJnRzmzAAQ: bets $0.50
pFtzb1sR4b0d1aw6aIRgDg: calls $0.50
GIJAc9kPrLZHLSX8Q6i99w: folds
*** SHOW DOWN ***
Ja2jdidjip2UeJnRzmzAAQ: shows [3c Ts] (three of a kind, Deuces)
pFtzb1sR4b0d1aw6aIRgDg: shows [4c As] (a full house, Deuces full of Aces)
pFtzb1sR4b0d1aw6aIRgDg collected $2.40 from pot
*** SUMMARY ***
Total pot $2.50 | Rake $0.10
Board [2s 2c 7d 2h Ad]
Seat 1: xZCXQSXlrZkp3pZizzVXCw folded before Flop (didn't bet)
Seat 2: 90Wb75h3W1BRpbqVnuk8gw folded before Flop (didn't bet)
Seat 3: AjV5McH1KMMclY26QdLM5w folded before Flop (didn't bet)
Seat 5: GIJAc9kPrLZHLSX8Q6i99w folded on the River
Seat 6: H8cPaCtX7d6meGUVSM5sxw folded before Flop (didn't bet)
Seat 7: HZkVla4kK2SI42CVrPZ/ig (button) folded before Flop (didn't bet)
Seat 8: Ja2jdidjip2UeJnRzmzAAQ (small blind) showed [3c Ts] and lost with three of a kind, Deuces
Seat 9: pFtzb1sR4b0d1aw6aIRgDg (big blind) showed [4c As] and won ($2.40) with a full house, Deuces full of Aces



PokerStars Game #59940958280:  Hold'em No Limit ($0.25/$0.50) - 2009/07/01 1:21:36 ET
Table 'BCN5su+SsXiy1zRMJi0SJw' 6-max Seat #3 is the button
Seat 1: GxXV09ciXaOxyY2H5aMIIw ($48.35 in chips)
Seat 2: ehFNAevCQri3trWxV6FJdA ($33.95 in chips)
Seat 3: kwgv5lNhiFrfONXCshzxlA ($44.45 in chips)
Seat 6: b2symlOdL7+0c9Pj4N/KlA ($58.75 in chips)
fXMRO3W+v+BAC9U+y/9YLQ will be allowed to play after the button
b2symlOdL7+0c9Pj4N/KlA: posts small blind $0.25
GxXV09ciXaOxyY2H5aMIIw: posts big blind $0.50
*** HOLE CARDS ***
ehFNAevCQri3trWxV6FJdA: folds
kwgv5lNhiFrfONXCshzxlA: calls $0.50
b2symlOdL7+0c9Pj4N/KlA: calls $0.25
kxPhs4ePFqMy52CInAJ2aw joins the table at seat #5
GxXV09ciXaOxyY2H5aMIIw: checks
*** FLOP *** [7d 6c 2d]
b2symlOdL7+0c9Pj4N/KlA: checks
GxXV09ciXaOxyY2H5aMIIw: checks
kwgv5lNhiFrfONXCshzxlA: checks
*** TURN *** [7d 6c 2d] [4c]
b2symlOdL7+0c9Pj4N/KlA: checks
GxXV09ciXaOxyY2H5aMIIw: checks
kwgv5lNhiFrfONXCshzxlA: checks
*** RIVER *** [7d 6c 2d 4c] [Th]
b2symlOdL7+0c9Pj4N/KlA: checks
GxXV09ciXaOxyY2H5aMIIw: checks
kwgv5lNhiFrfONXCshzxlA: checks
*** SHOW DOWN ***
b2symlOdL7+0c9Pj4N/KlA: shows [Qh Kd] (high card King)
GxXV09ciXaOxyY2H5aMIIw: shows [3h 2h] (a pair of Deuces)
kwgv5lNhiFrfONXCshzxlA: mucks hand
GxXV09ciXaOxyY2H5aMIIw collected $1.45 from pot
*** SUMMARY ***
Total pot $1.50 | Rake $0.05
Board [7d 6c 2d 4c Th]
Seat 1: GxXV09ciXaOxyY2H5aMIIw (big blind) showed [3h 2h] and won ($1.45) with a pair of Deuces
Seat 2: ehFNAevCQri3trWxV6FJdA folded before Flop (didn't bet)
Seat 3: kwgv5lNhiFrfONXCshzxlA (button) mucked
Seat 6: b2symlOdL7+0c9Pj4N/KlA (small blind) showed [Qh Kd] and lost with high card King



PokerStars Game #59940958902:  Hold'em No Limit ($0.25/$0.50) - 2009/07/01 1:21:37 ET
Table '8BQGgNetI1NOvWeu3gtMNw' 2-max Seat #2 is the button
Seat 1: bypIyrYcAAifLfhZpGlKLA ($66.10 in chips)
Seat 2: Z4HwehErEwzsv/noQlfUlg ($123.40 in chips)
Z4HwehErEwzsv/noQlfUlg: posts small blind $0.25
bypIyrYcAAifLfhZpGlKLA: posts big blind $0.50
*** HOLE CARDS ***
Z4HwehErEwzsv/noQlfUlg: raises $0.50 to $1
bypIyrYcAAifLfhZpGlKLA: calls $0.50
*** FLOP *** [As Ad Kd]
bypIyrYcAAifLfhZpGlKLA: checks
Z4HwehErEwzsv/noQlfUlg: checks
*** TURN *** [As Ad Kd] [3s]
bypIyrYcAAifLfhZpGlKLA: checks
Z4HwehErEwzsv/noQlfUlg: bets $2.50
bypIyrYcAAifLfhZpGlKLA: folds
Z4HwehErEwzsv/noQlfUlg collected $1.90 from pot
Z4HwehErEwzsv/noQlfUlg: doesn't show hand
*** SUMMARY ***
Total pot $2 | Rake $0.10
Board [As Ad Kd 3s]
Seat 1: bypIyrYcAAifLfhZpGlKLA (big blind) folded on the Turn
Seat 2: Z4HwehErEwzsv/noQlfUlg (button) (small blind) collected ($1.90)



PokerStars Game #59940959332:  Hold'em No Limit ($0.25/$0.50) - 2009/07/01 1:21:38 ET
Table 'tyR5AZNKV8Aadbrnrnlg7g' 6-max Seat #1 is the button
Seat 1: BgOXYI0yYSN1ULC4FqsNkg ($97.05 in chips)
Seat 2: BAjwVL+zKKd0s0fAWstzQQ ($56.50 in chips)
Seat 3: JFLrYNyQmwPhRQAtoSAuyA ($44.85 in chips)
Seat 4: 4QfsCWthT/vSLirorNXqtg ($88.70 in chips)
Seat 5: GUnvMULl2qFOO1yenu1UBw ($50 in chips)
Seat 6: 498aWaGsW4uGfuWl+2FCGw ($44.90 in chips)
BAjwVL+zKKd0s0fAWstzQQ: posts small blind $0.25
JFLrYNyQmwPhRQAtoSAuyA: posts big blind $0.50
*** HOLE CARDS ***
4QfsCWthT/vSLirorNXqtg: folds
GUnvMULl2qFOO1yenu1UBw: folds
498aWaGsW4uGfuWl+2FCGw: folds
BgOXYI0yYSN1ULC4FqsNkg: raises $0.50 to $1
BAjwVL+zKKd0s0fAWstzQQ: calls $0.75
JFLrYNyQmwPhRQAtoSAuyA: calls $0.50
*** FLOP *** [8c 7s 2s]
BAjwVL+zKKd0s0fAWstzQQ: checks
JFLrYNyQmwPhRQAtoSAuyA: checks
BgOXYI0yYSN1ULC4FqsNkg: checks
*** TURN *** [8c 7s 2s] [7c]
BAjwVL+zKKd0s0fAWstzQQ: checks
JFLrYNyQmwPhRQAtoSAuyA: checks
BgOXYI0yYSN1ULC4FqsNkg: checks
*** RIVER *** [8c 7s 2s 7c] [Jh]
BAjwVL+zKKd0s0fAWstzQQ: checks
JFLrYNyQmwPhRQAtoSAuyA: checks
BgOXYI0yYSN1ULC4FqsNkg: checks
*** SHOW DOWN ***
BAjwVL+zKKd0s0fAWstzQQ: shows [Ks 6h] (a pair of Sevens)
JFLrYNyQmwPhRQAtoSAuyA: shows [Kd 3d] (a pair of Sevens)
BgOXYI0yYSN1ULC4FqsNkg: mucks hand
BAjwVL+zKKd0s0fAWstzQQ collected $1.45 from pot
JFLrYNyQmwPhRQAtoSAuyA collected $1.40 from pot
*** SUMMARY ***
Total pot $3 | Rake $0.15
Board [8c 7s 2s 7c Jh]
Seat 1: BgOXYI0yYSN1ULC4FqsNkg (button) mucked
Seat 2: BAjwVL+zKKd0s0fAWstzQQ (small blind) showed [Ks 6h] and won ($1.45) with a pair of Sevens
Seat 3: JFLrYNyQmwPhRQAtoSAuyA (big blind) showed [Kd 3d] and won ($1.40) with a pair of Sevens
Seat 4: 4QfsCWthT/vSLirorNXqtg folded before Flop (didn't bet)
Seat 5: GUnvMULl2qFOO1yenu1UBw folded before Flop (didn't bet)
Seat 6: 498aWaGsW4uGfuWl+2FCGw folded before Flop (didn't bet)



PokerStars Game #59940960000:  Hold'em No Limit ($0.25/$0.50) - 2009/07/01 1:21:39 ET
Table 'ofnd8S4IdIPph1Cbn+x7hA' 2-max Seat #1 is the button
Seat 1: PY4NvRocCFPfSIHKbh0euQ ($26.40 in chips)
Seat 2: l5WbyJ/iWYjpeCC6GCYY6w ($67.25 in chips)
PY4NvRocCFPfSIHKbh0euQ: posts small blind $0.25
l5WbyJ/iWYjpeCC6GCYY6w: posts big blind $0.50
*** HOLE CARDS ***
PY4NvRocCFPfSIHKbh0euQ: raises $1.50 to $2
l5WbyJ/iWYjpeCC6GCYY6w: raises $4.50 to $6.50
PY4NvRocCFPfSIHKbh0euQ: folds
l5WbyJ/iWYjpeCC6GCYY6w collected $4 from pot
l5WbyJ/iWYjpeCC6GCYY6w: doesn't show hand
*** SUMMARY ***
Total pot $4 | Rake $0
Seat 1: PY4NvRocCFPfSIHKbh0euQ (button) (small blind) folded before Flop
Seat 2: l5WbyJ/iWYjpeCC6GCYY6w (big blind) collected ($4)



PokerStars Game #59940960114:  Hold'em No Limit ($0.25/$0.50) - 2009/07/01 1:21:39 ET
Table '+dXkOAQyS8j9PQZusUTMpg' 2-max Seat #1 is the button
Seat 1: Teld4PDKla7C8/Wfu2DSkg ($56.80 in chips)
Seat 2: +zI4bP23YIjMkUHqeN2xfw ($22.35 in chips)
Teld4PDKla7C8/Wfu2DSkg: posts small blind $0.25
+zI4bP23YIjMkUHqeN2xfw: posts big blind $0.50
*** HOLE CARDS ***
Teld4PDKla7C8/Wfu2DSkg: raises $0.50 to $1
+zI4bP23YIjMkUHqeN2xfw: raises $1.50 to $2.50
Teld4PDKla7C8/Wfu2DSkg: folds
+zI4bP23YIjMkUHqeN2xfw collected $2 from pot
*** SUMMARY ***
Total pot $2 | Rake $0
Seat 1: Teld4PDKla7C8/Wfu2DSkg (button) (small blind) folded before Flop
Seat 2: +zI4bP23YIjMkUHqeN2xfw (big blind) collected ($2)



PokerStars Game #59940966318:  Hold'em No Limit ($0.25/$0.50) - 2009/07/01 1:21:50 ET
Table 'ofnd8S4IdIPph1Cbn+x7hA' 2-max Seat #2 is the button
Seat 1: PY4NvRocCFPfSIHKbh0euQ ($24.40 in chips)
Seat 2: l5WbyJ/iWYjpeCC6GCYY6w ($69.25 in chips)
l5WbyJ/iWYjpeCC6GCYY6w: posts small blind $0.25
PY4NvRocCFPfSIHKbh0euQ: posts big blind $0.50
*** HOLE CARDS ***
l5WbyJ/iWYjpeCC6GCYY6w: calls $0.25
PY4NvRocCFPfSIHKbh0euQ: checks
*** FLOP *** [2h 3h 8h]
PY4NvRocCFPfSIHKbh0euQ: bets $1
l5WbyJ/iWYjpeCC6GCYY6w: folds
PY4NvRocCFPfSIHKbh0euQ collected $0.95 from pot
*** SUMMARY ***
Total pot $1 | Rake $0.05
Board [2h 3h 8h]
Seat 1: PY4NvRocCFPfSIHKbh0euQ (big blind) collected ($0.95)
Seat 2: l5WbyJ/iWYjpeCC6GCYY6w (button) (small blind) folded on the Flop



PokerStars Game #59940966222:  Hold'em No Limit ($0.25/$0.50) - 2009/07/01 1:21:50 ET
Table '+dXkOAQyS8j9PQZusUTMpg' 2-max Seat #2 is the button
Seat 1: Teld4PDKla7C8/Wfu2DSkg ($55.80 in chips)
Seat 2: +zI4bP23YIjMkUHqeN2xfw ($23.35 in chips)
+zI4bP23YIjMkUHqeN2xfw: posts small blind $0.25
Teld4PDKla7C8/Wfu2DSkg: posts big blind $0.50
*** HOLE CARDS ***
+zI4bP23YIjMkUHqeN2xfw: raises $1 to $1.50
Teld4PDKla7C8/Wfu2DSkg: calls $1
*** FLOP *** [3h 7s As]
Teld4PDKla7C8/Wfu2DSkg: checks
+zI4bP23YIjMkUHqeN2xfw: checks
*** TURN *** [3h 7s As] [2s]
Teld4PDKla7C8/Wfu2DSkg: checks
+zI4bP23YIjMkUHqeN2xfw: bets $2
Teld4PDKla7C8/Wfu2DSkg: folds
+zI4bP23YIjMkUHqeN2xfw collected $2.85 from pot
+zI4bP23YIjMkUHqeN2xfw: doesn't show hand
*** SUMMARY ***
Total pot $3 | Rake $0.15
Board [3h 7s As 2s]
Seat 1: Teld4PDKla7C8/Wfu2DSkg (big blind) folded on the Turn
Seat 2: +zI4bP23YIjMkUHqeN2xfw (button) (small blind) collected ($2.85)



PokerStars Game #59940967044:  Hold'em No Limit ($0.25/$0.50) - 2009/07/01 1:21:51 ET
Table 'c/CRn+68J3Y8KxD5g1ek2Q' 2-max Seat #2 is the button
Seat 1: 46qCyJ6evTkHo9al5sBMNA ($108.95 in chips)
Seat 2: BypVLsYQt3ePFm2xQL/dOA ($251.90 in chips)
BypVLsYQt3ePFm2xQL/dOA: posts small blind $0.25
46qCyJ6evTkHo9al5sBMNA: posts big blind $0.50
*** HOLE CARDS ***
BypVLsYQt3ePFm2xQL/dOA: calls $0.25
46qCyJ6evTkHo9al5sBMNA: checks
*** FLOP *** [3c 7h 3h]
46qCyJ6evTkHo9al5sBMNA: checks
BypVLsYQt3ePFm2xQL/dOA: checks
*** TURN *** [3c 7h 3h] [9c]
46qCyJ6evTkHo9al5sBMNA: bets $1
BypVLsYQt3ePFm2xQL/dOA: calls $1
*** RIVER *** [3c 7h 3h 9c] [3d]
46qCyJ6evTkHo9al5sBMNA: checks
BypVLsYQt3ePFm2xQL/dOA: checks
*** SHOW DOWN ***
46qCyJ6evTkHo9al5sBMNA: shows [Qh 2h] (three of a kind, Threes)
BypVLsYQt3ePFm2xQL/dOA: shows [Js Ac] (three of a kind, Threes - Ace kicker)
BypVLsYQt3ePFm2xQL/dOA collected $2.90 from pot
*** SUMMARY ***
Total pot $3 | Rake $0.10
Board [3c 7h 3h 9c 3d]
Seat 1: 46qCyJ6evTkHo9al5sBMNA (big blind) showed [Qh 2h] and lost with three of a kind, Threes
Seat 2: BypVLsYQt3ePFm2xQL/dOA (button) (small blind) showed [Js Ac] and won ($2.90) with three of a kind, Threes



PokerStars Game #59940969464:  Hold'em No Limit ($0.25/$0.50) - 2009/07/01 1:21:55 ET
Table 'fx6MqwfYAj/Rt86hBz2L3Q' 9-max Seat #1 is the button
Seat 1: v/4aX0ejnaIFK4ftDk2Lyg ($48.75 in chips)
Seat 2: C3rGXblctNcWI6JYPHhaEg ($41.10 in chips)
Seat 3: iadBi5AEt7gTBXbDSSnMYQ ($50.65 in chips)
Seat 5: iAISe3dVeua8PUn2wwgDHw ($65.15 in chips)
Seat 6: 5k9fvXD9suIgCxU4HLQjTw ($50 in chips)
Seat 7: SKnJuWHScqetA/qG5p+wCg ($30 in chips)
Seat 8: JYwJYYV9pM5KWdSiETl8rA ($63.25 in chips)
Seat 9: vO3QVRovWemcGMkm7ijAIA ($12.25 in chips)
C3rGXblctNcWI6JYPHhaEg: posts small blind $0.25
iadBi5AEt7gTBXbDSSnMYQ: posts big blind $0.50
*** HOLE CARDS ***
iAISe3dVeua8PUn2wwgDHw: folds
5k9fvXD9suIgCxU4HLQjTw: folds
SKnJuWHScqetA/qG5p+wCg: folds
JYwJYYV9pM5KWdSiETl8rA: folds
vO3QVRovWemcGMkm7ijAIA: folds
v/4aX0ejnaIFK4ftDk2Lyg: raises $1.50 to $2
C3rGXblctNcWI6JYPHhaEg: folds
iadBi5AEt7gTBXbDSSnMYQ: calls $1.50
*** FLOP *** [Qc 7s Jc]
iadBi5AEt7gTBXbDSSnMYQ: bets $1.50
v/4aX0ejnaIFK4ftDk2Lyg: raises $3.75 to $5.25
iadBi5AEt7gTBXbDSSnMYQ: folds
v/4aX0ejnaIFK4ftDk2Lyg collected $6.90 from pot
v/4aX0ejnaIFK4ftDk2Lyg: doesn't show hand
*** SUMMARY ***
Total pot $7.25 | Rake $0.35
Board [Qc 7s Jc]
Seat 1: v/4aX0ejnaIFK4ftDk2Lyg (button) collected ($6.90)
Seat 2: C3rGXblctNcWI6JYPHhaEg (small blind) folded before Flop
Seat 3: iadBi5AEt7gTBXbDSSnMYQ (big blind) folded on the Flop
Seat 5: iAISe3dVeua8PUn2wwgDHw folded before Flop (didn't bet)
Seat 6: 5k9fvXD9suIgCxU4HLQjTw folded before Flop (didn't bet)
Seat 7: SKnJuWHScqetA/qG5p+wCg folded before Flop (didn't bet)
Seat 8: JYwJYYV9pM5KWdSiETl8rA folded before Flop (didn't bet)
Seat 9: vO3QVRovWemcGMkm7ijAIA folded before Flop (didn't bet)



PokerStars Game #59940973114:  Hold'em No Limit ($0.25/$0.50) - 2009/07/01 1:21:58 ET
Table 'hSTs/dUsYLgJQuF2Onp0MQ' 6-max Seat #6 is the button
Seat 1: 1WUCqNG+p+vfWRTXNu4ljw ($50 in chips)
Seat 3: lxIzoHy0RnkfFSODHC2liw ($50 in chips)
Seat 4: 2igtJLmvIZ+HqX4XPgMPZA ($80.90 in chips)
Seat 5: IBNygaT1aa9Z1uPdJJilwA ($38.50 in chips)
Seat 6: M1KyQQvVPVuxqTAB8sR/zQ ($87.45 in chips)
1WUCqNG+p+vfWRTXNu4ljw: posts small blind $0.25
lxIzoHy0RnkfFSODHC2liw: posts big blind $0.50
*** HOLE CARDS ***
2igtJLmvIZ+HqX4XPgMPZA: folds
IBNygaT1aa9Z1uPdJJilwA: folds
M1KyQQvVPVuxqTAB8sR/zQ: folds
1WUCqNG+p+vfWRTXNu4ljw: folds
lxIzoHy0RnkfFSODHC2liw collected $0.50 from pot
*** SUMMARY ***
Total pot $0.50 | Rake $0
Seat 1: 1WUCqNG+p+vfWRTXNu4ljw (small blind) folded before Flop
Seat 3: lxIzoHy0RnkfFSODHC2liw (big blind) collected ($0.50)
Seat 4: 2igtJLmvIZ+HqX4XPgMPZA folded before Flop (didn't bet)
Seat 5: IBNygaT1aa9Z1uPdJJilwA folded before Flop (didn't bet)
Seat 6: M1KyQQvVPVuxqTAB8sR/zQ (button) folded before Flop (didn't bet)



PokerStars Game #59940974178:  Hold'em No Limit ($0.25/$0.50) - 2009/07/01 1:22:00 ET
Table 'kgbJRsxfv64KrErDRBAkcw' 6-max Seat #6 is the button
Seat 1: VamsyhlFzXGF6/ydo0BHeA ($36.05 in chips)
Seat 2: AdS8BJMOheS01zjCDfPMFg ($50 in chips)
Seat 3: c4MNIaIyPMOMxrgT8FT5nA ($225.20 in chips)
Seat 4: 2igtJLmvIZ+HqX4XPgMPZA ($50 in chips)
Seat 5: eUBBn2R56C1IQ6Cs/vitwg ($50 in chips)
Seat 6: 1b+2BbjMN8qhR1WPqdE9VQ ($59.65 in chips)
VamsyhlFzXGF6/ydo0BHeA: posts small blind $0.25
AdS8BJMOheS01zjCDfPMFg: posts big blind $0.50
*** HOLE CARDS ***
c4MNIaIyPMOMxrgT8FT5nA: raises $1 to $1.50
2igtJLmvIZ+HqX4XPgMPZA: calls $1.50
eUBBn2R56C1IQ6Cs/vitwg: folds
1b+2BbjMN8qhR1WPqdE9VQ: folds
VamsyhlFzXGF6/ydo0BHeA: calls $1.25
AdS8BJMOheS01zjCDfPMFg: raises $5.50 to $7
c4MNIaIyPMOMxrgT8FT5nA: folds
2igtJLmvIZ+HqX4XPgMPZA: folds
VamsyhlFzXGF6/ydo0BHeA: calls $5.50
*** FLOP *** [6c Kd 5d]
VamsyhlFzXGF6/ydo0BHeA: checks
VamsyhlFzXGF6/ydo0BHeA said, "kk"
AdS8BJMOheS01zjCDfPMFg: bets $7
VamsyhlFzXGF6/ydo0BHeA: calls $7
*** TURN *** [6c Kd 5d] [3c]
VamsyhlFzXGF6/ydo0BHeA: checks
AdS8BJMOheS01zjCDfPMFg: bets $23
VamsyhlFzXGF6/ydo0BHeA: folds
AdS8BJMOheS01zjCDfPMFg collected $29.50 from pot
*** SUMMARY ***
Total pot $31 | Rake $1.50
Board [6c Kd 5d 3c]
Seat 1: VamsyhlFzXGF6/ydo0BHeA (small blind) folded on the Turn
Seat 2: AdS8BJMOheS01zjCDfPMFg (big blind) collected ($29.50)
Seat 3: c4MNIaIyPMOMxrgT8FT5nA folded before Flop
Seat 4: 2igtJLmvIZ+HqX4XPgMPZA folded before Flop
Seat 5: eUBBn2R56C1IQ6Cs/vitwg folded before Flop (didn't bet)
Seat 6: 1b+2BbjMN8qhR1WPqdE9VQ (button) folded before Flop (didn't bet)



PokerStars Game #59940974886:  Hold'em No Limit ($0.25/$0.50) - 2009/07/01 1:22:01 ET
Table '8BQGgNetI1NOvWeu3gtMNw' 2-max Seat #1 is the button
Seat 1: bypIyrYcAAifLfhZpGlKLA ($65.10 in chips)
Seat 2: Z4HwehErEwzsv/noQlfUlg ($124.30 in chips)
bypIyrYcAAifLfhZpGlKLA: posts small blind $0.25
Z4HwehErEwzsv/noQlfUlg: posts big blind $0.50
*** HOLE CARDS ***
bypIyrYcAAifLfhZpGlKLA: folds
Z4HwehErEwzsv/noQlfUlg collected $0.50 from pot
Z4HwehErEwzsv/noQlfUlg: doesn't show hand
*** SUMMARY ***
Total pot $0.50 | Rake $0
Seat 1: bypIyrYcAAifLfhZpGlKLA (button) (small blind) folded before Flop
Seat 2: Z4HwehErEwzsv/noQlfUlg (big blind) collected ($0.50)



PokerStars Game #59940974536:  Hold'em No Limit ($0.25/$0.50) - 2009/07/01 1:22:01 ET
Table 'EiNh8p/wGJ1FP575iMFnqg' 9-max Seat #7 is the button
Seat 2: 8ehL7qlZzjgUh2H35iiWLw ($58.90 in chips)
Seat 3: ymLPoEIl7UL3TvZYmnadxQ ($60.10 in chips)
Seat 4: cMzaiXAM/ZAdNaEUu+LqhA ($50 in chips)
Seat 5: M+7+BTmX5vZatHVuoRB1nA ($80.45 in chips)
Seat 6: viwBDtJsY6JfsFOdBAyJIQ ($9.45 in chips)
Seat 7: 997ViqAtWn1FPjJqcffwcA ($50 in chips)
Seat 8: mSD1pginDsyHG5PDfqzphw ($10 in chips)
Seat 9: GuPkZObrz5Zkkn8FsEdF9w ($27.70 in chips)
mSD1pginDsyHG5PDfqzphw: posts small blind $0.25
GuPkZObrz5Zkkn8FsEdF9w: posts big blind $0.50
YFFlOZgyy1Mh4iBmuNRbmQ: sits out
*** HOLE CARDS ***
8ehL7qlZzjgUh2H35iiWLw: folds
ymLPoEIl7UL3TvZYmnadxQ: folds
cMzaiXAM/ZAdNaEUu+LqhA: folds
M+7+BTmX5vZatHVuoRB1nA: raises $1 to $1.50
viwBDtJsY6JfsFOdBAyJIQ: folds
997ViqAtWn1FPjJqcffwcA: calls $1.50
mSD1pginDsyHG5PDfqzphw: folds
GuPkZObrz5Zkkn8FsEdF9w: calls $1
*** FLOP *** [Jh Kc Ah]
GuPkZObrz5Zkkn8FsEdF9w: checks
M+7+BTmX5vZatHVuoRB1nA: bets $2.50
997ViqAtWn1FPjJqcffwcA: folds
GuPkZObrz5Zkkn8FsEdF9w: calls $2.50
*** TURN *** [Jh Kc Ah] [4c]
GuPkZObrz5Zkkn8FsEdF9w: checks
M+7+BTmX5vZatHVuoRB1nA: checks
*** RIVER *** [Jh Kc Ah 4c] [2c]
GuPkZObrz5Zkkn8FsEdF9w: bets $2
M+7+BTmX5vZatHVuoRB1nA: calls $2
*** SHOW DOWN ***
GuPkZObrz5Zkkn8FsEdF9w: shows [Kh 2h] (two pair, Kings and Deuces)
M+7+BTmX5vZatHVuoRB1nA: mucks hand
GuPkZObrz5Zkkn8FsEdF9w collected $13.10 from pot
*** SUMMARY ***
Total pot $13.75 | Rake $0.65
Board [Jh Kc Ah 4c 2c]
Seat 2: 8ehL7qlZzjgUh2H35iiWLw folded before Flop (didn't bet)
Seat 3: ymLPoEIl7UL3TvZYmnadxQ folded before Flop (didn't bet)
Seat 4: cMzaiXAM/ZAdNaEUu+LqhA folded before Flop (didn't bet)
Seat 5: M+7+BTmX5vZatHVuoRB1nA mucked
Seat 6: viwBDtJsY6JfsFOdBAyJIQ folded before Flop (didn't bet)
Seat 7: 997ViqAtWn1FPjJqcffwcA (button) folded on the Flop
Seat 8: mSD1pginDsyHG5PDfqzphw (small blind) folded before Flop
Seat 9: GuPkZObrz5Zkkn8FsEdF9w (big blind) showed [Kh 2h] and won ($13.10) with two pair, Kings and Deuces



PokerStars Game #59940975314:  Hold'em No Limit ($0.25/$0.50) - 2009/07/01 1:22:02 ET
Table 'ofnd8S4IdIPph1Cbn+x7hA' 2-max Seat #1 is the button
Seat 1: PY4NvRocCFPfSIHKbh0euQ ($24.85 in chips)
Seat 2: l5WbyJ/iWYjpeCC6GCYY6w ($68.75 in chips)
PY4NvRocCFPfSIHKbh0euQ: posts small blind $0.25
l5WbyJ/iWYjpeCC6GCYY6w: posts big blind $0.50
*** HOLE CARDS ***
PY4NvRocCFPfSIHKbh0euQ: raises $1 to $1.50
l5WbyJ/iWYjpeCC6GCYY6w: folds
PY4NvRocCFPfSIHKbh0euQ collected $1 from pot
*** SUMMARY ***
Total pot $1 | Rake $0
Seat 1: PY4NvRocCFPfSIHKbh0euQ (button) (small blind) collected ($1)
Seat 2: l5WbyJ/iWYjpeCC6GCYY6w (big blind) folded before Flop



PokerStars Game #59940976292:  Hold'em No Limit ($0.25/$0.50) - 2009/07/01 1:22:04 ET
Table 'lSisgp6H7Fg1hH5VfjEjYQ' 9-max Seat #5 is the button
Seat 1: 5k9fvXD9suIgCxU4HLQjTw ($55.85 in chips)
Seat 3: SKnJuWHScqetA/qG5p+wCg ($30 in chips)
Seat 4: bwv/rbH/hHhPhY6u9mu04w ($36.15 in chips)
Seat 5: mSD1pginDsyHG5PDfqzphw ($12.25 in chips)
Seat 6: +k7T5ocke8UwavtgUHm+Cg ($63.90 in chips)
Seat 7: IDtNLR9uFCDdjNsJWMHA5Q ($22.45 in chips)
Seat 8: a4JDWmpFQkL10XfAyuF51A ($13 in chips)
Seat 9: YzeKFbJVLmJGTgNH3ySQlw ($12.50 in chips)
+k7T5ocke8UwavtgUHm+Cg: posts small blind $0.25
IDtNLR9uFCDdjNsJWMHA5Q: posts big blind $0.50
*** HOLE CARDS ***
a4JDWmpFQkL10XfAyuF51A: folds
YzeKFbJVLmJGTgNH3ySQlw: calls $0.50
5k9fvXD9suIgCxU4HLQjTw: folds
SKnJuWHScqetA/qG5p+wCg: folds
bwv/rbH/hHhPhY6u9mu04w: folds
mSD1pginDsyHG5PDfqzphw: folds
+k7T5ocke8UwavtgUHm+Cg: calls $0.25
IDtNLR9uFCDdjNsJWMHA5Q: raises $1.50 to $2
YzeKFbJVLmJGTgNH3ySQlw: calls $1.50
+k7T5ocke8UwavtgUHm+Cg: folds
*** FLOP *** [7c 5s 8s]
IDtNLR9uFCDdjNsJWMHA5Q: checks
YzeKFbJVLmJGTgNH3ySQlw: checks
*** TURN *** [7c 5s 8s] [2h]
IDtNLR9uFCDdjNsJWMHA5Q: bets $3.50
YzeKFbJVLmJGTgNH3ySQlw: calls $3.50
*** RIVER *** [7c 5s 8s 2h] [5h]
IDtNLR9uFCDdjNsJWMHA5Q: bets $9.50
YzeKFbJVLmJGTgNH3ySQlw: folds
IDtNLR9uFCDdjNsJWMHA5Q collected $10.95 from pot
IDtNLR9uFCDdjNsJWMHA5Q: doesn't show hand
*** SUMMARY ***
Total pot $11.50 | Rake $0.55
Board [7c 5s 8s 2h 5h]
Seat 1: 5k9fvXD9suIgCxU4HLQjTw folded before Flop (didn't bet)
Seat 3: SKnJuWHScqetA/qG5p+wCg folded before Flop (didn't bet)
Seat 4: bwv/rbH/hHhPhY6u9mu04w folded before Flop (didn't bet)
Seat 5: mSD1pginDsyHG5PDfqzphw (button) folded before Flop (didn't bet)
Seat 6: +k7T5ocke8UwavtgUHm+Cg (small blind) folded before Flop
Seat 7: IDtNLR9uFCDdjNsJWMHA5Q (big blind) collected ($10.95)
Seat 8: a4JDWmpFQkL10XfAyuF51A folded before Flop (didn't bet)
Seat 9: YzeKFbJVLmJGTgNH3ySQlw folded on the River



PokerStars Game #59940976984:  Hold'em No Limit ($0.25/$0.50) - 2009/07/01 1:22:05 ET
Table 'otvGDROEDdqsabxskT79qg' 9-max Seat #3 is the button
Seat 1: 8ehL7qlZzjgUh2H35iiWLw ($62 in chips)
Seat 2: cCjTzH9jio8607WzjcfXlg ($10.65 in chips)
Seat 3: +k7T5ocke8UwavtgUHm+Cg ($73.75 in chips)
Seat 4: MG90wfSJZnOejs/KD3vlQQ ($80.15 in chips)
Seat 5: E2518gp4aFz1+kAgmGqeEg ($12.20 in chips)
Seat 6: bxLSulbgr8LmKNjOzw8URg ($55.25 in chips)
Seat 7: 75K2MXwN65Sjfp1yHd50Hg ($13.75 in chips)
Seat 8: zE9cVigS2nW/Ljy4K4bUQA ($33.30 in chips)
Seat 9: KcY3X8YpD74Kw1RHkx/g4A ($31.65 in chips)
MG90wfSJZnOejs/KD3vlQQ: posts small blind $0.25
E2518gp4aFz1+kAgmGqeEg: posts big blind $0.50
*** HOLE CARDS ***
bxLSulbgr8LmKNjOzw8URg: folds
75K2MXwN65Sjfp1yHd50Hg: folds
zE9cVigS2nW/Ljy4K4bUQA: folds
KcY3X8YpD74Kw1RHkx/g4A: folds
8ehL7qlZzjgUh2H35iiWLw: folds
cCjTzH9jio8607WzjcfXlg: folds
+k7T5ocke8UwavtgUHm+Cg: folds
MG90wfSJZnOejs/KD3vlQQ: raises $1 to $1.50
E2518gp4aFz1+kAgmGqeEg: folds
MG90wfSJZnOejs/KD3vlQQ collected $1 from pot
MG90wfSJZnOejs/KD3vlQQ: doesn't show hand
*** SUMMARY ***
Total pot $1 | Rake $0
Seat 1: 8ehL7qlZzjgUh2H35iiWLw folded before Flop (didn't bet)
Seat 2: cCjTzH9jio8607WzjcfXlg folded before Flop (didn't bet)
Seat 3: +k7T5ocke8UwavtgUHm+Cg (button) folded before Flop (didn't bet)
Seat 4: MG90wfSJZnOejs/KD3vlQQ (small blind) collected ($1)
Seat 5: E2518gp4aFz1+kAgmGqeEg (big blind) folded before Flop
Seat 6: bxLSulbgr8LmKNjOzw8URg folded before Flop (didn't bet)
Seat 7: 75K2MXwN65Sjfp1yHd50Hg folded before Flop (didn't bet)
Seat 8: zE9cVigS2nW/Ljy4K4bUQA folded before Flop (didn't bet)
Seat 9: KcY3X8YpD74Kw1RHkx/g4A folded before Flop (didn't bet)



PokerStars Game #59940978574:  Hold'em No Limit ($0.25/$0.50) - 2009/07/01 1:22:08 ET
Table 'NCiXr0d5CEKBQr/cZgLhbA' 9-max Seat #4 is the button
Seat 1: pFtzb1sR4b0d1aw6aIRgDg ($55.70 in chips)
Seat 2: AjV5McH1KMMclY26QdLM5w ($25 in chips)
Seat 3: xZCXQSXlrZkp3pZizzVXCw ($92.20 in chips)
Seat 4: 5k9fvXD9suIgCxU4HLQjTw ($53.95 in chips)
Seat 5: Ja2jdidjip2UeJnRzmzAAQ ($49.50 in chips)
Seat 6: t1qL+wRXOwTLB4TBbcw2QA ($50 in chips)
Seat 8: 1MJUKc3cc0QmUoz1JZLR2w ($63.95 in chips)
Seat 9: 4WLZvqBn5qv5tds5kt5A1Q ($54.75 in chips)
Ja2jdidjip2UeJnRzmzAAQ: posts small blind $0.25
t1qL+wRXOwTLB4TBbcw2QA: posts big blind $0.50
*** HOLE CARDS ***
M+7+BTmX5vZatHVuoRB1nA leaves the table
1MJUKc3cc0QmUoz1JZLR2w: folds
4WLZvqBn5qv5tds5kt5A1Q: folds
pFtzb1sR4b0d1aw6aIRgDg: folds
AjV5McH1KMMclY26QdLM5w: raises $1 to $1.50
dXhO5i7KOoVcsGqbklD+jw joins the table at seat #7
xZCXQSXlrZkp3pZizzVXCw: raises $4.50 to $6
5k9fvXD9suIgCxU4HLQjTw: folds
Ja2jdidjip2UeJnRzmzAAQ: folds
t1qL+wRXOwTLB4TBbcw2QA: folds
AjV5McH1KMMclY26QdLM5w: folds
xZCXQSXlrZkp3pZizzVXCw collected $3.75 from pot
xZCXQSXlrZkp3pZizzVXCw: doesn't show hand
*** SUMMARY ***
Total pot $3.75 | Rake $0
Seat 1: pFtzb1sR4b0d1aw6aIRgDg folded before Flop (didn't bet)
Seat 2: AjV5McH1KMMclY26QdLM5w folded before Flop
Seat 3: xZCXQSXlrZkp3pZizzVXCw collected ($3.75)
Seat 4: 5k9fvXD9suIgCxU4HLQjTw (button) folded before Flop (didn't bet)
Seat 5: Ja2jdidjip2UeJnRzmzAAQ (small blind) folded before Flop
Seat 6: t1qL+wRXOwTLB4TBbcw2QA (big blind) folded before Flop
Seat 8: 1MJUKc3cc0QmUoz1JZLR2w folded before Flop (didn't bet)
Seat 9: 4WLZvqBn5qv5tds5kt5A1Q folded before Flop (didn't bet)



PokerStars Game #59940978666:  Hold'em No Limit ($0.25/$0.50) - 2009/07/01 1:22:08 ET
Table 'ofnd8S4IdIPph1Cbn+x7hA' 2-max Seat #2 is the button
Seat 1: PY4NvRocCFPfSIHKbh0euQ ($25.35 in chips)
Seat 2: l5WbyJ/iWYjpeCC6GCYY6w ($68.25 in chips)
l5WbyJ/iWYjpeCC6GCYY6w: posts small blind $0.25
PY4NvRocCFPfSIHKbh0euQ: posts big blind $0.50
*** HOLE CARDS ***
l5WbyJ/iWYjpeCC6GCYY6w: folds
PY4NvRocCFPfSIHKbh0euQ collected $0.50 from pot
*** SUMMARY ***
Total pot $0.50 | Rake $0
Seat 1: PY4NvRocCFPfSIHKbh0euQ (big blind) collected ($0.50)
Seat 2: l5WbyJ/iWYjpeCC6GCYY6w (button) (small blind) folded before Flop



PokerStars Game #59940978274:  Hold'em No Limit ($0.25/$0.50) - 2009/07/01 1:22:08 ET
Table '8BQGgNetI1NOvWeu3gtMNw' 2-max Seat #2 is the button
Seat 1: bypIyrYcAAifLfhZpGlKLA ($64.85 in chips)
Seat 2: Z4HwehErEwzsv/noQlfUlg ($124.55 in chips)
Z4HwehErEwzsv/noQlfUlg: posts small blind $0.25
bypIyrYcAAifLfhZpGlKLA: posts big blind $0.50
*** HOLE CARDS ***
Z4HwehErEwzsv/noQlfUlg: calls $0.25
bypIyrYcAAifLfhZpGlKLA: checks
*** FLOP *** [7s Th 2h]
bypIyrYcAAifLfhZpGlKLA: checks
Z4HwehErEwzsv/noQlfUlg: bets $2
bypIyrYcAAifLfhZpGlKLA: folds
Z4HwehErEwzsv/noQlfUlg collected $0.95 from pot
Z4HwehErEwzsv/noQlfUlg: doesn't show hand
*** SUMMARY ***
Total pot $1 | Rake $0.05
Board [7s Th 2h]
Seat 1: bypIyrYcAAifLfhZpGlKLA (big blind) folded on the Flop
Seat 2: Z4HwehErEwzsv/noQlfUlg (button) (small blind) collected ($0.95)



PokerStars Game #59940980254:  Hold'em No Limit ($0.25/$0.50) - 2009/07/01 1:22:11 ET
Table 'c/CRn+68J3Y8KxD5g1ek2Q' 2-max Seat #1 is the button
Seat 1: 46qCyJ6evTkHo9al5sBMNA ($107.45 in chips)
Seat 2: BypVLsYQt3ePFm2xQL/dOA ($253.30 in chips)
46qCyJ6evTkHo9al5sBMNA: posts small blind $0.25
BypVLsYQt3ePFm2xQL/dOA: posts big blind $0.50
*** HOLE CARDS ***
46qCyJ6evTkHo9al5sBMNA: raises $1.50 to $2
BypVLsYQt3ePFm2xQL/dOA: calls $1.50
*** FLOP *** [Jd 9c 8d]
BypVLsYQt3ePFm2xQL/dOA: checks
46qCyJ6evTkHo9al5sBMNA: bets $3
BypVLsYQt3ePFm2xQL/dOA: raises $7.50 to $10.50
46qCyJ6evTkHo9al5sBMNA: folds
BypVLsYQt3ePFm2xQL/dOA collected $9.55 from pot
BypVLsYQt3ePFm2xQL/dOA: doesn't show hand
*** SUMMARY ***
Total pot $10 | Rake $0.45
Board [Jd 9c 8d]
Seat 1: 46qCyJ6evTkHo9al5sBMNA (button) (small blind) folded on the Flop
Seat 2: BypVLsYQt3ePFm2xQL/dOA (big blind) collected ($9.55)



PokerStars Game #59940980384:  Hold'em No Limit ($0.25/$0.50) - 2009/07/01 1:22:11 ET
Table '+dXkOAQyS8j9PQZusUTMpg' 2-max Seat #1 is the button
Seat 1: Teld4PDKla7C8/Wfu2DSkg ($54.30 in chips)
Seat 2: +zI4bP23YIjMkUHqeN2xfw ($24.70 in chips)
Teld4PDKla7C8/Wfu2DSkg: posts small blind $0.25
+zI4bP23YIjMkUHqeN2xfw: posts big blind $0.50
*** HOLE CARDS ***
Teld4PDKla7C8/Wfu2DSkg: folds
+zI4bP23YIjMkUHqeN2xfw collected $0.50 from pot
*** SUMMARY ***
Total pot $0.50 | Rake $0
Seat 1: Teld4PDKla7C8/Wfu2DSkg (button) (small blind) folded before Flop
Seat 2: +zI4bP23YIjMkUHqeN2xfw (big blind) collected ($0.50)



PokerStars Game #59940981466:  Hold'em No Limit ($0.25/$0.50) - 2009/07/01 1:22:13 ET
Table 'GfL/No5u5PoEnU39lP5pQg' 6-max Seat #2 is the button
Seat 1: 1WUCqNG+p+vfWRTXNu4ljw ($66 in chips)
Seat 2: uVwggSetzp7d+eVgowO3vg ($51.60 in chips)
Seat 3: 4pp9WxhGdbVbxCc9tlu0lw ($36.70 in chips)
Seat 4: r6u7MWSXF30/khcTYkrG9Q ($23.10 in chips)
Seat 5: M1KyQQvVPVuxqTAB8sR/zQ ($50 in chips)
Seat 6: kxPhs4ePFqMy52CInAJ2aw ($62.45 in chips)
4pp9WxhGdbVbxCc9tlu0lw: posts small blind $0.25
r6u7MWSXF30/khcTYkrG9Q: posts big blind $0.50
*** HOLE CARDS ***
M1KyQQvVPVuxqTAB8sR/zQ: folds
kxPhs4ePFqMy52CInAJ2aw: folds
1WUCqNG+p+vfWRTXNu4ljw: folds
uVwggSetzp7d+eVgowO3vg: raises $1 to $1.50
4pp9WxhGdbVbxCc9tlu0lw: folds
r6u7MWSXF30/khcTYkrG9Q: calls $1
*** FLOP *** [5s 4s Ts]
r6u7MWSXF30/khcTYkrG9Q: checks
uVwggSetzp7d+eVgowO3vg: checks
*** TURN *** [5s 4s Ts] [7d]
r6u7MWSXF30/khcTYkrG9Q: bets $2
uVwggSetzp7d+eVgowO3vg: calls $2
*** RIVER *** [5s 4s Ts 7d] [Ah]
r6u7MWSXF30/khcTYkrG9Q: bets $19.60 and is all-in
uVwggSetzp7d+eVgowO3vg: folds
r6u7MWSXF30/khcTYkrG9Q collected $6.90 from pot
*** SUMMARY ***
Total pot $7.25 | Rake $0.35
Board [5s 4s Ts 7d Ah]
Seat 1: 1WUCqNG+p+vfWRTXNu4ljw folded before Flop (didn't bet)
Seat 2: uVwggSetzp7d+eVgowO3vg (button) folded on the River
Seat 3: 4pp9WxhGdbVbxCc9tlu0lw (small blind) folded before Flop
Seat 4: r6u7MWSXF30/khcTYkrG9Q (big blind) collected ($6.90)
Seat 5: M1KyQQvVPVuxqTAB8sR/zQ folded before Flop (didn't bet)
Seat 6: kxPhs4ePFqMy52CInAJ2aw folded before Flop (didn't bet)



PokerStars Game #59940981370:  Hold'em No Limit ($0.25/$0.50) - 2009/07/01 1:22:13 ET
Table 'PALRfuH85dr5IkDfdv6new' 9-max Seat #4 is the button
Seat 1: v/4aX0ejnaIFK4ftDk2Lyg ($48 in chips)
Seat 2: 1aXjSbrubyQKHeauooF5Wg ($41.40 in chips)
Seat 3: gsyXT42WLEcOS4DdEk2wlw ($30 in chips)
Seat 4: mZNMJI1mY40XTC0U7GZakA ($60 in chips)
Seat 5: XcLXSUMHSpshK/7Lh0M4Vg ($9.50 in chips)
Seat 6: ottZQkg1UDWk85BtBzGJzg ($47.35 in chips)
Seat 7: 3NcyXvr39gnK+KbTq7ezyA ($56.65 in chips)
Seat 8: NkS+CseUKx4XHszWq0PXEQ ($75.95 in chips)
Seat 9: viwBDtJsY6JfsFOdBAyJIQ ($9.95 in chips)
XcLXSUMHSpshK/7Lh0M4Vg: posts small blind $0.25
ottZQkg1UDWk85BtBzGJzg: posts big blind $0.50
gsyXT42WLEcOS4DdEk2wlw: posts big blind $0.50
*** HOLE CARDS ***
3NcyXvr39gnK+KbTq7ezyA: folds
NkS+CseUKx4XHszWq0PXEQ: folds
viwBDtJsY6JfsFOdBAyJIQ: folds
v/4aX0ejnaIFK4ftDk2Lyg: folds
1aXjSbrubyQKHeauooF5Wg: folds
gsyXT42WLEcOS4DdEk2wlw: raises $2 to $2.50
mZNMJI1mY40XTC0U7GZakA: calls $2.50
XcLXSUMHSpshK/7Lh0M4Vg: folds
ottZQkg1UDWk85BtBzGJzg: folds
*** FLOP *** [7d Kh Qh]
gsyXT42WLEcOS4DdEk2wlw: bets $4
mZNMJI1mY40XTC0U7GZakA: folds
gsyXT42WLEcOS4DdEk2wlw collected $5.50 from pot
*** SUMMARY ***
Total pot $5.75 | Rake $0.25
Board [7d Kh Qh]
Seat 1: v/4aX0ejnaIFK4ftDk2Lyg folded before Flop (didn't bet)
Seat 2: 1aXjSbrubyQKHeauooF5Wg folded before Flop (didn't bet)
Seat 3: gsyXT42WLEcOS4DdEk2wlw collected ($5.50)
Seat 4: mZNMJI1mY40XTC0U7GZakA (button) folded on the Flop
Seat 5: XcLXSUMHSpshK/7Lh0M4Vg (small blind) folded before Flop
Seat 6: ottZQkg1UDWk85BtBzGJzg (big blind) folded before Flop
Seat 7: 3NcyXvr39gnK+KbTq7ezyA folded before Flop (didn't bet)
Seat 8: NkS+CseUKx4XHszWq0PXEQ folded before Flop (didn't bet)
Seat 9: viwBDtJsY6JfsFOdBAyJIQ folded before Flop (didn't bet)



PokerStars Game #59940981726:  Hold'em No Limit ($0.25/$0.50) - 2009/07/01 1:22:14 ET
Table 'ofnd8S4IdIPph1Cbn+x7hA' 2-max Seat #1 is the button
Seat 1: PY4NvRocCFPfSIHKbh0euQ ($25.60 in chips)
Seat 2: l5WbyJ/iWYjpeCC6GCYY6w ($68 in chips)
PY4NvRocCFPfSIHKbh0euQ: posts small blind $0.25
l5WbyJ/iWYjpeCC6GCYY6w: posts big blind $0.50
*** HOLE CARDS ***
PY4NvRocCFPfSIHKbh0euQ: raises $1 to $1.50
l5WbyJ/iWYjpeCC6GCYY6w: folds
PY4NvRocCFPfSIHKbh0euQ collected $1 from pot
*** SUMMARY ***
Total pot $1 | Rake $0
Seat 1: PY4NvRocCFPfSIHKbh0euQ (button) (small blind) collected ($1)
Seat 2: l5WbyJ/iWYjpeCC6GCYY6w (big blind) folded before Flop



PokerStars Game #59940983558:  Hold'em No Limit ($0.25/$0.50) - 2009/07/01 1:22:17 ET
Table 'hSTs/dUsYLgJQuF2Onp0MQ' 6-max Seat #1 is the button
Seat 1: 1WUCqNG+p+vfWRTXNu4ljw ($50 in chips)
Seat 3: lxIzoHy0RnkfFSODHC2liw ($50.25 in chips)
Seat 4: 2igtJLmvIZ+HqX4XPgMPZA ($80.90 in chips)
Seat 5: IBNygaT1aa9Z1uPdJJilwA ($38.50 in chips)
Seat 6: M1KyQQvVPVuxqTAB8sR/zQ ($87.45 in chips)
Fra omega was removed from the table for failing to post
lxIzoHy0RnkfFSODHC2liw: posts small blind $0.25
2igtJLmvIZ+HqX4XPgMPZA: posts big blind $0.50
*** HOLE CARDS ***
IBNygaT1aa9Z1uPdJJilwA: raises $1.50 to $2
M1KyQQvVPVuxqTAB8sR/zQ: folds
1WUCqNG+p+vfWRTXNu4ljw: folds
lxIzoHy0RnkfFSODHC2liw: folds
2igtJLmvIZ+HqX4XPgMPZA: folds
IBNygaT1aa9Z1uPdJJilwA collected $1.25 from pot
*** SUMMARY ***
Total pot $1.25 | Rake $0
Seat 1: 1WUCqNG+p+vfWRTXNu4ljw (button) folded before Flop (didn't bet)
Seat 3: lxIzoHy0RnkfFSODHC2liw (small blind) folded before Flop
Seat 4: 2igtJLmvIZ+HqX4XPgMPZA (big blind) folded before Flop
Seat 5: IBNygaT1aa9Z1uPdJJilwA collected ($1.25)
Seat 6: M1KyQQvVPVuxqTAB8sR/zQ folded before Flop (didn't bet)



PokerStars Game #59940983992:  Hold'em No Limit ($0.25/$0.50) - 2009/07/01 1:22:18 ET
Table '+dXkOAQyS8j9PQZusUTMpg' 2-max Seat #2 is the button
Seat 1: Teld4PDKla7C8/Wfu2DSkg ($54.05 in chips)
Seat 2: +zI4bP23YIjMkUHqeN2xfw ($24.95 in chips)
+zI4bP23YIjMkUHqeN2xfw: posts small blind $0.25
Teld4PDKla7C8/Wfu2DSkg: posts big blind $0.50
*** HOLE CARDS ***
+zI4bP23YIjMkUHqeN2xfw: calls $0.25
Teld4PDKla7C8/Wfu2DSkg: raises $1.50 to $2
+zI4bP23YIjMkUHqeN2xfw: calls $1.50
*** FLOP *** [8c Tc 5s]
Teld4PDKla7C8/Wfu2DSkg: checks
+zI4bP23YIjMkUHqeN2xfw: bets $1.50
Teld4PDKla7C8/Wfu2DSkg: calls $1.50
*** TURN *** [8c Tc 5s] [Ks]
Teld4PDKla7C8/Wfu2DSkg: checks
+zI4bP23YIjMkUHqeN2xfw: checks
*** RIVER *** [8c Tc 5s Ks] [Ad]
Teld4PDKla7C8/Wfu2DSkg: bets $3.50
+zI4bP23YIjMkUHqeN2xfw: calls $3.50
*** SHOW DOWN ***
Teld4PDKla7C8/Wfu2DSkg: shows [Qs Kd] (a pair of Kings)
+zI4bP23YIjMkUHqeN2xfw: shows [4c Ac] (a pair of Aces)
+zI4bP23YIjMkUHqeN2xfw collected $13.50 from pot
*** SUMMARY ***
Total pot $14 | Rake $0.50
Board [8c Tc 5s Ks Ad]
Seat 1: Teld4PDKla7C8/Wfu2DSkg (big blind) showed [Qs Kd] and lost with a pair of Kings
Seat 2: +zI4bP23YIjMkUHqeN2xfw (button) (small blind) showed [4c Ac] and won ($13.50) with a pair of Aces



PokerStars Game #59940985146:  Hold'em No Limit ($0.25/$0.50) - 2009/07/01 1:22:20 ET
Table 'X6IRCRTh+20gjz8aubWnwA' 9-max Seat #2 is the button
Seat 1: E2518gp4aFz1+kAgmGqeEg ($10.25 in chips)
Seat 2: HZkVla4kK2SI42CVrPZ/ig ($3 in chips)
Seat 3: SWv01peOe69QQRvhQTqjQw ($13.55 in chips)
Seat 4: M3JFBNQ8Bbw3FBZ/18MuXw ($24.15 in chips)
Seat 6: 75K2MXwN65Sjfp1yHd50Hg ($12.15 in chips)
Seat 7: cFHQjKQOOKTUzoilhrXHLg ($14 in chips)
Seat 8: HxeBVq06/3Bh/H986sgdbw ($48.50 in chips)
Seat 9: M+7+BTmX5vZatHVuoRB1nA ($44.80 in chips)
SWv01peOe69QQRvhQTqjQw: posts small blind $0.25
M3JFBNQ8Bbw3FBZ/18MuXw: posts big blind $0.50
uw9QayAAxLM3Hb+HR7mSkg: sits out
*** HOLE CARDS ***
SWv01peOe69QQRvhQTqjQw said, "nice!"
75K2MXwN65Sjfp1yHd50Hg: raises $1 to $1.50
cFHQjKQOOKTUzoilhrXHLg: folds
HxeBVq06/3Bh/H986sgdbw: calls $1.50
M+7+BTmX5vZatHVuoRB1nA: folds
E2518gp4aFz1+kAgmGqeEg: folds
HZkVla4kK2SI42CVrPZ/ig: folds
SWv01peOe69QQRvhQTqjQw: folds
M3JFBNQ8Bbw3FBZ/18MuXw: folds
*** FLOP *** [Kc 2h Jh]
75K2MXwN65Sjfp1yHd50Hg: bets $2
HxeBVq06/3Bh/H986sgdbw: folds
75K2MXwN65Sjfp1yHd50Hg collected $3.60 from pot
75K2MXwN65Sjfp1yHd50Hg: doesn't show hand
*** SUMMARY ***
Total pot $3.75 | Rake $0.15
Board [Kc 2h Jh]
Seat 1: E2518gp4aFz1+kAgmGqeEg folded before Flop (didn't bet)
Seat 2: HZkVla4kK2SI42CVrPZ/ig (button) folded before Flop (didn't bet)
Seat 3: SWv01peOe69QQRvhQTqjQw (small blind) folded before Flop
Seat 4: M3JFBNQ8Bbw3FBZ/18MuXw (big blind) folded before Flop
Seat 6: 75K2MXwN65Sjfp1yHd50Hg collected ($3.60)
Seat 7: cFHQjKQOOKTUzoilhrXHLg folded before Flop (didn't bet)
Seat 8: HxeBVq06/3Bh/H986sgdbw folded on the Flop
Seat 9: M+7+BTmX5vZatHVuoRB1nA folded before Flop (didn't bet)



PokerStars Game #59940987646:  Hold'em No Limit ($0.25/$0.50) - 2009/07/01 1:22:25 ET
Table 'ZYI3ZReBjdfKEYItkZHI6A' 9-max Seat #2 is the button
Seat 1: IYd5zG8k7vdBNVHbHg2Pag ($50.75 in chips)
Seat 2: uw9QayAAxLM3Hb+HR7mSkg ($9.25 in chips)
Seat 3: bkXkL3pmapikPQQRNPZSEA ($12.40 in chips)
Seat 4: e2+sK/yjnj94rXOKoxPP2A ($66.65 in chips)
Seat 5: ApHP7ouup365XIUFBdEDxg ($42.50 in chips)
Seat 6: 1xBtrSVBbgFH/viUWKqQeg ($30.20 in chips)
Seat 7: HWcfp1hY1hqvrddzW3/FQw ($16.75 in chips)
Seat 8: ji04uOybxCdpdefzlUQeKQ ($24 in chips)
bkXkL3pmapikPQQRNPZSEA: posts small blind $0.25
e2+sK/yjnj94rXOKoxPP2A: posts big blind $0.50
*** HOLE CARDS ***
ApHP7ouup365XIUFBdEDxg: calls $0.50
1xBtrSVBbgFH/viUWKqQeg: folds
HWcfp1hY1hqvrddzW3/FQw: folds
ji04uOybxCdpdefzlUQeKQ: raises $1.50 to $2
IYd5zG8k7vdBNVHbHg2Pag: folds
uw9QayAAxLM3Hb+HR7mSkg: folds
bkXkL3pmapikPQQRNPZSEA: folds
e2+sK/yjnj94rXOKoxPP2A: folds
ApHP7ouup365XIUFBdEDxg: calls $1.50
*** FLOP *** [Ad 2d Kd]
ApHP7ouup365XIUFBdEDxg: checks
ji04uOybxCdpdefzlUQeKQ: bets $4.50
ApHP7ouup365XIUFBdEDxg: calls $4.50
*** TURN *** [Ad 2d Kd] [6h]
Tactoad leaves the table
ApHP7ouup365XIUFBdEDxg: checks
HZkVla4kK2SI42CVrPZ/ig joins the table at seat #9
ji04uOybxCdpdefzlUQeKQ: bets $7.50
ApHP7ouup365XIUFBdEDxg: folds
ji04uOybxCdpdefzlUQeKQ collected $13.10 from pot
ji04uOybxCdpdefzlUQeKQ: doesn't show hand
*** SUMMARY ***
Total pot $13.75 | Rake $0.65
Board [Ad 2d Kd 6h]
Seat 1: IYd5zG8k7vdBNVHbHg2Pag folded before Flop (didn't bet)
Seat 2: uw9QayAAxLM3Hb+HR7mSkg (button) folded before Flop (didn't bet)
Seat 3: bkXkL3pmapikPQQRNPZSEA (small blind) folded before Flop
Seat 4: e2+sK/yjnj94rXOKoxPP2A (big blind) folded before Flop
Seat 5: ApHP7ouup365XIUFBdEDxg folded on the Turn
Seat 6: 1xBtrSVBbgFH/viUWKqQeg folded before Flop (didn't bet)
Seat 7: HWcfp1hY1hqvrddzW3/FQw folded before Flop (didn't bet)
Seat 8: ji04uOybxCdpdefzlUQeKQ collected ($13.10)



PokerStars Game #59940987464:  Hold'em No Limit ($0.25/$0.50) - 2009/07/01 1:22:25 ET
Table 'ofnd8S4IdIPph1Cbn+x7hA' 2-max Seat #2 is the button
Seat 1: PY4NvRocCFPfSIHKbh0euQ ($26.10 in chips)
Seat 2: l5WbyJ/iWYjpeCC6GCYY6w ($67.50 in chips)
l5WbyJ/iWYjpeCC6GCYY6w: posts small blind $0.25
PY4NvRocCFPfSIHKbh0euQ: posts big blind $0.50
*** HOLE CARDS ***
l5WbyJ/iWYjpeCC6GCYY6w: raises $1 to $1.50
PY4NvRocCFPfSIHKbh0euQ: folds
l5WbyJ/iWYjpeCC6GCYY6w collected $1 from pot
l5WbyJ/iWYjpeCC6GCYY6w: doesn't show hand
*** SUMMARY ***
Total pot $1 | Rake $0
Seat 1: PY4NvRocCFPfSIHKbh0euQ (big blind) folded before Flop
Seat 2: l5WbyJ/iWYjpeCC6GCYY6w (button) (small blind) collected ($1)



PokerStars Game #59940988366:  Hold'em No Limit ($0.25/$0.50) - 2009/07/01 1:22:26 ET
Table '3FhG0gl3kMX3wBEEqj+wnQ' 9-max Seat #7 is the button
Seat 1: bxLSulbgr8LmKNjOzw8URg ($50.05 in chips)
Seat 2: vacmVLJJECYI6HjAynFcpg ($52.10 in chips)
Seat 3: YXCE3WOZi8g2sIf3y/plVw ($50 in chips)
Seat 4: e2+sK/yjnj94rXOKoxPP2A ($71.75 in chips)
Seat 5: XcLXSUMHSpshK/7Lh0M4Vg ($10 in chips)
Seat 6: 997ViqAtWn1FPjJqcffwcA ($110.55 in chips)
Seat 7: mSD1pginDsyHG5PDfqzphw ($11.50 in chips)
Seat 8: j3K/Jujr7PY4ZM2RZvlH6A ($46.90 in chips)
Seat 9: KA0tkubTlbhmo4ju+qgXPg ($42.85 in chips)
j3K/Jujr7PY4ZM2RZvlH6A: posts small blind $0.25
KA0tkubTlbhmo4ju+qgXPg: posts big blind $0.50
*** HOLE CARDS ***
bxLSulbgr8LmKNjOzw8URg: folds
vacmVLJJECYI6HjAynFcpg: folds
YXCE3WOZi8g2sIf3y/plVw: raises $0.50 to $1
e2+sK/yjnj94rXOKoxPP2A: folds
XcLXSUMHSpshK/7Lh0M4Vg: folds
997ViqAtWn1FPjJqcffwcA: folds
mSD1pginDsyHG5PDfqzphw: folds
j3K/Jujr7PY4ZM2RZvlH6A: folds
KA0tkubTlbhmo4ju+qgXPg: calls $0.50
*** FLOP *** [7d 8h Th]
KA0tkubTlbhmo4ju+qgXPg: checks
YXCE3WOZi8g2sIf3y/plVw: bets $1.50
KA0tkubTlbhmo4ju+qgXPg: calls $1.50
*** TURN *** [7d 8h Th] [Js]
KA0tkubTlbhmo4ju+qgXPg: checks
YXCE3WOZi8g2sIf3y/plVw: checks
*** RIVER *** [7d 8h Th Js] [3c]
KA0tkubTlbhmo4ju+qgXPg: bets $3
YXCE3WOZi8g2sIf3y/plVw: folds
KA0tkubTlbhmo4ju+qgXPg collected $5 from pot
*** SUMMARY ***
Total pot $5.25 | Rake $0.25
Board [7d 8h Th Js 3c]
Seat 1: bxLSulbgr8LmKNjOzw8URg folded before Flop (didn't bet)
Seat 2: vacmVLJJECYI6HjAynFcpg folded before Flop (didn't bet)
Seat 3: YXCE3WOZi8g2sIf3y/plVw folded on the River
Seat 4: e2+sK/yjnj94rXOKoxPP2A folded before Flop (didn't bet)
Seat 5: XcLXSUMHSpshK/7Lh0M4Vg folded before Flop (didn't bet)
Seat 6: 997ViqAtWn1FPjJqcffwcA folded before Flop (didn't bet)
Seat 7: mSD1pginDsyHG5PDfqzphw (button) folded before Flop (didn't bet)
Seat 8: j3K/Jujr7PY4ZM2RZvlH6A (small blind) folded before Flop
Seat 9: KA0tkubTlbhmo4ju+qgXPg (big blind) collected ($5)



PokerStars Game #59940988926:  Hold'em No Limit ($0.25/$0.50) - 2009/07/01 1:22:27 ET
Table '+z1aekfHkpp09pc8F9aViw' 6-max Seat #6 is the button
Seat 1: 7zFtlEn2NxyROFkJdZA/yg ($50 in chips)
Seat 2: OZ6OtYh5Y53MCH/p0QTn5g ($67.85 in chips)
Seat 3: uUznlIMFnRUvwrBhYF73KA ($137.90 in chips)
Seat 4: RowCSpSURHTOL/dcjg/Iug ($90 in chips)
Seat 6: GUnvMULl2qFOO1yenu1UBw ($50 in chips)
7zFtlEn2NxyROFkJdZA/yg: posts small blind $0.25
OZ6OtYh5Y53MCH/p0QTn5g: posts big blind $0.50
2igtJLmvIZ+HqX4XPgMPZA: sits out
*** HOLE CARDS ***
uUznlIMFnRUvwrBhYF73KA: calls $0.50
RowCSpSURHTOL/dcjg/Iug: folds
GUnvMULl2qFOO1yenu1UBw: folds
7zFtlEn2NxyROFkJdZA/yg: folds
OZ6OtYh5Y53MCH/p0QTn5g: checks
*** FLOP *** [Kh Th Qs]
OZ6OtYh5Y53MCH/p0QTn5g: checks
uUznlIMFnRUvwrBhYF73KA: checks
*** TURN *** [Kh Th Qs] [6d]
OZ6OtYh5Y53MCH/p0QTn5g: checks
uUznlIMFnRUvwrBhYF73KA: checks
*** RIVER *** [Kh Th Qs 6d] [8c]
OZ6OtYh5Y53MCH/p0QTn5g: checks
uUznlIMFnRUvwrBhYF73KA: bets $2
OZ6OtYh5Y53MCH/p0QTn5g: folds
uUznlIMFnRUvwrBhYF73KA collected $1.20 from pot
uUznlIMFnRUvwrBhYF73KA: doesn't show hand
*** SUMMARY ***
Total pot $1.25 | Rake $0.05
Board [Kh Th Qs 6d 8c]
Seat 1: 7zFtlEn2NxyROFkJdZA/yg (small blind) folded before Flop
Seat 2: OZ6OtYh5Y53MCH/p0QTn5g (big blind) folded on the River
Seat 3: uUznlIMFnRUvwrBhYF73KA collected ($1.20)
Seat 4: RowCSpSURHTOL/dcjg/Iug folded before Flop (didn't bet)
Seat 6: GUnvMULl2qFOO1yenu1UBw (button) folded before Flop (didn't bet)



PokerStars Game #59940989382:  Hold'em No Limit ($0.25/$0.50) - 2009/07/01 1:22:28 ET
Table 'BCN5su+SsXiy1zRMJi0SJw' 6-max Seat #6 is the button
Seat 1: GxXV09ciXaOxyY2H5aMIIw ($49.30 in chips)
Seat 2: ehFNAevCQri3trWxV6FJdA ($33.95 in chips)
Seat 3: kwgv5lNhiFrfONXCshzxlA ($43.95 in chips)
Seat 4: fXMRO3W+v+BAC9U+y/9YLQ ($24.65 in chips)
Seat 6: b2symlOdL7+0c9Pj4N/KlA ($58.25 in chips)
GxXV09ciXaOxyY2H5aMIIw: posts small blind $0.25
ehFNAevCQri3trWxV6FJdA: posts big blind $0.50
fXMRO3W+v+BAC9U+y/9YLQ: posts big blind $0.50
kxPhs4ePFqMy52CInAJ2aw: sits out
*** HOLE CARDS ***
kwgv5lNhiFrfONXCshzxlA: calls $0.50
fXMRO3W+v+BAC9U+y/9YLQ: raises $0.50 to $1
b2symlOdL7+0c9Pj4N/KlA: folds
GxXV09ciXaOxyY2H5aMIIw: folds
ehFNAevCQri3trWxV6FJdA: calls $0.50
kwgv5lNhiFrfONXCshzxlA: calls $0.50
*** FLOP *** [Ac 5c 7s]
ehFNAevCQri3trWxV6FJdA: checks
kwgv5lNhiFrfONXCshzxlA: checks
fXMRO3W+v+BAC9U+y/9YLQ: checks
*** TURN *** [Ac 5c 7s] [Th]
ehFNAevCQri3trWxV6FJdA: bets $1.50
kwgv5lNhiFrfONXCshzxlA: folds
fXMRO3W+v+BAC9U+y/9YLQ: calls $1.50
*** RIVER *** [Ac 5c 7s Th] [5h]
ehFNAevCQri3trWxV6FJdA: bets $4
fXMRO3W+v+BAC9U+y/9YLQ: raises $4 to $8
ehFNAevCQri3trWxV6FJdA: raises $23.45 to $31.45 and is all-in
fXMRO3W+v+BAC9U+y/9YLQ: calls $14.15 and is all-in
*** SHOW DOWN ***
ehFNAevCQri3trWxV6FJdA: shows [5d 9h] (three of a kind, Fives)
fXMRO3W+v+BAC9U+y/9YLQ: mucks hand
ehFNAevCQri3trWxV6FJdA collected $48.55 from pot
*** SUMMARY ***
Total pot $50.55 | Rake $2
Board [Ac 5c 7s Th 5h]
Seat 1: GxXV09ciXaOxyY2H5aMIIw (small blind) folded before Flop
Seat 2: ehFNAevCQri3trWxV6FJdA (big blind) showed [5d 9h] and won ($48.55) with three of a kind, Fives
Seat 3: kwgv5lNhiFrfONXCshzxlA folded on the Turn
Seat 4: fXMRO3W+v+BAC9U+y/9YLQ mucked
Seat 6: b2symlOdL7+0c9Pj4N/KlA (button) folded before Flop (didn't bet)



PokerStars Game #59940993530:  Hold'em No Limit ($0.25/$0.50) - 2009/07/01 1:22:35 ET
Table 'tyR5AZNKV8Aadbrnrnlg7g' 6-max Seat #2 is the button
Seat 1: BgOXYI0yYSN1ULC4FqsNkg ($96.05 in chips)
Seat 2: BAjwVL+zKKd0s0fAWstzQQ ($56.95 in chips)
Seat 3: JFLrYNyQmwPhRQAtoSAuyA ($45.25 in chips)
Seat 4: 4QfsCWthT/vSLirorNXqtg ($88.70 in chips)
Seat 5: GUnvMULl2qFOO1yenu1UBw ($50 in chips)
Seat 6: 498aWaGsW4uGfuWl+2FCGw ($44.90 in chips)
JFLrYNyQmwPhRQAtoSAuyA: posts small blind $0.25
4QfsCWthT/vSLirorNXqtg: posts big blind $0.50
*** HOLE CARDS ***
GUnvMULl2qFOO1yenu1UBw: folds
498aWaGsW4uGfuWl+2FCGw: folds
BgOXYI0yYSN1ULC4FqsNkg: folds
BAjwVL+zKKd0s0fAWstzQQ: folds
JFLrYNyQmwPhRQAtoSAuyA: folds
4QfsCWthT/vSLirorNXqtg collected $0.50 from pot
4QfsCWthT/vSLirorNXqtg: doesn't show hand
*** SUMMARY ***
Total pot $0.50 | Rake $0
Seat 1: BgOXYI0yYSN1ULC4FqsNkg folded before Flop (didn't bet)
Seat 2: BAjwVL+zKKd0s0fAWstzQQ (button) folded before Flop (didn't bet)
Seat 3: JFLrYNyQmwPhRQAtoSAuyA (small blind) folded before Flop
Seat 4: 4QfsCWthT/vSLirorNXqtg (big blind) collected ($0.50)
Seat 5: GUnvMULl2qFOO1yenu1UBw folded before Flop (didn't bet)
Seat 6: 498aWaGsW4uGfuWl+2FCGw folded before Flop (didn't bet)



PokerStars Game #59940994260:  Hold'em No Limit ($0.25/$0.50) - 2009/07/01 1:22:36 ET
Table 'otvGDROEDdqsabxskT79qg' 9-max Seat #4 is the button
Seat 1: 8ehL7qlZzjgUh2H35iiWLw ($62 in chips)
Seat 2: cCjTzH9jio8607WzjcfXlg ($10.65 in chips)
Seat 3: +k7T5ocke8UwavtgUHm+Cg ($73.75 in chips)
Seat 4: MG90wfSJZnOejs/KD3vlQQ ($80.65 in chips)
Seat 5: E2518gp4aFz1+kAgmGqeEg ($11.70 in chips)
Seat 8: zE9cVigS2nW/Ljy4K4bUQA ($33.30 in chips)
Seat 9: KcY3X8YpD74Kw1RHkx/g4A ($31.65 in chips)
E2518gp4aFz1+kAgmGqeEg: posts small blind $0.25
bxLSulbgr8LmKNjOzw8URg: is sitting out
75K2MXwN65Sjfp1yHd50Hg: is sitting out
zE9cVigS2nW/Ljy4K4bUQA: posts big blind $0.50
*** HOLE CARDS ***
KcY3X8YpD74Kw1RHkx/g4A: folds
bxLSulbgr8LmKNjOzw8URg leaves the table
8ehL7qlZzjgUh2H35iiWLw: folds
cCjTzH9jio8607WzjcfXlg: folds
+k7T5ocke8UwavtgUHm+Cg: folds
MG90wfSJZnOejs/KD3vlQQ: folds
E2518gp4aFz1+kAgmGqeEg: raises $1 to $1.50
FFVKBJT0lZf+jFlgvy7ang joins the table at seat #6
zE9cVigS2nW/Ljy4K4bUQA: folds
E2518gp4aFz1+kAgmGqeEg collected $1 from pot
E2518gp4aFz1+kAgmGqeEg: doesn't show hand
*** SUMMARY ***
Total pot $1 | Rake $0
Seat 1: 8ehL7qlZzjgUh2H35iiWLw folded before Flop (didn't bet)
Seat 2: cCjTzH9jio8607WzjcfXlg folded before Flop (didn't bet)
Seat 3: +k7T5ocke8UwavtgUHm+Cg folded before Flop (didn't bet)
Seat 4: MG90wfSJZnOejs/KD3vlQQ (button) folded before Flop (didn't bet)
Seat 5: E2518gp4aFz1+kAgmGqeEg (small blind) collected ($1)
Seat 8: zE9cVigS2nW/Ljy4K4bUQA (big blind) folded before Flop
Seat 9: KcY3X8YpD74Kw1RHkx/g4A folded before Flop (didn't bet)



PokerStars Game #59940994276:  Hold'em No Limit ($0.25/$0.50) - 2009/07/01 1:22:36 ET
Table 'c/CRn+68J3Y8KxD5g1ek2Q' 2-max Seat #2 is the button
Seat 1: 46qCyJ6evTkHo9al5sBMNA ($102.45 in chips)
Seat 2: BypVLsYQt3ePFm2xQL/dOA ($257.85 in chips)
BypVLsYQt3ePFm2xQL/dOA: posts small blind $0.25
46qCyJ6evTkHo9al5sBMNA: posts big blind $0.50
*** HOLE CARDS ***
BypVLsYQt3ePFm2xQL/dOA: calls $0.25
46qCyJ6evTkHo9al5sBMNA: checks
*** FLOP *** [8c 9h 6d]
46qCyJ6evTkHo9al5sBMNA: checks
BypVLsYQt3ePFm2xQL/dOA: checks
*** TURN *** [8c 9h 6d] [Ah]
46qCyJ6evTkHo9al5sBMNA: bets $2
BypVLsYQt3ePFm2xQL/dOA: folds
46qCyJ6evTkHo9al5sBMNA collected $0.95 from pot
46qCyJ6evTkHo9al5sBMNA: doesn't show hand
*** SUMMARY ***
Total pot $1 | Rake $0.05
Board [8c 9h 6d Ah]
Seat 1: 46qCyJ6evTkHo9al5sBMNA (big blind) collected ($0.95)
Seat 2: BypVLsYQt3ePFm2xQL/dOA (button) (small blind) folded on the Turn



PokerStars Game #59940994354:  Hold'em No Limit ($0.25/$0.50) - 2009/07/01 1:22:36 ET
Table 'fx6MqwfYAj/Rt86hBz2L3Q' 9-max Seat #2 is the button
Seat 1: v/4aX0ejnaIFK4ftDk2Lyg ($52.15 in chips)
Seat 2: C3rGXblctNcWI6JYPHhaEg ($40.85 in chips)
Seat 3: iadBi5AEt7gTBXbDSSnMYQ ($47.15 in chips)
Seat 5: iAISe3dVeua8PUn2wwgDHw ($65.15 in chips)
Seat 6: 5k9fvXD9suIgCxU4HLQjTw ($50 in chips)
Seat 7: SKnJuWHScqetA/qG5p+wCg ($30 in chips)
Seat 8: JYwJYYV9pM5KWdSiETl8rA ($63.25 in chips)
Seat 9: vO3QVRovWemcGMkm7ijAIA ($12.25 in chips)
iadBi5AEt7gTBXbDSSnMYQ: posts small blind $0.25
iAISe3dVeua8PUn2wwgDHw: posts big blind $0.50
*** HOLE CARDS ***
5k9fvXD9suIgCxU4HLQjTw: folds
SKnJuWHScqetA/qG5p+wCg: folds
JYwJYYV9pM5KWdSiETl8rA: folds
vO3QVRovWemcGMkm7ijAIA: folds
v/4aX0ejnaIFK4ftDk2Lyg: folds
C3rGXblctNcWI6JYPHhaEg: calls $0.50
iadBi5AEt7gTBXbDSSnMYQ: calls $0.25
iAISe3dVeua8PUn2wwgDHw: checks
*** FLOP *** [9h 9c Kc]
iadBi5AEt7gTBXbDSSnMYQ: checks
iAISe3dVeua8PUn2wwgDHw: bets $0.50
C3rGXblctNcWI6JYPHhaEg: raises $0.85 to $1.35
iadBi5AEt7gTBXbDSSnMYQ: raises $4.15 to $5.50
iAISe3dVeua8PUn2wwgDHw: folds
C3rGXblctNcWI6JYPHhaEg: folds
iadBi5AEt7gTBXbDSSnMYQ collected $4.50 from pot
*** SUMMARY ***
Total pot $4.70 | Rake $0.20
Board [9h 9c Kc]
Seat 1: v/4aX0ejnaIFK4ftDk2Lyg folded before Flop (didn't bet)
Seat 2: C3rGXblctNcWI6JYPHhaEg (button) folded on the Flop
Seat 3: iadBi5AEt7gTBXbDSSnMYQ (small blind) collected ($4.50)
Seat 5: iAISe3dVeua8PUn2wwgDHw (big blind) folded on the Flop
Seat 6: 5k9fvXD9suIgCxU4HLQjTw folded before Flop (didn't bet)
Seat 7: SKnJuWHScqetA/qG5p+wCg folded before Flop (didn't bet)
Seat 8: JYwJYYV9pM5KWdSiETl8rA folded before Flop (didn't bet)
Seat 9: vO3QVRovWemcGMkm7ijAIA folded before Flop (didn't bet)



PokerStars Game #59940994688:  Hold'em No Limit ($0.25/$0.50) - 2009/07/01 1:22:37 ET
Table 'ofnd8S4IdIPph1Cbn+x7hA' 2-max Seat #1 is the button
Seat 1: PY4NvRocCFPfSIHKbh0euQ ($25.60 in chips)
Seat 2: l5WbyJ/iWYjpeCC6GCYY6w ($68 in chips)
PY4NvRocCFPfSIHKbh0euQ: posts small blind $0.25
l5WbyJ/iWYjpeCC6GCYY6w: posts big blind $0.50
*** HOLE CARDS ***
PY4NvRocCFPfSIHKbh0euQ: raises $0.50 to $1
l5WbyJ/iWYjpeCC6GCYY6w: folds
PY4NvRocCFPfSIHKbh0euQ collected $1 from pot
*** SUMMARY ***
Total pot $1 | Rake $0
Seat 1: PY4NvRocCFPfSIHKbh0euQ (button) (small blind) collected ($1)
Seat 2: l5WbyJ/iWYjpeCC6GCYY6w (big blind) folded before Flop



PokerStars Game #59940994634:  Hold'em No Limit ($0.25/$0.50) - 2009/07/01 1:22:37 ET
Table '8BQGgNetI1NOvWeu3gtMNw' 2-max Seat #1 is the button
Seat 1: bypIyrYcAAifLfhZpGlKLA ($64.35 in chips)
Seat 2: Z4HwehErEwzsv/noQlfUlg ($125 in chips)
bypIyrYcAAifLfhZpGlKLA: posts small blind $0.25
Z4HwehErEwzsv/noQlfUlg: posts big blind $0.50
*** HOLE CARDS ***
bypIyrYcAAifLfhZpGlKLA: raises $1 to $1.50
Z4HwehErEwzsv/noQlfUlg: calls $1
*** FLOP *** [3c 7s Jc]
Z4HwehErEwzsv/noQlfUlg: checks
bypIyrYcAAifLfhZpGlKLA: bets $2
Z4HwehErEwzsv/noQlfUlg: folds
bypIyrYcAAifLfhZpGlKLA collected $2.85 from pot
bypIyrYcAAifLfhZpGlKLA: doesn't show hand
*** SUMMARY ***
Total pot $3 | Rake $0.15
Board [3c 7s Jc]
Seat 1: bypIyrYcAAifLfhZpGlKLA (button) (small blind) collected ($2.85)
Seat 2: Z4HwehErEwzsv/noQlfUlg (big blind) folded on the Flop



PokerStars Game #59940997898:  Hold'em No Limit ($0.25/$0.50) - 2009/07/01 1:22:43 ET
Table 'iq+aXfWVQRdV0u8SRTYUEg' 9-max Seat #7 is the button
Seat 1: 3yl8Q6QaLfGtyhN4/pEFgQ ($76.30 in chips)
Seat 2: J9N0lxHFd/Js2S0xZLbsIQ ($35.95 in chips)
Seat 5: 997ViqAtWn1FPjJqcffwcA ($50 in chips)
Seat 6: bTJ0WgoxefTPxIoycS7uoA ($31.60 in chips)
Seat 7: SKnJuWHScqetA/qG5p+wCg ($31.55 in chips)
Seat 8: /DtIHuxEH+3tzKefmSV+Mw ($17.05 in chips)
Seat 9: olE1Z2rKWAV8+tGqmIBK9g ($23.55 in chips)
/DtIHuxEH+3tzKefmSV+Mw: posts small blind $0.25
olE1Z2rKWAV8+tGqmIBK9g: posts big blind $0.50
vHYT5s323LpajBj+2c9zbQ: sits out
*** HOLE CARDS ***
PANKAKE-FLOP has returned
3yl8Q6QaLfGtyhN4/pEFgQ: folds
PANKAKE-FLOP leaves the table
J9N0lxHFd/Js2S0xZLbsIQ: calls $0.50
997ViqAtWn1FPjJqcffwcA: folds
bTJ0WgoxefTPxIoycS7uoA: calls $0.50
SKnJuWHScqetA/qG5p+wCg: folds
/DtIHuxEH+3tzKefmSV+Mw: calls $0.25
Qi/PyOsKwaqtKIg0H+7ELg joins the table at seat #3
olE1Z2rKWAV8+tGqmIBK9g: checks
*** FLOP *** [6s 8d 9h]
/DtIHuxEH+3tzKefmSV+Mw: checks
olE1Z2rKWAV8+tGqmIBK9g: bets $1
J9N0lxHFd/Js2S0xZLbsIQ: calls $1
bTJ0WgoxefTPxIoycS7uoA: raises $1.50 to $2.50
/DtIHuxEH+3tzKefmSV+Mw: folds
olE1Z2rKWAV8+tGqmIBK9g: folds
J9N0lxHFd/Js2S0xZLbsIQ: calls $1.50
*** TURN *** [6s 8d 9h] [Kd]
J9N0lxHFd/Js2S0xZLbsIQ: checks
bTJ0WgoxefTPxIoycS7uoA: bets $2
J9N0lxHFd/Js2S0xZLbsIQ: calls $2
*** RIVER *** [6s 8d 9h Kd] [5s]
J9N0lxHFd/Js2S0xZLbsIQ: checks
bTJ0WgoxefTPxIoycS7uoA: bets $3
J9N0lxHFd/Js2S0xZLbsIQ: raises $5 to $8
bTJ0WgoxefTPxIoycS7uoA: calls $5
*** SHOW DOWN ***
J9N0lxHFd/Js2S0xZLbsIQ: shows [Ad 7s] (a straight, Five to Nine)
bTJ0WgoxefTPxIoycS7uoA: shows [9s 7c] (a straight, Five to Nine)
J9N0lxHFd/Js2S0xZLbsIQ collected $13.35 from pot
bTJ0WgoxefTPxIoycS7uoA collected $13.30 from pot
*** SUMMARY ***
Total pot $28 | Rake $1.35
Board [6s 8d 9h Kd 5s]
Seat 1: 3yl8Q6QaLfGtyhN4/pEFgQ folded before Flop (didn't bet)
Seat 2: J9N0lxHFd/Js2S0xZLbsIQ showed [Ad 7s] and won ($13.35) with a straight, Five to Nine
Seat 5: 997ViqAtWn1FPjJqcffwcA folded before Flop (didn't bet)
Seat 6: bTJ0WgoxefTPxIoycS7uoA showed [9s 7c] and won ($13.30) with a straight, Five to Nine
Seat 7: SKnJuWHScqetA/qG5p+wCg (button) folded before Flop (didn't bet)
Seat 8: /DtIHuxEH+3tzKefmSV+Mw (small blind) folded on the Flop
Seat 9: olE1Z2rKWAV8+tGqmIBK9g (big blind) folded on the Flop



PokerStars Game #59940999014:  Hold'em No Limit ($0.25/$0.50) - 2009/07/01 1:22:45 ET
Table 'ofnd8S4IdIPph1Cbn+x7hA' 2-max Seat #2 is the button
Seat 1: PY4NvRocCFPfSIHKbh0euQ ($26.10 in chips)
Seat 2: l5WbyJ/iWYjpeCC6GCYY6w ($67.50 in chips)
l5WbyJ/iWYjpeCC6GCYY6w: posts small blind $0.25
PY4NvRocCFPfSIHKbh0euQ: posts big blind $0.50
*** HOLE CARDS ***
l5WbyJ/iWYjpeCC6GCYY6w: folds
PY4NvRocCFPfSIHKbh0euQ collected $0.50 from pot
*** SUMMARY ***
Total pot $0.50 | Rake $0
Seat 1: PY4NvRocCFPfSIHKbh0euQ (big blind) collected ($0.50)
Seat 2: l5WbyJ/iWYjpeCC6GCYY6w (button) (small blind) folded before Flop



PokerStars Game #59940999018:  Hold'em No Limit ($0.25/$0.50) - 2009/07/01 1:22:45 ET
Table '+dXkOAQyS8j9PQZusUTMpg' 2-max Seat #1 is the button
Seat 1: Teld4PDKla7C8/Wfu2DSkg ($47.05 in chips)
Seat 2: +zI4bP23YIjMkUHqeN2xfw ($31.45 in chips)
Teld4PDKla7C8/Wfu2DSkg: posts small blind $0.25
+zI4bP23YIjMkUHqeN2xfw: posts big blind $0.50
*** HOLE CARDS ***
Teld4PDKla7C8/Wfu2DSkg: folds
+zI4bP23YIjMkUHqeN2xfw collected $0.50 from pot
*** SUMMARY ***
Total pot $0.50 | Rake $0
Seat 1: Teld4PDKla7C8/Wfu2DSkg (button) (small blind) folded before Flop
Seat 2: +zI4bP23YIjMkUHqeN2xfw (big blind) collected ($0.50)



PokerStars Game #59940999786:  Hold'em No Limit ($0.25/$0.50) - 2009/07/01 1:22:46 ET
Table 'tyR5AZNKV8Aadbrnrnlg7g' 6-max Seat #3 is the button
Seat 1: BgOXYI0yYSN1ULC4FqsNkg ($96.05 in chips)
Seat 2: BAjwVL+zKKd0s0fAWstzQQ ($56.95 in chips)
Seat 3: JFLrYNyQmwPhRQAtoSAuyA ($45 in chips)
Seat 4: 4QfsCWthT/vSLirorNXqtg ($88.95 in chips)
Seat 5: GUnvMULl2qFOO1yenu1UBw ($50 in chips)
Seat 6: 498aWaGsW4uGfuWl+2FCGw ($44.90 in chips)
4QfsCWthT/vSLirorNXqtg: posts small blind $0.25
GUnvMULl2qFOO1yenu1UBw: posts big blind $0.50
*** HOLE CARDS ***
498aWaGsW4uGfuWl+2FCGw: calls $0.50
BgOXYI0yYSN1ULC4FqsNkg: folds
BAjwVL+zKKd0s0fAWstzQQ: calls $0.50
JFLrYNyQmwPhRQAtoSAuyA: calls $0.50
4QfsCWthT/vSLirorNXqtg: folds
GUnvMULl2qFOO1yenu1UBw: checks
*** FLOP *** [6c 5c 4c]
GUnvMULl2qFOO1yenu1UBw: checks
498aWaGsW4uGfuWl+2FCGw: checks
BAjwVL+zKKd0s0fAWstzQQ: checks
JFLrYNyQmwPhRQAtoSAuyA: checks
*** TURN *** [6c 5c 4c] [Ac]
GUnvMULl2qFOO1yenu1UBw: checks
498aWaGsW4uGfuWl+2FCGw: bets $0.50
BAjwVL+zKKd0s0fAWstzQQ: folds
JFLrYNyQmwPhRQAtoSAuyA: folds
GUnvMULl2qFOO1yenu1UBw: folds
498aWaGsW4uGfuWl+2FCGw collected $2.15 from pot
498aWaGsW4uGfuWl+2FCGw: doesn't show hand
*** SUMMARY ***
Total pot $2.25 | Rake $0.10
Board [6c 5c 4c Ac]
Seat 1: BgOXYI0yYSN1ULC4FqsNkg folded before Flop (didn't bet)
Seat 2: BAjwVL+zKKd0s0fAWstzQQ folded on the Turn
Seat 3: JFLrYNyQmwPhRQAtoSAuyA (button) folded on the Turn
Seat 4: 4QfsCWthT/vSLirorNXqtg (small blind) folded before Flop
Seat 5: GUnvMULl2qFOO1yenu1UBw (big blind) folded on the Turn
Seat 6: 498aWaGsW4uGfuWl+2FCGw collected ($2.15)



PokerStars Game #59941002600:  Hold'em No Limit ($0.25/$0.50) - 2009/07/01 1:22:51 ET
Table 'ofnd8S4IdIPph1Cbn+x7hA' 2-max Seat #1 is the button
Seat 1: PY4NvRocCFPfSIHKbh0euQ ($26.35 in chips)
Seat 2: l5WbyJ/iWYjpeCC6GCYY6w ($67.25 in chips)
PY4NvRocCFPfSIHKbh0euQ: posts small blind $0.25
l5WbyJ/iWYjpeCC6GCYY6w: posts big blind $0.50
*** HOLE CARDS ***
PY4NvRocCFPfSIHKbh0euQ: raises $1.50 to $2
l5WbyJ/iWYjpeCC6GCYY6w: folds
PY4NvRocCFPfSIHKbh0euQ collected $1 from pot
*** SUMMARY ***
Total pot $1 | Rake $0
Seat 1: PY4NvRocCFPfSIHKbh0euQ (button) (small blind) collected ($1)
Seat 2: l5WbyJ/iWYjpeCC6GCYY6w (big blind) folded before Flop



PokerStars Game #59941002940:  Hold'em No Limit ($0.25/$0.50) - 2009/07/01 1:22:52 ET
Table '+dXkOAQyS8j9PQZusUTMpg' 2-max Seat #2 is the button
Seat 1: Teld4PDKla7C8/Wfu2DSkg ($46.80 in chips)
Seat 2: +zI4bP23YIjMkUHqeN2xfw ($31.70 in chips)
+zI4bP23YIjMkUHqeN2xfw: posts small blind $0.25
Teld4PDKla7C8/Wfu2DSkg: posts big blind $0.50
*** HOLE CARDS ***
+zI4bP23YIjMkUHqeN2xfw: calls $0.25
Teld4PDKla7C8/Wfu2DSkg: checks
*** FLOP *** [Td Kc Qh]
Teld4PDKla7C8/Wfu2DSkg: bets $0.50
+zI4bP23YIjMkUHqeN2xfw: raises $1.50 to $2
Teld4PDKla7C8/Wfu2DSkg: folds
+zI4bP23YIjMkUHqeN2xfw collected $1.95 from pot
+zI4bP23YIjMkUHqeN2xfw: doesn't show hand
*** SUMMARY ***
Total pot $2 | Rake $0.05
Board [Td Kc Qh]
Seat 1: Teld4PDKla7C8/Wfu2DSkg (big blind) folded on the Flop
Seat 2: +zI4bP23YIjMkUHqeN2xfw (button) (small blind) collected ($1.95)



PokerStars Game #59941003586:  Hold'em No Limit ($0.25/$0.50) - 2009/07/01 1:22:53 ET
Table '8BQGgNetI1NOvWeu3gtMNw' 2-max Seat #2 is the button
Seat 1: bypIyrYcAAifLfhZpGlKLA ($65.70 in chips)
Seat 2: Z4HwehErEwzsv/noQlfUlg ($123.50 in chips)
Z4HwehErEwzsv/noQlfUlg: posts small blind $0.25
bypIyrYcAAifLfhZpGlKLA: posts big blind $0.50
*** HOLE CARDS ***
Z4HwehErEwzsv/noQlfUlg: folds
bypIyrYcAAifLfhZpGlKLA collected $0.50 from pot
bypIyrYcAAifLfhZpGlKLA: doesn't show hand
*** SUMMARY ***
Total pot $0.50 | Rake $0
Seat 1: bypIyrYcAAifLfhZpGlKLA (big blind) collected ($0.50)
Seat 2: Z4HwehErEwzsv/noQlfUlg (button) (small blind) folded before Flop



PokerStars Game #59941005048:  Hold'em No Limit ($0.25/$0.50) - 2009/07/01 1:22:55 ET
Table 'hSTs/dUsYLgJQuF2Onp0MQ' 6-max Seat #3 is the button
Seat 1: 1WUCqNG+p+vfWRTXNu4ljw ($50 in chips)
Seat 3: lxIzoHy0RnkfFSODHC2liw ($50 in chips)
Seat 4: 2igtJLmvIZ+HqX4XPgMPZA ($80.40 in chips)
Seat 5: IBNygaT1aa9Z1uPdJJilwA ($39.25 in chips)
Seat 6: M1KyQQvVPVuxqTAB8sR/zQ ($87.45 in chips)
2igtJLmvIZ+HqX4XPgMPZA: posts small blind $0.25
IBNygaT1aa9Z1uPdJJilwA: posts big blind $0.50
*** HOLE CARDS ***
M1KyQQvVPVuxqTAB8sR/zQ: folds
1WUCqNG+p+vfWRTXNu4ljw: folds
lxIzoHy0RnkfFSODHC2liw: raises $1 to $1.50
Hdd4js36ITbTJ/QuVYwTlA joins the table at seat #2
2igtJLmvIZ+HqX4XPgMPZA: folds
IBNygaT1aa9Z1uPdJJilwA: folds
lxIzoHy0RnkfFSODHC2liw collected $1.25 from pot
*** SUMMARY ***
Total pot $1.25 | Rake $0
Seat 1: 1WUCqNG+p+vfWRTXNu4ljw folded before Flop (didn't bet)
Seat 3: lxIzoHy0RnkfFSODHC2liw (button) collected ($1.25)
Seat 4: 2igtJLmvIZ+HqX4XPgMPZA (small blind) folded before Flop
Seat 5: IBNygaT1aa9Z1uPdJJilwA (big blind) folded before Flop
Seat 6: M1KyQQvVPVuxqTAB8sR/zQ folded before Flop (didn't bet)



PokerStars Game #59941006202:  Hold'em No Limit ($0.25/$0.50) - 2009/07/01 1:22:57 ET
Table 'kgbJRsxfv64KrErDRBAkcw' 6-max Seat #1 is the button
Seat 1: VamsyhlFzXGF6/ydo0BHeA ($22.05 in chips)
Seat 2: AdS8BJMOheS01zjCDfPMFg ($65.50 in chips)
Seat 3: c4MNIaIyPMOMxrgT8FT5nA ($223.70 in chips)
Seat 4: 2igtJLmvIZ+HqX4XPgMPZA ($50 in chips)
Seat 5: eUBBn2R56C1IQ6Cs/vitwg ($50 in chips)
Seat 6: 1b+2BbjMN8qhR1WPqdE9VQ ($59.65 in chips)
AdS8BJMOheS01zjCDfPMFg: posts small blind $0.25
c4MNIaIyPMOMxrgT8FT5nA: posts big blind $0.50
*** HOLE CARDS ***
2igtJLmvIZ+HqX4XPgMPZA: folds
eUBBn2R56C1IQ6Cs/vitwg: raises $1.50 to $2
1b+2BbjMN8qhR1WPqdE9VQ: folds
VamsyhlFzXGF6/ydo0BHeA: folds
AdS8BJMOheS01zjCDfPMFg: folds
c4MNIaIyPMOMxrgT8FT5nA: calls $1.50
*** FLOP *** [Th Jh 5c]
c4MNIaIyPMOMxrgT8FT5nA: checks
eUBBn2R56C1IQ6Cs/vitwg: bets $3
c4MNIaIyPMOMxrgT8FT5nA: calls $3
*** TURN *** [Th Jh 5c] [2c]
c4MNIaIyPMOMxrgT8FT5nA: checks
eUBBn2R56C1IQ6Cs/vitwg: checks
*** RIVER *** [Th Jh 5c 2c] [8d]
c4MNIaIyPMOMxrgT8FT5nA: bets $4.50
eUBBn2R56C1IQ6Cs/vitwg: folds
c4MNIaIyPMOMxrgT8FT5nA collected $9.75 from pot
*** SUMMARY ***
Total pot $10.25 | Rake $0.50
Board [Th Jh 5c 2c 8d]
Seat 1: VamsyhlFzXGF6/ydo0BHeA (button) folded before Flop (didn't bet)
Seat 2: AdS8BJMOheS01zjCDfPMFg (small blind) folded before Flop
Seat 3: c4MNIaIyPMOMxrgT8FT5nA (big blind) collected ($9.75)
Seat 4: 2igtJLmvIZ+HqX4XPgMPZA folded before Flop (didn't bet)
Seat 5: eUBBn2R56C1IQ6Cs/vitwg folded on the River
Seat 6: 1b+2BbjMN8qhR1WPqdE9VQ folded before Flop (didn't bet)



PokerStars Game #59941005952:  Hold'em No Limit ($0.25/$0.50) - 2009/07/01 1:22:57 ET
Table 'Nz0Vr7WMHL2g5Uk7dDZjpw' 9-max Seat #9 is the button
Seat 3: hoglu9inkgs6zN573/bJag ($6.20 in chips)
Seat 4: E2518gp4aFz1+kAgmGqeEg ($13 in chips)
Seat 5: WGW0DgjBUXs1ylURHG8vnQ ($13 in chips)
Seat 6: 997ViqAtWn1FPjJqcffwcA ($58.05 in chips)
Seat 7: KPLH0gELgFe2OuAnhJFI5w ($26.20 in chips)
Seat 8: aoL+R/61Kxmw69ypuPrWAQ ($28.30 in chips)
Seat 9: mSD1pginDsyHG5PDfqzphw ($10 in chips)
SegjDnMxWMujiD57ESNL+g will be allowed to play after the button
hoglu9inkgs6zN573/bJag: posts small blind $0.25
E2518gp4aFz1+kAgmGqeEg: posts big blind $0.50
*** HOLE CARDS ***
WGW0DgjBUXs1ylURHG8vnQ: folds
997ViqAtWn1FPjJqcffwcA: folds
KPLH0gELgFe2OuAnhJFI5w: folds
aoL+R/61Kxmw69ypuPrWAQ: calls $0.50
mSD1pginDsyHG5PDfqzphw: folds
hoglu9inkgs6zN573/bJag: calls $0.25
E2518gp4aFz1+kAgmGqeEg: checks
*** FLOP *** [Qs 5s 4h]
hoglu9inkgs6zN573/bJag: checks
E2518gp4aFz1+kAgmGqeEg: checks
Tactoad leaves the table
aoL+R/61Kxmw69ypuPrWAQ: bets $1.50
hoglu9inkgs6zN573/bJag: folds
E2518gp4aFz1+kAgmGqeEg: folds
aoL+R/61Kxmw69ypuPrWAQ collected $1.45 from pot
*** SUMMARY ***
Total pot $1.50 | Rake $0.05
Board [Qs 5s 4h]
Seat 3: hoglu9inkgs6zN573/bJag (small blind) folded on the Flop
Seat 4: E2518gp4aFz1+kAgmGqeEg (big blind) folded on the Flop
Seat 5: WGW0DgjBUXs1ylURHG8vnQ folded before Flop (didn't bet)
Seat 6: 997ViqAtWn1FPjJqcffwcA folded before Flop (didn't bet)
Seat 7: KPLH0gELgFe2OuAnhJFI5w folded before Flop (didn't bet)
Seat 8: aoL+R/61Kxmw69ypuPrWAQ collected ($1.45)
Seat 9: mSD1pginDsyHG5PDfqzphw (button) folded before Flop (didn't bet)



PokerStars Game #59941007274:  Hold'em No Limit ($0.25/$0.50) - 2009/07/01 1:22:59 ET
Table 'NCiXr0d5CEKBQr/cZgLhbA' 9-max Seat #5 is the button
Seat 1: pFtzb1sR4b0d1aw6aIRgDg ($55.70 in chips)
Seat 2: AjV5McH1KMMclY26QdLM5w ($25 in chips)
Seat 3: xZCXQSXlrZkp3pZizzVXCw ($94.45 in chips)
Seat 4: 5k9fvXD9suIgCxU4HLQjTw ($53.95 in chips)
Seat 5: Ja2jdidjip2UeJnRzmzAAQ ($49.25 in chips)
Seat 6: t1qL+wRXOwTLB4TBbcw2QA ($49.50 in chips)
Seat 7: dXhO5i7KOoVcsGqbklD+jw ($30 in chips)
Seat 8: 1MJUKc3cc0QmUoz1JZLR2w ($63.95 in chips)
Seat 9: 4WLZvqBn5qv5tds5kt5A1Q ($54.75 in chips)
t1qL+wRXOwTLB4TBbcw2QA: posts small blind $0.25
dXhO5i7KOoVcsGqbklD+jw: posts big blind $0.50
*** HOLE CARDS ***
1MJUKc3cc0QmUoz1JZLR2w: folds
4WLZvqBn5qv5tds5kt5A1Q: calls $0.50
pFtzb1sR4b0d1aw6aIRgDg: folds
AjV5McH1KMMclY26QdLM5w: folds
xZCXQSXlrZkp3pZizzVXCw: folds
5k9fvXD9suIgCxU4HLQjTw: folds
Ja2jdidjip2UeJnRzmzAAQ: raises $1.50 to $2
t1qL+wRXOwTLB4TBbcw2QA: folds
dXhO5i7KOoVcsGqbklD+jw: folds
4WLZvqBn5qv5tds5kt5A1Q: calls $1.50
*** FLOP *** [3h 7c 2h]
4WLZvqBn5qv5tds5kt5A1Q: bets $3
Ja2jdidjip2UeJnRzmzAAQ: calls $3
*** TURN *** [3h 7c 2h] [Jd]
4WLZvqBn5qv5tds5kt5A1Q: bets $3.50
Ja2jdidjip2UeJnRzmzAAQ: calls $3.50
*** RIVER *** [3h 7c 2h Jd] [4d]
4WLZvqBn5qv5tds5kt5A1Q: bets $6.50
Ja2jdidjip2UeJnRzmzAAQ: calls $6.50
*** SHOW DOWN ***
4WLZvqBn5qv5tds5kt5A1Q: shows [Js Ts] (a pair of Jacks)
Ja2jdidjip2UeJnRzmzAAQ: mucks hand
4WLZvqBn5qv5tds5kt5A1Q collected $29.30 from pot
*** SUMMARY ***
Total pot $30.75 | Rake $1.45
Board [3h 7c 2h Jd 4d]
Seat 1: pFtzb1sR4b0d1aw6aIRgDg folded before Flop (didn't bet)
Seat 2: AjV5McH1KMMclY26QdLM5w folded before Flop (didn't bet)
Seat 3: xZCXQSXlrZkp3pZizzVXCw folded before Flop (didn't bet)
Seat 4: 5k9fvXD9suIgCxU4HLQjTw folded before Flop (didn't bet)
Seat 5: Ja2jdidjip2UeJnRzmzAAQ (button) mucked
Seat 6: t1qL+wRXOwTLB4TBbcw2QA (small blind) folded before Flop
Seat 7: dXhO5i7KOoVcsGqbklD+jw (big blind) folded before Flop
Seat 8: 1MJUKc3cc0QmUoz1JZLR2w folded before Flop (didn't bet)
Seat 9: 4WLZvqBn5qv5tds5kt5A1Q showed [Js Ts] and won ($29.30) with a pair of Jacks



PokerStars Game #59941007710:  Hold'em No Limit ($0.25/$0.50) - 2009/07/01 1:23:00 ET
Table 'GfL/No5u5PoEnU39lP5pQg' 6-max Seat #3 is the button
Seat 1: 1WUCqNG+p+vfWRTXNu4ljw ($66 in chips)
Seat 2: uVwggSetzp7d+eVgowO3vg ($48.10 in chips)
Seat 3: 4pp9WxhGdbVbxCc9tlu0lw ($36.45 in chips)
Seat 4: r6u7MWSXF30/khcTYkrG9Q ($26.50 in chips)
Seat 5: M1KyQQvVPVuxqTAB8sR/zQ ($50 in chips)
Seat 6: kxPhs4ePFqMy52CInAJ2aw ($62.45 in chips)
r6u7MWSXF30/khcTYkrG9Q: posts small blind $0.25
M1KyQQvVPVuxqTAB8sR/zQ: posts big blind $0.50
*** HOLE CARDS ***
kxPhs4ePFqMy52CInAJ2aw: folds
1WUCqNG+p+vfWRTXNu4ljw: folds
uVwggSetzp7d+eVgowO3vg: raises $1.25 to $1.75
4pp9WxhGdbVbxCc9tlu0lw: folds
r6u7MWSXF30/khcTYkrG9Q: folds
M1KyQQvVPVuxqTAB8sR/zQ: folds
uVwggSetzp7d+eVgowO3vg collected $1.25 from pot
*** SUMMARY ***
Total pot $1.25 | Rake $0
Seat 1: 1WUCqNG+p+vfWRTXNu4ljw folded before Flop (didn't bet)
Seat 2: uVwggSetzp7d+eVgowO3vg collected ($1.25)
Seat 3: 4pp9WxhGdbVbxCc9tlu0lw (button) folded before Flop (didn't bet)
Seat 4: r6u7MWSXF30/khcTYkrG9Q (small blind) folded before Flop
Seat 5: M1KyQQvVPVuxqTAB8sR/zQ (big blind) folded before Flop
Seat 6: kxPhs4ePFqMy52CInAJ2aw folded before Flop (didn't bet)



PokerStars Game #59941007704:  Hold'em No Limit ($0.25/$0.50) - 2009/07/01 1:23:00 ET
Table 'ofnd8S4IdIPph1Cbn+x7hA' 2-max Seat #2 is the button
Seat 1: PY4NvRocCFPfSIHKbh0euQ ($26.85 in chips)
Seat 2: l5WbyJ/iWYjpeCC6GCYY6w ($66.75 in chips)
l5WbyJ/iWYjpeCC6GCYY6w: posts small blind $0.25
PY4NvRocCFPfSIHKbh0euQ: posts big blind $0.50
*** HOLE CARDS ***
l5WbyJ/iWYjpeCC6GCYY6w: calls $0.25
PY4NvRocCFPfSIHKbh0euQ: checks
*** FLOP *** [2c Ad 4c]
PY4NvRocCFPfSIHKbh0euQ: bets $0.50
l5WbyJ/iWYjpeCC6GCYY6w: calls $0.50
*** TURN *** [2c Ad 4c] [9d]
PY4NvRocCFPfSIHKbh0euQ: bets $0.50
l5WbyJ/iWYjpeCC6GCYY6w: calls $0.50
*** RIVER *** [2c Ad 4c 9d] [6s]
PY4NvRocCFPfSIHKbh0euQ: bets $0.50
l5WbyJ/iWYjpeCC6GCYY6w: calls $0.50
*** SHOW DOWN ***
PY4NvRocCFPfSIHKbh0euQ: shows [Kc 4s] (a pair of Fours)
l5WbyJ/iWYjpeCC6GCYY6w: mucks hand
PY4NvRocCFPfSIHKbh0euQ collected $3.85 from pot
*** SUMMARY ***
Total pot $4 | Rake $0.15
Board [2c Ad 4c 9d 6s]
Seat 1: PY4NvRocCFPfSIHKbh0euQ (big blind) showed [Kc 4s] and won ($3.85) with a pair of Fours
Seat 2: l5WbyJ/iWYjpeCC6GCYY6w (button) (small blind) mucked



PokerStars Game #59941008102:  Hold'em No Limit ($0.25/$0.50) - 2009/07/01 1:23:01 ET
Table 'c/CRn+68J3Y8KxD5g1ek2Q' 2-max Seat #1 is the button
Seat 1: 46qCyJ6evTkHo9al5sBMNA ($102.90 in chips)
Seat 2: BypVLsYQt3ePFm2xQL/dOA ($257.35 in chips)
46qCyJ6evTkHo9al5sBMNA: posts small blind $0.25
BypVLsYQt3ePFm2xQL/dOA: posts big blind $0.50
*** HOLE CARDS ***
46qCyJ6evTkHo9al5sBMNA: raises $1 to $1.50
BypVLsYQt3ePFm2xQL/dOA: calls $1
*** FLOP *** [4s Qc 2d]
BypVLsYQt3ePFm2xQL/dOA: checks
46qCyJ6evTkHo9al5sBMNA: checks
*** TURN *** [4s Qc 2d] [Tc]
BypVLsYQt3ePFm2xQL/dOA: bets $1.50
46qCyJ6evTkHo9al5sBMNA: calls $1.50
*** RIVER *** [4s Qc 2d Tc] [2s]
BypVLsYQt3ePFm2xQL/dOA: checks
46qCyJ6evTkHo9al5sBMNA: checks
*** SHOW DOWN ***
BypVLsYQt3ePFm2xQL/dOA: shows [5d 5s] (two pair, Fives and Deuces)
46qCyJ6evTkHo9al5sBMNA: mucks hand
BypVLsYQt3ePFm2xQL/dOA collected $5.75 from pot
*** SUMMARY ***
Total pot $6 | Rake $0.25
Board [4s Qc 2d Tc 2s]
Seat 1: 46qCyJ6evTkHo9al5sBMNA (button) (small blind) mucked
Seat 2: BypVLsYQt3ePFm2xQL/dOA (big blind) showed [5d 5s] and won ($5.75) with two pair, Fives and Deuces



PokerStars Game #59941009374:  Hold'em No Limit ($0.25/$0.50) - 2009/07/01 1:23:03 ET
Table 'EiNh8p/wGJ1FP575iMFnqg' 9-max Seat #8 is the button
Seat 1: YFFlOZgyy1Mh4iBmuNRbmQ ($25 in chips)
Seat 2: 8ehL7qlZzjgUh2H35iiWLw ($58.90 in chips)
Seat 3: ymLPoEIl7UL3TvZYmnadxQ ($60.10 in chips)
Seat 4: cMzaiXAM/ZAdNaEUu+LqhA ($50 in chips)
Seat 5: M+7+BTmX5vZatHVuoRB1nA ($74.45 in chips)
Seat 6: viwBDtJsY6JfsFOdBAyJIQ ($9.45 in chips)
Seat 7: 997ViqAtWn1FPjJqcffwcA ($50 in chips)
Seat 8: mSD1pginDsyHG5PDfqzphw ($10 in chips)
Seat 9: GuPkZObrz5Zkkn8FsEdF9w ($34.80 in chips)
GuPkZObrz5Zkkn8FsEdF9w: posts small blind $0.25
YFFlOZgyy1Mh4iBmuNRbmQ: posts big blind $0.50
*** HOLE CARDS ***
8ehL7qlZzjgUh2H35iiWLw: folds
ymLPoEIl7UL3TvZYmnadxQ: folds
cMzaiXAM/ZAdNaEUu+LqhA: folds
M+7+BTmX5vZatHVuoRB1nA: folds
viwBDtJsY6JfsFOdBAyJIQ: folds
997ViqAtWn1FPjJqcffwcA: folds
mSD1pginDsyHG5PDfqzphw: raises $1 to $1.50
GuPkZObrz5Zkkn8FsEdF9w: calls $1.25
YFFlOZgyy1Mh4iBmuNRbmQ: calls $1
*** FLOP *** [3c Qd 9s]
GuPkZObrz5Zkkn8FsEdF9w: bets $2
YFFlOZgyy1Mh4iBmuNRbmQ: folds
mSD1pginDsyHG5PDfqzphw: folds
GuPkZObrz5Zkkn8FsEdF9w collected $4.30 from pot
GuPkZObrz5Zkkn8FsEdF9w: doesn't show hand
*** SUMMARY ***
Total pot $4.50 | Rake $0.20
Board [3c Qd 9s]
Seat 1: YFFlOZgyy1Mh4iBmuNRbmQ (big blind) folded on the Flop
Seat 2: 8ehL7qlZzjgUh2H35iiWLw folded before Flop (didn't bet)
Seat 3: ymLPoEIl7UL3TvZYmnadxQ folded before Flop (didn't bet)
Seat 4: cMzaiXAM/ZAdNaEUu+LqhA folded before Flop (didn't bet)
Seat 5: M+7+BTmX5vZatHVuoRB1nA folded before Flop (didn't bet)
Seat 6: viwBDtJsY6JfsFOdBAyJIQ folded before Flop (didn't bet)
Seat 7: 997ViqAtWn1FPjJqcffwcA folded before Flop (didn't bet)
Seat 8: mSD1pginDsyHG5PDfqzphw (button) folded on the Flop
Seat 9: GuPkZObrz5Zkkn8FsEdF9w (small blind) collected ($4.30)



PokerStars Game #59941010010:  Hold'em No Limit ($0.25/$0.50) - 2009/07/01 1:23:04 ET
Table '8BQGgNetI1NOvWeu3gtMNw' 2-max Seat #1 is the button
Seat 1: bypIyrYcAAifLfhZpGlKLA ($65.95 in chips)
Seat 2: Z4HwehErEwzsv/noQlfUlg ($123.25 in chips)
bypIyrYcAAifLfhZpGlKLA: posts small blind $0.25
Z4HwehErEwzsv/noQlfUlg: posts big blind $0.50
*** HOLE CARDS ***
bypIyrYcAAifLfhZpGlKLA: folds
Z4HwehErEwzsv/noQlfUlg collected $0.50 from pot
Z4HwehErEwzsv/noQlfUlg: doesn't show hand
*** SUMMARY ***
Total pot $0.50 | Rake $0
Seat 1: bypIyrYcAAifLfhZpGlKLA (button) (small blind) folded before Flop
Seat 2: Z4HwehErEwzsv/noQlfUlg (big blind) collected ($0.50)



PokerStars Game #59941010054:  Hold'em No Limit ($0.25/$0.50) - 2009/07/01 1:23:04 ET
Table 'otvGDROEDdqsabxskT79qg' 9-max Seat #5 is the button
Seat 1: 8ehL7qlZzjgUh2H35iiWLw ($62 in chips)
Seat 2: cCjTzH9jio8607WzjcfXlg ($10.65 in chips)
Seat 3: +k7T5ocke8UwavtgUHm+Cg ($73.75 in chips)
Seat 4: MG90wfSJZnOejs/KD3vlQQ ($80.65 in chips)
Seat 5: E2518gp4aFz1+kAgmGqeEg ($12.20 in chips)
Seat 8: zE9cVigS2nW/Ljy4K4bUQA ($32.80 in chips)
Seat 9: KcY3X8YpD74Kw1RHkx/g4A ($31.65 in chips)
FFVKBJT0lZf+jFlgvy7ang will be allowed to play after the button
zE9cVigS2nW/Ljy4K4bUQA: posts small blind $0.25
KcY3X8YpD74Kw1RHkx/g4A: posts big blind $0.50
*** HOLE CARDS ***
8ehL7qlZzjgUh2H35iiWLw: folds
cCjTzH9jio8607WzjcfXlg: folds
+k7T5ocke8UwavtgUHm+Cg: folds
MG90wfSJZnOejs/KD3vlQQ: folds
E2518gp4aFz1+kAgmGqeEg: folds
zE9cVigS2nW/Ljy4K4bUQA: raises $0.50 to $1
KcY3X8YpD74Kw1RHkx/g4A: folds
zE9cVigS2nW/Ljy4K4bUQA collected $1 from pot
zE9cVigS2nW/Ljy4K4bUQA: doesn't show hand
*** SUMMARY ***
Total pot $1 | Rake $0
Seat 1: 8ehL7qlZzjgUh2H35iiWLw folded before Flop (didn't bet)
Seat 2: cCjTzH9jio8607WzjcfXlg folded before Flop (didn't bet)
Seat 3: +k7T5ocke8UwavtgUHm+Cg folded before Flop (didn't bet)
Seat 4: MG90wfSJZnOejs/KD3vlQQ folded before Flop (didn't bet)
Seat 5: E2518gp4aFz1+kAgmGqeEg (button) folded before Flop (didn't bet)
Seat 8: zE9cVigS2nW/Ljy4K4bUQA (small blind) collected ($1)
Seat 9: KcY3X8YpD74Kw1RHkx/g4A (big blind) folded before Flop



PokerStars Game #59941010576:  Hold'em No Limit ($0.25/$0.50) - 2009/07/01 1:23:05 ET
Table '+dXkOAQyS8j9PQZusUTMpg' 2-max Seat #1 is the button
Seat 1: Teld4PDKla7C8/Wfu2DSkg ($45.80 in chips)
Seat 2: +zI4bP23YIjMkUHqeN2xfw ($32.65 in chips)
Teld4PDKla7C8/Wfu2DSkg: posts small blind $0.25
+zI4bP23YIjMkUHqeN2xfw: posts big blind $0.50
*** HOLE CARDS ***
Teld4PDKla7C8/Wfu2DSkg: folds
+zI4bP23YIjMkUHqeN2xfw collected $0.50 from pot
*** SUMMARY ***
Total pot $0.50 | Rake $0
Seat 1: Teld4PDKla7C8/Wfu2DSkg (button) (small blind) folded before Flop
Seat 2: +zI4bP23YIjMkUHqeN2xfw (big blind) collected ($0.50)



PokerStars Game #59941013722:  Hold'em No Limit ($0.25/$0.50) - 2009/07/01 1:23:10 ET
Table '+dXkOAQyS8j9PQZusUTMpg' 2-max Seat #2 is the button
Seat 1: Teld4PDKla7C8/Wfu2DSkg ($45.55 in chips)
Seat 2: +zI4bP23YIjMkUHqeN2xfw ($32.90 in chips)
+zI4bP23YIjMkUHqeN2xfw: posts small blind $0.25
Teld4PDKla7C8/Wfu2DSkg: posts big blind $0.50
*** HOLE CARDS ***
+zI4bP23YIjMkUHqeN2xfw: folds
Teld4PDKla7C8/Wfu2DSkg collected $0.50 from pot
Teld4PDKla7C8/Wfu2DSkg: doesn't show hand
*** SUMMARY ***
Total pot $0.50 | Rake $0
Seat 1: Teld4PDKla7C8/Wfu2DSkg (big blind) collected ($0.50)
Seat 2: +zI4bP23YIjMkUHqeN2xfw (button) (small blind) folded before Flop



PokerStars Game #59941013596:  Hold'em No Limit ($0.25/$0.50) - 2009/07/01 1:23:10 ET
Table '8BQGgNetI1NOvWeu3gtMNw' 2-max Seat #2 is the button
Seat 1: bypIyrYcAAifLfhZpGlKLA ($65.70 in chips)
Seat 2: Z4HwehErEwzsv/noQlfUlg ($123.50 in chips)
Z4HwehErEwzsv/noQlfUlg: posts small blind $0.25
bypIyrYcAAifLfhZpGlKLA: posts big blind $0.50
*** HOLE CARDS ***
Z4HwehErEwzsv/noQlfUlg: calls $0.25
bypIyrYcAAifLfhZpGlKLA: raises $1.50 to $2
Z4HwehErEwzsv/noQlfUlg: calls $1.50
*** FLOP *** [As 5s Td]
bypIyrYcAAifLfhZpGlKLA: bets $3
Z4HwehErEwzsv/noQlfUlg: folds
bypIyrYcAAifLfhZpGlKLA collected $3.80 from pot
bypIyrYcAAifLfhZpGlKLA: doesn't show hand
*** SUMMARY ***
Total pot $4 | Rake $0.20
Board [As 5s Td]
Seat 1: bypIyrYcAAifLfhZpGlKLA (big blind) collected ($3.80)
Seat 2: Z4HwehErEwzsv/noQlfUlg (button) (small blind) folded on the Flop



PokerStars Game #59941013450:  Hold'em No Limit ($0.25/$0.50) - 2009/07/01 1:23:10 ET
Table 'X6IRCRTh+20gjz8aubWnwA' 9-max Seat #3 is the button
Seat 1: E2518gp4aFz1+kAgmGqeEg ($10.25 in chips)
Seat 2: HZkVla4kK2SI42CVrPZ/ig ($3 in chips)
Seat 3: SWv01peOe69QQRvhQTqjQw ($13.30 in chips)
Seat 4: M3JFBNQ8Bbw3FBZ/18MuXw ($23.65 in chips)
Seat 5: uw9QayAAxLM3Hb+HR7mSkg ($10 in chips)
Seat 6: 75K2MXwN65Sjfp1yHd50Hg ($14.25 in chips)
Seat 7: cFHQjKQOOKTUzoilhrXHLg ($14 in chips)
Seat 8: HxeBVq06/3Bh/H986sgdbw ($47 in chips)
Seat 9: M+7+BTmX5vZatHVuoRB1nA ($44.80 in chips)
M3JFBNQ8Bbw3FBZ/18MuXw: posts small blind $0.25
uw9QayAAxLM3Hb+HR7mSkg: posts big blind $0.50
*** HOLE CARDS ***
75K2MXwN65Sjfp1yHd50Hg: folds
75K2MXwN65Sjfp1yHd50Hg leaves the table
cFHQjKQOOKTUzoilhrXHLg: calls $0.50
HxeBVq06/3Bh/H986sgdbw: folds
M+7+BTmX5vZatHVuoRB1nA: folds
E2518gp4aFz1+kAgmGqeEg: folds
HZkVla4kK2SI42CVrPZ/ig: folds
Qi/PyOsKwaqtKIg0H+7ELg joins the table at seat #6
SWv01peOe69QQRvhQTqjQw: folds
M3JFBNQ8Bbw3FBZ/18MuXw: calls $0.25
uw9QayAAxLM3Hb+HR7mSkg: raises $9.50 to $10 and is all-in
cFHQjKQOOKTUzoilhrXHLg: raises $4 to $14 and is all-in
M3JFBNQ8Bbw3FBZ/18MuXw: folds
*** FLOP *** [Td Kd Jh]
*** TURN *** [Td Kd Jh] [Th]
*** RIVER *** [Td Kd Jh Th] [6d]
*** SHOW DOWN ***
uw9QayAAxLM3Hb+HR7mSkg: shows [Ah Qs] (a straight, Ten to Ace)
cFHQjKQOOKTUzoilhrXHLg: shows [Qc As] (a straight, Ten to Ace)
uw9QayAAxLM3Hb+HR7mSkg collected $9.75 from pot
cFHQjKQOOKTUzoilhrXHLg collected $9.75 from pot
*** SUMMARY ***
Total pot $20.50 | Rake $1
Board [Td Kd Jh Th 6d]
Seat 1: E2518gp4aFz1+kAgmGqeEg folded before Flop (didn't bet)
Seat 2: HZkVla4kK2SI42CVrPZ/ig folded before Flop (didn't bet)
Seat 3: SWv01peOe69QQRvhQTqjQw (button) folded before Flop (didn't bet)
Seat 4: M3JFBNQ8Bbw3FBZ/18MuXw (small blind) folded before Flop
Seat 5: uw9QayAAxLM3Hb+HR7mSkg (big blind) showed [Ah Qs] and won ($9.75) with a straight, Ten to Ace
Seat 6: 75K2MXwN65Sjfp1yHd50Hg folded before Flop (didn't bet)
Seat 7: cFHQjKQOOKTUzoilhrXHLg showed [Qc As] and won ($9.75) with a straight, Ten to Ace
Seat 8: HxeBVq06/3Bh/H986sgdbw folded before Flop (didn't bet)
Seat 9: M+7+BTmX5vZatHVuoRB1nA folded before Flop (didn't bet)



PokerStars Game #59941017088:  Hold'em No Limit ($0.25/$0.50) - 2009/07/01 1:23:16 ET
Table '+dXkOAQyS8j9PQZusUTMpg' 2-max Seat #1 is the button
Seat 1: Teld4PDKla7C8/Wfu2DSkg ($45.80 in chips)
Seat 2: +zI4bP23YIjMkUHqeN2xfw ($32.65 in chips)
Teld4PDKla7C8/Wfu2DSkg: posts small blind $0.25
+zI4bP23YIjMkUHqeN2xfw: posts big blind $0.50
*** HOLE CARDS ***
Teld4PDKla7C8/Wfu2DSkg: raises $1 to $1.50
+zI4bP23YIjMkUHqeN2xfw: calls $1
*** FLOP *** [Jd 2d 6c]
+zI4bP23YIjMkUHqeN2xfw: checks
Teld4PDKla7C8/Wfu2DSkg: checks
*** TURN *** [Jd 2d 6c] [6s]
+zI4bP23YIjMkUHqeN2xfw: checks
Teld4PDKla7C8/Wfu2DSkg: checks
*** RIVER *** [Jd 2d 6c 6s] [7s]
+zI4bP23YIjMkUHqeN2xfw: checks
Teld4PDKla7C8/Wfu2DSkg: checks
*** SHOW DOWN ***
+zI4bP23YIjMkUHqeN2xfw: shows [9d Qh] (a pair of Sixes)
Teld4PDKla7C8/Wfu2DSkg: shows [Tc Ac] (a pair of Sixes - Ace kicker)
Teld4PDKla7C8/Wfu2DSkg collected $2.85 from pot
*** SUMMARY ***
Total pot $3 | Rake $0.15
Board [Jd 2d 6c 6s 7s]
Seat 1: Teld4PDKla7C8/Wfu2DSkg (button) (small blind) showed [Tc Ac] and won ($2.85) with a pair of Sixes
Seat 2: +zI4bP23YIjMkUHqeN2xfw (big blind) showed [9d Qh] and lost with a pair of Sixes



PokerStars Game #59941019644:  Hold'em No Limit ($0.25/$0.50) - 2009/07/01 1:23:20 ET
Table 'ofnd8S4IdIPph1Cbn+x7hA' 2-max Seat #1 is the button
Seat 1: PY4NvRocCFPfSIHKbh0euQ ($28.70 in chips)
Seat 2: l5WbyJ/iWYjpeCC6GCYY6w ($64.75 in chips)
PY4NvRocCFPfSIHKbh0euQ: posts small blind $0.25
l5WbyJ/iWYjpeCC6GCYY6w: posts big blind $0.50
*** HOLE CARDS ***
PY4NvRocCFPfSIHKbh0euQ: folds
l5WbyJ/iWYjpeCC6GCYY6w collected $0.50 from pot
l5WbyJ/iWYjpeCC6GCYY6w: doesn't show hand
*** SUMMARY ***
Total pot $0.50 | Rake $0
Seat 1: PY4NvRocCFPfSIHKbh0euQ (button) (small blind) folded before Flop
Seat 2: l5WbyJ/iWYjpeCC6GCYY6w (big blind) collected ($0.50)



PokerStars Game #59941020282:  Hold'em No Limit ($0.25/$0.50) - 2009/07/01 1:23:21 ET
Table 'lSisgp6H7Fg1hH5VfjEjYQ' 9-max Seat #6 is the button
Seat 1: 5k9fvXD9suIgCxU4HLQjTw ($55.85 in chips)
Seat 3: SKnJuWHScqetA/qG5p+wCg ($30 in chips)
Seat 4: bwv/rbH/hHhPhY6u9mu04w ($36.15 in chips)
Seat 5: mSD1pginDsyHG5PDfqzphw ($12.25 in chips)
Seat 6: +k7T5ocke8UwavtgUHm+Cg ($63.40 in chips)
Seat 7: IDtNLR9uFCDdjNsJWMHA5Q ($27.90 in chips)
Seat 8: a4JDWmpFQkL10XfAyuF51A ($13 in chips)
Seat 9: YzeKFbJVLmJGTgNH3ySQlw ($7 in chips)
IDtNLR9uFCDdjNsJWMHA5Q: posts small blind $0.25
a4JDWmpFQkL10XfAyuF51A: posts big blind $0.50
*** HOLE CARDS ***
YzeKFbJVLmJGTgNH3ySQlw: folds
5k9fvXD9suIgCxU4HLQjTw: folds
SKnJuWHScqetA/qG5p+wCg: folds
bwv/rbH/hHhPhY6u9mu04w: folds
mSD1pginDsyHG5PDfqzphw: raises $1 to $1.50
+k7T5ocke8UwavtgUHm+Cg: folds
IDtNLR9uFCDdjNsJWMHA5Q: folds
a4JDWmpFQkL10XfAyuF51A: folds
mSD1pginDsyHG5PDfqzphw collected $1.25 from pot
mSD1pginDsyHG5PDfqzphw: doesn't show hand
*** SUMMARY ***
Total pot $1.25 | Rake $0
Seat 1: 5k9fvXD9suIgCxU4HLQjTw folded before Flop (didn't bet)
Seat 3: SKnJuWHScqetA/qG5p+wCg folded before Flop (didn't bet)
Seat 4: bwv/rbH/hHhPhY6u9mu04w folded before Flop (didn't bet)
Seat 5: mSD1pginDsyHG5PDfqzphw collected ($1.25)
Seat 6: +k7T5ocke8UwavtgUHm+Cg (button) folded before Flop (didn't bet)
Seat 7: IDtNLR9uFCDdjNsJWMHA5Q (small blind) folded before Flop
Seat 8: a4JDWmpFQkL10XfAyuF51A (big blind) folded before Flop
Seat 9: YzeKFbJVLmJGTgNH3ySQlw folded before Flop (didn't bet)



PokerStars Game #59941019796:  Hold'em No Limit ($0.25/$0.50) - 2009/07/01 1:23:21 ET
Table '3FhG0gl3kMX3wBEEqj+wnQ' 9-max Seat #8 is the button
Seat 1: bxLSulbgr8LmKNjOzw8URg ($50.05 in chips)
Seat 2: vacmVLJJECYI6HjAynFcpg ($52.10 in chips)
Seat 3: YXCE3WOZi8g2sIf3y/plVw ($50 in chips)
Seat 4: e2+sK/yjnj94rXOKoxPP2A ($71.75 in chips)
Seat 5: XcLXSUMHSpshK/7Lh0M4Vg ($10 in chips)
Seat 6: 997ViqAtWn1FPjJqcffwcA ($110.55 in chips)
Seat 7: mSD1pginDsyHG5PDfqzphw ($11.50 in chips)
Seat 8: j3K/Jujr7PY4ZM2RZvlH6A ($46.65 in chips)
Seat 9: KA0tkubTlbhmo4ju+qgXPg ($45.35 in chips)
KA0tkubTlbhmo4ju+qgXPg: posts small blind $0.25
bxLSulbgr8LmKNjOzw8URg: posts big blind $0.50
*** HOLE CARDS ***
vacmVLJJECYI6HjAynFcpg: folds
YXCE3WOZi8g2sIf3y/plVw: folds
e2+sK/yjnj94rXOKoxPP2A: raises $1 to $1.50
XcLXSUMHSpshK/7Lh0M4Vg: folds
997ViqAtWn1FPjJqcffwcA: folds
mSD1pginDsyHG5PDfqzphw: raises $2.50 to $4
j3K/Jujr7PY4ZM2RZvlH6A: folds
KA0tkubTlbhmo4ju+qgXPg: folds
bxLSulbgr8LmKNjOzw8URg: folds
e2+sK/yjnj94rXOKoxPP2A: folds
mSD1pginDsyHG5PDfqzphw collected $3.75 from pot
mSD1pginDsyHG5PDfqzphw: doesn't show hand
*** SUMMARY ***
Total pot $3.75 | Rake $0
Seat 1: bxLSulbgr8LmKNjOzw8URg (big blind) folded before Flop
Seat 2: vacmVLJJECYI6HjAynFcpg folded before Flop (didn't bet)
Seat 3: YXCE3WOZi8g2sIf3y/plVw folded before Flop (didn't bet)
Seat 4: e2+sK/yjnj94rXOKoxPP2A folded before Flop
Seat 5: XcLXSUMHSpshK/7Lh0M4Vg folded before Flop (didn't bet)
Seat 6: 997ViqAtWn1FPjJqcffwcA folded before Flop (didn't bet)
Seat 7: mSD1pginDsyHG5PDfqzphw collected ($3.75)
Seat 8: j3K/Jujr7PY4ZM2RZvlH6A (button) folded before Flop (didn't bet)
Seat 9: KA0tkubTlbhmo4ju+qgXPg (small blind) folded before Flop



PokerStars Game #59941021590:  Hold'em No Limit ($0.25/$0.50) - 2009/07/01 1:23:24 ET
Table 'c/CRn+68J3Y8KxD5g1ek2Q' 2-max Seat #2 is the button
Seat 1: 46qCyJ6evTkHo9al5sBMNA ($99.90 in chips)
Seat 2: BypVLsYQt3ePFm2xQL/dOA ($260.10 in chips)
BypVLsYQt3ePFm2xQL/dOA: posts small blind $0.25
46qCyJ6evTkHo9al5sBMNA: posts big blind $0.50
*** HOLE CARDS ***
BypVLsYQt3ePFm2xQL/dOA: calls $0.25
46qCyJ6evTkHo9al5sBMNA: checks
*** FLOP *** [5d Kh Td]
46qCyJ6evTkHo9al5sBMNA: checks
BypVLsYQt3ePFm2xQL/dOA: checks
*** TURN *** [5d Kh Td] [6s]
46qCyJ6evTkHo9al5sBMNA: checks
BypVLsYQt3ePFm2xQL/dOA: checks
*** RIVER *** [5d Kh Td 6s] [5s]
46qCyJ6evTkHo9al5sBMNA: checks
BypVLsYQt3ePFm2xQL/dOA: bets $2.50
46qCyJ6evTkHo9al5sBMNA: folds
BypVLsYQt3ePFm2xQL/dOA collected $0.95 from pot
BypVLsYQt3ePFm2xQL/dOA: doesn't show hand
*** SUMMARY ***
Total pot $1 | Rake $0.05
Board [5d Kh Td 6s 5s]
Seat 1: 46qCyJ6evTkHo9al5sBMNA (big blind) folded on the River
Seat 2: BypVLsYQt3ePFm2xQL/dOA (button) (small blind) collected ($0.95)



PokerStars Game #59941022496:  Hold'em No Limit ($0.25/$0.50) - 2009/07/01 1:23:25 ET
Table 'hSTs/dUsYLgJQuF2Onp0MQ' 6-max Seat #4 is the button
Seat 1: 1WUCqNG+p+vfWRTXNu4ljw ($50 in chips)
Seat 3: lxIzoHy0RnkfFSODHC2liw ($50.75 in chips)
Seat 4: 2igtJLmvIZ+HqX4XPgMPZA ($80.15 in chips)
Seat 5: IBNygaT1aa9Z1uPdJJilwA ($38.75 in chips)
Seat 6: M1KyQQvVPVuxqTAB8sR/zQ ($87.45 in chips)
IBNygaT1aa9Z1uPdJJilwA: posts small blind $0.25
M1KyQQvVPVuxqTAB8sR/zQ: posts big blind $0.50
Hdd4js36ITbTJ/QuVYwTlA: sits out
*** HOLE CARDS ***
1WUCqNG+p+vfWRTXNu4ljw: folds
lxIzoHy0RnkfFSODHC2liw: raises $1 to $1.50
2igtJLmvIZ+HqX4XPgMPZA: folds
IBNygaT1aa9Z1uPdJJilwA: raises $2 to $3.50
M1KyQQvVPVuxqTAB8sR/zQ: folds
lxIzoHy0RnkfFSODHC2liw: calls $2
*** FLOP *** [2d 8s Ah]
IBNygaT1aa9Z1uPdJJilwA: bets $4
lxIzoHy0RnkfFSODHC2liw: calls $4
*** TURN *** [2d 8s Ah] [9d]
IBNygaT1aa9Z1uPdJJilwA: bets $8.50
lxIzoHy0RnkfFSODHC2liw: calls $8.50
*** RIVER *** [2d 8s Ah 9d] [9c]
IBNygaT1aa9Z1uPdJJilwA: bets $15.50
lxIzoHy0RnkfFSODHC2liw: folds
IBNygaT1aa9Z1uPdJJilwA collected $30.95 from pot
*** SUMMARY ***
Total pot $32.50 | Rake $1.55
Board [2d 8s Ah 9d 9c]
Seat 1: 1WUCqNG+p+vfWRTXNu4ljw folded before Flop (didn't bet)
Seat 3: lxIzoHy0RnkfFSODHC2liw folded on the River
Seat 4: 2igtJLmvIZ+HqX4XPgMPZA (button) folded before Flop (didn't bet)
Seat 5: IBNygaT1aa9Z1uPdJJilwA (small blind) collected ($30.95)
Seat 6: M1KyQQvVPVuxqTAB8sR/zQ (big blind) folded before Flop



PokerStars Game #59941022986:  Hold'em No Limit ($0.25/$0.50) - 2009/07/01 1:23:26 ET
Table 'ofnd8S4IdIPph1Cbn+x7hA' 2-max Seat #2 is the button
Seat 1: PY4NvRocCFPfSIHKbh0euQ ($28.45 in chips)
Seat 2: l5WbyJ/iWYjpeCC6GCYY6w ($65 in chips)
l5WbyJ/iWYjpeCC6GCYY6w: posts small blind $0.25
PY4NvRocCFPfSIHKbh0euQ: posts big blind $0.50
*** HOLE CARDS ***
l5WbyJ/iWYjpeCC6GCYY6w: folds
PY4NvRocCFPfSIHKbh0euQ collected $0.50 from pot
*** SUMMARY ***
Total pot $0.50 | Rake $0
Seat 1: PY4NvRocCFPfSIHKbh0euQ (big blind) collected ($0.50)
Seat 2: l5WbyJ/iWYjpeCC6GCYY6w (button) (small blind) folded before Flop



PokerStars Game #59941023724:  Hold'em No Limit ($0.25/$0.50) - 2009/07/01 1:23:27 ET
Table 'tyR5AZNKV8Aadbrnrnlg7g' 6-max Seat #4 is the button
Seat 1: BgOXYI0yYSN1ULC4FqsNkg ($96.05 in chips)
Seat 2: BAjwVL+zKKd0s0fAWstzQQ ($56.45 in chips)
Seat 3: JFLrYNyQmwPhRQAtoSAuyA ($44.50 in chips)
Seat 4: 4QfsCWthT/vSLirorNXqtg ($88.70 in chips)
Seat 5: GUnvMULl2qFOO1yenu1UBw ($50 in chips)
Seat 6: 498aWaGsW4uGfuWl+2FCGw ($46.55 in chips)
GUnvMULl2qFOO1yenu1UBw: posts small blind $0.25
498aWaGsW4uGfuWl+2FCGw: posts big blind $0.50
*** HOLE CARDS ***
BgOXYI0yYSN1ULC4FqsNkg: folds
BAjwVL+zKKd0s0fAWstzQQ: calls $0.50
JFLrYNyQmwPhRQAtoSAuyA: raises $1.50 to $2
4QfsCWthT/vSLirorNXqtg: calls $2
GUnvMULl2qFOO1yenu1UBw: raises $5 to $7
498aWaGsW4uGfuWl+2FCGw: raises $39.55 to $46.55 and is all-in
BAjwVL+zKKd0s0fAWstzQQ: raises $9.90 to $56.45 and is all-in
JFLrYNyQmwPhRQAtoSAuyA: folds
4QfsCWthT/vSLirorNXqtg: folds
GUnvMULl2qFOO1yenu1UBw: calls $43 and is all-in
*** FLOP *** [Ts 9c 9d]
*** TURN *** [Ts 9c 9d] [Th]
*** RIVER *** [Ts 9c 9d Th] [Js]
*** SHOW DOWN ***
GUnvMULl2qFOO1yenu1UBw: shows [Ac Ad] (two pair, Aces and Tens)
BAjwVL+zKKd0s0fAWstzQQ: shows [Qd Qh] (two pair, Queens and Tens)
GUnvMULl2qFOO1yenu1UBw collected $6.90 from side pot
498aWaGsW4uGfuWl+2FCGw: shows [Ah As] (two pair, Aces and Tens)
GUnvMULl2qFOO1yenu1UBw collected $70.35 from main pot
498aWaGsW4uGfuWl+2FCGw collected $70.30 from main pot
*** SUMMARY ***
Total pot $150.55 Main pot $140.65. Side pot $6.90. | Rake $3
Board [Ts 9c 9d Th Js]
Seat 1: BgOXYI0yYSN1ULC4FqsNkg folded before Flop (didn't bet)
Seat 2: BAjwVL+zKKd0s0fAWstzQQ showed [Qd Qh] and lost with two pair, Queens and Tens
Seat 3: JFLrYNyQmwPhRQAtoSAuyA folded before Flop
Seat 4: 4QfsCWthT/vSLirorNXqtg (button) folded before Flop
Seat 5: GUnvMULl2qFOO1yenu1UBw (small blind) showed [Ac Ad] and won ($77.25) with two pair, Aces and Tens
Seat 6: 498aWaGsW4uGfuWl+2FCGw (big blind) showed [Ah As] and won ($70.30) with two pair, Aces and Tens



PokerStars Game #59941023514:  Hold'em No Limit ($0.25/$0.50) - 2009/07/01 1:23:27 ET
Table 'BCN5su+SsXiy1zRMJi0SJw' 6-max Seat #1 is the button
Seat 1: GxXV09ciXaOxyY2H5aMIIw ($49.05 in chips)
Seat 2: ehFNAevCQri3trWxV6FJdA ($57.85 in chips)
Seat 3: kwgv5lNhiFrfONXCshzxlA ($42.95 in chips)
Seat 6: b2symlOdL7+0c9Pj4N/KlA ($58.25 in chips)
ehFNAevCQri3trWxV6FJdA: posts small blind $0.25
kwgv5lNhiFrfONXCshzxlA: posts big blind $0.50
kxPhs4ePFqMy52CInAJ2aw: sits out
*** HOLE CARDS ***
b2symlOdL7+0c9Pj4N/KlA: folds
GxXV09ciXaOxyY2H5aMIIw: folds
fXMRO3W+v+BAC9U+y/9YLQ leaves the table
ehFNAevCQri3trWxV6FJdA: calls $0.25
kwgv5lNhiFrfONXCshzxlA: checks
*** FLOP *** [7c 5h 6c]
ehFNAevCQri3trWxV6FJdA: checks
kwgv5lNhiFrfONXCshzxlA: checks
*** TURN *** [7c 5h 6c] [Ts]
ehFNAevCQri3trWxV6FJdA: checks
kwgv5lNhiFrfONXCshzxlA: checks
*** RIVER *** [7c 5h 6c Ts] [6d]
ehFNAevCQri3trWxV6FJdA: bets $2
kwgv5lNhiFrfONXCshzxlA: folds
ehFNAevCQri3trWxV6FJdA collected $0.95 from pot
*** SUMMARY ***
Total pot $1 | Rake $0.05
Board [7c 5h 6c Ts 6d]
Seat 1: GxXV09ciXaOxyY2H5aMIIw (button) folded before Flop (didn't bet)
Seat 2: ehFNAevCQri3trWxV6FJdA (small blind) collected ($0.95)
Seat 3: kwgv5lNhiFrfONXCshzxlA (big blind) folded on the River
Seat 6: b2symlOdL7+0c9Pj4N/KlA folded before Flop (didn't bet)



PokerStars Game #59941024800:  Hold'em No Limit ($0.25/$0.50) - 2009/07/01 1:23:29 ET
Table '+z1aekfHkpp09pc8F9aViw' 6-max Seat #1 is the button
Seat 1: 7zFtlEn2NxyROFkJdZA/yg ($50 in chips)
Seat 2: OZ6OtYh5Y53MCH/p0QTn5g ($67.35 in chips)
Seat 3: uUznlIMFnRUvwrBhYF73KA ($138.60 in chips)
Seat 4: RowCSpSURHTOL/dcjg/Iug ($90 in chips)
Seat 6: GUnvMULl2qFOO1yenu1UBw ($50 in chips)
OZ6OtYh5Y53MCH/p0QTn5g: posts small blind $0.25
uUznlIMFnRUvwrBhYF73KA: posts big blind $0.50
2igtJLmvIZ+HqX4XPgMPZA: sits out
*** HOLE CARDS ***
RowCSpSURHTOL/dcjg/Iug: folds
GUnvMULl2qFOO1yenu1UBw: folds
7zFtlEn2NxyROFkJdZA/yg: folds
OZ6OtYh5Y53MCH/p0QTn5g: folds
uUznlIMFnRUvwrBhYF73KA collected $0.50 from pot
*** SUMMARY ***
Total pot $0.50 | Rake $0
Seat 1: 7zFtlEn2NxyROFkJdZA/yg (button) folded before Flop (didn't bet)
Seat 2: OZ6OtYh5Y53MCH/p0QTn5g (small blind) folded before Flop
Seat 3: uUznlIMFnRUvwrBhYF73KA (big blind) collected ($0.50)
Seat 4: RowCSpSURHTOL/dcjg/Iug folded before Flop (didn't bet)
Seat 6: GUnvMULl2qFOO1yenu1UBw folded before Flop (didn't bet)



PokerStars Game #59941025900:  Hold'em No Limit ($0.25/$0.50) - 2009/07/01 1:23:31 ET
Table 'GfL/No5u5PoEnU39lP5pQg' 6-max Seat #4 is the button
Seat 1: 1WUCqNG+p+vfWRTXNu4ljw ($66 in chips)
Seat 2: uVwggSetzp7d+eVgowO3vg ($48.85 in chips)
Seat 3: 4pp9WxhGdbVbxCc9tlu0lw ($36.45 in chips)
Seat 4: r6u7MWSXF30/khcTYkrG9Q ($26.25 in chips)
Seat 5: M1KyQQvVPVuxqTAB8sR/zQ ($50 in chips)
Seat 6: kxPhs4ePFqMy52CInAJ2aw ($62.45 in chips)
M1KyQQvVPVuxqTAB8sR/zQ: posts small blind $0.25
kxPhs4ePFqMy52CInAJ2aw: posts big blind $0.50
*** HOLE CARDS ***
1WUCqNG+p+vfWRTXNu4ljw has timed out
1WUCqNG+p+vfWRTXNu4ljw: folds
1WUCqNG+p+vfWRTXNu4ljw is sitting out
1WUCqNG+p+vfWRTXNu4ljw has returned
uVwggSetzp7d+eVgowO3vg: calls $0.50
4pp9WxhGdbVbxCc9tlu0lw: folds
r6u7MWSXF30/khcTYkrG9Q: folds
M1KyQQvVPVuxqTAB8sR/zQ: folds
kxPhs4ePFqMy52CInAJ2aw: raises $2.50 to $3
uVwggSetzp7d+eVgowO3vg: calls $2.50
*** FLOP *** [Qd Th 6s]
kxPhs4ePFqMy52CInAJ2aw: bets $4.50
uVwggSetzp7d+eVgowO3vg: calls $4.50
*** TURN *** [Qd Th 6s] [Jc]
kxPhs4ePFqMy52CInAJ2aw: bets $10
uVwggSetzp7d+eVgowO3vg: folds
kxPhs4ePFqMy52CInAJ2aw collected $14.55 from pot
kxPhs4ePFqMy52CInAJ2aw: doesn't show hand
*** SUMMARY ***
Total pot $15.25 | Rake $0.70
Board [Qd Th 6s Jc]
Seat 1: 1WUCqNG+p+vfWRTXNu4ljw folded before Flop (didn't bet)
Seat 2: uVwggSetzp7d+eVgowO3vg folded on the Turn
Seat 3: 4pp9WxhGdbVbxCc9tlu0lw folded before Flop (didn't bet)
Seat 4: r6u7MWSXF30/khcTYkrG9Q (button) folded before Flop (didn't bet)
Seat 5: M1KyQQvVPVuxqTAB8sR/zQ (small blind) folded before Flop
Seat 6: kxPhs4ePFqMy52CInAJ2aw (big blind) collected ($14.55)



PokerStars Game #59941026552:  Hold'em No Limit ($0.25/$0.50) - 2009/07/01 1:23:32 ET
Table 'B+sqsfj6d6zXicNfaseTaw' 2-max Seat #1 is the button
Seat 1: +4GNcSsecmapVGSdV0mUPA ($151.30 in chips)
Seat 2: Lv5RmpRe6LtPkBzM9Gpo5A ($77.05 in chips)
+4GNcSsecmapVGSdV0mUPA: posts small blind $0.25
Lv5RmpRe6LtPkBzM9Gpo5A: posts big blind $0.50
*** HOLE CARDS ***
+4GNcSsecmapVGSdV0mUPA: calls $0.25
Lv5RmpRe6LtPkBzM9Gpo5A: raises $1 to $1.50
+4GNcSsecmapVGSdV0mUPA: calls $1
*** FLOP *** [7d 6s 9s]
Lv5RmpRe6LtPkBzM9Gpo5A: checks
+4GNcSsecmapVGSdV0mUPA: checks
*** TURN *** [7d 6s 9s] [2d]
Lv5RmpRe6LtPkBzM9Gpo5A: checks
+4GNcSsecmapVGSdV0mUPA: checks
*** RIVER *** [7d 6s 9s 2d] [3h]
Lv5RmpRe6LtPkBzM9Gpo5A: checks
+4GNcSsecmapVGSdV0mUPA: bets $3
Lv5RmpRe6LtPkBzM9Gpo5A: folds
+4GNcSsecmapVGSdV0mUPA collected $2.85 from pot
+4GNcSsecmapVGSdV0mUPA: doesn't show hand
*** SUMMARY ***
Total pot $3 | Rake $0.15
Board [7d 6s 9s 2d 3h]
Seat 1: +4GNcSsecmapVGSdV0mUPA (button) (small blind) collected ($2.85)
Seat 2: Lv5RmpRe6LtPkBzM9Gpo5A (big blind) folded on the River



PokerStars Game #59941027160:  Hold'em No Limit ($0.25/$0.50) - 2009/07/01 1:23:33 ET
Table 'ofnd8S4IdIPph1Cbn+x7hA' 2-max Seat #1 is the button
Seat 1: PY4NvRocCFPfSIHKbh0euQ ($28.70 in chips)
Seat 2: l5WbyJ/iWYjpeCC6GCYY6w ($64.75 in chips)
PY4NvRocCFPfSIHKbh0euQ: posts small blind $0.25
l5WbyJ/iWYjpeCC6GCYY6w: posts big blind $0.50
*** HOLE CARDS ***
PY4NvRocCFPfSIHKbh0euQ: raises $1 to $1.50
l5WbyJ/iWYjpeCC6GCYY6w: calls $1
*** FLOP *** [7s 6h 5h]
l5WbyJ/iWYjpeCC6GCYY6w: checks
PY4NvRocCFPfSIHKbh0euQ: checks
*** TURN *** [7s 6h 5h] [2s]
l5WbyJ/iWYjpeCC6GCYY6w: checks
PY4NvRocCFPfSIHKbh0euQ: bets $1
l5WbyJ/iWYjpeCC6GCYY6w: folds
PY4NvRocCFPfSIHKbh0euQ collected $2.85 from pot
*** SUMMARY ***
Total pot $3 | Rake $0.15
Board [7s 6h 5h 2s]
Seat 1: PY4NvRocCFPfSIHKbh0euQ (button) (small blind) collected ($2.85)
Seat 2: l5WbyJ/iWYjpeCC6GCYY6w (big blind) folded on the Turn



PokerStars Game #59941027088:  Hold'em No Limit ($0.25/$0.50) - 2009/07/01 1:23:33 ET
Table '+dXkOAQyS8j9PQZusUTMpg' 2-max Seat #2 is the button
Seat 1: Teld4PDKla7C8/Wfu2DSkg ($47.15 in chips)
Seat 2: +zI4bP23YIjMkUHqeN2xfw ($31.15 in chips)
+zI4bP23YIjMkUHqeN2xfw: posts small blind $0.25
Teld4PDKla7C8/Wfu2DSkg: posts big blind $0.50
*** HOLE CARDS ***
+zI4bP23YIjMkUHqeN2xfw: calls $0.25
Teld4PDKla7C8/Wfu2DSkg: checks
*** FLOP *** [Qd Tc Jh]
Teld4PDKla7C8/Wfu2DSkg: checks
+zI4bP23YIjMkUHqeN2xfw: checks
*** TURN *** [Qd Tc Jh] [8c]
Teld4PDKla7C8/Wfu2DSkg: checks
+zI4bP23YIjMkUHqeN2xfw: checks
*** RIVER *** [Qd Tc Jh 8c] [5c]
Teld4PDKla7C8/Wfu2DSkg: checks
+zI4bP23YIjMkUHqeN2xfw: checks
*** SHOW DOWN ***
Teld4PDKla7C8/Wfu2DSkg: shows [7h 4s] (high card Queen)
+zI4bP23YIjMkUHqeN2xfw: shows [Ac 3s] (high card Ace)
+zI4bP23YIjMkUHqeN2xfw collected $0.95 from pot
*** SUMMARY ***
Total pot $1 | Rake $0.05
Board [Qd Tc Jh 8c 5c]
Seat 1: Teld4PDKla7C8/Wfu2DSkg (big blind) showed [7h 4s] and lost with high card Queen
Seat 2: +zI4bP23YIjMkUHqeN2xfw (button) (small blind) showed [Ac 3s] and won ($0.95) with high card Ace



PokerStars Game #59941027082:  Hold'em No Limit ($0.25/$0.50) - 2009/07/01 1:23:33 ET
Table 'fx6MqwfYAj/Rt86hBz2L3Q' 9-max Seat #3 is the button
Seat 1: v/4aX0ejnaIFK4ftDk2Lyg ($52.15 in chips)
Seat 2: C3rGXblctNcWI6JYPHhaEg ($39 in chips)
Seat 3: iadBi5AEt7gTBXbDSSnMYQ ($49.80 in chips)
Seat 5: iAISe3dVeua8PUn2wwgDHw ($64.15 in chips)
Seat 6: 5k9fvXD9suIgCxU4HLQjTw ($50 in chips)
Seat 7: SKnJuWHScqetA/qG5p+wCg ($30 in chips)
Seat 8: JYwJYYV9pM5KWdSiETl8rA ($63.25 in chips)
Seat 9: vO3QVRovWemcGMkm7ijAIA ($12.25 in chips)
iAISe3dVeua8PUn2wwgDHw: posts small blind $0.25
5k9fvXD9suIgCxU4HLQjTw: posts big blind $0.50
*** HOLE CARDS ***
SKnJuWHScqetA/qG5p+wCg: folds
JYwJYYV9pM5KWdSiETl8rA: folds
vO3QVRovWemcGMkm7ijAIA: folds
v/4aX0ejnaIFK4ftDk2Lyg: folds
C3rGXblctNcWI6JYPHhaEg: raises $1.50 to $2
iadBi5AEt7gTBXbDSSnMYQ: folds
iAISe3dVeua8PUn2wwgDHw: calls $1.75
5k9fvXD9suIgCxU4HLQjTw: folds
*** FLOP *** [Tc As Qh]
iAISe3dVeua8PUn2wwgDHw: checks
C3rGXblctNcWI6JYPHhaEg: bets $3
iAISe3dVeua8PUn2wwgDHw: folds
C3rGXblctNcWI6JYPHhaEg collected $4.30 from pot
C3rGXblctNcWI6JYPHhaEg: doesn't show hand
*** SUMMARY ***
Total pot $4.50 | Rake $0.20
Board [Tc As Qh]
Seat 1: v/4aX0ejnaIFK4ftDk2Lyg folded before Flop (didn't bet)
Seat 2: C3rGXblctNcWI6JYPHhaEg collected ($4.30)
Seat 3: iadBi5AEt7gTBXbDSSnMYQ (button) folded before Flop (didn't bet)
Seat 5: iAISe3dVeua8PUn2wwgDHw (small blind) folded on the Flop
Seat 6: 5k9fvXD9suIgCxU4HLQjTw (big blind) folded before Flop
Seat 7: SKnJuWHScqetA/qG5p+wCg folded before Flop (didn't bet)
Seat 8: JYwJYYV9pM5KWdSiETl8rA folded before Flop (didn't bet)
Seat 9: vO3QVRovWemcGMkm7ijAIA folded before Flop (didn't bet)



PokerStars Game #59941030176:  Hold'em No Limit ($0.25/$0.50) - 2009/07/01 1:23:38 ET
Table 'lSisgp6H7Fg1hH5VfjEjYQ' 9-max Seat #7 is the button
Seat 1: 5k9fvXD9suIgCxU4HLQjTw ($55.85 in chips)
Seat 3: SKnJuWHScqetA/qG5p+wCg ($30 in chips)
Seat 4: bwv/rbH/hHhPhY6u9mu04w ($36.15 in chips)
Seat 5: mSD1pginDsyHG5PDfqzphw ($13 in chips)
Seat 6: +k7T5ocke8UwavtgUHm+Cg ($63.40 in chips)
Seat 7: IDtNLR9uFCDdjNsJWMHA5Q ($27.65 in chips)
Seat 8: a4JDWmpFQkL10XfAyuF51A ($12.50 in chips)
Seat 9: YzeKFbJVLmJGTgNH3ySQlw ($7 in chips)
a4JDWmpFQkL10XfAyuF51A: posts small blind $0.25
YzeKFbJVLmJGTgNH3ySQlw: posts big blind $0.50
*** HOLE CARDS ***
5k9fvXD9suIgCxU4HLQjTw: folds
SKnJuWHScqetA/qG5p+wCg: folds
bwv/rbH/hHhPhY6u9mu04w: folds
mSD1pginDsyHG5PDfqzphw: folds
+k7T5ocke8UwavtgUHm+Cg: folds
IDtNLR9uFCDdjNsJWMHA5Q: calls $0.50
a4JDWmpFQkL10XfAyuF51A: folds
YzeKFbJVLmJGTgNH3ySQlw: checks
*** FLOP *** [8c 7d Th]
YzeKFbJVLmJGTgNH3ySQlw: checks
IDtNLR9uFCDdjNsJWMHA5Q: checks
*** TURN *** [8c 7d Th] [2s]
YzeKFbJVLmJGTgNH3ySQlw: bets $1
IDtNLR9uFCDdjNsJWMHA5Q: folds
YzeKFbJVLmJGTgNH3ySQlw collected $1.20 from pot
*** SUMMARY ***
Total pot $1.25 | Rake $0.05
Board [8c 7d Th 2s]
Seat 1: 5k9fvXD9suIgCxU4HLQjTw folded before Flop (didn't bet)
Seat 3: SKnJuWHScqetA/qG5p+wCg folded before Flop (didn't bet)
Seat 4: bwv/rbH/hHhPhY6u9mu04w folded before Flop (didn't bet)
Seat 5: mSD1pginDsyHG5PDfqzphw folded before Flop (didn't bet)
Seat 6: +k7T5ocke8UwavtgUHm+Cg folded before Flop (didn't bet)
Seat 7: IDtNLR9uFCDdjNsJWMHA5Q (button) folded on the Turn
Seat 8: a4JDWmpFQkL10XfAyuF51A (small blind) folded before Flop
Seat 9: YzeKFbJVLmJGTgNH3ySQlw (big blind) collected ($1.20)



PokerStars Game #59941030450:  Hold'em No Limit ($0.25/$0.50) - 2009/07/01 1:23:39 ET
Table '8BQGgNetI1NOvWeu3gtMNw' 2-max Seat #1 is the button
Seat 1: bypIyrYcAAifLfhZpGlKLA ($67.50 in chips)
Seat 2: Z4HwehErEwzsv/noQlfUlg ($121.50 in chips)
bypIyrYcAAifLfhZpGlKLA: posts small blind $0.25
Z4HwehErEwzsv/noQlfUlg: posts big blind $0.50
*** HOLE CARDS ***
bypIyrYcAAifLfhZpGlKLA: raises $1 to $1.50
Z4HwehErEwzsv/noQlfUlg: calls $1
*** FLOP *** [7h Kd 5d]
Z4HwehErEwzsv/noQlfUlg: checks
bypIyrYcAAifLfhZpGlKLA: checks
*** TURN *** [7h Kd 5d] [Ad]
Z4HwehErEwzsv/noQlfUlg: checks
bypIyrYcAAifLfhZpGlKLA: checks
*** RIVER *** [7h Kd 5d Ad] [Qd]
Z4HwehErEwzsv/noQlfUlg: bets $1.50
bypIyrYcAAifLfhZpGlKLA: calls $1.50
*** SHOW DOWN ***
Z4HwehErEwzsv/noQlfUlg: shows [6s Ks] (a pair of Kings)
bypIyrYcAAifLfhZpGlKLA: shows [9h Kc] (a pair of Kings - Ace+Queen+Nine kicker)
bypIyrYcAAifLfhZpGlKLA collected $5.75 from pot
*** SUMMARY ***
Total pot $6 | Rake $0.25
Board [7h Kd 5d Ad Qd]
Seat 1: bypIyrYcAAifLfhZpGlKLA (button) (small blind) showed [9h Kc] and won ($5.75) with a pair of Kings
Seat 2: Z4HwehErEwzsv/noQlfUlg (big blind) showed [6s Ks] and lost with a pair of Kings



PokerStars Game #59941031370:  Hold'em No Limit ($0.25/$0.50) - 2009/07/01 1:23:40 ET
Table 'kgbJRsxfv64KrErDRBAkcw' 6-max Seat #2 is the button
Seat 1: VamsyhlFzXGF6/ydo0BHeA ($22.05 in chips)
Seat 2: AdS8BJMOheS01zjCDfPMFg ($65.25 in chips)
Seat 3: c4MNIaIyPMOMxrgT8FT5nA ($228.45 in chips)
Seat 4: 2igtJLmvIZ+HqX4XPgMPZA ($50 in chips)
Seat 5: eUBBn2R56C1IQ6Cs/vitwg ($50 in chips)
Seat 6: 1b+2BbjMN8qhR1WPqdE9VQ ($59.65 in chips)
c4MNIaIyPMOMxrgT8FT5nA: posts small blind $0.25
2igtJLmvIZ+HqX4XPgMPZA: posts big blind $0.50
*** HOLE CARDS ***
eUBBn2R56C1IQ6Cs/vitwg: folds
1b+2BbjMN8qhR1WPqdE9VQ: folds
VamsyhlFzXGF6/ydo0BHeA: raises $1 to $1.50
AdS8BJMOheS01zjCDfPMFg: folds
c4MNIaIyPMOMxrgT8FT5nA: calls $1.25
2igtJLmvIZ+HqX4XPgMPZA: folds
*** FLOP *** [2c 3c Tc]
c4MNIaIyPMOMxrgT8FT5nA: checks
VamsyhlFzXGF6/ydo0BHeA: checks
*** TURN *** [2c 3c Tc] [8h]
c4MNIaIyPMOMxrgT8FT5nA: checks
VamsyhlFzXGF6/ydo0BHeA: checks
*** RIVER *** [2c 3c Tc 8h] [5c]
c4MNIaIyPMOMxrgT8FT5nA: bets $2.50
VamsyhlFzXGF6/ydo0BHeA: folds
c4MNIaIyPMOMxrgT8FT5nA collected $3.35 from pot
c4MNIaIyPMOMxrgT8FT5nA: doesn't show hand
*** SUMMARY ***
Total pot $3.50 | Rake $0.15
Board [2c 3c Tc 8h 5c]
Seat 1: VamsyhlFzXGF6/ydo0BHeA folded on the River
Seat 2: AdS8BJMOheS01zjCDfPMFg (button) folded before Flop (didn't bet)
Seat 3: c4MNIaIyPMOMxrgT8FT5nA (small blind) collected ($3.35)
Seat 4: 2igtJLmvIZ+HqX4XPgMPZA (big blind) folded before Flop
Seat 5: eUBBn2R56C1IQ6Cs/vitwg folded before Flop (didn't bet)
Seat 6: 1b+2BbjMN8qhR1WPqdE9VQ folded before Flop (didn't bet)



PokerStars Game #59941031776:  Hold'em No Limit ($0.25/$0.50) - 2009/07/01 1:23:41 ET
Table 'otvGDROEDdqsabxskT79qg' 9-max Seat #8 is the button
Seat 1: 8ehL7qlZzjgUh2H35iiWLw ($62 in chips)
Seat 2: cCjTzH9jio8607WzjcfXlg ($10.65 in chips)
Seat 3: +k7T5ocke8UwavtgUHm+Cg ($73.75 in chips)
Seat 4: MG90wfSJZnOejs/KD3vlQQ ($80.65 in chips)
Seat 5: E2518gp4aFz1+kAgmGqeEg ($12.20 in chips)
Seat 6: FFVKBJT0lZf+jFlgvy7ang ($40 in chips)
Seat 8: zE9cVigS2nW/Ljy4K4bUQA ($33.30 in chips)
Seat 9: KcY3X8YpD74Kw1RHkx/g4A ($31.15 in chips)
KcY3X8YpD74Kw1RHkx/g4A: posts small blind $0.25
8ehL7qlZzjgUh2H35iiWLw: posts big blind $0.50
FFVKBJT0lZf+jFlgvy7ang: posts big blind $0.50
*** HOLE CARDS ***
cCjTzH9jio8607WzjcfXlg: folds
+k7T5ocke8UwavtgUHm+Cg: folds
MG90wfSJZnOejs/KD3vlQQ: folds
E2518gp4aFz1+kAgmGqeEg: folds
FFVKBJT0lZf+jFlgvy7ang: checks
zE9cVigS2nW/Ljy4K4bUQA: folds
KcY3X8YpD74Kw1RHkx/g4A: folds
8ehL7qlZzjgUh2H35iiWLw: checks
*** FLOP *** [9c 8s Ah]
8ehL7qlZzjgUh2H35iiWLw: checks
FFVKBJT0lZf+jFlgvy7ang: checks
*** TURN *** [9c 8s Ah] [3s]
8ehL7qlZzjgUh2H35iiWLw: checks
FFVKBJT0lZf+jFlgvy7ang: checks
*** RIVER *** [9c 8s Ah 3s] [Qh]
8ehL7qlZzjgUh2H35iiWLw: checks
FFVKBJT0lZf+jFlgvy7ang: bets $1.50
8ehL7qlZzjgUh2H35iiWLw: folds
FFVKBJT0lZf+jFlgvy7ang collected $1.20 from pot
*** SUMMARY ***
Total pot $1.25 | Rake $0.05
Board [9c 8s Ah 3s Qh]
Seat 1: 8ehL7qlZzjgUh2H35iiWLw (big blind) folded on the River
Seat 2: cCjTzH9jio8607WzjcfXlg folded before Flop (didn't bet)
Seat 3: +k7T5ocke8UwavtgUHm+Cg folded before Flop (didn't bet)
Seat 4: MG90wfSJZnOejs/KD3vlQQ folded before Flop (didn't bet)
Seat 5: E2518gp4aFz1+kAgmGqeEg folded before Flop (didn't bet)
Seat 6: FFVKBJT0lZf+jFlgvy7ang collected ($1.20)
Seat 8: zE9cVigS2nW/Ljy4K4bUQA (button) folded before Flop (didn't bet)
Seat 9: KcY3X8YpD74Kw1RHkx/g4A (small blind) folded before Flop



PokerStars Game #59941031890:  Hold'em No Limit ($0.25/$0.50) - 2009/07/01 1:23:41 ET
Table 'EiNh8p/wGJ1FP575iMFnqg' 9-max Seat #9 is the button
Seat 1: YFFlOZgyy1Mh4iBmuNRbmQ ($23.50 in chips)
Seat 2: 8ehL7qlZzjgUh2H35iiWLw ($58.90 in chips)
Seat 3: ymLPoEIl7UL3TvZYmnadxQ ($60.10 in chips)
Seat 4: cMzaiXAM/ZAdNaEUu+LqhA ($50 in chips)
Seat 5: M+7+BTmX5vZatHVuoRB1nA ($74.45 in chips)
Seat 6: viwBDtJsY6JfsFOdBAyJIQ ($9.45 in chips)
Seat 7: 997ViqAtWn1FPjJqcffwcA ($50 in chips)
Seat 8: mSD1pginDsyHG5PDfqzphw ($10 in chips)
Seat 9: GuPkZObrz5Zkkn8FsEdF9w ($37.60 in chips)
YFFlOZgyy1Mh4iBmuNRbmQ: posts small blind $0.25
8ehL7qlZzjgUh2H35iiWLw: posts big blind $0.50
*** HOLE CARDS ***
ymLPoEIl7UL3TvZYmnadxQ: calls $0.50
cMzaiXAM/ZAdNaEUu+LqhA: folds
M+7+BTmX5vZatHVuoRB1nA: folds
viwBDtJsY6JfsFOdBAyJIQ: folds
997ViqAtWn1FPjJqcffwcA: folds
mSD1pginDsyHG5PDfqzphw: folds
GuPkZObrz5Zkkn8FsEdF9w: folds
YFFlOZgyy1Mh4iBmuNRbmQ: raises $1 to $1.50
8ehL7qlZzjgUh2H35iiWLw: folds
ymLPoEIl7UL3TvZYmnadxQ: calls $1
*** FLOP *** [Tc 6h 4c]
YFFlOZgyy1Mh4iBmuNRbmQ: checks
ymLPoEIl7UL3TvZYmnadxQ: bets $3
YFFlOZgyy1Mh4iBmuNRbmQ: calls $3
*** TURN *** [Tc 6h 4c] [8d]
YFFlOZgyy1Mh4iBmuNRbmQ: bets $0.50
ymLPoEIl7UL3TvZYmnadxQ: calls $0.50
*** RIVER *** [Tc 6h 4c 8d] [Th]
YFFlOZgyy1Mh4iBmuNRbmQ: bets $5.50
ymLPoEIl7UL3TvZYmnadxQ: folds
YFFlOZgyy1Mh4iBmuNRbmQ collected $10 from pot
YFFlOZgyy1Mh4iBmuNRbmQ: doesn't show hand
*** SUMMARY ***
Total pot $10.50 | Rake $0.50
Board [Tc 6h 4c 8d Th]
Seat 1: YFFlOZgyy1Mh4iBmuNRbmQ (small blind) collected ($10)
Seat 2: 8ehL7qlZzjgUh2H35iiWLw (big blind) folded before Flop
Seat 3: ymLPoEIl7UL3TvZYmnadxQ folded on the River
Seat 4: cMzaiXAM/ZAdNaEUu+LqhA folded before Flop (didn't bet)
Seat 5: M+7+BTmX5vZatHVuoRB1nA folded before Flop (didn't bet)
Seat 6: viwBDtJsY6JfsFOdBAyJIQ folded before Flop (didn't bet)
Seat 7: 997ViqAtWn1FPjJqcffwcA folded before Flop (didn't bet)
Seat 8: mSD1pginDsyHG5PDfqzphw folded before Flop (didn't bet)
Seat 9: GuPkZObrz5Zkkn8FsEdF9w (button) folded before Flop (didn't bet)



PokerStars Game #59941032426:  Hold'em No Limit ($0.25/$0.50) - 2009/07/01 1:23:42 ET
Table 'ibNfFy0bCzuBaUORla0aGw' 9-max Seat #8 is the button
Seat 1: xZCXQSXlrZkp3pZizzVXCw ($50.55 in chips)
Seat 2: 90Wb75h3W1BRpbqVnuk8gw ($50.75 in chips)
Seat 3: AjV5McH1KMMclY26QdLM5w ($27.10 in chips)
Seat 5: GIJAc9kPrLZHLSX8Q6i99w ($26.80 in chips)
Seat 6: H8cPaCtX7d6meGUVSM5sxw ($55.75 in chips)
Seat 7: HZkVla4kK2SI42CVrPZ/ig ($13 in chips)
Seat 8: Ja2jdidjip2UeJnRzmzAAQ ($48.50 in chips)
Seat 9: pFtzb1sR4b0d1aw6aIRgDg ($57.90 in chips)
pFtzb1sR4b0d1aw6aIRgDg: posts small blind $0.25
xZCXQSXlrZkp3pZizzVXCw: posts big blind $0.50
nhDtFZ2uuvm5hDKG7ZVEpA: sits out
*** HOLE CARDS ***
90Wb75h3W1BRpbqVnuk8gw: folds
AjV5McH1KMMclY26QdLM5w: folds
GIJAc9kPrLZHLSX8Q6i99w: folds
H8cPaCtX7d6meGUVSM5sxw: raises $1 to $1.50
HZkVla4kK2SI42CVrPZ/ig: folds
Ja2jdidjip2UeJnRzmzAAQ: calls $1.50
pFtzb1sR4b0d1aw6aIRgDg: folds
xZCXQSXlrZkp3pZizzVXCw: folds
*** FLOP *** [9h Ts 2h]
H8cPaCtX7d6meGUVSM5sxw: bets $3
Ja2jdidjip2UeJnRzmzAAQ: folds
H8cPaCtX7d6meGUVSM5sxw collected $3.60 from pot
*** SUMMARY ***
Total pot $3.75 | Rake $0.15
Board [9h Ts 2h]
Seat 1: xZCXQSXlrZkp3pZizzVXCw (big blind) folded before Flop
Seat 2: 90Wb75h3W1BRpbqVnuk8gw folded before Flop (didn't bet)
Seat 3: AjV5McH1KMMclY26QdLM5w folded before Flop (didn't bet)
Seat 5: GIJAc9kPrLZHLSX8Q6i99w folded before Flop (didn't bet)
Seat 6: H8cPaCtX7d6meGUVSM5sxw collected ($3.60)
Seat 7: HZkVla4kK2SI42CVrPZ/ig folded before Flop (didn't bet)
Seat 8: Ja2jdidjip2UeJnRzmzAAQ (button) folded on the Flop
Seat 9: pFtzb1sR4b0d1aw6aIRgDg (small blind) folded before Flop



PokerStars Game #59941034006:  Hold'em No Limit ($0.25/$0.50) - 2009/07/01 1:23:45 ET
Table 'Nz0Vr7WMHL2g5Uk7dDZjpw' 9-max Seat #3 is the button
Seat 3: hoglu9inkgs6zN573/bJag ($5.70 in chips)
Seat 4: E2518gp4aFz1+kAgmGqeEg ($12.50 in chips)
Seat 5: WGW0DgjBUXs1ylURHG8vnQ ($13 in chips)
Seat 6: 997ViqAtWn1FPjJqcffwcA ($58.05 in chips)
Seat 7: KPLH0gELgFe2OuAnhJFI5w ($26.20 in chips)
Seat 8: aoL+R/61Kxmw69ypuPrWAQ ($29.25 in chips)
Seat 9: mSD1pginDsyHG5PDfqzphw ($10 in chips)
E2518gp4aFz1+kAgmGqeEg: posts small blind $0.25
WGW0DgjBUXs1ylURHG8vnQ: posts big blind $0.50
SegjDnMxWMujiD57ESNL+g: sits out
*** HOLE CARDS ***
997ViqAtWn1FPjJqcffwcA: folds
KPLH0gELgFe2OuAnhJFI5w: folds
aoL+R/61Kxmw69ypuPrWAQ: raises $1 to $1.50
mSD1pginDsyHG5PDfqzphw: folds
hoglu9inkgs6zN573/bJag: folds
E2518gp4aFz1+kAgmGqeEg: folds
WGW0DgjBUXs1ylURHG8vnQ: folds
aoL+R/61Kxmw69ypuPrWAQ collected $1.25 from pot
*** SUMMARY ***
Total pot $1.25 | Rake $0
Seat 3: hoglu9inkgs6zN573/bJag (button) folded before Flop (didn't bet)
Seat 4: E2518gp4aFz1+kAgmGqeEg (small blind) folded before Flop
Seat 5: WGW0DgjBUXs1ylURHG8vnQ (big blind) folded before Flop
Seat 6: 997ViqAtWn1FPjJqcffwcA folded before Flop (didn't bet)
Seat 7: KPLH0gELgFe2OuAnhJFI5w folded before Flop (didn't bet)
Seat 8: aoL+R/61Kxmw69ypuPrWAQ collected ($1.25)
Seat 9: mSD1pginDsyHG5PDfqzphw folded before Flop (didn't bet)



PokerStars Game #59941036378:  Hold'em No Limit ($0.25/$0.50) - 2009/07/01 1:23:49 ET
Table '+dXkOAQyS8j9PQZusUTMpg' 2-max Seat #1 is the button
Seat 1: Teld4PDKla7C8/Wfu2DSkg ($46.65 in chips)
Seat 2: +zI4bP23YIjMkUHqeN2xfw ($31.60 in chips)
Teld4PDKla7C8/Wfu2DSkg: posts small blind $0.25
+zI4bP23YIjMkUHqeN2xfw: posts big blind $0.50
*** HOLE CARDS ***
Teld4PDKla7C8/Wfu2DSkg: raises $0.50 to $1
+zI4bP23YIjMkUHqeN2xfw: calls $0.50
*** FLOP *** [7h Jh Jd]
+zI4bP23YIjMkUHqeN2xfw: checks
Teld4PDKla7C8/Wfu2DSkg: checks
*** TURN *** [7h Jh Jd] [4h]
+zI4bP23YIjMkUHqeN2xfw: checks
Teld4PDKla7C8/Wfu2DSkg: checks
*** RIVER *** [7h Jh Jd 4h] [Ts]
+zI4bP23YIjMkUHqeN2xfw: checks
Teld4PDKla7C8/Wfu2DSkg: bets $1
+zI4bP23YIjMkUHqeN2xfw: folds
Teld4PDKla7C8/Wfu2DSkg collected $1.90 from pot
Teld4PDKla7C8/Wfu2DSkg: doesn't show hand
*** SUMMARY ***
Total pot $2 | Rake $0.10
Board [7h Jh Jd 4h Ts]
Seat 1: Teld4PDKla7C8/Wfu2DSkg (button) (small blind) collected ($1.90)
Seat 2: +zI4bP23YIjMkUHqeN2xfw (big blind) folded on the River



PokerStars Game #59941037356:  Hold'em No Limit ($0.25/$0.50) - 2009/07/01 1:23:51 ET
Table 'c/CRn+68J3Y8KxD5g1ek2Q' 2-max Seat #1 is the button
Seat 1: 46qCyJ6evTkHo9al5sBMNA ($99.40 in chips)
Seat 2: BypVLsYQt3ePFm2xQL/dOA ($260.55 in chips)
46qCyJ6evTkHo9al5sBMNA: posts small blind $0.25
BypVLsYQt3ePFm2xQL/dOA: posts big blind $0.50
*** HOLE CARDS ***
46qCyJ6evTkHo9al5sBMNA: raises $1 to $1.50
BypVLsYQt3ePFm2xQL/dOA: folds
46qCyJ6evTkHo9al5sBMNA collected $1 from pot
46qCyJ6evTkHo9al5sBMNA: doesn't show hand
*** SUMMARY ***
Total pot $1 | Rake $0
Seat 1: 46qCyJ6evTkHo9al5sBMNA (button) (small blind) collected ($1)
Seat 2: BypVLsYQt3ePFm2xQL/dOA (big blind) folded before Flop



PokerStars Game #59941038250:  Hold'em No Limit ($0.25/$0.50) - 2009/07/01 1:23:52 ET
Table 'B+sqsfj6d6zXicNfaseTaw' 2-max Seat #2 is the button
Seat 1: +4GNcSsecmapVGSdV0mUPA ($152.65 in chips)
Seat 2: Lv5RmpRe6LtPkBzM9Gpo5A ($75.55 in chips)
Lv5RmpRe6LtPkBzM9Gpo5A: posts small blind $0.25
+4GNcSsecmapVGSdV0mUPA: posts big blind $0.50
*** HOLE CARDS ***
Lv5RmpRe6LtPkBzM9Gpo5A: raises $1 to $1.50
+4GNcSsecmapVGSdV0mUPA: raises $3.50 to $5
Lv5RmpRe6LtPkBzM9Gpo5A: calls $3.50
*** FLOP *** [Td Kh 9h]
+4GNcSsecmapVGSdV0mUPA: checks
Lv5RmpRe6LtPkBzM9Gpo5A: checks
*** TURN *** [Td Kh 9h] [7h]
+4GNcSsecmapVGSdV0mUPA: checks
Lv5RmpRe6LtPkBzM9Gpo5A: checks
*** RIVER *** [Td Kh 9h 7h] [Ts]
+4GNcSsecmapVGSdV0mUPA: bets $10
Lv5RmpRe6LtPkBzM9Gpo5A: folds
+4GNcSsecmapVGSdV0mUPA collected $9.50 from pot
+4GNcSsecmapVGSdV0mUPA: doesn't show hand
*** SUMMARY ***
Total pot $10 | Rake $0.50
Board [Td Kh 9h 7h Ts]
Seat 1: +4GNcSsecmapVGSdV0mUPA (big blind) collected ($9.50)
Seat 2: Lv5RmpRe6LtPkBzM9Gpo5A (button) (small blind) folded on the River



PokerStars Game #59941038902:  Hold'em No Limit ($0.25/$0.50) - 2009/07/01 1:23:54 ET
Table '+z1aekfHkpp09pc8F9aViw' 6-max Seat #2 is the button
Seat 1: 7zFtlEn2NxyROFkJdZA/yg ($50 in chips)
Seat 2: OZ6OtYh5Y53MCH/p0QTn5g ($67.10 in chips)
Seat 3: uUznlIMFnRUvwrBhYF73KA ($138.85 in chips)
Seat 4: RowCSpSURHTOL/dcjg/Iug ($90 in chips)
Seat 6: GUnvMULl2qFOO1yenu1UBw ($50 in chips)
uUznlIMFnRUvwrBhYF73KA: posts small blind $0.25
RowCSpSURHTOL/dcjg/Iug: posts big blind $0.50
2igtJLmvIZ+HqX4XPgMPZA: sits out
*** HOLE CARDS ***
GUnvMULl2qFOO1yenu1UBw: folds
7zFtlEn2NxyROFkJdZA/yg: folds
OZ6OtYh5Y53MCH/p0QTn5g: folds
uUznlIMFnRUvwrBhYF73KA: calls $0.25
RowCSpSURHTOL/dcjg/Iug: checks
*** FLOP *** [4c 8d Qc]
uUznlIMFnRUvwrBhYF73KA: checks
RowCSpSURHTOL/dcjg/Iug: checks
*** TURN *** [4c 8d Qc] [Ts]
uUznlIMFnRUvwrBhYF73KA: checks
RowCSpSURHTOL/dcjg/Iug: bets $1
uUznlIMFnRUvwrBhYF73KA: calls $1
*** RIVER *** [4c 8d Qc Ts] [Qs]
uUznlIMFnRUvwrBhYF73KA: checks
RowCSpSURHTOL/dcjg/Iug: checks
*** SHOW DOWN ***
uUznlIMFnRUvwrBhYF73KA: shows [Jh 8c] (two pair, Queens and Eights)
RowCSpSURHTOL/dcjg/Iug: mucks hand
uUznlIMFnRUvwrBhYF73KA collected $2.90 from pot
*** SUMMARY ***
Total pot $3 | Rake $0.10
Board [4c 8d Qc Ts Qs]
Seat 1: 7zFtlEn2NxyROFkJdZA/yg folded before Flop (didn't bet)
Seat 2: OZ6OtYh5Y53MCH/p0QTn5g (button) folded before Flop (didn't bet)
Seat 3: uUznlIMFnRUvwrBhYF73KA (small blind) showed [Jh 8c] and won ($2.90) with two pair, Queens and Eights
Seat 4: RowCSpSURHTOL/dcjg/Iug (big blind) mucked
Seat 6: GUnvMULl2qFOO1yenu1UBw folded before Flop (didn't bet)



PokerStars Game #59941040520:  Hold'em No Limit ($0.25/$0.50) - 2009/07/01 1:23:57 ET
Table 'ofnd8S4IdIPph1Cbn+x7hA' 2-max Seat #2 is the button
Seat 1: PY4NvRocCFPfSIHKbh0euQ ($30.05 in chips)
Seat 2: l5WbyJ/iWYjpeCC6GCYY6w ($63.25 in chips)
l5WbyJ/iWYjpeCC6GCYY6w: posts small blind $0.25
PY4NvRocCFPfSIHKbh0euQ: posts big blind $0.50
*** HOLE CARDS ***
l5WbyJ/iWYjpeCC6GCYY6w: raises $1 to $1.50
PY4NvRocCFPfSIHKbh0euQ: raises $1 to $2.50
l5WbyJ/iWYjpeCC6GCYY6w: calls $1
*** FLOP *** [6d 2c Qs]
PY4NvRocCFPfSIHKbh0euQ: bets $1
l5WbyJ/iWYjpeCC6GCYY6w: folds
PY4NvRocCFPfSIHKbh0euQ collected $4.75 from pot
*** SUMMARY ***
Total pot $5 | Rake $0.25
Board [6d 2c Qs]
Seat 1: PY4NvRocCFPfSIHKbh0euQ (big blind) collected ($4.75)
Seat 2: l5WbyJ/iWYjpeCC6GCYY6w (button) (small blind) folded on the Flop



PokerStars Game #59941041368:  Hold'em No Limit ($0.25/$0.50) - 2009/07/01 1:23:58 ET
Table 'ZYI3ZReBjdfKEYItkZHI6A' 9-max Seat #3 is the button
Seat 1: IYd5zG8k7vdBNVHbHg2Pag ($50.75 in chips)
Seat 2: uw9QayAAxLM3Hb+HR7mSkg ($9.25 in chips)
Seat 3: bkXkL3pmapikPQQRNPZSEA ($12.15 in chips)
Seat 4: e2+sK/yjnj94rXOKoxPP2A ($66.15 in chips)
Seat 5: ApHP7ouup365XIUFBdEDxg ($36 in chips)
Seat 6: 1xBtrSVBbgFH/viUWKqQeg ($30.20 in chips)
Seat 7: HWcfp1hY1hqvrddzW3/FQw ($16.75 in chips)
Seat 8: ji04uOybxCdpdefzlUQeKQ ($30.60 in chips)
e2+sK/yjnj94rXOKoxPP2A: posts small blind $0.25
ApHP7ouup365XIUFBdEDxg: posts big blind $0.50
HZkVla4kK2SI42CVrPZ/ig: sits out
*** HOLE CARDS ***
1xBtrSVBbgFH/viUWKqQeg: folds
HWcfp1hY1hqvrddzW3/FQw: raises $0.50 to $1
ji04uOybxCdpdefzlUQeKQ: folds
IYd5zG8k7vdBNVHbHg2Pag: folds
uw9QayAAxLM3Hb+HR7mSkg: folds
ApHP7ouup365XIUFBdEDxg said, "KK?"
bkXkL3pmapikPQQRNPZSEA: calls $1
e2+sK/yjnj94rXOKoxPP2A: folds
ApHP7ouup365XIUFBdEDxg: calls $0.50
*** FLOP *** [Qs 4c 9h]
ApHP7ouup365XIUFBdEDxg: checks
HWcfp1hY1hqvrddzW3/FQw: bets $1
bkXkL3pmapikPQQRNPZSEA: raises $1 to $2
ApHP7ouup365XIUFBdEDxg: folds
HWcfp1hY1hqvrddzW3/FQw: folds
bkXkL3pmapikPQQRNPZSEA collected $5 from pot
*** SUMMARY ***
Total pot $5.25 | Rake $0.25
Board [Qs 4c 9h]
Seat 1: IYd5zG8k7vdBNVHbHg2Pag folded before Flop (didn't bet)
Seat 2: uw9QayAAxLM3Hb+HR7mSkg folded before Flop (didn't bet)
Seat 3: bkXkL3pmapikPQQRNPZSEA (button) collected ($5)
Seat 4: e2+sK/yjnj94rXOKoxPP2A (small blind) folded before Flop
Seat 5: ApHP7ouup365XIUFBdEDxg (big blind) folded on the Flop
Seat 6: 1xBtrSVBbgFH/viUWKqQeg folded before Flop (didn't bet)
Seat 7: HWcfp1hY1hqvrddzW3/FQw folded on the Flop
Seat 8: ji04uOybxCdpdefzlUQeKQ folded before Flop (didn't bet)



PokerStars Game #59941041908:  Hold'em No Limit ($0.25/$0.50) - 2009/07/01 1:23:59 ET
Table '3FhG0gl3kMX3wBEEqj+wnQ' 9-max Seat #9 is the button
Seat 1: bxLSulbgr8LmKNjOzw8URg ($49.55 in chips)
Seat 2: vacmVLJJECYI6HjAynFcpg ($52.10 in chips)
Seat 3: YXCE3WOZi8g2sIf3y/plVw ($50 in chips)
Seat 4: e2+sK/yjnj94rXOKoxPP2A ($70.25 in chips)
Seat 5: XcLXSUMHSpshK/7Lh0M4Vg ($10 in chips)
Seat 6: 997ViqAtWn1FPjJqcffwcA ($110.55 in chips)
Seat 7: mSD1pginDsyHG5PDfqzphw ($13.75 in chips)
Seat 8: j3K/Jujr7PY4ZM2RZvlH6A ($46.65 in chips)
Seat 9: KA0tkubTlbhmo4ju+qgXPg ($45.10 in chips)
bxLSulbgr8LmKNjOzw8URg: posts small blind $0.25
vacmVLJJECYI6HjAynFcpg: posts big blind $0.50
*** HOLE CARDS ***
YXCE3WOZi8g2sIf3y/plVw: raises $0.50 to $1
e2+sK/yjnj94rXOKoxPP2A: folds
XcLXSUMHSpshK/7Lh0M4Vg: folds
997ViqAtWn1FPjJqcffwcA: folds
mSD1pginDsyHG5PDfqzphw: folds
j3K/Jujr7PY4ZM2RZvlH6A: raises $2.50 to $3.50
KA0tkubTlbhmo4ju+qgXPg: folds
bxLSulbgr8LmKNjOzw8URg: folds
vacmVLJJECYI6HjAynFcpg: folds
YXCE3WOZi8g2sIf3y/plVw: calls $2.50
*** FLOP *** [Ah 3d 3s]
YXCE3WOZi8g2sIf3y/plVw: checks
j3K/Jujr7PY4ZM2RZvlH6A: bets $2.50
YXCE3WOZi8g2sIf3y/plVw: folds
j3K/Jujr7PY4ZM2RZvlH6A collected $7.40 from pot
j3K/Jujr7PY4ZM2RZvlH6A: doesn't show hand
*** SUMMARY ***
Total pot $7.75 | Rake $0.35
Board [Ah 3d 3s]
Seat 1: bxLSulbgr8LmKNjOzw8URg (small blind) folded before Flop
Seat 2: vacmVLJJECYI6HjAynFcpg (big blind) folded before Flop
Seat 3: YXCE3WOZi8g2sIf3y/plVw folded on the Flop
Seat 4: e2+sK/yjnj94rXOKoxPP2A folded before Flop (didn't bet)
Seat 5: XcLXSUMHSpshK/7Lh0M4Vg folded before Flop (didn't bet)
Seat 6: 997ViqAtWn1FPjJqcffwcA folded before Flop (didn't bet)
Seat 7: mSD1pginDsyHG5PDfqzphw folded before Flop (didn't bet)
Seat 8: j3K/Jujr7PY4ZM2RZvlH6A collected ($7.40)
Seat 9: KA0tkubTlbhmo4ju+qgXPg (button) folded before Flop (didn't bet)



PokerStars Game #59941044098:  Hold'em No Limit ($0.25/$0.50) - 2009/07/01 1:24:03 ET
Table 'BCN5su+SsXiy1zRMJi0SJw' 6-max Seat #2 is the button
Seat 1: GxXV09ciXaOxyY2H5aMIIw ($49.05 in chips)
Seat 2: ehFNAevCQri3trWxV6FJdA ($58.30 in chips)
Seat 3: kwgv5lNhiFrfONXCshzxlA ($42.45 in chips)
Seat 5: kxPhs4ePFqMy52CInAJ2aw ($50 in chips)
Seat 6: b2symlOdL7+0c9Pj4N/KlA ($58.25 in chips)
kwgv5lNhiFrfONXCshzxlA: posts small blind $0.25
kxPhs4ePFqMy52CInAJ2aw: posts big blind $0.50
*** HOLE CARDS ***
b2symlOdL7+0c9Pj4N/KlA: folds
GxXV09ciXaOxyY2H5aMIIw: folds
ehFNAevCQri3trWxV6FJdA: calls $0.50
kwgv5lNhiFrfONXCshzxlA: calls $0.25
kxPhs4ePFqMy52CInAJ2aw: checks
*** FLOP *** [2d 6c 8c]
kwgv5lNhiFrfONXCshzxlA: bets $1
kxPhs4ePFqMy52CInAJ2aw: folds
ehFNAevCQri3trWxV6FJdA: folds
kwgv5lNhiFrfONXCshzxlA collected $1.45 from pot
*** SUMMARY ***
Total pot $1.50 | Rake $0.05
Board [2d 6c 8c]
Seat 1: GxXV09ciXaOxyY2H5aMIIw folded before Flop (didn't bet)
Seat 2: ehFNAevCQri3trWxV6FJdA (button) folded on the Flop
Seat 3: kwgv5lNhiFrfONXCshzxlA (small blind) collected ($1.45)
Seat 5: kxPhs4ePFqMy52CInAJ2aw (big blind) folded on the Flop
Seat 6: b2symlOdL7+0c9Pj4N/KlA folded before Flop (didn't bet)



PokerStars Game #59941044526:  Hold'em No Limit ($0.25/$0.50) - 2009/07/01 1:24:03 ET
Table 'fx6MqwfYAj/Rt86hBz2L3Q' 9-max Seat #5 is the button
Seat 1: v/4aX0ejnaIFK4ftDk2Lyg ($52.15 in chips)
Seat 2: C3rGXblctNcWI6JYPHhaEg ($41.30 in chips)
Seat 3: iadBi5AEt7gTBXbDSSnMYQ ($49.80 in chips)
Seat 5: iAISe3dVeua8PUn2wwgDHw ($62.15 in chips)
Seat 6: 5k9fvXD9suIgCxU4HLQjTw ($50 in chips)
Seat 7: SKnJuWHScqetA/qG5p+wCg ($30 in chips)
Seat 8: JYwJYYV9pM5KWdSiETl8rA ($63.25 in chips)
Seat 9: vO3QVRovWemcGMkm7ijAIA ($12.25 in chips)
5k9fvXD9suIgCxU4HLQjTw: posts small blind $0.25
SKnJuWHScqetA/qG5p+wCg: posts big blind $0.50
*** HOLE CARDS ***
JYwJYYV9pM5KWdSiETl8rA: folds
vO3QVRovWemcGMkm7ijAIA: folds
v/4aX0ejnaIFK4ftDk2Lyg: folds
C3rGXblctNcWI6JYPHhaEg: raises $0.80 to $1.30
iadBi5AEt7gTBXbDSSnMYQ: calls $1.30
iAISe3dVeua8PUn2wwgDHw: folds
5k9fvXD9suIgCxU4HLQjTw: calls $1.05
SKnJuWHScqetA/qG5p+wCg: calls $0.80
*** FLOP *** [Js 2c Qc]
5k9fvXD9suIgCxU4HLQjTw: checks
SKnJuWHScqetA/qG5p+wCg: checks
C3rGXblctNcWI6JYPHhaEg: bets $2.50
iadBi5AEt7gTBXbDSSnMYQ: calls $2.50
5k9fvXD9suIgCxU4HLQjTw: folds
SKnJuWHScqetA/qG5p+wCg: folds
*** TURN *** [Js 2c Qc] [5s]
C3rGXblctNcWI6JYPHhaEg: bets $2.50
iadBi5AEt7gTBXbDSSnMYQ: calls $2.50
*** RIVER *** [Js 2c Qc 5s] [2h]
C3rGXblctNcWI6JYPHhaEg: checks
iadBi5AEt7gTBXbDSSnMYQ: checks
*** SHOW DOWN ***
C3rGXblctNcWI6JYPHhaEg: shows [Kc Td] (a pair of Deuces)
iadBi5AEt7gTBXbDSSnMYQ: shows [Qd Ks] (two pair, Queens and Deuces)
iadBi5AEt7gTBXbDSSnMYQ collected $14.50 from pot
*** SUMMARY ***
Total pot $15.20 | Rake $0.70
Board [Js 2c Qc 5s 2h]
Seat 1: v/4aX0ejnaIFK4ftDk2Lyg folded before Flop (didn't bet)
Seat 2: C3rGXblctNcWI6JYPHhaEg showed [Kc Td] and lost with a pair of Deuces
Seat 3: iadBi5AEt7gTBXbDSSnMYQ showed [Qd Ks] and won ($14.50) with two pair, Queens and Deuces
Seat 5: iAISe3dVeua8PUn2wwgDHw (button) folded before Flop (didn't bet)
Seat 6: 5k9fvXD9suIgCxU4HLQjTw (small blind) folded on the Flop
Seat 7: SKnJuWHScqetA/qG5p+wCg (big blind) folded on the Flop
Seat 8: JYwJYYV9pM5KWdSiETl8rA folded before Flop (didn't bet)
Seat 9: vO3QVRovWemcGMkm7ijAIA folded before Flop (didn't bet)



PokerStars Game #59941044096:  Hold'em No Limit ($0.25/$0.50) - 2009/07/01 1:24:03 ET
Table 'c/CRn+68J3Y8KxD5g1ek2Q' 2-max Seat #2 is the button
Seat 1: 46qCyJ6evTkHo9al5sBMNA ($99.90 in chips)
Seat 2: BypVLsYQt3ePFm2xQL/dOA ($260.05 in chips)
BypVLsYQt3ePFm2xQL/dOA: posts small blind $0.25
46qCyJ6evTkHo9al5sBMNA: posts big blind $0.50
*** HOLE CARDS ***
BypVLsYQt3ePFm2xQL/dOA: calls $0.25
46qCyJ6evTkHo9al5sBMNA: raises $1 to $1.50
BypVLsYQt3ePFm2xQL/dOA: calls $1
*** FLOP *** [6s Qd 4d]
46qCyJ6evTkHo9al5sBMNA: checks
BypVLsYQt3ePFm2xQL/dOA: checks
*** TURN *** [6s Qd 4d] [Kd]
46qCyJ6evTkHo9al5sBMNA: bets $2.50
BypVLsYQt3ePFm2xQL/dOA: calls $2.50
*** RIVER *** [6s Qd 4d Kd] [2h]
46qCyJ6evTkHo9al5sBMNA: bets $5.50
BypVLsYQt3ePFm2xQL/dOA: folds
46qCyJ6evTkHo9al5sBMNA collected $7.65 from pot
46qCyJ6evTkHo9al5sBMNA: doesn't show hand
*** SUMMARY ***
Total pot $8 | Rake $0.35
Board [6s Qd 4d Kd 2h]
Seat 1: 46qCyJ6evTkHo9al5sBMNA (big blind) collected ($7.65)
Seat 2: BypVLsYQt3ePFm2xQL/dOA (button) (small blind) folded on the River



PokerStars Game #59941044740:  Hold'em No Limit ($0.25/$0.50) - 2009/07/01 1:24:04 ET
Table '8BQGgNetI1NOvWeu3gtMNw' 2-max Seat #2 is the button
Seat 1: bypIyrYcAAifLfhZpGlKLA ($70.25 in chips)
Seat 2: Z4HwehErEwzsv/noQlfUlg ($118.50 in chips)
Z4HwehErEwzsv/noQlfUlg: posts small blind $0.25
bypIyrYcAAifLfhZpGlKLA: posts big blind $0.50
*** HOLE CARDS ***
Z4HwehErEwzsv/noQlfUlg: raises $1.50 to $2
bypIyrYcAAifLfhZpGlKLA: raises $6 to $8
Z4HwehErEwzsv/noQlfUlg: calls $6
*** FLOP *** [Ad 6d Jh]
bypIyrYcAAifLfhZpGlKLA: bets $12.50
Z4HwehErEwzsv/noQlfUlg: calls $12.50
*** TURN *** [Ad 6d Jh] [3c]
bypIyrYcAAifLfhZpGlKLA: checks
Z4HwehErEwzsv/noQlfUlg: bets $50
bypIyrYcAAifLfhZpGlKLA: folds
Z4HwehErEwzsv/noQlfUlg collected $40.50 from pot
Z4HwehErEwzsv/noQlfUlg: doesn't show hand
*** SUMMARY ***
Total pot $41 | Rake $0.50
Board [Ad 6d Jh 3c]
Seat 1: bypIyrYcAAifLfhZpGlKLA (big blind) folded on the Turn
Seat 2: Z4HwehErEwzsv/noQlfUlg (button) (small blind) collected ($40.50)



PokerStars Game #59941047098:  Hold'em No Limit ($0.25/$0.50) - 2009/07/01 1:24:08 ET
Table 'Nz0Vr7WMHL2g5Uk7dDZjpw' 9-max Seat #4 is the button
Seat 3: hoglu9inkgs6zN573/bJag ($5.70 in chips)
Seat 4: E2518gp4aFz1+kAgmGqeEg ($12.25 in chips)
Seat 5: WGW0DgjBUXs1ylURHG8vnQ ($12.50 in chips)
Seat 6: 997ViqAtWn1FPjJqcffwcA ($58.05 in chips)
Seat 7: KPLH0gELgFe2OuAnhJFI5w ($26.20 in chips)
Seat 8: aoL+R/61Kxmw69ypuPrWAQ ($30 in chips)
Seat 9: mSD1pginDsyHG5PDfqzphw ($10 in chips)
WGW0DgjBUXs1ylURHG8vnQ: posts small blind $0.25
997ViqAtWn1FPjJqcffwcA: posts big blind $0.50
SegjDnMxWMujiD57ESNL+g: sits out
*** HOLE CARDS ***
9yMsdgReyOUerNsmTYCCDQ joins the table at seat #1
KPLH0gELgFe2OuAnhJFI5w has timed out
KPLH0gELgFe2OuAnhJFI5w: folds
KPLH0gELgFe2OuAnhJFI5w is sitting out
aoL+R/61Kxmw69ypuPrWAQ: calls $0.50
mSD1pginDsyHG5PDfqzphw: folds
hoglu9inkgs6zN573/bJag: folds
E2518gp4aFz1+kAgmGqeEg: folds
KPLH0gELgFe2OuAnhJFI5w has returned
WGW0DgjBUXs1ylURHG8vnQ: calls $0.25
997ViqAtWn1FPjJqcffwcA: checks
*** FLOP *** [8s 4d 7s]
WGW0DgjBUXs1ylURHG8vnQ: bets $1
997ViqAtWn1FPjJqcffwcA: folds
aoL+R/61Kxmw69ypuPrWAQ: calls $1
*** TURN *** [8s 4d 7s] [3c]
WGW0DgjBUXs1ylURHG8vnQ: bets $1
aoL+R/61Kxmw69ypuPrWAQ: calls $1
*** RIVER *** [8s 4d 7s 3c] [Ah]
WGW0DgjBUXs1ylURHG8vnQ: bets $1
aoL+R/61Kxmw69ypuPrWAQ: folds
WGW0DgjBUXs1ylURHG8vnQ collected $5.25 from pot
WGW0DgjBUXs1ylURHG8vnQ: doesn't show hand
*** SUMMARY ***
Total pot $5.50 | Rake $0.25
Board [8s 4d 7s 3c Ah]
Seat 3: hoglu9inkgs6zN573/bJag folded before Flop (didn't bet)
Seat 4: E2518gp4aFz1+kAgmGqeEg (button) folded before Flop (didn't bet)
Seat 5: WGW0DgjBUXs1ylURHG8vnQ (small blind) collected ($5.25)
Seat 6: 997ViqAtWn1FPjJqcffwcA (big blind) folded on the Flop
Seat 7: KPLH0gELgFe2OuAnhJFI5w folded before Flop (didn't bet)
Seat 8: aoL+R/61Kxmw69ypuPrWAQ folded on the River
Seat 9: mSD1pginDsyHG5PDfqzphw folded before Flop (didn't bet)



PokerStars Game #59941047562:  Hold'em No Limit ($0.25/$0.50) - 2009/07/01 1:24:09 ET
Table '+dXkOAQyS8j9PQZusUTMpg' 2-max Seat #2 is the button
Seat 1: Teld4PDKla7C8/Wfu2DSkg ($47.55 in chips)
Seat 2: +zI4bP23YIjMkUHqeN2xfw ($30.60 in chips)
+zI4bP23YIjMkUHqeN2xfw: posts small blind $0.25
Teld4PDKla7C8/Wfu2DSkg: posts big blind $0.50
*** HOLE CARDS ***
+zI4bP23YIjMkUHqeN2xfw: folds
Teld4PDKla7C8/Wfu2DSkg collected $0.50 from pot
Teld4PDKla7C8/Wfu2DSkg: doesn't show hand
*** SUMMARY ***
Total pot $0.50 | Rake $0
Seat 1: Teld4PDKla7C8/Wfu2DSkg (big blind) collected ($0.50)
Seat 2: +zI4bP23YIjMkUHqeN2xfw (button) (small blind) folded before Flop



PokerStars Game #59941048072:  Hold'em No Limit ($0.25/$0.50) - 2009/07/01 1:24:10 ET
Table '9ojijpRcYQSQTh6xI+haUA' 2-max Seat #2 is the button
Seat 1: 8hLWxFrmTLKeWL475NK4rQ ($18.05 in chips)
Seat 2: TitTV+fFCcBZWOERdytydA ($20.30 in chips)
TitTV+fFCcBZWOERdytydA: posts small blind $0.25
8hLWxFrmTLKeWL475NK4rQ: posts big blind $0.50
*** HOLE CARDS ***
TitTV+fFCcBZWOERdytydA: raises $1.50 to $2
8hLWxFrmTLKeWL475NK4rQ: folds
TitTV+fFCcBZWOERdytydA collected $1 from pot
*** SUMMARY ***
Total pot $1 | Rake $0
Seat 1: 8hLWxFrmTLKeWL475NK4rQ (big blind) folded before Flop
Seat 2: TitTV+fFCcBZWOERdytydA (button) (small blind) collected ($1)



PokerStars Game #59941048216:  Hold'em No Limit ($0.25/$0.50) - 2009/07/01 1:24:10 ET
Table 'X6IRCRTh+20gjz8aubWnwA' 9-max Seat #4 is the button
Seat 1: E2518gp4aFz1+kAgmGqeEg ($10.25 in chips)
Seat 2: HZkVla4kK2SI42CVrPZ/ig ($3 in chips)
Seat 3: SWv01peOe69QQRvhQTqjQw ($13.30 in chips)
Seat 4: M3JFBNQ8Bbw3FBZ/18MuXw ($23.15 in chips)
Seat 5: uw9QayAAxLM3Hb+HR7mSkg ($9.75 in chips)
Seat 6: Qi/PyOsKwaqtKIg0H+7ELg ($10 in chips)
Seat 7: cFHQjKQOOKTUzoilhrXHLg ($13.75 in chips)
Seat 8: HxeBVq06/3Bh/H986sgdbw ($47 in chips)
Seat 9: M+7+BTmX5vZatHVuoRB1nA ($44.80 in chips)
uw9QayAAxLM3Hb+HR7mSkg: posts small blind $0.25
Qi/PyOsKwaqtKIg0H+7ELg: posts big blind $0.50
*** HOLE CARDS ***
cFHQjKQOOKTUzoilhrXHLg: calls $0.50
HxeBVq06/3Bh/H986sgdbw: folds
M+7+BTmX5vZatHVuoRB1nA: folds
E2518gp4aFz1+kAgmGqeEg: folds
HZkVla4kK2SI42CVrPZ/ig: raises $2.50 to $3 and is all-in
SWv01peOe69QQRvhQTqjQw: folds
M3JFBNQ8Bbw3FBZ/18MuXw: folds
uw9QayAAxLM3Hb+HR7mSkg: folds
Qi/PyOsKwaqtKIg0H+7ELg: folds
cFHQjKQOOKTUzoilhrXHLg: calls $2.50
*** FLOP *** [3c 5d 3h]
*** TURN *** [3c 5d 3h] [Ac]
*** RIVER *** [3c 5d 3h Ac] [2s]
*** SHOW DOWN ***
cFHQjKQOOKTUzoilhrXHLg: shows [3s 5s] (a full house, Threes full of Fives)
HZkVla4kK2SI42CVrPZ/ig: mucks hand
cFHQjKQOOKTUzoilhrXHLg collected $6.45 from pot
*** SUMMARY ***
Total pot $6.75 | Rake $0.30
Board [3c 5d 3h Ac 2s]
Seat 1: E2518gp4aFz1+kAgmGqeEg folded before Flop (didn't bet)
Seat 2: HZkVla4kK2SI42CVrPZ/ig mucked
Seat 3: SWv01peOe69QQRvhQTqjQw folded before Flop (didn't bet)
Seat 4: M3JFBNQ8Bbw3FBZ/18MuXw (button) folded before Flop (didn't bet)
Seat 5: uw9QayAAxLM3Hb+HR7mSkg (small blind) folded before Flop
Seat 6: Qi/PyOsKwaqtKIg0H+7ELg (big blind) folded before Flop
Seat 7: cFHQjKQOOKTUzoilhrXHLg showed [3s 5s] and won ($6.45) with a full house, Threes full of Fives
Seat 8: HxeBVq06/3Bh/H986sgdbw folded before Flop (didn't bet)
Seat 9: M+7+BTmX5vZatHVuoRB1nA folded before Flop (didn't bet)



PokerStars Game #59941049750:  Hold'em No Limit ($0.25/$0.50) - 2009/07/01 1:24:12 ET
Table 'lSisgp6H7Fg1hH5VfjEjYQ' 9-max Seat #8 is the button
Seat 1: 5k9fvXD9suIgCxU4HLQjTw ($55.85 in chips)
Seat 3: SKnJuWHScqetA/qG5p+wCg ($30 in chips)
Seat 4: bwv/rbH/hHhPhY6u9mu04w ($36.15 in chips)
Seat 5: mSD1pginDsyHG5PDfqzphw ($13 in chips)
Seat 6: +k7T5ocke8UwavtgUHm+Cg ($63.40 in chips)
Seat 7: IDtNLR9uFCDdjNsJWMHA5Q ($27.15 in chips)
Seat 8: a4JDWmpFQkL10XfAyuF51A ($12.25 in chips)
Seat 9: YzeKFbJVLmJGTgNH3ySQlw ($7.70 in chips)
YzeKFbJVLmJGTgNH3ySQlw: posts small blind $0.25
5k9fvXD9suIgCxU4HLQjTw: posts big blind $0.50
*** HOLE CARDS ***
SKnJuWHScqetA/qG5p+wCg: folds
bwv/rbH/hHhPhY6u9mu04w: folds
mSD1pginDsyHG5PDfqzphw: folds
+k7T5ocke8UwavtgUHm+Cg: raises $1 to $1.50
IDtNLR9uFCDdjNsJWMHA5Q: folds
a4JDWmpFQkL10XfAyuF51A: folds
YzeKFbJVLmJGTgNH3ySQlw: folds
5k9fvXD9suIgCxU4HLQjTw: calls $1
*** FLOP *** [2h Js 3h]
5k9fvXD9suIgCxU4HLQjTw: checks
+k7T5ocke8UwavtgUHm+Cg: bets $1.50
5k9fvXD9suIgCxU4HLQjTw: folds
+k7T5ocke8UwavtgUHm+Cg collected $3.10 from pot
+k7T5ocke8UwavtgUHm+Cg: doesn't show hand
*** SUMMARY ***
Total pot $3.25 | Rake $0.15
Board [2h Js 3h]
Seat 1: 5k9fvXD9suIgCxU4HLQjTw (big blind) folded on the Flop
Seat 3: SKnJuWHScqetA/qG5p+wCg folded before Flop (didn't bet)
Seat 4: bwv/rbH/hHhPhY6u9mu04w folded before Flop (didn't bet)
Seat 5: mSD1pginDsyHG5PDfqzphw folded before Flop (didn't bet)
Seat 6: +k7T5ocke8UwavtgUHm+Cg collected ($3.10)
Seat 7: IDtNLR9uFCDdjNsJWMHA5Q folded before Flop (didn't bet)
Seat 8: a4JDWmpFQkL10XfAyuF51A (button) folded before Flop (didn't bet)
Seat 9: YzeKFbJVLmJGTgNH3ySQlw (small blind) folded before Flop



PokerStars Game #59941051136:  Hold'em No Limit ($0.25/$0.50) - 2009/07/01 1:24:15 ET
Table '+dXkOAQyS8j9PQZusUTMpg' 2-max Seat #1 is the button
Seat 1: Teld4PDKla7C8/Wfu2DSkg ($47.80 in chips)
Seat 2: +zI4bP23YIjMkUHqeN2xfw ($30.35 in chips)
Teld4PDKla7C8/Wfu2DSkg: posts small blind $0.25
+zI4bP23YIjMkUHqeN2xfw: posts big blind $0.50
*** HOLE CARDS ***
Teld4PDKla7C8/Wfu2DSkg: raises $1 to $1.50
+zI4bP23YIjMkUHqeN2xfw: folds
Teld4PDKla7C8/Wfu2DSkg collected $1 from pot
Teld4PDKla7C8/Wfu2DSkg: doesn't show hand
*** SUMMARY ***
Total pot $1 | Rake $0
Seat 1: Teld4PDKla7C8/Wfu2DSkg (button) (small blind) collected ($1)
Seat 2: +zI4bP23YIjMkUHqeN2xfw (big blind) folded before Flop



PokerStars Game #59941052434:  Hold'em No Limit ($0.25/$0.50) - 2009/07/01 1:24:17 ET
Table '2lPOwetm4cfkZPbTmGPH/w' 2-max Seat #2 is the button
Seat 1: vUGdApqS8J/GJE2gaVWl1w ($11 in chips)
Seat 2: FeErMt4Gvt/3PH2oB/pn4A ($10 in chips)
FeErMt4Gvt/3PH2oB/pn4A: posts small blind $0.25
vUGdApqS8J/GJE2gaVWl1w: posts big blind $0.50
*** HOLE CARDS ***
FeErMt4Gvt/3PH2oB/pn4A: calls $0.25
vUGdApqS8J/GJE2gaVWl1w: raises $0.50 to $1
FeErMt4Gvt/3PH2oB/pn4A: calls $0.50
*** FLOP *** [As 8c Ks]
vUGdApqS8J/GJE2gaVWl1w: bets $1
FeErMt4Gvt/3PH2oB/pn4A: folds
vUGdApqS8J/GJE2gaVWl1w collected $1.90 from pot
*** SUMMARY ***
Total pot $2 | Rake $0.10
Board [As 8c Ks]
Seat 1: vUGdApqS8J/GJE2gaVWl1w (big blind) collected ($1.90)
Seat 2: FeErMt4Gvt/3PH2oB/pn4A (button) (small blind) folded on the Flop



PokerStars Game #59941052376:  Hold'em No Limit ($0.25/$0.50) - 2009/07/01 1:24:17 ET
Table 'kgbJRsxfv64KrErDRBAkcw' 6-max Seat #3 is the button
Seat 1: VamsyhlFzXGF6/ydo0BHeA ($20.55 in chips)
Seat 2: AdS8BJMOheS01zjCDfPMFg ($65.25 in chips)
Seat 3: c4MNIaIyPMOMxrgT8FT5nA ($230.30 in chips)
Seat 4: 2igtJLmvIZ+HqX4XPgMPZA ($50 in chips)
Seat 5: eUBBn2R56C1IQ6Cs/vitwg ($50 in chips)
Seat 6: 1b+2BbjMN8qhR1WPqdE9VQ ($59.65 in chips)
2igtJLmvIZ+HqX4XPgMPZA: posts small blind $0.25
eUBBn2R56C1IQ6Cs/vitwg: posts big blind $0.50
*** HOLE CARDS ***
1b+2BbjMN8qhR1WPqdE9VQ: folds
VamsyhlFzXGF6/ydo0BHeA: folds
AdS8BJMOheS01zjCDfPMFg: folds
c4MNIaIyPMOMxrgT8FT5nA: calls $0.50
2igtJLmvIZ+HqX4XPgMPZA: folds
eUBBn2R56C1IQ6Cs/vitwg: checks
*** FLOP *** [4c 8c 4s]
eUBBn2R56C1IQ6Cs/vitwg: checks
c4MNIaIyPMOMxrgT8FT5nA: bets $3.50
eUBBn2R56C1IQ6Cs/vitwg: calls $3.50
*** TURN *** [4c 8c 4s] [7d]
eUBBn2R56C1IQ6Cs/vitwg: bets $6
c4MNIaIyPMOMxrgT8FT5nA: folds
eUBBn2R56C1IQ6Cs/vitwg collected $7.85 from pot
*** SUMMARY ***
Total pot $8.25 | Rake $0.40
Board [4c 8c 4s 7d]
Seat 1: VamsyhlFzXGF6/ydo0BHeA folded before Flop (didn't bet)
Seat 2: AdS8BJMOheS01zjCDfPMFg folded before Flop (didn't bet)
Seat 3: c4MNIaIyPMOMxrgT8FT5nA (button) folded on the Turn
Seat 4: 2igtJLmvIZ+HqX4XPgMPZA (small blind) folded before Flop
Seat 5: eUBBn2R56C1IQ6Cs/vitwg (big blind) collected ($7.85)
Seat 6: 1b+2BbjMN8qhR1WPqdE9VQ folded before Flop (didn't bet)



PokerStars Game #59941054242:  Hold'em No Limit ($0.25/$0.50) - 2009/07/01 1:24:20 ET
Table 'B+sqsfj6d6zXicNfaseTaw' 2-max Seat #1 is the button
Seat 1: +4GNcSsecmapVGSdV0mUPA ($157.15 in chips)
Seat 2: Lv5RmpRe6LtPkBzM9Gpo5A ($70.55 in chips)
+4GNcSsecmapVGSdV0mUPA: posts small blind $0.25
Lv5RmpRe6LtPkBzM9Gpo5A: posts big blind $0.50
*** HOLE CARDS ***
+4GNcSsecmapVGSdV0mUPA: raises $2.50 to $3
Lv5RmpRe6LtPkBzM9Gpo5A: raises $4 to $7
+4GNcSsecmapVGSdV0mUPA: calls $4
*** FLOP *** [2s 6d 2h]
Lv5RmpRe6LtPkBzM9Gpo5A: bets $6
+4GNcSsecmapVGSdV0mUPA: calls $6
*** TURN *** [2s 6d 2h] [8d]
Lv5RmpRe6LtPkBzM9Gpo5A: bets $57.55 and is all-in
+4GNcSsecmapVGSdV0mUPA: folds
Lv5RmpRe6LtPkBzM9Gpo5A collected $25.50 from pot
*** SUMMARY ***
Total pot $26 | Rake $0.50
Board [2s 6d 2h 8d]
Seat 1: +4GNcSsecmapVGSdV0mUPA (button) (small blind) folded on the Turn
Seat 2: Lv5RmpRe6LtPkBzM9Gpo5A (big blind) collected ($25.50)



PokerStars Game #59941055104:  Hold'em No Limit ($0.25/$0.50) - 2009/07/01 1:24:21 ET
Table 'ofnd8S4IdIPph1Cbn+x7hA' 2-max Seat #1 is the button
Seat 1: PY4NvRocCFPfSIHKbh0euQ ($32.30 in chips)
Seat 2: l5WbyJ/iWYjpeCC6GCYY6w ($60.75 in chips)
PY4NvRocCFPfSIHKbh0euQ: posts small blind $0.25
l5WbyJ/iWYjpeCC6GCYY6w: posts big blind $0.50
*** HOLE CARDS ***
PY4NvRocCFPfSIHKbh0euQ: folds
l5WbyJ/iWYjpeCC6GCYY6w collected $0.50 from pot
l5WbyJ/iWYjpeCC6GCYY6w: doesn't show hand
*** SUMMARY ***
Total pot $0.50 | Rake $0
Seat 1: PY4NvRocCFPfSIHKbh0euQ (button) (small blind) folded before Flop
Seat 2: l5WbyJ/iWYjpeCC6GCYY6w (big blind) collected ($0.50)



PokerStars Game #59941055020:  Hold'em No Limit ($0.25/$0.50) - 2009/07/01 1:24:21 ET
Table 'iq+aXfWVQRdV0u8SRTYUEg' 9-max Seat #8 is the button
Seat 1: 3yl8Q6QaLfGtyhN4/pEFgQ ($76.30 in chips)
Seat 2: J9N0lxHFd/Js2S0xZLbsIQ ($36.30 in chips)
Seat 5: 997ViqAtWn1FPjJqcffwcA ($50 in chips)
Seat 6: bTJ0WgoxefTPxIoycS7uoA ($31.90 in chips)
Seat 7: SKnJuWHScqetA/qG5p+wCg ($31.55 in chips)
Seat 8: /DtIHuxEH+3tzKefmSV+Mw ($36.55 in chips)
Seat 9: olE1Z2rKWAV8+tGqmIBK9g ($22.05 in chips)
olE1Z2rKWAV8+tGqmIBK9g: posts small blind $0.25
3yl8Q6QaLfGtyhN4/pEFgQ: posts big blind $0.50
Qi/PyOsKwaqtKIg0H+7ELg: sits out
vHYT5s323LpajBj+2c9zbQ: sits out
*** HOLE CARDS ***
J9N0lxHFd/Js2S0xZLbsIQ: folds
997ViqAtWn1FPjJqcffwcA: folds
bTJ0WgoxefTPxIoycS7uoA: folds
SKnJuWHScqetA/qG5p+wCg: folds
/DtIHuxEH+3tzKefmSV+Mw: folds
olE1Z2rKWAV8+tGqmIBK9g: calls $0.25
3yl8Q6QaLfGtyhN4/pEFgQ: checks
*** FLOP *** [Jh Js Th]
olE1Z2rKWAV8+tGqmIBK9g: bets $0.50
3yl8Q6QaLfGtyhN4/pEFgQ: calls $0.50
*** TURN *** [Jh Js Th] [8h]
olE1Z2rKWAV8+tGqmIBK9g: bets $0.50
3yl8Q6QaLfGtyhN4/pEFgQ: folds
olE1Z2rKWAV8+tGqmIBK9g collected $1.95 from pot
*** SUMMARY ***
Total pot $2 | Rake $0.05
Board [Jh Js Th 8h]
Seat 1: 3yl8Q6QaLfGtyhN4/pEFgQ (big blind) folded on the Turn
Seat 2: J9N0lxHFd/Js2S0xZLbsIQ folded before Flop (didn't bet)
Seat 5: 997ViqAtWn1FPjJqcffwcA folded before Flop (didn't bet)
Seat 6: bTJ0WgoxefTPxIoycS7uoA folded before Flop (didn't bet)
Seat 7: SKnJuWHScqetA/qG5p+wCg folded before Flop (didn't bet)
Seat 8: /DtIHuxEH+3tzKefmSV+Mw (button) folded before Flop (didn't bet)
Seat 9: olE1Z2rKWAV8+tGqmIBK9g (small blind) collected ($1.95)



PokerStars Game #59941056744:  Hold'em No Limit ($0.25/$0.50) - 2009/07/01 1:24:24 ET
Table 'tyR5AZNKV8Aadbrnrnlg7g' 6-max Seat #5 is the button
Seat 1: BgOXYI0yYSN1ULC4FqsNkg ($96.05 in chips)
Seat 2: BAjwVL+zKKd0s0fAWstzQQ ($6.45 in chips)
Seat 3: JFLrYNyQmwPhRQAtoSAuyA ($50 in chips)
Seat 4: 4QfsCWthT/vSLirorNXqtg ($86.70 in chips)
Seat 5: GUnvMULl2qFOO1yenu1UBw ($77.25 in chips)
Seat 6: 498aWaGsW4uGfuWl+2FCGw ($70.30 in chips)
498aWaGsW4uGfuWl+2FCGw: posts small blind $0.25
BgOXYI0yYSN1ULC4FqsNkg: posts big blind $0.50
*** HOLE CARDS ***
498aWaGsW4uGfuWl+2FCGw said, "wow"
BAjwVL+zKKd0s0fAWstzQQ: folds
JFLrYNyQmwPhRQAtoSAuyA: folds
4QfsCWthT/vSLirorNXqtg: folds
498aWaGsW4uGfuWl+2FCGw said, "nice fing hand"
GUnvMULl2qFOO1yenu1UBw: raises $1 to $1.50
498aWaGsW4uGfuWl+2FCGw: folds
BgOXYI0yYSN1ULC4FqsNkg: folds
GUnvMULl2qFOO1yenu1UBw collected $1.25 from pot
GUnvMULl2qFOO1yenu1UBw: doesn't show hand
*** SUMMARY ***
Total pot $1.25 | Rake $0
Seat 1: BgOXYI0yYSN1ULC4FqsNkg (big blind) folded before Flop
Seat 2: BAjwVL+zKKd0s0fAWstzQQ folded before Flop (didn't bet)
Seat 3: JFLrYNyQmwPhRQAtoSAuyA folded before Flop (didn't bet)
Seat 4: 4QfsCWthT/vSLirorNXqtg folded before Flop (didn't bet)
Seat 5: GUnvMULl2qFOO1yenu1UBw (button) collected ($1.25)
Seat 6: 498aWaGsW4uGfuWl+2FCGw (small blind) folded before Flop



PokerStars Game #59941056422:  Hold'em No Limit ($0.25/$0.50) - 2009/07/01 1:24:24 ET
Table '+dXkOAQyS8j9PQZusUTMpg' 2-max Seat #2 is the button
Seat 1: Teld4PDKla7C8/Wfu2DSkg ($48.30 in chips)
Seat 2: +zI4bP23YIjMkUHqeN2xfw ($29.85 in chips)
+zI4bP23YIjMkUHqeN2xfw: posts small blind $0.25
Teld4PDKla7C8/Wfu2DSkg: posts big blind $0.50
*** HOLE CARDS ***
+zI4bP23YIjMkUHqeN2xfw: folds
Teld4PDKla7C8/Wfu2DSkg collected $0.50 from pot
Teld4PDKla7C8/Wfu2DSkg: doesn't show hand
*** SUMMARY ***
Total pot $0.50 | Rake $0
Seat 1: Teld4PDKla7C8/Wfu2DSkg (big blind) collected ($0.50)
Seat 2: +zI4bP23YIjMkUHqeN2xfw (button) (small blind) folded before Flop



PokerStars Game #59941056790:  Hold'em No Limit ($0.25/$0.50) - 2009/07/01 1:24:24 ET
Table '9ojijpRcYQSQTh6xI+haUA' 2-max Seat #1 is the button
Seat 1: 8hLWxFrmTLKeWL475NK4rQ ($17.55 in chips)
Seat 2: TitTV+fFCcBZWOERdytydA ($20.80 in chips)
8hLWxFrmTLKeWL475NK4rQ: posts small blind $0.25
TitTV+fFCcBZWOERdytydA: posts big blind $0.50
*** HOLE CARDS ***
8hLWxFrmTLKeWL475NK4rQ: raises $1 to $1.50
TitTV+fFCcBZWOERdytydA: calls $1
*** FLOP *** [Ks As 2s]
TitTV+fFCcBZWOERdytydA: checks
8hLWxFrmTLKeWL475NK4rQ: bets $1
TitTV+fFCcBZWOERdytydA: calls $1
*** TURN *** [Ks As 2s] [Js]
TitTV+fFCcBZWOERdytydA: checks
8hLWxFrmTLKeWL475NK4rQ: bets $2
TitTV+fFCcBZWOERdytydA: raises $3.50 to $5.50
8hLWxFrmTLKeWL475NK4rQ: folds
TitTV+fFCcBZWOERdytydA collected $8.60 from pot
TitTV+fFCcBZWOERdytydA: doesn't show hand
*** SUMMARY ***
Total pot $9 | Rake $0.40
Board [Ks As 2s Js]
Seat 1: 8hLWxFrmTLKeWL475NK4rQ (button) (small blind) folded on the Turn
Seat 2: TitTV+fFCcBZWOERdytydA (big blind) collected ($8.60)



PokerStars Game #59941058708:  Hold'em No Limit ($0.25/$0.50) - 2009/07/01 1:24:28 ET
Table 'ofnd8S4IdIPph1Cbn+x7hA' 2-max Seat #2 is the button
Seat 1: PY4NvRocCFPfSIHKbh0euQ ($32.05 in chips)
Seat 2: l5WbyJ/iWYjpeCC6GCYY6w ($61 in chips)
l5WbyJ/iWYjpeCC6GCYY6w: posts small blind $0.25
PY4NvRocCFPfSIHKbh0euQ: posts big blind $0.50
*** HOLE CARDS ***
l5WbyJ/iWYjpeCC6GCYY6w: folds
PY4NvRocCFPfSIHKbh0euQ collected $0.50 from pot
*** SUMMARY ***
Total pot $0.50 | Rake $0
Seat 1: PY4NvRocCFPfSIHKbh0euQ (big blind) collected ($0.50)
Seat 2: l5WbyJ/iWYjpeCC6GCYY6w (button) (small blind) folded before Flop



PokerStars Game #59941059822:  Hold'em No Limit ($0.25/$0.50) - 2009/07/01 1:24:29 ET
Table '2lPOwetm4cfkZPbTmGPH/w' 2-max Seat #1 is the button
Seat 1: vUGdApqS8J/GJE2gaVWl1w ($11.90 in chips)
Seat 2: FeErMt4Gvt/3PH2oB/pn4A ($9 in chips)
vUGdApqS8J/GJE2gaVWl1w: posts small blind $0.25
FeErMt4Gvt/3PH2oB/pn4A: posts big blind $0.50
*** HOLE CARDS ***
vUGdApqS8J/GJE2gaVWl1w: calls $0.25
FeErMt4Gvt/3PH2oB/pn4A: checks
*** FLOP *** [Qh 7c Td]
FeErMt4Gvt/3PH2oB/pn4A: bets $0.50
vUGdApqS8J/GJE2gaVWl1w: raises $0.50 to $1
FeErMt4Gvt/3PH2oB/pn4A: calls $0.50
*** TURN *** [Qh 7c Td] [8c]
FeErMt4Gvt/3PH2oB/pn4A: checks
vUGdApqS8J/GJE2gaVWl1w: checks
*** RIVER *** [Qh 7c Td 8c] [3h]
FeErMt4Gvt/3PH2oB/pn4A: checks
vUGdApqS8J/GJE2gaVWl1w: checks
*** SHOW DOWN ***
FeErMt4Gvt/3PH2oB/pn4A: shows [6d Tc] (a pair of Tens)
vUGdApqS8J/GJE2gaVWl1w: shows [Ts Kc] (a pair of Tens - King kicker)
vUGdApqS8J/GJE2gaVWl1w collected $2.90 from pot
*** SUMMARY ***
Total pot $3 | Rake $0.10
Board [Qh 7c Td 8c 3h]
Seat 1: vUGdApqS8J/GJE2gaVWl1w (button) (small blind) showed [Ts Kc] and won ($2.90) with a pair of Tens
Seat 2: FeErMt4Gvt/3PH2oB/pn4A (big blind) showed [6d Tc] and lost with a pair of Tens



PokerStars Game #59941059824:  Hold'em No Limit ($0.25/$0.50) - 2009/07/01 1:24:29 ET
Table '+dXkOAQyS8j9PQZusUTMpg' 2-max Seat #1 is the button
Seat 1: Teld4PDKla7C8/Wfu2DSkg ($48.55 in chips)
Seat 2: +zI4bP23YIjMkUHqeN2xfw ($29.60 in chips)
Teld4PDKla7C8/Wfu2DSkg: posts small blind $0.25
+zI4bP23YIjMkUHqeN2xfw: posts big blind $0.50
*** HOLE CARDS ***
Teld4PDKla7C8/Wfu2DSkg: folds
+zI4bP23YIjMkUHqeN2xfw collected $0.50 from pot
*** SUMMARY ***
Total pot $0.50 | Rake $0
Seat 1: Teld4PDKla7C8/Wfu2DSkg (button) (small blind) folded before Flop
Seat 2: +zI4bP23YIjMkUHqeN2xfw (big blind) collected ($0.50)



PokerStars Game #59941059580:  Hold'em No Limit ($0.25/$0.50) - 2009/07/01 1:24:29 ET
Table 'ibNfFy0bCzuBaUORla0aGw' 9-max Seat #9 is the button
Seat 1: xZCXQSXlrZkp3pZizzVXCw ($50.05 in chips)
Seat 2: 90Wb75h3W1BRpbqVnuk8gw ($50.75 in chips)
Seat 3: AjV5McH1KMMclY26QdLM5w ($27.10 in chips)
Seat 5: GIJAc9kPrLZHLSX8Q6i99w ($26.80 in chips)
Seat 6: H8cPaCtX7d6meGUVSM5sxw ($57.85 in chips)
Seat 7: HZkVla4kK2SI42CVrPZ/ig ($13 in chips)
Seat 8: Ja2jdidjip2UeJnRzmzAAQ ($47 in chips)
Seat 9: pFtzb1sR4b0d1aw6aIRgDg ($57.65 in chips)
xZCXQSXlrZkp3pZizzVXCw: posts small blind $0.25
90Wb75h3W1BRpbqVnuk8gw: posts big blind $0.50
nhDtFZ2uuvm5hDKG7ZVEpA: sits out
*** HOLE CARDS ***
AjV5McH1KMMclY26QdLM5w: folds
GIJAc9kPrLZHLSX8Q6i99w: folds
H8cPaCtX7d6meGUVSM5sxw: folds
HZkVla4kK2SI42CVrPZ/ig: raises $1 to $1.50
Ja2jdidjip2UeJnRzmzAAQ: folds
pFtzb1sR4b0d1aw6aIRgDg: folds
xZCXQSXlrZkp3pZizzVXCw: folds
90Wb75h3W1BRpbqVnuk8gw: folds
HZkVla4kK2SI42CVrPZ/ig collected $1.25 from pot
*** SUMMARY ***
Total pot $1.25 | Rake $0
Seat 1: xZCXQSXlrZkp3pZizzVXCw (small blind) folded before Flop
Seat 2: 90Wb75h3W1BRpbqVnuk8gw (big blind) folded before Flop
Seat 3: AjV5McH1KMMclY26QdLM5w folded before Flop (didn't bet)
Seat 5: GIJAc9kPrLZHLSX8Q6i99w folded before Flop (didn't bet)
Seat 6: H8cPaCtX7d6meGUVSM5sxw folded before Flop (didn't bet)
Seat 7: HZkVla4kK2SI42CVrPZ/ig collected ($1.25)
Seat 8: Ja2jdidjip2UeJnRzmzAAQ folded before Flop (didn't bet)
Seat 9: pFtzb1sR4b0d1aw6aIRgDg (button) folded before Flop (didn't bet)



PokerStars Game #59941060898:  Hold'em No Limit ($0.25/$0.50) - 2009/07/01 1:24:31 ET
Table '8BQGgNetI1NOvWeu3gtMNw' 2-max Seat #1 is the button
Seat 1: bypIyrYcAAifLfhZpGlKLA ($50 in chips)
Seat 2: Z4HwehErEwzsv/noQlfUlg ($138.50 in chips)
bypIyrYcAAifLfhZpGlKLA: posts small blind $0.25
Z4HwehErEwzsv/noQlfUlg: posts big blind $0.50
*** HOLE CARDS ***
bypIyrYcAAifLfhZpGlKLA: raises $1 to $1.50
Z4HwehErEwzsv/noQlfUlg: raises $1 to $2.50
bypIyrYcAAifLfhZpGlKLA: raises $7 to $9.50
Z4HwehErEwzsv/noQlfUlg: folds
bypIyrYcAAifLfhZpGlKLA collected $5 from pot
bypIyrYcAAifLfhZpGlKLA: doesn't show hand
*** SUMMARY ***
Total pot $5 | Rake $0
Seat 1: bypIyrYcAAifLfhZpGlKLA (button) (small blind) collected ($5)
Seat 2: Z4HwehErEwzsv/noQlfUlg (big blind) folded before Flop



PokerStars Game #59941061096:  Hold'em No Limit ($0.25/$0.50) - 2009/07/01 1:24:32 ET
Table 'NCiXr0d5CEKBQr/cZgLhbA' 9-max Seat #6 is the button
Seat 1: pFtzb1sR4b0d1aw6aIRgDg ($55.70 in chips)
Seat 2: AjV5McH1KMMclY26QdLM5w ($25 in chips)
Seat 3: xZCXQSXlrZkp3pZizzVXCw ($94.45 in chips)
Seat 4: 5k9fvXD9suIgCxU4HLQjTw ($53.95 in chips)
Seat 5: Ja2jdidjip2UeJnRzmzAAQ ($36.60 in chips)
Seat 6: t1qL+wRXOwTLB4TBbcw2QA ($49.25 in chips)
Seat 7: dXhO5i7KOoVcsGqbklD+jw ($29.50 in chips)
Seat 8: 1MJUKc3cc0QmUoz1JZLR2w ($63.95 in chips)
Seat 9: 4WLZvqBn5qv5tds5kt5A1Q ($69.05 in chips)
dXhO5i7KOoVcsGqbklD+jw: posts small blind $0.25
1MJUKc3cc0QmUoz1JZLR2w: posts big blind $0.50
*** HOLE CARDS ***
4WLZvqBn5qv5tds5kt5A1Q: folds
pFtzb1sR4b0d1aw6aIRgDg: folds
AjV5McH1KMMclY26QdLM5w: folds
xZCXQSXlrZkp3pZizzVXCw: raises $1 to $1.50
5k9fvXD9suIgCxU4HLQjTw: folds
Ja2jdidjip2UeJnRzmzAAQ: folds
t1qL+wRXOwTLB4TBbcw2QA: calls $1.50
dXhO5i7KOoVcsGqbklD+jw: calls $1.25
1MJUKc3cc0QmUoz1JZLR2w: calls $1
*** FLOP *** [4c 5d 5c]
dXhO5i7KOoVcsGqbklD+jw: checks
1MJUKc3cc0QmUoz1JZLR2w: checks
xZCXQSXlrZkp3pZizzVXCw: bets $4.50
t1qL+wRXOwTLB4TBbcw2QA: folds
dXhO5i7KOoVcsGqbklD+jw: folds
1MJUKc3cc0QmUoz1JZLR2w: folds
xZCXQSXlrZkp3pZizzVXCw collected $5.70 from pot
*** SUMMARY ***
Total pot $6 | Rake $0.30
Board [4c 5d 5c]
Seat 1: pFtzb1sR4b0d1aw6aIRgDg folded before Flop (didn't bet)
Seat 2: AjV5McH1KMMclY26QdLM5w folded before Flop (didn't bet)
Seat 3: xZCXQSXlrZkp3pZizzVXCw collected ($5.70)
Seat 4: 5k9fvXD9suIgCxU4HLQjTw folded before Flop (didn't bet)
Seat 5: Ja2jdidjip2UeJnRzmzAAQ folded before Flop (didn't bet)
Seat 6: t1qL+wRXOwTLB4TBbcw2QA (button) folded on the Flop
Seat 7: dXhO5i7KOoVcsGqbklD+jw (small blind) folded on the Flop
Seat 8: 1MJUKc3cc0QmUoz1JZLR2w (big blind) folded on the Flop
Seat 9: 4WLZvqBn5qv5tds5kt5A1Q folded before Flop (didn't bet)



PokerStars Game #59941062246:  Hold'em No Limit ($0.25/$0.50) - 2009/07/01 1:24:33 ET
Table 'ofnd8S4IdIPph1Cbn+x7hA' 2-max Seat #1 is the button
Seat 1: PY4NvRocCFPfSIHKbh0euQ ($32.30 in chips)
Seat 2: l5WbyJ/iWYjpeCC6GCYY6w ($60.75 in chips)
PY4NvRocCFPfSIHKbh0euQ: posts small blind $0.25
l5WbyJ/iWYjpeCC6GCYY6w: posts big blind $0.50
*** HOLE CARDS ***
PY4NvRocCFPfSIHKbh0euQ: raises $1 to $1.50
l5WbyJ/iWYjpeCC6GCYY6w: folds
PY4NvRocCFPfSIHKbh0euQ collected $1 from pot
*** SUMMARY ***
Total pot $1 | Rake $0
Seat 1: PY4NvRocCFPfSIHKbh0euQ (button) (small blind) collected ($1)
Seat 2: l5WbyJ/iWYjpeCC6GCYY6w (big blind) folded before Flop



PokerStars Game #59941063490:  Hold'em No Limit ($0.25/$0.50) - 2009/07/01 1:24:35 ET
Table 'otvGDROEDdqsabxskT79qg' 9-max Seat #9 is the button
Seat 1: 8ehL7qlZzjgUh2H35iiWLw ($61.50 in chips)
Seat 2: cCjTzH9jio8607WzjcfXlg ($10.65 in chips)
Seat 3: +k7T5ocke8UwavtgUHm+Cg ($73.75 in chips)
Seat 4: MG90wfSJZnOejs/KD3vlQQ ($80.65 in chips)
Seat 5: E2518gp4aFz1+kAgmGqeEg ($12.20 in chips)
Seat 6: FFVKBJT0lZf+jFlgvy7ang ($40.70 in chips)
Seat 8: zE9cVigS2nW/Ljy4K4bUQA ($33.30 in chips)
Seat 9: KcY3X8YpD74Kw1RHkx/g4A ($30.90 in chips)
8ehL7qlZzjgUh2H35iiWLw: posts small blind $0.25
cCjTzH9jio8607WzjcfXlg: posts big blind $0.50
*** HOLE CARDS ***
+k7T5ocke8UwavtgUHm+Cg: folds
MG90wfSJZnOejs/KD3vlQQ: folds
E2518gp4aFz1+kAgmGqeEg: folds
FFVKBJT0lZf+jFlgvy7ang: calls $0.50
zE9cVigS2nW/Ljy4K4bUQA: folds
KcY3X8YpD74Kw1RHkx/g4A: folds
8ehL7qlZzjgUh2H35iiWLw: folds
cCjTzH9jio8607WzjcfXlg: checks
*** FLOP *** [3d Kh Tc]
cCjTzH9jio8607WzjcfXlg: checks
FFVKBJT0lZf+jFlgvy7ang: checks
*** TURN *** [3d Kh Tc] [4d]
cCjTzH9jio8607WzjcfXlg: checks
FFVKBJT0lZf+jFlgvy7ang: bets $1.50
cCjTzH9jio8607WzjcfXlg: calls $1.50
*** RIVER *** [3d Kh Tc 4d] [4s]
cCjTzH9jio8607WzjcfXlg: checks
FFVKBJT0lZf+jFlgvy7ang: bets $2.50
cCjTzH9jio8607WzjcfXlg: calls $2.50
*** SHOW DOWN ***
FFVKBJT0lZf+jFlgvy7ang: shows [Ks Qc] (two pair, Kings and Fours)
cCjTzH9jio8607WzjcfXlg: mucks hand
FFVKBJT0lZf+jFlgvy7ang collected $8.80 from pot
*** SUMMARY ***
Total pot $9.25 | Rake $0.45
Board [3d Kh Tc 4d 4s]
Seat 1: 8ehL7qlZzjgUh2H35iiWLw (small blind) folded before Flop
Seat 2: cCjTzH9jio8607WzjcfXlg (big blind) mucked
Seat 3: +k7T5ocke8UwavtgUHm+Cg folded before Flop (didn't bet)
Seat 4: MG90wfSJZnOejs/KD3vlQQ folded before Flop (didn't bet)
Seat 5: E2518gp4aFz1+kAgmGqeEg folded before Flop (didn't bet)
Seat 6: FFVKBJT0lZf+jFlgvy7ang showed [Ks Qc] and won ($8.80) with two pair, Kings and Fours
Seat 8: zE9cVigS2nW/Ljy4K4bUQA folded before Flop (didn't bet)
Seat 9: KcY3X8YpD74Kw1RHkx/g4A (button) folded before Flop (didn't bet)



PokerStars Game #59941063796:  Hold'em No Limit ($0.25/$0.50) - 2009/07/01 1:24:36 ET
Table '+dXkOAQyS8j9PQZusUTMpg' 2-max Seat #2 is the button
Seat 1: Teld4PDKla7C8/Wfu2DSkg ($48.30 in chips)
Seat 2: +zI4bP23YIjMkUHqeN2xfw ($29.85 in chips)
+zI4bP23YIjMkUHqeN2xfw: posts small blind $0.25
Teld4PDKla7C8/Wfu2DSkg: posts big blind $0.50
*** HOLE CARDS ***
+zI4bP23YIjMkUHqeN2xfw: calls $0.25
Teld4PDKla7C8/Wfu2DSkg: checks
*** FLOP *** [Jc 3c 5c]
Teld4PDKla7C8/Wfu2DSkg: checks
+zI4bP23YIjMkUHqeN2xfw: checks
*** TURN *** [Jc 3c 5c] [9h]
Teld4PDKla7C8/Wfu2DSkg: checks
+zI4bP23YIjMkUHqeN2xfw: checks
*** RIVER *** [Jc 3c 5c 9h] [2d]
Teld4PDKla7C8/Wfu2DSkg: checks
+zI4bP23YIjMkUHqeN2xfw: checks
*** SHOW DOWN ***
Teld4PDKla7C8/Wfu2DSkg: shows [Tc 2h] (a pair of Deuces)
+zI4bP23YIjMkUHqeN2xfw: mucks hand
Teld4PDKla7C8/Wfu2DSkg collected $0.95 from pot
*** SUMMARY ***
Total pot $1 | Rake $0.05
Board [Jc 3c 5c 9h 2d]
Seat 1: Teld4PDKla7C8/Wfu2DSkg (big blind) showed [Tc 2h] and won ($0.95) with a pair of Deuces
Seat 2: +zI4bP23YIjMkUHqeN2xfw (button) (small blind) mucked



PokerStars Game #59941063990:  Hold'em No Limit ($0.25/$0.50) - 2009/07/01 1:24:36 ET
Table 'GfL/No5u5PoEnU39lP5pQg' 6-max Seat #5 is the button
Seat 1: 1WUCqNG+p+vfWRTXNu4ljw ($66 in chips)
Seat 2: uVwggSetzp7d+eVgowO3vg ($41.35 in chips)
Seat 3: 4pp9WxhGdbVbxCc9tlu0lw ($36.45 in chips)
Seat 4: r6u7MWSXF30/khcTYkrG9Q ($26.25 in chips)
Seat 5: M1KyQQvVPVuxqTAB8sR/zQ ($50 in chips)
Seat 6: kxPhs4ePFqMy52CInAJ2aw ($69.50 in chips)
kxPhs4ePFqMy52CInAJ2aw: posts small blind $0.25
1WUCqNG+p+vfWRTXNu4ljw: posts big blind $0.50
*** HOLE CARDS ***
uVwggSetzp7d+eVgowO3vg: folds
4pp9WxhGdbVbxCc9tlu0lw: folds
r6u7MWSXF30/khcTYkrG9Q: raises $1 to $1.50
M1KyQQvVPVuxqTAB8sR/zQ: folds
kxPhs4ePFqMy52CInAJ2aw: folds
1WUCqNG+p+vfWRTXNu4ljw: folds
r6u7MWSXF30/khcTYkrG9Q collected $1.25 from pot
*** SUMMARY ***
Total pot $1.25 | Rake $0
Seat 1: 1WUCqNG+p+vfWRTXNu4ljw (big blind) folded before Flop
Seat 2: uVwggSetzp7d+eVgowO3vg folded before Flop (didn't bet)
Seat 3: 4pp9WxhGdbVbxCc9tlu0lw folded before Flop (didn't bet)
Seat 4: r6u7MWSXF30/khcTYkrG9Q collected ($1.25)
Seat 5: M1KyQQvVPVuxqTAB8sR/zQ (button) folded before Flop (didn't bet)
Seat 6: kxPhs4ePFqMy52CInAJ2aw (small blind) folded before Flop



PokerStars Game #59941065726:  Hold'em No Limit ($0.25/$0.50) - 2009/07/01 1:24:39 ET
Table 'ofnd8S4IdIPph1Cbn+x7hA' 2-max Seat #2 is the button
Seat 1: PY4NvRocCFPfSIHKbh0euQ ($32.80 in chips)
Seat 2: l5WbyJ/iWYjpeCC6GCYY6w ($60.25 in chips)
l5WbyJ/iWYjpeCC6GCYY6w: posts small blind $0.25
PY4NvRocCFPfSIHKbh0euQ: posts big blind $0.50
*** HOLE CARDS ***
l5WbyJ/iWYjpeCC6GCYY6w: folds
PY4NvRocCFPfSIHKbh0euQ collected $0.50 from pot
*** SUMMARY ***
Total pot $0.50 | Rake $0
Seat 1: PY4NvRocCFPfSIHKbh0euQ (big blind) collected ($0.50)
Seat 2: l5WbyJ/iWYjpeCC6GCYY6w (button) (small blind) folded before Flop



PokerStars Game #59941065418:  Hold'em No Limit ($0.25/$0.50) - 2009/07/01 1:24:39 ET
Table 'c/CRn+68J3Y8KxD5g1ek2Q' 2-max Seat #1 is the button
Seat 1: 46qCyJ6evTkHo9al5sBMNA ($103.55 in chips)
Seat 2: BypVLsYQt3ePFm2xQL/dOA ($256.05 in chips)
46qCyJ6evTkHo9al5sBMNA: posts small blind $0.25
BypVLsYQt3ePFm2xQL/dOA: posts big blind $0.50
*** HOLE CARDS ***
46qCyJ6evTkHo9al5sBMNA: raises $0.50 to $1
BypVLsYQt3ePFm2xQL/dOA: calls $0.50
*** FLOP *** [3s 5s Ks]
BypVLsYQt3ePFm2xQL/dOA: checks
46qCyJ6evTkHo9al5sBMNA: checks
*** TURN *** [3s 5s Ks] [7h]
BypVLsYQt3ePFm2xQL/dOA: checks
46qCyJ6evTkHo9al5sBMNA: checks
*** RIVER *** [3s 5s Ks 7h] [9h]
BypVLsYQt3ePFm2xQL/dOA: checks
46qCyJ6evTkHo9al5sBMNA: checks
*** SHOW DOWN ***
BypVLsYQt3ePFm2xQL/dOA: shows [Ts 4d] (high card King)
46qCyJ6evTkHo9al5sBMNA: shows [2h 2s] (a pair of Deuces)
46qCyJ6evTkHo9al5sBMNA collected $1.90 from pot
*** SUMMARY ***
Total pot $2 | Rake $0.10
Board [3s 5s Ks 7h 9h]
Seat 1: 46qCyJ6evTkHo9al5sBMNA (button) (small blind) showed [2h 2s] and won ($1.90) with a pair of Deuces
Seat 2: BypVLsYQt3ePFm2xQL/dOA (big blind) showed [Ts 4d] and lost with high card King



PokerStars Game #59941065388:  Hold'em No Limit ($0.25/$0.50) - 2009/07/01 1:24:39 ET
Table 'B+sqsfj6d6zXicNfaseTaw' 2-max Seat #2 is the button
Seat 1: +4GNcSsecmapVGSdV0mUPA ($144.15 in chips)
Seat 2: Lv5RmpRe6LtPkBzM9Gpo5A ($83.05 in chips)
Lv5RmpRe6LtPkBzM9Gpo5A: posts small blind $0.25
+4GNcSsecmapVGSdV0mUPA: posts big blind $0.50
*** HOLE CARDS ***
Lv5RmpRe6LtPkBzM9Gpo5A: raises $1 to $1.50
+4GNcSsecmapVGSdV0mUPA: calls $1
*** FLOP *** [6c 7d Ks]
+4GNcSsecmapVGSdV0mUPA: checks
Lv5RmpRe6LtPkBzM9Gpo5A: checks
*** TURN *** [6c 7d Ks] [Th]
+4GNcSsecmapVGSdV0mUPA: checks
Lv5RmpRe6LtPkBzM9Gpo5A: bets $1
+4GNcSsecmapVGSdV0mUPA: calls $1
*** RIVER *** [6c 7d Ks Th] [Qd]
+4GNcSsecmapVGSdV0mUPA: checks
Lv5RmpRe6LtPkBzM9Gpo5A: checks
*** SHOW DOWN ***
+4GNcSsecmapVGSdV0mUPA: shows [9c Ah] (high card Ace)
Lv5RmpRe6LtPkBzM9Gpo5A: shows [Tc 8s] (a pair of Tens)
Lv5RmpRe6LtPkBzM9Gpo5A collected $4.80 from pot
*** SUMMARY ***
Total pot $5 | Rake $0.20
Board [6c 7d Ks Th Qd]
Seat 1: +4GNcSsecmapVGSdV0mUPA (big blind) showed [9c Ah] and lost with high card Ace
Seat 2: Lv5RmpRe6LtPkBzM9Gpo5A (button) (small blind) showed [Tc 8s] and won ($4.80) with a pair of Tens



PokerStars Game #59941067770:  Hold'em No Limit ($0.25/$0.50) - 2009/07/01 1:24:43 ET
Table '+z1aekfHkpp09pc8F9aViw' 6-max Seat #3 is the button
Seat 1: 7zFtlEn2NxyROFkJdZA/yg ($50 in chips)
Seat 2: OZ6OtYh5Y53MCH/p0QTn5g ($67.10 in chips)
Seat 3: uUznlIMFnRUvwrBhYF73KA ($140.25 in chips)
Seat 4: RowCSpSURHTOL/dcjg/Iug ($88.50 in chips)
Seat 5: 2igtJLmvIZ+HqX4XPgMPZA ($50 in chips)
Seat 6: GUnvMULl2qFOO1yenu1UBw ($50 in chips)
RowCSpSURHTOL/dcjg/Iug: posts small blind $0.25
2igtJLmvIZ+HqX4XPgMPZA: posts big blind $0.50
*** HOLE CARDS ***
GUnvMULl2qFOO1yenu1UBw: folds
7zFtlEn2NxyROFkJdZA/yg: folds
OZ6OtYh5Y53MCH/p0QTn5g: folds
uUznlIMFnRUvwrBhYF73KA: folds
uUznlIMFnRUvwrBhYF73KA leaves the table
RowCSpSURHTOL/dcjg/Iug: calls $0.25
URYNc7fPA23K2UfadQbnCA joins the table at seat #3
2igtJLmvIZ+HqX4XPgMPZA: checks
*** FLOP *** [Kd Jd 8d]
RowCSpSURHTOL/dcjg/Iug: checks
2igtJLmvIZ+HqX4XPgMPZA: bets $1
RowCSpSURHTOL/dcjg/Iug: calls $1
*** TURN *** [Kd Jd 8d] [8c]
RowCSpSURHTOL/dcjg/Iug: checks
2igtJLmvIZ+HqX4XPgMPZA: bets $2
RowCSpSURHTOL/dcjg/Iug: calls $2
*** RIVER *** [Kd Jd 8d 8c] [3c]
RowCSpSURHTOL/dcjg/Iug: checks
2igtJLmvIZ+HqX4XPgMPZA: checks
*** SHOW DOWN ***
RowCSpSURHTOL/dcjg/Iug: shows [Jh Tc] (two pair, Jacks and Eights)
2igtJLmvIZ+HqX4XPgMPZA: shows [2d Kc] (two pair, Kings and Eights)
2igtJLmvIZ+HqX4XPgMPZA collected $6.70 from pot
*** SUMMARY ***
Total pot $7 | Rake $0.30
Board [Kd Jd 8d 8c 3c]
Seat 1: 7zFtlEn2NxyROFkJdZA/yg folded before Flop (didn't bet)
Seat 2: OZ6OtYh5Y53MCH/p0QTn5g folded before Flop (didn't bet)
Seat 3: uUznlIMFnRUvwrBhYF73KA (button) folded before Flop (didn't bet)
Seat 4: RowCSpSURHTOL/dcjg/Iug (small blind) showed [Jh Tc] and lost with two pair, Jacks and Eights
Seat 5: 2igtJLmvIZ+HqX4XPgMPZA (big blind) showed [2d Kc] and won ($6.70) with two pair, Kings and Eights
Seat 6: GUnvMULl2qFOO1yenu1UBw folded before Flop (didn't bet)



PokerStars Game #59941068640:  Hold'em No Limit ($0.25/$0.50) - 2009/07/01 1:24:45 ET
Table 'tyR5AZNKV8Aadbrnrnlg7g' 6-max Seat #6 is the button
Seat 1: BgOXYI0yYSN1ULC4FqsNkg ($95.55 in chips)
Seat 2: BAjwVL+zKKd0s0fAWstzQQ ($6.45 in chips)
Seat 3: JFLrYNyQmwPhRQAtoSAuyA ($50 in chips)
Seat 4: 4QfsCWthT/vSLirorNXqtg ($86.70 in chips)
Seat 5: GUnvMULl2qFOO1yenu1UBw ($78 in chips)
Seat 6: 498aWaGsW4uGfuWl+2FCGw ($70.05 in chips)
BgOXYI0yYSN1ULC4FqsNkg: posts small blind $0.25
BAjwVL+zKKd0s0fAWstzQQ: posts big blind $0.50
*** HOLE CARDS ***
JFLrYNyQmwPhRQAtoSAuyA: folds
4QfsCWthT/vSLirorNXqtg: folds
GUnvMULl2qFOO1yenu1UBw: folds
498aWaGsW4uGfuWl+2FCGw: folds
498aWaGsW4uGfuWl+2FCGw said, "we could of lost that swo easy"
BgOXYI0yYSN1ULC4FqsNkg: raises $0.50 to $1
BAjwVL+zKKd0s0fAWstzQQ: raises $5.45 to $6.45 and is all-in
BgOXYI0yYSN1ULC4FqsNkg: folds
BAjwVL+zKKd0s0fAWstzQQ collected $2 from pot
*** SUMMARY ***
Total pot $2 | Rake $0
Seat 1: BgOXYI0yYSN1ULC4FqsNkg (small blind) folded before Flop
Seat 2: BAjwVL+zKKd0s0fAWstzQQ (big blind) collected ($2)
Seat 3: JFLrYNyQmwPhRQAtoSAuyA folded before Flop (didn't bet)
Seat 4: 4QfsCWthT/vSLirorNXqtg folded before Flop (didn't bet)
Seat 5: GUnvMULl2qFOO1yenu1UBw folded before Flop (didn't bet)
Seat 6: 498aWaGsW4uGfuWl+2FCGw (button) folded before Flop (didn't bet)



PokerStars Game #59941068746:  Hold'em No Limit ($0.25/$0.50) - 2009/07/01 1:24:45 ET
Table 'X6IRCRTh+20gjz8aubWnwA' 9-max Seat #5 is the button
Seat 1: E2518gp4aFz1+kAgmGqeEg ($10.25 in chips)
Seat 2: HZkVla4kK2SI42CVrPZ/ig ($10 in chips)
Seat 3: SWv01peOe69QQRvhQTqjQw ($13.30 in chips)
Seat 4: M3JFBNQ8Bbw3FBZ/18MuXw ($23.15 in chips)
Seat 5: uw9QayAAxLM3Hb+HR7mSkg ($9.50 in chips)
Seat 6: Qi/PyOsKwaqtKIg0H+7ELg ($9.50 in chips)
Seat 7: cFHQjKQOOKTUzoilhrXHLg ($17.20 in chips)
Seat 8: HxeBVq06/3Bh/H986sgdbw ($47 in chips)
Seat 9: M+7+BTmX5vZatHVuoRB1nA ($44.80 in chips)
Qi/PyOsKwaqtKIg0H+7ELg: posts small blind $0.25
cFHQjKQOOKTUzoilhrXHLg: posts big blind $0.50
*** HOLE CARDS ***
HxeBVq06/3Bh/H986sgdbw: folds
M+7+BTmX5vZatHVuoRB1nA: folds
E2518gp4aFz1+kAgmGqeEg: folds
HZkVla4kK2SI42CVrPZ/ig: folds
SWv01peOe69QQRvhQTqjQw: folds
M3JFBNQ8Bbw3FBZ/18MuXw: folds
uw9QayAAxLM3Hb+HR7mSkg: raises $9 to $9.50 and is all-in
Qi/PyOsKwaqtKIg0H+7ELg: folds
cFHQjKQOOKTUzoilhrXHLg: calls $9
*** FLOP *** [As 7s Qd]
*** TURN *** [As 7s Qd] [Jh]
*** RIVER *** [As 7s Qd Jh] [Js]
*** SHOW DOWN ***
cFHQjKQOOKTUzoilhrXHLg: shows [9h 9c] (two pair, Jacks and Nines)
uw9QayAAxLM3Hb+HR7mSkg: shows [Ah Ts] (two pair, Aces and Jacks)
uw9QayAAxLM3Hb+HR7mSkg collected $18.30 from pot
*** SUMMARY ***
Total pot $19.25 | Rake $0.95
Board [As 7s Qd Jh Js]
Seat 1: E2518gp4aFz1+kAgmGqeEg folded before Flop (didn't bet)
Seat 2: HZkVla4kK2SI42CVrPZ/ig folded before Flop (didn't bet)
Seat 3: SWv01peOe69QQRvhQTqjQw folded before Flop (didn't bet)
Seat 4: M3JFBNQ8Bbw3FBZ/18MuXw folded before Flop (didn't bet)
Seat 5: uw9QayAAxLM3Hb+HR7mSkg (button) showed [Ah Ts] and won ($18.30) with two pair, Aces and Jacks
Seat 6: Qi/PyOsKwaqtKIg0H+7ELg (small blind) folded before Flop
Seat 7: cFHQjKQOOKTUzoilhrXHLg (big blind) showed [9h 9c] and lost with two pair, Jacks and Nines
Seat 8: HxeBVq06/3Bh/H986sgdbw folded before Flop (didn't bet)
Seat 9: M+7+BTmX5vZatHVuoRB1nA folded before Flop (didn't bet)



PokerStars Game #59941069394:  Hold'em No Limit ($0.25/$0.50) - 2009/07/01 1:24:46 ET
Table '3FhG0gl3kMX3wBEEqj+wnQ' 9-max Seat #1 is the button
Seat 1: bxLSulbgr8LmKNjOzw8URg ($49.30 in chips)
Seat 2: vacmVLJJECYI6HjAynFcpg ($51.60 in chips)
Seat 3: YXCE3WOZi8g2sIf3y/plVw ($50 in chips)
Seat 4: e2+sK/yjnj94rXOKoxPP2A ($70.25 in chips)
Seat 5: XcLXSUMHSpshK/7Lh0M4Vg ($10 in chips)
Seat 6: 997ViqAtWn1FPjJqcffwcA ($110.55 in chips)
Seat 7: mSD1pginDsyHG5PDfqzphw ($13.75 in chips)
Seat 8: j3K/Jujr7PY4ZM2RZvlH6A ($50.55 in chips)
Seat 9: KA0tkubTlbhmo4ju+qgXPg ($45.10 in chips)
vacmVLJJECYI6HjAynFcpg: posts small blind $0.25
YXCE3WOZi8g2sIf3y/plVw: posts big blind $0.50
*** HOLE CARDS ***
e2+sK/yjnj94rXOKoxPP2A: folds
XcLXSUMHSpshK/7Lh0M4Vg: folds
997ViqAtWn1FPjJqcffwcA: folds
mSD1pginDsyHG5PDfqzphw: folds
j3K/Jujr7PY4ZM2RZvlH6A: raises $0.50 to $1
KA0tkubTlbhmo4ju+qgXPg: folds
KA0tkubTlbhmo4ju+qgXPg is sitting out
bxLSulbgr8LmKNjOzw8URg: folds
vacmVLJJECYI6HjAynFcpg: calls $0.75
YXCE3WOZi8g2sIf3y/plVw: folds
*** FLOP *** [Js Ad Ks]
vacmVLJJECYI6HjAynFcpg: checks
j3K/Jujr7PY4ZM2RZvlH6A: bets $1.50
vacmVLJJECYI6HjAynFcpg: folds
j3K/Jujr7PY4ZM2RZvlH6A collected $2.40 from pot
j3K/Jujr7PY4ZM2RZvlH6A: doesn't show hand
*** SUMMARY ***
Total pot $2.50 | Rake $0.10
Board [Js Ad Ks]
Seat 1: bxLSulbgr8LmKNjOzw8URg (button) folded before Flop (didn't bet)
Seat 2: vacmVLJJECYI6HjAynFcpg (small blind) folded on the Flop
Seat 3: YXCE3WOZi8g2sIf3y/plVw (big blind) folded before Flop
Seat 4: e2+sK/yjnj94rXOKoxPP2A folded before Flop (didn't bet)
Seat 5: XcLXSUMHSpshK/7Lh0M4Vg folded before Flop (didn't bet)
Seat 6: 997ViqAtWn1FPjJqcffwcA folded before Flop (didn't bet)
Seat 7: mSD1pginDsyHG5PDfqzphw folded before Flop (didn't bet)
Seat 8: j3K/Jujr7PY4ZM2RZvlH6A collected ($2.40)
Seat 9: KA0tkubTlbhmo4ju+qgXPg folded before Flop (didn't bet)



PokerStars Game #59941069776:  Hold'em No Limit ($0.25/$0.50) - 2009/07/01 1:24:46 ET
Table 'BCN5su+SsXiy1zRMJi0SJw' 6-max Seat #3 is the button
Seat 1: GxXV09ciXaOxyY2H5aMIIw ($49.05 in chips)
Seat 2: ehFNAevCQri3trWxV6FJdA ($57.80 in chips)
Seat 3: kwgv5lNhiFrfONXCshzxlA ($43.40 in chips)
Seat 5: kxPhs4ePFqMy52CInAJ2aw ($49.50 in chips)
Seat 6: b2symlOdL7+0c9Pj4N/KlA ($58.25 in chips)
kxPhs4ePFqMy52CInAJ2aw: posts small blind $0.25
b2symlOdL7+0c9Pj4N/KlA: posts big blind $0.50
*** HOLE CARDS ***
GxXV09ciXaOxyY2H5aMIIw: folds
ehFNAevCQri3trWxV6FJdA: folds
kwgv5lNhiFrfONXCshzxlA: folds
bbsK8j+tpuVRhBqDzHxf7w joins the table at seat #4
kxPhs4ePFqMy52CInAJ2aw: raises $1.50 to $2
b2symlOdL7+0c9Pj4N/KlA: calls $1.50
*** FLOP *** [4d Jd 3d]
kxPhs4ePFqMy52CInAJ2aw: bets $3
b2symlOdL7+0c9Pj4N/KlA: folds
kxPhs4ePFqMy52CInAJ2aw collected $3.80 from pot
kxPhs4ePFqMy52CInAJ2aw: doesn't show hand
*** SUMMARY ***
Total pot $4 | Rake $0.20
Board [4d Jd 3d]
Seat 1: GxXV09ciXaOxyY2H5aMIIw folded before Flop (didn't bet)
Seat 2: ehFNAevCQri3trWxV6FJdA folded before Flop (didn't bet)
Seat 3: kwgv5lNhiFrfONXCshzxlA (button) folded before Flop (didn't bet)
Seat 5: kxPhs4ePFqMy52CInAJ2aw (small blind) collected ($3.80)
Seat 6: b2symlOdL7+0c9Pj4N/KlA (big blind) folded on the Flop



PokerStars Game #59941069816:  Hold'em No Limit ($0.25/$0.50) - 2009/07/01 1:24:47 ET
Table 'ofnd8S4IdIPph1Cbn+x7hA' 2-max Seat #1 is the button
Seat 1: PY4NvRocCFPfSIHKbh0euQ ($33.05 in chips)
Seat 2: l5WbyJ/iWYjpeCC6GCYY6w ($60 in chips)
PY4NvRocCFPfSIHKbh0euQ: posts small blind $0.25
l5WbyJ/iWYjpeCC6GCYY6w: posts big blind $0.50
*** HOLE CARDS ***
PY4NvRocCFPfSIHKbh0euQ: raises $0.50 to $1
l5WbyJ/iWYjpeCC6GCYY6w: folds
PY4NvRocCFPfSIHKbh0euQ collected $1 from pot
*** SUMMARY ***
Total pot $1 | Rake $0
Seat 1: PY4NvRocCFPfSIHKbh0euQ (button) (small blind) collected ($1)
Seat 2: l5WbyJ/iWYjpeCC6GCYY6w (big blind) folded before Flop



PokerStars Game #59941069888:  Hold'em No Limit ($0.25/$0.50) - 2009/07/01 1:24:47 ET
Table 'ZYI3ZReBjdfKEYItkZHI6A' 9-max Seat #4 is the button
Seat 1: IYd5zG8k7vdBNVHbHg2Pag ($50.75 in chips)
Seat 2: uw9QayAAxLM3Hb+HR7mSkg ($9.25 in chips)
Seat 3: bkXkL3pmapikPQQRNPZSEA ($15.15 in chips)
Seat 4: e2+sK/yjnj94rXOKoxPP2A ($65.90 in chips)
Seat 5: ApHP7ouup365XIUFBdEDxg ($35 in chips)
Seat 6: 1xBtrSVBbgFH/viUWKqQeg ($30.20 in chips)
Seat 7: HWcfp1hY1hqvrddzW3/FQw ($14.75 in chips)
Seat 8: ji04uOybxCdpdefzlUQeKQ ($30.60 in chips)
ApHP7ouup365XIUFBdEDxg: posts small blind $0.25
1xBtrSVBbgFH/viUWKqQeg: posts big blind $0.50
HZkVla4kK2SI42CVrPZ/ig: sits out
*** HOLE CARDS ***
HWcfp1hY1hqvrddzW3/FQw: calls $0.50
ji04uOybxCdpdefzlUQeKQ: folds
IYd5zG8k7vdBNVHbHg2Pag: raises $1 to $1.50
uw9QayAAxLM3Hb+HR7mSkg: folds
bkXkL3pmapikPQQRNPZSEA: folds
e2+sK/yjnj94rXOKoxPP2A: folds
ApHP7ouup365XIUFBdEDxg: calls $1.25
1xBtrSVBbgFH/viUWKqQeg: folds
HWcfp1hY1hqvrddzW3/FQw: calls $1
*** FLOP *** [Ad 3s Jc]
ApHP7ouup365XIUFBdEDxg: checks
HWcfp1hY1hqvrddzW3/FQw: checks
IYd5zG8k7vdBNVHbHg2Pag: bets $3.50
ApHP7ouup365XIUFBdEDxg: calls $3.50
HWcfp1hY1hqvrddzW3/FQw: folds
*** TURN *** [Ad 3s Jc] [8c]
ApHP7ouup365XIUFBdEDxg: checks
IYd5zG8k7vdBNVHbHg2Pag: bets $8
ApHP7ouup365XIUFBdEDxg: calls $8
*** RIVER *** [Ad 3s Jc 8c] [Kh]
ApHP7ouup365XIUFBdEDxg: checks
IYd5zG8k7vdBNVHbHg2Pag: checks
*** SHOW DOWN ***
ApHP7ouup365XIUFBdEDxg: shows [5c 3c] (a pair of Threes)
IYd5zG8k7vdBNVHbHg2Pag: shows [Ac Js] (two pair, Aces and Jacks)
IYd5zG8k7vdBNVHbHg2Pag collected $26.65 from pot
*** SUMMARY ***
Total pot $28 | Rake $1.35
Board [Ad 3s Jc 8c Kh]
Seat 1: IYd5zG8k7vdBNVHbHg2Pag showed [Ac Js] and won ($26.65) with two pair, Aces and Jacks
Seat 2: uw9QayAAxLM3Hb+HR7mSkg folded before Flop (didn't bet)
Seat 3: bkXkL3pmapikPQQRNPZSEA folded before Flop (didn't bet)
Seat 4: e2+sK/yjnj94rXOKoxPP2A (button) folded before Flop (didn't bet)
Seat 5: ApHP7ouup365XIUFBdEDxg (small blind) showed [5c 3c] and lost with a pair of Threes
Seat 6: 1xBtrSVBbgFH/viUWKqQeg (big blind) folded before Flop
Seat 7: HWcfp1hY1hqvrddzW3/FQw folded on the Flop
Seat 8: ji04uOybxCdpdefzlUQeKQ folded before Flop (didn't bet)



PokerStars Game #59941070552:  Hold'em No Limit ($0.25/$0.50) - 2009/07/01 1:24:48 ET
Table 'hSTs/dUsYLgJQuF2Onp0MQ' 6-max Seat #5 is the button
Seat 1: 1WUCqNG+p+vfWRTXNu4ljw ($50 in chips)
Seat 3: lxIzoHy0RnkfFSODHC2liw ($50 in chips)
Seat 4: 2igtJLmvIZ+HqX4XPgMPZA ($80.15 in chips)
Seat 5: IBNygaT1aa9Z1uPdJJilwA ($53.70 in chips)
Seat 6: M1KyQQvVPVuxqTAB8sR/zQ ($86.95 in chips)
M1KyQQvVPVuxqTAB8sR/zQ: posts small blind $0.25
1WUCqNG+p+vfWRTXNu4ljw: posts big blind $0.50
Hdd4js36ITbTJ/QuVYwTlA: sits out
*** HOLE CARDS ***
lxIzoHy0RnkfFSODHC2liw: folds
2igtJLmvIZ+HqX4XPgMPZA: folds
IBNygaT1aa9Z1uPdJJilwA: folds
M1KyQQvVPVuxqTAB8sR/zQ: folds
1WUCqNG+p+vfWRTXNu4ljw collected $0.50 from pot
*** SUMMARY ***
Total pot $0.50 | Rake $0
Seat 1: 1WUCqNG+p+vfWRTXNu4ljw (big blind) collected ($0.50)
Seat 3: lxIzoHy0RnkfFSODHC2liw folded before Flop (didn't bet)
Seat 4: 2igtJLmvIZ+HqX4XPgMPZA folded before Flop (didn't bet)
Seat 5: IBNygaT1aa9Z1uPdJJilwA (button) folded before Flop (didn't bet)
Seat 6: M1KyQQvVPVuxqTAB8sR/zQ (small blind) folded before Flop



PokerStars Game #59941071034:  Hold'em No Limit ($0.25/$0.50) - 2009/07/01 1:24:49 ET
Table '2lPOwetm4cfkZPbTmGPH/w' 2-max Seat #2 is the button
Seat 1: vUGdApqS8J/GJE2gaVWl1w ($13.30 in chips)
Seat 2: FeErMt4Gvt/3PH2oB/pn4A ($7.50 in chips)
FeErMt4Gvt/3PH2oB/pn4A: posts small blind $0.25
vUGdApqS8J/GJE2gaVWl1w: posts big blind $0.50
*** HOLE CARDS ***
FeErMt4Gvt/3PH2oB/pn4A: calls $0.25
vUGdApqS8J/GJE2gaVWl1w: checks
*** FLOP *** [6d Qs Ks]
vUGdApqS8J/GJE2gaVWl1w: checks
FeErMt4Gvt/3PH2oB/pn4A: bets $0.50
vUGdApqS8J/GJE2gaVWl1w: folds
FeErMt4Gvt/3PH2oB/pn4A collected $0.95 from pot
FeErMt4Gvt/3PH2oB/pn4A: doesn't show hand
*** SUMMARY ***
Total pot $1 | Rake $0.05
Board [6d Qs Ks]
Seat 1: vUGdApqS8J/GJE2gaVWl1w (big blind) folded on the Flop
Seat 2: FeErMt4Gvt/3PH2oB/pn4A (button) (small blind) collected ($0.95)



PokerStars Game #59941072144:  Hold'em No Limit ($0.25/$0.50) - 2009/07/01 1:24:50 ET
Table '8BQGgNetI1NOvWeu3gtMNw' 2-max Seat #2 is the button
Seat 1: bypIyrYcAAifLfhZpGlKLA ($52.50 in chips)
Seat 2: Z4HwehErEwzsv/noQlfUlg ($136 in chips)
Z4HwehErEwzsv/noQlfUlg: posts small blind $0.25
bypIyrYcAAifLfhZpGlKLA: posts big blind $0.50
*** HOLE CARDS ***
Z4HwehErEwzsv/noQlfUlg: folds
bypIyrYcAAifLfhZpGlKLA collected $0.50 from pot
bypIyrYcAAifLfhZpGlKLA: doesn't show hand
*** SUMMARY ***
Total pot $0.50 | Rake $0
Seat 1: bypIyrYcAAifLfhZpGlKLA (big blind) collected ($0.50)
Seat 2: Z4HwehErEwzsv/noQlfUlg (button) (small blind) folded before Flop



PokerStars Game #59941073560:  Hold'em No Limit ($0.25/$0.50) - 2009/07/01 1:24:53 ET
Table 'ofnd8S4IdIPph1Cbn+x7hA' 2-max Seat #2 is the button
Seat 1: PY4NvRocCFPfSIHKbh0euQ ($33.55 in chips)
Seat 2: l5WbyJ/iWYjpeCC6GCYY6w ($59.50 in chips)
l5WbyJ/iWYjpeCC6GCYY6w: posts small blind $0.25
PY4NvRocCFPfSIHKbh0euQ: posts big blind $0.50
*** HOLE CARDS ***
l5WbyJ/iWYjpeCC6GCYY6w: raises $1 to $1.50
PY4NvRocCFPfSIHKbh0euQ: folds
l5WbyJ/iWYjpeCC6GCYY6w collected $1 from pot
l5WbyJ/iWYjpeCC6GCYY6w: doesn't show hand
*** SUMMARY ***
Total pot $1 | Rake $0
Seat 1: PY4NvRocCFPfSIHKbh0euQ (big blind) folded before Flop
Seat 2: l5WbyJ/iWYjpeCC6GCYY6w (button) (small blind) collected ($1)



PokerStars Game #59941074436:  Hold'em No Limit ($0.25/$0.50) - 2009/07/01 1:24:54 ET
Table '+dXkOAQyS8j9PQZusUTMpg' 2-max Seat #1 is the button
Seat 1: Teld4PDKla7C8/Wfu2DSkg ($48.75 in chips)
Seat 2: +zI4bP23YIjMkUHqeN2xfw ($29.35 in chips)
Teld4PDKla7C8/Wfu2DSkg: posts small blind $0.25
+zI4bP23YIjMkUHqeN2xfw: posts big blind $0.50
*** HOLE CARDS ***
Teld4PDKla7C8/Wfu2DSkg: raises $0.50 to $1
+zI4bP23YIjMkUHqeN2xfw: calls $0.50
*** FLOP *** [5h Td Tc]
+zI4bP23YIjMkUHqeN2xfw: checks
Teld4PDKla7C8/Wfu2DSkg: checks
*** TURN *** [5h Td Tc] [4c]
+zI4bP23YIjMkUHqeN2xfw: checks
Teld4PDKla7C8/Wfu2DSkg: checks
*** RIVER *** [5h Td Tc 4c] [Kh]
+zI4bP23YIjMkUHqeN2xfw: bets $1
Teld4PDKla7C8/Wfu2DSkg: folds
+zI4bP23YIjMkUHqeN2xfw collected $1.90 from pot
*** SUMMARY ***
Total pot $2 | Rake $0.10
Board [5h Td Tc 4c Kh]
Seat 1: Teld4PDKla7C8/Wfu2DSkg (button) (small blind) folded on the River
Seat 2: +zI4bP23YIjMkUHqeN2xfw (big blind) collected ($1.90)



PokerStars Game #59941074170:  Hold'em No Limit ($0.25/$0.50) - 2009/07/01 1:24:54 ET
Table 'kgbJRsxfv64KrErDRBAkcw' 6-max Seat #4 is the button
Seat 1: VamsyhlFzXGF6/ydo0BHeA ($20.55 in chips)
Seat 2: AdS8BJMOheS01zjCDfPMFg ($65.25 in chips)
Seat 3: c4MNIaIyPMOMxrgT8FT5nA ($226.30 in chips)
Seat 4: 2igtJLmvIZ+HqX4XPgMPZA ($50 in chips)
Seat 5: eUBBn2R56C1IQ6Cs/vitwg ($53.85 in chips)
Seat 6: 1b+2BbjMN8qhR1WPqdE9VQ ($59.65 in chips)
eUBBn2R56C1IQ6Cs/vitwg: posts small blind $0.25
1b+2BbjMN8qhR1WPqdE9VQ: posts big blind $0.50
*** HOLE CARDS ***
VamsyhlFzXGF6/ydo0BHeA: folds
AdS8BJMOheS01zjCDfPMFg: folds
c4MNIaIyPMOMxrgT8FT5nA: raises $3 to $3.50
2igtJLmvIZ+HqX4XPgMPZA: folds
eUBBn2R56C1IQ6Cs/vitwg: folds
1b+2BbjMN8qhR1WPqdE9VQ: calls $3
*** FLOP *** [Ad 2d 5h]
1b+2BbjMN8qhR1WPqdE9VQ: checks
c4MNIaIyPMOMxrgT8FT5nA: bets $5.50
1b+2BbjMN8qhR1WPqdE9VQ: folds
c4MNIaIyPMOMxrgT8FT5nA collected $6.90 from pot
c4MNIaIyPMOMxrgT8FT5nA: doesn't show hand
*** SUMMARY ***
Total pot $7.25 | Rake $0.35
Board [Ad 2d 5h]
Seat 1: VamsyhlFzXGF6/ydo0BHeA folded before Flop (didn't bet)
Seat 2: AdS8BJMOheS01zjCDfPMFg folded before Flop (didn't bet)
Seat 3: c4MNIaIyPMOMxrgT8FT5nA collected ($6.90)
Seat 4: 2igtJLmvIZ+HqX4XPgMPZA (button) folded before Flop (didn't bet)
Seat 5: eUBBn2R56C1IQ6Cs/vitwg (small blind) folded before Flop
Seat 6: 1b+2BbjMN8qhR1WPqdE9VQ (big blind) folded on the Flop



PokerStars Game #59941077234:  Hold'em No Limit ($0.25/$0.50) - 2009/07/01 1:24:59 ET
Table '8BQGgNetI1NOvWeu3gtMNw' 2-max Seat #1 is the button
Seat 1: bypIyrYcAAifLfhZpGlKLA ($52.75 in chips)
Seat 2: Z4HwehErEwzsv/noQlfUlg ($135.75 in chips)
bypIyrYcAAifLfhZpGlKLA: posts small blind $0.25
Z4HwehErEwzsv/noQlfUlg: posts big blind $0.50
*** HOLE CARDS ***
bypIyrYcAAifLfhZpGlKLA: folds
Z4HwehErEwzsv/noQlfUlg collected $0.50 from pot
Z4HwehErEwzsv/noQlfUlg: doesn't show hand
*** SUMMARY ***
Total pot $0.50 | Rake $0
Seat 1: bypIyrYcAAifLfhZpGlKLA (button) (small blind) folded before Flop
Seat 2: Z4HwehErEwzsv/noQlfUlg (big blind) collected ($0.50)



PokerStars Game #59941077666:  Hold'em No Limit ($0.25/$0.50) - 2009/07/01 1:25:00 ET
Table '2lPOwetm4cfkZPbTmGPH/w' 2-max Seat #1 is the button
Seat 1: vUGdApqS8J/GJE2gaVWl1w ($12.80 in chips)
Seat 2: FeErMt4Gvt/3PH2oB/pn4A ($7.95 in chips)
vUGdApqS8J/GJE2gaVWl1w: posts small blind $0.25
FeErMt4Gvt/3PH2oB/pn4A: posts big blind $0.50
*** HOLE CARDS ***
vUGdApqS8J/GJE2gaVWl1w: calls $0.25
FeErMt4Gvt/3PH2oB/pn4A: checks
*** FLOP *** [6s 7d 2c]
FeErMt4Gvt/3PH2oB/pn4A: checks
vUGdApqS8J/GJE2gaVWl1w: bets $0.50
FeErMt4Gvt/3PH2oB/pn4A: folds
FeErMt4Gvt/3PH2oB/pn4A leaves the table
vUGdApqS8J/GJE2gaVWl1w collected $0.95 from pot
*** SUMMARY ***
Total pot $1 | Rake $0.05
Board [6s 7d 2c]
Seat 1: vUGdApqS8J/GJE2gaVWl1w (button) (small blind) collected ($0.95)
Seat 2: FeErMt4Gvt/3PH2oB/pn4A (big blind) folded on the Flop



PokerStars Game #59941078042:  Hold'em No Limit ($0.25/$0.50) - 2009/07/01 1:25:00 ET
Table 'c/CRn+68J3Y8KxD5g1ek2Q' 2-max Seat #2 is the button
Seat 1: 46qCyJ6evTkHo9al5sBMNA ($104.45 in chips)
Seat 2: BypVLsYQt3ePFm2xQL/dOA ($255.05 in chips)
BypVLsYQt3ePFm2xQL/dOA: posts small blind $0.25
46qCyJ6evTkHo9al5sBMNA: posts big blind $0.50
*** HOLE CARDS ***
BypVLsYQt3ePFm2xQL/dOA: calls $0.25
46qCyJ6evTkHo9al5sBMNA: checks
*** FLOP *** [Th 3c Qd]
46qCyJ6evTkHo9al5sBMNA: checks
BypVLsYQt3ePFm2xQL/dOA: bets $1
46qCyJ6evTkHo9al5sBMNA: folds
BypVLsYQt3ePFm2xQL/dOA collected $0.95 from pot
BypVLsYQt3ePFm2xQL/dOA: doesn't show hand
*** SUMMARY ***
Total pot $1 | Rake $0.05
Board [Th 3c Qd]
Seat 1: 46qCyJ6evTkHo9al5sBMNA (big blind) folded on the Flop
Seat 2: BypVLsYQt3ePFm2xQL/dOA (button) (small blind) collected ($0.95)



PokerStars Game #59941078264:  Hold'em No Limit ($0.25/$0.50) - 2009/07/01 1:25:01 ET
Table '9ojijpRcYQSQTh6xI+haUA' 2-max Seat #2 is the button
Seat 1: 8hLWxFrmTLKeWL475NK4rQ ($13.05 in chips)
Seat 2: TitTV+fFCcBZWOERdytydA ($24.90 in chips)
TitTV+fFCcBZWOERdytydA: posts small blind $0.25
8hLWxFrmTLKeWL475NK4rQ: posts big blind $0.50
*** HOLE CARDS ***
TitTV+fFCcBZWOERdytydA: raises $0.50 to $1
8hLWxFrmTLKeWL475NK4rQ: calls $0.50
*** FLOP *** [Jc 4h 6d]
8hLWxFrmTLKeWL475NK4rQ: bets $0.50
TitTV+fFCcBZWOERdytydA: folds
8hLWxFrmTLKeWL475NK4rQ collected $1.90 from pot
*** SUMMARY ***
Total pot $2 | Rake $0.10
Board [Jc 4h 6d]
Seat 1: 8hLWxFrmTLKeWL475NK4rQ (big blind) collected ($1.90)
Seat 2: TitTV+fFCcBZWOERdytydA (button) (small blind) folded on the Flop



PokerStars Game #59941078158:  Hold'em No Limit ($0.25/$0.50) - 2009/07/01 1:25:01 ET
Table 'fx6MqwfYAj/Rt86hBz2L3Q' 9-max Seat #6 is the button
Seat 1: v/4aX0ejnaIFK4ftDk2Lyg ($52.15 in chips)
Seat 2: C3rGXblctNcWI6JYPHhaEg ($35 in chips)
Seat 3: iadBi5AEt7gTBXbDSSnMYQ ($58 in chips)
Seat 5: iAISe3dVeua8PUn2wwgDHw ($62.15 in chips)
Seat 6: 5k9fvXD9suIgCxU4HLQjTw ($50 in chips)
Seat 8: JYwJYYV9pM5KWdSiETl8rA ($63.25 in chips)
Seat 9: vO3QVRovWemcGMkm7ijAIA ($12.25 in chips)
SKnJuWHScqetA/qG5p+wCg: is sitting out
JYwJYYV9pM5KWdSiETl8rA: posts small blind $0.25
vO3QVRovWemcGMkm7ijAIA: posts big blind $0.50
*** HOLE CARDS ***
SKnJuWHScqetA/qG5p+wCg has returned
v/4aX0ejnaIFK4ftDk2Lyg: folds
C3rGXblctNcWI6JYPHhaEg: calls $0.50
SKnJuWHScqetA/qG5p+wCg leaves the table
iadBi5AEt7gTBXbDSSnMYQ: calls $0.50
iAISe3dVeua8PUn2wwgDHw: calls $0.50
5k9fvXD9suIgCxU4HLQjTw: calls $0.50
JYwJYYV9pM5KWdSiETl8rA: folds
mSD1pginDsyHG5PDfqzphw joins the table at seat #7
vO3QVRovWemcGMkm7ijAIA: checks
*** FLOP *** [Ac Td 6d]
vO3QVRovWemcGMkm7ijAIA: checks
C3rGXblctNcWI6JYPHhaEg: checks
iadBi5AEt7gTBXbDSSnMYQ: checks
iAISe3dVeua8PUn2wwgDHw: checks
5k9fvXD9suIgCxU4HLQjTw: checks
*** TURN *** [Ac Td 6d] [4h]
vO3QVRovWemcGMkm7ijAIA: checks
C3rGXblctNcWI6JYPHhaEg: bets $1.50
iadBi5AEt7gTBXbDSSnMYQ: calls $1.50
iAISe3dVeua8PUn2wwgDHw: folds
5k9fvXD9suIgCxU4HLQjTw: calls $1.50
vO3QVRovWemcGMkm7ijAIA: folds
*** RIVER *** [Ac Td 6d 4h] [3c]
C3rGXblctNcWI6JYPHhaEg: bets $13
iadBi5AEt7gTBXbDSSnMYQ: folds
5k9fvXD9suIgCxU4HLQjTw: folds
C3rGXblctNcWI6JYPHhaEg collected $6.90 from pot
C3rGXblctNcWI6JYPHhaEg: doesn't show hand
*** SUMMARY ***
Total pot $7.25 | Rake $0.35
Board [Ac Td 6d 4h 3c]
Seat 1: v/4aX0ejnaIFK4ftDk2Lyg folded before Flop (didn't bet)
Seat 2: C3rGXblctNcWI6JYPHhaEg collected ($6.90)
Seat 3: iadBi5AEt7gTBXbDSSnMYQ folded on the River
Seat 5: iAISe3dVeua8PUn2wwgDHw folded on the Turn
Seat 6: 5k9fvXD9suIgCxU4HLQjTw (button) folded on the River
Seat 8: JYwJYYV9pM5KWdSiETl8rA (small blind) folded before Flop
Seat 9: vO3QVRovWemcGMkm7ijAIA (big blind) folded on the Turn



PokerStars Game #59941078402:  Hold'em No Limit ($0.25/$0.50) - 2009/07/01 1:25:01 ET
Table 'lSisgp6H7Fg1hH5VfjEjYQ' 9-max Seat #9 is the button
Seat 1: 5k9fvXD9suIgCxU4HLQjTw ($54.35 in chips)
Seat 3: SKnJuWHScqetA/qG5p+wCg ($30 in chips)
Seat 4: bwv/rbH/hHhPhY6u9mu04w ($36.15 in chips)
Seat 5: mSD1pginDsyHG5PDfqzphw ($13 in chips)
Seat 6: +k7T5ocke8UwavtgUHm+Cg ($65 in chips)
Seat 7: IDtNLR9uFCDdjNsJWMHA5Q ($27.15 in chips)
Seat 8: a4JDWmpFQkL10XfAyuF51A ($12.25 in chips)
Seat 9: YzeKFbJVLmJGTgNH3ySQlw ($7.45 in chips)
5k9fvXD9suIgCxU4HLQjTw: posts small blind $0.25
SKnJuWHScqetA/qG5p+wCg: posts big blind $0.50
*** HOLE CARDS ***
bwv/rbH/hHhPhY6u9mu04w: folds
mSD1pginDsyHG5PDfqzphw: folds
+k7T5ocke8UwavtgUHm+Cg: raises $1 to $1.50
IDtNLR9uFCDdjNsJWMHA5Q: calls $1.50
a4JDWmpFQkL10XfAyuF51A: folds
YzeKFbJVLmJGTgNH3ySQlw: folds
5k9fvXD9suIgCxU4HLQjTw: folds
SKnJuWHScqetA/qG5p+wCg: folds
*** FLOP *** [Kd Ts 4d]
+k7T5ocke8UwavtgUHm+Cg: bets $2
IDtNLR9uFCDdjNsJWMHA5Q: raises $2.50 to $4.50
+k7T5ocke8UwavtgUHm+Cg: calls $2.50
*** TURN *** [Kd Ts 4d] [Jh]
+k7T5ocke8UwavtgUHm+Cg: checks
IDtNLR9uFCDdjNsJWMHA5Q: checks
*** RIVER *** [Kd Ts 4d Jh] [4c]
+k7T5ocke8UwavtgUHm+Cg: bets $7
IDtNLR9uFCDdjNsJWMHA5Q: folds
+k7T5ocke8UwavtgUHm+Cg collected $12.15 from pot
+k7T5ocke8UwavtgUHm+Cg: doesn't show hand
*** SUMMARY ***
Total pot $12.75 | Rake $0.60
Board [Kd Ts 4d Jh 4c]
Seat 1: 5k9fvXD9suIgCxU4HLQjTw (small blind) folded before Flop
Seat 3: SKnJuWHScqetA/qG5p+wCg (big blind) folded before Flop
Seat 4: bwv/rbH/hHhPhY6u9mu04w folded before Flop (didn't bet)
Seat 5: mSD1pginDsyHG5PDfqzphw folded before Flop (didn't bet)
Seat 6: +k7T5ocke8UwavtgUHm+Cg collected ($12.15)
Seat 7: IDtNLR9uFCDdjNsJWMHA5Q folded on the River
Seat 8: a4JDWmpFQkL10XfAyuF51A folded before Flop (didn't bet)
Seat 9: YzeKFbJVLmJGTgNH3ySQlw (button) folded before Flop (didn't bet)



PokerStars Game #59941079646:  Hold'em No Limit ($0.25/$0.50) - 2009/07/01 1:25:03 ET
Table 'GfL/No5u5PoEnU39lP5pQg' 6-max Seat #6 is the button
Seat 1: 1WUCqNG+p+vfWRTXNu4ljw ($65.50 in chips)
Seat 2: uVwggSetzp7d+eVgowO3vg ($41.35 in chips)
Seat 3: 4pp9WxhGdbVbxCc9tlu0lw ($36.45 in chips)
Seat 4: r6u7MWSXF30/khcTYkrG9Q ($27 in chips)
Seat 5: M1KyQQvVPVuxqTAB8sR/zQ ($50 in chips)
Seat 6: kxPhs4ePFqMy52CInAJ2aw ($69.25 in chips)
1WUCqNG+p+vfWRTXNu4ljw: posts small blind $0.25
uVwggSetzp7d+eVgowO3vg: posts big blind $0.50
*** HOLE CARDS ***
4pp9WxhGdbVbxCc9tlu0lw: raises $0.50 to $1
r6u7MWSXF30/khcTYkrG9Q: folds
M1KyQQvVPVuxqTAB8sR/zQ: folds
kxPhs4ePFqMy52CInAJ2aw: calls $1
1WUCqNG+p+vfWRTXNu4ljw: folds
uVwggSetzp7d+eVgowO3vg: calls $0.50
*** FLOP *** [Ts 2d 9c]
uVwggSetzp7d+eVgowO3vg: checks
4pp9WxhGdbVbxCc9tlu0lw: bets $1.50
kxPhs4ePFqMy52CInAJ2aw: calls $1.50
uVwggSetzp7d+eVgowO3vg: folds
*** TURN *** [Ts 2d 9c] [5c]
4pp9WxhGdbVbxCc9tlu0lw: bets $1.50
kxPhs4ePFqMy52CInAJ2aw: calls $1.50
*** RIVER *** [Ts 2d 9c 5c] [Qs]
4pp9WxhGdbVbxCc9tlu0lw: bets $2
kxPhs4ePFqMy52CInAJ2aw: folds
4pp9WxhGdbVbxCc9tlu0lw collected $8.85 from pot
*** SUMMARY ***
Total pot $9.25 | Rake $0.40
Board [Ts 2d 9c 5c Qs]
Seat 1: 1WUCqNG+p+vfWRTXNu4ljw (small blind) folded before Flop
Seat 2: uVwggSetzp7d+eVgowO3vg (big blind) folded on the Flop
Seat 3: 4pp9WxhGdbVbxCc9tlu0lw collected ($8.85)
Seat 4: r6u7MWSXF30/khcTYkrG9Q folded before Flop (didn't bet)
Seat 5: M1KyQQvVPVuxqTAB8sR/zQ folded before Flop (didn't bet)
Seat 6: kxPhs4ePFqMy52CInAJ2aw (button) folded on the River



PokerStars Game #59941079664:  Hold'em No Limit ($0.25/$0.50) - 2009/07/01 1:25:03 ET
Table 'B+sqsfj6d6zXicNfaseTaw' 2-max Seat #1 is the button
Seat 1: +4GNcSsecmapVGSdV0mUPA ($141.65 in chips)
Seat 2: Lv5RmpRe6LtPkBzM9Gpo5A ($85.35 in chips)
+4GNcSsecmapVGSdV0mUPA: posts small blind $0.25
Lv5RmpRe6LtPkBzM9Gpo5A: posts big blind $0.50
*** HOLE CARDS ***
+4GNcSsecmapVGSdV0mUPA: calls $0.25
Lv5RmpRe6LtPkBzM9Gpo5A: checks
*** FLOP *** [Ks 4s 9c]
Lv5RmpRe6LtPkBzM9Gpo5A: checks
+4GNcSsecmapVGSdV0mUPA: bets $1
Lv5RmpRe6LtPkBzM9Gpo5A: folds
+4GNcSsecmapVGSdV0mUPA collected $0.95 from pot
+4GNcSsecmapVGSdV0mUPA: doesn't show hand
*** SUMMARY ***
Total pot $1 | Rake $0.05
Board [Ks 4s 9c]
Seat 1: +4GNcSsecmapVGSdV0mUPA (button) (small blind) collected ($0.95)
Seat 2: Lv5RmpRe6LtPkBzM9Gpo5A (big blind) folded on the Flop



PokerStars Game #59941080126:  Hold'em No Limit ($0.25/$0.50) - 2009/07/01 1:25:04 ET
Table 'hSTs/dUsYLgJQuF2Onp0MQ' 6-max Seat #6 is the button
Seat 1: 1WUCqNG+p+vfWRTXNu4ljw ($50.25 in chips)
Seat 2: Hdd4js36ITbTJ/QuVYwTlA ($50 in chips)
Seat 3: lxIzoHy0RnkfFSODHC2liw ($50 in chips)
Seat 4: 2igtJLmvIZ+HqX4XPgMPZA ($80.15 in chips)
Seat 5: IBNygaT1aa9Z1uPdJJilwA ($53.70 in chips)
Seat 6: M1KyQQvVPVuxqTAB8sR/zQ ($86.70 in chips)
1WUCqNG+p+vfWRTXNu4ljw: posts small blind $0.25
Hdd4js36ITbTJ/QuVYwTlA: posts big blind $0.50
*** HOLE CARDS ***
lxIzoHy0RnkfFSODHC2liw: folds
2igtJLmvIZ+HqX4XPgMPZA: folds
IBNygaT1aa9Z1uPdJJilwA: folds
M1KyQQvVPVuxqTAB8sR/zQ: raises $1 to $1.50
1WUCqNG+p+vfWRTXNu4ljw: folds
Hdd4js36ITbTJ/QuVYwTlA: calls $1
*** FLOP *** [Ah 6c 8c]
Hdd4js36ITbTJ/QuVYwTlA: bets $2.50
M1KyQQvVPVuxqTAB8sR/zQ: calls $2.50
*** TURN *** [Ah 6c 8c] [6h]
Hdd4js36ITbTJ/QuVYwTlA: bets $5.50
M1KyQQvVPVuxqTAB8sR/zQ: calls $5.50
*** RIVER *** [Ah 6c 8c 6h] [6d]
Hdd4js36ITbTJ/QuVYwTlA: checks
M1KyQQvVPVuxqTAB8sR/zQ: checks
*** SHOW DOWN ***
Hdd4js36ITbTJ/QuVYwTlA: shows [5h 2d] (three of a kind, Sixes)
M1KyQQvVPVuxqTAB8sR/zQ: shows [Qc Jc] (three of a kind, Sixes - Ace+Queen kicker)
M1KyQQvVPVuxqTAB8sR/zQ collected $18.35 from pot
*** SUMMARY ***
Total pot $19.25 | Rake $0.90
Board [Ah 6c 8c 6h 6d]
Seat 1: 1WUCqNG+p+vfWRTXNu4ljw (small blind) folded before Flop
Seat 2: Hdd4js36ITbTJ/QuVYwTlA (big blind) showed [5h 2d] and lost with three of a kind, Sixes
Seat 3: lxIzoHy0RnkfFSODHC2liw folded before Flop (didn't bet)
Seat 4: 2igtJLmvIZ+HqX4XPgMPZA folded before Flop (didn't bet)
Seat 5: IBNygaT1aa9Z1uPdJJilwA folded before Flop (didn't bet)
Seat 6: M1KyQQvVPVuxqTAB8sR/zQ (button) showed [Qc Jc] and won ($18.35) with three of a kind, Sixes



PokerStars Game #59941080772:  Hold'em No Limit ($0.25/$0.50) - 2009/07/01 1:25:05 ET
Table 'iq+aXfWVQRdV0u8SRTYUEg' 9-max Seat #9 is the button
Seat 1: 3yl8Q6QaLfGtyhN4/pEFgQ ($75.30 in chips)
Seat 2: J9N0lxHFd/Js2S0xZLbsIQ ($36.30 in chips)
Seat 5: 997ViqAtWn1FPjJqcffwcA ($50 in chips)
Seat 6: bTJ0WgoxefTPxIoycS7uoA ($31.90 in chips)
Seat 7: SKnJuWHScqetA/qG5p+wCg ($31.55 in chips)
Seat 8: /DtIHuxEH+3tzKefmSV+Mw ($36.55 in chips)
Seat 9: olE1Z2rKWAV8+tGqmIBK9g ($23 in chips)
3yl8Q6QaLfGtyhN4/pEFgQ: posts small blind $0.25
J9N0lxHFd/Js2S0xZLbsIQ: posts big blind $0.50
Qi/PyOsKwaqtKIg0H+7ELg: sits out
vHYT5s323LpajBj+2c9zbQ: sits out
*** HOLE CARDS ***
997ViqAtWn1FPjJqcffwcA: folds
bTJ0WgoxefTPxIoycS7uoA: folds
SKnJuWHScqetA/qG5p+wCg: folds
/DtIHuxEH+3tzKefmSV+Mw: folds
olE1Z2rKWAV8+tGqmIBK9g: folds
3yl8Q6QaLfGtyhN4/pEFgQ: raises $0.50 to $1
J9N0lxHFd/Js2S0xZLbsIQ: calls $0.50
*** FLOP *** [Js Qc Jd]
3yl8Q6QaLfGtyhN4/pEFgQ: checks
J9N0lxHFd/Js2S0xZLbsIQ: bets $0.50
3yl8Q6QaLfGtyhN4/pEFgQ: calls $0.50
*** TURN *** [Js Qc Jd] [Td]
3yl8Q6QaLfGtyhN4/pEFgQ: bets $1.50
J9N0lxHFd/Js2S0xZLbsIQ: calls $1.50
*** RIVER *** [Js Qc Jd Td] [5d]
3yl8Q6QaLfGtyhN4/pEFgQ: checks
J9N0lxHFd/Js2S0xZLbsIQ: checks
*** SHOW DOWN ***
3yl8Q6QaLfGtyhN4/pEFgQ: shows [Ah Jh] (three of a kind, Jacks)
J9N0lxHFd/Js2S0xZLbsIQ: mucks hand
3yl8Q6QaLfGtyhN4/pEFgQ collected $5.75 from pot
*** SUMMARY ***
Total pot $6 | Rake $0.25
Board [Js Qc Jd Td 5d]
Seat 1: 3yl8Q6QaLfGtyhN4/pEFgQ (small blind) showed [Ah Jh] and won ($5.75) with three of a kind, Jacks
Seat 2: J9N0lxHFd/Js2S0xZLbsIQ (big blind) mucked
Seat 5: 997ViqAtWn1FPjJqcffwcA folded before Flop (didn't bet)
Seat 6: bTJ0WgoxefTPxIoycS7uoA folded before Flop (didn't bet)
Seat 7: SKnJuWHScqetA/qG5p+wCg folded before Flop (didn't bet)
Seat 8: /DtIHuxEH+3tzKefmSV+Mw folded before Flop (didn't bet)
Seat 9: olE1Z2rKWAV8+tGqmIBK9g (button) folded before Flop (didn't bet)



PokerStars Game #59941080798:  Hold'em No Limit ($0.25/$0.50) - 2009/07/01 1:25:05 ET
Table 'ofnd8S4IdIPph1Cbn+x7hA' 2-max Seat #1 is the button
Seat 1: PY4NvRocCFPfSIHKbh0euQ ($33.05 in chips)
Seat 2: l5WbyJ/iWYjpeCC6GCYY6w ($60 in chips)
PY4NvRocCFPfSIHKbh0euQ: posts small blind $0.25
l5WbyJ/iWYjpeCC6GCYY6w: posts big blind $0.50
*** HOLE CARDS ***
PY4NvRocCFPfSIHKbh0euQ: raises $0.50 to $1
l5WbyJ/iWYjpeCC6GCYY6w: calls $0.50
*** FLOP *** [8h 6h 7c]
l5WbyJ/iWYjpeCC6GCYY6w: checks
PY4NvRocCFPfSIHKbh0euQ: checks
*** TURN *** [8h 6h 7c] [7d]
l5WbyJ/iWYjpeCC6GCYY6w: bets $1.50
PY4NvRocCFPfSIHKbh0euQ: calls $1.50
*** RIVER *** [8h 6h 7c 7d] [5s]
l5WbyJ/iWYjpeCC6GCYY6w: bets $1
PY4NvRocCFPfSIHKbh0euQ: calls $1
*** SHOW DOWN ***
l5WbyJ/iWYjpeCC6GCYY6w: shows [7s Ah] (three of a kind, Sevens)
PY4NvRocCFPfSIHKbh0euQ: mucks hand
l5WbyJ/iWYjpeCC6GCYY6w collected $6.70 from pot
*** SUMMARY ***
Total pot $7 | Rake $0.30
Board [8h 6h 7c 7d 5s]
Seat 1: PY4NvRocCFPfSIHKbh0euQ (button) (small blind) mucked
Seat 2: l5WbyJ/iWYjpeCC6GCYY6w (big blind) showed [7s Ah] and won ($6.70) with three of a kind, Sevens



PokerStars Game #59941080424:  Hold'em No Limit ($0.25/$0.50) - 2009/07/01 1:25:05 ET
Table '8BQGgNetI1NOvWeu3gtMNw' 2-max Seat #2 is the button
Seat 1: bypIyrYcAAifLfhZpGlKLA ($52.50 in chips)
Seat 2: Z4HwehErEwzsv/noQlfUlg ($136 in chips)
Z4HwehErEwzsv/noQlfUlg: posts small blind $0.25
bypIyrYcAAifLfhZpGlKLA: posts big blind $0.50
*** HOLE CARDS ***
Z4HwehErEwzsv/noQlfUlg: calls $0.25
bypIyrYcAAifLfhZpGlKLA: checks
*** FLOP *** [Ad 8s 6d]
bypIyrYcAAifLfhZpGlKLA: checks
Z4HwehErEwzsv/noQlfUlg: checks
*** TURN *** [Ad 8s 6d] [6s]
bypIyrYcAAifLfhZpGlKLA: checks
Z4HwehErEwzsv/noQlfUlg: checks
*** RIVER *** [Ad 8s 6d 6s] [4h]
bypIyrYcAAifLfhZpGlKLA: checks
Z4HwehErEwzsv/noQlfUlg: bets $1.50
bypIyrYcAAifLfhZpGlKLA: folds
Z4HwehErEwzsv/noQlfUlg collected $0.95 from pot
Z4HwehErEwzsv/noQlfUlg: doesn't show hand
*** SUMMARY ***
Total pot $1 | Rake $0.05
Board [Ad 8s 6d 6s 4h]
Seat 1: bypIyrYcAAifLfhZpGlKLA (big blind) folded on the River
Seat 2: Z4HwehErEwzsv/noQlfUlg (button) (small blind) collected ($0.95)



PokerStars Game #59941080308:  Hold'em No Limit ($0.25/$0.50) - 2009/07/01 1:25:05 ET
Table 'ibNfFy0bCzuBaUORla0aGw' 9-max Seat #1 is the button
Seat 1: xZCXQSXlrZkp3pZizzVXCw ($49.80 in chips)
Seat 2: 90Wb75h3W1BRpbqVnuk8gw ($50.25 in chips)
Seat 3: AjV5McH1KMMclY26QdLM5w ($27.10 in chips)
Seat 5: GIJAc9kPrLZHLSX8Q6i99w ($26.80 in chips)
Seat 6: H8cPaCtX7d6meGUVSM5sxw ($57.85 in chips)
Seat 7: HZkVla4kK2SI42CVrPZ/ig ($13.75 in chips)
Seat 8: Ja2jdidjip2UeJnRzmzAAQ ($47 in chips)
Seat 9: pFtzb1sR4b0d1aw6aIRgDg ($57.65 in chips)
90Wb75h3W1BRpbqVnuk8gw: posts small blind $0.25
AjV5McH1KMMclY26QdLM5w: posts big blind $0.50
nhDtFZ2uuvm5hDKG7ZVEpA: sits out
*** HOLE CARDS ***
GIJAc9kPrLZHLSX8Q6i99w: folds
H8cPaCtX7d6meGUVSM5sxw: raises $1 to $1.50
HZkVla4kK2SI42CVrPZ/ig: folds
Ja2jdidjip2UeJnRzmzAAQ: folds
pFtzb1sR4b0d1aw6aIRgDg: folds
xZCXQSXlrZkp3pZizzVXCw: folds
90Wb75h3W1BRpbqVnuk8gw: folds
AjV5McH1KMMclY26QdLM5w: folds
H8cPaCtX7d6meGUVSM5sxw collected $1.25 from pot
*** SUMMARY ***
Total pot $1.25 | Rake $0
Seat 1: xZCXQSXlrZkp3pZizzVXCw (button) folded before Flop (didn't bet)
Seat 2: 90Wb75h3W1BRpbqVnuk8gw (small blind) folded before Flop
Seat 3: AjV5McH1KMMclY26QdLM5w (big blind) folded before Flop
Seat 5: GIJAc9kPrLZHLSX8Q6i99w folded before Flop (didn't bet)
Seat 6: H8cPaCtX7d6meGUVSM5sxw collected ($1.25)
Seat 7: HZkVla4kK2SI42CVrPZ/ig folded before Flop (didn't bet)
Seat 8: Ja2jdidjip2UeJnRzmzAAQ folded before Flop (didn't bet)
Seat 9: pFtzb1sR4b0d1aw6aIRgDg folded before Flop (didn't bet)



PokerStars Game #59941086026:  Hold'em No Limit ($0.25/$0.50) - 2009/07/01 1:25:14 ET
Table '+dXkOAQyS8j9PQZusUTMpg' 2-max Seat #2 is the button
Seat 1: Teld4PDKla7C8/Wfu2DSkg ($47.75 in chips)
Seat 2: +zI4bP23YIjMkUHqeN2xfw ($30.25 in chips)
+zI4bP23YIjMkUHqeN2xfw: posts small blind $0.25
Teld4PDKla7C8/Wfu2DSkg: posts big blind $0.50
*** HOLE CARDS ***
+zI4bP23YIjMkUHqeN2xfw: calls $0.25
Teld4PDKla7C8/Wfu2DSkg: checks
*** FLOP *** [7d 6c Js]
Teld4PDKla7C8/Wfu2DSkg: checks
+zI4bP23YIjMkUHqeN2xfw: bets $1
Teld4PDKla7C8/Wfu2DSkg: calls $1
*** TURN *** [7d 6c Js] [9d]
Teld4PDKla7C8/Wfu2DSkg: checks
+zI4bP23YIjMkUHqeN2xfw: bets $1
Teld4PDKla7C8/Wfu2DSkg: calls $1
*** RIVER *** [7d 6c Js 9d] [5d]
Teld4PDKla7C8/Wfu2DSkg: bets $5.50
+zI4bP23YIjMkUHqeN2xfw: folds
Teld4PDKla7C8/Wfu2DSkg collected $4.80 from pot
Teld4PDKla7C8/Wfu2DSkg: doesn't show hand
*** SUMMARY ***
Total pot $5 | Rake $0.20
Board [7d 6c Js 9d 5d]
Seat 1: Teld4PDKla7C8/Wfu2DSkg (big blind) collected ($4.80)
Seat 2: +zI4bP23YIjMkUHqeN2xfw (button) (small blind) folded on the River



PokerStars Game #59941087016:  Hold'em No Limit ($0.25/$0.50) - 2009/07/01 1:25:16 ET
Table 'B+sqsfj6d6zXicNfaseTaw' 2-max Seat #2 is the button
Seat 1: +4GNcSsecmapVGSdV0mUPA ($142.10 in chips)
Seat 2: Lv5RmpRe6LtPkBzM9Gpo5A ($84.85 in chips)
Lv5RmpRe6LtPkBzM9Gpo5A: posts small blind $0.25
+4GNcSsecmapVGSdV0mUPA: posts big blind $0.50
*** HOLE CARDS ***
Lv5RmpRe6LtPkBzM9Gpo5A: raises $1.50 to $2
+4GNcSsecmapVGSdV0mUPA: calls $1.50
*** FLOP *** [2s 3d Qh]
+4GNcSsecmapVGSdV0mUPA: checks
Lv5RmpRe6LtPkBzM9Gpo5A: checks
*** TURN *** [2s 3d Qh] [Th]
+4GNcSsecmapVGSdV0mUPA: checks
Lv5RmpRe6LtPkBzM9Gpo5A: bets $2.50
+4GNcSsecmapVGSdV0mUPA: folds
Lv5RmpRe6LtPkBzM9Gpo5A collected $3.80 from pot
*** SUMMARY ***
Total pot $4 | Rake $0.20
Board [2s 3d Qh Th]
Seat 1: +4GNcSsecmapVGSdV0mUPA (big blind) folded on the Turn
Seat 2: Lv5RmpRe6LtPkBzM9Gpo5A (button) (small blind) collected ($3.80)



PokerStars Game #59941088370:  Hold'em No Limit ($0.25/$0.50) - 2009/07/01 1:25:18 ET
Table 'c/CRn+68J3Y8KxD5g1ek2Q' 2-max Seat #1 is the button
Seat 1: 46qCyJ6evTkHo9al5sBMNA ($103.95 in chips)
Seat 2: BypVLsYQt3ePFm2xQL/dOA ($255.50 in chips)
46qCyJ6evTkHo9al5sBMNA: posts small blind $0.25
BypVLsYQt3ePFm2xQL/dOA: posts big blind $0.50
*** HOLE CARDS ***
46qCyJ6evTkHo9al5sBMNA: folds
BypVLsYQt3ePFm2xQL/dOA collected $0.50 from pot
BypVLsYQt3ePFm2xQL/dOA: doesn't show hand
*** SUMMARY ***
Total pot $0.50 | Rake $0
Seat 1: 46qCyJ6evTkHo9al5sBMNA (button) (small blind) folded before Flop
Seat 2: BypVLsYQt3ePFm2xQL/dOA (big blind) collected ($0.50)



PokerStars Game #59941088052:  Hold'em No Limit ($0.25/$0.50) - 2009/07/01 1:25:18 ET
Table '9ojijpRcYQSQTh6xI+haUA' 2-max Seat #1 is the button
Seat 1: 8hLWxFrmTLKeWL475NK4rQ ($13.95 in chips)
Seat 2: TitTV+fFCcBZWOERdytydA ($23.90 in chips)
8hLWxFrmTLKeWL475NK4rQ: posts small blind $0.25
TitTV+fFCcBZWOERdytydA: posts big blind $0.50
*** HOLE CARDS ***
8hLWxFrmTLKeWL475NK4rQ: raises $1 to $1.50
TitTV+fFCcBZWOERdytydA: folds
8hLWxFrmTLKeWL475NK4rQ collected $1 from pot
*** SUMMARY ***
Total pot $1 | Rake $0
Seat 1: 8hLWxFrmTLKeWL475NK4rQ (button) (small blind) collected ($1)
Seat 2: TitTV+fFCcBZWOERdytydA (big blind) folded before Flop



PokerStars Game #59941089330:  Hold'em No Limit ($0.25/$0.50) - 2009/07/01 1:25:20 ET
Table 'tyR5AZNKV8Aadbrnrnlg7g' 6-max Seat #1 is the button
Seat 1: BgOXYI0yYSN1ULC4FqsNkg ($94.55 in chips)
Seat 2: BAjwVL+zKKd0s0fAWstzQQ ($7.45 in chips)
Seat 3: JFLrYNyQmwPhRQAtoSAuyA ($50 in chips)
Seat 4: 4QfsCWthT/vSLirorNXqtg ($86.70 in chips)
Seat 5: GUnvMULl2qFOO1yenu1UBw ($78 in chips)
Seat 6: 498aWaGsW4uGfuWl+2FCGw ($70.05 in chips)
BAjwVL+zKKd0s0fAWstzQQ: posts small blind $0.25
JFLrYNyQmwPhRQAtoSAuyA: posts big blind $0.50
*** HOLE CARDS ***
4QfsCWthT/vSLirorNXqtg: folds
GUnvMULl2qFOO1yenu1UBw: folds
498aWaGsW4uGfuWl+2FCGw: folds
BgOXYI0yYSN1ULC4FqsNkg: calls $0.50
BAjwVL+zKKd0s0fAWstzQQ: calls $0.25
JFLrYNyQmwPhRQAtoSAuyA: raises $2 to $2.50
BgOXYI0yYSN1ULC4FqsNkg: calls $2
BAjwVL+zKKd0s0fAWstzQQ: folds
*** FLOP *** [4c 3h Ts]
JFLrYNyQmwPhRQAtoSAuyA: bets $4
BgOXYI0yYSN1ULC4FqsNkg: folds
JFLrYNyQmwPhRQAtoSAuyA collected $5.25 from pot
JFLrYNyQmwPhRQAtoSAuyA: doesn't show hand
*** SUMMARY ***
Total pot $5.50 | Rake $0.25
Board [4c 3h Ts]
Seat 1: BgOXYI0yYSN1ULC4FqsNkg (button) folded on the Flop
Seat 2: BAjwVL+zKKd0s0fAWstzQQ (small blind) folded before Flop
Seat 3: JFLrYNyQmwPhRQAtoSAuyA (big blind) collected ($5.25)
Seat 4: 4QfsCWthT/vSLirorNXqtg folded before Flop (didn't bet)
Seat 5: GUnvMULl2qFOO1yenu1UBw folded before Flop (didn't bet)
Seat 6: 498aWaGsW4uGfuWl+2FCGw folded before Flop (didn't bet)



PokerStars Game #59941091370:  Hold'em No Limit ($0.25/$0.50) - 2009/07/01 1:25:24 ET
Table 'ofnd8S4IdIPph1Cbn+x7hA' 2-max Seat #2 is the button
Seat 1: PY4NvRocCFPfSIHKbh0euQ ($29.55 in chips)
Seat 2: l5WbyJ/iWYjpeCC6GCYY6w ($63.20 in chips)
l5WbyJ/iWYjpeCC6GCYY6w: posts small blind $0.25
PY4NvRocCFPfSIHKbh0euQ: posts big blind $0.50
*** HOLE CARDS ***
l5WbyJ/iWYjpeCC6GCYY6w: raises $1 to $1.50
PY4NvRocCFPfSIHKbh0euQ: calls $1
*** FLOP *** [Qs Ah Ac]
PY4NvRocCFPfSIHKbh0euQ: checks
l5WbyJ/iWYjpeCC6GCYY6w: bets $1.50
PY4NvRocCFPfSIHKbh0euQ: calls $1.50
*** TURN *** [Qs Ah Ac] [2h]
PY4NvRocCFPfSIHKbh0euQ: checks
l5WbyJ/iWYjpeCC6GCYY6w: checks
*** RIVER *** [Qs Ah Ac 2h] [5s]
PY4NvRocCFPfSIHKbh0euQ: bets $1
l5WbyJ/iWYjpeCC6GCYY6w: raises $5 to $6
PY4NvRocCFPfSIHKbh0euQ: folds
l5WbyJ/iWYjpeCC6GCYY6w collected $7.65 from pot
l5WbyJ/iWYjpeCC6GCYY6w: doesn't show hand
*** SUMMARY ***
Total pot $8 | Rake $0.35
Board [Qs Ah Ac 2h 5s]
Seat 1: PY4NvRocCFPfSIHKbh0euQ (big blind) folded on the River
Seat 2: l5WbyJ/iWYjpeCC6GCYY6w (button) (small blind) collected ($7.65)



PokerStars Game #59941092660:  Hold'em No Limit ($0.25/$0.50) - 2009/07/01 1:25:26 ET
Table 'c/CRn+68J3Y8KxD5g1ek2Q' 2-max Seat #2 is the button
Seat 1: 46qCyJ6evTkHo9al5sBMNA ($103.70 in chips)
Seat 2: BypVLsYQt3ePFm2xQL/dOA ($255.75 in chips)
BypVLsYQt3ePFm2xQL/dOA: posts small blind $0.25
46qCyJ6evTkHo9al5sBMNA: posts big blind $0.50
*** HOLE CARDS ***
BypVLsYQt3ePFm2xQL/dOA: calls $0.25
46qCyJ6evTkHo9al5sBMNA: raises $1 to $1.50
BypVLsYQt3ePFm2xQL/dOA: calls $1
*** FLOP *** [Jc Qh 4s]
46qCyJ6evTkHo9al5sBMNA: bets $2
BypVLsYQt3ePFm2xQL/dOA: raises $2 to $4
46qCyJ6evTkHo9al5sBMNA: folds
BypVLsYQt3ePFm2xQL/dOA collected $6.70 from pot
BypVLsYQt3ePFm2xQL/dOA: doesn't show hand
*** SUMMARY ***
Total pot $7 | Rake $0.30
Board [Jc Qh 4s]
Seat 1: 46qCyJ6evTkHo9al5sBMNA (big blind) folded on the Flop
Seat 2: BypVLsYQt3ePFm2xQL/dOA (button) (small blind) collected ($6.70)



PokerStars Game #59941093236:  Hold'em No Limit ($0.25/$0.50) - 2009/07/01 1:25:27 ET
Table 'EiNh8p/wGJ1FP575iMFnqg' 9-max Seat #1 is the button
Seat 1: YFFlOZgyy1Mh4iBmuNRbmQ ($28.50 in chips)
Seat 2: 8ehL7qlZzjgUh2H35iiWLw ($58.40 in chips)
Seat 3: ymLPoEIl7UL3TvZYmnadxQ ($55.10 in chips)
Seat 4: cMzaiXAM/ZAdNaEUu+LqhA ($50 in chips)
Seat 5: M+7+BTmX5vZatHVuoRB1nA ($74.45 in chips)
Seat 6: viwBDtJsY6JfsFOdBAyJIQ ($9.45 in chips)
Seat 7: 997ViqAtWn1FPjJqcffwcA ($50 in chips)
Seat 8: mSD1pginDsyHG5PDfqzphw ($10 in chips)
Seat 9: GuPkZObrz5Zkkn8FsEdF9w ($37.60 in chips)
8ehL7qlZzjgUh2H35iiWLw: posts small blind $0.25
ymLPoEIl7UL3TvZYmnadxQ: posts big blind $0.50
*** HOLE CARDS ***
cMzaiXAM/ZAdNaEUu+LqhA: folds
M+7+BTmX5vZatHVuoRB1nA: folds
viwBDtJsY6JfsFOdBAyJIQ: folds
997ViqAtWn1FPjJqcffwcA: folds
mSD1pginDsyHG5PDfqzphw: folds
GuPkZObrz5Zkkn8FsEdF9w: folds
YFFlOZgyy1Mh4iBmuNRbmQ has timed out
YFFlOZgyy1Mh4iBmuNRbmQ: folds
YFFlOZgyy1Mh4iBmuNRbmQ is sitting out
8ehL7qlZzjgUh2H35iiWLw: folds
ymLPoEIl7UL3TvZYmnadxQ collected $0.50 from pot
ymLPoEIl7UL3TvZYmnadxQ: doesn't show hand
*** SUMMARY ***
Total pot $0.50 | Rake $0
Seat 1: YFFlOZgyy1Mh4iBmuNRbmQ (button) folded before Flop (didn't bet)
Seat 2: 8ehL7qlZzjgUh2H35iiWLw (small blind) folded before Flop
Seat 3: ymLPoEIl7UL3TvZYmnadxQ (big blind) collected ($0.50)
Seat 4: cMzaiXAM/ZAdNaEUu+LqhA folded before Flop (didn't bet)
Seat 5: M+7+BTmX5vZatHVuoRB1nA folded before Flop (didn't bet)
Seat 6: viwBDtJsY6JfsFOdBAyJIQ folded before Flop (didn't bet)
Seat 7: 997ViqAtWn1FPjJqcffwcA folded before Flop (didn't bet)
Seat 8: mSD1pginDsyHG5PDfqzphw folded before Flop (didn't bet)
Seat 9: GuPkZObrz5Zkkn8FsEdF9w folded before Flop (didn't bet)



PokerStars Game #59941095392:  Hold'em No Limit ($0.25/$0.50) - 2009/07/01 1:25:30 ET
Table 'X6IRCRTh+20gjz8aubWnwA' 9-max Seat #6 is the button
Seat 1: E2518gp4aFz1+kAgmGqeEg ($10.25 in chips)
Seat 2: HZkVla4kK2SI42CVrPZ/ig ($10 in chips)
Seat 3: SWv01peOe69QQRvhQTqjQw ($13.30 in chips)
Seat 4: M3JFBNQ8Bbw3FBZ/18MuXw ($23.15 in chips)
Seat 5: uw9QayAAxLM3Hb+HR7mSkg ($18.30 in chips)
Seat 6: Qi/PyOsKwaqtKIg0H+7ELg ($9.25 in chips)
Seat 7: cFHQjKQOOKTUzoilhrXHLg ($7.70 in chips)
Seat 8: HxeBVq06/3Bh/H986sgdbw ($47 in chips)
Seat 9: M+7+BTmX5vZatHVuoRB1nA ($44.80 in chips)
cFHQjKQOOKTUzoilhrXHLg: posts small blind $0.25
HxeBVq06/3Bh/H986sgdbw: posts big blind $0.50
*** HOLE CARDS ***
M+7+BTmX5vZatHVuoRB1nA: folds
E2518gp4aFz1+kAgmGqeEg: folds
HZkVla4kK2SI42CVrPZ/ig: folds
SWv01peOe69QQRvhQTqjQw: calls $0.50
M3JFBNQ8Bbw3FBZ/18MuXw: calls $0.50
uw9QayAAxLM3Hb+HR7mSkg: folds
Qi/PyOsKwaqtKIg0H+7ELg: folds
cFHQjKQOOKTUzoilhrXHLg: raises $7.20 to $7.70 and is all-in
HxeBVq06/3Bh/H986sgdbw: folds
SWv01peOe69QQRvhQTqjQw: folds
M3JFBNQ8Bbw3FBZ/18MuXw: calls $7.20
*** FLOP *** [Kd 6s 4h]
*** TURN *** [Kd 6s 4h] [8c]
*** RIVER *** [Kd 6s 4h 8c] [4s]
*** SHOW DOWN ***
cFHQjKQOOKTUzoilhrXHLg: shows [2h Ts] (a pair of Fours)
M3JFBNQ8Bbw3FBZ/18MuXw: shows [7s 7d] (two pair, Sevens and Fours)
M3JFBNQ8Bbw3FBZ/18MuXw collected $15.60 from pot
*** SUMMARY ***
Total pot $16.40 | Rake $0.80
Board [Kd 6s 4h 8c 4s]
Seat 1: E2518gp4aFz1+kAgmGqeEg folded before Flop (didn't bet)
Seat 2: HZkVla4kK2SI42CVrPZ/ig folded before Flop (didn't bet)
Seat 3: SWv01peOe69QQRvhQTqjQw folded before Flop
Seat 4: M3JFBNQ8Bbw3FBZ/18MuXw showed [7s 7d] and won ($15.60) with two pair, Sevens and Fours
Seat 5: uw9QayAAxLM3Hb+HR7mSkg folded before Flop (didn't bet)
Seat 6: Qi/PyOsKwaqtKIg0H+7ELg (button) folded before Flop (didn't bet)
Seat 7: cFHQjKQOOKTUzoilhrXHLg (small blind) showed [2h Ts] and lost with a pair of Fours
Seat 8: HxeBVq06/3Bh/H986sgdbw (big blind) folded before Flop
Seat 9: M+7+BTmX5vZatHVuoRB1nA folded before Flop (didn't bet)



PokerStars Game #59941094952:  Hold'em No Limit ($0.25/$0.50) - 2009/07/01 1:25:30 ET
Table 'BCN5su+SsXiy1zRMJi0SJw' 6-max Seat #5 is the button
Seat 1: GxXV09ciXaOxyY2H5aMIIw ($49.05 in chips)
Seat 2: ehFNAevCQri3trWxV6FJdA ($57.80 in chips)
Seat 3: kwgv5lNhiFrfONXCshzxlA ($43.40 in chips)
Seat 5: kxPhs4ePFqMy52CInAJ2aw ($51.30 in chips)
Seat 6: b2symlOdL7+0c9Pj4N/KlA ($56.25 in chips)
b2symlOdL7+0c9Pj4N/KlA: posts small blind $0.25
GxXV09ciXaOxyY2H5aMIIw: posts big blind $0.50
bbsK8j+tpuVRhBqDzHxf7w: sits out
*** HOLE CARDS ***
ehFNAevCQri3trWxV6FJdA: calls $0.50
kwgv5lNhiFrfONXCshzxlA: folds
kxPhs4ePFqMy52CInAJ2aw: folds
b2symlOdL7+0c9Pj4N/KlA: calls $0.25
GxXV09ciXaOxyY2H5aMIIw: checks
*** FLOP *** [4s 9d Jc]
b2symlOdL7+0c9Pj4N/KlA: bets $1.50
GxXV09ciXaOxyY2H5aMIIw: folds
ehFNAevCQri3trWxV6FJdA: raises $1.50 to $3
b2symlOdL7+0c9Pj4N/KlA: calls $1.50
*** TURN *** [4s 9d Jc] [Kh]
b2symlOdL7+0c9Pj4N/KlA: checks
ehFNAevCQri3trWxV6FJdA: bets $1.50
b2symlOdL7+0c9Pj4N/KlA: raises $6 to $7.50
ehFNAevCQri3trWxV6FJdA: calls $6
*** RIVER *** [4s 9d Jc Kh] [4c]
b2symlOdL7+0c9Pj4N/KlA: bets $17
ehFNAevCQri3trWxV6FJdA: folds
b2symlOdL7+0c9Pj4N/KlA collected $21.40 from pot
b2symlOdL7+0c9Pj4N/KlA: doesn't show hand
*** SUMMARY ***
Total pot $22.50 | Rake $1.10
Board [4s 9d Jc Kh 4c]
Seat 1: GxXV09ciXaOxyY2H5aMIIw (big blind) folded on the Flop
Seat 2: ehFNAevCQri3trWxV6FJdA folded on the River
Seat 3: kwgv5lNhiFrfONXCshzxlA folded before Flop (didn't bet)
Seat 5: kxPhs4ePFqMy52CInAJ2aw (button) folded before Flop (didn't bet)
Seat 6: b2symlOdL7+0c9Pj4N/KlA (small blind) collected ($21.40)



PokerStars Game #59941095576:  Hold'em No Limit ($0.25/$0.50) - 2009/07/01 1:25:31 ET
Table '9ojijpRcYQSQTh6xI+haUA' 2-max Seat #2 is the button
Seat 1: 8hLWxFrmTLKeWL475NK4rQ ($14.45 in chips)
Seat 2: TitTV+fFCcBZWOERdytydA ($23.40 in chips)
TitTV+fFCcBZWOERdytydA: posts small blind $0.25
8hLWxFrmTLKeWL475NK4rQ: posts big blind $0.50
*** HOLE CARDS ***
TitTV+fFCcBZWOERdytydA: raises $1 to $1.50
8hLWxFrmTLKeWL475NK4rQ: raises $1.50 to $3
TitTV+fFCcBZWOERdytydA: calls $1.50
*** FLOP *** [Ad 2h 9s]
8hLWxFrmTLKeWL475NK4rQ: checks
TitTV+fFCcBZWOERdytydA: checks
*** TURN *** [Ad 2h 9s] [2s]
8hLWxFrmTLKeWL475NK4rQ: bets $2
TitTV+fFCcBZWOERdytydA: folds
8hLWxFrmTLKeWL475NK4rQ collected $5.70 from pot
*** SUMMARY ***
Total pot $6 | Rake $0.30
Board [Ad 2h 9s 2s]
Seat 1: 8hLWxFrmTLKeWL475NK4rQ (big blind) collected ($5.70)
Seat 2: TitTV+fFCcBZWOERdytydA (button) (small blind) folded on the Turn



PokerStars Game #59941095908:  Hold'em No Limit ($0.25/$0.50) - 2009/07/01 1:25:31 ET
Table '3FhG0gl3kMX3wBEEqj+wnQ' 9-max Seat #2 is the button
Seat 1: bxLSulbgr8LmKNjOzw8URg ($49.30 in chips)
Seat 2: vacmVLJJECYI6HjAynFcpg ($50.60 in chips)
Seat 3: YXCE3WOZi8g2sIf3y/plVw ($50 in chips)
Seat 4: e2+sK/yjnj94rXOKoxPP2A ($70.25 in chips)
Seat 5: XcLXSUMHSpshK/7Lh0M4Vg ($10 in chips)
Seat 6: 997ViqAtWn1FPjJqcffwcA ($110.55 in chips)
Seat 7: mSD1pginDsyHG5PDfqzphw ($13.75 in chips)
Seat 8: j3K/Jujr7PY4ZM2RZvlH6A ($51.95 in chips)
YXCE3WOZi8g2sIf3y/plVw: posts small blind $0.25
e2+sK/yjnj94rXOKoxPP2A: posts big blind $0.50
*** HOLE CARDS ***
XcLXSUMHSpshK/7Lh0M4Vg: folds
997ViqAtWn1FPjJqcffwcA: folds
mSD1pginDsyHG5PDfqzphw: folds
j3K/Jujr7PY4ZM2RZvlH6A: folds
bxLSulbgr8LmKNjOzw8URg: folds
vacmVLJJECYI6HjAynFcpg: folds
YXCE3WOZi8g2sIf3y/plVw: folds
e2+sK/yjnj94rXOKoxPP2A collected $0.50 from pot
e2+sK/yjnj94rXOKoxPP2A: doesn't show hand
*** SUMMARY ***
Total pot $0.50 | Rake $0
Seat 1: bxLSulbgr8LmKNjOzw8URg folded before Flop (didn't bet)
Seat 2: vacmVLJJECYI6HjAynFcpg (button) folded before Flop (didn't bet)
Seat 3: YXCE3WOZi8g2sIf3y/plVw (small blind) folded before Flop
Seat 4: e2+sK/yjnj94rXOKoxPP2A (big blind) collected ($0.50)
Seat 5: XcLXSUMHSpshK/7Lh0M4Vg folded before Flop (didn't bet)
Seat 6: 997ViqAtWn1FPjJqcffwcA folded before Flop (didn't bet)
Seat 7: mSD1pginDsyHG5PDfqzphw folded before Flop (didn't bet)
Seat 8: j3K/Jujr7PY4ZM2RZvlH6A folded before Flop (didn't bet)



PokerStars Game #59941096970:  Hold'em No Limit ($0.25/$0.50) - 2009/07/01 1:25:33 ET
Table 'otvGDROEDdqsabxskT79qg' 9-max Seat #1 is the button
Seat 1: 8ehL7qlZzjgUh2H35iiWLw ($61.25 in chips)
Seat 2: cCjTzH9jio8607WzjcfXlg ($6.15 in chips)
Seat 3: +k7T5ocke8UwavtgUHm+Cg ($73.75 in chips)
Seat 4: MG90wfSJZnOejs/KD3vlQQ ($80.65 in chips)
Seat 5: E2518gp4aFz1+kAgmGqeEg ($12.20 in chips)
Seat 6: FFVKBJT0lZf+jFlgvy7ang ($45 in chips)
Seat 8: zE9cVigS2nW/Ljy4K4bUQA ($33.30 in chips)
Seat 9: KcY3X8YpD74Kw1RHkx/g4A ($30.90 in chips)
cCjTzH9jio8607WzjcfXlg: posts small blind $0.25
+k7T5ocke8UwavtgUHm+Cg: posts big blind $0.50
*** HOLE CARDS ***
MG90wfSJZnOejs/KD3vlQQ: folds
E2518gp4aFz1+kAgmGqeEg: folds
FFVKBJT0lZf+jFlgvy7ang: folds
zE9cVigS2nW/Ljy4K4bUQA: folds
KcY3X8YpD74Kw1RHkx/g4A: calls $0.50
8ehL7qlZzjgUh2H35iiWLw: folds
cCjTzH9jio8607WzjcfXlg: folds
+k7T5ocke8UwavtgUHm+Cg: raises $1 to $1.50
KcY3X8YpD74Kw1RHkx/g4A: calls $1
*** FLOP *** [8h Kh 7d]
+k7T5ocke8UwavtgUHm+Cg: bets $1.50
KcY3X8YpD74Kw1RHkx/g4A: folds
+k7T5ocke8UwavtgUHm+Cg collected $3.10 from pot
+k7T5ocke8UwavtgUHm+Cg: doesn't show hand
*** SUMMARY ***
Total pot $3.25 | Rake $0.15
Board [8h Kh 7d]
Seat 1: 8ehL7qlZzjgUh2H35iiWLw (button) folded before Flop (didn't bet)
Seat 2: cCjTzH9jio8607WzjcfXlg (small blind) folded before Flop
Seat 3: +k7T5ocke8UwavtgUHm+Cg (big blind) collected ($3.10)
Seat 4: MG90wfSJZnOejs/KD3vlQQ folded before Flop (didn't bet)
Seat 5: E2518gp4aFz1+kAgmGqeEg folded before Flop (didn't bet)
Seat 6: FFVKBJT0lZf+jFlgvy7ang folded before Flop (didn't bet)
Seat 8: zE9cVigS2nW/Ljy4K4bUQA folded before Flop (didn't bet)
Seat 9: KcY3X8YpD74Kw1RHkx/g4A folded on the Flop



PokerStars Game #59941096886:  Hold'em No Limit ($0.25/$0.50) - 2009/07/01 1:25:33 ET
Table 'NCiXr0d5CEKBQr/cZgLhbA' 9-max Seat #7 is the button
Seat 1: pFtzb1sR4b0d1aw6aIRgDg ($55.70 in chips)
Seat 2: AjV5McH1KMMclY26QdLM5w ($25 in chips)
Seat 3: xZCXQSXlrZkp3pZizzVXCw ($98.65 in chips)
Seat 4: 5k9fvXD9suIgCxU4HLQjTw ($53.95 in chips)
Seat 5: Ja2jdidjip2UeJnRzmzAAQ ($36.60 in chips)
Seat 6: t1qL+wRXOwTLB4TBbcw2QA ($47.75 in chips)
Seat 7: dXhO5i7KOoVcsGqbklD+jw ($28 in chips)
Seat 8: 1MJUKc3cc0QmUoz1JZLR2w ($62.45 in chips)
Seat 9: 4WLZvqBn5qv5tds5kt5A1Q ($69.05 in chips)
1MJUKc3cc0QmUoz1JZLR2w: posts small blind $0.25
4WLZvqBn5qv5tds5kt5A1Q: posts big blind $0.50
*** HOLE CARDS ***
pFtzb1sR4b0d1aw6aIRgDg: calls $0.50
AjV5McH1KMMclY26QdLM5w: folds
xZCXQSXlrZkp3pZizzVXCw: folds
5k9fvXD9suIgCxU4HLQjTw: folds
Ja2jdidjip2UeJnRzmzAAQ: folds
t1qL+wRXOwTLB4TBbcw2QA: folds
dXhO5i7KOoVcsGqbklD+jw: calls $0.50
1MJUKc3cc0QmUoz1JZLR2w: calls $0.25
4WLZvqBn5qv5tds5kt5A1Q: checks
*** FLOP *** [Td Kh Ts]
1MJUKc3cc0QmUoz1JZLR2w: checks
4WLZvqBn5qv5tds5kt5A1Q: checks
pFtzb1sR4b0d1aw6aIRgDg: checks
dXhO5i7KOoVcsGqbklD+jw: checks
*** TURN *** [Td Kh Ts] [8d]
1MJUKc3cc0QmUoz1JZLR2w: bets $1
4WLZvqBn5qv5tds5kt5A1Q: calls $1
pFtzb1sR4b0d1aw6aIRgDg: raises $5 to $6
dXhO5i7KOoVcsGqbklD+jw: folds
1MJUKc3cc0QmUoz1JZLR2w: calls $5
4WLZvqBn5qv5tds5kt5A1Q: calls $5
*** RIVER *** [Td Kh Ts 8d] [7d]
1MJUKc3cc0QmUoz1JZLR2w: checks
4WLZvqBn5qv5tds5kt5A1Q: checks
pFtzb1sR4b0d1aw6aIRgDg: bets $7
1MJUKc3cc0QmUoz1JZLR2w: calls $7
4WLZvqBn5qv5tds5kt5A1Q: calls $7
*** SHOW DOWN ***
pFtzb1sR4b0d1aw6aIRgDg: shows [8h 8c] (a full house, Eights full of Tens)
1MJUKc3cc0QmUoz1JZLR2w: mucks hand
4WLZvqBn5qv5tds5kt5A1Q: mucks hand
pFtzb1sR4b0d1aw6aIRgDg collected $39 from pot
*** SUMMARY ***
Total pot $41 | Rake $2
Board [Td Kh Ts 8d 7d]
Seat 1: pFtzb1sR4b0d1aw6aIRgDg showed [8h 8c] and won ($39) with a full house, Eights full of Tens
Seat 2: AjV5McH1KMMclY26QdLM5w folded before Flop (didn't bet)
Seat 3: xZCXQSXlrZkp3pZizzVXCw folded before Flop (didn't bet)
Seat 4: 5k9fvXD9suIgCxU4HLQjTw folded before Flop (didn't bet)
Seat 5: Ja2jdidjip2UeJnRzmzAAQ folded before Flop (didn't bet)
Seat 6: t1qL+wRXOwTLB4TBbcw2QA folded before Flop (didn't bet)
Seat 7: dXhO5i7KOoVcsGqbklD+jw (button) folded on the Turn
Seat 8: 1MJUKc3cc0QmUoz1JZLR2w (small blind) mucked
Seat 9: 4WLZvqBn5qv5tds5kt5A1Q (big blind) mucked



PokerStars Game #59941097660:  Hold'em No Limit ($0.25/$0.50) - 2009/07/01 1:25:35 ET
Table 'B+sqsfj6d6zXicNfaseTaw' 2-max Seat #1 is the button
Seat 1: +4GNcSsecmapVGSdV0mUPA ($140.10 in chips)
Seat 2: Lv5RmpRe6LtPkBzM9Gpo5A ($86.65 in chips)
+4GNcSsecmapVGSdV0mUPA: posts small blind $0.25
Lv5RmpRe6LtPkBzM9Gpo5A: posts big blind $0.50
*** HOLE CARDS ***
+4GNcSsecmapVGSdV0mUPA: calls $0.25
Lv5RmpRe6LtPkBzM9Gpo5A: checks
*** FLOP *** [Jd 2h Qc]
Lv5RmpRe6LtPkBzM9Gpo5A: checks
+4GNcSsecmapVGSdV0mUPA: bets $1
Lv5RmpRe6LtPkBzM9Gpo5A: folds
+4GNcSsecmapVGSdV0mUPA collected $0.95 from pot
+4GNcSsecmapVGSdV0mUPA: doesn't show hand
*** SUMMARY ***
Total pot $1 | Rake $0.05
Board [Jd 2h Qc]
Seat 1: +4GNcSsecmapVGSdV0mUPA (button) (small blind) collected ($0.95)
Seat 2: Lv5RmpRe6LtPkBzM9Gpo5A (big blind) folded on the Flop



PokerStars Game #59941098758:  Hold'em No Limit ($0.25/$0.50) - 2009/07/01 1:25:36 ET
Table 'Nz0Vr7WMHL2g5Uk7dDZjpw' 9-max Seat #5 is the button
Seat 3: hoglu9inkgs6zN573/bJag ($5.70 in chips)
Seat 4: E2518gp4aFz1+kAgmGqeEg ($12.25 in chips)
Seat 5: WGW0DgjBUXs1ylURHG8vnQ ($15.25 in chips)
Seat 6: 997ViqAtWn1FPjJqcffwcA ($57.55 in chips)
Seat 7: KPLH0gELgFe2OuAnhJFI5w ($26.20 in chips)
Seat 8: aoL+R/61Kxmw69ypuPrWAQ ($27.50 in chips)
Seat 9: mSD1pginDsyHG5PDfqzphw ($10 in chips)
997ViqAtWn1FPjJqcffwcA: posts small blind $0.25
KPLH0gELgFe2OuAnhJFI5w: posts big blind $0.50
9yMsdgReyOUerNsmTYCCDQ: sits out
SegjDnMxWMujiD57ESNL+g: sits out
*** HOLE CARDS ***
aoL+R/61Kxmw69ypuPrWAQ: folds
mSD1pginDsyHG5PDfqzphw: folds
hoglu9inkgs6zN573/bJag: folds
E2518gp4aFz1+kAgmGqeEg: folds
WGW0DgjBUXs1ylURHG8vnQ: raises $0.50 to $1
997ViqAtWn1FPjJqcffwcA: folds
KPLH0gELgFe2OuAnhJFI5w: calls $0.50
*** FLOP *** [9s Kh Kd]
KPLH0gELgFe2OuAnhJFI5w: checks
WGW0DgjBUXs1ylURHG8vnQ: bets $1
KPLH0gELgFe2OuAnhJFI5w: folds
WGW0DgjBUXs1ylURHG8vnQ collected $2.15 from pot
WGW0DgjBUXs1ylURHG8vnQ: doesn't show hand
*** SUMMARY ***
Total pot $2.25 | Rake $0.10
Board [9s Kh Kd]
Seat 3: hoglu9inkgs6zN573/bJag folded before Flop (didn't bet)
Seat 4: E2518gp4aFz1+kAgmGqeEg folded before Flop (didn't bet)
Seat 5: WGW0DgjBUXs1ylURHG8vnQ (button) collected ($2.15)
Seat 6: 997ViqAtWn1FPjJqcffwcA (small blind) folded before Flop
Seat 7: KPLH0gELgFe2OuAnhJFI5w (big blind) folded on the Flop
Seat 8: aoL+R/61Kxmw69ypuPrWAQ folded before Flop (didn't bet)
Seat 9: mSD1pginDsyHG5PDfqzphw folded before Flop (didn't bet)



PokerStars Game #59941101068:  Hold'em No Limit ($0.25/$0.50) - 2009/07/01 1:25:40 ET
Table 'kgbJRsxfv64KrErDRBAkcw' 6-max Seat #5 is the button
Seat 1: VamsyhlFzXGF6/ydo0BHeA ($20.55 in chips)
Seat 2: AdS8BJMOheS01zjCDfPMFg ($65.25 in chips)
Seat 3: c4MNIaIyPMOMxrgT8FT5nA ($229.70 in chips)
Seat 4: 2igtJLmvIZ+HqX4XPgMPZA ($50 in chips)
Seat 5: eUBBn2R56C1IQ6Cs/vitwg ($53.60 in chips)
Seat 6: 1b+2BbjMN8qhR1WPqdE9VQ ($56.15 in chips)
1b+2BbjMN8qhR1WPqdE9VQ: posts small blind $0.25
VamsyhlFzXGF6/ydo0BHeA: posts big blind $0.50
*** HOLE CARDS ***
AdS8BJMOheS01zjCDfPMFg: folds
c4MNIaIyPMOMxrgT8FT5nA: folds
2igtJLmvIZ+HqX4XPgMPZA: folds
eUBBn2R56C1IQ6Cs/vitwg: raises $1 to $1.50
1b+2BbjMN8qhR1WPqdE9VQ: folds
VamsyhlFzXGF6/ydo0BHeA: calls $1
*** FLOP *** [Kh 4h 8h]
VamsyhlFzXGF6/ydo0BHeA: checks
eUBBn2R56C1IQ6Cs/vitwg: bets $2.50
VamsyhlFzXGF6/ydo0BHeA: folds
eUBBn2R56C1IQ6Cs/vitwg collected $3.10 from pot
*** SUMMARY ***
Total pot $3.25 | Rake $0.15
Board [Kh 4h 8h]
Seat 1: VamsyhlFzXGF6/ydo0BHeA (big blind) folded on the Flop
Seat 2: AdS8BJMOheS01zjCDfPMFg folded before Flop (didn't bet)
Seat 3: c4MNIaIyPMOMxrgT8FT5nA folded before Flop (didn't bet)
Seat 4: 2igtJLmvIZ+HqX4XPgMPZA folded before Flop (didn't bet)
Seat 5: eUBBn2R56C1IQ6Cs/vitwg (button) collected ($3.10)
Seat 6: 1b+2BbjMN8qhR1WPqdE9VQ (small blind) folded before Flop



PokerStars Game #59941103168:  Hold'em No Limit ($0.25/$0.50) - 2009/07/01 1:25:44 ET
Table '8BQGgNetI1NOvWeu3gtMNw' 2-max Seat #1 is the button
Seat 1: bypIyrYcAAifLfhZpGlKLA ($52 in chips)
Seat 2: Z4HwehErEwzsv/noQlfUlg ($136.45 in chips)
bypIyrYcAAifLfhZpGlKLA: posts small blind $0.25
Z4HwehErEwzsv/noQlfUlg: posts big blind $0.50
*** HOLE CARDS ***
bypIyrYcAAifLfhZpGlKLA: raises $1 to $1.50
Z4HwehErEwzsv/noQlfUlg: raises $1.50 to $3
bypIyrYcAAifLfhZpGlKLA: calls $1.50
*** FLOP *** [2c 7c Tc]
Z4HwehErEwzsv/noQlfUlg: checks
bypIyrYcAAifLfhZpGlKLA: bets $3.50
Z4HwehErEwzsv/noQlfUlg: calls $3.50
*** TURN *** [2c 7c Tc] [6c]
Z4HwehErEwzsv/noQlfUlg: checks
bypIyrYcAAifLfhZpGlKLA: bets $12
Z4HwehErEwzsv/noQlfUlg: raises $35 to $47
bypIyrYcAAifLfhZpGlKLA: folds
Z4HwehErEwzsv/noQlfUlg collected $36.50 from pot
Z4HwehErEwzsv/noQlfUlg: doesn't show hand
*** SUMMARY ***
Total pot $37 | Rake $0.50
Board [2c 7c Tc 6c]
Seat 1: bypIyrYcAAifLfhZpGlKLA (button) (small blind) folded on the Turn
Seat 2: Z4HwehErEwzsv/noQlfUlg (big blind) collected ($36.50)



PokerStars Game #59941103976:  Hold'em No Limit ($0.25/$0.50) - 2009/07/01 1:25:45 ET
Table 'ibNfFy0bCzuBaUORla0aGw' 9-max Seat #2 is the button
Seat 1: xZCXQSXlrZkp3pZizzVXCw ($49.80 in chips)
Seat 2: 90Wb75h3W1BRpbqVnuk8gw ($50 in chips)
Seat 3: AjV5McH1KMMclY26QdLM5w ($26.60 in chips)
Seat 4: nhDtFZ2uuvm5hDKG7ZVEpA ($50 in chips)
Seat 5: GIJAc9kPrLZHLSX8Q6i99w ($26.80 in chips)
Seat 6: H8cPaCtX7d6meGUVSM5sxw ($58.60 in chips)
Seat 7: HZkVla4kK2SI42CVrPZ/ig ($13.75 in chips)
Seat 8: Ja2jdidjip2UeJnRzmzAAQ ($47 in chips)
Seat 9: pFtzb1sR4b0d1aw6aIRgDg ($57.65 in chips)
AjV5McH1KMMclY26QdLM5w: posts small blind $0.25
nhDtFZ2uuvm5hDKG7ZVEpA: posts big blind $0.50
*** HOLE CARDS ***
GIJAc9kPrLZHLSX8Q6i99w: folds
H8cPaCtX7d6meGUVSM5sxw: folds
HZkVla4kK2SI42CVrPZ/ig: raises $1 to $1.50
Ja2jdidjip2UeJnRzmzAAQ: folds
pFtzb1sR4b0d1aw6aIRgDg: calls $1.50
xZCXQSXlrZkp3pZizzVXCw: folds
90Wb75h3W1BRpbqVnuk8gw: folds
AjV5McH1KMMclY26QdLM5w: folds
nhDtFZ2uuvm5hDKG7ZVEpA: folds
*** FLOP *** [Td Ac 4d]
HZkVla4kK2SI42CVrPZ/ig: bets $2
pFtzb1sR4b0d1aw6aIRgDg: folds
HZkVla4kK2SI42CVrPZ/ig collected $3.60 from pot
HZkVla4kK2SI42CVrPZ/ig: doesn't show hand
*** SUMMARY ***
Total pot $3.75 | Rake $0.15
Board [Td Ac 4d]
Seat 1: xZCXQSXlrZkp3pZizzVXCw folded before Flop (didn't bet)
Seat 2: 90Wb75h3W1BRpbqVnuk8gw (button) folded before Flop (didn't bet)
Seat 3: AjV5McH1KMMclY26QdLM5w (small blind) folded before Flop
Seat 4: nhDtFZ2uuvm5hDKG7ZVEpA (big blind) folded before Flop
Seat 5: GIJAc9kPrLZHLSX8Q6i99w folded before Flop (didn't bet)
Seat 6: H8cPaCtX7d6meGUVSM5sxw folded before Flop (didn't bet)
Seat 7: HZkVla4kK2SI42CVrPZ/ig collected ($3.60)
Seat 8: Ja2jdidjip2UeJnRzmzAAQ folded before Flop (didn't bet)
Seat 9: pFtzb1sR4b0d1aw6aIRgDg folded on the Flop



PokerStars Game #59941104896:  Hold'em No Limit ($0.25/$0.50) - 2009/07/01 1:25:47 ET
Table '+z1aekfHkpp09pc8F9aViw' 6-max Seat #4 is the button
Seat 1: 7zFtlEn2NxyROFkJdZA/yg ($50 in chips)
Seat 2: OZ6OtYh5Y53MCH/p0QTn5g ($67.10 in chips)
Seat 4: RowCSpSURHTOL/dcjg/Iug ($85 in chips)
Seat 5: 2igtJLmvIZ+HqX4XPgMPZA ($53.20 in chips)
Seat 6: GUnvMULl2qFOO1yenu1UBw ($50 in chips)
2igtJLmvIZ+HqX4XPgMPZA: posts small blind $0.25
GUnvMULl2qFOO1yenu1UBw: posts big blind $0.50
URYNc7fPA23K2UfadQbnCA: sits out
*** HOLE CARDS ***
7zFtlEn2NxyROFkJdZA/yg: folds
OZ6OtYh5Y53MCH/p0QTn5g: raises $1.50 to $2
RowCSpSURHTOL/dcjg/Iug: folds
7zFtlEn2NxyROFkJdZA/yg leaves the table
/DArfRoYc3YpLsOQSZubFg joins the table at seat #1
2igtJLmvIZ+HqX4XPgMPZA: folds
GUnvMULl2qFOO1yenu1UBw: folds
OZ6OtYh5Y53MCH/p0QTn5g collected $1.25 from pot
*** SUMMARY ***
Total pot $1.25 | Rake $0
Seat 1: 7zFtlEn2NxyROFkJdZA/yg folded before Flop (didn't bet)
Seat 2: OZ6OtYh5Y53MCH/p0QTn5g collected ($1.25)
Seat 4: RowCSpSURHTOL/dcjg/Iug (button) folded before Flop (didn't bet)
Seat 5: 2igtJLmvIZ+HqX4XPgMPZA (small blind) folded before Flop
Seat 6: GUnvMULl2qFOO1yenu1UBw (big blind) folded before Flop



PokerStars Game #59941105202:  Hold'em No Limit ($0.25/$0.50) - 2009/07/01 1:25:47 ET
Table '+dXkOAQyS8j9PQZusUTMpg' 2-max Seat #1 is the button
Seat 1: Teld4PDKla7C8/Wfu2DSkg ($50.05 in chips)
Seat 2: +zI4bP23YIjMkUHqeN2xfw ($27.75 in chips)
Teld4PDKla7C8/Wfu2DSkg: posts small blind $0.25
+zI4bP23YIjMkUHqeN2xfw: posts big blind $0.50
*** HOLE CARDS ***
Teld4PDKla7C8/Wfu2DSkg: raises $0.50 to $1
+zI4bP23YIjMkUHqeN2xfw: folds
Teld4PDKla7C8/Wfu2DSkg collected $1 from pot
Teld4PDKla7C8/Wfu2DSkg: doesn't show hand
*** SUMMARY ***
Total pot $1 | Rake $0
Seat 1: Teld4PDKla7C8/Wfu2DSkg (button) (small blind) collected ($1)
Seat 2: +zI4bP23YIjMkUHqeN2xfw (big blind) folded before Flop



PokerStars Game #59941105658:  Hold'em No Limit ($0.25/$0.50) - 2009/07/01 1:25:48 ET
Table 'c/CRn+68J3Y8KxD5g1ek2Q' 2-max Seat #1 is the button
Seat 1: 46qCyJ6evTkHo9al5sBMNA ($100.20 in chips)
Seat 2: BypVLsYQt3ePFm2xQL/dOA ($258.95 in chips)
46qCyJ6evTkHo9al5sBMNA: posts small blind $0.25
BypVLsYQt3ePFm2xQL/dOA: posts big blind $0.50
*** HOLE CARDS ***
46qCyJ6evTkHo9al5sBMNA: raises $1.50 to $2
BypVLsYQt3ePFm2xQL/dOA: calls $1.50
*** FLOP *** [7c 9c Ad]
BypVLsYQt3ePFm2xQL/dOA: checks
46qCyJ6evTkHo9al5sBMNA: checks
*** TURN *** [7c 9c Ad] [Qs]
BypVLsYQt3ePFm2xQL/dOA: checks
46qCyJ6evTkHo9al5sBMNA: checks
*** RIVER *** [7c 9c Ad Qs] [9s]
BypVLsYQt3ePFm2xQL/dOA: bets $3
46qCyJ6evTkHo9al5sBMNA: folds
BypVLsYQt3ePFm2xQL/dOA collected $3.80 from pot
BypVLsYQt3ePFm2xQL/dOA: doesn't show hand
*** SUMMARY ***
Total pot $4 | Rake $0.20
Board [7c 9c Ad Qs 9s]
Seat 1: 46qCyJ6evTkHo9al5sBMNA (button) (small blind) folded on the River
Seat 2: BypVLsYQt3ePFm2xQL/dOA (big blind) collected ($3.80)



PokerStars Game #59941105608:  Hold'em No Limit ($0.25/$0.50) - 2009/07/01 1:25:48 ET
Table 'B+sqsfj6d6zXicNfaseTaw' 2-max Seat #2 is the button
Seat 1: +4GNcSsecmapVGSdV0mUPA ($140.55 in chips)
Seat 2: Lv5RmpRe6LtPkBzM9Gpo5A ($86.15 in chips)
Lv5RmpRe6LtPkBzM9Gpo5A: posts small blind $0.25
+4GNcSsecmapVGSdV0mUPA: posts big blind $0.50
*** HOLE CARDS ***
Lv5RmpRe6LtPkBzM9Gpo5A: calls $0.25
+4GNcSsecmapVGSdV0mUPA: checks
*** FLOP *** [Th 5s Jh]
+4GNcSsecmapVGSdV0mUPA: checks
Lv5RmpRe6LtPkBzM9Gpo5A: checks
*** TURN *** [Th 5s Jh] [3d]
+4GNcSsecmapVGSdV0mUPA: bets $1
Lv5RmpRe6LtPkBzM9Gpo5A: folds
+4GNcSsecmapVGSdV0mUPA collected $0.95 from pot
+4GNcSsecmapVGSdV0mUPA: doesn't show hand
*** SUMMARY ***
Total pot $1 | Rake $0.05
Board [Th 5s Jh 3d]
Seat 1: +4GNcSsecmapVGSdV0mUPA (big blind) collected ($0.95)
Seat 2: Lv5RmpRe6LtPkBzM9Gpo5A (button) (small blind) folded on the Turn



PokerStars Game #59941106474:  Hold'em No Limit ($0.25/$0.50) - 2009/07/01 1:25:50 ET
Table 'ofnd8S4IdIPph1Cbn+x7hA' 2-max Seat #1 is the button
Seat 1: PY4NvRocCFPfSIHKbh0euQ ($25.55 in chips)
Seat 2: l5WbyJ/iWYjpeCC6GCYY6w ($66.85 in chips)
PY4NvRocCFPfSIHKbh0euQ: posts small blind $0.25
l5WbyJ/iWYjpeCC6GCYY6w: posts big blind $0.50
*** HOLE CARDS ***
PY4NvRocCFPfSIHKbh0euQ: raises $1 to $1.50
l5WbyJ/iWYjpeCC6GCYY6w: folds
PY4NvRocCFPfSIHKbh0euQ collected $1 from pot
*** SUMMARY ***
Total pot $1 | Rake $0
Seat 1: PY4NvRocCFPfSIHKbh0euQ (button) (small blind) collected ($1)
Seat 2: l5WbyJ/iWYjpeCC6GCYY6w (big blind) folded before Flop



PokerStars Game #59941106750:  Hold'em No Limit ($0.25/$0.50) - 2009/07/01 1:25:50 ET
Table 'tyR5AZNKV8Aadbrnrnlg7g' 6-max Seat #2 is the button
Seat 1: BgOXYI0yYSN1ULC4FqsNkg ($92.05 in chips)
Seat 2: BAjwVL+zKKd0s0fAWstzQQ ($6.95 in chips)
Seat 3: JFLrYNyQmwPhRQAtoSAuyA ($52.75 in chips)
Seat 4: 4QfsCWthT/vSLirorNXqtg ($86.70 in chips)
Seat 5: GUnvMULl2qFOO1yenu1UBw ($78 in chips)
Seat 6: 498aWaGsW4uGfuWl+2FCGw ($70.05 in chips)
JFLrYNyQmwPhRQAtoSAuyA: posts small blind $0.25
4QfsCWthT/vSLirorNXqtg: posts big blind $0.50
*** HOLE CARDS ***
GUnvMULl2qFOO1yenu1UBw: raises $1.50 to $2
498aWaGsW4uGfuWl+2FCGw: folds
BgOXYI0yYSN1ULC4FqsNkg: folds
BAjwVL+zKKd0s0fAWstzQQ: folds
JFLrYNyQmwPhRQAtoSAuyA: folds
4QfsCWthT/vSLirorNXqtg: folds
GUnvMULl2qFOO1yenu1UBw collected $1.25 from pot
GUnvMULl2qFOO1yenu1UBw: doesn't show hand
*** SUMMARY ***
Total pot $1.25 | Rake $0
Seat 1: BgOXYI0yYSN1ULC4FqsNkg folded before Flop (didn't bet)
Seat 2: BAjwVL+zKKd0s0fAWstzQQ (button) folded before Flop (didn't bet)
Seat 3: JFLrYNyQmwPhRQAtoSAuyA (small blind) folded before Flop
Seat 4: 4QfsCWthT/vSLirorNXqtg (big blind) folded before Flop
Seat 5: GUnvMULl2qFOO1yenu1UBw collected ($1.25)
Seat 6: 498aWaGsW4uGfuWl+2FCGw folded before Flop (didn't bet)



PokerStars Game #59941107424:  Hold'em No Limit ($0.25/$0.50) - 2009/07/01 1:25:51 ET
Table '3FhG0gl3kMX3wBEEqj+wnQ' 9-max Seat #3 is the button
Seat 1: bxLSulbgr8LmKNjOzw8URg ($49.30 in chips)
Seat 2: vacmVLJJECYI6HjAynFcpg ($50.60 in chips)
Seat 3: YXCE3WOZi8g2sIf3y/plVw ($50 in chips)
Seat 4: e2+sK/yjnj94rXOKoxPP2A ($70.50 in chips)
Seat 5: XcLXSUMHSpshK/7Lh0M4Vg ($10 in chips)
Seat 6: 997ViqAtWn1FPjJqcffwcA ($110.55 in chips)
Seat 7: mSD1pginDsyHG5PDfqzphw ($13.75 in chips)
Seat 8: j3K/Jujr7PY4ZM2RZvlH6A ($51.95 in chips)
e2+sK/yjnj94rXOKoxPP2A: posts small blind $0.25
XcLXSUMHSpshK/7Lh0M4Vg: posts big blind $0.50
*** HOLE CARDS ***
997ViqAtWn1FPjJqcffwcA: folds
mSD1pginDsyHG5PDfqzphw: folds
j3K/Jujr7PY4ZM2RZvlH6A: raises $1.50 to $2
bxLSulbgr8LmKNjOzw8URg: folds
vacmVLJJECYI6HjAynFcpg: folds
YXCE3WOZi8g2sIf3y/plVw: folds
e2+sK/yjnj94rXOKoxPP2A: folds
XcLXSUMHSpshK/7Lh0M4Vg: folds
j3K/Jujr7PY4ZM2RZvlH6A collected $1.25 from pot
j3K/Jujr7PY4ZM2RZvlH6A: doesn't show hand
*** SUMMARY ***
Total pot $1.25 | Rake $0
Seat 1: bxLSulbgr8LmKNjOzw8URg folded before Flop (didn't bet)
Seat 2: vacmVLJJECYI6HjAynFcpg folded before Flop (didn't bet)
Seat 3: YXCE3WOZi8g2sIf3y/plVw (button) folded before Flop (didn't bet)
Seat 4: e2+sK/yjnj94rXOKoxPP2A (small blind) folded before Flop
Seat 5: XcLXSUMHSpshK/7Lh0M4Vg (big blind) folded before Flop
Seat 6: 997ViqAtWn1FPjJqcffwcA folded before Flop (didn't bet)
Seat 7: mSD1pginDsyHG5PDfqzphw folded before Flop (didn't bet)
Seat 8: j3K/Jujr7PY4ZM2RZvlH6A collected ($1.25)



PokerStars Game #59941108202:  Hold'em No Limit ($0.25/$0.50) - 2009/07/01 1:25:53 ET
Table 'iq+aXfWVQRdV0u8SRTYUEg' 9-max Seat #1 is the button
Seat 1: 3yl8Q6QaLfGtyhN4/pEFgQ ($78.05 in chips)
Seat 2: J9N0lxHFd/Js2S0xZLbsIQ ($33.30 in chips)
Seat 3: Qi/PyOsKwaqtKIg0H+7ELg ($10 in chips)
Seat 5: 997ViqAtWn1FPjJqcffwcA ($50 in chips)
Seat 6: bTJ0WgoxefTPxIoycS7uoA ($31.90 in chips)
Seat 7: SKnJuWHScqetA/qG5p+wCg ($31.55 in chips)
Seat 8: /DtIHuxEH+3tzKefmSV+Mw ($36.55 in chips)
Seat 9: olE1Z2rKWAV8+tGqmIBK9g ($23 in chips)
J9N0lxHFd/Js2S0xZLbsIQ: posts small blind $0.25
Qi/PyOsKwaqtKIg0H+7ELg: posts big blind $0.50
vHYT5s323LpajBj+2c9zbQ: sits out
*** HOLE CARDS ***
997ViqAtWn1FPjJqcffwcA: folds
bTJ0WgoxefTPxIoycS7uoA: folds
SKnJuWHScqetA/qG5p+wCg: folds
/DtIHuxEH+3tzKefmSV+Mw: folds
olE1Z2rKWAV8+tGqmIBK9g: raises $1 to $1.50
3yl8Q6QaLfGtyhN4/pEFgQ: folds
J9N0lxHFd/Js2S0xZLbsIQ: calls $1.25
Qi/PyOsKwaqtKIg0H+7ELg: folds
*** FLOP *** [4s 6c 2s]
J9N0lxHFd/Js2S0xZLbsIQ: checks
olE1Z2rKWAV8+tGqmIBK9g: checks
*** TURN *** [4s 6c 2s] [5d]
J9N0lxHFd/Js2S0xZLbsIQ: checks
olE1Z2rKWAV8+tGqmIBK9g: bets $1
J9N0lxHFd/Js2S0xZLbsIQ: calls $1
*** RIVER *** [4s 6c 2s 5d] [7h]
J9N0lxHFd/Js2S0xZLbsIQ: bets $3
olE1Z2rKWAV8+tGqmIBK9g: calls $3
*** SHOW DOWN ***
J9N0lxHFd/Js2S0xZLbsIQ: shows [Th Ah] (high card Ace)
olE1Z2rKWAV8+tGqmIBK9g: shows [Jh Ac] (high card Ace - Jack kicker)
olE1Z2rKWAV8+tGqmIBK9g collected $10.95 from pot
*** SUMMARY ***
Total pot $11.50 | Rake $0.55
Board [4s 6c 2s 5d 7h]
Seat 1: 3yl8Q6QaLfGtyhN4/pEFgQ (button) folded before Flop (didn't bet)
Seat 2: J9N0lxHFd/Js2S0xZLbsIQ (small blind) showed [Th Ah] and lost with high card Ace
Seat 3: Qi/PyOsKwaqtKIg0H+7ELg (big blind) folded before Flop
Seat 5: 997ViqAtWn1FPjJqcffwcA folded before Flop (didn't bet)
Seat 6: bTJ0WgoxefTPxIoycS7uoA folded before Flop (didn't bet)
Seat 7: SKnJuWHScqetA/qG5p+wCg folded before Flop (didn't bet)
Seat 8: /DtIHuxEH+3tzKefmSV+Mw folded before Flop (didn't bet)
Seat 9: olE1Z2rKWAV8+tGqmIBK9g showed [Jh Ac] and won ($10.95) with high card Ace



PokerStars Game #59941109074:  Hold'em No Limit ($0.25/$0.50) - 2009/07/01 1:25:54 ET
Table 'ZYI3ZReBjdfKEYItkZHI6A' 9-max Seat #5 is the button
Seat 1: IYd5zG8k7vdBNVHbHg2Pag ($64.40 in chips)
Seat 2: uw9QayAAxLM3Hb+HR7mSkg ($9.25 in chips)
Seat 3: bkXkL3pmapikPQQRNPZSEA ($15.15 in chips)
Seat 4: e2+sK/yjnj94rXOKoxPP2A ($65.90 in chips)
Seat 5: ApHP7ouup365XIUFBdEDxg ($22 in chips)
Seat 6: 1xBtrSVBbgFH/viUWKqQeg ($29.70 in chips)
Seat 7: HWcfp1hY1hqvrddzW3/FQw ($13.25 in chips)
Seat 8: ji04uOybxCdpdefzlUQeKQ ($30.60 in chips)
1xBtrSVBbgFH/viUWKqQeg: posts small blind $0.25
HWcfp1hY1hqvrddzW3/FQw: posts big blind $0.50
HZkVla4kK2SI42CVrPZ/ig: sits out
*** HOLE CARDS ***
ji04uOybxCdpdefzlUQeKQ: folds
IYd5zG8k7vdBNVHbHg2Pag: folds
uw9QayAAxLM3Hb+HR7mSkg: folds
bkXkL3pmapikPQQRNPZSEA: folds
bkXkL3pmapikPQQRNPZSEA leaves the table
e2+sK/yjnj94rXOKoxPP2A: raises $1 to $1.50
ApHP7ouup365XIUFBdEDxg: raises $20.50 to $22 and is all-in
1xBtrSVBbgFH/viUWKqQeg: folds
HWcfp1hY1hqvrddzW3/FQw: folds
75K2MXwN65Sjfp1yHd50Hg joins the table at seat #3
e2+sK/yjnj94rXOKoxPP2A: folds
ApHP7ouup365XIUFBdEDxg collected $3.75 from pot
ApHP7ouup365XIUFBdEDxg: doesn't show hand
*** SUMMARY ***
Total pot $3.75 | Rake $0
Seat 1: IYd5zG8k7vdBNVHbHg2Pag folded before Flop (didn't bet)
Seat 2: uw9QayAAxLM3Hb+HR7mSkg folded before Flop (didn't bet)
Seat 3: bkXkL3pmapikPQQRNPZSEA folded before Flop (didn't bet)
Seat 4: e2+sK/yjnj94rXOKoxPP2A folded before Flop
Seat 5: ApHP7ouup365XIUFBdEDxg (button) collected ($3.75)
Seat 6: 1xBtrSVBbgFH/viUWKqQeg (small blind) folded before Flop
Seat 7: HWcfp1hY1hqvrddzW3/FQw (big blind) folded before Flop
Seat 8: ji04uOybxCdpdefzlUQeKQ folded before Flop (didn't bet)



PokerStars Game #59941108974:  Hold'em No Limit ($0.25/$0.50) - 2009/07/01 1:25:54 ET
Table '+dXkOAQyS8j9PQZusUTMpg' 2-max Seat #2 is the button
Seat 1: Teld4PDKla7C8/Wfu2DSkg ($50.55 in chips)
Seat 2: +zI4bP23YIjMkUHqeN2xfw ($27.25 in chips)
+zI4bP23YIjMkUHqeN2xfw: posts small blind $0.25
Teld4PDKla7C8/Wfu2DSkg: posts big blind $0.50
*** HOLE CARDS ***
+zI4bP23YIjMkUHqeN2xfw: folds
Teld4PDKla7C8/Wfu2DSkg collected $0.50 from pot
Teld4PDKla7C8/Wfu2DSkg: doesn't show hand
*** SUMMARY ***
Total pot $0.50 | Rake $0
Seat 1: Teld4PDKla7C8/Wfu2DSkg (big blind) collected ($0.50)
Seat 2: +zI4bP23YIjMkUHqeN2xfw (button) (small blind) folded before Flop



PokerStars Game #59941110562:  Hold'em No Limit ($0.25/$0.50) - 2009/07/01 1:25:57 ET
Table 'ofnd8S4IdIPph1Cbn+x7hA' 2-max Seat #2 is the button
Seat 1: PY4NvRocCFPfSIHKbh0euQ ($26.05 in chips)
Seat 2: l5WbyJ/iWYjpeCC6GCYY6w ($66.35 in chips)
l5WbyJ/iWYjpeCC6GCYY6w: posts small blind $0.25
PY4NvRocCFPfSIHKbh0euQ: posts big blind $0.50
*** HOLE CARDS ***
l5WbyJ/iWYjpeCC6GCYY6w: calls $0.25
PY4NvRocCFPfSIHKbh0euQ: checks
*** FLOP *** [3s Td 6c]
PY4NvRocCFPfSIHKbh0euQ: bets $1
l5WbyJ/iWYjpeCC6GCYY6w: folds
PY4NvRocCFPfSIHKbh0euQ collected $0.95 from pot
*** SUMMARY ***
Total pot $1 | Rake $0.05
Board [3s Td 6c]
Seat 1: PY4NvRocCFPfSIHKbh0euQ (big blind) collected ($0.95)
Seat 2: l5WbyJ/iWYjpeCC6GCYY6w (button) (small blind) folded on the Flop



PokerStars Game #59941111142:  Hold'em No Limit ($0.25/$0.50) - 2009/07/01 1:25:58 ET
Table 'lSisgp6H7Fg1hH5VfjEjYQ' 9-max Seat #1 is the button
Seat 1: 5k9fvXD9suIgCxU4HLQjTw ($54.10 in chips)
Seat 3: SKnJuWHScqetA/qG5p+wCg ($30 in chips)
Seat 4: bwv/rbH/hHhPhY6u9mu04w ($36.15 in chips)
Seat 5: mSD1pginDsyHG5PDfqzphw ($13 in chips)
Seat 6: +k7T5ocke8UwavtgUHm+Cg ($71.15 in chips)
Seat 7: IDtNLR9uFCDdjNsJWMHA5Q ($21.15 in chips)
Seat 8: a4JDWmpFQkL10XfAyuF51A ($12.25 in chips)
Seat 9: YzeKFbJVLmJGTgNH3ySQlw ($7.45 in chips)
SKnJuWHScqetA/qG5p+wCg: posts small blind $0.25
bwv/rbH/hHhPhY6u9mu04w: posts big blind $0.50
*** HOLE CARDS ***
mSD1pginDsyHG5PDfqzphw: folds
+k7T5ocke8UwavtgUHm+Cg: folds
IDtNLR9uFCDdjNsJWMHA5Q: folds
a4JDWmpFQkL10XfAyuF51A: folds
YzeKFbJVLmJGTgNH3ySQlw: folds
5k9fvXD9suIgCxU4HLQjTw: raises $1 to $1.50
SKnJuWHScqetA/qG5p+wCg: folds
bwv/rbH/hHhPhY6u9mu04w: folds
5k9fvXD9suIgCxU4HLQjTw collected $1.25 from pot
*** SUMMARY ***
Total pot $1.25 | Rake $0
Seat 1: 5k9fvXD9suIgCxU4HLQjTw (button) collected ($1.25)
Seat 3: SKnJuWHScqetA/qG5p+wCg (small blind) folded before Flop
Seat 4: bwv/rbH/hHhPhY6u9mu04w (big blind) folded before Flop
Seat 5: mSD1pginDsyHG5PDfqzphw folded before Flop (didn't bet)
Seat 6: +k7T5ocke8UwavtgUHm+Cg folded before Flop (didn't bet)
Seat 7: IDtNLR9uFCDdjNsJWMHA5Q folded before Flop (didn't bet)
Seat 8: a4JDWmpFQkL10XfAyuF51A folded before Flop (didn't bet)
Seat 9: YzeKFbJVLmJGTgNH3ySQlw folded before Flop (didn't bet)



PokerStars Game #59941112318:  Hold'em No Limit ($0.25/$0.50) - 2009/07/01 1:26:00 ET
Table '+dXkOAQyS8j9PQZusUTMpg' 2-max Seat #1 is the button
Seat 1: Teld4PDKla7C8/Wfu2DSkg ($50.80 in chips)
Seat 2: +zI4bP23YIjMkUHqeN2xfw ($27 in chips)
Teld4PDKla7C8/Wfu2DSkg: posts small blind $0.25
+zI4bP23YIjMkUHqeN2xfw: posts big blind $0.50
*** HOLE CARDS ***
Teld4PDKla7C8/Wfu2DSkg: raises $0.50 to $1
+zI4bP23YIjMkUHqeN2xfw: calls $0.50
*** FLOP *** [7c As 4d]
+zI4bP23YIjMkUHqeN2xfw: checks
Teld4PDKla7C8/Wfu2DSkg: bets $1
+zI4bP23YIjMkUHqeN2xfw: folds
Teld4PDKla7C8/Wfu2DSkg collected $1.90 from pot
Teld4PDKla7C8/Wfu2DSkg: doesn't show hand
*** SUMMARY ***
Total pot $2 | Rake $0.10
Board [7c As 4d]
Seat 1: Teld4PDKla7C8/Wfu2DSkg (button) (small blind) collected ($1.90)
Seat 2: +zI4bP23YIjMkUHqeN2xfw (big blind) folded on the Flop



PokerStars Game #59941112168:  Hold'em No Limit ($0.25/$0.50) - 2009/07/01 1:26:00 ET
Table 'cofQFHU7jbJoFecLVBof/w' 6-max Seat #5 is the button
Seat 1: URYNc7fPA23K2UfadQbnCA ($49.25 in chips)
Seat 2: f89uTQr3ieGlusj2IAYAEg ($50 in chips)
Seat 3: v4ctePcLlQw0r8E0qJtjYw ($49.45 in chips)
Seat 4: 5DE8aPciUJEVbjbL9lOOjw ($117.50 in chips)
Seat 5: QvwRlrpVqerRRF8eJm6dDw ($53.40 in chips)
Seat 6: 7+uQ0OOgCTbR4ltkSwyC0g ($153.95 in chips)
7+uQ0OOgCTbR4ltkSwyC0g: posts small blind $0.25
URYNc7fPA23K2UfadQbnCA: posts big blind $0.50
*** HOLE CARDS ***
f89uTQr3ieGlusj2IAYAEg: folds
7+uQ0OOgCTbR4ltkSwyC0g said, "that beats my ace"
v4ctePcLlQw0r8E0qJtjYw: raises $1 to $1.50
QvwRlrpVqerRRF8eJm6dDw said, "it was cheap to see the cards"
5DE8aPciUJEVbjbL9lOOjw: folds
5DE8aPciUJEVbjbL9lOOjw is sitting out
5DE8aPciUJEVbjbL9lOOjw leaves the table
QvwRlrpVqerRRF8eJm6dDw said, "but i showed it anyways"
QvwRlrpVqerRRF8eJm6dDw said, "as a sign of gratitude"
QvwRlrpVqerRRF8eJm6dDw: calls $1.50
7+uQ0OOgCTbR4ltkSwyC0g: folds
URYNc7fPA23K2UfadQbnCA: folds
*** FLOP *** [3d 7c Jh]
v4ctePcLlQw0r8E0qJtjYw: checks
g6lz8npaeeTJmJegtPYhlQ joins the table at seat #4
QvwRlrpVqerRRF8eJm6dDw: bets $2
v4ctePcLlQw0r8E0qJtjYw: folds
QvwRlrpVqerRRF8eJm6dDw collected $3.60 from pot
QvwRlrpVqerRRF8eJm6dDw: doesn't show hand
*** SUMMARY ***
Total pot $3.75 | Rake $0.15
Board [3d 7c Jh]
Seat 1: URYNc7fPA23K2UfadQbnCA (big blind) folded before Flop
Seat 2: f89uTQr3ieGlusj2IAYAEg folded before Flop (didn't bet)
Seat 3: v4ctePcLlQw0r8E0qJtjYw folded on the Flop
Seat 4: 5DE8aPciUJEVbjbL9lOOjw folded before Flop (didn't bet)
Seat 5: QvwRlrpVqerRRF8eJm6dDw (button) collected ($3.60)
Seat 6: 7+uQ0OOgCTbR4ltkSwyC0g (small blind) folded before Flop



PokerStars Game #59941114536:  Hold'em No Limit ($0.25/$0.50) - 2009/07/01 1:26:03 ET
Table 'fx6MqwfYAj/Rt86hBz2L3Q' 9-max Seat #8 is the button
Seat 1: v/4aX0ejnaIFK4ftDk2Lyg ($52.15 in chips)
Seat 2: C3rGXblctNcWI6JYPHhaEg ($39.90 in chips)
Seat 3: iadBi5AEt7gTBXbDSSnMYQ ($56 in chips)
Seat 5: iAISe3dVeua8PUn2wwgDHw ($61.65 in chips)
Seat 6: 5k9fvXD9suIgCxU4HLQjTw ($50 in chips)
Seat 8: JYwJYYV9pM5KWdSiETl8rA ($63 in chips)
Seat 9: vO3QVRovWemcGMkm7ijAIA ($11.75 in chips)
vO3QVRovWemcGMkm7ijAIA: posts small blind $0.25
v/4aX0ejnaIFK4ftDk2Lyg: posts big blind $0.50
mSD1pginDsyHG5PDfqzphw: sits out
*** HOLE CARDS ***
C3rGXblctNcWI6JYPHhaEg: raises $1.40 to $1.90
iadBi5AEt7gTBXbDSSnMYQ: calls $1.90
iAISe3dVeua8PUn2wwgDHw: folds
5k9fvXD9suIgCxU4HLQjTw: folds
JYwJYYV9pM5KWdSiETl8rA: folds
vO3QVRovWemcGMkm7ijAIA: folds
v/4aX0ejnaIFK4ftDk2Lyg: folds
*** FLOP *** [6h Ac 2d]
C3rGXblctNcWI6JYPHhaEg: bets $3
iadBi5AEt7gTBXbDSSnMYQ: folds
C3rGXblctNcWI6JYPHhaEg collected $4.35 from pot
*** SUMMARY ***
Total pot $4.55 | Rake $0.20
Board [6h Ac 2d]
Seat 1: v/4aX0ejnaIFK4ftDk2Lyg (big blind) folded before Flop
Seat 2: C3rGXblctNcWI6JYPHhaEg collected ($4.35)
Seat 3: iadBi5AEt7gTBXbDSSnMYQ folded on the Flop
Seat 5: iAISe3dVeua8PUn2wwgDHw folded before Flop (didn't bet)
Seat 6: 5k9fvXD9suIgCxU4HLQjTw folded before Flop (didn't bet)
Seat 8: JYwJYYV9pM5KWdSiETl8rA (button) folded before Flop (didn't bet)
Seat 9: vO3QVRovWemcGMkm7ijAIA (small blind) folded before Flop



PokerStars Game #59941114896:  Hold'em No Limit ($0.25/$0.50) - 2009/07/01 1:26:04 ET
Table '9ojijpRcYQSQTh6xI+haUA' 2-max Seat #1 is the button
Seat 1: 8hLWxFrmTLKeWL475NK4rQ ($17.15 in chips)
Seat 2: TitTV+fFCcBZWOERdytydA ($20.40 in chips)
8hLWxFrmTLKeWL475NK4rQ: posts small blind $0.25
TitTV+fFCcBZWOERdytydA: posts big blind $0.50
*** HOLE CARDS ***
8hLWxFrmTLKeWL475NK4rQ: calls $0.25
TitTV+fFCcBZWOERdytydA: raises $1.50 to $2
8hLWxFrmTLKeWL475NK4rQ: calls $1.50
*** FLOP *** [4d Ah 8s]
TitTV+fFCcBZWOERdytydA: checks
8hLWxFrmTLKeWL475NK4rQ: checks
*** TURN *** [4d Ah 8s] [Jh]
TitTV+fFCcBZWOERdytydA: bets $1.50
8hLWxFrmTLKeWL475NK4rQ: calls $1.50
*** RIVER *** [4d Ah 8s Jh] [Kd]
TitTV+fFCcBZWOERdytydA: bets $5.50
8hLWxFrmTLKeWL475NK4rQ: folds
TitTV+fFCcBZWOERdytydA collected $6.70 from pot
TitTV+fFCcBZWOERdytydA: doesn't show hand
*** SUMMARY ***
Total pot $7 | Rake $0.30
Board [4d Ah 8s Jh Kd]
Seat 1: 8hLWxFrmTLKeWL475NK4rQ (button) (small blind) folded on the River
Seat 2: TitTV+fFCcBZWOERdytydA (big blind) collected ($6.70)



PokerStars Game #59941115568:  Hold'em No Limit ($0.25/$0.50) - 2009/07/01 1:26:05 ET
Table 'tyR5AZNKV8Aadbrnrnlg7g' 6-max Seat #3 is the button
Seat 1: BgOXYI0yYSN1ULC4FqsNkg ($92.05 in chips)
Seat 2: BAjwVL+zKKd0s0fAWstzQQ ($6.95 in chips)
Seat 3: JFLrYNyQmwPhRQAtoSAuyA ($52.50 in chips)
Seat 4: 4QfsCWthT/vSLirorNXqtg ($86.20 in chips)
Seat 5: GUnvMULl2qFOO1yenu1UBw ($78.75 in chips)
Seat 6: 498aWaGsW4uGfuWl+2FCGw ($70.05 in chips)
4QfsCWthT/vSLirorNXqtg: posts small blind $0.25
GUnvMULl2qFOO1yenu1UBw: posts big blind $0.50
*** HOLE CARDS ***
498aWaGsW4uGfuWl+2FCGw: folds
BgOXYI0yYSN1ULC4FqsNkg: folds
BAjwVL+zKKd0s0fAWstzQQ: raises $6.45 to $6.95 and is all-in
JFLrYNyQmwPhRQAtoSAuyA: calls $6.95
4QfsCWthT/vSLirorNXqtg: folds
GUnvMULl2qFOO1yenu1UBw: folds
*** FLOP *** [2c As Js]
*** TURN *** [2c As Js] [9s]
*** RIVER *** [2c As Js 9s] [Jd]
*** SHOW DOWN ***
BAjwVL+zKKd0s0fAWstzQQ: shows [Jh Ks] (three of a kind, Jacks)
JFLrYNyQmwPhRQAtoSAuyA: mucks hand
BAjwVL+zKKd0s0fAWstzQQ collected $13.95 from pot
*** SUMMARY ***
Total pot $14.65 | Rake $0.70
Board [2c As Js 9s Jd]
Seat 1: BgOXYI0yYSN1ULC4FqsNkg folded before Flop (didn't bet)
Seat 2: BAjwVL+zKKd0s0fAWstzQQ showed [Jh Ks] and won ($13.95) with three of a kind, Jacks
Seat 3: JFLrYNyQmwPhRQAtoSAuyA (button) mucked
Seat 4: 4QfsCWthT/vSLirorNXqtg (small blind) folded before Flop
Seat 5: GUnvMULl2qFOO1yenu1UBw (big blind) folded before Flop
Seat 6: 498aWaGsW4uGfuWl+2FCGw folded before Flop (didn't bet)



PokerStars Game #59941116532:  Hold'em No Limit ($0.25/$0.50) - 2009/07/01 1:26:07 ET
Table 'ofnd8S4IdIPph1Cbn+x7hA' 2-max Seat #1 is the button
Seat 1: PY4NvRocCFPfSIHKbh0euQ ($26.50 in chips)
Seat 2: l5WbyJ/iWYjpeCC6GCYY6w ($65.85 in chips)
PY4NvRocCFPfSIHKbh0euQ: posts small blind $0.25
l5WbyJ/iWYjpeCC6GCYY6w: posts big blind $0.50
*** HOLE CARDS ***
PY4NvRocCFPfSIHKbh0euQ: raises $1 to $1.50
l5WbyJ/iWYjpeCC6GCYY6w: folds
PY4NvRocCFPfSIHKbh0euQ collected $1 from pot
*** SUMMARY ***
Total pot $1 | Rake $0
Seat 1: PY4NvRocCFPfSIHKbh0euQ (button) (small blind) collected ($1)
Seat 2: l5WbyJ/iWYjpeCC6GCYY6w (big blind) folded before Flop



PokerStars Game #59941118050:  Hold'em No Limit ($0.25/$0.50) - 2009/07/01 1:26:09 ET
Table 'GfL/No5u5PoEnU39lP5pQg' 6-max Seat #1 is the button
Seat 1: 1WUCqNG+p+vfWRTXNu4ljw ($65.25 in chips)
Seat 2: uVwggSetzp7d+eVgowO3vg ($40.35 in chips)
Seat 3: 4pp9WxhGdbVbxCc9tlu0lw ($41.30 in chips)
Seat 4: r6u7MWSXF30/khcTYkrG9Q ($27 in chips)
Seat 5: M1KyQQvVPVuxqTAB8sR/zQ ($50 in chips)
Seat 6: kxPhs4ePFqMy52CInAJ2aw ($65.25 in chips)
uVwggSetzp7d+eVgowO3vg: posts small blind $0.25
4pp9WxhGdbVbxCc9tlu0lw: posts big blind $0.50
*** HOLE CARDS ***
r6u7MWSXF30/khcTYkrG9Q: folds
M1KyQQvVPVuxqTAB8sR/zQ: folds
kxPhs4ePFqMy52CInAJ2aw: folds
1WUCqNG+p+vfWRTXNu4ljw: raises $1.50 to $2
uVwggSetzp7d+eVgowO3vg: calls $1.75
4pp9WxhGdbVbxCc9tlu0lw: calls $1.50
*** FLOP *** [Jh 8s Qc]
uVwggSetzp7d+eVgowO3vg: checks
4pp9WxhGdbVbxCc9tlu0lw: bets $2
1WUCqNG+p+vfWRTXNu4ljw: calls $2
uVwggSetzp7d+eVgowO3vg: calls $2
*** TURN *** [Jh 8s Qc] [Tc]
uVwggSetzp7d+eVgowO3vg: bets $2.50
4pp9WxhGdbVbxCc9tlu0lw: calls $2.50
1WUCqNG+p+vfWRTXNu4ljw: folds
*** RIVER *** [Jh 8s Qc Tc] [6c]
uVwggSetzp7d+eVgowO3vg: checks
4pp9WxhGdbVbxCc9tlu0lw: checks
*** SHOW DOWN ***
uVwggSetzp7d+eVgowO3vg: shows [9d 8d] (a straight, Eight to Queen)
4pp9WxhGdbVbxCc9tlu0lw: shows [As Qh] (a pair of Queens)
uVwggSetzp7d+eVgowO3vg collected $16.20 from pot
*** SUMMARY ***
Total pot $17 | Rake $0.80
Board [Jh 8s Qc Tc 6c]
Seat 1: 1WUCqNG+p+vfWRTXNu4ljw (button) folded on the Turn
Seat 2: uVwggSetzp7d+eVgowO3vg (small blind) showed [9d 8d] and won ($16.20) with a straight, Eight to Queen
Seat 3: 4pp9WxhGdbVbxCc9tlu0lw (big blind) showed [As Qh] and lost with a pair of Queens
Seat 4: r6u7MWSXF30/khcTYkrG9Q folded before Flop (didn't bet)
Seat 5: M1KyQQvVPVuxqTAB8sR/zQ folded before Flop (didn't bet)
Seat 6: kxPhs4ePFqMy52CInAJ2aw folded before Flop (didn't bet)



PokerStars Game #59941119234:  Hold'em No Limit ($0.25/$0.50) - 2009/07/01 1:26:11 ET
Table 'B+sqsfj6d6zXicNfaseTaw' 2-max Seat #1 is the button
Seat 1: +4GNcSsecmapVGSdV0mUPA ($141 in chips)
Seat 2: Lv5RmpRe6LtPkBzM9Gpo5A ($85.65 in chips)
+4GNcSsecmapVGSdV0mUPA: posts small blind $0.25
Lv5RmpRe6LtPkBzM9Gpo5A: posts big blind $0.50
*** HOLE CARDS ***
+4GNcSsecmapVGSdV0mUPA: raises $1.50 to $2
Lv5RmpRe6LtPkBzM9Gpo5A: raises $3 to $5
+4GNcSsecmapVGSdV0mUPA: calls $3
*** FLOP *** [3s 2s Qh]
Lv5RmpRe6LtPkBzM9Gpo5A: bets $6
+4GNcSsecmapVGSdV0mUPA: folds
Lv5RmpRe6LtPkBzM9Gpo5A collected $9.50 from pot
Lv5RmpRe6LtPkBzM9Gpo5A: doesn't show hand
*** SUMMARY ***
Total pot $10 | Rake $0.50
Board [3s 2s Qh]
Seat 1: +4GNcSsecmapVGSdV0mUPA (button) (small blind) folded on the Flop
Seat 2: Lv5RmpRe6LtPkBzM9Gpo5A (big blind) collected ($9.50)



PokerStars Game #59941121070:  Hold'em No Limit ($0.25/$0.50) - 2009/07/01 1:26:14 ET
Table '+dXkOAQyS8j9PQZusUTMpg' 2-max Seat #2 is the button
Seat 1: Teld4PDKla7C8/Wfu2DSkg ($51.70 in chips)
Seat 2: +zI4bP23YIjMkUHqeN2xfw ($26 in chips)
+zI4bP23YIjMkUHqeN2xfw: posts small blind $0.25
Teld4PDKla7C8/Wfu2DSkg: posts big blind $0.50
*** HOLE CARDS ***
+zI4bP23YIjMkUHqeN2xfw: raises $1 to $1.50
Teld4PDKla7C8/Wfu2DSkg: calls $1
*** FLOP *** [Kd 8c 2d]
Teld4PDKla7C8/Wfu2DSkg: checks
+zI4bP23YIjMkUHqeN2xfw: bets $1.50
Teld4PDKla7C8/Wfu2DSkg: calls $1.50
*** TURN *** [Kd 8c 2d] [4h]
Teld4PDKla7C8/Wfu2DSkg: checks
+zI4bP23YIjMkUHqeN2xfw: checks
*** RIVER *** [Kd 8c 2d 4h] [2h]
Teld4PDKla7C8/Wfu2DSkg: bets $2
+zI4bP23YIjMkUHqeN2xfw: folds
Teld4PDKla7C8/Wfu2DSkg collected $5.75 from pot
Teld4PDKla7C8/Wfu2DSkg: doesn't show hand
*** SUMMARY ***
Total pot $6 | Rake $0.25
Board [Kd 8c 2d 4h 2h]
Seat 1: Teld4PDKla7C8/Wfu2DSkg (big blind) collected ($5.75)
Seat 2: +zI4bP23YIjMkUHqeN2xfw (button) (small blind) folded on the River



PokerStars Game #59941120550:  Hold'em No Limit ($0.25/$0.50) - 2009/07/01 1:26:14 ET
Table 'EiNh8p/wGJ1FP575iMFnqg' 9-max Seat #2 is the button
Seat 2: 8ehL7qlZzjgUh2H35iiWLw ($58.15 in chips)
Seat 3: ymLPoEIl7UL3TvZYmnadxQ ($55.35 in chips)
Seat 4: cMzaiXAM/ZAdNaEUu+LqhA ($50 in chips)
Seat 5: M+7+BTmX5vZatHVuoRB1nA ($74.45 in chips)
Seat 6: viwBDtJsY6JfsFOdBAyJIQ ($9.45 in chips)
Seat 7: 997ViqAtWn1FPjJqcffwcA ($50 in chips)
Seat 8: mSD1pginDsyHG5PDfqzphw ($10 in chips)
Seat 9: GuPkZObrz5Zkkn8FsEdF9w ($37.60 in chips)
ymLPoEIl7UL3TvZYmnadxQ: posts small blind $0.25
cMzaiXAM/ZAdNaEUu+LqhA: posts big blind $0.50
*** HOLE CARDS ***
YFFlOZgyy1Mh4iBmuNRbmQ has returned
M+7+BTmX5vZatHVuoRB1nA: folds
viwBDtJsY6JfsFOdBAyJIQ: folds
997ViqAtWn1FPjJqcffwcA: folds
mSD1pginDsyHG5PDfqzphw: folds
GuPkZObrz5Zkkn8FsEdF9w: folds
8ehL7qlZzjgUh2H35iiWLw: folds
ymLPoEIl7UL3TvZYmnadxQ: calls $0.25
cMzaiXAM/ZAdNaEUu+LqhA: raises $2 to $2.50
ymLPoEIl7UL3TvZYmnadxQ: calls $2
*** FLOP *** [7c 4s Jd]
ymLPoEIl7UL3TvZYmnadxQ: checks
cMzaiXAM/ZAdNaEUu+LqhA: bets $2.50
ymLPoEIl7UL3TvZYmnadxQ: calls $2.50
*** TURN *** [7c 4s Jd] [3c]
ymLPoEIl7UL3TvZYmnadxQ: checks
cMzaiXAM/ZAdNaEUu+LqhA: bets $6
ymLPoEIl7UL3TvZYmnadxQ: calls $6
*** RIVER *** [7c 4s Jd 3c] [Kh]
ymLPoEIl7UL3TvZYmnadxQ: checks
cMzaiXAM/ZAdNaEUu+LqhA: bets $15
ymLPoEIl7UL3TvZYmnadxQ: folds
cMzaiXAM/ZAdNaEUu+LqhA collected $20.95 from pot
cMzaiXAM/ZAdNaEUu+LqhA: doesn't show hand
*** SUMMARY ***
Total pot $22 | Rake $1.05
Board [7c 4s Jd 3c Kh]
Seat 2: 8ehL7qlZzjgUh2H35iiWLw (button) folded before Flop (didn't bet)
Seat 3: ymLPoEIl7UL3TvZYmnadxQ (small blind) folded on the River
Seat 4: cMzaiXAM/ZAdNaEUu+LqhA (big blind) collected ($20.95)
Seat 5: M+7+BTmX5vZatHVuoRB1nA folded before Flop (didn't bet)
Seat 6: viwBDtJsY6JfsFOdBAyJIQ folded before Flop (didn't bet)
Seat 7: 997ViqAtWn1FPjJqcffwcA folded before Flop (didn't bet)
Seat 8: mSD1pginDsyHG5PDfqzphw folded before Flop (didn't bet)
Seat 9: GuPkZObrz5Zkkn8FsEdF9w folded before Flop (didn't bet)



PokerStars Game #59941121212:  Hold'em No Limit ($0.25/$0.50) - 2009/07/01 1:26:15 ET
Table 'ofnd8S4IdIPph1Cbn+x7hA' 2-max Seat #2 is the button
Seat 1: PY4NvRocCFPfSIHKbh0euQ ($27 in chips)
Seat 2: l5WbyJ/iWYjpeCC6GCYY6w ($65.35 in chips)
l5WbyJ/iWYjpeCC6GCYY6w: posts small blind $0.25
PY4NvRocCFPfSIHKbh0euQ: posts big blind $0.50
*** HOLE CARDS ***
l5WbyJ/iWYjpeCC6GCYY6w: calls $0.25
PY4NvRocCFPfSIHKbh0euQ: checks
*** FLOP *** [Tc 4s 3c]
PY4NvRocCFPfSIHKbh0euQ: checks
l5WbyJ/iWYjpeCC6GCYY6w: checks
*** TURN *** [Tc 4s 3c] [9h]
PY4NvRocCFPfSIHKbh0euQ: checks
l5WbyJ/iWYjpeCC6GCYY6w: checks
*** RIVER *** [Tc 4s 3c 9h] [6h]
PY4NvRocCFPfSIHKbh0euQ: checks
l5WbyJ/iWYjpeCC6GCYY6w: checks
*** SHOW DOWN ***
PY4NvRocCFPfSIHKbh0euQ: shows [Qh 5s] (high card Queen)
l5WbyJ/iWYjpeCC6GCYY6w: mucks hand
PY4NvRocCFPfSIHKbh0euQ collected $0.95 from pot
*** SUMMARY ***
Total pot $1 | Rake $0.05
Board [Tc 4s 3c 9h 6h]
Seat 1: PY4NvRocCFPfSIHKbh0euQ (big blind) showed [Qh 5s] and won ($0.95) with high card Queen
Seat 2: l5WbyJ/iWYjpeCC6GCYY6w (button) (small blind) mucked



PokerStars Game #59941121752:  Hold'em No Limit ($0.25/$0.50) - 2009/07/01 1:26:16 ET
Table '+z1aekfHkpp09pc8F9aViw' 6-max Seat #5 is the button
Seat 1: /DArfRoYc3YpLsOQSZubFg ($50 in chips)
Seat 2: OZ6OtYh5Y53MCH/p0QTn5g ($67.85 in chips)
Seat 4: RowCSpSURHTOL/dcjg/Iug ($85 in chips)
Seat 5: 2igtJLmvIZ+HqX4XPgMPZA ($52.95 in chips)
Seat 6: GUnvMULl2qFOO1yenu1UBw ($50 in chips)
GUnvMULl2qFOO1yenu1UBw: posts small blind $0.25
/DArfRoYc3YpLsOQSZubFg: posts big blind $0.50
URYNc7fPA23K2UfadQbnCA: sits out
*** HOLE CARDS ***
OZ6OtYh5Y53MCH/p0QTn5g: folds
OZ6OtYh5Y53MCH/p0QTn5g leaves the table
RowCSpSURHTOL/dcjg/Iug: raises $1.50 to $2
2igtJLmvIZ+HqX4XPgMPZA: folds
4QfsCWthT/vSLirorNXqtg joins the table at seat #2
GUnvMULl2qFOO1yenu1UBw: folds
/DArfRoYc3YpLsOQSZubFg: folds
RowCSpSURHTOL/dcjg/Iug collected $1.25 from pot
*** SUMMARY ***
Total pot $1.25 | Rake $0
Seat 1: /DArfRoYc3YpLsOQSZubFg (big blind) folded before Flop
Seat 2: OZ6OtYh5Y53MCH/p0QTn5g folded before Flop (didn't bet)
Seat 4: RowCSpSURHTOL/dcjg/Iug collected ($1.25)
Seat 5: 2igtJLmvIZ+HqX4XPgMPZA (button) folded before Flop (didn't bet)
Seat 6: GUnvMULl2qFOO1yenu1UBw (small blind) folded before Flop



PokerStars Game #59941122314:  Hold'em No Limit ($0.25/$0.50) - 2009/07/01 1:26:17 ET
Table 'otvGDROEDdqsabxskT79qg' 9-max Seat #2 is the button
Seat 1: 8ehL7qlZzjgUh2H35iiWLw ($61.25 in chips)
Seat 2: cCjTzH9jio8607WzjcfXlg ($5.90 in chips)
Seat 3: +k7T5ocke8UwavtgUHm+Cg ($75.35 in chips)
Seat 4: MG90wfSJZnOejs/KD3vlQQ ($80.65 in chips)
Seat 5: E2518gp4aFz1+kAgmGqeEg ($12.20 in chips)
Seat 6: FFVKBJT0lZf+jFlgvy7ang ($45 in chips)
Seat 8: zE9cVigS2nW/Ljy4K4bUQA ($33.30 in chips)
Seat 9: KcY3X8YpD74Kw1RHkx/g4A ($29.40 in chips)
+k7T5ocke8UwavtgUHm+Cg: posts small blind $0.25
MG90wfSJZnOejs/KD3vlQQ: posts big blind $0.50
*** HOLE CARDS ***
E2518gp4aFz1+kAgmGqeEg: folds
FFVKBJT0lZf+jFlgvy7ang: folds
zE9cVigS2nW/Ljy4K4bUQA: folds
KcY3X8YpD74Kw1RHkx/g4A: calls $0.50
8ehL7qlZzjgUh2H35iiWLw: folds
cCjTzH9jio8607WzjcfXlg: folds
+k7T5ocke8UwavtgUHm+Cg: calls $0.25
MG90wfSJZnOejs/KD3vlQQ: checks
*** FLOP *** [6c 9c 5c]
+k7T5ocke8UwavtgUHm+Cg: bets $1
MG90wfSJZnOejs/KD3vlQQ: calls $1
KcY3X8YpD74Kw1RHkx/g4A: folds
*** TURN *** [6c 9c 5c] [4c]
+k7T5ocke8UwavtgUHm+Cg: checks
MG90wfSJZnOejs/KD3vlQQ: checks
*** RIVER *** [6c 9c 5c 4c] [3d]
+k7T5ocke8UwavtgUHm+Cg: bets $2.50
MG90wfSJZnOejs/KD3vlQQ: folds
+k7T5ocke8UwavtgUHm+Cg collected $3.35 from pot
+k7T5ocke8UwavtgUHm+Cg: doesn't show hand
*** SUMMARY ***
Total pot $3.50 | Rake $0.15
Board [6c 9c 5c 4c 3d]
Seat 1: 8ehL7qlZzjgUh2H35iiWLw folded before Flop (didn't bet)
Seat 2: cCjTzH9jio8607WzjcfXlg (button) folded before Flop (didn't bet)
Seat 3: +k7T5ocke8UwavtgUHm+Cg (small blind) collected ($3.35)
Seat 4: MG90wfSJZnOejs/KD3vlQQ (big blind) folded on the River
Seat 5: E2518gp4aFz1+kAgmGqeEg folded before Flop (didn't bet)
Seat 6: FFVKBJT0lZf+jFlgvy7ang folded before Flop (didn't bet)
Seat 8: zE9cVigS2nW/Ljy4K4bUQA folded before Flop (didn't bet)
Seat 9: KcY3X8YpD74Kw1RHkx/g4A folded on the Flop



PokerStars Game #59941122866:  Hold'em No Limit ($0.25/$0.50) - 2009/07/01 1:26:18 ET
Table '8BQGgNetI1NOvWeu3gtMNw' 2-max Seat #2 is the button
Seat 1: bypIyrYcAAifLfhZpGlKLA ($50 in chips)
Seat 2: Z4HwehErEwzsv/noQlfUlg ($154.45 in chips)
Z4HwehErEwzsv/noQlfUlg: posts small blind $0.25
bypIyrYcAAifLfhZpGlKLA: posts big blind $0.50
*** HOLE CARDS ***
Z4HwehErEwzsv/noQlfUlg: raises $2.50 to $3
bypIyrYcAAifLfhZpGlKLA: folds
Z4HwehErEwzsv/noQlfUlg collected $1 from pot
Z4HwehErEwzsv/noQlfUlg: doesn't show hand
*** SUMMARY ***
Total pot $1 | Rake $0
Seat 1: bypIyrYcAAifLfhZpGlKLA (big blind) folded before Flop
Seat 2: Z4HwehErEwzsv/noQlfUlg (button) (small blind) collected ($1)



PokerStars Game #59941125938:  Hold'em No Limit ($0.25/$0.50) - 2009/07/01 1:26:23 ET
Table 'c/CRn+68J3Y8KxD5g1ek2Q' 2-max Seat #2 is the button
Seat 1: 46qCyJ6evTkHo9al5sBMNA ($98.20 in chips)
Seat 2: BypVLsYQt3ePFm2xQL/dOA ($260.75 in chips)
BypVLsYQt3ePFm2xQL/dOA: posts small blind $0.25
46qCyJ6evTkHo9al5sBMNA: posts big blind $0.50
*** HOLE CARDS ***
BypVLsYQt3ePFm2xQL/dOA: calls $0.25
46qCyJ6evTkHo9al5sBMNA: raises $1.50 to $2
BypVLsYQt3ePFm2xQL/dOA: calls $1.50
*** FLOP *** [Jc 8h 5s]
46qCyJ6evTkHo9al5sBMNA: bets $2.50
BypVLsYQt3ePFm2xQL/dOA: calls $2.50
*** TURN *** [Jc 8h 5s] [3c]
46qCyJ6evTkHo9al5sBMNA: bets $6
BypVLsYQt3ePFm2xQL/dOA: calls $6
*** RIVER *** [Jc 8h 5s 3c] [9h]
46qCyJ6evTkHo9al5sBMNA: bets $14
BypVLsYQt3ePFm2xQL/dOA: folds
46qCyJ6evTkHo9al5sBMNA collected $20.50 from pot
46qCyJ6evTkHo9al5sBMNA: doesn't show hand
*** SUMMARY ***
Total pot $21 | Rake $0.50
Board [Jc 8h 5s 3c 9h]
Seat 1: 46qCyJ6evTkHo9al5sBMNA (big blind) collected ($20.50)
Seat 2: BypVLsYQt3ePFm2xQL/dOA (button) (small blind) folded on the River



PokerStars Game #59941125748:  Hold'em No Limit ($0.25/$0.50) - 2009/07/01 1:26:23 ET
Table 'ZYI3ZReBjdfKEYItkZHI6A' 9-max Seat #6 is the button
Seat 1: IYd5zG8k7vdBNVHbHg2Pag ($64.40 in chips)
Seat 2: uw9QayAAxLM3Hb+HR7mSkg ($9.25 in chips)
Seat 4: e2+sK/yjnj94rXOKoxPP2A ($64.40 in chips)
Seat 5: ApHP7ouup365XIUFBdEDxg ($24.25 in chips)
Seat 6: 1xBtrSVBbgFH/viUWKqQeg ($29.45 in chips)
Seat 7: HWcfp1hY1hqvrddzW3/FQw ($12.75 in chips)
Seat 8: ji04uOybxCdpdefzlUQeKQ ($30.60 in chips)
HWcfp1hY1hqvrddzW3/FQw: posts small blind $0.25
ji04uOybxCdpdefzlUQeKQ: posts big blind $0.50
HZkVla4kK2SI42CVrPZ/ig: sits out
75K2MXwN65Sjfp1yHd50Hg: sits out
*** HOLE CARDS ***
e2+sK/yjnj94rXOKoxPP2A said, "i folded KK"
IYd5zG8k7vdBNVHbHg2Pag: folds
uw9QayAAxLM3Hb+HR7mSkg: folds
e2+sK/yjnj94rXOKoxPP2A: folds
ApHP7ouup365XIUFBdEDxg: folds
1xBtrSVBbgFH/viUWKqQeg: folds
HWcfp1hY1hqvrddzW3/FQw: calls $0.25
ji04uOybxCdpdefzlUQeKQ: checks
*** FLOP *** [9c Ad 4s]
HWcfp1hY1hqvrddzW3/FQw: checks
ji04uOybxCdpdefzlUQeKQ: checks
*** TURN *** [9c Ad 4s] [6s]
HWcfp1hY1hqvrddzW3/FQw: checks
ApHP7ouup365XIUFBdEDxg said, "glad you did"
ji04uOybxCdpdefzlUQeKQ: bets $1.50
HWcfp1hY1hqvrddzW3/FQw: folds
ji04uOybxCdpdefzlUQeKQ collected $0.95 from pot
ji04uOybxCdpdefzlUQeKQ: doesn't show hand
*** SUMMARY ***
Total pot $1 | Rake $0.05
Board [9c Ad 4s 6s]
Seat 1: IYd5zG8k7vdBNVHbHg2Pag folded before Flop (didn't bet)
Seat 2: uw9QayAAxLM3Hb+HR7mSkg folded before Flop (didn't bet)
Seat 4: e2+sK/yjnj94rXOKoxPP2A folded before Flop (didn't bet)
Seat 5: ApHP7ouup365XIUFBdEDxg folded before Flop (didn't bet)
Seat 6: 1xBtrSVBbgFH/viUWKqQeg (button) folded before Flop (didn't bet)
Seat 7: HWcfp1hY1hqvrddzW3/FQw (small blind) folded on the Turn
Seat 8: ji04uOybxCdpdefzlUQeKQ (big blind) collected ($0.95)



PokerStars Game #59941125862:  Hold'em No Limit ($0.25/$0.50) - 2009/07/01 1:26:23 ET
Table 'X6IRCRTh+20gjz8aubWnwA' 9-max Seat #8 is the button
Seat 1: E2518gp4aFz1+kAgmGqeEg ($10.25 in chips)
Seat 2: HZkVla4kK2SI42CVrPZ/ig ($10 in chips)
Seat 3: SWv01peOe69QQRvhQTqjQw ($12.80 in chips)
Seat 4: M3JFBNQ8Bbw3FBZ/18MuXw ($31.05 in chips)
Seat 5: uw9QayAAxLM3Hb+HR7mSkg ($18.30 in chips)
Seat 6: Qi/PyOsKwaqtKIg0H+7ELg ($9.25 in chips)
Seat 8: HxeBVq06/3Bh/H986sgdbw ($46.50 in chips)
Seat 9: M+7+BTmX5vZatHVuoRB1nA ($44.80 in chips)
M+7+BTmX5vZatHVuoRB1nA: posts small blind $0.25
E2518gp4aFz1+kAgmGqeEg: posts big blind $0.50
*** HOLE CARDS ***
cFHQjKQOOKTUzoilhrXHLg leaves the table
HZkVla4kK2SI42CVrPZ/ig: folds
SWv01peOe69QQRvhQTqjQw: folds
M3JFBNQ8Bbw3FBZ/18MuXw: raises $1 to $1.50
uw9QayAAxLM3Hb+HR7mSkg: folds
Qi/PyOsKwaqtKIg0H+7ELg: folds
HxeBVq06/3Bh/H986sgdbw: calls $1.50
M+7+BTmX5vZatHVuoRB1nA: folds
E2518gp4aFz1+kAgmGqeEg: folds
*** FLOP *** [5s 4d As]
+RUz0sVA09ZE8PNpIl+EBQ joins the table at seat #7
M3JFBNQ8Bbw3FBZ/18MuXw: bets $2
HxeBVq06/3Bh/H986sgdbw: folds
M3JFBNQ8Bbw3FBZ/18MuXw collected $3.60 from pot
*** SUMMARY ***
Total pot $3.75 | Rake $0.15
Board [5s 4d As]
Seat 1: E2518gp4aFz1+kAgmGqeEg (big blind) folded before Flop
Seat 2: HZkVla4kK2SI42CVrPZ/ig folded before Flop (didn't bet)
Seat 3: SWv01peOe69QQRvhQTqjQw folded before Flop (didn't bet)
Seat 4: M3JFBNQ8Bbw3FBZ/18MuXw collected ($3.60)
Seat 5: uw9QayAAxLM3Hb+HR7mSkg folded before Flop (didn't bet)
Seat 6: Qi/PyOsKwaqtKIg0H+7ELg folded before Flop (didn't bet)
Seat 8: HxeBVq06/3Bh/H986sgdbw (button) folded on the Flop
Seat 9: M+7+BTmX5vZatHVuoRB1nA (small blind) folded before Flop



PokerStars Game #59941127750:  Hold'em No Limit ($0.25/$0.50) - 2009/07/01 1:26:26 ET
Table 'lSisgp6H7Fg1hH5VfjEjYQ' 9-max Seat #3 is the button
Seat 1: 5k9fvXD9suIgCxU4HLQjTw ($54.85 in chips)
Seat 3: SKnJuWHScqetA/qG5p+wCg ($30 in chips)
Seat 4: bwv/rbH/hHhPhY6u9mu04w ($35.65 in chips)
Seat 5: mSD1pginDsyHG5PDfqzphw ($13 in chips)
Seat 6: +k7T5ocke8UwavtgUHm+Cg ($71.15 in chips)
Seat 7: IDtNLR9uFCDdjNsJWMHA5Q ($21.15 in chips)
Seat 8: a4JDWmpFQkL10XfAyuF51A ($12.25 in chips)
Seat 9: YzeKFbJVLmJGTgNH3ySQlw ($7.45 in chips)
bwv/rbH/hHhPhY6u9mu04w: posts small blind $0.25
mSD1pginDsyHG5PDfqzphw: posts big blind $0.50
*** HOLE CARDS ***
+k7T5ocke8UwavtgUHm+Cg: folds
IDtNLR9uFCDdjNsJWMHA5Q: calls $0.50
a4JDWmpFQkL10XfAyuF51A: folds
YzeKFbJVLmJGTgNH3ySQlw: calls $0.50
5k9fvXD9suIgCxU4HLQjTw: folds
SKnJuWHScqetA/qG5p+wCg: folds
bwv/rbH/hHhPhY6u9mu04w: calls $0.25
mSD1pginDsyHG5PDfqzphw: checks
*** FLOP *** [3s As Kc]
bwv/rbH/hHhPhY6u9mu04w: bets $0.50
mSD1pginDsyHG5PDfqzphw: folds
galinaglad leaves the table
IDtNLR9uFCDdjNsJWMHA5Q: calls $0.50
YzeKFbJVLmJGTgNH3ySQlw: calls $0.50
*** TURN *** [3s As Kc] [9d]
bwv/rbH/hHhPhY6u9mu04w: checks
IDtNLR9uFCDdjNsJWMHA5Q: checks
YzeKFbJVLmJGTgNH3ySQlw: bets $1
bwv/rbH/hHhPhY6u9mu04w: calls $1
IDtNLR9uFCDdjNsJWMHA5Q: folds
*** RIVER *** [3s As Kc 9d] [7s]
bwv/rbH/hHhPhY6u9mu04w: checks
YzeKFbJVLmJGTgNH3ySQlw: checks
*** SHOW DOWN ***
bwv/rbH/hHhPhY6u9mu04w: shows [7h Ah] (two pair, Aces and Sevens)
YzeKFbJVLmJGTgNH3ySQlw: mucks hand
bwv/rbH/hHhPhY6u9mu04w collected $5.25 from pot
5acK4E7fzEwnplVBZ6eNWA joins the table at seat #2
*** SUMMARY ***
Total pot $5.50 | Rake $0.25
Board [3s As Kc 9d 7s]
Seat 1: 5k9fvXD9suIgCxU4HLQjTw folded before Flop (didn't bet)
Seat 3: SKnJuWHScqetA/qG5p+wCg (button) folded before Flop (didn't bet)
Seat 4: bwv/rbH/hHhPhY6u9mu04w (small blind) showed [7h Ah] and won ($5.25) with two pair, Aces and Sevens
Seat 5: mSD1pginDsyHG5PDfqzphw (big blind) folded on the Flop
Seat 6: +k7T5ocke8UwavtgUHm+Cg folded before Flop (didn't bet)
Seat 7: IDtNLR9uFCDdjNsJWMHA5Q folded on the Turn
Seat 8: a4JDWmpFQkL10XfAyuF51A folded before Flop (didn't bet)
Seat 9: YzeKFbJVLmJGTgNH3ySQlw mucked



PokerStars Game #59941127472:  Hold'em No Limit ($0.25/$0.50) - 2009/07/01 1:26:26 ET
Table 'B+sqsfj6d6zXicNfaseTaw' 2-max Seat #2 is the button
Seat 1: +4GNcSsecmapVGSdV0mUPA ($136 in chips)
Seat 2: Lv5RmpRe6LtPkBzM9Gpo5A ($90.15 in chips)
Lv5RmpRe6LtPkBzM9Gpo5A: posts small blind $0.25
+4GNcSsecmapVGSdV0mUPA: posts big blind $0.50
*** HOLE CARDS ***
Lv5RmpRe6LtPkBzM9Gpo5A: calls $0.25
+4GNcSsecmapVGSdV0mUPA: checks
*** FLOP *** [4c 6c Th]
+4GNcSsecmapVGSdV0mUPA: checks
Lv5RmpRe6LtPkBzM9Gpo5A: checks
*** TURN *** [4c 6c Th] [Td]
+4GNcSsecmapVGSdV0mUPA: checks
Lv5RmpRe6LtPkBzM9Gpo5A: checks
*** RIVER *** [4c 6c Th Td] [3c]
+4GNcSsecmapVGSdV0mUPA: bets $5
Lv5RmpRe6LtPkBzM9Gpo5A: folds
+4GNcSsecmapVGSdV0mUPA collected $0.95 from pot
+4GNcSsecmapVGSdV0mUPA: doesn't show hand
*** SUMMARY ***
Total pot $1 | Rake $0.05
Board [4c 6c Th Td 3c]
Seat 1: +4GNcSsecmapVGSdV0mUPA (big blind) collected ($0.95)
Seat 2: Lv5RmpRe6LtPkBzM9Gpo5A (button) (small blind) folded on the River



PokerStars Game #59941128704:  Hold'em No Limit ($0.25/$0.50) - 2009/07/01 1:26:28 ET
Table 'fx6MqwfYAj/Rt86hBz2L3Q' 9-max Seat #9 is the button
Seat 1: v/4aX0ejnaIFK4ftDk2Lyg ($51.65 in chips)
Seat 2: C3rGXblctNcWI6JYPHhaEg ($42.35 in chips)
Seat 3: iadBi5AEt7gTBXbDSSnMYQ ($54.10 in chips)
Seat 5: iAISe3dVeua8PUn2wwgDHw ($61.65 in chips)
Seat 6: 5k9fvXD9suIgCxU4HLQjTw ($50 in chips)
Seat 8: JYwJYYV9pM5KWdSiETl8rA ($63 in chips)
Seat 9: vO3QVRovWemcGMkm7ijAIA ($11.50 in chips)
v/4aX0ejnaIFK4ftDk2Lyg: posts small blind $0.25
C3rGXblctNcWI6JYPHhaEg: posts big blind $0.50
mSD1pginDsyHG5PDfqzphw: sits out
*** HOLE CARDS ***
iadBi5AEt7gTBXbDSSnMYQ: calls $0.50
iAISe3dVeua8PUn2wwgDHw: folds
5k9fvXD9suIgCxU4HLQjTw: folds
JYwJYYV9pM5KWdSiETl8rA: folds
vO3QVRovWemcGMkm7ijAIA: folds
v/4aX0ejnaIFK4ftDk2Lyg: folds
C3rGXblctNcWI6JYPHhaEg: checks
*** FLOP *** [Ah 8d Qh]
C3rGXblctNcWI6JYPHhaEg: checks
iadBi5AEt7gTBXbDSSnMYQ: checks
*** TURN *** [Ah 8d Qh] [9c]
C3rGXblctNcWI6JYPHhaEg: checks
iadBi5AEt7gTBXbDSSnMYQ: checks
*** RIVER *** [Ah 8d Qh 9c] [6h]
C3rGXblctNcWI6JYPHhaEg: checks
iadBi5AEt7gTBXbDSSnMYQ: checks
*** SHOW DOWN ***
C3rGXblctNcWI6JYPHhaEg: shows [9h 3d] (a pair of Nines)
iadBi5AEt7gTBXbDSSnMYQ: shows [7d Qs] (a pair of Queens)
iadBi5AEt7gTBXbDSSnMYQ collected $1.20 from pot
*** SUMMARY ***
Total pot $1.25 | Rake $0.05
Board [Ah 8d Qh 9c 6h]
Seat 1: v/4aX0ejnaIFK4ftDk2Lyg (small blind) folded before Flop
Seat 2: C3rGXblctNcWI6JYPHhaEg (big blind) showed [9h 3d] and lost with a pair of Nines
Seat 3: iadBi5AEt7gTBXbDSSnMYQ showed [7d Qs] and won ($1.20) with a pair of Queens
Seat 5: iAISe3dVeua8PUn2wwgDHw folded before Flop (didn't bet)
Seat 6: 5k9fvXD9suIgCxU4HLQjTw folded before Flop (didn't bet)
Seat 8: JYwJYYV9pM5KWdSiETl8rA folded before Flop (didn't bet)
Seat 9: vO3QVRovWemcGMkm7ijAIA (button) folded before Flop (didn't bet)



PokerStars Game #59941129280:  Hold'em No Limit ($0.25/$0.50) - 2009/07/01 1:26:29 ET
Table '8BQGgNetI1NOvWeu3gtMNw' 2-max Seat #1 is the button
Seat 1: bypIyrYcAAifLfhZpGlKLA ($50 in chips)
Seat 2: Z4HwehErEwzsv/noQlfUlg ($154.95 in chips)
bypIyrYcAAifLfhZpGlKLA: posts small blind $0.25
Z4HwehErEwzsv/noQlfUlg: posts big blind $0.50
*** HOLE CARDS ***
bypIyrYcAAifLfhZpGlKLA: raises $1 to $1.50
Z4HwehErEwzsv/noQlfUlg: raises $2 to $3.50
bypIyrYcAAifLfhZpGlKLA: calls $2
*** FLOP *** [Qh 8d 9d]
Z4HwehErEwzsv/noQlfUlg: bets $3
bypIyrYcAAifLfhZpGlKLA: raises $8.50 to $11.50
Z4HwehErEwzsv/noQlfUlg: calls $8.50
*** TURN *** [Qh 8d 9d] [3d]
Z4HwehErEwzsv/noQlfUlg: checks
bypIyrYcAAifLfhZpGlKLA: checks
*** RIVER *** [Qh 8d 9d 3d] [4h]
Z4HwehErEwzsv/noQlfUlg: bets $35
bypIyrYcAAifLfhZpGlKLA: folds
Z4HwehErEwzsv/noQlfUlg collected $29.50 from pot
Z4HwehErEwzsv/noQlfUlg: doesn't show hand
*** SUMMARY ***
Total pot $30 | Rake $0.50
Board [Qh 8d 9d 3d 4h]
Seat 1: bypIyrYcAAifLfhZpGlKLA (button) (small blind) folded on the River
Seat 2: Z4HwehErEwzsv/noQlfUlg (big blind) collected ($29.50)



PokerStars Game #59941131370:  Hold'em No Limit ($0.25/$0.50) - 2009/07/01 1:26:32 ET
Table 'ofnd8S4IdIPph1Cbn+x7hA' 2-max Seat #1 is the button
Seat 1: PY4NvRocCFPfSIHKbh0euQ ($27.45 in chips)
Seat 2: l5WbyJ/iWYjpeCC6GCYY6w ($64.85 in chips)
PY4NvRocCFPfSIHKbh0euQ: posts small blind $0.25
l5WbyJ/iWYjpeCC6GCYY6w: posts big blind $0.50
*** HOLE CARDS ***
PY4NvRocCFPfSIHKbh0euQ: raises $0.50 to $1
l5WbyJ/iWYjpeCC6GCYY6w: folds
PY4NvRocCFPfSIHKbh0euQ collected $1 from pot
*** SUMMARY ***
Total pot $1 | Rake $0
Seat 1: PY4NvRocCFPfSIHKbh0euQ (button) (small blind) collected ($1)
Seat 2: l5WbyJ/iWYjpeCC6GCYY6w (big blind) folded before Flop



PokerStars Game #59941132078:  Hold'em No Limit ($0.25/$0.50) - 2009/07/01 1:26:33 ET
Table '3FhG0gl3kMX3wBEEqj+wnQ' 9-max Seat #4 is the button
Seat 1: bxLSulbgr8LmKNjOzw8URg ($49.30 in chips)
Seat 2: vacmVLJJECYI6HjAynFcpg ($50.60 in chips)
Seat 3: YXCE3WOZi8g2sIf3y/plVw ($50 in chips)
Seat 4: e2+sK/yjnj94rXOKoxPP2A ($70.25 in chips)
Seat 5: XcLXSUMHSpshK/7Lh0M4Vg ($9.50 in chips)
Seat 6: 997ViqAtWn1FPjJqcffwcA ($110.55 in chips)
Seat 7: mSD1pginDsyHG5PDfqzphw ($13.75 in chips)
Seat 8: j3K/Jujr7PY4ZM2RZvlH6A ($52.70 in chips)
XcLXSUMHSpshK/7Lh0M4Vg: posts small blind $0.25
997ViqAtWn1FPjJqcffwcA: posts big blind $0.50
*** HOLE CARDS ***
mSD1pginDsyHG5PDfqzphw: folds
j3K/Jujr7PY4ZM2RZvlH6A: raises $1 to $1.50
bxLSulbgr8LmKNjOzw8URg: folds
vacmVLJJECYI6HjAynFcpg: folds
YXCE3WOZi8g2sIf3y/plVw: folds
e2+sK/yjnj94rXOKoxPP2A: folds
XcLXSUMHSpshK/7Lh0M4Vg: folds
997ViqAtWn1FPjJqcffwcA: folds
j3K/Jujr7PY4ZM2RZvlH6A collected $1.25 from pot
j3K/Jujr7PY4ZM2RZvlH6A: doesn't show hand
*** SUMMARY ***
Total pot $1.25 | Rake $0
Seat 1: bxLSulbgr8LmKNjOzw8URg folded before Flop (didn't bet)
Seat 2: vacmVLJJECYI6HjAynFcpg folded before Flop (didn't bet)
Seat 3: YXCE3WOZi8g2sIf3y/plVw folded before Flop (didn't bet)
Seat 4: e2+sK/yjnj94rXOKoxPP2A (button) folded before Flop (didn't bet)
Seat 5: XcLXSUMHSpshK/7Lh0M4Vg (small blind) folded before Flop
Seat 6: 997ViqAtWn1FPjJqcffwcA (big blind) folded before Flop
Seat 7: mSD1pginDsyHG5PDfqzphw folded before Flop (didn't bet)
Seat 8: j3K/Jujr7PY4ZM2RZvlH6A collected ($1.25)



PokerStars Game #59941132628:  Hold'em No Limit ($0.25/$0.50) - 2009/07/01 1:26:34 ET
Table 'Nz0Vr7WMHL2g5Uk7dDZjpw' 9-max Seat #6 is the button
Seat 3: hoglu9inkgs6zN573/bJag ($5.70 in chips)
Seat 4: E2518gp4aFz1+kAgmGqeEg ($12.25 in chips)
Seat 5: WGW0DgjBUXs1ylURHG8vnQ ($16.40 in chips)
Seat 6: 997ViqAtWn1FPjJqcffwcA ($57.30 in chips)
Seat 7: KPLH0gELgFe2OuAnhJFI5w ($25.20 in chips)
Seat 8: aoL+R/61Kxmw69ypuPrWAQ ($27.50 in chips)
Seat 9: mSD1pginDsyHG5PDfqzphw ($10 in chips)
KPLH0gELgFe2OuAnhJFI5w: posts small blind $0.25
aoL+R/61Kxmw69ypuPrWAQ: posts big blind $0.50
9yMsdgReyOUerNsmTYCCDQ is connected
9yMsdgReyOUerNsmTYCCDQ: sits out
SegjDnMxWMujiD57ESNL+g: sits out
*** HOLE CARDS ***
mSD1pginDsyHG5PDfqzphw: folds
hoglu9inkgs6zN573/bJag: folds
E2518gp4aFz1+kAgmGqeEg: folds
WGW0DgjBUXs1ylURHG8vnQ: calls $0.50
997ViqAtWn1FPjJqcffwcA: folds
KPLH0gELgFe2OuAnhJFI5w: calls $0.25
aoL+R/61Kxmw69ypuPrWAQ: checks
*** FLOP *** [Jd Th Td]
KPLH0gELgFe2OuAnhJFI5w: checks
aoL+R/61Kxmw69ypuPrWAQ: checks
WGW0DgjBUXs1ylURHG8vnQ: bets $1
KPLH0gELgFe2OuAnhJFI5w: folds
aoL+R/61Kxmw69ypuPrWAQ: calls $1
*** TURN *** [Jd Th Td] [6h]
aoL+R/61Kxmw69ypuPrWAQ: checks
WGW0DgjBUXs1ylURHG8vnQ: bets $1
aoL+R/61Kxmw69ypuPrWAQ: raises $1 to $2
WGW0DgjBUXs1ylURHG8vnQ: calls $1
*** RIVER *** [Jd Th Td 6h] [8c]
aoL+R/61Kxmw69ypuPrWAQ: bets $2.50
WGW0DgjBUXs1ylURHG8vnQ: folds
aoL+R/61Kxmw69ypuPrWAQ collected $7.15 from pot
*** SUMMARY ***
Total pot $7.50 | Rake $0.35
Board [Jd Th Td 6h 8c]
Seat 3: hoglu9inkgs6zN573/bJag folded before Flop (didn't bet)
Seat 4: E2518gp4aFz1+kAgmGqeEg folded before Flop (didn't bet)
Seat 5: WGW0DgjBUXs1ylURHG8vnQ folded on the River
Seat 6: 997ViqAtWn1FPjJqcffwcA (button) folded before Flop (didn't bet)
Seat 7: KPLH0gELgFe2OuAnhJFI5w (small blind) folded on the Flop
Seat 8: aoL+R/61Kxmw69ypuPrWAQ (big blind) collected ($7.15)
Seat 9: mSD1pginDsyHG5PDfqzphw folded before Flop (didn't bet)



PokerStars Game #59941132444:  Hold'em No Limit ($0.25/$0.50) - 2009/07/01 1:26:34 ET
Table 'tyR5AZNKV8Aadbrnrnlg7g' 6-max Seat #4 is the button
Seat 1: BgOXYI0yYSN1ULC4FqsNkg ($92.05 in chips)
Seat 2: BAjwVL+zKKd0s0fAWstzQQ ($13.95 in chips)
Seat 3: JFLrYNyQmwPhRQAtoSAuyA ($45.55 in chips)
Seat 4: 4QfsCWthT/vSLirorNXqtg ($85.95 in chips)
Seat 5: GUnvMULl2qFOO1yenu1UBw ($78.25 in chips)
Seat 6: 498aWaGsW4uGfuWl+2FCGw ($70.05 in chips)
GUnvMULl2qFOO1yenu1UBw: posts small blind $0.25
498aWaGsW4uGfuWl+2FCGw: posts big blind $0.50
*** HOLE CARDS ***
BgOXYI0yYSN1ULC4FqsNkg: folds
BAjwVL+zKKd0s0fAWstzQQ: folds
JFLrYNyQmwPhRQAtoSAuyA: raises $1 to $1.50
4QfsCWthT/vSLirorNXqtg: folds
GUnvMULl2qFOO1yenu1UBw: folds
498aWaGsW4uGfuWl+2FCGw: calls $1
*** FLOP *** [6d 2h 5d]
498aWaGsW4uGfuWl+2FCGw: checks
JFLrYNyQmwPhRQAtoSAuyA: checks
*** TURN *** [6d 2h 5d] [7h]
498aWaGsW4uGfuWl+2FCGw: bets $0.50
JFLrYNyQmwPhRQAtoSAuyA: calls $0.50
*** RIVER *** [6d 2h 5d 7h] [Jc]
498aWaGsW4uGfuWl+2FCGw: checks
JFLrYNyQmwPhRQAtoSAuyA: bets $2
498aWaGsW4uGfuWl+2FCGw: calls $2
*** SHOW DOWN ***
JFLrYNyQmwPhRQAtoSAuyA: shows [Jh 8c] (a pair of Jacks)
498aWaGsW4uGfuWl+2FCGw: mucks hand
JFLrYNyQmwPhRQAtoSAuyA collected $7.85 from pot
*** SUMMARY ***
Total pot $8.25 | Rake $0.40
Board [6d 2h 5d 7h Jc]
Seat 1: BgOXYI0yYSN1ULC4FqsNkg folded before Flop (didn't bet)
Seat 2: BAjwVL+zKKd0s0fAWstzQQ folded before Flop (didn't bet)
Seat 3: JFLrYNyQmwPhRQAtoSAuyA showed [Jh 8c] and won ($7.85) with a pair of Jacks
Seat 4: 4QfsCWthT/vSLirorNXqtg (button) folded before Flop (didn't bet)
Seat 5: GUnvMULl2qFOO1yenu1UBw (small blind) folded before Flop
Seat 6: 498aWaGsW4uGfuWl+2FCGw (big blind) mucked



PokerStars Game #59941133014:  Hold'em No Limit ($0.25/$0.50) - 2009/07/01 1:26:35 ET
Table 'kgbJRsxfv64KrErDRBAkcw' 6-max Seat #6 is the button
Seat 1: VamsyhlFzXGF6/ydo0BHeA ($19.05 in chips)
Seat 2: AdS8BJMOheS01zjCDfPMFg ($65.25 in chips)
Seat 3: c4MNIaIyPMOMxrgT8FT5nA ($229.70 in chips)
Seat 4: 2igtJLmvIZ+HqX4XPgMPZA ($50 in chips)
Seat 5: eUBBn2R56C1IQ6Cs/vitwg ($55.20 in chips)
Seat 6: 1b+2BbjMN8qhR1WPqdE9VQ ($55.90 in chips)
VamsyhlFzXGF6/ydo0BHeA: posts small blind $0.25
AdS8BJMOheS01zjCDfPMFg: posts big blind $0.50
*** HOLE CARDS ***
c4MNIaIyPMOMxrgT8FT5nA: folds
2igtJLmvIZ+HqX4XPgMPZA: raises $1.50 to $2
eUBBn2R56C1IQ6Cs/vitwg: folds
1b+2BbjMN8qhR1WPqdE9VQ: folds
VamsyhlFzXGF6/ydo0BHeA: calls $1.75
AdS8BJMOheS01zjCDfPMFg: folds
*** FLOP *** [5h 5s Qh]
VamsyhlFzXGF6/ydo0BHeA: checks
2igtJLmvIZ+HqX4XPgMPZA: bets $3
VamsyhlFzXGF6/ydo0BHeA: calls $3
*** TURN *** [5h 5s Qh] [8h]
VamsyhlFzXGF6/ydo0BHeA: checks
2igtJLmvIZ+HqX4XPgMPZA: checks
*** RIVER *** [5h 5s Qh 8h] [Ad]
VamsyhlFzXGF6/ydo0BHeA: checks
2igtJLmvIZ+HqX4XPgMPZA: checks
*** SHOW DOWN ***
VamsyhlFzXGF6/ydo0BHeA: shows [4h 4c] (two pair, Fives and Fours)
2igtJLmvIZ+HqX4XPgMPZA: shows [8c 6c] (two pair, Eights and Fives)
2igtJLmvIZ+HqX4XPgMPZA collected $10 from pot
*** SUMMARY ***
Total pot $10.50 | Rake $0.50
Board [5h 5s Qh 8h Ad]
Seat 1: VamsyhlFzXGF6/ydo0BHeA (small blind) showed [4h 4c] and lost with two pair, Fives and Fours
Seat 2: AdS8BJMOheS01zjCDfPMFg (big blind) folded before Flop
Seat 3: c4MNIaIyPMOMxrgT8FT5nA folded before Flop (didn't bet)
Seat 4: 2igtJLmvIZ+HqX4XPgMPZA showed [8c 6c] and won ($10) with two pair, Eights and Fives
Seat 5: eUBBn2R56C1IQ6Cs/vitwg folded before Flop (didn't bet)
Seat 6: 1b+2BbjMN8qhR1WPqdE9VQ (button) folded before Flop (didn't bet)



PokerStars Game #59941134060:  Hold'em No Limit ($0.25/$0.50) - 2009/07/01 1:26:37 ET
Table 'ibNfFy0bCzuBaUORla0aGw' 9-max Seat #3 is the button
Seat 1: xZCXQSXlrZkp3pZizzVXCw ($49.80 in chips)
Seat 2: 90Wb75h3W1BRpbqVnuk8gw ($50 in chips)
Seat 3: AjV5McH1KMMclY26QdLM5w ($26.35 in chips)
Seat 4: nhDtFZ2uuvm5hDKG7ZVEpA ($49.50 in chips)
Seat 5: GIJAc9kPrLZHLSX8Q6i99w ($26.80 in chips)
Seat 6: H8cPaCtX7d6meGUVSM5sxw ($58.60 in chips)
Seat 7: HZkVla4kK2SI42CVrPZ/ig ($15.85 in chips)
Seat 8: Ja2jdidjip2UeJnRzmzAAQ ($47 in chips)
Seat 9: pFtzb1sR4b0d1aw6aIRgDg ($56.15 in chips)
nhDtFZ2uuvm5hDKG7ZVEpA: posts small blind $0.25
GIJAc9kPrLZHLSX8Q6i99w: posts big blind $0.50
*** HOLE CARDS ***
H8cPaCtX7d6meGUVSM5sxw: folds
HZkVla4kK2SI42CVrPZ/ig: folds
Ja2jdidjip2UeJnRzmzAAQ: folds
pFtzb1sR4b0d1aw6aIRgDg: folds
xZCXQSXlrZkp3pZizzVXCw: folds
90Wb75h3W1BRpbqVnuk8gw: raises $2 to $2.50
AjV5McH1KMMclY26QdLM5w: calls $2.50
nhDtFZ2uuvm5hDKG7ZVEpA: folds
GIJAc9kPrLZHLSX8Q6i99w: calls $2
*** FLOP *** [4s Qs 6c]
GIJAc9kPrLZHLSX8Q6i99w: bets $3
90Wb75h3W1BRpbqVnuk8gw: folds
AjV5McH1KMMclY26QdLM5w: calls $3
*** TURN *** [4s Qs 6c] [2h]
GIJAc9kPrLZHLSX8Q6i99w: bets $10.50
AjV5McH1KMMclY26QdLM5w: folds
GIJAc9kPrLZHLSX8Q6i99w collected $13.10 from pot
*** SUMMARY ***
Total pot $13.75 | Rake $0.65
Board [4s Qs 6c 2h]
Seat 1: xZCXQSXlrZkp3pZizzVXCw folded before Flop (didn't bet)
Seat 2: 90Wb75h3W1BRpbqVnuk8gw folded on the Flop
Seat 3: AjV5McH1KMMclY26QdLM5w (button) folded on the Turn
Seat 4: nhDtFZ2uuvm5hDKG7ZVEpA (small blind) folded before Flop
Seat 5: GIJAc9kPrLZHLSX8Q6i99w (big blind) collected ($13.10)
Seat 6: H8cPaCtX7d6meGUVSM5sxw folded before Flop (didn't bet)
Seat 7: HZkVla4kK2SI42CVrPZ/ig folded before Flop (didn't bet)
Seat 8: Ja2jdidjip2UeJnRzmzAAQ folded before Flop (didn't bet)
Seat 9: pFtzb1sR4b0d1aw6aIRgDg folded before Flop (didn't bet)



PokerStars Game #59941134960:  Hold'em No Limit ($0.25/$0.50) - 2009/07/01 1:26:38 ET
Table '+dXkOAQyS8j9PQZusUTMpg' 2-max Seat #1 is the button
Seat 1: Teld4PDKla7C8/Wfu2DSkg ($54.45 in chips)
Seat 2: +zI4bP23YIjMkUHqeN2xfw ($23 in chips)
Teld4PDKla7C8/Wfu2DSkg: posts small blind $0.25
+zI4bP23YIjMkUHqeN2xfw: posts big blind $0.50
*** HOLE CARDS ***
Teld4PDKla7C8/Wfu2DSkg: folds
+zI4bP23YIjMkUHqeN2xfw collected $0.50 from pot
*** SUMMARY ***
Total pot $0.50 | Rake $0
Seat 1: Teld4PDKla7C8/Wfu2DSkg (button) (small blind) folded before Flop
Seat 2: +zI4bP23YIjMkUHqeN2xfw (big blind) collected ($0.50)



PokerStars Game #59941135228:  Hold'em No Limit ($0.25/$0.50) - 2009/07/01 1:26:39 ET
Table 'ofnd8S4IdIPph1Cbn+x7hA' 2-max Seat #2 is the button
Seat 1: PY4NvRocCFPfSIHKbh0euQ ($27.95 in chips)
Seat 2: l5WbyJ/iWYjpeCC6GCYY6w ($64.35 in chips)
l5WbyJ/iWYjpeCC6GCYY6w: posts small blind $0.25
PY4NvRocCFPfSIHKbh0euQ: posts big blind $0.50
*** HOLE CARDS ***
l5WbyJ/iWYjpeCC6GCYY6w: folds
PY4NvRocCFPfSIHKbh0euQ collected $0.50 from pot
*** SUMMARY ***
Total pot $0.50 | Rake $0
Seat 1: PY4NvRocCFPfSIHKbh0euQ (big blind) collected ($0.50)
Seat 2: l5WbyJ/iWYjpeCC6GCYY6w (button) (small blind) folded before Flop



PokerStars Game #59941135378:  Hold'em No Limit ($0.25/$0.50) - 2009/07/01 1:26:39 ET
Table 'hSTs/dUsYLgJQuF2Onp0MQ' 6-max Seat #1 is the button
Seat 1: 1WUCqNG+p+vfWRTXNu4ljw ($50 in chips)
Seat 2: Hdd4js36ITbTJ/QuVYwTlA ($40.50 in chips)
Seat 3: lxIzoHy0RnkfFSODHC2liw ($50 in chips)
Seat 4: 2igtJLmvIZ+HqX4XPgMPZA ($80.15 in chips)
Seat 5: IBNygaT1aa9Z1uPdJJilwA ($53.70 in chips)
Seat 6: M1KyQQvVPVuxqTAB8sR/zQ ($95.55 in chips)
Hdd4js36ITbTJ/QuVYwTlA: posts small blind $0.25
lxIzoHy0RnkfFSODHC2liw: posts big blind $0.50
*** HOLE CARDS ***
2igtJLmvIZ+HqX4XPgMPZA: folds
IBNygaT1aa9Z1uPdJJilwA: folds
M1KyQQvVPVuxqTAB8sR/zQ: folds
1WUCqNG+p+vfWRTXNu4ljw: folds
Hdd4js36ITbTJ/QuVYwTlA: calls $0.25
lxIzoHy0RnkfFSODHC2liw: checks
*** FLOP *** [Ad 9c Qd]
Hdd4js36ITbTJ/QuVYwTlA: bets $0.50
lxIzoHy0RnkfFSODHC2liw: calls $0.50
*** TURN *** [Ad 9c Qd] [7c]
Hdd4js36ITbTJ/QuVYwTlA: bets $0.50
lxIzoHy0RnkfFSODHC2liw: calls $0.50
*** RIVER *** [Ad 9c Qd 7c] [2h]
Hdd4js36ITbTJ/QuVYwTlA: bets $0.50
lxIzoHy0RnkfFSODHC2liw: calls $0.50
*** SHOW DOWN ***
Hdd4js36ITbTJ/QuVYwTlA: shows [6d 4s] (high card Ace)
lxIzoHy0RnkfFSODHC2liw: shows [Ks Qh] (a pair of Queens)
lxIzoHy0RnkfFSODHC2liw collected $3.85 from pot
*** SUMMARY ***
Total pot $4 | Rake $0.15
Board [Ad 9c Qd 7c 2h]
Seat 1: 1WUCqNG+p+vfWRTXNu4ljw (button) folded before Flop (didn't bet)
Seat 2: Hdd4js36ITbTJ/QuVYwTlA (small blind) showed [6d 4s] and lost with high card Ace
Seat 3: lxIzoHy0RnkfFSODHC2liw (big blind) showed [Ks Qh] and won ($3.85) with a pair of Queens
Seat 4: 2igtJLmvIZ+HqX4XPgMPZA folded before Flop (didn't bet)
Seat 5: IBNygaT1aa9Z1uPdJJilwA folded before Flop (didn't bet)
Seat 6: M1KyQQvVPVuxqTAB8sR/zQ folded before Flop (didn't bet)



PokerStars Game #59941136042:  Hold'em No Limit ($0.25/$0.50) - 2009/07/01 1:26:40 ET
Table '2lPOwetm4cfkZPbTmGPH/w' 2-max Seat #2 is the button
Seat 1: vUGdApqS8J/GJE2gaVWl1w ($13.25 in chips)
Seat 2: XFa6sBGjP2gxoIvxR3fZIg ($30 in chips)
XFa6sBGjP2gxoIvxR3fZIg: posts small blind $0.25
vUGdApqS8J/GJE2gaVWl1w: posts big blind $0.50
*** HOLE CARDS ***
XFa6sBGjP2gxoIvxR3fZIg: raises $1 to $1.50
vUGdApqS8J/GJE2gaVWl1w: calls $1
*** FLOP *** [Qd Jh 5s]
vUGdApqS8J/GJE2gaVWl1w: checks
XFa6sBGjP2gxoIvxR3fZIg: bets $2
vUGdApqS8J/GJE2gaVWl1w: folds
XFa6sBGjP2gxoIvxR3fZIg collected $2.85 from pot
XFa6sBGjP2gxoIvxR3fZIg: doesn't show hand
*** SUMMARY ***
Total pot $3 | Rake $0.15
Board [Qd Jh 5s]
Seat 1: vUGdApqS8J/GJE2gaVWl1w (big blind) folded on the Flop
Seat 2: XFa6sBGjP2gxoIvxR3fZIg (button) (small blind) collected ($2.85)



PokerStars Game #59941137546:  Hold'em No Limit ($0.25/$0.50) - 2009/07/01 1:26:43 ET
Table '9ojijpRcYQSQTh6xI+haUA' 2-max Seat #2 is the button
Seat 1: 8hLWxFrmTLKeWL475NK4rQ ($13.65 in chips)
Seat 2: TitTV+fFCcBZWOERdytydA ($23.60 in chips)
TitTV+fFCcBZWOERdytydA: posts small blind $0.25
8hLWxFrmTLKeWL475NK4rQ: posts big blind $0.50
*** HOLE CARDS ***
TitTV+fFCcBZWOERdytydA: calls $0.25
8hLWxFrmTLKeWL475NK4rQ: raises $1 to $1.50
TitTV+fFCcBZWOERdytydA: raises $2.50 to $4
8hLWxFrmTLKeWL475NK4rQ: raises $4 to $8
TitTV+fFCcBZWOERdytydA: raises $15.60 to $23.60 and is all-in
8hLWxFrmTLKeWL475NK4rQ: calls $5.65 and is all-in
*** FLOP *** [6c 2d 8h]
*** TURN *** [6c 2d 8h] [7c]
*** RIVER *** [6c 2d 8h 7c] [Td]
*** SHOW DOWN ***
8hLWxFrmTLKeWL475NK4rQ: shows [Kh Jh] (high card King)
TitTV+fFCcBZWOERdytydA: shows [6s 6d] (three of a kind, Sixes)
TitTV+fFCcBZWOERdytydA collected $26.80 from pot
*** SUMMARY ***
Total pot $27.30 | Rake $0.50
Board [6c 2d 8h 7c Td]
Seat 1: 8hLWxFrmTLKeWL475NK4rQ (big blind) showed [Kh Jh] and lost with high card King
Seat 2: TitTV+fFCcBZWOERdytydA (button) (small blind) showed [6s 6d] and won ($26.80) with three of a kind, Sixes



PokerStars Game #59941137494:  Hold'em No Limit ($0.25/$0.50) - 2009/07/01 1:26:43 ET
Table 'BCN5su+SsXiy1zRMJi0SJw' 6-max Seat #6 is the button
Seat 1: GxXV09ciXaOxyY2H5aMIIw ($48.55 in chips)
Seat 2: ehFNAevCQri3trWxV6FJdA ($46.80 in chips)
Seat 3: kwgv5lNhiFrfONXCshzxlA ($43.40 in chips)
Seat 5: kxPhs4ePFqMy52CInAJ2aw ($51.30 in chips)
Seat 6: b2symlOdL7+0c9Pj4N/KlA ($66.65 in chips)
GxXV09ciXaOxyY2H5aMIIw: posts small blind $0.25
ehFNAevCQri3trWxV6FJdA: posts big blind $0.50
bbsK8j+tpuVRhBqDzHxf7w: sits out
*** HOLE CARDS ***
kwgv5lNhiFrfONXCshzxlA: folds
kxPhs4ePFqMy52CInAJ2aw: raises $1.50 to $2
b2symlOdL7+0c9Pj4N/KlA: folds
GxXV09ciXaOxyY2H5aMIIw: folds
ehFNAevCQri3trWxV6FJdA: folds
kxPhs4ePFqMy52CInAJ2aw collected $1.25 from pot
kxPhs4ePFqMy52CInAJ2aw: doesn't show hand
*** SUMMARY ***
Total pot $1.25 | Rake $0
Seat 1: GxXV09ciXaOxyY2H5aMIIw (small blind) folded before Flop
Seat 2: ehFNAevCQri3trWxV6FJdA (big blind) folded before Flop
Seat 3: kwgv5lNhiFrfONXCshzxlA folded before Flop (didn't bet)
Seat 5: kxPhs4ePFqMy52CInAJ2aw collected ($1.25)
Seat 6: b2symlOdL7+0c9Pj4N/KlA (button) folded before Flop (didn't bet)



PokerStars Game #59941138112:  Hold'em No Limit ($0.25/$0.50) - 2009/07/01 1:26:44 ET
Table 'B+sqsfj6d6zXicNfaseTaw' 2-max Seat #1 is the button
Seat 1: +4GNcSsecmapVGSdV0mUPA ($136.45 in chips)
Seat 2: Lv5RmpRe6LtPkBzM9Gpo5A ($89.65 in chips)
+4GNcSsecmapVGSdV0mUPA: posts small blind $0.25
Lv5RmpRe6LtPkBzM9Gpo5A: posts big blind $0.50
*** HOLE CARDS ***
+4GNcSsecmapVGSdV0mUPA: calls $0.25
Lv5RmpRe6LtPkBzM9Gpo5A: checks
*** FLOP *** [Jd 8d Qh]
Lv5RmpRe6LtPkBzM9Gpo5A: bets $1
+4GNcSsecmapVGSdV0mUPA: folds
Lv5RmpRe6LtPkBzM9Gpo5A collected $0.95 from pot
*** SUMMARY ***
Total pot $1 | Rake $0.05
Board [Jd 8d Qh]
Seat 1: +4GNcSsecmapVGSdV0mUPA (button) (small blind) folded on the Flop
Seat 2: Lv5RmpRe6LtPkBzM9Gpo5A (big blind) collected ($0.95)



PokerStars Game #59941138866:  Hold'em No Limit ($0.25/$0.50) - 2009/07/01 1:26:45 ET
Table 'ofnd8S4IdIPph1Cbn+x7hA' 2-max Seat #1 is the button
Seat 1: PY4NvRocCFPfSIHKbh0euQ ($28.20 in chips)
Seat 2: l5WbyJ/iWYjpeCC6GCYY6w ($64.10 in chips)
PY4NvRocCFPfSIHKbh0euQ: posts small blind $0.25
l5WbyJ/iWYjpeCC6GCYY6w: posts big blind $0.50
*** HOLE CARDS ***
PY4NvRocCFPfSIHKbh0euQ: raises $1 to $1.50
l5WbyJ/iWYjpeCC6GCYY6w: folds
PY4NvRocCFPfSIHKbh0euQ collected $1 from pot
*** SUMMARY ***
Total pot $1 | Rake $0
Seat 1: PY4NvRocCFPfSIHKbh0euQ (button) (small blind) collected ($1)
Seat 2: l5WbyJ/iWYjpeCC6GCYY6w (big blind) folded before Flop



PokerStars Game #59941138692:  Hold'em No Limit ($0.25/$0.50) - 2009/07/01 1:26:45 ET
Table '+dXkOAQyS8j9PQZusUTMpg' 2-max Seat #2 is the button
Seat 1: Teld4PDKla7C8/Wfu2DSkg ($54.20 in chips)
Seat 2: +zI4bP23YIjMkUHqeN2xfw ($23.25 in chips)
+zI4bP23YIjMkUHqeN2xfw: posts small blind $0.25
Teld4PDKla7C8/Wfu2DSkg: posts big blind $0.50
*** HOLE CARDS ***
+zI4bP23YIjMkUHqeN2xfw: folds
Teld4PDKla7C8/Wfu2DSkg collected $0.50 from pot
Teld4PDKla7C8/Wfu2DSkg: doesn't show hand
*** SUMMARY ***
Total pot $0.50 | Rake $0
Seat 1: Teld4PDKla7C8/Wfu2DSkg (big blind) collected ($0.50)
Seat 2: +zI4bP23YIjMkUHqeN2xfw (button) (small blind) folded before Flop



PokerStars Game #59941140044:  Hold'em No Limit ($0.25/$0.50) - 2009/07/01 1:26:47 ET
Table 'cofQFHU7jbJoFecLVBof/w' 6-max Seat #6 is the button
Seat 1: URYNc7fPA23K2UfadQbnCA ($48.75 in chips)
Seat 2: f89uTQr3ieGlusj2IAYAEg ($50 in chips)
Seat 3: v4ctePcLlQw0r8E0qJtjYw ($47.95 in chips)
Seat 4: g6lz8npaeeTJmJegtPYhlQ ($17.65 in chips)
Seat 5: QvwRlrpVqerRRF8eJm6dDw ($55.50 in chips)
Seat 6: 7+uQ0OOgCTbR4ltkSwyC0g ($153.70 in chips)
URYNc7fPA23K2UfadQbnCA: posts small blind $0.25
7+uQ0OOgCTbR4ltkSwyC0g said, "it was cheap indeed.  next time I should raise more??"
f89uTQr3ieGlusj2IAYAEg: posts big blind $0.50
g6lz8npaeeTJmJegtPYhlQ: posts big blind $0.50
*** HOLE CARDS ***
v4ctePcLlQw0r8E0qJtjYw: folds
g6lz8npaeeTJmJegtPYhlQ: checks
QvwRlrpVqerRRF8eJm6dDw: calls $0.50
7+uQ0OOgCTbR4ltkSwyC0g: raises $2 to $2.50
URYNc7fPA23K2UfadQbnCA: folds
f89uTQr3ieGlusj2IAYAEg: folds
g6lz8npaeeTJmJegtPYhlQ: folds
7+uQ0OOgCTbR4ltkSwyC0g said, "like that?"
QvwRlrpVqerRRF8eJm6dDw said, "with that bankroll i thought it was peanuts to you"
QvwRlrpVqerRRF8eJm6dDw: calls $2
*** FLOP *** [6c Ad 3d]
QvwRlrpVqerRRF8eJm6dDw: checks
7+uQ0OOgCTbR4ltkSwyC0g: bets $4.50
QvwRlrpVqerRRF8eJm6dDw: folds
7+uQ0OOgCTbR4ltkSwyC0g collected $5.95 from pot
*** SUMMARY ***
Total pot $6.25 | Rake $0.30
Board [6c Ad 3d]
Seat 1: URYNc7fPA23K2UfadQbnCA (small blind) folded before Flop
Seat 2: f89uTQr3ieGlusj2IAYAEg (big blind) folded before Flop
Seat 3: v4ctePcLlQw0r8E0qJtjYw folded before Flop (didn't bet)
Seat 4: g6lz8npaeeTJmJegtPYhlQ folded before Flop
Seat 5: QvwRlrpVqerRRF8eJm6dDw folded on the Flop
Seat 6: 7+uQ0OOgCTbR4ltkSwyC0g (button) collected ($5.95)



PokerStars Game #59941142006:  Hold'em No Limit ($0.25/$0.50) - 2009/07/01 1:26:50 ET
Table '+dXkOAQyS8j9PQZusUTMpg' 2-max Seat #1 is the button
Seat 1: Teld4PDKla7C8/Wfu2DSkg ($54.45 in chips)
Seat 2: +zI4bP23YIjMkUHqeN2xfw ($23 in chips)
Teld4PDKla7C8/Wfu2DSkg: posts small blind $0.25
+zI4bP23YIjMkUHqeN2xfw: posts big blind $0.50
*** HOLE CARDS ***
Teld4PDKla7C8/Wfu2DSkg: raises $0.50 to $1
+zI4bP23YIjMkUHqeN2xfw: folds
Teld4PDKla7C8/Wfu2DSkg collected $1 from pot
Teld4PDKla7C8/Wfu2DSkg: doesn't show hand
*** SUMMARY ***
Total pot $1 | Rake $0
Seat 1: Teld4PDKla7C8/Wfu2DSkg (button) (small blind) collected ($1)
Seat 2: +zI4bP23YIjMkUHqeN2xfw (big blind) folded before Flop



PokerStars Game #59941143192:  Hold'em No Limit ($0.25/$0.50) - 2009/07/01 1:26:52 ET
Table 'iq+aXfWVQRdV0u8SRTYUEg' 9-max Seat #2 is the button
Seat 1: 3yl8Q6QaLfGtyhN4/pEFgQ ($78.05 in chips)
Seat 2: J9N0lxHFd/Js2S0xZLbsIQ ($27.80 in chips)
Seat 3: Qi/PyOsKwaqtKIg0H+7ELg ($9.50 in chips)
Seat 4: vHYT5s323LpajBj+2c9zbQ ($31.20 in chips)
Seat 5: 997ViqAtWn1FPjJqcffwcA ($50 in chips)
Seat 6: bTJ0WgoxefTPxIoycS7uoA ($31.90 in chips)
Seat 7: SKnJuWHScqetA/qG5p+wCg ($31.55 in chips)
Seat 8: /DtIHuxEH+3tzKefmSV+Mw ($36.55 in chips)
Seat 9: olE1Z2rKWAV8+tGqmIBK9g ($28.45 in chips)
Qi/PyOsKwaqtKIg0H+7ELg: posts small blind $0.25
vHYT5s323LpajBj+2c9zbQ: posts big blind $0.50
*** HOLE CARDS ***
997ViqAtWn1FPjJqcffwcA: folds
bTJ0WgoxefTPxIoycS7uoA: calls $0.50
SKnJuWHScqetA/qG5p+wCg: folds
/DtIHuxEH+3tzKefmSV+Mw: calls $0.50
olE1Z2rKWAV8+tGqmIBK9g: folds
3yl8Q6QaLfGtyhN4/pEFgQ: folds
J9N0lxHFd/Js2S0xZLbsIQ: calls $0.50
Qi/PyOsKwaqtKIg0H+7ELg: calls $0.25
vHYT5s323LpajBj+2c9zbQ: checks
*** FLOP *** [4d 9s Qs]
Qi/PyOsKwaqtKIg0H+7ELg: checks
J9N0lxHFd/Js2S0xZLbsIQ said, "0"
J9N0lxHFd/Js2S0xZLbsIQ said, "bastr"
vHYT5s323LpajBj+2c9zbQ: checks
bTJ0WgoxefTPxIoycS7uoA: checks
/DtIHuxEH+3tzKefmSV+Mw: checks
J9N0lxHFd/Js2S0xZLbsIQ: checks
*** TURN *** [4d 9s Qs] [9c]
Qi/PyOsKwaqtKIg0H+7ELg: checks
vHYT5s323LpajBj+2c9zbQ: checks
bTJ0WgoxefTPxIoycS7uoA: checks
/DtIHuxEH+3tzKefmSV+Mw: checks
J9N0lxHFd/Js2S0xZLbsIQ: checks
*** RIVER *** [4d 9s Qs 9c] [9h]
Qi/PyOsKwaqtKIg0H+7ELg: checks
vHYT5s323LpajBj+2c9zbQ: checks
bTJ0WgoxefTPxIoycS7uoA: checks
/DtIHuxEH+3tzKefmSV+Mw: checks
J9N0lxHFd/Js2S0xZLbsIQ: checks
*** SHOW DOWN ***
Qi/PyOsKwaqtKIg0H+7ELg: shows [Kc 8s] (three of a kind, Nines)
vHYT5s323LpajBj+2c9zbQ: mucks hand
bTJ0WgoxefTPxIoycS7uoA: shows [2d Ad] (three of a kind, Nines - Ace kicker)
/DtIHuxEH+3tzKefmSV+Mw: shows [Ac Th] (three of a kind, Nines)
J9N0lxHFd/Js2S0xZLbsIQ: shows [7d As] (three of a kind, Nines)
bTJ0WgoxefTPxIoycS7uoA collected $0.80 from pot
/DtIHuxEH+3tzKefmSV+Mw collected $0.80 from pot
J9N0lxHFd/Js2S0xZLbsIQ collected $0.80 from pot
*** SUMMARY ***
Total pot $2.50 | Rake $0.10
Board [4d 9s Qs 9c 9h]
Seat 1: 3yl8Q6QaLfGtyhN4/pEFgQ folded before Flop (didn't bet)
Seat 2: J9N0lxHFd/Js2S0xZLbsIQ (button) showed [7d As] and won ($0.80) with three of a kind, Nines
Seat 3: Qi/PyOsKwaqtKIg0H+7ELg (small blind) showed [Kc 8s] and lost with three of a kind, Nines
Seat 4: vHYT5s323LpajBj+2c9zbQ (big blind) mucked
Seat 5: 997ViqAtWn1FPjJqcffwcA folded before Flop (didn't bet)
Seat 6: bTJ0WgoxefTPxIoycS7uoA showed [2d Ad] and won ($0.80) with three of a kind, Nines
Seat 7: SKnJuWHScqetA/qG5p+wCg folded before Flop (didn't bet)
Seat 8: /DtIHuxEH+3tzKefmSV+Mw showed [Ac Th] and won ($0.80) with three of a kind, Nines
Seat 9: olE1Z2rKWAV8+tGqmIBK9g folded before Flop (didn't bet)



PokerStars Game #59941143720:  Hold'em No Limit ($0.25/$0.50) - 2009/07/01 1:26:53 ET
Table 'ofnd8S4IdIPph1Cbn+x7hA' 2-max Seat #2 is the button
Seat 1: PY4NvRocCFPfSIHKbh0euQ ($28.70 in chips)
Seat 2: l5WbyJ/iWYjpeCC6GCYY6w ($63.60 in chips)
l5WbyJ/iWYjpeCC6GCYY6w: posts small blind $0.25
PY4NvRocCFPfSIHKbh0euQ: posts big blind $0.50
*** HOLE CARDS ***
l5WbyJ/iWYjpeCC6GCYY6w: calls $0.25
PY4NvRocCFPfSIHKbh0euQ: checks
*** FLOP *** [8c 9s 2c]
PY4NvRocCFPfSIHKbh0euQ: checks
l5WbyJ/iWYjpeCC6GCYY6w: bets $0.50
PY4NvRocCFPfSIHKbh0euQ: folds
l5WbyJ/iWYjpeCC6GCYY6w collected $0.95 from pot
l5WbyJ/iWYjpeCC6GCYY6w: doesn't show hand
*** SUMMARY ***
Total pot $1 | Rake $0.05
Board [8c 9s 2c]
Seat 1: PY4NvRocCFPfSIHKbh0euQ (big blind) folded on the Flop
Seat 2: l5WbyJ/iWYjpeCC6GCYY6w (button) (small blind) collected ($0.95)



PokerStars Game #59941144276:  Hold'em No Limit ($0.25/$0.50) - 2009/07/01 1:26:54 ET
Table 'GfL/No5u5PoEnU39lP5pQg' 6-max Seat #2 is the button
Seat 1: 1WUCqNG+p+vfWRTXNu4ljw ($61.25 in chips)
Seat 2: uVwggSetzp7d+eVgowO3vg ($50.05 in chips)
Seat 3: 4pp9WxhGdbVbxCc9tlu0lw ($34.80 in chips)
Seat 4: r6u7MWSXF30/khcTYkrG9Q ($27 in chips)
Seat 5: M1KyQQvVPVuxqTAB8sR/zQ ($50 in chips)
Seat 6: kxPhs4ePFqMy52CInAJ2aw ($65.25 in chips)
4pp9WxhGdbVbxCc9tlu0lw: posts small blind $0.25
r6u7MWSXF30/khcTYkrG9Q: posts big blind $0.50
*** HOLE CARDS ***
M1KyQQvVPVuxqTAB8sR/zQ: folds
kxPhs4ePFqMy52CInAJ2aw: folds
1WUCqNG+p+vfWRTXNu4ljw: folds
uVwggSetzp7d+eVgowO3vg: calls $0.50
4pp9WxhGdbVbxCc9tlu0lw: folds
r6u7MWSXF30/khcTYkrG9Q: checks
*** FLOP *** [4s 4d Qd]
r6u7MWSXF30/khcTYkrG9Q: checks
uVwggSetzp7d+eVgowO3vg: checks
*** TURN *** [4s 4d Qd] [5s]
r6u7MWSXF30/khcTYkrG9Q: checks
uVwggSetzp7d+eVgowO3vg: checks
*** RIVER *** [4s 4d Qd 5s] [9s]
r6u7MWSXF30/khcTYkrG9Q: checks
uVwggSetzp7d+eVgowO3vg: checks
*** SHOW DOWN ***
r6u7MWSXF30/khcTYkrG9Q: shows [6s 3c] (a pair of Fours)
uVwggSetzp7d+eVgowO3vg: shows [Jc 9d] (two pair, Nines and Fours)
uVwggSetzp7d+eVgowO3vg collected $1.20 from pot
*** SUMMARY ***
Total pot $1.25 | Rake $0.05
Board [4s 4d Qd 5s 9s]
Seat 1: 1WUCqNG+p+vfWRTXNu4ljw folded before Flop (didn't bet)
Seat 2: uVwggSetzp7d+eVgowO3vg (button) showed [Jc 9d] and won ($1.20) with two pair, Nines and Fours
Seat 3: 4pp9WxhGdbVbxCc9tlu0lw (small blind) folded before Flop
Seat 4: r6u7MWSXF30/khcTYkrG9Q (big blind) showed [6s 3c] and lost with a pair of Fours
Seat 5: M1KyQQvVPVuxqTAB8sR/zQ folded before Flop (didn't bet)
Seat 6: kxPhs4ePFqMy52CInAJ2aw folded before Flop (didn't bet)



PokerStars Game #59941145296:  Hold'em No Limit ($0.25/$0.50) - 2009/07/01 1:26:56 ET
Table '+z1aekfHkpp09pc8F9aViw' 6-max Seat #6 is the button
Seat 1: /DArfRoYc3YpLsOQSZubFg ($50 in chips)
Seat 2: 4QfsCWthT/vSLirorNXqtg ($50 in chips)
Seat 4: RowCSpSURHTOL/dcjg/Iug ($85.75 in chips)
Seat 5: 2igtJLmvIZ+HqX4XPgMPZA ($52.95 in chips)
Seat 6: GUnvMULl2qFOO1yenu1UBw ($50 in chips)
/DArfRoYc3YpLsOQSZubFg: posts small blind $0.25
4QfsCWthT/vSLirorNXqtg: posts big blind $0.50
URYNc7fPA23K2UfadQbnCA: sits out
*** HOLE CARDS ***
RowCSpSURHTOL/dcjg/Iug: folds
2igtJLmvIZ+HqX4XPgMPZA: raises $1.50 to $2
GUnvMULl2qFOO1yenu1UBw: folds
/DArfRoYc3YpLsOQSZubFg: folds
4QfsCWthT/vSLirorNXqtg: folds
2igtJLmvIZ+HqX4XPgMPZA collected $1.25 from pot
*** SUMMARY ***
Total pot $1.25 | Rake $0
Seat 1: /DArfRoYc3YpLsOQSZubFg (small blind) folded before Flop
Seat 2: 4QfsCWthT/vSLirorNXqtg (big blind) folded before Flop
Seat 4: RowCSpSURHTOL/dcjg/Iug folded before Flop (didn't bet)
Seat 5: 2igtJLmvIZ+HqX4XPgMPZA collected ($1.25)
Seat 6: GUnvMULl2qFOO1yenu1UBw (button) folded before Flop (didn't bet)



PokerStars Game #59941145612:  Hold'em No Limit ($0.25/$0.50) - 2009/07/01 1:26:57 ET
Table '+dXkOAQyS8j9PQZusUTMpg' 2-max Seat #2 is the button
Seat 1: Teld4PDKla7C8/Wfu2DSkg ($54.95 in chips)
Seat 2: +zI4bP23YIjMkUHqeN2xfw ($22.50 in chips)
+zI4bP23YIjMkUHqeN2xfw: posts small blind $0.25
Teld4PDKla7C8/Wfu2DSkg: posts big blind $0.50
*** HOLE CARDS ***
+zI4bP23YIjMkUHqeN2xfw: raises $0.50 to $1
Teld4PDKla7C8/Wfu2DSkg: calls $0.50
*** FLOP *** [7c 3h 6h]
Teld4PDKla7C8/Wfu2DSkg: checks
+zI4bP23YIjMkUHqeN2xfw: checks
*** TURN *** [7c 3h 6h] [3c]
Teld4PDKla7C8/Wfu2DSkg: checks
+zI4bP23YIjMkUHqeN2xfw: checks
*** RIVER *** [7c 3h 6h 3c] [2h]
Teld4PDKla7C8/Wfu2DSkg: checks
+zI4bP23YIjMkUHqeN2xfw: checks
*** SHOW DOWN ***
Teld4PDKla7C8/Wfu2DSkg: shows [Ts Qh] (a pair of Threes)
+zI4bP23YIjMkUHqeN2xfw: shows [Ks Ah] (a pair of Threes - Ace kicker)
+zI4bP23YIjMkUHqeN2xfw collected $1.90 from pot
*** SUMMARY ***
Total pot $2 | Rake $0.10
Board [7c 3h 6h 3c 2h]
Seat 1: Teld4PDKla7C8/Wfu2DSkg (big blind) showed [Ts Qh] and lost with a pair of Threes
Seat 2: +zI4bP23YIjMkUHqeN2xfw (button) (small blind) showed [Ks Ah] and won ($1.90) with a pair of Threes



PokerStars Game #59941146008:  Hold'em No Limit ($0.25/$0.50) - 2009/07/01 1:26:57 ET
Table 'B+sqsfj6d6zXicNfaseTaw' 2-max Seat #2 is the button
Seat 1: +4GNcSsecmapVGSdV0mUPA ($135.95 in chips)
Seat 2: Lv5RmpRe6LtPkBzM9Gpo5A ($90.10 in chips)
Lv5RmpRe6LtPkBzM9Gpo5A: posts small blind $0.25
+4GNcSsecmapVGSdV0mUPA: posts big blind $0.50
*** HOLE CARDS ***
Lv5RmpRe6LtPkBzM9Gpo5A: calls $0.25
+4GNcSsecmapVGSdV0mUPA: checks
*** FLOP *** [7d Ts 2s]
+4GNcSsecmapVGSdV0mUPA: checks
Lv5RmpRe6LtPkBzM9Gpo5A: bets $0.50
+4GNcSsecmapVGSdV0mUPA: folds
Lv5RmpRe6LtPkBzM9Gpo5A collected $0.95 from pot
*** SUMMARY ***
Total pot $1 | Rake $0.05
Board [7d Ts 2s]
Seat 1: +4GNcSsecmapVGSdV0mUPA (big blind) folded on the Flop
Seat 2: Lv5RmpRe6LtPkBzM9Gpo5A (button) (small blind) collected ($0.95)



PokerStars Game #59941146410:  Hold'em No Limit ($0.25/$0.50) - 2009/07/01 1:26:58 ET
Table '3FhG0gl3kMX3wBEEqj+wnQ' 9-max Seat #5 is the button
Seat 1: bxLSulbgr8LmKNjOzw8URg ($49.30 in chips)
Seat 2: vacmVLJJECYI6HjAynFcpg ($50.60 in chips)
Seat 3: YXCE3WOZi8g2sIf3y/plVw ($50 in chips)
Seat 4: e2+sK/yjnj94rXOKoxPP2A ($70.25 in chips)
Seat 5: XcLXSUMHSpshK/7Lh0M4Vg ($9.25 in chips)
Seat 6: 997ViqAtWn1FPjJqcffwcA ($110.05 in chips)
Seat 7: mSD1pginDsyHG5PDfqzphw ($13.75 in chips)
Seat 8: j3K/Jujr7PY4ZM2RZvlH6A ($53.45 in chips)
997ViqAtWn1FPjJqcffwcA: posts small blind $0.25
mSD1pginDsyHG5PDfqzphw: posts big blind $0.50
*** HOLE CARDS ***
j3K/Jujr7PY4ZM2RZvlH6A: calls $0.50
bxLSulbgr8LmKNjOzw8URg: folds
vacmVLJJECYI6HjAynFcpg: folds
YXCE3WOZi8g2sIf3y/plVw: folds
e2+sK/yjnj94rXOKoxPP2A: folds
XcLXSUMHSpshK/7Lh0M4Vg: folds
997ViqAtWn1FPjJqcffwcA: folds
mSD1pginDsyHG5PDfqzphw: checks
*** FLOP *** [6h As Th]
mSD1pginDsyHG5PDfqzphw: checks
j3K/Jujr7PY4ZM2RZvlH6A: bets $0.50
mSD1pginDsyHG5PDfqzphw: calls $0.50
*** TURN *** [6h As Th] [Js]
mSD1pginDsyHG5PDfqzphw: checks
j3K/Jujr7PY4ZM2RZvlH6A: bets $1.50
mSD1pginDsyHG5PDfqzphw: folds
j3K/Jujr7PY4ZM2RZvlH6A collected $2.15 from pot
j3K/Jujr7PY4ZM2RZvlH6A: doesn't show hand
*** SUMMARY ***
Total pot $2.25 | Rake $0.10
Board [6h As Th Js]
Seat 1: bxLSulbgr8LmKNjOzw8URg folded before Flop (didn't bet)
Seat 2: vacmVLJJECYI6HjAynFcpg folded before Flop (didn't bet)
Seat 3: YXCE3WOZi8g2sIf3y/plVw folded before Flop (didn't bet)
Seat 4: e2+sK/yjnj94rXOKoxPP2A folded before Flop (didn't bet)
Seat 5: XcLXSUMHSpshK/7Lh0M4Vg (button) folded before Flop (didn't bet)
Seat 6: 997ViqAtWn1FPjJqcffwcA (small blind) folded before Flop
Seat 7: mSD1pginDsyHG5PDfqzphw (big blind) folded on the Turn
Seat 8: j3K/Jujr7PY4ZM2RZvlH6A collected ($2.15)



PokerStars Game #59941147558:  Hold'em No Limit ($0.25/$0.50) - 2009/07/01 1:27:00 ET
Table '2lPOwetm4cfkZPbTmGPH/w' 2-max Seat #1 is the button
Seat 1: vUGdApqS8J/GJE2gaVWl1w ($11.75 in chips)
Seat 2: XFa6sBGjP2gxoIvxR3fZIg ($31.35 in chips)
vUGdApqS8J/GJE2gaVWl1w: posts small blind $0.25
XFa6sBGjP2gxoIvxR3fZIg: posts big blind $0.50
*** HOLE CARDS ***
vUGdApqS8J/GJE2gaVWl1w: raises $1 to $1.50
XFa6sBGjP2gxoIvxR3fZIg: folds
vUGdApqS8J/GJE2gaVWl1w collected $1 from pot
*** SUMMARY ***
Total pot $1 | Rake $0
Seat 1: vUGdApqS8J/GJE2gaVWl1w (button) (small blind) collected ($1)
Seat 2: XFa6sBGjP2gxoIvxR3fZIg (big blind) folded before Flop



PokerStars Game #59941147838:  Hold'em No Limit ($0.25/$0.50) - 2009/07/01 1:27:00 ET
Table 'fx6MqwfYAj/Rt86hBz2L3Q' 9-max Seat #1 is the button
Seat 1: v/4aX0ejnaIFK4ftDk2Lyg ($51.40 in chips)
Seat 2: C3rGXblctNcWI6JYPHhaEg ($41.85 in chips)
Seat 3: iadBi5AEt7gTBXbDSSnMYQ ($54.80 in chips)
Seat 5: iAISe3dVeua8PUn2wwgDHw ($61.65 in chips)
Seat 6: 5k9fvXD9suIgCxU4HLQjTw ($50 in chips)
Seat 8: JYwJYYV9pM5KWdSiETl8rA ($63 in chips)
Seat 9: vO3QVRovWemcGMkm7ijAIA ($11.50 in chips)
C3rGXblctNcWI6JYPHhaEg: posts small blind $0.25
iadBi5AEt7gTBXbDSSnMYQ: posts big blind $0.50
mSD1pginDsyHG5PDfqzphw: sits out
*** HOLE CARDS ***
iAISe3dVeua8PUn2wwgDHw: raises $0.50 to $1
5k9fvXD9suIgCxU4HLQjTw: folds
JYwJYYV9pM5KWdSiETl8rA: folds
vO3QVRovWemcGMkm7ijAIA: folds
v/4aX0ejnaIFK4ftDk2Lyg: folds
C3rGXblctNcWI6JYPHhaEg: folds
iadBi5AEt7gTBXbDSSnMYQ: raises $2 to $3
iAISe3dVeua8PUn2wwgDHw: raises $2 to $5
iadBi5AEt7gTBXbDSSnMYQ: calls $2
*** FLOP *** [5h Ks 9d]
iadBi5AEt7gTBXbDSSnMYQ: bets $2.50
iAISe3dVeua8PUn2wwgDHw: raises $2.50 to $5
iadBi5AEt7gTBXbDSSnMYQ: calls $2.50
*** TURN *** [5h Ks 9d] [As]
iadBi5AEt7gTBXbDSSnMYQ: bets $8
iAISe3dVeua8PUn2wwgDHw: raises $8 to $16
iadBi5AEt7gTBXbDSSnMYQ: folds
iAISe3dVeua8PUn2wwgDHw collected $34.50 from pot
*** SUMMARY ***
Total pot $36.25 | Rake $1.75
Board [5h Ks 9d As]
Seat 1: v/4aX0ejnaIFK4ftDk2Lyg (button) folded before Flop (didn't bet)
Seat 2: C3rGXblctNcWI6JYPHhaEg (small blind) folded before Flop
Seat 3: iadBi5AEt7gTBXbDSSnMYQ (big blind) folded on the Turn
Seat 5: iAISe3dVeua8PUn2wwgDHw collected ($34.50)
Seat 6: 5k9fvXD9suIgCxU4HLQjTw folded before Flop (didn't bet)
Seat 8: JYwJYYV9pM5KWdSiETl8rA folded before Flop (didn't bet)
Seat 9: vO3QVRovWemcGMkm7ijAIA folded before Flop (didn't bet)



PokerStars Game #59941148176:  Hold'em No Limit ($0.25/$0.50) - 2009/07/01 1:27:01 ET
Table 'c/CRn+68J3Y8KxD5g1ek2Q' 2-max Seat #1 is the button
Seat 1: 46qCyJ6evTkHo9al5sBMNA ($108.20 in chips)
Seat 2: BypVLsYQt3ePFm2xQL/dOA ($250.25 in chips)
46qCyJ6evTkHo9al5sBMNA: posts small blind $0.25
BypVLsYQt3ePFm2xQL/dOA: posts big blind $0.50
*** HOLE CARDS ***
46qCyJ6evTkHo9al5sBMNA: folds
BypVLsYQt3ePFm2xQL/dOA collected $0.50 from pot
BypVLsYQt3ePFm2xQL/dOA: doesn't show hand
*** SUMMARY ***
Total pot $0.50 | Rake $0
Seat 1: 46qCyJ6evTkHo9al5sBMNA (button) (small blind) folded before Flop
Seat 2: BypVLsYQt3ePFm2xQL/dOA (big blind) collected ($0.50)



PokerStars Game #59941147980:  Hold'em No Limit ($0.25/$0.50) - 2009/07/01 1:27:01 ET
Table 'BCN5su+SsXiy1zRMJi0SJw' 6-max Seat #1 is the button
Seat 1: GxXV09ciXaOxyY2H5aMIIw ($48.30 in chips)
Seat 2: ehFNAevCQri3trWxV6FJdA ($46.30 in chips)
Seat 3: kwgv5lNhiFrfONXCshzxlA ($43.40 in chips)
Seat 5: kxPhs4ePFqMy52CInAJ2aw ($52.05 in chips)
Seat 6: b2symlOdL7+0c9Pj4N/KlA ($66.65 in chips)
ehFNAevCQri3trWxV6FJdA: posts small blind $0.25
kwgv5lNhiFrfONXCshzxlA: posts big blind $0.50
bbsK8j+tpuVRhBqDzHxf7w: sits out
*** HOLE CARDS ***
kxPhs4ePFqMy52CInAJ2aw: folds
b2symlOdL7+0c9Pj4N/KlA: folds
GxXV09ciXaOxyY2H5aMIIw: folds
ehFNAevCQri3trWxV6FJdA: calls $0.25
kwgv5lNhiFrfONXCshzxlA: checks
*** FLOP *** [2d 2s Ah]
ehFNAevCQri3trWxV6FJdA: checks
kwgv5lNhiFrfONXCshzxlA: checks
*** TURN *** [2d 2s Ah] [Jd]
ehFNAevCQri3trWxV6FJdA: checks
kwgv5lNhiFrfONXCshzxlA: checks
*** RIVER *** [2d 2s Ah Jd] [8d]
ehFNAevCQri3trWxV6FJdA: checks
kwgv5lNhiFrfONXCshzxlA: bets $1
ehFNAevCQri3trWxV6FJdA: calls $1
*** SHOW DOWN ***
kwgv5lNhiFrfONXCshzxlA: shows [Ks 8s] (two pair, Eights and Deuces)
ehFNAevCQri3trWxV6FJdA: shows [8c 7h] (two pair, Eights and Deuces)
ehFNAevCQri3trWxV6FJdA collected $1.45 from pot
kwgv5lNhiFrfONXCshzxlA collected $1.45 from pot
*** SUMMARY ***
Total pot $3 | Rake $0.10
Board [2d 2s Ah Jd 8d]
Seat 1: GxXV09ciXaOxyY2H5aMIIw (button) folded before Flop (didn't bet)
Seat 2: ehFNAevCQri3trWxV6FJdA (small blind) showed [8c 7h] and won ($1.45) with two pair, Eights and Deuces
Seat 3: kwgv5lNhiFrfONXCshzxlA (big blind) showed [Ks 8s] and won ($1.45) with two pair, Eights and Deuces
Seat 5: kxPhs4ePFqMy52CInAJ2aw folded before Flop (didn't bet)
Seat 6: b2symlOdL7+0c9Pj4N/KlA folded before Flop (didn't bet)



PokerStars Game #59941149920:  Hold'em No Limit ($0.25/$0.50) - 2009/07/01 1:27:04 ET
Table '8BQGgNetI1NOvWeu3gtMNw' 2-max Seat #2 is the button
Seat 1: bypIyrYcAAifLfhZpGlKLA ($50 in chips)
Seat 2: Z4HwehErEwzsv/noQlfUlg ($169.45 in chips)
Z4HwehErEwzsv/noQlfUlg: posts small blind $0.25
bypIyrYcAAifLfhZpGlKLA: posts big blind $0.50
*** HOLE CARDS ***
Z4HwehErEwzsv/noQlfUlg: raises $2.50 to $3
bypIyrYcAAifLfhZpGlKLA: calls $2.50
*** FLOP *** [8s Qc Ah]
bypIyrYcAAifLfhZpGlKLA: checks
Z4HwehErEwzsv/noQlfUlg: checks
*** TURN *** [8s Qc Ah] [As]
bypIyrYcAAifLfhZpGlKLA: bets $4
Z4HwehErEwzsv/noQlfUlg: calls $4
*** RIVER *** [8s Qc Ah As] [Jh]
bypIyrYcAAifLfhZpGlKLA: checks
Z4HwehErEwzsv/noQlfUlg: bets $12
bypIyrYcAAifLfhZpGlKLA: calls $12
*** SHOW DOWN ***
Z4HwehErEwzsv/noQlfUlg: shows [7h Th] (a pair of Aces)
bypIyrYcAAifLfhZpGlKLA: shows [Jd 4s] (two pair, Aces and Jacks)
bypIyrYcAAifLfhZpGlKLA collected $37.50 from pot
*** SUMMARY ***
Total pot $38 | Rake $0.50
Board [8s Qc Ah As Jh]
Seat 1: bypIyrYcAAifLfhZpGlKLA (big blind) showed [Jd 4s] and won ($37.50) with two pair, Aces and Jacks
Seat 2: Z4HwehErEwzsv/noQlfUlg (button) (small blind) showed [7h Th] and lost with a pair of Aces



PokerStars Game #59941150022:  Hold'em No Limit ($0.25/$0.50) - 2009/07/01 1:27:04 ET
Table 'ZYI3ZReBjdfKEYItkZHI6A' 9-max Seat #7 is the button
Seat 1: IYd5zG8k7vdBNVHbHg2Pag ($64.40 in chips)
Seat 2: uw9QayAAxLM3Hb+HR7mSkg ($9.25 in chips)
Seat 4: e2+sK/yjnj94rXOKoxPP2A ($64.40 in chips)
Seat 5: ApHP7ouup365XIUFBdEDxg ($24.25 in chips)
Seat 6: 1xBtrSVBbgFH/viUWKqQeg ($29.45 in chips)
Seat 7: HWcfp1hY1hqvrddzW3/FQw ($12.25 in chips)
Seat 8: ji04uOybxCdpdefzlUQeKQ ($31.05 in chips)
Seat 9: HZkVla4kK2SI42CVrPZ/ig ($10 in chips)
ji04uOybxCdpdefzlUQeKQ: posts small blind $0.25
HZkVla4kK2SI42CVrPZ/ig: posts big blind $0.50
75K2MXwN65Sjfp1yHd50Hg: sits out
*** HOLE CARDS ***
IYd5zG8k7vdBNVHbHg2Pag: folds
uw9QayAAxLM3Hb+HR7mSkg: folds
e2+sK/yjnj94rXOKoxPP2A: folds
ApHP7ouup365XIUFBdEDxg: calls $0.50
1xBtrSVBbgFH/viUWKqQeg: folds
HWcfp1hY1hqvrddzW3/FQw: folds
ji04uOybxCdpdefzlUQeKQ: calls $0.25
HZkVla4kK2SI42CVrPZ/ig: checks
*** FLOP *** [9c Jc 7c]
ji04uOybxCdpdefzlUQeKQ: checks
HZkVla4kK2SI42CVrPZ/ig: checks
ApHP7ouup365XIUFBdEDxg: bets $0.50
ji04uOybxCdpdefzlUQeKQ: folds
HZkVla4kK2SI42CVrPZ/ig: folds
ApHP7ouup365XIUFBdEDxg collected $1.45 from pot
ApHP7ouup365XIUFBdEDxg: doesn't show hand
*** SUMMARY ***
Total pot $1.50 | Rake $0.05
Board [9c Jc 7c]
Seat 1: IYd5zG8k7vdBNVHbHg2Pag folded before Flop (didn't bet)
Seat 2: uw9QayAAxLM3Hb+HR7mSkg folded before Flop (didn't bet)
Seat 4: e2+sK/yjnj94rXOKoxPP2A folded before Flop (didn't bet)
Seat 5: ApHP7ouup365XIUFBdEDxg collected ($1.45)
Seat 6: 1xBtrSVBbgFH/viUWKqQeg folded before Flop (didn't bet)
Seat 7: HWcfp1hY1hqvrddzW3/FQw (button) folded before Flop (didn't bet)
Seat 8: ji04uOybxCdpdefzlUQeKQ (small blind) folded on the Flop
Seat 9: HZkVla4kK2SI42CVrPZ/ig (big blind) folded on the Flop



PokerStars Game #59941152094:  Hold'em No Limit ($0.25/$0.50) - 2009/07/01 1:27:08 ET
Table '2lPOwetm4cfkZPbTmGPH/w' 2-max Seat #2 is the button
Seat 1: vUGdApqS8J/GJE2gaVWl1w ($12.25 in chips)
Seat 2: XFa6sBGjP2gxoIvxR3fZIg ($30.85 in chips)
XFa6sBGjP2gxoIvxR3fZIg: posts small blind $0.25
vUGdApqS8J/GJE2gaVWl1w: posts big blind $0.50
*** HOLE CARDS ***
XFa6sBGjP2gxoIvxR3fZIg: calls $0.25
vUGdApqS8J/GJE2gaVWl1w: checks
*** FLOP *** [2c 9d Qs]
vUGdApqS8J/GJE2gaVWl1w: checks
XFa6sBGjP2gxoIvxR3fZIg: checks
*** TURN *** [2c 9d Qs] [Tc]
vUGdApqS8J/GJE2gaVWl1w: checks
XFa6sBGjP2gxoIvxR3fZIg: checks
*** RIVER *** [2c 9d Qs Tc] [8c]
vUGdApqS8J/GJE2gaVWl1w: bets $1
XFa6sBGjP2gxoIvxR3fZIg: calls $1
*** SHOW DOWN ***
vUGdApqS8J/GJE2gaVWl1w: shows [Jc 6s] (a straight, Eight to Queen)
XFa6sBGjP2gxoIvxR3fZIg: mucks hand
vUGdApqS8J/GJE2gaVWl1w collected $2.90 from pot
*** SUMMARY ***
Total pot $3 | Rake $0.10
Board [2c 9d Qs Tc 8c]
Seat 1: vUGdApqS8J/GJE2gaVWl1w (big blind) showed [Jc 6s] and won ($2.90) with a straight, Eight to Queen
Seat 2: XFa6sBGjP2gxoIvxR3fZIg (button) (small blind) mucked



PokerStars Game #59941152058:  Hold'em No Limit ($0.25/$0.50) - 2009/07/01 1:27:08 ET
Table 'c/CRn+68J3Y8KxD5g1ek2Q' 2-max Seat #2 is the button
Seat 1: 46qCyJ6evTkHo9al5sBMNA ($107.95 in chips)
Seat 2: BypVLsYQt3ePFm2xQL/dOA ($250.50 in chips)
BypVLsYQt3ePFm2xQL/dOA: posts small blind $0.25
46qCyJ6evTkHo9al5sBMNA: posts big blind $0.50
*** HOLE CARDS ***
BypVLsYQt3ePFm2xQL/dOA: calls $0.25
46qCyJ6evTkHo9al5sBMNA: raises $1 to $1.50
BypVLsYQt3ePFm2xQL/dOA: raises $2 to $3.50
46qCyJ6evTkHo9al5sBMNA: calls $2
*** FLOP *** [3c 8d Jd]
46qCyJ6evTkHo9al5sBMNA: checks
BypVLsYQt3ePFm2xQL/dOA: bets $5.50
46qCyJ6evTkHo9al5sBMNA: calls $5.50
*** TURN *** [3c 8d Jd] [7h]
46qCyJ6evTkHo9al5sBMNA: checks
BypVLsYQt3ePFm2xQL/dOA: bets $15.50
46qCyJ6evTkHo9al5sBMNA: calls $15.50
*** RIVER *** [3c 8d Jd 7h] [Kc]
46qCyJ6evTkHo9al5sBMNA: checks
BypVLsYQt3ePFm2xQL/dOA: bets $47.50
46qCyJ6evTkHo9al5sBMNA: calls $47.50
*** SHOW DOWN ***
BypVLsYQt3ePFm2xQL/dOA: shows [Ks Kh] (three of a kind, Kings)
46qCyJ6evTkHo9al5sBMNA: mucks hand
BypVLsYQt3ePFm2xQL/dOA collected $143.50 from pot
*** SUMMARY ***
Total pot $144 | Rake $0.50
Board [3c 8d Jd 7h Kc]
Seat 1: 46qCyJ6evTkHo9al5sBMNA (big blind) mucked
Seat 2: BypVLsYQt3ePFm2xQL/dOA (button) (small blind) showed [Ks Kh] and won ($143.50) with three of a kind, Kings



PokerStars Game #59941153396:  Hold'em No Limit ($0.25/$0.50) - 2009/07/01 1:27:10 ET
Table 'ofnd8S4IdIPph1Cbn+x7hA' 2-max Seat #1 is the button
Seat 1: PY4NvRocCFPfSIHKbh0euQ ($28.20 in chips)
Seat 2: l5WbyJ/iWYjpeCC6GCYY6w ($64.05 in chips)
PY4NvRocCFPfSIHKbh0euQ: posts small blind $0.25
l5WbyJ/iWYjpeCC6GCYY6w: posts big blind $0.50
*** HOLE CARDS ***
PY4NvRocCFPfSIHKbh0euQ: raises $0.50 to $1
l5WbyJ/iWYjpeCC6GCYY6w: folds
PY4NvRocCFPfSIHKbh0euQ collected $1 from pot
*** SUMMARY ***
Total pot $1 | Rake $0
Seat 1: PY4NvRocCFPfSIHKbh0euQ (button) (small blind) collected ($1)
Seat 2: l5WbyJ/iWYjpeCC6GCYY6w (big blind) folded before Flop



PokerStars Game #59941153846:  Hold'em No Limit ($0.25/$0.50) - 2009/07/01 1:27:11 ET
Table 'B+sqsfj6d6zXicNfaseTaw' 2-max Seat #1 is the button
Seat 1: +4GNcSsecmapVGSdV0mUPA ($135.45 in chips)
Seat 2: Lv5RmpRe6LtPkBzM9Gpo5A ($90.55 in chips)
+4GNcSsecmapVGSdV0mUPA: posts small blind $0.25
Lv5RmpRe6LtPkBzM9Gpo5A: posts big blind $0.50
*** HOLE CARDS ***
+4GNcSsecmapVGSdV0mUPA: calls $0.25
Lv5RmpRe6LtPkBzM9Gpo5A: raises $2 to $2.50
+4GNcSsecmapVGSdV0mUPA: calls $2
*** FLOP *** [9d 2d Kc]
Lv5RmpRe6LtPkBzM9Gpo5A: bets $16
+4GNcSsecmapVGSdV0mUPA: folds
Lv5RmpRe6LtPkBzM9Gpo5A collected $4.75 from pot
*** SUMMARY ***
Total pot $5 | Rake $0.25
Board [9d 2d Kc]
Seat 1: +4GNcSsecmapVGSdV0mUPA (button) (small blind) folded on the Flop
Seat 2: Lv5RmpRe6LtPkBzM9Gpo5A (big blind) collected ($4.75)



PokerStars Game #59941154038:  Hold'em No Limit ($0.25/$0.50) - 2009/07/01 1:27:11 ET
Table 'X6IRCRTh+20gjz8aubWnwA' 9-max Seat #9 is the button
Seat 1: E2518gp4aFz1+kAgmGqeEg ($11 in chips)
Seat 2: HZkVla4kK2SI42CVrPZ/ig ($10 in chips)
Seat 3: SWv01peOe69QQRvhQTqjQw ($12.80 in chips)
Seat 4: M3JFBNQ8Bbw3FBZ/18MuXw ($33.15 in chips)
Seat 5: uw9QayAAxLM3Hb+HR7mSkg ($18.30 in chips)
Seat 6: Qi/PyOsKwaqtKIg0H+7ELg ($9.25 in chips)
Seat 7: +RUz0sVA09ZE8PNpIl+EBQ ($30 in chips)
Seat 8: HxeBVq06/3Bh/H986sgdbw ($45 in chips)
Seat 9: M+7+BTmX5vZatHVuoRB1nA ($44.55 in chips)
E2518gp4aFz1+kAgmGqeEg: posts small blind $0.25
HZkVla4kK2SI42CVrPZ/ig: posts big blind $0.50
+RUz0sVA09ZE8PNpIl+EBQ: posts big blind $0.50
*** HOLE CARDS ***
SWv01peOe69QQRvhQTqjQw: folds
M3JFBNQ8Bbw3FBZ/18MuXw: raises $1 to $1.50
uw9QayAAxLM3Hb+HR7mSkg: folds
Qi/PyOsKwaqtKIg0H+7ELg: calls $1.50
+RUz0sVA09ZE8PNpIl+EBQ: folds
HxeBVq06/3Bh/H986sgdbw: folds
M+7+BTmX5vZatHVuoRB1nA: raises $4 to $5.50
E2518gp4aFz1+kAgmGqeEg: folds
HZkVla4kK2SI42CVrPZ/ig: raises $4.50 to $10 and is all-in
M3JFBNQ8Bbw3FBZ/18MuXw: folds
Qi/PyOsKwaqtKIg0H+7ELg: folds
M+7+BTmX5vZatHVuoRB1nA: calls $4.50
*** FLOP *** [7d 8c 8h]
*** TURN *** [7d 8c 8h] [As]
*** RIVER *** [7d 8c 8h As] [5c]
*** SHOW DOWN ***
HZkVla4kK2SI42CVrPZ/ig: shows [9d 9s] (two pair, Nines and Eights)
M+7+BTmX5vZatHVuoRB1nA: shows [Td Tc] (two pair, Tens and Eights)
M+7+BTmX5vZatHVuoRB1nA collected $22.60 from pot
*** SUMMARY ***
Total pot $23.75 | Rake $1.15
Board [7d 8c 8h As 5c]
Seat 1: E2518gp4aFz1+kAgmGqeEg (small blind) folded before Flop
Seat 2: HZkVla4kK2SI42CVrPZ/ig (big blind) showed [9d 9s] and lost with two pair, Nines and Eights
Seat 3: SWv01peOe69QQRvhQTqjQw folded before Flop (didn't bet)
Seat 4: M3JFBNQ8Bbw3FBZ/18MuXw folded before Flop
Seat 5: uw9QayAAxLM3Hb+HR7mSkg folded before Flop (didn't bet)
Seat 6: Qi/PyOsKwaqtKIg0H+7ELg folded before Flop
Seat 7: +RUz0sVA09ZE8PNpIl+EBQ folded before Flop
Seat 8: HxeBVq06/3Bh/H986sgdbw folded before Flop (didn't bet)
Seat 9: M+7+BTmX5vZatHVuoRB1nA (button) showed [Td Tc] and won ($22.60) with two pair, Tens and Eights



PokerStars Game #59941156258:  Hold'em No Limit ($0.25/$0.50) - 2009/07/01 1:27:15 ET
Table '+dXkOAQyS8j9PQZusUTMpg' 2-max Seat #1 is the button
Seat 1: Teld4PDKla7C8/Wfu2DSkg ($53.95 in chips)
Seat 2: +zI4bP23YIjMkUHqeN2xfw ($23.40 in chips)
Teld4PDKla7C8/Wfu2DSkg: posts small blind $0.25
+zI4bP23YIjMkUHqeN2xfw: posts big blind $0.50
*** HOLE CARDS ***
Teld4PDKla7C8/Wfu2DSkg: raises $0.50 to $1
+zI4bP23YIjMkUHqeN2xfw: folds
Teld4PDKla7C8/Wfu2DSkg collected $1 from pot
Teld4PDKla7C8/Wfu2DSkg: doesn't show hand
*** SUMMARY ***
Total pot $1 | Rake $0
Seat 1: Teld4PDKla7C8/Wfu2DSkg (button) (small blind) collected ($1)
Seat 2: +zI4bP23YIjMkUHqeN2xfw (big blind) folded before Flop



PokerStars Game #59941159356:  Hold'em No Limit ($0.25/$0.50) - 2009/07/01 1:27:20 ET
Table '+z1aekfHkpp09pc8F9aViw' 6-max Seat #1 is the button
Seat 1: /DArfRoYc3YpLsOQSZubFg ($50 in chips)
Seat 2: 4QfsCWthT/vSLirorNXqtg ($50 in chips)
Seat 3: URYNc7fPA23K2UfadQbnCA ($50 in chips)
Seat 4: RowCSpSURHTOL/dcjg/Iug ($85.75 in chips)
Seat 5: 2igtJLmvIZ+HqX4XPgMPZA ($53.70 in chips)
Seat 6: GUnvMULl2qFOO1yenu1UBw ($50 in chips)
4QfsCWthT/vSLirorNXqtg: posts small blind $0.25
URYNc7fPA23K2UfadQbnCA: posts big blind $0.50
*** HOLE CARDS ***
RowCSpSURHTOL/dcjg/Iug: folds
2igtJLmvIZ+HqX4XPgMPZA: folds
GUnvMULl2qFOO1yenu1UBw: raises $1 to $1.50
RowCSpSURHTOL/dcjg/Iug is sitting out
/DArfRoYc3YpLsOQSZubFg: folds
4QfsCWthT/vSLirorNXqtg: folds
URYNc7fPA23K2UfadQbnCA: folds
GUnvMULl2qFOO1yenu1UBw collected $1.25 from pot
*** SUMMARY ***
Total pot $1.25 | Rake $0
Seat 1: /DArfRoYc3YpLsOQSZubFg (button) folded before Flop (didn't bet)
Seat 2: 4QfsCWthT/vSLirorNXqtg (small blind) folded before Flop
Seat 3: URYNc7fPA23K2UfadQbnCA (big blind) folded before Flop
Seat 4: RowCSpSURHTOL/dcjg/Iug folded before Flop (didn't bet)
Seat 5: 2igtJLmvIZ+HqX4XPgMPZA folded before Flop (didn't bet)
Seat 6: GUnvMULl2qFOO1yenu1UBw collected ($1.25)



PokerStars Game #59941159652:  Hold'em No Limit ($0.25/$0.50) - 2009/07/01 1:27:21 ET
Table 'ofnd8S4IdIPph1Cbn+x7hA' 2-max Seat #2 is the button
Seat 1: PY4NvRocCFPfSIHKbh0euQ ($28.70 in chips)
Seat 2: l5WbyJ/iWYjpeCC6GCYY6w ($63.55 in chips)
l5WbyJ/iWYjpeCC6GCYY6w: posts small blind $0.25
PY4NvRocCFPfSIHKbh0euQ: posts big blind $0.50
*** HOLE CARDS ***
l5WbyJ/iWYjpeCC6GCYY6w: raises $1 to $1.50
PY4NvRocCFPfSIHKbh0euQ: calls $1
*** FLOP *** [7h Ah As]
PY4NvRocCFPfSIHKbh0euQ: checks
l5WbyJ/iWYjpeCC6GCYY6w: bets $1.50
PY4NvRocCFPfSIHKbh0euQ: calls $1.50
*** TURN *** [7h Ah As] [Jh]
PY4NvRocCFPfSIHKbh0euQ: checks
l5WbyJ/iWYjpeCC6GCYY6w: checks
*** RIVER *** [7h Ah As Jh] [Js]
PY4NvRocCFPfSIHKbh0euQ: bets $1.50
l5WbyJ/iWYjpeCC6GCYY6w: calls $1.50
*** SHOW DOWN ***
PY4NvRocCFPfSIHKbh0euQ: shows [7d 5d] (two pair, Aces and Jacks)
l5WbyJ/iWYjpeCC6GCYY6w: shows [9s Jc] (a full house, Jacks full of Aces)
l5WbyJ/iWYjpeCC6GCYY6w collected $8.60 from pot
*** SUMMARY ***
Total pot $9 | Rake $0.40
Board [7h Ah As Jh Js]
Seat 1: PY4NvRocCFPfSIHKbh0euQ (big blind) showed [7d 5d] and lost with two pair, Aces and Jacks
Seat 2: l5WbyJ/iWYjpeCC6GCYY6w (button) (small blind) showed [9s Jc] and won ($8.60) with a full house, Jacks full of Aces



PokerStars Game #59941160438:  Hold'em No Limit ($0.25/$0.50) - 2009/07/01 1:27:22 ET
Table '+dXkOAQyS8j9PQZusUTMpg' 2-max Seat #2 is the button
Seat 1: Teld4PDKla7C8/Wfu2DSkg ($54.45 in chips)
Seat 2: +zI4bP23YIjMkUHqeN2xfw ($22.90 in chips)
+zI4bP23YIjMkUHqeN2xfw: posts small blind $0.25
Teld4PDKla7C8/Wfu2DSkg: posts big blind $0.50
*** HOLE CARDS ***
+zI4bP23YIjMkUHqeN2xfw: raises $1 to $1.50
Teld4PDKla7C8/Wfu2DSkg: folds
+zI4bP23YIjMkUHqeN2xfw collected $1 from pot
*** SUMMARY ***
Total pot $1 | Rake $0
Seat 1: Teld4PDKla7C8/Wfu2DSkg (big blind) folded before Flop
Seat 2: +zI4bP23YIjMkUHqeN2xfw (button) (small blind) collected ($1)



PokerStars Game #59941160846:  Hold'em No Limit ($0.25/$0.50) - 2009/07/01 1:27:23 ET
Table 'tyR5AZNKV8Aadbrnrnlg7g' 6-max Seat #5 is the button
Seat 1: BgOXYI0yYSN1ULC4FqsNkg ($92.05 in chips)
Seat 2: BAjwVL+zKKd0s0fAWstzQQ ($13.95 in chips)
Seat 3: JFLrYNyQmwPhRQAtoSAuyA ($49.40 in chips)
Seat 4: 4QfsCWthT/vSLirorNXqtg ($85.95 in chips)
Seat 5: GUnvMULl2qFOO1yenu1UBw ($78 in chips)
Seat 6: 498aWaGsW4uGfuWl+2FCGw ($66.05 in chips)
498aWaGsW4uGfuWl+2FCGw: posts small blind $0.25
BgOXYI0yYSN1ULC4FqsNkg: posts big blind $0.50
*** HOLE CARDS ***
BAjwVL+zKKd0s0fAWstzQQ: folds
JFLrYNyQmwPhRQAtoSAuyA: folds
4QfsCWthT/vSLirorNXqtg: folds
GUnvMULl2qFOO1yenu1UBw: raises $1 to $1.50
498aWaGsW4uGfuWl+2FCGw: folds
BgOXYI0yYSN1ULC4FqsNkg: folds
GUnvMULl2qFOO1yenu1UBw collected $1.25 from pot
GUnvMULl2qFOO1yenu1UBw: doesn't show hand
*** SUMMARY ***
Total pot $1.25 | Rake $0
Seat 1: BgOXYI0yYSN1ULC4FqsNkg (big blind) folded before Flop
Seat 2: BAjwVL+zKKd0s0fAWstzQQ folded before Flop (didn't bet)
Seat 3: JFLrYNyQmwPhRQAtoSAuyA folded before Flop (didn't bet)
Seat 4: 4QfsCWthT/vSLirorNXqtg folded before Flop (didn't bet)
Seat 5: GUnvMULl2qFOO1yenu1UBw (button) collected ($1.25)
Seat 6: 498aWaGsW4uGfuWl+2FCGw (small blind) folded before Flop



PokerStars Game #59941160818:  Hold'em No Limit ($0.25/$0.50) - 2009/07/01 1:27:23 ET
Table 'lSisgp6H7Fg1hH5VfjEjYQ' 9-max Seat #4 is the button
Seat 1: 5k9fvXD9suIgCxU4HLQjTw ($54.85 in chips)
Seat 3: SKnJuWHScqetA/qG5p+wCg ($30 in chips)
Seat 4: bwv/rbH/hHhPhY6u9mu04w ($38.90 in chips)
Seat 5: mSD1pginDsyHG5PDfqzphw ($12.50 in chips)
Seat 6: +k7T5ocke8UwavtgUHm+Cg ($71.15 in chips)
Seat 7: IDtNLR9uFCDdjNsJWMHA5Q ($20.15 in chips)
Seat 8: a4JDWmpFQkL10XfAyuF51A ($12.25 in chips)
Seat 9: YzeKFbJVLmJGTgNH3ySQlw ($5.45 in chips)
mSD1pginDsyHG5PDfqzphw: posts small blind $0.25
+k7T5ocke8UwavtgUHm+Cg: posts big blind $0.50
5acK4E7fzEwnplVBZ6eNWA: sits out
*** HOLE CARDS ***
IDtNLR9uFCDdjNsJWMHA5Q: folds
a4JDWmpFQkL10XfAyuF51A: folds
YzeKFbJVLmJGTgNH3ySQlw: calls $0.50
5k9fvXD9suIgCxU4HLQjTw: raises $1 to $1.50
SKnJuWHScqetA/qG5p+wCg: folds
bwv/rbH/hHhPhY6u9mu04w: calls $1.50
mSD1pginDsyHG5PDfqzphw: folds
+k7T5ocke8UwavtgUHm+Cg: folds
YzeKFbJVLmJGTgNH3ySQlw: raises $3.95 to $5.45 and is all-in
5k9fvXD9suIgCxU4HLQjTw: folds
bwv/rbH/hHhPhY6u9mu04w: folds
YzeKFbJVLmJGTgNH3ySQlw collected $5.25 from pot
*** SUMMARY ***
Total pot $5.25 | Rake $0
Seat 1: 5k9fvXD9suIgCxU4HLQjTw folded before Flop
Seat 3: SKnJuWHScqetA/qG5p+wCg folded before Flop (didn't bet)
Seat 4: bwv/rbH/hHhPhY6u9mu04w (button) folded before Flop
Seat 5: mSD1pginDsyHG5PDfqzphw (small blind) folded before Flop
Seat 6: +k7T5ocke8UwavtgUHm+Cg (big blind) folded before Flop
Seat 7: IDtNLR9uFCDdjNsJWMHA5Q folded before Flop (didn't bet)
Seat 8: a4JDWmpFQkL10XfAyuF51A folded before Flop (didn't bet)
Seat 9: YzeKFbJVLmJGTgNH3ySQlw collected ($5.25)



PokerStars Game #59941161572:  Hold'em No Limit ($0.25/$0.50) - 2009/07/01 1:27:24 ET
Table 'otvGDROEDdqsabxskT79qg' 9-max Seat #3 is the button
Seat 1: 8ehL7qlZzjgUh2H35iiWLw ($61.25 in chips)
Seat 2: cCjTzH9jio8607WzjcfXlg ($5.90 in chips)
Seat 3: +k7T5ocke8UwavtgUHm+Cg ($77.20 in chips)
Seat 4: MG90wfSJZnOejs/KD3vlQQ ($79.15 in chips)
Seat 5: E2518gp4aFz1+kAgmGqeEg ($12.20 in chips)
Seat 6: FFVKBJT0lZf+jFlgvy7ang ($45 in chips)
Seat 8: zE9cVigS2nW/Ljy4K4bUQA ($33.30 in chips)
Seat 9: KcY3X8YpD74Kw1RHkx/g4A ($28.90 in chips)
MG90wfSJZnOejs/KD3vlQQ: posts small blind $0.25
E2518gp4aFz1+kAgmGqeEg: posts big blind $0.50
*** HOLE CARDS ***
FFVKBJT0lZf+jFlgvy7ang: folds
zE9cVigS2nW/Ljy4K4bUQA: folds
KcY3X8YpD74Kw1RHkx/g4A: folds
8ehL7qlZzjgUh2H35iiWLw: folds
cCjTzH9jio8607WzjcfXlg: calls $0.50
+k7T5ocke8UwavtgUHm+Cg: calls $0.50
MG90wfSJZnOejs/KD3vlQQ: folds
E2518gp4aFz1+kAgmGqeEg: checks
*** FLOP *** [9s Jd Kc]
E2518gp4aFz1+kAgmGqeEg: checks
cCjTzH9jio8607WzjcfXlg: bets $1
+k7T5ocke8UwavtgUHm+Cg: calls $1
E2518gp4aFz1+kAgmGqeEg: folds
*** TURN *** [9s Jd Kc] [8c]
E2518gp4aFz1+kAgmGqeEg is sitting out
cCjTzH9jio8607WzjcfXlg: bets $1
+k7T5ocke8UwavtgUHm+Cg: calls $1
*** RIVER *** [9s Jd Kc 8c] [6d]
cCjTzH9jio8607WzjcfXlg: checks
+k7T5ocke8UwavtgUHm+Cg: bets $4.50
cCjTzH9jio8607WzjcfXlg: calls $3.40 and is all-in
*** SHOW DOWN ***
+k7T5ocke8UwavtgUHm+Cg: shows [Kd Ts] (a pair of Kings)
cCjTzH9jio8607WzjcfXlg: mucks hand
+k7T5ocke8UwavtgUHm+Cg collected $11.95 from pot
*** SUMMARY ***
Total pot $12.55 | Rake $0.60
Board [9s Jd Kc 8c 6d]
Seat 1: 8ehL7qlZzjgUh2H35iiWLw folded before Flop (didn't bet)
Seat 2: cCjTzH9jio8607WzjcfXlg mucked
Seat 3: +k7T5ocke8UwavtgUHm+Cg (button) showed [Kd Ts] and won ($11.95) with a pair of Kings
Seat 4: MG90wfSJZnOejs/KD3vlQQ (small blind) folded before Flop
Seat 5: E2518gp4aFz1+kAgmGqeEg (big blind) folded on the Flop
Seat 6: FFVKBJT0lZf+jFlgvy7ang folded before Flop (didn't bet)
Seat 8: zE9cVigS2nW/Ljy4K4bUQA folded before Flop (didn't bet)
Seat 9: KcY3X8YpD74Kw1RHkx/g4A folded before Flop (didn't bet)



PokerStars Game #59941163576:  Hold'em No Limit ($0.25/$0.50) - 2009/07/01 1:27:27 ET
Table 'kgbJRsxfv64KrErDRBAkcw' 6-max Seat #1 is the button
Seat 1: VamsyhlFzXGF6/ydo0BHeA ($14.05 in chips)
Seat 2: AdS8BJMOheS01zjCDfPMFg ($64.75 in chips)
Seat 3: c4MNIaIyPMOMxrgT8FT5nA ($229.70 in chips)
Seat 4: 2igtJLmvIZ+HqX4XPgMPZA ($55 in chips)
Seat 5: eUBBn2R56C1IQ6Cs/vitwg ($55.20 in chips)
Seat 6: 1b+2BbjMN8qhR1WPqdE9VQ ($55.90 in chips)
AdS8BJMOheS01zjCDfPMFg: posts small blind $0.25
c4MNIaIyPMOMxrgT8FT5nA: posts big blind $0.50
*** HOLE CARDS ***
2igtJLmvIZ+HqX4XPgMPZA: raises $1.50 to $2
eUBBn2R56C1IQ6Cs/vitwg: folds
1b+2BbjMN8qhR1WPqdE9VQ: folds
VamsyhlFzXGF6/ydo0BHeA: calls $2
AdS8BJMOheS01zjCDfPMFg: folds
c4MNIaIyPMOMxrgT8FT5nA: folds
*** FLOP *** [2d Jc As]
2igtJLmvIZ+HqX4XPgMPZA: bets $2.50
VamsyhlFzXGF6/ydo0BHeA: calls $2.50
*** TURN *** [2d Jc As] [5h]
2igtJLmvIZ+HqX4XPgMPZA: checks
VamsyhlFzXGF6/ydo0BHeA: checks
*** RIVER *** [2d Jc As 5h] [Qh]
2igtJLmvIZ+HqX4XPgMPZA: checks
VamsyhlFzXGF6/ydo0BHeA: checks
*** SHOW DOWN ***
2igtJLmvIZ+HqX4XPgMPZA: shows [Kh Jh] (a pair of Jacks)
VamsyhlFzXGF6/ydo0BHeA: mucks hand
2igtJLmvIZ+HqX4XPgMPZA collected $9.30 from pot
*** SUMMARY ***
Total pot $9.75 | Rake $0.45
Board [2d Jc As 5h Qh]
Seat 1: VamsyhlFzXGF6/ydo0BHeA (button) mucked
Seat 2: AdS8BJMOheS01zjCDfPMFg (small blind) folded before Flop
Seat 3: c4MNIaIyPMOMxrgT8FT5nA (big blind) folded before Flop
Seat 4: 2igtJLmvIZ+HqX4XPgMPZA showed [Kh Jh] and won ($9.30) with a pair of Jacks
Seat 5: eUBBn2R56C1IQ6Cs/vitwg folded before Flop (didn't bet)
Seat 6: 1b+2BbjMN8qhR1WPqdE9VQ folded before Flop (didn't bet)



PokerStars Game #59941163528:  Hold'em No Limit ($0.25/$0.50) - 2009/07/01 1:27:27 ET
Table 'NCiXr0d5CEKBQr/cZgLhbA' 9-max Seat #8 is the button
Seat 1: pFtzb1sR4b0d1aw6aIRgDg ($81.20 in chips)
Seat 2: AjV5McH1KMMclY26QdLM5w ($25 in chips)
Seat 3: xZCXQSXlrZkp3pZizzVXCw ($98.65 in chips)
Seat 4: 5k9fvXD9suIgCxU4HLQjTw ($53.95 in chips)
Seat 5: Ja2jdidjip2UeJnRzmzAAQ ($36.60 in chips)
Seat 6: t1qL+wRXOwTLB4TBbcw2QA ($47.75 in chips)
Seat 7: dXhO5i7KOoVcsGqbklD+jw ($27.50 in chips)
Seat 8: 1MJUKc3cc0QmUoz1JZLR2w ($48.95 in chips)
Seat 9: 4WLZvqBn5qv5tds5kt5A1Q ($55.55 in chips)
4WLZvqBn5qv5tds5kt5A1Q: posts small blind $0.25
pFtzb1sR4b0d1aw6aIRgDg: posts big blind $0.50
*** HOLE CARDS ***
AjV5McH1KMMclY26QdLM5w: folds
xZCXQSXlrZkp3pZizzVXCw: folds
1MJUKc3cc0QmUoz1JZLR2w said, "that hand had it all....straight loses to a flush which loses to a full house"
1MJUKc3cc0QmUoz1JZLR2w said, "lol"
5k9fvXD9suIgCxU4HLQjTw: folds
Ja2jdidjip2UeJnRzmzAAQ: folds
t1qL+wRXOwTLB4TBbcw2QA: folds
dXhO5i7KOoVcsGqbklD+jw: folds
1MJUKc3cc0QmUoz1JZLR2w: folds
4WLZvqBn5qv5tds5kt5A1Q: calls $0.25
pFtzb1sR4b0d1aw6aIRgDg: checks
*** FLOP *** [4c 6s Kh]
4WLZvqBn5qv5tds5kt5A1Q: checks
pFtzb1sR4b0d1aw6aIRgDg: checks
*** TURN *** [4c 6s Kh] [2d]
4WLZvqBn5qv5tds5kt5A1Q: checks
pFtzb1sR4b0d1aw6aIRgDg: checks
*** RIVER *** [4c 6s Kh 2d] [4d]
4WLZvqBn5qv5tds5kt5A1Q: checks
pFtzb1sR4b0d1aw6aIRgDg: checks
*** SHOW DOWN ***
4WLZvqBn5qv5tds5kt5A1Q: shows [5h 5d] (two pair, Fives and Fours)
pFtzb1sR4b0d1aw6aIRgDg: mucks hand
4WLZvqBn5qv5tds5kt5A1Q collected $0.95 from pot
*** SUMMARY ***
Total pot $1 | Rake $0.05
Board [4c 6s Kh 2d 4d]
Seat 1: pFtzb1sR4b0d1aw6aIRgDg (big blind) mucked
Seat 2: AjV5McH1KMMclY26QdLM5w folded before Flop (didn't bet)
Seat 3: xZCXQSXlrZkp3pZizzVXCw folded before Flop (didn't bet)
Seat 4: 5k9fvXD9suIgCxU4HLQjTw folded before Flop (didn't bet)
Seat 5: Ja2jdidjip2UeJnRzmzAAQ folded before Flop (didn't bet)
Seat 6: t1qL+wRXOwTLB4TBbcw2QA folded before Flop (didn't bet)
Seat 7: dXhO5i7KOoVcsGqbklD+jw folded before Flop (didn't bet)
Seat 8: 1MJUKc3cc0QmUoz1JZLR2w (button) folded before Flop (didn't bet)
Seat 9: 4WLZvqBn5qv5tds5kt5A1Q (small blind) showed [5h 5d] and won ($0.95) with two pair, Fives and Fours



PokerStars Game #59941165092:  Hold'em No Limit ($0.25/$0.50) - 2009/07/01 1:27:30 ET
Table '+dXkOAQyS8j9PQZusUTMpg' 2-max Seat #1 is the button
Seat 1: Teld4PDKla7C8/Wfu2DSkg ($53.95 in chips)
Seat 2: +zI4bP23YIjMkUHqeN2xfw ($23.40 in chips)
Teld4PDKla7C8/Wfu2DSkg: posts small blind $0.25
+zI4bP23YIjMkUHqeN2xfw: posts big blind $0.50
*** HOLE CARDS ***
Teld4PDKla7C8/Wfu2DSkg: calls $0.25
+zI4bP23YIjMkUHqeN2xfw: checks
*** FLOP *** [3h Qd 8d]
+zI4bP23YIjMkUHqeN2xfw: checks
Teld4PDKla7C8/Wfu2DSkg: bets $0.50
+zI4bP23YIjMkUHqeN2xfw: folds
Teld4PDKla7C8/Wfu2DSkg collected $0.95 from pot
Teld4PDKla7C8/Wfu2DSkg: doesn't show hand
*** SUMMARY ***
Total pot $1 | Rake $0.05
Board [3h Qd 8d]
Seat 1: Teld4PDKla7C8/Wfu2DSkg (button) (small blind) collected ($0.95)
Seat 2: +zI4bP23YIjMkUHqeN2xfw (big blind) folded on the Flop



PokerStars Game #59941166350:  Hold'em No Limit ($0.25/$0.50) - 2009/07/01 1:27:32 ET
Table '8BQGgNetI1NOvWeu3gtMNw' 2-max Seat #1 is the button
Seat 1: bypIyrYcAAifLfhZpGlKLA ($68.50 in chips)
Seat 2: Z4HwehErEwzsv/noQlfUlg ($150.45 in chips)
bypIyrYcAAifLfhZpGlKLA: posts small blind $0.25
Z4HwehErEwzsv/noQlfUlg: posts big blind $0.50
*** HOLE CARDS ***
bypIyrYcAAifLfhZpGlKLA: raises $1 to $1.50
Z4HwehErEwzsv/noQlfUlg: calls $1
*** FLOP *** [Kc 4d As]
Z4HwehErEwzsv/noQlfUlg: checks
bypIyrYcAAifLfhZpGlKLA: bets $2
Z4HwehErEwzsv/noQlfUlg: calls $2
*** TURN *** [Kc 4d As] [6d]
Z4HwehErEwzsv/noQlfUlg: checks
bypIyrYcAAifLfhZpGlKLA: bets $4.50
Z4HwehErEwzsv/noQlfUlg: raises $4.50 to $9
bypIyrYcAAifLfhZpGlKLA: folds
Z4HwehErEwzsv/noQlfUlg collected $15.50 from pot
Z4HwehErEwzsv/noQlfUlg: doesn't show hand
*** SUMMARY ***
Total pot $16 | Rake $0.50
Board [Kc 4d As 6d]
Seat 1: bypIyrYcAAifLfhZpGlKLA (button) (small blind) folded on the Turn
Seat 2: Z4HwehErEwzsv/noQlfUlg (big blind) collected ($15.50)



PokerStars Game #59941166708:  Hold'em No Limit ($0.25/$0.50) - 2009/07/01 1:27:33 ET
Table '2lPOwetm4cfkZPbTmGPH/w' 2-max Seat #1 is the button
Seat 1: vUGdApqS8J/GJE2gaVWl1w ($13.65 in chips)
Seat 2: XFa6sBGjP2gxoIvxR3fZIg ($29.35 in chips)
vUGdApqS8J/GJE2gaVWl1w: posts small blind $0.25
XFa6sBGjP2gxoIvxR3fZIg: posts big blind $0.50
*** HOLE CARDS ***
vUGdApqS8J/GJE2gaVWl1w: folds
XFa6sBGjP2gxoIvxR3fZIg collected $0.50 from pot
*** SUMMARY ***
Total pot $0.50 | Rake $0
Seat 1: vUGdApqS8J/GJE2gaVWl1w (button) (small blind) folded before Flop
Seat 2: XFa6sBGjP2gxoIvxR3fZIg (big blind) collected ($0.50)



PokerStars Game #59941167964:  Hold'em No Limit ($0.25/$0.50) - 2009/07/01 1:27:35 ET
Table 'B+sqsfj6d6zXicNfaseTaw' 2-max Seat #2 is the button
Seat 1: +4GNcSsecmapVGSdV0mUPA ($132.95 in chips)
Seat 2: Lv5RmpRe6LtPkBzM9Gpo5A ($92.80 in chips)
Lv5RmpRe6LtPkBzM9Gpo5A: posts small blind $0.25
+4GNcSsecmapVGSdV0mUPA: posts big blind $0.50
*** HOLE CARDS ***
Lv5RmpRe6LtPkBzM9Gpo5A: calls $0.25
+4GNcSsecmapVGSdV0mUPA: checks
*** FLOP *** [3d 7d 3h]
+4GNcSsecmapVGSdV0mUPA: checks
Lv5RmpRe6LtPkBzM9Gpo5A: checks
*** TURN *** [3d 7d 3h] [Ah]
+4GNcSsecmapVGSdV0mUPA: checks
Lv5RmpRe6LtPkBzM9Gpo5A: checks
*** RIVER *** [3d 7d 3h Ah] [Tc]
+4GNcSsecmapVGSdV0mUPA: checks
Lv5RmpRe6LtPkBzM9Gpo5A: checks
*** SHOW DOWN ***
+4GNcSsecmapVGSdV0mUPA: shows [5c 8c] (a pair of Threes)
Lv5RmpRe6LtPkBzM9Gpo5A: shows [2c Qd] (a pair of Threes - Ace+Queen kicker)
Lv5RmpRe6LtPkBzM9Gpo5A collected $0.95 from pot
*** SUMMARY ***
Total pot $1 | Rake $0.05
Board [3d 7d 3h Ah Tc]
Seat 1: +4GNcSsecmapVGSdV0mUPA (big blind) showed [5c 8c] and lost with a pair of Threes
Seat 2: Lv5RmpRe6LtPkBzM9Gpo5A (button) (small blind) showed [2c Qd] and won ($0.95) with a pair of Threes



PokerStars Game #59941169444:  Hold'em No Limit ($0.25/$0.50) - 2009/07/01 1:27:37 ET
Table 'hSTs/dUsYLgJQuF2Onp0MQ' 6-max Seat #2 is the button
Seat 1: 1WUCqNG+p+vfWRTXNu4ljw ($50 in chips)
Seat 2: Hdd4js36ITbTJ/QuVYwTlA ($48.25 in chips)
Seat 3: lxIzoHy0RnkfFSODHC2liw ($51.85 in chips)
Seat 4: 2igtJLmvIZ+HqX4XPgMPZA ($80.15 in chips)
Seat 5: IBNygaT1aa9Z1uPdJJilwA ($53.70 in chips)
Seat 6: M1KyQQvVPVuxqTAB8sR/zQ ($95.55 in chips)
lxIzoHy0RnkfFSODHC2liw: posts small blind $0.25
2igtJLmvIZ+HqX4XPgMPZA: posts big blind $0.50
*** HOLE CARDS ***
IBNygaT1aa9Z1uPdJJilwA: folds
IBNygaT1aa9Z1uPdJJilwA leaves the table
M1KyQQvVPVuxqTAB8sR/zQ: folds
1WUCqNG+p+vfWRTXNu4ljw: raises $1.50 to $2
Hdd4js36ITbTJ/QuVYwTlA: calls $2
lxIzoHy0RnkfFSODHC2liw: folds
2igtJLmvIZ+HqX4XPgMPZA: folds
*** FLOP *** [Ks 6s 7c]
1WUCqNG+p+vfWRTXNu4ljw: bets $3
Hdd4js36ITbTJ/QuVYwTlA: calls $3
*** TURN *** [Ks 6s 7c] [3c]
1WUCqNG+p+vfWRTXNu4ljw: checks
Hdd4js36ITbTJ/QuVYwTlA: checks
*** RIVER *** [Ks 6s 7c 3c] [5s]
1WUCqNG+p+vfWRTXNu4ljw: checks
Hdd4js36ITbTJ/QuVYwTlA: bets $4
1WUCqNG+p+vfWRTXNu4ljw: folds
Hdd4js36ITbTJ/QuVYwTlA collected $10.25 from pot
*** SUMMARY ***
Total pot $10.75 | Rake $0.50
Board [Ks 6s 7c 3c 5s]
Seat 1: 1WUCqNG+p+vfWRTXNu4ljw folded on the River
Seat 2: Hdd4js36ITbTJ/QuVYwTlA (button) collected ($10.25)
Seat 3: lxIzoHy0RnkfFSODHC2liw (small blind) folded before Flop
Seat 4: 2igtJLmvIZ+HqX4XPgMPZA (big blind) folded before Flop
Seat 5: IBNygaT1aa9Z1uPdJJilwA folded before Flop (didn't bet)
Seat 6: M1KyQQvVPVuxqTAB8sR/zQ folded before Flop (didn't bet)



PokerStars Game #59941170468:  Hold'em No Limit ($0.25/$0.50) - 2009/07/01 1:27:39 ET
Table '2lPOwetm4cfkZPbTmGPH/w' 2-max Seat #2 is the button
Seat 1: vUGdApqS8J/GJE2gaVWl1w ($13.40 in chips)
Seat 2: XFa6sBGjP2gxoIvxR3fZIg ($29.60 in chips)
XFa6sBGjP2gxoIvxR3fZIg: posts small blind $0.25
vUGdApqS8J/GJE2gaVWl1w: posts big blind $0.50
*** HOLE CARDS ***
XFa6sBGjP2gxoIvxR3fZIg: raises $1 to $1.50
vUGdApqS8J/GJE2gaVWl1w: folds
XFa6sBGjP2gxoIvxR3fZIg collected $1 from pot
XFa6sBGjP2gxoIvxR3fZIg: doesn't show hand
*** SUMMARY ***
Total pot $1 | Rake $0
Seat 1: vUGdApqS8J/GJE2gaVWl1w (big blind) folded before Flop
Seat 2: XFa6sBGjP2gxoIvxR3fZIg (button) (small blind) collected ($1)



PokerStars Game #59941171318:  Hold'em No Limit ($0.25/$0.50) - 2009/07/01 1:27:41 ET
Table 'tyR5AZNKV8Aadbrnrnlg7g' 6-max Seat #6 is the button
Seat 1: BgOXYI0yYSN1ULC4FqsNkg ($91.55 in chips)
Seat 2: BAjwVL+zKKd0s0fAWstzQQ ($13.95 in chips)
Seat 3: JFLrYNyQmwPhRQAtoSAuyA ($49.40 in chips)
Seat 4: 4QfsCWthT/vSLirorNXqtg ($85.95 in chips)
Seat 5: GUnvMULl2qFOO1yenu1UBw ($78.75 in chips)
Seat 6: 498aWaGsW4uGfuWl+2FCGw ($65.80 in chips)
BgOXYI0yYSN1ULC4FqsNkg: posts small blind $0.25
BAjwVL+zKKd0s0fAWstzQQ: posts big blind $0.50
*** HOLE CARDS ***
JFLrYNyQmwPhRQAtoSAuyA: folds
4QfsCWthT/vSLirorNXqtg: folds
GUnvMULl2qFOO1yenu1UBw: folds
498aWaGsW4uGfuWl+2FCGw: folds
BgOXYI0yYSN1ULC4FqsNkg: folds
BAjwVL+zKKd0s0fAWstzQQ collected $0.50 from pot
*** SUMMARY ***
Total pot $0.50 | Rake $0
Seat 1: BgOXYI0yYSN1ULC4FqsNkg (small blind) folded before Flop
Seat 2: BAjwVL+zKKd0s0fAWstzQQ (big blind) collected ($0.50)
Seat 3: JFLrYNyQmwPhRQAtoSAuyA folded before Flop (didn't bet)
Seat 4: 4QfsCWthT/vSLirorNXqtg folded before Flop (didn't bet)
Seat 5: GUnvMULl2qFOO1yenu1UBw folded before Flop (didn't bet)
Seat 6: 498aWaGsW4uGfuWl+2FCGw (button) folded before Flop (didn't bet)



PokerStars Game #59941171892:  Hold'em No Limit ($0.25/$0.50) - 2009/07/01 1:27:42 ET
Table 'EiNh8p/wGJ1FP575iMFnqg' 9-max Seat #3 is the button
Seat 1: YFFlOZgyy1Mh4iBmuNRbmQ ($28.50 in chips)
Seat 2: 8ehL7qlZzjgUh2H35iiWLw ($58.15 in chips)
Seat 3: ymLPoEIl7UL3TvZYmnadxQ ($44.35 in chips)
Seat 4: cMzaiXAM/ZAdNaEUu+LqhA ($59.95 in chips)
Seat 5: M+7+BTmX5vZatHVuoRB1nA ($74.45 in chips)
Seat 6: viwBDtJsY6JfsFOdBAyJIQ ($9.45 in chips)
Seat 7: 997ViqAtWn1FPjJqcffwcA ($50 in chips)
Seat 8: mSD1pginDsyHG5PDfqzphw ($10 in chips)
Seat 9: GuPkZObrz5Zkkn8FsEdF9w ($37.60 in chips)
cMzaiXAM/ZAdNaEUu+LqhA: posts small blind $0.25
M+7+BTmX5vZatHVuoRB1nA: posts big blind $0.50
*** HOLE CARDS ***
viwBDtJsY6JfsFOdBAyJIQ: folds
997ViqAtWn1FPjJqcffwcA: folds
mSD1pginDsyHG5PDfqzphw: folds
GuPkZObrz5Zkkn8FsEdF9w: raises $1.50 to $2
YFFlOZgyy1Mh4iBmuNRbmQ: calls $2
8ehL7qlZzjgUh2H35iiWLw: calls $2
ymLPoEIl7UL3TvZYmnadxQ: calls $2
cMzaiXAM/ZAdNaEUu+LqhA: folds
M+7+BTmX5vZatHVuoRB1nA: folds
*** FLOP *** [Qh 3h 9s]
GuPkZObrz5Zkkn8FsEdF9w: checks
YFFlOZgyy1Mh4iBmuNRbmQ: checks
8ehL7qlZzjgUh2H35iiWLw: bets $5
ymLPoEIl7UL3TvZYmnadxQ: folds
GuPkZObrz5Zkkn8FsEdF9w: folds
YFFlOZgyy1Mh4iBmuNRbmQ: folds
8ehL7qlZzjgUh2H35iiWLw collected $8.35 from pot
8ehL7qlZzjgUh2H35iiWLw: doesn't show hand
*** SUMMARY ***
Total pot $8.75 | Rake $0.40
Board [Qh 3h 9s]
Seat 1: YFFlOZgyy1Mh4iBmuNRbmQ folded on the Flop
Seat 2: 8ehL7qlZzjgUh2H35iiWLw collected ($8.35)
Seat 3: ymLPoEIl7UL3TvZYmnadxQ (button) folded on the Flop
Seat 4: cMzaiXAM/ZAdNaEUu+LqhA (small blind) folded before Flop
Seat 5: M+7+BTmX5vZatHVuoRB1nA (big blind) folded before Flop
Seat 6: viwBDtJsY6JfsFOdBAyJIQ folded before Flop (didn't bet)
Seat 7: 997ViqAtWn1FPjJqcffwcA folded before Flop (didn't bet)
Seat 8: mSD1pginDsyHG5PDfqzphw folded before Flop (didn't bet)
Seat 9: GuPkZObrz5Zkkn8FsEdF9w folded on the Flop



PokerStars Game #59941172936:  Hold'em No Limit ($0.25/$0.50) - 2009/07/01 1:27:44 ET
Table '+dXkOAQyS8j9PQZusUTMpg' 2-max Seat #2 is the button
Seat 1: Teld4PDKla7C8/Wfu2DSkg ($54.40 in chips)
Seat 2: +zI4bP23YIjMkUHqeN2xfw ($22.90 in chips)
+zI4bP23YIjMkUHqeN2xfw: posts small blind $0.25
Teld4PDKla7C8/Wfu2DSkg: posts big blind $0.50
*** HOLE CARDS ***
+zI4bP23YIjMkUHqeN2xfw: folds
Teld4PDKla7C8/Wfu2DSkg collected $0.50 from pot
Teld4PDKla7C8/Wfu2DSkg: doesn't show hand
*** SUMMARY ***
Total pot $0.50 | Rake $0
Seat 1: Teld4PDKla7C8/Wfu2DSkg (big blind) collected ($0.50)
Seat 2: +zI4bP23YIjMkUHqeN2xfw (button) (small blind) folded before Flop



PokerStars Game #59941174098:  Hold'em No Limit ($0.25/$0.50) - 2009/07/01 1:27:45 ET
Table 'cofQFHU7jbJoFecLVBof/w' 6-max Seat #1 is the button
Seat 1: URYNc7fPA23K2UfadQbnCA ($48.50 in chips)
Seat 2: f89uTQr3ieGlusj2IAYAEg ($50 in chips)
Seat 3: v4ctePcLlQw0r8E0qJtjYw ($47.95 in chips)
Seat 4: g6lz8npaeeTJmJegtPYhlQ ($17.15 in chips)
Seat 5: QvwRlrpVqerRRF8eJm6dDw ($53 in chips)
Seat 6: 7+uQ0OOgCTbR4ltkSwyC0g ($157.15 in chips)
f89uTQr3ieGlusj2IAYAEg: posts small blind $0.25
v4ctePcLlQw0r8E0qJtjYw: posts big blind $0.50
*** HOLE CARDS ***
g6lz8npaeeTJmJegtPYhlQ: calls $0.50
QvwRlrpVqerRRF8eJm6dDw: folds
7+uQ0OOgCTbR4ltkSwyC0g: folds
URYNc7fPA23K2UfadQbnCA: folds
f89uTQr3ieGlusj2IAYAEg: folds
v4ctePcLlQw0r8E0qJtjYw: checks
*** FLOP *** [3s Jd Qs]
v4ctePcLlQw0r8E0qJtjYw: checks
g6lz8npaeeTJmJegtPYhlQ: checks
*** TURN *** [3s Jd Qs] [6h]
v4ctePcLlQw0r8E0qJtjYw: checks
g6lz8npaeeTJmJegtPYhlQ: bets $1
v4ctePcLlQw0r8E0qJtjYw: folds
g6lz8npaeeTJmJegtPYhlQ collected $1.20 from pot
*** SUMMARY ***
Total pot $1.25 | Rake $0.05
Board [3s Jd Qs 6h]
Seat 1: URYNc7fPA23K2UfadQbnCA (button) folded before Flop (didn't bet)
Seat 2: f89uTQr3ieGlusj2IAYAEg (small blind) folded before Flop
Seat 3: v4ctePcLlQw0r8E0qJtjYw (big blind) folded on the Turn
Seat 4: g6lz8npaeeTJmJegtPYhlQ collected ($1.20)
Seat 5: QvwRlrpVqerRRF8eJm6dDw folded before Flop (didn't bet)
Seat 6: 7+uQ0OOgCTbR4ltkSwyC0g folded before Flop (didn't bet)



PokerStars Game #59941175146:  Hold'em No Limit ($0.25/$0.50) - 2009/07/01 1:27:47 ET
Table 'BCN5su+SsXiy1zRMJi0SJw' 6-max Seat #2 is the button
Seat 1: GxXV09ciXaOxyY2H5aMIIw ($48.30 in chips)
Seat 2: ehFNAevCQri3trWxV6FJdA ($46.25 in chips)
Seat 3: kwgv5lNhiFrfONXCshzxlA ($43.35 in chips)
Seat 4: bbsK8j+tpuVRhBqDzHxf7w ($50 in chips)
Seat 5: kxPhs4ePFqMy52CInAJ2aw ($52.05 in chips)
Seat 6: b2symlOdL7+0c9Pj4N/KlA ($66.65 in chips)
kwgv5lNhiFrfONXCshzxlA: posts small blind $0.25
bbsK8j+tpuVRhBqDzHxf7w: posts big blind $0.50
*** HOLE CARDS ***
kxPhs4ePFqMy52CInAJ2aw: folds
b2symlOdL7+0c9Pj4N/KlA: folds
GxXV09ciXaOxyY2H5aMIIw: raises $1.50 to $2
ehFNAevCQri3trWxV6FJdA: calls $2
kwgv5lNhiFrfONXCshzxlA: folds
bbsK8j+tpuVRhBqDzHxf7w: folds
*** FLOP *** [6c Jd 8d]
GxXV09ciXaOxyY2H5aMIIw: bets $4
ehFNAevCQri3trWxV6FJdA: calls $4
*** TURN *** [6c Jd 8d] [6h]
GxXV09ciXaOxyY2H5aMIIw: bets $9.50
ehFNAevCQri3trWxV6FJdA: calls $9.50
*** RIVER *** [6c Jd 8d 6h] [9h]
GxXV09ciXaOxyY2H5aMIIw: checks
ehFNAevCQri3trWxV6FJdA: bets $30.75 and is all-in
GxXV09ciXaOxyY2H5aMIIw: folds
ehFNAevCQri3trWxV6FJdA collected $30.20 from pot
*** SUMMARY ***
Total pot $31.75 | Rake $1.55
Board [6c Jd 8d 6h 9h]
Seat 1: GxXV09ciXaOxyY2H5aMIIw folded on the River
Seat 2: ehFNAevCQri3trWxV6FJdA (button) collected ($30.20)
Seat 3: kwgv5lNhiFrfONXCshzxlA (small blind) folded before Flop
Seat 4: bbsK8j+tpuVRhBqDzHxf7w (big blind) folded before Flop
Seat 5: kxPhs4ePFqMy52CInAJ2aw folded before Flop (didn't bet)
Seat 6: b2symlOdL7+0c9Pj4N/KlA folded before Flop (didn't bet)



PokerStars Game #59941175000:  Hold'em No Limit ($0.25/$0.50) - 2009/07/01 1:27:47 ET
Table '2lPOwetm4cfkZPbTmGPH/w' 2-max Seat #1 is the button
Seat 1: vUGdApqS8J/GJE2gaVWl1w ($12.90 in chips)
Seat 2: XFa6sBGjP2gxoIvxR3fZIg ($30.10 in chips)
vUGdApqS8J/GJE2gaVWl1w: posts small blind $0.25
XFa6sBGjP2gxoIvxR3fZIg: posts big blind $0.50
*** HOLE CARDS ***
vUGdApqS8J/GJE2gaVWl1w: calls $0.25
XFa6sBGjP2gxoIvxR3fZIg: raises $1.50 to $2
vUGdApqS8J/GJE2gaVWl1w: folds
XFa6sBGjP2gxoIvxR3fZIg collected $1 from pot
XFa6sBGjP2gxoIvxR3fZIg: doesn't show hand
*** SUMMARY ***
Total pot $1 | Rake $0
Seat 1: vUGdApqS8J/GJE2gaVWl1w (button) (small blind) folded before Flop
Seat 2: XFa6sBGjP2gxoIvxR3fZIg (big blind) collected ($1)



PokerStars Game #59941174872:  Hold'em No Limit ($0.25/$0.50) - 2009/07/01 1:27:47 ET
Table '3FhG0gl3kMX3wBEEqj+wnQ' 9-max Seat #6 is the button
Seat 1: bxLSulbgr8LmKNjOzw8URg ($49.30 in chips)
Seat 2: vacmVLJJECYI6HjAynFcpg ($50.60 in chips)
Seat 3: YXCE3WOZi8g2sIf3y/plVw ($50 in chips)
Seat 4: e2+sK/yjnj94rXOKoxPP2A ($70.25 in chips)
Seat 5: XcLXSUMHSpshK/7Lh0M4Vg ($9.25 in chips)
Seat 6: 997ViqAtWn1FPjJqcffwcA ($109.80 in chips)
Seat 7: mSD1pginDsyHG5PDfqzphw ($12.75 in chips)
Seat 8: j3K/Jujr7PY4ZM2RZvlH6A ($54.60 in chips)
mSD1pginDsyHG5PDfqzphw: posts small blind $0.25
j3K/Jujr7PY4ZM2RZvlH6A: posts big blind $0.50
*** HOLE CARDS ***
bxLSulbgr8LmKNjOzw8URg: folds
vacmVLJJECYI6HjAynFcpg: folds
YXCE3WOZi8g2sIf3y/plVw: raises $0.50 to $1
e2+sK/yjnj94rXOKoxPP2A: folds
XcLXSUMHSpshK/7Lh0M4Vg: folds
997ViqAtWn1FPjJqcffwcA: folds
mSD1pginDsyHG5PDfqzphw: folds
j3K/Jujr7PY4ZM2RZvlH6A: raises $2.50 to $3.50
YXCE3WOZi8g2sIf3y/plVw: calls $2.50
*** FLOP *** [6d Ad 4c]
j3K/Jujr7PY4ZM2RZvlH6A: bets $3.50
YXCE3WOZi8g2sIf3y/plVw: calls $3.50
*** TURN *** [6d Ad 4c] [3c]
j3K/Jujr7PY4ZM2RZvlH6A: bets $3.50
YXCE3WOZi8g2sIf3y/plVw: raises $7.50 to $11
j3K/Jujr7PY4ZM2RZvlH6A: folds
YXCE3WOZi8g2sIf3y/plVw collected $20.25 from pot
YXCE3WOZi8g2sIf3y/plVw: doesn't show hand
*** SUMMARY ***
Total pot $21.25 | Rake $1
Board [6d Ad 4c 3c]
Seat 1: bxLSulbgr8LmKNjOzw8URg folded before Flop (didn't bet)
Seat 2: vacmVLJJECYI6HjAynFcpg folded before Flop (didn't bet)
Seat 3: YXCE3WOZi8g2sIf3y/plVw collected ($20.25)
Seat 4: e2+sK/yjnj94rXOKoxPP2A folded before Flop (didn't bet)
Seat 5: XcLXSUMHSpshK/7Lh0M4Vg folded before Flop (didn't bet)
Seat 6: 997ViqAtWn1FPjJqcffwcA (button) folded before Flop (didn't bet)
Seat 7: mSD1pginDsyHG5PDfqzphw (small blind) folded before Flop
Seat 8: j3K/Jujr7PY4ZM2RZvlH6A (big blind) folded on the Turn



PokerStars Game #59941176372:  Hold'em No Limit ($0.25/$0.50) - 2009/07/01 1:27:49 ET
Table '+dXkOAQyS8j9PQZusUTMpg' 2-max Seat #1 is the button
Seat 1: Teld4PDKla7C8/Wfu2DSkg ($54.65 in chips)
Seat 2: +zI4bP23YIjMkUHqeN2xfw ($22.65 in chips)
Teld4PDKla7C8/Wfu2DSkg: posts small blind $0.25
+zI4bP23YIjMkUHqeN2xfw: posts big blind $0.50
*** HOLE CARDS ***
Teld4PDKla7C8/Wfu2DSkg: raises $0.50 to $1
+zI4bP23YIjMkUHqeN2xfw: calls $0.50
*** FLOP *** [Jd Td 6h]
+zI4bP23YIjMkUHqeN2xfw: checks
Teld4PDKla7C8/Wfu2DSkg: checks
*** TURN *** [Jd Td 6h] [Qs]
+zI4bP23YIjMkUHqeN2xfw: checks
Teld4PDKla7C8/Wfu2DSkg: checks
*** RIVER *** [Jd Td 6h Qs] [Kh]
+zI4bP23YIjMkUHqeN2xfw: bets $1
Teld4PDKla7C8/Wfu2DSkg: folds
+zI4bP23YIjMkUHqeN2xfw collected $1.90 from pot
+zI4bP23YIjMkUHqeN2xfw: doesn't show hand
*** SUMMARY ***
Total pot $2 | Rake $0.10
Board [Jd Td 6h Qs Kh]
Seat 1: Teld4PDKla7C8/Wfu2DSkg (button) (small blind) folded on the River
Seat 2: +zI4bP23YIjMkUHqeN2xfw (big blind) collected ($1.90)



PokerStars Game #59941177054:  Hold'em No Limit ($0.25/$0.50) - 2009/07/01 1:27:50 ET
Table 'GfL/No5u5PoEnU39lP5pQg' 6-max Seat #3 is the button
Seat 1: 1WUCqNG+p+vfWRTXNu4ljw ($61.25 in chips)
Seat 2: uVwggSetzp7d+eVgowO3vg ($50.75 in chips)
Seat 3: 4pp9WxhGdbVbxCc9tlu0lw ($34.55 in chips)
Seat 4: r6u7MWSXF30/khcTYkrG9Q ($26.50 in chips)
Seat 5: M1KyQQvVPVuxqTAB8sR/zQ ($50 in chips)
Seat 6: kxPhs4ePFqMy52CInAJ2aw ($65.25 in chips)
r6u7MWSXF30/khcTYkrG9Q: posts small blind $0.25
M1KyQQvVPVuxqTAB8sR/zQ: posts big blind $0.50
*** HOLE CARDS ***
kxPhs4ePFqMy52CInAJ2aw: folds
1WUCqNG+p+vfWRTXNu4ljw: folds
uVwggSetzp7d+eVgowO3vg: folds
4pp9WxhGdbVbxCc9tlu0lw: folds
r6u7MWSXF30/khcTYkrG9Q: calls $0.25
M1KyQQvVPVuxqTAB8sR/zQ: raises $1.50 to $2
r6u7MWSXF30/khcTYkrG9Q: calls $1.50
*** FLOP *** [Jd 4h 4s]
r6u7MWSXF30/khcTYkrG9Q: checks
M1KyQQvVPVuxqTAB8sR/zQ: bets $2.50
r6u7MWSXF30/khcTYkrG9Q: raises $5 to $7.50
M1KyQQvVPVuxqTAB8sR/zQ: folds
r6u7MWSXF30/khcTYkrG9Q collected $8.60 from pot
*** SUMMARY ***
Total pot $9 | Rake $0.40
Board [Jd 4h 4s]
Seat 1: 1WUCqNG+p+vfWRTXNu4ljw folded before Flop (didn't bet)
Seat 2: uVwggSetzp7d+eVgowO3vg folded before Flop (didn't bet)
Seat 3: 4pp9WxhGdbVbxCc9tlu0lw (button) folded before Flop (didn't bet)
Seat 4: r6u7MWSXF30/khcTYkrG9Q (small blind) collected ($8.60)
Seat 5: M1KyQQvVPVuxqTAB8sR/zQ (big blind) folded on the Flop
Seat 6: kxPhs4ePFqMy52CInAJ2aw folded before Flop (didn't bet)



PokerStars Game #59941177320:  Hold'em No Limit ($0.25/$0.50) - 2009/07/01 1:27:51 ET
Table 'ZYI3ZReBjdfKEYItkZHI6A' 9-max Seat #8 is the button
Seat 1: IYd5zG8k7vdBNVHbHg2Pag ($64.40 in chips)
Seat 2: uw9QayAAxLM3Hb+HR7mSkg ($9.25 in chips)
Seat 4: e2+sK/yjnj94rXOKoxPP2A ($64.40 in chips)
Seat 5: ApHP7ouup365XIUFBdEDxg ($25.20 in chips)
Seat 6: 1xBtrSVBbgFH/viUWKqQeg ($29.45 in chips)
Seat 7: HWcfp1hY1hqvrddzW3/FQw ($12.25 in chips)
Seat 8: ji04uOybxCdpdefzlUQeKQ ($30.55 in chips)
Seat 9: HZkVla4kK2SI42CVrPZ/ig ($9.50 in chips)
HZkVla4kK2SI42CVrPZ/ig: posts small blind $0.25
IYd5zG8k7vdBNVHbHg2Pag: posts big blind $0.50
75K2MXwN65Sjfp1yHd50Hg: sits out
*** HOLE CARDS ***
uw9QayAAxLM3Hb+HR7mSkg: raises $8.75 to $9.25 and is all-in
e2+sK/yjnj94rXOKoxPP2A: folds
ApHP7ouup365XIUFBdEDxg: calls $9.25
1xBtrSVBbgFH/viUWKqQeg has timed out
1xBtrSVBbgFH/viUWKqQeg: folds
1xBtrSVBbgFH/viUWKqQeg is sitting out
HWcfp1hY1hqvrddzW3/FQw: folds
1xBtrSVBbgFH/viUWKqQeg has returned
ji04uOybxCdpdefzlUQeKQ: folds
HZkVla4kK2SI42CVrPZ/ig: folds
IYd5zG8k7vdBNVHbHg2Pag: folds
*** FLOP *** [2c Ts 4d]
*** TURN *** [2c Ts 4d] [4h]
*** RIVER *** [2c Ts 4d 4h] [9c]
*** SHOW DOWN ***
uw9QayAAxLM3Hb+HR7mSkg: shows [Ad Qd] (a pair of Fours)
ApHP7ouup365XIUFBdEDxg: mucks hand
uw9QayAAxLM3Hb+HR7mSkg collected $18.30 from pot
*** SUMMARY ***
Total pot $19.25 | Rake $0.95
Board [2c Ts 4d 4h 9c]
Seat 1: IYd5zG8k7vdBNVHbHg2Pag (big blind) folded before Flop
Seat 2: uw9QayAAxLM3Hb+HR7mSkg showed [Ad Qd] and won ($18.30) with a pair of Fours
Seat 4: e2+sK/yjnj94rXOKoxPP2A folded before Flop (didn't bet)
Seat 5: ApHP7ouup365XIUFBdEDxg mucked
Seat 6: 1xBtrSVBbgFH/viUWKqQeg folded before Flop (didn't bet)
Seat 7: HWcfp1hY1hqvrddzW3/FQw folded before Flop (didn't bet)
Seat 8: ji04uOybxCdpdefzlUQeKQ (button) folded before Flop (didn't bet)
Seat 9: HZkVla4kK2SI42CVrPZ/ig (small blind) folded before Flop



PokerStars Game #59941178334:  Hold'em No Limit ($0.25/$0.50) - 2009/07/01 1:27:53 ET
Table '+z1aekfHkpp09pc8F9aViw' 6-max Seat #2 is the button
Seat 1: /DArfRoYc3YpLsOQSZubFg ($50 in chips)
Seat 2: 4QfsCWthT/vSLirorNXqtg ($50 in chips)
Seat 3: URYNc7fPA23K2UfadQbnCA ($49.50 in chips)
Seat 5: 2igtJLmvIZ+HqX4XPgMPZA ($53.70 in chips)
Seat 6: GUnvMULl2qFOO1yenu1UBw ($50.75 in chips)
URYNc7fPA23K2UfadQbnCA: posts small blind $0.25
2igtJLmvIZ+HqX4XPgMPZA: posts big blind $0.50
*** HOLE CARDS ***
GUnvMULl2qFOO1yenu1UBw: folds
/DArfRoYc3YpLsOQSZubFg: folds
4QfsCWthT/vSLirorNXqtg: folds
URYNc7fPA23K2UfadQbnCA: folds
2igtJLmvIZ+HqX4XPgMPZA collected $0.50 from pot
*** SUMMARY ***
Total pot $0.50 | Rake $0
Seat 1: /DArfRoYc3YpLsOQSZubFg folded before Flop (didn't bet)
Seat 2: 4QfsCWthT/vSLirorNXqtg (button) folded before Flop (didn't bet)
Seat 3: URYNc7fPA23K2UfadQbnCA (small blind) folded before Flop
Seat 5: 2igtJLmvIZ+HqX4XPgMPZA (big blind) collected ($0.50)
Seat 6: GUnvMULl2qFOO1yenu1UBw folded before Flop (didn't bet)



PokerStars Game #59941179392:  Hold'em No Limit ($0.25/$0.50) - 2009/07/01 1:27:55 ET
Table 'fx6MqwfYAj/Rt86hBz2L3Q' 9-max Seat #2 is the button
Seat 1: v/4aX0ejnaIFK4ftDk2Lyg ($51.40 in chips)
Seat 2: C3rGXblctNcWI6JYPHhaEg ($41.60 in chips)
Seat 3: iadBi5AEt7gTBXbDSSnMYQ ($36.80 in chips)
Seat 5: iAISe3dVeua8PUn2wwgDHw ($78.15 in chips)
Seat 6: 5k9fvXD9suIgCxU4HLQjTw ($50 in chips)
Seat 8: JYwJYYV9pM5KWdSiETl8rA ($63 in chips)
Seat 9: vO3QVRovWemcGMkm7ijAIA ($11.50 in chips)
iadBi5AEt7gTBXbDSSnMYQ: posts small blind $0.25
iAISe3dVeua8PUn2wwgDHw: posts big blind $0.50
mSD1pginDsyHG5PDfqzphw: sits out
*** HOLE CARDS ***
5k9fvXD9suIgCxU4HLQjTw: folds
JYwJYYV9pM5KWdSiETl8rA: folds
vO3QVRovWemcGMkm7ijAIA: raises $1 to $1.50
v/4aX0ejnaIFK4ftDk2Lyg: folds
C3rGXblctNcWI6JYPHhaEg: calls $1.50
iadBi5AEt7gTBXbDSSnMYQ: folds
iAISe3dVeua8PUn2wwgDHw: calls $1
*** FLOP *** [6h Ac Kd]
iAISe3dVeua8PUn2wwgDHw: checks
vO3QVRovWemcGMkm7ijAIA: bets $2
C3rGXblctNcWI6JYPHhaEg: calls $2
iAISe3dVeua8PUn2wwgDHw: calls $2
*** TURN *** [6h Ac Kd] [Js]
iAISe3dVeua8PUn2wwgDHw: checks
vO3QVRovWemcGMkm7ijAIA: bets $2
C3rGXblctNcWI6JYPHhaEg: calls $2
iAISe3dVeua8PUn2wwgDHw: calls $2
*** RIVER *** [6h Ac Kd Js] [6d]
iAISe3dVeua8PUn2wwgDHw: checks
vO3QVRovWemcGMkm7ijAIA: bets $2
C3rGXblctNcWI6JYPHhaEg: calls $2
iAISe3dVeua8PUn2wwgDHw: calls $2
*** SHOW DOWN ***
vO3QVRovWemcGMkm7ijAIA: shows [Ah Jh] (two pair, Aces and Jacks)
C3rGXblctNcWI6JYPHhaEg: mucks hand
iAISe3dVeua8PUn2wwgDHw: mucks hand
vO3QVRovWemcGMkm7ijAIA collected $21.70 from pot
*** SUMMARY ***
Total pot $22.75 | Rake $1.05
Board [6h Ac Kd Js 6d]
Seat 1: v/4aX0ejnaIFK4ftDk2Lyg folded before Flop (didn't bet)
Seat 2: C3rGXblctNcWI6JYPHhaEg (button) mucked
Seat 3: iadBi5AEt7gTBXbDSSnMYQ (small blind) folded before Flop
Seat 5: iAISe3dVeua8PUn2wwgDHw (big blind) mucked
Seat 6: 5k9fvXD9suIgCxU4HLQjTw folded before Flop (didn't bet)
Seat 8: JYwJYYV9pM5KWdSiETl8rA folded before Flop (didn't bet)
Seat 9: vO3QVRovWemcGMkm7ijAIA showed [Ah Jh] and won ($21.70) with two pair, Aces and Jacks



PokerStars Game #59941181190:  Hold'em No Limit ($0.25/$0.50) - 2009/07/01 1:27:58 ET
Table 'tyR5AZNKV8Aadbrnrnlg7g' 6-max Seat #1 is the button
Seat 1: BgOXYI0yYSN1ULC4FqsNkg ($91.30 in chips)
Seat 2: BAjwVL+zKKd0s0fAWstzQQ ($14.20 in chips)
Seat 3: JFLrYNyQmwPhRQAtoSAuyA ($49.40 in chips)
Seat 4: 4QfsCWthT/vSLirorNXqtg ($85.95 in chips)
Seat 5: GUnvMULl2qFOO1yenu1UBw ($78.75 in chips)
Seat 6: 498aWaGsW4uGfuWl+2FCGw ($65.80 in chips)
BAjwVL+zKKd0s0fAWstzQQ: posts small blind $0.25
JFLrYNyQmwPhRQAtoSAuyA: posts big blind $0.50
*** HOLE CARDS ***
4QfsCWthT/vSLirorNXqtg: folds
GUnvMULl2qFOO1yenu1UBw: folds
498aWaGsW4uGfuWl+2FCGw: raises $1 to $1.50
BgOXYI0yYSN1ULC4FqsNkg: folds
BAjwVL+zKKd0s0fAWstzQQ: folds
JFLrYNyQmwPhRQAtoSAuyA: folds
498aWaGsW4uGfuWl+2FCGw collected $1.25 from pot
498aWaGsW4uGfuWl+2FCGw: doesn't show hand
*** SUMMARY ***
Total pot $1.25 | Rake $0
Seat 1: BgOXYI0yYSN1ULC4FqsNkg (button) folded before Flop (didn't bet)
Seat 2: BAjwVL+zKKd0s0fAWstzQQ (small blind) folded before Flop
Seat 3: JFLrYNyQmwPhRQAtoSAuyA (big blind) folded before Flop
Seat 4: 4QfsCWthT/vSLirorNXqtg folded before Flop (didn't bet)
Seat 5: GUnvMULl2qFOO1yenu1UBw folded before Flop (didn't bet)
Seat 6: 498aWaGsW4uGfuWl+2FCGw collected ($1.25)



PokerStars Game #59941181168:  Hold'em No Limit ($0.25/$0.50) - 2009/07/01 1:27:58 ET
Table '2lPOwetm4cfkZPbTmGPH/w' 2-max Seat #2 is the button
Seat 1: vUGdApqS8J/GJE2gaVWl1w ($12.40 in chips)
Seat 2: XFa6sBGjP2gxoIvxR3fZIg ($30.60 in chips)
XFa6sBGjP2gxoIvxR3fZIg: posts small blind $0.25
vUGdApqS8J/GJE2gaVWl1w: posts big blind $0.50
*** HOLE CARDS ***
XFa6sBGjP2gxoIvxR3fZIg: raises $1 to $1.50
vUGdApqS8J/GJE2gaVWl1w: calls $1
*** FLOP *** [Ks 3h Jh]
vUGdApqS8J/GJE2gaVWl1w: checks
XFa6sBGjP2gxoIvxR3fZIg: checks
*** TURN *** [Ks 3h Jh] [Tc]
vUGdApqS8J/GJE2gaVWl1w: bets $1.50
XFa6sBGjP2gxoIvxR3fZIg: calls $1.50
*** RIVER *** [Ks 3h Jh Tc] [Ts]
vUGdApqS8J/GJE2gaVWl1w: bets $1
XFa6sBGjP2gxoIvxR3fZIg: raises $14 to $15
vUGdApqS8J/GJE2gaVWl1w: folds
XFa6sBGjP2gxoIvxR3fZIg collected $7.65 from pot
XFa6sBGjP2gxoIvxR3fZIg: doesn't show hand
*** SUMMARY ***
Total pot $8 | Rake $0.35
Board [Ks 3h Jh Tc Ts]
Seat 1: vUGdApqS8J/GJE2gaVWl1w (big blind) folded on the River
Seat 2: XFa6sBGjP2gxoIvxR3fZIg (button) (small blind) collected ($7.65)



PokerStars Game #59941181736:  Hold'em No Limit ($0.25/$0.50) - 2009/07/01 1:27:59 ET
Table '8BQGgNetI1NOvWeu3gtMNw' 2-max Seat #2 is the button
Seat 1: bypIyrYcAAifLfhZpGlKLA ($60.50 in chips)
Seat 2: Z4HwehErEwzsv/noQlfUlg ($157.95 in chips)
Z4HwehErEwzsv/noQlfUlg: posts small blind $0.25
bypIyrYcAAifLfhZpGlKLA: posts big blind $0.50
*** HOLE CARDS ***
Z4HwehErEwzsv/noQlfUlg: calls $0.25
bypIyrYcAAifLfhZpGlKLA: checks
*** FLOP *** [7h Qh Ah]
bypIyrYcAAifLfhZpGlKLA: bets $1
Z4HwehErEwzsv/noQlfUlg: calls $1
*** TURN *** [7h Qh Ah] [2h]
bypIyrYcAAifLfhZpGlKLA: checks
Z4HwehErEwzsv/noQlfUlg: bets $2.50
bypIyrYcAAifLfhZpGlKLA: calls $2.50
*** RIVER *** [7h Qh Ah 2h] [Td]
bypIyrYcAAifLfhZpGlKLA: checks
Z4HwehErEwzsv/noQlfUlg: checks
*** SHOW DOWN ***
bypIyrYcAAifLfhZpGlKLA: shows [Js 8h] (a flush, Ace high)
Z4HwehErEwzsv/noQlfUlg: mucks hand
bypIyrYcAAifLfhZpGlKLA collected $7.65 from pot
*** SUMMARY ***
Total pot $8 | Rake $0.35
Board [7h Qh Ah 2h Td]
Seat 1: bypIyrYcAAifLfhZpGlKLA (big blind) showed [Js 8h] and won ($7.65) with a flush, Ace high
Seat 2: Z4HwehErEwzsv/noQlfUlg (button) (small blind) mucked



PokerStars Game #59941181674:  Hold'em No Limit ($0.25/$0.50) - 2009/07/01 1:27:59 ET
Table 'B+sqsfj6d6zXicNfaseTaw' 2-max Seat #1 is the button
Seat 1: +4GNcSsecmapVGSdV0mUPA ($132.45 in chips)
Seat 2: Lv5RmpRe6LtPkBzM9Gpo5A ($93.25 in chips)
+4GNcSsecmapVGSdV0mUPA: posts small blind $0.25
Lv5RmpRe6LtPkBzM9Gpo5A: posts big blind $0.50
*** HOLE CARDS ***
+4GNcSsecmapVGSdV0mUPA: calls $0.25
Lv5RmpRe6LtPkBzM9Gpo5A: checks
*** FLOP *** [5s Kc 5c]
Lv5RmpRe6LtPkBzM9Gpo5A: checks
+4GNcSsecmapVGSdV0mUPA: checks
*** TURN *** [5s Kc 5c] [2c]
Lv5RmpRe6LtPkBzM9Gpo5A: checks
+4GNcSsecmapVGSdV0mUPA: checks
*** RIVER *** [5s Kc 5c 2c] [As]
Lv5RmpRe6LtPkBzM9Gpo5A: checks
+4GNcSsecmapVGSdV0mUPA: checks
*** SHOW DOWN ***
Lv5RmpRe6LtPkBzM9Gpo5A: shows [9h 3d] (a pair of Fives)
+4GNcSsecmapVGSdV0mUPA: shows [9c Th] (a pair of Fives - Ace+King+Ten kicker)
+4GNcSsecmapVGSdV0mUPA collected $0.95 from pot
*** SUMMARY ***
Total pot $1 | Rake $0.05
Board [5s Kc 5c 2c As]
Seat 1: +4GNcSsecmapVGSdV0mUPA (button) (small blind) showed [9c Th] and won ($0.95) with a pair of Fives
Seat 2: Lv5RmpRe6LtPkBzM9Gpo5A (big blind) showed [9h 3d] and lost with a pair of Fives



PokerStars Game #59941182384:  Hold'em No Limit ($0.25/$0.50) - 2009/07/01 1:28:00 ET
Table '9ojijpRcYQSQTh6xI+haUA' 2-max Seat #1 is the button
Seat 1: FqpibuVWLNsAN/Z7ROZLnA ($50 in chips)
Seat 2: TitTV+fFCcBZWOERdytydA ($36.75 in chips)
FqpibuVWLNsAN/Z7ROZLnA: posts small blind $0.25
TitTV+fFCcBZWOERdytydA: posts big blind $0.50
*** HOLE CARDS ***
FqpibuVWLNsAN/Z7ROZLnA: raises $1 to $1.50
TitTV+fFCcBZWOERdytydA: folds
FqpibuVWLNsAN/Z7ROZLnA collected $1 from pot
*** SUMMARY ***
Total pot $1 | Rake $0
Seat 1: FqpibuVWLNsAN/Z7ROZLnA (button) (small blind) collected ($1)
Seat 2: TitTV+fFCcBZWOERdytydA (big blind) folded before Flop



PokerStars Game #59941182604:  Hold'em No Limit ($0.25/$0.50) - 2009/07/01 1:28:00 ET
Table 'Nz0Vr7WMHL2g5Uk7dDZjpw' 9-max Seat #7 is the button
Seat 3: hoglu9inkgs6zN573/bJag ($5.70 in chips)
Seat 4: E2518gp4aFz1+kAgmGqeEg ($12.25 in chips)
Seat 5: WGW0DgjBUXs1ylURHG8vnQ ($12.90 in chips)
Seat 6: 997ViqAtWn1FPjJqcffwcA ($57.30 in chips)
Seat 7: KPLH0gELgFe2OuAnhJFI5w ($24.70 in chips)
Seat 8: aoL+R/61Kxmw69ypuPrWAQ ($31.15 in chips)
Seat 9: mSD1pginDsyHG5PDfqzphw ($10 in chips)
aoL+R/61Kxmw69ypuPrWAQ: posts small blind $0.25
mSD1pginDsyHG5PDfqzphw: posts big blind $0.50
9yMsdgReyOUerNsmTYCCDQ: sits out
SegjDnMxWMujiD57ESNL+g: sits out
*** HOLE CARDS ***
hoglu9inkgs6zN573/bJag: folds
E2518gp4aFz1+kAgmGqeEg: folds
WGW0DgjBUXs1ylURHG8vnQ: calls $0.50
997ViqAtWn1FPjJqcffwcA: raises $2 to $2.50
KPLH0gELgFe2OuAnhJFI5w: folds
aoL+R/61Kxmw69ypuPrWAQ: folds
mSD1pginDsyHG5PDfqzphw: raises $7.50 to $10 and is all-in
WGW0DgjBUXs1ylURHG8vnQ: folds
997ViqAtWn1FPjJqcffwcA: calls $7.50
*** FLOP *** [6s 9c 6h]
*** TURN *** [6s 9c 6h] [5s]
*** RIVER *** [6s 9c 6h 5s] [5d]
*** SHOW DOWN ***
mSD1pginDsyHG5PDfqzphw: shows [As Ac] (two pair, Aces and Sixes)
997ViqAtWn1FPjJqcffwcA: mucks hand
mSD1pginDsyHG5PDfqzphw collected $19.75 from pot
*** SUMMARY ***
Total pot $20.75 | Rake $1
Board [6s 9c 6h 5s 5d]
Seat 3: hoglu9inkgs6zN573/bJag folded before Flop (didn't bet)
Seat 4: E2518gp4aFz1+kAgmGqeEg folded before Flop (didn't bet)
Seat 5: WGW0DgjBUXs1ylURHG8vnQ folded before Flop
Seat 6: 997ViqAtWn1FPjJqcffwcA mucked
Seat 7: KPLH0gELgFe2OuAnhJFI5w (button) folded before Flop (didn't bet)
Seat 8: aoL+R/61Kxmw69ypuPrWAQ (small blind) folded before Flop
Seat 9: mSD1pginDsyHG5PDfqzphw (big blind) showed [As Ac] and won ($19.75) with two pair, Aces and Sixes



PokerStars Game #59941183650:  Hold'em No Limit ($0.25/$0.50) - 2009/07/01 1:28:02 ET
Table 'lSisgp6H7Fg1hH5VfjEjYQ' 9-max Seat #5 is the button
Seat 1: 5k9fvXD9suIgCxU4HLQjTw ($53.35 in chips)
Seat 3: SKnJuWHScqetA/qG5p+wCg ($30 in chips)
Seat 4: bwv/rbH/hHhPhY6u9mu04w ($37.40 in chips)
Seat 5: mSD1pginDsyHG5PDfqzphw ($12.25 in chips)
Seat 6: +k7T5ocke8UwavtgUHm+Cg ($70.65 in chips)
Seat 7: IDtNLR9uFCDdjNsJWMHA5Q ($20.15 in chips)
Seat 8: a4JDWmpFQkL10XfAyuF51A ($12.25 in chips)
Seat 9: YzeKFbJVLmJGTgNH3ySQlw ($9.20 in chips)
+k7T5ocke8UwavtgUHm+Cg: posts small blind $0.25
IDtNLR9uFCDdjNsJWMHA5Q: posts big blind $0.50
5acK4E7fzEwnplVBZ6eNWA: sits out
*** HOLE CARDS ***
a4JDWmpFQkL10XfAyuF51A: folds
YzeKFbJVLmJGTgNH3ySQlw: folds
5k9fvXD9suIgCxU4HLQjTw: folds
SKnJuWHScqetA/qG5p+wCg: folds
bwv/rbH/hHhPhY6u9mu04w: folds
mSD1pginDsyHG5PDfqzphw: folds
+k7T5ocke8UwavtgUHm+Cg: calls $0.25
IDtNLR9uFCDdjNsJWMHA5Q: checks
*** FLOP *** [8s Ac 2c]
+k7T5ocke8UwavtgUHm+Cg: checks
IDtNLR9uFCDdjNsJWMHA5Q: checks
*** TURN *** [8s Ac 2c] [Td]
+k7T5ocke8UwavtgUHm+Cg: checks
IDtNLR9uFCDdjNsJWMHA5Q: checks
*** RIVER *** [8s Ac 2c Td] [5s]
+k7T5ocke8UwavtgUHm+Cg: checks
IDtNLR9uFCDdjNsJWMHA5Q: bets $0.50
+k7T5ocke8UwavtgUHm+Cg: folds
IDtNLR9uFCDdjNsJWMHA5Q collected $0.95 from pot
*** SUMMARY ***
Total pot $1 | Rake $0.05
Board [8s Ac 2c Td 5s]
Seat 1: 5k9fvXD9suIgCxU4HLQjTw folded before Flop (didn't bet)
Seat 3: SKnJuWHScqetA/qG5p+wCg folded before Flop (didn't bet)
Seat 4: bwv/rbH/hHhPhY6u9mu04w folded before Flop (didn't bet)
Seat 5: mSD1pginDsyHG5PDfqzphw (button) folded before Flop (didn't bet)
Seat 6: +k7T5ocke8UwavtgUHm+Cg (small blind) folded on the River
Seat 7: IDtNLR9uFCDdjNsJWMHA5Q (big blind) collected ($0.95)
Seat 8: a4JDWmpFQkL10XfAyuF51A folded before Flop (didn't bet)
Seat 9: YzeKFbJVLmJGTgNH3ySQlw folded before Flop (didn't bet)



PokerStars Game #59941184352:  Hold'em No Limit ($0.25/$0.50) - 2009/07/01 1:28:03 ET
Table 'X6IRCRTh+20gjz8aubWnwA' 9-max Seat #1 is the button
Seat 1: E2518gp4aFz1+kAgmGqeEg ($10.75 in chips)
Seat 2: HZkVla4kK2SI42CVrPZ/ig ($10 in chips)
Seat 3: SWv01peOe69QQRvhQTqjQw ($12.80 in chips)
Seat 4: M3JFBNQ8Bbw3FBZ/18MuXw ($31.65 in chips)
Seat 5: uw9QayAAxLM3Hb+HR7mSkg ($18.30 in chips)
Seat 6: Qi/PyOsKwaqtKIg0H+7ELg ($7.75 in chips)
Seat 7: +RUz0sVA09ZE8PNpIl+EBQ ($29.50 in chips)
Seat 8: HxeBVq06/3Bh/H986sgdbw ($45 in chips)
Seat 9: M+7+BTmX5vZatHVuoRB1nA ($57.15 in chips)
HZkVla4kK2SI42CVrPZ/ig: posts small blind $0.25
SWv01peOe69QQRvhQTqjQw: posts big blind $0.50
*** HOLE CARDS ***
M3JFBNQ8Bbw3FBZ/18MuXw: folds
uw9QayAAxLM3Hb+HR7mSkg: folds
Qi/PyOsKwaqtKIg0H+7ELg: folds
+RUz0sVA09ZE8PNpIl+EBQ: calls $0.50
HxeBVq06/3Bh/H986sgdbw: calls $0.50
M+7+BTmX5vZatHVuoRB1nA: folds
E2518gp4aFz1+kAgmGqeEg: raises $10.25 to $10.75 and is all-in
HZkVla4kK2SI42CVrPZ/ig: folds
SWv01peOe69QQRvhQTqjQw: folds
+RUz0sVA09ZE8PNpIl+EBQ: folds
HxeBVq06/3Bh/H986sgdbw: folds
E2518gp4aFz1+kAgmGqeEg collected $2.25 from pot
E2518gp4aFz1+kAgmGqeEg is sitting out
E2518gp4aFz1+kAgmGqeEg: doesn't show hand
*** SUMMARY ***
Total pot $2.25 | Rake $0
Seat 1: E2518gp4aFz1+kAgmGqeEg (button) collected ($2.25)
Seat 2: HZkVla4kK2SI42CVrPZ/ig (small blind) folded before Flop
Seat 3: SWv01peOe69QQRvhQTqjQw (big blind) folded before Flop
Seat 4: M3JFBNQ8Bbw3FBZ/18MuXw folded before Flop (didn't bet)
Seat 5: uw9QayAAxLM3Hb+HR7mSkg folded before Flop (didn't bet)
Seat 6: Qi/PyOsKwaqtKIg0H+7ELg folded before Flop (didn't bet)
Seat 7: +RUz0sVA09ZE8PNpIl+EBQ folded before Flop
Seat 8: HxeBVq06/3Bh/H986sgdbw folded before Flop
Seat 9: M+7+BTmX5vZatHVuoRB1nA folded before Flop (didn't bet)



PokerStars Game #59941185430:  Hold'em No Limit ($0.25/$0.50) - 2009/07/01 1:28:05 ET
Table 'kgbJRsxfv64KrErDRBAkcw' 6-max Seat #2 is the button
Seat 1: VamsyhlFzXGF6/ydo0BHeA ($9.55 in chips)
Seat 2: AdS8BJMOheS01zjCDfPMFg ($64.50 in chips)
Seat 3: c4MNIaIyPMOMxrgT8FT5nA ($229.20 in chips)
Seat 4: 2igtJLmvIZ+HqX4XPgMPZA ($59.80 in chips)
Seat 5: eUBBn2R56C1IQ6Cs/vitwg ($55.20 in chips)
Seat 6: 1b+2BbjMN8qhR1WPqdE9VQ ($55.90 in chips)
c4MNIaIyPMOMxrgT8FT5nA: posts small blind $0.25
2igtJLmvIZ+HqX4XPgMPZA: posts big blind $0.50
*** HOLE CARDS ***
eUBBn2R56C1IQ6Cs/vitwg: folds
1b+2BbjMN8qhR1WPqdE9VQ: folds
VamsyhlFzXGF6/ydo0BHeA: calls $0.50
AdS8BJMOheS01zjCDfPMFg: raises $1 to $1.50
c4MNIaIyPMOMxrgT8FT5nA: folds
2igtJLmvIZ+HqX4XPgMPZA: folds
VamsyhlFzXGF6/ydo0BHeA: calls $1
*** FLOP *** [9c Js 2s]
VamsyhlFzXGF6/ydo0BHeA: checks
AdS8BJMOheS01zjCDfPMFg: checks
*** TURN *** [9c Js 2s] [7h]
VamsyhlFzXGF6/ydo0BHeA: checks
AdS8BJMOheS01zjCDfPMFg: checks
*** RIVER *** [9c Js 2s 7h] [8d]
VamsyhlFzXGF6/ydo0BHeA: bets $3
AdS8BJMOheS01zjCDfPMFg: folds
VamsyhlFzXGF6/ydo0BHeA collected $3.60 from pot
VamsyhlFzXGF6/ydo0BHeA: doesn't show hand
*** SUMMARY ***
Total pot $3.75 | Rake $0.15
Board [9c Js 2s 7h 8d]
Seat 1: VamsyhlFzXGF6/ydo0BHeA collected ($3.60)
Seat 2: AdS8BJMOheS01zjCDfPMFg (button) folded on the River
Seat 3: c4MNIaIyPMOMxrgT8FT5nA (small blind) folded before Flop
Seat 4: 2igtJLmvIZ+HqX4XPgMPZA (big blind) folded before Flop
Seat 5: eUBBn2R56C1IQ6Cs/vitwg folded before Flop (didn't bet)
Seat 6: 1b+2BbjMN8qhR1WPqdE9VQ folded before Flop (didn't bet)



PokerStars Game #59941187554:  Hold'em No Limit ($0.25/$0.50) - 2009/07/01 1:28:09 ET
Table '+dXkOAQyS8j9PQZusUTMpg' 2-max Seat #2 is the button
Seat 1: Teld4PDKla7C8/Wfu2DSkg ($53.65 in chips)
Seat 2: +zI4bP23YIjMkUHqeN2xfw ($23.55 in chips)
+zI4bP23YIjMkUHqeN2xfw: posts small blind $0.25
Teld4PDKla7C8/Wfu2DSkg: posts big blind $0.50
*** HOLE CARDS ***
+zI4bP23YIjMkUHqeN2xfw: calls $0.25
Teld4PDKla7C8/Wfu2DSkg: checks
*** FLOP *** [6h Qs Ad]
Teld4PDKla7C8/Wfu2DSkg: bets $0.50
+zI4bP23YIjMkUHqeN2xfw: folds
Teld4PDKla7C8/Wfu2DSkg collected $0.95 from pot
Teld4PDKla7C8/Wfu2DSkg: doesn't show hand
*** SUMMARY ***
Total pot $1 | Rake $0.05
Board [6h Qs Ad]
Seat 1: Teld4PDKla7C8/Wfu2DSkg (big blind) collected ($0.95)
Seat 2: +zI4bP23YIjMkUHqeN2xfw (button) (small blind) folded on the Flop



PokerStars Game #59941189018:  Hold'em No Limit ($0.25/$0.50) - 2009/07/01 1:28:11 ET
Table 'ibNfFy0bCzuBaUORla0aGw' 9-max Seat #4 is the button
Seat 1: xZCXQSXlrZkp3pZizzVXCw ($49.80 in chips)
Seat 2: 90Wb75h3W1BRpbqVnuk8gw ($50 in chips)
Seat 3: AjV5McH1KMMclY26QdLM5w ($25 in chips)
Seat 4: nhDtFZ2uuvm5hDKG7ZVEpA ($49.25 in chips)
Seat 5: GIJAc9kPrLZHLSX8Q6i99w ($34.40 in chips)
Seat 6: H8cPaCtX7d6meGUVSM5sxw ($58.60 in chips)
Seat 7: HZkVla4kK2SI42CVrPZ/ig ($15.85 in chips)
Seat 8: Ja2jdidjip2UeJnRzmzAAQ ($47 in chips)
Seat 9: pFtzb1sR4b0d1aw6aIRgDg ($56.15 in chips)
GIJAc9kPrLZHLSX8Q6i99w: posts small blind $0.25
H8cPaCtX7d6meGUVSM5sxw: posts big blind $0.50
*** HOLE CARDS ***
HZkVla4kK2SI42CVrPZ/ig: folds
Ja2jdidjip2UeJnRzmzAAQ: folds
pFtzb1sR4b0d1aw6aIRgDg: folds
xZCXQSXlrZkp3pZizzVXCw: raises $1 to $1.50
90Wb75h3W1BRpbqVnuk8gw: folds
AjV5McH1KMMclY26QdLM5w: folds
nhDtFZ2uuvm5hDKG7ZVEpA: folds
GIJAc9kPrLZHLSX8Q6i99w: calls $1.25
H8cPaCtX7d6meGUVSM5sxw: folds
*** FLOP *** [Th 3h 9c]
GIJAc9kPrLZHLSX8Q6i99w: checks
xZCXQSXlrZkp3pZizzVXCw: checks
*** TURN *** [Th 3h 9c] [7c]
GIJAc9kPrLZHLSX8Q6i99w: checks
xZCXQSXlrZkp3pZizzVXCw: checks
*** RIVER *** [Th 3h 9c 7c] [7h]
GIJAc9kPrLZHLSX8Q6i99w: checks
xZCXQSXlrZkp3pZizzVXCw: checks
*** SHOW DOWN ***
GIJAc9kPrLZHLSX8Q6i99w: shows [4s 4d] (two pair, Sevens and Fours)
xZCXQSXlrZkp3pZizzVXCw: mucks hand
GIJAc9kPrLZHLSX8Q6i99w collected $3.35 from pot
*** SUMMARY ***
Total pot $3.50 | Rake $0.15
Board [Th 3h 9c 7c 7h]
Seat 1: xZCXQSXlrZkp3pZizzVXCw mucked
Seat 2: 90Wb75h3W1BRpbqVnuk8gw folded before Flop (didn't bet)
Seat 3: AjV5McH1KMMclY26QdLM5w folded before Flop (didn't bet)
Seat 4: nhDtFZ2uuvm5hDKG7ZVEpA (button) folded before Flop (didn't bet)
Seat 5: GIJAc9kPrLZHLSX8Q6i99w (small blind) showed [4s 4d] and won ($3.35) with two pair, Sevens and Fours
Seat 6: H8cPaCtX7d6meGUVSM5sxw (big blind) folded before Flop
Seat 7: HZkVla4kK2SI42CVrPZ/ig folded before Flop (didn't bet)
Seat 8: Ja2jdidjip2UeJnRzmzAAQ folded before Flop (didn't bet)
Seat 9: pFtzb1sR4b0d1aw6aIRgDg folded before Flop (didn't bet)



PokerStars Game #59941189268:  Hold'em No Limit ($0.25/$0.50) - 2009/07/01 1:28:12 ET
Table '9ojijpRcYQSQTh6xI+haUA' 2-max Seat #2 is the button
Seat 1: FqpibuVWLNsAN/Z7ROZLnA ($50.50 in chips)
Seat 2: TitTV+fFCcBZWOERdytydA ($36.25 in chips)
TitTV+fFCcBZWOERdytydA: posts small blind $0.25
FqpibuVWLNsAN/Z7ROZLnA: posts big blind $0.50
*** HOLE CARDS ***
TitTV+fFCcBZWOERdytydA: raises $1 to $1.50
FqpibuVWLNsAN/Z7ROZLnA: folds
TitTV+fFCcBZWOERdytydA collected $1 from pot
TitTV+fFCcBZWOERdytydA: doesn't show hand
*** SUMMARY ***
Total pot $1 | Rake $0
Seat 1: FqpibuVWLNsAN/Z7ROZLnA (big blind) folded before Flop
Seat 2: TitTV+fFCcBZWOERdytydA (button) (small blind) collected ($1)



PokerStars Game #59941190514:  Hold'em No Limit ($0.25/$0.50) - 2009/07/01 1:28:14 ET
Table 'B+sqsfj6d6zXicNfaseTaw' 2-max Seat #2 is the button
Seat 1: +4GNcSsecmapVGSdV0mUPA ($132.90 in chips)
Seat 2: Lv5RmpRe6LtPkBzM9Gpo5A ($92.75 in chips)
Lv5RmpRe6LtPkBzM9Gpo5A: posts small blind $0.25
+4GNcSsecmapVGSdV0mUPA: posts big blind $0.50
*** HOLE CARDS ***
Lv5RmpRe6LtPkBzM9Gpo5A: calls $0.25
+4GNcSsecmapVGSdV0mUPA: checks
*** FLOP *** [Jc 7h 4s]
+4GNcSsecmapVGSdV0mUPA: checks
Lv5RmpRe6LtPkBzM9Gpo5A: bets $1
+4GNcSsecmapVGSdV0mUPA: folds
Lv5RmpRe6LtPkBzM9Gpo5A collected $0.95 from pot
*** SUMMARY ***
Total pot $1 | Rake $0.05
Board [Jc 7h 4s]
Seat 1: +4GNcSsecmapVGSdV0mUPA (big blind) folded on the Flop
Seat 2: Lv5RmpRe6LtPkBzM9Gpo5A (button) (small blind) collected ($0.95)



PokerStars Game #59941193638:  Hold'em No Limit ($0.25/$0.50) - 2009/07/01 1:28:20 ET
Table 'tyR5AZNKV8Aadbrnrnlg7g' 6-max Seat #2 is the button
Seat 1: BgOXYI0yYSN1ULC4FqsNkg ($91.30 in chips)
Seat 2: BAjwVL+zKKd0s0fAWstzQQ ($13.95 in chips)
Seat 3: JFLrYNyQmwPhRQAtoSAuyA ($48.90 in chips)
Seat 4: 4QfsCWthT/vSLirorNXqtg ($85.95 in chips)
Seat 5: GUnvMULl2qFOO1yenu1UBw ($78.75 in chips)
Seat 6: 498aWaGsW4uGfuWl+2FCGw ($66.55 in chips)
JFLrYNyQmwPhRQAtoSAuyA: posts small blind $0.25
4QfsCWthT/vSLirorNXqtg: posts big blind $0.50
*** HOLE CARDS ***
GUnvMULl2qFOO1yenu1UBw: folds
498aWaGsW4uGfuWl+2FCGw: calls $0.50
BgOXYI0yYSN1ULC4FqsNkg: folds
BAjwVL+zKKd0s0fAWstzQQ: folds
JFLrYNyQmwPhRQAtoSAuyA: raises $2 to $2.50
4QfsCWthT/vSLirorNXqtg: folds
498aWaGsW4uGfuWl+2FCGw: folds
JFLrYNyQmwPhRQAtoSAuyA collected $1.50 from pot
JFLrYNyQmwPhRQAtoSAuyA: doesn't show hand
*** SUMMARY ***
Total pot $1.50 | Rake $0
Seat 1: BgOXYI0yYSN1ULC4FqsNkg folded before Flop (didn't bet)
Seat 2: BAjwVL+zKKd0s0fAWstzQQ (button) folded before Flop (didn't bet)
Seat 3: JFLrYNyQmwPhRQAtoSAuyA (small blind) collected ($1.50)
Seat 4: 4QfsCWthT/vSLirorNXqtg (big blind) folded before Flop
Seat 5: GUnvMULl2qFOO1yenu1UBw folded before Flop (didn't bet)
Seat 6: 498aWaGsW4uGfuWl+2FCGw folded before Flop



PokerStars Game #59941194276:  Hold'em No Limit ($0.25/$0.50) - 2009/07/01 1:28:21 ET
Table '+dXkOAQyS8j9PQZusUTMpg' 2-max Seat #1 is the button
Seat 1: Teld4PDKla7C8/Wfu2DSkg ($54.10 in chips)
Seat 2: +zI4bP23YIjMkUHqeN2xfw ($23.05 in chips)
Teld4PDKla7C8/Wfu2DSkg: posts small blind $0.25
+zI4bP23YIjMkUHqeN2xfw: posts big blind $0.50
*** HOLE CARDS ***
Teld4PDKla7C8/Wfu2DSkg: raises $0.50 to $1
+zI4bP23YIjMkUHqeN2xfw: calls $0.50
*** FLOP *** [5s 5d 3s]
+zI4bP23YIjMkUHqeN2xfw: checks
Teld4PDKla7C8/Wfu2DSkg: bets $1
+zI4bP23YIjMkUHqeN2xfw: calls $1
*** TURN *** [5s 5d 3s] [Jc]
+zI4bP23YIjMkUHqeN2xfw: checks
Teld4PDKla7C8/Wfu2DSkg: checks
*** RIVER *** [5s 5d 3s Jc] [7d]
+zI4bP23YIjMkUHqeN2xfw: bets $1
Teld4PDKla7C8/Wfu2DSkg: calls $1
*** SHOW DOWN ***
+zI4bP23YIjMkUHqeN2xfw: shows [5h Jh] (a full house, Fives full of Jacks)
Teld4PDKla7C8/Wfu2DSkg: mucks hand
+zI4bP23YIjMkUHqeN2xfw collected $5.75 from pot
*** SUMMARY ***
Total pot $6 | Rake $0.25
Board [5s 5d 3s Jc 7d]
Seat 1: Teld4PDKla7C8/Wfu2DSkg (button) (small blind) mucked
Seat 2: +zI4bP23YIjMkUHqeN2xfw (big blind) showed [5h Jh] and won ($5.75) with a full house, Fives full of Jacks



PokerStars Game #59941195110:  Hold'em No Limit ($0.25/$0.50) - 2009/07/01 1:28:22 ET
Table '9ojijpRcYQSQTh6xI+haUA' 2-max Seat #1 is the button
Seat 1: FqpibuVWLNsAN/Z7ROZLnA ($50 in chips)
Seat 2: TitTV+fFCcBZWOERdytydA ($36.75 in chips)
FqpibuVWLNsAN/Z7ROZLnA: posts small blind $0.25
TitTV+fFCcBZWOERdytydA: posts big blind $0.50
*** HOLE CARDS ***
FqpibuVWLNsAN/Z7ROZLnA: calls $0.25
TitTV+fFCcBZWOERdytydA: checks
*** FLOP *** [7s 5d 9c]
TitTV+fFCcBZWOERdytydA: checks
FqpibuVWLNsAN/Z7ROZLnA: bets $1
TitTV+fFCcBZWOERdytydA: calls $1
*** TURN *** [7s 5d 9c] [6s]
TitTV+fFCcBZWOERdytydA: checks
FqpibuVWLNsAN/Z7ROZLnA: checks
*** RIVER *** [7s 5d 9c 6s] [Ts]
TitTV+fFCcBZWOERdytydA: bets $2.50
FqpibuVWLNsAN/Z7ROZLnA: calls $2.50
*** SHOW DOWN ***
TitTV+fFCcBZWOERdytydA: shows [Ks Js] (a flush, King high)
FqpibuVWLNsAN/Z7ROZLnA: mucks hand
TitTV+fFCcBZWOERdytydA collected $7.65 from pot
*** SUMMARY ***
Total pot $8 | Rake $0.35
Board [7s 5d 9c 6s Ts]
Seat 1: FqpibuVWLNsAN/Z7ROZLnA (button) (small blind) mucked
Seat 2: TitTV+fFCcBZWOERdytydA (big blind) showed [Ks Js] and won ($7.65) with a flush, King high



PokerStars Game #59941197666:  Hold'em No Limit ($0.25/$0.50) - 2009/07/01 1:28:26 ET
Table 'hSTs/dUsYLgJQuF2Onp0MQ' 6-max Seat #3 is the button
Seat 1: 1WUCqNG+p+vfWRTXNu4ljw ($50 in chips)
Seat 2: Hdd4js36ITbTJ/QuVYwTlA ($53.50 in chips)
Seat 3: lxIzoHy0RnkfFSODHC2liw ($51.60 in chips)
Seat 4: 2igtJLmvIZ+HqX4XPgMPZA ($79.65 in chips)
Seat 6: M1KyQQvVPVuxqTAB8sR/zQ ($95.55 in chips)
2igtJLmvIZ+HqX4XPgMPZA: posts small blind $0.25
M1KyQQvVPVuxqTAB8sR/zQ: posts big blind $0.50
*** HOLE CARDS ***
1WUCqNG+p+vfWRTXNu4ljw: folds
Hdd4js36ITbTJ/QuVYwTlA: folds
lxIzoHy0RnkfFSODHC2liw: raises $1 to $1.50
2igtJLmvIZ+HqX4XPgMPZA: folds
M1KyQQvVPVuxqTAB8sR/zQ: calls $1
*** FLOP *** [As Th 5h]
M1KyQQvVPVuxqTAB8sR/zQ: checks
lxIzoHy0RnkfFSODHC2liw: bets $2.50
M1KyQQvVPVuxqTAB8sR/zQ: folds
lxIzoHy0RnkfFSODHC2liw collected $3.10 from pot
lxIzoHy0RnkfFSODHC2liw: doesn't show hand
*** SUMMARY ***
Total pot $3.25 | Rake $0.15
Board [As Th 5h]
Seat 1: 1WUCqNG+p+vfWRTXNu4ljw folded before Flop (didn't bet)
Seat 2: Hdd4js36ITbTJ/QuVYwTlA folded before Flop (didn't bet)
Seat 3: lxIzoHy0RnkfFSODHC2liw (button) collected ($3.10)
Seat 4: 2igtJLmvIZ+HqX4XPgMPZA (small blind) folded before Flop
Seat 6: M1KyQQvVPVuxqTAB8sR/zQ (big blind) folded on the Flop



PokerStars Game #59941197354:  Hold'em No Limit ($0.25/$0.50) - 2009/07/01 1:28:26 ET
Table '+z1aekfHkpp09pc8F9aViw' 6-max Seat #3 is the button
Seat 1: /DArfRoYc3YpLsOQSZubFg ($50 in chips)
Seat 2: 4QfsCWthT/vSLirorNXqtg ($50 in chips)
Seat 3: URYNc7fPA23K2UfadQbnCA ($49.25 in chips)
Seat 5: 2igtJLmvIZ+HqX4XPgMPZA ($53.95 in chips)
Seat 6: GUnvMULl2qFOO1yenu1UBw ($50.75 in chips)
2igtJLmvIZ+HqX4XPgMPZA: posts small blind $0.25
GUnvMULl2qFOO1yenu1UBw: posts big blind $0.50
*** HOLE CARDS ***
/DArfRoYc3YpLsOQSZubFg: folds
4QfsCWthT/vSLirorNXqtg: folds
URYNc7fPA23K2UfadQbnCA: folds
2igtJLmvIZ+HqX4XPgMPZA: folds
GUnvMULl2qFOO1yenu1UBw collected $0.50 from pot
*** SUMMARY ***
Total pot $0.50 | Rake $0
Seat 1: /DArfRoYc3YpLsOQSZubFg folded before Flop (didn't bet)
Seat 2: 4QfsCWthT/vSLirorNXqtg folded before Flop (didn't bet)
Seat 3: URYNc7fPA23K2UfadQbnCA (button) folded before Flop (didn't bet)
Seat 5: 2igtJLmvIZ+HqX4XPgMPZA (small blind) folded before Flop
Seat 6: GUnvMULl2qFOO1yenu1UBw (big blind) collected ($0.50)



PokerStars Game #59941197840:  Hold'em No Limit ($0.25/$0.50) - 2009/07/01 1:28:27 ET
Table '8BQGgNetI1NOvWeu3gtMNw' 2-max Seat #1 is the button
Seat 1: bypIyrYcAAifLfhZpGlKLA ($64.15 in chips)
Seat 2: Z4HwehErEwzsv/noQlfUlg ($153.95 in chips)
bypIyrYcAAifLfhZpGlKLA: posts small blind $0.25
Z4HwehErEwzsv/noQlfUlg: posts big blind $0.50
*** HOLE CARDS ***
bypIyrYcAAifLfhZpGlKLA: folds
Z4HwehErEwzsv/noQlfUlg collected $0.50 from pot
Z4HwehErEwzsv/noQlfUlg: doesn't show hand
*** SUMMARY ***
Total pot $0.50 | Rake $0
Seat 1: bypIyrYcAAifLfhZpGlKLA (button) (small blind) folded before Flop
Seat 2: Z4HwehErEwzsv/noQlfUlg (big blind) collected ($0.50)



PokerStars Game #59941199480:  Hold'em No Limit ($0.25/$0.50) - 2009/07/01 1:28:30 ET
Table '2lPOwetm4cfkZPbTmGPH/w' 2-max Seat #1 is the button
Seat 1: vUGdApqS8J/GJE2gaVWl1w ($8.40 in chips)
Seat 2: XFa6sBGjP2gxoIvxR3fZIg ($34.25 in chips)
vUGdApqS8J/GJE2gaVWl1w: posts small blind $0.25
XFa6sBGjP2gxoIvxR3fZIg: posts big blind $0.50
*** HOLE CARDS ***
vUGdApqS8J/GJE2gaVWl1w: calls $0.25
XFa6sBGjP2gxoIvxR3fZIg: raises $1.50 to $2
vUGdApqS8J/GJE2gaVWl1w: folds
XFa6sBGjP2gxoIvxR3fZIg collected $1 from pot
XFa6sBGjP2gxoIvxR3fZIg: doesn't show hand
*** SUMMARY ***
Total pot $1 | Rake $0
Seat 1: vUGdApqS8J/GJE2gaVWl1w (button) (small blind) folded before Flop
Seat 2: XFa6sBGjP2gxoIvxR3fZIg (big blind) collected ($1)



PokerStars Game #59941200532:  Hold'em No Limit ($0.25/$0.50) - 2009/07/01 1:28:31 ET
Table 'B+sqsfj6d6zXicNfaseTaw' 2-max Seat #1 is the button
Seat 1: +4GNcSsecmapVGSdV0mUPA ($132.40 in chips)
Seat 2: Lv5RmpRe6LtPkBzM9Gpo5A ($93.20 in chips)
+4GNcSsecmapVGSdV0mUPA: posts small blind $0.25
Lv5RmpRe6LtPkBzM9Gpo5A: posts big blind $0.50
*** HOLE CARDS ***
+4GNcSsecmapVGSdV0mUPA: folds
Lv5RmpRe6LtPkBzM9Gpo5A collected $0.50 from pot
*** SUMMARY ***
Total pot $0.50 | Rake $0
Seat 1: +4GNcSsecmapVGSdV0mUPA (button) (small blind) folded before Flop
Seat 2: Lv5RmpRe6LtPkBzM9Gpo5A (big blind) collected ($0.50)



PokerStars Game #59941201212:  Hold'em No Limit ($0.25/$0.50) - 2009/07/01 1:28:32 ET
Table '8BQGgNetI1NOvWeu3gtMNw' 2-max Seat #2 is the button
Seat 1: bypIyrYcAAifLfhZpGlKLA ($63.90 in chips)
Seat 2: Z4HwehErEwzsv/noQlfUlg ($154.20 in chips)
Z4HwehErEwzsv/noQlfUlg: posts small blind $0.25
bypIyrYcAAifLfhZpGlKLA: posts big blind $0.50
*** HOLE CARDS ***
Z4HwehErEwzsv/noQlfUlg: folds
bypIyrYcAAifLfhZpGlKLA collected $0.50 from pot
bypIyrYcAAifLfhZpGlKLA: doesn't show hand
*** SUMMARY ***
Total pot $0.50 | Rake $0
Seat 1: bypIyrYcAAifLfhZpGlKLA (big blind) collected ($0.50)
Seat 2: Z4HwehErEwzsv/noQlfUlg (button) (small blind) folded before Flop



PokerStars Game #59941200676:  Hold'em No Limit ($0.25/$0.50) - 2009/07/01 1:28:32 ET
Table 'GfL/No5u5PoEnU39lP5pQg' 6-max Seat #4 is the button
Seat 1: 1WUCqNG+p+vfWRTXNu4ljw ($61.25 in chips)
Seat 2: uVwggSetzp7d+eVgowO3vg ($50.75 in chips)
Seat 3: 4pp9WxhGdbVbxCc9tlu0lw ($34.55 in chips)
Seat 4: r6u7MWSXF30/khcTYkrG9Q ($30.60 in chips)
Seat 5: M1KyQQvVPVuxqTAB8sR/zQ ($50 in chips)
Seat 6: kxPhs4ePFqMy52CInAJ2aw ($65.25 in chips)
M1KyQQvVPVuxqTAB8sR/zQ: posts small blind $0.25
kxPhs4ePFqMy52CInAJ2aw: posts big blind $0.50
*** HOLE CARDS ***
1WUCqNG+p+vfWRTXNu4ljw: folds
uVwggSetzp7d+eVgowO3vg: raises $1 to $1.50
4pp9WxhGdbVbxCc9tlu0lw: calls $1.50
r6u7MWSXF30/khcTYkrG9Q: folds
M1KyQQvVPVuxqTAB8sR/zQ: calls $1.25
kxPhs4ePFqMy52CInAJ2aw: folds
*** FLOP *** [5d 3h 5h]
M1KyQQvVPVuxqTAB8sR/zQ: checks
uVwggSetzp7d+eVgowO3vg: checks
4pp9WxhGdbVbxCc9tlu0lw: bets $2
M1KyQQvVPVuxqTAB8sR/zQ: calls $2
uVwggSetzp7d+eVgowO3vg: folds
*** TURN *** [5d 3h 5h] [Qh]
M1KyQQvVPVuxqTAB8sR/zQ: bets $5
4pp9WxhGdbVbxCc9tlu0lw: calls $5
*** RIVER *** [5d 3h 5h Qh] [3s]
M1KyQQvVPVuxqTAB8sR/zQ: bets $10
4pp9WxhGdbVbxCc9tlu0lw: folds
M1KyQQvVPVuxqTAB8sR/zQ collected $18.10 from pot
M1KyQQvVPVuxqTAB8sR/zQ: doesn't show hand
*** SUMMARY ***
Total pot $19 | Rake $0.90
Board [5d 3h 5h Qh 3s]
Seat 1: 1WUCqNG+p+vfWRTXNu4ljw folded before Flop (didn't bet)
Seat 2: uVwggSetzp7d+eVgowO3vg folded on the Flop
Seat 3: 4pp9WxhGdbVbxCc9tlu0lw folded on the River
Seat 4: r6u7MWSXF30/khcTYkrG9Q (button) folded before Flop (didn't bet)
Seat 5: M1KyQQvVPVuxqTAB8sR/zQ (small blind) collected ($18.10)
Seat 6: kxPhs4ePFqMy52CInAJ2aw (big blind) folded before Flop



PokerStars Game #59941202338:  Hold'em No Limit ($0.25/$0.50) - 2009/07/01 1:28:34 ET
Table 'hWT2kq66tnKEpD26cia6fQ' 2-max Seat #2 is the button
Seat 1: Ce3KNFP+ao7Da9NHb65raw ($30.45 in chips)
Seat 2: 16tvT7AYgZ2LgiGFcvFKQg ($46.50 in chips)
16tvT7AYgZ2LgiGFcvFKQg: posts small blind $0.25
Ce3KNFP+ao7Da9NHb65raw: posts big blind $0.50
*** HOLE CARDS ***
16tvT7AYgZ2LgiGFcvFKQg: calls $0.25
Ce3KNFP+ao7Da9NHb65raw: checks
*** FLOP *** [2d 4h Ks]
Ce3KNFP+ao7Da9NHb65raw: checks
16tvT7AYgZ2LgiGFcvFKQg: checks
*** TURN *** [2d 4h Ks] [Qc]
Ce3KNFP+ao7Da9NHb65raw: checks
16tvT7AYgZ2LgiGFcvFKQg: checks
*** RIVER *** [2d 4h Ks Qc] [4c]
Ce3KNFP+ao7Da9NHb65raw: checks
16tvT7AYgZ2LgiGFcvFKQg: bets $1
Ce3KNFP+ao7Da9NHb65raw: folds
16tvT7AYgZ2LgiGFcvFKQg collected $0.95 from pot
*** SUMMARY ***
Total pot $1 | Rake $0.05
Board [2d 4h Ks Qc 4c]
Seat 1: Ce3KNFP+ao7Da9NHb65raw (big blind) folded on the River
Seat 2: 16tvT7AYgZ2LgiGFcvFKQg (button) (small blind) collected ($0.95)



PokerStars Game #59941202200:  Hold'em No Limit ($0.25/$0.50) - 2009/07/01 1:28:34 ET
Table 'Nz0Vr7WMHL2g5Uk7dDZjpw' 9-max Seat #8 is the button
Seat 1: 9yMsdgReyOUerNsmTYCCDQ ($10 in chips)
Seat 3: hoglu9inkgs6zN573/bJag ($5.70 in chips)
Seat 4: E2518gp4aFz1+kAgmGqeEg ($12.25 in chips)
Seat 5: WGW0DgjBUXs1ylURHG8vnQ ($12.40 in chips)
Seat 6: 997ViqAtWn1FPjJqcffwcA ($50 in chips)
Seat 7: KPLH0gELgFe2OuAnhJFI5w ($24.70 in chips)
Seat 8: aoL+R/61Kxmw69ypuPrWAQ ($30.90 in chips)
Seat 9: mSD1pginDsyHG5PDfqzphw ($19.75 in chips)
mSD1pginDsyHG5PDfqzphw: posts small blind $0.25
9yMsdgReyOUerNsmTYCCDQ: posts big blind $0.50
SegjDnMxWMujiD57ESNL+g: sits out
*** HOLE CARDS ***
hoglu9inkgs6zN573/bJag: calls $0.50
E2518gp4aFz1+kAgmGqeEg: folds
WGW0DgjBUXs1ylURHG8vnQ: folds
997ViqAtWn1FPjJqcffwcA: folds
KPLH0gELgFe2OuAnhJFI5w: folds
aoL+R/61Kxmw69ypuPrWAQ: calls $0.50
mSD1pginDsyHG5PDfqzphw: calls $0.25
9yMsdgReyOUerNsmTYCCDQ: checks
*** FLOP *** [6h 8d 5s]
mSD1pginDsyHG5PDfqzphw: checks
9yMsdgReyOUerNsmTYCCDQ: checks
hoglu9inkgs6zN573/bJag: checks
aoL+R/61Kxmw69ypuPrWAQ: bets $1.50
mSD1pginDsyHG5PDfqzphw: folds
9yMsdgReyOUerNsmTYCCDQ: folds
hoglu9inkgs6zN573/bJag: folds
aoL+R/61Kxmw69ypuPrWAQ collected $1.90 from pot
*** SUMMARY ***
Total pot $2 | Rake $0.10
Board [6h 8d 5s]
Seat 1: 9yMsdgReyOUerNsmTYCCDQ (big blind) folded on the Flop
Seat 3: hoglu9inkgs6zN573/bJag folded on the Flop
Seat 4: E2518gp4aFz1+kAgmGqeEg folded before Flop (didn't bet)
Seat 5: WGW0DgjBUXs1ylURHG8vnQ folded before Flop (didn't bet)
Seat 6: 997ViqAtWn1FPjJqcffwcA folded before Flop (didn't bet)
Seat 7: KPLH0gELgFe2OuAnhJFI5w folded before Flop (didn't bet)
Seat 8: aoL+R/61Kxmw69ypuPrWAQ (button) collected ($1.90)
Seat 9: mSD1pginDsyHG5PDfqzphw (small blind) folded on the Flop



PokerStars Game #59941202620:  Hold'em No Limit ($0.25/$0.50) - 2009/07/01 1:28:35 ET
Table '99gCy/CZQwPIjZWH+BguQg' 9-max Seat #4 is the button
Seat 3: qRAIErWOpf/5FYyZ8qza0w ($15.60 in chips)
Seat 4: bxLSulbgr8LmKNjOzw8URg ($58.05 in chips)
Seat 5: YXCE3WOZi8g2sIf3y/plVw ($51.15 in chips)
Seat 6: OcnLOMVFdy23jXnoTyaO5Q ($303.85 in chips)
Seat 7: ottZQkg1UDWk85BtBzGJzg ($29.75 in chips)
Seat 8: 8ehL7qlZzjgUh2H35iiWLw ($50 in chips)
Seat 9: j3K/Jujr7PY4ZM2RZvlH6A ($67.50 in chips)
YXCE3WOZi8g2sIf3y/plVw: posts small blind $0.25
OcnLOMVFdy23jXnoTyaO5Q: posts big blind $0.50
Bawookles: sits out
qRAIErWOpf/5FYyZ8qza0w: posts big blind $0.50
*** HOLE CARDS ***
ottZQkg1UDWk85BtBzGJzg: folds
8ehL7qlZzjgUh2H35iiWLw: raises $1.50 to $2
j3K/Jujr7PY4ZM2RZvlH6A: folds
qRAIErWOpf/5FYyZ8qza0w: raises $2 to $4
bxLSulbgr8LmKNjOzw8URg: folds
YXCE3WOZi8g2sIf3y/plVw: folds
OcnLOMVFdy23jXnoTyaO5Q: folds
8ehL7qlZzjgUh2H35iiWLw: calls $2
*** FLOP *** [4h 7d 3d]
7CKaQEWhd40e2lLifzZ1Cw joins the table at seat #2
8ehL7qlZzjgUh2H35iiWLw: checks
qRAIErWOpf/5FYyZ8qza0w: bets $11.60 and is all-in
8ehL7qlZzjgUh2H35iiWLw: calls $11.60
*** TURN *** [4h 7d 3d] [Kh]
*** RIVER *** [4h 7d 3d Kh] [3s]
*** SHOW DOWN ***
8ehL7qlZzjgUh2H35iiWLw: shows [6s 6h] (two pair, Sixes and Threes)
qRAIErWOpf/5FYyZ8qza0w: shows [Qd Qc] (two pair, Queens and Threes)
qRAIErWOpf/5FYyZ8qza0w collected $30.40 from pot
*** SUMMARY ***
Total pot $31.95 | Rake $1.55
Board [4h 7d 3d Kh 3s]
Seat 3: qRAIErWOpf/5FYyZ8qza0w showed [Qd Qc] and won ($30.40) with two pair, Queens and Threes
Seat 4: bxLSulbgr8LmKNjOzw8URg (button) folded before Flop (didn't bet)
Seat 5: YXCE3WOZi8g2sIf3y/plVw (small blind) folded before Flop
Seat 6: OcnLOMVFdy23jXnoTyaO5Q (big blind) folded before Flop
Seat 7: ottZQkg1UDWk85BtBzGJzg folded before Flop (didn't bet)
Seat 8: 8ehL7qlZzjgUh2H35iiWLw showed [6s 6h] and lost with two pair, Sixes and Threes
Seat 9: j3K/Jujr7PY4ZM2RZvlH6A folded before Flop (didn't bet)



PokerStars Game #59941203284:  Hold'em No Limit ($0.25/$0.50) - 2009/07/01 1:28:36 ET
Table 'NCiXr0d5CEKBQr/cZgLhbA' 9-max Seat #9 is the button
Seat 1: pFtzb1sR4b0d1aw6aIRgDg ($80.70 in chips)
Seat 2: AjV5McH1KMMclY26QdLM5w ($25 in chips)
Seat 3: xZCXQSXlrZkp3pZizzVXCw ($98.65 in chips)
Seat 4: 5k9fvXD9suIgCxU4HLQjTw ($53.95 in chips)
Seat 5: Ja2jdidjip2UeJnRzmzAAQ ($50 in chips)
Seat 6: t1qL+wRXOwTLB4TBbcw2QA ($47.75 in chips)
Seat 7: dXhO5i7KOoVcsGqbklD+jw ($27.50 in chips)
Seat 8: 1MJUKc3cc0QmUoz1JZLR2w ($48.95 in chips)
Seat 9: 4WLZvqBn5qv5tds5kt5A1Q ($56 in chips)
pFtzb1sR4b0d1aw6aIRgDg: posts small blind $0.25
AjV5McH1KMMclY26QdLM5w: posts big blind $0.50
*** HOLE CARDS ***
xZCXQSXlrZkp3pZizzVXCw: folds
5k9fvXD9suIgCxU4HLQjTw: folds
Ja2jdidjip2UeJnRzmzAAQ: folds
t1qL+wRXOwTLB4TBbcw2QA: folds
dXhO5i7KOoVcsGqbklD+jw: folds
1MJUKc3cc0QmUoz1JZLR2w: raises $1.50 to $2
4WLZvqBn5qv5tds5kt5A1Q: folds
pFtzb1sR4b0d1aw6aIRgDg: folds
AjV5McH1KMMclY26QdLM5w: calls $1.50
*** FLOP *** [8d 5d 9s]
AjV5McH1KMMclY26QdLM5w: checks
1MJUKc3cc0QmUoz1JZLR2w: bets $4
AjV5McH1KMMclY26QdLM5w: calls $4
*** TURN *** [8d 5d 9s] [7d]
AjV5McH1KMMclY26QdLM5w: bets $4.50
1MJUKc3cc0QmUoz1JZLR2w: calls $4.50
*** RIVER *** [8d 5d 9s 7d] [5c]
AjV5McH1KMMclY26QdLM5w: bets $14.50 and is all-in
1MJUKc3cc0QmUoz1JZLR2w: calls $14.50
*** SHOW DOWN ***
AjV5McH1KMMclY26QdLM5w: shows [6h 6d] (a straight, Five to Nine)
1MJUKc3cc0QmUoz1JZLR2w: mucks hand
AjV5McH1KMMclY26QdLM5w collected $47.80 from pot
*** SUMMARY ***
Total pot $50.25 | Rake $2.45
Board [8d 5d 9s 7d 5c]
Seat 1: pFtzb1sR4b0d1aw6aIRgDg (small blind) folded before Flop
Seat 2: AjV5McH1KMMclY26QdLM5w (big blind) showed [6h 6d] and won ($47.80) with a straight, Five to Nine
Seat 3: xZCXQSXlrZkp3pZizzVXCw folded before Flop (didn't bet)
Seat 4: 5k9fvXD9suIgCxU4HLQjTw folded before Flop (didn't bet)
Seat 5: Ja2jdidjip2UeJnRzmzAAQ folded before Flop (didn't bet)
Seat 6: t1qL+wRXOwTLB4TBbcw2QA folded before Flop (didn't bet)
Seat 7: dXhO5i7KOoVcsGqbklD+jw folded before Flop (didn't bet)
Seat 8: 1MJUKc3cc0QmUoz1JZLR2w mucked
Seat 9: 4WLZvqBn5qv5tds5kt5A1Q (button) folded before Flop (didn't bet)



PokerStars Game #59941204396:  Hold'em No Limit ($0.25/$0.50) - 2009/07/01 1:28:38 ET
Table '2lPOwetm4cfkZPbTmGPH/w' 2-max Seat #2 is the button
Seat 1: vUGdApqS8J/GJE2gaVWl1w ($7.90 in chips)
Seat 2: XFa6sBGjP2gxoIvxR3fZIg ($34.75 in chips)
XFa6sBGjP2gxoIvxR3fZIg: posts small blind $0.25
vUGdApqS8J/GJE2gaVWl1w: posts big blind $0.50
*** HOLE CARDS ***
XFa6sBGjP2gxoIvxR3fZIg: calls $0.25
vUGdApqS8J/GJE2gaVWl1w: checks
*** FLOP *** [Kh 7d Ks]
vUGdApqS8J/GJE2gaVWl1w: checks
XFa6sBGjP2gxoIvxR3fZIg: checks
*** TURN *** [Kh 7d Ks] [Js]
vUGdApqS8J/GJE2gaVWl1w: checks
XFa6sBGjP2gxoIvxR3fZIg: checks
*** RIVER *** [Kh 7d Ks Js] [6h]
vUGdApqS8J/GJE2gaVWl1w: checks
XFa6sBGjP2gxoIvxR3fZIg: checks
*** SHOW DOWN ***
vUGdApqS8J/GJE2gaVWl1w: shows [8c 4s] (a pair of Kings)
XFa6sBGjP2gxoIvxR3fZIg: shows [5d Qc] (a pair of Kings - Queen kicker)
XFa6sBGjP2gxoIvxR3fZIg collected $0.95 from pot
*** SUMMARY ***
Total pot $1 | Rake $0.05
Board [Kh 7d Ks Js 6h]
Seat 1: vUGdApqS8J/GJE2gaVWl1w (big blind) showed [8c 4s] and lost with a pair of Kings
Seat 2: XFa6sBGjP2gxoIvxR3fZIg (button) (small blind) showed [5d Qc] and won ($0.95) with a pair of Kings



PokerStars Game #59941204158:  Hold'em No Limit ($0.25/$0.50) - 2009/07/01 1:28:38 ET
Table 'B+sqsfj6d6zXicNfaseTaw' 2-max Seat #2 is the button
Seat 1: +4GNcSsecmapVGSdV0mUPA ($132.15 in chips)
Seat 2: Lv5RmpRe6LtPkBzM9Gpo5A ($93.45 in chips)
Lv5RmpRe6LtPkBzM9Gpo5A: posts small blind $0.25
+4GNcSsecmapVGSdV0mUPA: posts big blind $0.50
*** HOLE CARDS ***
Lv5RmpRe6LtPkBzM9Gpo5A: folds
+4GNcSsecmapVGSdV0mUPA collected $0.50 from pot
+4GNcSsecmapVGSdV0mUPA: doesn't show hand
*** SUMMARY ***
Total pot $0.50 | Rake $0
Seat 1: +4GNcSsecmapVGSdV0mUPA (big blind) collected ($0.50)
Seat 2: Lv5RmpRe6LtPkBzM9Gpo5A (button) (small blind) folded before Flop



PokerStars Game #59941205242:  Hold'em No Limit ($0.25/$0.50) - 2009/07/01 1:28:39 ET
Table '8BQGgNetI1NOvWeu3gtMNw' 2-max Seat #1 is the button
Seat 1: bypIyrYcAAifLfhZpGlKLA ($64.15 in chips)
Seat 2: Z4HwehErEwzsv/noQlfUlg ($153.95 in chips)
bypIyrYcAAifLfhZpGlKLA: posts small blind $0.25
Z4HwehErEwzsv/noQlfUlg: posts big blind $0.50
*** HOLE CARDS ***
bypIyrYcAAifLfhZpGlKLA: folds
Z4HwehErEwzsv/noQlfUlg collected $0.50 from pot
Z4HwehErEwzsv/noQlfUlg: doesn't show hand
*** SUMMARY ***
Total pot $0.50 | Rake $0
Seat 1: bypIyrYcAAifLfhZpGlKLA (button) (small blind) folded before Flop
Seat 2: Z4HwehErEwzsv/noQlfUlg (big blind) collected ($0.50)



PokerStars Game #59941207824:  Hold'em No Limit ($0.25/$0.50) - 2009/07/01 1:28:44 ET
Table 'X6IRCRTh+20gjz8aubWnwA' 9-max Seat #2 is the button
Seat 2: HZkVla4kK2SI42CVrPZ/ig ($9.75 in chips)
Seat 3: SWv01peOe69QQRvhQTqjQw ($12.30 in chips)
Seat 4: M3JFBNQ8Bbw3FBZ/18MuXw ($31.65 in chips)
Seat 5: uw9QayAAxLM3Hb+HR7mSkg ($18.30 in chips)
Seat 6: Qi/PyOsKwaqtKIg0H+7ELg ($7.75 in chips)
Seat 7: +RUz0sVA09ZE8PNpIl+EBQ ($29 in chips)
Seat 8: HxeBVq06/3Bh/H986sgdbw ($44.50 in chips)
Seat 9: M+7+BTmX5vZatHVuoRB1nA ($57.15 in chips)
SWv01peOe69QQRvhQTqjQw: posts small blind $0.25
M3JFBNQ8Bbw3FBZ/18MuXw: posts big blind $0.50
*** HOLE CARDS ***
uw9QayAAxLM3Hb+HR7mSkg: folds
Qi/PyOsKwaqtKIg0H+7ELg: folds
+RUz0sVA09ZE8PNpIl+EBQ: calls $0.50
HxeBVq06/3Bh/H986sgdbw: folds
M+7+BTmX5vZatHVuoRB1nA: folds
HZkVla4kK2SI42CVrPZ/ig: folds
SWv01peOe69QQRvhQTqjQw: calls $0.25
M3JFBNQ8Bbw3FBZ/18MuXw: checks
*** FLOP *** [As 2s Jd]
SWv01peOe69QQRvhQTqjQw: checks
M3JFBNQ8Bbw3FBZ/18MuXw: checks
+RUz0sVA09ZE8PNpIl+EBQ: checks
*** TURN *** [As 2s Jd] [Ad]
SWv01peOe69QQRvhQTqjQw: checks
M3JFBNQ8Bbw3FBZ/18MuXw: checks
+RUz0sVA09ZE8PNpIl+EBQ: checks
*** RIVER *** [As 2s Jd Ad] [Qs]
SWv01peOe69QQRvhQTqjQw: checks
M3JFBNQ8Bbw3FBZ/18MuXw: bets $1
+RUz0sVA09ZE8PNpIl+EBQ: raises $1 to $2
SWv01peOe69QQRvhQTqjQw: folds
M3JFBNQ8Bbw3FBZ/18MuXw: calls $1
*** SHOW DOWN ***
+RUz0sVA09ZE8PNpIl+EBQ: shows [Qc Jh] (two pair, Aces and Queens)
M3JFBNQ8Bbw3FBZ/18MuXw: shows [Kh Ts] (a straight, Ten to Ace)
M3JFBNQ8Bbw3FBZ/18MuXw collected $5.25 from pot
*** SUMMARY ***
Total pot $5.50 | Rake $0.25
Board [As 2s Jd Ad Qs]
Seat 2: HZkVla4kK2SI42CVrPZ/ig (button) folded before Flop (didn't bet)
Seat 3: SWv01peOe69QQRvhQTqjQw (small blind) folded on the River
Seat 4: M3JFBNQ8Bbw3FBZ/18MuXw (big blind) showed [Kh Ts] and won ($5.25) with a straight, Ten to Ace
Seat 5: uw9QayAAxLM3Hb+HR7mSkg folded before Flop (didn't bet)
Seat 6: Qi/PyOsKwaqtKIg0H+7ELg folded before Flop (didn't bet)
Seat 7: +RUz0sVA09ZE8PNpIl+EBQ showed [Qc Jh] and lost with two pair, Aces and Queens
Seat 8: HxeBVq06/3Bh/H986sgdbw folded before Flop (didn't bet)
Seat 9: M+7+BTmX5vZatHVuoRB1nA folded before Flop (didn't bet)



PokerStars Game #59941208110:  Hold'em No Limit ($0.25/$0.50) - 2009/07/01 1:28:44 ET
Table '+z1aekfHkpp09pc8F9aViw' 6-max Seat #5 is the button
Seat 1: /DArfRoYc3YpLsOQSZubFg ($50 in chips)
Seat 2: 4QfsCWthT/vSLirorNXqtg ($50 in chips)
Seat 3: URYNc7fPA23K2UfadQbnCA ($49.25 in chips)
Seat 5: 2igtJLmvIZ+HqX4XPgMPZA ($53.70 in chips)
Seat 6: GUnvMULl2qFOO1yenu1UBw ($51 in chips)
GUnvMULl2qFOO1yenu1UBw: posts small blind $0.25
/DArfRoYc3YpLsOQSZubFg: posts big blind $0.50
*** HOLE CARDS ***
4QfsCWthT/vSLirorNXqtg: folds
URYNc7fPA23K2UfadQbnCA: folds
2igtJLmvIZ+HqX4XPgMPZA: folds
GUnvMULl2qFOO1yenu1UBw: raises $1 to $1.50
/DArfRoYc3YpLsOQSZubFg: folds
GUnvMULl2qFOO1yenu1UBw collected $1 from pot
*** SUMMARY ***
Total pot $1 | Rake $0
Seat 1: /DArfRoYc3YpLsOQSZubFg (big blind) folded before Flop
Seat 2: 4QfsCWthT/vSLirorNXqtg folded before Flop (didn't bet)
Seat 3: URYNc7fPA23K2UfadQbnCA folded before Flop (didn't bet)
Seat 5: 2igtJLmvIZ+HqX4XPgMPZA (button) folded before Flop (didn't bet)
Seat 6: GUnvMULl2qFOO1yenu1UBw (small blind) collected ($1)



PokerStars Game #59941208346:  Hold'em No Limit ($0.25/$0.50) - 2009/07/01 1:28:45 ET
Table 'ZYI3ZReBjdfKEYItkZHI6A' 9-max Seat #9 is the button
Seat 1: IYd5zG8k7vdBNVHbHg2Pag ($63.90 in chips)
Seat 3: 75K2MXwN65Sjfp1yHd50Hg ($10 in chips)
Seat 4: e2+sK/yjnj94rXOKoxPP2A ($64.40 in chips)
Seat 5: ApHP7ouup365XIUFBdEDxg ($15.95 in chips)
Seat 6: 1xBtrSVBbgFH/viUWKqQeg ($29.45 in chips)
Seat 7: HWcfp1hY1hqvrddzW3/FQw ($12.25 in chips)
Seat 8: ji04uOybxCdpdefzlUQeKQ ($30.55 in chips)
Seat 9: HZkVla4kK2SI42CVrPZ/ig ($9.25 in chips)
IYd5zG8k7vdBNVHbHg2Pag: posts small blind $0.25
uw9QayAAxLM3Hb+HR7mSkg: is sitting out
75K2MXwN65Sjfp1yHd50Hg: posts big blind $0.50
*** HOLE CARDS ***
e2+sK/yjnj94rXOKoxPP2A: raises $1 to $1.50
uw9QayAAxLM3Hb+HR7mSkg leaves the table
ApHP7ouup365XIUFBdEDxg: folds
1xBtrSVBbgFH/viUWKqQeg: folds
HWcfp1hY1hqvrddzW3/FQw: calls $1.50
ji04uOybxCdpdefzlUQeKQ: folds
HZkVla4kK2SI42CVrPZ/ig: folds
IYd5zG8k7vdBNVHbHg2Pag: folds
5acK4E7fzEwnplVBZ6eNWA joins the table at seat #2
75K2MXwN65Sjfp1yHd50Hg: folds
*** FLOP *** [2c 8c 3d]
e2+sK/yjnj94rXOKoxPP2A: bets $2
HWcfp1hY1hqvrddzW3/FQw: raises $2.50 to $4.50
e2+sK/yjnj94rXOKoxPP2A: folds
HWcfp1hY1hqvrddzW3/FQw collected $7.40 from pot
*** SUMMARY ***
Total pot $7.75 | Rake $0.35
Board [2c 8c 3d]
Seat 1: IYd5zG8k7vdBNVHbHg2Pag (small blind) folded before Flop
Seat 3: 75K2MXwN65Sjfp1yHd50Hg (big blind) folded before Flop
Seat 4: e2+sK/yjnj94rXOKoxPP2A folded on the Flop
Seat 5: ApHP7ouup365XIUFBdEDxg folded before Flop (didn't bet)
Seat 6: 1xBtrSVBbgFH/viUWKqQeg folded before Flop (didn't bet)
Seat 7: HWcfp1hY1hqvrddzW3/FQw collected ($7.40)
Seat 8: ji04uOybxCdpdefzlUQeKQ folded before Flop (didn't bet)
Seat 9: HZkVla4kK2SI42CVrPZ/ig (button) folded before Flop (didn't bet)



PokerStars Game #59941208498:  Hold'em No Limit ($0.25/$0.50) - 2009/07/01 1:28:45 ET
Table '8BQGgNetI1NOvWeu3gtMNw' 2-max Seat #2 is the button
Seat 1: bypIyrYcAAifLfhZpGlKLA ($63.90 in chips)
Seat 2: Z4HwehErEwzsv/noQlfUlg ($154.20 in chips)
Z4HwehErEwzsv/noQlfUlg: posts small blind $0.25
bypIyrYcAAifLfhZpGlKLA: posts big blind $0.50
*** HOLE CARDS ***
Z4HwehErEwzsv/noQlfUlg: calls $0.25
bypIyrYcAAifLfhZpGlKLA: raises $1.50 to $2
Z4HwehErEwzsv/noQlfUlg: folds
bypIyrYcAAifLfhZpGlKLA collected $1 from pot
bypIyrYcAAifLfhZpGlKLA: doesn't show hand
*** SUMMARY ***
Total pot $1 | Rake $0
Seat 1: bypIyrYcAAifLfhZpGlKLA (big blind) collected ($1)
Seat 2: Z4HwehErEwzsv/noQlfUlg (button) (small blind) folded before Flop



PokerStars Game #59941209692:  Hold'em No Limit ($0.25/$0.50) - 2009/07/01 1:28:47 ET
Table 'B+sqsfj6d6zXicNfaseTaw' 2-max Seat #1 is the button
Seat 1: +4GNcSsecmapVGSdV0mUPA ($132.40 in chips)
Seat 2: Lv5RmpRe6LtPkBzM9Gpo5A ($93.20 in chips)
+4GNcSsecmapVGSdV0mUPA: posts small blind $0.25
Lv5RmpRe6LtPkBzM9Gpo5A: posts big blind $0.50
*** HOLE CARDS ***
+4GNcSsecmapVGSdV0mUPA: calls $0.25
Lv5RmpRe6LtPkBzM9Gpo5A: raises $1.50 to $2
+4GNcSsecmapVGSdV0mUPA: calls $1.50
*** FLOP *** [As 2d Ah]
Lv5RmpRe6LtPkBzM9Gpo5A: checks
+4GNcSsecmapVGSdV0mUPA: checks
*** TURN *** [As 2d Ah] [5s]
Lv5RmpRe6LtPkBzM9Gpo5A: bets $1.50
+4GNcSsecmapVGSdV0mUPA: calls $1.50
*** RIVER *** [As 2d Ah 5s] [Jd]
Lv5RmpRe6LtPkBzM9Gpo5A: checks
+4GNcSsecmapVGSdV0mUPA: checks
*** SHOW DOWN ***
Lv5RmpRe6LtPkBzM9Gpo5A: shows [Kh 8h] (a pair of Aces)
+4GNcSsecmapVGSdV0mUPA: shows [4h 2h] (two pair, Aces and Deuces)
+4GNcSsecmapVGSdV0mUPA collected $6.70 from pot
*** SUMMARY ***
Total pot $7 | Rake $0.30
Board [As 2d Ah 5s Jd]
Seat 1: +4GNcSsecmapVGSdV0mUPA (button) (small blind) showed [4h 2h] and won ($6.70) with two pair, Aces and Deuces
Seat 2: Lv5RmpRe6LtPkBzM9Gpo5A (big blind) showed [Kh 8h] and lost with a pair of Aces



PokerStars Game #59941210190:  Hold'em No Limit ($0.25/$0.50) - 2009/07/01 1:28:48 ET
Table '+dXkOAQyS8j9PQZusUTMpg' 2-max Seat #2 is the button
Seat 1: Teld4PDKla7C8/Wfu2DSkg ($51.10 in chips)
Seat 2: +zI4bP23YIjMkUHqeN2xfw ($25.80 in chips)
+zI4bP23YIjMkUHqeN2xfw: posts small blind $0.25
Teld4PDKla7C8/Wfu2DSkg: posts big blind $0.50
*** HOLE CARDS ***
+zI4bP23YIjMkUHqeN2xfw: folds
Teld4PDKla7C8/Wfu2DSkg collected $0.50 from pot
*** SUMMARY ***
Total pot $0.50 | Rake $0
Seat 1: Teld4PDKla7C8/Wfu2DSkg (big blind) collected ($0.50)
Seat 2: +zI4bP23YIjMkUHqeN2xfw (button) (small blind) folded before Flop



PokerStars Game #59941211012:  Hold'em No Limit ($0.25/$0.50) - 2009/07/01 1:28:49 ET
Table 'cofQFHU7jbJoFecLVBof/w' 6-max Seat #2 is the button
Seat 1: URYNc7fPA23K2UfadQbnCA ($48.50 in chips)
Seat 2: f89uTQr3ieGlusj2IAYAEg ($50 in chips)
Seat 3: v4ctePcLlQw0r8E0qJtjYw ($47.45 in chips)
Seat 4: g6lz8npaeeTJmJegtPYhlQ ($17.85 in chips)
Seat 5: QvwRlrpVqerRRF8eJm6dDw ($53 in chips)
Seat 6: 7+uQ0OOgCTbR4ltkSwyC0g ($157.15 in chips)
v4ctePcLlQw0r8E0qJtjYw: posts small blind $0.25
g6lz8npaeeTJmJegtPYhlQ: posts big blind $0.50
*** HOLE CARDS ***
QvwRlrpVqerRRF8eJm6dDw: folds
7+uQ0OOgCTbR4ltkSwyC0g: raises $1 to $1.50
URYNc7fPA23K2UfadQbnCA: folds
f89uTQr3ieGlusj2IAYAEg: calls $1.50
v4ctePcLlQw0r8E0qJtjYw: folds
g6lz8npaeeTJmJegtPYhlQ: folds
*** FLOP *** [5s 7d 8d]
7+uQ0OOgCTbR4ltkSwyC0g: bets $3.50
f89uTQr3ieGlusj2IAYAEg: raises $9.50 to $13
7+uQ0OOgCTbR4ltkSwyC0g: raises $142.65 to $155.65 and is all-in
f89uTQr3ieGlusj2IAYAEg: calls $35.50 and is all-in
*** TURN *** [5s 7d 8d] [2h]
*** RIVER *** [5s 7d 8d 2h] [6c]
*** SHOW DOWN ***
7+uQ0OOgCTbR4ltkSwyC0g: shows [8s 7s] (two pair, Eights and Sevens)
f89uTQr3ieGlusj2IAYAEg: shows [8h 7h] (two pair, Eights and Sevens)
7+uQ0OOgCTbR4ltkSwyC0g collected $48.90 from pot
f89uTQr3ieGlusj2IAYAEg collected $48.85 from pot
*** SUMMARY ***
Total pot $100.75 | Rake $3
Board [5s 7d 8d 2h 6c]
Seat 1: URYNc7fPA23K2UfadQbnCA folded before Flop (didn't bet)
Seat 2: f89uTQr3ieGlusj2IAYAEg (button) showed [8h 7h] and won ($48.85) with two pair, Eights and Sevens
Seat 3: v4ctePcLlQw0r8E0qJtjYw (small blind) folded before Flop
Seat 4: g6lz8npaeeTJmJegtPYhlQ (big blind) folded before Flop
Seat 5: QvwRlrpVqerRRF8eJm6dDw folded before Flop (didn't bet)
Seat 6: 7+uQ0OOgCTbR4ltkSwyC0g showed [8s 7s] and won ($48.90) with two pair, Eights and Sevens



PokerStars Game #59941210956:  Hold'em No Limit ($0.25/$0.50) - 2009/07/01 1:28:49 ET
Table '3FhG0gl3kMX3wBEEqj+wnQ' 9-max Seat #7 is the button
Seat 1: bxLSulbgr8LmKNjOzw8URg ($49.30 in chips)
Seat 2: vacmVLJJECYI6HjAynFcpg ($50.60 in chips)
Seat 3: YXCE3WOZi8g2sIf3y/plVw ($59.75 in chips)
Seat 4: e2+sK/yjnj94rXOKoxPP2A ($70.25 in chips)
Seat 5: XcLXSUMHSpshK/7Lh0M4Vg ($9.25 in chips)
Seat 6: 997ViqAtWn1FPjJqcffwcA ($109.80 in chips)
Seat 7: mSD1pginDsyHG5PDfqzphw ($12.50 in chips)
Seat 8: j3K/Jujr7PY4ZM2RZvlH6A ($44.10 in chips)
j3K/Jujr7PY4ZM2RZvlH6A: posts small blind $0.25
bxLSulbgr8LmKNjOzw8URg: posts big blind $0.50
*** HOLE CARDS ***
vacmVLJJECYI6HjAynFcpg: folds
YXCE3WOZi8g2sIf3y/plVw: folds
e2+sK/yjnj94rXOKoxPP2A has timed out
e2+sK/yjnj94rXOKoxPP2A: folds
e2+sK/yjnj94rXOKoxPP2A is sitting out
XcLXSUMHSpshK/7Lh0M4Vg: folds
997ViqAtWn1FPjJqcffwcA: folds
e2+sK/yjnj94rXOKoxPP2A has returned
mSD1pginDsyHG5PDfqzphw: folds
j3K/Jujr7PY4ZM2RZvlH6A: folds
bxLSulbgr8LmKNjOzw8URg collected $0.50 from pot
bxLSulbgr8LmKNjOzw8URg: doesn't show hand
*** SUMMARY ***
Total pot $0.50 | Rake $0
Seat 1: bxLSulbgr8LmKNjOzw8URg (big blind) collected ($0.50)
Seat 2: vacmVLJJECYI6HjAynFcpg folded before Flop (didn't bet)
Seat 3: YXCE3WOZi8g2sIf3y/plVw folded before Flop (didn't bet)
Seat 4: e2+sK/yjnj94rXOKoxPP2A folded before Flop (didn't bet)
Seat 5: XcLXSUMHSpshK/7Lh0M4Vg folded before Flop (didn't bet)
Seat 6: 997ViqAtWn1FPjJqcffwcA folded before Flop (didn't bet)
Seat 7: mSD1pginDsyHG5PDfqzphw (button) folded before Flop (didn't bet)
Seat 8: j3K/Jujr7PY4ZM2RZvlH6A (small blind) folded before Flop



PokerStars Game #59941211956:  Hold'em No Limit ($0.25/$0.50) - 2009/07/01 1:28:51 ET
Table 'tyR5AZNKV8Aadbrnrnlg7g' 6-max Seat #3 is the button
Seat 1: BgOXYI0yYSN1ULC4FqsNkg ($91.30 in chips)
Seat 2: BAjwVL+zKKd0s0fAWstzQQ ($13.95 in chips)
Seat 3: JFLrYNyQmwPhRQAtoSAuyA ($49.90 in chips)
Seat 4: 4QfsCWthT/vSLirorNXqtg ($85.45 in chips)
Seat 5: GUnvMULl2qFOO1yenu1UBw ($78.75 in chips)
Seat 6: 498aWaGsW4uGfuWl+2FCGw ($66.05 in chips)
4QfsCWthT/vSLirorNXqtg: posts small blind $0.25
GUnvMULl2qFOO1yenu1UBw: posts big blind $0.50
*** HOLE CARDS ***
498aWaGsW4uGfuWl+2FCGw: calls $0.50
BgOXYI0yYSN1ULC4FqsNkg: calls $0.50
BAjwVL+zKKd0s0fAWstzQQ: folds
JFLrYNyQmwPhRQAtoSAuyA: raises $1.50 to $2
4QfsCWthT/vSLirorNXqtg: folds
GUnvMULl2qFOO1yenu1UBw: folds
498aWaGsW4uGfuWl+2FCGw: calls $1.50
BgOXYI0yYSN1ULC4FqsNkg: calls $1.50
*** FLOP *** [4s Kd 9d]
498aWaGsW4uGfuWl+2FCGw: checks
BgOXYI0yYSN1ULC4FqsNkg: checks
JFLrYNyQmwPhRQAtoSAuyA: bets $1
498aWaGsW4uGfuWl+2FCGw: folds
BgOXYI0yYSN1ULC4FqsNkg: calls $1
*** TURN *** [4s Kd 9d] [3s]
BgOXYI0yYSN1ULC4FqsNkg: checks
JFLrYNyQmwPhRQAtoSAuyA: bets $5
BgOXYI0yYSN1ULC4FqsNkg: calls $5
*** RIVER *** [4s Kd 9d 3s] [5h]
BgOXYI0yYSN1ULC4FqsNkg: checks
JFLrYNyQmwPhRQAtoSAuyA: checks
*** SHOW DOWN ***
BgOXYI0yYSN1ULC4FqsNkg: shows [Ts 9s] (a pair of Nines)
JFLrYNyQmwPhRQAtoSAuyA: shows [Ks Tc] (a pair of Kings)
498aWaGsW4uGfuWl+2FCGw said, "kimbo sagamore hills where?"
JFLrYNyQmwPhRQAtoSAuyA collected $17.85 from pot
*** SUMMARY ***
Total pot $18.75 | Rake $0.90
Board [4s Kd 9d 3s 5h]
Seat 1: BgOXYI0yYSN1ULC4FqsNkg showed [Ts 9s] and lost with a pair of Nines
Seat 2: BAjwVL+zKKd0s0fAWstzQQ folded before Flop (didn't bet)
Seat 3: JFLrYNyQmwPhRQAtoSAuyA (button) showed [Ks Tc] and won ($17.85) with a pair of Kings
Seat 4: 4QfsCWthT/vSLirorNXqtg (small blind) folded before Flop
Seat 5: GUnvMULl2qFOO1yenu1UBw (big blind) folded before Flop
Seat 6: 498aWaGsW4uGfuWl+2FCGw folded on the Flop



PokerStars Game #59941211740:  Hold'em No Limit ($0.25/$0.50) - 2009/07/01 1:28:51 ET
Table 'EiNh8p/wGJ1FP575iMFnqg' 9-max Seat #4 is the button
Seat 1: YFFlOZgyy1Mh4iBmuNRbmQ ($26.50 in chips)
Seat 2: 8ehL7qlZzjgUh2H35iiWLw ($64.50 in chips)
Seat 3: ymLPoEIl7UL3TvZYmnadxQ ($42.35 in chips)
Seat 4: cMzaiXAM/ZAdNaEUu+LqhA ($59.70 in chips)
Seat 5: M+7+BTmX5vZatHVuoRB1nA ($73.95 in chips)
Seat 6: viwBDtJsY6JfsFOdBAyJIQ ($9.45 in chips)
Seat 7: 997ViqAtWn1FPjJqcffwcA ($50 in chips)
Seat 8: mSD1pginDsyHG5PDfqzphw ($10 in chips)
Seat 9: GuPkZObrz5Zkkn8FsEdF9w ($35.60 in chips)
M+7+BTmX5vZatHVuoRB1nA: posts small blind $0.25
viwBDtJsY6JfsFOdBAyJIQ: posts big blind $0.50
*** HOLE CARDS ***
997ViqAtWn1FPjJqcffwcA: folds
mSD1pginDsyHG5PDfqzphw: folds
GuPkZObrz5Zkkn8FsEdF9w: folds
YFFlOZgyy1Mh4iBmuNRbmQ: folds
8ehL7qlZzjgUh2H35iiWLw: folds
ymLPoEIl7UL3TvZYmnadxQ: folds
cMzaiXAM/ZAdNaEUu+LqhA: raises $1.50 to $2
M+7+BTmX5vZatHVuoRB1nA: folds
viwBDtJsY6JfsFOdBAyJIQ: folds
cMzaiXAM/ZAdNaEUu+LqhA collected $1.25 from pot
cMzaiXAM/ZAdNaEUu+LqhA: doesn't show hand
*** SUMMARY ***
Total pot $1.25 | Rake $0
Seat 1: YFFlOZgyy1Mh4iBmuNRbmQ folded before Flop (didn't bet)
Seat 2: 8ehL7qlZzjgUh2H35iiWLw folded before Flop (didn't bet)
Seat 3: ymLPoEIl7UL3TvZYmnadxQ folded before Flop (didn't bet)
Seat 4: cMzaiXAM/ZAdNaEUu+LqhA (button) collected ($1.25)
Seat 5: M+7+BTmX5vZatHVuoRB1nA (small blind) folded before Flop
Seat 6: viwBDtJsY6JfsFOdBAyJIQ (big blind) folded before Flop
Seat 7: 997ViqAtWn1FPjJqcffwcA folded before Flop (didn't bet)
Seat 8: mSD1pginDsyHG5PDfqzphw folded before Flop (didn't bet)
Seat 9: GuPkZObrz5Zkkn8FsEdF9w folded before Flop (didn't bet)



PokerStars Game #59941212486:  Hold'em No Limit ($0.25/$0.50) - 2009/07/01 1:28:52 ET
Table 'fx6MqwfYAj/Rt86hBz2L3Q' 9-max Seat #3 is the button
Seat 1: v/4aX0ejnaIFK4ftDk2Lyg ($51.40 in chips)
Seat 2: C3rGXblctNcWI6JYPHhaEg ($34.10 in chips)
Seat 3: iadBi5AEt7gTBXbDSSnMYQ ($36.55 in chips)
Seat 5: iAISe3dVeua8PUn2wwgDHw ($70.65 in chips)
Seat 6: 5k9fvXD9suIgCxU4HLQjTw ($50 in chips)
Seat 8: JYwJYYV9pM5KWdSiETl8rA ($63 in chips)
Seat 9: vO3QVRovWemcGMkm7ijAIA ($25.70 in chips)
75K2MXwN65Sjfp1yHd50Hg was removed from the table for failing to post
iAISe3dVeua8PUn2wwgDHw: posts small blind $0.25
5k9fvXD9suIgCxU4HLQjTw: posts big blind $0.50
mSD1pginDsyHG5PDfqzphw: sits out
*** HOLE CARDS ***
JYwJYYV9pM5KWdSiETl8rA: folds
VhjwWfxHSx00WxzYih3KOA joins the table at seat #4
vO3QVRovWemcGMkm7ijAIA: folds
v/4aX0ejnaIFK4ftDk2Lyg: folds
C3rGXblctNcWI6JYPHhaEg: calls $0.50
iadBi5AEt7gTBXbDSSnMYQ: folds
iAISe3dVeua8PUn2wwgDHw: calls $0.25
5k9fvXD9suIgCxU4HLQjTw: checks
*** FLOP *** [4h 2h 5d]
iAISe3dVeua8PUn2wwgDHw: checks
5k9fvXD9suIgCxU4HLQjTw: checks
C3rGXblctNcWI6JYPHhaEg: bets $0.60
iAISe3dVeua8PUn2wwgDHw: folds
5k9fvXD9suIgCxU4HLQjTw: folds
C3rGXblctNcWI6JYPHhaEg collected $1.45 from pot
C3rGXblctNcWI6JYPHhaEg: doesn't show hand
*** SUMMARY ***
Total pot $1.50 | Rake $0.05
Board [4h 2h 5d]
Seat 1: v/4aX0ejnaIFK4ftDk2Lyg folded before Flop (didn't bet)
Seat 2: C3rGXblctNcWI6JYPHhaEg collected ($1.45)
Seat 3: iadBi5AEt7gTBXbDSSnMYQ (button) folded before Flop (didn't bet)
Seat 5: iAISe3dVeua8PUn2wwgDHw (small blind) folded on the Flop
Seat 6: 5k9fvXD9suIgCxU4HLQjTw (big blind) folded on the Flop
Seat 8: JYwJYYV9pM5KWdSiETl8rA folded before Flop (didn't bet)
Seat 9: vO3QVRovWemcGMkm7ijAIA folded before Flop (didn't bet)



PokerStars Game #59941213094:  Hold'em No Limit ($0.25/$0.50) - 2009/07/01 1:28:53 ET
Table '2lPOwetm4cfkZPbTmGPH/w' 2-max Seat #1 is the button
Seat 1: vUGdApqS8J/GJE2gaVWl1w ($7.40 in chips)
Seat 2: XFa6sBGjP2gxoIvxR3fZIg ($35.20 in chips)
vUGdApqS8J/GJE2gaVWl1w: posts small blind $0.25
XFa6sBGjP2gxoIvxR3fZIg: posts big blind $0.50
*** HOLE CARDS ***
vUGdApqS8J/GJE2gaVWl1w: calls $0.25
XFa6sBGjP2gxoIvxR3fZIg: checks
*** FLOP *** [3d Ad Qs]
XFa6sBGjP2gxoIvxR3fZIg: checks
vUGdApqS8J/GJE2gaVWl1w: checks
*** TURN *** [3d Ad Qs] [4s]
XFa6sBGjP2gxoIvxR3fZIg: bets $1
vUGdApqS8J/GJE2gaVWl1w: folds
XFa6sBGjP2gxoIvxR3fZIg collected $0.95 from pot
XFa6sBGjP2gxoIvxR3fZIg: doesn't show hand
*** SUMMARY ***
Total pot $1 | Rake $0.05
Board [3d Ad Qs 4s]
Seat 1: vUGdApqS8J/GJE2gaVWl1w (button) (small blind) folded on the Turn
Seat 2: XFa6sBGjP2gxoIvxR3fZIg (big blind) collected ($0.95)



PokerStars Game #59941213358:  Hold'em No Limit ($0.25/$0.50) - 2009/07/01 1:28:54 ET
Table '+dXkOAQyS8j9PQZusUTMpg' 2-max Seat #1 is the button
Seat 1: Teld4PDKla7C8/Wfu2DSkg ($51.35 in chips)
Seat 2: +zI4bP23YIjMkUHqeN2xfw ($25.55 in chips)
Teld4PDKla7C8/Wfu2DSkg: posts small blind $0.25
+zI4bP23YIjMkUHqeN2xfw: posts big blind $0.50
*** HOLE CARDS ***
Teld4PDKla7C8/Wfu2DSkg: folds
+zI4bP23YIjMkUHqeN2xfw collected $0.50 from pot
*** SUMMARY ***
Total pot $0.50 | Rake $0
Seat 1: Teld4PDKla7C8/Wfu2DSkg (button) (small blind) folded before Flop
Seat 2: +zI4bP23YIjMkUHqeN2xfw (big blind) collected ($0.50)



PokerStars Game #59941213512:  Hold'em No Limit ($0.25/$0.50) - 2009/07/01 1:28:54 ET
Table 'iq+aXfWVQRdV0u8SRTYUEg' 9-max Seat #3 is the button
Seat 1: 3yl8Q6QaLfGtyhN4/pEFgQ ($78.05 in chips)
Seat 2: J9N0lxHFd/Js2S0xZLbsIQ ($28.10 in chips)
Seat 3: Qi/PyOsKwaqtKIg0H+7ELg ($9 in chips)
Seat 4: vHYT5s323LpajBj+2c9zbQ ($30.70 in chips)
Seat 5: 997ViqAtWn1FPjJqcffwcA ($50 in chips)
Seat 6: bTJ0WgoxefTPxIoycS7uoA ($32.20 in chips)
Seat 7: SKnJuWHScqetA/qG5p+wCg ($31.55 in chips)
Seat 8: /DtIHuxEH+3tzKefmSV+Mw ($36.85 in chips)
Seat 9: olE1Z2rKWAV8+tGqmIBK9g ($28.45 in chips)
vHYT5s323LpajBj+2c9zbQ: posts small blind $0.25
997ViqAtWn1FPjJqcffwcA: posts big blind $0.50
*** HOLE CARDS ***
bTJ0WgoxefTPxIoycS7uoA: calls $0.50
SKnJuWHScqetA/qG5p+wCg: folds
/DtIHuxEH+3tzKefmSV+Mw: folds
olE1Z2rKWAV8+tGqmIBK9g: folds
3yl8Q6QaLfGtyhN4/pEFgQ: folds
J9N0lxHFd/Js2S0xZLbsIQ: calls $0.50
Qi/PyOsKwaqtKIg0H+7ELg: folds
vHYT5s323LpajBj+2c9zbQ: calls $0.25
997ViqAtWn1FPjJqcffwcA: checks
*** FLOP *** [6h 6d 3h]
vHYT5s323LpajBj+2c9zbQ: bets $1.50
997ViqAtWn1FPjJqcffwcA: folds
bTJ0WgoxefTPxIoycS7uoA: folds
J9N0lxHFd/Js2S0xZLbsIQ: folds
vHYT5s323LpajBj+2c9zbQ collected $1.90 from pot
vHYT5s323LpajBj+2c9zbQ: doesn't show hand
*** SUMMARY ***
Total pot $2 | Rake $0.10
Board [6h 6d 3h]
Seat 1: 3yl8Q6QaLfGtyhN4/pEFgQ folded before Flop (didn't bet)
Seat 2: J9N0lxHFd/Js2S0xZLbsIQ folded on the Flop
Seat 3: Qi/PyOsKwaqtKIg0H+7ELg (button) folded before Flop (didn't bet)
Seat 4: vHYT5s323LpajBj+2c9zbQ (small blind) collected ($1.90)
Seat 5: 997ViqAtWn1FPjJqcffwcA (big blind) folded on the Flop
Seat 6: bTJ0WgoxefTPxIoycS7uoA folded on the Flop
Seat 7: SKnJuWHScqetA/qG5p+wCg folded before Flop (didn't bet)
Seat 8: /DtIHuxEH+3tzKefmSV+Mw folded before Flop (didn't bet)
Seat 9: olE1Z2rKWAV8+tGqmIBK9g folded before Flop (didn't bet)



PokerStars Game #59941214744:  Hold'em No Limit ($0.25/$0.50) - 2009/07/01 1:28:56 ET
Table '9ojijpRcYQSQTh6xI+haUA' 2-max Seat #2 is the button
Seat 1: FqpibuVWLNsAN/Z7ROZLnA ($46 in chips)
Seat 2: TitTV+fFCcBZWOERdytydA ($40.40 in chips)
TitTV+fFCcBZWOERdytydA: posts small blind $0.25
FqpibuVWLNsAN/Z7ROZLnA: posts big blind $0.50
*** HOLE CARDS ***
TitTV+fFCcBZWOERdytydA: raises $0.50 to $1
FqpibuVWLNsAN/Z7ROZLnA: folds
TitTV+fFCcBZWOERdytydA collected $1 from pot
TitTV+fFCcBZWOERdytydA: doesn't show hand
*** SUMMARY ***
Total pot $1 | Rake $0
Seat 1: FqpibuVWLNsAN/Z7ROZLnA (big blind) folded before Flop
Seat 2: TitTV+fFCcBZWOERdytydA (button) (small blind) collected ($1)



PokerStars Game #59941214442:  Hold'em No Limit ($0.25/$0.50) - 2009/07/01 1:28:56 ET
Table 'lSisgp6H7Fg1hH5VfjEjYQ' 9-max Seat #6 is the button
Seat 1: 5k9fvXD9suIgCxU4HLQjTw ($53.35 in chips)
Seat 3: SKnJuWHScqetA/qG5p+wCg ($30 in chips)
Seat 4: bwv/rbH/hHhPhY6u9mu04w ($37.40 in chips)
Seat 5: mSD1pginDsyHG5PDfqzphw ($12.25 in chips)
Seat 6: +k7T5ocke8UwavtgUHm+Cg ($70.15 in chips)
Seat 7: IDtNLR9uFCDdjNsJWMHA5Q ($20.60 in chips)
Seat 8: a4JDWmpFQkL10XfAyuF51A ($12.25 in chips)
Seat 9: YzeKFbJVLmJGTgNH3ySQlw ($9.20 in chips)
IDtNLR9uFCDdjNsJWMHA5Q: posts small blind $0.25
a4JDWmpFQkL10XfAyuF51A: posts big blind $0.50
5acK4E7fzEwnplVBZ6eNWA: sits out
*** HOLE CARDS ***
YzeKFbJVLmJGTgNH3ySQlw: folds
5k9fvXD9suIgCxU4HLQjTw: folds
SKnJuWHScqetA/qG5p+wCg: folds
bwv/rbH/hHhPhY6u9mu04w: folds
mSD1pginDsyHG5PDfqzphw: folds
+k7T5ocke8UwavtgUHm+Cg: raises $1.50 to $2
IDtNLR9uFCDdjNsJWMHA5Q: folds
a4JDWmpFQkL10XfAyuF51A: calls $1.50
*** FLOP *** [Jc 5h 4s]
a4JDWmpFQkL10XfAyuF51A: checks
+k7T5ocke8UwavtgUHm+Cg: bets $1
a4JDWmpFQkL10XfAyuF51A: folds
+k7T5ocke8UwavtgUHm+Cg collected $4.05 from pot
+k7T5ocke8UwavtgUHm+Cg: doesn't show hand
*** SUMMARY ***
Total pot $4.25 | Rake $0.20
Board [Jc 5h 4s]
Seat 1: 5k9fvXD9suIgCxU4HLQjTw folded before Flop (didn't bet)
Seat 3: SKnJuWHScqetA/qG5p+wCg folded before Flop (didn't bet)
Seat 4: bwv/rbH/hHhPhY6u9mu04w folded before Flop (didn't bet)
Seat 5: mSD1pginDsyHG5PDfqzphw folded before Flop (didn't bet)
Seat 6: +k7T5ocke8UwavtgUHm+Cg (button) collected ($4.05)
Seat 7: IDtNLR9uFCDdjNsJWMHA5Q (small blind) folded before Flop
Seat 8: a4JDWmpFQkL10XfAyuF51A (big blind) folded on the Flop
Seat 9: YzeKFbJVLmJGTgNH3ySQlw folded before Flop (didn't bet)



PokerStars Game #59941215388:  Hold'em No Limit ($0.25/$0.50) - 2009/07/01 1:28:57 ET
Table 'hWT2kq66tnKEpD26cia6fQ' 2-max Seat #1 is the button
Seat 1: Ce3KNFP+ao7Da9NHb65raw ($29.95 in chips)
Seat 2: 16tvT7AYgZ2LgiGFcvFKQg ($46.95 in chips)
Ce3KNFP+ao7Da9NHb65raw: posts small blind $0.25
16tvT7AYgZ2LgiGFcvFKQg: posts big blind $0.50
*** HOLE CARDS ***
Ce3KNFP+ao7Da9NHb65raw: calls $0.25
16tvT7AYgZ2LgiGFcvFKQg: checks
*** FLOP *** [7h Qs 6d]
16tvT7AYgZ2LgiGFcvFKQg: checks
Ce3KNFP+ao7Da9NHb65raw: checks
*** TURN *** [7h Qs 6d] [7s]
16tvT7AYgZ2LgiGFcvFKQg: checks
Ce3KNFP+ao7Da9NHb65raw: checks
*** RIVER *** [7h Qs 6d 7s] [Qd]
16tvT7AYgZ2LgiGFcvFKQg: checks
Ce3KNFP+ao7Da9NHb65raw: checks
*** SHOW DOWN ***
16tvT7AYgZ2LgiGFcvFKQg: shows [3h Ad] (two pair, Queens and Sevens)
Ce3KNFP+ao7Da9NHb65raw: mucks hand
16tvT7AYgZ2LgiGFcvFKQg collected $0.95 from pot
*** SUMMARY ***
Total pot $1 | Rake $0.05
Board [7h Qs 6d 7s Qd]
Seat 1: Ce3KNFP+ao7Da9NHb65raw (button) (small blind) mucked
Seat 2: 16tvT7AYgZ2LgiGFcvFKQg (big blind) showed [3h Ad] and won ($0.95) with two pair, Queens and Sevens



PokerStars Game #59941216860:  Hold'em No Limit ($0.25/$0.50) - 2009/07/01 1:29:00 ET
Table '+dXkOAQyS8j9PQZusUTMpg' 2-max Seat #2 is the button
Seat 1: Teld4PDKla7C8/Wfu2DSkg ($51.10 in chips)
Seat 2: +zI4bP23YIjMkUHqeN2xfw ($25.80 in chips)
+zI4bP23YIjMkUHqeN2xfw: posts small blind $0.25
Teld4PDKla7C8/Wfu2DSkg: posts big blind $0.50
*** HOLE CARDS ***
+zI4bP23YIjMkUHqeN2xfw: calls $0.25
Teld4PDKla7C8/Wfu2DSkg: checks
*** FLOP *** [9d Qc 4h]
Teld4PDKla7C8/Wfu2DSkg: bets $0.50
+zI4bP23YIjMkUHqeN2xfw: calls $0.50
*** TURN *** [9d Qc 4h] [Jc]
Teld4PDKla7C8/Wfu2DSkg: checks
+zI4bP23YIjMkUHqeN2xfw: bets $1
Teld4PDKla7C8/Wfu2DSkg: folds
+zI4bP23YIjMkUHqeN2xfw collected $1.95 from pot
+zI4bP23YIjMkUHqeN2xfw: doesn't show hand
*** SUMMARY ***
Total pot $2 | Rake $0.05
Board [9d Qc 4h Jc]
Seat 1: Teld4PDKla7C8/Wfu2DSkg (big blind) folded on the Turn
Seat 2: +zI4bP23YIjMkUHqeN2xfw (button) (small blind) collected ($1.95)



PokerStars Game #59941220298:  Hold'em No Limit ($0.25/$0.50) - 2009/07/01 1:29:06 ET
Table 'B+sqsfj6d6zXicNfaseTaw' 2-max Seat #2 is the button
Seat 1: +4GNcSsecmapVGSdV0mUPA ($135.60 in chips)
Seat 2: Lv5RmpRe6LtPkBzM9Gpo5A ($89.70 in chips)
Lv5RmpRe6LtPkBzM9Gpo5A: posts small blind $0.25
+4GNcSsecmapVGSdV0mUPA: posts big blind $0.50
*** HOLE CARDS ***
Lv5RmpRe6LtPkBzM9Gpo5A: raises $1.50 to $2
+4GNcSsecmapVGSdV0mUPA: calls $1.50
*** FLOP *** [6c 9s Jc]
+4GNcSsecmapVGSdV0mUPA: checks
Lv5RmpRe6LtPkBzM9Gpo5A: checks
*** TURN *** [6c 9s Jc] [4s]
+4GNcSsecmapVGSdV0mUPA: checks
Lv5RmpRe6LtPkBzM9Gpo5A: checks
*** RIVER *** [6c 9s Jc 4s] [9c]
+4GNcSsecmapVGSdV0mUPA: checks
Lv5RmpRe6LtPkBzM9Gpo5A: checks
*** SHOW DOWN ***
+4GNcSsecmapVGSdV0mUPA: shows [Qh 5h] (a pair of Nines)
Lv5RmpRe6LtPkBzM9Gpo5A: shows [8s Ad] (a pair of Nines - Ace kicker)
Lv5RmpRe6LtPkBzM9Gpo5A collected $3.80 from pot
*** SUMMARY ***
Total pot $4 | Rake $0.20
Board [6c 9s Jc 4s 9c]
Seat 1: +4GNcSsecmapVGSdV0mUPA (big blind) showed [Qh 5h] and lost with a pair of Nines
Seat 2: Lv5RmpRe6LtPkBzM9Gpo5A (button) (small blind) showed [8s Ad] and won ($3.80) with a pair of Nines



PokerStars Game #59941220794:  Hold'em No Limit ($0.25/$0.50) - 2009/07/01 1:29:07 ET
Table '8BQGgNetI1NOvWeu3gtMNw' 2-max Seat #1 is the button
Seat 1: bypIyrYcAAifLfhZpGlKLA ($64.40 in chips)
Seat 2: Z4HwehErEwzsv/noQlfUlg ($153.70 in chips)
bypIyrYcAAifLfhZpGlKLA: posts small blind $0.25
Z4HwehErEwzsv/noQlfUlg: posts big blind $0.50
*** HOLE CARDS ***
bypIyrYcAAifLfhZpGlKLA: raises $1 to $1.50
Z4HwehErEwzsv/noQlfUlg: calls $1
*** FLOP *** [Th Qs 4h]
Z4HwehErEwzsv/noQlfUlg: checks
bypIyrYcAAifLfhZpGlKLA: bets $2
Z4HwehErEwzsv/noQlfUlg: calls $2
*** TURN *** [Th Qs 4h] [8s]
Z4HwehErEwzsv/noQlfUlg: checks
bypIyrYcAAifLfhZpGlKLA: checks
*** RIVER *** [Th Qs 4h 8s] [8c]
Z4HwehErEwzsv/noQlfUlg: bets $4
bypIyrYcAAifLfhZpGlKLA: calls $4
*** SHOW DOWN ***
Z4HwehErEwzsv/noQlfUlg: shows [4c 3c] (two pair, Eights and Fours)
bypIyrYcAAifLfhZpGlKLA: mucks hand
Z4HwehErEwzsv/noQlfUlg collected $14.50 from pot
*** SUMMARY ***
Total pot $15 | Rake $0.50
Board [Th Qs 4h 8s 8c]
Seat 1: bypIyrYcAAifLfhZpGlKLA (button) (small blind) mucked
Seat 2: Z4HwehErEwzsv/noQlfUlg (big blind) showed [4c 3c] and won ($14.50) with two pair, Eights and Fours



PokerStars Game #59941221416:  Hold'em No Limit ($0.25/$0.50) - 2009/07/01 1:29:08 ET
Table '9ojijpRcYQSQTh6xI+haUA' 2-max Seat #1 is the button
Seat 1: FqpibuVWLNsAN/Z7ROZLnA ($45.50 in chips)
Seat 2: TitTV+fFCcBZWOERdytydA ($40.90 in chips)
FqpibuVWLNsAN/Z7ROZLnA: posts small blind $0.25
TitTV+fFCcBZWOERdytydA: posts big blind $0.50
*** HOLE CARDS ***
FqpibuVWLNsAN/Z7ROZLnA: raises $0.50 to $1
TitTV+fFCcBZWOERdytydA: folds
FqpibuVWLNsAN/Z7ROZLnA collected $1 from pot
*** SUMMARY ***
Total pot $1 | Rake $0
Seat 1: FqpibuVWLNsAN/Z7ROZLnA (button) (small blind) collected ($1)
Seat 2: TitTV+fFCcBZWOERdytydA (big blind) folded before Flop



PokerStars Game #59941222286:  Hold'em No Limit ($0.25/$0.50) - 2009/07/01 1:29:09 ET
Table '2lPOwetm4cfkZPbTmGPH/w' 2-max Seat #2 is the button
Seat 1: vUGdApqS8J/GJE2gaVWl1w ($6.90 in chips)
Seat 2: XFa6sBGjP2gxoIvxR3fZIg ($35.65 in chips)
XFa6sBGjP2gxoIvxR3fZIg: posts small blind $0.25
vUGdApqS8J/GJE2gaVWl1w: posts big blind $0.50
*** HOLE CARDS ***
XFa6sBGjP2gxoIvxR3fZIg: calls $0.25
vUGdApqS8J/GJE2gaVWl1w: checks
*** FLOP *** [8s Tc 2d]
vUGdApqS8J/GJE2gaVWl1w: checks
XFa6sBGjP2gxoIvxR3fZIg: bets $1
vUGdApqS8J/GJE2gaVWl1w: folds
XFa6sBGjP2gxoIvxR3fZIg collected $0.95 from pot
*** SUMMARY ***
Total pot $1 | Rake $0.05
Board [8s Tc 2d]
Seat 1: vUGdApqS8J/GJE2gaVWl1w (big blind) folded on the Flop
Seat 2: XFa6sBGjP2gxoIvxR3fZIg (button) (small blind) collected ($0.95)



PokerStars Game #59941222766:  Hold'em No Limit ($0.25/$0.50) - 2009/07/01 1:29:10 ET
Table '+z1aekfHkpp09pc8F9aViw' 6-max Seat #6 is the button
Seat 1: /DArfRoYc3YpLsOQSZubFg ($50 in chips)
Seat 2: 4QfsCWthT/vSLirorNXqtg ($50 in chips)
Seat 3: URYNc7fPA23K2UfadQbnCA ($49.25 in chips)
Seat 5: 2igtJLmvIZ+HqX4XPgMPZA ($53.70 in chips)
Seat 6: GUnvMULl2qFOO1yenu1UBw ($51.50 in chips)
/DArfRoYc3YpLsOQSZubFg: posts small blind $0.25
4QfsCWthT/vSLirorNXqtg: posts big blind $0.50
*** HOLE CARDS ***
URYNc7fPA23K2UfadQbnCA: folds
2igtJLmvIZ+HqX4XPgMPZA: folds
GUnvMULl2qFOO1yenu1UBw: raises $1 to $1.50
/DArfRoYc3YpLsOQSZubFg: folds
4QfsCWthT/vSLirorNXqtg: folds
GUnvMULl2qFOO1yenu1UBw collected $1.25 from pot
*** SUMMARY ***
Total pot $1.25 | Rake $0
Seat 1: /DArfRoYc3YpLsOQSZubFg (small blind) folded before Flop
Seat 2: 4QfsCWthT/vSLirorNXqtg (big blind) folded before Flop
Seat 3: URYNc7fPA23K2UfadQbnCA folded before Flop (didn't bet)
Seat 5: 2igtJLmvIZ+HqX4XPgMPZA folded before Flop (didn't bet)
Seat 6: GUnvMULl2qFOO1yenu1UBw (button) collected ($1.25)



PokerStars Game #59941226174:  Hold'em No Limit ($0.25/$0.50) - 2009/07/01 1:29:16 ET
Table 'hSTs/dUsYLgJQuF2Onp0MQ' 6-max Seat #4 is the button
Seat 1: 1WUCqNG+p+vfWRTXNu4ljw ($50 in chips)
Seat 2: Hdd4js36ITbTJ/QuVYwTlA ($53.50 in chips)
Seat 3: lxIzoHy0RnkfFSODHC2liw ($53.20 in chips)
Seat 4: 2igtJLmvIZ+HqX4XPgMPZA ($79.40 in chips)
Seat 6: M1KyQQvVPVuxqTAB8sR/zQ ($94.05 in chips)
M1KyQQvVPVuxqTAB8sR/zQ: posts small blind $0.25
1WUCqNG+p+vfWRTXNu4ljw: posts big blind $0.50
*** HOLE CARDS ***
Hdd4js36ITbTJ/QuVYwTlA: raises $1.50 to $2
lxIzoHy0RnkfFSODHC2liw: folds
2igtJLmvIZ+HqX4XPgMPZA: folds
M1KyQQvVPVuxqTAB8sR/zQ: folds
1WUCqNG+p+vfWRTXNu4ljw: folds
Hdd4js36ITbTJ/QuVYwTlA collected $1.25 from pot
*** SUMMARY ***
Total pot $1.25 | Rake $0
Seat 1: 1WUCqNG+p+vfWRTXNu4ljw (big blind) folded before Flop
Seat 2: Hdd4js36ITbTJ/QuVYwTlA collected ($1.25)
Seat 3: lxIzoHy0RnkfFSODHC2liw folded before Flop (didn't bet)
Seat 4: 2igtJLmvIZ+HqX4XPgMPZA (button) folded before Flop (didn't bet)
Seat 6: M1KyQQvVPVuxqTAB8sR/zQ (small blind) folded before Flop



PokerStars Game #59941226708:  Hold'em No Limit ($0.25/$0.50) - 2009/07/01 1:29:17 ET
Table 'EiNh8p/wGJ1FP575iMFnqg' 9-max Seat #5 is the button
Seat 1: YFFlOZgyy1Mh4iBmuNRbmQ ($26.50 in chips)
Seat 2: 8ehL7qlZzjgUh2H35iiWLw ($64.50 in chips)
Seat 3: ymLPoEIl7UL3TvZYmnadxQ ($42.35 in chips)
Seat 4: cMzaiXAM/ZAdNaEUu+LqhA ($60.45 in chips)
Seat 5: M+7+BTmX5vZatHVuoRB1nA ($73.70 in chips)
Seat 6: viwBDtJsY6JfsFOdBAyJIQ ($8.95 in chips)
Seat 7: 997ViqAtWn1FPjJqcffwcA ($50 in chips)
Seat 8: mSD1pginDsyHG5PDfqzphw ($10 in chips)
Seat 9: GuPkZObrz5Zkkn8FsEdF9w ($35.60 in chips)
viwBDtJsY6JfsFOdBAyJIQ: posts small blind $0.25
997ViqAtWn1FPjJqcffwcA: posts big blind $0.50
*** HOLE CARDS ***
mSD1pginDsyHG5PDfqzphw: folds
GuPkZObrz5Zkkn8FsEdF9w: folds
YFFlOZgyy1Mh4iBmuNRbmQ: calls $0.50
8ehL7qlZzjgUh2H35iiWLw: folds
ymLPoEIl7UL3TvZYmnadxQ: folds
cMzaiXAM/ZAdNaEUu+LqhA: calls $0.50
M+7+BTmX5vZatHVuoRB1nA: calls $0.50
viwBDtJsY6JfsFOdBAyJIQ: calls $0.25
997ViqAtWn1FPjJqcffwcA: checks
*** FLOP *** [4h Jc 7s]
viwBDtJsY6JfsFOdBAyJIQ: checks
997ViqAtWn1FPjJqcffwcA: checks
YFFlOZgyy1Mh4iBmuNRbmQ: checks
cMzaiXAM/ZAdNaEUu+LqhA: bets $1.50
M+7+BTmX5vZatHVuoRB1nA: folds
viwBDtJsY6JfsFOdBAyJIQ: folds
997ViqAtWn1FPjJqcffwcA: folds
YFFlOZgyy1Mh4iBmuNRbmQ: calls $1.50
*** TURN *** [4h Jc 7s] [Kh]
YFFlOZgyy1Mh4iBmuNRbmQ: bets $3
cMzaiXAM/ZAdNaEUu+LqhA: folds
YFFlOZgyy1Mh4iBmuNRbmQ collected $5.25 from pot
YFFlOZgyy1Mh4iBmuNRbmQ: doesn't show hand
*** SUMMARY ***
Total pot $5.50 | Rake $0.25
Board [4h Jc 7s Kh]
Seat 1: YFFlOZgyy1Mh4iBmuNRbmQ collected ($5.25)
Seat 2: 8ehL7qlZzjgUh2H35iiWLw folded before Flop (didn't bet)
Seat 3: ymLPoEIl7UL3TvZYmnadxQ folded before Flop (didn't bet)
Seat 4: cMzaiXAM/ZAdNaEUu+LqhA folded on the Turn
Seat 5: M+7+BTmX5vZatHVuoRB1nA (button) folded on the Flop
Seat 6: viwBDtJsY6JfsFOdBAyJIQ (small blind) folded on the Flop
Seat 7: 997ViqAtWn1FPjJqcffwcA (big blind) folded on the Flop
Seat 8: mSD1pginDsyHG5PDfqzphw folded before Flop (didn't bet)
Seat 9: GuPkZObrz5Zkkn8FsEdF9w folded before Flop (didn't bet)



PokerStars Game #59941226732:  Hold'em No Limit ($0.25/$0.50) - 2009/07/01 1:29:17 ET
Table '+dXkOAQyS8j9PQZusUTMpg' 2-max Seat #1 is the button
Seat 1: Teld4PDKla7C8/Wfu2DSkg ($50.10 in chips)
Seat 2: +zI4bP23YIjMkUHqeN2xfw ($26.75 in chips)
Teld4PDKla7C8/Wfu2DSkg: posts small blind $0.25
+zI4bP23YIjMkUHqeN2xfw: posts big blind $0.50
*** HOLE CARDS ***
Teld4PDKla7C8/Wfu2DSkg: raises $1 to $1.50
+zI4bP23YIjMkUHqeN2xfw: calls $1
*** FLOP *** [8s 2h 8d]
+zI4bP23YIjMkUHqeN2xfw: checks
Teld4PDKla7C8/Wfu2DSkg: checks
*** TURN *** [8s 2h 8d] [3d]
+zI4bP23YIjMkUHqeN2xfw: checks
Teld4PDKla7C8/Wfu2DSkg: checks
*** RIVER *** [8s 2h 8d 3d] [Jc]
+zI4bP23YIjMkUHqeN2xfw: checks
Teld4PDKla7C8/Wfu2DSkg: bets $4
+zI4bP23YIjMkUHqeN2xfw: folds
Teld4PDKla7C8/Wfu2DSkg collected $2.85 from pot
Teld4PDKla7C8/Wfu2DSkg: doesn't show hand
*** SUMMARY ***
Total pot $3 | Rake $0.15
Board [8s 2h 8d 3d Jc]
Seat 1: Teld4PDKla7C8/Wfu2DSkg (button) (small blind) collected ($2.85)
Seat 2: +zI4bP23YIjMkUHqeN2xfw (big blind) folded on the River



PokerStars Game #59941227774:  Hold'em No Limit ($0.25/$0.50) - 2009/07/01 1:29:18 ET
Table 'kgbJRsxfv64KrErDRBAkcw' 6-max Seat #3 is the button
Seat 1: VamsyhlFzXGF6/ydo0BHeA ($11.65 in chips)
Seat 2: AdS8BJMOheS01zjCDfPMFg ($63 in chips)
Seat 3: c4MNIaIyPMOMxrgT8FT5nA ($228.95 in chips)
Seat 4: 2igtJLmvIZ+HqX4XPgMPZA ($59.30 in chips)
Seat 5: eUBBn2R56C1IQ6Cs/vitwg ($55.20 in chips)
Seat 6: 1b+2BbjMN8qhR1WPqdE9VQ ($55.90 in chips)
2igtJLmvIZ+HqX4XPgMPZA: posts small blind $0.25
eUBBn2R56C1IQ6Cs/vitwg: posts big blind $0.50
*** HOLE CARDS ***
1b+2BbjMN8qhR1WPqdE9VQ: folds
VamsyhlFzXGF6/ydo0BHeA: calls $0.50
AdS8BJMOheS01zjCDfPMFg: folds
c4MNIaIyPMOMxrgT8FT5nA: calls $0.50
2igtJLmvIZ+HqX4XPgMPZA: raises $3 to $3.50
eUBBn2R56C1IQ6Cs/vitwg: raises $5.50 to $9
VamsyhlFzXGF6/ydo0BHeA: folds
c4MNIaIyPMOMxrgT8FT5nA: folds
c4MNIaIyPMOMxrgT8FT5nA is sitting out
2igtJLmvIZ+HqX4XPgMPZA: calls $5.50
*** FLOP *** [3h Jd 7d]
2igtJLmvIZ+HqX4XPgMPZA: checks
eUBBn2R56C1IQ6Cs/vitwg: bets $12
2igtJLmvIZ+HqX4XPgMPZA: calls $12
*** TURN *** [3h Jd 7d] [9c]
2igtJLmvIZ+HqX4XPgMPZA: checks
eUBBn2R56C1IQ6Cs/vitwg: bets $34.20 and is all-in
2igtJLmvIZ+HqX4XPgMPZA: calls $34.20
*** RIVER *** [3h Jd 7d 9c] [Qs]
*** SHOW DOWN ***
2igtJLmvIZ+HqX4XPgMPZA: shows [Qh Qc] (three of a kind, Queens)
eUBBn2R56C1IQ6Cs/vitwg: mucks hand
2igtJLmvIZ+HqX4XPgMPZA collected $108.40 from pot
c4MNIaIyPMOMxrgT8FT5nA has returned
*** SUMMARY ***
Total pot $111.40 | Rake $3
Board [3h Jd 7d 9c Qs]
Seat 1: VamsyhlFzXGF6/ydo0BHeA folded before Flop
Seat 2: AdS8BJMOheS01zjCDfPMFg folded before Flop (didn't bet)
Seat 3: c4MNIaIyPMOMxrgT8FT5nA (button) folded before Flop
Seat 4: 2igtJLmvIZ+HqX4XPgMPZA (small blind) showed [Qh Qc] and won ($108.40) with three of a kind, Queens
Seat 5: eUBBn2R56C1IQ6Cs/vitwg (big blind) mucked
Seat 6: 1b+2BbjMN8qhR1WPqdE9VQ folded before Flop (didn't bet)



PokerStars Game #59941228170:  Hold'em No Limit ($0.25/$0.50) - 2009/07/01 1:29:19 ET
Table '9ojijpRcYQSQTh6xI+haUA' 2-max Seat #2 is the button
Seat 1: FqpibuVWLNsAN/Z7ROZLnA ($46 in chips)
Seat 2: TitTV+fFCcBZWOERdytydA ($40.40 in chips)
TitTV+fFCcBZWOERdytydA: posts small blind $0.25
FqpibuVWLNsAN/Z7ROZLnA: posts big blind $0.50
*** HOLE CARDS ***
TitTV+fFCcBZWOERdytydA: raises $0.50 to $1
FqpibuVWLNsAN/Z7ROZLnA: calls $0.50
*** FLOP *** [4s 9h 6c]
FqpibuVWLNsAN/Z7ROZLnA: checks
TitTV+fFCcBZWOERdytydA: bets $2
FqpibuVWLNsAN/Z7ROZLnA: folds
TitTV+fFCcBZWOERdytydA collected $1.90 from pot
TitTV+fFCcBZWOERdytydA: doesn't show hand
*** SUMMARY ***
Total pot $2 | Rake $0.10
Board [4s 9h 6c]
Seat 1: FqpibuVWLNsAN/Z7ROZLnA (big blind) folded on the Flop
Seat 2: TitTV+fFCcBZWOERdytydA (button) (small blind) collected ($1.90)



PokerStars Game #59941228958:  Hold'em No Limit ($0.25/$0.50) - 2009/07/01 1:29:20 ET
Table '3FhG0gl3kMX3wBEEqj+wnQ' 9-max Seat #8 is the button
Seat 1: bxLSulbgr8LmKNjOzw8URg ($49.55 in chips)
Seat 2: vacmVLJJECYI6HjAynFcpg ($50.60 in chips)
Seat 3: YXCE3WOZi8g2sIf3y/plVw ($59.75 in chips)
Seat 4: e2+sK/yjnj94rXOKoxPP2A ($70.25 in chips)
Seat 5: XcLXSUMHSpshK/7Lh0M4Vg ($9.25 in chips)
Seat 6: 997ViqAtWn1FPjJqcffwcA ($109.80 in chips)
Seat 7: mSD1pginDsyHG5PDfqzphw ($12.50 in chips)
Seat 8: j3K/Jujr7PY4ZM2RZvlH6A ($43.85 in chips)
bxLSulbgr8LmKNjOzw8URg: posts small blind $0.25
vacmVLJJECYI6HjAynFcpg: posts big blind $0.50
*** HOLE CARDS ***
YXCE3WOZi8g2sIf3y/plVw: folds
e2+sK/yjnj94rXOKoxPP2A: folds
XcLXSUMHSpshK/7Lh0M4Vg: folds
997ViqAtWn1FPjJqcffwcA: folds
mSD1pginDsyHG5PDfqzphw: folds
j3K/Jujr7PY4ZM2RZvlH6A: raises $2 to $2.50
bxLSulbgr8LmKNjOzw8URg: folds
vacmVLJJECYI6HjAynFcpg: folds
j3K/Jujr7PY4ZM2RZvlH6A collected $1.25 from pot
j3K/Jujr7PY4ZM2RZvlH6A: doesn't show hand
*** SUMMARY ***
Total pot $1.25 | Rake $0
Seat 1: bxLSulbgr8LmKNjOzw8URg (small blind) folded before Flop
Seat 2: vacmVLJJECYI6HjAynFcpg (big blind) folded before Flop
Seat 3: YXCE3WOZi8g2sIf3y/plVw folded before Flop (didn't bet)
Seat 4: e2+sK/yjnj94rXOKoxPP2A folded before Flop (didn't bet)
Seat 5: XcLXSUMHSpshK/7Lh0M4Vg folded before Flop (didn't bet)
Seat 6: 997ViqAtWn1FPjJqcffwcA folded before Flop (didn't bet)
Seat 7: mSD1pginDsyHG5PDfqzphw folded before Flop (didn't bet)
Seat 8: j3K/Jujr7PY4ZM2RZvlH6A (button) collected ($1.25)



PokerStars Game #59941229032:  Hold'em No Limit ($0.25/$0.50) - 2009/07/01 1:29:21 ET
Table 'BCN5su+SsXiy1zRMJi0SJw' 6-max Seat #3 is the button
Seat 1: GxXV09ciXaOxyY2H5aMIIw ($32.80 in chips)
Seat 2: ehFNAevCQri3trWxV6FJdA ($60.95 in chips)
Seat 3: kwgv5lNhiFrfONXCshzxlA ($43.10 in chips)
Seat 4: bbsK8j+tpuVRhBqDzHxf7w ($49.50 in chips)
Seat 5: kxPhs4ePFqMy52CInAJ2aw ($52.05 in chips)
Seat 6: b2symlOdL7+0c9Pj4N/KlA ($66.65 in chips)
bbsK8j+tpuVRhBqDzHxf7w: posts small blind $0.25
kxPhs4ePFqMy52CInAJ2aw: posts big blind $0.50
*** HOLE CARDS ***
b2symlOdL7+0c9Pj4N/KlA: folds
GxXV09ciXaOxyY2H5aMIIw: folds
ehFNAevCQri3trWxV6FJdA: calls $0.50
kwgv5lNhiFrfONXCshzxlA: folds
bbsK8j+tpuVRhBqDzHxf7w: calls $0.25
kxPhs4ePFqMy52CInAJ2aw: checks
*** FLOP *** [6s 5h 7s]
bbsK8j+tpuVRhBqDzHxf7w: checks
kxPhs4ePFqMy52CInAJ2aw: checks
ehFNAevCQri3trWxV6FJdA: bets $1
bbsK8j+tpuVRhBqDzHxf7w: folds
kxPhs4ePFqMy52CInAJ2aw: folds
ehFNAevCQri3trWxV6FJdA collected $1.45 from pot
*** SUMMARY ***
Total pot $1.50 | Rake $0.05
Board [6s 5h 7s]
Seat 1: GxXV09ciXaOxyY2H5aMIIw folded before Flop (didn't bet)
Seat 2: ehFNAevCQri3trWxV6FJdA collected ($1.45)
Seat 3: kwgv5lNhiFrfONXCshzxlA (button) folded before Flop (didn't bet)
Seat 4: bbsK8j+tpuVRhBqDzHxf7w (small blind) folded on the Flop
Seat 5: kxPhs4ePFqMy52CInAJ2aw (big blind) folded on the Flop
Seat 6: b2symlOdL7+0c9Pj4N/KlA folded before Flop (didn't bet)



PokerStars Game #59941229674:  Hold'em No Limit ($0.25/$0.50) - 2009/07/01 1:29:22 ET
Table '2lPOwetm4cfkZPbTmGPH/w' 2-max Seat #1 is the button
Seat 1: vUGdApqS8J/GJE2gaVWl1w ($6.40 in chips)
Seat 2: XFa6sBGjP2gxoIvxR3fZIg ($36.10 in chips)
vUGdApqS8J/GJE2gaVWl1w: posts small blind $0.25
XFa6sBGjP2gxoIvxR3fZIg: posts big blind $0.50
*** HOLE CARDS ***
vUGdApqS8J/GJE2gaVWl1w: raises $1 to $1.50
XFa6sBGjP2gxoIvxR3fZIg: folds
vUGdApqS8J/GJE2gaVWl1w collected $1 from pot
*** SUMMARY ***
Total pot $1 | Rake $0
Seat 1: vUGdApqS8J/GJE2gaVWl1w (button) (small blind) collected ($1)
Seat 2: XFa6sBGjP2gxoIvxR3fZIg (big blind) folded before Flop



PokerStars Game #59941231654:  Hold'em No Limit ($0.25/$0.50) - 2009/07/01 1:29:25 ET
Table 'hWT2kq66tnKEpD26cia6fQ' 2-max Seat #2 is the button
Seat 1: Ce3KNFP+ao7Da9NHb65raw ($29.45 in chips)
Seat 2: 16tvT7AYgZ2LgiGFcvFKQg ($47.40 in chips)
16tvT7AYgZ2LgiGFcvFKQg: posts small blind $0.25
Ce3KNFP+ao7Da9NHb65raw: posts big blind $0.50
*** HOLE CARDS ***
16tvT7AYgZ2LgiGFcvFKQg: calls $0.25
Ce3KNFP+ao7Da9NHb65raw: raises $1 to $1.50
16tvT7AYgZ2LgiGFcvFKQg: calls $1
*** FLOP *** [As 6c 6d]
Ce3KNFP+ao7Da9NHb65raw: bets $2
16tvT7AYgZ2LgiGFcvFKQg: folds
Ce3KNFP+ao7Da9NHb65raw collected $2.85 from pot
*** SUMMARY ***
Total pot $3 | Rake $0.15
Board [As 6c 6d]
Seat 1: Ce3KNFP+ao7Da9NHb65raw (big blind) collected ($2.85)
Seat 2: 16tvT7AYgZ2LgiGFcvFKQg (button) (small blind) folded on the Flop



PokerStars Game #59941232034:  Hold'em No Limit ($0.25/$0.50) - 2009/07/01 1:29:26 ET
Table 'fx6MqwfYAj/Rt86hBz2L3Q' 9-max Seat #5 is the button
Seat 1: v/4aX0ejnaIFK4ftDk2Lyg ($51.40 in chips)
Seat 2: C3rGXblctNcWI6JYPHhaEg ($35.05 in chips)
Seat 3: iadBi5AEt7gTBXbDSSnMYQ ($36.55 in chips)
Seat 4: VhjwWfxHSx00WxzYih3KOA ($50 in chips)
Seat 5: iAISe3dVeua8PUn2wwgDHw ($70.15 in chips)
Seat 6: 5k9fvXD9suIgCxU4HLQjTw ($50 in chips)
Seat 7: mSD1pginDsyHG5PDfqzphw ($10 in chips)
Seat 8: JYwJYYV9pM5KWdSiETl8rA ($63 in chips)
Seat 9: vO3QVRovWemcGMkm7ijAIA ($25.70 in chips)
5k9fvXD9suIgCxU4HLQjTw: posts small blind $0.25
mSD1pginDsyHG5PDfqzphw: posts big blind $0.50
VhjwWfxHSx00WxzYih3KOA: posts big blind $0.50
*** HOLE CARDS ***
JYwJYYV9pM5KWdSiETl8rA: folds
vO3QVRovWemcGMkm7ijAIA: folds
v/4aX0ejnaIFK4ftDk2Lyg: folds
C3rGXblctNcWI6JYPHhaEg: raises $0.50 to $1
iadBi5AEt7gTBXbDSSnMYQ: folds
VhjwWfxHSx00WxzYih3KOA: folds
iAISe3dVeua8PUn2wwgDHw: folds
5k9fvXD9suIgCxU4HLQjTw: folds
mSD1pginDsyHG5PDfqzphw: folds
C3rGXblctNcWI6JYPHhaEg collected $1.75 from pot
C3rGXblctNcWI6JYPHhaEg: doesn't show hand
*** SUMMARY ***
Total pot $1.75 | Rake $0
Seat 1: v/4aX0ejnaIFK4ftDk2Lyg folded before Flop (didn't bet)
Seat 2: C3rGXblctNcWI6JYPHhaEg collected ($1.75)
Seat 3: iadBi5AEt7gTBXbDSSnMYQ folded before Flop (didn't bet)
Seat 4: VhjwWfxHSx00WxzYih3KOA folded before Flop
Seat 5: iAISe3dVeua8PUn2wwgDHw (button) folded before Flop (didn't bet)
Seat 6: 5k9fvXD9suIgCxU4HLQjTw (small blind) folded before Flop
Seat 7: mSD1pginDsyHG5PDfqzphw (big blind) folded before Flop
Seat 8: JYwJYYV9pM5KWdSiETl8rA folded before Flop (didn't bet)
Seat 9: vO3QVRovWemcGMkm7ijAIA folded before Flop (didn't bet)



PokerStars Game #59941233910:  Hold'em No Limit ($0.25/$0.50) - 2009/07/01 1:29:29 ET
Table '2lPOwetm4cfkZPbTmGPH/w' 2-max Seat #2 is the button
Seat 1: vUGdApqS8J/GJE2gaVWl1w ($6.90 in chips)
Seat 2: XFa6sBGjP2gxoIvxR3fZIg ($35.60 in chips)
XFa6sBGjP2gxoIvxR3fZIg: posts small blind $0.25
vUGdApqS8J/GJE2gaVWl1w: posts big blind $0.50
*** HOLE CARDS ***
XFa6sBGjP2gxoIvxR3fZIg: calls $0.25
vUGdApqS8J/GJE2gaVWl1w: checks
*** FLOP *** [3h Qc As]
vUGdApqS8J/GJE2gaVWl1w: bets $0.50
XFa6sBGjP2gxoIvxR3fZIg: folds
vUGdApqS8J/GJE2gaVWl1w collected $0.95 from pot
*** SUMMARY ***
Total pot $1 | Rake $0.05
Board [3h Qc As]
Seat 1: vUGdApqS8J/GJE2gaVWl1w (big blind) collected ($0.95)
Seat 2: XFa6sBGjP2gxoIvxR3fZIg (button) (small blind) folded on the Flop



PokerStars Game #59941234296:  Hold'em No Limit ($0.25/$0.50) - 2009/07/01 1:29:30 ET
Table 'B+sqsfj6d6zXicNfaseTaw' 2-max Seat #1 is the button
Seat 1: +4GNcSsecmapVGSdV0mUPA ($133.60 in chips)
Seat 2: Lv5RmpRe6LtPkBzM9Gpo5A ($91.50 in chips)
+4GNcSsecmapVGSdV0mUPA: posts small blind $0.25
Lv5RmpRe6LtPkBzM9Gpo5A: posts big blind $0.50
*** HOLE CARDS ***
+4GNcSsecmapVGSdV0mUPA: calls $0.25
Lv5RmpRe6LtPkBzM9Gpo5A: checks
*** FLOP *** [Tc 9s Kc]
Lv5RmpRe6LtPkBzM9Gpo5A: checks
+4GNcSsecmapVGSdV0mUPA: bets $1
Lv5RmpRe6LtPkBzM9Gpo5A: folds
+4GNcSsecmapVGSdV0mUPA collected $0.95 from pot
+4GNcSsecmapVGSdV0mUPA: doesn't show hand
*** SUMMARY ***
Total pot $1 | Rake $0.05
Board [Tc 9s Kc]
Seat 1: +4GNcSsecmapVGSdV0mUPA (button) (small blind) collected ($0.95)
Seat 2: Lv5RmpRe6LtPkBzM9Gpo5A (big blind) folded on the Flop



PokerStars Game #59941235208:  Hold'em No Limit ($0.25/$0.50) - 2009/07/01 1:29:32 ET
Table 'ZYI3ZReBjdfKEYItkZHI6A' 9-max Seat #1 is the button
Seat 1: IYd5zG8k7vdBNVHbHg2Pag ($63.65 in chips)
Seat 3: 75K2MXwN65Sjfp1yHd50Hg ($9.50 in chips)
Seat 4: e2+sK/yjnj94rXOKoxPP2A ($60.90 in chips)
Seat 5: ApHP7ouup365XIUFBdEDxg ($15.95 in chips)
Seat 6: 1xBtrSVBbgFH/viUWKqQeg ($29.45 in chips)
Seat 7: HWcfp1hY1hqvrddzW3/FQw ($16.15 in chips)
Seat 8: ji04uOybxCdpdefzlUQeKQ ($30.55 in chips)
Seat 9: HZkVla4kK2SI42CVrPZ/ig ($9.25 in chips)
5acK4E7fzEwnplVBZ6eNWA will be allowed to play after the button
75K2MXwN65Sjfp1yHd50Hg: posts small blind $0.25
e2+sK/yjnj94rXOKoxPP2A: posts big blind $0.50
*** HOLE CARDS ***
ApHP7ouup365XIUFBdEDxg: folds
1xBtrSVBbgFH/viUWKqQeg: folds
HWcfp1hY1hqvrddzW3/FQw: folds
ji04uOybxCdpdefzlUQeKQ: folds
HZkVla4kK2SI42CVrPZ/ig: folds
IYd5zG8k7vdBNVHbHg2Pag: folds
75K2MXwN65Sjfp1yHd50Hg: folds
e2+sK/yjnj94rXOKoxPP2A collected $0.50 from pot
e2+sK/yjnj94rXOKoxPP2A: doesn't show hand
*** SUMMARY ***
Total pot $0.50 | Rake $0
Seat 1: IYd5zG8k7vdBNVHbHg2Pag (button) folded before Flop (didn't bet)
Seat 3: 75K2MXwN65Sjfp1yHd50Hg (small blind) folded before Flop
Seat 4: e2+sK/yjnj94rXOKoxPP2A (big blind) collected ($0.50)
Seat 5: ApHP7ouup365XIUFBdEDxg folded before Flop (didn't bet)
Seat 6: 1xBtrSVBbgFH/viUWKqQeg folded before Flop (didn't bet)
Seat 7: HWcfp1hY1hqvrddzW3/FQw folded before Flop (didn't bet)
Seat 8: ji04uOybxCdpdefzlUQeKQ folded before Flop (didn't bet)
Seat 9: HZkVla4kK2SI42CVrPZ/ig folded before Flop (didn't bet)



PokerStars Game #59941235262:  Hold'em No Limit ($0.25/$0.50) - 2009/07/01 1:29:32 ET
Table 'iq+aXfWVQRdV0u8SRTYUEg' 9-max Seat #4 is the button
Seat 1: 3yl8Q6QaLfGtyhN4/pEFgQ ($78.05 in chips)
Seat 2: J9N0lxHFd/Js2S0xZLbsIQ ($27.60 in chips)
Seat 3: Qi/PyOsKwaqtKIg0H+7ELg ($9 in chips)
Seat 4: vHYT5s323LpajBj+2c9zbQ ($32.10 in chips)
Seat 5: 997ViqAtWn1FPjJqcffwcA ($50 in chips)
Seat 6: bTJ0WgoxefTPxIoycS7uoA ($31.70 in chips)
Seat 7: SKnJuWHScqetA/qG5p+wCg ($31.55 in chips)
Seat 8: /DtIHuxEH+3tzKefmSV+Mw ($36.85 in chips)
Seat 9: olE1Z2rKWAV8+tGqmIBK9g ($28.45 in chips)
997ViqAtWn1FPjJqcffwcA: posts small blind $0.25
bTJ0WgoxefTPxIoycS7uoA: posts big blind $0.50
*** HOLE CARDS ***
SKnJuWHScqetA/qG5p+wCg: folds
/DtIHuxEH+3tzKefmSV+Mw: folds
olE1Z2rKWAV8+tGqmIBK9g: folds
3yl8Q6QaLfGtyhN4/pEFgQ: folds
J9N0lxHFd/Js2S0xZLbsIQ: folds
Qi/PyOsKwaqtKIg0H+7ELg: raises $1 to $1.50
vHYT5s323LpajBj+2c9zbQ: folds
997ViqAtWn1FPjJqcffwcA: folds
bTJ0WgoxefTPxIoycS7uoA: folds
Qi/PyOsKwaqtKIg0H+7ELg collected $1.25 from pot
Qi/PyOsKwaqtKIg0H+7ELg: doesn't show hand
*** SUMMARY ***
Total pot $1.25 | Rake $0
Seat 1: 3yl8Q6QaLfGtyhN4/pEFgQ folded before Flop (didn't bet)
Seat 2: J9N0lxHFd/Js2S0xZLbsIQ folded before Flop (didn't bet)
Seat 3: Qi/PyOsKwaqtKIg0H+7ELg collected ($1.25)
Seat 4: vHYT5s323LpajBj+2c9zbQ (button) folded before Flop (didn't bet)
Seat 5: 997ViqAtWn1FPjJqcffwcA (small blind) folded before Flop
Seat 6: bTJ0WgoxefTPxIoycS7uoA (big blind) folded before Flop
Seat 7: SKnJuWHScqetA/qG5p+wCg folded before Flop (didn't bet)
Seat 8: /DtIHuxEH+3tzKefmSV+Mw folded before Flop (didn't bet)
Seat 9: olE1Z2rKWAV8+tGqmIBK9g folded before Flop (didn't bet)



PokerStars Game #59941237114:  Hold'em No Limit ($0.25/$0.50) - 2009/07/01 1:29:35 ET
Table '+z1aekfHkpp09pc8F9aViw' 6-max Seat #1 is the button
Seat 1: /DArfRoYc3YpLsOQSZubFg ($50 in chips)
Seat 2: 4QfsCWthT/vSLirorNXqtg ($50 in chips)
Seat 3: URYNc7fPA23K2UfadQbnCA ($49.25 in chips)
Seat 5: 2igtJLmvIZ+HqX4XPgMPZA ($53.70 in chips)
Seat 6: GUnvMULl2qFOO1yenu1UBw ($52.25 in chips)
4QfsCWthT/vSLirorNXqtg: posts small blind $0.25
URYNc7fPA23K2UfadQbnCA: posts big blind $0.50
*** HOLE CARDS ***
2igtJLmvIZ+HqX4XPgMPZA: raises $1.50 to $2
GUnvMULl2qFOO1yenu1UBw: folds
/DArfRoYc3YpLsOQSZubFg: raises $3 to $5
4QfsCWthT/vSLirorNXqtg: folds
URYNc7fPA23K2UfadQbnCA: folds
2igtJLmvIZ+HqX4XPgMPZA: folds
/DArfRoYc3YpLsOQSZubFg collected $4.75 from pot
*** SUMMARY ***
Total pot $4.75 | Rake $0
Seat 1: /DArfRoYc3YpLsOQSZubFg (button) collected ($4.75)
Seat 2: 4QfsCWthT/vSLirorNXqtg (small blind) folded before Flop
Seat 3: URYNc7fPA23K2UfadQbnCA (big blind) folded before Flop
Seat 5: 2igtJLmvIZ+HqX4XPgMPZA folded before Flop
Seat 6: GUnvMULl2qFOO1yenu1UBw folded before Flop (didn't bet)



PokerStars Game #59941238590:  Hold'em No Limit ($0.25/$0.50) - 2009/07/01 1:29:38 ET
Table 'hSTs/dUsYLgJQuF2Onp0MQ' 6-max Seat #6 is the button
Seat 1: 1WUCqNG+p+vfWRTXNu4ljw ($50 in chips)
Seat 2: Hdd4js36ITbTJ/QuVYwTlA ($54.25 in chips)
Seat 3: lxIzoHy0RnkfFSODHC2liw ($53.20 in chips)
Seat 4: 2igtJLmvIZ+HqX4XPgMPZA ($79.40 in chips)
Seat 6: M1KyQQvVPVuxqTAB8sR/zQ ($93.80 in chips)
1WUCqNG+p+vfWRTXNu4ljw: posts small blind $0.25
Hdd4js36ITbTJ/QuVYwTlA: posts big blind $0.50
*** HOLE CARDS ***
lxIzoHy0RnkfFSODHC2liw: folds
2igtJLmvIZ+HqX4XPgMPZA: raises $1.50 to $2
M1KyQQvVPVuxqTAB8sR/zQ: folds
1WUCqNG+p+vfWRTXNu4ljw: folds
Hdd4js36ITbTJ/QuVYwTlA: calls $1.50
*** FLOP *** [Qd 9h 5c]
Hdd4js36ITbTJ/QuVYwTlA: checks
2igtJLmvIZ+HqX4XPgMPZA: bets $4
Hdd4js36ITbTJ/QuVYwTlA: calls $4
*** TURN *** [Qd 9h 5c] [Kh]
Hdd4js36ITbTJ/QuVYwTlA: checks
2igtJLmvIZ+HqX4XPgMPZA: bets $11
FsRQ5ECdlLkLYI5le8+PDQ joins the table at seat #5
Hdd4js36ITbTJ/QuVYwTlA is disconnected
Hdd4js36ITbTJ/QuVYwTlA is connected
Hdd4js36ITbTJ/QuVYwTlA: calls $11
*** RIVER *** [Qd 9h 5c Kh] [Ts]
Hdd4js36ITbTJ/QuVYwTlA: bets $12.50
2igtJLmvIZ+HqX4XPgMPZA: calls $12.50
*** SHOW DOWN ***
Hdd4js36ITbTJ/QuVYwTlA: shows [Jd Kc] (a straight, Nine to King)
2igtJLmvIZ+HqX4XPgMPZA: mucks hand
Hdd4js36ITbTJ/QuVYwTlA collected $57.25 from pot
*** SUMMARY ***
Total pot $59.25 | Rake $2
Board [Qd 9h 5c Kh Ts]
Seat 1: 1WUCqNG+p+vfWRTXNu4ljw (small blind) folded before Flop
Seat 2: Hdd4js36ITbTJ/QuVYwTlA (big blind) showed [Jd Kc] and won ($57.25) with a straight, Nine to King
Seat 3: lxIzoHy0RnkfFSODHC2liw folded before Flop (didn't bet)
Seat 4: 2igtJLmvIZ+HqX4XPgMPZA mucked
Seat 6: M1KyQQvVPVuxqTAB8sR/zQ (button) folded before Flop (didn't bet)



PokerStars Game #59941238772:  Hold'em No Limit ($0.25/$0.50) - 2009/07/01 1:29:38 ET
Table '+dXkOAQyS8j9PQZusUTMpg' 2-max Seat #2 is the button
Seat 1: Teld4PDKla7C8/Wfu2DSkg ($51.45 in chips)
Seat 2: +zI4bP23YIjMkUHqeN2xfw ($25.25 in chips)
+zI4bP23YIjMkUHqeN2xfw: posts small blind $0.25
Teld4PDKla7C8/Wfu2DSkg: posts big blind $0.50
*** HOLE CARDS ***
+zI4bP23YIjMkUHqeN2xfw: folds
Teld4PDKla7C8/Wfu2DSkg collected $0.50 from pot
Teld4PDKla7C8/Wfu2DSkg: doesn't show hand
*** SUMMARY ***
Total pot $0.50 | Rake $0
Seat 1: Teld4PDKla7C8/Wfu2DSkg (big blind) collected ($0.50)
Seat 2: +zI4bP23YIjMkUHqeN2xfw (button) (small blind) folded before Flop



PokerStars Game #59941238600:  Hold'em No Limit ($0.25/$0.50) - 2009/07/01 1:29:38 ET
Table 'X6IRCRTh+20gjz8aubWnwA' 9-max Seat #3 is the button
Seat 2: HZkVla4kK2SI42CVrPZ/ig ($9.75 in chips)
Seat 3: SWv01peOe69QQRvhQTqjQw ($11.80 in chips)
Seat 4: M3JFBNQ8Bbw3FBZ/18MuXw ($34.40 in chips)
Seat 6: Qi/PyOsKwaqtKIg0H+7ELg ($7.75 in chips)
Seat 7: +RUz0sVA09ZE8PNpIl+EBQ ($26.50 in chips)
Seat 8: HxeBVq06/3Bh/H986sgdbw ($44.50 in chips)
Seat 9: M+7+BTmX5vZatHVuoRB1nA ($57.15 in chips)
M3JFBNQ8Bbw3FBZ/18MuXw: posts small blind $0.25
uw9QayAAxLM3Hb+HR7mSkg: is sitting out
Qi/PyOsKwaqtKIg0H+7ELg: posts big blind $0.50
*** HOLE CARDS ***
+RUz0sVA09ZE8PNpIl+EBQ: raises $1.50 to $2
HxeBVq06/3Bh/H986sgdbw: folds
uw9QayAAxLM3Hb+HR7mSkg leaves the table
M+7+BTmX5vZatHVuoRB1nA: folds
HZkVla4kK2SI42CVrPZ/ig: folds
SWv01peOe69QQRvhQTqjQw: folds
M3JFBNQ8Bbw3FBZ/18MuXw: folds
Qi/PyOsKwaqtKIg0H+7ELg: folds
+RUz0sVA09ZE8PNpIl+EBQ collected $1.25 from pot
*** SUMMARY ***
Total pot $1.25 | Rake $0
Seat 2: HZkVla4kK2SI42CVrPZ/ig folded before Flop (didn't bet)
Seat 3: SWv01peOe69QQRvhQTqjQw (button) folded before Flop (didn't bet)
Seat 4: M3JFBNQ8Bbw3FBZ/18MuXw (small blind) folded before Flop
Seat 6: Qi/PyOsKwaqtKIg0H+7ELg (big blind) folded before Flop
Seat 7: +RUz0sVA09ZE8PNpIl+EBQ collected ($1.25)
Seat 8: HxeBVq06/3Bh/H986sgdbw folded before Flop (didn't bet)
Seat 9: M+7+BTmX5vZatHVuoRB1nA folded before Flop (didn't bet)



PokerStars Game #59941239586:  Hold'em No Limit ($0.25/$0.50) - 2009/07/01 1:29:39 ET
Table '8BQGgNetI1NOvWeu3gtMNw' 2-max Seat #2 is the button
Seat 1: bypIyrYcAAifLfhZpGlKLA ($56.90 in chips)
Seat 2: Z4HwehErEwzsv/noQlfUlg ($160.70 in chips)
Z4HwehErEwzsv/noQlfUlg: posts small blind $0.25
bypIyrYcAAifLfhZpGlKLA: posts big blind $0.50
*** HOLE CARDS ***
Z4HwehErEwzsv/noQlfUlg: raises $2.50 to $3
bypIyrYcAAifLfhZpGlKLA: folds
Z4HwehErEwzsv/noQlfUlg collected $1 from pot
Z4HwehErEwzsv/noQlfUlg: doesn't show hand
*** SUMMARY ***
Total pot $1 | Rake $0
Seat 1: bypIyrYcAAifLfhZpGlKLA (big blind) folded before Flop
Seat 2: Z4HwehErEwzsv/noQlfUlg (button) (small blind) collected ($1)



PokerStars Game #59941240498:  Hold'em No Limit ($0.25/$0.50) - 2009/07/01 1:29:41 ET
Table '2lPOwetm4cfkZPbTmGPH/w' 2-max Seat #1 is the button
Seat 1: vUGdApqS8J/GJE2gaVWl1w ($7.35 in chips)
Seat 2: XFa6sBGjP2gxoIvxR3fZIg ($35.10 in chips)
vUGdApqS8J/GJE2gaVWl1w: posts small blind $0.25
XFa6sBGjP2gxoIvxR3fZIg: posts big blind $0.50
*** HOLE CARDS ***
vUGdApqS8J/GJE2gaVWl1w: calls $0.25
XFa6sBGjP2gxoIvxR3fZIg: checks
*** FLOP *** [3c Ah 8s]
XFa6sBGjP2gxoIvxR3fZIg: checks
vUGdApqS8J/GJE2gaVWl1w: checks
*** TURN *** [3c Ah 8s] [Jd]
XFa6sBGjP2gxoIvxR3fZIg: checks
vUGdApqS8J/GJE2gaVWl1w: bets $0.80
XFa6sBGjP2gxoIvxR3fZIg: folds
vUGdApqS8J/GJE2gaVWl1w collected $0.95 from pot
*** SUMMARY ***
Total pot $1 | Rake $0.05
Board [3c Ah 8s Jd]
Seat 1: vUGdApqS8J/GJE2gaVWl1w (button) (small blind) collected ($0.95)
Seat 2: XFa6sBGjP2gxoIvxR3fZIg (big blind) folded on the Turn



PokerStars Game #59941240416:  Hold'em No Limit ($0.25/$0.50) - 2009/07/01 1:29:41 ET
Table '9ojijpRcYQSQTh6xI+haUA' 2-max Seat #1 is the button
Seat 1: FqpibuVWLNsAN/Z7ROZLnA ($45 in chips)
Seat 2: TitTV+fFCcBZWOERdytydA ($41.30 in chips)
FqpibuVWLNsAN/Z7ROZLnA: posts small blind $0.25
TitTV+fFCcBZWOERdytydA: posts big blind $0.50
*** HOLE CARDS ***
FqpibuVWLNsAN/Z7ROZLnA: calls $0.25
TitTV+fFCcBZWOERdytydA: checks
*** FLOP *** [Js 7d 9d]
TitTV+fFCcBZWOERdytydA: checks
FqpibuVWLNsAN/Z7ROZLnA: bets $0.50
TitTV+fFCcBZWOERdytydA: raises $1 to $1.50
FqpibuVWLNsAN/Z7ROZLnA: calls $1
*** TURN *** [Js 7d 9d] [5h]
TitTV+fFCcBZWOERdytydA: checks
FqpibuVWLNsAN/Z7ROZLnA: checks
*** RIVER *** [Js 7d 9d 5h] [5c]
TitTV+fFCcBZWOERdytydA: bets $2
FqpibuVWLNsAN/Z7ROZLnA: folds
TitTV+fFCcBZWOERdytydA collected $3.85 from pot
TitTV+fFCcBZWOERdytydA: doesn't show hand
*** SUMMARY ***
Total pot $4 | Rake $0.15
Board [Js 7d 9d 5h 5c]
Seat 1: FqpibuVWLNsAN/Z7ROZLnA (button) (small blind) folded on the River
Seat 2: TitTV+fFCcBZWOERdytydA (big blind) collected ($3.85)



PokerStars Game #59941241214:  Hold'em No Limit ($0.25/$0.50) - 2009/07/01 1:29:42 ET
Table 'hWT2kq66tnKEpD26cia6fQ' 2-max Seat #1 is the button
Seat 1: Ce3KNFP+ao7Da9NHb65raw ($30.80 in chips)
Seat 2: 16tvT7AYgZ2LgiGFcvFKQg ($45.90 in chips)
Ce3KNFP+ao7Da9NHb65raw: posts small blind $0.25
16tvT7AYgZ2LgiGFcvFKQg: posts big blind $0.50
*** HOLE CARDS ***
Ce3KNFP+ao7Da9NHb65raw: calls $0.25
16tvT7AYgZ2LgiGFcvFKQg: checks
*** FLOP *** [8s 5s 5c]
16tvT7AYgZ2LgiGFcvFKQg: checks
Ce3KNFP+ao7Da9NHb65raw: bets $0.50
16tvT7AYgZ2LgiGFcvFKQg: calls $0.50
*** TURN *** [8s 5s 5c] [9h]
16tvT7AYgZ2LgiGFcvFKQg: checks
Ce3KNFP+ao7Da9NHb65raw: bets $1.50
16tvT7AYgZ2LgiGFcvFKQg: calls $1.50
*** RIVER *** [8s 5s 5c 9h] [3s]
16tvT7AYgZ2LgiGFcvFKQg: checks
Ce3KNFP+ao7Da9NHb65raw: bets $2
16tvT7AYgZ2LgiGFcvFKQg: folds
Ce3KNFP+ao7Da9NHb65raw collected $4.80 from pot
*** SUMMARY ***
Total pot $5 | Rake $0.20
Board [8s 5s 5c 9h 3s]
Seat 1: Ce3KNFP+ao7Da9NHb65raw (button) (small blind) collected ($4.80)
Seat 2: 16tvT7AYgZ2LgiGFcvFKQg (big blind) folded on the River



PokerStars Game #59941241112:  Hold'em No Limit ($0.25/$0.50) - 2009/07/01 1:29:42 ET
Table '3FhG0gl3kMX3wBEEqj+wnQ' 9-max Seat #1 is the button
Seat 1: bxLSulbgr8LmKNjOzw8URg ($49.30 in chips)
Seat 2: vacmVLJJECYI6HjAynFcpg ($50.10 in chips)
Seat 3: YXCE3WOZi8g2sIf3y/plVw ($59.75 in chips)
Seat 4: e2+sK/yjnj94rXOKoxPP2A ($70.25 in chips)
Seat 5: XcLXSUMHSpshK/7Lh0M4Vg ($9.25 in chips)
Seat 6: 997ViqAtWn1FPjJqcffwcA ($109.80 in chips)
Seat 7: mSD1pginDsyHG5PDfqzphw ($12.50 in chips)
Seat 8: j3K/Jujr7PY4ZM2RZvlH6A ($44.60 in chips)
vacmVLJJECYI6HjAynFcpg: posts small blind $0.25
YXCE3WOZi8g2sIf3y/plVw: posts big blind $0.50
*** HOLE CARDS ***
e2+sK/yjnj94rXOKoxPP2A: folds
XcLXSUMHSpshK/7Lh0M4Vg: folds
997ViqAtWn1FPjJqcffwcA: folds
mSD1pginDsyHG5PDfqzphw: folds
j3K/Jujr7PY4ZM2RZvlH6A: folds
bxLSulbgr8LmKNjOzw8URg: folds
vacmVLJJECYI6HjAynFcpg: folds
YXCE3WOZi8g2sIf3y/plVw collected $0.50 from pot
YXCE3WOZi8g2sIf3y/plVw: doesn't show hand
*** SUMMARY ***
Total pot $0.50 | Rake $0
Seat 1: bxLSulbgr8LmKNjOzw8URg (button) folded before Flop (didn't bet)
Seat 2: vacmVLJJECYI6HjAynFcpg (small blind) folded before Flop
Seat 3: YXCE3WOZi8g2sIf3y/plVw (big blind) collected ($0.50)
Seat 4: e2+sK/yjnj94rXOKoxPP2A folded before Flop (didn't bet)
Seat 5: XcLXSUMHSpshK/7Lh0M4Vg folded before Flop (didn't bet)
Seat 6: 997ViqAtWn1FPjJqcffwcA folded before Flop (didn't bet)
Seat 7: mSD1pginDsyHG5PDfqzphw folded before Flop (didn't bet)
Seat 8: j3K/Jujr7PY4ZM2RZvlH6A folded before Flop (didn't bet)



PokerStars Game #59941241626:  Hold'em No Limit ($0.25/$0.50) - 2009/07/01 1:29:43 ET
Table 'cofQFHU7jbJoFecLVBof/w' 6-max Seat #3 is the button
Seat 1: URYNc7fPA23K2UfadQbnCA ($48.50 in chips)
Seat 2: f89uTQr3ieGlusj2IAYAEg ($50 in chips)
Seat 3: v4ctePcLlQw0r8E0qJtjYw ($47.20 in chips)
Seat 4: g6lz8npaeeTJmJegtPYhlQ ($17.35 in chips)
Seat 5: QvwRlrpVqerRRF8eJm6dDw ($53 in chips)
Seat 6: 7+uQ0OOgCTbR4ltkSwyC0g ($156.05 in chips)
g6lz8npaeeTJmJegtPYhlQ: posts small blind $0.25
QvwRlrpVqerRRF8eJm6dDw: posts big blind $0.50
*** HOLE CARDS ***
7+uQ0OOgCTbR4ltkSwyC0g: raises $1 to $1.50
URYNc7fPA23K2UfadQbnCA: folds
f89uTQr3ieGlusj2IAYAEg: folds
v4ctePcLlQw0r8E0qJtjYw: folds
g6lz8npaeeTJmJegtPYhlQ: folds
QvwRlrpVqerRRF8eJm6dDw: raises $1 to $2.50
7+uQ0OOgCTbR4ltkSwyC0g: calls $1
*** FLOP *** [Th 5s 2d]
QvwRlrpVqerRRF8eJm6dDw: checks
7+uQ0OOgCTbR4ltkSwyC0g: checks
*** TURN *** [Th 5s 2d] [Ad]
QvwRlrpVqerRRF8eJm6dDw: checks
7+uQ0OOgCTbR4ltkSwyC0g: checks
*** RIVER *** [Th 5s 2d Ad] [Jh]
QvwRlrpVqerRRF8eJm6dDw: bets $5
7+uQ0OOgCTbR4ltkSwyC0g: calls $5
*** SHOW DOWN ***
QvwRlrpVqerRRF8eJm6dDw: shows [Ks Js] (a pair of Jacks)
7+uQ0OOgCTbR4ltkSwyC0g: shows [Ac 4s] (a pair of Aces)
7+uQ0OOgCTbR4ltkSwyC0g collected $14.50 from pot
*** SUMMARY ***
Total pot $15.25 | Rake $0.75
Board [Th 5s 2d Ad Jh]
Seat 1: URYNc7fPA23K2UfadQbnCA folded before Flop (didn't bet)
Seat 2: f89uTQr3ieGlusj2IAYAEg folded before Flop (didn't bet)
Seat 3: v4ctePcLlQw0r8E0qJtjYw (button) folded before Flop (didn't bet)
Seat 4: g6lz8npaeeTJmJegtPYhlQ (small blind) folded before Flop
Seat 5: QvwRlrpVqerRRF8eJm6dDw (big blind) showed [Ks Js] and lost with a pair of Jacks
Seat 6: 7+uQ0OOgCTbR4ltkSwyC0g showed [Ac 4s] and won ($14.50) with a pair of Aces



PokerStars Game #59941242110:  Hold'em No Limit ($0.25/$0.50) - 2009/07/01 1:29:44 ET
Table 'B+sqsfj6d6zXicNfaseTaw' 2-max Seat #2 is the button
Seat 1: +4GNcSsecmapVGSdV0mUPA ($134.05 in chips)
Seat 2: Lv5RmpRe6LtPkBzM9Gpo5A ($91 in chips)
Lv5RmpRe6LtPkBzM9Gpo5A: posts small blind $0.25
+4GNcSsecmapVGSdV0mUPA: posts big blind $0.50
*** HOLE CARDS ***
Lv5RmpRe6LtPkBzM9Gpo5A: raises $1 to $1.50
+4GNcSsecmapVGSdV0mUPA: folds
Lv5RmpRe6LtPkBzM9Gpo5A collected $1 from pot
*** SUMMARY ***
Total pot $1 | Rake $0
Seat 1: +4GNcSsecmapVGSdV0mUPA (big blind) folded before Flop
Seat 2: Lv5RmpRe6LtPkBzM9Gpo5A (button) (small blind) collected ($1)



PokerStars Game #59941242320:  Hold'em No Limit ($0.25/$0.50) - 2009/07/01 1:29:44 ET
Table 'lSisgp6H7Fg1hH5VfjEjYQ' 9-max Seat #7 is the button
Seat 1: 5k9fvXD9suIgCxU4HLQjTw ($53.35 in chips)
Seat 3: SKnJuWHScqetA/qG5p+wCg ($30 in chips)
Seat 4: bwv/rbH/hHhPhY6u9mu04w ($37.40 in chips)
Seat 5: mSD1pginDsyHG5PDfqzphw ($12.25 in chips)
Seat 6: +k7T5ocke8UwavtgUHm+Cg ($72.20 in chips)
Seat 7: IDtNLR9uFCDdjNsJWMHA5Q ($20.35 in chips)
Seat 8: a4JDWmpFQkL10XfAyuF51A ($10.25 in chips)
Seat 9: YzeKFbJVLmJGTgNH3ySQlw ($9.20 in chips)
a4JDWmpFQkL10XfAyuF51A: posts small blind $0.25
YzeKFbJVLmJGTgNH3ySQlw: posts big blind $0.50
5acK4E7fzEwnplVBZ6eNWA: sits out
*** HOLE CARDS ***
5k9fvXD9suIgCxU4HLQjTw: folds
SKnJuWHScqetA/qG5p+wCg: folds
bwv/rbH/hHhPhY6u9mu04w: folds
mSD1pginDsyHG5PDfqzphw: folds
+k7T5ocke8UwavtgUHm+Cg: folds
IDtNLR9uFCDdjNsJWMHA5Q: folds
a4JDWmpFQkL10XfAyuF51A: folds
YzeKFbJVLmJGTgNH3ySQlw collected $0.50 from pot
*** SUMMARY ***
Total pot $0.50 | Rake $0
Seat 1: 5k9fvXD9suIgCxU4HLQjTw folded before Flop (didn't bet)
Seat 3: SKnJuWHScqetA/qG5p+wCg folded before Flop (didn't bet)
Seat 4: bwv/rbH/hHhPhY6u9mu04w folded before Flop (didn't bet)
Seat 5: mSD1pginDsyHG5PDfqzphw folded before Flop (didn't bet)
Seat 6: +k7T5ocke8UwavtgUHm+Cg folded before Flop (didn't bet)
Seat 7: IDtNLR9uFCDdjNsJWMHA5Q (button) folded before Flop (didn't bet)
Seat 8: a4JDWmpFQkL10XfAyuF51A (small blind) folded before Flop
Seat 9: YzeKFbJVLmJGTgNH3ySQlw (big blind) collected ($0.50)



PokerStars Game #59941242612:  Hold'em No Limit ($0.25/$0.50) - 2009/07/01 1:29:44 ET
Table 'fx6MqwfYAj/Rt86hBz2L3Q' 9-max Seat #6 is the button
Seat 1: v/4aX0ejnaIFK4ftDk2Lyg ($51.40 in chips)
Seat 2: C3rGXblctNcWI6JYPHhaEg ($36.30 in chips)
Seat 3: iadBi5AEt7gTBXbDSSnMYQ ($36.55 in chips)
Seat 4: VhjwWfxHSx00WxzYih3KOA ($50 in chips)
Seat 5: iAISe3dVeua8PUn2wwgDHw ($70.15 in chips)
Seat 6: 5k9fvXD9suIgCxU4HLQjTw ($50 in chips)
Seat 7: mSD1pginDsyHG5PDfqzphw ($10 in chips)
Seat 8: JYwJYYV9pM5KWdSiETl8rA ($63 in chips)
Seat 9: vO3QVRovWemcGMkm7ijAIA ($25.70 in chips)
mSD1pginDsyHG5PDfqzphw: posts small blind $0.25
JYwJYYV9pM5KWdSiETl8rA: posts big blind $0.50
*** HOLE CARDS ***
vO3QVRovWemcGMkm7ijAIA: folds
v/4aX0ejnaIFK4ftDk2Lyg: folds
C3rGXblctNcWI6JYPHhaEg: raises $1 to $1.50
iadBi5AEt7gTBXbDSSnMYQ: folds
VhjwWfxHSx00WxzYih3KOA has timed out
VhjwWfxHSx00WxzYih3KOA: folds
VhjwWfxHSx00WxzYih3KOA is sitting out
iAISe3dVeua8PUn2wwgDHw: calls $1.50
5k9fvXD9suIgCxU4HLQjTw: folds
mSD1pginDsyHG5PDfqzphw: folds
JYwJYYV9pM5KWdSiETl8rA: folds
*** FLOP *** [Kd 5c 9h]
VhjwWfxHSx00WxzYih3KOA has returned
C3rGXblctNcWI6JYPHhaEg: bets $2.80
iAISe3dVeua8PUn2wwgDHw: raises $2.80 to $5.60
C3rGXblctNcWI6JYPHhaEg: calls $2.80
*** TURN *** [Kd 5c 9h] [7c]
C3rGXblctNcWI6JYPHhaEg: checks
iAISe3dVeua8PUn2wwgDHw: bets $3.50
C3rGXblctNcWI6JYPHhaEg: folds
iAISe3dVeua8PUn2wwgDHw collected $14.25 from pot
*** SUMMARY ***
Total pot $14.95 | Rake $0.70
Board [Kd 5c 9h 7c]
Seat 1: v/4aX0ejnaIFK4ftDk2Lyg folded before Flop (didn't bet)
Seat 2: C3rGXblctNcWI6JYPHhaEg folded on the Turn
Seat 3: iadBi5AEt7gTBXbDSSnMYQ folded before Flop (didn't bet)
Seat 4: VhjwWfxHSx00WxzYih3KOA folded before Flop (didn't bet)
Seat 5: iAISe3dVeua8PUn2wwgDHw collected ($14.25)
Seat 6: 5k9fvXD9suIgCxU4HLQjTw (button) folded before Flop (didn't bet)
Seat 7: mSD1pginDsyHG5PDfqzphw (small blind) folded before Flop
Seat 8: JYwJYYV9pM5KWdSiETl8rA (big blind) folded before Flop
Seat 9: vO3QVRovWemcGMkm7ijAIA folded before Flop (didn't bet)



PokerStars Game #59941243502:  Hold'em No Limit ($0.25/$0.50) - 2009/07/01 1:29:46 ET
Table '99gCy/CZQwPIjZWH+BguQg' 9-max Seat #5 is the button
Seat 2: 7CKaQEWhd40e2lLifzZ1Cw ($30 in chips)
Seat 3: qRAIErWOpf/5FYyZ8qza0w ($30.40 in chips)
Seat 4: bxLSulbgr8LmKNjOzw8URg ($58.05 in chips)
Seat 5: YXCE3WOZi8g2sIf3y/plVw ($50.90 in chips)
Seat 6: OcnLOMVFdy23jXnoTyaO5Q ($303.35 in chips)
Seat 7: ottZQkg1UDWk85BtBzGJzg ($29.75 in chips)
Seat 8: 8ehL7qlZzjgUh2H35iiWLw ($50 in chips)
Seat 9: j3K/Jujr7PY4ZM2RZvlH6A ($67.50 in chips)
OcnLOMVFdy23jXnoTyaO5Q: posts small blind $0.25
ottZQkg1UDWk85BtBzGJzg: posts big blind $0.50
Bawookles: sits out
7CKaQEWhd40e2lLifzZ1Cw: posts big blind $0.50
*** HOLE CARDS ***
8ehL7qlZzjgUh2H35iiWLw has timed out
8ehL7qlZzjgUh2H35iiWLw: folds
8ehL7qlZzjgUh2H35iiWLw is sitting out
j3K/Jujr7PY4ZM2RZvlH6A: folds
8ehL7qlZzjgUh2H35iiWLw has returned
7CKaQEWhd40e2lLifzZ1Cw: checks
qRAIErWOpf/5FYyZ8qza0w: calls $0.50
bxLSulbgr8LmKNjOzw8URg: raises $2 to $2.50
YXCE3WOZi8g2sIf3y/plVw: folds
OcnLOMVFdy23jXnoTyaO5Q: folds
ottZQkg1UDWk85BtBzGJzg: folds
7CKaQEWhd40e2lLifzZ1Cw: folds
qRAIErWOpf/5FYyZ8qza0w: calls $2
*** FLOP *** [2s 9c 6h]
qRAIErWOpf/5FYyZ8qza0w: bets $1.50
bxLSulbgr8LmKNjOzw8URg: raises $3.50 to $5
qRAIErWOpf/5FYyZ8qza0w: raises $3.50 to $8.50
bxLSulbgr8LmKNjOzw8URg: raises $6 to $14.50
qRAIErWOpf/5FYyZ8qza0w: raises $6 to $20.50
bxLSulbgr8LmKNjOzw8URg: raises $35.05 to $55.55 and is all-in
qRAIErWOpf/5FYyZ8qza0w: calls $7.40 and is all-in
*** TURN *** [2s 9c 6h] [Kh]
*** RIVER *** [2s 9c 6h Kh] [8s]
*** SHOW DOWN ***
qRAIErWOpf/5FYyZ8qza0w: shows [Qd 6d] (a pair of Sixes)
bxLSulbgr8LmKNjOzw8URg: shows [Ac Ad] (a pair of Aces)
bxLSulbgr8LmKNjOzw8URg collected $59.05 from pot
*** SUMMARY ***
Total pot $62.05 | Rake $3
Board [2s 9c 6h Kh 8s]
Seat 2: 7CKaQEWhd40e2lLifzZ1Cw folded before Flop
Seat 3: qRAIErWOpf/5FYyZ8qza0w showed [Qd 6d] and lost with a pair of Sixes
Seat 4: bxLSulbgr8LmKNjOzw8URg showed [Ac Ad] and won ($59.05) with a pair of Aces
Seat 5: YXCE3WOZi8g2sIf3y/plVw (button) folded before Flop (didn't bet)
Seat 6: OcnLOMVFdy23jXnoTyaO5Q (small blind) folded before Flop
Seat 7: ottZQkg1UDWk85BtBzGJzg (big blind) folded before Flop
Seat 8: 8ehL7qlZzjgUh2H35iiWLw folded before Flop (didn't bet)
Seat 9: j3K/Jujr7PY4ZM2RZvlH6A folded before Flop (didn't bet)



PokerStars Game #59941245918:  Hold'em No Limit ($0.25/$0.50) - 2009/07/01 1:29:50 ET
Table '+dXkOAQyS8j9PQZusUTMpg' 2-max Seat #1 is the button
Seat 1: Teld4PDKla7C8/Wfu2DSkg ($51.70 in chips)
Seat 2: +zI4bP23YIjMkUHqeN2xfw ($25 in chips)
Teld4PDKla7C8/Wfu2DSkg: posts small blind $0.25
+zI4bP23YIjMkUHqeN2xfw: posts big blind $0.50
*** HOLE CARDS ***
Teld4PDKla7C8/Wfu2DSkg: calls $0.25
+zI4bP23YIjMkUHqeN2xfw: checks
*** FLOP *** [3h Kc 5c]
+zI4bP23YIjMkUHqeN2xfw: checks
Teld4PDKla7C8/Wfu2DSkg: bets $1
+zI4bP23YIjMkUHqeN2xfw: folds
Teld4PDKla7C8/Wfu2DSkg collected $0.95 from pot
*** SUMMARY ***
Total pot $1 | Rake $0.05
Board [3h Kc 5c]
Seat 1: Teld4PDKla7C8/Wfu2DSkg (button) (small blind) collected ($0.95)
Seat 2: +zI4bP23YIjMkUHqeN2xfw (big blind) folded on the Flop



PokerStars Game #59941245784:  Hold'em No Limit ($0.25/$0.50) - 2009/07/01 1:29:50 ET
Table '8BQGgNetI1NOvWeu3gtMNw' 2-max Seat #1 is the button
Seat 1: bypIyrYcAAifLfhZpGlKLA ($56.40 in chips)
Seat 2: Z4HwehErEwzsv/noQlfUlg ($161.20 in chips)
bypIyrYcAAifLfhZpGlKLA: posts small blind $0.25
Z4HwehErEwzsv/noQlfUlg: posts big blind $0.50
*** HOLE CARDS ***
bypIyrYcAAifLfhZpGlKLA: raises $1 to $1.50
Z4HwehErEwzsv/noQlfUlg: folds
bypIyrYcAAifLfhZpGlKLA collected $1 from pot
bypIyrYcAAifLfhZpGlKLA: doesn't show hand
*** SUMMARY ***
Total pot $1 | Rake $0
Seat 1: bypIyrYcAAifLfhZpGlKLA (button) (small blind) collected ($1)
Seat 2: Z4HwehErEwzsv/noQlfUlg (big blind) folded before Flop



PokerStars Game #59941246576:  Hold'em No Limit ($0.25/$0.50) - 2009/07/01 1:29:51 ET
Table 'Oih5mInDJ8x49ONa0YdsPw' 2-max Seat #2 is the button
Seat 1: FeErMt4Gvt/3PH2oB/pn4A ($9.75 in chips)
Seat 2: CR6EAGkYzPzxXXZY9pip8Q ($9.75 in chips)
CR6EAGkYzPzxXXZY9pip8Q: posts small blind $0.25
FeErMt4Gvt/3PH2oB/pn4A: posts big blind $0.50
*** HOLE CARDS ***
CR6EAGkYzPzxXXZY9pip8Q: calls $0.25
FeErMt4Gvt/3PH2oB/pn4A: checks
*** FLOP *** [2h Qd Tc]
FeErMt4Gvt/3PH2oB/pn4A: checks
CR6EAGkYzPzxXXZY9pip8Q: checks
*** TURN *** [2h Qd Tc] [8d]
FeErMt4Gvt/3PH2oB/pn4A: bets $0.50
CR6EAGkYzPzxXXZY9pip8Q: folds
FeErMt4Gvt/3PH2oB/pn4A collected $0.95 from pot
FeErMt4Gvt/3PH2oB/pn4A: doesn't show hand
*** SUMMARY ***
Total pot $1 | Rake $0.05
Board [2h Qd Tc 8d]
Seat 1: FeErMt4Gvt/3PH2oB/pn4A (big blind) collected ($0.95)
Seat 2: CR6EAGkYzPzxXXZY9pip8Q (button) (small blind) folded on the Turn



PokerStars Game #59941246502:  Hold'em No Limit ($0.25/$0.50) - 2009/07/01 1:29:51 ET
Table 'B+sqsfj6d6zXicNfaseTaw' 2-max Seat #1 is the button
Seat 1: +4GNcSsecmapVGSdV0mUPA ($133.55 in chips)
Seat 2: Lv5RmpRe6LtPkBzM9Gpo5A ($91.50 in chips)
+4GNcSsecmapVGSdV0mUPA: posts small blind $0.25
Lv5RmpRe6LtPkBzM9Gpo5A: posts big blind $0.50
*** HOLE CARDS ***
+4GNcSsecmapVGSdV0mUPA: raises $1 to $1.50
Lv5RmpRe6LtPkBzM9Gpo5A: calls $1
*** FLOP *** [9s Qh Th]
Lv5RmpRe6LtPkBzM9Gpo5A: checks
+4GNcSsecmapVGSdV0mUPA: bets $1
Lv5RmpRe6LtPkBzM9Gpo5A: raises $2.50 to $3.50
+4GNcSsecmapVGSdV0mUPA: calls $2.50
*** TURN *** [9s Qh Th] [4h]
Lv5RmpRe6LtPkBzM9Gpo5A: checks
+4GNcSsecmapVGSdV0mUPA: checks
*** RIVER *** [9s Qh Th 4h] [Ad]
Lv5RmpRe6LtPkBzM9Gpo5A: bets $7
+4GNcSsecmapVGSdV0mUPA: folds
Lv5RmpRe6LtPkBzM9Gpo5A collected $9.55 from pot
*** SUMMARY ***
Total pot $10 | Rake $0.45
Board [9s Qh Th 4h Ad]
Seat 1: +4GNcSsecmapVGSdV0mUPA (button) (small blind) folded on the River
Seat 2: Lv5RmpRe6LtPkBzM9Gpo5A (big blind) collected ($9.55)



PokerStars Game #59941247058:  Hold'em No Limit ($0.25/$0.50) - 2009/07/01 1:29:52 ET
Table 'ZYI3ZReBjdfKEYItkZHI6A' 9-max Seat #3 is the button
Seat 1: IYd5zG8k7vdBNVHbHg2Pag ($63.65 in chips)
Seat 3: 75K2MXwN65Sjfp1yHd50Hg ($9.25 in chips)
Seat 4: e2+sK/yjnj94rXOKoxPP2A ($61.15 in chips)
Seat 5: ApHP7ouup365XIUFBdEDxg ($15.95 in chips)
Seat 6: 1xBtrSVBbgFH/viUWKqQeg ($29.45 in chips)
Seat 7: HWcfp1hY1hqvrddzW3/FQw ($16.15 in chips)
Seat 8: ji04uOybxCdpdefzlUQeKQ ($30.55 in chips)
Seat 9: HZkVla4kK2SI42CVrPZ/ig ($9.25 in chips)
e2+sK/yjnj94rXOKoxPP2A: posts small blind $0.25
ApHP7ouup365XIUFBdEDxg: posts big blind $0.50
5acK4E7fzEwnplVBZ6eNWA: sits out
*** HOLE CARDS ***
1xBtrSVBbgFH/viUWKqQeg: folds
HWcfp1hY1hqvrddzW3/FQw: folds
ji04uOybxCdpdefzlUQeKQ: folds
HZkVla4kK2SI42CVrPZ/ig: folds
IYd5zG8k7vdBNVHbHg2Pag: folds
75K2MXwN65Sjfp1yHd50Hg: folds
e2+sK/yjnj94rXOKoxPP2A: folds
ApHP7ouup365XIUFBdEDxg collected $0.50 from pot
ApHP7ouup365XIUFBdEDxg: doesn't show hand
*** SUMMARY ***
Total pot $0.50 | Rake $0
Seat 1: IYd5zG8k7vdBNVHbHg2Pag folded before Flop (didn't bet)
Seat 3: 75K2MXwN65Sjfp1yHd50Hg (button) folded before Flop (didn't bet)
Seat 4: e2+sK/yjnj94rXOKoxPP2A (small blind) folded before Flop
Seat 5: ApHP7ouup365XIUFBdEDxg (big blind) collected ($0.50)
Seat 6: 1xBtrSVBbgFH/viUWKqQeg folded before Flop (didn't bet)
Seat 7: HWcfp1hY1hqvrddzW3/FQw folded before Flop (didn't bet)
Seat 8: ji04uOybxCdpdefzlUQeKQ folded before Flop (didn't bet)
Seat 9: HZkVla4kK2SI42CVrPZ/ig folded before Flop (didn't bet)



PokerStars Game #59941246990:  Hold'em No Limit ($0.25/$0.50) - 2009/07/01 1:29:52 ET
Table 'Nz0Vr7WMHL2g5Uk7dDZjpw' 9-max Seat #9 is the button
Seat 1: 9yMsdgReyOUerNsmTYCCDQ ($9.50 in chips)
Seat 2: SegjDnMxWMujiD57ESNL+g ($19.10 in chips)
Seat 3: hoglu9inkgs6zN573/bJag ($5.20 in chips)
Seat 4: E2518gp4aFz1+kAgmGqeEg ($12.25 in chips)
Seat 5: WGW0DgjBUXs1ylURHG8vnQ ($12.40 in chips)
Seat 6: 997ViqAtWn1FPjJqcffwcA ($50 in chips)
Seat 7: KPLH0gELgFe2OuAnhJFI5w ($24.70 in chips)
Seat 8: aoL+R/61Kxmw69ypuPrWAQ ($32.30 in chips)
Seat 9: mSD1pginDsyHG5PDfqzphw ($19.25 in chips)
9yMsdgReyOUerNsmTYCCDQ: posts small blind $0.25
SegjDnMxWMujiD57ESNL+g: posts big blind $0.50
*** HOLE CARDS ***
hoglu9inkgs6zN573/bJag: folds
E2518gp4aFz1+kAgmGqeEg: folds
E2518gp4aFz1+kAgmGqeEg is sitting out
WGW0DgjBUXs1ylURHG8vnQ: folds
997ViqAtWn1FPjJqcffwcA: folds
KPLH0gELgFe2OuAnhJFI5w: folds
aoL+R/61Kxmw69ypuPrWAQ: calls $0.50
hoglu9inkgs6zN573/bJag leaves the table
mSD1pginDsyHG5PDfqzphw: folds
9yMsdgReyOUerNsmTYCCDQ: calls $0.25
SegjDnMxWMujiD57ESNL+g: raises $1.50 to $2
c638Xxo+q5F/t5qMtmvmvQ joins the table at seat #3
aoL+R/61Kxmw69ypuPrWAQ: folds
9yMsdgReyOUerNsmTYCCDQ: folds
SegjDnMxWMujiD57ESNL+g collected $1.50 from pot
SegjDnMxWMujiD57ESNL+g: doesn't show hand
*** SUMMARY ***
Total pot $1.50 | Rake $0
Seat 1: 9yMsdgReyOUerNsmTYCCDQ (small blind) folded before Flop
Seat 2: SegjDnMxWMujiD57ESNL+g (big blind) collected ($1.50)
Seat 3: hoglu9inkgs6zN573/bJag folded before Flop (didn't bet)
Seat 4: E2518gp4aFz1+kAgmGqeEg folded before Flop (didn't bet)
Seat 5: WGW0DgjBUXs1ylURHG8vnQ folded before Flop (didn't bet)
Seat 6: 997ViqAtWn1FPjJqcffwcA folded before Flop (didn't bet)
Seat 7: KPLH0gELgFe2OuAnhJFI5w folded before Flop (didn't bet)
Seat 8: aoL+R/61Kxmw69ypuPrWAQ folded before Flop
Seat 9: mSD1pginDsyHG5PDfqzphw (button) folded before Flop (didn't bet)



PokerStars Game #59941250746:  Hold'em No Limit ($0.25/$0.50) - 2009/07/01 1:29:58 ET
Table '8BQGgNetI1NOvWeu3gtMNw' 2-max Seat #2 is the button
Seat 1: bypIyrYcAAifLfhZpGlKLA ($56.90 in chips)
Seat 2: Z4HwehErEwzsv/noQlfUlg ($160.70 in chips)
Z4HwehErEwzsv/noQlfUlg: posts small blind $0.25
bypIyrYcAAifLfhZpGlKLA: posts big blind $0.50
*** HOLE CARDS ***
Z4HwehErEwzsv/noQlfUlg: calls $0.25
bypIyrYcAAifLfhZpGlKLA: raises $1.50 to $2
Z4HwehErEwzsv/noQlfUlg: folds
bypIyrYcAAifLfhZpGlKLA collected $1 from pot
bypIyrYcAAifLfhZpGlKLA: doesn't show hand
*** SUMMARY ***
Total pot $1 | Rake $0
Seat 1: bypIyrYcAAifLfhZpGlKLA (big blind) collected ($1)
Seat 2: Z4HwehErEwzsv/noQlfUlg (button) (small blind) folded before Flop



PokerStars Game #59941251660:  Hold'em No Limit ($0.25/$0.50) - 2009/07/01 1:30:00 ET
Table '2lPOwetm4cfkZPbTmGPH/w' 2-max Seat #2 is the button
Seat 1: vUGdApqS8J/GJE2gaVWl1w ($7.80 in chips)
Seat 2: XFa6sBGjP2gxoIvxR3fZIg ($34.60 in chips)
XFa6sBGjP2gxoIvxR3fZIg: posts small blind $0.25
vUGdApqS8J/GJE2gaVWl1w: posts big blind $0.50
*** HOLE CARDS ***
XFa6sBGjP2gxoIvxR3fZIg: raises $1 to $1.50
vUGdApqS8J/GJE2gaVWl1w: folds
XFa6sBGjP2gxoIvxR3fZIg collected $1 from pot
XFa6sBGjP2gxoIvxR3fZIg: doesn't show hand
*** SUMMARY ***
Total pot $1 | Rake $0
Seat 1: vUGdApqS8J/GJE2gaVWl1w (big blind) folded before Flop
Seat 2: XFa6sBGjP2gxoIvxR3fZIg (button) (small blind) collected ($1)



PokerStars Game #59941251850:  Hold'em No Limit ($0.25/$0.50) - 2009/07/01 1:30:00 ET
Table 'BCN5su+SsXiy1zRMJi0SJw' 6-max Seat #4 is the button
Seat 1: GxXV09ciXaOxyY2H5aMIIw ($32.80 in chips)
Seat 2: ehFNAevCQri3trWxV6FJdA ($61.90 in chips)
Seat 3: kwgv5lNhiFrfONXCshzxlA ($43.10 in chips)
Seat 4: bbsK8j+tpuVRhBqDzHxf7w ($49 in chips)
Seat 5: kxPhs4ePFqMy52CInAJ2aw ($51.55 in chips)
Seat 6: b2symlOdL7+0c9Pj4N/KlA ($66.65 in chips)
kxPhs4ePFqMy52CInAJ2aw: posts small blind $0.25
b2symlOdL7+0c9Pj4N/KlA: posts big blind $0.50
*** HOLE CARDS ***
GxXV09ciXaOxyY2H5aMIIw: folds
ehFNAevCQri3trWxV6FJdA: calls $0.50
kwgv5lNhiFrfONXCshzxlA: folds
bbsK8j+tpuVRhBqDzHxf7w: folds
kxPhs4ePFqMy52CInAJ2aw: folds
b2symlOdL7+0c9Pj4N/KlA: checks
*** FLOP *** [8h Jh Jd]
b2symlOdL7+0c9Pj4N/KlA: checks
ehFNAevCQri3trWxV6FJdA: checks
*** TURN *** [8h Jh Jd] [6d]
b2symlOdL7+0c9Pj4N/KlA: bets $0.50
ehFNAevCQri3trWxV6FJdA: calls $0.50
*** RIVER *** [8h Jh Jd 6d] [7d]
b2symlOdL7+0c9Pj4N/KlA: bets $1
ehFNAevCQri3trWxV6FJdA: calls $1
*** SHOW DOWN ***
b2symlOdL7+0c9Pj4N/KlA: shows [8s 9s] (two pair, Jacks and Eights)
ehFNAevCQri3trWxV6FJdA: mucks hand
b2symlOdL7+0c9Pj4N/KlA collected $4.05 from pot
*** SUMMARY ***
Total pot $4.25 | Rake $0.20
Board [8h Jh Jd 6d 7d]
Seat 1: GxXV09ciXaOxyY2H5aMIIw folded before Flop (didn't bet)
Seat 2: ehFNAevCQri3trWxV6FJdA mucked
Seat 3: kwgv5lNhiFrfONXCshzxlA folded before Flop (didn't bet)
Seat 4: bbsK8j+tpuVRhBqDzHxf7w (button) folded before Flop (didn't bet)
Seat 5: kxPhs4ePFqMy52CInAJ2aw (small blind) folded before Flop
Seat 6: b2symlOdL7+0c9Pj4N/KlA (big blind) showed [8s 9s] and won ($4.05) with two pair, Jacks and Eights



PokerStars Game #59941252916:  Hold'em No Limit ($0.25/$0.50) - 2009/07/01 1:30:02 ET
Table 'X6IRCRTh+20gjz8aubWnwA' 9-max Seat #4 is the button
Seat 2: HZkVla4kK2SI42CVrPZ/ig ($9.75 in chips)
Seat 3: SWv01peOe69QQRvhQTqjQw ($11.80 in chips)
Seat 4: M3JFBNQ8Bbw3FBZ/18MuXw ($34.15 in chips)
Seat 6: Qi/PyOsKwaqtKIg0H+7ELg ($7.25 in chips)
Seat 7: +RUz0sVA09ZE8PNpIl+EBQ ($27.25 in chips)
Seat 8: HxeBVq06/3Bh/H986sgdbw ($44.50 in chips)
Seat 9: M+7+BTmX5vZatHVuoRB1nA ($57.15 in chips)
Qi/PyOsKwaqtKIg0H+7ELg: posts small blind $0.25
+RUz0sVA09ZE8PNpIl+EBQ: posts big blind $0.50
*** HOLE CARDS ***
HxeBVq06/3Bh/H986sgdbw: calls $0.50
M+7+BTmX5vZatHVuoRB1nA: folds
HZkVla4kK2SI42CVrPZ/ig: folds
SWv01peOe69QQRvhQTqjQw: folds
M3JFBNQ8Bbw3FBZ/18MuXw: folds
Qi/PyOsKwaqtKIg0H+7ELg: raises $1.50 to $2
+RUz0sVA09ZE8PNpIl+EBQ: folds
HxeBVq06/3Bh/H986sgdbw: folds
HxeBVq06/3Bh/H986sgdbw is sitting out
Qi/PyOsKwaqtKIg0H+7ELg collected $1.50 from pot
Qi/PyOsKwaqtKIg0H+7ELg: doesn't show hand
*** SUMMARY ***
Total pot $1.50 | Rake $0
Seat 2: HZkVla4kK2SI42CVrPZ/ig folded before Flop (didn't bet)
Seat 3: SWv01peOe69QQRvhQTqjQw folded before Flop (didn't bet)
Seat 4: M3JFBNQ8Bbw3FBZ/18MuXw (button) folded before Flop (didn't bet)
Seat 6: Qi/PyOsKwaqtKIg0H+7ELg (small blind) collected ($1.50)
Seat 7: +RUz0sVA09ZE8PNpIl+EBQ (big blind) folded before Flop
Seat 8: HxeBVq06/3Bh/H986sgdbw folded before Flop
Seat 9: M+7+BTmX5vZatHVuoRB1nA folded before Flop (didn't bet)



PokerStars Game #59941252962:  Hold'em No Limit ($0.25/$0.50) - 2009/07/01 1:30:02 ET
Table '3FhG0gl3kMX3wBEEqj+wnQ' 9-max Seat #2 is the button
Seat 1: bxLSulbgr8LmKNjOzw8URg ($49.30 in chips)
Seat 2: vacmVLJJECYI6HjAynFcpg ($49.85 in chips)
Seat 3: YXCE3WOZi8g2sIf3y/plVw ($60 in chips)
Seat 4: e2+sK/yjnj94rXOKoxPP2A ($70.25 in chips)
Seat 5: XcLXSUMHSpshK/7Lh0M4Vg ($9.25 in chips)
Seat 6: 997ViqAtWn1FPjJqcffwcA ($109.80 in chips)
Seat 7: mSD1pginDsyHG5PDfqzphw ($12.50 in chips)
Seat 8: j3K/Jujr7PY4ZM2RZvlH6A ($44.60 in chips)
YXCE3WOZi8g2sIf3y/plVw: posts small blind $0.25
e2+sK/yjnj94rXOKoxPP2A: posts big blind $0.50
*** HOLE CARDS ***
XcLXSUMHSpshK/7Lh0M4Vg: folds
997ViqAtWn1FPjJqcffwcA: folds
mSD1pginDsyHG5PDfqzphw: folds
j3K/Jujr7PY4ZM2RZvlH6A: raises $0.50 to $1
bxLSulbgr8LmKNjOzw8URg: folds
vacmVLJJECYI6HjAynFcpg: folds
YXCE3WOZi8g2sIf3y/plVw: folds
e2+sK/yjnj94rXOKoxPP2A: folds
j3K/Jujr7PY4ZM2RZvlH6A collected $1.25 from pot
j3K/Jujr7PY4ZM2RZvlH6A: doesn't show hand
*** SUMMARY ***
Total pot $1.25 | Rake $0
Seat 1: bxLSulbgr8LmKNjOzw8URg folded before Flop (didn't bet)
Seat 2: vacmVLJJECYI6HjAynFcpg (button) folded before Flop (didn't bet)
Seat 3: YXCE3WOZi8g2sIf3y/plVw (small blind) folded before Flop
Seat 4: e2+sK/yjnj94rXOKoxPP2A (big blind) folded before Flop
Seat 5: XcLXSUMHSpshK/7Lh0M4Vg folded before Flop (didn't bet)
Seat 6: 997ViqAtWn1FPjJqcffwcA folded before Flop (didn't bet)
Seat 7: mSD1pginDsyHG5PDfqzphw folded before Flop (didn't bet)
Seat 8: j3K/Jujr7PY4ZM2RZvlH6A collected ($1.25)



PokerStars Game #59941252988:  Hold'em No Limit ($0.25/$0.50) - 2009/07/01 1:30:02 ET
Table '+z1aekfHkpp09pc8F9aViw' 6-max Seat #2 is the button
Seat 1: /DArfRoYc3YpLsOQSZubFg ($52.75 in chips)
Seat 2: 4QfsCWthT/vSLirorNXqtg ($50 in chips)
Seat 3: URYNc7fPA23K2UfadQbnCA ($48.75 in chips)
Seat 5: 2igtJLmvIZ+HqX4XPgMPZA ($51.70 in chips)
Seat 6: GUnvMULl2qFOO1yenu1UBw ($52.25 in chips)
URYNc7fPA23K2UfadQbnCA: posts small blind $0.25
2igtJLmvIZ+HqX4XPgMPZA: posts big blind $0.50
*** HOLE CARDS ***
GUnvMULl2qFOO1yenu1UBw: folds
/DArfRoYc3YpLsOQSZubFg: folds
4QfsCWthT/vSLirorNXqtg: raises $1 to $1.50
URYNc7fPA23K2UfadQbnCA: folds
2igtJLmvIZ+HqX4XPgMPZA: folds
4QfsCWthT/vSLirorNXqtg collected $1.25 from pot
4QfsCWthT/vSLirorNXqtg: doesn't show hand
*** SUMMARY ***
Total pot $1.25 | Rake $0
Seat 1: /DArfRoYc3YpLsOQSZubFg folded before Flop (didn't bet)
Seat 2: 4QfsCWthT/vSLirorNXqtg (button) collected ($1.25)
Seat 3: URYNc7fPA23K2UfadQbnCA (small blind) folded before Flop
Seat 5: 2igtJLmvIZ+HqX4XPgMPZA (big blind) folded before Flop
Seat 6: GUnvMULl2qFOO1yenu1UBw folded before Flop (didn't bet)



PokerStars Game #59941253420:  Hold'em No Limit ($0.25/$0.50) - 2009/07/01 1:30:03 ET
Table 'Oih5mInDJ8x49ONa0YdsPw' 2-max Seat #1 is the button
Seat 1: FeErMt4Gvt/3PH2oB/pn4A ($10.20 in chips)
Seat 2: CR6EAGkYzPzxXXZY9pip8Q ($9.25 in chips)
FeErMt4Gvt/3PH2oB/pn4A: posts small blind $0.25
CR6EAGkYzPzxXXZY9pip8Q: posts big blind $0.50
*** HOLE CARDS ***
FeErMt4Gvt/3PH2oB/pn4A: raises $1 to $1.50
CR6EAGkYzPzxXXZY9pip8Q: folds
FeErMt4Gvt/3PH2oB/pn4A collected $1 from pot
FeErMt4Gvt/3PH2oB/pn4A: doesn't show hand
*** SUMMARY ***
Total pot $1 | Rake $0
Seat 1: FeErMt4Gvt/3PH2oB/pn4A (button) (small blind) collected ($1)
Seat 2: CR6EAGkYzPzxXXZY9pip8Q (big blind) folded before Flop



PokerStars Game #59941253920:  Hold'em No Limit ($0.25/$0.50) - 2009/07/01 1:30:04 ET
Table 'lSisgp6H7Fg1hH5VfjEjYQ' 9-max Seat #8 is the button
Seat 1: 5k9fvXD9suIgCxU4HLQjTw ($53.35 in chips)
Seat 3: SKnJuWHScqetA/qG5p+wCg ($30 in chips)
Seat 4: bwv/rbH/hHhPhY6u9mu04w ($37.40 in chips)
Seat 5: mSD1pginDsyHG5PDfqzphw ($12.25 in chips)
Seat 6: +k7T5ocke8UwavtgUHm+Cg ($72.20 in chips)
Seat 7: IDtNLR9uFCDdjNsJWMHA5Q ($20.35 in chips)
Seat 8: a4JDWmpFQkL10XfAyuF51A ($10 in chips)
Seat 9: YzeKFbJVLmJGTgNH3ySQlw ($9.45 in chips)
YzeKFbJVLmJGTgNH3ySQlw: posts small blind $0.25
5k9fvXD9suIgCxU4HLQjTw: posts big blind $0.50
5acK4E7fzEwnplVBZ6eNWA: sits out
*** HOLE CARDS ***
SKnJuWHScqetA/qG5p+wCg: folds
bwv/rbH/hHhPhY6u9mu04w: folds
mSD1pginDsyHG5PDfqzphw: folds
+k7T5ocke8UwavtgUHm+Cg: folds
IDtNLR9uFCDdjNsJWMHA5Q: folds
a4JDWmpFQkL10XfAyuF51A: calls $0.50
YzeKFbJVLmJGTgNH3ySQlw: calls $0.25
5k9fvXD9suIgCxU4HLQjTw: checks
*** FLOP *** [Ks Jc Kc]
bwv/rbH/hHhPhY6u9mu04w is sitting out
YzeKFbJVLmJGTgNH3ySQlw: checks
5k9fvXD9suIgCxU4HLQjTw: checks
a4JDWmpFQkL10XfAyuF51A: checks
*** TURN *** [Ks Jc Kc] [Ts]
YzeKFbJVLmJGTgNH3ySQlw: checks
5k9fvXD9suIgCxU4HLQjTw: checks
a4JDWmpFQkL10XfAyuF51A: checks
*** RIVER *** [Ks Jc Kc Ts] [8c]
YzeKFbJVLmJGTgNH3ySQlw: checks
5k9fvXD9suIgCxU4HLQjTw: checks
a4JDWmpFQkL10XfAyuF51A: checks
*** SHOW DOWN ***
YzeKFbJVLmJGTgNH3ySQlw: shows [7h 3d] (a pair of Kings)
5k9fvXD9suIgCxU4HLQjTw: shows [Jh 3c] (two pair, Kings and Jacks)
a4JDWmpFQkL10XfAyuF51A: mucks hand
5k9fvXD9suIgCxU4HLQjTw collected $1.45 from pot
*** SUMMARY ***
Total pot $1.50 | Rake $0.05
Board [Ks Jc Kc Ts 8c]
Seat 1: 5k9fvXD9suIgCxU4HLQjTw (big blind) showed [Jh 3c] and won ($1.45) with two pair, Kings and Jacks
Seat 3: SKnJuWHScqetA/qG5p+wCg folded before Flop (didn't bet)
Seat 4: bwv/rbH/hHhPhY6u9mu04w folded before Flop (didn't bet)
Seat 5: mSD1pginDsyHG5PDfqzphw folded before Flop (didn't bet)
Seat 6: +k7T5ocke8UwavtgUHm+Cg folded before Flop (didn't bet)
Seat 7: IDtNLR9uFCDdjNsJWMHA5Q folded before Flop (didn't bet)
Seat 8: a4JDWmpFQkL10XfAyuF51A (button) mucked
Seat 9: YzeKFbJVLmJGTgNH3ySQlw (small blind) showed [7h 3d] and lost with a pair of Kings



PokerStars Game #59941253744:  Hold'em No Limit ($0.25/$0.50) - 2009/07/01 1:30:04 ET
Table 'iq+aXfWVQRdV0u8SRTYUEg' 9-max Seat #5 is the button
Seat 1: 3yl8Q6QaLfGtyhN4/pEFgQ ($78.05 in chips)
Seat 2: J9N0lxHFd/Js2S0xZLbsIQ ($27.60 in chips)
Seat 3: Qi/PyOsKwaqtKIg0H+7ELg ($9.75 in chips)
Seat 4: vHYT5s323LpajBj+2c9zbQ ($32.10 in chips)
Seat 5: 997ViqAtWn1FPjJqcffwcA ($50 in chips)
Seat 6: bTJ0WgoxefTPxIoycS7uoA ($31.20 in chips)
Seat 7: SKnJuWHScqetA/qG5p+wCg ($31.55 in chips)
Seat 8: /DtIHuxEH+3tzKefmSV+Mw ($36.85 in chips)
Seat 9: olE1Z2rKWAV8+tGqmIBK9g ($28.45 in chips)
bTJ0WgoxefTPxIoycS7uoA: posts small blind $0.25
SKnJuWHScqetA/qG5p+wCg: posts big blind $0.50
*** HOLE CARDS ***
/DtIHuxEH+3tzKefmSV+Mw: folds
olE1Z2rKWAV8+tGqmIBK9g: raises $1 to $1.50
3yl8Q6QaLfGtyhN4/pEFgQ: folds
J9N0lxHFd/Js2S0xZLbsIQ: calls $1.50
Qi/PyOsKwaqtKIg0H+7ELg: folds
vHYT5s323LpajBj+2c9zbQ: folds
997ViqAtWn1FPjJqcffwcA: raises $4.50 to $6
bTJ0WgoxefTPxIoycS7uoA: folds
SKnJuWHScqetA/qG5p+wCg: folds
olE1Z2rKWAV8+tGqmIBK9g: folds
J9N0lxHFd/Js2S0xZLbsIQ: calls $4.50
*** FLOP *** [4s 5h Jd]
J9N0lxHFd/Js2S0xZLbsIQ: checks
997ViqAtWn1FPjJqcffwcA: bets $8.50
J9N0lxHFd/Js2S0xZLbsIQ: folds
997ViqAtWn1FPjJqcffwcA collected $13.55 from pot
*** SUMMARY ***
Total pot $14.25 | Rake $0.70
Board [4s 5h Jd]
Seat 1: 3yl8Q6QaLfGtyhN4/pEFgQ folded before Flop (didn't bet)
Seat 2: J9N0lxHFd/Js2S0xZLbsIQ folded on the Flop
Seat 3: Qi/PyOsKwaqtKIg0H+7ELg folded before Flop (didn't bet)
Seat 4: vHYT5s323LpajBj+2c9zbQ folded before Flop (didn't bet)
Seat 5: 997ViqAtWn1FPjJqcffwcA (button) collected ($13.55)
Seat 6: bTJ0WgoxefTPxIoycS7uoA (small blind) folded before Flop
Seat 7: SKnJuWHScqetA/qG5p+wCg (big blind) folded before Flop
Seat 8: /DtIHuxEH+3tzKefmSV+Mw folded before Flop (didn't bet)
Seat 9: olE1Z2rKWAV8+tGqmIBK9g folded before Flop



PokerStars Game #59941254894:  Hold'em No Limit ($0.25/$0.50) - 2009/07/01 1:30:06 ET
Table '+dXkOAQyS8j9PQZusUTMpg' 2-max Seat #2 is the button
Seat 1: Teld4PDKla7C8/Wfu2DSkg ($52.15 in chips)
Seat 2: +zI4bP23YIjMkUHqeN2xfw ($24.50 in chips)
+zI4bP23YIjMkUHqeN2xfw: posts small blind $0.25
Teld4PDKla7C8/Wfu2DSkg: posts big blind $0.50
*** HOLE CARDS ***
+zI4bP23YIjMkUHqeN2xfw: folds
Teld4PDKla7C8/Wfu2DSkg collected $0.50 from pot
Teld4PDKla7C8/Wfu2DSkg: doesn't show hand
*** SUMMARY ***
Total pot $0.50 | Rake $0
Seat 1: Teld4PDKla7C8/Wfu2DSkg (big blind) collected ($0.50)
Seat 2: +zI4bP23YIjMkUHqeN2xfw (button) (small blind) folded before Flop



PokerStars Game #59941256000:  Hold'em No Limit ($0.25/$0.50) - 2009/07/01 1:30:08 ET
Table '9ojijpRcYQSQTh6xI+haUA' 2-max Seat #2 is the button
Seat 1: FqpibuVWLNsAN/Z7ROZLnA ($43 in chips)
Seat 2: TitTV+fFCcBZWOERdytydA ($43.15 in chips)
TitTV+fFCcBZWOERdytydA: posts small blind $0.25
FqpibuVWLNsAN/Z7ROZLnA: posts big blind $0.50
*** HOLE CARDS ***
TitTV+fFCcBZWOERdytydA: folds
FqpibuVWLNsAN/Z7ROZLnA collected $0.50 from pot
*** SUMMARY ***
Total pot $0.50 | Rake $0
Seat 1: FqpibuVWLNsAN/Z7ROZLnA (big blind) collected ($0.50)
Seat 2: TitTV+fFCcBZWOERdytydA (button) (small blind) folded before Flop



PokerStars Game #59941256330:  Hold'em No Limit ($0.25/$0.50) - 2009/07/01 1:30:08 ET
Table 'tyR5AZNKV8Aadbrnrnlg7g' 6-max Seat #4 is the button
Seat 1: BgOXYI0yYSN1ULC4FqsNkg ($83.30 in chips)
Seat 2: BAjwVL+zKKd0s0fAWstzQQ ($13.95 in chips)
Seat 3: JFLrYNyQmwPhRQAtoSAuyA ($59.75 in chips)
Seat 4: 4QfsCWthT/vSLirorNXqtg ($85.20 in chips)
Seat 5: GUnvMULl2qFOO1yenu1UBw ($78.25 in chips)
Seat 6: 498aWaGsW4uGfuWl+2FCGw ($64.05 in chips)
GUnvMULl2qFOO1yenu1UBw: posts small blind $0.25
498aWaGsW4uGfuWl+2FCGw: posts big blind $0.50
*** HOLE CARDS ***
BgOXYI0yYSN1ULC4FqsNkg: folds
BAjwVL+zKKd0s0fAWstzQQ: folds
JFLrYNyQmwPhRQAtoSAuyA: folds
4QfsCWthT/vSLirorNXqtg: folds
GUnvMULl2qFOO1yenu1UBw: folds
498aWaGsW4uGfuWl+2FCGw collected $0.50 from pot
*** SUMMARY ***
Total pot $0.50 | Rake $0
Seat 1: BgOXYI0yYSN1ULC4FqsNkg folded before Flop (didn't bet)
Seat 2: BAjwVL+zKKd0s0fAWstzQQ folded before Flop (didn't bet)
Seat 3: JFLrYNyQmwPhRQAtoSAuyA folded before Flop (didn't bet)
Seat 4: 4QfsCWthT/vSLirorNXqtg (button) folded before Flop (didn't bet)
Seat 5: GUnvMULl2qFOO1yenu1UBw (small blind) folded before Flop
Seat 6: 498aWaGsW4uGfuWl+2FCGw (big blind) collected ($0.50)



PokerStars Game #59941256860:  Hold'em No Limit ($0.25/$0.50) - 2009/07/01 1:30:09 ET
Table '2lPOwetm4cfkZPbTmGPH/w' 2-max Seat #1 is the button
Seat 1: vUGdApqS8J/GJE2gaVWl1w ($7.30 in chips)
Seat 2: XFa6sBGjP2gxoIvxR3fZIg ($35.10 in chips)
vUGdApqS8J/GJE2gaVWl1w: posts small blind $0.25
XFa6sBGjP2gxoIvxR3fZIg: posts big blind $0.50
*** HOLE CARDS ***
vUGdApqS8J/GJE2gaVWl1w: calls $0.25
XFa6sBGjP2gxoIvxR3fZIg: checks
*** FLOP *** [8d Qd 4h]
XFa6sBGjP2gxoIvxR3fZIg: checks
vUGdApqS8J/GJE2gaVWl1w: checks
*** TURN *** [8d Qd 4h] [As]
XFa6sBGjP2gxoIvxR3fZIg: checks
vUGdApqS8J/GJE2gaVWl1w: checks
*** RIVER *** [8d Qd 4h As] [Qs]
XFa6sBGjP2gxoIvxR3fZIg: checks
vUGdApqS8J/GJE2gaVWl1w: checks
*** SHOW DOWN ***
XFa6sBGjP2gxoIvxR3fZIg: shows [Td 9s] (a pair of Queens)
vUGdApqS8J/GJE2gaVWl1w: mucks hand
XFa6sBGjP2gxoIvxR3fZIg collected $0.95 from pot
*** SUMMARY ***
Total pot $1 | Rake $0.05
Board [8d Qd 4h As Qs]
Seat 1: vUGdApqS8J/GJE2gaVWl1w (button) (small blind) mucked
Seat 2: XFa6sBGjP2gxoIvxR3fZIg (big blind) showed [Td 9s] and won ($0.95) with a pair of Queens



PokerStars Game #59941257664:  Hold'em No Limit ($0.25/$0.50) - 2009/07/01 1:30:11 ET
Table 'Oih5mInDJ8x49ONa0YdsPw' 2-max Seat #2 is the button
Seat 1: FeErMt4Gvt/3PH2oB/pn4A ($10.70 in chips)
Seat 2: CR6EAGkYzPzxXXZY9pip8Q ($8.75 in chips)
CR6EAGkYzPzxXXZY9pip8Q: posts small blind $0.25
FeErMt4Gvt/3PH2oB/pn4A: posts big blind $0.50
*** HOLE CARDS ***
CR6EAGkYzPzxXXZY9pip8Q: raises $0.50 to $1
FeErMt4Gvt/3PH2oB/pn4A: folds
CR6EAGkYzPzxXXZY9pip8Q collected $1 from pot
*** SUMMARY ***
Total pot $1 | Rake $0
Seat 1: FeErMt4Gvt/3PH2oB/pn4A (big blind) folded before Flop
Seat 2: CR6EAGkYzPzxXXZY9pip8Q (button) (small blind) collected ($1)



PokerStars Game #59941258376:  Hold'em No Limit ($0.25/$0.50) - 2009/07/01 1:30:12 ET
Table 'hWT2kq66tnKEpD26cia6fQ' 2-max Seat #2 is the button
Seat 1: Ce3KNFP+ao7Da9NHb65raw ($33.10 in chips)
Seat 2: 16tvT7AYgZ2LgiGFcvFKQg ($43.40 in chips)
16tvT7AYgZ2LgiGFcvFKQg: posts small blind $0.25
Ce3KNFP+ao7Da9NHb65raw: posts big blind $0.50
*** HOLE CARDS ***
16tvT7AYgZ2LgiGFcvFKQg: raises $0.50 to $1
Ce3KNFP+ao7Da9NHb65raw: calls $0.50
*** FLOP *** [3c 8c 8h]
Ce3KNFP+ao7Da9NHb65raw: checks
16tvT7AYgZ2LgiGFcvFKQg: bets $1
Ce3KNFP+ao7Da9NHb65raw: raises $2 to $3
16tvT7AYgZ2LgiGFcvFKQg: calls $2
*** TURN *** [3c 8c 8h] [7h]
Ce3KNFP+ao7Da9NHb65raw: bets $4
16tvT7AYgZ2LgiGFcvFKQg: calls $4
*** RIVER *** [3c 8c 8h 7h] [6h]
Ce3KNFP+ao7Da9NHb65raw: bets $11.50
16tvT7AYgZ2LgiGFcvFKQg: calls $11.50
*** SHOW DOWN ***
Ce3KNFP+ao7Da9NHb65raw: shows [8s 9c] (three of a kind, Eights)
16tvT7AYgZ2LgiGFcvFKQg: shows [Jh Jd] (two pair, Jacks and Eights)
Ce3KNFP+ao7Da9NHb65raw collected $38.50 from pot
*** SUMMARY ***
Total pot $39 | Rake $0.50
Board [3c 8c 8h 7h 6h]
Seat 1: Ce3KNFP+ao7Da9NHb65raw (big blind) showed [8s 9c] and won ($38.50) with three of a kind, Eights
Seat 2: 16tvT7AYgZ2LgiGFcvFKQg (button) (small blind) showed [Jh Jd] and lost with two pair, Jacks and Eights



PokerStars Game #59941258148:  Hold'em No Limit ($0.25/$0.50) - 2009/07/01 1:30:12 ET
Table '+dXkOAQyS8j9PQZusUTMpg' 2-max Seat #1 is the button
Seat 1: Teld4PDKla7C8/Wfu2DSkg ($52.40 in chips)
Seat 2: +zI4bP23YIjMkUHqeN2xfw ($24.25 in chips)
Teld4PDKla7C8/Wfu2DSkg: posts small blind $0.25
+zI4bP23YIjMkUHqeN2xfw: posts big blind $0.50
*** HOLE CARDS ***
Teld4PDKla7C8/Wfu2DSkg: raises $0.50 to $1
+zI4bP23YIjMkUHqeN2xfw: folds
Teld4PDKla7C8/Wfu2DSkg collected $1 from pot
*** SUMMARY ***
Total pot $1 | Rake $0
Seat 1: Teld4PDKla7C8/Wfu2DSkg (button) (small blind) collected ($1)
Seat 2: +zI4bP23YIjMkUHqeN2xfw (big blind) folded before Flop



PokerStars Game #59941260288:  Hold'em No Limit ($0.25/$0.50) - 2009/07/01 1:30:16 ET
Table '9ojijpRcYQSQTh6xI+haUA' 2-max Seat #1 is the button
Seat 1: FqpibuVWLNsAN/Z7ROZLnA ($43.25 in chips)
Seat 2: TitTV+fFCcBZWOERdytydA ($42.90 in chips)
FqpibuVWLNsAN/Z7ROZLnA: posts small blind $0.25
TitTV+fFCcBZWOERdytydA: posts big blind $0.50
*** HOLE CARDS ***
FqpibuVWLNsAN/Z7ROZLnA: calls $0.25
TitTV+fFCcBZWOERdytydA: checks
*** FLOP *** [5h 3d 7h]
TitTV+fFCcBZWOERdytydA: checks
FqpibuVWLNsAN/Z7ROZLnA: bets $1
TitTV+fFCcBZWOERdytydA: raises $1.50 to $2.50
FqpibuVWLNsAN/Z7ROZLnA: calls $1.50
*** TURN *** [5h 3d 7h] [7c]
TitTV+fFCcBZWOERdytydA: checks
FqpibuVWLNsAN/Z7ROZLnA: bets $2
TitTV+fFCcBZWOERdytydA: raises $6 to $8
FqpibuVWLNsAN/Z7ROZLnA: folds
TitTV+fFCcBZWOERdytydA collected $9.55 from pot
TitTV+fFCcBZWOERdytydA: doesn't show hand
*** SUMMARY ***
Total pot $10 | Rake $0.45
Board [5h 3d 7h 7c]
Seat 1: FqpibuVWLNsAN/Z7ROZLnA (button) (small blind) folded on the Turn
Seat 2: TitTV+fFCcBZWOERdytydA (big blind) collected ($9.55)



PokerStars Game #59941261638:  Hold'em No Limit ($0.25/$0.50) - 2009/07/01 1:30:18 ET
Table 'Oih5mInDJ8x49ONa0YdsPw' 2-max Seat #1 is the button
Seat 1: FeErMt4Gvt/3PH2oB/pn4A ($10.20 in chips)
Seat 2: CR6EAGkYzPzxXXZY9pip8Q ($9.25 in chips)
FeErMt4Gvt/3PH2oB/pn4A: posts small blind $0.25
CR6EAGkYzPzxXXZY9pip8Q: posts big blind $0.50
*** HOLE CARDS ***
FeErMt4Gvt/3PH2oB/pn4A: calls $0.25
CR6EAGkYzPzxXXZY9pip8Q: checks
*** FLOP *** [Qd 5c 5d]
CR6EAGkYzPzxXXZY9pip8Q: checks
FeErMt4Gvt/3PH2oB/pn4A: checks
*** TURN *** [Qd 5c 5d] [7h]
CR6EAGkYzPzxXXZY9pip8Q: checks
FeErMt4Gvt/3PH2oB/pn4A: bets $1
CR6EAGkYzPzxXXZY9pip8Q: folds
FeErMt4Gvt/3PH2oB/pn4A collected $0.95 from pot
FeErMt4Gvt/3PH2oB/pn4A: doesn't show hand
*** SUMMARY ***
Total pot $1 | Rake $0.05
Board [Qd 5c 5d 7h]
Seat 1: FeErMt4Gvt/3PH2oB/pn4A (button) (small blind) collected ($0.95)
Seat 2: CR6EAGkYzPzxXXZY9pip8Q (big blind) folded on the Turn



PokerStars Game #59941261442:  Hold'em No Limit ($0.25/$0.50) - 2009/07/01 1:30:18 ET
Table '8BQGgNetI1NOvWeu3gtMNw' 2-max Seat #1 is the button
Seat 1: bypIyrYcAAifLfhZpGlKLA ($57.40 in chips)
Seat 2: Z4HwehErEwzsv/noQlfUlg ($160.20 in chips)
bypIyrYcAAifLfhZpGlKLA: posts small blind $0.25
Z4HwehErEwzsv/noQlfUlg: posts big blind $0.50
*** HOLE CARDS ***
bypIyrYcAAifLfhZpGlKLA: raises $1 to $1.50
Z4HwehErEwzsv/noQlfUlg: calls $1
*** FLOP *** [4s Ac 6d]
Z4HwehErEwzsv/noQlfUlg: bets $1
bypIyrYcAAifLfhZpGlKLA: calls $1
*** TURN *** [4s Ac 6d] [2d]
Z4HwehErEwzsv/noQlfUlg: bets $2.50
bypIyrYcAAifLfhZpGlKLA: raises $6 to $8.50
Z4HwehErEwzsv/noQlfUlg: calls $6
*** RIVER *** [4s Ac 6d 2d] [Ks]
Z4HwehErEwzsv/noQlfUlg: checks
bypIyrYcAAifLfhZpGlKLA: bets $15
Z4HwehErEwzsv/noQlfUlg: folds
bypIyrYcAAifLfhZpGlKLA collected $21.50 from pot
bypIyrYcAAifLfhZpGlKLA: doesn't show hand
*** SUMMARY ***
Total pot $22 | Rake $0.50
Board [4s Ac 6d 2d Ks]
Seat 1: bypIyrYcAAifLfhZpGlKLA (button) (small blind) collected ($21.50)
Seat 2: Z4HwehErEwzsv/noQlfUlg (big blind) folded on the River



PokerStars Game #59941261540:  Hold'em No Limit ($0.25/$0.50) - 2009/07/01 1:30:18 ET
Table 'B+sqsfj6d6zXicNfaseTaw' 2-max Seat #2 is the button
Seat 1: +4GNcSsecmapVGSdV0mUPA ($128.55 in chips)
Seat 2: Lv5RmpRe6LtPkBzM9Gpo5A ($96.05 in chips)
Lv5RmpRe6LtPkBzM9Gpo5A: posts small blind $0.25
+4GNcSsecmapVGSdV0mUPA: posts big blind $0.50
*** HOLE CARDS ***
Lv5RmpRe6LtPkBzM9Gpo5A: calls $0.25
+4GNcSsecmapVGSdV0mUPA: checks
*** FLOP *** [3s Ah Ks]
+4GNcSsecmapVGSdV0mUPA: checks
Lv5RmpRe6LtPkBzM9Gpo5A: checks
*** TURN *** [3s Ah Ks] [Jd]
+4GNcSsecmapVGSdV0mUPA: checks
Lv5RmpRe6LtPkBzM9Gpo5A: checks
*** RIVER *** [3s Ah Ks Jd] [Kd]
+4GNcSsecmapVGSdV0mUPA: checks
Lv5RmpRe6LtPkBzM9Gpo5A: checks
*** SHOW DOWN ***
+4GNcSsecmapVGSdV0mUPA: shows [3d 9c] (two pair, Kings and Threes)
Lv5RmpRe6LtPkBzM9Gpo5A: mucks hand
+4GNcSsecmapVGSdV0mUPA collected $0.95 from pot
*** SUMMARY ***
Total pot $1 | Rake $0.05
Board [3s Ah Ks Jd Kd]
Seat 1: +4GNcSsecmapVGSdV0mUPA (big blind) showed [3d 9c] and won ($0.95) with two pair, Kings and Threes
Seat 2: Lv5RmpRe6LtPkBzM9Gpo5A (button) (small blind) mucked



PokerStars Game #59941261978:  Hold'em No Limit ($0.25/$0.50) - 2009/07/01 1:30:19 ET
Table '+dXkOAQyS8j9PQZusUTMpg' 2-max Seat #2 is the button
Seat 1: Teld4PDKla7C8/Wfu2DSkg ($52.90 in chips)
Seat 2: +zI4bP23YIjMkUHqeN2xfw ($23.75 in chips)
+zI4bP23YIjMkUHqeN2xfw: posts small blind $0.25
Teld4PDKla7C8/Wfu2DSkg: posts big blind $0.50
*** HOLE CARDS ***
+zI4bP23YIjMkUHqeN2xfw: raises $1 to $1.50
Teld4PDKla7C8/Wfu2DSkg: folds
+zI4bP23YIjMkUHqeN2xfw collected $1 from pot
*** SUMMARY ***
Total pot $1 | Rake $0
Seat 1: Teld4PDKla7C8/Wfu2DSkg (big blind) folded before Flop
Seat 2: +zI4bP23YIjMkUHqeN2xfw (button) (small blind) collected ($1)



PokerStars Game #59941262420:  Hold'em No Limit ($0.25/$0.50) - 2009/07/01 1:30:20 ET
Table 'GfL/No5u5PoEnU39lP5pQg' 6-max Seat #5 is the button
Seat 1: 1WUCqNG+p+vfWRTXNu4ljw ($61.25 in chips)
Seat 2: uVwggSetzp7d+eVgowO3vg ($49.25 in chips)
Seat 3: 4pp9WxhGdbVbxCc9tlu0lw ($26.05 in chips)
Seat 4: r6u7MWSXF30/khcTYkrG9Q ($30.60 in chips)
Seat 5: M1KyQQvVPVuxqTAB8sR/zQ ($59.60 in chips)
Seat 6: kxPhs4ePFqMy52CInAJ2aw ($64.75 in chips)
kxPhs4ePFqMy52CInAJ2aw: posts small blind $0.25
1WUCqNG+p+vfWRTXNu4ljw: posts big blind $0.50
*** HOLE CARDS ***
uVwggSetzp7d+eVgowO3vg: calls $0.50
4pp9WxhGdbVbxCc9tlu0lw: folds
r6u7MWSXF30/khcTYkrG9Q: calls $0.50
M1KyQQvVPVuxqTAB8sR/zQ: folds
kxPhs4ePFqMy52CInAJ2aw: folds
1WUCqNG+p+vfWRTXNu4ljw: checks
*** FLOP *** [Jh 7h Ah]
1WUCqNG+p+vfWRTXNu4ljw: checks
uVwggSetzp7d+eVgowO3vg: checks
r6u7MWSXF30/khcTYkrG9Q: checks
*** TURN *** [Jh 7h Ah] [2h]
1WUCqNG+p+vfWRTXNu4ljw: checks
uVwggSetzp7d+eVgowO3vg: checks
r6u7MWSXF30/khcTYkrG9Q: checks
*** RIVER *** [Jh 7h Ah 2h] [As]
1WUCqNG+p+vfWRTXNu4ljw: checks
uVwggSetzp7d+eVgowO3vg: checks
r6u7MWSXF30/khcTYkrG9Q: checks
*** SHOW DOWN ***
1WUCqNG+p+vfWRTXNu4ljw: shows [3h 6s] (a flush, Ace high)
uVwggSetzp7d+eVgowO3vg: mucks hand
r6u7MWSXF30/khcTYkrG9Q: mucks hand
1WUCqNG+p+vfWRTXNu4ljw collected $1.70 from pot
*** SUMMARY ***
Total pot $1.75 | Rake $0.05
Board [Jh 7h Ah 2h As]
Seat 1: 1WUCqNG+p+vfWRTXNu4ljw (big blind) showed [3h 6s] and won ($1.70) with a flush, Ace high
Seat 2: uVwggSetzp7d+eVgowO3vg mucked
Seat 3: 4pp9WxhGdbVbxCc9tlu0lw folded before Flop (didn't bet)
Seat 4: r6u7MWSXF30/khcTYkrG9Q mucked
Seat 5: M1KyQQvVPVuxqTAB8sR/zQ (button) folded before Flop (didn't bet)
Seat 6: kxPhs4ePFqMy52CInAJ2aw (small blind) folded before Flop



PokerStars Game #59941262900:  Hold'em No Limit ($0.25/$0.50) - 2009/07/01 1:30:20 ET
Table 'ZYI3ZReBjdfKEYItkZHI6A' 9-max Seat #4 is the button
Seat 1: IYd5zG8k7vdBNVHbHg2Pag ($63.65 in chips)
Seat 3: 75K2MXwN65Sjfp1yHd50Hg ($9.25 in chips)
Seat 4: e2+sK/yjnj94rXOKoxPP2A ($60.90 in chips)
Seat 5: ApHP7ouup365XIUFBdEDxg ($16.20 in chips)
Seat 6: 1xBtrSVBbgFH/viUWKqQeg ($29.45 in chips)
Seat 7: HWcfp1hY1hqvrddzW3/FQw ($16.15 in chips)
Seat 8: ji04uOybxCdpdefzlUQeKQ ($30.55 in chips)
Seat 9: HZkVla4kK2SI42CVrPZ/ig ($9.25 in chips)
ApHP7ouup365XIUFBdEDxg: posts small blind $0.25
1xBtrSVBbgFH/viUWKqQeg: posts big blind $0.50
5acK4E7fzEwnplVBZ6eNWA: sits out
*** HOLE CARDS ***
HWcfp1hY1hqvrddzW3/FQw: raises $0.50 to $1
ji04uOybxCdpdefzlUQeKQ: folds
HZkVla4kK2SI42CVrPZ/ig: folds
IYd5zG8k7vdBNVHbHg2Pag: folds
75K2MXwN65Sjfp1yHd50Hg: folds
e2+sK/yjnj94rXOKoxPP2A: folds
ApHP7ouup365XIUFBdEDxg: folds
1xBtrSVBbgFH/viUWKqQeg: raises $2 to $3
HWcfp1hY1hqvrddzW3/FQw: calls $2
*** FLOP *** [5h 6c Th]
1xBtrSVBbgFH/viUWKqQeg: checks
HWcfp1hY1hqvrddzW3/FQw: checks
*** TURN *** [5h 6c Th] [Qd]
1xBtrSVBbgFH/viUWKqQeg: checks
HWcfp1hY1hqvrddzW3/FQw: checks
*** RIVER *** [5h 6c Th Qd] [5c]
1xBtrSVBbgFH/viUWKqQeg: bets $4
HWcfp1hY1hqvrddzW3/FQw: calls $4
*** SHOW DOWN ***
1xBtrSVBbgFH/viUWKqQeg: shows [Ks Ah] (a pair of Fives)
HWcfp1hY1hqvrddzW3/FQw: shows [Kc As] (a pair of Fives)
1xBtrSVBbgFH/viUWKqQeg collected $6.80 from pot
HWcfp1hY1hqvrddzW3/FQw collected $6.80 from pot
*** SUMMARY ***
Total pot $14.25 | Rake $0.65
Board [5h 6c Th Qd 5c]
Seat 1: IYd5zG8k7vdBNVHbHg2Pag folded before Flop (didn't bet)
Seat 3: 75K2MXwN65Sjfp1yHd50Hg folded before Flop (didn't bet)
Seat 4: e2+sK/yjnj94rXOKoxPP2A (button) folded before Flop (didn't bet)
Seat 5: ApHP7ouup365XIUFBdEDxg (small blind) folded before Flop
Seat 6: 1xBtrSVBbgFH/viUWKqQeg (big blind) showed [Ks Ah] and won ($6.80) with a pair of Fives
Seat 7: HWcfp1hY1hqvrddzW3/FQw showed [Kc As] and won ($6.80) with a pair of Fives
Seat 8: ji04uOybxCdpdefzlUQeKQ folded before Flop (didn't bet)
Seat 9: HZkVla4kK2SI42CVrPZ/ig folded before Flop (didn't bet)



PokerStars Game #59941263074:  Hold'em No Limit ($0.25/$0.50) - 2009/07/01 1:30:21 ET
Table 'tyR5AZNKV8Aadbrnrnlg7g' 6-max Seat #5 is the button
Seat 1: BgOXYI0yYSN1ULC4FqsNkg ($83.30 in chips)
Seat 2: BAjwVL+zKKd0s0fAWstzQQ ($13.95 in chips)
Seat 3: JFLrYNyQmwPhRQAtoSAuyA ($59.75 in chips)
Seat 4: 4QfsCWthT/vSLirorNXqtg ($85.20 in chips)
Seat 5: GUnvMULl2qFOO1yenu1UBw ($78 in chips)
Seat 6: 498aWaGsW4uGfuWl+2FCGw ($64.30 in chips)
498aWaGsW4uGfuWl+2FCGw: posts small blind $0.25
BgOXYI0yYSN1ULC4FqsNkg: posts big blind $0.50
*** HOLE CARDS ***
BAjwVL+zKKd0s0fAWstzQQ: folds
JFLrYNyQmwPhRQAtoSAuyA: calls $0.50
4QfsCWthT/vSLirorNXqtg: raises $2 to $2.50
GUnvMULl2qFOO1yenu1UBw: folds
498aWaGsW4uGfuWl+2FCGw: folds
BgOXYI0yYSN1ULC4FqsNkg: folds
JFLrYNyQmwPhRQAtoSAuyA: folds
4QfsCWthT/vSLirorNXqtg collected $1.75 from pot
4QfsCWthT/vSLirorNXqtg: doesn't show hand
*** SUMMARY ***
Total pot $1.75 | Rake $0
Seat 1: BgOXYI0yYSN1ULC4FqsNkg (big blind) folded before Flop
Seat 2: BAjwVL+zKKd0s0fAWstzQQ folded before Flop (didn't bet)
Seat 3: JFLrYNyQmwPhRQAtoSAuyA folded before Flop
Seat 4: 4QfsCWthT/vSLirorNXqtg collected ($1.75)
Seat 5: GUnvMULl2qFOO1yenu1UBw (button) folded before Flop (didn't bet)
Seat 6: 498aWaGsW4uGfuWl+2FCGw (small blind) folded before Flop



PokerStars Game #59941266098:  Hold'em No Limit ($0.25/$0.50) - 2009/07/01 1:30:26 ET
Table '+dXkOAQyS8j9PQZusUTMpg' 2-max Seat #1 is the button
Seat 1: Teld4PDKla7C8/Wfu2DSkg ($52.40 in chips)
Seat 2: +zI4bP23YIjMkUHqeN2xfw ($24.25 in chips)
Teld4PDKla7C8/Wfu2DSkg: posts small blind $0.25
+zI4bP23YIjMkUHqeN2xfw: posts big blind $0.50
*** HOLE CARDS ***
Teld4PDKla7C8/Wfu2DSkg: calls $0.25
+zI4bP23YIjMkUHqeN2xfw: checks
*** FLOP *** [7d Qs 3d]
+zI4bP23YIjMkUHqeN2xfw: checks
Teld4PDKla7C8/Wfu2DSkg: checks
*** TURN *** [7d Qs 3d] [Qh]
+zI4bP23YIjMkUHqeN2xfw: checks
Teld4PDKla7C8/Wfu2DSkg: checks
*** RIVER *** [7d Qs 3d Qh] [Ah]
+zI4bP23YIjMkUHqeN2xfw: checks
Teld4PDKla7C8/Wfu2DSkg: checks
*** SHOW DOWN ***
+zI4bP23YIjMkUHqeN2xfw: shows [Jc 3h] (two pair, Queens and Threes)
Teld4PDKla7C8/Wfu2DSkg: mucks hand
+zI4bP23YIjMkUHqeN2xfw collected $0.95 from pot
*** SUMMARY ***
Total pot $1 | Rake $0.05
Board [7d Qs 3d Qh Ah]
Seat 1: Teld4PDKla7C8/Wfu2DSkg (button) (small blind) mucked
Seat 2: +zI4bP23YIjMkUHqeN2xfw (big blind) showed [Jc 3h] and won ($0.95) with two pair, Queens and Threes



PokerStars Game #59941267272:  Hold'em No Limit ($0.25/$0.50) - 2009/07/01 1:30:28 ET
Table '2lPOwetm4cfkZPbTmGPH/w' 2-max Seat #2 is the button
Seat 1: vUGdApqS8J/GJE2gaVWl1w ($6.80 in chips)
Seat 2: XFa6sBGjP2gxoIvxR3fZIg ($35.55 in chips)
XFa6sBGjP2gxoIvxR3fZIg: posts small blind $0.25
vUGdApqS8J/GJE2gaVWl1w: posts big blind $0.50
*** HOLE CARDS ***
XFa6sBGjP2gxoIvxR3fZIg: calls $0.25
vUGdApqS8J/GJE2gaVWl1w: raises $1 to $1.50
XFa6sBGjP2gxoIvxR3fZIg: calls $1
*** FLOP *** [Tc Th Ah]
vUGdApqS8J/GJE2gaVWl1w: checks
XFa6sBGjP2gxoIvxR3fZIg: bets $2.50
vUGdApqS8J/GJE2gaVWl1w: raises $2.80 to $5.30 and is all-in
XFa6sBGjP2gxoIvxR3fZIg: calls $2.80
*** TURN *** [Tc Th Ah] [9h]
*** RIVER *** [Tc Th Ah 9h] [9d]
*** SHOW DOWN ***
vUGdApqS8J/GJE2gaVWl1w: shows [Qd Td] (a full house, Tens full of Nines)
XFa6sBGjP2gxoIvxR3fZIg: mucks hand
vUGdApqS8J/GJE2gaVWl1w collected $13.10 from pot
*** SUMMARY ***
Total pot $13.60 | Rake $0.50
Board [Tc Th Ah 9h 9d]
Seat 1: vUGdApqS8J/GJE2gaVWl1w (big blind) showed [Qd Td] and won ($13.10) with a full house, Tens full of Nines
Seat 2: XFa6sBGjP2gxoIvxR3fZIg (button) (small blind) mucked



PokerStars Game #59941271214:  Hold'em No Limit ($0.25/$0.50) - 2009/07/01 1:30:34 ET
Table '3FhG0gl3kMX3wBEEqj+wnQ' 9-max Seat #3 is the button
Seat 1: bxLSulbgr8LmKNjOzw8URg ($49.30 in chips)
Seat 2: vacmVLJJECYI6HjAynFcpg ($49.85 in chips)
Seat 3: YXCE3WOZi8g2sIf3y/plVw ($59.75 in chips)
Seat 4: e2+sK/yjnj94rXOKoxPP2A ($69.75 in chips)
Seat 5: XcLXSUMHSpshK/7Lh0M4Vg ($9.25 in chips)
Seat 6: 997ViqAtWn1FPjJqcffwcA ($109.80 in chips)
Seat 7: mSD1pginDsyHG5PDfqzphw ($12.50 in chips)
Seat 8: j3K/Jujr7PY4ZM2RZvlH6A ($45.35 in chips)
e2+sK/yjnj94rXOKoxPP2A: posts small blind $0.25
XcLXSUMHSpshK/7Lh0M4Vg: posts big blind $0.50
*** HOLE CARDS ***
997ViqAtWn1FPjJqcffwcA: folds
mSD1pginDsyHG5PDfqzphw: folds
j3K/Jujr7PY4ZM2RZvlH6A: raises $3 to $3.50
bxLSulbgr8LmKNjOzw8URg: folds
vacmVLJJECYI6HjAynFcpg: folds
YXCE3WOZi8g2sIf3y/plVw: folds
e2+sK/yjnj94rXOKoxPP2A: folds
XcLXSUMHSpshK/7Lh0M4Vg: folds
j3K/Jujr7PY4ZM2RZvlH6A collected $1.25 from pot
j3K/Jujr7PY4ZM2RZvlH6A: doesn't show hand
*** SUMMARY ***
Total pot $1.25 | Rake $0
Seat 1: bxLSulbgr8LmKNjOzw8URg folded before Flop (didn't bet)
Seat 2: vacmVLJJECYI6HjAynFcpg folded before Flop (didn't bet)
Seat 3: YXCE3WOZi8g2sIf3y/plVw (button) folded before Flop (didn't bet)
Seat 4: e2+sK/yjnj94rXOKoxPP2A (small blind) folded before Flop
Seat 5: XcLXSUMHSpshK/7Lh0M4Vg (big blind) folded before Flop
Seat 6: 997ViqAtWn1FPjJqcffwcA folded before Flop (didn't bet)
Seat 7: mSD1pginDsyHG5PDfqzphw folded before Flop (didn't bet)
Seat 8: j3K/Jujr7PY4ZM2RZvlH6A collected ($1.25)



PokerStars Game #59941271434:  Hold'em No Limit ($0.25/$0.50) - 2009/07/01 1:30:35 ET
Table 'Oih5mInDJ8x49ONa0YdsPw' 2-max Seat #2 is the button
Seat 1: FeErMt4Gvt/3PH2oB/pn4A ($10.65 in chips)
Seat 2: CR6EAGkYzPzxXXZY9pip8Q ($8.75 in chips)
CR6EAGkYzPzxXXZY9pip8Q: posts small blind $0.25
FeErMt4Gvt/3PH2oB/pn4A: posts big blind $0.50
*** HOLE CARDS ***
CR6EAGkYzPzxXXZY9pip8Q: calls $0.25
FeErMt4Gvt/3PH2oB/pn4A: checks
*** FLOP *** [Kc 4d 7s]
FeErMt4Gvt/3PH2oB/pn4A: bets $1
CR6EAGkYzPzxXXZY9pip8Q: calls $1
*** TURN *** [Kc 4d 7s] [8d]
FeErMt4Gvt/3PH2oB/pn4A: checks
CR6EAGkYzPzxXXZY9pip8Q: checks
*** RIVER *** [Kc 4d 7s 8d] [Qs]
FeErMt4Gvt/3PH2oB/pn4A: checks
CR6EAGkYzPzxXXZY9pip8Q: checks
*** SHOW DOWN ***
FeErMt4Gvt/3PH2oB/pn4A: shows [Jd 7h] (a pair of Sevens)
CR6EAGkYzPzxXXZY9pip8Q: shows [9s Ks] (a pair of Kings)
CR6EAGkYzPzxXXZY9pip8Q collected $2.90 from pot
*** SUMMARY ***
Total pot $3 | Rake $0.10
Board [Kc 4d 7s 8d Qs]
Seat 1: FeErMt4Gvt/3PH2oB/pn4A (big blind) showed [Jd 7h] and lost with a pair of Sevens
Seat 2: CR6EAGkYzPzxXXZY9pip8Q (button) (small blind) showed [9s Ks] and won ($2.90) with a pair of Kings



PokerStars Game #59941272178:  Hold'em No Limit ($0.25/$0.50) - 2009/07/01 1:30:36 ET
Table 'NCiXr0d5CEKBQr/cZgLhbA' 9-max Seat #1 is the button
Seat 1: pFtzb1sR4b0d1aw6aIRgDg ($80.45 in chips)
Seat 2: AjV5McH1KMMclY26QdLM5w ($47.80 in chips)
Seat 3: xZCXQSXlrZkp3pZizzVXCw ($98.65 in chips)
Seat 4: 5k9fvXD9suIgCxU4HLQjTw ($53.95 in chips)
Seat 5: Ja2jdidjip2UeJnRzmzAAQ ($50 in chips)
Seat 6: t1qL+wRXOwTLB4TBbcw2QA ($47.75 in chips)
Seat 7: dXhO5i7KOoVcsGqbklD+jw ($27.50 in chips)
Seat 9: 4WLZvqBn5qv5tds5kt5A1Q ($56 in chips)
AjV5McH1KMMclY26QdLM5w: posts small blind $0.25
xZCXQSXlrZkp3pZizzVXCw: posts big blind $0.50
*** HOLE CARDS ***
5k9fvXD9suIgCxU4HLQjTw: folds
Ja2jdidjip2UeJnRzmzAAQ: folds
t1qL+wRXOwTLB4TBbcw2QA: folds
dXhO5i7KOoVcsGqbklD+jw: folds
4WLZvqBn5qv5tds5kt5A1Q: folds
pFtzb1sR4b0d1aw6aIRgDg: folds
AjV5McH1KMMclY26QdLM5w: folds
xZCXQSXlrZkp3pZizzVXCw collected $0.50 from pot
*** SUMMARY ***
Total pot $0.50 | Rake $0
Seat 1: pFtzb1sR4b0d1aw6aIRgDg (button) folded before Flop (didn't bet)
Seat 2: AjV5McH1KMMclY26QdLM5w (small blind) folded before Flop
Seat 3: xZCXQSXlrZkp3pZizzVXCw (big blind) collected ($0.50)
Seat 4: 5k9fvXD9suIgCxU4HLQjTw folded before Flop (didn't bet)
Seat 5: Ja2jdidjip2UeJnRzmzAAQ folded before Flop (didn't bet)
Seat 6: t1qL+wRXOwTLB4TBbcw2QA folded before Flop (didn't bet)
Seat 7: dXhO5i7KOoVcsGqbklD+jw folded before Flop (didn't bet)
Seat 9: 4WLZvqBn5qv5tds5kt5A1Q folded before Flop (didn't bet)



PokerStars Game #59941274038:  Hold'em No Limit ($0.25/$0.50) - 2009/07/01 1:30:39 ET
Table 'B+sqsfj6d6zXicNfaseTaw' 2-max Seat #1 is the button
Seat 1: +4GNcSsecmapVGSdV0mUPA ($129 in chips)
Seat 2: Lv5RmpRe6LtPkBzM9Gpo5A ($95.55 in chips)
+4GNcSsecmapVGSdV0mUPA: posts small blind $0.25
Lv5RmpRe6LtPkBzM9Gpo5A: posts big blind $0.50
*** HOLE CARDS ***
+4GNcSsecmapVGSdV0mUPA: folds
Lv5RmpRe6LtPkBzM9Gpo5A collected $0.50 from pot
*** SUMMARY ***
Total pot $0.50 | Rake $0
Seat 1: +4GNcSsecmapVGSdV0mUPA (button) (small blind) folded before Flop
Seat 2: Lv5RmpRe6LtPkBzM9Gpo5A (big blind) collected ($0.50)



PokerStars Game #59941273932:  Hold'em No Limit ($0.25/$0.50) - 2009/07/01 1:30:39 ET
Table 'EiNh8p/wGJ1FP575iMFnqg' 9-max Seat #6 is the button
Seat 1: YFFlOZgyy1Mh4iBmuNRbmQ ($29.75 in chips)
Seat 2: 8ehL7qlZzjgUh2H35iiWLw ($64.50 in chips)
Seat 3: ymLPoEIl7UL3TvZYmnadxQ ($42.35 in chips)
Seat 4: cMzaiXAM/ZAdNaEUu+LqhA ($58.45 in chips)
Seat 5: M+7+BTmX5vZatHVuoRB1nA ($73.20 in chips)
Seat 6: viwBDtJsY6JfsFOdBAyJIQ ($8.45 in chips)
Seat 7: 997ViqAtWn1FPjJqcffwcA ($50 in chips)
Seat 8: mSD1pginDsyHG5PDfqzphw ($10 in chips)
Seat 9: GuPkZObrz5Zkkn8FsEdF9w ($35.60 in chips)
997ViqAtWn1FPjJqcffwcA: posts small blind $0.25
mSD1pginDsyHG5PDfqzphw: posts big blind $0.50
*** HOLE CARDS ***
GuPkZObrz5Zkkn8FsEdF9w: folds
YFFlOZgyy1Mh4iBmuNRbmQ: calls $0.50
8ehL7qlZzjgUh2H35iiWLw: raises $1.50 to $2
ymLPoEIl7UL3TvZYmnadxQ: folds
cMzaiXAM/ZAdNaEUu+LqhA: folds
M+7+BTmX5vZatHVuoRB1nA: folds
viwBDtJsY6JfsFOdBAyJIQ: folds
997ViqAtWn1FPjJqcffwcA: folds
mSD1pginDsyHG5PDfqzphw: folds
YFFlOZgyy1Mh4iBmuNRbmQ: calls $1.50
*** FLOP *** [Kh 8h Td]
YFFlOZgyy1Mh4iBmuNRbmQ: checks
8ehL7qlZzjgUh2H35iiWLw: bets $3
YFFlOZgyy1Mh4iBmuNRbmQ: calls $3
*** TURN *** [Kh 8h Td] [6d]
YFFlOZgyy1Mh4iBmuNRbmQ: checks
8ehL7qlZzjgUh2H35iiWLw: bets $7
YFFlOZgyy1Mh4iBmuNRbmQ: folds
8ehL7qlZzjgUh2H35iiWLw collected $10.25 from pot
8ehL7qlZzjgUh2H35iiWLw: doesn't show hand
*** SUMMARY ***
Total pot $10.75 | Rake $0.50
Board [Kh 8h Td 6d]
Seat 1: YFFlOZgyy1Mh4iBmuNRbmQ folded on the Turn
Seat 2: 8ehL7qlZzjgUh2H35iiWLw collected ($10.25)
Seat 3: ymLPoEIl7UL3TvZYmnadxQ folded before Flop (didn't bet)
Seat 4: cMzaiXAM/ZAdNaEUu+LqhA folded before Flop (didn't bet)
Seat 5: M+7+BTmX5vZatHVuoRB1nA folded before Flop (didn't bet)
Seat 6: viwBDtJsY6JfsFOdBAyJIQ (button) folded before Flop (didn't bet)
Seat 7: 997ViqAtWn1FPjJqcffwcA (small blind) folded before Flop
Seat 8: mSD1pginDsyHG5PDfqzphw (big blind) folded before Flop
Seat 9: GuPkZObrz5Zkkn8FsEdF9w folded before Flop (didn't bet)



PokerStars Game #59941273818:  Hold'em No Limit ($0.25/$0.50) - 2009/07/01 1:30:39 ET
Table '+z1aekfHkpp09pc8F9aViw' 6-max Seat #3 is the button
Seat 1: /DArfRoYc3YpLsOQSZubFg ($52.75 in chips)
Seat 2: 4QfsCWthT/vSLirorNXqtg ($50.75 in chips)
Seat 3: URYNc7fPA23K2UfadQbnCA ($48.50 in chips)
Seat 5: 2igtJLmvIZ+HqX4XPgMPZA ($51.20 in chips)
Seat 6: GUnvMULl2qFOO1yenu1UBw ($52.25 in chips)
2igtJLmvIZ+HqX4XPgMPZA: posts small blind $0.25
GUnvMULl2qFOO1yenu1UBw: posts big blind $0.50
*** HOLE CARDS ***
/DArfRoYc3YpLsOQSZubFg: folds
/DArfRoYc3YpLsOQSZubFg leaves the table
4QfsCWthT/vSLirorNXqtg: folds
URYNc7fPA23K2UfadQbnCA: folds
2igtJLmvIZ+HqX4XPgMPZA: folds
GUnvMULl2qFOO1yenu1UBw collected $0.50 from pot
*** SUMMARY ***
Total pot $0.50 | Rake $0
Seat 1: /DArfRoYc3YpLsOQSZubFg folded before Flop (didn't bet)
Seat 2: 4QfsCWthT/vSLirorNXqtg folded before Flop (didn't bet)
Seat 3: URYNc7fPA23K2UfadQbnCA (button) folded before Flop (didn't bet)
Seat 5: 2igtJLmvIZ+HqX4XPgMPZA (small blind) folded before Flop
Seat 6: GUnvMULl2qFOO1yenu1UBw (big blind) collected ($0.50)



PokerStars Game #59941274578:  Hold'em No Limit ($0.25/$0.50) - 2009/07/01 1:30:40 ET
Table 'ibNfFy0bCzuBaUORla0aGw' 9-max Seat #5 is the button
Seat 1: xZCXQSXlrZkp3pZizzVXCw ($50 in chips)
Seat 2: 90Wb75h3W1BRpbqVnuk8gw ($50 in chips)
Seat 3: AjV5McH1KMMclY26QdLM5w ($25 in chips)
Seat 4: nhDtFZ2uuvm5hDKG7ZVEpA ($49.25 in chips)
Seat 5: GIJAc9kPrLZHLSX8Q6i99w ($36.25 in chips)
Seat 6: H8cPaCtX7d6meGUVSM5sxw ($58.10 in chips)
Seat 7: HZkVla4kK2SI42CVrPZ/ig ($15.85 in chips)
Seat 8: Ja2jdidjip2UeJnRzmzAAQ ($47 in chips)
Seat 9: pFtzb1sR4b0d1aw6aIRgDg ($56.15 in chips)
H8cPaCtX7d6meGUVSM5sxw: posts small blind $0.25
HZkVla4kK2SI42CVrPZ/ig: posts big blind $0.50
*** HOLE CARDS ***
Ja2jdidjip2UeJnRzmzAAQ: folds
pFtzb1sR4b0d1aw6aIRgDg: folds
xZCXQSXlrZkp3pZizzVXCw: folds
90Wb75h3W1BRpbqVnuk8gw: folds
AjV5McH1KMMclY26QdLM5w: folds
nhDtFZ2uuvm5hDKG7ZVEpA: folds
GIJAc9kPrLZHLSX8Q6i99w: folds
H8cPaCtX7d6meGUVSM5sxw: calls $0.25
HZkVla4kK2SI42CVrPZ/ig: raises $1 to $1.50
H8cPaCtX7d6meGUVSM5sxw: calls $1
*** FLOP *** [7h Ad 4s]
H8cPaCtX7d6meGUVSM5sxw: checks
HZkVla4kK2SI42CVrPZ/ig: bets $1.50
H8cPaCtX7d6meGUVSM5sxw: folds
HZkVla4kK2SI42CVrPZ/ig collected $2.85 from pot
*** SUMMARY ***
Total pot $3 | Rake $0.15
Board [7h Ad 4s]
Seat 1: xZCXQSXlrZkp3pZizzVXCw folded before Flop (didn't bet)
Seat 2: 90Wb75h3W1BRpbqVnuk8gw folded before Flop (didn't bet)
Seat 3: AjV5McH1KMMclY26QdLM5w folded before Flop (didn't bet)
Seat 4: nhDtFZ2uuvm5hDKG7ZVEpA folded before Flop (didn't bet)
Seat 5: GIJAc9kPrLZHLSX8Q6i99w (button) folded before Flop (didn't bet)
Seat 6: H8cPaCtX7d6meGUVSM5sxw (small blind) folded on the Flop
Seat 7: HZkVla4kK2SI42CVrPZ/ig (big blind) collected ($2.85)
Seat 8: Ja2jdidjip2UeJnRzmzAAQ folded before Flop (didn't bet)
Seat 9: pFtzb1sR4b0d1aw6aIRgDg folded before Flop (didn't bet)



PokerStars Game #59941274958:  Hold'em No Limit ($0.25/$0.50) - 2009/07/01 1:30:41 ET
Table 'cofQFHU7jbJoFecLVBof/w' 6-max Seat #4 is the button
Seat 1: URYNc7fPA23K2UfadQbnCA ($48.50 in chips)
Seat 2: f89uTQr3ieGlusj2IAYAEg ($50 in chips)
Seat 3: v4ctePcLlQw0r8E0qJtjYw ($47.20 in chips)
Seat 4: g6lz8npaeeTJmJegtPYhlQ ($17.10 in chips)
Seat 5: QvwRlrpVqerRRF8eJm6dDw ($45.50 in chips)
Seat 6: 7+uQ0OOgCTbR4ltkSwyC0g ($163.05 in chips)
QvwRlrpVqerRRF8eJm6dDw: posts small blind $0.25
7+uQ0OOgCTbR4ltkSwyC0g: posts big blind $0.50
*** HOLE CARDS ***
URYNc7fPA23K2UfadQbnCA: calls $0.50
f89uTQr3ieGlusj2IAYAEg: folds
v4ctePcLlQw0r8E0qJtjYw: folds
g6lz8npaeeTJmJegtPYhlQ: folds
QvwRlrpVqerRRF8eJm6dDw: calls $0.25
7+uQ0OOgCTbR4ltkSwyC0g: raises $2 to $2.50
URYNc7fPA23K2UfadQbnCA: calls $2
QvwRlrpVqerRRF8eJm6dDw: calls $2
*** FLOP *** [5d Qd 2d]
QvwRlrpVqerRRF8eJm6dDw: bets $3
7+uQ0OOgCTbR4ltkSwyC0g: folds
URYNc7fPA23K2UfadQbnCA: folds
QvwRlrpVqerRRF8eJm6dDw collected $7.15 from pot
*** SUMMARY ***
Total pot $7.50 | Rake $0.35
Board [5d Qd 2d]
Seat 1: URYNc7fPA23K2UfadQbnCA folded on the Flop
Seat 2: f89uTQr3ieGlusj2IAYAEg folded before Flop (didn't bet)
Seat 3: v4ctePcLlQw0r8E0qJtjYw folded before Flop (didn't bet)
Seat 4: g6lz8npaeeTJmJegtPYhlQ (button) folded before Flop (didn't bet)
Seat 5: QvwRlrpVqerRRF8eJm6dDw (small blind) collected ($7.15)
Seat 6: 7+uQ0OOgCTbR4ltkSwyC0g (big blind) folded on the Flop



PokerStars Game #59941275960:  Hold'em No Limit ($0.25/$0.50) - 2009/07/01 1:30:43 ET
Table 'tyR5AZNKV8Aadbrnrnlg7g' 6-max Seat #6 is the button
Seat 1: BgOXYI0yYSN1ULC4FqsNkg ($82.80 in chips)
Seat 2: BAjwVL+zKKd0s0fAWstzQQ ($13.95 in chips)
Seat 3: JFLrYNyQmwPhRQAtoSAuyA ($59.25 in chips)
Seat 4: 4QfsCWthT/vSLirorNXqtg ($86.45 in chips)
Seat 5: GUnvMULl2qFOO1yenu1UBw ($78 in chips)
Seat 6: 498aWaGsW4uGfuWl+2FCGw ($64.05 in chips)
BgOXYI0yYSN1ULC4FqsNkg: posts small blind $0.25
BAjwVL+zKKd0s0fAWstzQQ: posts big blind $0.50
*** HOLE CARDS ***
JFLrYNyQmwPhRQAtoSAuyA: raises $1 to $1.50
4QfsCWthT/vSLirorNXqtg: folds
GUnvMULl2qFOO1yenu1UBw: calls $1.50
498aWaGsW4uGfuWl+2FCGw: folds
BgOXYI0yYSN1ULC4FqsNkg: calls $1.25
BAjwVL+zKKd0s0fAWstzQQ: folds
*** FLOP *** [Jc 8c Kd]
BgOXYI0yYSN1ULC4FqsNkg: checks
JFLrYNyQmwPhRQAtoSAuyA: checks
GUnvMULl2qFOO1yenu1UBw: bets $3
BgOXYI0yYSN1ULC4FqsNkg: calls $3
JFLrYNyQmwPhRQAtoSAuyA: folds
*** TURN *** [Jc 8c Kd] [6h]
BgOXYI0yYSN1ULC4FqsNkg: checks
GUnvMULl2qFOO1yenu1UBw: checks
*** RIVER *** [Jc 8c Kd 6h] [Ah]
BgOXYI0yYSN1ULC4FqsNkg: checks
GUnvMULl2qFOO1yenu1UBw: bets $7.50
BgOXYI0yYSN1ULC4FqsNkg: folds
GUnvMULl2qFOO1yenu1UBw collected $10.50 from pot
GUnvMULl2qFOO1yenu1UBw: doesn't show hand
*** SUMMARY ***
Total pot $11 | Rake $0.50
Board [Jc 8c Kd 6h Ah]
Seat 1: BgOXYI0yYSN1ULC4FqsNkg (small blind) folded on the River
Seat 2: BAjwVL+zKKd0s0fAWstzQQ (big blind) folded before Flop
Seat 3: JFLrYNyQmwPhRQAtoSAuyA folded on the Flop
Seat 4: 4QfsCWthT/vSLirorNXqtg folded before Flop (didn't bet)
Seat 5: GUnvMULl2qFOO1yenu1UBw collected ($10.50)
Seat 6: 498aWaGsW4uGfuWl+2FCGw (button) folded before Flop (didn't bet)



PokerStars Game #59941276234:  Hold'em No Limit ($0.25/$0.50) - 2009/07/01 1:30:43 ET
Table 'Nz0Vr7WMHL2g5Uk7dDZjpw' 9-max Seat #1 is the button
Seat 1: 9yMsdgReyOUerNsmTYCCDQ ($9 in chips)
Seat 2: SegjDnMxWMujiD57ESNL+g ($20.10 in chips)
Seat 3: c638Xxo+q5F/t5qMtmvmvQ ($50 in chips)
Seat 5: WGW0DgjBUXs1ylURHG8vnQ ($12.40 in chips)
Seat 6: 997ViqAtWn1FPjJqcffwcA ($50 in chips)
Seat 7: KPLH0gELgFe2OuAnhJFI5w ($24.70 in chips)
Seat 8: aoL+R/61Kxmw69ypuPrWAQ ($31.80 in chips)
Seat 9: mSD1pginDsyHG5PDfqzphw ($19.25 in chips)
SegjDnMxWMujiD57ESNL+g: posts small blind $0.25
c638Xxo+q5F/t5qMtmvmvQ: posts big blind $0.50
*** HOLE CARDS ***
WGW0DgjBUXs1ylURHG8vnQ: folds
997ViqAtWn1FPjJqcffwcA: folds
KPLH0gELgFe2OuAnhJFI5w: calls $0.50
aoL+R/61Kxmw69ypuPrWAQ: calls $0.50
mSD1pginDsyHG5PDfqzphw: folds
9yMsdgReyOUerNsmTYCCDQ: folds
SegjDnMxWMujiD57ESNL+g: calls $0.25
c638Xxo+q5F/t5qMtmvmvQ: checks
*** FLOP *** [6d Th 5s]
SegjDnMxWMujiD57ESNL+g: checks
c638Xxo+q5F/t5qMtmvmvQ: checks
E2518gp4aFz1+kAgmGqeEg leaves the table
KPLH0gELgFe2OuAnhJFI5w: checks
aoL+R/61Kxmw69ypuPrWAQ: checks
*** TURN *** [6d Th 5s] [2d]
SegjDnMxWMujiD57ESNL+g: checks
c638Xxo+q5F/t5qMtmvmvQ: bets $1.50
KPLH0gELgFe2OuAnhJFI5w: folds
uw9QayAAxLM3Hb+HR7mSkg joins the table at seat #4
aoL+R/61Kxmw69ypuPrWAQ: folds
SegjDnMxWMujiD57ESNL+g: folds
c638Xxo+q5F/t5qMtmvmvQ collected $1.90 from pot
c638Xxo+q5F/t5qMtmvmvQ: doesn't show hand
*** SUMMARY ***
Total pot $2 | Rake $0.10
Board [6d Th 5s 2d]
Seat 1: 9yMsdgReyOUerNsmTYCCDQ (button) folded before Flop (didn't bet)
Seat 2: SegjDnMxWMujiD57ESNL+g (small blind) folded on the Turn
Seat 3: c638Xxo+q5F/t5qMtmvmvQ (big blind) collected ($1.90)
Seat 5: WGW0DgjBUXs1ylURHG8vnQ folded before Flop (didn't bet)
Seat 6: 997ViqAtWn1FPjJqcffwcA folded before Flop (didn't bet)
Seat 7: KPLH0gELgFe2OuAnhJFI5w folded on the Turn
Seat 8: aoL+R/61Kxmw69ypuPrWAQ folded on the Turn
Seat 9: mSD1pginDsyHG5PDfqzphw folded before Flop (didn't bet)



PokerStars Game #59941277102:  Hold'em No Limit ($0.25/$0.50) - 2009/07/01 1:30:45 ET
Table 'B+sqsfj6d6zXicNfaseTaw' 2-max Seat #2 is the button
Seat 1: +4GNcSsecmapVGSdV0mUPA ($128.75 in chips)
Seat 2: Lv5RmpRe6LtPkBzM9Gpo5A ($95.80 in chips)
Lv5RmpRe6LtPkBzM9Gpo5A: posts small blind $0.25
+4GNcSsecmapVGSdV0mUPA: posts big blind $0.50
*** HOLE CARDS ***
Lv5RmpRe6LtPkBzM9Gpo5A: raises $0.50 to $1
+4GNcSsecmapVGSdV0mUPA: calls $0.50
*** FLOP *** [7c Js Ad]
+4GNcSsecmapVGSdV0mUPA: checks
Lv5RmpRe6LtPkBzM9Gpo5A: checks
*** TURN *** [7c Js Ad] [2d]
+4GNcSsecmapVGSdV0mUPA: checks
Lv5RmpRe6LtPkBzM9Gpo5A: checks
*** RIVER *** [7c Js Ad 2d] [9c]
+4GNcSsecmapVGSdV0mUPA: checks
Lv5RmpRe6LtPkBzM9Gpo5A: checks
*** SHOW DOWN ***
+4GNcSsecmapVGSdV0mUPA: shows [9h 6c] (a pair of Nines)
Lv5RmpRe6LtPkBzM9Gpo5A: mucks hand
+4GNcSsecmapVGSdV0mUPA collected $1.90 from pot
*** SUMMARY ***
Total pot $2 | Rake $0.10
Board [7c Js Ad 2d 9c]
Seat 1: +4GNcSsecmapVGSdV0mUPA (big blind) showed [9h 6c] and won ($1.90) with a pair of Nines
Seat 2: Lv5RmpRe6LtPkBzM9Gpo5A (button) (small blind) mucked



PokerStars Game #59941278926:  Hold'em No Limit ($0.25/$0.50) - 2009/07/01 1:30:48 ET
Table '+dXkOAQyS8j9PQZusUTMpg' 2-max Seat #2 is the button
Seat 1: Teld4PDKla7C8/Wfu2DSkg ($51.90 in chips)
Seat 2: +zI4bP23YIjMkUHqeN2xfw ($24.70 in chips)
+zI4bP23YIjMkUHqeN2xfw: posts small blind $0.25
Teld4PDKla7C8/Wfu2DSkg: posts big blind $0.50
*** HOLE CARDS ***
+zI4bP23YIjMkUHqeN2xfw: calls $0.25
Teld4PDKla7C8/Wfu2DSkg: checks
*** FLOP *** [Qs Jd Td]
Teld4PDKla7C8/Wfu2DSkg: checks
+zI4bP23YIjMkUHqeN2xfw: bets $1
Teld4PDKla7C8/Wfu2DSkg: raises $1 to $2
+zI4bP23YIjMkUHqeN2xfw: calls $1
*** TURN *** [Qs Jd Td] [Tc]
Teld4PDKla7C8/Wfu2DSkg: checks
+zI4bP23YIjMkUHqeN2xfw: checks
*** RIVER *** [Qs Jd Td Tc] [9d]
Teld4PDKla7C8/Wfu2DSkg: bets $4.50
+zI4bP23YIjMkUHqeN2xfw: folds
Teld4PDKla7C8/Wfu2DSkg collected $4.80 from pot
*** SUMMARY ***
Total pot $5 | Rake $0.20
Board [Qs Jd Td Tc 9d]
Seat 1: Teld4PDKla7C8/Wfu2DSkg (big blind) collected ($4.80)
Seat 2: +zI4bP23YIjMkUHqeN2xfw (button) (small blind) folded on the River



PokerStars Game #59941279456:  Hold'em No Limit ($0.25/$0.50) - 2009/07/01 1:30:49 ET
Table '9ojijpRcYQSQTh6xI+haUA' 2-max Seat #2 is the button
Seat 1: FqpibuVWLNsAN/Z7ROZLnA ($38.25 in chips)
Seat 2: TitTV+fFCcBZWOERdytydA ($47.45 in chips)
TitTV+fFCcBZWOERdytydA: posts small blind $0.25
FqpibuVWLNsAN/Z7ROZLnA: posts big blind $0.50
*** HOLE CARDS ***
TitTV+fFCcBZWOERdytydA: raises $1 to $1.50
FqpibuVWLNsAN/Z7ROZLnA: raises $1 to $2.50
TitTV+fFCcBZWOERdytydA: calls $1
*** FLOP *** [7s 9c 9h]
FqpibuVWLNsAN/Z7ROZLnA: bets $34
TitTV+fFCcBZWOERdytydA: folds
FqpibuVWLNsAN/Z7ROZLnA collected $4.75 from pot
*** SUMMARY ***
Total pot $5 | Rake $0.25
Board [7s 9c 9h]
Seat 1: FqpibuVWLNsAN/Z7ROZLnA (big blind) collected ($4.75)
Seat 2: TitTV+fFCcBZWOERdytydA (button) (small blind) folded on the Flop



PokerStars Game #59941279824:  Hold'em No Limit ($0.25/$0.50) - 2009/07/01 1:30:50 ET
Table 'Oih5mInDJ8x49ONa0YdsPw' 2-max Seat #1 is the button
Seat 1: FeErMt4Gvt/3PH2oB/pn4A ($9.15 in chips)
Seat 2: CR6EAGkYzPzxXXZY9pip8Q ($10.15 in chips)
FeErMt4Gvt/3PH2oB/pn4A: posts small blind $0.25
CR6EAGkYzPzxXXZY9pip8Q: posts big blind $0.50
*** HOLE CARDS ***
FeErMt4Gvt/3PH2oB/pn4A: raises $1 to $1.50
CR6EAGkYzPzxXXZY9pip8Q: folds
FeErMt4Gvt/3PH2oB/pn4A collected $1 from pot
FeErMt4Gvt/3PH2oB/pn4A: doesn't show hand
*** SUMMARY ***
Total pot $1 | Rake $0
Seat 1: FeErMt4Gvt/3PH2oB/pn4A (button) (small blind) collected ($1)
Seat 2: CR6EAGkYzPzxXXZY9pip8Q (big blind) folded before Flop



PokerStars Game #59941281366:  Hold'em No Limit ($0.25/$0.50) - 2009/07/01 1:30:53 ET
Table 'hWT2kq66tnKEpD26cia6fQ' 2-max Seat #1 is the button
Seat 1: Ce3KNFP+ao7Da9NHb65raw ($52.10 in chips)
Seat 2: 16tvT7AYgZ2LgiGFcvFKQg ($23.90 in chips)
Ce3KNFP+ao7Da9NHb65raw: posts small blind $0.25
16tvT7AYgZ2LgiGFcvFKQg: posts big blind $0.50
*** HOLE CARDS ***
Ce3KNFP+ao7Da9NHb65raw: calls $0.25
16tvT7AYgZ2LgiGFcvFKQg: checks
*** FLOP *** [Ad 4s Js]
16tvT7AYgZ2LgiGFcvFKQg: bets $1
Ce3KNFP+ao7Da9NHb65raw: folds
16tvT7AYgZ2LgiGFcvFKQg collected $0.95 from pot
16tvT7AYgZ2LgiGFcvFKQg: doesn't show hand
*** SUMMARY ***
Total pot $1 | Rake $0.05
Board [Ad 4s Js]
Seat 1: Ce3KNFP+ao7Da9NHb65raw (button) (small blind) folded on the Flop
Seat 2: 16tvT7AYgZ2LgiGFcvFKQg (big blind) collected ($0.95)



PokerStars Game #59941283474:  Hold'em No Limit ($0.25/$0.50) - 2009/07/01 1:30:56 ET
Table '2lPOwetm4cfkZPbTmGPH/w' 2-max Seat #1 is the button
Seat 1: vUGdApqS8J/GJE2gaVWl1w ($13.10 in chips)
Seat 2: XFa6sBGjP2gxoIvxR3fZIg ($28.75 in chips)
vUGdApqS8J/GJE2gaVWl1w: posts small blind $0.25
XFa6sBGjP2gxoIvxR3fZIg: posts big blind $0.50
*** HOLE CARDS ***
vUGdApqS8J/GJE2gaVWl1w: raises $0.50 to $1
XFa6sBGjP2gxoIvxR3fZIg: calls $0.50
*** FLOP *** [6h Ah Th]
XFa6sBGjP2gxoIvxR3fZIg: checks
vUGdApqS8J/GJE2gaVWl1w: bets $2.50
XFa6sBGjP2gxoIvxR3fZIg: raises $11 to $13.50
vUGdApqS8J/GJE2gaVWl1w: calls $9.60 and is all-in
*** TURN *** [6h Ah Th] [Td]
*** RIVER *** [6h Ah Th Td] [Kc]
*** SHOW DOWN ***
XFa6sBGjP2gxoIvxR3fZIg: shows [Tc 5h] (three of a kind, Tens)
vUGdApqS8J/GJE2gaVWl1w: shows [8h Jh] (a flush, Ace high)
vUGdApqS8J/GJE2gaVWl1w collected $25.70 from pot
*** SUMMARY ***
Total pot $26.20 | Rake $0.50
Board [6h Ah Th Td Kc]
Seat 1: vUGdApqS8J/GJE2gaVWl1w (button) (small blind) showed [8h Jh] and won ($25.70) with a flush, Ace high
Seat 2: XFa6sBGjP2gxoIvxR3fZIg (big blind) showed [Tc 5h] and lost with three of a kind, Tens



PokerStars Game #59941283368:  Hold'em No Limit ($0.25/$0.50) - 2009/07/01 1:30:56 ET
Table 'BCN5su+SsXiy1zRMJi0SJw' 6-max Seat #5 is the button
Seat 1: GxXV09ciXaOxyY2H5aMIIw ($32.80 in chips)
Seat 2: ehFNAevCQri3trWxV6FJdA ($59.90 in chips)
Seat 3: kwgv5lNhiFrfONXCshzxlA ($43.10 in chips)
Seat 4: bbsK8j+tpuVRhBqDzHxf7w ($49 in chips)
Seat 5: kxPhs4ePFqMy52CInAJ2aw ($51.30 in chips)
Seat 6: b2symlOdL7+0c9Pj4N/KlA ($68.70 in chips)
b2symlOdL7+0c9Pj4N/KlA: posts small blind $0.25
GxXV09ciXaOxyY2H5aMIIw: posts big blind $0.50
*** HOLE CARDS ***
ehFNAevCQri3trWxV6FJdA: calls $0.50
kwgv5lNhiFrfONXCshzxlA: calls $0.50
bbsK8j+tpuVRhBqDzHxf7w: folds
kxPhs4ePFqMy52CInAJ2aw: raises $2.50 to $3
b2symlOdL7+0c9Pj4N/KlA: folds
GxXV09ciXaOxyY2H5aMIIw: folds
ehFNAevCQri3trWxV6FJdA: folds
kwgv5lNhiFrfONXCshzxlA: folds
kxPhs4ePFqMy52CInAJ2aw collected $2.25 from pot
kxPhs4ePFqMy52CInAJ2aw: doesn't show hand
*** SUMMARY ***
Total pot $2.25 | Rake $0
Seat 1: GxXV09ciXaOxyY2H5aMIIw (big blind) folded before Flop
Seat 2: ehFNAevCQri3trWxV6FJdA folded before Flop
Seat 3: kwgv5lNhiFrfONXCshzxlA folded before Flop
Seat 4: bbsK8j+tpuVRhBqDzHxf7w folded before Flop (didn't bet)
Seat 5: kxPhs4ePFqMy52CInAJ2aw (button) collected ($2.25)
Seat 6: b2symlOdL7+0c9Pj4N/KlA (small blind) folded before Flop



PokerStars Game #59941283666:  Hold'em No Limit ($0.25/$0.50) - 2009/07/01 1:30:57 ET
Table 'fx6MqwfYAj/Rt86hBz2L3Q' 9-max Seat #7 is the button
Seat 1: v/4aX0ejnaIFK4ftDk2Lyg ($51.40 in chips)
Seat 2: C3rGXblctNcWI6JYPHhaEg ($29.20 in chips)
Seat 3: iadBi5AEt7gTBXbDSSnMYQ ($36.55 in chips)
Seat 4: VhjwWfxHSx00WxzYih3KOA ($50 in chips)
Seat 5: iAISe3dVeua8PUn2wwgDHw ($77.30 in chips)
Seat 6: 5k9fvXD9suIgCxU4HLQjTw ($50 in chips)
Seat 7: mSD1pginDsyHG5PDfqzphw ($10 in chips)
Seat 8: JYwJYYV9pM5KWdSiETl8rA ($62.50 in chips)
Seat 9: vO3QVRovWemcGMkm7ijAIA ($25.70 in chips)
JYwJYYV9pM5KWdSiETl8rA: posts small blind $0.25
vO3QVRovWemcGMkm7ijAIA: posts big blind $0.50
*** HOLE CARDS ***
v/4aX0ejnaIFK4ftDk2Lyg: folds
C3rGXblctNcWI6JYPHhaEg: calls $0.50
iadBi5AEt7gTBXbDSSnMYQ: raises $1 to $1.50
VhjwWfxHSx00WxzYih3KOA: folds
iAISe3dVeua8PUn2wwgDHw: folds
5k9fvXD9suIgCxU4HLQjTw: folds
mSD1pginDsyHG5PDfqzphw: folds
JYwJYYV9pM5KWdSiETl8rA: folds
vO3QVRovWemcGMkm7ijAIA: folds
C3rGXblctNcWI6JYPHhaEg: folds
iadBi5AEt7gTBXbDSSnMYQ collected $1.75 from pot
*** SUMMARY ***
Total pot $1.75 | Rake $0
Seat 1: v/4aX0ejnaIFK4ftDk2Lyg folded before Flop (didn't bet)
Seat 2: C3rGXblctNcWI6JYPHhaEg folded before Flop
Seat 3: iadBi5AEt7gTBXbDSSnMYQ collected ($1.75)
Seat 4: VhjwWfxHSx00WxzYih3KOA folded before Flop (didn't bet)
Seat 5: iAISe3dVeua8PUn2wwgDHw folded before Flop (didn't bet)
Seat 6: 5k9fvXD9suIgCxU4HLQjTw folded before Flop (didn't bet)
Seat 7: mSD1pginDsyHG5PDfqzphw (button) folded before Flop (didn't bet)
Seat 8: JYwJYYV9pM5KWdSiETl8rA (small blind) folded before Flop
Seat 9: vO3QVRovWemcGMkm7ijAIA (big blind) folded before Flop



PokerStars Game #59941285666:  Hold'em No Limit ($0.25/$0.50) - 2009/07/01 1:31:00 ET
Table '8BQGgNetI1NOvWeu3gtMNw' 2-max Seat #2 is the button
Seat 1: bypIyrYcAAifLfhZpGlKLA ($67.90 in chips)
Seat 2: Z4HwehErEwzsv/noQlfUlg ($149.20 in chips)
Z4HwehErEwzsv/noQlfUlg: posts small blind $0.25
bypIyrYcAAifLfhZpGlKLA: posts big blind $0.50
*** HOLE CARDS ***
Z4HwehErEwzsv/noQlfUlg: folds
bypIyrYcAAifLfhZpGlKLA collected $0.50 from pot
bypIyrYcAAifLfhZpGlKLA: doesn't show hand
*** SUMMARY ***
Total pot $0.50 | Rake $0
Seat 1: bypIyrYcAAifLfhZpGlKLA (big blind) collected ($0.50)
Seat 2: Z4HwehErEwzsv/noQlfUlg (button) (small blind) folded before Flop



PokerStars Game #59941288300:  Hold'em No Limit ($0.25/$0.50) - 2009/07/01 1:31:05 ET
Table 'hWT2kq66tnKEpD26cia6fQ' 2-max Seat #2 is the button
Seat 1: Ce3KNFP+ao7Da9NHb65raw ($51.60 in chips)
Seat 2: 16tvT7AYgZ2LgiGFcvFKQg ($24.35 in chips)
16tvT7AYgZ2LgiGFcvFKQg: posts small blind $0.25
Ce3KNFP+ao7Da9NHb65raw: posts big blind $0.50
*** HOLE CARDS ***
16tvT7AYgZ2LgiGFcvFKQg: calls $0.25
Ce3KNFP+ao7Da9NHb65raw: raises $1 to $1.50
16tvT7AYgZ2LgiGFcvFKQg: folds
Ce3KNFP+ao7Da9NHb65raw collected $1 from pot
*** SUMMARY ***
Total pot $1 | Rake $0
Seat 1: Ce3KNFP+ao7Da9NHb65raw (big blind) collected ($1)
Seat 2: 16tvT7AYgZ2LgiGFcvFKQg (button) (small blind) folded before Flop



PokerStars Game #59941288280:  Hold'em No Limit ($0.25/$0.50) - 2009/07/01 1:31:05 ET
Table 'NCiXr0d5CEKBQr/cZgLhbA' 9-max Seat #2 is the button
Seat 1: pFtzb1sR4b0d1aw6aIRgDg ($80.45 in chips)
Seat 2: AjV5McH1KMMclY26QdLM5w ($47.55 in chips)
Seat 3: xZCXQSXlrZkp3pZizzVXCw ($98.90 in chips)
Seat 4: 5k9fvXD9suIgCxU4HLQjTw ($53.95 in chips)
Seat 5: Ja2jdidjip2UeJnRzmzAAQ ($50 in chips)
Seat 6: t1qL+wRXOwTLB4TBbcw2QA ($47.75 in chips)
Seat 7: dXhO5i7KOoVcsGqbklD+jw ($27.50 in chips)
Seat 9: 4WLZvqBn5qv5tds5kt5A1Q ($56 in chips)
xZCXQSXlrZkp3pZizzVXCw: posts small blind $0.25
5k9fvXD9suIgCxU4HLQjTw: posts big blind $0.50
*** HOLE CARDS ***
Ja2jdidjip2UeJnRzmzAAQ: folds
t1qL+wRXOwTLB4TBbcw2QA: folds
dXhO5i7KOoVcsGqbklD+jw: folds
4WLZvqBn5qv5tds5kt5A1Q: folds
pFtzb1sR4b0d1aw6aIRgDg: folds
AjV5McH1KMMclY26QdLM5w: folds
xZCXQSXlrZkp3pZizzVXCw: folds
5k9fvXD9suIgCxU4HLQjTw collected $0.50 from pot
5k9fvXD9suIgCxU4HLQjTw: doesn't show hand
*** SUMMARY ***
Total pot $0.50 | Rake $0
Seat 1: pFtzb1sR4b0d1aw6aIRgDg folded before Flop (didn't bet)
Seat 2: AjV5McH1KMMclY26QdLM5w (button) folded before Flop (didn't bet)
Seat 3: xZCXQSXlrZkp3pZizzVXCw (small blind) folded before Flop
Seat 4: 5k9fvXD9suIgCxU4HLQjTw (big blind) collected ($0.50)
Seat 5: Ja2jdidjip2UeJnRzmzAAQ folded before Flop (didn't bet)
Seat 6: t1qL+wRXOwTLB4TBbcw2QA folded before Flop (didn't bet)
Seat 7: dXhO5i7KOoVcsGqbklD+jw folded before Flop (didn't bet)
Seat 9: 4WLZvqBn5qv5tds5kt5A1Q folded before Flop (didn't bet)



PokerStars Game #59941288568:  Hold'em No Limit ($0.25/$0.50) - 2009/07/01 1:31:05 ET
Table '3FhG0gl3kMX3wBEEqj+wnQ' 9-max Seat #4 is the button
Seat 1: bxLSulbgr8LmKNjOzw8URg ($49.30 in chips)
Seat 2: vacmVLJJECYI6HjAynFcpg ($49.85 in chips)
Seat 3: YXCE3WOZi8g2sIf3y/plVw ($59.75 in chips)
Seat 4: e2+sK/yjnj94rXOKoxPP2A ($69.50 in chips)
Seat 5: XcLXSUMHSpshK/7Lh0M4Vg ($8.75 in chips)
Seat 6: 997ViqAtWn1FPjJqcffwcA ($109.80 in chips)
Seat 7: mSD1pginDsyHG5PDfqzphw ($12.50 in chips)
Seat 8: j3K/Jujr7PY4ZM2RZvlH6A ($46.10 in chips)
XcLXSUMHSpshK/7Lh0M4Vg: posts small blind $0.25
997ViqAtWn1FPjJqcffwcA: posts big blind $0.50
*** HOLE CARDS ***
mSD1pginDsyHG5PDfqzphw: folds
j3K/Jujr7PY4ZM2RZvlH6A: folds
bxLSulbgr8LmKNjOzw8URg: folds
vacmVLJJECYI6HjAynFcpg: folds
YXCE3WOZi8g2sIf3y/plVw: folds
e2+sK/yjnj94rXOKoxPP2A: folds
XcLXSUMHSpshK/7Lh0M4Vg: folds
997ViqAtWn1FPjJqcffwcA collected $0.50 from pot
*** SUMMARY ***
Total pot $0.50 | Rake $0
Seat 1: bxLSulbgr8LmKNjOzw8URg folded before Flop (didn't bet)
Seat 2: vacmVLJJECYI6HjAynFcpg folded before Flop (didn't bet)
Seat 3: YXCE3WOZi8g2sIf3y/plVw folded before Flop (didn't bet)
Seat 4: e2+sK/yjnj94rXOKoxPP2A (button) folded before Flop (didn't bet)
Seat 5: XcLXSUMHSpshK/7Lh0M4Vg (small blind) folded before Flop
Seat 6: 997ViqAtWn1FPjJqcffwcA (big blind) collected ($0.50)
Seat 7: mSD1pginDsyHG5PDfqzphw folded before Flop (didn't bet)
Seat 8: j3K/Jujr7PY4ZM2RZvlH6A folded before Flop (didn't bet)



PokerStars Game #59941290142:  Hold'em No Limit ($0.25/$0.50) - 2009/07/01 1:31:08 ET
Table '8BQGgNetI1NOvWeu3gtMNw' 2-max Seat #1 is the button
Seat 1: bypIyrYcAAifLfhZpGlKLA ($68.15 in chips)
Seat 2: Z4HwehErEwzsv/noQlfUlg ($148.95 in chips)
bypIyrYcAAifLfhZpGlKLA: posts small blind $0.25
Z4HwehErEwzsv/noQlfUlg: posts big blind $0.50
*** HOLE CARDS ***
bypIyrYcAAifLfhZpGlKLA: raises $1 to $1.50
Z4HwehErEwzsv/noQlfUlg: raises $2 to $3.50
bypIyrYcAAifLfhZpGlKLA: calls $2
*** FLOP *** [6h Js 5c]
Z4HwehErEwzsv/noQlfUlg: checks
bypIyrYcAAifLfhZpGlKLA: checks
*** TURN *** [6h Js 5c] [2h]
Z4HwehErEwzsv/noQlfUlg: bets $4
bypIyrYcAAifLfhZpGlKLA: folds
Z4HwehErEwzsv/noQlfUlg collected $6.65 from pot
Z4HwehErEwzsv/noQlfUlg: doesn't show hand
*** SUMMARY ***
Total pot $7 | Rake $0.35
Board [6h Js 5c 2h]
Seat 1: bypIyrYcAAifLfhZpGlKLA (button) (small blind) folded on the Turn
Seat 2: Z4HwehErEwzsv/noQlfUlg (big blind) collected ($6.65)



PokerStars Game #59941291210:  Hold'em No Limit ($0.25/$0.50) - 2009/07/01 1:31:10 ET
Table 'B+sqsfj6d6zXicNfaseTaw' 2-max Seat #1 is the button
Seat 1: +4GNcSsecmapVGSdV0mUPA ($129.65 in chips)
Seat 2: Lv5RmpRe6LtPkBzM9Gpo5A ($94.80 in chips)
+4GNcSsecmapVGSdV0mUPA: posts small blind $0.25
Lv5RmpRe6LtPkBzM9Gpo5A: posts big blind $0.50
*** HOLE CARDS ***
+4GNcSsecmapVGSdV0mUPA: raises $1 to $1.50
Lv5RmpRe6LtPkBzM9Gpo5A: folds
+4GNcSsecmapVGSdV0mUPA collected $1 from pot
*** SUMMARY ***
Total pot $1 | Rake $0
Seat 1: +4GNcSsecmapVGSdV0mUPA (button) (small blind) collected ($1)
Seat 2: Lv5RmpRe6LtPkBzM9Gpo5A (big blind) folded before Flop



PokerStars Game #59941291212:  Hold'em No Limit ($0.25/$0.50) - 2009/07/01 1:31:10 ET
Table 'lSisgp6H7Fg1hH5VfjEjYQ' 9-max Seat #9 is the button
Seat 1: 5k9fvXD9suIgCxU4HLQjTw ($54.30 in chips)
Seat 2: 5acK4E7fzEwnplVBZ6eNWA ($50 in chips)
Seat 3: SKnJuWHScqetA/qG5p+wCg ($30 in chips)
Seat 5: mSD1pginDsyHG5PDfqzphw ($12.25 in chips)
Seat 6: +k7T5ocke8UwavtgUHm+Cg ($72.20 in chips)
Seat 7: IDtNLR9uFCDdjNsJWMHA5Q ($20.35 in chips)
Seat 8: a4JDWmpFQkL10XfAyuF51A ($9.50 in chips)
Seat 9: YzeKFbJVLmJGTgNH3ySQlw ($8.95 in chips)
5k9fvXD9suIgCxU4HLQjTw: posts small blind $0.25
5acK4E7fzEwnplVBZ6eNWA: posts big blind $0.50
*** HOLE CARDS ***
SKnJuWHScqetA/qG5p+wCg: folds
mSD1pginDsyHG5PDfqzphw: folds
+k7T5ocke8UwavtgUHm+Cg: folds
IDtNLR9uFCDdjNsJWMHA5Q: calls $0.50
a4JDWmpFQkL10XfAyuF51A: folds
YzeKFbJVLmJGTgNH3ySQlw: folds
5k9fvXD9suIgCxU4HLQjTw: folds
5acK4E7fzEwnplVBZ6eNWA: checks
*** FLOP *** [6c Ts 4c]
5acK4E7fzEwnplVBZ6eNWA: checks
IDtNLR9uFCDdjNsJWMHA5Q: checks
*** TURN *** [6c Ts 4c] [8s]
5acK4E7fzEwnplVBZ6eNWA: checks
IDtNLR9uFCDdjNsJWMHA5Q: checks
*** RIVER *** [6c Ts 4c 8s] [2s]
5acK4E7fzEwnplVBZ6eNWA: checks
IDtNLR9uFCDdjNsJWMHA5Q: checks
*** SHOW DOWN ***
5acK4E7fzEwnplVBZ6eNWA: shows [5c Qh] (high card Queen)
IDtNLR9uFCDdjNsJWMHA5Q: shows [9s Ah] (high card Ace)
IDtNLR9uFCDdjNsJWMHA5Q collected $1.20 from pot
*** SUMMARY ***
Total pot $1.25 | Rake $0.05
Board [6c Ts 4c 8s 2s]
Seat 1: 5k9fvXD9suIgCxU4HLQjTw (small blind) folded before Flop
Seat 2: 5acK4E7fzEwnplVBZ6eNWA (big blind) showed [5c Qh] and lost with high card Queen
Seat 3: SKnJuWHScqetA/qG5p+wCg folded before Flop (didn't bet)
Seat 5: mSD1pginDsyHG5PDfqzphw folded before Flop (didn't bet)
Seat 6: +k7T5ocke8UwavtgUHm+Cg folded before Flop (didn't bet)
Seat 7: IDtNLR9uFCDdjNsJWMHA5Q showed [9s Ah] and won ($1.20) with high card Ace
Seat 8: a4JDWmpFQkL10XfAyuF51A folded before Flop (didn't bet)
Seat 9: YzeKFbJVLmJGTgNH3ySQlw (button) folded before Flop (didn't bet)



PokerStars Game #59941291092:  Hold'em No Limit ($0.25/$0.50) - 2009/07/01 1:31:10 ET
Table '+z1aekfHkpp09pc8F9aViw' 6-max Seat #5 is the button
Seat 2: 4QfsCWthT/vSLirorNXqtg ($50.75 in chips)
Seat 3: URYNc7fPA23K2UfadQbnCA ($48.50 in chips)
Seat 5: 2igtJLmvIZ+HqX4XPgMPZA ($50.95 in chips)
Seat 6: GUnvMULl2qFOO1yenu1UBw ($52.50 in chips)
GUnvMULl2qFOO1yenu1UBw: posts small blind $0.25
4QfsCWthT/vSLirorNXqtg: posts big blind $0.50
*** HOLE CARDS ***
URYNc7fPA23K2UfadQbnCA: folds
2igtJLmvIZ+HqX4XPgMPZA: folds
RowCSpSURHTOL/dcjg/Iug has returned
GUnvMULl2qFOO1yenu1UBw: folds
4QfsCWthT/vSLirorNXqtg collected $0.50 from pot
*** SUMMARY ***
Total pot $0.50 | Rake $0
Seat 2: 4QfsCWthT/vSLirorNXqtg (big blind) collected ($0.50)
Seat 3: URYNc7fPA23K2UfadQbnCA folded before Flop (didn't bet)
Seat 5: 2igtJLmvIZ+HqX4XPgMPZA (button) folded before Flop (didn't bet)
Seat 6: GUnvMULl2qFOO1yenu1UBw (small blind) folded before Flop



PokerStars Game #59941292138:  Hold'em No Limit ($0.25/$0.50) - 2009/07/01 1:31:12 ET
Table '9ojijpRcYQSQTh6xI+haUA' 2-max Seat #1 is the button
Seat 1: FqpibuVWLNsAN/Z7ROZLnA ($40.50 in chips)
Seat 2: TitTV+fFCcBZWOERdytydA ($44.95 in chips)
FqpibuVWLNsAN/Z7ROZLnA: posts small blind $0.25
TitTV+fFCcBZWOERdytydA: posts big blind $0.50
*** HOLE CARDS ***
FqpibuVWLNsAN/Z7ROZLnA: folds
TitTV+fFCcBZWOERdytydA collected $0.50 from pot
TitTV+fFCcBZWOERdytydA: doesn't show hand
*** SUMMARY ***
Total pot $0.50 | Rake $0
Seat 1: FqpibuVWLNsAN/Z7ROZLnA (button) (small blind) folded before Flop
Seat 2: TitTV+fFCcBZWOERdytydA (big blind) collected ($0.50)



PokerStars Game #59941292942:  Hold'em No Limit ($0.25/$0.50) - 2009/07/01 1:31:13 ET
Table 'hSTs/dUsYLgJQuF2Onp0MQ' 6-max Seat #1 is the button
Seat 1: 1WUCqNG+p+vfWRTXNu4ljw ($50 in chips)
Seat 2: Hdd4js36ITbTJ/QuVYwTlA ($82 in chips)
Seat 3: lxIzoHy0RnkfFSODHC2liw ($53.20 in chips)
Seat 4: 2igtJLmvIZ+HqX4XPgMPZA ($50 in chips)
Seat 6: M1KyQQvVPVuxqTAB8sR/zQ ($93.80 in chips)
Hdd4js36ITbTJ/QuVYwTlA: posts small blind $0.25
lxIzoHy0RnkfFSODHC2liw: posts big blind $0.50
FsRQ5ECdlLkLYI5le8+PDQ: sits out
*** HOLE CARDS ***
2igtJLmvIZ+HqX4XPgMPZA: folds
M1KyQQvVPVuxqTAB8sR/zQ: folds
1WUCqNG+p+vfWRTXNu4ljw: folds
Hdd4js36ITbTJ/QuVYwTlA: raises $1.50 to $2
lxIzoHy0RnkfFSODHC2liw: raises $4.50 to $6.50
Hdd4js36ITbTJ/QuVYwTlA: calls $4.50
*** FLOP *** [Tc 8d 5s]
Hdd4js36ITbTJ/QuVYwTlA: checks
lxIzoHy0RnkfFSODHC2liw: checks
*** TURN *** [Tc 8d 5s] [7h]
Hdd4js36ITbTJ/QuVYwTlA: bets $7
lxIzoHy0RnkfFSODHC2liw: calls $7
*** RIVER *** [Tc 8d 5s 7h] [2c]
Hdd4js36ITbTJ/QuVYwTlA: bets $10
lxIzoHy0RnkfFSODHC2liw: calls $10
*** SHOW DOWN ***
Hdd4js36ITbTJ/QuVYwTlA: shows [8s 9s] (a pair of Eights)
lxIzoHy0RnkfFSODHC2liw: mucks hand
Hdd4js36ITbTJ/QuVYwTlA collected $45 from pot
*** SUMMARY ***
Total pot $47 | Rake $2
Board [Tc 8d 5s 7h 2c]
Seat 1: 1WUCqNG+p+vfWRTXNu4ljw (button) folded before Flop (didn't bet)
Seat 2: Hdd4js36ITbTJ/QuVYwTlA (small blind) showed [8s 9s] and won ($45) with a pair of Eights
Seat 3: lxIzoHy0RnkfFSODHC2liw (big blind) mucked
Seat 4: 2igtJLmvIZ+HqX4XPgMPZA folded before Flop (didn't bet)
Seat 6: M1KyQQvVPVuxqTAB8sR/zQ folded before Flop (didn't bet)



PokerStars Game #59941293594:  Hold'em No Limit ($0.25/$0.50) - 2009/07/01 1:31:14 ET
Table 'hWT2kq66tnKEpD26cia6fQ' 2-max Seat #1 is the button
Seat 1: Ce3KNFP+ao7Da9NHb65raw ($52.10 in chips)
Seat 2: 16tvT7AYgZ2LgiGFcvFKQg ($23.85 in chips)
Ce3KNFP+ao7Da9NHb65raw: posts small blind $0.25
16tvT7AYgZ2LgiGFcvFKQg: posts big blind $0.50
*** HOLE CARDS ***
Ce3KNFP+ao7Da9NHb65raw: calls $0.25
16tvT7AYgZ2LgiGFcvFKQg: checks
*** FLOP *** [5h Ts 7d]
16tvT7AYgZ2LgiGFcvFKQg: checks
Ce3KNFP+ao7Da9NHb65raw: bets $1
16tvT7AYgZ2LgiGFcvFKQg: folds
Ce3KNFP+ao7Da9NHb65raw collected $0.95 from pot
*** SUMMARY ***
Total pot $1 | Rake $0.05
Board [5h Ts 7d]
Seat 1: Ce3KNFP+ao7Da9NHb65raw (button) (small blind) collected ($0.95)
Seat 2: 16tvT7AYgZ2LgiGFcvFKQg (big blind) folded on the Flop



PokerStars Game #59941294380:  Hold'em No Limit ($0.25/$0.50) - 2009/07/01 1:31:15 ET
Table 'ZYI3ZReBjdfKEYItkZHI6A' 9-max Seat #5 is the button
Seat 1: IYd5zG8k7vdBNVHbHg2Pag ($63.65 in chips)
Seat 3: 75K2MXwN65Sjfp1yHd50Hg ($9.25 in chips)
Seat 4: e2+sK/yjnj94rXOKoxPP2A ($60.90 in chips)
Seat 5: ApHP7ouup365XIUFBdEDxg ($15.95 in chips)
Seat 6: 1xBtrSVBbgFH/viUWKqQeg ($29.25 in chips)
Seat 7: HWcfp1hY1hqvrddzW3/FQw ($15.95 in chips)
Seat 8: ji04uOybxCdpdefzlUQeKQ ($30.55 in chips)
Seat 9: HZkVla4kK2SI42CVrPZ/ig ($9.25 in chips)
1xBtrSVBbgFH/viUWKqQeg: posts small blind $0.25
HWcfp1hY1hqvrddzW3/FQw: posts big blind $0.50
5acK4E7fzEwnplVBZ6eNWA: sits out
*** HOLE CARDS ***
ji04uOybxCdpdefzlUQeKQ: folds
HZkVla4kK2SI42CVrPZ/ig: folds
IYd5zG8k7vdBNVHbHg2Pag has timed out
IYd5zG8k7vdBNVHbHg2Pag: folds
IYd5zG8k7vdBNVHbHg2Pag is sitting out
75K2MXwN65Sjfp1yHd50Hg: folds
e2+sK/yjnj94rXOKoxPP2A: folds
ApHP7ouup365XIUFBdEDxg: folds
IYd5zG8k7vdBNVHbHg2Pag has returned
1xBtrSVBbgFH/viUWKqQeg: calls $0.25
HWcfp1hY1hqvrddzW3/FQw: checks
*** FLOP *** [Ac 8s Ad]
1xBtrSVBbgFH/viUWKqQeg: bets $0.50
HWcfp1hY1hqvrddzW3/FQw: folds
1xBtrSVBbgFH/viUWKqQeg collected $0.95 from pot
*** SUMMARY ***
Total pot $1 | Rake $0.05
Board [Ac 8s Ad]
Seat 1: IYd5zG8k7vdBNVHbHg2Pag folded before Flop (didn't bet)
Seat 3: 75K2MXwN65Sjfp1yHd50Hg folded before Flop (didn't bet)
Seat 4: e2+sK/yjnj94rXOKoxPP2A folded before Flop (didn't bet)
Seat 5: ApHP7ouup365XIUFBdEDxg (button) folded before Flop (didn't bet)
Seat 6: 1xBtrSVBbgFH/viUWKqQeg (small blind) collected ($0.95)
Seat 7: HWcfp1hY1hqvrddzW3/FQw (big blind) folded on the Flop
Seat 8: ji04uOybxCdpdefzlUQeKQ folded before Flop (didn't bet)
Seat 9: HZkVla4kK2SI42CVrPZ/ig folded before Flop (didn't bet)



PokerStars Game #59941295602:  Hold'em No Limit ($0.25/$0.50) - 2009/07/01 1:31:17 ET
Table '2lPOwetm4cfkZPbTmGPH/w' 2-max Seat #2 is the button
Seat 1: vUGdApqS8J/GJE2gaVWl1w ($25.70 in chips)
Seat 2: XFa6sBGjP2gxoIvxR3fZIg ($15.65 in chips)
XFa6sBGjP2gxoIvxR3fZIg: posts small blind $0.25
vUGdApqS8J/GJE2gaVWl1w: posts big blind $0.50
*** HOLE CARDS ***
XFa6sBGjP2gxoIvxR3fZIg: raises $1 to $1.50
vUGdApqS8J/GJE2gaVWl1w: calls $1
*** FLOP *** [5c 3h 6c]
vUGdApqS8J/GJE2gaVWl1w: checks
XFa6sBGjP2gxoIvxR3fZIg: bets $2.50
vUGdApqS8J/GJE2gaVWl1w: folds
XFa6sBGjP2gxoIvxR3fZIg collected $2.85 from pot
*** SUMMARY ***
Total pot $3 | Rake $0.15
Board [5c 3h 6c]
Seat 1: vUGdApqS8J/GJE2gaVWl1w (big blind) folded on the Flop
Seat 2: XFa6sBGjP2gxoIvxR3fZIg (button) (small blind) collected ($2.85)



PokerStars Game #59941295134:  Hold'em No Limit ($0.25/$0.50) - 2009/07/01 1:31:17 ET
Table '99gCy/CZQwPIjZWH+BguQg' 9-max Seat #6 is the button
Seat 2: 7CKaQEWhd40e2lLifzZ1Cw ($29.50 in chips)
Seat 4: bxLSulbgr8LmKNjOzw8URg ($86.70 in chips)
Seat 5: YXCE3WOZi8g2sIf3y/plVw ($50.90 in chips)
Seat 6: OcnLOMVFdy23jXnoTyaO5Q ($303.10 in chips)
Seat 7: ottZQkg1UDWk85BtBzGJzg ($29.25 in chips)
Seat 8: 8ehL7qlZzjgUh2H35iiWLw ($50 in chips)
Seat 9: j3K/Jujr7PY4ZM2RZvlH6A ($67.50 in chips)
ottZQkg1UDWk85BtBzGJzg: posts small blind $0.25
8ehL7qlZzjgUh2H35iiWLw: posts big blind $0.50
Bawookles: sits out
*** HOLE CARDS ***
qRAIErWOpf/5FYyZ8qza0w leaves the table
j3K/Jujr7PY4ZM2RZvlH6A: raises $1 to $1.50
7CKaQEWhd40e2lLifzZ1Cw: folds
bxLSulbgr8LmKNjOzw8URg: folds
VhjwWfxHSx00WxzYih3KOA joins the table at seat #3
YXCE3WOZi8g2sIf3y/plVw: folds
OcnLOMVFdy23jXnoTyaO5Q: calls $1.50
ottZQkg1UDWk85BtBzGJzg: folds
8ehL7qlZzjgUh2H35iiWLw: calls $1
*** FLOP *** [7h 4d 9c]
8ehL7qlZzjgUh2H35iiWLw: checks
j3K/Jujr7PY4ZM2RZvlH6A: bets $1.50
OcnLOMVFdy23jXnoTyaO5Q: raises $1.50 to $3
8ehL7qlZzjgUh2H35iiWLw: folds
j3K/Jujr7PY4ZM2RZvlH6A: calls $1.50
*** TURN *** [7h 4d 9c] [8s]
j3K/Jujr7PY4ZM2RZvlH6A: bets $5
OcnLOMVFdy23jXnoTyaO5Q: calls $5
*** RIVER *** [7h 4d 9c 8s] [5d]
j3K/Jujr7PY4ZM2RZvlH6A: bets $12
OcnLOMVFdy23jXnoTyaO5Q: folds
j3K/Jujr7PY4ZM2RZvlH6A collected $19.75 from pot
j3K/Jujr7PY4ZM2RZvlH6A: doesn't show hand
*** SUMMARY ***
Total pot $20.75 | Rake $1
Board [7h 4d 9c 8s 5d]
Seat 2: 7CKaQEWhd40e2lLifzZ1Cw folded before Flop (didn't bet)
Seat 4: bxLSulbgr8LmKNjOzw8URg folded before Flop (didn't bet)
Seat 5: YXCE3WOZi8g2sIf3y/plVw folded before Flop (didn't bet)
Seat 6: OcnLOMVFdy23jXnoTyaO5Q (button) folded on the River
Seat 7: ottZQkg1UDWk85BtBzGJzg (small blind) folded before Flop
Seat 8: 8ehL7qlZzjgUh2H35iiWLw (big blind) folded on the Flop
Seat 9: j3K/Jujr7PY4ZM2RZvlH6A collected ($19.75)



PokerStars Game #59941296228:  Hold'em No Limit ($0.25/$0.50) - 2009/07/01 1:31:19 ET
Table '9ojijpRcYQSQTh6xI+haUA' 2-max Seat #2 is the button
Seat 1: FqpibuVWLNsAN/Z7ROZLnA ($40.25 in chips)
Seat 2: TitTV+fFCcBZWOERdytydA ($45.20 in chips)
TitTV+fFCcBZWOERdytydA: posts small blind $0.25
FqpibuVWLNsAN/Z7ROZLnA: posts big blind $0.50
*** HOLE CARDS ***
TitTV+fFCcBZWOERdytydA: raises $1 to $1.50
FqpibuVWLNsAN/Z7ROZLnA: raises $1 to $2.50
TitTV+fFCcBZWOERdytydA: calls $1
*** FLOP *** [9h 6d 8d]
FqpibuVWLNsAN/Z7ROZLnA: checks
TitTV+fFCcBZWOERdytydA: bets $2.50
FqpibuVWLNsAN/Z7ROZLnA: calls $2.50
*** TURN *** [9h 6d 8d] [6s]
FqpibuVWLNsAN/Z7ROZLnA: checks
TitTV+fFCcBZWOERdytydA: checks
*** RIVER *** [9h 6d 8d 6s] [6c]
FqpibuVWLNsAN/Z7ROZLnA: bets $5.50
TitTV+fFCcBZWOERdytydA: calls $5.50
*** SHOW DOWN ***
FqpibuVWLNsAN/Z7ROZLnA: shows [Tc Kc] (three of a kind, Sixes)
TitTV+fFCcBZWOERdytydA: shows [9s Qd] (a full house, Sixes full of Nines)
TitTV+fFCcBZWOERdytydA collected $20.50 from pot
*** SUMMARY ***
Total pot $21 | Rake $0.50
Board [9h 6d 8d 6s 6c]
Seat 1: FqpibuVWLNsAN/Z7ROZLnA (big blind) showed [Tc Kc] and lost with three of a kind, Sixes
Seat 2: TitTV+fFCcBZWOERdytydA (button) (small blind) showed [9s Qd] and won ($20.50) with a full house, Sixes full of Nines



PokerStars Game #59941296888:  Hold'em No Limit ($0.25/$0.50) - 2009/07/01 1:31:20 ET
Table 'kgbJRsxfv64KrErDRBAkcw' 6-max Seat #4 is the button
Seat 1: VamsyhlFzXGF6/ydo0BHeA ($11.15 in chips)
Seat 2: AdS8BJMOheS01zjCDfPMFg ($63 in chips)
Seat 3: c4MNIaIyPMOMxrgT8FT5nA ($228.45 in chips)
Seat 4: 2igtJLmvIZ+HqX4XPgMPZA ($112.50 in chips)
Seat 5: eUBBn2R56C1IQ6Cs/vitwg ($50 in chips)
Seat 6: 1b+2BbjMN8qhR1WPqdE9VQ ($55.90 in chips)
eUBBn2R56C1IQ6Cs/vitwg: posts small blind $0.25
1b+2BbjMN8qhR1WPqdE9VQ: posts big blind $0.50
*** HOLE CARDS ***
VamsyhlFzXGF6/ydo0BHeA: calls $0.50
AdS8BJMOheS01zjCDfPMFg: folds
c4MNIaIyPMOMxrgT8FT5nA: calls $0.50
eUBBn2R56C1IQ6Cs/vitwg said, "sick"
2igtJLmvIZ+HqX4XPgMPZA: folds
eUBBn2R56C1IQ6Cs/vitwg: calls $0.25
1b+2BbjMN8qhR1WPqdE9VQ: checks
*** FLOP *** [Td Jh 2h]
eUBBn2R56C1IQ6Cs/vitwg: bets $2
1b+2BbjMN8qhR1WPqdE9VQ: raises $4 to $6
VamsyhlFzXGF6/ydo0BHeA: folds
c4MNIaIyPMOMxrgT8FT5nA: calls $6
eUBBn2R56C1IQ6Cs/vitwg: calls $4
*** TURN *** [Td Jh 2h] [9s]
eUBBn2R56C1IQ6Cs/vitwg: checks
1b+2BbjMN8qhR1WPqdE9VQ: checks
c4MNIaIyPMOMxrgT8FT5nA: bets $11.50
eUBBn2R56C1IQ6Cs/vitwg: raises $32 to $43.50 and is all-in
1b+2BbjMN8qhR1WPqdE9VQ: folds
c4MNIaIyPMOMxrgT8FT5nA: calls $32
*** RIVER *** [Td Jh 2h 9s] [6c]
*** SHOW DOWN ***
eUBBn2R56C1IQ6Cs/vitwg: shows [Qh Ks] (a straight, Nine to King)
c4MNIaIyPMOMxrgT8FT5nA: mucks hand
eUBBn2R56C1IQ6Cs/vitwg collected $104 from pot
*** SUMMARY ***
Total pot $107 | Rake $3
Board [Td Jh 2h 9s 6c]
Seat 1: VamsyhlFzXGF6/ydo0BHeA folded on the Flop
Seat 2: AdS8BJMOheS01zjCDfPMFg folded before Flop (didn't bet)
Seat 3: c4MNIaIyPMOMxrgT8FT5nA mucked
Seat 4: 2igtJLmvIZ+HqX4XPgMPZA (button) folded before Flop (didn't bet)
Seat 5: eUBBn2R56C1IQ6Cs/vitwg (small blind) showed [Qh Ks] and won ($104) with a straight, Nine to King
Seat 6: 1b+2BbjMN8qhR1WPqdE9VQ (big blind) folded on the Turn



PokerStars Game #59941297112:  Hold'em No Limit ($0.25/$0.50) - 2009/07/01 1:31:20 ET
Table 'iq+aXfWVQRdV0u8SRTYUEg' 9-max Seat #6 is the button
Seat 1: 3yl8Q6QaLfGtyhN4/pEFgQ ($78.05 in chips)
Seat 2: J9N0lxHFd/Js2S0xZLbsIQ ($21.60 in chips)
Seat 3: Qi/PyOsKwaqtKIg0H+7ELg ($9.75 in chips)
Seat 4: vHYT5s323LpajBj+2c9zbQ ($32.10 in chips)
Seat 5: 997ViqAtWn1FPjJqcffwcA ($57.55 in chips)
Seat 6: bTJ0WgoxefTPxIoycS7uoA ($30.95 in chips)
Seat 7: SKnJuWHScqetA/qG5p+wCg ($31.05 in chips)
Seat 8: /DtIHuxEH+3tzKefmSV+Mw ($36.85 in chips)
Seat 9: olE1Z2rKWAV8+tGqmIBK9g ($26.95 in chips)
SKnJuWHScqetA/qG5p+wCg: posts small blind $0.25
/DtIHuxEH+3tzKefmSV+Mw: posts big blind $0.50
*** HOLE CARDS ***
olE1Z2rKWAV8+tGqmIBK9g: folds
3yl8Q6QaLfGtyhN4/pEFgQ: folds
J9N0lxHFd/Js2S0xZLbsIQ: folds
Qi/PyOsKwaqtKIg0H+7ELg: folds
vHYT5s323LpajBj+2c9zbQ: folds
997ViqAtWn1FPjJqcffwcA: folds
bTJ0WgoxefTPxIoycS7uoA: raises $1 to $1.50
SKnJuWHScqetA/qG5p+wCg: folds
/DtIHuxEH+3tzKefmSV+Mw: folds
bTJ0WgoxefTPxIoycS7uoA collected $1.25 from pot
bTJ0WgoxefTPxIoycS7uoA is sitting out
*** SUMMARY ***
Total pot $1.25 | Rake $0
Seat 1: 3yl8Q6QaLfGtyhN4/pEFgQ folded before Flop (didn't bet)
Seat 2: J9N0lxHFd/Js2S0xZLbsIQ folded before Flop (didn't bet)
Seat 3: Qi/PyOsKwaqtKIg0H+7ELg folded before Flop (didn't bet)
Seat 4: vHYT5s323LpajBj+2c9zbQ folded before Flop (didn't bet)
Seat 5: 997ViqAtWn1FPjJqcffwcA folded before Flop (didn't bet)
Seat 6: bTJ0WgoxefTPxIoycS7uoA (button) collected ($1.25)
Seat 7: SKnJuWHScqetA/qG5p+wCg (small blind) folded before Flop
Seat 8: /DtIHuxEH+3tzKefmSV+Mw (big blind) folded before Flop
Seat 9: olE1Z2rKWAV8+tGqmIBK9g folded before Flop (didn't bet)



PokerStars Game #59941297744:  Hold'em No Limit ($0.25/$0.50) - 2009/07/01 1:31:21 ET
Table 'BCN5su+SsXiy1zRMJi0SJw' 6-max Seat #6 is the button
Seat 1: GxXV09ciXaOxyY2H5aMIIw ($32.30 in chips)
Seat 2: ehFNAevCQri3trWxV6FJdA ($59.40 in chips)
Seat 3: kwgv5lNhiFrfONXCshzxlA ($42.60 in chips)
Seat 4: bbsK8j+tpuVRhBqDzHxf7w ($49 in chips)
Seat 5: kxPhs4ePFqMy52CInAJ2aw ($53.05 in chips)
Seat 6: b2symlOdL7+0c9Pj4N/KlA ($68.45 in chips)
GxXV09ciXaOxyY2H5aMIIw: posts small blind $0.25
ehFNAevCQri3trWxV6FJdA: posts big blind $0.50
*** HOLE CARDS ***
kwgv5lNhiFrfONXCshzxlA: folds
bbsK8j+tpuVRhBqDzHxf7w: raises $1 to $1.50
kxPhs4ePFqMy52CInAJ2aw: folds
b2symlOdL7+0c9Pj4N/KlA: folds
GxXV09ciXaOxyY2H5aMIIw: folds
ehFNAevCQri3trWxV6FJdA: calls $1
*** FLOP *** [Ts 6d Qd]
ehFNAevCQri3trWxV6FJdA: checks
bbsK8j+tpuVRhBqDzHxf7w: bets $2
ehFNAevCQri3trWxV6FJdA: folds
bbsK8j+tpuVRhBqDzHxf7w collected $3.10 from pot
bbsK8j+tpuVRhBqDzHxf7w: doesn't show hand
*** SUMMARY ***
Total pot $3.25 | Rake $0.15
Board [Ts 6d Qd]
Seat 1: GxXV09ciXaOxyY2H5aMIIw (small blind) folded before Flop
Seat 2: ehFNAevCQri3trWxV6FJdA (big blind) folded on the Flop
Seat 3: kwgv5lNhiFrfONXCshzxlA folded before Flop (didn't bet)
Seat 4: bbsK8j+tpuVRhBqDzHxf7w collected ($3.10)
Seat 5: kxPhs4ePFqMy52CInAJ2aw folded before Flop (didn't bet)
Seat 6: b2symlOdL7+0c9Pj4N/KlA (button) folded before Flop (didn't bet)



PokerStars Game #59941298472:  Hold'em No Limit ($0.25/$0.50) - 2009/07/01 1:31:22 ET
Table '+dXkOAQyS8j9PQZusUTMpg' 2-max Seat #1 is the button
Seat 1: Teld4PDKla7C8/Wfu2DSkg ($54.20 in chips)
Seat 2: +zI4bP23YIjMkUHqeN2xfw ($22.20 in chips)
Teld4PDKla7C8/Wfu2DSkg: posts small blind $0.25
+zI4bP23YIjMkUHqeN2xfw: posts big blind $0.50
*** HOLE CARDS ***
Teld4PDKla7C8/Wfu2DSkg: calls $0.25
+zI4bP23YIjMkUHqeN2xfw: checks
*** FLOP *** [6s 6c 9d]
+zI4bP23YIjMkUHqeN2xfw: checks
Teld4PDKla7C8/Wfu2DSkg: checks
*** TURN *** [6s 6c 9d] [4c]
+zI4bP23YIjMkUHqeN2xfw: checks
Teld4PDKla7C8/Wfu2DSkg: checks
*** RIVER *** [6s 6c 9d 4c] [7d]
+zI4bP23YIjMkUHqeN2xfw: bets $0.50
Teld4PDKla7C8/Wfu2DSkg: folds
+zI4bP23YIjMkUHqeN2xfw collected $0.95 from pot
*** SUMMARY ***
Total pot $1 | Rake $0.05
Board [6s 6c 9d 4c 7d]
Seat 1: Teld4PDKla7C8/Wfu2DSkg (button) (small blind) folded on the River
Seat 2: +zI4bP23YIjMkUHqeN2xfw (big blind) collected ($0.95)



PokerStars Game #59941298156:  Hold'em No Limit ($0.25/$0.50) - 2009/07/01 1:31:22 ET
Table 'ErOuyGLI5PT3G5MnpHgC/g' 9-max Seat #8 is the button
Seat 1: eBrej2jnlUCs/JgxFCRn2g ($44.90 in chips)
Seat 2: pciZn00ZDk4BVBMTTMcNVQ ($19.30 in chips)
Seat 3: xZCXQSXlrZkp3pZizzVXCw ($50 in chips)
Seat 5: JwvquocWfhTVApN5t47LgA ($57.80 in chips)
Seat 6: zE9cVigS2nW/Ljy4K4bUQA ($30 in chips)
Seat 7: 90Wb75h3W1BRpbqVnuk8gw ($62.60 in chips)
Seat 8: g4k0NXISyLCqaSWZDBjfEg ($50 in chips)
Seat 9: J0W5D97jl5VLky+IoPvDeA ($64.75 in chips)
J0W5D97jl5VLky+IoPvDeA: posts small blind $0.25
eBrej2jnlUCs/JgxFCRn2g: posts big blind $0.50
YRqrX/u38J7aLNNnBzQsjQ: sits out
*** HOLE CARDS ***
pciZn00ZDk4BVBMTTMcNVQ: folds
xZCXQSXlrZkp3pZizzVXCw: folds
JwvquocWfhTVApN5t47LgA: raises $1.50 to $2
zE9cVigS2nW/Ljy4K4bUQA: folds
90Wb75h3W1BRpbqVnuk8gw: folds
g4k0NXISyLCqaSWZDBjfEg: folds
J0W5D97jl5VLky+IoPvDeA: folds
eBrej2jnlUCs/JgxFCRn2g: folds
JwvquocWfhTVApN5t47LgA collected $1.25 from pot
JwvquocWfhTVApN5t47LgA: doesn't show hand
*** SUMMARY ***
Total pot $1.25 | Rake $0
Seat 1: eBrej2jnlUCs/JgxFCRn2g (big blind) folded before Flop
Seat 2: pciZn00ZDk4BVBMTTMcNVQ folded before Flop (didn't bet)
Seat 3: xZCXQSXlrZkp3pZizzVXCw folded before Flop (didn't bet)
Seat 5: JwvquocWfhTVApN5t47LgA collected ($1.25)
Seat 6: zE9cVigS2nW/Ljy4K4bUQA folded before Flop (didn't bet)
Seat 7: 90Wb75h3W1BRpbqVnuk8gw folded before Flop (didn't bet)
Seat 8: g4k0NXISyLCqaSWZDBjfEg (button) folded before Flop (didn't bet)
Seat 9: J0W5D97jl5VLky+IoPvDeA (small blind) folded before Flop



PokerStars Game #59941298996:  Hold'em No Limit ($0.25/$0.50) - 2009/07/01 1:31:23 ET
Table 'GfL/No5u5PoEnU39lP5pQg' 6-max Seat #6 is the button
Seat 1: 1WUCqNG+p+vfWRTXNu4ljw ($62.45 in chips)
Seat 2: uVwggSetzp7d+eVgowO3vg ($48.75 in chips)
Seat 3: 4pp9WxhGdbVbxCc9tlu0lw ($26.05 in chips)
Seat 4: r6u7MWSXF30/khcTYkrG9Q ($30.10 in chips)
Seat 5: M1KyQQvVPVuxqTAB8sR/zQ ($59.60 in chips)
Seat 6: kxPhs4ePFqMy52CInAJ2aw ($64.50 in chips)
1WUCqNG+p+vfWRTXNu4ljw: posts small blind $0.25
uVwggSetzp7d+eVgowO3vg: posts big blind $0.50
*** HOLE CARDS ***
4pp9WxhGdbVbxCc9tlu0lw: folds
r6u7MWSXF30/khcTYkrG9Q: folds
M1KyQQvVPVuxqTAB8sR/zQ: raises $1 to $1.50
kxPhs4ePFqMy52CInAJ2aw: calls $1.50
1WUCqNG+p+vfWRTXNu4ljw: folds
uVwggSetzp7d+eVgowO3vg: calls $1
*** FLOP *** [4d 6s 9c]
uVwggSetzp7d+eVgowO3vg: checks
M1KyQQvVPVuxqTAB8sR/zQ: bets $3.25
kxPhs4ePFqMy52CInAJ2aw: folds
uVwggSetzp7d+eVgowO3vg: folds
M1KyQQvVPVuxqTAB8sR/zQ collected $4.55 from pot
M1KyQQvVPVuxqTAB8sR/zQ: doesn't show hand
*** SUMMARY ***
Total pot $4.75 | Rake $0.20
Board [4d 6s 9c]
Seat 1: 1WUCqNG+p+vfWRTXNu4ljw (small blind) folded before Flop
Seat 2: uVwggSetzp7d+eVgowO3vg (big blind) folded on the Flop
Seat 3: 4pp9WxhGdbVbxCc9tlu0lw folded before Flop (didn't bet)
Seat 4: r6u7MWSXF30/khcTYkrG9Q folded before Flop (didn't bet)
Seat 5: M1KyQQvVPVuxqTAB8sR/zQ collected ($4.55)
Seat 6: kxPhs4ePFqMy52CInAJ2aw (button) folded on the Flop



PokerStars Game #59941299090:  Hold'em No Limit ($0.25/$0.50) - 2009/07/01 1:31:23 ET
Table 'fx6MqwfYAj/Rt86hBz2L3Q' 9-max Seat #8 is the button
Seat 1: v/4aX0ejnaIFK4ftDk2Lyg ($51.40 in chips)
Seat 2: C3rGXblctNcWI6JYPHhaEg ($28.70 in chips)
Seat 3: iadBi5AEt7gTBXbDSSnMYQ ($37.80 in chips)
Seat 4: VhjwWfxHSx00WxzYih3KOA ($50 in chips)
Seat 5: iAISe3dVeua8PUn2wwgDHw ($77.30 in chips)
Seat 6: 5k9fvXD9suIgCxU4HLQjTw ($50 in chips)
Seat 7: mSD1pginDsyHG5PDfqzphw ($10 in chips)
Seat 8: JYwJYYV9pM5KWdSiETl8rA ($62.25 in chips)
Seat 9: vO3QVRovWemcGMkm7ijAIA ($25.20 in chips)
vO3QVRovWemcGMkm7ijAIA: posts small blind $0.25
v/4aX0ejnaIFK4ftDk2Lyg: posts big blind $0.50
*** HOLE CARDS ***
C3rGXblctNcWI6JYPHhaEg: calls $0.50
iadBi5AEt7gTBXbDSSnMYQ: folds
VhjwWfxHSx00WxzYih3KOA: folds
iAISe3dVeua8PUn2wwgDHw: folds
5k9fvXD9suIgCxU4HLQjTw: folds
mSD1pginDsyHG5PDfqzphw: folds
JYwJYYV9pM5KWdSiETl8rA: folds
vO3QVRovWemcGMkm7ijAIA: folds
v/4aX0ejnaIFK4ftDk2Lyg: checks
*** FLOP *** [Ts Ac Jc]
v/4aX0ejnaIFK4ftDk2Lyg: checks
C3rGXblctNcWI6JYPHhaEg: bets $1.20
v/4aX0ejnaIFK4ftDk2Lyg: folds
C3rGXblctNcWI6JYPHhaEg collected $1.20 from pot
C3rGXblctNcWI6JYPHhaEg: doesn't show hand
*** SUMMARY ***
Total pot $1.25 | Rake $0.05
Board [Ts Ac Jc]
Seat 1: v/4aX0ejnaIFK4ftDk2Lyg (big blind) folded on the Flop
Seat 2: C3rGXblctNcWI6JYPHhaEg collected ($1.20)
Seat 3: iadBi5AEt7gTBXbDSSnMYQ folded before Flop (didn't bet)
Seat 4: VhjwWfxHSx00WxzYih3KOA folded before Flop (didn't bet)
Seat 5: iAISe3dVeua8PUn2wwgDHw folded before Flop (didn't bet)
Seat 6: 5k9fvXD9suIgCxU4HLQjTw folded before Flop (didn't bet)
Seat 7: mSD1pginDsyHG5PDfqzphw folded before Flop (didn't bet)
Seat 8: JYwJYYV9pM5KWdSiETl8rA (button) folded before Flop (didn't bet)
Seat 9: vO3QVRovWemcGMkm7ijAIA (small blind) folded before Flop



PokerStars Game #59941299592:  Hold'em No Limit ($0.25/$0.50) - 2009/07/01 1:31:24 ET
Table '3FhG0gl3kMX3wBEEqj+wnQ' 9-max Seat #5 is the button
Seat 1: bxLSulbgr8LmKNjOzw8URg ($49.30 in chips)
Seat 2: vacmVLJJECYI6HjAynFcpg ($49.85 in chips)
Seat 3: YXCE3WOZi8g2sIf3y/plVw ($59.75 in chips)
Seat 4: e2+sK/yjnj94rXOKoxPP2A ($69.50 in chips)
Seat 5: XcLXSUMHSpshK/7Lh0M4Vg ($8.50 in chips)
Seat 6: 997ViqAtWn1FPjJqcffwcA ($110.05 in chips)
Seat 7: mSD1pginDsyHG5PDfqzphw ($12.50 in chips)
Seat 8: j3K/Jujr7PY4ZM2RZvlH6A ($46.10 in chips)
997ViqAtWn1FPjJqcffwcA: posts small blind $0.25
mSD1pginDsyHG5PDfqzphw: posts big blind $0.50
*** HOLE CARDS ***
j3K/Jujr7PY4ZM2RZvlH6A: raises $1 to $1.50
bxLSulbgr8LmKNjOzw8URg: folds
vacmVLJJECYI6HjAynFcpg: folds
YXCE3WOZi8g2sIf3y/plVw: calls $1.50
e2+sK/yjnj94rXOKoxPP2A: folds
XcLXSUMHSpshK/7Lh0M4Vg: folds
997ViqAtWn1FPjJqcffwcA: folds
mSD1pginDsyHG5PDfqzphw: folds
*** FLOP *** [2c 6h Jc]
j3K/Jujr7PY4ZM2RZvlH6A: bets $0.50
YXCE3WOZi8g2sIf3y/plVw: raises $2.50 to $3
j3K/Jujr7PY4ZM2RZvlH6A: folds
YXCE3WOZi8g2sIf3y/plVw collected $4.55 from pot
YXCE3WOZi8g2sIf3y/plVw: doesn't show hand
*** SUMMARY ***
Total pot $4.75 | Rake $0.20
Board [2c 6h Jc]
Seat 1: bxLSulbgr8LmKNjOzw8URg folded before Flop (didn't bet)
Seat 2: vacmVLJJECYI6HjAynFcpg folded before Flop (didn't bet)
Seat 3: YXCE3WOZi8g2sIf3y/plVw collected ($4.55)
Seat 4: e2+sK/yjnj94rXOKoxPP2A folded before Flop (didn't bet)
Seat 5: XcLXSUMHSpshK/7Lh0M4Vg (button) folded before Flop (didn't bet)
Seat 6: 997ViqAtWn1FPjJqcffwcA (small blind) folded before Flop
Seat 7: mSD1pginDsyHG5PDfqzphw (big blind) folded before Flop
Seat 8: j3K/Jujr7PY4ZM2RZvlH6A folded on the Flop



PokerStars Game #59941300290:  Hold'em No Limit ($0.25/$0.50) - 2009/07/01 1:31:26 ET
Table 'NCiXr0d5CEKBQr/cZgLhbA' 9-max Seat #3 is the button
Seat 1: pFtzb1sR4b0d1aw6aIRgDg ($80.45 in chips)
Seat 2: AjV5McH1KMMclY26QdLM5w ($47.55 in chips)
Seat 3: xZCXQSXlrZkp3pZizzVXCw ($98.65 in chips)
Seat 4: 5k9fvXD9suIgCxU4HLQjTw ($54.20 in chips)
Seat 5: Ja2jdidjip2UeJnRzmzAAQ ($50 in chips)
Seat 6: t1qL+wRXOwTLB4TBbcw2QA ($47.75 in chips)
Seat 7: dXhO5i7KOoVcsGqbklD+jw ($27.50 in chips)
Seat 9: 4WLZvqBn5qv5tds5kt5A1Q ($56 in chips)
5k9fvXD9suIgCxU4HLQjTw: posts small blind $0.25
Ja2jdidjip2UeJnRzmzAAQ: posts big blind $0.50
*** HOLE CARDS ***
t1qL+wRXOwTLB4TBbcw2QA: folds
dXhO5i7KOoVcsGqbklD+jw: raises $1 to $1.50
4WLZvqBn5qv5tds5kt5A1Q: calls $1.50
pFtzb1sR4b0d1aw6aIRgDg: folds
AjV5McH1KMMclY26QdLM5w: folds
xZCXQSXlrZkp3pZizzVXCw: calls $1.50
5k9fvXD9suIgCxU4HLQjTw: folds
Ja2jdidjip2UeJnRzmzAAQ: calls $1
*** FLOP *** [4d Js Ah]
Ja2jdidjip2UeJnRzmzAAQ: checks
dXhO5i7KOoVcsGqbklD+jw: bets $3.50
4WLZvqBn5qv5tds5kt5A1Q: folds
xZCXQSXlrZkp3pZizzVXCw: folds
XA3GzEhYmqB0KknKKPDZGQ joins the table at seat #8
Ja2jdidjip2UeJnRzmzAAQ: folds
dXhO5i7KOoVcsGqbklD+jw collected $5.95 from pot
*** SUMMARY ***
Total pot $6.25 | Rake $0.30
Board [4d Js Ah]
Seat 1: pFtzb1sR4b0d1aw6aIRgDg folded before Flop (didn't bet)
Seat 2: AjV5McH1KMMclY26QdLM5w folded before Flop (didn't bet)
Seat 3: xZCXQSXlrZkp3pZizzVXCw (button) folded on the Flop
Seat 4: 5k9fvXD9suIgCxU4HLQjTw (small blind) folded before Flop
Seat 5: Ja2jdidjip2UeJnRzmzAAQ (big blind) folded on the Flop
Seat 6: t1qL+wRXOwTLB4TBbcw2QA folded before Flop (didn't bet)
Seat 7: dXhO5i7KOoVcsGqbklD+jw collected ($5.95)
Seat 9: 4WLZvqBn5qv5tds5kt5A1Q folded on the Flop



PokerStars Game #59941300886:  Hold'em No Limit ($0.25/$0.50) - 2009/07/01 1:31:27 ET
Table 'cofQFHU7jbJoFecLVBof/w' 6-max Seat #5 is the button
Seat 1: URYNc7fPA23K2UfadQbnCA ($46 in chips)
Seat 2: f89uTQr3ieGlusj2IAYAEg ($50 in chips)
Seat 3: v4ctePcLlQw0r8E0qJtjYw ($47.20 in chips)
Seat 4: g6lz8npaeeTJmJegtPYhlQ ($17.10 in chips)
Seat 5: QvwRlrpVqerRRF8eJm6dDw ($50.15 in chips)
Seat 6: 7+uQ0OOgCTbR4ltkSwyC0g ($160.55 in chips)
7+uQ0OOgCTbR4ltkSwyC0g: posts small blind $0.25
URYNc7fPA23K2UfadQbnCA: posts big blind $0.50
*** HOLE CARDS ***
f89uTQr3ieGlusj2IAYAEg: folds
v4ctePcLlQw0r8E0qJtjYw: raises $1 to $1.50
g6lz8npaeeTJmJegtPYhlQ: folds
QvwRlrpVqerRRF8eJm6dDw: calls $1.50
7+uQ0OOgCTbR4ltkSwyC0g: folds
URYNc7fPA23K2UfadQbnCA: folds
*** FLOP *** [5h Td Jd]
v4ctePcLlQw0r8E0qJtjYw: bets $2.50
QvwRlrpVqerRRF8eJm6dDw: folds
v4ctePcLlQw0r8E0qJtjYw collected $3.60 from pot
v4ctePcLlQw0r8E0qJtjYw: doesn't show hand
*** SUMMARY ***
Total pot $3.75 | Rake $0.15
Board [5h Td Jd]
Seat 1: URYNc7fPA23K2UfadQbnCA (big blind) folded before Flop
Seat 2: f89uTQr3ieGlusj2IAYAEg folded before Flop (didn't bet)
Seat 3: v4ctePcLlQw0r8E0qJtjYw collected ($3.60)
Seat 4: g6lz8npaeeTJmJegtPYhlQ folded before Flop (didn't bet)
Seat 5: QvwRlrpVqerRRF8eJm6dDw (button) folded on the Flop
Seat 6: 7+uQ0OOgCTbR4ltkSwyC0g (small blind) folded before Flop



PokerStars Game #59941301028:  Hold'em No Limit ($0.25/$0.50) - 2009/07/01 1:31:27 ET
Table 'hWT2kq66tnKEpD26cia6fQ' 2-max Seat #2 is the button
Seat 1: Ce3KNFP+ao7Da9NHb65raw ($52.55 in chips)
Seat 2: 16tvT7AYgZ2LgiGFcvFKQg ($23.35 in chips)
16tvT7AYgZ2LgiGFcvFKQg: posts small blind $0.25
Ce3KNFP+ao7Da9NHb65raw: posts big blind $0.50
*** HOLE CARDS ***
16tvT7AYgZ2LgiGFcvFKQg: raises $0.50 to $1
Ce3KNFP+ao7Da9NHb65raw: calls $0.50
*** FLOP *** [5h Kd 3s]
Ce3KNFP+ao7Da9NHb65raw: checks
16tvT7AYgZ2LgiGFcvFKQg: checks
*** TURN *** [5h Kd 3s] [Jd]
Ce3KNFP+ao7Da9NHb65raw: checks
16tvT7AYgZ2LgiGFcvFKQg: checks
*** RIVER *** [5h Kd 3s Jd] [5c]
Ce3KNFP+ao7Da9NHb65raw: checks
16tvT7AYgZ2LgiGFcvFKQg: bets $3
Ce3KNFP+ao7Da9NHb65raw: folds
16tvT7AYgZ2LgiGFcvFKQg collected $1.90 from pot
*** SUMMARY ***
Total pot $2 | Rake $0.10
Board [5h Kd 3s Jd 5c]
Seat 1: Ce3KNFP+ao7Da9NHb65raw (big blind) folded on the River
Seat 2: 16tvT7AYgZ2LgiGFcvFKQg (button) (small blind) collected ($1.90)



PokerStars Game #59941301036:  Hold'em No Limit ($0.25/$0.50) - 2009/07/01 1:31:27 ET
Table 'B+sqsfj6d6zXicNfaseTaw' 2-max Seat #2 is the button
Seat 1: +4GNcSsecmapVGSdV0mUPA ($130.15 in chips)
Seat 2: Lv5RmpRe6LtPkBzM9Gpo5A ($94.30 in chips)
Lv5RmpRe6LtPkBzM9Gpo5A: posts small blind $0.25
+4GNcSsecmapVGSdV0mUPA: posts big blind $0.50
*** HOLE CARDS ***
Lv5RmpRe6LtPkBzM9Gpo5A: raises $1.50 to $2
+4GNcSsecmapVGSdV0mUPA: calls $1.50
*** FLOP *** [6c Qs 3h]
+4GNcSsecmapVGSdV0mUPA: checks
Lv5RmpRe6LtPkBzM9Gpo5A: checks
*** TURN *** [6c Qs 3h] [2s]
+4GNcSsecmapVGSdV0mUPA: bets $4
Lv5RmpRe6LtPkBzM9Gpo5A: folds
+4GNcSsecmapVGSdV0mUPA collected $3.80 from pot
+4GNcSsecmapVGSdV0mUPA: doesn't show hand
*** SUMMARY ***
Total pot $4 | Rake $0.20
Board [6c Qs 3h 2s]
Seat 1: +4GNcSsecmapVGSdV0mUPA (big blind) collected ($3.80)
Seat 2: Lv5RmpRe6LtPkBzM9Gpo5A (button) (small blind) folded on the Turn



PokerStars Game #59941303430:  Hold'em No Limit ($0.25/$0.50) - 2009/07/01 1:31:31 ET
Table '2lPOwetm4cfkZPbTmGPH/w' 2-max Seat #1 is the button
Seat 1: vUGdApqS8J/GJE2gaVWl1w ($24.20 in chips)
Seat 2: XFa6sBGjP2gxoIvxR3fZIg ($17 in chips)
vUGdApqS8J/GJE2gaVWl1w: posts small blind $0.25
XFa6sBGjP2gxoIvxR3fZIg: posts big blind $0.50
*** HOLE CARDS ***
vUGdApqS8J/GJE2gaVWl1w: raises $0.50 to $1
XFa6sBGjP2gxoIvxR3fZIg: calls $0.50
*** FLOP *** [5h 9d 7d]
XFa6sBGjP2gxoIvxR3fZIg: checks
vUGdApqS8J/GJE2gaVWl1w: bets $1.50
XFa6sBGjP2gxoIvxR3fZIg: folds
vUGdApqS8J/GJE2gaVWl1w collected $1.90 from pot
*** SUMMARY ***
Total pot $2 | Rake $0.10
Board [5h 9d 7d]
Seat 1: vUGdApqS8J/GJE2gaVWl1w (button) (small blind) collected ($1.90)
Seat 2: XFa6sBGjP2gxoIvxR3fZIg (big blind) folded on the Flop



PokerStars Game #59941305004:  Hold'em No Limit ($0.25/$0.50) - 2009/07/01 1:31:34 ET
Table '8BQGgNetI1NOvWeu3gtMNw' 2-max Seat #2 is the button
Seat 1: bypIyrYcAAifLfhZpGlKLA ($64.65 in chips)
Seat 2: Z4HwehErEwzsv/noQlfUlg ($152.10 in chips)
Z4HwehErEwzsv/noQlfUlg: posts small blind $0.25
bypIyrYcAAifLfhZpGlKLA: posts big blind $0.50
*** HOLE CARDS ***
Z4HwehErEwzsv/noQlfUlg: raises $2.50 to $3
bypIyrYcAAifLfhZpGlKLA: calls $2.50
*** FLOP *** [6s Jd Qs]
bypIyrYcAAifLfhZpGlKLA: checks
Z4HwehErEwzsv/noQlfUlg: bets $3
bypIyrYcAAifLfhZpGlKLA: calls $3
*** TURN *** [6s Jd Qs] [Td]
bypIyrYcAAifLfhZpGlKLA: checks
Z4HwehErEwzsv/noQlfUlg: checks
*** RIVER *** [6s Jd Qs Td] [9h]
bypIyrYcAAifLfhZpGlKLA: checks
Z4HwehErEwzsv/noQlfUlg: bets $12
bypIyrYcAAifLfhZpGlKLA: calls $12
*** SHOW DOWN ***
Z4HwehErEwzsv/noQlfUlg: shows [As 5d] (high card Ace)
bypIyrYcAAifLfhZpGlKLA: shows [8h Jh] (a straight, Eight to Queen)
bypIyrYcAAifLfhZpGlKLA collected $35.50 from pot
*** SUMMARY ***
Total pot $36 | Rake $0.50
Board [6s Jd Qs Td 9h]
Seat 1: bypIyrYcAAifLfhZpGlKLA (big blind) showed [8h Jh] and won ($35.50) with a straight, Eight to Queen
Seat 2: Z4HwehErEwzsv/noQlfUlg (button) (small blind) showed [As 5d] and lost with high card Ace



PokerStars Game #59941308662:  Hold'em No Limit ($0.25/$0.50) - 2009/07/01 1:31:40 ET
Table 'ibNfFy0bCzuBaUORla0aGw' 9-max Seat #6 is the button
Seat 1: xZCXQSXlrZkp3pZizzVXCw ($50 in chips)
Seat 2: 90Wb75h3W1BRpbqVnuk8gw ($50 in chips)
Seat 3: AjV5McH1KMMclY26QdLM5w ($25 in chips)
Seat 4: nhDtFZ2uuvm5hDKG7ZVEpA ($49.25 in chips)
Seat 5: GIJAc9kPrLZHLSX8Q6i99w ($36.25 in chips)
Seat 6: H8cPaCtX7d6meGUVSM5sxw ($56.60 in chips)
Seat 7: HZkVla4kK2SI42CVrPZ/ig ($17.20 in chips)
Seat 8: Ja2jdidjip2UeJnRzmzAAQ ($47 in chips)
Seat 9: pFtzb1sR4b0d1aw6aIRgDg ($56.15 in chips)
HZkVla4kK2SI42CVrPZ/ig: posts small blind $0.25
Ja2jdidjip2UeJnRzmzAAQ: posts big blind $0.50
*** HOLE CARDS ***
pFtzb1sR4b0d1aw6aIRgDg: folds
xZCXQSXlrZkp3pZizzVXCw: raises $1 to $1.50
90Wb75h3W1BRpbqVnuk8gw: folds
AjV5McH1KMMclY26QdLM5w: raises $2.50 to $4
nhDtFZ2uuvm5hDKG7ZVEpA: folds
GIJAc9kPrLZHLSX8Q6i99w: folds
H8cPaCtX7d6meGUVSM5sxw: folds
HZkVla4kK2SI42CVrPZ/ig: folds
Ja2jdidjip2UeJnRzmzAAQ: folds
xZCXQSXlrZkp3pZizzVXCw: folds
AjV5McH1KMMclY26QdLM5w collected $3.75 from pot
*** SUMMARY ***
Total pot $3.75 | Rake $0
Seat 1: xZCXQSXlrZkp3pZizzVXCw folded before Flop
Seat 2: 90Wb75h3W1BRpbqVnuk8gw folded before Flop (didn't bet)
Seat 3: AjV5McH1KMMclY26QdLM5w collected ($3.75)
Seat 4: nhDtFZ2uuvm5hDKG7ZVEpA folded before Flop (didn't bet)
Seat 5: GIJAc9kPrLZHLSX8Q6i99w folded before Flop (didn't bet)
Seat 6: H8cPaCtX7d6meGUVSM5sxw (button) folded before Flop (didn't bet)
Seat 7: HZkVla4kK2SI42CVrPZ/ig (small blind) folded before Flop
Seat 8: Ja2jdidjip2UeJnRzmzAAQ (big blind) folded before Flop
Seat 9: pFtzb1sR4b0d1aw6aIRgDg folded before Flop (didn't bet)



PokerStars Game #59941311240:  Hold'em No Limit ($0.25/$0.50) - 2009/07/01 1:31:45 ET
Table '2lPOwetm4cfkZPbTmGPH/w' 2-max Seat #2 is the button
Seat 1: vUGdApqS8J/GJE2gaVWl1w ($25.10 in chips)
Seat 2: XFa6sBGjP2gxoIvxR3fZIg ($16 in chips)
XFa6sBGjP2gxoIvxR3fZIg: posts small blind $0.25
vUGdApqS8J/GJE2gaVWl1w: posts big blind $0.50
*** HOLE CARDS ***
XFa6sBGjP2gxoIvxR3fZIg: raises $1 to $1.50
vUGdApqS8J/GJE2gaVWl1w: calls $1
*** FLOP *** [3c Kc Ac]
vUGdApqS8J/GJE2gaVWl1w: bets $0.50
XFa6sBGjP2gxoIvxR3fZIg: calls $0.50
*** TURN *** [3c Kc Ac] [8d]
vUGdApqS8J/GJE2gaVWl1w: bets $1
XFa6sBGjP2gxoIvxR3fZIg: calls $1
*** RIVER *** [3c Kc Ac 8d] [6d]
vUGdApqS8J/GJE2gaVWl1w: bets $1
XFa6sBGjP2gxoIvxR3fZIg: calls $1
*** SHOW DOWN ***
vUGdApqS8J/GJE2gaVWl1w: shows [Jd 6h] (a pair of Sixes)
XFa6sBGjP2gxoIvxR3fZIg: shows [Qh Qd] (a pair of Queens)
XFa6sBGjP2gxoIvxR3fZIg collected $7.65 from pot
*** SUMMARY ***
Total pot $8 | Rake $0.35
Board [3c Kc Ac 8d 6d]
Seat 1: vUGdApqS8J/GJE2gaVWl1w (big blind) showed [Jd 6h] and lost with a pair of Sixes
Seat 2: XFa6sBGjP2gxoIvxR3fZIg (button) (small blind) showed [Qh Qd] and won ($7.65) with a pair of Queens



PokerStars Game #59941311492:  Hold'em No Limit ($0.25/$0.50) - 2009/07/01 1:31:45 ET
Table 'iq+aXfWVQRdV0u8SRTYUEg' 9-max Seat #7 is the button
Seat 1: 3yl8Q6QaLfGtyhN4/pEFgQ ($78.05 in chips)
Seat 2: J9N0lxHFd/Js2S0xZLbsIQ ($21.60 in chips)
Seat 3: Qi/PyOsKwaqtKIg0H+7ELg ($9.75 in chips)
Seat 4: vHYT5s323LpajBj+2c9zbQ ($32.10 in chips)
Seat 5: 997ViqAtWn1FPjJqcffwcA ($57.55 in chips)
Seat 7: SKnJuWHScqetA/qG5p+wCg ($30.80 in chips)
Seat 8: /DtIHuxEH+3tzKefmSV+Mw ($36.35 in chips)
Seat 9: olE1Z2rKWAV8+tGqmIBK9g ($26.95 in chips)
/DtIHuxEH+3tzKefmSV+Mw: posts small blind $0.25
olE1Z2rKWAV8+tGqmIBK9g: posts big blind $0.50
*** HOLE CARDS ***
3yl8Q6QaLfGtyhN4/pEFgQ: folds
J9N0lxHFd/Js2S0xZLbsIQ: folds
Qi/PyOsKwaqtKIg0H+7ELg: calls $0.50
vHYT5s323LpajBj+2c9zbQ: folds
997ViqAtWn1FPjJqcffwcA: folds
SKnJuWHScqetA/qG5p+wCg: folds
/DtIHuxEH+3tzKefmSV+Mw: folds
olE1Z2rKWAV8+tGqmIBK9g: checks
*** FLOP *** [Qs 9c Ac]
olE1Z2rKWAV8+tGqmIBK9g: checks
Qi/PyOsKwaqtKIg0H+7ELg: bets $1
olE1Z2rKWAV8+tGqmIBK9g: folds
Qi/PyOsKwaqtKIg0H+7ELg collected $1.20 from pot
Qi/PyOsKwaqtKIg0H+7ELg: doesn't show hand
*** SUMMARY ***
Total pot $1.25 | Rake $0.05
Board [Qs 9c Ac]
Seat 1: 3yl8Q6QaLfGtyhN4/pEFgQ folded before Flop (didn't bet)
Seat 2: J9N0lxHFd/Js2S0xZLbsIQ folded before Flop (didn't bet)
Seat 3: Qi/PyOsKwaqtKIg0H+7ELg collected ($1.20)
Seat 4: vHYT5s323LpajBj+2c9zbQ folded before Flop (didn't bet)
Seat 5: 997ViqAtWn1FPjJqcffwcA folded before Flop (didn't bet)
Seat 7: SKnJuWHScqetA/qG5p+wCg (button) folded before Flop (didn't bet)
Seat 8: /DtIHuxEH+3tzKefmSV+Mw (small blind) folded before Flop
Seat 9: olE1Z2rKWAV8+tGqmIBK9g (big blind) folded on the Flop



PokerStars Game #59941311806:  Hold'em No Limit ($0.25/$0.50) - 2009/07/01 1:31:46 ET
Table '+dXkOAQyS8j9PQZusUTMpg' 2-max Seat #2 is the button
Seat 1: Teld4PDKla7C8/Wfu2DSkg ($53.70 in chips)
Seat 2: +zI4bP23YIjMkUHqeN2xfw ($22.65 in chips)
+zI4bP23YIjMkUHqeN2xfw: posts small blind $0.25
Teld4PDKla7C8/Wfu2DSkg: posts big blind $0.50
*** HOLE CARDS ***
+zI4bP23YIjMkUHqeN2xfw: raises $1 to $1.50
Teld4PDKla7C8/Wfu2DSkg: folds
+zI4bP23YIjMkUHqeN2xfw collected $1 from pot
*** SUMMARY ***
Total pot $1 | Rake $0
Seat 1: Teld4PDKla7C8/Wfu2DSkg (big blind) folded before Flop
Seat 2: +zI4bP23YIjMkUHqeN2xfw (button) (small blind) collected ($1)



PokerStars Game #59941313382:  Hold'em No Limit ($0.25/$0.50) - 2009/07/01 1:31:49 ET
Table 'hWT2kq66tnKEpD26cia6fQ' 2-max Seat #1 is the button
Seat 1: Ce3KNFP+ao7Da9NHb65raw ($51.55 in chips)
Seat 2: 16tvT7AYgZ2LgiGFcvFKQg ($24.25 in chips)
Ce3KNFP+ao7Da9NHb65raw: posts small blind $0.25
16tvT7AYgZ2LgiGFcvFKQg: posts big blind $0.50
*** HOLE CARDS ***
Ce3KNFP+ao7Da9NHb65raw: folds
16tvT7AYgZ2LgiGFcvFKQg collected $0.50 from pot
*** SUMMARY ***
Total pot $0.50 | Rake $0
Seat 1: Ce3KNFP+ao7Da9NHb65raw (button) (small blind) folded before Flop
Seat 2: 16tvT7AYgZ2LgiGFcvFKQg (big blind) collected ($0.50)



PokerStars Game #59941313360:  Hold'em No Limit ($0.25/$0.50) - 2009/07/01 1:31:49 ET
Table 'B+sqsfj6d6zXicNfaseTaw' 2-max Seat #1 is the button
Seat 1: +4GNcSsecmapVGSdV0mUPA ($131.95 in chips)
Seat 2: Lv5RmpRe6LtPkBzM9Gpo5A ($92.30 in chips)
+4GNcSsecmapVGSdV0mUPA: posts small blind $0.25
Lv5RmpRe6LtPkBzM9Gpo5A: posts big blind $0.50
*** HOLE CARDS ***
+4GNcSsecmapVGSdV0mUPA: calls $0.25
Lv5RmpRe6LtPkBzM9Gpo5A: checks
*** FLOP *** [2s 4s 9d]
Lv5RmpRe6LtPkBzM9Gpo5A: checks
+4GNcSsecmapVGSdV0mUPA: bets $1
Lv5RmpRe6LtPkBzM9Gpo5A: folds
+4GNcSsecmapVGSdV0mUPA collected $0.95 from pot
+4GNcSsecmapVGSdV0mUPA: doesn't show hand
*** SUMMARY ***
Total pot $1 | Rake $0.05
Board [2s 4s 9d]
Seat 1: +4GNcSsecmapVGSdV0mUPA (button) (small blind) collected ($0.95)
Seat 2: Lv5RmpRe6LtPkBzM9Gpo5A (big blind) folded on the Flop



PokerStars Game #59941313760:  Hold'em No Limit ($0.25/$0.50) - 2009/07/01 1:31:50 ET
Table 'BCN5su+SsXiy1zRMJi0SJw' 6-max Seat #1 is the button
Seat 1: GxXV09ciXaOxyY2H5aMIIw ($32.05 in chips)
Seat 2: ehFNAevCQri3trWxV6FJdA ($57.90 in chips)
Seat 3: kwgv5lNhiFrfONXCshzxlA ($42.60 in chips)
Seat 4: bbsK8j+tpuVRhBqDzHxf7w ($50.60 in chips)
Seat 5: kxPhs4ePFqMy52CInAJ2aw ($53.05 in chips)
Seat 6: b2symlOdL7+0c9Pj4N/KlA ($68.45 in chips)
ehFNAevCQri3trWxV6FJdA: posts small blind $0.25
kwgv5lNhiFrfONXCshzxlA: posts big blind $0.50
*** HOLE CARDS ***
bbsK8j+tpuVRhBqDzHxf7w: folds
kxPhs4ePFqMy52CInAJ2aw: folds
b2symlOdL7+0c9Pj4N/KlA: folds
GxXV09ciXaOxyY2H5aMIIw: folds
ehFNAevCQri3trWxV6FJdA: calls $0.25
kwgv5lNhiFrfONXCshzxlA: checks
*** FLOP *** [4s 4d Kh]
ehFNAevCQri3trWxV6FJdA: checks
kwgv5lNhiFrfONXCshzxlA: bets $0.50
ehFNAevCQri3trWxV6FJdA: calls $0.50
*** TURN *** [4s 4d Kh] [5h]
ehFNAevCQri3trWxV6FJdA: checks
kwgv5lNhiFrfONXCshzxlA: checks
*** RIVER *** [4s 4d Kh 5h] [Td]
ehFNAevCQri3trWxV6FJdA: checks
kwgv5lNhiFrfONXCshzxlA: checks
*** SHOW DOWN ***
ehFNAevCQri3trWxV6FJdA: shows [8d 6d] (a pair of Fours)
kwgv5lNhiFrfONXCshzxlA: shows [8s 7c] (a pair of Fours)
ehFNAevCQri3trWxV6FJdA collected $1 from pot
kwgv5lNhiFrfONXCshzxlA collected $0.95 from pot
*** SUMMARY ***
Total pot $2 | Rake $0.05
Board [4s 4d Kh 5h Td]
Seat 1: GxXV09ciXaOxyY2H5aMIIw (button) folded before Flop (didn't bet)
Seat 2: ehFNAevCQri3trWxV6FJdA (small blind) showed [8d 6d] and won ($1) with a pair of Fours
Seat 3: kwgv5lNhiFrfONXCshzxlA (big blind) showed [8s 7c] and won ($0.95) with a pair of Fours
Seat 4: bbsK8j+tpuVRhBqDzHxf7w folded before Flop (didn't bet)
Seat 5: kxPhs4ePFqMy52CInAJ2aw folded before Flop (didn't bet)
Seat 6: b2symlOdL7+0c9Pj4N/KlA folded before Flop (didn't bet)



PokerStars Game #59941313804:  Hold'em No Limit ($0.25/$0.50) - 2009/07/01 1:31:50 ET
Table 'fx6MqwfYAj/Rt86hBz2L3Q' 9-max Seat #9 is the button
Seat 1: v/4aX0ejnaIFK4ftDk2Lyg ($50.90 in chips)
Seat 2: C3rGXblctNcWI6JYPHhaEg ($29.40 in chips)
Seat 3: iadBi5AEt7gTBXbDSSnMYQ ($37.80 in chips)
Seat 4: VhjwWfxHSx00WxzYih3KOA ($50 in chips)
Seat 5: iAISe3dVeua8PUn2wwgDHw ($77.30 in chips)
Seat 6: 5k9fvXD9suIgCxU4HLQjTw ($50 in chips)
Seat 7: mSD1pginDsyHG5PDfqzphw ($10 in chips)
Seat 8: JYwJYYV9pM5KWdSiETl8rA ($62.25 in chips)
Seat 9: vO3QVRovWemcGMkm7ijAIA ($24.95 in chips)
v/4aX0ejnaIFK4ftDk2Lyg: posts small blind $0.25
C3rGXblctNcWI6JYPHhaEg: posts big blind $0.50
*** HOLE CARDS ***
iadBi5AEt7gTBXbDSSnMYQ: folds
VhjwWfxHSx00WxzYih3KOA: folds
iAISe3dVeua8PUn2wwgDHw: folds
5k9fvXD9suIgCxU4HLQjTw: folds
mSD1pginDsyHG5PDfqzphw: folds
JYwJYYV9pM5KWdSiETl8rA: raises $1 to $1.50
vO3QVRovWemcGMkm7ijAIA: folds
v/4aX0ejnaIFK4ftDk2Lyg: folds
C3rGXblctNcWI6JYPHhaEg: calls $1
*** FLOP *** [Td 5c 2s]
C3rGXblctNcWI6JYPHhaEg: checks
JYwJYYV9pM5KWdSiETl8rA: bets $2.50
C3rGXblctNcWI6JYPHhaEg: calls $2.50
*** TURN *** [Td 5c 2s] [2c]
C3rGXblctNcWI6JYPHhaEg: checks
JYwJYYV9pM5KWdSiETl8rA: bets $5.50
C3rGXblctNcWI6JYPHhaEg: raises $5.50 to $11
JYwJYYV9pM5KWdSiETl8rA: calls $5.50
*** RIVER *** [Td 5c 2s 2c] [6s]
C3rGXblctNcWI6JYPHhaEg: bets $14.40 and is all-in
JYwJYYV9pM5KWdSiETl8rA: calls $14.40
*** SHOW DOWN ***
C3rGXblctNcWI6JYPHhaEg: shows [Tc 2d] (a full house, Deuces full of Tens)
JYwJYYV9pM5KWdSiETl8rA: mucks hand
C3rGXblctNcWI6JYPHhaEg collected $56.20 from pot
*** SUMMARY ***
Total pot $59.05 | Rake $2.85
Board [Td 5c 2s 2c 6s]
Seat 1: v/4aX0ejnaIFK4ftDk2Lyg (small blind) folded before Flop
Seat 2: C3rGXblctNcWI6JYPHhaEg (big blind) showed [Tc 2d] and won ($56.20) with a full house, Deuces full of Tens
Seat 3: iadBi5AEt7gTBXbDSSnMYQ folded before Flop (didn't bet)
Seat 4: VhjwWfxHSx00WxzYih3KOA folded before Flop (didn't bet)
Seat 5: iAISe3dVeua8PUn2wwgDHw folded before Flop (didn't bet)
Seat 6: 5k9fvXD9suIgCxU4HLQjTw folded before Flop (didn't bet)
Seat 7: mSD1pginDsyHG5PDfqzphw folded before Flop (didn't bet)
Seat 8: JYwJYYV9pM5KWdSiETl8rA mucked
Seat 9: vO3QVRovWemcGMkm7ijAIA (button) folded before Flop (didn't bet)



PokerStars Game #59941315386:  Hold'em No Limit ($0.25/$0.50) - 2009/07/01 1:31:52 ET
Table '+dXkOAQyS8j9PQZusUTMpg' 2-max Seat #1 is the button
Seat 1: Teld4PDKla7C8/Wfu2DSkg ($53.20 in chips)
Seat 2: +zI4bP23YIjMkUHqeN2xfw ($23.15 in chips)
Teld4PDKla7C8/Wfu2DSkg: posts small blind $0.25
+zI4bP23YIjMkUHqeN2xfw: posts big blind $0.50
*** HOLE CARDS ***
Teld4PDKla7C8/Wfu2DSkg: folds
+zI4bP23YIjMkUHqeN2xfw collected $0.50 from pot
*** SUMMARY ***
Total pot $0.50 | Rake $0
Seat 1: Teld4PDKla7C8/Wfu2DSkg (button) (small blind) folded before Flop
Seat 2: +zI4bP23YIjMkUHqeN2xfw (big blind) collected ($0.50)



PokerStars Game #59941317026:  Hold'em No Limit ($0.25/$0.50) - 2009/07/01 1:31:55 ET
Table 'hWT2kq66tnKEpD26cia6fQ' 2-max Seat #2 is the button
Seat 1: Ce3KNFP+ao7Da9NHb65raw ($51.30 in chips)
Seat 2: 16tvT7AYgZ2LgiGFcvFKQg ($24.50 in chips)
16tvT7AYgZ2LgiGFcvFKQg: posts small blind $0.25
Ce3KNFP+ao7Da9NHb65raw: posts big blind $0.50
*** HOLE CARDS ***
16tvT7AYgZ2LgiGFcvFKQg: calls $0.25
Ce3KNFP+ao7Da9NHb65raw: checks
*** FLOP *** [2s 4d 3d]
Ce3KNFP+ao7Da9NHb65raw: checks
16tvT7AYgZ2LgiGFcvFKQg: bets $0.50
Ce3KNFP+ao7Da9NHb65raw: calls $0.50
*** TURN *** [2s 4d 3d] [6h]
Ce3KNFP+ao7Da9NHb65raw: checks
16tvT7AYgZ2LgiGFcvFKQg: checks
*** RIVER *** [2s 4d 3d 6h] [7d]
Ce3KNFP+ao7Da9NHb65raw: bets $0.50
16tvT7AYgZ2LgiGFcvFKQg: calls $0.50
*** SHOW DOWN ***
Ce3KNFP+ao7Da9NHb65raw: shows [Kd 6c] (a pair of Sixes)
16tvT7AYgZ2LgiGFcvFKQg: shows [7s 4s] (two pair, Sevens and Fours)
16tvT7AYgZ2LgiGFcvFKQg collected $2.90 from pot
*** SUMMARY ***
Total pot $3 | Rake $0.10
Board [2s 4d 3d 6h 7d]
Seat 1: Ce3KNFP+ao7Da9NHb65raw (big blind) showed [Kd 6c] and lost with a pair of Sixes
Seat 2: 16tvT7AYgZ2LgiGFcvFKQg (button) (small blind) showed [7s 4s] and won ($2.90) with two pair, Sevens and Fours



PokerStars Game #59941316820:  Hold'em No Limit ($0.25/$0.50) - 2009/07/01 1:31:55 ET
Table 'GfL/No5u5PoEnU39lP5pQg' 6-max Seat #1 is the button
Seat 1: 1WUCqNG+p+vfWRTXNu4ljw ($62.20 in chips)
Seat 2: uVwggSetzp7d+eVgowO3vg ($47.25 in chips)
Seat 3: 4pp9WxhGdbVbxCc9tlu0lw ($26.05 in chips)
Seat 4: r6u7MWSXF30/khcTYkrG9Q ($30.10 in chips)
Seat 5: M1KyQQvVPVuxqTAB8sR/zQ ($62.65 in chips)
Seat 6: kxPhs4ePFqMy52CInAJ2aw ($63 in chips)
uVwggSetzp7d+eVgowO3vg: posts small blind $0.25
4pp9WxhGdbVbxCc9tlu0lw: posts big blind $0.50
*** HOLE CARDS ***
r6u7MWSXF30/khcTYkrG9Q: folds
M1KyQQvVPVuxqTAB8sR/zQ: folds
kxPhs4ePFqMy52CInAJ2aw: raises $1.50 to $2
1WUCqNG+p+vfWRTXNu4ljw: calls $2
uVwggSetzp7d+eVgowO3vg: folds
4pp9WxhGdbVbxCc9tlu0lw: folds
*** FLOP *** [3d 6c Jc]
kxPhs4ePFqMy52CInAJ2aw: bets $3.40
1WUCqNG+p+vfWRTXNu4ljw: raises $8.60 to $12
kxPhs4ePFqMy52CInAJ2aw: raises $49 to $61 and is all-in
1WUCqNG+p+vfWRTXNu4ljw: calls $48.20 and is all-in
*** TURN *** [3d 6c Jc] [8c]
*** RIVER *** [3d 6c Jc 8c] [Qc]
*** SHOW DOWN ***
kxPhs4ePFqMy52CInAJ2aw: shows [Kc Kh] (a flush, King high)
1WUCqNG+p+vfWRTXNu4ljw: mucks hand
kxPhs4ePFqMy52CInAJ2aw collected $122.15 from pot
*** SUMMARY ***
Total pot $125.15 | Rake $3
Board [3d 6c Jc 8c Qc]
Seat 1: 1WUCqNG+p+vfWRTXNu4ljw (button) mucked
Seat 2: uVwggSetzp7d+eVgowO3vg (small blind) folded before Flop
Seat 3: 4pp9WxhGdbVbxCc9tlu0lw (big blind) folded before Flop
Seat 4: r6u7MWSXF30/khcTYkrG9Q folded before Flop (didn't bet)
Seat 5: M1KyQQvVPVuxqTAB8sR/zQ folded before Flop (didn't bet)
Seat 6: kxPhs4ePFqMy52CInAJ2aw showed [Kc Kh] and won ($122.15) with a flush, King high



PokerStars Game #59941316892:  Hold'em No Limit ($0.25/$0.50) - 2009/07/01 1:31:55 ET
Table 'lSisgp6H7Fg1hH5VfjEjYQ' 9-max Seat #1 is the button
Seat 1: 5k9fvXD9suIgCxU4HLQjTw ($54.05 in chips)
Seat 2: 5acK4E7fzEwnplVBZ6eNWA ($50 in chips)
Seat 3: SKnJuWHScqetA/qG5p+wCg ($30 in chips)
Seat 5: mSD1pginDsyHG5PDfqzphw ($12.25 in chips)
Seat 6: +k7T5ocke8UwavtgUHm+Cg ($72.20 in chips)
Seat 7: IDtNLR9uFCDdjNsJWMHA5Q ($21.05 in chips)
Seat 8: a4JDWmpFQkL10XfAyuF51A ($9.50 in chips)
Seat 9: YzeKFbJVLmJGTgNH3ySQlw ($8.95 in chips)
5acK4E7fzEwnplVBZ6eNWA: posts small blind $0.25
SKnJuWHScqetA/qG5p+wCg: posts big blind $0.50
*** HOLE CARDS ***
mSD1pginDsyHG5PDfqzphw: folds
+k7T5ocke8UwavtgUHm+Cg: raises $1 to $1.50
IDtNLR9uFCDdjNsJWMHA5Q: folds
a4JDWmpFQkL10XfAyuF51A: folds
YzeKFbJVLmJGTgNH3ySQlw: calls $1.50
5k9fvXD9suIgCxU4HLQjTw: folds
5acK4E7fzEwnplVBZ6eNWA: folds
SKnJuWHScqetA/qG5p+wCg: folds
*** FLOP *** [8d Qd 6h]
+k7T5ocke8UwavtgUHm+Cg: bets $1
YzeKFbJVLmJGTgNH3ySQlw: calls $1
*** TURN *** [8d Qd 6h] [5s]
bwv/rbH/hHhPhY6u9mu04w leaves the table
+k7T5ocke8UwavtgUHm+Cg: checks
YzeKFbJVLmJGTgNH3ySQlw: checks
*** RIVER *** [8d Qd 6h 5s] [7h]
+k7T5ocke8UwavtgUHm+Cg: bets $3
YzeKFbJVLmJGTgNH3ySQlw: folds
+k7T5ocke8UwavtgUHm+Cg collected $5.50 from pot
+k7T5ocke8UwavtgUHm+Cg: doesn't show hand
*** SUMMARY ***
Total pot $5.75 | Rake $0.25
Board [8d Qd 6h 5s 7h]
Seat 1: 5k9fvXD9suIgCxU4HLQjTw (button) folded before Flop (didn't bet)
Seat 2: 5acK4E7fzEwnplVBZ6eNWA (small blind) folded before Flop
Seat 3: SKnJuWHScqetA/qG5p+wCg (big blind) folded before Flop
Seat 5: mSD1pginDsyHG5PDfqzphw folded before Flop (didn't bet)
Seat 6: +k7T5ocke8UwavtgUHm+Cg collected ($5.50)
Seat 7: IDtNLR9uFCDdjNsJWMHA5Q folded before Flop (didn't bet)
Seat 8: a4JDWmpFQkL10XfAyuF51A folded before Flop (didn't bet)
Seat 9: YzeKFbJVLmJGTgNH3ySQlw folded on the River



PokerStars Game #59941319986:  Hold'em No Limit ($0.25/$0.50) - 2009/07/01 1:32:00 ET
Table '3FhG0gl3kMX3wBEEqj+wnQ' 9-max Seat #6 is the button
Seat 1: bxLSulbgr8LmKNjOzw8URg ($49.30 in chips)
Seat 2: vacmVLJJECYI6HjAynFcpg ($49.85 in chips)
Seat 3: YXCE3WOZi8g2sIf3y/plVw ($62.30 in chips)
Seat 4: e2+sK/yjnj94rXOKoxPP2A ($69.50 in chips)
Seat 5: XcLXSUMHSpshK/7Lh0M4Vg ($8.50 in chips)
Seat 6: 997ViqAtWn1FPjJqcffwcA ($109.80 in chips)
Seat 7: mSD1pginDsyHG5PDfqzphw ($12 in chips)
Seat 8: j3K/Jujr7PY4ZM2RZvlH6A ($44.10 in chips)
mSD1pginDsyHG5PDfqzphw: posts small blind $0.25
j3K/Jujr7PY4ZM2RZvlH6A: posts big blind $0.50
*** HOLE CARDS ***
bxLSulbgr8LmKNjOzw8URg: folds
vacmVLJJECYI6HjAynFcpg: folds
YXCE3WOZi8g2sIf3y/plVw: folds
e2+sK/yjnj94rXOKoxPP2A: folds
XcLXSUMHSpshK/7Lh0M4Vg: folds
997ViqAtWn1FPjJqcffwcA: folds
mSD1pginDsyHG5PDfqzphw: calls $0.25
j3K/Jujr7PY4ZM2RZvlH6A: raises $2 to $2.50
mSD1pginDsyHG5PDfqzphw: raises $9.50 to $12 and is all-in
j3K/Jujr7PY4ZM2RZvlH6A: calls $9.50
*** FLOP *** [4s 7c As]
*** TURN *** [4s 7c As] [Ts]
*** RIVER *** [4s 7c As Ts] [9d]
*** SHOW DOWN ***
mSD1pginDsyHG5PDfqzphw: shows [6c 6s] (a pair of Sixes)
j3K/Jujr7PY4ZM2RZvlH6A: shows [Td Kc] (a pair of Tens)
j3K/Jujr7PY4ZM2RZvlH6A collected $22.80 from pot
*** SUMMARY ***
Total pot $24 | Rake $1.20
Board [4s 7c As Ts 9d]
Seat 1: bxLSulbgr8LmKNjOzw8URg folded before Flop (didn't bet)
Seat 2: vacmVLJJECYI6HjAynFcpg folded before Flop (didn't bet)
Seat 3: YXCE3WOZi8g2sIf3y/plVw folded before Flop (didn't bet)
Seat 4: e2+sK/yjnj94rXOKoxPP2A folded before Flop (didn't bet)
Seat 5: XcLXSUMHSpshK/7Lh0M4Vg folded before Flop (didn't bet)
Seat 6: 997ViqAtWn1FPjJqcffwcA (button) folded before Flop (didn't bet)
Seat 7: mSD1pginDsyHG5PDfqzphw (small blind) showed [6c 6s] and lost with a pair of Sixes
Seat 8: j3K/Jujr7PY4ZM2RZvlH6A (big blind) showed [Td Kc] and won ($22.80) with a pair of Tens



PokerStars Game #59941320216:  Hold'em No Limit ($0.25/$0.50) - 2009/07/01 1:32:00 ET
Table '+dXkOAQyS8j9PQZusUTMpg' 2-max Seat #2 is the button
Seat 1: Teld4PDKla7C8/Wfu2DSkg ($52.95 in chips)
Seat 2: +zI4bP23YIjMkUHqeN2xfw ($23.40 in chips)
+zI4bP23YIjMkUHqeN2xfw: posts small blind $0.25
Teld4PDKla7C8/Wfu2DSkg: posts big blind $0.50
*** HOLE CARDS ***
+zI4bP23YIjMkUHqeN2xfw: raises $1 to $1.50
Teld4PDKla7C8/Wfu2DSkg: folds
+zI4bP23YIjMkUHqeN2xfw collected $1 from pot
*** SUMMARY ***
Total pot $1 | Rake $0
Seat 1: Teld4PDKla7C8/Wfu2DSkg (big blind) folded before Flop
Seat 2: +zI4bP23YIjMkUHqeN2xfw (button) (small blind) collected ($1)



PokerStars Game #59941319730:  Hold'em No Limit ($0.25/$0.50) - 2009/07/01 1:32:00 ET
Table '9ojijpRcYQSQTh6xI+haUA' 2-max Seat #1 is the button
Seat 1: FqpibuVWLNsAN/Z7ROZLnA ($29.75 in chips)
Seat 2: TitTV+fFCcBZWOERdytydA ($55.20 in chips)
FqpibuVWLNsAN/Z7ROZLnA: posts small blind $0.25
TitTV+fFCcBZWOERdytydA: posts big blind $0.50
*** HOLE CARDS ***
FqpibuVWLNsAN/Z7ROZLnA: calls $0.25
TitTV+fFCcBZWOERdytydA: raises $2 to $2.50
FqpibuVWLNsAN/Z7ROZLnA: calls $2
*** FLOP *** [Kh 8s Ac]
TitTV+fFCcBZWOERdytydA: checks
FqpibuVWLNsAN/Z7ROZLnA: bets $1
TitTV+fFCcBZWOERdytydA: calls $1
*** TURN *** [Kh 8s Ac] [Ad]
TitTV+fFCcBZWOERdytydA: checks
FqpibuVWLNsAN/Z7ROZLnA: bets $1.50
TitTV+fFCcBZWOERdytydA: calls $1.50
*** RIVER *** [Kh 8s Ac Ad] [4c]
TitTV+fFCcBZWOERdytydA: checks
FqpibuVWLNsAN/Z7ROZLnA: checks
*** SHOW DOWN ***
TitTV+fFCcBZWOERdytydA: shows [Qd Qh] (two pair, Aces and Queens)
FqpibuVWLNsAN/Z7ROZLnA: shows [Kc 3c] (two pair, Aces and Kings)
FqpibuVWLNsAN/Z7ROZLnA collected $9.55 from pot
*** SUMMARY ***
Total pot $10 | Rake $0.45
Board [Kh 8s Ac Ad 4c]
Seat 1: FqpibuVWLNsAN/Z7ROZLnA (button) (small blind) showed [Kc 3c] and won ($9.55) with two pair, Aces and Kings
Seat 2: TitTV+fFCcBZWOERdytydA (big blind) showed [Qd Qh] and lost with two pair, Aces and Queens



PokerStars Game #59941320696:  Hold'em No Limit ($0.25/$0.50) - 2009/07/01 1:32:01 ET
Table '8BQGgNetI1NOvWeu3gtMNw' 2-max Seat #1 is the button
Seat 1: bypIyrYcAAifLfhZpGlKLA ($82.15 in chips)
Seat 2: Z4HwehErEwzsv/noQlfUlg ($134.10 in chips)
bypIyrYcAAifLfhZpGlKLA: posts small blind $0.25
Z4HwehErEwzsv/noQlfUlg: posts big blind $0.50
*** HOLE CARDS ***
bypIyrYcAAifLfhZpGlKLA: raises $1 to $1.50
Z4HwehErEwzsv/noQlfUlg: folds
bypIyrYcAAifLfhZpGlKLA collected $1 from pot
bypIyrYcAAifLfhZpGlKLA: doesn't show hand
*** SUMMARY ***
Total pot $1 | Rake $0
Seat 1: bypIyrYcAAifLfhZpGlKLA (button) (small blind) collected ($1)
Seat 2: Z4HwehErEwzsv/noQlfUlg (big blind) folded before Flop



PokerStars Game #59941320408:  Hold'em No Limit ($0.25/$0.50) - 2009/07/01 1:32:01 ET
Table 'cofQFHU7jbJoFecLVBof/w' 6-max Seat #6 is the button
Seat 1: URYNc7fPA23K2UfadQbnCA ($45.50 in chips)
Seat 2: f89uTQr3ieGlusj2IAYAEg ($50 in chips)
Seat 3: v4ctePcLlQw0r8E0qJtjYw ($49.30 in chips)
Seat 4: g6lz8npaeeTJmJegtPYhlQ ($17.10 in chips)
Seat 5: QvwRlrpVqerRRF8eJm6dDw ($48.65 in chips)
Seat 6: 7+uQ0OOgCTbR4ltkSwyC0g ($160.30 in chips)
URYNc7fPA23K2UfadQbnCA: posts small blind $0.25
f89uTQr3ieGlusj2IAYAEg: posts big blind $0.50
*** HOLE CARDS ***
v4ctePcLlQw0r8E0qJtjYw: folds
g6lz8npaeeTJmJegtPYhlQ: calls $0.50
QvwRlrpVqerRRF8eJm6dDw: folds
7+uQ0OOgCTbR4ltkSwyC0g: calls $0.50
URYNc7fPA23K2UfadQbnCA: folds
f89uTQr3ieGlusj2IAYAEg: raises $2 to $2.50
g6lz8npaeeTJmJegtPYhlQ: calls $2
7+uQ0OOgCTbR4ltkSwyC0g: folds
*** FLOP *** [5h Ts 4h]
f89uTQr3ieGlusj2IAYAEg: checks
g6lz8npaeeTJmJegtPYhlQ: bets $5
f89uTQr3ieGlusj2IAYAEg: folds
g6lz8npaeeTJmJegtPYhlQ collected $5.50 from pot
*** SUMMARY ***
Total pot $5.75 | Rake $0.25
Board [5h Ts 4h]
Seat 1: URYNc7fPA23K2UfadQbnCA (small blind) folded before Flop
Seat 2: f89uTQr3ieGlusj2IAYAEg (big blind) folded on the Flop
Seat 3: v4ctePcLlQw0r8E0qJtjYw folded before Flop (didn't bet)
Seat 4: g6lz8npaeeTJmJegtPYhlQ collected ($5.50)
Seat 5: QvwRlrpVqerRRF8eJm6dDw folded before Flop (didn't bet)
Seat 6: 7+uQ0OOgCTbR4ltkSwyC0g (button) folded before Flop



PokerStars Game #59941320460:  Hold'em No Limit ($0.25/$0.50) - 2009/07/01 1:32:01 ET
Table 'ZYI3ZReBjdfKEYItkZHI6A' 9-max Seat #6 is the button
Seat 1: IYd5zG8k7vdBNVHbHg2Pag ($63.65 in chips)
Seat 3: 75K2MXwN65Sjfp1yHd50Hg ($9.25 in chips)
Seat 4: e2+sK/yjnj94rXOKoxPP2A ($60.90 in chips)
Seat 5: ApHP7ouup365XIUFBdEDxg ($15.95 in chips)
Seat 6: 1xBtrSVBbgFH/viUWKqQeg ($29.70 in chips)
Seat 7: HWcfp1hY1hqvrddzW3/FQw ($15.45 in chips)
Seat 8: ji04uOybxCdpdefzlUQeKQ ($30.55 in chips)
Seat 9: HZkVla4kK2SI42CVrPZ/ig ($9.25 in chips)
HWcfp1hY1hqvrddzW3/FQw: posts small blind $0.25
ji04uOybxCdpdefzlUQeKQ: posts big blind $0.50
5acK4E7fzEwnplVBZ6eNWA: sits out
*** HOLE CARDS ***
HZkVla4kK2SI42CVrPZ/ig: folds
IYd5zG8k7vdBNVHbHg2Pag: folds
75K2MXwN65Sjfp1yHd50Hg: folds
e2+sK/yjnj94rXOKoxPP2A: raises $1 to $1.50
ApHP7ouup365XIUFBdEDxg: folds
1xBtrSVBbgFH/viUWKqQeg: folds
HWcfp1hY1hqvrddzW3/FQw: folds
ji04uOybxCdpdefzlUQeKQ: folds
e2+sK/yjnj94rXOKoxPP2A collected $1.25 from pot
e2+sK/yjnj94rXOKoxPP2A: doesn't show hand
*** SUMMARY ***
Total pot $1.25 | Rake $0
Seat 1: IYd5zG8k7vdBNVHbHg2Pag folded before Flop (didn't bet)
Seat 3: 75K2MXwN65Sjfp1yHd50Hg folded before Flop (didn't bet)
Seat 4: e2+sK/yjnj94rXOKoxPP2A collected ($1.25)
Seat 5: ApHP7ouup365XIUFBdEDxg folded before Flop (didn't bet)
Seat 6: 1xBtrSVBbgFH/viUWKqQeg (button) folded before Flop (didn't bet)
Seat 7: HWcfp1hY1hqvrddzW3/FQw (small blind) folded before Flop
Seat 8: ji04uOybxCdpdefzlUQeKQ (big blind) folded before Flop
Seat 9: HZkVla4kK2SI42CVrPZ/ig folded before Flop (didn't bet)



PokerStars Game #59941321352:  Hold'em No Limit ($0.25/$0.50) - 2009/07/01 1:32:02 ET
Table 'B+sqsfj6d6zXicNfaseTaw' 2-max Seat #2 is the button
Seat 1: +4GNcSsecmapVGSdV0mUPA ($132.40 in chips)
Seat 2: Lv5RmpRe6LtPkBzM9Gpo5A ($91.80 in chips)
Lv5RmpRe6LtPkBzM9Gpo5A: posts small blind $0.25
+4GNcSsecmapVGSdV0mUPA: posts big blind $0.50
*** HOLE CARDS ***
Lv5RmpRe6LtPkBzM9Gpo5A: calls $0.25
+4GNcSsecmapVGSdV0mUPA: raises $1 to $1.50
Lv5RmpRe6LtPkBzM9Gpo5A: raises $2.50 to $4
+4GNcSsecmapVGSdV0mUPA: calls $2.50
*** FLOP *** [As 5s Jd]
+4GNcSsecmapVGSdV0mUPA: checks
Lv5RmpRe6LtPkBzM9Gpo5A: checks
*** TURN *** [As 5s Jd] [8d]
+4GNcSsecmapVGSdV0mUPA: checks
Lv5RmpRe6LtPkBzM9Gpo5A: bets $6
+4GNcSsecmapVGSdV0mUPA: calls $6
*** RIVER *** [As 5s Jd 8d] [4c]
+4GNcSsecmapVGSdV0mUPA: checks
Lv5RmpRe6LtPkBzM9Gpo5A: bets $15
+4GNcSsecmapVGSdV0mUPA: calls $15
*** SHOW DOWN ***
Lv5RmpRe6LtPkBzM9Gpo5A: shows [9h 2h] (high card Ace)
+4GNcSsecmapVGSdV0mUPA: shows [Jc 8c] (two pair, Jacks and Eights)
+4GNcSsecmapVGSdV0mUPA collected $49.50 from pot
*** SUMMARY ***
Total pot $50 | Rake $0.50
Board [As 5s Jd 8d 4c]
Seat 1: +4GNcSsecmapVGSdV0mUPA (big blind) showed [Jc 8c] and won ($49.50) with two pair, Jacks and Eights
Seat 2: Lv5RmpRe6LtPkBzM9Gpo5A (button) (small blind) showed [9h 2h] and lost with high card Ace



PokerStars Game #59941321890:  Hold'em No Limit ($0.25/$0.50) - 2009/07/01 1:32:03 ET
Table 'tyR5AZNKV8Aadbrnrnlg7g' 6-max Seat #1 is the button
Seat 1: BgOXYI0yYSN1ULC4FqsNkg ($78.30 in chips)
Seat 2: BAjwVL+zKKd0s0fAWstzQQ ($13.45 in chips)
Seat 3: JFLrYNyQmwPhRQAtoSAuyA ($57.75 in chips)
Seat 4: 4QfsCWthT/vSLirorNXqtg ($86.45 in chips)
Seat 5: GUnvMULl2qFOO1yenu1UBw ($84 in chips)
Seat 6: 498aWaGsW4uGfuWl+2FCGw ($64.05 in chips)
BAjwVL+zKKd0s0fAWstzQQ: posts small blind $0.25
JFLrYNyQmwPhRQAtoSAuyA: posts big blind $0.50
*** HOLE CARDS ***
4QfsCWthT/vSLirorNXqtg: folds
GUnvMULl2qFOO1yenu1UBw: folds
498aWaGsW4uGfuWl+2FCGw: folds
BgOXYI0yYSN1ULC4FqsNkg: folds
BAjwVL+zKKd0s0fAWstzQQ: calls $0.25
JFLrYNyQmwPhRQAtoSAuyA: checks
*** FLOP *** [Js 3s 4s]
BAjwVL+zKKd0s0fAWstzQQ: checks
JFLrYNyQmwPhRQAtoSAuyA: checks
*** TURN *** [Js 3s 4s] [Qh]
498aWaGsW4uGfuWl+2FCGw said, "is that where you live or are you talking about president roosevelt"
BAjwVL+zKKd0s0fAWstzQQ: bets $0.50
JFLrYNyQmwPhRQAtoSAuyA: folds
BAjwVL+zKKd0s0fAWstzQQ collected $0.95 from pot
*** SUMMARY ***
Total pot $1 | Rake $0.05
Board [Js 3s 4s Qh]
Seat 1: BgOXYI0yYSN1ULC4FqsNkg (button) folded before Flop (didn't bet)
Seat 2: BAjwVL+zKKd0s0fAWstzQQ (small blind) collected ($0.95)
Seat 3: JFLrYNyQmwPhRQAtoSAuyA (big blind) folded on the Turn
Seat 4: 4QfsCWthT/vSLirorNXqtg folded before Flop (didn't bet)
Seat 5: GUnvMULl2qFOO1yenu1UBw folded before Flop (didn't bet)
Seat 6: 498aWaGsW4uGfuWl+2FCGw folded before Flop (didn't bet)



PokerStars Game #59941322738:  Hold'em No Limit ($0.25/$0.50) - 2009/07/01 1:32:05 ET
Table '2lPOwetm4cfkZPbTmGPH/w' 2-max Seat #1 is the button
Seat 1: vUGdApqS8J/GJE2gaVWl1w ($21.10 in chips)
Seat 2: XFa6sBGjP2gxoIvxR3fZIg ($19.65 in chips)
vUGdApqS8J/GJE2gaVWl1w: posts small blind $0.25
XFa6sBGjP2gxoIvxR3fZIg: posts big blind $0.50
*** HOLE CARDS ***
vUGdApqS8J/GJE2gaVWl1w: raises $0.50 to $1
XFa6sBGjP2gxoIvxR3fZIg: calls $0.50
*** FLOP *** [4c 5c Td]
XFa6sBGjP2gxoIvxR3fZIg: checks
vUGdApqS8J/GJE2gaVWl1w: bets $0.50
XFa6sBGjP2gxoIvxR3fZIg: calls $0.50
*** TURN *** [4c 5c Td] [9h]
XFa6sBGjP2gxoIvxR3fZIg: checks
vUGdApqS8J/GJE2gaVWl1w: bets $0.50
XFa6sBGjP2gxoIvxR3fZIg: calls $0.50
*** RIVER *** [4c 5c Td 9h] [Qs]
XFa6sBGjP2gxoIvxR3fZIg: checks
vUGdApqS8J/GJE2gaVWl1w: checks
*** SHOW DOWN ***
XFa6sBGjP2gxoIvxR3fZIg: shows [Qd Jh] (a pair of Queens)
vUGdApqS8J/GJE2gaVWl1w: mucks hand
XFa6sBGjP2gxoIvxR3fZIg collected $3.85 from pot
*** SUMMARY ***
Total pot $4 | Rake $0.15
Board [4c 5c Td 9h Qs]
Seat 1: vUGdApqS8J/GJE2gaVWl1w (button) (small blind) mucked
Seat 2: XFa6sBGjP2gxoIvxR3fZIg (big blind) showed [Qd Jh] and won ($3.85) with a pair of Queens



PokerStars Game #59941324234:  Hold'em No Limit ($0.25/$0.50) - 2009/07/01 1:32:07 ET
Table 'Wwfm5/i+g/g2Nj2gT3jnVQ' 2-max Seat #1 is the button
Seat 1: CHRLZDaaxjbo68bwQD1C/Q ($17.35 in chips)
Seat 2: PKuuhUvIr5WSkJyPJa9dFw ($14.95 in chips)
CHRLZDaaxjbo68bwQD1C/Q: posts small blind $0.25
PKuuhUvIr5WSkJyPJa9dFw: posts big blind $0.50
*** HOLE CARDS ***
CHRLZDaaxjbo68bwQD1C/Q: folds
PKuuhUvIr5WSkJyPJa9dFw collected $0.50 from pot
PKuuhUvIr5WSkJyPJa9dFw: doesn't show hand
*** SUMMARY ***
Total pot $0.50 | Rake $0
Seat 1: CHRLZDaaxjbo68bwQD1C/Q (button) (small blind) folded before Flop
Seat 2: PKuuhUvIr5WSkJyPJa9dFw (big blind) collected ($0.50)



PokerStars Game #59941324664:  Hold'em No Limit ($0.25/$0.50) - 2009/07/01 1:32:08 ET
Table '+dXkOAQyS8j9PQZusUTMpg' 2-max Seat #1 is the button
Seat 1: Teld4PDKla7C8/Wfu2DSkg ($52.45 in chips)
Seat 2: +zI4bP23YIjMkUHqeN2xfw ($23.90 in chips)
Teld4PDKla7C8/Wfu2DSkg: posts small blind $0.25
+zI4bP23YIjMkUHqeN2xfw: posts big blind $0.50
*** HOLE CARDS ***
Teld4PDKla7C8/Wfu2DSkg: raises $0.50 to $1
+zI4bP23YIjMkUHqeN2xfw: raises $1.50 to $2.50
Teld4PDKla7C8/Wfu2DSkg: calls $1.50
*** FLOP *** [3d Ks 6d]
+zI4bP23YIjMkUHqeN2xfw: checks
Teld4PDKla7C8/Wfu2DSkg: bets $2
+zI4bP23YIjMkUHqeN2xfw: folds
Teld4PDKla7C8/Wfu2DSkg collected $4.75 from pot
Teld4PDKla7C8/Wfu2DSkg: doesn't show hand
*** SUMMARY ***
Total pot $5 | Rake $0.25
Board [3d Ks 6d]
Seat 1: Teld4PDKla7C8/Wfu2DSkg (button) (small blind) collected ($4.75)
Seat 2: +zI4bP23YIjMkUHqeN2xfw (big blind) folded on the Flop



PokerStars Game #59941324368:  Hold'em No Limit ($0.25/$0.50) - 2009/07/01 1:32:08 ET
Table '+z1aekfHkpp09pc8F9aViw' 6-max Seat #6 is the button
Seat 2: 4QfsCWthT/vSLirorNXqtg ($51 in chips)
Seat 3: URYNc7fPA23K2UfadQbnCA ($48.50 in chips)
Seat 4: RowCSpSURHTOL/dcjg/Iug ($85.75 in chips)
Seat 5: 2igtJLmvIZ+HqX4XPgMPZA ($50.95 in chips)
Seat 6: GUnvMULl2qFOO1yenu1UBw ($52.25 in chips)
4QfsCWthT/vSLirorNXqtg: posts small blind $0.25
URYNc7fPA23K2UfadQbnCA: posts big blind $0.50
RowCSpSURHTOL/dcjg/Iug: posts small & big blinds $0.75
*** HOLE CARDS ***
RowCSpSURHTOL/dcjg/Iug: checks
2igtJLmvIZ+HqX4XPgMPZA: folds
GUnvMULl2qFOO1yenu1UBw: folds
4QfsCWthT/vSLirorNXqtg: folds
URYNc7fPA23K2UfadQbnCA: checks
*** FLOP *** [3c Js 4h]
URYNc7fPA23K2UfadQbnCA: checks
RowCSpSURHTOL/dcjg/Iug: checks
*** TURN *** [3c Js 4h] [Ac]
URYNc7fPA23K2UfadQbnCA: checks
9r1sdCwEwebh7DF+/EQqGg joins the table at seat #1
RowCSpSURHTOL/dcjg/Iug: checks
*** RIVER *** [3c Js 4h Ac] [Qh]
URYNc7fPA23K2UfadQbnCA: checks
RowCSpSURHTOL/dcjg/Iug: bets $1
URYNc7fPA23K2UfadQbnCA: folds
RowCSpSURHTOL/dcjg/Iug collected $1.45 from pot
*** SUMMARY ***
Total pot $1.50 | Rake $0.05
Board [3c Js 4h Ac Qh]
Seat 2: 4QfsCWthT/vSLirorNXqtg (small blind) folded before Flop
Seat 3: URYNc7fPA23K2UfadQbnCA (big blind) folded on the River
Seat 4: RowCSpSURHTOL/dcjg/Iug collected ($1.45)
Seat 5: 2igtJLmvIZ+HqX4XPgMPZA folded before Flop (didn't bet)
Seat 6: GUnvMULl2qFOO1yenu1UBw (button) folded before Flop (didn't bet)



PokerStars Game #59941325178:  Hold'em No Limit ($0.25/$0.50) - 2009/07/01 1:32:09 ET
Table '8BQGgNetI1NOvWeu3gtMNw' 2-max Seat #2 is the button
Seat 1: bypIyrYcAAifLfhZpGlKLA ($82.65 in chips)
Seat 2: Z4HwehErEwzsv/noQlfUlg ($133.60 in chips)
Z4HwehErEwzsv/noQlfUlg: posts small blind $0.25
bypIyrYcAAifLfhZpGlKLA: posts big blind $0.50
*** HOLE CARDS ***
Z4HwehErEwzsv/noQlfUlg: raises $2 to $2.50
bypIyrYcAAifLfhZpGlKLA: folds
Z4HwehErEwzsv/noQlfUlg collected $1 from pot
Z4HwehErEwzsv/noQlfUlg: doesn't show hand
*** SUMMARY ***
Total pot $1 | Rake $0
Seat 1: bypIyrYcAAifLfhZpGlKLA (big blind) folded before Flop
Seat 2: Z4HwehErEwzsv/noQlfUlg (button) (small blind) collected ($1)



PokerStars Game #59941326594:  Hold'em No Limit ($0.25/$0.50) - 2009/07/01 1:32:12 ET
Table 'hSTs/dUsYLgJQuF2Onp0MQ' 6-max Seat #2 is the button
Seat 1: 1WUCqNG+p+vfWRTXNu4ljw ($50 in chips)
Seat 2: Hdd4js36ITbTJ/QuVYwTlA ($103.50 in chips)
Seat 3: lxIzoHy0RnkfFSODHC2liw ($50 in chips)
Seat 4: 2igtJLmvIZ+HqX4XPgMPZA ($50 in chips)
Seat 6: M1KyQQvVPVuxqTAB8sR/zQ ($93.80 in chips)
lxIzoHy0RnkfFSODHC2liw: posts small blind $0.25
2igtJLmvIZ+HqX4XPgMPZA: posts big blind $0.50
FsRQ5ECdlLkLYI5le8+PDQ: sits out
*** HOLE CARDS ***
M1KyQQvVPVuxqTAB8sR/zQ: raises $1 to $1.50
1WUCqNG+p+vfWRTXNu4ljw: calls $1.50
Hdd4js36ITbTJ/QuVYwTlA: calls $1.50
lxIzoHy0RnkfFSODHC2liw: calls $1.25
2igtJLmvIZ+HqX4XPgMPZA: folds
*** FLOP *** [6d 2h 8s]
lxIzoHy0RnkfFSODHC2liw: checks
M1KyQQvVPVuxqTAB8sR/zQ: checks
1WUCqNG+p+vfWRTXNu4ljw: checks
Hdd4js36ITbTJ/QuVYwTlA: bets $4.50
lxIzoHy0RnkfFSODHC2liw: calls $4.50
M1KyQQvVPVuxqTAB8sR/zQ: folds
1WUCqNG+p+vfWRTXNu4ljw: folds
*** TURN *** [6d 2h 8s] [Tc]
lxIzoHy0RnkfFSODHC2liw: checks
Hdd4js36ITbTJ/QuVYwTlA: checks
*** RIVER *** [6d 2h 8s Tc] [8d]
lxIzoHy0RnkfFSODHC2liw: checks
Hdd4js36ITbTJ/QuVYwTlA: checks
*** SHOW DOWN ***
lxIzoHy0RnkfFSODHC2liw: shows [4d 4s] (two pair, Eights and Fours)
Hdd4js36ITbTJ/QuVYwTlA: shows [7s 6c] (two pair, Eights and Sixes)
Hdd4js36ITbTJ/QuVYwTlA collected $14.75 from pot
*** SUMMARY ***
Total pot $15.50 | Rake $0.75
Board [6d 2h 8s Tc 8d]
Seat 1: 1WUCqNG+p+vfWRTXNu4ljw folded on the Flop
Seat 2: Hdd4js36ITbTJ/QuVYwTlA (button) showed [7s 6c] and won ($14.75) with two pair, Eights and Sixes
Seat 3: lxIzoHy0RnkfFSODHC2liw (small blind) showed [4d 4s] and lost with two pair, Eights and Fours
Seat 4: 2igtJLmvIZ+HqX4XPgMPZA (big blind) folded before Flop
Seat 6: M1KyQQvVPVuxqTAB8sR/zQ folded on the Flop



PokerStars Game #59941327362:  Hold'em No Limit ($0.25/$0.50) - 2009/07/01 1:32:13 ET
Table 'Wwfm5/i+g/g2Nj2gT3jnVQ' 2-max Seat #2 is the button
Seat 1: CHRLZDaaxjbo68bwQD1C/Q ($17.10 in chips)
Seat 2: PKuuhUvIr5WSkJyPJa9dFw ($15.20 in chips)
PKuuhUvIr5WSkJyPJa9dFw: posts small blind $0.25
CHRLZDaaxjbo68bwQD1C/Q: posts big blind $0.50
*** HOLE CARDS ***
PKuuhUvIr5WSkJyPJa9dFw: calls $0.25
CHRLZDaaxjbo68bwQD1C/Q: raises $0.50 to $1
PKuuhUvIr5WSkJyPJa9dFw: calls $0.50
*** FLOP *** [5h Qd 4c]
CHRLZDaaxjbo68bwQD1C/Q: bets $0.50
PKuuhUvIr5WSkJyPJa9dFw: calls $0.50
*** TURN *** [5h Qd 4c] [Ks]
CHRLZDaaxjbo68bwQD1C/Q: bets $0.50
PKuuhUvIr5WSkJyPJa9dFw: raises $1.50 to $2
CHRLZDaaxjbo68bwQD1C/Q: calls $1.50
*** RIVER *** [5h Qd 4c Ks] [7c]
CHRLZDaaxjbo68bwQD1C/Q: bets $1
PKuuhUvIr5WSkJyPJa9dFw: calls $1
*** SHOW DOWN ***
CHRLZDaaxjbo68bwQD1C/Q: shows [Ah 5c] (a pair of Fives)
PKuuhUvIr5WSkJyPJa9dFw: shows [Kd 3s] (a pair of Kings)
PKuuhUvIr5WSkJyPJa9dFw collected $8.60 from pot
*** SUMMARY ***
Total pot $9 | Rake $0.40
Board [5h Qd 4c Ks 7c]
Seat 1: CHRLZDaaxjbo68bwQD1C/Q (big blind) showed [Ah 5c] and lost with a pair of Fives
Seat 2: PKuuhUvIr5WSkJyPJa9dFw (button) (small blind) showed [Kd 3s] and won ($8.60) with a pair of Kings



PokerStars Game #59941327858:  Hold'em No Limit ($0.25/$0.50) - 2009/07/01 1:32:14 ET
Table 'hWT2kq66tnKEpD26cia6fQ' 2-max Seat #1 is the button
Seat 1: Ce3KNFP+ao7Da9NHb65raw ($49.80 in chips)
Seat 2: 16tvT7AYgZ2LgiGFcvFKQg ($25.90 in chips)
Ce3KNFP+ao7Da9NHb65raw: posts small blind $0.25
16tvT7AYgZ2LgiGFcvFKQg: posts big blind $0.50
*** HOLE CARDS ***
Ce3KNFP+ao7Da9NHb65raw: calls $0.25
16tvT7AYgZ2LgiGFcvFKQg: checks
*** FLOP *** [Jd Kh 5h]
16tvT7AYgZ2LgiGFcvFKQg: checks
Ce3KNFP+ao7Da9NHb65raw: checks
*** TURN *** [Jd Kh 5h] [4s]
16tvT7AYgZ2LgiGFcvFKQg: checks
Ce3KNFP+ao7Da9NHb65raw: checks
*** RIVER *** [Jd Kh 5h 4s] [5s]
16tvT7AYgZ2LgiGFcvFKQg: checks
Ce3KNFP+ao7Da9NHb65raw: checks
*** SHOW DOWN ***
16tvT7AYgZ2LgiGFcvFKQg: shows [9c 6h] (a pair of Fives)
Ce3KNFP+ao7Da9NHb65raw: shows [2c Ac] (a pair of Fives - Ace kicker)
Ce3KNFP+ao7Da9NHb65raw collected $0.95 from pot
*** SUMMARY ***
Total pot $1 | Rake $0.05
Board [Jd Kh 5h 4s 5s]
Seat 1: Ce3KNFP+ao7Da9NHb65raw (button) (small blind) showed [2c Ac] and won ($0.95) with a pair of Fives
Seat 2: 16tvT7AYgZ2LgiGFcvFKQg (big blind) showed [9c 6h] and lost with a pair of Fives



PokerStars Game #59941327966:  Hold'em No Limit ($0.25/$0.50) - 2009/07/01 1:32:14 ET
Table 'ErOuyGLI5PT3G5MnpHgC/g' 9-max Seat #9 is the button
Seat 1: eBrej2jnlUCs/JgxFCRn2g ($44.40 in chips)
Seat 2: pciZn00ZDk4BVBMTTMcNVQ ($19.30 in chips)
Seat 3: xZCXQSXlrZkp3pZizzVXCw ($50 in chips)
Seat 5: JwvquocWfhTVApN5t47LgA ($58.55 in chips)
Seat 6: zE9cVigS2nW/Ljy4K4bUQA ($30 in chips)
Seat 7: 90Wb75h3W1BRpbqVnuk8gw ($62.60 in chips)
Seat 8: g4k0NXISyLCqaSWZDBjfEg ($50 in chips)
Seat 9: J0W5D97jl5VLky+IoPvDeA ($64.50 in chips)
eBrej2jnlUCs/JgxFCRn2g: posts small blind $0.25
pciZn00ZDk4BVBMTTMcNVQ: posts big blind $0.50
YRqrX/u38J7aLNNnBzQsjQ: sits out
*** HOLE CARDS ***
xZCXQSXlrZkp3pZizzVXCw: folds
JwvquocWfhTVApN5t47LgA: folds
zE9cVigS2nW/Ljy4K4bUQA: folds
90Wb75h3W1BRpbqVnuk8gw: folds
g4k0NXISyLCqaSWZDBjfEg: folds
J0W5D97jl5VLky+IoPvDeA: folds
eBrej2jnlUCs/JgxFCRn2g: calls $0.25
pciZn00ZDk4BVBMTTMcNVQ: checks
*** FLOP *** [9d Ks Ah]
eBrej2jnlUCs/JgxFCRn2g: checks
pciZn00ZDk4BVBMTTMcNVQ: bets $0.50
eBrej2jnlUCs/JgxFCRn2g: folds
pciZn00ZDk4BVBMTTMcNVQ collected $0.95 from pot
*** SUMMARY ***
Total pot $1 | Rake $0.05
Board [9d Ks Ah]
Seat 1: eBrej2jnlUCs/JgxFCRn2g (small blind) folded on the Flop
Seat 2: pciZn00ZDk4BVBMTTMcNVQ (big blind) collected ($0.95)
Seat 3: xZCXQSXlrZkp3pZizzVXCw folded before Flop (didn't bet)
Seat 5: JwvquocWfhTVApN5t47LgA folded before Flop (didn't bet)
Seat 6: zE9cVigS2nW/Ljy4K4bUQA folded before Flop (didn't bet)
Seat 7: 90Wb75h3W1BRpbqVnuk8gw folded before Flop (didn't bet)
Seat 8: g4k0NXISyLCqaSWZDBjfEg folded before Flop (didn't bet)
Seat 9: J0W5D97jl5VLky+IoPvDeA (button) folded before Flop (didn't bet)



PokerStars Game #59941330846:  Hold'em No Limit ($0.25/$0.50) - 2009/07/01 1:32:19 ET
Table '8BQGgNetI1NOvWeu3gtMNw' 2-max Seat #1 is the button
Seat 1: bypIyrYcAAifLfhZpGlKLA ($82.15 in chips)
Seat 2: Z4HwehErEwzsv/noQlfUlg ($134.10 in chips)
bypIyrYcAAifLfhZpGlKLA: posts small blind $0.25
Z4HwehErEwzsv/noQlfUlg: posts big blind $0.50
*** HOLE CARDS ***
bypIyrYcAAifLfhZpGlKLA: raises $1 to $1.50
Z4HwehErEwzsv/noQlfUlg: folds
bypIyrYcAAifLfhZpGlKLA collected $1 from pot
bypIyrYcAAifLfhZpGlKLA: doesn't show hand
*** SUMMARY ***
Total pot $1 | Rake $0
Seat 1: bypIyrYcAAifLfhZpGlKLA (button) (small blind) collected ($1)
Seat 2: Z4HwehErEwzsv/noQlfUlg (big blind) folded before Flop



PokerStars Game #59941332072:  Hold'em No Limit ($0.25/$0.50) - 2009/07/01 1:32:21 ET
Table 'iq+aXfWVQRdV0u8SRTYUEg' 9-max Seat #8 is the button
Seat 1: 3yl8Q6QaLfGtyhN4/pEFgQ ($78.05 in chips)
Seat 2: J9N0lxHFd/Js2S0xZLbsIQ ($21.60 in chips)
Seat 3: Qi/PyOsKwaqtKIg0H+7ELg ($10.45 in chips)
Seat 4: vHYT5s323LpajBj+2c9zbQ ($32.10 in chips)
Seat 5: 997ViqAtWn1FPjJqcffwcA ($57.55 in chips)
Seat 7: SKnJuWHScqetA/qG5p+wCg ($30.80 in chips)
Seat 8: /DtIHuxEH+3tzKefmSV+Mw ($36.10 in chips)
Seat 9: olE1Z2rKWAV8+tGqmIBK9g ($26.45 in chips)
olE1Z2rKWAV8+tGqmIBK9g: posts small blind $0.25
3yl8Q6QaLfGtyhN4/pEFgQ: posts big blind $0.50
*** HOLE CARDS ***
J9N0lxHFd/Js2S0xZLbsIQ: raises $2 to $2.50
Qi/PyOsKwaqtKIg0H+7ELg: folds
vHYT5s323LpajBj+2c9zbQ: folds
997ViqAtWn1FPjJqcffwcA: folds
SKnJuWHScqetA/qG5p+wCg: folds
/DtIHuxEH+3tzKefmSV+Mw: folds
olE1Z2rKWAV8+tGqmIBK9g: folds
3yl8Q6QaLfGtyhN4/pEFgQ: folds
J9N0lxHFd/Js2S0xZLbsIQ collected $1.25 from pot
*** SUMMARY ***
Total pot $1.25 | Rake $0
Seat 1: 3yl8Q6QaLfGtyhN4/pEFgQ (big blind) folded before Flop
Seat 2: J9N0lxHFd/Js2S0xZLbsIQ collected ($1.25)
Seat 3: Qi/PyOsKwaqtKIg0H+7ELg folded before Flop (didn't bet)
Seat 4: vHYT5s323LpajBj+2c9zbQ folded before Flop (didn't bet)
Seat 5: 997ViqAtWn1FPjJqcffwcA folded before Flop (didn't bet)
Seat 7: SKnJuWHScqetA/qG5p+wCg folded before Flop (didn't bet)
Seat 8: /DtIHuxEH+3tzKefmSV+Mw (button) folded before Flop (didn't bet)
Seat 9: olE1Z2rKWAV8+tGqmIBK9g (small blind) folded before Flop



PokerStars Game #59941332224:  Hold'em No Limit ($0.25/$0.50) - 2009/07/01 1:32:22 ET
Table 'tyR5AZNKV8Aadbrnrnlg7g' 6-max Seat #2 is the button
Seat 1: BgOXYI0yYSN1ULC4FqsNkg ($78.30 in chips)
Seat 2: BAjwVL+zKKd0s0fAWstzQQ ($13.90 in chips)
Seat 3: JFLrYNyQmwPhRQAtoSAuyA ($57.25 in chips)
Seat 4: 4QfsCWthT/vSLirorNXqtg ($86.45 in chips)
Seat 5: GUnvMULl2qFOO1yenu1UBw ($84 in chips)
Seat 6: 498aWaGsW4uGfuWl+2FCGw ($64.05 in chips)
JFLrYNyQmwPhRQAtoSAuyA: posts small blind $0.25
4QfsCWthT/vSLirorNXqtg: posts big blind $0.50
*** HOLE CARDS ***
GUnvMULl2qFOO1yenu1UBw: folds
498aWaGsW4uGfuWl+2FCGw: raises $0.50 to $1
BgOXYI0yYSN1ULC4FqsNkg: folds
BAjwVL+zKKd0s0fAWstzQQ: folds
JFLrYNyQmwPhRQAtoSAuyA: folds
4QfsCWthT/vSLirorNXqtg: folds
498aWaGsW4uGfuWl+2FCGw collected $1.25 from pot
*** SUMMARY ***
Total pot $1.25 | Rake $0
Seat 1: BgOXYI0yYSN1ULC4FqsNkg folded before Flop (didn't bet)
Seat 2: BAjwVL+zKKd0s0fAWstzQQ (button) folded before Flop (didn't bet)
Seat 3: JFLrYNyQmwPhRQAtoSAuyA (small blind) folded before Flop
Seat 4: 4QfsCWthT/vSLirorNXqtg (big blind) folded before Flop
Seat 5: GUnvMULl2qFOO1yenu1UBw folded before Flop (didn't bet)
Seat 6: 498aWaGsW4uGfuWl+2FCGw collected ($1.25)



PokerStars Game #59941333990:  Hold'em No Limit ($0.25/$0.50) - 2009/07/01 1:32:25 ET
Table '2lPOwetm4cfkZPbTmGPH/w' 2-max Seat #2 is the button
Seat 1: vUGdApqS8J/GJE2gaVWl1w ($19.10 in chips)
Seat 2: XFa6sBGjP2gxoIvxR3fZIg ($21.50 in chips)
XFa6sBGjP2gxoIvxR3fZIg: posts small blind $0.25
vUGdApqS8J/GJE2gaVWl1w: posts big blind $0.50
*** HOLE CARDS ***
XFa6sBGjP2gxoIvxR3fZIg: raises $1 to $1.50
vUGdApqS8J/GJE2gaVWl1w: calls $1
*** FLOP *** [5s Tc 9s]
vUGdApqS8J/GJE2gaVWl1w: checks
XFa6sBGjP2gxoIvxR3fZIg: bets $2
vUGdApqS8J/GJE2gaVWl1w: calls $2
*** TURN *** [5s Tc 9s] [Ac]
vUGdApqS8J/GJE2gaVWl1w: bets $0.50
XFa6sBGjP2gxoIvxR3fZIg: calls $0.50
*** RIVER *** [5s Tc 9s Ac] [5d]
vUGdApqS8J/GJE2gaVWl1w: bets $0.50
XFa6sBGjP2gxoIvxR3fZIg: raises $4.50 to $5
vUGdApqS8J/GJE2gaVWl1w: folds
XFa6sBGjP2gxoIvxR3fZIg collected $8.60 from pot
XFa6sBGjP2gxoIvxR3fZIg: doesn't show hand
*** SUMMARY ***
Total pot $9 | Rake $0.40
Board [5s Tc 9s Ac 5d]
Seat 1: vUGdApqS8J/GJE2gaVWl1w (big blind) folded on the River
Seat 2: XFa6sBGjP2gxoIvxR3fZIg (button) (small blind) collected ($8.60)



PokerStars Game #59941336136:  Hold'em No Limit ($0.25/$0.50) - 2009/07/01 1:32:29 ET
Table '+dXkOAQyS8j9PQZusUTMpg' 2-max Seat #2 is the button
Seat 1: Teld4PDKla7C8/Wfu2DSkg ($54.70 in chips)
Seat 2: +zI4bP23YIjMkUHqeN2xfw ($21.40 in chips)
+zI4bP23YIjMkUHqeN2xfw: posts small blind $0.25
Teld4PDKla7C8/Wfu2DSkg: posts big blind $0.50
*** HOLE CARDS ***
+zI4bP23YIjMkUHqeN2xfw: folds
Teld4PDKla7C8/Wfu2DSkg collected $0.50 from pot
Teld4PDKla7C8/Wfu2DSkg: doesn't show hand
*** SUMMARY ***
Total pot $0.50 | Rake $0
Seat 1: Teld4PDKla7C8/Wfu2DSkg (big blind) collected ($0.50)
Seat 2: +zI4bP23YIjMkUHqeN2xfw (button) (small blind) folded before Flop



PokerStars Game #59941336624:  Hold'em No Limit ($0.25/$0.50) - 2009/07/01 1:32:29 ET
Table '9ojijpRcYQSQTh6xI+haUA' 2-max Seat #2 is the button
Seat 1: FqpibuVWLNsAN/Z7ROZLnA ($34.30 in chips)
Seat 2: TitTV+fFCcBZWOERdytydA ($50.20 in chips)
TitTV+fFCcBZWOERdytydA: posts small blind $0.25
FqpibuVWLNsAN/Z7ROZLnA: posts big blind $0.50
*** HOLE CARDS ***
TitTV+fFCcBZWOERdytydA: folds
FqpibuVWLNsAN/Z7ROZLnA collected $0.50 from pot
*** SUMMARY ***
Total pot $0.50 | Rake $0
Seat 1: FqpibuVWLNsAN/Z7ROZLnA (big blind) collected ($0.50)
Seat 2: TitTV+fFCcBZWOERdytydA (button) (small blind) folded before Flop



PokerStars Game #59941338070:  Hold'em No Limit ($0.25/$0.50) - 2009/07/01 1:32:32 ET
Table 'NCiXr0d5CEKBQr/cZgLhbA' 9-max Seat #4 is the button
Seat 1: pFtzb1sR4b0d1aw6aIRgDg ($80.45 in chips)
Seat 2: AjV5McH1KMMclY26QdLM5w ($47.55 in chips)
Seat 3: xZCXQSXlrZkp3pZizzVXCw ($97.15 in chips)
Seat 4: 5k9fvXD9suIgCxU4HLQjTw ($53.95 in chips)
Seat 5: Ja2jdidjip2UeJnRzmzAAQ ($48.50 in chips)
Seat 6: t1qL+wRXOwTLB4TBbcw2QA ($47.75 in chips)
Seat 7: dXhO5i7KOoVcsGqbklD+jw ($31.95 in chips)
Seat 8: XA3GzEhYmqB0KknKKPDZGQ ($35 in chips)
Seat 9: 4WLZvqBn5qv5tds5kt5A1Q ($54.50 in chips)
Ja2jdidjip2UeJnRzmzAAQ: posts small blind $0.25
t1qL+wRXOwTLB4TBbcw2QA: posts big blind $0.50
XA3GzEhYmqB0KknKKPDZGQ: posts big blind $0.50
*** HOLE CARDS ***
dXhO5i7KOoVcsGqbklD+jw: raises $1 to $1.50
XA3GzEhYmqB0KknKKPDZGQ: calls $1
4WLZvqBn5qv5tds5kt5A1Q: folds
pFtzb1sR4b0d1aw6aIRgDg: folds
AjV5McH1KMMclY26QdLM5w: folds
xZCXQSXlrZkp3pZizzVXCw: folds
5k9fvXD9suIgCxU4HLQjTw: folds
Ja2jdidjip2UeJnRzmzAAQ: folds
t1qL+wRXOwTLB4TBbcw2QA: folds
*** FLOP *** [8c 3c 3h]
dXhO5i7KOoVcsGqbklD+jw: bets $1
XA3GzEhYmqB0KknKKPDZGQ: calls $1
*** TURN *** [8c 3c 3h] [3s]
dXhO5i7KOoVcsGqbklD+jw: checks
XA3GzEhYmqB0KknKKPDZGQ: bets $0.50
dXhO5i7KOoVcsGqbklD+jw: raises $1.50 to $2
XA3GzEhYmqB0KknKKPDZGQ: calls $1.50
*** RIVER *** [8c 3c 3h 3s] [Ac]
dXhO5i7KOoVcsGqbklD+jw: checks
XA3GzEhYmqB0KknKKPDZGQ: checks
*** SHOW DOWN ***
dXhO5i7KOoVcsGqbklD+jw: shows [Qc Kh] (three of a kind, Threes)
XA3GzEhYmqB0KknKKPDZGQ: shows [Tc Qh] (three of a kind, Threes - lower kicker)
dXhO5i7KOoVcsGqbklD+jw collected $9.30 from pot
*** SUMMARY ***
Total pot $9.75 | Rake $0.45
Board [8c 3c 3h 3s Ac]
Seat 1: pFtzb1sR4b0d1aw6aIRgDg folded before Flop (didn't bet)
Seat 2: AjV5McH1KMMclY26QdLM5w folded before Flop (didn't bet)
Seat 3: xZCXQSXlrZkp3pZizzVXCw folded before Flop (didn't bet)
Seat 4: 5k9fvXD9suIgCxU4HLQjTw (button) folded before Flop (didn't bet)
Seat 5: Ja2jdidjip2UeJnRzmzAAQ (small blind) folded before Flop
Seat 6: t1qL+wRXOwTLB4TBbcw2QA (big blind) folded before Flop
Seat 7: dXhO5i7KOoVcsGqbklD+jw showed [Qc Kh] and won ($9.30) with three of a kind, Threes
Seat 8: XA3GzEhYmqB0KknKKPDZGQ showed [Tc Qh] and lost with three of a kind, Threes
Seat 9: 4WLZvqBn5qv5tds5kt5A1Q folded before Flop (didn't bet)



PokerStars Game #59941338778:  Hold'em No Limit ($0.25/$0.50) - 2009/07/01 1:32:33 ET
Table 'EiNh8p/wGJ1FP575iMFnqg' 9-max Seat #7 is the button
Seat 1: YFFlOZgyy1Mh4iBmuNRbmQ ($24.75 in chips)
Seat 2: 8ehL7qlZzjgUh2H35iiWLw ($69.75 in chips)
Seat 3: ymLPoEIl7UL3TvZYmnadxQ ($42.35 in chips)
Seat 4: cMzaiXAM/ZAdNaEUu+LqhA ($58.45 in chips)
Seat 5: M+7+BTmX5vZatHVuoRB1nA ($73.20 in chips)
Seat 6: viwBDtJsY6JfsFOdBAyJIQ ($8.45 in chips)
Seat 7: 997ViqAtWn1FPjJqcffwcA ($50 in chips)
Seat 8: mSD1pginDsyHG5PDfqzphw ($10 in chips)
Seat 9: GuPkZObrz5Zkkn8FsEdF9w ($35.60 in chips)
mSD1pginDsyHG5PDfqzphw: posts small blind $0.25
GuPkZObrz5Zkkn8FsEdF9w: posts big blind $0.50
*** HOLE CARDS ***
YFFlOZgyy1Mh4iBmuNRbmQ: calls $0.50
8ehL7qlZzjgUh2H35iiWLw: folds
ymLPoEIl7UL3TvZYmnadxQ: folds
cMzaiXAM/ZAdNaEUu+LqhA: folds
M+7+BTmX5vZatHVuoRB1nA: folds
viwBDtJsY6JfsFOdBAyJIQ: folds
997ViqAtWn1FPjJqcffwcA: folds
mSD1pginDsyHG5PDfqzphw: folds
GuPkZObrz5Zkkn8FsEdF9w: checks
*** FLOP *** [Qd 8d 3h]
GuPkZObrz5Zkkn8FsEdF9w: checks
YFFlOZgyy1Mh4iBmuNRbmQ: bets $0.50
GuPkZObrz5Zkkn8FsEdF9w: folds
YFFlOZgyy1Mh4iBmuNRbmQ collected $1.20 from pot
*** SUMMARY ***
Total pot $1.25 | Rake $0.05
Board [Qd 8d 3h]
Seat 1: YFFlOZgyy1Mh4iBmuNRbmQ collected ($1.20)
Seat 2: 8ehL7qlZzjgUh2H35iiWLw folded before Flop (didn't bet)
Seat 3: ymLPoEIl7UL3TvZYmnadxQ folded before Flop (didn't bet)
Seat 4: cMzaiXAM/ZAdNaEUu+LqhA folded before Flop (didn't bet)
Seat 5: M+7+BTmX5vZatHVuoRB1nA folded before Flop (didn't bet)
Seat 6: viwBDtJsY6JfsFOdBAyJIQ folded before Flop (didn't bet)
Seat 7: 997ViqAtWn1FPjJqcffwcA (button) folded before Flop (didn't bet)
Seat 8: mSD1pginDsyHG5PDfqzphw (small blind) folded before Flop
Seat 9: GuPkZObrz5Zkkn8FsEdF9w (big blind) folded on the Flop



PokerStars Game #59941338866:  Hold'em No Limit ($0.25/$0.50) - 2009/07/01 1:32:33 ET
Table 'hWT2kq66tnKEpD26cia6fQ' 2-max Seat #2 is the button
Seat 1: Ce3KNFP+ao7Da9NHb65raw ($50.25 in chips)
Seat 2: 16tvT7AYgZ2LgiGFcvFKQg ($25.40 in chips)
16tvT7AYgZ2LgiGFcvFKQg: posts small blind $0.25
Ce3KNFP+ao7Da9NHb65raw: posts big blind $0.50
*** HOLE CARDS ***
16tvT7AYgZ2LgiGFcvFKQg: raises $0.50 to $1
Ce3KNFP+ao7Da9NHb65raw: calls $0.50
*** FLOP *** [2d Td 4h]
Ce3KNFP+ao7Da9NHb65raw: checks
16tvT7AYgZ2LgiGFcvFKQg: checks
*** TURN *** [2d Td 4h] [7h]
Ce3KNFP+ao7Da9NHb65raw: checks
16tvT7AYgZ2LgiGFcvFKQg: checks
*** RIVER *** [2d Td 4h 7h] [9d]
Ce3KNFP+ao7Da9NHb65raw: checks
16tvT7AYgZ2LgiGFcvFKQg: checks
*** SHOW DOWN ***
Ce3KNFP+ao7Da9NHb65raw: shows [Kc 3s] (high card King)
16tvT7AYgZ2LgiGFcvFKQg: shows [Qs Kh] (high card King - Queen kicker)
16tvT7AYgZ2LgiGFcvFKQg collected $1.90 from pot
*** SUMMARY ***
Total pot $2 | Rake $0.10
Board [2d Td 4h 7h 9d]
Seat 1: Ce3KNFP+ao7Da9NHb65raw (big blind) showed [Kc 3s] and lost with high card King
Seat 2: 16tvT7AYgZ2LgiGFcvFKQg (button) (small blind) showed [Qs Kh] and won ($1.90) with high card King



PokerStars Game #59941338398:  Hold'em No Limit ($0.25/$0.50) - 2009/07/01 1:32:33 ET
Table 'ZYI3ZReBjdfKEYItkZHI6A' 9-max Seat #7 is the button
Seat 1: IYd5zG8k7vdBNVHbHg2Pag ($63.65 in chips)
Seat 3: 75K2MXwN65Sjfp1yHd50Hg ($9.25 in chips)
Seat 4: e2+sK/yjnj94rXOKoxPP2A ($61.65 in chips)
Seat 5: ApHP7ouup365XIUFBdEDxg ($15.95 in chips)
Seat 6: 1xBtrSVBbgFH/viUWKqQeg ($29.70 in chips)
Seat 7: HWcfp1hY1hqvrddzW3/FQw ($15.20 in chips)
Seat 8: ji04uOybxCdpdefzlUQeKQ ($30.05 in chips)
Seat 9: HZkVla4kK2SI42CVrPZ/ig ($9.25 in chips)
ji04uOybxCdpdefzlUQeKQ: posts small blind $0.25
HZkVla4kK2SI42CVrPZ/ig: posts big blind $0.50
5acK4E7fzEwnplVBZ6eNWA: sits out
*** HOLE CARDS ***
IYd5zG8k7vdBNVHbHg2Pag: folds
75K2MXwN65Sjfp1yHd50Hg: folds
e2+sK/yjnj94rXOKoxPP2A: folds
ApHP7ouup365XIUFBdEDxg: calls $0.50
1xBtrSVBbgFH/viUWKqQeg: folds
HWcfp1hY1hqvrddzW3/FQw: calls $0.50
ji04uOybxCdpdefzlUQeKQ: calls $0.25
HZkVla4kK2SI42CVrPZ/ig: checks
*** FLOP *** [Jd Ah Kh]
ji04uOybxCdpdefzlUQeKQ: checks
HZkVla4kK2SI42CVrPZ/ig: bets $1
ApHP7ouup365XIUFBdEDxg: folds
HWcfp1hY1hqvrddzW3/FQw: folds
ji04uOybxCdpdefzlUQeKQ: folds
HZkVla4kK2SI42CVrPZ/ig collected $1.90 from pot
HZkVla4kK2SI42CVrPZ/ig: doesn't show hand
*** SUMMARY ***
Total pot $2 | Rake $0.10
Board [Jd Ah Kh]
Seat 1: IYd5zG8k7vdBNVHbHg2Pag folded before Flop (didn't bet)
Seat 3: 75K2MXwN65Sjfp1yHd50Hg folded before Flop (didn't bet)
Seat 4: e2+sK/yjnj94rXOKoxPP2A folded before Flop (didn't bet)
Seat 5: ApHP7ouup365XIUFBdEDxg folded on the Flop
Seat 6: 1xBtrSVBbgFH/viUWKqQeg folded before Flop (didn't bet)
Seat 7: HWcfp1hY1hqvrddzW3/FQw (button) folded on the Flop
Seat 8: ji04uOybxCdpdefzlUQeKQ (small blind) folded on the Flop
Seat 9: HZkVla4kK2SI42CVrPZ/ig (big blind) collected ($1.90)



PokerStars Game #59941339334:  Hold'em No Limit ($0.25/$0.50) - 2009/07/01 1:32:34 ET
Table '+dXkOAQyS8j9PQZusUTMpg' 2-max Seat #1 is the button
Seat 1: Teld4PDKla7C8/Wfu2DSkg ($54.95 in chips)
Seat 2: +zI4bP23YIjMkUHqeN2xfw ($21.15 in chips)
Teld4PDKla7C8/Wfu2DSkg: posts small blind $0.25
+zI4bP23YIjMkUHqeN2xfw: posts big blind $0.50
*** HOLE CARDS ***
Teld4PDKla7C8/Wfu2DSkg: raises $0.50 to $1
+zI4bP23YIjMkUHqeN2xfw: calls $0.50
*** FLOP *** [2d 7h 4d]
+zI4bP23YIjMkUHqeN2xfw: checks
Teld4PDKla7C8/Wfu2DSkg: bets $2
+zI4bP23YIjMkUHqeN2xfw: calls $2
*** TURN *** [2d 7h 4d] [2c]
+zI4bP23YIjMkUHqeN2xfw: checks
Teld4PDKla7C8/Wfu2DSkg: bets $4
+zI4bP23YIjMkUHqeN2xfw: folds
Teld4PDKla7C8/Wfu2DSkg collected $5.75 from pot
Teld4PDKla7C8/Wfu2DSkg: doesn't show hand
*** SUMMARY ***
Total pot $6 | Rake $0.25
Board [2d 7h 4d 2c]
Seat 1: Teld4PDKla7C8/Wfu2DSkg (button) (small blind) collected ($5.75)
Seat 2: +zI4bP23YIjMkUHqeN2xfw (big blind) folded on the Turn



PokerStars Game #59941339024:  Hold'em No Limit ($0.25/$0.50) - 2009/07/01 1:32:34 ET
Table 'Wwfm5/i+g/g2Nj2gT3jnVQ' 2-max Seat #1 is the button
Seat 1: CHRLZDaaxjbo68bwQD1C/Q ($12.60 in chips)
Seat 2: PKuuhUvIr5WSkJyPJa9dFw ($19.30 in chips)
CHRLZDaaxjbo68bwQD1C/Q: posts small blind $0.25
PKuuhUvIr5WSkJyPJa9dFw: posts big blind $0.50
*** HOLE CARDS ***
CHRLZDaaxjbo68bwQD1C/Q: calls $0.25
PKuuhUvIr5WSkJyPJa9dFw: checks
*** FLOP *** [7d Kc Qs]
PKuuhUvIr5WSkJyPJa9dFw: checks
CHRLZDaaxjbo68bwQD1C/Q: checks
*** TURN *** [7d Kc Qs] [8h]
PKuuhUvIr5WSkJyPJa9dFw: checks
CHRLZDaaxjbo68bwQD1C/Q: checks
*** RIVER *** [7d Kc Qs 8h] [4h]
PKuuhUvIr5WSkJyPJa9dFw: checks
CHRLZDaaxjbo68bwQD1C/Q: checks
*** SHOW DOWN ***
PKuuhUvIr5WSkJyPJa9dFw: shows [2s Jh] (high card King)
CHRLZDaaxjbo68bwQD1C/Q: mucks hand
PKuuhUvIr5WSkJyPJa9dFw collected $0.95 from pot
*** SUMMARY ***
Total pot $1 | Rake $0.05
Board [7d Kc Qs 8h 4h]
Seat 1: CHRLZDaaxjbo68bwQD1C/Q (button) (small blind) mucked
Seat 2: PKuuhUvIr5WSkJyPJa9dFw (big blind) showed [2s Jh] and won ($0.95) with high card King



PokerStars Game #59941339704:  Hold'em No Limit ($0.25/$0.50) - 2009/07/01 1:32:35 ET
Table '8BQGgNetI1NOvWeu3gtMNw' 2-max Seat #2 is the button
Seat 1: bypIyrYcAAifLfhZpGlKLA ($82.65 in chips)
Seat 2: Z4HwehErEwzsv/noQlfUlg ($133.60 in chips)
Z4HwehErEwzsv/noQlfUlg: posts small blind $0.25
bypIyrYcAAifLfhZpGlKLA: posts big blind $0.50
*** HOLE CARDS ***
Z4HwehErEwzsv/noQlfUlg: calls $0.25
bypIyrYcAAifLfhZpGlKLA: checks
*** FLOP *** [4h Qh Js]
bypIyrYcAAifLfhZpGlKLA: checks
Z4HwehErEwzsv/noQlfUlg: checks
*** TURN *** [4h Qh Js] [Ad]
bypIyrYcAAifLfhZpGlKLA: checks
Z4HwehErEwzsv/noQlfUlg: bets $2
bypIyrYcAAifLfhZpGlKLA: folds
Z4HwehErEwzsv/noQlfUlg collected $0.95 from pot
Z4HwehErEwzsv/noQlfUlg: doesn't show hand
*** SUMMARY ***
Total pot $1 | Rake $0.05
Board [4h Qh Js Ad]
Seat 1: bypIyrYcAAifLfhZpGlKLA (big blind) folded on the Turn
Seat 2: Z4HwehErEwzsv/noQlfUlg (button) (small blind) collected ($0.95)



PokerStars Game #59941339940:  Hold'em No Limit ($0.25/$0.50) - 2009/07/01 1:32:35 ET
Table 'B+sqsfj6d6zXicNfaseTaw' 2-max Seat #1 is the button
Seat 1: +4GNcSsecmapVGSdV0mUPA ($156.90 in chips)
Seat 2: Lv5RmpRe6LtPkBzM9Gpo5A ($66.80 in chips)
+4GNcSsecmapVGSdV0mUPA: posts small blind $0.25
Lv5RmpRe6LtPkBzM9Gpo5A: posts big blind $0.50
*** HOLE CARDS ***
+4GNcSsecmapVGSdV0mUPA: calls $0.25
Lv5RmpRe6LtPkBzM9Gpo5A: checks
*** FLOP *** [2d Kd 8d]
Lv5RmpRe6LtPkBzM9Gpo5A: checks
+4GNcSsecmapVGSdV0mUPA: bets $1
Lv5RmpRe6LtPkBzM9Gpo5A: calls $1
*** TURN *** [2d Kd 8d] [Qd]
Lv5RmpRe6LtPkBzM9Gpo5A: checks
+4GNcSsecmapVGSdV0mUPA: checks
*** RIVER *** [2d Kd 8d Qd] [4s]
Lv5RmpRe6LtPkBzM9Gpo5A: bets $2
+4GNcSsecmapVGSdV0mUPA: folds
Lv5RmpRe6LtPkBzM9Gpo5A collected $2.90 from pot
Lv5RmpRe6LtPkBzM9Gpo5A: doesn't show hand
*** SUMMARY ***
Total pot $3 | Rake $0.10
Board [2d Kd 8d Qd 4s]
Seat 1: +4GNcSsecmapVGSdV0mUPA (button) (small blind) folded on the River
Seat 2: Lv5RmpRe6LtPkBzM9Gpo5A (big blind) collected ($2.90)



PokerStars Game #59941339826:  Hold'em No Limit ($0.25/$0.50) - 2009/07/01 1:32:35 ET
Table 'tyR5AZNKV8Aadbrnrnlg7g' 6-max Seat #3 is the button
Seat 1: BgOXYI0yYSN1ULC4FqsNkg ($78.30 in chips)
Seat 2: BAjwVL+zKKd0s0fAWstzQQ ($13.90 in chips)
Seat 3: JFLrYNyQmwPhRQAtoSAuyA ($57 in chips)
Seat 4: 4QfsCWthT/vSLirorNXqtg ($85.95 in chips)
Seat 5: GUnvMULl2qFOO1yenu1UBw ($84 in chips)
Seat 6: 498aWaGsW4uGfuWl+2FCGw ($64.80 in chips)
4QfsCWthT/vSLirorNXqtg: posts small blind $0.25
GUnvMULl2qFOO1yenu1UBw: posts big blind $0.50
*** HOLE CARDS ***
498aWaGsW4uGfuWl+2FCGw: folds
BgOXYI0yYSN1ULC4FqsNkg: calls $0.50
BAjwVL+zKKd0s0fAWstzQQ: folds
JFLrYNyQmwPhRQAtoSAuyA: folds
4QfsCWthT/vSLirorNXqtg: folds
GUnvMULl2qFOO1yenu1UBw: checks
*** FLOP *** [Td 4d 7d]
GUnvMULl2qFOO1yenu1UBw: bets $1
BgOXYI0yYSN1ULC4FqsNkg: calls $1
*** TURN *** [Td 4d 7d] [Ac]
GUnvMULl2qFOO1yenu1UBw: bets $2.50
BgOXYI0yYSN1ULC4FqsNkg: calls $2.50
*** RIVER *** [Td 4d 7d Ac] [Ks]
GUnvMULl2qFOO1yenu1UBw: bets $3.50
BgOXYI0yYSN1ULC4FqsNkg: folds
498aWaGsW4uGfuWl+2FCGw said, "hello"
GUnvMULl2qFOO1yenu1UBw collected $7.85 from pot
GUnvMULl2qFOO1yenu1UBw: doesn't show hand
*** SUMMARY ***
Total pot $8.25 | Rake $0.40
Board [Td 4d 7d Ac Ks]
Seat 1: BgOXYI0yYSN1ULC4FqsNkg folded on the River
Seat 2: BAjwVL+zKKd0s0fAWstzQQ folded before Flop (didn't bet)
Seat 3: JFLrYNyQmwPhRQAtoSAuyA (button) folded before Flop (didn't bet)
Seat 4: 4QfsCWthT/vSLirorNXqtg (small blind) folded before Flop
Seat 5: GUnvMULl2qFOO1yenu1UBw (big blind) collected ($7.85)
Seat 6: 498aWaGsW4uGfuWl+2FCGw folded before Flop (didn't bet)



PokerStars Game #59941339636:  Hold'em No Limit ($0.25/$0.50) - 2009/07/01 1:32:35 ET
Table 'Nz0Vr7WMHL2g5Uk7dDZjpw' 9-max Seat #2 is the button
Seat 1: 9yMsdgReyOUerNsmTYCCDQ ($9 in chips)
Seat 2: SegjDnMxWMujiD57ESNL+g ($19.60 in chips)
Seat 3: c638Xxo+q5F/t5qMtmvmvQ ($51.40 in chips)
Seat 4: uw9QayAAxLM3Hb+HR7mSkg ($10 in chips)
Seat 5: WGW0DgjBUXs1ylURHG8vnQ ($12.40 in chips)
Seat 6: 997ViqAtWn1FPjJqcffwcA ($50 in chips)
Seat 7: KPLH0gELgFe2OuAnhJFI5w ($24.20 in chips)
Seat 8: aoL+R/61Kxmw69ypuPrWAQ ($31.30 in chips)
Seat 9: mSD1pginDsyHG5PDfqzphw ($19.25 in chips)
c638Xxo+q5F/t5qMtmvmvQ: posts small blind $0.25
uw9QayAAxLM3Hb+HR7mSkg: posts big blind $0.50
*** HOLE CARDS ***
WGW0DgjBUXs1ylURHG8vnQ: folds
997ViqAtWn1FPjJqcffwcA: folds
KPLH0gELgFe2OuAnhJFI5w: folds
aoL+R/61Kxmw69ypuPrWAQ: folds
mSD1pginDsyHG5PDfqzphw: folds
9yMsdgReyOUerNsmTYCCDQ: folds
SegjDnMxWMujiD57ESNL+g: raises $1.50 to $2
c638Xxo+q5F/t5qMtmvmvQ: folds
uw9QayAAxLM3Hb+HR7mSkg: folds
SegjDnMxWMujiD57ESNL+g collected $1.25 from pot
SegjDnMxWMujiD57ESNL+g: doesn't show hand
*** SUMMARY ***
Total pot $1.25 | Rake $0
Seat 1: 9yMsdgReyOUerNsmTYCCDQ folded before Flop (didn't bet)
Seat 2: SegjDnMxWMujiD57ESNL+g (button) collected ($1.25)
Seat 3: c638Xxo+q5F/t5qMtmvmvQ (small blind) folded before Flop
Seat 4: uw9QayAAxLM3Hb+HR7mSkg (big blind) folded before Flop
Seat 5: WGW0DgjBUXs1ylURHG8vnQ folded before Flop (didn't bet)
Seat 6: 997ViqAtWn1FPjJqcffwcA folded before Flop (didn't bet)
Seat 7: KPLH0gELgFe2OuAnhJFI5w folded before Flop (didn't bet)
Seat 8: aoL+R/61Kxmw69ypuPrWAQ folded before Flop (didn't bet)
Seat 9: mSD1pginDsyHG5PDfqzphw folded before Flop (didn't bet)



PokerStars Game #59941340694:  Hold'em No Limit ($0.25/$0.50) - 2009/07/01 1:32:37 ET
Table '9ojijpRcYQSQTh6xI+haUA' 2-max Seat #1 is the button
Seat 1: FqpibuVWLNsAN/Z7ROZLnA ($34.55 in chips)
Seat 2: TitTV+fFCcBZWOERdytydA ($49.95 in chips)
FqpibuVWLNsAN/Z7ROZLnA: posts small blind $0.25
TitTV+fFCcBZWOERdytydA: posts big blind $0.50
*** HOLE CARDS ***
FqpibuVWLNsAN/Z7ROZLnA: calls $0.25
TitTV+fFCcBZWOERdytydA: checks
*** FLOP *** [4d As 9h]
TitTV+fFCcBZWOERdytydA: checks
FqpibuVWLNsAN/Z7ROZLnA: bets $1.50
TitTV+fFCcBZWOERdytydA: folds
FqpibuVWLNsAN/Z7ROZLnA collected $0.95 from pot
*** SUMMARY ***
Total pot $1 | Rake $0.05
Board [4d As 9h]
Seat 1: FqpibuVWLNsAN/Z7ROZLnA (button) (small blind) collected ($0.95)
Seat 2: TitTV+fFCcBZWOERdytydA (big blind) folded on the Flop



PokerStars Game #59941341492:  Hold'em No Limit ($0.25/$0.50) - 2009/07/01 1:32:39 ET
Table 'BCN5su+SsXiy1zRMJi0SJw' 6-max Seat #2 is the button
Seat 1: GxXV09ciXaOxyY2H5aMIIw ($32.05 in chips)
Seat 2: ehFNAevCQri3trWxV6FJdA ($57.90 in chips)
Seat 3: kwgv5lNhiFrfONXCshzxlA ($42.55 in chips)
Seat 4: bbsK8j+tpuVRhBqDzHxf7w ($50.60 in chips)
Seat 5: kxPhs4ePFqMy52CInAJ2aw ($53.05 in chips)
Seat 6: b2symlOdL7+0c9Pj4N/KlA ($68.45 in chips)
kwgv5lNhiFrfONXCshzxlA: posts small blind $0.25
bbsK8j+tpuVRhBqDzHxf7w: posts big blind $0.50
*** HOLE CARDS ***
kxPhs4ePFqMy52CInAJ2aw: raises $1.50 to $2
b2symlOdL7+0c9Pj4N/KlA: folds
GxXV09ciXaOxyY2H5aMIIw: folds
ehFNAevCQri3trWxV6FJdA: calls $2
kwgv5lNhiFrfONXCshzxlA: folds
bbsK8j+tpuVRhBqDzHxf7w: folds
*** FLOP *** [Ah Kd 4c]
kxPhs4ePFqMy52CInAJ2aw: bets $3
ehFNAevCQri3trWxV6FJdA: calls $3
*** TURN *** [Ah Kd 4c] [Jh]
kxPhs4ePFqMy52CInAJ2aw: bets $8
ehFNAevCQri3trWxV6FJdA: calls $8
*** RIVER *** [Ah Kd 4c Jh] [3h]
kxPhs4ePFqMy52CInAJ2aw: bets $16
ehFNAevCQri3trWxV6FJdA: raises $16 to $32
kxPhs4ePFqMy52CInAJ2aw: calls $16
*** SHOW DOWN ***
ehFNAevCQri3trWxV6FJdA: shows [Qd Tc] (a straight, Ten to Ace)
kxPhs4ePFqMy52CInAJ2aw: mucks hand
ehFNAevCQri3trWxV6FJdA collected $87.75 from pot
*** SUMMARY ***
Total pot $90.75 | Rake $3
Board [Ah Kd 4c Jh 3h]
Seat 1: GxXV09ciXaOxyY2H5aMIIw folded before Flop (didn't bet)
Seat 2: ehFNAevCQri3trWxV6FJdA (button) showed [Qd Tc] and won ($87.75) with a straight, Ten to Ace
Seat 3: kwgv5lNhiFrfONXCshzxlA (small blind) folded before Flop
Seat 4: bbsK8j+tpuVRhBqDzHxf7w (big blind) folded before Flop
Seat 5: kxPhs4ePFqMy52CInAJ2aw mucked
Seat 6: b2symlOdL7+0c9Pj4N/KlA folded before Flop (didn't bet)



PokerStars Game #59941342268:  Hold'em No Limit ($0.25/$0.50) - 2009/07/01 1:32:40 ET
Table 'GfL/No5u5PoEnU39lP5pQg' 6-max Seat #2 is the button
Seat 1: 1WUCqNG+p+vfWRTXNu4ljw ($50 in chips)
Seat 2: uVwggSetzp7d+eVgowO3vg ($47 in chips)
Seat 3: 4pp9WxhGdbVbxCc9tlu0lw ($25.55 in chips)
Seat 5: M1KyQQvVPVuxqTAB8sR/zQ ($62.65 in chips)
Seat 6: kxPhs4ePFqMy52CInAJ2aw ($122.95 in chips)
4pp9WxhGdbVbxCc9tlu0lw: posts small blind $0.25
1WUCqNG+p+vfWRTXNu4ljw said, "what the ****"
1WUCqNG+p+vfWRTXNu4ljw said, "how bad can i ****ing run"
r6u7MWSXF30/khcTYkrG9Q has timed out while being disconnected
r6u7MWSXF30/khcTYkrG9Q: is sitting out
M1KyQQvVPVuxqTAB8sR/zQ: posts big blind $0.50
*** HOLE CARDS ***
r6u7MWSXF30/khcTYkrG9Q has returned
4pp9WxhGdbVbxCc9tlu0lw said, "pull a set and get flushed ??"
kxPhs4ePFqMy52CInAJ2aw: raises $1.50 to $2
1WUCqNG+p+vfWRTXNu4ljw: folds
uVwggSetzp7d+eVgowO3vg: folds
4pp9WxhGdbVbxCc9tlu0lw: folds
M1KyQQvVPVuxqTAB8sR/zQ: calls $1.50
*** FLOP *** [4c Kc 3s]
M1KyQQvVPVuxqTAB8sR/zQ: checks
kxPhs4ePFqMy52CInAJ2aw: checks
*** TURN *** [4c Kc 3s] [7h]
M1KyQQvVPVuxqTAB8sR/zQ: bets $3
kxPhs4ePFqMy52CInAJ2aw: folds
M1KyQQvVPVuxqTAB8sR/zQ collected $4.05 from pot
M1KyQQvVPVuxqTAB8sR/zQ: doesn't show hand
*** SUMMARY ***
Total pot $4.25 | Rake $0.20
Board [4c Kc 3s 7h]
Seat 1: 1WUCqNG+p+vfWRTXNu4ljw folded before Flop (didn't bet)
Seat 2: uVwggSetzp7d+eVgowO3vg (button) folded before Flop (didn't bet)
Seat 3: 4pp9WxhGdbVbxCc9tlu0lw (small blind) folded before Flop
Seat 5: M1KyQQvVPVuxqTAB8sR/zQ (big blind) collected ($4.05)
Seat 6: kxPhs4ePFqMy52CInAJ2aw folded on the Turn



PokerStars Game #59941342906:  Hold'em No Limit ($0.25/$0.50) - 2009/07/01 1:32:41 ET
Table 'iq+aXfWVQRdV0u8SRTYUEg' 9-max Seat #9 is the button
Seat 1: 3yl8Q6QaLfGtyhN4/pEFgQ ($77.55 in chips)
Seat 2: J9N0lxHFd/Js2S0xZLbsIQ ($22.35 in chips)
Seat 3: Qi/PyOsKwaqtKIg0H+7ELg ($10.45 in chips)
Seat 4: vHYT5s323LpajBj+2c9zbQ ($32.10 in chips)
Seat 5: 997ViqAtWn1FPjJqcffwcA ($57.55 in chips)
Seat 7: SKnJuWHScqetA/qG5p+wCg ($30.80 in chips)
Seat 8: /DtIHuxEH+3tzKefmSV+Mw ($36.10 in chips)
Seat 9: olE1Z2rKWAV8+tGqmIBK9g ($26.20 in chips)
3yl8Q6QaLfGtyhN4/pEFgQ: posts small blind $0.25
J9N0lxHFd/Js2S0xZLbsIQ: posts big blind $0.50
*** HOLE CARDS ***
Qi/PyOsKwaqtKIg0H+7ELg: folds
vHYT5s323LpajBj+2c9zbQ: folds
997ViqAtWn1FPjJqcffwcA: raises $1.50 to $2
SKnJuWHScqetA/qG5p+wCg: folds
/DtIHuxEH+3tzKefmSV+Mw: folds
olE1Z2rKWAV8+tGqmIBK9g: folds
3yl8Q6QaLfGtyhN4/pEFgQ: folds
J9N0lxHFd/Js2S0xZLbsIQ: calls $1.50
*** FLOP *** [4s Kd 5h]
J9N0lxHFd/Js2S0xZLbsIQ: checks
997ViqAtWn1FPjJqcffwcA: checks
*** TURN *** [4s Kd 5h] [Qc]
J9N0lxHFd/Js2S0xZLbsIQ: bets $3.50
997ViqAtWn1FPjJqcffwcA: folds
J9N0lxHFd/Js2S0xZLbsIQ collected $4.05 from pot
*** SUMMARY ***
Total pot $4.25 | Rake $0.20
Board [4s Kd 5h Qc]
Seat 1: 3yl8Q6QaLfGtyhN4/pEFgQ (small blind) folded before Flop
Seat 2: J9N0lxHFd/Js2S0xZLbsIQ (big blind) collected ($4.05)
Seat 3: Qi/PyOsKwaqtKIg0H+7ELg folded before Flop (didn't bet)
Seat 4: vHYT5s323LpajBj+2c9zbQ folded before Flop (didn't bet)
Seat 5: 997ViqAtWn1FPjJqcffwcA folded on the Turn
Seat 7: SKnJuWHScqetA/qG5p+wCg folded before Flop (didn't bet)
Seat 8: /DtIHuxEH+3tzKefmSV+Mw folded before Flop (didn't bet)
Seat 9: olE1Z2rKWAV8+tGqmIBK9g (button) folded before Flop (didn't bet)



PokerStars Game #59941343474:  Hold'em No Limit ($0.25/$0.50) - 2009/07/01 1:32:42 ET
Table 'kgbJRsxfv64KrErDRBAkcw' 6-max Seat #5 is the button
Seat 1: VamsyhlFzXGF6/ydo0BHeA ($10.65 in chips)
Seat 2: AdS8BJMOheS01zjCDfPMFg ($63 in chips)
Seat 3: c4MNIaIyPMOMxrgT8FT5nA ($178.45 in chips)
Seat 4: 2igtJLmvIZ+HqX4XPgMPZA ($112.50 in chips)
Seat 5: eUBBn2R56C1IQ6Cs/vitwg ($104 in chips)
Seat 6: 1b+2BbjMN8qhR1WPqdE9VQ ($50 in chips)
1b+2BbjMN8qhR1WPqdE9VQ: posts small blind $0.25
VamsyhlFzXGF6/ydo0BHeA: posts big blind $0.50
*** HOLE CARDS ***
AdS8BJMOheS01zjCDfPMFg: folds
c4MNIaIyPMOMxrgT8FT5nA: raises $2 to $2.50
2igtJLmvIZ+HqX4XPgMPZA: folds
eUBBn2R56C1IQ6Cs/vitwg: folds
1b+2BbjMN8qhR1WPqdE9VQ: folds
VamsyhlFzXGF6/ydo0BHeA: raises $8.15 to $10.65 and is all-in
c4MNIaIyPMOMxrgT8FT5nA: calls $8.15
*** FLOP *** [4h 6h 5h]
*** TURN *** [4h 6h 5h] [7d]
*** RIVER *** [4h 6h 5h 7d] [Jd]
*** SHOW DOWN ***
VamsyhlFzXGF6/ydo0BHeA: shows [As 8d] (a straight, Four to Eight)
c4MNIaIyPMOMxrgT8FT5nA: mucks hand
VamsyhlFzXGF6/ydo0BHeA collected $20.50 from pot
*** SUMMARY ***
Total pot $21.55 | Rake $1.05
Board [4h 6h 5h 7d Jd]
Seat 1: VamsyhlFzXGF6/ydo0BHeA (big blind) showed [As 8d] and won ($20.50) with a straight, Four to Eight
Seat 2: AdS8BJMOheS01zjCDfPMFg folded before Flop (didn't bet)
Seat 3: c4MNIaIyPMOMxrgT8FT5nA mucked
Seat 4: 2igtJLmvIZ+HqX4XPgMPZA folded before Flop (didn't bet)
Seat 5: eUBBn2R56C1IQ6Cs/vitwg (button) folded before Flop (didn't bet)
Seat 6: 1b+2BbjMN8qhR1WPqdE9VQ (small blind) folded before Flop



PokerStars Game #59941343710:  Hold'em No Limit ($0.25/$0.50) - 2009/07/01 1:32:43 ET
Table '5qf8oPyYje71HBKD0FwPgQ' 9-max Seat #6 is the button
Seat 1: uw9QayAAxLM3Hb+HR7mSkg ($12 in chips)
Seat 2: M+7+BTmX5vZatHVuoRB1nA ($56.80 in chips)
Seat 3: vacmVLJJECYI6HjAynFcpg ($57.70 in chips)
Seat 4: YXCE3WOZi8g2sIf3y/plVw ($54.60 in chips)
Seat 5: uo2Sgpknd7NdeVbeSCG02A ($15.15 in chips)
Seat 6: go0Ad6tqqJ4tR9/bqVlO0g ($20.45 in chips)
Seat 7: 1q5EPoiflJRl8pqfnVLjMw ($54.75 in chips)
Seat 8: sakr/FIfFtIZwDPmAj5Pzg ($58.90 in chips)
Seat 9: jWDRpL0TJljg+mBCE9ZMqA ($7.85 in chips)
1q5EPoiflJRl8pqfnVLjMw: posts small blind $0.25
sakr/FIfFtIZwDPmAj5Pzg: posts big blind $0.50
*** HOLE CARDS ***
jWDRpL0TJljg+mBCE9ZMqA: folds
uw9QayAAxLM3Hb+HR7mSkg: folds
M+7+BTmX5vZatHVuoRB1nA: folds
vacmVLJJECYI6HjAynFcpg: folds
YXCE3WOZi8g2sIf3y/plVw: folds
uo2Sgpknd7NdeVbeSCG02A: folds
go0Ad6tqqJ4tR9/bqVlO0g: folds
1q5EPoiflJRl8pqfnVLjMw: calls $0.25
sakr/FIfFtIZwDPmAj5Pzg: checks
*** FLOP *** [Qs Kc 5d]
1q5EPoiflJRl8pqfnVLjMw: checks
sakr/FIfFtIZwDPmAj5Pzg: checks
*** TURN *** [Qs Kc 5d] [2h]
1q5EPoiflJRl8pqfnVLjMw: checks
sakr/FIfFtIZwDPmAj5Pzg: checks
*** RIVER *** [Qs Kc 5d 2h] [2c]
1q5EPoiflJRl8pqfnVLjMw: checks
sakr/FIfFtIZwDPmAj5Pzg: checks
*** SHOW DOWN ***
1q5EPoiflJRl8pqfnVLjMw: shows [8c 3s] (a pair of Deuces)
sakr/FIfFtIZwDPmAj5Pzg: shows [Td 6c] (a pair of Deuces - King+Queen+Ten kicker)
sakr/FIfFtIZwDPmAj5Pzg collected $0.95 from pot
*** SUMMARY ***
Total pot $1 | Rake $0.05
Board [Qs Kc 5d 2h 2c]
Seat 1: uw9QayAAxLM3Hb+HR7mSkg folded before Flop (didn't bet)
Seat 2: M+7+BTmX5vZatHVuoRB1nA folded before Flop (didn't bet)
Seat 3: vacmVLJJECYI6HjAynFcpg folded before Flop (didn't bet)
Seat 4: YXCE3WOZi8g2sIf3y/plVw folded before Flop (didn't bet)
Seat 5: uo2Sgpknd7NdeVbeSCG02A folded before Flop (didn't bet)
Seat 6: go0Ad6tqqJ4tR9/bqVlO0g (button) folded before Flop (didn't bet)
Seat 7: 1q5EPoiflJRl8pqfnVLjMw (small blind) showed [8c 3s] and lost with a pair of Deuces
Seat 8: sakr/FIfFtIZwDPmAj5Pzg (big blind) showed [Td 6c] and won ($0.95) with a pair of Deuces
Seat 9: jWDRpL0TJljg+mBCE9ZMqA folded before Flop (didn't bet)



PokerStars Game #59941344560:  Hold'em No Limit ($0.25/$0.50) - 2009/07/01 1:32:44 ET
Table 'fx6MqwfYAj/Rt86hBz2L3Q' 9-max Seat #1 is the button
Seat 1: v/4aX0ejnaIFK4ftDk2Lyg ($50.65 in chips)
Seat 2: C3rGXblctNcWI6JYPHhaEg ($56.20 in chips)
Seat 3: iadBi5AEt7gTBXbDSSnMYQ ($37.80 in chips)
Seat 4: VhjwWfxHSx00WxzYih3KOA ($50 in chips)
Seat 5: iAISe3dVeua8PUn2wwgDHw ($77.30 in chips)
Seat 6: 5k9fvXD9suIgCxU4HLQjTw ($50 in chips)
Seat 7: mSD1pginDsyHG5PDfqzphw ($10 in chips)
Seat 8: JYwJYYV9pM5KWdSiETl8rA ($32.85 in chips)
Seat 9: vO3QVRovWemcGMkm7ijAIA ($24.95 in chips)
C3rGXblctNcWI6JYPHhaEg: posts small blind $0.25
iadBi5AEt7gTBXbDSSnMYQ: posts big blind $0.50
*** HOLE CARDS ***
VhjwWfxHSx00WxzYih3KOA: folds
iAISe3dVeua8PUn2wwgDHw: calls $0.50
5k9fvXD9suIgCxU4HLQjTw: folds
iadBi5AEt7gTBXbDSSnMYQ said, "nh"
mSD1pginDsyHG5PDfqzphw: folds
JYwJYYV9pM5KWdSiETl8rA: folds
C3rGXblctNcWI6JYPHhaEg said, "ty :)"
vO3QVRovWemcGMkm7ijAIA: calls $0.50
JYwJYYV9pM5KWdSiETl8rA leaves the table
v/4aX0ejnaIFK4ftDk2Lyg: folds
C3rGXblctNcWI6JYPHhaEg: calls $0.25
iadBi5AEt7gTBXbDSSnMYQ: checks
*** FLOP *** [3c 7d 4d]
C3rGXblctNcWI6JYPHhaEg: checks
iadBi5AEt7gTBXbDSSnMYQ: checks
iAISe3dVeua8PUn2wwgDHw: checks
vO3QVRovWemcGMkm7ijAIA: checks
*** TURN *** [3c 7d 4d] [7c]
C3rGXblctNcWI6JYPHhaEg: bets $0.70
iadBi5AEt7gTBXbDSSnMYQ: calls $0.70
iAISe3dVeua8PUn2wwgDHw: raises $0.70 to $1.40
vO3QVRovWemcGMkm7ijAIA: folds
C3rGXblctNcWI6JYPHhaEg: raises $0.70 to $2.10
iadBi5AEt7gTBXbDSSnMYQ: folds
iAISe3dVeua8PUn2wwgDHw: calls $0.70
*** RIVER *** [3c 7d 4d 7c] [2h]
75K2MXwN65Sjfp1yHd50Hg joins the table at seat #8
C3rGXblctNcWI6JYPHhaEg: bets $3.60
iAISe3dVeua8PUn2wwgDHw: calls $3.60
*** SHOW DOWN ***
C3rGXblctNcWI6JYPHhaEg: shows [3d 7s] (a full house, Sevens full of Threes)
iAISe3dVeua8PUn2wwgDHw: mucks hand
C3rGXblctNcWI6JYPHhaEg collected $13.45 from pot
*** SUMMARY ***
Total pot $14.10 | Rake $0.65
Board [3c 7d 4d 7c 2h]
Seat 1: v/4aX0ejnaIFK4ftDk2Lyg (button) folded before Flop (didn't bet)
Seat 2: C3rGXblctNcWI6JYPHhaEg (small blind) showed [3d 7s] and won ($13.45) with a full house, Sevens full of Threes
Seat 3: iadBi5AEt7gTBXbDSSnMYQ (big blind) folded on the Turn
Seat 4: VhjwWfxHSx00WxzYih3KOA folded before Flop (didn't bet)
Seat 5: iAISe3dVeua8PUn2wwgDHw mucked
Seat 6: 5k9fvXD9suIgCxU4HLQjTw folded before Flop (didn't bet)
Seat 7: mSD1pginDsyHG5PDfqzphw folded before Flop (didn't bet)
Seat 8: JYwJYYV9pM5KWdSiETl8rA folded before Flop (didn't bet)
Seat 9: vO3QVRovWemcGMkm7ijAIA folded on the Turn



PokerStars Game #59941346584:  Hold'em No Limit ($0.25/$0.50) - 2009/07/01 1:32:47 ET
Table 'cofQFHU7jbJoFecLVBof/w' 6-max Seat #1 is the button
Seat 1: URYNc7fPA23K2UfadQbnCA ($45.25 in chips)
Seat 2: f89uTQr3ieGlusj2IAYAEg ($50 in chips)
Seat 3: v4ctePcLlQw0r8E0qJtjYw ($49.30 in chips)
Seat 4: g6lz8npaeeTJmJegtPYhlQ ($20.10 in chips)
Seat 5: QvwRlrpVqerRRF8eJm6dDw ($48.65 in chips)
Seat 6: 7+uQ0OOgCTbR4ltkSwyC0g ($159.80 in chips)
f89uTQr3ieGlusj2IAYAEg: posts small blind $0.25
v4ctePcLlQw0r8E0qJtjYw: posts big blind $0.50
*** HOLE CARDS ***
g6lz8npaeeTJmJegtPYhlQ: folds
QvwRlrpVqerRRF8eJm6dDw: folds
7+uQ0OOgCTbR4ltkSwyC0g: raises $1 to $1.50
URYNc7fPA23K2UfadQbnCA: folds
f89uTQr3ieGlusj2IAYAEg: folds
v4ctePcLlQw0r8E0qJtjYw: folds
7+uQ0OOgCTbR4ltkSwyC0g collected $1.25 from pot
*** SUMMARY ***
Total pot $1.25 | Rake $0
Seat 1: URYNc7fPA23K2UfadQbnCA (button) folded before Flop (didn't bet)
Seat 2: f89uTQr3ieGlusj2IAYAEg (small blind) folded before Flop
Seat 3: v4ctePcLlQw0r8E0qJtjYw (big blind) folded before Flop
Seat 4: g6lz8npaeeTJmJegtPYhlQ folded before Flop (didn't bet)
Seat 5: QvwRlrpVqerRRF8eJm6dDw folded before Flop (didn't bet)
Seat 6: 7+uQ0OOgCTbR4ltkSwyC0g collected ($1.25)



PokerStars Game #59941348150:  Hold'em No Limit ($0.25/$0.50) - 2009/07/01 1:32:50 ET
Table 'hWT2kq66tnKEpD26cia6fQ' 2-max Seat #1 is the button
Seat 1: Ce3KNFP+ao7Da9NHb65raw ($49.25 in chips)
Seat 2: 16tvT7AYgZ2LgiGFcvFKQg ($26.30 in chips)
Ce3KNFP+ao7Da9NHb65raw: posts small blind $0.25
16tvT7AYgZ2LgiGFcvFKQg: posts big blind $0.50
*** HOLE CARDS ***
Ce3KNFP+ao7Da9NHb65raw: calls $0.25
16tvT7AYgZ2LgiGFcvFKQg: checks
*** FLOP *** [4d Jc As]
16tvT7AYgZ2LgiGFcvFKQg: checks
Ce3KNFP+ao7Da9NHb65raw: bets $0.50
16tvT7AYgZ2LgiGFcvFKQg: folds
Ce3KNFP+ao7Da9NHb65raw collected $0.95 from pot
*** SUMMARY ***
Total pot $1 | Rake $0.05
Board [4d Jc As]
Seat 1: Ce3KNFP+ao7Da9NHb65raw (button) (small blind) collected ($0.95)
Seat 2: 16tvT7AYgZ2LgiGFcvFKQg (big blind) folded on the Flop



PokerStars Game #59941348092:  Hold'em No Limit ($0.25/$0.50) - 2009/07/01 1:32:50 ET
Table 'Wwfm5/i+g/g2Nj2gT3jnVQ' 2-max Seat #2 is the button
Seat 1: CHRLZDaaxjbo68bwQD1C/Q ($12.10 in chips)
Seat 2: PKuuhUvIr5WSkJyPJa9dFw ($19.75 in chips)
PKuuhUvIr5WSkJyPJa9dFw: posts small blind $0.25
CHRLZDaaxjbo68bwQD1C/Q: posts big blind $0.50
*** HOLE CARDS ***
PKuuhUvIr5WSkJyPJa9dFw: folds
CHRLZDaaxjbo68bwQD1C/Q collected $0.50 from pot
CHRLZDaaxjbo68bwQD1C/Q: doesn't show hand
*** SUMMARY ***
Total pot $0.50 | Rake $0
Seat 1: CHRLZDaaxjbo68bwQD1C/Q (big blind) collected ($0.50)
Seat 2: PKuuhUvIr5WSkJyPJa9dFw (button) (small blind) folded before Flop



PokerStars Game #59941348428:  Hold'em No Limit ($0.25/$0.50) - 2009/07/01 1:32:51 ET
Table '+z1aekfHkpp09pc8F9aViw' 6-max Seat #2 is the button
Seat 2: 4QfsCWthT/vSLirorNXqtg ($50.75 in chips)
Seat 3: URYNc7fPA23K2UfadQbnCA ($48 in chips)
Seat 4: RowCSpSURHTOL/dcjg/Iug ($86.45 in chips)
Seat 5: 2igtJLmvIZ+HqX4XPgMPZA ($50.95 in chips)
Seat 6: GUnvMULl2qFOO1yenu1UBw ($52.25 in chips)
URYNc7fPA23K2UfadQbnCA: posts small blind $0.25
RowCSpSURHTOL/dcjg/Iug: posts big blind $0.50
9r1sdCwEwebh7DF+/EQqGg: sits out
*** HOLE CARDS ***
2igtJLmvIZ+HqX4XPgMPZA: folds
GUnvMULl2qFOO1yenu1UBw: folds
4QfsCWthT/vSLirorNXqtg: folds
URYNc7fPA23K2UfadQbnCA: folds
RowCSpSURHTOL/dcjg/Iug collected $0.50 from pot
*** SUMMARY ***
Total pot $0.50 | Rake $0
Seat 2: 4QfsCWthT/vSLirorNXqtg (button) folded before Flop (didn't bet)
Seat 3: URYNc7fPA23K2UfadQbnCA (small blind) folded before Flop
Seat 4: RowCSpSURHTOL/dcjg/Iug (big blind) collected ($0.50)
Seat 5: 2igtJLmvIZ+HqX4XPgMPZA folded before Flop (didn't bet)
Seat 6: GUnvMULl2qFOO1yenu1UBw folded before Flop (didn't bet)



PokerStars Game #59941349656:  Hold'em No Limit ($0.25/$0.50) - 2009/07/01 1:32:53 ET
Table '9ojijpRcYQSQTh6xI+haUA' 2-max Seat #2 is the button
Seat 1: FqpibuVWLNsAN/Z7ROZLnA ($35 in chips)
Seat 2: TitTV+fFCcBZWOERdytydA ($49.45 in chips)
TitTV+fFCcBZWOERdytydA: posts small blind $0.25
FqpibuVWLNsAN/Z7ROZLnA: posts big blind $0.50
*** HOLE CARDS ***
TitTV+fFCcBZWOERdytydA: raises $1 to $1.50
FqpibuVWLNsAN/Z7ROZLnA: folds
TitTV+fFCcBZWOERdytydA collected $1 from pot
TitTV+fFCcBZWOERdytydA: doesn't show hand
*** SUMMARY ***
Total pot $1 | Rake $0
Seat 1: FqpibuVWLNsAN/Z7ROZLnA (big blind) folded before Flop
Seat 2: TitTV+fFCcBZWOERdytydA (button) (small blind) collected ($1)



PokerStars Game #59941350034:  Hold'em No Limit ($0.25/$0.50) - 2009/07/01 1:32:53 ET
Table 'B+sqsfj6d6zXicNfaseTaw' 2-max Seat #2 is the button
Seat 1: +4GNcSsecmapVGSdV0mUPA ($155.40 in chips)
Seat 2: Lv5RmpRe6LtPkBzM9Gpo5A ($68.20 in chips)
Lv5RmpRe6LtPkBzM9Gpo5A: posts small blind $0.25
+4GNcSsecmapVGSdV0mUPA: posts big blind $0.50
*** HOLE CARDS ***
Lv5RmpRe6LtPkBzM9Gpo5A: calls $0.25
+4GNcSsecmapVGSdV0mUPA: checks
*** FLOP *** [8c As 4c]
+4GNcSsecmapVGSdV0mUPA: checks
Lv5RmpRe6LtPkBzM9Gpo5A: checks
*** TURN *** [8c As 4c] [Ac]
+4GNcSsecmapVGSdV0mUPA: checks
Lv5RmpRe6LtPkBzM9Gpo5A: checks
*** RIVER *** [8c As 4c Ac] [Qh]
+4GNcSsecmapVGSdV0mUPA: checks
Lv5RmpRe6LtPkBzM9Gpo5A: checks
*** SHOW DOWN ***
+4GNcSsecmapVGSdV0mUPA: shows [9c Th] (a pair of Aces)
Lv5RmpRe6LtPkBzM9Gpo5A: shows [8h Kh] (two pair, Aces and Eights)
Lv5RmpRe6LtPkBzM9Gpo5A collected $0.95 from pot
*** SUMMARY ***
Total pot $1 | Rake $0.05
Board [8c As 4c Ac Qh]
Seat 1: +4GNcSsecmapVGSdV0mUPA (big blind) showed [9c Th] and lost with a pair of Aces
Seat 2: Lv5RmpRe6LtPkBzM9Gpo5A (button) (small blind) showed [8h Kh] and won ($0.95) with two pair, Aces and Eights



PokerStars Game #59941350330:  Hold'em No Limit ($0.25/$0.50) - 2009/07/01 1:32:54 ET
Table '2lPOwetm4cfkZPbTmGPH/w' 2-max Seat #1 is the button
Seat 1: vUGdApqS8J/GJE2gaVWl1w ($14.60 in chips)
Seat 2: XFa6sBGjP2gxoIvxR3fZIg ($25.60 in chips)
vUGdApqS8J/GJE2gaVWl1w: posts small blind $0.25
XFa6sBGjP2gxoIvxR3fZIg: posts big blind $0.50
*** HOLE CARDS ***
vUGdApqS8J/GJE2gaVWl1w: folds
XFa6sBGjP2gxoIvxR3fZIg collected $0.50 from pot
*** SUMMARY ***
Total pot $0.50 | Rake $0
Seat 1: vUGdApqS8J/GJE2gaVWl1w (button) (small blind) folded before Flop
Seat 2: XFa6sBGjP2gxoIvxR3fZIg (big blind) collected ($0.50)



PokerStars Game #59941350192:  Hold'em No Limit ($0.25/$0.50) - 2009/07/01 1:32:54 ET
Table 'ofnd8S4IdIPph1Cbn+x7hAbR5MkGhKEbz+X2bpfpu11Qmax Seat #4 is the button
Seat 1: qG3y+yB3IhWjAWO8gvk6Rg ($48.80 in chips)
Seat 2: 1xBtrSVBbgFH/viUWKqQeg ($29.95 in chips)
Seat 3: JYwJYYV9pM5KWdSiETl8rA ($29.25 in chips)
Seat 4: mZNMJI1mY40XTC0U7GZakA ($62.45 in chips)
Seat 7: kJ06FP2Jc7cSdmywwvYOXw ($54.25 in chips)
Seat 8: R354x4oZnQcGCDV6GhjnpQ ($62.40 in chips)
Seat 9: 75K2MXwN65Sjfp1yHd50Hg ($8.50 in chips)
kJ06FP2Jc7cSdmywwvYOXw: posts small blind $0.25
R354x4oZnQcGCDV6GhjnpQ: posts big blind $0.50
*** HOLE CARDS ***
75K2MXwN65Sjfp1yHd50Hg: raises $1 to $1.50
qG3y+yB3IhWjAWO8gvk6Rg: folds
1xBtrSVBbgFH/viUWKqQeg: folds
JYwJYYV9pM5KWdSiETl8rA: folds
JYwJYYV9pM5KWdSiETl8rA leaves the table
mZNMJI1mY40XTC0U7GZakA: folds
2YaCb/8u1SesrR+963XiZA has returned
kJ06FP2Jc7cSdmywwvYOXw: calls $1.25
R354x4oZnQcGCDV6GhjnpQ: calls $1
*** FLOP *** [8s Jh Qc]
kJ06FP2Jc7cSdmywwvYOXw: checks
R354x4oZnQcGCDV6GhjnpQ: checks
75K2MXwN65Sjfp1yHd50Hg: bets $2
kJ06FP2Jc7cSdmywwvYOXw: calls $2
R354x4oZnQcGCDV6GhjnpQ: folds
*** TURN *** [8s Jh Qc] [As]
UVJbBPbDwNMEZadZB9WVmg joins the table at seat #3
kJ06FP2Jc7cSdmywwvYOXw: bets $4.50
75K2MXwN65Sjfp1yHd50Hg: raises $0.50 to $5 and is all-in
kJ06FP2Jc7cSdmywwvYOXw: calls $0.50
*** RIVER *** [8s Jh Qc As] [3d]
*** SHOW DOWN ***
kJ06FP2Jc7cSdmywwvYOXw: shows [9s Ad] (a pair of Aces)
75K2MXwN65Sjfp1yHd50Hg: mucks hand
kJ06FP2Jc7cSdmywwvYOXw collected $17.60 from pot
*** SUMMARY ***
Total pot $18.50 | Rake $0.90
Board [8s Jh Qc As 3d]
Seat 1: qG3y+yB3IhWjAWO8gvk6Rg folded before Flop (didn't bet)
Seat 2: 1xBtrSVBbgFH/viUWKqQeg folded before Flop (didn't bet)
Seat 3: JYwJYYV9pM5KWdSiETl8rA folded before Flop (didn't bet)
Seat 4: mZNMJI1mY40XTC0U7GZakA (button) folded before Flop (didn't bet)
Seat 7: kJ06FP2Jc7cSdmywwvYOXw (small blind) showed [9s Ad] and won ($17.60) with a pair of Aces
Seat 8: R354x4oZnQcGCDV6GhjnpQ (big blind) folded on the Flop
Seat 9: 75K2MXwN65Sjfp1yHd50Hg mucked



PokerStars Game #59941351262:  Hold'em No Limit ($0.25/$0.50) - 2009/07/01 1:32:55 ET
Table 'Wwfm5/i+g/g2Nj2gT3jnVQ' 2-max Seat #1 is the button
Seat 1: CHRLZDaaxjbo68bwQD1C/Q ($12.35 in chips)
Seat 2: PKuuhUvIr5WSkJyPJa9dFw ($19.50 in chips)
CHRLZDaaxjbo68bwQD1C/Q: posts small blind $0.25
PKuuhUvIr5WSkJyPJa9dFw: posts big blind $0.50
*** HOLE CARDS ***
CHRLZDaaxjbo68bwQD1C/Q: raises $0.50 to $1
PKuuhUvIr5WSkJyPJa9dFw: calls $0.50
*** FLOP *** [3s Td Ac]
PKuuhUvIr5WSkJyPJa9dFw: checks
CHRLZDaaxjbo68bwQD1C/Q: bets $0.50
PKuuhUvIr5WSkJyPJa9dFw: calls $0.50
*** TURN *** [3s Td Ac] [2h]
PKuuhUvIr5WSkJyPJa9dFw: checks
CHRLZDaaxjbo68bwQD1C/Q: bets $0.50
PKuuhUvIr5WSkJyPJa9dFw: calls $0.50
*** RIVER *** [3s Td Ac 2h] [Ks]
PKuuhUvIr5WSkJyPJa9dFw: checks
CHRLZDaaxjbo68bwQD1C/Q: bets $2
PKuuhUvIr5WSkJyPJa9dFw: folds
CHRLZDaaxjbo68bwQD1C/Q collected $3.85 from pot
CHRLZDaaxjbo68bwQD1C/Q: doesn't show hand
*** SUMMARY ***
Total pot $4 | Rake $0.15
Board [3s Td Ac 2h Ks]
Seat 1: CHRLZDaaxjbo68bwQD1C/Q (button) (small blind) collected ($3.85)
Seat 2: PKuuhUvIr5WSkJyPJa9dFw (big blind) folded on the River



PokerStars Game #59941351096:  Hold'em No Limit ($0.25/$0.50) - 2009/07/01 1:32:55 ET
Table '3FhG0gl3kMX3wBEEqj+wnQ' 9-max Seat #7 is the button
Seat 1: bxLSulbgr8LmKNjOzw8URg ($49.30 in chips)
Seat 2: vacmVLJJECYI6HjAynFcpg ($49.85 in chips)
Seat 3: YXCE3WOZi8g2sIf3y/plVw ($62.30 in chips)
Seat 4: e2+sK/yjnj94rXOKoxPP2A ($69.50 in chips)
Seat 5: XcLXSUMHSpshK/7Lh0M4Vg ($8.50 in chips)
Seat 6: 997ViqAtWn1FPjJqcffwcA ($109.80 in chips)
Seat 7: mSD1pginDsyHG5PDfqzphw ($10 in chips)
Seat 8: j3K/Jujr7PY4ZM2RZvlH6A ($54.90 in chips)
j3K/Jujr7PY4ZM2RZvlH6A: posts small blind $0.25
bxLSulbgr8LmKNjOzw8URg: posts big blind $0.50
*** HOLE CARDS ***
vacmVLJJECYI6HjAynFcpg: folds
YXCE3WOZi8g2sIf3y/plVw: folds
e2+sK/yjnj94rXOKoxPP2A: folds
XcLXSUMHSpshK/7Lh0M4Vg: folds
997ViqAtWn1FPjJqcffwcA: folds
mSD1pginDsyHG5PDfqzphw: folds
j3K/Jujr7PY4ZM2RZvlH6A: raises $0.50 to $1
bxLSulbgr8LmKNjOzw8URg: calls $0.50
*** FLOP *** [8c 7c 2s]
j3K/Jujr7PY4ZM2RZvlH6A: bets $1.50
bxLSulbgr8LmKNjOzw8URg: calls $1.50
*** TURN *** [8c 7c 2s] [7s]
j3K/Jujr7PY4ZM2RZvlH6A: bets $3.50
bxLSulbgr8LmKNjOzw8URg: calls $3.50
*** RIVER *** [8c 7c 2s 7s] [Jd]
j3K/Jujr7PY4ZM2RZvlH6A: bets $7
bxLSulbgr8LmKNjOzw8URg: folds
j3K/Jujr7PY4ZM2RZvlH6A collected $11.45 from pot
j3K/Jujr7PY4ZM2RZvlH6A: doesn't show hand
*** SUMMARY ***
Total pot $12 | Rake $0.55
Board [8c 7c 2s 7s Jd]
Seat 1: bxLSulbgr8LmKNjOzw8URg (big blind) folded on the River
Seat 2: vacmVLJJECYI6HjAynFcpg folded before Flop (didn't bet)
Seat 3: YXCE3WOZi8g2sIf3y/plVw folded before Flop (didn't bet)
Seat 4: e2+sK/yjnj94rXOKoxPP2A folded before Flop (didn't bet)
Seat 5: XcLXSUMHSpshK/7Lh0M4Vg folded before Flop (didn't bet)
Seat 6: 997ViqAtWn1FPjJqcffwcA folded before Flop (didn't bet)
Seat 7: mSD1pginDsyHG5PDfqzphw (button) folded before Flop (didn't bet)
Seat 8: j3K/Jujr7PY4ZM2RZvlH6A (small blind) collected ($11.45)



PokerStars Game #59941351304:  Hold'em No Limit ($0.25/$0.50) - 2009/07/01 1:32:56 ET
Table '8BQGgNetI1NOvWeu3gtMNw' 2-max Seat #1 is the button
Seat 1: bypIyrYcAAifLfhZpGlKLA ($82.15 in chips)
Seat 2: Z4HwehErEwzsv/noQlfUlg ($134.05 in chips)
bypIyrYcAAifLfhZpGlKLA: posts small blind $0.25
Z4HwehErEwzsv/noQlfUlg: posts big blind $0.50
*** HOLE CARDS ***
bypIyrYcAAifLfhZpGlKLA: raises $1 to $1.50
Z4HwehErEwzsv/noQlfUlg: calls $1
*** FLOP *** [9d Ah 9h]
Z4HwehErEwzsv/noQlfUlg: bets $1.50
bypIyrYcAAifLfhZpGlKLA: raises $4 to $5.50
Z4HwehErEwzsv/noQlfUlg: folds
bypIyrYcAAifLfhZpGlKLA collected $5.75 from pot
bypIyrYcAAifLfhZpGlKLA: doesn't show hand
*** SUMMARY ***
Total pot $6 | Rake $0.25
Board [9d Ah 9h]
Seat 1: bypIyrYcAAifLfhZpGlKLA (button) (small blind) collected ($5.75)
Seat 2: Z4HwehErEwzsv/noQlfUlg (big blind) folded on the Flop



PokerStars Game #59941352838:  Hold'em No Limit ($0.25/$0.50) - 2009/07/01 1:32:58 ET
Table '+dXkOAQyS8j9PQZusUTMpg' 2-max Seat #2 is the button
Seat 1: Teld4PDKla7C8/Wfu2DSkg ($57.70 in chips)
Seat 2: +zI4bP23YIjMkUHqeN2xfw ($18.15 in chips)
+zI4bP23YIjMkUHqeN2xfw: posts small blind $0.25
Teld4PDKla7C8/Wfu2DSkg: posts big blind $0.50
*** HOLE CARDS ***
+zI4bP23YIjMkUHqeN2xfw: raises $1 to $1.50
Teld4PDKla7C8/Wfu2DSkg: folds
+zI4bP23YIjMkUHqeN2xfw collected $1 from pot
*** SUMMARY ***
Total pot $1 | Rake $0
Seat 1: Teld4PDKla7C8/Wfu2DSkg (big blind) folded before Flop
Seat 2: +zI4bP23YIjMkUHqeN2xfw (button) (small blind) collected ($1)



PokerStars Game #59941353926:  Hold'em No Limit ($0.25/$0.50) - 2009/07/01 1:33:00 ET
Table '2lPOwetm4cfkZPbTmGPH/w' 2-max Seat #2 is the button
Seat 1: vUGdApqS8J/GJE2gaVWl1w ($14.35 in chips)
Seat 2: XFa6sBGjP2gxoIvxR3fZIg ($25.85 in chips)
XFa6sBGjP2gxoIvxR3fZIg: posts small blind $0.25
vUGdApqS8J/GJE2gaVWl1w: posts big blind $0.50
*** HOLE CARDS ***
XFa6sBGjP2gxoIvxR3fZIg: calls $0.25
vUGdApqS8J/GJE2gaVWl1w: checks
*** FLOP *** [Th 4h 3h]
vUGdApqS8J/GJE2gaVWl1w: checks
XFa6sBGjP2gxoIvxR3fZIg: bets $1
vUGdApqS8J/GJE2gaVWl1w: raises $1.50 to $2.50
XFa6sBGjP2gxoIvxR3fZIg: raises $10 to $12.50
vUGdApqS8J/GJE2gaVWl1w: raises $1.35 to $13.85 and is all-in
XFa6sBGjP2gxoIvxR3fZIg: calls $1.35
*** TURN *** [Th 4h 3h] [9c]
*** RIVER *** [Th 4h 3h 9c] [Qs]
*** SHOW DOWN ***
vUGdApqS8J/GJE2gaVWl1w: shows [3c 4c] (two pair, Fours and Threes)
XFa6sBGjP2gxoIvxR3fZIg: mucks hand
vUGdApqS8J/GJE2gaVWl1w collected $28.20 from pot
*** SUMMARY ***
Total pot $28.70 | Rake $0.50
Board [Th 4h 3h 9c Qs]
Seat 1: vUGdApqS8J/GJE2gaVWl1w (big blind) showed [3c 4c] and won ($28.20) with two pair, Fours and Threes
Seat 2: XFa6sBGjP2gxoIvxR3fZIg (button) (small blind) mucked



PokerStars Game #59941354520:  Hold'em No Limit ($0.25/$0.50) - 2009/07/01 1:33:01 ET
Table '9ojijpRcYQSQTh6xI+haUA' 2-max Seat #1 is the button
Seat 1: FqpibuVWLNsAN/Z7ROZLnA ($34.50 in chips)
Seat 2: TitTV+fFCcBZWOERdytydA ($49.95 in chips)
FqpibuVWLNsAN/Z7ROZLnA: posts small blind $0.25
TitTV+fFCcBZWOERdytydA: posts big blind $0.50
*** HOLE CARDS ***
FqpibuVWLNsAN/Z7ROZLnA: folds
TitTV+fFCcBZWOERdytydA collected $0.50 from pot
TitTV+fFCcBZWOERdytydA: doesn't show hand
*** SUMMARY ***
Total pot $0.50 | Rake $0
Seat 1: FqpibuVWLNsAN/Z7ROZLnA (button) (small blind) folded before Flop
Seat 2: TitTV+fFCcBZWOERdytydA (big blind) collected ($0.50)



PokerStars Game #59941354826:  Hold'em No Limit ($0.25/$0.50) - 2009/07/01 1:33:02 ET
Table 'lSisgp6H7Fg1hH5VfjEjYQ' 9-max Seat #2 is the button
Seat 1: 5k9fvXD9suIgCxU4HLQjTw ($54.05 in chips)
Seat 2: 5acK4E7fzEwnplVBZ6eNWA ($50 in chips)
Seat 3: SKnJuWHScqetA/qG5p+wCg ($30 in chips)
Seat 5: mSD1pginDsyHG5PDfqzphw ($12.25 in chips)
Seat 6: +k7T5ocke8UwavtgUHm+Cg ($75.20 in chips)
Seat 7: IDtNLR9uFCDdjNsJWMHA5Q ($21.05 in chips)
Seat 8: a4JDWmpFQkL10XfAyuF51A ($9.50 in chips)
Seat 9: YzeKFbJVLmJGTgNH3ySQlw ($6.45 in chips)
SKnJuWHScqetA/qG5p+wCg: posts small blind $0.25
mSD1pginDsyHG5PDfqzphw: posts big blind $0.50
*** HOLE CARDS ***
+k7T5ocke8UwavtgUHm+Cg: folds
IDtNLR9uFCDdjNsJWMHA5Q: folds
a4JDWmpFQkL10XfAyuF51A: folds
FFVKBJT0lZf+jFlgvy7ang joins the table at seat #4
YzeKFbJVLmJGTgNH3ySQlw: calls $0.50
5k9fvXD9suIgCxU4HLQjTw: folds
5acK4E7fzEwnplVBZ6eNWA: folds
SKnJuWHScqetA/qG5p+wCg: calls $0.25
mSD1pginDsyHG5PDfqzphw: checks
*** FLOP *** [5d 2c 5s]
SKnJuWHScqetA/qG5p+wCg: checks
mSD1pginDsyHG5PDfqzphw: checks
YzeKFbJVLmJGTgNH3ySQlw: checks
*** TURN *** [5d 2c 5s] [Ad]
SKnJuWHScqetA/qG5p+wCg: checks
mSD1pginDsyHG5PDfqzphw: checks
YzeKFbJVLmJGTgNH3ySQlw: bets $1
SKnJuWHScqetA/qG5p+wCg: folds
mSD1pginDsyHG5PDfqzphw: folds
YzeKFbJVLmJGTgNH3ySQlw collected $1.45 from pot
*** SUMMARY ***
Total pot $1.50 | Rake $0.05
Board [5d 2c 5s Ad]
Seat 1: 5k9fvXD9suIgCxU4HLQjTw folded before Flop (didn't bet)
Seat 2: 5acK4E7fzEwnplVBZ6eNWA (button) folded before Flop (didn't bet)
Seat 3: SKnJuWHScqetA/qG5p+wCg (small blind) folded on the Turn
Seat 5: mSD1pginDsyHG5PDfqzphw (big blind) folded on the Turn
Seat 6: +k7T5ocke8UwavtgUHm+Cg folded before Flop (didn't bet)
Seat 7: IDtNLR9uFCDdjNsJWMHA5Q folded before Flop (didn't bet)
Seat 8: a4JDWmpFQkL10XfAyuF51A folded before Flop (didn't bet)
Seat 9: YzeKFbJVLmJGTgNH3ySQlw collected ($1.45)



PokerStars Game #59941355718:  Hold'em No Limit ($0.25/$0.50) - 2009/07/01 1:33:03 ET
Table '99gCy/CZQwPIjZWH+BguQg' 9-max Seat #7 is the button
Seat 2: 7CKaQEWhd40e2lLifzZ1Cw ($29.50 in chips)
Seat 4: bxLSulbgr8LmKNjOzw8URg ($86.70 in chips)
Seat 5: YXCE3WOZi8g2sIf3y/plVw ($50.90 in chips)
Seat 6: OcnLOMVFdy23jXnoTyaO5Q ($293.60 in chips)
Seat 7: ottZQkg1UDWk85BtBzGJzg ($29 in chips)
Seat 8: 8ehL7qlZzjgUh2H35iiWLw ($50 in chips)
Seat 9: j3K/Jujr7PY4ZM2RZvlH6A ($77.75 in chips)
8ehL7qlZzjgUh2H35iiWLw: posts small blind $0.25
j3K/Jujr7PY4ZM2RZvlH6A: posts big blind $0.50
Bawookles: sits out
VhjwWfxHSx00WxzYih3KOA: sits out
*** HOLE CARDS ***
7CKaQEWhd40e2lLifzZ1Cw: folds
bxLSulbgr8LmKNjOzw8URg: folds
YXCE3WOZi8g2sIf3y/plVw: folds
OcnLOMVFdy23jXnoTyaO5Q: calls $0.50
ottZQkg1UDWk85BtBzGJzg: folds
8ehL7qlZzjgUh2H35iiWLw: folds
j3K/Jujr7PY4ZM2RZvlH6A: checks
*** FLOP *** [6d Kh 3d]
8ehL7qlZzjgUh2H35iiWLw leaves the table
j3K/Jujr7PY4ZM2RZvlH6A: bets $2.50
OcnLOMVFdy23jXnoTyaO5Q: folds
j3K/Jujr7PY4ZM2RZvlH6A collected $1.20 from pot
j3K/Jujr7PY4ZM2RZvlH6A: doesn't show hand
*** SUMMARY ***
Total pot $1.25 | Rake $0.05
Board [6d Kh 3d]
Seat 2: 7CKaQEWhd40e2lLifzZ1Cw folded before Flop (didn't bet)
Seat 4: bxLSulbgr8LmKNjOzw8URg folded before Flop (didn't bet)
Seat 5: YXCE3WOZi8g2sIf3y/plVw folded before Flop (didn't bet)
Seat 6: OcnLOMVFdy23jXnoTyaO5Q folded on the Flop
Seat 7: ottZQkg1UDWk85BtBzGJzg (button) folded before Flop (didn't bet)
Seat 8: 8ehL7qlZzjgUh2H35iiWLw (small blind) folded before Flop
Seat 9: j3K/Jujr7PY4ZM2RZvlH6A (big blind) collected ($1.20)



PokerStars Game #59941355988:  Hold'em No Limit ($0.25/$0.50) - 2009/07/01 1:33:04 ET
Table 'cofQFHU7jbJoFecLVBof/w' 6-max Seat #2 is the button
Seat 1: URYNc7fPA23K2UfadQbnCA ($45.25 in chips)
Seat 2: f89uTQr3ieGlusj2IAYAEg ($50 in chips)
Seat 3: v4ctePcLlQw0r8E0qJtjYw ($48.80 in chips)
Seat 4: g6lz8npaeeTJmJegtPYhlQ ($20.10 in chips)
Seat 5: QvwRlrpVqerRRF8eJm6dDw ($48.65 in chips)
Seat 6: 7+uQ0OOgCTbR4ltkSwyC0g ($160.55 in chips)
v4ctePcLlQw0r8E0qJtjYw: posts small blind $0.25
g6lz8npaeeTJmJegtPYhlQ: posts big blind $0.50
*** HOLE CARDS ***
QvwRlrpVqerRRF8eJm6dDw: folds
7+uQ0OOgCTbR4ltkSwyC0g: raises $1 to $1.50
URYNc7fPA23K2UfadQbnCA: folds
f89uTQr3ieGlusj2IAYAEg: folds
v4ctePcLlQw0r8E0qJtjYw: calls $1.25
g6lz8npaeeTJmJegtPYhlQ: calls $1
*** FLOP *** [6h Ks 2d]
v4ctePcLlQw0r8E0qJtjYw: checks
g6lz8npaeeTJmJegtPYhlQ: checks
7+uQ0OOgCTbR4ltkSwyC0g: bets $1.50
v4ctePcLlQw0r8E0qJtjYw: raises $3 to $4.50
g6lz8npaeeTJmJegtPYhlQ: folds
7+uQ0OOgCTbR4ltkSwyC0g: folds
v4ctePcLlQw0r8E0qJtjYw collected $7.15 from pot
*** SUMMARY ***
Total pot $7.50 | Rake $0.35
Board [6h Ks 2d]
Seat 1: URYNc7fPA23K2UfadQbnCA folded before Flop (didn't bet)
Seat 2: f89uTQr3ieGlusj2IAYAEg (button) folded before Flop (didn't bet)
Seat 3: v4ctePcLlQw0r8E0qJtjYw (small blind) collected ($7.15)
Seat 4: g6lz8npaeeTJmJegtPYhlQ (big blind) folded on the Flop
Seat 5: QvwRlrpVqerRRF8eJm6dDw folded before Flop (didn't bet)
Seat 6: 7+uQ0OOgCTbR4ltkSwyC0g folded on the Flop



PokerStars Game #59941356672:  Hold'em No Limit ($0.25/$0.50) - 2009/07/01 1:33:05 ET
Table 'Nz0Vr7WMHL2g5Uk7dDZjpw' 9-max Seat #3 is the button
Seat 1: 9yMsdgReyOUerNsmTYCCDQ ($9 in chips)
Seat 2: SegjDnMxWMujiD57ESNL+g ($20.35 in chips)
Seat 3: c638Xxo+q5F/t5qMtmvmvQ ($51.15 in chips)
Seat 4: uw9QayAAxLM3Hb+HR7mSkg ($9.50 in chips)
Seat 5: WGW0DgjBUXs1ylURHG8vnQ ($12.40 in chips)
Seat 6: 997ViqAtWn1FPjJqcffwcA ($50 in chips)
Seat 7: KPLH0gELgFe2OuAnhJFI5w ($24.20 in chips)
Seat 8: aoL+R/61Kxmw69ypuPrWAQ ($31.30 in chips)
Seat 9: mSD1pginDsyHG5PDfqzphw ($19.25 in chips)
uw9QayAAxLM3Hb+HR7mSkg: posts small blind $0.25
WGW0DgjBUXs1ylURHG8vnQ: posts big blind $0.50
*** HOLE CARDS ***
997ViqAtWn1FPjJqcffwcA: calls $0.50
KPLH0gELgFe2OuAnhJFI5w: folds
aoL+R/61Kxmw69ypuPrWAQ: calls $0.50
mSD1pginDsyHG5PDfqzphw: folds
9yMsdgReyOUerNsmTYCCDQ: folds
SegjDnMxWMujiD57ESNL+g: folds
c638Xxo+q5F/t5qMtmvmvQ: calls $0.50
uw9QayAAxLM3Hb+HR7mSkg: folds
WGW0DgjBUXs1ylURHG8vnQ: checks
*** FLOP *** [6d 7d As]
WGW0DgjBUXs1ylURHG8vnQ: checks
997ViqAtWn1FPjJqcffwcA: checks
aoL+R/61Kxmw69ypuPrWAQ: checks
c638Xxo+q5F/t5qMtmvmvQ: checks
*** TURN *** [6d 7d As] [Ac]
WGW0DgjBUXs1ylURHG8vnQ: bets $0.50
997ViqAtWn1FPjJqcffwcA: folds
aoL+R/61Kxmw69ypuPrWAQ: folds
c638Xxo+q5F/t5qMtmvmvQ: folds
WGW0DgjBUXs1ylURHG8vnQ collected $2.15 from pot
WGW0DgjBUXs1ylURHG8vnQ: doesn't show hand
*** SUMMARY ***
Total pot $2.25 | Rake $0.10
Board [6d 7d As Ac]
Seat 1: 9yMsdgReyOUerNsmTYCCDQ folded before Flop (didn't bet)
Seat 2: SegjDnMxWMujiD57ESNL+g folded before Flop (didn't bet)
Seat 3: c638Xxo+q5F/t5qMtmvmvQ (button) folded on the Turn
Seat 4: uw9QayAAxLM3Hb+HR7mSkg (small blind) folded before Flop
Seat 5: WGW0DgjBUXs1ylURHG8vnQ (big blind) collected ($2.15)
Seat 6: 997ViqAtWn1FPjJqcffwcA folded on the Turn
Seat 7: KPLH0gELgFe2OuAnhJFI5w folded before Flop (didn't bet)
Seat 8: aoL+R/61Kxmw69ypuPrWAQ folded on the Turn
Seat 9: mSD1pginDsyHG5PDfqzphw folded before Flop (didn't bet)



PokerStars Game #59941357346:  Hold'em No Limit ($0.25/$0.50) - 2009/07/01 1:33:06 ET
Table 'iq+aXfWVQRdV0u8SRTYUEg' 9-max Seat #1 is the button
Seat 1: 3yl8Q6QaLfGtyhN4/pEFgQ ($77.30 in chips)
Seat 2: J9N0lxHFd/Js2S0xZLbsIQ ($24.40 in chips)
Seat 3: Qi/PyOsKwaqtKIg0H+7ELg ($10.45 in chips)
Seat 4: vHYT5s323LpajBj+2c9zbQ ($32.10 in chips)
Seat 5: 997ViqAtWn1FPjJqcffwcA ($55.55 in chips)
Seat 7: SKnJuWHScqetA/qG5p+wCg ($30.80 in chips)
Seat 8: /DtIHuxEH+3tzKefmSV+Mw ($36.10 in chips)
Seat 9: olE1Z2rKWAV8+tGqmIBK9g ($26.20 in chips)
J9N0lxHFd/Js2S0xZLbsIQ: posts small blind $0.25
Qi/PyOsKwaqtKIg0H+7ELg: posts big blind $0.50
*** HOLE CARDS ***
vHYT5s323LpajBj+2c9zbQ: folds
997ViqAtWn1FPjJqcffwcA: folds
SKnJuWHScqetA/qG5p+wCg: folds
/DtIHuxEH+3tzKefmSV+Mw: folds
olE1Z2rKWAV8+tGqmIBK9g: folds
3yl8Q6QaLfGtyhN4/pEFgQ: folds
J9N0lxHFd/Js2S0xZLbsIQ: raises $1 to $1.50
Qi/PyOsKwaqtKIg0H+7ELg: folds
J9N0lxHFd/Js2S0xZLbsIQ collected $1 from pot
J9N0lxHFd/Js2S0xZLbsIQ: shows [3d 3h] (a pair of Threes)
*** SUMMARY ***
Total pot $1 | Rake $0
Seat 1: 3yl8Q6QaLfGtyhN4/pEFgQ (button) folded before Flop (didn't bet)
Seat 2: J9N0lxHFd/Js2S0xZLbsIQ (small blind) collected ($1)
Seat 3: Qi/PyOsKwaqtKIg0H+7ELg (big blind) folded before Flop
Seat 4: vHYT5s323LpajBj+2c9zbQ folded before Flop (didn't bet)
Seat 5: 997ViqAtWn1FPjJqcffwcA folded before Flop (didn't bet)
Seat 7: SKnJuWHScqetA/qG5p+wCg folded before Flop (didn't bet)
Seat 8: /DtIHuxEH+3tzKefmSV+Mw folded before Flop (didn't bet)
Seat 9: olE1Z2rKWAV8+tGqmIBK9g folded before Flop (didn't bet)



PokerStars Game #59941357406:  Hold'em No Limit ($0.25/$0.50) - 2009/07/01 1:33:07 ET
Table '+dXkOAQyS8j9PQZusUTMpg' 2-max Seat #1 is the button
Seat 1: Teld4PDKla7C8/Wfu2DSkg ($57.20 in chips)
Seat 2: +zI4bP23YIjMkUHqeN2xfw ($18.65 in chips)
Teld4PDKla7C8/Wfu2DSkg: posts small blind $0.25
+zI4bP23YIjMkUHqeN2xfw: posts big blind $0.50
*** HOLE CARDS ***
Teld4PDKla7C8/Wfu2DSkg: folds
+zI4bP23YIjMkUHqeN2xfw collected $0.50 from pot
*** SUMMARY ***
Total pot $0.50 | Rake $0
Seat 1: Teld4PDKla7C8/Wfu2DSkg (button) (small blind) folded before Flop
Seat 2: +zI4bP23YIjMkUHqeN2xfw (big blind) collected ($0.50)



PokerStars Game #59941358026:  Hold'em No Limit ($0.25/$0.50) - 2009/07/01 1:33:08 ET
Table '9ojijpRcYQSQTh6xI+haUA' 2-max Seat #2 is the button
Seat 1: FqpibuVWLNsAN/Z7ROZLnA ($34.25 in chips)
Seat 2: TitTV+fFCcBZWOERdytydA ($50.20 in chips)
TitTV+fFCcBZWOERdytydA: posts small blind $0.25
FqpibuVWLNsAN/Z7ROZLnA: posts big blind $0.50
*** HOLE CARDS ***
TitTV+fFCcBZWOERdytydA: raises $1 to $1.50
FqpibuVWLNsAN/Z7ROZLnA: calls $1
*** FLOP *** [4s Jc 3d]
FqpibuVWLNsAN/Z7ROZLnA: bets $3
TitTV+fFCcBZWOERdytydA: raises $3 to $6
FqpibuVWLNsAN/Z7ROZLnA: calls $3
*** TURN *** [4s Jc 3d] [2c]
FqpibuVWLNsAN/Z7ROZLnA: checks
TitTV+fFCcBZWOERdytydA: bets $8
FqpibuVWLNsAN/Z7ROZLnA: calls $8
*** RIVER *** [4s Jc 3d 2c] [Ah]
FqpibuVWLNsAN/Z7ROZLnA: bets $3.50
TitTV+fFCcBZWOERdytydA: raises $9 to $12.50
FqpibuVWLNsAN/Z7ROZLnA: calls $9
*** SHOW DOWN ***
TitTV+fFCcBZWOERdytydA: shows [4d 3c] (two pair, Fours and Threes)
FqpibuVWLNsAN/Z7ROZLnA: mucks hand
TitTV+fFCcBZWOERdytydA collected $55.50 from pot
*** SUMMARY ***
Total pot $56 | Rake $0.50
Board [4s Jc 3d 2c Ah]
Seat 1: FqpibuVWLNsAN/Z7ROZLnA (big blind) mucked
Seat 2: TitTV+fFCcBZWOERdytydA (button) (small blind) showed [4d 3c] and won ($55.50) with two pair, Fours and Threes



PokerStars Game #59941359500:  Hold'em No Limit ($0.25/$0.50) - 2009/07/01 1:33:10 ET
Table 'hWT2kq66tnKEpD26cia6fQ' 2-max Seat #2 is the button
Seat 1: Ce3KNFP+ao7Da9NHb65raw ($49.70 in chips)
Seat 2: 16tvT7AYgZ2LgiGFcvFKQg ($25.80 in chips)
16tvT7AYgZ2LgiGFcvFKQg: posts small blind $0.25
Ce3KNFP+ao7Da9NHb65raw: posts big blind $0.50
*** HOLE CARDS ***
16tvT7AYgZ2LgiGFcvFKQg: raises $0.50 to $1
Ce3KNFP+ao7Da9NHb65raw: calls $0.50
*** FLOP *** [7d 3s 8c]
Ce3KNFP+ao7Da9NHb65raw: checks
16tvT7AYgZ2LgiGFcvFKQg: bets $0.50
Ce3KNFP+ao7Da9NHb65raw: calls $0.50
*** TURN *** [7d 3s 8c] [8d]
Ce3KNFP+ao7Da9NHb65raw: bets $1
16tvT7AYgZ2LgiGFcvFKQg: calls $1
*** RIVER *** [7d 3s 8c 8d] [5d]
Ce3KNFP+ao7Da9NHb65raw: checks
16tvT7AYgZ2LgiGFcvFKQg: checks
*** SHOW DOWN ***
Ce3KNFP+ao7Da9NHb65raw: shows [Ac 6s] (a pair of Eights)
16tvT7AYgZ2LgiGFcvFKQg: shows [As Ts] (a pair of Eights - Ace+Ten kicker)
16tvT7AYgZ2LgiGFcvFKQg collected $4.80 from pot
*** SUMMARY ***
Total pot $5 | Rake $0.20
Board [7d 3s 8c 8d 5d]
Seat 1: Ce3KNFP+ao7Da9NHb65raw (big blind) showed [Ac 6s] and lost with a pair of Eights
Seat 2: 16tvT7AYgZ2LgiGFcvFKQg (button) (small blind) showed [As Ts] and won ($4.80) with a pair of Eights



PokerStars Game #59941359708:  Hold'em No Limit ($0.25/$0.50) - 2009/07/01 1:33:11 ET
Table 'tyR5AZNKV8Aadbrnrnlg7g' 6-max Seat #4 is the button
Seat 1: BgOXYI0yYSN1ULC4FqsNkg ($74.30 in chips)
Seat 2: BAjwVL+zKKd0s0fAWstzQQ ($13.90 in chips)
Seat 3: JFLrYNyQmwPhRQAtoSAuyA ($57 in chips)
Seat 4: 4QfsCWthT/vSLirorNXqtg ($85.70 in chips)
Seat 5: GUnvMULl2qFOO1yenu1UBw ($87.85 in chips)
Seat 6: 498aWaGsW4uGfuWl+2FCGw ($64.80 in chips)
GUnvMULl2qFOO1yenu1UBw: posts small blind $0.25
498aWaGsW4uGfuWl+2FCGw: posts big blind $0.50
*** HOLE CARDS ***
BgOXYI0yYSN1ULC4FqsNkg: raises $0.50 to $1
BAjwVL+zKKd0s0fAWstzQQ: folds
JFLrYNyQmwPhRQAtoSAuyA: folds
4QfsCWthT/vSLirorNXqtg: folds
GUnvMULl2qFOO1yenu1UBw: folds
498aWaGsW4uGfuWl+2FCGw: calls $0.50
*** FLOP *** [Th 3h 7s]
498aWaGsW4uGfuWl+2FCGw: checks
BgOXYI0yYSN1ULC4FqsNkg: bets $2
498aWaGsW4uGfuWl+2FCGw: folds
BgOXYI0yYSN1ULC4FqsNkg collected $2.15 from pot
*** SUMMARY ***
Total pot $2.25 | Rake $0.10
Board [Th 3h 7s]
Seat 1: BgOXYI0yYSN1ULC4FqsNkg collected ($2.15)
Seat 2: BAjwVL+zKKd0s0fAWstzQQ folded before Flop (didn't bet)
Seat 3: JFLrYNyQmwPhRQAtoSAuyA folded before Flop (didn't bet)
Seat 4: 4QfsCWthT/vSLirorNXqtg (button) folded before Flop (didn't bet)
Seat 5: GUnvMULl2qFOO1yenu1UBw (small blind) folded before Flop
Seat 6: 498aWaGsW4uGfuWl+2FCGw (big blind) folded on the Flop



PokerStars Game #59941360320:  Hold'em No Limit ($0.25/$0.50) - 2009/07/01 1:33:12 ET
Table 'B+sqsfj6d6zXicNfaseTaw' 2-max Seat #1 is the button
Seat 1: +4GNcSsecmapVGSdV0mUPA ($154.90 in chips)
Seat 2: Lv5RmpRe6LtPkBzM9Gpo5A ($68.65 in chips)
+4GNcSsecmapVGSdV0mUPA: posts small blind $0.25
Lv5RmpRe6LtPkBzM9Gpo5A: posts big blind $0.50
*** HOLE CARDS ***
+4GNcSsecmapVGSdV0mUPA: raises $1.50 to $2
Lv5RmpRe6LtPkBzM9Gpo5A: calls $1.50
*** FLOP *** [8d 2h Ts]
Lv5RmpRe6LtPkBzM9Gpo5A: checks
+4GNcSsecmapVGSdV0mUPA: bets $4
Lv5RmpRe6LtPkBzM9Gpo5A: folds
+4GNcSsecmapVGSdV0mUPA collected $3.80 from pot
+4GNcSsecmapVGSdV0mUPA: doesn't show hand
*** SUMMARY ***
Total pot $4 | Rake $0.20
Board [8d 2h Ts]
Seat 1: +4GNcSsecmapVGSdV0mUPA (button) (small blind) collected ($3.80)
Seat 2: Lv5RmpRe6LtPkBzM9Gpo5A (big blind) folded on the Flop



PokerStars Game #59941360772:  Hold'em No Limit ($0.25/$0.50) - 2009/07/01 1:33:13 ET
Table '+dXkOAQyS8j9PQZusUTMpg' 2-max Seat #2 is the button
Seat 1: Teld4PDKla7C8/Wfu2DSkg ($56.95 in chips)
Seat 2: +zI4bP23YIjMkUHqeN2xfw ($18.90 in chips)
+zI4bP23YIjMkUHqeN2xfw: posts small blind $0.25
Teld4PDKla7C8/Wfu2DSkg: posts big blind $0.50
*** HOLE CARDS ***
+zI4bP23YIjMkUHqeN2xfw: calls $0.25
Teld4PDKla7C8/Wfu2DSkg: checks
*** FLOP *** [9s 9d 7h]
Teld4PDKla7C8/Wfu2DSkg: checks
+zI4bP23YIjMkUHqeN2xfw: bets $1.50
Teld4PDKla7C8/Wfu2DSkg: folds
+zI4bP23YIjMkUHqeN2xfw collected $0.95 from pot
*** SUMMARY ***
Total pot $1 | Rake $0.05
Board [9s 9d 7h]
Seat 1: Teld4PDKla7C8/Wfu2DSkg (big blind) folded on the Flop
Seat 2: +zI4bP23YIjMkUHqeN2xfw (button) (small blind) collected ($0.95)



PokerStars Game #59941361490:  Hold'em No Limit ($0.25/$0.50) - 2009/07/01 1:33:14 ET
Table '1pi9mHyVuXF/uue+aPQc4w' 9-max Seat #4 is the button
Seat 2: vHYT5s323LpajBj+2c9zbQ ($25.90 in chips)
Seat 3: HZkVla4kK2SI42CVrPZ/ig ($10 in chips)
Seat 4: mSD1pginDsyHG5PDfqzphw ($11.80 in chips)
Seat 5: zE9cVigS2nW/Ljy4K4bUQA ($30.90 in chips)
Seat 6: 1xBtrSVBbgFH/viUWKqQeg ($47.30 in chips)
Seat 7: 61sfw5QTu62YYIt68OsdrA ($33.20 in chips)
Seat 8: g4k0NXISyLCqaSWZDBjfEg ($97.80 in chips)
zE9cVigS2nW/Ljy4K4bUQA: posts small blind $0.25
1xBtrSVBbgFH/viUWKqQeg: posts big blind $0.50
*** HOLE CARDS ***
61sfw5QTu62YYIt68OsdrA: calls $0.50
g4k0NXISyLCqaSWZDBjfEg: folds
vHYT5s323LpajBj+2c9zbQ: folds
HZkVla4kK2SI42CVrPZ/ig: folds
mSD1pginDsyHG5PDfqzphw: folds
zE9cVigS2nW/Ljy4K4bUQA: folds
1xBtrSVBbgFH/viUWKqQeg: checks
*** FLOP *** [Kh 2h Ks]
1xBtrSVBbgFH/viUWKqQeg: checks
M+D23GG26WXQ/2gyjREVOQ joins the table at seat #1
61sfw5QTu62YYIt68OsdrA: checks
*** TURN *** [Kh 2h Ks] [Qc]
1xBtrSVBbgFH/viUWKqQeg: bets $1
61sfw5QTu62YYIt68OsdrA: calls $1
*** RIVER *** [Kh 2h Ks Qc] [3c]
1xBtrSVBbgFH/viUWKqQeg: checks
61sfw5QTu62YYIt68OsdrA: bets $1.50
1xBtrSVBbgFH/viUWKqQeg: folds
61sfw5QTu62YYIt68OsdrA collected $3.10 from pot
61sfw5QTu62YYIt68OsdrA: doesn't show hand
Q/gZC63lfOMr7YhWKPCxoQ joins the table at seat #9
*** SUMMARY ***
Total pot $3.25 | Rake $0.15
Board [Kh 2h Ks Qc 3c]
Seat 2: vHYT5s323LpajBj+2c9zbQ folded before Flop (didn't bet)
Seat 3: HZkVla4kK2SI42CVrPZ/ig folded before Flop (didn't bet)
Seat 4: mSD1pginDsyHG5PDfqzphw (button) folded before Flop (didn't bet)
Seat 5: zE9cVigS2nW/Ljy4K4bUQA (small blind) folded before Flop
Seat 6: 1xBtrSVBbgFH/viUWKqQeg (big blind) folded on the River
Seat 7: 61sfw5QTu62YYIt68OsdrA collected ($3.10)
Seat 8: g4k0NXISyLCqaSWZDBjfEg folded before Flop (didn't bet)



PokerStars Game #59941362388:  Hold'em No Limit ($0.25/$0.50) - 2009/07/01 1:33:16 ET
Table 'ibNfFy0bCzuBaUORla0aGw' 9-max Seat #7 is the button
Seat 1: xZCXQSXlrZkp3pZizzVXCw ($50 in chips)
Seat 2: 90Wb75h3W1BRpbqVnuk8gw ($50 in chips)
Seat 3: AjV5McH1KMMclY26QdLM5w ($27.25 in chips)
Seat 4: nhDtFZ2uuvm5hDKG7ZVEpA ($49.25 in chips)
Seat 5: GIJAc9kPrLZHLSX8Q6i99w ($36.25 in chips)
Seat 6: H8cPaCtX7d6meGUVSM5sxw ($56.60 in chips)
Seat 7: HZkVla4kK2SI42CVrPZ/ig ($16.95 in chips)
Seat 8: Ja2jdidjip2UeJnRzmzAAQ ($46.50 in chips)
Seat 9: pFtzb1sR4b0d1aw6aIRgDg ($56.15 in chips)
Ja2jdidjip2UeJnRzmzAAQ: posts small blind $0.25
pFtzb1sR4b0d1aw6aIRgDg: posts big blind $0.50
*** HOLE CARDS ***
xZCXQSXlrZkp3pZizzVXCw: folds
90Wb75h3W1BRpbqVnuk8gw: raises $1.50 to $2
AjV5McH1KMMclY26QdLM5w: calls $2
nhDtFZ2uuvm5hDKG7ZVEpA: folds
GIJAc9kPrLZHLSX8Q6i99w: folds
H8cPaCtX7d6meGUVSM5sxw: folds
HZkVla4kK2SI42CVrPZ/ig: folds
Ja2jdidjip2UeJnRzmzAAQ: folds
pFtzb1sR4b0d1aw6aIRgDg: folds
*** FLOP *** [5d Kc Td]
90Wb75h3W1BRpbqVnuk8gw: bets $3
AjV5McH1KMMclY26QdLM5w: folds
90Wb75h3W1BRpbqVnuk8gw collected $4.55 from pot
*** SUMMARY ***
Total pot $4.75 | Rake $0.20
Board [5d Kc Td]
Seat 1: xZCXQSXlrZkp3pZizzVXCw folded before Flop (didn't bet)
Seat 2: 90Wb75h3W1BRpbqVnuk8gw collected ($4.55)
Seat 3: AjV5McH1KMMclY26QdLM5w folded on the Flop
Seat 4: nhDtFZ2uuvm5hDKG7ZVEpA folded before Flop (didn't bet)
Seat 5: GIJAc9kPrLZHLSX8Q6i99w folded before Flop (didn't bet)
Seat 6: H8cPaCtX7d6meGUVSM5sxw folded before Flop (didn't bet)
Seat 7: HZkVla4kK2SI42CVrPZ/ig (button) folded before Flop (didn't bet)
Seat 8: Ja2jdidjip2UeJnRzmzAAQ (small blind) folded before Flop
Seat 9: pFtzb1sR4b0d1aw6aIRgDg (big blind) folded before Flop



PokerStars Game #59941363968:  Hold'em No Limit ($0.25/$0.50) - 2009/07/01 1:33:18 ET
Table 'kgbJRsxfv64KrErDRBAkcw' 6-max Seat #6 is the button
Seat 1: VamsyhlFzXGF6/ydo0BHeA ($20.50 in chips)
Seat 2: AdS8BJMOheS01zjCDfPMFg ($63 in chips)
Seat 3: c4MNIaIyPMOMxrgT8FT5nA ($167.80 in chips)
Seat 4: 2igtJLmvIZ+HqX4XPgMPZA ($112.50 in chips)
Seat 5: eUBBn2R56C1IQ6Cs/vitwg ($104 in chips)
Seat 6: 1b+2BbjMN8qhR1WPqdE9VQ ($50 in chips)
VamsyhlFzXGF6/ydo0BHeA: posts small blind $0.25
AdS8BJMOheS01zjCDfPMFg: posts big blind $0.50
*** HOLE CARDS ***
c4MNIaIyPMOMxrgT8FT5nA: calls $0.50
2igtJLmvIZ+HqX4XPgMPZA: folds
eUBBn2R56C1IQ6Cs/vitwg: folds
1b+2BbjMN8qhR1WPqdE9VQ: raises $1.50 to $2
VamsyhlFzXGF6/ydo0BHeA: calls $1.75
AdS8BJMOheS01zjCDfPMFg: folds
c4MNIaIyPMOMxrgT8FT5nA: calls $1.50
*** FLOP *** [2c Jc Kh]
VamsyhlFzXGF6/ydo0BHeA: checks
c4MNIaIyPMOMxrgT8FT5nA: checks
1b+2BbjMN8qhR1WPqdE9VQ: checks
*** TURN *** [2c Jc Kh] [7h]
VamsyhlFzXGF6/ydo0BHeA: checks
c4MNIaIyPMOMxrgT8FT5nA: checks
1b+2BbjMN8qhR1WPqdE9VQ: checks
*** RIVER *** [2c Jc Kh 7h] [Td]
VamsyhlFzXGF6/ydo0BHeA: checks
c4MNIaIyPMOMxrgT8FT5nA: checks
1b+2BbjMN8qhR1WPqdE9VQ: bets $4.50
VamsyhlFzXGF6/ydo0BHeA: folds
c4MNIaIyPMOMxrgT8FT5nA: raises $9 to $13.50
1b+2BbjMN8qhR1WPqdE9VQ: calls $9
*** SHOW DOWN ***
c4MNIaIyPMOMxrgT8FT5nA: shows [6s 8s] (high card King)
1b+2BbjMN8qhR1WPqdE9VQ: shows [Tc Jd] (two pair, Jacks and Tens)
1b+2BbjMN8qhR1WPqdE9VQ collected $31.85 from pot
*** SUMMARY ***
Total pot $33.50 | Rake $1.65
Board [2c Jc Kh 7h Td]
Seat 1: VamsyhlFzXGF6/ydo0BHeA (small blind) folded on the River
Seat 2: AdS8BJMOheS01zjCDfPMFg (big blind) folded before Flop
Seat 3: c4MNIaIyPMOMxrgT8FT5nA showed [6s 8s] and lost with high card King
Seat 4: 2igtJLmvIZ+HqX4XPgMPZA folded before Flop (didn't bet)
Seat 5: eUBBn2R56C1IQ6Cs/vitwg folded before Flop (didn't bet)
Seat 6: 1b+2BbjMN8qhR1WPqdE9VQ (button) showed [Tc Jd] and won ($31.85) with two pair, Jacks and Tens



PokerStars Game #59941364342:  Hold'em No Limit ($0.25/$0.50) - 2009/07/01 1:33:19 ET
Table 'Wwfm5/i+g/g2Nj2gT3jnVQ' 2-max Seat #2 is the button
Seat 1: CHRLZDaaxjbo68bwQD1C/Q ($14.20 in chips)
Seat 2: PKuuhUvIr5WSkJyPJa9dFw ($17.50 in chips)
PKuuhUvIr5WSkJyPJa9dFw: posts small blind $0.25
CHRLZDaaxjbo68bwQD1C/Q: posts big blind $0.50
*** HOLE CARDS ***
PKuuhUvIr5WSkJyPJa9dFw: calls $0.25
CHRLZDaaxjbo68bwQD1C/Q: raises $0.50 to $1
PKuuhUvIr5WSkJyPJa9dFw: calls $0.50
*** FLOP *** [3c Js 4c]
CHRLZDaaxjbo68bwQD1C/Q: bets $0.50
PKuuhUvIr5WSkJyPJa9dFw: calls $0.50
*** TURN *** [3c Js 4c] [2d]
CHRLZDaaxjbo68bwQD1C/Q: bets $0.50
PKuuhUvIr5WSkJyPJa9dFw: calls $0.50
*** RIVER *** [3c Js 4c 2d] [9h]
CHRLZDaaxjbo68bwQD1C/Q: checks
PKuuhUvIr5WSkJyPJa9dFw: bets $4.50
CHRLZDaaxjbo68bwQD1C/Q: folds
PKuuhUvIr5WSkJyPJa9dFw collected $3.85 from pot
PKuuhUvIr5WSkJyPJa9dFw: doesn't show hand
*** SUMMARY ***
Total pot $4 | Rake $0.15
Board [3c Js 4c 2d 9h]
Seat 1: CHRLZDaaxjbo68bwQD1C/Q (big blind) folded on the River
Seat 2: PKuuhUvIr5WSkJyPJa9dFw (button) (small blind) collected ($3.85)



PokerStars Game #59941364600:  Hold'em No Limit ($0.25/$0.50) - 2009/07/01 1:33:20 ET
Table '5qf8oPyYje71HBKD0FwPgQ' 9-max Seat #7 is the button
Seat 1: uw9QayAAxLM3Hb+HR7mSkg ($12 in chips)
Seat 2: M+7+BTmX5vZatHVuoRB1nA ($56.80 in chips)
Seat 3: vacmVLJJECYI6HjAynFcpg ($57.70 in chips)
Seat 4: YXCE3WOZi8g2sIf3y/plVw ($54.60 in chips)
Seat 5: uo2Sgpknd7NdeVbeSCG02A ($15.15 in chips)
Seat 6: go0Ad6tqqJ4tR9/bqVlO0g ($20.45 in chips)
Seat 7: 1q5EPoiflJRl8pqfnVLjMw ($54.25 in chips)
Seat 8: sakr/FIfFtIZwDPmAj5Pzg ($59.35 in chips)
Seat 9: jWDRpL0TJljg+mBCE9ZMqA ($7.85 in chips)
sakr/FIfFtIZwDPmAj5Pzg: posts small blind $0.25
jWDRpL0TJljg+mBCE9ZMqA: posts big blind $0.50
*** HOLE CARDS ***
uw9QayAAxLM3Hb+HR7mSkg: folds
M+7+BTmX5vZatHVuoRB1nA: raises $1 to $1.50
vacmVLJJECYI6HjAynFcpg: folds
YXCE3WOZi8g2sIf3y/plVw: folds
uo2Sgpknd7NdeVbeSCG02A: folds
go0Ad6tqqJ4tR9/bqVlO0g: folds
1q5EPoiflJRl8pqfnVLjMw: calls $1.50
sakr/FIfFtIZwDPmAj5Pzg: folds
jWDRpL0TJljg+mBCE9ZMqA: folds
*** FLOP *** [Ts 7d 2c]
M+7+BTmX5vZatHVuoRB1nA: bets $2.50
1q5EPoiflJRl8pqfnVLjMw: folds
M+7+BTmX5vZatHVuoRB1nA collected $3.60 from pot
M+7+BTmX5vZatHVuoRB1nA: doesn't show hand
*** SUMMARY ***
Total pot $3.75 | Rake $0.15
Board [Ts 7d 2c]
Seat 1: uw9QayAAxLM3Hb+HR7mSkg folded before Flop (didn't bet)
Seat 2: M+7+BTmX5vZatHVuoRB1nA collected ($3.60)
Seat 3: vacmVLJJECYI6HjAynFcpg folded before Flop (didn't bet)
Seat 4: YXCE3WOZi8g2sIf3y/plVw folded before Flop (didn't bet)
Seat 5: uo2Sgpknd7NdeVbeSCG02A folded before Flop (didn't bet)
Seat 6: go0Ad6tqqJ4tR9/bqVlO0g folded before Flop (didn't bet)
Seat 7: 1q5EPoiflJRl8pqfnVLjMw (button) folded on the Flop
Seat 8: sakr/FIfFtIZwDPmAj5Pzg (small blind) folded before Flop
Seat 9: jWDRpL0TJljg+mBCE9ZMqA (big blind) folded before Flop



PokerStars Game #59941365656:  Hold'em No Limit ($0.25/$0.50) - 2009/07/01 1:33:21 ET
Table 'EiNh8p/wGJ1FP575iMFnqg' 9-max Seat #8 is the button
Seat 1: YFFlOZgyy1Mh4iBmuNRbmQ ($25.45 in chips)
Seat 2: 8ehL7qlZzjgUh2H35iiWLw ($69.75 in chips)
Seat 3: ymLPoEIl7UL3TvZYmnadxQ ($42.35 in chips)
Seat 4: cMzaiXAM/ZAdNaEUu+LqhA ($58.45 in chips)
Seat 5: M+7+BTmX5vZatHVuoRB1nA ($73.20 in chips)
Seat 6: viwBDtJsY6JfsFOdBAyJIQ ($8.45 in chips)
Seat 7: 997ViqAtWn1FPjJqcffwcA ($50 in chips)
Seat 8: mSD1pginDsyHG5PDfqzphw ($10 in chips)
Seat 9: GuPkZObrz5Zkkn8FsEdF9w ($35.10 in chips)
GuPkZObrz5Zkkn8FsEdF9w: posts small blind $0.25
YFFlOZgyy1Mh4iBmuNRbmQ: posts big blind $0.50
*** HOLE CARDS ***
8ehL7qlZzjgUh2H35iiWLw: folds
ymLPoEIl7UL3TvZYmnadxQ: calls $0.50
cMzaiXAM/ZAdNaEUu+LqhA: folds
M+7+BTmX5vZatHVuoRB1nA: folds
viwBDtJsY6JfsFOdBAyJIQ: folds
997ViqAtWn1FPjJqcffwcA: folds
mSD1pginDsyHG5PDfqzphw: folds
GuPkZObrz5Zkkn8FsEdF9w: calls $0.25
YFFlOZgyy1Mh4iBmuNRbmQ: raises $1 to $1.50
ymLPoEIl7UL3TvZYmnadxQ: calls $1
GuPkZObrz5Zkkn8FsEdF9w: folds
*** FLOP *** [8c Qs 4d]
YFFlOZgyy1Mh4iBmuNRbmQ: checks
ymLPoEIl7UL3TvZYmnadxQ: checks
*** TURN *** [8c Qs 4d] [9c]
8ehL7qlZzjgUh2H35iiWLw leaves the table
YFFlOZgyy1Mh4iBmuNRbmQ: bets $2
ymLPoEIl7UL3TvZYmnadxQ: raises $4 to $6
YFFlOZgyy1Mh4iBmuNRbmQ: folds
ymLPoEIl7UL3TvZYmnadxQ collected $7.15 from pot
ymLPoEIl7UL3TvZYmnadxQ: doesn't show hand
*** SUMMARY ***
Total pot $7.50 | Rake $0.35
Board [8c Qs 4d 9c]
Seat 1: YFFlOZgyy1Mh4iBmuNRbmQ (big blind) folded on the Turn
Seat 2: 8ehL7qlZzjgUh2H35iiWLw folded before Flop (didn't bet)
Seat 3: ymLPoEIl7UL3TvZYmnadxQ collected ($7.15)
Seat 4: cMzaiXAM/ZAdNaEUu+LqhA folded before Flop (didn't bet)
Seat 5: M+7+BTmX5vZatHVuoRB1nA folded before Flop (didn't bet)
Seat 6: viwBDtJsY6JfsFOdBAyJIQ folded before Flop (didn't bet)
Seat 7: 997ViqAtWn1FPjJqcffwcA folded before Flop (didn't bet)
Seat 8: mSD1pginDsyHG5PDfqzphw (button) folded before Flop (didn't bet)
Seat 9: GuPkZObrz5Zkkn8FsEdF9w (small blind) folded before Flop



PokerStars Game #59941365408:  Hold'em No Limit ($0.25/$0.50) - 2009/07/01 1:33:21 ET
Table 'ErOuyGLI5PT3G5MnpHgC/g' 9-max Seat #1 is the button
Seat 1: eBrej2jnlUCs/JgxFCRn2g ($43.90 in chips)
Seat 2: pciZn00ZDk4BVBMTTMcNVQ ($19.75 in chips)
Seat 3: xZCXQSXlrZkp3pZizzVXCw ($50 in chips)
Seat 5: JwvquocWfhTVApN5t47LgA ($58.55 in chips)
Seat 6: zE9cVigS2nW/Ljy4K4bUQA ($30 in chips)
Seat 7: 90Wb75h3W1BRpbqVnuk8gw ($62.60 in chips)
Seat 8: g4k0NXISyLCqaSWZDBjfEg ($50 in chips)
Seat 9: J0W5D97jl5VLky+IoPvDeA ($64.50 in chips)
pciZn00ZDk4BVBMTTMcNVQ: posts small blind $0.25
xZCXQSXlrZkp3pZizzVXCw: posts big blind $0.50
YRqrX/u38J7aLNNnBzQsjQ: sits out
*** HOLE CARDS ***
JwvquocWfhTVApN5t47LgA: calls $0.50
zE9cVigS2nW/Ljy4K4bUQA: folds
90Wb75h3W1BRpbqVnuk8gw: raises $2.50 to $3
g4k0NXISyLCqaSWZDBjfEg: folds
J0W5D97jl5VLky+IoPvDeA: folds
eBrej2jnlUCs/JgxFCRn2g: folds
pciZn00ZDk4BVBMTTMcNVQ: folds
xZCXQSXlrZkp3pZizzVXCw: folds
JwvquocWfhTVApN5t47LgA: calls $2.50
*** FLOP *** [Jc Qd 6s]
JwvquocWfhTVApN5t47LgA: bets $1
90Wb75h3W1BRpbqVnuk8gw: calls $1
*** TURN *** [Jc Qd 6s] [7h]
JwvquocWfhTVApN5t47LgA: bets $1
90Wb75h3W1BRpbqVnuk8gw: raises $4 to $5
JwvquocWfhTVApN5t47LgA: calls $4
*** RIVER *** [Jc Qd 6s 7h] [7s]
JwvquocWfhTVApN5t47LgA: checks
90Wb75h3W1BRpbqVnuk8gw: bets $12
JwvquocWfhTVApN5t47LgA: folds
90Wb75h3W1BRpbqVnuk8gw collected $17.85 from pot
*** SUMMARY ***
Total pot $18.75 | Rake $0.90
Board [Jc Qd 6s 7h 7s]
Seat 1: eBrej2jnlUCs/JgxFCRn2g (button) folded before Flop (didn't bet)
Seat 2: pciZn00ZDk4BVBMTTMcNVQ (small blind) folded before Flop
Seat 3: xZCXQSXlrZkp3pZizzVXCw (big blind) folded before Flop
Seat 5: JwvquocWfhTVApN5t47LgA folded on the River
Seat 6: zE9cVigS2nW/Ljy4K4bUQA folded before Flop (didn't bet)
Seat 7: 90Wb75h3W1BRpbqVnuk8gw collected ($17.85)
Seat 8: g4k0NXISyLCqaSWZDBjfEg folded before Flop (didn't bet)
Seat 9: J0W5D97jl5VLky+IoPvDeA folded before Flop (didn't bet)



PokerStars Game #59941365822:  Hold'em No Limit ($0.25/$0.50) - 2009/07/01 1:33:22 ET
Table '8BQGgNetI1NOvWeu3gtMNw' 2-max Seat #2 is the button
Seat 1: bypIyrYcAAifLfhZpGlKLA ($84.90 in chips)
Seat 2: Z4HwehErEwzsv/noQlfUlg ($131.05 in chips)
Z4HwehErEwzsv/noQlfUlg: posts small blind $0.25
bypIyrYcAAifLfhZpGlKLA: posts big blind $0.50
*** HOLE CARDS ***
Z4HwehErEwzsv/noQlfUlg: folds
bypIyrYcAAifLfhZpGlKLA collected $0.50 from pot
bypIyrYcAAifLfhZpGlKLA: doesn't show hand
*** SUMMARY ***
Total pot $0.50 | Rake $0
Seat 1: bypIyrYcAAifLfhZpGlKLA (big blind) collected ($0.50)
Seat 2: Z4HwehErEwzsv/noQlfUlg (button) (small blind) folded before Flop



PokerStars Game #59941367788:  Hold'em No Limit ($0.25/$0.50) - 2009/07/01 1:33:25 ET
Table '+z1aekfHkpp09pc8F9aViw' 6-max Seat #3 is the button
Seat 2: 4QfsCWthT/vSLirorNXqtg ($50.75 in chips)
Seat 3: URYNc7fPA23K2UfadQbnCA ($47.75 in chips)
Seat 4: RowCSpSURHTOL/dcjg/Iug ($86.70 in chips)
Seat 5: 2igtJLmvIZ+HqX4XPgMPZA ($50.95 in chips)
Seat 6: GUnvMULl2qFOO1yenu1UBw ($52.25 in chips)
RowCSpSURHTOL/dcjg/Iug: posts small blind $0.25
2igtJLmvIZ+HqX4XPgMPZA: posts big blind $0.50
9r1sdCwEwebh7DF+/EQqGg: sits out
*** HOLE CARDS ***
GUnvMULl2qFOO1yenu1UBw: folds
4QfsCWthT/vSLirorNXqtg: raises $1.50 to $2
URYNc7fPA23K2UfadQbnCA: folds
RowCSpSURHTOL/dcjg/Iug: folds
2igtJLmvIZ+HqX4XPgMPZA: folds
4QfsCWthT/vSLirorNXqtg collected $1.25 from pot
*** SUMMARY ***
Total pot $1.25 | Rake $0
Seat 2: 4QfsCWthT/vSLirorNXqtg collected ($1.25)
Seat 3: URYNc7fPA23K2UfadQbnCA (button) folded before Flop (didn't bet)
Seat 4: RowCSpSURHTOL/dcjg/Iug (small blind) folded before Flop
Seat 5: 2igtJLmvIZ+HqX4XPgMPZA (big blind) folded before Flop
Seat 6: GUnvMULl2qFOO1yenu1UBw folded before Flop (didn't bet)



PokerStars Game #59941368540:  Hold'em No Limit ($0.25/$0.50) - 2009/07/01 1:33:27 ET
Table '2lPOwetm4cfkZPbTmGPH/w' 2-max Seat #1 is the button
Seat 1: vUGdApqS8J/GJE2gaVWl1w ($28.20 in chips)
Seat 2: XFa6sBGjP2gxoIvxR3fZIg ($11.50 in chips)
vUGdApqS8J/GJE2gaVWl1w: posts small blind $0.25
XFa6sBGjP2gxoIvxR3fZIg: posts big blind $0.50
*** HOLE CARDS ***
vUGdApqS8J/GJE2gaVWl1w: calls $0.25
XFa6sBGjP2gxoIvxR3fZIg: raises $1.50 to $2
vUGdApqS8J/GJE2gaVWl1w: calls $1.50
*** FLOP *** [Jc Qd Ks]
XFa6sBGjP2gxoIvxR3fZIg: bets $3
vUGdApqS8J/GJE2gaVWl1w: folds
XFa6sBGjP2gxoIvxR3fZIg collected $3.80 from pot
XFa6sBGjP2gxoIvxR3fZIg: doesn't show hand
*** SUMMARY ***
Total pot $4 | Rake $0.20
Board [Jc Qd Ks]
Seat 1: vUGdApqS8J/GJE2gaVWl1w (button) (small blind) folded on the Flop
Seat 2: XFa6sBGjP2gxoIvxR3fZIg (big blind) collected ($3.80)



PokerStars Game #59941368794:  Hold'em No Limit ($0.25/$0.50) - 2009/07/01 1:33:27 ET
Table 'B+sqsfj6d6zXicNfaseTaw' 2-max Seat #2 is the button
Seat 1: +4GNcSsecmapVGSdV0mUPA ($156.70 in chips)
Seat 2: Lv5RmpRe6LtPkBzM9Gpo5A ($66.65 in chips)
Lv5RmpRe6LtPkBzM9Gpo5A: posts small blind $0.25
+4GNcSsecmapVGSdV0mUPA: posts big blind $0.50
*** HOLE CARDS ***
Lv5RmpRe6LtPkBzM9Gpo5A: raises $1.50 to $2
+4GNcSsecmapVGSdV0mUPA: calls $1.50
*** FLOP *** [9c Jc Ac]
+4GNcSsecmapVGSdV0mUPA: checks
Lv5RmpRe6LtPkBzM9Gpo5A: checks
*** TURN *** [9c Jc Ac] [8s]
+4GNcSsecmapVGSdV0mUPA: checks
Lv5RmpRe6LtPkBzM9Gpo5A: checks
*** RIVER *** [9c Jc Ac 8s] [9s]
+4GNcSsecmapVGSdV0mUPA: checks
Lv5RmpRe6LtPkBzM9Gpo5A: checks
*** SHOW DOWN ***
+4GNcSsecmapVGSdV0mUPA: shows [8d Kc] (two pair, Nines and Eights)
Lv5RmpRe6LtPkBzM9Gpo5A: mucks hand
+4GNcSsecmapVGSdV0mUPA collected $3.80 from pot
*** SUMMARY ***
Total pot $4 | Rake $0.20
Board [9c Jc Ac 8s 9s]
Seat 1: +4GNcSsecmapVGSdV0mUPA (big blind) showed [8d Kc] and won ($3.80) with two pair, Nines and Eights
Seat 2: Lv5RmpRe6LtPkBzM9Gpo5A (button) (small blind) mucked



PokerStars Game #59941369976:  Hold'em No Limit ($0.25/$0.50) - 2009/07/01 1:33:29 ET
Table '+dXkOAQyS8j9PQZusUTMpg' 2-max Seat #1 is the button
Seat 1: Teld4PDKla7C8/Wfu2DSkg ($56.45 in chips)
Seat 2: +zI4bP23YIjMkUHqeN2xfw ($19.35 in chips)
Teld4PDKla7C8/Wfu2DSkg: posts small blind $0.25
+zI4bP23YIjMkUHqeN2xfw: posts big blind $0.50
*** HOLE CARDS ***
Teld4PDKla7C8/Wfu2DSkg: folds
+zI4bP23YIjMkUHqeN2xfw collected $0.50 from pot
*** SUMMARY ***
Total pot $0.50 | Rake $0
Seat 1: Teld4PDKla7C8/Wfu2DSkg (button) (small blind) folded before Flop
Seat 2: +zI4bP23YIjMkUHqeN2xfw (big blind) collected ($0.50)



PokerStars Game #59941369778:  Hold'em No Limit ($0.25/$0.50) - 2009/07/01 1:33:29 ET
Table '8BQGgNetI1NOvWeu3gtMNw' 2-max Seat #1 is the button
Seat 1: bypIyrYcAAifLfhZpGlKLA ($85.15 in chips)
Seat 2: Z4HwehErEwzsv/noQlfUlg ($130.80 in chips)
bypIyrYcAAifLfhZpGlKLA: posts small blind $0.25
Z4HwehErEwzsv/noQlfUlg: posts big blind $0.50
*** HOLE CARDS ***
bypIyrYcAAifLfhZpGlKLA: raises $1 to $1.50
Z4HwehErEwzsv/noQlfUlg: calls $1
*** FLOP *** [Js 8c 9h]
Z4HwehErEwzsv/noQlfUlg: checks
bypIyrYcAAifLfhZpGlKLA: checks
*** TURN *** [Js 8c 9h] [8s]
Z4HwehErEwzsv/noQlfUlg: bets $5
bypIyrYcAAifLfhZpGlKLA: folds
Z4HwehErEwzsv/noQlfUlg collected $2.85 from pot
Z4HwehErEwzsv/noQlfUlg: doesn't show hand
*** SUMMARY ***
Total pot $3 | Rake $0.15
Board [Js 8c 9h 8s]
Seat 1: bypIyrYcAAifLfhZpGlKLA (button) (small blind) folded on the Turn
Seat 2: Z4HwehErEwzsv/noQlfUlg (big blind) collected ($2.85)



PokerStars Game #59941369826:  Hold'em No Limit ($0.25/$0.50) - 2009/07/01 1:33:29 ET
Table 'iq+aXfWVQRdV0u8SRTYUEg' 9-max Seat #2 is the button
Seat 1: 3yl8Q6QaLfGtyhN4/pEFgQ ($77.30 in chips)
Seat 2: J9N0lxHFd/Js2S0xZLbsIQ ($24.90 in chips)
Seat 3: Qi/PyOsKwaqtKIg0H+7ELg ($9.95 in chips)
Seat 4: vHYT5s323LpajBj+2c9zbQ ($32.10 in chips)
Seat 5: 997ViqAtWn1FPjJqcffwcA ($55.55 in chips)
Seat 7: SKnJuWHScqetA/qG5p+wCg ($30.80 in chips)
Seat 8: /DtIHuxEH+3tzKefmSV+Mw ($36.10 in chips)
Seat 9: olE1Z2rKWAV8+tGqmIBK9g ($26.20 in chips)
Qi/PyOsKwaqtKIg0H+7ELg: posts small blind $0.25
vHYT5s323LpajBj+2c9zbQ: posts big blind $0.50
*** HOLE CARDS ***
997ViqAtWn1FPjJqcffwcA: folds
SKnJuWHScqetA/qG5p+wCg: folds
/DtIHuxEH+3tzKefmSV+Mw: folds
olE1Z2rKWAV8+tGqmIBK9g: folds
3yl8Q6QaLfGtyhN4/pEFgQ: raises $1 to $1.50
J9N0lxHFd/Js2S0xZLbsIQ: calls $1.50
Qi/PyOsKwaqtKIg0H+7ELg: folds
vHYT5s323LpajBj+2c9zbQ: folds
*** FLOP *** [As Kc 9h]
3yl8Q6QaLfGtyhN4/pEFgQ: bets $2
J9N0lxHFd/Js2S0xZLbsIQ: calls $2
*** TURN *** [As Kc 9h] [Tc]
3yl8Q6QaLfGtyhN4/pEFgQ: checks
J9N0lxHFd/Js2S0xZLbsIQ: checks
*** RIVER *** [As Kc 9h Tc] [3h]
3yl8Q6QaLfGtyhN4/pEFgQ: checks
J9N0lxHFd/Js2S0xZLbsIQ: checks
*** SHOW DOWN ***
3yl8Q6QaLfGtyhN4/pEFgQ: shows [8s 6d] (high card Ace)
J9N0lxHFd/Js2S0xZLbsIQ: shows [5s 5h] (a pair of Fives)
J9N0lxHFd/Js2S0xZLbsIQ collected $7.40 from pot
*** SUMMARY ***
Total pot $7.75 | Rake $0.35
Board [As Kc 9h Tc 3h]
Seat 1: 3yl8Q6QaLfGtyhN4/pEFgQ showed [8s 6d] and lost with high card Ace
Seat 2: J9N0lxHFd/Js2S0xZLbsIQ (button) showed [5s 5h] and won ($7.40) with a pair of Fives
Seat 3: Qi/PyOsKwaqtKIg0H+7ELg (small blind) folded before Flop
Seat 4: vHYT5s323LpajBj+2c9zbQ (big blind) folded before Flop
Seat 5: 997ViqAtWn1FPjJqcffwcA folded before Flop (didn't bet)
Seat 7: SKnJuWHScqetA/qG5p+wCg folded before Flop (didn't bet)
Seat 8: /DtIHuxEH+3tzKefmSV+Mw folded before Flop (didn't bet)
Seat 9: olE1Z2rKWAV8+tGqmIBK9g folded before Flop (didn't bet)



PokerStars Game #59941370280:  Hold'em No Limit ($0.25/$0.50) - 2009/07/01 1:33:30 ET
Table 'ZYI3ZReBjdfKEYItkZHI6A' 9-max Seat #8 is the button
Seat 1: IYd5zG8k7vdBNVHbHg2Pag ($63.65 in chips)
Seat 3: 75K2MXwN65Sjfp1yHd50Hg ($9.25 in chips)
Seat 4: e2+sK/yjnj94rXOKoxPP2A ($61.65 in chips)
Seat 5: ApHP7ouup365XIUFBdEDxg ($15.45 in chips)
Seat 6: 1xBtrSVBbgFH/viUWKqQeg ($29.70 in chips)
Seat 7: HWcfp1hY1hqvrddzW3/FQw ($14.70 in chips)
Seat 8: ji04uOybxCdpdefzlUQeKQ ($29.55 in chips)
Seat 9: HZkVla4kK2SI42CVrPZ/ig ($10.65 in chips)
HZkVla4kK2SI42CVrPZ/ig: posts small blind $0.25
IYd5zG8k7vdBNVHbHg2Pag: posts big blind $0.50
5acK4E7fzEwnplVBZ6eNWA: sits out
*** HOLE CARDS ***
75K2MXwN65Sjfp1yHd50Hg: folds
e2+sK/yjnj94rXOKoxPP2A: folds
e2+sK/yjnj94rXOKoxPP2A leaves the table
ApHP7ouup365XIUFBdEDxg: raises $1 to $1.50
1xBtrSVBbgFH/viUWKqQeg: folds
HWcfp1hY1hqvrddzW3/FQw: calls $1.50
ji04uOybxCdpdefzlUQeKQ: folds
HZkVla4kK2SI42CVrPZ/ig: folds
IYd5zG8k7vdBNVHbHg2Pag: folds
*** FLOP *** [4h Kd 2d]
ApHP7ouup365XIUFBdEDxg: bets $2
HWcfp1hY1hqvrddzW3/FQw: calls $2
*** TURN *** [4h Kd 2d] [5s]
ApHP7ouup365XIUFBdEDxg: checks
HWcfp1hY1hqvrddzW3/FQw: bets $3
ApHP7ouup365XIUFBdEDxg: calls $3
*** RIVER *** [4h Kd 2d 5s] [7s]
ApHP7ouup365XIUFBdEDxg: checks
HWcfp1hY1hqvrddzW3/FQw: bets $3.50
/UdtxmXsFx6K/14AbHqzbQ joins the table at seat #4
ApHP7ouup365XIUFBdEDxg: folds
HWcfp1hY1hqvrddzW3/FQw collected $13.10 from pot
HWcfp1hY1hqvrddzW3/FQw: shows [As Ks] (a pair of Kings)
*** SUMMARY ***
Total pot $13.75 | Rake $0.65
Board [4h Kd 2d 5s 7s]
Seat 1: IYd5zG8k7vdBNVHbHg2Pag (big blind) folded before Flop
Seat 3: 75K2MXwN65Sjfp1yHd50Hg folded before Flop (didn't bet)
Seat 4: e2+sK/yjnj94rXOKoxPP2A folded before Flop (didn't bet)
Seat 5: ApHP7ouup365XIUFBdEDxg folded on the River
Seat 6: 1xBtrSVBbgFH/viUWKqQeg folded before Flop (didn't bet)
Seat 7: HWcfp1hY1hqvrddzW3/FQw collected ($13.10)
Seat 8: ji04uOybxCdpdefzlUQeKQ (button) folded before Flop (didn't bet)
Seat 9: HZkVla4kK2SI42CVrPZ/ig (small blind) folded before Flop



PokerStars Game #59941373386:  Hold'em No Limit ($0.25/$0.50) - 2009/07/01 1:33:35 ET
Table '+dXkOAQyS8j9PQZusUTMpg' 2-max Seat #2 is the button
Seat 1: Teld4PDKla7C8/Wfu2DSkg ($56.20 in chips)
Seat 2: +zI4bP23YIjMkUHqeN2xfw ($19.60 in chips)
+zI4bP23YIjMkUHqeN2xfw: posts small blind $0.25
Teld4PDKla7C8/Wfu2DSkg: posts big blind $0.50
*** HOLE CARDS ***
+zI4bP23YIjMkUHqeN2xfw: calls $0.25
Teld4PDKla7C8/Wfu2DSkg: checks
*** FLOP *** [9c 3h 7c]
Teld4PDKla7C8/Wfu2DSkg: checks
+zI4bP23YIjMkUHqeN2xfw: bets $1
Teld4PDKla7C8/Wfu2DSkg: folds
+zI4bP23YIjMkUHqeN2xfw collected $0.95 from pot
*** SUMMARY ***
Total pot $1 | Rake $0.05
Board [9c 3h 7c]
Seat 1: Teld4PDKla7C8/Wfu2DSkg (big blind) folded on the Flop
Seat 2: +zI4bP23YIjMkUHqeN2xfw (button) (small blind) collected ($0.95)



PokerStars Game #59941375216:  Hold'em No Limit ($0.25/$0.50) - 2009/07/01 1:33:38 ET
Table 'hSTs/dUsYLgJQuF2Onp0MQ' 6-max Seat #3 is the button
Seat 1: 1WUCqNG+p+vfWRTXNu4ljw ($50 in chips)
Seat 2: Hdd4js36ITbTJ/QuVYwTlA ($112.25 in chips)
Seat 3: lxIzoHy0RnkfFSODHC2liw ($50 in chips)
Seat 4: 2igtJLmvIZ+HqX4XPgMPZA ($50 in chips)
Seat 5: FsRQ5ECdlLkLYI5le8+PDQ ($50 in chips)
Seat 6: M1KyQQvVPVuxqTAB8sR/zQ ($92.30 in chips)
2igtJLmvIZ+HqX4XPgMPZA: posts small blind $0.25
FsRQ5ECdlLkLYI5le8+PDQ: posts big blind $0.50
*** HOLE CARDS ***
M1KyQQvVPVuxqTAB8sR/zQ: folds
1WUCqNG+p+vfWRTXNu4ljw: raises $1.50 to $2
Hdd4js36ITbTJ/QuVYwTlA: folds
lxIzoHy0RnkfFSODHC2liw: folds
2igtJLmvIZ+HqX4XPgMPZA: folds
FsRQ5ECdlLkLYI5le8+PDQ: folds
1WUCqNG+p+vfWRTXNu4ljw collected $1.25 from pot
*** SUMMARY ***
Total pot $1.25 | Rake $0
Seat 1: 1WUCqNG+p+vfWRTXNu4ljw collected ($1.25)
Seat 2: Hdd4js36ITbTJ/QuVYwTlA folded before Flop (didn't bet)
Seat 3: lxIzoHy0RnkfFSODHC2liw (button) folded before Flop (didn't bet)
Seat 4: 2igtJLmvIZ+HqX4XPgMPZA (small blind) folded before Flop
Seat 5: FsRQ5ECdlLkLYI5le8+PDQ (big blind) folded before Flop
Seat 6: M1KyQQvVPVuxqTAB8sR/zQ folded before Flop (didn't bet)



PokerStars Game #59941375014:  Hold'em No Limit ($0.25/$0.50) - 2009/07/01 1:33:38 ET
Table 'tyR5AZNKV8Aadbrnrnlg7g' 6-max Seat #5 is the button
Seat 1: BgOXYI0yYSN1ULC4FqsNkg ($75.45 in chips)
Seat 2: BAjwVL+zKKd0s0fAWstzQQ ($13.90 in chips)
Seat 3: JFLrYNyQmwPhRQAtoSAuyA ($57 in chips)
Seat 4: 4QfsCWthT/vSLirorNXqtg ($85.70 in chips)
Seat 5: GUnvMULl2qFOO1yenu1UBw ($87.60 in chips)
Seat 6: 498aWaGsW4uGfuWl+2FCGw ($63.80 in chips)
498aWaGsW4uGfuWl+2FCGw: posts small blind $0.25
BgOXYI0yYSN1ULC4FqsNkg: posts big blind $0.50
*** HOLE CARDS ***
BAjwVL+zKKd0s0fAWstzQQ: folds
JFLrYNyQmwPhRQAtoSAuyA: folds
4QfsCWthT/vSLirorNXqtg: folds
GUnvMULl2qFOO1yenu1UBw: folds
498aWaGsW4uGfuWl+2FCGw: calls $0.25
BgOXYI0yYSN1ULC4FqsNkg: checks
*** FLOP *** [Qs 6d 3d]
498aWaGsW4uGfuWl+2FCGw: checks
BgOXYI0yYSN1ULC4FqsNkg: bets $1.50
498aWaGsW4uGfuWl+2FCGw said, "anyhow if its in center pa whats up"
498aWaGsW4uGfuWl+2FCGw: calls $1.50
*** TURN *** [Qs 6d 3d] [Ts]
498aWaGsW4uGfuWl+2FCGw: checks
BgOXYI0yYSN1ULC4FqsNkg: checks
*** RIVER *** [Qs 6d 3d Ts] [8s]
498aWaGsW4uGfuWl+2FCGw: bets $3.50
BgOXYI0yYSN1ULC4FqsNkg: folds
498aWaGsW4uGfuWl+2FCGw collected $3.85 from pot
498aWaGsW4uGfuWl+2FCGw: doesn't show hand
*** SUMMARY ***
Total pot $4 | Rake $0.15
Board [Qs 6d 3d Ts 8s]
Seat 1: BgOXYI0yYSN1ULC4FqsNkg (big blind) folded on the River
Seat 2: BAjwVL+zKKd0s0fAWstzQQ folded before Flop (didn't bet)
Seat 3: JFLrYNyQmwPhRQAtoSAuyA folded before Flop (didn't bet)
Seat 4: 4QfsCWthT/vSLirorNXqtg folded before Flop (didn't bet)
Seat 5: GUnvMULl2qFOO1yenu1UBw (button) folded before Flop (didn't bet)
Seat 6: 498aWaGsW4uGfuWl+2FCGw (small blind) collected ($3.85)



PokerStars Game #59941375868:  Hold'em No Limit ($0.25/$0.50) - 2009/07/01 1:33:39 ET
Table 'cofQFHU7jbJoFecLVBof/w' 6-max Seat #3 is the button
Seat 1: URYNc7fPA23K2UfadQbnCA ($45.25 in chips)
Seat 2: f89uTQr3ieGlusj2IAYAEg ($50 in chips)
Seat 3: v4ctePcLlQw0r8E0qJtjYw ($52.95 in chips)
Seat 4: g6lz8npaeeTJmJegtPYhlQ ($18.60 in chips)
Seat 5: QvwRlrpVqerRRF8eJm6dDw ($48.65 in chips)
Seat 6: 7+uQ0OOgCTbR4ltkSwyC0g ($157.55 in chips)
g6lz8npaeeTJmJegtPYhlQ: posts small blind $0.25
QvwRlrpVqerRRF8eJm6dDw: posts big blind $0.50
*** HOLE CARDS ***
7+uQ0OOgCTbR4ltkSwyC0g: folds
URYNc7fPA23K2UfadQbnCA: folds
f89uTQr3ieGlusj2IAYAEg: folds
v4ctePcLlQw0r8E0qJtjYw: raises $1 to $1.50
g6lz8npaeeTJmJegtPYhlQ: folds
QvwRlrpVqerRRF8eJm6dDw: folds
v4ctePcLlQw0r8E0qJtjYw collected $1.25 from pot
*** SUMMARY ***
Total pot $1.25 | Rake $0
Seat 1: URYNc7fPA23K2UfadQbnCA folded before Flop (didn't bet)
Seat 2: f89uTQr3ieGlusj2IAYAEg folded before Flop (didn't bet)
Seat 3: v4ctePcLlQw0r8E0qJtjYw (button) collected ($1.25)
Seat 4: g6lz8npaeeTJmJegtPYhlQ (small blind) folded before Flop
Seat 5: QvwRlrpVqerRRF8eJm6dDw (big blind) folded before Flop
Seat 6: 7+uQ0OOgCTbR4ltkSwyC0g folded before Flop (didn't bet)



PokerStars Game #59941376606:  Hold'em No Limit ($0.25/$0.50) - 2009/07/01 1:33:41 ET
Table 'hWT2kq66tnKEpD26cia6fQ' 2-max Seat #1 is the button
Seat 1: Ce3KNFP+ao7Da9NHb65raw ($47.20 in chips)
Seat 2: 16tvT7AYgZ2LgiGFcvFKQg ($28.10 in chips)
Ce3KNFP+ao7Da9NHb65raw: posts small blind $0.25
16tvT7AYgZ2LgiGFcvFKQg: posts big blind $0.50
*** HOLE CARDS ***
Ce3KNFP+ao7Da9NHb65raw: folds
16tvT7AYgZ2LgiGFcvFKQg collected $0.50 from pot
*** SUMMARY ***
Total pot $0.50 | Rake $0
Seat 1: Ce3KNFP+ao7Da9NHb65raw (button) (small blind) folded before Flop
Seat 2: 16tvT7AYgZ2LgiGFcvFKQg (big blind) collected ($0.50)



PokerStars Game #59941377086:  Hold'em No Limit ($0.25/$0.50) - 2009/07/01 1:33:42 ET
Table '2lPOwetm4cfkZPbTmGPH/w' 2-max Seat #2 is the button
Seat 1: vUGdApqS8J/GJE2gaVWl1w ($26.20 in chips)
Seat 2: XFa6sBGjP2gxoIvxR3fZIg ($13.30 in chips)
XFa6sBGjP2gxoIvxR3fZIg: posts small blind $0.25
vUGdApqS8J/GJE2gaVWl1w: posts big blind $0.50
*** HOLE CARDS ***
XFa6sBGjP2gxoIvxR3fZIg: raises $1 to $1.50
vUGdApqS8J/GJE2gaVWl1w: calls $1
*** FLOP *** [3c 7h 9h]
vUGdApqS8J/GJE2gaVWl1w: checks
XFa6sBGjP2gxoIvxR3fZIg: bets $2
vUGdApqS8J/GJE2gaVWl1w: folds
XFa6sBGjP2gxoIvxR3fZIg collected $2.85 from pot
XFa6sBGjP2gxoIvxR3fZIg: doesn't show hand
*** SUMMARY ***
Total pot $3 | Rake $0.15
Board [3c 7h 9h]
Seat 1: vUGdApqS8J/GJE2gaVWl1w (big blind) folded on the Flop
Seat 2: XFa6sBGjP2gxoIvxR3fZIg (button) (small blind) collected ($2.85)



PokerStars Game #59941377272:  Hold'em No Limit ($0.25/$0.50) - 2009/07/01 1:33:42 ET
Table 'Wwfm5/i+g/g2Nj2gT3jnVQ' 2-max Seat #1 is the button
Seat 1: CHRLZDaaxjbo68bwQD1C/Q ($12.20 in chips)
Seat 2: PKuuhUvIr5WSkJyPJa9dFw ($19.35 in chips)
CHRLZDaaxjbo68bwQD1C/Q: posts small blind $0.25
PKuuhUvIr5WSkJyPJa9dFw: posts big blind $0.50
*** HOLE CARDS ***
CHRLZDaaxjbo68bwQD1C/Q: raises $1.50 to $2
PKuuhUvIr5WSkJyPJa9dFw: folds
CHRLZDaaxjbo68bwQD1C/Q collected $1 from pot
CHRLZDaaxjbo68bwQD1C/Q: doesn't show hand
*** SUMMARY ***
Total pot $1 | Rake $0
Seat 1: CHRLZDaaxjbo68bwQD1C/Q (button) (small blind) collected ($1)
Seat 2: PKuuhUvIr5WSkJyPJa9dFw (big blind) folded before Flop



PokerStars Game #59941377326:  Hold'em No Limit ($0.25/$0.50) - 2009/07/01 1:33:42 ET
Table '99gCy/CZQwPIjZWH+BguQg' 9-max Seat #9 is the button
Seat 2: 7CKaQEWhd40e2lLifzZ1Cw ($29.50 in chips)
Seat 3: VhjwWfxHSx00WxzYih3KOA ($50 in chips)
Seat 4: bxLSulbgr8LmKNjOzw8URg ($86.70 in chips)
Seat 5: YXCE3WOZi8g2sIf3y/plVw ($50.90 in chips)
Seat 6: OcnLOMVFdy23jXnoTyaO5Q ($293.10 in chips)
Seat 7: ottZQkg1UDWk85BtBzGJzg ($29 in chips)
Seat 9: j3K/Jujr7PY4ZM2RZvlH6A ($78.45 in chips)
Bawookles will be allowed to play after the button
7CKaQEWhd40e2lLifzZ1Cw: posts small blind $0.25
VhjwWfxHSx00WxzYih3KOA: posts big blind $0.50
*** HOLE CARDS ***
bxLSulbgr8LmKNjOzw8URg: folds
YXCE3WOZi8g2sIf3y/plVw: folds
OcnLOMVFdy23jXnoTyaO5Q: folds
ottZQkg1UDWk85BtBzGJzg: folds
tTzoQkWA3nKw6kfnSYw3rQ joins the table at seat #8
j3K/Jujr7PY4ZM2RZvlH6A: folds
7CKaQEWhd40e2lLifzZ1Cw: folds
VhjwWfxHSx00WxzYih3KOA collected $0.50 from pot
VhjwWfxHSx00WxzYih3KOA: doesn't show hand
*** SUMMARY ***
Total pot $0.50 | Rake $0
Seat 2: 7CKaQEWhd40e2lLifzZ1Cw (small blind) folded before Flop
Seat 3: VhjwWfxHSx00WxzYih3KOA (big blind) collected ($0.50)
Seat 4: bxLSulbgr8LmKNjOzw8URg folded before Flop (didn't bet)
Seat 5: YXCE3WOZi8g2sIf3y/plVw folded before Flop (didn't bet)
Seat 6: OcnLOMVFdy23jXnoTyaO5Q folded before Flop (didn't bet)
Seat 7: ottZQkg1UDWk85BtBzGJzg folded before Flop (didn't bet)
Seat 9: j3K/Jujr7PY4ZM2RZvlH6A (button) folded before Flop (didn't bet)



PokerStars Game #59941378238:  Hold'em No Limit ($0.25/$0.50) - 2009/07/01 1:33:44 ET
Table 'fx6MqwfYAj/Rt86hBz2L3Q' 9-max Seat #2 is the button
Seat 1: v/4aX0ejnaIFK4ftDk2Lyg ($50.65 in chips)
Seat 2: C3rGXblctNcWI6JYPHhaEg ($63.45 in chips)
Seat 3: iadBi5AEt7gTBXbDSSnMYQ ($36.60 in chips)
Seat 4: VhjwWfxHSx00WxzYih3KOA ($50 in chips)
Seat 5: iAISe3dVeua8PUn2wwgDHw ($71.10 in chips)
Seat 6: 5k9fvXD9suIgCxU4HLQjTw ($50 in chips)
Seat 7: mSD1pginDsyHG5PDfqzphw ($10 in chips)
Seat 9: vO3QVRovWemcGMkm7ijAIA ($24.45 in chips)
iadBi5AEt7gTBXbDSSnMYQ: posts small blind $0.25
VhjwWfxHSx00WxzYih3KOA: posts big blind $0.50
75K2MXwN65Sjfp1yHd50Hg: sits out
*** HOLE CARDS ***
iAISe3dVeua8PUn2wwgDHw: folds
5k9fvXD9suIgCxU4HLQjTw: folds
mSD1pginDsyHG5PDfqzphw: folds
iAISe3dVeua8PUn2wwgDHw leaves the table
vO3QVRovWemcGMkm7ijAIA: raises $1 to $1.50
v/4aX0ejnaIFK4ftDk2Lyg: folds
C3rGXblctNcWI6JYPHhaEg: calls $1.50
iadBi5AEt7gTBXbDSSnMYQ: calls $1.25
VhjwWfxHSx00WxzYih3KOA: folds
*** FLOP *** [Ad 9d 8d]
iadBi5AEt7gTBXbDSSnMYQ: bets $2.50
vO3QVRovWemcGMkm7ijAIA: folds
C3rGXblctNcWI6JYPHhaEg: folds
iadBi5AEt7gTBXbDSSnMYQ collected $4.75 from pot
*** SUMMARY ***
Total pot $5 | Rake $0.25
Board [Ad 9d 8d]
Seat 1: v/4aX0ejnaIFK4ftDk2Lyg folded before Flop (didn't bet)
Seat 2: C3rGXblctNcWI6JYPHhaEg (button) folded on the Flop
Seat 3: iadBi5AEt7gTBXbDSSnMYQ (small blind) collected ($4.75)
Seat 4: VhjwWfxHSx00WxzYih3KOA (big blind) folded before Flop
Seat 5: iAISe3dVeua8PUn2wwgDHw folded before Flop (didn't bet)
Seat 6: 5k9fvXD9suIgCxU4HLQjTw folded before Flop (didn't bet)
Seat 7: mSD1pginDsyHG5PDfqzphw folded before Flop (didn't bet)
Seat 9: vO3QVRovWemcGMkm7ijAIA folded on the Flop



PokerStars Game #59941378962:  Hold'em No Limit ($0.25/$0.50) - 2009/07/01 1:33:45 ET
Table 'NCiXr0d5CEKBQr/cZgLhbA' 9-max Seat #5 is the button
Seat 1: pFtzb1sR4b0d1aw6aIRgDg ($80.45 in chips)
Seat 2: AjV5McH1KMMclY26QdLM5w ($47.55 in chips)
Seat 3: xZCXQSXlrZkp3pZizzVXCw ($97.15 in chips)
Seat 4: 5k9fvXD9suIgCxU4HLQjTw ($53.95 in chips)
Seat 5: Ja2jdidjip2UeJnRzmzAAQ ($48.25 in chips)
Seat 6: t1qL+wRXOwTLB4TBbcw2QA ($47.25 in chips)
Seat 7: dXhO5i7KOoVcsGqbklD+jw ($36.75 in chips)
Seat 8: XA3GzEhYmqB0KknKKPDZGQ ($30.50 in chips)
Seat 9: 4WLZvqBn5qv5tds5kt5A1Q ($54.50 in chips)
t1qL+wRXOwTLB4TBbcw2QA: posts small blind $0.25
dXhO5i7KOoVcsGqbklD+jw: posts big blind $0.50
*** HOLE CARDS ***
XA3GzEhYmqB0KknKKPDZGQ: folds
4WLZvqBn5qv5tds5kt5A1Q: raises $1 to $1.50
pFtzb1sR4b0d1aw6aIRgDg: folds
AjV5McH1KMMclY26QdLM5w: raises $1.50 to $3
xZCXQSXlrZkp3pZizzVXCw: folds
5k9fvXD9suIgCxU4HLQjTw: folds
Ja2jdidjip2UeJnRzmzAAQ: folds
t1qL+wRXOwTLB4TBbcw2QA: folds
dXhO5i7KOoVcsGqbklD+jw: folds
4WLZvqBn5qv5tds5kt5A1Q: calls $1.50
*** FLOP *** [Ad 8s Ac]
4WLZvqBn5qv5tds5kt5A1Q: checks
AjV5McH1KMMclY26QdLM5w: checks
*** TURN *** [Ad 8s Ac] [7h]
4WLZvqBn5qv5tds5kt5A1Q: checks
AjV5McH1KMMclY26QdLM5w: checks
*** RIVER *** [Ad 8s Ac 7h] [3s]
4WLZvqBn5qv5tds5kt5A1Q: bets $5
AjV5McH1KMMclY26QdLM5w: folds
4WLZvqBn5qv5tds5kt5A1Q collected $6.45 from pot
*** SUMMARY ***
Total pot $6.75 | Rake $0.30
Board [Ad 8s Ac 7h 3s]
Seat 1: pFtzb1sR4b0d1aw6aIRgDg folded before Flop (didn't bet)
Seat 2: AjV5McH1KMMclY26QdLM5w folded on the River
Seat 3: xZCXQSXlrZkp3pZizzVXCw folded before Flop (didn't bet)
Seat 4: 5k9fvXD9suIgCxU4HLQjTw folded before Flop (didn't bet)
Seat 5: Ja2jdidjip2UeJnRzmzAAQ (button) folded before Flop (didn't bet)
Seat 6: t1qL+wRXOwTLB4TBbcw2QA (small blind) folded before Flop
Seat 7: dXhO5i7KOoVcsGqbklD+jw (big blind) folded before Flop
Seat 8: XA3GzEhYmqB0KknKKPDZGQ folded before Flop (didn't bet)
Seat 9: 4WLZvqBn5qv5tds5kt5A1Q collected ($6.45)



PokerStars Game #59941380056:  Hold'em No Limit ($0.25/$0.50) - 2009/07/01 1:33:47 ET
Table 'hWT2kq66tnKEpD26cia6fQ' 2-max Seat #2 is the button
Seat 1: Ce3KNFP+ao7Da9NHb65raw ($46.95 in chips)
Seat 2: 16tvT7AYgZ2LgiGFcvFKQg ($28.35 in chips)
16tvT7AYgZ2LgiGFcvFKQg: posts small blind $0.25
Ce3KNFP+ao7Da9NHb65raw: posts big blind $0.50
*** HOLE CARDS ***
16tvT7AYgZ2LgiGFcvFKQg: calls $0.25
Ce3KNFP+ao7Da9NHb65raw: checks
*** FLOP *** [Kd Kc 4s]
Ce3KNFP+ao7Da9NHb65raw: checks
16tvT7AYgZ2LgiGFcvFKQg: checks
*** TURN *** [Kd Kc 4s] [5s]
Ce3KNFP+ao7Da9NHb65raw: checks
16tvT7AYgZ2LgiGFcvFKQg: checks
*** RIVER *** [Kd Kc 4s 5s] [Jd]
Ce3KNFP+ao7Da9NHb65raw: checks
16tvT7AYgZ2LgiGFcvFKQg: bets $6
Ce3KNFP+ao7Da9NHb65raw: folds
16tvT7AYgZ2LgiGFcvFKQg collected $0.95 from pot
*** SUMMARY ***
Total pot $1 | Rake $0.05
Board [Kd Kc 4s 5s Jd]
Seat 1: Ce3KNFP+ao7Da9NHb65raw (big blind) folded on the River
Seat 2: 16tvT7AYgZ2LgiGFcvFKQg (button) (small blind) collected ($0.95)



PokerStars Game #59941380040:  Hold'em No Limit ($0.25/$0.50) - 2009/07/01 1:33:47 ET
Table 'B+sqsfj6d6zXicNfaseTaw' 2-max Seat #1 is the button
Seat 1: +4GNcSsecmapVGSdV0mUPA ($158.50 in chips)
Seat 2: Lv5RmpRe6LtPkBzM9Gpo5A ($64.65 in chips)
+4GNcSsecmapVGSdV0mUPA: posts small blind $0.25
Lv5RmpRe6LtPkBzM9Gpo5A: posts big blind $0.50
*** HOLE CARDS ***
+4GNcSsecmapVGSdV0mUPA: calls $0.25
Lv5RmpRe6LtPkBzM9Gpo5A: checks
*** FLOP *** [Ah 7s Ks]
Lv5RmpRe6LtPkBzM9Gpo5A: bets $1.50
+4GNcSsecmapVGSdV0mUPA: calls $1.50
*** TURN *** [Ah 7s Ks] [5h]
Lv5RmpRe6LtPkBzM9Gpo5A: checks
+4GNcSsecmapVGSdV0mUPA: bets $2
Lv5RmpRe6LtPkBzM9Gpo5A: calls $2
*** RIVER *** [Ah 7s Ks 5h] [Qc]
Lv5RmpRe6LtPkBzM9Gpo5A: checks
+4GNcSsecmapVGSdV0mUPA: bets $5
Lv5RmpRe6LtPkBzM9Gpo5A: folds
+4GNcSsecmapVGSdV0mUPA collected $7.65 from pot
+4GNcSsecmapVGSdV0mUPA: doesn't show hand
*** SUMMARY ***
Total pot $8 | Rake $0.35
Board [Ah 7s Ks 5h Qc]
Seat 1: +4GNcSsecmapVGSdV0mUPA (button) (small blind) collected ($7.65)
Seat 2: Lv5RmpRe6LtPkBzM9Gpo5A (big blind) folded on the River



PokerStars Game #59941380898:  Hold'em No Limit ($0.25/$0.50) - 2009/07/01 1:33:49 ET
Table '+dXkOAQyS8j9PQZusUTMpg' 2-max Seat #1 is the button
Seat 1: Teld4PDKla7C8/Wfu2DSkg ($55.70 in chips)
Seat 2: +zI4bP23YIjMkUHqeN2xfw ($20.05 in chips)
Teld4PDKla7C8/Wfu2DSkg: posts small blind $0.25
+zI4bP23YIjMkUHqeN2xfw: posts big blind $0.50
*** HOLE CARDS ***
Teld4PDKla7C8/Wfu2DSkg: folds
+zI4bP23YIjMkUHqeN2xfw collected $0.50 from pot
*** SUMMARY ***
Total pot $0.50 | Rake $0
Seat 1: Teld4PDKla7C8/Wfu2DSkg (button) (small blind) folded before Flop
Seat 2: +zI4bP23YIjMkUHqeN2xfw (big blind) collected ($0.50)



PokerStars Game #59941381746:  Hold'em No Limit ($0.25/$0.50) - 2009/07/01 1:33:50 ET
Table '8BQGgNetI1NOvWeu3gtMNw' 2-max Seat #2 is the button
Seat 1: bypIyrYcAAifLfhZpGlKLA ($83.65 in chips)
Seat 2: Z4HwehErEwzsv/noQlfUlg ($132.15 in chips)
Z4HwehErEwzsv/noQlfUlg: posts small blind $0.25
bypIyrYcAAifLfhZpGlKLA: posts big blind $0.50
*** HOLE CARDS ***
Z4HwehErEwzsv/noQlfUlg: folds
bypIyrYcAAifLfhZpGlKLA collected $0.50 from pot
bypIyrYcAAifLfhZpGlKLA: doesn't show hand
*** SUMMARY ***
Total pot $0.50 | Rake $0
Seat 1: bypIyrYcAAifLfhZpGlKLA (big blind) collected ($0.50)
Seat 2: Z4HwehErEwzsv/noQlfUlg (button) (small blind) folded before Flop



PokerStars Game #59941381812:  Hold'em No Limit ($0.25/$0.50) - 2009/07/01 1:33:50 ET
Table 'Wwfm5/i+g/g2Nj2gT3jnVQ' 2-max Seat #2 is the button
Seat 1: CHRLZDaaxjbo68bwQD1C/Q ($12.70 in chips)
Seat 2: PKuuhUvIr5WSkJyPJa9dFw ($18.85 in chips)
PKuuhUvIr5WSkJyPJa9dFw: posts small blind $0.25
CHRLZDaaxjbo68bwQD1C/Q: posts big blind $0.50
*** HOLE CARDS ***
PKuuhUvIr5WSkJyPJa9dFw: folds
CHRLZDaaxjbo68bwQD1C/Q collected $0.50 from pot
CHRLZDaaxjbo68bwQD1C/Q: doesn't show hand
*** SUMMARY ***
Total pot $0.50 | Rake $0
Seat 1: CHRLZDaaxjbo68bwQD1C/Q (big blind) collected ($0.50)
Seat 2: PKuuhUvIr5WSkJyPJa9dFw (button) (small blind) folded before Flop



PokerStars Game #59941383078:  Hold'em No Limit ($0.25/$0.50) - 2009/07/01 1:33:52 ET
Table 'BCN5su+SsXiy1zRMJi0SJw' 6-max Seat #3 is the button
Seat 1: GxXV09ciXaOxyY2H5aMIIw ($32.05 in chips)
Seat 2: ehFNAevCQri3trWxV6FJdA ($100.65 in chips)
Seat 3: kwgv5lNhiFrfONXCshzxlA ($42.30 in chips)
Seat 4: bbsK8j+tpuVRhBqDzHxf7w ($50.10 in chips)
Seat 5: kxPhs4ePFqMy52CInAJ2aw ($50 in chips)
Seat 6: b2symlOdL7+0c9Pj4N/KlA ($68.45 in chips)
bbsK8j+tpuVRhBqDzHxf7w: posts small blind $0.25
kxPhs4ePFqMy52CInAJ2aw: posts big blind $0.50
*** HOLE CARDS ***
b2symlOdL7+0c9Pj4N/KlA: folds
GxXV09ciXaOxyY2H5aMIIw: raises $1.50 to $2
ehFNAevCQri3trWxV6FJdA: folds
kwgv5lNhiFrfONXCshzxlA: calls $2
bbsK8j+tpuVRhBqDzHxf7w: folds
kxPhs4ePFqMy52CInAJ2aw said, "stupid wins all the time"
kxPhs4ePFqMy52CInAJ2aw: folds
*** FLOP *** [8c 6h 6c]
GxXV09ciXaOxyY2H5aMIIw: bets $3
kwgv5lNhiFrfONXCshzxlA: calls $3
*** TURN *** [8c 6h 6c] [2c]
GxXV09ciXaOxyY2H5aMIIw: bets $11
kwgv5lNhiFrfONXCshzxlA: calls $11
*** RIVER *** [8c 6h 6c 2c] [2d]
GxXV09ciXaOxyY2H5aMIIw: bets $16.05 and is all-in
kwgv5lNhiFrfONXCshzxlA: calls $16.05
*** SHOW DOWN ***
GxXV09ciXaOxyY2H5aMIIw: shows [Kc Ks] (two pair, Kings and Sixes)
kwgv5lNhiFrfONXCshzxlA: shows [8d 8h] (a full house, Eights full of Sixes)
kwgv5lNhiFrfONXCshzxlA collected $61.85 from pot
*** SUMMARY ***
Total pot $64.85 | Rake $3
Board [8c 6h 6c 2c 2d]
Seat 1: GxXV09ciXaOxyY2H5aMIIw showed [Kc Ks] and lost with two pair, Kings and Sixes
Seat 2: ehFNAevCQri3trWxV6FJdA folded before Flop (didn't bet)
Seat 3: kwgv5lNhiFrfONXCshzxlA (button) showed [8d 8h] and won ($61.85) with a full house, Eights full of Sixes
Seat 4: bbsK8j+tpuVRhBqDzHxf7w (small blind) folded before Flop
Seat 5: kxPhs4ePFqMy52CInAJ2aw (big blind) folded before Flop
Seat 6: b2symlOdL7+0c9Pj4N/KlA folded before Flop (didn't bet)



PokerStars Game #59941383332:  Hold'em No Limit ($0.25/$0.50) - 2009/07/01 1:33:53 ET
Table '+z1aekfHkpp09pc8F9aViw' 6-max Seat #4 is the button
Seat 2: 4QfsCWthT/vSLirorNXqtg ($51.50 in chips)
Seat 3: URYNc7fPA23K2UfadQbnCA ($47.75 in chips)
Seat 4: RowCSpSURHTOL/dcjg/Iug ($86.45 in chips)
Seat 5: 2igtJLmvIZ+HqX4XPgMPZA ($50.45 in chips)
Seat 6: GUnvMULl2qFOO1yenu1UBw ($52.25 in chips)
2igtJLmvIZ+HqX4XPgMPZA: posts small blind $0.25
GUnvMULl2qFOO1yenu1UBw: posts big blind $0.50
9r1sdCwEwebh7DF+/EQqGg: sits out
*** HOLE CARDS ***
4QfsCWthT/vSLirorNXqtg: folds
URYNc7fPA23K2UfadQbnCA: folds
RowCSpSURHTOL/dcjg/Iug: folds
2igtJLmvIZ+HqX4XPgMPZA: folds
GUnvMULl2qFOO1yenu1UBw collected $0.50 from pot
*** SUMMARY ***
Total pot $0.50 | Rake $0
Seat 2: 4QfsCWthT/vSLirorNXqtg folded before Flop (didn't bet)
Seat 3: URYNc7fPA23K2UfadQbnCA folded before Flop (didn't bet)
Seat 4: RowCSpSURHTOL/dcjg/Iug (button) folded before Flop (didn't bet)
Seat 5: 2igtJLmvIZ+HqX4XPgMPZA (small blind) folded before Flop
Seat 6: GUnvMULl2qFOO1yenu1UBw (big blind) collected ($0.50)



PokerStars Game #59941384414:  Hold'em No Limit ($0.25/$0.50) - 2009/07/01 1:33:55 ET
Table '+dXkOAQyS8j9PQZusUTMpg' 2-max Seat #2 is the button
Seat 1: Teld4PDKla7C8/Wfu2DSkg ($55.45 in chips)
Seat 2: +zI4bP23YIjMkUHqeN2xfw ($20.30 in chips)
+zI4bP23YIjMkUHqeN2xfw: posts small blind $0.25
Teld4PDKla7C8/Wfu2DSkg: posts big blind $0.50
*** HOLE CARDS ***
+zI4bP23YIjMkUHqeN2xfw: raises $1 to $1.50
Teld4PDKla7C8/Wfu2DSkg: folds
+zI4bP23YIjMkUHqeN2xfw collected $1 from pot
*** SUMMARY ***
Total pot $1 | Rake $0
Seat 1: Teld4PDKla7C8/Wfu2DSkg (big blind) folded before Flop
Seat 2: +zI4bP23YIjMkUHqeN2xfw (button) (small blind) collected ($1)



PokerStars Game #59941384774:  Hold'em No Limit ($0.25/$0.50) - 2009/07/01 1:33:55 ET
Table 'Wwfm5/i+g/g2Nj2gT3jnVQ' 2-max Seat #1 is the button
Seat 1: CHRLZDaaxjbo68bwQD1C/Q ($12.95 in chips)
Seat 2: PKuuhUvIr5WSkJyPJa9dFw ($18.60 in chips)
CHRLZDaaxjbo68bwQD1C/Q: posts small blind $0.25
PKuuhUvIr5WSkJyPJa9dFw: posts big blind $0.50
*** HOLE CARDS ***
CHRLZDaaxjbo68bwQD1C/Q: raises $1 to $1.50
PKuuhUvIr5WSkJyPJa9dFw: calls $1
*** FLOP *** [2h 8s 9h]
PKuuhUvIr5WSkJyPJa9dFw: checks
CHRLZDaaxjbo68bwQD1C/Q: bets $1
PKuuhUvIr5WSkJyPJa9dFw: raises $3 to $4
CHRLZDaaxjbo68bwQD1C/Q: calls $3
*** TURN *** [2h 8s 9h] [6d]
PKuuhUvIr5WSkJyPJa9dFw: bets $8
CHRLZDaaxjbo68bwQD1C/Q: folds
PKuuhUvIr5WSkJyPJa9dFw collected $10.50 from pot
PKuuhUvIr5WSkJyPJa9dFw: doesn't show hand
*** SUMMARY ***
Total pot $11 | Rake $0.50
Board [2h 8s 9h 6d]
Seat 1: CHRLZDaaxjbo68bwQD1C/Q (button) (small blind) folded on the Turn
Seat 2: PKuuhUvIr5WSkJyPJa9dFw (big blind) collected ($10.50)



PokerStars Game #59941384940:  Hold'em No Limit ($0.25/$0.50) - 2009/07/01 1:33:56 ET
Table '2lPOwetm4cfkZPbTmGPH/w' 2-max Seat #1 is the button
Seat 1: vUGdApqS8J/GJE2gaVWl1w ($24.70 in chips)
Seat 2: XFa6sBGjP2gxoIvxR3fZIg ($14.65 in chips)
vUGdApqS8J/GJE2gaVWl1w: posts small blind $0.25
XFa6sBGjP2gxoIvxR3fZIg: posts big blind $0.50
*** HOLE CARDS ***
vUGdApqS8J/GJE2gaVWl1w: calls $0.25
XFa6sBGjP2gxoIvxR3fZIg: checks
*** FLOP *** [Qd Ks 2h]
XFa6sBGjP2gxoIvxR3fZIg: checks
vUGdApqS8J/GJE2gaVWl1w: bets $1
XFa6sBGjP2gxoIvxR3fZIg: folds
vUGdApqS8J/GJE2gaVWl1w collected $0.95 from pot
vUGdApqS8J/GJE2gaVWl1w: doesn't show hand
*** SUMMARY ***
Total pot $1 | Rake $0.05
Board [Qd Ks 2h]
Seat 1: vUGdApqS8J/GJE2gaVWl1w (button) (small blind) collected ($0.95)
Seat 2: XFa6sBGjP2gxoIvxR3fZIg (big blind) folded on the Flop



PokerStars Game #59941385800:  Hold'em No Limit ($0.25/$0.50) - 2009/07/01 1:33:57 ET
Table 'GfL/No5u5PoEnU39lP5pQg' 6-max Seat #3 is the button
Seat 1: 1WUCqNG+p+vfWRTXNu4ljw ($50 in chips)
Seat 2: uVwggSetzp7d+eVgowO3vg ($47 in chips)
Seat 3: 4pp9WxhGdbVbxCc9tlu0lw ($25.30 in chips)
Seat 5: M1KyQQvVPVuxqTAB8sR/zQ ($64.70 in chips)
Seat 6: kxPhs4ePFqMy52CInAJ2aw ($120.95 in chips)
r6u7MWSXF30/khcTYkrG9Q will be allowed to play after the button
M1KyQQvVPVuxqTAB8sR/zQ: posts small blind $0.25
kxPhs4ePFqMy52CInAJ2aw: posts big blind $0.50
*** HOLE CARDS ***
1WUCqNG+p+vfWRTXNu4ljw: folds
uVwggSetzp7d+eVgowO3vg: folds
4pp9WxhGdbVbxCc9tlu0lw: folds
M1KyQQvVPVuxqTAB8sR/zQ: folds
kxPhs4ePFqMy52CInAJ2aw collected $0.50 from pot
kxPhs4ePFqMy52CInAJ2aw: doesn't show hand
*** SUMMARY ***
Total pot $0.50 | Rake $0
Seat 1: 1WUCqNG+p+vfWRTXNu4ljw folded before Flop (didn't bet)
Seat 2: uVwggSetzp7d+eVgowO3vg folded before Flop (didn't bet)
Seat 3: 4pp9WxhGdbVbxCc9tlu0lw (button) folded before Flop (didn't bet)
Seat 5: M1KyQQvVPVuxqTAB8sR/zQ (small blind) folded before Flop
Seat 6: kxPhs4ePFqMy52CInAJ2aw (big blind) collected ($0.50)



PokerStars Game #59941386594:  Hold'em No Limit ($0.25/$0.50) - 2009/07/01 1:33:59 ET
Table '99gCy/CZQwPIjZWH+BguQg' 9-max Seat #2 is the button
Seat 2: 7CKaQEWhd40e2lLifzZ1Cw ($29.25 in chips)
Seat 3: VhjwWfxHSx00WxzYih3KOA ($50.25 in chips)
Seat 4: bxLSulbgr8LmKNjOzw8URg ($86.70 in chips)
Seat 5: YXCE3WOZi8g2sIf3y/plVw ($50.90 in chips)
Seat 6: OcnLOMVFdy23jXnoTyaO5Q ($293.10 in chips)
Seat 7: ottZQkg1UDWk85BtBzGJzg ($29 in chips)
Seat 8: tTzoQkWA3nKw6kfnSYw3rQ ($50 in chips)
Seat 9: j3K/Jujr7PY4ZM2RZvlH6A ($78.45 in chips)
VhjwWfxHSx00WxzYih3KOA: posts small blind $0.25
bxLSulbgr8LmKNjOzw8URg: posts big blind $0.50
tTzoQkWA3nKw6kfnSYw3rQ: posts big blind $0.50
Bawookles: sits out
*** HOLE CARDS ***
YXCE3WOZi8g2sIf3y/plVw: folds
OcnLOMVFdy23jXnoTyaO5Q: folds
ottZQkg1UDWk85BtBzGJzg: raises $3.50 to $4
tTzoQkWA3nKw6kfnSYw3rQ: folds
j3K/Jujr7PY4ZM2RZvlH6A: folds
7CKaQEWhd40e2lLifzZ1Cw: raises $4 to $8
VhjwWfxHSx00WxzYih3KOA: folds
bxLSulbgr8LmKNjOzw8URg: folds
ottZQkg1UDWk85BtBzGJzg: calls $4
*** FLOP *** [2h Jd 8s]
ottZQkg1UDWk85BtBzGJzg: bets $21 and is all-in
7CKaQEWhd40e2lLifzZ1Cw: calls $21
*** TURN *** [2h Jd 8s] [5s]
*** RIVER *** [2h Jd 8s 5s] [5d]
*** SHOW DOWN ***
ottZQkg1UDWk85BtBzGJzg: shows [Th Ts] (two pair, Tens and Fives)
7CKaQEWhd40e2lLifzZ1Cw: shows [Qc Qd] (two pair, Queens and Fives)
7CKaQEWhd40e2lLifzZ1Cw collected $56.35 from pot
*** SUMMARY ***
Total pot $59.25 | Rake $2.90
Board [2h Jd 8s 5s 5d]
Seat 2: 7CKaQEWhd40e2lLifzZ1Cw (button) showed [Qc Qd] and won ($56.35) with two pair, Queens and Fives
Seat 3: VhjwWfxHSx00WxzYih3KOA (small blind) folded before Flop
Seat 4: bxLSulbgr8LmKNjOzw8URg (big blind) folded before Flop
Seat 5: YXCE3WOZi8g2sIf3y/plVw folded before Flop (didn't bet)
Seat 6: OcnLOMVFdy23jXnoTyaO5Q folded before Flop (didn't bet)
Seat 7: ottZQkg1UDWk85BtBzGJzg showed [Th Ts] and lost with two pair, Tens and Fives
Seat 8: tTzoQkWA3nKw6kfnSYw3rQ folded before Flop
Seat 9: j3K/Jujr7PY4ZM2RZvlH6A folded before Flop (didn't bet)



PokerStars Game #59941388526:  Hold'em No Limit ($0.25/$0.50) - 2009/07/01 1:34:02 ET
Table 'cofQFHU7jbJoFecLVBof/w' 6-max Seat #4 is the button
Seat 1: URYNc7fPA23K2UfadQbnCA ($45.25 in chips)
Seat 2: f89uTQr3ieGlusj2IAYAEg ($50 in chips)
Seat 3: v4ctePcLlQw0r8E0qJtjYw ($53.70 in chips)
Seat 4: g6lz8npaeeTJmJegtPYhlQ ($18.35 in chips)
Seat 5: QvwRlrpVqerRRF8eJm6dDw ($48.15 in chips)
Seat 6: 7+uQ0OOgCTbR4ltkSwyC0g ($157.55 in chips)
QvwRlrpVqerRRF8eJm6dDw: posts small blind $0.25
7+uQ0OOgCTbR4ltkSwyC0g: posts big blind $0.50
*** HOLE CARDS ***
URYNc7fPA23K2UfadQbnCA: folds
f89uTQr3ieGlusj2IAYAEg: folds
v4ctePcLlQw0r8E0qJtjYw: folds
g6lz8npaeeTJmJegtPYhlQ: calls $0.50
QvwRlrpVqerRRF8eJm6dDw: calls $0.25
7+uQ0OOgCTbR4ltkSwyC0g: raises $2 to $2.50
g6lz8npaeeTJmJegtPYhlQ: calls $2
QvwRlrpVqerRRF8eJm6dDw: folds
*** FLOP *** [5c 4s 9c]
7+uQ0OOgCTbR4ltkSwyC0g: bets $4.50
g6lz8npaeeTJmJegtPYhlQ: folds
7+uQ0OOgCTbR4ltkSwyC0g collected $5.25 from pot
*** SUMMARY ***
Total pot $5.50 | Rake $0.25
Board [5c 4s 9c]
Seat 1: URYNc7fPA23K2UfadQbnCA folded before Flop (didn't bet)
Seat 2: f89uTQr3ieGlusj2IAYAEg folded before Flop (didn't bet)
Seat 3: v4ctePcLlQw0r8E0qJtjYw folded before Flop (didn't bet)
Seat 4: g6lz8npaeeTJmJegtPYhlQ (button) folded on the Flop
Seat 5: QvwRlrpVqerRRF8eJm6dDw (small blind) folded before Flop
Seat 6: 7+uQ0OOgCTbR4ltkSwyC0g (big blind) collected ($5.25)



PokerStars Game #59941388762:  Hold'em No Limit ($0.25/$0.50) - 2009/07/01 1:34:03 ET
Table 'hSTs/dUsYLgJQuF2Onp0MQ' 6-max Seat #4 is the button
Seat 1: 1WUCqNG+p+vfWRTXNu4ljw ($50.75 in chips)
Seat 2: Hdd4js36ITbTJ/QuVYwTlA ($112.25 in chips)
Seat 3: lxIzoHy0RnkfFSODHC2liw ($50 in chips)
Seat 4: 2igtJLmvIZ+HqX4XPgMPZA ($50 in chips)
Seat 5: FsRQ5ECdlLkLYI5le8+PDQ ($49.50 in chips)
Seat 6: M1KyQQvVPVuxqTAB8sR/zQ ($92.30 in chips)
FsRQ5ECdlLkLYI5le8+PDQ: posts small blind $0.25
M1KyQQvVPVuxqTAB8sR/zQ: posts big blind $0.50
*** HOLE CARDS ***
1WUCqNG+p+vfWRTXNu4ljw: folds
Hdd4js36ITbTJ/QuVYwTlA: raises $1.50 to $2
lxIzoHy0RnkfFSODHC2liw: folds
2igtJLmvIZ+HqX4XPgMPZA: folds
FsRQ5ECdlLkLYI5le8+PDQ: folds
M1KyQQvVPVuxqTAB8sR/zQ: folds
Hdd4js36ITbTJ/QuVYwTlA collected $1.25 from pot
*** SUMMARY ***
Total pot $1.25 | Rake $0
Seat 1: 1WUCqNG+p+vfWRTXNu4ljw folded before Flop (didn't bet)
Seat 2: Hdd4js36ITbTJ/QuVYwTlA collected ($1.25)
Seat 3: lxIzoHy0RnkfFSODHC2liw folded before Flop (didn't bet)
Seat 4: 2igtJLmvIZ+HqX4XPgMPZA (button) folded before Flop (didn't bet)
Seat 5: FsRQ5ECdlLkLYI5le8+PDQ (small blind) folded before Flop
Seat 6: M1KyQQvVPVuxqTAB8sR/zQ (big blind) folded before Flop



PokerStars Game #59941389048:  Hold'em No Limit ($0.25/$0.50) - 2009/07/01 1:34:03 ET
Table '+dXkOAQyS8j9PQZusUTMpg' 2-max Seat #1 is the button
Seat 1: Teld4PDKla7C8/Wfu2DSkg ($54.95 in chips)
Seat 2: +zI4bP23YIjMkUHqeN2xfw ($20.80 in chips)
Teld4PDKla7C8/Wfu2DSkg: posts small blind $0.25
+zI4bP23YIjMkUHqeN2xfw: posts big blind $0.50
*** HOLE CARDS ***
Teld4PDKla7C8/Wfu2DSkg: raises $0.50 to $1
+zI4bP23YIjMkUHqeN2xfw: calls $0.50
*** FLOP *** [3d 6d Ac]
+zI4bP23YIjMkUHqeN2xfw: checks
Teld4PDKla7C8/Wfu2DSkg: bets $1.50
+zI4bP23YIjMkUHqeN2xfw: folds
Teld4PDKla7C8/Wfu2DSkg collected $1.90 from pot
Teld4PDKla7C8/Wfu2DSkg: doesn't show hand
*** SUMMARY ***
Total pot $2 | Rake $0.10
Board [3d 6d Ac]
Seat 1: Teld4PDKla7C8/Wfu2DSkg (button) (small blind) collected ($1.90)
Seat 2: +zI4bP23YIjMkUHqeN2xfw (big blind) folded on the Flop



PokerStars Game #59941389026:  Hold'em No Limit ($0.25/$0.50) - 2009/07/01 1:34:03 ET
Table '8BQGgNetI1NOvWeu3gtMNw' 2-max Seat #1 is the button
Seat 1: bypIyrYcAAifLfhZpGlKLA ($83.90 in chips)
Seat 2: Z4HwehErEwzsv/noQlfUlg ($131.90 in chips)
bypIyrYcAAifLfhZpGlKLA: posts small blind $0.25
Z4HwehErEwzsv/noQlfUlg: posts big blind $0.50
*** HOLE CARDS ***
bypIyrYcAAifLfhZpGlKLA: raises $1 to $1.50
Z4HwehErEwzsv/noQlfUlg: raises $1.50 to $3
bypIyrYcAAifLfhZpGlKLA: calls $1.50
*** FLOP *** [Qh Th 3d]
Z4HwehErEwzsv/noQlfUlg: checks
bypIyrYcAAifLfhZpGlKLA: checks
*** TURN *** [Qh Th 3d] [Jc]
Z4HwehErEwzsv/noQlfUlg: bets $5
bypIyrYcAAifLfhZpGlKLA: folds
Z4HwehErEwzsv/noQlfUlg collected $5.70 from pot
Z4HwehErEwzsv/noQlfUlg: doesn't show hand
*** SUMMARY ***
Total pot $6 | Rake $0.30
Board [Qh Th 3d Jc]
Seat 1: bypIyrYcAAifLfhZpGlKLA (button) (small blind) folded on the Turn
Seat 2: Z4HwehErEwzsv/noQlfUlg (big blind) collected ($5.70)



PokerStars Game #59941388932:  Hold'em No Limit ($0.25/$0.50) - 2009/07/01 1:34:03 ET
Table '5qf8oPyYje71HBKD0FwPgQ' 9-max Seat #8 is the button
Seat 2: M+7+BTmX5vZatHVuoRB1nA ($58.90 in chips)
Seat 3: vacmVLJJECYI6HjAynFcpg ($57.70 in chips)
Seat 4: YXCE3WOZi8g2sIf3y/plVw ($54.60 in chips)
Seat 5: uo2Sgpknd7NdeVbeSCG02A ($15.15 in chips)
Seat 6: go0Ad6tqqJ4tR9/bqVlO0g ($20.45 in chips)
Seat 7: 1q5EPoiflJRl8pqfnVLjMw ($52.75 in chips)
Seat 8: sakr/FIfFtIZwDPmAj5Pzg ($59.10 in chips)
Seat 9: jWDRpL0TJljg+mBCE9ZMqA ($7.35 in chips)
jWDRpL0TJljg+mBCE9ZMqA: posts small blind $0.25
uw9QayAAxLM3Hb+HR7mSkg: is sitting out
M+7+BTmX5vZatHVuoRB1nA: posts big blind $0.50
*** HOLE CARDS ***
vacmVLJJECYI6HjAynFcpg: folds
uw9QayAAxLM3Hb+HR7mSkg leaves the table
YXCE3WOZi8g2sIf3y/plVw: folds
uo2Sgpknd7NdeVbeSCG02A: raises $0.50 to $1
go0Ad6tqqJ4tR9/bqVlO0g: calls $1
1q5EPoiflJRl8pqfnVLjMw: folds
sakr/FIfFtIZwDPmAj5Pzg: folds
jWDRpL0TJljg+mBCE9ZMqA: folds
M+7+BTmX5vZatHVuoRB1nA: calls $0.50
*** FLOP *** [Th Qs 5d]
M+7+BTmX5vZatHVuoRB1nA: checks
uo2Sgpknd7NdeVbeSCG02A: bets $2
go0Ad6tqqJ4tR9/bqVlO0g: calls $2
M+7+BTmX5vZatHVuoRB1nA: folds
*** TURN *** [Th Qs 5d] [3d]
uo2Sgpknd7NdeVbeSCG02A: bets $4
go0Ad6tqqJ4tR9/bqVlO0g: calls $4
*** RIVER *** [Th Qs 5d 3d] [Ah]
uo2Sgpknd7NdeVbeSCG02A: bets $5.50
go0Ad6tqqJ4tR9/bqVlO0g: folds
uo2Sgpknd7NdeVbeSCG02A collected $14.55 from pot
*** SUMMARY ***
Total pot $15.25 | Rake $0.70
Board [Th Qs 5d 3d Ah]
Seat 2: M+7+BTmX5vZatHVuoRB1nA (big blind) folded on the Flop
Seat 3: vacmVLJJECYI6HjAynFcpg folded before Flop (didn't bet)
Seat 4: YXCE3WOZi8g2sIf3y/plVw folded before Flop (didn't bet)
Seat 5: uo2Sgpknd7NdeVbeSCG02A collected ($14.55)
Seat 6: go0Ad6tqqJ4tR9/bqVlO0g folded on the River
Seat 7: 1q5EPoiflJRl8pqfnVLjMw folded before Flop (didn't bet)
Seat 8: sakr/FIfFtIZwDPmAj5Pzg (button) folded before Flop (didn't bet)
Seat 9: jWDRpL0TJljg+mBCE9ZMqA (small blind) folded before Flop



PokerStars Game #59941390884:  Hold'em No Limit ($0.25/$0.50) - 2009/07/01 1:34:06 ET
Table 'hWT2kq66tnKEpD26cia6fQ' 2-max Seat #1 is the button
Seat 1: Ce3KNFP+ao7Da9NHb65raw ($46.45 in chips)
Seat 2: 16tvT7AYgZ2LgiGFcvFKQg ($28.80 in chips)
Ce3KNFP+ao7Da9NHb65raw: posts small blind $0.25
16tvT7AYgZ2LgiGFcvFKQg: posts big blind $0.50
*** HOLE CARDS ***
Ce3KNFP+ao7Da9NHb65raw: raises $1 to $1.50
16tvT7AYgZ2LgiGFcvFKQg: calls $1
*** FLOP *** [2h 4s Td]
16tvT7AYgZ2LgiGFcvFKQg: checks
Ce3KNFP+ao7Da9NHb65raw: bets $2
16tvT7AYgZ2LgiGFcvFKQg: calls $2
*** TURN *** [2h 4s Td] [4d]
16tvT7AYgZ2LgiGFcvFKQg: checks
Ce3KNFP+ao7Da9NHb65raw: bets $3
16tvT7AYgZ2LgiGFcvFKQg: calls $3
*** RIVER *** [2h 4s Td 4d] [5d]
16tvT7AYgZ2LgiGFcvFKQg: bets $11.50
Ce3KNFP+ao7Da9NHb65raw: calls $11.50
*** SHOW DOWN ***
16tvT7AYgZ2LgiGFcvFKQg: shows [4h Ah] (three of a kind, Fours)
Ce3KNFP+ao7Da9NHb65raw: mucks hand
16tvT7AYgZ2LgiGFcvFKQg collected $35.50 from pot
*** SUMMARY ***
Total pot $36 | Rake $0.50
Board [2h 4s Td 4d 5d]
Seat 1: Ce3KNFP+ao7Da9NHb65raw (button) (small blind) mucked
Seat 2: 16tvT7AYgZ2LgiGFcvFKQg (big blind) showed [4h Ah] and won ($35.50) with three of a kind, Fours



PokerStars Game #59941391580:  Hold'em No Limit ($0.25/$0.50) - 2009/07/01 1:34:08 ET
Table 'GfL/No5u5PoEnU39lP5pQg' 6-max Seat #5 is the button
Seat 1: 1WUCqNG+p+vfWRTXNu4ljw ($50 in chips)
Seat 2: uVwggSetzp7d+eVgowO3vg ($47 in chips)
Seat 3: 4pp9WxhGdbVbxCc9tlu0lw ($25.30 in chips)
Seat 4: r6u7MWSXF30/khcTYkrG9Q ($30.10 in chips)
Seat 5: M1KyQQvVPVuxqTAB8sR/zQ ($64.45 in chips)
Seat 6: kxPhs4ePFqMy52CInAJ2aw ($121.20 in chips)
kxPhs4ePFqMy52CInAJ2aw: posts small blind $0.25
1WUCqNG+p+vfWRTXNu4ljw: posts big blind $0.50
r6u7MWSXF30/khcTYkrG9Q: posts small & big blinds $0.75
*** HOLE CARDS ***
uVwggSetzp7d+eVgowO3vg: calls $0.50
4pp9WxhGdbVbxCc9tlu0lw: folds
r6u7MWSXF30/khcTYkrG9Q: checks
M1KyQQvVPVuxqTAB8sR/zQ: folds
kxPhs4ePFqMy52CInAJ2aw: folds
1WUCqNG+p+vfWRTXNu4ljw: checks
*** FLOP *** [As 7h Qs]
1WUCqNG+p+vfWRTXNu4ljw: checks
uVwggSetzp7d+eVgowO3vg: checks
r6u7MWSXF30/khcTYkrG9Q: bets $1
1WUCqNG+p+vfWRTXNu4ljw: folds
uVwggSetzp7d+eVgowO3vg: folds
r6u7MWSXF30/khcTYkrG9Q collected $1.90 from pot
*** SUMMARY ***
Total pot $2 | Rake $0.10
Board [As 7h Qs]
Seat 1: 1WUCqNG+p+vfWRTXNu4ljw (big blind) folded on the Flop
Seat 2: uVwggSetzp7d+eVgowO3vg folded on the Flop
Seat 3: 4pp9WxhGdbVbxCc9tlu0lw folded before Flop (didn't bet)
Seat 4: r6u7MWSXF30/khcTYkrG9Q collected ($1.90)
Seat 5: M1KyQQvVPVuxqTAB8sR/zQ (button) folded before Flop (didn't bet)
Seat 6: kxPhs4ePFqMy52CInAJ2aw (small blind) folded before Flop



PokerStars Game #59941391990:  Hold'em No Limit ($0.25/$0.50) - 2009/07/01 1:34:08 ET
Table 'ibNfFy0bCzuBaUORla0aGw' 9-max Seat #8 is the button
Seat 1: xZCXQSXlrZkp3pZizzVXCw ($50 in chips)
Seat 2: 90Wb75h3W1BRpbqVnuk8gw ($52.55 in chips)
Seat 3: AjV5McH1KMMclY26QdLM5w ($25.25 in chips)
Seat 4: nhDtFZ2uuvm5hDKG7ZVEpA ($49.25 in chips)
Seat 5: GIJAc9kPrLZHLSX8Q6i99w ($36.25 in chips)
Seat 6: H8cPaCtX7d6meGUVSM5sxw ($56.60 in chips)
Seat 7: HZkVla4kK2SI42CVrPZ/ig ($16.95 in chips)
Seat 8: Ja2jdidjip2UeJnRzmzAAQ ($46.25 in chips)
Seat 9: pFtzb1sR4b0d1aw6aIRgDg ($55.65 in chips)
pFtzb1sR4b0d1aw6aIRgDg: posts small blind $0.25
xZCXQSXlrZkp3pZizzVXCw: posts big blind $0.50
*** HOLE CARDS ***
90Wb75h3W1BRpbqVnuk8gw: folds
AjV5McH1KMMclY26QdLM5w: folds
nhDtFZ2uuvm5hDKG7ZVEpA: folds
GIJAc9kPrLZHLSX8Q6i99w: folds
H8cPaCtX7d6meGUVSM5sxw: folds
HZkVla4kK2SI42CVrPZ/ig: folds
Ja2jdidjip2UeJnRzmzAAQ: raises $1 to $1.50
pFtzb1sR4b0d1aw6aIRgDg: folds
xZCXQSXlrZkp3pZizzVXCw: folds
Ja2jdidjip2UeJnRzmzAAQ collected $1.25 from pot
*** SUMMARY ***
Total pot $1.25 | Rake $0
Seat 1: xZCXQSXlrZkp3pZizzVXCw (big blind) folded before Flop
Seat 2: 90Wb75h3W1BRpbqVnuk8gw folded before Flop (didn't bet)
Seat 3: AjV5McH1KMMclY26QdLM5w folded before Flop (didn't bet)
Seat 4: nhDtFZ2uuvm5hDKG7ZVEpA folded before Flop (didn't bet)
Seat 5: GIJAc9kPrLZHLSX8Q6i99w folded before Flop (didn't bet)
Seat 6: H8cPaCtX7d6meGUVSM5sxw folded before Flop (didn't bet)
Seat 7: HZkVla4kK2SI42CVrPZ/ig folded before Flop (didn't bet)
Seat 8: Ja2jdidjip2UeJnRzmzAAQ (button) collected ($1.25)
Seat 9: pFtzb1sR4b0d1aw6aIRgDg (small blind) folded before Flop



PokerStars Game #59941392436:  Hold'em No Limit ($0.25/$0.50) - 2009/07/01 1:34:09 ET
Table '2lPOwetm4cfkZPbTmGPH/w' 2-max Seat #2 is the button
Seat 1: vUGdApqS8J/GJE2gaVWl1w ($25.15 in chips)
Seat 2: XFa6sBGjP2gxoIvxR3fZIg ($14.15 in chips)
XFa6sBGjP2gxoIvxR3fZIg: posts small blind $0.25
vUGdApqS8J/GJE2gaVWl1w: posts big blind $0.50
*** HOLE CARDS ***
XFa6sBGjP2gxoIvxR3fZIg: calls $0.25
vUGdApqS8J/GJE2gaVWl1w: checks
*** FLOP *** [5h Th 2h]
vUGdApqS8J/GJE2gaVWl1w: checks
XFa6sBGjP2gxoIvxR3fZIg: checks
*** TURN *** [5h Th 2h] [Td]
vUGdApqS8J/GJE2gaVWl1w: bets $1
XFa6sBGjP2gxoIvxR3fZIg: folds
vUGdApqS8J/GJE2gaVWl1w collected $0.95 from pot
vUGdApqS8J/GJE2gaVWl1w: doesn't show hand
*** SUMMARY ***
Total pot $1 | Rake $0.05
Board [5h Th 2h Td]
Seat 1: vUGdApqS8J/GJE2gaVWl1w (big blind) collected ($0.95)
Seat 2: XFa6sBGjP2gxoIvxR3fZIg (button) (small blind) folded on the Turn



PokerStars Game #59941394322:  Hold'em No Limit ($0.25/$0.50) - 2009/07/01 1:34:12 ET
Table 'B+sqsfj6d6zXicNfaseTaw' 2-max Seat #2 is the button
Seat 1: +4GNcSsecmapVGSdV0mUPA ($162.15 in chips)
Seat 2: Lv5RmpRe6LtPkBzM9Gpo5A ($60.65 in chips)
Lv5RmpRe6LtPkBzM9Gpo5A: posts small blind $0.25
+4GNcSsecmapVGSdV0mUPA: posts big blind $0.50
*** HOLE CARDS ***
Lv5RmpRe6LtPkBzM9Gpo5A: raises $1 to $1.50
+4GNcSsecmapVGSdV0mUPA: calls $1
*** FLOP *** [Kh Jc 3d]
+4GNcSsecmapVGSdV0mUPA: checks
Lv5RmpRe6LtPkBzM9Gpo5A: checks
*** TURN *** [Kh Jc 3d] [7c]
+4GNcSsecmapVGSdV0mUPA: checks
Lv5RmpRe6LtPkBzM9Gpo5A: checks
*** RIVER *** [Kh Jc 3d 7c] [5s]
+4GNcSsecmapVGSdV0mUPA: checks
Lv5RmpRe6LtPkBzM9Gpo5A: checks
*** SHOW DOWN ***
+4GNcSsecmapVGSdV0mUPA: shows [As 6h] (high card Ace)
Lv5RmpRe6LtPkBzM9Gpo5A: shows [Qh 3h] (a pair of Threes)
Lv5RmpRe6LtPkBzM9Gpo5A collected $2.85 from pot
*** SUMMARY ***
Total pot $3 | Rake $0.15
Board [Kh Jc 3d 7c 5s]
Seat 1: +4GNcSsecmapVGSdV0mUPA (big blind) showed [As 6h] and lost with high card Ace
Seat 2: Lv5RmpRe6LtPkBzM9Gpo5A (button) (small blind) showed [Qh 3h] and won ($2.85) with a pair of Threes



PokerStars Game #59941393734:  Hold'em No Limit ($0.25/$0.50) - 2009/07/01 1:34:12 ET
Table 'iq+aXfWVQRdV0u8SRTYUEg' 9-max Seat #3 is the button
Seat 1: 3yl8Q6QaLfGtyhN4/pEFgQ ($73.80 in chips)
Seat 2: J9N0lxHFd/Js2S0xZLbsIQ ($28.80 in chips)
Seat 3: Qi/PyOsKwaqtKIg0H+7ELg ($9.70 in chips)
Seat 4: vHYT5s323LpajBj+2c9zbQ ($31.60 in chips)
Seat 5: 997ViqAtWn1FPjJqcffwcA ($55.55 in chips)
Seat 7: SKnJuWHScqetA/qG5p+wCg ($30.80 in chips)
Seat 8: /DtIHuxEH+3tzKefmSV+Mw ($36.10 in chips)
Seat 9: olE1Z2rKWAV8+tGqmIBK9g ($26.20 in chips)
vHYT5s323LpajBj+2c9zbQ: posts small blind $0.25
997ViqAtWn1FPjJqcffwcA: posts big blind $0.50
*** HOLE CARDS ***
SKnJuWHScqetA/qG5p+wCg: folds
/DtIHuxEH+3tzKefmSV+Mw: folds
olE1Z2rKWAV8+tGqmIBK9g: folds
3yl8Q6QaLfGtyhN4/pEFgQ: calls $0.50
J9N0lxHFd/Js2S0xZLbsIQ: folds
Qi/PyOsKwaqtKIg0H+7ELg: folds
vHYT5s323LpajBj+2c9zbQ: folds
997ViqAtWn1FPjJqcffwcA: checks
*** FLOP *** [3d 6s 3c]
997ViqAtWn1FPjJqcffwcA: checks
3yl8Q6QaLfGtyhN4/pEFgQ: checks
*** TURN *** [3d 6s 3c] [Kh]
997ViqAtWn1FPjJqcffwcA: checks
3yl8Q6QaLfGtyhN4/pEFgQ: bets $1
997ViqAtWn1FPjJqcffwcA: calls $1
*** RIVER *** [3d 6s 3c Kh] [4d]
997ViqAtWn1FPjJqcffwcA: checks
3yl8Q6QaLfGtyhN4/pEFgQ: checks
*** SHOW DOWN ***
997ViqAtWn1FPjJqcffwcA: shows [9h 9s] (two pair, Nines and Threes)
3yl8Q6QaLfGtyhN4/pEFgQ: mucks hand
997ViqAtWn1FPjJqcffwcA collected $3.10 from pot
*** SUMMARY ***
Total pot $3.25 | Rake $0.15
Board [3d 6s 3c Kh 4d]
Seat 1: 3yl8Q6QaLfGtyhN4/pEFgQ mucked
Seat 2: J9N0lxHFd/Js2S0xZLbsIQ folded before Flop (didn't bet)
Seat 3: Qi/PyOsKwaqtKIg0H+7ELg (button) folded before Flop (didn't bet)
Seat 4: vHYT5s323LpajBj+2c9zbQ (small blind) folded before Flop
Seat 5: 997ViqAtWn1FPjJqcffwcA (big blind) showed [9h 9s] and won ($3.10) with two pair, Nines and Threes
Seat 7: SKnJuWHScqetA/qG5p+wCg folded before Flop (didn't bet)
Seat 8: /DtIHuxEH+3tzKefmSV+Mw folded before Flop (didn't bet)
Seat 9: olE1Z2rKWAV8+tGqmIBK9g folded before Flop (didn't bet)



PokerStars Game #59941393924:  Hold'em No Limit ($0.25/$0.50) - 2009/07/01 1:34:12 ET
Table 'ofnd8S4IdIPph1Cbn+x7hAbR5MkGhKEbz+X2bpfpu11Qmax Seat #7 is the button
Seat 1: qG3y+yB3IhWjAWO8gvk6Rg ($48.80 in chips)
Seat 2: 1xBtrSVBbgFH/viUWKqQeg ($29.95 in chips)
Seat 3: UVJbBPbDwNMEZadZB9WVmg ($10 in chips)
Seat 4: mZNMJI1mY40XTC0U7GZakA ($62.45 in chips)
Seat 5: 2YaCb/8u1SesrR+963XiZA ($10 in chips)
Seat 7: kJ06FP2Jc7cSdmywwvYOXw ($63.35 in chips)
Seat 8: R354x4oZnQcGCDV6GhjnpQ ($60.90 in chips)
Seat 9: 75K2MXwN65Sjfp1yHd50Hg ($10 in chips)
R354x4oZnQcGCDV6GhjnpQ: posts small blind $0.25
75K2MXwN65Sjfp1yHd50Hg: posts big blind $0.50
UVJbBPbDwNMEZadZB9WVmg: posts big blind $0.50
2YaCb/8u1SesrR+963XiZA: posts small & big blinds $0.75
*** HOLE CARDS ***
qG3y+yB3IhWjAWO8gvk6Rg: calls $0.50
1xBtrSVBbgFH/viUWKqQeg: folds
UVJbBPbDwNMEZadZB9WVmg: checks
mZNMJI1mY40XTC0U7GZakA: folds
2YaCb/8u1SesrR+963XiZA: checks
kJ06FP2Jc7cSdmywwvYOXw: folds
R354x4oZnQcGCDV6GhjnpQ: calls $0.25
75K2MXwN65Sjfp1yHd50Hg: checks
*** FLOP *** [9c Ks 4h]
R354x4oZnQcGCDV6GhjnpQ: bets $2.50
75K2MXwN65Sjfp1yHd50Hg: folds
qG3y+yB3IhWjAWO8gvk6Rg: calls $2.50
UVJbBPbDwNMEZadZB9WVmg: folds
2YaCb/8u1SesrR+963XiZA: folds
*** TURN *** [9c Ks 4h] [6c]
R354x4oZnQcGCDV6GhjnpQ: bets $4.50
qG3y+yB3IhWjAWO8gvk6Rg: folds
R354x4oZnQcGCDV6GhjnpQ collected $7.40 from pot
R354x4oZnQcGCDV6GhjnpQ: doesn't show hand
*** SUMMARY ***
Total pot $7.75 | Rake $0.35
Board [9c Ks 4h 6c]
Seat 1: qG3y+yB3IhWjAWO8gvk6Rg folded on the Turn
Seat 2: 1xBtrSVBbgFH/viUWKqQeg folded before Flop (didn't bet)
Seat 3: UVJbBPbDwNMEZadZB9WVmg folded on the Flop
Seat 4: mZNMJI1mY40XTC0U7GZakA folded before Flop (didn't bet)
Seat 5: 2YaCb/8u1SesrR+963XiZA folded on the Flop
Seat 7: kJ06FP2Jc7cSdmywwvYOXw (button) folded before Flop (didn't bet)
Seat 8: R354x4oZnQcGCDV6GhjnpQ (small blind) collected ($7.40)
Seat 9: 75K2MXwN65Sjfp1yHd50Hg (big blind) folded on the Flop



PokerStars Game #59941393928:  Hold'em No Limit ($0.25/$0.50) - 2009/07/01 1:34:12 ET
Table 'Nz0Vr7WMHL2g5Uk7dDZjpw' 9-max Seat #4 is the button
Seat 1: 9yMsdgReyOUerNsmTYCCDQ ($9 in chips)
Seat 2: SegjDnMxWMujiD57ESNL+g ($20.35 in chips)
Seat 3: c638Xxo+q5F/t5qMtmvmvQ ($50.65 in chips)
Seat 4: uw9QayAAxLM3Hb+HR7mSkg ($9.25 in chips)
Seat 5: WGW0DgjBUXs1ylURHG8vnQ ($14.05 in chips)
Seat 6: 997ViqAtWn1FPjJqcffwcA ($50 in chips)
Seat 7: KPLH0gELgFe2OuAnhJFI5w ($24.20 in chips)
Seat 8: aoL+R/61Kxmw69ypuPrWAQ ($30.80 in chips)
Seat 9: mSD1pginDsyHG5PDfqzphw ($19.25 in chips)
WGW0DgjBUXs1ylURHG8vnQ: posts small blind $0.25
997ViqAtWn1FPjJqcffwcA: posts big blind $0.50
*** HOLE CARDS ***
KPLH0gELgFe2OuAnhJFI5w: calls $0.50
aoL+R/61Kxmw69ypuPrWAQ: calls $0.50
mSD1pginDsyHG5PDfqzphw: folds
9yMsdgReyOUerNsmTYCCDQ: folds
SegjDnMxWMujiD57ESNL+g: folds
c638Xxo+q5F/t5qMtmvmvQ: folds
uw9QayAAxLM3Hb+HR7mSkg: folds
WGW0DgjBUXs1ylURHG8vnQ: calls $0.25
997ViqAtWn1FPjJqcffwcA: checks
*** FLOP *** [Tc 7c 3d]
WGW0DgjBUXs1ylURHG8vnQ: checks
997ViqAtWn1FPjJqcffwcA: checks
KPLH0gELgFe2OuAnhJFI5w: bets $0.50
aoL+R/61Kxmw69ypuPrWAQ: calls $0.50
WGW0DgjBUXs1ylURHG8vnQ: folds
997ViqAtWn1FPjJqcffwcA: folds
*** TURN *** [Tc 7c 3d] [5h]
KPLH0gELgFe2OuAnhJFI5w: bets $0.50
aoL+R/61Kxmw69ypuPrWAQ: calls $0.50
*** RIVER *** [Tc 7c 3d 5h] [5d]
KPLH0gELgFe2OuAnhJFI5w: bets $0.50
aoL+R/61Kxmw69ypuPrWAQ: folds
KPLH0gELgFe2OuAnhJFI5w collected $3.85 from pot
*** SUMMARY ***
Total pot $4 | Rake $0.15
Board [Tc 7c 3d 5h 5d]
Seat 1: 9yMsdgReyOUerNsmTYCCDQ folded before Flop (didn't bet)
Seat 2: SegjDnMxWMujiD57ESNL+g folded before Flop (didn't bet)
Seat 3: c638Xxo+q5F/t5qMtmvmvQ folded before Flop (didn't bet)
Seat 4: uw9QayAAxLM3Hb+HR7mSkg (button) folded before Flop (didn't bet)
Seat 5: WGW0DgjBUXs1ylURHG8vnQ (small blind) folded on the Flop
Seat 6: 997ViqAtWn1FPjJqcffwcA (big blind) folded on the Flop
Seat 7: KPLH0gELgFe2OuAnhJFI5w collected ($3.85)
Seat 8: aoL+R/61Kxmw69ypuPrWAQ folded on the River
Seat 9: mSD1pginDsyHG5PDfqzphw folded before Flop (didn't bet)



PokerStars Game #59941396880:  Hold'em No Limit ($0.25/$0.50) - 2009/07/01 1:34:17 ET
Table '+dXkOAQyS8j9PQZusUTMpg' 2-max Seat #2 is the button
Seat 1: Teld4PDKla7C8/Wfu2DSkg ($55.85 in chips)
Seat 2: +zI4bP23YIjMkUHqeN2xfw ($19.80 in chips)
+zI4bP23YIjMkUHqeN2xfw: posts small blind $0.25
Teld4PDKla7C8/Wfu2DSkg: posts big blind $0.50
*** HOLE CARDS ***
+zI4bP23YIjMkUHqeN2xfw: raises $1 to $1.50
Teld4PDKla7C8/Wfu2DSkg: calls $1
*** FLOP *** [3d Ts Th]
Teld4PDKla7C8/Wfu2DSkg: checks
+zI4bP23YIjMkUHqeN2xfw: bets $1.50
Teld4PDKla7C8/Wfu2DSkg: folds
+zI4bP23YIjMkUHqeN2xfw collected $2.85 from pot
*** SUMMARY ***
Total pot $3 | Rake $0.15
Board [3d Ts Th]
Seat 1: Teld4PDKla7C8/Wfu2DSkg (big blind) folded on the Flop
Seat 2: +zI4bP23YIjMkUHqeN2xfw (button) (small blind) collected ($2.85)



PokerStars Game #59941397342:  Hold'em No Limit ($0.25/$0.50) - 2009/07/01 1:34:18 ET
Table 'lSisgp6H7Fg1hH5VfjEjYQ' 9-max Seat #3 is the button
Seat 1: 5k9fvXD9suIgCxU4HLQjTw ($54.05 in chips)
Seat 2: 5acK4E7fzEwnplVBZ6eNWA ($50 in chips)
Seat 3: SKnJuWHScqetA/qG5p+wCg ($30 in chips)
Seat 5: mSD1pginDsyHG5PDfqzphw ($11.75 in chips)
Seat 6: +k7T5ocke8UwavtgUHm+Cg ($75.20 in chips)
Seat 7: IDtNLR9uFCDdjNsJWMHA5Q ($21.05 in chips)
Seat 8: a4JDWmpFQkL10XfAyuF51A ($9.50 in chips)
Seat 9: YzeKFbJVLmJGTgNH3ySQlw ($7.40 in chips)
FFVKBJT0lZf+jFlgvy7ang will be allowed to play after the button
mSD1pginDsyHG5PDfqzphw: posts small blind $0.25
+k7T5ocke8UwavtgUHm+Cg: posts big blind $0.50
*** HOLE CARDS ***
IDtNLR9uFCDdjNsJWMHA5Q: folds
a4JDWmpFQkL10XfAyuF51A: raises $1.50 to $2
YzeKFbJVLmJGTgNH3ySQlw: folds
5k9fvXD9suIgCxU4HLQjTw: folds
5acK4E7fzEwnplVBZ6eNWA: folds
SKnJuWHScqetA/qG5p+wCg: folds
mSD1pginDsyHG5PDfqzphw: folds
+k7T5ocke8UwavtgUHm+Cg: folds
a4JDWmpFQkL10XfAyuF51A collected $1.25 from pot
a4JDWmpFQkL10XfAyuF51A: doesn't show hand
*** SUMMARY ***
Total pot $1.25 | Rake $0
Seat 1: 5k9fvXD9suIgCxU4HLQjTw folded before Flop (didn't bet)
Seat 2: 5acK4E7fzEwnplVBZ6eNWA folded before Flop (didn't bet)
Seat 3: SKnJuWHScqetA/qG5p+wCg (button) folded before Flop (didn't bet)
Seat 5: mSD1pginDsyHG5PDfqzphw (small blind) folded before Flop
Seat 6: +k7T5ocke8UwavtgUHm+Cg (big blind) folded before Flop
Seat 7: IDtNLR9uFCDdjNsJWMHA5Q folded before Flop (didn't bet)
Seat 8: a4JDWmpFQkL10XfAyuF51A collected ($1.25)
Seat 9: YzeKFbJVLmJGTgNH3ySQlw folded before Flop (didn't bet)



PokerStars Game #59941397614:  Hold'em No Limit ($0.25/$0.50) - 2009/07/01 1:34:19 ET
Table '+z1aekfHkpp09pc8F9aViw' 6-max Seat #5 is the button
Seat 1: 9r1sdCwEwebh7DF+/EQqGg ($50 in chips)
Seat 2: 4QfsCWthT/vSLirorNXqtg ($51.50 in chips)
Seat 3: URYNc7fPA23K2UfadQbnCA ($47.75 in chips)
Seat 4: RowCSpSURHTOL/dcjg/Iug ($86.45 in chips)
Seat 5: 2igtJLmvIZ+HqX4XPgMPZA ($50.20 in chips)
Seat 6: GUnvMULl2qFOO1yenu1UBw ($52.50 in chips)
GUnvMULl2qFOO1yenu1UBw: posts small blind $0.25
9r1sdCwEwebh7DF+/EQqGg: posts big blind $0.50
*** HOLE CARDS ***
4QfsCWthT/vSLirorNXqtg: folds
URYNc7fPA23K2UfadQbnCA: folds
RowCSpSURHTOL/dcjg/Iug: folds
2igtJLmvIZ+HqX4XPgMPZA: folds
GUnvMULl2qFOO1yenu1UBw: folds
9r1sdCwEwebh7DF+/EQqGg collected $0.50 from pot
9r1sdCwEwebh7DF+/EQqGg is sitting out
9r1sdCwEwebh7DF+/EQqGg: doesn't show hand
9r1sdCwEwebh7DF+/EQqGg leaves the table
*** SUMMARY ***
Total pot $0.50 | Rake $0
Seat 1: 9r1sdCwEwebh7DF+/EQqGg (big blind) collected ($0.50)
Seat 2: 4QfsCWthT/vSLirorNXqtg folded before Flop (didn't bet)
Seat 3: URYNc7fPA23K2UfadQbnCA folded before Flop (didn't bet)
Seat 4: RowCSpSURHTOL/dcjg/Iug folded before Flop (didn't bet)
Seat 5: 2igtJLmvIZ+HqX4XPgMPZA (button) folded before Flop (didn't bet)
Seat 6: GUnvMULl2qFOO1yenu1UBw (small blind) folded before Flop



PokerStars Game #59941397768:  Hold'em No Limit ($0.25/$0.50) - 2009/07/01 1:34:19 ET
Table 'fx6MqwfYAj/Rt86hBz2L3Q' 9-max Seat #3 is the button
Seat 1: v/4aX0ejnaIFK4ftDk2Lyg ($50.65 in chips)
Seat 2: C3rGXblctNcWI6JYPHhaEg ($61.95 in chips)
Seat 3: iadBi5AEt7gTBXbDSSnMYQ ($39.85 in chips)
Seat 4: VhjwWfxHSx00WxzYih3KOA ($50 in chips)
Seat 6: 5k9fvXD9suIgCxU4HLQjTw ($50 in chips)
Seat 7: mSD1pginDsyHG5PDfqzphw ($10 in chips)
Seat 9: vO3QVRovWemcGMkm7ijAIA ($22.95 in chips)
VhjwWfxHSx00WxzYih3KOA: posts small blind $0.25
5k9fvXD9suIgCxU4HLQjTw: posts big blind $0.50
75K2MXwN65Sjfp1yHd50Hg: sits out
*** HOLE CARDS ***
e2+sK/yjnj94rXOKoxPP2A joins the table at seat #5
mSD1pginDsyHG5PDfqzphw: folds
vO3QVRovWemcGMkm7ijAIA: folds
v/4aX0ejnaIFK4ftDk2Lyg: folds
C3rGXblctNcWI6JYPHhaEg: calls $0.50
iadBi5AEt7gTBXbDSSnMYQ: folds
VhjwWfxHSx00WxzYih3KOA: folds
5k9fvXD9suIgCxU4HLQjTw: checks
*** FLOP *** [4s 8h Ad]
5k9fvXD9suIgCxU4HLQjTw: checks
C3rGXblctNcWI6JYPHhaEg: checks
*** TURN *** [4s 8h Ad] [7h]
5k9fvXD9suIgCxU4HLQjTw: checks
C3rGXblctNcWI6JYPHhaEg: bets $1.45
5k9fvXD9suIgCxU4HLQjTw: folds
C3rGXblctNcWI6JYPHhaEg collected $1.20 from pot
C3rGXblctNcWI6JYPHhaEg: doesn't show hand
*** SUMMARY ***
Total pot $1.25 | Rake $0.05
Board [4s 8h Ad 7h]
Seat 1: v/4aX0ejnaIFK4ftDk2Lyg folded before Flop (didn't bet)
Seat 2: C3rGXblctNcWI6JYPHhaEg collected ($1.20)
Seat 3: iadBi5AEt7gTBXbDSSnMYQ (button) folded before Flop (didn't bet)
Seat 4: VhjwWfxHSx00WxzYih3KOA (small blind) folded before Flop
Seat 6: 5k9fvXD9suIgCxU4HLQjTw (big blind) folded on the Turn
Seat 7: mSD1pginDsyHG5PDfqzphw folded before Flop (didn't bet)
Seat 9: vO3QVRovWemcGMkm7ijAIA folded before Flop (didn't bet)



PokerStars Game #59941398204:  Hold'em No Limit ($0.25/$0.50) - 2009/07/01 1:34:20 ET
Table '3FhG0gl3kMX3wBEEqj+wnQ' 9-max Seat #8 is the button
Seat 1: bxLSulbgr8LmKNjOzw8URg ($50 in chips)
Seat 3: YXCE3WOZi8g2sIf3y/plVw ($62.30 in chips)
Seat 4: e2+sK/yjnj94rXOKoxPP2A ($69.50 in chips)
Seat 5: XcLXSUMHSpshK/7Lh0M4Vg ($8.50 in chips)
Seat 6: 997ViqAtWn1FPjJqcffwcA ($109.80 in chips)
Seat 7: mSD1pginDsyHG5PDfqzphw ($10 in chips)
Seat 8: j3K/Jujr7PY4ZM2RZvlH6A ($60.35 in chips)
bxLSulbgr8LmKNjOzw8URg: posts small blind $0.25
vacmVLJJECYI6HjAynFcpg: is sitting out
YXCE3WOZi8g2sIf3y/plVw: posts big blind $0.50
*** HOLE CARDS ***
e2+sK/yjnj94rXOKoxPP2A: folds
XcLXSUMHSpshK/7Lh0M4Vg: raises $1.50 to $2
997ViqAtWn1FPjJqcffwcA: folds
mSD1pginDsyHG5PDfqzphw: folds
vacmVLJJECYI6HjAynFcpg leaves the table
j3K/Jujr7PY4ZM2RZvlH6A: calls $2
bxLSulbgr8LmKNjOzw8URg: folds
KA0tkubTlbhmo4ju+qgXPg has returned
YXCE3WOZi8g2sIf3y/plVw: folds
*** FLOP *** [2h 5d Qh]
HZkVla4kK2SI42CVrPZ/ig joins the table at seat #2
XcLXSUMHSpshK/7Lh0M4Vg: bets $2
j3K/Jujr7PY4ZM2RZvlH6A: folds
XcLXSUMHSpshK/7Lh0M4Vg collected $4.55 from pot
XcLXSUMHSpshK/7Lh0M4Vg: doesn't show hand
*** SUMMARY ***
Total pot $4.75 | Rake $0.20
Board [2h 5d Qh]
Seat 1: bxLSulbgr8LmKNjOzw8URg (small blind) folded before Flop
Seat 3: YXCE3WOZi8g2sIf3y/plVw (big blind) folded before Flop
Seat 4: e2+sK/yjnj94rXOKoxPP2A folded before Flop (didn't bet)
Seat 5: XcLXSUMHSpshK/7Lh0M4Vg collected ($4.55)
Seat 6: 997ViqAtWn1FPjJqcffwcA folded before Flop (didn't bet)
Seat 7: mSD1pginDsyHG5PDfqzphw folded before Flop (didn't bet)
Seat 8: j3K/Jujr7PY4ZM2RZvlH6A (button) folded on the Flop



PokerStars Game #59941398516:  Hold'em No Limit ($0.25/$0.50) - 2009/07/01 1:34:20 ET
Table 'Wwfm5/i+g/g2Nj2gT3jnVQ' 2-max Seat #2 is the button
Seat 1: CHRLZDaaxjbo68bwQD1C/Q ($7.45 in chips)
Seat 2: PKuuhUvIr5WSkJyPJa9dFw ($23.60 in chips)
PKuuhUvIr5WSkJyPJa9dFw: posts small blind $0.25
CHRLZDaaxjbo68bwQD1C/Q: posts big blind $0.50
*** HOLE CARDS ***
PKuuhUvIr5WSkJyPJa9dFw: raises $1 to $1.50
CHRLZDaaxjbo68bwQD1C/Q: folds
PKuuhUvIr5WSkJyPJa9dFw collected $1 from pot
PKuuhUvIr5WSkJyPJa9dFw: doesn't show hand
*** SUMMARY ***
Total pot $1 | Rake $0
Seat 1: CHRLZDaaxjbo68bwQD1C/Q (big blind) folded before Flop
Seat 2: PKuuhUvIr5WSkJyPJa9dFw (button) (small blind) collected ($1)



PokerStars Game #59941400794:  Hold'em No Limit ($0.25/$0.50) - 2009/07/01 1:34:24 ET
Table '2lPOwetm4cfkZPbTmGPH/w' 2-max Seat #1 is the button
Seat 1: vUGdApqS8J/GJE2gaVWl1w ($25.60 in chips)
Seat 2: XFa6sBGjP2gxoIvxR3fZIg ($13.65 in chips)
vUGdApqS8J/GJE2gaVWl1w: posts small blind $0.25
XFa6sBGjP2gxoIvxR3fZIg: posts big blind $0.50
*** HOLE CARDS ***
vUGdApqS8J/GJE2gaVWl1w: raises $1 to $1.50
XFa6sBGjP2gxoIvxR3fZIg: folds
vUGdApqS8J/GJE2gaVWl1w collected $1 from pot
*** SUMMARY ***
Total pot $1 | Rake $0
Seat 1: vUGdApqS8J/GJE2gaVWl1w (button) (small blind) collected ($1)
Seat 2: XFa6sBGjP2gxoIvxR3fZIg (big blind) folded before Flop



PokerStars Game #59941402472:  Hold'em No Limit ($0.25/$0.50) - 2009/07/01 1:34:27 ET
Table 'Wwfm5/i+g/g2Nj2gT3jnVQ' 2-max Seat #1 is the button
Seat 1: CHRLZDaaxjbo68bwQD1C/Q ($6.95 in chips)
Seat 2: PKuuhUvIr5WSkJyPJa9dFw ($24.10 in chips)
CHRLZDaaxjbo68bwQD1C/Q: posts small blind $0.25
PKuuhUvIr5WSkJyPJa9dFw: posts big blind $0.50
*** HOLE CARDS ***
CHRLZDaaxjbo68bwQD1C/Q: raises $0.50 to $1
PKuuhUvIr5WSkJyPJa9dFw: calls $0.50
*** FLOP *** [7c Tc 3s]
PKuuhUvIr5WSkJyPJa9dFw: checks
CHRLZDaaxjbo68bwQD1C/Q: checks
*** TURN *** [7c Tc 3s] [As]
PKuuhUvIr5WSkJyPJa9dFw: checks
CHRLZDaaxjbo68bwQD1C/Q: bets $1
PKuuhUvIr5WSkJyPJa9dFw: calls $1
*** RIVER *** [7c Tc 3s As] [Ks]
PKuuhUvIr5WSkJyPJa9dFw: checks
CHRLZDaaxjbo68bwQD1C/Q: bets $1.50
PKuuhUvIr5WSkJyPJa9dFw: calls $1.50
*** SHOW DOWN ***
CHRLZDaaxjbo68bwQD1C/Q: shows [7d 7h] (three of a kind, Sevens)
PKuuhUvIr5WSkJyPJa9dFw: mucks hand
CHRLZDaaxjbo68bwQD1C/Q collected $6.70 from pot
*** SUMMARY ***
Total pot $7 | Rake $0.30
Board [7c Tc 3s As Ks]
Seat 1: CHRLZDaaxjbo68bwQD1C/Q (button) (small blind) showed [7d 7h] and won ($6.70) with three of a kind, Sevens
Seat 2: PKuuhUvIr5WSkJyPJa9dFw (big blind) mucked



PokerStars Game #59941403326:  Hold'em No Limit ($0.25/$0.50) - 2009/07/01 1:34:29 ET
Table '9ojijpRcYQSQTh6xI+haUA' 2-max Seat #1 is the button
Seat 1: FqpibuVWLNsAN/Z7ROZLnA ($6.25 in chips)
Seat 2: TitTV+fFCcBZWOERdytydA ($77.70 in chips)
FqpibuVWLNsAN/Z7ROZLnA: posts small blind $0.25
TitTV+fFCcBZWOERdytydA: posts big blind $0.50
*** HOLE CARDS ***
FqpibuVWLNsAN/Z7ROZLnA: calls $0.25
TitTV+fFCcBZWOERdytydA: checks
*** FLOP *** [8d Qh Jh]
TitTV+fFCcBZWOERdytydA: checks
FqpibuVWLNsAN/Z7ROZLnA: bets $1
TitTV+fFCcBZWOERdytydA: calls $1
*** TURN *** [8d Qh Jh] [Td]
TitTV+fFCcBZWOERdytydA: checks
FqpibuVWLNsAN/Z7ROZLnA: bets $4.50
TitTV+fFCcBZWOERdytydA: folds
FqpibuVWLNsAN/Z7ROZLnA collected $2.90 from pot
*** SUMMARY ***
Total pot $3 | Rake $0.10
Board [8d Qh Jh Td]
Seat 1: FqpibuVWLNsAN/Z7ROZLnA (button) (small blind) collected ($2.90)
Seat 2: TitTV+fFCcBZWOERdytydA (big blind) folded on the Turn



PokerStars Game #59941404198:  Hold'em No Limit ($0.25/$0.50) - 2009/07/01 1:34:30 ET
Table '8BQGgNetI1NOvWeu3gtMNw' 2-max Seat #2 is the button
Seat 1: bypIyrYcAAifLfhZpGlKLA ($80.90 in chips)
Seat 2: Z4HwehErEwzsv/noQlfUlg ($134.60 in chips)
Z4HwehErEwzsv/noQlfUlg: posts small blind $0.25
bypIyrYcAAifLfhZpGlKLA: posts big blind $0.50
*** HOLE CARDS ***
Z4HwehErEwzsv/noQlfUlg: raises $2.50 to $3
bypIyrYcAAifLfhZpGlKLA: folds
Z4HwehErEwzsv/noQlfUlg collected $1 from pot
Z4HwehErEwzsv/noQlfUlg: doesn't show hand
*** SUMMARY ***
Total pot $1 | Rake $0
Seat 1: bypIyrYcAAifLfhZpGlKLA (big blind) folded before Flop
Seat 2: Z4HwehErEwzsv/noQlfUlg (button) (small blind) collected ($1)



PokerStars Game #59941404358:  Hold'em No Limit ($0.25/$0.50) - 2009/07/01 1:34:30 ET
Table 'ZYI3ZReBjdfKEYItkZHI6A' 9-max Seat #9 is the button
Seat 1: IYd5zG8k7vdBNVHbHg2Pag ($63.15 in chips)
Seat 2: 5acK4E7fzEwnplVBZ6eNWA ($50 in chips)
Seat 3: 75K2MXwN65Sjfp1yHd50Hg ($9.25 in chips)
Seat 5: ApHP7ouup365XIUFBdEDxg ($8.95 in chips)
Seat 6: 1xBtrSVBbgFH/viUWKqQeg ($29.70 in chips)
Seat 7: HWcfp1hY1hqvrddzW3/FQw ($21.30 in chips)
Seat 8: ji04uOybxCdpdefzlUQeKQ ($29.55 in chips)
Seat 9: HZkVla4kK2SI42CVrPZ/ig ($10.40 in chips)
IYd5zG8k7vdBNVHbHg2Pag: posts small blind $0.25
5acK4E7fzEwnplVBZ6eNWA: posts big blind $0.50
/UdtxmXsFx6K/14AbHqzbQ: sits out
*** HOLE CARDS ***
75K2MXwN65Sjfp1yHd50Hg: folds
ApHP7ouup365XIUFBdEDxg said, "straight and flush draws"
ApHP7ouup365XIUFBdEDxg: calls $0.50
1xBtrSVBbgFH/viUWKqQeg: raises $1.50 to $2
HWcfp1hY1hqvrddzW3/FQw: folds
ji04uOybxCdpdefzlUQeKQ: folds
HZkVla4kK2SI42CVrPZ/ig: folds
HWcfp1hY1hqvrddzW3/FQw said, "so u raised with nothin pre flop"
IYd5zG8k7vdBNVHbHg2Pag: folds
5acK4E7fzEwnplVBZ6eNWA: folds
ApHP7ouup365XIUFBdEDxg said, "A6 diamonds againts only you, yeah i raised"
ApHP7ouup365XIUFBdEDxg: calls $1.50
*** FLOP *** [Tc 6c 9d]
ApHP7ouup365XIUFBdEDxg: checks
1xBtrSVBbgFH/viUWKqQeg: checks
*** TURN *** [Tc 6c 9d] [As]
ApHP7ouup365XIUFBdEDxg: checks
1xBtrSVBbgFH/viUWKqQeg: bets $2
ApHP7ouup365XIUFBdEDxg: calls $2
*** RIVER *** [Tc 6c 9d As] [5c]
ApHP7ouup365XIUFBdEDxg: checks
1xBtrSVBbgFH/viUWKqQeg: bets $5
ApHP7ouup365XIUFBdEDxg: calls $4.95 and is all-in
*** SHOW DOWN ***
1xBtrSVBbgFH/viUWKqQeg: shows [Qs Qd] (a pair of Queens)
ApHP7ouup365XIUFBdEDxg: shows [3s Ah] (a pair of Aces)
ApHP7ouup365XIUFBdEDxg collected $17.75 from pot
*** SUMMARY ***
Total pot $18.65 | Rake $0.90
Board [Tc 6c 9d As 5c]
Seat 1: IYd5zG8k7vdBNVHbHg2Pag (small blind) folded before Flop
Seat 2: 5acK4E7fzEwnplVBZ6eNWA (big blind) folded before Flop
Seat 3: 75K2MXwN65Sjfp1yHd50Hg folded before Flop (didn't bet)
Seat 5: ApHP7ouup365XIUFBdEDxg showed [3s Ah] and won ($17.75) with a pair of Aces
Seat 6: 1xBtrSVBbgFH/viUWKqQeg showed [Qs Qd] and lost with a pair of Queens
Seat 7: HWcfp1hY1hqvrddzW3/FQw folded before Flop (didn't bet)
Seat 8: ji04uOybxCdpdefzlUQeKQ folded before Flop (didn't bet)
Seat 9: HZkVla4kK2SI42CVrPZ/ig (button) folded before Flop (didn't bet)



PokerStars Game #59941404708:  Hold'em No Limit ($0.25/$0.50) - 2009/07/01 1:34:31 ET
Table '+dXkOAQyS8j9PQZusUTMpg' 2-max Seat #1 is the button
Seat 1: Teld4PDKla7C8/Wfu2DSkg ($54.35 in chips)
Seat 2: +zI4bP23YIjMkUHqeN2xfw ($21.15 in chips)
Teld4PDKla7C8/Wfu2DSkg: posts small blind $0.25
+zI4bP23YIjMkUHqeN2xfw: posts big blind $0.50
*** HOLE CARDS ***
Teld4PDKla7C8/Wfu2DSkg: calls $0.25
+zI4bP23YIjMkUHqeN2xfw: raises $1 to $1.50
Teld4PDKla7C8/Wfu2DSkg: folds
+zI4bP23YIjMkUHqeN2xfw collected $1 from pot
*** SUMMARY ***
Total pot $1 | Rake $0
Seat 1: Teld4PDKla7C8/Wfu2DSkg (button) (small blind) folded before Flop
Seat 2: +zI4bP23YIjMkUHqeN2xfw (big blind) collected ($1)



PokerStars Game #59941405432:  Hold'em No Limit ($0.25/$0.50) - 2009/07/01 1:34:32 ET
Table '2lPOwetm4cfkZPbTmGPH/w' 2-max Seat #2 is the button
Seat 1: vUGdApqS8J/GJE2gaVWl1w ($26.10 in chips)
Seat 2: XFa6sBGjP2gxoIvxR3fZIg ($13.15 in chips)
XFa6sBGjP2gxoIvxR3fZIg: posts small blind $0.25
vUGdApqS8J/GJE2gaVWl1w: posts big blind $0.50
*** HOLE CARDS ***
XFa6sBGjP2gxoIvxR3fZIg: calls $0.25
vUGdApqS8J/GJE2gaVWl1w: checks
*** FLOP *** [2d Kc Ad]
vUGdApqS8J/GJE2gaVWl1w: checks
XFa6sBGjP2gxoIvxR3fZIg: checks
*** TURN *** [2d Kc Ad] [Ts]
vUGdApqS8J/GJE2gaVWl1w: checks
XFa6sBGjP2gxoIvxR3fZIg: checks
*** RIVER *** [2d Kc Ad Ts] [8h]
vUGdApqS8J/GJE2gaVWl1w: checks
XFa6sBGjP2gxoIvxR3fZIg: checks
*** SHOW DOWN ***
vUGdApqS8J/GJE2gaVWl1w: shows [3h 9d] (high card Ace)
XFa6sBGjP2gxoIvxR3fZIg: shows [5h Jc] (high card Ace - King+Jack kicker)
XFa6sBGjP2gxoIvxR3fZIg collected $0.95 from pot
*** SUMMARY ***
Total pot $1 | Rake $0.05
Board [2d Kc Ad Ts 8h]
Seat 1: vUGdApqS8J/GJE2gaVWl1w (big blind) showed [3h 9d] and lost with high card Ace
Seat 2: XFa6sBGjP2gxoIvxR3fZIg (button) (small blind) showed [5h Jc] and won ($0.95) with high card Ace



PokerStars Game #59941405456:  Hold'em No Limit ($0.25/$0.50) - 2009/07/01 1:34:32 ET
Table 'EiNh8p/wGJ1FP575iMFnqg' 9-max Seat #9 is the button
Seat 1: YFFlOZgyy1Mh4iBmuNRbmQ ($21.95 in chips)
Seat 3: ymLPoEIl7UL3TvZYmnadxQ ($46 in chips)
Seat 4: cMzaiXAM/ZAdNaEUu+LqhA ($58.45 in chips)
Seat 5: M+7+BTmX5vZatHVuoRB1nA ($73.20 in chips)
Seat 6: viwBDtJsY6JfsFOdBAyJIQ ($8.45 in chips)
Seat 7: 997ViqAtWn1FPjJqcffwcA ($50 in chips)
Seat 8: mSD1pginDsyHG5PDfqzphw ($10 in chips)
Seat 9: GuPkZObrz5Zkkn8FsEdF9w ($34.60 in chips)
YFFlOZgyy1Mh4iBmuNRbmQ: posts small blind $0.25
ymLPoEIl7UL3TvZYmnadxQ: posts big blind $0.50
*** HOLE CARDS ***
cMzaiXAM/ZAdNaEUu+LqhA: folds
M+7+BTmX5vZatHVuoRB1nA: folds
viwBDtJsY6JfsFOdBAyJIQ: raises $1.50 to $2
997ViqAtWn1FPjJqcffwcA: folds
mSD1pginDsyHG5PDfqzphw: folds
GuPkZObrz5Zkkn8FsEdF9w: folds
YFFlOZgyy1Mh4iBmuNRbmQ: calls $1.75
GRV8J6o4lVSBDEyjt6BwMg joins the table at seat #2
ymLPoEIl7UL3TvZYmnadxQ: folds
*** FLOP *** [5s 4s 8h]
YFFlOZgyy1Mh4iBmuNRbmQ: bets $2
viwBDtJsY6JfsFOdBAyJIQ: raises $4.45 to $6.45 and is all-in
YFFlOZgyy1Mh4iBmuNRbmQ: folds
viwBDtJsY6JfsFOdBAyJIQ collected $8.10 from pot
*** SUMMARY ***
Total pot $8.50 | Rake $0.40
Board [5s 4s 8h]
Seat 1: YFFlOZgyy1Mh4iBmuNRbmQ (small blind) folded on the Flop
Seat 3: ymLPoEIl7UL3TvZYmnadxQ (big blind) folded before Flop
Seat 4: cMzaiXAM/ZAdNaEUu+LqhA folded before Flop (didn't bet)
Seat 5: M+7+BTmX5vZatHVuoRB1nA folded before Flop (didn't bet)
Seat 6: viwBDtJsY6JfsFOdBAyJIQ collected ($8.10)
Seat 7: 997ViqAtWn1FPjJqcffwcA folded before Flop (didn't bet)
Seat 8: mSD1pginDsyHG5PDfqzphw folded before Flop (didn't bet)
Seat 9: GuPkZObrz5Zkkn8FsEdF9w (button) folded before Flop (didn't bet)



PokerStars Game #59941406000:  Hold'em No Limit ($0.25/$0.50) - 2009/07/01 1:34:33 ET
Table 'ibNfFy0bCzuBaUORla0aGw' 9-max Seat #9 is the button
Seat 1: xZCXQSXlrZkp3pZizzVXCw ($49.50 in chips)
Seat 2: 90Wb75h3W1BRpbqVnuk8gw ($52.55 in chips)
Seat 3: AjV5McH1KMMclY26QdLM5w ($25.25 in chips)
Seat 4: nhDtFZ2uuvm5hDKG7ZVEpA ($49.25 in chips)
Seat 5: GIJAc9kPrLZHLSX8Q6i99w ($36.25 in chips)
Seat 6: H8cPaCtX7d6meGUVSM5sxw ($56.60 in chips)
Seat 7: HZkVla4kK2SI42CVrPZ/ig ($16.95 in chips)
Seat 8: Ja2jdidjip2UeJnRzmzAAQ ($47 in chips)
Seat 9: pFtzb1sR4b0d1aw6aIRgDg ($55.40 in chips)
xZCXQSXlrZkp3pZizzVXCw: posts small blind $0.25
90Wb75h3W1BRpbqVnuk8gw: posts big blind $0.50
*** HOLE CARDS ***
AjV5McH1KMMclY26QdLM5w: folds
nhDtFZ2uuvm5hDKG7ZVEpA: raises $1 to $1.50
GIJAc9kPrLZHLSX8Q6i99w: folds
H8cPaCtX7d6meGUVSM5sxw: raises $1.75 to $3.25
HZkVla4kK2SI42CVrPZ/ig: folds
Ja2jdidjip2UeJnRzmzAAQ: folds
pFtzb1sR4b0d1aw6aIRgDg: folds
GIJAc9kPrLZHLSX8Q6i99w leaves the table
xZCXQSXlrZkp3pZizzVXCw: folds
90Wb75h3W1BRpbqVnuk8gw: folds
nhDtFZ2uuvm5hDKG7ZVEpA: calls $1.75
*** FLOP *** [5c Kc 8h]
nhDtFZ2uuvm5hDKG7ZVEpA: bets $3
H8cPaCtX7d6meGUVSM5sxw: raises $6 to $9
nhDtFZ2uuvm5hDKG7ZVEpA: raises $11 to $20
H8cPaCtX7d6meGUVSM5sxw: folds
nhDtFZ2uuvm5hDKG7ZVEpA collected $24.05 from pot
*** SUMMARY ***
Total pot $25.25 | Rake $1.20
Board [5c Kc 8h]
Seat 1: xZCXQSXlrZkp3pZizzVXCw (small blind) folded before Flop
Seat 2: 90Wb75h3W1BRpbqVnuk8gw (big blind) folded before Flop
Seat 3: AjV5McH1KMMclY26QdLM5w folded before Flop (didn't bet)
Seat 4: nhDtFZ2uuvm5hDKG7ZVEpA collected ($24.05)
Seat 5: GIJAc9kPrLZHLSX8Q6i99w folded before Flop (didn't bet)
Seat 6: H8cPaCtX7d6meGUVSM5sxw folded on the Flop
Seat 7: HZkVla4kK2SI42CVrPZ/ig folded before Flop (didn't bet)
Seat 8: Ja2jdidjip2UeJnRzmzAAQ folded before Flop (didn't bet)
Seat 9: pFtzb1sR4b0d1aw6aIRgDg (button) folded before Flop (didn't bet)



PokerStars Game #59941407220:  Hold'em No Limit ($0.25/$0.50) - 2009/07/01 1:34:35 ET
Table 'tyR5AZNKV8Aadbrnrnlg7g' 6-max Seat #6 is the button
Seat 1: BgOXYI0yYSN1ULC4FqsNkg ($73.45 in chips)
Seat 2: BAjwVL+zKKd0s0fAWstzQQ ($13.90 in chips)
Seat 3: JFLrYNyQmwPhRQAtoSAuyA ($57 in chips)
Seat 4: 4QfsCWthT/vSLirorNXqtg ($85.70 in chips)
Seat 5: GUnvMULl2qFOO1yenu1UBw ($87.60 in chips)
Seat 6: 498aWaGsW4uGfuWl+2FCGw ($65.65 in chips)
BgOXYI0yYSN1ULC4FqsNkg: posts small blind $0.25
BAjwVL+zKKd0s0fAWstzQQ: posts big blind $0.50
*** HOLE CARDS ***
JFLrYNyQmwPhRQAtoSAuyA: folds
4QfsCWthT/vSLirorNXqtg: folds
GUnvMULl2qFOO1yenu1UBw: folds
498aWaGsW4uGfuWl+2FCGw: calls $0.50
BgOXYI0yYSN1ULC4FqsNkg: calls $0.25
BAjwVL+zKKd0s0fAWstzQQ: checks
*** FLOP *** [2d 5d Jc]
BgOXYI0yYSN1ULC4FqsNkg: checks
BAjwVL+zKKd0s0fAWstzQQ: checks
498aWaGsW4uGfuWl+2FCGw: checks
*** TURN *** [2d 5d Jc] [2h]
BgOXYI0yYSN1ULC4FqsNkg: checks
BAjwVL+zKKd0s0fAWstzQQ: checks
498aWaGsW4uGfuWl+2FCGw: bets $0.50
BgOXYI0yYSN1ULC4FqsNkg: folds
BAjwVL+zKKd0s0fAWstzQQ: calls $0.50
*** RIVER *** [2d 5d Jc 2h] [Td]
BAjwVL+zKKd0s0fAWstzQQ: checks
498aWaGsW4uGfuWl+2FCGw: checks
*** SHOW DOWN ***
BAjwVL+zKKd0s0fAWstzQQ: shows [4s Ad] (a pair of Deuces)
498aWaGsW4uGfuWl+2FCGw: mucks hand
BAjwVL+zKKd0s0fAWstzQQ collected $2.40 from pot
*** SUMMARY ***
Total pot $2.50 | Rake $0.10
Board [2d 5d Jc 2h Td]
Seat 1: BgOXYI0yYSN1ULC4FqsNkg (small blind) folded on the Turn
Seat 2: BAjwVL+zKKd0s0fAWstzQQ (big blind) showed [4s Ad] and won ($2.40) with a pair of Deuces
Seat 3: JFLrYNyQmwPhRQAtoSAuyA folded before Flop (didn't bet)
Seat 4: 4QfsCWthT/vSLirorNXqtg folded before Flop (didn't bet)
Seat 5: GUnvMULl2qFOO1yenu1UBw folded before Flop (didn't bet)
Seat 6: 498aWaGsW4uGfuWl+2FCGw (button) mucked



PokerStars Game #59941408144:  Hold'em No Limit ($0.25/$0.50) - 2009/07/01 1:34:37 ET
Table 'hSTs/dUsYLgJQuF2Onp0MQ' 6-max Seat #5 is the button
Seat 1: 1WUCqNG+p+vfWRTXNu4ljw ($50.75 in chips)
Seat 2: Hdd4js36ITbTJ/QuVYwTlA ($113 in chips)
Seat 3: lxIzoHy0RnkfFSODHC2liw ($50 in chips)
Seat 4: 2igtJLmvIZ+HqX4XPgMPZA ($50 in chips)
Seat 5: FsRQ5ECdlLkLYI5le8+PDQ ($49.25 in chips)
Seat 6: M1KyQQvVPVuxqTAB8sR/zQ ($91.80 in chips)
M1KyQQvVPVuxqTAB8sR/zQ: posts small blind $0.25
1WUCqNG+p+vfWRTXNu4ljw: posts big blind $0.50
*** HOLE CARDS ***
Hdd4js36ITbTJ/QuVYwTlA: folds
lxIzoHy0RnkfFSODHC2liw: folds
2igtJLmvIZ+HqX4XPgMPZA: folds
FsRQ5ECdlLkLYI5le8+PDQ: folds
M1KyQQvVPVuxqTAB8sR/zQ: folds
1WUCqNG+p+vfWRTXNu4ljw collected $0.50 from pot
*** SUMMARY ***
Total pot $0.50 | Rake $0
Seat 1: 1WUCqNG+p+vfWRTXNu4ljw (big blind) collected ($0.50)
Seat 2: Hdd4js36ITbTJ/QuVYwTlA folded before Flop (didn't bet)
Seat 3: lxIzoHy0RnkfFSODHC2liw folded before Flop (didn't bet)
Seat 4: 2igtJLmvIZ+HqX4XPgMPZA folded before Flop (didn't bet)
Seat 5: FsRQ5ECdlLkLYI5le8+PDQ (button) folded before Flop (didn't bet)
Seat 6: M1KyQQvVPVuxqTAB8sR/zQ (small blind) folded before Flop



PokerStars Game #59941407954:  Hold'em No Limit ($0.25/$0.50) - 2009/07/01 1:34:37 ET
Table 'B+sqsfj6d6zXicNfaseTaw' 2-max Seat #1 is the button
Seat 1: +4GNcSsecmapVGSdV0mUPA ($160.65 in chips)
Seat 2: Lv5RmpRe6LtPkBzM9Gpo5A ($62 in chips)
+4GNcSsecmapVGSdV0mUPA: posts small blind $0.25
Lv5RmpRe6LtPkBzM9Gpo5A: posts big blind $0.50
*** HOLE CARDS ***
+4GNcSsecmapVGSdV0mUPA: calls $0.25
Lv5RmpRe6LtPkBzM9Gpo5A: checks
*** FLOP *** [7c 6s Ts]
Lv5RmpRe6LtPkBzM9Gpo5A: checks
+4GNcSsecmapVGSdV0mUPA: bets $0.50
Lv5RmpRe6LtPkBzM9Gpo5A: calls $0.50
*** TURN *** [7c 6s Ts] [7s]
Lv5RmpRe6LtPkBzM9Gpo5A: checks
+4GNcSsecmapVGSdV0mUPA: bets $0.50
Lv5RmpRe6LtPkBzM9Gpo5A: calls $0.50
*** RIVER *** [7c 6s Ts 7s] [Ad]
Lv5RmpRe6LtPkBzM9Gpo5A: checks
+4GNcSsecmapVGSdV0mUPA: checks
*** SHOW DOWN ***
Lv5RmpRe6LtPkBzM9Gpo5A: shows [Td 4s] (two pair, Tens and Sevens)
+4GNcSsecmapVGSdV0mUPA: mucks hand
Lv5RmpRe6LtPkBzM9Gpo5A collected $2.90 from pot
*** SUMMARY ***
Total pot $3 | Rake $0.10
Board [7c 6s Ts 7s Ad]
Seat 1: +4GNcSsecmapVGSdV0mUPA (button) (small blind) mucked
Seat 2: Lv5RmpRe6LtPkBzM9Gpo5A (big blind) showed [Td 4s] and won ($2.90) with two pair, Tens and Sevens



PokerStars Game #59941409472:  Hold'em No Limit ($0.25/$0.50) - 2009/07/01 1:34:39 ET
Table '8BQGgNetI1NOvWeu3gtMNw' 2-max Seat #1 is the button
Seat 1: bypIyrYcAAifLfhZpGlKLA ($80.40 in chips)
Seat 2: Z4HwehErEwzsv/noQlfUlg ($135.10 in chips)
bypIyrYcAAifLfhZpGlKLA: posts small blind $0.25
Z4HwehErEwzsv/noQlfUlg: posts big blind $0.50
*** HOLE CARDS ***
bypIyrYcAAifLfhZpGlKLA: raises $1 to $1.50
Z4HwehErEwzsv/noQlfUlg: calls $1
*** FLOP *** [Qs 5d 9s]
Z4HwehErEwzsv/noQlfUlg: checks
bypIyrYcAAifLfhZpGlKLA: checks
*** TURN *** [Qs 5d 9s] [Jd]
Z4HwehErEwzsv/noQlfUlg: bets $1.50
bypIyrYcAAifLfhZpGlKLA: calls $1.50
*** RIVER *** [Qs 5d 9s Jd] [5h]
Z4HwehErEwzsv/noQlfUlg: checks
bypIyrYcAAifLfhZpGlKLA: checks
*** SHOW DOWN ***
Z4HwehErEwzsv/noQlfUlg: shows [4s 3d] (a pair of Fives)
bypIyrYcAAifLfhZpGlKLA: shows [7s 7c] (two pair, Sevens and Fives)
bypIyrYcAAifLfhZpGlKLA collected $5.75 from pot
*** SUMMARY ***
Total pot $6 | Rake $0.25
Board [Qs 5d 9s Jd 5h]
Seat 1: bypIyrYcAAifLfhZpGlKLA (button) (small blind) showed [7s 7c] and won ($5.75) with two pair, Sevens and Fives
Seat 2: Z4HwehErEwzsv/noQlfUlg (big blind) showed [4s 3d] and lost with a pair of Fives



PokerStars Game #59941410628:  Hold'em No Limit ($0.25/$0.50) - 2009/07/01 1:34:41 ET
Table 'hWT2kq66tnKEpD26cia6fQ' 2-max Seat #2 is the button
Seat 1: Ce3KNFP+ao7Da9NHb65raw ($28.45 in chips)
Seat 2: 16tvT7AYgZ2LgiGFcvFKQg ($46.30 in chips)
16tvT7AYgZ2LgiGFcvFKQg: posts small blind $0.25
Ce3KNFP+ao7Da9NHb65raw: posts big blind $0.50
*** HOLE CARDS ***
16tvT7AYgZ2LgiGFcvFKQg: folds
Ce3KNFP+ao7Da9NHb65raw collected $0.50 from pot
*** SUMMARY ***
Total pot $0.50 | Rake $0
Seat 1: Ce3KNFP+ao7Da9NHb65raw (big blind) collected ($0.50)
Seat 2: 16tvT7AYgZ2LgiGFcvFKQg (button) (small blind) folded before Flop



PokerStars Game #59941410104:  Hold'em No Limit ($0.25/$0.50) - 2009/07/01 1:34:41 ET
Table '+dXkOAQyS8j9PQZusUTMpg' 2-max Seat #2 is the button
Seat 1: Teld4PDKla7C8/Wfu2DSkg ($53.85 in chips)
Seat 2: +zI4bP23YIjMkUHqeN2xfw ($21.65 in chips)
+zI4bP23YIjMkUHqeN2xfw: posts small blind $0.25
Teld4PDKla7C8/Wfu2DSkg: posts big blind $0.50
*** HOLE CARDS ***
+zI4bP23YIjMkUHqeN2xfw: folds
Teld4PDKla7C8/Wfu2DSkg collected $0.50 from pot
Teld4PDKla7C8/Wfu2DSkg: doesn't show hand
*** SUMMARY ***
Total pot $0.50 | Rake $0
Seat 1: Teld4PDKla7C8/Wfu2DSkg (big blind) collected ($0.50)
Seat 2: +zI4bP23YIjMkUHqeN2xfw (button) (small blind) folded before Flop



PokerStars Game #59941411992:  Hold'em No Limit ($0.25/$0.50) - 2009/07/01 1:34:44 ET
Table '1pi9mHyVuXF/uue+aPQc4w' 9-max Seat #5 is the button
Seat 2: vHYT5s323LpajBj+2c9zbQ ($25.90 in chips)
Seat 3: HZkVla4kK2SI42CVrPZ/ig ($10 in chips)
Seat 4: mSD1pginDsyHG5PDfqzphw ($11.80 in chips)
Seat 5: zE9cVigS2nW/Ljy4K4bUQA ($30.65 in chips)
Seat 6: 1xBtrSVBbgFH/viUWKqQeg ($45.80 in chips)
Seat 7: 61sfw5QTu62YYIt68OsdrA ($34.80 in chips)
Seat 8: g4k0NXISyLCqaSWZDBjfEg ($97.80 in chips)
1xBtrSVBbgFH/viUWKqQeg: posts small blind $0.25
61sfw5QTu62YYIt68OsdrA: posts big blind $0.50
Q/gZC63lfOMr7YhWKPCxoQ: sits out
M+D23GG26WXQ/2gyjREVOQ: sits out
*** HOLE CARDS ***
g4k0NXISyLCqaSWZDBjfEg: folds
vHYT5s323LpajBj+2c9zbQ: folds
HZkVla4kK2SI42CVrPZ/ig: folds
mSD1pginDsyHG5PDfqzphw: folds
zE9cVigS2nW/Ljy4K4bUQA: folds
1xBtrSVBbgFH/viUWKqQeg: raises $0.50 to $1
61sfw5QTu62YYIt68OsdrA: calls $0.50
*** FLOP *** [7s 2c Qs]
1xBtrSVBbgFH/viUWKqQeg: checks
61sfw5QTu62YYIt68OsdrA: checks
*** TURN *** [7s 2c Qs] [Qh]
1xBtrSVBbgFH/viUWKqQeg: checks
61sfw5QTu62YYIt68OsdrA: checks
*** RIVER *** [7s 2c Qs Qh] [Jd]
1xBtrSVBbgFH/viUWKqQeg: bets $2
61sfw5QTu62YYIt68OsdrA: folds
1xBtrSVBbgFH/viUWKqQeg collected $1.90 from pot
*** SUMMARY ***
Total pot $2 | Rake $0.10
Board [7s 2c Qs Qh Jd]
Seat 2: vHYT5s323LpajBj+2c9zbQ folded before Flop (didn't bet)
Seat 3: HZkVla4kK2SI42CVrPZ/ig folded before Flop (didn't bet)
Seat 4: mSD1pginDsyHG5PDfqzphw folded before Flop (didn't bet)
Seat 5: zE9cVigS2nW/Ljy4K4bUQA (button) folded before Flop (didn't bet)
Seat 6: 1xBtrSVBbgFH/viUWKqQeg (small blind) collected ($1.90)
Seat 7: 61sfw5QTu62YYIt68OsdrA (big blind) folded on the River
Seat 8: g4k0NXISyLCqaSWZDBjfEg folded before Flop (didn't bet)



PokerStars Game #59941412312:  Hold'em No Limit ($0.25/$0.50) - 2009/07/01 1:34:45 ET
Table '99gCy/CZQwPIjZWH+BguQg' 9-max Seat #3 is the button
Seat 2: 7CKaQEWhd40e2lLifzZ1Cw ($56.60 in chips)
Seat 3: VhjwWfxHSx00WxzYih3KOA ($50 in chips)
Seat 4: bxLSulbgr8LmKNjOzw8URg ($86.20 in chips)
Seat 5: YXCE3WOZi8g2sIf3y/plVw ($50.90 in chips)
Seat 6: OcnLOMVFdy23jXnoTyaO5Q ($293.10 in chips)
Seat 8: tTzoQkWA3nKw6kfnSYw3rQ ($49.50 in chips)
Seat 9: j3K/Jujr7PY4ZM2RZvlH6A ($78.45 in chips)
bxLSulbgr8LmKNjOzw8URg: posts small blind $0.25
YXCE3WOZi8g2sIf3y/plVw: posts big blind $0.50
Bawookles: sits out
*** HOLE CARDS ***
ottZQkg1UDWk85BtBzGJzg leaves the table
OcnLOMVFdy23jXnoTyaO5Q: folds
tTzoQkWA3nKw6kfnSYw3rQ: calls $0.50
j3K/Jujr7PY4ZM2RZvlH6A: raises $2.50 to $3
7CKaQEWhd40e2lLifzZ1Cw: folds
VhjwWfxHSx00WxzYih3KOA: folds
bxLSulbgr8LmKNjOzw8URg: folds
YXCE3WOZi8g2sIf3y/plVw: folds
tTzoQkWA3nKw6kfnSYw3rQ: calls $2.50
*** FLOP *** [Qh Qd 9d]
tTzoQkWA3nKw6kfnSYw3rQ: checks
j3K/Jujr7PY4ZM2RZvlH6A: bets $4.50
tTzoQkWA3nKw6kfnSYw3rQ: calls $4.50
*** TURN *** [Qh Qd 9d] [4h]
tweakachu joins the table at seat #7
tTzoQkWA3nKw6kfnSYw3rQ: checks
j3K/Jujr7PY4ZM2RZvlH6A: bets $7.50
tTzoQkWA3nKw6kfnSYw3rQ: calls $7.50
*** RIVER *** [Qh Qd 9d 4h] [Kd]
tTzoQkWA3nKw6kfnSYw3rQ: bets $2.50
j3K/Jujr7PY4ZM2RZvlH6A: raises $12 to $14.50
7CKaQEWhd40e2lLifzZ1Cw leaves the table
tTzoQkWA3nKw6kfnSYw3rQ: calls $12
*** SHOW DOWN ***
j3K/Jujr7PY4ZM2RZvlH6A: shows [7d 7s] (two pair, Queens and Sevens)
tTzoQkWA3nKw6kfnSYw3rQ: shows [Kh Th] (two pair, Kings and Queens)
tTzoQkWA3nKw6kfnSYw3rQ collected $56.85 from pot
*** SUMMARY ***
Total pot $59.75 | Rake $2.90
Board [Qh Qd 9d 4h Kd]
Seat 2: 7CKaQEWhd40e2lLifzZ1Cw folded before Flop (didn't bet)
Seat 3: VhjwWfxHSx00WxzYih3KOA (button) folded before Flop (didn't bet)
Seat 4: bxLSulbgr8LmKNjOzw8URg (small blind) folded before Flop
Seat 5: YXCE3WOZi8g2sIf3y/plVw (big blind) folded before Flop
Seat 6: OcnLOMVFdy23jXnoTyaO5Q folded before Flop (didn't bet)
Seat 8: tTzoQkWA3nKw6kfnSYw3rQ showed [Kh Th] and won ($56.85) with two pair, Kings and Queens
Seat 9: j3K/Jujr7PY4ZM2RZvlH6A showed [7d 7s] and lost with two pair, Queens and Sevens



PokerStars Game #59941412612:  Hold'em No Limit ($0.25/$0.50) - 2009/07/01 1:34:45 ET
Table 'NCiXr0d5CEKBQr/cZgLhbA' 9-max Seat #6 is the button
Seat 1: pFtzb1sR4b0d1aw6aIRgDg ($80.45 in chips)
Seat 2: AjV5McH1KMMclY26QdLM5w ($44.55 in chips)
Seat 3: xZCXQSXlrZkp3pZizzVXCw ($97.15 in chips)
Seat 4: 5k9fvXD9suIgCxU4HLQjTw ($53.95 in chips)
Seat 5: Ja2jdidjip2UeJnRzmzAAQ ($48.25 in chips)
Seat 6: t1qL+wRXOwTLB4TBbcw2QA ($47 in chips)
Seat 7: dXhO5i7KOoVcsGqbklD+jw ($36.25 in chips)
Seat 8: XA3GzEhYmqB0KknKKPDZGQ ($30.50 in chips)
Seat 9: 4WLZvqBn5qv5tds5kt5A1Q ($57.95 in chips)
dXhO5i7KOoVcsGqbklD+jw: posts small blind $0.25
XA3GzEhYmqB0KknKKPDZGQ: posts big blind $0.50
*** HOLE CARDS ***
4WLZvqBn5qv5tds5kt5A1Q: folds
pFtzb1sR4b0d1aw6aIRgDg: folds
AjV5McH1KMMclY26QdLM5w: folds
xZCXQSXlrZkp3pZizzVXCw: raises $1 to $1.50
5k9fvXD9suIgCxU4HLQjTw: folds
Ja2jdidjip2UeJnRzmzAAQ: folds
t1qL+wRXOwTLB4TBbcw2QA: folds
dXhO5i7KOoVcsGqbklD+jw: calls $1.25
XA3GzEhYmqB0KknKKPDZGQ: calls $1
*** FLOP *** [3d 8d 9s]
dXhO5i7KOoVcsGqbklD+jw: bets $0.50
XA3GzEhYmqB0KknKKPDZGQ: raises $0.50 to $1
xZCXQSXlrZkp3pZizzVXCw: folds
dXhO5i7KOoVcsGqbklD+jw: calls $0.50
*** TURN *** [3d 8d 9s] [As]
dXhO5i7KOoVcsGqbklD+jw: bets $1
XA3GzEhYmqB0KknKKPDZGQ: calls $1
*** RIVER *** [3d 8d 9s As] [4d]
dXhO5i7KOoVcsGqbklD+jw: bets $3.50
XA3GzEhYmqB0KknKKPDZGQ: calls $3.50
*** SHOW DOWN ***
dXhO5i7KOoVcsGqbklD+jw: shows [Ac 4c] (two pair, Aces and Fours)
XA3GzEhYmqB0KknKKPDZGQ: mucks hand
dXhO5i7KOoVcsGqbklD+jw collected $14.75 from pot
*** SUMMARY ***
Total pot $15.50 | Rake $0.75
Board [3d 8d 9s As 4d]
Seat 1: pFtzb1sR4b0d1aw6aIRgDg folded before Flop (didn't bet)
Seat 2: AjV5McH1KMMclY26QdLM5w folded before Flop (didn't bet)
Seat 3: xZCXQSXlrZkp3pZizzVXCw folded on the Flop
Seat 4: 5k9fvXD9suIgCxU4HLQjTw folded before Flop (didn't bet)
Seat 5: Ja2jdidjip2UeJnRzmzAAQ folded before Flop (didn't bet)
Seat 6: t1qL+wRXOwTLB4TBbcw2QA (button) folded before Flop (didn't bet)
Seat 7: dXhO5i7KOoVcsGqbklD+jw (small blind) showed [Ac 4c] and won ($14.75) with two pair, Aces and Fours
Seat 8: XA3GzEhYmqB0KknKKPDZGQ (big blind) mucked
Seat 9: 4WLZvqBn5qv5tds5kt5A1Q folded before Flop (didn't bet)



PokerStars Game #59941413372:  Hold'em No Limit ($0.25/$0.50) - 2009/07/01 1:34:46 ET
Table '+dXkOAQyS8j9PQZusUTMpg' 2-max Seat #1 is the button
Seat 1: Teld4PDKla7C8/Wfu2DSkg ($54.10 in chips)
Seat 2: +zI4bP23YIjMkUHqeN2xfw ($21.40 in chips)
Teld4PDKla7C8/Wfu2DSkg: posts small blind $0.25
+zI4bP23YIjMkUHqeN2xfw: posts big blind $0.50
*** HOLE CARDS ***
Teld4PDKla7C8/Wfu2DSkg: raises $1 to $1.50
+zI4bP23YIjMkUHqeN2xfw: folds
Teld4PDKla7C8/Wfu2DSkg collected $1 from pot
Teld4PDKla7C8/Wfu2DSkg: doesn't show hand
*** SUMMARY ***
Total pot $1 | Rake $0
Seat 1: Teld4PDKla7C8/Wfu2DSkg (button) (small blind) collected ($1)
Seat 2: +zI4bP23YIjMkUHqeN2xfw (big blind) folded before Flop



PokerStars Game #59941413198:  Hold'em No Limit ($0.25/$0.50) - 2009/07/01 1:34:46 ET
Table 'Wwfm5/i+g/g2Nj2gT3jnVQ' 2-max Seat #2 is the button
Seat 1: CHRLZDaaxjbo68bwQD1C/Q ($10.15 in chips)
Seat 2: PKuuhUvIr5WSkJyPJa9dFw ($20.60 in chips)
PKuuhUvIr5WSkJyPJa9dFw: posts small blind $0.25
CHRLZDaaxjbo68bwQD1C/Q: posts big blind $0.50
*** HOLE CARDS ***
PKuuhUvIr5WSkJyPJa9dFw: folds
CHRLZDaaxjbo68bwQD1C/Q collected $0.50 from pot
CHRLZDaaxjbo68bwQD1C/Q: doesn't show hand
*** SUMMARY ***
Total pot $0.50 | Rake $0
Seat 1: CHRLZDaaxjbo68bwQD1C/Q (big blind) collected ($0.50)
Seat 2: PKuuhUvIr5WSkJyPJa9dFw (button) (small blind) folded before Flop



PokerStars Game #59941413688:  Hold'em No Limit ($0.25/$0.50) - 2009/07/01 1:34:47 ET
Table 'GfL/No5u5PoEnU39lP5pQg' 6-max Seat #6 is the button
Seat 1: 1WUCqNG+p+vfWRTXNu4ljw ($50 in chips)
Seat 2: uVwggSetzp7d+eVgowO3vg ($46.50 in chips)
Seat 3: 4pp9WxhGdbVbxCc9tlu0lw ($25.30 in chips)
Seat 4: r6u7MWSXF30/khcTYkrG9Q ($31.25 in chips)
Seat 5: M1KyQQvVPVuxqTAB8sR/zQ ($64.45 in chips)
Seat 6: kxPhs4ePFqMy52CInAJ2aw ($120.95 in chips)
1WUCqNG+p+vfWRTXNu4ljw: posts small blind $0.25
uVwggSetzp7d+eVgowO3vg: posts big blind $0.50
*** HOLE CARDS ***
4pp9WxhGdbVbxCc9tlu0lw: folds
r6u7MWSXF30/khcTYkrG9Q: folds
M1KyQQvVPVuxqTAB8sR/zQ: raises $1 to $1.50
kxPhs4ePFqMy52CInAJ2aw: folds
1WUCqNG+p+vfWRTXNu4ljw: calls $1.25
uVwggSetzp7d+eVgowO3vg: folds
*** FLOP *** [Kc 5c 9s]
1WUCqNG+p+vfWRTXNu4ljw: checks
M1KyQQvVPVuxqTAB8sR/zQ: bets $2.50
1WUCqNG+p+vfWRTXNu4ljw: raises $6 to $8.50
M1KyQQvVPVuxqTAB8sR/zQ: folds
1WUCqNG+p+vfWRTXNu4ljw collected $8.10 from pot
*** SUMMARY ***
Total pot $8.50 | Rake $0.40
Board [Kc 5c 9s]
Seat 1: 1WUCqNG+p+vfWRTXNu4ljw (small blind) collected ($8.10)
Seat 2: uVwggSetzp7d+eVgowO3vg (big blind) folded before Flop
Seat 3: 4pp9WxhGdbVbxCc9tlu0lw folded before Flop (didn't bet)
Seat 4: r6u7MWSXF30/khcTYkrG9Q folded before Flop (didn't bet)
Seat 5: M1KyQQvVPVuxqTAB8sR/zQ folded on the Flop
Seat 6: kxPhs4ePFqMy52CInAJ2aw (button) folded before Flop (didn't bet)



PokerStars Game #59941414012:  Hold'em No Limit ($0.25/$0.50) - 2009/07/01 1:34:48 ET
Table 'hWT2kq66tnKEpD26cia6fQ' 2-max Seat #1 is the button
Seat 1: Ce3KNFP+ao7Da9NHb65raw ($28.70 in chips)
Seat 2: 16tvT7AYgZ2LgiGFcvFKQg ($46.05 in chips)
Ce3KNFP+ao7Da9NHb65raw: posts small blind $0.25
16tvT7AYgZ2LgiGFcvFKQg: posts big blind $0.50
*** HOLE CARDS ***
Ce3KNFP+ao7Da9NHb65raw: raises $1 to $1.50
16tvT7AYgZ2LgiGFcvFKQg: folds
16tvT7AYgZ2LgiGFcvFKQg is sitting out
Ce3KNFP+ao7Da9NHb65raw collected $1 from pot
*** SUMMARY ***
Total pot $1 | Rake $0
Seat 1: Ce3KNFP+ao7Da9NHb65raw (button) (small blind) collected ($1)
Seat 2: 16tvT7AYgZ2LgiGFcvFKQg (big blind) folded before Flop



PokerStars Game #59941416152:  Hold'em No Limit ($0.25/$0.50) - 2009/07/01 1:34:51 ET
Table '2lPOwetm4cfkZPbTmGPH/w' 2-max Seat #1 is the button
Seat 1: vUGdApqS8J/GJE2gaVWl1w ($25.60 in chips)
Seat 2: XFa6sBGjP2gxoIvxR3fZIg ($13.60 in chips)
vUGdApqS8J/GJE2gaVWl1w: posts small blind $0.25
XFa6sBGjP2gxoIvxR3fZIg: posts big blind $0.50
*** HOLE CARDS ***
vUGdApqS8J/GJE2gaVWl1w: raises $0.50 to $1
XFa6sBGjP2gxoIvxR3fZIg: raises $4 to $5
vUGdApqS8J/GJE2gaVWl1w: folds
XFa6sBGjP2gxoIvxR3fZIg collected $2 from pot
XFa6sBGjP2gxoIvxR3fZIg: doesn't show hand
*** SUMMARY ***
Total pot $2 | Rake $0
Seat 1: vUGdApqS8J/GJE2gaVWl1w (button) (small blind) folded before Flop
Seat 2: XFa6sBGjP2gxoIvxR3fZIg (big blind) collected ($2)



PokerStars Game #59941415604:  Hold'em No Limit ($0.25/$0.50) - 2009/07/01 1:34:51 ET
Table 'kgbJRsxfv64KrErDRBAkcw' 6-max Seat #1 is the button
Seat 1: VamsyhlFzXGF6/ydo0BHeA ($18.50 in chips)
Seat 2: AdS8BJMOheS01zjCDfPMFg ($62.50 in chips)
Seat 3: c4MNIaIyPMOMxrgT8FT5nA ($152.30 in chips)
Seat 4: 2igtJLmvIZ+HqX4XPgMPZA ($112.50 in chips)
Seat 5: eUBBn2R56C1IQ6Cs/vitwg ($104 in chips)
Seat 6: 1b+2BbjMN8qhR1WPqdE9VQ ($66.35 in chips)
AdS8BJMOheS01zjCDfPMFg: posts small blind $0.25
c4MNIaIyPMOMxrgT8FT5nA: posts big blind $0.50
*** HOLE CARDS ***
2igtJLmvIZ+HqX4XPgMPZA: folds
1b+2BbjMN8qhR1WPqdE9VQ said, "no no"
eUBBn2R56C1IQ6Cs/vitwg: folds
1b+2BbjMN8qhR1WPqdE9VQ: folds
VamsyhlFzXGF6/ydo0BHeA: calls $0.50
AdS8BJMOheS01zjCDfPMFg: calls $0.25
c4MNIaIyPMOMxrgT8FT5nA: checks
*** FLOP *** [8c Kd Td]
AdS8BJMOheS01zjCDfPMFg: checks
c4MNIaIyPMOMxrgT8FT5nA: bets $2.50
VamsyhlFzXGF6/ydo0BHeA: folds
AdS8BJMOheS01zjCDfPMFg: folds
c4MNIaIyPMOMxrgT8FT5nA collected $1.45 from pot
c4MNIaIyPMOMxrgT8FT5nA: doesn't show hand
*** SUMMARY ***
Total pot $1.50 | Rake $0.05
Board [8c Kd Td]
Seat 1: VamsyhlFzXGF6/ydo0BHeA (button) folded on the Flop
Seat 2: AdS8BJMOheS01zjCDfPMFg (small blind) folded on the Flop
Seat 3: c4MNIaIyPMOMxrgT8FT5nA (big blind) collected ($1.45)
Seat 4: 2igtJLmvIZ+HqX4XPgMPZA folded before Flop (didn't bet)
Seat 5: eUBBn2R56C1IQ6Cs/vitwg folded before Flop (didn't bet)
Seat 6: 1b+2BbjMN8qhR1WPqdE9VQ folded before Flop (didn't bet)



PokerStars Game #59941416112:  Hold'em No Limit ($0.25/$0.50) - 2009/07/01 1:34:51 ET
Table '+z1aekfHkpp09pc8F9aViw' 6-max Seat #6 is the button
Seat 2: 4QfsCWthT/vSLirorNXqtg ($51.50 in chips)
Seat 3: URYNc7fPA23K2UfadQbnCA ($47.75 in chips)
Seat 4: RowCSpSURHTOL/dcjg/Iug ($86.45 in chips)
Seat 5: 2igtJLmvIZ+HqX4XPgMPZA ($50.20 in chips)
Seat 6: GUnvMULl2qFOO1yenu1UBw ($52.25 in chips)
4QfsCWthT/vSLirorNXqtg: posts small blind $0.25
URYNc7fPA23K2UfadQbnCA: posts big blind $0.50
*** HOLE CARDS ***
RowCSpSURHTOL/dcjg/Iug: folds
2igtJLmvIZ+HqX4XPgMPZA: raises $1.50 to $2
GUnvMULl2qFOO1yenu1UBw: folds
4QfsCWthT/vSLirorNXqtg: folds
URYNc7fPA23K2UfadQbnCA: folds
2igtJLmvIZ+HqX4XPgMPZA collected $1.25 from pot
*** SUMMARY ***
Total pot $1.25 | Rake $0
Seat 2: 4QfsCWthT/vSLirorNXqtg (small blind) folded before Flop
Seat 3: URYNc7fPA23K2UfadQbnCA (big blind) folded before Flop
Seat 4: RowCSpSURHTOL/dcjg/Iug folded before Flop (didn't bet)
Seat 5: 2igtJLmvIZ+HqX4XPgMPZA collected ($1.25)
Seat 6: GUnvMULl2qFOO1yenu1UBw (button) folded before Flop (didn't bet)



PokerStars Game #59941416664:  Hold'em No Limit ($0.25/$0.50) - 2009/07/01 1:34:52 ET
Table 'Wwfm5/i+g/g2Nj2gT3jnVQ' 2-max Seat #1 is the button
Seat 1: CHRLZDaaxjbo68bwQD1C/Q ($10.40 in chips)
Seat 2: PKuuhUvIr5WSkJyPJa9dFw ($20.35 in chips)
CHRLZDaaxjbo68bwQD1C/Q: posts small blind $0.25
PKuuhUvIr5WSkJyPJa9dFw: posts big blind $0.50
*** HOLE CARDS ***
CHRLZDaaxjbo68bwQD1C/Q: calls $0.25
PKuuhUvIr5WSkJyPJa9dFw: checks
*** FLOP *** [7c 3d Ac]
PKuuhUvIr5WSkJyPJa9dFw: checks
CHRLZDaaxjbo68bwQD1C/Q: bets $0.50
PKuuhUvIr5WSkJyPJa9dFw: calls $0.50
*** TURN *** [7c 3d Ac] [Jh]
PKuuhUvIr5WSkJyPJa9dFw: checks
CHRLZDaaxjbo68bwQD1C/Q: bets $0.50
PKuuhUvIr5WSkJyPJa9dFw: calls $0.50
*** RIVER *** [7c 3d Ac Jh] [9h]
PKuuhUvIr5WSkJyPJa9dFw: checks
CHRLZDaaxjbo68bwQD1C/Q: bets $0.50
PKuuhUvIr5WSkJyPJa9dFw: folds
CHRLZDaaxjbo68bwQD1C/Q collected $2.90 from pot
CHRLZDaaxjbo68bwQD1C/Q: doesn't show hand
*** SUMMARY ***
Total pot $3 | Rake $0.10
Board [7c 3d Ac Jh 9h]
Seat 1: CHRLZDaaxjbo68bwQD1C/Q (button) (small blind) collected ($2.90)
Seat 2: PKuuhUvIr5WSkJyPJa9dFw (big blind) folded on the River



PokerStars Game #59941416956:  Hold'em No Limit ($0.25/$0.50) - 2009/07/01 1:34:53 ET
Table 'iq+aXfWVQRdV0u8SRTYUEg' 9-max Seat #4 is the button
Seat 1: 3yl8Q6QaLfGtyhN4/pEFgQ ($72.30 in chips)
Seat 2: J9N0lxHFd/Js2S0xZLbsIQ ($28.80 in chips)
Seat 3: Qi/PyOsKwaqtKIg0H+7ELg ($9.70 in chips)
Seat 4: vHYT5s323LpajBj+2c9zbQ ($31.35 in chips)
Seat 5: 997ViqAtWn1FPjJqcffwcA ($57.15 in chips)
Seat 7: SKnJuWHScqetA/qG5p+wCg ($30.80 in chips)
Seat 8: /DtIHuxEH+3tzKefmSV+Mw ($36.10 in chips)
Seat 9: olE1Z2rKWAV8+tGqmIBK9g ($26.20 in chips)
997ViqAtWn1FPjJqcffwcA: posts small blind $0.25
SKnJuWHScqetA/qG5p+wCg: posts big blind $0.50
*** HOLE CARDS ***
/DtIHuxEH+3tzKefmSV+Mw: raises $1 to $1.50
olE1Z2rKWAV8+tGqmIBK9g: folds
3yl8Q6QaLfGtyhN4/pEFgQ: folds
J9N0lxHFd/Js2S0xZLbsIQ: calls $1.50
Qi/PyOsKwaqtKIg0H+7ELg: folds
vHYT5s323LpajBj+2c9zbQ: folds
997ViqAtWn1FPjJqcffwcA: folds
SKnJuWHScqetA/qG5p+wCg: folds
*** FLOP *** [7s 9h 7h]
/DtIHuxEH+3tzKefmSV+Mw: bets $3
J9N0lxHFd/Js2S0xZLbsIQ: folds
/DtIHuxEH+3tzKefmSV+Mw collected $3.60 from pot
*** SUMMARY ***
Total pot $3.75 | Rake $0.15
Board [7s 9h 7h]
Seat 1: 3yl8Q6QaLfGtyhN4/pEFgQ folded before Flop (didn't bet)
Seat 2: J9N0lxHFd/Js2S0xZLbsIQ folded on the Flop
Seat 3: Qi/PyOsKwaqtKIg0H+7ELg folded before Flop (didn't bet)
Seat 4: vHYT5s323LpajBj+2c9zbQ (button) folded before Flop (didn't bet)
Seat 5: 997ViqAtWn1FPjJqcffwcA (small blind) folded before Flop
Seat 7: SKnJuWHScqetA/qG5p+wCg (big blind) folded before Flop
Seat 8: /DtIHuxEH+3tzKefmSV+Mw collected ($3.60)
Seat 9: olE1Z2rKWAV8+tGqmIBK9g folded before Flop (didn't bet)



PokerStars Game #59941417578:  Hold'em No Limit ($0.25/$0.50) - 2009/07/01 1:34:54 ET
Table '+dXkOAQyS8j9PQZusUTMpg' 2-max Seat #2 is the button
Seat 1: Teld4PDKla7C8/Wfu2DSkg ($54.60 in chips)
Seat 2: +zI4bP23YIjMkUHqeN2xfw ($20.90 in chips)
+zI4bP23YIjMkUHqeN2xfw: posts small blind $0.25
Teld4PDKla7C8/Wfu2DSkg: posts big blind $0.50
*** HOLE CARDS ***
+zI4bP23YIjMkUHqeN2xfw: calls $0.25
Teld4PDKla7C8/Wfu2DSkg: checks
*** FLOP *** [8d 9s 6s]
Teld4PDKla7C8/Wfu2DSkg: checks
+zI4bP23YIjMkUHqeN2xfw: checks
*** TURN *** [8d 9s 6s] [2s]
Teld4PDKla7C8/Wfu2DSkg: bets $1
+zI4bP23YIjMkUHqeN2xfw: calls $1
*** RIVER *** [8d 9s 6s 2s] [Ad]
Teld4PDKla7C8/Wfu2DSkg: checks
+zI4bP23YIjMkUHqeN2xfw: checks
*** SHOW DOWN ***
Teld4PDKla7C8/Wfu2DSkg: shows [5c 8h] (a pair of Eights)
+zI4bP23YIjMkUHqeN2xfw: mucks hand
Teld4PDKla7C8/Wfu2DSkg collected $2.90 from pot
*** SUMMARY ***
Total pot $3 | Rake $0.10
Board [8d 9s 6s 2s Ad]
Seat 1: Teld4PDKla7C8/Wfu2DSkg (big blind) showed [5c 8h] and won ($2.90) with a pair of Eights
Seat 2: +zI4bP23YIjMkUHqeN2xfw (button) (small blind) mucked



PokerStars Game #59941418064:  Hold'em No Limit ($0.25/$0.50) - 2009/07/01 1:34:55 ET
Table 'fx6MqwfYAj/Rt86hBz2L3Q' 9-max Seat #4 is the button
Seat 1: v/4aX0ejnaIFK4ftDk2Lyg ($50.65 in chips)
Seat 2: C3rGXblctNcWI6JYPHhaEg ($62.65 in chips)
Seat 3: iadBi5AEt7gTBXbDSSnMYQ ($39.85 in chips)
Seat 4: VhjwWfxHSx00WxzYih3KOA ($50 in chips)
Seat 6: 5k9fvXD9suIgCxU4HLQjTw ($50 in chips)
Seat 7: mSD1pginDsyHG5PDfqzphw ($10 in chips)
Seat 9: vO3QVRovWemcGMkm7ijAIA ($22.95 in chips)
e2+sK/yjnj94rXOKoxPP2A will be allowed to play after the button
5k9fvXD9suIgCxU4HLQjTw: posts small blind $0.25
mSD1pginDsyHG5PDfqzphw: posts big blind $0.50
75K2MXwN65Sjfp1yHd50Hg: sits out
*** HOLE CARDS ***
vO3QVRovWemcGMkm7ijAIA: folds
v/4aX0ejnaIFK4ftDk2Lyg: folds
C3rGXblctNcWI6JYPHhaEg: calls $0.50
iadBi5AEt7gTBXbDSSnMYQ: folds
VhjwWfxHSx00WxzYih3KOA: folds
5k9fvXD9suIgCxU4HLQjTw: folds
mSD1pginDsyHG5PDfqzphw: checks
*** FLOP *** [Kh 5d 8h]
mSD1pginDsyHG5PDfqzphw: checks
C3rGXblctNcWI6JYPHhaEg: bets $1.15
mSD1pginDsyHG5PDfqzphw: raises $1.85 to $3
C3rGXblctNcWI6JYPHhaEg: folds
mSD1pginDsyHG5PDfqzphw collected $3.40 from pot
mSD1pginDsyHG5PDfqzphw: doesn't show hand
*** SUMMARY ***
Total pot $3.55 | Rake $0.15
Board [Kh 5d 8h]
Seat 1: v/4aX0ejnaIFK4ftDk2Lyg folded before Flop (didn't bet)
Seat 2: C3rGXblctNcWI6JYPHhaEg folded on the Flop
Seat 3: iadBi5AEt7gTBXbDSSnMYQ folded before Flop (didn't bet)
Seat 4: VhjwWfxHSx00WxzYih3KOA (button) folded before Flop (didn't bet)
Seat 6: 5k9fvXD9suIgCxU4HLQjTw (small blind) folded before Flop
Seat 7: mSD1pginDsyHG5PDfqzphw (big blind) collected ($3.40)
Seat 9: vO3QVRovWemcGMkm7ijAIA folded before Flop (didn't bet)



PokerStars Game #59941419380:  Hold'em No Limit ($0.25/$0.50) - 2009/07/01 1:34:57 ET
Table 'cofQFHU7jbJoFecLVBof/w' 6-max Seat #5 is the button
Seat 1: URYNc7fPA23K2UfadQbnCA ($50 in chips)
Seat 2: f89uTQr3ieGlusj2IAYAEg ($50 in chips)
Seat 3: v4ctePcLlQw0r8E0qJtjYw ($53.70 in chips)
Seat 4: g6lz8npaeeTJmJegtPYhlQ ($15.85 in chips)
Seat 5: QvwRlrpVqerRRF8eJm6dDw ($47.65 in chips)
Seat 6: 7+uQ0OOgCTbR4ltkSwyC0g ($160.30 in chips)
7+uQ0OOgCTbR4ltkSwyC0g: posts small blind $0.25
URYNc7fPA23K2UfadQbnCA: posts big blind $0.50
*** HOLE CARDS ***
f89uTQr3ieGlusj2IAYAEg: folds
v4ctePcLlQw0r8E0qJtjYw: folds
g6lz8npaeeTJmJegtPYhlQ: calls $0.50
QvwRlrpVqerRRF8eJm6dDw: folds
7+uQ0OOgCTbR4ltkSwyC0g: calls $0.25
URYNc7fPA23K2UfadQbnCA: raises $2.50 to $3
g6lz8npaeeTJmJegtPYhlQ: folds
7+uQ0OOgCTbR4ltkSwyC0g: folds
URYNc7fPA23K2UfadQbnCA collected $1.50 from pot
*** SUMMARY ***
Total pot $1.50 | Rake $0
Seat 1: URYNc7fPA23K2UfadQbnCA (big blind) collected ($1.50)
Seat 2: f89uTQr3ieGlusj2IAYAEg folded before Flop (didn't bet)
Seat 3: v4ctePcLlQw0r8E0qJtjYw folded before Flop (didn't bet)
Seat 4: g6lz8npaeeTJmJegtPYhlQ folded before Flop
Seat 5: QvwRlrpVqerRRF8eJm6dDw (button) folded before Flop (didn't bet)
Seat 6: 7+uQ0OOgCTbR4ltkSwyC0g (small blind) folded before Flop



PokerStars Game #59941419200:  Hold'em No Limit ($0.25/$0.50) - 2009/07/01 1:34:57 ET
Table '5qf8oPyYje71HBKD0FwPgQ' 9-max Seat #9 is the button
Seat 2: M+7+BTmX5vZatHVuoRB1nA ($57.90 in chips)
Seat 3: vacmVLJJECYI6HjAynFcpg ($57.70 in chips)
Seat 4: YXCE3WOZi8g2sIf3y/plVw ($54.60 in chips)
Seat 5: uo2Sgpknd7NdeVbeSCG02A ($22.70 in chips)
Seat 6: go0Ad6tqqJ4tR9/bqVlO0g ($13.45 in chips)
Seat 7: 1q5EPoiflJRl8pqfnVLjMw ($52.75 in chips)
Seat 8: sakr/FIfFtIZwDPmAj5Pzg ($59.10 in chips)
Seat 9: jWDRpL0TJljg+mBCE9ZMqA ($7.10 in chips)
M+7+BTmX5vZatHVuoRB1nA: posts small blind $0.25
vacmVLJJECYI6HjAynFcpg: posts big blind $0.50
*** HOLE CARDS ***
YXCE3WOZi8g2sIf3y/plVw: folds
uo2Sgpknd7NdeVbeSCG02A: folds
go0Ad6tqqJ4tR9/bqVlO0g: folds
1q5EPoiflJRl8pqfnVLjMw: folds
sakr/FIfFtIZwDPmAj5Pzg: folds
jWDRpL0TJljg+mBCE9ZMqA: raises $1 to $1.50
M+7+BTmX5vZatHVuoRB1nA: folds
vacmVLJJECYI6HjAynFcpg: folds
jWDRpL0TJljg+mBCE9ZMqA collected $1.25 from pot
jWDRpL0TJljg+mBCE9ZMqA: doesn't show hand
*** SUMMARY ***
Total pot $1.25 | Rake $0
Seat 2: M+7+BTmX5vZatHVuoRB1nA (small blind) folded before Flop
Seat 3: vacmVLJJECYI6HjAynFcpg (big blind) folded before Flop
Seat 4: YXCE3WOZi8g2sIf3y/plVw folded before Flop (didn't bet)
Seat 5: uo2Sgpknd7NdeVbeSCG02A folded before Flop (didn't bet)
Seat 6: go0Ad6tqqJ4tR9/bqVlO0g folded before Flop (didn't bet)
Seat 7: 1q5EPoiflJRl8pqfnVLjMw folded before Flop (didn't bet)
Seat 8: sakr/FIfFtIZwDPmAj5Pzg folded before Flop (didn't bet)
Seat 9: jWDRpL0TJljg+mBCE9ZMqA (button) collected ($1.25)



PokerStars Game #59941419814:  Hold'em No Limit ($0.25/$0.50) - 2009/07/01 1:34:58 ET
Table 'lSisgp6H7Fg1hH5VfjEjYQ' 9-max Seat #5 is the button
Seat 1: 5k9fvXD9suIgCxU4HLQjTw ($54.05 in chips)
Seat 2: 5acK4E7fzEwnplVBZ6eNWA ($50 in chips)
Seat 3: SKnJuWHScqetA/qG5p+wCg ($30 in chips)
Seat 4: FFVKBJT0lZf+jFlgvy7ang ($40 in chips)
Seat 5: mSD1pginDsyHG5PDfqzphw ($11.50 in chips)
Seat 6: +k7T5ocke8UwavtgUHm+Cg ($74.70 in chips)
Seat 7: IDtNLR9uFCDdjNsJWMHA5Q ($21.05 in chips)
Seat 8: a4JDWmpFQkL10XfAyuF51A ($10.25 in chips)
Seat 9: YzeKFbJVLmJGTgNH3ySQlw ($7.40 in chips)
+k7T5ocke8UwavtgUHm+Cg: posts small blind $0.25
IDtNLR9uFCDdjNsJWMHA5Q: posts big blind $0.50
FFVKBJT0lZf+jFlgvy7ang: posts big blind $0.50
*** HOLE CARDS ***
a4JDWmpFQkL10XfAyuF51A: folds
YzeKFbJVLmJGTgNH3ySQlw: calls $0.50
5k9fvXD9suIgCxU4HLQjTw: folds
5acK4E7fzEwnplVBZ6eNWA: folds
SKnJuWHScqetA/qG5p+wCg: folds
FFVKBJT0lZf+jFlgvy7ang: checks
mSD1pginDsyHG5PDfqzphw: raises $1.50 to $2
+k7T5ocke8UwavtgUHm+Cg: folds
IDtNLR9uFCDdjNsJWMHA5Q: folds
YzeKFbJVLmJGTgNH3ySQlw: calls $1.50
FFVKBJT0lZf+jFlgvy7ang: folds
*** FLOP *** [3s Kc 8h]
YzeKFbJVLmJGTgNH3ySQlw: checks
mSD1pginDsyHG5PDfqzphw: bets $2.50
YzeKFbJVLmJGTgNH3ySQlw: calls $2.50
*** TURN *** [3s Kc 8h] [8d]
YzeKFbJVLmJGTgNH3ySQlw has timed out
YzeKFbJVLmJGTgNH3ySQlw: checks
mSD1pginDsyHG5PDfqzphw: bets $7 and is all-in
YzeKFbJVLmJGTgNH3ySQlw: folds
mSD1pginDsyHG5PDfqzphw collected $9.75 from pot
mSD1pginDsyHG5PDfqzphw: doesn't show hand
*** SUMMARY ***
Total pot $10.25 | Rake $0.50
Board [3s Kc 8h 8d]
Seat 1: 5k9fvXD9suIgCxU4HLQjTw folded before Flop (didn't bet)
Seat 2: 5acK4E7fzEwnplVBZ6eNWA folded before Flop (didn't bet)
Seat 3: SKnJuWHScqetA/qG5p+wCg folded before Flop (didn't bet)
Seat 4: FFVKBJT0lZf+jFlgvy7ang folded before Flop
Seat 5: mSD1pginDsyHG5PDfqzphw (button) collected ($9.75)
Seat 6: +k7T5ocke8UwavtgUHm+Cg (small blind) folded before Flop
Seat 7: IDtNLR9uFCDdjNsJWMHA5Q (big blind) folded before Flop
Seat 8: a4JDWmpFQkL10XfAyuF51A folded before Flop (didn't bet)
Seat 9: YzeKFbJVLmJGTgNH3ySQlw folded on the Turn



PokerStars Game #59941419952:  Hold'em No Limit ($0.25/$0.50) - 2009/07/01 1:34:58 ET
Table 'ErOuyGLI5PT3G5MnpHgC/g' 9-max Seat #2 is the button
Seat 1: eBrej2jnlUCs/JgxFCRn2g ($43.90 in chips)
Seat 2: pciZn00ZDk4BVBMTTMcNVQ ($19.50 in chips)
Seat 3: xZCXQSXlrZkp3pZizzVXCw ($49.50 in chips)
Seat 4: YRqrX/u38J7aLNNnBzQsjQ ($10 in chips)
Seat 5: JwvquocWfhTVApN5t47LgA ($49.55 in chips)
Seat 6: zE9cVigS2nW/Ljy4K4bUQA ($30 in chips)
Seat 7: 90Wb75h3W1BRpbqVnuk8gw ($71.45 in chips)
Seat 8: g4k0NXISyLCqaSWZDBjfEg ($50 in chips)
Seat 9: J0W5D97jl5VLky+IoPvDeA ($64.50 in chips)
xZCXQSXlrZkp3pZizzVXCw: posts small blind $0.25
YRqrX/u38J7aLNNnBzQsjQ: posts big blind $0.50
*** HOLE CARDS ***
JwvquocWfhTVApN5t47LgA: folds
zE9cVigS2nW/Ljy4K4bUQA: folds
90Wb75h3W1BRpbqVnuk8gw: folds
g4k0NXISyLCqaSWZDBjfEg: folds
J0W5D97jl5VLky+IoPvDeA: folds
eBrej2jnlUCs/JgxFCRn2g: folds
pciZn00ZDk4BVBMTTMcNVQ: raises $0.50 to $1
xZCXQSXlrZkp3pZizzVXCw: folds
YRqrX/u38J7aLNNnBzQsjQ: folds
pciZn00ZDk4BVBMTTMcNVQ collected $1.25 from pot
*** SUMMARY ***
Total pot $1.25 | Rake $0
Seat 1: eBrej2jnlUCs/JgxFCRn2g folded before Flop (didn't bet)
Seat 2: pciZn00ZDk4BVBMTTMcNVQ (button) collected ($1.25)
Seat 3: xZCXQSXlrZkp3pZizzVXCw (small blind) folded before Flop
Seat 4: YRqrX/u38J7aLNNnBzQsjQ (big blind) folded before Flop
Seat 5: JwvquocWfhTVApN5t47LgA folded before Flop (didn't bet)
Seat 6: zE9cVigS2nW/Ljy4K4bUQA folded before Flop (didn't bet)
Seat 7: 90Wb75h3W1BRpbqVnuk8gw folded before Flop (didn't bet)
Seat 8: g4k0NXISyLCqaSWZDBjfEg folded before Flop (didn't bet)
Seat 9: J0W5D97jl5VLky+IoPvDeA folded before Flop (didn't bet)



PokerStars Game #59941422156:  Hold'em No Limit ($0.25/$0.50) - 2009/07/01 1:35:02 ET
Table 'B+sqsfj6d6zXicNfaseTaw' 2-max Seat #2 is the button
Seat 1: +4GNcSsecmapVGSdV0mUPA ($159.15 in chips)
Seat 2: Lv5RmpRe6LtPkBzM9Gpo5A ($63.40 in chips)
Lv5RmpRe6LtPkBzM9Gpo5A: posts small blind $0.25
+4GNcSsecmapVGSdV0mUPA: posts big blind $0.50
*** HOLE CARDS ***
Lv5RmpRe6LtPkBzM9Gpo5A: folds
+4GNcSsecmapVGSdV0mUPA collected $0.50 from pot
+4GNcSsecmapVGSdV0mUPA: doesn't show hand
*** SUMMARY ***
Total pot $0.50 | Rake $0
Seat 1: +4GNcSsecmapVGSdV0mUPA (big blind) collected ($0.50)
Seat 2: Lv5RmpRe6LtPkBzM9Gpo5A (button) (small blind) folded before Flop



PokerStars Game #59941423164:  Hold'em No Limit ($0.25/$0.50) - 2009/07/01 1:35:03 ET
Table '2lPOwetm4cfkZPbTmGPH/w' 2-max Seat #2 is the button
Seat 1: vUGdApqS8J/GJE2gaVWl1w ($24.60 in chips)
Seat 2: XFa6sBGjP2gxoIvxR3fZIg ($14.60 in chips)
XFa6sBGjP2gxoIvxR3fZIg: posts small blind $0.25
vUGdApqS8J/GJE2gaVWl1w: posts big blind $0.50
*** HOLE CARDS ***
XFa6sBGjP2gxoIvxR3fZIg: raises $1 to $1.50
vUGdApqS8J/GJE2gaVWl1w: calls $1
*** FLOP *** [8h 7c 8s]
vUGdApqS8J/GJE2gaVWl1w: checks
XFa6sBGjP2gxoIvxR3fZIg: bets $2
vUGdApqS8J/GJE2gaVWl1w: folds
XFa6sBGjP2gxoIvxR3fZIg collected $2.85 from pot
XFa6sBGjP2gxoIvxR3fZIg: doesn't show hand
*** SUMMARY ***
Total pot $3 | Rake $0.15
Board [8h 7c 8s]
Seat 1: vUGdApqS8J/GJE2gaVWl1w (big blind) folded on the Flop
Seat 2: XFa6sBGjP2gxoIvxR3fZIg (button) (small blind) collected ($2.85)



PokerStars Game #59941423300:  Hold'em No Limit ($0.25/$0.50) - 2009/07/01 1:35:03 ET
Table '9ojijpRcYQSQTh6xI+haUA' 2-max Seat #2 is the button
Seat 1: FqpibuVWLNsAN/Z7ROZLnA ($50 in chips)
Seat 2: TitTV+fFCcBZWOERdytydA ($76.20 in chips)
TitTV+fFCcBZWOERdytydA: posts small blind $0.25
FqpibuVWLNsAN/Z7ROZLnA: posts big blind $0.50
*** HOLE CARDS ***
TitTV+fFCcBZWOERdytydA: folds
FqpibuVWLNsAN/Z7ROZLnA collected $0.50 from pot
*** SUMMARY ***
Total pot $0.50 | Rake $0
Seat 1: FqpibuVWLNsAN/Z7ROZLnA (big blind) collected ($0.50)
Seat 2: TitTV+fFCcBZWOERdytydA (button) (small blind) folded before Flop



PokerStars Game #59941424642:  Hold'em No Limit ($0.25/$0.50) - 2009/07/01 1:35:06 ET
Table '8BQGgNetI1NOvWeu3gtMNw' 2-max Seat #2 is the button
Seat 1: bypIyrYcAAifLfhZpGlKLA ($83.15 in chips)
Seat 2: Z4HwehErEwzsv/noQlfUlg ($132.10 in chips)
Z4HwehErEwzsv/noQlfUlg: posts small blind $0.25
bypIyrYcAAifLfhZpGlKLA: posts big blind $0.50
*** HOLE CARDS ***
Z4HwehErEwzsv/noQlfUlg: raises $1 to $1.50
bypIyrYcAAifLfhZpGlKLA: folds
Z4HwehErEwzsv/noQlfUlg collected $1 from pot
Z4HwehErEwzsv/noQlfUlg: doesn't show hand
*** SUMMARY ***
Total pot $1 | Rake $0
Seat 1: bypIyrYcAAifLfhZpGlKLA (big blind) folded before Flop
Seat 2: Z4HwehErEwzsv/noQlfUlg (button) (small blind) collected ($1)



PokerStars Game #59941425834:  Hold'em No Limit ($0.25/$0.50) - 2009/07/01 1:35:08 ET
Table 'B+sqsfj6d6zXicNfaseTaw' 2-max Seat #1 is the button
Seat 1: +4GNcSsecmapVGSdV0mUPA ($159.40 in chips)
Seat 2: Lv5RmpRe6LtPkBzM9Gpo5A ($63.15 in chips)
+4GNcSsecmapVGSdV0mUPA: posts small blind $0.25
Lv5RmpRe6LtPkBzM9Gpo5A: posts big blind $0.50
*** HOLE CARDS ***
+4GNcSsecmapVGSdV0mUPA: raises $1 to $1.50
Lv5RmpRe6LtPkBzM9Gpo5A: folds
+4GNcSsecmapVGSdV0mUPA collected $1 from pot
+4GNcSsecmapVGSdV0mUPA: doesn't show hand
*** SUMMARY ***
Total pot $1 | Rake $0
Seat 1: +4GNcSsecmapVGSdV0mUPA (button) (small blind) collected ($1)
Seat 2: Lv5RmpRe6LtPkBzM9Gpo5A (big blind) folded before Flop



PokerStars Game #59941426632:  Hold'em No Limit ($0.25/$0.50) - 2009/07/01 1:35:09 ET
Table 'hSTs/dUsYLgJQuF2Onp0MQ' 6-max Seat #6 is the button
Seat 1: 1WUCqNG+p+vfWRTXNu4ljw ($51 in chips)
Seat 2: Hdd4js36ITbTJ/QuVYwTlA ($113 in chips)
Seat 3: lxIzoHy0RnkfFSODHC2liw ($50 in chips)
Seat 4: 2igtJLmvIZ+HqX4XPgMPZA ($50 in chips)
Seat 5: FsRQ5ECdlLkLYI5le8+PDQ ($49.25 in chips)
Seat 6: M1KyQQvVPVuxqTAB8sR/zQ ($91.55 in chips)
1WUCqNG+p+vfWRTXNu4ljw: posts small blind $0.25
Hdd4js36ITbTJ/QuVYwTlA: posts big blind $0.50
*** HOLE CARDS ***
lxIzoHy0RnkfFSODHC2liw: folds
2igtJLmvIZ+HqX4XPgMPZA: folds
FsRQ5ECdlLkLYI5le8+PDQ: folds
M1KyQQvVPVuxqTAB8sR/zQ: folds
1WUCqNG+p+vfWRTXNu4ljw: folds
Hdd4js36ITbTJ/QuVYwTlA collected $0.50 from pot
*** SUMMARY ***
Total pot $0.50 | Rake $0
Seat 1: 1WUCqNG+p+vfWRTXNu4ljw (small blind) folded before Flop
Seat 2: Hdd4js36ITbTJ/QuVYwTlA (big blind) collected ($0.50)
Seat 3: lxIzoHy0RnkfFSODHC2liw folded before Flop (didn't bet)
Seat 4: 2igtJLmvIZ+HqX4XPgMPZA folded before Flop (didn't bet)
Seat 5: FsRQ5ECdlLkLYI5le8+PDQ folded before Flop (didn't bet)
Seat 6: M1KyQQvVPVuxqTAB8sR/zQ (button) folded before Flop (didn't bet)



PokerStars Game #59941426578:  Hold'em No Limit ($0.25/$0.50) - 2009/07/01 1:35:09 ET
Table '3FhG0gl3kMX3wBEEqj+wnQ' 9-max Seat #1 is the button
Seat 1: bxLSulbgr8LmKNjOzw8URg ($49.75 in chips)
Seat 3: YXCE3WOZi8g2sIf3y/plVw ($61.80 in chips)
Seat 4: e2+sK/yjnj94rXOKoxPP2A ($69.50 in chips)
Seat 5: XcLXSUMHSpshK/7Lh0M4Vg ($11.05 in chips)
Seat 6: 997ViqAtWn1FPjJqcffwcA ($109.80 in chips)
Seat 7: mSD1pginDsyHG5PDfqzphw ($10 in chips)
Seat 8: j3K/Jujr7PY4ZM2RZvlH6A ($58.35 in chips)
HZkVla4kK2SI42CVrPZ/ig will be allowed to play after the button
YXCE3WOZi8g2sIf3y/plVw: posts small blind $0.25
e2+sK/yjnj94rXOKoxPP2A: posts big blind $0.50
KA0tkubTlbhmo4ju+qgXPg is disconnected
KA0tkubTlbhmo4ju+qgXPg has timed out while disconnected
KA0tkubTlbhmo4ju+qgXPg: is sitting out
*** HOLE CARDS ***
KA0tkubTlbhmo4ju+qgXPg is connected
XcLXSUMHSpshK/7Lh0M4Vg: folds
997ViqAtWn1FPjJqcffwcA: folds
KA0tkubTlbhmo4ju+qgXPg has returned
mSD1pginDsyHG5PDfqzphw: folds
j3K/Jujr7PY4ZM2RZvlH6A: folds
bxLSulbgr8LmKNjOzw8URg: raises $0.50 to $1
YXCE3WOZi8g2sIf3y/plVw: folds
e2+sK/yjnj94rXOKoxPP2A: folds
bxLSulbgr8LmKNjOzw8URg collected $1.25 from pot
bxLSulbgr8LmKNjOzw8URg: doesn't show hand
*** SUMMARY ***
Total pot $1.25 | Rake $0
Seat 1: bxLSulbgr8LmKNjOzw8URg (button) collected ($1.25)
Seat 3: YXCE3WOZi8g2sIf3y/plVw (small blind) folded before Flop
Seat 4: e2+sK/yjnj94rXOKoxPP2A (big blind) folded before Flop
Seat 5: XcLXSUMHSpshK/7Lh0M4Vg folded before Flop (didn't bet)
Seat 6: 997ViqAtWn1FPjJqcffwcA folded before Flop (didn't bet)
Seat 7: mSD1pginDsyHG5PDfqzphw folded before Flop (didn't bet)
Seat 8: j3K/Jujr7PY4ZM2RZvlH6A folded before Flop (didn't bet)



PokerStars Game #59941427004:  Hold'em No Limit ($0.25/$0.50) - 2009/07/01 1:35:10 ET
Table 'Wwfm5/i+g/g2Nj2gT3jnVQ' 2-max Seat #2 is the button
Seat 1: CHRLZDaaxjbo68bwQD1C/Q ($11.80 in chips)
Seat 2: PKuuhUvIr5WSkJyPJa9dFw ($18.85 in chips)
PKuuhUvIr5WSkJyPJa9dFw: posts small blind $0.25
CHRLZDaaxjbo68bwQD1C/Q: posts big blind $0.50
*** HOLE CARDS ***
PKuuhUvIr5WSkJyPJa9dFw: raises $1.50 to $2
CHRLZDaaxjbo68bwQD1C/Q: folds
PKuuhUvIr5WSkJyPJa9dFw collected $1 from pot
PKuuhUvIr5WSkJyPJa9dFw: doesn't show hand
*** SUMMARY ***
Total pot $1 | Rake $0
Seat 1: CHRLZDaaxjbo68bwQD1C/Q (big blind) folded before Flop
Seat 2: PKuuhUvIr5WSkJyPJa9dFw (button) (small blind) collected ($1)



PokerStars Game #59941427232:  Hold'em No Limit ($0.25/$0.50) - 2009/07/01 1:35:10 ET
Table 'BCN5su+SsXiy1zRMJi0SJw' 6-max Seat #4 is the button
Seat 2: ehFNAevCQri3trWxV6FJdA ($100.65 in chips)
Seat 3: kwgv5lNhiFrfONXCshzxlA ($72.10 in chips)
Seat 4: bbsK8j+tpuVRhBqDzHxf7w ($49.85 in chips)
Seat 5: kxPhs4ePFqMy52CInAJ2aw ($49.50 in chips)
Seat 6: b2symlOdL7+0c9Pj4N/KlA ($68.45 in chips)
kxPhs4ePFqMy52CInAJ2aw: posts small blind $0.25
b2symlOdL7+0c9Pj4N/KlA: posts big blind $0.50
*** HOLE CARDS ***
ehFNAevCQri3trWxV6FJdA: calls $0.50
kwgv5lNhiFrfONXCshzxlA: folds
bbsK8j+tpuVRhBqDzHxf7w: folds
kxPhs4ePFqMy52CInAJ2aw: raises $2.50 to $3
b2symlOdL7+0c9Pj4N/KlA: folds
GxXV09ciXaOxyY2H5aMIIw has returned
ehFNAevCQri3trWxV6FJdA: folds
kxPhs4ePFqMy52CInAJ2aw collected $1.50 from pot
kxPhs4ePFqMy52CInAJ2aw: doesn't show hand
*** SUMMARY ***
Total pot $1.50 | Rake $0
Seat 2: ehFNAevCQri3trWxV6FJdA folded before Flop
Seat 3: kwgv5lNhiFrfONXCshzxlA folded before Flop (didn't bet)
Seat 4: bbsK8j+tpuVRhBqDzHxf7w (button) folded before Flop (didn't bet)
Seat 5: kxPhs4ePFqMy52CInAJ2aw (small blind) collected ($1.50)
Seat 6: b2symlOdL7+0c9Pj4N/KlA (big blind) folded before Flop



PokerStars Game #59941427538:  Hold'em No Limit ($0.25/$0.50) - 2009/07/01 1:35:11 ET
Table '+z1aekfHkpp09pc8F9aViw' 6-max Seat #2 is the button
Seat 2: 4QfsCWthT/vSLirorNXqtg ($51.25 in chips)
Seat 3: URYNc7fPA23K2UfadQbnCA ($47.25 in chips)
Seat 4: RowCSpSURHTOL/dcjg/Iug ($86.45 in chips)
Seat 5: 2igtJLmvIZ+HqX4XPgMPZA ($50.95 in chips)
Seat 6: GUnvMULl2qFOO1yenu1UBw ($52.25 in chips)
URYNc7fPA23K2UfadQbnCA: posts small blind $0.25
RowCSpSURHTOL/dcjg/Iug: posts big blind $0.50
L0aIPg7qefDQjdJo3HCVEA: sits out
*** HOLE CARDS ***
2igtJLmvIZ+HqX4XPgMPZA: folds
GUnvMULl2qFOO1yenu1UBw: folds
4QfsCWthT/vSLirorNXqtg: raises $1 to $1.50
URYNc7fPA23K2UfadQbnCA: folds
RowCSpSURHTOL/dcjg/Iug: folds
4QfsCWthT/vSLirorNXqtg collected $1.25 from pot
*** SUMMARY ***
Total pot $1.25 | Rake $0
Seat 2: 4QfsCWthT/vSLirorNXqtg (button) collected ($1.25)
Seat 3: URYNc7fPA23K2UfadQbnCA (small blind) folded before Flop
Seat 4: RowCSpSURHTOL/dcjg/Iug (big blind) folded before Flop
Seat 5: 2igtJLmvIZ+HqX4XPgMPZA folded before Flop (didn't bet)
Seat 6: GUnvMULl2qFOO1yenu1UBw folded before Flop (didn't bet)



PokerStars Game #59941427930:  Hold'em No Limit ($0.25/$0.50) - 2009/07/01 1:35:12 ET
Table '9ojijpRcYQSQTh6xI+haUA' 2-max Seat #1 is the button
Seat 1: FqpibuVWLNsAN/Z7ROZLnA ($50.25 in chips)
Seat 2: TitTV+fFCcBZWOERdytydA ($75.95 in chips)
FqpibuVWLNsAN/Z7ROZLnA: posts small blind $0.25
TitTV+fFCcBZWOERdytydA: posts big blind $0.50
*** HOLE CARDS ***
FqpibuVWLNsAN/Z7ROZLnA: folds
TitTV+fFCcBZWOERdytydA collected $0.50 from pot
TitTV+fFCcBZWOERdytydA: doesn't show hand
*** SUMMARY ***
Total pot $0.50 | Rake $0
Seat 1: FqpibuVWLNsAN/Z7ROZLnA (button) (small blind) folded before Flop
Seat 2: TitTV+fFCcBZWOERdytydA (big blind) collected ($0.50)



PokerStars Game #59941428950:  Hold'em No Limit ($0.25/$0.50) - 2009/07/01 1:35:13 ET
Table '+dXkOAQyS8j9PQZusUTMpg' 2-max Seat #1 is the button
Seat 1: Teld4PDKla7C8/Wfu2DSkg ($56 in chips)
Seat 2: +zI4bP23YIjMkUHqeN2xfw ($19.40 in chips)
Teld4PDKla7C8/Wfu2DSkg: posts small blind $0.25
+zI4bP23YIjMkUHqeN2xfw: posts big blind $0.50
*** HOLE CARDS ***
Teld4PDKla7C8/Wfu2DSkg: calls $0.25
+zI4bP23YIjMkUHqeN2xfw: checks
*** FLOP *** [9s 7c Td]
+zI4bP23YIjMkUHqeN2xfw: checks
Teld4PDKla7C8/Wfu2DSkg: checks
*** TURN *** [9s 7c Td] [Kc]
+zI4bP23YIjMkUHqeN2xfw: checks
Teld4PDKla7C8/Wfu2DSkg: bets $1
+zI4bP23YIjMkUHqeN2xfw: raises $1 to $2
Teld4PDKla7C8/Wfu2DSkg: folds
+zI4bP23YIjMkUHqeN2xfw collected $2.90 from pot
*** SUMMARY ***
Total pot $3 | Rake $0.10
Board [9s 7c Td Kc]
Seat 1: Teld4PDKla7C8/Wfu2DSkg (button) (small blind) folded on the Turn
Seat 2: +zI4bP23YIjMkUHqeN2xfw (big blind) collected ($2.90)



PokerStars Game #59941429906:  Hold'em No Limit ($0.25/$0.50) - 2009/07/01 1:35:15 ET
Table '8BQGgNetI1NOvWeu3gtMNw' 2-max Seat #1 is the button
Seat 1: bypIyrYcAAifLfhZpGlKLA ($82.65 in chips)
Seat 2: Z4HwehErEwzsv/noQlfUlg ($132.60 in chips)
bypIyrYcAAifLfhZpGlKLA: posts small blind $0.25
Z4HwehErEwzsv/noQlfUlg: posts big blind $0.50
*** HOLE CARDS ***
bypIyrYcAAifLfhZpGlKLA: folds
Z4HwehErEwzsv/noQlfUlg collected $0.50 from pot
Z4HwehErEwzsv/noQlfUlg: doesn't show hand
*** SUMMARY ***
Total pot $0.50 | Rake $0
Seat 1: bypIyrYcAAifLfhZpGlKLA (button) (small blind) folded before Flop
Seat 2: Z4HwehErEwzsv/noQlfUlg (big blind) collected ($0.50)



PokerStars Game #59941430314:  Hold'em No Limit ($0.25/$0.50) - 2009/07/01 1:35:16 ET
Table 'B+sqsfj6d6zXicNfaseTaw' 2-max Seat #2 is the button
Seat 1: +4GNcSsecmapVGSdV0mUPA ($159.90 in chips)
Seat 2: Lv5RmpRe6LtPkBzM9Gpo5A ($62.65 in chips)
Lv5RmpRe6LtPkBzM9Gpo5A: posts small blind $0.25
+4GNcSsecmapVGSdV0mUPA: posts big blind $0.50
*** HOLE CARDS ***
Lv5RmpRe6LtPkBzM9Gpo5A: folds
+4GNcSsecmapVGSdV0mUPA collected $0.50 from pot
*** SUMMARY ***
Total pot $0.50 | Rake $0
Seat 1: +4GNcSsecmapVGSdV0mUPA (big blind) collected ($0.50)
Seat 2: Lv5RmpRe6LtPkBzM9Gpo5A (button) (small blind) folded before Flop



PokerStars Game #59941431138:  Hold'em No Limit ($0.25/$0.50) - 2009/07/01 1:35:17 ET
Table '2lPOwetm4cfkZPbTmGPH/w' 2-max Seat #1 is the button
Seat 1: vUGdApqS8J/GJE2gaVWl1w ($23.10 in chips)
Seat 2: XFa6sBGjP2gxoIvxR3fZIg ($15.95 in chips)
vUGdApqS8J/GJE2gaVWl1w: posts small blind $0.25
XFa6sBGjP2gxoIvxR3fZIg: posts big blind $0.50
*** HOLE CARDS ***
vUGdApqS8J/GJE2gaVWl1w: folds
XFa6sBGjP2gxoIvxR3fZIg collected $0.50 from pot
XFa6sBGjP2gxoIvxR3fZIg: doesn't show hand
*** SUMMARY ***
Total pot $0.50 | Rake $0
Seat 1: vUGdApqS8J/GJE2gaVWl1w (button) (small blind) folded before Flop
Seat 2: XFa6sBGjP2gxoIvxR3fZIg (big blind) collected ($0.50)



PokerStars Game #59941430924:  Hold'em No Limit ($0.25/$0.50) - 2009/07/01 1:35:17 ET
Table 'Wwfm5/i+g/g2Nj2gT3jnVQ' 2-max Seat #1 is the button
Seat 1: CHRLZDaaxjbo68bwQD1C/Q ($11.30 in chips)
Seat 2: PKuuhUvIr5WSkJyPJa9dFw ($19.35 in chips)
CHRLZDaaxjbo68bwQD1C/Q: posts small blind $0.25
PKuuhUvIr5WSkJyPJa9dFw: posts big blind $0.50
*** HOLE CARDS ***
CHRLZDaaxjbo68bwQD1C/Q: raises $1 to $1.50
PKuuhUvIr5WSkJyPJa9dFw: calls $1
*** FLOP *** [Kd 5h Kc]
PKuuhUvIr5WSkJyPJa9dFw: checks
CHRLZDaaxjbo68bwQD1C/Q: bets $1.50
PKuuhUvIr5WSkJyPJa9dFw: folds
CHRLZDaaxjbo68bwQD1C/Q collected $2.85 from pot
CHRLZDaaxjbo68bwQD1C/Q: doesn't show hand
*** SUMMARY ***
Total pot $3 | Rake $0.15
Board [Kd 5h Kc]
Seat 1: CHRLZDaaxjbo68bwQD1C/Q (button) (small blind) collected ($2.85)
Seat 2: PKuuhUvIr5WSkJyPJa9dFw (big blind) folded on the Flop



PokerStars Game #59941430876:  Hold'em No Limit ($0.25/$0.50) - 2009/07/01 1:35:17 ET
Table 'EiNh8p/wGJ1FP575iMFnqg' 9-max Seat #1 is the button
Seat 1: YFFlOZgyy1Mh4iBmuNRbmQ ($17.95 in chips)
Seat 3: ymLPoEIl7UL3TvZYmnadxQ ($45.50 in chips)
Seat 4: cMzaiXAM/ZAdNaEUu+LqhA ($58.45 in chips)
Seat 5: M+7+BTmX5vZatHVuoRB1nA ($73.20 in chips)
Seat 6: viwBDtJsY6JfsFOdBAyJIQ ($12.55 in chips)
Seat 7: 997ViqAtWn1FPjJqcffwcA ($50 in chips)
Seat 8: mSD1pginDsyHG5PDfqzphw ($10 in chips)
Seat 9: GuPkZObrz5Zkkn8FsEdF9w ($34.60 in chips)
GRV8J6o4lVSBDEyjt6BwMg will be allowed to play after the button
ymLPoEIl7UL3TvZYmnadxQ: posts small blind $0.25
cMzaiXAM/ZAdNaEUu+LqhA: posts big blind $0.50
*** HOLE CARDS ***
M+7+BTmX5vZatHVuoRB1nA: folds
viwBDtJsY6JfsFOdBAyJIQ: folds
997ViqAtWn1FPjJqcffwcA: folds
viwBDtJsY6JfsFOdBAyJIQ leaves the table
mSD1pginDsyHG5PDfqzphw: raises $1 to $1.50
GuPkZObrz5Zkkn8FsEdF9w: folds
YFFlOZgyy1Mh4iBmuNRbmQ: calls $1.50
ymLPoEIl7UL3TvZYmnadxQ: folds
cMzaiXAM/ZAdNaEUu+LqhA: folds
*** FLOP *** [Ah Ts Jd]
mSD1pginDsyHG5PDfqzphw: bets $2
YFFlOZgyy1Mh4iBmuNRbmQ: raises $2 to $4
mSD1pginDsyHG5PDfqzphw: raises $4.50 to $8.50 and is all-in
YFFlOZgyy1Mh4iBmuNRbmQ: calls $4.50
*** TURN *** [Ah Ts Jd] [8c]
*** RIVER *** [Ah Ts Jd 8c] [9c]
*** SHOW DOWN ***
mSD1pginDsyHG5PDfqzphw: shows [Ad Qh] (a straight, Eight to Queen)
YFFlOZgyy1Mh4iBmuNRbmQ: shows [Qs As] (a straight, Eight to Queen)
mSD1pginDsyHG5PDfqzphw collected $9.90 from pot
YFFlOZgyy1Mh4iBmuNRbmQ collected $9.85 from pot
*** SUMMARY ***
Total pot $20.75 | Rake $1
Board [Ah Ts Jd 8c 9c]
Seat 1: YFFlOZgyy1Mh4iBmuNRbmQ (button) showed [Qs As] and won ($9.85) with a straight, Eight to Queen
Seat 3: ymLPoEIl7UL3TvZYmnadxQ (small blind) folded before Flop
Seat 4: cMzaiXAM/ZAdNaEUu+LqhA (big blind) folded before Flop
Seat 5: M+7+BTmX5vZatHVuoRB1nA folded before Flop (didn't bet)
Seat 6: viwBDtJsY6JfsFOdBAyJIQ folded before Flop (didn't bet)
Seat 7: 997ViqAtWn1FPjJqcffwcA folded before Flop (didn't bet)
Seat 8: mSD1pginDsyHG5PDfqzphw showed [Ad Qh] and won ($9.90) with a straight, Eight to Queen
Seat 9: GuPkZObrz5Zkkn8FsEdF9w folded before Flop (didn't bet)



PokerStars Game #59941431334:  Hold'em No Limit ($0.25/$0.50) - 2009/07/01 1:35:18 ET
Table '5qf8oPyYje71HBKD0FwPgQ' 9-max Seat #2 is the button
Seat 2: M+7+BTmX5vZatHVuoRB1nA ($57.65 in chips)
Seat 3: vacmVLJJECYI6HjAynFcpg ($57.20 in chips)
Seat 4: YXCE3WOZi8g2sIf3y/plVw ($54.60 in chips)
Seat 5: uo2Sgpknd7NdeVbeSCG02A ($22.70 in chips)
Seat 6: go0Ad6tqqJ4tR9/bqVlO0g ($13.45 in chips)
Seat 7: 1q5EPoiflJRl8pqfnVLjMw ($52.75 in chips)
Seat 8: sakr/FIfFtIZwDPmAj5Pzg ($59.10 in chips)
Seat 9: jWDRpL0TJljg+mBCE9ZMqA ($7.85 in chips)
vacmVLJJECYI6HjAynFcpg: posts small blind $0.25
YXCE3WOZi8g2sIf3y/plVw: posts big blind $0.50
*** HOLE CARDS ***
uo2Sgpknd7NdeVbeSCG02A: raises $1.50 to $2
go0Ad6tqqJ4tR9/bqVlO0g: calls $2
1q5EPoiflJRl8pqfnVLjMw: folds
sakr/FIfFtIZwDPmAj5Pzg: folds
jWDRpL0TJljg+mBCE9ZMqA: folds
M+7+BTmX5vZatHVuoRB1nA: folds
vacmVLJJECYI6HjAynFcpg: folds
YXCE3WOZi8g2sIf3y/plVw: folds
*** FLOP *** [9c Ad 6c]
uo2Sgpknd7NdeVbeSCG02A: bets $2
go0Ad6tqqJ4tR9/bqVlO0g: raises $2 to $4
uo2Sgpknd7NdeVbeSCG02A: calls $2
*** TURN *** [9c Ad 6c] [Jh]
uo2Sgpknd7NdeVbeSCG02A: checks
go0Ad6tqqJ4tR9/bqVlO0g: bets $7.45 and is all-in
uo2Sgpknd7NdeVbeSCG02A: folds
go0Ad6tqqJ4tR9/bqVlO0g collected $12.15 from pot
*** SUMMARY ***
Total pot $12.75 | Rake $0.60
Board [9c Ad 6c Jh]
Seat 2: M+7+BTmX5vZatHVuoRB1nA (button) folded before Flop (didn't bet)
Seat 3: vacmVLJJECYI6HjAynFcpg (small blind) folded before Flop
Seat 4: YXCE3WOZi8g2sIf3y/plVw (big blind) folded before Flop
Seat 5: uo2Sgpknd7NdeVbeSCG02A folded on the Turn
Seat 6: go0Ad6tqqJ4tR9/bqVlO0g collected ($12.15)
Seat 7: 1q5EPoiflJRl8pqfnVLjMw folded before Flop (didn't bet)
Seat 8: sakr/FIfFtIZwDPmAj5Pzg folded before Flop (didn't bet)
Seat 9: jWDRpL0TJljg+mBCE9ZMqA folded before Flop (didn't bet)



PokerStars Game #59941431622:  Hold'em No Limit ($0.25/$0.50) - 2009/07/01 1:35:18 ET
Table '9ojijpRcYQSQTh6xI+haUA' 2-max Seat #2 is the button
Seat 1: FqpibuVWLNsAN/Z7ROZLnA ($50 in chips)
Seat 2: TitTV+fFCcBZWOERdytydA ($76.20 in chips)
TitTV+fFCcBZWOERdytydA: posts small blind $0.25
FqpibuVWLNsAN/Z7ROZLnA: posts big blind $0.50
*** HOLE CARDS ***
TitTV+fFCcBZWOERdytydA: raises $1 to $1.50
FqpibuVWLNsAN/Z7ROZLnA: calls $1
*** FLOP *** [9h 2s Ac]
FqpibuVWLNsAN/Z7ROZLnA: checks
TitTV+fFCcBZWOERdytydA: checks
*** TURN *** [9h 2s Ac] [Ah]
FqpibuVWLNsAN/Z7ROZLnA: bets $1
TitTV+fFCcBZWOERdytydA: raises $3.50 to $4.50
FqpibuVWLNsAN/Z7ROZLnA: calls $3.50
*** RIVER *** [9h 2s Ac Ah] [2h]
FqpibuVWLNsAN/Z7ROZLnA: checks
TitTV+fFCcBZWOERdytydA: bets $6
FqpibuVWLNsAN/Z7ROZLnA: calls $6
*** SHOW DOWN ***
TitTV+fFCcBZWOERdytydA: shows [6s 8h] (two pair, Aces and Deuces)
FqpibuVWLNsAN/Z7ROZLnA: shows [Js Kc] (two pair, Aces and Deuces - King kicker)
FqpibuVWLNsAN/Z7ROZLnA collected $23.50 from pot
*** SUMMARY ***
Total pot $24 | Rake $0.50
Board [9h 2s Ac Ah 2h]
Seat 1: FqpibuVWLNsAN/Z7ROZLnA (big blind) showed [Js Kc] and won ($23.50) with two pair, Aces and Deuces
Seat 2: TitTV+fFCcBZWOERdytydA (button) (small blind) showed [6s 8h] and lost with two pair, Aces and Deuces



PokerStars Game #59941431440:  Hold'em No Limit ($0.25/$0.50) - 2009/07/01 1:35:18 ET
Table 'tyR5AZNKV8Aadbrnrnlg7g' 6-max Seat #1 is the button
Seat 1: BgOXYI0yYSN1ULC4FqsNkg ($72.95 in chips)
Seat 2: BAjwVL+zKKd0s0fAWstzQQ ($15.30 in chips)
Seat 3: JFLrYNyQmwPhRQAtoSAuyA ($57 in chips)
Seat 4: 4QfsCWthT/vSLirorNXqtg ($85.70 in chips)
Seat 5: GUnvMULl2qFOO1yenu1UBw ($87.60 in chips)
Seat 6: 498aWaGsW4uGfuWl+2FCGw ($64.65 in chips)
BAjwVL+zKKd0s0fAWstzQQ: posts small blind $0.25
JFLrYNyQmwPhRQAtoSAuyA: posts big blind $0.50
*** HOLE CARDS ***
4QfsCWthT/vSLirorNXqtg: folds
GUnvMULl2qFOO1yenu1UBw: folds
498aWaGsW4uGfuWl+2FCGw: folds
BgOXYI0yYSN1ULC4FqsNkg: calls $0.50
BAjwVL+zKKd0s0fAWstzQQ: calls $0.25
JFLrYNyQmwPhRQAtoSAuyA: checks
*** FLOP *** [5h Jd Th]
BAjwVL+zKKd0s0fAWstzQQ: checks
JFLrYNyQmwPhRQAtoSAuyA: checks
BgOXYI0yYSN1ULC4FqsNkg: bets $3.50
BAjwVL+zKKd0s0fAWstzQQ: folds
JFLrYNyQmwPhRQAtoSAuyA: calls $3.50
*** TURN *** [5h Jd Th] [Kd]
JFLrYNyQmwPhRQAtoSAuyA: checks
BgOXYI0yYSN1ULC4FqsNkg: checks
*** RIVER *** [5h Jd Th Kd] [Ks]
JFLrYNyQmwPhRQAtoSAuyA: bets $5.50
BgOXYI0yYSN1ULC4FqsNkg: folds
JFLrYNyQmwPhRQAtoSAuyA collected $8.10 from pot
JFLrYNyQmwPhRQAtoSAuyA: doesn't show hand
*** SUMMARY ***
Total pot $8.50 | Rake $0.40
Board [5h Jd Th Kd Ks]
Seat 1: BgOXYI0yYSN1ULC4FqsNkg (button) folded on the River
Seat 2: BAjwVL+zKKd0s0fAWstzQQ (small blind) folded on the Flop
Seat 3: JFLrYNyQmwPhRQAtoSAuyA (big blind) collected ($8.10)
Seat 4: 4QfsCWthT/vSLirorNXqtg folded before Flop (didn't bet)
Seat 5: GUnvMULl2qFOO1yenu1UBw folded before Flop (didn't bet)
Seat 6: 498aWaGsW4uGfuWl+2FCGw folded before Flop (didn't bet)



PokerStars Game #59941432350:  Hold'em No Limit ($0.25/$0.50) - 2009/07/01 1:35:20 ET
Table 'ofnd8S4IdIPph1Cbn+x7hAbR5MkGhKEbz+X2bpfpu11Qmax Seat #8 is the button
Seat 1: qG3y+yB3IhWjAWO8gvk6Rg ($45.80 in chips)
Seat 2: 1xBtrSVBbgFH/viUWKqQeg ($29.95 in chips)
Seat 3: UVJbBPbDwNMEZadZB9WVmg ($9.50 in chips)
Seat 4: mZNMJI1mY40XTC0U7GZakA ($62.45 in chips)
Seat 5: 2YaCb/8u1SesrR+963XiZA ($9.25 in chips)
Seat 7: kJ06FP2Jc7cSdmywwvYOXw ($63.35 in chips)
Seat 8: R354x4oZnQcGCDV6GhjnpQ ($65.30 in chips)
Seat 9: 75K2MXwN65Sjfp1yHd50Hg ($9.50 in chips)
75K2MXwN65Sjfp1yHd50Hg: posts small blind $0.25
qG3y+yB3IhWjAWO8gvk6Rg: posts big blind $0.50
*** HOLE CARDS ***
1xBtrSVBbgFH/viUWKqQeg: folds
UVJbBPbDwNMEZadZB9WVmg: folds
mZNMJI1mY40XTC0U7GZakA: folds
2YaCb/8u1SesrR+963XiZA: folds
kJ06FP2Jc7cSdmywwvYOXw: folds
R354x4oZnQcGCDV6GhjnpQ: folds
75K2MXwN65Sjfp1yHd50Hg: raises $9 to $9.50 and is all-in
qG3y+yB3IhWjAWO8gvk6Rg: folds
75K2MXwN65Sjfp1yHd50Hg collected $1 from pot
75K2MXwN65Sjfp1yHd50Hg: doesn't show hand
*** SUMMARY ***
Total pot $1 | Rake $0
Seat 1: qG3y+yB3IhWjAWO8gvk6Rg (big blind) folded before Flop
Seat 2: 1xBtrSVBbgFH/viUWKqQeg folded before Flop (didn't bet)
Seat 3: UVJbBPbDwNMEZadZB9WVmg folded before Flop (didn't bet)
Seat 4: mZNMJI1mY40XTC0U7GZakA folded before Flop (didn't bet)
Seat 5: 2YaCb/8u1SesrR+963XiZA folded before Flop (didn't bet)
Seat 7: kJ06FP2Jc7cSdmywwvYOXw folded before Flop (didn't bet)
Seat 8: R354x4oZnQcGCDV6GhjnpQ (button) folded before Flop (didn't bet)
Seat 9: 75K2MXwN65Sjfp1yHd50Hg (small blind) collected ($1)



PokerStars Game #59941433380:  Hold'em No Limit ($0.25/$0.50) - 2009/07/01 1:35:22 ET
Table 'cofQFHU7jbJoFecLVBof/w' 6-max Seat #6 is the button
Seat 1: URYNc7fPA23K2UfadQbnCA ($51 in chips)
Seat 2: f89uTQr3ieGlusj2IAYAEg ($50 in chips)
Seat 3: v4ctePcLlQw0r8E0qJtjYw ($53.70 in chips)
Seat 4: g6lz8npaeeTJmJegtPYhlQ ($15.35 in chips)
Seat 5: QvwRlrpVqerRRF8eJm6dDw ($47.65 in chips)
Seat 6: 7+uQ0OOgCTbR4ltkSwyC0g ($159.80 in chips)
URYNc7fPA23K2UfadQbnCA: posts small blind $0.25
f89uTQr3ieGlusj2IAYAEg: posts big blind $0.50
*** HOLE CARDS ***
v4ctePcLlQw0r8E0qJtjYw: folds
g6lz8npaeeTJmJegtPYhlQ: calls $0.50
QvwRlrpVqerRRF8eJm6dDw: raises $0.50 to $1
7+uQ0OOgCTbR4ltkSwyC0g: folds
URYNc7fPA23K2UfadQbnCA: folds
f89uTQr3ieGlusj2IAYAEg: folds
g6lz8npaeeTJmJegtPYhlQ: calls $0.50
*** FLOP *** [8d Ah 9d]
g6lz8npaeeTJmJegtPYhlQ: bets $2
QvwRlrpVqerRRF8eJm6dDw: folds
g6lz8npaeeTJmJegtPYhlQ collected $2.65 from pot
*** SUMMARY ***
Total pot $2.75 | Rake $0.10
Board [8d Ah 9d]
Seat 1: URYNc7fPA23K2UfadQbnCA (small blind) folded before Flop
Seat 2: f89uTQr3ieGlusj2IAYAEg (big blind) folded before Flop
Seat 3: v4ctePcLlQw0r8E0qJtjYw folded before Flop (didn't bet)
Seat 4: g6lz8npaeeTJmJegtPYhlQ collected ($2.65)
Seat 5: QvwRlrpVqerRRF8eJm6dDw folded on the Flop
Seat 6: 7+uQ0OOgCTbR4ltkSwyC0g (button) folded before Flop (didn't bet)



PokerStars Game #59941433524:  Hold'em No Limit ($0.25/$0.50) - 2009/07/01 1:35:22 ET
Table '8BQGgNetI1NOvWeu3gtMNw' 2-max Seat #2 is the button
Seat 1: bypIyrYcAAifLfhZpGlKLA ($82.40 in chips)
Seat 2: Z4HwehErEwzsv/noQlfUlg ($132.85 in chips)
Z4HwehErEwzsv/noQlfUlg: posts small blind $0.25
bypIyrYcAAifLfhZpGlKLA: posts big blind $0.50
*** HOLE CARDS ***
Z4HwehErEwzsv/noQlfUlg: folds
bypIyrYcAAifLfhZpGlKLA collected $0.50 from pot
bypIyrYcAAifLfhZpGlKLA: doesn't show hand
*** SUMMARY ***
Total pot $0.50 | Rake $0
Seat 1: bypIyrYcAAifLfhZpGlKLA (big blind) collected ($0.50)
Seat 2: Z4HwehErEwzsv/noQlfUlg (button) (small blind) folded before Flop



PokerStars Game #59941434266:  Hold'em No Limit ($0.25/$0.50) - 2009/07/01 1:35:23 ET
Table '2lPOwetm4cfkZPbTmGPH/w' 2-max Seat #2 is the button
Seat 1: vUGdApqS8J/GJE2gaVWl1w ($22.85 in chips)
Seat 2: XFa6sBGjP2gxoIvxR3fZIg ($16.20 in chips)
XFa6sBGjP2gxoIvxR3fZIg: posts small blind $0.25
vUGdApqS8J/GJE2gaVWl1w: posts big blind $0.50
*** HOLE CARDS ***
XFa6sBGjP2gxoIvxR3fZIg: raises $1 to $1.50
vUGdApqS8J/GJE2gaVWl1w: folds
XFa6sBGjP2gxoIvxR3fZIg collected $1 from pot
XFa6sBGjP2gxoIvxR3fZIg: doesn't show hand
*** SUMMARY ***
Total pot $1 | Rake $0
Seat 1: vUGdApqS8J/GJE2gaVWl1w (big blind) folded before Flop
Seat 2: XFa6sBGjP2gxoIvxR3fZIg (button) (small blind) collected ($1)



PokerStars Game #59941434748:  Hold'em No Limit ($0.25/$0.50) - 2009/07/01 1:35:24 ET
Table 'B+sqsfj6d6zXicNfaseTaw' 2-max Seat #1 is the button
Seat 1: +4GNcSsecmapVGSdV0mUPA ($160.15 in chips)
Seat 2: Lv5RmpRe6LtPkBzM9Gpo5A ($62.40 in chips)
+4GNcSsecmapVGSdV0mUPA: posts small blind $0.25
Lv5RmpRe6LtPkBzM9Gpo5A: posts big blind $0.50
*** HOLE CARDS ***
+4GNcSsecmapVGSdV0mUPA: calls $0.25
Lv5RmpRe6LtPkBzM9Gpo5A: checks
*** FLOP *** [Kd 2c 2h]
Lv5RmpRe6LtPkBzM9Gpo5A: checks
+4GNcSsecmapVGSdV0mUPA: bets $0.50
Lv5RmpRe6LtPkBzM9Gpo5A: calls $0.50
*** TURN *** [Kd 2c 2h] [Jd]
Lv5RmpRe6LtPkBzM9Gpo5A: checks
+4GNcSsecmapVGSdV0mUPA: bets $2
Lv5RmpRe6LtPkBzM9Gpo5A: folds
+4GNcSsecmapVGSdV0mUPA collected $1.95 from pot
*** SUMMARY ***
Total pot $2 | Rake $0.05
Board [Kd 2c 2h Jd]
Seat 1: +4GNcSsecmapVGSdV0mUPA (button) (small blind) collected ($1.95)
Seat 2: Lv5RmpRe6LtPkBzM9Gpo5A (big blind) folded on the Turn



PokerStars Game #59941435056:  Hold'em No Limit ($0.25/$0.50) - 2009/07/01 1:35:25 ET
Table 'kgbJRsxfv64KrErDRBAkcw' 6-max Seat #2 is the button
Seat 1: VamsyhlFzXGF6/ydo0BHeA ($18 in chips)
Seat 2: AdS8BJMOheS01zjCDfPMFg ($62 in chips)
Seat 3: c4MNIaIyPMOMxrgT8FT5nA ($153.25 in chips)
Seat 4: 2igtJLmvIZ+HqX4XPgMPZA ($112.50 in chips)
Seat 5: eUBBn2R56C1IQ6Cs/vitwg ($104 in chips)
Seat 6: 1b+2BbjMN8qhR1WPqdE9VQ ($66.35 in chips)
c4MNIaIyPMOMxrgT8FT5nA: posts small blind $0.25
2igtJLmvIZ+HqX4XPgMPZA: posts big blind $0.50
*** HOLE CARDS ***
eUBBn2R56C1IQ6Cs/vitwg: folds
1b+2BbjMN8qhR1WPqdE9VQ: raises $1 to $1.50
VamsyhlFzXGF6/ydo0BHeA: folds
AdS8BJMOheS01zjCDfPMFg: calls $1.50
c4MNIaIyPMOMxrgT8FT5nA: folds
2igtJLmvIZ+HqX4XPgMPZA: folds
*** FLOP *** [Js Jc 4c]
1b+2BbjMN8qhR1WPqdE9VQ: bets $3
AdS8BJMOheS01zjCDfPMFg: raises $4.50 to $7.50
1b+2BbjMN8qhR1WPqdE9VQ: calls $4.50
*** TURN *** [Js Jc 4c] [9d]
1b+2BbjMN8qhR1WPqdE9VQ: checks
AdS8BJMOheS01zjCDfPMFg: bets $11
1b+2BbjMN8qhR1WPqdE9VQ: calls $11
*** RIVER *** [Js Jc 4c 9d] [6s]
1b+2BbjMN8qhR1WPqdE9VQ: checks
AdS8BJMOheS01zjCDfPMFg: bets $7
1b+2BbjMN8qhR1WPqdE9VQ: folds
AdS8BJMOheS01zjCDfPMFg collected $38.80 from pot
*** SUMMARY ***
Total pot $40.75 | Rake $1.95
Board [Js Jc 4c 9d 6s]
Seat 1: VamsyhlFzXGF6/ydo0BHeA folded before Flop (didn't bet)
Seat 2: AdS8BJMOheS01zjCDfPMFg (button) collected ($38.80)
Seat 3: c4MNIaIyPMOMxrgT8FT5nA (small blind) folded before Flop
Seat 4: 2igtJLmvIZ+HqX4XPgMPZA (big blind) folded before Flop
Seat 5: eUBBn2R56C1IQ6Cs/vitwg folded before Flop (didn't bet)
Seat 6: 1b+2BbjMN8qhR1WPqdE9VQ folded on the River



PokerStars Game #59941437110:  Hold'em No Limit ($0.25/$0.50) - 2009/07/01 1:35:28 ET
Table 'Nz0Vr7WMHL2g5Uk7dDZjpw' 9-max Seat #5 is the button
Seat 1: 9yMsdgReyOUerNsmTYCCDQ ($9 in chips)
Seat 2: SegjDnMxWMujiD57ESNL+g ($20.35 in chips)
Seat 3: c638Xxo+q5F/t5qMtmvmvQ ($50.65 in chips)
Seat 4: uw9QayAAxLM3Hb+HR7mSkg ($9.25 in chips)
Seat 5: WGW0DgjBUXs1ylURHG8vnQ ($13.55 in chips)
Seat 6: 997ViqAtWn1FPjJqcffwcA ($50 in chips)
Seat 7: KPLH0gELgFe2OuAnhJFI5w ($26.55 in chips)
Seat 8: aoL+R/61Kxmw69ypuPrWAQ ($29.30 in chips)
Seat 9: mSD1pginDsyHG5PDfqzphw ($19.25 in chips)
997ViqAtWn1FPjJqcffwcA: posts small blind $0.25
KPLH0gELgFe2OuAnhJFI5w: posts big blind $0.50
*** HOLE CARDS ***
aoL+R/61Kxmw69ypuPrWAQ: folds
mSD1pginDsyHG5PDfqzphw: raises $1 to $1.50
9yMsdgReyOUerNsmTYCCDQ: folds
SegjDnMxWMujiD57ESNL+g: folds
c638Xxo+q5F/t5qMtmvmvQ: folds
uw9QayAAxLM3Hb+HR7mSkg: folds
WGW0DgjBUXs1ylURHG8vnQ: folds
997ViqAtWn1FPjJqcffwcA: calls $1.25
KPLH0gELgFe2OuAnhJFI5w: calls $1
*** FLOP *** [5c 4h 4s]
997ViqAtWn1FPjJqcffwcA: checks
KPLH0gELgFe2OuAnhJFI5w: bets $0.50
mSD1pginDsyHG5PDfqzphw: calls $0.50
997ViqAtWn1FPjJqcffwcA: raises $3 to $3.50
KPLH0gELgFe2OuAnhJFI5w: folds
mSD1pginDsyHG5PDfqzphw: folds
997ViqAtWn1FPjJqcffwcA collected $5.75 from pot
*** SUMMARY ***
Total pot $6 | Rake $0.25
Board [5c 4h 4s]
Seat 1: 9yMsdgReyOUerNsmTYCCDQ folded before Flop (didn't bet)
Seat 2: SegjDnMxWMujiD57ESNL+g folded before Flop (didn't bet)
Seat 3: c638Xxo+q5F/t5qMtmvmvQ folded before Flop (didn't bet)
Seat 4: uw9QayAAxLM3Hb+HR7mSkg folded before Flop (didn't bet)
Seat 5: WGW0DgjBUXs1ylURHG8vnQ (button) folded before Flop (didn't bet)
Seat 6: 997ViqAtWn1FPjJqcffwcA (small blind) collected ($5.75)
Seat 7: KPLH0gELgFe2OuAnhJFI5w (big blind) folded on the Flop
Seat 8: aoL+R/61Kxmw69ypuPrWAQ folded before Flop (didn't bet)
Seat 9: mSD1pginDsyHG5PDfqzphw folded on the Flop



PokerStars Game #59941437688:  Hold'em No Limit ($0.25/$0.50) - 2009/07/01 1:35:29 ET
Table '2lPOwetm4cfkZPbTmGPH/w' 2-max Seat #1 is the button
Seat 1: vUGdApqS8J/GJE2gaVWl1w ($22.35 in chips)
Seat 2: XFa6sBGjP2gxoIvxR3fZIg ($16.70 in chips)
vUGdApqS8J/GJE2gaVWl1w: posts small blind $0.25
XFa6sBGjP2gxoIvxR3fZIg: posts big blind $0.50
*** HOLE CARDS ***
vUGdApqS8J/GJE2gaVWl1w: folds
XFa6sBGjP2gxoIvxR3fZIg collected $0.50 from pot
*** SUMMARY ***
Total pot $0.50 | Rake $0
Seat 1: vUGdApqS8J/GJE2gaVWl1w (button) (small blind) folded before Flop
Seat 2: XFa6sBGjP2gxoIvxR3fZIg (big blind) collected ($0.50)



PokerStars Game #59941437830:  Hold'em No Limit ($0.25/$0.50) - 2009/07/01 1:35:30 ET
Table 'Wwfm5/i+g/g2Nj2gT3jnVQ' 2-max Seat #2 is the button
Seat 1: CHRLZDaaxjbo68bwQD1C/Q ($12.65 in chips)
Seat 2: PKuuhUvIr5WSkJyPJa9dFw ($17.85 in chips)
PKuuhUvIr5WSkJyPJa9dFw: posts small blind $0.25
CHRLZDaaxjbo68bwQD1C/Q: posts big blind $0.50
*** HOLE CARDS ***
PKuuhUvIr5WSkJyPJa9dFw: raises $1.35 to $1.85
CHRLZDaaxjbo68bwQD1C/Q: folds
PKuuhUvIr5WSkJyPJa9dFw collected $1 from pot
PKuuhUvIr5WSkJyPJa9dFw: doesn't show hand
*** SUMMARY ***
Total pot $1 | Rake $0
Seat 1: CHRLZDaaxjbo68bwQD1C/Q (big blind) folded before Flop
Seat 2: PKuuhUvIr5WSkJyPJa9dFw (button) (small blind) collected ($1)



PokerStars Game #59941438562:  Hold'em No Limit ($0.25/$0.50) - 2009/07/01 1:35:31 ET
Table '+dXkOAQyS8j9PQZusUTMpg' 2-max Seat #2 is the button
Seat 1: Teld4PDKla7C8/Wfu2DSkg ($54.50 in chips)
Seat 2: +zI4bP23YIjMkUHqeN2xfw ($20.80 in chips)
+zI4bP23YIjMkUHqeN2xfw: posts small blind $0.25
Teld4PDKla7C8/Wfu2DSkg: posts big blind $0.50
*** HOLE CARDS ***
+zI4bP23YIjMkUHqeN2xfw: raises $0.50 to $1
Teld4PDKla7C8/Wfu2DSkg: calls $0.50
*** FLOP *** [As 7c 2s]
Teld4PDKla7C8/Wfu2DSkg: checks
+zI4bP23YIjMkUHqeN2xfw: bets $1
Teld4PDKla7C8/Wfu2DSkg: folds
+zI4bP23YIjMkUHqeN2xfw collected $1.90 from pot
*** SUMMARY ***
Total pot $2 | Rake $0.10
Board [As 7c 2s]
Seat 1: Teld4PDKla7C8/Wfu2DSkg (big blind) folded on the Flop
Seat 2: +zI4bP23YIjMkUHqeN2xfw (button) (small blind) collected ($1.90)



PokerStars Game #59941438650:  Hold'em No Limit ($0.25/$0.50) - 2009/07/01 1:35:31 ET
Table 'hSTs/dUsYLgJQuF2Onp0MQ' 6-max Seat #1 is the button
Seat 1: 1WUCqNG+p+vfWRTXNu4ljw ($50.75 in chips)
Seat 2: Hdd4js36ITbTJ/QuVYwTlA ($113.25 in chips)
Seat 3: lxIzoHy0RnkfFSODHC2liw ($50 in chips)
Seat 4: 2igtJLmvIZ+HqX4XPgMPZA ($50 in chips)
Seat 5: FsRQ5ECdlLkLYI5le8+PDQ ($49.25 in chips)
Seat 6: M1KyQQvVPVuxqTAB8sR/zQ ($91.55 in chips)
Hdd4js36ITbTJ/QuVYwTlA: posts small blind $0.25
lxIzoHy0RnkfFSODHC2liw: posts big blind $0.50
*** HOLE CARDS ***
2igtJLmvIZ+HqX4XPgMPZA: folds
FsRQ5ECdlLkLYI5le8+PDQ: folds
M1KyQQvVPVuxqTAB8sR/zQ: folds
1WUCqNG+p+vfWRTXNu4ljw: folds
Hdd4js36ITbTJ/QuVYwTlA: raises $1.50 to $2
lxIzoHy0RnkfFSODHC2liw: folds
Hdd4js36ITbTJ/QuVYwTlA collected $1 from pot
*** SUMMARY ***
Total pot $1 | Rake $0
Seat 1: 1WUCqNG+p+vfWRTXNu4ljw (button) folded before Flop (didn't bet)
Seat 2: Hdd4js36ITbTJ/QuVYwTlA (small blind) collected ($1)
Seat 3: lxIzoHy0RnkfFSODHC2liw (big blind) folded before Flop
Seat 4: 2igtJLmvIZ+HqX4XPgMPZA folded before Flop (didn't bet)
Seat 5: FsRQ5ECdlLkLYI5le8+PDQ folded before Flop (didn't bet)
Seat 6: M1KyQQvVPVuxqTAB8sR/zQ folded before Flop (didn't bet)



PokerStars Game #59941439294:  Hold'em No Limit ($0.25/$0.50) - 2009/07/01 1:35:32 ET
Table 'fx6MqwfYAj/Rt86hBz2L3Q' 9-max Seat #6 is the button
Seat 1: v/4aX0ejnaIFK4ftDk2Lyg ($50.65 in chips)
Seat 2: C3rGXblctNcWI6JYPHhaEg ($61 in chips)
Seat 3: iadBi5AEt7gTBXbDSSnMYQ ($39.85 in chips)
Seat 4: VhjwWfxHSx00WxzYih3KOA ($50 in chips)
Seat 6: 5k9fvXD9suIgCxU4HLQjTw ($50 in chips)
Seat 7: mSD1pginDsyHG5PDfqzphw ($11.75 in chips)
Seat 8: 75K2MXwN65Sjfp1yHd50Hg ($10 in chips)
Seat 9: vO3QVRovWemcGMkm7ijAIA ($22.95 in chips)
mSD1pginDsyHG5PDfqzphw: posts small blind $0.25
75K2MXwN65Sjfp1yHd50Hg: posts big blind $0.50
e2+sK/yjnj94rXOKoxPP2A: sits out
*** HOLE CARDS ***
vO3QVRovWemcGMkm7ijAIA: folds
v/4aX0ejnaIFK4ftDk2Lyg: folds
C3rGXblctNcWI6JYPHhaEg: calls $0.50
iadBi5AEt7gTBXbDSSnMYQ: folds
VhjwWfxHSx00WxzYih3KOA: folds
5k9fvXD9suIgCxU4HLQjTw: folds
mSD1pginDsyHG5PDfqzphw: folds
75K2MXwN65Sjfp1yHd50Hg: raises $2 to $2.50
C3rGXblctNcWI6JYPHhaEg: calls $2
*** FLOP *** [8c Ks 5h]
75K2MXwN65Sjfp1yHd50Hg: bets $2.50
C3rGXblctNcWI6JYPHhaEg: folds
75K2MXwN65Sjfp1yHd50Hg collected $5 from pot
75K2MXwN65Sjfp1yHd50Hg: doesn't show hand
*** SUMMARY ***
Total pot $5.25 | Rake $0.25
Board [8c Ks 5h]
Seat 1: v/4aX0ejnaIFK4ftDk2Lyg folded before Flop (didn't bet)
Seat 2: C3rGXblctNcWI6JYPHhaEg folded on the Flop
Seat 3: iadBi5AEt7gTBXbDSSnMYQ folded before Flop (didn't bet)
Seat 4: VhjwWfxHSx00WxzYih3KOA folded before Flop (didn't bet)
Seat 6: 5k9fvXD9suIgCxU4HLQjTw (button) folded before Flop (didn't bet)
Seat 7: mSD1pginDsyHG5PDfqzphw (small blind) folded before Flop
Seat 8: 75K2MXwN65Sjfp1yHd50Hg (big blind) collected ($5)
Seat 9: vO3QVRovWemcGMkm7ijAIA folded before Flop (didn't bet)



PokerStars Game #59941440320:  Hold'em No Limit ($0.25/$0.50) - 2009/07/01 1:35:34 ET
Table '8BQGgNetI1NOvWeu3gtMNw' 2-max Seat #1 is the button
Seat 1: bypIyrYcAAifLfhZpGlKLA ($82.65 in chips)
Seat 2: Z4HwehErEwzsv/noQlfUlg ($132.60 in chips)
bypIyrYcAAifLfhZpGlKLA: posts small blind $0.25
Z4HwehErEwzsv/noQlfUlg: posts big blind $0.50
*** HOLE CARDS ***
bypIyrYcAAifLfhZpGlKLA: raises $1 to $1.50
Z4HwehErEwzsv/noQlfUlg: calls $1
*** FLOP *** [4d Jd Ad]
Z4HwehErEwzsv/noQlfUlg: checks
bypIyrYcAAifLfhZpGlKLA: bets $2
Z4HwehErEwzsv/noQlfUlg: folds
bypIyrYcAAifLfhZpGlKLA collected $2.85 from pot
bypIyrYcAAifLfhZpGlKLA: doesn't show hand
*** SUMMARY ***
Total pot $3 | Rake $0.15
Board [4d Jd Ad]
Seat 1: bypIyrYcAAifLfhZpGlKLA (button) (small blind) collected ($2.85)
Seat 2: Z4HwehErEwzsv/noQlfUlg (big blind) folded on the Flop



PokerStars Game #59941441040:  Hold'em No Limit ($0.25/$0.50) - 2009/07/01 1:35:35 ET
Table '+z1aekfHkpp09pc8F9aViw' 6-max Seat #3 is the button
Seat 2: 4QfsCWthT/vSLirorNXqtg ($52 in chips)
Seat 3: URYNc7fPA23K2UfadQbnCA ($47 in chips)
Seat 4: RowCSpSURHTOL/dcjg/Iug ($85.95 in chips)
Seat 5: 2igtJLmvIZ+HqX4XPgMPZA ($50.95 in chips)
Seat 6: GUnvMULl2qFOO1yenu1UBw ($52.25 in chips)
RowCSpSURHTOL/dcjg/Iug: posts small blind $0.25
2igtJLmvIZ+HqX4XPgMPZA: posts big blind $0.50
L0aIPg7qefDQjdJo3HCVEA: sits out
*** HOLE CARDS ***
GUnvMULl2qFOO1yenu1UBw: folds
4QfsCWthT/vSLirorNXqtg: folds
URYNc7fPA23K2UfadQbnCA: folds
RowCSpSURHTOL/dcjg/Iug: folds
2igtJLmvIZ+HqX4XPgMPZA collected $0.50 from pot
*** SUMMARY ***
Total pot $0.50 | Rake $0
Seat 2: 4QfsCWthT/vSLirorNXqtg folded before Flop (didn't bet)
Seat 3: URYNc7fPA23K2UfadQbnCA (button) folded before Flop (didn't bet)
Seat 4: RowCSpSURHTOL/dcjg/Iug (small blind) folded before Flop
Seat 5: 2igtJLmvIZ+HqX4XPgMPZA (big blind) collected ($0.50)
Seat 6: GUnvMULl2qFOO1yenu1UBw folded before Flop (didn't bet)



PokerStars Game #59941441492:  Hold'em No Limit ($0.25/$0.50) - 2009/07/01 1:35:36 ET
Table 'GfL/No5u5PoEnU39lP5pQg' 6-max Seat #1 is the button
Seat 1: 1WUCqNG+p+vfWRTXNu4ljw ($54.10 in chips)
Seat 2: uVwggSetzp7d+eVgowO3vg ($46 in chips)
Seat 3: 4pp9WxhGdbVbxCc9tlu0lw ($25.30 in chips)
Seat 4: r6u7MWSXF30/khcTYkrG9Q ($31.25 in chips)
Seat 5: M1KyQQvVPVuxqTAB8sR/zQ ($60.45 in chips)
Seat 6: kxPhs4ePFqMy52CInAJ2aw ($120.95 in chips)
uVwggSetzp7d+eVgowO3vg: posts small blind $0.25
4pp9WxhGdbVbxCc9tlu0lw: posts big blind $0.50
*** HOLE CARDS ***
r6u7MWSXF30/khcTYkrG9Q: folds
M1KyQQvVPVuxqTAB8sR/zQ: raises $1 to $1.50
kxPhs4ePFqMy52CInAJ2aw: folds
1WUCqNG+p+vfWRTXNu4ljw: folds
r6u7MWSXF30/khcTYkrG9Q is sitting out
uVwggSetzp7d+eVgowO3vg: calls $1.25
r6u7MWSXF30/khcTYkrG9Q leaves the table
4pp9WxhGdbVbxCc9tlu0lw: folds
*** FLOP *** [8d Th 9h]
uVwggSetzp7d+eVgowO3vg: bets $1.50
vhWS+cwAJNd3JzqVzIjBZA joins the table at seat #4
M1KyQQvVPVuxqTAB8sR/zQ: calls $1.50
*** TURN *** [8d Th 9h] [4d]
uVwggSetzp7d+eVgowO3vg: bets $2
M1KyQQvVPVuxqTAB8sR/zQ: raises $4.50 to $6.50
uVwggSetzp7d+eVgowO3vg: calls $4.50
*** RIVER *** [8d Th 9h 4d] [8s]
uVwggSetzp7d+eVgowO3vg: checks
M1KyQQvVPVuxqTAB8sR/zQ: checks
*** SHOW DOWN ***
uVwggSetzp7d+eVgowO3vg: shows [Td 7c] (two pair, Tens and Eights)
M1KyQQvVPVuxqTAB8sR/zQ: mucks hand
uVwggSetzp7d+eVgowO3vg collected $18.55 from pot
*** SUMMARY ***
Total pot $19.50 | Rake $0.95
Board [8d Th 9h 4d 8s]
Seat 1: 1WUCqNG+p+vfWRTXNu4ljw (button) folded before Flop (didn't bet)
Seat 2: uVwggSetzp7d+eVgowO3vg (small blind) showed [Td 7c] and won ($18.55) with two pair, Tens and Eights
Seat 3: 4pp9WxhGdbVbxCc9tlu0lw (big blind) folded before Flop
Seat 4: r6u7MWSXF30/khcTYkrG9Q folded before Flop (didn't bet)
Seat 5: M1KyQQvVPVuxqTAB8sR/zQ mucked
Seat 6: kxPhs4ePFqMy52CInAJ2aw folded before Flop (didn't bet)



PokerStars Game #59941441994:  Hold'em No Limit ($0.25/$0.50) - 2009/07/01 1:35:37 ET
Table 'BCN5su+SsXiy1zRMJi0SJw' 6-max Seat #5 is the button
Seat 1: GxXV09ciXaOxyY2H5aMIIw ($30 in chips)
Seat 2: ehFNAevCQri3trWxV6FJdA ($100.15 in chips)
Seat 3: kwgv5lNhiFrfONXCshzxlA ($72.10 in chips)
Seat 4: bbsK8j+tpuVRhBqDzHxf7w ($49.85 in chips)
Seat 5: kxPhs4ePFqMy52CInAJ2aw ($50.50 in chips)
Seat 6: b2symlOdL7+0c9Pj4N/KlA ($67.95 in chips)
b2symlOdL7+0c9Pj4N/KlA: posts small blind $0.25
GxXV09ciXaOxyY2H5aMIIw: posts big blind $0.50
*** HOLE CARDS ***
ehFNAevCQri3trWxV6FJdA: calls $0.50
kwgv5lNhiFrfONXCshzxlA: calls $0.50
bbsK8j+tpuVRhBqDzHxf7w: folds
kxPhs4ePFqMy52CInAJ2aw: folds
b2symlOdL7+0c9Pj4N/KlA: calls $0.25
GxXV09ciXaOxyY2H5aMIIw: checks
*** FLOP *** [9d 8d Js]
b2symlOdL7+0c9Pj4N/KlA: checks
GxXV09ciXaOxyY2H5aMIIw: checks
ehFNAevCQri3trWxV6FJdA: checks
kwgv5lNhiFrfONXCshzxlA: bets $1
b2symlOdL7+0c9Pj4N/KlA: raises $4 to $5
GxXV09ciXaOxyY2H5aMIIw: folds
ehFNAevCQri3trWxV6FJdA: folds
kwgv5lNhiFrfONXCshzxlA: folds
b2symlOdL7+0c9Pj4N/KlA collected $3.85 from pot
b2symlOdL7+0c9Pj4N/KlA: doesn't show hand
*** SUMMARY ***
Total pot $4 | Rake $0.15
Board [9d 8d Js]
Seat 1: GxXV09ciXaOxyY2H5aMIIw (big blind) folded on the Flop
Seat 2: ehFNAevCQri3trWxV6FJdA folded on the Flop
Seat 3: kwgv5lNhiFrfONXCshzxlA folded on the Flop
Seat 4: bbsK8j+tpuVRhBqDzHxf7w folded before Flop (didn't bet)
Seat 5: kxPhs4ePFqMy52CInAJ2aw (button) folded before Flop (didn't bet)
Seat 6: b2symlOdL7+0c9Pj4N/KlA (small blind) collected ($3.85)



PokerStars Game #59941442038:  Hold'em No Limit ($0.25/$0.50) - 2009/07/01 1:35:37 ET
Table '2lPOwetm4cfkZPbTmGPH/w' 2-max Seat #2 is the button
Seat 1: vUGdApqS8J/GJE2gaVWl1w ($22.10 in chips)
Seat 2: XFa6sBGjP2gxoIvxR3fZIg ($16.95 in chips)
XFa6sBGjP2gxoIvxR3fZIg: posts small blind $0.25
vUGdApqS8J/GJE2gaVWl1w: posts big blind $0.50
*** HOLE CARDS ***
XFa6sBGjP2gxoIvxR3fZIg: calls $0.25
vUGdApqS8J/GJE2gaVWl1w: checks
*** FLOP *** [Ts 8h 2c]
vUGdApqS8J/GJE2gaVWl1w: bets $0.50
XFa6sBGjP2gxoIvxR3fZIg: folds
vUGdApqS8J/GJE2gaVWl1w collected $0.95 from pot
*** SUMMARY ***
Total pot $1 | Rake $0.05
Board [Ts 8h 2c]
Seat 1: vUGdApqS8J/GJE2gaVWl1w (big blind) collected ($0.95)
Seat 2: XFa6sBGjP2gxoIvxR3fZIg (button) (small blind) folded on the Flop



PokerStars Game #59941442254:  Hold'em No Limit ($0.25/$0.50) - 2009/07/01 1:35:37 ET
Table 'ErOuyGLI5PT3G5MnpHgC/g' 9-max Seat #3 is the button
Seat 1: eBrej2jnlUCs/JgxFCRn2g ($43.90 in chips)
Seat 2: pciZn00ZDk4BVBMTTMcNVQ ($20.25 in chips)
Seat 3: xZCXQSXlrZkp3pZizzVXCw ($49.25 in chips)
Seat 4: YRqrX/u38J7aLNNnBzQsjQ ($9.50 in chips)
Seat 5: JwvquocWfhTVApN5t47LgA ($49.55 in chips)
Seat 6: zE9cVigS2nW/Ljy4K4bUQA ($30 in chips)
Seat 7: 90Wb75h3W1BRpbqVnuk8gw ($71.45 in chips)
Seat 8: g4k0NXISyLCqaSWZDBjfEg ($50 in chips)
Seat 9: J0W5D97jl5VLky+IoPvDeA ($64.50 in chips)
YRqrX/u38J7aLNNnBzQsjQ: posts small blind $0.25
JwvquocWfhTVApN5t47LgA: posts big blind $0.50
*** HOLE CARDS ***
zE9cVigS2nW/Ljy4K4bUQA: raises $0.50 to $1
90Wb75h3W1BRpbqVnuk8gw: folds
g4k0NXISyLCqaSWZDBjfEg: calls $1
J0W5D97jl5VLky+IoPvDeA: folds
eBrej2jnlUCs/JgxFCRn2g: calls $1
pciZn00ZDk4BVBMTTMcNVQ: folds
xZCXQSXlrZkp3pZizzVXCw: folds
YRqrX/u38J7aLNNnBzQsjQ: folds
JwvquocWfhTVApN5t47LgA: calls $0.50
*** FLOP *** [As 2h Jd]
JwvquocWfhTVApN5t47LgA: checks
zE9cVigS2nW/Ljy4K4bUQA: checks
g4k0NXISyLCqaSWZDBjfEg: checks
eBrej2jnlUCs/JgxFCRn2g: bets $1
JwvquocWfhTVApN5t47LgA: folds
zE9cVigS2nW/Ljy4K4bUQA: calls $1
g4k0NXISyLCqaSWZDBjfEg: folds
*** TURN *** [As 2h Jd] [Qc]
zE9cVigS2nW/Ljy4K4bUQA: checks
eBrej2jnlUCs/JgxFCRn2g: checks
*** RIVER *** [As 2h Jd Qc] [2d]
zE9cVigS2nW/Ljy4K4bUQA: checks
eBrej2jnlUCs/JgxFCRn2g: checks
*** SHOW DOWN ***
zE9cVigS2nW/Ljy4K4bUQA: shows [Jc Kc] (two pair, Jacks and Deuces)
eBrej2jnlUCs/JgxFCRn2g: shows [Ts Ad] (two pair, Aces and Deuces)
eBrej2jnlUCs/JgxFCRn2g collected $5.95 from pot
*** SUMMARY ***
Total pot $6.25 | Rake $0.30
Board [As 2h Jd Qc 2d]
Seat 1: eBrej2jnlUCs/JgxFCRn2g showed [Ts Ad] and won ($5.95) with two pair, Aces and Deuces
Seat 2: pciZn00ZDk4BVBMTTMcNVQ folded before Flop (didn't bet)
Seat 3: xZCXQSXlrZkp3pZizzVXCw (button) folded before Flop (didn't bet)
Seat 4: YRqrX/u38J7aLNNnBzQsjQ (small blind) folded before Flop
Seat 5: JwvquocWfhTVApN5t47LgA (big blind) folded on the Flop
Seat 6: zE9cVigS2nW/Ljy4K4bUQA showed [Jc Kc] and lost with two pair, Jacks and Deuces
Seat 7: 90Wb75h3W1BRpbqVnuk8gw folded before Flop (didn't bet)
Seat 8: g4k0NXISyLCqaSWZDBjfEg folded on the Flop
Seat 9: J0W5D97jl5VLky+IoPvDeA folded before Flop (didn't bet)



PokerStars Game #59941443658:  Hold'em No Limit ($0.25/$0.50) - 2009/07/01 1:35:40 ET
Table 'iq+aXfWVQRdV0u8SRTYUEg' 9-max Seat #5 is the button
Seat 1: 3yl8Q6QaLfGtyhN4/pEFgQ ($72.30 in chips)
Seat 2: J9N0lxHFd/Js2S0xZLbsIQ ($27.30 in chips)
Seat 3: Qi/PyOsKwaqtKIg0H+7ELg ($9.70 in chips)
Seat 4: vHYT5s323LpajBj+2c9zbQ ($31.35 in chips)
Seat 5: 997ViqAtWn1FPjJqcffwcA ($56.90 in chips)
Seat 7: SKnJuWHScqetA/qG5p+wCg ($30.30 in chips)
Seat 8: /DtIHuxEH+3tzKefmSV+Mw ($38.20 in chips)
Seat 9: olE1Z2rKWAV8+tGqmIBK9g ($26.20 in chips)
SKnJuWHScqetA/qG5p+wCg: posts small blind $0.25
/DtIHuxEH+3tzKefmSV+Mw: posts big blind $0.50
*** HOLE CARDS ***
olE1Z2rKWAV8+tGqmIBK9g: folds
olE1Z2rKWAV8+tGqmIBK9g leaves the table
3yl8Q6QaLfGtyhN4/pEFgQ: folds
J9N0lxHFd/Js2S0xZLbsIQ: calls $0.50
Qi/PyOsKwaqtKIg0H+7ELg: raises $1.50 to $2
vHYT5s323LpajBj+2c9zbQ: folds
997ViqAtWn1FPjJqcffwcA: folds
SKnJuWHScqetA/qG5p+wCg: folds
/DtIHuxEH+3tzKefmSV+Mw: calls $1.50
J9N0lxHFd/Js2S0xZLbsIQ: calls $1.50
*** FLOP *** [8h 6c 6d]
7CKaQEWhd40e2lLifzZ1Cw joins the table at seat #9
/DtIHuxEH+3tzKefmSV+Mw: checks
J9N0lxHFd/Js2S0xZLbsIQ: checks
Qi/PyOsKwaqtKIg0H+7ELg: bets $1.50
/DtIHuxEH+3tzKefmSV+Mw: calls $1.50
J9N0lxHFd/Js2S0xZLbsIQ: folds
*** TURN *** [8h 6c 6d] [4c]
/DtIHuxEH+3tzKefmSV+Mw: checks
Qi/PyOsKwaqtKIg0H+7ELg: bets $1.50
/DtIHuxEH+3tzKefmSV+Mw: calls $1.50
*** RIVER *** [8h 6c 6d 4c] [4d]
/DtIHuxEH+3tzKefmSV+Mw: checks
Qi/PyOsKwaqtKIg0H+7ELg: checks
*** SHOW DOWN ***
/DtIHuxEH+3tzKefmSV+Mw: shows [Ks Ac] (two pair, Sixes and Fours)
Qi/PyOsKwaqtKIg0H+7ELg: mucks hand
/DtIHuxEH+3tzKefmSV+Mw collected $11.70 from pot
*** SUMMARY ***
Total pot $12.25 | Rake $0.55
Board [8h 6c 6d 4c 4d]
Seat 1: 3yl8Q6QaLfGtyhN4/pEFgQ folded before Flop (didn't bet)
Seat 2: J9N0lxHFd/Js2S0xZLbsIQ folded on the Flop
Seat 3: Qi/PyOsKwaqtKIg0H+7ELg mucked
Seat 4: vHYT5s323LpajBj+2c9zbQ folded before Flop (didn't bet)
Seat 5: 997ViqAtWn1FPjJqcffwcA (button) folded before Flop (didn't bet)
Seat 7: SKnJuWHScqetA/qG5p+wCg (small blind) folded before Flop
Seat 8: /DtIHuxEH+3tzKefmSV+Mw (big blind) showed [Ks Ac] and won ($11.70) with two pair, Sixes and Fours
Seat 9: olE1Z2rKWAV8+tGqmIBK9g folded before Flop (didn't bet)



PokerStars Game #59941444402:  Hold'em No Limit ($0.25/$0.50) - 2009/07/01 1:35:41 ET
Table 'Wwfm5/i+g/g2Nj2gT3jnVQ' 2-max Seat #1 is the button
Seat 1: CHRLZDaaxjbo68bwQD1C/Q ($12.15 in chips)
Seat 2: PKuuhUvIr5WSkJyPJa9dFw ($18.35 in chips)
CHRLZDaaxjbo68bwQD1C/Q: posts small blind $0.25
PKuuhUvIr5WSkJyPJa9dFw: posts big blind $0.50
*** HOLE CARDS ***
CHRLZDaaxjbo68bwQD1C/Q: folds
PKuuhUvIr5WSkJyPJa9dFw collected $0.50 from pot
PKuuhUvIr5WSkJyPJa9dFw: doesn't show hand
*** SUMMARY ***
Total pot $0.50 | Rake $0
Seat 1: CHRLZDaaxjbo68bwQD1C/Q (button) (small blind) folded before Flop
Seat 2: PKuuhUvIr5WSkJyPJa9dFw (big blind) collected ($0.50)



PokerStars Game #59941446242:  Hold'em No Limit ($0.25/$0.50) - 2009/07/01 1:35:44 ET
Table '+dXkOAQyS8j9PQZusUTMpg' 2-max Seat #1 is the button
Seat 1: Teld4PDKla7C8/Wfu2DSkg ($53.50 in chips)
Seat 2: +zI4bP23YIjMkUHqeN2xfw ($21.70 in chips)
Teld4PDKla7C8/Wfu2DSkg: posts small blind $0.25
+zI4bP23YIjMkUHqeN2xfw: posts big blind $0.50
*** HOLE CARDS ***
Teld4PDKla7C8/Wfu2DSkg: folds
+zI4bP23YIjMkUHqeN2xfw collected $0.50 from pot
*** SUMMARY ***
Total pot $0.50 | Rake $0
Seat 1: Teld4PDKla7C8/Wfu2DSkg (button) (small blind) folded before Flop
Seat 2: +zI4bP23YIjMkUHqeN2xfw (big blind) collected ($0.50)



PokerStars Game #59941446788:  Hold'em No Limit ($0.25/$0.50) - 2009/07/01 1:35:45 ET
Table 'ofnd8S4IdIPph1Cbn+x7hAbR5MkGhKEbz+X2bpfpu11Qmax Seat #9 is the button
Seat 1: qG3y+yB3IhWjAWO8gvk6Rg ($45.30 in chips)
Seat 2: 1xBtrSVBbgFH/viUWKqQeg ($29.95 in chips)
Seat 3: UVJbBPbDwNMEZadZB9WVmg ($9.50 in chips)
Seat 4: mZNMJI1mY40XTC0U7GZakA ($62.45 in chips)
Seat 5: 2YaCb/8u1SesrR+963XiZA ($9.25 in chips)
Seat 7: kJ06FP2Jc7cSdmywwvYOXw ($63.35 in chips)
Seat 8: R354x4oZnQcGCDV6GhjnpQ ($65.30 in chips)
Seat 9: 75K2MXwN65Sjfp1yHd50Hg ($10 in chips)
qG3y+yB3IhWjAWO8gvk6Rg: posts small blind $0.25
1xBtrSVBbgFH/viUWKqQeg: posts big blind $0.50
*** HOLE CARDS ***
UVJbBPbDwNMEZadZB9WVmg: folds
mZNMJI1mY40XTC0U7GZakA: folds
2YaCb/8u1SesrR+963XiZA: raises $1 to $1.50
kJ06FP2Jc7cSdmywwvYOXw: folds
R354x4oZnQcGCDV6GhjnpQ: folds
75K2MXwN65Sjfp1yHd50Hg: folds
qG3y+yB3IhWjAWO8gvk6Rg: folds
1xBtrSVBbgFH/viUWKqQeg: folds
2YaCb/8u1SesrR+963XiZA collected $1.25 from pot
2YaCb/8u1SesrR+963XiZA: doesn't show hand
*** SUMMARY ***
Total pot $1.25 | Rake $0
Seat 1: qG3y+yB3IhWjAWO8gvk6Rg (small blind) folded before Flop
Seat 2: 1xBtrSVBbgFH/viUWKqQeg (big blind) folded before Flop
Seat 3: UVJbBPbDwNMEZadZB9WVmg folded before Flop (didn't bet)
Seat 4: mZNMJI1mY40XTC0U7GZakA folded before Flop (didn't bet)
Seat 5: 2YaCb/8u1SesrR+963XiZA collected ($1.25)
Seat 7: kJ06FP2Jc7cSdmywwvYOXw folded before Flop (didn't bet)
Seat 8: R354x4oZnQcGCDV6GhjnpQ folded before Flop (didn't bet)
Seat 9: 75K2MXwN65Sjfp1yHd50Hg (button) folded before Flop (didn't bet)



PokerStars Game #59941448168:  Hold'em No Limit ($0.25/$0.50) - 2009/07/01 1:35:48 ET
Table 'Wwfm5/i+g/g2Nj2gT3jnVQ' 2-max Seat #2 is the button
Seat 1: CHRLZDaaxjbo68bwQD1C/Q ($11.90 in chips)
Seat 2: PKuuhUvIr5WSkJyPJa9dFw ($18.60 in chips)
PKuuhUvIr5WSkJyPJa9dFw: posts small blind $0.25
CHRLZDaaxjbo68bwQD1C/Q: posts big blind $0.50
*** HOLE CARDS ***
PKuuhUvIr5WSkJyPJa9dFw: raises $1 to $1.50
CHRLZDaaxjbo68bwQD1C/Q: folds
PKuuhUvIr5WSkJyPJa9dFw collected $1 from pot
PKuuhUvIr5WSkJyPJa9dFw: doesn't show hand
*** SUMMARY ***
Total pot $1 | Rake $0
Seat 1: CHRLZDaaxjbo68bwQD1C/Q (big blind) folded before Flop
Seat 2: PKuuhUvIr5WSkJyPJa9dFw (button) (small blind) collected ($1)



PokerStars Game #59941449422:  Hold'em No Limit ($0.25/$0.50) - 2009/07/01 1:35:50 ET
Table '2lPOwetm4cfkZPbTmGPH/w' 2-max Seat #1 is the button
Seat 1: vUGdApqS8J/GJE2gaVWl1w ($22.55 in chips)
Seat 2: XFa6sBGjP2gxoIvxR3fZIg ($16.45 in chips)
vUGdApqS8J/GJE2gaVWl1w: posts small blind $0.25
XFa6sBGjP2gxoIvxR3fZIg: posts big blind $0.50
*** HOLE CARDS ***
vUGdApqS8J/GJE2gaVWl1w: calls $0.25
XFa6sBGjP2gxoIvxR3fZIg: checks
*** FLOP *** [Ac 3h Kh]
XFa6sBGjP2gxoIvxR3fZIg: checks
vUGdApqS8J/GJE2gaVWl1w: bets $1.25
XFa6sBGjP2gxoIvxR3fZIg: calls $1.25
*** TURN *** [Ac 3h Kh] [5c]
XFa6sBGjP2gxoIvxR3fZIg: checks
vUGdApqS8J/GJE2gaVWl1w: bets $1
XFa6sBGjP2gxoIvxR3fZIg: raises $3 to $4
vUGdApqS8J/GJE2gaVWl1w: folds
XFa6sBGjP2gxoIvxR3fZIg collected $5.25 from pot
XFa6sBGjP2gxoIvxR3fZIg: doesn't show hand
*** SUMMARY ***
Total pot $5.50 | Rake $0.25
Board [Ac 3h Kh 5c]
Seat 1: vUGdApqS8J/GJE2gaVWl1w (button) (small blind) folded on the Turn
Seat 2: XFa6sBGjP2gxoIvxR3fZIg (big blind) collected ($5.25)



PokerStars Game #59941449608:  Hold'em No Limit ($0.25/$0.50) - 2009/07/01 1:35:50 ET
Table '+dXkOAQyS8j9PQZusUTMpg' 2-max Seat #2 is the button
Seat 1: Teld4PDKla7C8/Wfu2DSkg ($53.25 in chips)
Seat 2: +zI4bP23YIjMkUHqeN2xfw ($21.95 in chips)
+zI4bP23YIjMkUHqeN2xfw: posts small blind $0.25
Teld4PDKla7C8/Wfu2DSkg: posts big blind $0.50
*** HOLE CARDS ***
+zI4bP23YIjMkUHqeN2xfw: calls $0.25
Teld4PDKla7C8/Wfu2DSkg: checks
*** FLOP *** [9h 2s 8h]
Teld4PDKla7C8/Wfu2DSkg: checks
+zI4bP23YIjMkUHqeN2xfw: checks
*** TURN *** [9h 2s 8h] [Th]
Teld4PDKla7C8/Wfu2DSkg: checks
+zI4bP23YIjMkUHqeN2xfw: bets $1
Teld4PDKla7C8/Wfu2DSkg: folds
+zI4bP23YIjMkUHqeN2xfw collected $0.95 from pot
*** SUMMARY ***
Total pot $1 | Rake $0.05
Board [9h 2s 8h Th]
Seat 1: Teld4PDKla7C8/Wfu2DSkg (big blind) folded on the Turn
Seat 2: +zI4bP23YIjMkUHqeN2xfw (button) (small blind) collected ($0.95)



PokerStars Game #59941450308:  Hold'em No Limit ($0.25/$0.50) - 2009/07/01 1:35:52 ET
Table 'B+sqsfj6d6zXicNfaseTaw' 2-max Seat #2 is the button
Seat 1: +4GNcSsecmapVGSdV0mUPA ($161.10 in chips)
Seat 2: Lv5RmpRe6LtPkBzM9Gpo5A ($61.40 in chips)
Lv5RmpRe6LtPkBzM9Gpo5A: posts small blind $0.25
+4GNcSsecmapVGSdV0mUPA: posts big blind $0.50
*** HOLE CARDS ***
Lv5RmpRe6LtPkBzM9Gpo5A: raises $1.50 to $2
+4GNcSsecmapVGSdV0mUPA: calls $1.50
*** FLOP *** [Js Kh 2s]
+4GNcSsecmapVGSdV0mUPA: checks
Lv5RmpRe6LtPkBzM9Gpo5A: checks
*** TURN *** [Js Kh 2s] [Jh]
+4GNcSsecmapVGSdV0mUPA: checks
Lv5RmpRe6LtPkBzM9Gpo5A: checks
*** RIVER *** [Js Kh 2s Jh] [Jd]
+4GNcSsecmapVGSdV0mUPA: checks
Lv5RmpRe6LtPkBzM9Gpo5A: checks
*** SHOW DOWN ***
+4GNcSsecmapVGSdV0mUPA: shows [8d Qs] (three of a kind, Jacks)
Lv5RmpRe6LtPkBzM9Gpo5A: mucks hand
+4GNcSsecmapVGSdV0mUPA collected $3.80 from pot
*** SUMMARY ***
Total pot $4 | Rake $0.20
Board [Js Kh 2s Jh Jd]
Seat 1: +4GNcSsecmapVGSdV0mUPA (big blind) showed [8d Qs] and won ($3.80) with three of a kind, Jacks
Seat 2: Lv5RmpRe6LtPkBzM9Gpo5A (button) (small blind) mucked



PokerStars Game #59941452032:  Hold'em No Limit ($0.25/$0.50) - 2009/07/01 1:35:55 ET
Table '+z1aekfHkpp09pc8F9aViw' 6-max Seat #4 is the button
Seat 2: 4QfsCWthT/vSLirorNXqtg ($52 in chips)
Seat 3: URYNc7fPA23K2UfadQbnCA ($50 in chips)
Seat 4: RowCSpSURHTOL/dcjg/Iug ($85.70 in chips)
Seat 5: 2igtJLmvIZ+HqX4XPgMPZA ($51.20 in chips)
Seat 6: GUnvMULl2qFOO1yenu1UBw ($52.25 in chips)
2igtJLmvIZ+HqX4XPgMPZA: posts small blind $0.25
GUnvMULl2qFOO1yenu1UBw: posts big blind $0.50
L0aIPg7qefDQjdJo3HCVEA: sits out
*** HOLE CARDS ***
4QfsCWthT/vSLirorNXqtg: folds
URYNc7fPA23K2UfadQbnCA: raises $1.50 to $2
RowCSpSURHTOL/dcjg/Iug: folds
2igtJLmvIZ+HqX4XPgMPZA: folds
GUnvMULl2qFOO1yenu1UBw: folds
URYNc7fPA23K2UfadQbnCA collected $1.25 from pot
*** SUMMARY ***
Total pot $1.25 | Rake $0
Seat 2: 4QfsCWthT/vSLirorNXqtg folded before Flop (didn't bet)
Seat 3: URYNc7fPA23K2UfadQbnCA collected ($1.25)
Seat 4: RowCSpSURHTOL/dcjg/Iug (button) folded before Flop (didn't bet)
Seat 5: 2igtJLmvIZ+HqX4XPgMPZA (small blind) folded before Flop
Seat 6: GUnvMULl2qFOO1yenu1UBw (big blind) folded before Flop



PokerStars Game #59941452748:  Hold'em No Limit ($0.25/$0.50) - 2009/07/01 1:35:56 ET
Table '8BQGgNetI1NOvWeu3gtMNw' 2-max Seat #2 is the button
Seat 1: bypIyrYcAAifLfhZpGlKLA ($84 in chips)
Seat 2: Z4HwehErEwzsv/noQlfUlg ($131.10 in chips)
Z4HwehErEwzsv/noQlfUlg: posts small blind $0.25
bypIyrYcAAifLfhZpGlKLA: posts big blind $0.50
*** HOLE CARDS ***
Z4HwehErEwzsv/noQlfUlg: folds
bypIyrYcAAifLfhZpGlKLA collected $0.50 from pot
bypIyrYcAAifLfhZpGlKLA: doesn't show hand
*** SUMMARY ***
Total pot $0.50 | Rake $0
Seat 1: bypIyrYcAAifLfhZpGlKLA (big blind) collected ($0.50)
Seat 2: Z4HwehErEwzsv/noQlfUlg (button) (small blind) folded before Flop



PokerStars Game #59941453014:  Hold'em No Limit ($0.25/$0.50) - 2009/07/01 1:35:56 ET
Table '9ojijpRcYQSQTh6xI+haUA' 2-max Seat #1 is the button
Seat 1: FqpibuVWLNsAN/Z7ROZLnA ($61.50 in chips)
Seat 2: TitTV+fFCcBZWOERdytydA ($64.20 in chips)
FqpibuVWLNsAN/Z7ROZLnA: posts small blind $0.25
TitTV+fFCcBZWOERdytydA: posts big blind $0.50
*** HOLE CARDS ***
FqpibuVWLNsAN/Z7ROZLnA: calls $0.25
TitTV+fFCcBZWOERdytydA: raises $2 to $2.50
FqpibuVWLNsAN/Z7ROZLnA: folds
TitTV+fFCcBZWOERdytydA collected $1 from pot
TitTV+fFCcBZWOERdytydA: doesn't show hand
*** SUMMARY ***
Total pot $1 | Rake $0
Seat 1: FqpibuVWLNsAN/Z7ROZLnA (button) (small blind) folded before Flop
Seat 2: TitTV+fFCcBZWOERdytydA (big blind) collected ($1)



PokerStars Game #59941453530:  Hold'em No Limit ($0.25/$0.50) - 2009/07/01 1:35:57 ET
Table 'Wwfm5/i+g/g2Nj2gT3jnVQ' 2-max Seat #1 is the button
Seat 1: CHRLZDaaxjbo68bwQD1C/Q ($11.40 in chips)
Seat 2: PKuuhUvIr5WSkJyPJa9dFw ($19.10 in chips)
CHRLZDaaxjbo68bwQD1C/Q: posts small blind $0.25
PKuuhUvIr5WSkJyPJa9dFw: posts big blind $0.50
*** HOLE CARDS ***
CHRLZDaaxjbo68bwQD1C/Q: calls $0.25
PKuuhUvIr5WSkJyPJa9dFw: checks
*** FLOP *** [Kd Td 9d]
PKuuhUvIr5WSkJyPJa9dFw: checks
CHRLZDaaxjbo68bwQD1C/Q: bets $1
PKuuhUvIr5WSkJyPJa9dFw: folds
CHRLZDaaxjbo68bwQD1C/Q collected $0.95 from pot
CHRLZDaaxjbo68bwQD1C/Q: doesn't show hand
*** SUMMARY ***
Total pot $1 | Rake $0.05
Board [Kd Td 9d]
Seat 1: CHRLZDaaxjbo68bwQD1C/Q (button) (small blind) collected ($0.95)
Seat 2: PKuuhUvIr5WSkJyPJa9dFw (big blind) folded on the Flop



PokerStars Game #59941454934:  Hold'em No Limit ($0.25/$0.50) - 2009/07/01 1:36:00 ET
Table '1pi9mHyVuXF/uue+aPQc4w' 9-max Seat #6 is the button
Seat 2: vHYT5s323LpajBj+2c9zbQ ($25.90 in chips)
Seat 3: HZkVla4kK2SI42CVrPZ/ig ($10 in chips)
Seat 4: mSD1pginDsyHG5PDfqzphw ($11.80 in chips)
Seat 5: zE9cVigS2nW/Ljy4K4bUQA ($30.65 in chips)
Seat 6: 1xBtrSVBbgFH/viUWKqQeg ($46.70 in chips)
Seat 7: 61sfw5QTu62YYIt68OsdrA ($33.80 in chips)
Seat 8: g4k0NXISyLCqaSWZDBjfEg ($97.80 in chips)
Seat 9: Q/gZC63lfOMr7YhWKPCxoQ ($10.20 in chips)
61sfw5QTu62YYIt68OsdrA: posts small blind $0.25
g4k0NXISyLCqaSWZDBjfEg: posts big blind $0.50
Q/gZC63lfOMr7YhWKPCxoQ: posts big blind $0.50
M+D23GG26WXQ/2gyjREVOQ: sits out
*** HOLE CARDS ***
Q/gZC63lfOMr7YhWKPCxoQ: checks
vHYT5s323LpajBj+2c9zbQ: calls $0.50
HZkVla4kK2SI42CVrPZ/ig has timed out
HZkVla4kK2SI42CVrPZ/ig: folds
HZkVla4kK2SI42CVrPZ/ig is sitting out
HZkVla4kK2SI42CVrPZ/ig has returned
mSD1pginDsyHG5PDfqzphw: raises $1.50 to $2
zE9cVigS2nW/Ljy4K4bUQA: folds
1xBtrSVBbgFH/viUWKqQeg: folds
61sfw5QTu62YYIt68OsdrA: folds
g4k0NXISyLCqaSWZDBjfEg: folds
Q/gZC63lfOMr7YhWKPCxoQ: folds
vHYT5s323LpajBj+2c9zbQ: calls $1.50
*** FLOP *** [8d Ts Qd]
vHYT5s323LpajBj+2c9zbQ: checks
mSD1pginDsyHG5PDfqzphw: checks
*** TURN *** [8d Ts Qd] [As]
vHYT5s323LpajBj+2c9zbQ: checks
mSD1pginDsyHG5PDfqzphw: bets $1
vHYT5s323LpajBj+2c9zbQ: folds
mSD1pginDsyHG5PDfqzphw collected $5 from pot
mSD1pginDsyHG5PDfqzphw: doesn't show hand
*** SUMMARY ***
Total pot $5.25 | Rake $0.25
Board [8d Ts Qd As]
Seat 2: vHYT5s323LpajBj+2c9zbQ folded on the Turn
Seat 3: HZkVla4kK2SI42CVrPZ/ig folded before Flop (didn't bet)
Seat 4: mSD1pginDsyHG5PDfqzphw collected ($5)
Seat 5: zE9cVigS2nW/Ljy4K4bUQA folded before Flop (didn't bet)
Seat 6: 1xBtrSVBbgFH/viUWKqQeg (button) folded before Flop (didn't bet)
Seat 7: 61sfw5QTu62YYIt68OsdrA (small blind) folded before Flop
Seat 8: g4k0NXISyLCqaSWZDBjfEg (big blind) folded before Flop
Seat 9: Q/gZC63lfOMr7YhWKPCxoQ folded before Flop



PokerStars Game #59941457294:  Hold'em No Limit ($0.25/$0.50) - 2009/07/01 1:36:04 ET
Table 'EiNh8p/wGJ1FP575iMFnqg' 9-max Seat #3 is the button
Seat 1: YFFlOZgyy1Mh4iBmuNRbmQ ($17.80 in chips)
Seat 2: GRV8J6o4lVSBDEyjt6BwMg ($30 in chips)
Seat 3: ymLPoEIl7UL3TvZYmnadxQ ($45.25 in chips)
Seat 4: cMzaiXAM/ZAdNaEUu+LqhA ($57.95 in chips)
Seat 5: M+7+BTmX5vZatHVuoRB1nA ($73.20 in chips)
Seat 7: 997ViqAtWn1FPjJqcffwcA ($50 in chips)
Seat 8: mSD1pginDsyHG5PDfqzphw ($10 in chips)
Seat 9: GuPkZObrz5Zkkn8FsEdF9w ($34.60 in chips)
cMzaiXAM/ZAdNaEUu+LqhA: posts small blind $0.25
M+7+BTmX5vZatHVuoRB1nA: posts big blind $0.50
GRV8J6o4lVSBDEyjt6BwMg: posts big blind $0.50
*** HOLE CARDS ***
997ViqAtWn1FPjJqcffwcA: folds
mSD1pginDsyHG5PDfqzphw: folds
GuPkZObrz5Zkkn8FsEdF9w: folds
YFFlOZgyy1Mh4iBmuNRbmQ: calls $0.50
GRV8J6o4lVSBDEyjt6BwMg: checks
ymLPoEIl7UL3TvZYmnadxQ: calls $0.50
cMzaiXAM/ZAdNaEUu+LqhA: folds
M+7+BTmX5vZatHVuoRB1nA: checks
*** FLOP *** [8h Ah 5s]
M+7+BTmX5vZatHVuoRB1nA: bets $1
YFFlOZgyy1Mh4iBmuNRbmQ: folds
GRV8J6o4lVSBDEyjt6BwMg: folds
ymLPoEIl7UL3TvZYmnadxQ: folds
M+7+BTmX5vZatHVuoRB1nA collected $2.15 from pot
M+7+BTmX5vZatHVuoRB1nA: doesn't show hand
*** SUMMARY ***
Total pot $2.25 | Rake $0.10
Board [8h Ah 5s]
Seat 1: YFFlOZgyy1Mh4iBmuNRbmQ folded on the Flop
Seat 2: GRV8J6o4lVSBDEyjt6BwMg folded on the Flop
Seat 3: ymLPoEIl7UL3TvZYmnadxQ (button) folded on the Flop
Seat 4: cMzaiXAM/ZAdNaEUu+LqhA (small blind) folded before Flop
Seat 5: M+7+BTmX5vZatHVuoRB1nA (big blind) collected ($2.15)
Seat 7: 997ViqAtWn1FPjJqcffwcA folded before Flop (didn't bet)
Seat 8: mSD1pginDsyHG5PDfqzphw folded before Flop (didn't bet)
Seat 9: GuPkZObrz5Zkkn8FsEdF9w folded before Flop (didn't bet)



PokerStars Game #59941457506:  Hold'em No Limit ($0.25/$0.50) - 2009/07/01 1:36:05 ET
Table 'cofQFHU7jbJoFecLVBof/w' 6-max Seat #1 is the button
Seat 1: URYNc7fPA23K2UfadQbnCA ($50.75 in chips)
Seat 2: f89uTQr3ieGlusj2IAYAEg ($50 in chips)
Seat 3: v4ctePcLlQw0r8E0qJtjYw ($53.70 in chips)
Seat 4: g6lz8npaeeTJmJegtPYhlQ ($17 in chips)
Seat 5: QvwRlrpVqerRRF8eJm6dDw ($46.65 in chips)
Seat 6: 7+uQ0OOgCTbR4ltkSwyC0g ($159.80 in chips)
f89uTQr3ieGlusj2IAYAEg: posts small blind $0.25
v4ctePcLlQw0r8E0qJtjYw: posts big blind $0.50
*** HOLE CARDS ***
g6lz8npaeeTJmJegtPYhlQ: folds
QvwRlrpVqerRRF8eJm6dDw: folds
7+uQ0OOgCTbR4ltkSwyC0g: raises $1 to $1.50
URYNc7fPA23K2UfadQbnCA: folds
f89uTQr3ieGlusj2IAYAEg: folds
v4ctePcLlQw0r8E0qJtjYw: folds
7+uQ0OOgCTbR4ltkSwyC0g collected $1.25 from pot
*** SUMMARY ***
Total pot $1.25 | Rake $0
Seat 1: URYNc7fPA23K2UfadQbnCA (button) folded before Flop (didn't bet)
Seat 2: f89uTQr3ieGlusj2IAYAEg (small blind) folded before Flop
Seat 3: v4ctePcLlQw0r8E0qJtjYw (big blind) folded before Flop
Seat 4: g6lz8npaeeTJmJegtPYhlQ folded before Flop (didn't bet)
Seat 5: QvwRlrpVqerRRF8eJm6dDw folded before Flop (didn't bet)
Seat 6: 7+uQ0OOgCTbR4ltkSwyC0g collected ($1.25)



PokerStars Game #59941458446:  Hold'em No Limit ($0.25/$0.50) - 2009/07/01 1:36:06 ET
Table 'hSTs/dUsYLgJQuF2Onp0MQ' 6-max Seat #2 is the button
Seat 1: 1WUCqNG+p+vfWRTXNu4ljw ($50.75 in chips)
Seat 2: Hdd4js36ITbTJ/QuVYwTlA ($113.75 in chips)
Seat 3: lxIzoHy0RnkfFSODHC2liw ($50 in chips)
Seat 4: 2igtJLmvIZ+HqX4XPgMPZA ($50 in chips)
Seat 5: FsRQ5ECdlLkLYI5le8+PDQ ($49.25 in chips)
Seat 6: M1KyQQvVPVuxqTAB8sR/zQ ($91.55 in chips)
lxIzoHy0RnkfFSODHC2liw: posts small blind $0.25
2igtJLmvIZ+HqX4XPgMPZA: posts big blind $0.50
*** HOLE CARDS ***
FsRQ5ECdlLkLYI5le8+PDQ: folds
M1KyQQvVPVuxqTAB8sR/zQ: raises $1 to $1.50
1WUCqNG+p+vfWRTXNu4ljw: folds
Hdd4js36ITbTJ/QuVYwTlA: calls $1.50
lxIzoHy0RnkfFSODHC2liw: folds
2igtJLmvIZ+HqX4XPgMPZA: folds
*** FLOP *** [7c Js 6s]
M1KyQQvVPVuxqTAB8sR/zQ: bets $3
Hdd4js36ITbTJ/QuVYwTlA: calls $3
*** TURN *** [7c Js 6s] [3s]
M1KyQQvVPVuxqTAB8sR/zQ: bets $7
Hdd4js36ITbTJ/QuVYwTlA: calls $7
*** RIVER *** [7c Js 6s 3s] [9d]
M1KyQQvVPVuxqTAB8sR/zQ: checks
Hdd4js36ITbTJ/QuVYwTlA: checks
*** SHOW DOWN ***
M1KyQQvVPVuxqTAB8sR/zQ: shows [Qc Qs] (a pair of Queens)
Hdd4js36ITbTJ/QuVYwTlA: mucks hand
M1KyQQvVPVuxqTAB8sR/zQ collected $22.60 from pot
*** SUMMARY ***
Total pot $23.75 | Rake $1.15
Board [7c Js 6s 3s 9d]
Seat 1: 1WUCqNG+p+vfWRTXNu4ljw folded before Flop (didn't bet)
Seat 2: Hdd4js36ITbTJ/QuVYwTlA (button) mucked
Seat 3: lxIzoHy0RnkfFSODHC2liw (small blind) folded before Flop
Seat 4: 2igtJLmvIZ+HqX4XPgMPZA (big blind) folded before Flop
Seat 5: FsRQ5ECdlLkLYI5le8+PDQ folded before Flop (didn't bet)
Seat 6: M1KyQQvVPVuxqTAB8sR/zQ showed [Qc Qs] and won ($22.60) with a pair of Queens



PokerStars Game #59941459902:  Hold'em No Limit ($0.25/$0.50) - 2009/07/01 1:36:09 ET
Table '+dXkOAQyS8j9PQZusUTMpg' 2-max Seat #1 is the button
Seat 1: Teld4PDKla7C8/Wfu2DSkg ($52.75 in chips)
Seat 2: +zI4bP23YIjMkUHqeN2xfw ($22.40 in chips)
Teld4PDKla7C8/Wfu2DSkg: posts small blind $0.25
+zI4bP23YIjMkUHqeN2xfw: posts big blind $0.50
*** HOLE CARDS ***
Teld4PDKla7C8/Wfu2DSkg: raises $0.50 to $1
+zI4bP23YIjMkUHqeN2xfw: calls $0.50
*** FLOP *** [8s 4c Kh]
+zI4bP23YIjMkUHqeN2xfw: bets $1
Teld4PDKla7C8/Wfu2DSkg: calls $1
*** TURN *** [8s 4c Kh] [Ad]
+zI4bP23YIjMkUHqeN2xfw: checks
Teld4PDKla7C8/Wfu2DSkg: bets $3.50
+zI4bP23YIjMkUHqeN2xfw: folds
+zI4bP23YIjMkUHqeN2xfw is sitting out
Teld4PDKla7C8/Wfu2DSkg collected $3.85 from pot
*** SUMMARY ***
Total pot $4 | Rake $0.15
Board [8s 4c Kh Ad]
Seat 1: Teld4PDKla7C8/Wfu2DSkg (button) (small blind) collected ($3.85)
Seat 2: +zI4bP23YIjMkUHqeN2xfw (big blind) folded on the Turn



PokerStars Game #59941460058:  Hold'em No Limit ($0.25/$0.50) - 2009/07/01 1:36:09 ET
Table '3FhG0gl3kMX3wBEEqj+wnQ' 9-max Seat #3 is the button
Seat 1: bxLSulbgr8LmKNjOzw8URg ($50.50 in chips)
Seat 3: YXCE3WOZi8g2sIf3y/plVw ($61.55 in chips)
Seat 4: e2+sK/yjnj94rXOKoxPP2A ($69 in chips)
Seat 5: XcLXSUMHSpshK/7Lh0M4Vg ($11.05 in chips)
Seat 6: 997ViqAtWn1FPjJqcffwcA ($109.80 in chips)
Seat 7: mSD1pginDsyHG5PDfqzphw ($10 in chips)
Seat 8: j3K/Jujr7PY4ZM2RZvlH6A ($58.35 in chips)
Seat 9: KA0tkubTlbhmo4ju+qgXPg ($45.10 in chips)
e2+sK/yjnj94rXOKoxPP2A: posts small blind $0.25
XcLXSUMHSpshK/7Lh0M4Vg: posts big blind $0.50
KA0tkubTlbhmo4ju+qgXPg: posts small & big blinds $0.75
HZkVla4kK2SI42CVrPZ/ig: sits out
*** HOLE CARDS ***
997ViqAtWn1FPjJqcffwcA: folds
mSD1pginDsyHG5PDfqzphw: raises $1.50 to $2
j3K/Jujr7PY4ZM2RZvlH6A: raises $3.50 to $5.50
KA0tkubTlbhmo4ju+qgXPg: folds
bxLSulbgr8LmKNjOzw8URg: folds
YXCE3WOZi8g2sIf3y/plVw: folds
e2+sK/yjnj94rXOKoxPP2A: folds
XcLXSUMHSpshK/7Lh0M4Vg: folds
mSD1pginDsyHG5PDfqzphw: raises $4.50 to $10 and is all-in
j3K/Jujr7PY4ZM2RZvlH6A: calls $4.50
*** FLOP *** [Ts Js Tc]
*** TURN *** [Ts Js Tc] [Kh]
*** RIVER *** [Ts Js Tc Kh] [Jd]
*** SHOW DOWN ***
mSD1pginDsyHG5PDfqzphw: shows [Kd Ah] (two pair, Kings and Jacks)
j3K/Jujr7PY4ZM2RZvlH6A: mucks hand
mSD1pginDsyHG5PDfqzphw collected $20.45 from pot
*** SUMMARY ***
Total pot $21.50 | Rake $1.05
Board [Ts Js Tc Kh Jd]
Seat 1: bxLSulbgr8LmKNjOzw8URg folded before Flop (didn't bet)
Seat 3: YXCE3WOZi8g2sIf3y/plVw (button) folded before Flop (didn't bet)
Seat 4: e2+sK/yjnj94rXOKoxPP2A (small blind) folded before Flop
Seat 5: XcLXSUMHSpshK/7Lh0M4Vg (big blind) folded before Flop
Seat 6: 997ViqAtWn1FPjJqcffwcA folded before Flop (didn't bet)
Seat 7: mSD1pginDsyHG5PDfqzphw showed [Kd Ah] and won ($20.45) with two pair, Kings and Jacks
Seat 8: j3K/Jujr7PY4ZM2RZvlH6A mucked
Seat 9: KA0tkubTlbhmo4ju+qgXPg folded before Flop



PokerStars Game #59941460866:  Hold'em No Limit ($0.25/$0.50) - 2009/07/01 1:36:11 ET
Table '5qf8oPyYje71HBKD0FwPgQ' 9-max Seat #3 is the button
Seat 2: M+7+BTmX5vZatHVuoRB1nA ($57.65 in chips)
Seat 3: vacmVLJJECYI6HjAynFcpg ($56.95 in chips)
Seat 4: YXCE3WOZi8g2sIf3y/plVw ($54.10 in chips)
Seat 5: uo2Sgpknd7NdeVbeSCG02A ($16.70 in chips)
Seat 6: go0Ad6tqqJ4tR9/bqVlO0g ($19.60 in chips)
Seat 7: 1q5EPoiflJRl8pqfnVLjMw ($52.75 in chips)
Seat 8: sakr/FIfFtIZwDPmAj5Pzg ($59.10 in chips)
Seat 9: jWDRpL0TJljg+mBCE9ZMqA ($7.85 in chips)
YXCE3WOZi8g2sIf3y/plVw: posts small blind $0.25
uo2Sgpknd7NdeVbeSCG02A: posts big blind $0.50
*** HOLE CARDS ***
go0Ad6tqqJ4tR9/bqVlO0g: folds
1q5EPoiflJRl8pqfnVLjMw: calls $0.50
sakr/FIfFtIZwDPmAj5Pzg: folds
jWDRpL0TJljg+mBCE9ZMqA: folds
M+7+BTmX5vZatHVuoRB1nA: calls $0.50
vacmVLJJECYI6HjAynFcpg: folds
YXCE3WOZi8g2sIf3y/plVw: folds
uo2Sgpknd7NdeVbeSCG02A: checks
*** FLOP *** [Kh 8c Ac]
uo2Sgpknd7NdeVbeSCG02A: checks
1q5EPoiflJRl8pqfnVLjMw: checks
M+7+BTmX5vZatHVuoRB1nA: bets $1
uo2Sgpknd7NdeVbeSCG02A: folds
1q5EPoiflJRl8pqfnVLjMw: calls $1
*** TURN *** [Kh 8c Ac] [5d]
1q5EPoiflJRl8pqfnVLjMw: checks
gsyXT42WLEcOS4DdEk2wlw joins the table at seat #1
M+7+BTmX5vZatHVuoRB1nA: checks
*** RIVER *** [Kh 8c Ac 5d] [4h]
1q5EPoiflJRl8pqfnVLjMw: bets $3
M+7+BTmX5vZatHVuoRB1nA: calls $3
*** SHOW DOWN ***
1q5EPoiflJRl8pqfnVLjMw: shows [8d 8h] (three of a kind, Eights)
M+7+BTmX5vZatHVuoRB1nA: mucks hand
1q5EPoiflJRl8pqfnVLjMw collected $9.30 from pot
*** SUMMARY ***
Total pot $9.75 | Rake $0.45
Board [Kh 8c Ac 5d 4h]
Seat 2: M+7+BTmX5vZatHVuoRB1nA mucked
Seat 3: vacmVLJJECYI6HjAynFcpg (button) folded before Flop (didn't bet)
Seat 4: YXCE3WOZi8g2sIf3y/plVw (small blind) folded before Flop
Seat 5: uo2Sgpknd7NdeVbeSCG02A (big blind) folded on the Flop
Seat 6: go0Ad6tqqJ4tR9/bqVlO0g folded before Flop (didn't bet)
Seat 7: 1q5EPoiflJRl8pqfnVLjMw showed [8d 8h] and won ($9.30) with three of a kind, Eights
Seat 8: sakr/FIfFtIZwDPmAj5Pzg folded before Flop (didn't bet)
Seat 9: jWDRpL0TJljg+mBCE9ZMqA folded before Flop (didn't bet)



PokerStars Game #59941461262:  Hold'em No Limit ($0.25/$0.50) - 2009/07/01 1:36:11 ET
Table '8BQGgNetI1NOvWeu3gtMNw' 2-max Seat #1 is the button
Seat 1: bypIyrYcAAifLfhZpGlKLA ($84.25 in chips)
Seat 2: Z4HwehErEwzsv/noQlfUlg ($130.85 in chips)
bypIyrYcAAifLfhZpGlKLA: posts small blind $0.25
Z4HwehErEwzsv/noQlfUlg: posts big blind $0.50
*** HOLE CARDS ***
bypIyrYcAAifLfhZpGlKLA: raises $1 to $1.50
Z4HwehErEwzsv/noQlfUlg: raises $1 to $2.50
bypIyrYcAAifLfhZpGlKLA: calls $1
*** FLOP *** [6d 7s 3c]
Z4HwehErEwzsv/noQlfUlg: bets $5
bypIyrYcAAifLfhZpGlKLA: calls $5
*** TURN *** [6d 7s 3c] [Ad]
Z4HwehErEwzsv/noQlfUlg: bets $15
bypIyrYcAAifLfhZpGlKLA: calls $15
*** RIVER *** [6d 7s 3c Ad] [5s]
Z4HwehErEwzsv/noQlfUlg: bets $62
bypIyrYcAAifLfhZpGlKLA: folds
Z4HwehErEwzsv/noQlfUlg collected $44.50 from pot
Z4HwehErEwzsv/noQlfUlg: doesn't show hand
*** SUMMARY ***
Total pot $45 | Rake $0.50
Board [6d 7s 3c Ad 5s]
Seat 1: bypIyrYcAAifLfhZpGlKLA (button) (small blind) folded on the River
Seat 2: Z4HwehErEwzsv/noQlfUlg (big blind) collected ($44.50)



PokerStars Game #59941460786:  Hold'em No Limit ($0.25/$0.50) - 2009/07/01 1:36:11 ET
Table 'Wwfm5/i+g/g2Nj2gT3jnVQ' 2-max Seat #2 is the button
Seat 1: CHRLZDaaxjbo68bwQD1C/Q ($11.85 in chips)
Seat 2: PKuuhUvIr5WSkJyPJa9dFw ($18.60 in chips)
PKuuhUvIr5WSkJyPJa9dFw: posts small blind $0.25
CHRLZDaaxjbo68bwQD1C/Q: posts big blind $0.50
*** HOLE CARDS ***
PKuuhUvIr5WSkJyPJa9dFw: calls $0.25
CHRLZDaaxjbo68bwQD1C/Q: checks
*** FLOP *** [Qh 5s Qs]
CHRLZDaaxjbo68bwQD1C/Q: checks
PKuuhUvIr5WSkJyPJa9dFw: checks
*** TURN *** [Qh 5s Qs] [7h]
CHRLZDaaxjbo68bwQD1C/Q: checks
PKuuhUvIr5WSkJyPJa9dFw: checks
*** RIVER *** [Qh 5s Qs 7h] [9s]
CHRLZDaaxjbo68bwQD1C/Q: checks
PKuuhUvIr5WSkJyPJa9dFw: checks
*** SHOW DOWN ***
CHRLZDaaxjbo68bwQD1C/Q: shows [Ts 2d] (a pair of Queens)
PKuuhUvIr5WSkJyPJa9dFw: shows [6c Kh] (a pair of Queens - King kicker)
PKuuhUvIr5WSkJyPJa9dFw collected $0.95 from pot
*** SUMMARY ***
Total pot $1 | Rake $0.05
Board [Qh 5s Qs 7h 9s]
Seat 1: CHRLZDaaxjbo68bwQD1C/Q (big blind) showed [Ts 2d] and lost with a pair of Queens
Seat 2: PKuuhUvIr5WSkJyPJa9dFw (button) (small blind) showed [6c Kh] and won ($0.95) with a pair of Queens



PokerStars Game #59941461422:  Hold'em No Limit ($0.25/$0.50) - 2009/07/01 1:36:12 ET
Table '9ojijpRcYQSQTh6xI+haUA' 2-max Seat #2 is the button
Seat 1: FqpibuVWLNsAN/Z7ROZLnA ($61 in chips)
Seat 2: TitTV+fFCcBZWOERdytydA ($64.70 in chips)
TitTV+fFCcBZWOERdytydA: posts small blind $0.25
FqpibuVWLNsAN/Z7ROZLnA: posts big blind $0.50
*** HOLE CARDS ***
TitTV+fFCcBZWOERdytydA: folds
FqpibuVWLNsAN/Z7ROZLnA collected $0.50 from pot
*** SUMMARY ***
Total pot $0.50 | Rake $0
Seat 1: FqpibuVWLNsAN/Z7ROZLnA (big blind) collected ($0.50)
Seat 2: TitTV+fFCcBZWOERdytydA (button) (small blind) folded before Flop



PokerStars Game #59941462198:  Hold'em No Limit ($0.25/$0.50) - 2009/07/01 1:36:13 ET
Table 'hWT2kq66tnKEpD26cia6fQ' 2-max Seat #2 is the button
Seat 1: Ce3KNFP+ao7Da9NHb65raw ($29.20 in chips)
Seat 2: 16tvT7AYgZ2LgiGFcvFKQg ($45.55 in chips)
16tvT7AYgZ2LgiGFcvFKQg: posts small blind $0.25
Ce3KNFP+ao7Da9NHb65raw: posts big blind $0.50
*** HOLE CARDS ***
16tvT7AYgZ2LgiGFcvFKQg: calls $0.25
Ce3KNFP+ao7Da9NHb65raw: checks
*** FLOP *** [6h Kh 9c]
Ce3KNFP+ao7Da9NHb65raw: checks
16tvT7AYgZ2LgiGFcvFKQg: checks
*** TURN *** [6h Kh 9c] [Jd]
Ce3KNFP+ao7Da9NHb65raw: checks
16tvT7AYgZ2LgiGFcvFKQg: checks
*** RIVER *** [6h Kh 9c Jd] [4h]
Ce3KNFP+ao7Da9NHb65raw: checks
16tvT7AYgZ2LgiGFcvFKQg: checks
*** SHOW DOWN ***
Ce3KNFP+ao7Da9NHb65raw: shows [2d As] (high card Ace)
16tvT7AYgZ2LgiGFcvFKQg: mucks hand
Ce3KNFP+ao7Da9NHb65raw collected $0.95 from pot
*** SUMMARY ***
Total pot $1 | Rake $0.05
Board [6h Kh 9c Jd 4h]
Seat 1: Ce3KNFP+ao7Da9NHb65raw (big blind) showed [2d As] and won ($0.95) with high card Ace
Seat 2: 16tvT7AYgZ2LgiGFcvFKQg (button) (small blind) mucked



PokerStars Game #59941461966:  Hold'em No Limit ($0.25/$0.50) - 2009/07/01 1:36:13 ET
Table 'B+sqsfj6d6zXicNfaseTaw' 2-max Seat #1 is the button
Seat 1: +4GNcSsecmapVGSdV0mUPA ($162.90 in chips)
Seat 2: Lv5RmpRe6LtPkBzM9Gpo5A ($59.40 in chips)
+4GNcSsecmapVGSdV0mUPA: posts small blind $0.25
Lv5RmpRe6LtPkBzM9Gpo5A: posts big blind $0.50
*** HOLE CARDS ***
+4GNcSsecmapVGSdV0mUPA: calls $0.25
Lv5RmpRe6LtPkBzM9Gpo5A: checks
*** FLOP *** [Qd Ks 6c]
Lv5RmpRe6LtPkBzM9Gpo5A: checks
+4GNcSsecmapVGSdV0mUPA: bets $1
Lv5RmpRe6LtPkBzM9Gpo5A: calls $1
*** TURN *** [Qd Ks 6c] [2c]
Lv5RmpRe6LtPkBzM9Gpo5A: checks
+4GNcSsecmapVGSdV0mUPA: bets $1
Lv5RmpRe6LtPkBzM9Gpo5A: calls $1
*** RIVER *** [Qd Ks 6c 2c] [Ah]
Lv5RmpRe6LtPkBzM9Gpo5A: checks
+4GNcSsecmapVGSdV0mUPA: checks
*** SHOW DOWN ***
Lv5RmpRe6LtPkBzM9Gpo5A: shows [Td Jh] (a straight, Ten to Ace)
+4GNcSsecmapVGSdV0mUPA: mucks hand
Lv5RmpRe6LtPkBzM9Gpo5A collected $4.80 from pot
*** SUMMARY ***
Total pot $5 | Rake $0.20
Board [Qd Ks 6c 2c Ah]
Seat 1: +4GNcSsecmapVGSdV0mUPA (button) (small blind) mucked
Seat 2: Lv5RmpRe6LtPkBzM9Gpo5A (big blind) showed [Td Jh] and won ($4.80) with a straight, Ten to Ace



PokerStars Game #59941463174:  Hold'em No Limit ($0.25/$0.50) - 2009/07/01 1:36:15 ET
Table 'ZYI3ZReBjdfKEYItkZHI6A' 9-max Seat #1 is the button
Seat 1: IYd5zG8k7vdBNVHbHg2Pag ($62.90 in chips)
Seat 2: 5acK4E7fzEwnplVBZ6eNWA ($50 in chips)
Seat 3: 75K2MXwN65Sjfp1yHd50Hg ($9.25 in chips)
Seat 5: ApHP7ouup365XIUFBdEDxg ($17.75 in chips)
Seat 6: 1xBtrSVBbgFH/viUWKqQeg ($20.75 in chips)
Seat 7: HWcfp1hY1hqvrddzW3/FQw ($21.30 in chips)
Seat 8: ji04uOybxCdpdefzlUQeKQ ($29.55 in chips)
Seat 9: HZkVla4kK2SI42CVrPZ/ig ($10.40 in chips)
5acK4E7fzEwnplVBZ6eNWA: posts small blind $0.25
75K2MXwN65Sjfp1yHd50Hg: posts big blind $0.50
/UdtxmXsFx6K/14AbHqzbQ: sits out
*** HOLE CARDS ***
ApHP7ouup365XIUFBdEDxg: folds
1xBtrSVBbgFH/viUWKqQeg: raises $1 to $1.50
HWcfp1hY1hqvrddzW3/FQw: folds
ji04uOybxCdpdefzlUQeKQ: folds
HZkVla4kK2SI42CVrPZ/ig: folds
IYd5zG8k7vdBNVHbHg2Pag: folds
5acK4E7fzEwnplVBZ6eNWA: folds
75K2MXwN65Sjfp1yHd50Hg: folds
1xBtrSVBbgFH/viUWKqQeg collected $1.25 from pot
*** SUMMARY ***
Total pot $1.25 | Rake $0
Seat 1: IYd5zG8k7vdBNVHbHg2Pag (button) folded before Flop (didn't bet)
Seat 2: 5acK4E7fzEwnplVBZ6eNWA (small blind) folded before Flop
Seat 3: 75K2MXwN65Sjfp1yHd50Hg (big blind) folded before Flop
Seat 5: ApHP7ouup365XIUFBdEDxg folded before Flop (didn't bet)
Seat 6: 1xBtrSVBbgFH/viUWKqQeg collected ($1.25)
Seat 7: HWcfp1hY1hqvrddzW3/FQw folded before Flop (didn't bet)
Seat 8: ji04uOybxCdpdefzlUQeKQ folded before Flop (didn't bet)
Seat 9: HZkVla4kK2SI42CVrPZ/ig folded before Flop (didn't bet)



PokerStars Game #59941464480:  Hold'em No Limit ($0.25/$0.50) - 2009/07/01 1:36:17 ET
Table 'tyR5AZNKV8Aadbrnrnlg7g' 6-max Seat #2 is the button
Seat 1: BgOXYI0yYSN1ULC4FqsNkg ($68.95 in chips)
Seat 2: BAjwVL+zKKd0s0fAWstzQQ ($14.80 in chips)
Seat 3: JFLrYNyQmwPhRQAtoSAuyA ($61.10 in chips)
Seat 4: 4QfsCWthT/vSLirorNXqtg ($85.70 in chips)
Seat 5: GUnvMULl2qFOO1yenu1UBw ($87.60 in chips)
Seat 6: 498aWaGsW4uGfuWl+2FCGw ($64.65 in chips)
JFLrYNyQmwPhRQAtoSAuyA: posts small blind $0.25
4QfsCWthT/vSLirorNXqtg: posts big blind $0.50
*** HOLE CARDS ***
GUnvMULl2qFOO1yenu1UBw: raises $1.50 to $2
498aWaGsW4uGfuWl+2FCGw: folds
BgOXYI0yYSN1ULC4FqsNkg: raises $4.50 to $6.50
BAjwVL+zKKd0s0fAWstzQQ: folds
JFLrYNyQmwPhRQAtoSAuyA: folds
4QfsCWthT/vSLirorNXqtg: folds
GUnvMULl2qFOO1yenu1UBw: calls $4.50
*** FLOP *** [8d As 7h]
GUnvMULl2qFOO1yenu1UBw: checks
BgOXYI0yYSN1ULC4FqsNkg: bets $11
GUnvMULl2qFOO1yenu1UBw: folds
BgOXYI0yYSN1ULC4FqsNkg collected $13.10 from pot
*** SUMMARY ***
Total pot $13.75 | Rake $0.65
Board [8d As 7h]
Seat 1: BgOXYI0yYSN1ULC4FqsNkg collected ($13.10)
Seat 2: BAjwVL+zKKd0s0fAWstzQQ (button) folded before Flop (didn't bet)
Seat 3: JFLrYNyQmwPhRQAtoSAuyA (small blind) folded before Flop
Seat 4: 4QfsCWthT/vSLirorNXqtg (big blind) folded before Flop
Seat 5: GUnvMULl2qFOO1yenu1UBw folded on the Flop
Seat 6: 498aWaGsW4uGfuWl+2FCGw folded before Flop (didn't bet)



PokerStars Game #59941464720:  Hold'em No Limit ($0.25/$0.50) - 2009/07/01 1:36:18 ET
Table '+z1aekfHkpp09pc8F9aViw' 6-max Seat #5 is the button
Seat 1: L0aIPg7qefDQjdJo3HCVEA ($10 in chips)
Seat 2: 4QfsCWthT/vSLirorNXqtg ($52 in chips)
Seat 3: URYNc7fPA23K2UfadQbnCA ($50.75 in chips)
Seat 4: RowCSpSURHTOL/dcjg/Iug ($85.70 in chips)
Seat 5: 2igtJLmvIZ+HqX4XPgMPZA ($50.95 in chips)
Seat 6: GUnvMULl2qFOO1yenu1UBw ($51.75 in chips)
GUnvMULl2qFOO1yenu1UBw: posts small blind $0.25
L0aIPg7qefDQjdJo3HCVEA: posts big blind $0.50
*** HOLE CARDS ***
4QfsCWthT/vSLirorNXqtg: folds
URYNc7fPA23K2UfadQbnCA: folds
RowCSpSURHTOL/dcjg/Iug: folds
2igtJLmvIZ+HqX4XPgMPZA: folds
GUnvMULl2qFOO1yenu1UBw: folds
L0aIPg7qefDQjdJo3HCVEA collected $0.50 from pot
*** SUMMARY ***
Total pot $0.50 | Rake $0
Seat 1: L0aIPg7qefDQjdJo3HCVEA (big blind) collected ($0.50)
Seat 2: 4QfsCWthT/vSLirorNXqtg folded before Flop (didn't bet)
Seat 3: URYNc7fPA23K2UfadQbnCA folded before Flop (didn't bet)
Seat 4: RowCSpSURHTOL/dcjg/Iug folded before Flop (didn't bet)
Seat 5: 2igtJLmvIZ+HqX4XPgMPZA (button) folded before Flop (didn't bet)
Seat 6: GUnvMULl2qFOO1yenu1UBw (small blind) folded before Flop



PokerStars Game #59941464788:  Hold'em No Limit ($0.25/$0.50) - 2009/07/01 1:36:18 ET
Table 'fx6MqwfYAj/Rt86hBz2L3Q' 9-max Seat #7 is the button
Seat 1: v/4aX0ejnaIFK4ftDk2Lyg ($50.65 in chips)
Seat 2: C3rGXblctNcWI6JYPHhaEg ($58.50 in chips)
Seat 3: iadBi5AEt7gTBXbDSSnMYQ ($39.85 in chips)
Seat 4: VhjwWfxHSx00WxzYih3KOA ($50 in chips)
Seat 6: 5k9fvXD9suIgCxU4HLQjTw ($50 in chips)
Seat 7: mSD1pginDsyHG5PDfqzphw ($11.50 in chips)
Seat 8: 75K2MXwN65Sjfp1yHd50Hg ($12.50 in chips)
75K2MXwN65Sjfp1yHd50Hg: posts small blind $0.25
vO3QVRovWemcGMkm7ijAIA: is sitting out
v/4aX0ejnaIFK4ftDk2Lyg: posts big blind $0.50
e2+sK/yjnj94rXOKoxPP2A: sits out
*** HOLE CARDS ***
C3rGXblctNcWI6JYPHhaEg: calls $0.50
iadBi5AEt7gTBXbDSSnMYQ: calls $0.50
VhjwWfxHSx00WxzYih3KOA: folds
vO3QVRovWemcGMkm7ijAIA leaves the table
5k9fvXD9suIgCxU4HLQjTw: folds
mSD1pginDsyHG5PDfqzphw: folds
75K2MXwN65Sjfp1yHd50Hg: folds
v/4aX0ejnaIFK4ftDk2Lyg: checks
*** FLOP *** [Ah 8d 9d]
v/4aX0ejnaIFK4ftDk2Lyg: checks
Alf.STG joins the table at seat #9
C3rGXblctNcWI6JYPHhaEg: bets $0.50
iadBi5AEt7gTBXbDSSnMYQ: raises $1 to $1.50
v/4aX0ejnaIFK4ftDk2Lyg: folds
C3rGXblctNcWI6JYPHhaEg: calls $1
*** TURN *** [Ah 8d 9d] [Kc]
C3rGXblctNcWI6JYPHhaEg: checks
iadBi5AEt7gTBXbDSSnMYQ: checks
*** RIVER *** [Ah 8d 9d Kc] [4d]
C3rGXblctNcWI6JYPHhaEg: bets $1.50
iadBi5AEt7gTBXbDSSnMYQ: raises $3 to $4.50
C3rGXblctNcWI6JYPHhaEg: folds
iadBi5AEt7gTBXbDSSnMYQ collected $7.40 from pot
iadBi5AEt7gTBXbDSSnMYQ: doesn't show hand
*** SUMMARY ***
Total pot $7.75 | Rake $0.35
Board [Ah 8d 9d Kc 4d]
Seat 1: v/4aX0ejnaIFK4ftDk2Lyg (big blind) folded on the Flop
Seat 2: C3rGXblctNcWI6JYPHhaEg folded on the River
Seat 3: iadBi5AEt7gTBXbDSSnMYQ collected ($7.40)
Seat 4: VhjwWfxHSx00WxzYih3KOA folded before Flop (didn't bet)
Seat 6: 5k9fvXD9suIgCxU4HLQjTw folded before Flop (didn't bet)
Seat 7: mSD1pginDsyHG5PDfqzphw (button) folded before Flop (didn't bet)
Seat 8: 75K2MXwN65Sjfp1yHd50Hg (small blind) folded before Flop



PokerStars Game #59941464662:  Hold'em No Limit ($0.25/$0.50) - 2009/07/01 1:36:18 ET
Table 'ofnd8S4IdIPph1Cbn+x7hAbR5MkGhKEbz+X2bpfpu11Qmax Seat #1 is the button
Seat 1: qG3y+yB3IhWjAWO8gvk6Rg ($45.05 in chips)
Seat 2: 1xBtrSVBbgFH/viUWKqQeg ($29.45 in chips)
Seat 3: UVJbBPbDwNMEZadZB9WVmg ($9.50 in chips)
Seat 4: mZNMJI1mY40XTC0U7GZakA ($62.45 in chips)
Seat 5: 2YaCb/8u1SesrR+963XiZA ($10 in chips)
Seat 7: kJ06FP2Jc7cSdmywwvYOXw ($63.35 in chips)
Seat 8: R354x4oZnQcGCDV6GhjnpQ ($65.30 in chips)
Seat 9: 75K2MXwN65Sjfp1yHd50Hg ($10 in chips)
1xBtrSVBbgFH/viUWKqQeg: posts small blind $0.25
UVJbBPbDwNMEZadZB9WVmg: posts big blind $0.50
*** HOLE CARDS ***
mZNMJI1mY40XTC0U7GZakA: folds
2YaCb/8u1SesrR+963XiZA: folds
kJ06FP2Jc7cSdmywwvYOXw: folds
0Bw1Gb5YC/Xvb0SqVawKUw has returned
R354x4oZnQcGCDV6GhjnpQ: folds
75K2MXwN65Sjfp1yHd50Hg: folds
qG3y+yB3IhWjAWO8gvk6Rg: folds
1xBtrSVBbgFH/viUWKqQeg: raises $1 to $1.50
UVJbBPbDwNMEZadZB9WVmg: calls $1
*** FLOP *** [Js 3c 4h]
1xBtrSVBbgFH/viUWKqQeg: checks
UVJbBPbDwNMEZadZB9WVmg: bets $8 and is all-in
1xBtrSVBbgFH/viUWKqQeg: calls $8
*** TURN *** [Js 3c 4h] [7s]
*** RIVER *** [Js 3c 4h 7s] [4s]
*** SHOW DOWN ***
1xBtrSVBbgFH/viUWKqQeg: shows [Qs Qh] (two pair, Queens and Fours)
UVJbBPbDwNMEZadZB9WVmg: mucks hand
1xBtrSVBbgFH/viUWKqQeg collected $18.10 from pot
*** SUMMARY ***
Total pot $19 | Rake $0.90
Board [Js 3c 4h 7s 4s]
Seat 1: qG3y+yB3IhWjAWO8gvk6Rg (button) folded before Flop (didn't bet)
Seat 2: 1xBtrSVBbgFH/viUWKqQeg (small blind) showed [Qs Qh] and won ($18.10) with two pair, Queens and Fours
Seat 3: UVJbBPbDwNMEZadZB9WVmg (big blind) mucked
Seat 4: mZNMJI1mY40XTC0U7GZakA folded before Flop (didn't bet)
Seat 5: 2YaCb/8u1SesrR+963XiZA folded before Flop (didn't bet)
Seat 7: kJ06FP2Jc7cSdmywwvYOXw folded before Flop (didn't bet)
Seat 8: R354x4oZnQcGCDV6GhjnpQ folded before Flop (didn't bet)
Seat 9: 75K2MXwN65Sjfp1yHd50Hg folded before Flop (didn't bet)



PokerStars Game #59941466124:  Hold'em No Limit ($0.25/$0.50) - 2009/07/01 1:36:20 ET
Table 'ibNfFy0bCzuBaUORla0aGw' 9-max Seat #1 is the button
Seat 1: xZCXQSXlrZkp3pZizzVXCw ($49.25 in chips)
Seat 2: 90Wb75h3W1BRpbqVnuk8gw ($52.05 in chips)
Seat 3: AjV5McH1KMMclY26QdLM5w ($25.25 in chips)
Seat 4: nhDtFZ2uuvm5hDKG7ZVEpA ($61.05 in chips)
Seat 6: H8cPaCtX7d6meGUVSM5sxw ($44.35 in chips)
Seat 7: HZkVla4kK2SI42CVrPZ/ig ($16.95 in chips)
Seat 8: Ja2jdidjip2UeJnRzmzAAQ ($47 in chips)
Seat 9: pFtzb1sR4b0d1aw6aIRgDg ($55.40 in chips)
90Wb75h3W1BRpbqVnuk8gw: posts small blind $0.25
AjV5McH1KMMclY26QdLM5w: posts big blind $0.50
*** HOLE CARDS ***
nhDtFZ2uuvm5hDKG7ZVEpA: folds
H8cPaCtX7d6meGUVSM5sxw: folds
nhDtFZ2uuvm5hDKG7ZVEpA leaves the table
HZkVla4kK2SI42CVrPZ/ig: folds
Ja2jdidjip2UeJnRzmzAAQ: raises $1 to $1.50
pFtzb1sR4b0d1aw6aIRgDg: folds
xZCXQSXlrZkp3pZizzVXCw: folds
90Wb75h3W1BRpbqVnuk8gw: folds
AjV5McH1KMMclY26QdLM5w: folds
Ja2jdidjip2UeJnRzmzAAQ collected $1.25 from pot
*** SUMMARY ***
Total pot $1.25 | Rake $0
Seat 1: xZCXQSXlrZkp3pZizzVXCw (button) folded before Flop (didn't bet)
Seat 2: 90Wb75h3W1BRpbqVnuk8gw (small blind) folded before Flop
Seat 3: AjV5McH1KMMclY26QdLM5w (big blind) folded before Flop
Seat 4: nhDtFZ2uuvm5hDKG7ZVEpA folded before Flop (didn't bet)
Seat 6: H8cPaCtX7d6meGUVSM5sxw folded before Flop (didn't bet)
Seat 7: HZkVla4kK2SI42CVrPZ/ig folded before Flop (didn't bet)
Seat 8: Ja2jdidjip2UeJnRzmzAAQ collected ($1.25)
Seat 9: pFtzb1sR4b0d1aw6aIRgDg folded before Flop (didn't bet)



PokerStars Game #59941467384:  Hold'em No Limit ($0.25/$0.50) - 2009/07/01 1:36:23 ET
Table '9ojijpRcYQSQTh6xI+haUA' 2-max Seat #1 is the button
Seat 1: FqpibuVWLNsAN/Z7ROZLnA ($61.25 in chips)
Seat 2: TitTV+fFCcBZWOERdytydA ($64.45 in chips)
FqpibuVWLNsAN/Z7ROZLnA: posts small blind $0.25
TitTV+fFCcBZWOERdytydA: posts big blind $0.50
*** HOLE CARDS ***
FqpibuVWLNsAN/Z7ROZLnA: calls $0.25
TitTV+fFCcBZWOERdytydA: raises $2 to $2.50
FqpibuVWLNsAN/Z7ROZLnA: calls $2
*** FLOP *** [2s 3h 6s]
TitTV+fFCcBZWOERdytydA: bets $2
FqpibuVWLNsAN/Z7ROZLnA: calls $2
*** TURN *** [2s 3h 6s] [Tc]
TitTV+fFCcBZWOERdytydA: checks
FqpibuVWLNsAN/Z7ROZLnA: checks
*** RIVER *** [2s 3h 6s Tc] [6d]
TitTV+fFCcBZWOERdytydA: bets $6
FqpibuVWLNsAN/Z7ROZLnA: folds
TitTV+fFCcBZWOERdytydA collected $8.60 from pot
TitTV+fFCcBZWOERdytydA: doesn't show hand
*** SUMMARY ***
Total pot $9 | Rake $0.40
Board [2s 3h 6s Tc 6d]
Seat 1: FqpibuVWLNsAN/Z7ROZLnA (button) (small blind) folded on the River
Seat 2: TitTV+fFCcBZWOERdytydA (big blind) collected ($8.60)



PokerStars Game #59941468414:  Hold'em No Limit ($0.25/$0.50) - 2009/07/01 1:36:24 ET
Table '2lPOwetm4cfkZPbTmGPH/w' 2-max Seat #2 is the button
Seat 1: vUGdApqS8J/GJE2gaVWl1w ($19.80 in chips)
Seat 2: XFa6sBGjP2gxoIvxR3fZIg ($18.95 in chips)
XFa6sBGjP2gxoIvxR3fZIg: posts small blind $0.25
vUGdApqS8J/GJE2gaVWl1w: posts big blind $0.50
*** HOLE CARDS ***
XFa6sBGjP2gxoIvxR3fZIg: calls $0.25
vUGdApqS8J/GJE2gaVWl1w: raises $0.50 to $1
XFa6sBGjP2gxoIvxR3fZIg: calls $0.50
*** FLOP *** [Qc 5c Ac]
vUGdApqS8J/GJE2gaVWl1w: bets $1
XFa6sBGjP2gxoIvxR3fZIg: calls $1
*** TURN *** [Qc 5c Ac] [4d]
vUGdApqS8J/GJE2gaVWl1w: bets $1
XFa6sBGjP2gxoIvxR3fZIg: calls $1
*** RIVER *** [Qc 5c Ac 4d] [Kc]
vUGdApqS8J/GJE2gaVWl1w: bets $1.50
XFa6sBGjP2gxoIvxR3fZIg: raises $5 to $6.50
vUGdApqS8J/GJE2gaVWl1w: folds
XFa6sBGjP2gxoIvxR3fZIg collected $8.60 from pot
XFa6sBGjP2gxoIvxR3fZIg: doesn't show hand
*** SUMMARY ***
Total pot $9 | Rake $0.40
Board [Qc 5c Ac 4d Kc]
Seat 1: vUGdApqS8J/GJE2gaVWl1w (big blind) folded on the River
Seat 2: XFa6sBGjP2gxoIvxR3fZIg (button) (small blind) collected ($8.60)



PokerStars Game #59941468384:  Hold'em No Limit ($0.25/$0.50) - 2009/07/01 1:36:24 ET
Table 'Nz0Vr7WMHL2g5Uk7dDZjpw' 9-max Seat #6 is the button
Seat 1: 9yMsdgReyOUerNsmTYCCDQ ($9 in chips)
Seat 2: SegjDnMxWMujiD57ESNL+g ($20.35 in chips)
Seat 3: c638Xxo+q5F/t5qMtmvmvQ ($50.65 in chips)
Seat 4: uw9QayAAxLM3Hb+HR7mSkg ($9.25 in chips)
Seat 5: WGW0DgjBUXs1ylURHG8vnQ ($13.55 in chips)
Seat 6: 997ViqAtWn1FPjJqcffwcA ($53.75 in chips)
Seat 7: KPLH0gELgFe2OuAnhJFI5w ($24.55 in chips)
Seat 8: aoL+R/61Kxmw69ypuPrWAQ ($29.30 in chips)
Seat 9: mSD1pginDsyHG5PDfqzphw ($17.25 in chips)
KPLH0gELgFe2OuAnhJFI5w: posts small blind $0.25
aoL+R/61Kxmw69ypuPrWAQ: posts big blind $0.50
*** HOLE CARDS ***
mSD1pginDsyHG5PDfqzphw: folds
9yMsdgReyOUerNsmTYCCDQ: folds
SegjDnMxWMujiD57ESNL+g: folds
c638Xxo+q5F/t5qMtmvmvQ: folds
uw9QayAAxLM3Hb+HR7mSkg: folds
WGW0DgjBUXs1ylURHG8vnQ: folds
997ViqAtWn1FPjJqcffwcA: folds
KPLH0gELgFe2OuAnhJFI5w: calls $0.25
aoL+R/61Kxmw69ypuPrWAQ: checks
*** FLOP *** [Ac Qd 8h]
KPLH0gELgFe2OuAnhJFI5w: checks
aoL+R/61Kxmw69ypuPrWAQ: checks
*** TURN *** [Ac Qd 8h] [Tc]
KPLH0gELgFe2OuAnhJFI5w: checks
aoL+R/61Kxmw69ypuPrWAQ: checks
*** RIVER *** [Ac Qd 8h Tc] [Kd]
KPLH0gELgFe2OuAnhJFI5w: checks
aoL+R/61Kxmw69ypuPrWAQ: checks
*** SHOW DOWN ***
KPLH0gELgFe2OuAnhJFI5w: shows [5h 5s] (a pair of Fives)
aoL+R/61Kxmw69ypuPrWAQ: mucks hand
KPLH0gELgFe2OuAnhJFI5w collected $0.95 from pot
*** SUMMARY ***
Total pot $1 | Rake $0.05
Board [Ac Qd 8h Tc Kd]
Seat 1: 9yMsdgReyOUerNsmTYCCDQ folded before Flop (didn't bet)
Seat 2: SegjDnMxWMujiD57ESNL+g folded before Flop (didn't bet)
Seat 3: c638Xxo+q5F/t5qMtmvmvQ folded before Flop (didn't bet)
Seat 4: uw9QayAAxLM3Hb+HR7mSkg folded before Flop (didn't bet)
Seat 5: WGW0DgjBUXs1ylURHG8vnQ folded before Flop (didn't bet)
Seat 6: 997ViqAtWn1FPjJqcffwcA (button) folded before Flop (didn't bet)
Seat 7: KPLH0gELgFe2OuAnhJFI5w (small blind) showed [5h 5s] and won ($0.95) with a pair of Fives
Seat 8: aoL+R/61Kxmw69ypuPrWAQ (big blind) mucked
Seat 9: mSD1pginDsyHG5PDfqzphw folded before Flop (didn't bet)



PokerStars Game #59941468986:  Hold'em No Limit ($0.25/$0.50) - 2009/07/01 1:36:25 ET
Table 'cofQFHU7jbJoFecLVBof/w' 6-max Seat #2 is the button
Seat 1: URYNc7fPA23K2UfadQbnCA ($50.75 in chips)
Seat 2: f89uTQr3ieGlusj2IAYAEg ($50 in chips)
Seat 3: v4ctePcLlQw0r8E0qJtjYw ($53.20 in chips)
Seat 4: g6lz8npaeeTJmJegtPYhlQ ($17 in chips)
Seat 5: QvwRlrpVqerRRF8eJm6dDw ($46.65 in chips)
Seat 6: 7+uQ0OOgCTbR4ltkSwyC0g ($160.55 in chips)
v4ctePcLlQw0r8E0qJtjYw: posts small blind $0.25
g6lz8npaeeTJmJegtPYhlQ: posts big blind $0.50
*** HOLE CARDS ***
QvwRlrpVqerRRF8eJm6dDw: folds
7+uQ0OOgCTbR4ltkSwyC0g: folds
URYNc7fPA23K2UfadQbnCA: folds
f89uTQr3ieGlusj2IAYAEg: folds
v4ctePcLlQw0r8E0qJtjYw: folds
g6lz8npaeeTJmJegtPYhlQ collected $0.50 from pot
*** SUMMARY ***
Total pot $0.50 | Rake $0
Seat 1: URYNc7fPA23K2UfadQbnCA folded before Flop (didn't bet)
Seat 2: f89uTQr3ieGlusj2IAYAEg (button) folded before Flop (didn't bet)
Seat 3: v4ctePcLlQw0r8E0qJtjYw (small blind) folded before Flop
Seat 4: g6lz8npaeeTJmJegtPYhlQ (big blind) collected ($0.50)
Seat 5: QvwRlrpVqerRRF8eJm6dDw folded before Flop (didn't bet)
Seat 6: 7+uQ0OOgCTbR4ltkSwyC0g folded before Flop (didn't bet)



PokerStars Game #59941469376:  Hold'em No Limit ($0.25/$0.50) - 2009/07/01 1:36:26 ET
Table 'GfL/No5u5PoEnU39lP5pQg' 6-max Seat #2 is the button
Seat 1: 1WUCqNG+p+vfWRTXNu4ljw ($54.10 in chips)
Seat 2: uVwggSetzp7d+eVgowO3vg ($55.05 in chips)
Seat 3: 4pp9WxhGdbVbxCc9tlu0lw ($24.80 in chips)
Seat 4: vhWS+cwAJNd3JzqVzIjBZA ($50 in chips)
Seat 5: M1KyQQvVPVuxqTAB8sR/zQ ($50.95 in chips)
Seat 6: kxPhs4ePFqMy52CInAJ2aw ($120.95 in chips)
4pp9WxhGdbVbxCc9tlu0lw: posts small blind $0.25
vhWS+cwAJNd3JzqVzIjBZA: posts big blind $0.50
*** HOLE CARDS ***
M1KyQQvVPVuxqTAB8sR/zQ: folds
kxPhs4ePFqMy52CInAJ2aw: folds
1WUCqNG+p+vfWRTXNu4ljw: folds
uVwggSetzp7d+eVgowO3vg: folds
4pp9WxhGdbVbxCc9tlu0lw: folds
vhWS+cwAJNd3JzqVzIjBZA collected $0.50 from pot
vhWS+cwAJNd3JzqVzIjBZA: doesn't show hand
*** SUMMARY ***
Total pot $0.50 | Rake $0
Seat 1: 1WUCqNG+p+vfWRTXNu4ljw folded before Flop (didn't bet)
Seat 2: uVwggSetzp7d+eVgowO3vg (button) folded before Flop (didn't bet)
Seat 3: 4pp9WxhGdbVbxCc9tlu0lw (small blind) folded before Flop
Seat 4: vhWS+cwAJNd3JzqVzIjBZA (big blind) collected ($0.50)
Seat 5: M1KyQQvVPVuxqTAB8sR/zQ folded before Flop (didn't bet)
Seat 6: kxPhs4ePFqMy52CInAJ2aw folded before Flop (didn't bet)



PokerStars Game #59941470298:  Hold'em No Limit ($0.25/$0.50) - 2009/07/01 1:36:28 ET
Table 'Wwfm5/i+g/g2Nj2gT3jnVQ' 2-max Seat #1 is the button
Seat 1: CHRLZDaaxjbo68bwQD1C/Q ($11.35 in chips)
Seat 2: PKuuhUvIr5WSkJyPJa9dFw ($19.05 in chips)
CHRLZDaaxjbo68bwQD1C/Q: posts small blind $0.25
PKuuhUvIr5WSkJyPJa9dFw: posts big blind $0.50
*** HOLE CARDS ***
CHRLZDaaxjbo68bwQD1C/Q: calls $0.25
PKuuhUvIr5WSkJyPJa9dFw: checks
*** FLOP *** [4c Ts 8s]
PKuuhUvIr5WSkJyPJa9dFw: checks
CHRLZDaaxjbo68bwQD1C/Q: bets $0.50
PKuuhUvIr5WSkJyPJa9dFw: folds
CHRLZDaaxjbo68bwQD1C/Q collected $0.95 from pot
CHRLZDaaxjbo68bwQD1C/Q: doesn't show hand
*** SUMMARY ***
Total pot $1 | Rake $0.05
Board [4c Ts 8s]
Seat 1: CHRLZDaaxjbo68bwQD1C/Q (button) (small blind) collected ($0.95)
Seat 2: PKuuhUvIr5WSkJyPJa9dFw (big blind) folded on the Flop



PokerStars Game #59941472382:  Hold'em No Limit ($0.25/$0.50) - 2009/07/01 1:36:32 ET
Table 'BCN5su+SsXiy1zRMJi0SJw' 6-max Seat #6 is the button
Seat 1: GxXV09ciXaOxyY2H5aMIIw ($29.50 in chips)
Seat 2: ehFNAevCQri3trWxV6FJdA ($99.65 in chips)
Seat 3: kwgv5lNhiFrfONXCshzxlA ($70.60 in chips)
Seat 4: bbsK8j+tpuVRhBqDzHxf7w ($49.85 in chips)
Seat 5: kxPhs4ePFqMy52CInAJ2aw ($50.50 in chips)
Seat 6: b2symlOdL7+0c9Pj4N/KlA ($70.30 in chips)
GxXV09ciXaOxyY2H5aMIIw: posts small blind $0.25
ehFNAevCQri3trWxV6FJdA: posts big blind $0.50
*** HOLE CARDS ***
kwgv5lNhiFrfONXCshzxlA: calls $0.50
bbsK8j+tpuVRhBqDzHxf7w: folds
kxPhs4ePFqMy52CInAJ2aw: folds
b2symlOdL7+0c9Pj4N/KlA: folds
GxXV09ciXaOxyY2H5aMIIw: folds
ehFNAevCQri3trWxV6FJdA: checks
*** FLOP *** [9c 7d Jd]
ehFNAevCQri3trWxV6FJdA: checks
kwgv5lNhiFrfONXCshzxlA: bets $1
ehFNAevCQri3trWxV6FJdA: folds
kwgv5lNhiFrfONXCshzxlA collected $1.20 from pot
*** SUMMARY ***
Total pot $1.25 | Rake $0.05
Board [9c 7d Jd]
Seat 1: GxXV09ciXaOxyY2H5aMIIw (small blind) folded before Flop
Seat 2: ehFNAevCQri3trWxV6FJdA (big blind) folded on the Flop
Seat 3: kwgv5lNhiFrfONXCshzxlA collected ($1.20)
Seat 4: bbsK8j+tpuVRhBqDzHxf7w folded before Flop (didn't bet)
Seat 5: kxPhs4ePFqMy52CInAJ2aw folded before Flop (didn't bet)
Seat 6: b2symlOdL7+0c9Pj4N/KlA (button) folded before Flop (didn't bet)



PokerStars Game #59941473158:  Hold'em No Limit ($0.25/$0.50) - 2009/07/01 1:36:33 ET
Table 'hWT2kq66tnKEpD26cia6fQ' 2-max Seat #1 is the button
Seat 1: Ce3KNFP+ao7Da9NHb65raw ($29.65 in chips)
Seat 2: 16tvT7AYgZ2LgiGFcvFKQg ($45.05 in chips)
Ce3KNFP+ao7Da9NHb65raw: posts small blind $0.25
16tvT7AYgZ2LgiGFcvFKQg: posts big blind $0.50
*** HOLE CARDS ***
Ce3KNFP+ao7Da9NHb65raw: calls $0.25
16tvT7AYgZ2LgiGFcvFKQg: checks
*** FLOP *** [7h 5c 3d]
16tvT7AYgZ2LgiGFcvFKQg: checks
Ce3KNFP+ao7Da9NHb65raw: checks
*** TURN *** [7h 5c 3d] [Qs]
16tvT7AYgZ2LgiGFcvFKQg: checks
Ce3KNFP+ao7Da9NHb65raw: bets $0.50
16tvT7AYgZ2LgiGFcvFKQg: calls $0.50
*** RIVER *** [7h 5c 3d Qs] [3h]
16tvT7AYgZ2LgiGFcvFKQg: checks
Ce3KNFP+ao7Da9NHb65raw: checks
*** SHOW DOWN ***
16tvT7AYgZ2LgiGFcvFKQg: shows [Jc 9c] (a pair of Threes)
Ce3KNFP+ao7Da9NHb65raw: mucks hand
16tvT7AYgZ2LgiGFcvFKQg collected $1.95 from pot
*** SUMMARY ***
Total pot $2 | Rake $0.05
Board [7h 5c 3d Qs 3h]
Seat 1: Ce3KNFP+ao7Da9NHb65raw (button) (small blind) mucked
Seat 2: 16tvT7AYgZ2LgiGFcvFKQg (big blind) showed [Jc 9c] and won ($1.95) with a pair of Threes



PokerStars Game #59941475394:  Hold'em No Limit ($0.25/$0.50) - 2009/07/01 1:36:37 ET
Table 'iq+aXfWVQRdV0u8SRTYUEg' 9-max Seat #7 is the button
Seat 1: 3yl8Q6QaLfGtyhN4/pEFgQ ($72.30 in chips)
Seat 2: J9N0lxHFd/Js2S0xZLbsIQ ($25.30 in chips)
Seat 3: Qi/PyOsKwaqtKIg0H+7ELg ($4.70 in chips)
Seat 4: vHYT5s323LpajBj+2c9zbQ ($31.35 in chips)
Seat 5: 997ViqAtWn1FPjJqcffwcA ($56.90 in chips)
Seat 7: SKnJuWHScqetA/qG5p+wCg ($30.05 in chips)
Seat 8: /DtIHuxEH+3tzKefmSV+Mw ($44.90 in chips)
Seat 9: 7CKaQEWhd40e2lLifzZ1Cw ($30 in chips)
/DtIHuxEH+3tzKefmSV+Mw: posts small blind $0.25
7CKaQEWhd40e2lLifzZ1Cw: posts big blind $0.50
*** HOLE CARDS ***
3yl8Q6QaLfGtyhN4/pEFgQ: folds
J9N0lxHFd/Js2S0xZLbsIQ: folds
Qi/PyOsKwaqtKIg0H+7ELg: folds
vHYT5s323LpajBj+2c9zbQ: calls $0.50
997ViqAtWn1FPjJqcffwcA: folds
SKnJuWHScqetA/qG5p+wCg: folds
/DtIHuxEH+3tzKefmSV+Mw: folds
bTJ0WgoxefTPxIoycS7uoA has returned
7CKaQEWhd40e2lLifzZ1Cw: raises $1 to $1.50
vHYT5s323LpajBj+2c9zbQ: calls $1
*** FLOP *** [5s Ad As]
7CKaQEWhd40e2lLifzZ1Cw: bets $1.50
vHYT5s323LpajBj+2c9zbQ: calls $1.50
*** TURN *** [5s Ad As] [Tc]
7CKaQEWhd40e2lLifzZ1Cw: checks
vHYT5s323LpajBj+2c9zbQ: bets $3
7CKaQEWhd40e2lLifzZ1Cw: calls $3
*** RIVER *** [5s Ad As Tc] [8c]
7CKaQEWhd40e2lLifzZ1Cw: checks
vHYT5s323LpajBj+2c9zbQ: checks
*** SHOW DOWN ***
7CKaQEWhd40e2lLifzZ1Cw: shows [Kd Kc] (two pair, Aces and Kings)
vHYT5s323LpajBj+2c9zbQ: mucks hand
7CKaQEWhd40e2lLifzZ1Cw collected $11.70 from pot
*** SUMMARY ***
Total pot $12.25 | Rake $0.55
Board [5s Ad As Tc 8c]
Seat 1: 3yl8Q6QaLfGtyhN4/pEFgQ folded before Flop (didn't bet)
Seat 2: J9N0lxHFd/Js2S0xZLbsIQ folded before Flop (didn't bet)
Seat 3: Qi/PyOsKwaqtKIg0H+7ELg folded before Flop (didn't bet)
Seat 4: vHYT5s323LpajBj+2c9zbQ mucked
Seat 5: 997ViqAtWn1FPjJqcffwcA folded before Flop (didn't bet)
Seat 7: SKnJuWHScqetA/qG5p+wCg (button) folded before Flop (didn't bet)
Seat 8: /DtIHuxEH+3tzKefmSV+Mw (small blind) folded before Flop
Seat 9: 7CKaQEWhd40e2lLifzZ1Cw (big blind) showed [Kd Kc] and won ($11.70) with two pair, Aces and Kings



PokerStars Game #59941477376:  Hold'em No Limit ($0.25/$0.50) - 2009/07/01 1:36:40 ET
Table 'Wwfm5/i+g/g2Nj2gT3jnVQ' 2-max Seat #2 is the button
Seat 1: CHRLZDaaxjbo68bwQD1C/Q ($11.80 in chips)
Seat 2: PKuuhUvIr5WSkJyPJa9dFw ($18.55 in chips)
PKuuhUvIr5WSkJyPJa9dFw: posts small blind $0.25
CHRLZDaaxjbo68bwQD1C/Q: posts big blind $0.50
*** HOLE CARDS ***
PKuuhUvIr5WSkJyPJa9dFw: calls $0.25
CHRLZDaaxjbo68bwQD1C/Q: checks
*** FLOP *** [Kh Kd 5h]
CHRLZDaaxjbo68bwQD1C/Q: bets $0.50
PKuuhUvIr5WSkJyPJa9dFw: folds
CHRLZDaaxjbo68bwQD1C/Q collected $0.95 from pot
CHRLZDaaxjbo68bwQD1C/Q: doesn't show hand
*** SUMMARY ***
Total pot $1 | Rake $0.05
Board [Kh Kd 5h]
Seat 1: CHRLZDaaxjbo68bwQD1C/Q (big blind) collected ($0.95)
Seat 2: PKuuhUvIr5WSkJyPJa9dFw (button) (small blind) folded on the Flop



PokerStars Game #59941477996:  Hold'em No Limit ($0.25/$0.50) - 2009/07/01 1:36:41 ET
Table 'NCiXr0d5CEKBQr/cZgLhbA' 9-max Seat #7 is the button
Seat 1: pFtzb1sR4b0d1aw6aIRgDg ($80.45 in chips)
Seat 2: AjV5McH1KMMclY26QdLM5w ($44.55 in chips)
Seat 3: xZCXQSXlrZkp3pZizzVXCw ($95.65 in chips)
Seat 4: 5k9fvXD9suIgCxU4HLQjTw ($53.95 in chips)
Seat 5: Ja2jdidjip2UeJnRzmzAAQ ($48.25 in chips)
Seat 6: t1qL+wRXOwTLB4TBbcw2QA ($47 in chips)
Seat 7: dXhO5i7KOoVcsGqbklD+jw ($44 in chips)
Seat 8: XA3GzEhYmqB0KknKKPDZGQ ($23.50 in chips)
Seat 9: 4WLZvqBn5qv5tds5kt5A1Q ($57.95 in chips)
XA3GzEhYmqB0KknKKPDZGQ: posts small blind $0.25
4WLZvqBn5qv5tds5kt5A1Q: posts big blind $0.50
*** HOLE CARDS ***
pFtzb1sR4b0d1aw6aIRgDg: folds
AjV5McH1KMMclY26QdLM5w: folds
xZCXQSXlrZkp3pZizzVXCw: folds
5k9fvXD9suIgCxU4HLQjTw: folds
Ja2jdidjip2UeJnRzmzAAQ: raises $1 to $1.50
t1qL+wRXOwTLB4TBbcw2QA: folds
dXhO5i7KOoVcsGqbklD+jw: folds
XA3GzEhYmqB0KknKKPDZGQ: calls $1.25
4WLZvqBn5qv5tds5kt5A1Q: folds
*** FLOP *** [Qs 2s Jd]
XA3GzEhYmqB0KknKKPDZGQ: checks
Ja2jdidjip2UeJnRzmzAAQ: bets $1.50
XA3GzEhYmqB0KknKKPDZGQ: calls $1.50
*** TURN *** [Qs 2s Jd] [6h]
XA3GzEhYmqB0KknKKPDZGQ: checks
Ja2jdidjip2UeJnRzmzAAQ: bets $2
XA3GzEhYmqB0KknKKPDZGQ: raises $2 to $4
Ja2jdidjip2UeJnRzmzAAQ: calls $2
*** RIVER *** [Qs 2s Jd 6h] [8c]
XA3GzEhYmqB0KknKKPDZGQ: bets $16.50 and is all-in
Ja2jdidjip2UeJnRzmzAAQ: folds
XA3GzEhYmqB0KknKKPDZGQ collected $13.80 from pot
*** SUMMARY ***
Total pot $14.50 | Rake $0.70
Board [Qs 2s Jd 6h 8c]
Seat 1: pFtzb1sR4b0d1aw6aIRgDg folded before Flop (didn't bet)
Seat 2: AjV5McH1KMMclY26QdLM5w folded before Flop (didn't bet)
Seat 3: xZCXQSXlrZkp3pZizzVXCw folded before Flop (didn't bet)
Seat 4: 5k9fvXD9suIgCxU4HLQjTw folded before Flop (didn't bet)
Seat 5: Ja2jdidjip2UeJnRzmzAAQ folded on the River
Seat 6: t1qL+wRXOwTLB4TBbcw2QA folded before Flop (didn't bet)
Seat 7: dXhO5i7KOoVcsGqbklD+jw (button) folded before Flop (didn't bet)
Seat 8: XA3GzEhYmqB0KknKKPDZGQ (small blind) collected ($13.80)
Seat 9: 4WLZvqBn5qv5tds5kt5A1Q (big blind) folded before Flop



PokerStars Game #59941478942:  Hold'em No Limit ($0.25/$0.50) - 2009/07/01 1:36:43 ET
Table 'GfL/No5u5PoEnU39lP5pQg' 6-max Seat #3 is the button
Seat 1: 1WUCqNG+p+vfWRTXNu4ljw ($54.10 in chips)
Seat 2: uVwggSetzp7d+eVgowO3vg ($55.05 in chips)
Seat 3: 4pp9WxhGdbVbxCc9tlu0lw ($24.55 in chips)
Seat 4: vhWS+cwAJNd3JzqVzIjBZA ($50.25 in chips)
Seat 5: M1KyQQvVPVuxqTAB8sR/zQ ($50.95 in chips)
Seat 6: kxPhs4ePFqMy52CInAJ2aw ($120.95 in chips)
vhWS+cwAJNd3JzqVzIjBZA: posts small blind $0.25
M1KyQQvVPVuxqTAB8sR/zQ: posts big blind $0.50
*** HOLE CARDS ***
kxPhs4ePFqMy52CInAJ2aw: raises $1.50 to $2
1WUCqNG+p+vfWRTXNu4ljw: calls $2
uVwggSetzp7d+eVgowO3vg: folds
4pp9WxhGdbVbxCc9tlu0lw: folds
vhWS+cwAJNd3JzqVzIjBZA: folds
M1KyQQvVPVuxqTAB8sR/zQ: folds
*** FLOP *** [4s As 3c]
kxPhs4ePFqMy52CInAJ2aw: bets $3.40
1WUCqNG+p+vfWRTXNu4ljw: calls $3.40
*** TURN *** [4s As 3c] [6d]
kxPhs4ePFqMy52CInAJ2aw: bets $7
1WUCqNG+p+vfWRTXNu4ljw: calls $7
*** RIVER *** [4s As 3c 6d] [7c]
kxPhs4ePFqMy52CInAJ2aw: bets $14
1WUCqNG+p+vfWRTXNu4ljw: raises $27.70 to $41.70 and is all-in
kxPhs4ePFqMy52CInAJ2aw: folds
1WUCqNG+p+vfWRTXNu4ljw collected $50.95 from pot
*** SUMMARY ***
Total pot $53.55 | Rake $2.60
Board [4s As 3c 6d 7c]
Seat 1: 1WUCqNG+p+vfWRTXNu4ljw collected ($50.95)
Seat 2: uVwggSetzp7d+eVgowO3vg folded before Flop (didn't bet)
Seat 3: 4pp9WxhGdbVbxCc9tlu0lw (button) folded before Flop (didn't bet)
Seat 4: vhWS+cwAJNd3JzqVzIjBZA (small blind) folded before Flop
Seat 5: M1KyQQvVPVuxqTAB8sR/zQ (big blind) folded before Flop
Seat 6: kxPhs4ePFqMy52CInAJ2aw folded on the River



PokerStars Game #59941479474:  Hold'em No Limit ($0.25/$0.50) - 2009/07/01 1:36:44 ET
Table 'kgbJRsxfv64KrErDRBAkcw' 6-max Seat #3 is the button
Seat 1: VamsyhlFzXGF6/ydo0BHeA ($18 in chips)
Seat 2: AdS8BJMOheS01zjCDfPMFg ($80.80 in chips)
Seat 3: c4MNIaIyPMOMxrgT8FT5nA ($153 in chips)
Seat 4: 2igtJLmvIZ+HqX4XPgMPZA ($112 in chips)
Seat 5: eUBBn2R56C1IQ6Cs/vitwg ($104 in chips)
Seat 6: 1b+2BbjMN8qhR1WPqdE9VQ ($50 in chips)
2igtJLmvIZ+HqX4XPgMPZA: posts small blind $0.25
eUBBn2R56C1IQ6Cs/vitwg: posts big blind $0.50
*** HOLE CARDS ***
1b+2BbjMN8qhR1WPqdE9VQ: folds
VamsyhlFzXGF6/ydo0BHeA: calls $0.50
AdS8BJMOheS01zjCDfPMFg: raises $1 to $1.50
c4MNIaIyPMOMxrgT8FT5nA: folds
2igtJLmvIZ+HqX4XPgMPZA: folds
eUBBn2R56C1IQ6Cs/vitwg: raises $4.50 to $6
VamsyhlFzXGF6/ydo0BHeA: folds
AdS8BJMOheS01zjCDfPMFg: folds
eUBBn2R56C1IQ6Cs/vitwg collected $3.75 from pot
*** SUMMARY ***
Total pot $3.75 | Rake $0
Seat 1: VamsyhlFzXGF6/ydo0BHeA folded before Flop
Seat 2: AdS8BJMOheS01zjCDfPMFg folded before Flop
Seat 3: c4MNIaIyPMOMxrgT8FT5nA (button) folded before Flop (didn't bet)
Seat 4: 2igtJLmvIZ+HqX4XPgMPZA (small blind) folded before Flop
Seat 5: eUBBn2R56C1IQ6Cs/vitwg (big blind) collected ($3.75)
Seat 6: 1b+2BbjMN8qhR1WPqdE9VQ folded before Flop (didn't bet)



PokerStars Game #59941479450:  Hold'em No Limit ($0.25/$0.50) - 2009/07/01 1:36:44 ET
Table 'cofQFHU7jbJoFecLVBof/w' 6-max Seat #3 is the button
Seat 1: URYNc7fPA23K2UfadQbnCA ($50.75 in chips)
Seat 2: f89uTQr3ieGlusj2IAYAEg ($50 in chips)
Seat 3: v4ctePcLlQw0r8E0qJtjYw ($52.95 in chips)
Seat 4: g6lz8npaeeTJmJegtPYhlQ ($17.25 in chips)
Seat 5: QvwRlrpVqerRRF8eJm6dDw ($46.65 in chips)
Seat 6: 7+uQ0OOgCTbR4ltkSwyC0g ($160.55 in chips)
g6lz8npaeeTJmJegtPYhlQ: posts small blind $0.25
QvwRlrpVqerRRF8eJm6dDw: posts big blind $0.50
*** HOLE CARDS ***
7+uQ0OOgCTbR4ltkSwyC0g: folds
URYNc7fPA23K2UfadQbnCA: folds
f89uTQr3ieGlusj2IAYAEg: folds
v4ctePcLlQw0r8E0qJtjYw: raises $1 to $1.50
g6lz8npaeeTJmJegtPYhlQ: folds
QvwRlrpVqerRRF8eJm6dDw: calls $1
*** FLOP *** [8d Jh Ah]
QvwRlrpVqerRRF8eJm6dDw: bets $3
g6lz8npaeeTJmJegtPYhlQ leaves the table
v4ctePcLlQw0r8E0qJtjYw: folds
QvwRlrpVqerRRF8eJm6dDw collected $3.10 from pot
*** SUMMARY ***
Total pot $3.25 | Rake $0.15
Board [8d Jh Ah]
Seat 1: URYNc7fPA23K2UfadQbnCA folded before Flop (didn't bet)
Seat 2: f89uTQr3ieGlusj2IAYAEg folded before Flop (didn't bet)
Seat 3: v4ctePcLlQw0r8E0qJtjYw (button) folded on the Flop
Seat 4: g6lz8npaeeTJmJegtPYhlQ (small blind) folded before Flop
Seat 5: QvwRlrpVqerRRF8eJm6dDw (big blind) collected ($3.10)
Seat 6: 7+uQ0OOgCTbR4ltkSwyC0g folded before Flop (didn't bet)



PokerStars Game #59941479216:  Hold'em No Limit ($0.25/$0.50) - 2009/07/01 1:36:44 ET
Table 'B+sqsfj6d6zXicNfaseTaw' 2-max Seat #2 is the button
Seat 1: +4GNcSsecmapVGSdV0mUPA ($160.40 in chips)
Seat 2: Lv5RmpRe6LtPkBzM9Gpo5A ($61.70 in chips)
Lv5RmpRe6LtPkBzM9Gpo5A: posts small blind $0.25
+4GNcSsecmapVGSdV0mUPA: posts big blind $0.50
*** HOLE CARDS ***
Lv5RmpRe6LtPkBzM9Gpo5A: calls $0.25
+4GNcSsecmapVGSdV0mUPA: raises $1.50 to $2
Lv5RmpRe6LtPkBzM9Gpo5A: raises $3.50 to $5.50
+4GNcSsecmapVGSdV0mUPA: calls $3.50
*** FLOP *** [4h Jc 9c]
+4GNcSsecmapVGSdV0mUPA: checks
Lv5RmpRe6LtPkBzM9Gpo5A: bets $8.50
+4GNcSsecmapVGSdV0mUPA: calls $8.50
*** TURN *** [4h Jc 9c] [5c]
+4GNcSsecmapVGSdV0mUPA: checks
Lv5RmpRe6LtPkBzM9Gpo5A: bets $18
+4GNcSsecmapVGSdV0mUPA: folds
Lv5RmpRe6LtPkBzM9Gpo5A collected $27.50 from pot
*** SUMMARY ***
Total pot $28 | Rake $0.50
Board [4h Jc 9c 5c]
Seat 1: +4GNcSsecmapVGSdV0mUPA (big blind) folded on the Turn
Seat 2: Lv5RmpRe6LtPkBzM9Gpo5A (button) (small blind) collected ($27.50)



PokerStars Game #59941479612:  Hold'em No Limit ($0.25/$0.50) - 2009/07/01 1:36:44 ET
Table 'EiNh8p/wGJ1FP575iMFnqg' 9-max Seat #4 is the button
Seat 1: YFFlOZgyy1Mh4iBmuNRbmQ ($17.30 in chips)
Seat 2: GRV8J6o4lVSBDEyjt6BwMg ($29.50 in chips)
Seat 3: ymLPoEIl7UL3TvZYmnadxQ ($44.75 in chips)
Seat 4: cMzaiXAM/ZAdNaEUu+LqhA ($57.70 in chips)
Seat 5: M+7+BTmX5vZatHVuoRB1nA ($74.85 in chips)
Seat 7: 997ViqAtWn1FPjJqcffwcA ($50 in chips)
Seat 8: mSD1pginDsyHG5PDfqzphw ($10 in chips)
Seat 9: GuPkZObrz5Zkkn8FsEdF9w ($34.60 in chips)
M+7+BTmX5vZatHVuoRB1nA: posts small blind $0.25
997ViqAtWn1FPjJqcffwcA: posts big blind $0.50
*** HOLE CARDS ***
bCRukyMhXa3jkgAkKFa4VQ joins the table at seat #6
mSD1pginDsyHG5PDfqzphw: folds
GuPkZObrz5Zkkn8FsEdF9w: folds
YFFlOZgyy1Mh4iBmuNRbmQ: calls $0.50
GRV8J6o4lVSBDEyjt6BwMg: folds
ymLPoEIl7UL3TvZYmnadxQ: folds
cMzaiXAM/ZAdNaEUu+LqhA: raises $2.50 to $3
M+7+BTmX5vZatHVuoRB1nA: folds
997ViqAtWn1FPjJqcffwcA: folds
YFFlOZgyy1Mh4iBmuNRbmQ: calls $2.50
*** FLOP *** [2h Ts 2d]
YFFlOZgyy1Mh4iBmuNRbmQ: checks
cMzaiXAM/ZAdNaEUu+LqhA: checks
*** TURN *** [2h Ts 2d] [Js]
YFFlOZgyy1Mh4iBmuNRbmQ: bets $4.50
cMzaiXAM/ZAdNaEUu+LqhA: folds
YFFlOZgyy1Mh4iBmuNRbmQ collected $6.45 from pot
*** SUMMARY ***
Total pot $6.75 | Rake $0.30
Board [2h Ts 2d Js]
Seat 1: YFFlOZgyy1Mh4iBmuNRbmQ collected ($6.45)
Seat 2: GRV8J6o4lVSBDEyjt6BwMg folded before Flop (didn't bet)
Seat 3: ymLPoEIl7UL3TvZYmnadxQ folded before Flop (didn't bet)
Seat 4: cMzaiXAM/ZAdNaEUu+LqhA (button) folded on the Turn
Seat 5: M+7+BTmX5vZatHVuoRB1nA (small blind) folded before Flop
Seat 7: 997ViqAtWn1FPjJqcffwcA (big blind) folded before Flop
Seat 8: mSD1pginDsyHG5PDfqzphw folded before Flop (didn't bet)
Seat 9: GuPkZObrz5Zkkn8FsEdF9w folded before Flop (didn't bet)



PokerStars Game #59941479858:  Hold'em No Limit ($0.25/$0.50) - 2009/07/01 1:36:45 ET
Table '3FhG0gl3kMX3wBEEqj+wnQ' 9-max Seat #4 is the button
Seat 1: bxLSulbgr8LmKNjOzw8URg ($50.50 in chips)
Seat 3: YXCE3WOZi8g2sIf3y/plVw ($61.55 in chips)
Seat 4: e2+sK/yjnj94rXOKoxPP2A ($68.75 in chips)
Seat 5: XcLXSUMHSpshK/7Lh0M4Vg ($10.55 in chips)
Seat 6: 997ViqAtWn1FPjJqcffwcA ($109.80 in chips)
Seat 7: mSD1pginDsyHG5PDfqzphw ($20.45 in chips)
Seat 8: j3K/Jujr7PY4ZM2RZvlH6A ($48.35 in chips)
Seat 9: KA0tkubTlbhmo4ju+qgXPg ($44.35 in chips)
XcLXSUMHSpshK/7Lh0M4Vg: posts small blind $0.25
997ViqAtWn1FPjJqcffwcA: posts big blind $0.50
HZkVla4kK2SI42CVrPZ/ig: sits out
*** HOLE CARDS ***
mSD1pginDsyHG5PDfqzphw: folds
j3K/Jujr7PY4ZM2RZvlH6A: raises $1.50 to $2
KA0tkubTlbhmo4ju+qgXPg: folds
bxLSulbgr8LmKNjOzw8URg: calls $2
YXCE3WOZi8g2sIf3y/plVw: folds
e2+sK/yjnj94rXOKoxPP2A: folds
XcLXSUMHSpshK/7Lh0M4Vg: folds
997ViqAtWn1FPjJqcffwcA: folds
*** FLOP *** [5h 7s Th]
j3K/Jujr7PY4ZM2RZvlH6A: bets $46.35 and is all-in
bxLSulbgr8LmKNjOzw8URg: folds
j3K/Jujr7PY4ZM2RZvlH6A collected $4.55 from pot
j3K/Jujr7PY4ZM2RZvlH6A: doesn't show hand
*** SUMMARY ***
Total pot $4.75 | Rake $0.20
Board [5h 7s Th]
Seat 1: bxLSulbgr8LmKNjOzw8URg folded on the Flop
Seat 3: YXCE3WOZi8g2sIf3y/plVw folded before Flop (didn't bet)
Seat 4: e2+sK/yjnj94rXOKoxPP2A (button) folded before Flop (didn't bet)
Seat 5: XcLXSUMHSpshK/7Lh0M4Vg (small blind) folded before Flop
Seat 6: 997ViqAtWn1FPjJqcffwcA (big blind) folded before Flop
Seat 7: mSD1pginDsyHG5PDfqzphw folded before Flop (didn't bet)
Seat 8: j3K/Jujr7PY4ZM2RZvlH6A collected ($4.55)
Seat 9: KA0tkubTlbhmo4ju+qgXPg folded before Flop (didn't bet)



PokerStars Game #59941480932:  Hold'em No Limit ($0.25/$0.50) - 2009/07/01 1:36:47 ET
Table '+z1aekfHkpp09pc8F9aViw' 6-max Seat #6 is the button
Seat 1: L0aIPg7qefDQjdJo3HCVEA ($10.25 in chips)
Seat 3: URYNc7fPA23K2UfadQbnCA ($50.75 in chips)
Seat 4: RowCSpSURHTOL/dcjg/Iug ($85.70 in chips)
Seat 5: 2igtJLmvIZ+HqX4XPgMPZA ($50.95 in chips)
Seat 6: GUnvMULl2qFOO1yenu1UBw ($51.50 in chips)
L0aIPg7qefDQjdJo3HCVEA: posts small blind $0.25
4QfsCWthT/vSLirorNXqtg: is sitting out
URYNc7fPA23K2UfadQbnCA: posts big blind $0.50
*** HOLE CARDS ***
4QfsCWthT/vSLirorNXqtg leaves the table
RowCSpSURHTOL/dcjg/Iug: folds
2igtJLmvIZ+HqX4XPgMPZA: raises $1.50 to $2
GUnvMULl2qFOO1yenu1UBw: folds
L0aIPg7qefDQjdJo3HCVEA: raises $8.25 to $10.25 and is all-in
URYNc7fPA23K2UfadQbnCA: raises $9.75 to $20
2igtJLmvIZ+HqX4XPgMPZA: folds
*** FLOP *** [8d 9s 6s]
*** TURN *** [8d 9s 6s] [Qc]
*** RIVER *** [8d 9s 6s Qc] [8s]
*** SHOW DOWN ***
L0aIPg7qefDQjdJo3HCVEA: shows [Ad Jh] (a pair of Eights)
URYNc7fPA23K2UfadQbnCA: shows [Ks Kc] (two pair, Kings and Eights)
URYNc7fPA23K2UfadQbnCA collected $21.40 from pot
*** SUMMARY ***
Total pot $22.50 | Rake $1.10
Board [8d 9s 6s Qc 8s]
Seat 1: L0aIPg7qefDQjdJo3HCVEA (small blind) showed [Ad Jh] and lost with a pair of Eights
Seat 3: URYNc7fPA23K2UfadQbnCA (big blind) showed [Ks Kc] and won ($21.40) with two pair, Kings and Eights
Seat 4: RowCSpSURHTOL/dcjg/Iug folded before Flop (didn't bet)
Seat 5: 2igtJLmvIZ+HqX4XPgMPZA folded before Flop
Seat 6: GUnvMULl2qFOO1yenu1UBw (button) folded before Flop (didn't bet)



PokerStars Game #59941483864:  Hold'em No Limit ($0.25/$0.50) - 2009/07/01 1:36:52 ET
Table 'ZYI3ZReBjdfKEYItkZHI6A' 9-max Seat #2 is the button
Seat 1: IYd5zG8k7vdBNVHbHg2Pag ($62.90 in chips)
Seat 2: 5acK4E7fzEwnplVBZ6eNWA ($50 in chips)
Seat 3: 75K2MXwN65Sjfp1yHd50Hg ($8.75 in chips)
Seat 4: /UdtxmXsFx6K/14AbHqzbQ ($10 in chips)
Seat 5: ApHP7ouup365XIUFBdEDxg ($17.75 in chips)
Seat 6: 1xBtrSVBbgFH/viUWKqQeg ($21.50 in chips)
Seat 7: HWcfp1hY1hqvrddzW3/FQw ($21.30 in chips)
Seat 8: ji04uOybxCdpdefzlUQeKQ ($29.55 in chips)
Seat 9: HZkVla4kK2SI42CVrPZ/ig ($10.40 in chips)
75K2MXwN65Sjfp1yHd50Hg: posts small blind $0.25
/UdtxmXsFx6K/14AbHqzbQ: posts big blind $0.50
*** HOLE CARDS ***
ApHP7ouup365XIUFBdEDxg: calls $0.50
1xBtrSVBbgFH/viUWKqQeg: raises $1.50 to $2
HWcfp1hY1hqvrddzW3/FQw: folds
ji04uOybxCdpdefzlUQeKQ: folds
HZkVla4kK2SI42CVrPZ/ig: folds
IYd5zG8k7vdBNVHbHg2Pag: folds
5acK4E7fzEwnplVBZ6eNWA: folds
75K2MXwN65Sjfp1yHd50Hg: folds
/UdtxmXsFx6K/14AbHqzbQ: folds
ApHP7ouup365XIUFBdEDxg: folds
1xBtrSVBbgFH/viUWKqQeg collected $1.75 from pot
*** SUMMARY ***
Total pot $1.75 | Rake $0
Seat 1: IYd5zG8k7vdBNVHbHg2Pag folded before Flop (didn't bet)
Seat 2: 5acK4E7fzEwnplVBZ6eNWA (button) folded before Flop (didn't bet)
Seat 3: 75K2MXwN65Sjfp1yHd50Hg (small blind) folded before Flop
Seat 4: /UdtxmXsFx6K/14AbHqzbQ (big blind) folded before Flop
Seat 5: ApHP7ouup365XIUFBdEDxg folded before Flop
Seat 6: 1xBtrSVBbgFH/viUWKqQeg collected ($1.75)
Seat 7: HWcfp1hY1hqvrddzW3/FQw folded before Flop (didn't bet)
Seat 8: ji04uOybxCdpdefzlUQeKQ folded before Flop (didn't bet)
Seat 9: HZkVla4kK2SI42CVrPZ/ig folded before Flop (didn't bet)



PokerStars Game #59941484056:  Hold'em No Limit ($0.25/$0.50) - 2009/07/01 1:36:52 ET
Table '8BQGgNetI1NOvWeu3gtMNw' 2-max Seat #2 is the button
Seat 1: bypIyrYcAAifLfhZpGlKLA ($61.75 in chips)
Seat 2: Z4HwehErEwzsv/noQlfUlg ($152.85 in chips)
Z4HwehErEwzsv/noQlfUlg: posts small blind $0.25
bypIyrYcAAifLfhZpGlKLA: posts big blind $0.50
*** HOLE CARDS ***
Z4HwehErEwzsv/noQlfUlg: raises $1.50 to $2
bypIyrYcAAifLfhZpGlKLA: raises $6 to $8
Z4HwehErEwzsv/noQlfUlg: folds
bypIyrYcAAifLfhZpGlKLA collected $4 from pot
bypIyrYcAAifLfhZpGlKLA: doesn't show hand
*** SUMMARY ***
Total pot $4 | Rake $0
Seat 1: bypIyrYcAAifLfhZpGlKLA (big blind) collected ($4)
Seat 2: Z4HwehErEwzsv/noQlfUlg (button) (small blind) folded before Flop



PokerStars Game #59941483798:  Hold'em No Limit ($0.25/$0.50) - 2009/07/01 1:36:52 ET
Table 'Wwfm5/i+g/g2Nj2gT3jnVQ' 2-max Seat #1 is the button
Seat 1: CHRLZDaaxjbo68bwQD1C/Q ($12.25 in chips)
Seat 2: PKuuhUvIr5WSkJyPJa9dFw ($18.05 in chips)
CHRLZDaaxjbo68bwQD1C/Q: posts small blind $0.25
PKuuhUvIr5WSkJyPJa9dFw: posts big blind $0.50
*** HOLE CARDS ***
CHRLZDaaxjbo68bwQD1C/Q: folds
PKuuhUvIr5WSkJyPJa9dFw collected $0.50 from pot
PKuuhUvIr5WSkJyPJa9dFw: doesn't show hand
*** SUMMARY ***
Total pot $0.50 | Rake $0
Seat 1: CHRLZDaaxjbo68bwQD1C/Q (button) (small blind) folded before Flop
Seat 2: PKuuhUvIr5WSkJyPJa9dFw (big blind) collected ($0.50)



PokerStars Game #59941486300:  Hold'em No Limit ($0.25/$0.50) - 2009/07/01 1:36:56 ET
Table 'tyR5AZNKV8Aadbrnrnlg7g' 6-max Seat #3 is the button
Seat 1: BgOXYI0yYSN1ULC4FqsNkg ($75.55 in chips)
Seat 2: BAjwVL+zKKd0s0fAWstzQQ ($14.80 in chips)
Seat 3: JFLrYNyQmwPhRQAtoSAuyA ($60.85 in chips)
Seat 4: 4QfsCWthT/vSLirorNXqtg ($85.20 in chips)
Seat 5: GUnvMULl2qFOO1yenu1UBw ($81.10 in chips)
Seat 6: 498aWaGsW4uGfuWl+2FCGw ($64.65 in chips)
4QfsCWthT/vSLirorNXqtg: posts small blind $0.25
GUnvMULl2qFOO1yenu1UBw: posts big blind $0.50
*** HOLE CARDS ***
498aWaGsW4uGfuWl+2FCGw: calls $0.50
BgOXYI0yYSN1ULC4FqsNkg: folds
BAjwVL+zKKd0s0fAWstzQQ: folds
JFLrYNyQmwPhRQAtoSAuyA: folds
4QfsCWthT/vSLirorNXqtg: folds
GUnvMULl2qFOO1yenu1UBw: checks
*** FLOP *** [4d Jc 2c]
GUnvMULl2qFOO1yenu1UBw: checks
498aWaGsW4uGfuWl+2FCGw: bets $0.50
GUnvMULl2qFOO1yenu1UBw: folds
498aWaGsW4uGfuWl+2FCGw collected $1.20 from pot
498aWaGsW4uGfuWl+2FCGw: doesn't show hand
*** SUMMARY ***
Total pot $1.25 | Rake $0.05
Board [4d Jc 2c]
Seat 1: BgOXYI0yYSN1ULC4FqsNkg folded before Flop (didn't bet)
Seat 2: BAjwVL+zKKd0s0fAWstzQQ folded before Flop (didn't bet)
Seat 3: JFLrYNyQmwPhRQAtoSAuyA (button) folded before Flop (didn't bet)
Seat 4: 4QfsCWthT/vSLirorNXqtg (small blind) folded before Flop
Seat 5: GUnvMULl2qFOO1yenu1UBw (big blind) folded on the Flop
Seat 6: 498aWaGsW4uGfuWl+2FCGw collected ($1.20)



PokerStars Game #59941486818:  Hold'em No Limit ($0.25/$0.50) - 2009/07/01 1:36:57 ET
Table 'BCN5su+SsXiy1zRMJi0SJw' 6-max Seat #1 is the button
Seat 1: GxXV09ciXaOxyY2H5aMIIw ($29.25 in chips)
Seat 2: ehFNAevCQri3trWxV6FJdA ($99.15 in chips)
Seat 3: kwgv5lNhiFrfONXCshzxlA ($71.30 in chips)
Seat 4: bbsK8j+tpuVRhBqDzHxf7w ($49.85 in chips)
Seat 5: kxPhs4ePFqMy52CInAJ2aw ($50.50 in chips)
Seat 6: b2symlOdL7+0c9Pj4N/KlA ($70.30 in chips)
ehFNAevCQri3trWxV6FJdA: posts small blind $0.25
kwgv5lNhiFrfONXCshzxlA: posts big blind $0.50
*** HOLE CARDS ***
bbsK8j+tpuVRhBqDzHxf7w: folds
kxPhs4ePFqMy52CInAJ2aw: folds
b2symlOdL7+0c9Pj4N/KlA: folds
GxXV09ciXaOxyY2H5aMIIw: folds
ehFNAevCQri3trWxV6FJdA: folds
kwgv5lNhiFrfONXCshzxlA collected $0.50 from pot
*** SUMMARY ***
Total pot $0.50 | Rake $0
Seat 1: GxXV09ciXaOxyY2H5aMIIw (button) folded before Flop (didn't bet)
Seat 2: ehFNAevCQri3trWxV6FJdA (small blind) folded before Flop
Seat 3: kwgv5lNhiFrfONXCshzxlA (big blind) collected ($0.50)
Seat 4: bbsK8j+tpuVRhBqDzHxf7w folded before Flop (didn't bet)
Seat 5: kxPhs4ePFqMy52CInAJ2aw folded before Flop (didn't bet)
Seat 6: b2symlOdL7+0c9Pj4N/KlA folded before Flop (didn't bet)



PokerStars Game #59941487368:  Hold'em No Limit ($0.25/$0.50) - 2009/07/01 1:36:58 ET
Table 'hSTs/dUsYLgJQuF2Onp0MQ' 6-max Seat #3 is the button
Seat 1: 1WUCqNG+p+vfWRTXNu4ljw ($50.75 in chips)
Seat 2: Hdd4js36ITbTJ/QuVYwTlA ($102.25 in chips)
Seat 3: lxIzoHy0RnkfFSODHC2liw ($50 in chips)
Seat 4: 2igtJLmvIZ+HqX4XPgMPZA ($50 in chips)
Seat 5: FsRQ5ECdlLkLYI5le8+PDQ ($49.25 in chips)
Seat 6: M1KyQQvVPVuxqTAB8sR/zQ ($102.65 in chips)
2igtJLmvIZ+HqX4XPgMPZA: posts small blind $0.25
FsRQ5ECdlLkLYI5le8+PDQ: posts big blind $0.50
*** HOLE CARDS ***
M1KyQQvVPVuxqTAB8sR/zQ: folds
1WUCqNG+p+vfWRTXNu4ljw: raises $1.50 to $2
Hdd4js36ITbTJ/QuVYwTlA: calls $2
lxIzoHy0RnkfFSODHC2liw: calls $2
2igtJLmvIZ+HqX4XPgMPZA: folds
FsRQ5ECdlLkLYI5le8+PDQ: folds
*** FLOP *** [4s Qd Qc]
1WUCqNG+p+vfWRTXNu4ljw: checks
Hdd4js36ITbTJ/QuVYwTlA: checks
lxIzoHy0RnkfFSODHC2liw: checks
*** TURN *** [4s Qd Qc] [Ks]
1WUCqNG+p+vfWRTXNu4ljw: checks
Hdd4js36ITbTJ/QuVYwTlA: checks
lxIzoHy0RnkfFSODHC2liw: checks
*** RIVER *** [4s Qd Qc Ks] [5c]
1WUCqNG+p+vfWRTXNu4ljw: checks
Hdd4js36ITbTJ/QuVYwTlA: checks
lxIzoHy0RnkfFSODHC2liw: checks
*** SHOW DOWN ***
1WUCqNG+p+vfWRTXNu4ljw: shows [As 2s] (a pair of Queens)
Hdd4js36ITbTJ/QuVYwTlA: mucks hand
lxIzoHy0RnkfFSODHC2liw: mucks hand
1WUCqNG+p+vfWRTXNu4ljw collected $6.45 from pot
*** SUMMARY ***
Total pot $6.75 | Rake $0.30
Board [4s Qd Qc Ks 5c]
Seat 1: 1WUCqNG+p+vfWRTXNu4ljw showed [As 2s] and won ($6.45) with a pair of Queens
Seat 2: Hdd4js36ITbTJ/QuVYwTlA mucked
Seat 3: lxIzoHy0RnkfFSODHC2liw (button) mucked
Seat 4: 2igtJLmvIZ+HqX4XPgMPZA (small blind) folded before Flop
Seat 5: FsRQ5ECdlLkLYI5le8+PDQ (big blind) folded before Flop
Seat 6: M1KyQQvVPVuxqTAB8sR/zQ folded before Flop (didn't bet)



PokerStars Game #59941487346:  Hold'em No Limit ($0.25/$0.50) - 2009/07/01 1:36:58 ET
Table 'Wwfm5/i+g/g2Nj2gT3jnVQ' 2-max Seat #2 is the button
Seat 1: CHRLZDaaxjbo68bwQD1C/Q ($12 in chips)
Seat 2: PKuuhUvIr5WSkJyPJa9dFw ($18.30 in chips)
PKuuhUvIr5WSkJyPJa9dFw: posts small blind $0.25
CHRLZDaaxjbo68bwQD1C/Q: posts big blind $0.50
*** HOLE CARDS ***
PKuuhUvIr5WSkJyPJa9dFw: calls $0.25
CHRLZDaaxjbo68bwQD1C/Q: checks
*** FLOP *** [3s 3c 7s]
CHRLZDaaxjbo68bwQD1C/Q: checks
PKuuhUvIr5WSkJyPJa9dFw: checks
*** TURN *** [3s 3c 7s] [9d]
CHRLZDaaxjbo68bwQD1C/Q: bets $0.50
PKuuhUvIr5WSkJyPJa9dFw: calls $0.50
*** RIVER *** [3s 3c 7s 9d] [Kh]
CHRLZDaaxjbo68bwQD1C/Q: bets $1
PKuuhUvIr5WSkJyPJa9dFw: folds
CHRLZDaaxjbo68bwQD1C/Q collected $1.95 from pot
*** SUMMARY ***
Total pot $2 | Rake $0.05
Board [3s 3c 7s 9d Kh]
Seat 1: CHRLZDaaxjbo68bwQD1C/Q (big blind) collected ($1.95)
Seat 2: PKuuhUvIr5WSkJyPJa9dFw (button) (small blind) folded on the River



PokerStars Game #59941487528:  Hold'em No Limit ($0.25/$0.50) - 2009/07/01 1:36:59 ET
Table '2lPOwetm4cfkZPbTmGPH/w' 2-max Seat #1 is the button
Seat 1: vUGdApqS8J/GJE2gaVWl1w ($15.30 in chips)
Seat 2: XFa6sBGjP2gxoIvxR3fZIg ($23.05 in chips)
vUGdApqS8J/GJE2gaVWl1w: posts small blind $0.25
XFa6sBGjP2gxoIvxR3fZIg: posts big blind $0.50
*** HOLE CARDS ***
vUGdApqS8J/GJE2gaVWl1w: raises $0.50 to $1
XFa6sBGjP2gxoIvxR3fZIg: calls $0.50
*** FLOP *** [Tc 2c Kd]
XFa6sBGjP2gxoIvxR3fZIg: checks
vUGdApqS8J/GJE2gaVWl1w: checks
*** TURN *** [Tc 2c Kd] [9h]
XFa6sBGjP2gxoIvxR3fZIg: checks
vUGdApqS8J/GJE2gaVWl1w: checks
*** RIVER *** [Tc 2c Kd 9h] [Jd]
XFa6sBGjP2gxoIvxR3fZIg: checks
vUGdApqS8J/GJE2gaVWl1w: checks
*** SHOW DOWN ***
XFa6sBGjP2gxoIvxR3fZIg: shows [5s 7s] (high card King)
vUGdApqS8J/GJE2gaVWl1w: shows [3h 3c] (a pair of Threes)
vUGdApqS8J/GJE2gaVWl1w collected $1.90 from pot
*** SUMMARY ***
Total pot $2 | Rake $0.10
Board [Tc 2c Kd 9h Jd]
Seat 1: vUGdApqS8J/GJE2gaVWl1w (button) (small blind) showed [3h 3c] and won ($1.90) with a pair of Threes
Seat 2: XFa6sBGjP2gxoIvxR3fZIg (big blind) showed [5s 7s] and lost with high card King



PokerStars Game #59941488858:  Hold'em No Limit ($0.25/$0.50) - 2009/07/01 1:37:01 ET
Table 'hWT2kq66tnKEpD26cia6fQ' 2-max Seat #2 is the button
Seat 1: Ce3KNFP+ao7Da9NHb65raw ($28.65 in chips)
Seat 2: 16tvT7AYgZ2LgiGFcvFKQg ($46 in chips)
16tvT7AYgZ2LgiGFcvFKQg: posts small blind $0.25
Ce3KNFP+ao7Da9NHb65raw: posts big blind $0.50
*** HOLE CARDS ***
16tvT7AYgZ2LgiGFcvFKQg: raises $0.50 to $1
Ce3KNFP+ao7Da9NHb65raw: calls $0.50
*** FLOP *** [7s 4s 5h]
Ce3KNFP+ao7Da9NHb65raw: checks
16tvT7AYgZ2LgiGFcvFKQg: bets $0.50
Ce3KNFP+ao7Da9NHb65raw: calls $0.50
*** TURN *** [7s 4s 5h] [7c]
Ce3KNFP+ao7Da9NHb65raw: bets $1
16tvT7AYgZ2LgiGFcvFKQg: folds
Ce3KNFP+ao7Da9NHb65raw collected $2.90 from pot
*** SUMMARY ***
Total pot $3 | Rake $0.10
Board [7s 4s 5h 7c]
Seat 1: Ce3KNFP+ao7Da9NHb65raw (big blind) collected ($2.90)
Seat 2: 16tvT7AYgZ2LgiGFcvFKQg (button) (small blind) folded on the Turn



PokerStars Game #59941488740:  Hold'em No Limit ($0.25/$0.50) - 2009/07/01 1:37:01 ET
Table '9ojijpRcYQSQTh6xI+haUA' 2-max Seat #2 is the button
Seat 1: FqpibuVWLNsAN/Z7ROZLnA ($56.75 in chips)
Seat 2: TitTV+fFCcBZWOERdytydA ($68.55 in chips)
TitTV+fFCcBZWOERdytydA: posts small blind $0.25
FqpibuVWLNsAN/Z7ROZLnA: posts big blind $0.50
*** HOLE CARDS ***
TitTV+fFCcBZWOERdytydA: folds
FqpibuVWLNsAN/Z7ROZLnA collected $0.50 from pot
*** SUMMARY ***
Total pot $0.50 | Rake $0
Seat 1: FqpibuVWLNsAN/Z7ROZLnA (big blind) collected ($0.50)
Seat 2: TitTV+fFCcBZWOERdytydA (button) (small blind) folded before Flop



PokerStars Game #59941488906:  Hold'em No Limit ($0.25/$0.50) - 2009/07/01 1:37:01 ET
Table '5qf8oPyYje71HBKD0FwPgQ' 9-max Seat #4 is the button
Seat 2: M+7+BTmX5vZatHVuoRB1nA ($53.15 in chips)
Seat 3: vacmVLJJECYI6HjAynFcpg ($56.95 in chips)
Seat 4: YXCE3WOZi8g2sIf3y/plVw ($53.85 in chips)
Seat 5: uo2Sgpknd7NdeVbeSCG02A ($16.20 in chips)
Seat 6: go0Ad6tqqJ4tR9/bqVlO0g ($19.60 in chips)
Seat 7: 1q5EPoiflJRl8pqfnVLjMw ($57.55 in chips)
Seat 8: sakr/FIfFtIZwDPmAj5Pzg ($59.10 in chips)
Seat 9: jWDRpL0TJljg+mBCE9ZMqA ($7.85 in chips)
uo2Sgpknd7NdeVbeSCG02A: posts small blind $0.25
go0Ad6tqqJ4tR9/bqVlO0g: posts big blind $0.50
gsyXT42WLEcOS4DdEk2wlw: sits out
*** HOLE CARDS ***
1q5EPoiflJRl8pqfnVLjMw: calls $0.50
sakr/FIfFtIZwDPmAj5Pzg: folds
jWDRpL0TJljg+mBCE9ZMqA: folds
M+7+BTmX5vZatHVuoRB1nA: folds
vacmVLJJECYI6HjAynFcpg: calls $0.50
YXCE3WOZi8g2sIf3y/plVw: folds
uo2Sgpknd7NdeVbeSCG02A: calls $0.25
go0Ad6tqqJ4tR9/bqVlO0g: checks
*** FLOP *** [Th 9c 2d]
uo2Sgpknd7NdeVbeSCG02A: checks
go0Ad6tqqJ4tR9/bqVlO0g: checks
1q5EPoiflJRl8pqfnVLjMw: checks
vacmVLJJECYI6HjAynFcpg: bets $2
uo2Sgpknd7NdeVbeSCG02A: folds
go0Ad6tqqJ4tR9/bqVlO0g: calls $2
1q5EPoiflJRl8pqfnVLjMw: folds
*** TURN *** [Th 9c 2d] [Qd]
go0Ad6tqqJ4tR9/bqVlO0g: checks
vacmVLJJECYI6HjAynFcpg: bets $4
go0Ad6tqqJ4tR9/bqVlO0g: calls $4
*** RIVER *** [Th 9c 2d Qd] [8d]
go0Ad6tqqJ4tR9/bqVlO0g: bets $13.10 and is all-in
vacmVLJJECYI6HjAynFcpg: folds
go0Ad6tqqJ4tR9/bqVlO0g collected $13.35 from pot
*** SUMMARY ***
Total pot $14 | Rake $0.65
Board [Th 9c 2d Qd 8d]
Seat 2: M+7+BTmX5vZatHVuoRB1nA folded before Flop (didn't bet)
Seat 3: vacmVLJJECYI6HjAynFcpg folded on the River
Seat 4: YXCE3WOZi8g2sIf3y/plVw (button) folded before Flop (didn't bet)
Seat 5: uo2Sgpknd7NdeVbeSCG02A (small blind) folded on the Flop
Seat 6: go0Ad6tqqJ4tR9/bqVlO0g (big blind) collected ($13.35)
Seat 7: 1q5EPoiflJRl8pqfnVLjMw folded on the Flop
Seat 8: sakr/FIfFtIZwDPmAj5Pzg folded before Flop (didn't bet)
Seat 9: jWDRpL0TJljg+mBCE9ZMqA folded before Flop (didn't bet)



PokerStars Game #59941492214:  Hold'em No Limit ($0.25/$0.50) - 2009/07/01 1:37:07 ET
Table '8BQGgNetI1NOvWeu3gtMNw' 2-max Seat #1 is the button
Seat 1: bypIyrYcAAifLfhZpGlKLA ($63.75 in chips)
Seat 2: Z4HwehErEwzsv/noQlfUlg ($150.85 in chips)
bypIyrYcAAifLfhZpGlKLA: posts small blind $0.25
Z4HwehErEwzsv/noQlfUlg: posts big blind $0.50
*** HOLE CARDS ***
bypIyrYcAAifLfhZpGlKLA: raises $1 to $1.50
Z4HwehErEwzsv/noQlfUlg: raises $1 to $2.50
bypIyrYcAAifLfhZpGlKLA: calls $1
*** FLOP *** [Ah 9s As]
Z4HwehErEwzsv/noQlfUlg: checks
bypIyrYcAAifLfhZpGlKLA: checks
*** TURN *** [Ah 9s As] [3s]
Z4HwehErEwzsv/noQlfUlg: checks
bypIyrYcAAifLfhZpGlKLA: checks
*** RIVER *** [Ah 9s As 3s] [2h]
Z4HwehErEwzsv/noQlfUlg: bets $1.50
bypIyrYcAAifLfhZpGlKLA: raises $5 to $6.50
Z4HwehErEwzsv/noQlfUlg: folds
bypIyrYcAAifLfhZpGlKLA collected $7.65 from pot
bypIyrYcAAifLfhZpGlKLA: doesn't show hand
*** SUMMARY ***
Total pot $8 | Rake $0.35
Board [Ah 9s As 3s 2h]
Seat 1: bypIyrYcAAifLfhZpGlKLA (button) (small blind) collected ($7.65)
Seat 2: Z4HwehErEwzsv/noQlfUlg (big blind) folded on the River



PokerStars Game #59941492276:  Hold'em No Limit ($0.25/$0.50) - 2009/07/01 1:37:07 ET
Table 'ErOuyGLI5PT3G5MnpHgC/g' 9-max Seat #4 is the button
Seat 1: eBrej2jnlUCs/JgxFCRn2g ($47.85 in chips)
Seat 2: pciZn00ZDk4BVBMTTMcNVQ ($20.25 in chips)
Seat 3: xZCXQSXlrZkp3pZizzVXCw ($49.25 in chips)
Seat 4: YRqrX/u38J7aLNNnBzQsjQ ($9.25 in chips)
Seat 5: JwvquocWfhTVApN5t47LgA ($48.55 in chips)
Seat 6: zE9cVigS2nW/Ljy4K4bUQA ($30 in chips)
Seat 7: 90Wb75h3W1BRpbqVnuk8gw ($71.45 in chips)
Seat 8: g4k0NXISyLCqaSWZDBjfEg ($50 in chips)
Seat 9: J0W5D97jl5VLky+IoPvDeA ($64.50 in chips)
JwvquocWfhTVApN5t47LgA: posts small blind $0.25
zE9cVigS2nW/Ljy4K4bUQA: posts big blind $0.50
*** HOLE CARDS ***
90Wb75h3W1BRpbqVnuk8gw: raises $1.50 to $2
g4k0NXISyLCqaSWZDBjfEg: folds
J0W5D97jl5VLky+IoPvDeA: folds
eBrej2jnlUCs/JgxFCRn2g has timed out
eBrej2jnlUCs/JgxFCRn2g: folds
eBrej2jnlUCs/JgxFCRn2g is sitting out
pciZn00ZDk4BVBMTTMcNVQ: folds
xZCXQSXlrZkp3pZizzVXCw: folds
YRqrX/u38J7aLNNnBzQsjQ: raises $1.50 to $3.50
JwvquocWfhTVApN5t47LgA: folds
zE9cVigS2nW/Ljy4K4bUQA: folds
90Wb75h3W1BRpbqVnuk8gw: raises $7.50 to $11
YRqrX/u38J7aLNNnBzQsjQ: calls $5.75 and is all-in
eBrej2jnlUCs/JgxFCRn2g has returned
*** FLOP *** [9d 6d 9c]
*** TURN *** [9d 6d 9c] [6h]
*** RIVER *** [9d 6d 9c 6h] [8d]
*** SHOW DOWN ***
90Wb75h3W1BRpbqVnuk8gw: shows [As Kh] (two pair, Nines and Sixes)
YRqrX/u38J7aLNNnBzQsjQ: shows [Qc Qs] (two pair, Queens and Nines)
YRqrX/u38J7aLNNnBzQsjQ collected $18.30 from pot
*** SUMMARY ***
Total pot $19.25 | Rake $0.95
Board [9d 6d 9c 6h 8d]
Seat 1: eBrej2jnlUCs/JgxFCRn2g folded before Flop (didn't bet)
Seat 2: pciZn00ZDk4BVBMTTMcNVQ folded before Flop (didn't bet)
Seat 3: xZCXQSXlrZkp3pZizzVXCw folded before Flop (didn't bet)
Seat 4: YRqrX/u38J7aLNNnBzQsjQ (button) showed [Qc Qs] and won ($18.30) with two pair, Queens and Nines
Seat 5: JwvquocWfhTVApN5t47LgA (small blind) folded before Flop
Seat 6: zE9cVigS2nW/Ljy4K4bUQA (big blind) folded before Flop
Seat 7: 90Wb75h3W1BRpbqVnuk8gw showed [As Kh] and lost with two pair, Nines and Sixes
Seat 8: g4k0NXISyLCqaSWZDBjfEg folded before Flop (didn't bet)
Seat 9: J0W5D97jl5VLky+IoPvDeA folded before Flop (didn't bet)



PokerStars Game #59941493302:  Hold'em No Limit ($0.25/$0.50) - 2009/07/01 1:37:09 ET
Table '9ojijpRcYQSQTh6xI+haUA' 2-max Seat #1 is the button
Seat 1: FqpibuVWLNsAN/Z7ROZLnA ($57 in chips)
Seat 2: TitTV+fFCcBZWOERdytydA ($68.30 in chips)
FqpibuVWLNsAN/Z7ROZLnA: posts small blind $0.25
TitTV+fFCcBZWOERdytydA: posts big blind $0.50
*** HOLE CARDS ***
FqpibuVWLNsAN/Z7ROZLnA: calls $0.25
TitTV+fFCcBZWOERdytydA: checks
*** FLOP *** [Jh 4h 2d]
TitTV+fFCcBZWOERdytydA: checks
FqpibuVWLNsAN/Z7ROZLnA: checks
*** TURN *** [Jh 4h 2d] [Th]
TitTV+fFCcBZWOERdytydA: checks
FqpibuVWLNsAN/Z7ROZLnA: bets $1
TitTV+fFCcBZWOERdytydA: folds
FqpibuVWLNsAN/Z7ROZLnA collected $0.95 from pot
*** SUMMARY ***
Total pot $1 | Rake $0.05
Board [Jh 4h 2d Th]
Seat 1: FqpibuVWLNsAN/Z7ROZLnA (button) (small blind) collected ($0.95)
Seat 2: TitTV+fFCcBZWOERdytydA (big blind) folded on the Turn



PokerStars Game #59941493380:  Hold'em No Limit ($0.25/$0.50) - 2009/07/01 1:37:09 ET
Table 'fx6MqwfYAj/Rt86hBz2L3Q' 9-max Seat #8 is the button
Seat 1: v/4aX0ejnaIFK4ftDk2Lyg ($50.15 in chips)
Seat 2: C3rGXblctNcWI6JYPHhaEg ($55 in chips)
Seat 3: iadBi5AEt7gTBXbDSSnMYQ ($43.75 in chips)
Seat 4: VhjwWfxHSx00WxzYih3KOA ($50 in chips)
Seat 6: 5k9fvXD9suIgCxU4HLQjTw ($50 in chips)
Seat 7: mSD1pginDsyHG5PDfqzphw ($11.50 in chips)
Seat 8: 75K2MXwN65Sjfp1yHd50Hg ($12.25 in chips)
Alf.STG will be allowed to play after the button
v/4aX0ejnaIFK4ftDk2Lyg: posts small blind $0.25
C3rGXblctNcWI6JYPHhaEg: posts big blind $0.50
e2+sK/yjnj94rXOKoxPP2A: sits out
*** HOLE CARDS ***
iadBi5AEt7gTBXbDSSnMYQ: raises $1.50 to $2
VhjwWfxHSx00WxzYih3KOA: folds
5k9fvXD9suIgCxU4HLQjTw: folds
mSD1pginDsyHG5PDfqzphw: folds
75K2MXwN65Sjfp1yHd50Hg: folds
v/4aX0ejnaIFK4ftDk2Lyg: folds
C3rGXblctNcWI6JYPHhaEg: calls $1.50
*** FLOP *** [6d 8c 6s]
C3rGXblctNcWI6JYPHhaEg: checks
iadBi5AEt7gTBXbDSSnMYQ: checks
*** TURN *** [6d 8c 6s] [Qs]
C3rGXblctNcWI6JYPHhaEg: checks
iadBi5AEt7gTBXbDSSnMYQ: checks
*** RIVER *** [6d 8c 6s Qs] [Ad]
C3rGXblctNcWI6JYPHhaEg: checks
iadBi5AEt7gTBXbDSSnMYQ: checks
*** SHOW DOWN ***
C3rGXblctNcWI6JYPHhaEg: shows [7c Ts] (a pair of Sixes)
iadBi5AEt7gTBXbDSSnMYQ: shows [Ac Qc] (two pair, Aces and Queens)
iadBi5AEt7gTBXbDSSnMYQ collected $4.05 from pot
*** SUMMARY ***
Total pot $4.25 | Rake $0.20
Board [6d 8c 6s Qs Ad]
Seat 1: v/4aX0ejnaIFK4ftDk2Lyg (small blind) folded before Flop
Seat 2: C3rGXblctNcWI6JYPHhaEg (big blind) showed [7c Ts] and lost with a pair of Sixes
Seat 3: iadBi5AEt7gTBXbDSSnMYQ showed [Ac Qc] and won ($4.05) with two pair, Aces and Queens
Seat 4: VhjwWfxHSx00WxzYih3KOA folded before Flop (didn't bet)
Seat 6: 5k9fvXD9suIgCxU4HLQjTw folded before Flop (didn't bet)
Seat 7: mSD1pginDsyHG5PDfqzphw folded before Flop (didn't bet)
Seat 8: 75K2MXwN65Sjfp1yHd50Hg (button) folded before Flop (didn't bet)



PokerStars Game #59941493946:  Hold'em No Limit ($0.25/$0.50) - 2009/07/01 1:37:10 ET
Table 'B+sqsfj6d6zXicNfaseTaw' 2-max Seat #1 is the button
Seat 1: +4GNcSsecmapVGSdV0mUPA ($146.40 in chips)
Seat 2: Lv5RmpRe6LtPkBzM9Gpo5A ($75.20 in chips)
+4GNcSsecmapVGSdV0mUPA: posts small blind $0.25
Lv5RmpRe6LtPkBzM9Gpo5A: posts big blind $0.50
*** HOLE CARDS ***
+4GNcSsecmapVGSdV0mUPA: calls $0.25
Lv5RmpRe6LtPkBzM9Gpo5A: checks
*** FLOP *** [9d 6c 5d]
Lv5RmpRe6LtPkBzM9Gpo5A: checks
+4GNcSsecmapVGSdV0mUPA: checks
*** TURN *** [9d 6c 5d] [4c]
Lv5RmpRe6LtPkBzM9Gpo5A: checks
+4GNcSsecmapVGSdV0mUPA: checks
*** RIVER *** [9d 6c 5d 4c] [7c]
Lv5RmpRe6LtPkBzM9Gpo5A: checks
+4GNcSsecmapVGSdV0mUPA: checks
*** SHOW DOWN ***
Lv5RmpRe6LtPkBzM9Gpo5A: shows [Qh 3h] (a straight, Three to Seven)
+4GNcSsecmapVGSdV0mUPA: shows [Qc 3s] (a straight, Three to Seven)
Lv5RmpRe6LtPkBzM9Gpo5A collected $0.50 from pot
+4GNcSsecmapVGSdV0mUPA collected $0.45 from pot
*** SUMMARY ***
Total pot $1 | Rake $0.05
Board [9d 6c 5d 4c 7c]
Seat 1: +4GNcSsecmapVGSdV0mUPA (button) (small blind) showed [Qc 3s] and won ($0.45) with a straight, Three to Seven
Seat 2: Lv5RmpRe6LtPkBzM9Gpo5A (big blind) showed [Qh 3h] and won ($0.50) with a straight, Three to Seven



PokerStars Game #59941494430:  Hold'em No Limit ($0.25/$0.50) - 2009/07/01 1:37:11 ET
Table 'BCN5su+SsXiy1zRMJi0SJw' 6-max Seat #2 is the button
Seat 1: GxXV09ciXaOxyY2H5aMIIw ($29.25 in chips)
Seat 2: ehFNAevCQri3trWxV6FJdA ($98.90 in chips)
Seat 3: kwgv5lNhiFrfONXCshzxlA ($71.55 in chips)
Seat 4: bbsK8j+tpuVRhBqDzHxf7w ($49.85 in chips)
Seat 5: kxPhs4ePFqMy52CInAJ2aw ($50.50 in chips)
Seat 6: b2symlOdL7+0c9Pj4N/KlA ($70.30 in chips)
kwgv5lNhiFrfONXCshzxlA: posts small blind $0.25
bbsK8j+tpuVRhBqDzHxf7w: posts big blind $0.50
*** HOLE CARDS ***
kxPhs4ePFqMy52CInAJ2aw: folds
b2symlOdL7+0c9Pj4N/KlA: folds
GxXV09ciXaOxyY2H5aMIIw: folds
ehFNAevCQri3trWxV6FJdA: folds
kwgv5lNhiFrfONXCshzxlA: folds
bbsK8j+tpuVRhBqDzHxf7w collected $0.50 from pot
bbsK8j+tpuVRhBqDzHxf7w: doesn't show hand
*** SUMMARY ***
Total pot $0.50 | Rake $0
Seat 1: GxXV09ciXaOxyY2H5aMIIw folded before Flop (didn't bet)
Seat 2: ehFNAevCQri3trWxV6FJdA (button) folded before Flop (didn't bet)
Seat 3: kwgv5lNhiFrfONXCshzxlA (small blind) folded before Flop
Seat 4: bbsK8j+tpuVRhBqDzHxf7w (big blind) collected ($0.50)
Seat 5: kxPhs4ePFqMy52CInAJ2aw folded before Flop (didn't bet)
Seat 6: b2symlOdL7+0c9Pj4N/KlA folded before Flop (didn't bet)



PokerStars Game #59941494896:  Hold'em No Limit ($0.25/$0.50) - 2009/07/01 1:37:12 ET
Table '1pi9mHyVuXF/uue+aPQc4w' 9-max Seat #7 is the button
Seat 2: vHYT5s323LpajBj+2c9zbQ ($23.90 in chips)
Seat 3: HZkVla4kK2SI42CVrPZ/ig ($10 in chips)
Seat 4: mSD1pginDsyHG5PDfqzphw ($14.80 in chips)
Seat 5: zE9cVigS2nW/Ljy4K4bUQA ($30.65 in chips)
Seat 6: 1xBtrSVBbgFH/viUWKqQeg ($46.70 in chips)
Seat 7: 61sfw5QTu62YYIt68OsdrA ($33.55 in chips)
Seat 8: g4k0NXISyLCqaSWZDBjfEg ($97.30 in chips)
Seat 9: Q/gZC63lfOMr7YhWKPCxoQ ($9.70 in chips)
g4k0NXISyLCqaSWZDBjfEg: posts small blind $0.25
Q/gZC63lfOMr7YhWKPCxoQ: posts big blind $0.50
M+D23GG26WXQ/2gyjREVOQ: sits out
*** HOLE CARDS ***
vHYT5s323LpajBj+2c9zbQ: folds
HZkVla4kK2SI42CVrPZ/ig: folds
mSD1pginDsyHG5PDfqzphw: folds
zE9cVigS2nW/Ljy4K4bUQA: folds
1xBtrSVBbgFH/viUWKqQeg: folds
61sfw5QTu62YYIt68OsdrA: folds
g4k0NXISyLCqaSWZDBjfEg: folds
Q/gZC63lfOMr7YhWKPCxoQ collected $0.50 from pot
Q/gZC63lfOMr7YhWKPCxoQ: doesn't show hand
*** SUMMARY ***
Total pot $0.50 | Rake $0
Seat 2: vHYT5s323LpajBj+2c9zbQ folded before Flop (didn't bet)
Seat 3: HZkVla4kK2SI42CVrPZ/ig folded before Flop (didn't bet)
Seat 4: mSD1pginDsyHG5PDfqzphw folded before Flop (didn't bet)
Seat 5: zE9cVigS2nW/Ljy4K4bUQA folded before Flop (didn't bet)
Seat 6: 1xBtrSVBbgFH/viUWKqQeg folded before Flop (didn't bet)
Seat 7: 61sfw5QTu62YYIt68OsdrA (button) folded before Flop (didn't bet)
Seat 8: g4k0NXISyLCqaSWZDBjfEg (small blind) folded before Flop
Seat 9: Q/gZC63lfOMr7YhWKPCxoQ (big blind) collected ($0.50)



PokerStars Game #59941496424:  Hold'em No Limit ($0.25/$0.50) - 2009/07/01 1:37:14 ET
Table 'Wwfm5/i+g/g2Nj2gT3jnVQ' 2-max Seat #1 is the button
Seat 1: CHRLZDaaxjbo68bwQD1C/Q ($12.95 in chips)
Seat 2: PKuuhUvIr5WSkJyPJa9dFw ($17.30 in chips)
CHRLZDaaxjbo68bwQD1C/Q: posts small blind $0.25
PKuuhUvIr5WSkJyPJa9dFw: posts big blind $0.50
*** HOLE CARDS ***
CHRLZDaaxjbo68bwQD1C/Q: folds
PKuuhUvIr5WSkJyPJa9dFw collected $0.50 from pot
PKuuhUvIr5WSkJyPJa9dFw: doesn't show hand
*** SUMMARY ***
Total pot $0.50 | Rake $0
Seat 1: CHRLZDaaxjbo68bwQD1C/Q (button) (small blind) folded before Flop
Seat 2: PKuuhUvIr5WSkJyPJa9dFw (big blind) collected ($0.50)



PokerStars Game #59941496060:  Hold'em No Limit ($0.25/$0.50) - 2009/07/01 1:37:14 ET
Table 'lSisgp6H7Fg1hH5VfjEjYQ' 9-max Seat #6 is the button
Seat 1: 5k9fvXD9suIgCxU4HLQjTw ($54.05 in chips)
Seat 2: 5acK4E7fzEwnplVBZ6eNWA ($50 in chips)
Seat 3: SKnJuWHScqetA/qG5p+wCg ($30 in chips)
Seat 4: FFVKBJT0lZf+jFlgvy7ang ($39.50 in chips)
Seat 5: mSD1pginDsyHG5PDfqzphw ($16.75 in chips)
Seat 6: +k7T5ocke8UwavtgUHm+Cg ($74.45 in chips)
Seat 7: IDtNLR9uFCDdjNsJWMHA5Q ($20.55 in chips)
Seat 8: a4JDWmpFQkL10XfAyuF51A ($10.25 in chips)
Seat 9: YzeKFbJVLmJGTgNH3ySQlw ($2.90 in chips)
IDtNLR9uFCDdjNsJWMHA5Q: posts small blind $0.25
a4JDWmpFQkL10XfAyuF51A: posts big blind $0.50
*** HOLE CARDS ***
YzeKFbJVLmJGTgNH3ySQlw has timed out
YzeKFbJVLmJGTgNH3ySQlw: folds
YzeKFbJVLmJGTgNH3ySQlw is sitting out
5k9fvXD9suIgCxU4HLQjTw: folds
5acK4E7fzEwnplVBZ6eNWA: folds
SKnJuWHScqetA/qG5p+wCg: folds
FFVKBJT0lZf+jFlgvy7ang: folds
mSD1pginDsyHG5PDfqzphw: folds
+k7T5ocke8UwavtgUHm+Cg: folds
IDtNLR9uFCDdjNsJWMHA5Q: calls $0.25
a4JDWmpFQkL10XfAyuF51A: checks
*** FLOP *** [5d Ad 3h]
IDtNLR9uFCDdjNsJWMHA5Q: checks
a4JDWmpFQkL10XfAyuF51A: checks
*** TURN *** [5d Ad 3h] [Ah]
IDtNLR9uFCDdjNsJWMHA5Q: checks
a4JDWmpFQkL10XfAyuF51A: checks
*** RIVER *** [5d Ad 3h Ah] [Tc]
IDtNLR9uFCDdjNsJWMHA5Q: checks
a4JDWmpFQkL10XfAyuF51A: checks
*** SHOW DOWN ***
IDtNLR9uFCDdjNsJWMHA5Q: shows [Qd 8d] (a pair of Aces)
a4JDWmpFQkL10XfAyuF51A: shows [5s Jh] (two pair, Aces and Fives)
a4JDWmpFQkL10XfAyuF51A collected $0.95 from pot
*** SUMMARY ***
Total pot $1 | Rake $0.05
Board [5d Ad 3h Ah Tc]
Seat 1: 5k9fvXD9suIgCxU4HLQjTw folded before Flop (didn't bet)
Seat 2: 5acK4E7fzEwnplVBZ6eNWA folded before Flop (didn't bet)
Seat 3: SKnJuWHScqetA/qG5p+wCg folded before Flop (didn't bet)
Seat 4: FFVKBJT0lZf+jFlgvy7ang folded before Flop (didn't bet)
Seat 5: mSD1pginDsyHG5PDfqzphw folded before Flop (didn't bet)
Seat 6: +k7T5ocke8UwavtgUHm+Cg (button) folded before Flop (didn't bet)
Seat 7: IDtNLR9uFCDdjNsJWMHA5Q (small blind) showed [Qd 8d] and lost with a pair of Aces
Seat 8: a4JDWmpFQkL10XfAyuF51A (big blind) showed [5s Jh] and won ($0.95) with two pair, Aces and Fives
Seat 9: YzeKFbJVLmJGTgNH3ySQlw folded before Flop (didn't bet)



PokerStars Game #59941497632:  Hold'em No Limit ($0.25/$0.50) - 2009/07/01 1:37:16 ET
Table '2lPOwetm4cfkZPbTmGPH/w' 2-max Seat #2 is the button
Seat 1: vUGdApqS8J/GJE2gaVWl1w ($16.20 in chips)
Seat 2: XFa6sBGjP2gxoIvxR3fZIg ($22.05 in chips)
XFa6sBGjP2gxoIvxR3fZIg: posts small blind $0.25
vUGdApqS8J/GJE2gaVWl1w: posts big blind $0.50
*** HOLE CARDS ***
XFa6sBGjP2gxoIvxR3fZIg: calls $0.25
vUGdApqS8J/GJE2gaVWl1w: checks
*** FLOP *** [2s 6d Kd]
vUGdApqS8J/GJE2gaVWl1w: bets $0.50
XFa6sBGjP2gxoIvxR3fZIg: calls $0.50
*** TURN *** [2s 6d Kd] [8d]
vUGdApqS8J/GJE2gaVWl1w: checks
XFa6sBGjP2gxoIvxR3fZIg: checks
*** RIVER *** [2s 6d Kd 8d] [9d]
vUGdApqS8J/GJE2gaVWl1w: bets $0.50
XFa6sBGjP2gxoIvxR3fZIg: calls $0.50
*** SHOW DOWN ***
vUGdApqS8J/GJE2gaVWl1w: shows [6c Jd] (a flush, King high)
XFa6sBGjP2gxoIvxR3fZIg: mucks hand
vUGdApqS8J/GJE2gaVWl1w collected $2.90 from pot
*** SUMMARY ***
Total pot $3 | Rake $0.10
Board [2s 6d Kd 8d 9d]
Seat 1: vUGdApqS8J/GJE2gaVWl1w (big blind) showed [6c Jd] and won ($2.90) with a flush, King high
Seat 2: XFa6sBGjP2gxoIvxR3fZIg (button) (small blind) mucked



PokerStars Game #59941498658:  Hold'em No Limit ($0.25/$0.50) - 2009/07/01 1:37:18 ET
Table 'tyR5AZNKV8Aadbrnrnlg7g' 6-max Seat #4 is the button
Seat 1: BgOXYI0yYSN1ULC4FqsNkg ($75.55 in chips)
Seat 2: BAjwVL+zKKd0s0fAWstzQQ ($14.80 in chips)
Seat 3: JFLrYNyQmwPhRQAtoSAuyA ($60.85 in chips)
Seat 4: 4QfsCWthT/vSLirorNXqtg ($84.95 in chips)
Seat 5: GUnvMULl2qFOO1yenu1UBw ($80.60 in chips)
Seat 6: 498aWaGsW4uGfuWl+2FCGw ($65.35 in chips)
GUnvMULl2qFOO1yenu1UBw: posts small blind $0.25
498aWaGsW4uGfuWl+2FCGw: posts big blind $0.50
*** HOLE CARDS ***
BgOXYI0yYSN1ULC4FqsNkg: folds
BAjwVL+zKKd0s0fAWstzQQ: calls $0.50
JFLrYNyQmwPhRQAtoSAuyA: folds
4QfsCWthT/vSLirorNXqtg: calls $0.50
GUnvMULl2qFOO1yenu1UBw: folds
498aWaGsW4uGfuWl+2FCGw: raises $1.50 to $2
BAjwVL+zKKd0s0fAWstzQQ: calls $1.50
4QfsCWthT/vSLirorNXqtg: calls $1.50
*** FLOP *** [Jd 9c Qc]
498aWaGsW4uGfuWl+2FCGw: bets $2.50
BAjwVL+zKKd0s0fAWstzQQ: raises $10.30 to $12.80 and is all-in
4QfsCWthT/vSLirorNXqtg: folds
498aWaGsW4uGfuWl+2FCGw: calls $10.30
*** TURN *** [Jd 9c Qc] [3h]
*** RIVER *** [Jd 9c Qc 3h] [6s]
*** SHOW DOWN ***
498aWaGsW4uGfuWl+2FCGw: shows [Qh Ac] (a pair of Queens)
BAjwVL+zKKd0s0fAWstzQQ: mucks hand
498aWaGsW4uGfuWl+2FCGw collected $30.30 from pot
*** SUMMARY ***
Total pot $31.85 | Rake $1.55
Board [Jd 9c Qc 3h 6s]
Seat 1: BgOXYI0yYSN1ULC4FqsNkg folded before Flop (didn't bet)
Seat 2: BAjwVL+zKKd0s0fAWstzQQ mucked
Seat 3: JFLrYNyQmwPhRQAtoSAuyA folded before Flop (didn't bet)
Seat 4: 4QfsCWthT/vSLirorNXqtg (button) folded on the Flop
Seat 5: GUnvMULl2qFOO1yenu1UBw (small blind) folded before Flop
Seat 6: 498aWaGsW4uGfuWl+2FCGw (big blind) showed [Qh Ac] and won ($30.30) with a pair of Queens



PokerStars Game #59941499748:  Hold'em No Limit ($0.25/$0.50) - 2009/07/01 1:37:20 ET
Table 'kgbJRsxfv64KrErDRBAkcw' 6-max Seat #4 is the button
Seat 1: VamsyhlFzXGF6/ydo0BHeA ($17.50 in chips)
Seat 2: AdS8BJMOheS01zjCDfPMFg ($79.30 in chips)
Seat 3: c4MNIaIyPMOMxrgT8FT5nA ($153 in chips)
Seat 4: 2igtJLmvIZ+HqX4XPgMPZA ($111.75 in chips)
Seat 5: eUBBn2R56C1IQ6Cs/vitwg ($106.25 in chips)
Seat 6: 1b+2BbjMN8qhR1WPqdE9VQ ($50 in chips)
eUBBn2R56C1IQ6Cs/vitwg: posts small blind $0.25
1b+2BbjMN8qhR1WPqdE9VQ: posts big blind $0.50
*** HOLE CARDS ***
VamsyhlFzXGF6/ydo0BHeA: calls $0.50
AdS8BJMOheS01zjCDfPMFg: folds
c4MNIaIyPMOMxrgT8FT5nA: raises $2 to $2.50
2igtJLmvIZ+HqX4XPgMPZA: folds
eUBBn2R56C1IQ6Cs/vitwg: folds
1b+2BbjMN8qhR1WPqdE9VQ: folds
VamsyhlFzXGF6/ydo0BHeA: calls $2
*** FLOP *** [Qc 4s Td]
VamsyhlFzXGF6/ydo0BHeA: checks
c4MNIaIyPMOMxrgT8FT5nA: bets $3.50
VamsyhlFzXGF6/ydo0BHeA: folds
c4MNIaIyPMOMxrgT8FT5nA collected $5.50 from pot
*** SUMMARY ***
Total pot $5.75 | Rake $0.25
Board [Qc 4s Td]
Seat 1: VamsyhlFzXGF6/ydo0BHeA folded on the Flop
Seat 2: AdS8BJMOheS01zjCDfPMFg folded before Flop (didn't bet)
Seat 3: c4MNIaIyPMOMxrgT8FT5nA collected ($5.50)
Seat 4: 2igtJLmvIZ+HqX4XPgMPZA (button) folded before Flop (didn't bet)
Seat 5: eUBBn2R56C1IQ6Cs/vitwg (small blind) folded before Flop
Seat 6: 1b+2BbjMN8qhR1WPqdE9VQ (big blind) folded before Flop



PokerStars Game #59941499612:  Hold'em No Limit ($0.25/$0.50) - 2009/07/01 1:37:20 ET
Table 'hWT2kq66tnKEpD26cia6fQ' 2-max Seat #1 is the button
Seat 1: Ce3KNFP+ao7Da9NHb65raw ($30.05 in chips)
Seat 2: 16tvT7AYgZ2LgiGFcvFKQg ($44.50 in chips)
Ce3KNFP+ao7Da9NHb65raw: posts small blind $0.25
16tvT7AYgZ2LgiGFcvFKQg: posts big blind $0.50
*** HOLE CARDS ***
Ce3KNFP+ao7Da9NHb65raw: folds
16tvT7AYgZ2LgiGFcvFKQg collected $0.50 from pot
*** SUMMARY ***
Total pot $0.50 | Rake $0
Seat 1: Ce3KNFP+ao7Da9NHb65raw (button) (small blind) folded before Flop
Seat 2: 16tvT7AYgZ2LgiGFcvFKQg (big blind) collected ($0.50)



PokerStars Game #59941499652:  Hold'em No Limit ($0.25/$0.50) - 2009/07/01 1:37:20 ET
Table 'ofnd8S4IdIPph1Cbn+x7hAbR5MkGhKEbz+X2bpfpu11Qmax Seat #2 is the button
Seat 1: qG3y+yB3IhWjAWO8gvk6Rg ($45.05 in chips)
Seat 2: 1xBtrSVBbgFH/viUWKqQeg ($38.05 in chips)
Seat 4: mZNMJI1mY40XTC0U7GZakA ($62.45 in chips)
Seat 5: 2YaCb/8u1SesrR+963XiZA ($10 in chips)
Seat 6: 0Bw1Gb5YC/Xvb0SqVawKUw ($9.50 in chips)
Seat 7: kJ06FP2Jc7cSdmywwvYOXw ($63.35 in chips)
Seat 8: R354x4oZnQcGCDV6GhjnpQ ($65.30 in chips)
Seat 9: 75K2MXwN65Sjfp1yHd50Hg ($10 in chips)
mZNMJI1mY40XTC0U7GZakA: posts small blind $0.25
2YaCb/8u1SesrR+963XiZA: posts big blind $0.50
0Bw1Gb5YC/Xvb0SqVawKUw: posts small & big blinds $0.75
*** HOLE CARDS ***
0Bw1Gb5YC/Xvb0SqVawKUw: checks
kJ06FP2Jc7cSdmywwvYOXw: folds
R354x4oZnQcGCDV6GhjnpQ: folds
UVJbBPbDwNMEZadZB9WVmg has returned
75K2MXwN65Sjfp1yHd50Hg: folds
qG3y+yB3IhWjAWO8gvk6Rg: calls $0.50
1xBtrSVBbgFH/viUWKqQeg: folds
mZNMJI1mY40XTC0U7GZakA: folds
2YaCb/8u1SesrR+963XiZA: checks
*** FLOP *** [Jd 4h Ad]
2YaCb/8u1SesrR+963XiZA: checks
0Bw1Gb5YC/Xvb0SqVawKUw: checks
qG3y+yB3IhWjAWO8gvk6Rg: checks
*** TURN *** [Jd 4h Ad] [Kd]
2YaCb/8u1SesrR+963XiZA: bets $0.50
0Bw1Gb5YC/Xvb0SqVawKUw: calls $0.50
qG3y+yB3IhWjAWO8gvk6Rg: folds
*** RIVER *** [Jd 4h Ad Kd] [3s]
qG3y+yB3IhWjAWO8gvk6Rg leaves the table
2YaCb/8u1SesrR+963XiZA: bets $1
0Bw1Gb5YC/Xvb0SqVawKUw: folds
2YaCb/8u1SesrR+963XiZA collected $2.90 from pot
2YaCb/8u1SesrR+963XiZA: doesn't show hand
*** SUMMARY ***
Total pot $3 | Rake $0.10
Board [Jd 4h Ad Kd 3s]
Seat 1: qG3y+yB3IhWjAWO8gvk6Rg folded on the Turn
Seat 2: 1xBtrSVBbgFH/viUWKqQeg (button) folded before Flop (didn't bet)
Seat 4: mZNMJI1mY40XTC0U7GZakA (small blind) folded before Flop
Seat 5: 2YaCb/8u1SesrR+963XiZA (big blind) collected ($2.90)
Seat 6: 0Bw1Gb5YC/Xvb0SqVawKUw folded on the River
Seat 7: kJ06FP2Jc7cSdmywwvYOXw folded before Flop (didn't bet)
Seat 8: R354x4oZnQcGCDV6GhjnpQ folded before Flop (didn't bet)
Seat 9: 75K2MXwN65Sjfp1yHd50Hg folded before Flop (didn't bet)



PokerStars Game #59941499416:  Hold'em No Limit ($0.25/$0.50) - 2009/07/01 1:37:20 ET
Table 'Nz0Vr7WMHL2g5Uk7dDZjpw' 9-max Seat #7 is the button
Seat 1: 9yMsdgReyOUerNsmTYCCDQ ($9 in chips)
Seat 2: SegjDnMxWMujiD57ESNL+g ($20.35 in chips)
Seat 3: c638Xxo+q5F/t5qMtmvmvQ ($50.65 in chips)
Seat 4: uw9QayAAxLM3Hb+HR7mSkg ($9.25 in chips)
Seat 5: WGW0DgjBUXs1ylURHG8vnQ ($13.55 in chips)
Seat 6: 997ViqAtWn1FPjJqcffwcA ($53.75 in chips)
Seat 7: KPLH0gELgFe2OuAnhJFI5w ($25 in chips)
Seat 8: aoL+R/61Kxmw69ypuPrWAQ ($28.80 in chips)
Seat 9: mSD1pginDsyHG5PDfqzphw ($17.25 in chips)
aoL+R/61Kxmw69ypuPrWAQ: posts small blind $0.25
mSD1pginDsyHG5PDfqzphw: posts big blind $0.50
*** HOLE CARDS ***
9yMsdgReyOUerNsmTYCCDQ: folds
SegjDnMxWMujiD57ESNL+g: folds
c638Xxo+q5F/t5qMtmvmvQ: raises $1.50 to $2
uw9QayAAxLM3Hb+HR7mSkg: folds
WGW0DgjBUXs1ylURHG8vnQ: folds
997ViqAtWn1FPjJqcffwcA: folds
KPLH0gELgFe2OuAnhJFI5w: folds
aoL+R/61Kxmw69ypuPrWAQ: folds
mSD1pginDsyHG5PDfqzphw: folds
c638Xxo+q5F/t5qMtmvmvQ collected $1.25 from pot
c638Xxo+q5F/t5qMtmvmvQ: doesn't show hand
*** SUMMARY ***
Total pot $1.25 | Rake $0
Seat 1: 9yMsdgReyOUerNsmTYCCDQ folded before Flop (didn't bet)
Seat 2: SegjDnMxWMujiD57ESNL+g folded before Flop (didn't bet)
Seat 3: c638Xxo+q5F/t5qMtmvmvQ collected ($1.25)
Seat 4: uw9QayAAxLM3Hb+HR7mSkg folded before Flop (didn't bet)
Seat 5: WGW0DgjBUXs1ylURHG8vnQ folded before Flop (didn't bet)
Seat 6: 997ViqAtWn1FPjJqcffwcA folded before Flop (didn't bet)
Seat 7: KPLH0gELgFe2OuAnhJFI5w (button) folded before Flop (didn't bet)
Seat 8: aoL+R/61Kxmw69ypuPrWAQ (small blind) folded before Flop
Seat 9: mSD1pginDsyHG5PDfqzphw (big blind) folded before Flop



PokerStars Game #59941500080:  Hold'em No Limit ($0.25/$0.50) - 2009/07/01 1:37:21 ET
Table 'Wwfm5/i+g/g2Nj2gT3jnVQ' 2-max Seat #2 is the button
Seat 1: CHRLZDaaxjbo68bwQD1C/Q ($12.70 in chips)
Seat 2: PKuuhUvIr5WSkJyPJa9dFw ($17.55 in chips)
PKuuhUvIr5WSkJyPJa9dFw: posts small blind $0.25
CHRLZDaaxjbo68bwQD1C/Q: posts big blind $0.50
*** HOLE CARDS ***
PKuuhUvIr5WSkJyPJa9dFw: raises $1.50 to $2
CHRLZDaaxjbo68bwQD1C/Q: calls $1.50
*** FLOP *** [2h Kc Js]
CHRLZDaaxjbo68bwQD1C/Q: checks
PKuuhUvIr5WSkJyPJa9dFw: bets $1.50
CHRLZDaaxjbo68bwQD1C/Q: calls $1.50
*** TURN *** [2h Kc Js] [5h]
CHRLZDaaxjbo68bwQD1C/Q: checks
PKuuhUvIr5WSkJyPJa9dFw: bets $2
CHRLZDaaxjbo68bwQD1C/Q: calls $2
*** RIVER *** [2h Kc Js 5h] [4h]
CHRLZDaaxjbo68bwQD1C/Q: checks
PKuuhUvIr5WSkJyPJa9dFw: checks
*** SHOW DOWN ***
CHRLZDaaxjbo68bwQD1C/Q: shows [Jd 9s] (a pair of Jacks)
PKuuhUvIr5WSkJyPJa9dFw: shows [Qs Qc] (a pair of Queens)
PKuuhUvIr5WSkJyPJa9dFw collected $10.50 from pot
*** SUMMARY ***
Total pot $11 | Rake $0.50
Board [2h Kc Js 5h 4h]
Seat 1: CHRLZDaaxjbo68bwQD1C/Q (big blind) showed [Jd 9s] and lost with a pair of Jacks
Seat 2: PKuuhUvIr5WSkJyPJa9dFw (button) (small blind) showed [Qs Qc] and won ($10.50) with a pair of Queens



PokerStars Game #59941501618:  Hold'em No Limit ($0.25/$0.50) - 2009/07/01 1:37:24 ET
Table '3FhG0gl3kMX3wBEEqj+wnQ' 9-max Seat #5 is the button
Seat 1: bxLSulbgr8LmKNjOzw8URg ($48.50 in chips)
Seat 3: YXCE3WOZi8g2sIf3y/plVw ($61.55 in chips)
Seat 4: e2+sK/yjnj94rXOKoxPP2A ($68.75 in chips)
Seat 5: XcLXSUMHSpshK/7Lh0M4Vg ($10.30 in chips)
Seat 6: 997ViqAtWn1FPjJqcffwcA ($109.30 in chips)
Seat 7: mSD1pginDsyHG5PDfqzphw ($20.45 in chips)
Seat 8: j3K/Jujr7PY4ZM2RZvlH6A ($50.90 in chips)
Seat 9: KA0tkubTlbhmo4ju+qgXPg ($44.35 in chips)
997ViqAtWn1FPjJqcffwcA: posts small blind $0.25
mSD1pginDsyHG5PDfqzphw: posts big blind $0.50
HZkVla4kK2SI42CVrPZ/ig: sits out
*** HOLE CARDS ***
j3K/Jujr7PY4ZM2RZvlH6A: folds
KA0tkubTlbhmo4ju+qgXPg: folds
bxLSulbgr8LmKNjOzw8URg: folds
YXCE3WOZi8g2sIf3y/plVw: folds
e2+sK/yjnj94rXOKoxPP2A: folds
XcLXSUMHSpshK/7Lh0M4Vg: raises $1 to $1.50
997ViqAtWn1FPjJqcffwcA: folds
mSD1pginDsyHG5PDfqzphw: folds
XcLXSUMHSpshK/7Lh0M4Vg collected $1.25 from pot
XcLXSUMHSpshK/7Lh0M4Vg: doesn't show hand
*** SUMMARY ***
Total pot $1.25 | Rake $0
Seat 1: bxLSulbgr8LmKNjOzw8URg folded before Flop (didn't bet)
Seat 3: YXCE3WOZi8g2sIf3y/plVw folded before Flop (didn't bet)
Seat 4: e2+sK/yjnj94rXOKoxPP2A folded before Flop (didn't bet)
Seat 5: XcLXSUMHSpshK/7Lh0M4Vg (button) collected ($1.25)
Seat 6: 997ViqAtWn1FPjJqcffwcA (small blind) folded before Flop
Seat 7: mSD1pginDsyHG5PDfqzphw (big blind) folded before Flop
Seat 8: j3K/Jujr7PY4ZM2RZvlH6A folded before Flop (didn't bet)
Seat 9: KA0tkubTlbhmo4ju+qgXPg folded before Flop (didn't bet)



PokerStars Game #59941502564:  Hold'em No Limit ($0.25/$0.50) - 2009/07/01 1:37:25 ET
Table 'hWT2kq66tnKEpD26cia6fQ' 2-max Seat #2 is the button
Seat 1: Ce3KNFP+ao7Da9NHb65raw ($29.80 in chips)
Seat 2: 16tvT7AYgZ2LgiGFcvFKQg ($44.75 in chips)
16tvT7AYgZ2LgiGFcvFKQg: posts small blind $0.25
Ce3KNFP+ao7Da9NHb65raw: posts big blind $0.50
*** HOLE CARDS ***
16tvT7AYgZ2LgiGFcvFKQg: raises $0.50 to $1
Ce3KNFP+ao7Da9NHb65raw: calls $0.50
*** FLOP *** [Qh Ks 6c]
Ce3KNFP+ao7Da9NHb65raw: checks
16tvT7AYgZ2LgiGFcvFKQg: bets $0.50
Ce3KNFP+ao7Da9NHb65raw: calls $0.50
*** TURN *** [Qh Ks 6c] [7d]
Ce3KNFP+ao7Da9NHb65raw: checks
16tvT7AYgZ2LgiGFcvFKQg: bets $0.50
Ce3KNFP+ao7Da9NHb65raw: calls $0.50
*** RIVER *** [Qh Ks 6c 7d] [3h]
Ce3KNFP+ao7Da9NHb65raw: checks
16tvT7AYgZ2LgiGFcvFKQg: checks
*** SHOW DOWN ***
Ce3KNFP+ao7Da9NHb65raw: shows [Ac 9c] (high card Ace)
16tvT7AYgZ2LgiGFcvFKQg: shows [6s 9h] (a pair of Sixes)
16tvT7AYgZ2LgiGFcvFKQg collected $3.85 from pot
*** SUMMARY ***
Total pot $4 | Rake $0.15
Board [Qh Ks 6c 7d 3h]
Seat 1: Ce3KNFP+ao7Da9NHb65raw (big blind) showed [Ac 9c] and lost with high card Ace
Seat 2: 16tvT7AYgZ2LgiGFcvFKQg (button) (small blind) showed [6s 9h] and won ($3.85) with a pair of Sixes



PokerStars Game #59941504208:  Hold'em No Limit ($0.25/$0.50) - 2009/07/01 1:37:29 ET
Table 'BCN5su+SsXiy1zRMJi0SJw' 6-max Seat #3 is the button
Seat 1: GxXV09ciXaOxyY2H5aMIIw ($29.25 in chips)
Seat 2: ehFNAevCQri3trWxV6FJdA ($98.90 in chips)
Seat 3: kwgv5lNhiFrfONXCshzxlA ($71.30 in chips)
Seat 4: bbsK8j+tpuVRhBqDzHxf7w ($50.10 in chips)
Seat 5: kxPhs4ePFqMy52CInAJ2aw ($50.50 in chips)
Seat 6: b2symlOdL7+0c9Pj4N/KlA ($70.30 in chips)
bbsK8j+tpuVRhBqDzHxf7w: posts small blind $0.25
kxPhs4ePFqMy52CInAJ2aw: posts big blind $0.50
*** HOLE CARDS ***
b2symlOdL7+0c9Pj4N/KlA: folds
GxXV09ciXaOxyY2H5aMIIw: folds
ehFNAevCQri3trWxV6FJdA: calls $0.50
kwgv5lNhiFrfONXCshzxlA: folds
bbsK8j+tpuVRhBqDzHxf7w: folds
kxPhs4ePFqMy52CInAJ2aw: checks
*** FLOP *** [Jc Ac Kh]
kxPhs4ePFqMy52CInAJ2aw: checks
ehFNAevCQri3trWxV6FJdA: checks
*** TURN *** [Jc Ac Kh] [4s]
kxPhs4ePFqMy52CInAJ2aw: checks
ehFNAevCQri3trWxV6FJdA: checks
*** RIVER *** [Jc Ac Kh 4s] [3h]
kxPhs4ePFqMy52CInAJ2aw: checks
ehFNAevCQri3trWxV6FJdA: checks
*** SHOW DOWN ***
kxPhs4ePFqMy52CInAJ2aw: shows [2h 8d] (high card Ace)
ehFNAevCQri3trWxV6FJdA: shows [7d Qs] (high card Ace - King+Queen kicker)
ehFNAevCQri3trWxV6FJdA collected $1.20 from pot
*** SUMMARY ***
Total pot $1.25 | Rake $0.05
Board [Jc Ac Kh 4s 3h]
Seat 1: GxXV09ciXaOxyY2H5aMIIw folded before Flop (didn't bet)
Seat 2: ehFNAevCQri3trWxV6FJdA showed [7d Qs] and won ($1.20) with high card Ace
Seat 3: kwgv5lNhiFrfONXCshzxlA (button) folded before Flop (didn't bet)
Seat 4: bbsK8j+tpuVRhBqDzHxf7w (small blind) folded before Flop
Seat 5: kxPhs4ePFqMy52CInAJ2aw (big blind) showed [2h 8d] and lost with high card Ace
Seat 6: b2symlOdL7+0c9Pj4N/KlA folded before Flop (didn't bet)



PokerStars Game #59941504492:  Hold'em No Limit ($0.25/$0.50) - 2009/07/01 1:37:29 ET
Table '1pi9mHyVuXF/uue+aPQc4w' 9-max Seat #8 is the button
Seat 1: M+D23GG26WXQ/2gyjREVOQ ($50 in chips)
Seat 2: vHYT5s323LpajBj+2c9zbQ ($23.90 in chips)
Seat 3: HZkVla4kK2SI42CVrPZ/ig ($10 in chips)
Seat 4: mSD1pginDsyHG5PDfqzphw ($14.80 in chips)
Seat 5: zE9cVigS2nW/Ljy4K4bUQA ($30.65 in chips)
Seat 6: 1xBtrSVBbgFH/viUWKqQeg ($46.70 in chips)
Seat 7: 61sfw5QTu62YYIt68OsdrA ($33.55 in chips)
Seat 8: g4k0NXISyLCqaSWZDBjfEg ($97.05 in chips)
Seat 9: Q/gZC63lfOMr7YhWKPCxoQ ($9.95 in chips)
Q/gZC63lfOMr7YhWKPCxoQ: posts small blind $0.25
M+D23GG26WXQ/2gyjREVOQ: posts big blind $0.50
*** HOLE CARDS ***
vHYT5s323LpajBj+2c9zbQ: folds
HZkVla4kK2SI42CVrPZ/ig: raises $1 to $1.50
mSD1pginDsyHG5PDfqzphw: folds
zE9cVigS2nW/Ljy4K4bUQA: folds
1xBtrSVBbgFH/viUWKqQeg: folds
61sfw5QTu62YYIt68OsdrA: folds
g4k0NXISyLCqaSWZDBjfEg: folds
Q/gZC63lfOMr7YhWKPCxoQ: folds
M+D23GG26WXQ/2gyjREVOQ: folds
HZkVla4kK2SI42CVrPZ/ig collected $1.25 from pot
HZkVla4kK2SI42CVrPZ/ig: doesn't show hand
*** SUMMARY ***
Total pot $1.25 | Rake $0
Seat 1: M+D23GG26WXQ/2gyjREVOQ (big blind) folded before Flop
Seat 2: vHYT5s323LpajBj+2c9zbQ folded before Flop (didn't bet)
Seat 3: HZkVla4kK2SI42CVrPZ/ig collected ($1.25)
Seat 4: mSD1pginDsyHG5PDfqzphw folded before Flop (didn't bet)
Seat 5: zE9cVigS2nW/Ljy4K4bUQA folded before Flop (didn't bet)
Seat 6: 1xBtrSVBbgFH/viUWKqQeg folded before Flop (didn't bet)
Seat 7: 61sfw5QTu62YYIt68OsdrA folded before Flop (didn't bet)
Seat 8: g4k0NXISyLCqaSWZDBjfEg (button) folded before Flop (didn't bet)
Seat 9: Q/gZC63lfOMr7YhWKPCxoQ (small blind) folded before Flop



PokerStars Game #59941505486:  Hold'em No Limit ($0.25/$0.50) - 2009/07/01 1:37:31 ET
Table '9ojijpRcYQSQTh6xI+haUA' 2-max Seat #2 is the button
Seat 1: FqpibuVWLNsAN/Z7ROZLnA ($57.45 in chips)
Seat 2: TitTV+fFCcBZWOERdytydA ($67.80 in chips)
TitTV+fFCcBZWOERdytydA: posts small blind $0.25
FqpibuVWLNsAN/Z7ROZLnA: posts big blind $0.50
*** HOLE CARDS ***
TitTV+fFCcBZWOERdytydA: raises $1 to $1.50
FqpibuVWLNsAN/Z7ROZLnA: raises $1 to $2.50
TitTV+fFCcBZWOERdytydA: calls $1
*** FLOP *** [Qc 7d 2c]
FqpibuVWLNsAN/Z7ROZLnA: checks
TitTV+fFCcBZWOERdytydA: checks
*** TURN *** [Qc 7d 2c] [Jd]
FqpibuVWLNsAN/Z7ROZLnA: checks
TitTV+fFCcBZWOERdytydA: checks
*** RIVER *** [Qc 7d 2c Jd] [Tc]
FqpibuVWLNsAN/Z7ROZLnA: bets $4
TitTV+fFCcBZWOERdytydA: calls $4
*** SHOW DOWN ***
FqpibuVWLNsAN/Z7ROZLnA: shows [Ah Ks] (a straight, Ten to Ace)
TitTV+fFCcBZWOERdytydA: mucks hand
FqpibuVWLNsAN/Z7ROZLnA collected $12.50 from pot
*** SUMMARY ***
Total pot $13 | Rake $0.50
Board [Qc 7d 2c Jd Tc]
Seat 1: FqpibuVWLNsAN/Z7ROZLnA (big blind) showed [Ah Ks] and won ($12.50) with a straight, Ten to Ace
Seat 2: TitTV+fFCcBZWOERdytydA (button) (small blind) mucked



PokerStars Game #59941505980:  Hold'em No Limit ($0.25/$0.50) - 2009/07/01 1:37:32 ET
Table 'B+sqsfj6d6zXicNfaseTaw' 2-max Seat #2 is the button
Seat 1: +4GNcSsecmapVGSdV0mUPA ($146.35 in chips)
Seat 2: Lv5RmpRe6LtPkBzM9Gpo5A ($75.20 in chips)
Lv5RmpRe6LtPkBzM9Gpo5A: posts small blind $0.25
+4GNcSsecmapVGSdV0mUPA: posts big blind $0.50
*** HOLE CARDS ***
Lv5RmpRe6LtPkBzM9Gpo5A: raises $1.50 to $2
+4GNcSsecmapVGSdV0mUPA: calls $1.50
*** FLOP *** [Qc Kh 3h]
+4GNcSsecmapVGSdV0mUPA: checks
Lv5RmpRe6LtPkBzM9Gpo5A: checks
*** TURN *** [Qc Kh 3h] [3d]
+4GNcSsecmapVGSdV0mUPA: checks
Lv5RmpRe6LtPkBzM9Gpo5A: checks
*** RIVER *** [Qc Kh 3h 3d] [Qd]
+4GNcSsecmapVGSdV0mUPA: checks
Lv5RmpRe6LtPkBzM9Gpo5A: checks
*** SHOW DOWN ***
+4GNcSsecmapVGSdV0mUPA: shows [6s Kd] (two pair, Kings and Queens)
Lv5RmpRe6LtPkBzM9Gpo5A: mucks hand
+4GNcSsecmapVGSdV0mUPA collected $3.80 from pot
*** SUMMARY ***
Total pot $4 | Rake $0.20
Board [Qc Kh 3h 3d Qd]
Seat 1: +4GNcSsecmapVGSdV0mUPA (big blind) showed [6s Kd] and won ($3.80) with two pair, Kings and Queens
Seat 2: Lv5RmpRe6LtPkBzM9Gpo5A (button) (small blind) mucked



PokerStars Game #59941506662:  Hold'em No Limit ($0.25/$0.50) - 2009/07/01 1:37:33 ET
Table 'ibNfFy0bCzuBaUORla0aGw' 9-max Seat #2 is the button
Seat 1: xZCXQSXlrZkp3pZizzVXCw ($49.25 in chips)
Seat 2: 90Wb75h3W1BRpbqVnuk8gw ($51.80 in chips)
Seat 3: AjV5McH1KMMclY26QdLM5w ($25 in chips)
Seat 6: H8cPaCtX7d6meGUVSM5sxw ($50 in chips)
Seat 7: HZkVla4kK2SI42CVrPZ/ig ($16.95 in chips)
Seat 8: Ja2jdidjip2UeJnRzmzAAQ ($47.75 in chips)
Seat 9: pFtzb1sR4b0d1aw6aIRgDg ($55.40 in chips)
AjV5McH1KMMclY26QdLM5w: posts small blind $0.25
H8cPaCtX7d6meGUVSM5sxw: posts big blind $0.50
*** HOLE CARDS ***
HZkVla4kK2SI42CVrPZ/ig: folds
Ja2jdidjip2UeJnRzmzAAQ: folds
pFtzb1sR4b0d1aw6aIRgDg: folds
xZCXQSXlrZkp3pZizzVXCw: folds
90Wb75h3W1BRpbqVnuk8gw: folds
AjV5McH1KMMclY26QdLM5w: raises $1 to $1.50
H8cPaCtX7d6meGUVSM5sxw: folds
AjV5McH1KMMclY26QdLM5w collected $1 from pot
*** SUMMARY ***
Total pot $1 | Rake $0
Seat 1: xZCXQSXlrZkp3pZizzVXCw folded before Flop (didn't bet)
Seat 2: 90Wb75h3W1BRpbqVnuk8gw (button) folded before Flop (didn't bet)
Seat 3: AjV5McH1KMMclY26QdLM5w (small blind) collected ($1)
Seat 6: H8cPaCtX7d6meGUVSM5sxw (big blind) folded before Flop
Seat 7: HZkVla4kK2SI42CVrPZ/ig folded before Flop (didn't bet)
Seat 8: Ja2jdidjip2UeJnRzmzAAQ folded before Flop (didn't bet)
Seat 9: pFtzb1sR4b0d1aw6aIRgDg folded before Flop (didn't bet)



PokerStars Game #59941506924:  Hold'em No Limit ($0.25/$0.50) - 2009/07/01 1:37:33 ET
Table 'iq+aXfWVQRdV0u8SRTYUEg' 9-max Seat #8 is the button
Seat 1: 3yl8Q6QaLfGtyhN4/pEFgQ ($72.30 in chips)
Seat 2: J9N0lxHFd/Js2S0xZLbsIQ ($25.30 in chips)
Seat 3: Qi/PyOsKwaqtKIg0H+7ELg ($4.70 in chips)
Seat 4: vHYT5s323LpajBj+2c9zbQ ($25.35 in chips)
Seat 5: 997ViqAtWn1FPjJqcffwcA ($56.90 in chips)
Seat 6: bTJ0WgoxefTPxIoycS7uoA ($31.70 in chips)
Seat 7: SKnJuWHScqetA/qG5p+wCg ($30.05 in chips)
Seat 8: /DtIHuxEH+3tzKefmSV+Mw ($44.65 in chips)
Seat 9: 7CKaQEWhd40e2lLifzZ1Cw ($35.70 in chips)
7CKaQEWhd40e2lLifzZ1Cw: posts small blind $0.25
3yl8Q6QaLfGtyhN4/pEFgQ: posts big blind $0.50
bTJ0WgoxefTPxIoycS7uoA: posts small & big blinds $0.75
*** HOLE CARDS ***
J9N0lxHFd/Js2S0xZLbsIQ: folds
Qi/PyOsKwaqtKIg0H+7ELg: raises $1.50 to $2
vHYT5s323LpajBj+2c9zbQ: folds
997ViqAtWn1FPjJqcffwcA: folds
bTJ0WgoxefTPxIoycS7uoA: folds
SKnJuWHScqetA/qG5p+wCg: folds
/DtIHuxEH+3tzKefmSV+Mw: folds
7CKaQEWhd40e2lLifzZ1Cw: calls $1.75
3yl8Q6QaLfGtyhN4/pEFgQ: folds
*** FLOP *** [Kd 3d 6s]
7CKaQEWhd40e2lLifzZ1Cw: checks
Qi/PyOsKwaqtKIg0H+7ELg: checks
*** TURN *** [Kd 3d 6s] [5h]
7CKaQEWhd40e2lLifzZ1Cw: bets $3
Qi/PyOsKwaqtKIg0H+7ELg: calls $2.70 and is all-in
*** RIVER *** [Kd 3d 6s 5h] [Jh]
*** SHOW DOWN ***
7CKaQEWhd40e2lLifzZ1Cw: shows [Ks Qc] (a pair of Kings)
Qi/PyOsKwaqtKIg0H+7ELg: mucks hand
7CKaQEWhd40e2lLifzZ1Cw collected $10.15 from pot
*** SUMMARY ***
Total pot $10.65 | Rake $0.50
Board [Kd 3d 6s 5h Jh]
Seat 1: 3yl8Q6QaLfGtyhN4/pEFgQ (big blind) folded before Flop
Seat 2: J9N0lxHFd/Js2S0xZLbsIQ folded before Flop (didn't bet)
Seat 3: Qi/PyOsKwaqtKIg0H+7ELg mucked
Seat 4: vHYT5s323LpajBj+2c9zbQ folded before Flop (didn't bet)
Seat 5: 997ViqAtWn1FPjJqcffwcA folded before Flop (didn't bet)
Seat 6: bTJ0WgoxefTPxIoycS7uoA folded before Flop
Seat 7: SKnJuWHScqetA/qG5p+wCg folded before Flop (didn't bet)
Seat 8: /DtIHuxEH+3tzKefmSV+Mw (button) folded before Flop (didn't bet)
Seat 9: 7CKaQEWhd40e2lLifzZ1Cw (small blind) showed [Ks Qc] and won ($10.15) with a pair of Kings



PokerStars Game #59941507718:  Hold'em No Limit ($0.25/$0.50) - 2009/07/01 1:37:35 ET
Table '2lPOwetm4cfkZPbTmGPH/w' 2-max Seat #1 is the button
Seat 1: vUGdApqS8J/GJE2gaVWl1w ($17.60 in chips)
Seat 2: XFa6sBGjP2gxoIvxR3fZIg ($20.55 in chips)
vUGdApqS8J/GJE2gaVWl1w: posts small blind $0.25
XFa6sBGjP2gxoIvxR3fZIg: posts big blind $0.50
*** HOLE CARDS ***
vUGdApqS8J/GJE2gaVWl1w: calls $0.25
XFa6sBGjP2gxoIvxR3fZIg: checks
*** FLOP *** [3s Kc Jd]
XFa6sBGjP2gxoIvxR3fZIg: checks
vUGdApqS8J/GJE2gaVWl1w: checks
*** TURN *** [3s Kc Jd] [Qd]
XFa6sBGjP2gxoIvxR3fZIg: bets $1
vUGdApqS8J/GJE2gaVWl1w: calls $1
*** RIVER *** [3s Kc Jd Qd] [6h]
XFa6sBGjP2gxoIvxR3fZIg: bets $2.50
vUGdApqS8J/GJE2gaVWl1w: calls $2.50
*** SHOW DOWN ***
XFa6sBGjP2gxoIvxR3fZIg: shows [3h Qs] (two pair, Queens and Threes)
vUGdApqS8J/GJE2gaVWl1w: mucks hand
XFa6sBGjP2gxoIvxR3fZIg collected $7.65 from pot
*** SUMMARY ***
Total pot $8 | Rake $0.35
Board [3s Kc Jd Qd 6h]
Seat 1: vUGdApqS8J/GJE2gaVWl1w (button) (small blind) mucked
Seat 2: XFa6sBGjP2gxoIvxR3fZIg (big blind) showed [3h Qs] and won ($7.65) with two pair, Queens and Threes



PokerStars Game #59941507580:  Hold'em No Limit ($0.25/$0.50) - 2009/07/01 1:37:35 ET
Table '+dXkOAQyS8j9PQZusUTMpg' 2-max Seat #2 is the button
Seat 1: Teld4PDKla7C8/Wfu2DSkg ($54.60 in chips)
Seat 2: qjBVVp3quHGDRH0szgloKA ($11.40 in chips)
qjBVVp3quHGDRH0szgloKA: posts small blind $0.25
Teld4PDKla7C8/Wfu2DSkg: posts big blind $0.50
*** HOLE CARDS ***
qjBVVp3quHGDRH0szgloKA: raises $10.90 to $11.40 and is all-in
Teld4PDKla7C8/Wfu2DSkg: folds
qjBVVp3quHGDRH0szgloKA collected $1 from pot
qjBVVp3quHGDRH0szgloKA: doesn't show hand
*** SUMMARY ***
Total pot $1 | Rake $0
Seat 1: Teld4PDKla7C8/Wfu2DSkg (big blind) folded before Flop
Seat 2: qjBVVp3quHGDRH0szgloKA (button) (small blind) collected ($1)



PokerStars Game #59941509746:  Hold'em No Limit ($0.25/$0.50) - 2009/07/01 1:37:38 ET
Table '8BQGgNetI1NOvWeu3gtMNw' 2-max Seat #2 is the button
Seat 1: bypIyrYcAAifLfhZpGlKLA ($67.40 in chips)
Seat 2: Z4HwehErEwzsv/noQlfUlg ($146.85 in chips)
Z4HwehErEwzsv/noQlfUlg: posts small blind $0.25
bypIyrYcAAifLfhZpGlKLA: posts big blind $0.50
*** HOLE CARDS ***
Z4HwehErEwzsv/noQlfUlg: folds
bypIyrYcAAifLfhZpGlKLA collected $0.50 from pot
bypIyrYcAAifLfhZpGlKLA: doesn't show hand
*** SUMMARY ***
Total pot $0.50 | Rake $0
Seat 1: bypIyrYcAAifLfhZpGlKLA (big blind) collected ($0.50)
Seat 2: Z4HwehErEwzsv/noQlfUlg (button) (small blind) folded before Flop



PokerStars Game #59941509956:  Hold'em No Limit ($0.25/$0.50) - 2009/07/01 1:37:39 ET
Table 'cofQFHU7jbJoFecLVBof/w' 6-max Seat #5 is the button
Seat 1: URYNc7fPA23K2UfadQbnCA ($50.75 in chips)
Seat 2: f89uTQr3ieGlusj2IAYAEg ($50 in chips)
Seat 3: v4ctePcLlQw0r8E0qJtjYw ($51.45 in chips)
Seat 5: QvwRlrpVqerRRF8eJm6dDw ($48.25 in chips)
Seat 6: 7+uQ0OOgCTbR4ltkSwyC0g ($160.55 in chips)
7+uQ0OOgCTbR4ltkSwyC0g: posts small blind $0.25
URYNc7fPA23K2UfadQbnCA: posts big blind $0.50
*** HOLE CARDS ***
f89uTQr3ieGlusj2IAYAEg: folds
v4ctePcLlQw0r8E0qJtjYw: folds
QvwRlrpVqerRRF8eJm6dDw: folds
7+uQ0OOgCTbR4ltkSwyC0g: calls $0.25
URYNc7fPA23K2UfadQbnCA: checks
*** FLOP *** [4s 4d 2h]
7+uQ0OOgCTbR4ltkSwyC0g: checks
URYNc7fPA23K2UfadQbnCA: bets $0.75
7+uQ0OOgCTbR4ltkSwyC0g: folds
URYNc7fPA23K2UfadQbnCA collected $0.95 from pot
*** SUMMARY ***
Total pot $1 | Rake $0.05
Board [4s 4d 2h]
Seat 1: URYNc7fPA23K2UfadQbnCA (big blind) collected ($0.95)
Seat 2: f89uTQr3ieGlusj2IAYAEg folded before Flop (didn't bet)
Seat 3: v4ctePcLlQw0r8E0qJtjYw folded before Flop (didn't bet)
Seat 5: QvwRlrpVqerRRF8eJm6dDw (button) folded before Flop (didn't bet)
Seat 6: 7+uQ0OOgCTbR4ltkSwyC0g (small blind) folded on the Flop



PokerStars Game #59941512980:  Hold'em No Limit ($0.25/$0.50) - 2009/07/01 1:37:44 ET
Table '3FhG0gl3kMX3wBEEqj+wnQ' 9-max Seat #6 is the button
Seat 1: bxLSulbgr8LmKNjOzw8URg ($48.50 in chips)
Seat 3: YXCE3WOZi8g2sIf3y/plVw ($61.55 in chips)
Seat 4: e2+sK/yjnj94rXOKoxPP2A ($68.75 in chips)
Seat 5: XcLXSUMHSpshK/7Lh0M4Vg ($11.05 in chips)
Seat 6: 997ViqAtWn1FPjJqcffwcA ($109.05 in chips)
Seat 7: mSD1pginDsyHG5PDfqzphw ($19.95 in chips)
Seat 8: j3K/Jujr7PY4ZM2RZvlH6A ($50.90 in chips)
Seat 9: KA0tkubTlbhmo4ju+qgXPg ($44.35 in chips)
mSD1pginDsyHG5PDfqzphw: posts small blind $0.25
j3K/Jujr7PY4ZM2RZvlH6A: posts big blind $0.50
HZkVla4kK2SI42CVrPZ/ig: sits out
*** HOLE CARDS ***
KA0tkubTlbhmo4ju+qgXPg: calls $0.50
bxLSulbgr8LmKNjOzw8URg: folds
YXCE3WOZi8g2sIf3y/plVw: folds
e2+sK/yjnj94rXOKoxPP2A: folds
XcLXSUMHSpshK/7Lh0M4Vg: folds
997ViqAtWn1FPjJqcffwcA: folds
mSD1pginDsyHG5PDfqzphw: calls $0.25
j3K/Jujr7PY4ZM2RZvlH6A: raises $6 to $6.50
KA0tkubTlbhmo4ju+qgXPg: folds
mSD1pginDsyHG5PDfqzphw: folds
j3K/Jujr7PY4ZM2RZvlH6A collected $1.50 from pot
j3K/Jujr7PY4ZM2RZvlH6A: doesn't show hand
*** SUMMARY ***
Total pot $1.50 | Rake $0
Seat 1: bxLSulbgr8LmKNjOzw8URg folded before Flop (didn't bet)
Seat 3: YXCE3WOZi8g2sIf3y/plVw folded before Flop (didn't bet)
Seat 4: e2+sK/yjnj94rXOKoxPP2A folded before Flop (didn't bet)
Seat 5: XcLXSUMHSpshK/7Lh0M4Vg folded before Flop (didn't bet)
Seat 6: 997ViqAtWn1FPjJqcffwcA (button) folded before Flop (didn't bet)
Seat 7: mSD1pginDsyHG5PDfqzphw (small blind) folded before Flop
Seat 8: j3K/Jujr7PY4ZM2RZvlH6A (big blind) collected ($1.50)
Seat 9: KA0tkubTlbhmo4ju+qgXPg folded before Flop



PokerStars Game #59941514272:  Hold'em No Limit ($0.25/$0.50) - 2009/07/01 1:37:46 ET
Table 'hWT2kq66tnKEpD26cia6fQ' 2-max Seat #1 is the button
Seat 1: Ce3KNFP+ao7Da9NHb65raw ($27.80 in chips)
Seat 2: 16tvT7AYgZ2LgiGFcvFKQg ($46.60 in chips)
Ce3KNFP+ao7Da9NHb65raw: posts small blind $0.25
16tvT7AYgZ2LgiGFcvFKQg: posts big blind $0.50
*** HOLE CARDS ***
Ce3KNFP+ao7Da9NHb65raw: folds
16tvT7AYgZ2LgiGFcvFKQg collected $0.50 from pot
*** SUMMARY ***
Total pot $0.50 | Rake $0
Seat 1: Ce3KNFP+ao7Da9NHb65raw (button) (small blind) folded before Flop
Seat 2: 16tvT7AYgZ2LgiGFcvFKQg (big blind) collected ($0.50)



PokerStars Game #59941513996:  Hold'em No Limit ($0.25/$0.50) - 2009/07/01 1:37:46 ET
Table '+dXkOAQyS8j9PQZusUTMpg' 2-max Seat #1 is the button
Seat 1: Teld4PDKla7C8/Wfu2DSkg ($54.10 in chips)
Seat 2: qjBVVp3quHGDRH0szgloKA ($11.90 in chips)
Teld4PDKla7C8/Wfu2DSkg: posts small blind $0.25
qjBVVp3quHGDRH0szgloKA: posts big blind $0.50
*** HOLE CARDS ***
Teld4PDKla7C8/Wfu2DSkg: folds
qjBVVp3quHGDRH0szgloKA collected $0.50 from pot
qjBVVp3quHGDRH0szgloKA: doesn't show hand
*** SUMMARY ***
Total pot $0.50 | Rake $0
Seat 1: Teld4PDKla7C8/Wfu2DSkg (button) (small blind) folded before Flop
Seat 2: qjBVVp3quHGDRH0szgloKA (big blind) collected ($0.50)



PokerStars Game #59941514052:  Hold'em No Limit ($0.25/$0.50) - 2009/07/01 1:37:46 ET
Table 'Wwfm5/i+g/g2Nj2gT3jnVQ' 2-max Seat #1 is the button
Seat 1: CHRLZDaaxjbo68bwQD1C/Q ($7.20 in chips)
Seat 2: PKuuhUvIr5WSkJyPJa9dFw ($22.55 in chips)
CHRLZDaaxjbo68bwQD1C/Q: posts small blind $0.25
PKuuhUvIr5WSkJyPJa9dFw: posts big blind $0.50
*** HOLE CARDS ***
CHRLZDaaxjbo68bwQD1C/Q: folds
PKuuhUvIr5WSkJyPJa9dFw collected $0.50 from pot
PKuuhUvIr5WSkJyPJa9dFw: doesn't show hand
*** SUMMARY ***
Total pot $0.50 | Rake $0
Seat 1: CHRLZDaaxjbo68bwQD1C/Q (button) (small blind) folded before Flop
Seat 2: PKuuhUvIr5WSkJyPJa9dFw (big blind) collected ($0.50)



PokerStars Game #59941513840:  Hold'em No Limit ($0.25/$0.50) - 2009/07/01 1:37:46 ET
Table '5EmHi+fnatGQQShcNmzOZQ' 6-max Seat #5 is the button
Seat 1: avNOJXWxD1+SygFmWsd+qw ($51.25 in chips)
Seat 2: OZ6OtYh5Y53MCH/p0QTn5g ($50 in chips)
Seat 3: QmH/ZFyxZfvliy57YM9yxw ($75.45 in chips)
Seat 4: 1b+2BbjMN8qhR1WPqdE9VQ ($51.05 in chips)
Seat 5: 6yWjZXHP6iAyMEDF6pJlng ($55.30 in chips)
Seat 6: u3Ol7kv1LmvszuHNm9rc6w ($29.60 in chips)
u3Ol7kv1LmvszuHNm9rc6w: posts small blind $0.25
avNOJXWxD1+SygFmWsd+qw: posts big blind $0.50
*** HOLE CARDS ***
OZ6OtYh5Y53MCH/p0QTn5g: folds
QmH/ZFyxZfvliy57YM9yxw: calls $0.50
1b+2BbjMN8qhR1WPqdE9VQ: folds
6yWjZXHP6iAyMEDF6pJlng: folds
u3Ol7kv1LmvszuHNm9rc6w: calls $0.25
avNOJXWxD1+SygFmWsd+qw: checks
*** FLOP *** [Js Ah Kh]
u3Ol7kv1LmvszuHNm9rc6w: checks
avNOJXWxD1+SygFmWsd+qw: checks
QmH/ZFyxZfvliy57YM9yxw: bets $1
u3Ol7kv1LmvszuHNm9rc6w: calls $1
avNOJXWxD1+SygFmWsd+qw: calls $1
*** TURN *** [Js Ah Kh] [Kc]
u3Ol7kv1LmvszuHNm9rc6w: checks
avNOJXWxD1+SygFmWsd+qw: checks
QmH/ZFyxZfvliy57YM9yxw: bets $1.50
u3Ol7kv1LmvszuHNm9rc6w: calls $1.50
avNOJXWxD1+SygFmWsd+qw: raises $3.50 to $5
QmH/ZFyxZfvliy57YM9yxw: calls $3.50
u3Ol7kv1LmvszuHNm9rc6w: folds
*** RIVER *** [Js Ah Kh Kc] [3c]
avNOJXWxD1+SygFmWsd+qw: bets $9
QmH/ZFyxZfvliy57YM9yxw: calls $9
*** SHOW DOWN ***
avNOJXWxD1+SygFmWsd+qw: shows [6h Ks] (three of a kind, Kings)
QmH/ZFyxZfvliy57YM9yxw: mucks hand
avNOJXWxD1+SygFmWsd+qw collected $32.35 from pot
*** SUMMARY ***
Total pot $34 | Rake $1.65
Board [Js Ah Kh Kc 3c]
Seat 1: avNOJXWxD1+SygFmWsd+qw (big blind) showed [6h Ks] and won ($32.35) with three of a kind, Kings
Seat 2: OZ6OtYh5Y53MCH/p0QTn5g folded before Flop (didn't bet)
Seat 3: QmH/ZFyxZfvliy57YM9yxw mucked
Seat 4: 1b+2BbjMN8qhR1WPqdE9VQ folded before Flop (didn't bet)
Seat 5: 6yWjZXHP6iAyMEDF6pJlng (button) folded before Flop (didn't bet)
Seat 6: u3Ol7kv1LmvszuHNm9rc6w (small blind) folded on the Turn



PokerStars Game #59941515298:  Hold'em No Limit ($0.25/$0.50) - 2009/07/01 1:37:48 ET
Table '+z1aekfHkpp09pc8F9aViw' 6-max Seat #1 is the button
Seat 1: L0aIPg7qefDQjdJo3HCVEA ($10 in chips)
Seat 3: URYNc7fPA23K2UfadQbnCA ($61.90 in chips)
Seat 4: RowCSpSURHTOL/dcjg/Iug ($85.70 in chips)
Seat 5: 2igtJLmvIZ+HqX4XPgMPZA ($50 in chips)
Seat 6: GUnvMULl2qFOO1yenu1UBw ($51.50 in chips)
URYNc7fPA23K2UfadQbnCA: posts small blind $0.25
RowCSpSURHTOL/dcjg/Iug: posts big blind $0.50
*** HOLE CARDS ***
2igtJLmvIZ+HqX4XPgMPZA: folds
GUnvMULl2qFOO1yenu1UBw: folds
L0aIPg7qefDQjdJo3HCVEA: folds
URYNc7fPA23K2UfadQbnCA: folds
RowCSpSURHTOL/dcjg/Iug collected $0.50 from pot
*** SUMMARY ***
Total pot $0.50 | Rake $0
Seat 1: L0aIPg7qefDQjdJo3HCVEA (button) folded before Flop (didn't bet)
Seat 3: URYNc7fPA23K2UfadQbnCA (small blind) folded before Flop
Seat 4: RowCSpSURHTOL/dcjg/Iug (big blind) collected ($0.50)
Seat 5: 2igtJLmvIZ+HqX4XPgMPZA folded before Flop (didn't bet)
Seat 6: GUnvMULl2qFOO1yenu1UBw folded before Flop (didn't bet)



PokerStars Game #59941515446:  Hold'em No Limit ($0.25/$0.50) - 2009/07/01 1:37:48 ET
Table 'ZYI3ZReBjdfKEYItkZHI6A' 9-max Seat #3 is the button
Seat 1: IYd5zG8k7vdBNVHbHg2Pag ($62.90 in chips)
Seat 2: 5acK4E7fzEwnplVBZ6eNWA ($50 in chips)
Seat 3: 75K2MXwN65Sjfp1yHd50Hg ($8.50 in chips)
Seat 4: /UdtxmXsFx6K/14AbHqzbQ ($9.50 in chips)
Seat 5: ApHP7ouup365XIUFBdEDxg ($17.25 in chips)
Seat 6: 1xBtrSVBbgFH/viUWKqQeg ($22.75 in chips)
Seat 7: HWcfp1hY1hqvrddzW3/FQw ($21.30 in chips)
Seat 8: ji04uOybxCdpdefzlUQeKQ ($29.55 in chips)
Seat 9: HZkVla4kK2SI42CVrPZ/ig ($10.40 in chips)
/UdtxmXsFx6K/14AbHqzbQ: posts small blind $0.25
ApHP7ouup365XIUFBdEDxg: posts big blind $0.50
*** HOLE CARDS ***
1xBtrSVBbgFH/viUWKqQeg: folds
HWcfp1hY1hqvrddzW3/FQw: folds
ji04uOybxCdpdefzlUQeKQ: folds
HZkVla4kK2SI42CVrPZ/ig: folds
IYd5zG8k7vdBNVHbHg2Pag: raises $1 to $1.50
5acK4E7fzEwnplVBZ6eNWA: folds
75K2MXwN65Sjfp1yHd50Hg: folds
/UdtxmXsFx6K/14AbHqzbQ: calls $1.25
ApHP7ouup365XIUFBdEDxg: folds
*** FLOP *** [6c 7h Ad]
/UdtxmXsFx6K/14AbHqzbQ: checks
IYd5zG8k7vdBNVHbHg2Pag: bets $1
/UdtxmXsFx6K/14AbHqzbQ: calls $1
*** TURN *** [6c 7h Ad] [9s]
/UdtxmXsFx6K/14AbHqzbQ: checks
IYd5zG8k7vdBNVHbHg2Pag: checks
*** RIVER *** [6c 7h Ad 9s] [5h]
/UdtxmXsFx6K/14AbHqzbQ: bets $2.50
IYd5zG8k7vdBNVHbHg2Pag: folds
/UdtxmXsFx6K/14AbHqzbQ collected $5.25 from pot
*** SUMMARY ***
Total pot $5.50 | Rake $0.25
Board [6c 7h Ad 9s 5h]
Seat 1: IYd5zG8k7vdBNVHbHg2Pag folded on the River
Seat 2: 5acK4E7fzEwnplVBZ6eNWA folded before Flop (didn't bet)
Seat 3: 75K2MXwN65Sjfp1yHd50Hg (button) folded before Flop (didn't bet)
Seat 4: /UdtxmXsFx6K/14AbHqzbQ (small blind) collected ($5.25)
Seat 5: ApHP7ouup365XIUFBdEDxg (big blind) folded before Flop
Seat 6: 1xBtrSVBbgFH/viUWKqQeg folded before Flop (didn't bet)
Seat 7: HWcfp1hY1hqvrddzW3/FQw folded before Flop (didn't bet)
Seat 8: ji04uOybxCdpdefzlUQeKQ folded before Flop (didn't bet)
Seat 9: HZkVla4kK2SI42CVrPZ/ig folded before Flop (didn't bet)



PokerStars Game #59941516182:  Hold'em No Limit ($0.25/$0.50) - 2009/07/01 1:37:50 ET
Table 'EiNh8p/wGJ1FP575iMFnqg' 9-max Seat #5 is the button
Seat 1: YFFlOZgyy1Mh4iBmuNRbmQ ($20.75 in chips)
Seat 2: GRV8J6o4lVSBDEyjt6BwMg ($29.50 in chips)
Seat 3: ymLPoEIl7UL3TvZYmnadxQ ($44.75 in chips)
Seat 4: cMzaiXAM/ZAdNaEUu+LqhA ($54.70 in chips)
Seat 5: M+7+BTmX5vZatHVuoRB1nA ($74.60 in chips)
Seat 7: 997ViqAtWn1FPjJqcffwcA ($50 in chips)
Seat 8: mSD1pginDsyHG5PDfqzphw ($10 in chips)
Seat 9: GuPkZObrz5Zkkn8FsEdF9w ($34.60 in chips)
bCRukyMhXa3jkgAkKFa4VQ will be allowed to play after the button
997ViqAtWn1FPjJqcffwcA: posts small blind $0.25
mSD1pginDsyHG5PDfqzphw: posts big blind $0.50
*** HOLE CARDS ***
GuPkZObrz5Zkkn8FsEdF9w: folds
YFFlOZgyy1Mh4iBmuNRbmQ: calls $0.50
GRV8J6o4lVSBDEyjt6BwMg: folds
ymLPoEIl7UL3TvZYmnadxQ: folds
cMzaiXAM/ZAdNaEUu+LqhA: calls $0.50
M+7+BTmX5vZatHVuoRB1nA: calls $0.50
997ViqAtWn1FPjJqcffwcA: folds
mSD1pginDsyHG5PDfqzphw: checks
*** FLOP *** [Ad 8d Ts]
mSD1pginDsyHG5PDfqzphw: checks
YFFlOZgyy1Mh4iBmuNRbmQ: bets $1
cMzaiXAM/ZAdNaEUu+LqhA: folds
M+7+BTmX5vZatHVuoRB1nA: raises $2 to $3
mSD1pginDsyHG5PDfqzphw: folds
YFFlOZgyy1Mh4iBmuNRbmQ: folds
M+7+BTmX5vZatHVuoRB1nA collected $4.05 from pot
M+7+BTmX5vZatHVuoRB1nA: doesn't show hand
*** SUMMARY ***
Total pot $4.25 | Rake $0.20
Board [Ad 8d Ts]
Seat 1: YFFlOZgyy1Mh4iBmuNRbmQ folded on the Flop
Seat 2: GRV8J6o4lVSBDEyjt6BwMg folded before Flop (didn't bet)
Seat 3: ymLPoEIl7UL3TvZYmnadxQ folded before Flop (didn't bet)
Seat 4: cMzaiXAM/ZAdNaEUu+LqhA folded on the Flop
Seat 5: M+7+BTmX5vZatHVuoRB1nA (button) collected ($4.05)
Seat 7: 997ViqAtWn1FPjJqcffwcA (small blind) folded before Flop
Seat 8: mSD1pginDsyHG5PDfqzphw (big blind) folded on the Flop
Seat 9: GuPkZObrz5Zkkn8FsEdF9w folded before Flop (didn't bet)



PokerStars Game #59941517032:  Hold'em No Limit ($0.25/$0.50) - 2009/07/01 1:37:51 ET
Table 'hSTs/dUsYLgJQuF2Onp0MQ' 6-max Seat #4 is the button
Seat 1: 1WUCqNG+p+vfWRTXNu4ljw ($55.20 in chips)
Seat 2: Hdd4js36ITbTJ/QuVYwTlA ($100.25 in chips)
Seat 3: lxIzoHy0RnkfFSODHC2liw ($50 in chips)
Seat 4: 2igtJLmvIZ+HqX4XPgMPZA ($50 in chips)
Seat 5: FsRQ5ECdlLkLYI5le8+PDQ ($48.75 in chips)
Seat 6: M1KyQQvVPVuxqTAB8sR/zQ ($102.65 in chips)
FsRQ5ECdlLkLYI5le8+PDQ: posts small blind $0.25
M1KyQQvVPVuxqTAB8sR/zQ: posts big blind $0.50
*** HOLE CARDS ***
1WUCqNG+p+vfWRTXNu4ljw: folds
Hdd4js36ITbTJ/QuVYwTlA: raises $1.50 to $2
lxIzoHy0RnkfFSODHC2liw: folds
2igtJLmvIZ+HqX4XPgMPZA: folds
FsRQ5ECdlLkLYI5le8+PDQ: folds
M1KyQQvVPVuxqTAB8sR/zQ: folds
Hdd4js36ITbTJ/QuVYwTlA collected $1.25 from pot
*** SUMMARY ***
Total pot $1.25 | Rake $0
Seat 1: 1WUCqNG+p+vfWRTXNu4ljw folded before Flop (didn't bet)
Seat 2: Hdd4js36ITbTJ/QuVYwTlA collected ($1.25)
Seat 3: lxIzoHy0RnkfFSODHC2liw folded before Flop (didn't bet)
Seat 4: 2igtJLmvIZ+HqX4XPgMPZA (button) folded before Flop (didn't bet)
Seat 5: FsRQ5ECdlLkLYI5le8+PDQ (small blind) folded before Flop
Seat 6: M1KyQQvVPVuxqTAB8sR/zQ (big blind) folded before Flop



PokerStars Game #59941517596:  Hold'em No Limit ($0.25/$0.50) - 2009/07/01 1:37:52 ET
Table '+dXkOAQyS8j9PQZusUTMpg' 2-max Seat #2 is the button
Seat 1: Teld4PDKla7C8/Wfu2DSkg ($53.85 in chips)
Seat 2: qjBVVp3quHGDRH0szgloKA ($12.15 in chips)
qjBVVp3quHGDRH0szgloKA: posts small blind $0.25
Teld4PDKla7C8/Wfu2DSkg: posts big blind $0.50
*** HOLE CARDS ***
qjBVVp3quHGDRH0szgloKA: raises $1 to $1.50
Teld4PDKla7C8/Wfu2DSkg: calls $1
*** FLOP *** [3s Qd 2d]
Teld4PDKla7C8/Wfu2DSkg: checks
qjBVVp3quHGDRH0szgloKA: bets $0.50
Teld4PDKla7C8/Wfu2DSkg: calls $0.50
*** TURN *** [3s Qd 2d] [Th]
Teld4PDKla7C8/Wfu2DSkg: checks
qjBVVp3quHGDRH0szgloKA: bets $0.50
Teld4PDKla7C8/Wfu2DSkg: calls $0.50
*** RIVER *** [3s Qd 2d Th] [Qc]
Teld4PDKla7C8/Wfu2DSkg: checks
qjBVVp3quHGDRH0szgloKA: bets $0.50
Teld4PDKla7C8/Wfu2DSkg: raises $4 to $4.50
qjBVVp3quHGDRH0szgloKA: calls $4
*** SHOW DOWN ***
Teld4PDKla7C8/Wfu2DSkg: shows [Tc Kd] (two pair, Queens and Tens)
qjBVVp3quHGDRH0szgloKA: mucks hand
Teld4PDKla7C8/Wfu2DSkg collected $13.50 from pot
*** SUMMARY ***
Total pot $14 | Rake $0.50
Board [3s Qd 2d Th Qc]
Seat 1: Teld4PDKla7C8/Wfu2DSkg (big blind) showed [Tc Kd] and won ($13.50) with two pair, Queens and Tens
Seat 2: qjBVVp3quHGDRH0szgloKA (button) (small blind) mucked



PokerStars Game #59941518078:  Hold'em No Limit ($0.25/$0.50) - 2009/07/01 1:37:53 ET
Table '8BQGgNetI1NOvWeu3gtMNw' 2-max Seat #1 is the button
Seat 1: bypIyrYcAAifLfhZpGlKLA ($67.65 in chips)
Seat 2: Z4HwehErEwzsv/noQlfUlg ($146.60 in chips)
bypIyrYcAAifLfhZpGlKLA: posts small blind $0.25
Z4HwehErEwzsv/noQlfUlg: posts big blind $0.50
*** HOLE CARDS ***
bypIyrYcAAifLfhZpGlKLA: raises $1 to $1.50
Z4HwehErEwzsv/noQlfUlg: calls $1
*** FLOP *** [2s 9d Kd]
Z4HwehErEwzsv/noQlfUlg: bets $3
bypIyrYcAAifLfhZpGlKLA: calls $3
*** TURN *** [2s 9d Kd] [7d]
Z4HwehErEwzsv/noQlfUlg: bets $6
bypIyrYcAAifLfhZpGlKLA: calls $6
*** RIVER *** [2s 9d Kd 7d] [Ac]
Z4HwehErEwzsv/noQlfUlg: checks
bypIyrYcAAifLfhZpGlKLA: checks
*** SHOW DOWN ***
Z4HwehErEwzsv/noQlfUlg: shows [9h Js] (a pair of Nines)
bypIyrYcAAifLfhZpGlKLA: shows [6c Kc] (a pair of Kings)
bypIyrYcAAifLfhZpGlKLA collected $20.50 from pot
*** SUMMARY ***
Total pot $21 | Rake $0.50
Board [2s 9d Kd 7d Ac]
Seat 1: bypIyrYcAAifLfhZpGlKLA (button) (small blind) showed [6c Kc] and won ($20.50) with a pair of Kings
Seat 2: Z4HwehErEwzsv/noQlfUlg (big blind) showed [9h Js] and lost with a pair of Nines



PokerStars Game #59941517810:  Hold'em No Limit ($0.25/$0.50) - 2009/07/01 1:37:53 ET
Table 'Wwfm5/i+g/g2Nj2gT3jnVQ' 2-max Seat #2 is the button
Seat 1: CHRLZDaaxjbo68bwQD1C/Q ($6.95 in chips)
Seat 2: PKuuhUvIr5WSkJyPJa9dFw ($22.80 in chips)
PKuuhUvIr5WSkJyPJa9dFw: posts small blind $0.25
CHRLZDaaxjbo68bwQD1C/Q: posts big blind $0.50
*** HOLE CARDS ***
PKuuhUvIr5WSkJyPJa9dFw: calls $0.25
CHRLZDaaxjbo68bwQD1C/Q: checks
*** FLOP *** [Ks Jh Kc]
CHRLZDaaxjbo68bwQD1C/Q: checks
PKuuhUvIr5WSkJyPJa9dFw: checks
*** TURN *** [Ks Jh Kc] [7c]
CHRLZDaaxjbo68bwQD1C/Q: checks
PKuuhUvIr5WSkJyPJa9dFw: checks
*** RIVER *** [Ks Jh Kc 7c] [5c]
CHRLZDaaxjbo68bwQD1C/Q: checks
PKuuhUvIr5WSkJyPJa9dFw: checks
*** SHOW DOWN ***
CHRLZDaaxjbo68bwQD1C/Q: shows [Qc 4d] (a pair of Kings)
PKuuhUvIr5WSkJyPJa9dFw: shows [8d Qh] (a pair of Kings - Queen+Jack+Eight kicker)
PKuuhUvIr5WSkJyPJa9dFw collected $0.95 from pot
*** SUMMARY ***
Total pot $1 | Rake $0.05
Board [Ks Jh Kc 7c 5c]
Seat 1: CHRLZDaaxjbo68bwQD1C/Q (big blind) showed [Qc 4d] and lost with a pair of Kings
Seat 2: PKuuhUvIr5WSkJyPJa9dFw (button) (small blind) showed [8d Qh] and won ($0.95) with a pair of Kings



PokerStars Game #59941518336:  Hold'em No Limit ($0.25/$0.50) - 2009/07/01 1:37:54 ET
Table 'hWT2kq66tnKEpD26cia6fQ' 2-max Seat #2 is the button
Seat 1: Ce3KNFP+ao7Da9NHb65raw ($27.55 in chips)
Seat 2: 16tvT7AYgZ2LgiGFcvFKQg ($46.85 in chips)
16tvT7AYgZ2LgiGFcvFKQg: posts small blind $0.25
Ce3KNFP+ao7Da9NHb65raw: posts big blind $0.50
*** HOLE CARDS ***
16tvT7AYgZ2LgiGFcvFKQg: calls $0.25
Ce3KNFP+ao7Da9NHb65raw: raises $1 to $1.50
16tvT7AYgZ2LgiGFcvFKQg: calls $1
*** FLOP *** [7c Qs 8s]
Ce3KNFP+ao7Da9NHb65raw: bets $1.50
16tvT7AYgZ2LgiGFcvFKQg: calls $1.50
*** TURN *** [7c Qs 8s] [Kc]
Ce3KNFP+ao7Da9NHb65raw: bets $1.50
16tvT7AYgZ2LgiGFcvFKQg: calls $1.50
*** RIVER *** [7c Qs 8s Kc] [6c]
Ce3KNFP+ao7Da9NHb65raw: bets $3
16tvT7AYgZ2LgiGFcvFKQg: raises $3 to $6
Ce3KNFP+ao7Da9NHb65raw: calls $3
*** SHOW DOWN ***
16tvT7AYgZ2LgiGFcvFKQg: shows [4c 5s] (a straight, Four to Eight)
Ce3KNFP+ao7Da9NHb65raw: mucks hand
16tvT7AYgZ2LgiGFcvFKQg collected $20.50 from pot
*** SUMMARY ***
Total pot $21 | Rake $0.50
Board [7c Qs 8s Kc 6c]
Seat 1: Ce3KNFP+ao7Da9NHb65raw (big blind) mucked
Seat 2: 16tvT7AYgZ2LgiGFcvFKQg (button) (small blind) showed [4c 5s] and won ($20.50) with a straight, Four to Eight



PokerStars Game #59941519520:  Hold'em No Limit ($0.25/$0.50) - 2009/07/01 1:37:56 ET
Table 'B+sqsfj6d6zXicNfaseTaw' 2-max Seat #1 is the button
Seat 1: +4GNcSsecmapVGSdV0mUPA ($148.15 in chips)
Seat 2: Lv5RmpRe6LtPkBzM9Gpo5A ($73.20 in chips)
+4GNcSsecmapVGSdV0mUPA: posts small blind $0.25
Lv5RmpRe6LtPkBzM9Gpo5A: posts big blind $0.50
*** HOLE CARDS ***
+4GNcSsecmapVGSdV0mUPA: raises $1.50 to $2
Lv5RmpRe6LtPkBzM9Gpo5A: calls $1.50
*** FLOP *** [6c 8s 9s]
Lv5RmpRe6LtPkBzM9Gpo5A: checks
+4GNcSsecmapVGSdV0mUPA: checks
*** TURN *** [6c 8s 9s] [5c]
Lv5RmpRe6LtPkBzM9Gpo5A: bets $2
+4GNcSsecmapVGSdV0mUPA: calls $2
*** RIVER *** [6c 8s 9s 5c] [4c]
Lv5RmpRe6LtPkBzM9Gpo5A: bets $10.50
+4GNcSsecmapVGSdV0mUPA: folds
Lv5RmpRe6LtPkBzM9Gpo5A collected $7.65 from pot
*** SUMMARY ***
Total pot $8 | Rake $0.35
Board [6c 8s 9s 5c 4c]
Seat 1: +4GNcSsecmapVGSdV0mUPA (button) (small blind) folded on the River
Seat 2: Lv5RmpRe6LtPkBzM9Gpo5A (big blind) collected ($7.65)



PokerStars Game #59941520470:  Hold'em No Limit ($0.25/$0.50) - 2009/07/01 1:37:58 ET
Table 'Nz0Vr7WMHL2g5Uk7dDZjpw' 9-max Seat #8 is the button
Seat 1: 9yMsdgReyOUerNsmTYCCDQ ($9 in chips)
Seat 2: SegjDnMxWMujiD57ESNL+g ($20.35 in chips)
Seat 3: c638Xxo+q5F/t5qMtmvmvQ ($51.40 in chips)
Seat 4: uw9QayAAxLM3Hb+HR7mSkg ($9.25 in chips)
Seat 5: WGW0DgjBUXs1ylURHG8vnQ ($13.55 in chips)
Seat 6: 997ViqAtWn1FPjJqcffwcA ($53.75 in chips)
Seat 7: KPLH0gELgFe2OuAnhJFI5w ($25 in chips)
Seat 8: aoL+R/61Kxmw69ypuPrWAQ ($28.55 in chips)
Seat 9: mSD1pginDsyHG5PDfqzphw ($16.75 in chips)
mSD1pginDsyHG5PDfqzphw: posts small blind $0.25
9yMsdgReyOUerNsmTYCCDQ: posts big blind $0.50
*** HOLE CARDS ***
SegjDnMxWMujiD57ESNL+g: folds
c638Xxo+q5F/t5qMtmvmvQ: folds
uw9QayAAxLM3Hb+HR7mSkg: folds
WGW0DgjBUXs1ylURHG8vnQ: folds
997ViqAtWn1FPjJqcffwcA: folds
KPLH0gELgFe2OuAnhJFI5w: folds
aoL+R/61Kxmw69ypuPrWAQ: calls $0.50
mSD1pginDsyHG5PDfqzphw: folds
9yMsdgReyOUerNsmTYCCDQ: checks
*** FLOP *** [Ad 4h 5s]
9yMsdgReyOUerNsmTYCCDQ: checks
aoL+R/61Kxmw69ypuPrWAQ: bets $1
9yMsdgReyOUerNsmTYCCDQ: folds
aoL+R/61Kxmw69ypuPrWAQ collected $1.20 from pot
*** SUMMARY ***
Total pot $1.25 | Rake $0.05
Board [Ad 4h 5s]
Seat 1: 9yMsdgReyOUerNsmTYCCDQ (big blind) folded on the Flop
Seat 2: SegjDnMxWMujiD57ESNL+g folded before Flop (didn't bet)
Seat 3: c638Xxo+q5F/t5qMtmvmvQ folded before Flop (didn't bet)
Seat 4: uw9QayAAxLM3Hb+HR7mSkg folded before Flop (didn't bet)
Seat 5: WGW0DgjBUXs1ylURHG8vnQ folded before Flop (didn't bet)
Seat 6: 997ViqAtWn1FPjJqcffwcA folded before Flop (didn't bet)
Seat 7: KPLH0gELgFe2OuAnhJFI5w folded before Flop (didn't bet)
Seat 8: aoL+R/61Kxmw69ypuPrWAQ (button) collected ($1.20)
Seat 9: mSD1pginDsyHG5PDfqzphw (small blind) folded before Flop



PokerStars Game #59941522102:  Hold'em No Limit ($0.25/$0.50) - 2009/07/01 1:38:00 ET
Table 'fx6MqwfYAj/Rt86hBz2L3Q' 9-max Seat #1 is the button
Seat 1: v/4aX0ejnaIFK4ftDk2Lyg ($49.90 in chips)
Seat 2: C3rGXblctNcWI6JYPHhaEg ($53 in chips)
Seat 3: iadBi5AEt7gTBXbDSSnMYQ ($45.80 in chips)
Seat 4: VhjwWfxHSx00WxzYih3KOA ($50 in chips)
Seat 6: 5k9fvXD9suIgCxU4HLQjTw ($50 in chips)
Seat 7: mSD1pginDsyHG5PDfqzphw ($11.50 in chips)
Seat 8: 75K2MXwN65Sjfp1yHd50Hg ($12.25 in chips)
C3rGXblctNcWI6JYPHhaEg: posts small blind $0.25
iadBi5AEt7gTBXbDSSnMYQ: posts big blind $0.50
C3rGXblctNcWI6JYPHhaEg said, "nh"
e2+sK/yjnj94rXOKoxPP2A: sits out
Alf.STG: sits out
*** HOLE CARDS ***
VhjwWfxHSx00WxzYih3KOA: folds
5k9fvXD9suIgCxU4HLQjTw: folds
mSD1pginDsyHG5PDfqzphw: folds
75K2MXwN65Sjfp1yHd50Hg: folds
v/4aX0ejnaIFK4ftDk2Lyg: folds
C3rGXblctNcWI6JYPHhaEg: calls $0.25
iadBi5AEt7gTBXbDSSnMYQ: checks
*** FLOP *** [5d 5c 7s]
C3rGXblctNcWI6JYPHhaEg: checks
iadBi5AEt7gTBXbDSSnMYQ: checks
*** TURN *** [5d 5c 7s] [Ts]
C3rGXblctNcWI6JYPHhaEg: bets $0.50
iadBi5AEt7gTBXbDSSnMYQ: folds
iadBi5AEt7gTBXbDSSnMYQ leaves the table
C3rGXblctNcWI6JYPHhaEg collected $0.95 from pot
C3rGXblctNcWI6JYPHhaEg is sitting out
C3rGXblctNcWI6JYPHhaEg has returned
*** SUMMARY ***
Total pot $1 | Rake $0.05
Board [5d 5c 7s Ts]
Seat 1: v/4aX0ejnaIFK4ftDk2Lyg (button) folded before Flop (didn't bet)
Seat 2: C3rGXblctNcWI6JYPHhaEg (small blind) collected ($0.95)
Seat 3: iadBi5AEt7gTBXbDSSnMYQ (big blind) folded on the Turn
Seat 4: VhjwWfxHSx00WxzYih3KOA folded before Flop (didn't bet)
Seat 6: 5k9fvXD9suIgCxU4HLQjTw folded before Flop (didn't bet)
Seat 7: mSD1pginDsyHG5PDfqzphw folded before Flop (didn't bet)
Seat 8: 75K2MXwN65Sjfp1yHd50Hg folded before Flop (didn't bet)



PokerStars Game #59941522444:  Hold'em No Limit ($0.25/$0.50) - 2009/07/01 1:38:01 ET
Table '2lPOwetm4cfkZPbTmGPH/w' 2-max Seat #2 is the button
Seat 1: vUGdApqS8J/GJE2gaVWl1w ($13.60 in chips)
Seat 2: XFa6sBGjP2gxoIvxR3fZIg ($24.20 in chips)
XFa6sBGjP2gxoIvxR3fZIg: posts small blind $0.25
vUGdApqS8J/GJE2gaVWl1w: posts big blind $0.50
*** HOLE CARDS ***
XFa6sBGjP2gxoIvxR3fZIg: calls $0.25
vUGdApqS8J/GJE2gaVWl1w: raises $1 to $1.50
XFa6sBGjP2gxoIvxR3fZIg: folds
vUGdApqS8J/GJE2gaVWl1w collected $1 from pot
*** SUMMARY ***
Total pot $1 | Rake $0
Seat 1: vUGdApqS8J/GJE2gaVWl1w (big blind) collected ($1)
Seat 2: XFa6sBGjP2gxoIvxR3fZIg (button) (small blind) folded before Flop



PokerStars Game #59941522848:  Hold'em No Limit ($0.25/$0.50) - 2009/07/01 1:38:02 ET
Table '1pi9mHyVuXF/uue+aPQc4w' 9-max Seat #9 is the button
Seat 1: M+D23GG26WXQ/2gyjREVOQ ($49.50 in chips)
Seat 2: vHYT5s323LpajBj+2c9zbQ ($23.90 in chips)
Seat 3: HZkVla4kK2SI42CVrPZ/ig ($10.75 in chips)
Seat 4: mSD1pginDsyHG5PDfqzphw ($14.80 in chips)
Seat 5: zE9cVigS2nW/Ljy4K4bUQA ($30.65 in chips)
Seat 6: 1xBtrSVBbgFH/viUWKqQeg ($46.70 in chips)
Seat 7: 61sfw5QTu62YYIt68OsdrA ($33.55 in chips)
Seat 8: g4k0NXISyLCqaSWZDBjfEg ($97.05 in chips)
Seat 9: Q/gZC63lfOMr7YhWKPCxoQ ($9.70 in chips)
M+D23GG26WXQ/2gyjREVOQ: posts small blind $0.25
vHYT5s323LpajBj+2c9zbQ: posts big blind $0.50
*** HOLE CARDS ***
HZkVla4kK2SI42CVrPZ/ig: calls $0.50
mSD1pginDsyHG5PDfqzphw: folds
zE9cVigS2nW/Ljy4K4bUQA: folds
1xBtrSVBbgFH/viUWKqQeg: raises $1.50 to $2
61sfw5QTu62YYIt68OsdrA: folds
g4k0NXISyLCqaSWZDBjfEg: folds
Q/gZC63lfOMr7YhWKPCxoQ: folds
M+D23GG26WXQ/2gyjREVOQ: folds
vHYT5s323LpajBj+2c9zbQ: folds
HZkVla4kK2SI42CVrPZ/ig: calls $1.50
*** FLOP *** [9s 3h As]
HZkVla4kK2SI42CVrPZ/ig: checks
1xBtrSVBbgFH/viUWKqQeg: bets $2
HZkVla4kK2SI42CVrPZ/ig: folds
1xBtrSVBbgFH/viUWKqQeg collected $4.55 from pot
*** SUMMARY ***
Total pot $4.75 | Rake $0.20
Board [9s 3h As]
Seat 1: M+D23GG26WXQ/2gyjREVOQ (small blind) folded before Flop
Seat 2: vHYT5s323LpajBj+2c9zbQ (big blind) folded before Flop
Seat 3: HZkVla4kK2SI42CVrPZ/ig folded on the Flop
Seat 4: mSD1pginDsyHG5PDfqzphw folded before Flop (didn't bet)
Seat 5: zE9cVigS2nW/Ljy4K4bUQA folded before Flop (didn't bet)
Seat 6: 1xBtrSVBbgFH/viUWKqQeg collected ($4.55)
Seat 7: 61sfw5QTu62YYIt68OsdrA folded before Flop (didn't bet)
Seat 8: g4k0NXISyLCqaSWZDBjfEg folded before Flop (didn't bet)
Seat 9: Q/gZC63lfOMr7YhWKPCxoQ (button) folded before Flop (didn't bet)



PokerStars Game #59941523000:  Hold'em No Limit ($0.25/$0.50) - 2009/07/01 1:38:02 ET
Table 'tyR5AZNKV8Aadbrnrnlg7g' 6-max Seat #5 is the button
Seat 1: BgOXYI0yYSN1ULC4FqsNkg ($75.55 in chips)
Seat 3: JFLrYNyQmwPhRQAtoSAuyA ($60.85 in chips)
Seat 4: 4QfsCWthT/vSLirorNXqtg ($82.95 in chips)
Seat 5: GUnvMULl2qFOO1yenu1UBw ($80.35 in chips)
Seat 6: 498aWaGsW4uGfuWl+2FCGw ($80.85 in chips)
498aWaGsW4uGfuWl+2FCGw: posts small blind $0.25
BgOXYI0yYSN1ULC4FqsNkg: posts big blind $0.50
*** HOLE CARDS ***
JFLrYNyQmwPhRQAtoSAuyA: folds
4QfsCWthT/vSLirorNXqtg: folds
GUnvMULl2qFOO1yenu1UBw: folds
498aWaGsW4uGfuWl+2FCGw: folds
BAjwVL+zKKd0s0fAWstzQQ leaves the table
BgOXYI0yYSN1ULC4FqsNkg collected $0.50 from pot
*** SUMMARY ***
Total pot $0.50 | Rake $0
Seat 1: BgOXYI0yYSN1ULC4FqsNkg (big blind) collected ($0.50)
Seat 3: JFLrYNyQmwPhRQAtoSAuyA folded before Flop (didn't bet)
Seat 4: 4QfsCWthT/vSLirorNXqtg folded before Flop (didn't bet)
Seat 5: GUnvMULl2qFOO1yenu1UBw (button) folded before Flop (didn't bet)
Seat 6: 498aWaGsW4uGfuWl+2FCGw (small blind) folded before Flop



PokerStars Game #59941523552:  Hold'em No Limit ($0.25/$0.50) - 2009/07/01 1:38:03 ET
Table 'cofQFHU7jbJoFecLVBof/w' 6-max Seat #6 is the button
Seat 1: URYNc7fPA23K2UfadQbnCA ($51.20 in chips)
Seat 2: f89uTQr3ieGlusj2IAYAEg ($50 in chips)
Seat 3: v4ctePcLlQw0r8E0qJtjYw ($51.45 in chips)
Seat 5: QvwRlrpVqerRRF8eJm6dDw ($48.25 in chips)
Seat 6: 7+uQ0OOgCTbR4ltkSwyC0g ($160.05 in chips)
URYNc7fPA23K2UfadQbnCA: posts small blind $0.25
9XrTM0DuVxx1pjFAdSbD8A joins the table at seat #4
f89uTQr3ieGlusj2IAYAEg: posts big blind $0.50
*** HOLE CARDS ***
v4ctePcLlQw0r8E0qJtjYw: folds
QvwRlrpVqerRRF8eJm6dDw: folds
7+uQ0OOgCTbR4ltkSwyC0g: folds
URYNc7fPA23K2UfadQbnCA: folds
f89uTQr3ieGlusj2IAYAEg collected $0.50 from pot
*** SUMMARY ***
Total pot $0.50 | Rake $0
Seat 1: URYNc7fPA23K2UfadQbnCA (small blind) folded before Flop
Seat 2: f89uTQr3ieGlusj2IAYAEg (big blind) collected ($0.50)
Seat 3: v4ctePcLlQw0r8E0qJtjYw folded before Flop (didn't bet)
Seat 5: QvwRlrpVqerRRF8eJm6dDw folded before Flop (didn't bet)
Seat 6: 7+uQ0OOgCTbR4ltkSwyC0g (button) folded before Flop (didn't bet)



PokerStars Game #59941525360:  Hold'em No Limit ($0.25/$0.50) - 2009/07/01 1:38:06 ET
Table 'lSisgp6H7Fg1hH5VfjEjYQ' 9-max Seat #7 is the button
Seat 1: 5k9fvXD9suIgCxU4HLQjTw ($54.05 in chips)
Seat 2: 5acK4E7fzEwnplVBZ6eNWA ($50 in chips)
Seat 3: SKnJuWHScqetA/qG5p+wCg ($30 in chips)
Seat 4: FFVKBJT0lZf+jFlgvy7ang ($39.50 in chips)
Seat 5: mSD1pginDsyHG5PDfqzphw ($16.75 in chips)
Seat 6: +k7T5ocke8UwavtgUHm+Cg ($74.45 in chips)
Seat 7: IDtNLR9uFCDdjNsJWMHA5Q ($20.05 in chips)
Seat 8: a4JDWmpFQkL10XfAyuF51A ($10.70 in chips)
a4JDWmpFQkL10XfAyuF51A: posts small blind $0.25
5k9fvXD9suIgCxU4HLQjTw: posts big blind $0.50
*** HOLE CARDS ***
5acK4E7fzEwnplVBZ6eNWA: folds
SKnJuWHScqetA/qG5p+wCg: folds
FFVKBJT0lZf+jFlgvy7ang: folds
mSD1pginDsyHG5PDfqzphw: folds
+k7T5ocke8UwavtgUHm+Cg: raises $1 to $1.50
IDtNLR9uFCDdjNsJWMHA5Q: folds
a4JDWmpFQkL10XfAyuF51A: folds
5k9fvXD9suIgCxU4HLQjTw: folds
+k7T5ocke8UwavtgUHm+Cg collected $1.25 from pot
+k7T5ocke8UwavtgUHm+Cg: doesn't show hand
*** SUMMARY ***
Total pot $1.25 | Rake $0
Seat 1: 5k9fvXD9suIgCxU4HLQjTw (big blind) folded before Flop
Seat 2: 5acK4E7fzEwnplVBZ6eNWA folded before Flop (didn't bet)
Seat 3: SKnJuWHScqetA/qG5p+wCg folded before Flop (didn't bet)
Seat 4: FFVKBJT0lZf+jFlgvy7ang folded before Flop (didn't bet)
Seat 5: mSD1pginDsyHG5PDfqzphw folded before Flop (didn't bet)
Seat 6: +k7T5ocke8UwavtgUHm+Cg collected ($1.25)
Seat 7: IDtNLR9uFCDdjNsJWMHA5Q (button) folded before Flop (didn't bet)
Seat 8: a4JDWmpFQkL10XfAyuF51A (small blind) folded before Flop



PokerStars Game #59941525796:  Hold'em No Limit ($0.25/$0.50) - 2009/07/01 1:38:07 ET
Table '9ojijpRcYQSQTh6xI+haUA' 2-max Seat #1 is the button
Seat 1: FqpibuVWLNsAN/Z7ROZLnA ($63.45 in chips)
Seat 2: TitTV+fFCcBZWOERdytydA ($61.30 in chips)
FqpibuVWLNsAN/Z7ROZLnA: posts small blind $0.25
TitTV+fFCcBZWOERdytydA: posts big blind $0.50
*** HOLE CARDS ***
FqpibuVWLNsAN/Z7ROZLnA: calls $0.25
TitTV+fFCcBZWOERdytydA: checks
*** FLOP *** [Jd 3c 4s]
TitTV+fFCcBZWOERdytydA: checks
FqpibuVWLNsAN/Z7ROZLnA: checks
*** TURN *** [Jd 3c 4s] [4d]
TitTV+fFCcBZWOERdytydA: bets $1
FqpibuVWLNsAN/Z7ROZLnA: folds
TitTV+fFCcBZWOERdytydA collected $0.95 from pot
TitTV+fFCcBZWOERdytydA: doesn't show hand
*** SUMMARY ***
Total pot $1 | Rake $0.05
Board [Jd 3c 4s 4d]
Seat 1: FqpibuVWLNsAN/Z7ROZLnA (button) (small blind) folded on the Turn
Seat 2: TitTV+fFCcBZWOERdytydA (big blind) collected ($0.95)



PokerStars Game #59941528440:  Hold'em No Limit ($0.25/$0.50) - 2009/07/01 1:38:12 ET
Table '2lPOwetm4cfkZPbTmGPH/w' 2-max Seat #1 is the button
Seat 1: vUGdApqS8J/GJE2gaVWl1w ($14.10 in chips)
Seat 2: XFa6sBGjP2gxoIvxR3fZIg ($23.70 in chips)
vUGdApqS8J/GJE2gaVWl1w: posts small blind $0.25
XFa6sBGjP2gxoIvxR3fZIg: posts big blind $0.50
*** HOLE CARDS ***
vUGdApqS8J/GJE2gaVWl1w: raises $0.50 to $1
XFa6sBGjP2gxoIvxR3fZIg: calls $0.50
*** FLOP *** [5h 4c Qc]
XFa6sBGjP2gxoIvxR3fZIg: checks
vUGdApqS8J/GJE2gaVWl1w: checks
*** TURN *** [5h 4c Qc] [9s]
XFa6sBGjP2gxoIvxR3fZIg: bets $1.50
vUGdApqS8J/GJE2gaVWl1w: folds
XFa6sBGjP2gxoIvxR3fZIg collected $1.90 from pot
XFa6sBGjP2gxoIvxR3fZIg: doesn't show hand
*** SUMMARY ***
Total pot $2 | Rake $0.10
Board [5h 4c Qc 9s]
Seat 1: vUGdApqS8J/GJE2gaVWl1w (button) (small blind) folded on the Turn
Seat 2: XFa6sBGjP2gxoIvxR3fZIg (big blind) collected ($1.90)



PokerStars Game #59941528398:  Hold'em No Limit ($0.25/$0.50) - 2009/07/01 1:38:12 ET
Table 'tyR5AZNKV8Aadbrnrnlg7g' 6-max Seat #6 is the button
Seat 1: BgOXYI0yYSN1ULC4FqsNkg ($75.80 in chips)
Seat 3: JFLrYNyQmwPhRQAtoSAuyA ($60.85 in chips)
Seat 4: 4QfsCWthT/vSLirorNXqtg ($82.95 in chips)
Seat 5: GUnvMULl2qFOO1yenu1UBw ($80.35 in chips)
Seat 6: 498aWaGsW4uGfuWl+2FCGw ($80.60 in chips)
BgOXYI0yYSN1ULC4FqsNkg: posts small blind $0.25
JFLrYNyQmwPhRQAtoSAuyA: posts big blind $0.50
*** HOLE CARDS ***
4QfsCWthT/vSLirorNXqtg: folds
GUnvMULl2qFOO1yenu1UBw: folds
498aWaGsW4uGfuWl+2FCGw: folds
BgOXYI0yYSN1ULC4FqsNkg: folds
JFLrYNyQmwPhRQAtoSAuyA collected $0.50 from pot
JFLrYNyQmwPhRQAtoSAuyA: doesn't show hand
*** SUMMARY ***
Total pot $0.50 | Rake $0
Seat 1: BgOXYI0yYSN1ULC4FqsNkg (small blind) folded before Flop
Seat 3: JFLrYNyQmwPhRQAtoSAuyA (big blind) collected ($0.50)
Seat 4: 4QfsCWthT/vSLirorNXqtg folded before Flop (didn't bet)
Seat 5: GUnvMULl2qFOO1yenu1UBw folded before Flop (didn't bet)
Seat 6: 498aWaGsW4uGfuWl+2FCGw (button) folded before Flop (didn't bet)



PokerStars Game #59941528868:  Hold'em No Limit ($0.25/$0.50) - 2009/07/01 1:38:13 ET
Table 'Wwfm5/i+g/g2Nj2gT3jnVQ' 2-max Seat #1 is the button
Seat 1: CHRLZDaaxjbo68bwQD1C/Q ($6.45 in chips)
Seat 2: PKuuhUvIr5WSkJyPJa9dFw ($23.25 in chips)
CHRLZDaaxjbo68bwQD1C/Q: posts small blind $0.25
PKuuhUvIr5WSkJyPJa9dFw: posts big blind $0.50
*** HOLE CARDS ***
CHRLZDaaxjbo68bwQD1C/Q: calls $0.25
PKuuhUvIr5WSkJyPJa9dFw: checks
*** FLOP *** [Ac 6h 2h]
PKuuhUvIr5WSkJyPJa9dFw: checks
CHRLZDaaxjbo68bwQD1C/Q: bets $0.50
PKuuhUvIr5WSkJyPJa9dFw: calls $0.50
*** TURN *** [Ac 6h 2h] [Qs]
PKuuhUvIr5WSkJyPJa9dFw: checks
CHRLZDaaxjbo68bwQD1C/Q: bets $0.50
PKuuhUvIr5WSkJyPJa9dFw: calls $0.50
*** RIVER *** [Ac 6h 2h Qs] [8s]
PKuuhUvIr5WSkJyPJa9dFw: checks
CHRLZDaaxjbo68bwQD1C/Q: bets $0.50
PKuuhUvIr5WSkJyPJa9dFw: folds
CHRLZDaaxjbo68bwQD1C/Q collected $2.90 from pot
CHRLZDaaxjbo68bwQD1C/Q: doesn't show hand
*** SUMMARY ***
Total pot $3 | Rake $0.10
Board [Ac 6h 2h Qs 8s]
Seat 1: CHRLZDaaxjbo68bwQD1C/Q (button) (small blind) collected ($2.90)
Seat 2: PKuuhUvIr5WSkJyPJa9dFw (big blind) folded on the River



PokerStars Game #59941530064:  Hold'em No Limit ($0.25/$0.50) - 2009/07/01 1:38:15 ET
Table 'hSTs/dUsYLgJQuF2Onp0MQ' 6-max Seat #5 is the button
Seat 2: Hdd4js36ITbTJ/QuVYwTlA ($101 in chips)
Seat 3: lxIzoHy0RnkfFSODHC2liw ($50 in chips)
Seat 4: 2igtJLmvIZ+HqX4XPgMPZA ($50 in chips)
Seat 5: FsRQ5ECdlLkLYI5le8+PDQ ($48.50 in chips)
Seat 6: M1KyQQvVPVuxqTAB8sR/zQ ($102.15 in chips)
M1KyQQvVPVuxqTAB8sR/zQ: posts small blind $0.25
1WUCqNG+p+vfWRTXNu4ljw: is sitting out
Hdd4js36ITbTJ/QuVYwTlA: posts big blind $0.50
*** HOLE CARDS ***
lxIzoHy0RnkfFSODHC2liw: folds
2igtJLmvIZ+HqX4XPgMPZA: folds
FsRQ5ECdlLkLYI5le8+PDQ: folds
M1KyQQvVPVuxqTAB8sR/zQ: folds
Hdd4js36ITbTJ/QuVYwTlA collected $0.50 from pot
*** SUMMARY ***
Total pot $0.50 | Rake $0
Seat 2: Hdd4js36ITbTJ/QuVYwTlA (big blind) collected ($0.50)
Seat 3: lxIzoHy0RnkfFSODHC2liw folded before Flop (didn't bet)
Seat 4: 2igtJLmvIZ+HqX4XPgMPZA folded before Flop (didn't bet)
Seat 5: FsRQ5ECdlLkLYI5le8+PDQ (button) folded before Flop (didn't bet)
Seat 6: M1KyQQvVPVuxqTAB8sR/zQ (small blind) folded before Flop



PokerStars Game #59941532094:  Hold'em No Limit ($0.25/$0.50) - 2009/07/01 1:38:19 ET
Table 'B+sqsfj6d6zXicNfaseTaw' 2-max Seat #2 is the button
Seat 1: +4GNcSsecmapVGSdV0mUPA ($144.15 in chips)
Seat 2: Lv5RmpRe6LtPkBzM9Gpo5A ($76.85 in chips)
Lv5RmpRe6LtPkBzM9Gpo5A: posts small blind $0.25
+4GNcSsecmapVGSdV0mUPA: posts big blind $0.50
*** HOLE CARDS ***
Lv5RmpRe6LtPkBzM9Gpo5A: folds
+4GNcSsecmapVGSdV0mUPA collected $0.50 from pot
*** SUMMARY ***
Total pot $0.50 | Rake $0
Seat 1: +4GNcSsecmapVGSdV0mUPA (big blind) collected ($0.50)
Seat 2: Lv5RmpRe6LtPkBzM9Gpo5A (button) (small blind) folded before Flop



PokerStars Game #59941532048:  Hold'em No Limit ($0.25/$0.50) - 2009/07/01 1:38:19 ET
Table 'kgbJRsxfv64KrErDRBAkcw' 6-max Seat #5 is the button
Seat 1: VamsyhlFzXGF6/ydo0BHeA ($15 in chips)
Seat 2: AdS8BJMOheS01zjCDfPMFg ($79.30 in chips)
Seat 3: c4MNIaIyPMOMxrgT8FT5nA ($156 in chips)
Seat 4: 2igtJLmvIZ+HqX4XPgMPZA ($111.75 in chips)
Seat 5: eUBBn2R56C1IQ6Cs/vitwg ($106 in chips)
Seat 6: 1b+2BbjMN8qhR1WPqdE9VQ ($50 in chips)
1b+2BbjMN8qhR1WPqdE9VQ: posts small blind $0.25
VamsyhlFzXGF6/ydo0BHeA: posts big blind $0.50
*** HOLE CARDS ***
AdS8BJMOheS01zjCDfPMFg: raises $1 to $1.50
c4MNIaIyPMOMxrgT8FT5nA: folds
2igtJLmvIZ+HqX4XPgMPZA: folds
eUBBn2R56C1IQ6Cs/vitwg: folds
1b+2BbjMN8qhR1WPqdE9VQ: folds
VamsyhlFzXGF6/ydo0BHeA: calls $1
*** FLOP *** [Qs Td Jh]
VamsyhlFzXGF6/ydo0BHeA: checks
AdS8BJMOheS01zjCDfPMFg: bets $1
VamsyhlFzXGF6/ydo0BHeA: raises $2 to $3
AdS8BJMOheS01zjCDfPMFg: calls $2
*** TURN *** [Qs Td Jh] [Kh]
VamsyhlFzXGF6/ydo0BHeA: checks
AdS8BJMOheS01zjCDfPMFg: bets $2.50
VamsyhlFzXGF6/ydo0BHeA: calls $2.50
*** RIVER *** [Qs Td Jh Kh] [7s]
VamsyhlFzXGF6/ydo0BHeA: checks
AdS8BJMOheS01zjCDfPMFg: bets $3
VamsyhlFzXGF6/ydo0BHeA: calls $3
*** SHOW DOWN ***
AdS8BJMOheS01zjCDfPMFg: shows [Qd As] (a straight, Ten to Ace)
VamsyhlFzXGF6/ydo0BHeA: mucks hand
AdS8BJMOheS01zjCDfPMFg collected $19.30 from pot
*** SUMMARY ***
Total pot $20.25 | Rake $0.95
Board [Qs Td Jh Kh 7s]
Seat 1: VamsyhlFzXGF6/ydo0BHeA (big blind) mucked
Seat 2: AdS8BJMOheS01zjCDfPMFg showed [Qd As] and won ($19.30) with a straight, Ten to Ace
Seat 3: c4MNIaIyPMOMxrgT8FT5nA folded before Flop (didn't bet)
Seat 4: 2igtJLmvIZ+HqX4XPgMPZA folded before Flop (didn't bet)
Seat 5: eUBBn2R56C1IQ6Cs/vitwg (button) folded before Flop (didn't bet)
Seat 6: 1b+2BbjMN8qhR1WPqdE9VQ (small blind) folded before Flop



PokerStars Game #59941532338:  Hold'em No Limit ($0.25/$0.50) - 2009/07/01 1:38:19 ET
Table 'GfL/No5u5PoEnU39lP5pQg' 6-max Seat #4 is the button
Seat 1: 1WUCqNG+p+vfWRTXNu4ljw ($78.65 in chips)
Seat 2: uVwggSetzp7d+eVgowO3vg ($55.05 in chips)
Seat 3: 4pp9WxhGdbVbxCc9tlu0lw ($24.55 in chips)
Seat 4: vhWS+cwAJNd3JzqVzIjBZA ($50 in chips)
Seat 5: M1KyQQvVPVuxqTAB8sR/zQ ($50.45 in chips)
Seat 6: kxPhs4ePFqMy52CInAJ2aw ($94.55 in chips)
M1KyQQvVPVuxqTAB8sR/zQ: posts small blind $0.25
kxPhs4ePFqMy52CInAJ2aw: posts big blind $0.50
*** HOLE CARDS ***
1WUCqNG+p+vfWRTXNu4ljw: folds
uVwggSetzp7d+eVgowO3vg: folds
4pp9WxhGdbVbxCc9tlu0lw: calls $0.50
vhWS+cwAJNd3JzqVzIjBZA: folds
M1KyQQvVPVuxqTAB8sR/zQ: folds
kxPhs4ePFqMy52CInAJ2aw: checks
*** FLOP *** [5h Js 8h]
kxPhs4ePFqMy52CInAJ2aw: checks
4pp9WxhGdbVbxCc9tlu0lw: bets $0.50
kxPhs4ePFqMy52CInAJ2aw: folds
4pp9WxhGdbVbxCc9tlu0lw collected $1.20 from pot
*** SUMMARY ***
Total pot $1.25 | Rake $0.05
Board [5h Js 8h]
Seat 1: 1WUCqNG+p+vfWRTXNu4ljw folded before Flop (didn't bet)
Seat 2: uVwggSetzp7d+eVgowO3vg folded before Flop (didn't bet)
Seat 3: 4pp9WxhGdbVbxCc9tlu0lw collected ($1.20)
Seat 4: vhWS+cwAJNd3JzqVzIjBZA (button) folded before Flop (didn't bet)
Seat 5: M1KyQQvVPVuxqTAB8sR/zQ (small blind) folded before Flop
Seat 6: kxPhs4ePFqMy52CInAJ2aw (big blind) folded on the Flop



PokerStars Game #59941532776:  Hold'em No Limit ($0.25/$0.50) - 2009/07/01 1:38:20 ET
Table '8BQGgNetI1NOvWeu3gtMNw' 2-max Seat #2 is the button
Seat 1: bypIyrYcAAifLfhZpGlKLA ($77.65 in chips)
Seat 2: Z4HwehErEwzsv/noQlfUlg ($136.10 in chips)
Z4HwehErEwzsv/noQlfUlg: posts small blind $0.25
bypIyrYcAAifLfhZpGlKLA: posts big blind $0.50
*** HOLE CARDS ***
Z4HwehErEwzsv/noQlfUlg: folds
bypIyrYcAAifLfhZpGlKLA collected $0.50 from pot
bypIyrYcAAifLfhZpGlKLA: doesn't show hand
*** SUMMARY ***
Total pot $0.50 | Rake $0
Seat 1: bypIyrYcAAifLfhZpGlKLA (big blind) collected ($0.50)
Seat 2: Z4HwehErEwzsv/noQlfUlg (button) (small blind) folded before Flop



PokerStars Game #59941533040:  Hold'em No Limit ($0.25/$0.50) - 2009/07/01 1:38:20 ET
Table 'iq+aXfWVQRdV0u8SRTYUEg' 9-max Seat #9 is the button
Seat 1: 3yl8Q6QaLfGtyhN4/pEFgQ ($71.80 in chips)
Seat 2: J9N0lxHFd/Js2S0xZLbsIQ ($25.30 in chips)
Seat 4: vHYT5s323LpajBj+2c9zbQ ($25.35 in chips)
Seat 5: 997ViqAtWn1FPjJqcffwcA ($56.90 in chips)
Seat 6: bTJ0WgoxefTPxIoycS7uoA ($30.95 in chips)
Seat 7: SKnJuWHScqetA/qG5p+wCg ($30.05 in chips)
Seat 8: /DtIHuxEH+3tzKefmSV+Mw ($44.65 in chips)
Seat 9: 7CKaQEWhd40e2lLifzZ1Cw ($41.15 in chips)
3yl8Q6QaLfGtyhN4/pEFgQ: posts small blind $0.25
J9N0lxHFd/Js2S0xZLbsIQ: posts big blind $0.50
*** HOLE CARDS ***
vHYT5s323LpajBj+2c9zbQ: folds
997ViqAtWn1FPjJqcffwcA: folds
bTJ0WgoxefTPxIoycS7uoA: calls $0.50
Qi/PyOsKwaqtKIg0H+7ELg has returned
SKnJuWHScqetA/qG5p+wCg has timed out
SKnJuWHScqetA/qG5p+wCg: folds
SKnJuWHScqetA/qG5p+wCg is sitting out
SKnJuWHScqetA/qG5p+wCg has returned
/DtIHuxEH+3tzKefmSV+Mw: folds
7CKaQEWhd40e2lLifzZ1Cw: folds
7CKaQEWhd40e2lLifzZ1Cw leaves the table
3yl8Q6QaLfGtyhN4/pEFgQ: folds
J9N0lxHFd/Js2S0xZLbsIQ: raises $2 to $2.50
bTJ0WgoxefTPxIoycS7uoA: folds
J9N0lxHFd/Js2S0xZLbsIQ collected $1.25 from pot
*** SUMMARY ***
Total pot $1.25 | Rake $0
Seat 1: 3yl8Q6QaLfGtyhN4/pEFgQ (small blind) folded before Flop
Seat 2: J9N0lxHFd/Js2S0xZLbsIQ (big blind) collected ($1.25)
Seat 4: vHYT5s323LpajBj+2c9zbQ folded before Flop (didn't bet)
Seat 5: 997ViqAtWn1FPjJqcffwcA folded before Flop (didn't bet)
Seat 6: bTJ0WgoxefTPxIoycS7uoA folded before Flop
Seat 7: SKnJuWHScqetA/qG5p+wCg folded before Flop (didn't bet)
Seat 8: /DtIHuxEH+3tzKefmSV+Mw folded before Flop (didn't bet)
Seat 9: 7CKaQEWhd40e2lLifzZ1Cw (button) folded before Flop (didn't bet)



PokerStars Game #59941532534:  Hold'em No Limit ($0.25/$0.50) - 2009/07/01 1:38:20 ET
Table '+z1aekfHkpp09pc8F9aViw' 6-max Seat #3 is the button
Seat 1: L0aIPg7qefDQjdJo3HCVEA ($10 in chips)
Seat 3: URYNc7fPA23K2UfadQbnCA ($61.65 in chips)
Seat 4: RowCSpSURHTOL/dcjg/Iug ($85.95 in chips)
Seat 5: 2igtJLmvIZ+HqX4XPgMPZA ($50 in chips)
Seat 6: GUnvMULl2qFOO1yenu1UBw ($51.50 in chips)
RowCSpSURHTOL/dcjg/Iug: posts small blind $0.25
2igtJLmvIZ+HqX4XPgMPZA: posts big blind $0.50
*** HOLE CARDS ***
GUnvMULl2qFOO1yenu1UBw: folds
L0aIPg7qefDQjdJo3HCVEA: raises $0.50 to $1
URYNc7fPA23K2UfadQbnCA: folds
RowCSpSURHTOL/dcjg/Iug: folds
2igtJLmvIZ+HqX4XPgMPZA: folds
L0aIPg7qefDQjdJo3HCVEA collected $1.25 from pot
*** SUMMARY ***
Total pot $1.25 | Rake $0
Seat 1: L0aIPg7qefDQjdJo3HCVEA collected ($1.25)
Seat 3: URYNc7fPA23K2UfadQbnCA (button) folded before Flop (didn't bet)
Seat 4: RowCSpSURHTOL/dcjg/Iug (small blind) folded before Flop
Seat 5: 2igtJLmvIZ+HqX4XPgMPZA (big blind) folded before Flop
Seat 6: GUnvMULl2qFOO1yenu1UBw folded before Flop (didn't bet)



PokerStars Game #59941534188:  Hold'em No Limit ($0.25/$0.50) - 2009/07/01 1:38:23 ET
Table 'cofQFHU7jbJoFecLVBof/w' 6-max Seat #1 is the button
Seat 1: URYNc7fPA23K2UfadQbnCA ($50.95 in chips)
Seat 2: f89uTQr3ieGlusj2IAYAEg ($50.25 in chips)
Seat 3: v4ctePcLlQw0r8E0qJtjYw ($51.45 in chips)
Seat 5: QvwRlrpVqerRRF8eJm6dDw ($48.25 in chips)
Seat 6: 7+uQ0OOgCTbR4ltkSwyC0g ($160.05 in chips)
f89uTQr3ieGlusj2IAYAEg: posts small blind $0.25
v4ctePcLlQw0r8E0qJtjYw: posts big blind $0.50
9XrTM0DuVxx1pjFAdSbD8A: sits out
*** HOLE CARDS ***
QvwRlrpVqerRRF8eJm6dDw: raises $0.50 to $1
7+uQ0OOgCTbR4ltkSwyC0g: folds
URYNc7fPA23K2UfadQbnCA: folds
f89uTQr3ieGlusj2IAYAEg: calls $0.75
v4ctePcLlQw0r8E0qJtjYw: folds
*** FLOP *** [6s Ks Js]
f89uTQr3ieGlusj2IAYAEg: checks
QvwRlrpVqerRRF8eJm6dDw: bets $3
f89uTQr3ieGlusj2IAYAEg: folds
QvwRlrpVqerRRF8eJm6dDw collected $2.40 from pot
*** SUMMARY ***
Total pot $2.50 | Rake $0.10
Board [6s Ks Js]
Seat 1: URYNc7fPA23K2UfadQbnCA (button) folded before Flop (didn't bet)
Seat 2: f89uTQr3ieGlusj2IAYAEg (small blind) folded on the Flop
Seat 3: v4ctePcLlQw0r8E0qJtjYw (big blind) folded before Flop
Seat 5: QvwRlrpVqerRRF8eJm6dDw collected ($2.40)
Seat 6: 7+uQ0OOgCTbR4ltkSwyC0g folded before Flop (didn't bet)



PokerStars Game #59941534690:  Hold'em No Limit ($0.25/$0.50) - 2009/07/01 1:38:24 ET
Table 'tyR5AZNKV8Aadbrnrnlg7g' 6-max Seat #1 is the button
Seat 1: BgOXYI0yYSN1ULC4FqsNkg ($75.55 in chips)
Seat 3: JFLrYNyQmwPhRQAtoSAuyA ($61.10 in chips)
Seat 4: 4QfsCWthT/vSLirorNXqtg ($82.95 in chips)
Seat 5: GUnvMULl2qFOO1yenu1UBw ($80.35 in chips)
Seat 6: 498aWaGsW4uGfuWl+2FCGw ($80.60 in chips)
JFLrYNyQmwPhRQAtoSAuyA: posts small blind $0.25
4QfsCWthT/vSLirorNXqtg: posts big blind $0.50
*** HOLE CARDS ***
GUnvMULl2qFOO1yenu1UBw: folds
498aWaGsW4uGfuWl+2FCGw: raises $1 to $1.50
BgOXYI0yYSN1ULC4FqsNkg: folds
JFLrYNyQmwPhRQAtoSAuyA: folds
4QfsCWthT/vSLirorNXqtg: folds
498aWaGsW4uGfuWl+2FCGw collected $1.25 from pot
*** SUMMARY ***
Total pot $1.25 | Rake $0
Seat 1: BgOXYI0yYSN1ULC4FqsNkg (button) folded before Flop (didn't bet)
Seat 3: JFLrYNyQmwPhRQAtoSAuyA (small blind) folded before Flop
Seat 4: 4QfsCWthT/vSLirorNXqtg (big blind) folded before Flop
Seat 5: GUnvMULl2qFOO1yenu1UBw folded before Flop (didn't bet)
Seat 6: 498aWaGsW4uGfuWl+2FCGw collected ($1.25)



PokerStars Game #59941535044:  Hold'em No Limit ($0.25/$0.50) - 2009/07/01 1:38:24 ET
Table 'lSisgp6H7Fg1hH5VfjEjYQ' 9-max Seat #8 is the button
Seat 1: 5k9fvXD9suIgCxU4HLQjTw ($53.55 in chips)
Seat 2: 5acK4E7fzEwnplVBZ6eNWA ($50 in chips)
Seat 3: SKnJuWHScqetA/qG5p+wCg ($30 in chips)
Seat 4: FFVKBJT0lZf+jFlgvy7ang ($39.50 in chips)
Seat 5: mSD1pginDsyHG5PDfqzphw ($16.75 in chips)
Seat 6: +k7T5ocke8UwavtgUHm+Cg ($75.20 in chips)
Seat 7: IDtNLR9uFCDdjNsJWMHA5Q ($20.05 in chips)
Seat 8: a4JDWmpFQkL10XfAyuF51A ($10.45 in chips)
5k9fvXD9suIgCxU4HLQjTw: posts small blind $0.25
5acK4E7fzEwnplVBZ6eNWA: posts big blind $0.50
*** HOLE CARDS ***
SKnJuWHScqetA/qG5p+wCg: folds
FFVKBJT0lZf+jFlgvy7ang: calls $0.50
mSD1pginDsyHG5PDfqzphw: folds
+k7T5ocke8UwavtgUHm+Cg: folds
IDtNLR9uFCDdjNsJWMHA5Q: calls $0.50
a4JDWmpFQkL10XfAyuF51A: folds
5k9fvXD9suIgCxU4HLQjTw: folds
5acK4E7fzEwnplVBZ6eNWA: checks
*** FLOP *** [Qs 3d 5c]
5acK4E7fzEwnplVBZ6eNWA: checks
FFVKBJT0lZf+jFlgvy7ang: checks
IDtNLR9uFCDdjNsJWMHA5Q: checks
*** TURN *** [Qs 3d 5c] [Kh]
5acK4E7fzEwnplVBZ6eNWA: bets $1.25
FFVKBJT0lZf+jFlgvy7ang: folds
IDtNLR9uFCDdjNsJWMHA5Q: folds
5acK4E7fzEwnplVBZ6eNWA collected $1.70 from pot
5acK4E7fzEwnplVBZ6eNWA: doesn't show hand
*** SUMMARY ***
Total pot $1.75 | Rake $0.05
Board [Qs 3d 5c Kh]
Seat 1: 5k9fvXD9suIgCxU4HLQjTw (small blind) folded before Flop
Seat 2: 5acK4E7fzEwnplVBZ6eNWA (big blind) collected ($1.70)
Seat 3: SKnJuWHScqetA/qG5p+wCg folded before Flop (didn't bet)
Seat 4: FFVKBJT0lZf+jFlgvy7ang folded on the Turn
Seat 5: mSD1pginDsyHG5PDfqzphw folded before Flop (didn't bet)
Seat 6: +k7T5ocke8UwavtgUHm+Cg folded before Flop (didn't bet)
Seat 7: IDtNLR9uFCDdjNsJWMHA5Q folded on the Turn
Seat 8: a4JDWmpFQkL10XfAyuF51A (button) folded before Flop (didn't bet)



PokerStars Game #59941535628:  Hold'em No Limit ($0.25/$0.50) - 2009/07/01 1:38:25 ET
Table 'hWT2kq66tnKEpD26cia6fQ' 2-max Seat #1 is the button
Seat 1: Ce3KNFP+ao7Da9NHb65raw ($17.05 in chips)
Seat 2: 16tvT7AYgZ2LgiGFcvFKQg ($56.85 in chips)
Ce3KNFP+ao7Da9NHb65raw: posts small blind $0.25
16tvT7AYgZ2LgiGFcvFKQg: posts big blind $0.50
*** HOLE CARDS ***
Ce3KNFP+ao7Da9NHb65raw: raises $0.50 to $1
16tvT7AYgZ2LgiGFcvFKQg: calls $0.50
*** FLOP *** [Kd 6d 7c]
16tvT7AYgZ2LgiGFcvFKQg: checks
Ce3KNFP+ao7Da9NHb65raw: bets $1
16tvT7AYgZ2LgiGFcvFKQg: calls $1
*** TURN *** [Kd 6d 7c] [Qd]
16tvT7AYgZ2LgiGFcvFKQg: checks
Ce3KNFP+ao7Da9NHb65raw: checks
*** RIVER *** [Kd 6d 7c Qd] [5s]
16tvT7AYgZ2LgiGFcvFKQg: checks
Ce3KNFP+ao7Da9NHb65raw: bets $1
16tvT7AYgZ2LgiGFcvFKQg: calls $1
*** SHOW DOWN ***
Ce3KNFP+ao7Da9NHb65raw: shows [8s Qc] (a pair of Queens)
16tvT7AYgZ2LgiGFcvFKQg: mucks hand
Ce3KNFP+ao7Da9NHb65raw collected $5.75 from pot
*** SUMMARY ***
Total pot $6 | Rake $0.25
Board [Kd 6d 7c Qd 5s]
Seat 1: Ce3KNFP+ao7Da9NHb65raw (button) (small blind) showed [8s Qc] and won ($5.75) with a pair of Queens
Seat 2: 16tvT7AYgZ2LgiGFcvFKQg (big blind) mucked



PokerStars Game #59941535286:  Hold'em No Limit ($0.25/$0.50) - 2009/07/01 1:38:25 ET
Table 'B+sqsfj6d6zXicNfaseTaw' 2-max Seat #1 is the button
Seat 1: +4GNcSsecmapVGSdV0mUPA ($144.40 in chips)
Seat 2: Lv5RmpRe6LtPkBzM9Gpo5A ($76.60 in chips)
+4GNcSsecmapVGSdV0mUPA: posts small blind $0.25
Lv5RmpRe6LtPkBzM9Gpo5A: posts big blind $0.50
*** HOLE CARDS ***
+4GNcSsecmapVGSdV0mUPA: raises $1 to $1.50
Lv5RmpRe6LtPkBzM9Gpo5A: calls $1
*** FLOP *** [5c Kd Tc]
Lv5RmpRe6LtPkBzM9Gpo5A: checks
+4GNcSsecmapVGSdV0mUPA: bets $1
Lv5RmpRe6LtPkBzM9Gpo5A: folds
+4GNcSsecmapVGSdV0mUPA collected $2.85 from pot
+4GNcSsecmapVGSdV0mUPA: doesn't show hand
*** SUMMARY ***
Total pot $3 | Rake $0.15
Board [5c Kd Tc]
Seat 1: +4GNcSsecmapVGSdV0mUPA (button) (small blind) collected ($2.85)
Seat 2: Lv5RmpRe6LtPkBzM9Gpo5A (big blind) folded on the Flop



PokerStars Game #59941535810:  Hold'em No Limit ($0.25/$0.50) - 2009/07/01 1:38:26 ET
Table '9ojijpRcYQSQTh6xI+haUA' 2-max Seat #2 is the button
Seat 1: FqpibuVWLNsAN/Z7ROZLnA ($62.95 in chips)
Seat 2: TitTV+fFCcBZWOERdytydA ($61.75 in chips)
TitTV+fFCcBZWOERdytydA: posts small blind $0.25
FqpibuVWLNsAN/Z7ROZLnA: posts big blind $0.50
*** HOLE CARDS ***
TitTV+fFCcBZWOERdytydA: raises $1.50 to $2
FqpibuVWLNsAN/Z7ROZLnA: calls $1.50
*** FLOP *** [2c Qd As]
FqpibuVWLNsAN/Z7ROZLnA: checks
TitTV+fFCcBZWOERdytydA: checks
*** TURN *** [2c Qd As] [6d]
FqpibuVWLNsAN/Z7ROZLnA: checks
TitTV+fFCcBZWOERdytydA: checks
*** RIVER *** [2c Qd As 6d] [4c]
FqpibuVWLNsAN/Z7ROZLnA: bets $3.50
TitTV+fFCcBZWOERdytydA: raises $6.50 to $10
FqpibuVWLNsAN/Z7ROZLnA: calls $6.50
*** SHOW DOWN ***
TitTV+fFCcBZWOERdytydA: shows [6c 6s] (three of a kind, Sixes)
FqpibuVWLNsAN/Z7ROZLnA: mucks hand
TitTV+fFCcBZWOERdytydA collected $23.50 from pot
*** SUMMARY ***
Total pot $24 | Rake $0.50
Board [2c Qd As 6d 4c]
Seat 1: FqpibuVWLNsAN/Z7ROZLnA (big blind) mucked
Seat 2: TitTV+fFCcBZWOERdytydA (button) (small blind) showed [6c 6s] and won ($23.50) with three of a kind, Sixes



PokerStars Game #59941535778:  Hold'em No Limit ($0.25/$0.50) - 2009/07/01 1:38:26 ET
Table '5qf8oPyYje71HBKD0FwPgQ' 9-max Seat #5 is the button
Seat 2: M+7+BTmX5vZatHVuoRB1nA ($53.15 in chips)
Seat 3: vacmVLJJECYI6HjAynFcpg ($50.45 in chips)
Seat 4: YXCE3WOZi8g2sIf3y/plVw ($53.85 in chips)
Seat 5: uo2Sgpknd7NdeVbeSCG02A ($15.70 in chips)
Seat 6: go0Ad6tqqJ4tR9/bqVlO0g ($26.45 in chips)
Seat 7: 1q5EPoiflJRl8pqfnVLjMw ($57.05 in chips)
Seat 8: sakr/FIfFtIZwDPmAj5Pzg ($59.10 in chips)
Seat 9: jWDRpL0TJljg+mBCE9ZMqA ($7.85 in chips)
go0Ad6tqqJ4tR9/bqVlO0g: posts small blind $0.25
1q5EPoiflJRl8pqfnVLjMw: posts big blind $0.50
gsyXT42WLEcOS4DdEk2wlw: sits out
*** HOLE CARDS ***
sakr/FIfFtIZwDPmAj5Pzg: folds
jWDRpL0TJljg+mBCE9ZMqA: folds
M+7+BTmX5vZatHVuoRB1nA: folds
vacmVLJJECYI6HjAynFcpg: raises $1.50 to $2
YXCE3WOZi8g2sIf3y/plVw: folds
uo2Sgpknd7NdeVbeSCG02A: folds
go0Ad6tqqJ4tR9/bqVlO0g: folds
1q5EPoiflJRl8pqfnVLjMw: folds
vacmVLJJECYI6HjAynFcpg collected $1.25 from pot
vacmVLJJECYI6HjAynFcpg: doesn't show hand
*** SUMMARY ***
Total pot $1.25 | Rake $0
Seat 2: M+7+BTmX5vZatHVuoRB1nA folded before Flop (didn't bet)
Seat 3: vacmVLJJECYI6HjAynFcpg collected ($1.25)
Seat 4: YXCE3WOZi8g2sIf3y/plVw folded before Flop (didn't bet)
Seat 5: uo2Sgpknd7NdeVbeSCG02A (button) folded before Flop (didn't bet)
Seat 6: go0Ad6tqqJ4tR9/bqVlO0g (small blind) folded before Flop
Seat 7: 1q5EPoiflJRl8pqfnVLjMw (big blind) folded before Flop
Seat 8: sakr/FIfFtIZwDPmAj5Pzg folded before Flop (didn't bet)
Seat 9: jWDRpL0TJljg+mBCE9ZMqA folded before Flop (didn't bet)



PokerStars Game #59941536614:  Hold'em No Limit ($0.25/$0.50) - 2009/07/01 1:38:27 ET
Table '8BQGgNetI1NOvWeu3gtMNw' 2-max Seat #1 is the button
Seat 1: bypIyrYcAAifLfhZpGlKLA ($77.90 in chips)
Seat 2: Z4HwehErEwzsv/noQlfUlg ($135.85 in chips)
bypIyrYcAAifLfhZpGlKLA: posts small blind $0.25
Z4HwehErEwzsv/noQlfUlg: posts big blind $0.50
*** HOLE CARDS ***
bypIyrYcAAifLfhZpGlKLA: raises $1 to $1.50
Z4HwehErEwzsv/noQlfUlg: folds
bypIyrYcAAifLfhZpGlKLA collected $1 from pot
bypIyrYcAAifLfhZpGlKLA: doesn't show hand
*** SUMMARY ***
Total pot $1 | Rake $0
Seat 1: bypIyrYcAAifLfhZpGlKLA (button) (small blind) collected ($1)
Seat 2: Z4HwehErEwzsv/noQlfUlg (big blind) folded before Flop



PokerStars Game #59941538320:  Hold'em No Limit ($0.25/$0.50) - 2009/07/01 1:38:30 ET
Table 'fx6MqwfYAj/Rt86hBz2L3Q' 9-max Seat #2 is the button
Seat 1: v/4aX0ejnaIFK4ftDk2Lyg ($49.90 in chips)
Seat 2: C3rGXblctNcWI6JYPHhaEg ($53.45 in chips)
Seat 4: VhjwWfxHSx00WxzYih3KOA ($50 in chips)
Seat 5: e2+sK/yjnj94rXOKoxPP2A ($50 in chips)
Seat 6: 5k9fvXD9suIgCxU4HLQjTw ($50 in chips)
Seat 7: mSD1pginDsyHG5PDfqzphw ($11.50 in chips)
Seat 8: 75K2MXwN65Sjfp1yHd50Hg ($12.25 in chips)
VhjwWfxHSx00WxzYih3KOA: posts small blind $0.25
e2+sK/yjnj94rXOKoxPP2A: posts big blind $0.50
Alf.STG: sits out
*** HOLE CARDS ***
5k9fvXD9suIgCxU4HLQjTw: folds
mSD1pginDsyHG5PDfqzphw: folds
75K2MXwN65Sjfp1yHd50Hg: folds
v/4aX0ejnaIFK4ftDk2Lyg: folds
C3rGXblctNcWI6JYPHhaEg: calls $0.50
VhjwWfxHSx00WxzYih3KOA: calls $0.25
e2+sK/yjnj94rXOKoxPP2A: checks
*** FLOP *** [4d 3s 9s]
VhjwWfxHSx00WxzYih3KOA: checks
e2+sK/yjnj94rXOKoxPP2A: bets $1
C3rGXblctNcWI6JYPHhaEg: calls $1
VhjwWfxHSx00WxzYih3KOA: folds
*** TURN *** [4d 3s 9s] [6h]
C3rGXblctNcWI6JYPHhaEg said, "last hand ttyl"
tkflckdgk joins the table at seat #3
e2+sK/yjnj94rXOKoxPP2A: checks
C3rGXblctNcWI6JYPHhaEg: bets $1
e2+sK/yjnj94rXOKoxPP2A: folds
C3rGXblctNcWI6JYPHhaEg collected $3.35 from pot
C3rGXblctNcWI6JYPHhaEg is sitting out
*** SUMMARY ***
Total pot $3.50 | Rake $0.15
Board [4d 3s 9s 6h]
Seat 1: v/4aX0ejnaIFK4ftDk2Lyg folded before Flop (didn't bet)
Seat 2: C3rGXblctNcWI6JYPHhaEg (button) collected ($3.35)
Seat 4: VhjwWfxHSx00WxzYih3KOA (small blind) folded on the Flop
Seat 5: e2+sK/yjnj94rXOKoxPP2A (big blind) folded on the Turn
Seat 6: 5k9fvXD9suIgCxU4HLQjTw folded before Flop (didn't bet)
Seat 7: mSD1pginDsyHG5PDfqzphw folded before Flop (didn't bet)
Seat 8: 75K2MXwN65Sjfp1yHd50Hg folded before Flop (didn't bet)



PokerStars Game #59941538834:  Hold'em No Limit ($0.25/$0.50) - 2009/07/01 1:38:31 ET
Table '2lPOwetm4cfkZPbTmGPH/w' 2-max Seat #2 is the button
Seat 1: vUGdApqS8J/GJE2gaVWl1w ($13.10 in chips)
Seat 2: XFa6sBGjP2gxoIvxR3fZIg ($24.60 in chips)
XFa6sBGjP2gxoIvxR3fZIg: posts small blind $0.25
vUGdApqS8J/GJE2gaVWl1w: posts big blind $0.50
*** HOLE CARDS ***
XFa6sBGjP2gxoIvxR3fZIg: raises $1 to $1.50
vUGdApqS8J/GJE2gaVWl1w: calls $1
*** FLOP *** [3d 6h As]
vUGdApqS8J/GJE2gaVWl1w: checks
XFa6sBGjP2gxoIvxR3fZIg: checks
*** TURN *** [3d 6h As] [4s]
vUGdApqS8J/GJE2gaVWl1w: checks
XFa6sBGjP2gxoIvxR3fZIg: bets $2
vUGdApqS8J/GJE2gaVWl1w: folds
XFa6sBGjP2gxoIvxR3fZIg collected $2.85 from pot
XFa6sBGjP2gxoIvxR3fZIg: doesn't show hand
*** SUMMARY ***
Total pot $3 | Rake $0.15
Board [3d 6h As 4s]
Seat 1: vUGdApqS8J/GJE2gaVWl1w (big blind) folded on the Turn
Seat 2: XFa6sBGjP2gxoIvxR3fZIg (button) (small blind) collected ($2.85)



PokerStars Game #59941539206:  Hold'em No Limit ($0.25/$0.50) - 2009/07/01 1:38:31 ET
Table 'ofnd8S4IdIPph1Cbn+x7hAbR5MkGhKEbz+X2bpfpu11Qmax Seat #4 is the button
Seat 2: 1xBtrSVBbgFH/viUWKqQeg ($38.05 in chips)
Seat 3: UVJbBPbDwNMEZadZB9WVmg ($10 in chips)
Seat 4: mZNMJI1mY40XTC0U7GZakA ($62.20 in chips)
Seat 5: 2YaCb/8u1SesrR+963XiZA ($11.90 in chips)
Seat 6: 0Bw1Gb5YC/Xvb0SqVawKUw ($8.25 in chips)
Seat 7: kJ06FP2Jc7cSdmywwvYOXw ($63.35 in chips)
Seat 8: R354x4oZnQcGCDV6GhjnpQ ($65.30 in chips)
Seat 9: 75K2MXwN65Sjfp1yHd50Hg ($10 in chips)
2YaCb/8u1SesrR+963XiZA: posts small blind $0.25
0Bw1Gb5YC/Xvb0SqVawKUw: posts big blind $0.50
UVJbBPbDwNMEZadZB9WVmg: posts small blind $0.25
*** HOLE CARDS ***
kJ06FP2Jc7cSdmywwvYOXw: calls $0.50
R354x4oZnQcGCDV6GhjnpQ: folds
75K2MXwN65Sjfp1yHd50Hg: folds
1xBtrSVBbgFH/viUWKqQeg: folds
UVJbBPbDwNMEZadZB9WVmg: folds
mZNMJI1mY40XTC0U7GZakA: folds
2YaCb/8u1SesrR+963XiZA: calls $0.25
0Bw1Gb5YC/Xvb0SqVawKUw: checks
*** FLOP *** [9h Jh Kc]
2YaCb/8u1SesrR+963XiZA: bets $0.50
0Bw1Gb5YC/Xvb0SqVawKUw: calls $0.50
kJ06FP2Jc7cSdmywwvYOXw: calls $0.50
*** TURN *** [9h Jh Kc] [2s]
2YaCb/8u1SesrR+963XiZA: bets $0.50
0Bw1Gb5YC/Xvb0SqVawKUw: calls $0.50
kJ06FP2Jc7cSdmywwvYOXw: calls $0.50
*** RIVER *** [9h Jh Kc 2s] [4d]
2YaCb/8u1SesrR+963XiZA: bets $0.50
0Bw1Gb5YC/Xvb0SqVawKUw: folds
6CKPjbH+MB5p5oH9GwiXGA joins the table at seat #1
kJ06FP2Jc7cSdmywwvYOXw: calls $0.50
*** SHOW DOWN ***
2YaCb/8u1SesrR+963XiZA: shows [3d Kd] (a pair of Kings)
kJ06FP2Jc7cSdmywwvYOXw: mucks hand
2YaCb/8u1SesrR+963XiZA collected $5.50 from pot
*** SUMMARY ***
Total pot $5.75 | Rake $0.25
Board [9h Jh Kc 2s 4d]
Seat 2: 1xBtrSVBbgFH/viUWKqQeg folded before Flop (didn't bet)
Seat 3: UVJbBPbDwNMEZadZB9WVmg folded before Flop
Seat 4: mZNMJI1mY40XTC0U7GZakA (button) folded before Flop (didn't bet)
Seat 5: 2YaCb/8u1SesrR+963XiZA (small blind) showed [3d Kd] and won ($5.50) with a pair of Kings
Seat 6: 0Bw1Gb5YC/Xvb0SqVawKUw (big blind) folded on the River
Seat 7: kJ06FP2Jc7cSdmywwvYOXw mucked
Seat 8: R354x4oZnQcGCDV6GhjnpQ folded before Flop (didn't bet)
Seat 9: 75K2MXwN65Sjfp1yHd50Hg folded before Flop (didn't bet)



PokerStars Game #59941539464:  Hold'em No Limit ($0.25/$0.50) - 2009/07/01 1:38:32 ET
Table '+dXkOAQyS8j9PQZusUTMpg' 2-max Seat #1 is the button
Seat 1: Teld4PDKla7C8/Wfu2DSkg ($60.35 in chips)
Seat 2: qjBVVp3quHGDRH0szgloKA ($5.15 in chips)
Teld4PDKla7C8/Wfu2DSkg: posts small blind $0.25
qjBVVp3quHGDRH0szgloKA: posts big blind $0.50
*** HOLE CARDS ***
Teld4PDKla7C8/Wfu2DSkg: folds
qjBVVp3quHGDRH0szgloKA collected $0.50 from pot
qjBVVp3quHGDRH0szgloKA: doesn't show hand
*** SUMMARY ***
Total pot $0.50 | Rake $0
Seat 1: Teld4PDKla7C8/Wfu2DSkg (button) (small blind) folded before Flop
Seat 2: qjBVVp3quHGDRH0szgloKA (big blind) collected ($0.50)



PokerStars Game #59941539940:  Hold'em No Limit ($0.25/$0.50) - 2009/07/01 1:38:33 ET
Table 'Wwfm5/i+g/g2Nj2gT3jnVQ' 2-max Seat #2 is the button
Seat 1: CHRLZDaaxjbo68bwQD1C/Q ($7.85 in chips)
Seat 2: PKuuhUvIr5WSkJyPJa9dFw ($21.75 in chips)
PKuuhUvIr5WSkJyPJa9dFw: posts small blind $0.25
CHRLZDaaxjbo68bwQD1C/Q: posts big blind $0.50
*** HOLE CARDS ***
PKuuhUvIr5WSkJyPJa9dFw: calls $0.25
CHRLZDaaxjbo68bwQD1C/Q: checks
*** FLOP *** [2s Jd Qc]
CHRLZDaaxjbo68bwQD1C/Q: checks
PKuuhUvIr5WSkJyPJa9dFw: bets $0.50
CHRLZDaaxjbo68bwQD1C/Q: calls $0.50
*** TURN *** [2s Jd Qc] [Ac]
CHRLZDaaxjbo68bwQD1C/Q: checks
PKuuhUvIr5WSkJyPJa9dFw: checks
*** RIVER *** [2s Jd Qc Ac] [6h]
CHRLZDaaxjbo68bwQD1C/Q: checks
PKuuhUvIr5WSkJyPJa9dFw: bets $1.75
CHRLZDaaxjbo68bwQD1C/Q: folds
PKuuhUvIr5WSkJyPJa9dFw collected $1.95 from pot
PKuuhUvIr5WSkJyPJa9dFw: doesn't show hand
*** SUMMARY ***
Total pot $2 | Rake $0.05
Board [2s Jd Qc Ac 6h]
Seat 1: CHRLZDaaxjbo68bwQD1C/Q (big blind) folded on the River
Seat 2: PKuuhUvIr5WSkJyPJa9dFw (button) (small blind) collected ($1.95)



PokerStars Game #59941540212:  Hold'em No Limit ($0.25/$0.50) - 2009/07/01 1:38:33 ET
Table 'NCiXr0d5CEKBQr/cZgLhbA' 9-max Seat #8 is the button
Seat 1: pFtzb1sR4b0d1aw6aIRgDg ($80.45 in chips)
Seat 2: AjV5McH1KMMclY26QdLM5w ($44.55 in chips)
Seat 3: xZCXQSXlrZkp3pZizzVXCw ($95.65 in chips)
Seat 4: 5k9fvXD9suIgCxU4HLQjTw ($53.95 in chips)
Seat 5: Ja2jdidjip2UeJnRzmzAAQ ($41.25 in chips)
Seat 6: t1qL+wRXOwTLB4TBbcw2QA ($47 in chips)
Seat 7: dXhO5i7KOoVcsGqbklD+jw ($44 in chips)
Seat 8: XA3GzEhYmqB0KknKKPDZGQ ($30.30 in chips)
Seat 9: 4WLZvqBn5qv5tds5kt5A1Q ($57.45 in chips)
4WLZvqBn5qv5tds5kt5A1Q: posts small blind $0.25
pFtzb1sR4b0d1aw6aIRgDg: posts big blind $0.50
*** HOLE CARDS ***
AjV5McH1KMMclY26QdLM5w: raises $1 to $1.50
xZCXQSXlrZkp3pZizzVXCw: folds
5k9fvXD9suIgCxU4HLQjTw: folds
Ja2jdidjip2UeJnRzmzAAQ: calls $1.50
t1qL+wRXOwTLB4TBbcw2QA: folds
dXhO5i7KOoVcsGqbklD+jw: folds
XA3GzEhYmqB0KknKKPDZGQ: folds
4WLZvqBn5qv5tds5kt5A1Q: folds
pFtzb1sR4b0d1aw6aIRgDg: folds
*** FLOP *** [6s 4s As]
AjV5McH1KMMclY26QdLM5w: bets $1.50
Ja2jdidjip2UeJnRzmzAAQ: calls $1.50
*** TURN *** [6s 4s As] [4c]
AjV5McH1KMMclY26QdLM5w: checks
Ja2jdidjip2UeJnRzmzAAQ: checks
*** RIVER *** [6s 4s As 4c] [4d]
xZCXQSXlrZkp3pZizzVXCw is sitting out
AjV5McH1KMMclY26QdLM5w: checks
Ja2jdidjip2UeJnRzmzAAQ: bets $2.50
AjV5McH1KMMclY26QdLM5w: folds
Ja2jdidjip2UeJnRzmzAAQ collected $6.45 from pot
*** SUMMARY ***
Total pot $6.75 | Rake $0.30
Board [6s 4s As 4c 4d]
Seat 1: pFtzb1sR4b0d1aw6aIRgDg (big blind) folded before Flop
Seat 2: AjV5McH1KMMclY26QdLM5w folded on the River
Seat 3: xZCXQSXlrZkp3pZizzVXCw folded before Flop (didn't bet)
Seat 4: 5k9fvXD9suIgCxU4HLQjTw folded before Flop (didn't bet)
Seat 5: Ja2jdidjip2UeJnRzmzAAQ collected ($6.45)
Seat 6: t1qL+wRXOwTLB4TBbcw2QA folded before Flop (didn't bet)
Seat 7: dXhO5i7KOoVcsGqbklD+jw folded before Flop (didn't bet)
Seat 8: XA3GzEhYmqB0KknKKPDZGQ (button) folded before Flop (didn't bet)
Seat 9: 4WLZvqBn5qv5tds5kt5A1Q (small blind) folded before Flop



PokerStars Game #59941541348:  Hold'em No Limit ($0.25/$0.50) - 2009/07/01 1:38:35 ET
Table 'EiNh8p/wGJ1FP575iMFnqg' 9-max Seat #7 is the button
Seat 1: YFFlOZgyy1Mh4iBmuNRbmQ ($19.25 in chips)
Seat 2: GRV8J6o4lVSBDEyjt6BwMg ($29.50 in chips)
Seat 3: ymLPoEIl7UL3TvZYmnadxQ ($44.75 in chips)
Seat 4: cMzaiXAM/ZAdNaEUu+LqhA ($54.20 in chips)
Seat 5: M+7+BTmX5vZatHVuoRB1nA ($77.15 in chips)
Seat 6: bCRukyMhXa3jkgAkKFa4VQ ($10.80 in chips)
Seat 7: 997ViqAtWn1FPjJqcffwcA ($50 in chips)
Seat 8: mSD1pginDsyHG5PDfqzphw ($10 in chips)
Seat 9: GuPkZObrz5Zkkn8FsEdF9w ($34.60 in chips)
mSD1pginDsyHG5PDfqzphw: posts small blind $0.25
GuPkZObrz5Zkkn8FsEdF9w: posts big blind $0.50
bCRukyMhXa3jkgAkKFa4VQ: posts big blind $0.50
*** HOLE CARDS ***
YFFlOZgyy1Mh4iBmuNRbmQ: folds
GRV8J6o4lVSBDEyjt6BwMg: folds
ymLPoEIl7UL3TvZYmnadxQ: calls $0.50
cMzaiXAM/ZAdNaEUu+LqhA: folds
M+7+BTmX5vZatHVuoRB1nA: folds
bCRukyMhXa3jkgAkKFa4VQ: checks
997ViqAtWn1FPjJqcffwcA: folds
mSD1pginDsyHG5PDfqzphw: raises $2.50 to $3
GuPkZObrz5Zkkn8FsEdF9w: folds
ymLPoEIl7UL3TvZYmnadxQ: folds
bCRukyMhXa3jkgAkKFa4VQ: folds
mSD1pginDsyHG5PDfqzphw collected $2 from pot
mSD1pginDsyHG5PDfqzphw: doesn't show hand
*** SUMMARY ***
Total pot $2 | Rake $0
Seat 1: YFFlOZgyy1Mh4iBmuNRbmQ folded before Flop (didn't bet)
Seat 2: GRV8J6o4lVSBDEyjt6BwMg folded before Flop (didn't bet)
Seat 3: ymLPoEIl7UL3TvZYmnadxQ folded before Flop
Seat 4: cMzaiXAM/ZAdNaEUu+LqhA folded before Flop (didn't bet)
Seat 5: M+7+BTmX5vZatHVuoRB1nA folded before Flop (didn't bet)
Seat 6: bCRukyMhXa3jkgAkKFa4VQ folded before Flop
Seat 7: 997ViqAtWn1FPjJqcffwcA (button) folded before Flop (didn't bet)
Seat 8: mSD1pginDsyHG5PDfqzphw (small blind) collected ($2)
Seat 9: GuPkZObrz5Zkkn8FsEdF9w (big blind) folded before Flop



PokerStars Game #59941541738:  Hold'em No Limit ($0.25/$0.50) - 2009/07/01 1:38:36 ET
Table '8BQGgNetI1NOvWeu3gtMNw' 2-max Seat #2 is the button
Seat 1: bypIyrYcAAifLfhZpGlKLA ($78.40 in chips)
Seat 2: Z4HwehErEwzsv/noQlfUlg ($135.35 in chips)
Z4HwehErEwzsv/noQlfUlg: posts small blind $0.25
bypIyrYcAAifLfhZpGlKLA: posts big blind $0.50
*** HOLE CARDS ***
Z4HwehErEwzsv/noQlfUlg: folds
bypIyrYcAAifLfhZpGlKLA collected $0.50 from pot
bypIyrYcAAifLfhZpGlKLA: doesn't show hand
*** SUMMARY ***
Total pot $0.50 | Rake $0
Seat 1: bypIyrYcAAifLfhZpGlKLA (big blind) collected ($0.50)
Seat 2: Z4HwehErEwzsv/noQlfUlg (button) (small blind) folded before Flop



PokerStars Game #59941541878:  Hold'em No Limit ($0.25/$0.50) - 2009/07/01 1:38:36 ET
Table '3FhG0gl3kMX3wBEEqj+wnQ' 9-max Seat #7 is the button
Seat 1: bxLSulbgr8LmKNjOzw8URg ($48.50 in chips)
Seat 3: YXCE3WOZi8g2sIf3y/plVw ($61.55 in chips)
Seat 4: e2+sK/yjnj94rXOKoxPP2A ($68.75 in chips)
Seat 5: XcLXSUMHSpshK/7Lh0M4Vg ($11.05 in chips)
Seat 6: 997ViqAtWn1FPjJqcffwcA ($109.05 in chips)
Seat 7: mSD1pginDsyHG5PDfqzphw ($19.45 in chips)
Seat 8: j3K/Jujr7PY4ZM2RZvlH6A ($51.90 in chips)
Seat 9: KA0tkubTlbhmo4ju+qgXPg ($43.85 in chips)
j3K/Jujr7PY4ZM2RZvlH6A: posts small blind $0.25
KA0tkubTlbhmo4ju+qgXPg: posts big blind $0.50
HZkVla4kK2SI42CVrPZ/ig: sits out
*** HOLE CARDS ***
bxLSulbgr8LmKNjOzw8URg: calls $0.50
YXCE3WOZi8g2sIf3y/plVw: folds
e2+sK/yjnj94rXOKoxPP2A: folds
XcLXSUMHSpshK/7Lh0M4Vg: folds
997ViqAtWn1FPjJqcffwcA: folds
mSD1pginDsyHG5PDfqzphw: folds
j3K/Jujr7PY4ZM2RZvlH6A: calls $0.25
KA0tkubTlbhmo4ju+qgXPg: checks
*** FLOP *** [6c 2h 3c]
j3K/Jujr7PY4ZM2RZvlH6A: checks
KA0tkubTlbhmo4ju+qgXPg: checks
bxLSulbgr8LmKNjOzw8URg: checks
*** TURN *** [6c 2h 3c] [Jh]
j3K/Jujr7PY4ZM2RZvlH6A: checks
KA0tkubTlbhmo4ju+qgXPg: checks
bxLSulbgr8LmKNjOzw8URg: bets $1
j3K/Jujr7PY4ZM2RZvlH6A: folds
KA0tkubTlbhmo4ju+qgXPg: folds
bxLSulbgr8LmKNjOzw8URg collected $1.45 from pot
bxLSulbgr8LmKNjOzw8URg: doesn't show hand
*** SUMMARY ***
Total pot $1.50 | Rake $0.05
Board [6c 2h 3c Jh]
Seat 1: bxLSulbgr8LmKNjOzw8URg collected ($1.45)
Seat 3: YXCE3WOZi8g2sIf3y/plVw folded before Flop (didn't bet)
Seat 4: e2+sK/yjnj94rXOKoxPP2A folded before Flop (didn't bet)
Seat 5: XcLXSUMHSpshK/7Lh0M4Vg folded before Flop (didn't bet)
Seat 6: 997ViqAtWn1FPjJqcffwcA folded before Flop (didn't bet)
Seat 7: mSD1pginDsyHG5PDfqzphw (button) folded before Flop (didn't bet)
Seat 8: j3K/Jujr7PY4ZM2RZvlH6A (small blind) folded on the Turn
Seat 9: KA0tkubTlbhmo4ju+qgXPg (big blind) folded on the Turn



PokerStars Game #59941543394:  Hold'em No Limit ($0.25/$0.50) - 2009/07/01 1:38:39 ET
Table '+dXkOAQyS8j9PQZusUTMpg' 2-max Seat #2 is the button
Seat 1: Teld4PDKla7C8/Wfu2DSkg ($60.10 in chips)
Seat 2: qjBVVp3quHGDRH0szgloKA ($5.40 in chips)
qjBVVp3quHGDRH0szgloKA: posts small blind $0.25
Teld4PDKla7C8/Wfu2DSkg: posts big blind $0.50
*** HOLE CARDS ***
qjBVVp3quHGDRH0szgloKA: raises $4.90 to $5.40 and is all-in
Teld4PDKla7C8/Wfu2DSkg: folds
qjBVVp3quHGDRH0szgloKA collected $1 from pot
qjBVVp3quHGDRH0szgloKA: doesn't show hand
*** SUMMARY ***
Total pot $1 | Rake $0
Seat 1: Teld4PDKla7C8/Wfu2DSkg (big blind) folded before Flop
Seat 2: qjBVVp3quHGDRH0szgloKA (button) (small blind) collected ($1)



PokerStars Game #59941543346:  Hold'em No Limit ($0.25/$0.50) - 2009/07/01 1:38:39 ET
Table 'B+sqsfj6d6zXicNfaseTaw' 2-max Seat #2 is the button
Seat 1: +4GNcSsecmapVGSdV0mUPA ($145.75 in chips)
Seat 2: Lv5RmpRe6LtPkBzM9Gpo5A ($75.10 in chips)
Lv5RmpRe6LtPkBzM9Gpo5A: posts small blind $0.25
+4GNcSsecmapVGSdV0mUPA: posts big blind $0.50
*** HOLE CARDS ***
Lv5RmpRe6LtPkBzM9Gpo5A: folds
+4GNcSsecmapVGSdV0mUPA collected $0.50 from pot
+4GNcSsecmapVGSdV0mUPA: doesn't show hand
*** SUMMARY ***
Total pot $0.50 | Rake $0
Seat 1: +4GNcSsecmapVGSdV0mUPA (big blind) collected ($0.50)
Seat 2: Lv5RmpRe6LtPkBzM9Gpo5A (button) (small blind) folded before Flop



PokerStars Game #59941543320:  Hold'em No Limit ($0.25/$0.50) - 2009/07/01 1:38:39 ET
Table 'tyR5AZNKV8Aadbrnrnlg7g' 6-max Seat #3 is the button
Seat 1: BgOXYI0yYSN1ULC4FqsNkg ($75.55 in chips)
Seat 3: JFLrYNyQmwPhRQAtoSAuyA ($60.85 in chips)
Seat 4: 4QfsCWthT/vSLirorNXqtg ($82.45 in chips)
Seat 5: GUnvMULl2qFOO1yenu1UBw ($80.35 in chips)
Seat 6: 498aWaGsW4uGfuWl+2FCGw ($81.35 in chips)
4QfsCWthT/vSLirorNXqtg: posts small blind $0.25
GUnvMULl2qFOO1yenu1UBw: posts big blind $0.50
*** HOLE CARDS ***
498aWaGsW4uGfuWl+2FCGw: calls $0.50
vhWS+cwAJNd3JzqVzIjBZA joins the table at seat #2
BgOXYI0yYSN1ULC4FqsNkg: raises $2 to $2.50
JFLrYNyQmwPhRQAtoSAuyA: folds
4QfsCWthT/vSLirorNXqtg: folds
GUnvMULl2qFOO1yenu1UBw: folds
498aWaGsW4uGfuWl+2FCGw: folds
BgOXYI0yYSN1ULC4FqsNkg collected $1.75 from pot
*** SUMMARY ***
Total pot $1.75 | Rake $0
Seat 1: BgOXYI0yYSN1ULC4FqsNkg collected ($1.75)
Seat 3: JFLrYNyQmwPhRQAtoSAuyA (button) folded before Flop (didn't bet)
Seat 4: 4QfsCWthT/vSLirorNXqtg (small blind) folded before Flop
Seat 5: GUnvMULl2qFOO1yenu1UBw (big blind) folded before Flop
Seat 6: 498aWaGsW4uGfuWl+2FCGw folded before Flop



PokerStars Game #59941544144:  Hold'em No Limit ($0.25/$0.50) - 2009/07/01 1:38:40 ET
Table 'BCN5su+SsXiy1zRMJi0SJw' 6-max Seat #4 is the button
Seat 1: GxXV09ciXaOxyY2H5aMIIw ($29.25 in chips)
Seat 2: ehFNAevCQri3trWxV6FJdA ($99.60 in chips)
Seat 3: kwgv5lNhiFrfONXCshzxlA ($71.30 in chips)
Seat 4: bbsK8j+tpuVRhBqDzHxf7w ($49.85 in chips)
Seat 5: kxPhs4ePFqMy52CInAJ2aw ($50 in chips)
Seat 6: b2symlOdL7+0c9Pj4N/KlA ($70.30 in chips)
kxPhs4ePFqMy52CInAJ2aw: posts small blind $0.25
b2symlOdL7+0c9Pj4N/KlA: posts big blind $0.50
*** HOLE CARDS ***
GxXV09ciXaOxyY2H5aMIIw: folds
ehFNAevCQri3trWxV6FJdA: calls $0.50
kwgv5lNhiFrfONXCshzxlA: folds
bbsK8j+tpuVRhBqDzHxf7w: folds
kxPhs4ePFqMy52CInAJ2aw: folds
b2symlOdL7+0c9Pj4N/KlA: raises $2.50 to $3
ehFNAevCQri3trWxV6FJdA: calls $2.50
*** FLOP *** [9h 5s 4h]
b2symlOdL7+0c9Pj4N/KlA: bets $4.50
ehFNAevCQri3trWxV6FJdA: calls $4.50
*** TURN *** [9h 5s 4h] [Qc]
b2symlOdL7+0c9Pj4N/KlA: bets $11
ehFNAevCQri3trWxV6FJdA: folds
b2symlOdL7+0c9Pj4N/KlA collected $14.55 from pot
b2symlOdL7+0c9Pj4N/KlA: doesn't show hand
*** SUMMARY ***
Total pot $15.25 | Rake $0.70
Board [9h 5s 4h Qc]
Seat 1: GxXV09ciXaOxyY2H5aMIIw folded before Flop (didn't bet)
Seat 2: ehFNAevCQri3trWxV6FJdA folded on the Turn
Seat 3: kwgv5lNhiFrfONXCshzxlA folded before Flop (didn't bet)
Seat 4: bbsK8j+tpuVRhBqDzHxf7w (button) folded before Flop (didn't bet)
Seat 5: kxPhs4ePFqMy52CInAJ2aw (small blind) folded before Flop
Seat 6: b2symlOdL7+0c9Pj4N/KlA (big blind) collected ($14.55)



PokerStars Game #59941544600:  Hold'em No Limit ($0.25/$0.50) - 2009/07/01 1:38:41 ET
Table 'hSTs/dUsYLgJQuF2Onp0MQ' 6-max Seat #6 is the button
Seat 2: Hdd4js36ITbTJ/QuVYwTlA ($101.25 in chips)
Seat 3: lxIzoHy0RnkfFSODHC2liw ($50 in chips)
Seat 4: 2igtJLmvIZ+HqX4XPgMPZA ($50 in chips)
Seat 5: FsRQ5ECdlLkLYI5le8+PDQ ($48.50 in chips)
Seat 6: M1KyQQvVPVuxqTAB8sR/zQ ($101.90 in chips)
Hdd4js36ITbTJ/QuVYwTlA: posts small blind $0.25
lxIzoHy0RnkfFSODHC2liw: posts big blind $0.50
*** HOLE CARDS ***
2igtJLmvIZ+HqX4XPgMPZA: folds
FsRQ5ECdlLkLYI5le8+PDQ: raises $1 to $1.50
M1KyQQvVPVuxqTAB8sR/zQ: folds
Hdd4js36ITbTJ/QuVYwTlA: calls $1.25
lxIzoHy0RnkfFSODHC2liw: folds
*** FLOP *** [Ah 6h 7c]
Hdd4js36ITbTJ/QuVYwTlA: checks
FsRQ5ECdlLkLYI5le8+PDQ: bets $2
Hdd4js36ITbTJ/QuVYwTlA: folds
FsRQ5ECdlLkLYI5le8+PDQ collected $3.35 from pot
*** SUMMARY ***
Total pot $3.50 | Rake $0.15
Board [Ah 6h 7c]
Seat 2: Hdd4js36ITbTJ/QuVYwTlA (small blind) folded on the Flop
Seat 3: lxIzoHy0RnkfFSODHC2liw (big blind) folded before Flop
Seat 4: 2igtJLmvIZ+HqX4XPgMPZA folded before Flop (didn't bet)
Seat 5: FsRQ5ECdlLkLYI5le8+PDQ collected ($3.35)
Seat 6: M1KyQQvVPVuxqTAB8sR/zQ (button) folded before Flop (didn't bet)



PokerStars Game #59941544488:  Hold'em No Limit ($0.25/$0.50) - 2009/07/01 1:38:41 ET
Table 'GfL/No5u5PoEnU39lP5pQg' 6-max Seat #5 is the button
Seat 2: uVwggSetzp7d+eVgowO3vg ($55.05 in chips)
Seat 3: 4pp9WxhGdbVbxCc9tlu0lw ($25.25 in chips)
Seat 4: vhWS+cwAJNd3JzqVzIjBZA ($50 in chips)
Seat 5: M1KyQQvVPVuxqTAB8sR/zQ ($50.20 in chips)
Seat 6: kxPhs4ePFqMy52CInAJ2aw ($94.05 in chips)
kxPhs4ePFqMy52CInAJ2aw: posts small blind $0.25
1WUCqNG+p+vfWRTXNu4ljw: is sitting out
uVwggSetzp7d+eVgowO3vg: posts big blind $0.50
*** HOLE CARDS ***
4pp9WxhGdbVbxCc9tlu0lw: calls $0.50
vhWS+cwAJNd3JzqVzIjBZA: folds
M1KyQQvVPVuxqTAB8sR/zQ: folds
kxPhs4ePFqMy52CInAJ2aw: folds
uVwggSetzp7d+eVgowO3vg: checks
*** FLOP *** [Ad 6d Jc]
uVwggSetzp7d+eVgowO3vg: checks
4pp9WxhGdbVbxCc9tlu0lw: bets $0.50
uVwggSetzp7d+eVgowO3vg: calls $0.50
*** TURN *** [Ad 6d Jc] [5c]
uVwggSetzp7d+eVgowO3vg: checks
4pp9WxhGdbVbxCc9tlu0lw: bets $1
uVwggSetzp7d+eVgowO3vg: folds
4pp9WxhGdbVbxCc9tlu0lw collected $2.15 from pot
*** SUMMARY ***
Total pot $2.25 | Rake $0.10
Board [Ad 6d Jc 5c]
Seat 2: uVwggSetzp7d+eVgowO3vg (big blind) folded on the Turn
Seat 3: 4pp9WxhGdbVbxCc9tlu0lw collected ($2.15)
Seat 4: vhWS+cwAJNd3JzqVzIjBZA folded before Flop (didn't bet)
Seat 5: M1KyQQvVPVuxqTAB8sR/zQ (button) folded before Flop (didn't bet)
Seat 6: kxPhs4ePFqMy52CInAJ2aw (small blind) folded before Flop



PokerStars Game #59941546646:  Hold'em No Limit ($0.25/$0.50) - 2009/07/01 1:38:45 ET
Table 'B+sqsfj6d6zXicNfaseTaw' 2-max Seat #1 is the button
Seat 1: +4GNcSsecmapVGSdV0mUPA ($146 in chips)
Seat 2: Lv5RmpRe6LtPkBzM9Gpo5A ($74.85 in chips)
+4GNcSsecmapVGSdV0mUPA: posts small blind $0.25
Lv5RmpRe6LtPkBzM9Gpo5A: posts big blind $0.50
*** HOLE CARDS ***
+4GNcSsecmapVGSdV0mUPA: calls $0.25
Lv5RmpRe6LtPkBzM9Gpo5A: checks
*** FLOP *** [8d 4d Jd]
Lv5RmpRe6LtPkBzM9Gpo5A: checks
+4GNcSsecmapVGSdV0mUPA: bets $0.50
Lv5RmpRe6LtPkBzM9Gpo5A: folds
+4GNcSsecmapVGSdV0mUPA collected $0.95 from pot
+4GNcSsecmapVGSdV0mUPA: doesn't show hand
*** SUMMARY ***
Total pot $1 | Rake $0.05
Board [8d 4d Jd]
Seat 1: +4GNcSsecmapVGSdV0mUPA (button) (small blind) collected ($0.95)
Seat 2: Lv5RmpRe6LtPkBzM9Gpo5A (big blind) folded on the Flop



PokerStars Game #59941547768:  Hold'em No Limit ($0.25/$0.50) - 2009/07/01 1:38:47 ET
Table 'ErOuyGLI5PT3G5MnpHgC/g' 9-max Seat #5 is the button
Seat 1: eBrej2jnlUCs/JgxFCRn2g ($47.85 in chips)
Seat 2: pciZn00ZDk4BVBMTTMcNVQ ($20.25 in chips)
Seat 3: xZCXQSXlrZkp3pZizzVXCw ($49.25 in chips)
Seat 4: YRqrX/u38J7aLNNnBzQsjQ ($18.30 in chips)
Seat 5: JwvquocWfhTVApN5t47LgA ($48.30 in chips)
Seat 6: zE9cVigS2nW/Ljy4K4bUQA ($30 in chips)
Seat 7: 90Wb75h3W1BRpbqVnuk8gw ($62.20 in chips)
Seat 8: g4k0NXISyLCqaSWZDBjfEg ($50 in chips)
Seat 9: J0W5D97jl5VLky+IoPvDeA ($64.50 in chips)
zE9cVigS2nW/Ljy4K4bUQA: posts small blind $0.25
90Wb75h3W1BRpbqVnuk8gw: posts big blind $0.50
*** HOLE CARDS ***
g4k0NXISyLCqaSWZDBjfEg: folds
J0W5D97jl5VLky+IoPvDeA: folds
eBrej2jnlUCs/JgxFCRn2g: folds
pciZn00ZDk4BVBMTTMcNVQ: folds
xZCXQSXlrZkp3pZizzVXCw: folds
YRqrX/u38J7aLNNnBzQsjQ: raises $1 to $1.50
JwvquocWfhTVApN5t47LgA: folds
zE9cVigS2nW/Ljy4K4bUQA: folds
90Wb75h3W1BRpbqVnuk8gw: folds
YRqrX/u38J7aLNNnBzQsjQ collected $1.25 from pot
*** SUMMARY ***
Total pot $1.25 | Rake $0
Seat 1: eBrej2jnlUCs/JgxFCRn2g folded before Flop (didn't bet)
Seat 2: pciZn00ZDk4BVBMTTMcNVQ folded before Flop (didn't bet)
Seat 3: xZCXQSXlrZkp3pZizzVXCw folded before Flop (didn't bet)
Seat 4: YRqrX/u38J7aLNNnBzQsjQ collected ($1.25)
Seat 5: JwvquocWfhTVApN5t47LgA (button) folded before Flop (didn't bet)
Seat 6: zE9cVigS2nW/Ljy4K4bUQA (small blind) folded before Flop
Seat 7: 90Wb75h3W1BRpbqVnuk8gw (big blind) folded before Flop
Seat 8: g4k0NXISyLCqaSWZDBjfEg folded before Flop (didn't bet)
Seat 9: J0W5D97jl5VLky+IoPvDeA folded before Flop (didn't bet)



PokerStars Game #59941547898:  Hold'em No Limit ($0.25/$0.50) - 2009/07/01 1:38:47 ET
Table '1pi9mHyVuXF/uue+aPQc4w' 9-max Seat #1 is the button
Seat 1: M+D23GG26WXQ/2gyjREVOQ ($49.25 in chips)
Seat 2: vHYT5s323LpajBj+2c9zbQ ($23.40 in chips)
Seat 3: HZkVla4kK2SI42CVrPZ/ig ($8.75 in chips)
Seat 4: mSD1pginDsyHG5PDfqzphw ($14.80 in chips)
Seat 5: zE9cVigS2nW/Ljy4K4bUQA ($30.65 in chips)
Seat 6: 1xBtrSVBbgFH/viUWKqQeg ($49.25 in chips)
Seat 7: 61sfw5QTu62YYIt68OsdrA ($33.55 in chips)
Seat 8: g4k0NXISyLCqaSWZDBjfEg ($97.05 in chips)
Seat 9: Q/gZC63lfOMr7YhWKPCxoQ ($9.70 in chips)
vHYT5s323LpajBj+2c9zbQ: posts small blind $0.25
HZkVla4kK2SI42CVrPZ/ig: posts big blind $0.50
*** HOLE CARDS ***
mSD1pginDsyHG5PDfqzphw: folds
zE9cVigS2nW/Ljy4K4bUQA: folds
1xBtrSVBbgFH/viUWKqQeg: folds
61sfw5QTu62YYIt68OsdrA: folds
g4k0NXISyLCqaSWZDBjfEg: folds
Q/gZC63lfOMr7YhWKPCxoQ: calls $0.50
M+D23GG26WXQ/2gyjREVOQ: calls $0.50
vHYT5s323LpajBj+2c9zbQ: calls $0.25
HZkVla4kK2SI42CVrPZ/ig: checks
*** FLOP *** [Ac 7s 8h]
vHYT5s323LpajBj+2c9zbQ: checks
HZkVla4kK2SI42CVrPZ/ig: checks
Q/gZC63lfOMr7YhWKPCxoQ: checks
M+D23GG26WXQ/2gyjREVOQ: bets $1.50
vHYT5s323LpajBj+2c9zbQ: folds
HZkVla4kK2SI42CVrPZ/ig: folds
Q/gZC63lfOMr7YhWKPCxoQ: folds
M+D23GG26WXQ/2gyjREVOQ collected $1.90 from pot
M+D23GG26WXQ/2gyjREVOQ: doesn't show hand
*** SUMMARY ***
Total pot $2 | Rake $0.10
Board [Ac 7s 8h]
Seat 1: M+D23GG26WXQ/2gyjREVOQ (button) collected ($1.90)
Seat 2: vHYT5s323LpajBj+2c9zbQ (small blind) folded on the Flop
Seat 3: HZkVla4kK2SI42CVrPZ/ig (big blind) folded on the Flop
Seat 4: mSD1pginDsyHG5PDfqzphw folded before Flop (didn't bet)
Seat 5: zE9cVigS2nW/Ljy4K4bUQA folded before Flop (didn't bet)
Seat 6: 1xBtrSVBbgFH/viUWKqQeg folded before Flop (didn't bet)
Seat 7: 61sfw5QTu62YYIt68OsdrA folded before Flop (didn't bet)
Seat 8: g4k0NXISyLCqaSWZDBjfEg folded before Flop (didn't bet)
Seat 9: Q/gZC63lfOMr7YhWKPCxoQ folded on the Flop



PokerStars Game #59941548110:  Hold'em No Limit ($0.25/$0.50) - 2009/07/01 1:38:48 ET
Table '+dXkOAQyS8j9PQZusUTMpg' 2-max Seat #1 is the button
Seat 1: Teld4PDKla7C8/Wfu2DSkg ($59.60 in chips)
Seat 2: qjBVVp3quHGDRH0szgloKA ($5.90 in chips)
Teld4PDKla7C8/Wfu2DSkg: posts small blind $0.25
qjBVVp3quHGDRH0szgloKA: posts big blind $0.50
*** HOLE CARDS ***
Teld4PDKla7C8/Wfu2DSkg: folds
qjBVVp3quHGDRH0szgloKA collected $0.50 from pot
qjBVVp3quHGDRH0szgloKA: doesn't show hand
*** SUMMARY ***
Total pot $0.50 | Rake $0
Seat 1: Teld4PDKla7C8/Wfu2DSkg (button) (small blind) folded before Flop
Seat 2: qjBVVp3quHGDRH0szgloKA (big blind) collected ($0.50)



PokerStars Game #59941548178:  Hold'em No Limit ($0.25/$0.50) - 2009/07/01 1:38:48 ET
Table '8BQGgNetI1NOvWeu3gtMNw' 2-max Seat #1 is the button
Seat 1: bypIyrYcAAifLfhZpGlKLA ($78.65 in chips)
Seat 2: Z4HwehErEwzsv/noQlfUlg ($135.10 in chips)
bypIyrYcAAifLfhZpGlKLA: posts small blind $0.25
Z4HwehErEwzsv/noQlfUlg: posts big blind $0.50
*** HOLE CARDS ***
bypIyrYcAAifLfhZpGlKLA: raises $1 to $1.50
Z4HwehErEwzsv/noQlfUlg: folds
bypIyrYcAAifLfhZpGlKLA collected $1 from pot
bypIyrYcAAifLfhZpGlKLA: doesn't show hand
*** SUMMARY ***
Total pot $1 | Rake $0
Seat 1: bypIyrYcAAifLfhZpGlKLA (button) (small blind) collected ($1)
Seat 2: Z4HwehErEwzsv/noQlfUlg (big blind) folded before Flop



PokerStars Game #59941548536:  Hold'em No Limit ($0.25/$0.50) - 2009/07/01 1:38:48 ET
Table '5qf8oPyYje71HBKD0FwPgQ' 9-max Seat #6 is the button
Seat 2: M+7+BTmX5vZatHVuoRB1nA ($53.15 in chips)
Seat 3: vacmVLJJECYI6HjAynFcpg ($51.20 in chips)
Seat 4: YXCE3WOZi8g2sIf3y/plVw ($53.85 in chips)
Seat 5: uo2Sgpknd7NdeVbeSCG02A ($15.70 in chips)
Seat 6: go0Ad6tqqJ4tR9/bqVlO0g ($26.20 in chips)
Seat 7: 1q5EPoiflJRl8pqfnVLjMw ($56.55 in chips)
Seat 8: sakr/FIfFtIZwDPmAj5Pzg ($59.10 in chips)
Seat 9: jWDRpL0TJljg+mBCE9ZMqA ($7.85 in chips)
1q5EPoiflJRl8pqfnVLjMw: posts small blind $0.25
sakr/FIfFtIZwDPmAj5Pzg: posts big blind $0.50
gsyXT42WLEcOS4DdEk2wlw: sits out
*** HOLE CARDS ***
jWDRpL0TJljg+mBCE9ZMqA: folds
M+7+BTmX5vZatHVuoRB1nA: folds
vacmVLJJECYI6HjAynFcpg: folds
YXCE3WOZi8g2sIf3y/plVw: folds
uo2Sgpknd7NdeVbeSCG02A: calls $0.50
go0Ad6tqqJ4tR9/bqVlO0g: folds
1q5EPoiflJRl8pqfnVLjMw: calls $0.25
sakr/FIfFtIZwDPmAj5Pzg: checks
*** FLOP *** [4d Tc Qc]
1q5EPoiflJRl8pqfnVLjMw: checks
sakr/FIfFtIZwDPmAj5Pzg: checks
uo2Sgpknd7NdeVbeSCG02A: checks
*** TURN *** [4d Tc Qc] [Jd]
1q5EPoiflJRl8pqfnVLjMw: bets $1
sakr/FIfFtIZwDPmAj5Pzg: folds
uo2Sgpknd7NdeVbeSCG02A: folds
1q5EPoiflJRl8pqfnVLjMw collected $1.45 from pot
1q5EPoiflJRl8pqfnVLjMw: doesn't show hand
*** SUMMARY ***
Total pot $1.50 | Rake $0.05
Board [4d Tc Qc Jd]
Seat 2: M+7+BTmX5vZatHVuoRB1nA folded before Flop (didn't bet)
Seat 3: vacmVLJJECYI6HjAynFcpg folded before Flop (didn't bet)
Seat 4: YXCE3WOZi8g2sIf3y/plVw folded before Flop (didn't bet)
Seat 5: uo2Sgpknd7NdeVbeSCG02A folded on the Turn
Seat 6: go0Ad6tqqJ4tR9/bqVlO0g (button) folded before Flop (didn't bet)
Seat 7: 1q5EPoiflJRl8pqfnVLjMw (small blind) collected ($1.45)
Seat 8: sakr/FIfFtIZwDPmAj5Pzg (big blind) folded on the Turn
Seat 9: jWDRpL0TJljg+mBCE9ZMqA folded before Flop (didn't bet)



PokerStars Game #59941549440:  Hold'em No Limit ($0.25/$0.50) - 2009/07/01 1:38:50 ET
Table '2lPOwetm4cfkZPbTmGPH/w' 2-max Seat #1 is the button
Seat 1: vUGdApqS8J/GJE2gaVWl1w ($11.60 in chips)
Seat 2: XFa6sBGjP2gxoIvxR3fZIg ($25.95 in chips)
vUGdApqS8J/GJE2gaVWl1w: posts small blind $0.25
XFa6sBGjP2gxoIvxR3fZIg: posts big blind $0.50
*** HOLE CARDS ***
vUGdApqS8J/GJE2gaVWl1w: calls $0.25
XFa6sBGjP2gxoIvxR3fZIg: raises $1.50 to $2
vUGdApqS8J/GJE2gaVWl1w: calls $1.50
*** FLOP *** [8h 2h Js]
XFa6sBGjP2gxoIvxR3fZIg: checks
vUGdApqS8J/GJE2gaVWl1w: checks
*** TURN *** [8h 2h Js] [9c]
XFa6sBGjP2gxoIvxR3fZIg: checks
vUGdApqS8J/GJE2gaVWl1w: bets $1
XFa6sBGjP2gxoIvxR3fZIg: calls $1
*** RIVER *** [8h 2h Js 9c] [9d]
XFa6sBGjP2gxoIvxR3fZIg: checks
vUGdApqS8J/GJE2gaVWl1w: checks
*** SHOW DOWN ***
XFa6sBGjP2gxoIvxR3fZIg: shows [As 5s] (a pair of Nines)
vUGdApqS8J/GJE2gaVWl1w: mucks hand
XFa6sBGjP2gxoIvxR3fZIg collected $5.75 from pot
*** SUMMARY ***
Total pot $6 | Rake $0.25
Board [8h 2h Js 9c 9d]
Seat 1: vUGdApqS8J/GJE2gaVWl1w (button) (small blind) mucked
Seat 2: XFa6sBGjP2gxoIvxR3fZIg (big blind) showed [As 5s] and won ($5.75) with a pair of Nines



PokerStars Game #59941549894:  Hold'em No Limit ($0.25/$0.50) - 2009/07/01 1:38:51 ET
Table 'hWT2kq66tnKEpD26cia6fQ' 2-max Seat #2 is the button
Seat 1: Ce3KNFP+ao7Da9NHb65raw ($19.80 in chips)
Seat 2: 16tvT7AYgZ2LgiGFcvFKQg ($53.85 in chips)
16tvT7AYgZ2LgiGFcvFKQg: posts small blind $0.25
Ce3KNFP+ao7Da9NHb65raw: posts big blind $0.50
*** HOLE CARDS ***
16tvT7AYgZ2LgiGFcvFKQg: raises $0.50 to $1
Ce3KNFP+ao7Da9NHb65raw: calls $0.50
*** FLOP *** [Qd Ac 3c]
Ce3KNFP+ao7Da9NHb65raw: checks
16tvT7AYgZ2LgiGFcvFKQg: checks
*** TURN *** [Qd Ac 3c] [4s]
Ce3KNFP+ao7Da9NHb65raw: checks
16tvT7AYgZ2LgiGFcvFKQg: checks
*** RIVER *** [Qd Ac 3c 4s] [Qs]
Ce3KNFP+ao7Da9NHb65raw: bets $1.50
16tvT7AYgZ2LgiGFcvFKQg: folds
Ce3KNFP+ao7Da9NHb65raw collected $1.90 from pot
*** SUMMARY ***
Total pot $2 | Rake $0.10
Board [Qd Ac 3c 4s Qs]
Seat 1: Ce3KNFP+ao7Da9NHb65raw (big blind) collected ($1.90)
Seat 2: 16tvT7AYgZ2LgiGFcvFKQg (button) (small blind) folded on the River



PokerStars Game #59941552232:  Hold'em No Limit ($0.25/$0.50) - 2009/07/01 1:38:55 ET
Table '+dXkOAQyS8j9PQZusUTMpg' 2-max Seat #2 is the button
Seat 1: Teld4PDKla7C8/Wfu2DSkg ($59.35 in chips)
Seat 2: qjBVVp3quHGDRH0szgloKA ($6.15 in chips)
qjBVVp3quHGDRH0szgloKA: posts small blind $0.25
Teld4PDKla7C8/Wfu2DSkg: posts big blind $0.50
*** HOLE CARDS ***
qjBVVp3quHGDRH0szgloKA: raises $1 to $1.50
Teld4PDKla7C8/Wfu2DSkg: calls $1
*** FLOP *** [7s Jc Kd]
Teld4PDKla7C8/Wfu2DSkg: checks
qjBVVp3quHGDRH0szgloKA: bets $2
Teld4PDKla7C8/Wfu2DSkg: folds
qjBVVp3quHGDRH0szgloKA collected $2.85 from pot
qjBVVp3quHGDRH0szgloKA: doesn't show hand
*** SUMMARY ***
Total pot $3 | Rake $0.15
Board [7s Jc Kd]
Seat 1: Teld4PDKla7C8/Wfu2DSkg (big blind) folded on the Flop
Seat 2: qjBVVp3quHGDRH0szgloKA (button) (small blind) collected ($2.85)



PokerStars Game #59941552628:  Hold'em No Limit ($0.25/$0.50) - 2009/07/01 1:38:56 ET
Table '+z1aekfHkpp09pc8F9aViw' 6-max Seat #4 is the button
Seat 1: L0aIPg7qefDQjdJo3HCVEA ($10.75 in chips)
Seat 3: URYNc7fPA23K2UfadQbnCA ($61.65 in chips)
Seat 4: RowCSpSURHTOL/dcjg/Iug ($85.70 in chips)
Seat 5: 2igtJLmvIZ+HqX4XPgMPZA ($50 in chips)
Seat 6: GUnvMULl2qFOO1yenu1UBw ($51.50 in chips)
2igtJLmvIZ+HqX4XPgMPZA: posts small blind $0.25
GUnvMULl2qFOO1yenu1UBw: posts big blind $0.50
*** HOLE CARDS ***
L0aIPg7qefDQjdJo3HCVEA: raises $0.50 to $1
URYNc7fPA23K2UfadQbnCA: folds
RowCSpSURHTOL/dcjg/Iug: folds
2igtJLmvIZ+HqX4XPgMPZA: folds
GUnvMULl2qFOO1yenu1UBw: folds
L0aIPg7qefDQjdJo3HCVEA collected $1.25 from pot
L0aIPg7qefDQjdJo3HCVEA: doesn't show hand
*** SUMMARY ***
Total pot $1.25 | Rake $0
Seat 1: L0aIPg7qefDQjdJo3HCVEA collected ($1.25)
Seat 3: URYNc7fPA23K2UfadQbnCA folded before Flop (didn't bet)
Seat 4: RowCSpSURHTOL/dcjg/Iug (button) folded before Flop (didn't bet)
Seat 5: 2igtJLmvIZ+HqX4XPgMPZA (small blind) folded before Flop
Seat 6: GUnvMULl2qFOO1yenu1UBw (big blind) folded before Flop



PokerStars Game #59941553520:  Hold'em No Limit ($0.25/$0.50) - 2009/07/01 1:38:57 ET
Table 'ZYI3ZReBjdfKEYItkZHI6A' 9-max Seat #4 is the button
Seat 1: IYd5zG8k7vdBNVHbHg2Pag ($60.40 in chips)
Seat 2: 5acK4E7fzEwnplVBZ6eNWA ($50 in chips)
Seat 3: 75K2MXwN65Sjfp1yHd50Hg ($8.50 in chips)
Seat 4: /UdtxmXsFx6K/14AbHqzbQ ($12.25 in chips)
Seat 5: ApHP7ouup365XIUFBdEDxg ($16.75 in chips)
Seat 6: 1xBtrSVBbgFH/viUWKqQeg ($35.40 in chips)
Seat 7: HWcfp1hY1hqvrddzW3/FQw ($21.30 in chips)
Seat 8: ji04uOybxCdpdefzlUQeKQ ($29.55 in chips)
Seat 9: HZkVla4kK2SI42CVrPZ/ig ($10.40 in chips)
ApHP7ouup365XIUFBdEDxg: posts small blind $0.25
1xBtrSVBbgFH/viUWKqQeg: posts big blind $0.50
*** HOLE CARDS ***
HWcfp1hY1hqvrddzW3/FQw: folds
ji04uOybxCdpdefzlUQeKQ: folds
HZkVla4kK2SI42CVrPZ/ig: folds
IYd5zG8k7vdBNVHbHg2Pag has timed out
IYd5zG8k7vdBNVHbHg2Pag: folds
IYd5zG8k7vdBNVHbHg2Pag is sitting out
5acK4E7fzEwnplVBZ6eNWA: folds
IYd5zG8k7vdBNVHbHg2Pag has returned
75K2MXwN65Sjfp1yHd50Hg: folds
/UdtxmXsFx6K/14AbHqzbQ: calls $0.50
ApHP7ouup365XIUFBdEDxg: calls $0.25
1xBtrSVBbgFH/viUWKqQeg: checks
*** FLOP *** [As Qc Th]
ApHP7ouup365XIUFBdEDxg: checks
HWcfp1hY1hqvrddzW3/FQw leaves the table
1xBtrSVBbgFH/viUWKqQeg: bets $1
/UdtxmXsFx6K/14AbHqzbQ: folds
ApHP7ouup365XIUFBdEDxg: calls $1
*** TURN *** [As Qc Th] [3h]
ApHP7ouup365XIUFBdEDxg: checks
1xBtrSVBbgFH/viUWKqQeg: bets $2
ApHP7ouup365XIUFBdEDxg: folds
1xBtrSVBbgFH/viUWKqQeg collected $3.35 from pot
*** SUMMARY ***
Total pot $3.50 | Rake $0.15
Board [As Qc Th 3h]
Seat 1: IYd5zG8k7vdBNVHbHg2Pag folded before Flop (didn't bet)
Seat 2: 5acK4E7fzEwnplVBZ6eNWA folded before Flop (didn't bet)
Seat 3: 75K2MXwN65Sjfp1yHd50Hg folded before Flop (didn't bet)
Seat 4: /UdtxmXsFx6K/14AbHqzbQ (button) folded on the Flop
Seat 5: ApHP7ouup365XIUFBdEDxg (small blind) folded on the Turn
Seat 6: 1xBtrSVBbgFH/viUWKqQeg (big blind) collected ($3.35)
Seat 7: HWcfp1hY1hqvrddzW3/FQw folded before Flop (didn't bet)
Seat 8: ji04uOybxCdpdefzlUQeKQ folded before Flop (didn't bet)
Seat 9: HZkVla4kK2SI42CVrPZ/ig folded before Flop (didn't bet)



PokerStars Game #59941553946:  Hold'em No Limit ($0.25/$0.50) - 2009/07/01 1:38:58 ET
Table 'Wwfm5/i+g/g2Nj2gT3jnVQ' 2-max Seat #1 is the button
Seat 1: CHRLZDaaxjbo68bwQD1C/Q ($6.85 in chips)
Seat 2: PKuuhUvIr5WSkJyPJa9dFw ($22.70 in chips)
CHRLZDaaxjbo68bwQD1C/Q: posts small blind $0.25
PKuuhUvIr5WSkJyPJa9dFw: posts big blind $0.50
*** HOLE CARDS ***
CHRLZDaaxjbo68bwQD1C/Q: calls $0.25
PKuuhUvIr5WSkJyPJa9dFw: checks
*** FLOP *** [6d 7d Jc]
PKuuhUvIr5WSkJyPJa9dFw: checks
CHRLZDaaxjbo68bwQD1C/Q: bets $0.50
PKuuhUvIr5WSkJyPJa9dFw: raises $1.50 to $2
CHRLZDaaxjbo68bwQD1C/Q: folds
PKuuhUvIr5WSkJyPJa9dFw collected $1.95 from pot
PKuuhUvIr5WSkJyPJa9dFw: doesn't show hand
*** SUMMARY ***
Total pot $2 | Rake $0.05
Board [6d 7d Jc]
Seat 1: CHRLZDaaxjbo68bwQD1C/Q (button) (small blind) folded on the Flop
Seat 2: PKuuhUvIr5WSkJyPJa9dFw (big blind) collected ($1.95)



PokerStars Game #59941554430:  Hold'em No Limit ($0.25/$0.50) - 2009/07/01 1:38:59 ET
Table '8BQGgNetI1NOvWeu3gtMNw' 2-max Seat #2 is the button
Seat 1: bypIyrYcAAifLfhZpGlKLA ($79.15 in chips)
Seat 2: Z4HwehErEwzsv/noQlfUlg ($134.60 in chips)
Z4HwehErEwzsv/noQlfUlg: posts small blind $0.25
bypIyrYcAAifLfhZpGlKLA: posts big blind $0.50
*** HOLE CARDS ***
Z4HwehErEwzsv/noQlfUlg: raises $2.50 to $3
bypIyrYcAAifLfhZpGlKLA: calls $2.50
*** FLOP *** [8d 8s 5s]
bypIyrYcAAifLfhZpGlKLA: checks
Z4HwehErEwzsv/noQlfUlg: checks
*** TURN *** [8d 8s 5s] [Qd]
bypIyrYcAAifLfhZpGlKLA: bets $3.50
Z4HwehErEwzsv/noQlfUlg: raises $5.50 to $9
bypIyrYcAAifLfhZpGlKLA: calls $5.50
*** RIVER *** [8d 8s 5s Qd] [Th]
bypIyrYcAAifLfhZpGlKLA: checks
Z4HwehErEwzsv/noQlfUlg: bets $25
bypIyrYcAAifLfhZpGlKLA: folds
Z4HwehErEwzsv/noQlfUlg collected $23.50 from pot
Z4HwehErEwzsv/noQlfUlg: doesn't show hand
*** SUMMARY ***
Total pot $24 | Rake $0.50
Board [8d 8s 5s Qd Th]
Seat 1: bypIyrYcAAifLfhZpGlKLA (big blind) folded on the River
Seat 2: Z4HwehErEwzsv/noQlfUlg (button) (small blind) collected ($23.50)



PokerStars Game #59941554296:  Hold'em No Limit ($0.25/$0.50) - 2009/07/01 1:38:59 ET
Table 'B+sqsfj6d6zXicNfaseTaw' 2-max Seat #2 is the button
Seat 1: +4GNcSsecmapVGSdV0mUPA ($146.45 in chips)
Seat 2: Lv5RmpRe6LtPkBzM9Gpo5A ($74.35 in chips)
Lv5RmpRe6LtPkBzM9Gpo5A: posts small blind $0.25
+4GNcSsecmapVGSdV0mUPA: posts big blind $0.50
*** HOLE CARDS ***
Lv5RmpRe6LtPkBzM9Gpo5A: folds
+4GNcSsecmapVGSdV0mUPA collected $0.50 from pot
+4GNcSsecmapVGSdV0mUPA: doesn't show hand
*** SUMMARY ***
Total pot $0.50 | Rake $0
Seat 1: +4GNcSsecmapVGSdV0mUPA (big blind) collected ($0.50)
Seat 2: Lv5RmpRe6LtPkBzM9Gpo5A (button) (small blind) folded before Flop



PokerStars Game #59941556292:  Hold'em No Limit ($0.25/$0.50) - 2009/07/01 1:39:02 ET
Table 'iq+aXfWVQRdV0u8SRTYUEg' 9-max Seat #1 is the button
Seat 1: 3yl8Q6QaLfGtyhN4/pEFgQ ($71.55 in chips)
Seat 2: J9N0lxHFd/Js2S0xZLbsIQ ($26.05 in chips)
Seat 3: Qi/PyOsKwaqtKIg0H+7ELg ($10 in chips)
Seat 4: vHYT5s323LpajBj+2c9zbQ ($25.35 in chips)
Seat 5: 997ViqAtWn1FPjJqcffwcA ($56.90 in chips)
Seat 6: bTJ0WgoxefTPxIoycS7uoA ($30.45 in chips)
Seat 7: SKnJuWHScqetA/qG5p+wCg ($30.05 in chips)
Seat 8: /DtIHuxEH+3tzKefmSV+Mw ($44.65 in chips)
J9N0lxHFd/Js2S0xZLbsIQ: posts small blind $0.25
Qi/PyOsKwaqtKIg0H+7ELg: posts big blind $0.50
*** HOLE CARDS ***
vHYT5s323LpajBj+2c9zbQ: folds
997ViqAtWn1FPjJqcffwcA: folds
bTJ0WgoxefTPxIoycS7uoA: folds
SKnJuWHScqetA/qG5p+wCg: folds
/DtIHuxEH+3tzKefmSV+Mw: folds
3yl8Q6QaLfGtyhN4/pEFgQ: folds
J9N0lxHFd/Js2S0xZLbsIQ: calls $0.25
Qi/PyOsKwaqtKIg0H+7ELg: raises $0.50 to $1
J9N0lxHFd/Js2S0xZLbsIQ: calls $0.50
*** FLOP *** [Kh Jh 4c]
J9N0lxHFd/Js2S0xZLbsIQ: checks
Qi/PyOsKwaqtKIg0H+7ELg: bets $0.50
J9N0lxHFd/Js2S0xZLbsIQ: calls $0.50
*** TURN *** [Kh Jh 4c] [Qd]
J9N0lxHFd/Js2S0xZLbsIQ: checks
Qi/PyOsKwaqtKIg0H+7ELg: checks
*** RIVER *** [Kh Jh 4c Qd] [Js]
J9N0lxHFd/Js2S0xZLbsIQ: checks
Qi/PyOsKwaqtKIg0H+7ELg: checks
*** SHOW DOWN ***
J9N0lxHFd/Js2S0xZLbsIQ: shows [Th 8s] (a pair of Jacks)
Qi/PyOsKwaqtKIg0H+7ELg: shows [5h 5c] (two pair, Jacks and Fives)
Qi/PyOsKwaqtKIg0H+7ELg collected $2.90 from pot
*** SUMMARY ***
Total pot $3 | Rake $0.10
Board [Kh Jh 4c Qd Js]
Seat 1: 3yl8Q6QaLfGtyhN4/pEFgQ (button) folded before Flop (didn't bet)
Seat 2: J9N0lxHFd/Js2S0xZLbsIQ (small blind) showed [Th 8s] and lost with a pair of Jacks
Seat 3: Qi/PyOsKwaqtKIg0H+7ELg (big blind) showed [5h 5c] and won ($2.90) with two pair, Jacks and Fives
Seat 4: vHYT5s323LpajBj+2c9zbQ folded before Flop (didn't bet)
Seat 5: 997ViqAtWn1FPjJqcffwcA folded before Flop (didn't bet)
Seat 6: bTJ0WgoxefTPxIoycS7uoA folded before Flop (didn't bet)
Seat 7: SKnJuWHScqetA/qG5p+wCg folded before Flop (didn't bet)
Seat 8: /DtIHuxEH+3tzKefmSV+Mw folded before Flop (didn't bet)



PokerStars Game #59941556698:  Hold'em No Limit ($0.25/$0.50) - 2009/07/01 1:39:03 ET
Table 'tyR5AZNKV8Aadbrnrnlg7g' 6-max Seat #4 is the button
Seat 1: BgOXYI0yYSN1ULC4FqsNkg ($76.80 in chips)
Seat 3: JFLrYNyQmwPhRQAtoSAuyA ($60.85 in chips)
Seat 4: 4QfsCWthT/vSLirorNXqtg ($82.20 in chips)
Seat 5: GUnvMULl2qFOO1yenu1UBw ($79.85 in chips)
Seat 6: 498aWaGsW4uGfuWl+2FCGw ($80.85 in chips)
GUnvMULl2qFOO1yenu1UBw: posts small blind $0.25
498aWaGsW4uGfuWl+2FCGw: posts big blind $0.50
vhWS+cwAJNd3JzqVzIjBZA: sits out
*** HOLE CARDS ***
BgOXYI0yYSN1ULC4FqsNkg: folds
JFLrYNyQmwPhRQAtoSAuyA: folds
4QfsCWthT/vSLirorNXqtg: folds
GUnvMULl2qFOO1yenu1UBw: folds
498aWaGsW4uGfuWl+2FCGw collected $0.50 from pot
498aWaGsW4uGfuWl+2FCGw: doesn't show hand
*** SUMMARY ***
Total pot $0.50 | Rake $0
Seat 1: BgOXYI0yYSN1ULC4FqsNkg folded before Flop (didn't bet)
Seat 3: JFLrYNyQmwPhRQAtoSAuyA folded before Flop (didn't bet)
Seat 4: 4QfsCWthT/vSLirorNXqtg (button) folded before Flop (didn't bet)
Seat 5: GUnvMULl2qFOO1yenu1UBw (small blind) folded before Flop
Seat 6: 498aWaGsW4uGfuWl+2FCGw (big blind) collected ($0.50)



PokerStars Game #59941557270:  Hold'em No Limit ($0.25/$0.50) - 2009/07/01 1:39:04 ET
Table 'cofQFHU7jbJoFecLVBof/w' 6-max Seat #2 is the button
Seat 1: URYNc7fPA23K2UfadQbnCA ($50.95 in chips)
Seat 2: f89uTQr3ieGlusj2IAYAEg ($50 in chips)
Seat 3: v4ctePcLlQw0r8E0qJtjYw ($50.95 in chips)
Seat 4: 9XrTM0DuVxx1pjFAdSbD8A ($49.70 in chips)
Seat 5: QvwRlrpVqerRRF8eJm6dDw ($49.65 in chips)
Seat 6: 7+uQ0OOgCTbR4ltkSwyC0g ($160.05 in chips)
v4ctePcLlQw0r8E0qJtjYw: posts small blind $0.25
9XrTM0DuVxx1pjFAdSbD8A: posts big blind $0.50
*** HOLE CARDS ***
QvwRlrpVqerRRF8eJm6dDw: folds
7+uQ0OOgCTbR4ltkSwyC0g: calls $0.50
URYNc7fPA23K2UfadQbnCA: folds
f89uTQr3ieGlusj2IAYAEg: folds
v4ctePcLlQw0r8E0qJtjYw: folds
9XrTM0DuVxx1pjFAdSbD8A: checks
*** FLOP *** [4s Th 6h]
9XrTM0DuVxx1pjFAdSbD8A: bets $0.50
7+uQ0OOgCTbR4ltkSwyC0g: calls $0.50
*** TURN *** [4s Th 6h] [Qd]
9XrTM0DuVxx1pjFAdSbD8A: checks
7+uQ0OOgCTbR4ltkSwyC0g: checks
*** RIVER *** [4s Th 6h Qd] [6d]
9XrTM0DuVxx1pjFAdSbD8A: checks
7+uQ0OOgCTbR4ltkSwyC0g: checks
*** SHOW DOWN ***
9XrTM0DuVxx1pjFAdSbD8A: shows [4c 3d] (two pair, Sixes and Fours)
7+uQ0OOgCTbR4ltkSwyC0g: mucks hand
9XrTM0DuVxx1pjFAdSbD8A collected $2.15 from pot
*** SUMMARY ***
Total pot $2.25 | Rake $0.10
Board [4s Th 6h Qd 6d]
Seat 1: URYNc7fPA23K2UfadQbnCA folded before Flop (didn't bet)
Seat 2: f89uTQr3ieGlusj2IAYAEg (button) folded before Flop (didn't bet)
Seat 3: v4ctePcLlQw0r8E0qJtjYw (small blind) folded before Flop
Seat 4: 9XrTM0DuVxx1pjFAdSbD8A (big blind) showed [4c 3d] and won ($2.15) with two pair, Sixes and Fours
Seat 5: QvwRlrpVqerRRF8eJm6dDw folded before Flop (didn't bet)
Seat 6: 7+uQ0OOgCTbR4ltkSwyC0g mucked



PokerStars Game #59941557984:  Hold'em No Limit ($0.25/$0.50) - 2009/07/01 1:39:05 ET
Table 'B+sqsfj6d6zXicNfaseTaw' 2-max Seat #1 is the button
Seat 1: +4GNcSsecmapVGSdV0mUPA ($146.70 in chips)
Seat 2: Lv5RmpRe6LtPkBzM9Gpo5A ($74.10 in chips)
+4GNcSsecmapVGSdV0mUPA: posts small blind $0.25
Lv5RmpRe6LtPkBzM9Gpo5A: posts big blind $0.50
*** HOLE CARDS ***
+4GNcSsecmapVGSdV0mUPA: raises $1.50 to $2
Lv5RmpRe6LtPkBzM9Gpo5A: calls $1.50
*** FLOP *** [As 6c 9h]
Lv5RmpRe6LtPkBzM9Gpo5A: checks
+4GNcSsecmapVGSdV0mUPA: checks
*** TURN *** [As 6c 9h] [Qh]
Lv5RmpRe6LtPkBzM9Gpo5A: checks
+4GNcSsecmapVGSdV0mUPA: checks
*** RIVER *** [As 6c 9h Qh] [5h]
Lv5RmpRe6LtPkBzM9Gpo5A: checks
+4GNcSsecmapVGSdV0mUPA: checks
*** SHOW DOWN ***
Lv5RmpRe6LtPkBzM9Gpo5A: shows [5d 3s] (a pair of Fives)
+4GNcSsecmapVGSdV0mUPA: shows [Tc Th] (a pair of Tens)
+4GNcSsecmapVGSdV0mUPA collected $3.80 from pot
*** SUMMARY ***
Total pot $4 | Rake $0.20
Board [As 6c 9h Qh 5h]
Seat 1: +4GNcSsecmapVGSdV0mUPA (button) (small blind) showed [Tc Th] and won ($3.80) with a pair of Tens
Seat 2: Lv5RmpRe6LtPkBzM9Gpo5A (big blind) showed [5d 3s] and lost with a pair of Fives



PokerStars Game #59941559490:  Hold'em No Limit ($0.25/$0.50) - 2009/07/01 1:39:08 ET
Table '9ojijpRcYQSQTh6xI+haUA' 2-max Seat #1 is the button
Seat 1: FqpibuVWLNsAN/Z7ROZLnA ($50.95 in chips)
Seat 2: TitTV+fFCcBZWOERdytydA ($73.25 in chips)
FqpibuVWLNsAN/Z7ROZLnA: posts small blind $0.25
TitTV+fFCcBZWOERdytydA: posts big blind $0.50
*** HOLE CARDS ***
FqpibuVWLNsAN/Z7ROZLnA: raises $1.50 to $2
TitTV+fFCcBZWOERdytydA: calls $1.50
*** FLOP *** [7s Ah 6d]
TitTV+fFCcBZWOERdytydA: checks
FqpibuVWLNsAN/Z7ROZLnA: checks
*** TURN *** [7s Ah 6d] [9h]
TitTV+fFCcBZWOERdytydA: checks
FqpibuVWLNsAN/Z7ROZLnA: bets $1.50
TitTV+fFCcBZWOERdytydA: calls $1.50
*** RIVER *** [7s Ah 6d 9h] [4c]
TitTV+fFCcBZWOERdytydA: checks
FqpibuVWLNsAN/Z7ROZLnA: checks
*** SHOW DOWN ***
TitTV+fFCcBZWOERdytydA: shows [Ts Jc] (high card Ace)
FqpibuVWLNsAN/Z7ROZLnA: shows [Tc 9c] (a pair of Nines)
FqpibuVWLNsAN/Z7ROZLnA collected $6.70 from pot
*** SUMMARY ***
Total pot $7 | Rake $0.30
Board [7s Ah 6d 9h 4c]
Seat 1: FqpibuVWLNsAN/Z7ROZLnA (button) (small blind) showed [Tc 9c] and won ($6.70) with a pair of Nines
Seat 2: TitTV+fFCcBZWOERdytydA (big blind) showed [Ts Jc] and lost with high card Ace



PokerStars Game #59941559310:  Hold'em No Limit ($0.25/$0.50) - 2009/07/01 1:39:08 ET
Table 'Nz0Vr7WMHL2g5Uk7dDZjpw' 9-max Seat #9 is the button
Seat 1: 9yMsdgReyOUerNsmTYCCDQ ($8.50 in chips)
Seat 2: SegjDnMxWMujiD57ESNL+g ($20.35 in chips)
Seat 3: c638Xxo+q5F/t5qMtmvmvQ ($51.40 in chips)
Seat 4: uw9QayAAxLM3Hb+HR7mSkg ($9.25 in chips)
Seat 5: WGW0DgjBUXs1ylURHG8vnQ ($13.55 in chips)
Seat 6: 997ViqAtWn1FPjJqcffwcA ($53.75 in chips)
Seat 7: KPLH0gELgFe2OuAnhJFI5w ($25 in chips)
Seat 8: aoL+R/61Kxmw69ypuPrWAQ ($29.25 in chips)
Seat 9: mSD1pginDsyHG5PDfqzphw ($16.50 in chips)
9yMsdgReyOUerNsmTYCCDQ: posts small blind $0.25
SegjDnMxWMujiD57ESNL+g: posts big blind $0.50
*** HOLE CARDS ***
c638Xxo+q5F/t5qMtmvmvQ: folds
uw9QayAAxLM3Hb+HR7mSkg: folds
WGW0DgjBUXs1ylURHG8vnQ: folds
997ViqAtWn1FPjJqcffwcA: folds
KPLH0gELgFe2OuAnhJFI5w: raises $1 to $1.50
aoL+R/61Kxmw69ypuPrWAQ: calls $1.50
mSD1pginDsyHG5PDfqzphw: folds
9yMsdgReyOUerNsmTYCCDQ: folds
SegjDnMxWMujiD57ESNL+g: folds
*** FLOP *** [Kc 7h 6c]
KPLH0gELgFe2OuAnhJFI5w: checks
aoL+R/61Kxmw69ypuPrWAQ: checks
*** TURN *** [Kc 7h 6c] [Qs]
KPLH0gELgFe2OuAnhJFI5w: bets $1.50
aoL+R/61Kxmw69ypuPrWAQ: calls $1.50
*** RIVER *** [Kc 7h 6c Qs] [2h]
KPLH0gELgFe2OuAnhJFI5w: bets $6.50
aoL+R/61Kxmw69ypuPrWAQ: folds
KPLH0gELgFe2OuAnhJFI5w collected $6.45 from pot
*** SUMMARY ***
Total pot $6.75 | Rake $0.30
Board [Kc 7h 6c Qs 2h]
Seat 1: 9yMsdgReyOUerNsmTYCCDQ (small blind) folded before Flop
Seat 2: SegjDnMxWMujiD57ESNL+g (big blind) folded before Flop
Seat 3: c638Xxo+q5F/t5qMtmvmvQ folded before Flop (didn't bet)
Seat 4: uw9QayAAxLM3Hb+HR7mSkg folded before Flop (didn't bet)
Seat 5: WGW0DgjBUXs1ylURHG8vnQ folded before Flop (didn't bet)
Seat 6: 997ViqAtWn1FPjJqcffwcA folded before Flop (didn't bet)
Seat 7: KPLH0gELgFe2OuAnhJFI5w collected ($6.45)
Seat 8: aoL+R/61Kxmw69ypuPrWAQ folded on the River
Seat 9: mSD1pginDsyHG5PDfqzphw (button) folded before Flop (didn't bet)



PokerStars Game #59941560442:  Hold'em No Limit ($0.25/$0.50) - 2009/07/01 1:39:10 ET
Table 'EiNh8p/wGJ1FP575iMFnqg' 9-max Seat #8 is the button
Seat 1: YFFlOZgyy1Mh4iBmuNRbmQ ($19.25 in chips)
Seat 2: GRV8J6o4lVSBDEyjt6BwMg ($29.50 in chips)
Seat 3: ymLPoEIl7UL3TvZYmnadxQ ($44.25 in chips)
Seat 4: cMzaiXAM/ZAdNaEUu+LqhA ($54.20 in chips)
Seat 5: M+7+BTmX5vZatHVuoRB1nA ($77.15 in chips)
Seat 6: bCRukyMhXa3jkgAkKFa4VQ ($10.30 in chips)
Seat 7: 997ViqAtWn1FPjJqcffwcA ($50 in chips)
Seat 8: mSD1pginDsyHG5PDfqzphw ($11.50 in chips)
Seat 9: GuPkZObrz5Zkkn8FsEdF9w ($34.10 in chips)
GuPkZObrz5Zkkn8FsEdF9w: posts small blind $0.25
YFFlOZgyy1Mh4iBmuNRbmQ: posts big blind $0.50
*** HOLE CARDS ***
GRV8J6o4lVSBDEyjt6BwMg: folds
ymLPoEIl7UL3TvZYmnadxQ: folds
cMzaiXAM/ZAdNaEUu+LqhA: folds
M+7+BTmX5vZatHVuoRB1nA: raises $1.50 to $2
bCRukyMhXa3jkgAkKFa4VQ: folds
997ViqAtWn1FPjJqcffwcA: folds
mSD1pginDsyHG5PDfqzphw: calls $2
GuPkZObrz5Zkkn8FsEdF9w: folds
YFFlOZgyy1Mh4iBmuNRbmQ: folds
*** FLOP *** [Qs 5h 8d]
M+7+BTmX5vZatHVuoRB1nA: checks
mSD1pginDsyHG5PDfqzphw: bets $2
M+7+BTmX5vZatHVuoRB1nA: folds
mSD1pginDsyHG5PDfqzphw collected $4.55 from pot
mSD1pginDsyHG5PDfqzphw: doesn't show hand
*** SUMMARY ***
Total pot $4.75 | Rake $0.20
Board [Qs 5h 8d]
Seat 1: YFFlOZgyy1Mh4iBmuNRbmQ (big blind) folded before Flop
Seat 2: GRV8J6o4lVSBDEyjt6BwMg folded before Flop (didn't bet)
Seat 3: ymLPoEIl7UL3TvZYmnadxQ folded before Flop (didn't bet)
Seat 4: cMzaiXAM/ZAdNaEUu+LqhA folded before Flop (didn't bet)
Seat 5: M+7+BTmX5vZatHVuoRB1nA folded on the Flop
Seat 6: bCRukyMhXa3jkgAkKFa4VQ folded before Flop (didn't bet)
Seat 7: 997ViqAtWn1FPjJqcffwcA folded before Flop (didn't bet)
Seat 8: mSD1pginDsyHG5PDfqzphw (button) collected ($4.55)
Seat 9: GuPkZObrz5Zkkn8FsEdF9w (small blind) folded before Flop



PokerStars Game #59941560384:  Hold'em No Limit ($0.25/$0.50) - 2009/07/01 1:39:10 ET
Table 'hWT2kq66tnKEpD26cia6fQ' 2-max Seat #1 is the button
Seat 1: Ce3KNFP+ao7Da9NHb65raw ($20.70 in chips)
Seat 2: 16tvT7AYgZ2LgiGFcvFKQg ($52.85 in chips)
Ce3KNFP+ao7Da9NHb65raw: posts small blind $0.25
16tvT7AYgZ2LgiGFcvFKQg: posts big blind $0.50
*** HOLE CARDS ***
Ce3KNFP+ao7Da9NHb65raw: calls $0.25
16tvT7AYgZ2LgiGFcvFKQg: checks
*** FLOP *** [7s 7c 4c]
16tvT7AYgZ2LgiGFcvFKQg: checks
Ce3KNFP+ao7Da9NHb65raw: checks
*** TURN *** [7s 7c 4c] [3h]
16tvT7AYgZ2LgiGFcvFKQg: checks
Ce3KNFP+ao7Da9NHb65raw: checks
*** RIVER *** [7s 7c 4c 3h] [Td]
16tvT7AYgZ2LgiGFcvFKQg: bets $0.50
Ce3KNFP+ao7Da9NHb65raw: raises $0.50 to $1
16tvT7AYgZ2LgiGFcvFKQg: calls $0.50
*** SHOW DOWN ***
Ce3KNFP+ao7Da9NHb65raw: shows [Ts 2s] (two pair, Tens and Sevens)
16tvT7AYgZ2LgiGFcvFKQg: shows [Tc Jd] (two pair, Tens and Sevens - Jack kicker)
16tvT7AYgZ2LgiGFcvFKQg collected $2.90 from pot
*** SUMMARY ***
Total pot $3 | Rake $0.10
Board [7s 7c 4c 3h Td]
Seat 1: Ce3KNFP+ao7Da9NHb65raw (button) (small blind) showed [Ts 2s] and lost with two pair, Tens and Sevens
Seat 2: 16tvT7AYgZ2LgiGFcvFKQg (big blind) showed [Tc Jd] and won ($2.90) with two pair, Tens and Sevens



PokerStars Game #59941560880:  Hold'em No Limit ($0.25/$0.50) - 2009/07/01 1:39:11 ET
Table '+dXkOAQyS8j9PQZusUTMpg' 2-max Seat #1 is the button
Seat 1: Teld4PDKla7C8/Wfu2DSkg ($57.85 in chips)
Seat 2: qjBVVp3quHGDRH0szgloKA ($7.50 in chips)
Teld4PDKla7C8/Wfu2DSkg: posts small blind $0.25
qjBVVp3quHGDRH0szgloKA: posts big blind $0.50
*** HOLE CARDS ***
Teld4PDKla7C8/Wfu2DSkg: folds
qjBVVp3quHGDRH0szgloKA collected $0.50 from pot
qjBVVp3quHGDRH0szgloKA: doesn't show hand
*** SUMMARY ***
Total pot $0.50 | Rake $0
Seat 1: Teld4PDKla7C8/Wfu2DSkg (button) (small blind) folded before Flop
Seat 2: qjBVVp3quHGDRH0szgloKA (big blind) collected ($0.50)



PokerStars Game #59941561144:  Hold'em No Limit ($0.25/$0.50) - 2009/07/01 1:39:11 ET
Table '5EmHi+fnatGQQShcNmzOZQ' 6-max Seat #6 is the button
Seat 1: avNOJXWxD1+SygFmWsd+qw ($68.10 in chips)
Seat 2: OZ6OtYh5Y53MCH/p0QTn5g ($50 in chips)
Seat 3: QmH/ZFyxZfvliy57YM9yxw ($59.95 in chips)
Seat 4: 1b+2BbjMN8qhR1WPqdE9VQ ($51.05 in chips)
Seat 5: 6yWjZXHP6iAyMEDF6pJlng ($55.30 in chips)
Seat 6: u3Ol7kv1LmvszuHNm9rc6w ($26.60 in chips)
avNOJXWxD1+SygFmWsd+qw: posts small blind $0.25
OZ6OtYh5Y53MCH/p0QTn5g: posts big blind $0.50
*** HOLE CARDS ***
QmH/ZFyxZfvliy57YM9yxw: calls $0.50
1b+2BbjMN8qhR1WPqdE9VQ: folds
6yWjZXHP6iAyMEDF6pJlng: folds
u3Ol7kv1LmvszuHNm9rc6w: raises $1 to $1.50
avNOJXWxD1+SygFmWsd+qw: calls $1.25
OZ6OtYh5Y53MCH/p0QTn5g: folds
QmH/ZFyxZfvliy57YM9yxw: calls $1
*** FLOP *** [5s Ah 8c]
avNOJXWxD1+SygFmWsd+qw: checks
QmH/ZFyxZfvliy57YM9yxw: checks
u3Ol7kv1LmvszuHNm9rc6w: bets $3
avNOJXWxD1+SygFmWsd+qw: folds
QmH/ZFyxZfvliy57YM9yxw: calls $3
*** TURN *** [5s Ah 8c] [9c]
QmH/ZFyxZfvliy57YM9yxw: checks
u3Ol7kv1LmvszuHNm9rc6w: bets $6
QmH/ZFyxZfvliy57YM9yxw: raises $6 to $12
u3Ol7kv1LmvszuHNm9rc6w: calls $6
*** RIVER *** [5s Ah 8c 9c] [2h]
QmH/ZFyxZfvliy57YM9yxw: bets $5
u3Ol7kv1LmvszuHNm9rc6w: calls $5
*** SHOW DOWN ***
QmH/ZFyxZfvliy57YM9yxw: shows [9h 8s] (two pair, Nines and Eights)
u3Ol7kv1LmvszuHNm9rc6w: mucks hand
QmH/ZFyxZfvliy57YM9yxw collected $42.85 from pot
*** SUMMARY ***
Total pot $45 | Rake $2.15
Board [5s Ah 8c 9c 2h]
Seat 1: avNOJXWxD1+SygFmWsd+qw (small blind) folded on the Flop
Seat 2: OZ6OtYh5Y53MCH/p0QTn5g (big blind) folded before Flop
Seat 3: QmH/ZFyxZfvliy57YM9yxw showed [9h 8s] and won ($42.85) with two pair, Nines and Eights
Seat 4: 1b+2BbjMN8qhR1WPqdE9VQ folded before Flop (didn't bet)
Seat 5: 6yWjZXHP6iAyMEDF6pJlng folded before Flop (didn't bet)
Seat 6: u3Ol7kv1LmvszuHNm9rc6w (button) mucked



PokerStars Game #59941561654:  Hold'em No Limit ($0.25/$0.50) - 2009/07/01 1:39:12 ET
Table 'Wwfm5/i+g/g2Nj2gT3jnVQ' 2-max Seat #2 is the button
Seat 1: CHRLZDaaxjbo68bwQD1C/Q ($5.85 in chips)
Seat 2: PKuuhUvIr5WSkJyPJa9dFw ($23.65 in chips)
PKuuhUvIr5WSkJyPJa9dFw: posts small blind $0.25
CHRLZDaaxjbo68bwQD1C/Q: posts big blind $0.50
*** HOLE CARDS ***
PKuuhUvIr5WSkJyPJa9dFw: calls $0.25
CHRLZDaaxjbo68bwQD1C/Q: checks
*** FLOP *** [5d 6h 5c]
CHRLZDaaxjbo68bwQD1C/Q: checks
PKuuhUvIr5WSkJyPJa9dFw: bets $0.50
CHRLZDaaxjbo68bwQD1C/Q: folds
PKuuhUvIr5WSkJyPJa9dFw collected $0.95 from pot
PKuuhUvIr5WSkJyPJa9dFw: doesn't show hand
*** SUMMARY ***
Total pot $1 | Rake $0.05
Board [5d 6h 5c]
Seat 1: CHRLZDaaxjbo68bwQD1C/Q (big blind) folded on the Flop
Seat 2: PKuuhUvIr5WSkJyPJa9dFw (button) (small blind) collected ($0.95)



PokerStars Game #59941562260:  Hold'em No Limit ($0.25/$0.50) - 2009/07/01 1:39:13 ET
Table 'kgbJRsxfv64KrErDRBAkcw' 6-max Seat #6 is the button
Seat 1: VamsyhlFzXGF6/ydo0BHeA ($5 in chips)
Seat 2: AdS8BJMOheS01zjCDfPMFg ($88.60 in chips)
Seat 3: c4MNIaIyPMOMxrgT8FT5nA ($156 in chips)
Seat 4: 2igtJLmvIZ+HqX4XPgMPZA ($111.75 in chips)
Seat 5: eUBBn2R56C1IQ6Cs/vitwg ($106 in chips)
Seat 6: 1b+2BbjMN8qhR1WPqdE9VQ ($50 in chips)
VamsyhlFzXGF6/ydo0BHeA: posts small blind $0.25
AdS8BJMOheS01zjCDfPMFg: posts big blind $0.50
*** HOLE CARDS ***
c4MNIaIyPMOMxrgT8FT5nA: folds
2igtJLmvIZ+HqX4XPgMPZA: raises $1.50 to $2
eUBBn2R56C1IQ6Cs/vitwg: folds
1b+2BbjMN8qhR1WPqdE9VQ: folds
VamsyhlFzXGF6/ydo0BHeA: folds
AdS8BJMOheS01zjCDfPMFg: folds
2igtJLmvIZ+HqX4XPgMPZA collected $1.25 from pot
2igtJLmvIZ+HqX4XPgMPZA: doesn't show hand
*** SUMMARY ***
Total pot $1.25 | Rake $0
Seat 1: VamsyhlFzXGF6/ydo0BHeA (small blind) folded before Flop
Seat 2: AdS8BJMOheS01zjCDfPMFg (big blind) folded before Flop
Seat 3: c4MNIaIyPMOMxrgT8FT5nA folded before Flop (didn't bet)
Seat 4: 2igtJLmvIZ+HqX4XPgMPZA collected ($1.25)
Seat 5: eUBBn2R56C1IQ6Cs/vitwg folded before Flop (didn't bet)
Seat 6: 1b+2BbjMN8qhR1WPqdE9VQ (button) folded before Flop (didn't bet)



PokerStars Game #59941562356:  Hold'em No Limit ($0.25/$0.50) - 2009/07/01 1:39:13 ET
Table 'hSTs/dUsYLgJQuF2Onp0MQ' 6-max Seat #2 is the button
Seat 2: Hdd4js36ITbTJ/QuVYwTlA ($99.75 in chips)
Seat 3: lxIzoHy0RnkfFSODHC2liw ($50 in chips)
Seat 4: 2igtJLmvIZ+HqX4XPgMPZA ($50 in chips)
Seat 5: FsRQ5ECdlLkLYI5le8+PDQ ($50.35 in chips)
Seat 6: M1KyQQvVPVuxqTAB8sR/zQ ($101.90 in chips)
lxIzoHy0RnkfFSODHC2liw: posts small blind $0.25
2igtJLmvIZ+HqX4XPgMPZA: posts big blind $0.50
*** HOLE CARDS ***
FsRQ5ECdlLkLYI5le8+PDQ: folds
M1KyQQvVPVuxqTAB8sR/zQ: raises $1 to $1.50
Hdd4js36ITbTJ/QuVYwTlA: calls $1.50
lxIzoHy0RnkfFSODHC2liw: folds
2igtJLmvIZ+HqX4XPgMPZA: calls $1
*** FLOP *** [As Ks Qh]
2igtJLmvIZ+HqX4XPgMPZA: checks
M1KyQQvVPVuxqTAB8sR/zQ: bets $3.25
Hdd4js36ITbTJ/QuVYwTlA: folds
2igtJLmvIZ+HqX4XPgMPZA: folds
M1KyQQvVPVuxqTAB8sR/zQ collected $4.55 from pot
*** SUMMARY ***
Total pot $4.75 | Rake $0.20
Board [As Ks Qh]
Seat 2: Hdd4js36ITbTJ/QuVYwTlA (button) folded on the Flop
Seat 3: lxIzoHy0RnkfFSODHC2liw (small blind) folded before Flop
Seat 4: 2igtJLmvIZ+HqX4XPgMPZA (big blind) folded on the Flop
Seat 5: FsRQ5ECdlLkLYI5le8+PDQ folded before Flop (didn't bet)
Seat 6: M1KyQQvVPVuxqTAB8sR/zQ collected ($4.55)



PokerStars Game #59941564390:  Hold'em No Limit ($0.25/$0.50) - 2009/07/01 1:39:17 ET
Table '+dXkOAQyS8j9PQZusUTMpg' 2-max Seat #2 is the button
Seat 1: Teld4PDKla7C8/Wfu2DSkg ($57.60 in chips)
Seat 2: qjBVVp3quHGDRH0szgloKA ($7.75 in chips)
qjBVVp3quHGDRH0szgloKA: posts small blind $0.25
Teld4PDKla7C8/Wfu2DSkg: posts big blind $0.50
*** HOLE CARDS ***
qjBVVp3quHGDRH0szgloKA: raises $1.50 to $2
Teld4PDKla7C8/Wfu2DSkg: folds
qjBVVp3quHGDRH0szgloKA collected $1 from pot
qjBVVp3quHGDRH0szgloKA: doesn't show hand
*** SUMMARY ***
Total pot $1 | Rake $0
Seat 1: Teld4PDKla7C8/Wfu2DSkg (big blind) folded before Flop
Seat 2: qjBVVp3quHGDRH0szgloKA (button) (small blind) collected ($1)



PokerStars Game #59941564658:  Hold'em No Limit ($0.25/$0.50) - 2009/07/01 1:39:18 ET
Table 'lSisgp6H7Fg1hH5VfjEjYQ' 9-max Seat #1 is the button
Seat 1: 5k9fvXD9suIgCxU4HLQjTw ($53.30 in chips)
Seat 2: 5acK4E7fzEwnplVBZ6eNWA ($51.20 in chips)
Seat 3: SKnJuWHScqetA/qG5p+wCg ($30 in chips)
Seat 4: FFVKBJT0lZf+jFlgvy7ang ($39 in chips)
Seat 5: mSD1pginDsyHG5PDfqzphw ($16.75 in chips)
Seat 6: +k7T5ocke8UwavtgUHm+Cg ($75.20 in chips)
Seat 7: IDtNLR9uFCDdjNsJWMHA5Q ($19.55 in chips)
Seat 8: a4JDWmpFQkL10XfAyuF51A ($10.45 in chips)
YzeKFbJVLmJGTgNH3ySQlw has returned
5acK4E7fzEwnplVBZ6eNWA: posts small blind $0.25
SKnJuWHScqetA/qG5p+wCg: posts big blind $0.50
*** HOLE CARDS ***
FFVKBJT0lZf+jFlgvy7ang: folds
mSD1pginDsyHG5PDfqzphw: folds
+k7T5ocke8UwavtgUHm+Cg: calls $0.50
IDtNLR9uFCDdjNsJWMHA5Q: folds
a4JDWmpFQkL10XfAyuF51A: folds
5k9fvXD9suIgCxU4HLQjTw: folds
5acK4E7fzEwnplVBZ6eNWA: folds
SKnJuWHScqetA/qG5p+wCg: checks
*** FLOP *** [As 6c 5c]
SKnJuWHScqetA/qG5p+wCg: checks
+k7T5ocke8UwavtgUHm+Cg: checks
*** TURN *** [As 6c 5c] [8h]
SKnJuWHScqetA/qG5p+wCg: checks
+k7T5ocke8UwavtgUHm+Cg: bets $1
SKnJuWHScqetA/qG5p+wCg: folds
+k7T5ocke8UwavtgUHm+Cg collected $1.20 from pot
+k7T5ocke8UwavtgUHm+Cg: doesn't show hand
*** SUMMARY ***
Total pot $1.25 | Rake $0.05
Board [As 6c 5c 8h]
Seat 1: 5k9fvXD9suIgCxU4HLQjTw (button) folded before Flop (didn't bet)
Seat 2: 5acK4E7fzEwnplVBZ6eNWA (small blind) folded before Flop
Seat 3: SKnJuWHScqetA/qG5p+wCg (big blind) folded on the Turn
Seat 4: FFVKBJT0lZf+jFlgvy7ang folded before Flop (didn't bet)
Seat 5: mSD1pginDsyHG5PDfqzphw folded before Flop (didn't bet)
Seat 6: +k7T5ocke8UwavtgUHm+Cg collected ($1.20)
Seat 7: IDtNLR9uFCDdjNsJWMHA5Q folded before Flop (didn't bet)
Seat 8: a4JDWmpFQkL10XfAyuF51A folded before Flop (didn't bet)



PokerStars Game #59941565246:  Hold'em No Limit ($0.25/$0.50) - 2009/07/01 1:39:19 ET
Table 'tyR5AZNKV8Aadbrnrnlg7g' 6-max Seat #5 is the button
Seat 1: BgOXYI0yYSN1ULC4FqsNkg ($76.80 in chips)
Seat 3: JFLrYNyQmwPhRQAtoSAuyA ($60.85 in chips)
Seat 4: 4QfsCWthT/vSLirorNXqtg ($82.20 in chips)
Seat 5: GUnvMULl2qFOO1yenu1UBw ($79.60 in chips)
Seat 6: 498aWaGsW4uGfuWl+2FCGw ($81.10 in chips)
498aWaGsW4uGfuWl+2FCGw: posts small blind $0.25
BgOXYI0yYSN1ULC4FqsNkg: posts big blind $0.50
vhWS+cwAJNd3JzqVzIjBZA: sits out
*** HOLE CARDS ***
JFLrYNyQmwPhRQAtoSAuyA: folds
4QfsCWthT/vSLirorNXqtg: folds
GUnvMULl2qFOO1yenu1UBw: raises $1 to $1.50
498aWaGsW4uGfuWl+2FCGw: calls $1.25
BgOXYI0yYSN1ULC4FqsNkg: folds
*** FLOP *** [9d Ad 3h]
498aWaGsW4uGfuWl+2FCGw: checks
GUnvMULl2qFOO1yenu1UBw: bets $2.50
498aWaGsW4uGfuWl+2FCGw: calls $2.50
*** TURN *** [9d Ad 3h] [7h]
498aWaGsW4uGfuWl+2FCGw: checks
GUnvMULl2qFOO1yenu1UBw: checks
*** RIVER *** [9d Ad 3h 7h] [6d]
498aWaGsW4uGfuWl+2FCGw: bets $2
GUnvMULl2qFOO1yenu1UBw: folds
498aWaGsW4uGfuWl+2FCGw collected $8.10 from pot
498aWaGsW4uGfuWl+2FCGw: doesn't show hand
*** SUMMARY ***
Total pot $8.50 | Rake $0.40
Board [9d Ad 3h 7h 6d]
Seat 1: BgOXYI0yYSN1ULC4FqsNkg (big blind) folded before Flop
Seat 3: JFLrYNyQmwPhRQAtoSAuyA folded before Flop (didn't bet)
Seat 4: 4QfsCWthT/vSLirorNXqtg folded before Flop (didn't bet)
Seat 5: GUnvMULl2qFOO1yenu1UBw (button) folded on the River
Seat 6: 498aWaGsW4uGfuWl+2FCGw (small blind) collected ($8.10)



PokerStars Game #59941567170:  Hold'em No Limit ($0.25/$0.50) - 2009/07/01 1:39:22 ET
Table 'GfL/No5u5PoEnU39lP5pQg' 6-max Seat #6 is the button
Seat 2: uVwggSetzp7d+eVgowO3vg ($54.05 in chips)
Seat 3: 4pp9WxhGdbVbxCc9tlu0lw ($26.40 in chips)
Seat 4: vhWS+cwAJNd3JzqVzIjBZA ($50 in chips)
Seat 5: M1KyQQvVPVuxqTAB8sR/zQ ($50.20 in chips)
Seat 6: kxPhs4ePFqMy52CInAJ2aw ($93.80 in chips)
uVwggSetzp7d+eVgowO3vg: posts small blind $0.25
4pp9WxhGdbVbxCc9tlu0lw: posts big blind $0.50
*** HOLE CARDS ***
vhWS+cwAJNd3JzqVzIjBZA: folds
M1KyQQvVPVuxqTAB8sR/zQ: folds
kxPhs4ePFqMy52CInAJ2aw: folds
vhWS+cwAJNd3JzqVzIjBZA leaves the table
uVwggSetzp7d+eVgowO3vg: calls $0.25
4pp9WxhGdbVbxCc9tlu0lw: raises $0.50 to $1
uVwggSetzp7d+eVgowO3vg: calls $0.50
*** FLOP *** [7h 7d Qs]
uVwggSetzp7d+eVgowO3vg: checks
ifQmgsYNFiAg/XvBOMBSfQ joins the table at seat #4
4pp9WxhGdbVbxCc9tlu0lw: bets $1
uVwggSetzp7d+eVgowO3vg: folds
4pp9WxhGdbVbxCc9tlu0lw collected $1.90 from pot
*** SUMMARY ***
Total pot $2 | Rake $0.10
Board [7h 7d Qs]
Seat 2: uVwggSetzp7d+eVgowO3vg (small blind) folded on the Flop
Seat 3: 4pp9WxhGdbVbxCc9tlu0lw (big blind) collected ($1.90)
Seat 4: vhWS+cwAJNd3JzqVzIjBZA folded before Flop (didn't bet)
Seat 5: M1KyQQvVPVuxqTAB8sR/zQ folded before Flop (didn't bet)
Seat 6: kxPhs4ePFqMy52CInAJ2aw (button) folded before Flop (didn't bet)



PokerStars Game #59941567250:  Hold'em No Limit ($0.25/$0.50) - 2009/07/01 1:39:22 ET
Table 'B+sqsfj6d6zXicNfaseTaw' 2-max Seat #2 is the button
Seat 1: +4GNcSsecmapVGSdV0mUPA ($148.50 in chips)
Seat 2: Lv5RmpRe6LtPkBzM9Gpo5A ($72.10 in chips)
Lv5RmpRe6LtPkBzM9Gpo5A: posts small blind $0.25
+4GNcSsecmapVGSdV0mUPA: posts big blind $0.50
*** HOLE CARDS ***
Lv5RmpRe6LtPkBzM9Gpo5A: raises $0.50 to $1
+4GNcSsecmapVGSdV0mUPA: calls $0.50
*** FLOP *** [3h 3s Tc]
+4GNcSsecmapVGSdV0mUPA: checks
Lv5RmpRe6LtPkBzM9Gpo5A: checks
*** TURN *** [3h 3s Tc] [8h]
+4GNcSsecmapVGSdV0mUPA: checks
Lv5RmpRe6LtPkBzM9Gpo5A: checks
*** RIVER *** [3h 3s Tc 8h] [Ac]
+4GNcSsecmapVGSdV0mUPA: checks
Lv5RmpRe6LtPkBzM9Gpo5A: bets $0.50
+4GNcSsecmapVGSdV0mUPA: calls $0.50
*** SHOW DOWN ***
Lv5RmpRe6LtPkBzM9Gpo5A: shows [3d 6d] (three of a kind, Threes)
+4GNcSsecmapVGSdV0mUPA: mucks hand
Lv5RmpRe6LtPkBzM9Gpo5A collected $2.90 from pot
*** SUMMARY ***
Total pot $3 | Rake $0.10
Board [3h 3s Tc 8h Ac]
Seat 1: +4GNcSsecmapVGSdV0mUPA (big blind) mucked
Seat 2: Lv5RmpRe6LtPkBzM9Gpo5A (button) (small blind) showed [3d 6d] and won ($2.90) with three of a kind, Threes



PokerStars Game #59941568654:  Hold'em No Limit ($0.25/$0.50) - 2009/07/01 1:39:25 ET
Table 'Wwfm5/i+g/g2Nj2gT3jnVQ' 2-max Seat #1 is the button
Seat 1: CHRLZDaaxjbo68bwQD1C/Q ($5.35 in chips)
Seat 2: PKuuhUvIr5WSkJyPJa9dFw ($24.10 in chips)
CHRLZDaaxjbo68bwQD1C/Q: posts small blind $0.25
PKuuhUvIr5WSkJyPJa9dFw: posts big blind $0.50
*** HOLE CARDS ***
CHRLZDaaxjbo68bwQD1C/Q: calls $0.25
PKuuhUvIr5WSkJyPJa9dFw: raises $1.50 to $2
CHRLZDaaxjbo68bwQD1C/Q: folds
PKuuhUvIr5WSkJyPJa9dFw collected $1 from pot
PKuuhUvIr5WSkJyPJa9dFw: doesn't show hand
*** SUMMARY ***
Total pot $1 | Rake $0
Seat 1: CHRLZDaaxjbo68bwQD1C/Q (button) (small blind) folded before Flop
Seat 2: PKuuhUvIr5WSkJyPJa9dFw (big blind) collected ($1)



PokerStars Game #59941569564:  Hold'em No Limit ($0.25/$0.50) - 2009/07/01 1:39:26 ET
Table '+dXkOAQyS8j9PQZusUTMpg' 2-max Seat #1 is the button
Seat 1: Teld4PDKla7C8/Wfu2DSkg ($57.10 in chips)
Seat 2: qjBVVp3quHGDRH0szgloKA ($8.25 in chips)
Teld4PDKla7C8/Wfu2DSkg: posts small blind $0.25
qjBVVp3quHGDRH0szgloKA: posts big blind $0.50
*** HOLE CARDS ***
Teld4PDKla7C8/Wfu2DSkg: calls $0.25
qjBVVp3quHGDRH0szgloKA: raises $7.75 to $8.25 and is all-in
Teld4PDKla7C8/Wfu2DSkg: folds
qjBVVp3quHGDRH0szgloKA collected $1 from pot
qjBVVp3quHGDRH0szgloKA: doesn't show hand
*** SUMMARY ***
Total pot $1 | Rake $0
Seat 1: Teld4PDKla7C8/Wfu2DSkg (button) (small blind) folded before Flop
Seat 2: qjBVVp3quHGDRH0szgloKA (big blind) collected ($1)



PokerStars Game #59941570344:  Hold'em No Limit ($0.25/$0.50) - 2009/07/01 1:39:28 ET
Table '2lPOwetm4cfkZPbTmGPH/w' 2-max Seat #2 is the button
Seat 1: vUGdApqS8J/GJE2gaVWl1w ($8.60 in chips)
Seat 2: XFa6sBGjP2gxoIvxR3fZIg ($28.70 in chips)
XFa6sBGjP2gxoIvxR3fZIg: posts small blind $0.25
vUGdApqS8J/GJE2gaVWl1w: posts big blind $0.50
*** HOLE CARDS ***
XFa6sBGjP2gxoIvxR3fZIg: calls $0.25
vUGdApqS8J/GJE2gaVWl1w: checks
*** FLOP *** [Kc 5s Qd]
vUGdApqS8J/GJE2gaVWl1w: checks
XFa6sBGjP2gxoIvxR3fZIg: checks
*** TURN *** [Kc 5s Qd] [Th]
vUGdApqS8J/GJE2gaVWl1w: checks
XFa6sBGjP2gxoIvxR3fZIg: checks
*** RIVER *** [Kc 5s Qd Th] [Jd]
vUGdApqS8J/GJE2gaVWl1w: bets $0.50
XFa6sBGjP2gxoIvxR3fZIg: calls $0.50
*** SHOW DOWN ***
vUGdApqS8J/GJE2gaVWl1w: shows [Jc 3s] (a pair of Jacks)
XFa6sBGjP2gxoIvxR3fZIg: mucks hand
vUGdApqS8J/GJE2gaVWl1w collected $1.95 from pot
*** SUMMARY ***
Total pot $2 | Rake $0.05
Board [Kc 5s Qd Th Jd]
Seat 1: vUGdApqS8J/GJE2gaVWl1w (big blind) showed [Jc 3s] and won ($1.95) with a pair of Jacks
Seat 2: XFa6sBGjP2gxoIvxR3fZIg (button) (small blind) mucked



PokerStars Game #59941571254:  Hold'em No Limit ($0.25/$0.50) - 2009/07/01 1:39:29 ET
Table 'ofnd8S4IdIPph1Cbn+x7hAbR5MkGhKEbz+X2bpfpu11Qmax Seat #5 is the button
Seat 2: 1xBtrSVBbgFH/viUWKqQeg ($38.05 in chips)
Seat 3: UVJbBPbDwNMEZadZB9WVmg ($9.75 in chips)
Seat 4: mZNMJI1mY40XTC0U7GZakA ($62.20 in chips)
Seat 5: 2YaCb/8u1SesrR+963XiZA ($15.40 in chips)
Seat 6: 0Bw1Gb5YC/Xvb0SqVawKUw ($6.75 in chips)
Seat 7: kJ06FP2Jc7cSdmywwvYOXw ($61.35 in chips)
Seat 8: R354x4oZnQcGCDV6GhjnpQ ($65.30 in chips)
Seat 9: 75K2MXwN65Sjfp1yHd50Hg ($10 in chips)
0Bw1Gb5YC/Xvb0SqVawKUw: posts small blind $0.25
kJ06FP2Jc7cSdmywwvYOXw: posts big blind $0.50
6CKPjbH+MB5p5oH9GwiXGA: sits out
*** HOLE CARDS ***
R354x4oZnQcGCDV6GhjnpQ: folds
75K2MXwN65Sjfp1yHd50Hg: folds
1xBtrSVBbgFH/viUWKqQeg: folds
UVJbBPbDwNMEZadZB9WVmg: folds
mZNMJI1mY40XTC0U7GZakA: folds
2YaCb/8u1SesrR+963XiZA: calls $0.50
0Bw1Gb5YC/Xvb0SqVawKUw: calls $0.25
kJ06FP2Jc7cSdmywwvYOXw: checks
*** FLOP *** [2d 3s Ts]
0Bw1Gb5YC/Xvb0SqVawKUw: checks
kJ06FP2Jc7cSdmywwvYOXw: checks
2YaCb/8u1SesrR+963XiZA: bets $1
0Bw1Gb5YC/Xvb0SqVawKUw: calls $1
kJ06FP2Jc7cSdmywwvYOXw: calls $1
*** TURN *** [2d 3s Ts] [9h]
0Bw1Gb5YC/Xvb0SqVawKUw: checks
kJ06FP2Jc7cSdmywwvYOXw: checks
2YaCb/8u1SesrR+963XiZA: checks
*** RIVER *** [2d 3s Ts 9h] [6c]
0Bw1Gb5YC/Xvb0SqVawKUw: checks
kJ06FP2Jc7cSdmywwvYOXw: checks
2YaCb/8u1SesrR+963XiZA: checks
*** SHOW DOWN ***
0Bw1Gb5YC/Xvb0SqVawKUw: shows [9s As] (a pair of Nines)
kJ06FP2Jc7cSdmywwvYOXw: mucks hand
2YaCb/8u1SesrR+963XiZA: mucks hand
0Bw1Gb5YC/Xvb0SqVawKUw collected $4.30 from pot
*** SUMMARY ***
Total pot $4.50 | Rake $0.20
Board [2d 3s Ts 9h 6c]
Seat 2: 1xBtrSVBbgFH/viUWKqQeg folded before Flop (didn't bet)
Seat 3: UVJbBPbDwNMEZadZB9WVmg folded before Flop (didn't bet)
Seat 4: mZNMJI1mY40XTC0U7GZakA folded before Flop (didn't bet)
Seat 5: 2YaCb/8u1SesrR+963XiZA (button) mucked
Seat 6: 0Bw1Gb5YC/Xvb0SqVawKUw (small blind) showed [9s As] and won ($4.30) with a pair of Nines
Seat 7: kJ06FP2Jc7cSdmywwvYOXw (big blind) mucked
Seat 8: R354x4oZnQcGCDV6GhjnpQ folded before Flop (didn't bet)
Seat 9: 75K2MXwN65Sjfp1yHd50Hg folded before Flop (didn't bet)



PokerStars Game #59941570840:  Hold'em No Limit ($0.25/$0.50) - 2009/07/01 1:39:29 ET
Table '5qf8oPyYje71HBKD0FwPgQ' 9-max Seat #7 is the button
Seat 2: M+7+BTmX5vZatHVuoRB1nA ($53.15 in chips)
Seat 3: vacmVLJJECYI6HjAynFcpg ($51.20 in chips)
Seat 4: YXCE3WOZi8g2sIf3y/plVw ($53.85 in chips)
Seat 5: uo2Sgpknd7NdeVbeSCG02A ($15.20 in chips)
Seat 6: go0Ad6tqqJ4tR9/bqVlO0g ($26.20 in chips)
Seat 7: 1q5EPoiflJRl8pqfnVLjMw ($57.50 in chips)
Seat 8: sakr/FIfFtIZwDPmAj5Pzg ($58.60 in chips)
Seat 9: jWDRpL0TJljg+mBCE9ZMqA ($7.85 in chips)
sakr/FIfFtIZwDPmAj5Pzg: posts small blind $0.25
jWDRpL0TJljg+mBCE9ZMqA: posts big blind $0.50
gsyXT42WLEcOS4DdEk2wlw: sits out
*** HOLE CARDS ***
M+7+BTmX5vZatHVuoRB1nA: folds
vacmVLJJECYI6HjAynFcpg: folds
YXCE3WOZi8g2sIf3y/plVw: raises $0.50 to $1
uo2Sgpknd7NdeVbeSCG02A: calls $1
go0Ad6tqqJ4tR9/bqVlO0g: folds
1q5EPoiflJRl8pqfnVLjMw: folds
sakr/FIfFtIZwDPmAj5Pzg: folds
jWDRpL0TJljg+mBCE9ZMqA: calls $0.50
*** FLOP *** [8d Jc 7d]
jWDRpL0TJljg+mBCE9ZMqA: checks
YXCE3WOZi8g2sIf3y/plVw: bets $2
uo2Sgpknd7NdeVbeSCG02A: folds
jWDRpL0TJljg+mBCE9ZMqA: calls $2
*** TURN *** [8d Jc 7d] [8h]
jWDRpL0TJljg+mBCE9ZMqA: checks
YXCE3WOZi8g2sIf3y/plVw: checks
*** RIVER *** [8d Jc 7d 8h] [Ah]
jWDRpL0TJljg+mBCE9ZMqA: checks
YXCE3WOZi8g2sIf3y/plVw: bets $5
jWDRpL0TJljg+mBCE9ZMqA: folds
YXCE3WOZi8g2sIf3y/plVw collected $6.90 from pot
YXCE3WOZi8g2sIf3y/plVw: doesn't show hand
*** SUMMARY ***
Total pot $7.25 | Rake $0.35
Board [8d Jc 7d 8h Ah]
Seat 2: M+7+BTmX5vZatHVuoRB1nA folded before Flop (didn't bet)
Seat 3: vacmVLJJECYI6HjAynFcpg folded before Flop (didn't bet)
Seat 4: YXCE3WOZi8g2sIf3y/plVw collected ($6.90)
Seat 5: uo2Sgpknd7NdeVbeSCG02A folded on the Flop
Seat 6: go0Ad6tqqJ4tR9/bqVlO0g folded before Flop (didn't bet)
Seat 7: 1q5EPoiflJRl8pqfnVLjMw (button) folded before Flop (didn't bet)
Seat 8: sakr/FIfFtIZwDPmAj5Pzg (small blind) folded before Flop
Seat 9: jWDRpL0TJljg+mBCE9ZMqA (big blind) folded on the River



PokerStars Game #59941572720:  Hold'em No Limit ($0.25/$0.50) - 2009/07/01 1:39:32 ET
Table 'iq+aXfWVQRdV0u8SRTYUEg' 9-max Seat #2 is the button
Seat 1: 3yl8Q6QaLfGtyhN4/pEFgQ ($71.55 in chips)
Seat 2: J9N0lxHFd/Js2S0xZLbsIQ ($24.55 in chips)
Seat 3: Qi/PyOsKwaqtKIg0H+7ELg ($11.40 in chips)
Seat 4: vHYT5s323LpajBj+2c9zbQ ($25.35 in chips)
Seat 5: 997ViqAtWn1FPjJqcffwcA ($56.90 in chips)
Seat 6: bTJ0WgoxefTPxIoycS7uoA ($30.45 in chips)
Seat 7: SKnJuWHScqetA/qG5p+wCg ($30.05 in chips)
Seat 8: /DtIHuxEH+3tzKefmSV+Mw ($44.65 in chips)
Qi/PyOsKwaqtKIg0H+7ELg: posts small blind $0.25
vHYT5s323LpajBj+2c9zbQ: posts big blind $0.50
*** HOLE CARDS ***
997ViqAtWn1FPjJqcffwcA: folds
drKg+7JekfxR/0poTEK9Tg joins the table at seat #9
bTJ0WgoxefTPxIoycS7uoA: raises $1.50 to $2
SKnJuWHScqetA/qG5p+wCg: folds
/DtIHuxEH+3tzKefmSV+Mw: calls $2
3yl8Q6QaLfGtyhN4/pEFgQ: folds
J9N0lxHFd/Js2S0xZLbsIQ: calls $2
Qi/PyOsKwaqtKIg0H+7ELg: folds
vHYT5s323LpajBj+2c9zbQ: folds
*** FLOP *** [Qd As Qs]
bTJ0WgoxefTPxIoycS7uoA: checks
/DtIHuxEH+3tzKefmSV+Mw: checks
J9N0lxHFd/Js2S0xZLbsIQ: checks
*** TURN *** [Qd As Qs] [2c]
bTJ0WgoxefTPxIoycS7uoA: bets $2.50
/DtIHuxEH+3tzKefmSV+Mw: folds
J9N0lxHFd/Js2S0xZLbsIQ: calls $2.50
*** RIVER *** [Qd As Qs 2c] [Td]
bTJ0WgoxefTPxIoycS7uoA: checks
J9N0lxHFd/Js2S0xZLbsIQ: bets $4.50
Qi/PyOsKwaqtKIg0H+7ELg leaves the table
bTJ0WgoxefTPxIoycS7uoA: folds
J9N0lxHFd/Js2S0xZLbsIQ collected $11.20 from pot
J9N0lxHFd/Js2S0xZLbsIQ: shows [Ks 7s] (a pair of Queens)
*** SUMMARY ***
Total pot $11.75 | Rake $0.55
Board [Qd As Qs 2c Td]
Seat 1: 3yl8Q6QaLfGtyhN4/pEFgQ folded before Flop (didn't bet)
Seat 2: J9N0lxHFd/Js2S0xZLbsIQ (button) collected ($11.20)
Seat 3: Qi/PyOsKwaqtKIg0H+7ELg (small blind) folded before Flop
Seat 4: vHYT5s323LpajBj+2c9zbQ (big blind) folded before Flop
Seat 5: 997ViqAtWn1FPjJqcffwcA folded before Flop (didn't bet)
Seat 6: bTJ0WgoxefTPxIoycS7uoA folded on the River
Seat 7: SKnJuWHScqetA/qG5p+wCg folded before Flop (didn't bet)
Seat 8: /DtIHuxEH+3tzKefmSV+Mw folded on the Turn



PokerStars Game #59941572408:  Hold'em No Limit ($0.25/$0.50) - 2009/07/01 1:39:32 ET
Table '8BQGgNetI1NOvWeu3gtMNw' 2-max Seat #1 is the button
Seat 1: bypIyrYcAAifLfhZpGlKLA ($67.15 in chips)
Seat 2: Z4HwehErEwzsv/noQlfUlg ($146.10 in chips)
bypIyrYcAAifLfhZpGlKLA: posts small blind $0.25
Z4HwehErEwzsv/noQlfUlg: posts big blind $0.50
*** HOLE CARDS ***
bypIyrYcAAifLfhZpGlKLA: raises $1 to $1.50
Z4HwehErEwzsv/noQlfUlg: folds
bypIyrYcAAifLfhZpGlKLA collected $1 from pot
bypIyrYcAAifLfhZpGlKLA: doesn't show hand
*** SUMMARY ***
Total pot $1 | Rake $0
Seat 1: bypIyrYcAAifLfhZpGlKLA (button) (small blind) collected ($1)
Seat 2: Z4HwehErEwzsv/noQlfUlg (big blind) folded before Flop



PokerStars Game #59941572926:  Hold'em No Limit ($0.25/$0.50) - 2009/07/01 1:39:32 ET
Table '+z1aekfHkpp09pc8F9aViw' 6-max Seat #5 is the button
Seat 1: L0aIPg7qefDQjdJo3HCVEA ($11.50 in chips)
Seat 3: URYNc7fPA23K2UfadQbnCA ($61.65 in chips)
Seat 4: RowCSpSURHTOL/dcjg/Iug ($85.70 in chips)
Seat 5: 2igtJLmvIZ+HqX4XPgMPZA ($50 in chips)
Seat 6: GUnvMULl2qFOO1yenu1UBw ($51 in chips)
GUnvMULl2qFOO1yenu1UBw: posts small blind $0.25
L0aIPg7qefDQjdJo3HCVEA: posts big blind $0.50
*** HOLE CARDS ***
URYNc7fPA23K2UfadQbnCA: folds
RowCSpSURHTOL/dcjg/Iug: folds
2igtJLmvIZ+HqX4XPgMPZA: raises $1.50 to $2
GUnvMULl2qFOO1yenu1UBw: folds
L0aIPg7qefDQjdJo3HCVEA: folds
2igtJLmvIZ+HqX4XPgMPZA collected $1.25 from pot
*** SUMMARY ***
Total pot $1.25 | Rake $0
Seat 1: L0aIPg7qefDQjdJo3HCVEA (big blind) folded before Flop
Seat 3: URYNc7fPA23K2UfadQbnCA folded before Flop (didn't bet)
Seat 4: RowCSpSURHTOL/dcjg/Iug folded before Flop (didn't bet)
Seat 5: 2igtJLmvIZ+HqX4XPgMPZA (button) collected ($1.25)
Seat 6: GUnvMULl2qFOO1yenu1UBw (small blind) folded before Flop



PokerStars Game #59941573510:  Hold'em No Limit ($0.25/$0.50) - 2009/07/01 1:39:34 ET
Table 'Wwfm5/i+g/g2Nj2gT3jnVQ' 2-max Seat #2 is the button
Seat 1: CHRLZDaaxjbo68bwQD1C/Q ($4.85 in chips)
Seat 2: PKuuhUvIr5WSkJyPJa9dFw ($24.60 in chips)
PKuuhUvIr5WSkJyPJa9dFw: posts small blind $0.25
CHRLZDaaxjbo68bwQD1C/Q: posts big blind $0.50
*** HOLE CARDS ***
PKuuhUvIr5WSkJyPJa9dFw: folds
CHRLZDaaxjbo68bwQD1C/Q collected $0.50 from pot
CHRLZDaaxjbo68bwQD1C/Q: doesn't show hand
*** SUMMARY ***
Total pot $0.50 | Rake $0
Seat 1: CHRLZDaaxjbo68bwQD1C/Q (big blind) collected ($0.50)
Seat 2: PKuuhUvIr5WSkJyPJa9dFw (button) (small blind) folded before Flop



PokerStars Game #59941574018:  Hold'em No Limit ($0.25/$0.50) - 2009/07/01 1:39:34 ET
Table 'BCN5su+SsXiy1zRMJi0SJw' 6-max Seat #5 is the button
Seat 1: GxXV09ciXaOxyY2H5aMIIw ($29.25 in chips)
Seat 2: ehFNAevCQri3trWxV6FJdA ($92.10 in chips)
Seat 3: kwgv5lNhiFrfONXCshzxlA ($71.30 in chips)
Seat 4: bbsK8j+tpuVRhBqDzHxf7w ($49.85 in chips)
Seat 5: kxPhs4ePFqMy52CInAJ2aw ($49.75 in chips)
Seat 6: b2symlOdL7+0c9Pj4N/KlA ($77.35 in chips)
b2symlOdL7+0c9Pj4N/KlA: posts small blind $0.25
GxXV09ciXaOxyY2H5aMIIw: posts big blind $0.50
*** HOLE CARDS ***
ehFNAevCQri3trWxV6FJdA: calls $0.50
kwgv5lNhiFrfONXCshzxlA: folds
bbsK8j+tpuVRhBqDzHxf7w: folds
kxPhs4ePFqMy52CInAJ2aw: folds
b2symlOdL7+0c9Pj4N/KlA: folds
GxXV09ciXaOxyY2H5aMIIw: checks
*** FLOP *** [9c 7h 7s]
GxXV09ciXaOxyY2H5aMIIw: checks
ehFNAevCQri3trWxV6FJdA: checks
*** TURN *** [9c 7h 7s] [4c]
GxXV09ciXaOxyY2H5aMIIw: checks
ehFNAevCQri3trWxV6FJdA: checks
*** RIVER *** [9c 7h 7s 4c] [8c]
GxXV09ciXaOxyY2H5aMIIw: bets $1.50
ehFNAevCQri3trWxV6FJdA: raises $3.50 to $5
GxXV09ciXaOxyY2H5aMIIw: calls $3.50
*** SHOW DOWN ***
ehFNAevCQri3trWxV6FJdA: shows [4s 8s] (two pair, Eights and Sevens)
GxXV09ciXaOxyY2H5aMIIw: shows [6d Tc] (a straight, Six to Ten)
GxXV09ciXaOxyY2H5aMIIw collected $10.70 from pot
*** SUMMARY ***
Total pot $11.25 | Rake $0.55
Board [9c 7h 7s 4c 8c]
Seat 1: GxXV09ciXaOxyY2H5aMIIw (big blind) showed [6d Tc] and won ($10.70) with a straight, Six to Ten
Seat 2: ehFNAevCQri3trWxV6FJdA showed [4s 8s] and lost with two pair, Eights and Sevens
Seat 3: kwgv5lNhiFrfONXCshzxlA folded before Flop (didn't bet)
Seat 4: bbsK8j+tpuVRhBqDzHxf7w folded before Flop (didn't bet)
Seat 5: kxPhs4ePFqMy52CInAJ2aw (button) folded before Flop (didn't bet)
Seat 6: b2symlOdL7+0c9Pj4N/KlA (small blind) folded before Flop



PokerStars Game #59941574650:  Hold'em No Limit ($0.25/$0.50) - 2009/07/01 1:39:36 ET
Table '9ojijpRcYQSQTh6xI+haUA' 2-max Seat #2 is the button
Seat 1: FqpibuVWLNsAN/Z7ROZLnA ($54.15 in chips)
Seat 2: TitTV+fFCcBZWOERdytydA ($69.75 in chips)
TitTV+fFCcBZWOERdytydA: posts small blind $0.25
FqpibuVWLNsAN/Z7ROZLnA: posts big blind $0.50
*** HOLE CARDS ***
TitTV+fFCcBZWOERdytydA: raises $1 to $1.50
FqpibuVWLNsAN/Z7ROZLnA: raises $1 to $2.50
TitTV+fFCcBZWOERdytydA: raises $2 to $4.50
FqpibuVWLNsAN/Z7ROZLnA: calls $2
*** FLOP *** [8h 4s Jd]
FqpibuVWLNsAN/Z7ROZLnA: checks
TitTV+fFCcBZWOERdytydA: checks
*** TURN *** [8h 4s Jd] [2s]
FqpibuVWLNsAN/Z7ROZLnA: checks
TitTV+fFCcBZWOERdytydA: bets $3.50
FqpibuVWLNsAN/Z7ROZLnA: calls $3.50
*** RIVER *** [8h 4s Jd 2s] [9d]
FqpibuVWLNsAN/Z7ROZLnA: bets $4
TitTV+fFCcBZWOERdytydA: raises $11 to $15
FqpibuVWLNsAN/Z7ROZLnA: folds
TitTV+fFCcBZWOERdytydA collected $23.50 from pot
TitTV+fFCcBZWOERdytydA: doesn't show hand
*** SUMMARY ***
Total pot $24 | Rake $0.50
Board [8h 4s Jd 2s 9d]
Seat 1: FqpibuVWLNsAN/Z7ROZLnA (big blind) folded on the River
Seat 2: TitTV+fFCcBZWOERdytydA (button) (small blind) collected ($23.50)



PokerStars Game #59941575576:  Hold'em No Limit ($0.25/$0.50) - 2009/07/01 1:39:37 ET
Table '+dXkOAQyS8j9PQZusUTMpg' 2-max Seat #2 is the button
Seat 1: Teld4PDKla7C8/Wfu2DSkg ($56.60 in chips)
Seat 2: qjBVVp3quHGDRH0szgloKA ($8.75 in chips)
qjBVVp3quHGDRH0szgloKA: posts small blind $0.25
Teld4PDKla7C8/Wfu2DSkg: posts big blind $0.50
*** HOLE CARDS ***
qjBVVp3quHGDRH0szgloKA: raises $8.25 to $8.75 and is all-in
Teld4PDKla7C8/Wfu2DSkg: folds
qjBVVp3quHGDRH0szgloKA collected $1 from pot
qjBVVp3quHGDRH0szgloKA: doesn't show hand
*** SUMMARY ***
Total pot $1 | Rake $0
Seat 1: Teld4PDKla7C8/Wfu2DSkg (big blind) folded before Flop
Seat 2: qjBVVp3quHGDRH0szgloKA (button) (small blind) collected ($1)



PokerStars Game #59941576256:  Hold'em No Limit ($0.25/$0.50) - 2009/07/01 1:39:38 ET
Table '8BQGgNetI1NOvWeu3gtMNw' 2-max Seat #2 is the button
Seat 1: bypIyrYcAAifLfhZpGlKLA ($67.65 in chips)
Seat 2: Z4HwehErEwzsv/noQlfUlg ($145.60 in chips)
Z4HwehErEwzsv/noQlfUlg: posts small blind $0.25
bypIyrYcAAifLfhZpGlKLA: posts big blind $0.50
*** HOLE CARDS ***
Z4HwehErEwzsv/noQlfUlg: raises $2.50 to $3
bypIyrYcAAifLfhZpGlKLA: calls $2.50
*** FLOP *** [3d 5d 7d]
bypIyrYcAAifLfhZpGlKLA: checks
Z4HwehErEwzsv/noQlfUlg: checks
*** TURN *** [3d 5d 7d] [Ac]
bypIyrYcAAifLfhZpGlKLA: bets $3
Z4HwehErEwzsv/noQlfUlg: folds
bypIyrYcAAifLfhZpGlKLA collected $5.70 from pot
bypIyrYcAAifLfhZpGlKLA: doesn't show hand
*** SUMMARY ***
Total pot $6 | Rake $0.30
Board [3d 5d 7d Ac]
Seat 1: bypIyrYcAAifLfhZpGlKLA (big blind) collected ($5.70)
Seat 2: Z4HwehErEwzsv/noQlfUlg (button) (small blind) folded on the Turn



PokerStars Game #59941576274:  Hold'em No Limit ($0.25/$0.50) - 2009/07/01 1:39:38 ET
Table '3FhG0gl3kMX3wBEEqj+wnQ' 9-max Seat #8 is the button
Seat 1: bxLSulbgr8LmKNjOzw8URg ($49.45 in chips)
Seat 3: YXCE3WOZi8g2sIf3y/plVw ($61.55 in chips)
Seat 4: e2+sK/yjnj94rXOKoxPP2A ($68.75 in chips)
Seat 5: XcLXSUMHSpshK/7Lh0M4Vg ($11.05 in chips)
Seat 6: 997ViqAtWn1FPjJqcffwcA ($109.05 in chips)
Seat 7: mSD1pginDsyHG5PDfqzphw ($19.45 in chips)
Seat 8: j3K/Jujr7PY4ZM2RZvlH6A ($51.40 in chips)
Seat 9: KA0tkubTlbhmo4ju+qgXPg ($43.35 in chips)
KA0tkubTlbhmo4ju+qgXPg: posts small blind $0.25
bxLSulbgr8LmKNjOzw8URg: posts big blind $0.50
HZkVla4kK2SI42CVrPZ/ig: sits out
*** HOLE CARDS ***
YXCE3WOZi8g2sIf3y/plVw: folds
e2+sK/yjnj94rXOKoxPP2A: folds
XcLXSUMHSpshK/7Lh0M4Vg: folds
997ViqAtWn1FPjJqcffwcA: folds
mSD1pginDsyHG5PDfqzphw: folds
j3K/Jujr7PY4ZM2RZvlH6A: raises $1 to $1.50
KA0tkubTlbhmo4ju+qgXPg: folds
bxLSulbgr8LmKNjOzw8URg: folds
j3K/Jujr7PY4ZM2RZvlH6A collected $1.25 from pot
j3K/Jujr7PY4ZM2RZvlH6A: doesn't show hand
*** SUMMARY ***
Total pot $1.25 | Rake $0
Seat 1: bxLSulbgr8LmKNjOzw8URg (big blind) folded before Flop
Seat 3: YXCE3WOZi8g2sIf3y/plVw folded before Flop (didn't bet)
Seat 4: e2+sK/yjnj94rXOKoxPP2A folded before Flop (didn't bet)
Seat 5: XcLXSUMHSpshK/7Lh0M4Vg folded before Flop (didn't bet)
Seat 6: 997ViqAtWn1FPjJqcffwcA folded before Flop (didn't bet)
Seat 7: mSD1pginDsyHG5PDfqzphw folded before Flop (didn't bet)
Seat 8: j3K/Jujr7PY4ZM2RZvlH6A (button) collected ($1.25)
Seat 9: KA0tkubTlbhmo4ju+qgXPg (small blind) folded before Flop



PokerStars Game #59941576554:  Hold'em No Limit ($0.25/$0.50) - 2009/07/01 1:39:39 ET
Table 'Wwfm5/i+g/g2Nj2gT3jnVQ' 2-max Seat #1 is the button
Seat 1: CHRLZDaaxjbo68bwQD1C/Q ($5.10 in chips)
Seat 2: PKuuhUvIr5WSkJyPJa9dFw ($24.35 in chips)
CHRLZDaaxjbo68bwQD1C/Q: posts small blind $0.25
PKuuhUvIr5WSkJyPJa9dFw: posts big blind $0.50
*** HOLE CARDS ***
CHRLZDaaxjbo68bwQD1C/Q: calls $0.25
PKuuhUvIr5WSkJyPJa9dFw: checks
*** FLOP *** [5d 4d Qh]
PKuuhUvIr5WSkJyPJa9dFw: checks
CHRLZDaaxjbo68bwQD1C/Q: checks
*** TURN *** [5d 4d Qh] [4c]
PKuuhUvIr5WSkJyPJa9dFw: checks
CHRLZDaaxjbo68bwQD1C/Q: checks
*** RIVER *** [5d 4d Qh 4c] [Ks]
PKuuhUvIr5WSkJyPJa9dFw: checks
CHRLZDaaxjbo68bwQD1C/Q: checks
*** SHOW DOWN ***
PKuuhUvIr5WSkJyPJa9dFw: shows [Js Th] (a pair of Fours)
CHRLZDaaxjbo68bwQD1C/Q: shows [Qd Td] (two pair, Queens and Fours)
CHRLZDaaxjbo68bwQD1C/Q collected $0.95 from pot
*** SUMMARY ***
Total pot $1 | Rake $0.05
Board [5d 4d Qh 4c Ks]
Seat 1: CHRLZDaaxjbo68bwQD1C/Q (button) (small blind) showed [Qd Td] and won ($0.95) with two pair, Queens and Fours
Seat 2: PKuuhUvIr5WSkJyPJa9dFw (big blind) showed [Js Th] and lost with a pair of Fours



PokerStars Game #59941577168:  Hold'em No Limit ($0.25/$0.50) - 2009/07/01 1:39:40 ET
Table 'B+sqsfj6d6zXicNfaseTaw' 2-max Seat #1 is the button
Seat 1: +4GNcSsecmapVGSdV0mUPA ($147 in chips)
Seat 2: Lv5RmpRe6LtPkBzM9Gpo5A ($73.50 in chips)
+4GNcSsecmapVGSdV0mUPA: posts small blind $0.25
Lv5RmpRe6LtPkBzM9Gpo5A: posts big blind $0.50
*** HOLE CARDS ***
+4GNcSsecmapVGSdV0mUPA: raises $1.50 to $2
Lv5RmpRe6LtPkBzM9Gpo5A: calls $1.50
*** FLOP *** [Js Qc Td]
Lv5RmpRe6LtPkBzM9Gpo5A: checks
+4GNcSsecmapVGSdV0mUPA: checks
*** TURN *** [Js Qc Td] [6s]
Lv5RmpRe6LtPkBzM9Gpo5A: checks
+4GNcSsecmapVGSdV0mUPA: checks
*** RIVER *** [Js Qc Td 6s] [9c]
Lv5RmpRe6LtPkBzM9Gpo5A: checks
+4GNcSsecmapVGSdV0mUPA: checks
*** SHOW DOWN ***
Lv5RmpRe6LtPkBzM9Gpo5A: shows [6d Ts] (two pair, Tens and Sixes)
+4GNcSsecmapVGSdV0mUPA: mucks hand
Lv5RmpRe6LtPkBzM9Gpo5A collected $3.80 from pot
*** SUMMARY ***
Total pot $4 | Rake $0.20
Board [Js Qc Td 6s 9c]
Seat 1: +4GNcSsecmapVGSdV0mUPA (button) (small blind) mucked
Seat 2: Lv5RmpRe6LtPkBzM9Gpo5A (big blind) showed [6d Ts] and won ($3.80) with two pair, Tens and Sixes



PokerStars Game #59941577648:  Hold'em No Limit ($0.25/$0.50) - 2009/07/01 1:39:41 ET
Table 'b14oxfBMAjhXizfPVeTHng' 2-max Seat #1 is the button
Seat 1: NKw4WYm5uUoeEVf4i0fBvA ($11.70 in chips)
Seat 2: FeErMt4Gvt/3PH2oB/pn4A ($9.75 in chips)
NKw4WYm5uUoeEVf4i0fBvA: posts small blind $0.25
FeErMt4Gvt/3PH2oB/pn4A: posts big blind $0.50
*** HOLE CARDS ***
NKw4WYm5uUoeEVf4i0fBvA: raises $0.50 to $1
FeErMt4Gvt/3PH2oB/pn4A: calls $0.50
*** FLOP *** [Td 6c 2h]
FeErMt4Gvt/3PH2oB/pn4A: checks
NKw4WYm5uUoeEVf4i0fBvA: bets $10.70 and is all-in
FeErMt4Gvt/3PH2oB/pn4A: folds
FeErMt4Gvt/3PH2oB/pn4A said, "i'm fine"
FeErMt4Gvt/3PH2oB/pn4A said, "lol"
NKw4WYm5uUoeEVf4i0fBvA collected $1.90 from pot
FeErMt4Gvt/3PH2oB/pn4A said, "and u?"
*** SUMMARY ***
Total pot $2 | Rake $0.10
Board [Td 6c 2h]
Seat 1: NKw4WYm5uUoeEVf4i0fBvA (button) (small blind) collected ($1.90)
Seat 2: FeErMt4Gvt/3PH2oB/pn4A (big blind) folded on the Flop



PokerStars Game #59941577442:  Hold'em No Limit ($0.25/$0.50) - 2009/07/01 1:39:41 ET
Table 'hWT2kq66tnKEpD26cia6fQ' 2-max Seat #2 is the button
Seat 1: Ce3KNFP+ao7Da9NHb65raw ($19.20 in chips)
Seat 2: 16tvT7AYgZ2LgiGFcvFKQg ($54.25 in chips)
16tvT7AYgZ2LgiGFcvFKQg: posts small blind $0.25
Ce3KNFP+ao7Da9NHb65raw: posts big blind $0.50
*** HOLE CARDS ***
16tvT7AYgZ2LgiGFcvFKQg: calls $0.25
Ce3KNFP+ao7Da9NHb65raw: checks
*** FLOP *** [4h 9c As]
Ce3KNFP+ao7Da9NHb65raw: checks
16tvT7AYgZ2LgiGFcvFKQg: checks
*** TURN *** [4h 9c As] [4s]
Ce3KNFP+ao7Da9NHb65raw: checks
16tvT7AYgZ2LgiGFcvFKQg: checks
*** RIVER *** [4h 9c As 4s] [8s]
Ce3KNFP+ao7Da9NHb65raw: checks
16tvT7AYgZ2LgiGFcvFKQg: bets $2
Ce3KNFP+ao7Da9NHb65raw: folds
16tvT7AYgZ2LgiGFcvFKQg collected $0.95 from pot
*** SUMMARY ***
Total pot $1 | Rake $0.05
Board [4h 9c As 4s 8s]
Seat 1: Ce3KNFP+ao7Da9NHb65raw (big blind) folded on the River
Seat 2: 16tvT7AYgZ2LgiGFcvFKQg (button) (small blind) collected ($0.95)



PokerStars Game #59941578818:  Hold'em No Limit ($0.25/$0.50) - 2009/07/01 1:39:43 ET
Table 'kgbJRsxfv64KrErDRBAkcw' 6-max Seat #1 is the button
Seat 1: VamsyhlFzXGF6/ydo0BHeA ($4.75 in chips)
Seat 2: AdS8BJMOheS01zjCDfPMFg ($88.10 in chips)
Seat 3: c4MNIaIyPMOMxrgT8FT5nA ($156 in chips)
Seat 4: 2igtJLmvIZ+HqX4XPgMPZA ($112.50 in chips)
Seat 5: eUBBn2R56C1IQ6Cs/vitwg ($106 in chips)
Seat 6: 1b+2BbjMN8qhR1WPqdE9VQ ($50 in chips)
AdS8BJMOheS01zjCDfPMFg: posts small blind $0.25
c4MNIaIyPMOMxrgT8FT5nA: posts big blind $0.50
*** HOLE CARDS ***
2igtJLmvIZ+HqX4XPgMPZA: folds
eUBBn2R56C1IQ6Cs/vitwg: folds
1b+2BbjMN8qhR1WPqdE9VQ: folds
VamsyhlFzXGF6/ydo0BHeA: raises $4.25 to $4.75 and is all-in
AdS8BJMOheS01zjCDfPMFg: folds
c4MNIaIyPMOMxrgT8FT5nA: folds
VamsyhlFzXGF6/ydo0BHeA collected $1.25 from pot
VamsyhlFzXGF6/ydo0BHeA: doesn't show hand
*** SUMMARY ***
Total pot $1.25 | Rake $0
Seat 1: VamsyhlFzXGF6/ydo0BHeA (button) collected ($1.25)
Seat 2: AdS8BJMOheS01zjCDfPMFg (small blind) folded before Flop
Seat 3: c4MNIaIyPMOMxrgT8FT5nA (big blind) folded before Flop
Seat 4: 2igtJLmvIZ+HqX4XPgMPZA folded before Flop (didn't bet)
Seat 5: eUBBn2R56C1IQ6Cs/vitwg folded before Flop (didn't bet)
Seat 6: 1b+2BbjMN8qhR1WPqdE9VQ folded before Flop (didn't bet)



PokerStars Game #59941578684:  Hold'em No Limit ($0.25/$0.50) - 2009/07/01 1:39:43 ET
Table 'cofQFHU7jbJoFecLVBof/w' 6-max Seat #3 is the button
Seat 1: URYNc7fPA23K2UfadQbnCA ($50.95 in chips)
Seat 2: f89uTQr3ieGlusj2IAYAEg ($50 in chips)
Seat 3: v4ctePcLlQw0r8E0qJtjYw ($50.70 in chips)
Seat 4: 9XrTM0DuVxx1pjFAdSbD8A ($50.85 in chips)
Seat 5: QvwRlrpVqerRRF8eJm6dDw ($49.65 in chips)
Seat 6: 7+uQ0OOgCTbR4ltkSwyC0g ($159.05 in chips)
9XrTM0DuVxx1pjFAdSbD8A: posts small blind $0.25
QvwRlrpVqerRRF8eJm6dDw: posts big blind $0.50
*** HOLE CARDS ***
7+uQ0OOgCTbR4ltkSwyC0g: folds
URYNc7fPA23K2UfadQbnCA: folds
f89uTQr3ieGlusj2IAYAEg: raises $1 to $1.50
v4ctePcLlQw0r8E0qJtjYw: folds
9XrTM0DuVxx1pjFAdSbD8A: folds
QvwRlrpVqerRRF8eJm6dDw: calls $1
*** FLOP *** [Kh Qs 9h]
QvwRlrpVqerRRF8eJm6dDw: bets $2
f89uTQr3ieGlusj2IAYAEg: folds
QvwRlrpVqerRRF8eJm6dDw collected $3.10 from pot
*** SUMMARY ***
Total pot $3.25 | Rake $0.15
Board [Kh Qs 9h]
Seat 1: URYNc7fPA23K2UfadQbnCA folded before Flop (didn't bet)
Seat 2: f89uTQr3ieGlusj2IAYAEg folded on the Flop
Seat 3: v4ctePcLlQw0r8E0qJtjYw (button) folded before Flop (didn't bet)
Seat 4: 9XrTM0DuVxx1pjFAdSbD8A (small blind) folded before Flop
Seat 5: QvwRlrpVqerRRF8eJm6dDw (big blind) collected ($3.10)
Seat 6: 7+uQ0OOgCTbR4ltkSwyC0g folded before Flop (didn't bet)



PokerStars Game #59941580510:  Hold'em No Limit ($0.25/$0.50) - 2009/07/01 1:39:46 ET
Table '2lPOwetm4cfkZPbTmGPH/w' 2-max Seat #1 is the button
Seat 1: vUGdApqS8J/GJE2gaVWl1w ($9.55 in chips)
Seat 2: XFa6sBGjP2gxoIvxR3fZIg ($27.70 in chips)
vUGdApqS8J/GJE2gaVWl1w: posts small blind $0.25
XFa6sBGjP2gxoIvxR3fZIg: posts big blind $0.50
*** HOLE CARDS ***
vUGdApqS8J/GJE2gaVWl1w: folds
XFa6sBGjP2gxoIvxR3fZIg collected $0.50 from pot
XFa6sBGjP2gxoIvxR3fZIg: doesn't show hand
*** SUMMARY ***
Total pot $0.50 | Rake $0
Seat 1: vUGdApqS8J/GJE2gaVWl1w (button) (small blind) folded before Flop
Seat 2: XFa6sBGjP2gxoIvxR3fZIg (big blind) collected ($0.50)



PokerStars Game #59941583458:  Hold'em No Limit ($0.25/$0.50) - 2009/07/01 1:39:51 ET
Table '2lPOwetm4cfkZPbTmGPH/w' 2-max Seat #2 is the button
Seat 1: vUGdApqS8J/GJE2gaVWl1w ($9.30 in chips)
Seat 2: XFa6sBGjP2gxoIvxR3fZIg ($27.95 in chips)
XFa6sBGjP2gxoIvxR3fZIg: posts small blind $0.25
vUGdApqS8J/GJE2gaVWl1w: posts big blind $0.50
*** HOLE CARDS ***
XFa6sBGjP2gxoIvxR3fZIg: calls $0.25
vUGdApqS8J/GJE2gaVWl1w: checks
*** FLOP *** [Jd As 6h]
vUGdApqS8J/GJE2gaVWl1w: checks
XFa6sBGjP2gxoIvxR3fZIg: checks
*** TURN *** [Jd As 6h] [Ts]
vUGdApqS8J/GJE2gaVWl1w: bets $0.50
XFa6sBGjP2gxoIvxR3fZIg: calls $0.50
*** RIVER *** [Jd As 6h Ts] [4c]
vUGdApqS8J/GJE2gaVWl1w: checks
XFa6sBGjP2gxoIvxR3fZIg: checks
*** SHOW DOWN ***
vUGdApqS8J/GJE2gaVWl1w: shows [5h 6c] (a pair of Sixes)
XFa6sBGjP2gxoIvxR3fZIg: mucks hand
vUGdApqS8J/GJE2gaVWl1w collected $1.95 from pot
*** SUMMARY ***
Total pot $2 | Rake $0.05
Board [Jd As 6h Ts 4c]
Seat 1: vUGdApqS8J/GJE2gaVWl1w (big blind) showed [5h 6c] and won ($1.95) with a pair of Sixes
Seat 2: XFa6sBGjP2gxoIvxR3fZIg (button) (small blind) mucked



PokerStars Game #59941583494:  Hold'em No Limit ($0.25/$0.50) - 2009/07/01 1:39:51 ET
Table 'GfL/No5u5PoEnU39lP5pQg' 6-max Seat #2 is the button
Seat 2: uVwggSetzp7d+eVgowO3vg ($53.05 in chips)
Seat 3: 4pp9WxhGdbVbxCc9tlu0lw ($27.30 in chips)
Seat 4: ifQmgsYNFiAg/XvBOMBSfQ ($50 in chips)
Seat 5: M1KyQQvVPVuxqTAB8sR/zQ ($50.20 in chips)
Seat 6: kxPhs4ePFqMy52CInAJ2aw ($93.80 in chips)
4pp9WxhGdbVbxCc9tlu0lw: posts small blind $0.25
ifQmgsYNFiAg/XvBOMBSfQ: posts big blind $0.50
*** HOLE CARDS ***
M1KyQQvVPVuxqTAB8sR/zQ: raises $1 to $1.50
kxPhs4ePFqMy52CInAJ2aw: calls $1.50
uVwggSetzp7d+eVgowO3vg: folds
4pp9WxhGdbVbxCc9tlu0lw: folds
ifQmgsYNFiAg/XvBOMBSfQ: folds
*** FLOP *** [Qd 3h 7s]
M1KyQQvVPVuxqTAB8sR/zQ: bets $2.50
kxPhs4ePFqMy52CInAJ2aw: calls $2.50
*** TURN *** [Qd 3h 7s] [9c]
1WUCqNG+p+vfWRTXNu4ljw leaves the table
M1KyQQvVPVuxqTAB8sR/zQ: bets $5.50
kxPhs4ePFqMy52CInAJ2aw: raises $9.50 to $15
6qJZP2EKIgnEXJ3tMSBuew joins the table at seat #1
M1KyQQvVPVuxqTAB8sR/zQ: folds
kxPhs4ePFqMy52CInAJ2aw collected $18.80 from pot
kxPhs4ePFqMy52CInAJ2aw: doesn't show hand
*** SUMMARY ***
Total pot $19.75 | Rake $0.95
Board [Qd 3h 7s 9c]
Seat 2: uVwggSetzp7d+eVgowO3vg (button) folded before Flop (didn't bet)
Seat 3: 4pp9WxhGdbVbxCc9tlu0lw (small blind) folded before Flop
Seat 4: ifQmgsYNFiAg/XvBOMBSfQ (big blind) folded before Flop
Seat 5: M1KyQQvVPVuxqTAB8sR/zQ folded on the Turn
Seat 6: kxPhs4ePFqMy52CInAJ2aw collected ($18.80)



PokerStars Game #59941583928:  Hold'em No Limit ($0.25/$0.50) - 2009/07/01 1:39:52 ET
Table '1pi9mHyVuXF/uue+aPQc4w' 9-max Seat #2 is the button
Seat 1: M+D23GG26WXQ/2gyjREVOQ ($50.65 in chips)
Seat 2: vHYT5s323LpajBj+2c9zbQ ($22.90 in chips)
Seat 3: HZkVla4kK2SI42CVrPZ/ig ($8.25 in chips)
Seat 4: mSD1pginDsyHG5PDfqzphw ($14.80 in chips)
Seat 5: zE9cVigS2nW/Ljy4K4bUQA ($30.65 in chips)
Seat 6: 1xBtrSVBbgFH/viUWKqQeg ($49.25 in chips)
Seat 7: 61sfw5QTu62YYIt68OsdrA ($33.55 in chips)
Seat 8: g4k0NXISyLCqaSWZDBjfEg ($97.05 in chips)
Seat 9: Q/gZC63lfOMr7YhWKPCxoQ ($9.20 in chips)
HZkVla4kK2SI42CVrPZ/ig: posts small blind $0.25
mSD1pginDsyHG5PDfqzphw: posts big blind $0.50
*** HOLE CARDS ***
zE9cVigS2nW/Ljy4K4bUQA: folds
1xBtrSVBbgFH/viUWKqQeg: folds
61sfw5QTu62YYIt68OsdrA: folds
g4k0NXISyLCqaSWZDBjfEg: folds
Q/gZC63lfOMr7YhWKPCxoQ: folds
M+D23GG26WXQ/2gyjREVOQ: folds
vHYT5s323LpajBj+2c9zbQ: folds
HZkVla4kK2SI42CVrPZ/ig: raises $1 to $1.50
mSD1pginDsyHG5PDfqzphw: calls $1
*** FLOP *** [5h 6c 2d]
HZkVla4kK2SI42CVrPZ/ig: bets $1.50
mSD1pginDsyHG5PDfqzphw: folds
HZkVla4kK2SI42CVrPZ/ig collected $2.85 from pot
HZkVla4kK2SI42CVrPZ/ig: doesn't show hand
*** SUMMARY ***
Total pot $3 | Rake $0.15
Board [5h 6c 2d]
Seat 1: M+D23GG26WXQ/2gyjREVOQ folded before Flop (didn't bet)
Seat 2: vHYT5s323LpajBj+2c9zbQ (button) folded before Flop (didn't bet)
Seat 3: HZkVla4kK2SI42CVrPZ/ig (small blind) collected ($2.85)
Seat 4: mSD1pginDsyHG5PDfqzphw (big blind) folded on the Flop
Seat 5: zE9cVigS2nW/Ljy4K4bUQA folded before Flop (didn't bet)
Seat 6: 1xBtrSVBbgFH/viUWKqQeg folded before Flop (didn't bet)
Seat 7: 61sfw5QTu62YYIt68OsdrA folded before Flop (didn't bet)
Seat 8: g4k0NXISyLCqaSWZDBjfEg folded before Flop (didn't bet)
Seat 9: Q/gZC63lfOMr7YhWKPCxoQ folded before Flop (didn't bet)



PokerStars Game #59941584470:  Hold'em No Limit ($0.25/$0.50) - 2009/07/01 1:39:53 ET
Table 'Wwfm5/i+g/g2Nj2gT3jnVQ' 2-max Seat #2 is the button
Seat 1: CHRLZDaaxjbo68bwQD1C/Q ($5.55 in chips)
Seat 2: PKuuhUvIr5WSkJyPJa9dFw ($23.85 in chips)
PKuuhUvIr5WSkJyPJa9dFw: posts small blind $0.25
CHRLZDaaxjbo68bwQD1C/Q: posts big blind $0.50
*** HOLE CARDS ***
PKuuhUvIr5WSkJyPJa9dFw: calls $0.25
CHRLZDaaxjbo68bwQD1C/Q: raises $0.50 to $1
PKuuhUvIr5WSkJyPJa9dFw: calls $0.50
*** FLOP *** [Tc Td 3s]
CHRLZDaaxjbo68bwQD1C/Q: checks
PKuuhUvIr5WSkJyPJa9dFw: checks
*** TURN *** [Tc Td 3s] [Jc]
CHRLZDaaxjbo68bwQD1C/Q: checks
PKuuhUvIr5WSkJyPJa9dFw: checks
*** RIVER *** [Tc Td 3s Jc] [5h]
CHRLZDaaxjbo68bwQD1C/Q: bets $4.55 and is all-in
PKuuhUvIr5WSkJyPJa9dFw: folds
CHRLZDaaxjbo68bwQD1C/Q collected $1.90 from pot
CHRLZDaaxjbo68bwQD1C/Q: doesn't show hand
*** SUMMARY ***
Total pot $2 | Rake $0.10
Board [Tc Td 3s Jc 5h]
Seat 1: CHRLZDaaxjbo68bwQD1C/Q (big blind) collected ($1.90)
Seat 2: PKuuhUvIr5WSkJyPJa9dFw (button) (small blind) folded on the River



PokerStars Game #59941586334:  Hold'em No Limit ($0.25/$0.50) - 2009/07/01 1:39:56 ET
Table 'EiNh8p/wGJ1FP575iMFnqg' 9-max Seat #9 is the button
Seat 1: YFFlOZgyy1Mh4iBmuNRbmQ ($18.75 in chips)
Seat 2: GRV8J6o4lVSBDEyjt6BwMg ($29.50 in chips)
Seat 3: ymLPoEIl7UL3TvZYmnadxQ ($44.25 in chips)
Seat 4: cMzaiXAM/ZAdNaEUu+LqhA ($54.20 in chips)
Seat 5: M+7+BTmX5vZatHVuoRB1nA ($75.15 in chips)
Seat 6: bCRukyMhXa3jkgAkKFa4VQ ($10.30 in chips)
Seat 7: 997ViqAtWn1FPjJqcffwcA ($50 in chips)
Seat 8: mSD1pginDsyHG5PDfqzphw ($14.05 in chips)
Seat 9: GuPkZObrz5Zkkn8FsEdF9w ($33.85 in chips)
YFFlOZgyy1Mh4iBmuNRbmQ: posts small blind $0.25
GRV8J6o4lVSBDEyjt6BwMg: posts big blind $0.50
*** HOLE CARDS ***
ymLPoEIl7UL3TvZYmnadxQ: calls $0.50
cMzaiXAM/ZAdNaEUu+LqhA: folds
M+7+BTmX5vZatHVuoRB1nA: folds
bCRukyMhXa3jkgAkKFa4VQ: folds
997ViqAtWn1FPjJqcffwcA: folds
mSD1pginDsyHG5PDfqzphw: folds
GuPkZObrz5Zkkn8FsEdF9w: folds
YFFlOZgyy1Mh4iBmuNRbmQ: raises $1 to $1.50
GRV8J6o4lVSBDEyjt6BwMg: folds
ymLPoEIl7UL3TvZYmnadxQ: calls $1
*** FLOP *** [Kh 8d 5d]
YFFlOZgyy1Mh4iBmuNRbmQ: checks
ymLPoEIl7UL3TvZYmnadxQ: bets $3
YFFlOZgyy1Mh4iBmuNRbmQ: calls $3
*** TURN *** [Kh 8d 5d] [6d]
YFFlOZgyy1Mh4iBmuNRbmQ: checks
ymLPoEIl7UL3TvZYmnadxQ: checks
*** RIVER *** [Kh 8d 5d 6d] [6s]
YFFlOZgyy1Mh4iBmuNRbmQ: bets $4.50
ymLPoEIl7UL3TvZYmnadxQ: folds
YFFlOZgyy1Mh4iBmuNRbmQ collected $9.05 from pot
*** SUMMARY ***
Total pot $9.50 | Rake $0.45
Board [Kh 8d 5d 6d 6s]
Seat 1: YFFlOZgyy1Mh4iBmuNRbmQ (small blind) collected ($9.05)
Seat 2: GRV8J6o4lVSBDEyjt6BwMg (big blind) folded before Flop
Seat 3: ymLPoEIl7UL3TvZYmnadxQ folded on the River
Seat 4: cMzaiXAM/ZAdNaEUu+LqhA folded before Flop (didn't bet)
Seat 5: M+7+BTmX5vZatHVuoRB1nA folded before Flop (didn't bet)
Seat 6: bCRukyMhXa3jkgAkKFa4VQ folded before Flop (didn't bet)
Seat 7: 997ViqAtWn1FPjJqcffwcA folded before Flop (didn't bet)
Seat 8: mSD1pginDsyHG5PDfqzphw folded before Flop (didn't bet)
Seat 9: GuPkZObrz5Zkkn8FsEdF9w (button) folded before Flop (didn't bet)



PokerStars Game #59941587376:  Hold'em No Limit ($0.25/$0.50) - 2009/07/01 1:39:58 ET
Table 'b14oxfBMAjhXizfPVeTHng' 2-max Seat #2 is the button
Seat 1: NKw4WYm5uUoeEVf4i0fBvA ($12.60 in chips)
Seat 2: FeErMt4Gvt/3PH2oB/pn4A ($8.75 in chips)
FeErMt4Gvt/3PH2oB/pn4A: posts small blind $0.25
NKw4WYm5uUoeEVf4i0fBvA: posts big blind $0.50
*** HOLE CARDS ***
FeErMt4Gvt/3PH2oB/pn4A: raises $1 to $1.50
NKw4WYm5uUoeEVf4i0fBvA said, "good"
NKw4WYm5uUoeEVf4i0fBvA: calls $1
*** FLOP *** [Td Jc 5s]
FeErMt4Gvt/3PH2oB/pn4A said, "ur running good today?"
NKw4WYm5uUoeEVf4i0fBvA: bets $2
FeErMt4Gvt/3PH2oB/pn4A: calls $2
*** TURN *** [Td Jc 5s] [8c]
NKw4WYm5uUoeEVf4i0fBvA said, "pretty good"
NKw4WYm5uUoeEVf4i0fBvA: bets $1.50
FeErMt4Gvt/3PH2oB/pn4A said, "nice me to"
NKw4WYm5uUoeEVf4i0fBvA said, "how old r u?"
FeErMt4Gvt/3PH2oB/pn4A said, "i just won about 80$ in 15 min"
FeErMt4Gvt/3PH2oB/pn4A: calls $1.50
*** RIVER *** [Td Jc 5s 8c] [Ts]
NKw4WYm5uUoeEVf4i0fBvA said, "wow"
NKw4WYm5uUoeEVf4i0fBvA said, "dats good"
NKw4WYm5uUoeEVf4i0fBvA: bets $1
FeErMt4Gvt/3PH2oB/pn4A said, "ty"
FeErMt4Gvt/3PH2oB/pn4A: raises $2.75 to $3.75 and is all-in
NKw4WYm5uUoeEVf4i0fBvA: calls $2.75
*** SHOW DOWN ***
FeErMt4Gvt/3PH2oB/pn4A: shows [9s As] (a pair of Tens)
NKw4WYm5uUoeEVf4i0fBvA: shows [Jd Qd] (two pair, Jacks and Tens)
FeErMt4Gvt/3PH2oB/pn4A said, "n1"
NKw4WYm5uUoeEVf4i0fBvA collected $17 from pot
*** SUMMARY ***
Total pot $17.50 | Rake $0.50
Board [Td Jc 5s 8c Ts]
Seat 1: NKw4WYm5uUoeEVf4i0fBvA (big blind) showed [Jd Qd] and won ($17) with two pair, Jacks and Tens
Seat 2: FeErMt4Gvt/3PH2oB/pn4A (button) (small blind) showed [9s As] and lost with a pair of Tens



PokerStars Game #59941587030:  Hold'em No Limit ($0.25/$0.50) - 2009/07/01 1:39:58 ET
Table 'B+sqsfj6d6zXicNfaseTaw' 2-max Seat #2 is the button
Seat 1: +4GNcSsecmapVGSdV0mUPA ($145 in chips)
Seat 2: Lv5RmpRe6LtPkBzM9Gpo5A ($75.30 in chips)
Lv5RmpRe6LtPkBzM9Gpo5A: posts small blind $0.25
+4GNcSsecmapVGSdV0mUPA: posts big blind $0.50
*** HOLE CARDS ***
Lv5RmpRe6LtPkBzM9Gpo5A: raises $1 to $1.50
+4GNcSsecmapVGSdV0mUPA: calls $1
*** FLOP *** [9h 4s 3d]
+4GNcSsecmapVGSdV0mUPA: checks
Lv5RmpRe6LtPkBzM9Gpo5A: checks
*** TURN *** [9h 4s 3d] [Qh]
+4GNcSsecmapVGSdV0mUPA: bets $5
Lv5RmpRe6LtPkBzM9Gpo5A: folds
+4GNcSsecmapVGSdV0mUPA collected $2.85 from pot
+4GNcSsecmapVGSdV0mUPA: doesn't show hand
*** SUMMARY ***
Total pot $3 | Rake $0.15
Board [9h 4s 3d Qh]
Seat 1: +4GNcSsecmapVGSdV0mUPA (big blind) collected ($2.85)
Seat 2: Lv5RmpRe6LtPkBzM9Gpo5A (button) (small blind) folded on the Turn



PokerStars Game #59941587020:  Hold'em No Limit ($0.25/$0.50) - 2009/07/01 1:39:58 ET
Table 'otvGDROEDdqsabxskT79qg' 9-max Seat #9 is the button
Seat 1: M+D23GG26WXQ/2gyjREVOQ ($49.50 in chips)
Seat 2: 8pfDpjfHmTUlkgzpRPwQYQ ($23.35 in chips)
Seat 3: +k7T5ocke8UwavtgUHm+Cg ($90.85 in chips)
Seat 4: MG90wfSJZnOejs/KD3vlQQ ($81.35 in chips)
Seat 5: aaHXfJPbwwtrerPKvT348Q ($8.45 in chips)
Seat 6: FFVKBJT0lZf+jFlgvy7ang ($45.55 in chips)
Seat 8: zE9cVigS2nW/Ljy4K4bUQA ($32.25 in chips)
Seat 9: kuqESbpg/khtwiEKRXv2lg ($26.75 in chips)
M+D23GG26WXQ/2gyjREVOQ: posts small blind $0.25
8pfDpjfHmTUlkgzpRPwQYQ: posts big blind $0.50
*** HOLE CARDS ***
+k7T5ocke8UwavtgUHm+Cg: calls $0.50
MG90wfSJZnOejs/KD3vlQQ: folds
aaHXfJPbwwtrerPKvT348Q: folds
FFVKBJT0lZf+jFlgvy7ang: folds
zE9cVigS2nW/Ljy4K4bUQA: calls $0.50
kuqESbpg/khtwiEKRXv2lg: raises $0.50 to $1
M+D23GG26WXQ/2gyjREVOQ: folds
8pfDpjfHmTUlkgzpRPwQYQ: raises $2 to $3
+k7T5ocke8UwavtgUHm+Cg: folds
zE9cVigS2nW/Ljy4K4bUQA: folds
kuqESbpg/khtwiEKRXv2lg: calls $2
*** FLOP *** [7c 8c 2s]
8pfDpjfHmTUlkgzpRPwQYQ: bets $3
kuqESbpg/khtwiEKRXv2lg: folds
8pfDpjfHmTUlkgzpRPwQYQ collected $6.90 from pot
8pfDpjfHmTUlkgzpRPwQYQ: doesn't show hand
*** SUMMARY ***
Total pot $7.25 | Rake $0.35
Board [7c 8c 2s]
Seat 1: M+D23GG26WXQ/2gyjREVOQ (small blind) folded before Flop
Seat 2: 8pfDpjfHmTUlkgzpRPwQYQ (big blind) collected ($6.90)
Seat 3: +k7T5ocke8UwavtgUHm+Cg folded before Flop
Seat 4: MG90wfSJZnOejs/KD3vlQQ folded before Flop (didn't bet)
Seat 5: aaHXfJPbwwtrerPKvT348Q folded before Flop (didn't bet)
Seat 6: FFVKBJT0lZf+jFlgvy7ang folded before Flop (didn't bet)
Seat 8: zE9cVigS2nW/Ljy4K4bUQA folded before Flop
Seat 9: kuqESbpg/khtwiEKRXv2lg (button) folded on the Flop



PokerStars Game #59941588340:  Hold'em No Limit ($0.25/$0.50) - 2009/07/01 1:40:00 ET
Table '+z1aekfHkpp09pc8F9aViw' 6-max Seat #6 is the button
Seat 1: L0aIPg7qefDQjdJo3HCVEA ($11 in chips)
Seat 3: URYNc7fPA23K2UfadQbnCA ($61.65 in chips)
Seat 4: RowCSpSURHTOL/dcjg/Iug ($85.70 in chips)
Seat 5: 2igtJLmvIZ+HqX4XPgMPZA ($50.75 in chips)
Seat 6: GUnvMULl2qFOO1yenu1UBw ($50.75 in chips)
L0aIPg7qefDQjdJo3HCVEA: posts small blind $0.25
URYNc7fPA23K2UfadQbnCA: posts big blind $0.50
*** HOLE CARDS ***
RowCSpSURHTOL/dcjg/Iug: folds
2igtJLmvIZ+HqX4XPgMPZA: raises $1.50 to $2
GUnvMULl2qFOO1yenu1UBw: folds
L0aIPg7qefDQjdJo3HCVEA: folds
URYNc7fPA23K2UfadQbnCA: folds
2igtJLmvIZ+HqX4XPgMPZA collected $1.25 from pot
*** SUMMARY ***
Total pot $1.25 | Rake $0
Seat 1: L0aIPg7qefDQjdJo3HCVEA (small blind) folded before Flop
Seat 3: URYNc7fPA23K2UfadQbnCA (big blind) folded before Flop
Seat 4: RowCSpSURHTOL/dcjg/Iug folded before Flop (didn't bet)
Seat 5: 2igtJLmvIZ+HqX4XPgMPZA collected ($1.25)
Seat 6: GUnvMULl2qFOO1yenu1UBw (button) folded before Flop (didn't bet)



PokerStars Game #59941589178:  Hold'em No Limit ($0.25/$0.50) - 2009/07/01 1:40:01 ET
Table '3FhG0gl3kMX3wBEEqj+wnQ' 9-max Seat #9 is the button
Seat 1: bxLSulbgr8LmKNjOzw8URg ($50 in chips)
Seat 2: HZkVla4kK2SI42CVrPZ/ig ($10 in chips)
Seat 3: YXCE3WOZi8g2sIf3y/plVw ($61.55 in chips)
Seat 4: e2+sK/yjnj94rXOKoxPP2A ($68.75 in chips)
Seat 5: XcLXSUMHSpshK/7Lh0M4Vg ($11.05 in chips)
Seat 6: 997ViqAtWn1FPjJqcffwcA ($109.05 in chips)
Seat 7: mSD1pginDsyHG5PDfqzphw ($19.45 in chips)
Seat 8: j3K/Jujr7PY4ZM2RZvlH6A ($52.15 in chips)
Seat 9: KA0tkubTlbhmo4ju+qgXPg ($43.10 in chips)
bxLSulbgr8LmKNjOzw8URg: posts small blind $0.25
HZkVla4kK2SI42CVrPZ/ig: posts big blind $0.50
*** HOLE CARDS ***
YXCE3WOZi8g2sIf3y/plVw: folds
e2+sK/yjnj94rXOKoxPP2A: folds
XcLXSUMHSpshK/7Lh0M4Vg: folds
997ViqAtWn1FPjJqcffwcA: folds
mSD1pginDsyHG5PDfqzphw: folds
j3K/Jujr7PY4ZM2RZvlH6A: raises $2 to $2.50
KA0tkubTlbhmo4ju+qgXPg: folds
bxLSulbgr8LmKNjOzw8URg: folds
HZkVla4kK2SI42CVrPZ/ig: folds
j3K/Jujr7PY4ZM2RZvlH6A collected $1.25 from pot
j3K/Jujr7PY4ZM2RZvlH6A: doesn't show hand
*** SUMMARY ***
Total pot $1.25 | Rake $0
Seat 1: bxLSulbgr8LmKNjOzw8URg (small blind) folded before Flop
Seat 2: HZkVla4kK2SI42CVrPZ/ig (big blind) folded before Flop
Seat 3: YXCE3WOZi8g2sIf3y/plVw folded before Flop (didn't bet)
Seat 4: e2+sK/yjnj94rXOKoxPP2A folded before Flop (didn't bet)
Seat 5: XcLXSUMHSpshK/7Lh0M4Vg folded before Flop (didn't bet)
Seat 6: 997ViqAtWn1FPjJqcffwcA folded before Flop (didn't bet)
Seat 7: mSD1pginDsyHG5PDfqzphw folded before Flop (didn't bet)
Seat 8: j3K/Jujr7PY4ZM2RZvlH6A collected ($1.25)
Seat 9: KA0tkubTlbhmo4ju+qgXPg (button) folded before Flop (didn't bet)



PokerStars Game #59941588714:  Hold'em No Limit ($0.25/$0.50) - 2009/07/01 1:40:01 ET
Table 'hWT2kq66tnKEpD26cia6fQ' 2-max Seat #1 is the button
Seat 1: Ce3KNFP+ao7Da9NHb65raw ($18.70 in chips)
Seat 2: 16tvT7AYgZ2LgiGFcvFKQg ($54.70 in chips)
Ce3KNFP+ao7Da9NHb65raw: posts small blind $0.25
16tvT7AYgZ2LgiGFcvFKQg: posts big blind $0.50
*** HOLE CARDS ***
Ce3KNFP+ao7Da9NHb65raw: folds
16tvT7AYgZ2LgiGFcvFKQg collected $0.50 from pot
*** SUMMARY ***
Total pot $0.50 | Rake $0
Seat 1: Ce3KNFP+ao7Da9NHb65raw (button) (small blind) folded before Flop
Seat 2: 16tvT7AYgZ2LgiGFcvFKQg (big blind) collected ($0.50)



PokerStars Game #59941589296:  Hold'em No Limit ($0.25/$0.50) - 2009/07/01 1:40:02 ET
Table 'hSTs/dUsYLgJQuF2Onp0MQ' 6-max Seat #3 is the button
Seat 2: Hdd4js36ITbTJ/QuVYwTlA ($98.25 in chips)
Seat 3: lxIzoHy0RnkfFSODHC2liw ($50 in chips)
Seat 4: 2igtJLmvIZ+HqX4XPgMPZA ($50 in chips)
Seat 5: FsRQ5ECdlLkLYI5le8+PDQ ($50.35 in chips)
Seat 6: M1KyQQvVPVuxqTAB8sR/zQ ($104.95 in chips)
2igtJLmvIZ+HqX4XPgMPZA: posts small blind $0.25
FsRQ5ECdlLkLYI5le8+PDQ: posts big blind $0.50
*** HOLE CARDS ***
M1KyQQvVPVuxqTAB8sR/zQ: folds
Hdd4js36ITbTJ/QuVYwTlA: folds
Hdd4js36ITbTJ/QuVYwTlA leaves the table
lxIzoHy0RnkfFSODHC2liw: folds
vhWS+cwAJNd3JzqVzIjBZA joins the table at seat #2
1WUCqNG+p+vfWRTXNu4ljw leaves the table
2igtJLmvIZ+HqX4XPgMPZA: raises $1.50 to $2
FsRQ5ECdlLkLYI5le8+PDQ: folds
2igtJLmvIZ+HqX4XPgMPZA collected $1 from pot
*** SUMMARY ***
Total pot $1 | Rake $0
Seat 2: Hdd4js36ITbTJ/QuVYwTlA folded before Flop (didn't bet)
Seat 3: lxIzoHy0RnkfFSODHC2liw (button) folded before Flop (didn't bet)
Seat 4: 2igtJLmvIZ+HqX4XPgMPZA (small blind) collected ($1)
Seat 5: FsRQ5ECdlLkLYI5le8+PDQ (big blind) folded before Flop
Seat 6: M1KyQQvVPVuxqTAB8sR/zQ folded before Flop (didn't bet)



PokerStars Game #59941591314:  Hold'em No Limit ($0.25/$0.50) - 2009/07/01 1:40:05 ET
Table 'tyR5AZNKV8Aadbrnrnlg7g' 6-max Seat #6 is the button
Seat 1: BgOXYI0yYSN1ULC4FqsNkg ($76.30 in chips)
Seat 2: vhWS+cwAJNd3JzqVzIjBZA ($50 in chips)
Seat 3: JFLrYNyQmwPhRQAtoSAuyA ($60.85 in chips)
Seat 4: 4QfsCWthT/vSLirorNXqtg ($82.20 in chips)
Seat 5: GUnvMULl2qFOO1yenu1UBw ($75.60 in chips)
Seat 6: 498aWaGsW4uGfuWl+2FCGw ($85.20 in chips)
BgOXYI0yYSN1ULC4FqsNkg: posts small blind $0.25
vhWS+cwAJNd3JzqVzIjBZA: posts big blind $0.50
*** HOLE CARDS ***
JFLrYNyQmwPhRQAtoSAuyA: folds
4QfsCWthT/vSLirorNXqtg: folds
GUnvMULl2qFOO1yenu1UBw: raises $1 to $1.50
498aWaGsW4uGfuWl+2FCGw: folds
498aWaGsW4uGfuWl+2FCGw is sitting out
BgOXYI0yYSN1ULC4FqsNkg: folds
vhWS+cwAJNd3JzqVzIjBZA: folds
GUnvMULl2qFOO1yenu1UBw collected $1.25 from pot
GUnvMULl2qFOO1yenu1UBw: doesn't show hand
*** SUMMARY ***
Total pot $1.25 | Rake $0
Seat 1: BgOXYI0yYSN1ULC4FqsNkg (small blind) folded before Flop
Seat 2: vhWS+cwAJNd3JzqVzIjBZA (big blind) folded before Flop
Seat 3: JFLrYNyQmwPhRQAtoSAuyA folded before Flop (didn't bet)
Seat 4: 4QfsCWthT/vSLirorNXqtg folded before Flop (didn't bet)
Seat 5: GUnvMULl2qFOO1yenu1UBw collected ($1.25)
Seat 6: 498aWaGsW4uGfuWl+2FCGw (button) folded before Flop (didn't bet)



PokerStars Game #59941592060:  Hold'em No Limit ($0.25/$0.50) - 2009/07/01 1:40:07 ET
Table 'hWT2kq66tnKEpD26cia6fQ' 2-max Seat #2 is the button
Seat 1: Ce3KNFP+ao7Da9NHb65raw ($18.45 in chips)
Seat 2: 16tvT7AYgZ2LgiGFcvFKQg ($54.95 in chips)
16tvT7AYgZ2LgiGFcvFKQg: posts small blind $0.25
Ce3KNFP+ao7Da9NHb65raw: posts big blind $0.50
*** HOLE CARDS ***
16tvT7AYgZ2LgiGFcvFKQg: calls $0.25
Ce3KNFP+ao7Da9NHb65raw: raises $1 to $1.50
16tvT7AYgZ2LgiGFcvFKQg: calls $1
*** FLOP *** [5h 6s 8d]
Ce3KNFP+ao7Da9NHb65raw: bets $2
16tvT7AYgZ2LgiGFcvFKQg: calls $2
*** TURN *** [5h 6s 8d] [Ks]
Ce3KNFP+ao7Da9NHb65raw: bets $4
16tvT7AYgZ2LgiGFcvFKQg: calls $4
*** RIVER *** [5h 6s 8d Ks] [2c]
Ce3KNFP+ao7Da9NHb65raw: checks
16tvT7AYgZ2LgiGFcvFKQg: bets $4
Ce3KNFP+ao7Da9NHb65raw: calls $4
*** SHOW DOWN ***
16tvT7AYgZ2LgiGFcvFKQg: shows [Th 7h] (high card King)
Ce3KNFP+ao7Da9NHb65raw: shows [As 5c] (a pair of Fives)
Ce3KNFP+ao7Da9NHb65raw collected $22.50 from pot
*** SUMMARY ***
Total pot $23 | Rake $0.50
Board [5h 6s 8d Ks 2c]
Seat 1: Ce3KNFP+ao7Da9NHb65raw (big blind) showed [As 5c] and won ($22.50) with a pair of Fives
Seat 2: 16tvT7AYgZ2LgiGFcvFKQg (button) (small blind) showed [Th 7h] and lost with high card King



PokerStars Game #59941593340:  Hold'em No Limit ($0.25/$0.50) - 2009/07/01 1:40:09 ET
Table 'lSisgp6H7Fg1hH5VfjEjYQ' 9-max Seat #2 is the button
Seat 1: 5k9fvXD9suIgCxU4HLQjTw ($53.30 in chips)
Seat 2: 5acK4E7fzEwnplVBZ6eNWA ($50.95 in chips)
Seat 3: SKnJuWHScqetA/qG5p+wCg ($30 in chips)
Seat 4: FFVKBJT0lZf+jFlgvy7ang ($39 in chips)
Seat 5: mSD1pginDsyHG5PDfqzphw ($16.75 in chips)
Seat 6: +k7T5ocke8UwavtgUHm+Cg ($75.90 in chips)
Seat 7: IDtNLR9uFCDdjNsJWMHA5Q ($19.55 in chips)
Seat 8: a4JDWmpFQkL10XfAyuF51A ($10.45 in chips)
Seat 9: YzeKFbJVLmJGTgNH3ySQlw ($2.90 in chips)
SKnJuWHScqetA/qG5p+wCg: posts small blind $0.25
FFVKBJT0lZf+jFlgvy7ang: posts big blind $0.50
YzeKFbJVLmJGTgNH3ySQlw: posts small & big blinds $0.75
*** HOLE CARDS ***
mSD1pginDsyHG5PDfqzphw: folds
+k7T5ocke8UwavtgUHm+Cg: folds
IDtNLR9uFCDdjNsJWMHA5Q: calls $0.50
a4JDWmpFQkL10XfAyuF51A: folds
YzeKFbJVLmJGTgNH3ySQlw: raises $2.15 to $2.65 and is all-in
5k9fvXD9suIgCxU4HLQjTw: folds
5acK4E7fzEwnplVBZ6eNWA: folds
SKnJuWHScqetA/qG5p+wCg: folds
FFVKBJT0lZf+jFlgvy7ang: folds
IDtNLR9uFCDdjNsJWMHA5Q: calls $2.15
*** FLOP *** [Ks Jh 8s]
*** TURN *** [Ks Jh 8s] [Ah]
*** RIVER *** [Ks Jh 8s Ah] [7s]
*** SHOW DOWN ***
IDtNLR9uFCDdjNsJWMHA5Q: shows [4h 4c] (a pair of Fours)
YzeKFbJVLmJGTgNH3ySQlw: mucks hand
IDtNLR9uFCDdjNsJWMHA5Q collected $6 from pot
*** SUMMARY ***
Total pot $6.30 | Rake $0.30
Board [Ks Jh 8s Ah 7s]
Seat 1: 5k9fvXD9suIgCxU4HLQjTw folded before Flop (didn't bet)
Seat 2: 5acK4E7fzEwnplVBZ6eNWA (button) folded before Flop (didn't bet)
Seat 3: SKnJuWHScqetA/qG5p+wCg (small blind) folded before Flop
Seat 4: FFVKBJT0lZf+jFlgvy7ang (big blind) folded before Flop
Seat 5: mSD1pginDsyHG5PDfqzphw folded before Flop (didn't bet)
Seat 6: +k7T5ocke8UwavtgUHm+Cg folded before Flop (didn't bet)
Seat 7: IDtNLR9uFCDdjNsJWMHA5Q showed [4h 4c] and won ($6) with a pair of Fours
Seat 8: a4JDWmpFQkL10XfAyuF51A folded before Flop (didn't bet)
Seat 9: YzeKFbJVLmJGTgNH3ySQlw mucked



PokerStars Game #59941594626:  Hold'em No Limit ($0.25/$0.50) - 2009/07/01 1:40:11 ET
Table '8BQGgNetI1NOvWeu3gtMNw' 2-max Seat #1 is the button
Seat 1: bypIyrYcAAifLfhZpGlKLA ($70.35 in chips)
Seat 2: Z4HwehErEwzsv/noQlfUlg ($142.60 in chips)
bypIyrYcAAifLfhZpGlKLA: posts small blind $0.25
Z4HwehErEwzsv/noQlfUlg: posts big blind $0.50
*** HOLE CARDS ***
bypIyrYcAAifLfhZpGlKLA: folds
Z4HwehErEwzsv/noQlfUlg collected $0.50 from pot
*** SUMMARY ***
Total pot $0.50 | Rake $0
Seat 1: bypIyrYcAAifLfhZpGlKLA (button) (small blind) folded before Flop
Seat 2: Z4HwehErEwzsv/noQlfUlg (big blind) collected ($0.50)



PokerStars Game #59941595006:  Hold'em No Limit ($0.25/$0.50) - 2009/07/01 1:40:12 ET
Table '2lPOwetm4cfkZPbTmGPH/w' 2-max Seat #1 is the button
Seat 1: vUGdApqS8J/GJE2gaVWl1w ($10.25 in chips)
Seat 2: XFa6sBGjP2gxoIvxR3fZIg ($26.95 in chips)
vUGdApqS8J/GJE2gaVWl1w: posts small blind $0.25
XFa6sBGjP2gxoIvxR3fZIg: posts big blind $0.50
*** HOLE CARDS ***
vUGdApqS8J/GJE2gaVWl1w: calls $0.25
XFa6sBGjP2gxoIvxR3fZIg: checks
*** FLOP *** [7h Kc Ah]
XFa6sBGjP2gxoIvxR3fZIg: checks
vUGdApqS8J/GJE2gaVWl1w: bets $1
XFa6sBGjP2gxoIvxR3fZIg: folds
vUGdApqS8J/GJE2gaVWl1w collected $0.95 from pot
*** SUMMARY ***
Total pot $1 | Rake $0.05
Board [7h Kc Ah]
Seat 1: vUGdApqS8J/GJE2gaVWl1w (button) (small blind) collected ($0.95)
Seat 2: XFa6sBGjP2gxoIvxR3fZIg (big blind) folded on the Flop



PokerStars Game #59941596878:  Hold'em No Limit ($0.25/$0.50) - 2009/07/01 1:40:16 ET
Table 'B+sqsfj6d6zXicNfaseTaw' 2-max Seat #1 is the button
Seat 1: +4GNcSsecmapVGSdV0mUPA ($146.35 in chips)
Seat 2: Lv5RmpRe6LtPkBzM9Gpo5A ($73.80 in chips)
+4GNcSsecmapVGSdV0mUPA: posts small blind $0.25
Lv5RmpRe6LtPkBzM9Gpo5A: posts big blind $0.50
*** HOLE CARDS ***
+4GNcSsecmapVGSdV0mUPA: folds
Lv5RmpRe6LtPkBzM9Gpo5A collected $0.50 from pot
*** SUMMARY ***
Total pot $0.50 | Rake $0
Seat 1: +4GNcSsecmapVGSdV0mUPA (button) (small blind) folded before Flop
Seat 2: Lv5RmpRe6LtPkBzM9Gpo5A (big blind) collected ($0.50)



PokerStars Game #59941596884:  Hold'em No Limit ($0.25/$0.50) - 2009/07/01 1:40:16 ET
Table 'ZYI3ZReBjdfKEYItkZHI6A' 9-max Seat #5 is the button
Seat 1: IYd5zG8k7vdBNVHbHg2Pag ($60.40 in chips)
Seat 2: 5acK4E7fzEwnplVBZ6eNWA ($50 in chips)
Seat 3: 75K2MXwN65Sjfp1yHd50Hg ($8.50 in chips)
Seat 4: /UdtxmXsFx6K/14AbHqzbQ ($11.75 in chips)
Seat 5: ApHP7ouup365XIUFBdEDxg ($15.25 in chips)
Seat 6: 1xBtrSVBbgFH/viUWKqQeg ($37.25 in chips)
Seat 8: ji04uOybxCdpdefzlUQeKQ ($29.55 in chips)
Seat 9: HZkVla4kK2SI42CVrPZ/ig ($10.40 in chips)
1xBtrSVBbgFH/viUWKqQeg: posts small blind $0.25
ji04uOybxCdpdefzlUQeKQ: posts big blind $0.50
*** HOLE CARDS ***
HZkVla4kK2SI42CVrPZ/ig: folds
IYd5zG8k7vdBNVHbHg2Pag: folds
5acK4E7fzEwnplVBZ6eNWA: folds
75K2MXwN65Sjfp1yHd50Hg: folds
/UdtxmXsFx6K/14AbHqzbQ: raises $1 to $1.50
ApHP7ouup365XIUFBdEDxg: calls $1.50
1xBtrSVBbgFH/viUWKqQeg: folds
ji04uOybxCdpdefzlUQeKQ: folds
*** FLOP *** [Jd 6s 2d]
/UdtxmXsFx6K/14AbHqzbQ: bets $2.50
ApHP7ouup365XIUFBdEDxg: raises $11.25 to $13.75 and is all-in
/UdtxmXsFx6K/14AbHqzbQ: folds
ApHP7ouup365XIUFBdEDxg collected $8.35 from pot
ApHP7ouup365XIUFBdEDxg: shows [2c 5c] (a pair of Deuces)
*** SUMMARY ***
Total pot $8.75 | Rake $0.40
Board [Jd 6s 2d]
Seat 1: IYd5zG8k7vdBNVHbHg2Pag folded before Flop (didn't bet)
Seat 2: 5acK4E7fzEwnplVBZ6eNWA folded before Flop (didn't bet)
Seat 3: 75K2MXwN65Sjfp1yHd50Hg folded before Flop (didn't bet)
Seat 4: /UdtxmXsFx6K/14AbHqzbQ folded on the Flop
Seat 5: ApHP7ouup365XIUFBdEDxg (button) collected ($8.35)
Seat 6: 1xBtrSVBbgFH/viUWKqQeg (small blind) folded before Flop
Seat 8: ji04uOybxCdpdefzlUQeKQ (big blind) folded before Flop
Seat 9: HZkVla4kK2SI42CVrPZ/ig folded before Flop (didn't bet)



PokerStars Game #59941598146:  Hold'em No Limit ($0.25/$0.50) - 2009/07/01 1:40:18 ET
Table '8BQGgNetI1NOvWeu3gtMNw' 2-max Seat #2 is the button
Seat 1: bypIyrYcAAifLfhZpGlKLA ($70.10 in chips)
Seat 2: Z4HwehErEwzsv/noQlfUlg ($142.85 in chips)
Z4HwehErEwzsv/noQlfUlg: posts small blind $0.25
bypIyrYcAAifLfhZpGlKLA: posts big blind $0.50
*** HOLE CARDS ***
Z4HwehErEwzsv/noQlfUlg: folds
bypIyrYcAAifLfhZpGlKLA collected $0.50 from pot
bypIyrYcAAifLfhZpGlKLA: doesn't show hand
*** SUMMARY ***
Total pot $0.50 | Rake $0
Seat 1: bypIyrYcAAifLfhZpGlKLA (big blind) collected ($0.50)
Seat 2: Z4HwehErEwzsv/noQlfUlg (button) (small blind) folded before Flop



PokerStars Game #59941598880:  Hold'em No Limit ($0.25/$0.50) - 2009/07/01 1:40:19 ET
Table 'Nz0Vr7WMHL2g5Uk7dDZjpw' 9-max Seat #1 is the button
Seat 1: 9yMsdgReyOUerNsmTYCCDQ ($8.25 in chips)
Seat 2: SegjDnMxWMujiD57ESNL+g ($19.85 in chips)
Seat 3: c638Xxo+q5F/t5qMtmvmvQ ($51.40 in chips)
Seat 4: uw9QayAAxLM3Hb+HR7mSkg ($9.25 in chips)
Seat 5: WGW0DgjBUXs1ylURHG8vnQ ($13.55 in chips)
Seat 6: 997ViqAtWn1FPjJqcffwcA ($53.75 in chips)
Seat 7: KPLH0gELgFe2OuAnhJFI5w ($28.45 in chips)
Seat 8: aoL+R/61Kxmw69ypuPrWAQ ($26.25 in chips)
Seat 9: mSD1pginDsyHG5PDfqzphw ($16.50 in chips)
SegjDnMxWMujiD57ESNL+g: posts small blind $0.25
c638Xxo+q5F/t5qMtmvmvQ: posts big blind $0.50
*** HOLE CARDS ***
uw9QayAAxLM3Hb+HR7mSkg: folds
WGW0DgjBUXs1ylURHG8vnQ: calls $0.50
997ViqAtWn1FPjJqcffwcA: folds
KPLH0gELgFe2OuAnhJFI5w: calls $0.50
aoL+R/61Kxmw69ypuPrWAQ: folds
mSD1pginDsyHG5PDfqzphw: folds
9yMsdgReyOUerNsmTYCCDQ: folds
SegjDnMxWMujiD57ESNL+g: folds
c638Xxo+q5F/t5qMtmvmvQ: checks
*** FLOP *** [Js 7d Tc]
c638Xxo+q5F/t5qMtmvmvQ: checks
WGW0DgjBUXs1ylURHG8vnQ: bets $0.50
KPLH0gELgFe2OuAnhJFI5w: folds
c638Xxo+q5F/t5qMtmvmvQ: folds
WGW0DgjBUXs1ylURHG8vnQ collected $1.70 from pot
WGW0DgjBUXs1ylURHG8vnQ: doesn't show hand
*** SUMMARY ***
Total pot $1.75 | Rake $0.05
Board [Js 7d Tc]
Seat 1: 9yMsdgReyOUerNsmTYCCDQ (button) folded before Flop (didn't bet)
Seat 2: SegjDnMxWMujiD57ESNL+g (small blind) folded before Flop
Seat 3: c638Xxo+q5F/t5qMtmvmvQ (big blind) folded on the Flop
Seat 4: uw9QayAAxLM3Hb+HR7mSkg folded before Flop (didn't bet)
Seat 5: WGW0DgjBUXs1ylURHG8vnQ collected ($1.70)
Seat 6: 997ViqAtWn1FPjJqcffwcA folded before Flop (didn't bet)
Seat 7: KPLH0gELgFe2OuAnhJFI5w folded on the Flop
Seat 8: aoL+R/61Kxmw69ypuPrWAQ folded before Flop (didn't bet)
Seat 9: mSD1pginDsyHG5PDfqzphw folded before Flop (didn't bet)



PokerStars Game #59941599030:  Hold'em No Limit ($0.25/$0.50) - 2009/07/01 1:40:19 ET
Table '5qf8oPyYje71HBKD0FwPgQ' 9-max Seat #8 is the button
Seat 1: gsyXT42WLEcOS4DdEk2wlw ($30 in chips)
Seat 2: M+7+BTmX5vZatHVuoRB1nA ($53.15 in chips)
Seat 3: vacmVLJJECYI6HjAynFcpg ($51.20 in chips)
Seat 4: YXCE3WOZi8g2sIf3y/plVw ($57.75 in chips)
Seat 5: uo2Sgpknd7NdeVbeSCG02A ($14.20 in chips)
Seat 6: go0Ad6tqqJ4tR9/bqVlO0g ($26.20 in chips)
Seat 7: 1q5EPoiflJRl8pqfnVLjMw ($57.50 in chips)
Seat 8: sakr/FIfFtIZwDPmAj5Pzg ($58.35 in chips)
Seat 9: jWDRpL0TJljg+mBCE9ZMqA ($10 in chips)
jWDRpL0TJljg+mBCE9ZMqA: posts small blind $0.25
gsyXT42WLEcOS4DdEk2wlw: posts big blind $0.50
*** HOLE CARDS ***
M+7+BTmX5vZatHVuoRB1nA: raises $1 to $1.50
vacmVLJJECYI6HjAynFcpg: folds
YXCE3WOZi8g2sIf3y/plVw: folds
uo2Sgpknd7NdeVbeSCG02A: folds
go0Ad6tqqJ4tR9/bqVlO0g: folds
1q5EPoiflJRl8pqfnVLjMw: folds
sakr/FIfFtIZwDPmAj5Pzg: calls $1.50
jWDRpL0TJljg+mBCE9ZMqA: folds
gsyXT42WLEcOS4DdEk2wlw: folds
*** FLOP *** [Th 9d Td]
M+7+BTmX5vZatHVuoRB1nA: checks
sakr/FIfFtIZwDPmAj5Pzg: checks
*** TURN *** [Th 9d Td] [Kd]
M+7+BTmX5vZatHVuoRB1nA: bets $1.50
sakr/FIfFtIZwDPmAj5Pzg: folds
M+7+BTmX5vZatHVuoRB1nA collected $3.60 from pot
M+7+BTmX5vZatHVuoRB1nA: doesn't show hand
*** SUMMARY ***
Total pot $3.75 | Rake $0.15
Board [Th 9d Td Kd]
Seat 1: gsyXT42WLEcOS4DdEk2wlw (big blind) folded before Flop
Seat 2: M+7+BTmX5vZatHVuoRB1nA collected ($3.60)
Seat 3: vacmVLJJECYI6HjAynFcpg folded before Flop (didn't bet)
Seat 4: YXCE3WOZi8g2sIf3y/plVw folded before Flop (didn't bet)
Seat 5: uo2Sgpknd7NdeVbeSCG02A folded before Flop (didn't bet)
Seat 6: go0Ad6tqqJ4tR9/bqVlO0g folded before Flop (didn't bet)
Seat 7: 1q5EPoiflJRl8pqfnVLjMw folded before Flop (didn't bet)
Seat 8: sakr/FIfFtIZwDPmAj5Pzg (button) folded on the Turn
Seat 9: jWDRpL0TJljg+mBCE9ZMqA (small blind) folded before Flop



PokerStars Game #59941599304:  Hold'em No Limit ($0.25/$0.50) - 2009/07/01 1:40:20 ET
Table '9ojijpRcYQSQTh6xI+haUA' 2-max Seat #1 is the button
Seat 1: FqpibuVWLNsAN/Z7ROZLnA ($42.15 in chips)
Seat 2: TitTV+fFCcBZWOERdytydA ($81.25 in chips)
FqpibuVWLNsAN/Z7ROZLnA: posts small blind $0.25
TitTV+fFCcBZWOERdytydA: posts big blind $0.50
*** HOLE CARDS ***
FqpibuVWLNsAN/Z7ROZLnA: calls $0.25
TitTV+fFCcBZWOERdytydA: checks
*** FLOP *** [Ah 2d Ts]
TitTV+fFCcBZWOERdytydA: checks
FqpibuVWLNsAN/Z7ROZLnA: checks
*** TURN *** [Ah 2d Ts] [Kh]
TitTV+fFCcBZWOERdytydA: checks
FqpibuVWLNsAN/Z7ROZLnA: bets $1
TitTV+fFCcBZWOERdytydA: folds
FqpibuVWLNsAN/Z7ROZLnA collected $0.95 from pot
*** SUMMARY ***
Total pot $1 | Rake $0.05
Board [Ah 2d Ts Kh]
Seat 1: FqpibuVWLNsAN/Z7ROZLnA (button) (small blind) collected ($0.95)
Seat 2: TitTV+fFCcBZWOERdytydA (big blind) folded on the Turn



PokerStars Game #59941599802:  Hold'em No Limit ($0.25/$0.50) - 2009/07/01 1:40:21 ET
Table 'BCN5su+SsXiy1zRMJi0SJw' 6-max Seat #6 is the button
Seat 1: GxXV09ciXaOxyY2H5aMIIw ($34.45 in chips)
Seat 2: ehFNAevCQri3trWxV6FJdA ($86.60 in chips)
Seat 3: kwgv5lNhiFrfONXCshzxlA ($71.30 in chips)
Seat 4: bbsK8j+tpuVRhBqDzHxf7w ($49.85 in chips)
Seat 5: kxPhs4ePFqMy52CInAJ2aw ($49.75 in chips)
Seat 6: b2symlOdL7+0c9Pj4N/KlA ($77.10 in chips)
GxXV09ciXaOxyY2H5aMIIw: posts small blind $0.25
ehFNAevCQri3trWxV6FJdA: posts big blind $0.50
*** HOLE CARDS ***
kwgv5lNhiFrfONXCshzxlA: folds
bbsK8j+tpuVRhBqDzHxf7w: folds
kxPhs4ePFqMy52CInAJ2aw: folds
b2symlOdL7+0c9Pj4N/KlA: raises $1 to $1.50
GxXV09ciXaOxyY2H5aMIIw: folds
ehFNAevCQri3trWxV6FJdA: calls $1
*** FLOP *** [8h 4h Js]
ehFNAevCQri3trWxV6FJdA: checks
b2symlOdL7+0c9Pj4N/KlA: checks
*** TURN *** [8h 4h Js] [Kc]
ehFNAevCQri3trWxV6FJdA: checks
b2symlOdL7+0c9Pj4N/KlA: bets $2.50
ehFNAevCQri3trWxV6FJdA: folds
b2symlOdL7+0c9Pj4N/KlA collected $3.10 from pot
b2symlOdL7+0c9Pj4N/KlA: doesn't show hand
*** SUMMARY ***
Total pot $3.25 | Rake $0.15
Board [8h 4h Js Kc]
Seat 1: GxXV09ciXaOxyY2H5aMIIw (small blind) folded before Flop
Seat 2: ehFNAevCQri3trWxV6FJdA (big blind) folded on the Turn
Seat 3: kwgv5lNhiFrfONXCshzxlA folded before Flop (didn't bet)
Seat 4: bbsK8j+tpuVRhBqDzHxf7w folded before Flop (didn't bet)
Seat 5: kxPhs4ePFqMy52CInAJ2aw folded before Flop (didn't bet)
Seat 6: b2symlOdL7+0c9Pj4N/KlA (button) collected ($3.10)



PokerStars Game #59941600120:  Hold'em No Limit ($0.25/$0.50) - 2009/07/01 1:40:21 ET
Table 'cofQFHU7jbJoFecLVBof/w' 6-max Seat #4 is the button
Seat 1: URYNc7fPA23K2UfadQbnCA ($50.95 in chips)
Seat 2: f89uTQr3ieGlusj2IAYAEg ($50 in chips)
Seat 3: v4ctePcLlQw0r8E0qJtjYw ($50.70 in chips)
Seat 4: 9XrTM0DuVxx1pjFAdSbD8A ($50.60 in chips)
Seat 5: QvwRlrpVqerRRF8eJm6dDw ($51.25 in chips)
Seat 6: 7+uQ0OOgCTbR4ltkSwyC0g ($159.05 in chips)
QvwRlrpVqerRRF8eJm6dDw: posts small blind $0.25
7+uQ0OOgCTbR4ltkSwyC0g: posts big blind $0.50
*** HOLE CARDS ***
URYNc7fPA23K2UfadQbnCA: folds
f89uTQr3ieGlusj2IAYAEg: folds
v4ctePcLlQw0r8E0qJtjYw: raises $1 to $1.50
9XrTM0DuVxx1pjFAdSbD8A: folds
QvwRlrpVqerRRF8eJm6dDw: folds
7+uQ0OOgCTbR4ltkSwyC0g: folds
v4ctePcLlQw0r8E0qJtjYw collected $1.25 from pot
v4ctePcLlQw0r8E0qJtjYw: doesn't show hand
*** SUMMARY ***
Total pot $1.25 | Rake $0
Seat 1: URYNc7fPA23K2UfadQbnCA folded before Flop (didn't bet)
Seat 2: f89uTQr3ieGlusj2IAYAEg folded before Flop (didn't bet)
Seat 3: v4ctePcLlQw0r8E0qJtjYw collected ($1.25)
Seat 4: 9XrTM0DuVxx1pjFAdSbD8A (button) folded before Flop (didn't bet)
Seat 5: QvwRlrpVqerRRF8eJm6dDw (small blind) folded before Flop
Seat 6: 7+uQ0OOgCTbR4ltkSwyC0g (big blind) folded before Flop



PokerStars Game #59941600262:  Hold'em No Limit ($0.25/$0.50) - 2009/07/01 1:40:22 ET
Table 'B+sqsfj6d6zXicNfaseTaw' 2-max Seat #2 is the button
Seat 1: +4GNcSsecmapVGSdV0mUPA ($146.10 in chips)
Seat 2: Lv5RmpRe6LtPkBzM9Gpo5A ($74.05 in chips)
Lv5RmpRe6LtPkBzM9Gpo5A: posts small blind $0.25
+4GNcSsecmapVGSdV0mUPA: posts big blind $0.50
*** HOLE CARDS ***
Lv5RmpRe6LtPkBzM9Gpo5A: calls $0.25
+4GNcSsecmapVGSdV0mUPA: checks
*** FLOP *** [7h 7c 6h]
+4GNcSsecmapVGSdV0mUPA: checks
Lv5RmpRe6LtPkBzM9Gpo5A: checks
*** TURN *** [7h 7c 6h] [6c]
+4GNcSsecmapVGSdV0mUPA: checks
Lv5RmpRe6LtPkBzM9Gpo5A: checks
*** RIVER *** [7h 7c 6h 6c] [Ts]
+4GNcSsecmapVGSdV0mUPA: checks
Lv5RmpRe6LtPkBzM9Gpo5A: checks
*** SHOW DOWN ***
+4GNcSsecmapVGSdV0mUPA: shows [Qs 8s] (two pair, Sevens and Sixes)
Lv5RmpRe6LtPkBzM9Gpo5A: mucks hand
+4GNcSsecmapVGSdV0mUPA collected $0.95 from pot
*** SUMMARY ***
Total pot $1 | Rake $0.05
Board [7h 7c 6h 6c Ts]
Seat 1: +4GNcSsecmapVGSdV0mUPA (big blind) showed [Qs 8s] and won ($0.95) with two pair, Sevens and Sixes
Seat 2: Lv5RmpRe6LtPkBzM9Gpo5A (button) (small blind) mucked



PokerStars Game #59941600960:  Hold'em No Limit ($0.25/$0.50) - 2009/07/01 1:40:23 ET
Table '5EmHi+fnatGQQShcNmzOZQ' 6-max Seat #1 is the button
Seat 1: avNOJXWxD1+SygFmWsd+qw ($66.60 in chips)
Seat 2: OZ6OtYh5Y53MCH/p0QTn5g ($50 in chips)
Seat 3: QmH/ZFyxZfvliy57YM9yxw ($81.30 in chips)
Seat 4: 1b+2BbjMN8qhR1WPqdE9VQ ($51.05 in chips)
Seat 5: 6yWjZXHP6iAyMEDF6pJlng ($55.30 in chips)
Seat 6: u3Ol7kv1LmvszuHNm9rc6w ($5.10 in chips)
OZ6OtYh5Y53MCH/p0QTn5g: posts small blind $0.25
QmH/ZFyxZfvliy57YM9yxw: posts big blind $0.50
*** HOLE CARDS ***
1b+2BbjMN8qhR1WPqdE9VQ: folds
6yWjZXHP6iAyMEDF6pJlng: raises $1 to $1.50
u3Ol7kv1LmvszuHNm9rc6w: folds
avNOJXWxD1+SygFmWsd+qw: folds
OZ6OtYh5Y53MCH/p0QTn5g: folds
QmH/ZFyxZfvliy57YM9yxw: folds
6yWjZXHP6iAyMEDF6pJlng collected $1.25 from pot
*** SUMMARY ***
Total pot $1.25 | Rake $0
Seat 1: avNOJXWxD1+SygFmWsd+qw (button) folded before Flop (didn't bet)
Seat 2: OZ6OtYh5Y53MCH/p0QTn5g (small blind) folded before Flop
Seat 3: QmH/ZFyxZfvliy57YM9yxw (big blind) folded before Flop
Seat 4: 1b+2BbjMN8qhR1WPqdE9VQ folded before Flop (didn't bet)
Seat 5: 6yWjZXHP6iAyMEDF6pJlng collected ($1.25)
Seat 6: u3Ol7kv1LmvszuHNm9rc6w folded before Flop (didn't bet)



PokerStars Game #59941601812:  Hold'em No Limit ($0.25/$0.50) - 2009/07/01 1:40:24 ET
Table 'ErOuyGLI5PT3G5MnpHgC/g' 9-max Seat #6 is the button
Seat 1: eBrej2jnlUCs/JgxFCRn2g ($47.85 in chips)
Seat 2: pciZn00ZDk4BVBMTTMcNVQ ($20.25 in chips)
Seat 3: xZCXQSXlrZkp3pZizzVXCw ($49.25 in chips)
Seat 4: YRqrX/u38J7aLNNnBzQsjQ ($19.05 in chips)
Seat 5: JwvquocWfhTVApN5t47LgA ($48.30 in chips)
Seat 6: zE9cVigS2nW/Ljy4K4bUQA ($30 in chips)
Seat 7: 90Wb75h3W1BRpbqVnuk8gw ($61.70 in chips)
Seat 8: g4k0NXISyLCqaSWZDBjfEg ($50 in chips)
Seat 9: J0W5D97jl5VLky+IoPvDeA ($64.50 in chips)
90Wb75h3W1BRpbqVnuk8gw: posts small blind $0.25
g4k0NXISyLCqaSWZDBjfEg: posts big blind $0.50
*** HOLE CARDS ***
J0W5D97jl5VLky+IoPvDeA: folds
eBrej2jnlUCs/JgxFCRn2g: calls $0.50
pciZn00ZDk4BVBMTTMcNVQ: raises $1 to $1.50
xZCXQSXlrZkp3pZizzVXCw: folds
YRqrX/u38J7aLNNnBzQsjQ: folds
JwvquocWfhTVApN5t47LgA: folds
zE9cVigS2nW/Ljy4K4bUQA: folds
90Wb75h3W1BRpbqVnuk8gw: folds
g4k0NXISyLCqaSWZDBjfEg: folds
eBrej2jnlUCs/JgxFCRn2g: folds
pciZn00ZDk4BVBMTTMcNVQ collected $1.75 from pot
*** SUMMARY ***
Total pot $1.75 | Rake $0
Seat 1: eBrej2jnlUCs/JgxFCRn2g folded before Flop
Seat 2: pciZn00ZDk4BVBMTTMcNVQ collected ($1.75)
Seat 3: xZCXQSXlrZkp3pZizzVXCw folded before Flop (didn't bet)
Seat 4: YRqrX/u38J7aLNNnBzQsjQ folded before Flop (didn't bet)
Seat 5: JwvquocWfhTVApN5t47LgA folded before Flop (didn't bet)
Seat 6: zE9cVigS2nW/Ljy4K4bUQA (button) folded before Flop (didn't bet)
Seat 7: 90Wb75h3W1BRpbqVnuk8gw (small blind) folded before Flop
Seat 8: g4k0NXISyLCqaSWZDBjfEg (big blind) folded before Flop
Seat 9: J0W5D97jl5VLky+IoPvDeA folded before Flop (didn't bet)



PokerStars Game #59941602374:  Hold'em No Limit ($0.25/$0.50) - 2009/07/01 1:40:25 ET
Table '2lPOwetm4cfkZPbTmGPH/w' 2-max Seat #2 is the button
Seat 1: vUGdApqS8J/GJE2gaVWl1w ($10.70 in chips)
Seat 2: XFa6sBGjP2gxoIvxR3fZIg ($26.45 in chips)
XFa6sBGjP2gxoIvxR3fZIg: posts small blind $0.25
vUGdApqS8J/GJE2gaVWl1w: posts big blind $0.50
*** HOLE CARDS ***
XFa6sBGjP2gxoIvxR3fZIg: raises $1 to $1.50
vUGdApqS8J/GJE2gaVWl1w: calls $1
*** FLOP *** [3c 7h Th]
vUGdApqS8J/GJE2gaVWl1w: checks
XFa6sBGjP2gxoIvxR3fZIg: bets $2
vUGdApqS8J/GJE2gaVWl1w: folds
XFa6sBGjP2gxoIvxR3fZIg collected $2.85 from pot
XFa6sBGjP2gxoIvxR3fZIg: doesn't show hand
*** SUMMARY ***
Total pot $3 | Rake $0.15
Board [3c 7h Th]
Seat 1: vUGdApqS8J/GJE2gaVWl1w (big blind) folded on the Flop
Seat 2: XFa6sBGjP2gxoIvxR3fZIg (button) (small blind) collected ($2.85)



PokerStars Game #59941602780:  Hold'em No Limit ($0.25/$0.50) - 2009/07/01 1:40:26 ET
Table '8BQGgNetI1NOvWeu3gtMNw' 2-max Seat #1 is the button
Seat 1: bypIyrYcAAifLfhZpGlKLA ($70.35 in chips)
Seat 2: Z4HwehErEwzsv/noQlfUlg ($142.60 in chips)
bypIyrYcAAifLfhZpGlKLA: posts small blind $0.25
Z4HwehErEwzsv/noQlfUlg: posts big blind $0.50
*** HOLE CARDS ***
bypIyrYcAAifLfhZpGlKLA: raises $1 to $1.50
Z4HwehErEwzsv/noQlfUlg: raises $1 to $2.50
bypIyrYcAAifLfhZpGlKLA: calls $1
*** FLOP *** [6s 4c 3h]
Z4HwehErEwzsv/noQlfUlg: checks
bypIyrYcAAifLfhZpGlKLA: bets $3
Z4HwehErEwzsv/noQlfUlg: calls $3
*** TURN *** [6s 4c 3h] [Ad]
Z4HwehErEwzsv/noQlfUlg: checks
bypIyrYcAAifLfhZpGlKLA: checks
*** RIVER *** [6s 4c 3h Ad] [Qc]
Z4HwehErEwzsv/noQlfUlg: bets $9
bypIyrYcAAifLfhZpGlKLA: raises $16 to $25
Z4HwehErEwzsv/noQlfUlg: folds
bypIyrYcAAifLfhZpGlKLA collected $28.50 from pot
bypIyrYcAAifLfhZpGlKLA: doesn't show hand
*** SUMMARY ***
Total pot $29 | Rake $0.50
Board [6s 4c 3h Ad Qc]
Seat 1: bypIyrYcAAifLfhZpGlKLA (button) (small blind) collected ($28.50)
Seat 2: Z4HwehErEwzsv/noQlfUlg (big blind) folded on the River



PokerStars Game #59941603004:  Hold'em No Limit ($0.25/$0.50) - 2009/07/01 1:40:26 ET
Table 'kgbJRsxfv64KrErDRBAkcw' 6-max Seat #2 is the button
Seat 1: VamsyhlFzXGF6/ydo0BHeA ($5.50 in chips)
Seat 2: AdS8BJMOheS01zjCDfPMFg ($87.85 in chips)
Seat 3: c4MNIaIyPMOMxrgT8FT5nA ($155.50 in chips)
Seat 4: 2igtJLmvIZ+HqX4XPgMPZA ($112.50 in chips)
Seat 5: eUBBn2R56C1IQ6Cs/vitwg ($106 in chips)
Seat 6: 1b+2BbjMN8qhR1WPqdE9VQ ($50 in chips)
c4MNIaIyPMOMxrgT8FT5nA: posts small blind $0.25
2igtJLmvIZ+HqX4XPgMPZA: posts big blind $0.50
*** HOLE CARDS ***
eUBBn2R56C1IQ6Cs/vitwg: folds
1b+2BbjMN8qhR1WPqdE9VQ: folds
VamsyhlFzXGF6/ydo0BHeA: folds
AdS8BJMOheS01zjCDfPMFg: raises $1 to $1.50
c4MNIaIyPMOMxrgT8FT5nA: folds
2igtJLmvIZ+HqX4XPgMPZA: folds
AdS8BJMOheS01zjCDfPMFg collected $1.25 from pot
*** SUMMARY ***
Total pot $1.25 | Rake $0
Seat 1: VamsyhlFzXGF6/ydo0BHeA folded before Flop (didn't bet)
Seat 2: AdS8BJMOheS01zjCDfPMFg (button) collected ($1.25)
Seat 3: c4MNIaIyPMOMxrgT8FT5nA (small blind) folded before Flop
Seat 4: 2igtJLmvIZ+HqX4XPgMPZA (big blind) folded before Flop
Seat 5: eUBBn2R56C1IQ6Cs/vitwg folded before Flop (didn't bet)
Seat 6: 1b+2BbjMN8qhR1WPqdE9VQ folded before Flop (didn't bet)



PokerStars Game #59941603564:  Hold'em No Limit ($0.25/$0.50) - 2009/07/01 1:40:28 ET
Table 'Wwfm5/i+g/g2Nj2gT3jnVQ' 2-max Seat #2 is the button
Seat 1: CHRLZDaaxjbo68bwQD1C/Q ($5.95 in chips)
Seat 2: PKuuhUvIr5WSkJyPJa9dFw ($23.30 in chips)
PKuuhUvIr5WSkJyPJa9dFw: posts small blind $0.25
CHRLZDaaxjbo68bwQD1C/Q: posts big blind $0.50
*** HOLE CARDS ***
PKuuhUvIr5WSkJyPJa9dFw: folds
CHRLZDaaxjbo68bwQD1C/Q collected $0.50 from pot
CHRLZDaaxjbo68bwQD1C/Q: doesn't show hand
*** SUMMARY ***
Total pot $0.50 | Rake $0
Seat 1: CHRLZDaaxjbo68bwQD1C/Q (big blind) collected ($0.50)
Seat 2: PKuuhUvIr5WSkJyPJa9dFw (button) (small blind) folded before Flop



PokerStars Game #59941604680:  Hold'em No Limit ($0.25/$0.50) - 2009/07/01 1:40:29 ET
Table 'tyR5AZNKV8Aadbrnrnlg7g' 6-max Seat #1 is the button
Seat 1: BgOXYI0yYSN1ULC4FqsNkg ($76.05 in chips)
Seat 2: vhWS+cwAJNd3JzqVzIjBZA ($50 in chips)
Seat 3: JFLrYNyQmwPhRQAtoSAuyA ($60.85 in chips)
Seat 4: 4QfsCWthT/vSLirorNXqtg ($82.20 in chips)
Seat 5: GUnvMULl2qFOO1yenu1UBw ($76.35 in chips)
vhWS+cwAJNd3JzqVzIjBZA: posts small blind $0.25
JFLrYNyQmwPhRQAtoSAuyA: posts big blind $0.50
*** HOLE CARDS ***
4QfsCWthT/vSLirorNXqtg: folds
GUnvMULl2qFOO1yenu1UBw: folds
BgOXYI0yYSN1ULC4FqsNkg: folds
vhWS+cwAJNd3JzqVzIjBZA: folds
JFLrYNyQmwPhRQAtoSAuyA collected $0.50 from pot
JFLrYNyQmwPhRQAtoSAuyA: doesn't show hand
*** SUMMARY ***
Total pot $0.50 | Rake $0
Seat 1: BgOXYI0yYSN1ULC4FqsNkg (button) folded before Flop (didn't bet)
Seat 2: vhWS+cwAJNd3JzqVzIjBZA (small blind) folded before Flop
Seat 3: JFLrYNyQmwPhRQAtoSAuyA (big blind) collected ($0.50)
Seat 4: 4QfsCWthT/vSLirorNXqtg folded before Flop (didn't bet)
Seat 5: GUnvMULl2qFOO1yenu1UBw folded before Flop (didn't bet)



PokerStars Game #59941605092:  Hold'em No Limit ($0.25/$0.50) - 2009/07/01 1:40:30 ET
Table '1pi9mHyVuXF/uue+aPQc4w' 9-max Seat #3 is the button
Seat 1: M+D23GG26WXQ/2gyjREVOQ ($50.65 in chips)
Seat 2: vHYT5s323LpajBj+2c9zbQ ($22.90 in chips)
Seat 3: HZkVla4kK2SI42CVrPZ/ig ($9.60 in chips)
Seat 4: mSD1pginDsyHG5PDfqzphw ($13.30 in chips)
Seat 6: 1xBtrSVBbgFH/viUWKqQeg ($49.25 in chips)
Seat 7: 61sfw5QTu62YYIt68OsdrA ($33.55 in chips)
Seat 8: g4k0NXISyLCqaSWZDBjfEg ($97.05 in chips)
Seat 9: Q/gZC63lfOMr7YhWKPCxoQ ($9.20 in chips)
mSD1pginDsyHG5PDfqzphw: posts small blind $0.25
zE9cVigS2nW/Ljy4K4bUQA: is sitting out
1xBtrSVBbgFH/viUWKqQeg: posts big blind $0.50
*** HOLE CARDS ***
zE9cVigS2nW/Ljy4K4bUQA leaves the table
61sfw5QTu62YYIt68OsdrA: raises $1.50 to $2
g4k0NXISyLCqaSWZDBjfEg: folds
Q/gZC63lfOMr7YhWKPCxoQ: folds
M+D23GG26WXQ/2gyjREVOQ: calls $2
vHYT5s323LpajBj+2c9zbQ: folds
HZkVla4kK2SI42CVrPZ/ig: folds
bMkgDRXl6YaqJ4b/5qml2Q joins the table at seat #5
mSD1pginDsyHG5PDfqzphw: folds
1xBtrSVBbgFH/viUWKqQeg: raises $2 to $4
61sfw5QTu62YYIt68OsdrA: calls $2
M+D23GG26WXQ/2gyjREVOQ: calls $2
*** FLOP *** [9c 7s 2d]
1xBtrSVBbgFH/viUWKqQeg: checks
61sfw5QTu62YYIt68OsdrA: checks
M+D23GG26WXQ/2gyjREVOQ: bets $3
1xBtrSVBbgFH/viUWKqQeg: raises $4 to $7
61sfw5QTu62YYIt68OsdrA: folds
M+D23GG26WXQ/2gyjREVOQ: folds
1xBtrSVBbgFH/viUWKqQeg collected $17.40 from pot
1xBtrSVBbgFH/viUWKqQeg: shows [Ah As] (a pair of Aces)
*** SUMMARY ***
Total pot $18.25 | Rake $0.85
Board [9c 7s 2d]
Seat 1: M+D23GG26WXQ/2gyjREVOQ folded on the Flop
Seat 2: vHYT5s323LpajBj+2c9zbQ folded before Flop (didn't bet)
Seat 3: HZkVla4kK2SI42CVrPZ/ig (button) folded before Flop (didn't bet)
Seat 4: mSD1pginDsyHG5PDfqzphw (small blind) folded before Flop
Seat 6: 1xBtrSVBbgFH/viUWKqQeg (big blind) collected ($17.40)
Seat 7: 61sfw5QTu62YYIt68OsdrA folded on the Flop
Seat 8: g4k0NXISyLCqaSWZDBjfEg folded before Flop (didn't bet)
Seat 9: Q/gZC63lfOMr7YhWKPCxoQ folded before Flop (didn't bet)



PokerStars Game #59941606710:  Hold'em No Limit ($0.25/$0.50) - 2009/07/01 1:40:33 ET
Table 'Wwfm5/i+g/g2Nj2gT3jnVQ' 2-max Seat #1 is the button
Seat 1: CHRLZDaaxjbo68bwQD1C/Q ($6.20 in chips)
Seat 2: PKuuhUvIr5WSkJyPJa9dFw ($23.05 in chips)
CHRLZDaaxjbo68bwQD1C/Q: posts small blind $0.25
PKuuhUvIr5WSkJyPJa9dFw: posts big blind $0.50
*** HOLE CARDS ***
CHRLZDaaxjbo68bwQD1C/Q: calls $0.25
PKuuhUvIr5WSkJyPJa9dFw: raises $1.50 to $2
CHRLZDaaxjbo68bwQD1C/Q: raises $1.50 to $3.50
PKuuhUvIr5WSkJyPJa9dFw: raises $1.50 to $5
CHRLZDaaxjbo68bwQD1C/Q: raises $1.20 to $6.20 and is all-in
PKuuhUvIr5WSkJyPJa9dFw: calls $1.20
*** FLOP *** [Ad Qs 7s]
*** TURN *** [Ad Qs 7s] [6c]
*** RIVER *** [Ad Qs 7s 6c] [5h]
*** SHOW DOWN ***
PKuuhUvIr5WSkJyPJa9dFw: shows [Jh Kh] (high card Ace)
CHRLZDaaxjbo68bwQD1C/Q: shows [As 7h] (two pair, Aces and Sevens)
CHRLZDaaxjbo68bwQD1C/Q collected $11.90 from pot
*** SUMMARY ***
Total pot $12.40 | Rake $0.50
Board [Ad Qs 7s 6c 5h]
Seat 1: CHRLZDaaxjbo68bwQD1C/Q (button) (small blind) showed [As 7h] and won ($11.90) with two pair, Aces and Sevens
Seat 2: PKuuhUvIr5WSkJyPJa9dFw (big blind) showed [Jh Kh] and lost with high card Ace



PokerStars Game #59941606824:  Hold'em No Limit ($0.25/$0.50) - 2009/07/01 1:40:33 ET
Table 'hSTs/dUsYLgJQuF2Onp0MQ' 6-max Seat #4 is the button
Seat 3: lxIzoHy0RnkfFSODHC2liw ($50 in chips)
Seat 4: 2igtJLmvIZ+HqX4XPgMPZA ($50.50 in chips)
Seat 5: FsRQ5ECdlLkLYI5le8+PDQ ($49.85 in chips)
Seat 6: M1KyQQvVPVuxqTAB8sR/zQ ($104.95 in chips)
FsRQ5ECdlLkLYI5le8+PDQ: posts small blind $0.25
M1KyQQvVPVuxqTAB8sR/zQ: posts big blind $0.50
vhWS+cwAJNd3JzqVzIjBZA: sits out
*** HOLE CARDS ***
lxIzoHy0RnkfFSODHC2liw: folds
2igtJLmvIZ+HqX4XPgMPZA: folds
FsRQ5ECdlLkLYI5le8+PDQ: folds
M1KyQQvVPVuxqTAB8sR/zQ collected $0.50 from pot
*** SUMMARY ***
Total pot $0.50 | Rake $0
Seat 3: lxIzoHy0RnkfFSODHC2liw folded before Flop (didn't bet)
Seat 4: 2igtJLmvIZ+HqX4XPgMPZA (button) folded before Flop (didn't bet)
Seat 5: FsRQ5ECdlLkLYI5le8+PDQ (small blind) folded before Flop
Seat 6: M1KyQQvVPVuxqTAB8sR/zQ (big blind) collected ($0.50)



PokerStars Game #59941607354:  Hold'em No Limit ($0.25/$0.50) - 2009/07/01 1:40:34 ET
Table 'iq+aXfWVQRdV0u8SRTYUEg' 9-max Seat #4 is the button
Seat 1: 3yl8Q6QaLfGtyhN4/pEFgQ ($71.55 in chips)
Seat 2: J9N0lxHFd/Js2S0xZLbsIQ ($31.25 in chips)
Seat 4: vHYT5s323LpajBj+2c9zbQ ($24.85 in chips)
Seat 5: 997ViqAtWn1FPjJqcffwcA ($56.90 in chips)
Seat 6: bTJ0WgoxefTPxIoycS7uoA ($25.95 in chips)
Seat 7: SKnJuWHScqetA/qG5p+wCg ($30.05 in chips)
Seat 8: /DtIHuxEH+3tzKefmSV+Mw ($42.65 in chips)
997ViqAtWn1FPjJqcffwcA: posts small blind $0.25
bTJ0WgoxefTPxIoycS7uoA: posts big blind $0.50
drKg+7JekfxR/0poTEK9Tg: sits out
*** HOLE CARDS ***
SKnJuWHScqetA/qG5p+wCg: folds
/DtIHuxEH+3tzKefmSV+Mw: calls $0.50
bMkgDRXl6YaqJ4b/5qml2Q joins the table at seat #3
3yl8Q6QaLfGtyhN4/pEFgQ: folds
J9N0lxHFd/Js2S0xZLbsIQ: calls $0.50
vHYT5s323LpajBj+2c9zbQ: folds
997ViqAtWn1FPjJqcffwcA: folds
bTJ0WgoxefTPxIoycS7uoA: checks
*** FLOP *** [Js Kc 7s]
bTJ0WgoxefTPxIoycS7uoA: checks
/DtIHuxEH+3tzKefmSV+Mw: checks
J9N0lxHFd/Js2S0xZLbsIQ: bets $2.50
bTJ0WgoxefTPxIoycS7uoA: folds
/DtIHuxEH+3tzKefmSV+Mw: folds
J9N0lxHFd/Js2S0xZLbsIQ collected $1.70 from pot
J9N0lxHFd/Js2S0xZLbsIQ: shows [Tc Kh] (a pair of Kings)
*** SUMMARY ***
Total pot $1.75 | Rake $0.05
Board [Js Kc 7s]
Seat 1: 3yl8Q6QaLfGtyhN4/pEFgQ folded before Flop (didn't bet)
Seat 2: J9N0lxHFd/Js2S0xZLbsIQ collected ($1.70)
Seat 4: vHYT5s323LpajBj+2c9zbQ (button) folded before Flop (didn't bet)
Seat 5: 997ViqAtWn1FPjJqcffwcA (small blind) folded before Flop
Seat 6: bTJ0WgoxefTPxIoycS7uoA (big blind) folded on the Flop
Seat 7: SKnJuWHScqetA/qG5p+wCg folded before Flop (didn't bet)
Seat 8: /DtIHuxEH+3tzKefmSV+Mw folded on the Flop



PokerStars Game #59941607576:  Hold'em No Limit ($0.25/$0.50) - 2009/07/01 1:40:35 ET
Table '3FhG0gl3kMX3wBEEqj+wnQ' 9-max Seat #1 is the button
Seat 1: bxLSulbgr8LmKNjOzw8URg ($49.75 in chips)
Seat 2: HZkVla4kK2SI42CVrPZ/ig ($9.50 in chips)
Seat 3: YXCE3WOZi8g2sIf3y/plVw ($61.55 in chips)
Seat 4: e2+sK/yjnj94rXOKoxPP2A ($68.75 in chips)
Seat 5: XcLXSUMHSpshK/7Lh0M4Vg ($11.05 in chips)
Seat 6: 997ViqAtWn1FPjJqcffwcA ($109.05 in chips)
Seat 7: mSD1pginDsyHG5PDfqzphw ($19.45 in chips)
Seat 8: j3K/Jujr7PY4ZM2RZvlH6A ($52.90 in chips)
Seat 9: KA0tkubTlbhmo4ju+qgXPg ($43.10 in chips)
HZkVla4kK2SI42CVrPZ/ig: posts small blind $0.25
YXCE3WOZi8g2sIf3y/plVw: posts big blind $0.50
*** HOLE CARDS ***
e2+sK/yjnj94rXOKoxPP2A: folds
XcLXSUMHSpshK/7Lh0M4Vg: folds
997ViqAtWn1FPjJqcffwcA: folds
mSD1pginDsyHG5PDfqzphw: folds
j3K/Jujr7PY4ZM2RZvlH6A: raises $3 to $3.50
KA0tkubTlbhmo4ju+qgXPg: folds
bxLSulbgr8LmKNjOzw8URg: folds
HZkVla4kK2SI42CVrPZ/ig: folds
YXCE3WOZi8g2sIf3y/plVw: folds
j3K/Jujr7PY4ZM2RZvlH6A collected $1.25 from pot
j3K/Jujr7PY4ZM2RZvlH6A: doesn't show hand
*** SUMMARY ***
Total pot $1.25 | Rake $0
Seat 1: bxLSulbgr8LmKNjOzw8URg (button) folded before Flop (didn't bet)
Seat 2: HZkVla4kK2SI42CVrPZ/ig (small blind) folded before Flop
Seat 3: YXCE3WOZi8g2sIf3y/plVw (big blind) folded before Flop
Seat 4: e2+sK/yjnj94rXOKoxPP2A folded before Flop (didn't bet)
Seat 5: XcLXSUMHSpshK/7Lh0M4Vg folded before Flop (didn't bet)
Seat 6: 997ViqAtWn1FPjJqcffwcA folded before Flop (didn't bet)
Seat 7: mSD1pginDsyHG5PDfqzphw folded before Flop (didn't bet)
Seat 8: j3K/Jujr7PY4ZM2RZvlH6A collected ($1.25)
Seat 9: KA0tkubTlbhmo4ju+qgXPg folded before Flop (didn't bet)



PokerStars Game #59941609138:  Hold'em No Limit ($0.25/$0.50) - 2009/07/01 1:40:37 ET
Table 'B+sqsfj6d6zXicNfaseTaw' 2-max Seat #1 is the button
Seat 1: +4GNcSsecmapVGSdV0mUPA ($146.55 in chips)
Seat 2: Lv5RmpRe6LtPkBzM9Gpo5A ($73.55 in chips)
+4GNcSsecmapVGSdV0mUPA: posts small blind $0.25
Lv5RmpRe6LtPkBzM9Gpo5A: posts big blind $0.50
*** HOLE CARDS ***
+4GNcSsecmapVGSdV0mUPA: calls $0.25
Lv5RmpRe6LtPkBzM9Gpo5A: checks
*** FLOP *** [8d 9c 4c]
Lv5RmpRe6LtPkBzM9Gpo5A: checks
+4GNcSsecmapVGSdV0mUPA: bets $0.50
Lv5RmpRe6LtPkBzM9Gpo5A: folds
+4GNcSsecmapVGSdV0mUPA collected $0.95 from pot
+4GNcSsecmapVGSdV0mUPA: doesn't show hand
*** SUMMARY ***
Total pot $1 | Rake $0.05
Board [8d 9c 4c]
Seat 1: +4GNcSsecmapVGSdV0mUPA (button) (small blind) collected ($0.95)
Seat 2: Lv5RmpRe6LtPkBzM9Gpo5A (big blind) folded on the Flop



PokerStars Game #59941609038:  Hold'em No Limit ($0.25/$0.50) - 2009/07/01 1:40:37 ET
Table 'ofnd8S4IdIPph1Cbn+x7hAbR5MkGhKEbz+X2bpfpu11Qmax Seat #6 is the button
Seat 2: 1xBtrSVBbgFH/viUWKqQeg ($38.05 in chips)
Seat 3: UVJbBPbDwNMEZadZB9WVmg ($9.75 in chips)
Seat 4: mZNMJI1mY40XTC0U7GZakA ($62.20 in chips)
Seat 5: 2YaCb/8u1SesrR+963XiZA ($13.90 in chips)
Seat 6: 0Bw1Gb5YC/Xvb0SqVawKUw ($9.55 in chips)
Seat 7: kJ06FP2Jc7cSdmywwvYOXw ($59.85 in chips)
Seat 8: R354x4oZnQcGCDV6GhjnpQ ($65.30 in chips)
Seat 9: 75K2MXwN65Sjfp1yHd50Hg ($10 in chips)
kJ06FP2Jc7cSdmywwvYOXw: posts small blind $0.25
R354x4oZnQcGCDV6GhjnpQ: posts big blind $0.50
6CKPjbH+MB5p5oH9GwiXGA: sits out
*** HOLE CARDS ***
75K2MXwN65Sjfp1yHd50Hg: folds
1xBtrSVBbgFH/viUWKqQeg: folds
UVJbBPbDwNMEZadZB9WVmg: folds
mZNMJI1mY40XTC0U7GZakA: folds
2YaCb/8u1SesrR+963XiZA: folds
0Bw1Gb5YC/Xvb0SqVawKUw: folds
kJ06FP2Jc7cSdmywwvYOXw: calls $0.25
R354x4oZnQcGCDV6GhjnpQ: checks
*** FLOP *** [Kc 4d 2c]
kJ06FP2Jc7cSdmywwvYOXw: checks
R354x4oZnQcGCDV6GhjnpQ: checks
*** TURN *** [Kc 4d 2c] [2s]
kJ06FP2Jc7cSdmywwvYOXw: checks
R354x4oZnQcGCDV6GhjnpQ: checks
*** RIVER *** [Kc 4d 2c 2s] [6h]
kJ06FP2Jc7cSdmywwvYOXw: checks
R354x4oZnQcGCDV6GhjnpQ: bets $1.50
kJ06FP2Jc7cSdmywwvYOXw: folds
R354x4oZnQcGCDV6GhjnpQ collected $0.95 from pot
R354x4oZnQcGCDV6GhjnpQ: doesn't show hand
*** SUMMARY ***
Total pot $1 | Rake $0.05
Board [Kc 4d 2c 2s 6h]
Seat 2: 1xBtrSVBbgFH/viUWKqQeg folded before Flop (didn't bet)
Seat 3: UVJbBPbDwNMEZadZB9WVmg folded before Flop (didn't bet)
Seat 4: mZNMJI1mY40XTC0U7GZakA folded before Flop (didn't bet)
Seat 5: 2YaCb/8u1SesrR+963XiZA folded before Flop (didn't bet)
Seat 6: 0Bw1Gb5YC/Xvb0SqVawKUw (button) folded before Flop (didn't bet)
Seat 7: kJ06FP2Jc7cSdmywwvYOXw (small blind) folded on the River
Seat 8: R354x4oZnQcGCDV6GhjnpQ (big blind) collected ($0.95)
Seat 9: 75K2MXwN65Sjfp1yHd50Hg folded before Flop (didn't bet)



PokerStars Game #59941609596:  Hold'em No Limit ($0.25/$0.50) - 2009/07/01 1:40:38 ET
Table '5EmHi+fnatGQQShcNmzOZQ' 6-max Seat #2 is the button
Seat 1: avNOJXWxD1+SygFmWsd+qw ($66.60 in chips)
Seat 2: OZ6OtYh5Y53MCH/p0QTn5g ($50 in chips)
Seat 3: QmH/ZFyxZfvliy57YM9yxw ($80.80 in chips)
Seat 4: 1b+2BbjMN8qhR1WPqdE9VQ ($51.05 in chips)
Seat 5: 6yWjZXHP6iAyMEDF6pJlng ($56.05 in chips)
Seat 6: u3Ol7kv1LmvszuHNm9rc6w ($5.10 in chips)
QmH/ZFyxZfvliy57YM9yxw: posts small blind $0.25
1b+2BbjMN8qhR1WPqdE9VQ: posts big blind $0.50
*** HOLE CARDS ***
6yWjZXHP6iAyMEDF6pJlng: folds
u3Ol7kv1LmvszuHNm9rc6w: folds
avNOJXWxD1+SygFmWsd+qw: folds
OZ6OtYh5Y53MCH/p0QTn5g: folds
QmH/ZFyxZfvliy57YM9yxw: raises $0.50 to $1
1b+2BbjMN8qhR1WPqdE9VQ: calls $0.50
*** FLOP *** [6h Kc Jh]
QmH/ZFyxZfvliy57YM9yxw: bets $1
1b+2BbjMN8qhR1WPqdE9VQ: calls $1
*** TURN *** [6h Kc Jh] [Ah]
QmH/ZFyxZfvliy57YM9yxw: checks
1b+2BbjMN8qhR1WPqdE9VQ: checks
*** RIVER *** [6h Kc Jh Ah] [8h]
QmH/ZFyxZfvliy57YM9yxw: checks
1b+2BbjMN8qhR1WPqdE9VQ: bets $2
QmH/ZFyxZfvliy57YM9yxw: calls $2
*** SHOW DOWN ***
1b+2BbjMN8qhR1WPqdE9VQ: shows [7h 3h] (a flush, Ace high)
QmH/ZFyxZfvliy57YM9yxw: mucks hand
1b+2BbjMN8qhR1WPqdE9VQ collected $7.65 from pot
*** SUMMARY ***
Total pot $8 | Rake $0.35
Board [6h Kc Jh Ah 8h]
Seat 1: avNOJXWxD1+SygFmWsd+qw folded before Flop (didn't bet)
Seat 2: OZ6OtYh5Y53MCH/p0QTn5g (button) folded before Flop (didn't bet)
Seat 3: QmH/ZFyxZfvliy57YM9yxw (small blind) mucked
Seat 4: 1b+2BbjMN8qhR1WPqdE9VQ (big blind) showed [7h 3h] and won ($7.65) with a flush, Ace high
Seat 5: 6yWjZXHP6iAyMEDF6pJlng folded before Flop (didn't bet)
Seat 6: u3Ol7kv1LmvszuHNm9rc6w folded before Flop (didn't bet)



PokerStars Game #59941609778:  Hold'em No Limit ($0.25/$0.50) - 2009/07/01 1:40:39 ET
Table '2lPOwetm4cfkZPbTmGPH/w' 2-max Seat #1 is the button
Seat 1: vUGdApqS8J/GJE2gaVWl1w ($9.20 in chips)
Seat 2: XFa6sBGjP2gxoIvxR3fZIg ($27.80 in chips)
vUGdApqS8J/GJE2gaVWl1w: posts small blind $0.25
XFa6sBGjP2gxoIvxR3fZIg: posts big blind $0.50
*** HOLE CARDS ***
vUGdApqS8J/GJE2gaVWl1w: calls $0.25
XFa6sBGjP2gxoIvxR3fZIg: checks
*** FLOP *** [2c Kh 6c]
XFa6sBGjP2gxoIvxR3fZIg: bets $1
vUGdApqS8J/GJE2gaVWl1w: folds
XFa6sBGjP2gxoIvxR3fZIg collected $0.95 from pot
XFa6sBGjP2gxoIvxR3fZIg: doesn't show hand
*** SUMMARY ***
Total pot $1 | Rake $0.05
Board [2c Kh 6c]
Seat 1: vUGdApqS8J/GJE2gaVWl1w (button) (small blind) folded on the Flop
Seat 2: XFa6sBGjP2gxoIvxR3fZIg (big blind) collected ($0.95)



PokerStars Game #59941610640:  Hold'em No Limit ($0.25/$0.50) - 2009/07/01 1:40:40 ET
Table '9ojijpRcYQSQTh6xI+haUA' 2-max Seat #2 is the button
Seat 1: FqpibuVWLNsAN/Z7ROZLnA ($42.60 in chips)
Seat 2: TitTV+fFCcBZWOERdytydA ($80.75 in chips)
TitTV+fFCcBZWOERdytydA: posts small blind $0.25
FqpibuVWLNsAN/Z7ROZLnA: posts big blind $0.50
*** HOLE CARDS ***
TitTV+fFCcBZWOERdytydA: raises $1 to $1.50
FqpibuVWLNsAN/Z7ROZLnA: raises $1 to $2.50
TitTV+fFCcBZWOERdytydA: raises $1.50 to $4
FqpibuVWLNsAN/Z7ROZLnA: raises $1.50 to $5.50
TitTV+fFCcBZWOERdytydA: calls $1.50
*** FLOP *** [6c 5s Ah]
FqpibuVWLNsAN/Z7ROZLnA: bets $37.10 and is all-in
TitTV+fFCcBZWOERdytydA: folds
FqpibuVWLNsAN/Z7ROZLnA collected $10.50 from pot
FqpibuVWLNsAN/Z7ROZLnA: doesn't show hand
*** SUMMARY ***
Total pot $11 | Rake $0.50
Board [6c 5s Ah]
Seat 1: FqpibuVWLNsAN/Z7ROZLnA (big blind) collected ($10.50)
Seat 2: TitTV+fFCcBZWOERdytydA (button) (small blind) folded on the Flop



PokerStars Game #59941612414:  Hold'em No Limit ($0.25/$0.50) - 2009/07/01 1:40:43 ET
Table 'NCiXr0d5CEKBQr/cZgLhbA' 9-max Seat #9 is the button
Seat 1: pFtzb1sR4b0d1aw6aIRgDg ($79.95 in chips)
Seat 2: AjV5McH1KMMclY26QdLM5w ($41.55 in chips)
Seat 4: 5k9fvXD9suIgCxU4HLQjTw ($53.95 in chips)
Seat 5: Ja2jdidjip2UeJnRzmzAAQ ($44.70 in chips)
Seat 6: t1qL+wRXOwTLB4TBbcw2QA ($47 in chips)
Seat 7: dXhO5i7KOoVcsGqbklD+jw ($44 in chips)
Seat 8: XA3GzEhYmqB0KknKKPDZGQ ($30.30 in chips)
Seat 9: 4WLZvqBn5qv5tds5kt5A1Q ($57.20 in chips)
pFtzb1sR4b0d1aw6aIRgDg: posts small blind $0.25
AjV5McH1KMMclY26QdLM5w: posts big blind $0.50
*** HOLE CARDS ***
5k9fvXD9suIgCxU4HLQjTw: raises $1 to $1.50
Ja2jdidjip2UeJnRzmzAAQ: calls $1.50
t1qL+wRXOwTLB4TBbcw2QA: calls $1.50
dXhO5i7KOoVcsGqbklD+jw: folds
XA3GzEhYmqB0KknKKPDZGQ: calls $1.50
4WLZvqBn5qv5tds5kt5A1Q: folds
pFtzb1sR4b0d1aw6aIRgDg: calls $1.25
AjV5McH1KMMclY26QdLM5w: folds
*** FLOP *** [Qd 6s Qh]
pFtzb1sR4b0d1aw6aIRgDg: checks
5k9fvXD9suIgCxU4HLQjTw: checks
Ja2jdidjip2UeJnRzmzAAQ: checks
t1qL+wRXOwTLB4TBbcw2QA: bets $4
XA3GzEhYmqB0KknKKPDZGQ: folds
pFtzb1sR4b0d1aw6aIRgDg: folds
5k9fvXD9suIgCxU4HLQjTw: folds
Ja2jdidjip2UeJnRzmzAAQ: folds
t1qL+wRXOwTLB4TBbcw2QA collected $7.60 from pot
*** SUMMARY ***
Total pot $8 | Rake $0.40
Board [Qd 6s Qh]
Seat 1: pFtzb1sR4b0d1aw6aIRgDg (small blind) folded on the Flop
Seat 2: AjV5McH1KMMclY26QdLM5w (big blind) folded before Flop
Seat 4: 5k9fvXD9suIgCxU4HLQjTw folded on the Flop
Seat 5: Ja2jdidjip2UeJnRzmzAAQ folded on the Flop
Seat 6: t1qL+wRXOwTLB4TBbcw2QA collected ($7.60)
Seat 7: dXhO5i7KOoVcsGqbklD+jw folded before Flop (didn't bet)
Seat 8: XA3GzEhYmqB0KknKKPDZGQ folded on the Flop
Seat 9: 4WLZvqBn5qv5tds5kt5A1Q (button) folded before Flop (didn't bet)



PokerStars Game #59941613744:  Hold'em No Limit ($0.25/$0.50) - 2009/07/01 1:40:46 ET
Table 'tyR5AZNKV8Aadbrnrnlg7g' 6-max Seat #2 is the button
Seat 1: BgOXYI0yYSN1ULC4FqsNkg ($76.05 in chips)
Seat 2: vhWS+cwAJNd3JzqVzIjBZA ($50 in chips)
Seat 3: JFLrYNyQmwPhRQAtoSAuyA ($61.10 in chips)
Seat 4: 4QfsCWthT/vSLirorNXqtg ($82.20 in chips)
Seat 5: GUnvMULl2qFOO1yenu1UBw ($76.35 in chips)
JFLrYNyQmwPhRQAtoSAuyA: posts small blind $0.25
4QfsCWthT/vSLirorNXqtg: posts big blind $0.50
*** HOLE CARDS ***
GUnvMULl2qFOO1yenu1UBw: folds
BgOXYI0yYSN1ULC4FqsNkg: folds
vhWS+cwAJNd3JzqVzIjBZA: folds
JFLrYNyQmwPhRQAtoSAuyA: folds
4QfsCWthT/vSLirorNXqtg collected $0.50 from pot
4QfsCWthT/vSLirorNXqtg: doesn't show hand
*** SUMMARY ***
Total pot $0.50 | Rake $0
Seat 1: BgOXYI0yYSN1ULC4FqsNkg folded before Flop (didn't bet)
Seat 2: vhWS+cwAJNd3JzqVzIjBZA (button) folded before Flop (didn't bet)
Seat 3: JFLrYNyQmwPhRQAtoSAuyA (small blind) folded before Flop
Seat 4: 4QfsCWthT/vSLirorNXqtg (big blind) collected ($0.50)
Seat 5: GUnvMULl2qFOO1yenu1UBw folded before Flop (didn't bet)



PokerStars Game #59941614968:  Hold'em No Limit ($0.25/$0.50) - 2009/07/01 1:40:48 ET
Table 'otvGDROEDdqsabxskT79qg' 9-max Seat #1 is the button
Seat 1: M+D23GG26WXQ/2gyjREVOQ ($49.25 in chips)
Seat 2: 8pfDpjfHmTUlkgzpRPwQYQ ($27.25 in chips)
Seat 3: +k7T5ocke8UwavtgUHm+Cg ($90.35 in chips)
Seat 4: MG90wfSJZnOejs/KD3vlQQ ($81.35 in chips)
Seat 5: aaHXfJPbwwtrerPKvT348Q ($8.45 in chips)
Seat 6: FFVKBJT0lZf+jFlgvy7ang ($45.55 in chips)
Seat 8: zE9cVigS2nW/Ljy4K4bUQA ($31.75 in chips)
Seat 9: kuqESbpg/khtwiEKRXv2lg ($23.75 in chips)
8pfDpjfHmTUlkgzpRPwQYQ: posts small blind $0.25
+k7T5ocke8UwavtgUHm+Cg: posts big blind $0.50
*** HOLE CARDS ***
MG90wfSJZnOejs/KD3vlQQ: folds
aaHXfJPbwwtrerPKvT348Q: calls $0.50
FFVKBJT0lZf+jFlgvy7ang: calls $0.50
zE9cVigS2nW/Ljy4K4bUQA: folds
kuqESbpg/khtwiEKRXv2lg: raises $1.50 to $2
M+D23GG26WXQ/2gyjREVOQ: folds
8pfDpjfHmTUlkgzpRPwQYQ: folds
+k7T5ocke8UwavtgUHm+Cg: folds
aaHXfJPbwwtrerPKvT348Q: calls $1.50
FFVKBJT0lZf+jFlgvy7ang: folds
*** FLOP *** [6h 3s Jc]
aaHXfJPbwwtrerPKvT348Q: checks
zE9cVigS2nW/Ljy4K4bUQA leaves the table
kuqESbpg/khtwiEKRXv2lg: bets $1.50
aaHXfJPbwwtrerPKvT348Q: calls $1.50
*** TURN *** [6h 3s Jc] [6c]
aaHXfJPbwwtrerPKvT348Q: bets $2
7CKaQEWhd40e2lLifzZ1Cw joins the table at seat #8
kuqESbpg/khtwiEKRXv2lg: raises $3 to $5
aaHXfJPbwwtrerPKvT348Q: folds
kuqESbpg/khtwiEKRXv2lg collected $11.70 from pot
*** SUMMARY ***
Total pot $12.25 | Rake $0.55
Board [6h 3s Jc 6c]
Seat 1: M+D23GG26WXQ/2gyjREVOQ (button) folded before Flop (didn't bet)
Seat 2: 8pfDpjfHmTUlkgzpRPwQYQ (small blind) folded before Flop
Seat 3: +k7T5ocke8UwavtgUHm+Cg (big blind) folded before Flop
Seat 4: MG90wfSJZnOejs/KD3vlQQ folded before Flop (didn't bet)
Seat 5: aaHXfJPbwwtrerPKvT348Q folded on the Turn
Seat 6: FFVKBJT0lZf+jFlgvy7ang folded before Flop
Seat 8: zE9cVigS2nW/Ljy4K4bUQA folded before Flop (didn't bet)
Seat 9: kuqESbpg/khtwiEKRXv2lg collected ($11.70)



PokerStars Game #59941615596:  Hold'em No Limit ($0.25/$0.50) - 2009/07/01 1:40:49 ET
Table 'B+sqsfj6d6zXicNfaseTaw' 2-max Seat #2 is the button
Seat 1: +4GNcSsecmapVGSdV0mUPA ($147 in chips)
Seat 2: Lv5RmpRe6LtPkBzM9Gpo5A ($73.05 in chips)
Lv5RmpRe6LtPkBzM9Gpo5A: posts small blind $0.25
+4GNcSsecmapVGSdV0mUPA: posts big blind $0.50
*** HOLE CARDS ***
Lv5RmpRe6LtPkBzM9Gpo5A: raises $1 to $1.50
+4GNcSsecmapVGSdV0mUPA: calls $1
*** FLOP *** [3h 7c 7d]
+4GNcSsecmapVGSdV0mUPA: checks
Lv5RmpRe6LtPkBzM9Gpo5A: checks
*** TURN *** [3h 7c 7d] [9c]
+4GNcSsecmapVGSdV0mUPA: checks
Lv5RmpRe6LtPkBzM9Gpo5A: bets $0.50
+4GNcSsecmapVGSdV0mUPA: calls $0.50
*** RIVER *** [3h 7c 7d 9c] [Kc]
+4GNcSsecmapVGSdV0mUPA: checks
Lv5RmpRe6LtPkBzM9Gpo5A: bets $2
+4GNcSsecmapVGSdV0mUPA: folds
Lv5RmpRe6LtPkBzM9Gpo5A collected $3.85 from pot
Lv5RmpRe6LtPkBzM9Gpo5A: doesn't show hand
*** SUMMARY ***
Total pot $4 | Rake $0.15
Board [3h 7c 7d 9c Kc]
Seat 1: +4GNcSsecmapVGSdV0mUPA (big blind) folded on the River
Seat 2: Lv5RmpRe6LtPkBzM9Gpo5A (button) (small blind) collected ($3.85)



PokerStars Game #59941615410:  Hold'em No Limit ($0.25/$0.50) - 2009/07/01 1:40:49 ET
Table 'kgbJRsxfv64KrErDRBAkcw' 6-max Seat #3 is the button
Seat 1: VamsyhlFzXGF6/ydo0BHeA ($5.50 in chips)
Seat 2: AdS8BJMOheS01zjCDfPMFg ($88.60 in chips)
Seat 3: c4MNIaIyPMOMxrgT8FT5nA ($155.25 in chips)
Seat 4: 2igtJLmvIZ+HqX4XPgMPZA ($112 in chips)
Seat 5: eUBBn2R56C1IQ6Cs/vitwg ($106 in chips)
Seat 6: 1b+2BbjMN8qhR1WPqdE9VQ ($50 in chips)
2igtJLmvIZ+HqX4XPgMPZA: posts small blind $0.25
eUBBn2R56C1IQ6Cs/vitwg: posts big blind $0.50
*** HOLE CARDS ***
1b+2BbjMN8qhR1WPqdE9VQ: raises $1 to $1.50
VamsyhlFzXGF6/ydo0BHeA: raises $4 to $5.50 and is all-in
AdS8BJMOheS01zjCDfPMFg: folds
c4MNIaIyPMOMxrgT8FT5nA: folds
2igtJLmvIZ+HqX4XPgMPZA: folds
eUBBn2R56C1IQ6Cs/vitwg: folds
1b+2BbjMN8qhR1WPqdE9VQ: calls $4
*** FLOP *** [Qc Th As]
*** TURN *** [Qc Th As] [7c]
*** RIVER *** [Qc Th As 7c] [3c]
*** SHOW DOWN ***
1b+2BbjMN8qhR1WPqdE9VQ: shows [Ac 5c] (a flush, Ace high)
VamsyhlFzXGF6/ydo0BHeA: mucks hand
1b+2BbjMN8qhR1WPqdE9VQ collected $11.20 from pot
*** SUMMARY ***
Total pot $11.75 | Rake $0.55
Board [Qc Th As 7c 3c]
Seat 1: VamsyhlFzXGF6/ydo0BHeA mucked
Seat 2: AdS8BJMOheS01zjCDfPMFg folded before Flop (didn't bet)
Seat 3: c4MNIaIyPMOMxrgT8FT5nA (button) folded before Flop (didn't bet)
Seat 4: 2igtJLmvIZ+HqX4XPgMPZA (small blind) folded before Flop
Seat 5: eUBBn2R56C1IQ6Cs/vitwg (big blind) folded before Flop
Seat 6: 1b+2BbjMN8qhR1WPqdE9VQ showed [Ac 5c] and won ($11.20) with a flush, Ace high



PokerStars Game #59941615958:  Hold'em No Limit ($0.25/$0.50) - 2009/07/01 1:40:49 ET
Table 'Nz0Vr7WMHL2g5Uk7dDZjpw' 9-max Seat #2 is the button
Seat 1: 9yMsdgReyOUerNsmTYCCDQ ($8.25 in chips)
Seat 2: SegjDnMxWMujiD57ESNL+g ($19.60 in chips)
Seat 3: c638Xxo+q5F/t5qMtmvmvQ ($50.90 in chips)
Seat 4: uw9QayAAxLM3Hb+HR7mSkg ($9.25 in chips)
Seat 5: WGW0DgjBUXs1ylURHG8vnQ ($14.75 in chips)
Seat 6: 997ViqAtWn1FPjJqcffwcA ($53.75 in chips)
Seat 7: KPLH0gELgFe2OuAnhJFI5w ($27.95 in chips)
Seat 8: aoL+R/61Kxmw69ypuPrWAQ ($26.25 in chips)
Seat 9: mSD1pginDsyHG5PDfqzphw ($16.50 in chips)
c638Xxo+q5F/t5qMtmvmvQ: posts small blind $0.25
uw9QayAAxLM3Hb+HR7mSkg: posts big blind $0.50
*** HOLE CARDS ***
WGW0DgjBUXs1ylURHG8vnQ: calls $0.50
997ViqAtWn1FPjJqcffwcA: folds
KPLH0gELgFe2OuAnhJFI5w: folds
aoL+R/61Kxmw69ypuPrWAQ: folds
mSD1pginDsyHG5PDfqzphw: folds
9yMsdgReyOUerNsmTYCCDQ: folds
SegjDnMxWMujiD57ESNL+g: folds
c638Xxo+q5F/t5qMtmvmvQ: folds
uw9QayAAxLM3Hb+HR7mSkg: checks
*** FLOP *** [7h 9s Kh]
uw9QayAAxLM3Hb+HR7mSkg: checks
WGW0DgjBUXs1ylURHG8vnQ: bets $1
uw9QayAAxLM3Hb+HR7mSkg: folds
WGW0DgjBUXs1ylURHG8vnQ collected $1.20 from pot
WGW0DgjBUXs1ylURHG8vnQ: doesn't show hand
*** SUMMARY ***
Total pot $1.25 | Rake $0.05
Board [7h 9s Kh]
Seat 1: 9yMsdgReyOUerNsmTYCCDQ folded before Flop (didn't bet)
Seat 2: SegjDnMxWMujiD57ESNL+g (button) folded before Flop (didn't bet)
Seat 3: c638Xxo+q5F/t5qMtmvmvQ (small blind) folded before Flop
Seat 4: uw9QayAAxLM3Hb+HR7mSkg (big blind) folded on the Flop
Seat 5: WGW0DgjBUXs1ylURHG8vnQ collected ($1.20)
Seat 6: 997ViqAtWn1FPjJqcffwcA folded before Flop (didn't bet)
Seat 7: KPLH0gELgFe2OuAnhJFI5w folded before Flop (didn't bet)
Seat 8: aoL+R/61Kxmw69ypuPrWAQ folded before Flop (didn't bet)
Seat 9: mSD1pginDsyHG5PDfqzphw folded before Flop (didn't bet)



PokerStars Game #59941616424:  Hold'em No Limit ($0.25/$0.50) - 2009/07/01 1:40:50 ET
Table '2lPOwetm4cfkZPbTmGPH/w' 2-max Seat #2 is the button
Seat 1: vUGdApqS8J/GJE2gaVWl1w ($8.70 in chips)
Seat 2: XFa6sBGjP2gxoIvxR3fZIg ($28.25 in chips)
XFa6sBGjP2gxoIvxR3fZIg: posts small blind $0.25
vUGdApqS8J/GJE2gaVWl1w: posts big blind $0.50
*** HOLE CARDS ***
XFa6sBGjP2gxoIvxR3fZIg: raises $1 to $1.50
vUGdApqS8J/GJE2gaVWl1w: folds
XFa6sBGjP2gxoIvxR3fZIg collected $1 from pot
XFa6sBGjP2gxoIvxR3fZIg: doesn't show hand
*** SUMMARY ***
Total pot $1 | Rake $0
Seat 1: vUGdApqS8J/GJE2gaVWl1w (big blind) folded before Flop
Seat 2: XFa6sBGjP2gxoIvxR3fZIg (button) (small blind) collected ($1)



PokerStars Game #59941616602:  Hold'em No Limit ($0.25/$0.50) - 2009/07/01 1:40:51 ET
Table 'hWT2kq66tnKEpD26cia6fQ' 2-max Seat #1 is the button
Seat 1: Ce3KNFP+ao7Da9NHb65raw ($29.45 in chips)
Seat 2: 16tvT7AYgZ2LgiGFcvFKQg ($43.45 in chips)
Ce3KNFP+ao7Da9NHb65raw: posts small blind $0.25
16tvT7AYgZ2LgiGFcvFKQg: posts big blind $0.50
*** HOLE CARDS ***
Ce3KNFP+ao7Da9NHb65raw: calls $0.25
16tvT7AYgZ2LgiGFcvFKQg: raises $1 to $1.50
Ce3KNFP+ao7Da9NHb65raw: folds
16tvT7AYgZ2LgiGFcvFKQg collected $1 from pot
*** SUMMARY ***
Total pot $1 | Rake $0
Seat 1: Ce3KNFP+ao7Da9NHb65raw (button) (small blind) folded before Flop
Seat 2: 16tvT7AYgZ2LgiGFcvFKQg (big blind) collected ($1)



PokerStars Game #59941616702:  Hold'em No Limit ($0.25/$0.50) - 2009/07/01 1:40:51 ET
Table 'cofQFHU7jbJoFecLVBof/w' 6-max Seat #5 is the button
Seat 1: URYNc7fPA23K2UfadQbnCA ($50.95 in chips)
Seat 2: f89uTQr3ieGlusj2IAYAEg ($50 in chips)
Seat 3: v4ctePcLlQw0r8E0qJtjYw ($51.45 in chips)
Seat 4: 9XrTM0DuVxx1pjFAdSbD8A ($50.60 in chips)
Seat 5: QvwRlrpVqerRRF8eJm6dDw ($51 in chips)
Seat 6: 7+uQ0OOgCTbR4ltkSwyC0g ($158.55 in chips)
7+uQ0OOgCTbR4ltkSwyC0g: posts small blind $0.25
URYNc7fPA23K2UfadQbnCA: posts big blind $0.50
*** HOLE CARDS ***
f89uTQr3ieGlusj2IAYAEg: raises $1 to $1.50
v4ctePcLlQw0r8E0qJtjYw: folds
9XrTM0DuVxx1pjFAdSbD8A: calls $1.50
QvwRlrpVqerRRF8eJm6dDw: raises $1.50 to $3
7+uQ0OOgCTbR4ltkSwyC0g: folds
URYNc7fPA23K2UfadQbnCA: folds
f89uTQr3ieGlusj2IAYAEg: calls $1.50
9XrTM0DuVxx1pjFAdSbD8A: calls $1.50
*** FLOP *** [8c 8s 6h]
f89uTQr3ieGlusj2IAYAEg: checks
9XrTM0DuVxx1pjFAdSbD8A: checks
QvwRlrpVqerRRF8eJm6dDw: checks
*** TURN *** [8c 8s 6h] [5d]
f89uTQr3ieGlusj2IAYAEg: checks
9XrTM0DuVxx1pjFAdSbD8A: bets $1
QvwRlrpVqerRRF8eJm6dDw: calls $1
f89uTQr3ieGlusj2IAYAEg: folds
*** RIVER *** [8c 8s 6h 5d] [2d]
9XrTM0DuVxx1pjFAdSbD8A: checks
QvwRlrpVqerRRF8eJm6dDw: checks
*** SHOW DOWN ***
9XrTM0DuVxx1pjFAdSbD8A: shows [As 5s] (two pair, Eights and Fives)
QvwRlrpVqerRRF8eJm6dDw: mucks hand
9XrTM0DuVxx1pjFAdSbD8A collected $11.20 from pot
*** SUMMARY ***
Total pot $11.75 | Rake $0.55
Board [8c 8s 6h 5d 2d]
Seat 1: URYNc7fPA23K2UfadQbnCA (big blind) folded before Flop
Seat 2: f89uTQr3ieGlusj2IAYAEg folded on the Turn
Seat 3: v4ctePcLlQw0r8E0qJtjYw folded before Flop (didn't bet)
Seat 4: 9XrTM0DuVxx1pjFAdSbD8A showed [As 5s] and won ($11.20) with two pair, Eights and Fives
Seat 5: QvwRlrpVqerRRF8eJm6dDw (button) mucked
Seat 6: 7+uQ0OOgCTbR4ltkSwyC0g (small blind) folded before Flop



PokerStars Game #59941616562:  Hold'em No Limit ($0.25/$0.50) - 2009/07/01 1:40:51 ET
Table 'GfL/No5u5PoEnU39lP5pQg' 6-max Seat #3 is the button
Seat 2: uVwggSetzp7d+eVgowO3vg ($53.05 in chips)
Seat 3: 4pp9WxhGdbVbxCc9tlu0lw ($27.05 in chips)
Seat 4: ifQmgsYNFiAg/XvBOMBSfQ ($49.50 in chips)
Seat 5: M1KyQQvVPVuxqTAB8sR/zQ ($50 in chips)
Seat 6: kxPhs4ePFqMy52CInAJ2aw ($103.10 in chips)
ifQmgsYNFiAg/XvBOMBSfQ: posts small blind $0.25
M1KyQQvVPVuxqTAB8sR/zQ: posts big blind $0.50
6qJZP2EKIgnEXJ3tMSBuew: sits out
*** HOLE CARDS ***
kxPhs4ePFqMy52CInAJ2aw: folds
uVwggSetzp7d+eVgowO3vg: calls $0.50
4pp9WxhGdbVbxCc9tlu0lw: folds
ifQmgsYNFiAg/XvBOMBSfQ: folds
M1KyQQvVPVuxqTAB8sR/zQ: checks
*** FLOP *** [9h Qc Td]
M1KyQQvVPVuxqTAB8sR/zQ: checks
uVwggSetzp7d+eVgowO3vg: checks
*** TURN *** [9h Qc Td] [6c]
M1KyQQvVPVuxqTAB8sR/zQ: checks
uVwggSetzp7d+eVgowO3vg: checks
*** RIVER *** [9h Qc Td 6c] [3s]
M1KyQQvVPVuxqTAB8sR/zQ: checks
uVwggSetzp7d+eVgowO3vg: checks
*** SHOW DOWN ***
M1KyQQvVPVuxqTAB8sR/zQ: shows [2d 7s] (high card Queen)
uVwggSetzp7d+eVgowO3vg: shows [Kd 7d] (high card King)
uVwggSetzp7d+eVgowO3vg collected $1.20 from pot
*** SUMMARY ***
Total pot $1.25 | Rake $0.05
Board [9h Qc Td 6c 3s]
Seat 2: uVwggSetzp7d+eVgowO3vg showed [Kd 7d] and won ($1.20) with high card King
Seat 3: 4pp9WxhGdbVbxCc9tlu0lw (button) folded before Flop (didn't bet)
Seat 4: ifQmgsYNFiAg/XvBOMBSfQ (small blind) folded before Flop
Seat 5: M1KyQQvVPVuxqTAB8sR/zQ (big blind) showed [2d 7s] and lost with high card Queen
Seat 6: kxPhs4ePFqMy52CInAJ2aw folded before Flop (didn't bet)



PokerStars Game #59941617784:  Hold'em No Limit ($0.25/$0.50) - 2009/07/01 1:40:53 ET
Table 'Wwfm5/i+g/g2Nj2gT3jnVQ' 2-max Seat #2 is the button
Seat 1: CHRLZDaaxjbo68bwQD1C/Q ($11.90 in chips)
Seat 2: PKuuhUvIr5WSkJyPJa9dFw ($16.85 in chips)
PKuuhUvIr5WSkJyPJa9dFw: posts small blind $0.25
CHRLZDaaxjbo68bwQD1C/Q: posts big blind $0.50
*** HOLE CARDS ***
PKuuhUvIr5WSkJyPJa9dFw: calls $0.25
CHRLZDaaxjbo68bwQD1C/Q: checks
*** FLOP *** [3d 6d Ad]
CHRLZDaaxjbo68bwQD1C/Q: checks
PKuuhUvIr5WSkJyPJa9dFw: bets $1
CHRLZDaaxjbo68bwQD1C/Q: folds
PKuuhUvIr5WSkJyPJa9dFw collected $0.95 from pot
PKuuhUvIr5WSkJyPJa9dFw: doesn't show hand
*** SUMMARY ***
Total pot $1 | Rake $0.05
Board [3d 6d Ad]
Seat 1: CHRLZDaaxjbo68bwQD1C/Q (big blind) folded on the Flop
Seat 2: PKuuhUvIr5WSkJyPJa9dFw (button) (small blind) collected ($0.95)



PokerStars Game #59941619252:  Hold'em No Limit ($0.25/$0.50) - 2009/07/01 1:40:55 ET
Table 'hSTs/dUsYLgJQuF2Onp0MQ' 6-max Seat #5 is the button
Seat 2: vhWS+cwAJNd3JzqVzIjBZA ($50 in chips)
Seat 3: lxIzoHy0RnkfFSODHC2liw ($50 in chips)
Seat 4: 2igtJLmvIZ+HqX4XPgMPZA ($50.50 in chips)
Seat 5: FsRQ5ECdlLkLYI5le8+PDQ ($49.60 in chips)
Seat 6: M1KyQQvVPVuxqTAB8sR/zQ ($105.20 in chips)
M1KyQQvVPVuxqTAB8sR/zQ: posts small blind $0.25
vhWS+cwAJNd3JzqVzIjBZA: posts big blind $0.50
*** HOLE CARDS ***
lxIzoHy0RnkfFSODHC2liw: folds
2igtJLmvIZ+HqX4XPgMPZA: folds
FsRQ5ECdlLkLYI5le8+PDQ: folds
M1KyQQvVPVuxqTAB8sR/zQ: calls $0.25
vhWS+cwAJNd3JzqVzIjBZA: checks
*** FLOP *** [6d 9d Jc]
M1KyQQvVPVuxqTAB8sR/zQ: checks
vhWS+cwAJNd3JzqVzIjBZA: checks
*** TURN *** [6d 9d Jc] [5h]
Hdd4js36ITbTJ/QuVYwTlA joins the table at seat #1
M1KyQQvVPVuxqTAB8sR/zQ: checks
vhWS+cwAJNd3JzqVzIjBZA: bets $1
M1KyQQvVPVuxqTAB8sR/zQ: folds
vhWS+cwAJNd3JzqVzIjBZA collected $0.95 from pot
*** SUMMARY ***
Total pot $1 | Rake $0.05
Board [6d 9d Jc 5h]
Seat 2: vhWS+cwAJNd3JzqVzIjBZA (big blind) collected ($0.95)
Seat 3: lxIzoHy0RnkfFSODHC2liw folded before Flop (didn't bet)
Seat 4: 2igtJLmvIZ+HqX4XPgMPZA folded before Flop (didn't bet)
Seat 5: FsRQ5ECdlLkLYI5le8+PDQ (button) folded before Flop (didn't bet)
Seat 6: M1KyQQvVPVuxqTAB8sR/zQ (small blind) folded on the Turn



PokerStars Game #59941619262:  Hold'em No Limit ($0.25/$0.50) - 2009/07/01 1:40:55 ET
Table '5qf8oPyYje71HBKD0FwPgQ' 9-max Seat #9 is the button
Seat 1: gsyXT42WLEcOS4DdEk2wlw ($29.50 in chips)
Seat 2: M+7+BTmX5vZatHVuoRB1nA ($55.25 in chips)
Seat 3: vacmVLJJECYI6HjAynFcpg ($51.20 in chips)
Seat 4: YXCE3WOZi8g2sIf3y/plVw ($57.75 in chips)
Seat 5: uo2Sgpknd7NdeVbeSCG02A ($14.20 in chips)
Seat 6: go0Ad6tqqJ4tR9/bqVlO0g ($26.20 in chips)
Seat 7: 1q5EPoiflJRl8pqfnVLjMw ($57.50 in chips)
Seat 8: sakr/FIfFtIZwDPmAj5Pzg ($56.85 in chips)
Seat 9: jWDRpL0TJljg+mBCE9ZMqA ($9.75 in chips)
gsyXT42WLEcOS4DdEk2wlw: posts small blind $0.25
M+7+BTmX5vZatHVuoRB1nA: posts big blind $0.50
*** HOLE CARDS ***
vacmVLJJECYI6HjAynFcpg: raises $1.50 to $2
YXCE3WOZi8g2sIf3y/plVw: folds
uo2Sgpknd7NdeVbeSCG02A: calls $2
go0Ad6tqqJ4tR9/bqVlO0g: calls $2
1q5EPoiflJRl8pqfnVLjMw: calls $2
sakr/FIfFtIZwDPmAj5Pzg: folds
jWDRpL0TJljg+mBCE9ZMqA: folds
gsyXT42WLEcOS4DdEk2wlw: folds
M+7+BTmX5vZatHVuoRB1nA: calls $1.50
*** FLOP *** [2d 5h 8h]
M+7+BTmX5vZatHVuoRB1nA: checks
vacmVLJJECYI6HjAynFcpg: bets $6
uo2Sgpknd7NdeVbeSCG02A: folds
go0Ad6tqqJ4tR9/bqVlO0g: folds
1q5EPoiflJRl8pqfnVLjMw: folds
M+7+BTmX5vZatHVuoRB1nA: raises $9 to $15
vacmVLJJECYI6HjAynFcpg: folds
M+7+BTmX5vZatHVuoRB1nA collected $21.20 from pot
M+7+BTmX5vZatHVuoRB1nA: doesn't show hand
*** SUMMARY ***
Total pot $22.25 | Rake $1.05
Board [2d 5h 8h]
Seat 1: gsyXT42WLEcOS4DdEk2wlw (small blind) folded before Flop
Seat 2: M+7+BTmX5vZatHVuoRB1nA (big blind) collected ($21.20)
Seat 3: vacmVLJJECYI6HjAynFcpg folded on the Flop
Seat 4: YXCE3WOZi8g2sIf3y/plVw folded before Flop (didn't bet)
Seat 5: uo2Sgpknd7NdeVbeSCG02A folded on the Flop
Seat 6: go0Ad6tqqJ4tR9/bqVlO0g folded on the Flop
Seat 7: 1q5EPoiflJRl8pqfnVLjMw folded on the Flop
Seat 8: sakr/FIfFtIZwDPmAj5Pzg folded before Flop (didn't bet)
Seat 9: jWDRpL0TJljg+mBCE9ZMqA (button) folded before Flop (didn't bet)



PokerStars Game #59941620610:  Hold'em No Limit ($0.25/$0.50) - 2009/07/01 1:40:58 ET
Table '+z1aekfHkpp09pc8F9aViw' 6-max Seat #1 is the button
Seat 1: L0aIPg7qefDQjdJo3HCVEA ($10.75 in chips)
Seat 3: URYNc7fPA23K2UfadQbnCA ($61.15 in chips)
Seat 4: RowCSpSURHTOL/dcjg/Iug ($85.70 in chips)
Seat 5: 2igtJLmvIZ+HqX4XPgMPZA ($51.50 in chips)
Seat 6: GUnvMULl2qFOO1yenu1UBw ($50.75 in chips)
URYNc7fPA23K2UfadQbnCA: posts small blind $0.25
RowCSpSURHTOL/dcjg/Iug: posts big blind $0.50
*** HOLE CARDS ***
2igtJLmvIZ+HqX4XPgMPZA: folds
GUnvMULl2qFOO1yenu1UBw: raises $1 to $1.50
L0aIPg7qefDQjdJo3HCVEA: folds
URYNc7fPA23K2UfadQbnCA: raises $3.50 to $5
RowCSpSURHTOL/dcjg/Iug: folds
GUnvMULl2qFOO1yenu1UBw: folds
URYNc7fPA23K2UfadQbnCA collected $3.50 from pot
*** SUMMARY ***
Total pot $3.50 | Rake $0
Seat 1: L0aIPg7qefDQjdJo3HCVEA (button) folded before Flop (didn't bet)
Seat 3: URYNc7fPA23K2UfadQbnCA (small blind) collected ($3.50)
Seat 4: RowCSpSURHTOL/dcjg/Iug (big blind) folded before Flop
Seat 5: 2igtJLmvIZ+HqX4XPgMPZA folded before Flop (didn't bet)
Seat 6: GUnvMULl2qFOO1yenu1UBw folded before Flop



PokerStars Game #59941620714:  Hold'em No Limit ($0.25/$0.50) - 2009/07/01 1:40:58 ET
Table '2lPOwetm4cfkZPbTmGPH/w' 2-max Seat #1 is the button
Seat 1: vUGdApqS8J/GJE2gaVWl1w ($8.20 in chips)
Seat 2: XFa6sBGjP2gxoIvxR3fZIg ($28.75 in chips)
vUGdApqS8J/GJE2gaVWl1w: posts small blind $0.25
XFa6sBGjP2gxoIvxR3fZIg: posts big blind $0.50
*** HOLE CARDS ***
vUGdApqS8J/GJE2gaVWl1w: folds
XFa6sBGjP2gxoIvxR3fZIg collected $0.50 from pot
*** SUMMARY ***
Total pot $0.50 | Rake $0
Seat 1: vUGdApqS8J/GJE2gaVWl1w (button) (small blind) folded before Flop
Seat 2: XFa6sBGjP2gxoIvxR3fZIg (big blind) collected ($0.50)



PokerStars Game #59941621856:  Hold'em No Limit ($0.25/$0.50) - 2009/07/01 1:41:00 ET
Table 'hWT2kq66tnKEpD26cia6fQ' 2-max Seat #2 is the button
Seat 1: Ce3KNFP+ao7Da9NHb65raw ($28.95 in chips)
Seat 2: 16tvT7AYgZ2LgiGFcvFKQg ($43.95 in chips)
16tvT7AYgZ2LgiGFcvFKQg: posts small blind $0.25
Ce3KNFP+ao7Da9NHb65raw: posts big blind $0.50
*** HOLE CARDS ***
16tvT7AYgZ2LgiGFcvFKQg: calls $0.25
Ce3KNFP+ao7Da9NHb65raw: checks
*** FLOP *** [2s Ts Kd]
Ce3KNFP+ao7Da9NHb65raw: checks
16tvT7AYgZ2LgiGFcvFKQg: checks
*** TURN *** [2s Ts Kd] [Jc]
Ce3KNFP+ao7Da9NHb65raw: checks
16tvT7AYgZ2LgiGFcvFKQg: checks
*** RIVER *** [2s Ts Kd Jc] [Qd]
Ce3KNFP+ao7Da9NHb65raw: checks
16tvT7AYgZ2LgiGFcvFKQg: checks
*** SHOW DOWN ***
Ce3KNFP+ao7Da9NHb65raw: shows [Ac 5s] (a straight, Ten to Ace)
16tvT7AYgZ2LgiGFcvFKQg: mucks hand
Ce3KNFP+ao7Da9NHb65raw collected $0.95 from pot
*** SUMMARY ***
Total pot $1 | Rake $0.05
Board [2s Ts Kd Jc Qd]
Seat 1: Ce3KNFP+ao7Da9NHb65raw (big blind) showed [Ac 5s] and won ($0.95) with a straight, Ten to Ace
Seat 2: 16tvT7AYgZ2LgiGFcvFKQg (button) (small blind) mucked



PokerStars Game #59941621944:  Hold'em No Limit ($0.25/$0.50) - 2009/07/01 1:41:00 ET
Table 'tyR5AZNKV8Aadbrnrnlg7g' 6-max Seat #3 is the button
Seat 1: BgOXYI0yYSN1ULC4FqsNkg ($76.05 in chips)
Seat 2: vhWS+cwAJNd3JzqVzIjBZA ($50 in chips)
Seat 3: JFLrYNyQmwPhRQAtoSAuyA ($60.85 in chips)
Seat 4: 4QfsCWthT/vSLirorNXqtg ($82.45 in chips)
Seat 5: GUnvMULl2qFOO1yenu1UBw ($76.35 in chips)
4QfsCWthT/vSLirorNXqtg: posts small blind $0.25
GUnvMULl2qFOO1yenu1UBw: posts big blind $0.50
*** HOLE CARDS ***
BgOXYI0yYSN1ULC4FqsNkg: folds
vhWS+cwAJNd3JzqVzIjBZA: folds
JFLrYNyQmwPhRQAtoSAuyA: folds
4QfsCWthT/vSLirorNXqtg: folds
GUnvMULl2qFOO1yenu1UBw collected $0.50 from pot
GUnvMULl2qFOO1yenu1UBw: doesn't show hand
*** SUMMARY ***
Total pot $0.50 | Rake $0
Seat 1: BgOXYI0yYSN1ULC4FqsNkg folded before Flop (didn't bet)
Seat 2: vhWS+cwAJNd3JzqVzIjBZA folded before Flop (didn't bet)
Seat 3: JFLrYNyQmwPhRQAtoSAuyA (button) folded before Flop (didn't bet)
Seat 4: 4QfsCWthT/vSLirorNXqtg (small blind) folded before Flop
Seat 5: GUnvMULl2qFOO1yenu1UBw (big blind) collected ($0.50)



PokerStars Game #59941623752:  Hold'em No Limit ($0.25/$0.50) - 2009/07/01 1:41:03 ET
Table 'BCN5su+SsXiy1zRMJi0SJw' 6-max Seat #1 is the button
Seat 1: GxXV09ciXaOxyY2H5aMIIw ($34.20 in chips)
Seat 2: ehFNAevCQri3trWxV6FJdA ($85.10 in chips)
Seat 3: kwgv5lNhiFrfONXCshzxlA ($71.30 in chips)
Seat 4: bbsK8j+tpuVRhBqDzHxf7w ($49.85 in chips)
Seat 5: kxPhs4ePFqMy52CInAJ2aw ($49.75 in chips)
Seat 6: b2symlOdL7+0c9Pj4N/KlA ($78.70 in chips)
ehFNAevCQri3trWxV6FJdA: posts small blind $0.25
kwgv5lNhiFrfONXCshzxlA: posts big blind $0.50
*** HOLE CARDS ***
bbsK8j+tpuVRhBqDzHxf7w: folds
kxPhs4ePFqMy52CInAJ2aw: folds
b2symlOdL7+0c9Pj4N/KlA: folds
GxXV09ciXaOxyY2H5aMIIw: folds
ehFNAevCQri3trWxV6FJdA: calls $0.25
kwgv5lNhiFrfONXCshzxlA: checks
*** FLOP *** [7h Ah Ks]
ehFNAevCQri3trWxV6FJdA: checks
kwgv5lNhiFrfONXCshzxlA: checks
*** TURN *** [7h Ah Ks] [Jc]
ehFNAevCQri3trWxV6FJdA: checks
kwgv5lNhiFrfONXCshzxlA: checks
*** RIVER *** [7h Ah Ks Jc] [Kd]
ehFNAevCQri3trWxV6FJdA: bets $1
kwgv5lNhiFrfONXCshzxlA: folds
ehFNAevCQri3trWxV6FJdA collected $0.95 from pot
*** SUMMARY ***
Total pot $1 | Rake $0.05
Board [7h Ah Ks Jc Kd]
Seat 1: GxXV09ciXaOxyY2H5aMIIw (button) folded before Flop (didn't bet)
Seat 2: ehFNAevCQri3trWxV6FJdA (small blind) collected ($0.95)
Seat 3: kwgv5lNhiFrfONXCshzxlA (big blind) folded on the River
Seat 4: bbsK8j+tpuVRhBqDzHxf7w folded before Flop (didn't bet)
Seat 5: kxPhs4ePFqMy52CInAJ2aw folded before Flop (didn't bet)
Seat 6: b2symlOdL7+0c9Pj4N/KlA folded before Flop (didn't bet)



PokerStars Game #59941624060:  Hold'em No Limit ($0.25/$0.50) - 2009/07/01 1:41:04 ET
Table '2lPOwetm4cfkZPbTmGPH/w' 2-max Seat #2 is the button
Seat 1: vUGdApqS8J/GJE2gaVWl1w ($7.95 in chips)
Seat 2: XFa6sBGjP2gxoIvxR3fZIg ($29 in chips)
XFa6sBGjP2gxoIvxR3fZIg: posts small blind $0.25
vUGdApqS8J/GJE2gaVWl1w: posts big blind $0.50
*** HOLE CARDS ***
XFa6sBGjP2gxoIvxR3fZIg: calls $0.25
vUGdApqS8J/GJE2gaVWl1w: checks
*** FLOP *** [2d 9c Ks]
vUGdApqS8J/GJE2gaVWl1w: checks
XFa6sBGjP2gxoIvxR3fZIg: checks
*** TURN *** [2d 9c Ks] [Jc]
vUGdApqS8J/GJE2gaVWl1w: bets $0.50
XFa6sBGjP2gxoIvxR3fZIg: calls $0.50
*** RIVER *** [2d 9c Ks Jc] [Tc]
vUGdApqS8J/GJE2gaVWl1w: bets $2.50
XFa6sBGjP2gxoIvxR3fZIg: raises $22 to $24.50
vUGdApqS8J/GJE2gaVWl1w: calls $4.45 and is all-in
*** SHOW DOWN ***
XFa6sBGjP2gxoIvxR3fZIg: shows [3h Qh] (a straight, Nine to King)
vUGdApqS8J/GJE2gaVWl1w: shows [2c 3c] (a flush, Jack high)
vUGdApqS8J/GJE2gaVWl1w collected $15.40 from pot
*** SUMMARY ***
Total pot $15.90 | Rake $0.50
Board [2d 9c Ks Jc Tc]
Seat 1: vUGdApqS8J/GJE2gaVWl1w (big blind) showed [2c 3c] and won ($15.40) with a flush, Jack high
Seat 2: XFa6sBGjP2gxoIvxR3fZIg (button) (small blind) showed [3h Qh] and lost with a straight, Nine to King



PokerStars Game #59941625440:  Hold'em No Limit ($0.25/$0.50) - 2009/07/01 1:41:06 ET
Table 'ZYI3ZReBjdfKEYItkZHI6A' 9-max Seat #6 is the button
Seat 1: IYd5zG8k7vdBNVHbHg2Pag ($60.40 in chips)
Seat 2: 5acK4E7fzEwnplVBZ6eNWA ($50 in chips)
Seat 3: 75K2MXwN65Sjfp1yHd50Hg ($8.50 in chips)
Seat 4: /UdtxmXsFx6K/14AbHqzbQ ($7.75 in chips)
Seat 5: ApHP7ouup365XIUFBdEDxg ($19.60 in chips)
Seat 6: 1xBtrSVBbgFH/viUWKqQeg ($37 in chips)
Seat 8: ji04uOybxCdpdefzlUQeKQ ($29.05 in chips)
Seat 9: HZkVla4kK2SI42CVrPZ/ig ($10.40 in chips)
ji04uOybxCdpdefzlUQeKQ: posts small blind $0.25
HZkVla4kK2SI42CVrPZ/ig: posts big blind $0.50
*** HOLE CARDS ***
IYd5zG8k7vdBNVHbHg2Pag: folds
5acK4E7fzEwnplVBZ6eNWA: folds
ApHP7ouup365XIUFBdEDxg said, "AK?"
75K2MXwN65Sjfp1yHd50Hg: folds
/UdtxmXsFx6K/14AbHqzbQ: folds
ApHP7ouup365XIUFBdEDxg: folds
1xBtrSVBbgFH/viUWKqQeg: folds
ji04uOybxCdpdefzlUQeKQ: folds
HZkVla4kK2SI42CVrPZ/ig collected $0.50 from pot
HZkVla4kK2SI42CVrPZ/ig: doesn't show hand
*** SUMMARY ***
Total pot $0.50 | Rake $0
Seat 1: IYd5zG8k7vdBNVHbHg2Pag folded before Flop (didn't bet)
Seat 2: 5acK4E7fzEwnplVBZ6eNWA folded before Flop (didn't bet)
Seat 3: 75K2MXwN65Sjfp1yHd50Hg folded before Flop (didn't bet)
Seat 4: /UdtxmXsFx6K/14AbHqzbQ folded before Flop (didn't bet)
Seat 5: ApHP7ouup365XIUFBdEDxg folded before Flop (didn't bet)
Seat 6: 1xBtrSVBbgFH/viUWKqQeg (button) folded before Flop (didn't bet)
Seat 8: ji04uOybxCdpdefzlUQeKQ (small blind) folded before Flop
Seat 9: HZkVla4kK2SI42CVrPZ/ig (big blind) collected ($0.50)



PokerStars Game #59941626042:  Hold'em No Limit ($0.25/$0.50) - 2009/07/01 1:41:07 ET
Table '8BQGgNetI1NOvWeu3gtMNw' 2-max Seat #2 is the button
Seat 1: bypIyrYcAAifLfhZpGlKLA ($84.35 in chips)
Seat 2: Z4HwehErEwzsv/noQlfUlg ($128.10 in chips)
Z4HwehErEwzsv/noQlfUlg: posts small blind $0.25
bypIyrYcAAifLfhZpGlKLA: posts big blind $0.50
*** HOLE CARDS ***
Z4HwehErEwzsv/noQlfUlg: calls $0.25
bypIyrYcAAifLfhZpGlKLA: checks
*** FLOP *** [Tc 5s 7c]
bypIyrYcAAifLfhZpGlKLA: bets $1
Z4HwehErEwzsv/noQlfUlg: raises $1 to $2
bypIyrYcAAifLfhZpGlKLA: calls $1
*** TURN *** [Tc 5s 7c] [9d]
bypIyrYcAAifLfhZpGlKLA: bets $1
Z4HwehErEwzsv/noQlfUlg: raises $4 to $5
bypIyrYcAAifLfhZpGlKLA: calls $4
*** RIVER *** [Tc 5s 7c 9d] [7s]
bypIyrYcAAifLfhZpGlKLA: checks
Z4HwehErEwzsv/noQlfUlg: bets $15
bypIyrYcAAifLfhZpGlKLA: folds
Z4HwehErEwzsv/noQlfUlg collected $14.50 from pot
Z4HwehErEwzsv/noQlfUlg: doesn't show hand
*** SUMMARY ***
Total pot $15 | Rake $0.50
Board [Tc 5s 7c 9d 7s]
Seat 1: bypIyrYcAAifLfhZpGlKLA (big blind) folded on the River
Seat 2: Z4HwehErEwzsv/noQlfUlg (button) (small blind) collected ($14.50)



PokerStars Game #59941626536:  Hold'em No Limit ($0.25/$0.50) - 2009/07/01 1:41:08 ET
Table 'B+sqsfj6d6zXicNfaseTaw' 2-max Seat #1 is the button
Seat 1: +4GNcSsecmapVGSdV0mUPA ($145 in chips)
Seat 2: Lv5RmpRe6LtPkBzM9Gpo5A ($74.90 in chips)
+4GNcSsecmapVGSdV0mUPA: posts small blind $0.25
Lv5RmpRe6LtPkBzM9Gpo5A: posts big blind $0.50
*** HOLE CARDS ***
+4GNcSsecmapVGSdV0mUPA: calls $0.25
Lv5RmpRe6LtPkBzM9Gpo5A: checks
*** FLOP *** [Tc 3c 4s]
Lv5RmpRe6LtPkBzM9Gpo5A: checks
+4GNcSsecmapVGSdV0mUPA: checks
*** TURN *** [Tc 3c 4s] [Td]
Lv5RmpRe6LtPkBzM9Gpo5A: checks
+4GNcSsecmapVGSdV0mUPA: checks
*** RIVER *** [Tc 3c 4s Td] [4h]
Lv5RmpRe6LtPkBzM9Gpo5A: checks
+4GNcSsecmapVGSdV0mUPA: checks
*** SHOW DOWN ***
Lv5RmpRe6LtPkBzM9Gpo5A: shows [Qc Jh] (two pair, Tens and Fours)
+4GNcSsecmapVGSdV0mUPA: shows [8s Kc] (two pair, Tens and Fours - King kicker)
+4GNcSsecmapVGSdV0mUPA collected $0.95 from pot
*** SUMMARY ***
Total pot $1 | Rake $0.05
Board [Tc 3c 4s Td 4h]
Seat 1: +4GNcSsecmapVGSdV0mUPA (button) (small blind) showed [8s Kc] and won ($0.95) with two pair, Tens and Fours
Seat 2: Lv5RmpRe6LtPkBzM9Gpo5A (big blind) showed [Qc Jh] and lost with two pair, Tens and Fours



PokerStars Game #59941626580:  Hold'em No Limit ($0.25/$0.50) - 2009/07/01 1:41:08 ET
Table 'lSisgp6H7Fg1hH5VfjEjYQ' 9-max Seat #3 is the button
Seat 1: 5k9fvXD9suIgCxU4HLQjTw ($53.30 in chips)
Seat 2: 5acK4E7fzEwnplVBZ6eNWA ($50.95 in chips)
Seat 3: SKnJuWHScqetA/qG5p+wCg ($30 in chips)
Seat 4: FFVKBJT0lZf+jFlgvy7ang ($38.50 in chips)
Seat 5: mSD1pginDsyHG5PDfqzphw ($16.75 in chips)
Seat 6: +k7T5ocke8UwavtgUHm+Cg ($75.90 in chips)
Seat 7: IDtNLR9uFCDdjNsJWMHA5Q ($22.90 in chips)
Seat 8: a4JDWmpFQkL10XfAyuF51A ($10.45 in chips)
FFVKBJT0lZf+jFlgvy7ang: posts small blind $0.25
mSD1pginDsyHG5PDfqzphw: posts big blind $0.50
*** HOLE CARDS ***
YzeKFbJVLmJGTgNH3ySQlw leaves the table
+k7T5ocke8UwavtgUHm+Cg: folds
IDtNLR9uFCDdjNsJWMHA5Q: folds
a4JDWmpFQkL10XfAyuF51A: calls $0.50
5k9fvXD9suIgCxU4HLQjTw: calls $0.50
5acK4E7fzEwnplVBZ6eNWA: folds
SKnJuWHScqetA/qG5p+wCg: folds
FFVKBJT0lZf+jFlgvy7ang: calls $0.25
mSD1pginDsyHG5PDfqzphw: checks
*** FLOP *** [4c Th Jd]
FFVKBJT0lZf+jFlgvy7ang: checks
mSD1pginDsyHG5PDfqzphw: checks
M+D23GG26WXQ/2gyjREVOQ joins the table at seat #9
a4JDWmpFQkL10XfAyuF51A: bets $2
5k9fvXD9suIgCxU4HLQjTw: folds
FFVKBJT0lZf+jFlgvy7ang: folds
mSD1pginDsyHG5PDfqzphw: folds
a4JDWmpFQkL10XfAyuF51A collected $1.90 from pot
*** SUMMARY ***
Total pot $2 | Rake $0.10
Board [4c Th Jd]
Seat 1: 5k9fvXD9suIgCxU4HLQjTw folded on the Flop
Seat 2: 5acK4E7fzEwnplVBZ6eNWA folded before Flop (didn't bet)
Seat 3: SKnJuWHScqetA/qG5p+wCg (button) folded before Flop (didn't bet)
Seat 4: FFVKBJT0lZf+jFlgvy7ang (small blind) folded on the Flop
Seat 5: mSD1pginDsyHG5PDfqzphw (big blind) folded on the Flop
Seat 6: +k7T5ocke8UwavtgUHm+Cg folded before Flop (didn't bet)
Seat 7: IDtNLR9uFCDdjNsJWMHA5Q folded before Flop (didn't bet)
Seat 8: a4JDWmpFQkL10XfAyuF51A collected ($1.90)



PokerStars Game #59941628684:  Hold'em No Limit ($0.25/$0.50) - 2009/07/01 1:41:12 ET
Table 'tyR5AZNKV8Aadbrnrnlg7g' 6-max Seat #4 is the button
Seat 1: BgOXYI0yYSN1ULC4FqsNkg ($76.05 in chips)
Seat 2: vhWS+cwAJNd3JzqVzIjBZA ($50 in chips)
Seat 3: JFLrYNyQmwPhRQAtoSAuyA ($60.85 in chips)
Seat 4: 4QfsCWthT/vSLirorNXqtg ($82.20 in chips)
Seat 5: GUnvMULl2qFOO1yenu1UBw ($76.60 in chips)
GUnvMULl2qFOO1yenu1UBw: posts small blind $0.25
BgOXYI0yYSN1ULC4FqsNkg: posts big blind $0.50
*** HOLE CARDS ***
vhWS+cwAJNd3JzqVzIjBZA: folds
JFLrYNyQmwPhRQAtoSAuyA: folds
4QfsCWthT/vSLirorNXqtg: raises $1 to $1.50
GUnvMULl2qFOO1yenu1UBw: folds
BgOXYI0yYSN1ULC4FqsNkg: folds
4QfsCWthT/vSLirorNXqtg collected $1.25 from pot
4QfsCWthT/vSLirorNXqtg: doesn't show hand
*** SUMMARY ***
Total pot $1.25 | Rake $0
Seat 1: BgOXYI0yYSN1ULC4FqsNkg (big blind) folded before Flop
Seat 2: vhWS+cwAJNd3JzqVzIjBZA folded before Flop (didn't bet)
Seat 3: JFLrYNyQmwPhRQAtoSAuyA folded before Flop (didn't bet)
Seat 4: 4QfsCWthT/vSLirorNXqtg (button) collected ($1.25)
Seat 5: GUnvMULl2qFOO1yenu1UBw (small blind) folded before Flop



PokerStars Game #59941629902:  Hold'em No Limit ($0.25/$0.50) - 2009/07/01 1:41:14 ET
Table '5EmHi+fnatGQQShcNmzOZQ' 6-max Seat #3 is the button
Seat 1: avNOJXWxD1+SygFmWsd+qw ($66.60 in chips)
Seat 2: OZ6OtYh5Y53MCH/p0QTn5g ($50 in chips)
Seat 3: QmH/ZFyxZfvliy57YM9yxw ($76.80 in chips)
Seat 4: 1b+2BbjMN8qhR1WPqdE9VQ ($54.70 in chips)
Seat 5: 6yWjZXHP6iAyMEDF6pJlng ($56.05 in chips)
Seat 6: u3Ol7kv1LmvszuHNm9rc6w ($5.10 in chips)
1b+2BbjMN8qhR1WPqdE9VQ: posts small blind $0.25
6yWjZXHP6iAyMEDF6pJlng: posts big blind $0.50
*** HOLE CARDS ***
u3Ol7kv1LmvszuHNm9rc6w: raises $4.60 to $5.10 and is all-in
avNOJXWxD1+SygFmWsd+qw: folds
OZ6OtYh5Y53MCH/p0QTn5g: folds
QmH/ZFyxZfvliy57YM9yxw: folds
1b+2BbjMN8qhR1WPqdE9VQ: calls $4.85
6yWjZXHP6iAyMEDF6pJlng: folds
*** FLOP *** [6h 8c 6s]
*** TURN *** [6h 8c 6s] [4h]
*** RIVER *** [6h 8c 6s 4h] [Qd]
*** SHOW DOWN ***
1b+2BbjMN8qhR1WPqdE9VQ: shows [9d 9s] (two pair, Nines and Sixes)
u3Ol7kv1LmvszuHNm9rc6w: mucks hand
1b+2BbjMN8qhR1WPqdE9VQ collected $10.20 from pot
*** SUMMARY ***
Total pot $10.70 | Rake $0.50
Board [6h 8c 6s 4h Qd]
Seat 1: avNOJXWxD1+SygFmWsd+qw folded before Flop (didn't bet)
Seat 2: OZ6OtYh5Y53MCH/p0QTn5g folded before Flop (didn't bet)
Seat 3: QmH/ZFyxZfvliy57YM9yxw (button) folded before Flop (didn't bet)
Seat 4: 1b+2BbjMN8qhR1WPqdE9VQ (small blind) showed [9d 9s] and won ($10.20) with two pair, Nines and Sixes
Seat 5: 6yWjZXHP6iAyMEDF6pJlng (big blind) folded before Flop
Seat 6: u3Ol7kv1LmvszuHNm9rc6w mucked



PokerStars Game #59941631196:  Hold'em No Limit ($0.25/$0.50) - 2009/07/01 1:41:17 ET
Table 'b14oxfBMAjhXizfPVeTHng' 2-max Seat #1 is the button
Seat 1: NKw4WYm5uUoeEVf4i0fBvA ($20.85 in chips)
Seat 2: FeErMt4Gvt/3PH2oB/pn4A ($10 in chips)
NKw4WYm5uUoeEVf4i0fBvA: posts small blind $0.25
FeErMt4Gvt/3PH2oB/pn4A: posts big blind $0.50
*** HOLE CARDS ***
NKw4WYm5uUoeEVf4i0fBvA said, "wat do those stars mean?"
NKw4WYm5uUoeEVf4i0fBvA: calls $0.25
FeErMt4Gvt/3PH2oB/pn4A: checks
*** FLOP *** [Ac As Js]
NKw4WYm5uUoeEVf4i0fBvA said, "under ur name"
FeErMt4Gvt/3PH2oB/pn4A said, "u can earn vvp in games"
FeErMt4Gvt/3PH2oB/pn4A: checks
NKw4WYm5uUoeEVf4i0fBvA: checks
*** TURN *** [Ac As Js] [4c]
NKw4WYm5uUoeEVf4i0fBvA said, "FPPs?"
FeErMt4Gvt/3PH2oB/pn4A said, "and if u have won about 1200 vpp/ fpp u get silverstar(2 stars)"
FeErMt4Gvt/3PH2oB/pn4A: checks
NKw4WYm5uUoeEVf4i0fBvA: checks
*** RIVER *** [Ac As Js 4c] [Qc]
FeErMt4Gvt/3PH2oB/pn4A said, "in 1 month"
FeErMt4Gvt/3PH2oB/pn4A: checks
NKw4WYm5uUoeEVf4i0fBvA: checks
*** SHOW DOWN ***
FeErMt4Gvt/3PH2oB/pn4A: shows [6h 5c] (a pair of Aces)
NKw4WYm5uUoeEVf4i0fBvA: shows [3c 9h] (a pair of Aces - Queen+Jack+Nine kicker)
NKw4WYm5uUoeEVf4i0fBvA collected $0.95 from pot
*** SUMMARY ***
Total pot $1 | Rake $0.05
Board [Ac As Js 4c Qc]
Seat 1: NKw4WYm5uUoeEVf4i0fBvA (button) (small blind) showed [3c 9h] and won ($0.95) with a pair of Aces
Seat 2: FeErMt4Gvt/3PH2oB/pn4A (big blind) showed [6h 5c] and lost with a pair of Aces



PokerStars Game #59941631358:  Hold'em No Limit ($0.25/$0.50) - 2009/07/01 1:41:17 ET
Table 'GfL/No5u5PoEnU39lP5pQg' 6-max Seat #4 is the button
Seat 2: uVwggSetzp7d+eVgowO3vg ($53.75 in chips)
Seat 3: 4pp9WxhGdbVbxCc9tlu0lw ($27.05 in chips)
Seat 4: ifQmgsYNFiAg/XvBOMBSfQ ($49.25 in chips)
Seat 5: M1KyQQvVPVuxqTAB8sR/zQ ($50 in chips)
Seat 6: kxPhs4ePFqMy52CInAJ2aw ($103.10 in chips)
M1KyQQvVPVuxqTAB8sR/zQ: posts small blind $0.25
kxPhs4ePFqMy52CInAJ2aw: posts big blind $0.50
6qJZP2EKIgnEXJ3tMSBuew: sits out
*** HOLE CARDS ***
uVwggSetzp7d+eVgowO3vg: folds
4pp9WxhGdbVbxCc9tlu0lw: folds
ifQmgsYNFiAg/XvBOMBSfQ: folds
M1KyQQvVPVuxqTAB8sR/zQ: folds
kxPhs4ePFqMy52CInAJ2aw collected $0.50 from pot
kxPhs4ePFqMy52CInAJ2aw: doesn't show hand
*** SUMMARY ***
Total pot $0.50 | Rake $0
Seat 2: uVwggSetzp7d+eVgowO3vg folded before Flop (didn't bet)
Seat 3: 4pp9WxhGdbVbxCc9tlu0lw folded before Flop (didn't bet)
Seat 4: ifQmgsYNFiAg/XvBOMBSfQ (button) folded before Flop (didn't bet)
Seat 5: M1KyQQvVPVuxqTAB8sR/zQ (small blind) folded before Flop
Seat 6: kxPhs4ePFqMy52CInAJ2aw (big blind) collected ($0.50)



PokerStars Game #59941632100:  Hold'em No Limit ($0.25/$0.50) - 2009/07/01 1:41:18 ET
Table 'hWT2kq66tnKEpD26cia6fQ' 2-max Seat #1 is the button
Seat 1: Ce3KNFP+ao7Da9NHb65raw ($29.40 in chips)
Seat 2: 16tvT7AYgZ2LgiGFcvFKQg ($43.45 in chips)
Ce3KNFP+ao7Da9NHb65raw: posts small blind $0.25
16tvT7AYgZ2LgiGFcvFKQg: posts big blind $0.50
*** HOLE CARDS ***
Ce3KNFP+ao7Da9NHb65raw: calls $0.25
16tvT7AYgZ2LgiGFcvFKQg: raises $0.50 to $1
Ce3KNFP+ao7Da9NHb65raw: calls $0.50
*** FLOP *** [2h Tc 8c]
16tvT7AYgZ2LgiGFcvFKQg: bets $0.50
Ce3KNFP+ao7Da9NHb65raw: folds
16tvT7AYgZ2LgiGFcvFKQg collected $1.90 from pot
*** SUMMARY ***
Total pot $2 | Rake $0.10
Board [2h Tc 8c]
Seat 1: Ce3KNFP+ao7Da9NHb65raw (button) (small blind) folded on the Flop
Seat 2: 16tvT7AYgZ2LgiGFcvFKQg (big blind) collected ($1.90)



PokerStars Game #59941633622:  Hold'em No Limit ($0.25/$0.50) - 2009/07/01 1:41:21 ET
Table '9ojijpRcYQSQTh6xI+haUA' 2-max Seat #1 is the button
Seat 1: FqpibuVWLNsAN/Z7ROZLnA ($47.60 in chips)
Seat 2: TitTV+fFCcBZWOERdytydA ($75.25 in chips)
FqpibuVWLNsAN/Z7ROZLnA: posts small blind $0.25
TitTV+fFCcBZWOERdytydA: posts big blind $0.50
*** HOLE CARDS ***
FqpibuVWLNsAN/Z7ROZLnA: raises $0.50 to $1
TitTV+fFCcBZWOERdytydA: calls $0.50
*** FLOP *** [Ks Tc 2c]
TitTV+fFCcBZWOERdytydA: checks
FqpibuVWLNsAN/Z7ROZLnA: checks
*** TURN *** [Ks Tc 2c] [Th]
TitTV+fFCcBZWOERdytydA: checks
FqpibuVWLNsAN/Z7ROZLnA: bets $1.50
TitTV+fFCcBZWOERdytydA: raises $3 to $4.50
FqpibuVWLNsAN/Z7ROZLnA: calls $3
*** RIVER *** [Ks Tc 2c Th] [4h]
TitTV+fFCcBZWOERdytydA: checks
FqpibuVWLNsAN/Z7ROZLnA: checks
*** SHOW DOWN ***
TitTV+fFCcBZWOERdytydA: shows [5s 8s] (a pair of Tens)
FqpibuVWLNsAN/Z7ROZLnA: shows [Kc Qs] (two pair, Kings and Tens)
FqpibuVWLNsAN/Z7ROZLnA collected $10.50 from pot
*** SUMMARY ***
Total pot $11 | Rake $0.50
Board [Ks Tc 2c Th 4h]
Seat 1: FqpibuVWLNsAN/Z7ROZLnA (button) (small blind) showed [Kc Qs] and won ($10.50) with two pair, Kings and Tens
Seat 2: TitTV+fFCcBZWOERdytydA (big blind) showed [5s 8s] and lost with a pair of Tens



PokerStars Game #59941634046:  Hold'em No Limit ($0.25/$0.50) - 2009/07/01 1:41:22 ET
Table 'kgbJRsxfv64KrErDRBAkcw' 6-max Seat #4 is the button
Seat 2: AdS8BJMOheS01zjCDfPMFg ($88.60 in chips)
Seat 3: c4MNIaIyPMOMxrgT8FT5nA ($155.25 in chips)
Seat 4: 2igtJLmvIZ+HqX4XPgMPZA ($111.75 in chips)
Seat 5: eUBBn2R56C1IQ6Cs/vitwg ($105.50 in chips)
Seat 6: 1b+2BbjMN8qhR1WPqdE9VQ ($55.70 in chips)
eUBBn2R56C1IQ6Cs/vitwg: posts small blind $0.25
1b+2BbjMN8qhR1WPqdE9VQ: posts big blind $0.50
*** HOLE CARDS ***
AdS8BJMOheS01zjCDfPMFg: folds
c4MNIaIyPMOMxrgT8FT5nA: folds
2igtJLmvIZ+HqX4XPgMPZA: folds
eUBBn2R56C1IQ6Cs/vitwg: raises $1 to $1.50
1b+2BbjMN8qhR1WPqdE9VQ: calls $1
*** FLOP *** [Kh 3c Ts]
eUBBn2R56C1IQ6Cs/vitwg: bets $2.50
VamsyhlFzXGF6/ydo0BHeA leaves the table
1b+2BbjMN8qhR1WPqdE9VQ: calls $2.50
*** TURN *** [Kh 3c Ts] [2s]
eUBBn2R56C1IQ6Cs/vitwg: bets $5
k0xQy0tZZC75zf+pcK0bkQ joins the table at seat #1
1b+2BbjMN8qhR1WPqdE9VQ: folds
eUBBn2R56C1IQ6Cs/vitwg collected $7.65 from pot
*** SUMMARY ***
Total pot $8 | Rake $0.35
Board [Kh 3c Ts 2s]
Seat 2: AdS8BJMOheS01zjCDfPMFg folded before Flop (didn't bet)
Seat 3: c4MNIaIyPMOMxrgT8FT5nA folded before Flop (didn't bet)
Seat 4: 2igtJLmvIZ+HqX4XPgMPZA (button) folded before Flop (didn't bet)
Seat 5: eUBBn2R56C1IQ6Cs/vitwg (small blind) collected ($7.65)
Seat 6: 1b+2BbjMN8qhR1WPqdE9VQ (big blind) folded on the Turn



PokerStars Game #59941634208:  Hold'em No Limit ($0.25/$0.50) - 2009/07/01 1:41:22 ET
Table 'ErOuyGLI5PT3G5MnpHgC/g' 9-max Seat #7 is the button
Seat 1: eBrej2jnlUCs/JgxFCRn2g ($47.35 in chips)
Seat 2: pciZn00ZDk4BVBMTTMcNVQ ($21.50 in chips)
Seat 3: xZCXQSXlrZkp3pZizzVXCw ($49.25 in chips)
Seat 4: YRqrX/u38J7aLNNnBzQsjQ ($19.05 in chips)
Seat 5: JwvquocWfhTVApN5t47LgA ($48.30 in chips)
Seat 6: zE9cVigS2nW/Ljy4K4bUQA ($30 in chips)
Seat 7: 90Wb75h3W1BRpbqVnuk8gw ($61.45 in chips)
Seat 8: g4k0NXISyLCqaSWZDBjfEg ($50 in chips)
Seat 9: J0W5D97jl5VLky+IoPvDeA ($64.50 in chips)
g4k0NXISyLCqaSWZDBjfEg: posts small blind $0.25
J0W5D97jl5VLky+IoPvDeA: posts big blind $0.50
*** HOLE CARDS ***
eBrej2jnlUCs/JgxFCRn2g: raises $1.50 to $2
pciZn00ZDk4BVBMTTMcNVQ: folds
xZCXQSXlrZkp3pZizzVXCw: folds
xZCXQSXlrZkp3pZizzVXCw is sitting out
YRqrX/u38J7aLNNnBzQsjQ: folds
JwvquocWfhTVApN5t47LgA: folds
zE9cVigS2nW/Ljy4K4bUQA: folds
zE9cVigS2nW/Ljy4K4bUQA leaves the table
xZCXQSXlrZkp3pZizzVXCw has returned
90Wb75h3W1BRpbqVnuk8gw: calls $2
g4k0NXISyLCqaSWZDBjfEg: folds
J0W5D97jl5VLky+IoPvDeA: folds
*** FLOP *** [Jh 4d Ah]
eBrej2jnlUCs/JgxFCRn2g: checks
90Wb75h3W1BRpbqVnuk8gw: checks
*** TURN *** [Jh 4d Ah] [8s]
eBrej2jnlUCs/JgxFCRn2g: bets $1
90Wb75h3W1BRpbqVnuk8gw: raises $3 to $4
eBrej2jnlUCs/JgxFCRn2g: raises $3 to $7
90Wb75h3W1BRpbqVnuk8gw: folds
eBrej2jnlUCs/JgxFCRn2g collected $12.15 from pot
*** SUMMARY ***
Total pot $12.75 | Rake $0.60
Board [Jh 4d Ah 8s]
Seat 1: eBrej2jnlUCs/JgxFCRn2g collected ($12.15)
Seat 2: pciZn00ZDk4BVBMTTMcNVQ folded before Flop (didn't bet)
Seat 3: xZCXQSXlrZkp3pZizzVXCw folded before Flop (didn't bet)
Seat 4: YRqrX/u38J7aLNNnBzQsjQ folded before Flop (didn't bet)
Seat 5: JwvquocWfhTVApN5t47LgA folded before Flop (didn't bet)
Seat 6: zE9cVigS2nW/Ljy4K4bUQA folded before Flop (didn't bet)
Seat 7: 90Wb75h3W1BRpbqVnuk8gw (button) folded on the Turn
Seat 8: g4k0NXISyLCqaSWZDBjfEg (small blind) folded before Flop
Seat 9: J0W5D97jl5VLky+IoPvDeA (big blind) folded before Flop



PokerStars Game #59941634572:  Hold'em No Limit ($0.25/$0.50) - 2009/07/01 1:41:23 ET
Table 'B+sqsfj6d6zXicNfaseTaw' 2-max Seat #2 is the button
Seat 1: +4GNcSsecmapVGSdV0mUPA ($145.45 in chips)
Seat 2: Lv5RmpRe6LtPkBzM9Gpo5A ($74.40 in chips)
Lv5RmpRe6LtPkBzM9Gpo5A: posts small blind $0.25
+4GNcSsecmapVGSdV0mUPA: posts big blind $0.50
*** HOLE CARDS ***
Lv5RmpRe6LtPkBzM9Gpo5A: calls $0.25
+4GNcSsecmapVGSdV0mUPA: raises $1 to $1.50
Lv5RmpRe6LtPkBzM9Gpo5A: calls $1
*** FLOP *** [6d 7s Ah]
+4GNcSsecmapVGSdV0mUPA: checks
Lv5RmpRe6LtPkBzM9Gpo5A: checks
*** TURN *** [6d 7s Ah] [2c]
+4GNcSsecmapVGSdV0mUPA: bets $1
Lv5RmpRe6LtPkBzM9Gpo5A: folds
+4GNcSsecmapVGSdV0mUPA collected $2.85 from pot
+4GNcSsecmapVGSdV0mUPA: doesn't show hand
*** SUMMARY ***
Total pot $3 | Rake $0.15
Board [6d 7s Ah 2c]
Seat 1: +4GNcSsecmapVGSdV0mUPA (big blind) collected ($2.85)
Seat 2: Lv5RmpRe6LtPkBzM9Gpo5A (button) (small blind) folded on the Turn



PokerStars Game #59941634816:  Hold'em No Limit ($0.25/$0.50) - 2009/07/01 1:41:23 ET
Table 'iq+aXfWVQRdV0u8SRTYUEg' 9-max Seat #5 is the button
Seat 1: 3yl8Q6QaLfGtyhN4/pEFgQ ($71.55 in chips)
Seat 2: J9N0lxHFd/Js2S0xZLbsIQ ($32.45 in chips)
Seat 3: bMkgDRXl6YaqJ4b/5qml2Q ($10 in chips)
Seat 4: vHYT5s323LpajBj+2c9zbQ ($24.85 in chips)
Seat 5: 997ViqAtWn1FPjJqcffwcA ($56.65 in chips)
Seat 6: bTJ0WgoxefTPxIoycS7uoA ($25.45 in chips)
Seat 8: /DtIHuxEH+3tzKefmSV+Mw ($42.15 in chips)
bTJ0WgoxefTPxIoycS7uoA: posts small blind $0.25
SKnJuWHScqetA/qG5p+wCg: is sitting out
/DtIHuxEH+3tzKefmSV+Mw: posts big blind $0.50
drKg+7JekfxR/0poTEK9Tg: sits out
bMkgDRXl6YaqJ4b/5qml2Q: posts big blind $0.50
*** HOLE CARDS ***
3yl8Q6QaLfGtyhN4/pEFgQ: calls $0.50
J9N0lxHFd/Js2S0xZLbsIQ: folds
bMkgDRXl6YaqJ4b/5qml2Q: checks
vHYT5s323LpajBj+2c9zbQ: folds
997ViqAtWn1FPjJqcffwcA: folds
SKnJuWHScqetA/qG5p+wCg leaves the table
bTJ0WgoxefTPxIoycS7uoA: calls $0.25
/DtIHuxEH+3tzKefmSV+Mw: checks
*** FLOP *** [Kc 6h 5h]
bTJ0WgoxefTPxIoycS7uoA: checks
/DtIHuxEH+3tzKefmSV+Mw: bets $1.50
3yl8Q6QaLfGtyhN4/pEFgQ: folds
bMkgDRXl6YaqJ4b/5qml2Q: folds
bTJ0WgoxefTPxIoycS7uoA: folds
/DtIHuxEH+3tzKefmSV+Mw collected $1.90 from pot
/DtIHuxEH+3tzKefmSV+Mw: doesn't show hand
*** SUMMARY ***
Total pot $2 | Rake $0.10
Board [Kc 6h 5h]
Seat 1: 3yl8Q6QaLfGtyhN4/pEFgQ folded on the Flop
Seat 2: J9N0lxHFd/Js2S0xZLbsIQ folded before Flop (didn't bet)
Seat 3: bMkgDRXl6YaqJ4b/5qml2Q folded on the Flop
Seat 4: vHYT5s323LpajBj+2c9zbQ folded before Flop (didn't bet)
Seat 5: 997ViqAtWn1FPjJqcffwcA (button) folded before Flop (didn't bet)
Seat 6: bTJ0WgoxefTPxIoycS7uoA (small blind) folded on the Flop
Seat 8: /DtIHuxEH+3tzKefmSV+Mw (big blind) collected ($1.90)



PokerStars Game #59941635266:  Hold'em No Limit ($0.25/$0.50) - 2009/07/01 1:41:24 ET
Table '2lPOwetm4cfkZPbTmGPH/w' 2-max Seat #1 is the button
Seat 1: vUGdApqS8J/GJE2gaVWl1w ($15.40 in chips)
Seat 2: XFa6sBGjP2gxoIvxR3fZIg ($21.05 in chips)
vUGdApqS8J/GJE2gaVWl1w: posts small blind $0.25
XFa6sBGjP2gxoIvxR3fZIg: posts big blind $0.50
*** HOLE CARDS ***
vUGdApqS8J/GJE2gaVWl1w: raises $0.50 to $1
XFa6sBGjP2gxoIvxR3fZIg: calls $0.50
*** FLOP *** [7s Ad Kd]
XFa6sBGjP2gxoIvxR3fZIg: checks
vUGdApqS8J/GJE2gaVWl1w: bets $1.50
XFa6sBGjP2gxoIvxR3fZIg: folds
vUGdApqS8J/GJE2gaVWl1w collected $1.90 from pot
*** SUMMARY ***
Total pot $2 | Rake $0.10
Board [7s Ad Kd]
Seat 1: vUGdApqS8J/GJE2gaVWl1w (button) (small blind) collected ($1.90)
Seat 2: XFa6sBGjP2gxoIvxR3fZIg (big blind) folded on the Flop



PokerStars Game #59941635920:  Hold'em No Limit ($0.25/$0.50) - 2009/07/01 1:41:25 ET
Table '3FhG0gl3kMX3wBEEqj+wnQ' 9-max Seat #2 is the button
Seat 1: bxLSulbgr8LmKNjOzw8URg ($49.75 in chips)
Seat 2: HZkVla4kK2SI42CVrPZ/ig ($9.25 in chips)
Seat 3: YXCE3WOZi8g2sIf3y/plVw ($61.05 in chips)
Seat 4: e2+sK/yjnj94rXOKoxPP2A ($68.75 in chips)
Seat 5: XcLXSUMHSpshK/7Lh0M4Vg ($11.05 in chips)
Seat 6: 997ViqAtWn1FPjJqcffwcA ($109.05 in chips)
Seat 7: mSD1pginDsyHG5PDfqzphw ($19.45 in chips)
Seat 8: j3K/Jujr7PY4ZM2RZvlH6A ($53.65 in chips)
Seat 9: KA0tkubTlbhmo4ju+qgXPg ($43.10 in chips)
YXCE3WOZi8g2sIf3y/plVw: posts small blind $0.25
e2+sK/yjnj94rXOKoxPP2A: posts big blind $0.50
*** HOLE CARDS ***
XcLXSUMHSpshK/7Lh0M4Vg: folds
997ViqAtWn1FPjJqcffwcA: folds
mSD1pginDsyHG5PDfqzphw: folds
j3K/Jujr7PY4ZM2RZvlH6A: raises $2 to $2.50
KA0tkubTlbhmo4ju+qgXPg: folds
bxLSulbgr8LmKNjOzw8URg: folds
HZkVla4kK2SI42CVrPZ/ig: raises $6.75 to $9.25 and is all-in
YXCE3WOZi8g2sIf3y/plVw: folds
e2+sK/yjnj94rXOKoxPP2A: folds
j3K/Jujr7PY4ZM2RZvlH6A: calls $6.75
*** FLOP *** [Kc 4d 6d]
*** TURN *** [Kc 4d 6d] [Ad]
*** RIVER *** [Kc 4d 6d Ad] [3c]
*** SHOW DOWN ***
j3K/Jujr7PY4ZM2RZvlH6A: shows [6c Qs] (a pair of Sixes)
HZkVla4kK2SI42CVrPZ/ig: shows [Qc Ac] (a pair of Aces)
HZkVla4kK2SI42CVrPZ/ig collected $18.30 from pot
*** SUMMARY ***
Total pot $19.25 | Rake $0.95
Board [Kc 4d 6d Ad 3c]
Seat 1: bxLSulbgr8LmKNjOzw8URg folded before Flop (didn't bet)
Seat 2: HZkVla4kK2SI42CVrPZ/ig (button) showed [Qc Ac] and won ($18.30) with a pair of Aces
Seat 3: YXCE3WOZi8g2sIf3y/plVw (small blind) folded before Flop
Seat 4: e2+sK/yjnj94rXOKoxPP2A (big blind) folded before Flop
Seat 5: XcLXSUMHSpshK/7Lh0M4Vg folded before Flop (didn't bet)
Seat 6: 997ViqAtWn1FPjJqcffwcA folded before Flop (didn't bet)
Seat 7: mSD1pginDsyHG5PDfqzphw folded before Flop (didn't bet)
Seat 8: j3K/Jujr7PY4ZM2RZvlH6A showed [6c Qs] and lost with a pair of Sixes
Seat 9: KA0tkubTlbhmo4ju+qgXPg folded before Flop (didn't bet)



PokerStars Game #59941636172:  Hold'em No Limit ($0.25/$0.50) - 2009/07/01 1:41:26 ET
Table 'Nz0Vr7WMHL2g5Uk7dDZjpw' 9-max Seat #3 is the button
Seat 1: 9yMsdgReyOUerNsmTYCCDQ ($8.25 in chips)
Seat 2: SegjDnMxWMujiD57ESNL+g ($19.60 in chips)
Seat 3: c638Xxo+q5F/t5qMtmvmvQ ($50.65 in chips)
Seat 4: uw9QayAAxLM3Hb+HR7mSkg ($8.75 in chips)
Seat 5: WGW0DgjBUXs1ylURHG8vnQ ($15.45 in chips)
Seat 6: 997ViqAtWn1FPjJqcffwcA ($53.75 in chips)
Seat 7: KPLH0gELgFe2OuAnhJFI5w ($27.95 in chips)
Seat 8: aoL+R/61Kxmw69ypuPrWAQ ($26.25 in chips)
Seat 9: mSD1pginDsyHG5PDfqzphw ($16.50 in chips)
uw9QayAAxLM3Hb+HR7mSkg: posts small blind $0.25
WGW0DgjBUXs1ylURHG8vnQ: posts big blind $0.50
*** HOLE CARDS ***
997ViqAtWn1FPjJqcffwcA: raises $1.50 to $2
KPLH0gELgFe2OuAnhJFI5w: folds
aoL+R/61Kxmw69ypuPrWAQ: calls $2
mSD1pginDsyHG5PDfqzphw: folds
9yMsdgReyOUerNsmTYCCDQ: folds
SegjDnMxWMujiD57ESNL+g: folds
c638Xxo+q5F/t5qMtmvmvQ: folds
uw9QayAAxLM3Hb+HR7mSkg: folds
WGW0DgjBUXs1ylURHG8vnQ: calls $1.50
*** FLOP *** [7s 6h 8c]
WGW0DgjBUXs1ylURHG8vnQ: checks
997ViqAtWn1FPjJqcffwcA: checks
aoL+R/61Kxmw69ypuPrWAQ: bets $2.50
WGW0DgjBUXs1ylURHG8vnQ: folds
997ViqAtWn1FPjJqcffwcA: folds
997ViqAtWn1FPjJqcffwcA leaves the table
aoL+R/61Kxmw69ypuPrWAQ collected $5.95 from pot
*** SUMMARY ***
Total pot $6.25 | Rake $0.30
Board [7s 6h 8c]
Seat 1: 9yMsdgReyOUerNsmTYCCDQ folded before Flop (didn't bet)
Seat 2: SegjDnMxWMujiD57ESNL+g folded before Flop (didn't bet)
Seat 3: c638Xxo+q5F/t5qMtmvmvQ (button) folded before Flop (didn't bet)
Seat 4: uw9QayAAxLM3Hb+HR7mSkg (small blind) folded before Flop
Seat 5: WGW0DgjBUXs1ylURHG8vnQ (big blind) folded on the Flop
Seat 6: 997ViqAtWn1FPjJqcffwcA folded on the Flop
Seat 7: KPLH0gELgFe2OuAnhJFI5w folded before Flop (didn't bet)
Seat 8: aoL+R/61Kxmw69ypuPrWAQ collected ($5.95)
Seat 9: mSD1pginDsyHG5PDfqzphw folded before Flop (didn't bet)



PokerStars Game #59941637142:  Hold'em No Limit ($0.25/$0.50) - 2009/07/01 1:41:27 ET
Table 'tyR5AZNKV8Aadbrnrnlg7g' 6-max Seat #5 is the button
Seat 1: BgOXYI0yYSN1ULC4FqsNkg ($75.55 in chips)
Seat 2: vhWS+cwAJNd3JzqVzIjBZA ($50 in chips)
Seat 3: JFLrYNyQmwPhRQAtoSAuyA ($60.85 in chips)
Seat 4: 4QfsCWthT/vSLirorNXqtg ($82.95 in chips)
Seat 5: GUnvMULl2qFOO1yenu1UBw ($76.35 in chips)
BgOXYI0yYSN1ULC4FqsNkg: posts small blind $0.25
vhWS+cwAJNd3JzqVzIjBZA: posts big blind $0.50
*** HOLE CARDS ***
JFLrYNyQmwPhRQAtoSAuyA: folds
4QfsCWthT/vSLirorNXqtg: folds
GUnvMULl2qFOO1yenu1UBw: folds
BgOXYI0yYSN1ULC4FqsNkg: calls $0.25
vhWS+cwAJNd3JzqVzIjBZA: checks
*** FLOP *** [2c 9h Qs]
BgOXYI0yYSN1ULC4FqsNkg: checks
vhWS+cwAJNd3JzqVzIjBZA: bets $1
BgOXYI0yYSN1ULC4FqsNkg: folds
vhWS+cwAJNd3JzqVzIjBZA collected $0.95 from pot
vhWS+cwAJNd3JzqVzIjBZA: doesn't show hand
*** SUMMARY ***
Total pot $1 | Rake $0.05
Board [2c 9h Qs]
Seat 1: BgOXYI0yYSN1ULC4FqsNkg (small blind) folded on the Flop
Seat 2: vhWS+cwAJNd3JzqVzIjBZA (big blind) collected ($0.95)
Seat 3: JFLrYNyQmwPhRQAtoSAuyA folded before Flop (didn't bet)
Seat 4: 4QfsCWthT/vSLirorNXqtg folded before Flop (didn't bet)
Seat 5: GUnvMULl2qFOO1yenu1UBw (button) folded before Flop (didn't bet)



PokerStars Game #59941637030:  Hold'em No Limit ($0.25/$0.50) - 2009/07/01 1:41:27 ET
Table 'ofnd8S4IdIPph1Cbn+x7hAbR5MkGhKEbz+X2bpfpu11Qmax Seat #7 is the button
Seat 2: 1xBtrSVBbgFH/viUWKqQeg ($38.05 in chips)
Seat 3: UVJbBPbDwNMEZadZB9WVmg ($9.75 in chips)
Seat 4: mZNMJI1mY40XTC0U7GZakA ($62.20 in chips)
Seat 5: 2YaCb/8u1SesrR+963XiZA ($13.90 in chips)
Seat 6: 0Bw1Gb5YC/Xvb0SqVawKUw ($9.55 in chips)
Seat 7: kJ06FP2Jc7cSdmywwvYOXw ($59.35 in chips)
Seat 8: R354x4oZnQcGCDV6GhjnpQ ($65.75 in chips)
Seat 9: 75K2MXwN65Sjfp1yHd50Hg ($10 in chips)
R354x4oZnQcGCDV6GhjnpQ: posts small blind $0.25
75K2MXwN65Sjfp1yHd50Hg: posts big blind $0.50
6CKPjbH+MB5p5oH9GwiXGA: sits out
*** HOLE CARDS ***
1xBtrSVBbgFH/viUWKqQeg: folds
UVJbBPbDwNMEZadZB9WVmg: folds
mZNMJI1mY40XTC0U7GZakA: folds
2YaCb/8u1SesrR+963XiZA: folds
0Bw1Gb5YC/Xvb0SqVawKUw: folds
kJ06FP2Jc7cSdmywwvYOXw: calls $0.50
R354x4oZnQcGCDV6GhjnpQ: calls $0.25
75K2MXwN65Sjfp1yHd50Hg: checks
*** FLOP *** [Ac 2s 8h]
R354x4oZnQcGCDV6GhjnpQ: checks
75K2MXwN65Sjfp1yHd50Hg: checks
kJ06FP2Jc7cSdmywwvYOXw: checks
*** TURN *** [Ac 2s 8h] [Kc]
R354x4oZnQcGCDV6GhjnpQ: bets $2
75K2MXwN65Sjfp1yHd50Hg: folds
kJ06FP2Jc7cSdmywwvYOXw: raises $2 to $4
R354x4oZnQcGCDV6GhjnpQ: raises $4 to $8
kJ06FP2Jc7cSdmywwvYOXw: calls $4
*** RIVER *** [Ac 2s 8h Kc] [4c]
R354x4oZnQcGCDV6GhjnpQ: bets $6
kJ06FP2Jc7cSdmywwvYOXw: calls $6
*** SHOW DOWN ***
R354x4oZnQcGCDV6GhjnpQ: shows [8d Ad] (two pair, Aces and Eights)
kJ06FP2Jc7cSdmywwvYOXw: mucks hand
R354x4oZnQcGCDV6GhjnpQ collected $28.10 from pot
*** SUMMARY ***
Total pot $29.50 | Rake $1.40
Board [Ac 2s 8h Kc 4c]
Seat 2: 1xBtrSVBbgFH/viUWKqQeg folded before Flop (didn't bet)
Seat 3: UVJbBPbDwNMEZadZB9WVmg folded before Flop (didn't bet)
Seat 4: mZNMJI1mY40XTC0U7GZakA folded before Flop (didn't bet)
Seat 5: 2YaCb/8u1SesrR+963XiZA folded before Flop (didn't bet)
Seat 6: 0Bw1Gb5YC/Xvb0SqVawKUw folded before Flop (didn't bet)
Seat 7: kJ06FP2Jc7cSdmywwvYOXw (button) mucked
Seat 8: R354x4oZnQcGCDV6GhjnpQ (small blind) showed [8d Ad] and won ($28.10) with two pair, Aces and Eights
Seat 9: 75K2MXwN65Sjfp1yHd50Hg (big blind) folded on the Turn



PokerStars Game #59941637450:  Hold'em No Limit ($0.25/$0.50) - 2009/07/01 1:41:28 ET
Table 'ZYI3ZReBjdfKEYItkZHI6A' 9-max Seat #8 is the button
Seat 1: IYd5zG8k7vdBNVHbHg2Pag ($60.40 in chips)
Seat 2: 5acK4E7fzEwnplVBZ6eNWA ($50 in chips)
Seat 3: 75K2MXwN65Sjfp1yHd50Hg ($8.50 in chips)
Seat 4: /UdtxmXsFx6K/14AbHqzbQ ($7.75 in chips)
Seat 5: ApHP7ouup365XIUFBdEDxg ($19.60 in chips)
Seat 6: 1xBtrSVBbgFH/viUWKqQeg ($37 in chips)
Seat 8: ji04uOybxCdpdefzlUQeKQ ($28.80 in chips)
Seat 9: HZkVla4kK2SI42CVrPZ/ig ($10.65 in chips)
HZkVla4kK2SI42CVrPZ/ig: posts small blind $0.25
IYd5zG8k7vdBNVHbHg2Pag: posts big blind $0.50
*** HOLE CARDS ***
5acK4E7fzEwnplVBZ6eNWA: folds
75K2MXwN65Sjfp1yHd50Hg: folds
/UdtxmXsFx6K/14AbHqzbQ: calls $0.50
ApHP7ouup365XIUFBdEDxg: folds
1xBtrSVBbgFH/viUWKqQeg: folds
ji04uOybxCdpdefzlUQeKQ: folds
HZkVla4kK2SI42CVrPZ/ig: calls $0.25
IYd5zG8k7vdBNVHbHg2Pag: checks
*** FLOP *** [Jd 9h 2s]
HZkVla4kK2SI42CVrPZ/ig: checks
IYd5zG8k7vdBNVHbHg2Pag: checks
/UdtxmXsFx6K/14AbHqzbQ: bets $1.50
XysesR1vUp34S3HSj4ez+w joins the table at seat #7
HZkVla4kK2SI42CVrPZ/ig: folds
IYd5zG8k7vdBNVHbHg2Pag: folds
/UdtxmXsFx6K/14AbHqzbQ collected $1.45 from pot
*** SUMMARY ***
Total pot $1.50 | Rake $0.05
Board [Jd 9h 2s]
Seat 1: IYd5zG8k7vdBNVHbHg2Pag (big blind) folded on the Flop
Seat 2: 5acK4E7fzEwnplVBZ6eNWA folded before Flop (didn't bet)
Seat 3: 75K2MXwN65Sjfp1yHd50Hg folded before Flop (didn't bet)
Seat 4: /UdtxmXsFx6K/14AbHqzbQ collected ($1.45)
Seat 5: ApHP7ouup365XIUFBdEDxg folded before Flop (didn't bet)
Seat 6: 1xBtrSVBbgFH/viUWKqQeg folded before Flop (didn't bet)
Seat 8: ji04uOybxCdpdefzlUQeKQ (button) folded before Flop (didn't bet)
Seat 9: HZkVla4kK2SI42CVrPZ/ig (small blind) folded on the Flop



PokerStars Game #59941639272:  Hold'em No Limit ($0.25/$0.50) - 2009/07/01 1:41:31 ET
Table 'hWT2kq66tnKEpD26cia6fQ' 2-max Seat #2 is the button
Seat 1: Ce3KNFP+ao7Da9NHb65raw ($28.40 in chips)
Seat 2: 16tvT7AYgZ2LgiGFcvFKQg ($44.35 in chips)
16tvT7AYgZ2LgiGFcvFKQg: posts small blind $0.25
Ce3KNFP+ao7Da9NHb65raw: posts big blind $0.50
*** HOLE CARDS ***
16tvT7AYgZ2LgiGFcvFKQg: raises $0.50 to $1
Ce3KNFP+ao7Da9NHb65raw: folds
16tvT7AYgZ2LgiGFcvFKQg collected $1 from pot
*** SUMMARY ***
Total pot $1 | Rake $0
Seat 1: Ce3KNFP+ao7Da9NHb65raw (big blind) folded before Flop
Seat 2: 16tvT7AYgZ2LgiGFcvFKQg (button) (small blind) collected ($1)



PokerStars Game #59941640412:  Hold'em No Limit ($0.25/$0.50) - 2009/07/01 1:41:33 ET
Table '8BQGgNetI1NOvWeu3gtMNw' 2-max Seat #1 is the button
Seat 1: bypIyrYcAAifLfhZpGlKLA ($76.85 in chips)
Seat 2: Z4HwehErEwzsv/noQlfUlg ($135.10 in chips)
bypIyrYcAAifLfhZpGlKLA: posts small blind $0.25
Z4HwehErEwzsv/noQlfUlg: posts big blind $0.50
*** HOLE CARDS ***
bypIyrYcAAifLfhZpGlKLA: folds
Z4HwehErEwzsv/noQlfUlg collected $0.50 from pot
Z4HwehErEwzsv/noQlfUlg: doesn't show hand
*** SUMMARY ***
Total pot $0.50 | Rake $0
Seat 1: bypIyrYcAAifLfhZpGlKLA (button) (small blind) folded before Flop
Seat 2: Z4HwehErEwzsv/noQlfUlg (big blind) collected ($0.50)



PokerStars Game #59941641340:  Hold'em No Limit ($0.25/$0.50) - 2009/07/01 1:41:35 ET
Table 'GfL/No5u5PoEnU39lP5pQg' 6-max Seat #5 is the button
Seat 2: uVwggSetzp7d+eVgowO3vg ($53.75 in chips)
Seat 3: 4pp9WxhGdbVbxCc9tlu0lw ($27.05 in chips)
Seat 4: ifQmgsYNFiAg/XvBOMBSfQ ($49.25 in chips)
Seat 5: M1KyQQvVPVuxqTAB8sR/zQ ($50 in chips)
kxPhs4ePFqMy52CInAJ2aw: is sitting out
6qJZP2EKIgnEXJ3tMSBuew will be allowed to play after the button
uVwggSetzp7d+eVgowO3vg: posts small blind $0.25
4pp9WxhGdbVbxCc9tlu0lw: posts big blind $0.50
*** HOLE CARDS ***
kxPhs4ePFqMy52CInAJ2aw leaves the table
ifQmgsYNFiAg/XvBOMBSfQ: folds
M1KyQQvVPVuxqTAB8sR/zQ: raises $1 to $1.50
uVwggSetzp7d+eVgowO3vg: folds
4pp9WxhGdbVbxCc9tlu0lw: calls $1
*** FLOP *** [4s Kc 3s]
kxPhs4ePFqMy52CInAJ2aw joins the table at seat #6
4pp9WxhGdbVbxCc9tlu0lw: checks
M1KyQQvVPVuxqTAB8sR/zQ: checks
*** TURN *** [4s Kc 3s] [4c]
4pp9WxhGdbVbxCc9tlu0lw: checks
M1KyQQvVPVuxqTAB8sR/zQ: checks
*** RIVER *** [4s Kc 3s 4c] [Ad]
4pp9WxhGdbVbxCc9tlu0lw: checks
M1KyQQvVPVuxqTAB8sR/zQ: bets $2.50
4pp9WxhGdbVbxCc9tlu0lw: folds
M1KyQQvVPVuxqTAB8sR/zQ collected $3.10 from pot
M1KyQQvVPVuxqTAB8sR/zQ: doesn't show hand
*** SUMMARY ***
Total pot $3.25 | Rake $0.15
Board [4s Kc 3s 4c Ad]
Seat 2: uVwggSetzp7d+eVgowO3vg (small blind) folded before Flop
Seat 3: 4pp9WxhGdbVbxCc9tlu0lw (big blind) folded on the River
Seat 4: ifQmgsYNFiAg/XvBOMBSfQ folded before Flop (didn't bet)
Seat 5: M1KyQQvVPVuxqTAB8sR/zQ (button) collected ($3.10)



PokerStars Game #59941642178:  Hold'em No Limit ($0.25/$0.50) - 2009/07/01 1:41:36 ET
Table 'EiNh8p/wGJ1FP575iMFnqg' 9-max Seat #1 is the button
Seat 1: YFFlOZgyy1Mh4iBmuNRbmQ ($23.30 in chips)
Seat 2: GRV8J6o4lVSBDEyjt6BwMg ($29 in chips)
Seat 3: ymLPoEIl7UL3TvZYmnadxQ ($39.75 in chips)
Seat 4: cMzaiXAM/ZAdNaEUu+LqhA ($54.20 in chips)
Seat 5: M+7+BTmX5vZatHVuoRB1nA ($75.15 in chips)
Seat 6: bCRukyMhXa3jkgAkKFa4VQ ($10.30 in chips)
Seat 7: 997ViqAtWn1FPjJqcffwcA ($50 in chips)
Seat 8: mSD1pginDsyHG5PDfqzphw ($14.05 in chips)
Seat 9: GuPkZObrz5Zkkn8FsEdF9w ($33.85 in chips)
GRV8J6o4lVSBDEyjt6BwMg: posts small blind $0.25
ymLPoEIl7UL3TvZYmnadxQ: posts big blind $0.50
*** HOLE CARDS ***
cMzaiXAM/ZAdNaEUu+LqhA: folds
M+7+BTmX5vZatHVuoRB1nA: folds
bCRukyMhXa3jkgAkKFa4VQ: folds
997ViqAtWn1FPjJqcffwcA: folds
mSD1pginDsyHG5PDfqzphw: raises $1 to $1.50
GuPkZObrz5Zkkn8FsEdF9w: folds
YFFlOZgyy1Mh4iBmuNRbmQ: calls $1.50
GRV8J6o4lVSBDEyjt6BwMg: calls $1.25
ymLPoEIl7UL3TvZYmnadxQ: calls $1
*** FLOP *** [Td 5s Kd]
GRV8J6o4lVSBDEyjt6BwMg: checks
ymLPoEIl7UL3TvZYmnadxQ: checks
mSD1pginDsyHG5PDfqzphw: bets $3
YFFlOZgyy1Mh4iBmuNRbmQ: calls $3
GRV8J6o4lVSBDEyjt6BwMg: folds
ymLPoEIl7UL3TvZYmnadxQ: folds
*** TURN *** [Td 5s Kd] [Jc]
mSD1pginDsyHG5PDfqzphw: bets $9.55 and is all-in
YFFlOZgyy1Mh4iBmuNRbmQ: folds
mSD1pginDsyHG5PDfqzphw collected $11.45 from pot
mSD1pginDsyHG5PDfqzphw: doesn't show hand
*** SUMMARY ***
Total pot $12 | Rake $0.55
Board [Td 5s Kd Jc]
Seat 1: YFFlOZgyy1Mh4iBmuNRbmQ (button) folded on the Turn
Seat 2: GRV8J6o4lVSBDEyjt6BwMg (small blind) folded on the Flop
Seat 3: ymLPoEIl7UL3TvZYmnadxQ (big blind) folded on the Flop
Seat 4: cMzaiXAM/ZAdNaEUu+LqhA folded before Flop (didn't bet)
Seat 5: M+7+BTmX5vZatHVuoRB1nA folded before Flop (didn't bet)
Seat 6: bCRukyMhXa3jkgAkKFa4VQ folded before Flop (didn't bet)
Seat 7: 997ViqAtWn1FPjJqcffwcA folded before Flop (didn't bet)
Seat 8: mSD1pginDsyHG5PDfqzphw collected ($11.45)
Seat 9: GuPkZObrz5Zkkn8FsEdF9w folded before Flop (didn't bet)



PokerStars Game #59941642820:  Hold'em No Limit ($0.25/$0.50) - 2009/07/01 1:41:38 ET
Table '+z1aekfHkpp09pc8F9aViw' 6-max Seat #3 is the button
Seat 1: L0aIPg7qefDQjdJo3HCVEA ($10.75 in chips)
Seat 3: URYNc7fPA23K2UfadQbnCA ($63.15 in chips)
Seat 4: RowCSpSURHTOL/dcjg/Iug ($85.20 in chips)
Seat 5: 2igtJLmvIZ+HqX4XPgMPZA ($51.50 in chips)
Seat 6: GUnvMULl2qFOO1yenu1UBw ($50 in chips)
RowCSpSURHTOL/dcjg/Iug: posts small blind $0.25
2igtJLmvIZ+HqX4XPgMPZA: posts big blind $0.50
*** HOLE CARDS ***
GUnvMULl2qFOO1yenu1UBw: folds
L0aIPg7qefDQjdJo3HCVEA: folds
URYNc7fPA23K2UfadQbnCA: raises $1.50 to $2
RowCSpSURHTOL/dcjg/Iug: folds
2igtJLmvIZ+HqX4XPgMPZA: folds
URYNc7fPA23K2UfadQbnCA collected $1.25 from pot
*** SUMMARY ***
Total pot $1.25 | Rake $0
Seat 1: L0aIPg7qefDQjdJo3HCVEA folded before Flop (didn't bet)
Seat 3: URYNc7fPA23K2UfadQbnCA (button) collected ($1.25)
Seat 4: RowCSpSURHTOL/dcjg/Iug (small blind) folded before Flop
Seat 5: 2igtJLmvIZ+HqX4XPgMPZA (big blind) folded before Flop
Seat 6: GUnvMULl2qFOO1yenu1UBw folded before Flop (didn't bet)



PokerStars Game #59941643130:  Hold'em No Limit ($0.25/$0.50) - 2009/07/01 1:41:38 ET
Table '2lPOwetm4cfkZPbTmGPH/w' 2-max Seat #2 is the button
Seat 1: vUGdApqS8J/GJE2gaVWl1w ($16.30 in chips)
Seat 2: XFa6sBGjP2gxoIvxR3fZIg ($20.05 in chips)
XFa6sBGjP2gxoIvxR3fZIg: posts small blind $0.25
vUGdApqS8J/GJE2gaVWl1w: posts big blind $0.50
*** HOLE CARDS ***
XFa6sBGjP2gxoIvxR3fZIg: calls $0.25
vUGdApqS8J/GJE2gaVWl1w: raises $1.50 to $2
XFa6sBGjP2gxoIvxR3fZIg: folds
vUGdApqS8J/GJE2gaVWl1w collected $1 from pot
*** SUMMARY ***
Total pot $1 | Rake $0
Seat 1: vUGdApqS8J/GJE2gaVWl1w (big blind) collected ($1)
Seat 2: XFa6sBGjP2gxoIvxR3fZIg (button) (small blind) folded before Flop



PokerStars Game #59941643512:  Hold'em No Limit ($0.25/$0.50) - 2009/07/01 1:41:39 ET
Table '8BQGgNetI1NOvWeu3gtMNw' 2-max Seat #2 is the button
Seat 1: bypIyrYcAAifLfhZpGlKLA ($76.60 in chips)
Seat 2: Z4HwehErEwzsv/noQlfUlg ($135.35 in chips)
Z4HwehErEwzsv/noQlfUlg: posts small blind $0.25
bypIyrYcAAifLfhZpGlKLA: posts big blind $0.50
*** HOLE CARDS ***
Z4HwehErEwzsv/noQlfUlg: raises $0.50 to $1
bypIyrYcAAifLfhZpGlKLA: raises $3 to $4
Z4HwehErEwzsv/noQlfUlg: raises $3 to $7
bypIyrYcAAifLfhZpGlKLA: raises $17 to $24
Z4HwehErEwzsv/noQlfUlg: raises $111.35 to $135.35 and is all-in
bypIyrYcAAifLfhZpGlKLA: calls $52.60 and is all-in
*** FLOP *** [Qh 3c 6h]
*** TURN *** [Qh 3c 6h] [3d]
*** RIVER *** [Qh 3c 6h 3d] [Th]
*** SHOW DOWN ***
bypIyrYcAAifLfhZpGlKLA: shows [Ks Ac] (a pair of Threes)
Z4HwehErEwzsv/noQlfUlg: shows [Ah As] (two pair, Aces and Threes)
Z4HwehErEwzsv/noQlfUlg collected $152.70 from pot
*** SUMMARY ***
Total pot $153.20 | Rake $0.50
Board [Qh 3c 6h 3d Th]
Seat 1: bypIyrYcAAifLfhZpGlKLA (big blind) showed [Ks Ac] and lost with a pair of Threes
Seat 2: Z4HwehErEwzsv/noQlfUlg (button) (small blind) showed [Ah As] and won ($152.70) with two pair, Aces and Threes



PokerStars Game #59941643746:  Hold'em No Limit ($0.25/$0.50) - 2009/07/01 1:41:39 ET
Table 'B+sqsfj6d6zXicNfaseTaw' 2-max Seat #1 is the button
Seat 1: +4GNcSsecmapVGSdV0mUPA ($146.80 in chips)
Seat 2: Lv5RmpRe6LtPkBzM9Gpo5A ($72.90 in chips)
+4GNcSsecmapVGSdV0mUPA: posts small blind $0.25
Lv5RmpRe6LtPkBzM9Gpo5A: posts big blind $0.50
*** HOLE CARDS ***
+4GNcSsecmapVGSdV0mUPA: folds
Lv5RmpRe6LtPkBzM9Gpo5A collected $0.50 from pot
*** SUMMARY ***
Total pot $0.50 | Rake $0
Seat 1: +4GNcSsecmapVGSdV0mUPA (button) (small blind) folded before Flop
Seat 2: Lv5RmpRe6LtPkBzM9Gpo5A (big blind) collected ($0.50)



PokerStars Game #59941644116:  Hold'em No Limit ($0.25/$0.50) - 2009/07/01 1:41:40 ET
Table 'hWT2kq66tnKEpD26cia6fQ' 2-max Seat #1 is the button
Seat 1: Ce3KNFP+ao7Da9NHb65raw ($27.90 in chips)
Seat 2: 16tvT7AYgZ2LgiGFcvFKQg ($44.85 in chips)
Ce3KNFP+ao7Da9NHb65raw: posts small blind $0.25
16tvT7AYgZ2LgiGFcvFKQg: posts big blind $0.50
*** HOLE CARDS ***
Ce3KNFP+ao7Da9NHb65raw: folds
16tvT7AYgZ2LgiGFcvFKQg collected $0.50 from pot
*** SUMMARY ***
Total pot $0.50 | Rake $0
Seat 1: Ce3KNFP+ao7Da9NHb65raw (button) (small blind) folded before Flop
Seat 2: 16tvT7AYgZ2LgiGFcvFKQg (big blind) collected ($0.50)



PokerStars Game #59941645264:  Hold'em No Limit ($0.25/$0.50) - 2009/07/01 1:41:42 ET
Table 'hSTs/dUsYLgJQuF2Onp0MQ' 6-max Seat #6 is the button
Seat 2: vhWS+cwAJNd3JzqVzIjBZA ($50.45 in chips)
Seat 3: lxIzoHy0RnkfFSODHC2liw ($50 in chips)
Seat 4: 2igtJLmvIZ+HqX4XPgMPZA ($50.50 in chips)
Seat 5: FsRQ5ECdlLkLYI5le8+PDQ ($49.60 in chips)
Seat 6: M1KyQQvVPVuxqTAB8sR/zQ ($104.70 in chips)
Hdd4js36ITbTJ/QuVYwTlA will be allowed to play after the button
vhWS+cwAJNd3JzqVzIjBZA: posts small blind $0.25
lxIzoHy0RnkfFSODHC2liw: posts big blind $0.50
*** HOLE CARDS ***
2igtJLmvIZ+HqX4XPgMPZA: folds
FsRQ5ECdlLkLYI5le8+PDQ: raises $1 to $1.50
M1KyQQvVPVuxqTAB8sR/zQ: folds
vhWS+cwAJNd3JzqVzIjBZA: folds
lxIzoHy0RnkfFSODHC2liw: folds
FsRQ5ECdlLkLYI5le8+PDQ collected $1.25 from pot
*** SUMMARY ***
Total pot $1.25 | Rake $0
Seat 2: vhWS+cwAJNd3JzqVzIjBZA (small blind) folded before Flop
Seat 3: lxIzoHy0RnkfFSODHC2liw (big blind) folded before Flop
Seat 4: 2igtJLmvIZ+HqX4XPgMPZA folded before Flop (didn't bet)
Seat 5: FsRQ5ECdlLkLYI5le8+PDQ collected ($1.25)
Seat 6: M1KyQQvVPVuxqTAB8sR/zQ (button) folded before Flop (didn't bet)



PokerStars Game #59941646766:  Hold'em No Limit ($0.25/$0.50) - 2009/07/01 1:41:44 ET
Table 'B+sqsfj6d6zXicNfaseTaw' 2-max Seat #2 is the button
Seat 1: +4GNcSsecmapVGSdV0mUPA ($146.55 in chips)
Seat 2: Lv5RmpRe6LtPkBzM9Gpo5A ($73.15 in chips)
Lv5RmpRe6LtPkBzM9Gpo5A: posts small blind $0.25
+4GNcSsecmapVGSdV0mUPA: posts big blind $0.50
*** HOLE CARDS ***
Lv5RmpRe6LtPkBzM9Gpo5A: raises $1 to $1.50
+4GNcSsecmapVGSdV0mUPA: calls $1
*** FLOP *** [Ks Kc 3s]
+4GNcSsecmapVGSdV0mUPA: checks
Lv5RmpRe6LtPkBzM9Gpo5A: checks
*** TURN *** [Ks Kc 3s] [8s]
+4GNcSsecmapVGSdV0mUPA: checks
Lv5RmpRe6LtPkBzM9Gpo5A: checks
*** RIVER *** [Ks Kc 3s 8s] [Jc]
+4GNcSsecmapVGSdV0mUPA: checks
Lv5RmpRe6LtPkBzM9Gpo5A: checks
*** SHOW DOWN ***
+4GNcSsecmapVGSdV0mUPA: shows [2d 2s] (two pair, Kings and Deuces)
Lv5RmpRe6LtPkBzM9Gpo5A: mucks hand
+4GNcSsecmapVGSdV0mUPA collected $2.85 from pot
*** SUMMARY ***
Total pot $3 | Rake $0.15
Board [Ks Kc 3s 8s Jc]
Seat 1: +4GNcSsecmapVGSdV0mUPA (big blind) showed [2d 2s] and won ($2.85) with two pair, Kings and Deuces
Seat 2: Lv5RmpRe6LtPkBzM9Gpo5A (button) (small blind) mucked



PokerStars Game #59941647460:  Hold'em No Limit ($0.25/$0.50) - 2009/07/01 1:41:46 ET
Table 'hWT2kq66tnKEpD26cia6fQ' 2-max Seat #2 is the button
Seat 1: Ce3KNFP+ao7Da9NHb65raw ($27.65 in chips)
Seat 2: 16tvT7AYgZ2LgiGFcvFKQg ($45.10 in chips)
16tvT7AYgZ2LgiGFcvFKQg: posts small blind $0.25
Ce3KNFP+ao7Da9NHb65raw: posts big blind $0.50
*** HOLE CARDS ***
16tvT7AYgZ2LgiGFcvFKQg: calls $0.25
Ce3KNFP+ao7Da9NHb65raw: raises $1 to $1.50
16tvT7AYgZ2LgiGFcvFKQg: calls $1
*** FLOP *** [Js 3c 2c]
Ce3KNFP+ao7Da9NHb65raw: bets $2
16tvT7AYgZ2LgiGFcvFKQg: calls $2
*** TURN *** [Js 3c 2c] [Ks]
Ce3KNFP+ao7Da9NHb65raw: checks
16tvT7AYgZ2LgiGFcvFKQg: bets $2.50
Ce3KNFP+ao7Da9NHb65raw: calls $2.50
*** RIVER *** [Js 3c 2c Ks] [As]
Ce3KNFP+ao7Da9NHb65raw: checks
16tvT7AYgZ2LgiGFcvFKQg: bets $2.50
Ce3KNFP+ao7Da9NHb65raw: calls $2.50
*** SHOW DOWN ***
16tvT7AYgZ2LgiGFcvFKQg: shows [2s Kd] (two pair, Kings and Deuces)
Ce3KNFP+ao7Da9NHb65raw: mucks hand
16tvT7AYgZ2LgiGFcvFKQg collected $16.50 from pot
*** SUMMARY ***
Total pot $17 | Rake $0.50
Board [Js 3c 2c Ks As]
Seat 1: Ce3KNFP+ao7Da9NHb65raw (big blind) mucked
Seat 2: 16tvT7AYgZ2LgiGFcvFKQg (button) (small blind) showed [2s Kd] and won ($16.50) with two pair, Kings and Deuces



PokerStars Game #59941647554:  Hold'em No Limit ($0.25/$0.50) - 2009/07/01 1:41:46 ET
Table '5EmHi+fnatGQQShcNmzOZQ' 6-max Seat #4 is the button
Seat 1: avNOJXWxD1+SygFmWsd+qw ($66.60 in chips)
Seat 2: OZ6OtYh5Y53MCH/p0QTn5g ($50 in chips)
Seat 3: QmH/ZFyxZfvliy57YM9yxw ($76.80 in chips)
Seat 4: 1b+2BbjMN8qhR1WPqdE9VQ ($59.80 in chips)
Seat 5: 6yWjZXHP6iAyMEDF6pJlng ($55.55 in chips)
6yWjZXHP6iAyMEDF6pJlng: posts small blind $0.25
avNOJXWxD1+SygFmWsd+qw: posts big blind $0.50
*** HOLE CARDS ***
OZ6OtYh5Y53MCH/p0QTn5g: raises $1.50 to $2
QmH/ZFyxZfvliy57YM9yxw: folds
1b+2BbjMN8qhR1WPqdE9VQ: folds
6yWjZXHP6iAyMEDF6pJlng: folds
avNOJXWxD1+SygFmWsd+qw: folds
OZ6OtYh5Y53MCH/p0QTn5g collected $1.25 from pot
OZ6OtYh5Y53MCH/p0QTn5g: doesn't show hand
*** SUMMARY ***
Total pot $1.25 | Rake $0
Seat 1: avNOJXWxD1+SygFmWsd+qw (big blind) folded before Flop
Seat 2: OZ6OtYh5Y53MCH/p0QTn5g collected ($1.25)
Seat 3: QmH/ZFyxZfvliy57YM9yxw folded before Flop (didn't bet)
Seat 4: 1b+2BbjMN8qhR1WPqdE9VQ (button) folded before Flop (didn't bet)
Seat 5: 6yWjZXHP6iAyMEDF6pJlng (small blind) folded before Flop



PokerStars Game #59941647960:  Hold'em No Limit ($0.25/$0.50) - 2009/07/01 1:41:47 ET
Table 'cofQFHU7jbJoFecLVBof/w' 6-max Seat #6 is the button
Seat 1: URYNc7fPA23K2UfadQbnCA ($50.45 in chips)
Seat 2: f89uTQr3ieGlusj2IAYAEg ($50 in chips)
Seat 3: v4ctePcLlQw0r8E0qJtjYw ($51.45 in chips)
Seat 4: 9XrTM0DuVxx1pjFAdSbD8A ($57.80 in chips)
Seat 5: QvwRlrpVqerRRF8eJm6dDw ($47 in chips)
Seat 6: 7+uQ0OOgCTbR4ltkSwyC0g ($158.30 in chips)
URYNc7fPA23K2UfadQbnCA: posts small blind $0.25
f89uTQr3ieGlusj2IAYAEg: posts big blind $0.50
*** HOLE CARDS ***
v4ctePcLlQw0r8E0qJtjYw: folds
9XrTM0DuVxx1pjFAdSbD8A: folds
QvwRlrpVqerRRF8eJm6dDw: folds
7+uQ0OOgCTbR4ltkSwyC0g: folds
URYNc7fPA23K2UfadQbnCA: folds
f89uTQr3ieGlusj2IAYAEg collected $0.50 from pot
*** SUMMARY ***
Total pot $0.50 | Rake $0
Seat 1: URYNc7fPA23K2UfadQbnCA (small blind) folded before Flop
Seat 2: f89uTQr3ieGlusj2IAYAEg (big blind) collected ($0.50)
Seat 3: v4ctePcLlQw0r8E0qJtjYw folded before Flop (didn't bet)
Seat 4: 9XrTM0DuVxx1pjFAdSbD8A folded before Flop (didn't bet)
Seat 5: QvwRlrpVqerRRF8eJm6dDw folded before Flop (didn't bet)
Seat 6: 7+uQ0OOgCTbR4ltkSwyC0g (button) folded before Flop (didn't bet)



PokerStars Game #59941648654:  Hold'em No Limit ($0.25/$0.50) - 2009/07/01 1:41:48 ET
Table 'NCiXr0d5CEKBQr/cZgLhbA' 9-max Seat #1 is the button
Seat 1: pFtzb1sR4b0d1aw6aIRgDg ($78.45 in chips)
Seat 2: AjV5McH1KMMclY26QdLM5w ($41.05 in chips)
Seat 3: xZCXQSXlrZkp3pZizzVXCw ($95.65 in chips)
Seat 4: 5k9fvXD9suIgCxU4HLQjTw ($52.45 in chips)
Seat 5: Ja2jdidjip2UeJnRzmzAAQ ($43.20 in chips)
Seat 6: t1qL+wRXOwTLB4TBbcw2QA ($53.10 in chips)
Seat 7: dXhO5i7KOoVcsGqbklD+jw ($44 in chips)
Seat 8: XA3GzEhYmqB0KknKKPDZGQ ($28.80 in chips)
Seat 9: 4WLZvqBn5qv5tds5kt5A1Q ($57.20 in chips)
AjV5McH1KMMclY26QdLM5w: posts small blind $0.25
xZCXQSXlrZkp3pZizzVXCw: posts big blind $0.50
*** HOLE CARDS ***
5k9fvXD9suIgCxU4HLQjTw: raises $1.50 to $2
Ja2jdidjip2UeJnRzmzAAQ: folds
t1qL+wRXOwTLB4TBbcw2QA: folds
dXhO5i7KOoVcsGqbklD+jw: folds
XA3GzEhYmqB0KknKKPDZGQ: folds
4WLZvqBn5qv5tds5kt5A1Q: calls $2
pFtzb1sR4b0d1aw6aIRgDg: raises $4 to $6
AjV5McH1KMMclY26QdLM5w: folds
xZCXQSXlrZkp3pZizzVXCw: folds
5k9fvXD9suIgCxU4HLQjTw: folds
4WLZvqBn5qv5tds5kt5A1Q: calls $4
*** FLOP *** [6h 8d Kh]
4WLZvqBn5qv5tds5kt5A1Q: checks
pFtzb1sR4b0d1aw6aIRgDg: bets $4.50
4WLZvqBn5qv5tds5kt5A1Q: folds
pFtzb1sR4b0d1aw6aIRgDg collected $14.05 from pot
*** SUMMARY ***
Total pot $14.75 | Rake $0.70
Board [6h 8d Kh]
Seat 1: pFtzb1sR4b0d1aw6aIRgDg (button) collected ($14.05)
Seat 2: AjV5McH1KMMclY26QdLM5w (small blind) folded before Flop
Seat 3: xZCXQSXlrZkp3pZizzVXCw (big blind) folded before Flop
Seat 4: 5k9fvXD9suIgCxU4HLQjTw folded before Flop
Seat 5: Ja2jdidjip2UeJnRzmzAAQ folded before Flop (didn't bet)
Seat 6: t1qL+wRXOwTLB4TBbcw2QA folded before Flop (didn't bet)
Seat 7: dXhO5i7KOoVcsGqbklD+jw folded before Flop (didn't bet)
Seat 8: XA3GzEhYmqB0KknKKPDZGQ folded before Flop (didn't bet)
Seat 9: 4WLZvqBn5qv5tds5kt5A1Q folded on the Flop



PokerStars Game #59941649074:  Hold'em No Limit ($0.25/$0.50) - 2009/07/01 1:41:49 ET
Table '2lPOwetm4cfkZPbTmGPH/w' 2-max Seat #1 is the button
Seat 1: vUGdApqS8J/GJE2gaVWl1w ($16.80 in chips)
Seat 2: XFa6sBGjP2gxoIvxR3fZIg ($19.55 in chips)
vUGdApqS8J/GJE2gaVWl1w: posts small blind $0.25
XFa6sBGjP2gxoIvxR3fZIg: posts big blind $0.50
*** HOLE CARDS ***
vUGdApqS8J/GJE2gaVWl1w: calls $0.25
XFa6sBGjP2gxoIvxR3fZIg: checks
*** FLOP *** [5c 9h 8s]
XFa6sBGjP2gxoIvxR3fZIg: bets $1
vUGdApqS8J/GJE2gaVWl1w: calls $1
*** TURN *** [5c 9h 8s] [Jc]
XFa6sBGjP2gxoIvxR3fZIg: checks
vUGdApqS8J/GJE2gaVWl1w: bets $1
XFa6sBGjP2gxoIvxR3fZIg: calls $1
*** RIVER *** [5c 9h 8s Jc] [4d]
XFa6sBGjP2gxoIvxR3fZIg: checks
vUGdApqS8J/GJE2gaVWl1w: checks
*** SHOW DOWN ***
XFa6sBGjP2gxoIvxR3fZIg: shows [Kd 9s] (a pair of Nines)
vUGdApqS8J/GJE2gaVWl1w: mucks hand
XFa6sBGjP2gxoIvxR3fZIg collected $4.80 from pot
*** SUMMARY ***
Total pot $5 | Rake $0.20
Board [5c 9h 8s Jc 4d]
Seat 1: vUGdApqS8J/GJE2gaVWl1w (button) (small blind) mucked
Seat 2: XFa6sBGjP2gxoIvxR3fZIg (big blind) showed [Kd 9s] and won ($4.80) with a pair of Nines



PokerStars Game #59941650326:  Hold'em No Limit ($0.25/$0.50) - 2009/07/01 1:41:51 ET
Table 'lSisgp6H7Fg1hH5VfjEjYQ' 9-max Seat #4 is the button
Seat 1: 5k9fvXD9suIgCxU4HLQjTw ($52.80 in chips)
Seat 2: 5acK4E7fzEwnplVBZ6eNWA ($50.95 in chips)
Seat 3: SKnJuWHScqetA/qG5p+wCg ($30 in chips)
Seat 4: FFVKBJT0lZf+jFlgvy7ang ($38 in chips)
Seat 5: mSD1pginDsyHG5PDfqzphw ($16.25 in chips)
Seat 6: +k7T5ocke8UwavtgUHm+Cg ($75.90 in chips)
Seat 7: IDtNLR9uFCDdjNsJWMHA5Q ($22.90 in chips)
Seat 8: a4JDWmpFQkL10XfAyuF51A ($11.85 in chips)
mSD1pginDsyHG5PDfqzphw: posts small blind $0.25
+k7T5ocke8UwavtgUHm+Cg: posts big blind $0.50
M+D23GG26WXQ/2gyjREVOQ: sits out
*** HOLE CARDS ***
IDtNLR9uFCDdjNsJWMHA5Q: folds
a4JDWmpFQkL10XfAyuF51A: folds
5k9fvXD9suIgCxU4HLQjTw: folds
IDtNLR9uFCDdjNsJWMHA5Q leaves the table
5acK4E7fzEwnplVBZ6eNWA: folds
SKnJuWHScqetA/qG5p+wCg: folds
FFVKBJT0lZf+jFlgvy7ang: calls $0.50
drKg+7JekfxR/0poTEK9Tg joins the table at seat #7
mSD1pginDsyHG5PDfqzphw: calls $0.25
+k7T5ocke8UwavtgUHm+Cg: checks
*** FLOP *** [4h 5h Ac]
mSD1pginDsyHG5PDfqzphw: checks
+k7T5ocke8UwavtgUHm+Cg: checks
FFVKBJT0lZf+jFlgvy7ang: bets $1.50
mSD1pginDsyHG5PDfqzphw: folds
+k7T5ocke8UwavtgUHm+Cg: folds
FFVKBJT0lZf+jFlgvy7ang collected $1.45 from pot
*** SUMMARY ***
Total pot $1.50 | Rake $0.05
Board [4h 5h Ac]
Seat 1: 5k9fvXD9suIgCxU4HLQjTw folded before Flop (didn't bet)
Seat 2: 5acK4E7fzEwnplVBZ6eNWA folded before Flop (didn't bet)
Seat 3: SKnJuWHScqetA/qG5p+wCg folded before Flop (didn't bet)
Seat 4: FFVKBJT0lZf+jFlgvy7ang (button) collected ($1.45)
Seat 5: mSD1pginDsyHG5PDfqzphw (small blind) folded on the Flop
Seat 6: +k7T5ocke8UwavtgUHm+Cg (big blind) folded on the Flop
Seat 7: IDtNLR9uFCDdjNsJWMHA5Q folded before Flop (didn't bet)
Seat 8: a4JDWmpFQkL10XfAyuF51A folded before Flop (didn't bet)



PokerStars Game #59941651802:  Hold'em No Limit ($0.25/$0.50) - 2009/07/01 1:41:54 ET
Table 'tyR5AZNKV8Aadbrnrnlg7g' 6-max Seat #1 is the button
Seat 1: BgOXYI0yYSN1ULC4FqsNkg ($75.05 in chips)
Seat 2: vhWS+cwAJNd3JzqVzIjBZA ($50.45 in chips)
Seat 3: JFLrYNyQmwPhRQAtoSAuyA ($60.85 in chips)
Seat 4: 4QfsCWthT/vSLirorNXqtg ($82.95 in chips)
Seat 5: GUnvMULl2qFOO1yenu1UBw ($76.35 in chips)
vhWS+cwAJNd3JzqVzIjBZA: posts small blind $0.25
JFLrYNyQmwPhRQAtoSAuyA: posts big blind $0.50
*** HOLE CARDS ***
4QfsCWthT/vSLirorNXqtg: raises $1.50 to $2
GUnvMULl2qFOO1yenu1UBw: folds
BgOXYI0yYSN1ULC4FqsNkg: raises $4 to $6
vhWS+cwAJNd3JzqVzIjBZA: folds
JFLrYNyQmwPhRQAtoSAuyA: folds
4QfsCWthT/vSLirorNXqtg: calls $4
*** FLOP *** [Qs 6s 2s]
4QfsCWthT/vSLirorNXqtg: checks
BgOXYI0yYSN1ULC4FqsNkg: bets $7.50
4QfsCWthT/vSLirorNXqtg: folds
BgOXYI0yYSN1ULC4FqsNkg collected $12.15 from pot
*** SUMMARY ***
Total pot $12.75 | Rake $0.60
Board [Qs 6s 2s]
Seat 1: BgOXYI0yYSN1ULC4FqsNkg (button) collected ($12.15)
Seat 2: vhWS+cwAJNd3JzqVzIjBZA (small blind) folded before Flop
Seat 3: JFLrYNyQmwPhRQAtoSAuyA (big blind) folded before Flop
Seat 4: 4QfsCWthT/vSLirorNXqtg folded on the Flop
Seat 5: GUnvMULl2qFOO1yenu1UBw folded before Flop (didn't bet)



PokerStars Game #59941653032:  Hold'em No Limit ($0.25/$0.50) - 2009/07/01 1:41:56 ET
Table '1pi9mHyVuXF/uue+aPQc4w' 9-max Seat #4 is the button
Seat 1: M+D23GG26WXQ/2gyjREVOQ ($43.65 in chips)
Seat 2: vHYT5s323LpajBj+2c9zbQ ($22.90 in chips)
Seat 3: HZkVla4kK2SI42CVrPZ/ig ($9.60 in chips)
Seat 4: mSD1pginDsyHG5PDfqzphw ($13.05 in chips)
Seat 6: 1xBtrSVBbgFH/viUWKqQeg ($59.65 in chips)
Seat 7: 61sfw5QTu62YYIt68OsdrA ($29.55 in chips)
Seat 8: g4k0NXISyLCqaSWZDBjfEg ($97.05 in chips)
Seat 9: Q/gZC63lfOMr7YhWKPCxoQ ($9.20 in chips)
bMkgDRXl6YaqJ4b/5qml2Q will be allowed to play after the button
1xBtrSVBbgFH/viUWKqQeg: posts small blind $0.25
61sfw5QTu62YYIt68OsdrA: posts big blind $0.50
*** HOLE CARDS ***
g4k0NXISyLCqaSWZDBjfEg: folds
Q/gZC63lfOMr7YhWKPCxoQ: calls $0.50
M+D23GG26WXQ/2gyjREVOQ: calls $0.50
vHYT5s323LpajBj+2c9zbQ: calls $0.50
HZkVla4kK2SI42CVrPZ/ig: calls $0.50
mSD1pginDsyHG5PDfqzphw: folds
1xBtrSVBbgFH/viUWKqQeg: calls $0.25
61sfw5QTu62YYIt68OsdrA: checks
*** FLOP *** [Qc Ah 7d]
1xBtrSVBbgFH/viUWKqQeg: checks
61sfw5QTu62YYIt68OsdrA: checks
Q/gZC63lfOMr7YhWKPCxoQ: checks
M+D23GG26WXQ/2gyjREVOQ: checks
vHYT5s323LpajBj+2c9zbQ: checks
HZkVla4kK2SI42CVrPZ/ig: checks
*** TURN *** [Qc Ah 7d] [Jd]
1xBtrSVBbgFH/viUWKqQeg: checks
61sfw5QTu62YYIt68OsdrA: checks
Q/gZC63lfOMr7YhWKPCxoQ: bets $1
M+D23GG26WXQ/2gyjREVOQ: calls $1
vHYT5s323LpajBj+2c9zbQ: folds
HZkVla4kK2SI42CVrPZ/ig: raises $3 to $4
1xBtrSVBbgFH/viUWKqQeg: folds
61sfw5QTu62YYIt68OsdrA: folds
Q/gZC63lfOMr7YhWKPCxoQ: calls $3
M+D23GG26WXQ/2gyjREVOQ: folds
*** RIVER *** [Qc Ah 7d Jd] [9h]
Q/gZC63lfOMr7YhWKPCxoQ: checks
HZkVla4kK2SI42CVrPZ/ig: bets $5.10 and is all-in
Q/gZC63lfOMr7YhWKPCxoQ: calls $4.70 and is all-in
*** SHOW DOWN ***
HZkVla4kK2SI42CVrPZ/ig: shows [Td Kc] (a straight, Ten to Ace)
Q/gZC63lfOMr7YhWKPCxoQ: mucks hand
HZkVla4kK2SI42CVrPZ/ig collected $20.40 from pot
*** SUMMARY ***
Total pot $21.40 | Rake $1
Board [Qc Ah 7d Jd 9h]
Seat 1: M+D23GG26WXQ/2gyjREVOQ folded on the Turn
Seat 2: vHYT5s323LpajBj+2c9zbQ folded on the Turn
Seat 3: HZkVla4kK2SI42CVrPZ/ig showed [Td Kc] and won ($20.40) with a straight, Ten to Ace
Seat 4: mSD1pginDsyHG5PDfqzphw (button) folded before Flop (didn't bet)
Seat 6: 1xBtrSVBbgFH/viUWKqQeg (small blind) folded on the Turn
Seat 7: 61sfw5QTu62YYIt68OsdrA (big blind) folded on the Turn
Seat 8: g4k0NXISyLCqaSWZDBjfEg folded before Flop (didn't bet)
Seat 9: Q/gZC63lfOMr7YhWKPCxoQ mucked



PokerStars Game #59941652738:  Hold'em No Limit ($0.25/$0.50) - 2009/07/01 1:41:56 ET
Table 'BCN5su+SsXiy1zRMJi0SJw' 6-max Seat #2 is the button
Seat 1: GxXV09ciXaOxyY2H5aMIIw ($34.20 in chips)
Seat 2: ehFNAevCQri3trWxV6FJdA ($85.55 in chips)
Seat 3: kwgv5lNhiFrfONXCshzxlA ($70.80 in chips)
Seat 4: bbsK8j+tpuVRhBqDzHxf7w ($49.85 in chips)
Seat 5: kxPhs4ePFqMy52CInAJ2aw ($49.75 in chips)
Seat 6: b2symlOdL7+0c9Pj4N/KlA ($78.70 in chips)
kwgv5lNhiFrfONXCshzxlA: posts small blind $0.25
bbsK8j+tpuVRhBqDzHxf7w: posts big blind $0.50
*** HOLE CARDS ***
kxPhs4ePFqMy52CInAJ2aw: folds
b2symlOdL7+0c9Pj4N/KlA: folds
GxXV09ciXaOxyY2H5aMIIw: folds
ehFNAevCQri3trWxV6FJdA: folds
kwgv5lNhiFrfONXCshzxlA: calls $0.25
bbsK8j+tpuVRhBqDzHxf7w: checks
*** FLOP *** [3c Qh 2c]
kwgv5lNhiFrfONXCshzxlA: bets $0.50
bbsK8j+tpuVRhBqDzHxf7w: folds
kwgv5lNhiFrfONXCshzxlA collected $0.95 from pot
*** SUMMARY ***
Total pot $1 | Rake $0.05
Board [3c Qh 2c]
Seat 1: GxXV09ciXaOxyY2H5aMIIw folded before Flop (didn't bet)
Seat 2: ehFNAevCQri3trWxV6FJdA (button) folded before Flop (didn't bet)
Seat 3: kwgv5lNhiFrfONXCshzxlA (small blind) collected ($0.95)
Seat 4: bbsK8j+tpuVRhBqDzHxf7w (big blind) folded on the Flop
Seat 5: kxPhs4ePFqMy52CInAJ2aw folded before Flop (didn't bet)
Seat 6: b2symlOdL7+0c9Pj4N/KlA folded before Flop (didn't bet)



PokerStars Game #59941653578:  Hold'em No Limit ($0.25/$0.50) - 2009/07/01 1:41:57 ET
Table '9ojijpRcYQSQTh6xI+haUA' 2-max Seat #2 is the button
Seat 1: FqpibuVWLNsAN/Z7ROZLnA ($52.60 in chips)
Seat 2: TitTV+fFCcBZWOERdytydA ($69.75 in chips)
TitTV+fFCcBZWOERdytydA: posts small blind $0.25
FqpibuVWLNsAN/Z7ROZLnA: posts big blind $0.50
*** HOLE CARDS ***
TitTV+fFCcBZWOERdytydA: raises $1 to $1.50
FqpibuVWLNsAN/Z7ROZLnA: calls $1
*** FLOP *** [9d 6c 5d]
FqpibuVWLNsAN/Z7ROZLnA: checks
TitTV+fFCcBZWOERdytydA: bets $2.50
FqpibuVWLNsAN/Z7ROZLnA: folds
TitTV+fFCcBZWOERdytydA collected $2.85 from pot
TitTV+fFCcBZWOERdytydA: doesn't show hand
*** SUMMARY ***
Total pot $3 | Rake $0.15
Board [9d 6c 5d]
Seat 1: FqpibuVWLNsAN/Z7ROZLnA (big blind) folded on the Flop
Seat 2: TitTV+fFCcBZWOERdytydA (button) (small blind) collected ($2.85)



PokerStars Game #59941655548:  Hold'em No Limit ($0.25/$0.50) - 2009/07/01 1:42:01 ET
Table 'B+sqsfj6d6zXicNfaseTaw' 2-max Seat #1 is the button
Seat 1: +4GNcSsecmapVGSdV0mUPA ($147.90 in chips)
Seat 2: Lv5RmpRe6LtPkBzM9Gpo5A ($71.65 in chips)
+4GNcSsecmapVGSdV0mUPA: posts small blind $0.25
Lv5RmpRe6LtPkBzM9Gpo5A: posts big blind $0.50
*** HOLE CARDS ***
+4GNcSsecmapVGSdV0mUPA: calls $0.25
Lv5RmpRe6LtPkBzM9Gpo5A: checks
*** FLOP *** [2h Kd Th]
Lv5RmpRe6LtPkBzM9Gpo5A: checks
+4GNcSsecmapVGSdV0mUPA: bets $1
Lv5RmpRe6LtPkBzM9Gpo5A: folds
+4GNcSsecmapVGSdV0mUPA collected $0.95 from pot
+4GNcSsecmapVGSdV0mUPA: doesn't show hand
*** SUMMARY ***
Total pot $1 | Rake $0.05
Board [2h Kd Th]
Seat 1: +4GNcSsecmapVGSdV0mUPA (button) (small blind) collected ($0.95)
Seat 2: Lv5RmpRe6LtPkBzM9Gpo5A (big blind) folded on the Flop



PokerStars Game #59941655582:  Hold'em No Limit ($0.25/$0.50) - 2009/07/01 1:42:01 ET
Table '+z1aekfHkpp09pc8F9aViw' 6-max Seat #4 is the button
Seat 1: L0aIPg7qefDQjdJo3HCVEA ($10.75 in chips)
Seat 3: URYNc7fPA23K2UfadQbnCA ($63.90 in chips)
Seat 4: RowCSpSURHTOL/dcjg/Iug ($84.95 in chips)
Seat 5: 2igtJLmvIZ+HqX4XPgMPZA ($51 in chips)
Seat 6: GUnvMULl2qFOO1yenu1UBw ($50 in chips)
2igtJLmvIZ+HqX4XPgMPZA: posts small blind $0.25
GUnvMULl2qFOO1yenu1UBw: posts big blind $0.50
*** HOLE CARDS ***
L0aIPg7qefDQjdJo3HCVEA: folds
URYNc7fPA23K2UfadQbnCA: folds
RowCSpSURHTOL/dcjg/Iug: folds
2igtJLmvIZ+HqX4XPgMPZA: raises $1 to $1.50
GUnvMULl2qFOO1yenu1UBw: folds
2igtJLmvIZ+HqX4XPgMPZA collected $1 from pot
2igtJLmvIZ+HqX4XPgMPZA: doesn't show hand
*** SUMMARY ***
Total pot $1 | Rake $0
Seat 1: L0aIPg7qefDQjdJo3HCVEA folded before Flop (didn't bet)
Seat 3: URYNc7fPA23K2UfadQbnCA folded before Flop (didn't bet)
Seat 4: RowCSpSURHTOL/dcjg/Iug (button) folded before Flop (didn't bet)
Seat 5: 2igtJLmvIZ+HqX4XPgMPZA (small blind) collected ($1)
Seat 6: GUnvMULl2qFOO1yenu1UBw (big blind) folded before Flop



PokerStars Game #59941656760:  Hold'em No Limit ($0.25/$0.50) - 2009/07/01 1:42:03 ET
Table 'cofQFHU7jbJoFecLVBof/w' 6-max Seat #1 is the button
Seat 1: URYNc7fPA23K2UfadQbnCA ($50.20 in chips)
Seat 2: f89uTQr3ieGlusj2IAYAEg ($50.25 in chips)
Seat 3: v4ctePcLlQw0r8E0qJtjYw ($51.45 in chips)
Seat 4: 9XrTM0DuVxx1pjFAdSbD8A ($57.80 in chips)
Seat 5: QvwRlrpVqerRRF8eJm6dDw ($47 in chips)
Seat 6: 7+uQ0OOgCTbR4ltkSwyC0g ($158.30 in chips)
f89uTQr3ieGlusj2IAYAEg: posts small blind $0.25
v4ctePcLlQw0r8E0qJtjYw: posts big blind $0.50
*** HOLE CARDS ***
9XrTM0DuVxx1pjFAdSbD8A: folds
QvwRlrpVqerRRF8eJm6dDw: raises $0.50 to $1
7+uQ0OOgCTbR4ltkSwyC0g: folds
URYNc7fPA23K2UfadQbnCA: folds
f89uTQr3ieGlusj2IAYAEg: calls $0.75
v4ctePcLlQw0r8E0qJtjYw: folds
*** FLOP *** [5h 8h 4s]
f89uTQr3ieGlusj2IAYAEg: checks
QvwRlrpVqerRRF8eJm6dDw: bets $2.50
f89uTQr3ieGlusj2IAYAEg: folds
QvwRlrpVqerRRF8eJm6dDw collected $2.40 from pot
*** SUMMARY ***
Total pot $2.50 | Rake $0.10
Board [5h 8h 4s]
Seat 1: URYNc7fPA23K2UfadQbnCA (button) folded before Flop (didn't bet)
Seat 2: f89uTQr3ieGlusj2IAYAEg (small blind) folded on the Flop
Seat 3: v4ctePcLlQw0r8E0qJtjYw (big blind) folded before Flop
Seat 4: 9XrTM0DuVxx1pjFAdSbD8A folded before Flop (didn't bet)
Seat 5: QvwRlrpVqerRRF8eJm6dDw collected ($2.40)
Seat 6: 7+uQ0OOgCTbR4ltkSwyC0g folded before Flop (didn't bet)



PokerStars Game #59941657626:  Hold'em No Limit ($0.25/$0.50) - 2009/07/01 1:42:05 ET
Table 'kgbJRsxfv64KrErDRBAkcw' 6-max Seat #5 is the button
Seat 1: k0xQy0tZZC75zf+pcK0bkQ ($50 in chips)
Seat 2: AdS8BJMOheS01zjCDfPMFg ($88.60 in chips)
Seat 3: c4MNIaIyPMOMxrgT8FT5nA ($155.25 in chips)
Seat 4: 2igtJLmvIZ+HqX4XPgMPZA ($111.75 in chips)
Seat 5: eUBBn2R56C1IQ6Cs/vitwg ($109.15 in chips)
Seat 6: 1b+2BbjMN8qhR1WPqdE9VQ ($51.70 in chips)
1b+2BbjMN8qhR1WPqdE9VQ: posts small blind $0.25
k0xQy0tZZC75zf+pcK0bkQ: posts big blind $0.50
*** HOLE CARDS ***
AdS8BJMOheS01zjCDfPMFg: raises $1 to $1.50
c4MNIaIyPMOMxrgT8FT5nA: folds
2igtJLmvIZ+HqX4XPgMPZA: folds
eUBBn2R56C1IQ6Cs/vitwg: folds
1b+2BbjMN8qhR1WPqdE9VQ: folds
k0xQy0tZZC75zf+pcK0bkQ: folds
AdS8BJMOheS01zjCDfPMFg collected $1.25 from pot
*** SUMMARY ***
Total pot $1.25 | Rake $0
Seat 1: k0xQy0tZZC75zf+pcK0bkQ (big blind) folded before Flop
Seat 2: AdS8BJMOheS01zjCDfPMFg collected ($1.25)
Seat 3: c4MNIaIyPMOMxrgT8FT5nA folded before Flop (didn't bet)
Seat 4: 2igtJLmvIZ+HqX4XPgMPZA folded before Flop (didn't bet)
Seat 5: eUBBn2R56C1IQ6Cs/vitwg (button) folded before Flop (didn't bet)
Seat 6: 1b+2BbjMN8qhR1WPqdE9VQ (small blind) folded before Flop



PokerStars Game #59941659412:  Hold'em No Limit ($0.25/$0.50) - 2009/07/01 1:42:08 ET
Table '5qf8oPyYje71HBKD0FwPgQ' 9-max Seat #1 is the button
Seat 1: gsyXT42WLEcOS4DdEk2wlw ($29.25 in chips)
Seat 2: M+7+BTmX5vZatHVuoRB1nA ($68.45 in chips)
Seat 3: vacmVLJJECYI6HjAynFcpg ($50 in chips)
Seat 4: YXCE3WOZi8g2sIf3y/plVw ($57.75 in chips)
Seat 5: uo2Sgpknd7NdeVbeSCG02A ($12.20 in chips)
Seat 6: go0Ad6tqqJ4tR9/bqVlO0g ($24.20 in chips)
Seat 7: 1q5EPoiflJRl8pqfnVLjMw ($55.50 in chips)
Seat 8: sakr/FIfFtIZwDPmAj5Pzg ($56.85 in chips)
Seat 9: jWDRpL0TJljg+mBCE9ZMqA ($9.75 in chips)
M+7+BTmX5vZatHVuoRB1nA: posts small blind $0.25
vacmVLJJECYI6HjAynFcpg: posts big blind $0.50
*** HOLE CARDS ***
YXCE3WOZi8g2sIf3y/plVw: folds
uo2Sgpknd7NdeVbeSCG02A: raises $1.50 to $2
go0Ad6tqqJ4tR9/bqVlO0g: folds
1q5EPoiflJRl8pqfnVLjMw: calls $2
sakr/FIfFtIZwDPmAj5Pzg: folds
jWDRpL0TJljg+mBCE9ZMqA: raises $7.75 to $9.75 and is all-in
gsyXT42WLEcOS4DdEk2wlw: folds
M+7+BTmX5vZatHVuoRB1nA: folds
vacmVLJJECYI6HjAynFcpg: folds
uo2Sgpknd7NdeVbeSCG02A: raises $2.45 to $12.20 and is all-in
1q5EPoiflJRl8pqfnVLjMw: folds
*** FLOP *** [6s 7s 2s]
*** TURN *** [6s 7s 2s] [5c]
*** RIVER *** [6s 7s 2s 5c] [8d]
*** SHOW DOWN ***
uo2Sgpknd7NdeVbeSCG02A: shows [Ac Kc] (high card Ace)
jWDRpL0TJljg+mBCE9ZMqA: shows [Ah As] (a pair of Aces)
jWDRpL0TJljg+mBCE9ZMqA collected $21.15 from pot
*** SUMMARY ***
Total pot $22.25 | Rake $1.10
Board [6s 7s 2s 5c 8d]
Seat 1: gsyXT42WLEcOS4DdEk2wlw (button) folded before Flop (didn't bet)
Seat 2: M+7+BTmX5vZatHVuoRB1nA (small blind) folded before Flop
Seat 3: vacmVLJJECYI6HjAynFcpg (big blind) folded before Flop
Seat 4: YXCE3WOZi8g2sIf3y/plVw folded before Flop (didn't bet)
Seat 5: uo2Sgpknd7NdeVbeSCG02A showed [Ac Kc] and lost with high card Ace
Seat 6: go0Ad6tqqJ4tR9/bqVlO0g folded before Flop (didn't bet)
Seat 7: 1q5EPoiflJRl8pqfnVLjMw folded before Flop
Seat 8: sakr/FIfFtIZwDPmAj5Pzg folded before Flop (didn't bet)
Seat 9: jWDRpL0TJljg+mBCE9ZMqA showed [Ah As] and won ($21.15) with a pair of Aces



PokerStars Game #59941659618:  Hold'em No Limit ($0.25/$0.50) - 2009/07/01 1:42:09 ET
Table '3FhG0gl3kMX3wBEEqj+wnQ' 9-max Seat #3 is the button
Seat 1: bxLSulbgr8LmKNjOzw8URg ($49.75 in chips)
Seat 2: HZkVla4kK2SI42CVrPZ/ig ($18.30 in chips)
Seat 3: YXCE3WOZi8g2sIf3y/plVw ($60.80 in chips)
Seat 4: e2+sK/yjnj94rXOKoxPP2A ($68.25 in chips)
Seat 5: XcLXSUMHSpshK/7Lh0M4Vg ($11.05 in chips)
Seat 6: 997ViqAtWn1FPjJqcffwcA ($109.05 in chips)
Seat 7: mSD1pginDsyHG5PDfqzphw ($19.45 in chips)
Seat 8: j3K/Jujr7PY4ZM2RZvlH6A ($44.40 in chips)
Seat 9: KA0tkubTlbhmo4ju+qgXPg ($43.10 in chips)
e2+sK/yjnj94rXOKoxPP2A: posts small blind $0.25
XcLXSUMHSpshK/7Lh0M4Vg: posts big blind $0.50
*** HOLE CARDS ***
997ViqAtWn1FPjJqcffwcA: folds
mSD1pginDsyHG5PDfqzphw: folds
997ViqAtWn1FPjJqcffwcA leaves the table
j3K/Jujr7PY4ZM2RZvlH6A: raises $4.50 to $5
KA0tkubTlbhmo4ju+qgXPg: folds
bxLSulbgr8LmKNjOzw8URg: folds
HZkVla4kK2SI42CVrPZ/ig: folds
YXCE3WOZi8g2sIf3y/plVw: folds
e2+sK/yjnj94rXOKoxPP2A: folds
XcLXSUMHSpshK/7Lh0M4Vg: folds
j3K/Jujr7PY4ZM2RZvlH6A collected $1.25 from pot
j3K/Jujr7PY4ZM2RZvlH6A: doesn't show hand
*** SUMMARY ***
Total pot $1.25 | Rake $0
Seat 1: bxLSulbgr8LmKNjOzw8URg folded before Flop (didn't bet)
Seat 2: HZkVla4kK2SI42CVrPZ/ig folded before Flop (didn't bet)
Seat 3: YXCE3WOZi8g2sIf3y/plVw (button) folded before Flop (didn't bet)
Seat 4: e2+sK/yjnj94rXOKoxPP2A (small blind) folded before Flop
Seat 5: XcLXSUMHSpshK/7Lh0M4Vg (big blind) folded before Flop
Seat 6: 997ViqAtWn1FPjJqcffwcA folded before Flop (didn't bet)
Seat 7: mSD1pginDsyHG5PDfqzphw folded before Flop (didn't bet)
Seat 8: j3K/Jujr7PY4ZM2RZvlH6A collected ($1.25)
Seat 9: KA0tkubTlbhmo4ju+qgXPg folded before Flop (didn't bet)



PokerStars Game #59941659924:  Hold'em No Limit ($0.25/$0.50) - 2009/07/01 1:42:09 ET
Table 'otvGDROEDdqsabxskT79qg' 9-max Seat #2 is the button
Seat 1: M+D23GG26WXQ/2gyjREVOQ ($49.25 in chips)
Seat 2: 8pfDpjfHmTUlkgzpRPwQYQ ($27 in chips)
Seat 3: +k7T5ocke8UwavtgUHm+Cg ($89.85 in chips)
Seat 4: MG90wfSJZnOejs/KD3vlQQ ($81.35 in chips)
Seat 5: aaHXfJPbwwtrerPKvT348Q ($2.95 in chips)
Seat 6: FFVKBJT0lZf+jFlgvy7ang ($45.05 in chips)
Seat 9: kuqESbpg/khtwiEKRXv2lg ($49.95 in chips)
+k7T5ocke8UwavtgUHm+Cg: posts small blind $0.25
MG90wfSJZnOejs/KD3vlQQ: posts big blind $0.50
7CKaQEWhd40e2lLifzZ1Cw: sits out
*** HOLE CARDS ***
aaHXfJPbwwtrerPKvT348Q: folds
FFVKBJT0lZf+jFlgvy7ang: folds
kuqESbpg/khtwiEKRXv2lg: calls $0.50
M+D23GG26WXQ/2gyjREVOQ: folds
8pfDpjfHmTUlkgzpRPwQYQ: folds
+k7T5ocke8UwavtgUHm+Cg: calls $0.25
MG90wfSJZnOejs/KD3vlQQ: checks
*** FLOP *** [6c Js 7c]
+k7T5ocke8UwavtgUHm+Cg: checks
MG90wfSJZnOejs/KD3vlQQ: bets $1.25
kuqESbpg/khtwiEKRXv2lg: folds
+k7T5ocke8UwavtgUHm+Cg: folds
MG90wfSJZnOejs/KD3vlQQ collected $1.45 from pot
MG90wfSJZnOejs/KD3vlQQ: doesn't show hand
*** SUMMARY ***
Total pot $1.50 | Rake $0.05
Board [6c Js 7c]
Seat 1: M+D23GG26WXQ/2gyjREVOQ folded before Flop (didn't bet)
Seat 2: 8pfDpjfHmTUlkgzpRPwQYQ (button) folded before Flop (didn't bet)
Seat 3: +k7T5ocke8UwavtgUHm+Cg (small blind) folded on the Flop
Seat 4: MG90wfSJZnOejs/KD3vlQQ (big blind) collected ($1.45)
Seat 5: aaHXfJPbwwtrerPKvT348Q folded before Flop (didn't bet)
Seat 6: FFVKBJT0lZf+jFlgvy7ang folded before Flop (didn't bet)
Seat 9: kuqESbpg/khtwiEKRXv2lg folded on the Flop



PokerStars Game #59941661240:  Hold'em No Limit ($0.25/$0.50) - 2009/07/01 1:42:12 ET
Table 'hSTs/dUsYLgJQuF2Onp0MQ' 6-max Seat #2 is the button
Seat 1: Hdd4js36ITbTJ/QuVYwTlA ($98.25 in chips)
Seat 2: vhWS+cwAJNd3JzqVzIjBZA ($50.20 in chips)
Seat 3: lxIzoHy0RnkfFSODHC2liw ($50 in chips)
Seat 4: 2igtJLmvIZ+HqX4XPgMPZA ($50.50 in chips)
Seat 5: FsRQ5ECdlLkLYI5le8+PDQ ($50.35 in chips)
Seat 6: M1KyQQvVPVuxqTAB8sR/zQ ($104.70 in chips)
lxIzoHy0RnkfFSODHC2liw: posts small blind $0.25
2igtJLmvIZ+HqX4XPgMPZA: posts big blind $0.50
Hdd4js36ITbTJ/QuVYwTlA: posts big blind $0.50
*** HOLE CARDS ***
FsRQ5ECdlLkLYI5le8+PDQ: folds
M1KyQQvVPVuxqTAB8sR/zQ: raises $1.50 to $2
Hdd4js36ITbTJ/QuVYwTlA: calls $1.50
vhWS+cwAJNd3JzqVzIjBZA: folds
lxIzoHy0RnkfFSODHC2liw: folds
2igtJLmvIZ+HqX4XPgMPZA: calls $1.50
*** FLOP *** [9h 6s 5c]
2igtJLmvIZ+HqX4XPgMPZA: checks
M1KyQQvVPVuxqTAB8sR/zQ: checks
Hdd4js36ITbTJ/QuVYwTlA: checks
*** TURN *** [9h 6s 5c] [3h]
2igtJLmvIZ+HqX4XPgMPZA: checks
M1KyQQvVPVuxqTAB8sR/zQ: checks
Hdd4js36ITbTJ/QuVYwTlA: bets $3
2igtJLmvIZ+HqX4XPgMPZA: calls $3
M1KyQQvVPVuxqTAB8sR/zQ: folds
*** RIVER *** [9h 6s 5c 3h] [8s]
2igtJLmvIZ+HqX4XPgMPZA: checks
Hdd4js36ITbTJ/QuVYwTlA: bets $4
2igtJLmvIZ+HqX4XPgMPZA: calls $4
*** SHOW DOWN ***
Hdd4js36ITbTJ/QuVYwTlA: shows [4s Qc] (high card Queen)
2igtJLmvIZ+HqX4XPgMPZA: shows [Ac Jc] (high card Ace)
2igtJLmvIZ+HqX4XPgMPZA collected $19.30 from pot
*** SUMMARY ***
Total pot $20.25 | Rake $0.95
Board [9h 6s 5c 3h 8s]
Seat 1: Hdd4js36ITbTJ/QuVYwTlA showed [4s Qc] and lost with high card Queen
Seat 2: vhWS+cwAJNd3JzqVzIjBZA (button) folded before Flop (didn't bet)
Seat 3: lxIzoHy0RnkfFSODHC2liw (small blind) folded before Flop
Seat 4: 2igtJLmvIZ+HqX4XPgMPZA (big blind) showed [Ac Jc] and won ($19.30) with high card Ace
Seat 5: FsRQ5ECdlLkLYI5le8+PDQ folded before Flop (didn't bet)
Seat 6: M1KyQQvVPVuxqTAB8sR/zQ folded on the Turn



PokerStars Game #59941661280:  Hold'em No Limit ($0.25/$0.50) - 2009/07/01 1:42:12 ET
Table 'b14oxfBMAjhXizfPVeTHng' 2-max Seat #2 is the button
Seat 1: NKw4WYm5uUoeEVf4i0fBvA ($21.30 in chips)
Seat 2: FeErMt4Gvt/3PH2oB/pn4A ($9.50 in chips)
FeErMt4Gvt/3PH2oB/pn4A: posts small blind $0.25
NKw4WYm5uUoeEVf4i0fBvA: posts big blind $0.50
*** HOLE CARDS ***
FeErMt4Gvt/3PH2oB/pn4A: raises $1 to $1.50
NKw4WYm5uUoeEVf4i0fBvA: folds
FeErMt4Gvt/3PH2oB/pn4A collected $1 from pot
FeErMt4Gvt/3PH2oB/pn4A: doesn't show hand
*** SUMMARY ***
Total pot $1 | Rake $0
Seat 1: NKw4WYm5uUoeEVf4i0fBvA (big blind) folded before Flop
Seat 2: FeErMt4Gvt/3PH2oB/pn4A (button) (small blind) collected ($1)



PokerStars Game #59941661786:  Hold'em No Limit ($0.25/$0.50) - 2009/07/01 1:42:13 ET
Table 'B+sqsfj6d6zXicNfaseTaw' 2-max Seat #2 is the button
Seat 1: +4GNcSsecmapVGSdV0mUPA ($148.35 in chips)
Seat 2: Lv5RmpRe6LtPkBzM9Gpo5A ($71.15 in chips)
Lv5RmpRe6LtPkBzM9Gpo5A: posts small blind $0.25
+4GNcSsecmapVGSdV0mUPA: posts big blind $0.50
*** HOLE CARDS ***
Lv5RmpRe6LtPkBzM9Gpo5A: raises $1 to $1.50
+4GNcSsecmapVGSdV0mUPA: calls $1
*** FLOP *** [Tc 5s 4s]
+4GNcSsecmapVGSdV0mUPA: checks
Lv5RmpRe6LtPkBzM9Gpo5A: checks
*** TURN *** [Tc 5s 4s] [Qd]
+4GNcSsecmapVGSdV0mUPA: checks
Lv5RmpRe6LtPkBzM9Gpo5A: bets $2
+4GNcSsecmapVGSdV0mUPA: calls $2
*** RIVER *** [Tc 5s 4s Qd] [Qs]
+4GNcSsecmapVGSdV0mUPA: checks
Lv5RmpRe6LtPkBzM9Gpo5A: checks
*** SHOW DOWN ***
+4GNcSsecmapVGSdV0mUPA: shows [5d 9d] (two pair, Queens and Fives)
Lv5RmpRe6LtPkBzM9Gpo5A: mucks hand
+4GNcSsecmapVGSdV0mUPA collected $6.70 from pot
*** SUMMARY ***
Total pot $7 | Rake $0.30
Board [Tc 5s 4s Qd Qs]
Seat 1: +4GNcSsecmapVGSdV0mUPA (big blind) showed [5d 9d] and won ($6.70) with two pair, Queens and Fives
Seat 2: Lv5RmpRe6LtPkBzM9Gpo5A (button) (small blind) mucked



PokerStars Game #59941662032:  Hold'em No Limit ($0.25/$0.50) - 2009/07/01 1:42:13 ET
Table '5EmHi+fnatGQQShcNmzOZQ' 6-max Seat #5 is the button
Seat 1: avNOJXWxD1+SygFmWsd+qw ($66.10 in chips)
Seat 3: QmH/ZFyxZfvliy57YM9yxw ($76.80 in chips)
Seat 4: 1b+2BbjMN8qhR1WPqdE9VQ ($59.80 in chips)
Seat 5: 6yWjZXHP6iAyMEDF6pJlng ($55.30 in chips)
avNOJXWxD1+SygFmWsd+qw: posts small blind $0.25
OZ6OtYh5Y53MCH/p0QTn5g: is sitting out
QmH/ZFyxZfvliy57YM9yxw: posts big blind $0.50
*** HOLE CARDS ***
OZ6OtYh5Y53MCH/p0QTn5g leaves the table
1b+2BbjMN8qhR1WPqdE9VQ: raises $1 to $1.50
6yWjZXHP6iAyMEDF6pJlng: calls $1.50
avNOJXWxD1+SygFmWsd+qw: folds
QmH/ZFyxZfvliy57YM9yxw: folds
*** FLOP *** [Ah Kh 8h]
u3Ol7kv1LmvszuHNm9rc6w leaves the table
1b+2BbjMN8qhR1WPqdE9VQ: checks
vhWS+cwAJNd3JzqVzIjBZA joins the table at seat #2
6yWjZXHP6iAyMEDF6pJlng: bets $2
1b+2BbjMN8qhR1WPqdE9VQ: calls $2
*** TURN *** [Ah Kh 8h] [2h]
1b+2BbjMN8qhR1WPqdE9VQ: checks
I6jT30IIGKfk3BWwujd6WQ joins the table at seat #6
6yWjZXHP6iAyMEDF6pJlng: bets $3.50
1b+2BbjMN8qhR1WPqdE9VQ: calls $3.50
*** RIVER *** [Ah Kh 8h 2h] [7h]
1b+2BbjMN8qhR1WPqdE9VQ: checks
6yWjZXHP6iAyMEDF6pJlng: bets $5
1b+2BbjMN8qhR1WPqdE9VQ: calls $5
*** SHOW DOWN ***
6yWjZXHP6iAyMEDF6pJlng: shows [Ac Jh] (a flush, Ace high)
1b+2BbjMN8qhR1WPqdE9VQ: mucks hand
6yWjZXHP6iAyMEDF6pJlng collected $23.55 from pot
*** SUMMARY ***
Total pot $24.75 | Rake $1.20
Board [Ah Kh 8h 2h 7h]
Seat 1: avNOJXWxD1+SygFmWsd+qw (small blind) folded before Flop
Seat 3: QmH/ZFyxZfvliy57YM9yxw (big blind) folded before Flop
Seat 4: 1b+2BbjMN8qhR1WPqdE9VQ mucked
Seat 5: 6yWjZXHP6iAyMEDF6pJlng (button) showed [Ac Jh] and won ($23.55) with a flush, Ace high



PokerStars Game #59941662672:  Hold'em No Limit ($0.25/$0.50) - 2009/07/01 1:42:14 ET
Table '2lPOwetm4cfkZPbTmGPH/w' 2-max Seat #2 is the button
Seat 1: vUGdApqS8J/GJE2gaVWl1w ($14.30 in chips)
Seat 2: XFa6sBGjP2gxoIvxR3fZIg ($21.85 in chips)
XFa6sBGjP2gxoIvxR3fZIg: posts small blind $0.25
vUGdApqS8J/GJE2gaVWl1w: posts big blind $0.50
*** HOLE CARDS ***
XFa6sBGjP2gxoIvxR3fZIg: calls $0.25
vUGdApqS8J/GJE2gaVWl1w: checks
*** FLOP *** [Kh 6s Jh]
vUGdApqS8J/GJE2gaVWl1w: checks
XFa6sBGjP2gxoIvxR3fZIg: checks
*** TURN *** [Kh 6s Jh] [7h]
vUGdApqS8J/GJE2gaVWl1w: checks
XFa6sBGjP2gxoIvxR3fZIg: checks
*** RIVER *** [Kh 6s Jh 7h] [5c]
vUGdApqS8J/GJE2gaVWl1w: checks
XFa6sBGjP2gxoIvxR3fZIg: checks
*** SHOW DOWN ***
vUGdApqS8J/GJE2gaVWl1w: shows [9d 3d] (high card King)
XFa6sBGjP2gxoIvxR3fZIg: shows [Qd 5d] (a pair of Fives)
XFa6sBGjP2gxoIvxR3fZIg collected $0.95 from pot
*** SUMMARY ***
Total pot $1 | Rake $0.05
Board [Kh 6s Jh 7h 5c]
Seat 1: vUGdApqS8J/GJE2gaVWl1w (big blind) showed [9d 3d] and lost with high card King
Seat 2: XFa6sBGjP2gxoIvxR3fZIg (button) (small blind) showed [Qd 5d] and won ($0.95) with a pair of Fives



PokerStars Game #59941663722:  Hold'em No Limit ($0.25/$0.50) - 2009/07/01 1:42:16 ET
Table 'hWT2kq66tnKEpD26cia6fQ' 2-max Seat #1 is the button
Seat 1: Ce3KNFP+ao7Da9NHb65raw ($19.15 in chips)
Seat 2: 16tvT7AYgZ2LgiGFcvFKQg ($53.10 in chips)
Ce3KNFP+ao7Da9NHb65raw: posts small blind $0.25
16tvT7AYgZ2LgiGFcvFKQg: posts big blind $0.50
*** HOLE CARDS ***
Ce3KNFP+ao7Da9NHb65raw: calls $0.25
16tvT7AYgZ2LgiGFcvFKQg: checks
*** FLOP *** [Jc Ad 9s]
16tvT7AYgZ2LgiGFcvFKQg: bets $0.50
Ce3KNFP+ao7Da9NHb65raw: folds
16tvT7AYgZ2LgiGFcvFKQg collected $0.95 from pot
*** SUMMARY ***
Total pot $1 | Rake $0.05
Board [Jc Ad 9s]
Seat 1: Ce3KNFP+ao7Da9NHb65raw (button) (small blind) folded on the Flop
Seat 2: 16tvT7AYgZ2LgiGFcvFKQg (big blind) collected ($0.95)



PokerStars Game #59941664596:  Hold'em No Limit ($0.25/$0.50) - 2009/07/01 1:42:18 ET
Table 'ZYI3ZReBjdfKEYItkZHI6A' 9-max Seat #9 is the button
Seat 1: IYd5zG8k7vdBNVHbHg2Pag ($59.90 in chips)
Seat 2: 5acK4E7fzEwnplVBZ6eNWA ($50 in chips)
Seat 3: 75K2MXwN65Sjfp1yHd50Hg ($8.50 in chips)
Seat 4: /UdtxmXsFx6K/14AbHqzbQ ($8.70 in chips)
Seat 5: ApHP7ouup365XIUFBdEDxg ($19.60 in chips)
Seat 6: 1xBtrSVBbgFH/viUWKqQeg ($37 in chips)
Seat 8: ji04uOybxCdpdefzlUQeKQ ($28.80 in chips)
Seat 9: HZkVla4kK2SI42CVrPZ/ig ($10.15 in chips)
IYd5zG8k7vdBNVHbHg2Pag: posts small blind $0.25
5acK4E7fzEwnplVBZ6eNWA: posts big blind $0.50
XysesR1vUp34S3HSj4ez+w: sits out
*** HOLE CARDS ***
75K2MXwN65Sjfp1yHd50Hg: folds
/UdtxmXsFx6K/14AbHqzbQ: calls $0.50
ApHP7ouup365XIUFBdEDxg: folds
1xBtrSVBbgFH/viUWKqQeg: raises $2 to $2.50
ji04uOybxCdpdefzlUQeKQ: calls $2.50
HZkVla4kK2SI42CVrPZ/ig: folds
IYd5zG8k7vdBNVHbHg2Pag has timed out
IYd5zG8k7vdBNVHbHg2Pag: folds
IYd5zG8k7vdBNVHbHg2Pag is sitting out
5acK4E7fzEwnplVBZ6eNWA: folds
IYd5zG8k7vdBNVHbHg2Pag has returned
/UdtxmXsFx6K/14AbHqzbQ: calls $2
*** FLOP *** [5s 3h 7h]
/UdtxmXsFx6K/14AbHqzbQ: checks
1xBtrSVBbgFH/viUWKqQeg: bets $4
ji04uOybxCdpdefzlUQeKQ: folds
/UdtxmXsFx6K/14AbHqzbQ: raises $2.20 to $6.20 and is all-in
1xBtrSVBbgFH/viUWKqQeg: calls $2.20
*** TURN *** [5s 3h 7h] [9d]
*** RIVER *** [5s 3h 7h 9d] [Qs]
*** SHOW DOWN ***
/UdtxmXsFx6K/14AbHqzbQ: shows [7c 7s] (three of a kind, Sevens)
1xBtrSVBbgFH/viUWKqQeg: mucks hand
/UdtxmXsFx6K/14AbHqzbQ collected $19.65 from pot
*** SUMMARY ***
Total pot $20.65 | Rake $1
Board [5s 3h 7h 9d Qs]
Seat 1: IYd5zG8k7vdBNVHbHg2Pag (small blind) folded before Flop
Seat 2: 5acK4E7fzEwnplVBZ6eNWA (big blind) folded before Flop
Seat 3: 75K2MXwN65Sjfp1yHd50Hg folded before Flop (didn't bet)
Seat 4: /UdtxmXsFx6K/14AbHqzbQ showed [7c 7s] and won ($19.65) with three of a kind, Sevens
Seat 5: ApHP7ouup365XIUFBdEDxg folded before Flop (didn't bet)
Seat 6: 1xBtrSVBbgFH/viUWKqQeg mucked
Seat 8: ji04uOybxCdpdefzlUQeKQ folded on the Flop
Seat 9: HZkVla4kK2SI42CVrPZ/ig (button) folded before Flop (didn't bet)



PokerStars Game #59941665424:  Hold'em No Limit ($0.25/$0.50) - 2009/07/01 1:42:19 ET
Table 'b14oxfBMAjhXizfPVeTHng' 2-max Seat #1 is the button
Seat 1: NKw4WYm5uUoeEVf4i0fBvA ($20.80 in chips)
Seat 2: FeErMt4Gvt/3PH2oB/pn4A ($10 in chips)
NKw4WYm5uUoeEVf4i0fBvA: posts small blind $0.25
FeErMt4Gvt/3PH2oB/pn4A: posts big blind $0.50
*** HOLE CARDS ***
FeErMt4Gvt/3PH2oB/pn4A said, "u understand?"
NKw4WYm5uUoeEVf4i0fBvA: calls $0.25
FeErMt4Gvt/3PH2oB/pn4A: raises $1 to $1.50
NKw4WYm5uUoeEVf4i0fBvA: calls $1
*** FLOP *** [5h Ah 5d]
FeErMt4Gvt/3PH2oB/pn4A: checks
NKw4WYm5uUoeEVf4i0fBvA: bets $5.50
FeErMt4Gvt/3PH2oB/pn4A: raises $3 to $8.50 and is all-in
NKw4WYm5uUoeEVf4i0fBvA: calls $3
*** TURN *** [5h Ah 5d] [7c]
*** RIVER *** [5h Ah 5d 7c] [Jd]
*** SHOW DOWN ***
FeErMt4Gvt/3PH2oB/pn4A: shows [3c As] (two pair, Aces and Fives)
NKw4WYm5uUoeEVf4i0fBvA: mucks hand
FeErMt4Gvt/3PH2oB/pn4A said, "hehe"
FeErMt4Gvt/3PH2oB/pn4A collected $19.50 from pot
*** SUMMARY ***
Total pot $20 | Rake $0.50
Board [5h Ah 5d 7c Jd]
Seat 1: NKw4WYm5uUoeEVf4i0fBvA (button) (small blind) mucked
Seat 2: FeErMt4Gvt/3PH2oB/pn4A (big blind) showed [3c As] and won ($19.50) with two pair, Aces and Fives



PokerStars Game #59941665840:  Hold'em No Limit ($0.25/$0.50) - 2009/07/01 1:42:20 ET
Table 'BCN5su+SsXiy1zRMJi0SJw' 6-max Seat #3 is the button
Seat 1: GxXV09ciXaOxyY2H5aMIIw ($34.20 in chips)
Seat 2: ehFNAevCQri3trWxV6FJdA ($85.55 in chips)
Seat 3: kwgv5lNhiFrfONXCshzxlA ($71.25 in chips)
Seat 4: bbsK8j+tpuVRhBqDzHxf7w ($49.35 in chips)
Seat 5: kxPhs4ePFqMy52CInAJ2aw ($49.75 in chips)
Seat 6: b2symlOdL7+0c9Pj4N/KlA ($78.70 in chips)
bbsK8j+tpuVRhBqDzHxf7w: posts small blind $0.25
kxPhs4ePFqMy52CInAJ2aw: posts big blind $0.50
*** HOLE CARDS ***
b2symlOdL7+0c9Pj4N/KlA: folds
GxXV09ciXaOxyY2H5aMIIw: folds
ehFNAevCQri3trWxV6FJdA: raises $0.50 to $1
kwgv5lNhiFrfONXCshzxlA: raises $4 to $5
bbsK8j+tpuVRhBqDzHxf7w: folds
kxPhs4ePFqMy52CInAJ2aw: folds
ehFNAevCQri3trWxV6FJdA: folds
kwgv5lNhiFrfONXCshzxlA collected $2.75 from pot
*** SUMMARY ***
Total pot $2.75 | Rake $0
Seat 1: GxXV09ciXaOxyY2H5aMIIw folded before Flop (didn't bet)
Seat 2: ehFNAevCQri3trWxV6FJdA folded before Flop
Seat 3: kwgv5lNhiFrfONXCshzxlA (button) collected ($2.75)
Seat 4: bbsK8j+tpuVRhBqDzHxf7w (small blind) folded before Flop
Seat 5: kxPhs4ePFqMy52CInAJ2aw (big blind) folded before Flop
Seat 6: b2symlOdL7+0c9Pj4N/KlA folded before Flop (didn't bet)



PokerStars Game #59941666172:  Hold'em No Limit ($0.25/$0.50) - 2009/07/01 1:42:21 ET
Table 'kgbJRsxfv64KrErDRBAkcw' 6-max Seat #6 is the button
Seat 1: k0xQy0tZZC75zf+pcK0bkQ ($49.50 in chips)
Seat 2: AdS8BJMOheS01zjCDfPMFg ($89.35 in chips)
Seat 3: c4MNIaIyPMOMxrgT8FT5nA ($155.25 in chips)
Seat 4: 2igtJLmvIZ+HqX4XPgMPZA ($111.75 in chips)
Seat 5: eUBBn2R56C1IQ6Cs/vitwg ($109.15 in chips)
Seat 6: 1b+2BbjMN8qhR1WPqdE9VQ ($51.45 in chips)
k0xQy0tZZC75zf+pcK0bkQ: posts small blind $0.25
AdS8BJMOheS01zjCDfPMFg: posts big blind $0.50
*** HOLE CARDS ***
c4MNIaIyPMOMxrgT8FT5nA: raises $1.50 to $2
2igtJLmvIZ+HqX4XPgMPZA: folds
eUBBn2R56C1IQ6Cs/vitwg: folds
1b+2BbjMN8qhR1WPqdE9VQ: folds
k0xQy0tZZC75zf+pcK0bkQ: folds
AdS8BJMOheS01zjCDfPMFg: calls $1.50
*** FLOP *** [4h 9h 2d]
AdS8BJMOheS01zjCDfPMFg: checks
c4MNIaIyPMOMxrgT8FT5nA: bets $3.50
AdS8BJMOheS01zjCDfPMFg: folds
c4MNIaIyPMOMxrgT8FT5nA collected $4.05 from pot
c4MNIaIyPMOMxrgT8FT5nA: doesn't show hand
*** SUMMARY ***
Total pot $4.25 | Rake $0.20
Board [4h 9h 2d]
Seat 1: k0xQy0tZZC75zf+pcK0bkQ (small blind) folded before Flop
Seat 2: AdS8BJMOheS01zjCDfPMFg (big blind) folded on the Flop
Seat 3: c4MNIaIyPMOMxrgT8FT5nA collected ($4.05)
Seat 4: 2igtJLmvIZ+HqX4XPgMPZA folded before Flop (didn't bet)
Seat 5: eUBBn2R56C1IQ6Cs/vitwg folded before Flop (didn't bet)
Seat 6: 1b+2BbjMN8qhR1WPqdE9VQ (button) folded before Flop (didn't bet)



PokerStars Game #59941666778:  Hold'em No Limit ($0.25/$0.50) - 2009/07/01 1:42:22 ET
Table 'Nz0Vr7WMHL2g5Uk7dDZjpw' 9-max Seat #4 is the button
Seat 1: 9yMsdgReyOUerNsmTYCCDQ ($8.25 in chips)
Seat 2: SegjDnMxWMujiD57ESNL+g ($19.60 in chips)
Seat 3: c638Xxo+q5F/t5qMtmvmvQ ($50.65 in chips)
Seat 4: uw9QayAAxLM3Hb+HR7mSkg ($8.50 in chips)
Seat 5: WGW0DgjBUXs1ylURHG8vnQ ($13.45 in chips)
Seat 7: KPLH0gELgFe2OuAnhJFI5w ($27.95 in chips)
Seat 8: aoL+R/61Kxmw69ypuPrWAQ ($30.20 in chips)
Seat 9: mSD1pginDsyHG5PDfqzphw ($16.50 in chips)
WGW0DgjBUXs1ylURHG8vnQ: posts small blind $0.25
KPLH0gELgFe2OuAnhJFI5w: posts big blind $0.50
*** HOLE CARDS ***
aoL+R/61Kxmw69ypuPrWAQ: calls $0.50
SegjDnMxWMujiD57ESNL+g said, "hi"
mSD1pginDsyHG5PDfqzphw: folds
SegjDnMxWMujiD57ESNL+g said, "not much. how about u?"
9yMsdgReyOUerNsmTYCCDQ: folds
SegjDnMxWMujiD57ESNL+g: folds
c638Xxo+q5F/t5qMtmvmvQ: folds
uw9QayAAxLM3Hb+HR7mSkg: folds
WGW0DgjBUXs1ylURHG8vnQ: calls $0.25
KPLH0gELgFe2OuAnhJFI5w: checks
*** FLOP *** [3d Kc 8d]
Alf.STG joins the table at seat #6
WGW0DgjBUXs1ylURHG8vnQ: checks
KPLH0gELgFe2OuAnhJFI5w: bets $1
aoL+R/61Kxmw69ypuPrWAQ: folds
WGW0DgjBUXs1ylURHG8vnQ: folds
KPLH0gELgFe2OuAnhJFI5w collected $1.45 from pot
*** SUMMARY ***
Total pot $1.50 | Rake $0.05
Board [3d Kc 8d]
Seat 1: 9yMsdgReyOUerNsmTYCCDQ folded before Flop (didn't bet)
Seat 2: SegjDnMxWMujiD57ESNL+g folded before Flop (didn't bet)
Seat 3: c638Xxo+q5F/t5qMtmvmvQ folded before Flop (didn't bet)
Seat 4: uw9QayAAxLM3Hb+HR7mSkg (button) folded before Flop (didn't bet)
Seat 5: WGW0DgjBUXs1ylURHG8vnQ (small blind) folded on the Flop
Seat 7: KPLH0gELgFe2OuAnhJFI5w (big blind) collected ($1.45)
Seat 8: aoL+R/61Kxmw69ypuPrWAQ folded on the Flop
Seat 9: mSD1pginDsyHG5PDfqzphw folded before Flop (didn't bet)



PokerStars Game #59941667324:  Hold'em No Limit ($0.25/$0.50) - 2009/07/01 1:42:23 ET
Table 'iq+aXfWVQRdV0u8SRTYUEg' 9-max Seat #6 is the button
Seat 1: 3yl8Q6QaLfGtyhN4/pEFgQ ($71.05 in chips)
Seat 2: J9N0lxHFd/Js2S0xZLbsIQ ($32.45 in chips)
Seat 3: bMkgDRXl6YaqJ4b/5qml2Q ($9.50 in chips)
Seat 4: vHYT5s323LpajBj+2c9zbQ ($24.85 in chips)
Seat 5: 997ViqAtWn1FPjJqcffwcA ($56.65 in chips)
Seat 6: bTJ0WgoxefTPxIoycS7uoA ($24.95 in chips)
Seat 8: /DtIHuxEH+3tzKefmSV+Mw ($43.55 in chips)
Seat 9: drKg+7JekfxR/0poTEK9Tg ($50 in chips)
/DtIHuxEH+3tzKefmSV+Mw: posts small blind $0.25
drKg+7JekfxR/0poTEK9Tg: posts big blind $0.50
*** HOLE CARDS ***
3yl8Q6QaLfGtyhN4/pEFgQ: folds
J9N0lxHFd/Js2S0xZLbsIQ: folds
bMkgDRXl6YaqJ4b/5qml2Q: folds
vHYT5s323LpajBj+2c9zbQ: folds
997ViqAtWn1FPjJqcffwcA: folds
bTJ0WgoxefTPxIoycS7uoA: raises $1 to $1.50
/DtIHuxEH+3tzKefmSV+Mw: folds
drKg+7JekfxR/0poTEK9Tg: folds
bTJ0WgoxefTPxIoycS7uoA collected $1.25 from pot
*** SUMMARY ***
Total pot $1.25 | Rake $0
Seat 1: 3yl8Q6QaLfGtyhN4/pEFgQ folded before Flop (didn't bet)
Seat 2: J9N0lxHFd/Js2S0xZLbsIQ folded before Flop (didn't bet)
Seat 3: bMkgDRXl6YaqJ4b/5qml2Q folded before Flop (didn't bet)
Seat 4: vHYT5s323LpajBj+2c9zbQ folded before Flop (didn't bet)
Seat 5: 997ViqAtWn1FPjJqcffwcA folded before Flop (didn't bet)
Seat 6: bTJ0WgoxefTPxIoycS7uoA (button) collected ($1.25)
Seat 8: /DtIHuxEH+3tzKefmSV+Mw (small blind) folded before Flop
Seat 9: drKg+7JekfxR/0poTEK9Tg (big blind) folded before Flop



PokerStars Game #59941667408:  Hold'em No Limit ($0.25/$0.50) - 2009/07/01 1:42:23 ET
Table '+z1aekfHkpp09pc8F9aViw' 6-max Seat #5 is the button
Seat 1: L0aIPg7qefDQjdJo3HCVEA ($10.75 in chips)
Seat 3: URYNc7fPA23K2UfadQbnCA ($63.90 in chips)
Seat 4: RowCSpSURHTOL/dcjg/Iug ($84.95 in chips)
Seat 5: 2igtJLmvIZ+HqX4XPgMPZA ($51.50 in chips)
Seat 6: GUnvMULl2qFOO1yenu1UBw ($50 in chips)
GUnvMULl2qFOO1yenu1UBw: posts small blind $0.25
L0aIPg7qefDQjdJo3HCVEA: posts big blind $0.50
*** HOLE CARDS ***
URYNc7fPA23K2UfadQbnCA: folds
RowCSpSURHTOL/dcjg/Iug: folds
2igtJLmvIZ+HqX4XPgMPZA: folds
GUnvMULl2qFOO1yenu1UBw: raises $1 to $1.50
L0aIPg7qefDQjdJo3HCVEA: folds
GUnvMULl2qFOO1yenu1UBw collected $1 from pot
*** SUMMARY ***
Total pot $1 | Rake $0
Seat 1: L0aIPg7qefDQjdJo3HCVEA (big blind) folded before Flop
Seat 3: URYNc7fPA23K2UfadQbnCA folded before Flop (didn't bet)
Seat 4: RowCSpSURHTOL/dcjg/Iug folded before Flop (didn't bet)
Seat 5: 2igtJLmvIZ+HqX4XPgMPZA (button) folded before Flop (didn't bet)
Seat 6: GUnvMULl2qFOO1yenu1UBw (small blind) collected ($1)



PokerStars Game #59941668028:  Hold'em No Limit ($0.25/$0.50) - 2009/07/01 1:42:24 ET
Table 'GfL/No5u5PoEnU39lP5pQg' 6-max Seat #2 is the button
Seat 2: uVwggSetzp7d+eVgowO3vg ($53.50 in chips)
Seat 3: 4pp9WxhGdbVbxCc9tlu0lw ($25.55 in chips)
Seat 4: ifQmgsYNFiAg/XvBOMBSfQ ($49.25 in chips)
Seat 5: M1KyQQvVPVuxqTAB8sR/zQ ($51.60 in chips)
4pp9WxhGdbVbxCc9tlu0lw: posts small blind $0.25
ifQmgsYNFiAg/XvBOMBSfQ: posts big blind $0.50
kxPhs4ePFqMy52CInAJ2aw: sits out
6qJZP2EKIgnEXJ3tMSBuew: sits out
*** HOLE CARDS ***
M1KyQQvVPVuxqTAB8sR/zQ: folds
uVwggSetzp7d+eVgowO3vg has timed out
uVwggSetzp7d+eVgowO3vg: folds
uVwggSetzp7d+eVgowO3vg is sitting out
uVwggSetzp7d+eVgowO3vg has returned
4pp9WxhGdbVbxCc9tlu0lw: folds
ifQmgsYNFiAg/XvBOMBSfQ collected $0.50 from pot
*** SUMMARY ***
Total pot $0.50 | Rake $0
Seat 2: uVwggSetzp7d+eVgowO3vg (button) folded before Flop (didn't bet)
Seat 3: 4pp9WxhGdbVbxCc9tlu0lw (small blind) folded before Flop
Seat 4: ifQmgsYNFiAg/XvBOMBSfQ (big blind) collected ($0.50)
Seat 5: M1KyQQvVPVuxqTAB8sR/zQ folded before Flop (didn't bet)



PokerStars Game #59941670920:  Hold'em No Limit ($0.25/$0.50) - 2009/07/01 1:42:30 ET
Table 'lSisgp6H7Fg1hH5VfjEjYQ' 9-max Seat #5 is the button
Seat 1: 5k9fvXD9suIgCxU4HLQjTw ($52.80 in chips)
Seat 2: 5acK4E7fzEwnplVBZ6eNWA ($50.95 in chips)
Seat 3: SKnJuWHScqetA/qG5p+wCg ($30 in chips)
Seat 4: FFVKBJT0lZf+jFlgvy7ang ($38.95 in chips)
Seat 5: mSD1pginDsyHG5PDfqzphw ($15.75 in chips)
Seat 6: +k7T5ocke8UwavtgUHm+Cg ($75.40 in chips)
Seat 7: drKg+7JekfxR/0poTEK9Tg ($50 in chips)
Seat 8: a4JDWmpFQkL10XfAyuF51A ($11.85 in chips)
+k7T5ocke8UwavtgUHm+Cg: posts small blind $0.25
drKg+7JekfxR/0poTEK9Tg: posts big blind $0.50
M+D23GG26WXQ/2gyjREVOQ: sits out
*** HOLE CARDS ***
a4JDWmpFQkL10XfAyuF51A: folds
5k9fvXD9suIgCxU4HLQjTw: folds
5acK4E7fzEwnplVBZ6eNWA: folds
SKnJuWHScqetA/qG5p+wCg: folds
FFVKBJT0lZf+jFlgvy7ang: folds
mSD1pginDsyHG5PDfqzphw: folds
+k7T5ocke8UwavtgUHm+Cg: calls $0.25
drKg+7JekfxR/0poTEK9Tg: raises $1 to $1.50
+k7T5ocke8UwavtgUHm+Cg: folds
drKg+7JekfxR/0poTEK9Tg collected $1 from pot
drKg+7JekfxR/0poTEK9Tg: doesn't show hand
*** SUMMARY ***
Total pot $1 | Rake $0
Seat 1: 5k9fvXD9suIgCxU4HLQjTw folded before Flop (didn't bet)
Seat 2: 5acK4E7fzEwnplVBZ6eNWA folded before Flop (didn't bet)
Seat 3: SKnJuWHScqetA/qG5p+wCg folded before Flop (didn't bet)
Seat 4: FFVKBJT0lZf+jFlgvy7ang folded before Flop (didn't bet)
Seat 5: mSD1pginDsyHG5PDfqzphw (button) folded before Flop (didn't bet)
Seat 6: +k7T5ocke8UwavtgUHm+Cg (small blind) folded before Flop
Seat 7: drKg+7JekfxR/0poTEK9Tg (big blind) collected ($1)
Seat 8: a4JDWmpFQkL10XfAyuF51A folded before Flop (didn't bet)



PokerStars Game #59941670816:  Hold'em No Limit ($0.25/$0.50) - 2009/07/01 1:42:30 ET
Table 'hWT2kq66tnKEpD26cia6fQ' 2-max Seat #2 is the button
Seat 1: Ce3KNFP+ao7Da9NHb65raw ($18.65 in chips)
Seat 2: 16tvT7AYgZ2LgiGFcvFKQg ($53.55 in chips)
16tvT7AYgZ2LgiGFcvFKQg: posts small blind $0.25
Ce3KNFP+ao7Da9NHb65raw: posts big blind $0.50
*** HOLE CARDS ***
16tvT7AYgZ2LgiGFcvFKQg: calls $0.25
Ce3KNFP+ao7Da9NHb65raw: raises $1 to $1.50
16tvT7AYgZ2LgiGFcvFKQg: calls $1
*** FLOP *** [4c 3h Jd]
Ce3KNFP+ao7Da9NHb65raw: bets $1.50
16tvT7AYgZ2LgiGFcvFKQg: calls $1.50
*** TURN *** [4c 3h Jd] [4d]
Ce3KNFP+ao7Da9NHb65raw: checks
16tvT7AYgZ2LgiGFcvFKQg: checks
*** RIVER *** [4c 3h Jd 4d] [Jc]
Ce3KNFP+ao7Da9NHb65raw: bets $1
16tvT7AYgZ2LgiGFcvFKQg: folds
Ce3KNFP+ao7Da9NHb65raw collected $5.75 from pot
*** SUMMARY ***
Total pot $6 | Rake $0.25
Board [4c 3h Jd 4d Jc]
Seat 1: Ce3KNFP+ao7Da9NHb65raw (big blind) collected ($5.75)
Seat 2: 16tvT7AYgZ2LgiGFcvFKQg (button) (small blind) folded on the River



PokerStars Game #59941672158:  Hold'em No Limit ($0.25/$0.50) - 2009/07/01 1:42:32 ET
Table 'B+sqsfj6d6zXicNfaseTaw' 2-max Seat #1 is the button
Seat 1: +4GNcSsecmapVGSdV0mUPA ($151.55 in chips)
Seat 2: Lv5RmpRe6LtPkBzM9Gpo5A ($67.65 in chips)
+4GNcSsecmapVGSdV0mUPA: posts small blind $0.25
Lv5RmpRe6LtPkBzM9Gpo5A: posts big blind $0.50
*** HOLE CARDS ***
+4GNcSsecmapVGSdV0mUPA: calls $0.25
Lv5RmpRe6LtPkBzM9Gpo5A: checks
*** FLOP *** [8s Td 3d]
Lv5RmpRe6LtPkBzM9Gpo5A: checks
+4GNcSsecmapVGSdV0mUPA: checks
*** TURN *** [8s Td 3d] [7s]
Lv5RmpRe6LtPkBzM9Gpo5A: checks
+4GNcSsecmapVGSdV0mUPA: checks
*** RIVER *** [8s Td 3d 7s] [5h]
Lv5RmpRe6LtPkBzM9Gpo5A: bets $1.50
+4GNcSsecmapVGSdV0mUPA: folds
Lv5RmpRe6LtPkBzM9Gpo5A collected $0.95 from pot
*** SUMMARY ***
Total pot $1 | Rake $0.05
Board [8s Td 3d 7s 5h]
Seat 1: +4GNcSsecmapVGSdV0mUPA (button) (small blind) folded on the River
Seat 2: Lv5RmpRe6LtPkBzM9Gpo5A (big blind) collected ($0.95)



PokerStars Game #59941672250:  Hold'em No Limit ($0.25/$0.50) - 2009/07/01 1:42:32 ET
Table '3FhG0gl3kMX3wBEEqj+wnQ' 9-max Seat #4 is the button
Seat 1: bxLSulbgr8LmKNjOzw8URg ($49.75 in chips)
Seat 2: HZkVla4kK2SI42CVrPZ/ig ($18.30 in chips)
Seat 3: YXCE3WOZi8g2sIf3y/plVw ($60.80 in chips)
Seat 4: e2+sK/yjnj94rXOKoxPP2A ($68 in chips)
Seat 5: XcLXSUMHSpshK/7Lh0M4Vg ($10.55 in chips)
Seat 7: mSD1pginDsyHG5PDfqzphw ($19.45 in chips)
Seat 8: j3K/Jujr7PY4ZM2RZvlH6A ($45.15 in chips)
Seat 9: KA0tkubTlbhmo4ju+qgXPg ($43.10 in chips)
XcLXSUMHSpshK/7Lh0M4Vg: posts small blind $0.25
mSD1pginDsyHG5PDfqzphw: posts big blind $0.50
*** HOLE CARDS ***
j3K/Jujr7PY4ZM2RZvlH6A: raises $6.50 to $7
KA0tkubTlbhmo4ju+qgXPg is disconnected
KA0tkubTlbhmo4ju+qgXPg is connected
KA0tkubTlbhmo4ju+qgXPg: folds
bxLSulbgr8LmKNjOzw8URg: folds
HZkVla4kK2SI42CVrPZ/ig: folds
YXCE3WOZi8g2sIf3y/plVw: folds
e2+sK/yjnj94rXOKoxPP2A: folds
XcLXSUMHSpshK/7Lh0M4Vg: folds
mSD1pginDsyHG5PDfqzphw: folds
j3K/Jujr7PY4ZM2RZvlH6A collected $1.25 from pot
j3K/Jujr7PY4ZM2RZvlH6A: doesn't show hand
*** SUMMARY ***
Total pot $1.25 | Rake $0
Seat 1: bxLSulbgr8LmKNjOzw8URg folded before Flop (didn't bet)
Seat 2: HZkVla4kK2SI42CVrPZ/ig folded before Flop (didn't bet)
Seat 3: YXCE3WOZi8g2sIf3y/plVw folded before Flop (didn't bet)
Seat 4: e2+sK/yjnj94rXOKoxPP2A (button) folded before Flop (didn't bet)
Seat 5: XcLXSUMHSpshK/7Lh0M4Vg (small blind) folded before Flop
Seat 7: mSD1pginDsyHG5PDfqzphw (big blind) folded before Flop
Seat 8: j3K/Jujr7PY4ZM2RZvlH6A collected ($1.25)
Seat 9: KA0tkubTlbhmo4ju+qgXPg folded before Flop (didn't bet)



PokerStars Game #59941672326:  Hold'em No Limit ($0.25/$0.50) - 2009/07/01 1:42:32 ET
Table 'ofnd8S4IdIPph1Cbn+x7hAbR5MkGhKEbz+X2bpfpu11Qmax Seat #8 is the button
Seat 1: 6CKPjbH+MB5p5oH9GwiXGA ($50 in chips)
Seat 2: 1xBtrSVBbgFH/viUWKqQeg ($38.05 in chips)
Seat 3: UVJbBPbDwNMEZadZB9WVmg ($9.75 in chips)
Seat 4: mZNMJI1mY40XTC0U7GZakA ($62.20 in chips)
Seat 5: 2YaCb/8u1SesrR+963XiZA ($13.90 in chips)
Seat 6: 0Bw1Gb5YC/Xvb0SqVawKUw ($9.55 in chips)
Seat 7: kJ06FP2Jc7cSdmywwvYOXw ($44.85 in chips)
Seat 8: R354x4oZnQcGCDV6GhjnpQ ($79.35 in chips)
Seat 9: 75K2MXwN65Sjfp1yHd50Hg ($9.50 in chips)
75K2MXwN65Sjfp1yHd50Hg: posts small blind $0.25
6CKPjbH+MB5p5oH9GwiXGA: posts big blind $0.50
*** HOLE CARDS ***
1xBtrSVBbgFH/viUWKqQeg: folds
UVJbBPbDwNMEZadZB9WVmg: folds
kJ06FP2Jc7cSdmywwvYOXw said, "im comin' for ya magic!"
mZNMJI1mY40XTC0U7GZakA: folds
2YaCb/8u1SesrR+963XiZA: folds
0Bw1Gb5YC/Xvb0SqVawKUw: folds
kJ06FP2Jc7cSdmywwvYOXw: raises $1.50 to $2
R354x4oZnQcGCDV6GhjnpQ: folds
75K2MXwN65Sjfp1yHd50Hg: folds
6CKPjbH+MB5p5oH9GwiXGA: folds
kJ06FP2Jc7cSdmywwvYOXw collected $1.25 from pot
kJ06FP2Jc7cSdmywwvYOXw said, "comin' for ya man"
*** SUMMARY ***
Total pot $1.25 | Rake $0
Seat 1: 6CKPjbH+MB5p5oH9GwiXGA (big blind) folded before Flop
Seat 2: 1xBtrSVBbgFH/viUWKqQeg folded before Flop (didn't bet)
Seat 3: UVJbBPbDwNMEZadZB9WVmg folded before Flop (didn't bet)
Seat 4: mZNMJI1mY40XTC0U7GZakA folded before Flop (didn't bet)
Seat 5: 2YaCb/8u1SesrR+963XiZA folded before Flop (didn't bet)
Seat 6: 0Bw1Gb5YC/Xvb0SqVawKUw folded before Flop (didn't bet)
Seat 7: kJ06FP2Jc7cSdmywwvYOXw collected ($1.25)
Seat 8: R354x4oZnQcGCDV6GhjnpQ (button) folded before Flop (didn't bet)
Seat 9: 75K2MXwN65Sjfp1yHd50Hg (small blind) folded before Flop



PokerStars Game #59941673222:  Hold'em No Limit ($0.25/$0.50) - 2009/07/01 1:42:34 ET
Table 'NCiXr0d5CEKBQr/cZgLhbA' 9-max Seat #2 is the button
Seat 1: pFtzb1sR4b0d1aw6aIRgDg ($86.50 in chips)
Seat 2: AjV5McH1KMMclY26QdLM5w ($40.80 in chips)
Seat 3: xZCXQSXlrZkp3pZizzVXCw ($95.15 in chips)
Seat 4: 5k9fvXD9suIgCxU4HLQjTw ($50.45 in chips)
Seat 5: Ja2jdidjip2UeJnRzmzAAQ ($43.20 in chips)
Seat 6: t1qL+wRXOwTLB4TBbcw2QA ($53.10 in chips)
Seat 7: dXhO5i7KOoVcsGqbklD+jw ($44 in chips)
Seat 8: XA3GzEhYmqB0KknKKPDZGQ ($28.80 in chips)
Seat 9: 4WLZvqBn5qv5tds5kt5A1Q ($51.20 in chips)
xZCXQSXlrZkp3pZizzVXCw: posts small blind $0.25
5k9fvXD9suIgCxU4HLQjTw: posts big blind $0.50
*** HOLE CARDS ***
Ja2jdidjip2UeJnRzmzAAQ: folds
t1qL+wRXOwTLB4TBbcw2QA: folds
dXhO5i7KOoVcsGqbklD+jw: folds
XA3GzEhYmqB0KknKKPDZGQ: folds
4WLZvqBn5qv5tds5kt5A1Q: raises $1.50 to $2
pFtzb1sR4b0d1aw6aIRgDg: folds
AjV5McH1KMMclY26QdLM5w: folds
xZCXQSXlrZkp3pZizzVXCw: folds
5k9fvXD9suIgCxU4HLQjTw: folds
4WLZvqBn5qv5tds5kt5A1Q collected $1.25 from pot
*** SUMMARY ***
Total pot $1.25 | Rake $0
Seat 1: pFtzb1sR4b0d1aw6aIRgDg folded before Flop (didn't bet)
Seat 2: AjV5McH1KMMclY26QdLM5w (button) folded before Flop (didn't bet)
Seat 3: xZCXQSXlrZkp3pZizzVXCw (small blind) folded before Flop
Seat 4: 5k9fvXD9suIgCxU4HLQjTw (big blind) folded before Flop
Seat 5: Ja2jdidjip2UeJnRzmzAAQ folded before Flop (didn't bet)
Seat 6: t1qL+wRXOwTLB4TBbcw2QA folded before Flop (didn't bet)
Seat 7: dXhO5i7KOoVcsGqbklD+jw folded before Flop (didn't bet)
Seat 8: XA3GzEhYmqB0KknKKPDZGQ folded before Flop (didn't bet)
Seat 9: 4WLZvqBn5qv5tds5kt5A1Q collected ($1.25)



PokerStars Game #59941674428:  Hold'em No Limit ($0.25/$0.50) - 2009/07/01 1:42:36 ET
Table '2lPOwetm4cfkZPbTmGPH/w' 2-max Seat #1 is the button
Seat 1: vUGdApqS8J/GJE2gaVWl1w ($13.80 in chips)
Seat 2: XFa6sBGjP2gxoIvxR3fZIg ($22.30 in chips)
vUGdApqS8J/GJE2gaVWl1w: posts small blind $0.25
XFa6sBGjP2gxoIvxR3fZIg: posts big blind $0.50
*** HOLE CARDS ***
vUGdApqS8J/GJE2gaVWl1w: calls $0.25
XFa6sBGjP2gxoIvxR3fZIg: raises $1.50 to $2
vUGdApqS8J/GJE2gaVWl1w: folds
XFa6sBGjP2gxoIvxR3fZIg collected $1 from pot
XFa6sBGjP2gxoIvxR3fZIg: doesn't show hand
*** SUMMARY ***
Total pot $1 | Rake $0
Seat 1: vUGdApqS8J/GJE2gaVWl1w (button) (small blind) folded before Flop
Seat 2: XFa6sBGjP2gxoIvxR3fZIg (big blind) collected ($1)



PokerStars Game #59941674384:  Hold'em No Limit ($0.25/$0.50) - 2009/07/01 1:42:36 ET
Table 'cofQFHU7jbJoFecLVBof/w' 6-max Seat #2 is the button
Seat 1: URYNc7fPA23K2UfadQbnCA ($50.20 in chips)
Seat 2: f89uTQr3ieGlusj2IAYAEg ($50 in chips)
Seat 3: v4ctePcLlQw0r8E0qJtjYw ($50.95 in chips)
Seat 4: 9XrTM0DuVxx1pjFAdSbD8A ($57.80 in chips)
Seat 5: QvwRlrpVqerRRF8eJm6dDw ($48.40 in chips)
Seat 6: 7+uQ0OOgCTbR4ltkSwyC0g ($158.30 in chips)
v4ctePcLlQw0r8E0qJtjYw: posts small blind $0.25
9XrTM0DuVxx1pjFAdSbD8A: posts big blind $0.50
*** HOLE CARDS ***
QvwRlrpVqerRRF8eJm6dDw: folds
7+uQ0OOgCTbR4ltkSwyC0g: folds
URYNc7fPA23K2UfadQbnCA: folds
f89uTQr3ieGlusj2IAYAEg: raises $1 to $1.50
v4ctePcLlQw0r8E0qJtjYw: folds
9XrTM0DuVxx1pjFAdSbD8A: calls $1
*** FLOP *** [Tc 6h 2d]
9XrTM0DuVxx1pjFAdSbD8A: checks
f89uTQr3ieGlusj2IAYAEg: checks
*** TURN *** [Tc 6h 2d] [Ac]
9XrTM0DuVxx1pjFAdSbD8A: checks
f89uTQr3ieGlusj2IAYAEg: checks
*** RIVER *** [Tc 6h 2d Ac] [3c]
9XrTM0DuVxx1pjFAdSbD8A: checks
f89uTQr3ieGlusj2IAYAEg: checks
*** SHOW DOWN ***
9XrTM0DuVxx1pjFAdSbD8A: shows [Jc Qs] (high card Ace)
f89uTQr3ieGlusj2IAYAEg: mucks hand
9XrTM0DuVxx1pjFAdSbD8A collected $3.10 from pot
*** SUMMARY ***
Total pot $3.25 | Rake $0.15
Board [Tc 6h 2d Ac 3c]
Seat 1: URYNc7fPA23K2UfadQbnCA folded before Flop (didn't bet)
Seat 2: f89uTQr3ieGlusj2IAYAEg (button) mucked
Seat 3: v4ctePcLlQw0r8E0qJtjYw (small blind) folded before Flop
Seat 4: 9XrTM0DuVxx1pjFAdSbD8A (big blind) showed [Jc Qs] and won ($3.10) with high card Ace
Seat 5: QvwRlrpVqerRRF8eJm6dDw folded before Flop (didn't bet)
Seat 6: 7+uQ0OOgCTbR4ltkSwyC0g folded before Flop (didn't bet)



PokerStars Game #59941676100:  Hold'em No Limit ($0.25/$0.50) - 2009/07/01 1:42:39 ET
Table 'EiNh8p/wGJ1FP575iMFnqg' 9-max Seat #2 is the button
Seat 1: YFFlOZgyy1Mh4iBmuNRbmQ ($18.80 in chips)
Seat 2: GRV8J6o4lVSBDEyjt6BwMg ($27.50 in chips)
Seat 3: ymLPoEIl7UL3TvZYmnadxQ ($38.25 in chips)
Seat 4: cMzaiXAM/ZAdNaEUu+LqhA ($54.20 in chips)
Seat 5: M+7+BTmX5vZatHVuoRB1nA ($75.15 in chips)
Seat 6: bCRukyMhXa3jkgAkKFa4VQ ($10.30 in chips)
Seat 7: 997ViqAtWn1FPjJqcffwcA ($50 in chips)
Seat 8: mSD1pginDsyHG5PDfqzphw ($21 in chips)
Seat 9: GuPkZObrz5Zkkn8FsEdF9w ($33.85 in chips)
ymLPoEIl7UL3TvZYmnadxQ: posts small blind $0.25
cMzaiXAM/ZAdNaEUu+LqhA: posts big blind $0.50
*** HOLE CARDS ***
M+7+BTmX5vZatHVuoRB1nA: folds
bCRukyMhXa3jkgAkKFa4VQ: folds
997ViqAtWn1FPjJqcffwcA: folds
mSD1pginDsyHG5PDfqzphw: folds
GuPkZObrz5Zkkn8FsEdF9w: folds
YFFlOZgyy1Mh4iBmuNRbmQ: folds
GRV8J6o4lVSBDEyjt6BwMg: folds
ymLPoEIl7UL3TvZYmnadxQ: calls $0.25
cMzaiXAM/ZAdNaEUu+LqhA: checks
*** FLOP *** [8s As Qc]
ymLPoEIl7UL3TvZYmnadxQ: bets $0.50
cMzaiXAM/ZAdNaEUu+LqhA: calls $0.50
*** TURN *** [8s As Qc] [Th]
ymLPoEIl7UL3TvZYmnadxQ: checks
cMzaiXAM/ZAdNaEUu+LqhA: bets $1.50
ymLPoEIl7UL3TvZYmnadxQ: folds
cMzaiXAM/ZAdNaEUu+LqhA collected $1.95 from pot
cMzaiXAM/ZAdNaEUu+LqhA: doesn't show hand
*** SUMMARY ***
Total pot $2 | Rake $0.05
Board [8s As Qc Th]
Seat 1: YFFlOZgyy1Mh4iBmuNRbmQ folded before Flop (didn't bet)
Seat 2: GRV8J6o4lVSBDEyjt6BwMg (button) folded before Flop (didn't bet)
Seat 3: ymLPoEIl7UL3TvZYmnadxQ (small blind) folded on the Turn
Seat 4: cMzaiXAM/ZAdNaEUu+LqhA (big blind) collected ($1.95)
Seat 5: M+7+BTmX5vZatHVuoRB1nA folded before Flop (didn't bet)
Seat 6: bCRukyMhXa3jkgAkKFa4VQ folded before Flop (didn't bet)
Seat 7: 997ViqAtWn1FPjJqcffwcA folded before Flop (didn't bet)
Seat 8: mSD1pginDsyHG5PDfqzphw folded before Flop (didn't bet)
Seat 9: GuPkZObrz5Zkkn8FsEdF9w folded before Flop (didn't bet)



PokerStars Game #59941677408:  Hold'em No Limit ($0.25/$0.50) - 2009/07/01 1:42:42 ET
Table 'b14oxfBMAjhXizfPVeTHng' 2-max Seat #2 is the button
Seat 1: NKw4WYm5uUoeEVf4i0fBvA ($10.80 in chips)
Seat 2: FeErMt4Gvt/3PH2oB/pn4A ($19.50 in chips)
FeErMt4Gvt/3PH2oB/pn4A: posts small blind $0.25
NKw4WYm5uUoeEVf4i0fBvA: posts big blind $0.50
*** HOLE CARDS ***
FeErMt4Gvt/3PH2oB/pn4A: calls $0.25
NKw4WYm5uUoeEVf4i0fBvA said, "no"
FeErMt4Gvt/3PH2oB/pn4A said, "oh haha"
FeErMt4Gvt/3PH2oB/pn4A said, "well"
FeErMt4Gvt/3PH2oB/pn4A said, "go to pokerstars.com"
NKw4WYm5uUoeEVf4i0fBvA said, "how do u get 1st star?"
FeErMt4Gvt/3PH2oB/pn4A said, "and u can find it there"
NKw4WYm5uUoeEVf4i0fBvA: raises $0.50 to $1
FeErMt4Gvt/3PH2oB/pn4A said, "u already got one"
FeErMt4Gvt/3PH2oB/pn4A: calls $0.50
*** FLOP *** [4c Js Th]
NKw4WYm5uUoeEVf4i0fBvA: bets $0.50
FeErMt4Gvt/3PH2oB/pn4A: raises $1 to $1.50
NKw4WYm5uUoeEVf4i0fBvA: calls $1
*** TURN *** [4c Js Th] [4h]
NKw4WYm5uUoeEVf4i0fBvA said, "i cant c it"
FeErMt4Gvt/3PH2oB/pn4A said, "but u probably havent applied that u can see it"
NKw4WYm5uUoeEVf4i0fBvA: checks
FeErMt4Gvt/3PH2oB/pn4A said, "go in the main screen of pokerstars"
FeErMt4Gvt/3PH2oB/pn4A said, "to the left top of the window"
FeErMt4Gvt/3PH2oB/pn4A: bets $1
NKw4WYm5uUoeEVf4i0fBvA: calls $1
*** RIVER *** [4c Js Th 4h] [Jc]
NKw4WYm5uUoeEVf4i0fBvA: checks
FeErMt4Gvt/3PH2oB/pn4A said, "just under pokerstars"
FeErMt4Gvt/3PH2oB/pn4A said, "and the amount of players and tables"
FeErMt4Gvt/3PH2oB/pn4A said, "click on that"
FeErMt4Gvt/3PH2oB/pn4A said, "and it will be explained to you there"
FeErMt4Gvt/3PH2oB/pn4A: bets $1
FeErMt4Gvt/3PH2oB/pn4A said, "ok?"
NKw4WYm5uUoeEVf4i0fBvA: calls $1
*** SHOW DOWN ***
FeErMt4Gvt/3PH2oB/pn4A: shows [Ts 9c] (two pair, Jacks and Tens)
NKw4WYm5uUoeEVf4i0fBvA: mucks hand
FeErMt4Gvt/3PH2oB/pn4A collected $8.60 from pot
*** SUMMARY ***
Total pot $9 | Rake $0.40
Board [4c Js Th 4h Jc]
Seat 1: NKw4WYm5uUoeEVf4i0fBvA (big blind) mucked
Seat 2: FeErMt4Gvt/3PH2oB/pn4A (button) (small blind) showed [Ts 9c] and won ($8.60) with two pair, Jacks and Tens



PokerStars Game #59941679756:  Hold'em No Limit ($0.25/$0.50) - 2009/07/01 1:42:46 ET
Table '5qf8oPyYje71HBKD0FwPgQ' 9-max Seat #2 is the button
Seat 1: gsyXT42WLEcOS4DdEk2wlw ($29.25 in chips)
Seat 2: M+7+BTmX5vZatHVuoRB1nA ($68.20 in chips)
Seat 3: vacmVLJJECYI6HjAynFcpg ($49.50 in chips)
Seat 4: YXCE3WOZi8g2sIf3y/plVw ($57.75 in chips)
Seat 5: uo2Sgpknd7NdeVbeSCG02A ($2.45 in chips)
Seat 6: go0Ad6tqqJ4tR9/bqVlO0g ($24.20 in chips)
Seat 7: 1q5EPoiflJRl8pqfnVLjMw ($53.50 in chips)
Seat 8: sakr/FIfFtIZwDPmAj5Pzg ($56.85 in chips)
Seat 9: jWDRpL0TJljg+mBCE9ZMqA ($21.15 in chips)
vacmVLJJECYI6HjAynFcpg: posts small blind $0.25
YXCE3WOZi8g2sIf3y/plVw: posts big blind $0.50
*** HOLE CARDS ***
uo2Sgpknd7NdeVbeSCG02A: calls $0.50
go0Ad6tqqJ4tR9/bqVlO0g: calls $0.50
1q5EPoiflJRl8pqfnVLjMw: folds
sakr/FIfFtIZwDPmAj5Pzg: folds
jWDRpL0TJljg+mBCE9ZMqA: folds
gsyXT42WLEcOS4DdEk2wlw: folds
M+7+BTmX5vZatHVuoRB1nA: folds
vacmVLJJECYI6HjAynFcpg: folds
YXCE3WOZi8g2sIf3y/plVw: checks
*** FLOP *** [Tc 2c Td]
YXCE3WOZi8g2sIf3y/plVw: checks
uo2Sgpknd7NdeVbeSCG02A: checks
go0Ad6tqqJ4tR9/bqVlO0g: bets $1
YXCE3WOZi8g2sIf3y/plVw: folds
uo2Sgpknd7NdeVbeSCG02A: folds
go0Ad6tqqJ4tR9/bqVlO0g collected $1.70 from pot
*** SUMMARY ***
Total pot $1.75 | Rake $0.05
Board [Tc 2c Td]
Seat 1: gsyXT42WLEcOS4DdEk2wlw folded before Flop (didn't bet)
Seat 2: M+7+BTmX5vZatHVuoRB1nA (button) folded before Flop (didn't bet)
Seat 3: vacmVLJJECYI6HjAynFcpg (small blind) folded before Flop
Seat 4: YXCE3WOZi8g2sIf3y/plVw (big blind) folded on the Flop
Seat 5: uo2Sgpknd7NdeVbeSCG02A folded on the Flop
Seat 6: go0Ad6tqqJ4tR9/bqVlO0g collected ($1.70)
Seat 7: 1q5EPoiflJRl8pqfnVLjMw folded before Flop (didn't bet)
Seat 8: sakr/FIfFtIZwDPmAj5Pzg folded before Flop (didn't bet)
Seat 9: jWDRpL0TJljg+mBCE9ZMqA folded before Flop (didn't bet)



PokerStars Game #59941680374:  Hold'em No Limit ($0.25/$0.50) - 2009/07/01 1:42:47 ET
Table '2lPOwetm4cfkZPbTmGPH/w' 2-max Seat #2 is the button
Seat 1: vUGdApqS8J/GJE2gaVWl1w ($13.30 in chips)
Seat 2: XFa6sBGjP2gxoIvxR3fZIg ($22.80 in chips)
XFa6sBGjP2gxoIvxR3fZIg: posts small blind $0.25
vUGdApqS8J/GJE2gaVWl1w: posts big blind $0.50
*** HOLE CARDS ***
XFa6sBGjP2gxoIvxR3fZIg: raises $1 to $1.50
vUGdApqS8J/GJE2gaVWl1w: calls $1
*** FLOP *** [5c 9d 7h]
vUGdApqS8J/GJE2gaVWl1w: checks
XFa6sBGjP2gxoIvxR3fZIg: checks
*** TURN *** [5c 9d 7h] [5h]
vUGdApqS8J/GJE2gaVWl1w: bets $1
XFa6sBGjP2gxoIvxR3fZIg: raises $3.50 to $4.50
vUGdApqS8J/GJE2gaVWl1w: folds
XFa6sBGjP2gxoIvxR3fZIg collected $4.80 from pot
XFa6sBGjP2gxoIvxR3fZIg: doesn't show hand
*** SUMMARY ***
Total pot $5 | Rake $0.20
Board [5c 9d 7h 5h]
Seat 1: vUGdApqS8J/GJE2gaVWl1w (big blind) folded on the Turn
Seat 2: XFa6sBGjP2gxoIvxR3fZIg (button) (small blind) collected ($4.80)



PokerStars Game #59941680974:  Hold'em No Limit ($0.25/$0.50) - 2009/07/01 1:42:48 ET
Table 'ErOuyGLI5PT3G5MnpHgC/g' 9-max Seat #8 is the button
Seat 1: eBrej2jnlUCs/JgxFCRn2g ($53.50 in chips)
Seat 2: pciZn00ZDk4BVBMTTMcNVQ ($21.50 in chips)
Seat 3: xZCXQSXlrZkp3pZizzVXCw ($49.25 in chips)
Seat 4: YRqrX/u38J7aLNNnBzQsjQ ($19.05 in chips)
Seat 5: JwvquocWfhTVApN5t47LgA ($48.30 in chips)
Seat 7: 90Wb75h3W1BRpbqVnuk8gw ($55.45 in chips)
Seat 8: g4k0NXISyLCqaSWZDBjfEg ($50 in chips)
Seat 9: J0W5D97jl5VLky+IoPvDeA ($64 in chips)
J0W5D97jl5VLky+IoPvDeA: posts small blind $0.25
eBrej2jnlUCs/JgxFCRn2g: posts big blind $0.50
*** HOLE CARDS ***
pciZn00ZDk4BVBMTTMcNVQ: folds
xZCXQSXlrZkp3pZizzVXCw: raises $1 to $1.50
YRqrX/u38J7aLNNnBzQsjQ: folds
JwvquocWfhTVApN5t47LgA: folds
90Wb75h3W1BRpbqVnuk8gw: folds
g4k0NXISyLCqaSWZDBjfEg: folds
J0W5D97jl5VLky+IoPvDeA: folds
eBrej2jnlUCs/JgxFCRn2g: calls $1
*** FLOP *** [3s Kh 9c]
eBrej2jnlUCs/JgxFCRn2g: checks
xZCXQSXlrZkp3pZizzVXCw: bets $2
eBrej2jnlUCs/JgxFCRn2g: folds
xZCXQSXlrZkp3pZizzVXCw collected $3.10 from pot
*** SUMMARY ***
Total pot $3.25 | Rake $0.15
Board [3s Kh 9c]
Seat 1: eBrej2jnlUCs/JgxFCRn2g (big blind) folded on the Flop
Seat 2: pciZn00ZDk4BVBMTTMcNVQ folded before Flop (didn't bet)
Seat 3: xZCXQSXlrZkp3pZizzVXCw collected ($3.10)
Seat 4: YRqrX/u38J7aLNNnBzQsjQ folded before Flop (didn't bet)
Seat 5: JwvquocWfhTVApN5t47LgA folded before Flop (didn't bet)
Seat 7: 90Wb75h3W1BRpbqVnuk8gw folded before Flop (didn't bet)
Seat 8: g4k0NXISyLCqaSWZDBjfEg (button) folded before Flop (didn't bet)
Seat 9: J0W5D97jl5VLky+IoPvDeA (small blind) folded before Flop



PokerStars Game #59941682408:  Hold'em No Limit ($0.25/$0.50) - 2009/07/01 1:42:51 ET
Table 'BCN5su+SsXiy1zRMJi0SJw' 6-max Seat #4 is the button
Seat 1: GxXV09ciXaOxyY2H5aMIIw ($34.20 in chips)
Seat 2: ehFNAevCQri3trWxV6FJdA ($84.55 in chips)
Seat 3: kwgv5lNhiFrfONXCshzxlA ($73 in chips)
Seat 4: bbsK8j+tpuVRhBqDzHxf7w ($49.10 in chips)
Seat 5: kxPhs4ePFqMy52CInAJ2aw ($49.25 in chips)
kxPhs4ePFqMy52CInAJ2aw: posts small blind $0.25
b2symlOdL7+0c9Pj4N/KlA: is sitting out
GxXV09ciXaOxyY2H5aMIIw: posts big blind $0.50
*** HOLE CARDS ***
b2symlOdL7+0c9Pj4N/KlA leaves the table
ehFNAevCQri3trWxV6FJdA: folds
kwgv5lNhiFrfONXCshzxlA: calls $0.50
bbsK8j+tpuVRhBqDzHxf7w: folds
kxPhs4ePFqMy52CInAJ2aw: folds
vhWS+cwAJNd3JzqVzIjBZA joins the table at seat #6
GxXV09ciXaOxyY2H5aMIIw: checks
*** FLOP *** [Qs 9s 5s]
GxXV09ciXaOxyY2H5aMIIw: checks
kwgv5lNhiFrfONXCshzxlA: checks
*** TURN *** [Qs 9s 5s] [3c]
GxXV09ciXaOxyY2H5aMIIw: checks
kwgv5lNhiFrfONXCshzxlA: checks
*** RIVER *** [Qs 9s 5s 3c] [3d]
GxXV09ciXaOxyY2H5aMIIw: checks
kwgv5lNhiFrfONXCshzxlA: checks
*** SHOW DOWN ***
GxXV09ciXaOxyY2H5aMIIw: shows [5h 7h] (two pair, Fives and Threes)
kwgv5lNhiFrfONXCshzxlA: mucks hand
GxXV09ciXaOxyY2H5aMIIw collected $1.20 from pot
*** SUMMARY ***
Total pot $1.25 | Rake $0.05
Board [Qs 9s 5s 3c 3d]
Seat 1: GxXV09ciXaOxyY2H5aMIIw (big blind) showed [5h 7h] and won ($1.20) with two pair, Fives and Threes
Seat 2: ehFNAevCQri3trWxV6FJdA folded before Flop (didn't bet)
Seat 3: kwgv5lNhiFrfONXCshzxlA mucked
Seat 4: bbsK8j+tpuVRhBqDzHxf7w (button) folded before Flop (didn't bet)
Seat 5: kxPhs4ePFqMy52CInAJ2aw (small blind) folded before Flop



PokerStars Game #59941682422:  Hold'em No Limit ($0.25/$0.50) - 2009/07/01 1:42:51 ET
Table 'GfL/No5u5PoEnU39lP5pQg' 6-max Seat #3 is the button
Seat 2: uVwggSetzp7d+eVgowO3vg ($53.50 in chips)
Seat 3: 4pp9WxhGdbVbxCc9tlu0lw ($25.30 in chips)
Seat 4: ifQmgsYNFiAg/XvBOMBSfQ ($49.50 in chips)
Seat 5: M1KyQQvVPVuxqTAB8sR/zQ ($51.60 in chips)
ifQmgsYNFiAg/XvBOMBSfQ: posts small blind $0.25
M1KyQQvVPVuxqTAB8sR/zQ: posts big blind $0.50
kxPhs4ePFqMy52CInAJ2aw: sits out
6qJZP2EKIgnEXJ3tMSBuew: sits out
*** HOLE CARDS ***
uVwggSetzp7d+eVgowO3vg: folds
4pp9WxhGdbVbxCc9tlu0lw: raises $0.50 to $1
ifQmgsYNFiAg/XvBOMBSfQ: folds
M1KyQQvVPVuxqTAB8sR/zQ: folds
4pp9WxhGdbVbxCc9tlu0lw collected $1.25 from pot
*** SUMMARY ***
Total pot $1.25 | Rake $0
Seat 2: uVwggSetzp7d+eVgowO3vg folded before Flop (didn't bet)
Seat 3: 4pp9WxhGdbVbxCc9tlu0lw (button) collected ($1.25)
Seat 4: ifQmgsYNFiAg/XvBOMBSfQ (small blind) folded before Flop
Seat 5: M1KyQQvVPVuxqTAB8sR/zQ (big blind) folded before Flop



PokerStars Game #59941684208:  Hold'em No Limit ($0.25/$0.50) - 2009/07/01 1:42:54 ET
Table 'tyR5AZNKV8Aadbrnrnlg7g' 6-max Seat #2 is the button
Seat 1: BgOXYI0yYSN1ULC4FqsNkg ($81.20 in chips)
Seat 2: vhWS+cwAJNd3JzqVzIjBZA ($50.20 in chips)
Seat 3: JFLrYNyQmwPhRQAtoSAuyA ($60.35 in chips)
Seat 4: 4QfsCWthT/vSLirorNXqtg ($76.95 in chips)
Seat 5: GUnvMULl2qFOO1yenu1UBw ($76.35 in chips)
JFLrYNyQmwPhRQAtoSAuyA: posts small blind $0.25
4QfsCWthT/vSLirorNXqtg: posts big blind $0.50
*** HOLE CARDS ***
GUnvMULl2qFOO1yenu1UBw: folds
BgOXYI0yYSN1ULC4FqsNkg: folds
vhWS+cwAJNd3JzqVzIjBZA: folds
JFLrYNyQmwPhRQAtoSAuyA: folds
4QfsCWthT/vSLirorNXqtg collected $0.50 from pot
4QfsCWthT/vSLirorNXqtg: doesn't show hand
*** SUMMARY ***
Total pot $0.50 | Rake $0
Seat 1: BgOXYI0yYSN1ULC4FqsNkg folded before Flop (didn't bet)
Seat 2: vhWS+cwAJNd3JzqVzIjBZA (button) folded before Flop (didn't bet)
Seat 3: JFLrYNyQmwPhRQAtoSAuyA (small blind) folded before Flop
Seat 4: 4QfsCWthT/vSLirorNXqtg (big blind) collected ($0.50)
Seat 5: GUnvMULl2qFOO1yenu1UBw folded before Flop (didn't bet)



PokerStars Game #59941685574:  Hold'em No Limit ($0.25/$0.50) - 2009/07/01 1:42:57 ET
Table 'iq+aXfWVQRdV0u8SRTYUEg' 9-max Seat #8 is the button
Seat 1: 3yl8Q6QaLfGtyhN4/pEFgQ ($71.05 in chips)
Seat 2: J9N0lxHFd/Js2S0xZLbsIQ ($32.45 in chips)
Seat 3: bMkgDRXl6YaqJ4b/5qml2Q ($9.50 in chips)
Seat 4: vHYT5s323LpajBj+2c9zbQ ($24.85 in chips)
Seat 5: 997ViqAtWn1FPjJqcffwcA ($56.65 in chips)
Seat 6: bTJ0WgoxefTPxIoycS7uoA ($25.70 in chips)
Seat 8: /DtIHuxEH+3tzKefmSV+Mw ($43.30 in chips)
Seat 9: drKg+7JekfxR/0poTEK9Tg ($50 in chips)
drKg+7JekfxR/0poTEK9Tg: posts small blind $0.25
3yl8Q6QaLfGtyhN4/pEFgQ: posts big blind $0.50
*** HOLE CARDS ***
J9N0lxHFd/Js2S0xZLbsIQ: folds
J9N0lxHFd/Js2S0xZLbsIQ is sitting out
bMkgDRXl6YaqJ4b/5qml2Q: folds
vHYT5s323LpajBj+2c9zbQ: folds
997ViqAtWn1FPjJqcffwcA: folds
bTJ0WgoxefTPxIoycS7uoA: folds
/DtIHuxEH+3tzKefmSV+Mw: folds
drKg+7JekfxR/0poTEK9Tg: folds
3yl8Q6QaLfGtyhN4/pEFgQ collected $0.50 from pot
*** SUMMARY ***
Total pot $0.50 | Rake $0
Seat 1: 3yl8Q6QaLfGtyhN4/pEFgQ (big blind) collected ($0.50)
Seat 2: J9N0lxHFd/Js2S0xZLbsIQ folded before Flop (didn't bet)
Seat 3: bMkgDRXl6YaqJ4b/5qml2Q folded before Flop (didn't bet)
Seat 4: vHYT5s323LpajBj+2c9zbQ folded before Flop (didn't bet)
Seat 5: 997ViqAtWn1FPjJqcffwcA folded before Flop (didn't bet)
Seat 6: bTJ0WgoxefTPxIoycS7uoA folded before Flop (didn't bet)
Seat 8: /DtIHuxEH+3tzKefmSV+Mw (button) folded before Flop (didn't bet)
Seat 9: drKg+7JekfxR/0poTEK9Tg (small blind) folded before Flop



PokerStars Game #59941686628:  Hold'em No Limit ($0.25/$0.50) - 2009/07/01 1:42:59 ET
Table '+z1aekfHkpp09pc8F9aViw' 6-max Seat #6 is the button
Seat 1: L0aIPg7qefDQjdJo3HCVEA ($10.25 in chips)
Seat 3: URYNc7fPA23K2UfadQbnCA ($63.90 in chips)
Seat 4: RowCSpSURHTOL/dcjg/Iug ($84.95 in chips)
Seat 5: 2igtJLmvIZ+HqX4XPgMPZA ($51.50 in chips)
Seat 6: GUnvMULl2qFOO1yenu1UBw ($50.50 in chips)
L0aIPg7qefDQjdJo3HCVEA: posts small blind $0.25
URYNc7fPA23K2UfadQbnCA: posts big blind $0.50
*** HOLE CARDS ***
RowCSpSURHTOL/dcjg/Iug: folds
2igtJLmvIZ+HqX4XPgMPZA: folds
GUnvMULl2qFOO1yenu1UBw: folds
L0aIPg7qefDQjdJo3HCVEA: calls $0.25
URYNc7fPA23K2UfadQbnCA: checks
*** FLOP *** [9h Jd Jc]
L0aIPg7qefDQjdJo3HCVEA: checks
URYNc7fPA23K2UfadQbnCA: bets $0.75
L0aIPg7qefDQjdJo3HCVEA: calls $0.75
*** TURN *** [9h Jd Jc] [9c]
L0aIPg7qefDQjdJo3HCVEA: checks
URYNc7fPA23K2UfadQbnCA: checks
*** RIVER *** [9h Jd Jc 9c] [8s]
itojorgeCR joins the table at seat #2
L0aIPg7qefDQjdJo3HCVEA: checks
URYNc7fPA23K2UfadQbnCA: checks
*** SHOW DOWN ***
L0aIPg7qefDQjdJo3HCVEA: shows [2h 2s] (two pair, Jacks and Nines)
URYNc7fPA23K2UfadQbnCA: shows [6s 5s] (two pair, Jacks and Nines)
L0aIPg7qefDQjdJo3HCVEA collected $1.20 from pot
URYNc7fPA23K2UfadQbnCA collected $1.20 from pot
*** SUMMARY ***
Total pot $2.50 | Rake $0.10
Board [9h Jd Jc 9c 8s]
Seat 1: L0aIPg7qefDQjdJo3HCVEA (small blind) showed [2h 2s] and won ($1.20) with two pair, Jacks and Nines
Seat 3: URYNc7fPA23K2UfadQbnCA (big blind) showed [6s 5s] and won ($1.20) with two pair, Jacks and Nines
Seat 4: RowCSpSURHTOL/dcjg/Iug folded before Flop (didn't bet)
Seat 5: 2igtJLmvIZ+HqX4XPgMPZA folded before Flop (didn't bet)
Seat 6: GUnvMULl2qFOO1yenu1UBw (button) folded before Flop (didn't bet)



PokerStars Game #59941688526:  Hold'em No Limit ($0.25/$0.50) - 2009/07/01 1:43:02 ET
Table '5EmHi+fnatGQQShcNmzOZQ' 6-max Seat #1 is the button
Seat 1: avNOJXWxD1+SygFmWsd+qw ($65.85 in chips)
Seat 3: QmH/ZFyxZfvliy57YM9yxw ($76.30 in chips)
Seat 4: 1b+2BbjMN8qhR1WPqdE9VQ ($50 in chips)
Seat 5: 6yWjZXHP6iAyMEDF6pJlng ($66.85 in chips)
vhWS+cwAJNd3JzqVzIjBZA will be allowed to play after the button
QmH/ZFyxZfvliy57YM9yxw: posts small blind $0.25
1b+2BbjMN8qhR1WPqdE9VQ: posts big blind $0.50
I6jT30IIGKfk3BWwujd6WQ: sits out
*** HOLE CARDS ***
6yWjZXHP6iAyMEDF6pJlng: folds
avNOJXWxD1+SygFmWsd+qw: folds
QmH/ZFyxZfvliy57YM9yxw: calls $0.25
1b+2BbjMN8qhR1WPqdE9VQ: checks
*** FLOP *** [Kc 5d 5s]
QmH/ZFyxZfvliy57YM9yxw: checks
1b+2BbjMN8qhR1WPqdE9VQ: bets $0.70
QmH/ZFyxZfvliy57YM9yxw: folds
1b+2BbjMN8qhR1WPqdE9VQ collected $0.95 from pot
1b+2BbjMN8qhR1WPqdE9VQ: doesn't show hand
*** SUMMARY ***
Total pot $1 | Rake $0.05
Board [Kc 5d 5s]
Seat 1: avNOJXWxD1+SygFmWsd+qw (button) folded before Flop (didn't bet)
Seat 3: QmH/ZFyxZfvliy57YM9yxw (small blind) folded on the Flop
Seat 4: 1b+2BbjMN8qhR1WPqdE9VQ (big blind) collected ($0.95)
Seat 5: 6yWjZXHP6iAyMEDF6pJlng folded before Flop (didn't bet)



PokerStars Game #59941688748:  Hold'em No Limit ($0.25/$0.50) - 2009/07/01 1:43:03 ET
Table 'otvGDROEDdqsabxskT79qg' 9-max Seat #3 is the button
Seat 1: M+D23GG26WXQ/2gyjREVOQ ($49.25 in chips)
Seat 2: 8pfDpjfHmTUlkgzpRPwQYQ ($27 in chips)
Seat 3: +k7T5ocke8UwavtgUHm+Cg ($89.35 in chips)
Seat 4: MG90wfSJZnOejs/KD3vlQQ ($82.30 in chips)
Seat 5: aaHXfJPbwwtrerPKvT348Q ($2.95 in chips)
Seat 6: FFVKBJT0lZf+jFlgvy7ang ($45.05 in chips)
Seat 9: kuqESbpg/khtwiEKRXv2lg ($49.45 in chips)
MG90wfSJZnOejs/KD3vlQQ: posts small blind $0.25
aaHXfJPbwwtrerPKvT348Q: posts big blind $0.50
7CKaQEWhd40e2lLifzZ1Cw: sits out
*** HOLE CARDS ***
FFVKBJT0lZf+jFlgvy7ang: folds
kuqESbpg/khtwiEKRXv2lg: calls $0.50
M+D23GG26WXQ/2gyjREVOQ: folds
8pfDpjfHmTUlkgzpRPwQYQ: calls $0.50
+k7T5ocke8UwavtgUHm+Cg: calls $0.50
MG90wfSJZnOejs/KD3vlQQ: calls $0.25
aaHXfJPbwwtrerPKvT348Q: raises $2.45 to $2.95 and is all-in
kuqESbpg/khtwiEKRXv2lg: calls $2.45
8pfDpjfHmTUlkgzpRPwQYQ: calls $2.45
+k7T5ocke8UwavtgUHm+Cg: folds
MG90wfSJZnOejs/KD3vlQQ: calls $2.45
*** FLOP *** [5s Js 4c]
MG90wfSJZnOejs/KD3vlQQ: checks
kuqESbpg/khtwiEKRXv2lg: checks
8pfDpjfHmTUlkgzpRPwQYQ: checks
*** TURN *** [5s Js 4c] [Ad]
MG90wfSJZnOejs/KD3vlQQ: checks
kuqESbpg/khtwiEKRXv2lg: checks
8pfDpjfHmTUlkgzpRPwQYQ: checks
*** RIVER *** [5s Js 4c Ad] [7s]
MG90wfSJZnOejs/KD3vlQQ: checks
kuqESbpg/khtwiEKRXv2lg: checks
8pfDpjfHmTUlkgzpRPwQYQ: checks
*** SHOW DOWN ***
MG90wfSJZnOejs/KD3vlQQ: shows [Jd Qs] (a pair of Jacks)
aaHXfJPbwwtrerPKvT348Q: shows [Ks 8s] (a flush, King high)
kuqESbpg/khtwiEKRXv2lg: mucks hand
8pfDpjfHmTUlkgzpRPwQYQ: mucks hand
aaHXfJPbwwtrerPKvT348Q collected $11.70 from pot
*** SUMMARY ***
Total pot $12.30 | Rake $0.60
Board [5s Js 4c Ad 7s]
Seat 1: M+D23GG26WXQ/2gyjREVOQ folded before Flop (didn't bet)
Seat 2: 8pfDpjfHmTUlkgzpRPwQYQ mucked
Seat 3: +k7T5ocke8UwavtgUHm+Cg (button) folded before Flop
Seat 4: MG90wfSJZnOejs/KD3vlQQ (small blind) showed [Jd Qs] and lost with a pair of Jacks
Seat 5: aaHXfJPbwwtrerPKvT348Q (big blind) showed [Ks 8s] and won ($11.70) with a flush, King high
Seat 6: FFVKBJT0lZf+jFlgvy7ang folded before Flop (didn't bet)
Seat 9: kuqESbpg/khtwiEKRXv2lg mucked



PokerStars Game #59941689320:  Hold'em No Limit ($0.25/$0.50) - 2009/07/01 1:43:04 ET
Table 'GfL/No5u5PoEnU39lP5pQg' 6-max Seat #4 is the button
Seat 2: uVwggSetzp7d+eVgowO3vg ($53.50 in chips)
Seat 3: 4pp9WxhGdbVbxCc9tlu0lw ($26.05 in chips)
Seat 4: ifQmgsYNFiAg/XvBOMBSfQ ($49.25 in chips)
Seat 5: M1KyQQvVPVuxqTAB8sR/zQ ($51.10 in chips)
Seat 6: kxPhs4ePFqMy52CInAJ2aw ($103.35 in chips)
M1KyQQvVPVuxqTAB8sR/zQ: posts small blind $0.25
kxPhs4ePFqMy52CInAJ2aw: posts big blind $0.50
6qJZP2EKIgnEXJ3tMSBuew: sits out
*** HOLE CARDS ***
uVwggSetzp7d+eVgowO3vg: calls $0.50
4pp9WxhGdbVbxCc9tlu0lw: folds
ifQmgsYNFiAg/XvBOMBSfQ: folds
M1KyQQvVPVuxqTAB8sR/zQ: folds
kxPhs4ePFqMy52CInAJ2aw: checks
*** FLOP *** [Qd 5s 9s]
kxPhs4ePFqMy52CInAJ2aw: checks
uVwggSetzp7d+eVgowO3vg: checks
*** TURN *** [Qd 5s 9s] [2d]
kxPhs4ePFqMy52CInAJ2aw: checks
uVwggSetzp7d+eVgowO3vg: bets $2
kxPhs4ePFqMy52CInAJ2aw: folds
uVwggSetzp7d+eVgowO3vg collected $1.20 from pot
*** SUMMARY ***
Total pot $1.25 | Rake $0.05
Board [Qd 5s 9s 2d]
Seat 2: uVwggSetzp7d+eVgowO3vg collected ($1.20)
Seat 3: 4pp9WxhGdbVbxCc9tlu0lw folded before Flop (didn't bet)
Seat 4: ifQmgsYNFiAg/XvBOMBSfQ (button) folded before Flop (didn't bet)
Seat 5: M1KyQQvVPVuxqTAB8sR/zQ (small blind) folded before Flop
Seat 6: kxPhs4ePFqMy52CInAJ2aw (big blind) folded on the Turn



PokerStars Game #59941690580:  Hold'em No Limit ($0.25/$0.50) - 2009/07/01 1:43:06 ET
Table 'ofnd8S4IdIPph1Cbn+x7hAbR5MkGhKEbz+X2bpfpu11Qmax Seat #9 is the button
Seat 1: 6CKPjbH+MB5p5oH9GwiXGA ($50 in chips)
Seat 2: 1xBtrSVBbgFH/viUWKqQeg ($38.05 in chips)
Seat 3: UVJbBPbDwNMEZadZB9WVmg ($9.75 in chips)
Seat 4: mZNMJI1mY40XTC0U7GZakA ($62.20 in chips)
Seat 5: 2YaCb/8u1SesrR+963XiZA ($13.90 in chips)
Seat 6: 0Bw1Gb5YC/Xvb0SqVawKUw ($9.55 in chips)
Seat 7: kJ06FP2Jc7cSdmywwvYOXw ($45.60 in chips)
Seat 8: R354x4oZnQcGCDV6GhjnpQ ($79.35 in chips)
Seat 9: 75K2MXwN65Sjfp1yHd50Hg ($9.25 in chips)
6CKPjbH+MB5p5oH9GwiXGA: posts small blind $0.25
1xBtrSVBbgFH/viUWKqQeg: posts big blind $0.50
*** HOLE CARDS ***
UVJbBPbDwNMEZadZB9WVmg: folds
mZNMJI1mY40XTC0U7GZakA: folds
2YaCb/8u1SesrR+963XiZA: folds
0Bw1Gb5YC/Xvb0SqVawKUw: folds
kJ06FP2Jc7cSdmywwvYOXw: raises $1.75 to $2.25
R354x4oZnQcGCDV6GhjnpQ: calls $2.25
75K2MXwN65Sjfp1yHd50Hg: folds
6CKPjbH+MB5p5oH9GwiXGA: folds
1xBtrSVBbgFH/viUWKqQeg: folds
*** FLOP *** [3c Td Qd]
kJ06FP2Jc7cSdmywwvYOXw: checks
R354x4oZnQcGCDV6GhjnpQ: checks
*** TURN *** [3c Td Qd] [5s]
kJ06FP2Jc7cSdmywwvYOXw: bets $3.50
R354x4oZnQcGCDV6GhjnpQ: calls $3.50
*** RIVER *** [3c Td Qd 5s] [7d]
kJ06FP2Jc7cSdmywwvYOXw: checks
R354x4oZnQcGCDV6GhjnpQ: checks
*** SHOW DOWN ***
kJ06FP2Jc7cSdmywwvYOXw: shows [9d As] (high card Ace)
R354x4oZnQcGCDV6GhjnpQ: shows [4d 4h] (a pair of Fours)
R354x4oZnQcGCDV6GhjnpQ collected $11.65 from pot
*** SUMMARY ***
Total pot $12.25 | Rake $0.60
Board [3c Td Qd 5s 7d]
Seat 1: 6CKPjbH+MB5p5oH9GwiXGA (small blind) folded before Flop
Seat 2: 1xBtrSVBbgFH/viUWKqQeg (big blind) folded before Flop
Seat 3: UVJbBPbDwNMEZadZB9WVmg folded before Flop (didn't bet)
Seat 4: mZNMJI1mY40XTC0U7GZakA folded before Flop (didn't bet)
Seat 5: 2YaCb/8u1SesrR+963XiZA folded before Flop (didn't bet)
Seat 6: 0Bw1Gb5YC/Xvb0SqVawKUw folded before Flop (didn't bet)
Seat 7: kJ06FP2Jc7cSdmywwvYOXw showed [9d As] and lost with high card Ace
Seat 8: R354x4oZnQcGCDV6GhjnpQ showed [4d 4h] and won ($11.65) with a pair of Fours
Seat 9: 75K2MXwN65Sjfp1yHd50Hg (button) folded before Flop (didn't bet)



PokerStars Game #59941691272:  Hold'em No Limit ($0.25/$0.50) - 2009/07/01 1:43:07 ET
Table '2lPOwetm4cfkZPbTmGPH/w' 2-max Seat #1 is the button
Seat 1: vUGdApqS8J/GJE2gaVWl1w ($10.80 in chips)
Seat 2: XFa6sBGjP2gxoIvxR3fZIg ($25.10 in chips)
vUGdApqS8J/GJE2gaVWl1w: posts small blind $0.25
XFa6sBGjP2gxoIvxR3fZIg: posts big blind $0.50
*** HOLE CARDS ***
vUGdApqS8J/GJE2gaVWl1w: raises $1 to $1.50
XFa6sBGjP2gxoIvxR3fZIg: folds
vUGdApqS8J/GJE2gaVWl1w collected $1 from pot
*** SUMMARY ***
Total pot $1 | Rake $0
Seat 1: vUGdApqS8J/GJE2gaVWl1w (button) (small blind) collected ($1)
Seat 2: XFa6sBGjP2gxoIvxR3fZIg (big blind) folded before Flop



PokerStars Game #59941691544:  Hold'em No Limit ($0.25/$0.50) - 2009/07/01 1:43:08 ET
Table 'kgbJRsxfv64KrErDRBAkcw' 6-max Seat #1 is the button
Seat 1: k0xQy0tZZC75zf+pcK0bkQ ($49.25 in chips)
Seat 2: AdS8BJMOheS01zjCDfPMFg ($87.35 in chips)
Seat 3: c4MNIaIyPMOMxrgT8FT5nA ($157.30 in chips)
Seat 4: 2igtJLmvIZ+HqX4XPgMPZA ($111.75 in chips)
Seat 5: eUBBn2R56C1IQ6Cs/vitwg ($109.15 in chips)
Seat 6: 1b+2BbjMN8qhR1WPqdE9VQ ($51.45 in chips)
AdS8BJMOheS01zjCDfPMFg: posts small blind $0.25
c4MNIaIyPMOMxrgT8FT5nA: posts big blind $0.50
*** HOLE CARDS ***
2igtJLmvIZ+HqX4XPgMPZA: folds
eUBBn2R56C1IQ6Cs/vitwg: folds
1b+2BbjMN8qhR1WPqdE9VQ: raises $1 to $1.50
k0xQy0tZZC75zf+pcK0bkQ: folds
AdS8BJMOheS01zjCDfPMFg: folds
c4MNIaIyPMOMxrgT8FT5nA: calls $1
*** FLOP *** [2c 9c Kh]
c4MNIaIyPMOMxrgT8FT5nA: checks
1b+2BbjMN8qhR1WPqdE9VQ: checks
*** TURN *** [2c 9c Kh] [9h]
c4MNIaIyPMOMxrgT8FT5nA: bets $3
1b+2BbjMN8qhR1WPqdE9VQ: calls $3
*** RIVER *** [2c 9c Kh 9h] [7d]
k0xQy0tZZC75zf+pcK0bkQ leaves the table
c4MNIaIyPMOMxrgT8FT5nA: bets $5.50
1b+2BbjMN8qhR1WPqdE9VQ: folds
c4MNIaIyPMOMxrgT8FT5nA collected $8.80 from pot
*** SUMMARY ***
Total pot $9.25 | Rake $0.45
Board [2c 9c Kh 9h 7d]
Seat 1: k0xQy0tZZC75zf+pcK0bkQ (button) folded before Flop (didn't bet)
Seat 2: AdS8BJMOheS01zjCDfPMFg (small blind) folded before Flop
Seat 3: c4MNIaIyPMOMxrgT8FT5nA (big blind) collected ($8.80)
Seat 4: 2igtJLmvIZ+HqX4XPgMPZA folded before Flop (didn't bet)
Seat 5: eUBBn2R56C1IQ6Cs/vitwg folded before Flop (didn't bet)
Seat 6: 1b+2BbjMN8qhR1WPqdE9VQ folded on the River



PokerStars Game #59941691436:  Hold'em No Limit ($0.25/$0.50) - 2009/07/01 1:43:08 ET
Table 'lSisgp6H7Fg1hH5VfjEjYQ' 9-max Seat #6 is the button
Seat 1: 5k9fvXD9suIgCxU4HLQjTw ($52.80 in chips)
Seat 2: 5acK4E7fzEwnplVBZ6eNWA ($50.95 in chips)
Seat 3: SKnJuWHScqetA/qG5p+wCg ($30 in chips)
Seat 4: FFVKBJT0lZf+jFlgvy7ang ($38.95 in chips)
Seat 5: mSD1pginDsyHG5PDfqzphw ($15.75 in chips)
Seat 6: +k7T5ocke8UwavtgUHm+Cg ($74.90 in chips)
Seat 7: drKg+7JekfxR/0poTEK9Tg ($50.50 in chips)
Seat 8: a4JDWmpFQkL10XfAyuF51A ($11.85 in chips)
drKg+7JekfxR/0poTEK9Tg: posts small blind $0.25
a4JDWmpFQkL10XfAyuF51A: posts big blind $0.50
M+D23GG26WXQ/2gyjREVOQ: sits out
*** HOLE CARDS ***
5k9fvXD9suIgCxU4HLQjTw: folds
5acK4E7fzEwnplVBZ6eNWA: raises $1.50 to $2
SKnJuWHScqetA/qG5p+wCg: folds
FFVKBJT0lZf+jFlgvy7ang: folds
mSD1pginDsyHG5PDfqzphw: raises $3.50 to $5.50
+k7T5ocke8UwavtgUHm+Cg: folds
drKg+7JekfxR/0poTEK9Tg: calls $5.25
a4JDWmpFQkL10XfAyuF51A: folds
5acK4E7fzEwnplVBZ6eNWA: folds
*** FLOP *** [5h 4c Td]
drKg+7JekfxR/0poTEK9Tg: checks
mSD1pginDsyHG5PDfqzphw: bets $10.25 and is all-in
drKg+7JekfxR/0poTEK9Tg: calls $10.25
*** TURN *** [5h 4c Td] [8c]
*** RIVER *** [5h 4c Td 8c] [7s]
*** SHOW DOWN ***
drKg+7JekfxR/0poTEK9Tg: shows [As Ad] (a pair of Aces)
mSD1pginDsyHG5PDfqzphw: mucks hand
drKg+7JekfxR/0poTEK9Tg collected $32.35 from pot
*** SUMMARY ***
Total pot $34 | Rake $1.65
Board [5h 4c Td 8c 7s]
Seat 1: 5k9fvXD9suIgCxU4HLQjTw folded before Flop (didn't bet)
Seat 2: 5acK4E7fzEwnplVBZ6eNWA folded before Flop
Seat 3: SKnJuWHScqetA/qG5p+wCg folded before Flop (didn't bet)
Seat 4: FFVKBJT0lZf+jFlgvy7ang folded before Flop (didn't bet)
Seat 5: mSD1pginDsyHG5PDfqzphw mucked
Seat 6: +k7T5ocke8UwavtgUHm+Cg (button) folded before Flop (didn't bet)
Seat 7: drKg+7JekfxR/0poTEK9Tg (small blind) showed [As Ad] and won ($32.35) with a pair of Aces
Seat 8: a4JDWmpFQkL10XfAyuF51A (big blind) folded before Flop



PokerStars Game #59941691946:  Hold'em No Limit ($0.25/$0.50) - 2009/07/01 1:43:09 ET
Table 'cofQFHU7jbJoFecLVBof/w' 6-max Seat #3 is the button
Seat 1: URYNc7fPA23K2UfadQbnCA ($50.20 in chips)
Seat 2: f89uTQr3ieGlusj2IAYAEg ($50 in chips)
Seat 3: v4ctePcLlQw0r8E0qJtjYw ($50.70 in chips)
Seat 4: 9XrTM0DuVxx1pjFAdSbD8A ($59.40 in chips)
Seat 5: QvwRlrpVqerRRF8eJm6dDw ($48.40 in chips)
Seat 6: 7+uQ0OOgCTbR4ltkSwyC0g ($158.30 in chips)
9XrTM0DuVxx1pjFAdSbD8A: posts small blind $0.25
QvwRlrpVqerRRF8eJm6dDw: posts big blind $0.50
*** HOLE CARDS ***
7+uQ0OOgCTbR4ltkSwyC0g: folds
URYNc7fPA23K2UfadQbnCA: folds
f89uTQr3ieGlusj2IAYAEg: raises $1 to $1.50
v4ctePcLlQw0r8E0qJtjYw: folds
9XrTM0DuVxx1pjFAdSbD8A: folds
QvwRlrpVqerRRF8eJm6dDw: folds
f89uTQr3ieGlusj2IAYAEg collected $1.25 from pot
*** SUMMARY ***
Total pot $1.25 | Rake $0
Seat 1: URYNc7fPA23K2UfadQbnCA folded before Flop (didn't bet)
Seat 2: f89uTQr3ieGlusj2IAYAEg collected ($1.25)
Seat 3: v4ctePcLlQw0r8E0qJtjYw (button) folded before Flop (didn't bet)
Seat 4: 9XrTM0DuVxx1pjFAdSbD8A (small blind) folded before Flop
Seat 5: QvwRlrpVqerRRF8eJm6dDw (big blind) folded before Flop
Seat 6: 7+uQ0OOgCTbR4ltkSwyC0g folded before Flop (didn't bet)



PokerStars Game #59941691996:  Hold'em No Limit ($0.25/$0.50) - 2009/07/01 1:43:09 ET
Table 'NCiXr0d5CEKBQr/cZgLhbA' 9-max Seat #3 is the button
Seat 1: pFtzb1sR4b0d1aw6aIRgDg ($86.50 in chips)
Seat 2: AjV5McH1KMMclY26QdLM5w ($40.80 in chips)
Seat 3: xZCXQSXlrZkp3pZizzVXCw ($94.90 in chips)
Seat 4: 5k9fvXD9suIgCxU4HLQjTw ($50 in chips)
Seat 5: Ja2jdidjip2UeJnRzmzAAQ ($43.20 in chips)
Seat 6: t1qL+wRXOwTLB4TBbcw2QA ($53.10 in chips)
Seat 7: dXhO5i7KOoVcsGqbklD+jw ($44 in chips)
Seat 8: XA3GzEhYmqB0KknKKPDZGQ ($28.80 in chips)
Seat 9: 4WLZvqBn5qv5tds5kt5A1Q ($51.95 in chips)
5k9fvXD9suIgCxU4HLQjTw: posts small blind $0.25
Ja2jdidjip2UeJnRzmzAAQ: posts big blind $0.50
*** HOLE CARDS ***
t1qL+wRXOwTLB4TBbcw2QA: folds
dXhO5i7KOoVcsGqbklD+jw: folds
XA3GzEhYmqB0KknKKPDZGQ: folds
4WLZvqBn5qv5tds5kt5A1Q: folds
pFtzb1sR4b0d1aw6aIRgDg: raises $2 to $2.50
AjV5McH1KMMclY26QdLM5w: folds
xZCXQSXlrZkp3pZizzVXCw: folds
5k9fvXD9suIgCxU4HLQjTw: folds
Ja2jdidjip2UeJnRzmzAAQ: folds
pFtzb1sR4b0d1aw6aIRgDg collected $1.25 from pot
*** SUMMARY ***
Total pot $1.25 | Rake $0
Seat 1: pFtzb1sR4b0d1aw6aIRgDg collected ($1.25)
Seat 2: AjV5McH1KMMclY26QdLM5w folded before Flop (didn't bet)
Seat 3: xZCXQSXlrZkp3pZizzVXCw (button) folded before Flop (didn't bet)
Seat 4: 5k9fvXD9suIgCxU4HLQjTw (small blind) folded before Flop
Seat 5: Ja2jdidjip2UeJnRzmzAAQ (big blind) folded before Flop
Seat 6: t1qL+wRXOwTLB4TBbcw2QA folded before Flop (didn't bet)
Seat 7: dXhO5i7KOoVcsGqbklD+jw folded before Flop (didn't bet)
Seat 8: XA3GzEhYmqB0KknKKPDZGQ folded before Flop (didn't bet)
Seat 9: 4WLZvqBn5qv5tds5kt5A1Q folded before Flop (didn't bet)



PokerStars Game #59941692792:  Hold'em No Limit ($0.25/$0.50) - 2009/07/01 1:43:10 ET
Table 'Nz0Vr7WMHL2g5Uk7dDZjpw' 9-max Seat #5 is the button
Seat 1: 9yMsdgReyOUerNsmTYCCDQ ($8.25 in chips)
Seat 2: SegjDnMxWMujiD57ESNL+g ($19.60 in chips)
Seat 3: c638Xxo+q5F/t5qMtmvmvQ ($50.65 in chips)
Seat 4: uw9QayAAxLM3Hb+HR7mSkg ($8.50 in chips)
Seat 5: WGW0DgjBUXs1ylURHG8vnQ ($12.95 in chips)
Seat 7: KPLH0gELgFe2OuAnhJFI5w ($28.90 in chips)
Seat 8: aoL+R/61Kxmw69ypuPrWAQ ($29.70 in chips)
Seat 9: mSD1pginDsyHG5PDfqzphw ($16.50 in chips)
Alf.STG will be allowed to play after the button
KPLH0gELgFe2OuAnhJFI5w: posts small blind $0.25
aoL+R/61Kxmw69ypuPrWAQ: posts big blind $0.50
*** HOLE CARDS ***
mSD1pginDsyHG5PDfqzphw: folds
9yMsdgReyOUerNsmTYCCDQ: folds
SegjDnMxWMujiD57ESNL+g: folds
c638Xxo+q5F/t5qMtmvmvQ: folds
uw9QayAAxLM3Hb+HR7mSkg: folds
WGW0DgjBUXs1ylURHG8vnQ: calls $0.50
KPLH0gELgFe2OuAnhJFI5w: calls $0.25
aoL+R/61Kxmw69ypuPrWAQ: raises $1 to $1.50
WGW0DgjBUXs1ylURHG8vnQ: calls $1
KPLH0gELgFe2OuAnhJFI5w: calls $1
*** FLOP *** [6h Ks 9d]
KPLH0gELgFe2OuAnhJFI5w: bets $2
aoL+R/61Kxmw69ypuPrWAQ: calls $2
WGW0DgjBUXs1ylURHG8vnQ: calls $2
*** TURN *** [6h Ks 9d] [Td]
KPLH0gELgFe2OuAnhJFI5w: bets $1.50
aoL+R/61Kxmw69ypuPrWAQ: calls $1.50
WGW0DgjBUXs1ylURHG8vnQ: calls $1.50
*** RIVER *** [6h Ks 9d Td] [3c]
KPLH0gELgFe2OuAnhJFI5w: bets $2.50
aoL+R/61Kxmw69ypuPrWAQ: folds
WGW0DgjBUXs1ylURHG8vnQ: calls $2.50
*** SHOW DOWN ***
KPLH0gELgFe2OuAnhJFI5w: shows [Kc Qh] (a pair of Kings)
WGW0DgjBUXs1ylURHG8vnQ: shows [9s Th] (two pair, Tens and Nines)
WGW0DgjBUXs1ylURHG8vnQ collected $19.05 from pot
*** SUMMARY ***
Total pot $20 | Rake $0.95
Board [6h Ks 9d Td 3c]
Seat 1: 9yMsdgReyOUerNsmTYCCDQ folded before Flop (didn't bet)
Seat 2: SegjDnMxWMujiD57ESNL+g folded before Flop (didn't bet)
Seat 3: c638Xxo+q5F/t5qMtmvmvQ folded before Flop (didn't bet)
Seat 4: uw9QayAAxLM3Hb+HR7mSkg folded before Flop (didn't bet)
Seat 5: WGW0DgjBUXs1ylURHG8vnQ (button) showed [9s Th] and won ($19.05) with two pair, Tens and Nines
Seat 7: KPLH0gELgFe2OuAnhJFI5w (small blind) showed [Kc Qh] and lost with a pair of Kings
Seat 8: aoL+R/61Kxmw69ypuPrWAQ (big blind) folded on the River
Seat 9: mSD1pginDsyHG5PDfqzphw folded before Flop (didn't bet)



PokerStars Game #59941693146:  Hold'em No Limit ($0.25/$0.50) - 2009/07/01 1:43:11 ET
Table 'B+sqsfj6d6zXicNfaseTaw' 2-max Seat #2 is the button
Seat 1: +4GNcSsecmapVGSdV0mUPA ($151.05 in chips)
Seat 2: Lv5RmpRe6LtPkBzM9Gpo5A ($68.10 in chips)
Lv5RmpRe6LtPkBzM9Gpo5A: posts small blind $0.25
+4GNcSsecmapVGSdV0mUPA: posts big blind $0.50
*** HOLE CARDS ***
Lv5RmpRe6LtPkBzM9Gpo5A: calls $0.25
+4GNcSsecmapVGSdV0mUPA: checks
*** FLOP *** [9s 6c 6h]
+4GNcSsecmapVGSdV0mUPA: checks
Lv5RmpRe6LtPkBzM9Gpo5A: checks
*** TURN *** [9s 6c 6h] [2d]
+4GNcSsecmapVGSdV0mUPA: checks
Lv5RmpRe6LtPkBzM9Gpo5A: checks
*** RIVER *** [9s 6c 6h 2d] [5h]
+4GNcSsecmapVGSdV0mUPA: checks
Lv5RmpRe6LtPkBzM9Gpo5A: checks
*** SHOW DOWN ***
+4GNcSsecmapVGSdV0mUPA: shows [5c 3c] (two pair, Sixes and Fives)
Lv5RmpRe6LtPkBzM9Gpo5A: mucks hand
+4GNcSsecmapVGSdV0mUPA collected $0.95 from pot
*** SUMMARY ***
Total pot $1 | Rake $0.05
Board [9s 6c 6h 2d 5h]
Seat 1: +4GNcSsecmapVGSdV0mUPA (big blind) showed [5c 3c] and won ($0.95) with two pair, Sixes and Fives
Seat 2: Lv5RmpRe6LtPkBzM9Gpo5A (button) (small blind) mucked



PokerStars Game #59941694638:  Hold'em No Limit ($0.25/$0.50) - 2009/07/01 1:43:13 ET
Table 'iq+aXfWVQRdV0u8SRTYUEg' 9-max Seat #9 is the button
Seat 1: 3yl8Q6QaLfGtyhN4/pEFgQ ($71.30 in chips)
Seat 3: bMkgDRXl6YaqJ4b/5qml2Q ($9.50 in chips)
Seat 4: vHYT5s323LpajBj+2c9zbQ ($24.85 in chips)
Seat 5: 997ViqAtWn1FPjJqcffwcA ($56.65 in chips)
Seat 6: bTJ0WgoxefTPxIoycS7uoA ($25.70 in chips)
Seat 8: /DtIHuxEH+3tzKefmSV+Mw ($43.30 in chips)
Seat 9: drKg+7JekfxR/0poTEK9Tg ($50 in chips)
3yl8Q6QaLfGtyhN4/pEFgQ: posts small blind $0.25
bMkgDRXl6YaqJ4b/5qml2Q: posts big blind $0.50
*** HOLE CARDS ***
vHYT5s323LpajBj+2c9zbQ: folds
997ViqAtWn1FPjJqcffwcA: folds
bTJ0WgoxefTPxIoycS7uoA: calls $0.50
/DtIHuxEH+3tzKefmSV+Mw: folds
lonbeasurtea joins the table at seat #7
drKg+7JekfxR/0poTEK9Tg: folds
3yl8Q6QaLfGtyhN4/pEFgQ: folds
bMkgDRXl6YaqJ4b/5qml2Q: checks
*** FLOP *** [Th 5s Qs]
bMkgDRXl6YaqJ4b/5qml2Q: bets $1
bTJ0WgoxefTPxIoycS7uoA: folds
bMkgDRXl6YaqJ4b/5qml2Q collected $1.20 from pot
bMkgDRXl6YaqJ4b/5qml2Q: doesn't show hand
*** SUMMARY ***
Total pot $1.25 | Rake $0.05
Board [Th 5s Qs]
Seat 1: 3yl8Q6QaLfGtyhN4/pEFgQ (small blind) folded before Flop
Seat 3: bMkgDRXl6YaqJ4b/5qml2Q (big blind) collected ($1.20)
Seat 4: vHYT5s323LpajBj+2c9zbQ folded before Flop (didn't bet)
Seat 5: 997ViqAtWn1FPjJqcffwcA folded before Flop (didn't bet)
Seat 6: bTJ0WgoxefTPxIoycS7uoA folded on the Flop
Seat 8: /DtIHuxEH+3tzKefmSV+Mw folded before Flop (didn't bet)
Seat 9: drKg+7JekfxR/0poTEK9Tg (button) folded before Flop (didn't bet)



PokerStars Game #59941694560:  Hold'em No Limit ($0.25/$0.50) - 2009/07/01 1:43:13 ET
Table 'tyR5AZNKV8Aadbrnrnlg7g' 6-max Seat #3 is the button
Seat 1: BgOXYI0yYSN1ULC4FqsNkg ($81.20 in chips)
Seat 2: vhWS+cwAJNd3JzqVzIjBZA ($50.20 in chips)
Seat 3: JFLrYNyQmwPhRQAtoSAuyA ($60.10 in chips)
Seat 4: 4QfsCWthT/vSLirorNXqtg ($77.20 in chips)
Seat 5: GUnvMULl2qFOO1yenu1UBw ($76.35 in chips)
4QfsCWthT/vSLirorNXqtg: posts small blind $0.25
GUnvMULl2qFOO1yenu1UBw: posts big blind $0.50
*** HOLE CARDS ***
BgOXYI0yYSN1ULC4FqsNkg: calls $0.50
vhWS+cwAJNd3JzqVzIjBZA: folds
JFLrYNyQmwPhRQAtoSAuyA: folds
4QfsCWthT/vSLirorNXqtg: folds
GUnvMULl2qFOO1yenu1UBw: checks
*** FLOP *** [9s 5s 4s]
GUnvMULl2qFOO1yenu1UBw: checks
BgOXYI0yYSN1ULC4FqsNkg: bets $0.50
GUnvMULl2qFOO1yenu1UBw: folds
BgOXYI0yYSN1ULC4FqsNkg collected $1.20 from pot
*** SUMMARY ***
Total pot $1.25 | Rake $0.05
Board [9s 5s 4s]
Seat 1: BgOXYI0yYSN1ULC4FqsNkg collected ($1.20)
Seat 2: vhWS+cwAJNd3JzqVzIjBZA folded before Flop (didn't bet)
Seat 3: JFLrYNyQmwPhRQAtoSAuyA (button) folded before Flop (didn't bet)
Seat 4: 4QfsCWthT/vSLirorNXqtg (small blind) folded before Flop
Seat 5: GUnvMULl2qFOO1yenu1UBw (big blind) folded on the Flop



PokerStars Game #59941695388:  Hold'em No Limit ($0.25/$0.50) - 2009/07/01 1:43:15 ET
Table '2lPOwetm4cfkZPbTmGPH/w' 2-max Seat #2 is the button
Seat 1: vUGdApqS8J/GJE2gaVWl1w ($11.30 in chips)
Seat 2: XFa6sBGjP2gxoIvxR3fZIg ($24.60 in chips)
XFa6sBGjP2gxoIvxR3fZIg: posts small blind $0.25
vUGdApqS8J/GJE2gaVWl1w: posts big blind $0.50
*** HOLE CARDS ***
XFa6sBGjP2gxoIvxR3fZIg: calls $0.25
vUGdApqS8J/GJE2gaVWl1w: checks
*** FLOP *** [9h Ts 6s]
vUGdApqS8J/GJE2gaVWl1w: checks
XFa6sBGjP2gxoIvxR3fZIg: bets $1
vUGdApqS8J/GJE2gaVWl1w: folds
XFa6sBGjP2gxoIvxR3fZIg collected $0.95 from pot
XFa6sBGjP2gxoIvxR3fZIg: doesn't show hand
*** SUMMARY ***
Total pot $1 | Rake $0.05
Board [9h Ts 6s]
Seat 1: vUGdApqS8J/GJE2gaVWl1w (big blind) folded on the Flop
Seat 2: XFa6sBGjP2gxoIvxR3fZIg (button) (small blind) collected ($0.95)



PokerStars Game #59941697596:  Hold'em No Limit ($0.25/$0.50) - 2009/07/01 1:43:19 ET
Table 'EiNh8p/wGJ1FP575iMFnqg' 9-max Seat #3 is the button
Seat 1: YFFlOZgyy1Mh4iBmuNRbmQ ($18.80 in chips)
Seat 2: GRV8J6o4lVSBDEyjt6BwMg ($27.50 in chips)
Seat 3: ymLPoEIl7UL3TvZYmnadxQ ($37.25 in chips)
Seat 4: cMzaiXAM/ZAdNaEUu+LqhA ($55.15 in chips)
Seat 5: M+7+BTmX5vZatHVuoRB1nA ($75.15 in chips)
Seat 6: bCRukyMhXa3jkgAkKFa4VQ ($10.30 in chips)
Seat 7: 997ViqAtWn1FPjJqcffwcA ($50 in chips)
Seat 8: mSD1pginDsyHG5PDfqzphw ($21 in chips)
Seat 9: GuPkZObrz5Zkkn8FsEdF9w ($33.85 in chips)
cMzaiXAM/ZAdNaEUu+LqhA: posts small blind $0.25
M+7+BTmX5vZatHVuoRB1nA: posts big blind $0.50
*** HOLE CARDS ***
bCRukyMhXa3jkgAkKFa4VQ: folds
997ViqAtWn1FPjJqcffwcA: folds
mSD1pginDsyHG5PDfqzphw: folds
GuPkZObrz5Zkkn8FsEdF9w: folds
YFFlOZgyy1Mh4iBmuNRbmQ: folds
GRV8J6o4lVSBDEyjt6BwMg: folds
ymLPoEIl7UL3TvZYmnadxQ: raises $0.50 to $1
cMzaiXAM/ZAdNaEUu+LqhA: raises $3 to $4
M+7+BTmX5vZatHVuoRB1nA: folds
ymLPoEIl7UL3TvZYmnadxQ: folds
cMzaiXAM/ZAdNaEUu+LqhA collected $2.50 from pot
cMzaiXAM/ZAdNaEUu+LqhA: doesn't show hand
*** SUMMARY ***
Total pot $2.50 | Rake $0
Seat 1: YFFlOZgyy1Mh4iBmuNRbmQ folded before Flop (didn't bet)
Seat 2: GRV8J6o4lVSBDEyjt6BwMg folded before Flop (didn't bet)
Seat 3: ymLPoEIl7UL3TvZYmnadxQ (button) folded before Flop
Seat 4: cMzaiXAM/ZAdNaEUu+LqhA (small blind) collected ($2.50)
Seat 5: M+7+BTmX5vZatHVuoRB1nA (big blind) folded before Flop
Seat 6: bCRukyMhXa3jkgAkKFa4VQ folded before Flop (didn't bet)
Seat 7: 997ViqAtWn1FPjJqcffwcA folded before Flop (didn't bet)
Seat 8: mSD1pginDsyHG5PDfqzphw folded before Flop (didn't bet)
Seat 9: GuPkZObrz5Zkkn8FsEdF9w folded before Flop (didn't bet)



PokerStars Game #59941697894:  Hold'em No Limit ($0.25/$0.50) - 2009/07/01 1:43:20 ET
Table '5qf8oPyYje71HBKD0FwPgQ' 9-max Seat #3 is the button
Seat 1: gsyXT42WLEcOS4DdEk2wlw ($29.25 in chips)
Seat 2: M+7+BTmX5vZatHVuoRB1nA ($68.20 in chips)
Seat 3: vacmVLJJECYI6HjAynFcpg ($49.25 in chips)
Seat 4: YXCE3WOZi8g2sIf3y/plVw ($57.25 in chips)
Seat 5: uo2Sgpknd7NdeVbeSCG02A ($1.95 in chips)
Seat 6: go0Ad6tqqJ4tR9/bqVlO0g ($25.40 in chips)
Seat 7: 1q5EPoiflJRl8pqfnVLjMw ($53.50 in chips)
Seat 8: sakr/FIfFtIZwDPmAj5Pzg ($56.85 in chips)
Seat 9: jWDRpL0TJljg+mBCE9ZMqA ($21.15 in chips)
YXCE3WOZi8g2sIf3y/plVw: posts small blind $0.25
uo2Sgpknd7NdeVbeSCG02A: posts big blind $0.50
*** HOLE CARDS ***
go0Ad6tqqJ4tR9/bqVlO0g: folds
1q5EPoiflJRl8pqfnVLjMw: folds
sakr/FIfFtIZwDPmAj5Pzg: folds
jWDRpL0TJljg+mBCE9ZMqA: folds
gsyXT42WLEcOS4DdEk2wlw: calls $0.50
M+7+BTmX5vZatHVuoRB1nA: folds
vacmVLJJECYI6HjAynFcpg: folds
YXCE3WOZi8g2sIf3y/plVw: folds
uo2Sgpknd7NdeVbeSCG02A: raises $1.45 to $1.95 and is all-in
gsyXT42WLEcOS4DdEk2wlw: calls $1.45
*** FLOP *** [9d Qh 4d]
*** TURN *** [9d Qh 4d] [2h]
*** RIVER *** [9d Qh 4d 2h] [Jh]
*** SHOW DOWN ***
uo2Sgpknd7NdeVbeSCG02A: shows [As 5h] (high card Ace)
gsyXT42WLEcOS4DdEk2wlw: shows [3h 3c] (a pair of Threes)
gsyXT42WLEcOS4DdEk2wlw collected $3.95 from pot
*** SUMMARY ***
Total pot $4.15 | Rake $0.20
Board [9d Qh 4d 2h Jh]
Seat 1: gsyXT42WLEcOS4DdEk2wlw showed [3h 3c] and won ($3.95) with a pair of Threes
Seat 2: M+7+BTmX5vZatHVuoRB1nA folded before Flop (didn't bet)
Seat 3: vacmVLJJECYI6HjAynFcpg (button) folded before Flop (didn't bet)
Seat 4: YXCE3WOZi8g2sIf3y/plVw (small blind) folded before Flop
Seat 5: uo2Sgpknd7NdeVbeSCG02A (big blind) showed [As 5h] and lost with high card Ace
Seat 6: go0Ad6tqqJ4tR9/bqVlO0g folded before Flop (didn't bet)
Seat 7: 1q5EPoiflJRl8pqfnVLjMw folded before Flop (didn't bet)
Seat 8: sakr/FIfFtIZwDPmAj5Pzg folded before Flop (didn't bet)
Seat 9: jWDRpL0TJljg+mBCE9ZMqA folded before Flop (didn't bet)



PokerStars Game #59941698826:  Hold'em No Limit ($0.25/$0.50) - 2009/07/01 1:43:21 ET
Table 'hSTs/dUsYLgJQuF2Onp0MQ' 6-max Seat #3 is the button
Seat 1: Hdd4js36ITbTJ/QuVYwTlA ($89.25 in chips)
Seat 2: vhWS+cwAJNd3JzqVzIjBZA ($50.20 in chips)
Seat 3: lxIzoHy0RnkfFSODHC2liw ($50 in chips)
Seat 4: 2igtJLmvIZ+HqX4XPgMPZA ($60.80 in chips)
Seat 5: FsRQ5ECdlLkLYI5le8+PDQ ($50.35 in chips)
Seat 6: M1KyQQvVPVuxqTAB8sR/zQ ($102.70 in chips)
2igtJLmvIZ+HqX4XPgMPZA: posts small blind $0.25
FsRQ5ECdlLkLYI5le8+PDQ: posts big blind $0.50
*** HOLE CARDS ***
M1KyQQvVPVuxqTAB8sR/zQ: folds
Hdd4js36ITbTJ/QuVYwTlA: raises $2 to $2.50
vhWS+cwAJNd3JzqVzIjBZA: raises $5 to $7.50
lxIzoHy0RnkfFSODHC2liw: folds
2igtJLmvIZ+HqX4XPgMPZA: folds
FsRQ5ECdlLkLYI5le8+PDQ: raises $10.50 to $18
Hdd4js36ITbTJ/QuVYwTlA: folds
Hdd4js36ITbTJ/QuVYwTlA said, "lol"
vhWS+cwAJNd3JzqVzIjBZA: folds
FsRQ5ECdlLkLYI5le8+PDQ collected $17.75 from pot
*** SUMMARY ***
Total pot $17.75 | Rake $0
Seat 1: Hdd4js36ITbTJ/QuVYwTlA folded before Flop
Seat 2: vhWS+cwAJNd3JzqVzIjBZA folded before Flop
Seat 3: lxIzoHy0RnkfFSODHC2liw (button) folded before Flop (didn't bet)
Seat 4: 2igtJLmvIZ+HqX4XPgMPZA (small blind) folded before Flop
Seat 5: FsRQ5ECdlLkLYI5le8+PDQ (big blind) collected ($17.75)
Seat 6: M1KyQQvVPVuxqTAB8sR/zQ folded before Flop (didn't bet)



PokerStars Game #59941699038:  Hold'em No Limit ($0.25/$0.50) - 2009/07/01 1:43:22 ET
Table 'X6IRCRTh+20gjz8aubWnwA' 9-max Seat #6 is the button
Seat 1: 19W97h1250PJ5StTgSTflA ($5.75 in chips)
Seat 2: HZkVla4kK2SI42CVrPZ/ig ($25.20 in chips)
Seat 4: M3JFBNQ8Bbw3FBZ/18MuXw ($20.05 in chips)
Seat 5: x6aYxjx8NBg/FN9/5jVxrw ($49.25 in chips)
Seat 6: drKg+7JekfxR/0poTEK9Tg ($50 in chips)
Seat 7: +RUz0sVA09ZE8PNpIl+EBQ ($19.35 in chips)
Seat 8: Dayi7pXtIA/SVD06y5+DWg ($22.15 in chips)
Seat 9: M+7+BTmX5vZatHVuoRB1nA ($71.95 in chips)
+RUz0sVA09ZE8PNpIl+EBQ: posts small blind $0.25
Dayi7pXtIA/SVD06y5+DWg: posts big blind $0.50
*** HOLE CARDS ***
M+7+BTmX5vZatHVuoRB1nA: folds
19W97h1250PJ5StTgSTflA: folds
HZkVla4kK2SI42CVrPZ/ig: folds
M3JFBNQ8Bbw3FBZ/18MuXw: folds
x6aYxjx8NBg/FN9/5jVxrw: raises $1 to $1.50
drKg+7JekfxR/0poTEK9Tg: folds
sfduckman07 joins the table at seat #3
+RUz0sVA09ZE8PNpIl+EBQ: calls $1.25
Dayi7pXtIA/SVD06y5+DWg: folds
*** FLOP *** [5s 6c 7s]
+RUz0sVA09ZE8PNpIl+EBQ: checks
x6aYxjx8NBg/FN9/5jVxrw: bets $2
+RUz0sVA09ZE8PNpIl+EBQ: folds
x6aYxjx8NBg/FN9/5jVxrw collected $3.35 from pot
*** SUMMARY ***
Total pot $3.50 | Rake $0.15
Board [5s 6c 7s]
Seat 1: 19W97h1250PJ5StTgSTflA folded before Flop (didn't bet)
Seat 2: HZkVla4kK2SI42CVrPZ/ig folded before Flop (didn't bet)
Seat 4: M3JFBNQ8Bbw3FBZ/18MuXw folded before Flop (didn't bet)
Seat 5: x6aYxjx8NBg/FN9/5jVxrw collected ($3.35)
Seat 6: drKg+7JekfxR/0poTEK9Tg (button) folded before Flop (didn't bet)
Seat 7: +RUz0sVA09ZE8PNpIl+EBQ (small blind) folded on the Flop
Seat 8: Dayi7pXtIA/SVD06y5+DWg (big blind) folded before Flop
Seat 9: M+7+BTmX5vZatHVuoRB1nA folded before Flop (didn't bet)



PokerStars Game #59941699216:  Hold'em No Limit ($0.25/$0.50) - 2009/07/01 1:43:22 ET
Table '3FhG0gl3kMX3wBEEqj+wnQ' 9-max Seat #5 is the button
Seat 1: bxLSulbgr8LmKNjOzw8URg ($49.75 in chips)
Seat 2: HZkVla4kK2SI42CVrPZ/ig ($18.30 in chips)
Seat 3: YXCE3WOZi8g2sIf3y/plVw ($60.80 in chips)
Seat 4: e2+sK/yjnj94rXOKoxPP2A ($68 in chips)
Seat 5: XcLXSUMHSpshK/7Lh0M4Vg ($10.30 in chips)
Seat 7: mSD1pginDsyHG5PDfqzphw ($18.95 in chips)
Seat 8: j3K/Jujr7PY4ZM2RZvlH6A ($45.90 in chips)
Seat 9: KA0tkubTlbhmo4ju+qgXPg ($43.10 in chips)
mSD1pginDsyHG5PDfqzphw: posts small blind $0.25
j3K/Jujr7PY4ZM2RZvlH6A: posts big blind $0.50
*** HOLE CARDS ***
KA0tkubTlbhmo4ju+qgXPg: folds
bxLSulbgr8LmKNjOzw8URg: raises $1 to $1.50
HZkVla4kK2SI42CVrPZ/ig: calls $1.50
YXCE3WOZi8g2sIf3y/plVw: folds
e2+sK/yjnj94rXOKoxPP2A: folds
XcLXSUMHSpshK/7Lh0M4Vg: folds
mSD1pginDsyHG5PDfqzphw: folds
j3K/Jujr7PY4ZM2RZvlH6A: calls $1
*** FLOP *** [8c 5h 4c]
j3K/Jujr7PY4ZM2RZvlH6A: bets $4.50
bxLSulbgr8LmKNjOzw8URg: folds
HZkVla4kK2SI42CVrPZ/ig: calls $4.50
*** TURN *** [8c 5h 4c] [Ad]
j3K/Jujr7PY4ZM2RZvlH6A: bets $8.50
HZkVla4kK2SI42CVrPZ/ig: raises $3.80 to $12.30 and is all-in
j3K/Jujr7PY4ZM2RZvlH6A: calls $3.80
*** RIVER *** [8c 5h 4c Ad] [4s]
*** SHOW DOWN ***
j3K/Jujr7PY4ZM2RZvlH6A: shows [8d Jh] (two pair, Eights and Fours)
HZkVla4kK2SI42CVrPZ/ig: shows [Qh Qd] (two pair, Queens and Fours)
HZkVla4kK2SI42CVrPZ/ig collected $36.50 from pot
*** SUMMARY ***
Total pot $38.35 | Rake $1.85
Board [8c 5h 4c Ad 4s]
Seat 1: bxLSulbgr8LmKNjOzw8URg folded on the Flop
Seat 2: HZkVla4kK2SI42CVrPZ/ig showed [Qh Qd] and won ($36.50) with two pair, Queens and Fours
Seat 3: YXCE3WOZi8g2sIf3y/plVw folded before Flop (didn't bet)
Seat 4: e2+sK/yjnj94rXOKoxPP2A folded before Flop (didn't bet)
Seat 5: XcLXSUMHSpshK/7Lh0M4Vg (button) folded before Flop (didn't bet)
Seat 7: mSD1pginDsyHG5PDfqzphw (small blind) folded before Flop
Seat 8: j3K/Jujr7PY4ZM2RZvlH6A (big blind) showed [8d Jh] and lost with two pair, Eights and Fours
Seat 9: KA0tkubTlbhmo4ju+qgXPg folded before Flop (didn't bet)



PokerStars Game #59941702372:  Hold'em No Limit ($0.25/$0.50) - 2009/07/01 1:43:28 ET
Table '2lPOwetm4cfkZPbTmGPH/w' 2-max Seat #1 is the button
Seat 1: vUGdApqS8J/GJE2gaVWl1w ($10.80 in chips)
Seat 2: XFa6sBGjP2gxoIvxR3fZIg ($25.05 in chips)
vUGdApqS8J/GJE2gaVWl1w: posts small blind $0.25
XFa6sBGjP2gxoIvxR3fZIg: posts big blind $0.50
*** HOLE CARDS ***
vUGdApqS8J/GJE2gaVWl1w: calls $0.25
XFa6sBGjP2gxoIvxR3fZIg: checks
*** FLOP *** [2d Kd 6d]
XFa6sBGjP2gxoIvxR3fZIg: checks
vUGdApqS8J/GJE2gaVWl1w: bets $1
XFa6sBGjP2gxoIvxR3fZIg: folds
vUGdApqS8J/GJE2gaVWl1w collected $0.95 from pot
*** SUMMARY ***
Total pot $1 | Rake $0.05
Board [2d Kd 6d]
Seat 1: vUGdApqS8J/GJE2gaVWl1w (button) (small blind) collected ($0.95)
Seat 2: XFa6sBGjP2gxoIvxR3fZIg (big blind) folded on the Flop



PokerStars Game #59941703106:  Hold'em No Limit ($0.25/$0.50) - 2009/07/01 1:43:29 ET
Table '5EmHi+fnatGQQShcNmzOZQ' 6-max Seat #3 is the button
Seat 1: avNOJXWxD1+SygFmWsd+qw ($65.85 in chips)
Seat 3: QmH/ZFyxZfvliy57YM9yxw ($75.80 in chips)
Seat 4: 1b+2BbjMN8qhR1WPqdE9VQ ($50.45 in chips)
Seat 5: 6yWjZXHP6iAyMEDF6pJlng ($66.85 in chips)
1b+2BbjMN8qhR1WPqdE9VQ: posts small blind $0.25
6yWjZXHP6iAyMEDF6pJlng: posts big blind $0.50
I6jT30IIGKfk3BWwujd6WQ: sits out
vhWS+cwAJNd3JzqVzIjBZA: sits out
*** HOLE CARDS ***
avNOJXWxD1+SygFmWsd+qw: folds
QmH/ZFyxZfvliy57YM9yxw: folds
1b+2BbjMN8qhR1WPqdE9VQ: folds
6yWjZXHP6iAyMEDF6pJlng collected $0.50 from pot
*** SUMMARY ***
Total pot $0.50 | Rake $0
Seat 1: avNOJXWxD1+SygFmWsd+qw folded before Flop (didn't bet)
Seat 3: QmH/ZFyxZfvliy57YM9yxw (button) folded before Flop (didn't bet)
Seat 4: 1b+2BbjMN8qhR1WPqdE9VQ (small blind) folded before Flop
Seat 5: 6yWjZXHP6iAyMEDF6pJlng (big blind) collected ($0.50)



PokerStars Game #59941703672:  Hold'em No Limit ($0.25/$0.50) - 2009/07/01 1:43:31 ET
Table 'BCN5su+SsXiy1zRMJi0SJw' 6-max Seat #5 is the button
Seat 1: GxXV09ciXaOxyY2H5aMIIw ($34.90 in chips)
Seat 2: ehFNAevCQri3trWxV6FJdA ($84.55 in chips)
Seat 3: kwgv5lNhiFrfONXCshzxlA ($72.50 in chips)
Seat 4: bbsK8j+tpuVRhBqDzHxf7w ($49.10 in chips)
Seat 5: kxPhs4ePFqMy52CInAJ2aw ($49 in chips)
vhWS+cwAJNd3JzqVzIjBZA will be allowed to play after the button
GxXV09ciXaOxyY2H5aMIIw: posts small blind $0.25
ehFNAevCQri3trWxV6FJdA: posts big blind $0.50
*** HOLE CARDS ***
kwgv5lNhiFrfONXCshzxlA: folds
bbsK8j+tpuVRhBqDzHxf7w: raises $1 to $1.50
kxPhs4ePFqMy52CInAJ2aw: folds
GxXV09ciXaOxyY2H5aMIIw: folds
ehFNAevCQri3trWxV6FJdA: calls $1
*** FLOP *** [Ts Ac 8h]
ehFNAevCQri3trWxV6FJdA: checks
bbsK8j+tpuVRhBqDzHxf7w: checks
*** TURN *** [Ts Ac 8h] [4s]
ehFNAevCQri3trWxV6FJdA: checks
bbsK8j+tpuVRhBqDzHxf7w: checks
*** RIVER *** [Ts Ac 8h 4s] [Ad]
ehFNAevCQri3trWxV6FJdA: checks
bbsK8j+tpuVRhBqDzHxf7w: bets $1
ehFNAevCQri3trWxV6FJdA: folds
bbsK8j+tpuVRhBqDzHxf7w collected $3.10 from pot
bbsK8j+tpuVRhBqDzHxf7w: doesn't show hand
*** SUMMARY ***
Total pot $3.25 | Rake $0.15
Board [Ts Ac 8h 4s Ad]
Seat 1: GxXV09ciXaOxyY2H5aMIIw (small blind) folded before Flop
Seat 2: ehFNAevCQri3trWxV6FJdA (big blind) folded on the River
Seat 3: kwgv5lNhiFrfONXCshzxlA folded before Flop (didn't bet)
Seat 4: bbsK8j+tpuVRhBqDzHxf7w collected ($3.10)
Seat 5: kxPhs4ePFqMy52CInAJ2aw (button) folded before Flop (didn't bet)



PokerStars Game #59941704274:  Hold'em No Limit ($0.25/$0.50) - 2009/07/01 1:43:32 ET
Table 'B+sqsfj6d6zXicNfaseTaw' 2-max Seat #1 is the button
Seat 1: +4GNcSsecmapVGSdV0mUPA ($151.50 in chips)
Seat 2: Lv5RmpRe6LtPkBzM9Gpo5A ($67.60 in chips)
+4GNcSsecmapVGSdV0mUPA: posts small blind $0.25
Lv5RmpRe6LtPkBzM9Gpo5A: posts big blind $0.50
*** HOLE CARDS ***
+4GNcSsecmapVGSdV0mUPA: raises $1 to $1.50
Lv5RmpRe6LtPkBzM9Gpo5A: raises $2.50 to $4
+4GNcSsecmapVGSdV0mUPA: calls $2.50
*** FLOP *** [3c Ac 5s]
Lv5RmpRe6LtPkBzM9Gpo5A: bets $3.50
+4GNcSsecmapVGSdV0mUPA: folds
Lv5RmpRe6LtPkBzM9Gpo5A collected $7.60 from pot
*** SUMMARY ***
Total pot $8 | Rake $0.40
Board [3c Ac 5s]
Seat 1: +4GNcSsecmapVGSdV0mUPA (button) (small blind) folded on the Flop
Seat 2: Lv5RmpRe6LtPkBzM9Gpo5A (big blind) collected ($7.60)



PokerStars Game #59941705868:  Hold'em No Limit ($0.25/$0.50) - 2009/07/01 1:43:35 ET
Table 'cofQFHU7jbJoFecLVBof/w' 6-max Seat #4 is the button
Seat 1: URYNc7fPA23K2UfadQbnCA ($50.20 in chips)
Seat 2: f89uTQr3ieGlusj2IAYAEg ($50.75 in chips)
Seat 3: v4ctePcLlQw0r8E0qJtjYw ($50.70 in chips)
Seat 4: 9XrTM0DuVxx1pjFAdSbD8A ($59.15 in chips)
Seat 5: QvwRlrpVqerRRF8eJm6dDw ($47.90 in chips)
Seat 6: 7+uQ0OOgCTbR4ltkSwyC0g ($158.30 in chips)
QvwRlrpVqerRRF8eJm6dDw: posts small blind $0.25
7+uQ0OOgCTbR4ltkSwyC0g: posts big blind $0.50
*** HOLE CARDS ***
URYNc7fPA23K2UfadQbnCA: folds
f89uTQr3ieGlusj2IAYAEg: folds
v4ctePcLlQw0r8E0qJtjYw: folds
9XrTM0DuVxx1pjFAdSbD8A: raises $0.50 to $1
QvwRlrpVqerRRF8eJm6dDw: raises $0.50 to $1.50
7+uQ0OOgCTbR4ltkSwyC0g: folds
9XrTM0DuVxx1pjFAdSbD8A: calls $0.50
*** FLOP *** [6s Tc 5h]
QvwRlrpVqerRRF8eJm6dDw: bets $4
9XrTM0DuVxx1pjFAdSbD8A: folds
QvwRlrpVqerRRF8eJm6dDw collected $3.35 from pot
*** SUMMARY ***
Total pot $3.50 | Rake $0.15
Board [6s Tc 5h]
Seat 1: URYNc7fPA23K2UfadQbnCA folded before Flop (didn't bet)
Seat 2: f89uTQr3ieGlusj2IAYAEg folded before Flop (didn't bet)
Seat 3: v4ctePcLlQw0r8E0qJtjYw folded before Flop (didn't bet)
Seat 4: 9XrTM0DuVxx1pjFAdSbD8A (button) folded on the Flop
Seat 5: QvwRlrpVqerRRF8eJm6dDw (small blind) collected ($3.35)
Seat 6: 7+uQ0OOgCTbR4ltkSwyC0g (big blind) folded before Flop



PokerStars Game #59941707508:  Hold'em No Limit ($0.25/$0.50) - 2009/07/01 1:43:38 ET
Table 'eMxdLyFDf28E0wit6gm3Uw' 6-max Seat #6 is the button
Seat 1: jzl4amVmlpZ9J1ngneu8zQ ($53.20 in chips)
Seat 2: UEjiWqFckVmunpvV128Xfw ($49.45 in chips)
Seat 3: zAcsDhG/T128Vn7XGVSgKg ($67.55 in chips)
Seat 4: hPAFLRqGh8YnqPe3HMZiQg ($33.70 in chips)
Seat 5: x+dZZEcDM5hk2AuK0qVllQ ($50 in chips)
Seat 6: lxIzoHy0RnkfFSODHC2liw ($52.25 in chips)
jzl4amVmlpZ9J1ngneu8zQ: posts small blind $0.25
UEjiWqFckVmunpvV128Xfw: posts big blind $0.50
*** HOLE CARDS ***
zAcsDhG/T128Vn7XGVSgKg: folds
hPAFLRqGh8YnqPe3HMZiQg: folds
x+dZZEcDM5hk2AuK0qVllQ: folds
lxIzoHy0RnkfFSODHC2liw: folds
jzl4amVmlpZ9J1ngneu8zQ: calls $0.25
UEjiWqFckVmunpvV128Xfw: checks
*** FLOP *** [Jd 4d Kh]
jzl4amVmlpZ9J1ngneu8zQ: checks
UEjiWqFckVmunpvV128Xfw: checks
*** TURN *** [Jd 4d Kh] [Jh]
jzl4amVmlpZ9J1ngneu8zQ: checks
UEjiWqFckVmunpvV128Xfw: checks
*** RIVER *** [Jd 4d Kh Jh] [6d]
jzl4amVmlpZ9J1ngneu8zQ: checks
UEjiWqFckVmunpvV128Xfw: checks
*** SHOW DOWN ***
jzl4amVmlpZ9J1ngneu8zQ: shows [9h Qs] (a pair of Jacks)
UEjiWqFckVmunpvV128Xfw: mucks hand
jzl4amVmlpZ9J1ngneu8zQ collected $0.95 from pot
*** SUMMARY ***
Total pot $1 | Rake $0.05
Board [Jd 4d Kh Jh 6d]
Seat 1: jzl4amVmlpZ9J1ngneu8zQ (small blind) showed [9h Qs] and won ($0.95) with a pair of Jacks
Seat 2: UEjiWqFckVmunpvV128Xfw (big blind) mucked
Seat 3: zAcsDhG/T128Vn7XGVSgKg folded before Flop (didn't bet)
Seat 4: hPAFLRqGh8YnqPe3HMZiQg folded before Flop (didn't bet)
Seat 5: x+dZZEcDM5hk2AuK0qVllQ folded before Flop (didn't bet)
Seat 6: lxIzoHy0RnkfFSODHC2liw (button) folded before Flop (didn't bet)



PokerStars Game #59941707744:  Hold'em No Limit ($0.25/$0.50) - 2009/07/01 1:43:38 ET
Table 'tyR5AZNKV8Aadbrnrnlg7g' 6-max Seat #4 is the button
Seat 1: BgOXYI0yYSN1ULC4FqsNkg ($81.90 in chips)
Seat 2: vhWS+cwAJNd3JzqVzIjBZA ($50.20 in chips)
Seat 3: JFLrYNyQmwPhRQAtoSAuyA ($60.10 in chips)
Seat 4: 4QfsCWthT/vSLirorNXqtg ($76.95 in chips)
Seat 5: GUnvMULl2qFOO1yenu1UBw ($75.85 in chips)
GUnvMULl2qFOO1yenu1UBw: posts small blind $0.25
BgOXYI0yYSN1ULC4FqsNkg: posts big blind $0.50
*** HOLE CARDS ***
vhWS+cwAJNd3JzqVzIjBZA: folds
JFLrYNyQmwPhRQAtoSAuyA: folds
4QfsCWthT/vSLirorNXqtg: folds
GUnvMULl2qFOO1yenu1UBw: raises $1 to $1.50
BgOXYI0yYSN1ULC4FqsNkg: calls $1
*** FLOP *** [3h Ad 9s]
GUnvMULl2qFOO1yenu1UBw: bets $2
BgOXYI0yYSN1ULC4FqsNkg: calls $2
*** TURN *** [3h Ad 9s] [8h]
GUnvMULl2qFOO1yenu1UBw: checks
BgOXYI0yYSN1ULC4FqsNkg: bets $8
GUnvMULl2qFOO1yenu1UBw: folds
BgOXYI0yYSN1ULC4FqsNkg collected $6.70 from pot
*** SUMMARY ***
Total pot $7 | Rake $0.30
Board [3h Ad 9s 8h]
Seat 1: BgOXYI0yYSN1ULC4FqsNkg (big blind) collected ($6.70)
Seat 2: vhWS+cwAJNd3JzqVzIjBZA folded before Flop (didn't bet)
Seat 3: JFLrYNyQmwPhRQAtoSAuyA folded before Flop (didn't bet)
Seat 4: 4QfsCWthT/vSLirorNXqtg (button) folded before Flop (didn't bet)
Seat 5: GUnvMULl2qFOO1yenu1UBw (small blind) folded on the Turn



PokerStars Game #59941709934:  Hold'em No Limit ($0.25/$0.50) - 2009/07/01 1:43:42 ET
Table '5EmHi+fnatGQQShcNmzOZQ' 6-max Seat #4 is the button
Seat 1: avNOJXWxD1+SygFmWsd+qw ($65.85 in chips)
Seat 3: QmH/ZFyxZfvliy57YM9yxw ($75.80 in chips)
Seat 4: 1b+2BbjMN8qhR1WPqdE9VQ ($50.20 in chips)
Seat 5: 6yWjZXHP6iAyMEDF6pJlng ($67.10 in chips)
Seat 6: I6jT30IIGKfk3BWwujd6WQ ($50 in chips)
6yWjZXHP6iAyMEDF6pJlng: posts small blind $0.25
I6jT30IIGKfk3BWwujd6WQ: posts big blind $0.50
vhWS+cwAJNd3JzqVzIjBZA: sits out
*** HOLE CARDS ***
avNOJXWxD1+SygFmWsd+qw: raises $1.50 to $2
QmH/ZFyxZfvliy57YM9yxw: folds
1b+2BbjMN8qhR1WPqdE9VQ: folds
6yWjZXHP6iAyMEDF6pJlng: folds
I6jT30IIGKfk3BWwujd6WQ: folds
avNOJXWxD1+SygFmWsd+qw collected $1.25 from pot
avNOJXWxD1+SygFmWsd+qw: doesn't show hand
*** SUMMARY ***
Total pot $1.25 | Rake $0
Seat 1: avNOJXWxD1+SygFmWsd+qw collected ($1.25)
Seat 3: QmH/ZFyxZfvliy57YM9yxw folded before Flop (didn't bet)
Seat 4: 1b+2BbjMN8qhR1WPqdE9VQ (button) folded before Flop (didn't bet)
Seat 5: 6yWjZXHP6iAyMEDF6pJlng (small blind) folded before Flop
Seat 6: I6jT30IIGKfk3BWwujd6WQ (big blind) folded before Flop



PokerStars Game #59941710044:  Hold'em No Limit ($0.25/$0.50) - 2009/07/01 1:43:42 ET
Table '2lPOwetm4cfkZPbTmGPH/w' 2-max Seat #2 is the button
Seat 1: vUGdApqS8J/GJE2gaVWl1w ($11.25 in chips)
Seat 2: XFa6sBGjP2gxoIvxR3fZIg ($24.55 in chips)
XFa6sBGjP2gxoIvxR3fZIg: posts small blind $0.25
vUGdApqS8J/GJE2gaVWl1w: posts big blind $0.50
*** HOLE CARDS ***
XFa6sBGjP2gxoIvxR3fZIg: raises $1 to $1.50
vUGdApqS8J/GJE2gaVWl1w: calls $1
*** FLOP *** [4s Ah Td]
vUGdApqS8J/GJE2gaVWl1w: checks
XFa6sBGjP2gxoIvxR3fZIg: checks
*** TURN *** [4s Ah Td] [Kc]
vUGdApqS8J/GJE2gaVWl1w: bets $2
XFa6sBGjP2gxoIvxR3fZIg: calls $2
*** RIVER *** [4s Ah Td Kc] [6h]
vUGdApqS8J/GJE2gaVWl1w: bets $2
XFa6sBGjP2gxoIvxR3fZIg: folds
vUGdApqS8J/GJE2gaVWl1w collected $6.70 from pot
vUGdApqS8J/GJE2gaVWl1w: doesn't show hand
*** SUMMARY ***
Total pot $7 | Rake $0.30
Board [4s Ah Td Kc 6h]
Seat 1: vUGdApqS8J/GJE2gaVWl1w (big blind) collected ($6.70)
Seat 2: XFa6sBGjP2gxoIvxR3fZIg (button) (small blind) folded on the River



PokerStars Game #59941711798:  Hold'em No Limit ($0.25/$0.50) - 2009/07/01 1:43:46 ET
Table 'GfL/No5u5PoEnU39lP5pQg' 6-max Seat #5 is the button
Seat 1: 6qJZP2EKIgnEXJ3tMSBuew ($50 in chips)
Seat 2: uVwggSetzp7d+eVgowO3vg ($54.20 in chips)
Seat 3: 4pp9WxhGdbVbxCc9tlu0lw ($26.05 in chips)
Seat 4: ifQmgsYNFiAg/XvBOMBSfQ ($49.25 in chips)
Seat 5: M1KyQQvVPVuxqTAB8sR/zQ ($50.85 in chips)
Seat 6: kxPhs4ePFqMy52CInAJ2aw ($102.85 in chips)
kxPhs4ePFqMy52CInAJ2aw: posts small blind $0.25
6qJZP2EKIgnEXJ3tMSBuew: posts big blind $0.50
*** HOLE CARDS ***
uVwggSetzp7d+eVgowO3vg: folds
4pp9WxhGdbVbxCc9tlu0lw: folds
ifQmgsYNFiAg/XvBOMBSfQ: folds
M1KyQQvVPVuxqTAB8sR/zQ: folds
kxPhs4ePFqMy52CInAJ2aw: folds
6qJZP2EKIgnEXJ3tMSBuew collected $0.50 from pot
6qJZP2EKIgnEXJ3tMSBuew: doesn't show hand
*** SUMMARY ***
Total pot $0.50 | Rake $0
Seat 1: 6qJZP2EKIgnEXJ3tMSBuew (big blind) collected ($0.50)
Seat 2: uVwggSetzp7d+eVgowO3vg folded before Flop (didn't bet)
Seat 3: 4pp9WxhGdbVbxCc9tlu0lw folded before Flop (didn't bet)
Seat 4: ifQmgsYNFiAg/XvBOMBSfQ folded before Flop (didn't bet)
Seat 5: M1KyQQvVPVuxqTAB8sR/zQ (button) folded before Flop (didn't bet)
Seat 6: kxPhs4ePFqMy52CInAJ2aw (small blind) folded before Flop



PokerStars Game #59941714458:  Hold'em No Limit ($0.25/$0.50) - 2009/07/01 1:43:51 ET
Table 'B+sqsfj6d6zXicNfaseTaw' 2-max Seat #2 is the button
Seat 1: +4GNcSsecmapVGSdV0mUPA ($147.50 in chips)
Seat 2: Lv5RmpRe6LtPkBzM9Gpo5A ($71.20 in chips)
Lv5RmpRe6LtPkBzM9Gpo5A: posts small blind $0.25
+4GNcSsecmapVGSdV0mUPA: posts big blind $0.50
*** HOLE CARDS ***
Lv5RmpRe6LtPkBzM9Gpo5A: calls $0.25
+4GNcSsecmapVGSdV0mUPA: checks
*** FLOP *** [6d Th 4d]
+4GNcSsecmapVGSdV0mUPA: checks
Lv5RmpRe6LtPkBzM9Gpo5A: checks
*** TURN *** [6d Th 4d] [3c]
+4GNcSsecmapVGSdV0mUPA: bets $1
Lv5RmpRe6LtPkBzM9Gpo5A: calls $1
*** RIVER *** [6d Th 4d 3c] [7s]
+4GNcSsecmapVGSdV0mUPA: checks
Lv5RmpRe6LtPkBzM9Gpo5A: checks
*** SHOW DOWN ***
+4GNcSsecmapVGSdV0mUPA: shows [6s 2d] (a pair of Sixes)
Lv5RmpRe6LtPkBzM9Gpo5A: shows [8d 6h] (a pair of Sixes - Ten+Eight kicker)
Lv5RmpRe6LtPkBzM9Gpo5A collected $2.90 from pot
*** SUMMARY ***
Total pot $3 | Rake $0.10
Board [6d Th 4d 3c 7s]
Seat 1: +4GNcSsecmapVGSdV0mUPA (big blind) showed [6s 2d] and lost with a pair of Sixes
Seat 2: Lv5RmpRe6LtPkBzM9Gpo5A (button) (small blind) showed [8d 6h] and won ($2.90) with a pair of Sixes



PokerStars Game #59941714738:  Hold'em No Limit ($0.25/$0.50) - 2009/07/01 1:43:51 ET
Table 'ZYI3ZReBjdfKEYItkZHI6A' 9-max Seat #1 is the button
Seat 1: IYd5zG8k7vdBNVHbHg2Pag ($59.65 in chips)
Seat 2: 5acK4E7fzEwnplVBZ6eNWA ($50 in chips)
Seat 3: 75K2MXwN65Sjfp1yHd50Hg ($8.50 in chips)
Seat 4: /UdtxmXsFx6K/14AbHqzbQ ($19.65 in chips)
Seat 5: ApHP7ouup365XIUFBdEDxg ($19.60 in chips)
Seat 6: 1xBtrSVBbgFH/viUWKqQeg ($28.30 in chips)
Seat 7: XysesR1vUp34S3HSj4ez+w ($30 in chips)
Seat 8: ji04uOybxCdpdefzlUQeKQ ($26.30 in chips)
Seat 9: HZkVla4kK2SI42CVrPZ/ig ($10.15 in chips)
5acK4E7fzEwnplVBZ6eNWA: posts small blind $0.25
75K2MXwN65Sjfp1yHd50Hg: posts big blind $0.50
XysesR1vUp34S3HSj4ez+w: posts big blind $0.50
*** HOLE CARDS ***
/UdtxmXsFx6K/14AbHqzbQ: folds
ApHP7ouup365XIUFBdEDxg: folds
/UdtxmXsFx6K/14AbHqzbQ is sitting out
/UdtxmXsFx6K/14AbHqzbQ leaves the table
1xBtrSVBbgFH/viUWKqQeg: raises $2 to $2.50
XysesR1vUp34S3HSj4ez+w: folds
ji04uOybxCdpdefzlUQeKQ: folds
HZkVla4kK2SI42CVrPZ/ig: folds
IYd5zG8k7vdBNVHbHg2Pag: folds
5acK4E7fzEwnplVBZ6eNWA: folds
75K2MXwN65Sjfp1yHd50Hg: folds
1xBtrSVBbgFH/viUWKqQeg collected $1.75 from pot
*** SUMMARY ***
Total pot $1.75 | Rake $0
Seat 1: IYd5zG8k7vdBNVHbHg2Pag (button) folded before Flop (didn't bet)
Seat 2: 5acK4E7fzEwnplVBZ6eNWA (small blind) folded before Flop
Seat 3: 75K2MXwN65Sjfp1yHd50Hg (big blind) folded before Flop
Seat 4: /UdtxmXsFx6K/14AbHqzbQ folded before Flop (didn't bet)
Seat 5: ApHP7ouup365XIUFBdEDxg folded before Flop (didn't bet)
Seat 6: 1xBtrSVBbgFH/viUWKqQeg collected ($1.75)
Seat 7: XysesR1vUp34S3HSj4ez+w folded before Flop
Seat 8: ji04uOybxCdpdefzlUQeKQ folded before Flop (didn't bet)
Seat 9: HZkVla4kK2SI42CVrPZ/ig folded before Flop (didn't bet)



PokerStars Game #59941715720:  Hold'em No Limit ($0.25/$0.50) - 2009/07/01 1:43:53 ET
Table 'NCiXr0d5CEKBQr/cZgLhbA' 9-max Seat #4 is the button
Seat 1: pFtzb1sR4b0d1aw6aIRgDg ($87.25 in chips)
Seat 2: AjV5McH1KMMclY26QdLM5w ($40.80 in chips)
Seat 3: xZCXQSXlrZkp3pZizzVXCw ($94.90 in chips)
Seat 4: 5k9fvXD9suIgCxU4HLQjTw ($50 in chips)
Seat 5: Ja2jdidjip2UeJnRzmzAAQ ($42.70 in chips)
Seat 6: t1qL+wRXOwTLB4TBbcw2QA ($53.10 in chips)
Seat 7: dXhO5i7KOoVcsGqbklD+jw ($44 in chips)
Seat 8: XA3GzEhYmqB0KknKKPDZGQ ($28.80 in chips)
Seat 9: 4WLZvqBn5qv5tds5kt5A1Q ($51.95 in chips)
Ja2jdidjip2UeJnRzmzAAQ: posts small blind $0.25
t1qL+wRXOwTLB4TBbcw2QA: posts big blind $0.50
*** HOLE CARDS ***
dXhO5i7KOoVcsGqbklD+jw: folds
XA3GzEhYmqB0KknKKPDZGQ: folds
4WLZvqBn5qv5tds5kt5A1Q: folds
pFtzb1sR4b0d1aw6aIRgDg: folds
AjV5McH1KMMclY26QdLM5w: folds
xZCXQSXlrZkp3pZizzVXCw: folds
5k9fvXD9suIgCxU4HLQjTw: raises $1 to $1.50
Ja2jdidjip2UeJnRzmzAAQ: calls $1.25
t1qL+wRXOwTLB4TBbcw2QA: folds
*** FLOP *** [7s Tc 8s]
Ja2jdidjip2UeJnRzmzAAQ: checks
5k9fvXD9suIgCxU4HLQjTw: checks
*** TURN *** [7s Tc 8s] [Kh]
Ja2jdidjip2UeJnRzmzAAQ: bets $1.50
5k9fvXD9suIgCxU4HLQjTw: folds
Ja2jdidjip2UeJnRzmzAAQ collected $3.35 from pot
*** SUMMARY ***
Total pot $3.50 | Rake $0.15
Board [7s Tc 8s Kh]
Seat 1: pFtzb1sR4b0d1aw6aIRgDg folded before Flop (didn't bet)
Seat 2: AjV5McH1KMMclY26QdLM5w folded before Flop (didn't bet)
Seat 3: xZCXQSXlrZkp3pZizzVXCw folded before Flop (didn't bet)
Seat 4: 5k9fvXD9suIgCxU4HLQjTw (button) folded on the Turn
Seat 5: Ja2jdidjip2UeJnRzmzAAQ (small blind) collected ($3.35)
Seat 6: t1qL+wRXOwTLB4TBbcw2QA (big blind) folded before Flop
Seat 7: dXhO5i7KOoVcsGqbklD+jw folded before Flop (didn't bet)
Seat 8: XA3GzEhYmqB0KknKKPDZGQ folded before Flop (didn't bet)
Seat 9: 4WLZvqBn5qv5tds5kt5A1Q folded before Flop (didn't bet)



PokerStars Game #59941715620:  Hold'em No Limit ($0.25/$0.50) - 2009/07/01 1:43:53 ET
Table '5qf8oPyYje71HBKD0FwPgQ' 9-max Seat #4 is the button
Seat 1: gsyXT42WLEcOS4DdEk2wlw ($31.25 in chips)
Seat 2: M+7+BTmX5vZatHVuoRB1nA ($68.20 in chips)
Seat 3: vacmVLJJECYI6HjAynFcpg ($49.25 in chips)
Seat 4: YXCE3WOZi8g2sIf3y/plVw ($57 in chips)
Seat 6: go0Ad6tqqJ4tR9/bqVlO0g ($25.40 in chips)
Seat 7: 1q5EPoiflJRl8pqfnVLjMw ($53.50 in chips)
Seat 8: sakr/FIfFtIZwDPmAj5Pzg ($56.85 in chips)
Seat 9: jWDRpL0TJljg+mBCE9ZMqA ($21.15 in chips)
go0Ad6tqqJ4tR9/bqVlO0g: posts small blind $0.25
1q5EPoiflJRl8pqfnVLjMw: posts big blind $0.50
*** HOLE CARDS ***
sakr/FIfFtIZwDPmAj5Pzg: folds
jWDRpL0TJljg+mBCE9ZMqA: folds
gsyXT42WLEcOS4DdEk2wlw: folds
M+7+BTmX5vZatHVuoRB1nA: folds
uo2Sgpknd7NdeVbeSCG02A leaves the table
vacmVLJJECYI6HjAynFcpg: folds
YXCE3WOZi8g2sIf3y/plVw: raises $0.50 to $1
go0Ad6tqqJ4tR9/bqVlO0g: folds
1q5EPoiflJRl8pqfnVLjMw: folds
YXCE3WOZi8g2sIf3y/plVw collected $1.25 from pot
YXCE3WOZi8g2sIf3y/plVw: doesn't show hand
*** SUMMARY ***
Total pot $1.25 | Rake $0
Seat 1: gsyXT42WLEcOS4DdEk2wlw folded before Flop (didn't bet)
Seat 2: M+7+BTmX5vZatHVuoRB1nA folded before Flop (didn't bet)
Seat 3: vacmVLJJECYI6HjAynFcpg folded before Flop (didn't bet)
Seat 4: YXCE3WOZi8g2sIf3y/plVw (button) collected ($1.25)
Seat 6: go0Ad6tqqJ4tR9/bqVlO0g (small blind) folded before Flop
Seat 7: 1q5EPoiflJRl8pqfnVLjMw (big blind) folded before Flop
Seat 8: sakr/FIfFtIZwDPmAj5Pzg folded before Flop (didn't bet)
Seat 9: jWDRpL0TJljg+mBCE9ZMqA folded before Flop (didn't bet)



PokerStars Game #59941716132:  Hold'em No Limit ($0.25/$0.50) - 2009/07/01 1:43:54 ET
Table 'EiNh8p/wGJ1FP575iMFnqg' 9-max Seat #4 is the button
Seat 1: YFFlOZgyy1Mh4iBmuNRbmQ ($18.80 in chips)
Seat 2: GRV8J6o4lVSBDEyjt6BwMg ($27.50 in chips)
Seat 3: ymLPoEIl7UL3TvZYmnadxQ ($36.25 in chips)
Seat 4: cMzaiXAM/ZAdNaEUu+LqhA ($56.65 in chips)
Seat 5: M+7+BTmX5vZatHVuoRB1nA ($74.65 in chips)
Seat 6: bCRukyMhXa3jkgAkKFa4VQ ($10.30 in chips)
Seat 7: 997ViqAtWn1FPjJqcffwcA ($50 in chips)
Seat 8: mSD1pginDsyHG5PDfqzphw ($21 in chips)
Seat 9: GuPkZObrz5Zkkn8FsEdF9w ($33.85 in chips)
M+7+BTmX5vZatHVuoRB1nA: posts small blind $0.25
bCRukyMhXa3jkgAkKFa4VQ: posts big blind $0.50
*** HOLE CARDS ***
997ViqAtWn1FPjJqcffwcA: folds
997ViqAtWn1FPjJqcffwcA leaves the table
mSD1pginDsyHG5PDfqzphw: folds
GuPkZObrz5Zkkn8FsEdF9w: raises $1.50 to $2
YFFlOZgyy1Mh4iBmuNRbmQ: folds
GRV8J6o4lVSBDEyjt6BwMg: folds
ymLPoEIl7UL3TvZYmnadxQ: folds
cMzaiXAM/ZAdNaEUu+LqhA: folds
M+7+BTmX5vZatHVuoRB1nA: folds
bCRukyMhXa3jkgAkKFa4VQ: folds
GuPkZObrz5Zkkn8FsEdF9w collected $1.25 from pot
GuPkZObrz5Zkkn8FsEdF9w: doesn't show hand
*** SUMMARY ***
Total pot $1.25 | Rake $0
Seat 1: YFFlOZgyy1Mh4iBmuNRbmQ folded before Flop (didn't bet)
Seat 2: GRV8J6o4lVSBDEyjt6BwMg folded before Flop (didn't bet)
Seat 3: ymLPoEIl7UL3TvZYmnadxQ folded before Flop (didn't bet)
Seat 4: cMzaiXAM/ZAdNaEUu+LqhA (button) folded before Flop (didn't bet)
Seat 5: M+7+BTmX5vZatHVuoRB1nA (small blind) folded before Flop
Seat 6: bCRukyMhXa3jkgAkKFa4VQ (big blind) folded before Flop
Seat 7: 997ViqAtWn1FPjJqcffwcA folded before Flop (didn't bet)
Seat 8: mSD1pginDsyHG5PDfqzphw folded before Flop (didn't bet)
Seat 9: GuPkZObrz5Zkkn8FsEdF9w collected ($1.25)



