PokerStars Game #59940146398:  Hold'em No Limit ($0.25/$0.50) - 2009/07/01 0:58:31 ET
Table 'E7bWJ45aoFXRpyRv2gw+Ig' 2-max Seat #1 is the button
Seat 1: FRkiRasEGlHUeLrEl+k/nA ($66.70 in chips)
Seat 2: 3Wro85I7472vJ4Wkpneo9A ($124.10 in chips)
FRkiRasEGlHUeLrEl+k/nA: posts small blind $0.25
3Wro85I7472vJ4Wkpneo9A: posts big blind $0.50
*** HOLE CARDS ***
FRkiRasEGlHUeLrEl+k/nA: raises $1 to $1.50
3Wro85I7472vJ4Wkpneo9A: raises $3.50 to $5
FRkiRasEGlHUeLrEl+k/nA: calls $3.50
*** FLOP *** [8c Th 3d]
3Wro85I7472vJ4Wkpneo9A: bets $7
FRkiRasEGlHUeLrEl+k/nA: calls $7
*** TURN *** [8c Th 3d] [9h]
3Wro85I7472vJ4Wkpneo9A: checks
FRkiRasEGlHUeLrEl+k/nA: bets $14.50
3Wro85I7472vJ4Wkpneo9A: folds
FRkiRasEGlHUeLrEl+k/nA collected $23.50 from pot
FRkiRasEGlHUeLrEl+k/nA: doesn't show hand
*** SUMMARY ***
Total pot $24 | Rake $0.50
Board [8c Th 3d 9h]
Seat 1: FRkiRasEGlHUeLrEl+k/nA (button) (small blind) collected ($23.50)
Seat 2: 3Wro85I7472vJ4Wkpneo9A (big blind) folded on the Turn



PokerStars Game #59940146324:  Hold'em No Limit ($0.25/$0.50) - 2009/07/01 0:58:31 ET
Table 'ErOuyGLI5PT3G5MnpHgC/gQOgaEqMcJ73pcUMMxoisUg Seat #1 is the button
Seat 1: eBrej2jnlUCs/JgxFCRn2g ($40 in chips)
Seat 3: xZCXQSXlrZkp3pZizzVXCw ($51.75 in chips)
Seat 4: 3UmXLy3GfjC3EkOebduerQ ($50.45 in chips)
Seat 5: JwvquocWfhTVApN5t47LgA ($63.35 in chips)
Seat 6: zE9cVigS2nW/Ljy4K4bUQA ($31.60 in chips)
Seat 7: 90Wb75h3W1BRpbqVnuk8gw ($63.60 in chips)
Seat 8: g4k0NXISyLCqaSWZDBjfEg ($50 in chips)
Seat 9: J0W5D97jl5VLky+IoPvDeA ($51.40 in chips)
timbojjjones was removed from the table for failing to post
xZCXQSXlrZkp3pZizzVXCw: posts small blind $0.25
3UmXLy3GfjC3EkOebduerQ: posts big blind $0.50
*** HOLE CARDS ***
JwvquocWfhTVApN5t47LgA: folds
zE9cVigS2nW/Ljy4K4bUQA: folds
90Wb75h3W1BRpbqVnuk8gw: folds
g4k0NXISyLCqaSWZDBjfEg: folds
pciZn00ZDk4BVBMTTMcNVQ joins the table at seat #2
J0W5D97jl5VLky+IoPvDeA: raises $1.50 to $2
eBrej2jnlUCs/JgxFCRn2g: folds
xZCXQSXlrZkp3pZizzVXCw: folds
3UmXLy3GfjC3EkOebduerQ: folds
J0W5D97jl5VLky+IoPvDeA collected $1.25 from pot
*** SUMMARY ***
Total pot $1.25 | Rake $0
Seat 1: eBrej2jnlUCs/JgxFCRn2g (button) folded before Flop (didn't bet)
Seat 3: xZCXQSXlrZkp3pZizzVXCw (small blind) folded before Flop
Seat 4: 3UmXLy3GfjC3EkOebduerQ (big blind) folded before Flop
Seat 5: JwvquocWfhTVApN5t47LgA folded before Flop (didn't bet)
Seat 6: zE9cVigS2nW/Ljy4K4bUQA folded before Flop (didn't bet)
Seat 7: 90Wb75h3W1BRpbqVnuk8gw folded before Flop (didn't bet)
Seat 8: g4k0NXISyLCqaSWZDBjfEg folded before Flop (didn't bet)
Seat 9: J0W5D97jl5VLky+IoPvDeA collected ($1.25)



PokerStars Game #59940146840:  Hold'em No Limit ($0.25/$0.50) - 2009/07/01 0:58:32 ET
Table 'X6IRCRTh+20gjz8aubWnwA' 9-max Seat #4 is the button
Seat 1: DSM67hHHq1XFoEOi9p8Alw ($49.05 in chips)
Seat 2: HZkVla4kK2SI42CVrPZ/ig ($7.55 in chips)
Seat 3: SWv01peOe69QQRvhQTqjQw ($3.90 in chips)
Seat 4: M3JFBNQ8Bbw3FBZ/18MuXw ($14.45 in chips)
Seat 5: NnQCepdIR/AOUQn1yhYx6Q ($9.50 in chips)
Seat 6: 75K2MXwN65Sjfp1yHd50Hg ($10 in chips)
Seat 7: cFHQjKQOOKTUzoilhrXHLg ($49.15 in chips)
Seat 8: HxeBVq06/3Bh/H986sgdbw ($24 in chips)
Seat 9: M+7+BTmX5vZatHVuoRB1nA ($46.75 in chips)
NnQCepdIR/AOUQn1yhYx6Q: posts small blind $0.25
75K2MXwN65Sjfp1yHd50Hg: posts big blind $0.50
*** HOLE CARDS ***
cFHQjKQOOKTUzoilhrXHLg: calls $0.50
HxeBVq06/3Bh/H986sgdbw: folds
M+7+BTmX5vZatHVuoRB1nA: folds
DSM67hHHq1XFoEOi9p8Alw: folds
HZkVla4kK2SI42CVrPZ/ig: folds
SWv01peOe69QQRvhQTqjQw: calls $0.50
M3JFBNQ8Bbw3FBZ/18MuXw: folds
NnQCepdIR/AOUQn1yhYx6Q: folds
75K2MXwN65Sjfp1yHd50Hg: checks
*** FLOP *** [Ah 2h 2s]
75K2MXwN65Sjfp1yHd50Hg: checks
cFHQjKQOOKTUzoilhrXHLg: checks
SWv01peOe69QQRvhQTqjQw: bets $1
75K2MXwN65Sjfp1yHd50Hg: folds
cFHQjKQOOKTUzoilhrXHLg: calls $1
*** TURN *** [Ah 2h 2s] [Ac]
cFHQjKQOOKTUzoilhrXHLg: checks
SWv01peOe69QQRvhQTqjQw: bets $1
cFHQjKQOOKTUzoilhrXHLg: calls $1
*** RIVER *** [Ah 2h 2s Ac] [Jc]
cFHQjKQOOKTUzoilhrXHLg: checks
SWv01peOe69QQRvhQTqjQw: bets $1.40 and is all-in
cFHQjKQOOKTUzoilhrXHLg: calls $1.40
*** SHOW DOWN ***
SWv01peOe69QQRvhQTqjQw: shows [As Th] (a full house, Aces full of Deuces)
cFHQjKQOOKTUzoilhrXHLg: mucks hand
SWv01peOe69QQRvhQTqjQw collected $8.15 from pot
*** SUMMARY ***
Total pot $8.55 | Rake $0.40
Board [Ah 2h 2s Ac Jc]
Seat 1: DSM67hHHq1XFoEOi9p8Alw folded before Flop (didn't bet)
Seat 2: HZkVla4kK2SI42CVrPZ/ig folded before Flop (didn't bet)
Seat 3: SWv01peOe69QQRvhQTqjQw showed [As Th] and won ($8.15) with a full house, Aces full of Deuces
Seat 4: M3JFBNQ8Bbw3FBZ/18MuXw (button) folded before Flop (didn't bet)
Seat 5: NnQCepdIR/AOUQn1yhYx6Q (small blind) folded before Flop
Seat 6: 75K2MXwN65Sjfp1yHd50Hg (big blind) folded on the Flop
Seat 7: cFHQjKQOOKTUzoilhrXHLg mucked
Seat 8: HxeBVq06/3Bh/H986sgdbw folded before Flop (didn't bet)
Seat 9: M+7+BTmX5vZatHVuoRB1nA folded before Flop (didn't bet)



PokerStars Game #59940149478:  Hold'em No Limit ($0.25/$0.50) - 2009/07/01 0:58:36 ET
Table 'EiNh8p/wGJ1FP575iMFnqg' 9-max Seat #7 is the button
Seat 1: r3ZqM1Mi0W3y4hOdssE+Sg ($44.85 in chips)
Seat 2: 8ehL7qlZzjgUh2H35iiWLw ($52.60 in chips)
Seat 3: ymLPoEIl7UL3TvZYmnadxQ ($52.55 in chips)
Seat 4: cMzaiXAM/ZAdNaEUu+LqhA ($55.70 in chips)
Seat 5: M+7+BTmX5vZatHVuoRB1nA ($81.45 in chips)
Seat 6: 3UmXLy3GfjC3EkOebduerQ ($64.60 in chips)
Seat 7: 997ViqAtWn1FPjJqcffwcA ($50 in chips)
Seat 8: mSD1pginDsyHG5PDfqzphw ($10 in chips)
Seat 9: NnQCepdIR/AOUQn1yhYx6Q ($10.75 in chips)
mSD1pginDsyHG5PDfqzphw: posts small blind $0.25
NnQCepdIR/AOUQn1yhYx6Q: posts big blind $0.50
*** HOLE CARDS ***
r3ZqM1Mi0W3y4hOdssE+Sg has timed out
r3ZqM1Mi0W3y4hOdssE+Sg: folds
r3ZqM1Mi0W3y4hOdssE+Sg is sitting out
8ehL7qlZzjgUh2H35iiWLw: folds
ymLPoEIl7UL3TvZYmnadxQ: folds
cMzaiXAM/ZAdNaEUu+LqhA: folds
M+7+BTmX5vZatHVuoRB1nA: folds
3UmXLy3GfjC3EkOebduerQ: calls $0.50
997ViqAtWn1FPjJqcffwcA: calls $0.50
r3ZqM1Mi0W3y4hOdssE+Sg has returned
mSD1pginDsyHG5PDfqzphw: folds
NnQCepdIR/AOUQn1yhYx6Q: raises $10.25 to $10.75 and is all-in
3UmXLy3GfjC3EkOebduerQ: folds
997ViqAtWn1FPjJqcffwcA: folds
NnQCepdIR/AOUQn1yhYx6Q collected $1.75 from pot
*** SUMMARY ***
Total pot $1.75 | Rake $0
Seat 1: r3ZqM1Mi0W3y4hOdssE+Sg folded before Flop (didn't bet)
Seat 2: 8ehL7qlZzjgUh2H35iiWLw folded before Flop (didn't bet)
Seat 3: ymLPoEIl7UL3TvZYmnadxQ folded before Flop (didn't bet)
Seat 4: cMzaiXAM/ZAdNaEUu+LqhA folded before Flop (didn't bet)
Seat 5: M+7+BTmX5vZatHVuoRB1nA folded before Flop (didn't bet)
Seat 6: 3UmXLy3GfjC3EkOebduerQ folded before Flop
Seat 7: 997ViqAtWn1FPjJqcffwcA (button) folded before Flop
Seat 8: mSD1pginDsyHG5PDfqzphw (small blind) folded before Flop
Seat 9: NnQCepdIR/AOUQn1yhYx6Q (big blind) collected ($1.75)



PokerStars Game #59940150370:  Hold'em No Limit ($0.25/$0.50) - 2009/07/01 0:58:38 ET
Table 'lpxYasB1ClBSgTpCCITwhQ' 9-max Seat #8 is the button
Seat 1: mj7PS7wCH4PAl7+eYTFs7A ($46.40 in chips)
Seat 2: OWP/DOu+PlPK6ZZ3zYa0HA ($20.10 in chips)
Seat 4: NnQCepdIR/AOUQn1yhYx6Q ($9.25 in chips)
Seat 5: IYd5zG8k7vdBNVHbHg2Pag ($36.35 in chips)
Seat 6: SegjDnMxWMujiD57ESNL+g ($12.10 in chips)
Seat 7: bmRtaIYKthN1F+B3JLZ3Jw ($67.30 in chips)
Seat 8: /mfensKw8/iZ1Vrx33S4xg ($11.85 in chips)
Seat 9: XNMDwbXt/Q4jM99AXnbJDw ($50 in chips)
XNMDwbXt/Q4jM99AXnbJDw: posts small blind $0.25
mj7PS7wCH4PAl7+eYTFs7A: posts big blind $0.50
IVoxShuYD5lqbK8F9+jVsg: sits out
*** HOLE CARDS ***
OWP/DOu+PlPK6ZZ3zYa0HA: folds
NnQCepdIR/AOUQn1yhYx6Q: folds
IYd5zG8k7vdBNVHbHg2Pag: folds
SegjDnMxWMujiD57ESNL+g: folds
bmRtaIYKthN1F+B3JLZ3Jw: calls $0.50
/mfensKw8/iZ1Vrx33S4xg: folds
XNMDwbXt/Q4jM99AXnbJDw: folds
mj7PS7wCH4PAl7+eYTFs7A: checks
*** FLOP *** [7h 3c Jc]
XNMDwbXt/Q4jM99AXnbJDw leaves the table
mj7PS7wCH4PAl7+eYTFs7A: checks
bmRtaIYKthN1F+B3JLZ3Jw: checks
*** TURN *** [7h 3c Jc] [9s]
mj7PS7wCH4PAl7+eYTFs7A: checks
bmRtaIYKthN1F+B3JLZ3Jw: checks
*** RIVER *** [7h 3c Jc 9s] [9d]
mj7PS7wCH4PAl7+eYTFs7A: checks
bmRtaIYKthN1F+B3JLZ3Jw: checks
*** SHOW DOWN ***
mj7PS7wCH4PAl7+eYTFs7A: shows [Td 3h] (two pair, Nines and Threes)
bmRtaIYKthN1F+B3JLZ3Jw: shows [6d 6c] (two pair, Nines and Sixes)
bmRtaIYKthN1F+B3JLZ3Jw collected $1.20 from pot
*** SUMMARY ***
Total pot $1.25 | Rake $0.05
Board [7h 3c Jc 9s 9d]
Seat 1: mj7PS7wCH4PAl7+eYTFs7A (big blind) showed [Td 3h] and lost with two pair, Nines and Threes
Seat 2: OWP/DOu+PlPK6ZZ3zYa0HA folded before Flop (didn't bet)
Seat 4: NnQCepdIR/AOUQn1yhYx6Q folded before Flop (didn't bet)
Seat 5: IYd5zG8k7vdBNVHbHg2Pag folded before Flop (didn't bet)
Seat 6: SegjDnMxWMujiD57ESNL+g folded before Flop (didn't bet)
Seat 7: bmRtaIYKthN1F+B3JLZ3Jw showed [6d 6c] and won ($1.20) with two pair, Nines and Sixes
Seat 8: /mfensKw8/iZ1Vrx33S4xg (button) folded before Flop (didn't bet)
Seat 9: XNMDwbXt/Q4jM99AXnbJDw (small blind) folded before Flop



PokerStars Game #59940152232:  Hold'em No Limit ($0.25/$0.50) - 2009/07/01 0:58:41 ET
Table 'c/CRn+68J3Y8KxD5g1ek2Q' 2-max Seat #1 is the button
Seat 1: 46qCyJ6evTkHo9al5sBMNA ($90.70 in chips)
Seat 2: BypVLsYQt3ePFm2xQL/dOA ($278.25 in chips)
46qCyJ6evTkHo9al5sBMNA: posts small blind $0.25
BypVLsYQt3ePFm2xQL/dOA: posts big blind $0.50
*** HOLE CARDS ***
46qCyJ6evTkHo9al5sBMNA: raises $1.50 to $2
BypVLsYQt3ePFm2xQL/dOA: calls $1.50
*** FLOP *** [9h Ks Ac]
BypVLsYQt3ePFm2xQL/dOA: checks
46qCyJ6evTkHo9al5sBMNA: checks
*** TURN *** [9h Ks Ac] [6h]
BypVLsYQt3ePFm2xQL/dOA: checks
46qCyJ6evTkHo9al5sBMNA: bets $3
BypVLsYQt3ePFm2xQL/dOA: folds
46qCyJ6evTkHo9al5sBMNA collected $3.80 from pot
46qCyJ6evTkHo9al5sBMNA: doesn't show hand
*** SUMMARY ***
Total pot $4 | Rake $0.20
Board [9h Ks Ac 6h]
Seat 1: 46qCyJ6evTkHo9al5sBMNA (button) (small blind) collected ($3.80)
Seat 2: BypVLsYQt3ePFm2xQL/dOA (big blind) folded on the Turn



PokerStars Game #59940153562:  Hold'em No Limit ($0.25/$0.50) - 2009/07/01 0:58:43 ET
Table 'Nz0Vr7WMHL2g5Uk7dDZjpw' 9-max Seat #5 is the button
Seat 1: tLkxo7JgV+WWI0UBw44K5A ($109.85 in chips)
Seat 2: XNMDwbXt/Q4jM99AXnbJDw ($58.60 in chips)
Seat 3: uw9QayAAxLM3Hb+HR7mSkg ($10 in chips)
Seat 4: E2518gp4aFz1+kAgmGqeEg ($11.50 in chips)
Seat 5: WGW0DgjBUXs1ylURHG8vnQ ($26.75 in chips)
Seat 6: 997ViqAtWn1FPjJqcffwcA ($60.80 in chips)
Seat 7: KPLH0gELgFe2OuAnhJFI5w ($17.85 in chips)
Seat 8: HkZI6g4zl83TDTA7SRspmQ ($15.95 in chips)
Seat 9: mSD1pginDsyHG5PDfqzphw ($10 in chips)
997ViqAtWn1FPjJqcffwcA: posts small blind $0.25
KPLH0gELgFe2OuAnhJFI5w: posts big blind $0.50
*** HOLE CARDS ***
HkZI6g4zl83TDTA7SRspmQ: folds
mSD1pginDsyHG5PDfqzphw: folds
tLkxo7JgV+WWI0UBw44K5A: folds
XNMDwbXt/Q4jM99AXnbJDw: folds
XNMDwbXt/Q4jM99AXnbJDw leaves the table
uw9QayAAxLM3Hb+HR7mSkg: folds
E2518gp4aFz1+kAgmGqeEg: folds
WGW0DgjBUXs1ylURHG8vnQ: calls $0.50
997ViqAtWn1FPjJqcffwcA: folds
KPLH0gELgFe2OuAnhJFI5w: checks
*** FLOP *** [9c Qd 4h]
KPLH0gELgFe2OuAnhJFI5w: checks
gsyXT42WLEcOS4DdEk2wlw joins the table at seat #2
WGW0DgjBUXs1ylURHG8vnQ: bets $0.50
KPLH0gELgFe2OuAnhJFI5w: calls $0.50
*** TURN *** [9c Qd 4h] [5s]
KPLH0gELgFe2OuAnhJFI5w: checks
WGW0DgjBUXs1ylURHG8vnQ: bets $1
KPLH0gELgFe2OuAnhJFI5w: folds
WGW0DgjBUXs1ylURHG8vnQ collected $2.15 from pot
WGW0DgjBUXs1ylURHG8vnQ: doesn't show hand
*** SUMMARY ***
Total pot $2.25 | Rake $0.10
Board [9c Qd 4h 5s]
Seat 1: tLkxo7JgV+WWI0UBw44K5A folded before Flop (didn't bet)
Seat 2: XNMDwbXt/Q4jM99AXnbJDw folded before Flop (didn't bet)
Seat 3: uw9QayAAxLM3Hb+HR7mSkg folded before Flop (didn't bet)
Seat 4: E2518gp4aFz1+kAgmGqeEg folded before Flop (didn't bet)
Seat 5: WGW0DgjBUXs1ylURHG8vnQ (button) collected ($2.15)
Seat 6: 997ViqAtWn1FPjJqcffwcA (small blind) folded before Flop
Seat 7: KPLH0gELgFe2OuAnhJFI5w (big blind) folded on the Turn
Seat 8: HkZI6g4zl83TDTA7SRspmQ folded before Flop (didn't bet)
Seat 9: mSD1pginDsyHG5PDfqzphw folded before Flop (didn't bet)



PokerStars Game #59940153670:  Hold'em No Limit ($0.25/$0.50) - 2009/07/01 0:58:43 ET
Table 'otvGDROEDdqsabxskT79qg' 9-max Seat #9 is the button
Seat 1: 8ehL7qlZzjgUh2H35iiWLw ($57 in chips)
Seat 2: cCjTzH9jio8607WzjcfXlg ($14.30 in chips)
Seat 3: +k7T5ocke8UwavtgUHm+Cg ($67.20 in chips)
Seat 4: MG90wfSJZnOejs/KD3vlQQ ($73.95 in chips)
Seat 5: XNMDwbXt/Q4jM99AXnbJDw ($51.15 in chips)
Seat 6: bxLSulbgr8LmKNjOzw8URg ($53.70 in chips)
Seat 7: C7+tBppJrKgd/r+tuKUIpA ($32.05 in chips)
Seat 8: zE9cVigS2nW/Ljy4K4bUQA ($30 in chips)
Seat 9: KcY3X8YpD74Kw1RHkx/g4A ($57.15 in chips)
8ehL7qlZzjgUh2H35iiWLw: posts small blind $0.25
cCjTzH9jio8607WzjcfXlg: posts big blind $0.50
*** HOLE CARDS ***
+k7T5ocke8UwavtgUHm+Cg: raises $1.50 to $2
MG90wfSJZnOejs/KD3vlQQ: folds
XNMDwbXt/Q4jM99AXnbJDw: folds
bxLSulbgr8LmKNjOzw8URg: folds
C7+tBppJrKgd/r+tuKUIpA: folds
zE9cVigS2nW/Ljy4K4bUQA: folds
KcY3X8YpD74Kw1RHkx/g4A: calls $2
XNMDwbXt/Q4jM99AXnbJDw leaves the table
8ehL7qlZzjgUh2H35iiWLw: folds
cCjTzH9jio8607WzjcfXlg: folds
*** FLOP *** [9s Jd 6d]
+k7T5ocke8UwavtgUHm+Cg: checks
KcY3X8YpD74Kw1RHkx/g4A: checks
*** TURN *** [9s Jd 6d] [Js]
+k7T5ocke8UwavtgUHm+Cg: bets $1.50
KcY3X8YpD74Kw1RHkx/g4A: calls $1.50
*** RIVER *** [9s Jd 6d Js] [4s]
C7+tBppJrKgd/r+tuKUIpA leaves the table
E2518gp4aFz1+kAgmGqeEg joins the table at seat #5
+k7T5ocke8UwavtgUHm+Cg: bets $3
KcY3X8YpD74Kw1RHkx/g4A: folds
75K2MXwN65Sjfp1yHd50Hg joins the table at seat #7
+k7T5ocke8UwavtgUHm+Cg collected $7.40 from pot
+k7T5ocke8UwavtgUHm+Cg: doesn't show hand
*** SUMMARY ***
Total pot $7.75 | Rake $0.35
Board [9s Jd 6d Js 4s]
Seat 1: 8ehL7qlZzjgUh2H35iiWLw (small blind) folded before Flop
Seat 2: cCjTzH9jio8607WzjcfXlg (big blind) folded before Flop
Seat 3: +k7T5ocke8UwavtgUHm+Cg collected ($7.40)
Seat 4: MG90wfSJZnOejs/KD3vlQQ folded before Flop (didn't bet)
Seat 5: XNMDwbXt/Q4jM99AXnbJDw folded before Flop (didn't bet)
Seat 6: bxLSulbgr8LmKNjOzw8URg folded before Flop (didn't bet)
Seat 7: C7+tBppJrKgd/r+tuKUIpA folded before Flop (didn't bet)
Seat 8: zE9cVigS2nW/Ljy4K4bUQA folded before Flop (didn't bet)
Seat 9: KcY3X8YpD74Kw1RHkx/g4A (button) folded on the River



PokerStars Game #59940154414:  Hold'em No Limit ($0.25/$0.50) - 2009/07/01 0:58:44 ET
Table '0eJtgVAXVvBgncFdcUpXcQ' 2-max Seat #2 is the button
Seat 1: Ag6DvxX4vbRheqsv2zXKTQ ($30.80 in chips)
Seat 2: KMc4R+K9ao4Ur3rF7NGe6Q ($18.70 in chips)
KMc4R+K9ao4Ur3rF7NGe6Q: posts small blind $0.25
Ag6DvxX4vbRheqsv2zXKTQ: posts big blind $0.50
*** HOLE CARDS ***
KMc4R+K9ao4Ur3rF7NGe6Q: folds
Ag6DvxX4vbRheqsv2zXKTQ collected $0.50 from pot
*** SUMMARY ***
Total pot $0.50 | Rake $0
Seat 1: Ag6DvxX4vbRheqsv2zXKTQ (big blind) collected ($0.50)
Seat 2: KMc4R+K9ao4Ur3rF7NGe6Q (button) (small blind) folded before Flop



PokerStars Game #59940154480:  Hold'em No Limit ($0.25/$0.50) - 2009/07/01 0:58:44 ET
Table 'BCN5su+SsXiy1zRMJi0SJw' 6-max Seat #1 is the button
Seat 1: GxXV09ciXaOxyY2H5aMIIw ($29.65 in chips)
Seat 2: oU2kDCkT/gilYbHWrg7D8w ($30.70 in chips)
Seat 3: 6wzJiRvp8HY6t+MQGnSIzA ($30.35 in chips)
Seat 4: qfeUHOJpMYyzQcj0o2A7ng ($11.25 in chips)
Seat 5: IBNygaT1aa9Z1uPdJJilwA ($31.35 in chips)
Seat 6: b2symlOdL7+0c9Pj4N/KlA ($65 in chips)
oU2kDCkT/gilYbHWrg7D8w: posts small blind $0.25
6wzJiRvp8HY6t+MQGnSIzA: posts big blind $0.50
*** HOLE CARDS ***
qfeUHOJpMYyzQcj0o2A7ng: calls $0.50
IBNygaT1aa9Z1uPdJJilwA: calls $0.50
b2symlOdL7+0c9Pj4N/KlA: folds
GxXV09ciXaOxyY2H5aMIIw: folds
oU2kDCkT/gilYbHWrg7D8w: calls $0.25
6wzJiRvp8HY6t+MQGnSIzA: checks
*** FLOP *** [Jh 4c 2c]
oU2kDCkT/gilYbHWrg7D8w: bets $1
6wzJiRvp8HY6t+MQGnSIzA: calls $1
qfeUHOJpMYyzQcj0o2A7ng: folds
IBNygaT1aa9Z1uPdJJilwA: folds
*** TURN *** [Jh 4c 2c] [9c]
oU2kDCkT/gilYbHWrg7D8w: bets $1
6wzJiRvp8HY6t+MQGnSIzA: calls $1
*** RIVER *** [Jh 4c 2c 9c] [Kd]
oU2kDCkT/gilYbHWrg7D8w: bets $2
6wzJiRvp8HY6t+MQGnSIzA: calls $2
*** SHOW DOWN ***
oU2kDCkT/gilYbHWrg7D8w: shows [Ah Ad] (a pair of Aces)
6wzJiRvp8HY6t+MQGnSIzA: mucks hand
oU2kDCkT/gilYbHWrg7D8w collected $9.55 from pot
*** SUMMARY ***
Total pot $10 | Rake $0.45
Board [Jh 4c 2c 9c Kd]
Seat 1: GxXV09ciXaOxyY2H5aMIIw (button) folded before Flop (didn't bet)
Seat 2: oU2kDCkT/gilYbHWrg7D8w (small blind) showed [Ah Ad] and won ($9.55) with a pair of Aces
Seat 3: 6wzJiRvp8HY6t+MQGnSIzA (big blind) mucked
Seat 4: qfeUHOJpMYyzQcj0o2A7ng folded on the Flop
Seat 5: IBNygaT1aa9Z1uPdJJilwA folded on the Flop
Seat 6: b2symlOdL7+0c9Pj4N/KlA folded before Flop (didn't bet)



PokerStars Game #59940154214:  Hold'em No Limit ($0.25/$0.50) - 2009/07/01 0:58:44 ET
Table 'QOgaEqMcJ73pcUMMxoisUg' 6-max Seat #5 is the button
Seat 1: lxIzoHy0RnkfFSODHC2liw ($50 in chips)
Seat 2: 4QfsCWthT/vSLirorNXqtg ($76.35 in chips)
Seat 3: Rt6KgtZ8YaJoTc3FPim00w ($86.05 in chips)
Seat 4: zAcsDhG/T128Vn7XGVSgKg ($50 in chips)
Seat 5: 6vNxrjjCl6FwfaaymM9jjg ($26.25 in chips)
Seat 6: GoVjFxr3C+JO9vtJH9+IcA ($33.05 in chips)
GoVjFxr3C+JO9vtJH9+IcA: posts small blind $0.25
lxIzoHy0RnkfFSODHC2liw: posts big blind $0.50
*** HOLE CARDS ***
4QfsCWthT/vSLirorNXqtg: folds
Rt6KgtZ8YaJoTc3FPim00w: raises $1 to $1.50
zAcsDhG/T128Vn7XGVSgKg: folds
6vNxrjjCl6FwfaaymM9jjg: folds
GoVjFxr3C+JO9vtJH9+IcA: raises $1.50 to $3
lxIzoHy0RnkfFSODHC2liw: folds
Rt6KgtZ8YaJoTc3FPim00w: calls $1.50
*** FLOP *** [7c Qs 4c]
GoVjFxr3C+JO9vtJH9+IcA: bets $4
Rt6KgtZ8YaJoTc3FPim00w: calls $4
*** TURN *** [7c Qs 4c] [4s]
GoVjFxr3C+JO9vtJH9+IcA: bets $9.50
Rt6KgtZ8YaJoTc3FPim00w: raises $69.55 to $79.05 and is all-in
GoVjFxr3C+JO9vtJH9+IcA: calls $16.55 and is all-in
*** RIVER *** [7c Qs 4c 4s] [2d]
*** SHOW DOWN ***
GoVjFxr3C+JO9vtJH9+IcA: shows [Ac Ah] (two pair, Aces and Fours)
Rt6KgtZ8YaJoTc3FPim00w: mucks hand
GoVjFxr3C+JO9vtJH9+IcA collected $63.60 from pot
*** SUMMARY ***
Total pot $66.60 | Rake $3
Board [7c Qs 4c 4s 2d]
Seat 1: lxIzoHy0RnkfFSODHC2liw (big blind) folded before Flop
Seat 2: 4QfsCWthT/vSLirorNXqtg folded before Flop (didn't bet)
Seat 3: Rt6KgtZ8YaJoTc3FPim00w mucked
Seat 4: zAcsDhG/T128Vn7XGVSgKg folded before Flop (didn't bet)
Seat 5: 6vNxrjjCl6FwfaaymM9jjg (button) folded before Flop (didn't bet)
Seat 6: GoVjFxr3C+JO9vtJH9+IcA (small blind) showed [Ac Ah] and won ($63.60) with two pair, Aces and Fours



PokerStars Game #59940156356:  Hold'em No Limit ($0.25/$0.50) - 2009/07/01 0:58:47 ET
Table '5EmHi+fnatGQQShcNmzOZQ' 6-max Seat #4 is the button
Seat 1: My8WkRtGx5FW6rJ1I4R3hg ($10.60 in chips)
Seat 3: TjmTe3bhs9dFz5gXX9x7Lw ($26.65 in chips)
Seat 4: 1b+2BbjMN8qhR1WPqdE9VQ ($63.25 in chips)
Seat 5: kxPhs4ePFqMy52CInAJ2aw ($80.05 in chips)
Seat 6: 686aeHikcJlgKkSuIFdcXQ ($131.75 in chips)
kxPhs4ePFqMy52CInAJ2aw: posts small blind $0.25
686aeHikcJlgKkSuIFdcXQ: posts big blind $0.50
bfFjgAtIoAI+pUxUwFt3aQ: sits out
*** HOLE CARDS ***
My8WkRtGx5FW6rJ1I4R3hg: folds
TjmTe3bhs9dFz5gXX9x7Lw: folds
1b+2BbjMN8qhR1WPqdE9VQ: folds
kxPhs4ePFqMy52CInAJ2aw: folds
686aeHikcJlgKkSuIFdcXQ collected $0.50 from pot
*** SUMMARY ***
Total pot $0.50 | Rake $0
Seat 1: My8WkRtGx5FW6rJ1I4R3hg folded before Flop (didn't bet)
Seat 3: TjmTe3bhs9dFz5gXX9x7Lw folded before Flop (didn't bet)
Seat 4: 1b+2BbjMN8qhR1WPqdE9VQ (button) folded before Flop (didn't bet)
Seat 5: kxPhs4ePFqMy52CInAJ2aw (small blind) folded before Flop
Seat 6: 686aeHikcJlgKkSuIFdcXQ (big blind) collected ($0.50)



PokerStars Game #59940156800:  Hold'em No Limit ($0.25/$0.50) - 2009/07/01 0:58:48 ET
Table '8BQGgNetI1NOvWeu3gtMNw' 2-max Seat #2 is the button
Seat 1: bypIyrYcAAifLfhZpGlKLA ($50 in chips)
Seat 2: Z4HwehErEwzsv/noQlfUlg ($149.75 in chips)
Z4HwehErEwzsv/noQlfUlg: posts small blind $0.25
bypIyrYcAAifLfhZpGlKLA: posts big blind $0.50
*** HOLE CARDS ***
Z4HwehErEwzsv/noQlfUlg: raises $0.50 to $1
bypIyrYcAAifLfhZpGlKLA: raises $2 to $3
Z4HwehErEwzsv/noQlfUlg: calls $2
*** FLOP *** [5s Ts Qs]
bypIyrYcAAifLfhZpGlKLA: checks
Z4HwehErEwzsv/noQlfUlg: checks
*** TURN *** [5s Ts Qs] [2c]
bypIyrYcAAifLfhZpGlKLA: checks
Z4HwehErEwzsv/noQlfUlg: bets $3
bypIyrYcAAifLfhZpGlKLA: folds
Z4HwehErEwzsv/noQlfUlg collected $5.70 from pot
*** SUMMARY ***
Total pot $6 | Rake $0.30
Board [5s Ts Qs 2c]
Seat 1: bypIyrYcAAifLfhZpGlKLA (big blind) folded on the Turn
Seat 2: Z4HwehErEwzsv/noQlfUlg (button) (small blind) collected ($5.70)



PokerStars Game #59940157614:  Hold'em No Limit ($0.25/$0.50) - 2009/07/01 0:58:49 ET
Table '0eJtgVAXVvBgncFdcUpXcQ' 2-max Seat #1 is the button
Seat 1: Ag6DvxX4vbRheqsv2zXKTQ ($31.05 in chips)
Seat 2: KMc4R+K9ao4Ur3rF7NGe6Q ($18.45 in chips)
Ag6DvxX4vbRheqsv2zXKTQ: posts small blind $0.25
KMc4R+K9ao4Ur3rF7NGe6Q: posts big blind $0.50
*** HOLE CARDS ***
Ag6DvxX4vbRheqsv2zXKTQ: raises $1 to $1.50
KMc4R+K9ao4Ur3rF7NGe6Q: calls $1
*** FLOP *** [Kd 7h 5s]
KMc4R+K9ao4Ur3rF7NGe6Q: checks
Ag6DvxX4vbRheqsv2zXKTQ: bets $1
KMc4R+K9ao4Ur3rF7NGe6Q: raises $1 to $2
Ag6DvxX4vbRheqsv2zXKTQ: calls $1
*** TURN *** [Kd 7h 5s] [8h]
KMc4R+K9ao4Ur3rF7NGe6Q: checks
Ag6DvxX4vbRheqsv2zXKTQ: bets $1.50
KMc4R+K9ao4Ur3rF7NGe6Q: calls $1.50
*** RIVER *** [Kd 7h 5s 8h] [Jc]
KMc4R+K9ao4Ur3rF7NGe6Q: checks
Ag6DvxX4vbRheqsv2zXKTQ: bets $3
KMc4R+K9ao4Ur3rF7NGe6Q: folds
Ag6DvxX4vbRheqsv2zXKTQ collected $9.55 from pot
Ag6DvxX4vbRheqsv2zXKTQ: shows [8d 8c] (three of a kind, Eights)
*** SUMMARY ***
Total pot $10 | Rake $0.45
Board [Kd 7h 5s 8h Jc]
Seat 1: Ag6DvxX4vbRheqsv2zXKTQ (button) (small blind) collected ($9.55)
Seat 2: KMc4R+K9ao4Ur3rF7NGe6Q (big blind) folded on the River



PokerStars Game #59940157400:  Hold'em No Limit ($0.25/$0.50) - 2009/07/01 0:58:49 ET
Table '+dXkOAQyS8j9PQZusUTMpg' 2-max Seat #1 is the button
Seat 1: XFa6sBGjP2gxoIvxR3fZIg ($61.60 in chips)
Seat 2: 5IBeOgaApY1Bvzv2P8X4EA ($137.70 in chips)
XFa6sBGjP2gxoIvxR3fZIg: posts small blind $0.25
5IBeOgaApY1Bvzv2P8X4EA: posts big blind $0.50
*** HOLE CARDS ***
XFa6sBGjP2gxoIvxR3fZIg: raises $1 to $1.50
5IBeOgaApY1Bvzv2P8X4EA: calls $1
*** FLOP *** [As 6d 9h]
5IBeOgaApY1Bvzv2P8X4EA: checks
XFa6sBGjP2gxoIvxR3fZIg: checks
*** TURN *** [As 6d 9h] [Qs]
5IBeOgaApY1Bvzv2P8X4EA: bets $1
XFa6sBGjP2gxoIvxR3fZIg: calls $1
*** RIVER *** [As 6d 9h Qs] [4d]
5IBeOgaApY1Bvzv2P8X4EA: bets $2.50
XFa6sBGjP2gxoIvxR3fZIg: raises $9 to $11.50
5IBeOgaApY1Bvzv2P8X4EA: calls $9
*** SHOW DOWN ***
XFa6sBGjP2gxoIvxR3fZIg: shows [8c Ac] (a pair of Aces)
5IBeOgaApY1Bvzv2P8X4EA: shows [8d Ad] (a pair of Aces)
5IBeOgaApY1Bvzv2P8X4EA collected $13.75 from pot
XFa6sBGjP2gxoIvxR3fZIg collected $13.75 from pot
*** SUMMARY ***
Total pot $28 | Rake $0.50
Board [As 6d 9h Qs 4d]
Seat 1: XFa6sBGjP2gxoIvxR3fZIg (button) (small blind) showed [8c Ac] and won ($13.75) with a pair of Aces
Seat 2: 5IBeOgaApY1Bvzv2P8X4EA (big blind) showed [8d Ad] and won ($13.75) with a pair of Aces



PokerStars Game #59940158088:  Hold'em No Limit ($0.25/$0.50) - 2009/07/01 0:58:50 ET
Table 'hWT2kq66tnKEpD26cia6fQ' 2-max Seat #1 is the button
Seat 1: nDAH8M70KzyNYO9u3Jg+JQ ($39.85 in chips)
Seat 2: 16tvT7AYgZ2LgiGFcvFKQg ($5.50 in chips)
nDAH8M70KzyNYO9u3Jg+JQ: posts small blind $0.25
16tvT7AYgZ2LgiGFcvFKQg: posts big blind $0.50
*** HOLE CARDS ***
nDAH8M70KzyNYO9u3Jg+JQ: calls $0.25
16tvT7AYgZ2LgiGFcvFKQg: checks
*** FLOP *** [9s Th 8c]
16tvT7AYgZ2LgiGFcvFKQg: checks
nDAH8M70KzyNYO9u3Jg+JQ: bets $0.50
16tvT7AYgZ2LgiGFcvFKQg: calls $0.50
*** TURN *** [9s Th 8c] [Ah]
16tvT7AYgZ2LgiGFcvFKQg: checks
nDAH8M70KzyNYO9u3Jg+JQ: bets $0.50
16tvT7AYgZ2LgiGFcvFKQg: calls $0.50
*** RIVER *** [9s Th 8c Ah] [9c]
16tvT7AYgZ2LgiGFcvFKQg: checks
nDAH8M70KzyNYO9u3Jg+JQ: bets $2
16tvT7AYgZ2LgiGFcvFKQg: folds
nDAH8M70KzyNYO9u3Jg+JQ collected $2.90 from pot
nDAH8M70KzyNYO9u3Jg+JQ: doesn't show hand
*** SUMMARY ***
Total pot $3 | Rake $0.10
Board [9s Th 8c Ah 9c]
Seat 1: nDAH8M70KzyNYO9u3Jg+JQ (button) (small blind) collected ($2.90)
Seat 2: 16tvT7AYgZ2LgiGFcvFKQg (big blind) folded on the River



PokerStars Game #59940161490:  Hold'em No Limit ($0.25/$0.50) - 2009/07/01 0:58:56 ET
Table 'lSisgp6H7Fg1hH5VfjEjYQ' 9-max Seat #5 is the button
Seat 1: 5k9fvXD9suIgCxU4HLQjTw ($50 in chips)
Seat 2: UrcnkQOiLVk8BlKDPJSy7Q ($76.60 in chips)
Seat 3: aTkyjTh3w5YLWiIERupZOA ($51.95 in chips)
Seat 4: bwv/rbH/hHhPhY6u9mu04w ($31.60 in chips)
Seat 5: mSD1pginDsyHG5PDfqzphw ($10 in chips)
Seat 6: +k7T5ocke8UwavtgUHm+Cg ($66.55 in chips)
Seat 7: IDtNLR9uFCDdjNsJWMHA5Q ($19.85 in chips)
Seat 8: a4JDWmpFQkL10XfAyuF51A ($29 in chips)
Seat 9: gsyXT42WLEcOS4DdEk2wlw ($42.05 in chips)
+k7T5ocke8UwavtgUHm+Cg: posts small blind $0.25
IDtNLR9uFCDdjNsJWMHA5Q: posts big blind $0.50
*** HOLE CARDS ***
a4JDWmpFQkL10XfAyuF51A: folds
gsyXT42WLEcOS4DdEk2wlw: folds
gsyXT42WLEcOS4DdEk2wlw leaves the table
5k9fvXD9suIgCxU4HLQjTw: folds
UrcnkQOiLVk8BlKDPJSy7Q: folds
aTkyjTh3w5YLWiIERupZOA: folds
bwv/rbH/hHhPhY6u9mu04w: folds
mSD1pginDsyHG5PDfqzphw: folds
+k7T5ocke8UwavtgUHm+Cg: raises $1.50 to $2
IDtNLR9uFCDdjNsJWMHA5Q: folds
+k7T5ocke8UwavtgUHm+Cg collected $1 from pot
+k7T5ocke8UwavtgUHm+Cg: doesn't show hand
*** SUMMARY ***
Total pot $1 | Rake $0
Seat 1: 5k9fvXD9suIgCxU4HLQjTw folded before Flop (didn't bet)
Seat 2: UrcnkQOiLVk8BlKDPJSy7Q folded before Flop (didn't bet)
Seat 3: aTkyjTh3w5YLWiIERupZOA folded before Flop (didn't bet)
Seat 4: bwv/rbH/hHhPhY6u9mu04w folded before Flop (didn't bet)
Seat 5: mSD1pginDsyHG5PDfqzphw (button) folded before Flop (didn't bet)
Seat 6: +k7T5ocke8UwavtgUHm+Cg (small blind) collected ($1)
Seat 7: IDtNLR9uFCDdjNsJWMHA5Q (big blind) folded before Flop
Seat 8: a4JDWmpFQkL10XfAyuF51A folded before Flop (didn't bet)
Seat 9: gsyXT42WLEcOS4DdEk2wlw folded before Flop (didn't bet)



PokerStars Game #59940162150:  Hold'em No Limit ($0.25/$0.50) - 2009/07/01 0:58:57 ET
Table '/cQuAT3ef4t+PGrXiNhGaQ' 9-max Seat #6 is the button
Seat 1: HZkVla4kK2SI42CVrPZ/ig ($15 in chips)
Seat 2: jXGruyaMqirTaTXNOvBdew ($71.95 in chips)
Seat 3: g4k0NXISyLCqaSWZDBjfEg ($55.75 in chips)
Seat 4: OWP/DOu+PlPK6ZZ3zYa0HA ($25.90 in chips)
Seat 5: 5SgaHdWixdClWvaEG+KUjQ ($12.10 in chips)
Seat 6: APYIOyK/4AGb+kIwlOUNBQ ($36.50 in chips)
Seat 7: J0W5D97jl5VLky+IoPvDeA ($110.90 in chips)
Seat 8: eBrej2jnlUCs/JgxFCRn2g ($52.55 in chips)
Seat 9: AjV5McH1KMMclY26QdLM5w ($26.45 in chips)
J0W5D97jl5VLky+IoPvDeA: posts small blind $0.25
eBrej2jnlUCs/JgxFCRn2g: posts big blind $0.50
*** HOLE CARDS ***
AjV5McH1KMMclY26QdLM5w: folds
HZkVla4kK2SI42CVrPZ/ig: folds
jXGruyaMqirTaTXNOvBdew: folds
g4k0NXISyLCqaSWZDBjfEg: raises $1 to $1.50
OWP/DOu+PlPK6ZZ3zYa0HA: calls $1.50
5SgaHdWixdClWvaEG+KUjQ: raises $10.60 to $12.10 and is all-in
APYIOyK/4AGb+kIwlOUNBQ: folds
J0W5D97jl5VLky+IoPvDeA: folds
eBrej2jnlUCs/JgxFCRn2g: folds
g4k0NXISyLCqaSWZDBjfEg: folds
OWP/DOu+PlPK6ZZ3zYa0HA: folds
5SgaHdWixdClWvaEG+KUjQ collected $5.25 from pot
*** SUMMARY ***
Total pot $5.25 | Rake $0
Seat 1: HZkVla4kK2SI42CVrPZ/ig folded before Flop (didn't bet)
Seat 2: jXGruyaMqirTaTXNOvBdew folded before Flop (didn't bet)
Seat 3: g4k0NXISyLCqaSWZDBjfEg folded before Flop
Seat 4: OWP/DOu+PlPK6ZZ3zYa0HA folded before Flop
Seat 5: 5SgaHdWixdClWvaEG+KUjQ collected ($5.25)
Seat 6: APYIOyK/4AGb+kIwlOUNBQ (button) folded before Flop (didn't bet)
Seat 7: J0W5D97jl5VLky+IoPvDeA (small blind) folded before Flop
Seat 8: eBrej2jnlUCs/JgxFCRn2g (big blind) folded before Flop
Seat 9: AjV5McH1KMMclY26QdLM5w folded before Flop (didn't bet)



PokerStars Game #59940163056:  Hold'em No Limit ($0.25/$0.50) - 2009/07/01 0:58:58 ET
Table '9Puy2HWN1RQe5SSjq162gA' 2-max Seat #1 is the button
Seat 1: Fp/oksNpipCrD2MJ2pH20g ($10 in chips)
Seat 2: tDV+zhxH9+3DkJDzoTERyg ($28.30 in chips)
Fp/oksNpipCrD2MJ2pH20g: posts small blind $0.25
tDV+zhxH9+3DkJDzoTERyg: posts big blind $0.50
*** HOLE CARDS ***
Fp/oksNpipCrD2MJ2pH20g: raises $0.50 to $1
tDV+zhxH9+3DkJDzoTERyg: calls $0.50
*** FLOP *** [7d 6d Qd]
tDV+zhxH9+3DkJDzoTERyg: checks
Fp/oksNpipCrD2MJ2pH20g: bets $1.50
tDV+zhxH9+3DkJDzoTERyg: folds
Fp/oksNpipCrD2MJ2pH20g collected $1.90 from pot
Fp/oksNpipCrD2MJ2pH20g: doesn't show hand
*** SUMMARY ***
Total pot $2 | Rake $0.10
Board [7d 6d Qd]
Seat 1: Fp/oksNpipCrD2MJ2pH20g (button) (small blind) collected ($1.90)
Seat 2: tDV+zhxH9+3DkJDzoTERyg (big blind) folded on the Flop



PokerStars Game #59940164466:  Hold'em No Limit ($0.25/$0.50) - 2009/07/01 0:59:01 ET
Table 'E7bWJ45aoFXRpyRv2gw+Ig' 2-max Seat #2 is the button
Seat 1: FRkiRasEGlHUeLrEl+k/nA ($78.20 in chips)
Seat 2: 3Wro85I7472vJ4Wkpneo9A ($112.10 in chips)
3Wro85I7472vJ4Wkpneo9A: posts small blind $0.25
FRkiRasEGlHUeLrEl+k/nA: posts big blind $0.50
*** HOLE CARDS ***
3Wro85I7472vJ4Wkpneo9A: calls $0.25
FRkiRasEGlHUeLrEl+k/nA: checks
*** FLOP *** [5c 7s 3s]
FRkiRasEGlHUeLrEl+k/nA: bets $1
3Wro85I7472vJ4Wkpneo9A: calls $1
*** TURN *** [5c 7s 3s] [4s]
FRkiRasEGlHUeLrEl+k/nA: checks
3Wro85I7472vJ4Wkpneo9A: bets $2
FRkiRasEGlHUeLrEl+k/nA: folds
3Wro85I7472vJ4Wkpneo9A collected $2.90 from pot
3Wro85I7472vJ4Wkpneo9A: doesn't show hand
*** SUMMARY ***
Total pot $3 | Rake $0.10
Board [5c 7s 3s 4s]
Seat 1: FRkiRasEGlHUeLrEl+k/nA (big blind) folded on the Turn
Seat 2: 3Wro85I7472vJ4Wkpneo9A (button) (small blind) collected ($2.90)



PokerStars Game #59940167854:  Hold'em No Limit ($0.25/$0.50) - 2009/07/01 0:59:06 ET
Table 'ErOuyGLI5PT3G5MnpHgC/gQOgaEqMcJ73pcUMMxoisUg Seat #3 is the button
Seat 1: eBrej2jnlUCs/JgxFCRn2g ($40 in chips)
Seat 2: pciZn00ZDk4BVBMTTMcNVQ ($30 in chips)
Seat 3: xZCXQSXlrZkp3pZizzVXCw ($51.50 in chips)
Seat 4: 3UmXLy3GfjC3EkOebduerQ ($50 in chips)
Seat 5: JwvquocWfhTVApN5t47LgA ($63.35 in chips)
Seat 6: zE9cVigS2nW/Ljy4K4bUQA ($31.60 in chips)
Seat 7: 90Wb75h3W1BRpbqVnuk8gw ($63.60 in chips)
Seat 8: g4k0NXISyLCqaSWZDBjfEg ($50 in chips)
Seat 9: J0W5D97jl5VLky+IoPvDeA ($52.15 in chips)
3UmXLy3GfjC3EkOebduerQ: posts small blind $0.25
JwvquocWfhTVApN5t47LgA: posts big blind $0.50
pciZn00ZDk4BVBMTTMcNVQ: posts big blind $0.50
*** HOLE CARDS ***
zE9cVigS2nW/Ljy4K4bUQA: folds
90Wb75h3W1BRpbqVnuk8gw: folds
g4k0NXISyLCqaSWZDBjfEg: folds
J0W5D97jl5VLky+IoPvDeA: folds
eBrej2jnlUCs/JgxFCRn2g: folds
pciZn00ZDk4BVBMTTMcNVQ: checks
xZCXQSXlrZkp3pZizzVXCw: raises $2 to $2.50
3UmXLy3GfjC3EkOebduerQ: folds
JwvquocWfhTVApN5t47LgA: folds
pciZn00ZDk4BVBMTTMcNVQ: folds
xZCXQSXlrZkp3pZizzVXCw collected $1.75 from pot
*** SUMMARY ***
Total pot $1.75 | Rake $0
Seat 1: eBrej2jnlUCs/JgxFCRn2g folded before Flop (didn't bet)
Seat 2: pciZn00ZDk4BVBMTTMcNVQ folded before Flop
Seat 3: xZCXQSXlrZkp3pZizzVXCw (button) collected ($1.75)
Seat 4: 3UmXLy3GfjC3EkOebduerQ (small blind) folded before Flop
Seat 5: JwvquocWfhTVApN5t47LgA (big blind) folded before Flop
Seat 6: zE9cVigS2nW/Ljy4K4bUQA folded before Flop (didn't bet)
Seat 7: 90Wb75h3W1BRpbqVnuk8gw folded before Flop (didn't bet)
Seat 8: g4k0NXISyLCqaSWZDBjfEg folded before Flop (didn't bet)
Seat 9: J0W5D97jl5VLky+IoPvDeA folded before Flop (didn't bet)



PokerStars Game #59940168958:  Hold'em No Limit ($0.25/$0.50) - 2009/07/01 0:59:08 ET
Table 'c/CRn+68J3Y8KxD5g1ek2Q' 2-max Seat #2 is the button
Seat 1: 46qCyJ6evTkHo9al5sBMNA ($92.50 in chips)
Seat 2: BypVLsYQt3ePFm2xQL/dOA ($276.25 in chips)
BypVLsYQt3ePFm2xQL/dOA: posts small blind $0.25
46qCyJ6evTkHo9al5sBMNA: posts big blind $0.50
*** HOLE CARDS ***
BypVLsYQt3ePFm2xQL/dOA: calls $0.25
46qCyJ6evTkHo9al5sBMNA: checks
*** FLOP *** [Ts Jd 4c]
46qCyJ6evTkHo9al5sBMNA: checks
BypVLsYQt3ePFm2xQL/dOA: checks
*** TURN *** [Ts Jd 4c] [6c]
46qCyJ6evTkHo9al5sBMNA: checks
BypVLsYQt3ePFm2xQL/dOA: checks
*** RIVER *** [Ts Jd 4c 6c] [Qh]
46qCyJ6evTkHo9al5sBMNA: checks
BypVLsYQt3ePFm2xQL/dOA: bets $4.50
46qCyJ6evTkHo9al5sBMNA: folds
BypVLsYQt3ePFm2xQL/dOA collected $0.95 from pot
BypVLsYQt3ePFm2xQL/dOA: doesn't show hand
*** SUMMARY ***
Total pot $1 | Rake $0.05
Board [Ts Jd 4c 6c Qh]
Seat 1: 46qCyJ6evTkHo9al5sBMNA (big blind) folded on the River
Seat 2: BypVLsYQt3ePFm2xQL/dOA (button) (small blind) collected ($0.95)



PokerStars Game #59940170606:  Hold'em No Limit ($0.25/$0.50) - 2009/07/01 0:59:10 ET
Table 'fx6MqwfYAj/Rt86hBz2L3Q' 9-max Seat #3 is the button
Seat 2: C3rGXblctNcWI6JYPHhaEg ($28.60 in chips)
Seat 3: iadBi5AEt7gTBXbDSSnMYQ ($80.75 in chips)
Seat 4: 75K2MXwN65Sjfp1yHd50Hg ($9.50 in chips)
Seat 5: iAISe3dVeua8PUn2wwgDHw ($30.50 in chips)
Seat 6: 5k9fvXD9suIgCxU4HLQjTw ($50 in chips)
Seat 7: SKnJuWHScqetA/qG5p+wCg ($30 in chips)
Seat 8: JYwJYYV9pM5KWdSiETl8rA ($24 in chips)
Seat 9: HZkVla4kK2SI42CVrPZ/ig ($10.25 in chips)
75K2MXwN65Sjfp1yHd50Hg: posts small blind $0.25
iAISe3dVeua8PUn2wwgDHw: posts big blind $0.50
*** HOLE CARDS ***
5k9fvXD9suIgCxU4HLQjTw: folds
SKnJuWHScqetA/qG5p+wCg: folds
SegjDnMxWMujiD57ESNL+g said, "lol"
JYwJYYV9pM5KWdSiETl8rA: raises $1.50 to $2
HZkVla4kK2SI42CVrPZ/ig: folds
C3rGXblctNcWI6JYPHhaEg: folds
iadBi5AEt7gTBXbDSSnMYQ: calls $2
75K2MXwN65Sjfp1yHd50Hg: folds
iAISe3dVeua8PUn2wwgDHw: calls $1.50
*** FLOP *** [9h 7s Jd]
iAISe3dVeua8PUn2wwgDHw: checks
SegjDnMxWMujiD57ESNL+g leaves the table
JYwJYYV9pM5KWdSiETl8rA: checks
iadBi5AEt7gTBXbDSSnMYQ: bets $2.50
iAISe3dVeua8PUn2wwgDHw: calls $2.50
JYwJYYV9pM5KWdSiETl8rA: folds
*** TURN *** [9h 7s Jd] [4h]
uw9QayAAxLM3Hb+HR7mSkg joins the table at seat #1
iAISe3dVeua8PUn2wwgDHw: checks
iadBi5AEt7gTBXbDSSnMYQ: bets $4
iAISe3dVeua8PUn2wwgDHw: folds
iadBi5AEt7gTBXbDSSnMYQ collected $10.75 from pot
*** SUMMARY ***
Total pot $11.25 | Rake $0.50
Board [9h 7s Jd 4h]
Seat 2: C3rGXblctNcWI6JYPHhaEg folded before Flop (didn't bet)
Seat 3: iadBi5AEt7gTBXbDSSnMYQ (button) collected ($10.75)
Seat 4: 75K2MXwN65Sjfp1yHd50Hg (small blind) folded before Flop
Seat 5: iAISe3dVeua8PUn2wwgDHw (big blind) folded on the Turn
Seat 6: 5k9fvXD9suIgCxU4HLQjTw folded before Flop (didn't bet)
Seat 7: SKnJuWHScqetA/qG5p+wCg folded before Flop (didn't bet)
Seat 8: JYwJYYV9pM5KWdSiETl8rA folded on the Flop
Seat 9: HZkVla4kK2SI42CVrPZ/ig folded before Flop (didn't bet)



PokerStars Game #59940170672:  Hold'em No Limit ($0.25/$0.50) - 2009/07/01 0:59:11 ET
Table 'GfL/No5u5PoEnU39lP5pQg' 6-max Seat #3 is the button
Seat 1: 1WUCqNG+p+vfWRTXNu4ljw ($50 in chips)
Seat 2: uVwggSetzp7d+eVgowO3vg ($59.50 in chips)
Seat 3: eQXFICMuu3hw6XlcmuVNEA ($14.05 in chips)
Seat 4: r6u7MWSXF30/khcTYkrG9Q ($29.95 in chips)
Seat 5: M1KyQQvVPVuxqTAB8sR/zQ ($51.50 in chips)
Seat 6: kxPhs4ePFqMy52CInAJ2aw ($56.50 in chips)
r6u7MWSXF30/khcTYkrG9Q: posts small blind $0.25
M1KyQQvVPVuxqTAB8sR/zQ: posts big blind $0.50
*** HOLE CARDS ***
kxPhs4ePFqMy52CInAJ2aw: folds
r6u7MWSXF30/khcTYkrG9Q said, "3 hosed me"
1WUCqNG+p+vfWRTXNu4ljw: folds
uVwggSetzp7d+eVgowO3vg: calls $0.50
eQXFICMuu3hw6XlcmuVNEA: folds
r6u7MWSXF30/khcTYkrG9Q: raises $2 to $2.50
M1KyQQvVPVuxqTAB8sR/zQ: folds
uVwggSetzp7d+eVgowO3vg: calls $2
*** FLOP *** [5d Qd 9c]
r6u7MWSXF30/khcTYkrG9Q: checks
uVwggSetzp7d+eVgowO3vg: checks
*** TURN *** [5d Qd 9c] [2h]
r6u7MWSXF30/khcTYkrG9Q: checks
uVwggSetzp7d+eVgowO3vg: checks
*** RIVER *** [5d Qd 9c 2h] [Js]
r6u7MWSXF30/khcTYkrG9Q: checks
uVwggSetzp7d+eVgowO3vg: checks
*** SHOW DOWN ***
r6u7MWSXF30/khcTYkrG9Q: shows [Ks Ac] (high card Ace)
uVwggSetzp7d+eVgowO3vg: mucks hand
r6u7MWSXF30/khcTYkrG9Q collected $5.25 from pot
*** SUMMARY ***
Total pot $5.50 | Rake $0.25
Board [5d Qd 9c 2h Js]
Seat 1: 1WUCqNG+p+vfWRTXNu4ljw folded before Flop (didn't bet)
Seat 2: uVwggSetzp7d+eVgowO3vg mucked
Seat 3: eQXFICMuu3hw6XlcmuVNEA (button) folded before Flop (didn't bet)
Seat 4: r6u7MWSXF30/khcTYkrG9Q (small blind) showed [Ks Ac] and won ($5.25) with high card Ace
Seat 5: M1KyQQvVPVuxqTAB8sR/zQ (big blind) folded before Flop
Seat 6: kxPhs4ePFqMy52CInAJ2aw folded before Flop (didn't bet)



PokerStars Game #59940171300:  Hold'em No Limit ($0.25/$0.50) - 2009/07/01 0:59:12 ET
Table 'E7bWJ45aoFXRpyRv2gw+Ig99gCy/CZQwPIjZWH+BguQgeat #3 is the button
Seat 2: n6VQBu6crjYjy6DxNP1NZA ($28 in chips)
Seat 3: qEn9ijNGtuyTxamBf07hYg ($50 in chips)
Seat 4: bxLSulbgr8LmKNjOzw8URg ($62.45 in chips)
Seat 6: OcnLOMVFdy23jXnoTyaO5Q ($266.40 in chips)
Seat 7: bfSq6LBw0UvxeM5yfuWC7w ($17.85 in chips)
Seat 8: 8ehL7qlZzjgUh2H35iiWLw ($51.75 in chips)
Seat 9: j3K/Jujr7PY4ZM2RZvlH6A ($77.45 in chips)
bxLSulbgr8LmKNjOzw8URg: posts small blind $0.25
DSM67hHHq1XFoEOi9p8Alw: is sitting out
OcnLOMVFdy23jXnoTyaO5Q: posts big blind $0.50
*** HOLE CARDS ***
bfSq6LBw0UvxeM5yfuWC7w: folds
DSM67hHHq1XFoEOi9p8Alw leaves the table
8ehL7qlZzjgUh2H35iiWLw: folds
j3K/Jujr7PY4ZM2RZvlH6A: folds
n6VQBu6crjYjy6DxNP1NZA: raises $1.50 to $2
qEn9ijNGtuyTxamBf07hYg: folds
bxLSulbgr8LmKNjOzw8URg: folds
OcnLOMVFdy23jXnoTyaO5Q: folds
n6VQBu6crjYjy6DxNP1NZA collected $1.25 from pot
n6VQBu6crjYjy6DxNP1NZA: doesn't show hand
*** SUMMARY ***
Total pot $1.25 | Rake $0
Seat 2: n6VQBu6crjYjy6DxNP1NZA collected ($1.25)
Seat 3: qEn9ijNGtuyTxamBf07hYg (button) folded before Flop (didn't bet)
Seat 4: bxLSulbgr8LmKNjOzw8URg (small blind) folded before Flop
Seat 6: OcnLOMVFdy23jXnoTyaO5Q (big blind) folded before Flop
Seat 7: bfSq6LBw0UvxeM5yfuWC7w folded before Flop (didn't bet)
Seat 8: 8ehL7qlZzjgUh2H35iiWLw folded before Flop (didn't bet)
Seat 9: j3K/Jujr7PY4ZM2RZvlH6A folded before Flop (didn't bet)



PokerStars Game #59940172292:  Hold'em No Limit ($0.25/$0.50) - 2009/07/01 0:59:13 ET
Table 'hWT2kq66tnKEpD26cia6fQ' 2-max Seat #2 is the button
Seat 1: nDAH8M70KzyNYO9u3Jg+JQ ($41.25 in chips)
Seat 2: 16tvT7AYgZ2LgiGFcvFKQg ($4 in chips)
16tvT7AYgZ2LgiGFcvFKQg: posts small blind $0.25
nDAH8M70KzyNYO9u3Jg+JQ: posts big blind $0.50
*** HOLE CARDS ***
16tvT7AYgZ2LgiGFcvFKQg: folds
nDAH8M70KzyNYO9u3Jg+JQ collected $0.50 from pot
nDAH8M70KzyNYO9u3Jg+JQ: doesn't show hand
*** SUMMARY ***
Total pot $0.50 | Rake $0
Seat 1: nDAH8M70KzyNYO9u3Jg+JQ (big blind) collected ($0.50)
Seat 2: 16tvT7AYgZ2LgiGFcvFKQg (button) (small blind) folded before Flop



PokerStars Game #59940171766:  Hold'em No Limit ($0.25/$0.50) - 2009/07/01 0:59:13 ET
Table '5EmHi+fnatGQQShcNmzOZQ' 6-max Seat #5 is the button
Seat 1: My8WkRtGx5FW6rJ1I4R3hg ($10.60 in chips)
Seat 3: TjmTe3bhs9dFz5gXX9x7Lw ($26.65 in chips)
Seat 4: 1b+2BbjMN8qhR1WPqdE9VQ ($63.25 in chips)
Seat 5: kxPhs4ePFqMy52CInAJ2aw ($79.80 in chips)
Seat 6: 686aeHikcJlgKkSuIFdcXQ ($132 in chips)
686aeHikcJlgKkSuIFdcXQ: posts small blind $0.25
My8WkRtGx5FW6rJ1I4R3hg: posts big blind $0.50
bfFjgAtIoAI+pUxUwFt3aQ: sits out
*** HOLE CARDS ***
TjmTe3bhs9dFz5gXX9x7Lw: calls $0.50
1b+2BbjMN8qhR1WPqdE9VQ: folds
kxPhs4ePFqMy52CInAJ2aw: raises $2 to $2.50
686aeHikcJlgKkSuIFdcXQ: folds
My8WkRtGx5FW6rJ1I4R3hg: folds
TjmTe3bhs9dFz5gXX9x7Lw: calls $2
*** FLOP *** [5h 4d Kh]
TjmTe3bhs9dFz5gXX9x7Lw: checks
kxPhs4ePFqMy52CInAJ2aw: bets $4.50
TjmTe3bhs9dFz5gXX9x7Lw: folds
kxPhs4ePFqMy52CInAJ2aw collected $5.50 from pot
kxPhs4ePFqMy52CInAJ2aw: doesn't show hand
*** SUMMARY ***
Total pot $5.75 | Rake $0.25
Board [5h 4d Kh]
Seat 1: My8WkRtGx5FW6rJ1I4R3hg (big blind) folded before Flop
Seat 3: TjmTe3bhs9dFz5gXX9x7Lw folded on the Flop
Seat 4: 1b+2BbjMN8qhR1WPqdE9VQ folded before Flop (didn't bet)
Seat 5: kxPhs4ePFqMy52CInAJ2aw (button) collected ($5.50)
Seat 6: 686aeHikcJlgKkSuIFdcXQ (small blind) folded before Flop



PokerStars Game #59940172782:  Hold'em No Limit ($0.25/$0.50) - 2009/07/01 0:59:14 ET
Table '0eJtgVAXVvBgncFdcUpXcQ' 2-max Seat #2 is the button
Seat 1: Ag6DvxX4vbRheqsv2zXKTQ ($35.60 in chips)
Seat 2: KMc4R+K9ao4Ur3rF7NGe6Q ($13.45 in chips)
KMc4R+K9ao4Ur3rF7NGe6Q: posts small blind $0.25
Ag6DvxX4vbRheqsv2zXKTQ: posts big blind $0.50
*** HOLE CARDS ***
KMc4R+K9ao4Ur3rF7NGe6Q: calls $0.25
Ag6DvxX4vbRheqsv2zXKTQ: checks
*** FLOP *** [As Td Kc]
Ag6DvxX4vbRheqsv2zXKTQ: checks
KMc4R+K9ao4Ur3rF7NGe6Q: checks
*** TURN *** [As Td Kc] [2h]
Ag6DvxX4vbRheqsv2zXKTQ: checks
KMc4R+K9ao4Ur3rF7NGe6Q: checks
*** RIVER *** [As Td Kc 2h] [2d]
Ag6DvxX4vbRheqsv2zXKTQ: checks
KMc4R+K9ao4Ur3rF7NGe6Q: checks
*** SHOW DOWN ***
Ag6DvxX4vbRheqsv2zXKTQ: shows [7h Js] (a pair of Deuces)
KMc4R+K9ao4Ur3rF7NGe6Q: shows [4c Jd] (a pair of Deuces)
Ag6DvxX4vbRheqsv2zXKTQ collected $0.50 from pot
KMc4R+K9ao4Ur3rF7NGe6Q collected $0.45 from pot
*** SUMMARY ***
Total pot $1 | Rake $0.05
Board [As Td Kc 2h 2d]
Seat 1: Ag6DvxX4vbRheqsv2zXKTQ (big blind) showed [7h Js] and won ($0.50) with a pair of Deuces
Seat 2: KMc4R+K9ao4Ur3rF7NGe6Q (button) (small blind) showed [4c Jd] and won ($0.45) with a pair of Deuces



PokerStars Game #59940172570:  Hold'em No Limit ($0.25/$0.50) - 2009/07/01 0:59:14 ET
Table '9Puy2HWN1RQe5SSjq162gA' 2-max Seat #2 is the button
Seat 1: Fp/oksNpipCrD2MJ2pH20g ($10.90 in chips)
Seat 2: tDV+zhxH9+3DkJDzoTERyg ($27.30 in chips)
tDV+zhxH9+3DkJDzoTERyg: posts small blind $0.25
Fp/oksNpipCrD2MJ2pH20g: posts big blind $0.50
*** HOLE CARDS ***
tDV+zhxH9+3DkJDzoTERyg: calls $0.25
Fp/oksNpipCrD2MJ2pH20g: raises $0.50 to $1
tDV+zhxH9+3DkJDzoTERyg: calls $0.50
*** FLOP *** [9c Kh 9s]
Fp/oksNpipCrD2MJ2pH20g: bets $2.50
tDV+zhxH9+3DkJDzoTERyg: folds
Fp/oksNpipCrD2MJ2pH20g collected $1.90 from pot
Fp/oksNpipCrD2MJ2pH20g: doesn't show hand
*** SUMMARY ***
Total pot $2 | Rake $0.10
Board [9c Kh 9s]
Seat 1: Fp/oksNpipCrD2MJ2pH20g (big blind) collected ($1.90)
Seat 2: tDV+zhxH9+3DkJDzoTERyg (button) (small blind) folded on the Flop



PokerStars Game #59940173016:  Hold'em No Limit ($0.25/$0.50) - 2009/07/01 0:59:15 ET
Table '37qXEp3oe+er5q4CZip9eQ' 6-max Seat #5 is the button
Seat 1: oqOqoO2AyCZenUghCxMDxw ($53.40 in chips)
Seat 2: LvH4G7n+QSjT6NDaD3cREA ($50 in chips)
Seat 3: Rt6KgtZ8YaJoTc3FPim00w ($104.50 in chips)
Seat 4: XsmE8nXMAAMFJbWaJTmHFw ($40.60 in chips)
Seat 5: VOmI0x4dDPnTESZd5B4d1Q ($43.50 in chips)
Seat 6: N50kln4negd8q7Mmoz1j4g ($16.05 in chips)
N50kln4negd8q7Mmoz1j4g: posts small blind $0.25
oqOqoO2AyCZenUghCxMDxw: posts big blind $0.50
*** HOLE CARDS ***
LvH4G7n+QSjT6NDaD3cREA: folds
Rt6KgtZ8YaJoTc3FPim00w: raises $1 to $1.50
XsmE8nXMAAMFJbWaJTmHFw: folds
VOmI0x4dDPnTESZd5B4d1Q: folds
N50kln4negd8q7Mmoz1j4g: folds
oqOqoO2AyCZenUghCxMDxw: calls $1
*** FLOP *** [4d 8s 9d]
oqOqoO2AyCZenUghCxMDxw: checks
Rt6KgtZ8YaJoTc3FPim00w: bets $2
oqOqoO2AyCZenUghCxMDxw: calls $2
*** TURN *** [4d 8s 9d] [2h]
oqOqoO2AyCZenUghCxMDxw: checks
XsmE8nXMAAMFJbWaJTmHFw said, "I had a second king and made my flush with the turn. I thought you'd call with a better flush"
Rt6KgtZ8YaJoTc3FPim00w: checks
*** RIVER *** [4d 8s 9d 2h] [9s]
oqOqoO2AyCZenUghCxMDxw: bets $5
Rt6KgtZ8YaJoTc3FPim00w: calls $5
*** SHOW DOWN ***
oqOqoO2AyCZenUghCxMDxw: shows [Qc Th] (a pair of Nines)
Rt6KgtZ8YaJoTc3FPim00w: shows [3d 3c] (two pair, Nines and Threes)
Rt6KgtZ8YaJoTc3FPim00w collected $16.45 from pot
*** SUMMARY ***
Total pot $17.25 | Rake $0.80
Board [4d 8s 9d 2h 9s]
Seat 1: oqOqoO2AyCZenUghCxMDxw (big blind) showed [Qc Th] and lost with a pair of Nines
Seat 2: LvH4G7n+QSjT6NDaD3cREA folded before Flop (didn't bet)
Seat 3: Rt6KgtZ8YaJoTc3FPim00w showed [3d 3c] and won ($16.45) with two pair, Nines and Threes
Seat 4: XsmE8nXMAAMFJbWaJTmHFw folded before Flop (didn't bet)
Seat 5: VOmI0x4dDPnTESZd5B4d1Q (button) folded before Flop (didn't bet)
Seat 6: N50kln4negd8q7Mmoz1j4g (small blind) folded before Flop



PokerStars Game #59940173258:  Hold'em No Limit ($0.25/$0.50) - 2009/07/01 0:59:15 ET
Table 'NCiXr0d5CEKBQr/cZgLhbA' 9-max Seat #6 is the button
Seat 1: pFtzb1sR4b0d1aw6aIRgDg ($50 in chips)
Seat 2: ulxuJchBV9iguXg0FUonfg ($51.45 in chips)
Seat 3: xZCXQSXlrZkp3pZizzVXCw ($52.70 in chips)
Seat 4: 5k9fvXD9suIgCxU4HLQjTw ($55.20 in chips)
Seat 5: zE9cVigS2nW/Ljy4K4bUQA ($31.70 in chips)
Seat 6: SKnJuWHScqetA/qG5p+wCg ($32.75 in chips)
Seat 7: M+7+BTmX5vZatHVuoRB1nA ($52.25 in chips)
Seat 8: 1MJUKc3cc0QmUoz1JZLR2w ($64.05 in chips)
Seat 9: 4WLZvqBn5qv5tds5kt5A1Q ($39.50 in chips)
M+7+BTmX5vZatHVuoRB1nA: posts small blind $0.25
1MJUKc3cc0QmUoz1JZLR2w: posts big blind $0.50
*** HOLE CARDS ***
4WLZvqBn5qv5tds5kt5A1Q: folds
pFtzb1sR4b0d1aw6aIRgDg: folds
ulxuJchBV9iguXg0FUonfg: folds
xZCXQSXlrZkp3pZizzVXCw: folds
5k9fvXD9suIgCxU4HLQjTw: folds
zE9cVigS2nW/Ljy4K4bUQA: folds
SKnJuWHScqetA/qG5p+wCg: folds
M+7+BTmX5vZatHVuoRB1nA: folds
1MJUKc3cc0QmUoz1JZLR2w collected $0.50 from pot
*** SUMMARY ***
Total pot $0.50 | Rake $0
Seat 1: pFtzb1sR4b0d1aw6aIRgDg folded before Flop (didn't bet)
Seat 2: ulxuJchBV9iguXg0FUonfg folded before Flop (didn't bet)
Seat 3: xZCXQSXlrZkp3pZizzVXCw folded before Flop (didn't bet)
Seat 4: 5k9fvXD9suIgCxU4HLQjTw folded before Flop (didn't bet)
Seat 5: zE9cVigS2nW/Ljy4K4bUQA folded before Flop (didn't bet)
Seat 6: SKnJuWHScqetA/qG5p+wCg (button) folded before Flop (didn't bet)
Seat 7: M+7+BTmX5vZatHVuoRB1nA (small blind) folded before Flop
Seat 8: 1MJUKc3cc0QmUoz1JZLR2w (big blind) collected ($0.50)
Seat 9: 4WLZvqBn5qv5tds5kt5A1Q folded before Flop (didn't bet)



PokerStars Game #59940175626:  Hold'em No Limit ($0.25/$0.50) - 2009/07/01 0:59:19 ET
Table 'BCN5su+SsXiy1zRMJi0SJw' 6-max Seat #2 is the button
Seat 1: GxXV09ciXaOxyY2H5aMIIw ($29.65 in chips)
Seat 2: oU2kDCkT/gilYbHWrg7D8w ($35.75 in chips)
Seat 3: 6wzJiRvp8HY6t+MQGnSIzA ($25.85 in chips)
Seat 4: qfeUHOJpMYyzQcj0o2A7ng ($10.75 in chips)
Seat 5: IBNygaT1aa9Z1uPdJJilwA ($30.85 in chips)
Seat 6: b2symlOdL7+0c9Pj4N/KlA ($65 in chips)
6wzJiRvp8HY6t+MQGnSIzA: posts small blind $0.25
qfeUHOJpMYyzQcj0o2A7ng: posts big blind $0.50
*** HOLE CARDS ***
IBNygaT1aa9Z1uPdJJilwA: folds
b2symlOdL7+0c9Pj4N/KlA: folds
GxXV09ciXaOxyY2H5aMIIw: raises $2 to $2.50
oU2kDCkT/gilYbHWrg7D8w: folds
6wzJiRvp8HY6t+MQGnSIzA: calls $2.25
qfeUHOJpMYyzQcj0o2A7ng: folds
*** FLOP *** [5h 8d 2c]
6wzJiRvp8HY6t+MQGnSIzA: checks
oU2kDCkT/gilYbHWrg7D8w said, "that was strange sequence of events"
GxXV09ciXaOxyY2H5aMIIw: bets $5
6wzJiRvp8HY6t+MQGnSIzA: folds
GxXV09ciXaOxyY2H5aMIIw collected $5.25 from pot
*** SUMMARY ***
Total pot $5.50 | Rake $0.25
Board [5h 8d 2c]
Seat 1: GxXV09ciXaOxyY2H5aMIIw collected ($5.25)
Seat 2: oU2kDCkT/gilYbHWrg7D8w (button) folded before Flop (didn't bet)
Seat 3: 6wzJiRvp8HY6t+MQGnSIzA (small blind) folded on the Flop
Seat 4: qfeUHOJpMYyzQcj0o2A7ng (big blind) folded before Flop
Seat 5: IBNygaT1aa9Z1uPdJJilwA folded before Flop (didn't bet)
Seat 6: b2symlOdL7+0c9Pj4N/KlA folded before Flop (didn't bet)



PokerStars Game #59940175930:  Hold'em No Limit ($0.25/$0.50) - 2009/07/01 0:59:19 ET
Table 'hWT2kq66tnKEpD26cia6fQ' 2-max Seat #1 is the button
Seat 1: nDAH8M70KzyNYO9u3Jg+JQ ($41.50 in chips)
Seat 2: 16tvT7AYgZ2LgiGFcvFKQg ($3.75 in chips)
nDAH8M70KzyNYO9u3Jg+JQ: posts small blind $0.25
16tvT7AYgZ2LgiGFcvFKQg: posts big blind $0.50
*** HOLE CARDS ***
nDAH8M70KzyNYO9u3Jg+JQ: calls $0.25
16tvT7AYgZ2LgiGFcvFKQg: checks
*** FLOP *** [5h Jd 2s]
16tvT7AYgZ2LgiGFcvFKQg: checks
nDAH8M70KzyNYO9u3Jg+JQ: checks
*** TURN *** [5h Jd 2s] [Tc]
16tvT7AYgZ2LgiGFcvFKQg: checks
nDAH8M70KzyNYO9u3Jg+JQ: checks
*** RIVER *** [5h Jd 2s Tc] [4d]
16tvT7AYgZ2LgiGFcvFKQg: checks
nDAH8M70KzyNYO9u3Jg+JQ: checks
*** SHOW DOWN ***
16tvT7AYgZ2LgiGFcvFKQg: shows [Qh 3c] (high card Queen)
nDAH8M70KzyNYO9u3Jg+JQ: shows [Ks 3s] (high card King)
nDAH8M70KzyNYO9u3Jg+JQ collected $0.95 from pot
*** SUMMARY ***
Total pot $1 | Rake $0.05
Board [5h Jd 2s Tc 4d]
Seat 1: nDAH8M70KzyNYO9u3Jg+JQ (button) (small blind) showed [Ks 3s] and won ($0.95) with high card King
Seat 2: 16tvT7AYgZ2LgiGFcvFKQg (big blind) showed [Qh 3c] and lost with high card Queen



PokerStars Game #59940176418:  Hold'em No Limit ($0.25/$0.50) - 2009/07/01 0:59:20 ET
Table 'lSisgp6H7Fg1hH5VfjEjYQ' 9-max Seat #6 is the button
Seat 1: 5k9fvXD9suIgCxU4HLQjTw ($50 in chips)
Seat 2: UrcnkQOiLVk8BlKDPJSy7Q ($76.60 in chips)
Seat 3: aTkyjTh3w5YLWiIERupZOA ($51.95 in chips)
Seat 4: bwv/rbH/hHhPhY6u9mu04w ($31.60 in chips)
Seat 5: mSD1pginDsyHG5PDfqzphw ($10 in chips)
Seat 6: +k7T5ocke8UwavtgUHm+Cg ($67.05 in chips)
Seat 7: IDtNLR9uFCDdjNsJWMHA5Q ($19.35 in chips)
Seat 8: a4JDWmpFQkL10XfAyuF51A ($29 in chips)
IDtNLR9uFCDdjNsJWMHA5Q: posts small blind $0.25
a4JDWmpFQkL10XfAyuF51A: posts big blind $0.50
*** HOLE CARDS ***
5k9fvXD9suIgCxU4HLQjTw: folds
UrcnkQOiLVk8BlKDPJSy7Q: folds
aTkyjTh3w5YLWiIERupZOA: folds
bwv/rbH/hHhPhY6u9mu04w: folds
mSD1pginDsyHG5PDfqzphw: folds
+k7T5ocke8UwavtgUHm+Cg: folds
IDtNLR9uFCDdjNsJWMHA5Q: calls $0.25
a4JDWmpFQkL10XfAyuF51A: checks
*** FLOP *** [7s Jc 9d]
IDtNLR9uFCDdjNsJWMHA5Q: checks
a4JDWmpFQkL10XfAyuF51A: checks
*** TURN *** [7s Jc 9d] [5h]
IDtNLR9uFCDdjNsJWMHA5Q: bets $0.50
a4JDWmpFQkL10XfAyuF51A: folds
IDtNLR9uFCDdjNsJWMHA5Q collected $0.95 from pot
IDtNLR9uFCDdjNsJWMHA5Q: doesn't show hand
*** SUMMARY ***
Total pot $1 | Rake $0.05
Board [7s Jc 9d 5h]
Seat 1: 5k9fvXD9suIgCxU4HLQjTw folded before Flop (didn't bet)
Seat 2: UrcnkQOiLVk8BlKDPJSy7Q folded before Flop (didn't bet)
Seat 3: aTkyjTh3w5YLWiIERupZOA folded before Flop (didn't bet)
Seat 4: bwv/rbH/hHhPhY6u9mu04w folded before Flop (didn't bet)
Seat 5: mSD1pginDsyHG5PDfqzphw folded before Flop (didn't bet)
Seat 6: +k7T5ocke8UwavtgUHm+Cg (button) folded before Flop (didn't bet)
Seat 7: IDtNLR9uFCDdjNsJWMHA5Q (small blind) collected ($0.95)
Seat 8: a4JDWmpFQkL10XfAyuF51A (big blind) folded on the Turn



PokerStars Game #59940178912:  Hold'em No Limit ($0.25/$0.50) - 2009/07/01 0:59:24 ET
Table '+dXkOAQyS8j9PQZusUTMpg' 2-max Seat #2 is the button
Seat 1: XFa6sBGjP2gxoIvxR3fZIg ($61.35 in chips)
Seat 2: 5IBeOgaApY1Bvzv2P8X4EA ($137.45 in chips)
5IBeOgaApY1Bvzv2P8X4EA: posts small blind $0.25
XFa6sBGjP2gxoIvxR3fZIg: posts big blind $0.50
*** HOLE CARDS ***
5IBeOgaApY1Bvzv2P8X4EA: folds
XFa6sBGjP2gxoIvxR3fZIg collected $0.50 from pot
XFa6sBGjP2gxoIvxR3fZIg: doesn't show hand
*** SUMMARY ***
Total pot $0.50 | Rake $0
Seat 1: XFa6sBGjP2gxoIvxR3fZIg (big blind) collected ($0.50)
Seat 2: 5IBeOgaApY1Bvzv2P8X4EA (button) (small blind) folded before Flop



PokerStars Game #59940178758:  Hold'em No Limit ($0.25/$0.50) - 2009/07/01 0:59:24 ET
Table '8BQGgNetI1NOvWeu3gtMNw' 2-max Seat #1 is the button
Seat 1: bypIyrYcAAifLfhZpGlKLA ($50 in chips)
Seat 2: Z4HwehErEwzsv/noQlfUlg ($152.45 in chips)
bypIyrYcAAifLfhZpGlKLA: posts small blind $0.25
Z4HwehErEwzsv/noQlfUlg: posts big blind $0.50
*** HOLE CARDS ***
bypIyrYcAAifLfhZpGlKLA: raises $1 to $1.50
Z4HwehErEwzsv/noQlfUlg: raises $2.50 to $4
bypIyrYcAAifLfhZpGlKLA: calls $2.50
*** FLOP *** [Jd Jc 6h]
Z4HwehErEwzsv/noQlfUlg: bets $5
bypIyrYcAAifLfhZpGlKLA: calls $5
*** TURN *** [Jd Jc 6h] [3d]
Z4HwehErEwzsv/noQlfUlg: checks
bypIyrYcAAifLfhZpGlKLA: bets $10.50
Z4HwehErEwzsv/noQlfUlg: folds
bypIyrYcAAifLfhZpGlKLA collected $17.50 from pot
bypIyrYcAAifLfhZpGlKLA: doesn't show hand
*** SUMMARY ***
Total pot $18 | Rake $0.50
Board [Jd Jc 6h 3d]
Seat 1: bypIyrYcAAifLfhZpGlKLA (button) (small blind) collected ($17.50)
Seat 2: Z4HwehErEwzsv/noQlfUlg (big blind) folded on the Turn



PokerStars Game #59940179074:  Hold'em No Limit ($0.25/$0.50) - 2009/07/01 0:59:25 ET
Table 'E7bWJ45aoFXRpyRv2gw+Ig' 2-max Seat #1 is the button
Seat 1: FRkiRasEGlHUeLrEl+k/nA ($76.70 in chips)
Seat 2: 3Wro85I7472vJ4Wkpneo9A ($113.50 in chips)
FRkiRasEGlHUeLrEl+k/nA: posts small blind $0.25
3Wro85I7472vJ4Wkpneo9A: posts big blind $0.50
*** HOLE CARDS ***
FRkiRasEGlHUeLrEl+k/nA: raises $1 to $1.50
3Wro85I7472vJ4Wkpneo9A: folds
FRkiRasEGlHUeLrEl+k/nA collected $1 from pot
*** SUMMARY ***
Total pot $1 | Rake $0
Seat 1: FRkiRasEGlHUeLrEl+k/nA (button) (small blind) collected ($1)
Seat 2: 3Wro85I7472vJ4Wkpneo9A (big blind) folded before Flop



PokerStars Game #59940180132:  Hold'em No Limit ($0.25/$0.50) - 2009/07/01 0:59:26 ET
Table 'MJxeZCzYELxiIsyUZyT0jw' 6-max Seat #6 is the button
Seat 1: +Pf9jTVizYlIo+woPvptfA ($50 in chips)
Seat 2: t3GiVMzqA9Svgr5Uol32cQ ($35.10 in chips)
Seat 3: JQZew0FjzS19kTjeNtrE+A ($64.60 in chips)
Seat 4: alGiiQP/wwtYnfuXII+sgw ($39.35 in chips)
Seat 5: 3jvoOXNtXE90w2BdfNZwZQ ($60.10 in chips)
Seat 6: c0n4hrn20AML9qzyFC2E8Q ($48 in chips)
+Pf9jTVizYlIo+woPvptfA: posts small blind $0.25
t3GiVMzqA9Svgr5Uol32cQ: posts big blind $0.50
*** HOLE CARDS ***
JQZew0FjzS19kTjeNtrE+A: folds
alGiiQP/wwtYnfuXII+sgw: folds
3jvoOXNtXE90w2BdfNZwZQ: folds
c0n4hrn20AML9qzyFC2E8Q: raises $1 to $1.50
+Pf9jTVizYlIo+woPvptfA: folds
t3GiVMzqA9Svgr5Uol32cQ: folds
c0n4hrn20AML9qzyFC2E8Q collected $1.25 from pot
c0n4hrn20AML9qzyFC2E8Q: doesn't show hand
*** SUMMARY ***
Total pot $1.25 | Rake $0
Seat 1: +Pf9jTVizYlIo+woPvptfA (small blind) folded before Flop
Seat 2: t3GiVMzqA9Svgr5Uol32cQ (big blind) folded before Flop
Seat 3: JQZew0FjzS19kTjeNtrE+A folded before Flop (didn't bet)
Seat 4: alGiiQP/wwtYnfuXII+sgw folded before Flop (didn't bet)
Seat 5: 3jvoOXNtXE90w2BdfNZwZQ folded before Flop (didn't bet)
Seat 6: c0n4hrn20AML9qzyFC2E8Q (button) collected ($1.25)



PokerStars Game #59940180164:  Hold'em No Limit ($0.25/$0.50) - 2009/07/01 0:59:26 ET
Table 'Nz0Vr7WMHL2g5Uk7dDZjpw' 9-max Seat #6 is the button
Seat 1: tLkxo7JgV+WWI0UBw44K5A ($109.85 in chips)
Seat 3: uw9QayAAxLM3Hb+HR7mSkg ($10 in chips)
Seat 4: E2518gp4aFz1+kAgmGqeEg ($11.50 in chips)
Seat 5: WGW0DgjBUXs1ylURHG8vnQ ($27.90 in chips)
Seat 6: 997ViqAtWn1FPjJqcffwcA ($60.55 in chips)
Seat 7: KPLH0gELgFe2OuAnhJFI5w ($16.85 in chips)
Seat 8: HkZI6g4zl83TDTA7SRspmQ ($15.95 in chips)
Seat 9: mSD1pginDsyHG5PDfqzphw ($10 in chips)
KPLH0gELgFe2OuAnhJFI5w: posts small blind $0.25
HkZI6g4zl83TDTA7SRspmQ: posts big blind $0.50
gsyXT42WLEcOS4DdEk2wlw: sits out
*** HOLE CARDS ***
mSD1pginDsyHG5PDfqzphw: folds
tLkxo7JgV+WWI0UBw44K5A: folds
uw9QayAAxLM3Hb+HR7mSkg: folds
E2518gp4aFz1+kAgmGqeEg: folds
WGW0DgjBUXs1ylURHG8vnQ: folds
997ViqAtWn1FPjJqcffwcA: folds
KPLH0gELgFe2OuAnhJFI5w: calls $0.25
HkZI6g4zl83TDTA7SRspmQ: raises $0.50 to $1
KPLH0gELgFe2OuAnhJFI5w: calls $0.50
*** FLOP *** [7s Kh 5h]
KPLH0gELgFe2OuAnhJFI5w: checks
HkZI6g4zl83TDTA7SRspmQ: bets $1.50
KPLH0gELgFe2OuAnhJFI5w: folds
HkZI6g4zl83TDTA7SRspmQ collected $1.90 from pot
*** SUMMARY ***
Total pot $2 | Rake $0.10
Board [7s Kh 5h]
Seat 1: tLkxo7JgV+WWI0UBw44K5A folded before Flop (didn't bet)
Seat 3: uw9QayAAxLM3Hb+HR7mSkg folded before Flop (didn't bet)
Seat 4: E2518gp4aFz1+kAgmGqeEg folded before Flop (didn't bet)
Seat 5: WGW0DgjBUXs1ylURHG8vnQ folded before Flop (didn't bet)
Seat 6: 997ViqAtWn1FPjJqcffwcA (button) folded before Flop (didn't bet)
Seat 7: KPLH0gELgFe2OuAnhJFI5w (small blind) folded on the Flop
Seat 8: HkZI6g4zl83TDTA7SRspmQ (big blind) collected ($1.90)
Seat 9: mSD1pginDsyHG5PDfqzphw folded before Flop (didn't bet)



PokerStars Game #59940181204:  Hold'em No Limit ($0.25/$0.50) - 2009/07/01 0:59:28 ET
Table 'lpxYasB1ClBSgTpCCITwhQ' 9-max Seat #1 is the button
Seat 1: mj7PS7wCH4PAl7+eYTFs7A ($45.90 in chips)
Seat 2: OWP/DOu+PlPK6ZZ3zYa0HA ($20.10 in chips)
Seat 3: IVoxShuYD5lqbK8F9+jVsg ($10 in chips)
Seat 4: NnQCepdIR/AOUQn1yhYx6Q ($9.25 in chips)
Seat 5: IYd5zG8k7vdBNVHbHg2Pag ($36.35 in chips)
Seat 6: SegjDnMxWMujiD57ESNL+g ($12.10 in chips)
Seat 7: bmRtaIYKthN1F+B3JLZ3Jw ($68 in chips)
Seat 8: /mfensKw8/iZ1Vrx33S4xg ($11.85 in chips)
OWP/DOu+PlPK6ZZ3zYa0HA: posts small blind $0.25
IVoxShuYD5lqbK8F9+jVsg: posts big blind $0.50
*** HOLE CARDS ***
NnQCepdIR/AOUQn1yhYx6Q: folds
IYd5zG8k7vdBNVHbHg2Pag: folds
SegjDnMxWMujiD57ESNL+g: folds
sUIUZ+begh92dzkUmvbMrw joins the table at seat #9
bmRtaIYKthN1F+B3JLZ3Jw: raises $1 to $1.50
/mfensKw8/iZ1Vrx33S4xg: folds
mj7PS7wCH4PAl7+eYTFs7A: calls $1.50
OWP/DOu+PlPK6ZZ3zYa0HA: folds
IVoxShuYD5lqbK8F9+jVsg: folds
*** FLOP *** [5d Jd 8h]
bmRtaIYKthN1F+B3JLZ3Jw: bets $2
mj7PS7wCH4PAl7+eYTFs7A: calls $2
*** TURN *** [5d Jd 8h] [3d]
bmRtaIYKthN1F+B3JLZ3Jw: checks
mj7PS7wCH4PAl7+eYTFs7A: checks
*** RIVER *** [5d Jd 8h 3d] [7c]
bmRtaIYKthN1F+B3JLZ3Jw: checks
mj7PS7wCH4PAl7+eYTFs7A: checks
*** SHOW DOWN ***
bmRtaIYKthN1F+B3JLZ3Jw: shows [As Kc] (high card Ace)
mj7PS7wCH4PAl7+eYTFs7A: mucks hand
bmRtaIYKthN1F+B3JLZ3Jw collected $7.40 from pot
*** SUMMARY ***
Total pot $7.75 | Rake $0.35
Board [5d Jd 8h 3d 7c]
Seat 1: mj7PS7wCH4PAl7+eYTFs7A (button) mucked
Seat 2: OWP/DOu+PlPK6ZZ3zYa0HA (small blind) folded before Flop
Seat 3: IVoxShuYD5lqbK8F9+jVsg (big blind) folded before Flop
Seat 4: NnQCepdIR/AOUQn1yhYx6Q folded before Flop (didn't bet)
Seat 5: IYd5zG8k7vdBNVHbHg2Pag folded before Flop (didn't bet)
Seat 6: SegjDnMxWMujiD57ESNL+g folded before Flop (didn't bet)
Seat 7: bmRtaIYKthN1F+B3JLZ3Jw showed [As Kc] and won ($7.40) with high card Ace
Seat 8: /mfensKw8/iZ1Vrx33S4xg folded before Flop (didn't bet)



PokerStars Game #59940181730:  Hold'em No Limit ($0.25/$0.50) - 2009/07/01 0:59:29 ET
Table 'EiNh8p/wGJ1FP575iMFnqg' 9-max Seat #8 is the button
Seat 1: r3ZqM1Mi0W3y4hOdssE+Sg ($44.85 in chips)
Seat 2: 8ehL7qlZzjgUh2H35iiWLw ($52.60 in chips)
Seat 3: ymLPoEIl7UL3TvZYmnadxQ ($52.55 in chips)
Seat 4: cMzaiXAM/ZAdNaEUu+LqhA ($55.70 in chips)
Seat 5: M+7+BTmX5vZatHVuoRB1nA ($81.45 in chips)
Seat 6: 3UmXLy3GfjC3EkOebduerQ ($64.10 in chips)
Seat 7: 997ViqAtWn1FPjJqcffwcA ($50 in chips)
Seat 8: mSD1pginDsyHG5PDfqzphw ($10 in chips)
Seat 9: NnQCepdIR/AOUQn1yhYx6Q ($12 in chips)
NnQCepdIR/AOUQn1yhYx6Q: posts small blind $0.25
r3ZqM1Mi0W3y4hOdssE+Sg: posts big blind $0.50
*** HOLE CARDS ***
8ehL7qlZzjgUh2H35iiWLw: folds
ymLPoEIl7UL3TvZYmnadxQ: folds
cMzaiXAM/ZAdNaEUu+LqhA: folds
M+7+BTmX5vZatHVuoRB1nA: folds
3UmXLy3GfjC3EkOebduerQ: folds
997ViqAtWn1FPjJqcffwcA: folds
mSD1pginDsyHG5PDfqzphw: folds
NnQCepdIR/AOUQn1yhYx6Q: folds
r3ZqM1Mi0W3y4hOdssE+Sg collected $0.50 from pot
*** SUMMARY ***
Total pot $0.50 | Rake $0
Seat 1: r3ZqM1Mi0W3y4hOdssE+Sg (big blind) collected ($0.50)
Seat 2: 8ehL7qlZzjgUh2H35iiWLw folded before Flop (didn't bet)
Seat 3: ymLPoEIl7UL3TvZYmnadxQ folded before Flop (didn't bet)
Seat 4: cMzaiXAM/ZAdNaEUu+LqhA folded before Flop (didn't bet)
Seat 5: M+7+BTmX5vZatHVuoRB1nA folded before Flop (didn't bet)
Seat 6: 3UmXLy3GfjC3EkOebduerQ folded before Flop (didn't bet)
Seat 7: 997ViqAtWn1FPjJqcffwcA folded before Flop (didn't bet)
Seat 8: mSD1pginDsyHG5PDfqzphw (button) folded before Flop (didn't bet)
Seat 9: NnQCepdIR/AOUQn1yhYx6Q (small blind) folded before Flop



PokerStars Game #59940182082:  Hold'em No Limit ($0.25/$0.50) - 2009/07/01 0:59:30 ET
Table '0eJtgVAXVvBgncFdcUpXcQ' 2-max Seat #1 is the button
Seat 1: Ag6DvxX4vbRheqsv2zXKTQ ($35.60 in chips)
Seat 2: KMc4R+K9ao4Ur3rF7NGe6Q ($13.40 in chips)
Ag6DvxX4vbRheqsv2zXKTQ: posts small blind $0.25
KMc4R+K9ao4Ur3rF7NGe6Q: posts big blind $0.50
*** HOLE CARDS ***
Ag6DvxX4vbRheqsv2zXKTQ: calls $0.25
KMc4R+K9ao4Ur3rF7NGe6Q: checks
*** FLOP *** [Jc 4d As]
KMc4R+K9ao4Ur3rF7NGe6Q: checks
Ag6DvxX4vbRheqsv2zXKTQ: bets $1
KMc4R+K9ao4Ur3rF7NGe6Q: folds
Ag6DvxX4vbRheqsv2zXKTQ collected $0.95 from pot
*** SUMMARY ***
Total pot $1 | Rake $0.05
Board [Jc 4d As]
Seat 1: Ag6DvxX4vbRheqsv2zXKTQ (button) (small blind) collected ($0.95)
Seat 2: KMc4R+K9ao4Ur3rF7NGe6Q (big blind) folded on the Flop



PokerStars Game #59940182402:  Hold'em No Limit ($0.25/$0.50) - 2009/07/01 0:59:30 ET
Table '9Puy2HWN1RQe5SSjq162gA' 2-max Seat #1 is the button
Seat 1: Fp/oksNpipCrD2MJ2pH20g ($11.80 in chips)
Seat 2: tDV+zhxH9+3DkJDzoTERyg ($26.30 in chips)
Fp/oksNpipCrD2MJ2pH20g: posts small blind $0.25
tDV+zhxH9+3DkJDzoTERyg: posts big blind $0.50
*** HOLE CARDS ***
Fp/oksNpipCrD2MJ2pH20g: raises $1 to $1.50
tDV+zhxH9+3DkJDzoTERyg: calls $1
*** FLOP *** [2s Js 8h]
tDV+zhxH9+3DkJDzoTERyg: bets $1.50
Fp/oksNpipCrD2MJ2pH20g: raises $8.80 to $10.30 and is all-in
tDV+zhxH9+3DkJDzoTERyg: folds
Fp/oksNpipCrD2MJ2pH20g collected $5.75 from pot
Fp/oksNpipCrD2MJ2pH20g: doesn't show hand
*** SUMMARY ***
Total pot $6 | Rake $0.25
Board [2s Js 8h]
Seat 1: Fp/oksNpipCrD2MJ2pH20g (button) (small blind) collected ($5.75)
Seat 2: tDV+zhxH9+3DkJDzoTERyg (big blind) folded on the Flop



PokerStars Game #59940182616:  Hold'em No Limit ($0.25/$0.50) - 2009/07/01 0:59:30 ET
Table '+dXkOAQyS8j9PQZusUTMpg' 2-max Seat #1 is the button
Seat 1: XFa6sBGjP2gxoIvxR3fZIg ($61.60 in chips)
Seat 2: 5IBeOgaApY1Bvzv2P8X4EA ($137.20 in chips)
XFa6sBGjP2gxoIvxR3fZIg: posts small blind $0.25
5IBeOgaApY1Bvzv2P8X4EA: posts big blind $0.50
*** HOLE CARDS ***
XFa6sBGjP2gxoIvxR3fZIg: raises $1 to $1.50
5IBeOgaApY1Bvzv2P8X4EA: folds
XFa6sBGjP2gxoIvxR3fZIg collected $1 from pot
XFa6sBGjP2gxoIvxR3fZIg: doesn't show hand
*** SUMMARY ***
Total pot $1 | Rake $0
Seat 1: XFa6sBGjP2gxoIvxR3fZIg (button) (small blind) collected ($1)
Seat 2: 5IBeOgaApY1Bvzv2P8X4EA (big blind) folded before Flop



PokerStars Game #59940183932:  Hold'em No Limit ($0.25/$0.50) - 2009/07/01 0:59:33 ET
Table 'E7bWJ45aoFXRpyRv2gw+Ig' 2-max Seat #2 is the button
Seat 1: FRkiRasEGlHUeLrEl+k/nA ($77.20 in chips)
Seat 2: 3Wro85I7472vJ4Wkpneo9A ($113 in chips)
3Wro85I7472vJ4Wkpneo9A: posts small blind $0.25
FRkiRasEGlHUeLrEl+k/nA: posts big blind $0.50
*** HOLE CARDS ***
3Wro85I7472vJ4Wkpneo9A: raises $1 to $1.50
FRkiRasEGlHUeLrEl+k/nA: calls $1
*** FLOP *** [3s Kh 6s]
FRkiRasEGlHUeLrEl+k/nA: bets $1.50
3Wro85I7472vJ4Wkpneo9A: calls $1.50
*** TURN *** [3s Kh 6s] [Ks]
FRkiRasEGlHUeLrEl+k/nA: bets $3
3Wro85I7472vJ4Wkpneo9A: calls $3
*** RIVER *** [3s Kh 6s Ks] [8h]
FRkiRasEGlHUeLrEl+k/nA: bets $11.50
3Wro85I7472vJ4Wkpneo9A: folds
FRkiRasEGlHUeLrEl+k/nA collected $11.50 from pot
*** SUMMARY ***
Total pot $12 | Rake $0.50
Board [3s Kh 6s Ks 8h]
Seat 1: FRkiRasEGlHUeLrEl+k/nA (big blind) collected ($11.50)
Seat 2: 3Wro85I7472vJ4Wkpneo9A (button) (small blind) folded on the River



PokerStars Game #59940184892:  Hold'em No Limit ($0.25/$0.50) - 2009/07/01 0:59:34 ET
Table 'E7bWJ45aoFXRpyRv2gw+Ig99gCy/CZQwPIjZWH+BguQgeat #4 is the button
Seat 2: n6VQBu6crjYjy6DxNP1NZA ($28.75 in chips)
Seat 3: qEn9ijNGtuyTxamBf07hYg ($50 in chips)
Seat 4: bxLSulbgr8LmKNjOzw8URg ($62.20 in chips)
Seat 6: OcnLOMVFdy23jXnoTyaO5Q ($265.90 in chips)
Seat 7: bfSq6LBw0UvxeM5yfuWC7w ($17.85 in chips)
Seat 8: 8ehL7qlZzjgUh2H35iiWLw ($51.75 in chips)
Seat 9: j3K/Jujr7PY4ZM2RZvlH6A ($77.45 in chips)
OcnLOMVFdy23jXnoTyaO5Q: posts small blind $0.25
bfSq6LBw0UvxeM5yfuWC7w: posts big blind $0.50
*** HOLE CARDS ***
8ehL7qlZzjgUh2H35iiWLw: folds
YXCE3WOZi8g2sIf3y/plVw joins the table at seat #5
j3K/Jujr7PY4ZM2RZvlH6A: folds
n6VQBu6crjYjy6DxNP1NZA: folds
qEn9ijNGtuyTxamBf07hYg: folds
bxLSulbgr8LmKNjOzw8URg: raises $1 to $1.50
OcnLOMVFdy23jXnoTyaO5Q: folds
bfSq6LBw0UvxeM5yfuWC7w: folds
bxLSulbgr8LmKNjOzw8URg collected $1.25 from pot
bxLSulbgr8LmKNjOzw8URg: doesn't show hand
*** SUMMARY ***
Total pot $1.25 | Rake $0
Seat 2: n6VQBu6crjYjy6DxNP1NZA folded before Flop (didn't bet)
Seat 3: qEn9ijNGtuyTxamBf07hYg folded before Flop (didn't bet)
Seat 4: bxLSulbgr8LmKNjOzw8URg (button) collected ($1.25)
Seat 6: OcnLOMVFdy23jXnoTyaO5Q (small blind) folded before Flop
Seat 7: bfSq6LBw0UvxeM5yfuWC7w (big blind) folded before Flop
Seat 8: 8ehL7qlZzjgUh2H35iiWLw folded before Flop (didn't bet)
Seat 9: j3K/Jujr7PY4ZM2RZvlH6A folded before Flop (didn't bet)



PokerStars Game #59940186018:  Hold'em No Limit ($0.25/$0.50) - 2009/07/01 0:59:36 ET
Table '+z1aekfHkpp09pc8F9aViw' 6-max Seat #3 is the button
Seat 1: FHilMb2i2DbUCc9lplszog ($36.55 in chips)
Seat 2: M6xK/VklCvdyyrmvzATlxQ ($33.75 in chips)
Seat 3: uUznlIMFnRUvwrBhYF73KA ($124.90 in chips)
Seat 4: RowCSpSURHTOL/dcjg/Iug ($39.80 in chips)
Seat 5: rplyldNweS6YyMNEALQrug ($38.55 in chips)
Seat 6: 686aeHikcJlgKkSuIFdcXQ ($50 in chips)
RowCSpSURHTOL/dcjg/Iug: posts small blind $0.25
rplyldNweS6YyMNEALQrug: posts big blind $0.50
*** HOLE CARDS ***
686aeHikcJlgKkSuIFdcXQ: folds
FHilMb2i2DbUCc9lplszog: raises $1.50 to $2
M6xK/VklCvdyyrmvzATlxQ: folds
uUznlIMFnRUvwrBhYF73KA: folds
RowCSpSURHTOL/dcjg/Iug: folds
rplyldNweS6YyMNEALQrug: raises $5 to $7
FHilMb2i2DbUCc9lplszog: calls $5
*** FLOP *** [Ks Jc Jd]
rplyldNweS6YyMNEALQrug: bets $11.50
FHilMb2i2DbUCc9lplszog: calls $11.50
*** TURN *** [Ks Jc Jd] [Qc]
rplyldNweS6YyMNEALQrug: bets $20.05 and is all-in
FHilMb2i2DbUCc9lplszog: folds
rplyldNweS6YyMNEALQrug collected $35.45 from pot
*** SUMMARY ***
Total pot $37.25 | Rake $1.80
Board [Ks Jc Jd Qc]
Seat 1: FHilMb2i2DbUCc9lplszog folded on the Turn
Seat 2: M6xK/VklCvdyyrmvzATlxQ folded before Flop (didn't bet)
Seat 3: uUznlIMFnRUvwrBhYF73KA (button) folded before Flop (didn't bet)
Seat 4: RowCSpSURHTOL/dcjg/Iug (small blind) folded before Flop
Seat 5: rplyldNweS6YyMNEALQrug (big blind) collected ($35.45)
Seat 6: 686aeHikcJlgKkSuIFdcXQ folded before Flop (didn't bet)



PokerStars Game #59940187394:  Hold'em No Limit ($0.25/$0.50) - 2009/07/01 0:59:38 ET
Table 'c/CRn+68J3Y8KxD5g1ek2Q' 2-max Seat #1 is the button
Seat 1: 46qCyJ6evTkHo9al5sBMNA ($92 in chips)
Seat 2: BypVLsYQt3ePFm2xQL/dOA ($276.70 in chips)
46qCyJ6evTkHo9al5sBMNA: posts small blind $0.25
BypVLsYQt3ePFm2xQL/dOA: posts big blind $0.50
*** HOLE CARDS ***
46qCyJ6evTkHo9al5sBMNA: folds
BypVLsYQt3ePFm2xQL/dOA collected $0.50 from pot
BypVLsYQt3ePFm2xQL/dOA: doesn't show hand
*** SUMMARY ***
Total pot $0.50 | Rake $0
Seat 1: 46qCyJ6evTkHo9al5sBMNA (button) (small blind) folded before Flop
Seat 2: BypVLsYQt3ePFm2xQL/dOA (big blind) collected ($0.50)



PokerStars Game #59940187166:  Hold'em No Limit ($0.25/$0.50) - 2009/07/01 0:59:38 ET
Table '+dXkOAQyS8j9PQZusUTMpg' 2-max Seat #2 is the button
Seat 1: XFa6sBGjP2gxoIvxR3fZIg ($62.10 in chips)
Seat 2: 5IBeOgaApY1Bvzv2P8X4EA ($136.70 in chips)
5IBeOgaApY1Bvzv2P8X4EA: posts small blind $0.25
XFa6sBGjP2gxoIvxR3fZIg: posts big blind $0.50
*** HOLE CARDS ***
5IBeOgaApY1Bvzv2P8X4EA: folds
XFa6sBGjP2gxoIvxR3fZIg collected $0.50 from pot
*** SUMMARY ***
Total pot $0.50 | Rake $0
Seat 1: XFa6sBGjP2gxoIvxR3fZIg (big blind) collected ($0.50)
Seat 2: 5IBeOgaApY1Bvzv2P8X4EA (button) (small blind) folded before Flop



PokerStars Game #59940188406:  Hold'em No Limit ($0.25/$0.50) - 2009/07/01 0:59:40 ET
Table 'otvGDROEDdqsabxskT79qg' 9-max Seat #1 is the button
Seat 1: 8ehL7qlZzjgUh2H35iiWLw ($56.75 in chips)
Seat 2: cCjTzH9jio8607WzjcfXlg ($13.80 in chips)
Seat 3: +k7T5ocke8UwavtgUHm+Cg ($71.10 in chips)
Seat 4: MG90wfSJZnOejs/KD3vlQQ ($73.95 in chips)
Seat 6: bxLSulbgr8LmKNjOzw8URg ($53.70 in chips)
Seat 8: zE9cVigS2nW/Ljy4K4bUQA ($30 in chips)
Seat 9: KcY3X8YpD74Kw1RHkx/g4A ($53.65 in chips)
cCjTzH9jio8607WzjcfXlg: posts small blind $0.25
+k7T5ocke8UwavtgUHm+Cg: posts big blind $0.50
E2518gp4aFz1+kAgmGqeEg: sits out
75K2MXwN65Sjfp1yHd50Hg: sits out
*** HOLE CARDS ***
MG90wfSJZnOejs/KD3vlQQ: folds
bxLSulbgr8LmKNjOzw8URg: folds
zE9cVigS2nW/Ljy4K4bUQA: raises $1 to $1.50
KcY3X8YpD74Kw1RHkx/g4A: folds
8ehL7qlZzjgUh2H35iiWLw: folds
cCjTzH9jio8607WzjcfXlg: folds
+k7T5ocke8UwavtgUHm+Cg: folds
zE9cVigS2nW/Ljy4K4bUQA collected $1.25 from pot
zE9cVigS2nW/Ljy4K4bUQA: doesn't show hand
*** SUMMARY ***
Total pot $1.25 | Rake $0
Seat 1: 8ehL7qlZzjgUh2H35iiWLw (button) folded before Flop (didn't bet)
Seat 2: cCjTzH9jio8607WzjcfXlg (small blind) folded before Flop
Seat 3: +k7T5ocke8UwavtgUHm+Cg (big blind) folded before Flop
Seat 4: MG90wfSJZnOejs/KD3vlQQ folded before Flop (didn't bet)
Seat 6: bxLSulbgr8LmKNjOzw8URg folded before Flop (didn't bet)
Seat 8: zE9cVigS2nW/Ljy4K4bUQA collected ($1.25)
Seat 9: KcY3X8YpD74Kw1RHkx/g4A folded before Flop (didn't bet)



PokerStars Game #59940189060:  Hold'em No Limit ($0.25/$0.50) - 2009/07/01 0:59:41 ET
Table '0eJtgVAXVvBgncFdcUpXcQ' 2-max Seat #2 is the button
Seat 1: Ag6DvxX4vbRheqsv2zXKTQ ($36.05 in chips)
Seat 2: KMc4R+K9ao4Ur3rF7NGe6Q ($12.90 in chips)
KMc4R+K9ao4Ur3rF7NGe6Q: posts small blind $0.25
Ag6DvxX4vbRheqsv2zXKTQ: posts big blind $0.50
*** HOLE CARDS ***
KMc4R+K9ao4Ur3rF7NGe6Q: calls $0.25
Ag6DvxX4vbRheqsv2zXKTQ: checks
*** FLOP *** [8h 6d Js]
Ag6DvxX4vbRheqsv2zXKTQ: checks
KMc4R+K9ao4Ur3rF7NGe6Q: bets $1
Ag6DvxX4vbRheqsv2zXKTQ: folds
KMc4R+K9ao4Ur3rF7NGe6Q collected $0.95 from pot
KMc4R+K9ao4Ur3rF7NGe6Q: doesn't show hand
*** SUMMARY ***
Total pot $1 | Rake $0.05
Board [8h 6d Js]
Seat 1: Ag6DvxX4vbRheqsv2zXKTQ (big blind) folded on the Flop
Seat 2: KMc4R+K9ao4Ur3rF7NGe6Q (button) (small blind) collected ($0.95)



PokerStars Game #59940190220:  Hold'em No Limit ($0.25/$0.50) - 2009/07/01 0:59:43 ET
Table 'kgbJRsxfv64KrErDRBAkcw' 6-max Seat #2 is the button
Seat 2: AdS8BJMOheS01zjCDfPMFg ($48.50 in chips)
Seat 3: c4MNIaIyPMOMxrgT8FT5nA ($131.25 in chips)
Seat 4: qanMEqjABjWxC/JgQ/0l7w ($57.25 in chips)
Seat 5: eUBBn2R56C1IQ6Cs/vitwg ($56 in chips)
Seat 6: 1b+2BbjMN8qhR1WPqdE9VQ ($52.65 in chips)
c4MNIaIyPMOMxrgT8FT5nA: posts small blind $0.25
qanMEqjABjWxC/JgQ/0l7w: posts big blind $0.50
*** HOLE CARDS ***
bebehottie leaves the table
eUBBn2R56C1IQ6Cs/vitwg has timed out
eUBBn2R56C1IQ6Cs/vitwg: folds
eUBBn2R56C1IQ6Cs/vitwg is sitting out
eUBBn2R56C1IQ6Cs/vitwg has returned
1b+2BbjMN8qhR1WPqdE9VQ: folds
AdS8BJMOheS01zjCDfPMFg: raises $1 to $1.50
VamsyhlFzXGF6/ydo0BHeA joins the table at seat #1
c4MNIaIyPMOMxrgT8FT5nA: raises $4 to $5.50
qanMEqjABjWxC/JgQ/0l7w: folds
AdS8BJMOheS01zjCDfPMFg: folds
c4MNIaIyPMOMxrgT8FT5nA collected $3.50 from pot
c4MNIaIyPMOMxrgT8FT5nA: doesn't show hand
*** SUMMARY ***
Total pot $3.50 | Rake $0
Seat 2: AdS8BJMOheS01zjCDfPMFg (button) folded before Flop
Seat 3: c4MNIaIyPMOMxrgT8FT5nA (small blind) collected ($3.50)
Seat 4: qanMEqjABjWxC/JgQ/0l7w (big blind) folded before Flop
Seat 5: eUBBn2R56C1IQ6Cs/vitwg folded before Flop (didn't bet)
Seat 6: 1b+2BbjMN8qhR1WPqdE9VQ folded before Flop (didn't bet)



PokerStars Game #59940191004:  Hold'em No Limit ($0.25/$0.50) - 2009/07/01 0:59:44 ET
Table 'X6IRCRTh+20gjz8aubWnwA' 9-max Seat #5 is the button
Seat 1: DSM67hHHq1XFoEOi9p8Alw ($49.05 in chips)
Seat 2: HZkVla4kK2SI42CVrPZ/ig ($7.55 in chips)
Seat 3: SWv01peOe69QQRvhQTqjQw ($8.15 in chips)
Seat 4: M3JFBNQ8Bbw3FBZ/18MuXw ($14.45 in chips)
Seat 5: NnQCepdIR/AOUQn1yhYx6Q ($9.25 in chips)
Seat 6: 75K2MXwN65Sjfp1yHd50Hg ($9.50 in chips)
Seat 7: cFHQjKQOOKTUzoilhrXHLg ($45.25 in chips)
Seat 8: HxeBVq06/3Bh/H986sgdbw ($24 in chips)
Seat 9: M+7+BTmX5vZatHVuoRB1nA ($46.75 in chips)
75K2MXwN65Sjfp1yHd50Hg: posts small blind $0.25
cFHQjKQOOKTUzoilhrXHLg: posts big blind $0.50
*** HOLE CARDS ***
HxeBVq06/3Bh/H986sgdbw: folds
M+7+BTmX5vZatHVuoRB1nA: folds
DSM67hHHq1XFoEOi9p8Alw: folds
HZkVla4kK2SI42CVrPZ/ig: folds
SWv01peOe69QQRvhQTqjQw: calls $0.50
M3JFBNQ8Bbw3FBZ/18MuXw: folds
NnQCepdIR/AOUQn1yhYx6Q: folds
75K2MXwN65Sjfp1yHd50Hg: folds
cFHQjKQOOKTUzoilhrXHLg: checks
*** FLOP *** [Th 4d 8d]
cFHQjKQOOKTUzoilhrXHLg: checks
SWv01peOe69QQRvhQTqjQw: bets $1
cFHQjKQOOKTUzoilhrXHLg: calls $1
*** TURN *** [Th 4d 8d] [9h]
cFHQjKQOOKTUzoilhrXHLg: checks
SWv01peOe69QQRvhQTqjQw: bets $1
cFHQjKQOOKTUzoilhrXHLg: folds
SWv01peOe69QQRvhQTqjQw collected $3.10 from pot
SWv01peOe69QQRvhQTqjQw: doesn't show hand
*** SUMMARY ***
Total pot $3.25 | Rake $0.15
Board [Th 4d 8d 9h]
Seat 1: DSM67hHHq1XFoEOi9p8Alw folded before Flop (didn't bet)
Seat 2: HZkVla4kK2SI42CVrPZ/ig folded before Flop (didn't bet)
Seat 3: SWv01peOe69QQRvhQTqjQw collected ($3.10)
Seat 4: M3JFBNQ8Bbw3FBZ/18MuXw folded before Flop (didn't bet)
Seat 5: NnQCepdIR/AOUQn1yhYx6Q (button) folded before Flop (didn't bet)
Seat 6: 75K2MXwN65Sjfp1yHd50Hg (small blind) folded before Flop
Seat 7: cFHQjKQOOKTUzoilhrXHLg (big blind) folded on the Turn
Seat 8: HxeBVq06/3Bh/H986sgdbw folded before Flop (didn't bet)
Seat 9: M+7+BTmX5vZatHVuoRB1nA folded before Flop (didn't bet)



PokerStars Game #59940191372:  Hold'em No Limit ($0.25/$0.50) - 2009/07/01 0:59:45 ET
Table '+dXkOAQyS8j9PQZusUTMpg' 2-max Seat #1 is the button
Seat 1: XFa6sBGjP2gxoIvxR3fZIg ($62.35 in chips)
Seat 2: 5IBeOgaApY1Bvzv2P8X4EA ($136.45 in chips)
XFa6sBGjP2gxoIvxR3fZIg: posts small blind $0.25
5IBeOgaApY1Bvzv2P8X4EA: posts big blind $0.50
*** HOLE CARDS ***
XFa6sBGjP2gxoIvxR3fZIg: raises $1 to $1.50
5IBeOgaApY1Bvzv2P8X4EA: folds
XFa6sBGjP2gxoIvxR3fZIg collected $1 from pot
*** SUMMARY ***
Total pot $1 | Rake $0
Seat 1: XFa6sBGjP2gxoIvxR3fZIg (button) (small blind) collected ($1)
Seat 2: 5IBeOgaApY1Bvzv2P8X4EA (big blind) folded before Flop



PokerStars Game #59940191954:  Hold'em No Limit ($0.25/$0.50) - 2009/07/01 0:59:46 ET
Table 'c/CRn+68J3Y8KxD5g1ek2Q' 2-max Seat #2 is the button
Seat 1: 46qCyJ6evTkHo9al5sBMNA ($91.75 in chips)
Seat 2: BypVLsYQt3ePFm2xQL/dOA ($276.95 in chips)
BypVLsYQt3ePFm2xQL/dOA: posts small blind $0.25
46qCyJ6evTkHo9al5sBMNA: posts big blind $0.50
*** HOLE CARDS ***
BypVLsYQt3ePFm2xQL/dOA: calls $0.25
46qCyJ6evTkHo9al5sBMNA: checks
*** FLOP *** [5c 4h Kh]
46qCyJ6evTkHo9al5sBMNA: checks
BypVLsYQt3ePFm2xQL/dOA: checks
*** TURN *** [5c 4h Kh] [Qs]
46qCyJ6evTkHo9al5sBMNA: checks
BypVLsYQt3ePFm2xQL/dOA: bets $0.50
46qCyJ6evTkHo9al5sBMNA: calls $0.50
*** RIVER *** [5c 4h Kh Qs] [5d]
46qCyJ6evTkHo9al5sBMNA: bets $1
BypVLsYQt3ePFm2xQL/dOA: folds
46qCyJ6evTkHo9al5sBMNA collected $1.95 from pot
46qCyJ6evTkHo9al5sBMNA: doesn't show hand
*** SUMMARY ***
Total pot $2 | Rake $0.05
Board [5c 4h Kh Qs 5d]
Seat 1: 46qCyJ6evTkHo9al5sBMNA (big blind) collected ($1.95)
Seat 2: BypVLsYQt3ePFm2xQL/dOA (button) (small blind) folded on the River



PokerStars Game #59940192018:  Hold'em No Limit ($0.25/$0.50) - 2009/07/01 0:59:46 ET
Table 'BCN5su+SsXiy1zRMJi0SJw' 6-max Seat #3 is the button
Seat 1: GxXV09ciXaOxyY2H5aMIIw ($32.40 in chips)
Seat 2: oU2kDCkT/gilYbHWrg7D8w ($35.75 in chips)
Seat 3: 6wzJiRvp8HY6t+MQGnSIzA ($23.35 in chips)
Seat 4: qfeUHOJpMYyzQcj0o2A7ng ($10.25 in chips)
Seat 5: IBNygaT1aa9Z1uPdJJilwA ($30.85 in chips)
Seat 6: b2symlOdL7+0c9Pj4N/KlA ($65 in chips)
qfeUHOJpMYyzQcj0o2A7ng: posts small blind $0.25
IBNygaT1aa9Z1uPdJJilwA: posts big blind $0.50
*** HOLE CARDS ***
b2symlOdL7+0c9Pj4N/KlA: folds
GxXV09ciXaOxyY2H5aMIIw: folds
oU2kDCkT/gilYbHWrg7D8w: calls $0.50
6wzJiRvp8HY6t+MQGnSIzA: raises $1.50 to $2
qfeUHOJpMYyzQcj0o2A7ng: calls $1.75
IBNygaT1aa9Z1uPdJJilwA: folds
oU2kDCkT/gilYbHWrg7D8w: calls $1.50
*** FLOP *** [6c 8s Jd]
qfeUHOJpMYyzQcj0o2A7ng: checks
oU2kDCkT/gilYbHWrg7D8w: checks
6wzJiRvp8HY6t+MQGnSIzA: checks
*** TURN *** [6c 8s Jd] [7c]
qfeUHOJpMYyzQcj0o2A7ng: bets $2.50
oU2kDCkT/gilYbHWrg7D8w: calls $2.50
6wzJiRvp8HY6t+MQGnSIzA: calls $2.50
*** RIVER *** [6c 8s Jd 7c] [9h]
qfeUHOJpMYyzQcj0o2A7ng: checks
oU2kDCkT/gilYbHWrg7D8w: bets $5
6wzJiRvp8HY6t+MQGnSIzA: folds
qfeUHOJpMYyzQcj0o2A7ng said, "so ****ing sick"
qfeUHOJpMYyzQcj0o2A7ng: folds
oU2kDCkT/gilYbHWrg7D8w collected $13.35 from pot
oU2kDCkT/gilYbHWrg7D8w: shows [8d Td] (a straight, Seven to Jack)
*** SUMMARY ***
Total pot $14 | Rake $0.65
Board [6c 8s Jd 7c 9h]
Seat 1: GxXV09ciXaOxyY2H5aMIIw folded before Flop (didn't bet)
Seat 2: oU2kDCkT/gilYbHWrg7D8w collected ($13.35)
Seat 3: 6wzJiRvp8HY6t+MQGnSIzA (button) folded on the River
Seat 4: qfeUHOJpMYyzQcj0o2A7ng (small blind) folded on the River
Seat 5: IBNygaT1aa9Z1uPdJJilwA (big blind) folded before Flop
Seat 6: b2symlOdL7+0c9Pj4N/KlA folded before Flop (didn't bet)



PokerStars Game #59940193164:  Hold'em No Limit ($0.25/$0.50) - 2009/07/01 0:59:48 ET
Table '9Puy2HWN1RQe5SSjq162gA' 2-max Seat #2 is the button
Seat 1: Fp/oksNpipCrD2MJ2pH20g ($14.55 in chips)
Seat 2: tDV+zhxH9+3DkJDzoTERyg ($23.30 in chips)
tDV+zhxH9+3DkJDzoTERyg: posts small blind $0.25
Fp/oksNpipCrD2MJ2pH20g: posts big blind $0.50
*** HOLE CARDS ***
tDV+zhxH9+3DkJDzoTERyg: raises $1 to $1.50
Fp/oksNpipCrD2MJ2pH20g: raises $13.05 to $14.55 and is all-in
tDV+zhxH9+3DkJDzoTERyg: calls $13.05
*** FLOP *** [8c 8d 5s]
*** TURN *** [8c 8d 5s] [Ac]
*** RIVER *** [8c 8d 5s Ac] [9c]
*** SHOW DOWN ***
Fp/oksNpipCrD2MJ2pH20g: shows [Kc Js] (a pair of Eights)
tDV+zhxH9+3DkJDzoTERyg: shows [Jh 5h] (two pair, Eights and Fives)
tDV+zhxH9+3DkJDzoTERyg collected $28.60 from pot
tDV+zhxH9+3DkJDzoTERyg said, "lol ***got........."
*** SUMMARY ***
Total pot $29.10 | Rake $0.50
Board [8c 8d 5s Ac 9c]
Seat 1: Fp/oksNpipCrD2MJ2pH20g (big blind) showed [Kc Js] and lost with a pair of Eights
Seat 2: tDV+zhxH9+3DkJDzoTERyg (button) (small blind) showed [Jh 5h] and won ($28.60) with two pair, Eights and Fives



PokerStars Game #59940194760:  Hold'em No Limit ($0.25/$0.50) - 2009/07/01 0:59:50 ET
Table 'GfL/No5u5PoEnU39lP5pQg' 6-max Seat #4 is the button
Seat 1: 1WUCqNG+p+vfWRTXNu4ljw ($50 in chips)
Seat 2: uVwggSetzp7d+eVgowO3vg ($57 in chips)
Seat 3: eQXFICMuu3hw6XlcmuVNEA ($14.05 in chips)
Seat 4: r6u7MWSXF30/khcTYkrG9Q ($32.70 in chips)
Seat 5: M1KyQQvVPVuxqTAB8sR/zQ ($51 in chips)
Seat 6: kxPhs4ePFqMy52CInAJ2aw ($56.50 in chips)
M1KyQQvVPVuxqTAB8sR/zQ: posts small blind $0.25
kxPhs4ePFqMy52CInAJ2aw: posts big blind $0.50
*** HOLE CARDS ***
1WUCqNG+p+vfWRTXNu4ljw: raises $1.50 to $2
uVwggSetzp7d+eVgowO3vg: folds
eQXFICMuu3hw6XlcmuVNEA: folds
r6u7MWSXF30/khcTYkrG9Q: folds
M1KyQQvVPVuxqTAB8sR/zQ: folds
kxPhs4ePFqMy52CInAJ2aw: calls $1.50
*** FLOP *** [4c Tc 7c]
kxPhs4ePFqMy52CInAJ2aw: checks
1WUCqNG+p+vfWRTXNu4ljw: checks
*** TURN *** [4c Tc 7c] [9h]
kxPhs4ePFqMy52CInAJ2aw: bets $3
1WUCqNG+p+vfWRTXNu4ljw: calls $3
*** RIVER *** [4c Tc 7c 9h] [7d]
kxPhs4ePFqMy52CInAJ2aw: bets $6
1WUCqNG+p+vfWRTXNu4ljw: calls $6
*** SHOW DOWN ***
kxPhs4ePFqMy52CInAJ2aw: shows [8s 8d] (two pair, Eights and Sevens)
1WUCqNG+p+vfWRTXNu4ljw: shows [Kd Ks] (two pair, Kings and Sevens)
1WUCqNG+p+vfWRTXNu4ljw collected $21.20 from pot
*** SUMMARY ***
Total pot $22.25 | Rake $1.05
Board [4c Tc 7c 9h 7d]
Seat 1: 1WUCqNG+p+vfWRTXNu4ljw showed [Kd Ks] and won ($21.20) with two pair, Kings and Sevens
Seat 2: uVwggSetzp7d+eVgowO3vg folded before Flop (didn't bet)
Seat 3: eQXFICMuu3hw6XlcmuVNEA folded before Flop (didn't bet)
Seat 4: r6u7MWSXF30/khcTYkrG9Q (button) folded before Flop (didn't bet)
Seat 5: M1KyQQvVPVuxqTAB8sR/zQ (small blind) folded before Flop
Seat 6: kxPhs4ePFqMy52CInAJ2aw (big blind) showed [8s 8d] and lost with two pair, Eights and Sevens



PokerStars Game #59940195168:  Hold'em No Limit ($0.25/$0.50) - 2009/07/01 0:59:51 ET
Table 'lSisgp6H7Fg1hH5VfjEjYQ' 9-max Seat #7 is the button
Seat 1: 5k9fvXD9suIgCxU4HLQjTw ($50 in chips)
Seat 2: UrcnkQOiLVk8BlKDPJSy7Q ($76.60 in chips)
Seat 3: aTkyjTh3w5YLWiIERupZOA ($51.95 in chips)
Seat 4: bwv/rbH/hHhPhY6u9mu04w ($31.60 in chips)
Seat 5: mSD1pginDsyHG5PDfqzphw ($10 in chips)
Seat 6: +k7T5ocke8UwavtgUHm+Cg ($67.05 in chips)
Seat 7: IDtNLR9uFCDdjNsJWMHA5Q ($19.80 in chips)
Seat 8: a4JDWmpFQkL10XfAyuF51A ($28.50 in chips)
a4JDWmpFQkL10XfAyuF51A: posts small blind $0.25
5k9fvXD9suIgCxU4HLQjTw: posts big blind $0.50
*** HOLE CARDS ***
UrcnkQOiLVk8BlKDPJSy7Q: folds
aTkyjTh3w5YLWiIERupZOA: folds
bwv/rbH/hHhPhY6u9mu04w: folds
mSD1pginDsyHG5PDfqzphw: folds
+k7T5ocke8UwavtgUHm+Cg: raises $1 to $1.50
IDtNLR9uFCDdjNsJWMHA5Q: folds
a4JDWmpFQkL10XfAyuF51A: folds
tkflckdgk joins the table at seat #9
5k9fvXD9suIgCxU4HLQjTw: folds
+k7T5ocke8UwavtgUHm+Cg collected $1.25 from pot
+k7T5ocke8UwavtgUHm+Cg: doesn't show hand
*** SUMMARY ***
Total pot $1.25 | Rake $0
Seat 1: 5k9fvXD9suIgCxU4HLQjTw (big blind) folded before Flop
Seat 2: UrcnkQOiLVk8BlKDPJSy7Q folded before Flop (didn't bet)
Seat 3: aTkyjTh3w5YLWiIERupZOA folded before Flop (didn't bet)
Seat 4: bwv/rbH/hHhPhY6u9mu04w folded before Flop (didn't bet)
Seat 5: mSD1pginDsyHG5PDfqzphw folded before Flop (didn't bet)
Seat 6: +k7T5ocke8UwavtgUHm+Cg collected ($1.25)
Seat 7: IDtNLR9uFCDdjNsJWMHA5Q (button) folded before Flop (didn't bet)
Seat 8: a4JDWmpFQkL10XfAyuF51A (small blind) folded before Flop



PokerStars Game #59940195638:  Hold'em No Limit ($0.25/$0.50) - 2009/07/01 0:59:52 ET
Table '0eJtgVAXVvBgncFdcUpXcQ' 2-max Seat #1 is the button
Seat 1: Ag6DvxX4vbRheqsv2zXKTQ ($35.55 in chips)
Seat 2: KMc4R+K9ao4Ur3rF7NGe6Q ($13.35 in chips)
Ag6DvxX4vbRheqsv2zXKTQ: posts small blind $0.25
KMc4R+K9ao4Ur3rF7NGe6Q: posts big blind $0.50
*** HOLE CARDS ***
Ag6DvxX4vbRheqsv2zXKTQ: raises $1 to $1.50
KMc4R+K9ao4Ur3rF7NGe6Q: calls $1
*** FLOP *** [Js 3c Tc]
KMc4R+K9ao4Ur3rF7NGe6Q: bets $1
Ag6DvxX4vbRheqsv2zXKTQ: calls $1
*** TURN *** [Js 3c Tc] [6s]
KMc4R+K9ao4Ur3rF7NGe6Q: bets $2
Ag6DvxX4vbRheqsv2zXKTQ: folds
KMc4R+K9ao4Ur3rF7NGe6Q collected $4.80 from pot
KMc4R+K9ao4Ur3rF7NGe6Q: doesn't show hand
*** SUMMARY ***
Total pot $5 | Rake $0.20
Board [Js 3c Tc 6s]
Seat 1: Ag6DvxX4vbRheqsv2zXKTQ (button) (small blind) folded on the Turn
Seat 2: KMc4R+K9ao4Ur3rF7NGe6Q (big blind) collected ($4.80)



PokerStars Game #59940196220:  Hold'em No Limit ($0.25/$0.50) - 2009/07/01 0:59:53 ET
Table '+dXkOAQyS8j9PQZusUTMpg' 2-max Seat #2 is the button
Seat 1: XFa6sBGjP2gxoIvxR3fZIg ($62.85 in chips)
Seat 2: 5IBeOgaApY1Bvzv2P8X4EA ($135.95 in chips)
5IBeOgaApY1Bvzv2P8X4EA: posts small blind $0.25
XFa6sBGjP2gxoIvxR3fZIg: posts big blind $0.50
*** HOLE CARDS ***
5IBeOgaApY1Bvzv2P8X4EA: folds
XFa6sBGjP2gxoIvxR3fZIg collected $0.50 from pot
*** SUMMARY ***
Total pot $0.50 | Rake $0
Seat 1: XFa6sBGjP2gxoIvxR3fZIg (big blind) collected ($0.50)
Seat 2: 5IBeOgaApY1Bvzv2P8X4EA (button) (small blind) folded before Flop



PokerStars Game #59940198168:  Hold'em No Limit ($0.25/$0.50) - 2009/07/01 0:59:56 ET
Table '5EmHi+fnatGQQShcNmzOZQ' 6-max Seat #6 is the button
Seat 1: My8WkRtGx5FW6rJ1I4R3hg ($10.10 in chips)
Seat 2: bfFjgAtIoAI+pUxUwFt3aQ ($50 in chips)
Seat 3: TjmTe3bhs9dFz5gXX9x7Lw ($24.15 in chips)
Seat 4: 1b+2BbjMN8qhR1WPqdE9VQ ($63.25 in chips)
Seat 5: kxPhs4ePFqMy52CInAJ2aw ($82.80 in chips)
Seat 6: 686aeHikcJlgKkSuIFdcXQ ($131.75 in chips)
My8WkRtGx5FW6rJ1I4R3hg: posts small blind $0.25
bfFjgAtIoAI+pUxUwFt3aQ: posts big blind $0.50
*** HOLE CARDS ***
TjmTe3bhs9dFz5gXX9x7Lw: calls $0.50
1b+2BbjMN8qhR1WPqdE9VQ: raises $1.50 to $2
kxPhs4ePFqMy52CInAJ2aw: folds
686aeHikcJlgKkSuIFdcXQ: folds
My8WkRtGx5FW6rJ1I4R3hg: folds
bfFjgAtIoAI+pUxUwFt3aQ: folds
TjmTe3bhs9dFz5gXX9x7Lw: calls $1.50
*** FLOP *** [6c 6s 2s]
TjmTe3bhs9dFz5gXX9x7Lw: checks
1b+2BbjMN8qhR1WPqdE9VQ: bets $3.25
TjmTe3bhs9dFz5gXX9x7Lw: folds
1b+2BbjMN8qhR1WPqdE9VQ collected $4.55 from pot
*** SUMMARY ***
Total pot $4.75 | Rake $0.20
Board [6c 6s 2s]
Seat 1: My8WkRtGx5FW6rJ1I4R3hg (small blind) folded before Flop
Seat 2: bfFjgAtIoAI+pUxUwFt3aQ (big blind) folded before Flop
Seat 3: TjmTe3bhs9dFz5gXX9x7Lw folded on the Flop
Seat 4: 1b+2BbjMN8qhR1WPqdE9VQ collected ($4.55)
Seat 5: kxPhs4ePFqMy52CInAJ2aw folded before Flop (didn't bet)
Seat 6: 686aeHikcJlgKkSuIFdcXQ (button) folded before Flop (didn't bet)



PokerStars Game #59940198480:  Hold'em No Limit ($0.25/$0.50) - 2009/07/01 0:59:56 ET
Table 'Nz0Vr7WMHL2g5Uk7dDZjpw' 9-max Seat #7 is the button
Seat 1: tLkxo7JgV+WWI0UBw44K5A ($109.85 in chips)
Seat 3: uw9QayAAxLM3Hb+HR7mSkg ($10 in chips)
Seat 4: E2518gp4aFz1+kAgmGqeEg ($11.50 in chips)
Seat 5: WGW0DgjBUXs1ylURHG8vnQ ($27.90 in chips)
Seat 6: 997ViqAtWn1FPjJqcffwcA ($60.55 in chips)
Seat 7: KPLH0gELgFe2OuAnhJFI5w ($15.85 in chips)
Seat 8: HkZI6g4zl83TDTA7SRspmQ ($16.85 in chips)
Seat 9: mSD1pginDsyHG5PDfqzphw ($10 in chips)
HkZI6g4zl83TDTA7SRspmQ: posts small blind $0.25
mSD1pginDsyHG5PDfqzphw: posts big blind $0.50
gsyXT42WLEcOS4DdEk2wlw: sits out
*** HOLE CARDS ***
tLkxo7JgV+WWI0UBw44K5A: folds
uw9QayAAxLM3Hb+HR7mSkg: folds
E2518gp4aFz1+kAgmGqeEg: folds
WGW0DgjBUXs1ylURHG8vnQ: folds
997ViqAtWn1FPjJqcffwcA: folds
KPLH0gELgFe2OuAnhJFI5w: calls $0.50
HkZI6g4zl83TDTA7SRspmQ: calls $0.25
mSD1pginDsyHG5PDfqzphw: checks
*** FLOP *** [3s 5s Qd]
HkZI6g4zl83TDTA7SRspmQ: checks
mSD1pginDsyHG5PDfqzphw: checks
KPLH0gELgFe2OuAnhJFI5w: checks
*** TURN *** [3s 5s Qd] [Ac]
HkZI6g4zl83TDTA7SRspmQ: checks
mSD1pginDsyHG5PDfqzphw: checks
KPLH0gELgFe2OuAnhJFI5w: checks
*** RIVER *** [3s 5s Qd Ac] [5h]
HkZI6g4zl83TDTA7SRspmQ: bets $10
mSD1pginDsyHG5PDfqzphw: folds
KPLH0gELgFe2OuAnhJFI5w: folds
HkZI6g4zl83TDTA7SRspmQ collected $1.45 from pot
*** SUMMARY ***
Total pot $1.50 | Rake $0.05
Board [3s 5s Qd Ac 5h]
Seat 1: tLkxo7JgV+WWI0UBw44K5A folded before Flop (didn't bet)
Seat 3: uw9QayAAxLM3Hb+HR7mSkg folded before Flop (didn't bet)
Seat 4: E2518gp4aFz1+kAgmGqeEg folded before Flop (didn't bet)
Seat 5: WGW0DgjBUXs1ylURHG8vnQ folded before Flop (didn't bet)
Seat 6: 997ViqAtWn1FPjJqcffwcA folded before Flop (didn't bet)
Seat 7: KPLH0gELgFe2OuAnhJFI5w (button) folded on the River
Seat 8: HkZI6g4zl83TDTA7SRspmQ (small blind) collected ($1.45)
Seat 9: mSD1pginDsyHG5PDfqzphw (big blind) folded on the River



PokerStars Game #59940198014:  Hold'em No Limit ($0.25/$0.50) - 2009/07/01 0:59:56 ET
Table 'NCiXr0d5CEKBQr/cZgLhbA' 9-max Seat #7 is the button
Seat 1: pFtzb1sR4b0d1aw6aIRgDg ($50 in chips)
Seat 2: ulxuJchBV9iguXg0FUonfg ($51.45 in chips)
Seat 3: xZCXQSXlrZkp3pZizzVXCw ($52.70 in chips)
Seat 4: 5k9fvXD9suIgCxU4HLQjTw ($55.20 in chips)
Seat 5: zE9cVigS2nW/Ljy4K4bUQA ($31.70 in chips)
Seat 6: SKnJuWHScqetA/qG5p+wCg ($32.75 in chips)
Seat 7: M+7+BTmX5vZatHVuoRB1nA ($52 in chips)
Seat 8: 1MJUKc3cc0QmUoz1JZLR2w ($64.30 in chips)
Seat 9: 4WLZvqBn5qv5tds5kt5A1Q ($39.50 in chips)
1MJUKc3cc0QmUoz1JZLR2w: posts small blind $0.25
4WLZvqBn5qv5tds5kt5A1Q: posts big blind $0.50
*** HOLE CARDS ***
pFtzb1sR4b0d1aw6aIRgDg: folds
ulxuJchBV9iguXg0FUonfg: folds
xZCXQSXlrZkp3pZizzVXCw: folds
5k9fvXD9suIgCxU4HLQjTw: folds
zE9cVigS2nW/Ljy4K4bUQA: raises $1 to $1.50
SKnJuWHScqetA/qG5p+wCg: folds
M+7+BTmX5vZatHVuoRB1nA: folds
1MJUKc3cc0QmUoz1JZLR2w: folds
4WLZvqBn5qv5tds5kt5A1Q: calls $1
*** FLOP *** [Kd 4c 5s]
4WLZvqBn5qv5tds5kt5A1Q: checks
zE9cVigS2nW/Ljy4K4bUQA: bets $2
4WLZvqBn5qv5tds5kt5A1Q: folds
zE9cVigS2nW/Ljy4K4bUQA collected $3.10 from pot
*** SUMMARY ***
Total pot $3.25 | Rake $0.15
Board [Kd 4c 5s]
Seat 1: pFtzb1sR4b0d1aw6aIRgDg folded before Flop (didn't bet)
Seat 2: ulxuJchBV9iguXg0FUonfg folded before Flop (didn't bet)
Seat 3: xZCXQSXlrZkp3pZizzVXCw folded before Flop (didn't bet)
Seat 4: 5k9fvXD9suIgCxU4HLQjTw folded before Flop (didn't bet)
Seat 5: zE9cVigS2nW/Ljy4K4bUQA collected ($3.10)
Seat 6: SKnJuWHScqetA/qG5p+wCg folded before Flop (didn't bet)
Seat 7: M+7+BTmX5vZatHVuoRB1nA (button) folded before Flop (didn't bet)
Seat 8: 1MJUKc3cc0QmUoz1JZLR2w (small blind) folded before Flop
Seat 9: 4WLZvqBn5qv5tds5kt5A1Q (big blind) folded on the Flop



PokerStars Game #59940198356:  Hold'em No Limit ($0.25/$0.50) - 2009/07/01 0:59:56 ET
Table '/cQuAT3ef4t+PGrXiNhGaQ' 9-max Seat #7 is the button
Seat 1: HZkVla4kK2SI42CVrPZ/ig ($15 in chips)
Seat 2: jXGruyaMqirTaTXNOvBdew ($71.95 in chips)
Seat 3: g4k0NXISyLCqaSWZDBjfEg ($54.25 in chips)
Seat 4: OWP/DOu+PlPK6ZZ3zYa0HA ($24.40 in chips)
Seat 5: 5SgaHdWixdClWvaEG+KUjQ ($15.85 in chips)
Seat 6: APYIOyK/4AGb+kIwlOUNBQ ($36.50 in chips)
Seat 7: J0W5D97jl5VLky+IoPvDeA ($110.65 in chips)
Seat 8: eBrej2jnlUCs/JgxFCRn2g ($52.05 in chips)
Seat 9: AjV5McH1KMMclY26QdLM5w ($26.45 in chips)
eBrej2jnlUCs/JgxFCRn2g: posts small blind $0.25
AjV5McH1KMMclY26QdLM5w: posts big blind $0.50
*** HOLE CARDS ***
HZkVla4kK2SI42CVrPZ/ig: folds
jXGruyaMqirTaTXNOvBdew: raises $1 to $1.50
g4k0NXISyLCqaSWZDBjfEg: folds
OWP/DOu+PlPK6ZZ3zYa0HA: folds
5SgaHdWixdClWvaEG+KUjQ: folds
APYIOyK/4AGb+kIwlOUNBQ: folds
J0W5D97jl5VLky+IoPvDeA: folds
eBrej2jnlUCs/JgxFCRn2g: folds
AjV5McH1KMMclY26QdLM5w: folds
jXGruyaMqirTaTXNOvBdew collected $1.25 from pot
*** SUMMARY ***
Total pot $1.25 | Rake $0
Seat 1: HZkVla4kK2SI42CVrPZ/ig folded before Flop (didn't bet)
Seat 2: jXGruyaMqirTaTXNOvBdew collected ($1.25)
Seat 3: g4k0NXISyLCqaSWZDBjfEg folded before Flop (didn't bet)
Seat 4: OWP/DOu+PlPK6ZZ3zYa0HA folded before Flop (didn't bet)
Seat 5: 5SgaHdWixdClWvaEG+KUjQ folded before Flop (didn't bet)
Seat 6: APYIOyK/4AGb+kIwlOUNBQ folded before Flop (didn't bet)
Seat 7: J0W5D97jl5VLky+IoPvDeA (button) folded before Flop (didn't bet)
Seat 8: eBrej2jnlUCs/JgxFCRn2g (small blind) folded before Flop
Seat 9: AjV5McH1KMMclY26QdLM5w (big blind) folded before Flop



PokerStars Game #59940198678:  Hold'em No Limit ($0.25/$0.50) - 2009/07/01 0:59:57 ET
Table 'EiNh8p/wGJ1FP575iMFnqg' 9-max Seat #9 is the button
Seat 1: r3ZqM1Mi0W3y4hOdssE+Sg ($45.10 in chips)
Seat 2: 8ehL7qlZzjgUh2H35iiWLw ($52.60 in chips)
Seat 3: ymLPoEIl7UL3TvZYmnadxQ ($52.55 in chips)
Seat 4: cMzaiXAM/ZAdNaEUu+LqhA ($55.70 in chips)
Seat 5: M+7+BTmX5vZatHVuoRB1nA ($81.45 in chips)
Seat 6: 3UmXLy3GfjC3EkOebduerQ ($64.10 in chips)
Seat 7: 997ViqAtWn1FPjJqcffwcA ($50 in chips)
Seat 8: mSD1pginDsyHG5PDfqzphw ($10 in chips)
Seat 9: NnQCepdIR/AOUQn1yhYx6Q ($11.75 in chips)
r3ZqM1Mi0W3y4hOdssE+Sg: posts small blind $0.25
8ehL7qlZzjgUh2H35iiWLw: posts big blind $0.50
*** HOLE CARDS ***
ymLPoEIl7UL3TvZYmnadxQ: folds
cMzaiXAM/ZAdNaEUu+LqhA: folds
M+7+BTmX5vZatHVuoRB1nA: raises $1.50 to $2
3UmXLy3GfjC3EkOebduerQ: folds
997ViqAtWn1FPjJqcffwcA: folds
mSD1pginDsyHG5PDfqzphw: folds
NnQCepdIR/AOUQn1yhYx6Q: folds
r3ZqM1Mi0W3y4hOdssE+Sg: folds
8ehL7qlZzjgUh2H35iiWLw: folds
M+7+BTmX5vZatHVuoRB1nA collected $1.25 from pot
M+7+BTmX5vZatHVuoRB1nA: doesn't show hand
*** SUMMARY ***
Total pot $1.25 | Rake $0
Seat 1: r3ZqM1Mi0W3y4hOdssE+Sg (small blind) folded before Flop
Seat 2: 8ehL7qlZzjgUh2H35iiWLw (big blind) folded before Flop
Seat 3: ymLPoEIl7UL3TvZYmnadxQ folded before Flop (didn't bet)
Seat 4: cMzaiXAM/ZAdNaEUu+LqhA folded before Flop (didn't bet)
Seat 5: M+7+BTmX5vZatHVuoRB1nA collected ($1.25)
Seat 6: 3UmXLy3GfjC3EkOebduerQ folded before Flop (didn't bet)
Seat 7: 997ViqAtWn1FPjJqcffwcA folded before Flop (didn't bet)
Seat 8: mSD1pginDsyHG5PDfqzphw folded before Flop (didn't bet)
Seat 9: NnQCepdIR/AOUQn1yhYx6Q (button) folded before Flop (didn't bet)



PokerStars Game #59940199978:  Hold'em No Limit ($0.25/$0.50) - 2009/07/01 0:59:59 ET
Table '+dXkOAQyS8j9PQZusUTMpg' 2-max Seat #1 is the button
Seat 1: XFa6sBGjP2gxoIvxR3fZIg ($63.10 in chips)
Seat 2: 5IBeOgaApY1Bvzv2P8X4EA ($135.70 in chips)
XFa6sBGjP2gxoIvxR3fZIg: posts small blind $0.25
5IBeOgaApY1Bvzv2P8X4EA: posts big blind $0.50
*** HOLE CARDS ***
XFa6sBGjP2gxoIvxR3fZIg: raises $1 to $1.50
5IBeOgaApY1Bvzv2P8X4EA: raises $1.50 to $3
XFa6sBGjP2gxoIvxR3fZIg: calls $1.50
*** FLOP *** [2c 7s 2s]
5IBeOgaApY1Bvzv2P8X4EA: bets $5.50
XFa6sBGjP2gxoIvxR3fZIg: folds
5IBeOgaApY1Bvzv2P8X4EA collected $5.70 from pot
5IBeOgaApY1Bvzv2P8X4EA: doesn't show hand
*** SUMMARY ***
Total pot $6 | Rake $0.30
Board [2c 7s 2s]
Seat 1: XFa6sBGjP2gxoIvxR3fZIg (button) (small blind) folded on the Flop
Seat 2: 5IBeOgaApY1Bvzv2P8X4EA (big blind) collected ($5.70)



PokerStars Game #59940201226:  Hold'em No Limit ($0.25/$0.50) - 2009/07/01 1:00:00 ET
Table '8BQGgNetI1NOvWeu3gtMNw' 2-max Seat #2 is the button
Seat 1: bypIyrYcAAifLfhZpGlKLA ($58.50 in chips)
Seat 2: Z4HwehErEwzsv/noQlfUlg ($143.45 in chips)
Z4HwehErEwzsv/noQlfUlg: posts small blind $0.25
bypIyrYcAAifLfhZpGlKLA: posts big blind $0.50
*** HOLE CARDS ***
Z4HwehErEwzsv/noQlfUlg: raises $1.50 to $2
bypIyrYcAAifLfhZpGlKLA: calls $1.50
*** FLOP *** [3d 7s 8d]
bypIyrYcAAifLfhZpGlKLA: checks
Z4HwehErEwzsv/noQlfUlg: checks
*** TURN *** [3d 7s 8d] [5c]
bypIyrYcAAifLfhZpGlKLA: checks
Z4HwehErEwzsv/noQlfUlg: bets $4
bypIyrYcAAifLfhZpGlKLA: folds
Z4HwehErEwzsv/noQlfUlg collected $3.80 from pot
Z4HwehErEwzsv/noQlfUlg: doesn't show hand
*** SUMMARY ***
Total pot $4 | Rake $0.20
Board [3d 7s 8d 5c]
Seat 1: bypIyrYcAAifLfhZpGlKLA (big blind) folded on the Turn
Seat 2: Z4HwehErEwzsv/noQlfUlg (button) (small blind) collected ($3.80)



PokerStars Game #59940202380:  Hold'em No Limit ($0.25/$0.50) - 2009/07/01 1:00:02 ET
Table 'E7bWJ45aoFXRpyRv2gw+Ig99gCy/CZQwPIjZWH+BguQgeat #6 is the button
Seat 2: n6VQBu6crjYjy6DxNP1NZA ($28.75 in chips)
Seat 3: qEn9ijNGtuyTxamBf07hYg ($50 in chips)
Seat 4: bxLSulbgr8LmKNjOzw8URg ($62.95 in chips)
Seat 6: OcnLOMVFdy23jXnoTyaO5Q ($265.65 in chips)
Seat 7: bfSq6LBw0UvxeM5yfuWC7w ($17.35 in chips)
Seat 8: 8ehL7qlZzjgUh2H35iiWLw ($51.75 in chips)
Seat 9: j3K/Jujr7PY4ZM2RZvlH6A ($77.45 in chips)
bfSq6LBw0UvxeM5yfuWC7w: posts small blind $0.25
8ehL7qlZzjgUh2H35iiWLw: posts big blind $0.50
YXCE3WOZi8g2sIf3y/plVw: sits out
*** HOLE CARDS ***
j3K/Jujr7PY4ZM2RZvlH6A: folds
n6VQBu6crjYjy6DxNP1NZA: folds
qEn9ijNGtuyTxamBf07hYg: folds
bxLSulbgr8LmKNjOzw8URg: folds
OcnLOMVFdy23jXnoTyaO5Q: calls $0.50
bfSq6LBw0UvxeM5yfuWC7w: raises $0.85 to $1.35
8ehL7qlZzjgUh2H35iiWLw: calls $0.85
OcnLOMVFdy23jXnoTyaO5Q: calls $0.85
*** FLOP *** [Th 3d 8h]
bfSq6LBw0UvxeM5yfuWC7w: bets $2
8ehL7qlZzjgUh2H35iiWLw: folds
OcnLOMVFdy23jXnoTyaO5Q: folds
bfSq6LBw0UvxeM5yfuWC7w collected $3.85 from pot
*** SUMMARY ***
Total pot $4.05 | Rake $0.20
Board [Th 3d 8h]
Seat 2: n6VQBu6crjYjy6DxNP1NZA folded before Flop (didn't bet)
Seat 3: qEn9ijNGtuyTxamBf07hYg folded before Flop (didn't bet)
Seat 4: bxLSulbgr8LmKNjOzw8URg folded before Flop (didn't bet)
Seat 6: OcnLOMVFdy23jXnoTyaO5Q (button) folded on the Flop
Seat 7: bfSq6LBw0UvxeM5yfuWC7w (small blind) collected ($3.85)
Seat 8: 8ehL7qlZzjgUh2H35iiWLw (big blind) folded on the Flop
Seat 9: j3K/Jujr7PY4ZM2RZvlH6A folded before Flop (didn't bet)



PokerStars Game #59940203010:  Hold'em No Limit ($0.25/$0.50) - 2009/07/01 1:00:03 ET
Table 'MJxeZCzYELxiIsyUZyT0jw' 6-max Seat #1 is the button
Seat 1: +Pf9jTVizYlIo+woPvptfA ($50 in chips)
Seat 2: t3GiVMzqA9Svgr5Uol32cQ ($34.60 in chips)
Seat 3: JQZew0FjzS19kTjeNtrE+A ($64.60 in chips)
Seat 4: alGiiQP/wwtYnfuXII+sgw ($39.35 in chips)
Seat 5: 3jvoOXNtXE90w2BdfNZwZQ ($60.10 in chips)
Seat 6: c0n4hrn20AML9qzyFC2E8Q ($48.75 in chips)
t3GiVMzqA9Svgr5Uol32cQ: posts small blind $0.25
JQZew0FjzS19kTjeNtrE+A: posts big blind $0.50
*** HOLE CARDS ***
alGiiQP/wwtYnfuXII+sgw: raises $0.50 to $1
3jvoOXNtXE90w2BdfNZwZQ: folds
c0n4hrn20AML9qzyFC2E8Q: folds
+Pf9jTVizYlIo+woPvptfA: calls $1
t3GiVMzqA9Svgr5Uol32cQ: calls $0.75
JQZew0FjzS19kTjeNtrE+A: calls $0.50
*** FLOP *** [6s 5d Jh]
t3GiVMzqA9Svgr5Uol32cQ: checks
JQZew0FjzS19kTjeNtrE+A: bets $2
alGiiQP/wwtYnfuXII+sgw: folds
+Pf9jTVizYlIo+woPvptfA: calls $2
t3GiVMzqA9Svgr5Uol32cQ: calls $2
*** TURN *** [6s 5d Jh] [9c]
t3GiVMzqA9Svgr5Uol32cQ: checks
JQZew0FjzS19kTjeNtrE+A: bets $3
+Pf9jTVizYlIo+woPvptfA: folds
t3GiVMzqA9Svgr5Uol32cQ: raises $6.50 to $9.50
JQZew0FjzS19kTjeNtrE+A: folds
t3GiVMzqA9Svgr5Uol32cQ collected $15.25 from pot
t3GiVMzqA9Svgr5Uol32cQ: doesn't show hand
*** SUMMARY ***
Total pot $16 | Rake $0.75
Board [6s 5d Jh 9c]
Seat 1: +Pf9jTVizYlIo+woPvptfA (button) folded on the Turn
Seat 2: t3GiVMzqA9Svgr5Uol32cQ (small blind) collected ($15.25)
Seat 3: JQZew0FjzS19kTjeNtrE+A (big blind) folded on the Turn
Seat 4: alGiiQP/wwtYnfuXII+sgw folded on the Flop
Seat 5: 3jvoOXNtXE90w2BdfNZwZQ folded before Flop (didn't bet)
Seat 6: c0n4hrn20AML9qzyFC2E8Q folded before Flop (didn't bet)



PokerStars Game #59940203054:  Hold'em No Limit ($0.25/$0.50) - 2009/07/01 1:00:03 ET
Table 'fx6MqwfYAj/Rt86hBz2L3Q' 9-max Seat #4 is the button
Seat 2: C3rGXblctNcWI6JYPHhaEg ($28.60 in chips)
Seat 3: iadBi5AEt7gTBXbDSSnMYQ ($87 in chips)
Seat 4: 75K2MXwN65Sjfp1yHd50Hg ($9.25 in chips)
Seat 5: iAISe3dVeua8PUn2wwgDHw ($26 in chips)
Seat 6: 5k9fvXD9suIgCxU4HLQjTw ($50 in chips)
Seat 7: SKnJuWHScqetA/qG5p+wCg ($30 in chips)
Seat 8: JYwJYYV9pM5KWdSiETl8rA ($22 in chips)
Seat 9: HZkVla4kK2SI42CVrPZ/ig ($10.25 in chips)
iAISe3dVeua8PUn2wwgDHw: posts small blind $0.25
5k9fvXD9suIgCxU4HLQjTw: posts big blind $0.50
uw9QayAAxLM3Hb+HR7mSkg: sits out
*** HOLE CARDS ***
SKnJuWHScqetA/qG5p+wCg: folds
JYwJYYV9pM5KWdSiETl8rA: folds
HZkVla4kK2SI42CVrPZ/ig: folds
C3rGXblctNcWI6JYPHhaEg: folds
iadBi5AEt7gTBXbDSSnMYQ: folds
75K2MXwN65Sjfp1yHd50Hg: folds
iAISe3dVeua8PUn2wwgDHw: folds
5k9fvXD9suIgCxU4HLQjTw collected $0.50 from pot
*** SUMMARY ***
Total pot $0.50 | Rake $0
Seat 2: C3rGXblctNcWI6JYPHhaEg folded before Flop (didn't bet)
Seat 3: iadBi5AEt7gTBXbDSSnMYQ folded before Flop (didn't bet)
Seat 4: 75K2MXwN65Sjfp1yHd50Hg (button) folded before Flop (didn't bet)
Seat 5: iAISe3dVeua8PUn2wwgDHw (small blind) folded before Flop
Seat 6: 5k9fvXD9suIgCxU4HLQjTw (big blind) collected ($0.50)
Seat 7: SKnJuWHScqetA/qG5p+wCg folded before Flop (didn't bet)
Seat 8: JYwJYYV9pM5KWdSiETl8rA folded before Flop (didn't bet)
Seat 9: HZkVla4kK2SI42CVrPZ/ig folded before Flop (didn't bet)



PokerStars Game #59940205380:  Hold'em No Limit ($0.25/$0.50) - 2009/07/01 1:00:07 ET
Table 'otvGDROEDdqsabxskT79qg' 9-max Seat #2 is the button
Seat 1: 8ehL7qlZzjgUh2H35iiWLw ($56.75 in chips)
Seat 2: cCjTzH9jio8607WzjcfXlg ($13.55 in chips)
Seat 3: +k7T5ocke8UwavtgUHm+Cg ($70.60 in chips)
Seat 4: MG90wfSJZnOejs/KD3vlQQ ($73.95 in chips)
Seat 6: bxLSulbgr8LmKNjOzw8URg ($53.70 in chips)
Seat 8: zE9cVigS2nW/Ljy4K4bUQA ($30.75 in chips)
Seat 9: KcY3X8YpD74Kw1RHkx/g4A ($53.65 in chips)
+k7T5ocke8UwavtgUHm+Cg: posts small blind $0.25
MG90wfSJZnOejs/KD3vlQQ: posts big blind $0.50
E2518gp4aFz1+kAgmGqeEg: sits out
75K2MXwN65Sjfp1yHd50Hg: sits out
*** HOLE CARDS ***
bxLSulbgr8LmKNjOzw8URg: folds
zE9cVigS2nW/Ljy4K4bUQA: folds
KcY3X8YpD74Kw1RHkx/g4A: folds
8ehL7qlZzjgUh2H35iiWLw: folds
cCjTzH9jio8607WzjcfXlg: folds
+k7T5ocke8UwavtgUHm+Cg: raises $1 to $1.50
MG90wfSJZnOejs/KD3vlQQ: folds
+k7T5ocke8UwavtgUHm+Cg collected $1 from pot
+k7T5ocke8UwavtgUHm+Cg: doesn't show hand
*** SUMMARY ***
Total pot $1 | Rake $0
Seat 1: 8ehL7qlZzjgUh2H35iiWLw folded before Flop (didn't bet)
Seat 2: cCjTzH9jio8607WzjcfXlg (button) folded before Flop (didn't bet)
Seat 3: +k7T5ocke8UwavtgUHm+Cg (small blind) collected ($1)
Seat 4: MG90wfSJZnOejs/KD3vlQQ (big blind) folded before Flop
Seat 6: bxLSulbgr8LmKNjOzw8URg folded before Flop (didn't bet)
Seat 8: zE9cVigS2nW/Ljy4K4bUQA folded before Flop (didn't bet)
Seat 9: KcY3X8YpD74Kw1RHkx/g4A folded before Flop (didn't bet)



PokerStars Game #59940206392:  Hold'em No Limit ($0.25/$0.50) - 2009/07/01 1:00:09 ET
Table '0eJtgVAXVvBgncFdcUpXcQ' 2-max Seat #2 is the button
Seat 1: Ag6DvxX4vbRheqsv2zXKTQ ($33.05 in chips)
Seat 2: KMc4R+K9ao4Ur3rF7NGe6Q ($15.65 in chips)
KMc4R+K9ao4Ur3rF7NGe6Q: posts small blind $0.25
Ag6DvxX4vbRheqsv2zXKTQ: posts big blind $0.50
*** HOLE CARDS ***
KMc4R+K9ao4Ur3rF7NGe6Q: folds
Ag6DvxX4vbRheqsv2zXKTQ collected $0.50 from pot
*** SUMMARY ***
Total pot $0.50 | Rake $0
Seat 1: Ag6DvxX4vbRheqsv2zXKTQ (big blind) collected ($0.50)
Seat 2: KMc4R+K9ao4Ur3rF7NGe6Q (button) (small blind) folded before Flop



PokerStars Game #59940206486:  Hold'em No Limit ($0.25/$0.50) - 2009/07/01 1:00:09 ET
Table 'ErOuyGLI5PT3G5MnpHgC/gQOgaEqMcJ73pcUMMxoisUg Seat #4 is the button
Seat 1: eBrej2jnlUCs/JgxFCRn2g ($40 in chips)
Seat 2: pciZn00ZDk4BVBMTTMcNVQ ($29.50 in chips)
Seat 3: xZCXQSXlrZkp3pZizzVXCw ($52.75 in chips)
Seat 4: 3UmXLy3GfjC3EkOebduerQ ($50 in chips)
Seat 5: JwvquocWfhTVApN5t47LgA ($62.85 in chips)
Seat 6: zE9cVigS2nW/Ljy4K4bUQA ($31.60 in chips)
Seat 7: 90Wb75h3W1BRpbqVnuk8gw ($63.60 in chips)
Seat 8: g4k0NXISyLCqaSWZDBjfEg ($50 in chips)
Seat 9: J0W5D97jl5VLky+IoPvDeA ($52.15 in chips)
JwvquocWfhTVApN5t47LgA: posts small blind $0.25
zE9cVigS2nW/Ljy4K4bUQA: posts big blind $0.50
*** HOLE CARDS ***
90Wb75h3W1BRpbqVnuk8gw: folds
g4k0NXISyLCqaSWZDBjfEg: folds
J0W5D97jl5VLky+IoPvDeA: folds
eBrej2jnlUCs/JgxFCRn2g: raises $1.50 to $2
pciZn00ZDk4BVBMTTMcNVQ: folds
xZCXQSXlrZkp3pZizzVXCw: folds
3UmXLy3GfjC3EkOebduerQ: folds
JwvquocWfhTVApN5t47LgA: folds
zE9cVigS2nW/Ljy4K4bUQA: folds
eBrej2jnlUCs/JgxFCRn2g collected $1.25 from pot
*** SUMMARY ***
Total pot $1.25 | Rake $0
Seat 1: eBrej2jnlUCs/JgxFCRn2g collected ($1.25)
Seat 2: pciZn00ZDk4BVBMTTMcNVQ folded before Flop (didn't bet)
Seat 3: xZCXQSXlrZkp3pZizzVXCw folded before Flop (didn't bet)
Seat 4: 3UmXLy3GfjC3EkOebduerQ (button) folded before Flop (didn't bet)
Seat 5: JwvquocWfhTVApN5t47LgA (small blind) folded before Flop
Seat 6: zE9cVigS2nW/Ljy4K4bUQA (big blind) folded before Flop
Seat 7: 90Wb75h3W1BRpbqVnuk8gw folded before Flop (didn't bet)
Seat 8: g4k0NXISyLCqaSWZDBjfEg folded before Flop (didn't bet)
Seat 9: J0W5D97jl5VLky+IoPvDeA folded before Flop (didn't bet)



PokerStars Game #59940207130:  Hold'em No Limit ($0.25/$0.50) - 2009/07/01 1:00:10 ET
Table 'QOgaEqMcJ73pcUMMxoisUg' 6-max Seat #6 is the button
Seat 1: lxIzoHy0RnkfFSODHC2liw ($50 in chips)
Seat 2: 4QfsCWthT/vSLirorNXqtg ($76.35 in chips)
Seat 3: Rt6KgtZ8YaJoTc3FPim00w ($53 in chips)
Seat 4: zAcsDhG/T128Vn7XGVSgKg ($50 in chips)
Seat 5: 6vNxrjjCl6FwfaaymM9jjg ($26.25 in chips)
Seat 6: GoVjFxr3C+JO9vtJH9+IcA ($63.60 in chips)
lxIzoHy0RnkfFSODHC2liw: posts small blind $0.25
4QfsCWthT/vSLirorNXqtg: posts big blind $0.50
*** HOLE CARDS ***
Rt6KgtZ8YaJoTc3FPim00w: folds
zAcsDhG/T128Vn7XGVSgKg: folds
6vNxrjjCl6FwfaaymM9jjg: folds
GoVjFxr3C+JO9vtJH9+IcA: folds
lxIzoHy0RnkfFSODHC2liw: folds
4QfsCWthT/vSLirorNXqtg collected $0.50 from pot
*** SUMMARY ***
Total pot $0.50 | Rake $0
Seat 1: lxIzoHy0RnkfFSODHC2liw (small blind) folded before Flop
Seat 2: 4QfsCWthT/vSLirorNXqtg (big blind) collected ($0.50)
Seat 3: Rt6KgtZ8YaJoTc3FPim00w folded before Flop (didn't bet)
Seat 4: zAcsDhG/T128Vn7XGVSgKg folded before Flop (didn't bet)
Seat 5: 6vNxrjjCl6FwfaaymM9jjg folded before Flop (didn't bet)
Seat 6: GoVjFxr3C+JO9vtJH9+IcA (button) folded before Flop (didn't bet)



PokerStars Game #59940207720:  Hold'em No Limit ($0.25/$0.50) - 2009/07/01 1:00:11 ET
Table 'E7bWJ45aoFXRpyRv2gw+Ig' 2-max Seat #1 is the button
Seat 1: FRkiRasEGlHUeLrEl+k/nA ($82.70 in chips)
Seat 2: 3Wro85I7472vJ4Wkpneo9A ($107 in chips)
FRkiRasEGlHUeLrEl+k/nA: posts small blind $0.25
3Wro85I7472vJ4Wkpneo9A: posts big blind $0.50
*** HOLE CARDS ***
FRkiRasEGlHUeLrEl+k/nA: raises $1 to $1.50
3Wro85I7472vJ4Wkpneo9A: raises $3.50 to $5
FRkiRasEGlHUeLrEl+k/nA: calls $3.50
*** FLOP *** [8d 6s 5d]
3Wro85I7472vJ4Wkpneo9A: checks
FRkiRasEGlHUeLrEl+k/nA: bets $3
3Wro85I7472vJ4Wkpneo9A: calls $3
*** TURN *** [8d 6s 5d] [3h]
3Wro85I7472vJ4Wkpneo9A: checks
FRkiRasEGlHUeLrEl+k/nA: bets $6
3Wro85I7472vJ4Wkpneo9A: folds
FRkiRasEGlHUeLrEl+k/nA collected $15.50 from pot
*** SUMMARY ***
Total pot $16 | Rake $0.50
Board [8d 6s 5d 3h]
Seat 1: FRkiRasEGlHUeLrEl+k/nA (button) (small blind) collected ($15.50)
Seat 2: 3Wro85I7472vJ4Wkpneo9A (big blind) folded on the Turn



PokerStars Game #59940211432:  Hold'em No Limit ($0.25/$0.50) - 2009/07/01 1:00:17 ET
Table '0eJtgVAXVvBgncFdcUpXcQ' 2-max Seat #1 is the button
Seat 1: Ag6DvxX4vbRheqsv2zXKTQ ($33.30 in chips)
Seat 2: KMc4R+K9ao4Ur3rF7NGe6Q ($15.40 in chips)
Ag6DvxX4vbRheqsv2zXKTQ: posts small blind $0.25
KMc4R+K9ao4Ur3rF7NGe6Q: posts big blind $0.50
*** HOLE CARDS ***
Ag6DvxX4vbRheqsv2zXKTQ: calls $0.25
KMc4R+K9ao4Ur3rF7NGe6Q: checks
*** FLOP *** [3h Jc Ah]
KMc4R+K9ao4Ur3rF7NGe6Q: checks
Ag6DvxX4vbRheqsv2zXKTQ: checks
*** TURN *** [3h Jc Ah] [2c]
KMc4R+K9ao4Ur3rF7NGe6Q: checks
Ag6DvxX4vbRheqsv2zXKTQ: bets $0.50
KMc4R+K9ao4Ur3rF7NGe6Q: folds
Ag6DvxX4vbRheqsv2zXKTQ collected $0.95 from pot
*** SUMMARY ***
Total pot $1 | Rake $0.05
Board [3h Jc Ah 2c]
Seat 1: Ag6DvxX4vbRheqsv2zXKTQ (button) (small blind) collected ($0.95)
Seat 2: KMc4R+K9ao4Ur3rF7NGe6Q (big blind) folded on the Turn



PokerStars Game #59940212294:  Hold'em No Limit ($0.25/$0.50) - 2009/07/01 1:00:19 ET
Table '+dXkOAQyS8j9PQZusUTMpg' 2-max Seat #2 is the button
Seat 1: XFa6sBGjP2gxoIvxR3fZIg ($60.10 in chips)
Seat 2: 5IBeOgaApY1Bvzv2P8X4EA ($138.40 in chips)
5IBeOgaApY1Bvzv2P8X4EA: posts small blind $0.25
XFa6sBGjP2gxoIvxR3fZIg: posts big blind $0.50
*** HOLE CARDS ***
5IBeOgaApY1Bvzv2P8X4EA: folds
XFa6sBGjP2gxoIvxR3fZIg collected $0.50 from pot
XFa6sBGjP2gxoIvxR3fZIg: doesn't show hand
*** SUMMARY ***
Total pot $0.50 | Rake $0
Seat 1: XFa6sBGjP2gxoIvxR3fZIg (big blind) collected ($0.50)
Seat 2: 5IBeOgaApY1Bvzv2P8X4EA (button) (small blind) folded before Flop



PokerStars Game #59940213048:  Hold'em No Limit ($0.25/$0.50) - 2009/07/01 1:00:20 ET
Table 'lSisgp6H7Fg1hH5VfjEjYQ' 9-max Seat #8 is the button
Seat 1: 5k9fvXD9suIgCxU4HLQjTw ($50 in chips)
Seat 2: UrcnkQOiLVk8BlKDPJSy7Q ($76.60 in chips)
Seat 3: aTkyjTh3w5YLWiIERupZOA ($51.95 in chips)
Seat 4: bwv/rbH/hHhPhY6u9mu04w ($31.60 in chips)
Seat 5: mSD1pginDsyHG5PDfqzphw ($10 in chips)
Seat 6: +k7T5ocke8UwavtgUHm+Cg ($67.80 in chips)
Seat 7: IDtNLR9uFCDdjNsJWMHA5Q ($19.80 in chips)
Seat 8: a4JDWmpFQkL10XfAyuF51A ($28.25 in chips)
tkflckdgk will be allowed to play after the button
5k9fvXD9suIgCxU4HLQjTw: posts small blind $0.25
UrcnkQOiLVk8BlKDPJSy7Q: posts big blind $0.50
*** HOLE CARDS ***
aTkyjTh3w5YLWiIERupZOA: folds
bwv/rbH/hHhPhY6u9mu04w: folds
mSD1pginDsyHG5PDfqzphw: folds
+k7T5ocke8UwavtgUHm+Cg: folds
IDtNLR9uFCDdjNsJWMHA5Q: calls $0.50
a4JDWmpFQkL10XfAyuF51A: calls $0.50
5k9fvXD9suIgCxU4HLQjTw: folds
UrcnkQOiLVk8BlKDPJSy7Q: checks
*** FLOP *** [2c 5c Jc]
UrcnkQOiLVk8BlKDPJSy7Q: checks
IDtNLR9uFCDdjNsJWMHA5Q: bets $1.50
a4JDWmpFQkL10XfAyuF51A: folds
UrcnkQOiLVk8BlKDPJSy7Q: folds
IDtNLR9uFCDdjNsJWMHA5Q collected $1.70 from pot
IDtNLR9uFCDdjNsJWMHA5Q: doesn't show hand
*** SUMMARY ***
Total pot $1.75 | Rake $0.05
Board [2c 5c Jc]
Seat 1: 5k9fvXD9suIgCxU4HLQjTw (small blind) folded before Flop
Seat 2: UrcnkQOiLVk8BlKDPJSy7Q (big blind) folded on the Flop
Seat 3: aTkyjTh3w5YLWiIERupZOA folded before Flop (didn't bet)
Seat 4: bwv/rbH/hHhPhY6u9mu04w folded before Flop (didn't bet)
Seat 5: mSD1pginDsyHG5PDfqzphw folded before Flop (didn't bet)
Seat 6: +k7T5ocke8UwavtgUHm+Cg folded before Flop (didn't bet)
Seat 7: IDtNLR9uFCDdjNsJWMHA5Q collected ($1.70)
Seat 8: a4JDWmpFQkL10XfAyuF51A (button) folded on the Flop



PokerStars Game #59940215134:  Hold'em No Limit ($0.25/$0.50) - 2009/07/01 1:00:23 ET
Table '37qXEp3oe+er5q4CZip9eQ' 6-max Seat #6 is the button
Seat 1: oqOqoO2AyCZenUghCxMDxw ($50 in chips)
Seat 2: LvH4G7n+QSjT6NDaD3cREA ($50 in chips)
Seat 3: Rt6KgtZ8YaJoTc3FPim00w ($112.45 in chips)
Seat 4: XsmE8nXMAAMFJbWaJTmHFw ($40.60 in chips)
Seat 5: VOmI0x4dDPnTESZd5B4d1Q ($43.50 in chips)
Seat 6: N50kln4negd8q7Mmoz1j4g ($15.80 in chips)
oqOqoO2AyCZenUghCxMDxw: posts small blind $0.25
LvH4G7n+QSjT6NDaD3cREA: posts big blind $0.50
*** HOLE CARDS ***
Rt6KgtZ8YaJoTc3FPim00w: folds
VOmI0x4dDPnTESZd5B4d1Q said, "JJ"
XsmE8nXMAAMFJbWaJTmHFw: folds
VOmI0x4dDPnTESZd5B4d1Q said, "no heart"
VOmI0x4dDPnTESZd5B4d1Q: raises $1.50 to $2
N50kln4negd8q7Mmoz1j4g: folds
oqOqoO2AyCZenUghCxMDxw: calls $1.75
VOmI0x4dDPnTESZd5B4d1Q said, "nh"
LvH4G7n+QSjT6NDaD3cREA: raises $7 to $9
XsmE8nXMAAMFJbWaJTmHFw said, "Cheers"
VOmI0x4dDPnTESZd5B4d1Q: folds
oqOqoO2AyCZenUghCxMDxw: folds
LvH4G7n+QSjT6NDaD3cREA collected $6 from pot
*** SUMMARY ***
Total pot $6 | Rake $0
Seat 1: oqOqoO2AyCZenUghCxMDxw (small blind) folded before Flop
Seat 2: LvH4G7n+QSjT6NDaD3cREA (big blind) collected ($6)
Seat 3: Rt6KgtZ8YaJoTc3FPim00w folded before Flop (didn't bet)
Seat 4: XsmE8nXMAAMFJbWaJTmHFw folded before Flop (didn't bet)
Seat 5: VOmI0x4dDPnTESZd5B4d1Q folded before Flop
Seat 6: N50kln4negd8q7Mmoz1j4g (button) folded before Flop (didn't bet)



PokerStars Game #59940216342:  Hold'em No Limit ($0.25/$0.50) - 2009/07/01 1:00:25 ET
Table '9Puy2HWN1RQe5SSjq162gA' 2-max Seat #1 is the button
Seat 1: Fp/oksNpipCrD2MJ2pH20g ($10 in chips)
Seat 2: tDV+zhxH9+3DkJDzoTERyg ($37.35 in chips)
Fp/oksNpipCrD2MJ2pH20g: posts small blind $0.25
tDV+zhxH9+3DkJDzoTERyg: posts big blind $0.50
*** HOLE CARDS ***
Fp/oksNpipCrD2MJ2pH20g: raises $1.50 to $2
tDV+zhxH9+3DkJDzoTERyg: folds
Fp/oksNpipCrD2MJ2pH20g collected $1 from pot
Fp/oksNpipCrD2MJ2pH20g: doesn't show hand
*** SUMMARY ***
Total pot $1 | Rake $0
Seat 1: Fp/oksNpipCrD2MJ2pH20g (button) (small blind) collected ($1)
Seat 2: tDV+zhxH9+3DkJDzoTERyg (big blind) folded before Flop



PokerStars Game #59940215944:  Hold'em No Limit ($0.25/$0.50) - 2009/07/01 1:00:25 ET
Table '+dXkOAQyS8j9PQZusUTMpg' 2-max Seat #1 is the button
Seat 1: XFa6sBGjP2gxoIvxR3fZIg ($60.35 in chips)
Seat 2: 5IBeOgaApY1Bvzv2P8X4EA ($138.15 in chips)
XFa6sBGjP2gxoIvxR3fZIg: posts small blind $0.25
5IBeOgaApY1Bvzv2P8X4EA: posts big blind $0.50
*** HOLE CARDS ***
XFa6sBGjP2gxoIvxR3fZIg: raises $1 to $1.50
5IBeOgaApY1Bvzv2P8X4EA: calls $1
*** FLOP *** [Ts 2c 4d]
5IBeOgaApY1Bvzv2P8X4EA: checks
XFa6sBGjP2gxoIvxR3fZIg: bets $2
5IBeOgaApY1Bvzv2P8X4EA: folds
XFa6sBGjP2gxoIvxR3fZIg collected $2.85 from pot
XFa6sBGjP2gxoIvxR3fZIg: doesn't show hand
*** SUMMARY ***
Total pot $3 | Rake $0.15
Board [Ts 2c 4d]
Seat 1: XFa6sBGjP2gxoIvxR3fZIg (button) (small blind) collected ($2.85)
Seat 2: 5IBeOgaApY1Bvzv2P8X4EA (big blind) folded on the Flop



PokerStars Game #59940216366:  Hold'em No Limit ($0.25/$0.50) - 2009/07/01 1:00:25 ET
Table 'fx6MqwfYAj/Rt86hBz2L3Q' 9-max Seat #5 is the button
Seat 2: C3rGXblctNcWI6JYPHhaEg ($28.60 in chips)
Seat 3: iadBi5AEt7gTBXbDSSnMYQ ($87 in chips)
Seat 4: 75K2MXwN65Sjfp1yHd50Hg ($9.25 in chips)
Seat 5: iAISe3dVeua8PUn2wwgDHw ($25.75 in chips)
Seat 6: 5k9fvXD9suIgCxU4HLQjTw ($50.25 in chips)
Seat 7: SKnJuWHScqetA/qG5p+wCg ($30 in chips)
Seat 8: JYwJYYV9pM5KWdSiETl8rA ($22 in chips)
Seat 9: HZkVla4kK2SI42CVrPZ/ig ($10.25 in chips)
5k9fvXD9suIgCxU4HLQjTw: posts small blind $0.25
SKnJuWHScqetA/qG5p+wCg: posts big blind $0.50
uw9QayAAxLM3Hb+HR7mSkg: sits out
*** HOLE CARDS ***
JYwJYYV9pM5KWdSiETl8rA: folds
HZkVla4kK2SI42CVrPZ/ig: folds
C3rGXblctNcWI6JYPHhaEg: raises $1.10 to $1.60
iadBi5AEt7gTBXbDSSnMYQ: calls $1.60
75K2MXwN65Sjfp1yHd50Hg: folds
iAISe3dVeua8PUn2wwgDHw: folds
5k9fvXD9suIgCxU4HLQjTw: calls $1.35
SKnJuWHScqetA/qG5p+wCg: folds
*** FLOP *** [3c Ks 3h]
5k9fvXD9suIgCxU4HLQjTw: checks
C3rGXblctNcWI6JYPHhaEg: bets $2
iadBi5AEt7gTBXbDSSnMYQ: calls $2
5k9fvXD9suIgCxU4HLQjTw: folds
*** TURN *** [3c Ks 3h] [8s]
C3rGXblctNcWI6JYPHhaEg: bets $3
iadBi5AEt7gTBXbDSSnMYQ: calls $3
*** RIVER *** [3c Ks 3h 8s] [5h]
C3rGXblctNcWI6JYPHhaEg: bets $2
iadBi5AEt7gTBXbDSSnMYQ: folds
C3rGXblctNcWI6JYPHhaEg collected $14.60 from pot
*** SUMMARY ***
Total pot $15.30 | Rake $0.70
Board [3c Ks 3h 8s 5h]
Seat 2: C3rGXblctNcWI6JYPHhaEg collected ($14.60)
Seat 3: iadBi5AEt7gTBXbDSSnMYQ folded on the River
Seat 4: 75K2MXwN65Sjfp1yHd50Hg folded before Flop (didn't bet)
Seat 5: iAISe3dVeua8PUn2wwgDHw (button) folded before Flop (didn't bet)
Seat 6: 5k9fvXD9suIgCxU4HLQjTw (small blind) folded on the Flop
Seat 7: SKnJuWHScqetA/qG5p+wCg (big blind) folded before Flop
Seat 8: JYwJYYV9pM5KWdSiETl8rA folded before Flop (didn't bet)
Seat 9: HZkVla4kK2SI42CVrPZ/ig folded before Flop (didn't bet)



PokerStars Game #59940217766:  Hold'em No Limit ($0.25/$0.50) - 2009/07/01 1:00:27 ET
Table 'kgbJRsxfv64KrErDRBAkcw' 6-max Seat #3 is the button
Seat 1: VamsyhlFzXGF6/ydo0BHeA ($43.55 in chips)
Seat 2: AdS8BJMOheS01zjCDfPMFg ($50 in chips)
Seat 3: c4MNIaIyPMOMxrgT8FT5nA ($133.25 in chips)
Seat 4: qanMEqjABjWxC/JgQ/0l7w ($56.75 in chips)
Seat 5: eUBBn2R56C1IQ6Cs/vitwg ($56 in chips)
Seat 6: 1b+2BbjMN8qhR1WPqdE9VQ ($52.65 in chips)
qanMEqjABjWxC/JgQ/0l7w: posts small blind $0.25
eUBBn2R56C1IQ6Cs/vitwg: posts big blind $0.50
VamsyhlFzXGF6/ydo0BHeA: posts big blind $0.50
*** HOLE CARDS ***
1b+2BbjMN8qhR1WPqdE9VQ: folds
VamsyhlFzXGF6/ydo0BHeA: checks
AdS8BJMOheS01zjCDfPMFg: folds
c4MNIaIyPMOMxrgT8FT5nA: raises $4 to $4.50
qanMEqjABjWxC/JgQ/0l7w: folds
eUBBn2R56C1IQ6Cs/vitwg: folds
VamsyhlFzXGF6/ydo0BHeA: folds
c4MNIaIyPMOMxrgT8FT5nA collected $1.75 from pot
c4MNIaIyPMOMxrgT8FT5nA: doesn't show hand
*** SUMMARY ***
Total pot $1.75 | Rake $0
Seat 1: VamsyhlFzXGF6/ydo0BHeA folded before Flop
Seat 2: AdS8BJMOheS01zjCDfPMFg folded before Flop (didn't bet)
Seat 3: c4MNIaIyPMOMxrgT8FT5nA (button) collected ($1.75)
Seat 4: qanMEqjABjWxC/JgQ/0l7w (small blind) folded before Flop
Seat 5: eUBBn2R56C1IQ6Cs/vitwg (big blind) folded before Flop
Seat 6: 1b+2BbjMN8qhR1WPqdE9VQ folded before Flop (didn't bet)



PokerStars Game #59940217894:  Hold'em No Limit ($0.25/$0.50) - 2009/07/01 1:00:28 ET
Table 'lpxYasB1ClBSgTpCCITwhQ' 9-max Seat #2 is the button
Seat 1: mj7PS7wCH4PAl7+eYTFs7A ($42.40 in chips)
Seat 2: OWP/DOu+PlPK6ZZ3zYa0HA ($19.85 in chips)
Seat 3: IVoxShuYD5lqbK8F9+jVsg ($9.50 in chips)
Seat 4: NnQCepdIR/AOUQn1yhYx6Q ($9.25 in chips)
Seat 5: IYd5zG8k7vdBNVHbHg2Pag ($36.35 in chips)
Seat 6: SegjDnMxWMujiD57ESNL+g ($12.10 in chips)
Seat 7: bmRtaIYKthN1F+B3JLZ3Jw ($71.90 in chips)
Seat 8: /mfensKw8/iZ1Vrx33S4xg ($11.85 in chips)
Seat 9: sUIUZ+begh92dzkUmvbMrw ($10.40 in chips)
IVoxShuYD5lqbK8F9+jVsg: posts small blind $0.25
NnQCepdIR/AOUQn1yhYx6Q: posts big blind $0.50
sUIUZ+begh92dzkUmvbMrw: posts big blind $0.50
*** HOLE CARDS ***
IYd5zG8k7vdBNVHbHg2Pag: folds
SegjDnMxWMujiD57ESNL+g: folds
bmRtaIYKthN1F+B3JLZ3Jw: folds
/mfensKw8/iZ1Vrx33S4xg: folds
sUIUZ+begh92dzkUmvbMrw: checks
mj7PS7wCH4PAl7+eYTFs7A: calls $0.50
OWP/DOu+PlPK6ZZ3zYa0HA: calls $0.50
IVoxShuYD5lqbK8F9+jVsg: calls $0.25
NnQCepdIR/AOUQn1yhYx6Q: checks
*** FLOP *** [Ad 9h 3h]
IVoxShuYD5lqbK8F9+jVsg: checks
NnQCepdIR/AOUQn1yhYx6Q: checks
sUIUZ+begh92dzkUmvbMrw: checks
mj7PS7wCH4PAl7+eYTFs7A: bets $1.50
OWP/DOu+PlPK6ZZ3zYa0HA: folds
IVoxShuYD5lqbK8F9+jVsg: folds
NnQCepdIR/AOUQn1yhYx6Q: folds
sUIUZ+begh92dzkUmvbMrw: folds
mj7PS7wCH4PAl7+eYTFs7A collected $2.40 from pot
mj7PS7wCH4PAl7+eYTFs7A: doesn't show hand
*** SUMMARY ***
Total pot $2.50 | Rake $0.10
Board [Ad 9h 3h]
Seat 1: mj7PS7wCH4PAl7+eYTFs7A collected ($2.40)
Seat 2: OWP/DOu+PlPK6ZZ3zYa0HA (button) folded on the Flop
Seat 3: IVoxShuYD5lqbK8F9+jVsg (small blind) folded on the Flop
Seat 4: NnQCepdIR/AOUQn1yhYx6Q (big blind) folded on the Flop
Seat 5: IYd5zG8k7vdBNVHbHg2Pag folded before Flop (didn't bet)
Seat 6: SegjDnMxWMujiD57ESNL+g folded before Flop (didn't bet)
Seat 7: bmRtaIYKthN1F+B3JLZ3Jw folded before Flop (didn't bet)
Seat 8: /mfensKw8/iZ1Vrx33S4xg folded before Flop (didn't bet)
Seat 9: sUIUZ+begh92dzkUmvbMrw folded on the Flop



PokerStars Game #59940219102:  Hold'em No Limit ($0.25/$0.50) - 2009/07/01 1:00:30 ET
Table '0eJtgVAXVvBgncFdcUpXcQ' 2-max Seat #2 is the button
Seat 1: Ag6DvxX4vbRheqsv2zXKTQ ($33.75 in chips)
Seat 2: KMc4R+K9ao4Ur3rF7NGe6Q ($14.90 in chips)
KMc4R+K9ao4Ur3rF7NGe6Q: posts small blind $0.25
Ag6DvxX4vbRheqsv2zXKTQ: posts big blind $0.50
*** HOLE CARDS ***
KMc4R+K9ao4Ur3rF7NGe6Q: calls $0.25
Ag6DvxX4vbRheqsv2zXKTQ: checks
*** FLOP *** [7d As Qs]
Ag6DvxX4vbRheqsv2zXKTQ: checks
KMc4R+K9ao4Ur3rF7NGe6Q: checks
*** TURN *** [7d As Qs] [3c]
Ag6DvxX4vbRheqsv2zXKTQ: bets $0.50
KMc4R+K9ao4Ur3rF7NGe6Q: calls $0.50
*** RIVER *** [7d As Qs 3c] [Qd]
Ag6DvxX4vbRheqsv2zXKTQ: checks
KMc4R+K9ao4Ur3rF7NGe6Q: checks
*** SHOW DOWN ***
Ag6DvxX4vbRheqsv2zXKTQ: shows [9c 9h] (two pair, Queens and Nines)
KMc4R+K9ao4Ur3rF7NGe6Q: mucks hand
Ag6DvxX4vbRheqsv2zXKTQ collected $1.95 from pot
*** SUMMARY ***
Total pot $2 | Rake $0.05
Board [7d As Qs 3c Qd]
Seat 1: Ag6DvxX4vbRheqsv2zXKTQ (big blind) showed [9c 9h] and won ($1.95) with two pair, Queens and Nines
Seat 2: KMc4R+K9ao4Ur3rF7NGe6Q (button) (small blind) mucked



PokerStars Game #59940219628:  Hold'em No Limit ($0.25/$0.50) - 2009/07/01 1:00:31 ET
Table 'c/CRn+68J3Y8KxD5g1ek2Q' 2-max Seat #1 is the button
Seat 1: 46qCyJ6evTkHo9al5sBMNA ($92.70 in chips)
Seat 2: BypVLsYQt3ePFm2xQL/dOA ($275.95 in chips)
46qCyJ6evTkHo9al5sBMNA: posts small blind $0.25
BypVLsYQt3ePFm2xQL/dOA: posts big blind $0.50
*** HOLE CARDS ***
46qCyJ6evTkHo9al5sBMNA: folds
BypVLsYQt3ePFm2xQL/dOA collected $0.50 from pot
BypVLsYQt3ePFm2xQL/dOA: doesn't show hand
*** SUMMARY ***
Total pot $0.50 | Rake $0
Seat 1: 46qCyJ6evTkHo9al5sBMNA (button) (small blind) folded before Flop
Seat 2: BypVLsYQt3ePFm2xQL/dOA (big blind) collected ($0.50)



PokerStars Game #59940220498:  Hold'em No Limit ($0.25/$0.50) - 2009/07/01 1:00:32 ET
Table '8BQGgNetI1NOvWeu3gtMNw' 2-max Seat #1 is the button
Seat 1: bypIyrYcAAifLfhZpGlKLA ($56.50 in chips)
Seat 2: Z4HwehErEwzsv/noQlfUlg ($145.25 in chips)
bypIyrYcAAifLfhZpGlKLA: posts small blind $0.25
Z4HwehErEwzsv/noQlfUlg: posts big blind $0.50
*** HOLE CARDS ***
bypIyrYcAAifLfhZpGlKLA: raises $1 to $1.50
Z4HwehErEwzsv/noQlfUlg: folds
bypIyrYcAAifLfhZpGlKLA collected $1 from pot
bypIyrYcAAifLfhZpGlKLA: doesn't show hand
*** SUMMARY ***
Total pot $1 | Rake $0
Seat 1: bypIyrYcAAifLfhZpGlKLA (button) (small blind) collected ($1)
Seat 2: Z4HwehErEwzsv/noQlfUlg (big blind) folded before Flop



PokerStars Game #59940221024:  Hold'em No Limit ($0.25/$0.50) - 2009/07/01 1:00:33 ET
Table 'otvGDROEDdqsabxskT79qg' 9-max Seat #3 is the button
Seat 1: 8ehL7qlZzjgUh2H35iiWLw ($56.75 in chips)
Seat 2: cCjTzH9jio8607WzjcfXlg ($13.55 in chips)
Seat 3: +k7T5ocke8UwavtgUHm+Cg ($71.10 in chips)
Seat 4: MG90wfSJZnOejs/KD3vlQQ ($73.45 in chips)
Seat 5: E2518gp4aFz1+kAgmGqeEg ($11 in chips)
Seat 6: bxLSulbgr8LmKNjOzw8URg ($53.70 in chips)
Seat 8: zE9cVigS2nW/Ljy4K4bUQA ($30.75 in chips)
Seat 9: KcY3X8YpD74Kw1RHkx/g4A ($53.65 in chips)
MG90wfSJZnOejs/KD3vlQQ: posts small blind $0.25
E2518gp4aFz1+kAgmGqeEg: posts big blind $0.50
75K2MXwN65Sjfp1yHd50Hg: sits out
*** HOLE CARDS ***
bxLSulbgr8LmKNjOzw8URg: folds
zE9cVigS2nW/Ljy4K4bUQA: folds
KcY3X8YpD74Kw1RHkx/g4A: folds
8ehL7qlZzjgUh2H35iiWLw: folds
cCjTzH9jio8607WzjcfXlg: folds
+k7T5ocke8UwavtgUHm+Cg: folds
MG90wfSJZnOejs/KD3vlQQ: folds
E2518gp4aFz1+kAgmGqeEg collected $0.50 from pot
E2518gp4aFz1+kAgmGqeEg: doesn't show hand
*** SUMMARY ***
Total pot $0.50 | Rake $0
Seat 1: 8ehL7qlZzjgUh2H35iiWLw folded before Flop (didn't bet)
Seat 2: cCjTzH9jio8607WzjcfXlg folded before Flop (didn't bet)
Seat 3: +k7T5ocke8UwavtgUHm+Cg (button) folded before Flop (didn't bet)
Seat 4: MG90wfSJZnOejs/KD3vlQQ (small blind) folded before Flop
Seat 5: E2518gp4aFz1+kAgmGqeEg (big blind) collected ($0.50)
Seat 6: bxLSulbgr8LmKNjOzw8URg folded before Flop (didn't bet)
Seat 8: zE9cVigS2nW/Ljy4K4bUQA folded before Flop (didn't bet)
Seat 9: KcY3X8YpD74Kw1RHkx/g4A folded before Flop (didn't bet)



PokerStars Game #59940221656:  Hold'em No Limit ($0.25/$0.50) - 2009/07/01 1:00:34 ET
Table '9Puy2HWN1RQe5SSjq162gA' 2-max Seat #2 is the button
Seat 1: Fp/oksNpipCrD2MJ2pH20g ($10.50 in chips)
Seat 2: tDV+zhxH9+3DkJDzoTERyg ($36.85 in chips)
tDV+zhxH9+3DkJDzoTERyg: posts small blind $0.25
Fp/oksNpipCrD2MJ2pH20g: posts big blind $0.50
*** HOLE CARDS ***
tDV+zhxH9+3DkJDzoTERyg: folds
Fp/oksNpipCrD2MJ2pH20g collected $0.50 from pot
Fp/oksNpipCrD2MJ2pH20g: doesn't show hand
*** SUMMARY ***
Total pot $0.50 | Rake $0
Seat 1: Fp/oksNpipCrD2MJ2pH20g (big blind) collected ($0.50)
Seat 2: tDV+zhxH9+3DkJDzoTERyg (button) (small blind) folded before Flop



PokerStars Game #59940222282:  Hold'em No Limit ($0.25/$0.50) - 2009/07/01 1:00:35 ET
Table 'X6IRCRTh+20gjz8aubWnwA' 9-max Seat #6 is the button
Seat 1: DSM67hHHq1XFoEOi9p8Alw ($49.05 in chips)
Seat 2: HZkVla4kK2SI42CVrPZ/ig ($7.55 in chips)
Seat 3: SWv01peOe69QQRvhQTqjQw ($9.75 in chips)
Seat 4: M3JFBNQ8Bbw3FBZ/18MuXw ($14.45 in chips)
Seat 5: NnQCepdIR/AOUQn1yhYx6Q ($9.25 in chips)
Seat 6: 75K2MXwN65Sjfp1yHd50Hg ($9.25 in chips)
Seat 7: cFHQjKQOOKTUzoilhrXHLg ($43.75 in chips)
Seat 8: HxeBVq06/3Bh/H986sgdbw ($24 in chips)
Seat 9: M+7+BTmX5vZatHVuoRB1nA ($46.75 in chips)
cFHQjKQOOKTUzoilhrXHLg: posts small blind $0.25
HxeBVq06/3Bh/H986sgdbw: posts big blind $0.50
*** HOLE CARDS ***
M+7+BTmX5vZatHVuoRB1nA: folds
DSM67hHHq1XFoEOi9p8Alw: folds
HZkVla4kK2SI42CVrPZ/ig: folds
SWv01peOe69QQRvhQTqjQw: calls $0.50
M3JFBNQ8Bbw3FBZ/18MuXw: calls $0.50
NnQCepdIR/AOUQn1yhYx6Q: folds
75K2MXwN65Sjfp1yHd50Hg: raises $2.50 to $3
cFHQjKQOOKTUzoilhrXHLg: calls $2.75
HxeBVq06/3Bh/H986sgdbw: folds
SWv01peOe69QQRvhQTqjQw: folds
M3JFBNQ8Bbw3FBZ/18MuXw: calls $2.50
*** FLOP *** [Ks 5c 2c]
cFHQjKQOOKTUzoilhrXHLg: checks
M3JFBNQ8Bbw3FBZ/18MuXw: checks
75K2MXwN65Sjfp1yHd50Hg: checks
*** TURN *** [Ks 5c 2c] [Kh]
cFHQjKQOOKTUzoilhrXHLg: checks
M3JFBNQ8Bbw3FBZ/18MuXw: checks
75K2MXwN65Sjfp1yHd50Hg: bets $6.25 and is all-in
cFHQjKQOOKTUzoilhrXHLg: folds
M3JFBNQ8Bbw3FBZ/18MuXw: calls $6.25
*** RIVER *** [Ks 5c 2c Kh] [2d]
*** SHOW DOWN ***
M3JFBNQ8Bbw3FBZ/18MuXw: shows [3h 3d] (two pair, Kings and Threes)
75K2MXwN65Sjfp1yHd50Hg: mucks hand
M3JFBNQ8Bbw3FBZ/18MuXw collected $21.40 from pot
*** SUMMARY ***
Total pot $22.50 | Rake $1.10
Board [Ks 5c 2c Kh 2d]
Seat 1: DSM67hHHq1XFoEOi9p8Alw folded before Flop (didn't bet)
Seat 2: HZkVla4kK2SI42CVrPZ/ig folded before Flop (didn't bet)
Seat 3: SWv01peOe69QQRvhQTqjQw folded before Flop
Seat 4: M3JFBNQ8Bbw3FBZ/18MuXw showed [3h 3d] and won ($21.40) with two pair, Kings and Threes
Seat 5: NnQCepdIR/AOUQn1yhYx6Q folded before Flop (didn't bet)
Seat 6: 75K2MXwN65Sjfp1yHd50Hg (button) mucked
Seat 7: cFHQjKQOOKTUzoilhrXHLg (small blind) folded on the Turn
Seat 8: HxeBVq06/3Bh/H986sgdbw (big blind) folded before Flop
Seat 9: M+7+BTmX5vZatHVuoRB1nA folded before Flop (didn't bet)



PokerStars Game #59940222212:  Hold'em No Limit ($0.25/$0.50) - 2009/07/01 1:00:35 ET
Table 'NCiXr0d5CEKBQr/cZgLhbA' 9-max Seat #8 is the button
Seat 1: pFtzb1sR4b0d1aw6aIRgDg ($50 in chips)
Seat 2: ulxuJchBV9iguXg0FUonfg ($51.45 in chips)
Seat 3: xZCXQSXlrZkp3pZizzVXCw ($52.70 in chips)
Seat 4: 5k9fvXD9suIgCxU4HLQjTw ($55.20 in chips)
Seat 5: zE9cVigS2nW/Ljy4K4bUQA ($33.30 in chips)
Seat 6: SKnJuWHScqetA/qG5p+wCg ($32.75 in chips)
Seat 7: M+7+BTmX5vZatHVuoRB1nA ($52 in chips)
Seat 8: 1MJUKc3cc0QmUoz1JZLR2w ($64.05 in chips)
Seat 9: 4WLZvqBn5qv5tds5kt5A1Q ($38 in chips)
4WLZvqBn5qv5tds5kt5A1Q: posts small blind $0.25
pFtzb1sR4b0d1aw6aIRgDg: posts big blind $0.50
*** HOLE CARDS ***
ulxuJchBV9iguXg0FUonfg: folds
xZCXQSXlrZkp3pZizzVXCw: folds
5k9fvXD9suIgCxU4HLQjTw: folds
zE9cVigS2nW/Ljy4K4bUQA: folds
SKnJuWHScqetA/qG5p+wCg: folds
M+7+BTmX5vZatHVuoRB1nA: folds
1MJUKc3cc0QmUoz1JZLR2w: folds
4WLZvqBn5qv5tds5kt5A1Q: calls $0.25
pFtzb1sR4b0d1aw6aIRgDg: checks
*** FLOP *** [Qh Qd 5c]
4WLZvqBn5qv5tds5kt5A1Q: checks
pFtzb1sR4b0d1aw6aIRgDg: checks
*** TURN *** [Qh Qd 5c] [8h]
4WLZvqBn5qv5tds5kt5A1Q: bets $0.50
pFtzb1sR4b0d1aw6aIRgDg: folds
4WLZvqBn5qv5tds5kt5A1Q collected $0.95 from pot
*** SUMMARY ***
Total pot $1 | Rake $0.05
Board [Qh Qd 5c 8h]
Seat 1: pFtzb1sR4b0d1aw6aIRgDg (big blind) folded on the Turn
Seat 2: ulxuJchBV9iguXg0FUonfg folded before Flop (didn't bet)
Seat 3: xZCXQSXlrZkp3pZizzVXCw folded before Flop (didn't bet)
Seat 4: 5k9fvXD9suIgCxU4HLQjTw folded before Flop (didn't bet)
Seat 5: zE9cVigS2nW/Ljy4K4bUQA folded before Flop (didn't bet)
Seat 6: SKnJuWHScqetA/qG5p+wCg folded before Flop (didn't bet)
Seat 7: M+7+BTmX5vZatHVuoRB1nA folded before Flop (didn't bet)
Seat 8: 1MJUKc3cc0QmUoz1JZLR2w (button) folded before Flop (didn't bet)
Seat 9: 4WLZvqBn5qv5tds5kt5A1Q (small blind) collected ($0.95)



PokerStars Game #59940223440:  Hold'em No Limit ($0.25/$0.50) - 2009/07/01 1:00:37 ET
Table 'c/CRn+68J3Y8KxD5g1ek2Q' 2-max Seat #2 is the button
Seat 1: 46qCyJ6evTkHo9al5sBMNA ($92.45 in chips)
Seat 2: BypVLsYQt3ePFm2xQL/dOA ($276.20 in chips)
BypVLsYQt3ePFm2xQL/dOA: posts small blind $0.25
46qCyJ6evTkHo9al5sBMNA: posts big blind $0.50
*** HOLE CARDS ***
BypVLsYQt3ePFm2xQL/dOA: calls $0.25
46qCyJ6evTkHo9al5sBMNA: raises $1.50 to $2
BypVLsYQt3ePFm2xQL/dOA: calls $1.50
*** FLOP *** [3h 2s 9s]
46qCyJ6evTkHo9al5sBMNA: checks
BypVLsYQt3ePFm2xQL/dOA: checks
*** TURN *** [3h 2s 9s] [6h]
46qCyJ6evTkHo9al5sBMNA: checks
BypVLsYQt3ePFm2xQL/dOA: bets $3.50
46qCyJ6evTkHo9al5sBMNA: folds
BypVLsYQt3ePFm2xQL/dOA collected $3.80 from pot
BypVLsYQt3ePFm2xQL/dOA: doesn't show hand
*** SUMMARY ***
Total pot $4 | Rake $0.20
Board [3h 2s 9s 6h]
Seat 1: 46qCyJ6evTkHo9al5sBMNA (big blind) folded on the Turn
Seat 2: BypVLsYQt3ePFm2xQL/dOA (button) (small blind) collected ($3.80)



PokerStars Game #59940223312:  Hold'em No Limit ($0.25/$0.50) - 2009/07/01 1:00:37 ET
Table 'QOgaEqMcJ73pcUMMxoisUg' 6-max Seat #1 is the button
Seat 1: lxIzoHy0RnkfFSODHC2liw ($50 in chips)
Seat 2: 4QfsCWthT/vSLirorNXqtg ($76.60 in chips)
Seat 3: Rt6KgtZ8YaJoTc3FPim00w ($53 in chips)
Seat 4: zAcsDhG/T128Vn7XGVSgKg ($50 in chips)
Seat 5: 6vNxrjjCl6FwfaaymM9jjg ($26.25 in chips)
Seat 6: GoVjFxr3C+JO9vtJH9+IcA ($63.60 in chips)
4QfsCWthT/vSLirorNXqtg: posts small blind $0.25
Rt6KgtZ8YaJoTc3FPim00w: posts big blind $0.50
*** HOLE CARDS ***
zAcsDhG/T128Vn7XGVSgKg: folds
6vNxrjjCl6FwfaaymM9jjg: folds
GoVjFxr3C+JO9vtJH9+IcA: folds
lxIzoHy0RnkfFSODHC2liw: folds
4QfsCWthT/vSLirorNXqtg: folds
Rt6KgtZ8YaJoTc3FPim00w collected $0.50 from pot
*** SUMMARY ***
Total pot $0.50 | Rake $0
Seat 1: lxIzoHy0RnkfFSODHC2liw (button) folded before Flop (didn't bet)
Seat 2: 4QfsCWthT/vSLirorNXqtg (small blind) folded before Flop
Seat 3: Rt6KgtZ8YaJoTc3FPim00w (big blind) collected ($0.50)
Seat 4: zAcsDhG/T128Vn7XGVSgKg folded before Flop (didn't bet)
Seat 5: 6vNxrjjCl6FwfaaymM9jjg folded before Flop (didn't bet)
Seat 6: GoVjFxr3C+JO9vtJH9+IcA folded before Flop (didn't bet)



PokerStars Game #59940223882:  Hold'em No Limit ($0.25/$0.50) - 2009/07/01 1:00:38 ET
Table 'BCN5su+SsXiy1zRMJi0SJw' 6-max Seat #4 is the button
Seat 1: GxXV09ciXaOxyY2H5aMIIw ($32.40 in chips)
Seat 2: oU2kDCkT/gilYbHWrg7D8w ($44.60 in chips)
Seat 3: 6wzJiRvp8HY6t+MQGnSIzA ($18.85 in chips)
Seat 4: qfeUHOJpMYyzQcj0o2A7ng ($5.75 in chips)
Seat 5: IBNygaT1aa9Z1uPdJJilwA ($30.35 in chips)
Seat 6: b2symlOdL7+0c9Pj4N/KlA ($65 in chips)
IBNygaT1aa9Z1uPdJJilwA: posts small blind $0.25
b2symlOdL7+0c9Pj4N/KlA: posts big blind $0.50
*** HOLE CARDS ***
GxXV09ciXaOxyY2H5aMIIw: folds
oU2kDCkT/gilYbHWrg7D8w: folds
6wzJiRvp8HY6t+MQGnSIzA: folds
qfeUHOJpMYyzQcj0o2A7ng: folds
oU2kDCkT/gilYbHWrg7D8w said, "y?"
IBNygaT1aa9Z1uPdJJilwA: calls $0.25
6wzJiRvp8HY6t+MQGnSIzA said, "this is gay"
b2symlOdL7+0c9Pj4N/KlA: raises $1.50 to $2
IBNygaT1aa9Z1uPdJJilwA: calls $1.50
*** FLOP *** [Th 5c 9h]
oU2kDCkT/gilYbHWrg7D8w said, "yep"
IBNygaT1aa9Z1uPdJJilwA: checks
b2symlOdL7+0c9Pj4N/KlA: bets $2.50
IBNygaT1aa9Z1uPdJJilwA: calls $2.50
*** TURN *** [Th 5c 9h] [Ts]
IBNygaT1aa9Z1uPdJJilwA: checks
6wzJiRvp8HY6t+MQGnSIzA is sitting out
b2symlOdL7+0c9Pj4N/KlA: bets $6.50
IBNygaT1aa9Z1uPdJJilwA: raises $19.35 to $25.85 and is all-in
b2symlOdL7+0c9Pj4N/KlA: folds
IBNygaT1aa9Z1uPdJJilwA collected $20.95 from pot
*** SUMMARY ***
Total pot $22 | Rake $1.05
Board [Th 5c 9h Ts]
Seat 1: GxXV09ciXaOxyY2H5aMIIw folded before Flop (didn't bet)
Seat 2: oU2kDCkT/gilYbHWrg7D8w folded before Flop (didn't bet)
Seat 3: 6wzJiRvp8HY6t+MQGnSIzA folded before Flop (didn't bet)
Seat 4: qfeUHOJpMYyzQcj0o2A7ng (button) folded before Flop (didn't bet)
Seat 5: IBNygaT1aa9Z1uPdJJilwA (small blind) collected ($20.95)
Seat 6: b2symlOdL7+0c9Pj4N/KlA (big blind) folded on the Turn



PokerStars Game #59940224298:  Hold'em No Limit ($0.25/$0.50) - 2009/07/01 1:00:38 ET
Table '+dXkOAQyS8j9PQZusUTMpg' 2-max Seat #2 is the button
Seat 1: XFa6sBGjP2gxoIvxR3fZIg ($61.70 in chips)
Seat 2: 5IBeOgaApY1Bvzv2P8X4EA ($136.65 in chips)
5IBeOgaApY1Bvzv2P8X4EA: posts small blind $0.25
XFa6sBGjP2gxoIvxR3fZIg: posts big blind $0.50
*** HOLE CARDS ***
5IBeOgaApY1Bvzv2P8X4EA: folds
XFa6sBGjP2gxoIvxR3fZIg collected $0.50 from pot
*** SUMMARY ***
Total pot $0.50 | Rake $0
Seat 1: XFa6sBGjP2gxoIvxR3fZIg (big blind) collected ($0.50)
Seat 2: 5IBeOgaApY1Bvzv2P8X4EA (button) (small blind) folded before Flop



PokerStars Game #59940224902:  Hold'em No Limit ($0.25/$0.50) - 2009/07/01 1:00:39 ET
Table '8BQGgNetI1NOvWeu3gtMNw' 2-max Seat #2 is the button
Seat 1: bypIyrYcAAifLfhZpGlKLA ($57 in chips)
Seat 2: Z4HwehErEwzsv/noQlfUlg ($144.75 in chips)
Z4HwehErEwzsv/noQlfUlg: posts small blind $0.25
bypIyrYcAAifLfhZpGlKLA: posts big blind $0.50
*** HOLE CARDS ***
Z4HwehErEwzsv/noQlfUlg: folds
bypIyrYcAAifLfhZpGlKLA collected $0.50 from pot
bypIyrYcAAifLfhZpGlKLA: doesn't show hand
*** SUMMARY ***
Total pot $0.50 | Rake $0
Seat 1: bypIyrYcAAifLfhZpGlKLA (big blind) collected ($0.50)
Seat 2: Z4HwehErEwzsv/noQlfUlg (button) (small blind) folded before Flop



PokerStars Game #59940224988:  Hold'em No Limit ($0.25/$0.50) - 2009/07/01 1:00:40 ET
Table '9Puy2HWN1RQe5SSjq162gA' 2-max Seat #1 is the button
Seat 1: Fp/oksNpipCrD2MJ2pH20g ($10.75 in chips)
Seat 2: tDV+zhxH9+3DkJDzoTERyg ($36.60 in chips)
Fp/oksNpipCrD2MJ2pH20g: posts small blind $0.25
tDV+zhxH9+3DkJDzoTERyg: posts big blind $0.50
*** HOLE CARDS ***
Fp/oksNpipCrD2MJ2pH20g: raises $1.50 to $2
tDV+zhxH9+3DkJDzoTERyg: raises $9 to $11
Fp/oksNpipCrD2MJ2pH20g: calls $8.75 and is all-in
*** FLOP *** [3s 7s As]
*** TURN *** [3s 7s As] [Kc]
*** RIVER *** [3s 7s As Kc] [6d]
*** SHOW DOWN ***
tDV+zhxH9+3DkJDzoTERyg: shows [Qc Ks] (a pair of Kings)
Fp/oksNpipCrD2MJ2pH20g: shows [3d 3h] (three of a kind, Threes)
tDV+zhxH9+3DkJDzoTERyg is sitting out
Fp/oksNpipCrD2MJ2pH20g collected $21 from pot
tDV+zhxH9+3DkJDzoTERyg has returned
tDV+zhxH9+3DkJDzoTERyg is sitting out
*** SUMMARY ***
Total pot $21.50 | Rake $0.50
Board [3s 7s As Kc 6d]
Seat 1: Fp/oksNpipCrD2MJ2pH20g (button) (small blind) showed [3d 3h] and won ($21) with three of a kind, Threes
Seat 2: tDV+zhxH9+3DkJDzoTERyg (big blind) showed [Qc Ks] and lost with a pair of Kings



PokerStars Game #59940226770:  Hold'em No Limit ($0.25/$0.50) - 2009/07/01 1:00:43 ET
Table '/cQuAT3ef4t+PGrXiNhGaQ' 9-max Seat #8 is the button
Seat 1: HZkVla4kK2SI42CVrPZ/ig ($15 in chips)
Seat 2: jXGruyaMqirTaTXNOvBdew ($72.70 in chips)
Seat 3: g4k0NXISyLCqaSWZDBjfEg ($54.25 in chips)
Seat 4: OWP/DOu+PlPK6ZZ3zYa0HA ($24.40 in chips)
Seat 5: 5SgaHdWixdClWvaEG+KUjQ ($15.85 in chips)
Seat 6: APYIOyK/4AGb+kIwlOUNBQ ($36.50 in chips)
Seat 7: J0W5D97jl5VLky+IoPvDeA ($110.65 in chips)
Seat 8: eBrej2jnlUCs/JgxFCRn2g ($51.80 in chips)
Seat 9: AjV5McH1KMMclY26QdLM5w ($25.95 in chips)
AjV5McH1KMMclY26QdLM5w: posts small blind $0.25
HZkVla4kK2SI42CVrPZ/ig: posts big blind $0.50
*** HOLE CARDS ***
jXGruyaMqirTaTXNOvBdew: folds
g4k0NXISyLCqaSWZDBjfEg: folds
OWP/DOu+PlPK6ZZ3zYa0HA: raises $1 to $1.50
5SgaHdWixdClWvaEG+KUjQ: calls $1.50
APYIOyK/4AGb+kIwlOUNBQ: folds
J0W5D97jl5VLky+IoPvDeA: folds
eBrej2jnlUCs/JgxFCRn2g: calls $1.50
AjV5McH1KMMclY26QdLM5w: folds
HZkVla4kK2SI42CVrPZ/ig: folds
*** FLOP *** [5h Jc 3c]
OWP/DOu+PlPK6ZZ3zYa0HA: bets $3
5SgaHdWixdClWvaEG+KUjQ: folds
eBrej2jnlUCs/JgxFCRn2g: calls $3
*** TURN *** [5h Jc 3c] [Kd]
OWP/DOu+PlPK6ZZ3zYa0HA: bets $6.50
eBrej2jnlUCs/JgxFCRn2g: folds
OWP/DOu+PlPK6ZZ3zYa0HA collected $10.70 from pot
*** SUMMARY ***
Total pot $11.25 | Rake $0.55
Board [5h Jc 3c Kd]
Seat 1: HZkVla4kK2SI42CVrPZ/ig (big blind) folded before Flop
Seat 2: jXGruyaMqirTaTXNOvBdew folded before Flop (didn't bet)
Seat 3: g4k0NXISyLCqaSWZDBjfEg folded before Flop (didn't bet)
Seat 4: OWP/DOu+PlPK6ZZ3zYa0HA collected ($10.70)
Seat 5: 5SgaHdWixdClWvaEG+KUjQ folded on the Flop
Seat 6: APYIOyK/4AGb+kIwlOUNBQ folded before Flop (didn't bet)
Seat 7: J0W5D97jl5VLky+IoPvDeA folded before Flop (didn't bet)
Seat 8: eBrej2jnlUCs/JgxFCRn2g (button) folded on the Turn
Seat 9: AjV5McH1KMMclY26QdLM5w (small blind) folded before Flop



PokerStars Game #59940228202:  Hold'em No Limit ($0.25/$0.50) - 2009/07/01 1:00:45 ET
Table 'E7bWJ45aoFXRpyRv2gw+Ig' 2-max Seat #2 is the button
Seat 1: FRkiRasEGlHUeLrEl+k/nA ($90.20 in chips)
Seat 2: 3Wro85I7472vJ4Wkpneo9A ($99 in chips)
3Wro85I7472vJ4Wkpneo9A: posts small blind $0.25
FRkiRasEGlHUeLrEl+k/nA: posts big blind $0.50
*** HOLE CARDS ***
3Wro85I7472vJ4Wkpneo9A: raises $1 to $1.50
FRkiRasEGlHUeLrEl+k/nA: calls $1
*** FLOP *** [Jh Ac 4h]
FRkiRasEGlHUeLrEl+k/nA: checks
3Wro85I7472vJ4Wkpneo9A: bets $2
FRkiRasEGlHUeLrEl+k/nA: calls $2
*** TURN *** [Jh Ac 4h] [Jd]
FRkiRasEGlHUeLrEl+k/nA: checks
3Wro85I7472vJ4Wkpneo9A: bets $4.50
FRkiRasEGlHUeLrEl+k/nA: raises $9 to $13.50
3Wro85I7472vJ4Wkpneo9A: calls $9
*** RIVER *** [Jh Ac 4h Jd] [4s]
FRkiRasEGlHUeLrEl+k/nA: bets $15
3Wro85I7472vJ4Wkpneo9A: calls $15
*** SHOW DOWN ***
FRkiRasEGlHUeLrEl+k/nA: shows [7s 9s] (two pair, Jacks and Fours)
3Wro85I7472vJ4Wkpneo9A: shows [As Kd] (two pair, Aces and Jacks)
3Wro85I7472vJ4Wkpneo9A collected $63.50 from pot
*** SUMMARY ***
Total pot $64 | Rake $0.50
Board [Jh Ac 4h Jd 4s]
Seat 1: FRkiRasEGlHUeLrEl+k/nA (big blind) showed [7s 9s] and lost with two pair, Jacks and Fours
Seat 2: 3Wro85I7472vJ4Wkpneo9A (button) (small blind) showed [As Kd] and won ($63.50) with two pair, Aces and Jacks



PokerStars Game #59940228232:  Hold'em No Limit ($0.25/$0.50) - 2009/07/01 1:00:45 ET
Table '+dXkOAQyS8j9PQZusUTMpg' 2-max Seat #1 is the button
Seat 1: XFa6sBGjP2gxoIvxR3fZIg ($61.95 in chips)
Seat 2: 5IBeOgaApY1Bvzv2P8X4EA ($136.40 in chips)
XFa6sBGjP2gxoIvxR3fZIg: posts small blind $0.25
5IBeOgaApY1Bvzv2P8X4EA: posts big blind $0.50
*** HOLE CARDS ***
XFa6sBGjP2gxoIvxR3fZIg: raises $1 to $1.50
5IBeOgaApY1Bvzv2P8X4EA: folds
XFa6sBGjP2gxoIvxR3fZIg collected $1 from pot
*** SUMMARY ***
Total pot $1 | Rake $0
Seat 1: XFa6sBGjP2gxoIvxR3fZIg (button) (small blind) collected ($1)
Seat 2: 5IBeOgaApY1Bvzv2P8X4EA (big blind) folded before Flop



PokerStars Game #59940228228:  Hold'em No Limit ($0.25/$0.50) - 2009/07/01 1:00:45 ET
Table '5EmHi+fnatGQQShcNmzOZQ' 6-max Seat #1 is the button
Seat 1: My8WkRtGx5FW6rJ1I4R3hg ($9.85 in chips)
Seat 2: bfFjgAtIoAI+pUxUwFt3aQ ($49.50 in chips)
Seat 3: TjmTe3bhs9dFz5gXX9x7Lw ($22.15 in chips)
Seat 4: 1b+2BbjMN8qhR1WPqdE9VQ ($65.80 in chips)
Seat 5: kxPhs4ePFqMy52CInAJ2aw ($82.80 in chips)
Seat 6: 686aeHikcJlgKkSuIFdcXQ ($131.75 in chips)
bfFjgAtIoAI+pUxUwFt3aQ: posts small blind $0.25
TjmTe3bhs9dFz5gXX9x7Lw: posts big blind $0.50
*** HOLE CARDS ***
1b+2BbjMN8qhR1WPqdE9VQ: folds
kxPhs4ePFqMy52CInAJ2aw: folds
686aeHikcJlgKkSuIFdcXQ: folds
My8WkRtGx5FW6rJ1I4R3hg: calls $0.50
bfFjgAtIoAI+pUxUwFt3aQ: calls $0.25
TjmTe3bhs9dFz5gXX9x7Lw: raises $3 to $3.50
My8WkRtGx5FW6rJ1I4R3hg: calls $3
bfFjgAtIoAI+pUxUwFt3aQ: folds
*** FLOP *** [6s 9d 7c]
TjmTe3bhs9dFz5gXX9x7Lw: bets $18.65 and is all-in
My8WkRtGx5FW6rJ1I4R3hg: calls $6.35 and is all-in
*** TURN *** [6s 9d 7c] [5c]
*** RIVER *** [6s 9d 7c 5c] [Th]
*** SHOW DOWN ***
TjmTe3bhs9dFz5gXX9x7Lw: shows [As 7d] (a pair of Sevens)
My8WkRtGx5FW6rJ1I4R3hg: shows [Ks Kh] (a pair of Kings)
My8WkRtGx5FW6rJ1I4R3hg collected $19.25 from pot
*** SUMMARY ***
Total pot $20.20 | Rake $0.95
Board [6s 9d 7c 5c Th]
Seat 1: My8WkRtGx5FW6rJ1I4R3hg (button) showed [Ks Kh] and won ($19.25) with a pair of Kings
Seat 2: bfFjgAtIoAI+pUxUwFt3aQ (small blind) folded before Flop
Seat 3: TjmTe3bhs9dFz5gXX9x7Lw (big blind) showed [As 7d] and lost with a pair of Sevens
Seat 4: 1b+2BbjMN8qhR1WPqdE9VQ folded before Flop (didn't bet)
Seat 5: kxPhs4ePFqMy52CInAJ2aw folded before Flop (didn't bet)
Seat 6: 686aeHikcJlgKkSuIFdcXQ folded before Flop (didn't bet)



PokerStars Game #59940227850:  Hold'em No Limit ($0.25/$0.50) - 2009/07/01 1:00:45 ET
Table 'Nz0Vr7WMHL2g5Uk7dDZjpw' 9-max Seat #8 is the button
Seat 1: tLkxo7JgV+WWI0UBw44K5A ($109.85 in chips)
Seat 3: uw9QayAAxLM3Hb+HR7mSkg ($10 in chips)
Seat 4: E2518gp4aFz1+kAgmGqeEg ($11.50 in chips)
Seat 5: WGW0DgjBUXs1ylURHG8vnQ ($27.90 in chips)
Seat 6: 997ViqAtWn1FPjJqcffwcA ($60.55 in chips)
Seat 7: KPLH0gELgFe2OuAnhJFI5w ($15.35 in chips)
Seat 8: HkZI6g4zl83TDTA7SRspmQ ($17.80 in chips)
Seat 9: mSD1pginDsyHG5PDfqzphw ($10 in chips)
mSD1pginDsyHG5PDfqzphw: posts small blind $0.25
tLkxo7JgV+WWI0UBw44K5A: posts big blind $0.50
gsyXT42WLEcOS4DdEk2wlw: sits out
*** HOLE CARDS ***
uw9QayAAxLM3Hb+HR7mSkg: raises $9.50 to $10 and is all-in
E2518gp4aFz1+kAgmGqeEg: folds
WGW0DgjBUXs1ylURHG8vnQ: folds
997ViqAtWn1FPjJqcffwcA: folds
KPLH0gELgFe2OuAnhJFI5w: folds
HkZI6g4zl83TDTA7SRspmQ said, "two live cards"
HkZI6g4zl83TDTA7SRspmQ said, "i have maybe"
HkZI6g4zl83TDTA7SRspmQ has timed out
HkZI6g4zl83TDTA7SRspmQ: folds
HkZI6g4zl83TDTA7SRspmQ is sitting out
mSD1pginDsyHG5PDfqzphw: folds
HkZI6g4zl83TDTA7SRspmQ has returned
tLkxo7JgV+WWI0UBw44K5A: folds
uw9QayAAxLM3Hb+HR7mSkg collected $1.25 from pot
uw9QayAAxLM3Hb+HR7mSkg: doesn't show hand
*** SUMMARY ***
Total pot $1.25 | Rake $0
Seat 1: tLkxo7JgV+WWI0UBw44K5A (big blind) folded before Flop
Seat 3: uw9QayAAxLM3Hb+HR7mSkg collected ($1.25)
Seat 4: E2518gp4aFz1+kAgmGqeEg folded before Flop (didn't bet)
Seat 5: WGW0DgjBUXs1ylURHG8vnQ folded before Flop (didn't bet)
Seat 6: 997ViqAtWn1FPjJqcffwcA folded before Flop (didn't bet)
Seat 7: KPLH0gELgFe2OuAnhJFI5w folded before Flop (didn't bet)
Seat 8: HkZI6g4zl83TDTA7SRspmQ (button) folded before Flop (didn't bet)
Seat 9: mSD1pginDsyHG5PDfqzphw (small blind) folded before Flop



PokerStars Game #59940228992:  Hold'em No Limit ($0.25/$0.50) - 2009/07/01 1:00:46 ET
Table '0eJtgVAXVvBgncFdcUpXcQ' 2-max Seat #1 is the button
Seat 1: Ag6DvxX4vbRheqsv2zXKTQ ($34.70 in chips)
Seat 2: KMc4R+K9ao4Ur3rF7NGe6Q ($13.90 in chips)
Ag6DvxX4vbRheqsv2zXKTQ: posts small blind $0.25
KMc4R+K9ao4Ur3rF7NGe6Q: posts big blind $0.50
*** HOLE CARDS ***
Ag6DvxX4vbRheqsv2zXKTQ: folds
KMc4R+K9ao4Ur3rF7NGe6Q collected $0.50 from pot
*** SUMMARY ***
Total pot $0.50 | Rake $0
Seat 1: Ag6DvxX4vbRheqsv2zXKTQ (button) (small blind) folded before Flop
Seat 2: KMc4R+K9ao4Ur3rF7NGe6Q (big blind) collected ($0.50)



PokerStars Game #59940229840:  Hold'em No Limit ($0.25/$0.50) - 2009/07/01 1:00:48 ET
Table '8BQGgNetI1NOvWeu3gtMNw' 2-max Seat #1 is the button
Seat 1: bypIyrYcAAifLfhZpGlKLA ($57.25 in chips)
Seat 2: Z4HwehErEwzsv/noQlfUlg ($144.50 in chips)
bypIyrYcAAifLfhZpGlKLA: posts small blind $0.25
Z4HwehErEwzsv/noQlfUlg: posts big blind $0.50
*** HOLE CARDS ***
bypIyrYcAAifLfhZpGlKLA: raises $1 to $1.50
Z4HwehErEwzsv/noQlfUlg: calls $1
*** FLOP *** [Qc Tc 9h]
Z4HwehErEwzsv/noQlfUlg: bets $2
bypIyrYcAAifLfhZpGlKLA: folds
Z4HwehErEwzsv/noQlfUlg collected $2.85 from pot
Z4HwehErEwzsv/noQlfUlg: doesn't show hand
*** SUMMARY ***
Total pot $3 | Rake $0.15
Board [Qc Tc 9h]
Seat 1: bypIyrYcAAifLfhZpGlKLA (button) (small blind) folded on the Flop
Seat 2: Z4HwehErEwzsv/noQlfUlg (big blind) collected ($2.85)



PokerStars Game #59940230534:  Hold'em No Limit ($0.25/$0.50) - 2009/07/01 1:00:49 ET
Table 'GfL/No5u5PoEnU39lP5pQg' 6-max Seat #5 is the button
Seat 1: 1WUCqNG+p+vfWRTXNu4ljw ($60.20 in chips)
Seat 2: uVwggSetzp7d+eVgowO3vg ($57 in chips)
Seat 3: eQXFICMuu3hw6XlcmuVNEA ($14.05 in chips)
Seat 4: r6u7MWSXF30/khcTYkrG9Q ($32.70 in chips)
Seat 5: M1KyQQvVPVuxqTAB8sR/zQ ($50.75 in chips)
Seat 6: kxPhs4ePFqMy52CInAJ2aw ($50 in chips)
kxPhs4ePFqMy52CInAJ2aw: posts small blind $0.25
1WUCqNG+p+vfWRTXNu4ljw: posts big blind $0.50
*** HOLE CARDS ***
uVwggSetzp7d+eVgowO3vg: folds
eQXFICMuu3hw6XlcmuVNEA: folds
r6u7MWSXF30/khcTYkrG9Q: folds
M1KyQQvVPVuxqTAB8sR/zQ: folds
kxPhs4ePFqMy52CInAJ2aw: raises $1.50 to $2
1WUCqNG+p+vfWRTXNu4ljw: raises $4 to $6
kxPhs4ePFqMy52CInAJ2aw: calls $4
*** FLOP *** [3s 5c 9d]
kxPhs4ePFqMy52CInAJ2aw: checks
1WUCqNG+p+vfWRTXNu4ljw: bets $7.50
kxPhs4ePFqMy52CInAJ2aw: folds
1WUCqNG+p+vfWRTXNu4ljw collected $11.40 from pot
*** SUMMARY ***
Total pot $12 | Rake $0.60
Board [3s 5c 9d]
Seat 1: 1WUCqNG+p+vfWRTXNu4ljw (big blind) collected ($11.40)
Seat 2: uVwggSetzp7d+eVgowO3vg folded before Flop (didn't bet)
Seat 3: eQXFICMuu3hw6XlcmuVNEA folded before Flop (didn't bet)
Seat 4: r6u7MWSXF30/khcTYkrG9Q folded before Flop (didn't bet)
Seat 5: M1KyQQvVPVuxqTAB8sR/zQ (button) folded before Flop (didn't bet)
Seat 6: kxPhs4ePFqMy52CInAJ2aw (small blind) folded on the Flop



PokerStars Game #59940230756:  Hold'em No Limit ($0.25/$0.50) - 2009/07/01 1:00:49 ET
Table 'E7bWJ45aoFXRpyRv2gw+Ig99gCy/CZQwPIjZWH+BguQgeat #7 is the button
Seat 2: n6VQBu6crjYjy6DxNP1NZA ($28.75 in chips)
Seat 3: qEn9ijNGtuyTxamBf07hYg ($50 in chips)
Seat 4: bxLSulbgr8LmKNjOzw8URg ($62.95 in chips)
Seat 6: OcnLOMVFdy23jXnoTyaO5Q ($264.30 in chips)
Seat 7: bfSq6LBw0UvxeM5yfuWC7w ($19.85 in chips)
Seat 8: 8ehL7qlZzjgUh2H35iiWLw ($50.40 in chips)
Seat 9: j3K/Jujr7PY4ZM2RZvlH6A ($77.45 in chips)
8ehL7qlZzjgUh2H35iiWLw: posts small blind $0.25
j3K/Jujr7PY4ZM2RZvlH6A: posts big blind $0.50
YXCE3WOZi8g2sIf3y/plVw: sits out
*** HOLE CARDS ***
n6VQBu6crjYjy6DxNP1NZA: calls $0.50
qEn9ijNGtuyTxamBf07hYg: folds
bxLSulbgr8LmKNjOzw8URg: folds
OcnLOMVFdy23jXnoTyaO5Q: calls $0.50
qEn9ijNGtuyTxamBf07hYg leaves the table
bfSq6LBw0UvxeM5yfuWC7w: raises $1 to $1.50
8ehL7qlZzjgUh2H35iiWLw: folds
j3K/Jujr7PY4ZM2RZvlH6A: folds
n6VQBu6crjYjy6DxNP1NZA: calls $1
OcnLOMVFdy23jXnoTyaO5Q: calls $1
*** FLOP *** [3c 7c Ts]
n6VQBu6crjYjy6DxNP1NZA: checks
OcnLOMVFdy23jXnoTyaO5Q: checks
bfSq6LBw0UvxeM5yfuWC7w: bets $2.35
n6VQBu6crjYjy6DxNP1NZA: folds
NJ1984 joins the table at seat #3
OcnLOMVFdy23jXnoTyaO5Q: folds
bfSq6LBw0UvxeM5yfuWC7w collected $5 from pot
*** SUMMARY ***
Total pot $5.25 | Rake $0.25
Board [3c 7c Ts]
Seat 2: n6VQBu6crjYjy6DxNP1NZA folded on the Flop
Seat 3: qEn9ijNGtuyTxamBf07hYg folded before Flop (didn't bet)
Seat 4: bxLSulbgr8LmKNjOzw8URg folded before Flop (didn't bet)
Seat 6: OcnLOMVFdy23jXnoTyaO5Q folded on the Flop
Seat 7: bfSq6LBw0UvxeM5yfuWC7w (button) collected ($5)
Seat 8: 8ehL7qlZzjgUh2H35iiWLw (small blind) folded before Flop
Seat 9: j3K/Jujr7PY4ZM2RZvlH6A (big blind) folded before Flop



PokerStars Game #59940231096:  Hold'em No Limit ($0.25/$0.50) - 2009/07/01 1:00:50 ET
Table 'EiNh8p/wGJ1FP575iMFnqg' 9-max Seat #1 is the button
Seat 1: r3ZqM1Mi0W3y4hOdssE+Sg ($44.85 in chips)
Seat 2: 8ehL7qlZzjgUh2H35iiWLw ($52.10 in chips)
Seat 3: ymLPoEIl7UL3TvZYmnadxQ ($52.55 in chips)
Seat 4: cMzaiXAM/ZAdNaEUu+LqhA ($55.70 in chips)
Seat 5: M+7+BTmX5vZatHVuoRB1nA ($82.20 in chips)
Seat 6: 3UmXLy3GfjC3EkOebduerQ ($64.10 in chips)
Seat 7: 997ViqAtWn1FPjJqcffwcA ($50 in chips)
Seat 8: mSD1pginDsyHG5PDfqzphw ($10 in chips)
Seat 9: NnQCepdIR/AOUQn1yhYx6Q ($11.75 in chips)
8ehL7qlZzjgUh2H35iiWLw: posts small blind $0.25
ymLPoEIl7UL3TvZYmnadxQ: posts big blind $0.50
*** HOLE CARDS ***
cMzaiXAM/ZAdNaEUu+LqhA: folds
M+7+BTmX5vZatHVuoRB1nA: folds
3UmXLy3GfjC3EkOebduerQ: folds
997ViqAtWn1FPjJqcffwcA: folds
mSD1pginDsyHG5PDfqzphw: raises $1 to $1.50
NnQCepdIR/AOUQn1yhYx6Q: folds
r3ZqM1Mi0W3y4hOdssE+Sg: folds
8ehL7qlZzjgUh2H35iiWLw: folds
ymLPoEIl7UL3TvZYmnadxQ: calls $1
*** FLOP *** [4d Qh Kd]
ymLPoEIl7UL3TvZYmnadxQ: checks
mSD1pginDsyHG5PDfqzphw: bets $2.50
ymLPoEIl7UL3TvZYmnadxQ: folds
mSD1pginDsyHG5PDfqzphw collected $3.10 from pot
mSD1pginDsyHG5PDfqzphw: doesn't show hand
*** SUMMARY ***
Total pot $3.25 | Rake $0.15
Board [4d Qh Kd]
Seat 1: r3ZqM1Mi0W3y4hOdssE+Sg (button) folded before Flop (didn't bet)
Seat 2: 8ehL7qlZzjgUh2H35iiWLw (small blind) folded before Flop
Seat 3: ymLPoEIl7UL3TvZYmnadxQ (big blind) folded on the Flop
Seat 4: cMzaiXAM/ZAdNaEUu+LqhA folded before Flop (didn't bet)
Seat 5: M+7+BTmX5vZatHVuoRB1nA folded before Flop (didn't bet)
Seat 6: 3UmXLy3GfjC3EkOebduerQ folded before Flop (didn't bet)
Seat 7: 997ViqAtWn1FPjJqcffwcA folded before Flop (didn't bet)
Seat 8: mSD1pginDsyHG5PDfqzphw collected ($3.10)
Seat 9: NnQCepdIR/AOUQn1yhYx6Q folded before Flop (didn't bet)



PokerStars Game #59940231986:  Hold'em No Limit ($0.25/$0.50) - 2009/07/01 1:00:51 ET
Table '+z1aekfHkpp09pc8F9aViw' 6-max Seat #4 is the button
Seat 1: FHilMb2i2DbUCc9lplszog ($18.05 in chips)
Seat 2: M6xK/VklCvdyyrmvzATlxQ ($33.75 in chips)
Seat 3: uUznlIMFnRUvwrBhYF73KA ($124.90 in chips)
Seat 4: RowCSpSURHTOL/dcjg/Iug ($39.55 in chips)
Seat 5: rplyldNweS6YyMNEALQrug ($55.50 in chips)
Seat 6: 686aeHikcJlgKkSuIFdcXQ ($50 in chips)
rplyldNweS6YyMNEALQrug: posts small blind $0.25
686aeHikcJlgKkSuIFdcXQ: posts big blind $0.50
*** HOLE CARDS ***
FHilMb2i2DbUCc9lplszog: raises $1.50 to $2
M6xK/VklCvdyyrmvzATlxQ: folds
uUznlIMFnRUvwrBhYF73KA: calls $2
RowCSpSURHTOL/dcjg/Iug: folds
rplyldNweS6YyMNEALQrug: calls $1.75
686aeHikcJlgKkSuIFdcXQ: calls $1.50
*** FLOP *** [7d Th 4d]
rplyldNweS6YyMNEALQrug: checks
686aeHikcJlgKkSuIFdcXQ: checks
FHilMb2i2DbUCc9lplszog: bets $3.50
uUznlIMFnRUvwrBhYF73KA: folds
rplyldNweS6YyMNEALQrug: folds
686aeHikcJlgKkSuIFdcXQ: calls $3.50
*** TURN *** [7d Th 4d] [3c]
686aeHikcJlgKkSuIFdcXQ: checks
FHilMb2i2DbUCc9lplszog: bets $12.55 and is all-in
686aeHikcJlgKkSuIFdcXQ: folds
FHilMb2i2DbUCc9lplszog collected $14.30 from pot
*** SUMMARY ***
Total pot $15 | Rake $0.70
Board [7d Th 4d 3c]
Seat 1: FHilMb2i2DbUCc9lplszog collected ($14.30)
Seat 2: M6xK/VklCvdyyrmvzATlxQ folded before Flop (didn't bet)
Seat 3: uUznlIMFnRUvwrBhYF73KA folded on the Flop
Seat 4: RowCSpSURHTOL/dcjg/Iug (button) folded before Flop (didn't bet)
Seat 5: rplyldNweS6YyMNEALQrug (small blind) folded on the Flop
Seat 6: 686aeHikcJlgKkSuIFdcXQ (big blind) folded on the Turn



PokerStars Game #59940232212:  Hold'em No Limit ($0.25/$0.50) - 2009/07/01 1:00:52 ET
Table '0eJtgVAXVvBgncFdcUpXcQ' 2-max Seat #2 is the button
Seat 1: Ag6DvxX4vbRheqsv2zXKTQ ($34.45 in chips)
Seat 2: KMc4R+K9ao4Ur3rF7NGe6Q ($14.15 in chips)
KMc4R+K9ao4Ur3rF7NGe6Q: posts small blind $0.25
Ag6DvxX4vbRheqsv2zXKTQ: posts big blind $0.50
*** HOLE CARDS ***
KMc4R+K9ao4Ur3rF7NGe6Q: folds
Ag6DvxX4vbRheqsv2zXKTQ collected $0.50 from pot
*** SUMMARY ***
Total pot $0.50 | Rake $0
Seat 1: Ag6DvxX4vbRheqsv2zXKTQ (big blind) collected ($0.50)
Seat 2: KMc4R+K9ao4Ur3rF7NGe6Q (button) (small blind) folded before Flop



PokerStars Game #59940232716:  Hold'em No Limit ($0.25/$0.50) - 2009/07/01 1:00:52 ET
Table '+dXkOAQyS8j9PQZusUTMpg' 2-max Seat #2 is the button
Seat 1: XFa6sBGjP2gxoIvxR3fZIg ($62.45 in chips)
Seat 2: 5IBeOgaApY1Bvzv2P8X4EA ($135.90 in chips)
5IBeOgaApY1Bvzv2P8X4EA: posts small blind $0.25
XFa6sBGjP2gxoIvxR3fZIg: posts big blind $0.50
*** HOLE CARDS ***
5IBeOgaApY1Bvzv2P8X4EA: calls $0.25
XFa6sBGjP2gxoIvxR3fZIg: checks
*** FLOP *** [3c Th Ks]
XFa6sBGjP2gxoIvxR3fZIg: checks
5IBeOgaApY1Bvzv2P8X4EA: checks
*** TURN *** [3c Th Ks] [8s]
XFa6sBGjP2gxoIvxR3fZIg: checks
5IBeOgaApY1Bvzv2P8X4EA: checks
*** RIVER *** [3c Th Ks 8s] [Jd]
XFa6sBGjP2gxoIvxR3fZIg: checks
5IBeOgaApY1Bvzv2P8X4EA: checks
*** SHOW DOWN ***
XFa6sBGjP2gxoIvxR3fZIg: shows [8d 6c] (a pair of Eights)
5IBeOgaApY1Bvzv2P8X4EA: mucks hand
XFa6sBGjP2gxoIvxR3fZIg collected $0.95 from pot
*** SUMMARY ***
Total pot $1 | Rake $0.05
Board [3c Th Ks 8s Jd]
Seat 1: XFa6sBGjP2gxoIvxR3fZIg (big blind) showed [8d 6c] and won ($0.95) with a pair of Eights
Seat 2: 5IBeOgaApY1Bvzv2P8X4EA (button) (small blind) mucked



PokerStars Game #59940236718:  Hold'em No Limit ($0.25/$0.50) - 2009/07/01 1:00:59 ET
Table '0eJtgVAXVvBgncFdcUpXcQ' 2-max Seat #1 is the button
Seat 1: Ag6DvxX4vbRheqsv2zXKTQ ($34.70 in chips)
Seat 2: KMc4R+K9ao4Ur3rF7NGe6Q ($13.90 in chips)
Ag6DvxX4vbRheqsv2zXKTQ: posts small blind $0.25
KMc4R+K9ao4Ur3rF7NGe6Q: posts big blind $0.50
*** HOLE CARDS ***
Ag6DvxX4vbRheqsv2zXKTQ: calls $0.25
KMc4R+K9ao4Ur3rF7NGe6Q: checks
*** FLOP *** [Jc Jd Qc]
KMc4R+K9ao4Ur3rF7NGe6Q: checks
Ag6DvxX4vbRheqsv2zXKTQ: checks
*** TURN *** [Jc Jd Qc] [2h]
KMc4R+K9ao4Ur3rF7NGe6Q: bets $1
Ag6DvxX4vbRheqsv2zXKTQ: calls $1
*** RIVER *** [Jc Jd Qc 2h] [8h]
KMc4R+K9ao4Ur3rF7NGe6Q: bets $1.50
Ag6DvxX4vbRheqsv2zXKTQ: folds
KMc4R+K9ao4Ur3rF7NGe6Q collected $2.90 from pot
KMc4R+K9ao4Ur3rF7NGe6Q: doesn't show hand
*** SUMMARY ***
Total pot $3 | Rake $0.10
Board [Jc Jd Qc 2h 8h]
Seat 1: Ag6DvxX4vbRheqsv2zXKTQ (button) (small blind) folded on the River
Seat 2: KMc4R+K9ao4Ur3rF7NGe6Q (big blind) collected ($2.90)



PokerStars Game #59940238482:  Hold'em No Limit ($0.25/$0.50) - 2009/07/01 1:01:02 ET
Table 'QOgaEqMcJ73pcUMMxoisUg' 6-max Seat #2 is the button
Seat 1: lxIzoHy0RnkfFSODHC2liw ($50 in chips)
Seat 2: 4QfsCWthT/vSLirorNXqtg ($76.35 in chips)
Seat 3: Rt6KgtZ8YaJoTc3FPim00w ($53.25 in chips)
Seat 4: zAcsDhG/T128Vn7XGVSgKg ($50 in chips)
Seat 5: 6vNxrjjCl6FwfaaymM9jjg ($26.25 in chips)
Seat 6: GoVjFxr3C+JO9vtJH9+IcA ($63.60 in chips)
Rt6KgtZ8YaJoTc3FPim00w: posts small blind $0.25
zAcsDhG/T128Vn7XGVSgKg: posts big blind $0.50
*** HOLE CARDS ***
6vNxrjjCl6FwfaaymM9jjg: folds
GoVjFxr3C+JO9vtJH9+IcA: calls $0.50
lxIzoHy0RnkfFSODHC2liw: folds
4QfsCWthT/vSLirorNXqtg: folds
Rt6KgtZ8YaJoTc3FPim00w: folds
zAcsDhG/T128Vn7XGVSgKg: checks
*** FLOP *** [Ks Qd Ah]
zAcsDhG/T128Vn7XGVSgKg: checks
GoVjFxr3C+JO9vtJH9+IcA: bets $1
zAcsDhG/T128Vn7XGVSgKg: folds
GoVjFxr3C+JO9vtJH9+IcA collected $1.20 from pot
*** SUMMARY ***
Total pot $1.25 | Rake $0.05
Board [Ks Qd Ah]
Seat 1: lxIzoHy0RnkfFSODHC2liw folded before Flop (didn't bet)
Seat 2: 4QfsCWthT/vSLirorNXqtg (button) folded before Flop (didn't bet)
Seat 3: Rt6KgtZ8YaJoTc3FPim00w (small blind) folded before Flop
Seat 4: zAcsDhG/T128Vn7XGVSgKg (big blind) folded on the Flop
Seat 5: 6vNxrjjCl6FwfaaymM9jjg folded before Flop (didn't bet)
Seat 6: GoVjFxr3C+JO9vtJH9+IcA collected ($1.20)



PokerStars Game #59940239256:  Hold'em No Limit ($0.25/$0.50) - 2009/07/01 1:01:03 ET
Table 'lSisgp6H7Fg1hH5VfjEjYQ' 9-max Seat #1 is the button
Seat 1: 5k9fvXD9suIgCxU4HLQjTw ($50 in chips)
Seat 2: UrcnkQOiLVk8BlKDPJSy7Q ($76.10 in chips)
Seat 3: aTkyjTh3w5YLWiIERupZOA ($51.95 in chips)
Seat 4: bwv/rbH/hHhPhY6u9mu04w ($31.60 in chips)
Seat 5: mSD1pginDsyHG5PDfqzphw ($10 in chips)
Seat 6: +k7T5ocke8UwavtgUHm+Cg ($67.80 in chips)
Seat 7: IDtNLR9uFCDdjNsJWMHA5Q ($21 in chips)
Seat 8: a4JDWmpFQkL10XfAyuF51A ($27.75 in chips)
UrcnkQOiLVk8BlKDPJSy7Q: posts small blind $0.25
aTkyjTh3w5YLWiIERupZOA: posts big blind $0.50
tkflckdgk: sits out
*** HOLE CARDS ***
bwv/rbH/hHhPhY6u9mu04w: folds
mSD1pginDsyHG5PDfqzphw: folds
+k7T5ocke8UwavtgUHm+Cg: folds
IDtNLR9uFCDdjNsJWMHA5Q: calls $0.50
a4JDWmpFQkL10XfAyuF51A: folds
5k9fvXD9suIgCxU4HLQjTw: folds
UrcnkQOiLVk8BlKDPJSy7Q: folds
aTkyjTh3w5YLWiIERupZOA: checks
*** FLOP *** [Ac Ad 3d]
aTkyjTh3w5YLWiIERupZOA: checks
IDtNLR9uFCDdjNsJWMHA5Q: bets $1
aTkyjTh3w5YLWiIERupZOA: folds
IDtNLR9uFCDdjNsJWMHA5Q collected $1.20 from pot
*** SUMMARY ***
Total pot $1.25 | Rake $0.05
Board [Ac Ad 3d]
Seat 1: 5k9fvXD9suIgCxU4HLQjTw (button) folded before Flop (didn't bet)
Seat 2: UrcnkQOiLVk8BlKDPJSy7Q (small blind) folded before Flop
Seat 3: aTkyjTh3w5YLWiIERupZOA (big blind) folded on the Flop
Seat 4: bwv/rbH/hHhPhY6u9mu04w folded before Flop (didn't bet)
Seat 5: mSD1pginDsyHG5PDfqzphw folded before Flop (didn't bet)
Seat 6: +k7T5ocke8UwavtgUHm+Cg folded before Flop (didn't bet)
Seat 7: IDtNLR9uFCDdjNsJWMHA5Q collected ($1.20)
Seat 8: a4JDWmpFQkL10XfAyuF51A folded before Flop (didn't bet)



PokerStars Game #59940240710:  Hold'em No Limit ($0.25/$0.50) - 2009/07/01 1:01:05 ET
Table 'kgbJRsxfv64KrErDRBAkcw' 6-max Seat #4 is the button
Seat 1: VamsyhlFzXGF6/ydo0BHeA ($43.05 in chips)
Seat 2: AdS8BJMOheS01zjCDfPMFg ($50 in chips)
Seat 3: c4MNIaIyPMOMxrgT8FT5nA ($134.50 in chips)
Seat 4: qanMEqjABjWxC/JgQ/0l7w ($56.50 in chips)
Seat 5: eUBBn2R56C1IQ6Cs/vitwg ($55.50 in chips)
Seat 6: 1b+2BbjMN8qhR1WPqdE9VQ ($52.65 in chips)
eUBBn2R56C1IQ6Cs/vitwg: posts small blind $0.25
1b+2BbjMN8qhR1WPqdE9VQ: posts big blind $0.50
*** HOLE CARDS ***
VamsyhlFzXGF6/ydo0BHeA: raises $2 to $2.50
AdS8BJMOheS01zjCDfPMFg: calls $2.50
c4MNIaIyPMOMxrgT8FT5nA: folds
qanMEqjABjWxC/JgQ/0l7w: folds
eUBBn2R56C1IQ6Cs/vitwg: folds
1b+2BbjMN8qhR1WPqdE9VQ: calls $2
*** FLOP *** [8s 7d Js]
1b+2BbjMN8qhR1WPqdE9VQ: checks
VamsyhlFzXGF6/ydo0BHeA: checks
AdS8BJMOheS01zjCDfPMFg: checks
*** TURN *** [8s 7d Js] [Tc]
1b+2BbjMN8qhR1WPqdE9VQ: checks
VamsyhlFzXGF6/ydo0BHeA: checks
AdS8BJMOheS01zjCDfPMFg: checks
*** RIVER *** [8s 7d Js Tc] [9d]
1b+2BbjMN8qhR1WPqdE9VQ: checks
VamsyhlFzXGF6/ydo0BHeA: checks
AdS8BJMOheS01zjCDfPMFg: checks
*** SHOW DOWN ***
1b+2BbjMN8qhR1WPqdE9VQ: shows [7s 7c] (a straight, Seven to Jack)
VamsyhlFzXGF6/ydo0BHeA: shows [Ah Kd] (a straight, Seven to Jack)
AdS8BJMOheS01zjCDfPMFg: shows [6c 6d] (a straight, Seven to Jack)
1b+2BbjMN8qhR1WPqdE9VQ collected $2.50 from pot
VamsyhlFzXGF6/ydo0BHeA collected $2.45 from pot
AdS8BJMOheS01zjCDfPMFg collected $2.45 from pot
*** SUMMARY ***
Total pot $7.75 | Rake $0.35
Board [8s 7d Js Tc 9d]
Seat 1: VamsyhlFzXGF6/ydo0BHeA showed [Ah Kd] and won ($2.45) with a straight, Seven to Jack
Seat 2: AdS8BJMOheS01zjCDfPMFg showed [6c 6d] and won ($2.45) with a straight, Seven to Jack
Seat 3: c4MNIaIyPMOMxrgT8FT5nA folded before Flop (didn't bet)
Seat 4: qanMEqjABjWxC/JgQ/0l7w (button) folded before Flop (didn't bet)
Seat 5: eUBBn2R56C1IQ6Cs/vitwg (small blind) folded before Flop
Seat 6: 1b+2BbjMN8qhR1WPqdE9VQ (big blind) showed [7s 7c] and won ($2.50) with a straight, Seven to Jack



PokerStars Game #59940241568:  Hold'em No Limit ($0.25/$0.50) - 2009/07/01 1:01:07 ET
Table 'ErOuyGLI5PT3G5MnpHgC/gQOgaEqMcJ73pcUMMxoisUg Seat #5 is the button
Seat 1: eBrej2jnlUCs/JgxFCRn2g ($40.75 in chips)
Seat 2: pciZn00ZDk4BVBMTTMcNVQ ($29.50 in chips)
Seat 3: xZCXQSXlrZkp3pZizzVXCw ($52.75 in chips)
Seat 4: 3UmXLy3GfjC3EkOebduerQ ($50 in chips)
Seat 5: JwvquocWfhTVApN5t47LgA ($62.60 in chips)
Seat 6: zE9cVigS2nW/Ljy4K4bUQA ($31.10 in chips)
Seat 7: 90Wb75h3W1BRpbqVnuk8gw ($63.60 in chips)
Seat 8: g4k0NXISyLCqaSWZDBjfEg ($50 in chips)
Seat 9: J0W5D97jl5VLky+IoPvDeA ($52.15 in chips)
zE9cVigS2nW/Ljy4K4bUQA: posts small blind $0.25
90Wb75h3W1BRpbqVnuk8gw: posts big blind $0.50
*** HOLE CARDS ***
g4k0NXISyLCqaSWZDBjfEg: folds
J0W5D97jl5VLky+IoPvDeA: folds
eBrej2jnlUCs/JgxFCRn2g has timed out
eBrej2jnlUCs/JgxFCRn2g: folds
eBrej2jnlUCs/JgxFCRn2g is sitting out
pciZn00ZDk4BVBMTTMcNVQ: folds
xZCXQSXlrZkp3pZizzVXCw: folds
3UmXLy3GfjC3EkOebduerQ: folds
JwvquocWfhTVApN5t47LgA: folds
zE9cVigS2nW/Ljy4K4bUQA: folds
90Wb75h3W1BRpbqVnuk8gw collected $0.50 from pot
*** SUMMARY ***
Total pot $0.50 | Rake $0
Seat 1: eBrej2jnlUCs/JgxFCRn2g folded before Flop (didn't bet)
Seat 2: pciZn00ZDk4BVBMTTMcNVQ folded before Flop (didn't bet)
Seat 3: xZCXQSXlrZkp3pZizzVXCw folded before Flop (didn't bet)
Seat 4: 3UmXLy3GfjC3EkOebduerQ folded before Flop (didn't bet)
Seat 5: JwvquocWfhTVApN5t47LgA (button) folded before Flop (didn't bet)
Seat 6: zE9cVigS2nW/Ljy4K4bUQA (small blind) folded before Flop
Seat 7: 90Wb75h3W1BRpbqVnuk8gw (big blind) collected ($0.50)
Seat 8: g4k0NXISyLCqaSWZDBjfEg folded before Flop (didn't bet)
Seat 9: J0W5D97jl5VLky+IoPvDeA folded before Flop (didn't bet)



PokerStars Game #59940242602:  Hold'em No Limit ($0.25/$0.50) - 2009/07/01 1:01:09 ET
Table 'c/CRn+68J3Y8KxD5g1ek2Q' 2-max Seat #1 is the button
Seat 1: 46qCyJ6evTkHo9al5sBMNA ($90.45 in chips)
Seat 2: BypVLsYQt3ePFm2xQL/dOA ($278 in chips)
46qCyJ6evTkHo9al5sBMNA: posts small blind $0.25
BypVLsYQt3ePFm2xQL/dOA: posts big blind $0.50
*** HOLE CARDS ***
46qCyJ6evTkHo9al5sBMNA: raises $1.50 to $2
BypVLsYQt3ePFm2xQL/dOA: calls $1.50
*** FLOP *** [5s Kd 6h]
BypVLsYQt3ePFm2xQL/dOA: checks
46qCyJ6evTkHo9al5sBMNA: checks
*** TURN *** [5s Kd 6h] [3s]
BypVLsYQt3ePFm2xQL/dOA: checks
46qCyJ6evTkHo9al5sBMNA: checks
*** RIVER *** [5s Kd 6h 3s] [Jc]
BypVLsYQt3ePFm2xQL/dOA: bets $1.50
46qCyJ6evTkHo9al5sBMNA: folds
BypVLsYQt3ePFm2xQL/dOA collected $3.80 from pot
BypVLsYQt3ePFm2xQL/dOA: doesn't show hand
*** SUMMARY ***
Total pot $4 | Rake $0.20
Board [5s Kd 6h 3s Jc]
Seat 1: 46qCyJ6evTkHo9al5sBMNA (button) (small blind) folded on the River
Seat 2: BypVLsYQt3ePFm2xQL/dOA (big blind) collected ($3.80)



PokerStars Game #59940243598:  Hold'em No Limit ($0.25/$0.50) - 2009/07/01 1:01:10 ET
Table '8BQGgNetI1NOvWeu3gtMNw' 2-max Seat #2 is the button
Seat 1: bypIyrYcAAifLfhZpGlKLA ($55.75 in chips)
Seat 2: Z4HwehErEwzsv/noQlfUlg ($145.85 in chips)
Z4HwehErEwzsv/noQlfUlg: posts small blind $0.25
bypIyrYcAAifLfhZpGlKLA: posts big blind $0.50
*** HOLE CARDS ***
Z4HwehErEwzsv/noQlfUlg: raises $0.50 to $1
bypIyrYcAAifLfhZpGlKLA: calls $0.50
*** FLOP *** [Jd Qd 9h]
bypIyrYcAAifLfhZpGlKLA: checks
Z4HwehErEwzsv/noQlfUlg: checks
*** TURN *** [Jd Qd 9h] [3h]
bypIyrYcAAifLfhZpGlKLA: bets $2
Z4HwehErEwzsv/noQlfUlg: raises $4 to $6
bypIyrYcAAifLfhZpGlKLA: folds
Z4HwehErEwzsv/noQlfUlg collected $5.75 from pot
Z4HwehErEwzsv/noQlfUlg: doesn't show hand
*** SUMMARY ***
Total pot $6 | Rake $0.25
Board [Jd Qd 9h 3h]
Seat 1: bypIyrYcAAifLfhZpGlKLA (big blind) folded on the Turn
Seat 2: Z4HwehErEwzsv/noQlfUlg (button) (small blind) collected ($5.75)



PokerStars Game #59940245738:  Hold'em No Limit ($0.25/$0.50) - 2009/07/01 1:01:14 ET
Table '0eJtgVAXVvBgncFdcUpXcQ' 2-max Seat #2 is the button
Seat 1: Ag6DvxX4vbRheqsv2zXKTQ ($33.20 in chips)
Seat 2: KMc4R+K9ao4Ur3rF7NGe6Q ($15.30 in chips)
KMc4R+K9ao4Ur3rF7NGe6Q: posts small blind $0.25
Ag6DvxX4vbRheqsv2zXKTQ: posts big blind $0.50
*** HOLE CARDS ***
KMc4R+K9ao4Ur3rF7NGe6Q: raises $1.50 to $2
Ag6DvxX4vbRheqsv2zXKTQ: calls $1.50
*** FLOP *** [3c Qs Ah]
Ag6DvxX4vbRheqsv2zXKTQ: checks
KMc4R+K9ao4Ur3rF7NGe6Q: bets $1.50
Ag6DvxX4vbRheqsv2zXKTQ: calls $1.50
*** TURN *** [3c Qs Ah] [Qc]
Ag6DvxX4vbRheqsv2zXKTQ: bets $1.50
KMc4R+K9ao4Ur3rF7NGe6Q: calls $1.50
*** RIVER *** [3c Qs Ah Qc] [6d]
Ag6DvxX4vbRheqsv2zXKTQ: checks
KMc4R+K9ao4Ur3rF7NGe6Q: checks
*** SHOW DOWN ***
Ag6DvxX4vbRheqsv2zXKTQ: shows [4c 4d] (two pair, Queens and Fours)
KMc4R+K9ao4Ur3rF7NGe6Q: shows [Ac 8h] (two pair, Aces and Queens)
KMc4R+K9ao4Ur3rF7NGe6Q collected $9.55 from pot
*** SUMMARY ***
Total pot $10 | Rake $0.45
Board [3c Qs Ah Qc 6d]
Seat 1: Ag6DvxX4vbRheqsv2zXKTQ (big blind) showed [4c 4d] and lost with two pair, Queens and Fours
Seat 2: KMc4R+K9ao4Ur3rF7NGe6Q (button) (small blind) showed [Ac 8h] and won ($9.55) with two pair, Aces and Queens



PokerStars Game #59940245720:  Hold'em No Limit ($0.25/$0.50) - 2009/07/01 1:01:14 ET
Table '+dXkOAQyS8j9PQZusUTMpg' 2-max Seat #1 is the button
Seat 1: XFa6sBGjP2gxoIvxR3fZIg ($62.90 in chips)
Seat 2: 5IBeOgaApY1Bvzv2P8X4EA ($135.40 in chips)
XFa6sBGjP2gxoIvxR3fZIg: posts small blind $0.25
5IBeOgaApY1Bvzv2P8X4EA: posts big blind $0.50
*** HOLE CARDS ***
XFa6sBGjP2gxoIvxR3fZIg: raises $1 to $1.50
5IBeOgaApY1Bvzv2P8X4EA: calls $1
*** FLOP *** [6h Js 7s]
5IBeOgaApY1Bvzv2P8X4EA: checks
XFa6sBGjP2gxoIvxR3fZIg: bets $2
5IBeOgaApY1Bvzv2P8X4EA: calls $2
*** TURN *** [6h Js 7s] [Kd]
5IBeOgaApY1Bvzv2P8X4EA: checks
XFa6sBGjP2gxoIvxR3fZIg: bets $6
5IBeOgaApY1Bvzv2P8X4EA: calls $6
*** RIVER *** [6h Js 7s Kd] [Ts]
5IBeOgaApY1Bvzv2P8X4EA: bets $16.50
XFa6sBGjP2gxoIvxR3fZIg said, "I hate this..."
5IBeOgaApY1Bvzv2P8X4EA said, "to cheap"
XFa6sBGjP2gxoIvxR3fZIg said, "You have the flush and I canÃ¯Â¿Â½t fold"
5IBeOgaApY1Bvzv2P8X4EA said, "pay"
5IBeOgaApY1Bvzv2P8X4EA said, ":D"
XFa6sBGjP2gxoIvxR3fZIg: calls $16.50
*** SHOW DOWN ***
5IBeOgaApY1Bvzv2P8X4EA: shows [Ah 6s] (a pair of Sixes)
XFa6sBGjP2gxoIvxR3fZIg: shows [Ks 6c] (two pair, Kings and Sixes)
XFa6sBGjP2gxoIvxR3fZIg collected $51.50 from pot
*** SUMMARY ***
Total pot $52 | Rake $0.50
Board [6h Js 7s Kd Ts]
Seat 1: XFa6sBGjP2gxoIvxR3fZIg (button) (small blind) showed [Ks 6c] and won ($51.50) with two pair, Kings and Sixes
Seat 2: 5IBeOgaApY1Bvzv2P8X4EA (big blind) showed [Ah 6s] and lost with a pair of Sixes



PokerStars Game #59940246542:  Hold'em No Limit ($0.25/$0.50) - 2009/07/01 1:01:15 ET
Table '9Puy2HWN1RQe5SSjq162gA' 2-max Seat #2 is the button
Seat 1: Fp/oksNpipCrD2MJ2pH20g ($21 in chips)
Seat 2: tDV+zhxH9+3DkJDzoTERyg ($25.85 in chips)
tDV+zhxH9+3DkJDzoTERyg: posts small blind $0.25
Fp/oksNpipCrD2MJ2pH20g: posts big blind $0.50
*** HOLE CARDS ***
tDV+zhxH9+3DkJDzoTERyg: folds
Fp/oksNpipCrD2MJ2pH20g collected $0.50 from pot
Fp/oksNpipCrD2MJ2pH20g: doesn't show hand
*** SUMMARY ***
Total pot $0.50 | Rake $0
Seat 1: Fp/oksNpipCrD2MJ2pH20g (big blind) collected ($0.50)
Seat 2: tDV+zhxH9+3DkJDzoTERyg (button) (small blind) folded before Flop



PokerStars Game #59940250276:  Hold'em No Limit ($0.25/$0.50) - 2009/07/01 1:01:21 ET
Table '9Puy2HWN1RQe5SSjq162gA' 2-max Seat #1 is the button
Seat 1: Fp/oksNpipCrD2MJ2pH20g ($21.25 in chips)
Seat 2: tDV+zhxH9+3DkJDzoTERyg ($25.60 in chips)
Fp/oksNpipCrD2MJ2pH20g: posts small blind $0.25
tDV+zhxH9+3DkJDzoTERyg: posts big blind $0.50
*** HOLE CARDS ***
Fp/oksNpipCrD2MJ2pH20g: raises $0.50 to $1
tDV+zhxH9+3DkJDzoTERyg: calls $0.50
*** FLOP *** [3h Kd 2d]
tDV+zhxH9+3DkJDzoTERyg: bets $1.50
Fp/oksNpipCrD2MJ2pH20g: folds
tDV+zhxH9+3DkJDzoTERyg collected $1.90 from pot
tDV+zhxH9+3DkJDzoTERyg: doesn't show hand
*** SUMMARY ***
Total pot $2 | Rake $0.10
Board [3h Kd 2d]
Seat 1: Fp/oksNpipCrD2MJ2pH20g (button) (small blind) folded on the Flop
Seat 2: tDV+zhxH9+3DkJDzoTERyg (big blind) collected ($1.90)



PokerStars Game #59940251052:  Hold'em No Limit ($0.25/$0.50) - 2009/07/01 1:01:22 ET
Table 'BCN5su+SsXiy1zRMJi0SJw' 6-max Seat #5 is the button
Seat 1: GxXV09ciXaOxyY2H5aMIIw ($32.40 in chips)
Seat 2: oU2kDCkT/gilYbHWrg7D8w ($44.60 in chips)
Seat 4: qfeUHOJpMYyzQcj0o2A7ng ($5.75 in chips)
Seat 5: IBNygaT1aa9Z1uPdJJilwA ($40.30 in chips)
Seat 6: b2symlOdL7+0c9Pj4N/KlA ($54 in chips)
b2symlOdL7+0c9Pj4N/KlA: posts small blind $0.25
GxXV09ciXaOxyY2H5aMIIw: posts big blind $0.50
*** HOLE CARDS ***
oU2kDCkT/gilYbHWrg7D8w: folds
qfeUHOJpMYyzQcj0o2A7ng: folds
IBNygaT1aa9Z1uPdJJilwA: folds
b2symlOdL7+0c9Pj4N/KlA: raises $1.50 to $2
GxXV09ciXaOxyY2H5aMIIw: folds
b2symlOdL7+0c9Pj4N/KlA collected $1 from pot
b2symlOdL7+0c9Pj4N/KlA: doesn't show hand
*** SUMMARY ***
Total pot $1 | Rake $0
Seat 1: GxXV09ciXaOxyY2H5aMIIw (big blind) folded before Flop
Seat 2: oU2kDCkT/gilYbHWrg7D8w folded before Flop (didn't bet)
Seat 4: qfeUHOJpMYyzQcj0o2A7ng folded before Flop (didn't bet)
Seat 5: IBNygaT1aa9Z1uPdJJilwA (button) folded before Flop (didn't bet)
Seat 6: b2symlOdL7+0c9Pj4N/KlA (small blind) collected ($1)



PokerStars Game #59940252710:  Hold'em No Limit ($0.25/$0.50) - 2009/07/01 1:01:25 ET
Table 'Nz0Vr7WMHL2g5Uk7dDZjpw' 9-max Seat #9 is the button
Seat 1: tLkxo7JgV+WWI0UBw44K5A ($109.35 in chips)
Seat 2: gsyXT42WLEcOS4DdEk2wlw ($30 in chips)
Seat 3: uw9QayAAxLM3Hb+HR7mSkg ($10.75 in chips)
Seat 4: E2518gp4aFz1+kAgmGqeEg ($11.50 in chips)
Seat 5: WGW0DgjBUXs1ylURHG8vnQ ($27.90 in chips)
Seat 6: 997ViqAtWn1FPjJqcffwcA ($60.55 in chips)
Seat 7: KPLH0gELgFe2OuAnhJFI5w ($15.35 in chips)
Seat 8: HkZI6g4zl83TDTA7SRspmQ ($17.80 in chips)
Seat 9: mSD1pginDsyHG5PDfqzphw ($10 in chips)
tLkxo7JgV+WWI0UBw44K5A: posts small blind $0.25
gsyXT42WLEcOS4DdEk2wlw: posts big blind $0.50
*** HOLE CARDS ***
uw9QayAAxLM3Hb+HR7mSkg: folds
E2518gp4aFz1+kAgmGqeEg: folds
WGW0DgjBUXs1ylURHG8vnQ: folds
997ViqAtWn1FPjJqcffwcA: folds
KPLH0gELgFe2OuAnhJFI5w: folds
HkZI6g4zl83TDTA7SRspmQ: folds
mSD1pginDsyHG5PDfqzphw: folds
tLkxo7JgV+WWI0UBw44K5A: raises $1 to $1.50
gsyXT42WLEcOS4DdEk2wlw: folds
tLkxo7JgV+WWI0UBw44K5A collected $1 from pot
*** SUMMARY ***
Total pot $1 | Rake $0
Seat 1: tLkxo7JgV+WWI0UBw44K5A (small blind) collected ($1)
Seat 2: gsyXT42WLEcOS4DdEk2wlw (big blind) folded before Flop
Seat 3: uw9QayAAxLM3Hb+HR7mSkg folded before Flop (didn't bet)
Seat 4: E2518gp4aFz1+kAgmGqeEg folded before Flop (didn't bet)
Seat 5: WGW0DgjBUXs1ylURHG8vnQ folded before Flop (didn't bet)
Seat 6: 997ViqAtWn1FPjJqcffwcA folded before Flop (didn't bet)
Seat 7: KPLH0gELgFe2OuAnhJFI5w folded before Flop (didn't bet)
Seat 8: HkZI6g4zl83TDTA7SRspmQ folded before Flop (didn't bet)
Seat 9: mSD1pginDsyHG5PDfqzphw (button) folded before Flop (didn't bet)



PokerStars Game #59940253238:  Hold'em No Limit ($0.25/$0.50) - 2009/07/01 1:01:26 ET
Table '37qXEp3oe+er5q4CZip9eQ' 6-max Seat #1 is the button
Seat 1: oqOqoO2AyCZenUghCxMDxw ($50 in chips)
Seat 2: LvH4G7n+QSjT6NDaD3cREA ($54 in chips)
Seat 3: Rt6KgtZ8YaJoTc3FPim00w ($112.45 in chips)
Seat 4: XsmE8nXMAAMFJbWaJTmHFw ($40.60 in chips)
Seat 5: VOmI0x4dDPnTESZd5B4d1Q ($41.50 in chips)
Seat 6: N50kln4negd8q7Mmoz1j4g ($15.80 in chips)
LvH4G7n+QSjT6NDaD3cREA: posts small blind $0.25
Rt6KgtZ8YaJoTc3FPim00w: posts big blind $0.50
*** HOLE CARDS ***
XsmE8nXMAAMFJbWaJTmHFw: folds
VOmI0x4dDPnTESZd5B4d1Q: folds
N50kln4negd8q7Mmoz1j4g: folds
oqOqoO2AyCZenUghCxMDxw: folds
LvH4G7n+QSjT6NDaD3cREA: raises $1.50 to $2
Rt6KgtZ8YaJoTc3FPim00w: calls $1.50
*** FLOP *** [2c 3d 8h]
LvH4G7n+QSjT6NDaD3cREA: bets $2.50
VOmI0x4dDPnTESZd5B4d1Q said, "every good hand ive had ben beat all night - frustrating!"
Rt6KgtZ8YaJoTc3FPim00w: folds
LvH4G7n+QSjT6NDaD3cREA collected $3.80 from pot
*** SUMMARY ***
Total pot $4 | Rake $0.20
Board [2c 3d 8h]
Seat 1: oqOqoO2AyCZenUghCxMDxw (button) folded before Flop (didn't bet)
Seat 2: LvH4G7n+QSjT6NDaD3cREA (small blind) collected ($3.80)
Seat 3: Rt6KgtZ8YaJoTc3FPim00w (big blind) folded on the Flop
Seat 4: XsmE8nXMAAMFJbWaJTmHFw folded before Flop (didn't bet)
Seat 5: VOmI0x4dDPnTESZd5B4d1Q folded before Flop (didn't bet)
Seat 6: N50kln4negd8q7Mmoz1j4g folded before Flop (didn't bet)



PokerStars Game #59940254372:  Hold'em No Limit ($0.25/$0.50) - 2009/07/01 1:01:28 ET
Table 'GfL/No5u5PoEnU39lP5pQg' 6-max Seat #6 is the button
Seat 1: 1WUCqNG+p+vfWRTXNu4ljw ($65.60 in chips)
Seat 2: uVwggSetzp7d+eVgowO3vg ($57 in chips)
Seat 3: eQXFICMuu3hw6XlcmuVNEA ($14.05 in chips)
Seat 4: r6u7MWSXF30/khcTYkrG9Q ($32.70 in chips)
Seat 5: M1KyQQvVPVuxqTAB8sR/zQ ($50.75 in chips)
Seat 6: kxPhs4ePFqMy52CInAJ2aw ($50 in chips)
1WUCqNG+p+vfWRTXNu4ljw: posts small blind $0.25
uVwggSetzp7d+eVgowO3vg: posts big blind $0.50
*** HOLE CARDS ***
eQXFICMuu3hw6XlcmuVNEA: folds
r6u7MWSXF30/khcTYkrG9Q: raises $1 to $1.50
M1KyQQvVPVuxqTAB8sR/zQ: folds
kxPhs4ePFqMy52CInAJ2aw: calls $1.50
1WUCqNG+p+vfWRTXNu4ljw: folds
uVwggSetzp7d+eVgowO3vg: folds
*** FLOP *** [5h Tc Td]
r6u7MWSXF30/khcTYkrG9Q: bets $2
kxPhs4ePFqMy52CInAJ2aw: calls $2
*** TURN *** [5h Tc Td] [4h]
r6u7MWSXF30/khcTYkrG9Q: bets $7
kxPhs4ePFqMy52CInAJ2aw: calls $7
*** RIVER *** [5h Tc Td 4h] [Ks]
r6u7MWSXF30/khcTYkrG9Q: bets $22.20 and is all-in
kxPhs4ePFqMy52CInAJ2aw: folds
r6u7MWSXF30/khcTYkrG9Q collected $20.70 from pot
*** SUMMARY ***
Total pot $21.75 | Rake $1.05
Board [5h Tc Td 4h Ks]
Seat 1: 1WUCqNG+p+vfWRTXNu4ljw (small blind) folded before Flop
Seat 2: uVwggSetzp7d+eVgowO3vg (big blind) folded before Flop
Seat 3: eQXFICMuu3hw6XlcmuVNEA folded before Flop (didn't bet)
Seat 4: r6u7MWSXF30/khcTYkrG9Q collected ($20.70)
Seat 5: M1KyQQvVPVuxqTAB8sR/zQ folded before Flop (didn't bet)
Seat 6: kxPhs4ePFqMy52CInAJ2aw (button) folded on the River



PokerStars Game #59940254144:  Hold'em No Limit ($0.25/$0.50) - 2009/07/01 1:01:28 ET
Table 'MJxeZCzYELxiIsyUZyT0jw' 6-max Seat #2 is the button
Seat 1: +Pf9jTVizYlIo+woPvptfA ($50 in chips)
Seat 2: t3GiVMzqA9Svgr5Uol32cQ ($43.85 in chips)
Seat 3: JQZew0FjzS19kTjeNtrE+A ($58.60 in chips)
Seat 4: alGiiQP/wwtYnfuXII+sgw ($38.35 in chips)
Seat 5: 3jvoOXNtXE90w2BdfNZwZQ ($60.10 in chips)
Seat 6: c0n4hrn20AML9qzyFC2E8Q ($48.75 in chips)
JQZew0FjzS19kTjeNtrE+A: posts small blind $0.25
alGiiQP/wwtYnfuXII+sgw: posts big blind $0.50
*** HOLE CARDS ***
3jvoOXNtXE90w2BdfNZwZQ: folds
c0n4hrn20AML9qzyFC2E8Q: folds
+Pf9jTVizYlIo+woPvptfA: folds
t3GiVMzqA9Svgr5Uol32cQ: folds
JQZew0FjzS19kTjeNtrE+A: raises $1.50 to $2
alGiiQP/wwtYnfuXII+sgw: calls $1.50
*** FLOP *** [As Jh 3h]
JQZew0FjzS19kTjeNtrE+A: bets $2.50
alGiiQP/wwtYnfuXII+sgw: folds
JQZew0FjzS19kTjeNtrE+A collected $3.80 from pot
*** SUMMARY ***
Total pot $4 | Rake $0.20
Board [As Jh 3h]
Seat 1: +Pf9jTVizYlIo+woPvptfA folded before Flop (didn't bet)
Seat 2: t3GiVMzqA9Svgr5Uol32cQ (button) folded before Flop (didn't bet)
Seat 3: JQZew0FjzS19kTjeNtrE+A (small blind) collected ($3.80)
Seat 4: alGiiQP/wwtYnfuXII+sgw (big blind) folded on the Flop
Seat 5: 3jvoOXNtXE90w2BdfNZwZQ folded before Flop (didn't bet)
Seat 6: c0n4hrn20AML9qzyFC2E8Q folded before Flop (didn't bet)



PokerStars Game #59940254658:  Hold'em No Limit ($0.25/$0.50) - 2009/07/01 1:01:28 ET
Table 'fx6MqwfYAj/Rt86hBz2L3Q' 9-max Seat #6 is the button
Seat 2: C3rGXblctNcWI6JYPHhaEg ($36.60 in chips)
Seat 3: iadBi5AEt7gTBXbDSSnMYQ ($80.40 in chips)
Seat 4: 75K2MXwN65Sjfp1yHd50Hg ($9.25 in chips)
Seat 5: iAISe3dVeua8PUn2wwgDHw ($25.75 in chips)
Seat 6: 5k9fvXD9suIgCxU4HLQjTw ($50 in chips)
Seat 7: SKnJuWHScqetA/qG5p+wCg ($30 in chips)
Seat 8: JYwJYYV9pM5KWdSiETl8rA ($22 in chips)
Seat 9: HZkVla4kK2SI42CVrPZ/ig ($10.25 in chips)
SKnJuWHScqetA/qG5p+wCg: posts small blind $0.25
JYwJYYV9pM5KWdSiETl8rA: posts big blind $0.50
uw9QayAAxLM3Hb+HR7mSkg: sits out
*** HOLE CARDS ***
HZkVla4kK2SI42CVrPZ/ig: folds
C3rGXblctNcWI6JYPHhaEg: folds
iadBi5AEt7gTBXbDSSnMYQ: folds
75K2MXwN65Sjfp1yHd50Hg: folds
iAISe3dVeua8PUn2wwgDHw: folds
5k9fvXD9suIgCxU4HLQjTw: raises $1 to $1.50
SKnJuWHScqetA/qG5p+wCg: folds
JYwJYYV9pM5KWdSiETl8rA: folds
5k9fvXD9suIgCxU4HLQjTw collected $1.25 from pot
*** SUMMARY ***
Total pot $1.25 | Rake $0
Seat 2: C3rGXblctNcWI6JYPHhaEg folded before Flop (didn't bet)
Seat 3: iadBi5AEt7gTBXbDSSnMYQ folded before Flop (didn't bet)
Seat 4: 75K2MXwN65Sjfp1yHd50Hg folded before Flop (didn't bet)
Seat 5: iAISe3dVeua8PUn2wwgDHw folded before Flop (didn't bet)
Seat 6: 5k9fvXD9suIgCxU4HLQjTw (button) collected ($1.25)
Seat 7: SKnJuWHScqetA/qG5p+wCg (small blind) folded before Flop
Seat 8: JYwJYYV9pM5KWdSiETl8rA (big blind) folded before Flop
Seat 9: HZkVla4kK2SI42CVrPZ/ig folded before Flop (didn't bet)



PokerStars Game #59940254850:  Hold'em No Limit ($0.25/$0.50) - 2009/07/01 1:01:29 ET
Table 'NCiXr0d5CEKBQr/cZgLhbA' 9-max Seat #9 is the button
Seat 1: pFtzb1sR4b0d1aw6aIRgDg ($50 in chips)
Seat 2: ulxuJchBV9iguXg0FUonfg ($51.45 in chips)
Seat 3: xZCXQSXlrZkp3pZizzVXCw ($52.70 in chips)
Seat 4: 5k9fvXD9suIgCxU4HLQjTw ($55.20 in chips)
Seat 5: zE9cVigS2nW/Ljy4K4bUQA ($33.30 in chips)
Seat 6: SKnJuWHScqetA/qG5p+wCg ($32.75 in chips)
Seat 7: M+7+BTmX5vZatHVuoRB1nA ($52 in chips)
Seat 8: 1MJUKc3cc0QmUoz1JZLR2w ($64.05 in chips)
Seat 9: 4WLZvqBn5qv5tds5kt5A1Q ($38.45 in chips)
pFtzb1sR4b0d1aw6aIRgDg: posts small blind $0.25
ulxuJchBV9iguXg0FUonfg: posts big blind $0.50
*** HOLE CARDS ***
xZCXQSXlrZkp3pZizzVXCw: folds
5k9fvXD9suIgCxU4HLQjTw: folds
zE9cVigS2nW/Ljy4K4bUQA: folds
SKnJuWHScqetA/qG5p+wCg: folds
M+7+BTmX5vZatHVuoRB1nA: folds
1MJUKc3cc0QmUoz1JZLR2w: folds
4WLZvqBn5qv5tds5kt5A1Q: folds
pFtzb1sR4b0d1aw6aIRgDg: folds
ulxuJchBV9iguXg0FUonfg collected $0.50 from pot
*** SUMMARY ***
Total pot $0.50 | Rake $0
Seat 1: pFtzb1sR4b0d1aw6aIRgDg (small blind) folded before Flop
Seat 2: ulxuJchBV9iguXg0FUonfg (big blind) collected ($0.50)
Seat 3: xZCXQSXlrZkp3pZizzVXCw folded before Flop (didn't bet)
Seat 4: 5k9fvXD9suIgCxU4HLQjTw folded before Flop (didn't bet)
Seat 5: zE9cVigS2nW/Ljy4K4bUQA folded before Flop (didn't bet)
Seat 6: SKnJuWHScqetA/qG5p+wCg folded before Flop (didn't bet)
Seat 7: M+7+BTmX5vZatHVuoRB1nA folded before Flop (didn't bet)
Seat 8: 1MJUKc3cc0QmUoz1JZLR2w folded before Flop (didn't bet)
Seat 9: 4WLZvqBn5qv5tds5kt5A1Q (button) folded before Flop (didn't bet)



PokerStars Game #59940255990:  Hold'em No Limit ($0.25/$0.50) - 2009/07/01 1:01:31 ET
Table 'otvGDROEDdqsabxskT79qg' 9-max Seat #4 is the button
Seat 1: 8ehL7qlZzjgUh2H35iiWLw ($56.75 in chips)
Seat 2: cCjTzH9jio8607WzjcfXlg ($13.55 in chips)
Seat 3: +k7T5ocke8UwavtgUHm+Cg ($71.10 in chips)
Seat 4: MG90wfSJZnOejs/KD3vlQQ ($73.20 in chips)
Seat 5: E2518gp4aFz1+kAgmGqeEg ($11.25 in chips)
Seat 6: bxLSulbgr8LmKNjOzw8URg ($53.70 in chips)
Seat 8: zE9cVigS2nW/Ljy4K4bUQA ($30.75 in chips)
Seat 9: KcY3X8YpD74Kw1RHkx/g4A ($53.65 in chips)
E2518gp4aFz1+kAgmGqeEg: posts small blind $0.25
bxLSulbgr8LmKNjOzw8URg: posts big blind $0.50
75K2MXwN65Sjfp1yHd50Hg: sits out
*** HOLE CARDS ***
zE9cVigS2nW/Ljy4K4bUQA: folds
KcY3X8YpD74Kw1RHkx/g4A: calls $0.50
8ehL7qlZzjgUh2H35iiWLw: folds
cCjTzH9jio8607WzjcfXlg: folds
+k7T5ocke8UwavtgUHm+Cg: calls $0.50
MG90wfSJZnOejs/KD3vlQQ: raises $2 to $2.50
E2518gp4aFz1+kAgmGqeEg: folds
bxLSulbgr8LmKNjOzw8URg: folds
KcY3X8YpD74Kw1RHkx/g4A: calls $2
+k7T5ocke8UwavtgUHm+Cg: folds
*** FLOP *** [3d 8c 8s]
KcY3X8YpD74Kw1RHkx/g4A: checks
MG90wfSJZnOejs/KD3vlQQ: bets $4.75
KcY3X8YpD74Kw1RHkx/g4A: folds
MG90wfSJZnOejs/KD3vlQQ collected $5.95 from pot
MG90wfSJZnOejs/KD3vlQQ: doesn't show hand
*** SUMMARY ***
Total pot $6.25 | Rake $0.30
Board [3d 8c 8s]
Seat 1: 8ehL7qlZzjgUh2H35iiWLw folded before Flop (didn't bet)
Seat 2: cCjTzH9jio8607WzjcfXlg folded before Flop (didn't bet)
Seat 3: +k7T5ocke8UwavtgUHm+Cg folded before Flop
Seat 4: MG90wfSJZnOejs/KD3vlQQ (button) collected ($5.95)
Seat 5: E2518gp4aFz1+kAgmGqeEg (small blind) folded before Flop
Seat 6: bxLSulbgr8LmKNjOzw8URg (big blind) folded before Flop
Seat 8: zE9cVigS2nW/Ljy4K4bUQA folded before Flop (didn't bet)
Seat 9: KcY3X8YpD74Kw1RHkx/g4A folded on the Flop



PokerStars Game #59940256666:  Hold'em No Limit ($0.25/$0.50) - 2009/07/01 1:01:32 ET
Table 'lSisgp6H7Fg1hH5VfjEjYQ' 9-max Seat #2 is the button
Seat 1: 5k9fvXD9suIgCxU4HLQjTw ($50 in chips)
Seat 2: UrcnkQOiLVk8BlKDPJSy7Q ($75.85 in chips)
Seat 3: aTkyjTh3w5YLWiIERupZOA ($51.45 in chips)
Seat 4: bwv/rbH/hHhPhY6u9mu04w ($31.60 in chips)
Seat 5: mSD1pginDsyHG5PDfqzphw ($10 in chips)
Seat 6: +k7T5ocke8UwavtgUHm+Cg ($67.80 in chips)
Seat 7: IDtNLR9uFCDdjNsJWMHA5Q ($21.70 in chips)
Seat 8: a4JDWmpFQkL10XfAyuF51A ($27.75 in chips)
aTkyjTh3w5YLWiIERupZOA: posts small blind $0.25
bwv/rbH/hHhPhY6u9mu04w: posts big blind $0.50
tkflckdgk: sits out
*** HOLE CARDS ***
mSD1pginDsyHG5PDfqzphw: folds
+k7T5ocke8UwavtgUHm+Cg: folds
IDtNLR9uFCDdjNsJWMHA5Q: folds
a4JDWmpFQkL10XfAyuF51A: folds
5k9fvXD9suIgCxU4HLQjTw: folds
UrcnkQOiLVk8BlKDPJSy7Q: folds
aTkyjTh3w5YLWiIERupZOA: calls $0.25
bwv/rbH/hHhPhY6u9mu04w: checks
*** FLOP *** [6d 9h 9c]
aTkyjTh3w5YLWiIERupZOA: checks
bwv/rbH/hHhPhY6u9mu04w: checks
*** TURN *** [6d 9h 9c] [Td]
aTkyjTh3w5YLWiIERupZOA: bets $1
bwv/rbH/hHhPhY6u9mu04w: folds
aTkyjTh3w5YLWiIERupZOA collected $0.95 from pot
aTkyjTh3w5YLWiIERupZOA: doesn't show hand
*** SUMMARY ***
Total pot $1 | Rake $0.05
Board [6d 9h 9c Td]
Seat 1: 5k9fvXD9suIgCxU4HLQjTw folded before Flop (didn't bet)
Seat 2: UrcnkQOiLVk8BlKDPJSy7Q (button) folded before Flop (didn't bet)
Seat 3: aTkyjTh3w5YLWiIERupZOA (small blind) collected ($0.95)
Seat 4: bwv/rbH/hHhPhY6u9mu04w (big blind) folded on the Turn
Seat 5: mSD1pginDsyHG5PDfqzphw folded before Flop (didn't bet)
Seat 6: +k7T5ocke8UwavtgUHm+Cg folded before Flop (didn't bet)
Seat 7: IDtNLR9uFCDdjNsJWMHA5Q folded before Flop (didn't bet)
Seat 8: a4JDWmpFQkL10XfAyuF51A folded before Flop (didn't bet)



PokerStars Game #59940256920:  Hold'em No Limit ($0.25/$0.50) - 2009/07/01 1:01:32 ET
Table '5EmHi+fnatGQQShcNmzOZQ' 6-max Seat #2 is the button
Seat 1: My8WkRtGx5FW6rJ1I4R3hg ($19.25 in chips)
Seat 2: bfFjgAtIoAI+pUxUwFt3aQ ($49 in chips)
Seat 3: TjmTe3bhs9dFz5gXX9x7Lw ($12.30 in chips)
Seat 4: 1b+2BbjMN8qhR1WPqdE9VQ ($65.80 in chips)
Seat 5: kxPhs4ePFqMy52CInAJ2aw ($82.80 in chips)
Seat 6: 686aeHikcJlgKkSuIFdcXQ ($131.75 in chips)
TjmTe3bhs9dFz5gXX9x7Lw: posts small blind $0.25
1b+2BbjMN8qhR1WPqdE9VQ: posts big blind $0.50
*** HOLE CARDS ***
kxPhs4ePFqMy52CInAJ2aw: folds
686aeHikcJlgKkSuIFdcXQ: folds
My8WkRtGx5FW6rJ1I4R3hg: folds
bfFjgAtIoAI+pUxUwFt3aQ: folds
TjmTe3bhs9dFz5gXX9x7Lw: folds
1b+2BbjMN8qhR1WPqdE9VQ collected $0.50 from pot
1b+2BbjMN8qhR1WPqdE9VQ: doesn't show hand
*** SUMMARY ***
Total pot $0.50 | Rake $0
Seat 1: My8WkRtGx5FW6rJ1I4R3hg folded before Flop (didn't bet)
Seat 2: bfFjgAtIoAI+pUxUwFt3aQ (button) folded before Flop (didn't bet)
Seat 3: TjmTe3bhs9dFz5gXX9x7Lw (small blind) folded before Flop
Seat 4: 1b+2BbjMN8qhR1WPqdE9VQ (big blind) collected ($0.50)
Seat 5: kxPhs4ePFqMy52CInAJ2aw folded before Flop (didn't bet)
Seat 6: 686aeHikcJlgKkSuIFdcXQ folded before Flop (didn't bet)



PokerStars Game #59940257510:  Hold'em No Limit ($0.25/$0.50) - 2009/07/01 1:01:33 ET
Table '0eJtgVAXVvBgncFdcUpXcQ' 2-max Seat #1 is the button
Seat 1: Ag6DvxX4vbRheqsv2zXKTQ ($28.20 in chips)
Seat 2: KMc4R+K9ao4Ur3rF7NGe6Q ($19.85 in chips)
Ag6DvxX4vbRheqsv2zXKTQ: posts small blind $0.25
KMc4R+K9ao4Ur3rF7NGe6Q: posts big blind $0.50
*** HOLE CARDS ***
Ag6DvxX4vbRheqsv2zXKTQ: calls $0.25
KMc4R+K9ao4Ur3rF7NGe6Q: checks
*** FLOP *** [8c 5s 9h]
KMc4R+K9ao4Ur3rF7NGe6Q: checks
Ag6DvxX4vbRheqsv2zXKTQ: checks
*** TURN *** [8c 5s 9h] [Qd]
KMc4R+K9ao4Ur3rF7NGe6Q: bets $1
Ag6DvxX4vbRheqsv2zXKTQ: folds
KMc4R+K9ao4Ur3rF7NGe6Q collected $0.95 from pot
KMc4R+K9ao4Ur3rF7NGe6Q: doesn't show hand
*** SUMMARY ***
Total pot $1 | Rake $0.05
Board [8c 5s 9h Qd]
Seat 1: Ag6DvxX4vbRheqsv2zXKTQ (button) (small blind) folded on the Turn
Seat 2: KMc4R+K9ao4Ur3rF7NGe6Q (big blind) collected ($0.95)



PokerStars Game #59940259462:  Hold'em No Limit ($0.25/$0.50) - 2009/07/01 1:01:37 ET
Table '9Puy2HWN1RQe5SSjq162gA' 2-max Seat #2 is the button
Seat 1: Fp/oksNpipCrD2MJ2pH20g ($20.25 in chips)
Seat 2: tDV+zhxH9+3DkJDzoTERyg ($26.50 in chips)
tDV+zhxH9+3DkJDzoTERyg: posts small blind $0.25
Fp/oksNpipCrD2MJ2pH20g: posts big blind $0.50
*** HOLE CARDS ***
tDV+zhxH9+3DkJDzoTERyg: raises $1.50 to $2
Fp/oksNpipCrD2MJ2pH20g: calls $1.50
*** FLOP *** [3h 7d 2s]
Fp/oksNpipCrD2MJ2pH20g: checks
tDV+zhxH9+3DkJDzoTERyg: bets $2.50
Fp/oksNpipCrD2MJ2pH20g: folds
tDV+zhxH9+3DkJDzoTERyg collected $3.80 from pot
tDV+zhxH9+3DkJDzoTERyg: doesn't show hand
*** SUMMARY ***
Total pot $4 | Rake $0.20
Board [3h 7d 2s]
Seat 1: Fp/oksNpipCrD2MJ2pH20g (big blind) folded on the Flop
Seat 2: tDV+zhxH9+3DkJDzoTERyg (button) (small blind) collected ($3.80)



PokerStars Game #59940259510:  Hold'em No Limit ($0.25/$0.50) - 2009/07/01 1:01:37 ET
Table '8BQGgNetI1NOvWeu3gtMNw' 2-max Seat #1 is the button
Seat 1: bypIyrYcAAifLfhZpGlKLA ($52.75 in chips)
Seat 2: Z4HwehErEwzsv/noQlfUlg ($148.60 in chips)
bypIyrYcAAifLfhZpGlKLA: posts small blind $0.25
Z4HwehErEwzsv/noQlfUlg: posts big blind $0.50
*** HOLE CARDS ***
bypIyrYcAAifLfhZpGlKLA: raises $1 to $1.50
Z4HwehErEwzsv/noQlfUlg: folds
bypIyrYcAAifLfhZpGlKLA collected $1 from pot
bypIyrYcAAifLfhZpGlKLA: doesn't show hand
*** SUMMARY ***
Total pot $1 | Rake $0
Seat 1: bypIyrYcAAifLfhZpGlKLA (button) (small blind) collected ($1)
Seat 2: Z4HwehErEwzsv/noQlfUlg (big blind) folded before Flop



PokerStars Game #59940260016:  Hold'em No Limit ($0.25/$0.50) - 2009/07/01 1:01:37 ET
Table 'lpxYasB1ClBSgTpCCITwhQ' 9-max Seat #3 is the button
Seat 1: mj7PS7wCH4PAl7+eYTFs7A ($44.30 in chips)
Seat 2: OWP/DOu+PlPK6ZZ3zYa0HA ($19.35 in chips)
Seat 3: IVoxShuYD5lqbK8F9+jVsg ($9 in chips)
Seat 4: NnQCepdIR/AOUQn1yhYx6Q ($8.75 in chips)
Seat 5: IYd5zG8k7vdBNVHbHg2Pag ($36.35 in chips)
Seat 6: SegjDnMxWMujiD57ESNL+g ($12.10 in chips)
Seat 7: bmRtaIYKthN1F+B3JLZ3Jw ($71.90 in chips)
Seat 8: /mfensKw8/iZ1Vrx33S4xg ($11.85 in chips)
Seat 9: sUIUZ+begh92dzkUmvbMrw ($9.90 in chips)
NnQCepdIR/AOUQn1yhYx6Q: posts small blind $0.25
IYd5zG8k7vdBNVHbHg2Pag: posts big blind $0.50
*** HOLE CARDS ***
SegjDnMxWMujiD57ESNL+g: folds
bmRtaIYKthN1F+B3JLZ3Jw: folds
/mfensKw8/iZ1Vrx33S4xg: folds
sUIUZ+begh92dzkUmvbMrw: folds
mj7PS7wCH4PAl7+eYTFs7A: folds
OWP/DOu+PlPK6ZZ3zYa0HA: folds
IVoxShuYD5lqbK8F9+jVsg: folds
NnQCepdIR/AOUQn1yhYx6Q: folds
IYd5zG8k7vdBNVHbHg2Pag collected $0.50 from pot
*** SUMMARY ***
Total pot $0.50 | Rake $0
Seat 1: mj7PS7wCH4PAl7+eYTFs7A folded before Flop (didn't bet)
Seat 2: OWP/DOu+PlPK6ZZ3zYa0HA folded before Flop (didn't bet)
Seat 3: IVoxShuYD5lqbK8F9+jVsg (button) folded before Flop (didn't bet)
Seat 4: NnQCepdIR/AOUQn1yhYx6Q (small blind) folded before Flop
Seat 5: IYd5zG8k7vdBNVHbHg2Pag (big blind) collected ($0.50)
Seat 6: SegjDnMxWMujiD57ESNL+g folded before Flop (didn't bet)
Seat 7: bmRtaIYKthN1F+B3JLZ3Jw folded before Flop (didn't bet)
Seat 8: /mfensKw8/iZ1Vrx33S4xg folded before Flop (didn't bet)
Seat 9: sUIUZ+begh92dzkUmvbMrw folded before Flop (didn't bet)



PokerStars Game #59940259934:  Hold'em No Limit ($0.25/$0.50) - 2009/07/01 1:01:37 ET
Table 'BCN5su+SsXiy1zRMJi0SJw' 6-max Seat #6 is the button
Seat 1: GxXV09ciXaOxyY2H5aMIIw ($31.90 in chips)
Seat 2: oU2kDCkT/gilYbHWrg7D8w ($44.60 in chips)
Seat 4: qfeUHOJpMYyzQcj0o2A7ng ($5.75 in chips)
Seat 5: IBNygaT1aa9Z1uPdJJilwA ($40.30 in chips)
Seat 6: b2symlOdL7+0c9Pj4N/KlA ($54.50 in chips)
GxXV09ciXaOxyY2H5aMIIw: posts small blind $0.25
oU2kDCkT/gilYbHWrg7D8w: posts big blind $0.50
*** HOLE CARDS ***
qfeUHOJpMYyzQcj0o2A7ng: folds
IBNygaT1aa9Z1uPdJJilwA: calls $0.50
b2symlOdL7+0c9Pj4N/KlA: folds
GxXV09ciXaOxyY2H5aMIIw: folds
oU2kDCkT/gilYbHWrg7D8w: checks
*** FLOP *** [2h Qd 5s]
6wzJiRvp8HY6t+MQGnSIzA has returned
oU2kDCkT/gilYbHWrg7D8w: checks
IBNygaT1aa9Z1uPdJJilwA: checks
*** TURN *** [2h Qd 5s] [Jd]
oU2kDCkT/gilYbHWrg7D8w: checks
IBNygaT1aa9Z1uPdJJilwA: checks
*** RIVER *** [2h Qd 5s Jd] [6c]
oU2kDCkT/gilYbHWrg7D8w: checks
IBNygaT1aa9Z1uPdJJilwA: bets $2
oU2kDCkT/gilYbHWrg7D8w: folds
IBNygaT1aa9Z1uPdJJilwA collected $1.20 from pot
*** SUMMARY ***
Total pot $1.25 | Rake $0.05
Board [2h Qd 5s Jd 6c]
Seat 1: GxXV09ciXaOxyY2H5aMIIw (small blind) folded before Flop
Seat 2: oU2kDCkT/gilYbHWrg7D8w (big blind) folded on the River
Seat 4: qfeUHOJpMYyzQcj0o2A7ng folded before Flop (didn't bet)
Seat 5: IBNygaT1aa9Z1uPdJJilwA collected ($1.20)
Seat 6: b2symlOdL7+0c9Pj4N/KlA (button) folded before Flop (didn't bet)



PokerStars Game #59940261648:  Hold'em No Limit ($0.25/$0.50) - 2009/07/01 1:01:40 ET
Table 'E7bWJ45aoFXRpyRv2gw+Ig' 2-max Seat #1 is the button
Seat 1: FRkiRasEGlHUeLrEl+k/nA ($58.20 in chips)
Seat 2: 3Wro85I7472vJ4Wkpneo9A ($130.50 in chips)
FRkiRasEGlHUeLrEl+k/nA: posts small blind $0.25
3Wro85I7472vJ4Wkpneo9A: posts big blind $0.50
*** HOLE CARDS ***
FRkiRasEGlHUeLrEl+k/nA: calls $0.25
3Wro85I7472vJ4Wkpneo9A: checks
*** FLOP *** [Kc 2c 7c]
3Wro85I7472vJ4Wkpneo9A: checks
FRkiRasEGlHUeLrEl+k/nA: checks
*** TURN *** [Kc 2c 7c] [Jh]
3Wro85I7472vJ4Wkpneo9A: checks
FRkiRasEGlHUeLrEl+k/nA: checks
*** RIVER *** [Kc 2c 7c Jh] [Js]
3Wro85I7472vJ4Wkpneo9A: checks
FRkiRasEGlHUeLrEl+k/nA: checks
*** SHOW DOWN ***
3Wro85I7472vJ4Wkpneo9A: shows [3d 4d] (a pair of Jacks)
FRkiRasEGlHUeLrEl+k/nA: shows [8c Qd] (a pair of Jacks - King+Queen kicker)
FRkiRasEGlHUeLrEl+k/nA collected $0.95 from pot
*** SUMMARY ***
Total pot $1 | Rake $0.05
Board [Kc 2c 7c Jh Js]
Seat 1: FRkiRasEGlHUeLrEl+k/nA (button) (small blind) showed [8c Qd] and won ($0.95) with a pair of Jacks
Seat 2: 3Wro85I7472vJ4Wkpneo9A (big blind) showed [3d 4d] and lost with a pair of Jacks



PokerStars Game #59940264244:  Hold'em No Limit ($0.25/$0.50) - 2009/07/01 1:01:44 ET
Table '+z1aekfHkpp09pc8F9aViw' 6-max Seat #5 is the button
Seat 1: FHilMb2i2DbUCc9lplszog ($26.85 in chips)
Seat 2: M6xK/VklCvdyyrmvzATlxQ ($33.75 in chips)
Seat 3: uUznlIMFnRUvwrBhYF73KA ($122.90 in chips)
Seat 4: RowCSpSURHTOL/dcjg/Iug ($39.55 in chips)
Seat 5: rplyldNweS6YyMNEALQrug ($53.50 in chips)
Seat 6: 686aeHikcJlgKkSuIFdcXQ ($50 in chips)
686aeHikcJlgKkSuIFdcXQ: posts small blind $0.25
FHilMb2i2DbUCc9lplszog: posts big blind $0.50
*** HOLE CARDS ***
M6xK/VklCvdyyrmvzATlxQ: folds
uUznlIMFnRUvwrBhYF73KA: calls $0.50
RowCSpSURHTOL/dcjg/Iug: folds
rplyldNweS6YyMNEALQrug: calls $0.50
686aeHikcJlgKkSuIFdcXQ: calls $0.25
FHilMb2i2DbUCc9lplszog: checks
*** FLOP *** [7h 8s Ah]
686aeHikcJlgKkSuIFdcXQ: checks
FHilMb2i2DbUCc9lplszog: checks
uUznlIMFnRUvwrBhYF73KA: checks
rplyldNweS6YyMNEALQrug: checks
*** TURN *** [7h 8s Ah] [Ac]
686aeHikcJlgKkSuIFdcXQ: checks
FHilMb2i2DbUCc9lplszog: checks
uUznlIMFnRUvwrBhYF73KA: checks
rplyldNweS6YyMNEALQrug: bets $3
686aeHikcJlgKkSuIFdcXQ: folds
FHilMb2i2DbUCc9lplszog: folds
uUznlIMFnRUvwrBhYF73KA: folds
rplyldNweS6YyMNEALQrug collected $1.90 from pot
*** SUMMARY ***
Total pot $2 | Rake $0.10
Board [7h 8s Ah Ac]
Seat 1: FHilMb2i2DbUCc9lplszog (big blind) folded on the Turn
Seat 2: M6xK/VklCvdyyrmvzATlxQ folded before Flop (didn't bet)
Seat 3: uUznlIMFnRUvwrBhYF73KA folded on the Turn
Seat 4: RowCSpSURHTOL/dcjg/Iug folded before Flop (didn't bet)
Seat 5: rplyldNweS6YyMNEALQrug (button) collected ($1.90)
Seat 6: 686aeHikcJlgKkSuIFdcXQ (small blind) folded on the Turn



PokerStars Game #59940264628:  Hold'em No Limit ($0.25/$0.50) - 2009/07/01 1:01:45 ET
Table 'Nz0Vr7WMHL2g5Uk7dDZjpw' 9-max Seat #1 is the button
Seat 1: tLkxo7JgV+WWI0UBw44K5A ($109.85 in chips)
Seat 2: gsyXT42WLEcOS4DdEk2wlw ($29.50 in chips)
Seat 4: E2518gp4aFz1+kAgmGqeEg ($11.50 in chips)
Seat 5: WGW0DgjBUXs1ylURHG8vnQ ($27.90 in chips)
Seat 6: 997ViqAtWn1FPjJqcffwcA ($60.55 in chips)
Seat 7: KPLH0gELgFe2OuAnhJFI5w ($15.35 in chips)
Seat 8: HkZI6g4zl83TDTA7SRspmQ ($17.80 in chips)
Seat 9: mSD1pginDsyHG5PDfqzphw ($10 in chips)
gsyXT42WLEcOS4DdEk2wlw: posts small blind $0.25
uw9QayAAxLM3Hb+HR7mSkg: is sitting out
E2518gp4aFz1+kAgmGqeEg: posts big blind $0.50
*** HOLE CARDS ***
WGW0DgjBUXs1ylURHG8vnQ: folds
997ViqAtWn1FPjJqcffwcA: folds
uw9QayAAxLM3Hb+HR7mSkg leaves the table
KPLH0gELgFe2OuAnhJFI5w: folds
HkZI6g4zl83TDTA7SRspmQ: calls $0.50
mSD1pginDsyHG5PDfqzphw: folds
tLkxo7JgV+WWI0UBw44K5A: folds
gsyXT42WLEcOS4DdEk2wlw: folds
E2518gp4aFz1+kAgmGqeEg: raises $11 to $11.50 and is all-in
HkZI6g4zl83TDTA7SRspmQ: calls $11
*** FLOP *** [8h 7s Qs]
*** TURN *** [8h 7s Qs] [9h]
*** RIVER *** [8h 7s Qs 9h] [2s]
*** SHOW DOWN ***
E2518gp4aFz1+kAgmGqeEg: shows [Kc Jc] (high card King)
HkZI6g4zl83TDTA7SRspmQ: shows [Qd Js] (a pair of Queens)
HkZI6g4zl83TDTA7SRspmQ collected $22.10 from pot
*** SUMMARY ***
Total pot $23.25 | Rake $1.15
Board [8h 7s Qs 9h 2s]
Seat 1: tLkxo7JgV+WWI0UBw44K5A (button) folded before Flop (didn't bet)
Seat 2: gsyXT42WLEcOS4DdEk2wlw (small blind) folded before Flop
Seat 4: E2518gp4aFz1+kAgmGqeEg (big blind) showed [Kc Jc] and lost with high card King
Seat 5: WGW0DgjBUXs1ylURHG8vnQ folded before Flop (didn't bet)
Seat 6: 997ViqAtWn1FPjJqcffwcA folded before Flop (didn't bet)
Seat 7: KPLH0gELgFe2OuAnhJFI5w folded before Flop (didn't bet)
Seat 8: HkZI6g4zl83TDTA7SRspmQ showed [Qd Js] and won ($22.10) with a pair of Queens
Seat 9: mSD1pginDsyHG5PDfqzphw folded before Flop (didn't bet)



PokerStars Game #59940264988:  Hold'em No Limit ($0.25/$0.50) - 2009/07/01 1:01:46 ET
Table '0eJtgVAXVvBgncFdcUpXcQ' 2-max Seat #2 is the button
Seat 1: Ag6DvxX4vbRheqsv2zXKTQ ($27.70 in chips)
Seat 2: KMc4R+K9ao4Ur3rF7NGe6Q ($20.30 in chips)
KMc4R+K9ao4Ur3rF7NGe6Q: posts small blind $0.25
Ag6DvxX4vbRheqsv2zXKTQ: posts big blind $0.50
*** HOLE CARDS ***
KMc4R+K9ao4Ur3rF7NGe6Q: folds
Ag6DvxX4vbRheqsv2zXKTQ collected $0.50 from pot
*** SUMMARY ***
Total pot $0.50 | Rake $0
Seat 1: Ag6DvxX4vbRheqsv2zXKTQ (big blind) collected ($0.50)
Seat 2: KMc4R+K9ao4Ur3rF7NGe6Q (button) (small blind) folded before Flop



PokerStars Game #59940265140:  Hold'em No Limit ($0.25/$0.50) - 2009/07/01 1:01:46 ET
Table 'ZYI3ZReBjdfKEYItkZHI6A' 9-max Seat #4 is the button
Seat 1: E2518gp4aFz1+kAgmGqeEg ($10.25 in chips)
Seat 2: 8zdVaT8pZ/Wm0uWoeLhtZg ($6.75 in chips)
Seat 3: bkXkL3pmapikPQQRNPZSEA ($19.75 in chips)
Seat 4: e2+sK/yjnj94rXOKoxPP2A ($50 in chips)
Seat 5: ApHP7ouup365XIUFBdEDxg ($50.15 in chips)
Seat 6: Wj7mKnRFR90j40wWUu2+Og ($30 in chips)
Seat 7: HWcfp1hY1hqvrddzW3/FQw ($17.50 in chips)
Seat 8: ji04uOybxCdpdefzlUQeKQ ($29.25 in chips)
Seat 9: tLkxo7JgV+WWI0UBw44K5A ($51.60 in chips)
ApHP7ouup365XIUFBdEDxg: posts small blind $0.25
Wj7mKnRFR90j40wWUu2+Og: posts big blind $0.50
*** HOLE CARDS ***
HWcfp1hY1hqvrddzW3/FQw: folds
ji04uOybxCdpdefzlUQeKQ: folds
tLkxo7JgV+WWI0UBw44K5A: folds
E2518gp4aFz1+kAgmGqeEg: raises $1 to $1.50
8zdVaT8pZ/Wm0uWoeLhtZg: folds
bkXkL3pmapikPQQRNPZSEA: folds
e2+sK/yjnj94rXOKoxPP2A: folds
ApHP7ouup365XIUFBdEDxg: folds
Wj7mKnRFR90j40wWUu2+Og: calls $1
*** FLOP *** [3s Kd 8d]
Wj7mKnRFR90j40wWUu2+Og: checks
E2518gp4aFz1+kAgmGqeEg: bets $2
Wj7mKnRFR90j40wWUu2+Og: folds
E2518gp4aFz1+kAgmGqeEg collected $3.10 from pot
E2518gp4aFz1+kAgmGqeEg: doesn't show hand
*** SUMMARY ***
Total pot $3.25 | Rake $0.15
Board [3s Kd 8d]
Seat 1: E2518gp4aFz1+kAgmGqeEg collected ($3.10)
Seat 2: 8zdVaT8pZ/Wm0uWoeLhtZg folded before Flop (didn't bet)
Seat 3: bkXkL3pmapikPQQRNPZSEA folded before Flop (didn't bet)
Seat 4: e2+sK/yjnj94rXOKoxPP2A (button) folded before Flop (didn't bet)
Seat 5: ApHP7ouup365XIUFBdEDxg (small blind) folded before Flop
Seat 6: Wj7mKnRFR90j40wWUu2+Og (big blind) folded on the Flop
Seat 7: HWcfp1hY1hqvrddzW3/FQw folded before Flop (didn't bet)
Seat 8: ji04uOybxCdpdefzlUQeKQ folded before Flop (didn't bet)
Seat 9: tLkxo7JgV+WWI0UBw44K5A folded before Flop (didn't bet)



PokerStars Game #59940265714:  Hold'em No Limit ($0.25/$0.50) - 2009/07/01 1:01:47 ET
Table 'QOgaEqMcJ73pcUMMxoisUg' 6-max Seat #3 is the button
Seat 1: lxIzoHy0RnkfFSODHC2liw ($50 in chips)
Seat 2: 4QfsCWthT/vSLirorNXqtg ($76.35 in chips)
Seat 3: Rt6KgtZ8YaJoTc3FPim00w ($53 in chips)
Seat 4: zAcsDhG/T128Vn7XGVSgKg ($50 in chips)
Seat 5: 6vNxrjjCl6FwfaaymM9jjg ($26.25 in chips)
Seat 6: GoVjFxr3C+JO9vtJH9+IcA ($64.30 in chips)
zAcsDhG/T128Vn7XGVSgKg: posts small blind $0.25
6vNxrjjCl6FwfaaymM9jjg: posts big blind $0.50
*** HOLE CARDS ***
GoVjFxr3C+JO9vtJH9+IcA: calls $0.50
lxIzoHy0RnkfFSODHC2liw: folds
4QfsCWthT/vSLirorNXqtg: folds
Rt6KgtZ8YaJoTc3FPim00w: folds
zAcsDhG/T128Vn7XGVSgKg: calls $0.25
6vNxrjjCl6FwfaaymM9jjg: checks
*** FLOP *** [2h Qc 3s]
zAcsDhG/T128Vn7XGVSgKg: checks
6vNxrjjCl6FwfaaymM9jjg: checks
GoVjFxr3C+JO9vtJH9+IcA: bets $1.50
zAcsDhG/T128Vn7XGVSgKg: folds
6vNxrjjCl6FwfaaymM9jjg: calls $1.50
*** TURN *** [2h Qc 3s] [7d]
6vNxrjjCl6FwfaaymM9jjg: checks
GoVjFxr3C+JO9vtJH9+IcA: bets $3
6vNxrjjCl6FwfaaymM9jjg: calls $3
*** RIVER *** [2h Qc 3s 7d] [7s]
6vNxrjjCl6FwfaaymM9jjg: checks
GoVjFxr3C+JO9vtJH9+IcA: bets $6
6vNxrjjCl6FwfaaymM9jjg: folds
GoVjFxr3C+JO9vtJH9+IcA collected $10 from pot
*** SUMMARY ***
Total pot $10.50 | Rake $0.50
Board [2h Qc 3s 7d 7s]
Seat 1: lxIzoHy0RnkfFSODHC2liw folded before Flop (didn't bet)
Seat 2: 4QfsCWthT/vSLirorNXqtg folded before Flop (didn't bet)
Seat 3: Rt6KgtZ8YaJoTc3FPim00w (button) folded before Flop (didn't bet)
Seat 4: zAcsDhG/T128Vn7XGVSgKg (small blind) folded on the Flop
Seat 5: 6vNxrjjCl6FwfaaymM9jjg (big blind) folded on the River
Seat 6: GoVjFxr3C+JO9vtJH9+IcA collected ($10)



PokerStars Game #59940266466:  Hold'em No Limit ($0.25/$0.50) - 2009/07/01 1:01:48 ET
Table '8BQGgNetI1NOvWeu3gtMNw' 2-max Seat #2 is the button
Seat 1: bypIyrYcAAifLfhZpGlKLA ($53.25 in chips)
Seat 2: Z4HwehErEwzsv/noQlfUlg ($148.10 in chips)
Z4HwehErEwzsv/noQlfUlg: posts small blind $0.25
bypIyrYcAAifLfhZpGlKLA: posts big blind $0.50
*** HOLE CARDS ***
Z4HwehErEwzsv/noQlfUlg: folds
bypIyrYcAAifLfhZpGlKLA collected $0.50 from pot
bypIyrYcAAifLfhZpGlKLA: doesn't show hand
*** SUMMARY ***
Total pot $0.50 | Rake $0
Seat 1: bypIyrYcAAifLfhZpGlKLA (big blind) collected ($0.50)
Seat 2: Z4HwehErEwzsv/noQlfUlg (button) (small blind) folded before Flop



PokerStars Game #59940266790:  Hold'em No Limit ($0.25/$0.50) - 2009/07/01 1:01:49 ET
Table '5EmHi+fnatGQQShcNmzOZQ' 6-max Seat #3 is the button
Seat 1: My8WkRtGx5FW6rJ1I4R3hg ($19.25 in chips)
Seat 2: bfFjgAtIoAI+pUxUwFt3aQ ($49 in chips)
Seat 3: TjmTe3bhs9dFz5gXX9x7Lw ($12.05 in chips)
Seat 4: 1b+2BbjMN8qhR1WPqdE9VQ ($66.05 in chips)
Seat 5: kxPhs4ePFqMy52CInAJ2aw ($82.80 in chips)
Seat 6: 686aeHikcJlgKkSuIFdcXQ ($131.75 in chips)
1b+2BbjMN8qhR1WPqdE9VQ: posts small blind $0.25
kxPhs4ePFqMy52CInAJ2aw: posts big blind $0.50
*** HOLE CARDS ***
686aeHikcJlgKkSuIFdcXQ: folds
My8WkRtGx5FW6rJ1I4R3hg: calls $0.50
bfFjgAtIoAI+pUxUwFt3aQ: folds
TjmTe3bhs9dFz5gXX9x7Lw: folds
1b+2BbjMN8qhR1WPqdE9VQ: folds
kxPhs4ePFqMy52CInAJ2aw: checks
*** FLOP *** [Ks 9s 2c]
kxPhs4ePFqMy52CInAJ2aw: checks
My8WkRtGx5FW6rJ1I4R3hg: bets $0.50
kxPhs4ePFqMy52CInAJ2aw: folds
My8WkRtGx5FW6rJ1I4R3hg collected $1.20 from pot
*** SUMMARY ***
Total pot $1.25 | Rake $0.05
Board [Ks 9s 2c]
Seat 1: My8WkRtGx5FW6rJ1I4R3hg collected ($1.20)
Seat 2: bfFjgAtIoAI+pUxUwFt3aQ folded before Flop (didn't bet)
Seat 3: TjmTe3bhs9dFz5gXX9x7Lw (button) folded before Flop (didn't bet)
Seat 4: 1b+2BbjMN8qhR1WPqdE9VQ (small blind) folded before Flop
Seat 5: kxPhs4ePFqMy52CInAJ2aw (big blind) folded on the Flop
Seat 6: 686aeHikcJlgKkSuIFdcXQ folded before Flop (didn't bet)



PokerStars Game #59940266888:  Hold'em No Limit ($0.25/$0.50) - 2009/07/01 1:01:49 ET
Table 'EiNh8p/wGJ1FP575iMFnqg' 9-max Seat #2 is the button
Seat 1: r3ZqM1Mi0W3y4hOdssE+Sg ($44.85 in chips)
Seat 2: 8ehL7qlZzjgUh2H35iiWLw ($51.85 in chips)
Seat 3: ymLPoEIl7UL3TvZYmnadxQ ($51.05 in chips)
Seat 4: cMzaiXAM/ZAdNaEUu+LqhA ($55.70 in chips)
Seat 5: M+7+BTmX5vZatHVuoRB1nA ($82.20 in chips)
Seat 6: 3UmXLy3GfjC3EkOebduerQ ($64.10 in chips)
Seat 7: 997ViqAtWn1FPjJqcffwcA ($50 in chips)
Seat 8: mSD1pginDsyHG5PDfqzphw ($11.60 in chips)
Seat 9: NnQCepdIR/AOUQn1yhYx6Q ($11.75 in chips)
ymLPoEIl7UL3TvZYmnadxQ: posts small blind $0.25
cMzaiXAM/ZAdNaEUu+LqhA: posts big blind $0.50
*** HOLE CARDS ***
M+7+BTmX5vZatHVuoRB1nA: raises $1.50 to $2
3UmXLy3GfjC3EkOebduerQ: folds
997ViqAtWn1FPjJqcffwcA: folds
mSD1pginDsyHG5PDfqzphw: folds
NnQCepdIR/AOUQn1yhYx6Q: folds
r3ZqM1Mi0W3y4hOdssE+Sg: folds
8ehL7qlZzjgUh2H35iiWLw: folds
ymLPoEIl7UL3TvZYmnadxQ: folds
cMzaiXAM/ZAdNaEUu+LqhA: folds
M+7+BTmX5vZatHVuoRB1nA collected $1.25 from pot
M+7+BTmX5vZatHVuoRB1nA: doesn't show hand
*** SUMMARY ***
Total pot $1.25 | Rake $0
Seat 1: r3ZqM1Mi0W3y4hOdssE+Sg folded before Flop (didn't bet)
Seat 2: 8ehL7qlZzjgUh2H35iiWLw (button) folded before Flop (didn't bet)
Seat 3: ymLPoEIl7UL3TvZYmnadxQ (small blind) folded before Flop
Seat 4: cMzaiXAM/ZAdNaEUu+LqhA (big blind) folded before Flop
Seat 5: M+7+BTmX5vZatHVuoRB1nA collected ($1.25)
Seat 6: 3UmXLy3GfjC3EkOebduerQ folded before Flop (didn't bet)
Seat 7: 997ViqAtWn1FPjJqcffwcA folded before Flop (didn't bet)
Seat 8: mSD1pginDsyHG5PDfqzphw folded before Flop (didn't bet)
Seat 9: NnQCepdIR/AOUQn1yhYx6Q folded before Flop (didn't bet)



PokerStars Game #59940268256:  Hold'em No Limit ($0.25/$0.50) - 2009/07/01 1:01:51 ET
Table '0eJtgVAXVvBgncFdcUpXcQ' 2-max Seat #1 is the button
Seat 1: Ag6DvxX4vbRheqsv2zXKTQ ($27.95 in chips)
Seat 2: KMc4R+K9ao4Ur3rF7NGe6Q ($20.05 in chips)
Ag6DvxX4vbRheqsv2zXKTQ: posts small blind $0.25
KMc4R+K9ao4Ur3rF7NGe6Q: posts big blind $0.50
*** HOLE CARDS ***
Ag6DvxX4vbRheqsv2zXKTQ: raises $1 to $1.50
KMc4R+K9ao4Ur3rF7NGe6Q: calls $1
*** FLOP *** [6h 3s Tc]
KMc4R+K9ao4Ur3rF7NGe6Q: bets $2
Ag6DvxX4vbRheqsv2zXKTQ: calls $2
*** TURN *** [6h 3s Tc] [Td]
KMc4R+K9ao4Ur3rF7NGe6Q: checks
Ag6DvxX4vbRheqsv2zXKTQ: bets $3
KMc4R+K9ao4Ur3rF7NGe6Q: folds
Ag6DvxX4vbRheqsv2zXKTQ collected $6.70 from pot
*** SUMMARY ***
Total pot $7 | Rake $0.30
Board [6h 3s Tc Td]
Seat 1: Ag6DvxX4vbRheqsv2zXKTQ (button) (small blind) collected ($6.70)
Seat 2: KMc4R+K9ao4Ur3rF7NGe6Q (big blind) folded on the Turn



PokerStars Game #59940269362:  Hold'em No Limit ($0.25/$0.50) - 2009/07/01 1:01:53 ET
Table 'fx6MqwfYAj/Rt86hBz2L3Q' 9-max Seat #7 is the button
Seat 2: C3rGXblctNcWI6JYPHhaEg ($36.60 in chips)
Seat 3: iadBi5AEt7gTBXbDSSnMYQ ($80.40 in chips)
Seat 4: 75K2MXwN65Sjfp1yHd50Hg ($9.25 in chips)
Seat 5: iAISe3dVeua8PUn2wwgDHw ($25.75 in chips)
Seat 6: 5k9fvXD9suIgCxU4HLQjTw ($50.75 in chips)
Seat 7: SKnJuWHScqetA/qG5p+wCg ($30 in chips)
Seat 8: JYwJYYV9pM5KWdSiETl8rA ($21.50 in chips)
Seat 9: HZkVla4kK2SI42CVrPZ/ig ($10.25 in chips)
JYwJYYV9pM5KWdSiETl8rA: posts small blind $0.25
HZkVla4kK2SI42CVrPZ/ig: posts big blind $0.50
uw9QayAAxLM3Hb+HR7mSkg: sits out
*** HOLE CARDS ***
C3rGXblctNcWI6JYPHhaEg: calls $0.50
iadBi5AEt7gTBXbDSSnMYQ: calls $0.50
75K2MXwN65Sjfp1yHd50Hg: folds
iAISe3dVeua8PUn2wwgDHw: raises $1.50 to $2
5k9fvXD9suIgCxU4HLQjTw: folds
SKnJuWHScqetA/qG5p+wCg: folds
JYwJYYV9pM5KWdSiETl8rA: folds
HZkVla4kK2SI42CVrPZ/ig: folds
C3rGXblctNcWI6JYPHhaEg: calls $1.50
iadBi5AEt7gTBXbDSSnMYQ: calls $1.50
*** FLOP *** [Jd 7s Td]
C3rGXblctNcWI6JYPHhaEg: checks
iadBi5AEt7gTBXbDSSnMYQ: bets $1.50
iAISe3dVeua8PUn2wwgDHw: raises $1.50 to $3
C3rGXblctNcWI6JYPHhaEg: folds
iadBi5AEt7gTBXbDSSnMYQ: calls $1.50
*** TURN *** [Jd 7s Td] [Jc]
iadBi5AEt7gTBXbDSSnMYQ: bets $3
iAISe3dVeua8PUn2wwgDHw: raises $3 to $6
iadBi5AEt7gTBXbDSSnMYQ: raises $25 to $31
iAISe3dVeua8PUn2wwgDHw: calls $14.75 and is all-in
*** RIVER *** [Jd 7s Td Jc] [6h]
*** SHOW DOWN ***
iadBi5AEt7gTBXbDSSnMYQ: shows [8h Th] (two pair, Jacks and Tens)
iAISe3dVeua8PUn2wwgDHw: shows [Qd Qs] (two pair, Queens and Jacks)
iAISe3dVeua8PUn2wwgDHw collected $51.60 from pot
*** SUMMARY ***
Total pot $54.25 | Rake $2.65
Board [Jd 7s Td Jc 6h]
Seat 2: C3rGXblctNcWI6JYPHhaEg folded on the Flop
Seat 3: iadBi5AEt7gTBXbDSSnMYQ showed [8h Th] and lost with two pair, Jacks and Tens
Seat 4: 75K2MXwN65Sjfp1yHd50Hg folded before Flop (didn't bet)
Seat 5: iAISe3dVeua8PUn2wwgDHw showed [Qd Qs] and won ($51.60) with two pair, Queens and Jacks
Seat 6: 5k9fvXD9suIgCxU4HLQjTw folded before Flop (didn't bet)
Seat 7: SKnJuWHScqetA/qG5p+wCg (button) folded before Flop (didn't bet)
Seat 8: JYwJYYV9pM5KWdSiETl8rA (small blind) folded before Flop
Seat 9: HZkVla4kK2SI42CVrPZ/ig (big blind) folded before Flop



PokerStars Game #59940269810:  Hold'em No Limit ($0.25/$0.50) - 2009/07/01 1:01:54 ET
Table '9Puy2HWN1RQe5SSjq162gA' 2-max Seat #1 is the button
Seat 1: Fp/oksNpipCrD2MJ2pH20g ($18.25 in chips)
Seat 2: tDV+zhxH9+3DkJDzoTERyg ($28.30 in chips)
Fp/oksNpipCrD2MJ2pH20g: posts small blind $0.25
tDV+zhxH9+3DkJDzoTERyg: posts big blind $0.50
*** HOLE CARDS ***
Fp/oksNpipCrD2MJ2pH20g: calls $0.25
tDV+zhxH9+3DkJDzoTERyg: checks
*** FLOP *** [6s Ks 6d]
tDV+zhxH9+3DkJDzoTERyg: checks
Fp/oksNpipCrD2MJ2pH20g: checks
*** TURN *** [6s Ks 6d] [3h]
tDV+zhxH9+3DkJDzoTERyg: checks
Fp/oksNpipCrD2MJ2pH20g: checks
*** RIVER *** [6s Ks 6d 3h] [Kd]
tDV+zhxH9+3DkJDzoTERyg: checks
Fp/oksNpipCrD2MJ2pH20g: checks
*** SHOW DOWN ***
tDV+zhxH9+3DkJDzoTERyg: shows [4h 2s] (two pair, Kings and Sixes)
Fp/oksNpipCrD2MJ2pH20g: shows [Qh 5h] (two pair, Kings and Sixes - Queen kicker)
Fp/oksNpipCrD2MJ2pH20g collected $0.95 from pot
*** SUMMARY ***
Total pot $1 | Rake $0.05
Board [6s Ks 6d 3h Kd]
Seat 1: Fp/oksNpipCrD2MJ2pH20g (button) (small blind) showed [Qh 5h] and won ($0.95) with two pair, Kings and Sixes
Seat 2: tDV+zhxH9+3DkJDzoTERyg (big blind) showed [4h 2s] and lost with two pair, Kings and Sixes



PokerStars Game #59940271484:  Hold'em No Limit ($0.25/$0.50) - 2009/07/01 1:01:56 ET
Table 'NCiXr0d5CEKBQr/cZgLhbA' 9-max Seat #1 is the button
Seat 1: pFtzb1sR4b0d1aw6aIRgDg ($50 in chips)
Seat 2: ulxuJchBV9iguXg0FUonfg ($51.70 in chips)
Seat 3: xZCXQSXlrZkp3pZizzVXCw ($52.70 in chips)
Seat 4: 5k9fvXD9suIgCxU4HLQjTw ($55.20 in chips)
Seat 5: zE9cVigS2nW/Ljy4K4bUQA ($33.30 in chips)
Seat 6: SKnJuWHScqetA/qG5p+wCg ($32.75 in chips)
Seat 7: M+7+BTmX5vZatHVuoRB1nA ($52 in chips)
Seat 8: 1MJUKc3cc0QmUoz1JZLR2w ($64.05 in chips)
Seat 9: 4WLZvqBn5qv5tds5kt5A1Q ($38.45 in chips)
ulxuJchBV9iguXg0FUonfg: posts small blind $0.25
xZCXQSXlrZkp3pZizzVXCw: posts big blind $0.50
*** HOLE CARDS ***
5k9fvXD9suIgCxU4HLQjTw: folds
zE9cVigS2nW/Ljy4K4bUQA: folds
SKnJuWHScqetA/qG5p+wCg: folds
M+7+BTmX5vZatHVuoRB1nA: folds
1MJUKc3cc0QmUoz1JZLR2w: folds
4WLZvqBn5qv5tds5kt5A1Q: raises $1.50 to $2
pFtzb1sR4b0d1aw6aIRgDg: folds
ulxuJchBV9iguXg0FUonfg: calls $1.75
xZCXQSXlrZkp3pZizzVXCw: folds
*** FLOP *** [4c Ks 8d]
ulxuJchBV9iguXg0FUonfg: checks
4WLZvqBn5qv5tds5kt5A1Q: checks
*** TURN *** [4c Ks 8d] [9c]
ulxuJchBV9iguXg0FUonfg: bets $1
4WLZvqBn5qv5tds5kt5A1Q: raises $3 to $4
ulxuJchBV9iguXg0FUonfg: folds
4WLZvqBn5qv5tds5kt5A1Q collected $6.20 from pot
*** SUMMARY ***
Total pot $6.50 | Rake $0.30
Board [4c Ks 8d 9c]
Seat 1: pFtzb1sR4b0d1aw6aIRgDg (button) folded before Flop (didn't bet)
Seat 2: ulxuJchBV9iguXg0FUonfg (small blind) folded on the Turn
Seat 3: xZCXQSXlrZkp3pZizzVXCw (big blind) folded before Flop
Seat 4: 5k9fvXD9suIgCxU4HLQjTw folded before Flop (didn't bet)
Seat 5: zE9cVigS2nW/Ljy4K4bUQA folded before Flop (didn't bet)
Seat 6: SKnJuWHScqetA/qG5p+wCg folded before Flop (didn't bet)
Seat 7: M+7+BTmX5vZatHVuoRB1nA folded before Flop (didn't bet)
Seat 8: 1MJUKc3cc0QmUoz1JZLR2w folded before Flop (didn't bet)
Seat 9: 4WLZvqBn5qv5tds5kt5A1Q collected ($6.20)



PokerStars Game #59940272644:  Hold'em No Limit ($0.25/$0.50) - 2009/07/01 1:01:58 ET
Table 'c/CRn+68J3Y8KxD5g1ek2Q' 2-max Seat #2 is the button
Seat 1: 46qCyJ6evTkHo9al5sBMNA ($88.45 in chips)
Seat 2: BypVLsYQt3ePFm2xQL/dOA ($279.80 in chips)
BypVLsYQt3ePFm2xQL/dOA: posts small blind $0.25
46qCyJ6evTkHo9al5sBMNA: posts big blind $0.50
*** HOLE CARDS ***
BypVLsYQt3ePFm2xQL/dOA: calls $0.25
46qCyJ6evTkHo9al5sBMNA: checks
*** FLOP *** [Jd Jh As]
46qCyJ6evTkHo9al5sBMNA: checks
BypVLsYQt3ePFm2xQL/dOA: bets $1.50
46qCyJ6evTkHo9al5sBMNA: folds
BypVLsYQt3ePFm2xQL/dOA collected $0.95 from pot
BypVLsYQt3ePFm2xQL/dOA: doesn't show hand
*** SUMMARY ***
Total pot $1 | Rake $0.05
Board [Jd Jh As]
Seat 1: 46qCyJ6evTkHo9al5sBMNA (big blind) folded on the Flop
Seat 2: BypVLsYQt3ePFm2xQL/dOA (button) (small blind) collected ($0.95)



PokerStars Game #59940274060:  Hold'em No Limit ($0.25/$0.50) - 2009/07/01 1:02:01 ET
Table '8BQGgNetI1NOvWeu3gtMNw' 2-max Seat #1 is the button
Seat 1: bypIyrYcAAifLfhZpGlKLA ($53.50 in chips)
Seat 2: Z4HwehErEwzsv/noQlfUlg ($147.85 in chips)
bypIyrYcAAifLfhZpGlKLA: posts small blind $0.25
Z4HwehErEwzsv/noQlfUlg: posts big blind $0.50
*** HOLE CARDS ***
bypIyrYcAAifLfhZpGlKLA: folds
Z4HwehErEwzsv/noQlfUlg collected $0.50 from pot
Z4HwehErEwzsv/noQlfUlg: doesn't show hand
*** SUMMARY ***
Total pot $0.50 | Rake $0
Seat 1: bypIyrYcAAifLfhZpGlKLA (button) (small blind) folded before Flop
Seat 2: Z4HwehErEwzsv/noQlfUlg (big blind) collected ($0.50)



PokerStars Game #59940274262:  Hold'em No Limit ($0.25/$0.50) - 2009/07/01 1:02:01 ET
Table 'MJxeZCzYELxiIsyUZyT0jw' 6-max Seat #3 is the button
Seat 1: +Pf9jTVizYlIo+woPvptfA ($50 in chips)
Seat 2: t3GiVMzqA9Svgr5Uol32cQ ($43.85 in chips)
Seat 3: JQZew0FjzS19kTjeNtrE+A ($60.40 in chips)
Seat 4: alGiiQP/wwtYnfuXII+sgw ($36.35 in chips)
Seat 5: 3jvoOXNtXE90w2BdfNZwZQ ($60.10 in chips)
Seat 6: c0n4hrn20AML9qzyFC2E8Q ($48.75 in chips)
alGiiQP/wwtYnfuXII+sgw: posts small blind $0.25
3jvoOXNtXE90w2BdfNZwZQ: posts big blind $0.50
*** HOLE CARDS ***
c0n4hrn20AML9qzyFC2E8Q: folds
+Pf9jTVizYlIo+woPvptfA: folds
t3GiVMzqA9Svgr5Uol32cQ: folds
JQZew0FjzS19kTjeNtrE+A: folds
alGiiQP/wwtYnfuXII+sgw: folds
3jvoOXNtXE90w2BdfNZwZQ collected $0.50 from pot
3jvoOXNtXE90w2BdfNZwZQ: doesn't show hand
*** SUMMARY ***
Total pot $0.50 | Rake $0
Seat 1: +Pf9jTVizYlIo+woPvptfA folded before Flop (didn't bet)
Seat 2: t3GiVMzqA9Svgr5Uol32cQ folded before Flop (didn't bet)
Seat 3: JQZew0FjzS19kTjeNtrE+A (button) folded before Flop (didn't bet)
Seat 4: alGiiQP/wwtYnfuXII+sgw (small blind) folded before Flop
Seat 5: 3jvoOXNtXE90w2BdfNZwZQ (big blind) collected ($0.50)
Seat 6: c0n4hrn20AML9qzyFC2E8Q folded before Flop (didn't bet)



PokerStars Game #59940275062:  Hold'em No Limit ($0.25/$0.50) - 2009/07/01 1:02:02 ET
Table 'X6IRCRTh+20gjz8aubWnwA' 9-max Seat #7 is the button
Seat 1: DSM67hHHq1XFoEOi9p8Alw ($49.05 in chips)
Seat 2: HZkVla4kK2SI42CVrPZ/ig ($7.55 in chips)
Seat 3: SWv01peOe69QQRvhQTqjQw ($9.25 in chips)
Seat 4: M3JFBNQ8Bbw3FBZ/18MuXw ($26.60 in chips)
Seat 5: NnQCepdIR/AOUQn1yhYx6Q ($9.25 in chips)
Seat 6: 75K2MXwN65Sjfp1yHd50Hg ($10 in chips)
Seat 7: cFHQjKQOOKTUzoilhrXHLg ($40.75 in chips)
Seat 8: HxeBVq06/3Bh/H986sgdbw ($23.50 in chips)
Seat 9: M+7+BTmX5vZatHVuoRB1nA ($46.75 in chips)
HxeBVq06/3Bh/H986sgdbw: posts small blind $0.25
M+7+BTmX5vZatHVuoRB1nA: posts big blind $0.50
*** HOLE CARDS ***
DSM67hHHq1XFoEOi9p8Alw: folds
HZkVla4kK2SI42CVrPZ/ig: folds
SWv01peOe69QQRvhQTqjQw: folds
M3JFBNQ8Bbw3FBZ/18MuXw: folds
NnQCepdIR/AOUQn1yhYx6Q: raises $1.50 to $2
75K2MXwN65Sjfp1yHd50Hg: folds
cFHQjKQOOKTUzoilhrXHLg: folds
HxeBVq06/3Bh/H986sgdbw: folds
M+7+BTmX5vZatHVuoRB1nA: folds
NnQCepdIR/AOUQn1yhYx6Q collected $1.25 from pot
*** SUMMARY ***
Total pot $1.25 | Rake $0
Seat 1: DSM67hHHq1XFoEOi9p8Alw folded before Flop (didn't bet)
Seat 2: HZkVla4kK2SI42CVrPZ/ig folded before Flop (didn't bet)
Seat 3: SWv01peOe69QQRvhQTqjQw folded before Flop (didn't bet)
Seat 4: M3JFBNQ8Bbw3FBZ/18MuXw folded before Flop (didn't bet)
Seat 5: NnQCepdIR/AOUQn1yhYx6Q collected ($1.25)
Seat 6: 75K2MXwN65Sjfp1yHd50Hg folded before Flop (didn't bet)
Seat 7: cFHQjKQOOKTUzoilhrXHLg (button) folded before Flop (didn't bet)
Seat 8: HxeBVq06/3Bh/H986sgdbw (small blind) folded before Flop
Seat 9: M+7+BTmX5vZatHVuoRB1nA (big blind) folded before Flop



PokerStars Game #59940276706:  Hold'em No Limit ($0.25/$0.50) - 2009/07/01 1:02:05 ET
Table 'BCN5su+SsXiy1zRMJi0SJw' 6-max Seat #1 is the button
Seat 1: GxXV09ciXaOxyY2H5aMIIw ($31.65 in chips)
Seat 2: oU2kDCkT/gilYbHWrg7D8w ($44.10 in chips)
Seat 3: 6wzJiRvp8HY6t+MQGnSIzA ($18.85 in chips)
Seat 4: qfeUHOJpMYyzQcj0o2A7ng ($5.75 in chips)
Seat 5: IBNygaT1aa9Z1uPdJJilwA ($41 in chips)
Seat 6: b2symlOdL7+0c9Pj4N/KlA ($54.50 in chips)
oU2kDCkT/gilYbHWrg7D8w: posts small blind $0.25
6wzJiRvp8HY6t+MQGnSIzA: posts big blind $0.50
*** HOLE CARDS ***
qfeUHOJpMYyzQcj0o2A7ng: folds
IBNygaT1aa9Z1uPdJJilwA: folds
b2symlOdL7+0c9Pj4N/KlA: folds
GxXV09ciXaOxyY2H5aMIIw: folds
oU2kDCkT/gilYbHWrg7D8w: calls $0.25
6wzJiRvp8HY6t+MQGnSIzA: checks
*** FLOP *** [Jd Tc 9s]
oU2kDCkT/gilYbHWrg7D8w: checks
6wzJiRvp8HY6t+MQGnSIzA: bets $1
oU2kDCkT/gilYbHWrg7D8w: folds
6wzJiRvp8HY6t+MQGnSIzA collected $0.95 from pot
6wzJiRvp8HY6t+MQGnSIzA: doesn't show hand
*** SUMMARY ***
Total pot $1 | Rake $0.05
Board [Jd Tc 9s]
Seat 1: GxXV09ciXaOxyY2H5aMIIw (button) folded before Flop (didn't bet)
Seat 2: oU2kDCkT/gilYbHWrg7D8w (small blind) folded on the Flop
Seat 3: 6wzJiRvp8HY6t+MQGnSIzA (big blind) collected ($0.95)
Seat 4: qfeUHOJpMYyzQcj0o2A7ng folded before Flop (didn't bet)
Seat 5: IBNygaT1aa9Z1uPdJJilwA folded before Flop (didn't bet)
Seat 6: b2symlOdL7+0c9Pj4N/KlA folded before Flop (didn't bet)



PokerStars Game #59940278094:  Hold'em No Limit ($0.25/$0.50) - 2009/07/01 1:02:07 ET
Table 'E7bWJ45aoFXRpyRv2gw+Ig' 2-max Seat #2 is the button
Seat 1: FRkiRasEGlHUeLrEl+k/nA ($58.65 in chips)
Seat 2: 3Wro85I7472vJ4Wkpneo9A ($130 in chips)
3Wro85I7472vJ4Wkpneo9A: posts small blind $0.25
FRkiRasEGlHUeLrEl+k/nA: posts big blind $0.50
*** HOLE CARDS ***
3Wro85I7472vJ4Wkpneo9A: calls $0.25
FRkiRasEGlHUeLrEl+k/nA: checks
*** FLOP *** [Tc 7d 4d]
FRkiRasEGlHUeLrEl+k/nA: checks
3Wro85I7472vJ4Wkpneo9A: bets $1
FRkiRasEGlHUeLrEl+k/nA: folds
3Wro85I7472vJ4Wkpneo9A collected $0.95 from pot
3Wro85I7472vJ4Wkpneo9A: doesn't show hand
*** SUMMARY ***
Total pot $1 | Rake $0.05
Board [Tc 7d 4d]
Seat 1: FRkiRasEGlHUeLrEl+k/nA (big blind) folded on the Flop
Seat 2: 3Wro85I7472vJ4Wkpneo9A (button) (small blind) collected ($0.95)



PokerStars Game #59940278128:  Hold'em No Limit ($0.25/$0.50) - 2009/07/01 1:02:07 ET
Table '8BQGgNetI1NOvWeu3gtMNw' 2-max Seat #2 is the button
Seat 1: bypIyrYcAAifLfhZpGlKLA ($53.25 in chips)
Seat 2: Z4HwehErEwzsv/noQlfUlg ($148.10 in chips)
Z4HwehErEwzsv/noQlfUlg: posts small blind $0.25
bypIyrYcAAifLfhZpGlKLA: posts big blind $0.50
*** HOLE CARDS ***
Z4HwehErEwzsv/noQlfUlg: folds
bypIyrYcAAifLfhZpGlKLA collected $0.50 from pot
bypIyrYcAAifLfhZpGlKLA: doesn't show hand
*** SUMMARY ***
Total pot $0.50 | Rake $0
Seat 1: bypIyrYcAAifLfhZpGlKLA (big blind) collected ($0.50)
Seat 2: Z4HwehErEwzsv/noQlfUlg (button) (small blind) folded before Flop



PokerStars Game #59940278216:  Hold'em No Limit ($0.25/$0.50) - 2009/07/01 1:02:08 ET
Table 'otvGDROEDdqsabxskT79qg' 9-max Seat #5 is the button
Seat 1: 8ehL7qlZzjgUh2H35iiWLw ($56.75 in chips)
Seat 2: cCjTzH9jio8607WzjcfXlg ($13.55 in chips)
Seat 3: +k7T5ocke8UwavtgUHm+Cg ($70.60 in chips)
Seat 4: MG90wfSJZnOejs/KD3vlQQ ($76.65 in chips)
Seat 5: E2518gp4aFz1+kAgmGqeEg ($11 in chips)
Seat 6: bxLSulbgr8LmKNjOzw8URg ($53.20 in chips)
Seat 7: 75K2MXwN65Sjfp1yHd50Hg ($10 in chips)
Seat 8: zE9cVigS2nW/Ljy4K4bUQA ($30.75 in chips)
Seat 9: KcY3X8YpD74Kw1RHkx/g4A ($51.15 in chips)
bxLSulbgr8LmKNjOzw8URg: posts small blind $0.25
75K2MXwN65Sjfp1yHd50Hg: posts big blind $0.50
*** HOLE CARDS ***
zE9cVigS2nW/Ljy4K4bUQA: folds
KcY3X8YpD74Kw1RHkx/g4A: folds
8ehL7qlZzjgUh2H35iiWLw: folds
cCjTzH9jio8607WzjcfXlg: calls $0.50
+k7T5ocke8UwavtgUHm+Cg: folds
MG90wfSJZnOejs/KD3vlQQ: folds
E2518gp4aFz1+kAgmGqeEg: folds
bxLSulbgr8LmKNjOzw8URg: folds
75K2MXwN65Sjfp1yHd50Hg: checks
*** FLOP *** [Kd Tc 6c]
75K2MXwN65Sjfp1yHd50Hg: checks
cCjTzH9jio8607WzjcfXlg: checks
*** TURN *** [Kd Tc 6c] [8s]
75K2MXwN65Sjfp1yHd50Hg: checks
cCjTzH9jio8607WzjcfXlg: checks
*** RIVER *** [Kd Tc 6c 8s] [7c]
75K2MXwN65Sjfp1yHd50Hg: checks
cCjTzH9jio8607WzjcfXlg: checks
*** SHOW DOWN ***
75K2MXwN65Sjfp1yHd50Hg: shows [4h 2c] (high card King)
cCjTzH9jio8607WzjcfXlg: shows [Ad 5d] (high card Ace)
cCjTzH9jio8607WzjcfXlg collected $1.20 from pot
*** SUMMARY ***
Total pot $1.25 | Rake $0.05
Board [Kd Tc 6c 8s 7c]
Seat 1: 8ehL7qlZzjgUh2H35iiWLw folded before Flop (didn't bet)
Seat 2: cCjTzH9jio8607WzjcfXlg showed [Ad 5d] and won ($1.20) with high card Ace
Seat 3: +k7T5ocke8UwavtgUHm+Cg folded before Flop (didn't bet)
Seat 4: MG90wfSJZnOejs/KD3vlQQ folded before Flop (didn't bet)
Seat 5: E2518gp4aFz1+kAgmGqeEg (button) folded before Flop (didn't bet)
Seat 6: bxLSulbgr8LmKNjOzw8URg (small blind) folded before Flop
Seat 7: 75K2MXwN65Sjfp1yHd50Hg (big blind) showed [4h 2c] and lost with high card King
Seat 8: zE9cVigS2nW/Ljy4K4bUQA folded before Flop (didn't bet)
Seat 9: KcY3X8YpD74Kw1RHkx/g4A folded before Flop (didn't bet)



PokerStars Game #59940278988:  Hold'em No Limit ($0.25/$0.50) - 2009/07/01 1:02:09 ET
Table '0eJtgVAXVvBgncFdcUpXcQ' 2-max Seat #2 is the button
Seat 1: Ag6DvxX4vbRheqsv2zXKTQ ($31.15 in chips)
Seat 2: KMc4R+K9ao4Ur3rF7NGe6Q ($16.55 in chips)
KMc4R+K9ao4Ur3rF7NGe6Q: posts small blind $0.25
Ag6DvxX4vbRheqsv2zXKTQ: posts big blind $0.50
*** HOLE CARDS ***
KMc4R+K9ao4Ur3rF7NGe6Q: calls $0.25
Ag6DvxX4vbRheqsv2zXKTQ: checks
*** FLOP *** [7h Ks 5h]
Ag6DvxX4vbRheqsv2zXKTQ: checks
KMc4R+K9ao4Ur3rF7NGe6Q: checks
*** TURN *** [7h Ks 5h] [Qs]
Ag6DvxX4vbRheqsv2zXKTQ: checks
KMc4R+K9ao4Ur3rF7NGe6Q: checks
*** RIVER *** [7h Ks 5h Qs] [8h]
Ag6DvxX4vbRheqsv2zXKTQ: checks
KMc4R+K9ao4Ur3rF7NGe6Q: checks
*** SHOW DOWN ***
Ag6DvxX4vbRheqsv2zXKTQ: shows [3h As] (high card Ace)
KMc4R+K9ao4Ur3rF7NGe6Q: mucks hand
Ag6DvxX4vbRheqsv2zXKTQ collected $0.95 from pot
*** SUMMARY ***
Total pot $1 | Rake $0.05
Board [7h Ks 5h Qs 8h]
Seat 1: Ag6DvxX4vbRheqsv2zXKTQ (big blind) showed [3h As] and won ($0.95) with high card Ace
Seat 2: KMc4R+K9ao4Ur3rF7NGe6Q (button) (small blind) mucked



PokerStars Game #59940280394:  Hold'em No Limit ($0.25/$0.50) - 2009/07/01 1:02:11 ET
Table 'lSisgp6H7Fg1hH5VfjEjYQ' 9-max Seat #3 is the button
Seat 1: 5k9fvXD9suIgCxU4HLQjTw ($50 in chips)
Seat 2: UrcnkQOiLVk8BlKDPJSy7Q ($75.85 in chips)
Seat 3: aTkyjTh3w5YLWiIERupZOA ($51.90 in chips)
Seat 4: bwv/rbH/hHhPhY6u9mu04w ($31.10 in chips)
Seat 5: mSD1pginDsyHG5PDfqzphw ($10 in chips)
Seat 6: +k7T5ocke8UwavtgUHm+Cg ($67.80 in chips)
Seat 7: IDtNLR9uFCDdjNsJWMHA5Q ($21.70 in chips)
Seat 8: a4JDWmpFQkL10XfAyuF51A ($27.75 in chips)
bwv/rbH/hHhPhY6u9mu04w: posts small blind $0.25
mSD1pginDsyHG5PDfqzphw: posts big blind $0.50
tkflckdgk: sits out
*** HOLE CARDS ***
+k7T5ocke8UwavtgUHm+Cg: folds
IDtNLR9uFCDdjNsJWMHA5Q: folds
a4JDWmpFQkL10XfAyuF51A: folds
5k9fvXD9suIgCxU4HLQjTw: folds
UrcnkQOiLVk8BlKDPJSy7Q: folds
aTkyjTh3w5YLWiIERupZOA: folds
bwv/rbH/hHhPhY6u9mu04w: folds
mSD1pginDsyHG5PDfqzphw collected $0.50 from pot
mSD1pginDsyHG5PDfqzphw: doesn't show hand
*** SUMMARY ***
Total pot $0.50 | Rake $0
Seat 1: 5k9fvXD9suIgCxU4HLQjTw folded before Flop (didn't bet)
Seat 2: UrcnkQOiLVk8BlKDPJSy7Q folded before Flop (didn't bet)
Seat 3: aTkyjTh3w5YLWiIERupZOA (button) folded before Flop (didn't bet)
Seat 4: bwv/rbH/hHhPhY6u9mu04w (small blind) folded before Flop
Seat 5: mSD1pginDsyHG5PDfqzphw (big blind) collected ($0.50)
Seat 6: +k7T5ocke8UwavtgUHm+Cg folded before Flop (didn't bet)
Seat 7: IDtNLR9uFCDdjNsJWMHA5Q folded before Flop (didn't bet)
Seat 8: a4JDWmpFQkL10XfAyuF51A folded before Flop (didn't bet)



PokerStars Game #59940281020:  Hold'em No Limit ($0.25/$0.50) - 2009/07/01 1:02:12 ET
Table 'ErOuyGLI5PT3G5MnpHgC/gQOgaEqMcJ73pcUMMxoisUg Seat #6 is the button
Seat 2: pciZn00ZDk4BVBMTTMcNVQ ($29.50 in chips)
Seat 3: xZCXQSXlrZkp3pZizzVXCw ($52.75 in chips)
Seat 4: 3UmXLy3GfjC3EkOebduerQ ($50 in chips)
Seat 5: JwvquocWfhTVApN5t47LgA ($62.60 in chips)
Seat 6: zE9cVigS2nW/Ljy4K4bUQA ($30.85 in chips)
Seat 7: 90Wb75h3W1BRpbqVnuk8gw ($63.85 in chips)
Seat 8: g4k0NXISyLCqaSWZDBjfEg ($50 in chips)
Seat 9: J0W5D97jl5VLky+IoPvDeA ($52.15 in chips)
90Wb75h3W1BRpbqVnuk8gw: posts small blind $0.25
g4k0NXISyLCqaSWZDBjfEg: posts big blind $0.50
*** HOLE CARDS ***
eBrej2jnlUCs/JgxFCRn2g has returned
J0W5D97jl5VLky+IoPvDeA: folds
pciZn00ZDk4BVBMTTMcNVQ: raises $1 to $1.50
xZCXQSXlrZkp3pZizzVXCw: folds
3UmXLy3GfjC3EkOebduerQ: folds
JwvquocWfhTVApN5t47LgA: folds
zE9cVigS2nW/Ljy4K4bUQA: folds
90Wb75h3W1BRpbqVnuk8gw: folds
g4k0NXISyLCqaSWZDBjfEg: folds
pciZn00ZDk4BVBMTTMcNVQ collected $1.25 from pot
*** SUMMARY ***
Total pot $1.25 | Rake $0
Seat 2: pciZn00ZDk4BVBMTTMcNVQ collected ($1.25)
Seat 3: xZCXQSXlrZkp3pZizzVXCw folded before Flop (didn't bet)
Seat 4: 3UmXLy3GfjC3EkOebduerQ folded before Flop (didn't bet)
Seat 5: JwvquocWfhTVApN5t47LgA folded before Flop (didn't bet)
Seat 6: zE9cVigS2nW/Ljy4K4bUQA (button) folded before Flop (didn't bet)
Seat 7: 90Wb75h3W1BRpbqVnuk8gw (small blind) folded before Flop
Seat 8: g4k0NXISyLCqaSWZDBjfEg (big blind) folded before Flop
Seat 9: J0W5D97jl5VLky+IoPvDeA folded before Flop (didn't bet)



PokerStars Game #59940283210:  Hold'em No Limit ($0.25/$0.50) - 2009/07/01 1:02:16 ET
Table '37qXEp3oe+er5q4CZip9eQ' 6-max Seat #2 is the button
Seat 1: oqOqoO2AyCZenUghCxMDxw ($50 in chips)
Seat 2: LvH4G7n+QSjT6NDaD3cREA ($55.80 in chips)
Seat 3: Rt6KgtZ8YaJoTc3FPim00w ($110.45 in chips)
Seat 4: XsmE8nXMAAMFJbWaJTmHFw ($40.60 in chips)
Seat 5: VOmI0x4dDPnTESZd5B4d1Q ($41.50 in chips)
Seat 6: N50kln4negd8q7Mmoz1j4g ($15.80 in chips)
Rt6KgtZ8YaJoTc3FPim00w: posts small blind $0.25
XsmE8nXMAAMFJbWaJTmHFw: posts big blind $0.50
*** HOLE CARDS ***
VOmI0x4dDPnTESZd5B4d1Q: raises $1.50 to $2
N50kln4negd8q7Mmoz1j4g: calls $2
oqOqoO2AyCZenUghCxMDxw: folds
XsmE8nXMAAMFJbWaJTmHFw said, "Very"
LvH4G7n+QSjT6NDaD3cREA: folds
Rt6KgtZ8YaJoTc3FPim00w: folds
XsmE8nXMAAMFJbWaJTmHFw: folds
*** FLOP *** [Js 6c Kd]
VOmI0x4dDPnTESZd5B4d1Q: checks
N50kln4negd8q7Mmoz1j4g: bets $2.50
VOmI0x4dDPnTESZd5B4d1Q said, "lol another good hand folded"
VOmI0x4dDPnTESZd5B4d1Q: folds
N50kln4negd8q7Mmoz1j4g collected $4.55 from pot
*** SUMMARY ***
Total pot $4.75 | Rake $0.20
Board [Js 6c Kd]
Seat 1: oqOqoO2AyCZenUghCxMDxw folded before Flop (didn't bet)
Seat 2: LvH4G7n+QSjT6NDaD3cREA (button) folded before Flop (didn't bet)
Seat 3: Rt6KgtZ8YaJoTc3FPim00w (small blind) folded before Flop
Seat 4: XsmE8nXMAAMFJbWaJTmHFw (big blind) folded before Flop
Seat 5: VOmI0x4dDPnTESZd5B4d1Q folded on the Flop
Seat 6: N50kln4negd8q7Mmoz1j4g collected ($4.55)



PokerStars Game #59940283630:  Hold'em No Limit ($0.25/$0.50) - 2009/07/01 1:02:17 ET
Table '8BQGgNetI1NOvWeu3gtMNw' 2-max Seat #1 is the button
Seat 1: bypIyrYcAAifLfhZpGlKLA ($53.50 in chips)
Seat 2: Z4HwehErEwzsv/noQlfUlg ($147.85 in chips)
bypIyrYcAAifLfhZpGlKLA: posts small blind $0.25
Z4HwehErEwzsv/noQlfUlg: posts big blind $0.50
*** HOLE CARDS ***
bypIyrYcAAifLfhZpGlKLA: raises $1 to $1.50
Z4HwehErEwzsv/noQlfUlg: calls $1
*** FLOP *** [2s Jh 9c]
Z4HwehErEwzsv/noQlfUlg: bets $1.50
bypIyrYcAAifLfhZpGlKLA: raises $5 to $6.50
Z4HwehErEwzsv/noQlfUlg: folds
bypIyrYcAAifLfhZpGlKLA collected $5.75 from pot
bypIyrYcAAifLfhZpGlKLA: doesn't show hand
*** SUMMARY ***
Total pot $6 | Rake $0.25
Board [2s Jh 9c]
Seat 1: bypIyrYcAAifLfhZpGlKLA (button) (small blind) collected ($5.75)
Seat 2: Z4HwehErEwzsv/noQlfUlg (big blind) folded on the Flop



PokerStars Game #59940284892:  Hold'em No Limit ($0.25/$0.50) - 2009/07/01 1:02:19 ET
Table '+dXkOAQyS8j9PQZusUTMpg' 2-max Seat #2 is the button
Seat 1: XFa6sBGjP2gxoIvxR3fZIg ($88.40 in chips)
Seat 2: 5IBeOgaApY1Bvzv2P8X4EA ($109.40 in chips)
5IBeOgaApY1Bvzv2P8X4EA: posts small blind $0.25
XFa6sBGjP2gxoIvxR3fZIg: posts big blind $0.50
*** HOLE CARDS ***
5IBeOgaApY1Bvzv2P8X4EA said, "jajaja"
5IBeOgaApY1Bvzv2P8X4EA said, "good"
5IBeOgaApY1Bvzv2P8X4EA said, "pay"
5IBeOgaApY1Bvzv2P8X4EA said, "call"
5IBeOgaApY1Bvzv2P8X4EA: folds
XFa6sBGjP2gxoIvxR3fZIg collected $0.50 from pot
*** SUMMARY ***
Total pot $0.50 | Rake $0
Seat 1: XFa6sBGjP2gxoIvxR3fZIg (big blind) collected ($0.50)
Seat 2: 5IBeOgaApY1Bvzv2P8X4EA (button) (small blind) folded before Flop



PokerStars Game #59940284702:  Hold'em No Limit ($0.25/$0.50) - 2009/07/01 1:02:19 ET
Table '/cQuAT3ef4t+PGrXiNhGaQ' 9-max Seat #9 is the button
Seat 1: HZkVla4kK2SI42CVrPZ/ig ($14.50 in chips)
Seat 2: jXGruyaMqirTaTXNOvBdew ($72.70 in chips)
Seat 3: g4k0NXISyLCqaSWZDBjfEg ($54.25 in chips)
Seat 4: OWP/DOu+PlPK6ZZ3zYa0HA ($30.60 in chips)
Seat 5: 5SgaHdWixdClWvaEG+KUjQ ($14.35 in chips)
Seat 6: APYIOyK/4AGb+kIwlOUNBQ ($36.50 in chips)
Seat 7: J0W5D97jl5VLky+IoPvDeA ($110.65 in chips)
Seat 8: eBrej2jnlUCs/JgxFCRn2g ($47.30 in chips)
Seat 9: AjV5McH1KMMclY26QdLM5w ($25.70 in chips)
HZkVla4kK2SI42CVrPZ/ig: posts small blind $0.25
jXGruyaMqirTaTXNOvBdew: posts big blind $0.50
*** HOLE CARDS ***
g4k0NXISyLCqaSWZDBjfEg: folds
OWP/DOu+PlPK6ZZ3zYa0HA: folds
5SgaHdWixdClWvaEG+KUjQ: folds
APYIOyK/4AGb+kIwlOUNBQ: folds
J0W5D97jl5VLky+IoPvDeA: calls $0.50
eBrej2jnlUCs/JgxFCRn2g: raises $1 to $1.50
AjV5McH1KMMclY26QdLM5w: folds
HZkVla4kK2SI42CVrPZ/ig: folds
jXGruyaMqirTaTXNOvBdew: calls $1
J0W5D97jl5VLky+IoPvDeA: calls $1
*** FLOP *** [8c Js 7c]
jXGruyaMqirTaTXNOvBdew: checks
J0W5D97jl5VLky+IoPvDeA: checks
eBrej2jnlUCs/JgxFCRn2g: checks
*** TURN *** [8c Js 7c] [4s]
jXGruyaMqirTaTXNOvBdew: bets $2
J0W5D97jl5VLky+IoPvDeA: calls $2
eBrej2jnlUCs/JgxFCRn2g: raises $2 to $4
jXGruyaMqirTaTXNOvBdew: calls $2
J0W5D97jl5VLky+IoPvDeA: raises $8 to $12
eBrej2jnlUCs/JgxFCRn2g: raises $8 to $20
jXGruyaMqirTaTXNOvBdew: folds
J0W5D97jl5VLky+IoPvDeA: raises $89.15 to $109.15 and is all-in
eBrej2jnlUCs/JgxFCRn2g: calls $25.80 and is all-in
*** RIVER *** [8c Js 7c 4s] [3d]
*** SHOW DOWN ***
J0W5D97jl5VLky+IoPvDeA: shows [Tc 9c] (a straight, Seven to Jack)
eBrej2jnlUCs/JgxFCRn2g: mucks hand
J0W5D97jl5VLky+IoPvDeA collected $97.35 from pot
*** SUMMARY ***
Total pot $100.35 | Rake $3
Board [8c Js 7c 4s 3d]
Seat 1: HZkVla4kK2SI42CVrPZ/ig (small blind) folded before Flop
Seat 2: jXGruyaMqirTaTXNOvBdew (big blind) folded on the Turn
Seat 3: g4k0NXISyLCqaSWZDBjfEg folded before Flop (didn't bet)
Seat 4: OWP/DOu+PlPK6ZZ3zYa0HA folded before Flop (didn't bet)
Seat 5: 5SgaHdWixdClWvaEG+KUjQ folded before Flop (didn't bet)
Seat 6: APYIOyK/4AGb+kIwlOUNBQ folded before Flop (didn't bet)
Seat 7: J0W5D97jl5VLky+IoPvDeA showed [Tc 9c] and won ($97.35) with a straight, Seven to Jack
Seat 8: eBrej2jnlUCs/JgxFCRn2g mucked
Seat 9: AjV5McH1KMMclY26QdLM5w (button) folded before Flop (didn't bet)



PokerStars Game #59940285646:  Hold'em No Limit ($0.25/$0.50) - 2009/07/01 1:02:20 ET
Table 'BCN5su+SsXiy1zRMJi0SJw' 6-max Seat #2 is the button
Seat 1: GxXV09ciXaOxyY2H5aMIIw ($31.65 in chips)
Seat 2: oU2kDCkT/gilYbHWrg7D8w ($43.60 in chips)
Seat 3: 6wzJiRvp8HY6t+MQGnSIzA ($19.30 in chips)
Seat 4: qfeUHOJpMYyzQcj0o2A7ng ($5.75 in chips)
Seat 5: IBNygaT1aa9Z1uPdJJilwA ($41 in chips)
Seat 6: b2symlOdL7+0c9Pj4N/KlA ($54.50 in chips)
6wzJiRvp8HY6t+MQGnSIzA: posts small blind $0.25
qfeUHOJpMYyzQcj0o2A7ng: posts big blind $0.50
*** HOLE CARDS ***
IBNygaT1aa9Z1uPdJJilwA: folds
b2symlOdL7+0c9Pj4N/KlA: folds
GxXV09ciXaOxyY2H5aMIIw: raises $1.50 to $2
oU2kDCkT/gilYbHWrg7D8w: folds
6wzJiRvp8HY6t+MQGnSIzA: calls $1.75
qfeUHOJpMYyzQcj0o2A7ng: raises $3.75 to $5.75 and is all-in
GxXV09ciXaOxyY2H5aMIIw: calls $3.75
6wzJiRvp8HY6t+MQGnSIzA: calls $3.75
*** FLOP *** [7s 7d 4s]
6wzJiRvp8HY6t+MQGnSIzA: checks
GxXV09ciXaOxyY2H5aMIIw: checks
*** TURN *** [7s 7d 4s] [Qh]
6wzJiRvp8HY6t+MQGnSIzA: checks
GxXV09ciXaOxyY2H5aMIIw: checks
*** RIVER *** [7s 7d 4s Qh] [Ah]
6wzJiRvp8HY6t+MQGnSIzA: checks
qfeUHOJpMYyzQcj0o2A7ng said, "**** this ****"
GxXV09ciXaOxyY2H5aMIIw: checks
*** SHOW DOWN ***
6wzJiRvp8HY6t+MQGnSIzA: shows [3c Tc] (a pair of Sevens)
qfeUHOJpMYyzQcj0o2A7ng: shows [Kh Kc] (two pair, Kings and Sevens)
GxXV09ciXaOxyY2H5aMIIw: shows [8c Ac] (two pair, Aces and Sevens)
GxXV09ciXaOxyY2H5aMIIw collected $16.40 from pot
*** SUMMARY ***
Total pot $17.25 | Rake $0.85
Board [7s 7d 4s Qh Ah]
Seat 1: GxXV09ciXaOxyY2H5aMIIw showed [8c Ac] and won ($16.40) with two pair, Aces and Sevens
Seat 2: oU2kDCkT/gilYbHWrg7D8w (button) folded before Flop (didn't bet)
Seat 3: 6wzJiRvp8HY6t+MQGnSIzA (small blind) showed [3c Tc] and lost with a pair of Sevens
Seat 4: qfeUHOJpMYyzQcj0o2A7ng (big blind) showed [Kh Kc] and lost with two pair, Kings and Sevens
Seat 5: IBNygaT1aa9Z1uPdJJilwA folded before Flop (didn't bet)
Seat 6: b2symlOdL7+0c9Pj4N/KlA folded before Flop (didn't bet)



PokerStars Game #59940286800:  Hold'em No Limit ($0.25/$0.50) - 2009/07/01 1:02:22 ET
Table 'c/CRn+68J3Y8KxD5g1ek2Q' 2-max Seat #1 is the button
Seat 1: 46qCyJ6evTkHo9al5sBMNA ($87.95 in chips)
Seat 2: BypVLsYQt3ePFm2xQL/dOA ($280.25 in chips)
46qCyJ6evTkHo9al5sBMNA: posts small blind $0.25
BypVLsYQt3ePFm2xQL/dOA: posts big blind $0.50
*** HOLE CARDS ***
46qCyJ6evTkHo9al5sBMNA: raises $1.50 to $2
BypVLsYQt3ePFm2xQL/dOA: folds
46qCyJ6evTkHo9al5sBMNA collected $1 from pot
46qCyJ6evTkHo9al5sBMNA: doesn't show hand
*** SUMMARY ***
Total pot $1 | Rake $0
Seat 1: 46qCyJ6evTkHo9al5sBMNA (button) (small blind) collected ($1)
Seat 2: BypVLsYQt3ePFm2xQL/dOA (big blind) folded before Flop



PokerStars Game #59940286942:  Hold'em No Limit ($0.25/$0.50) - 2009/07/01 1:02:23 ET
Table '+z1aekfHkpp09pc8F9aViw' 6-max Seat #6 is the button
Seat 1: FHilMb2i2DbUCc9lplszog ($26.35 in chips)
Seat 3: uUznlIMFnRUvwrBhYF73KA ($122.40 in chips)
Seat 4: RowCSpSURHTOL/dcjg/Iug ($39.55 in chips)
Seat 5: rplyldNweS6YyMNEALQrug ($54.90 in chips)
Seat 6: 686aeHikcJlgKkSuIFdcXQ ($50 in chips)
FHilMb2i2DbUCc9lplszog: posts small blind $0.25
M6xK/VklCvdyyrmvzATlxQ: is sitting out
uUznlIMFnRUvwrBhYF73KA: posts big blind $0.50
*** HOLE CARDS ***
RowCSpSURHTOL/dcjg/Iug: folds
rplyldNweS6YyMNEALQrug: calls $0.50
686aeHikcJlgKkSuIFdcXQ: folds
FHilMb2i2DbUCc9lplszog: raises $3 to $3.50
uUznlIMFnRUvwrBhYF73KA: calls $3
rplyldNweS6YyMNEALQrug: calls $3
*** FLOP *** [5h Jd Jc]
FHilMb2i2DbUCc9lplszog: checks
uUznlIMFnRUvwrBhYF73KA: bets $5
rplyldNweS6YyMNEALQrug: folds
FHilMb2i2DbUCc9lplszog: calls $5
*** TURN *** [5h Jd Jc] [Td]
FHilMb2i2DbUCc9lplszog: checks
M6xK/VklCvdyyrmvzATlxQ leaves the table
uUznlIMFnRUvwrBhYF73KA: bets $12.50
FHilMb2i2DbUCc9lplszog: folds
uUznlIMFnRUvwrBhYF73KA collected $19.50 from pot
*** SUMMARY ***
Total pot $20.50 | Rake $1
Board [5h Jd Jc Td]
Seat 1: FHilMb2i2DbUCc9lplszog (small blind) folded on the Turn
Seat 3: uUznlIMFnRUvwrBhYF73KA (big blind) collected ($19.50)
Seat 4: RowCSpSURHTOL/dcjg/Iug folded before Flop (didn't bet)
Seat 5: rplyldNweS6YyMNEALQrug folded on the Flop
Seat 6: 686aeHikcJlgKkSuIFdcXQ (button) folded before Flop (didn't bet)



PokerStars Game #59940288600:  Hold'em No Limit ($0.25/$0.50) - 2009/07/01 1:02:25 ET
Table 'kgbJRsxfv64KrErDRBAkcw' 6-max Seat #5 is the button
Seat 1: VamsyhlFzXGF6/ydo0BHeA ($43 in chips)
Seat 2: AdS8BJMOheS01zjCDfPMFg ($49.95 in chips)
Seat 3: c4MNIaIyPMOMxrgT8FT5nA ($134.50 in chips)
Seat 4: qanMEqjABjWxC/JgQ/0l7w ($56.50 in chips)
Seat 5: eUBBn2R56C1IQ6Cs/vitwg ($55.25 in chips)
Seat 6: 1b+2BbjMN8qhR1WPqdE9VQ ($52.65 in chips)
1b+2BbjMN8qhR1WPqdE9VQ: posts small blind $0.25
VamsyhlFzXGF6/ydo0BHeA: posts big blind $0.50
*** HOLE CARDS ***
AdS8BJMOheS01zjCDfPMFg: folds
c4MNIaIyPMOMxrgT8FT5nA: calls $0.50
qanMEqjABjWxC/JgQ/0l7w: folds
eUBBn2R56C1IQ6Cs/vitwg: folds
1b+2BbjMN8qhR1WPqdE9VQ: folds
VamsyhlFzXGF6/ydo0BHeA: checks
*** FLOP *** [8h As 8s]
VamsyhlFzXGF6/ydo0BHeA: checks
c4MNIaIyPMOMxrgT8FT5nA: bets $3
VamsyhlFzXGF6/ydo0BHeA: calls $3
*** TURN *** [8h As 8s] [8c]
VamsyhlFzXGF6/ydo0BHeA: checks
c4MNIaIyPMOMxrgT8FT5nA: bets $3.50
VamsyhlFzXGF6/ydo0BHeA: folds
c4MNIaIyPMOMxrgT8FT5nA collected $6.90 from pot
c4MNIaIyPMOMxrgT8FT5nA: doesn't show hand
*** SUMMARY ***
Total pot $7.25 | Rake $0.35
Board [8h As 8s 8c]
Seat 1: VamsyhlFzXGF6/ydo0BHeA (big blind) folded on the Turn
Seat 2: AdS8BJMOheS01zjCDfPMFg folded before Flop (didn't bet)
Seat 3: c4MNIaIyPMOMxrgT8FT5nA collected ($6.90)
Seat 4: qanMEqjABjWxC/JgQ/0l7w folded before Flop (didn't bet)
Seat 5: eUBBn2R56C1IQ6Cs/vitwg (button) folded before Flop (didn't bet)
Seat 6: 1b+2BbjMN8qhR1WPqdE9VQ (small blind) folded before Flop



PokerStars Game #59940288450:  Hold'em No Limit ($0.25/$0.50) - 2009/07/01 1:02:25 ET
Table 'MJxeZCzYELxiIsyUZyT0jw' 6-max Seat #4 is the button
Seat 1: +Pf9jTVizYlIo+woPvptfA ($50 in chips)
Seat 2: t3GiVMzqA9Svgr5Uol32cQ ($43.85 in chips)
Seat 3: JQZew0FjzS19kTjeNtrE+A ($60.40 in chips)
Seat 4: alGiiQP/wwtYnfuXII+sgw ($36.10 in chips)
Seat 5: 3jvoOXNtXE90w2BdfNZwZQ ($60.35 in chips)
Seat 6: c0n4hrn20AML9qzyFC2E8Q ($48.75 in chips)
3jvoOXNtXE90w2BdfNZwZQ: posts small blind $0.25
c0n4hrn20AML9qzyFC2E8Q: posts big blind $0.50
*** HOLE CARDS ***
+Pf9jTVizYlIo+woPvptfA: folds
t3GiVMzqA9Svgr5Uol32cQ: folds
JQZew0FjzS19kTjeNtrE+A: folds
alGiiQP/wwtYnfuXII+sgw: folds
3jvoOXNtXE90w2BdfNZwZQ: raises $1.50 to $2
c0n4hrn20AML9qzyFC2E8Q: folds
3jvoOXNtXE90w2BdfNZwZQ collected $1 from pot
3jvoOXNtXE90w2BdfNZwZQ: doesn't show hand
*** SUMMARY ***
Total pot $1 | Rake $0
Seat 1: +Pf9jTVizYlIo+woPvptfA folded before Flop (didn't bet)
Seat 2: t3GiVMzqA9Svgr5Uol32cQ folded before Flop (didn't bet)
Seat 3: JQZew0FjzS19kTjeNtrE+A folded before Flop (didn't bet)
Seat 4: alGiiQP/wwtYnfuXII+sgw (button) folded before Flop (didn't bet)
Seat 5: 3jvoOXNtXE90w2BdfNZwZQ (small blind) collected ($1)
Seat 6: c0n4hrn20AML9qzyFC2E8Q (big blind) folded before Flop



PokerStars Game #59940289386:  Hold'em No Limit ($0.25/$0.50) - 2009/07/01 1:02:27 ET
Table '0eJtgVAXVvBgncFdcUpXcQ' 2-max Seat #1 is the button
Seat 1: Ag6DvxX4vbRheqsv2zXKTQ ($31.60 in chips)
Seat 2: KMc4R+K9ao4Ur3rF7NGe6Q ($16.05 in chips)
Ag6DvxX4vbRheqsv2zXKTQ: posts small blind $0.25
KMc4R+K9ao4Ur3rF7NGe6Q: posts big blind $0.50
*** HOLE CARDS ***
Ag6DvxX4vbRheqsv2zXKTQ: calls $0.25
KMc4R+K9ao4Ur3rF7NGe6Q: checks
*** FLOP *** [5s 4d Qh]
KMc4R+K9ao4Ur3rF7NGe6Q: bets $1
Ag6DvxX4vbRheqsv2zXKTQ: folds
KMc4R+K9ao4Ur3rF7NGe6Q collected $0.95 from pot
KMc4R+K9ao4Ur3rF7NGe6Q: doesn't show hand
*** SUMMARY ***
Total pot $1 | Rake $0.05
Board [5s 4d Qh]
Seat 1: Ag6DvxX4vbRheqsv2zXKTQ (button) (small blind) folded on the Flop
Seat 2: KMc4R+K9ao4Ur3rF7NGe6Q (big blind) collected ($0.95)



PokerStars Game #59940289584:  Hold'em No Limit ($0.25/$0.50) - 2009/07/01 1:02:27 ET
Table 'lpxYasB1ClBSgTpCCITwhQ' 9-max Seat #4 is the button
Seat 1: mj7PS7wCH4PAl7+eYTFs7A ($44.30 in chips)
Seat 2: OWP/DOu+PlPK6ZZ3zYa0HA ($19.35 in chips)
Seat 3: IVoxShuYD5lqbK8F9+jVsg ($9 in chips)
Seat 4: NnQCepdIR/AOUQn1yhYx6Q ($8.50 in chips)
Seat 5: IYd5zG8k7vdBNVHbHg2Pag ($36.60 in chips)
Seat 6: SegjDnMxWMujiD57ESNL+g ($12.10 in chips)
Seat 7: bmRtaIYKthN1F+B3JLZ3Jw ($71.90 in chips)
Seat 8: /mfensKw8/iZ1Vrx33S4xg ($11.85 in chips)
Seat 9: sUIUZ+begh92dzkUmvbMrw ($9.90 in chips)
IYd5zG8k7vdBNVHbHg2Pag: posts small blind $0.25
SegjDnMxWMujiD57ESNL+g: posts big blind $0.50
*** HOLE CARDS ***
bmRtaIYKthN1F+B3JLZ3Jw: folds
/mfensKw8/iZ1Vrx33S4xg: folds
sUIUZ+begh92dzkUmvbMrw: folds
mj7PS7wCH4PAl7+eYTFs7A: folds
OWP/DOu+PlPK6ZZ3zYa0HA: calls $0.50
IVoxShuYD5lqbK8F9+jVsg: calls $0.50
NnQCepdIR/AOUQn1yhYx6Q: folds
IYd5zG8k7vdBNVHbHg2Pag: calls $0.25
SegjDnMxWMujiD57ESNL+g: checks
*** FLOP *** [5h Td Ac]
IYd5zG8k7vdBNVHbHg2Pag: checks
SegjDnMxWMujiD57ESNL+g: checks
OWP/DOu+PlPK6ZZ3zYa0HA: checks
IVoxShuYD5lqbK8F9+jVsg: checks
*** TURN *** [5h Td Ac] [Jd]
IYd5zG8k7vdBNVHbHg2Pag: checks
SegjDnMxWMujiD57ESNL+g: checks
OWP/DOu+PlPK6ZZ3zYa0HA: bets $1.50
IVoxShuYD5lqbK8F9+jVsg: calls $1.50
IYd5zG8k7vdBNVHbHg2Pag: folds
SegjDnMxWMujiD57ESNL+g: folds
*** RIVER *** [5h Td Ac Jd] [5d]
OWP/DOu+PlPK6ZZ3zYa0HA: bets $4
IVoxShuYD5lqbK8F9+jVsg: raises $3 to $7 and is all-in
OWP/DOu+PlPK6ZZ3zYa0HA: calls $3
*** SHOW DOWN ***
IVoxShuYD5lqbK8F9+jVsg: shows [7d Qd] (a flush, Queen high)
OWP/DOu+PlPK6ZZ3zYa0HA: shows [Th Tc] (a full house, Tens full of Fives)
OWP/DOu+PlPK6ZZ3zYa0HA collected $18.10 from pot
*** SUMMARY ***
Total pot $19 | Rake $0.90
Board [5h Td Ac Jd 5d]
Seat 1: mj7PS7wCH4PAl7+eYTFs7A folded before Flop (didn't bet)
Seat 2: OWP/DOu+PlPK6ZZ3zYa0HA showed [Th Tc] and won ($18.10) with a full house, Tens full of Fives
Seat 3: IVoxShuYD5lqbK8F9+jVsg showed [7d Qd] and lost with a flush, Queen high
Seat 4: NnQCepdIR/AOUQn1yhYx6Q (button) folded before Flop (didn't bet)
Seat 5: IYd5zG8k7vdBNVHbHg2Pag (small blind) folded on the Turn
Seat 6: SegjDnMxWMujiD57ESNL+g (big blind) folded on the Turn
Seat 7: bmRtaIYKthN1F+B3JLZ3Jw folded before Flop (didn't bet)
Seat 8: /mfensKw8/iZ1Vrx33S4xg folded before Flop (didn't bet)
Seat 9: sUIUZ+begh92dzkUmvbMrw folded before Flop (didn't bet)



PokerStars Game #59940289846:  Hold'em No Limit ($0.25/$0.50) - 2009/07/01 1:02:28 ET
Table 'ZYI3ZReBjdfKEYItkZHI6A' 9-max Seat #5 is the button
Seat 1: E2518gp4aFz1+kAgmGqeEg ($11.85 in chips)
Seat 2: 8zdVaT8pZ/Wm0uWoeLhtZg ($6.75 in chips)
Seat 3: bkXkL3pmapikPQQRNPZSEA ($19.75 in chips)
Seat 4: e2+sK/yjnj94rXOKoxPP2A ($50 in chips)
Seat 5: ApHP7ouup365XIUFBdEDxg ($49.90 in chips)
Seat 6: Wj7mKnRFR90j40wWUu2+Og ($28.50 in chips)
Seat 7: HWcfp1hY1hqvrddzW3/FQw ($17.50 in chips)
Seat 8: ji04uOybxCdpdefzlUQeKQ ($29.25 in chips)
Seat 9: tLkxo7JgV+WWI0UBw44K5A ($51.60 in chips)
Wj7mKnRFR90j40wWUu2+Og: posts small blind $0.25
HWcfp1hY1hqvrddzW3/FQw: posts big blind $0.50
*** HOLE CARDS ***
ji04uOybxCdpdefzlUQeKQ: folds
tLkxo7JgV+WWI0UBw44K5A: folds
E2518gp4aFz1+kAgmGqeEg: folds
8zdVaT8pZ/Wm0uWoeLhtZg: raises $1 to $1.50
bkXkL3pmapikPQQRNPZSEA: folds
e2+sK/yjnj94rXOKoxPP2A: folds
ApHP7ouup365XIUFBdEDxg: folds
Wj7mKnRFR90j40wWUu2+Og: folds
HWcfp1hY1hqvrddzW3/FQw: folds
8zdVaT8pZ/Wm0uWoeLhtZg collected $1.25 from pot
*** SUMMARY ***
Total pot $1.25 | Rake $0
Seat 1: E2518gp4aFz1+kAgmGqeEg folded before Flop (didn't bet)
Seat 2: 8zdVaT8pZ/Wm0uWoeLhtZg collected ($1.25)
Seat 3: bkXkL3pmapikPQQRNPZSEA folded before Flop (didn't bet)
Seat 4: e2+sK/yjnj94rXOKoxPP2A folded before Flop (didn't bet)
Seat 5: ApHP7ouup365XIUFBdEDxg (button) folded before Flop (didn't bet)
Seat 6: Wj7mKnRFR90j40wWUu2+Og (small blind) folded before Flop
Seat 7: HWcfp1hY1hqvrddzW3/FQw (big blind) folded before Flop
Seat 8: ji04uOybxCdpdefzlUQeKQ folded before Flop (didn't bet)
Seat 9: tLkxo7JgV+WWI0UBw44K5A folded before Flop (didn't bet)



PokerStars Game #59940289812:  Hold'em No Limit ($0.25/$0.50) - 2009/07/01 1:02:28 ET
Table 'lSisgp6H7Fg1hH5VfjEjYQ' 9-max Seat #4 is the button
Seat 1: 5k9fvXD9suIgCxU4HLQjTw ($50 in chips)
Seat 2: UrcnkQOiLVk8BlKDPJSy7Q ($75.85 in chips)
Seat 3: aTkyjTh3w5YLWiIERupZOA ($51.90 in chips)
Seat 4: bwv/rbH/hHhPhY6u9mu04w ($30.85 in chips)
Seat 5: mSD1pginDsyHG5PDfqzphw ($10.25 in chips)
Seat 6: +k7T5ocke8UwavtgUHm+Cg ($67.80 in chips)
Seat 7: IDtNLR9uFCDdjNsJWMHA5Q ($21.70 in chips)
Seat 8: a4JDWmpFQkL10XfAyuF51A ($27.75 in chips)
mSD1pginDsyHG5PDfqzphw: posts small blind $0.25
+k7T5ocke8UwavtgUHm+Cg: posts big blind $0.50
tkflckdgk: sits out
*** HOLE CARDS ***
IDtNLR9uFCDdjNsJWMHA5Q: calls $0.50
a4JDWmpFQkL10XfAyuF51A: folds
5k9fvXD9suIgCxU4HLQjTw: folds
UrcnkQOiLVk8BlKDPJSy7Q: folds
aTkyjTh3w5YLWiIERupZOA: calls $0.50
bwv/rbH/hHhPhY6u9mu04w: calls $0.50
mSD1pginDsyHG5PDfqzphw: folds
+k7T5ocke8UwavtgUHm+Cg: checks
*** FLOP *** [6h Ah Ts]
+k7T5ocke8UwavtgUHm+Cg: checks
IDtNLR9uFCDdjNsJWMHA5Q: bets $1.50
aTkyjTh3w5YLWiIERupZOA: folds
bwv/rbH/hHhPhY6u9mu04w: folds
+k7T5ocke8UwavtgUHm+Cg: folds
IDtNLR9uFCDdjNsJWMHA5Q collected $2.15 from pot
IDtNLR9uFCDdjNsJWMHA5Q: doesn't show hand
*** SUMMARY ***
Total pot $2.25 | Rake $0.10
Board [6h Ah Ts]
Seat 1: 5k9fvXD9suIgCxU4HLQjTw folded before Flop (didn't bet)
Seat 2: UrcnkQOiLVk8BlKDPJSy7Q folded before Flop (didn't bet)
Seat 3: aTkyjTh3w5YLWiIERupZOA folded on the Flop
Seat 4: bwv/rbH/hHhPhY6u9mu04w (button) folded on the Flop
Seat 5: mSD1pginDsyHG5PDfqzphw (small blind) folded before Flop
Seat 6: +k7T5ocke8UwavtgUHm+Cg (big blind) folded on the Flop
Seat 7: IDtNLR9uFCDdjNsJWMHA5Q collected ($2.15)
Seat 8: a4JDWmpFQkL10XfAyuF51A folded before Flop (didn't bet)



PokerStars Game #59940290874:  Hold'em No Limit ($0.25/$0.50) - 2009/07/01 1:02:29 ET
Table 'Nz0Vr7WMHL2g5Uk7dDZjpw' 9-max Seat #2 is the button
Seat 1: tLkxo7JgV+WWI0UBw44K5A ($109.85 in chips)
Seat 2: gsyXT42WLEcOS4DdEk2wlw ($29.25 in chips)
Seat 4: E2518gp4aFz1+kAgmGqeEg ($11 in chips)
Seat 5: WGW0DgjBUXs1ylURHG8vnQ ($27.90 in chips)
Seat 6: 997ViqAtWn1FPjJqcffwcA ($60.55 in chips)
Seat 7: KPLH0gELgFe2OuAnhJFI5w ($15.35 in chips)
Seat 8: HkZI6g4zl83TDTA7SRspmQ ($28.40 in chips)
Seat 9: mSD1pginDsyHG5PDfqzphw ($10 in chips)
E2518gp4aFz1+kAgmGqeEg: posts small blind $0.25
WGW0DgjBUXs1ylURHG8vnQ: posts big blind $0.50
*** HOLE CARDS ***
997ViqAtWn1FPjJqcffwcA: folds
KPLH0gELgFe2OuAnhJFI5w: calls $0.50
HkZI6g4zl83TDTA7SRspmQ: folds
mSD1pginDsyHG5PDfqzphw: folds
tLkxo7JgV+WWI0UBw44K5A: folds
gsyXT42WLEcOS4DdEk2wlw: folds
E2518gp4aFz1+kAgmGqeEg: calls $0.25
WGW0DgjBUXs1ylURHG8vnQ: checks
*** FLOP *** [8s Ts 6h]
E2518gp4aFz1+kAgmGqeEg: bets $1.50
WGW0DgjBUXs1ylURHG8vnQ: calls $1.50
KPLH0gELgFe2OuAnhJFI5w: folds
*** TURN *** [8s Ts 6h] [8d]
E2518gp4aFz1+kAgmGqeEg: bets $9 and is all-in
WGW0DgjBUXs1ylURHG8vnQ: folds
E2518gp4aFz1+kAgmGqeEg collected $4.30 from pot
E2518gp4aFz1+kAgmGqeEg: doesn't show hand
*** SUMMARY ***
Total pot $4.50 | Rake $0.20
Board [8s Ts 6h 8d]
Seat 1: tLkxo7JgV+WWI0UBw44K5A folded before Flop (didn't bet)
Seat 2: gsyXT42WLEcOS4DdEk2wlw (button) folded before Flop (didn't bet)
Seat 4: E2518gp4aFz1+kAgmGqeEg (small blind) collected ($4.30)
Seat 5: WGW0DgjBUXs1ylURHG8vnQ (big blind) folded on the Turn
Seat 6: 997ViqAtWn1FPjJqcffwcA folded before Flop (didn't bet)
Seat 7: KPLH0gELgFe2OuAnhJFI5w folded on the Flop
Seat 8: HkZI6g4zl83TDTA7SRspmQ folded before Flop (didn't bet)
Seat 9: mSD1pginDsyHG5PDfqzphw folded before Flop (didn't bet)



PokerStars Game #59940292088:  Hold'em No Limit ($0.25/$0.50) - 2009/07/01 1:02:31 ET
Table 'E7bWJ45aoFXRpyRv2gw+Ig' 2-max Seat #1 is the button
Seat 1: FRkiRasEGlHUeLrEl+k/nA ($58.15 in chips)
Seat 2: 3Wro85I7472vJ4Wkpneo9A ($130.45 in chips)
FRkiRasEGlHUeLrEl+k/nA: posts small blind $0.25
3Wro85I7472vJ4Wkpneo9A: posts big blind $0.50
*** HOLE CARDS ***
FRkiRasEGlHUeLrEl+k/nA: raises $1 to $1.50
3Wro85I7472vJ4Wkpneo9A: calls $1
*** FLOP *** [Jc 5d 7h]
3Wro85I7472vJ4Wkpneo9A: checks
FRkiRasEGlHUeLrEl+k/nA: checks
*** TURN *** [Jc 5d 7h] [9c]
3Wro85I7472vJ4Wkpneo9A: checks
FRkiRasEGlHUeLrEl+k/nA: checks
*** RIVER *** [Jc 5d 7h 9c] [Qh]
3Wro85I7472vJ4Wkpneo9A: checks
FRkiRasEGlHUeLrEl+k/nA: checks
*** SHOW DOWN ***
3Wro85I7472vJ4Wkpneo9A: shows [2s Ah] (high card Ace)
FRkiRasEGlHUeLrEl+k/nA: shows [Ac 2h] (high card Ace)
3Wro85I7472vJ4Wkpneo9A collected $1.45 from pot
FRkiRasEGlHUeLrEl+k/nA collected $1.40 from pot
*** SUMMARY ***
Total pot $3 | Rake $0.15
Board [Jc 5d 7h 9c Qh]
Seat 1: FRkiRasEGlHUeLrEl+k/nA (button) (small blind) showed [Ac 2h] and won ($1.40) with high card Ace
Seat 2: 3Wro85I7472vJ4Wkpneo9A (big blind) showed [2s Ah] and won ($1.45) with high card Ace



PokerStars Game #59940291716:  Hold'em No Limit ($0.25/$0.50) - 2009/07/01 1:02:31 ET
Table '5EmHi+fnatGQQShcNmzOZQ' 6-max Seat #4 is the button
Seat 1: My8WkRtGx5FW6rJ1I4R3hg ($19.95 in chips)
Seat 2: bfFjgAtIoAI+pUxUwFt3aQ ($49 in chips)
Seat 3: TjmTe3bhs9dFz5gXX9x7Lw ($12.05 in chips)
Seat 4: 1b+2BbjMN8qhR1WPqdE9VQ ($65.80 in chips)
Seat 5: kxPhs4ePFqMy52CInAJ2aw ($82.30 in chips)
Seat 6: 686aeHikcJlgKkSuIFdcXQ ($131.75 in chips)
kxPhs4ePFqMy52CInAJ2aw: posts small blind $0.25
686aeHikcJlgKkSuIFdcXQ: posts big blind $0.50
*** HOLE CARDS ***
My8WkRtGx5FW6rJ1I4R3hg: folds
bfFjgAtIoAI+pUxUwFt3aQ: folds
TjmTe3bhs9dFz5gXX9x7Lw: folds
1b+2BbjMN8qhR1WPqdE9VQ: raises $1 to $1.50
kxPhs4ePFqMy52CInAJ2aw: folds
686aeHikcJlgKkSuIFdcXQ: folds
1b+2BbjMN8qhR1WPqdE9VQ collected $1.25 from pot
1b+2BbjMN8qhR1WPqdE9VQ: doesn't show hand
*** SUMMARY ***
Total pot $1.25 | Rake $0
Seat 1: My8WkRtGx5FW6rJ1I4R3hg folded before Flop (didn't bet)
Seat 2: bfFjgAtIoAI+pUxUwFt3aQ folded before Flop (didn't bet)
Seat 3: TjmTe3bhs9dFz5gXX9x7Lw folded before Flop (didn't bet)
Seat 4: 1b+2BbjMN8qhR1WPqdE9VQ (button) collected ($1.25)
Seat 5: kxPhs4ePFqMy52CInAJ2aw (small blind) folded before Flop
Seat 6: 686aeHikcJlgKkSuIFdcXQ (big blind) folded before Flop



PokerStars Game #59940292590:  Hold'em No Limit ($0.25/$0.50) - 2009/07/01 1:02:32 ET
Table '+dXkOAQyS8j9PQZusUTMpg' 2-max Seat #1 is the button
Seat 1: XFa6sBGjP2gxoIvxR3fZIg ($88.65 in chips)
Seat 2: 5IBeOgaApY1Bvzv2P8X4EA ($109.15 in chips)
XFa6sBGjP2gxoIvxR3fZIg: posts small blind $0.25
5IBeOgaApY1Bvzv2P8X4EA: posts big blind $0.50
*** HOLE CARDS ***
XFa6sBGjP2gxoIvxR3fZIg said, "had to pay, but a nice bet"
XFa6sBGjP2gxoIvxR3fZIg: raises $1 to $1.50
5IBeOgaApY1Bvzv2P8X4EA: calls $1
*** FLOP *** [Qd 2d Ks]
5IBeOgaApY1Bvzv2P8X4EA: checks
XFa6sBGjP2gxoIvxR3fZIg: bets $2
5IBeOgaApY1Bvzv2P8X4EA: calls $2
*** TURN *** [Qd 2d Ks] [4d]
5IBeOgaApY1Bvzv2P8X4EA: checks
XFa6sBGjP2gxoIvxR3fZIg: bets $5.50
5IBeOgaApY1Bvzv2P8X4EA: calls $5.50
*** RIVER *** [Qd 2d Ks 4d] [5h]
5IBeOgaApY1Bvzv2P8X4EA: checks
XFa6sBGjP2gxoIvxR3fZIg: bets $16
5IBeOgaApY1Bvzv2P8X4EA said, "flush"
5IBeOgaApY1Bvzv2P8X4EA said, "?"
5IBeOgaApY1Bvzv2P8X4EA said, "..."
XFa6sBGjP2gxoIvxR3fZIg said, "two cards"
5IBeOgaApY1Bvzv2P8X4EA said, "ka?"
5IBeOgaApY1Bvzv2P8X4EA said, "me to i want to see"
5IBeOgaApY1Bvzv2P8X4EA: calls $16
*** SHOW DOWN ***
XFa6sBGjP2gxoIvxR3fZIg: shows [3d Kd] (a flush, King high)
5IBeOgaApY1Bvzv2P8X4EA: mucks hand
XFa6sBGjP2gxoIvxR3fZIg collected $49.50 from pot
5IBeOgaApY1Bvzv2P8X4EA said, ":S"
*** SUMMARY ***
Total pot $50 | Rake $0.50
Board [Qd 2d Ks 4d 5h]
Seat 1: XFa6sBGjP2gxoIvxR3fZIg (button) (small blind) showed [3d Kd] and won ($49.50) with a flush, King high
Seat 2: 5IBeOgaApY1Bvzv2P8X4EA (big blind) mucked



PokerStars Game #59940292922:  Hold'em No Limit ($0.25/$0.50) - 2009/07/01 1:02:33 ET
Table 'c/CRn+68J3Y8KxD5g1ek2Q' 2-max Seat #2 is the button
Seat 1: 46qCyJ6evTkHo9al5sBMNA ($88.45 in chips)
Seat 2: BypVLsYQt3ePFm2xQL/dOA ($279.75 in chips)
BypVLsYQt3ePFm2xQL/dOA: posts small blind $0.25
46qCyJ6evTkHo9al5sBMNA: posts big blind $0.50
*** HOLE CARDS ***
BypVLsYQt3ePFm2xQL/dOA: calls $0.25
46qCyJ6evTkHo9al5sBMNA: raises $1.50 to $2
BypVLsYQt3ePFm2xQL/dOA: calls $1.50
*** FLOP *** [Kh Td 7s]
46qCyJ6evTkHo9al5sBMNA: bets $2
BypVLsYQt3ePFm2xQL/dOA: calls $2
*** TURN *** [Kh Td 7s] [7h]
46qCyJ6evTkHo9al5sBMNA: bets $4
BypVLsYQt3ePFm2xQL/dOA: calls $4
*** RIVER *** [Kh Td 7s 7h] [2d]
46qCyJ6evTkHo9al5sBMNA: checks
BypVLsYQt3ePFm2xQL/dOA: checks
*** SHOW DOWN ***
46qCyJ6evTkHo9al5sBMNA: shows [Qd Th] (two pair, Tens and Sevens)
BypVLsYQt3ePFm2xQL/dOA: mucks hand
46qCyJ6evTkHo9al5sBMNA collected $15.50 from pot
*** SUMMARY ***
Total pot $16 | Rake $0.50
Board [Kh Td 7s 7h 2d]
Seat 1: 46qCyJ6evTkHo9al5sBMNA (big blind) showed [Qd Th] and won ($15.50) with two pair, Tens and Sevens
Seat 2: BypVLsYQt3ePFm2xQL/dOA (button) (small blind) mucked



PokerStars Game #59940293934:  Hold'em No Limit ($0.25/$0.50) - 2009/07/01 1:02:34 ET
Table 'EiNh8p/wGJ1FP575iMFnqg' 9-max Seat #3 is the button
Seat 1: r3ZqM1Mi0W3y4hOdssE+Sg ($44.85 in chips)
Seat 2: 8ehL7qlZzjgUh2H35iiWLw ($51.85 in chips)
Seat 3: ymLPoEIl7UL3TvZYmnadxQ ($50.80 in chips)
Seat 4: cMzaiXAM/ZAdNaEUu+LqhA ($55.20 in chips)
Seat 5: M+7+BTmX5vZatHVuoRB1nA ($82.95 in chips)
Seat 6: 3UmXLy3GfjC3EkOebduerQ ($64.10 in chips)
Seat 7: 997ViqAtWn1FPjJqcffwcA ($50 in chips)
Seat 8: mSD1pginDsyHG5PDfqzphw ($11.60 in chips)
Seat 9: NnQCepdIR/AOUQn1yhYx6Q ($11.75 in chips)
cMzaiXAM/ZAdNaEUu+LqhA: posts small blind $0.25
M+7+BTmX5vZatHVuoRB1nA: posts big blind $0.50
*** HOLE CARDS ***
3UmXLy3GfjC3EkOebduerQ: folds
997ViqAtWn1FPjJqcffwcA: folds
mSD1pginDsyHG5PDfqzphw: folds
NnQCepdIR/AOUQn1yhYx6Q: folds
r3ZqM1Mi0W3y4hOdssE+Sg: folds
8ehL7qlZzjgUh2H35iiWLw: folds
ymLPoEIl7UL3TvZYmnadxQ: raises $0.50 to $1
cMzaiXAM/ZAdNaEUu+LqhA: folds
M+7+BTmX5vZatHVuoRB1nA: folds
ymLPoEIl7UL3TvZYmnadxQ collected $1.25 from pot
ymLPoEIl7UL3TvZYmnadxQ: doesn't show hand
*** SUMMARY ***
Total pot $1.25 | Rake $0
Seat 1: r3ZqM1Mi0W3y4hOdssE+Sg folded before Flop (didn't bet)
Seat 2: 8ehL7qlZzjgUh2H35iiWLw folded before Flop (didn't bet)
Seat 3: ymLPoEIl7UL3TvZYmnadxQ (button) collected ($1.25)
Seat 4: cMzaiXAM/ZAdNaEUu+LqhA (small blind) folded before Flop
Seat 5: M+7+BTmX5vZatHVuoRB1nA (big blind) folded before Flop
Seat 6: 3UmXLy3GfjC3EkOebduerQ folded before Flop (didn't bet)
Seat 7: 997ViqAtWn1FPjJqcffwcA folded before Flop (didn't bet)
Seat 8: mSD1pginDsyHG5PDfqzphw folded before Flop (didn't bet)
Seat 9: NnQCepdIR/AOUQn1yhYx6Q folded before Flop (didn't bet)



PokerStars Game #59940294324:  Hold'em No Limit ($0.25/$0.50) - 2009/07/01 1:02:35 ET
Table 'X6IRCRTh+20gjz8aubWnwA' 9-max Seat #8 is the button
Seat 1: DSM67hHHq1XFoEOi9p8Alw ($49.05 in chips)
Seat 2: HZkVla4kK2SI42CVrPZ/ig ($7.55 in chips)
Seat 3: SWv01peOe69QQRvhQTqjQw ($9.25 in chips)
Seat 4: M3JFBNQ8Bbw3FBZ/18MuXw ($26.60 in chips)
Seat 5: NnQCepdIR/AOUQn1yhYx6Q ($10 in chips)
Seat 6: 75K2MXwN65Sjfp1yHd50Hg ($10 in chips)
Seat 7: cFHQjKQOOKTUzoilhrXHLg ($40.75 in chips)
Seat 8: HxeBVq06/3Bh/H986sgdbw ($23.25 in chips)
Seat 9: M+7+BTmX5vZatHVuoRB1nA ($46.25 in chips)
M+7+BTmX5vZatHVuoRB1nA: posts small blind $0.25
DSM67hHHq1XFoEOi9p8Alw: posts big blind $0.50
*** HOLE CARDS ***
HZkVla4kK2SI42CVrPZ/ig: folds
SWv01peOe69QQRvhQTqjQw: folds
M3JFBNQ8Bbw3FBZ/18MuXw: folds
NnQCepdIR/AOUQn1yhYx6Q: folds
75K2MXwN65Sjfp1yHd50Hg: folds
cFHQjKQOOKTUzoilhrXHLg: calls $0.50
HxeBVq06/3Bh/H986sgdbw: raises $1.50 to $2
M+7+BTmX5vZatHVuoRB1nA: calls $1.75
DSM67hHHq1XFoEOi9p8Alw: calls $1.50
cFHQjKQOOKTUzoilhrXHLg: calls $1.50
*** FLOP *** [8h Kc Jh]
M+7+BTmX5vZatHVuoRB1nA: checks
DSM67hHHq1XFoEOi9p8Alw: checks
cFHQjKQOOKTUzoilhrXHLg: checks
HxeBVq06/3Bh/H986sgdbw: bets $5
M+7+BTmX5vZatHVuoRB1nA: folds
DSM67hHHq1XFoEOi9p8Alw: folds
cFHQjKQOOKTUzoilhrXHLg: calls $5
*** TURN *** [8h Kc Jh] [2s]
cFHQjKQOOKTUzoilhrXHLg: checks
HxeBVq06/3Bh/H986sgdbw: bets $16.25 and is all-in
cFHQjKQOOKTUzoilhrXHLg: calls $16.25
*** RIVER *** [8h Kc Jh 2s] [5s]
*** SHOW DOWN ***
cFHQjKQOOKTUzoilhrXHLg: shows [Jd Td] (a pair of Jacks)
HxeBVq06/3Bh/H986sgdbw: shows [Kd Qd] (a pair of Kings)
HxeBVq06/3Bh/H986sgdbw collected $48.05 from pot
*** SUMMARY ***
Total pot $50.50 | Rake $2.45
Board [8h Kc Jh 2s 5s]
Seat 1: DSM67hHHq1XFoEOi9p8Alw (big blind) folded on the Flop
Seat 2: HZkVla4kK2SI42CVrPZ/ig folded before Flop (didn't bet)
Seat 3: SWv01peOe69QQRvhQTqjQw folded before Flop (didn't bet)
Seat 4: M3JFBNQ8Bbw3FBZ/18MuXw folded before Flop (didn't bet)
Seat 5: NnQCepdIR/AOUQn1yhYx6Q folded before Flop (didn't bet)
Seat 6: 75K2MXwN65Sjfp1yHd50Hg folded before Flop (didn't bet)
Seat 7: cFHQjKQOOKTUzoilhrXHLg showed [Jd Td] and lost with a pair of Jacks
Seat 8: HxeBVq06/3Bh/H986sgdbw (button) showed [Kd Qd] and won ($48.05) with a pair of Kings
Seat 9: M+7+BTmX5vZatHVuoRB1nA (small blind) folded on the Flop



PokerStars Game #59940297552:  Hold'em No Limit ($0.25/$0.50) - 2009/07/01 1:02:40 ET
Table '8BQGgNetI1NOvWeu3gtMNw' 2-max Seat #2 is the button
Seat 1: bypIyrYcAAifLfhZpGlKLA ($56.25 in chips)
Seat 2: Z4HwehErEwzsv/noQlfUlg ($144.85 in chips)
Z4HwehErEwzsv/noQlfUlg: posts small blind $0.25
bypIyrYcAAifLfhZpGlKLA: posts big blind $0.50
*** HOLE CARDS ***
Z4HwehErEwzsv/noQlfUlg: folds
bypIyrYcAAifLfhZpGlKLA collected $0.50 from pot
bypIyrYcAAifLfhZpGlKLA: doesn't show hand
*** SUMMARY ***
Total pot $0.50 | Rake $0
Seat 1: bypIyrYcAAifLfhZpGlKLA (big blind) collected ($0.50)
Seat 2: Z4HwehErEwzsv/noQlfUlg (button) (small blind) folded before Flop



PokerStars Game #59940298220:  Hold'em No Limit ($0.25/$0.50) - 2009/07/01 1:02:41 ET
Table 'ErOuyGLI5PT3G5MnpHgC/gQOgaEqMcJ73pcUMMxoisUg Seat #7 is the button
Seat 1: eBrej2jnlUCs/JgxFCRn2g ($40.75 in chips)
Seat 2: pciZn00ZDk4BVBMTTMcNVQ ($30.25 in chips)
Seat 3: xZCXQSXlrZkp3pZizzVXCw ($52.75 in chips)
Seat 4: 3UmXLy3GfjC3EkOebduerQ ($50 in chips)
Seat 5: JwvquocWfhTVApN5t47LgA ($62.60 in chips)
Seat 6: zE9cVigS2nW/Ljy4K4bUQA ($30.85 in chips)
Seat 7: 90Wb75h3W1BRpbqVnuk8gw ($63.60 in chips)
Seat 8: g4k0NXISyLCqaSWZDBjfEg ($50 in chips)
Seat 9: J0W5D97jl5VLky+IoPvDeA ($52.15 in chips)
g4k0NXISyLCqaSWZDBjfEg: posts small blind $0.25
J0W5D97jl5VLky+IoPvDeA: posts big blind $0.50
*** HOLE CARDS ***
eBrej2jnlUCs/JgxFCRn2g: folds
pciZn00ZDk4BVBMTTMcNVQ: folds
xZCXQSXlrZkp3pZizzVXCw: folds
3UmXLy3GfjC3EkOebduerQ: folds
JwvquocWfhTVApN5t47LgA: folds
zE9cVigS2nW/Ljy4K4bUQA: raises $1 to $1.50
90Wb75h3W1BRpbqVnuk8gw: folds
g4k0NXISyLCqaSWZDBjfEg: folds
J0W5D97jl5VLky+IoPvDeA: folds
zE9cVigS2nW/Ljy4K4bUQA collected $1.25 from pot
*** SUMMARY ***
Total pot $1.25 | Rake $0
Seat 1: eBrej2jnlUCs/JgxFCRn2g folded before Flop (didn't bet)
Seat 2: pciZn00ZDk4BVBMTTMcNVQ folded before Flop (didn't bet)
Seat 3: xZCXQSXlrZkp3pZizzVXCw folded before Flop (didn't bet)
Seat 4: 3UmXLy3GfjC3EkOebduerQ folded before Flop (didn't bet)
Seat 5: JwvquocWfhTVApN5t47LgA folded before Flop (didn't bet)
Seat 6: zE9cVigS2nW/Ljy4K4bUQA collected ($1.25)
Seat 7: 90Wb75h3W1BRpbqVnuk8gw (button) folded before Flop (didn't bet)
Seat 8: g4k0NXISyLCqaSWZDBjfEg (small blind) folded before Flop
Seat 9: J0W5D97jl5VLky+IoPvDeA (big blind) folded before Flop



PokerStars Game #59940301388:  Hold'em No Limit ($0.25/$0.50) - 2009/07/01 1:02:47 ET
Table 'ZYI3ZReBjdfKEYItkZHI6A' 9-max Seat #6 is the button
Seat 1: E2518gp4aFz1+kAgmGqeEg ($11.85 in chips)
Seat 2: 8zdVaT8pZ/Wm0uWoeLhtZg ($7.50 in chips)
Seat 3: bkXkL3pmapikPQQRNPZSEA ($19.75 in chips)
Seat 4: e2+sK/yjnj94rXOKoxPP2A ($50 in chips)
Seat 5: ApHP7ouup365XIUFBdEDxg ($49.90 in chips)
Seat 6: Wj7mKnRFR90j40wWUu2+Og ($28.25 in chips)
Seat 7: HWcfp1hY1hqvrddzW3/FQw ($17 in chips)
Seat 8: ji04uOybxCdpdefzlUQeKQ ($29.25 in chips)
Seat 9: tLkxo7JgV+WWI0UBw44K5A ($51.60 in chips)
HWcfp1hY1hqvrddzW3/FQw: posts small blind $0.25
ji04uOybxCdpdefzlUQeKQ: posts big blind $0.50
*** HOLE CARDS ***
tLkxo7JgV+WWI0UBw44K5A: folds
E2518gp4aFz1+kAgmGqeEg: calls $0.50
8zdVaT8pZ/Wm0uWoeLhtZg: folds
bkXkL3pmapikPQQRNPZSEA: raises $0.50 to $1
e2+sK/yjnj94rXOKoxPP2A: folds
ApHP7ouup365XIUFBdEDxg: folds
Wj7mKnRFR90j40wWUu2+Og: folds
HWcfp1hY1hqvrddzW3/FQw: calls $0.75
ji04uOybxCdpdefzlUQeKQ: calls $0.50
E2518gp4aFz1+kAgmGqeEg: raises $10.85 to $11.85 and is all-in
bkXkL3pmapikPQQRNPZSEA: folds
HWcfp1hY1hqvrddzW3/FQw: folds
ji04uOybxCdpdefzlUQeKQ: folds
E2518gp4aFz1+kAgmGqeEg collected $4 from pot
E2518gp4aFz1+kAgmGqeEg: doesn't show hand
*** SUMMARY ***
Total pot $4 | Rake $0
Seat 1: E2518gp4aFz1+kAgmGqeEg collected ($4)
Seat 2: 8zdVaT8pZ/Wm0uWoeLhtZg folded before Flop (didn't bet)
Seat 3: bkXkL3pmapikPQQRNPZSEA folded before Flop
Seat 4: e2+sK/yjnj94rXOKoxPP2A folded before Flop (didn't bet)
Seat 5: ApHP7ouup365XIUFBdEDxg folded before Flop (didn't bet)
Seat 6: Wj7mKnRFR90j40wWUu2+Og (button) folded before Flop (didn't bet)
Seat 7: HWcfp1hY1hqvrddzW3/FQw (small blind) folded before Flop
Seat 8: ji04uOybxCdpdefzlUQeKQ (big blind) folded before Flop
Seat 9: tLkxo7JgV+WWI0UBw44K5A folded before Flop (didn't bet)



PokerStars Game #59940302506:  Hold'em No Limit ($0.25/$0.50) - 2009/07/01 1:02:49 ET
Table '0eJtgVAXVvBgncFdcUpXcQ' 2-max Seat #2 is the button
Seat 1: Ag6DvxX4vbRheqsv2zXKTQ ($31.10 in chips)
Seat 2: KMc4R+K9ao4Ur3rF7NGe6Q ($16.50 in chips)
KMc4R+K9ao4Ur3rF7NGe6Q: posts small blind $0.25
Ag6DvxX4vbRheqsv2zXKTQ: posts big blind $0.50
*** HOLE CARDS ***
KMc4R+K9ao4Ur3rF7NGe6Q: calls $0.25
Ag6DvxX4vbRheqsv2zXKTQ: raises $1.50 to $2
KMc4R+K9ao4Ur3rF7NGe6Q: folds
Ag6DvxX4vbRheqsv2zXKTQ collected $1 from pot
*** SUMMARY ***
Total pot $1 | Rake $0
Seat 1: Ag6DvxX4vbRheqsv2zXKTQ (big blind) collected ($1)
Seat 2: KMc4R+K9ao4Ur3rF7NGe6Q (button) (small blind) folded before Flop



PokerStars Game #59940304728:  Hold'em No Limit ($0.25/$0.50) - 2009/07/01 1:02:52 ET
Table '5EmHi+fnatGQQShcNmzOZQ' 6-max Seat #5 is the button
Seat 1: My8WkRtGx5FW6rJ1I4R3hg ($19.95 in chips)
Seat 2: bfFjgAtIoAI+pUxUwFt3aQ ($49 in chips)
Seat 3: TjmTe3bhs9dFz5gXX9x7Lw ($12.05 in chips)
Seat 4: 1b+2BbjMN8qhR1WPqdE9VQ ($66.55 in chips)
Seat 5: kxPhs4ePFqMy52CInAJ2aw ($82.05 in chips)
Seat 6: 686aeHikcJlgKkSuIFdcXQ ($131.25 in chips)
686aeHikcJlgKkSuIFdcXQ: posts small blind $0.25
My8WkRtGx5FW6rJ1I4R3hg: posts big blind $0.50
*** HOLE CARDS ***
bfFjgAtIoAI+pUxUwFt3aQ: raises $0.50 to $1
TjmTe3bhs9dFz5gXX9x7Lw: folds
1b+2BbjMN8qhR1WPqdE9VQ: folds
kxPhs4ePFqMy52CInAJ2aw: folds
686aeHikcJlgKkSuIFdcXQ: folds
My8WkRtGx5FW6rJ1I4R3hg: folds
bfFjgAtIoAI+pUxUwFt3aQ collected $1.25 from pot
*** SUMMARY ***
Total pot $1.25 | Rake $0
Seat 1: My8WkRtGx5FW6rJ1I4R3hg (big blind) folded before Flop
Seat 2: bfFjgAtIoAI+pUxUwFt3aQ collected ($1.25)
Seat 3: TjmTe3bhs9dFz5gXX9x7Lw folded before Flop (didn't bet)
Seat 4: 1b+2BbjMN8qhR1WPqdE9VQ folded before Flop (didn't bet)
Seat 5: kxPhs4ePFqMy52CInAJ2aw (button) folded before Flop (didn't bet)
Seat 6: 686aeHikcJlgKkSuIFdcXQ (small blind) folded before Flop



PokerStars Game #59940304254:  Hold'em No Limit ($0.25/$0.50) - 2009/07/01 1:02:52 ET
Table 'MJxeZCzYELxiIsyUZyT0jw' 6-max Seat #5 is the button
Seat 1: +Pf9jTVizYlIo+woPvptfA ($50 in chips)
Seat 2: t3GiVMzqA9Svgr5Uol32cQ ($43.85 in chips)
Seat 3: JQZew0FjzS19kTjeNtrE+A ($60.40 in chips)
Seat 4: alGiiQP/wwtYnfuXII+sgw ($36.10 in chips)
Seat 5: 3jvoOXNtXE90w2BdfNZwZQ ($60.85 in chips)
Seat 6: c0n4hrn20AML9qzyFC2E8Q ($48.25 in chips)
c0n4hrn20AML9qzyFC2E8Q: posts small blind $0.25
+Pf9jTVizYlIo+woPvptfA: posts big blind $0.50
*** HOLE CARDS ***
t3GiVMzqA9Svgr5Uol32cQ: folds
JQZew0FjzS19kTjeNtrE+A: raises $1.50 to $2
alGiiQP/wwtYnfuXII+sgw: folds
3jvoOXNtXE90w2BdfNZwZQ: folds
c0n4hrn20AML9qzyFC2E8Q: folds
+Pf9jTVizYlIo+woPvptfA: folds
JQZew0FjzS19kTjeNtrE+A collected $1.25 from pot
*** SUMMARY ***
Total pot $1.25 | Rake $0
Seat 1: +Pf9jTVizYlIo+woPvptfA (big blind) folded before Flop
Seat 2: t3GiVMzqA9Svgr5Uol32cQ folded before Flop (didn't bet)
Seat 3: JQZew0FjzS19kTjeNtrE+A collected ($1.25)
Seat 4: alGiiQP/wwtYnfuXII+sgw folded before Flop (didn't bet)
Seat 5: 3jvoOXNtXE90w2BdfNZwZQ (button) folded before Flop (didn't bet)
Seat 6: c0n4hrn20AML9qzyFC2E8Q (small blind) folded before Flop



PokerStars Game #59940305164:  Hold'em No Limit ($0.25/$0.50) - 2009/07/01 1:02:53 ET
Table 'E7bWJ45aoFXRpyRv2gw+Ig' 2-max Seat #2 is the button
Seat 1: FRkiRasEGlHUeLrEl+k/nA ($58.05 in chips)
Seat 2: 3Wro85I7472vJ4Wkpneo9A ($130.40 in chips)
3Wro85I7472vJ4Wkpneo9A: posts small blind $0.25
FRkiRasEGlHUeLrEl+k/nA: posts big blind $0.50
*** HOLE CARDS ***
3Wro85I7472vJ4Wkpneo9A: raises $1 to $1.50
FRkiRasEGlHUeLrEl+k/nA: raises $2 to $3.50
3Wro85I7472vJ4Wkpneo9A: raises $9.50 to $13
FRkiRasEGlHUeLrEl+k/nA: folds
3Wro85I7472vJ4Wkpneo9A collected $7 from pot
3Wro85I7472vJ4Wkpneo9A: doesn't show hand
*** SUMMARY ***
Total pot $7 | Rake $0
Seat 1: FRkiRasEGlHUeLrEl+k/nA (big blind) folded before Flop
Seat 2: 3Wro85I7472vJ4Wkpneo9A (button) (small blind) collected ($7)



PokerStars Game #59940305300:  Hold'em No Limit ($0.25/$0.50) - 2009/07/01 1:02:53 ET
Table '8BQGgNetI1NOvWeu3gtMNw' 2-max Seat #1 is the button
Seat 1: bypIyrYcAAifLfhZpGlKLA ($56.50 in chips)
Seat 2: Z4HwehErEwzsv/noQlfUlg ($144.60 in chips)
bypIyrYcAAifLfhZpGlKLA: posts small blind $0.25
Z4HwehErEwzsv/noQlfUlg: posts big blind $0.50
*** HOLE CARDS ***
bypIyrYcAAifLfhZpGlKLA: raises $1 to $1.50
Z4HwehErEwzsv/noQlfUlg: calls $1
*** FLOP *** [8h 2c Ad]
Z4HwehErEwzsv/noQlfUlg: bets $2
bypIyrYcAAifLfhZpGlKLA: raises $5 to $7
Z4HwehErEwzsv/noQlfUlg: folds
bypIyrYcAAifLfhZpGlKLA collected $6.70 from pot
bypIyrYcAAifLfhZpGlKLA: doesn't show hand
*** SUMMARY ***
Total pot $7 | Rake $0.30
Board [8h 2c Ad]
Seat 1: bypIyrYcAAifLfhZpGlKLA (button) (small blind) collected ($6.70)
Seat 2: Z4HwehErEwzsv/noQlfUlg (big blind) folded on the Flop



PokerStars Game #59940306090:  Hold'em No Limit ($0.25/$0.50) - 2009/07/01 1:02:55 ET
Table 'fx6MqwfYAj/Rt86hBz2L3Q' 9-max Seat #8 is the button
Seat 1: uw9QayAAxLM3Hb+HR7mSkg ($10 in chips)
Seat 2: C3rGXblctNcWI6JYPHhaEg ($34.60 in chips)
Seat 3: iadBi5AEt7gTBXbDSSnMYQ ($54.65 in chips)
Seat 4: 75K2MXwN65Sjfp1yHd50Hg ($9.25 in chips)
Seat 5: iAISe3dVeua8PUn2wwgDHw ($51.60 in chips)
Seat 6: 5k9fvXD9suIgCxU4HLQjTw ($50.75 in chips)
Seat 7: SKnJuWHScqetA/qG5p+wCg ($30 in chips)
Seat 8: JYwJYYV9pM5KWdSiETl8rA ($21.25 in chips)
Seat 9: HZkVla4kK2SI42CVrPZ/ig ($9.75 in chips)
HZkVla4kK2SI42CVrPZ/ig: posts small blind $0.25
uw9QayAAxLM3Hb+HR7mSkg: posts big blind $0.50
*** HOLE CARDS ***
C3rGXblctNcWI6JYPHhaEg: calls $0.50
iadBi5AEt7gTBXbDSSnMYQ: folds
75K2MXwN65Sjfp1yHd50Hg: folds
iAISe3dVeua8PUn2wwgDHw: calls $0.50
5k9fvXD9suIgCxU4HLQjTw: folds
SKnJuWHScqetA/qG5p+wCg: folds
JYwJYYV9pM5KWdSiETl8rA: folds
HZkVla4kK2SI42CVrPZ/ig: calls $0.25
uw9QayAAxLM3Hb+HR7mSkg: checks
*** FLOP *** [As Jd Qh]
HZkVla4kK2SI42CVrPZ/ig: checks
uw9QayAAxLM3Hb+HR7mSkg: checks
C3rGXblctNcWI6JYPHhaEg: bets $2.10
iAISe3dVeua8PUn2wwgDHw: calls $2.10
HZkVla4kK2SI42CVrPZ/ig: folds
uw9QayAAxLM3Hb+HR7mSkg: folds
*** TURN *** [As Jd Qh] [Ac]
C3rGXblctNcWI6JYPHhaEg: bets $2
iAISe3dVeua8PUn2wwgDHw: calls $2
*** RIVER *** [As Jd Qh Ac] [9d]
C3rGXblctNcWI6JYPHhaEg: bets $5
iAISe3dVeua8PUn2wwgDHw: calls $5
*** SHOW DOWN ***
C3rGXblctNcWI6JYPHhaEg: shows [9s Ts] (two pair, Aces and Nines)
iAISe3dVeua8PUn2wwgDHw: shows [Qs 6s] (two pair, Aces and Queens)
iAISe3dVeua8PUn2wwgDHw collected $19.25 from pot
*** SUMMARY ***
Total pot $20.20 | Rake $0.95
Board [As Jd Qh Ac 9d]
Seat 1: uw9QayAAxLM3Hb+HR7mSkg (big blind) folded on the Flop
Seat 2: C3rGXblctNcWI6JYPHhaEg showed [9s Ts] and lost with two pair, Aces and Nines
Seat 3: iadBi5AEt7gTBXbDSSnMYQ folded before Flop (didn't bet)
Seat 4: 75K2MXwN65Sjfp1yHd50Hg folded before Flop (didn't bet)
Seat 5: iAISe3dVeua8PUn2wwgDHw showed [Qs 6s] and won ($19.25) with two pair, Aces and Queens
Seat 6: 5k9fvXD9suIgCxU4HLQjTw folded before Flop (didn't bet)
Seat 7: SKnJuWHScqetA/qG5p+wCg folded before Flop (didn't bet)
Seat 8: JYwJYYV9pM5KWdSiETl8rA (button) folded before Flop (didn't bet)
Seat 9: HZkVla4kK2SI42CVrPZ/ig (small blind) folded on the Flop



PokerStars Game #59940308084:  Hold'em No Limit ($0.25/$0.50) - 2009/07/01 1:02:58 ET
Table 'QOgaEqMcJ73pcUMMxoisUg' 6-max Seat #4 is the button
Seat 1: lxIzoHy0RnkfFSODHC2liw ($50 in chips)
Seat 2: 4QfsCWthT/vSLirorNXqtg ($76.35 in chips)
Seat 3: Rt6KgtZ8YaJoTc3FPim00w ($53 in chips)
Seat 4: zAcsDhG/T128Vn7XGVSgKg ($50 in chips)
Seat 5: 6vNxrjjCl6FwfaaymM9jjg ($21.25 in chips)
6vNxrjjCl6FwfaaymM9jjg: posts small blind $0.25
GoVjFxr3C+JO9vtJH9+IcA: is sitting out
lxIzoHy0RnkfFSODHC2liw: posts big blind $0.50
*** HOLE CARDS ***
GoVjFxr3C+JO9vtJH9+IcA leaves the table
4QfsCWthT/vSLirorNXqtg: folds
Rt6KgtZ8YaJoTc3FPim00w: folds
zAcsDhG/T128Vn7XGVSgKg: folds
6vNxrjjCl6FwfaaymM9jjg: raises $2 to $2.50
lxIzoHy0RnkfFSODHC2liw: folds
6vNxrjjCl6FwfaaymM9jjg collected $1 from pot
*** SUMMARY ***
Total pot $1 | Rake $0
Seat 1: lxIzoHy0RnkfFSODHC2liw (big blind) folded before Flop
Seat 2: 4QfsCWthT/vSLirorNXqtg folded before Flop (didn't bet)
Seat 3: Rt6KgtZ8YaJoTc3FPim00w folded before Flop (didn't bet)
Seat 4: zAcsDhG/T128Vn7XGVSgKg (button) folded before Flop (didn't bet)
Seat 5: 6vNxrjjCl6FwfaaymM9jjg (small blind) collected ($1)



PokerStars Game #59940307824:  Hold'em No Limit ($0.25/$0.50) - 2009/07/01 1:02:58 ET
Table '0eJtgVAXVvBgncFdcUpXcQ' 2-max Seat #1 is the button
Seat 1: Ag6DvxX4vbRheqsv2zXKTQ ($31.60 in chips)
Seat 2: KMc4R+K9ao4Ur3rF7NGe6Q ($16 in chips)
Ag6DvxX4vbRheqsv2zXKTQ: posts small blind $0.25
KMc4R+K9ao4Ur3rF7NGe6Q: posts big blind $0.50
*** HOLE CARDS ***
Ag6DvxX4vbRheqsv2zXKTQ: calls $0.25
KMc4R+K9ao4Ur3rF7NGe6Q: raises $1 to $1.50
Ag6DvxX4vbRheqsv2zXKTQ: folds
KMc4R+K9ao4Ur3rF7NGe6Q collected $1 from pot
KMc4R+K9ao4Ur3rF7NGe6Q: doesn't show hand
*** SUMMARY ***
Total pot $1 | Rake $0
Seat 1: Ag6DvxX4vbRheqsv2zXKTQ (button) (small blind) folded before Flop
Seat 2: KMc4R+K9ao4Ur3rF7NGe6Q (big blind) collected ($1)



PokerStars Game #59940308202:  Hold'em No Limit ($0.25/$0.50) - 2009/07/01 1:02:58 ET
Table 'lSisgp6H7Fg1hH5VfjEjYQ' 9-max Seat #5 is the button
Seat 1: 5k9fvXD9suIgCxU4HLQjTw ($50 in chips)
Seat 2: UrcnkQOiLVk8BlKDPJSy7Q ($75.85 in chips)
Seat 3: aTkyjTh3w5YLWiIERupZOA ($51.40 in chips)
Seat 4: bwv/rbH/hHhPhY6u9mu04w ($30.35 in chips)
Seat 5: mSD1pginDsyHG5PDfqzphw ($10 in chips)
Seat 6: +k7T5ocke8UwavtgUHm+Cg ($67.30 in chips)
Seat 7: IDtNLR9uFCDdjNsJWMHA5Q ($23.35 in chips)
Seat 8: a4JDWmpFQkL10XfAyuF51A ($27.75 in chips)
+k7T5ocke8UwavtgUHm+Cg: posts small blind $0.25
IDtNLR9uFCDdjNsJWMHA5Q: posts big blind $0.50
tkflckdgk: sits out
*** HOLE CARDS ***
a4JDWmpFQkL10XfAyuF51A: folds
5k9fvXD9suIgCxU4HLQjTw: folds
tkflckdgk leaves the table
UrcnkQOiLVk8BlKDPJSy7Q: folds
aTkyjTh3w5YLWiIERupZOA: folds
bwv/rbH/hHhPhY6u9mu04w: folds
mSD1pginDsyHG5PDfqzphw: folds
+k7T5ocke8UwavtgUHm+Cg: calls $0.25
IDtNLR9uFCDdjNsJWMHA5Q: checks
*** FLOP *** [4c 6s As]
+k7T5ocke8UwavtgUHm+Cg: checks
IDtNLR9uFCDdjNsJWMHA5Q: bets $1
+k7T5ocke8UwavtgUHm+Cg: folds
IDtNLR9uFCDdjNsJWMHA5Q collected $0.95 from pot
*** SUMMARY ***
Total pot $1 | Rake $0.05
Board [4c 6s As]
Seat 1: 5k9fvXD9suIgCxU4HLQjTw folded before Flop (didn't bet)
Seat 2: UrcnkQOiLVk8BlKDPJSy7Q folded before Flop (didn't bet)
Seat 3: aTkyjTh3w5YLWiIERupZOA folded before Flop (didn't bet)
Seat 4: bwv/rbH/hHhPhY6u9mu04w folded before Flop (didn't bet)
Seat 5: mSD1pginDsyHG5PDfqzphw (button) folded before Flop (didn't bet)
Seat 6: +k7T5ocke8UwavtgUHm+Cg (small blind) folded on the Flop
Seat 7: IDtNLR9uFCDdjNsJWMHA5Q (big blind) collected ($0.95)
Seat 8: a4JDWmpFQkL10XfAyuF51A folded before Flop (didn't bet)



PokerStars Game #59940308928:  Hold'em No Limit ($0.25/$0.50) - 2009/07/01 1:03:00 ET
Table 'NCiXr0d5CEKBQr/cZgLhbA' 9-max Seat #2 is the button
Seat 1: pFtzb1sR4b0d1aw6aIRgDg ($50 in chips)
Seat 2: ulxuJchBV9iguXg0FUonfg ($48.70 in chips)
Seat 3: xZCXQSXlrZkp3pZizzVXCw ($52.20 in chips)
Seat 4: 5k9fvXD9suIgCxU4HLQjTw ($55.20 in chips)
Seat 5: zE9cVigS2nW/Ljy4K4bUQA ($33.30 in chips)
Seat 6: SKnJuWHScqetA/qG5p+wCg ($32.75 in chips)
Seat 7: M+7+BTmX5vZatHVuoRB1nA ($52 in chips)
Seat 8: 1MJUKc3cc0QmUoz1JZLR2w ($64.05 in chips)
Seat 9: 4WLZvqBn5qv5tds5kt5A1Q ($41.65 in chips)
xZCXQSXlrZkp3pZizzVXCw: posts small blind $0.25
5k9fvXD9suIgCxU4HLQjTw: posts big blind $0.50
*** HOLE CARDS ***
zE9cVigS2nW/Ljy4K4bUQA: folds
SKnJuWHScqetA/qG5p+wCg: folds
M+7+BTmX5vZatHVuoRB1nA: raises $1.50 to $2
1MJUKc3cc0QmUoz1JZLR2w: folds
4WLZvqBn5qv5tds5kt5A1Q: folds
pFtzb1sR4b0d1aw6aIRgDg: folds
ulxuJchBV9iguXg0FUonfg: folds
xZCXQSXlrZkp3pZizzVXCw: folds
5k9fvXD9suIgCxU4HLQjTw: folds
M+7+BTmX5vZatHVuoRB1nA collected $1.25 from pot
*** SUMMARY ***
Total pot $1.25 | Rake $0
Seat 1: pFtzb1sR4b0d1aw6aIRgDg folded before Flop (didn't bet)
Seat 2: ulxuJchBV9iguXg0FUonfg (button) folded before Flop (didn't bet)
Seat 3: xZCXQSXlrZkp3pZizzVXCw (small blind) folded before Flop
Seat 4: 5k9fvXD9suIgCxU4HLQjTw (big blind) folded before Flop
Seat 5: zE9cVigS2nW/Ljy4K4bUQA folded before Flop (didn't bet)
Seat 6: SKnJuWHScqetA/qG5p+wCg folded before Flop (didn't bet)
Seat 7: M+7+BTmX5vZatHVuoRB1nA collected ($1.25)
Seat 8: 1MJUKc3cc0QmUoz1JZLR2w folded before Flop (didn't bet)
Seat 9: 4WLZvqBn5qv5tds5kt5A1Q folded before Flop (didn't bet)



PokerStars Game #59940309428:  Hold'em No Limit ($0.25/$0.50) - 2009/07/01 1:03:01 ET
Table 'GfL/No5u5PoEnU39lP5pQg' 6-max Seat #1 is the button
Seat 1: 1WUCqNG+p+vfWRTXNu4ljw ($65.35 in chips)
Seat 2: uVwggSetzp7d+eVgowO3vg ($56.50 in chips)
Seat 3: eQXFICMuu3hw6XlcmuVNEA ($14.05 in chips)
Seat 4: r6u7MWSXF30/khcTYkrG9Q ($42.90 in chips)
Seat 5: M1KyQQvVPVuxqTAB8sR/zQ ($50.75 in chips)
Seat 6: kxPhs4ePFqMy52CInAJ2aw ($50 in chips)
uVwggSetzp7d+eVgowO3vg: posts small blind $0.25
eQXFICMuu3hw6XlcmuVNEA: posts big blind $0.50
*** HOLE CARDS ***
r6u7MWSXF30/khcTYkrG9Q: raises $1 to $1.50
M1KyQQvVPVuxqTAB8sR/zQ: folds
kxPhs4ePFqMy52CInAJ2aw: calls $1.50
1WUCqNG+p+vfWRTXNu4ljw: calls $1.50
uVwggSetzp7d+eVgowO3vg: calls $1.25
eQXFICMuu3hw6XlcmuVNEA: calls $1
*** FLOP *** [Jd 8s Ks]
uVwggSetzp7d+eVgowO3vg: checks
eQXFICMuu3hw6XlcmuVNEA: checks
r6u7MWSXF30/khcTYkrG9Q: checks
kxPhs4ePFqMy52CInAJ2aw: checks
1WUCqNG+p+vfWRTXNu4ljw: bets $5
uVwggSetzp7d+eVgowO3vg: folds
eQXFICMuu3hw6XlcmuVNEA: folds
r6u7MWSXF30/khcTYkrG9Q: folds
kxPhs4ePFqMy52CInAJ2aw: folds
1WUCqNG+p+vfWRTXNu4ljw collected $7.15 from pot
*** SUMMARY ***
Total pot $7.50 | Rake $0.35
Board [Jd 8s Ks]
Seat 1: 1WUCqNG+p+vfWRTXNu4ljw (button) collected ($7.15)
Seat 2: uVwggSetzp7d+eVgowO3vg (small blind) folded on the Flop
Seat 3: eQXFICMuu3hw6XlcmuVNEA (big blind) folded on the Flop
Seat 4: r6u7MWSXF30/khcTYkrG9Q folded on the Flop
Seat 5: M1KyQQvVPVuxqTAB8sR/zQ folded before Flop (didn't bet)
Seat 6: kxPhs4ePFqMy52CInAJ2aw folded on the Flop



PokerStars Game #59940310984:  Hold'em No Limit ($0.25/$0.50) - 2009/07/01 1:03:03 ET
Table 'EiNh8p/wGJ1FP575iMFnqg' 9-max Seat #4 is the button
Seat 1: r3ZqM1Mi0W3y4hOdssE+Sg ($44.85 in chips)
Seat 2: 8ehL7qlZzjgUh2H35iiWLw ($51.85 in chips)
Seat 3: ymLPoEIl7UL3TvZYmnadxQ ($51.55 in chips)
Seat 4: cMzaiXAM/ZAdNaEUu+LqhA ($54.95 in chips)
Seat 5: M+7+BTmX5vZatHVuoRB1nA ($82.45 in chips)
Seat 6: 3UmXLy3GfjC3EkOebduerQ ($64.10 in chips)
Seat 7: 997ViqAtWn1FPjJqcffwcA ($50 in chips)
Seat 8: mSD1pginDsyHG5PDfqzphw ($11.60 in chips)
Seat 9: NnQCepdIR/AOUQn1yhYx6Q ($11.75 in chips)
M+7+BTmX5vZatHVuoRB1nA: posts small blind $0.25
3UmXLy3GfjC3EkOebduerQ: posts big blind $0.50
*** HOLE CARDS ***
997ViqAtWn1FPjJqcffwcA: folds
mSD1pginDsyHG5PDfqzphw: folds
NnQCepdIR/AOUQn1yhYx6Q: folds
r3ZqM1Mi0W3y4hOdssE+Sg: folds
8ehL7qlZzjgUh2H35iiWLw: raises $1.50 to $2
ymLPoEIl7UL3TvZYmnadxQ: folds
cMzaiXAM/ZAdNaEUu+LqhA: folds
M+7+BTmX5vZatHVuoRB1nA: calls $1.75
3UmXLy3GfjC3EkOebduerQ: folds
*** FLOP *** [3s 4d 6s]
M+7+BTmX5vZatHVuoRB1nA: checks
8ehL7qlZzjgUh2H35iiWLw: bets $3
M+7+BTmX5vZatHVuoRB1nA: folds
8ehL7qlZzjgUh2H35iiWLw collected $4.30 from pot
8ehL7qlZzjgUh2H35iiWLw: doesn't show hand
*** SUMMARY ***
Total pot $4.50 | Rake $0.20
Board [3s 4d 6s]
Seat 1: r3ZqM1Mi0W3y4hOdssE+Sg folded before Flop (didn't bet)
Seat 2: 8ehL7qlZzjgUh2H35iiWLw collected ($4.30)
Seat 3: ymLPoEIl7UL3TvZYmnadxQ folded before Flop (didn't bet)
Seat 4: cMzaiXAM/ZAdNaEUu+LqhA (button) folded before Flop (didn't bet)
Seat 5: M+7+BTmX5vZatHVuoRB1nA (small blind) folded on the Flop
Seat 6: 3UmXLy3GfjC3EkOebduerQ (big blind) folded before Flop
Seat 7: 997ViqAtWn1FPjJqcffwcA folded before Flop (didn't bet)
Seat 8: mSD1pginDsyHG5PDfqzphw folded before Flop (didn't bet)
Seat 9: NnQCepdIR/AOUQn1yhYx6Q folded before Flop (didn't bet)



PokerStars Game #59940313486:  Hold'em No Limit ($0.25/$0.50) - 2009/07/01 1:03:07 ET
Table '0eJtgVAXVvBgncFdcUpXcQ' 2-max Seat #2 is the button
Seat 1: Ag6DvxX4vbRheqsv2zXKTQ ($31.10 in chips)
Seat 2: KMc4R+K9ao4Ur3rF7NGe6Q ($16.50 in chips)
KMc4R+K9ao4Ur3rF7NGe6Q: posts small blind $0.25
Ag6DvxX4vbRheqsv2zXKTQ: posts big blind $0.50
*** HOLE CARDS ***
KMc4R+K9ao4Ur3rF7NGe6Q: folds
Ag6DvxX4vbRheqsv2zXKTQ collected $0.50 from pot
*** SUMMARY ***
Total pot $0.50 | Rake $0
Seat 1: Ag6DvxX4vbRheqsv2zXKTQ (big blind) collected ($0.50)
Seat 2: KMc4R+K9ao4Ur3rF7NGe6Q (button) (small blind) folded before Flop



PokerStars Game #59940314864:  Hold'em No Limit ($0.25/$0.50) - 2009/07/01 1:03:10 ET
Table 'Nz0Vr7WMHL2g5Uk7dDZjpw' 9-max Seat #4 is the button
Seat 1: tLkxo7JgV+WWI0UBw44K5A ($109.85 in chips)
Seat 2: gsyXT42WLEcOS4DdEk2wlw ($29.25 in chips)
Seat 4: E2518gp4aFz1+kAgmGqeEg ($13.30 in chips)
Seat 5: WGW0DgjBUXs1ylURHG8vnQ ($25.90 in chips)
Seat 6: 997ViqAtWn1FPjJqcffwcA ($60.55 in chips)
Seat 7: KPLH0gELgFe2OuAnhJFI5w ($14.85 in chips)
Seat 8: HkZI6g4zl83TDTA7SRspmQ ($28.40 in chips)
Seat 9: mSD1pginDsyHG5PDfqzphw ($10 in chips)
WGW0DgjBUXs1ylURHG8vnQ: posts small blind $0.25
997ViqAtWn1FPjJqcffwcA: posts big blind $0.50
*** HOLE CARDS ***
KPLH0gELgFe2OuAnhJFI5w: folds
HkZI6g4zl83TDTA7SRspmQ: folds
mSD1pginDsyHG5PDfqzphw: folds
tLkxo7JgV+WWI0UBw44K5A: folds
gsyXT42WLEcOS4DdEk2wlw: folds
E2518gp4aFz1+kAgmGqeEg: folds
WGW0DgjBUXs1ylURHG8vnQ: calls $0.25
997ViqAtWn1FPjJqcffwcA: checks
*** FLOP *** [6s Ad Tc]
WGW0DgjBUXs1ylURHG8vnQ: bets $0.50
997ViqAtWn1FPjJqcffwcA: folds
WGW0DgjBUXs1ylURHG8vnQ collected $0.95 from pot
WGW0DgjBUXs1ylURHG8vnQ: doesn't show hand
*** SUMMARY ***
Total pot $1 | Rake $0.05
Board [6s Ad Tc]
Seat 1: tLkxo7JgV+WWI0UBw44K5A folded before Flop (didn't bet)
Seat 2: gsyXT42WLEcOS4DdEk2wlw folded before Flop (didn't bet)
Seat 4: E2518gp4aFz1+kAgmGqeEg (button) folded before Flop (didn't bet)
Seat 5: WGW0DgjBUXs1ylURHG8vnQ (small blind) collected ($0.95)
Seat 6: 997ViqAtWn1FPjJqcffwcA (big blind) folded on the Flop
Seat 7: KPLH0gELgFe2OuAnhJFI5w folded before Flop (didn't bet)
Seat 8: HkZI6g4zl83TDTA7SRspmQ folded before Flop (didn't bet)
Seat 9: mSD1pginDsyHG5PDfqzphw folded before Flop (didn't bet)



PokerStars Game #59940315106:  Hold'em No Limit ($0.25/$0.50) - 2009/07/01 1:03:10 ET
Table 'BCN5su+SsXiy1zRMJi0SJw' 6-max Seat #3 is the button
Seat 1: GxXV09ciXaOxyY2H5aMIIw ($42.30 in chips)
Seat 2: oU2kDCkT/gilYbHWrg7D8w ($43.60 in chips)
Seat 3: 6wzJiRvp8HY6t+MQGnSIzA ($13.55 in chips)
Seat 5: IBNygaT1aa9Z1uPdJJilwA ($41 in chips)
Seat 6: b2symlOdL7+0c9Pj4N/KlA ($54.50 in chips)
IBNygaT1aa9Z1uPdJJilwA: posts small blind $0.25
b2symlOdL7+0c9Pj4N/KlA: posts big blind $0.50
*** HOLE CARDS ***
GxXV09ciXaOxyY2H5aMIIw: folds
oU2kDCkT/gilYbHWrg7D8w: folds
6wzJiRvp8HY6t+MQGnSIzA: calls $0.50
qfeUHOJpMYyzQcj0o2A7ng said, "and **** you all"
IBNygaT1aa9Z1uPdJJilwA: raises $1.50 to $2
b2symlOdL7+0c9Pj4N/KlA: folds
6wzJiRvp8HY6t+MQGnSIzA: calls $1.50
*** FLOP *** [Jd 2h 3h]
IBNygaT1aa9Z1uPdJJilwA: bets $2
6wzJiRvp8HY6t+MQGnSIzA: folds
oU2kDCkT/gilYbHWrg7D8w said, "10-3????"
IBNygaT1aa9Z1uPdJJilwA collected $4.30 from pot
*** SUMMARY ***
Total pot $4.50 | Rake $0.20
Board [Jd 2h 3h]
Seat 1: GxXV09ciXaOxyY2H5aMIIw folded before Flop (didn't bet)
Seat 2: oU2kDCkT/gilYbHWrg7D8w folded before Flop (didn't bet)
Seat 3: 6wzJiRvp8HY6t+MQGnSIzA (button) folded on the Flop
Seat 5: IBNygaT1aa9Z1uPdJJilwA (small blind) collected ($4.30)
Seat 6: b2symlOdL7+0c9Pj4N/KlA (big blind) folded before Flop



PokerStars Game #59940316718:  Hold'em No Limit ($0.25/$0.50) - 2009/07/01 1:03:13 ET
Table '0eJtgVAXVvBgncFdcUpXcQ' 2-max Seat #1 is the button
Seat 1: Ag6DvxX4vbRheqsv2zXKTQ ($31.35 in chips)
Seat 2: KMc4R+K9ao4Ur3rF7NGe6Q ($16.25 in chips)
Ag6DvxX4vbRheqsv2zXKTQ: posts small blind $0.25
KMc4R+K9ao4Ur3rF7NGe6Q: posts big blind $0.50
*** HOLE CARDS ***
Ag6DvxX4vbRheqsv2zXKTQ: calls $0.25
KMc4R+K9ao4Ur3rF7NGe6Q: checks
*** FLOP *** [7s 7c Qs]
KMc4R+K9ao4Ur3rF7NGe6Q: bets $1
Ag6DvxX4vbRheqsv2zXKTQ: calls $1
*** TURN *** [7s 7c Qs] [5h]
KMc4R+K9ao4Ur3rF7NGe6Q: bets $1.50
Ag6DvxX4vbRheqsv2zXKTQ: calls $1.50
*** RIVER *** [7s 7c Qs 5h] [Qh]
KMc4R+K9ao4Ur3rF7NGe6Q: checks
Ag6DvxX4vbRheqsv2zXKTQ: bets $2.50
KMc4R+K9ao4Ur3rF7NGe6Q: folds
Ag6DvxX4vbRheqsv2zXKTQ collected $5.75 from pot
Ag6DvxX4vbRheqsv2zXKTQ: shows [Ks Qd] (a full house, Queens full of Sevens)
*** SUMMARY ***
Total pot $6 | Rake $0.25
Board [7s 7c Qs 5h Qh]
Seat 1: Ag6DvxX4vbRheqsv2zXKTQ (button) (small blind) collected ($5.75)
Seat 2: KMc4R+K9ao4Ur3rF7NGe6Q (big blind) folded on the River



PokerStars Game #59940316876:  Hold'em No Limit ($0.25/$0.50) - 2009/07/01 1:03:13 ET
Table 'kgbJRsxfv64KrErDRBAkcw' 6-max Seat #6 is the button
Seat 1: VamsyhlFzXGF6/ydo0BHeA ($39.50 in chips)
Seat 2: AdS8BJMOheS01zjCDfPMFg ($49.95 in chips)
Seat 3: c4MNIaIyPMOMxrgT8FT5nA ($137.90 in chips)
Seat 4: qanMEqjABjWxC/JgQ/0l7w ($56.50 in chips)
Seat 5: eUBBn2R56C1IQ6Cs/vitwg ($55.25 in chips)
Seat 6: 1b+2BbjMN8qhR1WPqdE9VQ ($52.40 in chips)
VamsyhlFzXGF6/ydo0BHeA: posts small blind $0.25
AdS8BJMOheS01zjCDfPMFg: posts big blind $0.50
*** HOLE CARDS ***
c4MNIaIyPMOMxrgT8FT5nA: raises $3 to $3.50
qanMEqjABjWxC/JgQ/0l7w: folds
eUBBn2R56C1IQ6Cs/vitwg: folds
1b+2BbjMN8qhR1WPqdE9VQ: folds
VamsyhlFzXGF6/ydo0BHeA: calls $3.25
AdS8BJMOheS01zjCDfPMFg: folds
*** FLOP *** [4c Jh Js]
VamsyhlFzXGF6/ydo0BHeA: checks
c4MNIaIyPMOMxrgT8FT5nA: bets $5.50
VamsyhlFzXGF6/ydo0BHeA: folds
c4MNIaIyPMOMxrgT8FT5nA collected $7.15 from pot
c4MNIaIyPMOMxrgT8FT5nA: doesn't show hand
*** SUMMARY ***
Total pot $7.50 | Rake $0.35
Board [4c Jh Js]
Seat 1: VamsyhlFzXGF6/ydo0BHeA (small blind) folded on the Flop
Seat 2: AdS8BJMOheS01zjCDfPMFg (big blind) folded before Flop
Seat 3: c4MNIaIyPMOMxrgT8FT5nA collected ($7.15)
Seat 4: qanMEqjABjWxC/JgQ/0l7w folded before Flop (didn't bet)
Seat 5: eUBBn2R56C1IQ6Cs/vitwg folded before Flop (didn't bet)
Seat 6: 1b+2BbjMN8qhR1WPqdE9VQ (button) folded before Flop (didn't bet)



PokerStars Game #59940317438:  Hold'em No Limit ($0.25/$0.50) - 2009/07/01 1:03:14 ET
Table '37qXEp3oe+er5q4CZip9eQ' 6-max Seat #3 is the button
Seat 1: oqOqoO2AyCZenUghCxMDxw ($50 in chips)
Seat 2: LvH4G7n+QSjT6NDaD3cREA ($55.80 in chips)
Seat 3: Rt6KgtZ8YaJoTc3FPim00w ($110.20 in chips)
Seat 4: XsmE8nXMAAMFJbWaJTmHFw ($40.10 in chips)
Seat 5: VOmI0x4dDPnTESZd5B4d1Q ($39.50 in chips)
Seat 6: N50kln4negd8q7Mmoz1j4g ($18.35 in chips)
XsmE8nXMAAMFJbWaJTmHFw: posts small blind $0.25
VOmI0x4dDPnTESZd5B4d1Q: posts big blind $0.50
*** HOLE CARDS ***
N50kln4negd8q7Mmoz1j4g: folds
oqOqoO2AyCZenUghCxMDxw: folds
LvH4G7n+QSjT6NDaD3cREA: raises $1 to $1.50
Rt6KgtZ8YaJoTc3FPim00w: folds
XsmE8nXMAAMFJbWaJTmHFw: folds
VOmI0x4dDPnTESZd5B4d1Q said, "plus for this stake ppl are playing ridiculously tight!"
VOmI0x4dDPnTESZd5B4d1Q: folds
LvH4G7n+QSjT6NDaD3cREA collected $1.25 from pot
*** SUMMARY ***
Total pot $1.25 | Rake $0
Seat 1: oqOqoO2AyCZenUghCxMDxw folded before Flop (didn't bet)
Seat 2: LvH4G7n+QSjT6NDaD3cREA collected ($1.25)
Seat 3: Rt6KgtZ8YaJoTc3FPim00w (button) folded before Flop (didn't bet)
Seat 4: XsmE8nXMAAMFJbWaJTmHFw (small blind) folded before Flop
Seat 5: VOmI0x4dDPnTESZd5B4d1Q (big blind) folded before Flop
Seat 6: N50kln4negd8q7Mmoz1j4g folded before Flop (didn't bet)



PokerStars Game #59940317462:  Hold'em No Limit ($0.25/$0.50) - 2009/07/01 1:03:14 ET
Table '8BQGgNetI1NOvWeu3gtMNw' 2-max Seat #2 is the button
Seat 1: bypIyrYcAAifLfhZpGlKLA ($59.70 in chips)
Seat 2: Z4HwehErEwzsv/noQlfUlg ($141.10 in chips)
Z4HwehErEwzsv/noQlfUlg: posts small blind $0.25
bypIyrYcAAifLfhZpGlKLA: posts big blind $0.50
*** HOLE CARDS ***
Z4HwehErEwzsv/noQlfUlg: folds
bypIyrYcAAifLfhZpGlKLA collected $0.50 from pot
bypIyrYcAAifLfhZpGlKLA: doesn't show hand
*** SUMMARY ***
Total pot $0.50 | Rake $0
Seat 1: bypIyrYcAAifLfhZpGlKLA (big blind) collected ($0.50)
Seat 2: Z4HwehErEwzsv/noQlfUlg (button) (small blind) folded before Flop



PokerStars Game #59940318002:  Hold'em No Limit ($0.25/$0.50) - 2009/07/01 1:03:15 ET
Table 'E7bWJ45aoFXRpyRv2gw+Ig' 2-max Seat #1 is the button
Seat 1: FRkiRasEGlHUeLrEl+k/nA ($54.55 in chips)
Seat 2: 3Wro85I7472vJ4Wkpneo9A ($133.90 in chips)
FRkiRasEGlHUeLrEl+k/nA: posts small blind $0.25
3Wro85I7472vJ4Wkpneo9A: posts big blind $0.50
*** HOLE CARDS ***
FRkiRasEGlHUeLrEl+k/nA: folds
3Wro85I7472vJ4Wkpneo9A collected $0.50 from pot
3Wro85I7472vJ4Wkpneo9A: doesn't show hand
*** SUMMARY ***
Total pot $0.50 | Rake $0
Seat 1: FRkiRasEGlHUeLrEl+k/nA (button) (small blind) folded before Flop
Seat 2: 3Wro85I7472vJ4Wkpneo9A (big blind) collected ($0.50)



PokerStars Game #59940317920:  Hold'em No Limit ($0.25/$0.50) - 2009/07/01 1:03:15 ET
Table 'MJxeZCzYELxiIsyUZyT0jw' 6-max Seat #6 is the button
Seat 1: +Pf9jTVizYlIo+woPvptfA ($50 in chips)
Seat 2: t3GiVMzqA9Svgr5Uol32cQ ($43.85 in chips)
Seat 3: JQZew0FjzS19kTjeNtrE+A ($61.15 in chips)
Seat 4: alGiiQP/wwtYnfuXII+sgw ($36.10 in chips)
Seat 5: 3jvoOXNtXE90w2BdfNZwZQ ($60.85 in chips)
Seat 6: c0n4hrn20AML9qzyFC2E8Q ($48 in chips)
+Pf9jTVizYlIo+woPvptfA: posts small blind $0.25
t3GiVMzqA9Svgr5Uol32cQ: posts big blind $0.50
*** HOLE CARDS ***
JQZew0FjzS19kTjeNtrE+A: folds
alGiiQP/wwtYnfuXII+sgw: folds
3jvoOXNtXE90w2BdfNZwZQ: raises $1.50 to $2
c0n4hrn20AML9qzyFC2E8Q: folds
+Pf9jTVizYlIo+woPvptfA: folds
t3GiVMzqA9Svgr5Uol32cQ: calls $1.50
*** FLOP *** [As 5h Td]
t3GiVMzqA9Svgr5Uol32cQ: bets $2.50
JQZew0FjzS19kTjeNtrE+A leaves the table
3jvoOXNtXE90w2BdfNZwZQ: calls $2.50
*** TURN *** [As 5h Td] [Kh]
t3GiVMzqA9Svgr5Uol32cQ: checks
3jvoOXNtXE90w2BdfNZwZQ: checks
*** RIVER *** [As 5h Td Kh] [9c]
t3GiVMzqA9Svgr5Uol32cQ: checks
3jvoOXNtXE90w2BdfNZwZQ: checks
*** SHOW DOWN ***
t3GiVMzqA9Svgr5Uol32cQ: shows [6h Ac] (a pair of Aces)
3jvoOXNtXE90w2BdfNZwZQ: mucks hand
t3GiVMzqA9Svgr5Uol32cQ collected $8.80 from pot
*** SUMMARY ***
Total pot $9.25 | Rake $0.45
Board [As 5h Td Kh 9c]
Seat 1: +Pf9jTVizYlIo+woPvptfA (small blind) folded before Flop
Seat 2: t3GiVMzqA9Svgr5Uol32cQ (big blind) showed [6h Ac] and won ($8.80) with a pair of Aces
Seat 3: JQZew0FjzS19kTjeNtrE+A folded before Flop (didn't bet)
Seat 4: alGiiQP/wwtYnfuXII+sgw folded before Flop (didn't bet)
Seat 5: 3jvoOXNtXE90w2BdfNZwZQ mucked
Seat 6: c0n4hrn20AML9qzyFC2E8Q (button) folded before Flop (didn't bet)



PokerStars Game #59940320780:  Hold'em No Limit ($0.25/$0.50) - 2009/07/01 1:03:20 ET
Table '5EmHi+fnatGQQShcNmzOZQ' 6-max Seat #6 is the button
Seat 1: My8WkRtGx5FW6rJ1I4R3hg ($19.45 in chips)
Seat 2: bfFjgAtIoAI+pUxUwFt3aQ ($49.75 in chips)
Seat 3: TjmTe3bhs9dFz5gXX9x7Lw ($12.05 in chips)
Seat 4: 1b+2BbjMN8qhR1WPqdE9VQ ($66.55 in chips)
Seat 5: kxPhs4ePFqMy52CInAJ2aw ($82.05 in chips)
Seat 6: 686aeHikcJlgKkSuIFdcXQ ($131 in chips)
My8WkRtGx5FW6rJ1I4R3hg: posts small blind $0.25
bfFjgAtIoAI+pUxUwFt3aQ: posts big blind $0.50
*** HOLE CARDS ***
TjmTe3bhs9dFz5gXX9x7Lw: raises $1 to $1.50
1b+2BbjMN8qhR1WPqdE9VQ: folds
kxPhs4ePFqMy52CInAJ2aw: folds
686aeHikcJlgKkSuIFdcXQ: folds
My8WkRtGx5FW6rJ1I4R3hg: calls $1.25
bfFjgAtIoAI+pUxUwFt3aQ: folds
*** FLOP *** [2c 3d 8d]
My8WkRtGx5FW6rJ1I4R3hg: bets $0.50
TjmTe3bhs9dFz5gXX9x7Lw: calls $0.50
*** TURN *** [2c 3d 8d] [7h]
My8WkRtGx5FW6rJ1I4R3hg: bets $0.50
TjmTe3bhs9dFz5gXX9x7Lw: calls $0.50
*** RIVER *** [2c 3d 8d 7h] [3c]
My8WkRtGx5FW6rJ1I4R3hg: bets $0.50
TjmTe3bhs9dFz5gXX9x7Lw: raises $3 to $3.50
My8WkRtGx5FW6rJ1I4R3hg: folds
TjmTe3bhs9dFz5gXX9x7Lw collected $6.20 from pot
TjmTe3bhs9dFz5gXX9x7Lw: doesn't show hand
*** SUMMARY ***
Total pot $6.50 | Rake $0.30
Board [2c 3d 8d 7h 3c]
Seat 1: My8WkRtGx5FW6rJ1I4R3hg (small blind) folded on the River
Seat 2: bfFjgAtIoAI+pUxUwFt3aQ (big blind) folded before Flop
Seat 3: TjmTe3bhs9dFz5gXX9x7Lw collected ($6.20)
Seat 4: 1b+2BbjMN8qhR1WPqdE9VQ folded before Flop (didn't bet)
Seat 5: kxPhs4ePFqMy52CInAJ2aw folded before Flop (didn't bet)
Seat 6: 686aeHikcJlgKkSuIFdcXQ (button) folded before Flop (didn't bet)



PokerStars Game #59940320726:  Hold'em No Limit ($0.25/$0.50) - 2009/07/01 1:03:20 ET
Table 'c/CRn+68J3Y8KxD5g1ek2Q' 2-max Seat #1 is the button
Seat 1: 46qCyJ6evTkHo9al5sBMNA ($95.95 in chips)
Seat 2: BypVLsYQt3ePFm2xQL/dOA ($271.75 in chips)
46qCyJ6evTkHo9al5sBMNA: posts small blind $0.25
BypVLsYQt3ePFm2xQL/dOA: posts big blind $0.50
*** HOLE CARDS ***
46qCyJ6evTkHo9al5sBMNA: raises $1.50 to $2
BypVLsYQt3ePFm2xQL/dOA: calls $1.50
*** FLOP *** [6d 5c 4h]
BypVLsYQt3ePFm2xQL/dOA: checks
46qCyJ6evTkHo9al5sBMNA: checks
*** TURN *** [6d 5c 4h] [Tc]
BypVLsYQt3ePFm2xQL/dOA: bets $1.50
46qCyJ6evTkHo9al5sBMNA: calls $1.50
*** RIVER *** [6d 5c 4h Tc] [3s]
BypVLsYQt3ePFm2xQL/dOA: checks
46qCyJ6evTkHo9al5sBMNA: checks
*** SHOW DOWN ***
BypVLsYQt3ePFm2xQL/dOA: shows [6h Ah] (a pair of Sixes)
46qCyJ6evTkHo9al5sBMNA: mucks hand
BypVLsYQt3ePFm2xQL/dOA collected $6.70 from pot
*** SUMMARY ***
Total pot $7 | Rake $0.30
Board [6d 5c 4h Tc 3s]
Seat 1: 46qCyJ6evTkHo9al5sBMNA (button) (small blind) mucked
Seat 2: BypVLsYQt3ePFm2xQL/dOA (big blind) showed [6h Ah] and won ($6.70) with a pair of Sixes



PokerStars Game #59940320996:  Hold'em No Limit ($0.25/$0.50) - 2009/07/01 1:03:20 ET
Table 'otvGDROEDdqsabxskT79qg' 9-max Seat #6 is the button
Seat 1: 8ehL7qlZzjgUh2H35iiWLw ($56.75 in chips)
Seat 2: cCjTzH9jio8607WzjcfXlg ($14.25 in chips)
Seat 3: +k7T5ocke8UwavtgUHm+Cg ($70.60 in chips)
Seat 4: MG90wfSJZnOejs/KD3vlQQ ($76.65 in chips)
Seat 5: E2518gp4aFz1+kAgmGqeEg ($11 in chips)
Seat 6: bxLSulbgr8LmKNjOzw8URg ($52.95 in chips)
Seat 7: 75K2MXwN65Sjfp1yHd50Hg ($9.50 in chips)
Seat 8: zE9cVigS2nW/Ljy4K4bUQA ($30.75 in chips)
Seat 9: KcY3X8YpD74Kw1RHkx/g4A ($51.15 in chips)
75K2MXwN65Sjfp1yHd50Hg: posts small blind $0.25
zE9cVigS2nW/Ljy4K4bUQA: posts big blind $0.50
*** HOLE CARDS ***
KcY3X8YpD74Kw1RHkx/g4A: folds
8ehL7qlZzjgUh2H35iiWLw: folds
cCjTzH9jio8607WzjcfXlg: folds
+k7T5ocke8UwavtgUHm+Cg: folds
MG90wfSJZnOejs/KD3vlQQ: folds
E2518gp4aFz1+kAgmGqeEg: raises $1 to $1.50
bxLSulbgr8LmKNjOzw8URg: folds
75K2MXwN65Sjfp1yHd50Hg: folds
zE9cVigS2nW/Ljy4K4bUQA: folds
E2518gp4aFz1+kAgmGqeEg collected $1.25 from pot
E2518gp4aFz1+kAgmGqeEg: doesn't show hand
*** SUMMARY ***
Total pot $1.25 | Rake $0
Seat 1: 8ehL7qlZzjgUh2H35iiWLw folded before Flop (didn't bet)
Seat 2: cCjTzH9jio8607WzjcfXlg folded before Flop (didn't bet)
Seat 3: +k7T5ocke8UwavtgUHm+Cg folded before Flop (didn't bet)
Seat 4: MG90wfSJZnOejs/KD3vlQQ folded before Flop (didn't bet)
Seat 5: E2518gp4aFz1+kAgmGqeEg collected ($1.25)
Seat 6: bxLSulbgr8LmKNjOzw8URg (button) folded before Flop (didn't bet)
Seat 7: 75K2MXwN65Sjfp1yHd50Hg (small blind) folded before Flop
Seat 8: zE9cVigS2nW/Ljy4K4bUQA (big blind) folded before Flop
Seat 9: KcY3X8YpD74Kw1RHkx/g4A folded before Flop (didn't bet)



PokerStars Game #59940321358:  Hold'em No Limit ($0.25/$0.50) - 2009/07/01 1:03:21 ET
Table '+z1aekfHkpp09pc8F9aViw' 6-max Seat #1 is the button
Seat 1: FHilMb2i2DbUCc9lplszog ($17.85 in chips)
Seat 3: uUznlIMFnRUvwrBhYF73KA ($133.40 in chips)
Seat 4: RowCSpSURHTOL/dcjg/Iug ($39.55 in chips)
Seat 5: rplyldNweS6YyMNEALQrug ($51.40 in chips)
Seat 6: 686aeHikcJlgKkSuIFdcXQ ($50 in chips)
of9mtXiD8G4Nx5p7hCbgqQ will be allowed to play after the button
uUznlIMFnRUvwrBhYF73KA: posts small blind $0.25
RowCSpSURHTOL/dcjg/Iug: posts big blind $0.50
*** HOLE CARDS ***
rplyldNweS6YyMNEALQrug: folds
686aeHikcJlgKkSuIFdcXQ: folds
FHilMb2i2DbUCc9lplszog: raises $1.50 to $2
uUznlIMFnRUvwrBhYF73KA: folds
RowCSpSURHTOL/dcjg/Iug: calls $1.50
*** FLOP *** [5d 2c 6h]
RowCSpSURHTOL/dcjg/Iug: checks
FHilMb2i2DbUCc9lplszog: bets $3
RowCSpSURHTOL/dcjg/Iug: folds
FHilMb2i2DbUCc9lplszog collected $4.05 from pot
*** SUMMARY ***
Total pot $4.25 | Rake $0.20
Board [5d 2c 6h]
Seat 1: FHilMb2i2DbUCc9lplszog (button) collected ($4.05)
Seat 3: uUznlIMFnRUvwrBhYF73KA (small blind) folded before Flop
Seat 4: RowCSpSURHTOL/dcjg/Iug (big blind) folded on the Flop
Seat 5: rplyldNweS6YyMNEALQrug folded before Flop (didn't bet)
Seat 6: 686aeHikcJlgKkSuIFdcXQ folded before Flop (didn't bet)



PokerStars Game #59940321442:  Hold'em No Limit ($0.25/$0.50) - 2009/07/01 1:03:21 ET
Table 'ErOuyGLI5PT3G5MnpHgC/gQOgaEqMcJ73pcUMMxoisUg Seat #8 is the button
Seat 2: pciZn00ZDk4BVBMTTMcNVQ ($30.25 in chips)
Seat 3: xZCXQSXlrZkp3pZizzVXCw ($52.75 in chips)
Seat 4: 3UmXLy3GfjC3EkOebduerQ ($50 in chips)
Seat 5: JwvquocWfhTVApN5t47LgA ($62.60 in chips)
Seat 6: zE9cVigS2nW/Ljy4K4bUQA ($31.60 in chips)
Seat 7: 90Wb75h3W1BRpbqVnuk8gw ($63.60 in chips)
Seat 8: g4k0NXISyLCqaSWZDBjfEg ($50 in chips)
Seat 9: J0W5D97jl5VLky+IoPvDeA ($51.65 in chips)
J0W5D97jl5VLky+IoPvDeA: posts small blind $0.25
eBrej2jnlUCs/JgxFCRn2g has timed out
eBrej2jnlUCs/JgxFCRn2g: is sitting out
pciZn00ZDk4BVBMTTMcNVQ: posts big blind $0.50
*** HOLE CARDS ***
xZCXQSXlrZkp3pZizzVXCw: folds
3UmXLy3GfjC3EkOebduerQ: folds
JwvquocWfhTVApN5t47LgA: raises $1.50 to $2
zE9cVigS2nW/Ljy4K4bUQA: folds
90Wb75h3W1BRpbqVnuk8gw: folds
g4k0NXISyLCqaSWZDBjfEg: folds
J0W5D97jl5VLky+IoPvDeA: folds
pciZn00ZDk4BVBMTTMcNVQ: calls $1.50
*** FLOP *** [6s 9c Ad]
pciZn00ZDk4BVBMTTMcNVQ: checks
JwvquocWfhTVApN5t47LgA: bets $3
pciZn00ZDk4BVBMTTMcNVQ: folds
JwvquocWfhTVApN5t47LgA collected $4.05 from pot
*** SUMMARY ***
Total pot $4.25 | Rake $0.20
Board [6s 9c Ad]
Seat 2: pciZn00ZDk4BVBMTTMcNVQ (big blind) folded on the Flop
Seat 3: xZCXQSXlrZkp3pZizzVXCw folded before Flop (didn't bet)
Seat 4: 3UmXLy3GfjC3EkOebduerQ folded before Flop (didn't bet)
Seat 5: JwvquocWfhTVApN5t47LgA collected ($4.05)
Seat 6: zE9cVigS2nW/Ljy4K4bUQA folded before Flop (didn't bet)
Seat 7: 90Wb75h3W1BRpbqVnuk8gw folded before Flop (didn't bet)
Seat 8: g4k0NXISyLCqaSWZDBjfEg (button) folded before Flop (didn't bet)
Seat 9: J0W5D97jl5VLky+IoPvDeA (small blind) folded before Flop



PokerStars Game #59940321844:  Hold'em No Limit ($0.25/$0.50) - 2009/07/01 1:03:22 ET
Table 'E7bWJ45aoFXRpyRv2gw+Ig' 2-max Seat #2 is the button
Seat 1: FRkiRasEGlHUeLrEl+k/nA ($54.30 in chips)
Seat 2: 3Wro85I7472vJ4Wkpneo9A ($134.15 in chips)
3Wro85I7472vJ4Wkpneo9A: posts small blind $0.25
FRkiRasEGlHUeLrEl+k/nA: posts big blind $0.50
*** HOLE CARDS ***
3Wro85I7472vJ4Wkpneo9A: calls $0.25
FRkiRasEGlHUeLrEl+k/nA: checks
*** FLOP *** [5c Ah 3s]
FRkiRasEGlHUeLrEl+k/nA: checks
3Wro85I7472vJ4Wkpneo9A: checks
*** TURN *** [5c Ah 3s] [9s]
FRkiRasEGlHUeLrEl+k/nA: bets $1
3Wro85I7472vJ4Wkpneo9A: folds
FRkiRasEGlHUeLrEl+k/nA collected $0.95 from pot
*** SUMMARY ***
Total pot $1 | Rake $0.05
Board [5c Ah 3s 9s]
Seat 1: FRkiRasEGlHUeLrEl+k/nA (big blind) collected ($0.95)
Seat 2: 3Wro85I7472vJ4Wkpneo9A (button) (small blind) folded on the Turn



PokerStars Game #59940322034:  Hold'em No Limit ($0.25/$0.50) - 2009/07/01 1:03:22 ET
Table '8BQGgNetI1NOvWeu3gtMNw' 2-max Seat #1 is the button
Seat 1: bypIyrYcAAifLfhZpGlKLA ($59.95 in chips)
Seat 2: Z4HwehErEwzsv/noQlfUlg ($140.85 in chips)
bypIyrYcAAifLfhZpGlKLA: posts small blind $0.25
Z4HwehErEwzsv/noQlfUlg: posts big blind $0.50
*** HOLE CARDS ***
bypIyrYcAAifLfhZpGlKLA: raises $1 to $1.50
Z4HwehErEwzsv/noQlfUlg: raises $1 to $2.50
bypIyrYcAAifLfhZpGlKLA: calls $1
*** FLOP *** [As 7h 8s]
Z4HwehErEwzsv/noQlfUlg: bets $4.50
bypIyrYcAAifLfhZpGlKLA: raises $10 to $14.50
Z4HwehErEwzsv/noQlfUlg: calls $10
*** TURN *** [As 7h 8s] [6d]
Z4HwehErEwzsv/noQlfUlg: checks
bypIyrYcAAifLfhZpGlKLA: bets $11.50
Z4HwehErEwzsv/noQlfUlg: calls $11.50
*** RIVER *** [As 7h 8s 6d] [6c]
Z4HwehErEwzsv/noQlfUlg: checks
bypIyrYcAAifLfhZpGlKLA: bets $31.45 and is all-in
Z4HwehErEwzsv/noQlfUlg: folds
bypIyrYcAAifLfhZpGlKLA collected $56.50 from pot
bypIyrYcAAifLfhZpGlKLA: doesn't show hand
*** SUMMARY ***
Total pot $57 | Rake $0.50
Board [As 7h 8s 6d 6c]
Seat 1: bypIyrYcAAifLfhZpGlKLA (button) (small blind) collected ($56.50)
Seat 2: Z4HwehErEwzsv/noQlfUlg (big blind) folded on the River



PokerStars Game #59940322070:  Hold'em No Limit ($0.25/$0.50) - 2009/07/01 1:03:22 ET
Table 'QOgaEqMcJ73pcUMMxoisUg' 6-max Seat #5 is the button
Seat 1: lxIzoHy0RnkfFSODHC2liw ($50 in chips)
Seat 3: Rt6KgtZ8YaJoTc3FPim00w ($53 in chips)
Seat 4: zAcsDhG/T128Vn7XGVSgKg ($50 in chips)
Seat 5: 6vNxrjjCl6FwfaaymM9jjg ($21.75 in chips)
lxIzoHy0RnkfFSODHC2liw: posts small blind $0.25
4QfsCWthT/vSLirorNXqtg: is sitting out
Rt6KgtZ8YaJoTc3FPim00w: posts big blind $0.50
*** HOLE CARDS ***
4QfsCWthT/vSLirorNXqtg leaves the table
zAcsDhG/T128Vn7XGVSgKg: raises $1 to $1.50
6vNxrjjCl6FwfaaymM9jjg: folds
lxIzoHy0RnkfFSODHC2liw: calls $1.25
Rt6KgtZ8YaJoTc3FPim00w: folds
*** FLOP *** [5h 3h 7h]
lxIzoHy0RnkfFSODHC2liw: checks
zAcsDhG/T128Vn7XGVSgKg: bets $2.50
lxIzoHy0RnkfFSODHC2liw: raises $6 to $8.50
zAcsDhG/T128Vn7XGVSgKg: folds
lxIzoHy0RnkfFSODHC2liw collected $8.10 from pot
*** SUMMARY ***
Total pot $8.50 | Rake $0.40
Board [5h 3h 7h]
Seat 1: lxIzoHy0RnkfFSODHC2liw (small blind) collected ($8.10)
Seat 3: Rt6KgtZ8YaJoTc3FPim00w (big blind) folded before Flop
Seat 4: zAcsDhG/T128Vn7XGVSgKg folded on the Flop
Seat 5: 6vNxrjjCl6FwfaaymM9jjg (button) folded before Flop (didn't bet)



PokerStars Game #59940328398:  Hold'em No Limit ($0.25/$0.50) - 2009/07/01 1:03:32 ET
Table '0eJtgVAXVvBgncFdcUpXcQ' 2-max Seat #2 is the button
Seat 1: Ag6DvxX4vbRheqsv2zXKTQ ($34.10 in chips)
Seat 2: KMc4R+K9ao4Ur3rF7NGe6Q ($13.25 in chips)
KMc4R+K9ao4Ur3rF7NGe6Q: posts small blind $0.25
Ag6DvxX4vbRheqsv2zXKTQ: posts big blind $0.50
*** HOLE CARDS ***
KMc4R+K9ao4Ur3rF7NGe6Q: raises $1 to $1.50
Ag6DvxX4vbRheqsv2zXKTQ: folds
KMc4R+K9ao4Ur3rF7NGe6Q collected $1 from pot
KMc4R+K9ao4Ur3rF7NGe6Q: doesn't show hand
*** SUMMARY ***
Total pot $1 | Rake $0
Seat 1: Ag6DvxX4vbRheqsv2zXKTQ (big blind) folded before Flop
Seat 2: KMc4R+K9ao4Ur3rF7NGe6Q (button) (small blind) collected ($1)



PokerStars Game #59940330032:  Hold'em No Limit ($0.25/$0.50) - 2009/07/01 1:03:35 ET
Table 'lSisgp6H7Fg1hH5VfjEjYQ' 9-max Seat #6 is the button
Seat 1: 5k9fvXD9suIgCxU4HLQjTw ($50 in chips)
Seat 2: UrcnkQOiLVk8BlKDPJSy7Q ($75.85 in chips)
Seat 3: aTkyjTh3w5YLWiIERupZOA ($51.40 in chips)
Seat 4: bwv/rbH/hHhPhY6u9mu04w ($30.35 in chips)
Seat 5: mSD1pginDsyHG5PDfqzphw ($10 in chips)
Seat 6: +k7T5ocke8UwavtgUHm+Cg ($66.80 in chips)
Seat 7: IDtNLR9uFCDdjNsJWMHA5Q ($23.80 in chips)
Seat 8: a4JDWmpFQkL10XfAyuF51A ($27.75 in chips)
IDtNLR9uFCDdjNsJWMHA5Q: posts small blind $0.25
a4JDWmpFQkL10XfAyuF51A: posts big blind $0.50
*** HOLE CARDS ***
5k9fvXD9suIgCxU4HLQjTw: folds
UrcnkQOiLVk8BlKDPJSy7Q: folds
aTkyjTh3w5YLWiIERupZOA: raises $0.50 to $1
bwv/rbH/hHhPhY6u9mu04w: folds
mSD1pginDsyHG5PDfqzphw: folds
+k7T5ocke8UwavtgUHm+Cg: folds
IDtNLR9uFCDdjNsJWMHA5Q: folds
a4JDWmpFQkL10XfAyuF51A: folds
aTkyjTh3w5YLWiIERupZOA collected $1.25 from pot
aTkyjTh3w5YLWiIERupZOA: doesn't show hand
*** SUMMARY ***
Total pot $1.25 | Rake $0
Seat 1: 5k9fvXD9suIgCxU4HLQjTw folded before Flop (didn't bet)
Seat 2: UrcnkQOiLVk8BlKDPJSy7Q folded before Flop (didn't bet)
Seat 3: aTkyjTh3w5YLWiIERupZOA collected ($1.25)
Seat 4: bwv/rbH/hHhPhY6u9mu04w folded before Flop (didn't bet)
Seat 5: mSD1pginDsyHG5PDfqzphw folded before Flop (didn't bet)
Seat 6: +k7T5ocke8UwavtgUHm+Cg (button) folded before Flop (didn't bet)
Seat 7: IDtNLR9uFCDdjNsJWMHA5Q (small blind) folded before Flop
Seat 8: a4JDWmpFQkL10XfAyuF51A (big blind) folded before Flop



PokerStars Game #59940330290:  Hold'em No Limit ($0.25/$0.50) - 2009/07/01 1:03:36 ET
Table 'ZYI3ZReBjdfKEYItkZHI6A' 9-max Seat #7 is the button
Seat 1: E2518gp4aFz1+kAgmGqeEg ($14.85 in chips)
Seat 2: 8zdVaT8pZ/Wm0uWoeLhtZg ($7.50 in chips)
Seat 3: bkXkL3pmapikPQQRNPZSEA ($18.75 in chips)
Seat 4: e2+sK/yjnj94rXOKoxPP2A ($50 in chips)
Seat 5: ApHP7ouup365XIUFBdEDxg ($49.90 in chips)
Seat 6: Wj7mKnRFR90j40wWUu2+Og ($28.25 in chips)
Seat 7: HWcfp1hY1hqvrddzW3/FQw ($16 in chips)
Seat 8: ji04uOybxCdpdefzlUQeKQ ($28.25 in chips)
Seat 9: tLkxo7JgV+WWI0UBw44K5A ($51.60 in chips)
ji04uOybxCdpdefzlUQeKQ: posts small blind $0.25
tLkxo7JgV+WWI0UBw44K5A: posts big blind $0.50
*** HOLE CARDS ***
E2518gp4aFz1+kAgmGqeEg: folds
8zdVaT8pZ/Wm0uWoeLhtZg: folds
bkXkL3pmapikPQQRNPZSEA: folds
e2+sK/yjnj94rXOKoxPP2A: folds
ApHP7ouup365XIUFBdEDxg: calls $0.50
Wj7mKnRFR90j40wWUu2+Og: raises $2 to $2.50
HWcfp1hY1hqvrddzW3/FQw: folds
ji04uOybxCdpdefzlUQeKQ: folds
tLkxo7JgV+WWI0UBw44K5A: folds
ApHP7ouup365XIUFBdEDxg: calls $2
*** FLOP *** [9d 2h 2c]
ApHP7ouup365XIUFBdEDxg: checks
Wj7mKnRFR90j40wWUu2+Og: checks
*** TURN *** [9d 2h 2c] [Ac]
ApHP7ouup365XIUFBdEDxg: checks
Wj7mKnRFR90j40wWUu2+Og: checks
*** RIVER *** [9d 2h 2c Ac] [Ad]
ApHP7ouup365XIUFBdEDxg: bets $0.50
Wj7mKnRFR90j40wWUu2+Og: calls $0.50
*** SHOW DOWN ***
ApHP7ouup365XIUFBdEDxg: shows [4h 4c] (two pair, Aces and Fours)
Wj7mKnRFR90j40wWUu2+Og: shows [Qs 9s] (two pair, Aces and Nines)
Wj7mKnRFR90j40wWUu2+Og collected $6.45 from pot
*** SUMMARY ***
Total pot $6.75 | Rake $0.30
Board [9d 2h 2c Ac Ad]
Seat 1: E2518gp4aFz1+kAgmGqeEg folded before Flop (didn't bet)
Seat 2: 8zdVaT8pZ/Wm0uWoeLhtZg folded before Flop (didn't bet)
Seat 3: bkXkL3pmapikPQQRNPZSEA folded before Flop (didn't bet)
Seat 4: e2+sK/yjnj94rXOKoxPP2A folded before Flop (didn't bet)
Seat 5: ApHP7ouup365XIUFBdEDxg showed [4h 4c] and lost with two pair, Aces and Fours
Seat 6: Wj7mKnRFR90j40wWUu2+Og showed [Qs 9s] and won ($6.45) with two pair, Aces and Nines
Seat 7: HWcfp1hY1hqvrddzW3/FQw (button) folded before Flop (didn't bet)
Seat 8: ji04uOybxCdpdefzlUQeKQ (small blind) folded before Flop
Seat 9: tLkxo7JgV+WWI0UBw44K5A (big blind) folded before Flop



PokerStars Game #59940331912:  Hold'em No Limit ($0.25/$0.50) - 2009/07/01 1:03:38 ET
Table 'BCN5su+SsXiy1zRMJi0SJw' 6-max Seat #5 is the button
Seat 1: GxXV09ciXaOxyY2H5aMIIw ($42.30 in chips)
Seat 2: oU2kDCkT/gilYbHWrg7D8w ($43.60 in chips)
Seat 3: 6wzJiRvp8HY6t+MQGnSIzA ($11.55 in chips)
Seat 5: IBNygaT1aa9Z1uPdJJilwA ($43.30 in chips)
Seat 6: b2symlOdL7+0c9Pj4N/KlA ($54 in chips)
b2symlOdL7+0c9Pj4N/KlA: posts small blind $0.25
GxXV09ciXaOxyY2H5aMIIw: posts big blind $0.50
*** HOLE CARDS ***
oU2kDCkT/gilYbHWrg7D8w: folds
6wzJiRvp8HY6t+MQGnSIzA: folds
IBNygaT1aa9Z1uPdJJilwA: folds
b2symlOdL7+0c9Pj4N/KlA: raises $1.50 to $2
oU2kDCkT/gilYbHWrg7D8w said, "u on tilt 4sakn?"
qfeUHOJpMYyzQcj0o2A7ng leaves the table
GxXV09ciXaOxyY2H5aMIIw: folds
b2symlOdL7+0c9Pj4N/KlA collected $1 from pot
b2symlOdL7+0c9Pj4N/KlA: doesn't show hand
*** SUMMARY ***
Total pot $1 | Rake $0
Seat 1: GxXV09ciXaOxyY2H5aMIIw (big blind) folded before Flop
Seat 2: oU2kDCkT/gilYbHWrg7D8w folded before Flop (didn't bet)
Seat 3: 6wzJiRvp8HY6t+MQGnSIzA folded before Flop (didn't bet)
Seat 5: IBNygaT1aa9Z1uPdJJilwA (button) folded before Flop (didn't bet)
Seat 6: b2symlOdL7+0c9Pj4N/KlA (small blind) collected ($1)



PokerStars Game #59940331548:  Hold'em No Limit ($0.25/$0.50) - 2009/07/01 1:03:38 ET
Table 'E7bWJ45aoFXRpyRv2gw+Ig' 2-max Seat #1 is the button
Seat 1: FRkiRasEGlHUeLrEl+k/nA ($54.75 in chips)
Seat 2: 3Wro85I7472vJ4Wkpneo9A ($133.65 in chips)
FRkiRasEGlHUeLrEl+k/nA: posts small blind $0.25
3Wro85I7472vJ4Wkpneo9A: posts big blind $0.50
*** HOLE CARDS ***
FRkiRasEGlHUeLrEl+k/nA: folds
3Wro85I7472vJ4Wkpneo9A collected $0.50 from pot
3Wro85I7472vJ4Wkpneo9A: doesn't show hand
*** SUMMARY ***
Total pot $0.50 | Rake $0
Seat 1: FRkiRasEGlHUeLrEl+k/nA (button) (small blind) folded before Flop
Seat 2: 3Wro85I7472vJ4Wkpneo9A (big blind) collected ($0.50)



PokerStars Game #59940332442:  Hold'em No Limit ($0.25/$0.50) - 2009/07/01 1:03:39 ET
Table '0eJtgVAXVvBgncFdcUpXcQ' 2-max Seat #1 is the button
Seat 1: Ag6DvxX4vbRheqsv2zXKTQ ($33.60 in chips)
Seat 2: KMc4R+K9ao4Ur3rF7NGe6Q ($13.75 in chips)
Ag6DvxX4vbRheqsv2zXKTQ: posts small blind $0.25
KMc4R+K9ao4Ur3rF7NGe6Q: posts big blind $0.50
*** HOLE CARDS ***
Ag6DvxX4vbRheqsv2zXKTQ: folds
KMc4R+K9ao4Ur3rF7NGe6Q collected $0.50 from pot
KMc4R+K9ao4Ur3rF7NGe6Q: doesn't show hand
*** SUMMARY ***
Total pot $0.50 | Rake $0
Seat 1: Ag6DvxX4vbRheqsv2zXKTQ (button) (small blind) folded before Flop
Seat 2: KMc4R+K9ao4Ur3rF7NGe6Q (big blind) collected ($0.50)



PokerStars Game #59940334040:  Hold'em No Limit ($0.25/$0.50) - 2009/07/01 1:03:42 ET
Table 'GfL/No5u5PoEnU39lP5pQg' 6-max Seat #2 is the button
Seat 1: 1WUCqNG+p+vfWRTXNu4ljw ($71 in chips)
Seat 2: uVwggSetzp7d+eVgowO3vg ($55 in chips)
Seat 3: eQXFICMuu3hw6XlcmuVNEA ($12.55 in chips)
Seat 4: r6u7MWSXF30/khcTYkrG9Q ($41.40 in chips)
Seat 5: M1KyQQvVPVuxqTAB8sR/zQ ($50.75 in chips)
Seat 6: kxPhs4ePFqMy52CInAJ2aw ($48.50 in chips)
eQXFICMuu3hw6XlcmuVNEA: posts small blind $0.25
r6u7MWSXF30/khcTYkrG9Q: posts big blind $0.50
*** HOLE CARDS ***
r6u7MWSXF30/khcTYkrG9Q said, "QQ, that was an ugly preflop and an even uglier flop"
M1KyQQvVPVuxqTAB8sR/zQ: folds
kxPhs4ePFqMy52CInAJ2aw: folds
1WUCqNG+p+vfWRTXNu4ljw: raises $1.50 to $2
uVwggSetzp7d+eVgowO3vg: calls $2
eQXFICMuu3hw6XlcmuVNEA: folds
r6u7MWSXF30/khcTYkrG9Q: folds
*** FLOP *** [3d 8d 5d]
1WUCqNG+p+vfWRTXNu4ljw: bets $3
uVwggSetzp7d+eVgowO3vg: calls $3
*** TURN *** [3d 8d 5d] [9h]
1WUCqNG+p+vfWRTXNu4ljw: checks
uVwggSetzp7d+eVgowO3vg: bets $6
1WUCqNG+p+vfWRTXNu4ljw: folds
uVwggSetzp7d+eVgowO3vg collected $10.25 from pot
uVwggSetzp7d+eVgowO3vg: doesn't show hand
*** SUMMARY ***
Total pot $10.75 | Rake $0.50
Board [3d 8d 5d 9h]
Seat 1: 1WUCqNG+p+vfWRTXNu4ljw folded on the Turn
Seat 2: uVwggSetzp7d+eVgowO3vg (button) collected ($10.25)
Seat 3: eQXFICMuu3hw6XlcmuVNEA (small blind) folded before Flop
Seat 4: r6u7MWSXF30/khcTYkrG9Q (big blind) folded before Flop
Seat 5: M1KyQQvVPVuxqTAB8sR/zQ folded before Flop (didn't bet)
Seat 6: kxPhs4ePFqMy52CInAJ2aw folded before Flop (didn't bet)



PokerStars Game #59940334324:  Hold'em No Limit ($0.25/$0.50) - 2009/07/01 1:03:42 ET
Table 'Nz0Vr7WMHL2g5Uk7dDZjpw' 9-max Seat #5 is the button
Seat 1: tLkxo7JgV+WWI0UBw44K5A ($109.85 in chips)
Seat 2: gsyXT42WLEcOS4DdEk2wlw ($29.25 in chips)
Seat 4: E2518gp4aFz1+kAgmGqeEg ($13.30 in chips)
Seat 5: WGW0DgjBUXs1ylURHG8vnQ ($26.35 in chips)
Seat 6: 997ViqAtWn1FPjJqcffwcA ($60.05 in chips)
Seat 7: KPLH0gELgFe2OuAnhJFI5w ($14.85 in chips)
Seat 8: HkZI6g4zl83TDTA7SRspmQ ($28.40 in chips)
Seat 9: mSD1pginDsyHG5PDfqzphw ($10 in chips)
997ViqAtWn1FPjJqcffwcA: posts small blind $0.25
KPLH0gELgFe2OuAnhJFI5w: posts big blind $0.50
*** HOLE CARDS ***
HkZI6g4zl83TDTA7SRspmQ: folds
mSD1pginDsyHG5PDfqzphw: folds
tLkxo7JgV+WWI0UBw44K5A: raises $1 to $1.50
gsyXT42WLEcOS4DdEk2wlw: folds
E2518gp4aFz1+kAgmGqeEg: folds
WGW0DgjBUXs1ylURHG8vnQ: folds
997ViqAtWn1FPjJqcffwcA: folds
KPLH0gELgFe2OuAnhJFI5w: folds
tLkxo7JgV+WWI0UBw44K5A collected $1.25 from pot
*** SUMMARY ***
Total pot $1.25 | Rake $0
Seat 1: tLkxo7JgV+WWI0UBw44K5A collected ($1.25)
Seat 2: gsyXT42WLEcOS4DdEk2wlw folded before Flop (didn't bet)
Seat 4: E2518gp4aFz1+kAgmGqeEg folded before Flop (didn't bet)
Seat 5: WGW0DgjBUXs1ylURHG8vnQ (button) folded before Flop (didn't bet)
Seat 6: 997ViqAtWn1FPjJqcffwcA (small blind) folded before Flop
Seat 7: KPLH0gELgFe2OuAnhJFI5w (big blind) folded before Flop
Seat 8: HkZI6g4zl83TDTA7SRspmQ folded before Flop (didn't bet)
Seat 9: mSD1pginDsyHG5PDfqzphw folded before Flop (didn't bet)



PokerStars Game #59940334374:  Hold'em No Limit ($0.25/$0.50) - 2009/07/01 1:03:42 ET
Table 'NCiXr0d5CEKBQr/cZgLhbA' 9-max Seat #3 is the button
Seat 1: pFtzb1sR4b0d1aw6aIRgDg ($50 in chips)
Seat 2: ulxuJchBV9iguXg0FUonfg ($48.70 in chips)
Seat 3: xZCXQSXlrZkp3pZizzVXCw ($51.95 in chips)
Seat 4: 5k9fvXD9suIgCxU4HLQjTw ($54.70 in chips)
Seat 5: zE9cVigS2nW/Ljy4K4bUQA ($33.30 in chips)
Seat 6: SKnJuWHScqetA/qG5p+wCg ($32.75 in chips)
Seat 7: M+7+BTmX5vZatHVuoRB1nA ($52.75 in chips)
Seat 8: 1MJUKc3cc0QmUoz1JZLR2w ($64.05 in chips)
Seat 9: 4WLZvqBn5qv5tds5kt5A1Q ($41.65 in chips)
5k9fvXD9suIgCxU4HLQjTw: posts small blind $0.25
zE9cVigS2nW/Ljy4K4bUQA: posts big blind $0.50
*** HOLE CARDS ***
SKnJuWHScqetA/qG5p+wCg: folds
M+7+BTmX5vZatHVuoRB1nA: folds
1MJUKc3cc0QmUoz1JZLR2w: folds
4WLZvqBn5qv5tds5kt5A1Q: calls $0.50
pFtzb1sR4b0d1aw6aIRgDg: calls $0.50
ulxuJchBV9iguXg0FUonfg: calls $0.50
xZCXQSXlrZkp3pZizzVXCw: folds
5k9fvXD9suIgCxU4HLQjTw: folds
zE9cVigS2nW/Ljy4K4bUQA: checks
*** FLOP *** [Qs 3h As]
zE9cVigS2nW/Ljy4K4bUQA: checks
4WLZvqBn5qv5tds5kt5A1Q: checks
pFtzb1sR4b0d1aw6aIRgDg: bets $1
ulxuJchBV9iguXg0FUonfg: calls $1
zE9cVigS2nW/Ljy4K4bUQA: folds
4WLZvqBn5qv5tds5kt5A1Q: calls $1
*** TURN *** [Qs 3h As] [7d]
4WLZvqBn5qv5tds5kt5A1Q: checks
pFtzb1sR4b0d1aw6aIRgDg: checks
ulxuJchBV9iguXg0FUonfg: bets $3.50
4WLZvqBn5qv5tds5kt5A1Q: folds
pFtzb1sR4b0d1aw6aIRgDg: folds
ulxuJchBV9iguXg0FUonfg collected $5 from pot
*** SUMMARY ***
Total pot $5.25 | Rake $0.25
Board [Qs 3h As 7d]
Seat 1: pFtzb1sR4b0d1aw6aIRgDg folded on the Turn
Seat 2: ulxuJchBV9iguXg0FUonfg collected ($5)
Seat 3: xZCXQSXlrZkp3pZizzVXCw (button) folded before Flop (didn't bet)
Seat 4: 5k9fvXD9suIgCxU4HLQjTw (small blind) folded before Flop
Seat 5: zE9cVigS2nW/Ljy4K4bUQA (big blind) folded on the Flop
Seat 6: SKnJuWHScqetA/qG5p+wCg folded before Flop (didn't bet)
Seat 7: M+7+BTmX5vZatHVuoRB1nA folded before Flop (didn't bet)
Seat 8: 1MJUKc3cc0QmUoz1JZLR2w folded before Flop (didn't bet)
Seat 9: 4WLZvqBn5qv5tds5kt5A1Q folded on the Turn



PokerStars Game #59940335424:  Hold'em No Limit ($0.25/$0.50) - 2009/07/01 1:03:44 ET
Table 'E7bWJ45aoFXRpyRv2gw+Ig' 2-max Seat #2 is the button
Seat 1: FRkiRasEGlHUeLrEl+k/nA ($54.50 in chips)
Seat 2: 3Wro85I7472vJ4Wkpneo9A ($133.90 in chips)
3Wro85I7472vJ4Wkpneo9A: posts small blind $0.25
FRkiRasEGlHUeLrEl+k/nA: posts big blind $0.50
*** HOLE CARDS ***
3Wro85I7472vJ4Wkpneo9A: raises $1 to $1.50
FRkiRasEGlHUeLrEl+k/nA: calls $1
*** FLOP *** [Tc Js Ac]
FRkiRasEGlHUeLrEl+k/nA: checks
3Wro85I7472vJ4Wkpneo9A: checks
*** TURN *** [Tc Js Ac] [2s]
FRkiRasEGlHUeLrEl+k/nA: checks
3Wro85I7472vJ4Wkpneo9A: bets $2
FRkiRasEGlHUeLrEl+k/nA: folds
3Wro85I7472vJ4Wkpneo9A collected $2.85 from pot
3Wro85I7472vJ4Wkpneo9A: doesn't show hand
*** SUMMARY ***
Total pot $3 | Rake $0.15
Board [Tc Js Ac 2s]
Seat 1: FRkiRasEGlHUeLrEl+k/nA (big blind) folded on the Turn
Seat 2: 3Wro85I7472vJ4Wkpneo9A (button) (small blind) collected ($2.85)



PokerStars Game #59940335644:  Hold'em No Limit ($0.25/$0.50) - 2009/07/01 1:03:45 ET
Table '0eJtgVAXVvBgncFdcUpXcQ' 2-max Seat #2 is the button
Seat 1: Ag6DvxX4vbRheqsv2zXKTQ ($33.35 in chips)
Seat 2: KMc4R+K9ao4Ur3rF7NGe6Q ($14 in chips)
KMc4R+K9ao4Ur3rF7NGe6Q: posts small blind $0.25
Ag6DvxX4vbRheqsv2zXKTQ: posts big blind $0.50
*** HOLE CARDS ***
KMc4R+K9ao4Ur3rF7NGe6Q: calls $0.25
Ag6DvxX4vbRheqsv2zXKTQ: checks
*** FLOP *** [Qh 2c Jc]
Ag6DvxX4vbRheqsv2zXKTQ: checks
KMc4R+K9ao4Ur3rF7NGe6Q: checks
*** TURN *** [Qh 2c Jc] [Js]
Ag6DvxX4vbRheqsv2zXKTQ: bets $1
KMc4R+K9ao4Ur3rF7NGe6Q: folds
Ag6DvxX4vbRheqsv2zXKTQ collected $0.95 from pot
*** SUMMARY ***
Total pot $1 | Rake $0.05
Board [Qh 2c Jc Js]
Seat 1: Ag6DvxX4vbRheqsv2zXKTQ (big blind) collected ($0.95)
Seat 2: KMc4R+K9ao4Ur3rF7NGe6Q (button) (small blind) folded on the Turn



PokerStars Game #59940335834:  Hold'em No Limit ($0.25/$0.50) - 2009/07/01 1:03:45 ET
Table 'EiNh8p/wGJ1FP575iMFnqg' 9-max Seat #5 is the button
Seat 1: r3ZqM1Mi0W3y4hOdssE+Sg ($44.85 in chips)
Seat 2: 8ehL7qlZzjgUh2H35iiWLw ($54.15 in chips)
Seat 3: ymLPoEIl7UL3TvZYmnadxQ ($51.55 in chips)
Seat 4: cMzaiXAM/ZAdNaEUu+LqhA ($54.95 in chips)
Seat 5: M+7+BTmX5vZatHVuoRB1nA ($80.45 in chips)
Seat 6: 3UmXLy3GfjC3EkOebduerQ ($63.60 in chips)
Seat 7: 997ViqAtWn1FPjJqcffwcA ($50 in chips)
Seat 8: mSD1pginDsyHG5PDfqzphw ($11.60 in chips)
Seat 9: NnQCepdIR/AOUQn1yhYx6Q ($11.75 in chips)
3UmXLy3GfjC3EkOebduerQ: posts small blind $0.25
997ViqAtWn1FPjJqcffwcA: posts big blind $0.50
*** HOLE CARDS ***
mSD1pginDsyHG5PDfqzphw: folds
NnQCepdIR/AOUQn1yhYx6Q: folds
r3ZqM1Mi0W3y4hOdssE+Sg: folds
8ehL7qlZzjgUh2H35iiWLw: folds
ymLPoEIl7UL3TvZYmnadxQ: folds
cMzaiXAM/ZAdNaEUu+LqhA: folds
M+7+BTmX5vZatHVuoRB1nA: folds
3UmXLy3GfjC3EkOebduerQ: raises $1.50 to $2
997ViqAtWn1FPjJqcffwcA: folds
3UmXLy3GfjC3EkOebduerQ collected $1 from pot
3UmXLy3GfjC3EkOebduerQ: doesn't show hand
*** SUMMARY ***
Total pot $1 | Rake $0
Seat 1: r3ZqM1Mi0W3y4hOdssE+Sg folded before Flop (didn't bet)
Seat 2: 8ehL7qlZzjgUh2H35iiWLw folded before Flop (didn't bet)
Seat 3: ymLPoEIl7UL3TvZYmnadxQ folded before Flop (didn't bet)
Seat 4: cMzaiXAM/ZAdNaEUu+LqhA folded before Flop (didn't bet)
Seat 5: M+7+BTmX5vZatHVuoRB1nA (button) folded before Flop (didn't bet)
Seat 6: 3UmXLy3GfjC3EkOebduerQ (small blind) collected ($1)
Seat 7: 997ViqAtWn1FPjJqcffwcA (big blind) folded before Flop
Seat 8: mSD1pginDsyHG5PDfqzphw folded before Flop (didn't bet)
Seat 9: NnQCepdIR/AOUQn1yhYx6Q folded before Flop (didn't bet)



PokerStars Game #59940338390:  Hold'em No Limit ($0.25/$0.50) - 2009/07/01 1:03:49 ET
Table 'c/CRn+68J3Y8KxD5g1ek2Q' 2-max Seat #2 is the button
Seat 1: 46qCyJ6evTkHo9al5sBMNA ($92.45 in chips)
Seat 2: BypVLsYQt3ePFm2xQL/dOA ($274.95 in chips)
BypVLsYQt3ePFm2xQL/dOA: posts small blind $0.25
46qCyJ6evTkHo9al5sBMNA: posts big blind $0.50
*** HOLE CARDS ***
BypVLsYQt3ePFm2xQL/dOA: calls $0.25
46qCyJ6evTkHo9al5sBMNA: raises $1.50 to $2
BypVLsYQt3ePFm2xQL/dOA: folds
46qCyJ6evTkHo9al5sBMNA collected $1 from pot
46qCyJ6evTkHo9al5sBMNA: doesn't show hand
*** SUMMARY ***
Total pot $1 | Rake $0
Seat 1: 46qCyJ6evTkHo9al5sBMNA (big blind) collected ($1)
Seat 2: BypVLsYQt3ePFm2xQL/dOA (button) (small blind) folded before Flop



PokerStars Game #59940340066:  Hold'em No Limit ($0.25/$0.50) - 2009/07/01 1:03:52 ET
Table 'BCN5su+SsXiy1zRMJi0SJw' 6-max Seat #6 is the button
Seat 1: GxXV09ciXaOxyY2H5aMIIw ($41.80 in chips)
Seat 2: oU2kDCkT/gilYbHWrg7D8w ($43.60 in chips)
Seat 3: 6wzJiRvp8HY6t+MQGnSIzA ($11.55 in chips)
Seat 5: IBNygaT1aa9Z1uPdJJilwA ($43.30 in chips)
Seat 6: b2symlOdL7+0c9Pj4N/KlA ($54.50 in chips)
GxXV09ciXaOxyY2H5aMIIw: posts small blind $0.25
oU2kDCkT/gilYbHWrg7D8w: posts big blind $0.50
*** HOLE CARDS ***
oU2kDCkT/gilYbHWrg7D8w said, "dusty.... calm down"
6wzJiRvp8HY6t+MQGnSIzA: folds
IBNygaT1aa9Z1uPdJJilwA: folds
b2symlOdL7+0c9Pj4N/KlA: raises $1 to $1.50
oU2kDCkT/gilYbHWrg7D8w said, "dussty good bye"
4QfsCWthT/vSLirorNXqtg joins the table at seat #4
GxXV09ciXaOxyY2H5aMIIw: folds
oU2kDCkT/gilYbHWrg7D8w: calls $1
*** FLOP *** [9h 8c Qs]
oU2kDCkT/gilYbHWrg7D8w: checks
b2symlOdL7+0c9Pj4N/KlA: bets $2
oU2kDCkT/gilYbHWrg7D8w: folds
6wzJiRvp8HY6t+MQGnSIzA said, "i dont play on tilt"
b2symlOdL7+0c9Pj4N/KlA collected $3.10 from pot
b2symlOdL7+0c9Pj4N/KlA: doesn't show hand
*** SUMMARY ***
Total pot $3.25 | Rake $0.15
Board [9h 8c Qs]
Seat 1: GxXV09ciXaOxyY2H5aMIIw (small blind) folded before Flop
Seat 2: oU2kDCkT/gilYbHWrg7D8w (big blind) folded on the Flop
Seat 3: 6wzJiRvp8HY6t+MQGnSIzA folded before Flop (didn't bet)
Seat 5: IBNygaT1aa9Z1uPdJJilwA folded before Flop (didn't bet)
Seat 6: b2symlOdL7+0c9Pj4N/KlA (button) collected ($3.10)



PokerStars Game #59940340504:  Hold'em No Limit ($0.25/$0.50) - 2009/07/01 1:03:53 ET
Table 'tYh970kmVfYS0gXPT/XtoQ' 2-max Seat #2 is the button
Seat 1: mW7WbnOUOr5szbwJvGciAA ($30.70 in chips)
Seat 2: dokz3oqYBKI5gNELbiWhbQ ($21.25 in chips)
dokz3oqYBKI5gNELbiWhbQ: posts small blind $0.25
mW7WbnOUOr5szbwJvGciAA: posts big blind $0.50
*** HOLE CARDS ***
dokz3oqYBKI5gNELbiWhbQ: raises $1 to $1.50
mW7WbnOUOr5szbwJvGciAA: calls $1
*** FLOP *** [Js 4s Ks]
mW7WbnOUOr5szbwJvGciAA: checks
dokz3oqYBKI5gNELbiWhbQ: checks
*** TURN *** [Js 4s Ks] [Jh]
mW7WbnOUOr5szbwJvGciAA: checks
dokz3oqYBKI5gNELbiWhbQ: bets $1
mW7WbnOUOr5szbwJvGciAA: folds
dokz3oqYBKI5gNELbiWhbQ collected $2.85 from pot
*** SUMMARY ***
Total pot $3 | Rake $0.15
Board [Js 4s Ks Jh]
Seat 1: mW7WbnOUOr5szbwJvGciAA (big blind) folded on the Turn
Seat 2: dokz3oqYBKI5gNELbiWhbQ (button) (small blind) collected ($2.85)



PokerStars Game #59940341286:  Hold'em No Limit ($0.25/$0.50) - 2009/07/01 1:03:54 ET
Table 'fx6MqwfYAj/Rt86hBz2L3Q' 9-max Seat #9 is the button
Seat 1: uw9QayAAxLM3Hb+HR7mSkg ($9.50 in chips)
Seat 2: C3rGXblctNcWI6JYPHhaEg ($25 in chips)
Seat 3: iadBi5AEt7gTBXbDSSnMYQ ($54.65 in chips)
Seat 4: 75K2MXwN65Sjfp1yHd50Hg ($9.25 in chips)
Seat 5: iAISe3dVeua8PUn2wwgDHw ($61.25 in chips)
Seat 6: 5k9fvXD9suIgCxU4HLQjTw ($50.75 in chips)
Seat 7: SKnJuWHScqetA/qG5p+wCg ($30 in chips)
Seat 8: JYwJYYV9pM5KWdSiETl8rA ($21.25 in chips)
Seat 9: HZkVla4kK2SI42CVrPZ/ig ($9.25 in chips)
uw9QayAAxLM3Hb+HR7mSkg: posts small blind $0.25
C3rGXblctNcWI6JYPHhaEg: posts big blind $0.50
*** HOLE CARDS ***
iadBi5AEt7gTBXbDSSnMYQ: calls $0.50
75K2MXwN65Sjfp1yHd50Hg: folds
iAISe3dVeua8PUn2wwgDHw: folds
5k9fvXD9suIgCxU4HLQjTw: folds
SKnJuWHScqetA/qG5p+wCg: calls $0.50
JYwJYYV9pM5KWdSiETl8rA: folds
HZkVla4kK2SI42CVrPZ/ig: raises $1.50 to $2
uw9QayAAxLM3Hb+HR7mSkg: folds
C3rGXblctNcWI6JYPHhaEg: folds
iadBi5AEt7gTBXbDSSnMYQ: raises $2 to $4
SKnJuWHScqetA/qG5p+wCg: folds
HZkVla4kK2SI42CVrPZ/ig: raises $5.25 to $9.25 and is all-in
iadBi5AEt7gTBXbDSSnMYQ: calls $5.25
*** FLOP *** [Qh 6h 8h]
*** TURN *** [Qh 6h 8h] [Th]
*** RIVER *** [Qh 6h 8h Th] [3c]
*** SHOW DOWN ***
iadBi5AEt7gTBXbDSSnMYQ: shows [8s 9s] (a pair of Eights)
HZkVla4kK2SI42CVrPZ/ig: shows [Kh Kc] (a flush, King high)
HZkVla4kK2SI42CVrPZ/ig collected $18.80 from pot
*** SUMMARY ***
Total pot $19.75 | Rake $0.95
Board [Qh 6h 8h Th 3c]
Seat 1: uw9QayAAxLM3Hb+HR7mSkg (small blind) folded before Flop
Seat 2: C3rGXblctNcWI6JYPHhaEg (big blind) folded before Flop
Seat 3: iadBi5AEt7gTBXbDSSnMYQ showed [8s 9s] and lost with a pair of Eights
Seat 4: 75K2MXwN65Sjfp1yHd50Hg folded before Flop (didn't bet)
Seat 5: iAISe3dVeua8PUn2wwgDHw folded before Flop (didn't bet)
Seat 6: 5k9fvXD9suIgCxU4HLQjTw folded before Flop (didn't bet)
Seat 7: SKnJuWHScqetA/qG5p+wCg folded before Flop
Seat 8: JYwJYYV9pM5KWdSiETl8rA folded before Flop (didn't bet)
Seat 9: HZkVla4kK2SI42CVrPZ/ig (button) showed [Kh Kc] and won ($18.80) with a flush, King high



PokerStars Game #59940341544:  Hold'em No Limit ($0.25/$0.50) - 2009/07/01 1:03:55 ET
Table '+z1aekfHkpp09pc8F9aViw' 6-max Seat #3 is the button
Seat 1: FHilMb2i2DbUCc9lplszog ($19.90 in chips)
Seat 3: uUznlIMFnRUvwrBhYF73KA ($133.15 in chips)
Seat 4: RowCSpSURHTOL/dcjg/Iug ($37.55 in chips)
Seat 5: rplyldNweS6YyMNEALQrug ($51.40 in chips)
Seat 6: 686aeHikcJlgKkSuIFdcXQ ($50 in chips)
RowCSpSURHTOL/dcjg/Iug: posts small blind $0.25
rplyldNweS6YyMNEALQrug: posts big blind $0.50
of9mtXiD8G4Nx5p7hCbgqQ: sits out
*** HOLE CARDS ***
686aeHikcJlgKkSuIFdcXQ: folds
FHilMb2i2DbUCc9lplszog: raises $1 to $1.50
uUznlIMFnRUvwrBhYF73KA: calls $1.50
RowCSpSURHTOL/dcjg/Iug: folds
rplyldNweS6YyMNEALQrug: calls $1
*** FLOP *** [5h Ts 3h]
rplyldNweS6YyMNEALQrug: checks
FHilMb2i2DbUCc9lplszog: checks
uUznlIMFnRUvwrBhYF73KA: checks
*** TURN *** [5h Ts 3h] [Td]
rplyldNweS6YyMNEALQrug: checks
FHilMb2i2DbUCc9lplszog: checks
uUznlIMFnRUvwrBhYF73KA: checks
*** RIVER *** [5h Ts 3h Td] [4h]
of9mtXiD8G4Nx5p7hCbgqQ leaves the table
rplyldNweS6YyMNEALQrug: bets $5
FHilMb2i2DbUCc9lplszog: folds
uUznlIMFnRUvwrBhYF73KA: folds
rplyldNweS6YyMNEALQrug collected $4.55 from pot
*** SUMMARY ***
Total pot $4.75 | Rake $0.20
Board [5h Ts 3h Td 4h]
Seat 1: FHilMb2i2DbUCc9lplszog folded on the River
Seat 3: uUznlIMFnRUvwrBhYF73KA (button) folded on the River
Seat 4: RowCSpSURHTOL/dcjg/Iug (small blind) folded before Flop
Seat 5: rplyldNweS6YyMNEALQrug (big blind) collected ($4.55)
Seat 6: 686aeHikcJlgKkSuIFdcXQ folded before Flop (didn't bet)



PokerStars Game #59940342238:  Hold'em No Limit ($0.25/$0.50) - 2009/07/01 1:03:56 ET
Table 'otvGDROEDdqsabxskT79qg' 9-max Seat #7 is the button
Seat 1: 8ehL7qlZzjgUh2H35iiWLw ($56.75 in chips)
Seat 2: cCjTzH9jio8607WzjcfXlg ($14.25 in chips)
Seat 3: +k7T5ocke8UwavtgUHm+Cg ($70.60 in chips)
Seat 4: MG90wfSJZnOejs/KD3vlQQ ($76.65 in chips)
Seat 5: E2518gp4aFz1+kAgmGqeEg ($11.75 in chips)
Seat 6: bxLSulbgr8LmKNjOzw8URg ($52.95 in chips)
Seat 7: 75K2MXwN65Sjfp1yHd50Hg ($9.25 in chips)
Seat 8: zE9cVigS2nW/Ljy4K4bUQA ($30.25 in chips)
Seat 9: KcY3X8YpD74Kw1RHkx/g4A ($51.15 in chips)
zE9cVigS2nW/Ljy4K4bUQA: posts small blind $0.25
KcY3X8YpD74Kw1RHkx/g4A: posts big blind $0.50
*** HOLE CARDS ***
8ehL7qlZzjgUh2H35iiWLw: folds
cCjTzH9jio8607WzjcfXlg: calls $0.50
+k7T5ocke8UwavtgUHm+Cg: folds
MG90wfSJZnOejs/KD3vlQQ: folds
E2518gp4aFz1+kAgmGqeEg: folds
bxLSulbgr8LmKNjOzw8URg: raises $1.50 to $2
75K2MXwN65Sjfp1yHd50Hg: folds
zE9cVigS2nW/Ljy4K4bUQA: folds
KcY3X8YpD74Kw1RHkx/g4A: folds
cCjTzH9jio8607WzjcfXlg: calls $1.50
*** FLOP *** [5h Kh 5d]
cCjTzH9jio8607WzjcfXlg: checks
bxLSulbgr8LmKNjOzw8URg: bets $2
cCjTzH9jio8607WzjcfXlg: folds
bxLSulbgr8LmKNjOzw8URg collected $4.55 from pot
bxLSulbgr8LmKNjOzw8URg: doesn't show hand
*** SUMMARY ***
Total pot $4.75 | Rake $0.20
Board [5h Kh 5d]
Seat 1: 8ehL7qlZzjgUh2H35iiWLw folded before Flop (didn't bet)
Seat 2: cCjTzH9jio8607WzjcfXlg folded on the Flop
Seat 3: +k7T5ocke8UwavtgUHm+Cg folded before Flop (didn't bet)
Seat 4: MG90wfSJZnOejs/KD3vlQQ folded before Flop (didn't bet)
Seat 5: E2518gp4aFz1+kAgmGqeEg folded before Flop (didn't bet)
Seat 6: bxLSulbgr8LmKNjOzw8URg collected ($4.55)
Seat 7: 75K2MXwN65Sjfp1yHd50Hg (button) folded before Flop (didn't bet)
Seat 8: zE9cVigS2nW/Ljy4K4bUQA (small blind) folded before Flop
Seat 9: KcY3X8YpD74Kw1RHkx/g4A (big blind) folded before Flop



PokerStars Game #59940343366:  Hold'em No Limit ($0.25/$0.50) - 2009/07/01 1:03:57 ET
Table '0eJtgVAXVvBgncFdcUpXcQ' 2-max Seat #1 is the button
Seat 1: Ag6DvxX4vbRheqsv2zXKTQ ($33.80 in chips)
Seat 2: KMc4R+K9ao4Ur3rF7NGe6Q ($13.50 in chips)
Ag6DvxX4vbRheqsv2zXKTQ: posts small blind $0.25
KMc4R+K9ao4Ur3rF7NGe6Q: posts big blind $0.50
*** HOLE CARDS ***
Ag6DvxX4vbRheqsv2zXKTQ: raises $1 to $1.50
KMc4R+K9ao4Ur3rF7NGe6Q: calls $1
*** FLOP *** [8c Jh 3c]
KMc4R+K9ao4Ur3rF7NGe6Q: bets $1.50
Ag6DvxX4vbRheqsv2zXKTQ: calls $1.50
*** TURN *** [8c Jh 3c] [4h]
KMc4R+K9ao4Ur3rF7NGe6Q: checks
Ag6DvxX4vbRheqsv2zXKTQ: bets $2
KMc4R+K9ao4Ur3rF7NGe6Q: raises $2.50 to $4.50
Ag6DvxX4vbRheqsv2zXKTQ: calls $2.50
*** RIVER *** [8c Jh 3c 4h] [7c]
KMc4R+K9ao4Ur3rF7NGe6Q: bets $3
Ag6DvxX4vbRheqsv2zXKTQ: calls $3
*** SHOW DOWN ***
KMc4R+K9ao4Ur3rF7NGe6Q: shows [Ks 9s] (high card King)
Ag6DvxX4vbRheqsv2zXKTQ: shows [Js Ts] (a pair of Jacks)
Ag6DvxX4vbRheqsv2zXKTQ collected $20.50 from pot
*** SUMMARY ***
Total pot $21 | Rake $0.50
Board [8c Jh 3c 4h 7c]
Seat 1: Ag6DvxX4vbRheqsv2zXKTQ (button) (small blind) showed [Js Ts] and won ($20.50) with a pair of Jacks
Seat 2: KMc4R+K9ao4Ur3rF7NGe6Q (big blind) showed [Ks 9s] and lost with high card King



PokerStars Game #59940343896:  Hold'em No Limit ($0.25/$0.50) - 2009/07/01 1:03:58 ET
Table '37qXEp3oe+er5q4CZip9eQ' 6-max Seat #4 is the button
Seat 1: oqOqoO2AyCZenUghCxMDxw ($50 in chips)
Seat 2: LvH4G7n+QSjT6NDaD3cREA ($56.55 in chips)
Seat 3: Rt6KgtZ8YaJoTc3FPim00w ($110.20 in chips)
Seat 4: XsmE8nXMAAMFJbWaJTmHFw ($39.85 in chips)
Seat 5: VOmI0x4dDPnTESZd5B4d1Q ($39 in chips)
Seat 6: N50kln4negd8q7Mmoz1j4g ($18.35 in chips)
VOmI0x4dDPnTESZd5B4d1Q: posts small blind $0.25
N50kln4negd8q7Mmoz1j4g: posts big blind $0.50
*** HOLE CARDS ***
VOmI0x4dDPnTESZd5B4d1Q said, "maybe just this table"
oqOqoO2AyCZenUghCxMDxw: raises $1 to $1.50
LvH4G7n+QSjT6NDaD3cREA: folds
Rt6KgtZ8YaJoTc3FPim00w: folds
XsmE8nXMAAMFJbWaJTmHFw: folds
VOmI0x4dDPnTESZd5B4d1Q: calls $1.25
N50kln4negd8q7Mmoz1j4g: calls $1
*** FLOP *** [Tc Ks 8d]
VOmI0x4dDPnTESZd5B4d1Q: checks
N50kln4negd8q7Mmoz1j4g: checks
oqOqoO2AyCZenUghCxMDxw: checks
*** TURN *** [Tc Ks 8d] [4h]
VOmI0x4dDPnTESZd5B4d1Q: bets $2
XsmE8nXMAAMFJbWaJTmHFw said, "I don't know. Don't play many of them"
N50kln4negd8q7Mmoz1j4g: folds
oqOqoO2AyCZenUghCxMDxw: folds
VOmI0x4dDPnTESZd5B4d1Q collected $4.30 from pot
*** SUMMARY ***
Total pot $4.50 | Rake $0.20
Board [Tc Ks 8d 4h]
Seat 1: oqOqoO2AyCZenUghCxMDxw folded on the Turn
Seat 2: LvH4G7n+QSjT6NDaD3cREA folded before Flop (didn't bet)
Seat 3: Rt6KgtZ8YaJoTc3FPim00w folded before Flop (didn't bet)
Seat 4: XsmE8nXMAAMFJbWaJTmHFw (button) folded before Flop (didn't bet)
Seat 5: VOmI0x4dDPnTESZd5B4d1Q (small blind) collected ($4.30)
Seat 6: N50kln4negd8q7Mmoz1j4g (big blind) folded on the Turn



PokerStars Game #59940346206:  Hold'em No Limit ($0.25/$0.50) - 2009/07/01 1:04:02 ET
Table 'c/CRn+68J3Y8KxD5g1ek2Q' 2-max Seat #1 is the button
Seat 1: 46qCyJ6evTkHo9al5sBMNA ($92.95 in chips)
Seat 2: BypVLsYQt3ePFm2xQL/dOA ($274.45 in chips)
46qCyJ6evTkHo9al5sBMNA: posts small blind $0.25
BypVLsYQt3ePFm2xQL/dOA: posts big blind $0.50
*** HOLE CARDS ***
46qCyJ6evTkHo9al5sBMNA: raises $1.50 to $2
BypVLsYQt3ePFm2xQL/dOA: folds
46qCyJ6evTkHo9al5sBMNA collected $1 from pot
46qCyJ6evTkHo9al5sBMNA: doesn't show hand
*** SUMMARY ***
Total pot $1 | Rake $0
Seat 1: 46qCyJ6evTkHo9al5sBMNA (button) (small blind) collected ($1)
Seat 2: BypVLsYQt3ePFm2xQL/dOA (big blind) folded before Flop



PokerStars Game #59940346032:  Hold'em No Limit ($0.25/$0.50) - 2009/07/01 1:04:02 ET
Table 'lSisgp6H7Fg1hH5VfjEjYQ' 9-max Seat #7 is the button
Seat 1: 5k9fvXD9suIgCxU4HLQjTw ($50 in chips)
Seat 2: UrcnkQOiLVk8BlKDPJSy7Q ($75.85 in chips)
Seat 3: aTkyjTh3w5YLWiIERupZOA ($52.15 in chips)
Seat 4: bwv/rbH/hHhPhY6u9mu04w ($30.35 in chips)
Seat 5: mSD1pginDsyHG5PDfqzphw ($10 in chips)
Seat 6: +k7T5ocke8UwavtgUHm+Cg ($66.80 in chips)
Seat 7: IDtNLR9uFCDdjNsJWMHA5Q ($23.55 in chips)
Seat 8: a4JDWmpFQkL10XfAyuF51A ($27.25 in chips)
a4JDWmpFQkL10XfAyuF51A: posts small blind $0.25
5k9fvXD9suIgCxU4HLQjTw: posts big blind $0.50
*** HOLE CARDS ***
UrcnkQOiLVk8BlKDPJSy7Q: folds
aTkyjTh3w5YLWiIERupZOA: folds
bwv/rbH/hHhPhY6u9mu04w: folds
mSD1pginDsyHG5PDfqzphw: folds
+k7T5ocke8UwavtgUHm+Cg: folds
IDtNLR9uFCDdjNsJWMHA5Q: folds
a4JDWmpFQkL10XfAyuF51A: folds
5k9fvXD9suIgCxU4HLQjTw collected $0.50 from pot
*** SUMMARY ***
Total pot $0.50 | Rake $0
Seat 1: 5k9fvXD9suIgCxU4HLQjTw (big blind) collected ($0.50)
Seat 2: UrcnkQOiLVk8BlKDPJSy7Q folded before Flop (didn't bet)
Seat 3: aTkyjTh3w5YLWiIERupZOA folded before Flop (didn't bet)
Seat 4: bwv/rbH/hHhPhY6u9mu04w folded before Flop (didn't bet)
Seat 5: mSD1pginDsyHG5PDfqzphw folded before Flop (didn't bet)
Seat 6: +k7T5ocke8UwavtgUHm+Cg folded before Flop (didn't bet)
Seat 7: IDtNLR9uFCDdjNsJWMHA5Q (button) folded before Flop (didn't bet)
Seat 8: a4JDWmpFQkL10XfAyuF51A (small blind) folded before Flop



PokerStars Game #59940347264:  Hold'em No Limit ($0.25/$0.50) - 2009/07/01 1:04:04 ET
Table '+dXkOAQyS8j9PQZusUTMpg' 2-max Seat #2 is the button
Seat 1: XFa6sBGjP2gxoIvxR3fZIg ($113.15 in chips)
Seat 2: 5IBeOgaApY1Bvzv2P8X4EA ($84.15 in chips)
5IBeOgaApY1Bvzv2P8X4EA: posts small blind $0.25
XFa6sBGjP2gxoIvxR3fZIg: posts big blind $0.50
*** HOLE CARDS ***
5IBeOgaApY1Bvzv2P8X4EA: raises $1 to $1.50
XFa6sBGjP2gxoIvxR3fZIg: folds
5IBeOgaApY1Bvzv2P8X4EA collected $1 from pot
5IBeOgaApY1Bvzv2P8X4EA: doesn't show hand
*** SUMMARY ***
Total pot $1 | Rake $0
Seat 1: XFa6sBGjP2gxoIvxR3fZIg (big blind) folded before Flop
Seat 2: 5IBeOgaApY1Bvzv2P8X4EA (button) (small blind) collected ($1)



PokerStars Game #59940347474:  Hold'em No Limit ($0.25/$0.50) - 2009/07/01 1:04:04 ET
Table 'MJxeZCzYELxiIsyUZyT0jw' 6-max Seat #1 is the button
Seat 1: +Pf9jTVizYlIo+woPvptfA ($50 in chips)
Seat 2: t3GiVMzqA9Svgr5Uol32cQ ($48.15 in chips)
Seat 4: alGiiQP/wwtYnfuXII+sgw ($36.10 in chips)
Seat 5: 3jvoOXNtXE90w2BdfNZwZQ ($56.35 in chips)
Seat 6: c0n4hrn20AML9qzyFC2E8Q ($48 in chips)
t3GiVMzqA9Svgr5Uol32cQ: posts small blind $0.25
alGiiQP/wwtYnfuXII+sgw: posts big blind $0.50
*** HOLE CARDS ***
3jvoOXNtXE90w2BdfNZwZQ: folds
c0n4hrn20AML9qzyFC2E8Q: raises $1 to $1.50
+Pf9jTVizYlIo+woPvptfA: folds
t3GiVMzqA9Svgr5Uol32cQ: calls $1.25
alGiiQP/wwtYnfuXII+sgw: calls $1
*** FLOP *** [9h 7c 3d]
sIG4mp8tZEI+W4nKZNkkQA joins the table at seat #3
t3GiVMzqA9Svgr5Uol32cQ: checks
alGiiQP/wwtYnfuXII+sgw: bets $1.50
c0n4hrn20AML9qzyFC2E8Q: folds
t3GiVMzqA9Svgr5Uol32cQ: calls $1.50
*** TURN *** [9h 7c 3d] [6h]
t3GiVMzqA9Svgr5Uol32cQ: checks
alGiiQP/wwtYnfuXII+sgw: bets $4
t3GiVMzqA9Svgr5Uol32cQ: calls $4
*** RIVER *** [9h 7c 3d 6h] [Ks]
t3GiVMzqA9Svgr5Uol32cQ: bets $11
alGiiQP/wwtYnfuXII+sgw: raises $11 to $22
t3GiVMzqA9Svgr5Uol32cQ: calls $11
*** SHOW DOWN ***
alGiiQP/wwtYnfuXII+sgw: shows [9s Kc] (two pair, Kings and Nines)
t3GiVMzqA9Svgr5Uol32cQ: mucks hand
alGiiQP/wwtYnfuXII+sgw collected $57.50 from pot
*** SUMMARY ***
Total pot $59.50 | Rake $2
Board [9h 7c 3d 6h Ks]
Seat 1: +Pf9jTVizYlIo+woPvptfA (button) folded before Flop (didn't bet)
Seat 2: t3GiVMzqA9Svgr5Uol32cQ (small blind) mucked
Seat 4: alGiiQP/wwtYnfuXII+sgw (big blind) showed [9s Kc] and won ($57.50) with two pair, Kings and Nines
Seat 5: 3jvoOXNtXE90w2BdfNZwZQ folded before Flop (didn't bet)
Seat 6: c0n4hrn20AML9qzyFC2E8Q folded on the Flop



PokerStars Game #59940348862:  Hold'em No Limit ($0.25/$0.50) - 2009/07/01 1:04:07 ET
Table 'X6IRCRTh+20gjz8aubWnwA' 9-max Seat #9 is the button
Seat 1: DSM67hHHq1XFoEOi9p8Alw ($50 in chips)
Seat 2: HZkVla4kK2SI42CVrPZ/ig ($7.55 in chips)
Seat 3: SWv01peOe69QQRvhQTqjQw ($9.25 in chips)
Seat 4: M3JFBNQ8Bbw3FBZ/18MuXw ($26.60 in chips)
Seat 5: NnQCepdIR/AOUQn1yhYx6Q ($10 in chips)
Seat 6: 75K2MXwN65Sjfp1yHd50Hg ($10 in chips)
Seat 7: cFHQjKQOOKTUzoilhrXHLg ($17.50 in chips)
Seat 8: HxeBVq06/3Bh/H986sgdbw ($48.05 in chips)
Seat 9: M+7+BTmX5vZatHVuoRB1nA ($44.25 in chips)
DSM67hHHq1XFoEOi9p8Alw: posts small blind $0.25
HZkVla4kK2SI42CVrPZ/ig: posts big blind $0.50
*** HOLE CARDS ***
SWv01peOe69QQRvhQTqjQw: calls $0.50
M3JFBNQ8Bbw3FBZ/18MuXw: folds
NnQCepdIR/AOUQn1yhYx6Q: folds
75K2MXwN65Sjfp1yHd50Hg: folds
cFHQjKQOOKTUzoilhrXHLg: calls $0.50
HxeBVq06/3Bh/H986sgdbw: folds
M+7+BTmX5vZatHVuoRB1nA: folds
DSM67hHHq1XFoEOi9p8Alw: calls $0.25
HZkVla4kK2SI42CVrPZ/ig: checks
*** FLOP *** [5s 6c Kc]
DSM67hHHq1XFoEOi9p8Alw: checks
HZkVla4kK2SI42CVrPZ/ig: checks
SWv01peOe69QQRvhQTqjQw: checks
cFHQjKQOOKTUzoilhrXHLg: checks
*** TURN *** [5s 6c Kc] [Ks]
DSM67hHHq1XFoEOi9p8Alw: checks
HZkVla4kK2SI42CVrPZ/ig: checks
SWv01peOe69QQRvhQTqjQw: checks
cFHQjKQOOKTUzoilhrXHLg: checks
*** RIVER *** [5s 6c Kc Ks] [4d]
DSM67hHHq1XFoEOi9p8Alw: checks
HZkVla4kK2SI42CVrPZ/ig: checks
SWv01peOe69QQRvhQTqjQw: checks
cFHQjKQOOKTUzoilhrXHLg: bets $1.50
DSM67hHHq1XFoEOi9p8Alw: folds
HZkVla4kK2SI42CVrPZ/ig: folds
SWv01peOe69QQRvhQTqjQw: folds
cFHQjKQOOKTUzoilhrXHLg collected $1.90 from pot
*** SUMMARY ***
Total pot $2 | Rake $0.10
Board [5s 6c Kc Ks 4d]
Seat 1: DSM67hHHq1XFoEOi9p8Alw (small blind) folded on the River
Seat 2: HZkVla4kK2SI42CVrPZ/ig (big blind) folded on the River
Seat 3: SWv01peOe69QQRvhQTqjQw folded on the River
Seat 4: M3JFBNQ8Bbw3FBZ/18MuXw folded before Flop (didn't bet)
Seat 5: NnQCepdIR/AOUQn1yhYx6Q folded before Flop (didn't bet)
Seat 6: 75K2MXwN65Sjfp1yHd50Hg folded before Flop (didn't bet)
Seat 7: cFHQjKQOOKTUzoilhrXHLg collected ($1.90)
Seat 8: HxeBVq06/3Bh/H986sgdbw folded before Flop (didn't bet)
Seat 9: M+7+BTmX5vZatHVuoRB1nA (button) folded before Flop (didn't bet)



PokerStars Game #59940349272:  Hold'em No Limit ($0.25/$0.50) - 2009/07/01 1:04:08 ET
Table '5EmHi+fnatGQQShcNmzOZQ' 6-max Seat #1 is the button
Seat 1: My8WkRtGx5FW6rJ1I4R3hg ($16.45 in chips)
Seat 2: bfFjgAtIoAI+pUxUwFt3aQ ($49.25 in chips)
Seat 3: TjmTe3bhs9dFz5gXX9x7Lw ($15.25 in chips)
Seat 4: 1b+2BbjMN8qhR1WPqdE9VQ ($66.55 in chips)
Seat 5: kxPhs4ePFqMy52CInAJ2aw ($82.05 in chips)
Seat 6: 686aeHikcJlgKkSuIFdcXQ ($131 in chips)
bfFjgAtIoAI+pUxUwFt3aQ: posts small blind $0.25
TjmTe3bhs9dFz5gXX9x7Lw: posts big blind $0.50
*** HOLE CARDS ***
1b+2BbjMN8qhR1WPqdE9VQ: folds
kxPhs4ePFqMy52CInAJ2aw: folds
686aeHikcJlgKkSuIFdcXQ: raises $1.50 to $2
My8WkRtGx5FW6rJ1I4R3hg: folds
bfFjgAtIoAI+pUxUwFt3aQ: calls $1.75
TjmTe3bhs9dFz5gXX9x7Lw: folds
*** FLOP *** [4h Tc 9d]
bfFjgAtIoAI+pUxUwFt3aQ: checks
686aeHikcJlgKkSuIFdcXQ: bets $3.50
bfFjgAtIoAI+pUxUwFt3aQ: folds
686aeHikcJlgKkSuIFdcXQ collected $4.30 from pot
*** SUMMARY ***
Total pot $4.50 | Rake $0.20
Board [4h Tc 9d]
Seat 1: My8WkRtGx5FW6rJ1I4R3hg (button) folded before Flop (didn't bet)
Seat 2: bfFjgAtIoAI+pUxUwFt3aQ (small blind) folded on the Flop
Seat 3: TjmTe3bhs9dFz5gXX9x7Lw (big blind) folded before Flop
Seat 4: 1b+2BbjMN8qhR1WPqdE9VQ folded before Flop (didn't bet)
Seat 5: kxPhs4ePFqMy52CInAJ2aw folded before Flop (didn't bet)
Seat 6: 686aeHikcJlgKkSuIFdcXQ collected ($4.30)



PokerStars Game #59940350242:  Hold'em No Limit ($0.25/$0.50) - 2009/07/01 1:04:09 ET
Table 'lpxYasB1ClBSgTpCCITwhQ' 9-max Seat #5 is the button
Seat 1: mj7PS7wCH4PAl7+eYTFs7A ($44.30 in chips)
Seat 2: OWP/DOu+PlPK6ZZ3zYa0HA ($28.45 in chips)
Seat 4: NnQCepdIR/AOUQn1yhYx6Q ($8.50 in chips)
Seat 5: IYd5zG8k7vdBNVHbHg2Pag ($36.10 in chips)
Seat 6: SegjDnMxWMujiD57ESNL+g ($11.60 in chips)
Seat 7: bmRtaIYKthN1F+B3JLZ3Jw ($71.90 in chips)
Seat 8: /mfensKw8/iZ1Vrx33S4xg ($11.85 in chips)
Seat 9: sUIUZ+begh92dzkUmvbMrw ($9.90 in chips)
SegjDnMxWMujiD57ESNL+g: posts small blind $0.25
bmRtaIYKthN1F+B3JLZ3Jw: posts big blind $0.50
*** HOLE CARDS ***
/mfensKw8/iZ1Vrx33S4xg: folds
sUIUZ+begh92dzkUmvbMrw: folds
mj7PS7wCH4PAl7+eYTFs7A: folds
OWP/DOu+PlPK6ZZ3zYa0HA: folds
NnQCepdIR/AOUQn1yhYx6Q: folds
IYd5zG8k7vdBNVHbHg2Pag: raises $1 to $1.50
SegjDnMxWMujiD57ESNL+g: folds
bmRtaIYKthN1F+B3JLZ3Jw: raises $2.50 to $4
IYd5zG8k7vdBNVHbHg2Pag: folds
IVoxShuYD5lqbK8F9+jVsg leaves the table
bmRtaIYKthN1F+B3JLZ3Jw collected $3.25 from pot
*** SUMMARY ***
Total pot $3.25 | Rake $0
Seat 1: mj7PS7wCH4PAl7+eYTFs7A folded before Flop (didn't bet)
Seat 2: OWP/DOu+PlPK6ZZ3zYa0HA folded before Flop (didn't bet)
Seat 4: NnQCepdIR/AOUQn1yhYx6Q folded before Flop (didn't bet)
Seat 5: IYd5zG8k7vdBNVHbHg2Pag (button) folded before Flop
Seat 6: SegjDnMxWMujiD57ESNL+g (small blind) folded before Flop
Seat 7: bmRtaIYKthN1F+B3JLZ3Jw (big blind) collected ($3.25)
Seat 8: /mfensKw8/iZ1Vrx33S4xg folded before Flop (didn't bet)
Seat 9: sUIUZ+begh92dzkUmvbMrw folded before Flop (didn't bet)



PokerStars Game #59940352272:  Hold'em No Limit ($0.25/$0.50) - 2009/07/01 1:04:12 ET
Table 'E7bWJ45aoFXRpyRv2gw+Ig' 2-max Seat #1 is the button
Seat 1: FRkiRasEGlHUeLrEl+k/nA ($53 in chips)
Seat 2: 3Wro85I7472vJ4Wkpneo9A ($135.25 in chips)
FRkiRasEGlHUeLrEl+k/nA: posts small blind $0.25
3Wro85I7472vJ4Wkpneo9A: posts big blind $0.50
*** HOLE CARDS ***
FRkiRasEGlHUeLrEl+k/nA: folds
3Wro85I7472vJ4Wkpneo9A collected $0.50 from pot
3Wro85I7472vJ4Wkpneo9A: doesn't show hand
*** SUMMARY ***
Total pot $0.50 | Rake $0
Seat 1: FRkiRasEGlHUeLrEl+k/nA (button) (small blind) folded before Flop
Seat 2: 3Wro85I7472vJ4Wkpneo9A (big blind) collected ($0.50)



PokerStars Game #59940352298:  Hold'em No Limit ($0.25/$0.50) - 2009/07/01 1:04:12 ET
Table 'c/CRn+68J3Y8KxD5g1ek2Q' 2-max Seat #2 is the button
Seat 1: 46qCyJ6evTkHo9al5sBMNA ($93.45 in chips)
Seat 2: BypVLsYQt3ePFm2xQL/dOA ($273.95 in chips)
BypVLsYQt3ePFm2xQL/dOA: posts small blind $0.25
46qCyJ6evTkHo9al5sBMNA: posts big blind $0.50
*** HOLE CARDS ***
BypVLsYQt3ePFm2xQL/dOA: calls $0.25
46qCyJ6evTkHo9al5sBMNA: raises $1.50 to $2
BypVLsYQt3ePFm2xQL/dOA: calls $1.50
*** FLOP *** [6s Td 5h]
46qCyJ6evTkHo9al5sBMNA: checks
BypVLsYQt3ePFm2xQL/dOA: checks
*** TURN *** [6s Td 5h] [8d]
46qCyJ6evTkHo9al5sBMNA: bets $3
BypVLsYQt3ePFm2xQL/dOA: folds
46qCyJ6evTkHo9al5sBMNA collected $3.80 from pot
46qCyJ6evTkHo9al5sBMNA: doesn't show hand
*** SUMMARY ***
Total pot $4 | Rake $0.20
Board [6s Td 5h 8d]
Seat 1: 46qCyJ6evTkHo9al5sBMNA (big blind) collected ($3.80)
Seat 2: BypVLsYQt3ePFm2xQL/dOA (button) (small blind) folded on the Turn



PokerStars Game #59940353190:  Hold'em No Limit ($0.25/$0.50) - 2009/07/01 1:04:14 ET
Table '+dXkOAQyS8j9PQZusUTMpg' 2-max Seat #1 is the button
Seat 1: XFa6sBGjP2gxoIvxR3fZIg ($112.65 in chips)
Seat 2: 5IBeOgaApY1Bvzv2P8X4EA ($84.65 in chips)
XFa6sBGjP2gxoIvxR3fZIg: posts small blind $0.25
5IBeOgaApY1Bvzv2P8X4EA: posts big blind $0.50
*** HOLE CARDS ***
XFa6sBGjP2gxoIvxR3fZIg said, "First guess usually right"
XFa6sBGjP2gxoIvxR3fZIg: raises $1 to $1.50
5IBeOgaApY1Bvzv2P8X4EA: raises $1.50 to $3
XFa6sBGjP2gxoIvxR3fZIg: calls $1.50
*** FLOP *** [7c 4s 3h]
5IBeOgaApY1Bvzv2P8X4EA: bets $3.50
XFa6sBGjP2gxoIvxR3fZIg: calls $3.50
*** TURN *** [7c 4s 3h] [8d]
5IBeOgaApY1Bvzv2P8X4EA: bets $9.50
XFa6sBGjP2gxoIvxR3fZIg: folds
5IBeOgaApY1Bvzv2P8X4EA collected $12.50 from pot
5IBeOgaApY1Bvzv2P8X4EA: doesn't show hand
*** SUMMARY ***
Total pot $13 | Rake $0.50
Board [7c 4s 3h 8d]
Seat 1: XFa6sBGjP2gxoIvxR3fZIg (button) (small blind) folded on the Turn
Seat 2: 5IBeOgaApY1Bvzv2P8X4EA (big blind) collected ($12.50)



PokerStars Game #59940353952:  Hold'em No Limit ($0.25/$0.50) - 2009/07/01 1:04:15 ET
Table 'GfL/No5u5PoEnU39lP5pQg' 6-max Seat #3 is the button
Seat 1: 1WUCqNG+p+vfWRTXNu4ljw ($66 in chips)
Seat 2: uVwggSetzp7d+eVgowO3vg ($60.25 in chips)
Seat 3: eQXFICMuu3hw6XlcmuVNEA ($12.30 in chips)
Seat 4: r6u7MWSXF30/khcTYkrG9Q ($40.90 in chips)
Seat 5: M1KyQQvVPVuxqTAB8sR/zQ ($50.75 in chips)
Seat 6: kxPhs4ePFqMy52CInAJ2aw ($48.50 in chips)
r6u7MWSXF30/khcTYkrG9Q: posts small blind $0.25
M1KyQQvVPVuxqTAB8sR/zQ: posts big blind $0.50
*** HOLE CARDS ***
kxPhs4ePFqMy52CInAJ2aw: folds
1WUCqNG+p+vfWRTXNu4ljw: folds
uVwggSetzp7d+eVgowO3vg: calls $0.50
eQXFICMuu3hw6XlcmuVNEA: folds
r6u7MWSXF30/khcTYkrG9Q: calls $0.25
M1KyQQvVPVuxqTAB8sR/zQ: raises $1.75 to $2.25
uVwggSetzp7d+eVgowO3vg: folds
r6u7MWSXF30/khcTYkrG9Q: calls $1.75
*** FLOP *** [Js 9s Th]
r6u7MWSXF30/khcTYkrG9Q: checks
M1KyQQvVPVuxqTAB8sR/zQ: bets $3.50
r6u7MWSXF30/khcTYkrG9Q: folds
M1KyQQvVPVuxqTAB8sR/zQ collected $4.75 from pot
M1KyQQvVPVuxqTAB8sR/zQ: doesn't show hand
*** SUMMARY ***
Total pot $5 | Rake $0.25
Board [Js 9s Th]
Seat 1: 1WUCqNG+p+vfWRTXNu4ljw folded before Flop (didn't bet)
Seat 2: uVwggSetzp7d+eVgowO3vg folded before Flop
Seat 3: eQXFICMuu3hw6XlcmuVNEA (button) folded before Flop (didn't bet)
Seat 4: r6u7MWSXF30/khcTYkrG9Q (small blind) folded on the Flop
Seat 5: M1KyQQvVPVuxqTAB8sR/zQ (big blind) collected ($4.75)
Seat 6: kxPhs4ePFqMy52CInAJ2aw folded before Flop (didn't bet)



PokerStars Game #59940354266:  Hold'em No Limit ($0.25/$0.50) - 2009/07/01 1:04:16 ET
Table 'lSisgp6H7Fg1hH5VfjEjYQ' 9-max Seat #8 is the button
Seat 1: 5k9fvXD9suIgCxU4HLQjTw ($50.25 in chips)
Seat 2: UrcnkQOiLVk8BlKDPJSy7Q ($75.85 in chips)
Seat 3: aTkyjTh3w5YLWiIERupZOA ($52.15 in chips)
Seat 4: bwv/rbH/hHhPhY6u9mu04w ($30.35 in chips)
Seat 5: mSD1pginDsyHG5PDfqzphw ($10 in chips)
Seat 6: +k7T5ocke8UwavtgUHm+Cg ($66.80 in chips)
Seat 7: IDtNLR9uFCDdjNsJWMHA5Q ($23.55 in chips)
Seat 8: a4JDWmpFQkL10XfAyuF51A ($27 in chips)
5k9fvXD9suIgCxU4HLQjTw: posts small blind $0.25
UrcnkQOiLVk8BlKDPJSy7Q: posts big blind $0.50
*** HOLE CARDS ***
aTkyjTh3w5YLWiIERupZOA: folds
bwv/rbH/hHhPhY6u9mu04w: folds
mSD1pginDsyHG5PDfqzphw: folds
YzeKFbJVLmJGTgNH3ySQlw joins the table at seat #9
+k7T5ocke8UwavtgUHm+Cg: calls $0.50
IDtNLR9uFCDdjNsJWMHA5Q: folds
a4JDWmpFQkL10XfAyuF51A: folds
5k9fvXD9suIgCxU4HLQjTw: calls $0.25
UrcnkQOiLVk8BlKDPJSy7Q: checks
*** FLOP *** [5c 8c 2d]
5k9fvXD9suIgCxU4HLQjTw: checks
UrcnkQOiLVk8BlKDPJSy7Q: checks
+k7T5ocke8UwavtgUHm+Cg: checks
*** TURN *** [5c 8c 2d] [3s]
5k9fvXD9suIgCxU4HLQjTw: checks
UrcnkQOiLVk8BlKDPJSy7Q: checks
+k7T5ocke8UwavtgUHm+Cg: checks
*** RIVER *** [5c 8c 2d 3s] [Ah]
5k9fvXD9suIgCxU4HLQjTw: checks
UrcnkQOiLVk8BlKDPJSy7Q: checks
+k7T5ocke8UwavtgUHm+Cg: checks
*** SHOW DOWN ***
5k9fvXD9suIgCxU4HLQjTw: shows [7d Td] (high card Ace)
UrcnkQOiLVk8BlKDPJSy7Q: shows [Js 3h] (a pair of Threes)
+k7T5ocke8UwavtgUHm+Cg: mucks hand
UrcnkQOiLVk8BlKDPJSy7Q collected $1.45 from pot
*** SUMMARY ***
Total pot $1.50 | Rake $0.05
Board [5c 8c 2d 3s Ah]
Seat 1: 5k9fvXD9suIgCxU4HLQjTw (small blind) showed [7d Td] and lost with high card Ace
Seat 2: UrcnkQOiLVk8BlKDPJSy7Q (big blind) showed [Js 3h] and won ($1.45) with a pair of Threes
Seat 3: aTkyjTh3w5YLWiIERupZOA folded before Flop (didn't bet)
Seat 4: bwv/rbH/hHhPhY6u9mu04w folded before Flop (didn't bet)
Seat 5: mSD1pginDsyHG5PDfqzphw folded before Flop (didn't bet)
Seat 6: +k7T5ocke8UwavtgUHm+Cg mucked
Seat 7: IDtNLR9uFCDdjNsJWMHA5Q folded before Flop (didn't bet)
Seat 8: a4JDWmpFQkL10XfAyuF51A (button) folded before Flop (didn't bet)



PokerStars Game #59940356230:  Hold'em No Limit ($0.25/$0.50) - 2009/07/01 1:04:19 ET
Table 'Nz0Vr7WMHL2g5Uk7dDZjpw' 9-max Seat #6 is the button
Seat 1: tLkxo7JgV+WWI0UBw44K5A ($110.60 in chips)
Seat 2: gsyXT42WLEcOS4DdEk2wlw ($29.25 in chips)
Seat 4: E2518gp4aFz1+kAgmGqeEg ($13.30 in chips)
Seat 5: WGW0DgjBUXs1ylURHG8vnQ ($26.35 in chips)
Seat 6: 997ViqAtWn1FPjJqcffwcA ($59.80 in chips)
Seat 7: KPLH0gELgFe2OuAnhJFI5w ($14.35 in chips)
Seat 8: HkZI6g4zl83TDTA7SRspmQ ($28.40 in chips)
Seat 9: mSD1pginDsyHG5PDfqzphw ($10 in chips)
KPLH0gELgFe2OuAnhJFI5w: posts small blind $0.25
HkZI6g4zl83TDTA7SRspmQ: posts big blind $0.50
*** HOLE CARDS ***
mSD1pginDsyHG5PDfqzphw: folds
tLkxo7JgV+WWI0UBw44K5A: folds
gsyXT42WLEcOS4DdEk2wlw: folds
E2518gp4aFz1+kAgmGqeEg: folds
WGW0DgjBUXs1ylURHG8vnQ: calls $0.50
997ViqAtWn1FPjJqcffwcA: folds
KPLH0gELgFe2OuAnhJFI5w: calls $0.25
HkZI6g4zl83TDTA7SRspmQ: checks
*** FLOP *** [Ts Qh Ah]
KPLH0gELgFe2OuAnhJFI5w: bets $1.50
HkZI6g4zl83TDTA7SRspmQ: folds
WGW0DgjBUXs1ylURHG8vnQ: folds
KPLH0gELgFe2OuAnhJFI5w collected $1.45 from pot
*** SUMMARY ***
Total pot $1.50 | Rake $0.05
Board [Ts Qh Ah]
Seat 1: tLkxo7JgV+WWI0UBw44K5A folded before Flop (didn't bet)
Seat 2: gsyXT42WLEcOS4DdEk2wlw folded before Flop (didn't bet)
Seat 4: E2518gp4aFz1+kAgmGqeEg folded before Flop (didn't bet)
Seat 5: WGW0DgjBUXs1ylURHG8vnQ folded on the Flop
Seat 6: 997ViqAtWn1FPjJqcffwcA (button) folded before Flop (didn't bet)
Seat 7: KPLH0gELgFe2OuAnhJFI5w (small blind) collected ($1.45)
Seat 8: HkZI6g4zl83TDTA7SRspmQ (big blind) folded on the Flop
Seat 9: mSD1pginDsyHG5PDfqzphw folded before Flop (didn't bet)



PokerStars Game #59940356256:  Hold'em No Limit ($0.25/$0.50) - 2009/07/01 1:04:19 ET
Table 'E7bWJ45aoFXRpyRv2gw+Ig' 2-max Seat #2 is the button
Seat 1: FRkiRasEGlHUeLrEl+k/nA ($52.75 in chips)
Seat 2: 3Wro85I7472vJ4Wkpneo9A ($135.50 in chips)
3Wro85I7472vJ4Wkpneo9A: posts small blind $0.25
FRkiRasEGlHUeLrEl+k/nA: posts big blind $0.50
*** HOLE CARDS ***
3Wro85I7472vJ4Wkpneo9A: raises $1 to $1.50
FRkiRasEGlHUeLrEl+k/nA: raises $2 to $3.50
3Wro85I7472vJ4Wkpneo9A: calls $2
*** FLOP *** [7d 5c 8s]
FRkiRasEGlHUeLrEl+k/nA: bets $2
3Wro85I7472vJ4Wkpneo9A: calls $2
*** TURN *** [7d 5c 8s] [Kh]
FRkiRasEGlHUeLrEl+k/nA: checks
3Wro85I7472vJ4Wkpneo9A: checks
*** RIVER *** [7d 5c 8s Kh] [As]
FRkiRasEGlHUeLrEl+k/nA: bets $7.50
3Wro85I7472vJ4Wkpneo9A: folds
FRkiRasEGlHUeLrEl+k/nA collected $10.50 from pot
FRkiRasEGlHUeLrEl+k/nA: doesn't show hand
*** SUMMARY ***
Total pot $11 | Rake $0.50
Board [7d 5c 8s Kh As]
Seat 1: FRkiRasEGlHUeLrEl+k/nA (big blind) collected ($10.50)
Seat 2: 3Wro85I7472vJ4Wkpneo9A (button) (small blind) folded on the River



PokerStars Game #59940356390:  Hold'em No Limit ($0.25/$0.50) - 2009/07/01 1:04:19 ET
Table 'tYh970kmVfYS0gXPT/XtoQ' 2-max Seat #1 is the button
Seat 1: mW7WbnOUOr5szbwJvGciAA ($29.20 in chips)
Seat 2: dokz3oqYBKI5gNELbiWhbQ ($22.60 in chips)
mW7WbnOUOr5szbwJvGciAA: posts small blind $0.25
dokz3oqYBKI5gNELbiWhbQ: posts big blind $0.50
*** HOLE CARDS ***
mW7WbnOUOr5szbwJvGciAA: calls $0.25
dokz3oqYBKI5gNELbiWhbQ: checks
*** FLOP *** [6d 9c Qc]
dokz3oqYBKI5gNELbiWhbQ: checks
mW7WbnOUOr5szbwJvGciAA: checks
*** TURN *** [6d 9c Qc] [2h]
dokz3oqYBKI5gNELbiWhbQ: checks
mW7WbnOUOr5szbwJvGciAA: checks
*** RIVER *** [6d 9c Qc 2h] [5c]
dokz3oqYBKI5gNELbiWhbQ: checks
mW7WbnOUOr5szbwJvGciAA: bets $0.50
dokz3oqYBKI5gNELbiWhbQ: folds
mW7WbnOUOr5szbwJvGciAA collected $0.95 from pot
mW7WbnOUOr5szbwJvGciAA: doesn't show hand
*** SUMMARY ***
Total pot $1 | Rake $0.05
Board [6d 9c Qc 2h 5c]
Seat 1: mW7WbnOUOr5szbwJvGciAA (button) (small blind) collected ($0.95)
Seat 2: dokz3oqYBKI5gNELbiWhbQ (big blind) folded on the River



PokerStars Game #59940357152:  Hold'em No Limit ($0.25/$0.50) - 2009/07/01 1:04:21 ET
Table 'kgbJRsxfv64KrErDRBAkcw' 6-max Seat #1 is the button
Seat 1: VamsyhlFzXGF6/ydo0BHeA ($36 in chips)
Seat 2: AdS8BJMOheS01zjCDfPMFg ($49.45 in chips)
Seat 3: c4MNIaIyPMOMxrgT8FT5nA ($141.55 in chips)
Seat 4: qanMEqjABjWxC/JgQ/0l7w ($56.50 in chips)
Seat 5: eUBBn2R56C1IQ6Cs/vitwg ($55.25 in chips)
Seat 6: 1b+2BbjMN8qhR1WPqdE9VQ ($52.40 in chips)
AdS8BJMOheS01zjCDfPMFg: posts small blind $0.25
c4MNIaIyPMOMxrgT8FT5nA: posts big blind $0.50
*** HOLE CARDS ***
qanMEqjABjWxC/JgQ/0l7w: folds
eUBBn2R56C1IQ6Cs/vitwg: raises $1.50 to $2
1b+2BbjMN8qhR1WPqdE9VQ: folds
VamsyhlFzXGF6/ydo0BHeA: folds
AdS8BJMOheS01zjCDfPMFg: folds
c4MNIaIyPMOMxrgT8FT5nA: calls $1.50
*** FLOP *** [7s Kh 2s]
c4MNIaIyPMOMxrgT8FT5nA: checks
eUBBn2R56C1IQ6Cs/vitwg: checks
*** TURN *** [7s Kh 2s] [Kc]
c4MNIaIyPMOMxrgT8FT5nA: bets $4.50
eUBBn2R56C1IQ6Cs/vitwg: calls $4.50
*** RIVER *** [7s Kh 2s Kc] [Ts]
c4MNIaIyPMOMxrgT8FT5nA: checks
eUBBn2R56C1IQ6Cs/vitwg: checks
*** SHOW DOWN ***
c4MNIaIyPMOMxrgT8FT5nA: shows [6c Qc] (a pair of Kings)
eUBBn2R56C1IQ6Cs/vitwg: shows [8c 8s] (two pair, Kings and Eights)
eUBBn2R56C1IQ6Cs/vitwg collected $12.60 from pot
*** SUMMARY ***
Total pot $13.25 | Rake $0.65
Board [7s Kh 2s Kc Ts]
Seat 1: VamsyhlFzXGF6/ydo0BHeA (button) folded before Flop (didn't bet)
Seat 2: AdS8BJMOheS01zjCDfPMFg (small blind) folded before Flop
Seat 3: c4MNIaIyPMOMxrgT8FT5nA (big blind) showed [6c Qc] and lost with a pair of Kings
Seat 4: qanMEqjABjWxC/JgQ/0l7w folded before Flop (didn't bet)
Seat 5: eUBBn2R56C1IQ6Cs/vitwg showed [8c 8s] and won ($12.60) with two pair, Kings and Eights
Seat 6: 1b+2BbjMN8qhR1WPqdE9VQ folded before Flop (didn't bet)



PokerStars Game #59940357380:  Hold'em No Limit ($0.25/$0.50) - 2009/07/01 1:04:21 ET
Table 'BCN5su+SsXiy1zRMJi0SJw' 6-max Seat #1 is the button
Seat 1: GxXV09ciXaOxyY2H5aMIIw ($41.55 in chips)
Seat 2: oU2kDCkT/gilYbHWrg7D8w ($42.10 in chips)
Seat 3: 6wzJiRvp8HY6t+MQGnSIzA ($11.55 in chips)
Seat 5: IBNygaT1aa9Z1uPdJJilwA ($43.30 in chips)
Seat 6: b2symlOdL7+0c9Pj4N/KlA ($56.10 in chips)
oU2kDCkT/gilYbHWrg7D8w: posts small blind $0.25
6wzJiRvp8HY6t+MQGnSIzA: posts big blind $0.50
4QfsCWthT/vSLirorNXqtg: sits out
*** HOLE CARDS ***
IBNygaT1aa9Z1uPdJJilwA: folds
b2symlOdL7+0c9Pj4N/KlA: raises $1 to $1.50
GxXV09ciXaOxyY2H5aMIIw: folds
oU2kDCkT/gilYbHWrg7D8w: calls $1.25
6wzJiRvp8HY6t+MQGnSIzA: calls $1
*** FLOP *** [2s Tc Th]
oU2kDCkT/gilYbHWrg7D8w: checks
6wzJiRvp8HY6t+MQGnSIzA: checks
b2symlOdL7+0c9Pj4N/KlA: bets $3.50
oU2kDCkT/gilYbHWrg7D8w: folds
6wzJiRvp8HY6t+MQGnSIzA: folds
b2symlOdL7+0c9Pj4N/KlA collected $4.30 from pot
b2symlOdL7+0c9Pj4N/KlA: doesn't show hand
*** SUMMARY ***
Total pot $4.50 | Rake $0.20
Board [2s Tc Th]
Seat 1: GxXV09ciXaOxyY2H5aMIIw (button) folded before Flop (didn't bet)
Seat 2: oU2kDCkT/gilYbHWrg7D8w (small blind) folded on the Flop
Seat 3: 6wzJiRvp8HY6t+MQGnSIzA (big blind) folded on the Flop
Seat 5: IBNygaT1aa9Z1uPdJJilwA folded before Flop (didn't bet)
Seat 6: b2symlOdL7+0c9Pj4N/KlA collected ($4.30)



PokerStars Game #59940357438:  Hold'em No Limit ($0.25/$0.50) - 2009/07/01 1:04:21 ET
Table 'QOgaEqMcJ73pcUMMxoisUg' 6-max Seat #1 is the button
Seat 1: lxIzoHy0RnkfFSODHC2liw ($54.10 in chips)
Seat 3: Rt6KgtZ8YaJoTc3FPim00w ($52.50 in chips)
Seat 4: zAcsDhG/T128Vn7XGVSgKg ($50 in chips)
Seat 5: 6vNxrjjCl6FwfaaymM9jjg ($21.75 in chips)
Rt6KgtZ8YaJoTc3FPim00w: posts small blind $0.25
zAcsDhG/T128Vn7XGVSgKg: posts big blind $0.50
*** HOLE CARDS ***
6vNxrjjCl6FwfaaymM9jjg: folds
lxIzoHy0RnkfFSODHC2liw: folds
Rt6KgtZ8YaJoTc3FPim00w: folds
zAcsDhG/T128Vn7XGVSgKg collected $0.50 from pot
*** SUMMARY ***
Total pot $0.50 | Rake $0
Seat 1: lxIzoHy0RnkfFSODHC2liw (button) folded before Flop (didn't bet)
Seat 3: Rt6KgtZ8YaJoTc3FPim00w (small blind) folded before Flop
Seat 4: zAcsDhG/T128Vn7XGVSgKg (big blind) collected ($0.50)
Seat 5: 6vNxrjjCl6FwfaaymM9jjg folded before Flop (didn't bet)



PokerStars Game #59940357794:  Hold'em No Limit ($0.25/$0.50) - 2009/07/01 1:04:22 ET
Table '8BQGgNetI1NOvWeu3gtMNw' 2-max Seat #2 is the button
Seat 1: bypIyrYcAAifLfhZpGlKLA ($87.95 in chips)
Seat 2: Z4HwehErEwzsv/noQlfUlg ($112.35 in chips)
Z4HwehErEwzsv/noQlfUlg: posts small blind $0.25
bypIyrYcAAifLfhZpGlKLA: posts big blind $0.50
*** HOLE CARDS ***
Z4HwehErEwzsv/noQlfUlg: raises $0.50 to $1
bypIyrYcAAifLfhZpGlKLA: calls $0.50
*** FLOP *** [3s 7d Ac]
bypIyrYcAAifLfhZpGlKLA: checks
Z4HwehErEwzsv/noQlfUlg: checks
*** TURN *** [3s 7d Ac] [Ts]
bypIyrYcAAifLfhZpGlKLA: checks
Z4HwehErEwzsv/noQlfUlg: checks
*** RIVER *** [3s 7d Ac Ts] [Kc]
bypIyrYcAAifLfhZpGlKLA: checks
Z4HwehErEwzsv/noQlfUlg: checks
*** SHOW DOWN ***
bypIyrYcAAifLfhZpGlKLA: shows [4s 9h] (high card Ace)
Z4HwehErEwzsv/noQlfUlg: shows [5c Jd] (high card Ace - King+Jack kicker)
Z4HwehErEwzsv/noQlfUlg collected $1.90 from pot
*** SUMMARY ***
Total pot $2 | Rake $0.10
Board [3s 7d Ac Ts Kc]
Seat 1: bypIyrYcAAifLfhZpGlKLA (big blind) showed [4s 9h] and lost with high card Ace
Seat 2: Z4HwehErEwzsv/noQlfUlg (button) (small blind) showed [5c Jd] and won ($1.90) with high card Ace



PokerStars Game #59940359502:  Hold'em No Limit ($0.25/$0.50) - 2009/07/01 1:04:25 ET
Table 'EiNh8p/wGJ1FP575iMFnqg' 9-max Seat #6 is the button
Seat 1: r3ZqM1Mi0W3y4hOdssE+Sg ($44.85 in chips)
Seat 2: 8ehL7qlZzjgUh2H35iiWLw ($54.15 in chips)
Seat 3: ymLPoEIl7UL3TvZYmnadxQ ($51.55 in chips)
Seat 4: cMzaiXAM/ZAdNaEUu+LqhA ($54.95 in chips)
Seat 5: M+7+BTmX5vZatHVuoRB1nA ($80.45 in chips)
Seat 6: 3UmXLy3GfjC3EkOebduerQ ($64.10 in chips)
Seat 7: 997ViqAtWn1FPjJqcffwcA ($50 in chips)
Seat 8: mSD1pginDsyHG5PDfqzphw ($11.60 in chips)
Seat 9: NnQCepdIR/AOUQn1yhYx6Q ($11.75 in chips)
997ViqAtWn1FPjJqcffwcA: posts small blind $0.25
mSD1pginDsyHG5PDfqzphw: posts big blind $0.50
*** HOLE CARDS ***
NnQCepdIR/AOUQn1yhYx6Q: folds
r3ZqM1Mi0W3y4hOdssE+Sg: folds
8ehL7qlZzjgUh2H35iiWLw: folds
ymLPoEIl7UL3TvZYmnadxQ: raises $1 to $1.50
cMzaiXAM/ZAdNaEUu+LqhA: folds
M+7+BTmX5vZatHVuoRB1nA: folds
3UmXLy3GfjC3EkOebduerQ: calls $1.50
997ViqAtWn1FPjJqcffwcA: folds
mSD1pginDsyHG5PDfqzphw: folds
*** FLOP *** [Qh Ac Qc]
ymLPoEIl7UL3TvZYmnadxQ: checks
3UmXLy3GfjC3EkOebduerQ: checks
*** TURN *** [Qh Ac Qc] [Qs]
ymLPoEIl7UL3TvZYmnadxQ: bets $0.50
3UmXLy3GfjC3EkOebduerQ: calls $0.50
*** RIVER *** [Qh Ac Qc Qs] [5c]
ymLPoEIl7UL3TvZYmnadxQ: bets $0.50
3UmXLy3GfjC3EkOebduerQ: calls $0.50
*** SHOW DOWN ***
ymLPoEIl7UL3TvZYmnadxQ: shows [9h 9d] (a full house, Queens full of Nines)
3UmXLy3GfjC3EkOebduerQ: mucks hand
ymLPoEIl7UL3TvZYmnadxQ collected $5.50 from pot
*** SUMMARY ***
Total pot $5.75 | Rake $0.25
Board [Qh Ac Qc Qs 5c]
Seat 1: r3ZqM1Mi0W3y4hOdssE+Sg folded before Flop (didn't bet)
Seat 2: 8ehL7qlZzjgUh2H35iiWLw folded before Flop (didn't bet)
Seat 3: ymLPoEIl7UL3TvZYmnadxQ showed [9h 9d] and won ($5.50) with a full house, Queens full of Nines
Seat 4: cMzaiXAM/ZAdNaEUu+LqhA folded before Flop (didn't bet)
Seat 5: M+7+BTmX5vZatHVuoRB1nA folded before Flop (didn't bet)
Seat 6: 3UmXLy3GfjC3EkOebduerQ (button) mucked
Seat 7: 997ViqAtWn1FPjJqcffwcA (small blind) folded before Flop
Seat 8: mSD1pginDsyHG5PDfqzphw (big blind) folded before Flop
Seat 9: NnQCepdIR/AOUQn1yhYx6Q folded before Flop (didn't bet)



PokerStars Game #59940360830:  Hold'em No Limit ($0.25/$0.50) - 2009/07/01 1:04:27 ET
Table '0eJtgVAXVvBgncFdcUpXcQ' 2-max Seat #2 is the button
Seat 1: Ag6DvxX4vbRheqsv2zXKTQ ($43.80 in chips)
Seat 2: KMc4R+K9ao4Ur3rF7NGe6Q ($3 in chips)
KMc4R+K9ao4Ur3rF7NGe6Q: posts small blind $0.25
Ag6DvxX4vbRheqsv2zXKTQ: posts big blind $0.50
*** HOLE CARDS ***
KMc4R+K9ao4Ur3rF7NGe6Q: calls $0.25
KMc4R+K9ao4Ur3rF7NGe6Q said, "damn"
Ag6DvxX4vbRheqsv2zXKTQ: raises $1.50 to $2
KMc4R+K9ao4Ur3rF7NGe6Q: raises $1 to $3 and is all-in
Ag6DvxX4vbRheqsv2zXKTQ: calls $1
*** FLOP *** [Tc 5d Qs]
KMc4R+K9ao4Ur3rF7NGe6Q said, "couldnt pull any moves"
*** TURN *** [Tc 5d Qs] [Ks]
*** RIVER *** [Tc 5d Qs Ks] [6s]
*** SHOW DOWN ***
Ag6DvxX4vbRheqsv2zXKTQ: shows [Kh Kc] (three of a kind, Kings)
KMc4R+K9ao4Ur3rF7NGe6Q: shows [Th 2h] (a pair of Tens)
Ag6DvxX4vbRheqsv2zXKTQ collected $5.70 from pot
*** SUMMARY ***
Total pot $6 | Rake $0.30
Board [Tc 5d Qs Ks 6s]
Seat 1: Ag6DvxX4vbRheqsv2zXKTQ (big blind) showed [Kh Kc] and won ($5.70) with three of a kind, Kings
Seat 2: KMc4R+K9ao4Ur3rF7NGe6Q (button) (small blind) showed [Th 2h] and lost with a pair of Tens



PokerStars Game #59940366466:  Hold'em No Limit ($0.25/$0.50) - 2009/07/01 1:04:36 ET
Table 'QOgaEqMcJ73pcUMMxoisUg' 6-max Seat #3 is the button
Seat 1: lxIzoHy0RnkfFSODHC2liw ($54.10 in chips)
Seat 3: Rt6KgtZ8YaJoTc3FPim00w ($52.25 in chips)
Seat 4: zAcsDhG/T128Vn7XGVSgKg ($50.25 in chips)
Seat 5: 6vNxrjjCl6FwfaaymM9jjg ($21.75 in chips)
zAcsDhG/T128Vn7XGVSgKg: posts small blind $0.25
6vNxrjjCl6FwfaaymM9jjg: posts big blind $0.50
*** HOLE CARDS ***
lxIzoHy0RnkfFSODHC2liw: folds
Rt6KgtZ8YaJoTc3FPim00w: folds
zAcsDhG/T128Vn7XGVSgKg: folds
6vNxrjjCl6FwfaaymM9jjg collected $0.50 from pot
*** SUMMARY ***
Total pot $0.50 | Rake $0
Seat 1: lxIzoHy0RnkfFSODHC2liw folded before Flop (didn't bet)
Seat 3: Rt6KgtZ8YaJoTc3FPim00w (button) folded before Flop (didn't bet)
Seat 4: zAcsDhG/T128Vn7XGVSgKg (small blind) folded before Flop
Seat 5: 6vNxrjjCl6FwfaaymM9jjg (big blind) collected ($0.50)



PokerStars Game #59940366578:  Hold'em No Limit ($0.25/$0.50) - 2009/07/01 1:04:37 ET
Table '/cQuAT3ef4t+PGrXiNhGaQ' 9-max Seat #1 is the button
Seat 1: HZkVla4kK2SI42CVrPZ/ig ($14.25 in chips)
Seat 2: jXGruyaMqirTaTXNOvBdew ($67.20 in chips)
Seat 3: g4k0NXISyLCqaSWZDBjfEg ($54.25 in chips)
Seat 4: OWP/DOu+PlPK6ZZ3zYa0HA ($30.60 in chips)
Seat 5: 5SgaHdWixdClWvaEG+KUjQ ($14.35 in chips)
Seat 6: APYIOyK/4AGb+kIwlOUNBQ ($36.50 in chips)
Seat 7: J0W5D97jl5VLky+IoPvDeA ($160.70 in chips)
Seat 8: eBrej2jnlUCs/JgxFCRn2g ($40 in chips)
Seat 9: AjV5McH1KMMclY26QdLM5w ($25.70 in chips)
jXGruyaMqirTaTXNOvBdew: posts small blind $0.25
g4k0NXISyLCqaSWZDBjfEg: posts big blind $0.50
*** HOLE CARDS ***
OWP/DOu+PlPK6ZZ3zYa0HA: folds
5SgaHdWixdClWvaEG+KUjQ: folds
APYIOyK/4AGb+kIwlOUNBQ: folds
J0W5D97jl5VLky+IoPvDeA: folds
eBrej2jnlUCs/JgxFCRn2g: calls $0.50
AjV5McH1KMMclY26QdLM5w: folds
HZkVla4kK2SI42CVrPZ/ig: folds
jXGruyaMqirTaTXNOvBdew: raises $1 to $1.50
g4k0NXISyLCqaSWZDBjfEg: folds
eBrej2jnlUCs/JgxFCRn2g: folds
jXGruyaMqirTaTXNOvBdew collected $1.50 from pot
*** SUMMARY ***
Total pot $1.50 | Rake $0
Seat 1: HZkVla4kK2SI42CVrPZ/ig (button) folded before Flop (didn't bet)
Seat 2: jXGruyaMqirTaTXNOvBdew (small blind) collected ($1.50)
Seat 3: g4k0NXISyLCqaSWZDBjfEg (big blind) folded before Flop
Seat 4: OWP/DOu+PlPK6ZZ3zYa0HA folded before Flop (didn't bet)
Seat 5: 5SgaHdWixdClWvaEG+KUjQ folded before Flop (didn't bet)
Seat 6: APYIOyK/4AGb+kIwlOUNBQ folded before Flop (didn't bet)
Seat 7: J0W5D97jl5VLky+IoPvDeA folded before Flop (didn't bet)
Seat 8: eBrej2jnlUCs/JgxFCRn2g folded before Flop
Seat 9: AjV5McH1KMMclY26QdLM5w folded before Flop (didn't bet)



PokerStars Game #59940367760:  Hold'em No Limit ($0.25/$0.50) - 2009/07/01 1:04:39 ET
Table 'c/CRn+68J3Y8KxD5g1ek2Q' 2-max Seat #1 is the button
Seat 1: 46qCyJ6evTkHo9al5sBMNA ($95.25 in chips)
Seat 2: BypVLsYQt3ePFm2xQL/dOA ($271.95 in chips)
46qCyJ6evTkHo9al5sBMNA: posts small blind $0.25
BypVLsYQt3ePFm2xQL/dOA: posts big blind $0.50
*** HOLE CARDS ***
46qCyJ6evTkHo9al5sBMNA: raises $1 to $1.50
BypVLsYQt3ePFm2xQL/dOA said, "goog bluff"
BypVLsYQt3ePFm2xQL/dOA: calls $1
*** FLOP *** [9s Qh 3h]
BypVLsYQt3ePFm2xQL/dOA: checks
46qCyJ6evTkHo9al5sBMNA: checks
*** TURN *** [9s Qh 3h] [8d]
BypVLsYQt3ePFm2xQL/dOA: checks
46qCyJ6evTkHo9al5sBMNA: bets $2.50
BypVLsYQt3ePFm2xQL/dOA: calls $2.50
*** RIVER *** [9s Qh 3h 8d] [Ts]
BypVLsYQt3ePFm2xQL/dOA: checks
46qCyJ6evTkHo9al5sBMNA: checks
*** SHOW DOWN ***
BypVLsYQt3ePFm2xQL/dOA: shows [Kh Th] (a pair of Tens)
46qCyJ6evTkHo9al5sBMNA: mucks hand
BypVLsYQt3ePFm2xQL/dOA collected $7.65 from pot
*** SUMMARY ***
Total pot $8 | Rake $0.35
Board [9s Qh 3h 8d Ts]
Seat 1: 46qCyJ6evTkHo9al5sBMNA (button) (small blind) mucked
Seat 2: BypVLsYQt3ePFm2xQL/dOA (big blind) showed [Kh Th] and won ($7.65) with a pair of Tens



PokerStars Game #59940369538:  Hold'em No Limit ($0.25/$0.50) - 2009/07/01 1:04:42 ET
Table 'tYh970kmVfYS0gXPT/XtoQ' 2-max Seat #2 is the button
Seat 1: mW7WbnOUOr5szbwJvGciAA ($29.65 in chips)
Seat 2: dokz3oqYBKI5gNELbiWhbQ ($22.10 in chips)
dokz3oqYBKI5gNELbiWhbQ: posts small blind $0.25
mW7WbnOUOr5szbwJvGciAA: posts big blind $0.50
*** HOLE CARDS ***
dokz3oqYBKI5gNELbiWhbQ: raises $1 to $1.50
mW7WbnOUOr5szbwJvGciAA: folds
dokz3oqYBKI5gNELbiWhbQ collected $1 from pot
*** SUMMARY ***
Total pot $1 | Rake $0
Seat 1: mW7WbnOUOr5szbwJvGciAA (big blind) folded before Flop
Seat 2: dokz3oqYBKI5gNELbiWhbQ (button) (small blind) collected ($1)



PokerStars Game #59940370420:  Hold'em No Limit ($0.25/$0.50) - 2009/07/01 1:04:43 ET
Table 'fx6MqwfYAj/Rt86hBz2L3Q' 9-max Seat #1 is the button
Seat 1: uw9QayAAxLM3Hb+HR7mSkg ($9.25 in chips)
Seat 2: C3rGXblctNcWI6JYPHhaEg ($24.50 in chips)
Seat 3: iadBi5AEt7gTBXbDSSnMYQ ($45.40 in chips)
Seat 4: 75K2MXwN65Sjfp1yHd50Hg ($9.25 in chips)
Seat 5: iAISe3dVeua8PUn2wwgDHw ($61.25 in chips)
Seat 6: 5k9fvXD9suIgCxU4HLQjTw ($50.75 in chips)
Seat 7: SKnJuWHScqetA/qG5p+wCg ($30 in chips)
Seat 8: JYwJYYV9pM5KWdSiETl8rA ($21.25 in chips)
Seat 9: HZkVla4kK2SI42CVrPZ/ig ($18.80 in chips)
C3rGXblctNcWI6JYPHhaEg: posts small blind $0.25
iadBi5AEt7gTBXbDSSnMYQ: posts big blind $0.50
*** HOLE CARDS ***
75K2MXwN65Sjfp1yHd50Hg: folds
iAISe3dVeua8PUn2wwgDHw: folds
5k9fvXD9suIgCxU4HLQjTw: folds
SKnJuWHScqetA/qG5p+wCg: folds
JYwJYYV9pM5KWdSiETl8rA: folds
HZkVla4kK2SI42CVrPZ/ig: calls $0.50
uw9QayAAxLM3Hb+HR7mSkg: raises $8.75 to $9.25 and is all-in
C3rGXblctNcWI6JYPHhaEg: folds
iadBi5AEt7gTBXbDSSnMYQ: folds
HZkVla4kK2SI42CVrPZ/ig: folds
uw9QayAAxLM3Hb+HR7mSkg collected $1.75 from pot
uw9QayAAxLM3Hb+HR7mSkg: doesn't show hand
*** SUMMARY ***
Total pot $1.75 | Rake $0
Seat 1: uw9QayAAxLM3Hb+HR7mSkg (button) collected ($1.75)
Seat 2: C3rGXblctNcWI6JYPHhaEg (small blind) folded before Flop
Seat 3: iadBi5AEt7gTBXbDSSnMYQ (big blind) folded before Flop
Seat 4: 75K2MXwN65Sjfp1yHd50Hg folded before Flop (didn't bet)
Seat 5: iAISe3dVeua8PUn2wwgDHw folded before Flop (didn't bet)
Seat 6: 5k9fvXD9suIgCxU4HLQjTw folded before Flop (didn't bet)
Seat 7: SKnJuWHScqetA/qG5p+wCg folded before Flop (didn't bet)
Seat 8: JYwJYYV9pM5KWdSiETl8rA folded before Flop (didn't bet)
Seat 9: HZkVla4kK2SI42CVrPZ/ig folded before Flop



PokerStars Game #59940371348:  Hold'em No Limit ($0.25/$0.50) - 2009/07/01 1:04:45 ET
Table '5EmHi+fnatGQQShcNmzOZQ' 6-max Seat #2 is the button
Seat 1: My8WkRtGx5FW6rJ1I4R3hg ($16.45 in chips)
Seat 2: bfFjgAtIoAI+pUxUwFt3aQ ($47.25 in chips)
Seat 3: TjmTe3bhs9dFz5gXX9x7Lw ($14.75 in chips)
Seat 4: 1b+2BbjMN8qhR1WPqdE9VQ ($66.55 in chips)
Seat 5: kxPhs4ePFqMy52CInAJ2aw ($82.05 in chips)
Seat 6: 686aeHikcJlgKkSuIFdcXQ ($133.30 in chips)
TjmTe3bhs9dFz5gXX9x7Lw: posts small blind $0.25
1b+2BbjMN8qhR1WPqdE9VQ: posts big blind $0.50
*** HOLE CARDS ***
kxPhs4ePFqMy52CInAJ2aw: raises $1.50 to $2
686aeHikcJlgKkSuIFdcXQ: folds
My8WkRtGx5FW6rJ1I4R3hg: folds
bfFjgAtIoAI+pUxUwFt3aQ: folds
TjmTe3bhs9dFz5gXX9x7Lw: calls $1.75
1b+2BbjMN8qhR1WPqdE9VQ: folds
*** FLOP *** [Jc 8s Ad]
TjmTe3bhs9dFz5gXX9x7Lw: checks
kxPhs4ePFqMy52CInAJ2aw: checks
*** TURN *** [Jc 8s Ad] [Ts]
TjmTe3bhs9dFz5gXX9x7Lw: checks
kxPhs4ePFqMy52CInAJ2aw: bets $3
TjmTe3bhs9dFz5gXX9x7Lw: calls $3
*** RIVER *** [Jc 8s Ad Ts] [2d]
TjmTe3bhs9dFz5gXX9x7Lw: checks
kxPhs4ePFqMy52CInAJ2aw: bets $37.50
TjmTe3bhs9dFz5gXX9x7Lw: calls $9.75 and is all-in
*** SHOW DOWN ***
kxPhs4ePFqMy52CInAJ2aw: shows [9h 7h] (a straight, Seven to Jack)
TjmTe3bhs9dFz5gXX9x7Lw: mucks hand
kxPhs4ePFqMy52CInAJ2aw collected $28.55 from pot
*** SUMMARY ***
Total pot $30 | Rake $1.45
Board [Jc 8s Ad Ts 2d]
Seat 1: My8WkRtGx5FW6rJ1I4R3hg folded before Flop (didn't bet)
Seat 2: bfFjgAtIoAI+pUxUwFt3aQ (button) folded before Flop (didn't bet)
Seat 3: TjmTe3bhs9dFz5gXX9x7Lw (small blind) mucked
Seat 4: 1b+2BbjMN8qhR1WPqdE9VQ (big blind) folded before Flop
Seat 5: kxPhs4ePFqMy52CInAJ2aw showed [9h 7h] and won ($28.55) with a straight, Seven to Jack
Seat 6: 686aeHikcJlgKkSuIFdcXQ folded before Flop (didn't bet)



PokerStars Game #59940371334:  Hold'em No Limit ($0.25/$0.50) - 2009/07/01 1:04:45 ET
Table 'GfL/No5u5PoEnU39lP5pQg' 6-max Seat #4 is the button
Seat 1: 1WUCqNG+p+vfWRTXNu4ljw ($66 in chips)
Seat 2: uVwggSetzp7d+eVgowO3vg ($59.75 in chips)
Seat 3: eQXFICMuu3hw6XlcmuVNEA ($12.30 in chips)
Seat 4: r6u7MWSXF30/khcTYkrG9Q ($38.65 in chips)
Seat 5: M1KyQQvVPVuxqTAB8sR/zQ ($53.25 in chips)
Seat 6: kxPhs4ePFqMy52CInAJ2aw ($48.50 in chips)
M1KyQQvVPVuxqTAB8sR/zQ: posts small blind $0.25
kxPhs4ePFqMy52CInAJ2aw: posts big blind $0.50
*** HOLE CARDS ***
1WUCqNG+p+vfWRTXNu4ljw: folds
uVwggSetzp7d+eVgowO3vg: folds
eQXFICMuu3hw6XlcmuVNEA: folds
r6u7MWSXF30/khcTYkrG9Q: folds
M1KyQQvVPVuxqTAB8sR/zQ: folds
kxPhs4ePFqMy52CInAJ2aw collected $0.50 from pot
kxPhs4ePFqMy52CInAJ2aw: doesn't show hand
*** SUMMARY ***
Total pot $0.50 | Rake $0
Seat 1: 1WUCqNG+p+vfWRTXNu4ljw folded before Flop (didn't bet)
Seat 2: uVwggSetzp7d+eVgowO3vg folded before Flop (didn't bet)
Seat 3: eQXFICMuu3hw6XlcmuVNEA folded before Flop (didn't bet)
Seat 4: r6u7MWSXF30/khcTYkrG9Q (button) folded before Flop (didn't bet)
Seat 5: M1KyQQvVPVuxqTAB8sR/zQ (small blind) folded before Flop
Seat 6: kxPhs4ePFqMy52CInAJ2aw (big blind) collected ($0.50)



PokerStars Game #59940372126:  Hold'em No Limit ($0.25/$0.50) - 2009/07/01 1:04:46 ET
Table 'BCN5su+SsXiy1zRMJi0SJw' 6-max Seat #2 is the button
Seat 1: GxXV09ciXaOxyY2H5aMIIw ($41.55 in chips)
Seat 2: oU2kDCkT/gilYbHWrg7D8w ($40.60 in chips)
Seat 3: 6wzJiRvp8HY6t+MQGnSIzA ($10.05 in chips)
Seat 4: 4QfsCWthT/vSLirorNXqtg ($50 in chips)
Seat 5: IBNygaT1aa9Z1uPdJJilwA ($43.30 in chips)
Seat 6: b2symlOdL7+0c9Pj4N/KlA ($58.90 in chips)
6wzJiRvp8HY6t+MQGnSIzA: posts small blind $0.25
4QfsCWthT/vSLirorNXqtg: posts big blind $0.50
*** HOLE CARDS ***
IBNygaT1aa9Z1uPdJJilwA: folds
b2symlOdL7+0c9Pj4N/KlA: raises $1.50 to $2
GxXV09ciXaOxyY2H5aMIIw: folds
oU2kDCkT/gilYbHWrg7D8w: folds
6wzJiRvp8HY6t+MQGnSIzA: folds
4QfsCWthT/vSLirorNXqtg: folds
b2symlOdL7+0c9Pj4N/KlA collected $1.25 from pot
b2symlOdL7+0c9Pj4N/KlA: doesn't show hand
*** SUMMARY ***
Total pot $1.25 | Rake $0
Seat 1: GxXV09ciXaOxyY2H5aMIIw folded before Flop (didn't bet)
Seat 2: oU2kDCkT/gilYbHWrg7D8w (button) folded before Flop (didn't bet)
Seat 3: 6wzJiRvp8HY6t+MQGnSIzA (small blind) folded before Flop
Seat 4: 4QfsCWthT/vSLirorNXqtg (big blind) folded before Flop
Seat 5: IBNygaT1aa9Z1uPdJJilwA folded before Flop (didn't bet)
Seat 6: b2symlOdL7+0c9Pj4N/KlA collected ($1.25)



PokerStars Game #59940374122:  Hold'em No Limit ($0.25/$0.50) - 2009/07/01 1:04:49 ET
Table 'ErOuyGLI5PT3G5MnpHgC/gQOgaEqMcJ73pcUMMxoisUg Seat #9 is the button
Seat 2: pciZn00ZDk4BVBMTTMcNVQ ($28.25 in chips)
Seat 3: xZCXQSXlrZkp3pZizzVXCw ($52.75 in chips)
Seat 4: 3UmXLy3GfjC3EkOebduerQ ($50 in chips)
Seat 5: JwvquocWfhTVApN5t47LgA ($64.65 in chips)
Seat 6: zE9cVigS2nW/Ljy4K4bUQA ($31.60 in chips)
Seat 7: 90Wb75h3W1BRpbqVnuk8gw ($63.60 in chips)
Seat 8: g4k0NXISyLCqaSWZDBjfEg ($50 in chips)
Seat 9: J0W5D97jl5VLky+IoPvDeA ($51.40 in chips)
pciZn00ZDk4BVBMTTMcNVQ: posts small blind $0.25
xZCXQSXlrZkp3pZizzVXCw: posts big blind $0.50
*** HOLE CARDS ***
3UmXLy3GfjC3EkOebduerQ: folds
JwvquocWfhTVApN5t47LgA: folds
zE9cVigS2nW/Ljy4K4bUQA: folds
90Wb75h3W1BRpbqVnuk8gw: folds
g4k0NXISyLCqaSWZDBjfEg: raises $1 to $1.50
J0W5D97jl5VLky+IoPvDeA: folds
pciZn00ZDk4BVBMTTMcNVQ: folds
xZCXQSXlrZkp3pZizzVXCw: folds
g4k0NXISyLCqaSWZDBjfEg collected $1.25 from pot
*** SUMMARY ***
Total pot $1.25 | Rake $0
Seat 2: pciZn00ZDk4BVBMTTMcNVQ (small blind) folded before Flop
Seat 3: xZCXQSXlrZkp3pZizzVXCw (big blind) folded before Flop
Seat 4: 3UmXLy3GfjC3EkOebduerQ folded before Flop (didn't bet)
Seat 5: JwvquocWfhTVApN5t47LgA folded before Flop (didn't bet)
Seat 6: zE9cVigS2nW/Ljy4K4bUQA folded before Flop (didn't bet)
Seat 7: 90Wb75h3W1BRpbqVnuk8gw folded before Flop (didn't bet)
Seat 8: g4k0NXISyLCqaSWZDBjfEg collected ($1.25)
Seat 9: J0W5D97jl5VLky+IoPvDeA (button) folded before Flop (didn't bet)



PokerStars Game #59940374274:  Hold'em No Limit ($0.25/$0.50) - 2009/07/01 1:04:50 ET
Table '+z1aekfHkpp09pc8F9aViw' 6-max Seat #4 is the button
Seat 1: FHilMb2i2DbUCc9lplszog ($18.40 in chips)
Seat 2: 5j0x09GvpIU1XELCpgivoA ($10.05 in chips)
Seat 3: uUznlIMFnRUvwrBhYF73KA ($131.65 in chips)
Seat 4: RowCSpSURHTOL/dcjg/Iug ($37.30 in chips)
Seat 5: rplyldNweS6YyMNEALQrug ($54.45 in chips)
Seat 6: 686aeHikcJlgKkSuIFdcXQ ($50 in chips)
rplyldNweS6YyMNEALQrug: posts small blind $0.25
686aeHikcJlgKkSuIFdcXQ: posts big blind $0.50
5j0x09GvpIU1XELCpgivoA: posts big blind $0.50
*** HOLE CARDS ***
FHilMb2i2DbUCc9lplszog: raises $2 to $2.50
5j0x09GvpIU1XELCpgivoA: raises $7.55 to $10.05 and is all-in
uUznlIMFnRUvwrBhYF73KA: folds
RowCSpSURHTOL/dcjg/Iug: folds
rplyldNweS6YyMNEALQrug: folds
686aeHikcJlgKkSuIFdcXQ: folds
FHilMb2i2DbUCc9lplszog: calls $7.55
*** FLOP *** [Js 3h 2c]
*** TURN *** [Js 3h 2c] [Ah]
*** RIVER *** [Js 3h 2c Ah] [4h]
*** SHOW DOWN ***
FHilMb2i2DbUCc9lplszog: shows [9h Qs] (high card Ace)
5j0x09GvpIU1XELCpgivoA: shows [Kh 8c] (high card Ace - King kicker)
5j0x09GvpIU1XELCpgivoA collected $19.85 from pot
*** SUMMARY ***
Total pot $20.85 | Rake $1
Board [Js 3h 2c Ah 4h]
Seat 1: FHilMb2i2DbUCc9lplszog showed [9h Qs] and lost with high card Ace
Seat 2: 5j0x09GvpIU1XELCpgivoA showed [Kh 8c] and won ($19.85) with high card Ace
Seat 3: uUznlIMFnRUvwrBhYF73KA folded before Flop (didn't bet)
Seat 4: RowCSpSURHTOL/dcjg/Iug (button) folded before Flop (didn't bet)
Seat 5: rplyldNweS6YyMNEALQrug (small blind) folded before Flop
Seat 6: 686aeHikcJlgKkSuIFdcXQ (big blind) folded before Flop



PokerStars Game #59940375020:  Hold'em No Limit ($0.25/$0.50) - 2009/07/01 1:04:51 ET
Table 'tYh970kmVfYS0gXPT/XtoQ' 2-max Seat #1 is the button
Seat 1: mW7WbnOUOr5szbwJvGciAA ($29.15 in chips)
Seat 2: dokz3oqYBKI5gNELbiWhbQ ($22.60 in chips)
mW7WbnOUOr5szbwJvGciAA: posts small blind $0.25
dokz3oqYBKI5gNELbiWhbQ: posts big blind $0.50
*** HOLE CARDS ***
mW7WbnOUOr5szbwJvGciAA: folds
dokz3oqYBKI5gNELbiWhbQ collected $0.50 from pot
*** SUMMARY ***
Total pot $0.50 | Rake $0
Seat 1: mW7WbnOUOr5szbwJvGciAA (button) (small blind) folded before Flop
Seat 2: dokz3oqYBKI5gNELbiWhbQ (big blind) collected ($0.50)



PokerStars Game #59940374916:  Hold'em No Limit ($0.25/$0.50) - 2009/07/01 1:04:51 ET
Table 'NCiXr0d5CEKBQr/cZgLhbA' 9-max Seat #4 is the button
Seat 1: pFtzb1sR4b0d1aw6aIRgDg ($50 in chips)
Seat 2: ulxuJchBV9iguXg0FUonfg ($52.20 in chips)
Seat 3: xZCXQSXlrZkp3pZizzVXCw ($51.95 in chips)
Seat 4: 5k9fvXD9suIgCxU4HLQjTw ($54.45 in chips)
Seat 5: zE9cVigS2nW/Ljy4K4bUQA ($32.80 in chips)
Seat 6: SKnJuWHScqetA/qG5p+wCg ($32.75 in chips)
Seat 7: M+7+BTmX5vZatHVuoRB1nA ($52.75 in chips)
Seat 8: 1MJUKc3cc0QmUoz1JZLR2w ($64.05 in chips)
Seat 9: 4WLZvqBn5qv5tds5kt5A1Q ($40.15 in chips)
zE9cVigS2nW/Ljy4K4bUQA: posts small blind $0.25
SKnJuWHScqetA/qG5p+wCg: posts big blind $0.50
*** HOLE CARDS ***
M+7+BTmX5vZatHVuoRB1nA: folds
1MJUKc3cc0QmUoz1JZLR2w: folds
4WLZvqBn5qv5tds5kt5A1Q: folds
pFtzb1sR4b0d1aw6aIRgDg: folds
ulxuJchBV9iguXg0FUonfg: raises $1.50 to $2
xZCXQSXlrZkp3pZizzVXCw: folds
5k9fvXD9suIgCxU4HLQjTw: calls $2
zE9cVigS2nW/Ljy4K4bUQA: raises $6 to $8
SKnJuWHScqetA/qG5p+wCg: folds
ulxuJchBV9iguXg0FUonfg: calls $6
5k9fvXD9suIgCxU4HLQjTw: folds
*** FLOP *** [8c 2h 4h]
zE9cVigS2nW/Ljy4K4bUQA: bets $10
ulxuJchBV9iguXg0FUonfg: raises $15 to $25
zE9cVigS2nW/Ljy4K4bUQA: calls $14.80 and is all-in
*** TURN *** [8c 2h 4h] [7d]
*** RIVER *** [8c 2h 4h 7d] [3h]
*** SHOW DOWN ***
zE9cVigS2nW/Ljy4K4bUQA: shows [Ks Kc] (a pair of Kings)
ulxuJchBV9iguXg0FUonfg: mucks hand
ulxuJchBV9iguXg0FUonfg said, "nh"
zE9cVigS2nW/Ljy4K4bUQA collected $65.10 from pot
*** SUMMARY ***
Total pot $68.10 | Rake $3
Board [8c 2h 4h 7d 3h]
Seat 1: pFtzb1sR4b0d1aw6aIRgDg folded before Flop (didn't bet)
Seat 2: ulxuJchBV9iguXg0FUonfg mucked
Seat 3: xZCXQSXlrZkp3pZizzVXCw folded before Flop (didn't bet)
Seat 4: 5k9fvXD9suIgCxU4HLQjTw (button) folded before Flop
Seat 5: zE9cVigS2nW/Ljy4K4bUQA (small blind) showed [Ks Kc] and won ($65.10) with a pair of Kings
Seat 6: SKnJuWHScqetA/qG5p+wCg (big blind) folded before Flop
Seat 7: M+7+BTmX5vZatHVuoRB1nA folded before Flop (didn't bet)
Seat 8: 1MJUKc3cc0QmUoz1JZLR2w folded before Flop (didn't bet)
Seat 9: 4WLZvqBn5qv5tds5kt5A1Q folded before Flop (didn't bet)



PokerStars Game #59940376372:  Hold'em No Limit ($0.25/$0.50) - 2009/07/01 1:04:53 ET
Table 'QOgaEqMcJ73pcUMMxoisUg' 6-max Seat #4 is the button
Seat 1: lxIzoHy0RnkfFSODHC2liw ($54.10 in chips)
Seat 3: Rt6KgtZ8YaJoTc3FPim00w ($52.25 in chips)
Seat 4: zAcsDhG/T128Vn7XGVSgKg ($50 in chips)
Seat 5: 6vNxrjjCl6FwfaaymM9jjg ($22 in chips)
6vNxrjjCl6FwfaaymM9jjg: posts small blind $0.25
lxIzoHy0RnkfFSODHC2liw: posts big blind $0.50
*** HOLE CARDS ***
Rt6KgtZ8YaJoTc3FPim00w: folds
zAcsDhG/T128Vn7XGVSgKg: raises $1 to $1.50
6vNxrjjCl6FwfaaymM9jjg: folds
lxIzoHy0RnkfFSODHC2liw: folds
zAcsDhG/T128Vn7XGVSgKg collected $1.25 from pot
*** SUMMARY ***
Total pot $1.25 | Rake $0
Seat 1: lxIzoHy0RnkfFSODHC2liw (big blind) folded before Flop
Seat 3: Rt6KgtZ8YaJoTc3FPim00w folded before Flop (didn't bet)
Seat 4: zAcsDhG/T128Vn7XGVSgKg (button) collected ($1.25)
Seat 5: 6vNxrjjCl6FwfaaymM9jjg (small blind) folded before Flop



PokerStars Game #59940376798:  Hold'em No Limit ($0.25/$0.50) - 2009/07/01 1:04:54 ET
Table 'otvGDROEDdqsabxskT79qg' 9-max Seat #8 is the button
Seat 1: 8ehL7qlZzjgUh2H35iiWLw ($56.75 in chips)
Seat 2: cCjTzH9jio8607WzjcfXlg ($12.25 in chips)
Seat 3: +k7T5ocke8UwavtgUHm+Cg ($70.60 in chips)
Seat 4: MG90wfSJZnOejs/KD3vlQQ ($76.65 in chips)
Seat 5: E2518gp4aFz1+kAgmGqeEg ($11.75 in chips)
Seat 6: bxLSulbgr8LmKNjOzw8URg ($55.50 in chips)
Seat 7: 75K2MXwN65Sjfp1yHd50Hg ($9.25 in chips)
Seat 8: zE9cVigS2nW/Ljy4K4bUQA ($30 in chips)
Seat 9: KcY3X8YpD74Kw1RHkx/g4A ($50.65 in chips)
KcY3X8YpD74Kw1RHkx/g4A: posts small blind $0.25
8ehL7qlZzjgUh2H35iiWLw: posts big blind $0.50
*** HOLE CARDS ***
cCjTzH9jio8607WzjcfXlg: folds
+k7T5ocke8UwavtgUHm+Cg: folds
MG90wfSJZnOejs/KD3vlQQ: folds
E2518gp4aFz1+kAgmGqeEg: folds
bxLSulbgr8LmKNjOzw8URg: folds
75K2MXwN65Sjfp1yHd50Hg: raises $1 to $1.50
zE9cVigS2nW/Ljy4K4bUQA: folds
KcY3X8YpD74Kw1RHkx/g4A: folds
8ehL7qlZzjgUh2H35iiWLw: folds
75K2MXwN65Sjfp1yHd50Hg collected $1.25 from pot
75K2MXwN65Sjfp1yHd50Hg: doesn't show hand
*** SUMMARY ***
Total pot $1.25 | Rake $0
Seat 1: 8ehL7qlZzjgUh2H35iiWLw (big blind) folded before Flop
Seat 2: cCjTzH9jio8607WzjcfXlg folded before Flop (didn't bet)
Seat 3: +k7T5ocke8UwavtgUHm+Cg folded before Flop (didn't bet)
Seat 4: MG90wfSJZnOejs/KD3vlQQ folded before Flop (didn't bet)
Seat 5: E2518gp4aFz1+kAgmGqeEg folded before Flop (didn't bet)
Seat 6: bxLSulbgr8LmKNjOzw8URg folded before Flop (didn't bet)
Seat 7: 75K2MXwN65Sjfp1yHd50Hg collected ($1.25)
Seat 8: zE9cVigS2nW/Ljy4K4bUQA (button) folded before Flop (didn't bet)
Seat 9: KcY3X8YpD74Kw1RHkx/g4A (small blind) folded before Flop



PokerStars Game #59940377726:  Hold'em No Limit ($0.25/$0.50) - 2009/07/01 1:04:55 ET
Table 'ZYI3ZReBjdfKEYItkZHI6A' 9-max Seat #8 is the button
Seat 1: E2518gp4aFz1+kAgmGqeEg ($14.85 in chips)
Seat 2: 8zdVaT8pZ/Wm0uWoeLhtZg ($7.50 in chips)
Seat 3: bkXkL3pmapikPQQRNPZSEA ($18.75 in chips)
Seat 4: e2+sK/yjnj94rXOKoxPP2A ($50 in chips)
Seat 5: ApHP7ouup365XIUFBdEDxg ($46.90 in chips)
Seat 6: Wj7mKnRFR90j40wWUu2+Og ($31.70 in chips)
Seat 7: HWcfp1hY1hqvrddzW3/FQw ($16 in chips)
Seat 8: ji04uOybxCdpdefzlUQeKQ ($28 in chips)
Seat 9: tLkxo7JgV+WWI0UBw44K5A ($51.10 in chips)
tLkxo7JgV+WWI0UBw44K5A: posts small blind $0.25
E2518gp4aFz1+kAgmGqeEg: posts big blind $0.50
*** HOLE CARDS ***
8zdVaT8pZ/Wm0uWoeLhtZg: folds
bkXkL3pmapikPQQRNPZSEA: folds
e2+sK/yjnj94rXOKoxPP2A: folds
ApHP7ouup365XIUFBdEDxg: raises $0.50 to $1
Wj7mKnRFR90j40wWUu2+Og: folds
HWcfp1hY1hqvrddzW3/FQw: folds
ji04uOybxCdpdefzlUQeKQ: folds
tLkxo7JgV+WWI0UBw44K5A: folds
E2518gp4aFz1+kAgmGqeEg: folds
ApHP7ouup365XIUFBdEDxg collected $1.25 from pot
ApHP7ouup365XIUFBdEDxg: doesn't show hand
*** SUMMARY ***
Total pot $1.25 | Rake $0
Seat 1: E2518gp4aFz1+kAgmGqeEg (big blind) folded before Flop
Seat 2: 8zdVaT8pZ/Wm0uWoeLhtZg folded before Flop (didn't bet)
Seat 3: bkXkL3pmapikPQQRNPZSEA folded before Flop (didn't bet)
Seat 4: e2+sK/yjnj94rXOKoxPP2A folded before Flop (didn't bet)
Seat 5: ApHP7ouup365XIUFBdEDxg collected ($1.25)
Seat 6: Wj7mKnRFR90j40wWUu2+Og folded before Flop (didn't bet)
Seat 7: HWcfp1hY1hqvrddzW3/FQw folded before Flop (didn't bet)
Seat 8: ji04uOybxCdpdefzlUQeKQ (button) folded before Flop (didn't bet)
Seat 9: tLkxo7JgV+WWI0UBw44K5A (small blind) folded before Flop



PokerStars Game #59940378628:  Hold'em No Limit ($0.25/$0.50) - 2009/07/01 1:04:57 ET
Table '8BQGgNetI1NOvWeu3gtMNw' 2-max Seat #1 is the button
Seat 1: bypIyrYcAAifLfhZpGlKLA ($86.95 in chips)
Seat 2: Z4HwehErEwzsv/noQlfUlg ($113.25 in chips)
bypIyrYcAAifLfhZpGlKLA: posts small blind $0.25
Z4HwehErEwzsv/noQlfUlg: posts big blind $0.50
*** HOLE CARDS ***
bypIyrYcAAifLfhZpGlKLA: raises $1 to $1.50
Z4HwehErEwzsv/noQlfUlg: calls $1
*** FLOP *** [4h 5c Qh]
Z4HwehErEwzsv/noQlfUlg: checks
bypIyrYcAAifLfhZpGlKLA: checks
*** TURN *** [4h 5c Qh] [9s]
Z4HwehErEwzsv/noQlfUlg: bets $1
bypIyrYcAAifLfhZpGlKLA: raises $3.50 to $4.50
Z4HwehErEwzsv/noQlfUlg: folds
bypIyrYcAAifLfhZpGlKLA collected $4.80 from pot
bypIyrYcAAifLfhZpGlKLA: doesn't show hand
*** SUMMARY ***
Total pot $5 | Rake $0.20
Board [4h 5c Qh 9s]
Seat 1: bypIyrYcAAifLfhZpGlKLA (button) (small blind) collected ($4.80)
Seat 2: Z4HwehErEwzsv/noQlfUlg (big blind) folded on the Turn



PokerStars Game #59940379238:  Hold'em No Limit ($0.25/$0.50) - 2009/07/01 1:04:58 ET
Table 'tYh970kmVfYS0gXPT/XtoQ' 2-max Seat #2 is the button
Seat 1: mW7WbnOUOr5szbwJvGciAA ($28.90 in chips)
Seat 2: dokz3oqYBKI5gNELbiWhbQ ($22.85 in chips)
dokz3oqYBKI5gNELbiWhbQ: posts small blind $0.25
mW7WbnOUOr5szbwJvGciAA: posts big blind $0.50
*** HOLE CARDS ***
dokz3oqYBKI5gNELbiWhbQ: raises $1 to $1.50
mW7WbnOUOr5szbwJvGciAA: raises $1 to $2.50
dokz3oqYBKI5gNELbiWhbQ: calls $1
*** FLOP *** [7c 2h 2c]
mW7WbnOUOr5szbwJvGciAA: checks
dokz3oqYBKI5gNELbiWhbQ: checks
*** TURN *** [7c 2h 2c] [Ac]
mW7WbnOUOr5szbwJvGciAA: bets $1.50
dokz3oqYBKI5gNELbiWhbQ: folds
mW7WbnOUOr5szbwJvGciAA collected $4.75 from pot
*** SUMMARY ***
Total pot $5 | Rake $0.25
Board [7c 2h 2c Ac]
Seat 1: mW7WbnOUOr5szbwJvGciAA (big blind) collected ($4.75)
Seat 2: dokz3oqYBKI5gNELbiWhbQ (button) (small blind) folded on the Turn



PokerStars Game #59940379198:  Hold'em No Limit ($0.25/$0.50) - 2009/07/01 1:04:58 ET
Table 'GfL/No5u5PoEnU39lP5pQg' 6-max Seat #5 is the button
Seat 1: 1WUCqNG+p+vfWRTXNu4ljw ($66 in chips)
Seat 2: uVwggSetzp7d+eVgowO3vg ($59.75 in chips)
Seat 3: eQXFICMuu3hw6XlcmuVNEA ($12.30 in chips)
Seat 4: r6u7MWSXF30/khcTYkrG9Q ($38.65 in chips)
Seat 5: M1KyQQvVPVuxqTAB8sR/zQ ($53 in chips)
Seat 6: kxPhs4ePFqMy52CInAJ2aw ($48.75 in chips)
kxPhs4ePFqMy52CInAJ2aw: posts small blind $0.25
1WUCqNG+p+vfWRTXNu4ljw: posts big blind $0.50
*** HOLE CARDS ***
uVwggSetzp7d+eVgowO3vg: raises $0.75 to $1.25
eQXFICMuu3hw6XlcmuVNEA: calls $1.25
r6u7MWSXF30/khcTYkrG9Q: calls $1.25
M1KyQQvVPVuxqTAB8sR/zQ: folds
kxPhs4ePFqMy52CInAJ2aw: folds
1WUCqNG+p+vfWRTXNu4ljw: calls $0.75
*** FLOP *** [6c Jh 2h]
1WUCqNG+p+vfWRTXNu4ljw: checks
uVwggSetzp7d+eVgowO3vg: checks
eQXFICMuu3hw6XlcmuVNEA: bets $1.50
r6u7MWSXF30/khcTYkrG9Q: calls $1.50
1WUCqNG+p+vfWRTXNu4ljw: folds
uVwggSetzp7d+eVgowO3vg: folds
*** TURN *** [6c Jh 2h] [8h]
eQXFICMuu3hw6XlcmuVNEA: bets $2
r6u7MWSXF30/khcTYkrG9Q: folds
eQXFICMuu3hw6XlcmuVNEA collected $7.85 from pot
*** SUMMARY ***
Total pot $8.25 | Rake $0.40
Board [6c Jh 2h 8h]
Seat 1: 1WUCqNG+p+vfWRTXNu4ljw (big blind) folded on the Flop
Seat 2: uVwggSetzp7d+eVgowO3vg folded on the Flop
Seat 3: eQXFICMuu3hw6XlcmuVNEA collected ($7.85)
Seat 4: r6u7MWSXF30/khcTYkrG9Q folded on the Turn
Seat 5: M1KyQQvVPVuxqTAB8sR/zQ (button) folded before Flop (didn't bet)
Seat 6: kxPhs4ePFqMy52CInAJ2aw (small blind) folded before Flop



PokerStars Game #59940379426:  Hold'em No Limit ($0.25/$0.50) - 2009/07/01 1:04:58 ET
Table 'lpxYasB1ClBSgTpCCITwhQ' 9-max Seat #6 is the button
Seat 1: mj7PS7wCH4PAl7+eYTFs7A ($44.30 in chips)
Seat 2: OWP/DOu+PlPK6ZZ3zYa0HA ($28.45 in chips)
Seat 4: NnQCepdIR/AOUQn1yhYx6Q ($8.50 in chips)
Seat 5: IYd5zG8k7vdBNVHbHg2Pag ($35 in chips)
Seat 6: SegjDnMxWMujiD57ESNL+g ($11.35 in chips)
Seat 7: bmRtaIYKthN1F+B3JLZ3Jw ($73.65 in chips)
Seat 8: /mfensKw8/iZ1Vrx33S4xg ($11.85 in chips)
Seat 9: sUIUZ+begh92dzkUmvbMrw ($9.90 in chips)
bmRtaIYKthN1F+B3JLZ3Jw: posts small blind $0.25
/mfensKw8/iZ1Vrx33S4xg: posts big blind $0.50
*** HOLE CARDS ***
sUIUZ+begh92dzkUmvbMrw: folds
mj7PS7wCH4PAl7+eYTFs7A: folds
OWP/DOu+PlPK6ZZ3zYa0HA: folds
NnQCepdIR/AOUQn1yhYx6Q: raises $1.50 to $2
IYd5zG8k7vdBNVHbHg2Pag: folds
sakr/FIfFtIZwDPmAj5Pzg joins the table at seat #3
SegjDnMxWMujiD57ESNL+g: folds
bmRtaIYKthN1F+B3JLZ3Jw: folds
/mfensKw8/iZ1Vrx33S4xg: calls $1.50
*** FLOP *** [9s Td 6h]
/mfensKw8/iZ1Vrx33S4xg: checks
NnQCepdIR/AOUQn1yhYx6Q: bets $2.50
/mfensKw8/iZ1Vrx33S4xg: raises $2.50 to $5
NnQCepdIR/AOUQn1yhYx6Q: raises $1.50 to $6.50 and is all-in
/mfensKw8/iZ1Vrx33S4xg: calls $1.50
*** TURN *** [9s Td 6h] [Kd]
*** RIVER *** [9s Td 6h Kd] [Ac]
*** SHOW DOWN ***
/mfensKw8/iZ1Vrx33S4xg: shows [9c Ah] (two pair, Aces and Nines)
NnQCepdIR/AOUQn1yhYx6Q: mucks hand
/mfensKw8/iZ1Vrx33S4xg collected $16.40 from pot
*** SUMMARY ***
Total pot $17.25 | Rake $0.85
Board [9s Td 6h Kd Ac]
Seat 1: mj7PS7wCH4PAl7+eYTFs7A folded before Flop (didn't bet)
Seat 2: OWP/DOu+PlPK6ZZ3zYa0HA folded before Flop (didn't bet)
Seat 4: NnQCepdIR/AOUQn1yhYx6Q mucked
Seat 5: IYd5zG8k7vdBNVHbHg2Pag folded before Flop (didn't bet)
Seat 6: SegjDnMxWMujiD57ESNL+g (button) folded before Flop (didn't bet)
Seat 7: bmRtaIYKthN1F+B3JLZ3Jw (small blind) folded before Flop
Seat 8: /mfensKw8/iZ1Vrx33S4xg (big blind) showed [9c Ah] and won ($16.40) with two pair, Aces and Nines
Seat 9: sUIUZ+begh92dzkUmvbMrw folded before Flop (didn't bet)



PokerStars Game #59940380032:  Hold'em No Limit ($0.25/$0.50) - 2009/07/01 1:04:59 ET
Table '37qXEp3oe+er5q4CZip9eQ' 6-max Seat #5 is the button
Seat 1: oqOqoO2AyCZenUghCxMDxw ($50 in chips)
Seat 2: LvH4G7n+QSjT6NDaD3cREA ($56.55 in chips)
Seat 3: Rt6KgtZ8YaJoTc3FPim00w ($110.20 in chips)
Seat 4: XsmE8nXMAAMFJbWaJTmHFw ($39.85 in chips)
Seat 5: VOmI0x4dDPnTESZd5B4d1Q ($41.80 in chips)
Seat 6: N50kln4negd8q7Mmoz1j4g ($16.85 in chips)
N50kln4negd8q7Mmoz1j4g: posts small blind $0.25
oqOqoO2AyCZenUghCxMDxw: posts big blind $0.50
*** HOLE CARDS ***
LvH4G7n+QSjT6NDaD3cREA: raises $1 to $1.50
Rt6KgtZ8YaJoTc3FPim00w: folds
XsmE8nXMAAMFJbWaJTmHFw: folds
VOmI0x4dDPnTESZd5B4d1Q: folds
N50kln4negd8q7Mmoz1j4g: folds
oqOqoO2AyCZenUghCxMDxw: folds
oqOqoO2AyCZenUghCxMDxw leaves the table
LvH4G7n+QSjT6NDaD3cREA collected $1.25 from pot
*** SUMMARY ***
Total pot $1.25 | Rake $0
Seat 1: oqOqoO2AyCZenUghCxMDxw (big blind) folded before Flop
Seat 2: LvH4G7n+QSjT6NDaD3cREA collected ($1.25)
Seat 3: Rt6KgtZ8YaJoTc3FPim00w folded before Flop (didn't bet)
Seat 4: XsmE8nXMAAMFJbWaJTmHFw folded before Flop (didn't bet)
Seat 5: VOmI0x4dDPnTESZd5B4d1Q (button) folded before Flop (didn't bet)
Seat 6: N50kln4negd8q7Mmoz1j4g (small blind) folded before Flop



PokerStars Game #59940380452:  Hold'em No Limit ($0.25/$0.50) - 2009/07/01 1:05:00 ET
Table 'BCN5su+SsXiy1zRMJi0SJw' 6-max Seat #3 is the button
Seat 1: GxXV09ciXaOxyY2H5aMIIw ($41.55 in chips)
Seat 2: oU2kDCkT/gilYbHWrg7D8w ($40.60 in chips)
Seat 3: 6wzJiRvp8HY6t+MQGnSIzA ($9.80 in chips)
Seat 4: 4QfsCWthT/vSLirorNXqtg ($50 in chips)
Seat 5: IBNygaT1aa9Z1uPdJJilwA ($43.30 in chips)
Seat 6: b2symlOdL7+0c9Pj4N/KlA ($59.65 in chips)
4QfsCWthT/vSLirorNXqtg: posts small blind $0.25
IBNygaT1aa9Z1uPdJJilwA: posts big blind $0.50
*** HOLE CARDS ***
b2symlOdL7+0c9Pj4N/KlA: folds
GxXV09ciXaOxyY2H5aMIIw: folds
oU2kDCkT/gilYbHWrg7D8w: folds
6wzJiRvp8HY6t+MQGnSIzA: raises $1.50 to $2
oU2kDCkT/gilYbHWrg7D8w said, "ok"
4QfsCWthT/vSLirorNXqtg: folds
IBNygaT1aa9Z1uPdJJilwA: calls $1.50
*** FLOP *** [3c 8d Jh]
IBNygaT1aa9Z1uPdJJilwA: checks
6wzJiRvp8HY6t+MQGnSIzA: bets $7.80 and is all-in
IBNygaT1aa9Z1uPdJJilwA: calls $7.80
*** TURN *** [3c 8d Jh] [Td]
*** RIVER *** [3c 8d Jh Td] [3s]
*** SHOW DOWN ***
IBNygaT1aa9Z1uPdJJilwA: shows [8c 9c] (two pair, Eights and Threes)
6wzJiRvp8HY6t+MQGnSIzA: mucks hand
IBNygaT1aa9Z1uPdJJilwA collected $18.90 from pot
*** SUMMARY ***
Total pot $19.85 | Rake $0.95
Board [3c 8d Jh Td 3s]
Seat 1: GxXV09ciXaOxyY2H5aMIIw folded before Flop (didn't bet)
Seat 2: oU2kDCkT/gilYbHWrg7D8w folded before Flop (didn't bet)
Seat 3: 6wzJiRvp8HY6t+MQGnSIzA (button) mucked
Seat 4: 4QfsCWthT/vSLirorNXqtg (small blind) folded before Flop
Seat 5: IBNygaT1aa9Z1uPdJJilwA (big blind) showed [8c 9c] and won ($18.90) with two pair, Eights and Threes
Seat 6: b2symlOdL7+0c9Pj4N/KlA folded before Flop (didn't bet)



PokerStars Game #59940380402:  Hold'em No Limit ($0.25/$0.50) - 2009/07/01 1:05:00 ET
Table 'Nz0Vr7WMHL2g5Uk7dDZjpw' 9-max Seat #7 is the button
Seat 1: tLkxo7JgV+WWI0UBw44K5A ($110.60 in chips)
Seat 2: gsyXT42WLEcOS4DdEk2wlw ($29.25 in chips)
Seat 4: E2518gp4aFz1+kAgmGqeEg ($13.30 in chips)
Seat 5: WGW0DgjBUXs1ylURHG8vnQ ($25.85 in chips)
Seat 6: 997ViqAtWn1FPjJqcffwcA ($59.80 in chips)
Seat 7: KPLH0gELgFe2OuAnhJFI5w ($15.30 in chips)
Seat 8: HkZI6g4zl83TDTA7SRspmQ ($27.90 in chips)
Seat 9: mSD1pginDsyHG5PDfqzphw ($10 in chips)
HkZI6g4zl83TDTA7SRspmQ: posts small blind $0.25
mSD1pginDsyHG5PDfqzphw: posts big blind $0.50
*** HOLE CARDS ***
tLkxo7JgV+WWI0UBw44K5A: raises $1 to $1.50
gsyXT42WLEcOS4DdEk2wlw: folds
E2518gp4aFz1+kAgmGqeEg: folds
WGW0DgjBUXs1ylURHG8vnQ: folds
997ViqAtWn1FPjJqcffwcA: folds
KPLH0gELgFe2OuAnhJFI5w: folds
HkZI6g4zl83TDTA7SRspmQ: folds
mSD1pginDsyHG5PDfqzphw: folds
tLkxo7JgV+WWI0UBw44K5A collected $1.25 from pot
*** SUMMARY ***
Total pot $1.25 | Rake $0
Seat 1: tLkxo7JgV+WWI0UBw44K5A collected ($1.25)
Seat 2: gsyXT42WLEcOS4DdEk2wlw folded before Flop (didn't bet)
Seat 4: E2518gp4aFz1+kAgmGqeEg folded before Flop (didn't bet)
Seat 5: WGW0DgjBUXs1ylURHG8vnQ folded before Flop (didn't bet)
Seat 6: 997ViqAtWn1FPjJqcffwcA folded before Flop (didn't bet)
Seat 7: KPLH0gELgFe2OuAnhJFI5w (button) folded before Flop (didn't bet)
Seat 8: HkZI6g4zl83TDTA7SRspmQ (small blind) folded before Flop
Seat 9: mSD1pginDsyHG5PDfqzphw (big blind) folded before Flop



PokerStars Game #59940382656:  Hold'em No Limit ($0.25/$0.50) - 2009/07/01 1:05:04 ET
Table 'E7bWJ45aoFXRpyRv2gw+Ig' 2-max Seat #1 is the button
Seat 1: FRkiRasEGlHUeLrEl+k/nA ($57.75 in chips)
Seat 2: 3Wro85I7472vJ4Wkpneo9A ($130 in chips)
FRkiRasEGlHUeLrEl+k/nA: posts small blind $0.25
3Wro85I7472vJ4Wkpneo9A: posts big blind $0.50
*** HOLE CARDS ***
FRkiRasEGlHUeLrEl+k/nA: folds
3Wro85I7472vJ4Wkpneo9A collected $0.50 from pot
3Wro85I7472vJ4Wkpneo9A: doesn't show hand
*** SUMMARY ***
Total pot $0.50 | Rake $0
Seat 1: FRkiRasEGlHUeLrEl+k/nA (button) (small blind) folded before Flop
Seat 2: 3Wro85I7472vJ4Wkpneo9A (big blind) collected ($0.50)



PokerStars Game #59940384654:  Hold'em No Limit ($0.25/$0.50) - 2009/07/01 1:05:07 ET
Table '+dXkOAQyS8j9PQZusUTMpg' 2-max Seat #2 is the button
Seat 1: XFa6sBGjP2gxoIvxR3fZIg ($106.15 in chips)
Seat 2: 5IBeOgaApY1Bvzv2P8X4EA ($90.65 in chips)
5IBeOgaApY1Bvzv2P8X4EA: posts small blind $0.25
XFa6sBGjP2gxoIvxR3fZIg: posts big blind $0.50
*** HOLE CARDS ***
5IBeOgaApY1Bvzv2P8X4EA: folds
XFa6sBGjP2gxoIvxR3fZIg collected $0.50 from pot
*** SUMMARY ***
Total pot $0.50 | Rake $0
Seat 1: XFa6sBGjP2gxoIvxR3fZIg (big blind) collected ($0.50)
Seat 2: 5IBeOgaApY1Bvzv2P8X4EA (button) (small blind) folded before Flop



PokerStars Game #59940386362:  Hold'em No Limit ($0.25/$0.50) - 2009/07/01 1:05:10 ET
Table 'E7bWJ45aoFXRpyRv2gw+Ig' 2-max Seat #2 is the button
Seat 1: FRkiRasEGlHUeLrEl+k/nA ($57.50 in chips)
Seat 2: 3Wro85I7472vJ4Wkpneo9A ($130.25 in chips)
3Wro85I7472vJ4Wkpneo9A: posts small blind $0.25
FRkiRasEGlHUeLrEl+k/nA: posts big blind $0.50
*** HOLE CARDS ***
3Wro85I7472vJ4Wkpneo9A: raises $1 to $1.50
FRkiRasEGlHUeLrEl+k/nA: raises $3 to $4.50
3Wro85I7472vJ4Wkpneo9A: folds
FRkiRasEGlHUeLrEl+k/nA collected $3 from pot
FRkiRasEGlHUeLrEl+k/nA: doesn't show hand
*** SUMMARY ***
Total pot $3 | Rake $0
Seat 1: FRkiRasEGlHUeLrEl+k/nA (big blind) collected ($3)
Seat 2: 3Wro85I7472vJ4Wkpneo9A (button) (small blind) folded before Flop



PokerStars Game #59940388116:  Hold'em No Limit ($0.25/$0.50) - 2009/07/01 1:05:13 ET
Table '+dXkOAQyS8j9PQZusUTMpg' 2-max Seat #1 is the button
Seat 1: XFa6sBGjP2gxoIvxR3fZIg ($106.40 in chips)
Seat 2: 5IBeOgaApY1Bvzv2P8X4EA ($90.40 in chips)
XFa6sBGjP2gxoIvxR3fZIg: posts small blind $0.25
5IBeOgaApY1Bvzv2P8X4EA: posts big blind $0.50
*** HOLE CARDS ***
XFa6sBGjP2gxoIvxR3fZIg: raises $1 to $1.50
5IBeOgaApY1Bvzv2P8X4EA: folds
XFa6sBGjP2gxoIvxR3fZIg collected $1 from pot
*** SUMMARY ***
Total pot $1 | Rake $0
Seat 1: XFa6sBGjP2gxoIvxR3fZIg (button) (small blind) collected ($1)
Seat 2: 5IBeOgaApY1Bvzv2P8X4EA (big blind) folded before Flop



PokerStars Game #59940388414:  Hold'em No Limit ($0.25/$0.50) - 2009/07/01 1:05:13 ET
Table 'QOgaEqMcJ73pcUMMxoisUg' 6-max Seat #5 is the button
Seat 1: lxIzoHy0RnkfFSODHC2liw ($53.60 in chips)
Seat 3: Rt6KgtZ8YaJoTc3FPim00w ($52.25 in chips)
Seat 4: zAcsDhG/T128Vn7XGVSgKg ($50.75 in chips)
Seat 5: 6vNxrjjCl6FwfaaymM9jjg ($21.75 in chips)
lxIzoHy0RnkfFSODHC2liw: posts small blind $0.25
Rt6KgtZ8YaJoTc3FPim00w: posts big blind $0.50
*** HOLE CARDS ***
zAcsDhG/T128Vn7XGVSgKg: raises $1 to $1.50
6vNxrjjCl6FwfaaymM9jjg: folds
lxIzoHy0RnkfFSODHC2liw: folds
oqOqoO2AyCZenUghCxMDxw joins the table at seat #2
Rt6KgtZ8YaJoTc3FPim00w: raises $4 to $5.50
zAcsDhG/T128Vn7XGVSgKg: folds
Rt6KgtZ8YaJoTc3FPim00w collected $3.25 from pot
*** SUMMARY ***
Total pot $3.25 | Rake $0
Seat 1: lxIzoHy0RnkfFSODHC2liw (small blind) folded before Flop
Seat 3: Rt6KgtZ8YaJoTc3FPim00w (big blind) collected ($3.25)
Seat 4: zAcsDhG/T128Vn7XGVSgKg folded before Flop
Seat 5: 6vNxrjjCl6FwfaaymM9jjg (button) folded before Flop (didn't bet)



PokerStars Game #59940390690:  Hold'em No Limit ($0.25/$0.50) - 2009/07/01 1:05:17 ET
Table 'ZYI3ZReBjdfKEYItkZHI6A' 9-max Seat #9 is the button
Seat 1: E2518gp4aFz1+kAgmGqeEg ($14.35 in chips)
Seat 2: 8zdVaT8pZ/Wm0uWoeLhtZg ($7.50 in chips)
Seat 3: bkXkL3pmapikPQQRNPZSEA ($18.75 in chips)
Seat 4: e2+sK/yjnj94rXOKoxPP2A ($50 in chips)
Seat 5: ApHP7ouup365XIUFBdEDxg ($47.65 in chips)
Seat 6: Wj7mKnRFR90j40wWUu2+Og ($31.70 in chips)
Seat 7: HWcfp1hY1hqvrddzW3/FQw ($16 in chips)
Seat 8: ji04uOybxCdpdefzlUQeKQ ($28 in chips)
Seat 9: tLkxo7JgV+WWI0UBw44K5A ($50.85 in chips)
E2518gp4aFz1+kAgmGqeEg: posts small blind $0.25
8zdVaT8pZ/Wm0uWoeLhtZg: posts big blind $0.50
*** HOLE CARDS ***
bkXkL3pmapikPQQRNPZSEA: folds
e2+sK/yjnj94rXOKoxPP2A: folds
ApHP7ouup365XIUFBdEDxg: calls $0.50
Wj7mKnRFR90j40wWUu2+Og: calls $0.50
HWcfp1hY1hqvrddzW3/FQw: calls $0.50
ji04uOybxCdpdefzlUQeKQ: folds
tLkxo7JgV+WWI0UBw44K5A: folds
E2518gp4aFz1+kAgmGqeEg: calls $0.25
8zdVaT8pZ/Wm0uWoeLhtZg: checks
*** FLOP *** [3s 8d Td]
E2518gp4aFz1+kAgmGqeEg: checks
8zdVaT8pZ/Wm0uWoeLhtZg: bets $1
ApHP7ouup365XIUFBdEDxg: folds
Wj7mKnRFR90j40wWUu2+Og: calls $1
HWcfp1hY1hqvrddzW3/FQw: calls $1
E2518gp4aFz1+kAgmGqeEg: folds
*** TURN *** [3s 8d Td] [Ts]
8zdVaT8pZ/Wm0uWoeLhtZg: bets $1
Wj7mKnRFR90j40wWUu2+Og: calls $1
HWcfp1hY1hqvrddzW3/FQw: calls $1
*** RIVER *** [3s 8d Td Ts] [3d]
8zdVaT8pZ/Wm0uWoeLhtZg: checks
Wj7mKnRFR90j40wWUu2+Og: bets $5
HWcfp1hY1hqvrddzW3/FQw: folds
8zdVaT8pZ/Wm0uWoeLhtZg: folds
Wj7mKnRFR90j40wWUu2+Og collected $8.10 from pot
*** SUMMARY ***
Total pot $8.50 | Rake $0.40
Board [3s 8d Td Ts 3d]
Seat 1: E2518gp4aFz1+kAgmGqeEg (small blind) folded on the Flop
Seat 2: 8zdVaT8pZ/Wm0uWoeLhtZg (big blind) folded on the River
Seat 3: bkXkL3pmapikPQQRNPZSEA folded before Flop (didn't bet)
Seat 4: e2+sK/yjnj94rXOKoxPP2A folded before Flop (didn't bet)
Seat 5: ApHP7ouup365XIUFBdEDxg folded on the Flop
Seat 6: Wj7mKnRFR90j40wWUu2+Og collected ($8.10)
Seat 7: HWcfp1hY1hqvrddzW3/FQw folded on the River
Seat 8: ji04uOybxCdpdefzlUQeKQ folded before Flop (didn't bet)
Seat 9: tLkxo7JgV+WWI0UBw44K5A (button) folded before Flop (didn't bet)



PokerStars Game #59940391012:  Hold'em No Limit ($0.25/$0.50) - 2009/07/01 1:05:18 ET
Table '0eJtgVAXVvBgncFdcUpXcQ' 2-max Seat #1 is the button
Seat 1: Ag6DvxX4vbRheqsv2zXKTQ ($46.50 in chips)
Seat 2: KMc4R+K9ao4Ur3rF7NGe6Q ($10 in chips)
Ag6DvxX4vbRheqsv2zXKTQ: posts small blind $0.25
KMc4R+K9ao4Ur3rF7NGe6Q: posts big blind $0.50
*** HOLE CARDS ***
Ag6DvxX4vbRheqsv2zXKTQ: folds
KMc4R+K9ao4Ur3rF7NGe6Q collected $0.50 from pot
KMc4R+K9ao4Ur3rF7NGe6Q: doesn't show hand
*** SUMMARY ***
Total pot $0.50 | Rake $0
Seat 1: Ag6DvxX4vbRheqsv2zXKTQ (button) (small blind) folded before Flop
Seat 2: KMc4R+K9ao4Ur3rF7NGe6Q (big blind) collected ($0.50)



PokerStars Game #59940392476:  Hold'em No Limit ($0.25/$0.50) - 2009/07/01 1:05:20 ET
Table '+dXkOAQyS8j9PQZusUTMpg' 2-max Seat #2 is the button
Seat 1: XFa6sBGjP2gxoIvxR3fZIg ($106.90 in chips)
Seat 2: 5IBeOgaApY1Bvzv2P8X4EA ($89.90 in chips)
5IBeOgaApY1Bvzv2P8X4EA: posts small blind $0.25
XFa6sBGjP2gxoIvxR3fZIg: posts big blind $0.50
*** HOLE CARDS ***
5IBeOgaApY1Bvzv2P8X4EA: folds
XFa6sBGjP2gxoIvxR3fZIg collected $0.50 from pot
*** SUMMARY ***
Total pot $0.50 | Rake $0
Seat 1: XFa6sBGjP2gxoIvxR3fZIg (big blind) collected ($0.50)
Seat 2: 5IBeOgaApY1Bvzv2P8X4EA (button) (small blind) folded before Flop



PokerStars Game #59940392498:  Hold'em No Limit ($0.25/$0.50) - 2009/07/01 1:05:20 ET
Table 'kgbJRsxfv64KrErDRBAkcw' 6-max Seat #2 is the button
Seat 1: VamsyhlFzXGF6/ydo0BHeA ($36 in chips)
Seat 2: AdS8BJMOheS01zjCDfPMFg ($49.20 in chips)
Seat 3: c4MNIaIyPMOMxrgT8FT5nA ($135.05 in chips)
Seat 5: eUBBn2R56C1IQ6Cs/vitwg ($61.35 in chips)
Seat 6: 1b+2BbjMN8qhR1WPqdE9VQ ($52.40 in chips)
c4MNIaIyPMOMxrgT8FT5nA: posts small blind $0.25
qanMEqjABjWxC/JgQ/0l7w: is sitting out
eUBBn2R56C1IQ6Cs/vitwg: posts big blind $0.50
*** HOLE CARDS ***
1b+2BbjMN8qhR1WPqdE9VQ: folds
VamsyhlFzXGF6/ydo0BHeA: calls $0.50
AdS8BJMOheS01zjCDfPMFg: folds
c4MNIaIyPMOMxrgT8FT5nA: folds
eUBBn2R56C1IQ6Cs/vitwg: checks
*** FLOP *** [Kh 4h 9d]
eUBBn2R56C1IQ6Cs/vitwg: bets $1
VamsyhlFzXGF6/ydo0BHeA: calls $1
*** TURN *** [Kh 4h 9d] [6d]
eUBBn2R56C1IQ6Cs/vitwg: bets $3
VamsyhlFzXGF6/ydo0BHeA: folds
eUBBn2R56C1IQ6Cs/vitwg collected $3.10 from pot
*** SUMMARY ***
Total pot $3.25 | Rake $0.15
Board [Kh 4h 9d 6d]
Seat 1: VamsyhlFzXGF6/ydo0BHeA folded on the Turn
Seat 2: AdS8BJMOheS01zjCDfPMFg (button) folded before Flop (didn't bet)
Seat 3: c4MNIaIyPMOMxrgT8FT5nA (small blind) folded before Flop
Seat 5: eUBBn2R56C1IQ6Cs/vitwg (big blind) collected ($3.10)
Seat 6: 1b+2BbjMN8qhR1WPqdE9VQ folded before Flop (didn't bet)



PokerStars Game #59940392976:  Hold'em No Limit ($0.25/$0.50) - 2009/07/01 1:05:21 ET
Table 'EiNh8p/wGJ1FP575iMFnqg' 9-max Seat #7 is the button
Seat 1: r3ZqM1Mi0W3y4hOdssE+Sg ($44.85 in chips)
Seat 2: 8ehL7qlZzjgUh2H35iiWLw ($54.15 in chips)
Seat 3: ymLPoEIl7UL3TvZYmnadxQ ($54.55 in chips)
Seat 4: cMzaiXAM/ZAdNaEUu+LqhA ($54.95 in chips)
Seat 5: M+7+BTmX5vZatHVuoRB1nA ($80.45 in chips)
Seat 6: 3UmXLy3GfjC3EkOebduerQ ($61.60 in chips)
Seat 7: 997ViqAtWn1FPjJqcffwcA ($50 in chips)
Seat 8: mSD1pginDsyHG5PDfqzphw ($11.10 in chips)
Seat 9: NnQCepdIR/AOUQn1yhYx6Q ($11.75 in chips)
mSD1pginDsyHG5PDfqzphw: posts small blind $0.25
NnQCepdIR/AOUQn1yhYx6Q: posts big blind $0.50
*** HOLE CARDS ***
r3ZqM1Mi0W3y4hOdssE+Sg: folds
8ehL7qlZzjgUh2H35iiWLw: folds
ymLPoEIl7UL3TvZYmnadxQ: folds
cMzaiXAM/ZAdNaEUu+LqhA: folds
M+7+BTmX5vZatHVuoRB1nA: folds
3UmXLy3GfjC3EkOebduerQ: folds
997ViqAtWn1FPjJqcffwcA: folds
mSD1pginDsyHG5PDfqzphw: raises $1 to $1.50
NnQCepdIR/AOUQn1yhYx6Q: raises $10.25 to $11.75 and is all-in
mSD1pginDsyHG5PDfqzphw: calls $9.60 and is all-in
*** FLOP *** [Qs 5d 4h]
*** TURN *** [Qs 5d 4h] [Js]
*** RIVER *** [Qs 5d 4h Js] [4s]
*** SHOW DOWN ***
mSD1pginDsyHG5PDfqzphw: shows [Tc Th] (two pair, Tens and Fours)
NnQCepdIR/AOUQn1yhYx6Q: shows [Ah Ac] (two pair, Aces and Fours)
NnQCepdIR/AOUQn1yhYx6Q collected $21.10 from pot
*** SUMMARY ***
Total pot $22.20 | Rake $1.10
Board [Qs 5d 4h Js 4s]
Seat 1: r3ZqM1Mi0W3y4hOdssE+Sg folded before Flop (didn't bet)
Seat 2: 8ehL7qlZzjgUh2H35iiWLw folded before Flop (didn't bet)
Seat 3: ymLPoEIl7UL3TvZYmnadxQ folded before Flop (didn't bet)
Seat 4: cMzaiXAM/ZAdNaEUu+LqhA folded before Flop (didn't bet)
Seat 5: M+7+BTmX5vZatHVuoRB1nA folded before Flop (didn't bet)
Seat 6: 3UmXLy3GfjC3EkOebduerQ folded before Flop (didn't bet)
Seat 7: 997ViqAtWn1FPjJqcffwcA (button) folded before Flop (didn't bet)
Seat 8: mSD1pginDsyHG5PDfqzphw (small blind) showed [Tc Th] and lost with two pair, Tens and Fours
Seat 9: NnQCepdIR/AOUQn1yhYx6Q (big blind) showed [Ah Ac] and won ($21.10) with two pair, Aces and Fours



PokerStars Game #59940393340:  Hold'em No Limit ($0.25/$0.50) - 2009/07/01 1:05:22 ET
Table '37qXEp3oe+er5q4CZip9eQ' 6-max Seat #6 is the button
Seat 2: LvH4G7n+QSjT6NDaD3cREA ($57.30 in chips)
Seat 3: Rt6KgtZ8YaJoTc3FPim00w ($110.20 in chips)
Seat 4: XsmE8nXMAAMFJbWaJTmHFw ($39.85 in chips)
Seat 5: VOmI0x4dDPnTESZd5B4d1Q ($41.80 in chips)
Seat 6: N50kln4negd8q7Mmoz1j4g ($16.60 in chips)
LvH4G7n+QSjT6NDaD3cREA: posts small blind $0.25
Rt6KgtZ8YaJoTc3FPim00w: posts big blind $0.50
*** HOLE CARDS ***
XsmE8nXMAAMFJbWaJTmHFw: folds
VOmI0x4dDPnTESZd5B4d1Q: raises $1.50 to $2
N50kln4negd8q7Mmoz1j4g: folds
LvH4G7n+QSjT6NDaD3cREA: folds
Rt6KgtZ8YaJoTc3FPim00w: folds
VOmI0x4dDPnTESZd5B4d1Q collected $1.25 from pot
*** SUMMARY ***
Total pot $1.25 | Rake $0
Seat 2: LvH4G7n+QSjT6NDaD3cREA (small blind) folded before Flop
Seat 3: Rt6KgtZ8YaJoTc3FPim00w (big blind) folded before Flop
Seat 4: XsmE8nXMAAMFJbWaJTmHFw folded before Flop (didn't bet)
Seat 5: VOmI0x4dDPnTESZd5B4d1Q collected ($1.25)
Seat 6: N50kln4negd8q7Mmoz1j4g (button) folded before Flop (didn't bet)



PokerStars Game #59940393430:  Hold'em No Limit ($0.25/$0.50) - 2009/07/01 1:05:22 ET
Table 'E7bWJ45aoFXRpyRv2gw+Ig' 2-max Seat #1 is the button
Seat 1: FRkiRasEGlHUeLrEl+k/nA ($59 in chips)
Seat 2: 3Wro85I7472vJ4Wkpneo9A ($128.75 in chips)
FRkiRasEGlHUeLrEl+k/nA: posts small blind $0.25
3Wro85I7472vJ4Wkpneo9A: posts big blind $0.50
*** HOLE CARDS ***
FRkiRasEGlHUeLrEl+k/nA: folds
3Wro85I7472vJ4Wkpneo9A collected $0.50 from pot
3Wro85I7472vJ4Wkpneo9A: doesn't show hand
*** SUMMARY ***
Total pot $0.50 | Rake $0
Seat 1: FRkiRasEGlHUeLrEl+k/nA (button) (small blind) folded before Flop
Seat 2: 3Wro85I7472vJ4Wkpneo9A (big blind) collected ($0.50)



PokerStars Game #59940393350:  Hold'em No Limit ($0.25/$0.50) - 2009/07/01 1:05:22 ET
Table 'tYh970kmVfYS0gXPT/XtoQ' 2-max Seat #1 is the button
Seat 1: mW7WbnOUOr5szbwJvGciAA ($31.15 in chips)
Seat 2: dokz3oqYBKI5gNELbiWhbQ ($20.35 in chips)
mW7WbnOUOr5szbwJvGciAA: posts small blind $0.25
dokz3oqYBKI5gNELbiWhbQ: posts big blind $0.50
*** HOLE CARDS ***
mW7WbnOUOr5szbwJvGciAA: calls $0.25
dokz3oqYBKI5gNELbiWhbQ: checks
*** FLOP *** [Th 4c 2c]
dokz3oqYBKI5gNELbiWhbQ: checks
mW7WbnOUOr5szbwJvGciAA: checks
*** TURN *** [Th 4c 2c] [Kc]
dokz3oqYBKI5gNELbiWhbQ: checks
mW7WbnOUOr5szbwJvGciAA: checks
*** RIVER *** [Th 4c 2c Kc] [8s]
dokz3oqYBKI5gNELbiWhbQ: checks
mW7WbnOUOr5szbwJvGciAA: checks
*** SHOW DOWN ***
dokz3oqYBKI5gNELbiWhbQ: shows [Js 3h] (high card King)
mW7WbnOUOr5szbwJvGciAA: mucks hand
dokz3oqYBKI5gNELbiWhbQ collected $0.95 from pot
*** SUMMARY ***
Total pot $1 | Rake $0.05
Board [Th 4c 2c Kc 8s]
Seat 1: mW7WbnOUOr5szbwJvGciAA (button) (small blind) mucked
Seat 2: dokz3oqYBKI5gNELbiWhbQ (big blind) showed [Js 3h] and won ($0.95) with high card King



PokerStars Game #59940393660:  Hold'em No Limit ($0.25/$0.50) - 2009/07/01 1:05:23 ET
Table 'c/CRn+68J3Y8KxD5g1ek2Q' 2-max Seat #2 is the button
Seat 1: 46qCyJ6evTkHo9al5sBMNA ($91.25 in chips)
Seat 2: BypVLsYQt3ePFm2xQL/dOA ($275.60 in chips)
BypVLsYQt3ePFm2xQL/dOA: posts small blind $0.25
46qCyJ6evTkHo9al5sBMNA: posts big blind $0.50
*** HOLE CARDS ***
BypVLsYQt3ePFm2xQL/dOA said, "no good card"
BypVLsYQt3ePFm2xQL/dOA: calls $0.25
46qCyJ6evTkHo9al5sBMNA: checks
*** FLOP *** [7h 4s 2s]
46qCyJ6evTkHo9al5sBMNA: checks
BypVLsYQt3ePFm2xQL/dOA: bets $1.50
46qCyJ6evTkHo9al5sBMNA: folds
BypVLsYQt3ePFm2xQL/dOA collected $0.95 from pot
BypVLsYQt3ePFm2xQL/dOA: doesn't show hand
*** SUMMARY ***
Total pot $1 | Rake $0.05
Board [7h 4s 2s]
Seat 1: 46qCyJ6evTkHo9al5sBMNA (big blind) folded on the Flop
Seat 2: BypVLsYQt3ePFm2xQL/dOA (button) (small blind) collected ($0.95)



PokerStars Game #59940393762:  Hold'em No Limit ($0.25/$0.50) - 2009/07/01 1:05:23 ET
Table 'otvGDROEDdqsabxskT79qg' 9-max Seat #9 is the button
Seat 1: 8ehL7qlZzjgUh2H35iiWLw ($56.25 in chips)
Seat 2: cCjTzH9jio8607WzjcfXlg ($12.25 in chips)
Seat 3: +k7T5ocke8UwavtgUHm+Cg ($70.60 in chips)
Seat 4: MG90wfSJZnOejs/KD3vlQQ ($76.65 in chips)
Seat 5: E2518gp4aFz1+kAgmGqeEg ($11.75 in chips)
Seat 6: bxLSulbgr8LmKNjOzw8URg ($55.50 in chips)
Seat 7: 75K2MXwN65Sjfp1yHd50Hg ($10 in chips)
Seat 8: zE9cVigS2nW/Ljy4K4bUQA ($30 in chips)
Seat 9: KcY3X8YpD74Kw1RHkx/g4A ($50.40 in chips)
8ehL7qlZzjgUh2H35iiWLw: posts small blind $0.25
cCjTzH9jio8607WzjcfXlg: posts big blind $0.50
*** HOLE CARDS ***
+k7T5ocke8UwavtgUHm+Cg: folds
MG90wfSJZnOejs/KD3vlQQ: folds
E2518gp4aFz1+kAgmGqeEg: folds
bxLSulbgr8LmKNjOzw8URg: folds
75K2MXwN65Sjfp1yHd50Hg: folds
zE9cVigS2nW/Ljy4K4bUQA: folds
KcY3X8YpD74Kw1RHkx/g4A: folds
8ehL7qlZzjgUh2H35iiWLw: folds
cCjTzH9jio8607WzjcfXlg collected $0.50 from pot
*** SUMMARY ***
Total pot $0.50 | Rake $0
Seat 1: 8ehL7qlZzjgUh2H35iiWLw (small blind) folded before Flop
Seat 2: cCjTzH9jio8607WzjcfXlg (big blind) collected ($0.50)
Seat 3: +k7T5ocke8UwavtgUHm+Cg folded before Flop (didn't bet)
Seat 4: MG90wfSJZnOejs/KD3vlQQ folded before Flop (didn't bet)
Seat 5: E2518gp4aFz1+kAgmGqeEg folded before Flop (didn't bet)
Seat 6: bxLSulbgr8LmKNjOzw8URg folded before Flop (didn't bet)
Seat 7: 75K2MXwN65Sjfp1yHd50Hg folded before Flop (didn't bet)
Seat 8: zE9cVigS2nW/Ljy4K4bUQA folded before Flop (didn't bet)
Seat 9: KcY3X8YpD74Kw1RHkx/g4A (button) folded before Flop (didn't bet)



PokerStars Game #59940393878:  Hold'em No Limit ($0.25/$0.50) - 2009/07/01 1:05:23 ET
Table 'fx6MqwfYAj/Rt86hBz2L3Q' 9-max Seat #2 is the button
Seat 1: uw9QayAAxLM3Hb+HR7mSkg ($10.50 in chips)
Seat 2: C3rGXblctNcWI6JYPHhaEg ($24.25 in chips)
Seat 3: iadBi5AEt7gTBXbDSSnMYQ ($50 in chips)
Seat 4: 75K2MXwN65Sjfp1yHd50Hg ($9.25 in chips)
Seat 5: iAISe3dVeua8PUn2wwgDHw ($61.25 in chips)
Seat 6: 5k9fvXD9suIgCxU4HLQjTw ($50.75 in chips)
Seat 7: SKnJuWHScqetA/qG5p+wCg ($30 in chips)
Seat 8: JYwJYYV9pM5KWdSiETl8rA ($21.25 in chips)
Seat 9: HZkVla4kK2SI42CVrPZ/ig ($18.30 in chips)
iadBi5AEt7gTBXbDSSnMYQ: posts small blind $0.25
75K2MXwN65Sjfp1yHd50Hg: posts big blind $0.50
*** HOLE CARDS ***
iAISe3dVeua8PUn2wwgDHw: folds
5k9fvXD9suIgCxU4HLQjTw: folds
SKnJuWHScqetA/qG5p+wCg: calls $0.50
JYwJYYV9pM5KWdSiETl8rA: raises $1.50 to $2
HZkVla4kK2SI42CVrPZ/ig: folds
uw9QayAAxLM3Hb+HR7mSkg: folds
C3rGXblctNcWI6JYPHhaEg: calls $2
iadBi5AEt7gTBXbDSSnMYQ: calls $1.75
75K2MXwN65Sjfp1yHd50Hg: folds
SKnJuWHScqetA/qG5p+wCg: calls $1.50
*** FLOP *** [Th 5c Jc]
iadBi5AEt7gTBXbDSSnMYQ: bets $2
SKnJuWHScqetA/qG5p+wCg: folds
JYwJYYV9pM5KWdSiETl8rA: folds
C3rGXblctNcWI6JYPHhaEg: folds
iadBi5AEt7gTBXbDSSnMYQ collected $8.10 from pot
*** SUMMARY ***
Total pot $8.50 | Rake $0.40
Board [Th 5c Jc]
Seat 1: uw9QayAAxLM3Hb+HR7mSkg folded before Flop (didn't bet)
Seat 2: C3rGXblctNcWI6JYPHhaEg (button) folded on the Flop
Seat 3: iadBi5AEt7gTBXbDSSnMYQ (small blind) collected ($8.10)
Seat 4: 75K2MXwN65Sjfp1yHd50Hg (big blind) folded before Flop
Seat 5: iAISe3dVeua8PUn2wwgDHw folded before Flop (didn't bet)
Seat 6: 5k9fvXD9suIgCxU4HLQjTw folded before Flop (didn't bet)
Seat 7: SKnJuWHScqetA/qG5p+wCg folded on the Flop
Seat 8: JYwJYYV9pM5KWdSiETl8rA folded on the Flop
Seat 9: HZkVla4kK2SI42CVrPZ/ig folded before Flop (didn't bet)



PokerStars Game #59940394378:  Hold'em No Limit ($0.25/$0.50) - 2009/07/01 1:05:24 ET
Table '0eJtgVAXVvBgncFdcUpXcQ' 2-max Seat #2 is the button
Seat 1: Ag6DvxX4vbRheqsv2zXKTQ ($46.25 in chips)
Seat 2: KMc4R+K9ao4Ur3rF7NGe6Q ($10.25 in chips)
KMc4R+K9ao4Ur3rF7NGe6Q: posts small blind $0.25
Ag6DvxX4vbRheqsv2zXKTQ: posts big blind $0.50
*** HOLE CARDS ***
KMc4R+K9ao4Ur3rF7NGe6Q: raises $1.50 to $2
Ag6DvxX4vbRheqsv2zXKTQ: folds
KMc4R+K9ao4Ur3rF7NGe6Q collected $1 from pot
KMc4R+K9ao4Ur3rF7NGe6Q: doesn't show hand
*** SUMMARY ***
Total pot $1 | Rake $0
Seat 1: Ag6DvxX4vbRheqsv2zXKTQ (big blind) folded before Flop
Seat 2: KMc4R+K9ao4Ur3rF7NGe6Q (button) (small blind) collected ($1)



PokerStars Game #59940394864:  Hold'em No Limit ($0.25/$0.50) - 2009/07/01 1:05:25 ET
Table 'Nz0Vr7WMHL2g5Uk7dDZjpw' 9-max Seat #8 is the button
Seat 1: tLkxo7JgV+WWI0UBw44K5A ($111.35 in chips)
Seat 2: gsyXT42WLEcOS4DdEk2wlw ($29.25 in chips)
Seat 4: E2518gp4aFz1+kAgmGqeEg ($13.30 in chips)
Seat 5: WGW0DgjBUXs1ylURHG8vnQ ($25.85 in chips)
Seat 6: 997ViqAtWn1FPjJqcffwcA ($59.80 in chips)
Seat 7: KPLH0gELgFe2OuAnhJFI5w ($15.30 in chips)
Seat 8: HkZI6g4zl83TDTA7SRspmQ ($27.65 in chips)
Seat 9: mSD1pginDsyHG5PDfqzphw ($10 in chips)
mSD1pginDsyHG5PDfqzphw: posts small blind $0.25
tLkxo7JgV+WWI0UBw44K5A: posts big blind $0.50
*** HOLE CARDS ***
gsyXT42WLEcOS4DdEk2wlw: folds
E2518gp4aFz1+kAgmGqeEg: folds
WGW0DgjBUXs1ylURHG8vnQ: calls $0.50
997ViqAtWn1FPjJqcffwcA: folds
hoglu9inkgs6zN573/bJag joins the table at seat #3
KPLH0gELgFe2OuAnhJFI5w: calls $0.50
HkZI6g4zl83TDTA7SRspmQ: calls $0.50
mSD1pginDsyHG5PDfqzphw: folds
tLkxo7JgV+WWI0UBw44K5A: checks
*** FLOP *** [Kh Td 7h]
tLkxo7JgV+WWI0UBw44K5A: bets $1
WGW0DgjBUXs1ylURHG8vnQ: calls $1
KPLH0gELgFe2OuAnhJFI5w: calls $1
HkZI6g4zl83TDTA7SRspmQ: folds
*** TURN *** [Kh Td 7h] [8s]
tLkxo7JgV+WWI0UBw44K5A: bets $2.50
WGW0DgjBUXs1ylURHG8vnQ: calls $2.50
KPLH0gELgFe2OuAnhJFI5w: calls $2.50
*** RIVER *** [Kh Td 7h 8s] [4c]
tLkxo7JgV+WWI0UBw44K5A: checks
WGW0DgjBUXs1ylURHG8vnQ: checks
KPLH0gELgFe2OuAnhJFI5w: checks
*** SHOW DOWN ***
tLkxo7JgV+WWI0UBw44K5A: shows [4h Qh] (a pair of Fours)
WGW0DgjBUXs1ylURHG8vnQ: shows [6d 8d] (a pair of Eights)
KPLH0gELgFe2OuAnhJFI5w: shows [7d Kd] (two pair, Kings and Sevens)
KPLH0gELgFe2OuAnhJFI5w collected $12.15 from pot
*** SUMMARY ***
Total pot $12.75 | Rake $0.60
Board [Kh Td 7h 8s 4c]
Seat 1: tLkxo7JgV+WWI0UBw44K5A (big blind) showed [4h Qh] and lost with a pair of Fours
Seat 2: gsyXT42WLEcOS4DdEk2wlw folded before Flop (didn't bet)
Seat 4: E2518gp4aFz1+kAgmGqeEg folded before Flop (didn't bet)
Seat 5: WGW0DgjBUXs1ylURHG8vnQ showed [6d 8d] and lost with a pair of Eights
Seat 6: 997ViqAtWn1FPjJqcffwcA folded before Flop (didn't bet)
Seat 7: KPLH0gELgFe2OuAnhJFI5w showed [7d Kd] and won ($12.15) with two pair, Kings and Sevens
Seat 8: HkZI6g4zl83TDTA7SRspmQ (button) folded on the Flop
Seat 9: mSD1pginDsyHG5PDfqzphw (small blind) folded before Flop



PokerStars Game #59940395890:  Hold'em No Limit ($0.25/$0.50) - 2009/07/01 1:05:26 ET
Table 'ErOuyGLI5PT3G5MnpHgC/gQOgaEqMcJ73pcUMMxoisUg Seat #2 is the button
Seat 2: pciZn00ZDk4BVBMTTMcNVQ ($28 in chips)
Seat 3: xZCXQSXlrZkp3pZizzVXCw ($52.25 in chips)
Seat 4: 3UmXLy3GfjC3EkOebduerQ ($50 in chips)
Seat 5: JwvquocWfhTVApN5t47LgA ($64.65 in chips)
Seat 6: zE9cVigS2nW/Ljy4K4bUQA ($31.60 in chips)
Seat 7: 90Wb75h3W1BRpbqVnuk8gw ($63.60 in chips)
Seat 8: g4k0NXISyLCqaSWZDBjfEg ($50.75 in chips)
Seat 9: J0W5D97jl5VLky+IoPvDeA ($51.40 in chips)
xZCXQSXlrZkp3pZizzVXCw: posts small blind $0.25
3UmXLy3GfjC3EkOebduerQ: posts big blind $0.50
*** HOLE CARDS ***
JwvquocWfhTVApN5t47LgA: folds
zE9cVigS2nW/Ljy4K4bUQA: folds
90Wb75h3W1BRpbqVnuk8gw: folds
g4k0NXISyLCqaSWZDBjfEg: folds
J0W5D97jl5VLky+IoPvDeA: folds
pciZn00ZDk4BVBMTTMcNVQ: folds
eBrej2jnlUCs/JgxFCRn2g has returned
xZCXQSXlrZkp3pZizzVXCw: folds
3UmXLy3GfjC3EkOebduerQ collected $0.50 from pot
*** SUMMARY ***
Total pot $0.50 | Rake $0
Seat 2: pciZn00ZDk4BVBMTTMcNVQ (button) folded before Flop (didn't bet)
Seat 3: xZCXQSXlrZkp3pZizzVXCw (small blind) folded before Flop
Seat 4: 3UmXLy3GfjC3EkOebduerQ (big blind) collected ($0.50)
Seat 5: JwvquocWfhTVApN5t47LgA folded before Flop (didn't bet)
Seat 6: zE9cVigS2nW/Ljy4K4bUQA folded before Flop (didn't bet)
Seat 7: 90Wb75h3W1BRpbqVnuk8gw folded before Flop (didn't bet)
Seat 8: g4k0NXISyLCqaSWZDBjfEg folded before Flop (didn't bet)
Seat 9: J0W5D97jl5VLky+IoPvDeA folded before Flop (didn't bet)



PokerStars Game #59940395516:  Hold'em No Limit ($0.25/$0.50) - 2009/07/01 1:05:26 ET
Table 'BCN5su+SsXiy1zRMJi0SJw' 6-max Seat #4 is the button
Seat 1: GxXV09ciXaOxyY2H5aMIIw ($41.55 in chips)
Seat 2: oU2kDCkT/gilYbHWrg7D8w ($40.60 in chips)
Seat 4: 4QfsCWthT/vSLirorNXqtg ($50 in chips)
Seat 5: IBNygaT1aa9Z1uPdJJilwA ($52.40 in chips)
Seat 6: b2symlOdL7+0c9Pj4N/KlA ($59.65 in chips)
IBNygaT1aa9Z1uPdJJilwA: posts small blind $0.25
b2symlOdL7+0c9Pj4N/KlA: posts big blind $0.50
*** HOLE CARDS ***
6wzJiRvp8HY6t+MQGnSIzA leaves the table
GxXV09ciXaOxyY2H5aMIIw: folds
oU2kDCkT/gilYbHWrg7D8w: calls $0.50
of9mtXiD8G4Nx5p7hCbgqQ joins the table at seat #3
4QfsCWthT/vSLirorNXqtg: folds
IBNygaT1aa9Z1uPdJJilwA: folds
b2symlOdL7+0c9Pj4N/KlA: checks
*** FLOP *** [Th Ts 8s]
b2symlOdL7+0c9Pj4N/KlA: checks
oU2kDCkT/gilYbHWrg7D8w said, "no tilt there"
oU2kDCkT/gilYbHWrg7D8w: checks
*** TURN *** [Th Ts 8s] [Kc]
b2symlOdL7+0c9Pj4N/KlA: checks
oU2kDCkT/gilYbHWrg7D8w: checks
*** RIVER *** [Th Ts 8s Kc] [3h]
b2symlOdL7+0c9Pj4N/KlA: checks
oU2kDCkT/gilYbHWrg7D8w: checks
*** SHOW DOWN ***
b2symlOdL7+0c9Pj4N/KlA: shows [7h 3c] (two pair, Tens and Threes)
oU2kDCkT/gilYbHWrg7D8w: mucks hand
IBNygaT1aa9Z1uPdJJilwA said, "lol"
b2symlOdL7+0c9Pj4N/KlA collected $1.20 from pot
oU2kDCkT/gilYbHWrg7D8w said, "ha"
*** SUMMARY ***
Total pot $1.25 | Rake $0.05
Board [Th Ts 8s Kc 3h]
Seat 1: GxXV09ciXaOxyY2H5aMIIw folded before Flop (didn't bet)
Seat 2: oU2kDCkT/gilYbHWrg7D8w mucked
Seat 4: 4QfsCWthT/vSLirorNXqtg (button) folded before Flop (didn't bet)
Seat 5: IBNygaT1aa9Z1uPdJJilwA (small blind) folded before Flop
Seat 6: b2symlOdL7+0c9Pj4N/KlA (big blind) showed [7h 3c] and won ($1.20) with two pair, Tens and Threes



PokerStars Game #59940395790:  Hold'em No Limit ($0.25/$0.50) - 2009/07/01 1:05:26 ET
Table 'MJxeZCzYELxiIsyUZyT0jw' 6-max Seat #2 is the button
Seat 1: +Pf9jTVizYlIo+woPvptfA ($50 in chips)
Seat 2: t3GiVMzqA9Svgr5Uol32cQ ($19.15 in chips)
Seat 4: alGiiQP/wwtYnfuXII+sgw ($64.60 in chips)
Seat 5: 3jvoOXNtXE90w2BdfNZwZQ ($56.35 in chips)
Seat 6: c0n4hrn20AML9qzyFC2E8Q ($46.50 in chips)
sIG4mp8tZEI+W4nKZNkkQA will be allowed to play after the button
alGiiQP/wwtYnfuXII+sgw: posts small blind $0.25
3jvoOXNtXE90w2BdfNZwZQ: posts big blind $0.50
*** HOLE CARDS ***
c0n4hrn20AML9qzyFC2E8Q: raises $1 to $1.50
+Pf9jTVizYlIo+woPvptfA: folds
t3GiVMzqA9Svgr5Uol32cQ: calls $1.50
alGiiQP/wwtYnfuXII+sgw: folds
3jvoOXNtXE90w2BdfNZwZQ: raises $4.50 to $6
c0n4hrn20AML9qzyFC2E8Q: folds
t3GiVMzqA9Svgr5Uol32cQ: calls $4.50
*** FLOP *** [Qs Ks 8c]
3jvoOXNtXE90w2BdfNZwZQ: bets $50.35 and is all-in
t3GiVMzqA9Svgr5Uol32cQ: calls $13.15 and is all-in
*** TURN *** [Qs Ks 8c] [5s]
*** RIVER *** [Qs Ks 8c 5s] [5h]
*** SHOW DOWN ***
3jvoOXNtXE90w2BdfNZwZQ: shows [Kd As] (two pair, Kings and Fives)
t3GiVMzqA9Svgr5Uol32cQ: shows [6s 9s] (a flush, King high)
t3GiVMzqA9Svgr5Uol32cQ collected $38.10 from pot
*** SUMMARY ***
Total pot $40.05 | Rake $1.95
Board [Qs Ks 8c 5s 5h]
Seat 1: +Pf9jTVizYlIo+woPvptfA folded before Flop (didn't bet)
Seat 2: t3GiVMzqA9Svgr5Uol32cQ (button) showed [6s 9s] and won ($38.10) with a flush, King high
Seat 4: alGiiQP/wwtYnfuXII+sgw (small blind) folded before Flop
Seat 5: 3jvoOXNtXE90w2BdfNZwZQ (big blind) showed [Kd As] and lost with two pair, Kings and Fives
Seat 6: c0n4hrn20AML9qzyFC2E8Q folded before Flop



PokerStars Game #59940396168:  Hold'em No Limit ($0.25/$0.50) - 2009/07/01 1:05:27 ET
Table '+dXkOAQyS8j9PQZusUTMpg' 2-max Seat #1 is the button
Seat 1: XFa6sBGjP2gxoIvxR3fZIg ($107.15 in chips)
Seat 2: 5IBeOgaApY1Bvzv2P8X4EA ($89.65 in chips)
XFa6sBGjP2gxoIvxR3fZIg: posts small blind $0.25
5IBeOgaApY1Bvzv2P8X4EA: posts big blind $0.50
*** HOLE CARDS ***
XFa6sBGjP2gxoIvxR3fZIg: raises $1 to $1.50
5IBeOgaApY1Bvzv2P8X4EA: calls $1
*** FLOP *** [Kh 8c 5h]
5IBeOgaApY1Bvzv2P8X4EA: checks
XFa6sBGjP2gxoIvxR3fZIg: bets $2
5IBeOgaApY1Bvzv2P8X4EA: calls $2
*** TURN *** [Kh 8c 5h] [8d]
5IBeOgaApY1Bvzv2P8X4EA: checks
XFa6sBGjP2gxoIvxR3fZIg: checks
*** RIVER *** [Kh 8c 5h 8d] [2c]
5IBeOgaApY1Bvzv2P8X4EA: bets $3
XFa6sBGjP2gxoIvxR3fZIg: calls $3
*** SHOW DOWN ***
5IBeOgaApY1Bvzv2P8X4EA: shows [3c 3d] (two pair, Eights and Threes)
XFa6sBGjP2gxoIvxR3fZIg: shows [Qc Qd] (two pair, Queens and Eights)
XFa6sBGjP2gxoIvxR3fZIg collected $12.50 from pot
*** SUMMARY ***
Total pot $13 | Rake $0.50
Board [Kh 8c 5h 8d 2c]
Seat 1: XFa6sBGjP2gxoIvxR3fZIg (button) (small blind) showed [Qc Qd] and won ($12.50) with two pair, Queens and Eights
Seat 2: 5IBeOgaApY1Bvzv2P8X4EA (big blind) showed [3c 3d] and lost with two pair, Eights and Threes



PokerStars Game #59940396924:  Hold'em No Limit ($0.25/$0.50) - 2009/07/01 1:05:28 ET
Table 'E7bWJ45aoFXRpyRv2gw+Ig' 2-max Seat #2 is the button
Seat 1: FRkiRasEGlHUeLrEl+k/nA ($58.75 in chips)
Seat 2: 3Wro85I7472vJ4Wkpneo9A ($129 in chips)
3Wro85I7472vJ4Wkpneo9A: posts small blind $0.25
FRkiRasEGlHUeLrEl+k/nA: posts big blind $0.50
*** HOLE CARDS ***
3Wro85I7472vJ4Wkpneo9A: folds
FRkiRasEGlHUeLrEl+k/nA collected $0.50 from pot
FRkiRasEGlHUeLrEl+k/nA: doesn't show hand
*** SUMMARY ***
Total pot $0.50 | Rake $0
Seat 1: FRkiRasEGlHUeLrEl+k/nA (big blind) collected ($0.50)
Seat 2: 3Wro85I7472vJ4Wkpneo9A (button) (small blind) folded before Flop



PokerStars Game #59940398246:  Hold'em No Limit ($0.25/$0.50) - 2009/07/01 1:05:30 ET
Table '0eJtgVAXVvBgncFdcUpXcQ' 2-max Seat #1 is the button
Seat 1: Ag6DvxX4vbRheqsv2zXKTQ ($45.75 in chips)
Seat 2: KMc4R+K9ao4Ur3rF7NGe6Q ($10.75 in chips)
Ag6DvxX4vbRheqsv2zXKTQ: posts small blind $0.25
KMc4R+K9ao4Ur3rF7NGe6Q: posts big blind $0.50
*** HOLE CARDS ***
Ag6DvxX4vbRheqsv2zXKTQ: calls $0.25
KMc4R+K9ao4Ur3rF7NGe6Q: raises $2 to $2.50
Ag6DvxX4vbRheqsv2zXKTQ: calls $2
*** FLOP *** [Ts Qh 7s]
KMc4R+K9ao4Ur3rF7NGe6Q: bets $3
Ag6DvxX4vbRheqsv2zXKTQ: folds
KMc4R+K9ao4Ur3rF7NGe6Q collected $4.75 from pot
KMc4R+K9ao4Ur3rF7NGe6Q: doesn't show hand
*** SUMMARY ***
Total pot $5 | Rake $0.25
Board [Ts Qh 7s]
Seat 1: Ag6DvxX4vbRheqsv2zXKTQ (button) (small blind) folded on the Flop
Seat 2: KMc4R+K9ao4Ur3rF7NGe6Q (big blind) collected ($4.75)



PokerStars Game #59940398056:  Hold'em No Limit ($0.25/$0.50) - 2009/07/01 1:05:30 ET
Table '/cQuAT3ef4t+PGrXiNhGaQ' 9-max Seat #2 is the button
Seat 1: HZkVla4kK2SI42CVrPZ/ig ($14.25 in chips)
Seat 2: jXGruyaMqirTaTXNOvBdew ($68.20 in chips)
Seat 3: g4k0NXISyLCqaSWZDBjfEg ($53.75 in chips)
Seat 4: OWP/DOu+PlPK6ZZ3zYa0HA ($30.60 in chips)
Seat 5: 5SgaHdWixdClWvaEG+KUjQ ($49.35 in chips)
Seat 6: APYIOyK/4AGb+kIwlOUNBQ ($36.50 in chips)
Seat 7: J0W5D97jl5VLky+IoPvDeA ($160.70 in chips)
Seat 8: eBrej2jnlUCs/JgxFCRn2g ($40 in chips)
Seat 9: AjV5McH1KMMclY26QdLM5w ($25.70 in chips)
g4k0NXISyLCqaSWZDBjfEg: posts small blind $0.25
OWP/DOu+PlPK6ZZ3zYa0HA: posts big blind $0.50
*** HOLE CARDS ***
5SgaHdWixdClWvaEG+KUjQ: folds
APYIOyK/4AGb+kIwlOUNBQ: calls $0.50
J0W5D97jl5VLky+IoPvDeA: folds
eBrej2jnlUCs/JgxFCRn2g: folds
AjV5McH1KMMclY26QdLM5w: folds
HZkVla4kK2SI42CVrPZ/ig: folds
jXGruyaMqirTaTXNOvBdew: folds
g4k0NXISyLCqaSWZDBjfEg: folds
OWP/DOu+PlPK6ZZ3zYa0HA: checks
*** FLOP *** [Ac Td 2h]
OWP/DOu+PlPK6ZZ3zYa0HA: checks
APYIOyK/4AGb+kIwlOUNBQ: bets $1
OWP/DOu+PlPK6ZZ3zYa0HA: calls $1
*** TURN *** [Ac Td 2h] [9d]
OWP/DOu+PlPK6ZZ3zYa0HA: checks
APYIOyK/4AGb+kIwlOUNBQ: bets $3
OWP/DOu+PlPK6ZZ3zYa0HA: folds
APYIOyK/4AGb+kIwlOUNBQ collected $3.10 from pot
*** SUMMARY ***
Total pot $3.25 | Rake $0.15
Board [Ac Td 2h 9d]
Seat 1: HZkVla4kK2SI42CVrPZ/ig folded before Flop (didn't bet)
Seat 2: jXGruyaMqirTaTXNOvBdew (button) folded before Flop (didn't bet)
Seat 3: g4k0NXISyLCqaSWZDBjfEg (small blind) folded before Flop
Seat 4: OWP/DOu+PlPK6ZZ3zYa0HA (big blind) folded on the Turn
Seat 5: 5SgaHdWixdClWvaEG+KUjQ folded before Flop (didn't bet)
Seat 6: APYIOyK/4AGb+kIwlOUNBQ collected ($3.10)
Seat 7: J0W5D97jl5VLky+IoPvDeA folded before Flop (didn't bet)
Seat 8: eBrej2jnlUCs/JgxFCRn2g folded before Flop (didn't bet)
Seat 9: AjV5McH1KMMclY26QdLM5w folded before Flop (didn't bet)



PokerStars Game #59940398910:  Hold'em No Limit ($0.25/$0.50) - 2009/07/01 1:05:31 ET
Table 'X6IRCRTh+20gjz8aubWnwA' 9-max Seat #1 is the button
Seat 1: DSM67hHHq1XFoEOi9p8Alw ($49.50 in chips)
Seat 2: HZkVla4kK2SI42CVrPZ/ig ($7.05 in chips)
Seat 3: SWv01peOe69QQRvhQTqjQw ($8.75 in chips)
Seat 4: M3JFBNQ8Bbw3FBZ/18MuXw ($26.60 in chips)
Seat 5: NnQCepdIR/AOUQn1yhYx6Q ($10 in chips)
Seat 6: 75K2MXwN65Sjfp1yHd50Hg ($10 in chips)
Seat 7: cFHQjKQOOKTUzoilhrXHLg ($18.90 in chips)
Seat 8: HxeBVq06/3Bh/H986sgdbw ($48.05 in chips)
Seat 9: M+7+BTmX5vZatHVuoRB1nA ($44.25 in chips)
HZkVla4kK2SI42CVrPZ/ig: posts small blind $0.25
SWv01peOe69QQRvhQTqjQw: posts big blind $0.50
*** HOLE CARDS ***
M3JFBNQ8Bbw3FBZ/18MuXw: calls $0.50
NnQCepdIR/AOUQn1yhYx6Q: folds
75K2MXwN65Sjfp1yHd50Hg: folds
cFHQjKQOOKTUzoilhrXHLg: calls $0.50
HxeBVq06/3Bh/H986sgdbw: raises $2 to $2.50
M+7+BTmX5vZatHVuoRB1nA: folds
DSM67hHHq1XFoEOi9p8Alw: folds
HZkVla4kK2SI42CVrPZ/ig: folds
SWv01peOe69QQRvhQTqjQw: folds
M3JFBNQ8Bbw3FBZ/18MuXw: calls $2
cFHQjKQOOKTUzoilhrXHLg: folds
*** FLOP *** [6s Ks Qd]
M3JFBNQ8Bbw3FBZ/18MuXw: checks
HxeBVq06/3Bh/H986sgdbw: bets $3.50
M3JFBNQ8Bbw3FBZ/18MuXw: folds
HxeBVq06/3Bh/H986sgdbw collected $5.95 from pot
HxeBVq06/3Bh/H986sgdbw: doesn't show hand
*** SUMMARY ***
Total pot $6.25 | Rake $0.30
Board [6s Ks Qd]
Seat 1: DSM67hHHq1XFoEOi9p8Alw (button) folded before Flop (didn't bet)
Seat 2: HZkVla4kK2SI42CVrPZ/ig (small blind) folded before Flop
Seat 3: SWv01peOe69QQRvhQTqjQw (big blind) folded before Flop
Seat 4: M3JFBNQ8Bbw3FBZ/18MuXw folded on the Flop
Seat 5: NnQCepdIR/AOUQn1yhYx6Q folded before Flop (didn't bet)
Seat 6: 75K2MXwN65Sjfp1yHd50Hg folded before Flop (didn't bet)
Seat 7: cFHQjKQOOKTUzoilhrXHLg folded before Flop
Seat 8: HxeBVq06/3Bh/H986sgdbw collected ($5.95)
Seat 9: M+7+BTmX5vZatHVuoRB1nA folded before Flop (didn't bet)



PokerStars Game #59940399882:  Hold'em No Limit ($0.25/$0.50) - 2009/07/01 1:05:33 ET
Table '8BQGgNetI1NOvWeu3gtMNw' 2-max Seat #2 is the button
Seat 1: bypIyrYcAAifLfhZpGlKLA ($89.25 in chips)
Seat 2: Z4HwehErEwzsv/noQlfUlg ($110.75 in chips)
Z4HwehErEwzsv/noQlfUlg: posts small blind $0.25
bypIyrYcAAifLfhZpGlKLA: posts big blind $0.50
*** HOLE CARDS ***
Z4HwehErEwzsv/noQlfUlg: folds
bypIyrYcAAifLfhZpGlKLA collected $0.50 from pot
bypIyrYcAAifLfhZpGlKLA: doesn't show hand
*** SUMMARY ***
Total pot $0.50 | Rake $0
Seat 1: bypIyrYcAAifLfhZpGlKLA (big blind) collected ($0.50)
Seat 2: Z4HwehErEwzsv/noQlfUlg (button) (small blind) folded before Flop



PokerStars Game #59940400668:  Hold'em No Limit ($0.25/$0.50) - 2009/07/01 1:05:34 ET
Table '+z1aekfHkpp09pc8F9aViw' 6-max Seat #5 is the button
Seat 1: FHilMb2i2DbUCc9lplszog ($8.35 in chips)
Seat 3: uUznlIMFnRUvwrBhYF73KA ($131.65 in chips)
Seat 4: RowCSpSURHTOL/dcjg/Iug ($37.30 in chips)
Seat 5: rplyldNweS6YyMNEALQrug ($54.20 in chips)
Seat 6: 686aeHikcJlgKkSuIFdcXQ ($50 in chips)
686aeHikcJlgKkSuIFdcXQ: posts small blind $0.25
FHilMb2i2DbUCc9lplszog: posts big blind $0.50
*** HOLE CARDS ***
uUznlIMFnRUvwrBhYF73KA: calls $0.50
RowCSpSURHTOL/dcjg/Iug: folds
rplyldNweS6YyMNEALQrug: calls $0.50
8EEqTTh7T1q48sYDqbI2Xg joins the table at seat #2
686aeHikcJlgKkSuIFdcXQ: calls $0.25
FHilMb2i2DbUCc9lplszog: raises $5 to $5.50
uUznlIMFnRUvwrBhYF73KA: folds
rplyldNweS6YyMNEALQrug: folds
686aeHikcJlgKkSuIFdcXQ: folds
FHilMb2i2DbUCc9lplszog collected $2 from pot
*** SUMMARY ***
Total pot $2 | Rake $0
Seat 1: FHilMb2i2DbUCc9lplszog (big blind) collected ($2)
Seat 3: uUznlIMFnRUvwrBhYF73KA folded before Flop
Seat 4: RowCSpSURHTOL/dcjg/Iug folded before Flop (didn't bet)
Seat 5: rplyldNweS6YyMNEALQrug (button) folded before Flop
Seat 6: 686aeHikcJlgKkSuIFdcXQ (small blind) folded before Flop



PokerStars Game #59940401178:  Hold'em No Limit ($0.25/$0.50) - 2009/07/01 1:05:35 ET
Table 'E7bWJ45aoFXRpyRv2gw+Ig' 2-max Seat #1 is the button
Seat 1: FRkiRasEGlHUeLrEl+k/nA ($59 in chips)
Seat 2: 3Wro85I7472vJ4Wkpneo9A ($128.75 in chips)
FRkiRasEGlHUeLrEl+k/nA: posts small blind $0.25
3Wro85I7472vJ4Wkpneo9A: posts big blind $0.50
*** HOLE CARDS ***
FRkiRasEGlHUeLrEl+k/nA: raises $1 to $1.50
3Wro85I7472vJ4Wkpneo9A: folds
FRkiRasEGlHUeLrEl+k/nA collected $1 from pot
*** SUMMARY ***
Total pot $1 | Rake $0
Seat 1: FRkiRasEGlHUeLrEl+k/nA (button) (small blind) collected ($1)
Seat 2: 3Wro85I7472vJ4Wkpneo9A (big blind) folded before Flop



PokerStars Game #59940405222:  Hold'em No Limit ($0.25/$0.50) - 2009/07/01 1:05:42 ET
Table '8BQGgNetI1NOvWeu3gtMNw' 2-max Seat #1 is the button
Seat 1: bypIyrYcAAifLfhZpGlKLA ($89.50 in chips)
Seat 2: Z4HwehErEwzsv/noQlfUlg ($110.50 in chips)
bypIyrYcAAifLfhZpGlKLA: posts small blind $0.25
Z4HwehErEwzsv/noQlfUlg: posts big blind $0.50
*** HOLE CARDS ***
bypIyrYcAAifLfhZpGlKLA: raises $1 to $1.50
Z4HwehErEwzsv/noQlfUlg: raises $1.50 to $3
bypIyrYcAAifLfhZpGlKLA: calls $1.50
*** FLOP *** [Qh 7h 5d]
Z4HwehErEwzsv/noQlfUlg: checks
bypIyrYcAAifLfhZpGlKLA: checks
*** TURN *** [Qh 7h 5d] [9h]
Z4HwehErEwzsv/noQlfUlg: checks
bypIyrYcAAifLfhZpGlKLA: checks
*** RIVER *** [Qh 7h 5d 9h] [6s]
Z4HwehErEwzsv/noQlfUlg: bets $5
bypIyrYcAAifLfhZpGlKLA: calls $5
*** SHOW DOWN ***
Z4HwehErEwzsv/noQlfUlg: shows [Js 9c] (a pair of Nines)
bypIyrYcAAifLfhZpGlKLA: shows [4d 3d] (a straight, Three to Seven)
bypIyrYcAAifLfhZpGlKLA collected $15.50 from pot
*** SUMMARY ***
Total pot $16 | Rake $0.50
Board [Qh 7h 5d 9h 6s]
Seat 1: bypIyrYcAAifLfhZpGlKLA (button) (small blind) showed [4d 3d] and won ($15.50) with a straight, Three to Seven
Seat 2: Z4HwehErEwzsv/noQlfUlg (big blind) showed [Js 9c] and lost with a pair of Nines



PokerStars Game #59940405466:  Hold'em No Limit ($0.25/$0.50) - 2009/07/01 1:05:43 ET
Table '0eJtgVAXVvBgncFdcUpXcQ' 2-max Seat #2 is the button
Seat 1: Ag6DvxX4vbRheqsv2zXKTQ ($43.25 in chips)
Seat 2: KMc4R+K9ao4Ur3rF7NGe6Q ($13 in chips)
KMc4R+K9ao4Ur3rF7NGe6Q: posts small blind $0.25
Ag6DvxX4vbRheqsv2zXKTQ: posts big blind $0.50
*** HOLE CARDS ***
KMc4R+K9ao4Ur3rF7NGe6Q: calls $0.25
Ag6DvxX4vbRheqsv2zXKTQ: checks
*** FLOP *** [Tc Th 3h]
Ag6DvxX4vbRheqsv2zXKTQ: checks
KMc4R+K9ao4Ur3rF7NGe6Q: checks
*** TURN *** [Tc Th 3h] [2s]
Ag6DvxX4vbRheqsv2zXKTQ: bets $0.50
KMc4R+K9ao4Ur3rF7NGe6Q: calls $0.50
*** RIVER *** [Tc Th 3h 2s] [Kc]
Ag6DvxX4vbRheqsv2zXKTQ: checks
KMc4R+K9ao4Ur3rF7NGe6Q: checks
*** SHOW DOWN ***
Ag6DvxX4vbRheqsv2zXKTQ: shows [Jc 6s] (a pair of Tens)
KMc4R+K9ao4Ur3rF7NGe6Q: mucks hand
Ag6DvxX4vbRheqsv2zXKTQ collected $1.95 from pot
*** SUMMARY ***
Total pot $2 | Rake $0.05
Board [Tc Th 3h 2s Kc]
Seat 1: Ag6DvxX4vbRheqsv2zXKTQ (big blind) showed [Jc 6s] and won ($1.95) with a pair of Tens
Seat 2: KMc4R+K9ao4Ur3rF7NGe6Q (button) (small blind) mucked



PokerStars Game #59940405830:  Hold'em No Limit ($0.25/$0.50) - 2009/07/01 1:05:43 ET
Table 'QOgaEqMcJ73pcUMMxoisUg' 6-max Seat #1 is the button
Seat 1: lxIzoHy0RnkfFSODHC2liw ($53.35 in chips)
Seat 3: Rt6KgtZ8YaJoTc3FPim00w ($54 in chips)
Seat 4: zAcsDhG/T128Vn7XGVSgKg ($50 in chips)
Seat 5: 6vNxrjjCl6FwfaaymM9jjg ($21.75 in chips)
oqOqoO2AyCZenUghCxMDxw will be allowed to play after the button
Rt6KgtZ8YaJoTc3FPim00w: posts small blind $0.25
zAcsDhG/T128Vn7XGVSgKg: posts big blind $0.50
*** HOLE CARDS ***
6vNxrjjCl6FwfaaymM9jjg: folds
lxIzoHy0RnkfFSODHC2liw: folds
Rt6KgtZ8YaJoTc3FPim00w: folds
zAcsDhG/T128Vn7XGVSgKg collected $0.50 from pot
zAcsDhG/T128Vn7XGVSgKg: doesn't show hand
*** SUMMARY ***
Total pot $0.50 | Rake $0
Seat 1: lxIzoHy0RnkfFSODHC2liw (button) folded before Flop (didn't bet)
Seat 3: Rt6KgtZ8YaJoTc3FPim00w (small blind) folded before Flop
Seat 4: zAcsDhG/T128Vn7XGVSgKg (big blind) collected ($0.50)
Seat 5: 6vNxrjjCl6FwfaaymM9jjg folded before Flop (didn't bet)



PokerStars Game #59940406134:  Hold'em No Limit ($0.25/$0.50) - 2009/07/01 1:05:44 ET
Table 'GfL/No5u5PoEnU39lP5pQg' 6-max Seat #6 is the button
Seat 1: 1WUCqNG+p+vfWRTXNu4ljw ($64.75 in chips)
Seat 2: uVwggSetzp7d+eVgowO3vg ($58.50 in chips)
Seat 3: eQXFICMuu3hw6XlcmuVNEA ($17.40 in chips)
Seat 4: r6u7MWSXF30/khcTYkrG9Q ($35.90 in chips)
Seat 5: M1KyQQvVPVuxqTAB8sR/zQ ($53 in chips)
Seat 6: kxPhs4ePFqMy52CInAJ2aw ($48.50 in chips)
1WUCqNG+p+vfWRTXNu4ljw: posts small blind $0.25
uVwggSetzp7d+eVgowO3vg: posts big blind $0.50
*** HOLE CARDS ***
eQXFICMuu3hw6XlcmuVNEA: raises $1.50 to $2
r6u7MWSXF30/khcTYkrG9Q: folds
M1KyQQvVPVuxqTAB8sR/zQ: calls $2
kxPhs4ePFqMy52CInAJ2aw: folds
1WUCqNG+p+vfWRTXNu4ljw: folds
uVwggSetzp7d+eVgowO3vg: calls $1.50
*** FLOP *** [Ah 2d Tc]
uVwggSetzp7d+eVgowO3vg: checks
eQXFICMuu3hw6XlcmuVNEA: bets $2.50
M1KyQQvVPVuxqTAB8sR/zQ: folds
uVwggSetzp7d+eVgowO3vg: folds
eQXFICMuu3hw6XlcmuVNEA collected $5.95 from pot
*** SUMMARY ***
Total pot $6.25 | Rake $0.30
Board [Ah 2d Tc]
Seat 1: 1WUCqNG+p+vfWRTXNu4ljw (small blind) folded before Flop
Seat 2: uVwggSetzp7d+eVgowO3vg (big blind) folded on the Flop
Seat 3: eQXFICMuu3hw6XlcmuVNEA collected ($5.95)
Seat 4: r6u7MWSXF30/khcTYkrG9Q folded before Flop (didn't bet)
Seat 5: M1KyQQvVPVuxqTAB8sR/zQ folded on the Flop
Seat 6: kxPhs4ePFqMy52CInAJ2aw (button) folded before Flop (didn't bet)



PokerStars Game #59940406986:  Hold'em No Limit ($0.25/$0.50) - 2009/07/01 1:05:45 ET
Table 'E7bWJ45aoFXRpyRv2gw+Ig' 2-max Seat #2 is the button
Seat 1: FRkiRasEGlHUeLrEl+k/nA ($59.50 in chips)
Seat 2: 3Wro85I7472vJ4Wkpneo9A ($128.25 in chips)
3Wro85I7472vJ4Wkpneo9A: posts small blind $0.25
FRkiRasEGlHUeLrEl+k/nA: posts big blind $0.50
*** HOLE CARDS ***
3Wro85I7472vJ4Wkpneo9A: calls $0.25
FRkiRasEGlHUeLrEl+k/nA: checks
*** FLOP *** [Kc Jc 3s]
FRkiRasEGlHUeLrEl+k/nA: checks
3Wro85I7472vJ4Wkpneo9A: bets $1
FRkiRasEGlHUeLrEl+k/nA: folds
3Wro85I7472vJ4Wkpneo9A collected $0.95 from pot
3Wro85I7472vJ4Wkpneo9A: doesn't show hand
*** SUMMARY ***
Total pot $1 | Rake $0.05
Board [Kc Jc 3s]
Seat 1: FRkiRasEGlHUeLrEl+k/nA (big blind) folded on the Flop
Seat 2: 3Wro85I7472vJ4Wkpneo9A (button) (small blind) collected ($0.95)



PokerStars Game #59940406910:  Hold'em No Limit ($0.25/$0.50) - 2009/07/01 1:05:45 ET
Table '37qXEp3oe+er5q4CZip9eQ' 6-max Seat #2 is the button
Seat 2: LvH4G7n+QSjT6NDaD3cREA ($57.05 in chips)
Seat 3: Rt6KgtZ8YaJoTc3FPim00w ($109.70 in chips)
Seat 4: XsmE8nXMAAMFJbWaJTmHFw ($39.85 in chips)
Seat 5: VOmI0x4dDPnTESZd5B4d1Q ($42.55 in chips)
Seat 6: N50kln4negd8q7Mmoz1j4g ($16.60 in chips)
Rt6KgtZ8YaJoTc3FPim00w: posts small blind $0.25
XsmE8nXMAAMFJbWaJTmHFw: posts big blind $0.50
*** HOLE CARDS ***
VOmI0x4dDPnTESZd5B4d1Q: calls $0.50
N50kln4negd8q7Mmoz1j4g: folds
LvH4G7n+QSjT6NDaD3cREA: folds
Rt6KgtZ8YaJoTc3FPim00w: folds
XsmE8nXMAAMFJbWaJTmHFw: checks
*** FLOP *** [6d Js 9h]
XsmE8nXMAAMFJbWaJTmHFw: checks
VOmI0x4dDPnTESZd5B4d1Q: checks
*** TURN *** [6d Js 9h] [Kh]
XsmE8nXMAAMFJbWaJTmHFw: checks
VOmI0x4dDPnTESZd5B4d1Q: bets $1
XsmE8nXMAAMFJbWaJTmHFw: folds
VOmI0x4dDPnTESZd5B4d1Q collected $1.20 from pot
*** SUMMARY ***
Total pot $1.25 | Rake $0.05
Board [6d Js 9h Kh]
Seat 2: LvH4G7n+QSjT6NDaD3cREA (button) folded before Flop (didn't bet)
Seat 3: Rt6KgtZ8YaJoTc3FPim00w (small blind) folded before Flop
Seat 4: XsmE8nXMAAMFJbWaJTmHFw (big blind) folded on the Turn
Seat 5: VOmI0x4dDPnTESZd5B4d1Q collected ($1.20)
Seat 6: N50kln4negd8q7Mmoz1j4g folded before Flop (didn't bet)



PokerStars Game #59940408860:  Hold'em No Limit ($0.25/$0.50) - 2009/07/01 1:05:48 ET
Table '+dXkOAQyS8j9PQZusUTMpg' 2-max Seat #2 is the button
Seat 1: XFa6sBGjP2gxoIvxR3fZIg ($113.15 in chips)
Seat 2: 5IBeOgaApY1Bvzv2P8X4EA ($83.15 in chips)
5IBeOgaApY1Bvzv2P8X4EA: posts small blind $0.25
XFa6sBGjP2gxoIvxR3fZIg: posts big blind $0.50
*** HOLE CARDS ***
5IBeOgaApY1Bvzv2P8X4EA said, "nh"
5IBeOgaApY1Bvzv2P8X4EA: raises $1 to $1.50
XFa6sBGjP2gxoIvxR3fZIg said, "ty"
XFa6sBGjP2gxoIvxR3fZIg: raises $4 to $5.50
5IBeOgaApY1Bvzv2P8X4EA: calls $4
*** FLOP *** [5d Qc 7s]
XFa6sBGjP2gxoIvxR3fZIg: checks
5IBeOgaApY1Bvzv2P8X4EA: checks
*** TURN *** [5d Qc 7s] [6c]
XFa6sBGjP2gxoIvxR3fZIg: bets $10.50
5IBeOgaApY1Bvzv2P8X4EA: folds
XFa6sBGjP2gxoIvxR3fZIg collected $10.50 from pot
XFa6sBGjP2gxoIvxR3fZIg: doesn't show hand
*** SUMMARY ***
Total pot $11 | Rake $0.50
Board [5d Qc 7s 6c]
Seat 1: XFa6sBGjP2gxoIvxR3fZIg (big blind) collected ($10.50)
Seat 2: 5IBeOgaApY1Bvzv2P8X4EA (button) (small blind) folded on the Turn



PokerStars Game #59940408736:  Hold'em No Limit ($0.25/$0.50) - 2009/07/01 1:05:48 ET
Table 'ibNfFy0bCzuBaUORla0aGw' 9-max Seat #1 is the button
Seat 1: xZCXQSXlrZkp3pZizzVXCw ($50.55 in chips)
Seat 2: 90Wb75h3W1BRpbqVnuk8gw ($51.65 in chips)
Seat 3: AjV5McH1KMMclY26QdLM5w ($25 in chips)
Seat 4: YBN054X4blmis+B2bBlC0g ($22.20 in chips)
Seat 5: GIJAc9kPrLZHLSX8Q6i99w ($23.95 in chips)
Seat 7: HZkVla4kK2SI42CVrPZ/ig ($14.30 in chips)
Seat 8: 2CfOMUqXsQk69Igusq28Pg ($11.20 in chips)
Seat 9: pFtzb1sR4b0d1aw6aIRgDg ($50.05 in chips)
90Wb75h3W1BRpbqVnuk8gw: posts small blind $0.25
AjV5McH1KMMclY26QdLM5w: posts big blind $0.50
H8cPaCtX7d6meGUVSM5sxw: sits out
*** HOLE CARDS ***
YBN054X4blmis+B2bBlC0g: folds
GIJAc9kPrLZHLSX8Q6i99w: raises $1 to $1.50
HZkVla4kK2SI42CVrPZ/ig: folds
2CfOMUqXsQk69Igusq28Pg: folds
pFtzb1sR4b0d1aw6aIRgDg: folds
xZCXQSXlrZkp3pZizzVXCw: folds
90Wb75h3W1BRpbqVnuk8gw: calls $1.25
AjV5McH1KMMclY26QdLM5w: folds
*** FLOP *** [5s 3d Js]
90Wb75h3W1BRpbqVnuk8gw: checks
GIJAc9kPrLZHLSX8Q6i99w: checks
*** TURN *** [5s 3d Js] [8s]
90Wb75h3W1BRpbqVnuk8gw: bets $2
GIJAc9kPrLZHLSX8Q6i99w: folds
90Wb75h3W1BRpbqVnuk8gw collected $3.35 from pot
90Wb75h3W1BRpbqVnuk8gw: doesn't show hand
*** SUMMARY ***
Total pot $3.50 | Rake $0.15
Board [5s 3d Js 8s]
Seat 1: xZCXQSXlrZkp3pZizzVXCw (button) folded before Flop (didn't bet)
Seat 2: 90Wb75h3W1BRpbqVnuk8gw (small blind) collected ($3.35)
Seat 3: AjV5McH1KMMclY26QdLM5w (big blind) folded before Flop
Seat 4: YBN054X4blmis+B2bBlC0g folded before Flop (didn't bet)
Seat 5: GIJAc9kPrLZHLSX8Q6i99w folded on the Turn
Seat 7: HZkVla4kK2SI42CVrPZ/ig folded before Flop (didn't bet)
Seat 8: 2CfOMUqXsQk69Igusq28Pg folded before Flop (didn't bet)
Seat 9: pFtzb1sR4b0d1aw6aIRgDg folded before Flop (didn't bet)



PokerStars Game #59940408358:  Hold'em No Limit ($0.25/$0.50) - 2009/07/01 1:05:48 ET
Table 'lpxYasB1ClBSgTpCCITwhQ' 9-max Seat #7 is the button
Seat 1: mj7PS7wCH4PAl7+eYTFs7A ($50 in chips)
Seat 2: OWP/DOu+PlPK6ZZ3zYa0HA ($28.45 in chips)
Seat 4: NnQCepdIR/AOUQn1yhYx6Q ($10 in chips)
Seat 5: IYd5zG8k7vdBNVHbHg2Pag ($35 in chips)
Seat 6: SegjDnMxWMujiD57ESNL+g ($11.35 in chips)
Seat 7: bmRtaIYKthN1F+B3JLZ3Jw ($73.40 in chips)
Seat 8: /mfensKw8/iZ1Vrx33S4xg ($19.75 in chips)
Seat 9: sUIUZ+begh92dzkUmvbMrw ($9.90 in chips)
/mfensKw8/iZ1Vrx33S4xg: posts small blind $0.25
sUIUZ+begh92dzkUmvbMrw: posts big blind $0.50
sakr/FIfFtIZwDPmAj5Pzg: sits out
*** HOLE CARDS ***
mj7PS7wCH4PAl7+eYTFs7A: folds
OWP/DOu+PlPK6ZZ3zYa0HA: raises $1 to $1.50
NnQCepdIR/AOUQn1yhYx6Q: folds
IYd5zG8k7vdBNVHbHg2Pag: folds
SegjDnMxWMujiD57ESNL+g: folds
bmRtaIYKthN1F+B3JLZ3Jw: folds
/mfensKw8/iZ1Vrx33S4xg: folds
sUIUZ+begh92dzkUmvbMrw: calls $1
*** FLOP *** [5h 9c 2c]
sUIUZ+begh92dzkUmvbMrw: checks
OWP/DOu+PlPK6ZZ3zYa0HA: bets $2
sUIUZ+begh92dzkUmvbMrw: raises $4 to $6
OWP/DOu+PlPK6ZZ3zYa0HA: folds
sUIUZ+begh92dzkUmvbMrw collected $6.90 from pot
*** SUMMARY ***
Total pot $7.25 | Rake $0.35
Board [5h 9c 2c]
Seat 1: mj7PS7wCH4PAl7+eYTFs7A folded before Flop (didn't bet)
Seat 2: OWP/DOu+PlPK6ZZ3zYa0HA folded on the Flop
Seat 4: NnQCepdIR/AOUQn1yhYx6Q folded before Flop (didn't bet)
Seat 5: IYd5zG8k7vdBNVHbHg2Pag folded before Flop (didn't bet)
Seat 6: SegjDnMxWMujiD57ESNL+g folded before Flop (didn't bet)
Seat 7: bmRtaIYKthN1F+B3JLZ3Jw (button) folded before Flop (didn't bet)
Seat 8: /mfensKw8/iZ1Vrx33S4xg (small blind) folded before Flop
Seat 9: sUIUZ+begh92dzkUmvbMrw (big blind) collected ($6.90)



PokerStars Game #59940409710:  Hold'em No Limit ($0.25/$0.50) - 2009/07/01 1:05:50 ET
Table 'c/CRn+68J3Y8KxD5g1ek2Q' 2-max Seat #1 is the button
Seat 1: 46qCyJ6evTkHo9al5sBMNA ($90.75 in chips)
Seat 2: BypVLsYQt3ePFm2xQL/dOA ($276.05 in chips)
46qCyJ6evTkHo9al5sBMNA: posts small blind $0.25
BypVLsYQt3ePFm2xQL/dOA: posts big blind $0.50
*** HOLE CARDS ***
46qCyJ6evTkHo9al5sBMNA: raises $1.50 to $2
BypVLsYQt3ePFm2xQL/dOA: calls $1.50
*** FLOP *** [Jh Qh 8d]
BypVLsYQt3ePFm2xQL/dOA: checks
46qCyJ6evTkHo9al5sBMNA: checks
*** TURN *** [Jh Qh 8d] [6d]
BypVLsYQt3ePFm2xQL/dOA: checks
46qCyJ6evTkHo9al5sBMNA: checks
*** RIVER *** [Jh Qh 8d 6d] [Qs]
BypVLsYQt3ePFm2xQL/dOA: checks
46qCyJ6evTkHo9al5sBMNA: checks
*** SHOW DOWN ***
BypVLsYQt3ePFm2xQL/dOA: shows [Ah 8c] (two pair, Queens and Eights)
46qCyJ6evTkHo9al5sBMNA: shows [9s 9h] (two pair, Queens and Nines)
46qCyJ6evTkHo9al5sBMNA collected $3.80 from pot
*** SUMMARY ***
Total pot $4 | Rake $0.20
Board [Jh Qh 8d 6d Qs]
Seat 1: 46qCyJ6evTkHo9al5sBMNA (button) (small blind) showed [9s 9h] and won ($3.80) with two pair, Queens and Nines
Seat 2: BypVLsYQt3ePFm2xQL/dOA (big blind) showed [Ah 8c] and lost with two pair, Queens and Eights



PokerStars Game #59940411280:  Hold'em No Limit ($0.25/$0.50) - 2009/07/01 1:05:52 ET
Table 'WlCrrUP9MxwySQN5fzLFBQ' 2-max Seat #2 is the button
Seat 1: U7xFsli2XvMiGlVDxk8a/Q ($22.55 in chips)
Seat 2: JTT5TsRNqs6npc7cgI4X/w ($10 in chips)
JTT5TsRNqs6npc7cgI4X/w: posts small blind $0.25
U7xFsli2XvMiGlVDxk8a/Q: posts big blind $0.50
*** HOLE CARDS ***
JTT5TsRNqs6npc7cgI4X/w: raises $1.50 to $2
U7xFsli2XvMiGlVDxk8a/Q: raises $20.55 to $22.55 and is all-in
JTT5TsRNqs6npc7cgI4X/w: calls $8 and is all-in
*** FLOP *** [4h Tc 3h]
*** TURN *** [4h Tc 3h] [8s]
*** RIVER *** [4h Tc 3h 8s] [5h]
*** SHOW DOWN ***
U7xFsli2XvMiGlVDxk8a/Q: shows [Kc Qs] (high card King)
JTT5TsRNqs6npc7cgI4X/w: shows [Th Ac] (a pair of Tens)
JTT5TsRNqs6npc7cgI4X/w collected $19.50 from pot
*** SUMMARY ***
Total pot $20 | Rake $0.50
Board [4h Tc 3h 8s 5h]
Seat 1: U7xFsli2XvMiGlVDxk8a/Q (big blind) showed [Kc Qs] and lost with high card King
Seat 2: JTT5TsRNqs6npc7cgI4X/w (button) (small blind) showed [Th Ac] and won ($19.50) with a pair of Tens



PokerStars Game #59940411954:  Hold'em No Limit ($0.25/$0.50) - 2009/07/01 1:05:53 ET
Table 'otvGDROEDdqsabxskT79qg' 9-max Seat #1 is the button
Seat 1: 8ehL7qlZzjgUh2H35iiWLw ($56 in chips)
Seat 2: cCjTzH9jio8607WzjcfXlg ($12.50 in chips)
Seat 3: +k7T5ocke8UwavtgUHm+Cg ($70.60 in chips)
Seat 4: MG90wfSJZnOejs/KD3vlQQ ($76.65 in chips)
Seat 5: E2518gp4aFz1+kAgmGqeEg ($11.75 in chips)
Seat 6: bxLSulbgr8LmKNjOzw8URg ($55.50 in chips)
Seat 7: 75K2MXwN65Sjfp1yHd50Hg ($10 in chips)
Seat 8: zE9cVigS2nW/Ljy4K4bUQA ($30 in chips)
Seat 9: KcY3X8YpD74Kw1RHkx/g4A ($50.40 in chips)
cCjTzH9jio8607WzjcfXlg: posts small blind $0.25
+k7T5ocke8UwavtgUHm+Cg: posts big blind $0.50
*** HOLE CARDS ***
MG90wfSJZnOejs/KD3vlQQ: folds
E2518gp4aFz1+kAgmGqeEg: folds
bxLSulbgr8LmKNjOzw8URg: folds
75K2MXwN65Sjfp1yHd50Hg: folds
zE9cVigS2nW/Ljy4K4bUQA: folds
KcY3X8YpD74Kw1RHkx/g4A: folds
8ehL7qlZzjgUh2H35iiWLw: raises $1.50 to $2
cCjTzH9jio8607WzjcfXlg: folds
+k7T5ocke8UwavtgUHm+Cg: folds
8ehL7qlZzjgUh2H35iiWLw collected $1.25 from pot
8ehL7qlZzjgUh2H35iiWLw: doesn't show hand
*** SUMMARY ***
Total pot $1.25 | Rake $0
Seat 1: 8ehL7qlZzjgUh2H35iiWLw (button) collected ($1.25)
Seat 2: cCjTzH9jio8607WzjcfXlg (small blind) folded before Flop
Seat 3: +k7T5ocke8UwavtgUHm+Cg (big blind) folded before Flop
Seat 4: MG90wfSJZnOejs/KD3vlQQ folded before Flop (didn't bet)
Seat 5: E2518gp4aFz1+kAgmGqeEg folded before Flop (didn't bet)
Seat 6: bxLSulbgr8LmKNjOzw8URg folded before Flop (didn't bet)
Seat 7: 75K2MXwN65Sjfp1yHd50Hg folded before Flop (didn't bet)
Seat 8: zE9cVigS2nW/Ljy4K4bUQA folded before Flop (didn't bet)
Seat 9: KcY3X8YpD74Kw1RHkx/g4A folded before Flop (didn't bet)



PokerStars Game #59940412490:  Hold'em No Limit ($0.25/$0.50) - 2009/07/01 1:05:54 ET
Table 'lSisgp6H7Fg1hH5VfjEjYQ' 9-max Seat #1 is the button
Seat 1: 5k9fvXD9suIgCxU4HLQjTw ($50 in chips)
Seat 2: UrcnkQOiLVk8BlKDPJSy7Q ($76.80 in chips)
Seat 3: aTkyjTh3w5YLWiIERupZOA ($52.15 in chips)
Seat 4: bwv/rbH/hHhPhY6u9mu04w ($30.35 in chips)
Seat 5: mSD1pginDsyHG5PDfqzphw ($10 in chips)
Seat 6: +k7T5ocke8UwavtgUHm+Cg ($66.30 in chips)
Seat 7: IDtNLR9uFCDdjNsJWMHA5Q ($23.55 in chips)
Seat 8: a4JDWmpFQkL10XfAyuF51A ($27 in chips)
Seat 9: YzeKFbJVLmJGTgNH3ySQlw ($10 in chips)
UrcnkQOiLVk8BlKDPJSy7Q: posts small blind $0.25
aTkyjTh3w5YLWiIERupZOA: posts big blind $0.50
YzeKFbJVLmJGTgNH3ySQlw: posts big blind $0.50
*** HOLE CARDS ***
bwv/rbH/hHhPhY6u9mu04w: calls $0.50
mSD1pginDsyHG5PDfqzphw: folds
+k7T5ocke8UwavtgUHm+Cg: folds
IDtNLR9uFCDdjNsJWMHA5Q: folds
a4JDWmpFQkL10XfAyuF51A: folds
YzeKFbJVLmJGTgNH3ySQlw: checks
5k9fvXD9suIgCxU4HLQjTw: calls $0.50
UrcnkQOiLVk8BlKDPJSy7Q: folds
aTkyjTh3w5YLWiIERupZOA: checks
*** FLOP *** [3s Jh 6h]
aTkyjTh3w5YLWiIERupZOA: checks
bwv/rbH/hHhPhY6u9mu04w: bets $1
YzeKFbJVLmJGTgNH3ySQlw: folds
5k9fvXD9suIgCxU4HLQjTw: calls $1
aTkyjTh3w5YLWiIERupZOA: folds
*** TURN *** [3s Jh 6h] [5c]
bwv/rbH/hHhPhY6u9mu04w: bets $1.50
5k9fvXD9suIgCxU4HLQjTw: calls $1.50
*** RIVER *** [3s Jh 6h 5c] [2h]
bwv/rbH/hHhPhY6u9mu04w: bets $2
5k9fvXD9suIgCxU4HLQjTw: calls $2
*** SHOW DOWN ***
bwv/rbH/hHhPhY6u9mu04w: shows [Qs Jd] (a pair of Jacks)
5k9fvXD9suIgCxU4HLQjTw: shows [Jc Qc] (a pair of Jacks)
bwv/rbH/hHhPhY6u9mu04w collected $5.40 from pot
5k9fvXD9suIgCxU4HLQjTw collected $5.35 from pot
*** SUMMARY ***
Total pot $11.25 | Rake $0.50
Board [3s Jh 6h 5c 2h]
Seat 1: 5k9fvXD9suIgCxU4HLQjTw (button) showed [Jc Qc] and won ($5.35) with a pair of Jacks
Seat 2: UrcnkQOiLVk8BlKDPJSy7Q (small blind) folded before Flop
Seat 3: aTkyjTh3w5YLWiIERupZOA (big blind) folded on the Flop
Seat 4: bwv/rbH/hHhPhY6u9mu04w showed [Qs Jd] and won ($5.40) with a pair of Jacks
Seat 5: mSD1pginDsyHG5PDfqzphw folded before Flop (didn't bet)
Seat 6: +k7T5ocke8UwavtgUHm+Cg folded before Flop (didn't bet)
Seat 7: IDtNLR9uFCDdjNsJWMHA5Q folded before Flop (didn't bet)
Seat 8: a4JDWmpFQkL10XfAyuF51A folded before Flop (didn't bet)
Seat 9: YzeKFbJVLmJGTgNH3ySQlw folded on the Flop



PokerStars Game #59940414244:  Hold'em No Limit ($0.25/$0.50) - 2009/07/01 1:05:57 ET
Table 'tYh970kmVfYS0gXPT/XtoQ' 2-max Seat #2 is the button
Seat 1: mW7WbnOUOr5szbwJvGciAA ($30.65 in chips)
Seat 2: dokz3oqYBKI5gNELbiWhbQ ($20.80 in chips)
dokz3oqYBKI5gNELbiWhbQ: posts small blind $0.25
mW7WbnOUOr5szbwJvGciAA: posts big blind $0.50
*** HOLE CARDS ***
dokz3oqYBKI5gNELbiWhbQ: folds
mW7WbnOUOr5szbwJvGciAA collected $0.50 from pot
*** SUMMARY ***
Total pot $0.50 | Rake $0
Seat 1: mW7WbnOUOr5szbwJvGciAA (big blind) collected ($0.50)
Seat 2: dokz3oqYBKI5gNELbiWhbQ (button) (small blind) folded before Flop



PokerStars Game #59940414420:  Hold'em No Limit ($0.25/$0.50) - 2009/07/01 1:05:58 ET
Table 'BCN5su+SsXiy1zRMJi0SJw' 6-max Seat #5 is the button
Seat 1: GxXV09ciXaOxyY2H5aMIIw ($41.55 in chips)
Seat 2: oU2kDCkT/gilYbHWrg7D8w ($40.10 in chips)
Seat 4: 4QfsCWthT/vSLirorNXqtg ($50 in chips)
Seat 5: IBNygaT1aa9Z1uPdJJilwA ($52.15 in chips)
Seat 6: b2symlOdL7+0c9Pj4N/KlA ($60.35 in chips)
b2symlOdL7+0c9Pj4N/KlA: posts small blind $0.25
GxXV09ciXaOxyY2H5aMIIw: posts big blind $0.50
of9mtXiD8G4Nx5p7hCbgqQ: sits out
*** HOLE CARDS ***
oU2kDCkT/gilYbHWrg7D8w: calls $0.50
4QfsCWthT/vSLirorNXqtg: folds
IBNygaT1aa9Z1uPdJJilwA: folds
b2symlOdL7+0c9Pj4N/KlA: folds
GxXV09ciXaOxyY2H5aMIIw: checks
*** FLOP *** [4d 2h 7h]
GxXV09ciXaOxyY2H5aMIIw: checks
oU2kDCkT/gilYbHWrg7D8w: bets $1.20
GxXV09ciXaOxyY2H5aMIIw: folds
oU2kDCkT/gilYbHWrg7D8w collected $1.20 from pot
oU2kDCkT/gilYbHWrg7D8w: doesn't show hand
*** SUMMARY ***
Total pot $1.25 | Rake $0.05
Board [4d 2h 7h]
Seat 1: GxXV09ciXaOxyY2H5aMIIw (big blind) folded on the Flop
Seat 2: oU2kDCkT/gilYbHWrg7D8w collected ($1.20)
Seat 4: 4QfsCWthT/vSLirorNXqtg folded before Flop (didn't bet)
Seat 5: IBNygaT1aa9Z1uPdJJilwA (button) folded before Flop (didn't bet)
Seat 6: b2symlOdL7+0c9Pj4N/KlA (small blind) folded before Flop



PokerStars Game #59940415344:  Hold'em No Limit ($0.25/$0.50) - 2009/07/01 1:05:59 ET
Table '0eJtgVAXVvBgncFdcUpXcQ' 2-max Seat #1 is the button
Seat 1: Ag6DvxX4vbRheqsv2zXKTQ ($44.20 in chips)
Seat 2: KMc4R+K9ao4Ur3rF7NGe6Q ($12 in chips)
Ag6DvxX4vbRheqsv2zXKTQ: posts small blind $0.25
KMc4R+K9ao4Ur3rF7NGe6Q: posts big blind $0.50
*** HOLE CARDS ***
Ag6DvxX4vbRheqsv2zXKTQ: calls $0.25
KMc4R+K9ao4Ur3rF7NGe6Q: checks
*** FLOP *** [9c 9d 6s]
KMc4R+K9ao4Ur3rF7NGe6Q: bets $1
Ag6DvxX4vbRheqsv2zXKTQ: folds
KMc4R+K9ao4Ur3rF7NGe6Q collected $0.95 from pot
KMc4R+K9ao4Ur3rF7NGe6Q: doesn't show hand
*** SUMMARY ***
Total pot $1 | Rake $0.05
Board [9c 9d 6s]
Seat 1: Ag6DvxX4vbRheqsv2zXKTQ (button) (small blind) folded on the Flop
Seat 2: KMc4R+K9ao4Ur3rF7NGe6Q (big blind) collected ($0.95)



PokerStars Game #59940416192:  Hold'em No Limit ($0.25/$0.50) - 2009/07/01 1:06:01 ET
Table '5EmHi+fnatGQQShcNmzOZQ' 6-max Seat #4 is the button
Seat 1: My8WkRtGx5FW6rJ1I4R3hg ($16.45 in chips)
Seat 2: bfFjgAtIoAI+pUxUwFt3aQ ($47.25 in chips)
Seat 4: 1b+2BbjMN8qhR1WPqdE9VQ ($66.05 in chips)
Seat 5: kxPhs4ePFqMy52CInAJ2aw ($95.85 in chips)
Seat 6: 686aeHikcJlgKkSuIFdcXQ ($133.30 in chips)
kxPhs4ePFqMy52CInAJ2aw: posts small blind $0.25
686aeHikcJlgKkSuIFdcXQ: posts big blind $0.50
*** HOLE CARDS ***
TjmTe3bhs9dFz5gXX9x7Lw leaves the table
My8WkRtGx5FW6rJ1I4R3hg: folds
bfFjgAtIoAI+pUxUwFt3aQ: folds
1b+2BbjMN8qhR1WPqdE9VQ: folds
1mYbhL8CU/QYqfVmFcaHDQ joins the table at seat #3
kxPhs4ePFqMy52CInAJ2aw: raises $1.50 to $2
686aeHikcJlgKkSuIFdcXQ: calls $1.50
*** FLOP *** [2d Jd 7h]
kxPhs4ePFqMy52CInAJ2aw: checks
686aeHikcJlgKkSuIFdcXQ: bets $3
kxPhs4ePFqMy52CInAJ2aw: folds
686aeHikcJlgKkSuIFdcXQ collected $3.80 from pot
*** SUMMARY ***
Total pot $4 | Rake $0.20
Board [2d Jd 7h]
Seat 1: My8WkRtGx5FW6rJ1I4R3hg folded before Flop (didn't bet)
Seat 2: bfFjgAtIoAI+pUxUwFt3aQ folded before Flop (didn't bet)
Seat 4: 1b+2BbjMN8qhR1WPqdE9VQ (button) folded before Flop (didn't bet)
Seat 5: kxPhs4ePFqMy52CInAJ2aw (small blind) folded on the Flop
Seat 6: 686aeHikcJlgKkSuIFdcXQ (big blind) collected ($3.80)



PokerStars Game #59940418868:  Hold'em No Limit ($0.25/$0.50) - 2009/07/01 1:06:05 ET
Table 'E7bWJ45aoFXRpyRv2gw+Ig' 2-max Seat #1 is the button
Seat 1: FRkiRasEGlHUeLrEl+k/nA ($59 in chips)
Seat 2: 3Wro85I7472vJ4Wkpneo9A ($128.70 in chips)
FRkiRasEGlHUeLrEl+k/nA: posts small blind $0.25
3Wro85I7472vJ4Wkpneo9A: posts big blind $0.50
*** HOLE CARDS ***
FRkiRasEGlHUeLrEl+k/nA: folds
3Wro85I7472vJ4Wkpneo9A collected $0.50 from pot
3Wro85I7472vJ4Wkpneo9A: doesn't show hand
*** SUMMARY ***
Total pot $0.50 | Rake $0
Seat 1: FRkiRasEGlHUeLrEl+k/nA (button) (small blind) folded before Flop
Seat 2: 3Wro85I7472vJ4Wkpneo9A (big blind) collected ($0.50)



PokerStars Game #59940419380:  Hold'em No Limit ($0.25/$0.50) - 2009/07/01 1:06:06 ET
Table 'MJxeZCzYELxiIsyUZyT0jw' 6-max Seat #4 is the button
Seat 1: +Pf9jTVizYlIo+woPvptfA ($50 in chips)
Seat 2: t3GiVMzqA9Svgr5Uol32cQ ($38.10 in chips)
Seat 4: alGiiQP/wwtYnfuXII+sgw ($64.35 in chips)
Seat 5: 3jvoOXNtXE90w2BdfNZwZQ ($50 in chips)
Seat 6: c0n4hrn20AML9qzyFC2E8Q ($45 in chips)
3jvoOXNtXE90w2BdfNZwZQ: posts small blind $0.25
c0n4hrn20AML9qzyFC2E8Q: posts big blind $0.50
sIG4mp8tZEI+W4nKZNkkQA: sits out
*** HOLE CARDS ***
+Pf9jTVizYlIo+woPvptfA: folds
t3GiVMzqA9Svgr5Uol32cQ: calls $0.50
alGiiQP/wwtYnfuXII+sgw: folds
3jvoOXNtXE90w2BdfNZwZQ: calls $0.25
c0n4hrn20AML9qzyFC2E8Q: raises $1.50 to $2
t3GiVMzqA9Svgr5Uol32cQ: calls $1.50
3jvoOXNtXE90w2BdfNZwZQ: folds
*** FLOP *** [Jd Jc 9h]
c0n4hrn20AML9qzyFC2E8Q: bets $2
t3GiVMzqA9Svgr5Uol32cQ: calls $2
*** TURN *** [Jd Jc 9h] [4c]
c0n4hrn20AML9qzyFC2E8Q: checks
t3GiVMzqA9Svgr5Uol32cQ: checks
*** RIVER *** [Jd Jc 9h 4c] [6d]
c0n4hrn20AML9qzyFC2E8Q: bets $6
t3GiVMzqA9Svgr5Uol32cQ: calls $6
*** SHOW DOWN ***
c0n4hrn20AML9qzyFC2E8Q: shows [Ks Jh] (three of a kind, Jacks)
t3GiVMzqA9Svgr5Uol32cQ: shows [8s 8d] (two pair, Jacks and Eights)
c0n4hrn20AML9qzyFC2E8Q collected $19.50 from pot
*** SUMMARY ***
Total pot $20.50 | Rake $1
Board [Jd Jc 9h 4c 6d]
Seat 1: +Pf9jTVizYlIo+woPvptfA folded before Flop (didn't bet)
Seat 2: t3GiVMzqA9Svgr5Uol32cQ showed [8s 8d] and lost with two pair, Jacks and Eights
Seat 4: alGiiQP/wwtYnfuXII+sgw (button) folded before Flop (didn't bet)
Seat 5: 3jvoOXNtXE90w2BdfNZwZQ (small blind) folded before Flop
Seat 6: c0n4hrn20AML9qzyFC2E8Q (big blind) showed [Ks Jh] and won ($19.50) with three of a kind, Jacks



PokerStars Game #59940420896:  Hold'em No Limit ($0.25/$0.50) - 2009/07/01 1:06:09 ET
Table 'tYh970kmVfYS0gXPT/XtoQ' 2-max Seat #1 is the button
Seat 1: mW7WbnOUOr5szbwJvGciAA ($30.90 in chips)
Seat 2: dokz3oqYBKI5gNELbiWhbQ ($20.55 in chips)
mW7WbnOUOr5szbwJvGciAA: posts small blind $0.25
dokz3oqYBKI5gNELbiWhbQ: posts big blind $0.50
*** HOLE CARDS ***
mW7WbnOUOr5szbwJvGciAA: raises $0.50 to $1
dokz3oqYBKI5gNELbiWhbQ: raises $4 to $5
mW7WbnOUOr5szbwJvGciAA: raises $25.90 to $30.90 and is all-in
dokz3oqYBKI5gNELbiWhbQ: calls $15.55 and is all-in
*** FLOP *** [Kc 4d 2h]
*** TURN *** [Kc 4d 2h] [8h]
*** RIVER *** [Kc 4d 2h 8h] [3h]
*** SHOW DOWN ***
dokz3oqYBKI5gNELbiWhbQ: shows [Jd Ah] (high card Ace)
mW7WbnOUOr5szbwJvGciAA: shows [7s 7d] (a pair of Sevens)
mW7WbnOUOr5szbwJvGciAA collected $40.60 from pot
*** SUMMARY ***
Total pot $41.10 | Rake $0.50
Board [Kc 4d 2h 8h 3h]
Seat 1: mW7WbnOUOr5szbwJvGciAA (button) (small blind) showed [7s 7d] and won ($40.60) with a pair of Sevens
Seat 2: dokz3oqYBKI5gNELbiWhbQ (big blind) showed [Jd Ah] and lost with high card Ace



PokerStars Game #59940421352:  Hold'em No Limit ($0.25/$0.50) - 2009/07/01 1:06:10 ET
Table '0eJtgVAXVvBgncFdcUpXcQ' 2-max Seat #2 is the button
Seat 1: Ag6DvxX4vbRheqsv2zXKTQ ($43.70 in chips)
Seat 2: KMc4R+K9ao4Ur3rF7NGe6Q ($12.45 in chips)
KMc4R+K9ao4Ur3rF7NGe6Q: posts small blind $0.25
Ag6DvxX4vbRheqsv2zXKTQ: posts big blind $0.50
*** HOLE CARDS ***
KMc4R+K9ao4Ur3rF7NGe6Q: calls $0.25
Ag6DvxX4vbRheqsv2zXKTQ: checks
*** FLOP *** [Ac Qh As]
Ag6DvxX4vbRheqsv2zXKTQ: checks
KMc4R+K9ao4Ur3rF7NGe6Q: checks
*** TURN *** [Ac Qh As] [4c]
Ag6DvxX4vbRheqsv2zXKTQ: checks
KMc4R+K9ao4Ur3rF7NGe6Q: checks
*** RIVER *** [Ac Qh As 4c] [5s]
Ag6DvxX4vbRheqsv2zXKTQ: checks
KMc4R+K9ao4Ur3rF7NGe6Q: bets $0.50
Ag6DvxX4vbRheqsv2zXKTQ: folds
KMc4R+K9ao4Ur3rF7NGe6Q collected $0.95 from pot
KMc4R+K9ao4Ur3rF7NGe6Q: doesn't show hand
*** SUMMARY ***
Total pot $1 | Rake $0.05
Board [Ac Qh As 4c 5s]
Seat 1: Ag6DvxX4vbRheqsv2zXKTQ (big blind) folded on the River
Seat 2: KMc4R+K9ao4Ur3rF7NGe6Q (button) (small blind) collected ($0.95)



PokerStars Game #59940421296:  Hold'em No Limit ($0.25/$0.50) - 2009/07/01 1:06:10 ET
Table 'QOgaEqMcJ73pcUMMxoisUg' 6-max Seat #3 is the button
Seat 1: lxIzoHy0RnkfFSODHC2liw ($53.35 in chips)
Seat 2: oqOqoO2AyCZenUghCxMDxw ($50 in chips)
Seat 3: Rt6KgtZ8YaJoTc3FPim00w ($53.75 in chips)
Seat 4: zAcsDhG/T128Vn7XGVSgKg ($50.25 in chips)
Seat 5: 6vNxrjjCl6FwfaaymM9jjg ($21.75 in chips)
zAcsDhG/T128Vn7XGVSgKg: posts small blind $0.25
6vNxrjjCl6FwfaaymM9jjg: posts big blind $0.50
oqOqoO2AyCZenUghCxMDxw: posts big blind $0.50
*** HOLE CARDS ***
lxIzoHy0RnkfFSODHC2liw: folds
oqOqoO2AyCZenUghCxMDxw: raises $1 to $1.50
AdS8BJMOheS01zjCDfPMFg joins the table at seat #6
Rt6KgtZ8YaJoTc3FPim00w: folds
zAcsDhG/T128Vn7XGVSgKg: folds
6vNxrjjCl6FwfaaymM9jjg: calls $1
*** FLOP *** [7s Ah 5c]
6vNxrjjCl6FwfaaymM9jjg: checks
oqOqoO2AyCZenUghCxMDxw: bets $1.50
6vNxrjjCl6FwfaaymM9jjg: folds
oqOqoO2AyCZenUghCxMDxw collected $3.10 from pot
*** SUMMARY ***
Total pot $3.25 | Rake $0.15
Board [7s Ah 5c]
Seat 1: lxIzoHy0RnkfFSODHC2liw folded before Flop (didn't bet)
Seat 2: oqOqoO2AyCZenUghCxMDxw collected ($3.10)
Seat 3: Rt6KgtZ8YaJoTc3FPim00w (button) folded before Flop (didn't bet)
Seat 4: zAcsDhG/T128Vn7XGVSgKg (small blind) folded before Flop
Seat 5: 6vNxrjjCl6FwfaaymM9jjg (big blind) folded on the Flop



PokerStars Game #59940422214:  Hold'em No Limit ($0.25/$0.50) - 2009/07/01 1:06:11 ET
Table 'WlCrrUP9MxwySQN5fzLFBQ' 2-max Seat #1 is the button
Seat 1: U7xFsli2XvMiGlVDxk8a/Q ($12.55 in chips)
Seat 2: JTT5TsRNqs6npc7cgI4X/w ($19.50 in chips)
U7xFsli2XvMiGlVDxk8a/Q: posts small blind $0.25
JTT5TsRNqs6npc7cgI4X/w: posts big blind $0.50
*** HOLE CARDS ***
U7xFsli2XvMiGlVDxk8a/Q: calls $0.25
JTT5TsRNqs6npc7cgI4X/w: checks
*** FLOP *** [Ks As 4c]
JTT5TsRNqs6npc7cgI4X/w: checks
U7xFsli2XvMiGlVDxk8a/Q: checks
*** TURN *** [Ks As 4c] [Th]
JTT5TsRNqs6npc7cgI4X/w: checks
U7xFsli2XvMiGlVDxk8a/Q: bets $1
JTT5TsRNqs6npc7cgI4X/w: folds
U7xFsli2XvMiGlVDxk8a/Q collected $0.95 from pot
U7xFsli2XvMiGlVDxk8a/Q: doesn't show hand
*** SUMMARY ***
Total pot $1 | Rake $0.05
Board [Ks As 4c Th]
Seat 1: U7xFsli2XvMiGlVDxk8a/Q (button) (small blind) collected ($0.95)
Seat 2: JTT5TsRNqs6npc7cgI4X/w (big blind) folded on the Turn



PokerStars Game #59940422942:  Hold'em No Limit ($0.25/$0.50) - 2009/07/01 1:06:12 ET
Table 'c/CRn+68J3Y8KxD5g1ek2Q' 2-max Seat #2 is the button
Seat 1: 46qCyJ6evTkHo9al5sBMNA ($92.55 in chips)
Seat 2: BypVLsYQt3ePFm2xQL/dOA ($274.05 in chips)
BypVLsYQt3ePFm2xQL/dOA: posts small blind $0.25
46qCyJ6evTkHo9al5sBMNA: posts big blind $0.50
*** HOLE CARDS ***
BypVLsYQt3ePFm2xQL/dOA: calls $0.25
46qCyJ6evTkHo9al5sBMNA: raises $1 to $1.50
BypVLsYQt3ePFm2xQL/dOA: calls $1
*** FLOP *** [Kd Qd 5h]
46qCyJ6evTkHo9al5sBMNA: checks
BypVLsYQt3ePFm2xQL/dOA: checks
*** TURN *** [Kd Qd 5h] [5s]
46qCyJ6evTkHo9al5sBMNA: checks
BypVLsYQt3ePFm2xQL/dOA: checks
*** RIVER *** [Kd Qd 5h 5s] [8s]
46qCyJ6evTkHo9al5sBMNA: checks
BypVLsYQt3ePFm2xQL/dOA: bets $2.50
46qCyJ6evTkHo9al5sBMNA: folds
BypVLsYQt3ePFm2xQL/dOA collected $2.85 from pot
BypVLsYQt3ePFm2xQL/dOA: doesn't show hand
*** SUMMARY ***
Total pot $3 | Rake $0.15
Board [Kd Qd 5h 5s 8s]
Seat 1: 46qCyJ6evTkHo9al5sBMNA (big blind) folded on the River
Seat 2: BypVLsYQt3ePFm2xQL/dOA (button) (small blind) collected ($2.85)



PokerStars Game #59940423176:  Hold'em No Limit ($0.25/$0.50) - 2009/07/01 1:06:13 ET
Table 'E7bWJ45aoFXRpyRv2gw+Ig' 2-max Seat #2 is the button
Seat 1: FRkiRasEGlHUeLrEl+k/nA ($58.75 in chips)
Seat 2: 3Wro85I7472vJ4Wkpneo9A ($128.95 in chips)
3Wro85I7472vJ4Wkpneo9A: posts small blind $0.25
FRkiRasEGlHUeLrEl+k/nA: posts big blind $0.50
*** HOLE CARDS ***
3Wro85I7472vJ4Wkpneo9A: calls $0.25
FRkiRasEGlHUeLrEl+k/nA: checks
*** FLOP *** [Jc 9h 8d]
FRkiRasEGlHUeLrEl+k/nA: checks
3Wro85I7472vJ4Wkpneo9A: bets $1
FRkiRasEGlHUeLrEl+k/nA: folds
3Wro85I7472vJ4Wkpneo9A collected $0.95 from pot
3Wro85I7472vJ4Wkpneo9A: doesn't show hand
*** SUMMARY ***
Total pot $1 | Rake $0.05
Board [Jc 9h 8d]
Seat 1: FRkiRasEGlHUeLrEl+k/nA (big blind) folded on the Flop
Seat 2: 3Wro85I7472vJ4Wkpneo9A (button) (small blind) collected ($0.95)



PokerStars Game #59940424162:  Hold'em No Limit ($0.25/$0.50) - 2009/07/01 1:06:14 ET
Table '8BQGgNetI1NOvWeu3gtMNw' 2-max Seat #2 is the button
Seat 1: bypIyrYcAAifLfhZpGlKLA ($97 in chips)
Seat 2: Z4HwehErEwzsv/noQlfUlg ($102.50 in chips)
Z4HwehErEwzsv/noQlfUlg: posts small blind $0.25
bypIyrYcAAifLfhZpGlKLA: posts big blind $0.50
*** HOLE CARDS ***
Z4HwehErEwzsv/noQlfUlg: raises $1.50 to $2
bypIyrYcAAifLfhZpGlKLA: folds
Z4HwehErEwzsv/noQlfUlg collected $1 from pot
Z4HwehErEwzsv/noQlfUlg: doesn't show hand
*** SUMMARY ***
Total pot $1 | Rake $0
Seat 1: bypIyrYcAAifLfhZpGlKLA (big blind) folded before Flop
Seat 2: Z4HwehErEwzsv/noQlfUlg (button) (small blind) collected ($1)



PokerStars Game #59940424482:  Hold'em No Limit ($0.25/$0.50) - 2009/07/01 1:06:15 ET
Table 'fx6MqwfYAj/Rt86hBz2L3Q' 9-max Seat #3 is the button
Seat 1: uw9QayAAxLM3Hb+HR7mSkg ($10.50 in chips)
Seat 2: C3rGXblctNcWI6JYPHhaEg ($22.25 in chips)
Seat 3: iadBi5AEt7gTBXbDSSnMYQ ($56.10 in chips)
Seat 4: 75K2MXwN65Sjfp1yHd50Hg ($8.75 in chips)
Seat 5: iAISe3dVeua8PUn2wwgDHw ($61.25 in chips)
Seat 6: 5k9fvXD9suIgCxU4HLQjTw ($50.75 in chips)
Seat 7: SKnJuWHScqetA/qG5p+wCg ($30 in chips)
Seat 8: JYwJYYV9pM5KWdSiETl8rA ($19.25 in chips)
Seat 9: HZkVla4kK2SI42CVrPZ/ig ($18.30 in chips)
75K2MXwN65Sjfp1yHd50Hg: posts small blind $0.25
iAISe3dVeua8PUn2wwgDHw: posts big blind $0.50
*** HOLE CARDS ***
5k9fvXD9suIgCxU4HLQjTw: folds
SKnJuWHScqetA/qG5p+wCg: folds
JYwJYYV9pM5KWdSiETl8rA: folds
HZkVla4kK2SI42CVrPZ/ig: folds
uw9QayAAxLM3Hb+HR7mSkg: folds
C3rGXblctNcWI6JYPHhaEg: calls $0.50
iadBi5AEt7gTBXbDSSnMYQ: folds
75K2MXwN65Sjfp1yHd50Hg: folds
iAISe3dVeua8PUn2wwgDHw: checks
*** FLOP *** [2d 4d Js]
iAISe3dVeua8PUn2wwgDHw: checks
C3rGXblctNcWI6JYPHhaEg: checks
*** TURN *** [2d 4d Js] [Qd]
iAISe3dVeua8PUn2wwgDHw: bets $0.50
C3rGXblctNcWI6JYPHhaEg: calls $0.50
*** RIVER *** [2d 4d Js Qd] [Qh]
iAISe3dVeua8PUn2wwgDHw: bets $1.50
C3rGXblctNcWI6JYPHhaEg: calls $1.50
*** SHOW DOWN ***
iAISe3dVeua8PUn2wwgDHw: shows [Ts 5d] (a pair of Queens)
C3rGXblctNcWI6JYPHhaEg: shows [As 2c] (two pair, Queens and Deuces)
C3rGXblctNcWI6JYPHhaEg collected $5 from pot
*** SUMMARY ***
Total pot $5.25 | Rake $0.25
Board [2d 4d Js Qd Qh]
Seat 1: uw9QayAAxLM3Hb+HR7mSkg folded before Flop (didn't bet)
Seat 2: C3rGXblctNcWI6JYPHhaEg showed [As 2c] and won ($5) with two pair, Queens and Deuces
Seat 3: iadBi5AEt7gTBXbDSSnMYQ (button) folded before Flop (didn't bet)
Seat 4: 75K2MXwN65Sjfp1yHd50Hg (small blind) folded before Flop
Seat 5: iAISe3dVeua8PUn2wwgDHw (big blind) showed [Ts 5d] and lost with a pair of Queens
Seat 6: 5k9fvXD9suIgCxU4HLQjTw folded before Flop (didn't bet)
Seat 7: SKnJuWHScqetA/qG5p+wCg folded before Flop (didn't bet)
Seat 8: JYwJYYV9pM5KWdSiETl8rA folded before Flop (didn't bet)
Seat 9: HZkVla4kK2SI42CVrPZ/ig folded before Flop (didn't bet)



PokerStars Game #59940425982:  Hold'em No Limit ($0.25/$0.50) - 2009/07/01 1:06:17 ET
Table 'GfL/No5u5PoEnU39lP5pQg' 6-max Seat #1 is the button
Seat 1: 1WUCqNG+p+vfWRTXNu4ljw ($64.50 in chips)
Seat 2: uVwggSetzp7d+eVgowO3vg ($56.50 in chips)
Seat 3: eQXFICMuu3hw6XlcmuVNEA ($21.35 in chips)
Seat 4: r6u7MWSXF30/khcTYkrG9Q ($35.90 in chips)
Seat 5: M1KyQQvVPVuxqTAB8sR/zQ ($51 in chips)
Seat 6: kxPhs4ePFqMy52CInAJ2aw ($48.50 in chips)
uVwggSetzp7d+eVgowO3vg: posts small blind $0.25
eQXFICMuu3hw6XlcmuVNEA: posts big blind $0.50
*** HOLE CARDS ***
r6u7MWSXF30/khcTYkrG9Q: folds
M1KyQQvVPVuxqTAB8sR/zQ: folds
kxPhs4ePFqMy52CInAJ2aw: folds
1WUCqNG+p+vfWRTXNu4ljw: folds
uVwggSetzp7d+eVgowO3vg: folds
eQXFICMuu3hw6XlcmuVNEA collected $0.50 from pot
*** SUMMARY ***
Total pot $0.50 | Rake $0
Seat 1: 1WUCqNG+p+vfWRTXNu4ljw (button) folded before Flop (didn't bet)
Seat 2: uVwggSetzp7d+eVgowO3vg (small blind) folded before Flop
Seat 3: eQXFICMuu3hw6XlcmuVNEA (big blind) collected ($0.50)
Seat 4: r6u7MWSXF30/khcTYkrG9Q folded before Flop (didn't bet)
Seat 5: M1KyQQvVPVuxqTAB8sR/zQ folded before Flop (didn't bet)
Seat 6: kxPhs4ePFqMy52CInAJ2aw folded before Flop (didn't bet)



PokerStars Game #59940426174:  Hold'em No Limit ($0.25/$0.50) - 2009/07/01 1:06:18 ET
Table 'ErOuyGLI5PT3G5MnpHgC/gQOgaEqMcJ73pcUMMxoisUg Seat #3 is the button
Seat 2: pciZn00ZDk4BVBMTTMcNVQ ($28 in chips)
Seat 3: xZCXQSXlrZkp3pZizzVXCw ($52 in chips)
Seat 4: 3UmXLy3GfjC3EkOebduerQ ($50.25 in chips)
Seat 5: JwvquocWfhTVApN5t47LgA ($64.65 in chips)
Seat 6: zE9cVigS2nW/Ljy4K4bUQA ($31.60 in chips)
Seat 7: 90Wb75h3W1BRpbqVnuk8gw ($63.60 in chips)
Seat 8: g4k0NXISyLCqaSWZDBjfEg ($50.75 in chips)
Seat 9: J0W5D97jl5VLky+IoPvDeA ($51.40 in chips)
3UmXLy3GfjC3EkOebduerQ: posts small blind $0.25
JwvquocWfhTVApN5t47LgA: posts big blind $0.50
eBrej2jnlUCs/JgxFCRn2g: sits out
*** HOLE CARDS ***
zE9cVigS2nW/Ljy4K4bUQA: folds
90Wb75h3W1BRpbqVnuk8gw: folds
g4k0NXISyLCqaSWZDBjfEg: folds
J0W5D97jl5VLky+IoPvDeA: calls $0.50
pciZn00ZDk4BVBMTTMcNVQ: folds
xZCXQSXlrZkp3pZizzVXCw: folds
3UmXLy3GfjC3EkOebduerQ: calls $0.25
JwvquocWfhTVApN5t47LgA: checks
*** FLOP *** [5s 4h 5c]
3UmXLy3GfjC3EkOebduerQ: checks
JwvquocWfhTVApN5t47LgA: checks
J0W5D97jl5VLky+IoPvDeA: bets $2
3UmXLy3GfjC3EkOebduerQ: folds
JwvquocWfhTVApN5t47LgA: folds
J0W5D97jl5VLky+IoPvDeA collected $1.45 from pot
*** SUMMARY ***
Total pot $1.50 | Rake $0.05
Board [5s 4h 5c]
Seat 2: pciZn00ZDk4BVBMTTMcNVQ folded before Flop (didn't bet)
Seat 3: xZCXQSXlrZkp3pZizzVXCw (button) folded before Flop (didn't bet)
Seat 4: 3UmXLy3GfjC3EkOebduerQ (small blind) folded on the Flop
Seat 5: JwvquocWfhTVApN5t47LgA (big blind) folded on the Flop
Seat 6: zE9cVigS2nW/Ljy4K4bUQA folded before Flop (didn't bet)
Seat 7: 90Wb75h3W1BRpbqVnuk8gw folded before Flop (didn't bet)
Seat 8: g4k0NXISyLCqaSWZDBjfEg folded before Flop (didn't bet)
Seat 9: J0W5D97jl5VLky+IoPvDeA collected ($1.45)



PokerStars Game #59940426114:  Hold'em No Limit ($0.25/$0.50) - 2009/07/01 1:06:18 ET
Table 'kgbJRsxfv64KrErDRBAkcw' 6-max Seat #3 is the button
Seat 1: VamsyhlFzXGF6/ydo0BHeA ($34.50 in chips)
Seat 2: AdS8BJMOheS01zjCDfPMFg ($49.20 in chips)
Seat 3: c4MNIaIyPMOMxrgT8FT5nA ($134.80 in chips)
Seat 5: eUBBn2R56C1IQ6Cs/vitwg ($62.95 in chips)
Seat 6: 1b+2BbjMN8qhR1WPqdE9VQ ($52.40 in chips)
eUBBn2R56C1IQ6Cs/vitwg: posts small blind $0.25
1b+2BbjMN8qhR1WPqdE9VQ: posts big blind $0.50
*** HOLE CARDS ***
VamsyhlFzXGF6/ydo0BHeA: folds
AdS8BJMOheS01zjCDfPMFg: folds
c4MNIaIyPMOMxrgT8FT5nA: raises $2 to $2.50
eUBBn2R56C1IQ6Cs/vitwg: folds
1b+2BbjMN8qhR1WPqdE9VQ: folds
c4MNIaIyPMOMxrgT8FT5nA collected $1.25 from pot
c4MNIaIyPMOMxrgT8FT5nA: doesn't show hand
*** SUMMARY ***
Total pot $1.25 | Rake $0
Seat 1: VamsyhlFzXGF6/ydo0BHeA folded before Flop (didn't bet)
Seat 2: AdS8BJMOheS01zjCDfPMFg folded before Flop (didn't bet)
Seat 3: c4MNIaIyPMOMxrgT8FT5nA (button) collected ($1.25)
Seat 5: eUBBn2R56C1IQ6Cs/vitwg (small blind) folded before Flop
Seat 6: 1b+2BbjMN8qhR1WPqdE9VQ (big blind) folded before Flop



PokerStars Game #59940427358:  Hold'em No Limit ($0.25/$0.50) - 2009/07/01 1:06:20 ET
Table '37qXEp3oe+er5q4CZip9eQ' 6-max Seat #3 is the button
Seat 2: LvH4G7n+QSjT6NDaD3cREA ($57.05 in chips)
Seat 3: Rt6KgtZ8YaJoTc3FPim00w ($109.45 in chips)
Seat 4: XsmE8nXMAAMFJbWaJTmHFw ($39.35 in chips)
Seat 5: VOmI0x4dDPnTESZd5B4d1Q ($43.25 in chips)
Seat 6: N50kln4negd8q7Mmoz1j4g ($16.60 in chips)
XsmE8nXMAAMFJbWaJTmHFw: posts small blind $0.25
VOmI0x4dDPnTESZd5B4d1Q: posts big blind $0.50
*** HOLE CARDS ***
N50kln4negd8q7Mmoz1j4g: folds
LvH4G7n+QSjT6NDaD3cREA: folds
Rt6KgtZ8YaJoTc3FPim00w: raises $1 to $1.50
XsmE8nXMAAMFJbWaJTmHFw said, "I had a great folding hand"
XsmE8nXMAAMFJbWaJTmHFw: folds
lxIzoHy0RnkfFSODHC2liw joins the table at seat #1
VOmI0x4dDPnTESZd5B4d1Q: folds
Rt6KgtZ8YaJoTc3FPim00w collected $1.25 from pot
*** SUMMARY ***
Total pot $1.25 | Rake $0
Seat 2: LvH4G7n+QSjT6NDaD3cREA folded before Flop (didn't bet)
Seat 3: Rt6KgtZ8YaJoTc3FPim00w (button) collected ($1.25)
Seat 4: XsmE8nXMAAMFJbWaJTmHFw (small blind) folded before Flop
Seat 5: VOmI0x4dDPnTESZd5B4d1Q (big blind) folded before Flop
Seat 6: N50kln4negd8q7Mmoz1j4g folded before Flop (didn't bet)



PokerStars Game #59940427406:  Hold'em No Limit ($0.25/$0.50) - 2009/07/01 1:06:20 ET
Table 'EiNh8p/wGJ1FP575iMFnqg' 9-max Seat #8 is the button
Seat 1: r3ZqM1Mi0W3y4hOdssE+Sg ($44.85 in chips)
Seat 2: 8ehL7qlZzjgUh2H35iiWLw ($54.15 in chips)
Seat 3: ymLPoEIl7UL3TvZYmnadxQ ($54.55 in chips)
Seat 4: cMzaiXAM/ZAdNaEUu+LqhA ($54.95 in chips)
Seat 5: M+7+BTmX5vZatHVuoRB1nA ($80.45 in chips)
Seat 6: 3UmXLy3GfjC3EkOebduerQ ($61.60 in chips)
Seat 7: 997ViqAtWn1FPjJqcffwcA ($50 in chips)
Seat 8: mSD1pginDsyHG5PDfqzphw ($10 in chips)
Seat 9: NnQCepdIR/AOUQn1yhYx6Q ($21.75 in chips)
NnQCepdIR/AOUQn1yhYx6Q: posts small blind $0.25
r3ZqM1Mi0W3y4hOdssE+Sg: posts big blind $0.50
*** HOLE CARDS ***
8ehL7qlZzjgUh2H35iiWLw: folds
ymLPoEIl7UL3TvZYmnadxQ: calls $0.50
cMzaiXAM/ZAdNaEUu+LqhA: folds
M+7+BTmX5vZatHVuoRB1nA: folds
3UmXLy3GfjC3EkOebduerQ: folds
997ViqAtWn1FPjJqcffwcA: folds
mSD1pginDsyHG5PDfqzphw: folds
NnQCepdIR/AOUQn1yhYx6Q: folds
r3ZqM1Mi0W3y4hOdssE+Sg: checks
*** FLOP *** [6c 2d 5c]
r3ZqM1Mi0W3y4hOdssE+Sg: checks
ymLPoEIl7UL3TvZYmnadxQ: checks
*** TURN *** [6c 2d 5c] [Jd]
r3ZqM1Mi0W3y4hOdssE+Sg: checks
ymLPoEIl7UL3TvZYmnadxQ: bets $1
r3ZqM1Mi0W3y4hOdssE+Sg: folds
ymLPoEIl7UL3TvZYmnadxQ collected $1.20 from pot
ymLPoEIl7UL3TvZYmnadxQ: doesn't show hand
*** SUMMARY ***
Total pot $1.25 | Rake $0.05
Board [6c 2d 5c Jd]
Seat 1: r3ZqM1Mi0W3y4hOdssE+Sg (big blind) folded on the Turn
Seat 2: 8ehL7qlZzjgUh2H35iiWLw folded before Flop (didn't bet)
Seat 3: ymLPoEIl7UL3TvZYmnadxQ collected ($1.20)
Seat 4: cMzaiXAM/ZAdNaEUu+LqhA folded before Flop (didn't bet)
Seat 5: M+7+BTmX5vZatHVuoRB1nA folded before Flop (didn't bet)
Seat 6: 3UmXLy3GfjC3EkOebduerQ folded before Flop (didn't bet)
Seat 7: 997ViqAtWn1FPjJqcffwcA folded before Flop (didn't bet)
Seat 8: mSD1pginDsyHG5PDfqzphw (button) folded before Flop (didn't bet)
Seat 9: NnQCepdIR/AOUQn1yhYx6Q (small blind) folded before Flop



PokerStars Game #59940429012:  Hold'em No Limit ($0.25/$0.50) - 2009/07/01 1:06:23 ET
Table 'BCN5su+SsXiy1zRMJi0SJw' 6-max Seat #6 is the button
Seat 1: GxXV09ciXaOxyY2H5aMIIw ($41.05 in chips)
Seat 2: oU2kDCkT/gilYbHWrg7D8w ($40.80 in chips)
Seat 4: 4QfsCWthT/vSLirorNXqtg ($50 in chips)
Seat 5: IBNygaT1aa9Z1uPdJJilwA ($52.15 in chips)
Seat 6: b2symlOdL7+0c9Pj4N/KlA ($60.10 in chips)
GxXV09ciXaOxyY2H5aMIIw: posts small blind $0.25
oU2kDCkT/gilYbHWrg7D8w: posts big blind $0.50
of9mtXiD8G4Nx5p7hCbgqQ: sits out
*** HOLE CARDS ***
4QfsCWthT/vSLirorNXqtg: folds
IBNygaT1aa9Z1uPdJJilwA: folds
b2symlOdL7+0c9Pj4N/KlA: folds
GxXV09ciXaOxyY2H5aMIIw: folds
oU2kDCkT/gilYbHWrg7D8w collected $0.50 from pot
oU2kDCkT/gilYbHWrg7D8w: doesn't show hand
*** SUMMARY ***
Total pot $0.50 | Rake $0
Seat 1: GxXV09ciXaOxyY2H5aMIIw (small blind) folded before Flop
Seat 2: oU2kDCkT/gilYbHWrg7D8w (big blind) collected ($0.50)
Seat 4: 4QfsCWthT/vSLirorNXqtg folded before Flop (didn't bet)
Seat 5: IBNygaT1aa9Z1uPdJJilwA folded before Flop (didn't bet)
Seat 6: b2symlOdL7+0c9Pj4N/KlA (button) folded before Flop (didn't bet)



PokerStars Game #59940430218:  Hold'em No Limit ($0.25/$0.50) - 2009/07/01 1:06:24 ET
Table '0eJtgVAXVvBgncFdcUpXcQ' 2-max Seat #1 is the button
Seat 1: Ag6DvxX4vbRheqsv2zXKTQ ($43.20 in chips)
Seat 2: KMc4R+K9ao4Ur3rF7NGe6Q ($12.90 in chips)
Ag6DvxX4vbRheqsv2zXKTQ: posts small blind $0.25
KMc4R+K9ao4Ur3rF7NGe6Q: posts big blind $0.50
*** HOLE CARDS ***
Ag6DvxX4vbRheqsv2zXKTQ: raises $1 to $1.50
KMc4R+K9ao4Ur3rF7NGe6Q: folds
Ag6DvxX4vbRheqsv2zXKTQ collected $1 from pot
*** SUMMARY ***
Total pot $1 | Rake $0
Seat 1: Ag6DvxX4vbRheqsv2zXKTQ (button) (small blind) collected ($1)
Seat 2: KMc4R+K9ao4Ur3rF7NGe6Q (big blind) folded before Flop



PokerStars Game #59940431526:  Hold'em No Limit ($0.25/$0.50) - 2009/07/01 1:06:27 ET
Table '8BQGgNetI1NOvWeu3gtMNw' 2-max Seat #1 is the button
Seat 1: bypIyrYcAAifLfhZpGlKLA ($96.50 in chips)
Seat 2: Z4HwehErEwzsv/noQlfUlg ($103 in chips)
bypIyrYcAAifLfhZpGlKLA: posts small blind $0.25
Z4HwehErEwzsv/noQlfUlg: posts big blind $0.50
*** HOLE CARDS ***
bypIyrYcAAifLfhZpGlKLA: raises $1 to $1.50
Z4HwehErEwzsv/noQlfUlg: folds
bypIyrYcAAifLfhZpGlKLA collected $1 from pot
bypIyrYcAAifLfhZpGlKLA: doesn't show hand
*** SUMMARY ***
Total pot $1 | Rake $0
Seat 1: bypIyrYcAAifLfhZpGlKLA (button) (small blind) collected ($1)
Seat 2: Z4HwehErEwzsv/noQlfUlg (big blind) folded before Flop



PokerStars Game #59940431462:  Hold'em No Limit ($0.25/$0.50) - 2009/07/01 1:06:27 ET
Table 'WlCrrUP9MxwySQN5fzLFBQ' 2-max Seat #2 is the button
Seat 1: U7xFsli2XvMiGlVDxk8a/Q ($13 in chips)
Seat 2: JTT5TsRNqs6npc7cgI4X/w ($19 in chips)
JTT5TsRNqs6npc7cgI4X/w: posts small blind $0.25
U7xFsli2XvMiGlVDxk8a/Q: posts big blind $0.50
*** HOLE CARDS ***
JTT5TsRNqs6npc7cgI4X/w: calls $0.25
U7xFsli2XvMiGlVDxk8a/Q: raises $12.50 to $13 and is all-in
JTT5TsRNqs6npc7cgI4X/w: folds
U7xFsli2XvMiGlVDxk8a/Q collected $1 from pot
U7xFsli2XvMiGlVDxk8a/Q: doesn't show hand
*** SUMMARY ***
Total pot $1 | Rake $0
Seat 1: U7xFsli2XvMiGlVDxk8a/Q (big blind) collected ($1)
Seat 2: JTT5TsRNqs6npc7cgI4X/w (button) (small blind) folded before Flop



PokerStars Game #59940431750:  Hold'em No Limit ($0.25/$0.50) - 2009/07/01 1:06:27 ET
Table 'NCiXr0d5CEKBQr/cZgLhbA' 9-max Seat #5 is the button
Seat 1: pFtzb1sR4b0d1aw6aIRgDg ($50 in chips)
Seat 2: ulxuJchBV9iguXg0FUonfg ($19.40 in chips)
Seat 3: xZCXQSXlrZkp3pZizzVXCw ($51.95 in chips)
Seat 4: 5k9fvXD9suIgCxU4HLQjTw ($52.45 in chips)
Seat 5: zE9cVigS2nW/Ljy4K4bUQA ($65.10 in chips)
Seat 6: SKnJuWHScqetA/qG5p+wCg ($32.25 in chips)
Seat 7: M+7+BTmX5vZatHVuoRB1nA ($52.75 in chips)
Seat 8: 1MJUKc3cc0QmUoz1JZLR2w ($64.05 in chips)
Seat 9: 4WLZvqBn5qv5tds5kt5A1Q ($40.15 in chips)
SKnJuWHScqetA/qG5p+wCg: posts small blind $0.25
M+7+BTmX5vZatHVuoRB1nA: posts big blind $0.50
*** HOLE CARDS ***
zE9cVigS2nW/Ljy4K4bUQA said, "ty"
1MJUKc3cc0QmUoz1JZLR2w: folds
4WLZvqBn5qv5tds5kt5A1Q: folds
pFtzb1sR4b0d1aw6aIRgDg: folds
ulxuJchBV9iguXg0FUonfg: folds
xZCXQSXlrZkp3pZizzVXCw: folds
SKnJuWHScqetA/qG5p+wCg said, "no ten river?"
5k9fvXD9suIgCxU4HLQjTw: folds
zE9cVigS2nW/Ljy4K4bUQA: folds
SKnJuWHScqetA/qG5p+wCg said, "strange game"
SKnJuWHScqetA/qG5p+wCg: raises $0.50 to $1
M+7+BTmX5vZatHVuoRB1nA: folds
SKnJuWHScqetA/qG5p+wCg collected $1 from pot
*** SUMMARY ***
Total pot $1 | Rake $0
Seat 1: pFtzb1sR4b0d1aw6aIRgDg folded before Flop (didn't bet)
Seat 2: ulxuJchBV9iguXg0FUonfg folded before Flop (didn't bet)
Seat 3: xZCXQSXlrZkp3pZizzVXCw folded before Flop (didn't bet)
Seat 4: 5k9fvXD9suIgCxU4HLQjTw folded before Flop (didn't bet)
Seat 5: zE9cVigS2nW/Ljy4K4bUQA (button) folded before Flop (didn't bet)
Seat 6: SKnJuWHScqetA/qG5p+wCg (small blind) collected ($1)
Seat 7: M+7+BTmX5vZatHVuoRB1nA (big blind) folded before Flop
Seat 8: 1MJUKc3cc0QmUoz1JZLR2w folded before Flop (didn't bet)
Seat 9: 4WLZvqBn5qv5tds5kt5A1Q folded before Flop (didn't bet)



PokerStars Game #59940432140:  Hold'em No Limit ($0.25/$0.50) - 2009/07/01 1:06:28 ET
Table 'otvGDROEDdqsabxskT79qg' 9-max Seat #2 is the button
Seat 1: 8ehL7qlZzjgUh2H35iiWLw ($56.75 in chips)
Seat 2: cCjTzH9jio8607WzjcfXlg ($12.25 in chips)
Seat 3: +k7T5ocke8UwavtgUHm+Cg ($70.10 in chips)
Seat 4: MG90wfSJZnOejs/KD3vlQQ ($76.65 in chips)
Seat 5: E2518gp4aFz1+kAgmGqeEg ($11.75 in chips)
Seat 6: bxLSulbgr8LmKNjOzw8URg ($55.50 in chips)
Seat 7: 75K2MXwN65Sjfp1yHd50Hg ($10 in chips)
Seat 8: zE9cVigS2nW/Ljy4K4bUQA ($30 in chips)
Seat 9: KcY3X8YpD74Kw1RHkx/g4A ($50.40 in chips)
+k7T5ocke8UwavtgUHm+Cg: posts small blind $0.25
MG90wfSJZnOejs/KD3vlQQ: posts big blind $0.50
*** HOLE CARDS ***
E2518gp4aFz1+kAgmGqeEg: folds
bxLSulbgr8LmKNjOzw8URg: folds
75K2MXwN65Sjfp1yHd50Hg: folds
zE9cVigS2nW/Ljy4K4bUQA: folds
KcY3X8YpD74Kw1RHkx/g4A: calls $0.50
8ehL7qlZzjgUh2H35iiWLw: raises $2 to $2.50
cCjTzH9jio8607WzjcfXlg: folds
+k7T5ocke8UwavtgUHm+Cg: folds
MG90wfSJZnOejs/KD3vlQQ: folds
KcY3X8YpD74Kw1RHkx/g4A: calls $2
*** FLOP *** [9h 6s Kd]
KcY3X8YpD74Kw1RHkx/g4A: checks
8ehL7qlZzjgUh2H35iiWLw: bets $4
KcY3X8YpD74Kw1RHkx/g4A: folds
8ehL7qlZzjgUh2H35iiWLw collected $5.50 from pot
8ehL7qlZzjgUh2H35iiWLw: doesn't show hand
*** SUMMARY ***
Total pot $5.75 | Rake $0.25
Board [9h 6s Kd]
Seat 1: 8ehL7qlZzjgUh2H35iiWLw collected ($5.50)
Seat 2: cCjTzH9jio8607WzjcfXlg (button) folded before Flop (didn't bet)
Seat 3: +k7T5ocke8UwavtgUHm+Cg (small blind) folded before Flop
Seat 4: MG90wfSJZnOejs/KD3vlQQ (big blind) folded before Flop
Seat 5: E2518gp4aFz1+kAgmGqeEg folded before Flop (didn't bet)
Seat 6: bxLSulbgr8LmKNjOzw8URg folded before Flop (didn't bet)
Seat 7: 75K2MXwN65Sjfp1yHd50Hg folded before Flop (didn't bet)
Seat 8: zE9cVigS2nW/Ljy4K4bUQA folded before Flop (didn't bet)
Seat 9: KcY3X8YpD74Kw1RHkx/g4A folded on the Flop



PokerStars Game #59940432616:  Hold'em No Limit ($0.25/$0.50) - 2009/07/01 1:06:28 ET
Table '+dXkOAQyS8j9PQZusUTMpg' 2-max Seat #1 is the button
Seat 1: XFa6sBGjP2gxoIvxR3fZIg ($118.15 in chips)
Seat 2: 5IBeOgaApY1Bvzv2P8X4EA ($77.65 in chips)
XFa6sBGjP2gxoIvxR3fZIg: posts small blind $0.25
5IBeOgaApY1Bvzv2P8X4EA: posts big blind $0.50
*** HOLE CARDS ***
XFa6sBGjP2gxoIvxR3fZIg: raises $1 to $1.50
5IBeOgaApY1Bvzv2P8X4EA: folds
XFa6sBGjP2gxoIvxR3fZIg collected $1 from pot
*** SUMMARY ***
Total pot $1 | Rake $0
Seat 1: XFa6sBGjP2gxoIvxR3fZIg (button) (small blind) collected ($1)
Seat 2: 5IBeOgaApY1Bvzv2P8X4EA (big blind) folded before Flop



PokerStars Game #59940432770:  Hold'em No Limit ($0.25/$0.50) - 2009/07/01 1:06:29 ET
Table 'E7bWJ45aoFXRpyRv2gw+Ig' 2-max Seat #1 is the button
Seat 1: FRkiRasEGlHUeLrEl+k/nA ($58.25 in chips)
Seat 2: 3Wro85I7472vJ4Wkpneo9A ($129.40 in chips)
FRkiRasEGlHUeLrEl+k/nA: posts small blind $0.25
3Wro85I7472vJ4Wkpneo9A: posts big blind $0.50
*** HOLE CARDS ***
FRkiRasEGlHUeLrEl+k/nA: raises $1 to $1.50
3Wro85I7472vJ4Wkpneo9A: folds
FRkiRasEGlHUeLrEl+k/nA collected $1 from pot
*** SUMMARY ***
Total pot $1 | Rake $0
Seat 1: FRkiRasEGlHUeLrEl+k/nA (button) (small blind) collected ($1)
Seat 2: 3Wro85I7472vJ4Wkpneo9A (big blind) folded before Flop



PokerStars Game #59940432748:  Hold'em No Limit ($0.25/$0.50) - 2009/07/01 1:06:29 ET
Table 'ofnd8S4IdIPph1Cbn+x7hA' 2-max Seat #2 is the button
Seat 1: 77q9x51ZNwX7DR8zR5r9wQ ($20 in chips)
Seat 2: l5WbyJ/iWYjpeCC6GCYY6w ($50 in chips)
l5WbyJ/iWYjpeCC6GCYY6w: posts small blind $0.25
77q9x51ZNwX7DR8zR5r9wQ: posts big blind $0.50
*** HOLE CARDS ***
l5WbyJ/iWYjpeCC6GCYY6w: calls $0.25
77q9x51ZNwX7DR8zR5r9wQ: checks
*** FLOP *** [Th 6c 4s]
77q9x51ZNwX7DR8zR5r9wQ: bets $1
l5WbyJ/iWYjpeCC6GCYY6w: folds
77q9x51ZNwX7DR8zR5r9wQ collected $0.95 from pot
*** SUMMARY ***
Total pot $1 | Rake $0.05
Board [Th 6c 4s]
Seat 1: 77q9x51ZNwX7DR8zR5r9wQ (big blind) collected ($0.95)
Seat 2: l5WbyJ/iWYjpeCC6GCYY6w (button) (small blind) folded on the Flop



PokerStars Game #59940433046:  Hold'em No Limit ($0.25/$0.50) - 2009/07/01 1:06:29 ET
Table 'X6IRCRTh+20gjz8aubWnwA' 9-max Seat #2 is the button
Seat 1: DSM67hHHq1XFoEOi9p8Alw ($49.50 in chips)
Seat 2: HZkVla4kK2SI42CVrPZ/ig ($6.80 in chips)
Seat 3: SWv01peOe69QQRvhQTqjQw ($8.25 in chips)
Seat 4: M3JFBNQ8Bbw3FBZ/18MuXw ($24.10 in chips)
Seat 5: NnQCepdIR/AOUQn1yhYx6Q ($10 in chips)
Seat 6: 75K2MXwN65Sjfp1yHd50Hg ($10 in chips)
Seat 7: cFHQjKQOOKTUzoilhrXHLg ($18.40 in chips)
Seat 8: HxeBVq06/3Bh/H986sgdbw ($51.50 in chips)
Seat 9: M+7+BTmX5vZatHVuoRB1nA ($44.25 in chips)
SWv01peOe69QQRvhQTqjQw: posts small blind $0.25
M3JFBNQ8Bbw3FBZ/18MuXw: posts big blind $0.50
*** HOLE CARDS ***
NnQCepdIR/AOUQn1yhYx6Q: folds
75K2MXwN65Sjfp1yHd50Hg: folds
cFHQjKQOOKTUzoilhrXHLg: calls $0.50
HxeBVq06/3Bh/H986sgdbw: folds
M+7+BTmX5vZatHVuoRB1nA: folds
DSM67hHHq1XFoEOi9p8Alw: raises $1.50 to $2
HZkVla4kK2SI42CVrPZ/ig: folds
SWv01peOe69QQRvhQTqjQw: folds
M3JFBNQ8Bbw3FBZ/18MuXw: folds
cFHQjKQOOKTUzoilhrXHLg: calls $1.50
*** FLOP *** [2h 2c 9c]
cFHQjKQOOKTUzoilhrXHLg: checks
DSM67hHHq1XFoEOi9p8Alw: checks
*** TURN *** [2h 2c 9c] [4s]
cFHQjKQOOKTUzoilhrXHLg: checks
DSM67hHHq1XFoEOi9p8Alw: checks
*** RIVER *** [2h 2c 9c 4s] [Qs]
cFHQjKQOOKTUzoilhrXHLg: checks
DSM67hHHq1XFoEOi9p8Alw: bets $3
cFHQjKQOOKTUzoilhrXHLg: folds
DSM67hHHq1XFoEOi9p8Alw collected $4.55 from pot
*** SUMMARY ***
Total pot $4.75 | Rake $0.20
Board [2h 2c 9c 4s Qs]
Seat 1: DSM67hHHq1XFoEOi9p8Alw collected ($4.55)
Seat 2: HZkVla4kK2SI42CVrPZ/ig (button) folded before Flop (didn't bet)
Seat 3: SWv01peOe69QQRvhQTqjQw (small blind) folded before Flop
Seat 4: M3JFBNQ8Bbw3FBZ/18MuXw (big blind) folded before Flop
Seat 5: NnQCepdIR/AOUQn1yhYx6Q folded before Flop (didn't bet)
Seat 6: 75K2MXwN65Sjfp1yHd50Hg folded before Flop (didn't bet)
Seat 7: cFHQjKQOOKTUzoilhrXHLg folded on the River
Seat 8: HxeBVq06/3Bh/H986sgdbw folded before Flop (didn't bet)
Seat 9: M+7+BTmX5vZatHVuoRB1nA folded before Flop (didn't bet)



PokerStars Game #59940434202:  Hold'em No Limit ($0.25/$0.50) - 2009/07/01 1:06:31 ET
Table '0eJtgVAXVvBgncFdcUpXcQ' 2-max Seat #2 is the button
Seat 1: Ag6DvxX4vbRheqsv2zXKTQ ($43.70 in chips)
Seat 2: KMc4R+K9ao4Ur3rF7NGe6Q ($12.40 in chips)
KMc4R+K9ao4Ur3rF7NGe6Q: posts small blind $0.25
Ag6DvxX4vbRheqsv2zXKTQ: posts big blind $0.50
*** HOLE CARDS ***
KMc4R+K9ao4Ur3rF7NGe6Q: raises $1.50 to $2
Ag6DvxX4vbRheqsv2zXKTQ: folds
KMc4R+K9ao4Ur3rF7NGe6Q collected $1 from pot
KMc4R+K9ao4Ur3rF7NGe6Q: doesn't show hand
*** SUMMARY ***
Total pot $1 | Rake $0
Seat 1: Ag6DvxX4vbRheqsv2zXKTQ (big blind) folded before Flop
Seat 2: KMc4R+K9ao4Ur3rF7NGe6Q (button) (small blind) collected ($1)



PokerStars Game #59940434370:  Hold'em No Limit ($0.25/$0.50) - 2009/07/01 1:06:32 ET
Table '/cQuAT3ef4t+PGrXiNhGaQ' 9-max Seat #3 is the button
Seat 1: HZkVla4kK2SI42CVrPZ/ig ($14.25 in chips)
Seat 2: jXGruyaMqirTaTXNOvBdew ($68.20 in chips)
Seat 3: g4k0NXISyLCqaSWZDBjfEg ($53.50 in chips)
Seat 4: OWP/DOu+PlPK6ZZ3zYa0HA ($29.10 in chips)
Seat 5: 5SgaHdWixdClWvaEG+KUjQ ($49.35 in chips)
Seat 6: APYIOyK/4AGb+kIwlOUNBQ ($38.10 in chips)
Seat 7: J0W5D97jl5VLky+IoPvDeA ($160.70 in chips)
Seat 8: eBrej2jnlUCs/JgxFCRn2g ($40 in chips)
Seat 9: AjV5McH1KMMclY26QdLM5w ($25.70 in chips)
OWP/DOu+PlPK6ZZ3zYa0HA: posts small blind $0.25
5SgaHdWixdClWvaEG+KUjQ: posts big blind $0.50
*** HOLE CARDS ***
APYIOyK/4AGb+kIwlOUNBQ: folds
J0W5D97jl5VLky+IoPvDeA: calls $0.50
eBrej2jnlUCs/JgxFCRn2g: calls $0.50
AjV5McH1KMMclY26QdLM5w: folds
HZkVla4kK2SI42CVrPZ/ig: folds
jXGruyaMqirTaTXNOvBdew: folds
g4k0NXISyLCqaSWZDBjfEg: folds
OWP/DOu+PlPK6ZZ3zYa0HA: calls $0.25
5SgaHdWixdClWvaEG+KUjQ: checks
*** FLOP *** [6s 6d 5s]
OWP/DOu+PlPK6ZZ3zYa0HA: checks
5SgaHdWixdClWvaEG+KUjQ: checks
J0W5D97jl5VLky+IoPvDeA: checks
eBrej2jnlUCs/JgxFCRn2g: checks
*** TURN *** [6s 6d 5s] [4s]
OWP/DOu+PlPK6ZZ3zYa0HA: bets $1
5SgaHdWixdClWvaEG+KUjQ: raises $2 to $3
J0W5D97jl5VLky+IoPvDeA: calls $3
eBrej2jnlUCs/JgxFCRn2g: folds
OWP/DOu+PlPK6ZZ3zYa0HA: folds
*** RIVER *** [6s 6d 5s 4s] [8c]
5SgaHdWixdClWvaEG+KUjQ: bets $3
J0W5D97jl5VLky+IoPvDeA: calls $3
*** SHOW DOWN ***
5SgaHdWixdClWvaEG+KUjQ: shows [Kc 5d] (two pair, Sixes and Fives)
J0W5D97jl5VLky+IoPvDeA: shows [Qs Js] (a flush, Queen high)
J0W5D97jl5VLky+IoPvDeA collected $14.30 from pot
*** SUMMARY ***
Total pot $15 | Rake $0.70
Board [6s 6d 5s 4s 8c]
Seat 1: HZkVla4kK2SI42CVrPZ/ig folded before Flop (didn't bet)
Seat 2: jXGruyaMqirTaTXNOvBdew folded before Flop (didn't bet)
Seat 3: g4k0NXISyLCqaSWZDBjfEg (button) folded before Flop (didn't bet)
Seat 4: OWP/DOu+PlPK6ZZ3zYa0HA (small blind) folded on the Turn
Seat 5: 5SgaHdWixdClWvaEG+KUjQ (big blind) showed [Kc 5d] and lost with two pair, Sixes and Fives
Seat 6: APYIOyK/4AGb+kIwlOUNBQ folded before Flop (didn't bet)
Seat 7: J0W5D97jl5VLky+IoPvDeA showed [Qs Js] and won ($14.30) with a flush, Queen high
Seat 8: eBrej2jnlUCs/JgxFCRn2g folded on the Turn
Seat 9: AjV5McH1KMMclY26QdLM5w folded before Flop (didn't bet)



PokerStars Game #59940435050:  Hold'em No Limit ($0.25/$0.50) - 2009/07/01 1:06:33 ET
Table 'BCN5su+SsXiy1zRMJi0SJw' 6-max Seat #1 is the button
Seat 1: GxXV09ciXaOxyY2H5aMIIw ($40.80 in chips)
Seat 2: oU2kDCkT/gilYbHWrg7D8w ($41.05 in chips)
Seat 3: of9mtXiD8G4Nx5p7hCbgqQ ($50 in chips)
Seat 4: 4QfsCWthT/vSLirorNXqtg ($50 in chips)
Seat 5: IBNygaT1aa9Z1uPdJJilwA ($52.15 in chips)
Seat 6: b2symlOdL7+0c9Pj4N/KlA ($60.10 in chips)
oU2kDCkT/gilYbHWrg7D8w: posts small blind $0.25
of9mtXiD8G4Nx5p7hCbgqQ: posts big blind $0.50
*** HOLE CARDS ***
4QfsCWthT/vSLirorNXqtg: folds
IBNygaT1aa9Z1uPdJJilwA: folds
b2symlOdL7+0c9Pj4N/KlA: folds
GxXV09ciXaOxyY2H5aMIIw: folds
oU2kDCkT/gilYbHWrg7D8w: raises $1 to $1.50
of9mtXiD8G4Nx5p7hCbgqQ: folds
oU2kDCkT/gilYbHWrg7D8w collected $1 from pot
*** SUMMARY ***
Total pot $1 | Rake $0
Seat 1: GxXV09ciXaOxyY2H5aMIIw (button) folded before Flop (didn't bet)
Seat 2: oU2kDCkT/gilYbHWrg7D8w (small blind) collected ($1)
Seat 3: of9mtXiD8G4Nx5p7hCbgqQ (big blind) folded before Flop
Seat 4: 4QfsCWthT/vSLirorNXqtg folded before Flop (didn't bet)
Seat 5: IBNygaT1aa9Z1uPdJJilwA folded before Flop (didn't bet)
Seat 6: b2symlOdL7+0c9Pj4N/KlA folded before Flop (didn't bet)



PokerStars Game #59940436332:  Hold'em No Limit ($0.25/$0.50) - 2009/07/01 1:06:35 ET
Table '+dXkOAQyS8j9PQZusUTMpg' 2-max Seat #2 is the button
Seat 1: XFa6sBGjP2gxoIvxR3fZIg ($118.65 in chips)
Seat 2: 5IBeOgaApY1Bvzv2P8X4EA ($77.15 in chips)
5IBeOgaApY1Bvzv2P8X4EA: posts small blind $0.25
XFa6sBGjP2gxoIvxR3fZIg: posts big blind $0.50
*** HOLE CARDS ***
5IBeOgaApY1Bvzv2P8X4EA: folds
XFa6sBGjP2gxoIvxR3fZIg collected $0.50 from pot
XFa6sBGjP2gxoIvxR3fZIg: doesn't show hand
*** SUMMARY ***
Total pot $0.50 | Rake $0
Seat 1: XFa6sBGjP2gxoIvxR3fZIg (big blind) collected ($0.50)
Seat 2: 5IBeOgaApY1Bvzv2P8X4EA (button) (small blind) folded before Flop



PokerStars Game #59940437128:  Hold'em No Limit ($0.25/$0.50) - 2009/07/01 1:06:36 ET
Table '8BQGgNetI1NOvWeu3gtMNw' 2-max Seat #2 is the button
Seat 1: bypIyrYcAAifLfhZpGlKLA ($97 in chips)
Seat 2: Z4HwehErEwzsv/noQlfUlg ($102.50 in chips)
Z4HwehErEwzsv/noQlfUlg: posts small blind $0.25
bypIyrYcAAifLfhZpGlKLA: posts big blind $0.50
*** HOLE CARDS ***
Z4HwehErEwzsv/noQlfUlg: calls $0.25
bypIyrYcAAifLfhZpGlKLA: checks
*** FLOP *** [Ah As 8c]
bypIyrYcAAifLfhZpGlKLA: checks
Z4HwehErEwzsv/noQlfUlg: checks
*** TURN *** [Ah As 8c] [9d]
bypIyrYcAAifLfhZpGlKLA: checks
Z4HwehErEwzsv/noQlfUlg: bets $1
bypIyrYcAAifLfhZpGlKLA: calls $1
*** RIVER *** [Ah As 8c 9d] [7c]
bypIyrYcAAifLfhZpGlKLA: checks
Z4HwehErEwzsv/noQlfUlg: checks
*** SHOW DOWN ***
bypIyrYcAAifLfhZpGlKLA: shows [2s 9c] (two pair, Aces and Nines)
Z4HwehErEwzsv/noQlfUlg: mucks hand
bypIyrYcAAifLfhZpGlKLA collected $2.90 from pot
*** SUMMARY ***
Total pot $3 | Rake $0.10
Board [Ah As 8c 9d 7c]
Seat 1: bypIyrYcAAifLfhZpGlKLA (big blind) showed [2s 9c] and won ($2.90) with two pair, Aces and Nines
Seat 2: Z4HwehErEwzsv/noQlfUlg (button) (small blind) mucked



PokerStars Game #59940436892:  Hold'em No Limit ($0.25/$0.50) - 2009/07/01 1:06:36 ET
Table 'GfL/No5u5PoEnU39lP5pQg' 6-max Seat #2 is the button
Seat 1: 1WUCqNG+p+vfWRTXNu4ljw ($64.50 in chips)
Seat 2: uVwggSetzp7d+eVgowO3vg ($56.25 in chips)
Seat 3: eQXFICMuu3hw6XlcmuVNEA ($21.60 in chips)
Seat 4: r6u7MWSXF30/khcTYkrG9Q ($35.90 in chips)
Seat 5: M1KyQQvVPVuxqTAB8sR/zQ ($51 in chips)
Seat 6: kxPhs4ePFqMy52CInAJ2aw ($48.50 in chips)
eQXFICMuu3hw6XlcmuVNEA: posts small blind $0.25
r6u7MWSXF30/khcTYkrG9Q: posts big blind $0.50
*** HOLE CARDS ***
M1KyQQvVPVuxqTAB8sR/zQ: folds
kxPhs4ePFqMy52CInAJ2aw: raises $1.50 to $2
1WUCqNG+p+vfWRTXNu4ljw: folds
uVwggSetzp7d+eVgowO3vg: folds
eQXFICMuu3hw6XlcmuVNEA: folds
r6u7MWSXF30/khcTYkrG9Q: folds
kxPhs4ePFqMy52CInAJ2aw collected $1.25 from pot
kxPhs4ePFqMy52CInAJ2aw: doesn't show hand
*** SUMMARY ***
Total pot $1.25 | Rake $0
Seat 1: 1WUCqNG+p+vfWRTXNu4ljw folded before Flop (didn't bet)
Seat 2: uVwggSetzp7d+eVgowO3vg (button) folded before Flop (didn't bet)
Seat 3: eQXFICMuu3hw6XlcmuVNEA (small blind) folded before Flop
Seat 4: r6u7MWSXF30/khcTYkrG9Q (big blind) folded before Flop
Seat 5: M1KyQQvVPVuxqTAB8sR/zQ folded before Flop (didn't bet)
Seat 6: kxPhs4ePFqMy52CInAJ2aw collected ($1.25)



PokerStars Game #59940437662:  Hold'em No Limit ($0.25/$0.50) - 2009/07/01 1:06:37 ET
Table 'E7bWJ45aoFXRpyRv2gw+Ig' 2-max Seat #2 is the button
Seat 1: FRkiRasEGlHUeLrEl+k/nA ($58.75 in chips)
Seat 2: 3Wro85I7472vJ4Wkpneo9A ($128.90 in chips)
3Wro85I7472vJ4Wkpneo9A: posts small blind $0.25
FRkiRasEGlHUeLrEl+k/nA: posts big blind $0.50
*** HOLE CARDS ***
3Wro85I7472vJ4Wkpneo9A: raises $1 to $1.50
FRkiRasEGlHUeLrEl+k/nA: calls $1
*** FLOP *** [6s Jc 9h]
FRkiRasEGlHUeLrEl+k/nA: checks
3Wro85I7472vJ4Wkpneo9A: bets $2
FRkiRasEGlHUeLrEl+k/nA: folds
3Wro85I7472vJ4Wkpneo9A collected $2.85 from pot
3Wro85I7472vJ4Wkpneo9A: doesn't show hand
*** SUMMARY ***
Total pot $3 | Rake $0.15
Board [6s Jc 9h]
Seat 1: FRkiRasEGlHUeLrEl+k/nA (big blind) folded on the Flop
Seat 2: 3Wro85I7472vJ4Wkpneo9A (button) (small blind) collected ($2.85)



PokerStars Game #59940437888:  Hold'em No Limit ($0.25/$0.50) - 2009/07/01 1:06:38 ET
Table 'WlCrrUP9MxwySQN5fzLFBQ' 2-max Seat #1 is the button
Seat 1: U7xFsli2XvMiGlVDxk8a/Q ($13.50 in chips)
Seat 2: JTT5TsRNqs6npc7cgI4X/w ($18.50 in chips)
U7xFsli2XvMiGlVDxk8a/Q: posts small blind $0.25
JTT5TsRNqs6npc7cgI4X/w: posts big blind $0.50
*** HOLE CARDS ***
U7xFsli2XvMiGlVDxk8a/Q: raises $1 to $1.50
JTT5TsRNqs6npc7cgI4X/w: calls $1
*** FLOP *** [Kc Jc As]
JTT5TsRNqs6npc7cgI4X/w: checks
U7xFsli2XvMiGlVDxk8a/Q: bets $1.50
JTT5TsRNqs6npc7cgI4X/w: calls $1.50
*** TURN *** [Kc Jc As] [6d]
JTT5TsRNqs6npc7cgI4X/w: checks
U7xFsli2XvMiGlVDxk8a/Q: checks
*** RIVER *** [Kc Jc As 6d] [7s]
JTT5TsRNqs6npc7cgI4X/w: checks
U7xFsli2XvMiGlVDxk8a/Q: checks
*** SHOW DOWN ***
JTT5TsRNqs6npc7cgI4X/w: shows [Qc 2c] (high card Ace)
U7xFsli2XvMiGlVDxk8a/Q: shows [6s Qh] (a pair of Sixes)
U7xFsli2XvMiGlVDxk8a/Q collected $5.75 from pot
*** SUMMARY ***
Total pot $6 | Rake $0.25
Board [Kc Jc As 6d 7s]
Seat 1: U7xFsli2XvMiGlVDxk8a/Q (button) (small blind) showed [6s Qh] and won ($5.75) with a pair of Sixes
Seat 2: JTT5TsRNqs6npc7cgI4X/w (big blind) showed [Qc 2c] and lost with high card Ace



PokerStars Game #59940438430:  Hold'em No Limit ($0.25/$0.50) - 2009/07/01 1:06:39 ET
Table '+z1aekfHkpp09pc8F9aViw' 6-max Seat #6 is the button
Seat 1: FHilMb2i2DbUCc9lplszog ($9.85 in chips)
Seat 2: 8EEqTTh7T1q48sYDqbI2Xg ($30 in chips)
Seat 3: uUznlIMFnRUvwrBhYF73KA ($131.15 in chips)
Seat 4: RowCSpSURHTOL/dcjg/Iug ($37.30 in chips)
Seat 5: rplyldNweS6YyMNEALQrug ($53.70 in chips)
Seat 6: 686aeHikcJlgKkSuIFdcXQ ($50 in chips)
FHilMb2i2DbUCc9lplszog: posts small blind $0.25
8EEqTTh7T1q48sYDqbI2Xg: posts big blind $0.50
*** HOLE CARDS ***
uUznlIMFnRUvwrBhYF73KA: calls $0.50
RowCSpSURHTOL/dcjg/Iug: folds
rplyldNweS6YyMNEALQrug: calls $0.50
686aeHikcJlgKkSuIFdcXQ: folds
FHilMb2i2DbUCc9lplszog: calls $0.25
8EEqTTh7T1q48sYDqbI2Xg: checks
*** FLOP *** [4s Qs Td]
FHilMb2i2DbUCc9lplszog: checks
8EEqTTh7T1q48sYDqbI2Xg: checks
uUznlIMFnRUvwrBhYF73KA: checks
rplyldNweS6YyMNEALQrug: checks
*** TURN *** [4s Qs Td] [2d]
FHilMb2i2DbUCc9lplszog: checks
8EEqTTh7T1q48sYDqbI2Xg: checks
uUznlIMFnRUvwrBhYF73KA: checks
rplyldNweS6YyMNEALQrug: checks
*** RIVER *** [4s Qs Td 2d] [Kc]
FHilMb2i2DbUCc9lplszog: checks
8EEqTTh7T1q48sYDqbI2Xg: checks
uUznlIMFnRUvwrBhYF73KA: checks
rplyldNweS6YyMNEALQrug: bets $3
FHilMb2i2DbUCc9lplszog: folds
8EEqTTh7T1q48sYDqbI2Xg: folds
uUznlIMFnRUvwrBhYF73KA: raises $3 to $6
rplyldNweS6YyMNEALQrug: calls $3
*** SHOW DOWN ***
uUznlIMFnRUvwrBhYF73KA: shows [Ks 9c] (a pair of Kings)
rplyldNweS6YyMNEALQrug: shows [3d Kd] (a pair of Kings - lower kicker)
uUznlIMFnRUvwrBhYF73KA collected $13.35 from pot
*** SUMMARY ***
Total pot $14 | Rake $0.65
Board [4s Qs Td 2d Kc]
Seat 1: FHilMb2i2DbUCc9lplszog (small blind) folded on the River
Seat 2: 8EEqTTh7T1q48sYDqbI2Xg (big blind) folded on the River
Seat 3: uUznlIMFnRUvwrBhYF73KA showed [Ks 9c] and won ($13.35) with a pair of Kings
Seat 4: RowCSpSURHTOL/dcjg/Iug folded before Flop (didn't bet)
Seat 5: rplyldNweS6YyMNEALQrug showed [3d Kd] and lost with a pair of Kings
Seat 6: 686aeHikcJlgKkSuIFdcXQ (button) folded before Flop (didn't bet)



PokerStars Game #59940439024:  Hold'em No Limit ($0.25/$0.50) - 2009/07/01 1:06:40 ET
Table 'hSTs/dUsYLgJQuF2Onp0MQ' 6-max Seat #2 is the button
Seat 1: 1WUCqNG+p+vfWRTXNu4ljw ($50 in chips)
Seat 2: 6vNxrjjCl6FwfaaymM9jjg ($32.50 in chips)
Seat 3: C3qJBo7uxfFVDluE1lmK2w ($52.10 in chips)
Seat 4: L0aIPg7qefDQjdJo3HCVEA ($10.80 in chips)
Seat 5: 686aeHikcJlgKkSuIFdcXQ ($59.90 in chips)
Seat 6: M1KyQQvVPVuxqTAB8sR/zQ ($80.40 in chips)
C3qJBo7uxfFVDluE1lmK2w: posts small blind $0.25
L0aIPg7qefDQjdJo3HCVEA: posts big blind $0.50
*** HOLE CARDS ***
686aeHikcJlgKkSuIFdcXQ: raises $1.50 to $2
M1KyQQvVPVuxqTAB8sR/zQ: folds
1WUCqNG+p+vfWRTXNu4ljw: folds
6vNxrjjCl6FwfaaymM9jjg: calls $2
C3qJBo7uxfFVDluE1lmK2w: folds
L0aIPg7qefDQjdJo3HCVEA: folds
*** FLOP *** [Js Qc Qh]
686aeHikcJlgKkSuIFdcXQ: checks
6vNxrjjCl6FwfaaymM9jjg: checks
*** TURN *** [Js Qc Qh] [Ts]
686aeHikcJlgKkSuIFdcXQ: checks
6vNxrjjCl6FwfaaymM9jjg: checks
*** RIVER *** [Js Qc Qh Ts] [6c]
686aeHikcJlgKkSuIFdcXQ: checks
6vNxrjjCl6FwfaaymM9jjg: checks
*** SHOW DOWN ***
686aeHikcJlgKkSuIFdcXQ: shows [7d 9d] (a pair of Queens)
6vNxrjjCl6FwfaaymM9jjg: shows [8d 6d] (two pair, Queens and Sixes)
6vNxrjjCl6FwfaaymM9jjg collected $4.55 from pot
*** SUMMARY ***
Total pot $4.75 | Rake $0.20
Board [Js Qc Qh Ts 6c]
Seat 1: 1WUCqNG+p+vfWRTXNu4ljw folded before Flop (didn't bet)
Seat 2: 6vNxrjjCl6FwfaaymM9jjg (button) showed [8d 6d] and won ($4.55) with two pair, Queens and Sixes
Seat 3: C3qJBo7uxfFVDluE1lmK2w (small blind) folded before Flop
Seat 4: L0aIPg7qefDQjdJo3HCVEA (big blind) folded before Flop
Seat 5: 686aeHikcJlgKkSuIFdcXQ showed [7d 9d] and lost with a pair of Queens
Seat 6: M1KyQQvVPVuxqTAB8sR/zQ folded before Flop (didn't bet)



PokerStars Game #59940440264:  Hold'em No Limit ($0.25/$0.50) - 2009/07/01 1:06:41 ET
Table '+dXkOAQyS8j9PQZusUTMpg' 2-max Seat #1 is the button
Seat 1: XFa6sBGjP2gxoIvxR3fZIg ($118.90 in chips)
Seat 2: 5IBeOgaApY1Bvzv2P8X4EA ($76.90 in chips)
XFa6sBGjP2gxoIvxR3fZIg: posts small blind $0.25
5IBeOgaApY1Bvzv2P8X4EA: posts big blind $0.50
*** HOLE CARDS ***
XFa6sBGjP2gxoIvxR3fZIg: calls $0.25
5IBeOgaApY1Bvzv2P8X4EA: checks
*** FLOP *** [Jh 5c Qs]
5IBeOgaApY1Bvzv2P8X4EA: checks
XFa6sBGjP2gxoIvxR3fZIg: checks
*** TURN *** [Jh 5c Qs] [Jc]
5IBeOgaApY1Bvzv2P8X4EA: checks
XFa6sBGjP2gxoIvxR3fZIg: checks
*** RIVER *** [Jh 5c Qs Jc] [4c]
5IBeOgaApY1Bvzv2P8X4EA: checks
XFa6sBGjP2gxoIvxR3fZIg: checks
*** SHOW DOWN ***
5IBeOgaApY1Bvzv2P8X4EA: shows [Ts 7d] (a pair of Jacks)
XFa6sBGjP2gxoIvxR3fZIg: mucks hand
5IBeOgaApY1Bvzv2P8X4EA collected $0.95 from pot
*** SUMMARY ***
Total pot $1 | Rake $0.05
Board [Jh 5c Qs Jc 4c]
Seat 1: XFa6sBGjP2gxoIvxR3fZIg (button) (small blind) mucked
Seat 2: 5IBeOgaApY1Bvzv2P8X4EA (big blind) showed [Ts 7d] and won ($0.95) with a pair of Jacks



PokerStars Game #59940440496:  Hold'em No Limit ($0.25/$0.50) - 2009/07/01 1:06:42 ET
Table 'ZYI3ZReBjdfKEYItkZHI6A' 9-max Seat #1 is the button
Seat 1: E2518gp4aFz1+kAgmGqeEg ($13.85 in chips)
Seat 2: 8zdVaT8pZ/Wm0uWoeLhtZg ($5 in chips)
Seat 3: bkXkL3pmapikPQQRNPZSEA ($18.75 in chips)
Seat 4: e2+sK/yjnj94rXOKoxPP2A ($50 in chips)
Seat 5: ApHP7ouup365XIUFBdEDxg ($47.15 in chips)
Seat 6: Wj7mKnRFR90j40wWUu2+Og ($37.30 in chips)
Seat 7: HWcfp1hY1hqvrddzW3/FQw ($13.50 in chips)
Seat 8: ji04uOybxCdpdefzlUQeKQ ($28 in chips)
Seat 9: tLkxo7JgV+WWI0UBw44K5A ($50.85 in chips)
8zdVaT8pZ/Wm0uWoeLhtZg: posts small blind $0.25
bkXkL3pmapikPQQRNPZSEA: posts big blind $0.50
*** HOLE CARDS ***
e2+sK/yjnj94rXOKoxPP2A: folds
ApHP7ouup365XIUFBdEDxg: folds
Wj7mKnRFR90j40wWUu2+Og: folds
HWcfp1hY1hqvrddzW3/FQw: calls $0.50
ji04uOybxCdpdefzlUQeKQ: folds
tLkxo7JgV+WWI0UBw44K5A has timed out
tLkxo7JgV+WWI0UBw44K5A: folds
tLkxo7JgV+WWI0UBw44K5A is sitting out
E2518gp4aFz1+kAgmGqeEg: folds
8zdVaT8pZ/Wm0uWoeLhtZg: calls $0.25
bkXkL3pmapikPQQRNPZSEA: checks
*** FLOP *** [Qd 5c Jc]
8zdVaT8pZ/Wm0uWoeLhtZg: checks
bkXkL3pmapikPQQRNPZSEA: bets $0.50
HWcfp1hY1hqvrddzW3/FQw: calls $0.50
8zdVaT8pZ/Wm0uWoeLhtZg: folds
*** TURN *** [Qd 5c Jc] [7c]
bkXkL3pmapikPQQRNPZSEA: bets $1
HWcfp1hY1hqvrddzW3/FQw: folds
bkXkL3pmapikPQQRNPZSEA collected $2.40 from pot
*** SUMMARY ***
Total pot $2.50 | Rake $0.10
Board [Qd 5c Jc 7c]
Seat 1: E2518gp4aFz1+kAgmGqeEg (button) folded before Flop (didn't bet)
Seat 2: 8zdVaT8pZ/Wm0uWoeLhtZg (small blind) folded on the Flop
Seat 3: bkXkL3pmapikPQQRNPZSEA (big blind) collected ($2.40)
Seat 4: e2+sK/yjnj94rXOKoxPP2A folded before Flop (didn't bet)
Seat 5: ApHP7ouup365XIUFBdEDxg folded before Flop (didn't bet)
Seat 6: Wj7mKnRFR90j40wWUu2+Og folded before Flop (didn't bet)
Seat 7: HWcfp1hY1hqvrddzW3/FQw folded on the Turn
Seat 8: ji04uOybxCdpdefzlUQeKQ folded before Flop (didn't bet)
Seat 9: tLkxo7JgV+WWI0UBw44K5A folded before Flop (didn't bet)



PokerStars Game #59940441632:  Hold'em No Limit ($0.25/$0.50) - 2009/07/01 1:06:44 ET
Table '0eJtgVAXVvBgncFdcUpXcQ' 2-max Seat #1 is the button
Seat 1: Ag6DvxX4vbRheqsv2zXKTQ ($43.20 in chips)
Seat 2: KMc4R+K9ao4Ur3rF7NGe6Q ($12.90 in chips)
Ag6DvxX4vbRheqsv2zXKTQ: posts small blind $0.25
KMc4R+K9ao4Ur3rF7NGe6Q: posts big blind $0.50
*** HOLE CARDS ***
Ag6DvxX4vbRheqsv2zXKTQ: folds
KMc4R+K9ao4Ur3rF7NGe6Q collected $0.50 from pot
KMc4R+K9ao4Ur3rF7NGe6Q: doesn't show hand
*** SUMMARY ***
Total pot $0.50 | Rake $0
Seat 1: Ag6DvxX4vbRheqsv2zXKTQ (button) (small blind) folded before Flop
Seat 2: KMc4R+K9ao4Ur3rF7NGe6Q (big blind) collected ($0.50)



PokerStars Game #59940442648:  Hold'em No Limit ($0.25/$0.50) - 2009/07/01 1:06:45 ET
Table 'QOgaEqMcJ73pcUMMxoisUg' 6-max Seat #4 is the button
Seat 1: lxIzoHy0RnkfFSODHC2liw ($53.35 in chips)
Seat 2: oqOqoO2AyCZenUghCxMDxw ($51.60 in chips)
Seat 3: Rt6KgtZ8YaJoTc3FPim00w ($53.75 in chips)
Seat 4: zAcsDhG/T128Vn7XGVSgKg ($50 in chips)
Seat 5: 6vNxrjjCl6FwfaaymM9jjg ($20.25 in chips)
Seat 6: AdS8BJMOheS01zjCDfPMFg ($50 in chips)
6vNxrjjCl6FwfaaymM9jjg: posts small blind $0.25
AdS8BJMOheS01zjCDfPMFg: posts big blind $0.50
*** HOLE CARDS ***
lxIzoHy0RnkfFSODHC2liw: raises $1 to $1.50
oqOqoO2AyCZenUghCxMDxw: folds
Rt6KgtZ8YaJoTc3FPim00w: folds
zAcsDhG/T128Vn7XGVSgKg: folds
6vNxrjjCl6FwfaaymM9jjg: folds
AdS8BJMOheS01zjCDfPMFg: folds
lxIzoHy0RnkfFSODHC2liw collected $1.25 from pot
*** SUMMARY ***
Total pot $1.25 | Rake $0
Seat 1: lxIzoHy0RnkfFSODHC2liw collected ($1.25)
Seat 2: oqOqoO2AyCZenUghCxMDxw folded before Flop (didn't bet)
Seat 3: Rt6KgtZ8YaJoTc3FPim00w folded before Flop (didn't bet)
Seat 4: zAcsDhG/T128Vn7XGVSgKg (button) folded before Flop (didn't bet)
Seat 5: 6vNxrjjCl6FwfaaymM9jjg (small blind) folded before Flop
Seat 6: AdS8BJMOheS01zjCDfPMFg (big blind) folded before Flop



PokerStars Game #59940443328:  Hold'em No Limit ($0.25/$0.50) - 2009/07/01 1:06:47 ET
Table '5EmHi+fnatGQQShcNmzOZQ' 6-max Seat #5 is the button
Seat 1: My8WkRtGx5FW6rJ1I4R3hg ($16.45 in chips)
Seat 2: bfFjgAtIoAI+pUxUwFt3aQ ($47.25 in chips)
Seat 3: 1mYbhL8CU/QYqfVmFcaHDQ ($10 in chips)
Seat 4: 1b+2BbjMN8qhR1WPqdE9VQ ($66.05 in chips)
Seat 5: kxPhs4ePFqMy52CInAJ2aw ($93.85 in chips)
Seat 6: 686aeHikcJlgKkSuIFdcXQ ($135.10 in chips)
686aeHikcJlgKkSuIFdcXQ: posts small blind $0.25
My8WkRtGx5FW6rJ1I4R3hg: posts big blind $0.50
1mYbhL8CU/QYqfVmFcaHDQ: posts big blind $0.50
*** HOLE CARDS ***
bfFjgAtIoAI+pUxUwFt3aQ: calls $0.50
1mYbhL8CU/QYqfVmFcaHDQ: checks
1b+2BbjMN8qhR1WPqdE9VQ: folds
kxPhs4ePFqMy52CInAJ2aw: folds
686aeHikcJlgKkSuIFdcXQ: folds
My8WkRtGx5FW6rJ1I4R3hg: checks
*** FLOP *** [8s Qs 5d]
My8WkRtGx5FW6rJ1I4R3hg: bets $0.50
bfFjgAtIoAI+pUxUwFt3aQ: raises $1 to $1.50
1mYbhL8CU/QYqfVmFcaHDQ: calls $1.50
My8WkRtGx5FW6rJ1I4R3hg: calls $1
*** TURN *** [8s Qs 5d] [Kd]
My8WkRtGx5FW6rJ1I4R3hg: checks
bfFjgAtIoAI+pUxUwFt3aQ: bets $4
1mYbhL8CU/QYqfVmFcaHDQ: folds
My8WkRtGx5FW6rJ1I4R3hg: raises $4 to $8
bfFjgAtIoAI+pUxUwFt3aQ: calls $4
*** RIVER *** [8s Qs 5d Kd] [3s]
My8WkRtGx5FW6rJ1I4R3hg: checks
bfFjgAtIoAI+pUxUwFt3aQ: checks
*** SHOW DOWN ***
My8WkRtGx5FW6rJ1I4R3hg: shows [8d Kh] (two pair, Kings and Eights)
bfFjgAtIoAI+pUxUwFt3aQ: mucks hand
My8WkRtGx5FW6rJ1I4R3hg collected $21.20 from pot
*** SUMMARY ***
Total pot $22.25 | Rake $1.05
Board [8s Qs 5d Kd 3s]
Seat 1: My8WkRtGx5FW6rJ1I4R3hg (big blind) showed [8d Kh] and won ($21.20) with two pair, Kings and Eights
Seat 2: bfFjgAtIoAI+pUxUwFt3aQ mucked
Seat 3: 1mYbhL8CU/QYqfVmFcaHDQ folded on the Turn
Seat 4: 1b+2BbjMN8qhR1WPqdE9VQ folded before Flop (didn't bet)
Seat 5: kxPhs4ePFqMy52CInAJ2aw (button) folded before Flop (didn't bet)
Seat 6: 686aeHikcJlgKkSuIFdcXQ (small blind) folded before Flop



PokerStars Game #59940443346:  Hold'em No Limit ($0.25/$0.50) - 2009/07/01 1:06:47 ET
Table 'BCN5su+SsXiy1zRMJi0SJw' 6-max Seat #2 is the button
Seat 1: GxXV09ciXaOxyY2H5aMIIw ($40.80 in chips)
Seat 2: oU2kDCkT/gilYbHWrg7D8w ($41.55 in chips)
Seat 3: of9mtXiD8G4Nx5p7hCbgqQ ($50 in chips)
Seat 4: 4QfsCWthT/vSLirorNXqtg ($50 in chips)
Seat 5: IBNygaT1aa9Z1uPdJJilwA ($52.15 in chips)
Seat 6: b2symlOdL7+0c9Pj4N/KlA ($60.10 in chips)
of9mtXiD8G4Nx5p7hCbgqQ: posts small blind $0.25
4QfsCWthT/vSLirorNXqtg: posts big blind $0.50
*** HOLE CARDS ***
IBNygaT1aa9Z1uPdJJilwA: folds
b2symlOdL7+0c9Pj4N/KlA: folds
GxXV09ciXaOxyY2H5aMIIw: folds
oU2kDCkT/gilYbHWrg7D8w: calls $0.50
of9mtXiD8G4Nx5p7hCbgqQ: calls $0.25
4QfsCWthT/vSLirorNXqtg: checks
*** FLOP *** [8d Jc 9h]
of9mtXiD8G4Nx5p7hCbgqQ: checks
IBNygaT1aa9Z1uPdJJilwA leaves the table
4QfsCWthT/vSLirorNXqtg: checks
oU2kDCkT/gilYbHWrg7D8w: checks
*** TURN *** [8d Jc 9h] [As]
of9mtXiD8G4Nx5p7hCbgqQ: checks
4QfsCWthT/vSLirorNXqtg: bets $1
oU2kDCkT/gilYbHWrg7D8w: folds
of9mtXiD8G4Nx5p7hCbgqQ: folds
4QfsCWthT/vSLirorNXqtg collected $1.45 from pot
4QfsCWthT/vSLirorNXqtg: doesn't show hand
*** SUMMARY ***
Total pot $1.50 | Rake $0.05
Board [8d Jc 9h As]
Seat 1: GxXV09ciXaOxyY2H5aMIIw folded before Flop (didn't bet)
Seat 2: oU2kDCkT/gilYbHWrg7D8w (button) folded on the Turn
Seat 3: of9mtXiD8G4Nx5p7hCbgqQ (small blind) folded on the Turn
Seat 4: 4QfsCWthT/vSLirorNXqtg (big blind) collected ($1.45)
Seat 5: IBNygaT1aa9Z1uPdJJilwA folded before Flop (didn't bet)
Seat 6: b2symlOdL7+0c9Pj4N/KlA folded before Flop (didn't bet)



PokerStars Game #59940444138:  Hold'em No Limit ($0.25/$0.50) - 2009/07/01 1:06:48 ET
Table 'GfL/No5u5PoEnU39lP5pQg' 6-max Seat #3 is the button
Seat 1: 1WUCqNG+p+vfWRTXNu4ljw ($64.50 in chips)
Seat 2: uVwggSetzp7d+eVgowO3vg ($56.25 in chips)
Seat 3: eQXFICMuu3hw6XlcmuVNEA ($21.35 in chips)
Seat 4: r6u7MWSXF30/khcTYkrG9Q ($35.40 in chips)
Seat 5: M1KyQQvVPVuxqTAB8sR/zQ ($51 in chips)
Seat 6: kxPhs4ePFqMy52CInAJ2aw ($49.25 in chips)
r6u7MWSXF30/khcTYkrG9Q: posts small blind $0.25
M1KyQQvVPVuxqTAB8sR/zQ: posts big blind $0.50
*** HOLE CARDS ***
kxPhs4ePFqMy52CInAJ2aw: folds
1WUCqNG+p+vfWRTXNu4ljw: folds
uVwggSetzp7d+eVgowO3vg: raises $0.50 to $1
eQXFICMuu3hw6XlcmuVNEA: folds
r6u7MWSXF30/khcTYkrG9Q: folds
M1KyQQvVPVuxqTAB8sR/zQ: folds
uVwggSetzp7d+eVgowO3vg collected $1.25 from pot
*** SUMMARY ***
Total pot $1.25 | Rake $0
Seat 1: 1WUCqNG+p+vfWRTXNu4ljw folded before Flop (didn't bet)
Seat 2: uVwggSetzp7d+eVgowO3vg collected ($1.25)
Seat 3: eQXFICMuu3hw6XlcmuVNEA (button) folded before Flop (didn't bet)
Seat 4: r6u7MWSXF30/khcTYkrG9Q (small blind) folded before Flop
Seat 5: M1KyQQvVPVuxqTAB8sR/zQ (big blind) folded before Flop
Seat 6: kxPhs4ePFqMy52CInAJ2aw folded before Flop (didn't bet)



PokerStars Game #59940445036:  Hold'em No Limit ($0.25/$0.50) - 2009/07/01 1:06:50 ET
Table '0eJtgVAXVvBgncFdcUpXcQ' 2-max Seat #2 is the button
Seat 1: Ag6DvxX4vbRheqsv2zXKTQ ($42.95 in chips)
Seat 2: KMc4R+K9ao4Ur3rF7NGe6Q ($13.15 in chips)
KMc4R+K9ao4Ur3rF7NGe6Q: posts small blind $0.25
Ag6DvxX4vbRheqsv2zXKTQ: posts big blind $0.50
*** HOLE CARDS ***
KMc4R+K9ao4Ur3rF7NGe6Q: raises $1 to $1.50
Ag6DvxX4vbRheqsv2zXKTQ: folds
KMc4R+K9ao4Ur3rF7NGe6Q collected $1 from pot
KMc4R+K9ao4Ur3rF7NGe6Q: doesn't show hand
*** SUMMARY ***
Total pot $1 | Rake $0
Seat 1: Ag6DvxX4vbRheqsv2zXKTQ (big blind) folded before Flop
Seat 2: KMc4R+K9ao4Ur3rF7NGe6Q (button) (small blind) collected ($1)



PokerStars Game #59940447304:  Hold'em No Limit ($0.25/$0.50) - 2009/07/01 1:06:53 ET
Table 'E7bWJ45aoFXRpyRv2gw+Ig' 2-max Seat #1 is the button
Seat 1: FRkiRasEGlHUeLrEl+k/nA ($57.25 in chips)
Seat 2: 3Wro85I7472vJ4Wkpneo9A ($130.25 in chips)
FRkiRasEGlHUeLrEl+k/nA: posts small blind $0.25
3Wro85I7472vJ4Wkpneo9A: posts big blind $0.50
*** HOLE CARDS ***
FRkiRasEGlHUeLrEl+k/nA: calls $0.25
3Wro85I7472vJ4Wkpneo9A: checks
*** FLOP *** [6h 4c 8c]
3Wro85I7472vJ4Wkpneo9A: checks
FRkiRasEGlHUeLrEl+k/nA: checks
*** TURN *** [6h 4c 8c] [7s]
3Wro85I7472vJ4Wkpneo9A: checks
FRkiRasEGlHUeLrEl+k/nA: bets $1
3Wro85I7472vJ4Wkpneo9A: folds
FRkiRasEGlHUeLrEl+k/nA collected $0.95 from pot
FRkiRasEGlHUeLrEl+k/nA: doesn't show hand
*** SUMMARY ***
Total pot $1 | Rake $0.05
Board [6h 4c 8c 7s]
Seat 1: FRkiRasEGlHUeLrEl+k/nA (button) (small blind) collected ($0.95)
Seat 2: 3Wro85I7472vJ4Wkpneo9A (big blind) folded on the Turn



PokerStars Game #59940448136:  Hold'em No Limit ($0.25/$0.50) - 2009/07/01 1:06:55 ET
Table 'c/CRn+68J3Y8KxD5g1ek2Q' 2-max Seat #1 is the button
Seat 1: 46qCyJ6evTkHo9al5sBMNA ($91.05 in chips)
Seat 2: BypVLsYQt3ePFm2xQL/dOA ($275.40 in chips)
46qCyJ6evTkHo9al5sBMNA: posts small blind $0.25
BypVLsYQt3ePFm2xQL/dOA: posts big blind $0.50
*** HOLE CARDS ***
46qCyJ6evTkHo9al5sBMNA: folds
BypVLsYQt3ePFm2xQL/dOA collected $0.50 from pot
BypVLsYQt3ePFm2xQL/dOA: doesn't show hand
*** SUMMARY ***
Total pot $0.50 | Rake $0
Seat 1: 46qCyJ6evTkHo9al5sBMNA (button) (small blind) folded before Flop
Seat 2: BypVLsYQt3ePFm2xQL/dOA (big blind) collected ($0.50)



PokerStars Game #59940448076:  Hold'em No Limit ($0.25/$0.50) - 2009/07/01 1:06:55 ET
Table 'kgbJRsxfv64KrErDRBAkcw' 6-max Seat #5 is the button
Seat 1: VamsyhlFzXGF6/ydo0BHeA ($34.50 in chips)
Seat 2: AdS8BJMOheS01zjCDfPMFg ($49.20 in chips)
Seat 3: c4MNIaIyPMOMxrgT8FT5nA ($135.55 in chips)
Seat 5: eUBBn2R56C1IQ6Cs/vitwg ($62.70 in chips)
Seat 6: 1b+2BbjMN8qhR1WPqdE9VQ ($51.90 in chips)
1b+2BbjMN8qhR1WPqdE9VQ: posts small blind $0.25
VamsyhlFzXGF6/ydo0BHeA: posts big blind $0.50
*** HOLE CARDS ***
AdS8BJMOheS01zjCDfPMFg: raises $1 to $1.50
c4MNIaIyPMOMxrgT8FT5nA: folds
eUBBn2R56C1IQ6Cs/vitwg: folds
1b+2BbjMN8qhR1WPqdE9VQ: folds
VamsyhlFzXGF6/ydo0BHeA: calls $1
*** FLOP *** [3d 9h 2s]
VamsyhlFzXGF6/ydo0BHeA: bets $2
AdS8BJMOheS01zjCDfPMFg: raises $2.50 to $4.50
VamsyhlFzXGF6/ydo0BHeA: calls $2.50
*** TURN *** [3d 9h 2s] [Kc]
VamsyhlFzXGF6/ydo0BHeA: checks
AdS8BJMOheS01zjCDfPMFg: bets $7.50
VamsyhlFzXGF6/ydo0BHeA: calls $7.50
*** RIVER *** [3d 9h 2s Kc] [Ts]
VamsyhlFzXGF6/ydo0BHeA: checks
AdS8BJMOheS01zjCDfPMFg: checks
*** SHOW DOWN ***
VamsyhlFzXGF6/ydo0BHeA: shows [9d Qh] (a pair of Nines)
AdS8BJMOheS01zjCDfPMFg: mucks hand
VamsyhlFzXGF6/ydo0BHeA collected $25.95 from pot
*** SUMMARY ***
Total pot $27.25 | Rake $1.30
Board [3d 9h 2s Kc Ts]
Seat 1: VamsyhlFzXGF6/ydo0BHeA (big blind) showed [9d Qh] and won ($25.95) with a pair of Nines
Seat 2: AdS8BJMOheS01zjCDfPMFg mucked
Seat 3: c4MNIaIyPMOMxrgT8FT5nA folded before Flop (didn't bet)
Seat 5: eUBBn2R56C1IQ6Cs/vitwg (button) folded before Flop (didn't bet)
Seat 6: 1b+2BbjMN8qhR1WPqdE9VQ (small blind) folded before Flop



PokerStars Game #59940448590:  Hold'em No Limit ($0.25/$0.50) - 2009/07/01 1:06:56 ET
Table 'MJxeZCzYELxiIsyUZyT0jw' 6-max Seat #5 is the button
Seat 1: +Pf9jTVizYlIo+woPvptfA ($50 in chips)
Seat 2: t3GiVMzqA9Svgr5Uol32cQ ($28.10 in chips)
Seat 4: alGiiQP/wwtYnfuXII+sgw ($64.35 in chips)
Seat 5: 3jvoOXNtXE90w2BdfNZwZQ ($50 in chips)
Seat 6: c0n4hrn20AML9qzyFC2E8Q ($54.50 in chips)
c0n4hrn20AML9qzyFC2E8Q: posts small blind $0.25
+Pf9jTVizYlIo+woPvptfA: posts big blind $0.50
sIG4mp8tZEI+W4nKZNkkQA: sits out
*** HOLE CARDS ***
t3GiVMzqA9Svgr5Uol32cQ: folds
alGiiQP/wwtYnfuXII+sgw: folds
3jvoOXNtXE90w2BdfNZwZQ: raises $1 to $1.50
c0n4hrn20AML9qzyFC2E8Q: calls $1.25
+Pf9jTVizYlIo+woPvptfA: folds
*** FLOP *** [3s 5s 5h]
c0n4hrn20AML9qzyFC2E8Q: checks
3jvoOXNtXE90w2BdfNZwZQ: checks
*** TURN *** [3s 5s 5h] [2d]
c0n4hrn20AML9qzyFC2E8Q: bets $2
3jvoOXNtXE90w2BdfNZwZQ: folds
c0n4hrn20AML9qzyFC2E8Q collected $3.35 from pot
c0n4hrn20AML9qzyFC2E8Q: doesn't show hand
*** SUMMARY ***
Total pot $3.50 | Rake $0.15
Board [3s 5s 5h 2d]
Seat 1: +Pf9jTVizYlIo+woPvptfA (big blind) folded before Flop
Seat 2: t3GiVMzqA9Svgr5Uol32cQ folded before Flop (didn't bet)
Seat 4: alGiiQP/wwtYnfuXII+sgw folded before Flop (didn't bet)
Seat 5: 3jvoOXNtXE90w2BdfNZwZQ (button) folded on the Turn
Seat 6: c0n4hrn20AML9qzyFC2E8Q (small blind) collected ($3.35)



PokerStars Game #59940448842:  Hold'em No Limit ($0.25/$0.50) - 2009/07/01 1:06:56 ET
Table '0eJtgVAXVvBgncFdcUpXcQ' 2-max Seat #1 is the button
Seat 1: Ag6DvxX4vbRheqsv2zXKTQ ($42.45 in chips)
Seat 2: KMc4R+K9ao4Ur3rF7NGe6Q ($13.65 in chips)
Ag6DvxX4vbRheqsv2zXKTQ: posts small blind $0.25
KMc4R+K9ao4Ur3rF7NGe6Q: posts big blind $0.50
*** HOLE CARDS ***
Ag6DvxX4vbRheqsv2zXKTQ: calls $0.25
KMc4R+K9ao4Ur3rF7NGe6Q: checks
*** FLOP *** [2c Tc 3h]
KMc4R+K9ao4Ur3rF7NGe6Q: checks
Ag6DvxX4vbRheqsv2zXKTQ: bets $1
KMc4R+K9ao4Ur3rF7NGe6Q: calls $1
*** TURN *** [2c Tc 3h] [5h]
KMc4R+K9ao4Ur3rF7NGe6Q: bets $1
Ag6DvxX4vbRheqsv2zXKTQ: calls $1
*** RIVER *** [2c Tc 3h 5h] [6h]
KMc4R+K9ao4Ur3rF7NGe6Q: checks
Ag6DvxX4vbRheqsv2zXKTQ: checks
*** SHOW DOWN ***
KMc4R+K9ao4Ur3rF7NGe6Q: shows [Ad 5c] (a pair of Fives)
Ag6DvxX4vbRheqsv2zXKTQ: shows [8d 8h] (a pair of Eights)
Ag6DvxX4vbRheqsv2zXKTQ collected $4.80 from pot
*** SUMMARY ***
Total pot $5 | Rake $0.20
Board [2c Tc 3h 5h 6h]
Seat 1: Ag6DvxX4vbRheqsv2zXKTQ (button) (small blind) showed [8d 8h] and won ($4.80) with a pair of Eights
Seat 2: KMc4R+K9ao4Ur3rF7NGe6Q (big blind) showed [Ad 5c] and lost with a pair of Fives



PokerStars Game #59940448668:  Hold'em No Limit ($0.25/$0.50) - 2009/07/01 1:06:56 ET
Table 'WlCrrUP9MxwySQN5fzLFBQ' 2-max Seat #2 is the button
Seat 1: U7xFsli2XvMiGlVDxk8a/Q ($16.25 in chips)
Seat 2: JTT5TsRNqs6npc7cgI4X/w ($15.50 in chips)
JTT5TsRNqs6npc7cgI4X/w: posts small blind $0.25
U7xFsli2XvMiGlVDxk8a/Q: posts big blind $0.50
*** HOLE CARDS ***
JTT5TsRNqs6npc7cgI4X/w: folds
U7xFsli2XvMiGlVDxk8a/Q collected $0.50 from pot
U7xFsli2XvMiGlVDxk8a/Q: doesn't show hand
*** SUMMARY ***
Total pot $0.50 | Rake $0
Seat 1: U7xFsli2XvMiGlVDxk8a/Q (big blind) collected ($0.50)
Seat 2: JTT5TsRNqs6npc7cgI4X/w (button) (small blind) folded before Flop



PokerStars Game #59940449442:  Hold'em No Limit ($0.25/$0.50) - 2009/07/01 1:06:57 ET
Table 'lpxYasB1ClBSgTpCCITwhQ' 9-max Seat #8 is the button
Seat 1: mj7PS7wCH4PAl7+eYTFs7A ($50 in chips)
Seat 2: OWP/DOu+PlPK6ZZ3zYa0HA ($24.95 in chips)
Seat 3: sakr/FIfFtIZwDPmAj5Pzg ($50 in chips)
Seat 4: NnQCepdIR/AOUQn1yhYx6Q ($10 in chips)
Seat 5: IYd5zG8k7vdBNVHbHg2Pag ($35 in chips)
Seat 6: SegjDnMxWMujiD57ESNL+g ($11.35 in chips)
Seat 7: bmRtaIYKthN1F+B3JLZ3Jw ($73.40 in chips)
Seat 8: /mfensKw8/iZ1Vrx33S4xg ($19.50 in chips)
Seat 9: sUIUZ+begh92dzkUmvbMrw ($13.30 in chips)
sUIUZ+begh92dzkUmvbMrw: posts small blind $0.25
mj7PS7wCH4PAl7+eYTFs7A: posts big blind $0.50
sakr/FIfFtIZwDPmAj5Pzg: posts big blind $0.50
*** HOLE CARDS ***
OWP/DOu+PlPK6ZZ3zYa0HA: folds
sakr/FIfFtIZwDPmAj5Pzg: checks
NnQCepdIR/AOUQn1yhYx6Q: folds
IYd5zG8k7vdBNVHbHg2Pag: folds
SegjDnMxWMujiD57ESNL+g: folds
bmRtaIYKthN1F+B3JLZ3Jw: folds
/mfensKw8/iZ1Vrx33S4xg: folds
sUIUZ+begh92dzkUmvbMrw: calls $0.25
mj7PS7wCH4PAl7+eYTFs7A: checks
*** FLOP *** [Js Ad 5c]
sUIUZ+begh92dzkUmvbMrw: checks
mj7PS7wCH4PAl7+eYTFs7A: checks
sakr/FIfFtIZwDPmAj5Pzg: checks
*** TURN *** [Js Ad 5c] [4s]
sUIUZ+begh92dzkUmvbMrw: checks
mj7PS7wCH4PAl7+eYTFs7A: checks
sakr/FIfFtIZwDPmAj5Pzg: checks
*** RIVER *** [Js Ad 5c 4s] [Kd]
sUIUZ+begh92dzkUmvbMrw: checks
mj7PS7wCH4PAl7+eYTFs7A: checks
sakr/FIfFtIZwDPmAj5Pzg has timed out
sakr/FIfFtIZwDPmAj5Pzg: checks
*** SHOW DOWN ***
sUIUZ+begh92dzkUmvbMrw: shows [9h Ts] (high card Ace)
mj7PS7wCH4PAl7+eYTFs7A: shows [4c 6d] (a pair of Fours)
sakr/FIfFtIZwDPmAj5Pzg: shows [Qc Th] (a straight, Ten to Ace)
sakr/FIfFtIZwDPmAj5Pzg collected $1.45 from pot
*** SUMMARY ***
Total pot $1.50 | Rake $0.05
Board [Js Ad 5c 4s Kd]
Seat 1: mj7PS7wCH4PAl7+eYTFs7A (big blind) showed [4c 6d] and lost with a pair of Fours
Seat 2: OWP/DOu+PlPK6ZZ3zYa0HA folded before Flop (didn't bet)
Seat 3: sakr/FIfFtIZwDPmAj5Pzg showed [Qc Th] and won ($1.45) with a straight, Ten to Ace
Seat 4: NnQCepdIR/AOUQn1yhYx6Q folded before Flop (didn't bet)
Seat 5: IYd5zG8k7vdBNVHbHg2Pag folded before Flop (didn't bet)
Seat 6: SegjDnMxWMujiD57ESNL+g folded before Flop (didn't bet)
Seat 7: bmRtaIYKthN1F+B3JLZ3Jw folded before Flop (didn't bet)
Seat 8: /mfensKw8/iZ1Vrx33S4xg (button) folded before Flop (didn't bet)
Seat 9: sUIUZ+begh92dzkUmvbMrw (small blind) showed [9h Ts] and lost with high card Ace



PokerStars Game #59940450730:  Hold'em No Limit ($0.25/$0.50) - 2009/07/01 1:06:59 ET
Table 'Nz0Vr7WMHL2g5Uk7dDZjpw' 9-max Seat #9 is the button
Seat 1: tLkxo7JgV+WWI0UBw44K5A ($107.35 in chips)
Seat 2: gsyXT42WLEcOS4DdEk2wlw ($29.25 in chips)
Seat 3: hoglu9inkgs6zN573/bJag ($10 in chips)
Seat 4: E2518gp4aFz1+kAgmGqeEg ($13.30 in chips)
Seat 5: WGW0DgjBUXs1ylURHG8vnQ ($21.85 in chips)
Seat 6: 997ViqAtWn1FPjJqcffwcA ($59.80 in chips)
Seat 7: KPLH0gELgFe2OuAnhJFI5w ($23.45 in chips)
Seat 8: HkZI6g4zl83TDTA7SRspmQ ($27.15 in chips)
Seat 9: mSD1pginDsyHG5PDfqzphw ($10 in chips)
tLkxo7JgV+WWI0UBw44K5A: posts small blind $0.25
gsyXT42WLEcOS4DdEk2wlw: posts big blind $0.50
hoglu9inkgs6zN573/bJag: posts big blind $0.50
*** HOLE CARDS ***
hoglu9inkgs6zN573/bJag: checks
E2518gp4aFz1+kAgmGqeEg: folds
WGW0DgjBUXs1ylURHG8vnQ: folds
997ViqAtWn1FPjJqcffwcA: folds
KPLH0gELgFe2OuAnhJFI5w: folds
HkZI6g4zl83TDTA7SRspmQ: folds
HkZI6g4zl83TDTA7SRspmQ leaves the table
mSD1pginDsyHG5PDfqzphw: folds
tLkxo7JgV+WWI0UBw44K5A: folds
gsyXT42WLEcOS4DdEk2wlw: checks
*** FLOP *** [Th Jd 8d]
gsyXT42WLEcOS4DdEk2wlw: checks
hoglu9inkgs6zN573/bJag: bets $0.50
gsyXT42WLEcOS4DdEk2wlw: calls $0.50
*** TURN *** [Th Jd 8d] [Ac]
gsyXT42WLEcOS4DdEk2wlw: checks
hoglu9inkgs6zN573/bJag: bets $0.50
gsyXT42WLEcOS4DdEk2wlw: calls $0.50
*** RIVER *** [Th Jd 8d Ac] [4s]
gsyXT42WLEcOS4DdEk2wlw: checks
hoglu9inkgs6zN573/bJag: checks
*** SHOW DOWN ***
gsyXT42WLEcOS4DdEk2wlw: shows [Td 7h] (a pair of Tens)
hoglu9inkgs6zN573/bJag: mucks hand
gsyXT42WLEcOS4DdEk2wlw collected $3.10 from pot
*** SUMMARY ***
Total pot $3.25 | Rake $0.15
Board [Th Jd 8d Ac 4s]
Seat 1: tLkxo7JgV+WWI0UBw44K5A (small blind) folded before Flop
Seat 2: gsyXT42WLEcOS4DdEk2wlw (big blind) showed [Td 7h] and won ($3.10) with a pair of Tens
Seat 3: hoglu9inkgs6zN573/bJag mucked
Seat 4: E2518gp4aFz1+kAgmGqeEg folded before Flop (didn't bet)
Seat 5: WGW0DgjBUXs1ylURHG8vnQ folded before Flop (didn't bet)
Seat 6: 997ViqAtWn1FPjJqcffwcA folded before Flop (didn't bet)
Seat 7: KPLH0gELgFe2OuAnhJFI5w folded before Flop (didn't bet)
Seat 8: HkZI6g4zl83TDTA7SRspmQ folded before Flop (didn't bet)
Seat 9: mSD1pginDsyHG5PDfqzphw (button) folded before Flop (didn't bet)



PokerStars Game #59940451104:  Hold'em No Limit ($0.25/$0.50) - 2009/07/01 1:07:00 ET
Table '8BQGgNetI1NOvWeu3gtMNw' 2-max Seat #1 is the button
Seat 1: bypIyrYcAAifLfhZpGlKLA ($98.40 in chips)
Seat 2: Z4HwehErEwzsv/noQlfUlg ($101 in chips)
bypIyrYcAAifLfhZpGlKLA: posts small blind $0.25
Z4HwehErEwzsv/noQlfUlg: posts big blind $0.50
*** HOLE CARDS ***
bypIyrYcAAifLfhZpGlKLA: raises $1 to $1.50
Z4HwehErEwzsv/noQlfUlg: raises $1 to $2.50
bypIyrYcAAifLfhZpGlKLA: calls $1
*** FLOP *** [7c Jc Qs]
Z4HwehErEwzsv/noQlfUlg: checks
bypIyrYcAAifLfhZpGlKLA: checks
*** TURN *** [7c Jc Qs] [8s]
Z4HwehErEwzsv/noQlfUlg: checks
bypIyrYcAAifLfhZpGlKLA: checks
*** RIVER *** [7c Jc Qs 8s] [4d]
Z4HwehErEwzsv/noQlfUlg: checks
bypIyrYcAAifLfhZpGlKLA: checks
*** SHOW DOWN ***
Z4HwehErEwzsv/noQlfUlg: shows [3s Kh] (high card King)
bypIyrYcAAifLfhZpGlKLA: mucks hand
Z4HwehErEwzsv/noQlfUlg collected $4.75 from pot
*** SUMMARY ***
Total pot $5 | Rake $0.25
Board [7c Jc Qs 8s 4d]
Seat 1: bypIyrYcAAifLfhZpGlKLA (button) (small blind) mucked
Seat 2: Z4HwehErEwzsv/noQlfUlg (big blind) showed [3s Kh] and won ($4.75) with high card King



PokerStars Game #59940451916:  Hold'em No Limit ($0.25/$0.50) - 2009/07/01 1:07:01 ET
Table 'c/CRn+68J3Y8KxD5g1ek2Q' 2-max Seat #2 is the button
Seat 1: 46qCyJ6evTkHo9al5sBMNA ($90.80 in chips)
Seat 2: BypVLsYQt3ePFm2xQL/dOA ($275.65 in chips)
BypVLsYQt3ePFm2xQL/dOA: posts small blind $0.25
46qCyJ6evTkHo9al5sBMNA: posts big blind $0.50
*** HOLE CARDS ***
BypVLsYQt3ePFm2xQL/dOA: calls $0.25
46qCyJ6evTkHo9al5sBMNA: raises $1 to $1.50
BypVLsYQt3ePFm2xQL/dOA: calls $1
*** FLOP *** [8c Td 7d]
46qCyJ6evTkHo9al5sBMNA: bets $1.50
BypVLsYQt3ePFm2xQL/dOA: calls $1.50
*** TURN *** [8c Td 7d] [9h]
46qCyJ6evTkHo9al5sBMNA: bets $3
BypVLsYQt3ePFm2xQL/dOA: calls $3
*** RIVER *** [8c Td 7d 9h] [Ad]
46qCyJ6evTkHo9al5sBMNA: checks
BypVLsYQt3ePFm2xQL/dOA: checks
*** SHOW DOWN ***
46qCyJ6evTkHo9al5sBMNA: shows [5s 6s] (a straight, Six to Ten)
BypVLsYQt3ePFm2xQL/dOA: mucks hand
46qCyJ6evTkHo9al5sBMNA collected $11.50 from pot
*** SUMMARY ***
Total pot $12 | Rake $0.50
Board [8c Td 7d 9h Ad]
Seat 1: 46qCyJ6evTkHo9al5sBMNA (big blind) showed [5s 6s] and won ($11.50) with a straight, Six to Ten
Seat 2: BypVLsYQt3ePFm2xQL/dOA (button) (small blind) mucked



PokerStars Game #59940451588:  Hold'em No Limit ($0.25/$0.50) - 2009/07/01 1:07:01 ET
Table 'lSisgp6H7Fg1hH5VfjEjYQ' 9-max Seat #2 is the button
Seat 1: 5k9fvXD9suIgCxU4HLQjTw ($50.35 in chips)
Seat 2: UrcnkQOiLVk8BlKDPJSy7Q ($76.55 in chips)
Seat 3: aTkyjTh3w5YLWiIERupZOA ($51.65 in chips)
Seat 4: bwv/rbH/hHhPhY6u9mu04w ($30.75 in chips)
Seat 5: mSD1pginDsyHG5PDfqzphw ($10 in chips)
Seat 6: +k7T5ocke8UwavtgUHm+Cg ($66.30 in chips)
Seat 7: IDtNLR9uFCDdjNsJWMHA5Q ($23.55 in chips)
Seat 8: a4JDWmpFQkL10XfAyuF51A ($27 in chips)
Seat 9: YzeKFbJVLmJGTgNH3ySQlw ($9.50 in chips)
aTkyjTh3w5YLWiIERupZOA: posts small blind $0.25
bwv/rbH/hHhPhY6u9mu04w: posts big blind $0.50
*** HOLE CARDS ***
mSD1pginDsyHG5PDfqzphw: folds
+k7T5ocke8UwavtgUHm+Cg: folds
IDtNLR9uFCDdjNsJWMHA5Q: calls $0.50
a4JDWmpFQkL10XfAyuF51A: folds
YzeKFbJVLmJGTgNH3ySQlw: raises $1 to $1.50
5k9fvXD9suIgCxU4HLQjTw: folds
UrcnkQOiLVk8BlKDPJSy7Q: folds
aTkyjTh3w5YLWiIERupZOA: folds
bwv/rbH/hHhPhY6u9mu04w: folds
IDtNLR9uFCDdjNsJWMHA5Q: calls $1
*** FLOP *** [9d 9s 6s]
IDtNLR9uFCDdjNsJWMHA5Q: checks
YzeKFbJVLmJGTgNH3ySQlw: bets $1.50
IDtNLR9uFCDdjNsJWMHA5Q: calls $1.50
*** TURN *** [9d 9s 6s] [3h]
IDtNLR9uFCDdjNsJWMHA5Q: checks
YzeKFbJVLmJGTgNH3ySQlw: bets $5.50
IDtNLR9uFCDdjNsJWMHA5Q: folds
YzeKFbJVLmJGTgNH3ySQlw collected $6.45 from pot
*** SUMMARY ***
Total pot $6.75 | Rake $0.30
Board [9d 9s 6s 3h]
Seat 1: 5k9fvXD9suIgCxU4HLQjTw folded before Flop (didn't bet)
Seat 2: UrcnkQOiLVk8BlKDPJSy7Q (button) folded before Flop (didn't bet)
Seat 3: aTkyjTh3w5YLWiIERupZOA (small blind) folded before Flop
Seat 4: bwv/rbH/hHhPhY6u9mu04w (big blind) folded before Flop
Seat 5: mSD1pginDsyHG5PDfqzphw folded before Flop (didn't bet)
Seat 6: +k7T5ocke8UwavtgUHm+Cg folded before Flop (didn't bet)
Seat 7: IDtNLR9uFCDdjNsJWMHA5Q folded on the Turn
Seat 8: a4JDWmpFQkL10XfAyuF51A folded before Flop (didn't bet)
Seat 9: YzeKFbJVLmJGTgNH3ySQlw collected ($6.45)



PokerStars Game #59940451954:  Hold'em No Limit ($0.25/$0.50) - 2009/07/01 1:07:01 ET
Table '37qXEp3oe+er5q4CZip9eQ' 6-max Seat #4 is the button
Seat 2: LvH4G7n+QSjT6NDaD3cREA ($57.05 in chips)
Seat 3: Rt6KgtZ8YaJoTc3FPim00w ($110.20 in chips)
Seat 4: XsmE8nXMAAMFJbWaJTmHFw ($39.10 in chips)
Seat 5: VOmI0x4dDPnTESZd5B4d1Q ($42.75 in chips)
Seat 6: N50kln4negd8q7Mmoz1j4g ($16.60 in chips)
VOmI0x4dDPnTESZd5B4d1Q: posts small blind $0.25
N50kln4negd8q7Mmoz1j4g: posts big blind $0.50
lxIzoHy0RnkfFSODHC2liw: sits out
*** HOLE CARDS ***
LvH4G7n+QSjT6NDaD3cREA: folds
Rt6KgtZ8YaJoTc3FPim00w: folds
XsmE8nXMAAMFJbWaJTmHFw: raises $1 to $1.50
VOmI0x4dDPnTESZd5B4d1Q said, "6 2os?"
VOmI0x4dDPnTESZd5B4d1Q: folds
N50kln4negd8q7Mmoz1j4g: calls $1
*** FLOP *** [4s 5h Ad]
N50kln4negd8q7Mmoz1j4g: checks
XsmE8nXMAAMFJbWaJTmHFw: bets $1.50
N50kln4negd8q7Mmoz1j4g: calls $1.50
*** TURN *** [4s 5h Ad] [4c]
N50kln4negd8q7Mmoz1j4g: checks
XsmE8nXMAAMFJbWaJTmHFw: checks
*** RIVER *** [4s 5h Ad 4c] [7s]
N50kln4negd8q7Mmoz1j4g: bets $4
XsmE8nXMAAMFJbWaJTmHFw: calls $4
*** SHOW DOWN ***
N50kln4negd8q7Mmoz1j4g: shows [3h 3c] (two pair, Fours and Threes)
XsmE8nXMAAMFJbWaJTmHFw: shows [9s Ah] (two pair, Aces and Fours)
XsmE8nXMAAMFJbWaJTmHFw collected $13.60 from pot
*** SUMMARY ***
Total pot $14.25 | Rake $0.65
Board [4s 5h Ad 4c 7s]
Seat 2: LvH4G7n+QSjT6NDaD3cREA folded before Flop (didn't bet)
Seat 3: Rt6KgtZ8YaJoTc3FPim00w folded before Flop (didn't bet)
Seat 4: XsmE8nXMAAMFJbWaJTmHFw (button) showed [9s Ah] and won ($13.60) with two pair, Aces and Fours
Seat 5: VOmI0x4dDPnTESZd5B4d1Q (small blind) folded before Flop
Seat 6: N50kln4negd8q7Mmoz1j4g (big blind) showed [3h 3c] and lost with two pair, Fours and Threes



PokerStars Game #59940452444:  Hold'em No Limit ($0.25/$0.50) - 2009/07/01 1:07:02 ET
Table 'NCiXr0d5CEKBQr/cZgLhbA' 9-max Seat #6 is the button
Seat 1: pFtzb1sR4b0d1aw6aIRgDg ($50 in chips)
Seat 2: ulxuJchBV9iguXg0FUonfg ($19.40 in chips)
Seat 3: xZCXQSXlrZkp3pZizzVXCw ($51.95 in chips)
Seat 4: 5k9fvXD9suIgCxU4HLQjTw ($52.45 in chips)
Seat 5: zE9cVigS2nW/Ljy4K4bUQA ($65.10 in chips)
Seat 6: SKnJuWHScqetA/qG5p+wCg ($32.75 in chips)
Seat 7: M+7+BTmX5vZatHVuoRB1nA ($52.25 in chips)
Seat 8: 1MJUKc3cc0QmUoz1JZLR2w ($64.05 in chips)
Seat 9: 4WLZvqBn5qv5tds5kt5A1Q ($40.15 in chips)
M+7+BTmX5vZatHVuoRB1nA: posts small blind $0.25
1MJUKc3cc0QmUoz1JZLR2w: posts big blind $0.50
*** HOLE CARDS ***
4WLZvqBn5qv5tds5kt5A1Q: folds
pFtzb1sR4b0d1aw6aIRgDg: folds
ulxuJchBV9iguXg0FUonfg: folds
xZCXQSXlrZkp3pZizzVXCw: folds
5k9fvXD9suIgCxU4HLQjTw: folds
zE9cVigS2nW/Ljy4K4bUQA: folds
ulxuJchBV9iguXg0FUonfg said, "pompy... u let me get to the river with a check and a smooth call... if anyone misplayed it, it was you with your ace trap"
SKnJuWHScqetA/qG5p+wCg: folds
M+7+BTmX5vZatHVuoRB1nA: folds
1MJUKc3cc0QmUoz1JZLR2w collected $0.50 from pot
*** SUMMARY ***
Total pot $0.50 | Rake $0
Seat 1: pFtzb1sR4b0d1aw6aIRgDg folded before Flop (didn't bet)
Seat 2: ulxuJchBV9iguXg0FUonfg folded before Flop (didn't bet)
Seat 3: xZCXQSXlrZkp3pZizzVXCw folded before Flop (didn't bet)
Seat 4: 5k9fvXD9suIgCxU4HLQjTw folded before Flop (didn't bet)
Seat 5: zE9cVigS2nW/Ljy4K4bUQA folded before Flop (didn't bet)
Seat 6: SKnJuWHScqetA/qG5p+wCg (button) folded before Flop (didn't bet)
Seat 7: M+7+BTmX5vZatHVuoRB1nA (small blind) folded before Flop
Seat 8: 1MJUKc3cc0QmUoz1JZLR2w (big blind) collected ($0.50)
Seat 9: 4WLZvqBn5qv5tds5kt5A1Q folded before Flop (didn't bet)



PokerStars Game #59940452270:  Hold'em No Limit ($0.25/$0.50) - 2009/07/01 1:07:02 ET
Table 'WlCrrUP9MxwySQN5fzLFBQ' 2-max Seat #1 is the button
Seat 1: U7xFsli2XvMiGlVDxk8a/Q ($16.50 in chips)
Seat 2: JTT5TsRNqs6npc7cgI4X/w ($15.25 in chips)
U7xFsli2XvMiGlVDxk8a/Q: posts small blind $0.25
JTT5TsRNqs6npc7cgI4X/w: posts big blind $0.50
*** HOLE CARDS ***
U7xFsli2XvMiGlVDxk8a/Q: raises $0.50 to $1
JTT5TsRNqs6npc7cgI4X/w: calls $0.50
*** FLOP *** [Jh 7d 6h]
JTT5TsRNqs6npc7cgI4X/w: checks
U7xFsli2XvMiGlVDxk8a/Q: checks
*** TURN *** [Jh 7d 6h] [6d]
JTT5TsRNqs6npc7cgI4X/w: checks
U7xFsli2XvMiGlVDxk8a/Q: checks
*** RIVER *** [Jh 7d 6h 6d] [5h]
JTT5TsRNqs6npc7cgI4X/w: bets $2.50
U7xFsli2XvMiGlVDxk8a/Q: calls $2.50
*** SHOW DOWN ***
JTT5TsRNqs6npc7cgI4X/w: shows [3c Td] (a pair of Sixes)
U7xFsli2XvMiGlVDxk8a/Q: shows [7c 9s] (two pair, Sevens and Sixes)
U7xFsli2XvMiGlVDxk8a/Q collected $6.70 from pot
*** SUMMARY ***
Total pot $7 | Rake $0.30
Board [Jh 7d 6h 6d 5h]
Seat 1: U7xFsli2XvMiGlVDxk8a/Q (button) (small blind) showed [7c 9s] and won ($6.70) with two pair, Sevens and Sixes
Seat 2: JTT5TsRNqs6npc7cgI4X/w (big blind) showed [3c Td] and lost with a pair of Sixes



PokerStars Game #59940455484:  Hold'em No Limit ($0.25/$0.50) - 2009/07/01 1:07:07 ET
Table '+dXkOAQyS8j9PQZusUTMpg' 2-max Seat #2 is the button
Seat 1: XFa6sBGjP2gxoIvxR3fZIg ($118.40 in chips)
Seat 2: 5IBeOgaApY1Bvzv2P8X4EA ($77.35 in chips)
5IBeOgaApY1Bvzv2P8X4EA: posts small blind $0.25
XFa6sBGjP2gxoIvxR3fZIg: posts big blind $0.50
*** HOLE CARDS ***
5IBeOgaApY1Bvzv2P8X4EA: folds
XFa6sBGjP2gxoIvxR3fZIg collected $0.50 from pot
XFa6sBGjP2gxoIvxR3fZIg: doesn't show hand
*** SUMMARY ***
Total pot $0.50 | Rake $0
Seat 1: XFa6sBGjP2gxoIvxR3fZIg (big blind) collected ($0.50)
Seat 2: 5IBeOgaApY1Bvzv2P8X4EA (button) (small blind) folded before Flop



PokerStars Game #59940455598:  Hold'em No Limit ($0.25/$0.50) - 2009/07/01 1:07:07 ET
Table 'GfL/No5u5PoEnU39lP5pQg' 6-max Seat #4 is the button
Seat 1: 1WUCqNG+p+vfWRTXNu4ljw ($64.50 in chips)
Seat 2: uVwggSetzp7d+eVgowO3vg ($57 in chips)
Seat 3: eQXFICMuu3hw6XlcmuVNEA ($21.35 in chips)
Seat 4: r6u7MWSXF30/khcTYkrG9Q ($35.15 in chips)
Seat 5: M1KyQQvVPVuxqTAB8sR/zQ ($50.50 in chips)
Seat 6: kxPhs4ePFqMy52CInAJ2aw ($49.25 in chips)
M1KyQQvVPVuxqTAB8sR/zQ: posts small blind $0.25
kxPhs4ePFqMy52CInAJ2aw: posts big blind $0.50
*** HOLE CARDS ***
1WUCqNG+p+vfWRTXNu4ljw: folds
uVwggSetzp7d+eVgowO3vg: folds
eQXFICMuu3hw6XlcmuVNEA: calls $0.50
r6u7MWSXF30/khcTYkrG9Q: folds
M1KyQQvVPVuxqTAB8sR/zQ: calls $0.25
kxPhs4ePFqMy52CInAJ2aw: checks
*** FLOP *** [Ac 7d Qh]
M1KyQQvVPVuxqTAB8sR/zQ: checks
kxPhs4ePFqMy52CInAJ2aw: bets $1
eQXFICMuu3hw6XlcmuVNEA: calls $1
M1KyQQvVPVuxqTAB8sR/zQ: folds
*** TURN *** [Ac 7d Qh] [5c]
kxPhs4ePFqMy52CInAJ2aw: bets $25
eQXFICMuu3hw6XlcmuVNEA: folds
kxPhs4ePFqMy52CInAJ2aw collected $3.35 from pot
kxPhs4ePFqMy52CInAJ2aw: doesn't show hand
*** SUMMARY ***
Total pot $3.50 | Rake $0.15
Board [Ac 7d Qh 5c]
Seat 1: 1WUCqNG+p+vfWRTXNu4ljw folded before Flop (didn't bet)
Seat 2: uVwggSetzp7d+eVgowO3vg folded before Flop (didn't bet)
Seat 3: eQXFICMuu3hw6XlcmuVNEA folded on the Turn
Seat 4: r6u7MWSXF30/khcTYkrG9Q (button) folded before Flop (didn't bet)
Seat 5: M1KyQQvVPVuxqTAB8sR/zQ (small blind) folded on the Flop
Seat 6: kxPhs4ePFqMy52CInAJ2aw (big blind) collected ($3.35)



PokerStars Game #59940455166:  Hold'em No Limit ($0.25/$0.50) - 2009/07/01 1:07:07 ET
Table 'fx6MqwfYAj/Rt86hBz2L3Q' 9-max Seat #4 is the button
Seat 1: uw9QayAAxLM3Hb+HR7mSkg ($10.50 in chips)
Seat 2: C3rGXblctNcWI6JYPHhaEg ($24.75 in chips)
Seat 3: iadBi5AEt7gTBXbDSSnMYQ ($56.10 in chips)
Seat 4: 75K2MXwN65Sjfp1yHd50Hg ($8.50 in chips)
Seat 5: iAISe3dVeua8PUn2wwgDHw ($58.75 in chips)
Seat 6: 5k9fvXD9suIgCxU4HLQjTw ($50.75 in chips)
Seat 7: SKnJuWHScqetA/qG5p+wCg ($30 in chips)
Seat 8: JYwJYYV9pM5KWdSiETl8rA ($19.25 in chips)
Seat 9: HZkVla4kK2SI42CVrPZ/ig ($18.30 in chips)
iAISe3dVeua8PUn2wwgDHw: posts small blind $0.25
5k9fvXD9suIgCxU4HLQjTw: posts big blind $0.50
*** HOLE CARDS ***
SKnJuWHScqetA/qG5p+wCg: folds
JYwJYYV9pM5KWdSiETl8rA: folds
HZkVla4kK2SI42CVrPZ/ig: folds
uw9QayAAxLM3Hb+HR7mSkg: folds
C3rGXblctNcWI6JYPHhaEg: calls $0.50
iadBi5AEt7gTBXbDSSnMYQ: calls $0.50
75K2MXwN65Sjfp1yHd50Hg: raises $2.50 to $3
iAISe3dVeua8PUn2wwgDHw: folds
5k9fvXD9suIgCxU4HLQjTw: folds
C3rGXblctNcWI6JYPHhaEg: calls $2.50
iadBi5AEt7gTBXbDSSnMYQ: folds
*** FLOP *** [9s Th 3h]
C3rGXblctNcWI6JYPHhaEg: checks
75K2MXwN65Sjfp1yHd50Hg: bets $5.50 and is all-in
C3rGXblctNcWI6JYPHhaEg: calls $5.50
*** TURN *** [9s Th 3h] [2c]
*** RIVER *** [9s Th 3h 2c] [6s]
*** SHOW DOWN ***
C3rGXblctNcWI6JYPHhaEg: shows [7h 7s] (a pair of Sevens)
75K2MXwN65Sjfp1yHd50Hg: mucks hand
C3rGXblctNcWI6JYPHhaEg collected $17.40 from pot
*** SUMMARY ***
Total pot $18.25 | Rake $0.85
Board [9s Th 3h 2c 6s]
Seat 1: uw9QayAAxLM3Hb+HR7mSkg folded before Flop (didn't bet)
Seat 2: C3rGXblctNcWI6JYPHhaEg showed [7h 7s] and won ($17.40) with a pair of Sevens
Seat 3: iadBi5AEt7gTBXbDSSnMYQ folded before Flop
Seat 4: 75K2MXwN65Sjfp1yHd50Hg (button) mucked
Seat 5: iAISe3dVeua8PUn2wwgDHw (small blind) folded before Flop
Seat 6: 5k9fvXD9suIgCxU4HLQjTw (big blind) folded before Flop
Seat 7: SKnJuWHScqetA/qG5p+wCg folded before Flop (didn't bet)
Seat 8: JYwJYYV9pM5KWdSiETl8rA folded before Flop (didn't bet)
Seat 9: HZkVla4kK2SI42CVrPZ/ig folded before Flop (didn't bet)



PokerStars Game #59940457052:  Hold'em No Limit ($0.25/$0.50) - 2009/07/01 1:07:10 ET
Table 'EiNh8p/wGJ1FP575iMFnqg' 9-max Seat #9 is the button
Seat 1: r3ZqM1Mi0W3y4hOdssE+Sg ($44.35 in chips)
Seat 2: 8ehL7qlZzjgUh2H35iiWLw ($54.15 in chips)
Seat 3: ymLPoEIl7UL3TvZYmnadxQ ($55.25 in chips)
Seat 4: cMzaiXAM/ZAdNaEUu+LqhA ($54.95 in chips)
Seat 5: M+7+BTmX5vZatHVuoRB1nA ($80.45 in chips)
Seat 6: 3UmXLy3GfjC3EkOebduerQ ($61.60 in chips)
Seat 7: 997ViqAtWn1FPjJqcffwcA ($50 in chips)
Seat 8: mSD1pginDsyHG5PDfqzphw ($10 in chips)
Seat 9: NnQCepdIR/AOUQn1yhYx6Q ($21.50 in chips)
r3ZqM1Mi0W3y4hOdssE+Sg: posts small blind $0.25
8ehL7qlZzjgUh2H35iiWLw: posts big blind $0.50
*** HOLE CARDS ***
ymLPoEIl7UL3TvZYmnadxQ: calls $0.50
cMzaiXAM/ZAdNaEUu+LqhA: folds
M+7+BTmX5vZatHVuoRB1nA: folds
3UmXLy3GfjC3EkOebduerQ: folds
997ViqAtWn1FPjJqcffwcA: folds
mSD1pginDsyHG5PDfqzphw: folds
NnQCepdIR/AOUQn1yhYx6Q: folds
r3ZqM1Mi0W3y4hOdssE+Sg: calls $0.25
8ehL7qlZzjgUh2H35iiWLw: checks
*** FLOP *** [4h Qh 7d]
r3ZqM1Mi0W3y4hOdssE+Sg: checks
8ehL7qlZzjgUh2H35iiWLw: checks
ymLPoEIl7UL3TvZYmnadxQ: bets $1
r3ZqM1Mi0W3y4hOdssE+Sg: calls $1
8ehL7qlZzjgUh2H35iiWLw: folds
*** TURN *** [4h Qh 7d] [8d]
r3ZqM1Mi0W3y4hOdssE+Sg: checks
ymLPoEIl7UL3TvZYmnadxQ: bets $2
r3ZqM1Mi0W3y4hOdssE+Sg: calls $2
*** RIVER *** [4h Qh 7d 8d] [9c]
r3ZqM1Mi0W3y4hOdssE+Sg: checks
ymLPoEIl7UL3TvZYmnadxQ: checks
*** SHOW DOWN ***
r3ZqM1Mi0W3y4hOdssE+Sg: shows [6c Qc] (a pair of Queens)
ymLPoEIl7UL3TvZYmnadxQ: shows [Qs Jh] (a pair of Queens - Jack kicker)
ymLPoEIl7UL3TvZYmnadxQ collected $7.15 from pot
*** SUMMARY ***
Total pot $7.50 | Rake $0.35
Board [4h Qh 7d 8d 9c]
Seat 1: r3ZqM1Mi0W3y4hOdssE+Sg (small blind) showed [6c Qc] and lost with a pair of Queens
Seat 2: 8ehL7qlZzjgUh2H35iiWLw (big blind) folded on the Flop
Seat 3: ymLPoEIl7UL3TvZYmnadxQ showed [Qs Jh] and won ($7.15) with a pair of Queens
Seat 4: cMzaiXAM/ZAdNaEUu+LqhA folded before Flop (didn't bet)
Seat 5: M+7+BTmX5vZatHVuoRB1nA folded before Flop (didn't bet)
Seat 6: 3UmXLy3GfjC3EkOebduerQ folded before Flop (didn't bet)
Seat 7: 997ViqAtWn1FPjJqcffwcA folded before Flop (didn't bet)
Seat 8: mSD1pginDsyHG5PDfqzphw folded before Flop (didn't bet)
Seat 9: NnQCepdIR/AOUQn1yhYx6Q (button) folded before Flop (didn't bet)



PokerStars Game #59940458854:  Hold'em No Limit ($0.25/$0.50) - 2009/07/01 1:07:13 ET
Table '0eJtgVAXVvBgncFdcUpXcQ' 2-max Seat #2 is the button
Seat 1: Ag6DvxX4vbRheqsv2zXKTQ ($44.75 in chips)
Seat 2: KMc4R+K9ao4Ur3rF7NGe6Q ($11.15 in chips)
KMc4R+K9ao4Ur3rF7NGe6Q: posts small blind $0.25
Ag6DvxX4vbRheqsv2zXKTQ: posts big blind $0.50
*** HOLE CARDS ***
KMc4R+K9ao4Ur3rF7NGe6Q: raises $1 to $1.50
Ag6DvxX4vbRheqsv2zXKTQ: folds
KMc4R+K9ao4Ur3rF7NGe6Q collected $1 from pot
KMc4R+K9ao4Ur3rF7NGe6Q: doesn't show hand
*** SUMMARY ***
Total pot $1 | Rake $0
Seat 1: Ag6DvxX4vbRheqsv2zXKTQ (big blind) folded before Flop
Seat 2: KMc4R+K9ao4Ur3rF7NGe6Q (button) (small blind) collected ($1)



PokerStars Game #59940459234:  Hold'em No Limit ($0.25/$0.50) - 2009/07/01 1:07:14 ET
Table '+dXkOAQyS8j9PQZusUTMpg' 2-max Seat #1 is the button
Seat 1: XFa6sBGjP2gxoIvxR3fZIg ($118.65 in chips)
Seat 2: 5IBeOgaApY1Bvzv2P8X4EA ($77.10 in chips)
XFa6sBGjP2gxoIvxR3fZIg: posts small blind $0.25
5IBeOgaApY1Bvzv2P8X4EA: posts big blind $0.50
*** HOLE CARDS ***
XFa6sBGjP2gxoIvxR3fZIg: raises $1 to $1.50
5IBeOgaApY1Bvzv2P8X4EA: folds
XFa6sBGjP2gxoIvxR3fZIg collected $1 from pot
*** SUMMARY ***
Total pot $1 | Rake $0
Seat 1: XFa6sBGjP2gxoIvxR3fZIg (button) (small blind) collected ($1)
Seat 2: 5IBeOgaApY1Bvzv2P8X4EA (big blind) folded before Flop



PokerStars Game #59940460060:  Hold'em No Limit ($0.25/$0.50) - 2009/07/01 1:07:15 ET
Table 'E7bWJ45aoFXRpyRv2gw+Ig' 2-max Seat #2 is the button
Seat 1: FRkiRasEGlHUeLrEl+k/nA ($57.70 in chips)
Seat 2: 3Wro85I7472vJ4Wkpneo9A ($129.75 in chips)
3Wro85I7472vJ4Wkpneo9A: posts small blind $0.25
FRkiRasEGlHUeLrEl+k/nA: posts big blind $0.50
*** HOLE CARDS ***
3Wro85I7472vJ4Wkpneo9A: raises $1 to $1.50
FRkiRasEGlHUeLrEl+k/nA: folds
3Wro85I7472vJ4Wkpneo9A collected $1 from pot
3Wro85I7472vJ4Wkpneo9A: doesn't show hand
*** SUMMARY ***
Total pot $1 | Rake $0
Seat 1: FRkiRasEGlHUeLrEl+k/nA (big blind) folded before Flop
Seat 2: 3Wro85I7472vJ4Wkpneo9A (button) (small blind) collected ($1)



PokerStars Game #59940461396:  Hold'em No Limit ($0.25/$0.50) - 2009/07/01 1:07:17 ET
Table 'QOgaEqMcJ73pcUMMxoisUg' 6-max Seat #5 is the button
Seat 1: lxIzoHy0RnkfFSODHC2liw ($54.10 in chips)
Seat 2: oqOqoO2AyCZenUghCxMDxw ($51.60 in chips)
Seat 3: Rt6KgtZ8YaJoTc3FPim00w ($53.75 in chips)
Seat 4: zAcsDhG/T128Vn7XGVSgKg ($50 in chips)
Seat 5: 6vNxrjjCl6FwfaaymM9jjg ($20 in chips)
Seat 6: AdS8BJMOheS01zjCDfPMFg ($49.50 in chips)
AdS8BJMOheS01zjCDfPMFg: posts small blind $0.25
lxIzoHy0RnkfFSODHC2liw: posts big blind $0.50
*** HOLE CARDS ***
oqOqoO2AyCZenUghCxMDxw: folds
Rt6KgtZ8YaJoTc3FPim00w: folds
zAcsDhG/T128Vn7XGVSgKg: folds
6vNxrjjCl6FwfaaymM9jjg: raises $1.50 to $2
AdS8BJMOheS01zjCDfPMFg: folds
lxIzoHy0RnkfFSODHC2liw: folds
6vNxrjjCl6FwfaaymM9jjg collected $1.25 from pot
*** SUMMARY ***
Total pot $1.25 | Rake $0
Seat 1: lxIzoHy0RnkfFSODHC2liw (big blind) folded before Flop
Seat 2: oqOqoO2AyCZenUghCxMDxw folded before Flop (didn't bet)
Seat 3: Rt6KgtZ8YaJoTc3FPim00w folded before Flop (didn't bet)
Seat 4: zAcsDhG/T128Vn7XGVSgKg folded before Flop (didn't bet)
Seat 5: 6vNxrjjCl6FwfaaymM9jjg (button) collected ($1.25)
Seat 6: AdS8BJMOheS01zjCDfPMFg (small blind) folded before Flop



PokerStars Game #59940460980:  Hold'em No Limit ($0.25/$0.50) - 2009/07/01 1:07:17 ET
Table 'ibNfFy0bCzuBaUORla0aGw' 9-max Seat #2 is the button
Seat 1: xZCXQSXlrZkp3pZizzVXCw ($50.55 in chips)
Seat 2: 90Wb75h3W1BRpbqVnuk8gw ($53.50 in chips)
Seat 3: AjV5McH1KMMclY26QdLM5w ($25 in chips)
Seat 4: YBN054X4blmis+B2bBlC0g ($22.20 in chips)
Seat 5: GIJAc9kPrLZHLSX8Q6i99w ($22.45 in chips)
Seat 7: HZkVla4kK2SI42CVrPZ/ig ($14.30 in chips)
Seat 8: 2CfOMUqXsQk69Igusq28Pg ($11.20 in chips)
Seat 9: pFtzb1sR4b0d1aw6aIRgDg ($50.05 in chips)
AjV5McH1KMMclY26QdLM5w: posts small blind $0.25
YBN054X4blmis+B2bBlC0g: posts big blind $0.50
H8cPaCtX7d6meGUVSM5sxw: sits out
*** HOLE CARDS ***
GIJAc9kPrLZHLSX8Q6i99w: folds
HZkVla4kK2SI42CVrPZ/ig: calls $0.50
2CfOMUqXsQk69Igusq28Pg: folds
pFtzb1sR4b0d1aw6aIRgDg: folds
xZCXQSXlrZkp3pZizzVXCw: folds
90Wb75h3W1BRpbqVnuk8gw: folds
AjV5McH1KMMclY26QdLM5w: folds
YBN054X4blmis+B2bBlC0g: checks
*** FLOP *** [9h 5h Ad]
YBN054X4blmis+B2bBlC0g: checks
HZkVla4kK2SI42CVrPZ/ig: checks
*** TURN *** [9h 5h Ad] [Js]
YBN054X4blmis+B2bBlC0g: checks
HZkVla4kK2SI42CVrPZ/ig: checks
*** RIVER *** [9h 5h Ad Js] [Ts]
YBN054X4blmis+B2bBlC0g: bets $0.50
HZkVla4kK2SI42CVrPZ/ig: folds
YBN054X4blmis+B2bBlC0g collected $1.20 from pot
*** SUMMARY ***
Total pot $1.25 | Rake $0.05
Board [9h 5h Ad Js Ts]
Seat 1: xZCXQSXlrZkp3pZizzVXCw folded before Flop (didn't bet)
Seat 2: 90Wb75h3W1BRpbqVnuk8gw (button) folded before Flop (didn't bet)
Seat 3: AjV5McH1KMMclY26QdLM5w (small blind) folded before Flop
Seat 4: YBN054X4blmis+B2bBlC0g (big blind) collected ($1.20)
Seat 5: GIJAc9kPrLZHLSX8Q6i99w folded before Flop (didn't bet)
Seat 7: HZkVla4kK2SI42CVrPZ/ig folded on the River
Seat 8: 2CfOMUqXsQk69Igusq28Pg folded before Flop (didn't bet)
Seat 9: pFtzb1sR4b0d1aw6aIRgDg folded before Flop (didn't bet)



PokerStars Game #59940462640:  Hold'em No Limit ($0.25/$0.50) - 2009/07/01 1:07:20 ET
Table '0eJtgVAXVvBgncFdcUpXcQ' 2-max Seat #1 is the button
Seat 1: Ag6DvxX4vbRheqsv2zXKTQ ($44.25 in chips)
Seat 2: KMc4R+K9ao4Ur3rF7NGe6Q ($11.65 in chips)
Ag6DvxX4vbRheqsv2zXKTQ: posts small blind $0.25
KMc4R+K9ao4Ur3rF7NGe6Q: posts big blind $0.50
*** HOLE CARDS ***
Ag6DvxX4vbRheqsv2zXKTQ: calls $0.25
KMc4R+K9ao4Ur3rF7NGe6Q: checks
*** FLOP *** [7d Ac 9h]
KMc4R+K9ao4Ur3rF7NGe6Q: bets $1
Ag6DvxX4vbRheqsv2zXKTQ: calls $1
*** TURN *** [7d Ac 9h] [8d]
KMc4R+K9ao4Ur3rF7NGe6Q: bets $1.50
Ag6DvxX4vbRheqsv2zXKTQ: calls $1.50
*** RIVER *** [7d Ac 9h 8d] [Qh]
KMc4R+K9ao4Ur3rF7NGe6Q: bets $1.50
Ag6DvxX4vbRheqsv2zXKTQ: calls $1.50
*** SHOW DOWN ***
KMc4R+K9ao4Ur3rF7NGe6Q: shows [Ah 5h] (a pair of Aces)
Ag6DvxX4vbRheqsv2zXKTQ: shows [Ad 4s] (a pair of Aces)
KMc4R+K9ao4Ur3rF7NGe6Q collected $4.30 from pot
Ag6DvxX4vbRheqsv2zXKTQ collected $4.30 from pot
*** SUMMARY ***
Total pot $9 | Rake $0.40
Board [7d Ac 9h 8d Qh]
Seat 1: Ag6DvxX4vbRheqsv2zXKTQ (button) (small blind) showed [Ad 4s] and won ($4.30) with a pair of Aces
Seat 2: KMc4R+K9ao4Ur3rF7NGe6Q (big blind) showed [Ah 5h] and won ($4.30) with a pair of Aces



PokerStars Game #59940462634:  Hold'em No Limit ($0.25/$0.50) - 2009/07/01 1:07:20 ET
Table 'otvGDROEDdqsabxskT79qg' 9-max Seat #3 is the button
Seat 1: 8ehL7qlZzjgUh2H35iiWLw ($59.75 in chips)
Seat 2: cCjTzH9jio8607WzjcfXlg ($12.25 in chips)
Seat 3: +k7T5ocke8UwavtgUHm+Cg ($69.85 in chips)
Seat 4: MG90wfSJZnOejs/KD3vlQQ ($76.15 in chips)
Seat 5: E2518gp4aFz1+kAgmGqeEg ($11.75 in chips)
Seat 6: bxLSulbgr8LmKNjOzw8URg ($55.50 in chips)
Seat 7: 75K2MXwN65Sjfp1yHd50Hg ($10 in chips)
Seat 8: zE9cVigS2nW/Ljy4K4bUQA ($30 in chips)
Seat 9: KcY3X8YpD74Kw1RHkx/g4A ($47.90 in chips)
MG90wfSJZnOejs/KD3vlQQ: posts small blind $0.25
E2518gp4aFz1+kAgmGqeEg: posts big blind $0.50
*** HOLE CARDS ***
bxLSulbgr8LmKNjOzw8URg: folds
75K2MXwN65Sjfp1yHd50Hg: folds
zE9cVigS2nW/Ljy4K4bUQA: folds
KcY3X8YpD74Kw1RHkx/g4A: folds
8ehL7qlZzjgUh2H35iiWLw: folds
cCjTzH9jio8607WzjcfXlg: folds
+k7T5ocke8UwavtgUHm+Cg: raises $0.50 to $1
MG90wfSJZnOejs/KD3vlQQ: folds
E2518gp4aFz1+kAgmGqeEg: folds
+k7T5ocke8UwavtgUHm+Cg collected $1.25 from pot
+k7T5ocke8UwavtgUHm+Cg: doesn't show hand
*** SUMMARY ***
Total pot $1.25 | Rake $0
Seat 1: 8ehL7qlZzjgUh2H35iiWLw folded before Flop (didn't bet)
Seat 2: cCjTzH9jio8607WzjcfXlg folded before Flop (didn't bet)
Seat 3: +k7T5ocke8UwavtgUHm+Cg (button) collected ($1.25)
Seat 4: MG90wfSJZnOejs/KD3vlQQ (small blind) folded before Flop
Seat 5: E2518gp4aFz1+kAgmGqeEg (big blind) folded before Flop
Seat 6: bxLSulbgr8LmKNjOzw8URg folded before Flop (didn't bet)
Seat 7: 75K2MXwN65Sjfp1yHd50Hg folded before Flop (didn't bet)
Seat 8: zE9cVigS2nW/Ljy4K4bUQA folded before Flop (didn't bet)
Seat 9: KcY3X8YpD74Kw1RHkx/g4A folded before Flop (didn't bet)



PokerStars Game #59940463118:  Hold'em No Limit ($0.25/$0.50) - 2009/07/01 1:07:21 ET
Table 'WlCrrUP9MxwySQN5fzLFBQ' 2-max Seat #2 is the button
Seat 1: U7xFsli2XvMiGlVDxk8a/Q ($19.70 in chips)
Seat 2: JTT5TsRNqs6npc7cgI4X/w ($11.75 in chips)
JTT5TsRNqs6npc7cgI4X/w: posts small blind $0.25
U7xFsli2XvMiGlVDxk8a/Q: posts big blind $0.50
*** HOLE CARDS ***
JTT5TsRNqs6npc7cgI4X/w: raises $1.50 to $2
U7xFsli2XvMiGlVDxk8a/Q: folds
JTT5TsRNqs6npc7cgI4X/w collected $1 from pot
JTT5TsRNqs6npc7cgI4X/w: doesn't show hand
*** SUMMARY ***
Total pot $1 | Rake $0
Seat 1: U7xFsli2XvMiGlVDxk8a/Q (big blind) folded before Flop
Seat 2: JTT5TsRNqs6npc7cgI4X/w (button) (small blind) collected ($1)



PokerStars Game #59940464304:  Hold'em No Limit ($0.25/$0.50) - 2009/07/01 1:07:23 ET
Table '+dXkOAQyS8j9PQZusUTMpg' 2-max Seat #2 is the button
Seat 1: XFa6sBGjP2gxoIvxR3fZIg ($119.15 in chips)
Seat 2: 5IBeOgaApY1Bvzv2P8X4EA ($76.60 in chips)
5IBeOgaApY1Bvzv2P8X4EA: posts small blind $0.25
XFa6sBGjP2gxoIvxR3fZIg: posts big blind $0.50
*** HOLE CARDS ***
5IBeOgaApY1Bvzv2P8X4EA: calls $0.25
XFa6sBGjP2gxoIvxR3fZIg: raises $1.50 to $2
5IBeOgaApY1Bvzv2P8X4EA: folds
XFa6sBGjP2gxoIvxR3fZIg collected $1 from pot
XFa6sBGjP2gxoIvxR3fZIg: doesn't show hand
*** SUMMARY ***
Total pot $1 | Rake $0
Seat 1: XFa6sBGjP2gxoIvxR3fZIg (big blind) collected ($1)
Seat 2: 5IBeOgaApY1Bvzv2P8X4EA (button) (small blind) folded before Flop



PokerStars Game #59940465892:  Hold'em No Limit ($0.25/$0.50) - 2009/07/01 1:07:25 ET
Table 'E7bWJ45aoFXRpyRv2gw+Ig' 2-max Seat #1 is the button
Seat 1: FRkiRasEGlHUeLrEl+k/nA ($57.20 in chips)
Seat 2: 3Wro85I7472vJ4Wkpneo9A ($130.25 in chips)
FRkiRasEGlHUeLrEl+k/nA: posts small blind $0.25
3Wro85I7472vJ4Wkpneo9A: posts big blind $0.50
*** HOLE CARDS ***
FRkiRasEGlHUeLrEl+k/nA: raises $1 to $1.50
3Wro85I7472vJ4Wkpneo9A: folds
FRkiRasEGlHUeLrEl+k/nA collected $1 from pot
FRkiRasEGlHUeLrEl+k/nA: doesn't show hand
*** SUMMARY ***
Total pot $1 | Rake $0
Seat 1: FRkiRasEGlHUeLrEl+k/nA (button) (small blind) collected ($1)
Seat 2: 3Wro85I7472vJ4Wkpneo9A (big blind) folded before Flop



PokerStars Game #59940466142:  Hold'em No Limit ($0.25/$0.50) - 2009/07/01 1:07:26 ET
Table 'BCN5su+SsXiy1zRMJi0SJw' 6-max Seat #3 is the button
Seat 1: GxXV09ciXaOxyY2H5aMIIw ($40.80 in chips)
Seat 2: oU2kDCkT/gilYbHWrg7D8w ($41.05 in chips)
Seat 3: of9mtXiD8G4Nx5p7hCbgqQ ($50 in chips)
Seat 4: 4QfsCWthT/vSLirorNXqtg ($50.95 in chips)
Seat 6: b2symlOdL7+0c9Pj4N/KlA ($60.10 in chips)
4QfsCWthT/vSLirorNXqtg: posts small blind $0.25
b2symlOdL7+0c9Pj4N/KlA: posts big blind $0.50
*** HOLE CARDS ***
GxXV09ciXaOxyY2H5aMIIw: folds
oU2kDCkT/gilYbHWrg7D8w: folds
of9mtXiD8G4Nx5p7hCbgqQ: folds
4QfsCWthT/vSLirorNXqtg: raises $1 to $1.50
b2symlOdL7+0c9Pj4N/KlA: folds
4QfsCWthT/vSLirorNXqtg collected $1 from pot
4QfsCWthT/vSLirorNXqtg: doesn't show hand
*** SUMMARY ***
Total pot $1 | Rake $0
Seat 1: GxXV09ciXaOxyY2H5aMIIw folded before Flop (didn't bet)
Seat 2: oU2kDCkT/gilYbHWrg7D8w folded before Flop (didn't bet)
Seat 3: of9mtXiD8G4Nx5p7hCbgqQ (button) folded before Flop (didn't bet)
Seat 4: 4QfsCWthT/vSLirorNXqtg (small blind) collected ($1)
Seat 6: b2symlOdL7+0c9Pj4N/KlA (big blind) folded before Flop



PokerStars Game #59940467130:  Hold'em No Limit ($0.25/$0.50) - 2009/07/01 1:07:27 ET
Table '8BQGgNetI1NOvWeu3gtMNw' 2-max Seat #2 is the button
Seat 1: bypIyrYcAAifLfhZpGlKLA ($95.90 in chips)
Seat 2: Z4HwehErEwzsv/noQlfUlg ($103.25 in chips)
Z4HwehErEwzsv/noQlfUlg: posts small blind $0.25
bypIyrYcAAifLfhZpGlKLA: posts big blind $0.50
*** HOLE CARDS ***
Z4HwehErEwzsv/noQlfUlg: raises $2.50 to $3
bypIyrYcAAifLfhZpGlKLA: calls $2.50
*** FLOP *** [5s Kh Jd]
bypIyrYcAAifLfhZpGlKLA: checks
Z4HwehErEwzsv/noQlfUlg: checks
*** TURN *** [5s Kh Jd] [Jc]
bypIyrYcAAifLfhZpGlKLA: checks
Z4HwehErEwzsv/noQlfUlg: bets $3
bypIyrYcAAifLfhZpGlKLA: calls $3
*** RIVER *** [5s Kh Jd Jc] [7c]
bypIyrYcAAifLfhZpGlKLA: checks
Z4HwehErEwzsv/noQlfUlg: checks
*** SHOW DOWN ***
bypIyrYcAAifLfhZpGlKLA: shows [Kd Qs] (two pair, Kings and Jacks)
Z4HwehErEwzsv/noQlfUlg: mucks hand
bypIyrYcAAifLfhZpGlKLA collected $11.50 from pot
*** SUMMARY ***
Total pot $12 | Rake $0.50
Board [5s Kh Jd Jc 7c]
Seat 1: bypIyrYcAAifLfhZpGlKLA (big blind) showed [Kd Qs] and won ($11.50) with two pair, Kings and Jacks
Seat 2: Z4HwehErEwzsv/noQlfUlg (button) (small blind) mucked



PokerStars Game #59940468156:  Hold'em No Limit ($0.25/$0.50) - 2009/07/01 1:07:29 ET
Table 'WlCrrUP9MxwySQN5fzLFBQ' 2-max Seat #1 is the button
Seat 1: U7xFsli2XvMiGlVDxk8a/Q ($19.20 in chips)
Seat 2: JTT5TsRNqs6npc7cgI4X/w ($12.25 in chips)
U7xFsli2XvMiGlVDxk8a/Q: posts small blind $0.25
JTT5TsRNqs6npc7cgI4X/w: posts big blind $0.50
*** HOLE CARDS ***
U7xFsli2XvMiGlVDxk8a/Q: raises $0.50 to $1
JTT5TsRNqs6npc7cgI4X/w: calls $0.50
*** FLOP *** [8s Jh 4h]
JTT5TsRNqs6npc7cgI4X/w: checks
U7xFsli2XvMiGlVDxk8a/Q: checks
*** TURN *** [8s Jh 4h] [8d]
JTT5TsRNqs6npc7cgI4X/w: checks
U7xFsli2XvMiGlVDxk8a/Q: checks
*** RIVER *** [8s Jh 4h 8d] [Td]
JTT5TsRNqs6npc7cgI4X/w: checks
U7xFsli2XvMiGlVDxk8a/Q: checks
*** SHOW DOWN ***
JTT5TsRNqs6npc7cgI4X/w: shows [Qs 6s] (a pair of Eights)
U7xFsli2XvMiGlVDxk8a/Q: shows [7c Kd] (a pair of Eights - King kicker)
U7xFsli2XvMiGlVDxk8a/Q collected $1.90 from pot
*** SUMMARY ***
Total pot $2 | Rake $0.10
Board [8s Jh 4h 8d Td]
Seat 1: U7xFsli2XvMiGlVDxk8a/Q (button) (small blind) showed [7c Kd] and won ($1.90) with a pair of Eights
Seat 2: JTT5TsRNqs6npc7cgI4X/w (big blind) showed [Qs 6s] and lost with a pair of Eights



PokerStars Game #59940468174:  Hold'em No Limit ($0.25/$0.50) - 2009/07/01 1:07:29 ET
Table 'hSTs/dUsYLgJQuF2Onp0MQ' 6-max Seat #3 is the button
Seat 1: 1WUCqNG+p+vfWRTXNu4ljw ($50 in chips)
Seat 2: 6vNxrjjCl6FwfaaymM9jjg ($35.05 in chips)
Seat 3: C3qJBo7uxfFVDluE1lmK2w ($51.85 in chips)
Seat 4: L0aIPg7qefDQjdJo3HCVEA ($10.30 in chips)
Seat 5: 686aeHikcJlgKkSuIFdcXQ ($57.90 in chips)
Seat 6: M1KyQQvVPVuxqTAB8sR/zQ ($80.40 in chips)
L0aIPg7qefDQjdJo3HCVEA: posts small blind $0.25
686aeHikcJlgKkSuIFdcXQ: posts big blind $0.50
*** HOLE CARDS ***
M1KyQQvVPVuxqTAB8sR/zQ: folds
1WUCqNG+p+vfWRTXNu4ljw: folds
6vNxrjjCl6FwfaaymM9jjg: folds
C3qJBo7uxfFVDluE1lmK2w: raises $1 to $1.50
L0aIPg7qefDQjdJo3HCVEA: folds
686aeHikcJlgKkSuIFdcXQ: folds
C3qJBo7uxfFVDluE1lmK2w collected $1.25 from pot
*** SUMMARY ***
Total pot $1.25 | Rake $0
Seat 1: 1WUCqNG+p+vfWRTXNu4ljw folded before Flop (didn't bet)
Seat 2: 6vNxrjjCl6FwfaaymM9jjg folded before Flop (didn't bet)
Seat 3: C3qJBo7uxfFVDluE1lmK2w (button) collected ($1.25)
Seat 4: L0aIPg7qefDQjdJo3HCVEA (small blind) folded before Flop
Seat 5: 686aeHikcJlgKkSuIFdcXQ (big blind) folded before Flop
Seat 6: M1KyQQvVPVuxqTAB8sR/zQ folded before Flop (didn't bet)



PokerStars Game #59940467842:  Hold'em No Limit ($0.25/$0.50) - 2009/07/01 1:07:29 ET
Table 'eMxdLyFDf28E0wit6gm3Uw' 6-max Seat #3 is the button
Seat 2: UEjiWqFckVmunpvV128Xfw ($47.75 in chips)
Seat 3: pFpoMlE7/SOsr+6aKNR7bw ($11 in chips)
Seat 4: hPAFLRqGh8YnqPe3HMZiQg ($22.10 in chips)
Seat 5: OtITKlSIHBhVAjRe30+BBQ ($35.25 in chips)
Seat 6: lxIzoHy0RnkfFSODHC2liw ($50 in chips)
hPAFLRqGh8YnqPe3HMZiQg: posts small blind $0.25
OtITKlSIHBhVAjRe30+BBQ: posts big blind $0.50
FONMraB4GCHzDwDcfciKyw: sits out
*** HOLE CARDS ***
lxIzoHy0RnkfFSODHC2liw: folds
UEjiWqFckVmunpvV128Xfw: folds
pFpoMlE7/SOsr+6aKNR7bw: folds
hPAFLRqGh8YnqPe3HMZiQg: calls $0.25
OtITKlSIHBhVAjRe30+BBQ: checks
*** FLOP *** [2s 5h 4d]
hPAFLRqGh8YnqPe3HMZiQg: bets $1
OtITKlSIHBhVAjRe30+BBQ: calls $1
*** TURN *** [2s 5h 4d] [2d]
hPAFLRqGh8YnqPe3HMZiQg: bets $1.50
OtITKlSIHBhVAjRe30+BBQ: calls $1.50
*** RIVER *** [2s 5h 4d 2d] [Kd]
hPAFLRqGh8YnqPe3HMZiQg: bets $3
OtITKlSIHBhVAjRe30+BBQ: folds
hPAFLRqGh8YnqPe3HMZiQg collected $5.75 from pot
*** SUMMARY ***
Total pot $6 | Rake $0.25
Board [2s 5h 4d 2d Kd]
Seat 2: UEjiWqFckVmunpvV128Xfw folded before Flop (didn't bet)
Seat 3: pFpoMlE7/SOsr+6aKNR7bw (button) folded before Flop (didn't bet)
Seat 4: hPAFLRqGh8YnqPe3HMZiQg (small blind) collected ($5.75)
Seat 5: OtITKlSIHBhVAjRe30+BBQ (big blind) folded on the River
Seat 6: lxIzoHy0RnkfFSODHC2liw folded before Flop (didn't bet)



PokerStars Game #59940468422:  Hold'em No Limit ($0.25/$0.50) - 2009/07/01 1:07:30 ET
Table 'ErOuyGLI5PT3G5MnpHgC/gQOgaEqMcJ73pcUMMxoisUg Seat #4 is the button
Seat 2: pciZn00ZDk4BVBMTTMcNVQ ($28 in chips)
Seat 3: xZCXQSXlrZkp3pZizzVXCw ($52 in chips)
Seat 4: 3UmXLy3GfjC3EkOebduerQ ($50 in chips)
Seat 5: JwvquocWfhTVApN5t47LgA ($64.15 in chips)
Seat 6: zE9cVigS2nW/Ljy4K4bUQA ($31.60 in chips)
Seat 7: 90Wb75h3W1BRpbqVnuk8gw ($63.60 in chips)
Seat 8: g4k0NXISyLCqaSWZDBjfEg ($50.75 in chips)
Seat 9: J0W5D97jl5VLky+IoPvDeA ($52.35 in chips)
JwvquocWfhTVApN5t47LgA: posts small blind $0.25
zE9cVigS2nW/Ljy4K4bUQA: posts big blind $0.50
eBrej2jnlUCs/JgxFCRn2g: sits out
*** HOLE CARDS ***
90Wb75h3W1BRpbqVnuk8gw: folds
g4k0NXISyLCqaSWZDBjfEg: folds
J0W5D97jl5VLky+IoPvDeA: folds
pciZn00ZDk4BVBMTTMcNVQ: folds
xZCXQSXlrZkp3pZizzVXCw: folds
3UmXLy3GfjC3EkOebduerQ: folds
JwvquocWfhTVApN5t47LgA: calls $0.25
zE9cVigS2nW/Ljy4K4bUQA: checks
*** FLOP *** [9d Ac 2s]
JwvquocWfhTVApN5t47LgA: checks
zE9cVigS2nW/Ljy4K4bUQA: checks
*** TURN *** [9d Ac 2s] [5s]
JwvquocWfhTVApN5t47LgA: bets $0.50
zE9cVigS2nW/Ljy4K4bUQA: folds
JwvquocWfhTVApN5t47LgA collected $0.95 from pot
*** SUMMARY ***
Total pot $1 | Rake $0.05
Board [9d Ac 2s 5s]
Seat 2: pciZn00ZDk4BVBMTTMcNVQ folded before Flop (didn't bet)
Seat 3: xZCXQSXlrZkp3pZizzVXCw folded before Flop (didn't bet)
Seat 4: 3UmXLy3GfjC3EkOebduerQ (button) folded before Flop (didn't bet)
Seat 5: JwvquocWfhTVApN5t47LgA (small blind) collected ($0.95)
Seat 6: zE9cVigS2nW/Ljy4K4bUQA (big blind) folded on the Turn
Seat 7: 90Wb75h3W1BRpbqVnuk8gw folded before Flop (didn't bet)
Seat 8: g4k0NXISyLCqaSWZDBjfEg folded before Flop (didn't bet)
Seat 9: J0W5D97jl5VLky+IoPvDeA folded before Flop (didn't bet)



PokerStars Game #59940469850:  Hold'em No Limit ($0.25/$0.50) - 2009/07/01 1:07:32 ET
Table 'c/CRn+68J3Y8KxD5g1ek2Q' 2-max Seat #1 is the button
Seat 1: 46qCyJ6evTkHo9al5sBMNA ($96.30 in chips)
Seat 2: BypVLsYQt3ePFm2xQL/dOA ($269.65 in chips)
46qCyJ6evTkHo9al5sBMNA: posts small blind $0.25
BypVLsYQt3ePFm2xQL/dOA: posts big blind $0.50
*** HOLE CARDS ***
46qCyJ6evTkHo9al5sBMNA: folds
BypVLsYQt3ePFm2xQL/dOA collected $0.50 from pot
BypVLsYQt3ePFm2xQL/dOA: doesn't show hand
*** SUMMARY ***
Total pot $0.50 | Rake $0
Seat 1: 46qCyJ6evTkHo9al5sBMNA (button) (small blind) folded before Flop
Seat 2: BypVLsYQt3ePFm2xQL/dOA (big blind) collected ($0.50)



PokerStars Game #59940469812:  Hold'em No Limit ($0.25/$0.50) - 2009/07/01 1:07:32 ET
Table 'NCiXr0d5CEKBQr/cZgLhbA' 9-max Seat #7 is the button
Seat 1: pFtzb1sR4b0d1aw6aIRgDg ($50 in chips)
Seat 2: ulxuJchBV9iguXg0FUonfg ($19.40 in chips)
Seat 3: xZCXQSXlrZkp3pZizzVXCw ($51.95 in chips)
Seat 4: 5k9fvXD9suIgCxU4HLQjTw ($52.45 in chips)
Seat 5: zE9cVigS2nW/Ljy4K4bUQA ($65.10 in chips)
Seat 6: SKnJuWHScqetA/qG5p+wCg ($32.75 in chips)
Seat 7: M+7+BTmX5vZatHVuoRB1nA ($52 in chips)
Seat 8: 1MJUKc3cc0QmUoz1JZLR2w ($64.30 in chips)
Seat 9: 4WLZvqBn5qv5tds5kt5A1Q ($40.15 in chips)
1MJUKc3cc0QmUoz1JZLR2w: posts small blind $0.25
4WLZvqBn5qv5tds5kt5A1Q: posts big blind $0.50
*** HOLE CARDS ***
pFtzb1sR4b0d1aw6aIRgDg: folds
ulxuJchBV9iguXg0FUonfg said, "I overplayed that one, but at least I'll admit it"
ulxuJchBV9iguXg0FUonfg: folds
xZCXQSXlrZkp3pZizzVXCw: folds
5k9fvXD9suIgCxU4HLQjTw: folds
zE9cVigS2nW/Ljy4K4bUQA: folds
SKnJuWHScqetA/qG5p+wCg: raises $1 to $1.50
M+7+BTmX5vZatHVuoRB1nA: folds
1MJUKc3cc0QmUoz1JZLR2w: calls $1.25
4WLZvqBn5qv5tds5kt5A1Q: calls $1
*** FLOP *** [9d 2s Tc]
1MJUKc3cc0QmUoz1JZLR2w: checks
4WLZvqBn5qv5tds5kt5A1Q: checks
SKnJuWHScqetA/qG5p+wCg: checks
*** TURN *** [9d 2s Tc] [Jh]
1MJUKc3cc0QmUoz1JZLR2w: bets $1.50
4WLZvqBn5qv5tds5kt5A1Q: calls $1.50
SKnJuWHScqetA/qG5p+wCg: calls $1.50
*** RIVER *** [9d 2s Tc Jh] [2c]
1MJUKc3cc0QmUoz1JZLR2w: checks
SKnJuWHScqetA/qG5p+wCg said, "idiot"
SKnJuWHScqetA/qG5p+wCg said, "mute"
4WLZvqBn5qv5tds5kt5A1Q: bets $2.50
SKnJuWHScqetA/qG5p+wCg: folds
1MJUKc3cc0QmUoz1JZLR2w: raises $3.50 to $6
ulxuJchBV9iguXg0FUonfg said, "no snappy reparte? I'm crushed"
4WLZvqBn5qv5tds5kt5A1Q: raises $6 to $12
1MJUKc3cc0QmUoz1JZLR2w said, "****...should have just called"
1MJUKc3cc0QmUoz1JZLR2w: calls $6
*** SHOW DOWN ***
4WLZvqBn5qv5tds5kt5A1Q: shows [Qc 8h] (a straight, Eight to Queen)
1MJUKc3cc0QmUoz1JZLR2w: shows [8c 7c] (a straight, Seven to Jack)
4WLZvqBn5qv5tds5kt5A1Q collected $31.40 from pot
*** SUMMARY ***
Total pot $33 | Rake $1.60
Board [9d 2s Tc Jh 2c]
Seat 1: pFtzb1sR4b0d1aw6aIRgDg folded before Flop (didn't bet)
Seat 2: ulxuJchBV9iguXg0FUonfg folded before Flop (didn't bet)
Seat 3: xZCXQSXlrZkp3pZizzVXCw folded before Flop (didn't bet)
Seat 4: 5k9fvXD9suIgCxU4HLQjTw folded before Flop (didn't bet)
Seat 5: zE9cVigS2nW/Ljy4K4bUQA folded before Flop (didn't bet)
Seat 6: SKnJuWHScqetA/qG5p+wCg folded on the River
Seat 7: M+7+BTmX5vZatHVuoRB1nA (button) folded before Flop (didn't bet)
Seat 8: 1MJUKc3cc0QmUoz1JZLR2w (small blind) showed [8c 7c] and lost with a straight, Seven to Jack
Seat 9: 4WLZvqBn5qv5tds5kt5A1Q (big blind) showed [Qc 8h] and won ($31.40) with a straight, Eight to Queen



PokerStars Game #59940470560:  Hold'em No Limit ($0.25/$0.50) - 2009/07/01 1:07:33 ET
Table 'E7bWJ45aoFXRpyRv2gw+Ig' 2-max Seat #2 is the button
Seat 1: FRkiRasEGlHUeLrEl+k/nA ($57.70 in chips)
Seat 2: 3Wro85I7472vJ4Wkpneo9A ($129.75 in chips)
3Wro85I7472vJ4Wkpneo9A: posts small blind $0.25
FRkiRasEGlHUeLrEl+k/nA: posts big blind $0.50
*** HOLE CARDS ***
3Wro85I7472vJ4Wkpneo9A: raises $1 to $1.50
FRkiRasEGlHUeLrEl+k/nA: raises $2 to $3.50
3Wro85I7472vJ4Wkpneo9A: calls $2
*** FLOP *** [6h 6s 7d]
FRkiRasEGlHUeLrEl+k/nA: checks
3Wro85I7472vJ4Wkpneo9A: checks
*** TURN *** [6h 6s 7d] [Qh]
FRkiRasEGlHUeLrEl+k/nA: checks
3Wro85I7472vJ4Wkpneo9A: bets $4
FRkiRasEGlHUeLrEl+k/nA: folds
3Wro85I7472vJ4Wkpneo9A collected $6.65 from pot
3Wro85I7472vJ4Wkpneo9A: doesn't show hand
*** SUMMARY ***
Total pot $7 | Rake $0.35
Board [6h 6s 7d Qh]
Seat 1: FRkiRasEGlHUeLrEl+k/nA (big blind) folded on the Turn
Seat 2: 3Wro85I7472vJ4Wkpneo9A (button) (small blind) collected ($6.65)



PokerStars Game #59940471312:  Hold'em No Limit ($0.25/$0.50) - 2009/07/01 1:07:34 ET
Table 'X6IRCRTh+20gjz8aubWnwA' 9-max Seat #3 is the button
Seat 1: DSM67hHHq1XFoEOi9p8Alw ($52.05 in chips)
Seat 2: HZkVla4kK2SI42CVrPZ/ig ($6.80 in chips)
Seat 3: SWv01peOe69QQRvhQTqjQw ($8 in chips)
Seat 4: M3JFBNQ8Bbw3FBZ/18MuXw ($23.60 in chips)
Seat 5: NnQCepdIR/AOUQn1yhYx6Q ($10 in chips)
Seat 6: 75K2MXwN65Sjfp1yHd50Hg ($10 in chips)
Seat 7: cFHQjKQOOKTUzoilhrXHLg ($16.40 in chips)
Seat 8: HxeBVq06/3Bh/H986sgdbw ($51.50 in chips)
Seat 9: M+7+BTmX5vZatHVuoRB1nA ($44.25 in chips)
M3JFBNQ8Bbw3FBZ/18MuXw: posts small blind $0.25
NnQCepdIR/AOUQn1yhYx6Q: posts big blind $0.50
*** HOLE CARDS ***
75K2MXwN65Sjfp1yHd50Hg: folds
cFHQjKQOOKTUzoilhrXHLg: calls $0.50
HxeBVq06/3Bh/H986sgdbw: folds
M+7+BTmX5vZatHVuoRB1nA: calls $0.50
DSM67hHHq1XFoEOi9p8Alw: folds
HZkVla4kK2SI42CVrPZ/ig: folds
SWv01peOe69QQRvhQTqjQw: folds
M3JFBNQ8Bbw3FBZ/18MuXw: calls $0.25
NnQCepdIR/AOUQn1yhYx6Q: checks
*** FLOP *** [Jc 7s Jh]
M3JFBNQ8Bbw3FBZ/18MuXw: checks
NnQCepdIR/AOUQn1yhYx6Q: checks
cFHQjKQOOKTUzoilhrXHLg: checks
M+7+BTmX5vZatHVuoRB1nA: checks
*** TURN *** [Jc 7s Jh] [5c]
M3JFBNQ8Bbw3FBZ/18MuXw: bets $2
NnQCepdIR/AOUQn1yhYx6Q: folds
cFHQjKQOOKTUzoilhrXHLg: folds
M+7+BTmX5vZatHVuoRB1nA: folds
M3JFBNQ8Bbw3FBZ/18MuXw collected $1.90 from pot
*** SUMMARY ***
Total pot $2 | Rake $0.10
Board [Jc 7s Jh 5c]
Seat 1: DSM67hHHq1XFoEOi9p8Alw folded before Flop (didn't bet)
Seat 2: HZkVla4kK2SI42CVrPZ/ig folded before Flop (didn't bet)
Seat 3: SWv01peOe69QQRvhQTqjQw (button) folded before Flop (didn't bet)
Seat 4: M3JFBNQ8Bbw3FBZ/18MuXw (small blind) collected ($1.90)
Seat 5: NnQCepdIR/AOUQn1yhYx6Q (big blind) folded on the Turn
Seat 6: 75K2MXwN65Sjfp1yHd50Hg folded before Flop (didn't bet)
Seat 7: cFHQjKQOOKTUzoilhrXHLg folded on the Turn
Seat 8: HxeBVq06/3Bh/H986sgdbw folded before Flop (didn't bet)
Seat 9: M+7+BTmX5vZatHVuoRB1nA folded on the Turn



PokerStars Game #59940471994:  Hold'em No Limit ($0.25/$0.50) - 2009/07/01 1:07:36 ET
Table 'MJxeZCzYELxiIsyUZyT0jw' 6-max Seat #6 is the button
Seat 1: +Pf9jTVizYlIo+woPvptfA ($50 in chips)
Seat 2: t3GiVMzqA9Svgr5Uol32cQ ($28.10 in chips)
Seat 4: alGiiQP/wwtYnfuXII+sgw ($64.35 in chips)
Seat 5: 3jvoOXNtXE90w2BdfNZwZQ ($50 in chips)
Seat 6: c0n4hrn20AML9qzyFC2E8Q ($56.35 in chips)
+Pf9jTVizYlIo+woPvptfA: posts small blind $0.25
t3GiVMzqA9Svgr5Uol32cQ: posts big blind $0.50
sIG4mp8tZEI+W4nKZNkkQA: sits out
*** HOLE CARDS ***
alGiiQP/wwtYnfuXII+sgw: calls $0.50
3jvoOXNtXE90w2BdfNZwZQ: raises $2 to $2.50
c0n4hrn20AML9qzyFC2E8Q: calls $2.50
+Pf9jTVizYlIo+woPvptfA: folds
t3GiVMzqA9Svgr5Uol32cQ: folds
alGiiQP/wwtYnfuXII+sgw: folds
*** FLOP *** [Th 5d Tc]
3jvoOXNtXE90w2BdfNZwZQ: bets $3.50
c0n4hrn20AML9qzyFC2E8Q: raises $3.50 to $7
3jvoOXNtXE90w2BdfNZwZQ: folds
c0n4hrn20AML9qzyFC2E8Q collected $12.65 from pot
c0n4hrn20AML9qzyFC2E8Q: doesn't show hand
*** SUMMARY ***
Total pot $13.25 | Rake $0.60
Board [Th 5d Tc]
Seat 1: +Pf9jTVizYlIo+woPvptfA (small blind) folded before Flop
Seat 2: t3GiVMzqA9Svgr5Uol32cQ (big blind) folded before Flop
Seat 4: alGiiQP/wwtYnfuXII+sgw folded before Flop
Seat 5: 3jvoOXNtXE90w2BdfNZwZQ folded on the Flop
Seat 6: c0n4hrn20AML9qzyFC2E8Q (button) collected ($12.65)



PokerStars Game #59940472052:  Hold'em No Limit ($0.25/$0.50) - 2009/07/01 1:07:36 ET
Table '0eJtgVAXVvBgncFdcUpXcQ' 2-max Seat #2 is the button
Seat 1: Ag6DvxX4vbRheqsv2zXKTQ ($44.05 in chips)
Seat 2: KMc4R+K9ao4Ur3rF7NGe6Q ($11.45 in chips)
KMc4R+K9ao4Ur3rF7NGe6Q: posts small blind $0.25
Ag6DvxX4vbRheqsv2zXKTQ: posts big blind $0.50
*** HOLE CARDS ***
KMc4R+K9ao4Ur3rF7NGe6Q: raises $1.50 to $2
Ag6DvxX4vbRheqsv2zXKTQ: folds
KMc4R+K9ao4Ur3rF7NGe6Q collected $1 from pot
KMc4R+K9ao4Ur3rF7NGe6Q: doesn't show hand
*** SUMMARY ***
Total pot $1 | Rake $0
Seat 1: Ag6DvxX4vbRheqsv2zXKTQ (big blind) folded before Flop
Seat 2: KMc4R+K9ao4Ur3rF7NGe6Q (button) (small blind) collected ($1)



PokerStars Game #59940472046:  Hold'em No Limit ($0.25/$0.50) - 2009/07/01 1:07:36 ET
Table '+dXkOAQyS8j9PQZusUTMpg' 2-max Seat #1 is the button
Seat 1: XFa6sBGjP2gxoIvxR3fZIg ($119.65 in chips)
Seat 2: 5IBeOgaApY1Bvzv2P8X4EA ($76.10 in chips)
XFa6sBGjP2gxoIvxR3fZIg: posts small blind $0.25
5IBeOgaApY1Bvzv2P8X4EA: posts big blind $0.50
*** HOLE CARDS ***
XFa6sBGjP2gxoIvxR3fZIg: raises $1 to $1.50
5IBeOgaApY1Bvzv2P8X4EA: calls $1
*** FLOP *** [5c 3h 4h]
5IBeOgaApY1Bvzv2P8X4EA: checks
XFa6sBGjP2gxoIvxR3fZIg: checks
*** TURN *** [5c 3h 4h] [Kh]
5IBeOgaApY1Bvzv2P8X4EA: bets $3.50
XFa6sBGjP2gxoIvxR3fZIg: folds
5IBeOgaApY1Bvzv2P8X4EA collected $2.85 from pot
5IBeOgaApY1Bvzv2P8X4EA: doesn't show hand
*** SUMMARY ***
Total pot $3 | Rake $0.15
Board [5c 3h 4h Kh]
Seat 1: XFa6sBGjP2gxoIvxR3fZIg (button) (small blind) folded on the Turn
Seat 2: 5IBeOgaApY1Bvzv2P8X4EA (big blind) collected ($2.85)



PokerStars Game #59940475114:  Hold'em No Limit ($0.25/$0.50) - 2009/07/01 1:07:41 ET
Table 'c/CRn+68J3Y8KxD5g1ek2Q' 2-max Seat #2 is the button
Seat 1: 46qCyJ6evTkHo9al5sBMNA ($96.05 in chips)
Seat 2: BypVLsYQt3ePFm2xQL/dOA ($269.90 in chips)
BypVLsYQt3ePFm2xQL/dOA: posts small blind $0.25
46qCyJ6evTkHo9al5sBMNA: posts big blind $0.50
*** HOLE CARDS ***
BypVLsYQt3ePFm2xQL/dOA: calls $0.25
46qCyJ6evTkHo9al5sBMNA: raises $1 to $1.50
BypVLsYQt3ePFm2xQL/dOA: calls $1
*** FLOP *** [2s 6h 2c]
46qCyJ6evTkHo9al5sBMNA: checks
BypVLsYQt3ePFm2xQL/dOA: checks
*** TURN *** [2s 6h 2c] [Ac]
46qCyJ6evTkHo9al5sBMNA: checks
BypVLsYQt3ePFm2xQL/dOA: bets $1.50
46qCyJ6evTkHo9al5sBMNA: folds
BypVLsYQt3ePFm2xQL/dOA collected $2.85 from pot
BypVLsYQt3ePFm2xQL/dOA: doesn't show hand
*** SUMMARY ***
Total pot $3 | Rake $0.15
Board [2s 6h 2c Ac]
Seat 1: 46qCyJ6evTkHo9al5sBMNA (big blind) folded on the Turn
Seat 2: BypVLsYQt3ePFm2xQL/dOA (button) (small blind) collected ($2.85)



PokerStars Game #59940474916:  Hold'em No Limit ($0.25/$0.50) - 2009/07/01 1:07:41 ET
Table 'lSisgp6H7Fg1hH5VfjEjYQ' 9-max Seat #3 is the button
Seat 1: 5k9fvXD9suIgCxU4HLQjTw ($50.35 in chips)
Seat 2: UrcnkQOiLVk8BlKDPJSy7Q ($76.55 in chips)
Seat 3: aTkyjTh3w5YLWiIERupZOA ($51.40 in chips)
Seat 4: bwv/rbH/hHhPhY6u9mu04w ($30.25 in chips)
Seat 5: mSD1pginDsyHG5PDfqzphw ($10 in chips)
Seat 6: +k7T5ocke8UwavtgUHm+Cg ($66.30 in chips)
Seat 7: IDtNLR9uFCDdjNsJWMHA5Q ($20.55 in chips)
Seat 8: a4JDWmpFQkL10XfAyuF51A ($27 in chips)
Seat 9: YzeKFbJVLmJGTgNH3ySQlw ($12.95 in chips)
bwv/rbH/hHhPhY6u9mu04w: posts small blind $0.25
mSD1pginDsyHG5PDfqzphw: posts big blind $0.50
*** HOLE CARDS ***
+k7T5ocke8UwavtgUHm+Cg: folds
IDtNLR9uFCDdjNsJWMHA5Q: folds
a4JDWmpFQkL10XfAyuF51A: folds
YzeKFbJVLmJGTgNH3ySQlw: folds
5k9fvXD9suIgCxU4HLQjTw: folds
UrcnkQOiLVk8BlKDPJSy7Q: folds
aTkyjTh3w5YLWiIERupZOA: folds
bwv/rbH/hHhPhY6u9mu04w: calls $0.25
mSD1pginDsyHG5PDfqzphw: checks
*** FLOP *** [4d Jd 2h]
bwv/rbH/hHhPhY6u9mu04w: checks
mSD1pginDsyHG5PDfqzphw: checks
*** TURN *** [4d Jd 2h] [9d]
bwv/rbH/hHhPhY6u9mu04w: checks
mSD1pginDsyHG5PDfqzphw: checks
*** RIVER *** [4d Jd 2h 9d] [Qc]
bwv/rbH/hHhPhY6u9mu04w: bets $0.50
mSD1pginDsyHG5PDfqzphw: folds
bwv/rbH/hHhPhY6u9mu04w collected $0.95 from pot
*** SUMMARY ***
Total pot $1 | Rake $0.05
Board [4d Jd 2h 9d Qc]
Seat 1: 5k9fvXD9suIgCxU4HLQjTw folded before Flop (didn't bet)
Seat 2: UrcnkQOiLVk8BlKDPJSy7Q folded before Flop (didn't bet)
Seat 3: aTkyjTh3w5YLWiIERupZOA (button) folded before Flop (didn't bet)
Seat 4: bwv/rbH/hHhPhY6u9mu04w (small blind) collected ($0.95)
Seat 5: mSD1pginDsyHG5PDfqzphw (big blind) folded on the River
Seat 6: +k7T5ocke8UwavtgUHm+Cg folded before Flop (didn't bet)
Seat 7: IDtNLR9uFCDdjNsJWMHA5Q folded before Flop (didn't bet)
Seat 8: a4JDWmpFQkL10XfAyuF51A folded before Flop (didn't bet)
Seat 9: YzeKFbJVLmJGTgNH3ySQlw folded before Flop (didn't bet)



PokerStars Game #59940475856:  Hold'em No Limit ($0.25/$0.50) - 2009/07/01 1:07:42 ET
Table '0eJtgVAXVvBgncFdcUpXcQ' 2-max Seat #1 is the button
Seat 1: Ag6DvxX4vbRheqsv2zXKTQ ($43.55 in chips)
Seat 2: KMc4R+K9ao4Ur3rF7NGe6Q ($11.95 in chips)
Ag6DvxX4vbRheqsv2zXKTQ: posts small blind $0.25
KMc4R+K9ao4Ur3rF7NGe6Q: posts big blind $0.50
*** HOLE CARDS ***
Ag6DvxX4vbRheqsv2zXKTQ: raises $1 to $1.50
KMc4R+K9ao4Ur3rF7NGe6Q: calls $1
*** FLOP *** [8c 2s 2d]
KMc4R+K9ao4Ur3rF7NGe6Q: checks
Ag6DvxX4vbRheqsv2zXKTQ: bets $1.50
KMc4R+K9ao4Ur3rF7NGe6Q: folds
Ag6DvxX4vbRheqsv2zXKTQ collected $2.85 from pot
*** SUMMARY ***
Total pot $3 | Rake $0.15
Board [8c 2s 2d]
Seat 1: Ag6DvxX4vbRheqsv2zXKTQ (button) (small blind) collected ($2.85)
Seat 2: KMc4R+K9ao4Ur3rF7NGe6Q (big blind) folded on the Flop



PokerStars Game #59940476654:  Hold'em No Limit ($0.25/$0.50) - 2009/07/01 1:07:44 ET
Table 'WlCrrUP9MxwySQN5fzLFBQ' 2-max Seat #2 is the button
Seat 1: U7xFsli2XvMiGlVDxk8a/Q ($20.10 in chips)
Seat 2: JTT5TsRNqs6npc7cgI4X/w ($11.25 in chips)
JTT5TsRNqs6npc7cgI4X/w: posts small blind $0.25
U7xFsli2XvMiGlVDxk8a/Q: posts big blind $0.50
*** HOLE CARDS ***
JTT5TsRNqs6npc7cgI4X/w: raises $1.50 to $2
U7xFsli2XvMiGlVDxk8a/Q: raises $18.10 to $20.10 and is all-in
JTT5TsRNqs6npc7cgI4X/w: calls $9.25 and is all-in
*** FLOP *** [5d Tc 3c]
*** TURN *** [5d Tc 3c] [6c]
*** RIVER *** [5d Tc 3c 6c] [8d]
*** SHOW DOWN ***
U7xFsli2XvMiGlVDxk8a/Q: shows [9h Kd] (high card King)
JTT5TsRNqs6npc7cgI4X/w: shows [Jh Jc] (a pair of Jacks)
JTT5TsRNqs6npc7cgI4X/w collected $22 from pot
*** SUMMARY ***
Total pot $22.50 | Rake $0.50
Board [5d Tc 3c 6c 8d]
Seat 1: U7xFsli2XvMiGlVDxk8a/Q (big blind) showed [9h Kd] and lost with high card King
Seat 2: JTT5TsRNqs6npc7cgI4X/w (button) (small blind) showed [Jh Jc] and won ($22) with a pair of Jacks



PokerStars Game #59940478588:  Hold'em No Limit ($0.25/$0.50) - 2009/07/01 1:07:47 ET
Table 'otvGDROEDdqsabxskT79qg' 9-max Seat #4 is the button
Seat 1: 8ehL7qlZzjgUh2H35iiWLw ($59.75 in chips)
Seat 2: cCjTzH9jio8607WzjcfXlg ($12.25 in chips)
Seat 3: +k7T5ocke8UwavtgUHm+Cg ($70.60 in chips)
Seat 4: MG90wfSJZnOejs/KD3vlQQ ($75.90 in chips)
Seat 5: E2518gp4aFz1+kAgmGqeEg ($11.25 in chips)
Seat 6: bxLSulbgr8LmKNjOzw8URg ($55.50 in chips)
Seat 7: 75K2MXwN65Sjfp1yHd50Hg ($10 in chips)
Seat 8: zE9cVigS2nW/Ljy4K4bUQA ($30 in chips)
Seat 9: KcY3X8YpD74Kw1RHkx/g4A ($47.90 in chips)
E2518gp4aFz1+kAgmGqeEg: posts small blind $0.25
bxLSulbgr8LmKNjOzw8URg: posts big blind $0.50
*** HOLE CARDS ***
75K2MXwN65Sjfp1yHd50Hg: folds
zE9cVigS2nW/Ljy4K4bUQA: folds
KcY3X8YpD74Kw1RHkx/g4A: folds
8ehL7qlZzjgUh2H35iiWLw: folds
cCjTzH9jio8607WzjcfXlg: folds
+k7T5ocke8UwavtgUHm+Cg: folds
MG90wfSJZnOejs/KD3vlQQ: folds
E2518gp4aFz1+kAgmGqeEg: folds
bxLSulbgr8LmKNjOzw8URg collected $0.50 from pot
bxLSulbgr8LmKNjOzw8URg: doesn't show hand
*** SUMMARY ***
Total pot $0.50 | Rake $0
Seat 1: 8ehL7qlZzjgUh2H35iiWLw folded before Flop (didn't bet)
Seat 2: cCjTzH9jio8607WzjcfXlg folded before Flop (didn't bet)
Seat 3: +k7T5ocke8UwavtgUHm+Cg folded before Flop (didn't bet)
Seat 4: MG90wfSJZnOejs/KD3vlQQ (button) folded before Flop (didn't bet)
Seat 5: E2518gp4aFz1+kAgmGqeEg (small blind) folded before Flop
Seat 6: bxLSulbgr8LmKNjOzw8URg (big blind) collected ($0.50)
Seat 7: 75K2MXwN65Sjfp1yHd50Hg folded before Flop (didn't bet)
Seat 8: zE9cVigS2nW/Ljy4K4bUQA folded before Flop (didn't bet)
Seat 9: KcY3X8YpD74Kw1RHkx/g4A folded before Flop (didn't bet)



PokerStars Game #59940478978:  Hold'em No Limit ($0.25/$0.50) - 2009/07/01 1:07:48 ET
Table '+z1aekfHkpp09pc8F9aViw' 6-max Seat #1 is the button
Seat 1: FHilMb2i2DbUCc9lplszog ($9.35 in chips)
Seat 2: 8EEqTTh7T1q48sYDqbI2Xg ($29.50 in chips)
Seat 3: uUznlIMFnRUvwrBhYF73KA ($138 in chips)
Seat 4: RowCSpSURHTOL/dcjg/Iug ($37.30 in chips)
Seat 5: rplyldNweS6YyMNEALQrug ($47.20 in chips)
Seat 6: 686aeHikcJlgKkSuIFdcXQ ($50 in chips)
8EEqTTh7T1q48sYDqbI2Xg: posts small blind $0.25
uUznlIMFnRUvwrBhYF73KA: posts big blind $0.50
*** HOLE CARDS ***
RowCSpSURHTOL/dcjg/Iug: folds
rplyldNweS6YyMNEALQrug: folds
686aeHikcJlgKkSuIFdcXQ: raises $1.50 to $2
FHilMb2i2DbUCc9lplszog: folds
8EEqTTh7T1q48sYDqbI2Xg: folds
uUznlIMFnRUvwrBhYF73KA: calls $1.50
*** FLOP *** [4c 3s 9d]
uUznlIMFnRUvwrBhYF73KA: checks
686aeHikcJlgKkSuIFdcXQ: bets $4
uUznlIMFnRUvwrBhYF73KA: calls $4
*** TURN *** [4c 3s 9d] [2h]
uUznlIMFnRUvwrBhYF73KA: checks
686aeHikcJlgKkSuIFdcXQ: checks
*** RIVER *** [4c 3s 9d 2h] [6d]
uUznlIMFnRUvwrBhYF73KA: checks
686aeHikcJlgKkSuIFdcXQ: checks
*** SHOW DOWN ***
uUznlIMFnRUvwrBhYF73KA: shows [6s 7d] (a pair of Sixes)
686aeHikcJlgKkSuIFdcXQ: mucks hand
uUznlIMFnRUvwrBhYF73KA collected $11.65 from pot
*** SUMMARY ***
Total pot $12.25 | Rake $0.60
Board [4c 3s 9d 2h 6d]
Seat 1: FHilMb2i2DbUCc9lplszog (button) folded before Flop (didn't bet)
Seat 2: 8EEqTTh7T1q48sYDqbI2Xg (small blind) folded before Flop
Seat 3: uUznlIMFnRUvwrBhYF73KA (big blind) showed [6s 7d] and won ($11.65) with a pair of Sixes
Seat 4: RowCSpSURHTOL/dcjg/Iug folded before Flop (didn't bet)
Seat 5: rplyldNweS6YyMNEALQrug folded before Flop (didn't bet)
Seat 6: 686aeHikcJlgKkSuIFdcXQ mucked



PokerStars Game #59940479624:  Hold'em No Limit ($0.25/$0.50) - 2009/07/01 1:07:49 ET
Table 'BCN5su+SsXiy1zRMJi0SJw' 6-max Seat #4 is the button
Seat 1: GxXV09ciXaOxyY2H5aMIIw ($40.80 in chips)
Seat 2: oU2kDCkT/gilYbHWrg7D8w ($41.05 in chips)
Seat 3: of9mtXiD8G4Nx5p7hCbgqQ ($50 in chips)
Seat 4: 4QfsCWthT/vSLirorNXqtg ($51.45 in chips)
Seat 6: b2symlOdL7+0c9Pj4N/KlA ($59.60 in chips)
b2symlOdL7+0c9Pj4N/KlA: posts small blind $0.25
GxXV09ciXaOxyY2H5aMIIw: posts big blind $0.50
*** HOLE CARDS ***
oU2kDCkT/gilYbHWrg7D8w: folds
of9mtXiD8G4Nx5p7hCbgqQ: folds
4QfsCWthT/vSLirorNXqtg: folds
b2symlOdL7+0c9Pj4N/KlA: raises $1 to $1.50
GxXV09ciXaOxyY2H5aMIIw: folds
b2symlOdL7+0c9Pj4N/KlA collected $1 from pot
b2symlOdL7+0c9Pj4N/KlA: doesn't show hand
*** SUMMARY ***
Total pot $1 | Rake $0
Seat 1: GxXV09ciXaOxyY2H5aMIIw (big blind) folded before Flop
Seat 2: oU2kDCkT/gilYbHWrg7D8w folded before Flop (didn't bet)
Seat 3: of9mtXiD8G4Nx5p7hCbgqQ folded before Flop (didn't bet)
Seat 4: 4QfsCWthT/vSLirorNXqtg (button) folded before Flop (didn't bet)
Seat 6: b2symlOdL7+0c9Pj4N/KlA (small blind) collected ($1)



PokerStars Game #59940480042:  Hold'em No Limit ($0.25/$0.50) - 2009/07/01 1:07:49 ET
Table 'kgbJRsxfv64KrErDRBAkcw' 6-max Seat #6 is the button
Seat 1: VamsyhlFzXGF6/ydo0BHeA ($46.95 in chips)
Seat 2: AdS8BJMOheS01zjCDfPMFg ($35.70 in chips)
Seat 3: c4MNIaIyPMOMxrgT8FT5nA ($135.55 in chips)
Seat 5: eUBBn2R56C1IQ6Cs/vitwg ($62.70 in chips)
Seat 6: 1b+2BbjMN8qhR1WPqdE9VQ ($51.65 in chips)
VamsyhlFzXGF6/ydo0BHeA: posts small blind $0.25
AdS8BJMOheS01zjCDfPMFg: posts big blind $0.50
*** HOLE CARDS ***
c4MNIaIyPMOMxrgT8FT5nA: folds
eUBBn2R56C1IQ6Cs/vitwg: raises $1 to $1.50
c4MNIaIyPMOMxrgT8FT5nA is sitting out
1b+2BbjMN8qhR1WPqdE9VQ: raises $3 to $4.50
VamsyhlFzXGF6/ydo0BHeA: calls $4.25
AdS8BJMOheS01zjCDfPMFg: folds
eUBBn2R56C1IQ6Cs/vitwg: folds
*** FLOP *** [3h Th 9c]
VamsyhlFzXGF6/ydo0BHeA: checks
1b+2BbjMN8qhR1WPqdE9VQ: bets $7
VamsyhlFzXGF6/ydo0BHeA: folds
1b+2BbjMN8qhR1WPqdE9VQ collected $10.45 from pot
1b+2BbjMN8qhR1WPqdE9VQ: doesn't show hand
*** SUMMARY ***
Total pot $11 | Rake $0.55
Board [3h Th 9c]
Seat 1: VamsyhlFzXGF6/ydo0BHeA (small blind) folded on the Flop
Seat 2: AdS8BJMOheS01zjCDfPMFg (big blind) folded before Flop
Seat 3: c4MNIaIyPMOMxrgT8FT5nA folded before Flop (didn't bet)
Seat 5: eUBBn2R56C1IQ6Cs/vitwg folded before Flop
Seat 6: 1b+2BbjMN8qhR1WPqdE9VQ (button) collected ($10.45)



PokerStars Game #59940481580:  Hold'em No Limit ($0.25/$0.50) - 2009/07/01 1:07:52 ET
Table 'ZYI3ZReBjdfKEYItkZHI6A' 9-max Seat #2 is the button
Seat 1: E2518gp4aFz1+kAgmGqeEg ($13.85 in chips)
Seat 2: 8zdVaT8pZ/Wm0uWoeLhtZg ($4.50 in chips)
Seat 3: bkXkL3pmapikPQQRNPZSEA ($20.15 in chips)
Seat 4: e2+sK/yjnj94rXOKoxPP2A ($50 in chips)
Seat 5: ApHP7ouup365XIUFBdEDxg ($47.15 in chips)
Seat 6: Wj7mKnRFR90j40wWUu2+Og ($37.30 in chips)
Seat 7: HWcfp1hY1hqvrddzW3/FQw ($12.50 in chips)
Seat 8: ji04uOybxCdpdefzlUQeKQ ($28 in chips)
bkXkL3pmapikPQQRNPZSEA: posts small blind $0.25
e2+sK/yjnj94rXOKoxPP2A: posts big blind $0.50
*** HOLE CARDS ***
ApHP7ouup365XIUFBdEDxg: folds
Wj7mKnRFR90j40wWUu2+Og: folds
HWcfp1hY1hqvrddzW3/FQw: folds
ji04uOybxCdpdefzlUQeKQ: folds
E2518gp4aFz1+kAgmGqeEg: folds
8zdVaT8pZ/Wm0uWoeLhtZg: calls $0.50
bkXkL3pmapikPQQRNPZSEA: calls $0.25
e2+sK/yjnj94rXOKoxPP2A: checks
*** FLOP *** [Qh 7s 8d]
bkXkL3pmapikPQQRNPZSEA: checks
e2+sK/yjnj94rXOKoxPP2A: checks
8zdVaT8pZ/Wm0uWoeLhtZg: bets $4 and is all-in
bkXkL3pmapikPQQRNPZSEA: folds
e2+sK/yjnj94rXOKoxPP2A: folds
8zdVaT8pZ/Wm0uWoeLhtZg collected $1.45 from pot
*** SUMMARY ***
Total pot $1.50 | Rake $0.05
Board [Qh 7s 8d]
Seat 1: E2518gp4aFz1+kAgmGqeEg folded before Flop (didn't bet)
Seat 2: 8zdVaT8pZ/Wm0uWoeLhtZg (button) collected ($1.45)
Seat 3: bkXkL3pmapikPQQRNPZSEA (small blind) folded on the Flop
Seat 4: e2+sK/yjnj94rXOKoxPP2A (big blind) folded on the Flop
Seat 5: ApHP7ouup365XIUFBdEDxg folded before Flop (didn't bet)
Seat 6: Wj7mKnRFR90j40wWUu2+Og folded before Flop (didn't bet)
Seat 7: HWcfp1hY1hqvrddzW3/FQw folded before Flop (didn't bet)
Seat 8: ji04uOybxCdpdefzlUQeKQ folded before Flop (didn't bet)



PokerStars Game #59940482940:  Hold'em No Limit ($0.25/$0.50) - 2009/07/01 1:07:55 ET
Table '0eJtgVAXVvBgncFdcUpXcQ' 2-max Seat #2 is the button
Seat 1: Ag6DvxX4vbRheqsv2zXKTQ ($44.90 in chips)
Seat 2: KMc4R+K9ao4Ur3rF7NGe6Q ($10.45 in chips)
KMc4R+K9ao4Ur3rF7NGe6Q: posts small blind $0.25
Ag6DvxX4vbRheqsv2zXKTQ: posts big blind $0.50
*** HOLE CARDS ***
KMc4R+K9ao4Ur3rF7NGe6Q: raises $1 to $1.50
Ag6DvxX4vbRheqsv2zXKTQ: folds
KMc4R+K9ao4Ur3rF7NGe6Q collected $1 from pot
KMc4R+K9ao4Ur3rF7NGe6Q: doesn't show hand
*** SUMMARY ***
Total pot $1 | Rake $0
Seat 1: Ag6DvxX4vbRheqsv2zXKTQ (big blind) folded before Flop
Seat 2: KMc4R+K9ao4Ur3rF7NGe6Q (button) (small blind) collected ($1)



PokerStars Game #59940484284:  Hold'em No Limit ($0.25/$0.50) - 2009/07/01 1:07:57 ET
Table '+dXkOAQyS8j9PQZusUTMpg' 2-max Seat #2 is the button
Seat 1: XFa6sBGjP2gxoIvxR3fZIg ($118.15 in chips)
Seat 2: 5IBeOgaApY1Bvzv2P8X4EA ($77.45 in chips)
5IBeOgaApY1Bvzv2P8X4EA: posts small blind $0.25
XFa6sBGjP2gxoIvxR3fZIg: posts big blind $0.50
*** HOLE CARDS ***
5IBeOgaApY1Bvzv2P8X4EA: folds
XFa6sBGjP2gxoIvxR3fZIg collected $0.50 from pot
XFa6sBGjP2gxoIvxR3fZIg: doesn't show hand
*** SUMMARY ***
Total pot $0.50 | Rake $0
Seat 1: XFa6sBGjP2gxoIvxR3fZIg (big blind) collected ($0.50)
Seat 2: 5IBeOgaApY1Bvzv2P8X4EA (button) (small blind) folded before Flop



PokerStars Game #59940484656:  Hold'em No Limit ($0.25/$0.50) - 2009/07/01 1:07:57 ET
Table '37qXEp3oe+er5q4CZip9eQ' 6-max Seat #5 is the button
Seat 1: lxIzoHy0RnkfFSODHC2liw ($50 in chips)
Seat 2: LvH4G7n+QSjT6NDaD3cREA ($57.05 in chips)
Seat 3: Rt6KgtZ8YaJoTc3FPim00w ($110.20 in chips)
Seat 4: XsmE8nXMAAMFJbWaJTmHFw ($45.70 in chips)
Seat 5: VOmI0x4dDPnTESZd5B4d1Q ($42.50 in chips)
Seat 6: N50kln4negd8q7Mmoz1j4g ($9.60 in chips)
N50kln4negd8q7Mmoz1j4g: posts small blind $0.25
lxIzoHy0RnkfFSODHC2liw: posts big blind $0.50
*** HOLE CARDS ***
LvH4G7n+QSjT6NDaD3cREA: folds
XsmE8nXMAAMFJbWaJTmHFw said, "32"
Rt6KgtZ8YaJoTc3FPim00w: folds
XsmE8nXMAAMFJbWaJTmHFw: folds
VOmI0x4dDPnTESZd5B4d1Q: folds
N50kln4negd8q7Mmoz1j4g: calls $0.25
lxIzoHy0RnkfFSODHC2liw: checks
*** FLOP *** [Kh Jd Jh]
N50kln4negd8q7Mmoz1j4g: checks
lxIzoHy0RnkfFSODHC2liw: checks
*** TURN *** [Kh Jd Jh] [5h]
N50kln4negd8q7Mmoz1j4g: bets $1
lxIzoHy0RnkfFSODHC2liw: folds
N50kln4negd8q7Mmoz1j4g collected $0.95 from pot
*** SUMMARY ***
Total pot $1 | Rake $0.05
Board [Kh Jd Jh 5h]
Seat 1: lxIzoHy0RnkfFSODHC2liw (big blind) folded on the Turn
Seat 2: LvH4G7n+QSjT6NDaD3cREA folded before Flop (didn't bet)
Seat 3: Rt6KgtZ8YaJoTc3FPim00w folded before Flop (didn't bet)
Seat 4: XsmE8nXMAAMFJbWaJTmHFw folded before Flop (didn't bet)
Seat 5: VOmI0x4dDPnTESZd5B4d1Q (button) folded before Flop (didn't bet)
Seat 6: N50kln4negd8q7Mmoz1j4g (small blind) collected ($0.95)



PokerStars Game #59940484740:  Hold'em No Limit ($0.25/$0.50) - 2009/07/01 1:07:58 ET
Table '8BQGgNetI1NOvWeu3gtMNw' 2-max Seat #1 is the button
Seat 1: bypIyrYcAAifLfhZpGlKLA ($101.40 in chips)
Seat 2: Z4HwehErEwzsv/noQlfUlg ($97.25 in chips)
bypIyrYcAAifLfhZpGlKLA: posts small blind $0.25
Z4HwehErEwzsv/noQlfUlg: posts big blind $0.50
*** HOLE CARDS ***
bypIyrYcAAifLfhZpGlKLA: raises $1 to $1.50
Z4HwehErEwzsv/noQlfUlg: raises $1.50 to $3
bypIyrYcAAifLfhZpGlKLA: calls $1.50
*** FLOP *** [6h 8s Ad]
Z4HwehErEwzsv/noQlfUlg: bets $3
bypIyrYcAAifLfhZpGlKLA: calls $3
*** TURN *** [6h 8s Ad] [Ah]
Z4HwehErEwzsv/noQlfUlg: bets $4
bypIyrYcAAifLfhZpGlKLA: calls $4
*** RIVER *** [6h 8s Ad Ah] [Js]
Z4HwehErEwzsv/noQlfUlg: checks
bypIyrYcAAifLfhZpGlKLA: checks
*** SHOW DOWN ***
Z4HwehErEwzsv/noQlfUlg: shows [9h 9d] (two pair, Aces and Nines)
bypIyrYcAAifLfhZpGlKLA: mucks hand
Z4HwehErEwzsv/noQlfUlg collected $19.50 from pot
*** SUMMARY ***
Total pot $20 | Rake $0.50
Board [6h 8s Ad Ah Js]
Seat 1: bypIyrYcAAifLfhZpGlKLA (button) (small blind) mucked
Seat 2: Z4HwehErEwzsv/noQlfUlg (big blind) showed [9h 9d] and won ($19.50) with two pair, Aces and Nines



PokerStars Game #59940486868:  Hold'em No Limit ($0.25/$0.50) - 2009/07/01 1:08:01 ET
Table '0eJtgVAXVvBgncFdcUpXcQ' 2-max Seat #1 is the button
Seat 1: Ag6DvxX4vbRheqsv2zXKTQ ($44.40 in chips)
Seat 2: KMc4R+K9ao4Ur3rF7NGe6Q ($10.95 in chips)
Ag6DvxX4vbRheqsv2zXKTQ: posts small blind $0.25
KMc4R+K9ao4Ur3rF7NGe6Q: posts big blind $0.50
*** HOLE CARDS ***
Ag6DvxX4vbRheqsv2zXKTQ: folds
KMc4R+K9ao4Ur3rF7NGe6Q collected $0.50 from pot
KMc4R+K9ao4Ur3rF7NGe6Q: doesn't show hand
*** SUMMARY ***
Total pot $0.50 | Rake $0
Seat 1: Ag6DvxX4vbRheqsv2zXKTQ (button) (small blind) folded before Flop
Seat 2: KMc4R+K9ao4Ur3rF7NGe6Q (big blind) collected ($0.50)



PokerStars Game #59940486930:  Hold'em No Limit ($0.25/$0.50) - 2009/07/01 1:08:01 ET
Table 'GfL/No5u5PoEnU39lP5pQg' 6-max Seat #5 is the button
Seat 1: 1WUCqNG+p+vfWRTXNu4ljw ($64.50 in chips)
Seat 2: uVwggSetzp7d+eVgowO3vg ($57 in chips)
Seat 3: eQXFICMuu3hw6XlcmuVNEA ($19.85 in chips)
Seat 4: r6u7MWSXF30/khcTYkrG9Q ($35.15 in chips)
Seat 5: M1KyQQvVPVuxqTAB8sR/zQ ($50 in chips)
Seat 6: kxPhs4ePFqMy52CInAJ2aw ($51.10 in chips)
kxPhs4ePFqMy52CInAJ2aw: posts small blind $0.25
1WUCqNG+p+vfWRTXNu4ljw: posts big blind $0.50
*** HOLE CARDS ***
uVwggSetzp7d+eVgowO3vg: folds
eQXFICMuu3hw6XlcmuVNEA: folds
r6u7MWSXF30/khcTYkrG9Q: folds
M1KyQQvVPVuxqTAB8sR/zQ: folds
eQXFICMuu3hw6XlcmuVNEA leaves the table
kxPhs4ePFqMy52CInAJ2aw: folds
1WUCqNG+p+vfWRTXNu4ljw collected $0.50 from pot
*** SUMMARY ***
Total pot $0.50 | Rake $0
Seat 1: 1WUCqNG+p+vfWRTXNu4ljw (big blind) collected ($0.50)
Seat 2: uVwggSetzp7d+eVgowO3vg folded before Flop (didn't bet)
Seat 3: eQXFICMuu3hw6XlcmuVNEA folded before Flop (didn't bet)
Seat 4: r6u7MWSXF30/khcTYkrG9Q folded before Flop (didn't bet)
Seat 5: M1KyQQvVPVuxqTAB8sR/zQ (button) folded before Flop (didn't bet)
Seat 6: kxPhs4ePFqMy52CInAJ2aw (small blind) folded before Flop



PokerStars Game #59940487404:  Hold'em No Limit ($0.25/$0.50) - 2009/07/01 1:08:02 ET
Table 'WlCrrUP9MxwySQN5fzLFBQ' 2-max Seat #1 is the button
Seat 1: U7xFsli2XvMiGlVDxk8a/Q ($8.85 in chips)
Seat 2: JTT5TsRNqs6npc7cgI4X/w ($22 in chips)
U7xFsli2XvMiGlVDxk8a/Q: posts small blind $0.25
JTT5TsRNqs6npc7cgI4X/w: posts big blind $0.50
*** HOLE CARDS ***
U7xFsli2XvMiGlVDxk8a/Q: raises $8.35 to $8.85 and is all-in
JTT5TsRNqs6npc7cgI4X/w: folds
U7xFsli2XvMiGlVDxk8a/Q collected $1 from pot
U7xFsli2XvMiGlVDxk8a/Q: doesn't show hand
*** SUMMARY ***
Total pot $1 | Rake $0
Seat 1: U7xFsli2XvMiGlVDxk8a/Q (button) (small blind) collected ($1)
Seat 2: JTT5TsRNqs6npc7cgI4X/w (big blind) folded before Flop



PokerStars Game #59940487814:  Hold'em No Limit ($0.25/$0.50) - 2009/07/01 1:08:03 ET
Table '+dXkOAQyS8j9PQZusUTMpg' 2-max Seat #1 is the button
Seat 1: XFa6sBGjP2gxoIvxR3fZIg ($118.40 in chips)
Seat 2: 5IBeOgaApY1Bvzv2P8X4EA ($77.20 in chips)
XFa6sBGjP2gxoIvxR3fZIg: posts small blind $0.25
5IBeOgaApY1Bvzv2P8X4EA: posts big blind $0.50
*** HOLE CARDS ***
XFa6sBGjP2gxoIvxR3fZIg: raises $1 to $1.50
5IBeOgaApY1Bvzv2P8X4EA: folds
XFa6sBGjP2gxoIvxR3fZIg collected $1 from pot
XFa6sBGjP2gxoIvxR3fZIg: doesn't show hand
*** SUMMARY ***
Total pot $1 | Rake $0
Seat 1: XFa6sBGjP2gxoIvxR3fZIg (button) (small blind) collected ($1)
Seat 2: 5IBeOgaApY1Bvzv2P8X4EA (big blind) folded before Flop



PokerStars Game #59940487584:  Hold'em No Limit ($0.25/$0.50) - 2009/07/01 1:08:03 ET
Table '5EmHi+fnatGQQShcNmzOZQ' 6-max Seat #6 is the button
Seat 1: My8WkRtGx5FW6rJ1I4R3hg ($27.65 in chips)
Seat 2: bfFjgAtIoAI+pUxUwFt3aQ ($37.25 in chips)
Seat 3: 1mYbhL8CU/QYqfVmFcaHDQ ($8 in chips)
Seat 4: 1b+2BbjMN8qhR1WPqdE9VQ ($66.05 in chips)
Seat 5: kxPhs4ePFqMy52CInAJ2aw ($93.85 in chips)
Seat 6: 686aeHikcJlgKkSuIFdcXQ ($134.85 in chips)
My8WkRtGx5FW6rJ1I4R3hg: posts small blind $0.25
bfFjgAtIoAI+pUxUwFt3aQ: posts big blind $0.50
*** HOLE CARDS ***
1mYbhL8CU/QYqfVmFcaHDQ: folds
1b+2BbjMN8qhR1WPqdE9VQ: raises $1 to $1.50
kxPhs4ePFqMy52CInAJ2aw: folds
686aeHikcJlgKkSuIFdcXQ: folds
My8WkRtGx5FW6rJ1I4R3hg: calls $1.25
bfFjgAtIoAI+pUxUwFt3aQ: folds
*** FLOP *** [3c 3h Td]
My8WkRtGx5FW6rJ1I4R3hg: checks
1b+2BbjMN8qhR1WPqdE9VQ: bets $2.50
My8WkRtGx5FW6rJ1I4R3hg: calls $2.50
*** TURN *** [3c 3h Td] [Ad]
My8WkRtGx5FW6rJ1I4R3hg: checks
1b+2BbjMN8qhR1WPqdE9VQ: bets $5.50
My8WkRtGx5FW6rJ1I4R3hg: calls $5.50
*** RIVER *** [3c 3h Td Ad] [8s]
My8WkRtGx5FW6rJ1I4R3hg: checks
1b+2BbjMN8qhR1WPqdE9VQ: bets $14
My8WkRtGx5FW6rJ1I4R3hg: calls $14
*** SHOW DOWN ***
1b+2BbjMN8qhR1WPqdE9VQ: shows [4c 5c] (a pair of Threes)
My8WkRtGx5FW6rJ1I4R3hg: shows [7s Ah] (two pair, Aces and Threes)
My8WkRtGx5FW6rJ1I4R3hg collected $45.20 from pot
*** SUMMARY ***
Total pot $47.50 | Rake $2.30
Board [3c 3h Td Ad 8s]
Seat 1: My8WkRtGx5FW6rJ1I4R3hg (small blind) showed [7s Ah] and won ($45.20) with two pair, Aces and Threes
Seat 2: bfFjgAtIoAI+pUxUwFt3aQ (big blind) folded before Flop
Seat 3: 1mYbhL8CU/QYqfVmFcaHDQ folded before Flop (didn't bet)
Seat 4: 1b+2BbjMN8qhR1WPqdE9VQ showed [4c 5c] and lost with a pair of Threes
Seat 5: kxPhs4ePFqMy52CInAJ2aw folded before Flop (didn't bet)
Seat 6: 686aeHikcJlgKkSuIFdcXQ (button) folded before Flop (didn't bet)



PokerStars Game #59940488086:  Hold'em No Limit ($0.25/$0.50) - 2009/07/01 1:08:03 ET
Table 'QOgaEqMcJ73pcUMMxoisUg' 6-max Seat #6 is the button
Seat 1: lxIzoHy0RnkfFSODHC2liw ($53.60 in chips)
Seat 2: oqOqoO2AyCZenUghCxMDxw ($51.60 in chips)
Seat 3: Rt6KgtZ8YaJoTc3FPim00w ($53.75 in chips)
Seat 4: zAcsDhG/T128Vn7XGVSgKg ($50 in chips)
Seat 5: 6vNxrjjCl6FwfaaymM9jjg ($20.75 in chips)
Seat 6: AdS8BJMOheS01zjCDfPMFg ($49.25 in chips)
lxIzoHy0RnkfFSODHC2liw: posts small blind $0.25
oqOqoO2AyCZenUghCxMDxw: posts big blind $0.50
*** HOLE CARDS ***
Rt6KgtZ8YaJoTc3FPim00w: folds
zAcsDhG/T128Vn7XGVSgKg: raises $1 to $1.50
6vNxrjjCl6FwfaaymM9jjg: folds
AdS8BJMOheS01zjCDfPMFg: folds
lxIzoHy0RnkfFSODHC2liw: raises $4 to $5.50
oqOqoO2AyCZenUghCxMDxw: calls $5
zAcsDhG/T128Vn7XGVSgKg: folds
*** FLOP *** [7s 9c 8d]
lxIzoHy0RnkfFSODHC2liw: bets $8
oqOqoO2AyCZenUghCxMDxw: calls $8
*** TURN *** [7s 9c 8d] [5h]
lxIzoHy0RnkfFSODHC2liw: checks
oqOqoO2AyCZenUghCxMDxw: checks
*** RIVER *** [7s 9c 8d 5h] [As]
lxIzoHy0RnkfFSODHC2liw: checks
oqOqoO2AyCZenUghCxMDxw: checks
*** SHOW DOWN ***
lxIzoHy0RnkfFSODHC2liw: shows [Js Ks] (high card Ace)
oqOqoO2AyCZenUghCxMDxw: shows [Ah Qd] (a pair of Aces)
oqOqoO2AyCZenUghCxMDxw collected $27.15 from pot
*** SUMMARY ***
Total pot $28.50 | Rake $1.35
Board [7s 9c 8d 5h As]
Seat 1: lxIzoHy0RnkfFSODHC2liw (small blind) showed [Js Ks] and lost with high card Ace
Seat 2: oqOqoO2AyCZenUghCxMDxw (big blind) showed [Ah Qd] and won ($27.15) with a pair of Aces
Seat 3: Rt6KgtZ8YaJoTc3FPim00w folded before Flop (didn't bet)
Seat 4: zAcsDhG/T128Vn7XGVSgKg folded before Flop
Seat 5: 6vNxrjjCl6FwfaaymM9jjg folded before Flop (didn't bet)
Seat 6: AdS8BJMOheS01zjCDfPMFg (button) folded before Flop (didn't bet)



PokerStars Game #59940487642:  Hold'em No Limit ($0.25/$0.50) - 2009/07/01 1:08:03 ET
Table 'Nz0Vr7WMHL2g5Uk7dDZjpw' 9-max Seat #1 is the button
Seat 1: tLkxo7JgV+WWI0UBw44K5A ($107.10 in chips)
Seat 2: gsyXT42WLEcOS4DdEk2wlw ($30.85 in chips)
Seat 3: hoglu9inkgs6zN573/bJag ($8.50 in chips)
Seat 4: E2518gp4aFz1+kAgmGqeEg ($13.30 in chips)
Seat 5: WGW0DgjBUXs1ylURHG8vnQ ($21.85 in chips)
Seat 6: 997ViqAtWn1FPjJqcffwcA ($59.80 in chips)
Seat 7: KPLH0gELgFe2OuAnhJFI5w ($23.45 in chips)
Seat 9: mSD1pginDsyHG5PDfqzphw ($10 in chips)
gsyXT42WLEcOS4DdEk2wlw: posts small blind $0.25
hoglu9inkgs6zN573/bJag: posts big blind $0.50
*** HOLE CARDS ***
E2518gp4aFz1+kAgmGqeEg: folds
WGW0DgjBUXs1ylURHG8vnQ: folds
997ViqAtWn1FPjJqcffwcA: folds
KPLH0gELgFe2OuAnhJFI5w: folds
mSD1pginDsyHG5PDfqzphw: raises $1 to $1.50
tLkxo7JgV+WWI0UBw44K5A: folds
gsyXT42WLEcOS4DdEk2wlw: folds
hoglu9inkgs6zN573/bJag: folds
mSD1pginDsyHG5PDfqzphw collected $1.25 from pot
mSD1pginDsyHG5PDfqzphw: doesn't show hand
aoL+R/61Kxmw69ypuPrWAQ joins the table at seat #8
*** SUMMARY ***
Total pot $1.25 | Rake $0
Seat 1: tLkxo7JgV+WWI0UBw44K5A (button) folded before Flop (didn't bet)
Seat 2: gsyXT42WLEcOS4DdEk2wlw (small blind) folded before Flop
Seat 3: hoglu9inkgs6zN573/bJag (big blind) folded before Flop
Seat 4: E2518gp4aFz1+kAgmGqeEg folded before Flop (didn't bet)
Seat 5: WGW0DgjBUXs1ylURHG8vnQ folded before Flop (didn't bet)
Seat 6: 997ViqAtWn1FPjJqcffwcA folded before Flop (didn't bet)
Seat 7: KPLH0gELgFe2OuAnhJFI5w folded before Flop (didn't bet)
Seat 9: mSD1pginDsyHG5PDfqzphw collected ($1.25)



PokerStars Game #59940487668:  Hold'em No Limit ($0.25/$0.50) - 2009/07/01 1:08:03 ET
Table 'eMxdLyFDf28E0wit6gm3Uw' 6-max Seat #4 is the button
Seat 2: UEjiWqFckVmunpvV128Xfw ($47.75 in chips)
Seat 3: pFpoMlE7/SOsr+6aKNR7bw ($11 in chips)
Seat 4: hPAFLRqGh8YnqPe3HMZiQg ($24.85 in chips)
Seat 5: OtITKlSIHBhVAjRe30+BBQ ($32.25 in chips)
Seat 6: lxIzoHy0RnkfFSODHC2liw ($50 in chips)
OtITKlSIHBhVAjRe30+BBQ: posts small blind $0.25
lxIzoHy0RnkfFSODHC2liw: posts big blind $0.50
FONMraB4GCHzDwDcfciKyw: sits out
*** HOLE CARDS ***
UEjiWqFckVmunpvV128Xfw: raises $1 to $1.50
pFpoMlE7/SOsr+6aKNR7bw: folds
hPAFLRqGh8YnqPe3HMZiQg: folds
OtITKlSIHBhVAjRe30+BBQ: calls $1.25
lxIzoHy0RnkfFSODHC2liw: folds
*** FLOP *** [4h 5s 2d]
OtITKlSIHBhVAjRe30+BBQ: checks
UEjiWqFckVmunpvV128Xfw: bets $2
OtITKlSIHBhVAjRe30+BBQ: folds
UEjiWqFckVmunpvV128Xfw collected $3.35 from pot
*** SUMMARY ***
Total pot $3.50 | Rake $0.15
Board [4h 5s 2d]
Seat 2: UEjiWqFckVmunpvV128Xfw collected ($3.35)
Seat 3: pFpoMlE7/SOsr+6aKNR7bw folded before Flop (didn't bet)
Seat 4: hPAFLRqGh8YnqPe3HMZiQg (button) folded before Flop (didn't bet)
Seat 5: OtITKlSIHBhVAjRe30+BBQ (small blind) folded on the Flop
Seat 6: lxIzoHy0RnkfFSODHC2liw (big blind) folded before Flop



PokerStars Game #59940488570:  Hold'em No Limit ($0.25/$0.50) - 2009/07/01 1:08:04 ET
Table '/cQuAT3ef4t+PGrXiNhGaQ' 9-max Seat #4 is the button
Seat 1: HZkVla4kK2SI42CVrPZ/ig ($14.25 in chips)
Seat 2: jXGruyaMqirTaTXNOvBdew ($68.20 in chips)
Seat 3: g4k0NXISyLCqaSWZDBjfEg ($53.50 in chips)
Seat 4: OWP/DOu+PlPK6ZZ3zYa0HA ($27.60 in chips)
Seat 5: 5SgaHdWixdClWvaEG+KUjQ ($42.85 in chips)
Seat 6: APYIOyK/4AGb+kIwlOUNBQ ($38.10 in chips)
Seat 7: J0W5D97jl5VLky+IoPvDeA ($168.50 in chips)
Seat 8: eBrej2jnlUCs/JgxFCRn2g ($39.60 in chips)
Seat 9: AjV5McH1KMMclY26QdLM5w ($25.70 in chips)
5SgaHdWixdClWvaEG+KUjQ: posts small blind $0.25
APYIOyK/4AGb+kIwlOUNBQ: posts big blind $0.50
*** HOLE CARDS ***
J0W5D97jl5VLky+IoPvDeA: folds
eBrej2jnlUCs/JgxFCRn2g: calls $0.50
AjV5McH1KMMclY26QdLM5w: raises $1.50 to $2
HZkVla4kK2SI42CVrPZ/ig: folds
jXGruyaMqirTaTXNOvBdew: folds
g4k0NXISyLCqaSWZDBjfEg: folds
OWP/DOu+PlPK6ZZ3zYa0HA: folds
5SgaHdWixdClWvaEG+KUjQ: folds
APYIOyK/4AGb+kIwlOUNBQ: folds
eBrej2jnlUCs/JgxFCRn2g: folds
AjV5McH1KMMclY26QdLM5w collected $1.75 from pot
AjV5McH1KMMclY26QdLM5w: doesn't show hand
*** SUMMARY ***
Total pot $1.75 | Rake $0
Seat 1: HZkVla4kK2SI42CVrPZ/ig folded before Flop (didn't bet)
Seat 2: jXGruyaMqirTaTXNOvBdew folded before Flop (didn't bet)
Seat 3: g4k0NXISyLCqaSWZDBjfEg folded before Flop (didn't bet)
Seat 4: OWP/DOu+PlPK6ZZ3zYa0HA (button) folded before Flop (didn't bet)
Seat 5: 5SgaHdWixdClWvaEG+KUjQ (small blind) folded before Flop
Seat 6: APYIOyK/4AGb+kIwlOUNBQ (big blind) folded before Flop
Seat 7: J0W5D97jl5VLky+IoPvDeA folded before Flop (didn't bet)
Seat 8: eBrej2jnlUCs/JgxFCRn2g folded before Flop
Seat 9: AjV5McH1KMMclY26QdLM5w collected ($1.75)



PokerStars Game #59940489010:  Hold'em No Limit ($0.25/$0.50) - 2009/07/01 1:08:05 ET
Table 'BCN5su+SsXiy1zRMJi0SJw' 6-max Seat #6 is the button
Seat 1: GxXV09ciXaOxyY2H5aMIIw ($40.30 in chips)
Seat 2: oU2kDCkT/gilYbHWrg7D8w ($41.05 in chips)
Seat 3: of9mtXiD8G4Nx5p7hCbgqQ ($50 in chips)
Seat 4: 4QfsCWthT/vSLirorNXqtg ($51.45 in chips)
Seat 6: b2symlOdL7+0c9Pj4N/KlA ($60.10 in chips)
GxXV09ciXaOxyY2H5aMIIw: posts small blind $0.25
oU2kDCkT/gilYbHWrg7D8w: posts big blind $0.50
*** HOLE CARDS ***
of9mtXiD8G4Nx5p7hCbgqQ: folds
4QfsCWthT/vSLirorNXqtg: folds
b2symlOdL7+0c9Pj4N/KlA: folds
GxXV09ciXaOxyY2H5aMIIw: folds
oU2kDCkT/gilYbHWrg7D8w collected $0.50 from pot
oU2kDCkT/gilYbHWrg7D8w: doesn't show hand
*** SUMMARY ***
Total pot $0.50 | Rake $0
Seat 1: GxXV09ciXaOxyY2H5aMIIw (small blind) folded before Flop
Seat 2: oU2kDCkT/gilYbHWrg7D8w (big blind) collected ($0.50)
Seat 3: of9mtXiD8G4Nx5p7hCbgqQ folded before Flop (didn't bet)
Seat 4: 4QfsCWthT/vSLirorNXqtg folded before Flop (didn't bet)
Seat 6: b2symlOdL7+0c9Pj4N/KlA (button) folded before Flop (didn't bet)



PokerStars Game #59940489798:  Hold'em No Limit ($0.25/$0.50) - 2009/07/01 1:08:06 ET
Table 'E7bWJ45aoFXRpyRv2gw+Ig' 2-max Seat #1 is the button
Seat 1: FRkiRasEGlHUeLrEl+k/nA ($54.20 in chips)
Seat 2: 3Wro85I7472vJ4Wkpneo9A ($132.90 in chips)
FRkiRasEGlHUeLrEl+k/nA: posts small blind $0.25
3Wro85I7472vJ4Wkpneo9A: posts big blind $0.50
*** HOLE CARDS ***
FRkiRasEGlHUeLrEl+k/nA: calls $0.25
3Wro85I7472vJ4Wkpneo9A: checks
*** FLOP *** [Th 5c 8c]
3Wro85I7472vJ4Wkpneo9A: bets $1
FRkiRasEGlHUeLrEl+k/nA: raises $2 to $3
3Wro85I7472vJ4Wkpneo9A: folds
FRkiRasEGlHUeLrEl+k/nA collected $2.90 from pot
*** SUMMARY ***
Total pot $3 | Rake $0.10
Board [Th 5c 8c]
Seat 1: FRkiRasEGlHUeLrEl+k/nA (button) (small blind) collected ($2.90)
Seat 2: 3Wro85I7472vJ4Wkpneo9A (big blind) folded on the Flop



PokerStars Game #59940489894:  Hold'em No Limit ($0.25/$0.50) - 2009/07/01 1:08:07 ET
Table '0eJtgVAXVvBgncFdcUpXcQ' 2-max Seat #2 is the button
Seat 1: Ag6DvxX4vbRheqsv2zXKTQ ($44.15 in chips)
Seat 2: KMc4R+K9ao4Ur3rF7NGe6Q ($11.20 in chips)
KMc4R+K9ao4Ur3rF7NGe6Q: posts small blind $0.25
Ag6DvxX4vbRheqsv2zXKTQ: posts big blind $0.50
*** HOLE CARDS ***
KMc4R+K9ao4Ur3rF7NGe6Q: calls $0.25
Ag6DvxX4vbRheqsv2zXKTQ: checks
*** FLOP *** [7s 4s 5s]
Ag6DvxX4vbRheqsv2zXKTQ: checks
KMc4R+K9ao4Ur3rF7NGe6Q: checks
*** TURN *** [7s 4s 5s] [5c]
Ag6DvxX4vbRheqsv2zXKTQ: bets $1
KMc4R+K9ao4Ur3rF7NGe6Q: calls $1
*** RIVER *** [7s 4s 5s 5c] [Kd]
Ag6DvxX4vbRheqsv2zXKTQ: bets $1
KMc4R+K9ao4Ur3rF7NGe6Q: folds
Ag6DvxX4vbRheqsv2zXKTQ collected $2.90 from pot
Ag6DvxX4vbRheqsv2zXKTQ: shows [5h 3c] (three of a kind, Fives)
*** SUMMARY ***
Total pot $3 | Rake $0.10
Board [7s 4s 5s 5c Kd]
Seat 1: Ag6DvxX4vbRheqsv2zXKTQ (big blind) collected ($2.90)
Seat 2: KMc4R+K9ao4Ur3rF7NGe6Q (button) (small blind) folded on the River



PokerStars Game #59940490468:  Hold'em No Limit ($0.25/$0.50) - 2009/07/01 1:08:07 ET
Table 'c/CRn+68J3Y8KxD5g1ek2Q' 2-max Seat #1 is the button
Seat 1: 46qCyJ6evTkHo9al5sBMNA ($94.55 in chips)
Seat 2: BypVLsYQt3ePFm2xQL/dOA ($271.25 in chips)
46qCyJ6evTkHo9al5sBMNA: posts small blind $0.25
BypVLsYQt3ePFm2xQL/dOA: posts big blind $0.50
*** HOLE CARDS ***
46qCyJ6evTkHo9al5sBMNA: folds
BypVLsYQt3ePFm2xQL/dOA collected $0.50 from pot
BypVLsYQt3ePFm2xQL/dOA: doesn't show hand
*** SUMMARY ***
Total pot $0.50 | Rake $0
Seat 1: 46qCyJ6evTkHo9al5sBMNA (button) (small blind) folded before Flop
Seat 2: BypVLsYQt3ePFm2xQL/dOA (big blind) collected ($0.50)



PokerStars Game #59940491478:  Hold'em No Limit ($0.25/$0.50) - 2009/07/01 1:08:09 ET
Table 'fx6MqwfYAj/Rt86hBz2L3Q' 9-max Seat #5 is the button
Seat 1: uw9QayAAxLM3Hb+HR7mSkg ($10.50 in chips)
Seat 2: C3rGXblctNcWI6JYPHhaEg ($33.65 in chips)
Seat 3: iadBi5AEt7gTBXbDSSnMYQ ($55.60 in chips)
Seat 4: 75K2MXwN65Sjfp1yHd50Hg ($10 in chips)
Seat 5: iAISe3dVeua8PUn2wwgDHw ($58.50 in chips)
Seat 6: 5k9fvXD9suIgCxU4HLQjTw ($50.25 in chips)
Seat 7: SKnJuWHScqetA/qG5p+wCg ($30 in chips)
Seat 8: JYwJYYV9pM5KWdSiETl8rA ($19.25 in chips)
Seat 9: HZkVla4kK2SI42CVrPZ/ig ($18.30 in chips)
5k9fvXD9suIgCxU4HLQjTw: posts small blind $0.25
SKnJuWHScqetA/qG5p+wCg: posts big blind $0.50
*** HOLE CARDS ***
JYwJYYV9pM5KWdSiETl8rA: folds
HZkVla4kK2SI42CVrPZ/ig: folds
uw9QayAAxLM3Hb+HR7mSkg: folds
C3rGXblctNcWI6JYPHhaEg: folds
iadBi5AEt7gTBXbDSSnMYQ: raises $0.50 to $1
75K2MXwN65Sjfp1yHd50Hg has timed out
75K2MXwN65Sjfp1yHd50Hg: folds
75K2MXwN65Sjfp1yHd50Hg is sitting out
iAISe3dVeua8PUn2wwgDHw: raises $1 to $2
5k9fvXD9suIgCxU4HLQjTw: folds
SKnJuWHScqetA/qG5p+wCg: folds
iadBi5AEt7gTBXbDSSnMYQ: calls $1
*** FLOP *** [Tc 9h As]
iadBi5AEt7gTBXbDSSnMYQ: bets $1
iAISe3dVeua8PUn2wwgDHw: calls $1
*** TURN *** [Tc 9h As] [Ah]
iadBi5AEt7gTBXbDSSnMYQ: bets $1.50
iAISe3dVeua8PUn2wwgDHw: calls $1.50
*** RIVER *** [Tc 9h As Ah] [Th]
iadBi5AEt7gTBXbDSSnMYQ: bets $1.50
iAISe3dVeua8PUn2wwgDHw: raises $1.50 to $3
iadBi5AEt7gTBXbDSSnMYQ: calls $1.50
*** SHOW DOWN ***
iAISe3dVeua8PUn2wwgDHw: shows [Ks Kd] (two pair, Aces and Kings)
iadBi5AEt7gTBXbDSSnMYQ: mucks hand
iAISe3dVeua8PUn2wwgDHw collected $15 from pot
*** SUMMARY ***
Total pot $15.75 | Rake $0.75
Board [Tc 9h As Ah Th]
Seat 1: uw9QayAAxLM3Hb+HR7mSkg folded before Flop (didn't bet)
Seat 2: C3rGXblctNcWI6JYPHhaEg folded before Flop (didn't bet)
Seat 3: iadBi5AEt7gTBXbDSSnMYQ mucked
Seat 4: 75K2MXwN65Sjfp1yHd50Hg folded before Flop (didn't bet)
Seat 5: iAISe3dVeua8PUn2wwgDHw (button) showed [Ks Kd] and won ($15) with two pair, Aces and Kings
Seat 6: 5k9fvXD9suIgCxU4HLQjTw (small blind) folded before Flop
Seat 7: SKnJuWHScqetA/qG5p+wCg (big blind) folded before Flop
Seat 8: JYwJYYV9pM5KWdSiETl8rA folded before Flop (didn't bet)
Seat 9: HZkVla4kK2SI42CVrPZ/ig folded before Flop (didn't bet)



PokerStars Game #59940492634:  Hold'em No Limit ($0.25/$0.50) - 2009/07/01 1:08:11 ET
Table 'WlCrrUP9MxwySQN5fzLFBQ' 2-max Seat #2 is the button
Seat 1: U7xFsli2XvMiGlVDxk8a/Q ($9.35 in chips)
Seat 2: JTT5TsRNqs6npc7cgI4X/w ($21.50 in chips)
JTT5TsRNqs6npc7cgI4X/w: posts small blind $0.25
U7xFsli2XvMiGlVDxk8a/Q: posts big blind $0.50
*** HOLE CARDS ***
JTT5TsRNqs6npc7cgI4X/w: calls $0.25
U7xFsli2XvMiGlVDxk8a/Q: raises $8.85 to $9.35 and is all-in
JTT5TsRNqs6npc7cgI4X/w: folds
U7xFsli2XvMiGlVDxk8a/Q collected $1 from pot
U7xFsli2XvMiGlVDxk8a/Q: doesn't show hand
*** SUMMARY ***
Total pot $1 | Rake $0
Seat 1: U7xFsli2XvMiGlVDxk8a/Q (big blind) collected ($1)
Seat 2: JTT5TsRNqs6npc7cgI4X/w (button) (small blind) folded before Flop



PokerStars Game #59940494060:  Hold'em No Limit ($0.25/$0.50) - 2009/07/01 1:08:13 ET
Table 'GfL/No5u5PoEnU39lP5pQg' 6-max Seat #6 is the button
Seat 1: 1WUCqNG+p+vfWRTXNu4ljw ($64.75 in chips)
Seat 2: uVwggSetzp7d+eVgowO3vg ($57 in chips)
Seat 4: r6u7MWSXF30/khcTYkrG9Q ($35.15 in chips)
Seat 5: M1KyQQvVPVuxqTAB8sR/zQ ($50 in chips)
Seat 6: kxPhs4ePFqMy52CInAJ2aw ($50.85 in chips)
1WUCqNG+p+vfWRTXNu4ljw: posts small blind $0.25
uVwggSetzp7d+eVgowO3vg: posts big blind $0.50
*** HOLE CARDS ***
r6u7MWSXF30/khcTYkrG9Q: folds
M1KyQQvVPVuxqTAB8sR/zQ: raises $1 to $1.50
kxPhs4ePFqMy52CInAJ2aw: folds
1WUCqNG+p+vfWRTXNu4ljw: folds
uVwggSetzp7d+eVgowO3vg: calls $1
*** FLOP *** [6h 5s 5d]
uVwggSetzp7d+eVgowO3vg: checks
M1KyQQvVPVuxqTAB8sR/zQ: checks
*** TURN *** [6h 5s 5d] [9h]
uVwggSetzp7d+eVgowO3vg: checks
M1KyQQvVPVuxqTAB8sR/zQ: checks
*** RIVER *** [6h 5s 5d 9h] [5c]
uVwggSetzp7d+eVgowO3vg: checks
M1KyQQvVPVuxqTAB8sR/zQ: checks
*** SHOW DOWN ***
uVwggSetzp7d+eVgowO3vg: shows [3c Qc] (three of a kind, Fives)
M1KyQQvVPVuxqTAB8sR/zQ: shows [Js Ah] (three of a kind, Fives - Ace kicker)
M1KyQQvVPVuxqTAB8sR/zQ collected $3.10 from pot
*** SUMMARY ***
Total pot $3.25 | Rake $0.15
Board [6h 5s 5d 9h 5c]
Seat 1: 1WUCqNG+p+vfWRTXNu4ljw (small blind) folded before Flop
Seat 2: uVwggSetzp7d+eVgowO3vg (big blind) showed [3c Qc] and lost with three of a kind, Fives
Seat 4: r6u7MWSXF30/khcTYkrG9Q folded before Flop (didn't bet)
Seat 5: M1KyQQvVPVuxqTAB8sR/zQ showed [Js Ah] and won ($3.10) with three of a kind, Fives
Seat 6: kxPhs4ePFqMy52CInAJ2aw (button) folded before Flop (didn't bet)



PokerStars Game #59940494280:  Hold'em No Limit ($0.25/$0.50) - 2009/07/01 1:08:14 ET
Table 'c/CRn+68J3Y8KxD5g1ek2Q' 2-max Seat #2 is the button
Seat 1: 46qCyJ6evTkHo9al5sBMNA ($94.30 in chips)
Seat 2: BypVLsYQt3ePFm2xQL/dOA ($271.50 in chips)
BypVLsYQt3ePFm2xQL/dOA: posts small blind $0.25
46qCyJ6evTkHo9al5sBMNA: posts big blind $0.50
*** HOLE CARDS ***
BypVLsYQt3ePFm2xQL/dOA: calls $0.25
46qCyJ6evTkHo9al5sBMNA: raises $1.50 to $2
BypVLsYQt3ePFm2xQL/dOA: calls $1.50
*** FLOP *** [As Jd 2c]
46qCyJ6evTkHo9al5sBMNA: checks
BypVLsYQt3ePFm2xQL/dOA: checks
*** TURN *** [As Jd 2c] [Js]
46qCyJ6evTkHo9al5sBMNA: checks
BypVLsYQt3ePFm2xQL/dOA: checks
*** RIVER *** [As Jd 2c Js] [Ad]
46qCyJ6evTkHo9al5sBMNA: checks
BypVLsYQt3ePFm2xQL/dOA: checks
*** SHOW DOWN ***
46qCyJ6evTkHo9al5sBMNA: shows [Qh Ts] (two pair, Aces and Jacks)
BypVLsYQt3ePFm2xQL/dOA: mucks hand
46qCyJ6evTkHo9al5sBMNA collected $3.80 from pot
*** SUMMARY ***
Total pot $4 | Rake $0.20
Board [As Jd 2c Js Ad]
Seat 1: 46qCyJ6evTkHo9al5sBMNA (big blind) showed [Qh Ts] and won ($3.80) with two pair, Aces and Jacks
Seat 2: BypVLsYQt3ePFm2xQL/dOA (button) (small blind) mucked



PokerStars Game #59940495096:  Hold'em No Limit ($0.25/$0.50) - 2009/07/01 1:08:15 ET
Table '+dXkOAQyS8j9PQZusUTMpg' 2-max Seat #2 is the button
Seat 1: XFa6sBGjP2gxoIvxR3fZIg ($118.90 in chips)
Seat 2: 5IBeOgaApY1Bvzv2P8X4EA ($76.70 in chips)
5IBeOgaApY1Bvzv2P8X4EA: posts small blind $0.25
XFa6sBGjP2gxoIvxR3fZIg: posts big blind $0.50
*** HOLE CARDS ***
5IBeOgaApY1Bvzv2P8X4EA: calls $0.25
XFa6sBGjP2gxoIvxR3fZIg: checks
*** FLOP *** [As Qd 7s]
XFa6sBGjP2gxoIvxR3fZIg: checks
5IBeOgaApY1Bvzv2P8X4EA: checks
*** TURN *** [As Qd 7s] [9h]
XFa6sBGjP2gxoIvxR3fZIg: checks
5IBeOgaApY1Bvzv2P8X4EA: checks
*** RIVER *** [As Qd 7s 9h] [7d]
XFa6sBGjP2gxoIvxR3fZIg: bets $1
5IBeOgaApY1Bvzv2P8X4EA: calls $1
*** SHOW DOWN ***
XFa6sBGjP2gxoIvxR3fZIg: shows [7h 2h] (three of a kind, Sevens)
5IBeOgaApY1Bvzv2P8X4EA: mucks hand
XFa6sBGjP2gxoIvxR3fZIg collected $2.90 from pot
*** SUMMARY ***
Total pot $3 | Rake $0.10
Board [As Qd 7s 9h 7d]
Seat 1: XFa6sBGjP2gxoIvxR3fZIg (big blind) showed [7h 2h] and won ($2.90) with three of a kind, Sevens
Seat 2: 5IBeOgaApY1Bvzv2P8X4EA (button) (small blind) mucked



PokerStars Game #59940495132:  Hold'em No Limit ($0.25/$0.50) - 2009/07/01 1:08:15 ET
Table 'BCN5su+SsXiy1zRMJi0SJw' 6-max Seat #1 is the button
Seat 1: GxXV09ciXaOxyY2H5aMIIw ($40.05 in chips)
Seat 2: oU2kDCkT/gilYbHWrg7D8w ($41.30 in chips)
Seat 4: 4QfsCWthT/vSLirorNXqtg ($51.45 in chips)
Seat 6: b2symlOdL7+0c9Pj4N/KlA ($60.10 in chips)
oU2kDCkT/gilYbHWrg7D8w: posts small blind $0.25
of9mtXiD8G4Nx5p7hCbgqQ: is sitting out
4QfsCWthT/vSLirorNXqtg: posts big blind $0.50
*** HOLE CARDS ***
b2symlOdL7+0c9Pj4N/KlA: folds
of9mtXiD8G4Nx5p7hCbgqQ leaves the table
GxXV09ciXaOxyY2H5aMIIw: folds
oU2kDCkT/gilYbHWrg7D8w: calls $0.25
4QfsCWthT/vSLirorNXqtg: checks
*** FLOP *** [5s 9c Ad]
oU2kDCkT/gilYbHWrg7D8w: bets $1
4QfsCWthT/vSLirorNXqtg: folds
oU2kDCkT/gilYbHWrg7D8w collected $0.95 from pot
oU2kDCkT/gilYbHWrg7D8w: doesn't show hand
*** SUMMARY ***
Total pot $1 | Rake $0.05
Board [5s 9c Ad]
Seat 1: GxXV09ciXaOxyY2H5aMIIw (button) folded before Flop (didn't bet)
Seat 2: oU2kDCkT/gilYbHWrg7D8w (small blind) collected ($0.95)
Seat 4: 4QfsCWthT/vSLirorNXqtg (big blind) folded on the Flop
Seat 6: b2symlOdL7+0c9Pj4N/KlA folded before Flop (didn't bet)



PokerStars Game #59940498250:  Hold'em No Limit ($0.25/$0.50) - 2009/07/01 1:08:20 ET
Table 'WlCrrUP9MxwySQN5fzLFBQ' 2-max Seat #1 is the button
Seat 1: U7xFsli2XvMiGlVDxk8a/Q ($9.85 in chips)
Seat 2: JTT5TsRNqs6npc7cgI4X/w ($21 in chips)
U7xFsli2XvMiGlVDxk8a/Q: posts small blind $0.25
JTT5TsRNqs6npc7cgI4X/w: posts big blind $0.50
*** HOLE CARDS ***
U7xFsli2XvMiGlVDxk8a/Q: folds
JTT5TsRNqs6npc7cgI4X/w collected $0.50 from pot
JTT5TsRNqs6npc7cgI4X/w: doesn't show hand
*** SUMMARY ***
Total pot $0.50 | Rake $0
Seat 1: U7xFsli2XvMiGlVDxk8a/Q (button) (small blind) folded before Flop
Seat 2: JTT5TsRNqs6npc7cgI4X/w (big blind) collected ($0.50)



PokerStars Game #59940498302:  Hold'em No Limit ($0.25/$0.50) - 2009/07/01 1:08:20 ET
Table 'MJxeZCzYELxiIsyUZyT0jw' 6-max Seat #1 is the button
Seat 1: +Pf9jTVizYlIo+woPvptfA ($50 in chips)
Seat 2: t3GiVMzqA9Svgr5Uol32cQ ($27.60 in chips)
Seat 3: sIG4mp8tZEI+W4nKZNkkQA ($50 in chips)
Seat 4: alGiiQP/wwtYnfuXII+sgw ($63.85 in chips)
Seat 5: 3jvoOXNtXE90w2BdfNZwZQ ($50 in chips)
Seat 6: c0n4hrn20AML9qzyFC2E8Q ($63 in chips)
t3GiVMzqA9Svgr5Uol32cQ: posts small blind $0.25
sIG4mp8tZEI+W4nKZNkkQA: posts big blind $0.50
*** HOLE CARDS ***
alGiiQP/wwtYnfuXII+sgw: calls $0.50
3jvoOXNtXE90w2BdfNZwZQ: folds
c0n4hrn20AML9qzyFC2E8Q: folds
+Pf9jTVizYlIo+woPvptfA: folds
t3GiVMzqA9Svgr5Uol32cQ: calls $0.25
sIG4mp8tZEI+W4nKZNkkQA: checks
*** FLOP *** [9s 5d 3h]
t3GiVMzqA9Svgr5Uol32cQ: checks
sIG4mp8tZEI+W4nKZNkkQA: bets $1
alGiiQP/wwtYnfuXII+sgw: folds
t3GiVMzqA9Svgr5Uol32cQ: folds
sIG4mp8tZEI+W4nKZNkkQA collected $1.45 from pot
sIG4mp8tZEI+W4nKZNkkQA: doesn't show hand
*** SUMMARY ***
Total pot $1.50 | Rake $0.05
Board [9s 5d 3h]
Seat 1: +Pf9jTVizYlIo+woPvptfA (button) folded before Flop (didn't bet)
Seat 2: t3GiVMzqA9Svgr5Uol32cQ (small blind) folded on the Flop
Seat 3: sIG4mp8tZEI+W4nKZNkkQA (big blind) collected ($1.45)
Seat 4: alGiiQP/wwtYnfuXII+sgw folded on the Flop
Seat 5: 3jvoOXNtXE90w2BdfNZwZQ folded before Flop (didn't bet)
Seat 6: c0n4hrn20AML9qzyFC2E8Q folded before Flop (didn't bet)



PokerStars Game #59940498786:  Hold'em No Limit ($0.25/$0.50) - 2009/07/01 1:08:21 ET
Table 'lSisgp6H7Fg1hH5VfjEjYQ' 9-max Seat #4 is the button
Seat 1: 5k9fvXD9suIgCxU4HLQjTw ($50.35 in chips)
Seat 2: UrcnkQOiLVk8BlKDPJSy7Q ($76.55 in chips)
Seat 3: aTkyjTh3w5YLWiIERupZOA ($51.40 in chips)
Seat 4: bwv/rbH/hHhPhY6u9mu04w ($30.70 in chips)
Seat 5: mSD1pginDsyHG5PDfqzphw ($10 in chips)
Seat 6: +k7T5ocke8UwavtgUHm+Cg ($66.30 in chips)
Seat 7: IDtNLR9uFCDdjNsJWMHA5Q ($20.55 in chips)
Seat 8: a4JDWmpFQkL10XfAyuF51A ($27 in chips)
Seat 9: YzeKFbJVLmJGTgNH3ySQlw ($12.95 in chips)
mSD1pginDsyHG5PDfqzphw: posts small blind $0.25
+k7T5ocke8UwavtgUHm+Cg: posts big blind $0.50
*** HOLE CARDS ***
IDtNLR9uFCDdjNsJWMHA5Q: folds
a4JDWmpFQkL10XfAyuF51A: folds
YzeKFbJVLmJGTgNH3ySQlw: calls $0.50
5k9fvXD9suIgCxU4HLQjTw: folds
UrcnkQOiLVk8BlKDPJSy7Q: folds
aTkyjTh3w5YLWiIERupZOA: folds
bwv/rbH/hHhPhY6u9mu04w: raises $1 to $1.50
mSD1pginDsyHG5PDfqzphw: folds
+k7T5ocke8UwavtgUHm+Cg: folds
YzeKFbJVLmJGTgNH3ySQlw: calls $1
*** FLOP *** [9c 2d Qd]
YzeKFbJVLmJGTgNH3ySQlw: checks
bwv/rbH/hHhPhY6u9mu04w: checks
*** TURN *** [9c 2d Qd] [7s]
YzeKFbJVLmJGTgNH3ySQlw: checks
bwv/rbH/hHhPhY6u9mu04w: checks
*** RIVER *** [9c 2d Qd 7s] [6s]
YzeKFbJVLmJGTgNH3ySQlw: bets $2
bwv/rbH/hHhPhY6u9mu04w: calls $2
*** SHOW DOWN ***
YzeKFbJVLmJGTgNH3ySQlw: shows [3d Jd] (high card Queen)
bwv/rbH/hHhPhY6u9mu04w: shows [8d 8h] (a pair of Eights)
bwv/rbH/hHhPhY6u9mu04w collected $7.40 from pot
*** SUMMARY ***
Total pot $7.75 | Rake $0.35
Board [9c 2d Qd 7s 6s]
Seat 1: 5k9fvXD9suIgCxU4HLQjTw folded before Flop (didn't bet)
Seat 2: UrcnkQOiLVk8BlKDPJSy7Q folded before Flop (didn't bet)
Seat 3: aTkyjTh3w5YLWiIERupZOA folded before Flop (didn't bet)
Seat 4: bwv/rbH/hHhPhY6u9mu04w (button) showed [8d 8h] and won ($7.40) with a pair of Eights
Seat 5: mSD1pginDsyHG5PDfqzphw (small blind) folded before Flop
Seat 6: +k7T5ocke8UwavtgUHm+Cg (big blind) folded before Flop
Seat 7: IDtNLR9uFCDdjNsJWMHA5Q folded before Flop (didn't bet)
Seat 8: a4JDWmpFQkL10XfAyuF51A folded before Flop (didn't bet)
Seat 9: YzeKFbJVLmJGTgNH3ySQlw showed [3d Jd] and lost with high card Queen



PokerStars Game #59940499406:  Hold'em No Limit ($0.25/$0.50) - 2009/07/01 1:08:22 ET
Table 'Nz0Vr7WMHL2g5Uk7dDZjpw' 9-max Seat #2 is the button
Seat 1: tLkxo7JgV+WWI0UBw44K5A ($107.10 in chips)
Seat 2: gsyXT42WLEcOS4DdEk2wlw ($30.60 in chips)
Seat 3: hoglu9inkgs6zN573/bJag ($8 in chips)
Seat 4: E2518gp4aFz1+kAgmGqeEg ($13.30 in chips)
Seat 5: WGW0DgjBUXs1ylURHG8vnQ ($21.85 in chips)
Seat 6: 997ViqAtWn1FPjJqcffwcA ($59.80 in chips)
Seat 7: KPLH0gELgFe2OuAnhJFI5w ($23.45 in chips)
Seat 9: mSD1pginDsyHG5PDfqzphw ($10.75 in chips)
hoglu9inkgs6zN573/bJag: posts small blind $0.25
E2518gp4aFz1+kAgmGqeEg: posts big blind $0.50
aoL+R/61Kxmw69ypuPrWAQ: sits out
*** HOLE CARDS ***
WGW0DgjBUXs1ylURHG8vnQ: calls $0.50
997ViqAtWn1FPjJqcffwcA: folds
KPLH0gELgFe2OuAnhJFI5w: folds
mSD1pginDsyHG5PDfqzphw: folds
tLkxo7JgV+WWI0UBw44K5A: folds
gsyXT42WLEcOS4DdEk2wlw: folds
hoglu9inkgs6zN573/bJag: calls $0.25
E2518gp4aFz1+kAgmGqeEg: checks
*** FLOP *** [4h 8h Kc]
hoglu9inkgs6zN573/bJag: checks
E2518gp4aFz1+kAgmGqeEg: checks
WGW0DgjBUXs1ylURHG8vnQ: bets $1
hoglu9inkgs6zN573/bJag: folds
E2518gp4aFz1+kAgmGqeEg: folds
WGW0DgjBUXs1ylURHG8vnQ collected $1.45 from pot
WGW0DgjBUXs1ylURHG8vnQ: doesn't show hand
*** SUMMARY ***
Total pot $1.50 | Rake $0.05
Board [4h 8h Kc]
Seat 1: tLkxo7JgV+WWI0UBw44K5A folded before Flop (didn't bet)
Seat 2: gsyXT42WLEcOS4DdEk2wlw (button) folded before Flop (didn't bet)
Seat 3: hoglu9inkgs6zN573/bJag (small blind) folded on the Flop
Seat 4: E2518gp4aFz1+kAgmGqeEg (big blind) folded on the Flop
Seat 5: WGW0DgjBUXs1ylURHG8vnQ collected ($1.45)
Seat 6: 997ViqAtWn1FPjJqcffwcA folded before Flop (didn't bet)
Seat 7: KPLH0gELgFe2OuAnhJFI5w folded before Flop (didn't bet)
Seat 9: mSD1pginDsyHG5PDfqzphw folded before Flop (didn't bet)



PokerStars Game #59940499948:  Hold'em No Limit ($0.25/$0.50) - 2009/07/01 1:08:23 ET
Table '0eJtgVAXVvBgncFdcUpXcQ' 2-max Seat #1 is the button
Seat 1: Ag6DvxX4vbRheqsv2zXKTQ ($45.55 in chips)
Seat 2: KMc4R+K9ao4Ur3rF7NGe6Q ($9.70 in chips)
Ag6DvxX4vbRheqsv2zXKTQ: posts small blind $0.25
KMc4R+K9ao4Ur3rF7NGe6Q: posts big blind $0.50
*** HOLE CARDS ***
Ag6DvxX4vbRheqsv2zXKTQ: calls $0.25
KMc4R+K9ao4Ur3rF7NGe6Q: raises $0.50 to $1
Ag6DvxX4vbRheqsv2zXKTQ: calls $0.50
*** FLOP *** [8h Qc 3s]
KMc4R+K9ao4Ur3rF7NGe6Q: checks
Ag6DvxX4vbRheqsv2zXKTQ: bets $1
KMc4R+K9ao4Ur3rF7NGe6Q: calls $1
*** TURN *** [8h Qc 3s] [Qs]
KMc4R+K9ao4Ur3rF7NGe6Q: checks
Ag6DvxX4vbRheqsv2zXKTQ: bets $1
KMc4R+K9ao4Ur3rF7NGe6Q: calls $1
*** RIVER *** [8h Qc 3s Qs] [2s]
KMc4R+K9ao4Ur3rF7NGe6Q: checks
Ag6DvxX4vbRheqsv2zXKTQ: checks
*** SHOW DOWN ***
KMc4R+K9ao4Ur3rF7NGe6Q: shows [5c Kc] (a pair of Queens)
Ag6DvxX4vbRheqsv2zXKTQ: shows [6d 8d] (two pair, Queens and Eights)
Ag6DvxX4vbRheqsv2zXKTQ collected $5.75 from pot
*** SUMMARY ***
Total pot $6 | Rake $0.25
Board [8h Qc 3s Qs 2s]
Seat 1: Ag6DvxX4vbRheqsv2zXKTQ (button) (small blind) showed [6d 8d] and won ($5.75) with two pair, Queens and Eights
Seat 2: KMc4R+K9ao4Ur3rF7NGe6Q (big blind) showed [5c Kc] and lost with a pair of Queens



PokerStars Game #59940501036:  Hold'em No Limit ($0.25/$0.50) - 2009/07/01 1:08:25 ET
Table 'E7bWJ45aoFXRpyRv2gw+Ig' 2-max Seat #2 is the button
Seat 1: FRkiRasEGlHUeLrEl+k/nA ($55.60 in chips)
Seat 2: 3Wro85I7472vJ4Wkpneo9A ($131.40 in chips)
3Wro85I7472vJ4Wkpneo9A: posts small blind $0.25
FRkiRasEGlHUeLrEl+k/nA: posts big blind $0.50
*** HOLE CARDS ***
3Wro85I7472vJ4Wkpneo9A: raises $1 to $1.50
FRkiRasEGlHUeLrEl+k/nA: folds
3Wro85I7472vJ4Wkpneo9A collected $1 from pot
3Wro85I7472vJ4Wkpneo9A: doesn't show hand
*** SUMMARY ***
Total pot $1 | Rake $0
Seat 1: FRkiRasEGlHUeLrEl+k/nA (big blind) folded before Flop
Seat 2: 3Wro85I7472vJ4Wkpneo9A (button) (small blind) collected ($1)



PokerStars Game #59940501788:  Hold'em No Limit ($0.25/$0.50) - 2009/07/01 1:08:27 ET
Table 'WlCrrUP9MxwySQN5fzLFBQ' 2-max Seat #2 is the button
Seat 1: U7xFsli2XvMiGlVDxk8a/Q ($9.60 in chips)
Seat 2: JTT5TsRNqs6npc7cgI4X/w ($21.25 in chips)
JTT5TsRNqs6npc7cgI4X/w: posts small blind $0.25
U7xFsli2XvMiGlVDxk8a/Q: posts big blind $0.50
*** HOLE CARDS ***
JTT5TsRNqs6npc7cgI4X/w: calls $0.25
U7xFsli2XvMiGlVDxk8a/Q: raises $9.10 to $9.60 and is all-in
JTT5TsRNqs6npc7cgI4X/w: folds
U7xFsli2XvMiGlVDxk8a/Q collected $1 from pot
U7xFsli2XvMiGlVDxk8a/Q: doesn't show hand
*** SUMMARY ***
Total pot $1 | Rake $0
Seat 1: U7xFsli2XvMiGlVDxk8a/Q (big blind) collected ($1)
Seat 2: JTT5TsRNqs6npc7cgI4X/w (button) (small blind) folded before Flop



PokerStars Game #59940502540:  Hold'em No Limit ($0.25/$0.50) - 2009/07/01 1:08:28 ET
Table 'PALRfuH85dr5IkDfdv6new' 9-max Seat #4 is the button
Seat 1: v/4aX0ejnaIFK4ftDk2Lyg ($50 in chips)
Seat 2: 1aXjSbrubyQKHeauooF5Wg ($48.90 in chips)
Seat 3: 50QWoELmpmHFrFIlWMJo9g ($91.50 in chips)
Seat 4: mZNMJI1mY40XTC0U7GZakA ($50 in chips)
Seat 5: jSSGUXdNFAZA3QCvTcUMQw ($64.20 in chips)
Seat 6: ottZQkg1UDWk85BtBzGJzg ($47.55 in chips)
Seat 7: 3NcyXvr39gnK+KbTq7ezyA ($63.80 in chips)
Seat 8: NkS+CseUKx4XHszWq0PXEQ ($74.65 in chips)
jSSGUXdNFAZA3QCvTcUMQw: posts small blind $0.25
ottZQkg1UDWk85BtBzGJzg: posts big blind $0.50
viwBDtJsY6JfsFOdBAyJIQ: sits out
v/4aX0ejnaIFK4ftDk2Lyg: posts big blind $0.50
*** HOLE CARDS ***
3NcyXvr39gnK+KbTq7ezyA: calls $0.50
NkS+CseUKx4XHszWq0PXEQ: folds
v/4aX0ejnaIFK4ftDk2Lyg: checks
1aXjSbrubyQKHeauooF5Wg: folds
50QWoELmpmHFrFIlWMJo9g: folds
mZNMJI1mY40XTC0U7GZakA: folds
jSSGUXdNFAZA3QCvTcUMQw: calls $0.25
ottZQkg1UDWk85BtBzGJzg: checks
*** FLOP *** [2d 5d 6h]
jSSGUXdNFAZA3QCvTcUMQw: bets $1.50
ottZQkg1UDWk85BtBzGJzg: calls $1.50
3NcyXvr39gnK+KbTq7ezyA: folds
v/4aX0ejnaIFK4ftDk2Lyg: folds
*** TURN *** [2d 5d 6h] [Ah]
jSSGUXdNFAZA3QCvTcUMQw: checks
ottZQkg1UDWk85BtBzGJzg: bets $3
jSSGUXdNFAZA3QCvTcUMQw: folds
ottZQkg1UDWk85BtBzGJzg collected $4.80 from pot
ottZQkg1UDWk85BtBzGJzg: doesn't show hand
*** SUMMARY ***
Total pot $5 | Rake $0.20
Board [2d 5d 6h Ah]
Seat 1: v/4aX0ejnaIFK4ftDk2Lyg folded on the Flop
Seat 2: 1aXjSbrubyQKHeauooF5Wg folded before Flop (didn't bet)
Seat 3: 50QWoELmpmHFrFIlWMJo9g folded before Flop (didn't bet)
Seat 4: mZNMJI1mY40XTC0U7GZakA (button) folded before Flop (didn't bet)
Seat 5: jSSGUXdNFAZA3QCvTcUMQw (small blind) folded on the Turn
Seat 6: ottZQkg1UDWk85BtBzGJzg (big blind) collected ($4.80)
Seat 7: 3NcyXvr39gnK+KbTq7ezyA folded on the Flop
Seat 8: NkS+CseUKx4XHszWq0PXEQ folded before Flop (didn't bet)



PokerStars Game #59940503466:  Hold'em No Limit ($0.25/$0.50) - 2009/07/01 1:08:29 ET
Table 'otvGDROEDdqsabxskT79qg' 9-max Seat #5 is the button
Seat 1: 8ehL7qlZzjgUh2H35iiWLw ($59.75 in chips)
Seat 2: cCjTzH9jio8607WzjcfXlg ($12.25 in chips)
Seat 3: +k7T5ocke8UwavtgUHm+Cg ($70.60 in chips)
Seat 4: MG90wfSJZnOejs/KD3vlQQ ($75.90 in chips)
Seat 5: E2518gp4aFz1+kAgmGqeEg ($11 in chips)
Seat 6: bxLSulbgr8LmKNjOzw8URg ($55.75 in chips)
Seat 7: 75K2MXwN65Sjfp1yHd50Hg ($10 in chips)
Seat 8: zE9cVigS2nW/Ljy4K4bUQA ($30 in chips)
Seat 9: KcY3X8YpD74Kw1RHkx/g4A ($47.90 in chips)
bxLSulbgr8LmKNjOzw8URg: posts small blind $0.25
75K2MXwN65Sjfp1yHd50Hg: posts big blind $0.50
*** HOLE CARDS ***
zE9cVigS2nW/Ljy4K4bUQA: folds
KcY3X8YpD74Kw1RHkx/g4A: folds
8ehL7qlZzjgUh2H35iiWLw: folds
cCjTzH9jio8607WzjcfXlg: calls $0.50
+k7T5ocke8UwavtgUHm+Cg: folds
MG90wfSJZnOejs/KD3vlQQ: folds
E2518gp4aFz1+kAgmGqeEg: folds
bxLSulbgr8LmKNjOzw8URg: calls $0.25
75K2MXwN65Sjfp1yHd50Hg: checks
*** FLOP *** [9s Kc Ah]
bxLSulbgr8LmKNjOzw8URg: checks
75K2MXwN65Sjfp1yHd50Hg: checks
cCjTzH9jio8607WzjcfXlg: bets $1
bxLSulbgr8LmKNjOzw8URg: folds
75K2MXwN65Sjfp1yHd50Hg: folds
cCjTzH9jio8607WzjcfXlg collected $1.45 from pot
*** SUMMARY ***
Total pot $1.50 | Rake $0.05
Board [9s Kc Ah]
Seat 1: 8ehL7qlZzjgUh2H35iiWLw folded before Flop (didn't bet)
Seat 2: cCjTzH9jio8607WzjcfXlg collected ($1.45)
Seat 3: +k7T5ocke8UwavtgUHm+Cg folded before Flop (didn't bet)
Seat 4: MG90wfSJZnOejs/KD3vlQQ folded before Flop (didn't bet)
Seat 5: E2518gp4aFz1+kAgmGqeEg (button) folded before Flop (didn't bet)
Seat 6: bxLSulbgr8LmKNjOzw8URg (small blind) folded on the Flop
Seat 7: 75K2MXwN65Sjfp1yHd50Hg (big blind) folded on the Flop
Seat 8: zE9cVigS2nW/Ljy4K4bUQA folded before Flop (didn't bet)
Seat 9: KcY3X8YpD74Kw1RHkx/g4A folded before Flop (didn't bet)



PokerStars Game #59940504118:  Hold'em No Limit ($0.25/$0.50) - 2009/07/01 1:08:31 ET
Table 'kgbJRsxfv64KrErDRBAkcw' 6-max Seat #1 is the button
Seat 1: VamsyhlFzXGF6/ydo0BHeA ($42.45 in chips)
Seat 2: AdS8BJMOheS01zjCDfPMFg ($49.50 in chips)
Seat 5: eUBBn2R56C1IQ6Cs/vitwg ($61.20 in chips)
Seat 6: 1b+2BbjMN8qhR1WPqdE9VQ ($57.60 in chips)
AdS8BJMOheS01zjCDfPMFg: posts small blind $0.25
eUBBn2R56C1IQ6Cs/vitwg: posts big blind $0.50
*** HOLE CARDS ***
1b+2BbjMN8qhR1WPqdE9VQ: folds
VamsyhlFzXGF6/ydo0BHeA: calls $0.50
AdS8BJMOheS01zjCDfPMFg: calls $0.25
eUBBn2R56C1IQ6Cs/vitwg: checks
*** FLOP *** [8d 9h 3c]
AdS8BJMOheS01zjCDfPMFg: checks
eUBBn2R56C1IQ6Cs/vitwg: checks
VamsyhlFzXGF6/ydo0BHeA: bets $1
AdS8BJMOheS01zjCDfPMFg: folds
eUBBn2R56C1IQ6Cs/vitwg: folds
VamsyhlFzXGF6/ydo0BHeA collected $1.45 from pot
VamsyhlFzXGF6/ydo0BHeA: doesn't show hand
*** SUMMARY ***
Total pot $1.50 | Rake $0.05
Board [8d 9h 3c]
Seat 1: VamsyhlFzXGF6/ydo0BHeA (button) collected ($1.45)
Seat 2: AdS8BJMOheS01zjCDfPMFg (small blind) folded on the Flop
Seat 5: eUBBn2R56C1IQ6Cs/vitwg (big blind) folded on the Flop
Seat 6: 1b+2BbjMN8qhR1WPqdE9VQ folded before Flop (didn't bet)



PokerStars Game #59940504184:  Hold'em No Limit ($0.25/$0.50) - 2009/07/01 1:08:31 ET
Table 'ibNfFy0bCzuBaUORla0aGw' 9-max Seat #3 is the button
Seat 1: xZCXQSXlrZkp3pZizzVXCw ($50.55 in chips)
Seat 2: 90Wb75h3W1BRpbqVnuk8gw ($53.50 in chips)
Seat 3: AjV5McH1KMMclY26QdLM5w ($25 in chips)
Seat 4: YBN054X4blmis+B2bBlC0g ($22.90 in chips)
Seat 5: GIJAc9kPrLZHLSX8Q6i99w ($22.45 in chips)
Seat 7: HZkVla4kK2SI42CVrPZ/ig ($13.80 in chips)
Seat 8: 2CfOMUqXsQk69Igusq28Pg ($11.20 in chips)
Seat 9: pFtzb1sR4b0d1aw6aIRgDg ($50.05 in chips)
YBN054X4blmis+B2bBlC0g: posts small blind $0.25
GIJAc9kPrLZHLSX8Q6i99w: posts big blind $0.50
H8cPaCtX7d6meGUVSM5sxw: sits out
*** HOLE CARDS ***
HZkVla4kK2SI42CVrPZ/ig: calls $0.50
2CfOMUqXsQk69Igusq28Pg: folds
pFtzb1sR4b0d1aw6aIRgDg: folds
xZCXQSXlrZkp3pZizzVXCw: folds
90Wb75h3W1BRpbqVnuk8gw: folds
AjV5McH1KMMclY26QdLM5w: folds
YBN054X4blmis+B2bBlC0g: folds
GIJAc9kPrLZHLSX8Q6i99w: checks
*** FLOP *** [5s 2d 3c]
GIJAc9kPrLZHLSX8Q6i99w: checks
HZkVla4kK2SI42CVrPZ/ig: bets $1
GIJAc9kPrLZHLSX8Q6i99w: folds
HZkVla4kK2SI42CVrPZ/ig collected $1.20 from pot
*** SUMMARY ***
Total pot $1.25 | Rake $0.05
Board [5s 2d 3c]
Seat 1: xZCXQSXlrZkp3pZizzVXCw folded before Flop (didn't bet)
Seat 2: 90Wb75h3W1BRpbqVnuk8gw folded before Flop (didn't bet)
Seat 3: AjV5McH1KMMclY26QdLM5w (button) folded before Flop (didn't bet)
Seat 4: YBN054X4blmis+B2bBlC0g (small blind) folded before Flop
Seat 5: GIJAc9kPrLZHLSX8Q6i99w (big blind) folded on the Flop
Seat 7: HZkVla4kK2SI42CVrPZ/ig collected ($1.20)
Seat 8: 2CfOMUqXsQk69Igusq28Pg folded before Flop (didn't bet)
Seat 9: pFtzb1sR4b0d1aw6aIRgDg folded before Flop (didn't bet)



PokerStars Game #59940506146:  Hold'em No Limit ($0.25/$0.50) - 2009/07/01 1:08:34 ET
Table 'E7bWJ45aoFXRpyRv2gw+Ig' 2-max Seat #1 is the button
Seat 1: FRkiRasEGlHUeLrEl+k/nA ($55.10 in chips)
Seat 2: 3Wro85I7472vJ4Wkpneo9A ($131.90 in chips)
FRkiRasEGlHUeLrEl+k/nA: posts small blind $0.25
3Wro85I7472vJ4Wkpneo9A: posts big blind $0.50
*** HOLE CARDS ***
FRkiRasEGlHUeLrEl+k/nA: raises $1 to $1.50
3Wro85I7472vJ4Wkpneo9A: calls $1
*** FLOP *** [3c Kh Qc]
3Wro85I7472vJ4Wkpneo9A: checks
FRkiRasEGlHUeLrEl+k/nA: bets $1.50
3Wro85I7472vJ4Wkpneo9A: folds
FRkiRasEGlHUeLrEl+k/nA collected $2.85 from pot
FRkiRasEGlHUeLrEl+k/nA: doesn't show hand
*** SUMMARY ***
Total pot $3 | Rake $0.15
Board [3c Kh Qc]
Seat 1: FRkiRasEGlHUeLrEl+k/nA (button) (small blind) collected ($2.85)
Seat 2: 3Wro85I7472vJ4Wkpneo9A (big blind) folded on the Flop



PokerStars Game #59940506206:  Hold'em No Limit ($0.25/$0.50) - 2009/07/01 1:08:34 ET
Table '+dXkOAQyS8j9PQZusUTMpg' 2-max Seat #1 is the button
Seat 1: XFa6sBGjP2gxoIvxR3fZIg ($120.30 in chips)
Seat 2: 5IBeOgaApY1Bvzv2P8X4EA ($75.20 in chips)
XFa6sBGjP2gxoIvxR3fZIg: posts small blind $0.25
5IBeOgaApY1Bvzv2P8X4EA: posts big blind $0.50
*** HOLE CARDS ***
XFa6sBGjP2gxoIvxR3fZIg: raises $1 to $1.50
5IBeOgaApY1Bvzv2P8X4EA: calls $1
*** FLOP *** [4h Th 9h]
5IBeOgaApY1Bvzv2P8X4EA: checks
XFa6sBGjP2gxoIvxR3fZIg: checks
*** TURN *** [4h Th 9h] [7d]
5IBeOgaApY1Bvzv2P8X4EA: checks
XFa6sBGjP2gxoIvxR3fZIg: checks
*** RIVER *** [4h Th 9h 7d] [Ad]
5IBeOgaApY1Bvzv2P8X4EA: checks
XFa6sBGjP2gxoIvxR3fZIg: checks
*** SHOW DOWN ***
5IBeOgaApY1Bvzv2P8X4EA: shows [Qc 9d] (a pair of Nines)
XFa6sBGjP2gxoIvxR3fZIg: mucks hand
5IBeOgaApY1Bvzv2P8X4EA collected $2.85 from pot
*** SUMMARY ***
Total pot $3 | Rake $0.15
Board [4h Th 9h 7d Ad]
Seat 1: XFa6sBGjP2gxoIvxR3fZIg (button) (small blind) mucked
Seat 2: 5IBeOgaApY1Bvzv2P8X4EA (big blind) showed [Qc 9d] and won ($2.85) with a pair of Nines



PokerStars Game #59940506104:  Hold'em No Limit ($0.25/$0.50) - 2009/07/01 1:08:34 ET
Table 'BCN5su+SsXiy1zRMJi0SJw' 6-max Seat #2 is the button
Seat 1: GxXV09ciXaOxyY2H5aMIIw ($40.05 in chips)
Seat 2: oU2kDCkT/gilYbHWrg7D8w ($41.75 in chips)
Seat 4: 4QfsCWthT/vSLirorNXqtg ($50.95 in chips)
Seat 6: b2symlOdL7+0c9Pj4N/KlA ($60.10 in chips)
4QfsCWthT/vSLirorNXqtg: posts small blind $0.25
b2symlOdL7+0c9Pj4N/KlA: posts big blind $0.50
*** HOLE CARDS ***
kwgv5lNhiFrfONXCshzxlA joins the table at seat #3
GxXV09ciXaOxyY2H5aMIIw: folds
oU2kDCkT/gilYbHWrg7D8w: calls $0.50
4QfsCWthT/vSLirorNXqtg: folds
WUgnrlL2IrGbGEyDnzOJzQ joins the table at seat #5
b2symlOdL7+0c9Pj4N/KlA: checks
*** FLOP *** [5s Jh 3d]
b2symlOdL7+0c9Pj4N/KlA: checks
oU2kDCkT/gilYbHWrg7D8w: bets $1
b2symlOdL7+0c9Pj4N/KlA: folds
oU2kDCkT/gilYbHWrg7D8w collected $1.20 from pot
oU2kDCkT/gilYbHWrg7D8w: doesn't show hand
*** SUMMARY ***
Total pot $1.25 | Rake $0.05
Board [5s Jh 3d]
Seat 1: GxXV09ciXaOxyY2H5aMIIw folded before Flop (didn't bet)
Seat 2: oU2kDCkT/gilYbHWrg7D8w (button) collected ($1.20)
Seat 4: 4QfsCWthT/vSLirorNXqtg (small blind) folded before Flop
Seat 6: b2symlOdL7+0c9Pj4N/KlA (big blind) folded on the Flop



PokerStars Game #59940506888:  Hold'em No Limit ($0.25/$0.50) - 2009/07/01 1:08:35 ET
Table 'WlCrrUP9MxwySQN5fzLFBQ' 2-max Seat #1 is the button
Seat 1: U7xFsli2XvMiGlVDxk8a/Q ($10.10 in chips)
Seat 2: JTT5TsRNqs6npc7cgI4X/w ($20.75 in chips)
U7xFsli2XvMiGlVDxk8a/Q: posts small blind $0.25
JTT5TsRNqs6npc7cgI4X/w: posts big blind $0.50
*** HOLE CARDS ***
U7xFsli2XvMiGlVDxk8a/Q: raises $9.60 to $10.10 and is all-in
JTT5TsRNqs6npc7cgI4X/w: folds
U7xFsli2XvMiGlVDxk8a/Q collected $1 from pot
U7xFsli2XvMiGlVDxk8a/Q: doesn't show hand
*** SUMMARY ***
Total pot $1 | Rake $0
Seat 1: U7xFsli2XvMiGlVDxk8a/Q (button) (small blind) collected ($1)
Seat 2: JTT5TsRNqs6npc7cgI4X/w (big blind) folded before Flop



PokerStars Game #59940506410:  Hold'em No Limit ($0.25/$0.50) - 2009/07/01 1:08:35 ET
Table 'hSTs/dUsYLgJQuF2Onp0MQ' 6-max Seat #4 is the button
Seat 1: 1WUCqNG+p+vfWRTXNu4ljw ($50 in chips)
Seat 2: 6vNxrjjCl6FwfaaymM9jjg ($35.05 in chips)
Seat 3: C3qJBo7uxfFVDluE1lmK2w ($52.60 in chips)
Seat 4: L0aIPg7qefDQjdJo3HCVEA ($10.05 in chips)
Seat 5: 686aeHikcJlgKkSuIFdcXQ ($57.40 in chips)
Seat 6: M1KyQQvVPVuxqTAB8sR/zQ ($80.40 in chips)
686aeHikcJlgKkSuIFdcXQ: posts small blind $0.25
M1KyQQvVPVuxqTAB8sR/zQ: posts big blind $0.50
*** HOLE CARDS ***
1WUCqNG+p+vfWRTXNu4ljw: raises $1.50 to $2
6vNxrjjCl6FwfaaymM9jjg: folds
C3qJBo7uxfFVDluE1lmK2w: folds
L0aIPg7qefDQjdJo3HCVEA: folds
686aeHikcJlgKkSuIFdcXQ: folds
M1KyQQvVPVuxqTAB8sR/zQ: folds
1WUCqNG+p+vfWRTXNu4ljw collected $1.25 from pot
*** SUMMARY ***
Total pot $1.25 | Rake $0
Seat 1: 1WUCqNG+p+vfWRTXNu4ljw collected ($1.25)
Seat 2: 6vNxrjjCl6FwfaaymM9jjg folded before Flop (didn't bet)
Seat 3: C3qJBo7uxfFVDluE1lmK2w folded before Flop (didn't bet)
Seat 4: L0aIPg7qefDQjdJo3HCVEA (button) folded before Flop (didn't bet)
Seat 5: 686aeHikcJlgKkSuIFdcXQ (small blind) folded before Flop
Seat 6: M1KyQQvVPVuxqTAB8sR/zQ (big blind) folded before Flop



PokerStars Game #59940507354:  Hold'em No Limit ($0.25/$0.50) - 2009/07/01 1:08:36 ET
Table 'c/CRn+68J3Y8KxD5g1ek2Q' 2-max Seat #1 is the button
Seat 1: 46qCyJ6evTkHo9al5sBMNA ($96.10 in chips)
Seat 2: BypVLsYQt3ePFm2xQL/dOA ($269.50 in chips)
46qCyJ6evTkHo9al5sBMNA: posts small blind $0.25
BypVLsYQt3ePFm2xQL/dOA: posts big blind $0.50
*** HOLE CARDS ***
46qCyJ6evTkHo9al5sBMNA: folds
BypVLsYQt3ePFm2xQL/dOA collected $0.50 from pot
BypVLsYQt3ePFm2xQL/dOA: doesn't show hand
*** SUMMARY ***
Total pot $0.50 | Rake $0
Seat 1: 46qCyJ6evTkHo9al5sBMNA (button) (small blind) folded before Flop
Seat 2: BypVLsYQt3ePFm2xQL/dOA (big blind) collected ($0.50)



PokerStars Game #59940507754:  Hold'em No Limit ($0.25/$0.50) - 2009/07/01 1:08:37 ET
Table '8BQGgNetI1NOvWeu3gtMNw' 2-max Seat #2 is the button
Seat 1: bypIyrYcAAifLfhZpGlKLA ($91.40 in chips)
Seat 2: Z4HwehErEwzsv/noQlfUlg ($106.75 in chips)
Z4HwehErEwzsv/noQlfUlg: posts small blind $0.25
bypIyrYcAAifLfhZpGlKLA: posts big blind $0.50
*** HOLE CARDS ***
Z4HwehErEwzsv/noQlfUlg: raises $2.50 to $3
bypIyrYcAAifLfhZpGlKLA: folds
Z4HwehErEwzsv/noQlfUlg collected $1 from pot
Z4HwehErEwzsv/noQlfUlg: doesn't show hand
*** SUMMARY ***
Total pot $1 | Rake $0
Seat 1: bypIyrYcAAifLfhZpGlKLA (big blind) folded before Flop
Seat 2: Z4HwehErEwzsv/noQlfUlg (button) (small blind) collected ($1)



PokerStars Game #59940507764:  Hold'em No Limit ($0.25/$0.50) - 2009/07/01 1:08:37 ET
Table 'eMxdLyFDf28E0wit6gm3Uw' 6-max Seat #5 is the button
Seat 1: FONMraB4GCHzDwDcfciKyw ($50 in chips)
Seat 2: UEjiWqFckVmunpvV128Xfw ($49.60 in chips)
Seat 3: pFpoMlE7/SOsr+6aKNR7bw ($11 in chips)
Seat 4: hPAFLRqGh8YnqPe3HMZiQg ($24.85 in chips)
Seat 5: OtITKlSIHBhVAjRe30+BBQ ($30.75 in chips)
Seat 6: lxIzoHy0RnkfFSODHC2liw ($50 in chips)
lxIzoHy0RnkfFSODHC2liw: posts small blind $0.25
FONMraB4GCHzDwDcfciKyw: posts big blind $0.50
*** HOLE CARDS ***
UEjiWqFckVmunpvV128Xfw: folds
pFpoMlE7/SOsr+6aKNR7bw: raises $1.50 to $2
hPAFLRqGh8YnqPe3HMZiQg: folds
OtITKlSIHBhVAjRe30+BBQ: calls $2
lxIzoHy0RnkfFSODHC2liw: folds
FONMraB4GCHzDwDcfciKyw: folds
*** FLOP *** [Js 9s 4h]
pFpoMlE7/SOsr+6aKNR7bw: checks
OtITKlSIHBhVAjRe30+BBQ: bets $4
pFpoMlE7/SOsr+6aKNR7bw: calls $4
*** TURN *** [Js 9s 4h] [Kd]
pFpoMlE7/SOsr+6aKNR7bw: checks
OtITKlSIHBhVAjRe30+BBQ: bets $6
pFpoMlE7/SOsr+6aKNR7bw: calls $5 and is all-in
*** RIVER *** [Js 9s 4h Kd] [Tc]
*** SHOW DOWN ***
pFpoMlE7/SOsr+6aKNR7bw: shows [Kh Qh] (a straight, Nine to King)
OtITKlSIHBhVAjRe30+BBQ: shows [As Qd] (a straight, Ten to Ace)
OtITKlSIHBhVAjRe30+BBQ collected $21.65 from pot
*** SUMMARY ***
Total pot $22.75 | Rake $1.10
Board [Js 9s 4h Kd Tc]
Seat 1: FONMraB4GCHzDwDcfciKyw (big blind) folded before Flop
Seat 2: UEjiWqFckVmunpvV128Xfw folded before Flop (didn't bet)
Seat 3: pFpoMlE7/SOsr+6aKNR7bw showed [Kh Qh] and lost with a straight, Nine to King
Seat 4: hPAFLRqGh8YnqPe3HMZiQg folded before Flop (didn't bet)
Seat 5: OtITKlSIHBhVAjRe30+BBQ (button) showed [As Qd] and won ($21.65) with a straight, Ten to Ace
Seat 6: lxIzoHy0RnkfFSODHC2liw (small blind) folded before Flop



PokerStars Game #59940508506:  Hold'em No Limit ($0.25/$0.50) - 2009/07/01 1:08:38 ET
Table 'tYh970kmVfYS0gXPT/XtoQ' 2-max Seat #2 is the button
Seat 1: CLj3pYZDnglQbP8AEHiYIw ($50 in chips)
Seat 2: fxN9bTdAgPNvNkHgbVXKGw ($10 in chips)
fxN9bTdAgPNvNkHgbVXKGw: posts small blind $0.25
CLj3pYZDnglQbP8AEHiYIw: posts big blind $0.50
*** HOLE CARDS ***
fxN9bTdAgPNvNkHgbVXKGw: calls $0.25
CLj3pYZDnglQbP8AEHiYIw: raises $1.50 to $2
fxN9bTdAgPNvNkHgbVXKGw: calls $1.50
*** FLOP *** [Qh 5s Tc]
CLj3pYZDnglQbP8AEHiYIw: checks
fxN9bTdAgPNvNkHgbVXKGw: checks
*** TURN *** [Qh 5s Tc] [9c]
CLj3pYZDnglQbP8AEHiYIw: bets $3
fxN9bTdAgPNvNkHgbVXKGw: calls $3
*** RIVER *** [Qh 5s Tc 9c] [Th]
CLj3pYZDnglQbP8AEHiYIw: bets $3.50
fxN9bTdAgPNvNkHgbVXKGw: calls $3.50
*** SHOW DOWN ***
CLj3pYZDnglQbP8AEHiYIw: shows [Jc Qc] (two pair, Queens and Tens)
fxN9bTdAgPNvNkHgbVXKGw: mucks hand
CLj3pYZDnglQbP8AEHiYIw collected $16.50 from pot
*** SUMMARY ***
Total pot $17 | Rake $0.50
Board [Qh 5s Tc 9c Th]
Seat 1: CLj3pYZDnglQbP8AEHiYIw (big blind) showed [Jc Qc] and won ($16.50) with two pair, Queens and Tens
Seat 2: fxN9bTdAgPNvNkHgbVXKGw (button) (small blind) mucked



PokerStars Game #59940509318:  Hold'em No Limit ($0.25/$0.50) - 2009/07/01 1:08:40 ET
Table 'EiNh8p/wGJ1FP575iMFnqg' 9-max Seat #1 is the button
Seat 1: r3ZqM1Mi0W3y4hOdssE+Sg ($40.85 in chips)
Seat 2: 8ehL7qlZzjgUh2H35iiWLw ($53.65 in chips)
Seat 3: ymLPoEIl7UL3TvZYmnadxQ ($58.90 in chips)
Seat 4: cMzaiXAM/ZAdNaEUu+LqhA ($54.95 in chips)
Seat 5: M+7+BTmX5vZatHVuoRB1nA ($80.45 in chips)
Seat 6: 3UmXLy3GfjC3EkOebduerQ ($61.60 in chips)
Seat 7: 997ViqAtWn1FPjJqcffwcA ($50 in chips)
Seat 8: mSD1pginDsyHG5PDfqzphw ($10 in chips)
Seat 9: NnQCepdIR/AOUQn1yhYx6Q ($21.50 in chips)
8ehL7qlZzjgUh2H35iiWLw: posts small blind $0.25
ymLPoEIl7UL3TvZYmnadxQ: posts big blind $0.50
*** HOLE CARDS ***
cMzaiXAM/ZAdNaEUu+LqhA: folds
M+7+BTmX5vZatHVuoRB1nA: folds
3UmXLy3GfjC3EkOebduerQ: folds
997ViqAtWn1FPjJqcffwcA: folds
mSD1pginDsyHG5PDfqzphw: folds
NnQCepdIR/AOUQn1yhYx6Q: folds
r3ZqM1Mi0W3y4hOdssE+Sg: folds
8ehL7qlZzjgUh2H35iiWLw: folds
ymLPoEIl7UL3TvZYmnadxQ collected $0.50 from pot
ymLPoEIl7UL3TvZYmnadxQ: doesn't show hand
*** SUMMARY ***
Total pot $0.50 | Rake $0
Seat 1: r3ZqM1Mi0W3y4hOdssE+Sg (button) folded before Flop (didn't bet)
Seat 2: 8ehL7qlZzjgUh2H35iiWLw (small blind) folded before Flop
Seat 3: ymLPoEIl7UL3TvZYmnadxQ (big blind) collected ($0.50)
Seat 4: cMzaiXAM/ZAdNaEUu+LqhA folded before Flop (didn't bet)
Seat 5: M+7+BTmX5vZatHVuoRB1nA folded before Flop (didn't bet)
Seat 6: 3UmXLy3GfjC3EkOebduerQ folded before Flop (didn't bet)
Seat 7: 997ViqAtWn1FPjJqcffwcA folded before Flop (didn't bet)
Seat 8: mSD1pginDsyHG5PDfqzphw folded before Flop (didn't bet)
Seat 9: NnQCepdIR/AOUQn1yhYx6Q folded before Flop (didn't bet)



PokerStars Game #59940509896:  Hold'em No Limit ($0.25/$0.50) - 2009/07/01 1:08:41 ET
Table 'ErOuyGLI5PT3G5MnpHgC/gQOgaEqMcJ73pcUMMxoisUg Seat #5 is the button
Seat 2: pciZn00ZDk4BVBMTTMcNVQ ($28 in chips)
Seat 3: xZCXQSXlrZkp3pZizzVXCw ($52 in chips)
Seat 4: 3UmXLy3GfjC3EkOebduerQ ($50 in chips)
Seat 5: JwvquocWfhTVApN5t47LgA ($64.60 in chips)
Seat 6: zE9cVigS2nW/Ljy4K4bUQA ($31.10 in chips)
Seat 7: 90Wb75h3W1BRpbqVnuk8gw ($63.60 in chips)
Seat 8: g4k0NXISyLCqaSWZDBjfEg ($50.75 in chips)
Seat 9: J0W5D97jl5VLky+IoPvDeA ($52.35 in chips)
zE9cVigS2nW/Ljy4K4bUQA: posts small blind $0.25
90Wb75h3W1BRpbqVnuk8gw: posts big blind $0.50
eBrej2jnlUCs/JgxFCRn2g: sits out
*** HOLE CARDS ***
g4k0NXISyLCqaSWZDBjfEg: folds
J0W5D97jl5VLky+IoPvDeA: folds
pciZn00ZDk4BVBMTTMcNVQ: folds
xZCXQSXlrZkp3pZizzVXCw: raises $1 to $1.50
3UmXLy3GfjC3EkOebduerQ: folds
JwvquocWfhTVApN5t47LgA: folds
zE9cVigS2nW/Ljy4K4bUQA: folds
90Wb75h3W1BRpbqVnuk8gw: calls $1
*** FLOP *** [3d 8s 3c]
90Wb75h3W1BRpbqVnuk8gw: checks
xZCXQSXlrZkp3pZizzVXCw: checks
*** TURN *** [3d 8s 3c] [Kh]
90Wb75h3W1BRpbqVnuk8gw: bets $2
xZCXQSXlrZkp3pZizzVXCw: folds
90Wb75h3W1BRpbqVnuk8gw collected $3.10 from pot
*** SUMMARY ***
Total pot $3.25 | Rake $0.15
Board [3d 8s 3c Kh]
Seat 2: pciZn00ZDk4BVBMTTMcNVQ folded before Flop (didn't bet)
Seat 3: xZCXQSXlrZkp3pZizzVXCw folded on the Turn
Seat 4: 3UmXLy3GfjC3EkOebduerQ folded before Flop (didn't bet)
Seat 5: JwvquocWfhTVApN5t47LgA (button) folded before Flop (didn't bet)
Seat 6: zE9cVigS2nW/Ljy4K4bUQA (small blind) folded before Flop
Seat 7: 90Wb75h3W1BRpbqVnuk8gw (big blind) collected ($3.10)
Seat 8: g4k0NXISyLCqaSWZDBjfEg folded before Flop (didn't bet)
Seat 9: J0W5D97jl5VLky+IoPvDeA folded before Flop (didn't bet)



PokerStars Game #59940510618:  Hold'em No Limit ($0.25/$0.50) - 2009/07/01 1:08:42 ET
Table 'lpxYasB1ClBSgTpCCITwhQ' 9-max Seat #9 is the button
Seat 1: mj7PS7wCH4PAl7+eYTFs7A ($49.50 in chips)
Seat 2: OWP/DOu+PlPK6ZZ3zYa0HA ($24.95 in chips)
Seat 3: sakr/FIfFtIZwDPmAj5Pzg ($50.95 in chips)
Seat 4: NnQCepdIR/AOUQn1yhYx6Q ($10 in chips)
Seat 5: IYd5zG8k7vdBNVHbHg2Pag ($35 in chips)
Seat 6: SegjDnMxWMujiD57ESNL+g ($11.35 in chips)
Seat 7: bmRtaIYKthN1F+B3JLZ3Jw ($73.40 in chips)
Seat 8: /mfensKw8/iZ1Vrx33S4xg ($19.50 in chips)
Seat 9: sUIUZ+begh92dzkUmvbMrw ($12.80 in chips)
mj7PS7wCH4PAl7+eYTFs7A: posts small blind $0.25
OWP/DOu+PlPK6ZZ3zYa0HA: posts big blind $0.50
*** HOLE CARDS ***
sakr/FIfFtIZwDPmAj5Pzg has timed out
sakr/FIfFtIZwDPmAj5Pzg: folds
sakr/FIfFtIZwDPmAj5Pzg is sitting out
NnQCepdIR/AOUQn1yhYx6Q: folds
IYd5zG8k7vdBNVHbHg2Pag: folds
SegjDnMxWMujiD57ESNL+g: folds
bmRtaIYKthN1F+B3JLZ3Jw: calls $0.50
/mfensKw8/iZ1Vrx33S4xg: folds
sUIUZ+begh92dzkUmvbMrw: folds
mj7PS7wCH4PAl7+eYTFs7A: folds
OWP/DOu+PlPK6ZZ3zYa0HA: checks
*** FLOP *** [6h Qh 3s]
OWP/DOu+PlPK6ZZ3zYa0HA: checks
bmRtaIYKthN1F+B3JLZ3Jw: bets $0.50
OWP/DOu+PlPK6ZZ3zYa0HA: folds
sakr/FIfFtIZwDPmAj5Pzg has returned
bmRtaIYKthN1F+B3JLZ3Jw collected $1.20 from pot
*** SUMMARY ***
Total pot $1.25 | Rake $0.05
Board [6h Qh 3s]
Seat 1: mj7PS7wCH4PAl7+eYTFs7A (small blind) folded before Flop
Seat 2: OWP/DOu+PlPK6ZZ3zYa0HA (big blind) folded on the Flop
Seat 3: sakr/FIfFtIZwDPmAj5Pzg folded before Flop (didn't bet)
Seat 4: NnQCepdIR/AOUQn1yhYx6Q folded before Flop (didn't bet)
Seat 5: IYd5zG8k7vdBNVHbHg2Pag folded before Flop (didn't bet)
Seat 6: SegjDnMxWMujiD57ESNL+g folded before Flop (didn't bet)
Seat 7: bmRtaIYKthN1F+B3JLZ3Jw collected ($1.20)
Seat 8: /mfensKw8/iZ1Vrx33S4xg folded before Flop (didn't bet)
Seat 9: sUIUZ+begh92dzkUmvbMrw (button) folded before Flop (didn't bet)



PokerStars Game #59940511180:  Hold'em No Limit ($0.25/$0.50) - 2009/07/01 1:08:43 ET
Table 'c/CRn+68J3Y8KxD5g1ek2Q' 2-max Seat #2 is the button
Seat 1: 46qCyJ6evTkHo9al5sBMNA ($95.85 in chips)
Seat 2: BypVLsYQt3ePFm2xQL/dOA ($269.75 in chips)
BypVLsYQt3ePFm2xQL/dOA: posts small blind $0.25
46qCyJ6evTkHo9al5sBMNA: posts big blind $0.50
*** HOLE CARDS ***
BypVLsYQt3ePFm2xQL/dOA: calls $0.25
46qCyJ6evTkHo9al5sBMNA: raises $1.50 to $2
BypVLsYQt3ePFm2xQL/dOA: calls $1.50
*** FLOP *** [Qc Qd Kd]
46qCyJ6evTkHo9al5sBMNA: bets $1.50
BypVLsYQt3ePFm2xQL/dOA: calls $1.50
*** TURN *** [Qc Qd Kd] [8h]
46qCyJ6evTkHo9al5sBMNA: checks
BypVLsYQt3ePFm2xQL/dOA: checks
*** RIVER *** [Qc Qd Kd 8h] [4c]
46qCyJ6evTkHo9al5sBMNA: checks
BypVLsYQt3ePFm2xQL/dOA: bets $3
46qCyJ6evTkHo9al5sBMNA: calls $3
*** SHOW DOWN ***
BypVLsYQt3ePFm2xQL/dOA: shows [Kc 3d] (two pair, Kings and Queens)
46qCyJ6evTkHo9al5sBMNA: mucks hand
BypVLsYQt3ePFm2xQL/dOA collected $12.50 from pot
*** SUMMARY ***
Total pot $13 | Rake $0.50
Board [Qc Qd Kd 8h 4c]
Seat 1: 46qCyJ6evTkHo9al5sBMNA (big blind) mucked
Seat 2: BypVLsYQt3ePFm2xQL/dOA (button) (small blind) showed [Kc 3d] and won ($12.50) with two pair, Kings and Queens



PokerStars Game #59940511032:  Hold'em No Limit ($0.25/$0.50) - 2009/07/01 1:08:43 ET
Table 'WlCrrUP9MxwySQN5fzLFBQ' 2-max Seat #2 is the button
Seat 1: U7xFsli2XvMiGlVDxk8a/Q ($10.60 in chips)
Seat 2: JTT5TsRNqs6npc7cgI4X/w ($20.25 in chips)
JTT5TsRNqs6npc7cgI4X/w: posts small blind $0.25
U7xFsli2XvMiGlVDxk8a/Q: posts big blind $0.50
*** HOLE CARDS ***
JTT5TsRNqs6npc7cgI4X/w: calls $0.25
U7xFsli2XvMiGlVDxk8a/Q: raises $10.10 to $10.60 and is all-in
JTT5TsRNqs6npc7cgI4X/w: calls $10.10
*** FLOP *** [8h 2c 9s]
*** TURN *** [8h 2c 9s] [Th]
*** RIVER *** [8h 2c 9s Th] [Qd]
*** SHOW DOWN ***
U7xFsli2XvMiGlVDxk8a/Q: shows [Ac 5c] (high card Ace)
JTT5TsRNqs6npc7cgI4X/w: shows [Td Ah] (a pair of Tens)
JTT5TsRNqs6npc7cgI4X/w collected $20.70 from pot
*** SUMMARY ***
Total pot $21.20 | Rake $0.50
Board [8h 2c 9s Th Qd]
Seat 1: U7xFsli2XvMiGlVDxk8a/Q (big blind) showed [Ac 5c] and lost with high card Ace
Seat 2: JTT5TsRNqs6npc7cgI4X/w (button) (small blind) showed [Td Ah] and won ($20.70) with a pair of Tens



PokerStars Game #59940513090:  Hold'em No Limit ($0.25/$0.50) - 2009/07/01 1:08:46 ET
Table '0eJtgVAXVvBgncFdcUpXcQ' 2-max Seat #2 is the button
Seat 1: Ag6DvxX4vbRheqsv2zXKTQ ($48.30 in chips)
Seat 2: KMc4R+K9ao4Ur3rF7NGe6Q ($6.70 in chips)
KMc4R+K9ao4Ur3rF7NGe6Q: posts small blind $0.25
Ag6DvxX4vbRheqsv2zXKTQ: posts big blind $0.50
*** HOLE CARDS ***
KMc4R+K9ao4Ur3rF7NGe6Q: calls $0.25
Ag6DvxX4vbRheqsv2zXKTQ: checks
*** FLOP *** [2h Qh Kh]
Ag6DvxX4vbRheqsv2zXKTQ: checks
KMc4R+K9ao4Ur3rF7NGe6Q: checks
*** TURN *** [2h Qh Kh] [4c]
Ag6DvxX4vbRheqsv2zXKTQ: bets $0.50
KMc4R+K9ao4Ur3rF7NGe6Q: raises $1 to $1.50
Ag6DvxX4vbRheqsv2zXKTQ: folds
KMc4R+K9ao4Ur3rF7NGe6Q collected $1.95 from pot
KMc4R+K9ao4Ur3rF7NGe6Q: shows [Qd Qs] (three of a kind, Queens)
*** SUMMARY ***
Total pot $2 | Rake $0.05
Board [2h Qh Kh 4c]
Seat 1: Ag6DvxX4vbRheqsv2zXKTQ (big blind) folded on the Turn
Seat 2: KMc4R+K9ao4Ur3rF7NGe6Q (button) (small blind) collected ($1.95)



PokerStars Game #59940512964:  Hold'em No Limit ($0.25/$0.50) - 2009/07/01 1:08:46 ET
Table 'ZYI3ZReBjdfKEYItkZHI6A' 9-max Seat #3 is the button
Seat 1: E2518gp4aFz1+kAgmGqeEg ($13.85 in chips)
Seat 2: 8zdVaT8pZ/Wm0uWoeLhtZg ($5.45 in chips)
Seat 3: bkXkL3pmapikPQQRNPZSEA ($19.65 in chips)
Seat 4: e2+sK/yjnj94rXOKoxPP2A ($50 in chips)
Seat 5: ApHP7ouup365XIUFBdEDxg ($47.15 in chips)
Seat 6: Wj7mKnRFR90j40wWUu2+Og ($37.30 in chips)
Seat 7: HWcfp1hY1hqvrddzW3/FQw ($12.50 in chips)
Seat 8: ji04uOybxCdpdefzlUQeKQ ($28 in chips)
e2+sK/yjnj94rXOKoxPP2A: posts small blind $0.25
ApHP7ouup365XIUFBdEDxg: posts big blind $0.50
*** HOLE CARDS ***
Wj7mKnRFR90j40wWUu2+Og: folds
HWcfp1hY1hqvrddzW3/FQw: folds
ji04uOybxCdpdefzlUQeKQ: folds
E2518gp4aFz1+kAgmGqeEg: folds
8zdVaT8pZ/Wm0uWoeLhtZg: folds
bkXkL3pmapikPQQRNPZSEA: folds
e2+sK/yjnj94rXOKoxPP2A: calls $0.25
ApHP7ouup365XIUFBdEDxg: raises $1 to $1.50
e2+sK/yjnj94rXOKoxPP2A: calls $1
*** FLOP *** [Jd Qd 6d]
e2+sK/yjnj94rXOKoxPP2A: checks
ApHP7ouup365XIUFBdEDxg: bets $1.50
e2+sK/yjnj94rXOKoxPP2A: folds
ApHP7ouup365XIUFBdEDxg collected $2.85 from pot
ApHP7ouup365XIUFBdEDxg: doesn't show hand
*** SUMMARY ***
Total pot $3 | Rake $0.15
Board [Jd Qd 6d]
Seat 1: E2518gp4aFz1+kAgmGqeEg folded before Flop (didn't bet)
Seat 2: 8zdVaT8pZ/Wm0uWoeLhtZg folded before Flop (didn't bet)
Seat 3: bkXkL3pmapikPQQRNPZSEA (button) folded before Flop (didn't bet)
Seat 4: e2+sK/yjnj94rXOKoxPP2A (small blind) folded on the Flop
Seat 5: ApHP7ouup365XIUFBdEDxg (big blind) collected ($2.85)
Seat 6: Wj7mKnRFR90j40wWUu2+Og folded before Flop (didn't bet)
Seat 7: HWcfp1hY1hqvrddzW3/FQw folded before Flop (didn't bet)
Seat 8: ji04uOybxCdpdefzlUQeKQ folded before Flop (didn't bet)



PokerStars Game #59940516520:  Hold'em No Limit ($0.25/$0.50) - 2009/07/01 1:08:52 ET
Table '8BQGgNetI1NOvWeu3gtMNw' 2-max Seat #1 is the button
Seat 1: bypIyrYcAAifLfhZpGlKLA ($90.90 in chips)
Seat 2: Z4HwehErEwzsv/noQlfUlg ($107.25 in chips)
bypIyrYcAAifLfhZpGlKLA: posts small blind $0.25
Z4HwehErEwzsv/noQlfUlg: posts big blind $0.50
*** HOLE CARDS ***
bypIyrYcAAifLfhZpGlKLA: raises $1 to $1.50
Z4HwehErEwzsv/noQlfUlg: raises $1.50 to $3
bypIyrYcAAifLfhZpGlKLA: calls $1.50
*** FLOP *** [4c 5d 3h]
Z4HwehErEwzsv/noQlfUlg: bets $4
bypIyrYcAAifLfhZpGlKLA: calls $4
*** TURN *** [4c 5d 3h] [2s]
Z4HwehErEwzsv/noQlfUlg: checks
bypIyrYcAAifLfhZpGlKLA: checks
*** RIVER *** [4c 5d 3h 2s] [7s]
Z4HwehErEwzsv/noQlfUlg: checks
bypIyrYcAAifLfhZpGlKLA: bets $7.50
Z4HwehErEwzsv/noQlfUlg: calls $7.50
*** SHOW DOWN ***
bypIyrYcAAifLfhZpGlKLA: shows [Kd Ad] (a straight, Ace to Five)
Z4HwehErEwzsv/noQlfUlg: shows [Ts Th] (a pair of Tens)
bypIyrYcAAifLfhZpGlKLA collected $28.50 from pot
*** SUMMARY ***
Total pot $29 | Rake $0.50
Board [4c 5d 3h 2s 7s]
Seat 1: bypIyrYcAAifLfhZpGlKLA (button) (small blind) showed [Kd Ad] and won ($28.50) with a straight, Ace to Five
Seat 2: Z4HwehErEwzsv/noQlfUlg (big blind) showed [Ts Th] and lost with a pair of Tens



PokerStars Game #59940518294:  Hold'em No Limit ($0.25/$0.50) - 2009/07/01 1:08:55 ET
Table 'E7bWJ45aoFXRpyRv2gw+Ig' 2-max Seat #2 is the button
Seat 1: FRkiRasEGlHUeLrEl+k/nA ($56.45 in chips)
Seat 2: 3Wro85I7472vJ4Wkpneo9A ($130.40 in chips)
3Wro85I7472vJ4Wkpneo9A: posts small blind $0.25
FRkiRasEGlHUeLrEl+k/nA: posts big blind $0.50
*** HOLE CARDS ***
3Wro85I7472vJ4Wkpneo9A: calls $0.25
FRkiRasEGlHUeLrEl+k/nA: raises $1 to $1.50
3Wro85I7472vJ4Wkpneo9A: calls $1
*** FLOP *** [Jd 5s 8h]
FRkiRasEGlHUeLrEl+k/nA: bets $1
3Wro85I7472vJ4Wkpneo9A: calls $1
*** TURN *** [Jd 5s 8h] [Th]
FRkiRasEGlHUeLrEl+k/nA: bets $3.50
3Wro85I7472vJ4Wkpneo9A: raises $8.50 to $12
FRkiRasEGlHUeLrEl+k/nA: calls $8.50
*** RIVER *** [Jd 5s 8h Th] [Qh]
FRkiRasEGlHUeLrEl+k/nA: checks
3Wro85I7472vJ4Wkpneo9A: checks
*** SHOW DOWN ***
FRkiRasEGlHUeLrEl+k/nA: shows [Ks Js] (a pair of Jacks)
3Wro85I7472vJ4Wkpneo9A: shows [6c 9h] (a straight, Eight to Queen)
3Wro85I7472vJ4Wkpneo9A collected $28.50 from pot
*** SUMMARY ***
Total pot $29 | Rake $0.50
Board [Jd 5s 8h Th Qh]
Seat 1: FRkiRasEGlHUeLrEl+k/nA (big blind) showed [Ks Js] and lost with a pair of Jacks
Seat 2: 3Wro85I7472vJ4Wkpneo9A (button) (small blind) showed [6c 9h] and won ($28.50) with a straight, Eight to Queen



PokerStars Game #59940519338:  Hold'em No Limit ($0.25/$0.50) - 2009/07/01 1:08:56 ET
Table '37qXEp3oe+er5q4CZip9eQ' 6-max Seat #6 is the button
Seat 1: lxIzoHy0RnkfFSODHC2liw ($50 in chips)
Seat 2: LvH4G7n+QSjT6NDaD3cREA ($57.05 in chips)
Seat 3: Rt6KgtZ8YaJoTc3FPim00w ($110.20 in chips)
Seat 4: XsmE8nXMAAMFJbWaJTmHFw ($45.70 in chips)
Seat 5: VOmI0x4dDPnTESZd5B4d1Q ($42.50 in chips)
Seat 6: N50kln4negd8q7Mmoz1j4g ($10.05 in chips)
lxIzoHy0RnkfFSODHC2liw: posts small blind $0.25
LvH4G7n+QSjT6NDaD3cREA: posts big blind $0.50
*** HOLE CARDS ***
Rt6KgtZ8YaJoTc3FPim00w: folds
XsmE8nXMAAMFJbWaJTmHFw: calls $0.50
VOmI0x4dDPnTESZd5B4d1Q: folds
N50kln4negd8q7Mmoz1j4g: folds
lxIzoHy0RnkfFSODHC2liw: folds
LvH4G7n+QSjT6NDaD3cREA: checks
*** FLOP *** [Ah 4c Jc]
LvH4G7n+QSjT6NDaD3cREA: bets $1
XsmE8nXMAAMFJbWaJTmHFw: raises $1 to $2
LvH4G7n+QSjT6NDaD3cREA: calls $1
*** TURN *** [Ah 4c Jc] [6s]
LvH4G7n+QSjT6NDaD3cREA: checks
XsmE8nXMAAMFJbWaJTmHFw: checks
*** RIVER *** [Ah 4c Jc 6s] [2s]
LvH4G7n+QSjT6NDaD3cREA: checks
XsmE8nXMAAMFJbWaJTmHFw: checks
*** SHOW DOWN ***
LvH4G7n+QSjT6NDaD3cREA: shows [9s Jd] (a pair of Jacks)
XsmE8nXMAAMFJbWaJTmHFw: shows [3s As] (a pair of Aces)
XsmE8nXMAAMFJbWaJTmHFw collected $5 from pot
*** SUMMARY ***
Total pot $5.25 | Rake $0.25
Board [Ah 4c Jc 6s 2s]
Seat 1: lxIzoHy0RnkfFSODHC2liw (small blind) folded before Flop
Seat 2: LvH4G7n+QSjT6NDaD3cREA (big blind) showed [9s Jd] and lost with a pair of Jacks
Seat 3: Rt6KgtZ8YaJoTc3FPim00w folded before Flop (didn't bet)
Seat 4: XsmE8nXMAAMFJbWaJTmHFw showed [3s As] and won ($5) with a pair of Aces
Seat 5: VOmI0x4dDPnTESZd5B4d1Q folded before Flop (didn't bet)
Seat 6: N50kln4negd8q7Mmoz1j4g (button) folded before Flop (didn't bet)



PokerStars Game #59940519394:  Hold'em No Limit ($0.25/$0.50) - 2009/07/01 1:08:57 ET
Table '+dXkOAQyS8j9PQZusUTMpg' 2-max Seat #2 is the button
Seat 1: XFa6sBGjP2gxoIvxR3fZIg ($118.80 in chips)
Seat 2: 5IBeOgaApY1Bvzv2P8X4EA ($76.55 in chips)
5IBeOgaApY1Bvzv2P8X4EA: posts small blind $0.25
XFa6sBGjP2gxoIvxR3fZIg: posts big blind $0.50
*** HOLE CARDS ***
5IBeOgaApY1Bvzv2P8X4EA: calls $0.25
XFa6sBGjP2gxoIvxR3fZIg: checks
*** FLOP *** [2d 3s 2c]
XFa6sBGjP2gxoIvxR3fZIg: checks
5IBeOgaApY1Bvzv2P8X4EA: checks
*** TURN *** [2d 3s 2c] [4c]
XFa6sBGjP2gxoIvxR3fZIg: checks
5IBeOgaApY1Bvzv2P8X4EA: checks
*** RIVER *** [2d 3s 2c 4c] [Qh]
XFa6sBGjP2gxoIvxR3fZIg: checks
5IBeOgaApY1Bvzv2P8X4EA: bets $1
XFa6sBGjP2gxoIvxR3fZIg: folds
5IBeOgaApY1Bvzv2P8X4EA collected $0.95 from pot
5IBeOgaApY1Bvzv2P8X4EA: doesn't show hand
*** SUMMARY ***
Total pot $1 | Rake $0.05
Board [2d 3s 2c 4c Qh]
Seat 1: XFa6sBGjP2gxoIvxR3fZIg (big blind) folded on the River
Seat 2: 5IBeOgaApY1Bvzv2P8X4EA (button) (small blind) collected ($0.95)



PokerStars Game #59940519824:  Hold'em No Limit ($0.25/$0.50) - 2009/07/01 1:08:57 ET
Table 'BCN5su+SsXiy1zRMJi0SJw' 6-max Seat #4 is the button
Seat 1: GxXV09ciXaOxyY2H5aMIIw ($40.05 in chips)
Seat 2: oU2kDCkT/gilYbHWrg7D8w ($42.45 in chips)
Seat 3: kwgv5lNhiFrfONXCshzxlA ($30 in chips)
Seat 4: 4QfsCWthT/vSLirorNXqtg ($50.70 in chips)
Seat 6: b2symlOdL7+0c9Pj4N/KlA ($59.60 in chips)
WUgnrlL2IrGbGEyDnzOJzQ will be allowed to play after the button
b2symlOdL7+0c9Pj4N/KlA: posts small blind $0.25
GxXV09ciXaOxyY2H5aMIIw: posts big blind $0.50
kwgv5lNhiFrfONXCshzxlA: posts big blind $0.50
*** HOLE CARDS ***
oU2kDCkT/gilYbHWrg7D8w: folds
kwgv5lNhiFrfONXCshzxlA: checks
4QfsCWthT/vSLirorNXqtg: raises $2 to $2.50
b2symlOdL7+0c9Pj4N/KlA: folds
GxXV09ciXaOxyY2H5aMIIw: raises $4.50 to $7
kwgv5lNhiFrfONXCshzxlA: folds
4QfsCWthT/vSLirorNXqtg: folds
GxXV09ciXaOxyY2H5aMIIw collected $5.75 from pot
*** SUMMARY ***
Total pot $5.75 | Rake $0
Seat 1: GxXV09ciXaOxyY2H5aMIIw (big blind) collected ($5.75)
Seat 2: oU2kDCkT/gilYbHWrg7D8w folded before Flop (didn't bet)
Seat 3: kwgv5lNhiFrfONXCshzxlA folded before Flop
Seat 4: 4QfsCWthT/vSLirorNXqtg (button) folded before Flop
Seat 6: b2symlOdL7+0c9Pj4N/KlA (small blind) folded before Flop



PokerStars Game #59940521034:  Hold'em No Limit ($0.25/$0.50) - 2009/07/01 1:08:59 ET
Table '0eJtgVAXVvBgncFdcUpXcQ' 2-max Seat #1 is the button
Seat 1: Ag6DvxX4vbRheqsv2zXKTQ ($47.30 in chips)
Seat 2: KMc4R+K9ao4Ur3rF7NGe6Q ($7.65 in chips)
Ag6DvxX4vbRheqsv2zXKTQ: posts small blind $0.25
KMc4R+K9ao4Ur3rF7NGe6Q: posts big blind $0.50
*** HOLE CARDS ***
Ag6DvxX4vbRheqsv2zXKTQ: calls $0.25
KMc4R+K9ao4Ur3rF7NGe6Q: raises $1 to $1.50
Ag6DvxX4vbRheqsv2zXKTQ said, "sick"
Ag6DvxX4vbRheqsv2zXKTQ: calls $1
*** FLOP *** [Th Kd Tc]
KMc4R+K9ao4Ur3rF7NGe6Q said, "yeh"
KMc4R+K9ao4Ur3rF7NGe6Q said, "its heads up"
KMc4R+K9ao4Ur3rF7NGe6Q: checks
Ag6DvxX4vbRheqsv2zXKTQ: checks
*** TURN *** [Th Kd Tc] [2d]
KMc4R+K9ao4Ur3rF7NGe6Q: checks
Ag6DvxX4vbRheqsv2zXKTQ: bets $1.50
KMc4R+K9ao4Ur3rF7NGe6Q: calls $1.50
*** RIVER *** [Th Kd Tc 2d] [Ks]
KMc4R+K9ao4Ur3rF7NGe6Q: bets $0.50
Ag6DvxX4vbRheqsv2zXKTQ: folds
KMc4R+K9ao4Ur3rF7NGe6Q collected $5.75 from pot
KMc4R+K9ao4Ur3rF7NGe6Q: doesn't show hand
*** SUMMARY ***
Total pot $6 | Rake $0.25
Board [Th Kd Tc 2d Ks]
Seat 1: Ag6DvxX4vbRheqsv2zXKTQ (button) (small blind) folded on the River
Seat 2: KMc4R+K9ao4Ur3rF7NGe6Q (big blind) collected ($5.75)



PokerStars Game #59940522116:  Hold'em No Limit ($0.25/$0.50) - 2009/07/01 1:09:01 ET
Table 'Nz0Vr7WMHL2g5Uk7dDZjpw' 9-max Seat #3 is the button
Seat 1: tLkxo7JgV+WWI0UBw44K5A ($107.10 in chips)
Seat 2: gsyXT42WLEcOS4DdEk2wlw ($30.60 in chips)
Seat 3: hoglu9inkgs6zN573/bJag ($7.50 in chips)
Seat 4: E2518gp4aFz1+kAgmGqeEg ($12.80 in chips)
Seat 5: WGW0DgjBUXs1ylURHG8vnQ ($22.80 in chips)
Seat 6: 997ViqAtWn1FPjJqcffwcA ($59.80 in chips)
Seat 7: KPLH0gELgFe2OuAnhJFI5w ($23.45 in chips)
Seat 8: aoL+R/61Kxmw69ypuPrWAQ ($23.95 in chips)
Seat 9: mSD1pginDsyHG5PDfqzphw ($10.75 in chips)
E2518gp4aFz1+kAgmGqeEg: posts small blind $0.25
WGW0DgjBUXs1ylURHG8vnQ: posts big blind $0.50
aoL+R/61Kxmw69ypuPrWAQ: posts big blind $0.50
*** HOLE CARDS ***
997ViqAtWn1FPjJqcffwcA: folds
KPLH0gELgFe2OuAnhJFI5w: folds
aoL+R/61Kxmw69ypuPrWAQ: raises $1 to $1.50
mSD1pginDsyHG5PDfqzphw: folds
tLkxo7JgV+WWI0UBw44K5A: folds
gsyXT42WLEcOS4DdEk2wlw: folds
hoglu9inkgs6zN573/bJag: folds
E2518gp4aFz1+kAgmGqeEg: folds
WGW0DgjBUXs1ylURHG8vnQ: folds
aoL+R/61Kxmw69ypuPrWAQ collected $1.25 from pot
*** SUMMARY ***
Total pot $1.25 | Rake $0
Seat 1: tLkxo7JgV+WWI0UBw44K5A folded before Flop (didn't bet)
Seat 2: gsyXT42WLEcOS4DdEk2wlw folded before Flop (didn't bet)
Seat 3: hoglu9inkgs6zN573/bJag (button) folded before Flop (didn't bet)
Seat 4: E2518gp4aFz1+kAgmGqeEg (small blind) folded before Flop
Seat 5: WGW0DgjBUXs1ylURHG8vnQ (big blind) folded before Flop
Seat 6: 997ViqAtWn1FPjJqcffwcA folded before Flop (didn't bet)
Seat 7: KPLH0gELgFe2OuAnhJFI5w folded before Flop (didn't bet)
Seat 8: aoL+R/61Kxmw69ypuPrWAQ collected ($1.25)
Seat 9: mSD1pginDsyHG5PDfqzphw folded before Flop (didn't bet)



PokerStars Game #59940521768:  Hold'em No Limit ($0.25/$0.50) - 2009/07/01 1:09:01 ET
Table '/cQuAT3ef4t+PGrXiNhGaQ' 9-max Seat #5 is the button
Seat 1: HZkVla4kK2SI42CVrPZ/ig ($14.25 in chips)
Seat 2: jXGruyaMqirTaTXNOvBdew ($68.20 in chips)
Seat 3: g4k0NXISyLCqaSWZDBjfEg ($53.50 in chips)
Seat 4: OWP/DOu+PlPK6ZZ3zYa0HA ($27.60 in chips)
Seat 5: 5SgaHdWixdClWvaEG+KUjQ ($42.60 in chips)
Seat 6: APYIOyK/4AGb+kIwlOUNBQ ($37.60 in chips)
Seat 7: J0W5D97jl5VLky+IoPvDeA ($168.50 in chips)
Seat 8: eBrej2jnlUCs/JgxFCRn2g ($39.10 in chips)
Seat 9: AjV5McH1KMMclY26QdLM5w ($26.95 in chips)
APYIOyK/4AGb+kIwlOUNBQ: posts small blind $0.25
J0W5D97jl5VLky+IoPvDeA: posts big blind $0.50
*** HOLE CARDS ***
eBrej2jnlUCs/JgxFCRn2g: folds
AjV5McH1KMMclY26QdLM5w: folds
HZkVla4kK2SI42CVrPZ/ig: folds
jXGruyaMqirTaTXNOvBdew: folds
g4k0NXISyLCqaSWZDBjfEg: raises $1 to $1.50
OWP/DOu+PlPK6ZZ3zYa0HA: folds
5SgaHdWixdClWvaEG+KUjQ: folds
APYIOyK/4AGb+kIwlOUNBQ: calls $1.25
J0W5D97jl5VLky+IoPvDeA: folds
*** FLOP *** [Qh Ac Kc]
APYIOyK/4AGb+kIwlOUNBQ: checks
g4k0NXISyLCqaSWZDBjfEg: checks
*** TURN *** [Qh Ac Kc] [7s]
APYIOyK/4AGb+kIwlOUNBQ: checks
g4k0NXISyLCqaSWZDBjfEg: bets $2
APYIOyK/4AGb+kIwlOUNBQ: folds
g4k0NXISyLCqaSWZDBjfEg collected $3.35 from pot
*** SUMMARY ***
Total pot $3.50 | Rake $0.15
Board [Qh Ac Kc 7s]
Seat 1: HZkVla4kK2SI42CVrPZ/ig folded before Flop (didn't bet)
Seat 2: jXGruyaMqirTaTXNOvBdew folded before Flop (didn't bet)
Seat 3: g4k0NXISyLCqaSWZDBjfEg collected ($3.35)
Seat 4: OWP/DOu+PlPK6ZZ3zYa0HA folded before Flop (didn't bet)
Seat 5: 5SgaHdWixdClWvaEG+KUjQ (button) folded before Flop (didn't bet)
Seat 6: APYIOyK/4AGb+kIwlOUNBQ (small blind) folded on the Turn
Seat 7: J0W5D97jl5VLky+IoPvDeA (big blind) folded before Flop
Seat 8: eBrej2jnlUCs/JgxFCRn2g folded before Flop (didn't bet)
Seat 9: AjV5McH1KMMclY26QdLM5w folded before Flop (didn't bet)



PokerStars Game #59940524240:  Hold'em No Limit ($0.25/$0.50) - 2009/07/01 1:09:04 ET
Table 'X6IRCRTh+20gjz8aubWnwA' 9-max Seat #4 is the button
Seat 1: DSM67hHHq1XFoEOi9p8Alw ($52.05 in chips)
Seat 2: HZkVla4kK2SI42CVrPZ/ig ($6.80 in chips)
Seat 3: SWv01peOe69QQRvhQTqjQw ($8 in chips)
Seat 4: M3JFBNQ8Bbw3FBZ/18MuXw ($25 in chips)
Seat 5: NnQCepdIR/AOUQn1yhYx6Q ($9.50 in chips)
Seat 6: 75K2MXwN65Sjfp1yHd50Hg ($10 in chips)
Seat 7: cFHQjKQOOKTUzoilhrXHLg ($15.90 in chips)
Seat 8: HxeBVq06/3Bh/H986sgdbw ($51.50 in chips)
Seat 9: M+7+BTmX5vZatHVuoRB1nA ($43.75 in chips)
NnQCepdIR/AOUQn1yhYx6Q: posts small blind $0.25
75K2MXwN65Sjfp1yHd50Hg: posts big blind $0.50
*** HOLE CARDS ***
cFHQjKQOOKTUzoilhrXHLg: calls $0.50
HxeBVq06/3Bh/H986sgdbw: folds
M+7+BTmX5vZatHVuoRB1nA: folds
DSM67hHHq1XFoEOi9p8Alw: folds
HZkVla4kK2SI42CVrPZ/ig: folds
SWv01peOe69QQRvhQTqjQw: folds
M3JFBNQ8Bbw3FBZ/18MuXw: folds
NnQCepdIR/AOUQn1yhYx6Q: folds
75K2MXwN65Sjfp1yHd50Hg: checks
*** FLOP *** [Ad 2h 7d]
75K2MXwN65Sjfp1yHd50Hg: checks
cFHQjKQOOKTUzoilhrXHLg: checks
*** TURN *** [Ad 2h 7d] [Ac]
75K2MXwN65Sjfp1yHd50Hg: bets $1
cFHQjKQOOKTUzoilhrXHLg: folds
75K2MXwN65Sjfp1yHd50Hg collected $1.20 from pot
75K2MXwN65Sjfp1yHd50Hg: doesn't show hand
*** SUMMARY ***
Total pot $1.25 | Rake $0.05
Board [Ad 2h 7d Ac]
Seat 1: DSM67hHHq1XFoEOi9p8Alw folded before Flop (didn't bet)
Seat 2: HZkVla4kK2SI42CVrPZ/ig folded before Flop (didn't bet)
Seat 3: SWv01peOe69QQRvhQTqjQw folded before Flop (didn't bet)
Seat 4: M3JFBNQ8Bbw3FBZ/18MuXw (button) folded before Flop (didn't bet)
Seat 5: NnQCepdIR/AOUQn1yhYx6Q (small blind) folded before Flop
Seat 6: 75K2MXwN65Sjfp1yHd50Hg (big blind) collected ($1.20)
Seat 7: cFHQjKQOOKTUzoilhrXHLg folded on the Turn
Seat 8: HxeBVq06/3Bh/H986sgdbw folded before Flop (didn't bet)
Seat 9: M+7+BTmX5vZatHVuoRB1nA folded before Flop (didn't bet)



PokerStars Game #59940524224:  Hold'em No Limit ($0.25/$0.50) - 2009/07/01 1:09:04 ET
Table 'tYh970kmVfYS0gXPT/XtoQ' 2-max Seat #1 is the button
Seat 1: CLj3pYZDnglQbP8AEHiYIw ($58 in chips)
Seat 2: fxN9bTdAgPNvNkHgbVXKGw ($1.50 in chips)
CLj3pYZDnglQbP8AEHiYIw: posts small blind $0.25
fxN9bTdAgPNvNkHgbVXKGw: posts big blind $0.50
*** HOLE CARDS ***
CLj3pYZDnglQbP8AEHiYIw: raises $2 to $2.50
fxN9bTdAgPNvNkHgbVXKGw: calls $1 and is all-in
*** FLOP *** [5d Ah 8s]
*** TURN *** [5d Ah 8s] [4c]
*** RIVER *** [5d Ah 8s 4c] [4h]
*** SHOW DOWN ***
fxN9bTdAgPNvNkHgbVXKGw: shows [2d Jh] (a pair of Fours)
CLj3pYZDnglQbP8AEHiYIw: shows [2s 3d] (a straight, Ace to Five)
CLj3pYZDnglQbP8AEHiYIw collected $2.85 from pot
*** SUMMARY ***
Total pot $3 | Rake $0.15
Board [5d Ah 8s 4c 4h]
Seat 1: CLj3pYZDnglQbP8AEHiYIw (button) (small blind) showed [2s 3d] and won ($2.85) with a straight, Ace to Five
Seat 2: fxN9bTdAgPNvNkHgbVXKGw (big blind) showed [2d Jh] and lost with a pair of Fours



PokerStars Game #59940526168:  Hold'em No Limit ($0.25/$0.50) - 2009/07/01 1:09:07 ET
Table 'QOgaEqMcJ73pcUMMxoisUg' 6-max Seat #1 is the button
Seat 1: lxIzoHy0RnkfFSODHC2liw ($50 in chips)
Seat 2: oqOqoO2AyCZenUghCxMDxw ($65.25 in chips)
Seat 3: Rt6KgtZ8YaJoTc3FPim00w ($53.75 in chips)
Seat 4: zAcsDhG/T128Vn7XGVSgKg ($50 in chips)
Seat 5: 6vNxrjjCl6FwfaaymM9jjg ($20.75 in chips)
Seat 6: AdS8BJMOheS01zjCDfPMFg ($49.25 in chips)
oqOqoO2AyCZenUghCxMDxw: posts small blind $0.25
Rt6KgtZ8YaJoTc3FPim00w: posts big blind $0.50
*** HOLE CARDS ***
zAcsDhG/T128Vn7XGVSgKg: raises $1 to $1.50
6vNxrjjCl6FwfaaymM9jjg: folds
AdS8BJMOheS01zjCDfPMFg: raises $3 to $4.50
lxIzoHy0RnkfFSODHC2liw: folds
oqOqoO2AyCZenUghCxMDxw: folds
Rt6KgtZ8YaJoTc3FPim00w: folds
zAcsDhG/T128Vn7XGVSgKg: calls $3
*** FLOP *** [4c Qc Td]
zAcsDhG/T128Vn7XGVSgKg: checks
AdS8BJMOheS01zjCDfPMFg: bets $6.50
zAcsDhG/T128Vn7XGVSgKg: raises $14 to $20.50
AdS8BJMOheS01zjCDfPMFg: folds
zAcsDhG/T128Vn7XGVSgKg collected $21.65 from pot
*** SUMMARY ***
Total pot $22.75 | Rake $1.10
Board [4c Qc Td]
Seat 1: lxIzoHy0RnkfFSODHC2liw (button) folded before Flop (didn't bet)
Seat 2: oqOqoO2AyCZenUghCxMDxw (small blind) folded before Flop
Seat 3: Rt6KgtZ8YaJoTc3FPim00w (big blind) folded before Flop
Seat 4: zAcsDhG/T128Vn7XGVSgKg collected ($21.65)
Seat 5: 6vNxrjjCl6FwfaaymM9jjg folded before Flop (didn't bet)
Seat 6: AdS8BJMOheS01zjCDfPMFg folded on the Flop



PokerStars Game #59940525894:  Hold'em No Limit ($0.25/$0.50) - 2009/07/01 1:09:07 ET
Table 'lSisgp6H7Fg1hH5VfjEjYQ' 9-max Seat #5 is the button
Seat 1: 5k9fvXD9suIgCxU4HLQjTw ($50.35 in chips)
Seat 2: UrcnkQOiLVk8BlKDPJSy7Q ($76.55 in chips)
Seat 3: aTkyjTh3w5YLWiIERupZOA ($51.40 in chips)
Seat 4: bwv/rbH/hHhPhY6u9mu04w ($34.60 in chips)
Seat 5: mSD1pginDsyHG5PDfqzphw ($10 in chips)
Seat 6: +k7T5ocke8UwavtgUHm+Cg ($65.80 in chips)
Seat 7: IDtNLR9uFCDdjNsJWMHA5Q ($20.55 in chips)
Seat 8: a4JDWmpFQkL10XfAyuF51A ($27 in chips)
Seat 9: YzeKFbJVLmJGTgNH3ySQlw ($9.45 in chips)
+k7T5ocke8UwavtgUHm+Cg: posts small blind $0.25
IDtNLR9uFCDdjNsJWMHA5Q: posts big blind $0.50
*** HOLE CARDS ***
a4JDWmpFQkL10XfAyuF51A: folds
YzeKFbJVLmJGTgNH3ySQlw: calls $0.50
5k9fvXD9suIgCxU4HLQjTw: folds
UrcnkQOiLVk8BlKDPJSy7Q: folds
aTkyjTh3w5YLWiIERupZOA: folds
bwv/rbH/hHhPhY6u9mu04w: folds
mSD1pginDsyHG5PDfqzphw: folds
+k7T5ocke8UwavtgUHm+Cg: calls $0.25
IDtNLR9uFCDdjNsJWMHA5Q: checks
*** FLOP *** [3h Qh 2s]
+k7T5ocke8UwavtgUHm+Cg: checks
IDtNLR9uFCDdjNsJWMHA5Q: bets $1
YzeKFbJVLmJGTgNH3ySQlw: calls $1
+k7T5ocke8UwavtgUHm+Cg: folds
*** TURN *** [3h Qh 2s] [6d]
IDtNLR9uFCDdjNsJWMHA5Q: checks
YzeKFbJVLmJGTgNH3ySQlw: bets $1
IDtNLR9uFCDdjNsJWMHA5Q: folds
YzeKFbJVLmJGTgNH3ySQlw collected $3.35 from pot
*** SUMMARY ***
Total pot $3.50 | Rake $0.15
Board [3h Qh 2s 6d]
Seat 1: 5k9fvXD9suIgCxU4HLQjTw folded before Flop (didn't bet)
Seat 2: UrcnkQOiLVk8BlKDPJSy7Q folded before Flop (didn't bet)
Seat 3: aTkyjTh3w5YLWiIERupZOA folded before Flop (didn't bet)
Seat 4: bwv/rbH/hHhPhY6u9mu04w folded before Flop (didn't bet)
Seat 5: mSD1pginDsyHG5PDfqzphw (button) folded before Flop (didn't bet)
Seat 6: +k7T5ocke8UwavtgUHm+Cg (small blind) folded on the Flop
Seat 7: IDtNLR9uFCDdjNsJWMHA5Q (big blind) folded on the Turn
Seat 8: a4JDWmpFQkL10XfAyuF51A folded before Flop (didn't bet)
Seat 9: YzeKFbJVLmJGTgNH3ySQlw collected ($3.35)



PokerStars Game #59940526090:  Hold'em No Limit ($0.25/$0.50) - 2009/07/01 1:09:07 ET
Table 'ibNfFy0bCzuBaUORla0aGw' 9-max Seat #4 is the button
Seat 1: xZCXQSXlrZkp3pZizzVXCw ($50.55 in chips)
Seat 2: 90Wb75h3W1BRpbqVnuk8gw ($53.50 in chips)
Seat 3: AjV5McH1KMMclY26QdLM5w ($25 in chips)
Seat 4: YBN054X4blmis+B2bBlC0g ($22.65 in chips)
Seat 5: GIJAc9kPrLZHLSX8Q6i99w ($21.95 in chips)
Seat 6: H8cPaCtX7d6meGUVSM5sxw ($50 in chips)
Seat 7: HZkVla4kK2SI42CVrPZ/ig ($14.50 in chips)
Seat 8: 2CfOMUqXsQk69Igusq28Pg ($11.20 in chips)
Seat 9: pFtzb1sR4b0d1aw6aIRgDg ($50.05 in chips)
GIJAc9kPrLZHLSX8Q6i99w: posts small blind $0.25
H8cPaCtX7d6meGUVSM5sxw: posts big blind $0.50
*** HOLE CARDS ***
HZkVla4kK2SI42CVrPZ/ig: folds
2CfOMUqXsQk69Igusq28Pg: raises $0.50 to $1
pFtzb1sR4b0d1aw6aIRgDg: folds
xZCXQSXlrZkp3pZizzVXCw: folds
90Wb75h3W1BRpbqVnuk8gw: folds
AjV5McH1KMMclY26QdLM5w: folds
YBN054X4blmis+B2bBlC0g: folds
GIJAc9kPrLZHLSX8Q6i99w: folds
H8cPaCtX7d6meGUVSM5sxw: calls $0.50
*** FLOP *** [9d Kd 3d]
H8cPaCtX7d6meGUVSM5sxw: checks
2CfOMUqXsQk69Igusq28Pg: checks
*** TURN *** [9d Kd 3d] [4d]
H8cPaCtX7d6meGUVSM5sxw: checks
2CfOMUqXsQk69Igusq28Pg: checks
*** RIVER *** [9d Kd 3d 4d] [Qs]
H8cPaCtX7d6meGUVSM5sxw: checks
2CfOMUqXsQk69Igusq28Pg: checks
*** SHOW DOWN ***
H8cPaCtX7d6meGUVSM5sxw: shows [4c 5d] (a flush, King high)
2CfOMUqXsQk69Igusq28Pg: shows [7d 8d] (a flush, King high - Eight higher)
2CfOMUqXsQk69Igusq28Pg collected $2.15 from pot
*** SUMMARY ***
Total pot $2.25 | Rake $0.10
Board [9d Kd 3d 4d Qs]
Seat 1: xZCXQSXlrZkp3pZizzVXCw folded before Flop (didn't bet)
Seat 2: 90Wb75h3W1BRpbqVnuk8gw folded before Flop (didn't bet)
Seat 3: AjV5McH1KMMclY26QdLM5w folded before Flop (didn't bet)
Seat 4: YBN054X4blmis+B2bBlC0g (button) folded before Flop (didn't bet)
Seat 5: GIJAc9kPrLZHLSX8Q6i99w (small blind) folded before Flop
Seat 6: H8cPaCtX7d6meGUVSM5sxw (big blind) showed [4c 5d] and lost with a flush, King high
Seat 7: HZkVla4kK2SI42CVrPZ/ig folded before Flop (didn't bet)
Seat 8: 2CfOMUqXsQk69Igusq28Pg showed [7d 8d] and won ($2.15) with a flush, King high
Seat 9: pFtzb1sR4b0d1aw6aIRgDg folded before Flop (didn't bet)



PokerStars Game #59940526204:  Hold'em No Limit ($0.25/$0.50) - 2009/07/01 1:09:07 ET
Table 'GfL/No5u5PoEnU39lP5pQg' 6-max Seat #1 is the button
Seat 1: 1WUCqNG+p+vfWRTXNu4ljw ($64.50 in chips)
Seat 2: uVwggSetzp7d+eVgowO3vg ($55.50 in chips)
Seat 4: r6u7MWSXF30/khcTYkrG9Q ($35.15 in chips)
Seat 5: M1KyQQvVPVuxqTAB8sR/zQ ($51.60 in chips)
Seat 6: kxPhs4ePFqMy52CInAJ2aw ($50.85 in chips)
uVwggSetzp7d+eVgowO3vg: posts small blind $0.25
r6u7MWSXF30/khcTYkrG9Q: posts big blind $0.50
*** HOLE CARDS ***
M1KyQQvVPVuxqTAB8sR/zQ: folds
kxPhs4ePFqMy52CInAJ2aw: folds
1WUCqNG+p+vfWRTXNu4ljw: folds
uVwggSetzp7d+eVgowO3vg: calls $0.25
r6u7MWSXF30/khcTYkrG9Q: checks
*** FLOP *** [6h 9d Qc]
uVwggSetzp7d+eVgowO3vg: checks
r6u7MWSXF30/khcTYkrG9Q: bets $1
uVwggSetzp7d+eVgowO3vg: folds
r6u7MWSXF30/khcTYkrG9Q collected $0.95 from pot
*** SUMMARY ***
Total pot $1 | Rake $0.05
Board [6h 9d Qc]
Seat 1: 1WUCqNG+p+vfWRTXNu4ljw (button) folded before Flop (didn't bet)
Seat 2: uVwggSetzp7d+eVgowO3vg (small blind) folded on the Flop
Seat 4: r6u7MWSXF30/khcTYkrG9Q (big blind) collected ($0.95)
Seat 5: M1KyQQvVPVuxqTAB8sR/zQ folded before Flop (didn't bet)
Seat 6: kxPhs4ePFqMy52CInAJ2aw folded before Flop (didn't bet)



PokerStars Game #59940526844:  Hold'em No Limit ($0.25/$0.50) - 2009/07/01 1:09:09 ET
Table 'EiNh8p/wGJ1FP575iMFnqg' 9-max Seat #2 is the button
Seat 1: r3ZqM1Mi0W3y4hOdssE+Sg ($50 in chips)
Seat 2: 8ehL7qlZzjgUh2H35iiWLw ($53.40 in chips)
Seat 3: ymLPoEIl7UL3TvZYmnadxQ ($59.15 in chips)
Seat 4: cMzaiXAM/ZAdNaEUu+LqhA ($54.95 in chips)
Seat 5: M+7+BTmX5vZatHVuoRB1nA ($80.45 in chips)
Seat 6: 3UmXLy3GfjC3EkOebduerQ ($61.60 in chips)
Seat 7: 997ViqAtWn1FPjJqcffwcA ($50 in chips)
Seat 8: mSD1pginDsyHG5PDfqzphw ($10 in chips)
Seat 9: NnQCepdIR/AOUQn1yhYx6Q ($21.50 in chips)
ymLPoEIl7UL3TvZYmnadxQ: posts small blind $0.25
cMzaiXAM/ZAdNaEUu+LqhA: posts big blind $0.50
*** HOLE CARDS ***
M+7+BTmX5vZatHVuoRB1nA: folds
3UmXLy3GfjC3EkOebduerQ: folds
997ViqAtWn1FPjJqcffwcA: folds
mSD1pginDsyHG5PDfqzphw: folds
NnQCepdIR/AOUQn1yhYx6Q: folds
NnQCepdIR/AOUQn1yhYx6Q leaves the table
r3ZqM1Mi0W3y4hOdssE+Sg: raises $1.50 to $2
8ehL7qlZzjgUh2H35iiWLw: folds
ymLPoEIl7UL3TvZYmnadxQ: folds
cMzaiXAM/ZAdNaEUu+LqhA: folds
r3ZqM1Mi0W3y4hOdssE+Sg collected $1.25 from pot
r3ZqM1Mi0W3y4hOdssE+Sg: doesn't show hand
*** SUMMARY ***
Total pot $1.25 | Rake $0
Seat 1: r3ZqM1Mi0W3y4hOdssE+Sg collected ($1.25)
Seat 2: 8ehL7qlZzjgUh2H35iiWLw (button) folded before Flop (didn't bet)
Seat 3: ymLPoEIl7UL3TvZYmnadxQ (small blind) folded before Flop
Seat 4: cMzaiXAM/ZAdNaEUu+LqhA (big blind) folded before Flop
Seat 5: M+7+BTmX5vZatHVuoRB1nA folded before Flop (didn't bet)
Seat 6: 3UmXLy3GfjC3EkOebduerQ folded before Flop (didn't bet)
Seat 7: 997ViqAtWn1FPjJqcffwcA folded before Flop (didn't bet)
Seat 8: mSD1pginDsyHG5PDfqzphw folded before Flop (didn't bet)
Seat 9: NnQCepdIR/AOUQn1yhYx6Q folded before Flop (didn't bet)



PokerStars Game #59940526848:  Hold'em No Limit ($0.25/$0.50) - 2009/07/01 1:09:09 ET
Table 'hSTs/dUsYLgJQuF2Onp0MQ' 6-max Seat #5 is the button
Seat 1: 1WUCqNG+p+vfWRTXNu4ljw ($50.75 in chips)
Seat 2: 6vNxrjjCl6FwfaaymM9jjg ($35.05 in chips)
Seat 3: C3qJBo7uxfFVDluE1lmK2w ($52.60 in chips)
Seat 4: L0aIPg7qefDQjdJo3HCVEA ($10.05 in chips)
Seat 5: 686aeHikcJlgKkSuIFdcXQ ($57.15 in chips)
Seat 6: M1KyQQvVPVuxqTAB8sR/zQ ($79.90 in chips)
M1KyQQvVPVuxqTAB8sR/zQ: posts small blind $0.25
1WUCqNG+p+vfWRTXNu4ljw: posts big blind $0.50
*** HOLE CARDS ***
6vNxrjjCl6FwfaaymM9jjg: calls $0.50
C3qJBo7uxfFVDluE1lmK2w: folds
L0aIPg7qefDQjdJo3HCVEA: folds
686aeHikcJlgKkSuIFdcXQ: folds
M1KyQQvVPVuxqTAB8sR/zQ: folds
1WUCqNG+p+vfWRTXNu4ljw: checks
*** FLOP *** [Qh 6h Qc]
1WUCqNG+p+vfWRTXNu4ljw: checks
6vNxrjjCl6FwfaaymM9jjg: checks
*** TURN *** [Qh 6h Qc] [Jc]
1WUCqNG+p+vfWRTXNu4ljw: checks
6vNxrjjCl6FwfaaymM9jjg: checks
*** RIVER *** [Qh 6h Qc Jc] [Qs]
1WUCqNG+p+vfWRTXNu4ljw: checks
6vNxrjjCl6FwfaaymM9jjg: checks
*** SHOW DOWN ***
1WUCqNG+p+vfWRTXNu4ljw: shows [Tc 4c] (three of a kind, Queens)
6vNxrjjCl6FwfaaymM9jjg: shows [3s 3d] (a full house, Queens full of Threes)
6vNxrjjCl6FwfaaymM9jjg collected $1.20 from pot
*** SUMMARY ***
Total pot $1.25 | Rake $0.05
Board [Qh 6h Qc Jc Qs]
Seat 1: 1WUCqNG+p+vfWRTXNu4ljw (big blind) showed [Tc 4c] and lost with three of a kind, Queens
Seat 2: 6vNxrjjCl6FwfaaymM9jjg showed [3s 3d] and won ($1.20) with a full house, Queens full of Threes
Seat 3: C3qJBo7uxfFVDluE1lmK2w folded before Flop (didn't bet)
Seat 4: L0aIPg7qefDQjdJo3HCVEA folded before Flop (didn't bet)
Seat 5: 686aeHikcJlgKkSuIFdcXQ (button) folded before Flop (didn't bet)
Seat 6: M1KyQQvVPVuxqTAB8sR/zQ (small blind) folded before Flop



PokerStars Game #59940527746:  Hold'em No Limit ($0.25/$0.50) - 2009/07/01 1:09:10 ET
Table 'kgbJRsxfv64KrErDRBAkcw' 6-max Seat #2 is the button
Seat 1: VamsyhlFzXGF6/ydo0BHeA ($43.40 in chips)
Seat 2: AdS8BJMOheS01zjCDfPMFg ($49 in chips)
Seat 5: eUBBn2R56C1IQ6Cs/vitwg ($60.70 in chips)
Seat 6: 1b+2BbjMN8qhR1WPqdE9VQ ($57.60 in chips)
eUBBn2R56C1IQ6Cs/vitwg: posts small blind $0.25
1b+2BbjMN8qhR1WPqdE9VQ: posts big blind $0.50
*** HOLE CARDS ***
VamsyhlFzXGF6/ydo0BHeA: folds
AdS8BJMOheS01zjCDfPMFg: folds
eUBBn2R56C1IQ6Cs/vitwg: folds
1b+2BbjMN8qhR1WPqdE9VQ collected $0.50 from pot
1b+2BbjMN8qhR1WPqdE9VQ: doesn't show hand
*** SUMMARY ***
Total pot $0.50 | Rake $0
Seat 1: VamsyhlFzXGF6/ydo0BHeA folded before Flop (didn't bet)
Seat 2: AdS8BJMOheS01zjCDfPMFg (button) folded before Flop (didn't bet)
Seat 5: eUBBn2R56C1IQ6Cs/vitwg (small blind) folded before Flop
Seat 6: 1b+2BbjMN8qhR1WPqdE9VQ (big blind) collected ($0.50)



PokerStars Game #59940528358:  Hold'em No Limit ($0.25/$0.50) - 2009/07/01 1:09:11 ET
Table 'ZYI3ZReBjdfKEYItkZHI6A' 9-max Seat #4 is the button
Seat 1: E2518gp4aFz1+kAgmGqeEg ($13.85 in chips)
Seat 2: 8zdVaT8pZ/Wm0uWoeLhtZg ($5.45 in chips)
Seat 3: bkXkL3pmapikPQQRNPZSEA ($19.65 in chips)
Seat 4: e2+sK/yjnj94rXOKoxPP2A ($50 in chips)
Seat 5: ApHP7ouup365XIUFBdEDxg ($48.50 in chips)
Seat 6: Wj7mKnRFR90j40wWUu2+Og ($37.30 in chips)
Seat 7: HWcfp1hY1hqvrddzW3/FQw ($12.50 in chips)
Seat 8: ji04uOybxCdpdefzlUQeKQ ($28 in chips)
ApHP7ouup365XIUFBdEDxg: posts small blind $0.25
Wj7mKnRFR90j40wWUu2+Og: posts big blind $0.50
*** HOLE CARDS ***
HWcfp1hY1hqvrddzW3/FQw: folds
ji04uOybxCdpdefzlUQeKQ: folds
E2518gp4aFz1+kAgmGqeEg: raises $1 to $1.50
8zdVaT8pZ/Wm0uWoeLhtZg: folds
bkXkL3pmapikPQQRNPZSEA: folds
e2+sK/yjnj94rXOKoxPP2A: folds
ApHP7ouup365XIUFBdEDxg: calls $1.25
Wj7mKnRFR90j40wWUu2+Og: folds
*** FLOP *** [Ts 8d 7s]
ApHP7ouup365XIUFBdEDxg: checks
E2518gp4aFz1+kAgmGqeEg: bets $2
ApHP7ouup365XIUFBdEDxg: calls $2
*** TURN *** [Ts 8d 7s] [2d]
ApHP7ouup365XIUFBdEDxg: checks
E2518gp4aFz1+kAgmGqeEg: checks
*** RIVER *** [Ts 8d 7s 2d] [Td]
ApHP7ouup365XIUFBdEDxg: checks
E2518gp4aFz1+kAgmGqeEg: checks
*** SHOW DOWN ***
ApHP7ouup365XIUFBdEDxg: shows [6d 7h] (two pair, Tens and Sevens)
E2518gp4aFz1+kAgmGqeEg: shows [8h Kh] (two pair, Tens and Eights)
E2518gp4aFz1+kAgmGqeEg collected $7.15 from pot
*** SUMMARY ***
Total pot $7.50 | Rake $0.35
Board [Ts 8d 7s 2d Td]
Seat 1: E2518gp4aFz1+kAgmGqeEg showed [8h Kh] and won ($7.15) with two pair, Tens and Eights
Seat 2: 8zdVaT8pZ/Wm0uWoeLhtZg folded before Flop (didn't bet)
Seat 3: bkXkL3pmapikPQQRNPZSEA folded before Flop (didn't bet)
Seat 4: e2+sK/yjnj94rXOKoxPP2A (button) folded before Flop (didn't bet)
Seat 5: ApHP7ouup365XIUFBdEDxg (small blind) showed [6d 7h] and lost with two pair, Tens and Sevens
Seat 6: Wj7mKnRFR90j40wWUu2+Og (big blind) folded before Flop
Seat 7: HWcfp1hY1hqvrddzW3/FQw folded before Flop (didn't bet)
Seat 8: ji04uOybxCdpdefzlUQeKQ folded before Flop (didn't bet)



PokerStars Game #59940529112:  Hold'em No Limit ($0.25/$0.50) - 2009/07/01 1:09:12 ET
Table 'c/CRn+68J3Y8KxD5g1ek2Q' 2-max Seat #1 is the button
Seat 1: 46qCyJ6evTkHo9al5sBMNA ($89.35 in chips)
Seat 2: BypVLsYQt3ePFm2xQL/dOA ($275.75 in chips)
46qCyJ6evTkHo9al5sBMNA: posts small blind $0.25
BypVLsYQt3ePFm2xQL/dOA: posts big blind $0.50
*** HOLE CARDS ***
46qCyJ6evTkHo9al5sBMNA: raises $1.50 to $2
BypVLsYQt3ePFm2xQL/dOA: folds
46qCyJ6evTkHo9al5sBMNA collected $1 from pot
46qCyJ6evTkHo9al5sBMNA: doesn't show hand
*** SUMMARY ***
Total pot $1 | Rake $0
Seat 1: 46qCyJ6evTkHo9al5sBMNA (button) (small blind) collected ($1)
Seat 2: BypVLsYQt3ePFm2xQL/dOA (big blind) folded before Flop



PokerStars Game #59940530306:  Hold'em No Limit ($0.25/$0.50) - 2009/07/01 1:09:15 ET
Table '+z1aekfHkpp09pc8F9aViw' 6-max Seat #2 is the button
Seat 1: FHilMb2i2DbUCc9lplszog ($9.35 in chips)
Seat 2: 8EEqTTh7T1q48sYDqbI2Xg ($29.25 in chips)
Seat 3: uUznlIMFnRUvwrBhYF73KA ($143.65 in chips)
Seat 4: RowCSpSURHTOL/dcjg/Iug ($37.30 in chips)
Seat 5: rplyldNweS6YyMNEALQrug ($47.20 in chips)
Seat 6: 686aeHikcJlgKkSuIFdcXQ ($50 in chips)
uUznlIMFnRUvwrBhYF73KA: posts small blind $0.25
RowCSpSURHTOL/dcjg/Iug: posts big blind $0.50
*** HOLE CARDS ***
rplyldNweS6YyMNEALQrug: raises $3.50 to $4
686aeHikcJlgKkSuIFdcXQ: folds
FHilMb2i2DbUCc9lplszog: raises $5.35 to $9.35 and is all-in
8EEqTTh7T1q48sYDqbI2Xg: folds
uUznlIMFnRUvwrBhYF73KA: folds
RowCSpSURHTOL/dcjg/Iug: folds
rplyldNweS6YyMNEALQrug: calls $5.35
*** FLOP *** [Th 8c 3d]
*** TURN *** [Th 8c 3d] [Kd]
*** RIVER *** [Th 8c 3d Kd] [2h]
*** SHOW DOWN ***
rplyldNweS6YyMNEALQrug: shows [Ad Ks] (a pair of Kings)
FHilMb2i2DbUCc9lplszog: mucks hand
rplyldNweS6YyMNEALQrug collected $18.50 from pot
*** SUMMARY ***
Total pot $19.45 | Rake $0.95
Board [Th 8c 3d Kd 2h]
Seat 1: FHilMb2i2DbUCc9lplszog mucked
Seat 2: 8EEqTTh7T1q48sYDqbI2Xg (button) folded before Flop (didn't bet)
Seat 3: uUznlIMFnRUvwrBhYF73KA (small blind) folded before Flop
Seat 4: RowCSpSURHTOL/dcjg/Iug (big blind) folded before Flop
Seat 5: rplyldNweS6YyMNEALQrug showed [Ad Ks] and won ($18.50) with a pair of Kings
Seat 6: 686aeHikcJlgKkSuIFdcXQ folded before Flop (didn't bet)



PokerStars Game #59940531670:  Hold'em No Limit ($0.25/$0.50) - 2009/07/01 1:09:17 ET
Table '+dXkOAQyS8j9PQZusUTMpg' 2-max Seat #1 is the button
Seat 1: XFa6sBGjP2gxoIvxR3fZIg ($118.30 in chips)
Seat 2: 5IBeOgaApY1Bvzv2P8X4EA ($77 in chips)
XFa6sBGjP2gxoIvxR3fZIg: posts small blind $0.25
5IBeOgaApY1Bvzv2P8X4EA: posts big blind $0.50
*** HOLE CARDS ***
XFa6sBGjP2gxoIvxR3fZIg: raises $1 to $1.50
5IBeOgaApY1Bvzv2P8X4EA: folds
XFa6sBGjP2gxoIvxR3fZIg collected $1 from pot
*** SUMMARY ***
Total pot $1 | Rake $0
Seat 1: XFa6sBGjP2gxoIvxR3fZIg (button) (small blind) collected ($1)
Seat 2: 5IBeOgaApY1Bvzv2P8X4EA (big blind) folded before Flop



PokerStars Game #59940531666:  Hold'em No Limit ($0.25/$0.50) - 2009/07/01 1:09:17 ET
Table 'fx6MqwfYAj/Rt86hBz2L3Q' 9-max Seat #6 is the button
Seat 1: uw9QayAAxLM3Hb+HR7mSkg ($10.50 in chips)
Seat 2: C3rGXblctNcWI6JYPHhaEg ($33.65 in chips)
Seat 3: iadBi5AEt7gTBXbDSSnMYQ ($48.10 in chips)
Seat 5: iAISe3dVeua8PUn2wwgDHw ($66 in chips)
Seat 6: 5k9fvXD9suIgCxU4HLQjTw ($50 in chips)
Seat 7: SKnJuWHScqetA/qG5p+wCg ($30 in chips)
Seat 8: JYwJYYV9pM5KWdSiETl8rA ($19.25 in chips)
Seat 9: HZkVla4kK2SI42CVrPZ/ig ($18.30 in chips)
SKnJuWHScqetA/qG5p+wCg: posts small blind $0.25
JYwJYYV9pM5KWdSiETl8rA: posts big blind $0.50
*** HOLE CARDS ***
HZkVla4kK2SI42CVrPZ/ig: folds
uw9QayAAxLM3Hb+HR7mSkg: folds
C3rGXblctNcWI6JYPHhaEg: calls $0.50
iadBi5AEt7gTBXbDSSnMYQ: folds
iAISe3dVeua8PUn2wwgDHw: folds
5k9fvXD9suIgCxU4HLQjTw: folds
SKnJuWHScqetA/qG5p+wCg: folds
JYwJYYV9pM5KWdSiETl8rA: checks
*** FLOP *** [4c 8c 8h]
JYwJYYV9pM5KWdSiETl8rA: checks
C3rGXblctNcWI6JYPHhaEg: bets $1.15
JYwJYYV9pM5KWdSiETl8rA: folds
C3rGXblctNcWI6JYPHhaEg collected $1.20 from pot
C3rGXblctNcWI6JYPHhaEg: doesn't show hand
*** SUMMARY ***
Total pot $1.25 | Rake $0.05
Board [4c 8c 8h]
Seat 1: uw9QayAAxLM3Hb+HR7mSkg folded before Flop (didn't bet)
Seat 2: C3rGXblctNcWI6JYPHhaEg collected ($1.20)
Seat 3: iadBi5AEt7gTBXbDSSnMYQ folded before Flop (didn't bet)
Seat 5: iAISe3dVeua8PUn2wwgDHw folded before Flop (didn't bet)
Seat 6: 5k9fvXD9suIgCxU4HLQjTw (button) folded before Flop (didn't bet)
Seat 7: SKnJuWHScqetA/qG5p+wCg (small blind) folded before Flop
Seat 8: JYwJYYV9pM5KWdSiETl8rA (big blind) folded on the Flop
Seat 9: HZkVla4kK2SI42CVrPZ/ig folded before Flop (didn't bet)



PokerStars Game #59940534948:  Hold'em No Limit ($0.25/$0.50) - 2009/07/01 1:09:22 ET
Table 'c/CRn+68J3Y8KxD5g1ek2Q' 2-max Seat #2 is the button
Seat 1: 46qCyJ6evTkHo9al5sBMNA ($89.85 in chips)
Seat 2: BypVLsYQt3ePFm2xQL/dOA ($275.25 in chips)
BypVLsYQt3ePFm2xQL/dOA: posts small blind $0.25
46qCyJ6evTkHo9al5sBMNA: posts big blind $0.50
*** HOLE CARDS ***
BypVLsYQt3ePFm2xQL/dOA: calls $0.25
46qCyJ6evTkHo9al5sBMNA: checks
*** FLOP *** [4d Qs Js]
46qCyJ6evTkHo9al5sBMNA: checks
BypVLsYQt3ePFm2xQL/dOA: bets $1
46qCyJ6evTkHo9al5sBMNA: folds
BypVLsYQt3ePFm2xQL/dOA collected $0.95 from pot
BypVLsYQt3ePFm2xQL/dOA: doesn't show hand
*** SUMMARY ***
Total pot $1 | Rake $0.05
Board [4d Qs Js]
Seat 1: 46qCyJ6evTkHo9al5sBMNA (big blind) folded on the Flop
Seat 2: BypVLsYQt3ePFm2xQL/dOA (button) (small blind) collected ($0.95)



PokerStars Game #59940535716:  Hold'em No Limit ($0.25/$0.50) - 2009/07/01 1:09:24 ET
Table 'kgbJRsxfv64KrErDRBAkcw' 6-max Seat #5 is the button
Seat 1: VamsyhlFzXGF6/ydo0BHeA ($43.40 in chips)
Seat 2: AdS8BJMOheS01zjCDfPMFg ($49 in chips)
Seat 5: eUBBn2R56C1IQ6Cs/vitwg ($60.45 in chips)
Seat 6: 1b+2BbjMN8qhR1WPqdE9VQ ($57.85 in chips)
1b+2BbjMN8qhR1WPqdE9VQ: posts small blind $0.25
VamsyhlFzXGF6/ydo0BHeA: posts big blind $0.50
*** HOLE CARDS ***
AdS8BJMOheS01zjCDfPMFg: folds
eUBBn2R56C1IQ6Cs/vitwg: folds
1b+2BbjMN8qhR1WPqdE9VQ: calls $0.25
VamsyhlFzXGF6/ydo0BHeA: checks
*** FLOP *** [6h 9c 2d]
c4MNIaIyPMOMxrgT8FT5nA has returned
1b+2BbjMN8qhR1WPqdE9VQ: checks
VamsyhlFzXGF6/ydo0BHeA: checks
*** TURN *** [6h 9c 2d] [Qh]
1b+2BbjMN8qhR1WPqdE9VQ: checks
VamsyhlFzXGF6/ydo0BHeA: bets $2
1b+2BbjMN8qhR1WPqdE9VQ: folds
VamsyhlFzXGF6/ydo0BHeA collected $0.95 from pot
VamsyhlFzXGF6/ydo0BHeA: doesn't show hand
*** SUMMARY ***
Total pot $1 | Rake $0.05
Board [6h 9c 2d Qh]
Seat 1: VamsyhlFzXGF6/ydo0BHeA (big blind) collected ($0.95)
Seat 2: AdS8BJMOheS01zjCDfPMFg folded before Flop (didn't bet)
Seat 5: eUBBn2R56C1IQ6Cs/vitwg (button) folded before Flop (didn't bet)
Seat 6: 1b+2BbjMN8qhR1WPqdE9VQ (small blind) folded on the Turn



PokerStars Game #59940536682:  Hold'em No Limit ($0.25/$0.50) - 2009/07/01 1:09:25 ET
Table 'GfL/No5u5PoEnU39lP5pQg' 6-max Seat #2 is the button
Seat 1: 1WUCqNG+p+vfWRTXNu4ljw ($64.50 in chips)
Seat 2: uVwggSetzp7d+eVgowO3vg ($55 in chips)
Seat 4: r6u7MWSXF30/khcTYkrG9Q ($35.60 in chips)
Seat 5: M1KyQQvVPVuxqTAB8sR/zQ ($51.60 in chips)
Seat 6: kxPhs4ePFqMy52CInAJ2aw ($50.85 in chips)
r6u7MWSXF30/khcTYkrG9Q: posts small blind $0.25
M1KyQQvVPVuxqTAB8sR/zQ: posts big blind $0.50
*** HOLE CARDS ***
kxPhs4ePFqMy52CInAJ2aw: folds
1WUCqNG+p+vfWRTXNu4ljw: raises $1.50 to $2
uVwggSetzp7d+eVgowO3vg: folds
r6u7MWSXF30/khcTYkrG9Q: folds
M1KyQQvVPVuxqTAB8sR/zQ: folds
1WUCqNG+p+vfWRTXNu4ljw collected $1.25 from pot
*** SUMMARY ***
Total pot $1.25 | Rake $0
Seat 1: 1WUCqNG+p+vfWRTXNu4ljw collected ($1.25)
Seat 2: uVwggSetzp7d+eVgowO3vg (button) folded before Flop (didn't bet)
Seat 4: r6u7MWSXF30/khcTYkrG9Q (small blind) folded before Flop
Seat 5: M1KyQQvVPVuxqTAB8sR/zQ (big blind) folded before Flop
Seat 6: kxPhs4ePFqMy52CInAJ2aw folded before Flop (didn't bet)



PokerStars Game #59940536610:  Hold'em No Limit ($0.25/$0.50) - 2009/07/01 1:09:25 ET
Table '+dXkOAQyS8j9PQZusUTMpg' 2-max Seat #2 is the button
Seat 1: XFa6sBGjP2gxoIvxR3fZIg ($118.80 in chips)
Seat 2: 5IBeOgaApY1Bvzv2P8X4EA ($76.50 in chips)
5IBeOgaApY1Bvzv2P8X4EA: posts small blind $0.25
XFa6sBGjP2gxoIvxR3fZIg: posts big blind $0.50
*** HOLE CARDS ***
5IBeOgaApY1Bvzv2P8X4EA: folds
XFa6sBGjP2gxoIvxR3fZIg collected $0.50 from pot
*** SUMMARY ***
Total pot $0.50 | Rake $0
Seat 1: XFa6sBGjP2gxoIvxR3fZIg (big blind) collected ($0.50)
Seat 2: 5IBeOgaApY1Bvzv2P8X4EA (button) (small blind) folded before Flop



PokerStars Game #59940538064:  Hold'em No Limit ($0.25/$0.50) - 2009/07/01 1:09:28 ET
Table '0eJtgVAXVvBgncFdcUpXcQ' 2-max Seat #2 is the button
Seat 1: Ag6DvxX4vbRheqsv2zXKTQ ($44.30 in chips)
Seat 2: KMc4R+K9ao4Ur3rF7NGe6Q ($10.40 in chips)
KMc4R+K9ao4Ur3rF7NGe6Q: posts small blind $0.25
Ag6DvxX4vbRheqsv2zXKTQ: posts big blind $0.50
*** HOLE CARDS ***
KMc4R+K9ao4Ur3rF7NGe6Q: folds
Ag6DvxX4vbRheqsv2zXKTQ collected $0.50 from pot
*** SUMMARY ***
Total pot $0.50 | Rake $0
Seat 1: Ag6DvxX4vbRheqsv2zXKTQ (big blind) collected ($0.50)
Seat 2: KMc4R+K9ao4Ur3rF7NGe6Q (button) (small blind) folded before Flop



PokerStars Game #59940537962:  Hold'em No Limit ($0.25/$0.50) - 2009/07/01 1:09:28 ET
Table '8BQGgNetI1NOvWeu3gtMNw' 2-max Seat #2 is the button
Seat 1: bypIyrYcAAifLfhZpGlKLA ($104.90 in chips)
Seat 2: Z4HwehErEwzsv/noQlfUlg ($92.75 in chips)
Z4HwehErEwzsv/noQlfUlg: posts small blind $0.25
bypIyrYcAAifLfhZpGlKLA: posts big blind $0.50
*** HOLE CARDS ***
Z4HwehErEwzsv/noQlfUlg: calls $0.25
bypIyrYcAAifLfhZpGlKLA: checks
*** FLOP *** [3d 7s 9h]
bypIyrYcAAifLfhZpGlKLA: checks
Z4HwehErEwzsv/noQlfUlg: checks
*** TURN *** [3d 7s 9h] [2d]
bypIyrYcAAifLfhZpGlKLA: checks
Z4HwehErEwzsv/noQlfUlg: checks
*** RIVER *** [3d 7s 9h 2d] [4c]
bypIyrYcAAifLfhZpGlKLA: checks
Z4HwehErEwzsv/noQlfUlg: checks
*** SHOW DOWN ***
bypIyrYcAAifLfhZpGlKLA: shows [Kd 8c] (high card King)
Z4HwehErEwzsv/noQlfUlg: mucks hand
bypIyrYcAAifLfhZpGlKLA collected $0.95 from pot
*** SUMMARY ***
Total pot $1 | Rake $0.05
Board [3d 7s 9h 2d 4c]
Seat 1: bypIyrYcAAifLfhZpGlKLA (big blind) showed [Kd 8c] and won ($0.95) with high card King
Seat 2: Z4HwehErEwzsv/noQlfUlg (button) (small blind) mucked



PokerStars Game #59940538444:  Hold'em No Limit ($0.25/$0.50) - 2009/07/01 1:09:28 ET
Table 'lpxYasB1ClBSgTpCCITwhQ' 9-max Seat #1 is the button
Seat 1: mj7PS7wCH4PAl7+eYTFs7A ($49.25 in chips)
Seat 2: OWP/DOu+PlPK6ZZ3zYa0HA ($24.45 in chips)
Seat 3: sakr/FIfFtIZwDPmAj5Pzg ($50.95 in chips)
Seat 4: NnQCepdIR/AOUQn1yhYx6Q ($10 in chips)
Seat 5: IYd5zG8k7vdBNVHbHg2Pag ($35 in chips)
Seat 6: SegjDnMxWMujiD57ESNL+g ($11.35 in chips)
Seat 7: bmRtaIYKthN1F+B3JLZ3Jw ($74.10 in chips)
Seat 8: /mfensKw8/iZ1Vrx33S4xg ($19.50 in chips)
Seat 9: sUIUZ+begh92dzkUmvbMrw ($12.80 in chips)
OWP/DOu+PlPK6ZZ3zYa0HA: posts small blind $0.25
sakr/FIfFtIZwDPmAj5Pzg: posts big blind $0.50
*** HOLE CARDS ***
NnQCepdIR/AOUQn1yhYx6Q: folds
IYd5zG8k7vdBNVHbHg2Pag: folds
SegjDnMxWMujiD57ESNL+g: folds
bmRtaIYKthN1F+B3JLZ3Jw: folds
/mfensKw8/iZ1Vrx33S4xg: folds
sUIUZ+begh92dzkUmvbMrw: folds
mj7PS7wCH4PAl7+eYTFs7A: folds
OWP/DOu+PlPK6ZZ3zYa0HA: calls $0.25
sakr/FIfFtIZwDPmAj5Pzg: checks
*** FLOP *** [Jd 8c Qd]
OWP/DOu+PlPK6ZZ3zYa0HA: checks
sakr/FIfFtIZwDPmAj5Pzg: bets $1
OWP/DOu+PlPK6ZZ3zYa0HA: calls $1
*** TURN *** [Jd 8c Qd] [3d]
OWP/DOu+PlPK6ZZ3zYa0HA: checks
sakr/FIfFtIZwDPmAj5Pzg: checks
*** RIVER *** [Jd 8c Qd 3d] [3s]
OWP/DOu+PlPK6ZZ3zYa0HA: checks
sakr/FIfFtIZwDPmAj5Pzg: checks
*** SHOW DOWN ***
OWP/DOu+PlPK6ZZ3zYa0HA: shows [Js Qs] (two pair, Queens and Jacks)
sakr/FIfFtIZwDPmAj5Pzg: mucks hand
OWP/DOu+PlPK6ZZ3zYa0HA collected $2.90 from pot
*** SUMMARY ***
Total pot $3 | Rake $0.10
Board [Jd 8c Qd 3d 3s]
Seat 1: mj7PS7wCH4PAl7+eYTFs7A (button) folded before Flop (didn't bet)
Seat 2: OWP/DOu+PlPK6ZZ3zYa0HA (small blind) showed [Js Qs] and won ($2.90) with two pair, Queens and Jacks
Seat 3: sakr/FIfFtIZwDPmAj5Pzg (big blind) mucked
Seat 4: NnQCepdIR/AOUQn1yhYx6Q folded before Flop (didn't bet)
Seat 5: IYd5zG8k7vdBNVHbHg2Pag folded before Flop (didn't bet)
Seat 6: SegjDnMxWMujiD57ESNL+g folded before Flop (didn't bet)
Seat 7: bmRtaIYKthN1F+B3JLZ3Jw folded before Flop (didn't bet)
Seat 8: /mfensKw8/iZ1Vrx33S4xg folded before Flop (didn't bet)
Seat 9: sUIUZ+begh92dzkUmvbMrw folded before Flop (didn't bet)



PokerStars Game #59940539098:  Hold'em No Limit ($0.25/$0.50) - 2009/07/01 1:09:30 ET
Table 'Nz0Vr7WMHL2g5Uk7dDZjpw' 9-max Seat #4 is the button
Seat 1: tLkxo7JgV+WWI0UBw44K5A ($107.10 in chips)
Seat 2: gsyXT42WLEcOS4DdEk2wlw ($30.60 in chips)
Seat 3: hoglu9inkgs6zN573/bJag ($7.50 in chips)
Seat 4: E2518gp4aFz1+kAgmGqeEg ($12.55 in chips)
Seat 5: WGW0DgjBUXs1ylURHG8vnQ ($22.30 in chips)
Seat 6: 997ViqAtWn1FPjJqcffwcA ($59.80 in chips)
Seat 7: KPLH0gELgFe2OuAnhJFI5w ($23.45 in chips)
Seat 8: aoL+R/61Kxmw69ypuPrWAQ ($24.70 in chips)
Seat 9: mSD1pginDsyHG5PDfqzphw ($10.75 in chips)
WGW0DgjBUXs1ylURHG8vnQ: posts small blind $0.25
997ViqAtWn1FPjJqcffwcA: posts big blind $0.50
*** HOLE CARDS ***
KPLH0gELgFe2OuAnhJFI5w: calls $0.50
aoL+R/61Kxmw69ypuPrWAQ: calls $0.50
mSD1pginDsyHG5PDfqzphw: folds
tLkxo7JgV+WWI0UBw44K5A: folds
gsyXT42WLEcOS4DdEk2wlw: folds
hoglu9inkgs6zN573/bJag: folds
E2518gp4aFz1+kAgmGqeEg: folds
WGW0DgjBUXs1ylURHG8vnQ: calls $0.25
997ViqAtWn1FPjJqcffwcA: checks
*** FLOP *** [5d 7h 3s]
WGW0DgjBUXs1ylURHG8vnQ: bets $0.50
997ViqAtWn1FPjJqcffwcA: folds
KPLH0gELgFe2OuAnhJFI5w: calls $0.50
aoL+R/61Kxmw69ypuPrWAQ: calls $0.50
*** TURN *** [5d 7h 3s] [Ad]
WGW0DgjBUXs1ylURHG8vnQ: bets $0.50
KPLH0gELgFe2OuAnhJFI5w: folds
aoL+R/61Kxmw69ypuPrWAQ: folds
WGW0DgjBUXs1ylURHG8vnQ collected $3.35 from pot
WGW0DgjBUXs1ylURHG8vnQ: doesn't show hand
*** SUMMARY ***
Total pot $3.50 | Rake $0.15
Board [5d 7h 3s Ad]
Seat 1: tLkxo7JgV+WWI0UBw44K5A folded before Flop (didn't bet)
Seat 2: gsyXT42WLEcOS4DdEk2wlw folded before Flop (didn't bet)
Seat 3: hoglu9inkgs6zN573/bJag folded before Flop (didn't bet)
Seat 4: E2518gp4aFz1+kAgmGqeEg (button) folded before Flop (didn't bet)
Seat 5: WGW0DgjBUXs1ylURHG8vnQ (small blind) collected ($3.35)
Seat 6: 997ViqAtWn1FPjJqcffwcA (big blind) folded on the Flop
Seat 7: KPLH0gELgFe2OuAnhJFI5w folded on the Turn
Seat 8: aoL+R/61Kxmw69ypuPrWAQ folded on the Turn
Seat 9: mSD1pginDsyHG5PDfqzphw folded before Flop (didn't bet)



PokerStars Game #59940540614:  Hold'em No Limit ($0.25/$0.50) - 2009/07/01 1:09:32 ET
Table '+dXkOAQyS8j9PQZusUTMpg' 2-max Seat #1 is the button
Seat 1: XFa6sBGjP2gxoIvxR3fZIg ($119.05 in chips)
Seat 2: 5IBeOgaApY1Bvzv2P8X4EA ($76.25 in chips)
XFa6sBGjP2gxoIvxR3fZIg: posts small blind $0.25
5IBeOgaApY1Bvzv2P8X4EA: posts big blind $0.50
*** HOLE CARDS ***
XFa6sBGjP2gxoIvxR3fZIg: raises $1 to $1.50
5IBeOgaApY1Bvzv2P8X4EA: folds
XFa6sBGjP2gxoIvxR3fZIg collected $1 from pot
*** SUMMARY ***
Total pot $1 | Rake $0
Seat 1: XFa6sBGjP2gxoIvxR3fZIg (button) (small blind) collected ($1)
Seat 2: 5IBeOgaApY1Bvzv2P8X4EA (big blind) folded before Flop



PokerStars Game #59940541364:  Hold'em No Limit ($0.25/$0.50) - 2009/07/01 1:09:33 ET
Table '0eJtgVAXVvBgncFdcUpXcQ' 2-max Seat #1 is the button
Seat 1: Ag6DvxX4vbRheqsv2zXKTQ ($44.55 in chips)
Seat 2: KMc4R+K9ao4Ur3rF7NGe6Q ($10.15 in chips)
Ag6DvxX4vbRheqsv2zXKTQ: posts small blind $0.25
KMc4R+K9ao4Ur3rF7NGe6Q: posts big blind $0.50
*** HOLE CARDS ***
Ag6DvxX4vbRheqsv2zXKTQ: calls $0.25
KMc4R+K9ao4Ur3rF7NGe6Q: checks
*** FLOP *** [4h 9s 3h]
KMc4R+K9ao4Ur3rF7NGe6Q: checks
Ag6DvxX4vbRheqsv2zXKTQ: bets $1.50
KMc4R+K9ao4Ur3rF7NGe6Q: folds
Ag6DvxX4vbRheqsv2zXKTQ collected $0.95 from pot
*** SUMMARY ***
Total pot $1 | Rake $0.05
Board [4h 9s 3h]
Seat 1: Ag6DvxX4vbRheqsv2zXKTQ (button) (small blind) collected ($0.95)
Seat 2: KMc4R+K9ao4Ur3rF7NGe6Q (big blind) folded on the Flop



PokerStars Game #59940541420:  Hold'em No Limit ($0.25/$0.50) - 2009/07/01 1:09:33 ET
Table 'MJxeZCzYELxiIsyUZyT0jw' 6-max Seat #2 is the button
Seat 1: +Pf9jTVizYlIo+woPvptfA ($50 in chips)
Seat 2: t3GiVMzqA9Svgr5Uol32cQ ($27.10 in chips)
Seat 3: sIG4mp8tZEI+W4nKZNkkQA ($50.95 in chips)
Seat 4: alGiiQP/wwtYnfuXII+sgw ($63.35 in chips)
Seat 5: 3jvoOXNtXE90w2BdfNZwZQ ($50 in chips)
Seat 6: c0n4hrn20AML9qzyFC2E8Q ($63 in chips)
sIG4mp8tZEI+W4nKZNkkQA: posts small blind $0.25
alGiiQP/wwtYnfuXII+sgw: posts big blind $0.50
*** HOLE CARDS ***
3jvoOXNtXE90w2BdfNZwZQ: folds
c0n4hrn20AML9qzyFC2E8Q: folds
+Pf9jTVizYlIo+woPvptfA: raises $1.50 to $2
t3GiVMzqA9Svgr5Uol32cQ: folds
sIG4mp8tZEI+W4nKZNkkQA: raises $5 to $7
alGiiQP/wwtYnfuXII+sgw: folds
+Pf9jTVizYlIo+woPvptfA: folds
sIG4mp8tZEI+W4nKZNkkQA collected $4.50 from pot
sIG4mp8tZEI+W4nKZNkkQA: doesn't show hand
*** SUMMARY ***
Total pot $4.50 | Rake $0
Seat 1: +Pf9jTVizYlIo+woPvptfA folded before Flop
Seat 2: t3GiVMzqA9Svgr5Uol32cQ (button) folded before Flop (didn't bet)
Seat 3: sIG4mp8tZEI+W4nKZNkkQA (small blind) collected ($4.50)
Seat 4: alGiiQP/wwtYnfuXII+sgw (big blind) folded before Flop
Seat 5: 3jvoOXNtXE90w2BdfNZwZQ folded before Flop (didn't bet)
Seat 6: c0n4hrn20AML9qzyFC2E8Q folded before Flop (didn't bet)



PokerStars Game #59940540924:  Hold'em No Limit ($0.25/$0.50) - 2009/07/01 1:09:33 ET
Table 'eMxdLyFDf28E0wit6gm3Uw' 6-max Seat #6 is the button
Seat 1: FONMraB4GCHzDwDcfciKyw ($50 in chips)
Seat 2: UEjiWqFckVmunpvV128Xfw ($49.60 in chips)
Seat 4: hPAFLRqGh8YnqPe3HMZiQg ($24.85 in chips)
Seat 5: OtITKlSIHBhVAjRe30+BBQ ($41.40 in chips)
Seat 6: lxIzoHy0RnkfFSODHC2liw ($50 in chips)
FONMraB4GCHzDwDcfciKyw: posts small blind $0.25
UEjiWqFckVmunpvV128Xfw: posts big blind $0.50
*** HOLE CARDS ***
hPAFLRqGh8YnqPe3HMZiQg: folds
OtITKlSIHBhVAjRe30+BBQ: folds
lxIzoHy0RnkfFSODHC2liw: raises $1 to $1.50
FONMraB4GCHzDwDcfciKyw: folds
UEjiWqFckVmunpvV128Xfw: folds
lxIzoHy0RnkfFSODHC2liw collected $1.25 from pot
*** SUMMARY ***
Total pot $1.25 | Rake $0
Seat 1: FONMraB4GCHzDwDcfciKyw (small blind) folded before Flop
Seat 2: UEjiWqFckVmunpvV128Xfw (big blind) folded before Flop
Seat 4: hPAFLRqGh8YnqPe3HMZiQg folded before Flop (didn't bet)
Seat 5: OtITKlSIHBhVAjRe30+BBQ folded before Flop (didn't bet)
Seat 6: lxIzoHy0RnkfFSODHC2liw (button) collected ($1.25)



PokerStars Game #59940541612:  Hold'em No Limit ($0.25/$0.50) - 2009/07/01 1:09:34 ET
Table 'BCN5su+SsXiy1zRMJi0SJw' 6-max Seat #6 is the button
Seat 1: GxXV09ciXaOxyY2H5aMIIw ($43.30 in chips)
Seat 2: oU2kDCkT/gilYbHWrg7D8w ($42.45 in chips)
Seat 3: kwgv5lNhiFrfONXCshzxlA ($29.50 in chips)
Seat 4: 4QfsCWthT/vSLirorNXqtg ($50 in chips)
Seat 5: WUgnrlL2IrGbGEyDnzOJzQ ($10 in chips)
Seat 6: b2symlOdL7+0c9Pj4N/KlA ($59.35 in chips)
GxXV09ciXaOxyY2H5aMIIw: posts small blind $0.25
oU2kDCkT/gilYbHWrg7D8w: posts big blind $0.50
WUgnrlL2IrGbGEyDnzOJzQ: posts big blind $0.50
*** HOLE CARDS ***
kwgv5lNhiFrfONXCshzxlA: folds
4QfsCWthT/vSLirorNXqtg: folds
WUgnrlL2IrGbGEyDnzOJzQ: checks
b2symlOdL7+0c9Pj4N/KlA: folds
GxXV09ciXaOxyY2H5aMIIw: calls $0.25
oU2kDCkT/gilYbHWrg7D8w: checks
*** FLOP *** [4h 2d 9c]
GxXV09ciXaOxyY2H5aMIIw: checks
oU2kDCkT/gilYbHWrg7D8w: checks
WUgnrlL2IrGbGEyDnzOJzQ: bets $1
GxXV09ciXaOxyY2H5aMIIw: folds
oU2kDCkT/gilYbHWrg7D8w: folds
WUgnrlL2IrGbGEyDnzOJzQ collected $1.45 from pot
WUgnrlL2IrGbGEyDnzOJzQ: doesn't show hand
*** SUMMARY ***
Total pot $1.50 | Rake $0.05
Board [4h 2d 9c]
Seat 1: GxXV09ciXaOxyY2H5aMIIw (small blind) folded on the Flop
Seat 2: oU2kDCkT/gilYbHWrg7D8w (big blind) folded on the Flop
Seat 3: kwgv5lNhiFrfONXCshzxlA folded before Flop (didn't bet)
Seat 4: 4QfsCWthT/vSLirorNXqtg folded before Flop (didn't bet)
Seat 5: WUgnrlL2IrGbGEyDnzOJzQ collected ($1.45)
Seat 6: b2symlOdL7+0c9Pj4N/KlA (button) folded before Flop (didn't bet)



PokerStars Game #59940545048:  Hold'em No Limit ($0.25/$0.50) - 2009/07/01 1:09:39 ET
Table 'E7bWJ45aoFXRpyRv2gw+Ig' 2-max Seat #1 is the button
Seat 1: FRkiRasEGlHUeLrEl+k/nA ($50 in chips)
Seat 2: 3Wro85I7472vJ4Wkpneo9A ($144.40 in chips)
FRkiRasEGlHUeLrEl+k/nA: posts small blind $0.25
3Wro85I7472vJ4Wkpneo9A: posts big blind $0.50
*** HOLE CARDS ***
FRkiRasEGlHUeLrEl+k/nA: folds
3Wro85I7472vJ4Wkpneo9A collected $0.50 from pot
3Wro85I7472vJ4Wkpneo9A: doesn't show hand
*** SUMMARY ***
Total pot $0.50 | Rake $0
Seat 1: FRkiRasEGlHUeLrEl+k/nA (button) (small blind) folded before Flop
Seat 2: 3Wro85I7472vJ4Wkpneo9A (big blind) collected ($0.50)



PokerStars Game #59940544876:  Hold'em No Limit ($0.25/$0.50) - 2009/07/01 1:09:39 ET
Table '+dXkOAQyS8j9PQZusUTMpg' 2-max Seat #2 is the button
Seat 1: XFa6sBGjP2gxoIvxR3fZIg ($119.55 in chips)
Seat 2: 5IBeOgaApY1Bvzv2P8X4EA ($75.75 in chips)
5IBeOgaApY1Bvzv2P8X4EA: posts small blind $0.25
XFa6sBGjP2gxoIvxR3fZIg: posts big blind $0.50
*** HOLE CARDS ***
5IBeOgaApY1Bvzv2P8X4EA: folds
XFa6sBGjP2gxoIvxR3fZIg collected $0.50 from pot
XFa6sBGjP2gxoIvxR3fZIg: doesn't show hand
*** SUMMARY ***
Total pot $0.50 | Rake $0
Seat 1: XFa6sBGjP2gxoIvxR3fZIg (big blind) collected ($0.50)
Seat 2: 5IBeOgaApY1Bvzv2P8X4EA (button) (small blind) folded before Flop



PokerStars Game #59940545320:  Hold'em No Limit ($0.25/$0.50) - 2009/07/01 1:09:40 ET
Table 'PALRfuH85dr5IkDfdv6new' 9-max Seat #5 is the button
Seat 1: v/4aX0ejnaIFK4ftDk2Lyg ($49.50 in chips)
Seat 2: 1aXjSbrubyQKHeauooF5Wg ($48.90 in chips)
Seat 3: 50QWoELmpmHFrFIlWMJo9g ($91.50 in chips)
Seat 4: mZNMJI1mY40XTC0U7GZakA ($50 in chips)
Seat 5: jSSGUXdNFAZA3QCvTcUMQw ($62.20 in chips)
Seat 6: ottZQkg1UDWk85BtBzGJzg ($50.35 in chips)
Seat 7: 3NcyXvr39gnK+KbTq7ezyA ($63.30 in chips)
Seat 8: NkS+CseUKx4XHszWq0PXEQ ($74.65 in chips)
Seat 9: viwBDtJsY6JfsFOdBAyJIQ ($10 in chips)
ottZQkg1UDWk85BtBzGJzg: posts small blind $0.25
3NcyXvr39gnK+KbTq7ezyA: posts big blind $0.50
viwBDtJsY6JfsFOdBAyJIQ: posts big blind $0.50
*** HOLE CARDS ***
NkS+CseUKx4XHszWq0PXEQ: folds
viwBDtJsY6JfsFOdBAyJIQ: checks
v/4aX0ejnaIFK4ftDk2Lyg: folds
1aXjSbrubyQKHeauooF5Wg: calls $0.50
50QWoELmpmHFrFIlWMJo9g: folds
mZNMJI1mY40XTC0U7GZakA: raises $2.50 to $3
jSSGUXdNFAZA3QCvTcUMQw: folds
ottZQkg1UDWk85BtBzGJzg: folds
3NcyXvr39gnK+KbTq7ezyA: folds
viwBDtJsY6JfsFOdBAyJIQ: folds
1aXjSbrubyQKHeauooF5Wg: calls $2.50
*** FLOP *** [6c 7c 8c]
1aXjSbrubyQKHeauooF5Wg: checks
mZNMJI1mY40XTC0U7GZakA: bets $4
1aXjSbrubyQKHeauooF5Wg: calls $4
*** TURN *** [6c 7c 8c] [8s]
1aXjSbrubyQKHeauooF5Wg: checks
mZNMJI1mY40XTC0U7GZakA: checks
*** RIVER *** [6c 7c 8c 8s] [4c]
1aXjSbrubyQKHeauooF5Wg: checks
mZNMJI1mY40XTC0U7GZakA: checks
*** SHOW DOWN ***
1aXjSbrubyQKHeauooF5Wg: shows [4d 5d] (a straight, Four to Eight)
mZNMJI1mY40XTC0U7GZakA: shows [Qh Jc] (a flush, Jack high)
mZNMJI1mY40XTC0U7GZakA collected $14.55 from pot
*** SUMMARY ***
Total pot $15.25 | Rake $0.70
Board [6c 7c 8c 8s 4c]
Seat 1: v/4aX0ejnaIFK4ftDk2Lyg folded before Flop (didn't bet)
Seat 2: 1aXjSbrubyQKHeauooF5Wg showed [4d 5d] and lost with a straight, Four to Eight
Seat 3: 50QWoELmpmHFrFIlWMJo9g folded before Flop (didn't bet)
Seat 4: mZNMJI1mY40XTC0U7GZakA showed [Qh Jc] and won ($14.55) with a flush, Jack high
Seat 5: jSSGUXdNFAZA3QCvTcUMQw (button) folded before Flop (didn't bet)
Seat 6: ottZQkg1UDWk85BtBzGJzg (small blind) folded before Flop
Seat 7: 3NcyXvr39gnK+KbTq7ezyA (big blind) folded before Flop
Seat 8: NkS+CseUKx4XHszWq0PXEQ folded before Flop (didn't bet)
Seat 9: viwBDtJsY6JfsFOdBAyJIQ folded before Flop



PokerStars Game #59940545902:  Hold'em No Limit ($0.25/$0.50) - 2009/07/01 1:09:41 ET
Table 'tYh970kmVfYS0gXPT/XtoQ' 2-max Seat #2 is the button
Seat 1: CLj3pYZDnglQbP8AEHiYIw ($59.35 in chips)
Seat 2: fxN9bTdAgPNvNkHgbVXKGw ($10 in chips)
fxN9bTdAgPNvNkHgbVXKGw: posts small blind $0.25
CLj3pYZDnglQbP8AEHiYIw: posts big blind $0.50
*** HOLE CARDS ***
fxN9bTdAgPNvNkHgbVXKGw: raises $0.50 to $1
CLj3pYZDnglQbP8AEHiYIw: folds
fxN9bTdAgPNvNkHgbVXKGw collected $1 from pot
fxN9bTdAgPNvNkHgbVXKGw: doesn't show hand
*** SUMMARY ***
Total pot $1 | Rake $0
Seat 1: CLj3pYZDnglQbP8AEHiYIw (big blind) folded before Flop
Seat 2: fxN9bTdAgPNvNkHgbVXKGw (button) (small blind) collected ($1)



PokerStars Game #59940546424:  Hold'em No Limit ($0.25/$0.50) - 2009/07/01 1:09:42 ET
Table 'ErOuyGLI5PT3G5MnpHgC/gQOgaEqMcJ73pcUMMxoisUg Seat #6 is the button
Seat 2: pciZn00ZDk4BVBMTTMcNVQ ($28 in chips)
Seat 3: xZCXQSXlrZkp3pZizzVXCw ($50.50 in chips)
Seat 4: 3UmXLy3GfjC3EkOebduerQ ($50 in chips)
Seat 5: JwvquocWfhTVApN5t47LgA ($64.60 in chips)
Seat 6: zE9cVigS2nW/Ljy4K4bUQA ($30.85 in chips)
Seat 7: 90Wb75h3W1BRpbqVnuk8gw ($65.20 in chips)
Seat 8: g4k0NXISyLCqaSWZDBjfEg ($50.75 in chips)
Seat 9: J0W5D97jl5VLky+IoPvDeA ($52.35 in chips)
90Wb75h3W1BRpbqVnuk8gw: posts small blind $0.25
g4k0NXISyLCqaSWZDBjfEg: posts big blind $0.50
eBrej2jnlUCs/JgxFCRn2g: sits out
*** HOLE CARDS ***
J0W5D97jl5VLky+IoPvDeA: folds
pciZn00ZDk4BVBMTTMcNVQ: folds
xZCXQSXlrZkp3pZizzVXCw: folds
3UmXLy3GfjC3EkOebduerQ: folds
JwvquocWfhTVApN5t47LgA: folds
zE9cVigS2nW/Ljy4K4bUQA: raises $1 to $1.50
90Wb75h3W1BRpbqVnuk8gw: folds
g4k0NXISyLCqaSWZDBjfEg: folds
zE9cVigS2nW/Ljy4K4bUQA collected $1.25 from pot
*** SUMMARY ***
Total pot $1.25 | Rake $0
Seat 2: pciZn00ZDk4BVBMTTMcNVQ folded before Flop (didn't bet)
Seat 3: xZCXQSXlrZkp3pZizzVXCw folded before Flop (didn't bet)
Seat 4: 3UmXLy3GfjC3EkOebduerQ folded before Flop (didn't bet)
Seat 5: JwvquocWfhTVApN5t47LgA folded before Flop (didn't bet)
Seat 6: zE9cVigS2nW/Ljy4K4bUQA (button) collected ($1.25)
Seat 7: 90Wb75h3W1BRpbqVnuk8gw (small blind) folded before Flop
Seat 8: g4k0NXISyLCqaSWZDBjfEg (big blind) folded before Flop
Seat 9: J0W5D97jl5VLky+IoPvDeA folded before Flop (didn't bet)



PokerStars Game #59940547140:  Hold'em No Limit ($0.25/$0.50) - 2009/07/01 1:09:43 ET
Table '5EmHi+fnatGQQShcNmzOZQ' 6-max Seat #1 is the button
Seat 1: My8WkRtGx5FW6rJ1I4R3hg ($49.35 in chips)
Seat 2: bfFjgAtIoAI+pUxUwFt3aQ ($36.75 in chips)
Seat 3: 1mYbhL8CU/QYqfVmFcaHDQ ($8 in chips)
Seat 4: 1b+2BbjMN8qhR1WPqdE9VQ ($50 in chips)
Seat 5: kxPhs4ePFqMy52CInAJ2aw ($93.85 in chips)
Seat 6: 686aeHikcJlgKkSuIFdcXQ ($134.85 in chips)
bfFjgAtIoAI+pUxUwFt3aQ: posts small blind $0.25
1mYbhL8CU/QYqfVmFcaHDQ: posts big blind $0.50
*** HOLE CARDS ***
1b+2BbjMN8qhR1WPqdE9VQ: raises $1 to $1.50
kxPhs4ePFqMy52CInAJ2aw: folds
686aeHikcJlgKkSuIFdcXQ: folds
My8WkRtGx5FW6rJ1I4R3hg: folds
bfFjgAtIoAI+pUxUwFt3aQ: calls $1.25
1mYbhL8CU/QYqfVmFcaHDQ: folds
*** FLOP *** [4c 6d 7c]
bfFjgAtIoAI+pUxUwFt3aQ: bets $2.50
1b+2BbjMN8qhR1WPqdE9VQ: folds
bfFjgAtIoAI+pUxUwFt3aQ collected $3.35 from pot
*** SUMMARY ***
Total pot $3.50 | Rake $0.15
Board [4c 6d 7c]
Seat 1: My8WkRtGx5FW6rJ1I4R3hg (button) folded before Flop (didn't bet)
Seat 2: bfFjgAtIoAI+pUxUwFt3aQ (small blind) collected ($3.35)
Seat 3: 1mYbhL8CU/QYqfVmFcaHDQ (big blind) folded before Flop
Seat 4: 1b+2BbjMN8qhR1WPqdE9VQ folded on the Flop
Seat 5: kxPhs4ePFqMy52CInAJ2aw folded before Flop (didn't bet)
Seat 6: 686aeHikcJlgKkSuIFdcXQ folded before Flop (didn't bet)



PokerStars Game #59940547786:  Hold'em No Limit ($0.25/$0.50) - 2009/07/01 1:09:44 ET
Table 'EiNh8p/wGJ1FP575iMFnqg' 9-max Seat #3 is the button
Seat 1: r3ZqM1Mi0W3y4hOdssE+Sg ($50.75 in chips)
Seat 2: 8ehL7qlZzjgUh2H35iiWLw ($53.40 in chips)
Seat 3: ymLPoEIl7UL3TvZYmnadxQ ($58.90 in chips)
Seat 4: cMzaiXAM/ZAdNaEUu+LqhA ($54.45 in chips)
Seat 5: M+7+BTmX5vZatHVuoRB1nA ($80.45 in chips)
Seat 6: 3UmXLy3GfjC3EkOebduerQ ($61.60 in chips)
Seat 7: 997ViqAtWn1FPjJqcffwcA ($50 in chips)
Seat 8: mSD1pginDsyHG5PDfqzphw ($10 in chips)
cMzaiXAM/ZAdNaEUu+LqhA: posts small blind $0.25
M+7+BTmX5vZatHVuoRB1nA: posts big blind $0.50
*** HOLE CARDS ***
3UmXLy3GfjC3EkOebduerQ: folds
997ViqAtWn1FPjJqcffwcA: folds
mSD1pginDsyHG5PDfqzphw: folds
r3ZqM1Mi0W3y4hOdssE+Sg: folds
8ehL7qlZzjgUh2H35iiWLw: raises $1.50 to $2
ymLPoEIl7UL3TvZYmnadxQ: folds
cMzaiXAM/ZAdNaEUu+LqhA: folds
M+7+BTmX5vZatHVuoRB1nA: folds
8ehL7qlZzjgUh2H35iiWLw collected $1.25 from pot
8ehL7qlZzjgUh2H35iiWLw: doesn't show hand
*** SUMMARY ***
Total pot $1.25 | Rake $0
Seat 1: r3ZqM1Mi0W3y4hOdssE+Sg folded before Flop (didn't bet)
Seat 2: 8ehL7qlZzjgUh2H35iiWLw collected ($1.25)
Seat 3: ymLPoEIl7UL3TvZYmnadxQ (button) folded before Flop (didn't bet)
Seat 4: cMzaiXAM/ZAdNaEUu+LqhA (small blind) folded before Flop
Seat 5: M+7+BTmX5vZatHVuoRB1nA (big blind) folded before Flop
Seat 6: 3UmXLy3GfjC3EkOebduerQ folded before Flop (didn't bet)
Seat 7: 997ViqAtWn1FPjJqcffwcA folded before Flop (didn't bet)
Seat 8: mSD1pginDsyHG5PDfqzphw folded before Flop (didn't bet)



PokerStars Game #59940548284:  Hold'em No Limit ($0.25/$0.50) - 2009/07/01 1:09:45 ET
Table '+dXkOAQyS8j9PQZusUTMpg' 2-max Seat #1 is the button
Seat 1: XFa6sBGjP2gxoIvxR3fZIg ($119.80 in chips)
Seat 2: 5IBeOgaApY1Bvzv2P8X4EA ($75.50 in chips)
XFa6sBGjP2gxoIvxR3fZIg: posts small blind $0.25
5IBeOgaApY1Bvzv2P8X4EA: posts big blind $0.50
*** HOLE CARDS ***
XFa6sBGjP2gxoIvxR3fZIg: raises $1 to $1.50
5IBeOgaApY1Bvzv2P8X4EA: folds
XFa6sBGjP2gxoIvxR3fZIg collected $1 from pot
XFa6sBGjP2gxoIvxR3fZIg: doesn't show hand
*** SUMMARY ***
Total pot $1 | Rake $0
Seat 1: XFa6sBGjP2gxoIvxR3fZIg (button) (small blind) collected ($1)
Seat 2: 5IBeOgaApY1Bvzv2P8X4EA (big blind) folded before Flop



PokerStars Game #59940548736:  Hold'em No Limit ($0.25/$0.50) - 2009/07/01 1:09:46 ET
Table '0eJtgVAXVvBgncFdcUpXcQ' 2-max Seat #2 is the button
Seat 1: Ag6DvxX4vbRheqsv2zXKTQ ($45 in chips)
Seat 2: KMc4R+K9ao4Ur3rF7NGe6Q ($9.65 in chips)
KMc4R+K9ao4Ur3rF7NGe6Q: posts small blind $0.25
Ag6DvxX4vbRheqsv2zXKTQ: posts big blind $0.50
*** HOLE CARDS ***
KMc4R+K9ao4Ur3rF7NGe6Q: calls $0.25
Ag6DvxX4vbRheqsv2zXKTQ: checks
*** FLOP *** [8s Jc Td]
Ag6DvxX4vbRheqsv2zXKTQ: checks
KMc4R+K9ao4Ur3rF7NGe6Q: checks
*** TURN *** [8s Jc Td] [Jd]
Ag6DvxX4vbRheqsv2zXKTQ: checks
KMc4R+K9ao4Ur3rF7NGe6Q: checks
*** RIVER *** [8s Jc Td Jd] [Ad]
Ag6DvxX4vbRheqsv2zXKTQ: bets $1
KMc4R+K9ao4Ur3rF7NGe6Q: folds
Ag6DvxX4vbRheqsv2zXKTQ collected $0.95 from pot
*** SUMMARY ***
Total pot $1 | Rake $0.05
Board [8s Jc Td Jd Ad]
Seat 1: Ag6DvxX4vbRheqsv2zXKTQ (big blind) collected ($0.95)
Seat 2: KMc4R+K9ao4Ur3rF7NGe6Q (button) (small blind) folded on the River



PokerStars Game #59940548642:  Hold'em No Limit ($0.25/$0.50) - 2009/07/01 1:09:46 ET
Table 'GfL/No5u5PoEnU39lP5pQg' 6-max Seat #4 is the button
Seat 1: 1WUCqNG+p+vfWRTXNu4ljw ($65.25 in chips)
Seat 2: uVwggSetzp7d+eVgowO3vg ($55 in chips)
Seat 4: r6u7MWSXF30/khcTYkrG9Q ($35.35 in chips)
Seat 5: M1KyQQvVPVuxqTAB8sR/zQ ($51.10 in chips)
Seat 6: kxPhs4ePFqMy52CInAJ2aw ($50.85 in chips)
M1KyQQvVPVuxqTAB8sR/zQ: posts small blind $0.25
kxPhs4ePFqMy52CInAJ2aw: posts big blind $0.50
*** HOLE CARDS ***
1WUCqNG+p+vfWRTXNu4ljw: folds
uVwggSetzp7d+eVgowO3vg: folds
4pp9WxhGdbVbxCc9tlu0lw joins the table at seat #3
r6u7MWSXF30/khcTYkrG9Q: raises $1 to $1.50
M1KyQQvVPVuxqTAB8sR/zQ: folds
kxPhs4ePFqMy52CInAJ2aw: folds
r6u7MWSXF30/khcTYkrG9Q collected $1.25 from pot
*** SUMMARY ***
Total pot $1.25 | Rake $0
Seat 1: 1WUCqNG+p+vfWRTXNu4ljw folded before Flop (didn't bet)
Seat 2: uVwggSetzp7d+eVgowO3vg folded before Flop (didn't bet)
Seat 4: r6u7MWSXF30/khcTYkrG9Q (button) collected ($1.25)
Seat 5: M1KyQQvVPVuxqTAB8sR/zQ (small blind) folded before Flop
Seat 6: kxPhs4ePFqMy52CInAJ2aw (big blind) folded before Flop



PokerStars Game #59940549702:  Hold'em No Limit ($0.25/$0.50) - 2009/07/01 1:09:47 ET
Table 'otvGDROEDdqsabxskT79qg' 9-max Seat #6 is the button
Seat 1: 8ehL7qlZzjgUh2H35iiWLw ($59.75 in chips)
Seat 2: cCjTzH9jio8607WzjcfXlg ($13.20 in chips)
Seat 3: +k7T5ocke8UwavtgUHm+Cg ($70.60 in chips)
Seat 4: MG90wfSJZnOejs/KD3vlQQ ($75.90 in chips)
Seat 5: E2518gp4aFz1+kAgmGqeEg ($11 in chips)
Seat 6: bxLSulbgr8LmKNjOzw8URg ($55.25 in chips)
Seat 7: 75K2MXwN65Sjfp1yHd50Hg ($9.50 in chips)
Seat 8: zE9cVigS2nW/Ljy4K4bUQA ($30 in chips)
Seat 9: KcY3X8YpD74Kw1RHkx/g4A ($47.90 in chips)
75K2MXwN65Sjfp1yHd50Hg: posts small blind $0.25
zE9cVigS2nW/Ljy4K4bUQA: posts big blind $0.50
*** HOLE CARDS ***
KcY3X8YpD74Kw1RHkx/g4A: folds
8ehL7qlZzjgUh2H35iiWLw: folds
cCjTzH9jio8607WzjcfXlg: folds
+k7T5ocke8UwavtgUHm+Cg: folds
MG90wfSJZnOejs/KD3vlQQ: folds
E2518gp4aFz1+kAgmGqeEg: raises $1 to $1.50
bxLSulbgr8LmKNjOzw8URg: folds
75K2MXwN65Sjfp1yHd50Hg: folds
zE9cVigS2nW/Ljy4K4bUQA: folds
E2518gp4aFz1+kAgmGqeEg collected $1.25 from pot
E2518gp4aFz1+kAgmGqeEg: doesn't show hand
*** SUMMARY ***
Total pot $1.25 | Rake $0
Seat 1: 8ehL7qlZzjgUh2H35iiWLw folded before Flop (didn't bet)
Seat 2: cCjTzH9jio8607WzjcfXlg folded before Flop (didn't bet)
Seat 3: +k7T5ocke8UwavtgUHm+Cg folded before Flop (didn't bet)
Seat 4: MG90wfSJZnOejs/KD3vlQQ folded before Flop (didn't bet)
Seat 5: E2518gp4aFz1+kAgmGqeEg collected ($1.25)
Seat 6: bxLSulbgr8LmKNjOzw8URg (button) folded before Flop (didn't bet)
Seat 7: 75K2MXwN65Sjfp1yHd50Hg (small blind) folded before Flop
Seat 8: zE9cVigS2nW/Ljy4K4bUQA (big blind) folded before Flop
Seat 9: KcY3X8YpD74Kw1RHkx/g4A folded before Flop (didn't bet)



PokerStars Game #59940550008:  Hold'em No Limit ($0.25/$0.50) - 2009/07/01 1:09:48 ET
Table 'c/CRn+68J3Y8KxD5g1ek2Q' 2-max Seat #1 is the button
Seat 1: 46qCyJ6evTkHo9al5sBMNA ($89.35 in chips)
Seat 2: BypVLsYQt3ePFm2xQL/dOA ($275.70 in chips)
46qCyJ6evTkHo9al5sBMNA: posts small blind $0.25
BypVLsYQt3ePFm2xQL/dOA: posts big blind $0.50
*** HOLE CARDS ***
46qCyJ6evTkHo9al5sBMNA: folds
BypVLsYQt3ePFm2xQL/dOA collected $0.50 from pot
BypVLsYQt3ePFm2xQL/dOA: doesn't show hand
*** SUMMARY ***
Total pot $0.50 | Rake $0
Seat 1: 46qCyJ6evTkHo9al5sBMNA (button) (small blind) folded before Flop
Seat 2: BypVLsYQt3ePFm2xQL/dOA (big blind) collected ($0.50)



PokerStars Game #59940550024:  Hold'em No Limit ($0.25/$0.50) - 2009/07/01 1:09:48 ET
Table '37qXEp3oe+er5q4CZip9eQ' 6-max Seat #1 is the button
Seat 1: lxIzoHy0RnkfFSODHC2liw ($50 in chips)
Seat 2: LvH4G7n+QSjT6NDaD3cREA ($54.55 in chips)
Seat 3: Rt6KgtZ8YaJoTc3FPim00w ($110.20 in chips)
Seat 4: XsmE8nXMAAMFJbWaJTmHFw ($48.20 in chips)
Seat 5: VOmI0x4dDPnTESZd5B4d1Q ($42.50 in chips)
Seat 6: N50kln4negd8q7Mmoz1j4g ($10.05 in chips)
LvH4G7n+QSjT6NDaD3cREA: posts small blind $0.25
Rt6KgtZ8YaJoTc3FPim00w: posts big blind $0.50
*** HOLE CARDS ***
XsmE8nXMAAMFJbWaJTmHFw: raises $1 to $1.50
VOmI0x4dDPnTESZd5B4d1Q: folds
N50kln4negd8q7Mmoz1j4g: folds
lxIzoHy0RnkfFSODHC2liw: folds
LvH4G7n+QSjT6NDaD3cREA: folds
Rt6KgtZ8YaJoTc3FPim00w: folds
XsmE8nXMAAMFJbWaJTmHFw collected $1.25 from pot
*** SUMMARY ***
Total pot $1.25 | Rake $0
Seat 1: lxIzoHy0RnkfFSODHC2liw (button) folded before Flop (didn't bet)
Seat 2: LvH4G7n+QSjT6NDaD3cREA (small blind) folded before Flop
Seat 3: Rt6KgtZ8YaJoTc3FPim00w (big blind) folded before Flop
Seat 4: XsmE8nXMAAMFJbWaJTmHFw collected ($1.25)
Seat 5: VOmI0x4dDPnTESZd5B4d1Q folded before Flop (didn't bet)
Seat 6: N50kln4negd8q7Mmoz1j4g folded before Flop (didn't bet)



PokerStars Game #59940550644:  Hold'em No Limit ($0.25/$0.50) - 2009/07/01 1:09:49 ET
Table 'E7bWJ45aoFXRpyRv2gw+Ig' 2-max Seat #2 is the button
Seat 1: FRkiRasEGlHUeLrEl+k/nA ($50 in chips)
Seat 2: 3Wro85I7472vJ4Wkpneo9A ($144.65 in chips)
3Wro85I7472vJ4Wkpneo9A: posts small blind $0.25
FRkiRasEGlHUeLrEl+k/nA said, "joke.."
FRkiRasEGlHUeLrEl+k/nA: posts big blind $0.50
*** HOLE CARDS ***
3Wro85I7472vJ4Wkpneo9A: folds
FRkiRasEGlHUeLrEl+k/nA collected $0.50 from pot
*** SUMMARY ***
Total pot $0.50 | Rake $0
Seat 1: FRkiRasEGlHUeLrEl+k/nA (big blind) collected ($0.50)
Seat 2: 3Wro85I7472vJ4Wkpneo9A (button) (small blind) folded before Flop



PokerStars Game #59940550484:  Hold'em No Limit ($0.25/$0.50) - 2009/07/01 1:09:49 ET
Table 'tYh970kmVfYS0gXPT/XtoQ' 2-max Seat #1 is the button
Seat 1: CLj3pYZDnglQbP8AEHiYIw ($58.85 in chips)
Seat 2: fxN9bTdAgPNvNkHgbVXKGw ($10.50 in chips)
CLj3pYZDnglQbP8AEHiYIw: posts small blind $0.25
fxN9bTdAgPNvNkHgbVXKGw: posts big blind $0.50
*** HOLE CARDS ***
CLj3pYZDnglQbP8AEHiYIw: raises $1 to $1.50
fxN9bTdAgPNvNkHgbVXKGw: folds
CLj3pYZDnglQbP8AEHiYIw collected $1 from pot
*** SUMMARY ***
Total pot $1 | Rake $0
Seat 1: CLj3pYZDnglQbP8AEHiYIw (button) (small blind) collected ($1)
Seat 2: fxN9bTdAgPNvNkHgbVXKGw (big blind) folded before Flop



PokerStars Game #59940550390:  Hold'em No Limit ($0.25/$0.50) - 2009/07/01 1:09:49 ET
Table 'lSisgp6H7Fg1hH5VfjEjYQ' 9-max Seat #6 is the button
Seat 1: 5k9fvXD9suIgCxU4HLQjTw ($50.35 in chips)
Seat 2: UrcnkQOiLVk8BlKDPJSy7Q ($76.55 in chips)
Seat 3: aTkyjTh3w5YLWiIERupZOA ($51.40 in chips)
Seat 4: bwv/rbH/hHhPhY6u9mu04w ($34.60 in chips)
Seat 5: mSD1pginDsyHG5PDfqzphw ($10 in chips)
Seat 6: +k7T5ocke8UwavtgUHm+Cg ($65.30 in chips)
Seat 7: IDtNLR9uFCDdjNsJWMHA5Q ($19.05 in chips)
Seat 8: a4JDWmpFQkL10XfAyuF51A ($27 in chips)
Seat 9: YzeKFbJVLmJGTgNH3ySQlw ($11.30 in chips)
IDtNLR9uFCDdjNsJWMHA5Q: posts small blind $0.25
a4JDWmpFQkL10XfAyuF51A: posts big blind $0.50
*** HOLE CARDS ***
YzeKFbJVLmJGTgNH3ySQlw: calls $0.50
5k9fvXD9suIgCxU4HLQjTw: folds
UrcnkQOiLVk8BlKDPJSy7Q: folds
aTkyjTh3w5YLWiIERupZOA: raises $1 to $1.50
bwv/rbH/hHhPhY6u9mu04w: folds
mSD1pginDsyHG5PDfqzphw: folds
+k7T5ocke8UwavtgUHm+Cg: folds
IDtNLR9uFCDdjNsJWMHA5Q: folds
a4JDWmpFQkL10XfAyuF51A: folds
YzeKFbJVLmJGTgNH3ySQlw: calls $1
*** FLOP *** [6s 3d Qc]
YzeKFbJVLmJGTgNH3ySQlw: checks
aTkyjTh3w5YLWiIERupZOA: bets $1.50
YzeKFbJVLmJGTgNH3ySQlw: calls $1.50
*** TURN *** [6s 3d Qc] [2c]
YzeKFbJVLmJGTgNH3ySQlw: checks
aTkyjTh3w5YLWiIERupZOA: checks
*** RIVER *** [6s 3d Qc 2c] [6c]
YzeKFbJVLmJGTgNH3ySQlw: bets $3
aTkyjTh3w5YLWiIERupZOA: folds
YzeKFbJVLmJGTgNH3ySQlw collected $6.45 from pot
*** SUMMARY ***
Total pot $6.75 | Rake $0.30
Board [6s 3d Qc 2c 6c]
Seat 1: 5k9fvXD9suIgCxU4HLQjTw folded before Flop (didn't bet)
Seat 2: UrcnkQOiLVk8BlKDPJSy7Q folded before Flop (didn't bet)
Seat 3: aTkyjTh3w5YLWiIERupZOA folded on the River
Seat 4: bwv/rbH/hHhPhY6u9mu04w folded before Flop (didn't bet)
Seat 5: mSD1pginDsyHG5PDfqzphw folded before Flop (didn't bet)
Seat 6: +k7T5ocke8UwavtgUHm+Cg (button) folded before Flop (didn't bet)
Seat 7: IDtNLR9uFCDdjNsJWMHA5Q (small blind) folded before Flop
Seat 8: a4JDWmpFQkL10XfAyuF51A (big blind) folded before Flop
Seat 9: YzeKFbJVLmJGTgNH3ySQlw collected ($6.45)



PokerStars Game #59940550846:  Hold'em No Limit ($0.25/$0.50) - 2009/07/01 1:09:49 ET
Table 'NCiXr0d5CEKBQr/cZgLhbA' 9-max Seat #8 is the button
Seat 1: pFtzb1sR4b0d1aw6aIRgDg ($50 in chips)
Seat 2: ulxuJchBV9iguXg0FUonfg ($19.40 in chips)
Seat 3: xZCXQSXlrZkp3pZizzVXCw ($51.95 in chips)
Seat 4: 5k9fvXD9suIgCxU4HLQjTw ($52.45 in chips)
Seat 5: zE9cVigS2nW/Ljy4K4bUQA ($65.10 in chips)
Seat 6: SKnJuWHScqetA/qG5p+wCg ($30 in chips)
Seat 7: M+7+BTmX5vZatHVuoRB1nA ($52 in chips)
Seat 8: 1MJUKc3cc0QmUoz1JZLR2w ($49.30 in chips)
Seat 9: 4WLZvqBn5qv5tds5kt5A1Q ($56.55 in chips)
4WLZvqBn5qv5tds5kt5A1Q: posts small blind $0.25
pFtzb1sR4b0d1aw6aIRgDg: posts big blind $0.50
*** HOLE CARDS ***
ulxuJchBV9iguXg0FUonfg: folds
4WLZvqBn5qv5tds5kt5A1Q said, "ty"
xZCXQSXlrZkp3pZizzVXCw: folds
5k9fvXD9suIgCxU4HLQjTw: folds
zE9cVigS2nW/Ljy4K4bUQA: folds
SKnJuWHScqetA/qG5p+wCg: folds
M+7+BTmX5vZatHVuoRB1nA: folds
1MJUKc3cc0QmUoz1JZLR2w: folds
4WLZvqBn5qv5tds5kt5A1Q: calls $0.25
pFtzb1sR4b0d1aw6aIRgDg: checks
*** FLOP *** [3c 7d 2h]
4WLZvqBn5qv5tds5kt5A1Q: checks
pFtzb1sR4b0d1aw6aIRgDg: bets $1
4WLZvqBn5qv5tds5kt5A1Q: folds
pFtzb1sR4b0d1aw6aIRgDg collected $0.95 from pot
*** SUMMARY ***
Total pot $1 | Rake $0.05
Board [3c 7d 2h]
Seat 1: pFtzb1sR4b0d1aw6aIRgDg (big blind) collected ($0.95)
Seat 2: ulxuJchBV9iguXg0FUonfg folded before Flop (didn't bet)
Seat 3: xZCXQSXlrZkp3pZizzVXCw folded before Flop (didn't bet)
Seat 4: 5k9fvXD9suIgCxU4HLQjTw folded before Flop (didn't bet)
Seat 5: zE9cVigS2nW/Ljy4K4bUQA folded before Flop (didn't bet)
Seat 6: SKnJuWHScqetA/qG5p+wCg folded before Flop (didn't bet)
Seat 7: M+7+BTmX5vZatHVuoRB1nA folded before Flop (didn't bet)
Seat 8: 1MJUKc3cc0QmUoz1JZLR2w (button) folded before Flop (didn't bet)
Seat 9: 4WLZvqBn5qv5tds5kt5A1Q (small blind) folded on the Flop



PokerStars Game #59940553026:  Hold'em No Limit ($0.25/$0.50) - 2009/07/01 1:09:53 ET
Table '+dXkOAQyS8j9PQZusUTMpg' 2-max Seat #2 is the button
Seat 1: XFa6sBGjP2gxoIvxR3fZIg ($120.30 in chips)
Seat 2: 5IBeOgaApY1Bvzv2P8X4EA ($75 in chips)
5IBeOgaApY1Bvzv2P8X4EA: posts small blind $0.25
XFa6sBGjP2gxoIvxR3fZIg: posts big blind $0.50
*** HOLE CARDS ***
5IBeOgaApY1Bvzv2P8X4EA: calls $0.25
XFa6sBGjP2gxoIvxR3fZIg: checks
*** FLOP *** [Qd 8s 4s]
XFa6sBGjP2gxoIvxR3fZIg: checks
5IBeOgaApY1Bvzv2P8X4EA: bets $1
XFa6sBGjP2gxoIvxR3fZIg: folds
5IBeOgaApY1Bvzv2P8X4EA collected $0.95 from pot
5IBeOgaApY1Bvzv2P8X4EA: doesn't show hand
*** SUMMARY ***
Total pot $1 | Rake $0.05
Board [Qd 8s 4s]
Seat 1: XFa6sBGjP2gxoIvxR3fZIg (big blind) folded on the Flop
Seat 2: 5IBeOgaApY1Bvzv2P8X4EA (button) (small blind) collected ($0.95)



PokerStars Game #59940553024:  Hold'em No Limit ($0.25/$0.50) - 2009/07/01 1:09:53 ET
Table 'MJxeZCzYELxiIsyUZyT0jw' 6-max Seat #3 is the button
Seat 1: +Pf9jTVizYlIo+woPvptfA ($50 in chips)
Seat 2: t3GiVMzqA9Svgr5Uol32cQ ($27.10 in chips)
Seat 3: sIG4mp8tZEI+W4nKZNkkQA ($53.45 in chips)
Seat 4: alGiiQP/wwtYnfuXII+sgw ($62.85 in chips)
Seat 5: 3jvoOXNtXE90w2BdfNZwZQ ($50 in chips)
Seat 6: c0n4hrn20AML9qzyFC2E8Q ($63 in chips)
alGiiQP/wwtYnfuXII+sgw: posts small blind $0.25
3jvoOXNtXE90w2BdfNZwZQ: posts big blind $0.50
*** HOLE CARDS ***
c0n4hrn20AML9qzyFC2E8Q: folds
+Pf9jTVizYlIo+woPvptfA: folds
t3GiVMzqA9Svgr5Uol32cQ has timed out
t3GiVMzqA9Svgr5Uol32cQ: folds
t3GiVMzqA9Svgr5Uol32cQ is sitting out
sIG4mp8tZEI+W4nKZNkkQA: folds
alGiiQP/wwtYnfuXII+sgw: calls $0.25
3jvoOXNtXE90w2BdfNZwZQ: raises $2 to $2.50
alGiiQP/wwtYnfuXII+sgw: folds
3jvoOXNtXE90w2BdfNZwZQ collected $1 from pot
3jvoOXNtXE90w2BdfNZwZQ: doesn't show hand
*** SUMMARY ***
Total pot $1 | Rake $0
Seat 1: +Pf9jTVizYlIo+woPvptfA folded before Flop (didn't bet)
Seat 2: t3GiVMzqA9Svgr5Uol32cQ folded before Flop (didn't bet)
Seat 3: sIG4mp8tZEI+W4nKZNkkQA (button) folded before Flop (didn't bet)
Seat 4: alGiiQP/wwtYnfuXII+sgw (small blind) folded before Flop
Seat 5: 3jvoOXNtXE90w2BdfNZwZQ (big blind) collected ($1)
Seat 6: c0n4hrn20AML9qzyFC2E8Q folded before Flop (didn't bet)



PokerStars Game #59940553472:  Hold'em No Limit ($0.25/$0.50) - 2009/07/01 1:09:54 ET
Table 'eMxdLyFDf28E0wit6gm3Uw' 6-max Seat #1 is the button
Seat 1: FONMraB4GCHzDwDcfciKyw ($50 in chips)
Seat 2: UEjiWqFckVmunpvV128Xfw ($49.10 in chips)
Seat 4: hPAFLRqGh8YnqPe3HMZiQg ($24.85 in chips)
Seat 5: OtITKlSIHBhVAjRe30+BBQ ($41.40 in chips)
Seat 6: lxIzoHy0RnkfFSODHC2liw ($50.75 in chips)
UEjiWqFckVmunpvV128Xfw: posts small blind $0.25
hPAFLRqGh8YnqPe3HMZiQg: posts big blind $0.50
*** HOLE CARDS ***
OtITKlSIHBhVAjRe30+BBQ: calls $0.50
lxIzoHy0RnkfFSODHC2liw: folds
FONMraB4GCHzDwDcfciKyw: folds
UEjiWqFckVmunpvV128Xfw: folds
hPAFLRqGh8YnqPe3HMZiQg: raises $1.50 to $2
OtITKlSIHBhVAjRe30+BBQ: calls $1.50
*** FLOP *** [2c Jd 5c]
hPAFLRqGh8YnqPe3HMZiQg: bets $2
OtITKlSIHBhVAjRe30+BBQ: folds
hPAFLRqGh8YnqPe3HMZiQg collected $4.05 from pot
*** SUMMARY ***
Total pot $4.25 | Rake $0.20
Board [2c Jd 5c]
Seat 1: FONMraB4GCHzDwDcfciKyw (button) folded before Flop (didn't bet)
Seat 2: UEjiWqFckVmunpvV128Xfw (small blind) folded before Flop
Seat 4: hPAFLRqGh8YnqPe3HMZiQg (big blind) collected ($4.05)
Seat 5: OtITKlSIHBhVAjRe30+BBQ folded on the Flop
Seat 6: lxIzoHy0RnkfFSODHC2liw folded before Flop (didn't bet)



PokerStars Game #59940553892:  Hold'em No Limit ($0.25/$0.50) - 2009/07/01 1:09:55 ET
Table 'c/CRn+68J3Y8KxD5g1ek2Q' 2-max Seat #2 is the button
Seat 1: 46qCyJ6evTkHo9al5sBMNA ($89.10 in chips)
Seat 2: BypVLsYQt3ePFm2xQL/dOA ($275.95 in chips)
BypVLsYQt3ePFm2xQL/dOA: posts small blind $0.25
46qCyJ6evTkHo9al5sBMNA: posts big blind $0.50
*** HOLE CARDS ***
BypVLsYQt3ePFm2xQL/dOA: calls $0.25
46qCyJ6evTkHo9al5sBMNA: checks
*** FLOP *** [6d 8d Qh]
46qCyJ6evTkHo9al5sBMNA: checks
BypVLsYQt3ePFm2xQL/dOA: checks
*** TURN *** [6d 8d Qh] [9d]
46qCyJ6evTkHo9al5sBMNA: checks
BypVLsYQt3ePFm2xQL/dOA: checks
*** RIVER *** [6d 8d Qh 9d] [7h]
46qCyJ6evTkHo9al5sBMNA: checks
BypVLsYQt3ePFm2xQL/dOA: checks
*** SHOW DOWN ***
46qCyJ6evTkHo9al5sBMNA: shows [Jh 2h] (high card Queen)
BypVLsYQt3ePFm2xQL/dOA: shows [Ad 4c] (high card Ace)
BypVLsYQt3ePFm2xQL/dOA collected $0.95 from pot
*** SUMMARY ***
Total pot $1 | Rake $0.05
Board [6d 8d Qh 9d 7h]
Seat 1: 46qCyJ6evTkHo9al5sBMNA (big blind) showed [Jh 2h] and lost with high card Queen
Seat 2: BypVLsYQt3ePFm2xQL/dOA (button) (small blind) showed [Ad 4c] and won ($0.95) with high card Ace



PokerStars Game #59940554008:  Hold'em No Limit ($0.25/$0.50) - 2009/07/01 1:09:55 ET
Table 'ZYI3ZReBjdfKEYItkZHI6A' 9-max Seat #5 is the button
Seat 1: E2518gp4aFz1+kAgmGqeEg ($17.50 in chips)
Seat 2: 8zdVaT8pZ/Wm0uWoeLhtZg ($5.45 in chips)
Seat 3: bkXkL3pmapikPQQRNPZSEA ($19.65 in chips)
Seat 4: e2+sK/yjnj94rXOKoxPP2A ($50 in chips)
Seat 5: ApHP7ouup365XIUFBdEDxg ($45 in chips)
Seat 6: Wj7mKnRFR90j40wWUu2+Og ($36.80 in chips)
Seat 7: HWcfp1hY1hqvrddzW3/FQw ($12.50 in chips)
Seat 8: ji04uOybxCdpdefzlUQeKQ ($28 in chips)
Wj7mKnRFR90j40wWUu2+Og: posts small blind $0.25
HWcfp1hY1hqvrddzW3/FQw: posts big blind $0.50
*** HOLE CARDS ***
ji04uOybxCdpdefzlUQeKQ: raises $1.50 to $2
E2518gp4aFz1+kAgmGqeEg: folds
8zdVaT8pZ/Wm0uWoeLhtZg: folds
bkXkL3pmapikPQQRNPZSEA: folds
e2+sK/yjnj94rXOKoxPP2A: folds
ApHP7ouup365XIUFBdEDxg: folds
Wj7mKnRFR90j40wWUu2+Og: folds
HWcfp1hY1hqvrddzW3/FQw: folds
ji04uOybxCdpdefzlUQeKQ collected $1.25 from pot
ji04uOybxCdpdefzlUQeKQ: doesn't show hand
*** SUMMARY ***
Total pot $1.25 | Rake $0
Seat 1: E2518gp4aFz1+kAgmGqeEg folded before Flop (didn't bet)
Seat 2: 8zdVaT8pZ/Wm0uWoeLhtZg folded before Flop (didn't bet)
Seat 3: bkXkL3pmapikPQQRNPZSEA folded before Flop (didn't bet)
Seat 4: e2+sK/yjnj94rXOKoxPP2A folded before Flop (didn't bet)
Seat 5: ApHP7ouup365XIUFBdEDxg (button) folded before Flop (didn't bet)
Seat 6: Wj7mKnRFR90j40wWUu2+Og (small blind) folded before Flop
Seat 7: HWcfp1hY1hqvrddzW3/FQw (big blind) folded before Flop
Seat 8: ji04uOybxCdpdefzlUQeKQ collected ($1.25)



PokerStars Game #59940554924:  Hold'em No Limit ($0.25/$0.50) - 2009/07/01 1:09:56 ET
Table 'E7bWJ45aoFXRpyRv2gw+Ig' 2-max Seat #1 is the button
Seat 1: FRkiRasEGlHUeLrEl+k/nA ($50.25 in chips)
Seat 2: 3Wro85I7472vJ4Wkpneo9A ($144.40 in chips)
FRkiRasEGlHUeLrEl+k/nA: posts small blind $0.25
3Wro85I7472vJ4Wkpneo9A: posts big blind $0.50
*** HOLE CARDS ***
FRkiRasEGlHUeLrEl+k/nA: raises $1.50 to $2
3Wro85I7472vJ4Wkpneo9A: folds
FRkiRasEGlHUeLrEl+k/nA collected $1 from pot
*** SUMMARY ***
Total pot $1 | Rake $0
Seat 1: FRkiRasEGlHUeLrEl+k/nA (button) (small blind) collected ($1)
Seat 2: 3Wro85I7472vJ4Wkpneo9A (big blind) folded before Flop



PokerStars Game #59940554670:  Hold'em No Limit ($0.25/$0.50) - 2009/07/01 1:09:56 ET
Table 'tYh970kmVfYS0gXPT/XtoQ' 2-max Seat #2 is the button
Seat 1: CLj3pYZDnglQbP8AEHiYIw ($59.35 in chips)
Seat 2: fxN9bTdAgPNvNkHgbVXKGw ($10 in chips)
fxN9bTdAgPNvNkHgbVXKGw: posts small blind $0.25
CLj3pYZDnglQbP8AEHiYIw: posts big blind $0.50
*** HOLE CARDS ***
fxN9bTdAgPNvNkHgbVXKGw: raises $0.50 to $1
CLj3pYZDnglQbP8AEHiYIw: folds
fxN9bTdAgPNvNkHgbVXKGw collected $1 from pot
fxN9bTdAgPNvNkHgbVXKGw: doesn't show hand
*** SUMMARY ***
Total pot $1 | Rake $0
Seat 1: CLj3pYZDnglQbP8AEHiYIw (big blind) folded before Flop
Seat 2: fxN9bTdAgPNvNkHgbVXKGw (button) (small blind) collected ($1)



PokerStars Game #59940554464:  Hold'em No Limit ($0.25/$0.50) - 2009/07/01 1:09:56 ET
Table 'X6IRCRTh+20gjz8aubWnwA' 9-max Seat #5 is the button
Seat 1: DSM67hHHq1XFoEOi9p8Alw ($52.05 in chips)
Seat 2: HZkVla4kK2SI42CVrPZ/ig ($6.80 in chips)
Seat 3: SWv01peOe69QQRvhQTqjQw ($8 in chips)
Seat 4: M3JFBNQ8Bbw3FBZ/18MuXw ($25 in chips)
Seat 5: NnQCepdIR/AOUQn1yhYx6Q ($9.25 in chips)
Seat 6: 75K2MXwN65Sjfp1yHd50Hg ($10.70 in chips)
Seat 7: cFHQjKQOOKTUzoilhrXHLg ($15.40 in chips)
Seat 8: HxeBVq06/3Bh/H986sgdbw ($51.50 in chips)
Seat 9: M+7+BTmX5vZatHVuoRB1nA ($43.75 in chips)
75K2MXwN65Sjfp1yHd50Hg: posts small blind $0.25
cFHQjKQOOKTUzoilhrXHLg: posts big blind $0.50
*** HOLE CARDS ***
HxeBVq06/3Bh/H986sgdbw: folds
M+7+BTmX5vZatHVuoRB1nA: folds
DSM67hHHq1XFoEOi9p8Alw: raises $1.50 to $2
HZkVla4kK2SI42CVrPZ/ig: folds
SWv01peOe69QQRvhQTqjQw: calls $2
M3JFBNQ8Bbw3FBZ/18MuXw: folds
NnQCepdIR/AOUQn1yhYx6Q: folds
75K2MXwN65Sjfp1yHd50Hg: folds
cFHQjKQOOKTUzoilhrXHLg: calls $1.50
*** FLOP *** [Ts 6c 4c]
cFHQjKQOOKTUzoilhrXHLg: checks
DSM67hHHq1XFoEOi9p8Alw: bets $5
SWv01peOe69QQRvhQTqjQw: folds
cFHQjKQOOKTUzoilhrXHLg: folds
DSM67hHHq1XFoEOi9p8Alw collected $5.95 from pot
*** SUMMARY ***
Total pot $6.25 | Rake $0.30
Board [Ts 6c 4c]
Seat 1: DSM67hHHq1XFoEOi9p8Alw collected ($5.95)
Seat 2: HZkVla4kK2SI42CVrPZ/ig folded before Flop (didn't bet)
Seat 3: SWv01peOe69QQRvhQTqjQw folded on the Flop
Seat 4: M3JFBNQ8Bbw3FBZ/18MuXw folded before Flop (didn't bet)
Seat 5: NnQCepdIR/AOUQn1yhYx6Q (button) folded before Flop (didn't bet)
Seat 6: 75K2MXwN65Sjfp1yHd50Hg (small blind) folded before Flop
Seat 7: cFHQjKQOOKTUzoilhrXHLg (big blind) folded on the Flop
Seat 8: HxeBVq06/3Bh/H986sgdbw folded before Flop (didn't bet)
Seat 9: M+7+BTmX5vZatHVuoRB1nA folded before Flop (didn't bet)



PokerStars Game #59940555112:  Hold'em No Limit ($0.25/$0.50) - 2009/07/01 1:09:57 ET
Table '+z1aekfHkpp09pc8F9aViw' 6-max Seat #3 is the button
Seat 2: 8EEqTTh7T1q48sYDqbI2Xg ($29.25 in chips)
Seat 3: uUznlIMFnRUvwrBhYF73KA ($143.40 in chips)
Seat 4: RowCSpSURHTOL/dcjg/Iug ($36.80 in chips)
Seat 5: rplyldNweS6YyMNEALQrug ($56.35 in chips)
Seat 6: 686aeHikcJlgKkSuIFdcXQ ($50 in chips)
RowCSpSURHTOL/dcjg/Iug: posts small blind $0.25
rplyldNweS6YyMNEALQrug: posts big blind $0.50
*** HOLE CARDS ***
686aeHikcJlgKkSuIFdcXQ: raises $1.50 to $2
8EEqTTh7T1q48sYDqbI2Xg: folds
7zFtlEn2NxyROFkJdZA/yg joins the table at seat #1
uUznlIMFnRUvwrBhYF73KA: calls $2
RowCSpSURHTOL/dcjg/Iug: folds
rplyldNweS6YyMNEALQrug: folds
*** FLOP *** [Jc Js Td]
686aeHikcJlgKkSuIFdcXQ: bets $4
uUznlIMFnRUvwrBhYF73KA: folds
686aeHikcJlgKkSuIFdcXQ collected $4.55 from pot
*** SUMMARY ***
Total pot $4.75 | Rake $0.20
Board [Jc Js Td]
Seat 2: 8EEqTTh7T1q48sYDqbI2Xg folded before Flop (didn't bet)
Seat 3: uUznlIMFnRUvwrBhYF73KA (button) folded on the Flop
Seat 4: RowCSpSURHTOL/dcjg/Iug (small blind) folded before Flop
Seat 5: rplyldNweS6YyMNEALQrug (big blind) folded before Flop
Seat 6: 686aeHikcJlgKkSuIFdcXQ collected ($4.55)



PokerStars Game #59940555938:  Hold'em No Limit ($0.25/$0.50) - 2009/07/01 1:09:58 ET
Table '/cQuAT3ef4t+PGrXiNhGaQ' 9-max Seat #6 is the button
Seat 1: HZkVla4kK2SI42CVrPZ/ig ($14.25 in chips)
Seat 2: jXGruyaMqirTaTXNOvBdew ($68.20 in chips)
Seat 3: g4k0NXISyLCqaSWZDBjfEg ($55.35 in chips)
Seat 4: OWP/DOu+PlPK6ZZ3zYa0HA ($27.60 in chips)
Seat 5: 5SgaHdWixdClWvaEG+KUjQ ($42.60 in chips)
Seat 6: APYIOyK/4AGb+kIwlOUNBQ ($36.10 in chips)
Seat 7: J0W5D97jl5VLky+IoPvDeA ($168 in chips)
Seat 8: eBrej2jnlUCs/JgxFCRn2g ($39.10 in chips)
Seat 9: AjV5McH1KMMclY26QdLM5w ($26.95 in chips)
J0W5D97jl5VLky+IoPvDeA: posts small blind $0.25
eBrej2jnlUCs/JgxFCRn2g: posts big blind $0.50
*** HOLE CARDS ***
AjV5McH1KMMclY26QdLM5w: folds
HZkVla4kK2SI42CVrPZ/ig: folds
jXGruyaMqirTaTXNOvBdew: folds
g4k0NXISyLCqaSWZDBjfEg: folds
OWP/DOu+PlPK6ZZ3zYa0HA: folds
5SgaHdWixdClWvaEG+KUjQ: raises $1 to $1.50
APYIOyK/4AGb+kIwlOUNBQ: folds
J0W5D97jl5VLky+IoPvDeA: folds
eBrej2jnlUCs/JgxFCRn2g: calls $1
*** FLOP *** [Jc 6h Ts]
eBrej2jnlUCs/JgxFCRn2g: bets $1
5SgaHdWixdClWvaEG+KUjQ: calls $1
*** TURN *** [Jc 6h Ts] [8d]
eBrej2jnlUCs/JgxFCRn2g: bets $1
5SgaHdWixdClWvaEG+KUjQ: calls $1
*** RIVER *** [Jc 6h Ts 8d] [4c]
eBrej2jnlUCs/JgxFCRn2g: bets $3
5SgaHdWixdClWvaEG+KUjQ: folds
eBrej2jnlUCs/JgxFCRn2g collected $6.90 from pot
*** SUMMARY ***
Total pot $7.25 | Rake $0.35
Board [Jc 6h Ts 8d 4c]
Seat 1: HZkVla4kK2SI42CVrPZ/ig folded before Flop (didn't bet)
Seat 2: jXGruyaMqirTaTXNOvBdew folded before Flop (didn't bet)
Seat 3: g4k0NXISyLCqaSWZDBjfEg folded before Flop (didn't bet)
Seat 4: OWP/DOu+PlPK6ZZ3zYa0HA folded before Flop (didn't bet)
Seat 5: 5SgaHdWixdClWvaEG+KUjQ folded on the River
Seat 6: APYIOyK/4AGb+kIwlOUNBQ (button) folded before Flop (didn't bet)
Seat 7: J0W5D97jl5VLky+IoPvDeA (small blind) folded before Flop
Seat 8: eBrej2jnlUCs/JgxFCRn2g (big blind) collected ($6.90)
Seat 9: AjV5McH1KMMclY26QdLM5w folded before Flop (didn't bet)



PokerStars Game #59940555656:  Hold'em No Limit ($0.25/$0.50) - 2009/07/01 1:09:58 ET
Table 'BCN5su+SsXiy1zRMJi0SJw' 6-max Seat #1 is the button
Seat 1: GxXV09ciXaOxyY2H5aMIIw ($42.80 in chips)
Seat 2: oU2kDCkT/gilYbHWrg7D8w ($41.95 in chips)
Seat 3: kwgv5lNhiFrfONXCshzxlA ($29.50 in chips)
Seat 4: 4QfsCWthT/vSLirorNXqtg ($50 in chips)
Seat 5: WUgnrlL2IrGbGEyDnzOJzQ ($10.95 in chips)
Seat 6: b2symlOdL7+0c9Pj4N/KlA ($59.35 in chips)
oU2kDCkT/gilYbHWrg7D8w: posts small blind $0.25
kwgv5lNhiFrfONXCshzxlA: posts big blind $0.50
*** HOLE CARDS ***
4QfsCWthT/vSLirorNXqtg: folds
WUgnrlL2IrGbGEyDnzOJzQ: raises $1.50 to $2
b2symlOdL7+0c9Pj4N/KlA: folds
GxXV09ciXaOxyY2H5aMIIw: raises $4 to $6
oU2kDCkT/gilYbHWrg7D8w: folds
kwgv5lNhiFrfONXCshzxlA: folds
WUgnrlL2IrGbGEyDnzOJzQ: calls $4
*** FLOP *** [Td Jh 5s]
WUgnrlL2IrGbGEyDnzOJzQ: bets $4.95 and is all-in
GxXV09ciXaOxyY2H5aMIIw: calls $4.95
*** TURN *** [Td Jh 5s] [Ts]
*** RIVER *** [Td Jh 5s Ts] [6c]
*** SHOW DOWN ***
WUgnrlL2IrGbGEyDnzOJzQ: shows [Qd Ks] (a pair of Tens)
GxXV09ciXaOxyY2H5aMIIw: shows [Qs Qc] (two pair, Queens and Tens)
GxXV09ciXaOxyY2H5aMIIw collected $21.55 from pot
*** SUMMARY ***
Total pot $22.65 | Rake $1.10
Board [Td Jh 5s Ts 6c]
Seat 1: GxXV09ciXaOxyY2H5aMIIw (button) showed [Qs Qc] and won ($21.55) with two pair, Queens and Tens
Seat 2: oU2kDCkT/gilYbHWrg7D8w (small blind) folded before Flop
Seat 3: kwgv5lNhiFrfONXCshzxlA (big blind) folded before Flop
Seat 4: 4QfsCWthT/vSLirorNXqtg folded before Flop (didn't bet)
Seat 5: WUgnrlL2IrGbGEyDnzOJzQ showed [Qd Ks] and lost with a pair of Tens
Seat 6: b2symlOdL7+0c9Pj4N/KlA folded before Flop (didn't bet)



PokerStars Game #59940556538:  Hold'em No Limit ($0.25/$0.50) - 2009/07/01 1:09:59 ET
Table '8BQGgNetI1NOvWeu3gtMNw' 2-max Seat #1 is the button
Seat 1: bypIyrYcAAifLfhZpGlKLA ($105.35 in chips)
Seat 2: Z4HwehErEwzsv/noQlfUlg ($92.25 in chips)
bypIyrYcAAifLfhZpGlKLA: posts small blind $0.25
Z4HwehErEwzsv/noQlfUlg: posts big blind $0.50
*** HOLE CARDS ***
bypIyrYcAAifLfhZpGlKLA: raises $1 to $1.50
Z4HwehErEwzsv/noQlfUlg: raises $1.50 to $3
bypIyrYcAAifLfhZpGlKLA: calls $1.50
*** FLOP *** [8c 6s Qc]
Z4HwehErEwzsv/noQlfUlg: checks
bypIyrYcAAifLfhZpGlKLA: bets $4
Z4HwehErEwzsv/noQlfUlg: folds
bypIyrYcAAifLfhZpGlKLA collected $5.70 from pot
bypIyrYcAAifLfhZpGlKLA: doesn't show hand
*** SUMMARY ***
Total pot $6 | Rake $0.30
Board [8c 6s Qc]
Seat 1: bypIyrYcAAifLfhZpGlKLA (button) (small blind) collected ($5.70)
Seat 2: Z4HwehErEwzsv/noQlfUlg (big blind) folded on the Flop



PokerStars Game #59940558304:  Hold'em No Limit ($0.25/$0.50) - 2009/07/01 1:10:02 ET
Table '0eJtgVAXVvBgncFdcUpXcQ' 2-max Seat #1 is the button
Seat 1: Ag6DvxX4vbRheqsv2zXKTQ ($45.45 in chips)
Seat 2: KMc4R+K9ao4Ur3rF7NGe6Q ($9.15 in chips)
Ag6DvxX4vbRheqsv2zXKTQ: posts small blind $0.25
KMc4R+K9ao4Ur3rF7NGe6Q: posts big blind $0.50
*** HOLE CARDS ***
Ag6DvxX4vbRheqsv2zXKTQ: calls $0.25
KMc4R+K9ao4Ur3rF7NGe6Q: checks
*** FLOP *** [3s 6h 6s]
KMc4R+K9ao4Ur3rF7NGe6Q: checks
Ag6DvxX4vbRheqsv2zXKTQ: bets $1
KMc4R+K9ao4Ur3rF7NGe6Q: calls $1
*** TURN *** [3s 6h 6s] [Ah]
KMc4R+K9ao4Ur3rF7NGe6Q: checks
Ag6DvxX4vbRheqsv2zXKTQ: bets $1.50
KMc4R+K9ao4Ur3rF7NGe6Q: raises $2 to $3.50
Ag6DvxX4vbRheqsv2zXKTQ: calls $2
*** RIVER *** [3s 6h 6s Ah] [Qh]
KMc4R+K9ao4Ur3rF7NGe6Q: checks
Ag6DvxX4vbRheqsv2zXKTQ: checks
*** SHOW DOWN ***
KMc4R+K9ao4Ur3rF7NGe6Q: shows [7s 5d] (a pair of Sixes)
Ag6DvxX4vbRheqsv2zXKTQ: shows [9s Ad] (two pair, Aces and Sixes)
Ag6DvxX4vbRheqsv2zXKTQ collected $9.55 from pot
*** SUMMARY ***
Total pot $10 | Rake $0.45
Board [3s 6h 6s Ah Qh]
Seat 1: Ag6DvxX4vbRheqsv2zXKTQ (button) (small blind) showed [9s Ad] and won ($9.55) with two pair, Aces and Sixes
Seat 2: KMc4R+K9ao4Ur3rF7NGe6Q (big blind) showed [7s 5d] and lost with a pair of Sixes



PokerStars Game #59940559076:  Hold'em No Limit ($0.25/$0.50) - 2009/07/01 1:10:03 ET
Table 'tYh970kmVfYS0gXPT/XtoQ' 2-max Seat #1 is the button
Seat 1: CLj3pYZDnglQbP8AEHiYIw ($58.85 in chips)
Seat 2: fxN9bTdAgPNvNkHgbVXKGw ($10.50 in chips)
CLj3pYZDnglQbP8AEHiYIw: posts small blind $0.25
fxN9bTdAgPNvNkHgbVXKGw: posts big blind $0.50
*** HOLE CARDS ***
CLj3pYZDnglQbP8AEHiYIw: calls $0.25
fxN9bTdAgPNvNkHgbVXKGw: checks
*** FLOP *** [7s 9h 7h]
fxN9bTdAgPNvNkHgbVXKGw: checks
CLj3pYZDnglQbP8AEHiYIw: checks
*** TURN *** [7s 9h 7h] [Qh]
fxN9bTdAgPNvNkHgbVXKGw: checks
CLj3pYZDnglQbP8AEHiYIw: checks
*** RIVER *** [7s 9h 7h Qh] [Qd]
fxN9bTdAgPNvNkHgbVXKGw: bets $0.50
CLj3pYZDnglQbP8AEHiYIw: folds
fxN9bTdAgPNvNkHgbVXKGw collected $0.95 from pot
fxN9bTdAgPNvNkHgbVXKGw: doesn't show hand
*** SUMMARY ***
Total pot $1 | Rake $0.05
Board [7s 9h 7h Qh Qd]
Seat 1: CLj3pYZDnglQbP8AEHiYIw (button) (small blind) folded on the River
Seat 2: fxN9bTdAgPNvNkHgbVXKGw (big blind) collected ($0.95)



PokerStars Game #59940559438:  Hold'em No Limit ($0.25/$0.50) - 2009/07/01 1:10:04 ET
Table 'E7bWJ45aoFXRpyRv2gw+Ig' 2-max Seat #2 is the button
Seat 1: FRkiRasEGlHUeLrEl+k/nA ($50.75 in chips)
Seat 2: 3Wro85I7472vJ4Wkpneo9A ($143.90 in chips)
3Wro85I7472vJ4Wkpneo9A: posts small blind $0.25
FRkiRasEGlHUeLrEl+k/nA: posts big blind $0.50
*** HOLE CARDS ***
3Wro85I7472vJ4Wkpneo9A: raises $1 to $1.50
FRkiRasEGlHUeLrEl+k/nA: folds
3Wro85I7472vJ4Wkpneo9A collected $1 from pot
3Wro85I7472vJ4Wkpneo9A: doesn't show hand
*** SUMMARY ***
Total pot $1 | Rake $0
Seat 1: FRkiRasEGlHUeLrEl+k/nA (big blind) folded before Flop
Seat 2: 3Wro85I7472vJ4Wkpneo9A (button) (small blind) collected ($1)



PokerStars Game #59940559614:  Hold'em No Limit ($0.25/$0.50) - 2009/07/01 1:10:04 ET
Table 'QOgaEqMcJ73pcUMMxoisUg' 6-max Seat #2 is the button
Seat 1: lxIzoHy0RnkfFSODHC2liw ($50 in chips)
Seat 2: oqOqoO2AyCZenUghCxMDxw ($65 in chips)
Seat 3: Rt6KgtZ8YaJoTc3FPim00w ($53.25 in chips)
Seat 4: zAcsDhG/T128Vn7XGVSgKg ($60.65 in chips)
Seat 5: 6vNxrjjCl6FwfaaymM9jjg ($20.75 in chips)
Seat 6: AdS8BJMOheS01zjCDfPMFg ($50 in chips)
Rt6KgtZ8YaJoTc3FPim00w: posts small blind $0.25
zAcsDhG/T128Vn7XGVSgKg: posts big blind $0.50
*** HOLE CARDS ***
6vNxrjjCl6FwfaaymM9jjg: calls $0.50
AdS8BJMOheS01zjCDfPMFg: folds
lxIzoHy0RnkfFSODHC2liw: folds
oqOqoO2AyCZenUghCxMDxw: folds
Rt6KgtZ8YaJoTc3FPim00w: folds
zAcsDhG/T128Vn7XGVSgKg: checks
*** FLOP *** [4h 8d 9s]
zAcsDhG/T128Vn7XGVSgKg: checks
6vNxrjjCl6FwfaaymM9jjg: checks
*** TURN *** [4h 8d 9s] [Ac]
zAcsDhG/T128Vn7XGVSgKg: checks
6vNxrjjCl6FwfaaymM9jjg: bets $1.50
zAcsDhG/T128Vn7XGVSgKg: folds
6vNxrjjCl6FwfaaymM9jjg collected $1.20 from pot
*** SUMMARY ***
Total pot $1.25 | Rake $0.05
Board [4h 8d 9s Ac]
Seat 1: lxIzoHy0RnkfFSODHC2liw folded before Flop (didn't bet)
Seat 2: oqOqoO2AyCZenUghCxMDxw (button) folded before Flop (didn't bet)
Seat 3: Rt6KgtZ8YaJoTc3FPim00w (small blind) folded before Flop
Seat 4: zAcsDhG/T128Vn7XGVSgKg (big blind) folded on the Turn
Seat 5: 6vNxrjjCl6FwfaaymM9jjg collected ($1.20)
Seat 6: AdS8BJMOheS01zjCDfPMFg folded before Flop (didn't bet)



PokerStars Game #59940561174:  Hold'em No Limit ($0.25/$0.50) - 2009/07/01 1:10:07 ET
Table 'fx6MqwfYAj/Rt86hBz2L3Q' 9-max Seat #7 is the button
Seat 1: uw9QayAAxLM3Hb+HR7mSkg ($10.50 in chips)
Seat 2: C3rGXblctNcWI6JYPHhaEg ($34.35 in chips)
Seat 3: iadBi5AEt7gTBXbDSSnMYQ ($48.80 in chips)
Seat 5: iAISe3dVeua8PUn2wwgDHw ($66 in chips)
Seat 6: 5k9fvXD9suIgCxU4HLQjTw ($50 in chips)
Seat 7: SKnJuWHScqetA/qG5p+wCg ($30 in chips)
Seat 8: JYwJYYV9pM5KWdSiETl8rA ($30 in chips)
JYwJYYV9pM5KWdSiETl8rA: posts small blind $0.25
HZkVla4kK2SI42CVrPZ/ig: is sitting out
uw9QayAAxLM3Hb+HR7mSkg: posts big blind $0.50
*** HOLE CARDS ***
C3rGXblctNcWI6JYPHhaEg: raises $0.50 to $1
iadBi5AEt7gTBXbDSSnMYQ: folds
HZkVla4kK2SI42CVrPZ/ig leaves the table
iAISe3dVeua8PUn2wwgDHw: folds
5k9fvXD9suIgCxU4HLQjTw: folds
SKnJuWHScqetA/qG5p+wCg: calls $1
JYwJYYV9pM5KWdSiETl8rA: folds
uw9QayAAxLM3Hb+HR7mSkg: folds
*** FLOP *** [5c Qs 7s]
C3rGXblctNcWI6JYPHhaEg: bets $1.35
SKnJuWHScqetA/qG5p+wCg: folds
C3rGXblctNcWI6JYPHhaEg collected $2.65 from pot
*** SUMMARY ***
Total pot $2.75 | Rake $0.10
Board [5c Qs 7s]
Seat 1: uw9QayAAxLM3Hb+HR7mSkg (big blind) folded before Flop
Seat 2: C3rGXblctNcWI6JYPHhaEg collected ($2.65)
Seat 3: iadBi5AEt7gTBXbDSSnMYQ folded before Flop (didn't bet)
Seat 5: iAISe3dVeua8PUn2wwgDHw folded before Flop (didn't bet)
Seat 6: 5k9fvXD9suIgCxU4HLQjTw folded before Flop (didn't bet)
Seat 7: SKnJuWHScqetA/qG5p+wCg (button) folded on the Flop
Seat 8: JYwJYYV9pM5KWdSiETl8rA (small blind) folded before Flop



PokerStars Game #59940561872:  Hold'em No Limit ($0.25/$0.50) - 2009/07/01 1:10:08 ET
Table 'GfL/No5u5PoEnU39lP5pQg' 6-max Seat #5 is the button
Seat 1: 1WUCqNG+p+vfWRTXNu4ljw ($65.25 in chips)
Seat 2: uVwggSetzp7d+eVgowO3vg ($55 in chips)
Seat 4: r6u7MWSXF30/khcTYkrG9Q ($36.10 in chips)
Seat 5: M1KyQQvVPVuxqTAB8sR/zQ ($50.85 in chips)
Seat 6: kxPhs4ePFqMy52CInAJ2aw ($50.35 in chips)
kxPhs4ePFqMy52CInAJ2aw: posts small blind $0.25
1WUCqNG+p+vfWRTXNu4ljw: posts big blind $0.50
4pp9WxhGdbVbxCc9tlu0lw: sits out
*** HOLE CARDS ***
uVwggSetzp7d+eVgowO3vg: calls $0.50
r6u7MWSXF30/khcTYkrG9Q: folds
M1KyQQvVPVuxqTAB8sR/zQ: raises $1.50 to $2
kxPhs4ePFqMy52CInAJ2aw: folds
1WUCqNG+p+vfWRTXNu4ljw: folds
uVwggSetzp7d+eVgowO3vg: calls $1.50
*** FLOP *** [5d Ac Qs]
uVwggSetzp7d+eVgowO3vg: checks
M1KyQQvVPVuxqTAB8sR/zQ: bets $3.25
uVwggSetzp7d+eVgowO3vg: folds
M1KyQQvVPVuxqTAB8sR/zQ collected $4.55 from pot
M1KyQQvVPVuxqTAB8sR/zQ: doesn't show hand
*** SUMMARY ***
Total pot $4.75 | Rake $0.20
Board [5d Ac Qs]
Seat 1: 1WUCqNG+p+vfWRTXNu4ljw (big blind) folded before Flop
Seat 2: uVwggSetzp7d+eVgowO3vg folded on the Flop
Seat 4: r6u7MWSXF30/khcTYkrG9Q folded before Flop (didn't bet)
Seat 5: M1KyQQvVPVuxqTAB8sR/zQ (button) collected ($4.55)
Seat 6: kxPhs4ePFqMy52CInAJ2aw (small blind) folded before Flop



PokerStars Game #59940562508:  Hold'em No Limit ($0.25/$0.50) - 2009/07/01 1:10:09 ET
Table 'hSTs/dUsYLgJQuF2Onp0MQ' 6-max Seat #6 is the button
Seat 1: 1WUCqNG+p+vfWRTXNu4ljw ($50.25 in chips)
Seat 2: 6vNxrjjCl6FwfaaymM9jjg ($35.75 in chips)
Seat 3: C3qJBo7uxfFVDluE1lmK2w ($52.60 in chips)
Seat 4: L0aIPg7qefDQjdJo3HCVEA ($10.05 in chips)
Seat 5: 686aeHikcJlgKkSuIFdcXQ ($57.15 in chips)
Seat 6: M1KyQQvVPVuxqTAB8sR/zQ ($79.65 in chips)
1WUCqNG+p+vfWRTXNu4ljw: posts small blind $0.25
6vNxrjjCl6FwfaaymM9jjg: posts big blind $0.50
*** HOLE CARDS ***
C3qJBo7uxfFVDluE1lmK2w: folds
L0aIPg7qefDQjdJo3HCVEA: folds
686aeHikcJlgKkSuIFdcXQ: folds
M1KyQQvVPVuxqTAB8sR/zQ: folds
1WUCqNG+p+vfWRTXNu4ljw: folds
6vNxrjjCl6FwfaaymM9jjg collected $0.50 from pot
6vNxrjjCl6FwfaaymM9jjg: doesn't show hand
*** SUMMARY ***
Total pot $0.50 | Rake $0
Seat 1: 1WUCqNG+p+vfWRTXNu4ljw (small blind) folded before Flop
Seat 2: 6vNxrjjCl6FwfaaymM9jjg (big blind) collected ($0.50)
Seat 3: C3qJBo7uxfFVDluE1lmK2w folded before Flop (didn't bet)
Seat 4: L0aIPg7qefDQjdJo3HCVEA folded before Flop (didn't bet)
Seat 5: 686aeHikcJlgKkSuIFdcXQ folded before Flop (didn't bet)
Seat 6: M1KyQQvVPVuxqTAB8sR/zQ (button) folded before Flop (didn't bet)



PokerStars Game #59940562104:  Hold'em No Limit ($0.25/$0.50) - 2009/07/01 1:10:09 ET
Table '+dXkOAQyS8j9PQZusUTMpg' 2-max Seat #1 is the button
Seat 1: XFa6sBGjP2gxoIvxR3fZIg ($119.80 in chips)
Seat 2: 5IBeOgaApY1Bvzv2P8X4EA ($75.45 in chips)
XFa6sBGjP2gxoIvxR3fZIg: posts small blind $0.25
5IBeOgaApY1Bvzv2P8X4EA: posts big blind $0.50
*** HOLE CARDS ***
XFa6sBGjP2gxoIvxR3fZIg: raises $1 to $1.50
5IBeOgaApY1Bvzv2P8X4EA: calls $1
*** FLOP *** [8d Qc 6c]
5IBeOgaApY1Bvzv2P8X4EA: checks
XFa6sBGjP2gxoIvxR3fZIg: checks
*** TURN *** [8d Qc 6c] [3d]
5IBeOgaApY1Bvzv2P8X4EA: bets $1.50
XFa6sBGjP2gxoIvxR3fZIg: folds
5IBeOgaApY1Bvzv2P8X4EA collected $2.85 from pot
5IBeOgaApY1Bvzv2P8X4EA: doesn't show hand
*** SUMMARY ***
Total pot $3 | Rake $0.15
Board [8d Qc 6c 3d]
Seat 1: XFa6sBGjP2gxoIvxR3fZIg (button) (small blind) folded on the Turn
Seat 2: 5IBeOgaApY1Bvzv2P8X4EA (big blind) collected ($2.85)



PokerStars Game #59940564194:  Hold'em No Limit ($0.25/$0.50) - 2009/07/01 1:10:12 ET
Table 'E7bWJ45aoFXRpyRv2gw+Ig' 2-max Seat #1 is the button
Seat 1: FRkiRasEGlHUeLrEl+k/nA ($50.25 in chips)
Seat 2: 3Wro85I7472vJ4Wkpneo9A ($144.40 in chips)
FRkiRasEGlHUeLrEl+k/nA: posts small blind $0.25
3Wro85I7472vJ4Wkpneo9A: posts big blind $0.50
*** HOLE CARDS ***
FRkiRasEGlHUeLrEl+k/nA: folds
3Wro85I7472vJ4Wkpneo9A collected $0.50 from pot
3Wro85I7472vJ4Wkpneo9A: doesn't show hand
*** SUMMARY ***
Total pot $0.50 | Rake $0
Seat 1: FRkiRasEGlHUeLrEl+k/nA (button) (small blind) folded before Flop
Seat 2: 3Wro85I7472vJ4Wkpneo9A (big blind) collected ($0.50)



PokerStars Game #59940564134:  Hold'em No Limit ($0.25/$0.50) - 2009/07/01 1:10:12 ET
Table 'EiNh8p/wGJ1FP575iMFnqg' 9-max Seat #4 is the button
Seat 1: r3ZqM1Mi0W3y4hOdssE+Sg ($50.75 in chips)
Seat 2: 8ehL7qlZzjgUh2H35iiWLw ($54.15 in chips)
Seat 3: ymLPoEIl7UL3TvZYmnadxQ ($58.90 in chips)
Seat 4: cMzaiXAM/ZAdNaEUu+LqhA ($54.20 in chips)
Seat 5: M+7+BTmX5vZatHVuoRB1nA ($79.95 in chips)
Seat 6: 3UmXLy3GfjC3EkOebduerQ ($61.60 in chips)
Seat 7: 997ViqAtWn1FPjJqcffwcA ($50 in chips)
Seat 8: mSD1pginDsyHG5PDfqzphw ($10 in chips)
M+7+BTmX5vZatHVuoRB1nA: posts small blind $0.25
3UmXLy3GfjC3EkOebduerQ: posts big blind $0.50
*** HOLE CARDS ***
997ViqAtWn1FPjJqcffwcA: folds
GuPkZObrz5Zkkn8FsEdF9w joins the table at seat #9
mSD1pginDsyHG5PDfqzphw: folds
r3ZqM1Mi0W3y4hOdssE+Sg: raises $1.50 to $2
8ehL7qlZzjgUh2H35iiWLw: folds
ymLPoEIl7UL3TvZYmnadxQ: folds
cMzaiXAM/ZAdNaEUu+LqhA: calls $2
M+7+BTmX5vZatHVuoRB1nA: folds
3UmXLy3GfjC3EkOebduerQ: folds
*** FLOP *** [5d 3d 3c]
r3ZqM1Mi0W3y4hOdssE+Sg: bets $3.50
cMzaiXAM/ZAdNaEUu+LqhA: calls $3.50
*** TURN *** [5d 3d 3c] [Ks]
r3ZqM1Mi0W3y4hOdssE+Sg: checks
cMzaiXAM/ZAdNaEUu+LqhA: checks
*** RIVER *** [5d 3d 3c Ks] [3h]
r3ZqM1Mi0W3y4hOdssE+Sg: bets $12
cMzaiXAM/ZAdNaEUu+LqhA: calls $12
*** SHOW DOWN ***
r3ZqM1Mi0W3y4hOdssE+Sg: shows [Ad Ah] (a full house, Threes full of Aces)
cMzaiXAM/ZAdNaEUu+LqhA: mucks hand
r3ZqM1Mi0W3y4hOdssE+Sg collected $34 from pot
*** SUMMARY ***
Total pot $35.75 | Rake $1.75
Board [5d 3d 3c Ks 3h]
Seat 1: r3ZqM1Mi0W3y4hOdssE+Sg showed [Ad Ah] and won ($34) with a full house, Threes full of Aces
Seat 2: 8ehL7qlZzjgUh2H35iiWLw folded before Flop (didn't bet)
Seat 3: ymLPoEIl7UL3TvZYmnadxQ folded before Flop (didn't bet)
Seat 4: cMzaiXAM/ZAdNaEUu+LqhA (button) mucked
Seat 5: M+7+BTmX5vZatHVuoRB1nA (small blind) folded before Flop
Seat 6: 3UmXLy3GfjC3EkOebduerQ (big blind) folded before Flop
Seat 7: 997ViqAtWn1FPjJqcffwcA folded before Flop (didn't bet)
Seat 8: mSD1pginDsyHG5PDfqzphw folded before Flop (didn't bet)



PokerStars Game #59940566378:  Hold'em No Limit ($0.25/$0.50) - 2009/07/01 1:10:16 ET
Table '5EmHi+fnatGQQShcNmzOZQ' 6-max Seat #2 is the button
Seat 1: My8WkRtGx5FW6rJ1I4R3hg ($49.35 in chips)
Seat 2: bfFjgAtIoAI+pUxUwFt3aQ ($38.60 in chips)
Seat 3: 1mYbhL8CU/QYqfVmFcaHDQ ($7.50 in chips)
Seat 4: 1b+2BbjMN8qhR1WPqdE9VQ ($50 in chips)
Seat 5: kxPhs4ePFqMy52CInAJ2aw ($93.85 in chips)
Seat 6: 686aeHikcJlgKkSuIFdcXQ ($134.85 in chips)
1mYbhL8CU/QYqfVmFcaHDQ: posts small blind $0.25
1b+2BbjMN8qhR1WPqdE9VQ: posts big blind $0.50
*** HOLE CARDS ***
kxPhs4ePFqMy52CInAJ2aw: folds
686aeHikcJlgKkSuIFdcXQ: folds
My8WkRtGx5FW6rJ1I4R3hg: folds
bfFjgAtIoAI+pUxUwFt3aQ: folds
1mYbhL8CU/QYqfVmFcaHDQ: raises $0.50 to $1
1b+2BbjMN8qhR1WPqdE9VQ: folds
1mYbhL8CU/QYqfVmFcaHDQ collected $1 from pot
1mYbhL8CU/QYqfVmFcaHDQ: doesn't show hand
*** SUMMARY ***
Total pot $1 | Rake $0
Seat 1: My8WkRtGx5FW6rJ1I4R3hg folded before Flop (didn't bet)
Seat 2: bfFjgAtIoAI+pUxUwFt3aQ (button) folded before Flop (didn't bet)
Seat 3: 1mYbhL8CU/QYqfVmFcaHDQ (small blind) collected ($1)
Seat 4: 1b+2BbjMN8qhR1WPqdE9VQ (big blind) folded before Flop
Seat 5: kxPhs4ePFqMy52CInAJ2aw folded before Flop (didn't bet)
Seat 6: 686aeHikcJlgKkSuIFdcXQ folded before Flop (didn't bet)



PokerStars Game #59940566654:  Hold'em No Limit ($0.25/$0.50) - 2009/07/01 1:10:16 ET
Table '37qXEp3oe+er5q4CZip9eQ' 6-max Seat #2 is the button
Seat 1: lxIzoHy0RnkfFSODHC2liw ($50 in chips)
Seat 2: LvH4G7n+QSjT6NDaD3cREA ($54.30 in chips)
Seat 3: Rt6KgtZ8YaJoTc3FPim00w ($109.70 in chips)
Seat 4: XsmE8nXMAAMFJbWaJTmHFw ($48.95 in chips)
Seat 5: VOmI0x4dDPnTESZd5B4d1Q ($42.50 in chips)
Seat 6: N50kln4negd8q7Mmoz1j4g ($10.05 in chips)
Rt6KgtZ8YaJoTc3FPim00w: posts small blind $0.25
XsmE8nXMAAMFJbWaJTmHFw: posts big blind $0.50
*** HOLE CARDS ***
VOmI0x4dDPnTESZd5B4d1Q: folds
N50kln4negd8q7Mmoz1j4g: folds
lxIzoHy0RnkfFSODHC2liw: folds
LvH4G7n+QSjT6NDaD3cREA: raises $1.50 to $2
Rt6KgtZ8YaJoTc3FPim00w: folds
XsmE8nXMAAMFJbWaJTmHFw: folds
LvH4G7n+QSjT6NDaD3cREA collected $1.25 from pot
*** SUMMARY ***
Total pot $1.25 | Rake $0
Seat 1: lxIzoHy0RnkfFSODHC2liw folded before Flop (didn't bet)
Seat 2: LvH4G7n+QSjT6NDaD3cREA (button) collected ($1.25)
Seat 3: Rt6KgtZ8YaJoTc3FPim00w (small blind) folded before Flop
Seat 4: XsmE8nXMAAMFJbWaJTmHFw (big blind) folded before Flop
Seat 5: VOmI0x4dDPnTESZd5B4d1Q folded before Flop (didn't bet)
Seat 6: N50kln4negd8q7Mmoz1j4g folded before Flop (didn't bet)



PokerStars Game #59940566544:  Hold'em No Limit ($0.25/$0.50) - 2009/07/01 1:10:16 ET
Table 'ibNfFy0bCzuBaUORla0aGw' 9-max Seat #5 is the button
Seat 1: xZCXQSXlrZkp3pZizzVXCw ($50.55 in chips)
Seat 2: 90Wb75h3W1BRpbqVnuk8gw ($53.50 in chips)
Seat 3: AjV5McH1KMMclY26QdLM5w ($25 in chips)
Seat 4: YBN054X4blmis+B2bBlC0g ($22.65 in chips)
Seat 5: GIJAc9kPrLZHLSX8Q6i99w ($21.70 in chips)
Seat 6: H8cPaCtX7d6meGUVSM5sxw ($49 in chips)
Seat 7: HZkVla4kK2SI42CVrPZ/ig ($14.50 in chips)
Seat 8: 2CfOMUqXsQk69Igusq28Pg ($12.35 in chips)
Seat 9: pFtzb1sR4b0d1aw6aIRgDg ($50.05 in chips)
H8cPaCtX7d6meGUVSM5sxw: posts small blind $0.25
HZkVla4kK2SI42CVrPZ/ig: posts big blind $0.50
*** HOLE CARDS ***
2CfOMUqXsQk69Igusq28Pg: folds
pFtzb1sR4b0d1aw6aIRgDg: calls $0.50
xZCXQSXlrZkp3pZizzVXCw: folds
90Wb75h3W1BRpbqVnuk8gw: raises $2 to $2.50
AjV5McH1KMMclY26QdLM5w: folds
YBN054X4blmis+B2bBlC0g: folds
GIJAc9kPrLZHLSX8Q6i99w: folds
H8cPaCtX7d6meGUVSM5sxw: folds
HZkVla4kK2SI42CVrPZ/ig: folds
pFtzb1sR4b0d1aw6aIRgDg: calls $2
*** FLOP *** [6h 5h Qh]
pFtzb1sR4b0d1aw6aIRgDg: checks
90Wb75h3W1BRpbqVnuk8gw: checks
*** TURN *** [6h 5h Qh] [8h]
pFtzb1sR4b0d1aw6aIRgDg: checks
90Wb75h3W1BRpbqVnuk8gw: bets $3
pFtzb1sR4b0d1aw6aIRgDg: calls $3
*** RIVER *** [6h 5h Qh 8h] [Ks]
pFtzb1sR4b0d1aw6aIRgDg: checks
90Wb75h3W1BRpbqVnuk8gw: checks
*** SHOW DOWN ***
pFtzb1sR4b0d1aw6aIRgDg: shows [6c 6d] (three of a kind, Sixes)
90Wb75h3W1BRpbqVnuk8gw: mucks hand
pFtzb1sR4b0d1aw6aIRgDg collected $11.20 from pot
*** SUMMARY ***
Total pot $11.75 | Rake $0.55
Board [6h 5h Qh 8h Ks]
Seat 1: xZCXQSXlrZkp3pZizzVXCw folded before Flop (didn't bet)
Seat 2: 90Wb75h3W1BRpbqVnuk8gw mucked
Seat 3: AjV5McH1KMMclY26QdLM5w folded before Flop (didn't bet)
Seat 4: YBN054X4blmis+B2bBlC0g folded before Flop (didn't bet)
Seat 5: GIJAc9kPrLZHLSX8Q6i99w (button) folded before Flop (didn't bet)
Seat 6: H8cPaCtX7d6meGUVSM5sxw (small blind) folded before Flop
Seat 7: HZkVla4kK2SI42CVrPZ/ig (big blind) folded before Flop
Seat 8: 2CfOMUqXsQk69Igusq28Pg folded before Flop (didn't bet)
Seat 9: pFtzb1sR4b0d1aw6aIRgDg showed [6c 6d] and won ($11.20) with three of a kind, Sixes



PokerStars Game #59940566892:  Hold'em No Limit ($0.25/$0.50) - 2009/07/01 1:10:17 ET
Table 'ZYI3ZReBjdfKEYItkZHI6A' 9-max Seat #6 is the button
Seat 1: E2518gp4aFz1+kAgmGqeEg ($17.50 in chips)
Seat 2: 8zdVaT8pZ/Wm0uWoeLhtZg ($5.45 in chips)
Seat 3: bkXkL3pmapikPQQRNPZSEA ($19.65 in chips)
Seat 4: e2+sK/yjnj94rXOKoxPP2A ($50 in chips)
Seat 5: ApHP7ouup365XIUFBdEDxg ($45 in chips)
Seat 6: Wj7mKnRFR90j40wWUu2+Og ($36.55 in chips)
Seat 7: HWcfp1hY1hqvrddzW3/FQw ($12 in chips)
Seat 8: ji04uOybxCdpdefzlUQeKQ ($28.75 in chips)
HWcfp1hY1hqvrddzW3/FQw: posts small blind $0.25
ji04uOybxCdpdefzlUQeKQ: posts big blind $0.50
*** HOLE CARDS ***
E2518gp4aFz1+kAgmGqeEg: calls $0.50
8zdVaT8pZ/Wm0uWoeLhtZg: raises $1 to $1.50
bkXkL3pmapikPQQRNPZSEA: folds
e2+sK/yjnj94rXOKoxPP2A: folds
ApHP7ouup365XIUFBdEDxg: folds
Wj7mKnRFR90j40wWUu2+Og: folds
HWcfp1hY1hqvrddzW3/FQw: calls $1.25
ji04uOybxCdpdefzlUQeKQ: folds
E2518gp4aFz1+kAgmGqeEg: raises $16 to $17.50 and is all-in
8zdVaT8pZ/Wm0uWoeLhtZg: calls $3.95 and is all-in
HWcfp1hY1hqvrddzW3/FQw: folds
*** FLOP *** [7d Td 5h]
*** TURN *** [7d Td 5h] [Kc]
*** RIVER *** [7d Td 5h Kc] [2d]
*** SHOW DOWN ***
E2518gp4aFz1+kAgmGqeEg: shows [Kd Kh] (three of a kind, Kings)
8zdVaT8pZ/Wm0uWoeLhtZg: mucks hand
E2518gp4aFz1+kAgmGqeEg collected $12.30 from pot
E2518gp4aFz1+kAgmGqeEg is sitting out
*** SUMMARY ***
Total pot $12.90 | Rake $0.60
Board [7d Td 5h Kc 2d]
Seat 1: E2518gp4aFz1+kAgmGqeEg showed [Kd Kh] and won ($12.30) with three of a kind, Kings
Seat 2: 8zdVaT8pZ/Wm0uWoeLhtZg mucked
Seat 3: bkXkL3pmapikPQQRNPZSEA folded before Flop (didn't bet)
Seat 4: e2+sK/yjnj94rXOKoxPP2A folded before Flop (didn't bet)
Seat 5: ApHP7ouup365XIUFBdEDxg folded before Flop (didn't bet)
Seat 6: Wj7mKnRFR90j40wWUu2+Og (button) folded before Flop (didn't bet)
Seat 7: HWcfp1hY1hqvrddzW3/FQw (small blind) folded before Flop
Seat 8: ji04uOybxCdpdefzlUQeKQ (big blind) folded before Flop



PokerStars Game #59940567854:  Hold'em No Limit ($0.25/$0.50) - 2009/07/01 1:10:18 ET
Table 'E7bWJ45aoFXRpyRv2gw+Ig' 2-max Seat #2 is the button
Seat 1: FRkiRasEGlHUeLrEl+k/nA ($50 in chips)
Seat 2: 3Wro85I7472vJ4Wkpneo9A ($144.65 in chips)
3Wro85I7472vJ4Wkpneo9A: posts small blind $0.25
FRkiRasEGlHUeLrEl+k/nA: posts big blind $0.50
*** HOLE CARDS ***
3Wro85I7472vJ4Wkpneo9A: raises $1 to $1.50
FRkiRasEGlHUeLrEl+k/nA: folds
3Wro85I7472vJ4Wkpneo9A collected $1 from pot
3Wro85I7472vJ4Wkpneo9A: doesn't show hand
*** SUMMARY ***
Total pot $1 | Rake $0
Seat 1: FRkiRasEGlHUeLrEl+k/nA (big blind) folded before Flop
Seat 2: 3Wro85I7472vJ4Wkpneo9A (button) (small blind) collected ($1)



PokerStars Game #59940567792:  Hold'em No Limit ($0.25/$0.50) - 2009/07/01 1:10:18 ET
Table 'WlCrrUP9MxwySQN5fzLFBQ' 2-max Seat #1 is the button
Seat 1: AMDFA0ajpsTPOIGjeT0g0Q ($50 in chips)
Seat 2: I6jT30IIGKfk3BWwujd6WQ ($50 in chips)
AMDFA0ajpsTPOIGjeT0g0Q: posts small blind $0.25
I6jT30IIGKfk3BWwujd6WQ: posts big blind $0.50
*** HOLE CARDS ***
AMDFA0ajpsTPOIGjeT0g0Q: raises $1 to $1.50
I6jT30IIGKfk3BWwujd6WQ: calls $1
*** FLOP *** [Ts 2s Th]
I6jT30IIGKfk3BWwujd6WQ: checks
AMDFA0ajpsTPOIGjeT0g0Q: bets $2
I6jT30IIGKfk3BWwujd6WQ: folds
AMDFA0ajpsTPOIGjeT0g0Q collected $2.85 from pot
AMDFA0ajpsTPOIGjeT0g0Q: doesn't show hand
*** SUMMARY ***
Total pot $3 | Rake $0.15
Board [Ts 2s Th]
Seat 1: AMDFA0ajpsTPOIGjeT0g0Q (button) (small blind) collected ($2.85)
Seat 2: I6jT30IIGKfk3BWwujd6WQ (big blind) folded on the Flop



PokerStars Game #59940568010:  Hold'em No Limit ($0.25/$0.50) - 2009/07/01 1:10:19 ET
Table 'otvGDROEDdqsabxskT79qg' 9-max Seat #7 is the button
Seat 1: 8ehL7qlZzjgUh2H35iiWLw ($59.75 in chips)
Seat 2: cCjTzH9jio8607WzjcfXlg ($13.20 in chips)
Seat 3: +k7T5ocke8UwavtgUHm+Cg ($70.60 in chips)
Seat 4: MG90wfSJZnOejs/KD3vlQQ ($75.90 in chips)
Seat 5: E2518gp4aFz1+kAgmGqeEg ($11.75 in chips)
Seat 6: bxLSulbgr8LmKNjOzw8URg ($55.25 in chips)
Seat 7: 75K2MXwN65Sjfp1yHd50Hg ($9.25 in chips)
Seat 8: zE9cVigS2nW/Ljy4K4bUQA ($30 in chips)
Seat 9: KcY3X8YpD74Kw1RHkx/g4A ($47.90 in chips)
zE9cVigS2nW/Ljy4K4bUQA: posts small blind $0.25
KcY3X8YpD74Kw1RHkx/g4A: posts big blind $0.50
*** HOLE CARDS ***
8ehL7qlZzjgUh2H35iiWLw: folds
cCjTzH9jio8607WzjcfXlg: folds
+k7T5ocke8UwavtgUHm+Cg: folds
MG90wfSJZnOejs/KD3vlQQ: folds
E2518gp4aFz1+kAgmGqeEg: folds
bxLSulbgr8LmKNjOzw8URg: raises $1 to $1.50
75K2MXwN65Sjfp1yHd50Hg: folds
zE9cVigS2nW/Ljy4K4bUQA: folds
KcY3X8YpD74Kw1RHkx/g4A: folds
bxLSulbgr8LmKNjOzw8URg collected $1.25 from pot
bxLSulbgr8LmKNjOzw8URg: doesn't show hand
*** SUMMARY ***
Total pot $1.25 | Rake $0
Seat 1: 8ehL7qlZzjgUh2H35iiWLw folded before Flop (didn't bet)
Seat 2: cCjTzH9jio8607WzjcfXlg folded before Flop (didn't bet)
Seat 3: +k7T5ocke8UwavtgUHm+Cg folded before Flop (didn't bet)
Seat 4: MG90wfSJZnOejs/KD3vlQQ folded before Flop (didn't bet)
Seat 5: E2518gp4aFz1+kAgmGqeEg folded before Flop (didn't bet)
Seat 6: bxLSulbgr8LmKNjOzw8URg collected ($1.25)
Seat 7: 75K2MXwN65Sjfp1yHd50Hg (button) folded before Flop (didn't bet)
Seat 8: zE9cVigS2nW/Ljy4K4bUQA (small blind) folded before Flop
Seat 9: KcY3X8YpD74Kw1RHkx/g4A (big blind) folded before Flop



PokerStars Game #59940569158:  Hold'em No Limit ($0.25/$0.50) - 2009/07/01 1:10:20 ET
Table 'tYh970kmVfYS0gXPT/XtoQ' 2-max Seat #2 is the button
Seat 1: CLj3pYZDnglQbP8AEHiYIw ($58.35 in chips)
Seat 2: fxN9bTdAgPNvNkHgbVXKGw ($10.95 in chips)
fxN9bTdAgPNvNkHgbVXKGw: posts small blind $0.25
CLj3pYZDnglQbP8AEHiYIw: posts big blind $0.50
*** HOLE CARDS ***
fxN9bTdAgPNvNkHgbVXKGw: calls $0.25
CLj3pYZDnglQbP8AEHiYIw: checks
*** FLOP *** [9h 7c Tc]
CLj3pYZDnglQbP8AEHiYIw: checks
fxN9bTdAgPNvNkHgbVXKGw: checks
*** TURN *** [9h 7c Tc] [2h]
CLj3pYZDnglQbP8AEHiYIw: checks
fxN9bTdAgPNvNkHgbVXKGw: bets $0.50
CLj3pYZDnglQbP8AEHiYIw: folds
fxN9bTdAgPNvNkHgbVXKGw collected $0.95 from pot
fxN9bTdAgPNvNkHgbVXKGw: doesn't show hand
*** SUMMARY ***
Total pot $1 | Rake $0.05
Board [9h 7c Tc 2h]
Seat 1: CLj3pYZDnglQbP8AEHiYIw (big blind) folded on the Turn
Seat 2: fxN9bTdAgPNvNkHgbVXKGw (button) (small blind) collected ($0.95)



PokerStars Game #59940570058:  Hold'em No Limit ($0.25/$0.50) - 2009/07/01 1:10:22 ET
Table 'ErOuyGLI5PT3G5MnpHgC/gQOgaEqMcJ73pcUMMxoisUg Seat #7 is the button
Seat 2: pciZn00ZDk4BVBMTTMcNVQ ($28 in chips)
Seat 3: xZCXQSXlrZkp3pZizzVXCw ($50.50 in chips)
Seat 4: 3UmXLy3GfjC3EkOebduerQ ($50 in chips)
Seat 5: JwvquocWfhTVApN5t47LgA ($64.60 in chips)
Seat 6: zE9cVigS2nW/Ljy4K4bUQA ($31.60 in chips)
Seat 7: 90Wb75h3W1BRpbqVnuk8gw ($64.95 in chips)
Seat 8: g4k0NXISyLCqaSWZDBjfEg ($50.25 in chips)
Seat 9: J0W5D97jl5VLky+IoPvDeA ($52.35 in chips)
g4k0NXISyLCqaSWZDBjfEg: posts small blind $0.25
J0W5D97jl5VLky+IoPvDeA: posts big blind $0.50
eBrej2jnlUCs/JgxFCRn2g: sits out
*** HOLE CARDS ***
pciZn00ZDk4BVBMTTMcNVQ: folds
xZCXQSXlrZkp3pZizzVXCw: folds
3UmXLy3GfjC3EkOebduerQ: folds
JwvquocWfhTVApN5t47LgA: folds
zE9cVigS2nW/Ljy4K4bUQA: folds
90Wb75h3W1BRpbqVnuk8gw: folds
g4k0NXISyLCqaSWZDBjfEg: folds
J0W5D97jl5VLky+IoPvDeA collected $0.50 from pot
*** SUMMARY ***
Total pot $0.50 | Rake $0
Seat 2: pciZn00ZDk4BVBMTTMcNVQ folded before Flop (didn't bet)
Seat 3: xZCXQSXlrZkp3pZizzVXCw folded before Flop (didn't bet)
Seat 4: 3UmXLy3GfjC3EkOebduerQ folded before Flop (didn't bet)
Seat 5: JwvquocWfhTVApN5t47LgA folded before Flop (didn't bet)
Seat 6: zE9cVigS2nW/Ljy4K4bUQA folded before Flop (didn't bet)
Seat 7: 90Wb75h3W1BRpbqVnuk8gw (button) folded before Flop (didn't bet)
Seat 8: g4k0NXISyLCqaSWZDBjfEg (small blind) folded before Flop
Seat 9: J0W5D97jl5VLky+IoPvDeA (big blind) collected ($0.50)



PokerStars Game #59940570702:  Hold'em No Limit ($0.25/$0.50) - 2009/07/01 1:10:23 ET
Table 'c/CRn+68J3Y8KxD5g1ek2Q' 2-max Seat #1 is the button
Seat 1: 46qCyJ6evTkHo9al5sBMNA ($88.60 in chips)
Seat 2: BypVLsYQt3ePFm2xQL/dOA ($276.40 in chips)
46qCyJ6evTkHo9al5sBMNA: posts small blind $0.25
BypVLsYQt3ePFm2xQL/dOA: posts big blind $0.50
*** HOLE CARDS ***
46qCyJ6evTkHo9al5sBMNA: raises $1.50 to $2
BypVLsYQt3ePFm2xQL/dOA: calls $1.50
*** FLOP *** [2c 9s Td]
BypVLsYQt3ePFm2xQL/dOA: checks
46qCyJ6evTkHo9al5sBMNA: checks
*** TURN *** [2c 9s Td] [5d]
BypVLsYQt3ePFm2xQL/dOA: checks
46qCyJ6evTkHo9al5sBMNA: checks
*** RIVER *** [2c 9s Td 5d] [9d]
BypVLsYQt3ePFm2xQL/dOA: bets $5.50
46qCyJ6evTkHo9al5sBMNA: raises $11.50 to $17
BypVLsYQt3ePFm2xQL/dOA: calls $11.50
*** SHOW DOWN ***
46qCyJ6evTkHo9al5sBMNA: shows [Kd Ad] (a flush, Ace high)
BypVLsYQt3ePFm2xQL/dOA: mucks hand
46qCyJ6evTkHo9al5sBMNA collected $37.50 from pot
*** SUMMARY ***
Total pot $38 | Rake $0.50
Board [2c 9s Td 5d 9d]
Seat 1: 46qCyJ6evTkHo9al5sBMNA (button) (small blind) showed [Kd Ad] and won ($37.50) with a flush, Ace high
Seat 2: BypVLsYQt3ePFm2xQL/dOA (big blind) mucked



PokerStars Game #59940570820:  Hold'em No Limit ($0.25/$0.50) - 2009/07/01 1:10:23 ET
Table '8BQGgNetI1NOvWeu3gtMNw' 2-max Seat #2 is the button
Seat 1: bypIyrYcAAifLfhZpGlKLA ($108.05 in chips)
Seat 2: Z4HwehErEwzsv/noQlfUlg ($89.25 in chips)
Z4HwehErEwzsv/noQlfUlg: posts small blind $0.25
bypIyrYcAAifLfhZpGlKLA: posts big blind $0.50
*** HOLE CARDS ***
Z4HwehErEwzsv/noQlfUlg: raises $3.50 to $4
bypIyrYcAAifLfhZpGlKLA: folds
Z4HwehErEwzsv/noQlfUlg collected $1 from pot
Z4HwehErEwzsv/noQlfUlg: doesn't show hand
*** SUMMARY ***
Total pot $1 | Rake $0
Seat 1: bypIyrYcAAifLfhZpGlKLA (big blind) folded before Flop
Seat 2: Z4HwehErEwzsv/noQlfUlg (button) (small blind) collected ($1)



PokerStars Game #59940571274:  Hold'em No Limit ($0.25/$0.50) - 2009/07/01 1:10:24 ET
Table '+dXkOAQyS8j9PQZusUTMpg' 2-max Seat #2 is the button
Seat 1: XFa6sBGjP2gxoIvxR3fZIg ($118.30 in chips)
Seat 2: 5IBeOgaApY1Bvzv2P8X4EA ($76.80 in chips)
5IBeOgaApY1Bvzv2P8X4EA: posts small blind $0.25
XFa6sBGjP2gxoIvxR3fZIg: posts big blind $0.50
*** HOLE CARDS ***
5IBeOgaApY1Bvzv2P8X4EA: calls $0.25
XFa6sBGjP2gxoIvxR3fZIg: checks
*** FLOP *** [Qd Ac Kc]
XFa6sBGjP2gxoIvxR3fZIg: bets $1
5IBeOgaApY1Bvzv2P8X4EA: calls $1
*** TURN *** [Qd Ac Kc] [3d]
XFa6sBGjP2gxoIvxR3fZIg: bets $1
5IBeOgaApY1Bvzv2P8X4EA: calls $1
*** RIVER *** [Qd Ac Kc 3d] [Jh]
XFa6sBGjP2gxoIvxR3fZIg: checks
5IBeOgaApY1Bvzv2P8X4EA: checks
*** SHOW DOWN ***
XFa6sBGjP2gxoIvxR3fZIg: shows [6c 5c] (high card Ace)
5IBeOgaApY1Bvzv2P8X4EA: shows [Kh 9d] (a pair of Kings)
5IBeOgaApY1Bvzv2P8X4EA collected $4.80 from pot
*** SUMMARY ***
Total pot $5 | Rake $0.20
Board [Qd Ac Kc 3d Jh]
Seat 1: XFa6sBGjP2gxoIvxR3fZIg (big blind) showed [6c 5c] and lost with high card Ace
Seat 2: 5IBeOgaApY1Bvzv2P8X4EA (button) (small blind) showed [Kh 9d] and won ($4.80) with a pair of Kings



PokerStars Game #59940572086:  Hold'em No Limit ($0.25/$0.50) - 2009/07/01 1:10:25 ET
Table '+z1aekfHkpp09pc8F9aViw' 6-max Seat #4 is the button
Seat 2: 8EEqTTh7T1q48sYDqbI2Xg ($29.25 in chips)
Seat 3: uUznlIMFnRUvwrBhYF73KA ($141.40 in chips)
Seat 4: RowCSpSURHTOL/dcjg/Iug ($36.55 in chips)
Seat 5: rplyldNweS6YyMNEALQrug ($55.85 in chips)
Seat 6: 686aeHikcJlgKkSuIFdcXQ ($52.55 in chips)
rplyldNweS6YyMNEALQrug: posts small blind $0.25
686aeHikcJlgKkSuIFdcXQ: posts big blind $0.50
7zFtlEn2NxyROFkJdZA/yg: sits out
*** HOLE CARDS ***
8EEqTTh7T1q48sYDqbI2Xg: calls $0.50
uUznlIMFnRUvwrBhYF73KA: folds
RowCSpSURHTOL/dcjg/Iug: folds
rplyldNweS6YyMNEALQrug: calls $0.25
686aeHikcJlgKkSuIFdcXQ: checks
*** FLOP *** [9c 5c 2d]
rplyldNweS6YyMNEALQrug: checks
686aeHikcJlgKkSuIFdcXQ: checks
8EEqTTh7T1q48sYDqbI2Xg: checks
*** TURN *** [9c 5c 2d] [Jd]
rplyldNweS6YyMNEALQrug: bets $1.50
686aeHikcJlgKkSuIFdcXQ: folds
8EEqTTh7T1q48sYDqbI2Xg: folds
rplyldNweS6YyMNEALQrug collected $1.45 from pot
*** SUMMARY ***
Total pot $1.50 | Rake $0.05
Board [9c 5c 2d Jd]
Seat 2: 8EEqTTh7T1q48sYDqbI2Xg folded on the Turn
Seat 3: uUznlIMFnRUvwrBhYF73KA folded before Flop (didn't bet)
Seat 4: RowCSpSURHTOL/dcjg/Iug (button) folded before Flop (didn't bet)
Seat 5: rplyldNweS6YyMNEALQrug (small blind) collected ($1.45)
Seat 6: 686aeHikcJlgKkSuIFdcXQ (big blind) folded on the Turn



PokerStars Game #59940572230:  Hold'em No Limit ($0.25/$0.50) - 2009/07/01 1:10:26 ET
Table '0eJtgVAXVvBgncFdcUpXcQ' 2-max Seat #2 is the button
Seat 1: Ag6DvxX4vbRheqsv2zXKTQ ($50 in chips)
Seat 2: KMc4R+K9ao4Ur3rF7NGe6Q ($4.15 in chips)
KMc4R+K9ao4Ur3rF7NGe6Q: posts small blind $0.25
Ag6DvxX4vbRheqsv2zXKTQ: posts big blind $0.50
*** HOLE CARDS ***
KMc4R+K9ao4Ur3rF7NGe6Q: raises $3.65 to $4.15 and is all-in
Ag6DvxX4vbRheqsv2zXKTQ: folds
KMc4R+K9ao4Ur3rF7NGe6Q collected $1 from pot
KMc4R+K9ao4Ur3rF7NGe6Q: doesn't show hand
*** SUMMARY ***
Total pot $1 | Rake $0
Seat 1: Ag6DvxX4vbRheqsv2zXKTQ (big blind) folded before Flop
Seat 2: KMc4R+K9ao4Ur3rF7NGe6Q (button) (small blind) collected ($1)



PokerStars Game #59940572936:  Hold'em No Limit ($0.25/$0.50) - 2009/07/01 1:10:27 ET
Table 'E7bWJ45aoFXRpyRv2gw+Ig' 2-max Seat #1 is the button
Seat 1: FRkiRasEGlHUeLrEl+k/nA ($50 in chips)
Seat 2: 3Wro85I7472vJ4Wkpneo9A ($145.15 in chips)
FRkiRasEGlHUeLrEl+k/nA: posts small blind $0.25
3Wro85I7472vJ4Wkpneo9A: posts big blind $0.50
*** HOLE CARDS ***
FRkiRasEGlHUeLrEl+k/nA: folds
3Wro85I7472vJ4Wkpneo9A collected $0.50 from pot
3Wro85I7472vJ4Wkpneo9A: doesn't show hand
*** SUMMARY ***
Total pot $0.50 | Rake $0
Seat 1: FRkiRasEGlHUeLrEl+k/nA (button) (small blind) folded before Flop
Seat 2: 3Wro85I7472vJ4Wkpneo9A (big blind) collected ($0.50)



PokerStars Game #59940572848:  Hold'em No Limit ($0.25/$0.50) - 2009/07/01 1:10:27 ET
Table 'eMxdLyFDf28E0wit6gm3Uw' 6-max Seat #2 is the button
Seat 1: FONMraB4GCHzDwDcfciKyw ($50 in chips)
Seat 2: UEjiWqFckVmunpvV128Xfw ($48.85 in chips)
Seat 4: hPAFLRqGh8YnqPe3HMZiQg ($26.90 in chips)
Seat 5: OtITKlSIHBhVAjRe30+BBQ ($39.40 in chips)
Seat 6: lxIzoHy0RnkfFSODHC2liw ($50.75 in chips)
hPAFLRqGh8YnqPe3HMZiQg: posts small blind $0.25
OtITKlSIHBhVAjRe30+BBQ: posts big blind $0.50
*** HOLE CARDS ***
lxIzoHy0RnkfFSODHC2liw: folds
FONMraB4GCHzDwDcfciKyw: folds
UEjiWqFckVmunpvV128Xfw: raises $1.50 to $2
hPAFLRqGh8YnqPe3HMZiQg: calls $1.75
OtITKlSIHBhVAjRe30+BBQ: folds
*** FLOP *** [Jc Tc 9h]
hPAFLRqGh8YnqPe3HMZiQg: checks
UEjiWqFckVmunpvV128Xfw: bets $2.50
hPAFLRqGh8YnqPe3HMZiQg: calls $2.50
*** TURN *** [Jc Tc 9h] [Jd]
hPAFLRqGh8YnqPe3HMZiQg: checks
UEjiWqFckVmunpvV128Xfw: checks
*** RIVER *** [Jc Tc 9h Jd] [Jh]
hPAFLRqGh8YnqPe3HMZiQg: bets $2.50
UEjiWqFckVmunpvV128Xfw: calls $2.50
*** SHOW DOWN ***
hPAFLRqGh8YnqPe3HMZiQg: shows [As 8d] (three of a kind, Jacks)
UEjiWqFckVmunpvV128Xfw: shows [Th Td] (a full house, Jacks full of Tens)
UEjiWqFckVmunpvV128Xfw collected $13.80 from pot
*** SUMMARY ***
Total pot $14.50 | Rake $0.70
Board [Jc Tc 9h Jd Jh]
Seat 1: FONMraB4GCHzDwDcfciKyw folded before Flop (didn't bet)
Seat 2: UEjiWqFckVmunpvV128Xfw (button) showed [Th Td] and won ($13.80) with a full house, Jacks full of Tens
Seat 4: hPAFLRqGh8YnqPe3HMZiQg (small blind) showed [As 8d] and lost with three of a kind, Jacks
Seat 5: OtITKlSIHBhVAjRe30+BBQ (big blind) folded before Flop
Seat 6: lxIzoHy0RnkfFSODHC2liw folded before Flop (didn't bet)



PokerStars Game #59940575560:  Hold'em No Limit ($0.25/$0.50) - 2009/07/01 1:10:31 ET
Table 'kgbJRsxfv64KrErDRBAkcw' 6-max Seat #6 is the button
Seat 1: VamsyhlFzXGF6/ydo0BHeA ($43.85 in chips)
Seat 2: AdS8BJMOheS01zjCDfPMFg ($49 in chips)
Seat 3: c4MNIaIyPMOMxrgT8FT5nA ($135.55 in chips)
Seat 5: eUBBn2R56C1IQ6Cs/vitwg ($60.45 in chips)
Seat 6: 1b+2BbjMN8qhR1WPqdE9VQ ($57.35 in chips)
VamsyhlFzXGF6/ydo0BHeA: posts small blind $0.25
AdS8BJMOheS01zjCDfPMFg: posts big blind $0.50
c4MNIaIyPMOMxrgT8FT5nA: posts small & big blinds $0.75
*** HOLE CARDS ***
c4MNIaIyPMOMxrgT8FT5nA: checks
eUBBn2R56C1IQ6Cs/vitwg: folds
1b+2BbjMN8qhR1WPqdE9VQ: folds
VamsyhlFzXGF6/ydo0BHeA: calls $0.25
AdS8BJMOheS01zjCDfPMFg: raises $1 to $1.50
c4MNIaIyPMOMxrgT8FT5nA: calls $1
VamsyhlFzXGF6/ydo0BHeA: calls $1
*** FLOP *** [7h 2c 8c]
VamsyhlFzXGF6/ydo0BHeA: checks
AdS8BJMOheS01zjCDfPMFg: bets $3
c4MNIaIyPMOMxrgT8FT5nA: raises $4.50 to $7.50
VamsyhlFzXGF6/ydo0BHeA: folds
AdS8BJMOheS01zjCDfPMFg: raises $6.50 to $14
c4MNIaIyPMOMxrgT8FT5nA: folds
AdS8BJMOheS01zjCDfPMFg collected $18.80 from pot
*** SUMMARY ***
Total pot $19.75 | Rake $0.95
Board [7h 2c 8c]
Seat 1: VamsyhlFzXGF6/ydo0BHeA (small blind) folded on the Flop
Seat 2: AdS8BJMOheS01zjCDfPMFg (big blind) collected ($18.80)
Seat 3: c4MNIaIyPMOMxrgT8FT5nA folded on the Flop
Seat 5: eUBBn2R56C1IQ6Cs/vitwg folded before Flop (didn't bet)
Seat 6: 1b+2BbjMN8qhR1WPqdE9VQ (button) folded before Flop (didn't bet)



PokerStars Game #59940576150:  Hold'em No Limit ($0.25/$0.50) - 2009/07/01 1:10:32 ET
Table '5EmHi+fnatGQQShcNmzOZQ' 6-max Seat #3 is the button
Seat 1: My8WkRtGx5FW6rJ1I4R3hg ($49.35 in chips)
Seat 2: bfFjgAtIoAI+pUxUwFt3aQ ($38.60 in chips)
Seat 3: 1mYbhL8CU/QYqfVmFcaHDQ ($8 in chips)
Seat 4: 1b+2BbjMN8qhR1WPqdE9VQ ($50 in chips)
Seat 5: kxPhs4ePFqMy52CInAJ2aw ($93.85 in chips)
Seat 6: 686aeHikcJlgKkSuIFdcXQ ($134.85 in chips)
1b+2BbjMN8qhR1WPqdE9VQ: posts small blind $0.25
kxPhs4ePFqMy52CInAJ2aw: posts big blind $0.50
*** HOLE CARDS ***
686aeHikcJlgKkSuIFdcXQ: folds
My8WkRtGx5FW6rJ1I4R3hg: calls $0.50
bfFjgAtIoAI+pUxUwFt3aQ: calls $0.50
1mYbhL8CU/QYqfVmFcaHDQ: folds
1b+2BbjMN8qhR1WPqdE9VQ: calls $0.25
kxPhs4ePFqMy52CInAJ2aw: checks
*** FLOP *** [4c 4s 3h]
1b+2BbjMN8qhR1WPqdE9VQ: bets $1
kxPhs4ePFqMy52CInAJ2aw: folds
My8WkRtGx5FW6rJ1I4R3hg: raises $1 to $2
bfFjgAtIoAI+pUxUwFt3aQ: folds
1b+2BbjMN8qhR1WPqdE9VQ: calls $1
*** TURN *** [4c 4s 3h] [Ah]
1b+2BbjMN8qhR1WPqdE9VQ: checks
My8WkRtGx5FW6rJ1I4R3hg: bets $1
1b+2BbjMN8qhR1WPqdE9VQ: calls $1
*** RIVER *** [4c 4s 3h Ah] [3c]
1b+2BbjMN8qhR1WPqdE9VQ: checks
My8WkRtGx5FW6rJ1I4R3hg: checks
*** SHOW DOWN ***
1b+2BbjMN8qhR1WPqdE9VQ: shows [7c 7h] (two pair, Sevens and Fours)
My8WkRtGx5FW6rJ1I4R3hg: mucks hand
1b+2BbjMN8qhR1WPqdE9VQ collected $7.65 from pot
*** SUMMARY ***
Total pot $8 | Rake $0.35
Board [4c 4s 3h Ah 3c]
Seat 1: My8WkRtGx5FW6rJ1I4R3hg mucked
Seat 2: bfFjgAtIoAI+pUxUwFt3aQ folded on the Flop
Seat 3: 1mYbhL8CU/QYqfVmFcaHDQ (button) folded before Flop (didn't bet)
Seat 4: 1b+2BbjMN8qhR1WPqdE9VQ (small blind) showed [7c 7h] and won ($7.65) with two pair, Sevens and Fours
Seat 5: kxPhs4ePFqMy52CInAJ2aw (big blind) folded on the Flop
Seat 6: 686aeHikcJlgKkSuIFdcXQ folded before Flop (didn't bet)



PokerStars Game #59940576414:  Hold'em No Limit ($0.25/$0.50) - 2009/07/01 1:10:33 ET
Table '0eJtgVAXVvBgncFdcUpXcQ' 2-max Seat #1 is the button
Seat 1: Ag6DvxX4vbRheqsv2zXKTQ ($49.50 in chips)
Seat 2: KMc4R+K9ao4Ur3rF7NGe6Q ($4.65 in chips)
Ag6DvxX4vbRheqsv2zXKTQ: posts small blind $0.25
KMc4R+K9ao4Ur3rF7NGe6Q: posts big blind $0.50
*** HOLE CARDS ***
Ag6DvxX4vbRheqsv2zXKTQ: folds
KMc4R+K9ao4Ur3rF7NGe6Q collected $0.50 from pot
*** SUMMARY ***
Total pot $0.50 | Rake $0
Seat 1: Ag6DvxX4vbRheqsv2zXKTQ (button) (small blind) folded before Flop
Seat 2: KMc4R+K9ao4Ur3rF7NGe6Q (big blind) collected ($0.50)



PokerStars Game #59940576420:  Hold'em No Limit ($0.25/$0.50) - 2009/07/01 1:10:33 ET
Table 'MJxeZCzYELxiIsyUZyT0jw' 6-max Seat #4 is the button
Seat 1: +Pf9jTVizYlIo+woPvptfA ($50 in chips)
Seat 3: sIG4mp8tZEI+W4nKZNkkQA ($53.45 in chips)
Seat 4: alGiiQP/wwtYnfuXII+sgw ($62.35 in chips)
Seat 5: 3jvoOXNtXE90w2BdfNZwZQ ($50.50 in chips)
Seat 6: c0n4hrn20AML9qzyFC2E8Q ($63 in chips)
3jvoOXNtXE90w2BdfNZwZQ: posts small blind $0.25
c0n4hrn20AML9qzyFC2E8Q: posts big blind $0.50
*** HOLE CARDS ***
+Pf9jTVizYlIo+woPvptfA: folds
sIG4mp8tZEI+W4nKZNkkQA: folds
alGiiQP/wwtYnfuXII+sgw: folds
3jvoOXNtXE90w2BdfNZwZQ: raises $1.50 to $2
c0n4hrn20AML9qzyFC2E8Q: calls $1.50
*** FLOP *** [2d 3h 8s]
3jvoOXNtXE90w2BdfNZwZQ: bets $2.50
c0n4hrn20AML9qzyFC2E8Q: folds
3jvoOXNtXE90w2BdfNZwZQ collected $3.80 from pot
3jvoOXNtXE90w2BdfNZwZQ: doesn't show hand
*** SUMMARY ***
Total pot $4 | Rake $0.20
Board [2d 3h 8s]
Seat 1: +Pf9jTVizYlIo+woPvptfA folded before Flop (didn't bet)
Seat 3: sIG4mp8tZEI+W4nKZNkkQA folded before Flop (didn't bet)
Seat 4: alGiiQP/wwtYnfuXII+sgw (button) folded before Flop (didn't bet)
Seat 5: 3jvoOXNtXE90w2BdfNZwZQ (small blind) collected ($3.80)
Seat 6: c0n4hrn20AML9qzyFC2E8Q (big blind) folded on the Flop



PokerStars Game #59940576844:  Hold'em No Limit ($0.25/$0.50) - 2009/07/01 1:10:34 ET
Table 'E7bWJ45aoFXRpyRv2gw+Ig' 2-max Seat #2 is the button
Seat 1: FRkiRasEGlHUeLrEl+k/nA ($50 in chips)
Seat 2: 3Wro85I7472vJ4Wkpneo9A ($145.40 in chips)
3Wro85I7472vJ4Wkpneo9A: posts small blind $0.25
FRkiRasEGlHUeLrEl+k/nA: posts big blind $0.50
*** HOLE CARDS ***
3Wro85I7472vJ4Wkpneo9A: calls $0.25
FRkiRasEGlHUeLrEl+k/nA: checks
*** FLOP *** [7s Ts 5s]
FRkiRasEGlHUeLrEl+k/nA: checks
3Wro85I7472vJ4Wkpneo9A: bets $1
FRkiRasEGlHUeLrEl+k/nA: folds
3Wro85I7472vJ4Wkpneo9A collected $0.95 from pot
3Wro85I7472vJ4Wkpneo9A: doesn't show hand
*** SUMMARY ***
Total pot $1 | Rake $0.05
Board [7s Ts 5s]
Seat 1: FRkiRasEGlHUeLrEl+k/nA (big blind) folded on the Flop
Seat 2: 3Wro85I7472vJ4Wkpneo9A (button) (small blind) collected ($0.95)



PokerStars Game #59940577496:  Hold'em No Limit ($0.25/$0.50) - 2009/07/01 1:10:35 ET
Table 'tYh970kmVfYS0gXPT/XtoQ' 2-max Seat #1 is the button
Seat 1: CLj3pYZDnglQbP8AEHiYIw ($57.85 in chips)
Seat 2: fxN9bTdAgPNvNkHgbVXKGw ($11.40 in chips)
CLj3pYZDnglQbP8AEHiYIw: posts small blind $0.25
fxN9bTdAgPNvNkHgbVXKGw: posts big blind $0.50
*** HOLE CARDS ***
CLj3pYZDnglQbP8AEHiYIw: folds
fxN9bTdAgPNvNkHgbVXKGw collected $0.50 from pot
fxN9bTdAgPNvNkHgbVXKGw: doesn't show hand
*** SUMMARY ***
Total pot $0.50 | Rake $0
Seat 1: CLj3pYZDnglQbP8AEHiYIw (button) (small blind) folded before Flop
Seat 2: fxN9bTdAgPNvNkHgbVXKGw (big blind) collected ($0.50)



PokerStars Game #59940577672:  Hold'em No Limit ($0.25/$0.50) - 2009/07/01 1:10:35 ET
Table 'WlCrrUP9MxwySQN5fzLFBQ' 2-max Seat #2 is the button
Seat 1: AMDFA0ajpsTPOIGjeT0g0Q ($51.35 in chips)
Seat 2: I6jT30IIGKfk3BWwujd6WQ ($50 in chips)
I6jT30IIGKfk3BWwujd6WQ: posts small blind $0.25
AMDFA0ajpsTPOIGjeT0g0Q: posts big blind $0.50
*** HOLE CARDS ***
I6jT30IIGKfk3BWwujd6WQ: raises $1 to $1.50
AMDFA0ajpsTPOIGjeT0g0Q: folds
I6jT30IIGKfk3BWwujd6WQ collected $1 from pot
*** SUMMARY ***
Total pot $1 | Rake $0
Seat 1: AMDFA0ajpsTPOIGjeT0g0Q (big blind) folded before Flop
Seat 2: I6jT30IIGKfk3BWwujd6WQ (button) (small blind) collected ($1)



PokerStars Game #59940579692:  Hold'em No Limit ($0.25/$0.50) - 2009/07/01 1:10:38 ET
Table 'fx6MqwfYAj/Rt86hBz2L3Q' 9-max Seat #8 is the button
Seat 1: uw9QayAAxLM3Hb+HR7mSkg ($10 in chips)
Seat 2: C3rGXblctNcWI6JYPHhaEg ($36 in chips)
Seat 3: iadBi5AEt7gTBXbDSSnMYQ ($48.80 in chips)
Seat 5: iAISe3dVeua8PUn2wwgDHw ($66 in chips)
Seat 6: 5k9fvXD9suIgCxU4HLQjTw ($50 in chips)
Seat 7: SKnJuWHScqetA/qG5p+wCg ($30 in chips)
Seat 8: JYwJYYV9pM5KWdSiETl8rA ($29.75 in chips)
uw9QayAAxLM3Hb+HR7mSkg: posts small blind $0.25
C3rGXblctNcWI6JYPHhaEg: posts big blind $0.50
*** HOLE CARDS ***
rFvc7K/96V9eGvYRfmpoUQ joins the table at seat #9
iadBi5AEt7gTBXbDSSnMYQ: calls $0.50
iAISe3dVeua8PUn2wwgDHw: folds
5k9fvXD9suIgCxU4HLQjTw: folds
SKnJuWHScqetA/qG5p+wCg: folds
JYwJYYV9pM5KWdSiETl8rA: folds
uw9QayAAxLM3Hb+HR7mSkg: folds
C3rGXblctNcWI6JYPHhaEg: checks
*** FLOP *** [4d Qs 2d]
C3rGXblctNcWI6JYPHhaEg: checks
iadBi5AEt7gTBXbDSSnMYQ: checks
*** TURN *** [4d Qs 2d] [Qc]
C3rGXblctNcWI6JYPHhaEg: checks
iadBi5AEt7gTBXbDSSnMYQ: checks
*** RIVER *** [4d Qs 2d Qc] [Ks]
C3rGXblctNcWI6JYPHhaEg: checks
iadBi5AEt7gTBXbDSSnMYQ: checks
*** SHOW DOWN ***
C3rGXblctNcWI6JYPHhaEg: shows [8s 7s] (a pair of Queens)
iadBi5AEt7gTBXbDSSnMYQ: shows [Jh 5s] (a pair of Queens - King+Jack kicker)
iadBi5AEt7gTBXbDSSnMYQ collected $1.20 from pot
*** SUMMARY ***
Total pot $1.25 | Rake $0.05
Board [4d Qs 2d Qc Ks]
Seat 1: uw9QayAAxLM3Hb+HR7mSkg (small blind) folded before Flop
Seat 2: C3rGXblctNcWI6JYPHhaEg (big blind) showed [8s 7s] and lost with a pair of Queens
Seat 3: iadBi5AEt7gTBXbDSSnMYQ showed [Jh 5s] and won ($1.20) with a pair of Queens
Seat 5: iAISe3dVeua8PUn2wwgDHw folded before Flop (didn't bet)
Seat 6: 5k9fvXD9suIgCxU4HLQjTw folded before Flop (didn't bet)
Seat 7: SKnJuWHScqetA/qG5p+wCg folded before Flop (didn't bet)
Seat 8: JYwJYYV9pM5KWdSiETl8rA (button) folded before Flop (didn't bet)



PokerStars Game #59940579110:  Hold'em No Limit ($0.25/$0.50) - 2009/07/01 1:10:38 ET
Table 'BCN5su+SsXiy1zRMJi0SJw' 6-max Seat #2 is the button
Seat 1: GxXV09ciXaOxyY2H5aMIIw ($53.40 in chips)
Seat 2: oU2kDCkT/gilYbHWrg7D8w ($41.70 in chips)
Seat 3: kwgv5lNhiFrfONXCshzxlA ($29 in chips)
Seat 4: 4QfsCWthT/vSLirorNXqtg ($50 in chips)
Seat 6: b2symlOdL7+0c9Pj4N/KlA ($59.35 in chips)
kwgv5lNhiFrfONXCshzxlA: posts small blind $0.25
4QfsCWthT/vSLirorNXqtg: posts big blind $0.50
*** HOLE CARDS ***
WUgnrlL2IrGbGEyDnzOJzQ leaves the table
b2symlOdL7+0c9Pj4N/KlA: folds
GxXV09ciXaOxyY2H5aMIIw: folds
oU2kDCkT/gilYbHWrg7D8w: raises $1 to $1.50
kwgv5lNhiFrfONXCshzxlA: folds
4QfsCWthT/vSLirorNXqtg: folds
oU2kDCkT/gilYbHWrg7D8w collected $1.25 from pot
oU2kDCkT/gilYbHWrg7D8w: doesn't show hand
*** SUMMARY ***
Total pot $1.25 | Rake $0
Seat 1: GxXV09ciXaOxyY2H5aMIIw folded before Flop (didn't bet)
Seat 2: oU2kDCkT/gilYbHWrg7D8w (button) collected ($1.25)
Seat 3: kwgv5lNhiFrfONXCshzxlA (small blind) folded before Flop
Seat 4: 4QfsCWthT/vSLirorNXqtg (big blind) folded before Flop
Seat 6: b2symlOdL7+0c9Pj4N/KlA folded before Flop (didn't bet)



PokerStars Game #59940580294:  Hold'em No Limit ($0.25/$0.50) - 2009/07/01 1:10:40 ET
Table 'hSTs/dUsYLgJQuF2Onp0MQ' 6-max Seat #1 is the button
Seat 1: 1WUCqNG+p+vfWRTXNu4ljw ($50 in chips)
Seat 2: 6vNxrjjCl6FwfaaymM9jjg ($36 in chips)
Seat 3: C3qJBo7uxfFVDluE1lmK2w ($52.60 in chips)
Seat 4: L0aIPg7qefDQjdJo3HCVEA ($10.05 in chips)
Seat 5: 686aeHikcJlgKkSuIFdcXQ ($57.15 in chips)
Seat 6: M1KyQQvVPVuxqTAB8sR/zQ ($79.65 in chips)
6vNxrjjCl6FwfaaymM9jjg: posts small blind $0.25
C3qJBo7uxfFVDluE1lmK2w: posts big blind $0.50
*** HOLE CARDS ***
L0aIPg7qefDQjdJo3HCVEA: folds
686aeHikcJlgKkSuIFdcXQ: folds
M1KyQQvVPVuxqTAB8sR/zQ: folds
1WUCqNG+p+vfWRTXNu4ljw: folds
6vNxrjjCl6FwfaaymM9jjg: calls $0.25
C3qJBo7uxfFVDluE1lmK2w: checks
*** FLOP *** [6c 8c 5s]
6vNxrjjCl6FwfaaymM9jjg: bets $0.50
C3qJBo7uxfFVDluE1lmK2w: raises $1 to $1.50
6vNxrjjCl6FwfaaymM9jjg: raises $1 to $2.50
C3qJBo7uxfFVDluE1lmK2w: calls $1
*** TURN *** [6c 8c 5s] [2h]
6vNxrjjCl6FwfaaymM9jjg: bets $5
C3qJBo7uxfFVDluE1lmK2w: raises $5 to $10
6vNxrjjCl6FwfaaymM9jjg: raises $23 to $33 and is all-in
C3qJBo7uxfFVDluE1lmK2w: calls $23
*** RIVER *** [6c 8c 5s 2h] [2d]
*** SHOW DOWN ***
6vNxrjjCl6FwfaaymM9jjg: shows [7d 9d] (a straight, Five to Nine)
C3qJBo7uxfFVDluE1lmK2w: mucks hand
6vNxrjjCl6FwfaaymM9jjg collected $69 from pot
*** SUMMARY ***
Total pot $72 | Rake $3
Board [6c 8c 5s 2h 2d]
Seat 1: 1WUCqNG+p+vfWRTXNu4ljw (button) folded before Flop (didn't bet)
Seat 2: 6vNxrjjCl6FwfaaymM9jjg (small blind) showed [7d 9d] and won ($69) with a straight, Five to Nine
Seat 3: C3qJBo7uxfFVDluE1lmK2w (big blind) mucked
Seat 4: L0aIPg7qefDQjdJo3HCVEA folded before Flop (didn't bet)
Seat 5: 686aeHikcJlgKkSuIFdcXQ folded before Flop (didn't bet)
Seat 6: M1KyQQvVPVuxqTAB8sR/zQ folded before Flop (didn't bet)



PokerStars Game #59940580668:  Hold'em No Limit ($0.25/$0.50) - 2009/07/01 1:10:40 ET
Table 'tYh970kmVfYS0gXPT/XtoQ' 2-max Seat #2 is the button
Seat 1: CLj3pYZDnglQbP8AEHiYIw ($57.60 in chips)
Seat 2: fxN9bTdAgPNvNkHgbVXKGw ($11.65 in chips)
fxN9bTdAgPNvNkHgbVXKGw: posts small blind $0.25
CLj3pYZDnglQbP8AEHiYIw: posts big blind $0.50
*** HOLE CARDS ***
fxN9bTdAgPNvNkHgbVXKGw: calls $0.25
CLj3pYZDnglQbP8AEHiYIw: checks
*** FLOP *** [Qs 7c 9d]
CLj3pYZDnglQbP8AEHiYIw: checks
fxN9bTdAgPNvNkHgbVXKGw: bets $0.50
CLj3pYZDnglQbP8AEHiYIw: folds
fxN9bTdAgPNvNkHgbVXKGw collected $0.95 from pot
fxN9bTdAgPNvNkHgbVXKGw: doesn't show hand
*** SUMMARY ***
Total pot $1 | Rake $0.05
Board [Qs 7c 9d]
Seat 1: CLj3pYZDnglQbP8AEHiYIw (big blind) folded on the Flop
Seat 2: fxN9bTdAgPNvNkHgbVXKGw (button) (small blind) collected ($0.95)



PokerStars Game #59940580616:  Hold'em No Limit ($0.25/$0.50) - 2009/07/01 1:10:40 ET
Table 'NCiXr0d5CEKBQr/cZgLhbA' 9-max Seat #9 is the button
Seat 1: pFtzb1sR4b0d1aw6aIRgDg ($50.45 in chips)
Seat 3: xZCXQSXlrZkp3pZizzVXCw ($51.95 in chips)
Seat 4: 5k9fvXD9suIgCxU4HLQjTw ($52.45 in chips)
Seat 5: zE9cVigS2nW/Ljy4K4bUQA ($65.10 in chips)
Seat 6: SKnJuWHScqetA/qG5p+wCg ($30 in chips)
Seat 7: M+7+BTmX5vZatHVuoRB1nA ($52 in chips)
Seat 8: 1MJUKc3cc0QmUoz1JZLR2w ($49.30 in chips)
Seat 9: 4WLZvqBn5qv5tds5kt5A1Q ($56.05 in chips)
pFtzb1sR4b0d1aw6aIRgDg: posts small blind $0.25
xZCXQSXlrZkp3pZizzVXCw: posts big blind $0.50
*** HOLE CARDS ***
5k9fvXD9suIgCxU4HLQjTw: folds
zE9cVigS2nW/Ljy4K4bUQA: folds
SKnJuWHScqetA/qG5p+wCg: folds
M+7+BTmX5vZatHVuoRB1nA: folds
ulxuJchBV9iguXg0FUonfg said, "gnite all... gl"
1MJUKc3cc0QmUoz1JZLR2w: folds
4WLZvqBn5qv5tds5kt5A1Q: folds
pFtzb1sR4b0d1aw6aIRgDg: folds
xZCXQSXlrZkp3pZizzVXCw collected $0.50 from pot
*** SUMMARY ***
Total pot $0.50 | Rake $0
Seat 1: pFtzb1sR4b0d1aw6aIRgDg (small blind) folded before Flop
Seat 3: xZCXQSXlrZkp3pZizzVXCw (big blind) collected ($0.50)
Seat 4: 5k9fvXD9suIgCxU4HLQjTw folded before Flop (didn't bet)
Seat 5: zE9cVigS2nW/Ljy4K4bUQA folded before Flop (didn't bet)
Seat 6: SKnJuWHScqetA/qG5p+wCg folded before Flop (didn't bet)
Seat 7: M+7+BTmX5vZatHVuoRB1nA folded before Flop (didn't bet)
Seat 8: 1MJUKc3cc0QmUoz1JZLR2w folded before Flop (didn't bet)
Seat 9: 4WLZvqBn5qv5tds5kt5A1Q (button) folded before Flop (didn't bet)



PokerStars Game #59940581498:  Hold'em No Limit ($0.25/$0.50) - 2009/07/01 1:10:42 ET
Table '0eJtgVAXVvBgncFdcUpXcQ' 2-max Seat #2 is the button
Seat 1: Ag6DvxX4vbRheqsv2zXKTQ ($49.25 in chips)
Seat 2: KMc4R+K9ao4Ur3rF7NGe6Q ($4.90 in chips)
KMc4R+K9ao4Ur3rF7NGe6Q: posts small blind $0.25
Ag6DvxX4vbRheqsv2zXKTQ: posts big blind $0.50
*** HOLE CARDS ***
KMc4R+K9ao4Ur3rF7NGe6Q: calls $0.25
Ag6DvxX4vbRheqsv2zXKTQ: checks
*** FLOP *** [8c 5h 8s]
Ag6DvxX4vbRheqsv2zXKTQ: checks
KMc4R+K9ao4Ur3rF7NGe6Q: folds
Ag6DvxX4vbRheqsv2zXKTQ collected $0.95 from pot
Ag6DvxX4vbRheqsv2zXKTQ: shows [Js Qc] (a pair of Eights)
*** SUMMARY ***
Total pot $1 | Rake $0.05
Board [8c 5h 8s]
Seat 1: Ag6DvxX4vbRheqsv2zXKTQ (big blind) collected ($0.95)
Seat 2: KMc4R+K9ao4Ur3rF7NGe6Q (button) (small blind) folded on the Flop



PokerStars Game #59940582300:  Hold'em No Limit ($0.25/$0.50) - 2009/07/01 1:10:43 ET
Table 'QOgaEqMcJ73pcUMMxoisUg' 6-max Seat #3 is the button
Seat 1: lxIzoHy0RnkfFSODHC2liw ($50 in chips)
Seat 2: oqOqoO2AyCZenUghCxMDxw ($65 in chips)
Seat 3: Rt6KgtZ8YaJoTc3FPim00w ($53 in chips)
Seat 4: zAcsDhG/T128Vn7XGVSgKg ($60.15 in chips)
Seat 5: 6vNxrjjCl6FwfaaymM9jjg ($21.45 in chips)
Seat 6: AdS8BJMOheS01zjCDfPMFg ($50 in chips)
zAcsDhG/T128Vn7XGVSgKg: posts small blind $0.25
6vNxrjjCl6FwfaaymM9jjg: posts big blind $0.50
*** HOLE CARDS ***
AdS8BJMOheS01zjCDfPMFg: folds
lxIzoHy0RnkfFSODHC2liw: folds
oqOqoO2AyCZenUghCxMDxw: folds
Rt6KgtZ8YaJoTc3FPim00w: raises $1 to $1.50
zAcsDhG/T128Vn7XGVSgKg: folds
6vNxrjjCl6FwfaaymM9jjg: folds
Rt6KgtZ8YaJoTc3FPim00w collected $1.25 from pot
Rt6KgtZ8YaJoTc3FPim00w: doesn't show hand
*** SUMMARY ***
Total pot $1.25 | Rake $0
Seat 1: lxIzoHy0RnkfFSODHC2liw folded before Flop (didn't bet)
Seat 2: oqOqoO2AyCZenUghCxMDxw folded before Flop (didn't bet)
Seat 3: Rt6KgtZ8YaJoTc3FPim00w (button) collected ($1.25)
Seat 4: zAcsDhG/T128Vn7XGVSgKg (small blind) folded before Flop
Seat 5: 6vNxrjjCl6FwfaaymM9jjg (big blind) folded before Flop
Seat 6: AdS8BJMOheS01zjCDfPMFg folded before Flop (didn't bet)



PokerStars Game #59940582272:  Hold'em No Limit ($0.25/$0.50) - 2009/07/01 1:10:43 ET
Table 'X6IRCRTh+20gjz8aubWnwA' 9-max Seat #6 is the button
Seat 1: DSM67hHHq1XFoEOi9p8Alw ($56 in chips)
Seat 2: HZkVla4kK2SI42CVrPZ/ig ($6.80 in chips)
Seat 3: SWv01peOe69QQRvhQTqjQw ($6 in chips)
Seat 4: M3JFBNQ8Bbw3FBZ/18MuXw ($25 in chips)
Seat 5: NnQCepdIR/AOUQn1yhYx6Q ($9.25 in chips)
Seat 6: 75K2MXwN65Sjfp1yHd50Hg ($10.45 in chips)
Seat 7: cFHQjKQOOKTUzoilhrXHLg ($13.40 in chips)
Seat 8: HxeBVq06/3Bh/H986sgdbw ($51.50 in chips)
Seat 9: M+7+BTmX5vZatHVuoRB1nA ($43.75 in chips)
cFHQjKQOOKTUzoilhrXHLg: posts small blind $0.25
HxeBVq06/3Bh/H986sgdbw: posts big blind $0.50
*** HOLE CARDS ***
M+7+BTmX5vZatHVuoRB1nA: folds
DSM67hHHq1XFoEOi9p8Alw: folds
HZkVla4kK2SI42CVrPZ/ig: folds
SWv01peOe69QQRvhQTqjQw: folds
M3JFBNQ8Bbw3FBZ/18MuXw: calls $0.50
NnQCepdIR/AOUQn1yhYx6Q: folds
75K2MXwN65Sjfp1yHd50Hg: folds
cFHQjKQOOKTUzoilhrXHLg: folds
HxeBVq06/3Bh/H986sgdbw: checks
*** FLOP *** [Qd 5c 9h]
HxeBVq06/3Bh/H986sgdbw: checks
M3JFBNQ8Bbw3FBZ/18MuXw: checks
*** TURN *** [Qd 5c 9h] [Jd]
HxeBVq06/3Bh/H986sgdbw: checks
M3JFBNQ8Bbw3FBZ/18MuXw: bets $1
HxeBVq06/3Bh/H986sgdbw: folds
M3JFBNQ8Bbw3FBZ/18MuXw collected $1.20 from pot
*** SUMMARY ***
Total pot $1.25 | Rake $0.05
Board [Qd 5c 9h Jd]
Seat 1: DSM67hHHq1XFoEOi9p8Alw folded before Flop (didn't bet)
Seat 2: HZkVla4kK2SI42CVrPZ/ig folded before Flop (didn't bet)
Seat 3: SWv01peOe69QQRvhQTqjQw folded before Flop (didn't bet)
Seat 4: M3JFBNQ8Bbw3FBZ/18MuXw collected ($1.20)
Seat 5: NnQCepdIR/AOUQn1yhYx6Q folded before Flop (didn't bet)
Seat 6: 75K2MXwN65Sjfp1yHd50Hg (button) folded before Flop (didn't bet)
Seat 7: cFHQjKQOOKTUzoilhrXHLg (small blind) folded before Flop
Seat 8: HxeBVq06/3Bh/H986sgdbw (big blind) folded on the Turn
Seat 9: M+7+BTmX5vZatHVuoRB1nA folded before Flop (didn't bet)



PokerStars Game #59940583188:  Hold'em No Limit ($0.25/$0.50) - 2009/07/01 1:10:45 ET
Table 'lpxYasB1ClBSgTpCCITwhQ' 9-max Seat #2 is the button
Seat 1: mj7PS7wCH4PAl7+eYTFs7A ($49.25 in chips)
Seat 2: OWP/DOu+PlPK6ZZ3zYa0HA ($25.85 in chips)
Seat 3: sakr/FIfFtIZwDPmAj5Pzg ($49.45 in chips)
Seat 4: NnQCepdIR/AOUQn1yhYx6Q ($10 in chips)
Seat 5: IYd5zG8k7vdBNVHbHg2Pag ($35 in chips)
Seat 6: SegjDnMxWMujiD57ESNL+g ($11.35 in chips)
Seat 7: bmRtaIYKthN1F+B3JLZ3Jw ($74.10 in chips)
Seat 8: /mfensKw8/iZ1Vrx33S4xg ($19.50 in chips)
Seat 9: sUIUZ+begh92dzkUmvbMrw ($12.80 in chips)
sakr/FIfFtIZwDPmAj5Pzg: posts small blind $0.25
NnQCepdIR/AOUQn1yhYx6Q: posts big blind $0.50
*** HOLE CARDS ***
IYd5zG8k7vdBNVHbHg2Pag: folds
SegjDnMxWMujiD57ESNL+g: folds
bmRtaIYKthN1F+B3JLZ3Jw: raises $0.50 to $1
/mfensKw8/iZ1Vrx33S4xg: folds
sUIUZ+begh92dzkUmvbMrw: folds
mj7PS7wCH4PAl7+eYTFs7A: folds
OWP/DOu+PlPK6ZZ3zYa0HA: folds
sakr/FIfFtIZwDPmAj5Pzg: folds
NnQCepdIR/AOUQn1yhYx6Q: folds
bmRtaIYKthN1F+B3JLZ3Jw collected $1.25 from pot
*** SUMMARY ***
Total pot $1.25 | Rake $0
Seat 1: mj7PS7wCH4PAl7+eYTFs7A folded before Flop (didn't bet)
Seat 2: OWP/DOu+PlPK6ZZ3zYa0HA (button) folded before Flop (didn't bet)
Seat 3: sakr/FIfFtIZwDPmAj5Pzg (small blind) folded before Flop
Seat 4: NnQCepdIR/AOUQn1yhYx6Q (big blind) folded before Flop
Seat 5: IYd5zG8k7vdBNVHbHg2Pag folded before Flop (didn't bet)
Seat 6: SegjDnMxWMujiD57ESNL+g folded before Flop (didn't bet)
Seat 7: bmRtaIYKthN1F+B3JLZ3Jw collected ($1.25)
Seat 8: /mfensKw8/iZ1Vrx33S4xg folded before Flop (didn't bet)
Seat 9: sUIUZ+begh92dzkUmvbMrw folded before Flop (didn't bet)



PokerStars Game #59940583564:  Hold'em No Limit ($0.25/$0.50) - 2009/07/01 1:10:45 ET
Table '+dXkOAQyS8j9PQZusUTMpg' 2-max Seat #1 is the button
Seat 1: XFa6sBGjP2gxoIvxR3fZIg ($115.80 in chips)
Seat 2: 5IBeOgaApY1Bvzv2P8X4EA ($79.10 in chips)
XFa6sBGjP2gxoIvxR3fZIg: posts small blind $0.25
5IBeOgaApY1Bvzv2P8X4EA: posts big blind $0.50
*** HOLE CARDS ***
XFa6sBGjP2gxoIvxR3fZIg: raises $1 to $1.50
5IBeOgaApY1Bvzv2P8X4EA: folds
XFa6sBGjP2gxoIvxR3fZIg collected $1 from pot
XFa6sBGjP2gxoIvxR3fZIg: doesn't show hand
*** SUMMARY ***
Total pot $1 | Rake $0
Seat 1: XFa6sBGjP2gxoIvxR3fZIg (button) (small blind) collected ($1)
Seat 2: 5IBeOgaApY1Bvzv2P8X4EA (big blind) folded before Flop



PokerStars Game #59940584098:  Hold'em No Limit ($0.25/$0.50) - 2009/07/01 1:10:46 ET
Table '8BQGgNetI1NOvWeu3gtMNw' 2-max Seat #1 is the button
Seat 1: bypIyrYcAAifLfhZpGlKLA ($107.55 in chips)
Seat 2: Z4HwehErEwzsv/noQlfUlg ($89.75 in chips)
bypIyrYcAAifLfhZpGlKLA: posts small blind $0.25
Z4HwehErEwzsv/noQlfUlg: posts big blind $0.50
*** HOLE CARDS ***
bypIyrYcAAifLfhZpGlKLA: folds
Z4HwehErEwzsv/noQlfUlg collected $0.50 from pot
Z4HwehErEwzsv/noQlfUlg: doesn't show hand
*** SUMMARY ***
Total pot $0.50 | Rake $0
Seat 1: bypIyrYcAAifLfhZpGlKLA (button) (small blind) folded before Flop
Seat 2: Z4HwehErEwzsv/noQlfUlg (big blind) collected ($0.50)



PokerStars Game #59940584692:  Hold'em No Limit ($0.25/$0.50) - 2009/07/01 1:10:47 ET
Table 'WlCrrUP9MxwySQN5fzLFBQ' 2-max Seat #1 is the button
Seat 1: AMDFA0ajpsTPOIGjeT0g0Q ($50.85 in chips)
Seat 2: I6jT30IIGKfk3BWwujd6WQ ($50.50 in chips)
AMDFA0ajpsTPOIGjeT0g0Q: posts small blind $0.25
I6jT30IIGKfk3BWwujd6WQ: posts big blind $0.50
*** HOLE CARDS ***
AMDFA0ajpsTPOIGjeT0g0Q: raises $1 to $1.50
I6jT30IIGKfk3BWwujd6WQ: folds
AMDFA0ajpsTPOIGjeT0g0Q collected $1 from pot
AMDFA0ajpsTPOIGjeT0g0Q: doesn't show hand
*** SUMMARY ***
Total pot $1 | Rake $0
Seat 1: AMDFA0ajpsTPOIGjeT0g0Q (button) (small blind) collected ($1)
Seat 2: I6jT30IIGKfk3BWwujd6WQ (big blind) folded before Flop



PokerStars Game #59940586130:  Hold'em No Limit ($0.25/$0.50) - 2009/07/01 1:10:49 ET
Table 'E7bWJ45aoFXRpyRv2gw+Ig' 2-max Seat #1 is the button
Seat 1: FRkiRasEGlHUeLrEl+k/nA ($50 in chips)
Seat 2: 3Wro85I7472vJ4Wkpneo9A ($145.85 in chips)
FRkiRasEGlHUeLrEl+k/nA: posts small blind $0.25
3Wro85I7472vJ4Wkpneo9A: posts big blind $0.50
*** HOLE CARDS ***
FRkiRasEGlHUeLrEl+k/nA: raises $1.50 to $2
3Wro85I7472vJ4Wkpneo9A: calls $1.50
*** FLOP *** [6c 4s 2h]
3Wro85I7472vJ4Wkpneo9A: bets $3
FRkiRasEGlHUeLrEl+k/nA: calls $3
*** TURN *** [6c 4s 2h] [4c]
3Wro85I7472vJ4Wkpneo9A: bets $7
FRkiRasEGlHUeLrEl+k/nA: calls $7
*** RIVER *** [6c 4s 2h 4c] [Kh]
3Wro85I7472vJ4Wkpneo9A: checks
FRkiRasEGlHUeLrEl+k/nA: bets $9
3Wro85I7472vJ4Wkpneo9A: raises $29 to $38
FRkiRasEGlHUeLrEl+k/nA: calls $29 and is all-in
*** SHOW DOWN ***
3Wro85I7472vJ4Wkpneo9A: shows [2d 2s] (a full house, Deuces full of Fours)
FRkiRasEGlHUeLrEl+k/nA: mucks hand
3Wro85I7472vJ4Wkpneo9A collected $99.50 from pot
*** SUMMARY ***
Total pot $100 | Rake $0.50
Board [6c 4s 2h 4c Kh]
Seat 1: FRkiRasEGlHUeLrEl+k/nA (button) (small blind) mucked
Seat 2: 3Wro85I7472vJ4Wkpneo9A (big blind) showed [2d 2s] and won ($99.50) with a full house, Deuces full of Fours



PokerStars Game #59940586520:  Hold'em No Limit ($0.25/$0.50) - 2009/07/01 1:10:50 ET
Table 'Nz0Vr7WMHL2g5Uk7dDZjpw' 9-max Seat #5 is the button
Seat 1: tLkxo7JgV+WWI0UBw44K5A ($107.10 in chips)
Seat 2: gsyXT42WLEcOS4DdEk2wlw ($30.60 in chips)
Seat 3: hoglu9inkgs6zN573/bJag ($7.50 in chips)
Seat 4: E2518gp4aFz1+kAgmGqeEg ($12.55 in chips)
Seat 5: WGW0DgjBUXs1ylURHG8vnQ ($24.65 in chips)
Seat 6: 997ViqAtWn1FPjJqcffwcA ($59.30 in chips)
Seat 7: KPLH0gELgFe2OuAnhJFI5w ($22.45 in chips)
Seat 8: aoL+R/61Kxmw69ypuPrWAQ ($23.70 in chips)
Seat 9: mSD1pginDsyHG5PDfqzphw ($10.75 in chips)
997ViqAtWn1FPjJqcffwcA: posts small blind $0.25
KPLH0gELgFe2OuAnhJFI5w: posts big blind $0.50
*** HOLE CARDS ***
aoL+R/61Kxmw69ypuPrWAQ: folds
mSD1pginDsyHG5PDfqzphw: folds
tLkxo7JgV+WWI0UBw44K5A has timed out
tLkxo7JgV+WWI0UBw44K5A: folds
tLkxo7JgV+WWI0UBw44K5A is sitting out
gsyXT42WLEcOS4DdEk2wlw: folds
hoglu9inkgs6zN573/bJag: calls $0.50
E2518gp4aFz1+kAgmGqeEg: folds
WGW0DgjBUXs1ylURHG8vnQ: folds
997ViqAtWn1FPjJqcffwcA: folds
KPLH0gELgFe2OuAnhJFI5w: checks
*** FLOP *** [Jc 4d 5d]
KPLH0gELgFe2OuAnhJFI5w: checks
hoglu9inkgs6zN573/bJag: checks
*** TURN *** [Jc 4d 5d] [5h]
KPLH0gELgFe2OuAnhJFI5w: checks
hoglu9inkgs6zN573/bJag: checks
*** RIVER *** [Jc 4d 5d 5h] [Kd]
KPLH0gELgFe2OuAnhJFI5w: checks
hoglu9inkgs6zN573/bJag: checks
*** SHOW DOWN ***
KPLH0gELgFe2OuAnhJFI5w: shows [As 3s] (a pair of Fives)
hoglu9inkgs6zN573/bJag: shows [2s Ad] (a pair of Fives)
KPLH0gELgFe2OuAnhJFI5w collected $0.60 from pot
hoglu9inkgs6zN573/bJag collected $0.60 from pot
*** SUMMARY ***
Total pot $1.25 | Rake $0.05
Board [Jc 4d 5d 5h Kd]
Seat 1: tLkxo7JgV+WWI0UBw44K5A folded before Flop (didn't bet)
Seat 2: gsyXT42WLEcOS4DdEk2wlw folded before Flop (didn't bet)
Seat 3: hoglu9inkgs6zN573/bJag showed [2s Ad] and won ($0.60) with a pair of Fives
Seat 4: E2518gp4aFz1+kAgmGqeEg folded before Flop (didn't bet)
Seat 5: WGW0DgjBUXs1ylURHG8vnQ (button) folded before Flop (didn't bet)
Seat 6: 997ViqAtWn1FPjJqcffwcA (small blind) folded before Flop
Seat 7: KPLH0gELgFe2OuAnhJFI5w (big blind) showed [As 3s] and won ($0.60) with a pair of Fives
Seat 8: aoL+R/61Kxmw69ypuPrWAQ folded before Flop (didn't bet)
Seat 9: mSD1pginDsyHG5PDfqzphw folded before Flop (didn't bet)



PokerStars Game #59940586774:  Hold'em No Limit ($0.25/$0.50) - 2009/07/01 1:10:50 ET
Table 'ErOuyGLI5PT3G5MnpHgC/gQOgaEqMcJ73pcUMMxoisUg Seat #8 is the button
Seat 1: eBrej2jnlUCs/JgxFCRn2g ($40.75 in chips)
Seat 2: pciZn00ZDk4BVBMTTMcNVQ ($28 in chips)
Seat 3: xZCXQSXlrZkp3pZizzVXCw ($50.50 in chips)
Seat 4: 3UmXLy3GfjC3EkOebduerQ ($50 in chips)
Seat 5: JwvquocWfhTVApN5t47LgA ($64.60 in chips)
Seat 6: zE9cVigS2nW/Ljy4K4bUQA ($31.60 in chips)
Seat 7: 90Wb75h3W1BRpbqVnuk8gw ($64.95 in chips)
Seat 8: g4k0NXISyLCqaSWZDBjfEg ($50 in chips)
Seat 9: J0W5D97jl5VLky+IoPvDeA ($52.60 in chips)
J0W5D97jl5VLky+IoPvDeA: posts small blind $0.25
eBrej2jnlUCs/JgxFCRn2g: posts big blind $0.50
*** HOLE CARDS ***
pciZn00ZDk4BVBMTTMcNVQ: raises $0.50 to $1
xZCXQSXlrZkp3pZizzVXCw: folds
3UmXLy3GfjC3EkOebduerQ: folds
JwvquocWfhTVApN5t47LgA: folds
zE9cVigS2nW/Ljy4K4bUQA: folds
90Wb75h3W1BRpbqVnuk8gw: calls $1
g4k0NXISyLCqaSWZDBjfEg: folds
J0W5D97jl5VLky+IoPvDeA: folds
eBrej2jnlUCs/JgxFCRn2g: folds
*** FLOP *** [9c 6c Ac]
pciZn00ZDk4BVBMTTMcNVQ: bets $0.50
90Wb75h3W1BRpbqVnuk8gw: calls $0.50
*** TURN *** [9c 6c Ac] [2h]
pciZn00ZDk4BVBMTTMcNVQ: bets $0.50
90Wb75h3W1BRpbqVnuk8gw: raises $2.50 to $3
pciZn00ZDk4BVBMTTMcNVQ: calls $2.50
*** RIVER *** [9c 6c Ac 2h] [8c]
pciZn00ZDk4BVBMTTMcNVQ: checks
90Wb75h3W1BRpbqVnuk8gw: checks
*** SHOW DOWN ***
pciZn00ZDk4BVBMTTMcNVQ: shows [Th As] (a pair of Aces)
90Wb75h3W1BRpbqVnuk8gw: mucks hand
pciZn00ZDk4BVBMTTMcNVQ collected $9.30 from pot
*** SUMMARY ***
Total pot $9.75 | Rake $0.45
Board [9c 6c Ac 2h 8c]
Seat 1: eBrej2jnlUCs/JgxFCRn2g (big blind) folded before Flop
Seat 2: pciZn00ZDk4BVBMTTMcNVQ showed [Th As] and won ($9.30) with a pair of Aces
Seat 3: xZCXQSXlrZkp3pZizzVXCw folded before Flop (didn't bet)
Seat 4: 3UmXLy3GfjC3EkOebduerQ folded before Flop (didn't bet)
Seat 5: JwvquocWfhTVApN5t47LgA folded before Flop (didn't bet)
Seat 6: zE9cVigS2nW/Ljy4K4bUQA folded before Flop (didn't bet)
Seat 7: 90Wb75h3W1BRpbqVnuk8gw mucked
Seat 8: g4k0NXISyLCqaSWZDBjfEg (button) folded before Flop (didn't bet)
Seat 9: J0W5D97jl5VLky+IoPvDeA (small blind) folded before Flop



PokerStars Game #59940586828:  Hold'em No Limit ($0.25/$0.50) - 2009/07/01 1:10:51 ET
Table 'otvGDROEDdqsabxskT79qg' 9-max Seat #8 is the button
Seat 1: 8ehL7qlZzjgUh2H35iiWLw ($59.75 in chips)
Seat 2: cCjTzH9jio8607WzjcfXlg ($13.20 in chips)
Seat 3: +k7T5ocke8UwavtgUHm+Cg ($70.60 in chips)
Seat 4: MG90wfSJZnOejs/KD3vlQQ ($75.90 in chips)
Seat 5: E2518gp4aFz1+kAgmGqeEg ($11.75 in chips)
Seat 6: bxLSulbgr8LmKNjOzw8URg ($56 in chips)
Seat 7: 75K2MXwN65Sjfp1yHd50Hg ($9.25 in chips)
Seat 8: zE9cVigS2nW/Ljy4K4bUQA ($30 in chips)
Seat 9: KcY3X8YpD74Kw1RHkx/g4A ($47.40 in chips)
KcY3X8YpD74Kw1RHkx/g4A: posts small blind $0.25
8ehL7qlZzjgUh2H35iiWLw: posts big blind $0.50
*** HOLE CARDS ***
cCjTzH9jio8607WzjcfXlg: folds
+k7T5ocke8UwavtgUHm+Cg: folds
MG90wfSJZnOejs/KD3vlQQ: folds
E2518gp4aFz1+kAgmGqeEg: folds
bxLSulbgr8LmKNjOzw8URg: folds
75K2MXwN65Sjfp1yHd50Hg: folds
zE9cVigS2nW/Ljy4K4bUQA: folds
KcY3X8YpD74Kw1RHkx/g4A: folds
8ehL7qlZzjgUh2H35iiWLw collected $0.50 from pot
8ehL7qlZzjgUh2H35iiWLw: doesn't show hand
*** SUMMARY ***
Total pot $0.50 | Rake $0
Seat 1: 8ehL7qlZzjgUh2H35iiWLw (big blind) collected ($0.50)
Seat 2: cCjTzH9jio8607WzjcfXlg folded before Flop (didn't bet)
Seat 3: +k7T5ocke8UwavtgUHm+Cg folded before Flop (didn't bet)
Seat 4: MG90wfSJZnOejs/KD3vlQQ folded before Flop (didn't bet)
Seat 5: E2518gp4aFz1+kAgmGqeEg folded before Flop (didn't bet)
Seat 6: bxLSulbgr8LmKNjOzw8URg folded before Flop (didn't bet)
Seat 7: 75K2MXwN65Sjfp1yHd50Hg folded before Flop (didn't bet)
Seat 8: zE9cVigS2nW/Ljy4K4bUQA (button) folded before Flop (didn't bet)
Seat 9: KcY3X8YpD74Kw1RHkx/g4A (small blind) folded before Flop



PokerStars Game #59940587296:  Hold'em No Limit ($0.25/$0.50) - 2009/07/01 1:10:51 ET
Table 'GfL/No5u5PoEnU39lP5pQg' 6-max Seat #6 is the button
Seat 1: 1WUCqNG+p+vfWRTXNu4ljw ($64.75 in chips)
Seat 2: uVwggSetzp7d+eVgowO3vg ($53 in chips)
Seat 3: 4pp9WxhGdbVbxCc9tlu0lw ($30 in chips)
Seat 4: r6u7MWSXF30/khcTYkrG9Q ($36.10 in chips)
Seat 5: M1KyQQvVPVuxqTAB8sR/zQ ($53.40 in chips)
Seat 6: kxPhs4ePFqMy52CInAJ2aw ($50.10 in chips)
1WUCqNG+p+vfWRTXNu4ljw: posts small blind $0.25
uVwggSetzp7d+eVgowO3vg: posts big blind $0.50
4pp9WxhGdbVbxCc9tlu0lw: posts big blind $0.50
*** HOLE CARDS ***
4pp9WxhGdbVbxCc9tlu0lw: checks
r6u7MWSXF30/khcTYkrG9Q: folds
M1KyQQvVPVuxqTAB8sR/zQ: folds
kxPhs4ePFqMy52CInAJ2aw: folds
1WUCqNG+p+vfWRTXNu4ljw: folds
uVwggSetzp7d+eVgowO3vg: checks
*** FLOP *** [Ks 8c Ah]
uVwggSetzp7d+eVgowO3vg: checks
4pp9WxhGdbVbxCc9tlu0lw: checks
*** TURN *** [Ks 8c Ah] [2d]
uVwggSetzp7d+eVgowO3vg: checks
4pp9WxhGdbVbxCc9tlu0lw: checks
*** RIVER *** [Ks 8c Ah 2d] [7h]
uVwggSetzp7d+eVgowO3vg: checks
4pp9WxhGdbVbxCc9tlu0lw: checks
*** SHOW DOWN ***
uVwggSetzp7d+eVgowO3vg: shows [Qh 8d] (a pair of Eights)
4pp9WxhGdbVbxCc9tlu0lw: mucks hand
uVwggSetzp7d+eVgowO3vg collected $1.20 from pot
*** SUMMARY ***
Total pot $1.25 | Rake $0.05
Board [Ks 8c Ah 2d 7h]
Seat 1: 1WUCqNG+p+vfWRTXNu4ljw (small blind) folded before Flop
Seat 2: uVwggSetzp7d+eVgowO3vg (big blind) showed [Qh 8d] and won ($1.20) with a pair of Eights
Seat 3: 4pp9WxhGdbVbxCc9tlu0lw mucked
Seat 4: r6u7MWSXF30/khcTYkrG9Q folded before Flop (didn't bet)
Seat 5: M1KyQQvVPVuxqTAB8sR/zQ folded before Flop (didn't bet)
Seat 6: kxPhs4ePFqMy52CInAJ2aw (button) folded before Flop (didn't bet)



PokerStars Game #59940587608:  Hold'em No Limit ($0.25/$0.50) - 2009/07/01 1:10:52 ET
Table '0eJtgVAXVvBgncFdcUpXcQ' 2-max Seat #1 is the button
Seat 1: Ag6DvxX4vbRheqsv2zXKTQ ($49.70 in chips)
Seat 2: KMc4R+K9ao4Ur3rF7NGe6Q ($4.40 in chips)
Ag6DvxX4vbRheqsv2zXKTQ: posts small blind $0.25
KMc4R+K9ao4Ur3rF7NGe6Q: posts big blind $0.50
*** HOLE CARDS ***
Ag6DvxX4vbRheqsv2zXKTQ: folds
KMc4R+K9ao4Ur3rF7NGe6Q collected $0.50 from pot
KMc4R+K9ao4Ur3rF7NGe6Q: doesn't show hand
*** SUMMARY ***
Total pot $0.50 | Rake $0
Seat 1: Ag6DvxX4vbRheqsv2zXKTQ (button) (small blind) folded before Flop
Seat 2: KMc4R+K9ao4Ur3rF7NGe6Q (big blind) collected ($0.50)



PokerStars Game #59940587688:  Hold'em No Limit ($0.25/$0.50) - 2009/07/01 1:10:52 ET
Table '+dXkOAQyS8j9PQZusUTMpg' 2-max Seat #2 is the button
Seat 1: XFa6sBGjP2gxoIvxR3fZIg ($116.30 in chips)
Seat 2: 5IBeOgaApY1Bvzv2P8X4EA ($78.60 in chips)
5IBeOgaApY1Bvzv2P8X4EA: posts small blind $0.25
XFa6sBGjP2gxoIvxR3fZIg: posts big blind $0.50
*** HOLE CARDS ***
5IBeOgaApY1Bvzv2P8X4EA: folds
XFa6sBGjP2gxoIvxR3fZIg collected $0.50 from pot
XFa6sBGjP2gxoIvxR3fZIg: doesn't show hand
*** SUMMARY ***
Total pot $0.50 | Rake $0
Seat 1: XFa6sBGjP2gxoIvxR3fZIg (big blind) collected ($0.50)
Seat 2: 5IBeOgaApY1Bvzv2P8X4EA (button) (small blind) folded before Flop



PokerStars Game #59940587652:  Hold'em No Limit ($0.25/$0.50) - 2009/07/01 1:10:52 ET
Table '8BQGgNetI1NOvWeu3gtMNw' 2-max Seat #2 is the button
Seat 1: bypIyrYcAAifLfhZpGlKLA ($107.30 in chips)
Seat 2: Z4HwehErEwzsv/noQlfUlg ($90 in chips)
Z4HwehErEwzsv/noQlfUlg: posts small blind $0.25
bypIyrYcAAifLfhZpGlKLA: posts big blind $0.50
*** HOLE CARDS ***
Z4HwehErEwzsv/noQlfUlg: raises $1.50 to $2
bypIyrYcAAifLfhZpGlKLA: calls $1.50
*** FLOP *** [4d Kc Ts]
bypIyrYcAAifLfhZpGlKLA: checks
Z4HwehErEwzsv/noQlfUlg: checks
*** TURN *** [4d Kc Ts] [9h]
bypIyrYcAAifLfhZpGlKLA: bets $3
Z4HwehErEwzsv/noQlfUlg: raises $3 to $6
bypIyrYcAAifLfhZpGlKLA: calls $3
*** RIVER *** [4d Kc Ts 9h] [7d]
bypIyrYcAAifLfhZpGlKLA: checks
Z4HwehErEwzsv/noQlfUlg: checks
*** SHOW DOWN ***
bypIyrYcAAifLfhZpGlKLA: shows [Td Ah] (a pair of Tens)
Z4HwehErEwzsv/noQlfUlg: mucks hand
bypIyrYcAAifLfhZpGlKLA collected $15.50 from pot
*** SUMMARY ***
Total pot $16 | Rake $0.50
Board [4d Kc Ts 9h 7d]
Seat 1: bypIyrYcAAifLfhZpGlKLA (big blind) showed [Td Ah] and won ($15.50) with a pair of Tens
Seat 2: Z4HwehErEwzsv/noQlfUlg (button) (small blind) mucked



PokerStars Game #59940587954:  Hold'em No Limit ($0.25/$0.50) - 2009/07/01 1:10:53 ET
Table 'tYh970kmVfYS0gXPT/XtoQ' 2-max Seat #1 is the button
Seat 1: CLj3pYZDnglQbP8AEHiYIw ($57.10 in chips)
Seat 2: fxN9bTdAgPNvNkHgbVXKGw ($12.10 in chips)
CLj3pYZDnglQbP8AEHiYIw: posts small blind $0.25
fxN9bTdAgPNvNkHgbVXKGw: posts big blind $0.50
*** HOLE CARDS ***
CLj3pYZDnglQbP8AEHiYIw: raises $1 to $1.50
fxN9bTdAgPNvNkHgbVXKGw: calls $1
*** FLOP *** [9s Ts 7d]
fxN9bTdAgPNvNkHgbVXKGw: bets $0.50
CLj3pYZDnglQbP8AEHiYIw: folds
fxN9bTdAgPNvNkHgbVXKGw collected $2.85 from pot
fxN9bTdAgPNvNkHgbVXKGw: doesn't show hand
*** SUMMARY ***
Total pot $3 | Rake $0.15
Board [9s Ts 7d]
Seat 1: CLj3pYZDnglQbP8AEHiYIw (button) (small blind) folded on the Flop
Seat 2: fxN9bTdAgPNvNkHgbVXKGw (big blind) collected ($2.85)



PokerStars Game #59940590054:  Hold'em No Limit ($0.25/$0.50) - 2009/07/01 1:10:56 ET
Table 'BCN5su+SsXiy1zRMJi0SJw' 6-max Seat #3 is the button
Seat 1: GxXV09ciXaOxyY2H5aMIIw ($53.40 in chips)
Seat 2: oU2kDCkT/gilYbHWrg7D8w ($42.45 in chips)
Seat 3: kwgv5lNhiFrfONXCshzxlA ($28.75 in chips)
Seat 4: 4QfsCWthT/vSLirorNXqtg ($50 in chips)
Seat 6: b2symlOdL7+0c9Pj4N/KlA ($59.35 in chips)
4QfsCWthT/vSLirorNXqtg: posts small blind $0.25
b2symlOdL7+0c9Pj4N/KlA: posts big blind $0.50
*** HOLE CARDS ***
GxXV09ciXaOxyY2H5aMIIw: folds
oU2kDCkT/gilYbHWrg7D8w: folds
kwgv5lNhiFrfONXCshzxlA: folds
4QfsCWthT/vSLirorNXqtg: folds
b2symlOdL7+0c9Pj4N/KlA collected $0.50 from pot
b2symlOdL7+0c9Pj4N/KlA: doesn't show hand
*** SUMMARY ***
Total pot $0.50 | Rake $0
Seat 1: GxXV09ciXaOxyY2H5aMIIw folded before Flop (didn't bet)
Seat 2: oU2kDCkT/gilYbHWrg7D8w folded before Flop (didn't bet)
Seat 3: kwgv5lNhiFrfONXCshzxlA (button) folded before Flop (didn't bet)
Seat 4: 4QfsCWthT/vSLirorNXqtg (small blind) folded before Flop
Seat 6: b2symlOdL7+0c9Pj4N/KlA (big blind) collected ($0.50)



PokerStars Game #59940590720:  Hold'em No Limit ($0.25/$0.50) - 2009/07/01 1:10:57 ET
Table '0eJtgVAXVvBgncFdcUpXcQ' 2-max Seat #2 is the button
Seat 1: Ag6DvxX4vbRheqsv2zXKTQ ($49.45 in chips)
Seat 2: KMc4R+K9ao4Ur3rF7NGe6Q ($4.65 in chips)
KMc4R+K9ao4Ur3rF7NGe6Q: posts small blind $0.25
Ag6DvxX4vbRheqsv2zXKTQ: posts big blind $0.50
*** HOLE CARDS ***
KMc4R+K9ao4Ur3rF7NGe6Q: raises $4.15 to $4.65 and is all-in
Ag6DvxX4vbRheqsv2zXKTQ: folds
KMc4R+K9ao4Ur3rF7NGe6Q collected $1 from pot
KMc4R+K9ao4Ur3rF7NGe6Q: doesn't show hand
*** SUMMARY ***
Total pot $1 | Rake $0
Seat 1: Ag6DvxX4vbRheqsv2zXKTQ (big blind) folded before Flop
Seat 2: KMc4R+K9ao4Ur3rF7NGe6Q (button) (small blind) collected ($1)



PokerStars Game #59940590660:  Hold'em No Limit ($0.25/$0.50) - 2009/07/01 1:10:57 ET
Table 'WlCrrUP9MxwySQN5fzLFBQ' 2-max Seat #2 is the button
Seat 1: AMDFA0ajpsTPOIGjeT0g0Q ($51.35 in chips)
Seat 2: I6jT30IIGKfk3BWwujd6WQ ($50 in chips)
I6jT30IIGKfk3BWwujd6WQ: posts small blind $0.25
AMDFA0ajpsTPOIGjeT0g0Q: posts big blind $0.50
*** HOLE CARDS ***
I6jT30IIGKfk3BWwujd6WQ: raises $1 to $1.50
AMDFA0ajpsTPOIGjeT0g0Q: raises $3.50 to $5
I6jT30IIGKfk3BWwujd6WQ: calls $3.50
*** FLOP *** [Qd 3d 5d]
AMDFA0ajpsTPOIGjeT0g0Q: bets $6.50
I6jT30IIGKfk3BWwujd6WQ: folds
AMDFA0ajpsTPOIGjeT0g0Q collected $9.50 from pot
AMDFA0ajpsTPOIGjeT0g0Q: doesn't show hand
*** SUMMARY ***
Total pot $10 | Rake $0.50
Board [Qd 3d 5d]
Seat 1: AMDFA0ajpsTPOIGjeT0g0Q (big blind) collected ($9.50)
Seat 2: I6jT30IIGKfk3BWwujd6WQ (button) (small blind) folded on the Flop



PokerStars Game #59940590322:  Hold'em No Limit ($0.25/$0.50) - 2009/07/01 1:10:57 ET
Table '37qXEp3oe+er5q4CZip9eQ' 6-max Seat #3 is the button
Seat 1: lxIzoHy0RnkfFSODHC2liw ($50 in chips)
Seat 2: LvH4G7n+QSjT6NDaD3cREA ($55.05 in chips)
Seat 3: Rt6KgtZ8YaJoTc3FPim00w ($109.45 in chips)
Seat 4: XsmE8nXMAAMFJbWaJTmHFw ($48.45 in chips)
Seat 5: VOmI0x4dDPnTESZd5B4d1Q ($42.50 in chips)
Seat 6: N50kln4negd8q7Mmoz1j4g ($10.05 in chips)
XsmE8nXMAAMFJbWaJTmHFw: posts small blind $0.25
VOmI0x4dDPnTESZd5B4d1Q: posts big blind $0.50
*** HOLE CARDS ***
N50kln4negd8q7Mmoz1j4g: calls $0.50
lxIzoHy0RnkfFSODHC2liw: folds
LvH4G7n+QSjT6NDaD3cREA: raises $1.50 to $2
Rt6KgtZ8YaJoTc3FPim00w: folds
XsmE8nXMAAMFJbWaJTmHFw: folds
VOmI0x4dDPnTESZd5B4d1Q: calls $1.50
N50kln4negd8q7Mmoz1j4g: folds
*** FLOP *** [4c Ts Td]
VOmI0x4dDPnTESZd5B4d1Q: checks
LvH4G7n+QSjT6NDaD3cREA: bets $2.50
VOmI0x4dDPnTESZd5B4d1Q: calls $2.50
*** TURN *** [4c Ts Td] [Tc]
VOmI0x4dDPnTESZd5B4d1Q: checks
LvH4G7n+QSjT6NDaD3cREA: bets $6
VOmI0x4dDPnTESZd5B4d1Q said, "sick"
VOmI0x4dDPnTESZd5B4d1Q: folds
LvH4G7n+QSjT6NDaD3cREA collected $9.30 from pot
LvH4G7n+QSjT6NDaD3cREA: doesn't show hand
*** SUMMARY ***
Total pot $9.75 | Rake $0.45
Board [4c Ts Td Tc]
Seat 1: lxIzoHy0RnkfFSODHC2liw folded before Flop (didn't bet)
Seat 2: LvH4G7n+QSjT6NDaD3cREA collected ($9.30)
Seat 3: Rt6KgtZ8YaJoTc3FPim00w (button) folded before Flop (didn't bet)
Seat 4: XsmE8nXMAAMFJbWaJTmHFw (small blind) folded before Flop
Seat 5: VOmI0x4dDPnTESZd5B4d1Q (big blind) folded on the Turn
Seat 6: N50kln4negd8q7Mmoz1j4g folded before Flop



PokerStars Game #59940591232:  Hold'em No Limit ($0.25/$0.50) - 2009/07/01 1:10:58 ET
Table '+dXkOAQyS8j9PQZusUTMpg' 2-max Seat #1 is the button
Seat 1: XFa6sBGjP2gxoIvxR3fZIg ($116.55 in chips)
Seat 2: 5IBeOgaApY1Bvzv2P8X4EA ($78.35 in chips)
XFa6sBGjP2gxoIvxR3fZIg: posts small blind $0.25
5IBeOgaApY1Bvzv2P8X4EA: posts big blind $0.50
*** HOLE CARDS ***
XFa6sBGjP2gxoIvxR3fZIg: raises $1 to $1.50
5IBeOgaApY1Bvzv2P8X4EA: folds
XFa6sBGjP2gxoIvxR3fZIg collected $1 from pot
XFa6sBGjP2gxoIvxR3fZIg: doesn't show hand
*** SUMMARY ***
Total pot $1 | Rake $0
Seat 1: XFa6sBGjP2gxoIvxR3fZIg (button) (small blind) collected ($1)
Seat 2: 5IBeOgaApY1Bvzv2P8X4EA (big blind) folded before Flop



PokerStars Game #59940592806:  Hold'em No Limit ($0.25/$0.50) - 2009/07/01 1:11:01 ET
Table 'c/CRn+68J3Y8KxD5g1ek2Q' 2-max Seat #2 is the button
Seat 1: 46qCyJ6evTkHo9al5sBMNA ($107.10 in chips)
Seat 2: BypVLsYQt3ePFm2xQL/dOA ($257.40 in chips)
BypVLsYQt3ePFm2xQL/dOA: posts small blind $0.25
46qCyJ6evTkHo9al5sBMNA: posts big blind $0.50
*** HOLE CARDS ***
BypVLsYQt3ePFm2xQL/dOA: calls $0.25
46qCyJ6evTkHo9al5sBMNA: checks
*** FLOP *** [Qc Kh Js]
46qCyJ6evTkHo9al5sBMNA: checks
BypVLsYQt3ePFm2xQL/dOA: bets $2
46qCyJ6evTkHo9al5sBMNA: folds
BypVLsYQt3ePFm2xQL/dOA collected $0.95 from pot
BypVLsYQt3ePFm2xQL/dOA: doesn't show hand
*** SUMMARY ***
Total pot $1 | Rake $0.05
Board [Qc Kh Js]
Seat 1: 46qCyJ6evTkHo9al5sBMNA (big blind) folded on the Flop
Seat 2: BypVLsYQt3ePFm2xQL/dOA (button) (small blind) collected ($0.95)



PokerStars Game #59940594686:  Hold'em No Limit ($0.25/$0.50) - 2009/07/01 1:11:04 ET
Table 'lSisgp6H7Fg1hH5VfjEjYQ' 9-max Seat #7 is the button
Seat 1: 5k9fvXD9suIgCxU4HLQjTw ($50.35 in chips)
Seat 2: UrcnkQOiLVk8BlKDPJSy7Q ($76.55 in chips)
Seat 3: aTkyjTh3w5YLWiIERupZOA ($48.40 in chips)
Seat 4: bwv/rbH/hHhPhY6u9mu04w ($34.60 in chips)
Seat 5: mSD1pginDsyHG5PDfqzphw ($10 in chips)
Seat 6: +k7T5ocke8UwavtgUHm+Cg ($65.30 in chips)
Seat 7: IDtNLR9uFCDdjNsJWMHA5Q ($18.80 in chips)
Seat 8: a4JDWmpFQkL10XfAyuF51A ($26.50 in chips)
Seat 9: YzeKFbJVLmJGTgNH3ySQlw ($14.75 in chips)
a4JDWmpFQkL10XfAyuF51A: posts small blind $0.25
YzeKFbJVLmJGTgNH3ySQlw: posts big blind $0.50
*** HOLE CARDS ***
5k9fvXD9suIgCxU4HLQjTw: raises $1 to $1.50
UrcnkQOiLVk8BlKDPJSy7Q: folds
aTkyjTh3w5YLWiIERupZOA: folds
bwv/rbH/hHhPhY6u9mu04w: folds
mSD1pginDsyHG5PDfqzphw: folds
+k7T5ocke8UwavtgUHm+Cg: calls $1.50
IDtNLR9uFCDdjNsJWMHA5Q: raises $17.30 to $18.80 and is all-in
a4JDWmpFQkL10XfAyuF51A: folds
YzeKFbJVLmJGTgNH3ySQlw: folds
5k9fvXD9suIgCxU4HLQjTw: folds
+k7T5ocke8UwavtgUHm+Cg: folds
IDtNLR9uFCDdjNsJWMHA5Q collected $5.25 from pot
*** SUMMARY ***
Total pot $5.25 | Rake $0
Seat 1: 5k9fvXD9suIgCxU4HLQjTw folded before Flop
Seat 2: UrcnkQOiLVk8BlKDPJSy7Q folded before Flop (didn't bet)
Seat 3: aTkyjTh3w5YLWiIERupZOA folded before Flop (didn't bet)
Seat 4: bwv/rbH/hHhPhY6u9mu04w folded before Flop (didn't bet)
Seat 5: mSD1pginDsyHG5PDfqzphw folded before Flop (didn't bet)
Seat 6: +k7T5ocke8UwavtgUHm+Cg folded before Flop
Seat 7: IDtNLR9uFCDdjNsJWMHA5Q (button) collected ($5.25)
Seat 8: a4JDWmpFQkL10XfAyuF51A (small blind) folded before Flop
Seat 9: YzeKFbJVLmJGTgNH3ySQlw (big blind) folded before Flop



PokerStars Game #59940595576:  Hold'em No Limit ($0.25/$0.50) - 2009/07/01 1:11:05 ET
Table 'tYh970kmVfYS0gXPT/XtoQ' 2-max Seat #2 is the button
Seat 1: CLj3pYZDnglQbP8AEHiYIw ($55.60 in chips)
Seat 2: fxN9bTdAgPNvNkHgbVXKGw ($13.45 in chips)
fxN9bTdAgPNvNkHgbVXKGw: posts small blind $0.25
CLj3pYZDnglQbP8AEHiYIw: posts big blind $0.50
*** HOLE CARDS ***
fxN9bTdAgPNvNkHgbVXKGw: calls $0.25
CLj3pYZDnglQbP8AEHiYIw: checks
*** FLOP *** [4s Jc 8d]
CLj3pYZDnglQbP8AEHiYIw: bets $1.50
fxN9bTdAgPNvNkHgbVXKGw: calls $1.50
*** TURN *** [4s Jc 8d] [3s]
CLj3pYZDnglQbP8AEHiYIw: bets $0.50
fxN9bTdAgPNvNkHgbVXKGw: calls $0.50
*** RIVER *** [4s Jc 8d 3s] [Qh]
CLj3pYZDnglQbP8AEHiYIw: checks
fxN9bTdAgPNvNkHgbVXKGw: checks
*** SHOW DOWN ***
CLj3pYZDnglQbP8AEHiYIw: shows [5h 6d] (high card Queen)
fxN9bTdAgPNvNkHgbVXKGw: shows [9h Ad] (high card Ace)
fxN9bTdAgPNvNkHgbVXKGw collected $4.80 from pot
*** SUMMARY ***
Total pot $5 | Rake $0.20
Board [4s Jc 8d 3s Qh]
Seat 1: CLj3pYZDnglQbP8AEHiYIw (big blind) showed [5h 6d] and lost with high card Queen
Seat 2: fxN9bTdAgPNvNkHgbVXKGw (button) (small blind) showed [9h Ad] and won ($4.80) with high card Ace



PokerStars Game #59940595600:  Hold'em No Limit ($0.25/$0.50) - 2009/07/01 1:11:06 ET
Table '0eJtgVAXVvBgncFdcUpXcQ' 2-max Seat #1 is the button
Seat 1: Ag6DvxX4vbRheqsv2zXKTQ ($48.95 in chips)
Seat 2: KMc4R+K9ao4Ur3rF7NGe6Q ($5.15 in chips)
Ag6DvxX4vbRheqsv2zXKTQ: posts small blind $0.25
KMc4R+K9ao4Ur3rF7NGe6Q: posts big blind $0.50
*** HOLE CARDS ***
Ag6DvxX4vbRheqsv2zXKTQ: folds
KMc4R+K9ao4Ur3rF7NGe6Q collected $0.50 from pot
KMc4R+K9ao4Ur3rF7NGe6Q: doesn't show hand
*** SUMMARY ***
Total pot $0.50 | Rake $0
Seat 1: Ag6DvxX4vbRheqsv2zXKTQ (button) (small blind) folded before Flop
Seat 2: KMc4R+K9ao4Ur3rF7NGe6Q (big blind) collected ($0.50)



PokerStars Game #59940595804:  Hold'em No Limit ($0.25/$0.50) - 2009/07/01 1:11:06 ET
Table 'NCiXr0d5CEKBQr/cZgLhbA' 9-max Seat #1 is the button
Seat 1: pFtzb1sR4b0d1aw6aIRgDg ($50.20 in chips)
Seat 3: xZCXQSXlrZkp3pZizzVXCw ($52.20 in chips)
Seat 4: 5k9fvXD9suIgCxU4HLQjTw ($52.45 in chips)
Seat 5: zE9cVigS2nW/Ljy4K4bUQA ($65.10 in chips)
Seat 6: SKnJuWHScqetA/qG5p+wCg ($30 in chips)
Seat 7: M+7+BTmX5vZatHVuoRB1nA ($52 in chips)
Seat 8: 1MJUKc3cc0QmUoz1JZLR2w ($49.30 in chips)
Seat 9: 4WLZvqBn5qv5tds5kt5A1Q ($56.05 in chips)
xZCXQSXlrZkp3pZizzVXCw: posts small blind $0.25
5k9fvXD9suIgCxU4HLQjTw: posts big blind $0.50
*** HOLE CARDS ***
zE9cVigS2nW/Ljy4K4bUQA: raises $0.50 to $1
SKnJuWHScqetA/qG5p+wCg: folds
M+7+BTmX5vZatHVuoRB1nA: folds
1MJUKc3cc0QmUoz1JZLR2w: folds
ulxuJchBV9iguXg0FUonfg said, "SKnJuWHScqetA/qG5p+wCg... lighten up bro"
4WLZvqBn5qv5tds5kt5A1Q: folds
pFtzb1sR4b0d1aw6aIRgDg: folds
ulxuJchBV9iguXg0FUonfg leaves the table
xZCXQSXlrZkp3pZizzVXCw: folds
AjV5McH1KMMclY26QdLM5w joins the table at seat #2
5k9fvXD9suIgCxU4HLQjTw: raises $3 to $4
zE9cVigS2nW/Ljy4K4bUQA: folds
5k9fvXD9suIgCxU4HLQjTw collected $2.25 from pot
*** SUMMARY ***
Total pot $2.25 | Rake $0
Seat 1: pFtzb1sR4b0d1aw6aIRgDg (button) folded before Flop (didn't bet)
Seat 3: xZCXQSXlrZkp3pZizzVXCw (small blind) folded before Flop
Seat 4: 5k9fvXD9suIgCxU4HLQjTw (big blind) collected ($2.25)
Seat 5: zE9cVigS2nW/Ljy4K4bUQA folded before Flop
Seat 6: SKnJuWHScqetA/qG5p+wCg folded before Flop (didn't bet)
Seat 7: M+7+BTmX5vZatHVuoRB1nA folded before Flop (didn't bet)
Seat 8: 1MJUKc3cc0QmUoz1JZLR2w folded before Flop (didn't bet)
Seat 9: 4WLZvqBn5qv5tds5kt5A1Q folded before Flop (didn't bet)



PokerStars Game #59940596264:  Hold'em No Limit ($0.25/$0.50) - 2009/07/01 1:11:07 ET
Table '+dXkOAQyS8j9PQZusUTMpg' 2-max Seat #2 is the button
Seat 1: XFa6sBGjP2gxoIvxR3fZIg ($117.05 in chips)
Seat 2: 5IBeOgaApY1Bvzv2P8X4EA ($77.85 in chips)
5IBeOgaApY1Bvzv2P8X4EA: posts small blind $0.25
XFa6sBGjP2gxoIvxR3fZIg: posts big blind $0.50
*** HOLE CARDS ***
5IBeOgaApY1Bvzv2P8X4EA: folds
XFa6sBGjP2gxoIvxR3fZIg collected $0.50 from pot
XFa6sBGjP2gxoIvxR3fZIg: doesn't show hand
*** SUMMARY ***
Total pot $0.50 | Rake $0
Seat 1: XFa6sBGjP2gxoIvxR3fZIg (big blind) collected ($0.50)
Seat 2: 5IBeOgaApY1Bvzv2P8X4EA (button) (small blind) folded before Flop



PokerStars Game #59940596156:  Hold'em No Limit ($0.25/$0.50) - 2009/07/01 1:11:07 ET
Table 'BCN5su+SsXiy1zRMJi0SJw' 6-max Seat #4 is the button
Seat 1: GxXV09ciXaOxyY2H5aMIIw ($53.40 in chips)
Seat 2: oU2kDCkT/gilYbHWrg7D8w ($42.45 in chips)
Seat 3: kwgv5lNhiFrfONXCshzxlA ($28.75 in chips)
Seat 4: 4QfsCWthT/vSLirorNXqtg ($50 in chips)
Seat 6: b2symlOdL7+0c9Pj4N/KlA ($59.60 in chips)
b2symlOdL7+0c9Pj4N/KlA: posts small blind $0.25
GxXV09ciXaOxyY2H5aMIIw: posts big blind $0.50
*** HOLE CARDS ***
oU2kDCkT/gilYbHWrg7D8w: folds
kwgv5lNhiFrfONXCshzxlA: folds
4QfsCWthT/vSLirorNXqtg: folds
b2symlOdL7+0c9Pj4N/KlA: raises $1.50 to $2
GxXV09ciXaOxyY2H5aMIIw: calls $1.50
*** FLOP *** [Tc 8h Jh]
b2symlOdL7+0c9Pj4N/KlA: bets $3
GxXV09ciXaOxyY2H5aMIIw: folds
b2symlOdL7+0c9Pj4N/KlA collected $3.80 from pot
b2symlOdL7+0c9Pj4N/KlA: doesn't show hand
*** SUMMARY ***
Total pot $4 | Rake $0.20
Board [Tc 8h Jh]
Seat 1: GxXV09ciXaOxyY2H5aMIIw (big blind) folded on the Flop
Seat 2: oU2kDCkT/gilYbHWrg7D8w folded before Flop (didn't bet)
Seat 3: kwgv5lNhiFrfONXCshzxlA folded before Flop (didn't bet)
Seat 4: 4QfsCWthT/vSLirorNXqtg (button) folded before Flop (didn't bet)
Seat 6: b2symlOdL7+0c9Pj4N/KlA (small blind) collected ($3.80)



PokerStars Game #59940596976:  Hold'em No Limit ($0.25/$0.50) - 2009/07/01 1:11:08 ET
Table '+z1aekfHkpp09pc8F9aViw' 6-max Seat #5 is the button
Seat 1: 7zFtlEn2NxyROFkJdZA/yg ($50 in chips)
Seat 2: 8EEqTTh7T1q48sYDqbI2Xg ($28.75 in chips)
Seat 3: uUznlIMFnRUvwrBhYF73KA ($141.40 in chips)
Seat 4: RowCSpSURHTOL/dcjg/Iug ($36.55 in chips)
Seat 5: rplyldNweS6YyMNEALQrug ($56.80 in chips)
Seat 6: 686aeHikcJlgKkSuIFdcXQ ($52.05 in chips)
686aeHikcJlgKkSuIFdcXQ: posts small blind $0.25
7zFtlEn2NxyROFkJdZA/yg: posts big blind $0.50
*** HOLE CARDS ***
8EEqTTh7T1q48sYDqbI2Xg: calls $0.50
uUznlIMFnRUvwrBhYF73KA: folds
RowCSpSURHTOL/dcjg/Iug: raises $1 to $1.50
rplyldNweS6YyMNEALQrug: folds
686aeHikcJlgKkSuIFdcXQ: folds
7zFtlEn2NxyROFkJdZA/yg: folds
8EEqTTh7T1q48sYDqbI2Xg: calls $1
*** FLOP *** [3d 4c 3c]
686aeHikcJlgKkSuIFdcXQ leaves the table
8EEqTTh7T1q48sYDqbI2Xg: bets $0.50
GUnvMULl2qFOO1yenu1UBw joins the table at seat #6
RowCSpSURHTOL/dcjg/Iug: calls $0.50
*** TURN *** [3d 4c 3c] [As]
8EEqTTh7T1q48sYDqbI2Xg: bets $1
RowCSpSURHTOL/dcjg/Iug: calls $1
*** RIVER *** [3d 4c 3c As] [7h]
8EEqTTh7T1q48sYDqbI2Xg: bets $1.50
RowCSpSURHTOL/dcjg/Iug: raises $2.50 to $4
8EEqTTh7T1q48sYDqbI2Xg: calls $2.50
*** SHOW DOWN ***
RowCSpSURHTOL/dcjg/Iug: shows [9s Ac] (two pair, Aces and Threes)
8EEqTTh7T1q48sYDqbI2Xg: mucks hand
8EEqTTh7T1q48sYDqbI2Xg is sitting out
RowCSpSURHTOL/dcjg/Iug collected $14.05 from pot
*** SUMMARY ***
Total pot $14.75 | Rake $0.70
Board [3d 4c 3c As 7h]
Seat 1: 7zFtlEn2NxyROFkJdZA/yg (big blind) folded before Flop
Seat 2: 8EEqTTh7T1q48sYDqbI2Xg mucked
Seat 3: uUznlIMFnRUvwrBhYF73KA folded before Flop (didn't bet)
Seat 4: RowCSpSURHTOL/dcjg/Iug showed [9s Ac] and won ($14.05) with two pair, Aces and Threes
Seat 5: rplyldNweS6YyMNEALQrug (button) folded before Flop (didn't bet)
Seat 6: 686aeHikcJlgKkSuIFdcXQ (small blind) folded before Flop



PokerStars Game #59940598384:  Hold'em No Limit ($0.25/$0.50) - 2009/07/01 1:11:10 ET
Table 'eMxdLyFDf28E0wit6gm3Uw' 6-max Seat #4 is the button
Seat 1: FONMraB4GCHzDwDcfciKyw ($50 in chips)
Seat 2: UEjiWqFckVmunpvV128Xfw ($55.65 in chips)
Seat 4: hPAFLRqGh8YnqPe3HMZiQg ($19.90 in chips)
Seat 5: OtITKlSIHBhVAjRe30+BBQ ($38.90 in chips)
Seat 6: lxIzoHy0RnkfFSODHC2liw ($50.75 in chips)
OtITKlSIHBhVAjRe30+BBQ: posts small blind $0.25
lxIzoHy0RnkfFSODHC2liw: posts big blind $0.50
*** HOLE CARDS ***
FONMraB4GCHzDwDcfciKyw: folds
FONMraB4GCHzDwDcfciKyw leaves the table
UEjiWqFckVmunpvV128Xfw: folds
hPAFLRqGh8YnqPe3HMZiQg: raises $1 to $1.50
OtITKlSIHBhVAjRe30+BBQ: calls $1.25
lxIzoHy0RnkfFSODHC2liw: folds
*** FLOP *** [8d Qs Ac]
OtITKlSIHBhVAjRe30+BBQ: checks
hPAFLRqGh8YnqPe3HMZiQg: bets $1
OtITKlSIHBhVAjRe30+BBQ: calls $1
*** TURN *** [8d Qs Ac] [9s]
OtITKlSIHBhVAjRe30+BBQ: checks
hPAFLRqGh8YnqPe3HMZiQg: checks
*** RIVER *** [8d Qs Ac 9s] [4d]
OtITKlSIHBhVAjRe30+BBQ: bets $1
hPAFLRqGh8YnqPe3HMZiQg: calls $1
*** SHOW DOWN ***
OtITKlSIHBhVAjRe30+BBQ: shows [Jc Qh] (a pair of Queens)
hPAFLRqGh8YnqPe3HMZiQg: mucks hand
OtITKlSIHBhVAjRe30+BBQ collected $7.15 from pot
*** SUMMARY ***
Total pot $7.50 | Rake $0.35
Board [8d Qs Ac 9s 4d]
Seat 1: FONMraB4GCHzDwDcfciKyw folded before Flop (didn't bet)
Seat 2: UEjiWqFckVmunpvV128Xfw folded before Flop (didn't bet)
Seat 4: hPAFLRqGh8YnqPe3HMZiQg (button) mucked
Seat 5: OtITKlSIHBhVAjRe30+BBQ (small blind) showed [Jc Qh] and won ($7.15) with a pair of Queens
Seat 6: lxIzoHy0RnkfFSODHC2liw (big blind) folded before Flop



PokerStars Game #59940598496:  Hold'em No Limit ($0.25/$0.50) - 2009/07/01 1:11:11 ET
Table 'PALRfuH85dr5IkDfdv6new' 9-max Seat #6 is the button
Seat 1: v/4aX0ejnaIFK4ftDk2Lyg ($49.50 in chips)
Seat 2: 1aXjSbrubyQKHeauooF5Wg ($41.90 in chips)
Seat 3: 50QWoELmpmHFrFIlWMJo9g ($91.50 in chips)
Seat 4: mZNMJI1mY40XTC0U7GZakA ($57.55 in chips)
Seat 5: jSSGUXdNFAZA3QCvTcUMQw ($62.20 in chips)
Seat 6: ottZQkg1UDWk85BtBzGJzg ($50.10 in chips)
Seat 7: 3NcyXvr39gnK+KbTq7ezyA ($62.80 in chips)
Seat 8: NkS+CseUKx4XHszWq0PXEQ ($74.65 in chips)
Seat 9: viwBDtJsY6JfsFOdBAyJIQ ($9.50 in chips)
3NcyXvr39gnK+KbTq7ezyA: posts small blind $0.25
NkS+CseUKx4XHszWq0PXEQ: posts big blind $0.50
*** HOLE CARDS ***
viwBDtJsY6JfsFOdBAyJIQ: folds
v/4aX0ejnaIFK4ftDk2Lyg: folds
1aXjSbrubyQKHeauooF5Wg: folds
50QWoELmpmHFrFIlWMJo9g: folds
mZNMJI1mY40XTC0U7GZakA: folds
jSSGUXdNFAZA3QCvTcUMQw: folds
ottZQkg1UDWk85BtBzGJzg: folds
3NcyXvr39gnK+KbTq7ezyA: calls $0.25
NkS+CseUKx4XHszWq0PXEQ: checks
*** FLOP *** [6d 4c Kd]
jSSGUXdNFAZA3QCvTcUMQw leaves the table
3NcyXvr39gnK+KbTq7ezyA: checks
qEn9ijNGtuyTxamBf07hYg joins the table at seat #5
NkS+CseUKx4XHszWq0PXEQ: checks
*** TURN *** [6d 4c Kd] [9c]
3NcyXvr39gnK+KbTq7ezyA: bets $1
NkS+CseUKx4XHszWq0PXEQ: calls $1
*** RIVER *** [6d 4c Kd 9c] [Qc]
3NcyXvr39gnK+KbTq7ezyA: bets $0.50
NkS+CseUKx4XHszWq0PXEQ: raises $2.50 to $3
3NcyXvr39gnK+KbTq7ezyA: folds
NkS+CseUKx4XHszWq0PXEQ collected $3.85 from pot
*** SUMMARY ***
Total pot $4 | Rake $0.15
Board [6d 4c Kd 9c Qc]
Seat 1: v/4aX0ejnaIFK4ftDk2Lyg folded before Flop (didn't bet)
Seat 2: 1aXjSbrubyQKHeauooF5Wg folded before Flop (didn't bet)
Seat 3: 50QWoELmpmHFrFIlWMJo9g folded before Flop (didn't bet)
Seat 4: mZNMJI1mY40XTC0U7GZakA folded before Flop (didn't bet)
Seat 5: jSSGUXdNFAZA3QCvTcUMQw folded before Flop (didn't bet)
Seat 6: ottZQkg1UDWk85BtBzGJzg (button) folded before Flop (didn't bet)
Seat 7: 3NcyXvr39gnK+KbTq7ezyA (small blind) folded on the River
Seat 8: NkS+CseUKx4XHszWq0PXEQ (big blind) collected ($3.85)
Seat 9: viwBDtJsY6JfsFOdBAyJIQ folded before Flop (didn't bet)



PokerStars Game #59940599048:  Hold'em No Limit ($0.25/$0.50) - 2009/07/01 1:11:11 ET
Table '0eJtgVAXVvBgncFdcUpXcQ' 2-max Seat #2 is the button
Seat 1: Ag6DvxX4vbRheqsv2zXKTQ ($48.70 in chips)
Seat 2: KMc4R+K9ao4Ur3rF7NGe6Q ($5.40 in chips)
KMc4R+K9ao4Ur3rF7NGe6Q: posts small blind $0.25
Ag6DvxX4vbRheqsv2zXKTQ: posts big blind $0.50
*** HOLE CARDS ***
KMc4R+K9ao4Ur3rF7NGe6Q: raises $4.90 to $5.40 and is all-in
Ag6DvxX4vbRheqsv2zXKTQ: folds
KMc4R+K9ao4Ur3rF7NGe6Q collected $1 from pot
KMc4R+K9ao4Ur3rF7NGe6Q: doesn't show hand
*** SUMMARY ***
Total pot $1 | Rake $0
Seat 1: Ag6DvxX4vbRheqsv2zXKTQ (big blind) folded before Flop
Seat 2: KMc4R+K9ao4Ur3rF7NGe6Q (button) (small blind) collected ($1)



PokerStars Game #59940602072:  Hold'em No Limit ($0.25/$0.50) - 2009/07/01 1:11:16 ET
Table 'kgbJRsxfv64KrErDRBAkcw' 6-max Seat #1 is the button
Seat 1: VamsyhlFzXGF6/ydo0BHeA ($42.35 in chips)
Seat 2: AdS8BJMOheS01zjCDfPMFg ($58.80 in chips)
Seat 3: c4MNIaIyPMOMxrgT8FT5nA ($126.30 in chips)
Seat 5: eUBBn2R56C1IQ6Cs/vitwg ($60.45 in chips)
Seat 6: 1b+2BbjMN8qhR1WPqdE9VQ ($57.35 in chips)
AdS8BJMOheS01zjCDfPMFg: posts small blind $0.25
c4MNIaIyPMOMxrgT8FT5nA: posts big blind $0.50
*** HOLE CARDS ***
eUBBn2R56C1IQ6Cs/vitwg: folds
1b+2BbjMN8qhR1WPqdE9VQ: folds
VamsyhlFzXGF6/ydo0BHeA: calls $0.50
AdS8BJMOheS01zjCDfPMFg: folds
c4MNIaIyPMOMxrgT8FT5nA: checks
*** FLOP *** [Qs 7h Ac]
c4MNIaIyPMOMxrgT8FT5nA: bets $2.50
VamsyhlFzXGF6/ydo0BHeA: folds
c4MNIaIyPMOMxrgT8FT5nA collected $1.20 from pot
c4MNIaIyPMOMxrgT8FT5nA: doesn't show hand
*** SUMMARY ***
Total pot $1.25 | Rake $0.05
Board [Qs 7h Ac]
Seat 1: VamsyhlFzXGF6/ydo0BHeA (button) folded on the Flop
Seat 2: AdS8BJMOheS01zjCDfPMFg (small blind) folded before Flop
Seat 3: c4MNIaIyPMOMxrgT8FT5nA (big blind) collected ($1.20)
Seat 5: eUBBn2R56C1IQ6Cs/vitwg folded before Flop (didn't bet)
Seat 6: 1b+2BbjMN8qhR1WPqdE9VQ folded before Flop (didn't bet)



PokerStars Game #59940602564:  Hold'em No Limit ($0.25/$0.50) - 2009/07/01 1:11:17 ET
Table '+dXkOAQyS8j9PQZusUTMpg' 2-max Seat #1 is the button
Seat 1: XFa6sBGjP2gxoIvxR3fZIg ($117.30 in chips)
Seat 2: 5IBeOgaApY1Bvzv2P8X4EA ($77.60 in chips)
XFa6sBGjP2gxoIvxR3fZIg: posts small blind $0.25
5IBeOgaApY1Bvzv2P8X4EA: posts big blind $0.50
*** HOLE CARDS ***
XFa6sBGjP2gxoIvxR3fZIg: raises $1 to $1.50
5IBeOgaApY1Bvzv2P8X4EA: calls $1
*** FLOP *** [8h Ks 5c]
5IBeOgaApY1Bvzv2P8X4EA: checks
XFa6sBGjP2gxoIvxR3fZIg: bets $2
5IBeOgaApY1Bvzv2P8X4EA: calls $2
*** TURN *** [8h Ks 5c] [Ah]
5IBeOgaApY1Bvzv2P8X4EA: checks
XFa6sBGjP2gxoIvxR3fZIg: checks
*** RIVER *** [8h Ks 5c Ah] [Ad]
5IBeOgaApY1Bvzv2P8X4EA: checks
XFa6sBGjP2gxoIvxR3fZIg: checks
*** SHOW DOWN ***
5IBeOgaApY1Bvzv2P8X4EA: shows [Kd 7d] (two pair, Aces and Kings)
XFa6sBGjP2gxoIvxR3fZIg: mucks hand
5IBeOgaApY1Bvzv2P8X4EA collected $6.70 from pot
*** SUMMARY ***
Total pot $7 | Rake $0.30
Board [8h Ks 5c Ah Ad]
Seat 1: XFa6sBGjP2gxoIvxR3fZIg (button) (small blind) mucked
Seat 2: 5IBeOgaApY1Bvzv2P8X4EA (big blind) showed [Kd 7d] and won ($6.70) with two pair, Aces and Kings



PokerStars Game #59940602514:  Hold'em No Limit ($0.25/$0.50) - 2009/07/01 1:11:17 ET
Table 'lpxYasB1ClBSgTpCCITwhQ' 9-max Seat #3 is the button
Seat 1: mj7PS7wCH4PAl7+eYTFs7A ($49.25 in chips)
Seat 2: OWP/DOu+PlPK6ZZ3zYa0HA ($25.85 in chips)
Seat 3: sakr/FIfFtIZwDPmAj5Pzg ($49.20 in chips)
Seat 4: NnQCepdIR/AOUQn1yhYx6Q ($9.50 in chips)
Seat 6: SegjDnMxWMujiD57ESNL+g ($11.35 in chips)
Seat 7: bmRtaIYKthN1F+B3JLZ3Jw ($74.85 in chips)
Seat 8: /mfensKw8/iZ1Vrx33S4xg ($19.50 in chips)
Seat 9: sUIUZ+begh92dzkUmvbMrw ($12.80 in chips)
NnQCepdIR/AOUQn1yhYx6Q: posts small blind $0.25
IYd5zG8k7vdBNVHbHg2Pag: is sitting out
SegjDnMxWMujiD57ESNL+g: posts big blind $0.50
*** HOLE CARDS ***
bmRtaIYKthN1F+B3JLZ3Jw said, "come on"
bmRtaIYKthN1F+B3JLZ3Jw: folds
bmRtaIYKthN1F+B3JLZ3Jw said, "no one plays with the wench?"
/mfensKw8/iZ1Vrx33S4xg: raises $1 to $1.50
sUIUZ+begh92dzkUmvbMrw: folds
mj7PS7wCH4PAl7+eYTFs7A: folds
OWP/DOu+PlPK6ZZ3zYa0HA: folds
sakr/FIfFtIZwDPmAj5Pzg: folds
NnQCepdIR/AOUQn1yhYx6Q: folds
SegjDnMxWMujiD57ESNL+g: folds
/mfensKw8/iZ1Vrx33S4xg collected $1.25 from pot
/mfensKw8/iZ1Vrx33S4xg: doesn't show hand
*** SUMMARY ***
Total pot $1.25 | Rake $0
Seat 1: mj7PS7wCH4PAl7+eYTFs7A folded before Flop (didn't bet)
Seat 2: OWP/DOu+PlPK6ZZ3zYa0HA folded before Flop (didn't bet)
Seat 3: sakr/FIfFtIZwDPmAj5Pzg (button) folded before Flop (didn't bet)
Seat 4: NnQCepdIR/AOUQn1yhYx6Q (small blind) folded before Flop
Seat 6: SegjDnMxWMujiD57ESNL+g (big blind) folded before Flop
Seat 7: bmRtaIYKthN1F+B3JLZ3Jw folded before Flop (didn't bet)
Seat 8: /mfensKw8/iZ1Vrx33S4xg collected ($1.25)
Seat 9: sUIUZ+begh92dzkUmvbMrw folded before Flop (didn't bet)



PokerStars Game #59940603164:  Hold'em No Limit ($0.25/$0.50) - 2009/07/01 1:11:18 ET
Table 'EiNh8p/wGJ1FP575iMFnqg' 9-max Seat #5 is the button
Seat 1: r3ZqM1Mi0W3y4hOdssE+Sg ($67.25 in chips)
Seat 2: 8ehL7qlZzjgUh2H35iiWLw ($54.15 in chips)
Seat 3: ymLPoEIl7UL3TvZYmnadxQ ($58.90 in chips)
Seat 4: cMzaiXAM/ZAdNaEUu+LqhA ($50 in chips)
Seat 5: M+7+BTmX5vZatHVuoRB1nA ($79.70 in chips)
Seat 6: 3UmXLy3GfjC3EkOebduerQ ($61.10 in chips)
Seat 7: 997ViqAtWn1FPjJqcffwcA ($50 in chips)
Seat 8: mSD1pginDsyHG5PDfqzphw ($10 in chips)
3UmXLy3GfjC3EkOebduerQ: posts small blind $0.25
997ViqAtWn1FPjJqcffwcA: posts big blind $0.50
GuPkZObrz5Zkkn8FsEdF9w: sits out
*** HOLE CARDS ***
mSD1pginDsyHG5PDfqzphw: folds
r3ZqM1Mi0W3y4hOdssE+Sg: folds
8ehL7qlZzjgUh2H35iiWLw: folds
ymLPoEIl7UL3TvZYmnadxQ: folds
cMzaiXAM/ZAdNaEUu+LqhA: folds
M+7+BTmX5vZatHVuoRB1nA: folds
3UmXLy3GfjC3EkOebduerQ: raises $1.50 to $2
997ViqAtWn1FPjJqcffwcA: folds
3UmXLy3GfjC3EkOebduerQ collected $1 from pot
3UmXLy3GfjC3EkOebduerQ: doesn't show hand
*** SUMMARY ***
Total pot $1 | Rake $0
Seat 1: r3ZqM1Mi0W3y4hOdssE+Sg folded before Flop (didn't bet)
Seat 2: 8ehL7qlZzjgUh2H35iiWLw folded before Flop (didn't bet)
Seat 3: ymLPoEIl7UL3TvZYmnadxQ folded before Flop (didn't bet)
Seat 4: cMzaiXAM/ZAdNaEUu+LqhA folded before Flop (didn't bet)
Seat 5: M+7+BTmX5vZatHVuoRB1nA (button) folded before Flop (didn't bet)
Seat 6: 3UmXLy3GfjC3EkOebduerQ (small blind) collected ($1)
Seat 7: 997ViqAtWn1FPjJqcffwcA (big blind) folded before Flop
Seat 8: mSD1pginDsyHG5PDfqzphw folded before Flop (didn't bet)



PokerStars Game #59940602868:  Hold'em No Limit ($0.25/$0.50) - 2009/07/01 1:11:18 ET
Table 'fx6MqwfYAj/Rt86hBz2L3Q' 9-max Seat #1 is the button
Seat 1: uw9QayAAxLM3Hb+HR7mSkg ($9.75 in chips)
Seat 2: C3rGXblctNcWI6JYPHhaEg ($35.50 in chips)
Seat 3: iadBi5AEt7gTBXbDSSnMYQ ($49.50 in chips)
Seat 5: iAISe3dVeua8PUn2wwgDHw ($66 in chips)
Seat 6: 5k9fvXD9suIgCxU4HLQjTw ($50 in chips)
Seat 7: SKnJuWHScqetA/qG5p+wCg ($30 in chips)
Seat 8: JYwJYYV9pM5KWdSiETl8rA ($29.75 in chips)
C3rGXblctNcWI6JYPHhaEg: posts small blind $0.25
iadBi5AEt7gTBXbDSSnMYQ: posts big blind $0.50
rFvc7K/96V9eGvYRfmpoUQ: sits out
*** HOLE CARDS ***
C3rGXblctNcWI6JYPHhaEg said, "lol"
iAISe3dVeua8PUn2wwgDHw: folds
5k9fvXD9suIgCxU4HLQjTw: raises $1 to $1.50
SKnJuWHScqetA/qG5p+wCg: folds
JYwJYYV9pM5KWdSiETl8rA: folds
uw9QayAAxLM3Hb+HR7mSkg: raises $8.25 to $9.75 and is all-in
C3rGXblctNcWI6JYPHhaEg: folds
iadBi5AEt7gTBXbDSSnMYQ: folds
5k9fvXD9suIgCxU4HLQjTw: folds
uw9QayAAxLM3Hb+HR7mSkg collected $3.75 from pot
uw9QayAAxLM3Hb+HR7mSkg: doesn't show hand
*** SUMMARY ***
Total pot $3.75 | Rake $0
Seat 1: uw9QayAAxLM3Hb+HR7mSkg (button) collected ($3.75)
Seat 2: C3rGXblctNcWI6JYPHhaEg (small blind) folded before Flop
Seat 3: iadBi5AEt7gTBXbDSSnMYQ (big blind) folded before Flop
Seat 5: iAISe3dVeua8PUn2wwgDHw folded before Flop (didn't bet)
Seat 6: 5k9fvXD9suIgCxU4HLQjTw folded before Flop
Seat 7: SKnJuWHScqetA/qG5p+wCg folded before Flop (didn't bet)
Seat 8: JYwJYYV9pM5KWdSiETl8rA folded before Flop (didn't bet)



PokerStars Game #59940603014:  Hold'em No Limit ($0.25/$0.50) - 2009/07/01 1:11:18 ET
Table 'MJxeZCzYELxiIsyUZyT0jw' 6-max Seat #5 is the button
Seat 1: +Pf9jTVizYlIo+woPvptfA ($50 in chips)
Seat 3: sIG4mp8tZEI+W4nKZNkkQA ($53.45 in chips)
Seat 4: alGiiQP/wwtYnfuXII+sgw ($62.35 in chips)
Seat 5: 3jvoOXNtXE90w2BdfNZwZQ ($52.30 in chips)
Seat 6: c0n4hrn20AML9qzyFC2E8Q ($61 in chips)
c0n4hrn20AML9qzyFC2E8Q: posts small blind $0.25
+Pf9jTVizYlIo+woPvptfA: posts big blind $0.50
*** HOLE CARDS ***
sIG4mp8tZEI+W4nKZNkkQA: folds
alGiiQP/wwtYnfuXII+sgw: folds
t3GiVMzqA9Svgr5Uol32cQ has returned
3jvoOXNtXE90w2BdfNZwZQ: folds
c0n4hrn20AML9qzyFC2E8Q: raises $1.50 to $2
+Pf9jTVizYlIo+woPvptfA: folds
c0n4hrn20AML9qzyFC2E8Q collected $1 from pot
c0n4hrn20AML9qzyFC2E8Q: doesn't show hand
*** SUMMARY ***
Total pot $1 | Rake $0
Seat 1: +Pf9jTVizYlIo+woPvptfA (big blind) folded before Flop
Seat 3: sIG4mp8tZEI+W4nKZNkkQA folded before Flop (didn't bet)
Seat 4: alGiiQP/wwtYnfuXII+sgw folded before Flop (didn't bet)
Seat 5: 3jvoOXNtXE90w2BdfNZwZQ (button) folded before Flop (didn't bet)
Seat 6: c0n4hrn20AML9qzyFC2E8Q (small blind) collected ($1)



PokerStars Game #59940603450:  Hold'em No Limit ($0.25/$0.50) - 2009/07/01 1:11:19 ET
Table '0eJtgVAXVvBgncFdcUpXcQ' 2-max Seat #1 is the button
Seat 1: Ag6DvxX4vbRheqsv2zXKTQ ($48.20 in chips)
Seat 2: KMc4R+K9ao4Ur3rF7NGe6Q ($5.90 in chips)
Ag6DvxX4vbRheqsv2zXKTQ: posts small blind $0.25
KMc4R+K9ao4Ur3rF7NGe6Q: posts big blind $0.50
*** HOLE CARDS ***
Ag6DvxX4vbRheqsv2zXKTQ: calls $0.25
KMc4R+K9ao4Ur3rF7NGe6Q: checks
*** FLOP *** [2c Kd Ad]
KMc4R+K9ao4Ur3rF7NGe6Q: checks
Ag6DvxX4vbRheqsv2zXKTQ: bets $1
KMc4R+K9ao4Ur3rF7NGe6Q: folds
Ag6DvxX4vbRheqsv2zXKTQ collected $0.95 from pot
*** SUMMARY ***
Total pot $1 | Rake $0.05
Board [2c Kd Ad]
Seat 1: Ag6DvxX4vbRheqsv2zXKTQ (button) (small blind) collected ($0.95)
Seat 2: KMc4R+K9ao4Ur3rF7NGe6Q (big blind) folded on the Flop



PokerStars Game #59940604920:  Hold'em No Limit ($0.25/$0.50) - 2009/07/01 1:11:21 ET
Table '5EmHi+fnatGQQShcNmzOZQ' 6-max Seat #4 is the button
Seat 1: My8WkRtGx5FW6rJ1I4R3hg ($45.85 in chips)
Seat 2: bfFjgAtIoAI+pUxUwFt3aQ ($38.10 in chips)
Seat 3: 1mYbhL8CU/QYqfVmFcaHDQ ($8 in chips)
Seat 4: 1b+2BbjMN8qhR1WPqdE9VQ ($54.15 in chips)
Seat 5: kxPhs4ePFqMy52CInAJ2aw ($93.35 in chips)
Seat 6: 686aeHikcJlgKkSuIFdcXQ ($134.85 in chips)
kxPhs4ePFqMy52CInAJ2aw: posts small blind $0.25
686aeHikcJlgKkSuIFdcXQ: posts big blind $0.50
*** HOLE CARDS ***
My8WkRtGx5FW6rJ1I4R3hg: calls $0.50
bfFjgAtIoAI+pUxUwFt3aQ: folds
1mYbhL8CU/QYqfVmFcaHDQ: raises $1 to $1.50
1b+2BbjMN8qhR1WPqdE9VQ: folds
kxPhs4ePFqMy52CInAJ2aw: folds
686aeHikcJlgKkSuIFdcXQ: calls $1
My8WkRtGx5FW6rJ1I4R3hg: calls $1
*** FLOP *** [7c 4h Qd]
686aeHikcJlgKkSuIFdcXQ: checks
My8WkRtGx5FW6rJ1I4R3hg: checks
1mYbhL8CU/QYqfVmFcaHDQ: bets $1
686aeHikcJlgKkSuIFdcXQ: folds
686aeHikcJlgKkSuIFdcXQ leaves the table
My8WkRtGx5FW6rJ1I4R3hg: folds
1mYbhL8CU/QYqfVmFcaHDQ collected $4.55 from pot
1mYbhL8CU/QYqfVmFcaHDQ: doesn't show hand
*** SUMMARY ***
Total pot $4.75 | Rake $0.20
Board [7c 4h Qd]
Seat 1: My8WkRtGx5FW6rJ1I4R3hg folded on the Flop
Seat 2: bfFjgAtIoAI+pUxUwFt3aQ folded before Flop (didn't bet)
Seat 3: 1mYbhL8CU/QYqfVmFcaHDQ collected ($4.55)
Seat 4: 1b+2BbjMN8qhR1WPqdE9VQ (button) folded before Flop (didn't bet)
Seat 5: kxPhs4ePFqMy52CInAJ2aw (small blind) folded before Flop
Seat 6: 686aeHikcJlgKkSuIFdcXQ (big blind) folded on the Flop



PokerStars Game #59940605106:  Hold'em No Limit ($0.25/$0.50) - 2009/07/01 1:11:22 ET
Table 'otvGDROEDdqsabxskT79qg' 9-max Seat #9 is the button
Seat 1: 8ehL7qlZzjgUh2H35iiWLw ($60 in chips)
Seat 2: cCjTzH9jio8607WzjcfXlg ($13.20 in chips)
Seat 3: +k7T5ocke8UwavtgUHm+Cg ($70.60 in chips)
Seat 4: MG90wfSJZnOejs/KD3vlQQ ($75.90 in chips)
Seat 5: E2518gp4aFz1+kAgmGqeEg ($11.75 in chips)
Seat 6: bxLSulbgr8LmKNjOzw8URg ($56 in chips)
Seat 7: 75K2MXwN65Sjfp1yHd50Hg ($9.25 in chips)
Seat 8: zE9cVigS2nW/Ljy4K4bUQA ($30 in chips)
Seat 9: KcY3X8YpD74Kw1RHkx/g4A ($47.15 in chips)
8ehL7qlZzjgUh2H35iiWLw: posts small blind $0.25
cCjTzH9jio8607WzjcfXlg: posts big blind $0.50
*** HOLE CARDS ***
+k7T5ocke8UwavtgUHm+Cg: folds
MG90wfSJZnOejs/KD3vlQQ: folds
E2518gp4aFz1+kAgmGqeEg: folds
bxLSulbgr8LmKNjOzw8URg: folds
75K2MXwN65Sjfp1yHd50Hg: folds
zE9cVigS2nW/Ljy4K4bUQA: folds
KcY3X8YpD74Kw1RHkx/g4A: folds
8ehL7qlZzjgUh2H35iiWLw: folds
cCjTzH9jio8607WzjcfXlg collected $0.50 from pot
*** SUMMARY ***
Total pot $0.50 | Rake $0
Seat 1: 8ehL7qlZzjgUh2H35iiWLw (small blind) folded before Flop
Seat 2: cCjTzH9jio8607WzjcfXlg (big blind) collected ($0.50)
Seat 3: +k7T5ocke8UwavtgUHm+Cg folded before Flop (didn't bet)
Seat 4: MG90wfSJZnOejs/KD3vlQQ folded before Flop (didn't bet)
Seat 5: E2518gp4aFz1+kAgmGqeEg folded before Flop (didn't bet)
Seat 6: bxLSulbgr8LmKNjOzw8URg folded before Flop (didn't bet)
Seat 7: 75K2MXwN65Sjfp1yHd50Hg folded before Flop (didn't bet)
Seat 8: zE9cVigS2nW/Ljy4K4bUQA folded before Flop (didn't bet)
Seat 9: KcY3X8YpD74Kw1RHkx/g4A (button) folded before Flop (didn't bet)



PokerStars Game #59940605846:  Hold'em No Limit ($0.25/$0.50) - 2009/07/01 1:11:23 ET
Table 'c/CRn+68J3Y8KxD5g1ek2Q' 2-max Seat #1 is the button
Seat 1: 46qCyJ6evTkHo9al5sBMNA ($106.60 in chips)
Seat 2: BypVLsYQt3ePFm2xQL/dOA ($257.85 in chips)
46qCyJ6evTkHo9al5sBMNA: posts small blind $0.25
BypVLsYQt3ePFm2xQL/dOA: posts big blind $0.50
*** HOLE CARDS ***
46qCyJ6evTkHo9al5sBMNA: raises $1.50 to $2
BypVLsYQt3ePFm2xQL/dOA: raises $5.50 to $7.50
46qCyJ6evTkHo9al5sBMNA: raises $13.50 to $21
BypVLsYQt3ePFm2xQL/dOA: folds
46qCyJ6evTkHo9al5sBMNA collected $15 from pot
46qCyJ6evTkHo9al5sBMNA: doesn't show hand
*** SUMMARY ***
Total pot $15 | Rake $0
Seat 1: 46qCyJ6evTkHo9al5sBMNA (button) (small blind) collected ($15)
Seat 2: BypVLsYQt3ePFm2xQL/dOA (big blind) folded before Flop



PokerStars Game #59940606452:  Hold'em No Limit ($0.25/$0.50) - 2009/07/01 1:11:24 ET
Table 'QOgaEqMcJ73pcUMMxoisUg' 6-max Seat #4 is the button
Seat 1: lxIzoHy0RnkfFSODHC2liw ($50 in chips)
Seat 2: oqOqoO2AyCZenUghCxMDxw ($65 in chips)
Seat 3: Rt6KgtZ8YaJoTc3FPim00w ($53.75 in chips)
Seat 4: zAcsDhG/T128Vn7XGVSgKg ($59.90 in chips)
Seat 5: 6vNxrjjCl6FwfaaymM9jjg ($20.95 in chips)
Seat 6: AdS8BJMOheS01zjCDfPMFg ($50 in chips)
6vNxrjjCl6FwfaaymM9jjg: posts small blind $0.25
AdS8BJMOheS01zjCDfPMFg: posts big blind $0.50
*** HOLE CARDS ***
lxIzoHy0RnkfFSODHC2liw: folds
oqOqoO2AyCZenUghCxMDxw: folds
Rt6KgtZ8YaJoTc3FPim00w: folds
zAcsDhG/T128Vn7XGVSgKg: folds
6vNxrjjCl6FwfaaymM9jjg: calls $0.25
AdS8BJMOheS01zjCDfPMFg: raises $1 to $1.50
6vNxrjjCl6FwfaaymM9jjg: calls $1
*** FLOP *** [8s 2h 4s]
6vNxrjjCl6FwfaaymM9jjg: checks
AdS8BJMOheS01zjCDfPMFg: bets $1.50
6vNxrjjCl6FwfaaymM9jjg: raises $1.50 to $3
AdS8BJMOheS01zjCDfPMFg: calls $1.50
*** TURN *** [8s 2h 4s] [Jd]
6vNxrjjCl6FwfaaymM9jjg: checks
AdS8BJMOheS01zjCDfPMFg: bets $5.50
6vNxrjjCl6FwfaaymM9jjg: folds
AdS8BJMOheS01zjCDfPMFg collected $8.60 from pot
*** SUMMARY ***
Total pot $9 | Rake $0.40
Board [8s 2h 4s Jd]
Seat 1: lxIzoHy0RnkfFSODHC2liw folded before Flop (didn't bet)
Seat 2: oqOqoO2AyCZenUghCxMDxw folded before Flop (didn't bet)
Seat 3: Rt6KgtZ8YaJoTc3FPim00w folded before Flop (didn't bet)
Seat 4: zAcsDhG/T128Vn7XGVSgKg (button) folded before Flop (didn't bet)
Seat 5: 6vNxrjjCl6FwfaaymM9jjg (small blind) folded on the Turn
Seat 6: AdS8BJMOheS01zjCDfPMFg (big blind) collected ($8.60)



PokerStars Game #59940606794:  Hold'em No Limit ($0.25/$0.50) - 2009/07/01 1:11:24 ET
Table '/cQuAT3ef4t+PGrXiNhGaQ' 9-max Seat #7 is the button
Seat 1: HZkVla4kK2SI42CVrPZ/ig ($14.25 in chips)
Seat 2: jXGruyaMqirTaTXNOvBdew ($68.20 in chips)
Seat 3: g4k0NXISyLCqaSWZDBjfEg ($55.35 in chips)
Seat 4: OWP/DOu+PlPK6ZZ3zYa0HA ($27.60 in chips)
Seat 5: 5SgaHdWixdClWvaEG+KUjQ ($39.10 in chips)
Seat 6: APYIOyK/4AGb+kIwlOUNBQ ($36.10 in chips)
Seat 7: J0W5D97jl5VLky+IoPvDeA ($167.75 in chips)
Seat 8: eBrej2jnlUCs/JgxFCRn2g ($42.50 in chips)
Seat 9: AjV5McH1KMMclY26QdLM5w ($26.95 in chips)
eBrej2jnlUCs/JgxFCRn2g: posts small blind $0.25
AjV5McH1KMMclY26QdLM5w: posts big blind $0.50
*** HOLE CARDS ***
HZkVla4kK2SI42CVrPZ/ig: folds
jXGruyaMqirTaTXNOvBdew: calls $0.50
g4k0NXISyLCqaSWZDBjfEg: folds
OWP/DOu+PlPK6ZZ3zYa0HA: raises $1.50 to $2
5SgaHdWixdClWvaEG+KUjQ: calls $2
APYIOyK/4AGb+kIwlOUNBQ: folds
J0W5D97jl5VLky+IoPvDeA: folds
eBrej2jnlUCs/JgxFCRn2g: folds
AjV5McH1KMMclY26QdLM5w: calls $1.50
jXGruyaMqirTaTXNOvBdew: folds
*** FLOP *** [9s Jc 3h]
AjV5McH1KMMclY26QdLM5w: bets $1
OWP/DOu+PlPK6ZZ3zYa0HA: raises $3.50 to $4.50
5SgaHdWixdClWvaEG+KUjQ: folds
AjV5McH1KMMclY26QdLM5w: folds
OWP/DOu+PlPK6ZZ3zYa0HA collected $8.35 from pot
*** SUMMARY ***
Total pot $8.75 | Rake $0.40
Board [9s Jc 3h]
Seat 1: HZkVla4kK2SI42CVrPZ/ig folded before Flop (didn't bet)
Seat 2: jXGruyaMqirTaTXNOvBdew folded before Flop
Seat 3: g4k0NXISyLCqaSWZDBjfEg folded before Flop (didn't bet)
Seat 4: OWP/DOu+PlPK6ZZ3zYa0HA collected ($8.35)
Seat 5: 5SgaHdWixdClWvaEG+KUjQ folded on the Flop
Seat 6: APYIOyK/4AGb+kIwlOUNBQ folded before Flop (didn't bet)
Seat 7: J0W5D97jl5VLky+IoPvDeA (button) folded before Flop (didn't bet)
Seat 8: eBrej2jnlUCs/JgxFCRn2g (small blind) folded before Flop
Seat 9: AjV5McH1KMMclY26QdLM5w (big blind) folded on the Flop



PokerStars Game #59940606978:  Hold'em No Limit ($0.25/$0.50) - 2009/07/01 1:11:25 ET
Table 'tYh970kmVfYS0gXPT/XtoQ' 2-max Seat #1 is the button
Seat 1: CLj3pYZDnglQbP8AEHiYIw ($53.10 in chips)
Seat 2: fxN9bTdAgPNvNkHgbVXKGw ($15.75 in chips)
CLj3pYZDnglQbP8AEHiYIw: posts small blind $0.25
fxN9bTdAgPNvNkHgbVXKGw: posts big blind $0.50
*** HOLE CARDS ***
CLj3pYZDnglQbP8AEHiYIw: calls $0.25
fxN9bTdAgPNvNkHgbVXKGw: checks
*** FLOP *** [Jd 4h 4c]
fxN9bTdAgPNvNkHgbVXKGw: checks
CLj3pYZDnglQbP8AEHiYIw: checks
*** TURN *** [Jd 4h 4c] [8s]
fxN9bTdAgPNvNkHgbVXKGw: checks
CLj3pYZDnglQbP8AEHiYIw: checks
*** RIVER *** [Jd 4h 4c 8s] [5s]
fxN9bTdAgPNvNkHgbVXKGw: checks
CLj3pYZDnglQbP8AEHiYIw: checks
*** SHOW DOWN ***
fxN9bTdAgPNvNkHgbVXKGw: shows [7c 2c] (a pair of Fours)
CLj3pYZDnglQbP8AEHiYIw: shows [Th 6s] (a pair of Fours - Jack+Ten kicker)
CLj3pYZDnglQbP8AEHiYIw collected $0.95 from pot
*** SUMMARY ***
Total pot $1 | Rake $0.05
Board [Jd 4h 4c 8s 5s]
Seat 1: CLj3pYZDnglQbP8AEHiYIw (button) (small blind) showed [Th 6s] and won ($0.95) with a pair of Fours
Seat 2: fxN9bTdAgPNvNkHgbVXKGw (big blind) showed [7c 2c] and lost with a pair of Fours



PokerStars Game #59940608470:  Hold'em No Limit ($0.25/$0.50) - 2009/07/01 1:11:27 ET
Table '8BQGgNetI1NOvWeu3gtMNw' 2-max Seat #1 is the button
Seat 1: bypIyrYcAAifLfhZpGlKLA ($114.80 in chips)
Seat 2: Z4HwehErEwzsv/noQlfUlg ($82 in chips)
bypIyrYcAAifLfhZpGlKLA: posts small blind $0.25
Z4HwehErEwzsv/noQlfUlg: posts big blind $0.50
*** HOLE CARDS ***
bypIyrYcAAifLfhZpGlKLA: raises $1 to $1.50
Z4HwehErEwzsv/noQlfUlg: raises $2.50 to $4
bypIyrYcAAifLfhZpGlKLA: calls $2.50
*** FLOP *** [9d Qs Jd]
Z4HwehErEwzsv/noQlfUlg: bets $4
bypIyrYcAAifLfhZpGlKLA: folds
Z4HwehErEwzsv/noQlfUlg collected $7.60 from pot
Z4HwehErEwzsv/noQlfUlg: doesn't show hand
*** SUMMARY ***
Total pot $8 | Rake $0.40
Board [9d Qs Jd]
Seat 1: bypIyrYcAAifLfhZpGlKLA (button) (small blind) folded on the Flop
Seat 2: Z4HwehErEwzsv/noQlfUlg (big blind) collected ($7.60)



PokerStars Game #59940609152:  Hold'em No Limit ($0.25/$0.50) - 2009/07/01 1:11:29 ET
Table 'ibNfFy0bCzuBaUORla0aGw' 9-max Seat #6 is the button
Seat 1: xZCXQSXlrZkp3pZizzVXCw ($50.55 in chips)
Seat 2: 90Wb75h3W1BRpbqVnuk8gw ($50 in chips)
Seat 3: AjV5McH1KMMclY26QdLM5w ($25 in chips)
Seat 4: YBN054X4blmis+B2bBlC0g ($22.65 in chips)
Seat 5: GIJAc9kPrLZHLSX8Q6i99w ($21.70 in chips)
Seat 6: H8cPaCtX7d6meGUVSM5sxw ($48.75 in chips)
Seat 7: HZkVla4kK2SI42CVrPZ/ig ($14 in chips)
Seat 9: pFtzb1sR4b0d1aw6aIRgDg ($55.75 in chips)
HZkVla4kK2SI42CVrPZ/ig: posts small blind $0.25
2CfOMUqXsQk69Igusq28Pg: is sitting out
pFtzb1sR4b0d1aw6aIRgDg: posts big blind $0.50
*** HOLE CARDS ***
2CfOMUqXsQk69Igusq28Pg leaves the table
viwBDtJsY6JfsFOdBAyJIQ joins the table at seat #8
xZCXQSXlrZkp3pZizzVXCw has timed out
xZCXQSXlrZkp3pZizzVXCw: folds
xZCXQSXlrZkp3pZizzVXCw is sitting out
90Wb75h3W1BRpbqVnuk8gw: folds
xZCXQSXlrZkp3pZizzVXCw has returned
AjV5McH1KMMclY26QdLM5w: folds
YBN054X4blmis+B2bBlC0g: folds
GIJAc9kPrLZHLSX8Q6i99w: folds
H8cPaCtX7d6meGUVSM5sxw: folds
HZkVla4kK2SI42CVrPZ/ig: folds
pFtzb1sR4b0d1aw6aIRgDg collected $0.50 from pot
pFtzb1sR4b0d1aw6aIRgDg: doesn't show hand
*** SUMMARY ***
Total pot $0.50 | Rake $0
Seat 1: xZCXQSXlrZkp3pZizzVXCw folded before Flop (didn't bet)
Seat 2: 90Wb75h3W1BRpbqVnuk8gw folded before Flop (didn't bet)
Seat 3: AjV5McH1KMMclY26QdLM5w folded before Flop (didn't bet)
Seat 4: YBN054X4blmis+B2bBlC0g folded before Flop (didn't bet)
Seat 5: GIJAc9kPrLZHLSX8Q6i99w folded before Flop (didn't bet)
Seat 6: H8cPaCtX7d6meGUVSM5sxw (button) folded before Flop (didn't bet)
Seat 7: HZkVla4kK2SI42CVrPZ/ig (small blind) folded before Flop
Seat 9: pFtzb1sR4b0d1aw6aIRgDg (big blind) collected ($0.50)



PokerStars Game #59940611298:  Hold'em No Limit ($0.25/$0.50) - 2009/07/01 1:11:32 ET
Table 'E7bWJ45aoFXRpyRv2gw+Ig' 2-max Seat #2 is the button
Seat 1: FRkiRasEGlHUeLrEl+k/nA ($22.35 in chips)
Seat 2: 3Wro85I7472vJ4Wkpneo9A ($195.35 in chips)
3Wro85I7472vJ4Wkpneo9A: posts small blind $0.25
FRkiRasEGlHUeLrEl+k/nA: posts big blind $0.50
*** HOLE CARDS ***
3Wro85I7472vJ4Wkpneo9A: calls $0.25
FRkiRasEGlHUeLrEl+k/nA: raises $21.85 to $22.35 and is all-in
3Wro85I7472vJ4Wkpneo9A: folds
FRkiRasEGlHUeLrEl+k/nA collected $1 from pot
*** SUMMARY ***
Total pot $1 | Rake $0
Seat 1: FRkiRasEGlHUeLrEl+k/nA (big blind) collected ($1)
Seat 2: 3Wro85I7472vJ4Wkpneo9A (button) (small blind) folded before Flop



PokerStars Game #59940611438:  Hold'em No Limit ($0.25/$0.50) - 2009/07/01 1:11:33 ET
Table '0eJtgVAXVvBgncFdcUpXcQ' 2-max Seat #2 is the button
Seat 1: Ag6DvxX4vbRheqsv2zXKTQ ($48.65 in chips)
Seat 2: KMc4R+K9ao4Ur3rF7NGe6Q ($5.40 in chips)
KMc4R+K9ao4Ur3rF7NGe6Q: posts small blind $0.25
Ag6DvxX4vbRheqsv2zXKTQ: posts big blind $0.50
*** HOLE CARDS ***
KMc4R+K9ao4Ur3rF7NGe6Q: folds
Ag6DvxX4vbRheqsv2zXKTQ collected $0.50 from pot
*** SUMMARY ***
Total pot $0.50 | Rake $0
Seat 1: Ag6DvxX4vbRheqsv2zXKTQ (big blind) collected ($0.50)
Seat 2: KMc4R+K9ao4Ur3rF7NGe6Q (button) (small blind) folded before Flop



PokerStars Game #59940611638:  Hold'em No Limit ($0.25/$0.50) - 2009/07/01 1:11:33 ET
Table 'lSisgp6H7Fg1hH5VfjEjYQ' 9-max Seat #8 is the button
Seat 1: 5k9fvXD9suIgCxU4HLQjTw ($50 in chips)
Seat 2: UrcnkQOiLVk8BlKDPJSy7Q ($76.55 in chips)
Seat 3: aTkyjTh3w5YLWiIERupZOA ($48.40 in chips)
Seat 4: bwv/rbH/hHhPhY6u9mu04w ($34.60 in chips)
Seat 5: mSD1pginDsyHG5PDfqzphw ($10 in chips)
Seat 6: +k7T5ocke8UwavtgUHm+Cg ($63.80 in chips)
Seat 7: IDtNLR9uFCDdjNsJWMHA5Q ($22.55 in chips)
Seat 8: a4JDWmpFQkL10XfAyuF51A ($26.25 in chips)
Seat 9: YzeKFbJVLmJGTgNH3ySQlw ($14.25 in chips)
YzeKFbJVLmJGTgNH3ySQlw: posts small blind $0.25
5k9fvXD9suIgCxU4HLQjTw: posts big blind $0.50
*** HOLE CARDS ***
UrcnkQOiLVk8BlKDPJSy7Q: folds
aTkyjTh3w5YLWiIERupZOA: folds
bwv/rbH/hHhPhY6u9mu04w: raises $1 to $1.50
mSD1pginDsyHG5PDfqzphw: folds
+k7T5ocke8UwavtgUHm+Cg: folds
IDtNLR9uFCDdjNsJWMHA5Q: folds
a4JDWmpFQkL10XfAyuF51A: folds
YzeKFbJVLmJGTgNH3ySQlw: folds
5k9fvXD9suIgCxU4HLQjTw: folds
bwv/rbH/hHhPhY6u9mu04w collected $1.25 from pot
*** SUMMARY ***
Total pot $1.25 | Rake $0
Seat 1: 5k9fvXD9suIgCxU4HLQjTw (big blind) folded before Flop
Seat 2: UrcnkQOiLVk8BlKDPJSy7Q folded before Flop (didn't bet)
Seat 3: aTkyjTh3w5YLWiIERupZOA folded before Flop (didn't bet)
Seat 4: bwv/rbH/hHhPhY6u9mu04w collected ($1.25)
Seat 5: mSD1pginDsyHG5PDfqzphw folded before Flop (didn't bet)
Seat 6: +k7T5ocke8UwavtgUHm+Cg folded before Flop (didn't bet)
Seat 7: IDtNLR9uFCDdjNsJWMHA5Q folded before Flop (didn't bet)
Seat 8: a4JDWmpFQkL10XfAyuF51A (button) folded before Flop (didn't bet)
Seat 9: YzeKFbJVLmJGTgNH3ySQlw (small blind) folded before Flop



PokerStars Game #59940613658:  Hold'em No Limit ($0.25/$0.50) - 2009/07/01 1:11:36 ET
Table 'hSTs/dUsYLgJQuF2Onp0MQ' 6-max Seat #2 is the button
Seat 1: 1WUCqNG+p+vfWRTXNu4ljw ($50 in chips)
Seat 2: 6vNxrjjCl6FwfaaymM9jjg ($69 in chips)
Seat 3: C3qJBo7uxfFVDluE1lmK2w ($16.60 in chips)
Seat 4: L0aIPg7qefDQjdJo3HCVEA ($10.05 in chips)
Seat 5: 686aeHikcJlgKkSuIFdcXQ ($57.15 in chips)
Seat 6: M1KyQQvVPVuxqTAB8sR/zQ ($79.65 in chips)
C3qJBo7uxfFVDluE1lmK2w: posts small blind $0.25
L0aIPg7qefDQjdJo3HCVEA: posts big blind $0.50
*** HOLE CARDS ***
686aeHikcJlgKkSuIFdcXQ: folds
M1KyQQvVPVuxqTAB8sR/zQ: folds
686aeHikcJlgKkSuIFdcXQ leaves the table
1WUCqNG+p+vfWRTXNu4ljw: raises $1.50 to $2
6vNxrjjCl6FwfaaymM9jjg: raises $6 to $8
C3qJBo7uxfFVDluE1lmK2w: folds
IBNygaT1aa9Z1uPdJJilwA joins the table at seat #5
L0aIPg7qefDQjdJo3HCVEA: folds
1WUCqNG+p+vfWRTXNu4ljw: calls $6
*** FLOP *** [Kd 9h 5h]
1WUCqNG+p+vfWRTXNu4ljw: checks
6vNxrjjCl6FwfaaymM9jjg: bets $16
1WUCqNG+p+vfWRTXNu4ljw: folds
6vNxrjjCl6FwfaaymM9jjg collected $15.95 from pot
*** SUMMARY ***
Total pot $16.75 | Rake $0.80
Board [Kd 9h 5h]
Seat 1: 1WUCqNG+p+vfWRTXNu4ljw folded on the Flop
Seat 2: 6vNxrjjCl6FwfaaymM9jjg (button) collected ($15.95)
Seat 3: C3qJBo7uxfFVDluE1lmK2w (small blind) folded before Flop
Seat 4: L0aIPg7qefDQjdJo3HCVEA (big blind) folded before Flop
Seat 5: 686aeHikcJlgKkSuIFdcXQ folded before Flop (didn't bet)
Seat 6: M1KyQQvVPVuxqTAB8sR/zQ folded before Flop (didn't bet)



PokerStars Game #59940614084:  Hold'em No Limit ($0.25/$0.50) - 2009/07/01 1:11:37 ET
Table 'X6IRCRTh+20gjz8aubWnwA' 9-max Seat #7 is the button
Seat 1: DSM67hHHq1XFoEOi9p8Alw ($56 in chips)
Seat 2: HZkVla4kK2SI42CVrPZ/ig ($6.80 in chips)
Seat 3: SWv01peOe69QQRvhQTqjQw ($6 in chips)
Seat 4: M3JFBNQ8Bbw3FBZ/18MuXw ($25.70 in chips)
Seat 5: NnQCepdIR/AOUQn1yhYx6Q ($9.25 in chips)
Seat 6: 75K2MXwN65Sjfp1yHd50Hg ($10.45 in chips)
Seat 7: cFHQjKQOOKTUzoilhrXHLg ($13.15 in chips)
Seat 8: HxeBVq06/3Bh/H986sgdbw ($51 in chips)
Seat 9: M+7+BTmX5vZatHVuoRB1nA ($43.75 in chips)
HxeBVq06/3Bh/H986sgdbw: posts small blind $0.25
M+7+BTmX5vZatHVuoRB1nA: posts big blind $0.50
*** HOLE CARDS ***
DSM67hHHq1XFoEOi9p8Alw: folds
HZkVla4kK2SI42CVrPZ/ig: folds
SWv01peOe69QQRvhQTqjQw: calls $0.50
M3JFBNQ8Bbw3FBZ/18MuXw: folds
NnQCepdIR/AOUQn1yhYx6Q: folds
75K2MXwN65Sjfp1yHd50Hg: raises $2 to $2.50
cFHQjKQOOKTUzoilhrXHLg: folds
HxeBVq06/3Bh/H986sgdbw: folds
M+7+BTmX5vZatHVuoRB1nA: folds
SWv01peOe69QQRvhQTqjQw: folds
75K2MXwN65Sjfp1yHd50Hg collected $1.75 from pot
75K2MXwN65Sjfp1yHd50Hg: doesn't show hand
*** SUMMARY ***
Total pot $1.75 | Rake $0
Seat 1: DSM67hHHq1XFoEOi9p8Alw folded before Flop (didn't bet)
Seat 2: HZkVla4kK2SI42CVrPZ/ig folded before Flop (didn't bet)
Seat 3: SWv01peOe69QQRvhQTqjQw folded before Flop
Seat 4: M3JFBNQ8Bbw3FBZ/18MuXw folded before Flop (didn't bet)
Seat 5: NnQCepdIR/AOUQn1yhYx6Q folded before Flop (didn't bet)
Seat 6: 75K2MXwN65Sjfp1yHd50Hg collected ($1.75)
Seat 7: cFHQjKQOOKTUzoilhrXHLg (button) folded before Flop (didn't bet)
Seat 8: HxeBVq06/3Bh/H986sgdbw (small blind) folded before Flop
Seat 9: M+7+BTmX5vZatHVuoRB1nA (big blind) folded before Flop



PokerStars Game #59940614304:  Hold'em No Limit ($0.25/$0.50) - 2009/07/01 1:11:38 ET
Table 'BCN5su+SsXiy1zRMJi0SJw' 6-max Seat #6 is the button
Seat 1: GxXV09ciXaOxyY2H5aMIIw ($51.40 in chips)
Seat 2: oU2kDCkT/gilYbHWrg7D8w ($42.45 in chips)
Seat 3: kwgv5lNhiFrfONXCshzxlA ($28.75 in chips)
Seat 4: 4QfsCWthT/vSLirorNXqtg ($50 in chips)
Seat 6: b2symlOdL7+0c9Pj4N/KlA ($61.40 in chips)
GxXV09ciXaOxyY2H5aMIIw: posts small blind $0.25
oU2kDCkT/gilYbHWrg7D8w: posts big blind $0.50
*** HOLE CARDS ***
kwgv5lNhiFrfONXCshzxlA: folds
4QfsCWthT/vSLirorNXqtg: folds
cEMJmfAUQZmMChZe6aacKw joins the table at seat #5
b2symlOdL7+0c9Pj4N/KlA: folds
GxXV09ciXaOxyY2H5aMIIw: folds
oU2kDCkT/gilYbHWrg7D8w collected $0.50 from pot
*** SUMMARY ***
Total pot $0.50 | Rake $0
Seat 1: GxXV09ciXaOxyY2H5aMIIw (small blind) folded before Flop
Seat 2: oU2kDCkT/gilYbHWrg7D8w (big blind) collected ($0.50)
Seat 3: kwgv5lNhiFrfONXCshzxlA folded before Flop (didn't bet)
Seat 4: 4QfsCWthT/vSLirorNXqtg folded before Flop (didn't bet)
Seat 6: b2symlOdL7+0c9Pj4N/KlA (button) folded before Flop (didn't bet)



PokerStars Game #59940614938:  Hold'em No Limit ($0.25/$0.50) - 2009/07/01 1:11:39 ET
Table '0eJtgVAXVvBgncFdcUpXcQ' 2-max Seat #1 is the button
Seat 1: Ag6DvxX4vbRheqsv2zXKTQ ($48.90 in chips)
Seat 2: KMc4R+K9ao4Ur3rF7NGe6Q ($5.15 in chips)
Ag6DvxX4vbRheqsv2zXKTQ: posts small blind $0.25
KMc4R+K9ao4Ur3rF7NGe6Q: posts big blind $0.50
*** HOLE CARDS ***
Ag6DvxX4vbRheqsv2zXKTQ: calls $0.25
KMc4R+K9ao4Ur3rF7NGe6Q: checks
*** FLOP *** [Qd 7s Ks]
KMc4R+K9ao4Ur3rF7NGe6Q: checks
Ag6DvxX4vbRheqsv2zXKTQ: bets $1
KMc4R+K9ao4Ur3rF7NGe6Q: calls $1
*** TURN *** [Qd 7s Ks] [7h]
KMc4R+K9ao4Ur3rF7NGe6Q: checks
Ag6DvxX4vbRheqsv2zXKTQ: checks
*** RIVER *** [Qd 7s Ks 7h] [4c]
KMc4R+K9ao4Ur3rF7NGe6Q: bets $3.65 and is all-in
Ag6DvxX4vbRheqsv2zXKTQ: folds
KMc4R+K9ao4Ur3rF7NGe6Q collected $2.90 from pot
KMc4R+K9ao4Ur3rF7NGe6Q: doesn't show hand
*** SUMMARY ***
Total pot $3 | Rake $0.10
Board [Qd 7s Ks 7h 4c]
Seat 1: Ag6DvxX4vbRheqsv2zXKTQ (button) (small blind) folded on the River
Seat 2: KMc4R+K9ao4Ur3rF7NGe6Q (big blind) collected ($2.90)



PokerStars Game #59940615100:  Hold'em No Limit ($0.25/$0.50) - 2009/07/01 1:11:39 ET
Table '+dXkOAQyS8j9PQZusUTMpg' 2-max Seat #2 is the button
Seat 1: XFa6sBGjP2gxoIvxR3fZIg ($113.80 in chips)
Seat 2: 5IBeOgaApY1Bvzv2P8X4EA ($80.80 in chips)
5IBeOgaApY1Bvzv2P8X4EA: posts small blind $0.25
XFa6sBGjP2gxoIvxR3fZIg: posts big blind $0.50
*** HOLE CARDS ***
5IBeOgaApY1Bvzv2P8X4EA: calls $0.25
XFa6sBGjP2gxoIvxR3fZIg: raises $2 to $2.50
5IBeOgaApY1Bvzv2P8X4EA: calls $2
*** FLOP *** [Kd 2c 2h]
XFa6sBGjP2gxoIvxR3fZIg: bets $3.50
5IBeOgaApY1Bvzv2P8X4EA: folds
XFa6sBGjP2gxoIvxR3fZIg collected $4.75 from pot
XFa6sBGjP2gxoIvxR3fZIg: doesn't show hand
*** SUMMARY ***
Total pot $5 | Rake $0.25
Board [Kd 2c 2h]
Seat 1: XFa6sBGjP2gxoIvxR3fZIg (big blind) collected ($4.75)
Seat 2: 5IBeOgaApY1Bvzv2P8X4EA (button) (small blind) folded on the Flop



PokerStars Game #59940615766:  Hold'em No Limit ($0.25/$0.50) - 2009/07/01 1:11:40 ET
Table 'tYh970kmVfYS0gXPT/XtoQ' 2-max Seat #2 is the button
Seat 1: CLj3pYZDnglQbP8AEHiYIw ($53.55 in chips)
Seat 2: fxN9bTdAgPNvNkHgbVXKGw ($15.25 in chips)
fxN9bTdAgPNvNkHgbVXKGw: posts small blind $0.25
CLj3pYZDnglQbP8AEHiYIw: posts big blind $0.50
*** HOLE CARDS ***
fxN9bTdAgPNvNkHgbVXKGw: calls $0.25
CLj3pYZDnglQbP8AEHiYIw: checks
*** FLOP *** [Td 4c 7d]
CLj3pYZDnglQbP8AEHiYIw: checks
fxN9bTdAgPNvNkHgbVXKGw: checks
*** TURN *** [Td 4c 7d] [6s]
CLj3pYZDnglQbP8AEHiYIw: checks
fxN9bTdAgPNvNkHgbVXKGw: bets $0.50
CLj3pYZDnglQbP8AEHiYIw: folds
fxN9bTdAgPNvNkHgbVXKGw collected $0.95 from pot
fxN9bTdAgPNvNkHgbVXKGw: doesn't show hand
*** SUMMARY ***
Total pot $1 | Rake $0.05
Board [Td 4c 7d 6s]
Seat 1: CLj3pYZDnglQbP8AEHiYIw (big blind) folded on the Turn
Seat 2: fxN9bTdAgPNvNkHgbVXKGw (button) (small blind) collected ($0.95)



PokerStars Game #59940616030:  Hold'em No Limit ($0.25/$0.50) - 2009/07/01 1:11:41 ET
Table 'MJxeZCzYELxiIsyUZyT0jw' 6-max Seat #6 is the button
Seat 1: +Pf9jTVizYlIo+woPvptfA ($50 in chips)
Seat 2: t3GiVMzqA9Svgr5Uol32cQ ($27.10 in chips)
Seat 3: sIG4mp8tZEI+W4nKZNkkQA ($53.45 in chips)
Seat 4: alGiiQP/wwtYnfuXII+sgw ($62.35 in chips)
Seat 5: 3jvoOXNtXE90w2BdfNZwZQ ($52.30 in chips)
Seat 6: c0n4hrn20AML9qzyFC2E8Q ($61.50 in chips)
+Pf9jTVizYlIo+woPvptfA: posts small blind $0.25
t3GiVMzqA9Svgr5Uol32cQ: posts big blind $0.50
*** HOLE CARDS ***
sIG4mp8tZEI+W4nKZNkkQA: folds
alGiiQP/wwtYnfuXII+sgw: folds
3jvoOXNtXE90w2BdfNZwZQ: folds
c0n4hrn20AML9qzyFC2E8Q: folds
+Pf9jTVizYlIo+woPvptfA: folds
t3GiVMzqA9Svgr5Uol32cQ collected $0.50 from pot
*** SUMMARY ***
Total pot $0.50 | Rake $0
Seat 1: +Pf9jTVizYlIo+woPvptfA (small blind) folded before Flop
Seat 2: t3GiVMzqA9Svgr5Uol32cQ (big blind) collected ($0.50)
Seat 3: sIG4mp8tZEI+W4nKZNkkQA folded before Flop (didn't bet)
Seat 4: alGiiQP/wwtYnfuXII+sgw folded before Flop (didn't bet)
Seat 5: 3jvoOXNtXE90w2BdfNZwZQ folded before Flop (didn't bet)
Seat 6: c0n4hrn20AML9qzyFC2E8Q (button) folded before Flop (didn't bet)



PokerStars Game #59940617426:  Hold'em No Limit ($0.25/$0.50) - 2009/07/01 1:11:43 ET
Table 'GfL/No5u5PoEnU39lP5pQg' 6-max Seat #1 is the button
Seat 1: 1WUCqNG+p+vfWRTXNu4ljw ($64.50 in chips)
Seat 2: uVwggSetzp7d+eVgowO3vg ($53.70 in chips)
Seat 3: 4pp9WxhGdbVbxCc9tlu0lw ($29.50 in chips)
Seat 4: r6u7MWSXF30/khcTYkrG9Q ($36.10 in chips)
Seat 5: M1KyQQvVPVuxqTAB8sR/zQ ($53.40 in chips)
Seat 6: kxPhs4ePFqMy52CInAJ2aw ($50.10 in chips)
uVwggSetzp7d+eVgowO3vg: posts small blind $0.25
4pp9WxhGdbVbxCc9tlu0lw: posts big blind $0.50
*** HOLE CARDS ***
r6u7MWSXF30/khcTYkrG9Q: raises $1 to $1.50
M1KyQQvVPVuxqTAB8sR/zQ: folds
kxPhs4ePFqMy52CInAJ2aw: raises $4.50 to $6
1WUCqNG+p+vfWRTXNu4ljw: folds
uVwggSetzp7d+eVgowO3vg: folds
4pp9WxhGdbVbxCc9tlu0lw: folds
r6u7MWSXF30/khcTYkrG9Q: calls $4.50
*** FLOP *** [8c 5s 3d]
r6u7MWSXF30/khcTYkrG9Q: checks
kxPhs4ePFqMy52CInAJ2aw: bets $8
r6u7MWSXF30/khcTYkrG9Q: calls $8
*** TURN *** [8c 5s 3d] [4h]
r6u7MWSXF30/khcTYkrG9Q: checks
kxPhs4ePFqMy52CInAJ2aw: checks
*** RIVER *** [8c 5s 3d 4h] [Qs]
r6u7MWSXF30/khcTYkrG9Q: checks
kxPhs4ePFqMy52CInAJ2aw: bets $36.10 and is all-in
r6u7MWSXF30/khcTYkrG9Q: folds
kxPhs4ePFqMy52CInAJ2aw collected $27.35 from pot
*** SUMMARY ***
Total pot $28.75 | Rake $1.40
Board [8c 5s 3d 4h Qs]
Seat 1: 1WUCqNG+p+vfWRTXNu4ljw (button) folded before Flop (didn't bet)
Seat 2: uVwggSetzp7d+eVgowO3vg (small blind) folded before Flop
Seat 3: 4pp9WxhGdbVbxCc9tlu0lw (big blind) folded before Flop
Seat 4: r6u7MWSXF30/khcTYkrG9Q folded on the River
Seat 5: M1KyQQvVPVuxqTAB8sR/zQ folded before Flop (didn't bet)
Seat 6: kxPhs4ePFqMy52CInAJ2aw collected ($27.35)



PokerStars Game #59940619270:  Hold'em No Limit ($0.25/$0.50) - 2009/07/01 1:11:46 ET
Table 'c/CRn+68J3Y8KxD5g1ek2Q' 2-max Seat #2 is the button
Seat 1: 46qCyJ6evTkHo9al5sBMNA ($114.10 in chips)
Seat 2: BypVLsYQt3ePFm2xQL/dOA ($250.35 in chips)
BypVLsYQt3ePFm2xQL/dOA: posts small blind $0.25
46qCyJ6evTkHo9al5sBMNA: posts big blind $0.50
*** HOLE CARDS ***
BypVLsYQt3ePFm2xQL/dOA: calls $0.25
46qCyJ6evTkHo9al5sBMNA: checks
*** FLOP *** [Qh 6c 2h]
46qCyJ6evTkHo9al5sBMNA: bets $1.50
BypVLsYQt3ePFm2xQL/dOA: folds
46qCyJ6evTkHo9al5sBMNA collected $0.95 from pot
46qCyJ6evTkHo9al5sBMNA: doesn't show hand
*** SUMMARY ***
Total pot $1 | Rake $0.05
Board [Qh 6c 2h]
Seat 1: 46qCyJ6evTkHo9al5sBMNA (big blind) collected ($0.95)
Seat 2: BypVLsYQt3ePFm2xQL/dOA (button) (small blind) folded on the Flop



PokerStars Game #59940619690:  Hold'em No Limit ($0.25/$0.50) - 2009/07/01 1:11:47 ET
Table 'fx6MqwfYAj/Rt86hBz2L3Q' 9-max Seat #2 is the button
Seat 1: uw9QayAAxLM3Hb+HR7mSkg ($12 in chips)
Seat 2: C3rGXblctNcWI6JYPHhaEg ($35.25 in chips)
Seat 3: iadBi5AEt7gTBXbDSSnMYQ ($49 in chips)
Seat 5: iAISe3dVeua8PUn2wwgDHw ($66 in chips)
Seat 6: 5k9fvXD9suIgCxU4HLQjTw ($50 in chips)
Seat 7: SKnJuWHScqetA/qG5p+wCg ($30 in chips)
Seat 8: JYwJYYV9pM5KWdSiETl8rA ($29.75 in chips)
iadBi5AEt7gTBXbDSSnMYQ: posts small blind $0.25
iAISe3dVeua8PUn2wwgDHw: posts big blind $0.50
rFvc7K/96V9eGvYRfmpoUQ: sits out
*** HOLE CARDS ***
5k9fvXD9suIgCxU4HLQjTw: folds
SKnJuWHScqetA/qG5p+wCg: folds
JYwJYYV9pM5KWdSiETl8rA: folds
uw9QayAAxLM3Hb+HR7mSkg: folds
C3rGXblctNcWI6JYPHhaEg: raises $0.75 to $1.25
iadBi5AEt7gTBXbDSSnMYQ: folds
iAISe3dVeua8PUn2wwgDHw: folds
C3rGXblctNcWI6JYPHhaEg collected $1.25 from pot
C3rGXblctNcWI6JYPHhaEg: doesn't show hand
*** SUMMARY ***
Total pot $1.25 | Rake $0
Seat 1: uw9QayAAxLM3Hb+HR7mSkg folded before Flop (didn't bet)
Seat 2: C3rGXblctNcWI6JYPHhaEg (button) collected ($1.25)
Seat 3: iadBi5AEt7gTBXbDSSnMYQ (small blind) folded before Flop
Seat 5: iAISe3dVeua8PUn2wwgDHw (big blind) folded before Flop
Seat 6: 5k9fvXD9suIgCxU4HLQjTw folded before Flop (didn't bet)
Seat 7: SKnJuWHScqetA/qG5p+wCg folded before Flop (didn't bet)
Seat 8: JYwJYYV9pM5KWdSiETl8rA folded before Flop (didn't bet)



PokerStars Game #59940620472:  Hold'em No Limit ($0.25/$0.50) - 2009/07/01 1:11:48 ET
Table 'lpxYasB1ClBSgTpCCITwhQ' 9-max Seat #4 is the button
Seat 1: mj7PS7wCH4PAl7+eYTFs7A ($49.25 in chips)
Seat 2: OWP/DOu+PlPK6ZZ3zYa0HA ($25.85 in chips)
Seat 3: sakr/FIfFtIZwDPmAj5Pzg ($49.20 in chips)
Seat 4: NnQCepdIR/AOUQn1yhYx6Q ($9.25 in chips)
Seat 6: SegjDnMxWMujiD57ESNL+g ($10.85 in chips)
Seat 7: bmRtaIYKthN1F+B3JLZ3Jw ($74.85 in chips)
Seat 8: /mfensKw8/iZ1Vrx33S4xg ($20.25 in chips)
Seat 9: sUIUZ+begh92dzkUmvbMrw ($12.80 in chips)
SegjDnMxWMujiD57ESNL+g: posts small blind $0.25
bmRtaIYKthN1F+B3JLZ3Jw: posts big blind $0.50
*** HOLE CARDS ***
/mfensKw8/iZ1Vrx33S4xg: calls $0.50
sUIUZ+begh92dzkUmvbMrw: folds
mj7PS7wCH4PAl7+eYTFs7A: folds
OWP/DOu+PlPK6ZZ3zYa0HA: folds
sakr/FIfFtIZwDPmAj5Pzg: folds
NnQCepdIR/AOUQn1yhYx6Q: folds
SegjDnMxWMujiD57ESNL+g: calls $0.25
bmRtaIYKthN1F+B3JLZ3Jw: checks
*** FLOP *** [8h 8c 4c]
SegjDnMxWMujiD57ESNL+g: checks
bmRtaIYKthN1F+B3JLZ3Jw: checks
/mfensKw8/iZ1Vrx33S4xg: bets $1
SegjDnMxWMujiD57ESNL+g: calls $1
bmRtaIYKthN1F+B3JLZ3Jw: folds
*** TURN *** [8h 8c 4c] [4h]
SegjDnMxWMujiD57ESNL+g: checks
/mfensKw8/iZ1Vrx33S4xg: bets $1
SegjDnMxWMujiD57ESNL+g: calls $1
*** RIVER *** [8h 8c 4c 4h] [Ks]
SegjDnMxWMujiD57ESNL+g: bets $8.35 and is all-in
/mfensKw8/iZ1Vrx33S4xg: folds
SegjDnMxWMujiD57ESNL+g collected $5.25 from pot
SegjDnMxWMujiD57ESNL+g: doesn't show hand
*** SUMMARY ***
Total pot $5.50 | Rake $0.25
Board [8h 8c 4c 4h Ks]
Seat 1: mj7PS7wCH4PAl7+eYTFs7A folded before Flop (didn't bet)
Seat 2: OWP/DOu+PlPK6ZZ3zYa0HA folded before Flop (didn't bet)
Seat 3: sakr/FIfFtIZwDPmAj5Pzg folded before Flop (didn't bet)
Seat 4: NnQCepdIR/AOUQn1yhYx6Q (button) folded before Flop (didn't bet)
Seat 6: SegjDnMxWMujiD57ESNL+g (small blind) collected ($5.25)
Seat 7: bmRtaIYKthN1F+B3JLZ3Jw (big blind) folded on the Flop
Seat 8: /mfensKw8/iZ1Vrx33S4xg folded on the River
Seat 9: sUIUZ+begh92dzkUmvbMrw folded before Flop (didn't bet)



PokerStars Game #59940620682:  Hold'em No Limit ($0.25/$0.50) - 2009/07/01 1:11:48 ET
Table 'lSisgp6H7Fg1hH5VfjEjYQ' 9-max Seat #9 is the button
Seat 1: 5k9fvXD9suIgCxU4HLQjTw ($50 in chips)
Seat 2: UrcnkQOiLVk8BlKDPJSy7Q ($76.55 in chips)
Seat 3: aTkyjTh3w5YLWiIERupZOA ($48.40 in chips)
Seat 4: bwv/rbH/hHhPhY6u9mu04w ($35.35 in chips)
Seat 5: mSD1pginDsyHG5PDfqzphw ($10 in chips)
Seat 6: +k7T5ocke8UwavtgUHm+Cg ($63.80 in chips)
Seat 7: IDtNLR9uFCDdjNsJWMHA5Q ($22.55 in chips)
Seat 8: a4JDWmpFQkL10XfAyuF51A ($26.25 in chips)
Seat 9: YzeKFbJVLmJGTgNH3ySQlw ($14 in chips)
5k9fvXD9suIgCxU4HLQjTw: posts small blind $0.25
UrcnkQOiLVk8BlKDPJSy7Q: posts big blind $0.50
*** HOLE CARDS ***
aTkyjTh3w5YLWiIERupZOA: folds
bwv/rbH/hHhPhY6u9mu04w: folds
mSD1pginDsyHG5PDfqzphw: folds
+k7T5ocke8UwavtgUHm+Cg: raises $1 to $1.50
IDtNLR9uFCDdjNsJWMHA5Q: folds
a4JDWmpFQkL10XfAyuF51A: folds
YzeKFbJVLmJGTgNH3ySQlw: calls $1.50
5k9fvXD9suIgCxU4HLQjTw: folds
UrcnkQOiLVk8BlKDPJSy7Q: folds
*** FLOP *** [2c 2d 4c]
+k7T5ocke8UwavtgUHm+Cg: bets $2.50
YzeKFbJVLmJGTgNH3ySQlw: folds
+k7T5ocke8UwavtgUHm+Cg collected $3.60 from pot
+k7T5ocke8UwavtgUHm+Cg: doesn't show hand
*** SUMMARY ***
Total pot $3.75 | Rake $0.15
Board [2c 2d 4c]
Seat 1: 5k9fvXD9suIgCxU4HLQjTw (small blind) folded before Flop
Seat 2: UrcnkQOiLVk8BlKDPJSy7Q (big blind) folded before Flop
Seat 3: aTkyjTh3w5YLWiIERupZOA folded before Flop (didn't bet)
Seat 4: bwv/rbH/hHhPhY6u9mu04w folded before Flop (didn't bet)
Seat 5: mSD1pginDsyHG5PDfqzphw folded before Flop (didn't bet)
Seat 6: +k7T5ocke8UwavtgUHm+Cg collected ($3.60)
Seat 7: IDtNLR9uFCDdjNsJWMHA5Q folded before Flop (didn't bet)
Seat 8: a4JDWmpFQkL10XfAyuF51A folded before Flop (didn't bet)
Seat 9: YzeKFbJVLmJGTgNH3ySQlw (button) folded on the Flop



PokerStars Game #59940621158:  Hold'em No Limit ($0.25/$0.50) - 2009/07/01 1:11:49 ET
Table 'EiNh8p/wGJ1FP575iMFnqg' 9-max Seat #6 is the button
Seat 1: r3ZqM1Mi0W3y4hOdssE+Sg ($67.25 in chips)
Seat 2: 8ehL7qlZzjgUh2H35iiWLw ($54.15 in chips)
Seat 3: ymLPoEIl7UL3TvZYmnadxQ ($58.90 in chips)
Seat 4: cMzaiXAM/ZAdNaEUu+LqhA ($50 in chips)
Seat 5: M+7+BTmX5vZatHVuoRB1nA ($79.70 in chips)
Seat 6: 3UmXLy3GfjC3EkOebduerQ ($61.60 in chips)
Seat 7: 997ViqAtWn1FPjJqcffwcA ($50 in chips)
Seat 8: mSD1pginDsyHG5PDfqzphw ($10 in chips)
997ViqAtWn1FPjJqcffwcA: posts small blind $0.25
mSD1pginDsyHG5PDfqzphw: posts big blind $0.50
GuPkZObrz5Zkkn8FsEdF9w: sits out
*** HOLE CARDS ***
r3ZqM1Mi0W3y4hOdssE+Sg: folds
8ehL7qlZzjgUh2H35iiWLw: folds
ymLPoEIl7UL3TvZYmnadxQ: folds
cMzaiXAM/ZAdNaEUu+LqhA: raises $1.50 to $2
M+7+BTmX5vZatHVuoRB1nA: folds
3UmXLy3GfjC3EkOebduerQ: folds
997ViqAtWn1FPjJqcffwcA: folds
mSD1pginDsyHG5PDfqzphw: folds
cMzaiXAM/ZAdNaEUu+LqhA collected $1.25 from pot
cMzaiXAM/ZAdNaEUu+LqhA: doesn't show hand
*** SUMMARY ***
Total pot $1.25 | Rake $0
Seat 1: r3ZqM1Mi0W3y4hOdssE+Sg folded before Flop (didn't bet)
Seat 2: 8ehL7qlZzjgUh2H35iiWLw folded before Flop (didn't bet)
Seat 3: ymLPoEIl7UL3TvZYmnadxQ folded before Flop (didn't bet)
Seat 4: cMzaiXAM/ZAdNaEUu+LqhA collected ($1.25)
Seat 5: M+7+BTmX5vZatHVuoRB1nA folded before Flop (didn't bet)
Seat 6: 3UmXLy3GfjC3EkOebduerQ (button) folded before Flop (didn't bet)
Seat 7: 997ViqAtWn1FPjJqcffwcA (small blind) folded before Flop
Seat 8: mSD1pginDsyHG5PDfqzphw (big blind) folded before Flop



PokerStars Game #59940621436:  Hold'em No Limit ($0.25/$0.50) - 2009/07/01 1:11:50 ET
Table 'eMxdLyFDf28E0wit6gm3Uw' 6-max Seat #5 is the button
Seat 2: UEjiWqFckVmunpvV128Xfw ($55.65 in chips)
Seat 4: hPAFLRqGh8YnqPe3HMZiQg ($16.40 in chips)
Seat 5: OtITKlSIHBhVAjRe30+BBQ ($42.55 in chips)
Seat 6: lxIzoHy0RnkfFSODHC2liw ($50.25 in chips)
lxIzoHy0RnkfFSODHC2liw: posts small blind $0.25
UEjiWqFckVmunpvV128Xfw: posts big blind $0.50
*** HOLE CARDS ***
hPAFLRqGh8YnqPe3HMZiQg: folds
OtITKlSIHBhVAjRe30+BBQ: raises $1 to $1.50
lxIzoHy0RnkfFSODHC2liw: folds
UEjiWqFckVmunpvV128Xfw: folds
OtITKlSIHBhVAjRe30+BBQ collected $1.25 from pot
*** SUMMARY ***
Total pot $1.25 | Rake $0
Seat 2: UEjiWqFckVmunpvV128Xfw (big blind) folded before Flop
Seat 4: hPAFLRqGh8YnqPe3HMZiQg folded before Flop (didn't bet)
Seat 5: OtITKlSIHBhVAjRe30+BBQ (button) collected ($1.25)
Seat 6: lxIzoHy0RnkfFSODHC2liw (small blind) folded before Flop



PokerStars Game #59940622188:  Hold'em No Limit ($0.25/$0.50) - 2009/07/01 1:11:51 ET
Table 'Nz0Vr7WMHL2g5Uk7dDZjpw' 9-max Seat #6 is the button
Seat 2: gsyXT42WLEcOS4DdEk2wlw ($30.60 in chips)
Seat 3: hoglu9inkgs6zN573/bJag ($7.60 in chips)
Seat 4: E2518gp4aFz1+kAgmGqeEg ($12.55 in chips)
Seat 5: WGW0DgjBUXs1ylURHG8vnQ ($24.65 in chips)
Seat 6: 997ViqAtWn1FPjJqcffwcA ($59.05 in chips)
Seat 7: KPLH0gELgFe2OuAnhJFI5w ($22.55 in chips)
Seat 8: aoL+R/61Kxmw69ypuPrWAQ ($23.70 in chips)
Seat 9: mSD1pginDsyHG5PDfqzphw ($10.75 in chips)
KPLH0gELgFe2OuAnhJFI5w: posts small blind $0.25
aoL+R/61Kxmw69ypuPrWAQ: posts big blind $0.50
*** HOLE CARDS ***
mSD1pginDsyHG5PDfqzphw: folds
gsyXT42WLEcOS4DdEk2wlw: folds
hoglu9inkgs6zN573/bJag: folds
E2518gp4aFz1+kAgmGqeEg: folds
WGW0DgjBUXs1ylURHG8vnQ: raises $0.50 to $1
997ViqAtWn1FPjJqcffwcA: folds
KPLH0gELgFe2OuAnhJFI5w: folds
aoL+R/61Kxmw69ypuPrWAQ: calls $0.50
*** FLOP *** [2d 9c Tc]
aoL+R/61Kxmw69ypuPrWAQ: bets $1.50
WGW0DgjBUXs1ylURHG8vnQ: calls $1.50
*** TURN *** [2d 9c Tc] [Ah]
aoL+R/61Kxmw69ypuPrWAQ: bets $3
WGW0DgjBUXs1ylURHG8vnQ: calls $3
*** RIVER *** [2d 9c Tc Ah] [6d]
aoL+R/61Kxmw69ypuPrWAQ: bets $6
WGW0DgjBUXs1ylURHG8vnQ: folds
aoL+R/61Kxmw69ypuPrWAQ collected $10.70 from pot
*** SUMMARY ***
Total pot $11.25 | Rake $0.55
Board [2d 9c Tc Ah 6d]
Seat 2: gsyXT42WLEcOS4DdEk2wlw folded before Flop (didn't bet)
Seat 3: hoglu9inkgs6zN573/bJag folded before Flop (didn't bet)
Seat 4: E2518gp4aFz1+kAgmGqeEg folded before Flop (didn't bet)
Seat 5: WGW0DgjBUXs1ylURHG8vnQ folded on the River
Seat 6: 997ViqAtWn1FPjJqcffwcA (button) folded before Flop (didn't bet)
Seat 7: KPLH0gELgFe2OuAnhJFI5w (small blind) folded before Flop
Seat 8: aoL+R/61Kxmw69ypuPrWAQ (big blind) collected ($10.70)
Seat 9: mSD1pginDsyHG5PDfqzphw folded before Flop (didn't bet)



PokerStars Game #59940622366:  Hold'em No Limit ($0.25/$0.50) - 2009/07/01 1:11:51 ET
Table '8BQGgNetI1NOvWeu3gtMNw' 2-max Seat #2 is the button
Seat 1: bypIyrYcAAifLfhZpGlKLA ($110.80 in chips)
Seat 2: Z4HwehErEwzsv/noQlfUlg ($85.60 in chips)
Z4HwehErEwzsv/noQlfUlg: posts small blind $0.25
bypIyrYcAAifLfhZpGlKLA: posts big blind $0.50
*** HOLE CARDS ***
Z4HwehErEwzsv/noQlfUlg: folds
bypIyrYcAAifLfhZpGlKLA collected $0.50 from pot
bypIyrYcAAifLfhZpGlKLA: doesn't show hand
*** SUMMARY ***
Total pot $0.50 | Rake $0
Seat 1: bypIyrYcAAifLfhZpGlKLA (big blind) collected ($0.50)
Seat 2: Z4HwehErEwzsv/noQlfUlg (button) (small blind) folded before Flop



PokerStars Game #59940624578:  Hold'em No Limit ($0.25/$0.50) - 2009/07/01 1:11:55 ET
Table 'tYh970kmVfYS0gXPT/XtoQ' 2-max Seat #1 is the button
Seat 1: CLj3pYZDnglQbP8AEHiYIw ($53.05 in chips)
Seat 2: fxN9bTdAgPNvNkHgbVXKGw ($15.70 in chips)
CLj3pYZDnglQbP8AEHiYIw: posts small blind $0.25
fxN9bTdAgPNvNkHgbVXKGw: posts big blind $0.50
*** HOLE CARDS ***
CLj3pYZDnglQbP8AEHiYIw: raises $1 to $1.50
fxN9bTdAgPNvNkHgbVXKGw: raises $14.20 to $15.70 and is all-in
CLj3pYZDnglQbP8AEHiYIw: calls $14.20
*** FLOP *** [7s Kd 4d]
*** TURN *** [7s Kd 4d] [Js]
*** RIVER *** [7s Kd 4d Js] [9c]
*** SHOW DOWN ***
fxN9bTdAgPNvNkHgbVXKGw: shows [Ad Qd] (high card Ace)
CLj3pYZDnglQbP8AEHiYIw: shows [Qh Ah] (high card Ace)
fxN9bTdAgPNvNkHgbVXKGw collected $15.45 from pot
CLj3pYZDnglQbP8AEHiYIw collected $15.45 from pot
*** SUMMARY ***
Total pot $31.40 | Rake $0.50
Board [7s Kd 4d Js 9c]
Seat 1: CLj3pYZDnglQbP8AEHiYIw (button) (small blind) showed [Qh Ah] and won ($15.45) with high card Ace
Seat 2: fxN9bTdAgPNvNkHgbVXKGw (big blind) showed [Ad Qd] and won ($15.45) with high card Ace



PokerStars Game #59940624988:  Hold'em No Limit ($0.25/$0.50) - 2009/07/01 1:11:56 ET
Table 'BCN5su+SsXiy1zRMJi0SJw' 6-max Seat #1 is the button
Seat 1: GxXV09ciXaOxyY2H5aMIIw ($51.15 in chips)
Seat 2: oU2kDCkT/gilYbHWrg7D8w ($42.70 in chips)
Seat 3: kwgv5lNhiFrfONXCshzxlA ($28.75 in chips)
Seat 4: 4QfsCWthT/vSLirorNXqtg ($50 in chips)
Seat 5: cEMJmfAUQZmMChZe6aacKw ($25 in chips)
Seat 6: b2symlOdL7+0c9Pj4N/KlA ($61.40 in chips)
oU2kDCkT/gilYbHWrg7D8w: posts small blind $0.25
kwgv5lNhiFrfONXCshzxlA: posts big blind $0.50
cEMJmfAUQZmMChZe6aacKw: posts big blind $0.50
*** HOLE CARDS ***
4QfsCWthT/vSLirorNXqtg: folds
cEMJmfAUQZmMChZe6aacKw: checks
b2symlOdL7+0c9Pj4N/KlA: raises $2 to $2.50
GxXV09ciXaOxyY2H5aMIIw: raises $3.50 to $6
oU2kDCkT/gilYbHWrg7D8w: folds
kwgv5lNhiFrfONXCshzxlA: folds
cEMJmfAUQZmMChZe6aacKw: folds
b2symlOdL7+0c9Pj4N/KlA: folds
oU2kDCkT/gilYbHWrg7D8w said, "sproggs u saving me money thanks"
GxXV09ciXaOxyY2H5aMIIw collected $6.25 from pot
*** SUMMARY ***
Total pot $6.25 | Rake $0
Seat 1: GxXV09ciXaOxyY2H5aMIIw (button) collected ($6.25)
Seat 2: oU2kDCkT/gilYbHWrg7D8w (small blind) folded before Flop
Seat 3: kwgv5lNhiFrfONXCshzxlA (big blind) folded before Flop
Seat 4: 4QfsCWthT/vSLirorNXqtg folded before Flop (didn't bet)
Seat 5: cEMJmfAUQZmMChZe6aacKw folded before Flop
Seat 6: b2symlOdL7+0c9Pj4N/KlA folded before Flop



PokerStars Game #59940624878:  Hold'em No Limit ($0.25/$0.50) - 2009/07/01 1:11:56 ET
Table 'kgbJRsxfv64KrErDRBAkcw' 6-max Seat #2 is the button
Seat 1: VamsyhlFzXGF6/ydo0BHeA ($41.85 in chips)
Seat 2: AdS8BJMOheS01zjCDfPMFg ($58.55 in chips)
Seat 3: c4MNIaIyPMOMxrgT8FT5nA ($127 in chips)
Seat 5: eUBBn2R56C1IQ6Cs/vitwg ($60.45 in chips)
Seat 6: 1b+2BbjMN8qhR1WPqdE9VQ ($57.35 in chips)
c4MNIaIyPMOMxrgT8FT5nA: posts small blind $0.25
eUBBn2R56C1IQ6Cs/vitwg: posts big blind $0.50
*** HOLE CARDS ***
1b+2BbjMN8qhR1WPqdE9VQ: folds
VamsyhlFzXGF6/ydo0BHeA: calls $0.50
AdS8BJMOheS01zjCDfPMFg: folds
c4MNIaIyPMOMxrgT8FT5nA: calls $0.25
eUBBn2R56C1IQ6Cs/vitwg: checks
*** FLOP *** [6h 8c Qc]
c4MNIaIyPMOMxrgT8FT5nA: bets $3.50
eUBBn2R56C1IQ6Cs/vitwg: folds
VamsyhlFzXGF6/ydo0BHeA: raises $9.50 to $13
c4MNIaIyPMOMxrgT8FT5nA: folds
VamsyhlFzXGF6/ydo0BHeA collected $8.10 from pot
VamsyhlFzXGF6/ydo0BHeA: doesn't show hand
*** SUMMARY ***
Total pot $8.50 | Rake $0.40
Board [6h 8c Qc]
Seat 1: VamsyhlFzXGF6/ydo0BHeA collected ($8.10)
Seat 2: AdS8BJMOheS01zjCDfPMFg (button) folded before Flop (didn't bet)
Seat 3: c4MNIaIyPMOMxrgT8FT5nA (small blind) folded on the Flop
Seat 5: eUBBn2R56C1IQ6Cs/vitwg (big blind) folded on the Flop
Seat 6: 1b+2BbjMN8qhR1WPqdE9VQ folded before Flop (didn't bet)



PokerStars Game #59940625958:  Hold'em No Limit ($0.25/$0.50) - 2009/07/01 1:11:57 ET
Table '0eJtgVAXVvBgncFdcUpXcQ' 2-max Seat #2 is the button
Seat 1: Ag6DvxX4vbRheqsv2zXKTQ ($47.40 in chips)
Seat 2: KMc4R+K9ao4Ur3rF7NGe6Q ($6.55 in chips)
KMc4R+K9ao4Ur3rF7NGe6Q: posts small blind $0.25
Ag6DvxX4vbRheqsv2zXKTQ: posts big blind $0.50
*** HOLE CARDS ***
KMc4R+K9ao4Ur3rF7NGe6Q: calls $0.25
Ag6DvxX4vbRheqsv2zXKTQ: checks
*** FLOP *** [2h Tc Js]
Ag6DvxX4vbRheqsv2zXKTQ: checks
KMc4R+K9ao4Ur3rF7NGe6Q: checks
*** TURN *** [2h Tc Js] [4h]
Ag6DvxX4vbRheqsv2zXKTQ: bets $1
KMc4R+K9ao4Ur3rF7NGe6Q: raises $1 to $2
Ag6DvxX4vbRheqsv2zXKTQ: calls $1
*** RIVER *** [2h Tc Js 4h] [3h]
Ag6DvxX4vbRheqsv2zXKTQ: checks
KMc4R+K9ao4Ur3rF7NGe6Q: checks
*** SHOW DOWN ***
Ag6DvxX4vbRheqsv2zXKTQ: shows [9s Td] (a pair of Tens)
KMc4R+K9ao4Ur3rF7NGe6Q: mucks hand
Ag6DvxX4vbRheqsv2zXKTQ collected $4.80 from pot
*** SUMMARY ***
Total pot $5 | Rake $0.20
Board [2h Tc Js 4h 3h]
Seat 1: Ag6DvxX4vbRheqsv2zXKTQ (big blind) showed [9s Td] and won ($4.80) with a pair of Tens
Seat 2: KMc4R+K9ao4Ur3rF7NGe6Q (button) (small blind) mucked



PokerStars Game #59940626796:  Hold'em No Limit ($0.25/$0.50) - 2009/07/01 1:11:59 ET
Table '+dXkOAQyS8j9PQZusUTMpg' 2-max Seat #1 is the button
Seat 1: XFa6sBGjP2gxoIvxR3fZIg ($116.05 in chips)
Seat 2: 5IBeOgaApY1Bvzv2P8X4EA ($78.30 in chips)
XFa6sBGjP2gxoIvxR3fZIg: posts small blind $0.25
5IBeOgaApY1Bvzv2P8X4EA: posts big blind $0.50
*** HOLE CARDS ***
XFa6sBGjP2gxoIvxR3fZIg: raises $1 to $1.50
5IBeOgaApY1Bvzv2P8X4EA: folds
XFa6sBGjP2gxoIvxR3fZIg collected $1 from pot
XFa6sBGjP2gxoIvxR3fZIg: doesn't show hand
*** SUMMARY ***
Total pot $1 | Rake $0
Seat 1: XFa6sBGjP2gxoIvxR3fZIg (button) (small blind) collected ($1)
Seat 2: 5IBeOgaApY1Bvzv2P8X4EA (big blind) folded before Flop



PokerStars Game #59940627734:  Hold'em No Limit ($0.25/$0.50) - 2009/07/01 1:12:00 ET
Table '8BQGgNetI1NOvWeu3gtMNw' 2-max Seat #1 is the button
Seat 1: bypIyrYcAAifLfhZpGlKLA ($111.05 in chips)
Seat 2: Z4HwehErEwzsv/noQlfUlg ($85.35 in chips)
bypIyrYcAAifLfhZpGlKLA: posts small blind $0.25
Z4HwehErEwzsv/noQlfUlg: posts big blind $0.50
*** HOLE CARDS ***
bypIyrYcAAifLfhZpGlKLA: raises $1 to $1.50
Z4HwehErEwzsv/noQlfUlg: raises $1 to $2.50
bypIyrYcAAifLfhZpGlKLA: calls $1
*** FLOP *** [Ac 3s 8s]
Z4HwehErEwzsv/noQlfUlg: checks
bypIyrYcAAifLfhZpGlKLA: bets $3
Z4HwehErEwzsv/noQlfUlg: folds
bypIyrYcAAifLfhZpGlKLA collected $4.75 from pot
bypIyrYcAAifLfhZpGlKLA: doesn't show hand
*** SUMMARY ***
Total pot $5 | Rake $0.25
Board [Ac 3s 8s]
Seat 1: bypIyrYcAAifLfhZpGlKLA (button) (small blind) collected ($4.75)
Seat 2: Z4HwehErEwzsv/noQlfUlg (big blind) folded on the Flop



PokerStars Game #59940627548:  Hold'em No Limit ($0.25/$0.50) - 2009/07/01 1:12:00 ET
Table 'MJxeZCzYELxiIsyUZyT0jw' 6-max Seat #1 is the button
Seat 1: +Pf9jTVizYlIo+woPvptfA ($50 in chips)
Seat 2: t3GiVMzqA9Svgr5Uol32cQ ($27.35 in chips)
Seat 3: sIG4mp8tZEI+W4nKZNkkQA ($53.45 in chips)
Seat 4: alGiiQP/wwtYnfuXII+sgw ($62.35 in chips)
Seat 5: 3jvoOXNtXE90w2BdfNZwZQ ($52.30 in chips)
Seat 6: c0n4hrn20AML9qzyFC2E8Q ($61.50 in chips)
t3GiVMzqA9Svgr5Uol32cQ: posts small blind $0.25
sIG4mp8tZEI+W4nKZNkkQA: posts big blind $0.50
*** HOLE CARDS ***
alGiiQP/wwtYnfuXII+sgw: folds
3jvoOXNtXE90w2BdfNZwZQ: folds
c0n4hrn20AML9qzyFC2E8Q: raises $1.50 to $2
+Pf9jTVizYlIo+woPvptfA: folds
t3GiVMzqA9Svgr5Uol32cQ: folds
sIG4mp8tZEI+W4nKZNkkQA: raises $5 to $7
c0n4hrn20AML9qzyFC2E8Q: calls $5
*** FLOP *** [9d Kh 8h]
sIG4mp8tZEI+W4nKZNkkQA: bets $9.50
c0n4hrn20AML9qzyFC2E8Q: raises $9.50 to $19
sIG4mp8tZEI+W4nKZNkkQA: raises $27.45 to $46.45 and is all-in
c0n4hrn20AML9qzyFC2E8Q: calls $27.45
*** TURN *** [9d Kh 8h] [Js]
*** RIVER *** [9d Kh 8h Js] [Jd]
*** SHOW DOWN ***
sIG4mp8tZEI+W4nKZNkkQA: shows [Kd Ah] (two pair, Kings and Jacks)
c0n4hrn20AML9qzyFC2E8Q: shows [Ks Ac] (two pair, Kings and Jacks)
sIG4mp8tZEI+W4nKZNkkQA collected $52.10 from pot
c0n4hrn20AML9qzyFC2E8Q collected $52.05 from pot
*** SUMMARY ***
Total pot $107.15 | Rake $3
Board [9d Kh 8h Js Jd]
Seat 1: +Pf9jTVizYlIo+woPvptfA (button) folded before Flop (didn't bet)
Seat 2: t3GiVMzqA9Svgr5Uol32cQ (small blind) folded before Flop
Seat 3: sIG4mp8tZEI+W4nKZNkkQA (big blind) showed [Kd Ah] and won ($52.10) with two pair, Kings and Jacks
Seat 4: alGiiQP/wwtYnfuXII+sgw folded before Flop (didn't bet)
Seat 5: 3jvoOXNtXE90w2BdfNZwZQ folded before Flop (didn't bet)
Seat 6: c0n4hrn20AML9qzyFC2E8Q showed [Ks Ac] and won ($52.05) with two pair, Kings and Jacks



PokerStars Game #59940628858:  Hold'em No Limit ($0.25/$0.50) - 2009/07/01 1:12:02 ET
Table 'otvGDROEDdqsabxskT79qg' 9-max Seat #1 is the button
Seat 1: 8ehL7qlZzjgUh2H35iiWLw ($59.75 in chips)
Seat 2: cCjTzH9jio8607WzjcfXlg ($13.45 in chips)
Seat 3: +k7T5ocke8UwavtgUHm+Cg ($70.60 in chips)
Seat 4: MG90wfSJZnOejs/KD3vlQQ ($75.90 in chips)
Seat 5: E2518gp4aFz1+kAgmGqeEg ($11.75 in chips)
Seat 6: bxLSulbgr8LmKNjOzw8URg ($56 in chips)
Seat 7: 75K2MXwN65Sjfp1yHd50Hg ($9.25 in chips)
Seat 8: zE9cVigS2nW/Ljy4K4bUQA ($30 in chips)
Seat 9: KcY3X8YpD74Kw1RHkx/g4A ($47.15 in chips)
cCjTzH9jio8607WzjcfXlg: posts small blind $0.25
+k7T5ocke8UwavtgUHm+Cg: posts big blind $0.50
*** HOLE CARDS ***
MG90wfSJZnOejs/KD3vlQQ: folds
E2518gp4aFz1+kAgmGqeEg: folds
bxLSulbgr8LmKNjOzw8URg: folds
75K2MXwN65Sjfp1yHd50Hg: folds
zE9cVigS2nW/Ljy4K4bUQA: folds
KcY3X8YpD74Kw1RHkx/g4A: folds
8ehL7qlZzjgUh2H35iiWLw: folds
cCjTzH9jio8607WzjcfXlg: calls $0.25
+k7T5ocke8UwavtgUHm+Cg: checks
*** FLOP *** [2h 3s Ad]
cCjTzH9jio8607WzjcfXlg: checks
+k7T5ocke8UwavtgUHm+Cg: checks
*** TURN *** [2h 3s Ad] [Kh]
cCjTzH9jio8607WzjcfXlg: checks
+k7T5ocke8UwavtgUHm+Cg: bets $0.50
cCjTzH9jio8607WzjcfXlg: calls $0.50
*** RIVER *** [2h 3s Ad Kh] [Td]
cCjTzH9jio8607WzjcfXlg: checks
+k7T5ocke8UwavtgUHm+Cg: checks
*** SHOW DOWN ***
cCjTzH9jio8607WzjcfXlg: shows [3c 4c] (a pair of Threes)
+k7T5ocke8UwavtgUHm+Cg: mucks hand
cCjTzH9jio8607WzjcfXlg collected $1.95 from pot
*** SUMMARY ***
Total pot $2 | Rake $0.05
Board [2h 3s Ad Kh Td]
Seat 1: 8ehL7qlZzjgUh2H35iiWLw (button) folded before Flop (didn't bet)
Seat 2: cCjTzH9jio8607WzjcfXlg (small blind) showed [3c 4c] and won ($1.95) with a pair of Threes
Seat 3: +k7T5ocke8UwavtgUHm+Cg (big blind) mucked
Seat 4: MG90wfSJZnOejs/KD3vlQQ folded before Flop (didn't bet)
Seat 5: E2518gp4aFz1+kAgmGqeEg folded before Flop (didn't bet)
Seat 6: bxLSulbgr8LmKNjOzw8URg folded before Flop (didn't bet)
Seat 7: 75K2MXwN65Sjfp1yHd50Hg folded before Flop (didn't bet)
Seat 8: zE9cVigS2nW/Ljy4K4bUQA folded before Flop (didn't bet)
Seat 9: KcY3X8YpD74Kw1RHkx/g4A folded before Flop (didn't bet)



PokerStars Game #59940628308:  Hold'em No Limit ($0.25/$0.50) - 2009/07/01 1:12:02 ET
Table '+z1aekfHkpp09pc8F9aViw' 6-max Seat #1 is the button
Seat 1: 7zFtlEn2NxyROFkJdZA/yg ($50 in chips)
Seat 3: uUznlIMFnRUvwrBhYF73KA ($141.40 in chips)
Seat 4: RowCSpSURHTOL/dcjg/Iug ($43.60 in chips)
Seat 5: rplyldNweS6YyMNEALQrug ($56.80 in chips)
uUznlIMFnRUvwrBhYF73KA: posts small blind $0.25
RowCSpSURHTOL/dcjg/Iug: posts big blind $0.50
OZ6OtYh5Y53MCH/p0QTn5g joins the table at seat #2
GUnvMULl2qFOO1yenu1UBw has timed out
GUnvMULl2qFOO1yenu1UBw: is sitting out
*** HOLE CARDS ***
rplyldNweS6YyMNEALQrug: calls $0.50
7zFtlEn2NxyROFkJdZA/yg: folds
uUznlIMFnRUvwrBhYF73KA: folds
RowCSpSURHTOL/dcjg/Iug: checks
*** FLOP *** [Ts 8h Tc]
GUnvMULl2qFOO1yenu1UBw has returned
RowCSpSURHTOL/dcjg/Iug: checks
rplyldNweS6YyMNEALQrug: checks
*** TURN *** [Ts 8h Tc] [8c]
RowCSpSURHTOL/dcjg/Iug: bets $1
rplyldNweS6YyMNEALQrug: raises $3 to $4
RowCSpSURHTOL/dcjg/Iug: calls $3
*** RIVER *** [Ts 8h Tc 8c] [Ah]
RowCSpSURHTOL/dcjg/Iug: bets $2.50
rplyldNweS6YyMNEALQrug: calls $2.50
*** SHOW DOWN ***
RowCSpSURHTOL/dcjg/Iug: shows [Td Qh] (a full house, Tens full of Eights)
rplyldNweS6YyMNEALQrug: shows [Js Jh] (two pair, Jacks and Tens)
RowCSpSURHTOL/dcjg/Iug collected $13.60 from pot
*** SUMMARY ***
Total pot $14.25 | Rake $0.65
Board [Ts 8h Tc 8c Ah]
Seat 1: 7zFtlEn2NxyROFkJdZA/yg (button) folded before Flop (didn't bet)
Seat 3: uUznlIMFnRUvwrBhYF73KA (small blind) folded before Flop
Seat 4: RowCSpSURHTOL/dcjg/Iug (big blind) showed [Td Qh] and won ($13.60) with a full house, Tens full of Eights
Seat 5: rplyldNweS6YyMNEALQrug showed [Js Jh] and lost with two pair, Jacks and Tens



PokerStars Game #59940628984:  Hold'em No Limit ($0.25/$0.50) - 2009/07/01 1:12:03 ET
Table 'c/CRn+68J3Y8KxD5g1ek2Q' 2-max Seat #1 is the button
Seat 1: 46qCyJ6evTkHo9al5sBMNA ($114.55 in chips)
Seat 2: BypVLsYQt3ePFm2xQL/dOA ($249.85 in chips)
46qCyJ6evTkHo9al5sBMNA: posts small blind $0.25
BypVLsYQt3ePFm2xQL/dOA: posts big blind $0.50
*** HOLE CARDS ***
46qCyJ6evTkHo9al5sBMNA: folds
BypVLsYQt3ePFm2xQL/dOA collected $0.50 from pot
BypVLsYQt3ePFm2xQL/dOA: doesn't show hand
*** SUMMARY ***
Total pot $0.50 | Rake $0
Seat 1: 46qCyJ6evTkHo9al5sBMNA (button) (small blind) folded before Flop
Seat 2: BypVLsYQt3ePFm2xQL/dOA (big blind) collected ($0.50)



PokerStars Game #59940630834:  Hold'em No Limit ($0.25/$0.50) - 2009/07/01 1:12:06 ET
Table '+dXkOAQyS8j9PQZusUTMpg' 2-max Seat #2 is the button
Seat 1: XFa6sBGjP2gxoIvxR3fZIg ($116.55 in chips)
Seat 2: 5IBeOgaApY1Bvzv2P8X4EA ($77.80 in chips)
5IBeOgaApY1Bvzv2P8X4EA: posts small blind $0.25
XFa6sBGjP2gxoIvxR3fZIg: posts big blind $0.50
*** HOLE CARDS ***
5IBeOgaApY1Bvzv2P8X4EA: calls $0.25
XFa6sBGjP2gxoIvxR3fZIg: checks
*** FLOP *** [7h Th 4c]
XFa6sBGjP2gxoIvxR3fZIg: bets $1
5IBeOgaApY1Bvzv2P8X4EA: folds
XFa6sBGjP2gxoIvxR3fZIg collected $0.95 from pot
XFa6sBGjP2gxoIvxR3fZIg: doesn't show hand
*** SUMMARY ***
Total pot $1 | Rake $0.05
Board [7h Th 4c]
Seat 1: XFa6sBGjP2gxoIvxR3fZIg (big blind) collected ($0.95)
Seat 2: 5IBeOgaApY1Bvzv2P8X4EA (button) (small blind) folded on the Flop



PokerStars Game #59940631850:  Hold'em No Limit ($0.25/$0.50) - 2009/07/01 1:12:07 ET
Table 'NCiXr0d5CEKBQr/cZgLhbA' 9-max Seat #3 is the button
Seat 1: pFtzb1sR4b0d1aw6aIRgDg ($50.20 in chips)
Seat 3: xZCXQSXlrZkp3pZizzVXCw ($51.95 in chips)
Seat 4: 5k9fvXD9suIgCxU4HLQjTw ($53.70 in chips)
Seat 5: zE9cVigS2nW/Ljy4K4bUQA ($64.10 in chips)
Seat 6: SKnJuWHScqetA/qG5p+wCg ($30 in chips)
Seat 7: M+7+BTmX5vZatHVuoRB1nA ($52 in chips)
Seat 8: 1MJUKc3cc0QmUoz1JZLR2w ($49.30 in chips)
Seat 9: 4WLZvqBn5qv5tds5kt5A1Q ($56.05 in chips)
5k9fvXD9suIgCxU4HLQjTw: posts small blind $0.25
zE9cVigS2nW/Ljy4K4bUQA: posts big blind $0.50
AjV5McH1KMMclY26QdLM5w: sits out
*** HOLE CARDS ***
SKnJuWHScqetA/qG5p+wCg: folds
M+7+BTmX5vZatHVuoRB1nA: folds
1MJUKc3cc0QmUoz1JZLR2w: folds
4WLZvqBn5qv5tds5kt5A1Q: calls $0.50
pFtzb1sR4b0d1aw6aIRgDg: folds
xZCXQSXlrZkp3pZizzVXCw: folds
5k9fvXD9suIgCxU4HLQjTw: calls $0.25
zE9cVigS2nW/Ljy4K4bUQA: checks
*** FLOP *** [5d Ts Qd]
5k9fvXD9suIgCxU4HLQjTw: checks
zE9cVigS2nW/Ljy4K4bUQA: checks
4WLZvqBn5qv5tds5kt5A1Q: checks
*** TURN *** [5d Ts Qd] [Tc]
5k9fvXD9suIgCxU4HLQjTw: checks
zE9cVigS2nW/Ljy4K4bUQA: checks
4WLZvqBn5qv5tds5kt5A1Q: checks
*** RIVER *** [5d Ts Qd Tc] [Jc]
5k9fvXD9suIgCxU4HLQjTw: checks
zE9cVigS2nW/Ljy4K4bUQA: checks
4WLZvqBn5qv5tds5kt5A1Q: checks
*** SHOW DOWN ***
5k9fvXD9suIgCxU4HLQjTw: shows [Ac 2c] (a pair of Tens)
zE9cVigS2nW/Ljy4K4bUQA: mucks hand
4WLZvqBn5qv5tds5kt5A1Q: shows [9c As] (a pair of Tens)
5k9fvXD9suIgCxU4HLQjTw collected $0.75 from pot
4WLZvqBn5qv5tds5kt5A1Q collected $0.70 from pot
*** SUMMARY ***
Total pot $1.50 | Rake $0.05
Board [5d Ts Qd Tc Jc]
Seat 1: pFtzb1sR4b0d1aw6aIRgDg folded before Flop (didn't bet)
Seat 3: xZCXQSXlrZkp3pZizzVXCw (button) folded before Flop (didn't bet)
Seat 4: 5k9fvXD9suIgCxU4HLQjTw (small blind) showed [Ac 2c] and won ($0.75) with a pair of Tens
Seat 5: zE9cVigS2nW/Ljy4K4bUQA (big blind) mucked
Seat 6: SKnJuWHScqetA/qG5p+wCg folded before Flop (didn't bet)
Seat 7: M+7+BTmX5vZatHVuoRB1nA folded before Flop (didn't bet)
Seat 8: 1MJUKc3cc0QmUoz1JZLR2w folded before Flop (didn't bet)
Seat 9: 4WLZvqBn5qv5tds5kt5A1Q showed [9c As] and won ($0.70) with a pair of Tens



PokerStars Game #59940631842:  Hold'em No Limit ($0.25/$0.50) - 2009/07/01 1:12:07 ET
Table '5EmHi+fnatGQQShcNmzOZQ' 6-max Seat #5 is the button
Seat 1: My8WkRtGx5FW6rJ1I4R3hg ($44.35 in chips)
Seat 2: bfFjgAtIoAI+pUxUwFt3aQ ($38.10 in chips)
Seat 3: 1mYbhL8CU/QYqfVmFcaHDQ ($11.05 in chips)
Seat 4: 1b+2BbjMN8qhR1WPqdE9VQ ($54.15 in chips)
Seat 5: kxPhs4ePFqMy52CInAJ2aw ($93.10 in chips)
My8WkRtGx5FW6rJ1I4R3hg: posts small blind $0.25
bfFjgAtIoAI+pUxUwFt3aQ: posts big blind $0.50
*** HOLE CARDS ***
1mYbhL8CU/QYqfVmFcaHDQ: calls $0.50
1b+2BbjMN8qhR1WPqdE9VQ: folds
kxPhs4ePFqMy52CInAJ2aw: folds
My8WkRtGx5FW6rJ1I4R3hg: folds
bfFjgAtIoAI+pUxUwFt3aQ: checks
*** FLOP *** [6h Ac 3c]
bfFjgAtIoAI+pUxUwFt3aQ: bets $1
1mYbhL8CU/QYqfVmFcaHDQ: calls $1
*** TURN *** [6h Ac 3c] [9s]
bfFjgAtIoAI+pUxUwFt3aQ: checks
1mYbhL8CU/QYqfVmFcaHDQ: checks
*** RIVER *** [6h Ac 3c 9s] [4h]
bfFjgAtIoAI+pUxUwFt3aQ: bets $1.50
1mYbhL8CU/QYqfVmFcaHDQ: folds
bfFjgAtIoAI+pUxUwFt3aQ collected $3.10 from pot
*** SUMMARY ***
Total pot $3.25 | Rake $0.15
Board [6h Ac 3c 9s 4h]
Seat 1: My8WkRtGx5FW6rJ1I4R3hg (small blind) folded before Flop
Seat 2: bfFjgAtIoAI+pUxUwFt3aQ (big blind) collected ($3.10)
Seat 3: 1mYbhL8CU/QYqfVmFcaHDQ folded on the River
Seat 4: 1b+2BbjMN8qhR1WPqdE9VQ folded before Flop (didn't bet)
Seat 5: kxPhs4ePFqMy52CInAJ2aw (button) folded before Flop (didn't bet)



PokerStars Game #59940633238:  Hold'em No Limit ($0.25/$0.50) - 2009/07/01 1:12:10 ET
Table 'c/CRn+68J3Y8KxD5g1ek2Q' 2-max Seat #2 is the button
Seat 1: 46qCyJ6evTkHo9al5sBMNA ($114.30 in chips)
Seat 2: BypVLsYQt3ePFm2xQL/dOA ($250.10 in chips)
BypVLsYQt3ePFm2xQL/dOA: posts small blind $0.25
46qCyJ6evTkHo9al5sBMNA: posts big blind $0.50
*** HOLE CARDS ***
BypVLsYQt3ePFm2xQL/dOA: calls $0.25
46qCyJ6evTkHo9al5sBMNA: checks
*** FLOP *** [Js Ac 5d]
46qCyJ6evTkHo9al5sBMNA: checks
BypVLsYQt3ePFm2xQL/dOA: bets $1.50
46qCyJ6evTkHo9al5sBMNA: folds
BypVLsYQt3ePFm2xQL/dOA collected $0.95 from pot
BypVLsYQt3ePFm2xQL/dOA: doesn't show hand
*** SUMMARY ***
Total pot $1 | Rake $0.05
Board [Js Ac 5d]
Seat 1: 46qCyJ6evTkHo9al5sBMNA (big blind) folded on the Flop
Seat 2: BypVLsYQt3ePFm2xQL/dOA (button) (small blind) collected ($0.95)



PokerStars Game #59940633098:  Hold'em No Limit ($0.25/$0.50) - 2009/07/01 1:12:10 ET
Table 'fx6MqwfYAj/Rt86hBz2L3Q' 9-max Seat #3 is the button
Seat 1: uw9QayAAxLM3Hb+HR7mSkg ($12 in chips)
Seat 2: C3rGXblctNcWI6JYPHhaEg ($36 in chips)
Seat 3: iadBi5AEt7gTBXbDSSnMYQ ($48.75 in chips)
Seat 5: iAISe3dVeua8PUn2wwgDHw ($65.50 in chips)
Seat 6: 5k9fvXD9suIgCxU4HLQjTw ($50 in chips)
Seat 7: SKnJuWHScqetA/qG5p+wCg ($30 in chips)
Seat 8: JYwJYYV9pM5KWdSiETl8rA ($29.75 in chips)
iAISe3dVeua8PUn2wwgDHw: posts small blind $0.25
5k9fvXD9suIgCxU4HLQjTw: posts big blind $0.50
rFvc7K/96V9eGvYRfmpoUQ: sits out
*** HOLE CARDS ***
SKnJuWHScqetA/qG5p+wCg: folds
JYwJYYV9pM5KWdSiETl8rA: folds
uw9QayAAxLM3Hb+HR7mSkg: folds
C3rGXblctNcWI6JYPHhaEg: raises $0.50 to $1
iadBi5AEt7gTBXbDSSnMYQ: calls $1
iAISe3dVeua8PUn2wwgDHw: folds
5k9fvXD9suIgCxU4HLQjTw: calls $0.50
*** FLOP *** [3c Js 7s]
5k9fvXD9suIgCxU4HLQjTw: checks
C3rGXblctNcWI6JYPHhaEg: bets $1
iadBi5AEt7gTBXbDSSnMYQ: raises $1 to $2
5k9fvXD9suIgCxU4HLQjTw: folds
C3rGXblctNcWI6JYPHhaEg: calls $1
*** TURN *** [3c Js 7s] [Kh]
C3rGXblctNcWI6JYPHhaEg: bets $3
iadBi5AEt7gTBXbDSSnMYQ: folds
C3rGXblctNcWI6JYPHhaEg collected $6.90 from pot
C3rGXblctNcWI6JYPHhaEg: shows [Kc 2c] (a pair of Kings)
*** SUMMARY ***
Total pot $7.25 | Rake $0.35
Board [3c Js 7s Kh]
Seat 1: uw9QayAAxLM3Hb+HR7mSkg folded before Flop (didn't bet)
Seat 2: C3rGXblctNcWI6JYPHhaEg collected ($6.90)
Seat 3: iadBi5AEt7gTBXbDSSnMYQ (button) folded on the Turn
Seat 5: iAISe3dVeua8PUn2wwgDHw (small blind) folded before Flop
Seat 6: 5k9fvXD9suIgCxU4HLQjTw (big blind) folded on the Flop
Seat 7: SKnJuWHScqetA/qG5p+wCg folded before Flop (didn't bet)
Seat 8: JYwJYYV9pM5KWdSiETl8rA folded before Flop (didn't bet)



PokerStars Game #59940634492:  Hold'em No Limit ($0.25/$0.50) - 2009/07/01 1:12:12 ET
Table 'eMxdLyFDf28E0wit6gm3Uw' 6-max Seat #6 is the button
Seat 2: UEjiWqFckVmunpvV128Xfw ($55.15 in chips)
Seat 4: hPAFLRqGh8YnqPe3HMZiQg ($16.40 in chips)
Seat 5: OtITKlSIHBhVAjRe30+BBQ ($43.30 in chips)
Seat 6: lxIzoHy0RnkfFSODHC2liw ($50 in chips)
UEjiWqFckVmunpvV128Xfw: posts small blind $0.25
hPAFLRqGh8YnqPe3HMZiQg: posts big blind $0.50
*** HOLE CARDS ***
OtITKlSIHBhVAjRe30+BBQ: folds
lxIzoHy0RnkfFSODHC2liw: folds
OtITKlSIHBhVAjRe30+BBQ leaves the table
UEjiWqFckVmunpvV128Xfw: folds
hPAFLRqGh8YnqPe3HMZiQg collected $0.50 from pot
*** SUMMARY ***
Total pot $0.50 | Rake $0
Seat 2: UEjiWqFckVmunpvV128Xfw (small blind) folded before Flop
Seat 4: hPAFLRqGh8YnqPe3HMZiQg (big blind) collected ($0.50)
Seat 5: OtITKlSIHBhVAjRe30+BBQ folded before Flop (didn't bet)
Seat 6: lxIzoHy0RnkfFSODHC2liw (button) folded before Flop (didn't bet)



PokerStars Game #59940635962:  Hold'em No Limit ($0.25/$0.50) - 2009/07/01 1:12:14 ET
Table '0eJtgVAXVvBgncFdcUpXcQ' 2-max Seat #1 is the button
Seat 1: Ag6DvxX4vbRheqsv2zXKTQ ($49.70 in chips)
Seat 2: KMc4R+K9ao4Ur3rF7NGe6Q ($4.05 in chips)
Ag6DvxX4vbRheqsv2zXKTQ: posts small blind $0.25
KMc4R+K9ao4Ur3rF7NGe6Q: posts big blind $0.50
*** HOLE CARDS ***
Ag6DvxX4vbRheqsv2zXKTQ: calls $0.25
KMc4R+K9ao4Ur3rF7NGe6Q: raises $1 to $1.50
Ag6DvxX4vbRheqsv2zXKTQ: folds
KMc4R+K9ao4Ur3rF7NGe6Q collected $1 from pot
*** SUMMARY ***
Total pot $1 | Rake $0
Seat 1: Ag6DvxX4vbRheqsv2zXKTQ (button) (small blind) folded before Flop
Seat 2: KMc4R+K9ao4Ur3rF7NGe6Q (big blind) collected ($1)



PokerStars Game #59940636636:  Hold'em No Limit ($0.25/$0.50) - 2009/07/01 1:12:15 ET
Table 'X6IRCRTh+20gjz8aubWnwA' 9-max Seat #8 is the button
Seat 2: HZkVla4kK2SI42CVrPZ/ig ($6.80 in chips)
Seat 3: SWv01peOe69QQRvhQTqjQw ($5.50 in chips)
Seat 4: M3JFBNQ8Bbw3FBZ/18MuXw ($25.70 in chips)
Seat 5: NnQCepdIR/AOUQn1yhYx6Q ($9.25 in chips)
Seat 6: 75K2MXwN65Sjfp1yHd50Hg ($11.70 in chips)
Seat 7: cFHQjKQOOKTUzoilhrXHLg ($13.15 in chips)
Seat 8: HxeBVq06/3Bh/H986sgdbw ($50.75 in chips)
Seat 9: M+7+BTmX5vZatHVuoRB1nA ($43.25 in chips)
M+7+BTmX5vZatHVuoRB1nA: posts small blind $0.25
DSM67hHHq1XFoEOi9p8Alw: is sitting out
HZkVla4kK2SI42CVrPZ/ig: posts big blind $0.50
*** HOLE CARDS ***
SWv01peOe69QQRvhQTqjQw: folds
DSM67hHHq1XFoEOi9p8Alw leaves the table
M3JFBNQ8Bbw3FBZ/18MuXw: folds
NnQCepdIR/AOUQn1yhYx6Q: folds
E2518gp4aFz1+kAgmGqeEg joins the table at seat #1
75K2MXwN65Sjfp1yHd50Hg: folds
cFHQjKQOOKTUzoilhrXHLg: calls $0.50
HxeBVq06/3Bh/H986sgdbw: calls $0.50
M+7+BTmX5vZatHVuoRB1nA: folds
HZkVla4kK2SI42CVrPZ/ig: checks
*** FLOP *** [8d Qc 5h]
HZkVla4kK2SI42CVrPZ/ig: checks
cFHQjKQOOKTUzoilhrXHLg: checks
HxeBVq06/3Bh/H986sgdbw: checks
*** TURN *** [8d Qc 5h] [2c]
HZkVla4kK2SI42CVrPZ/ig: checks
cFHQjKQOOKTUzoilhrXHLg: bets $1
HxeBVq06/3Bh/H986sgdbw: calls $1
HZkVla4kK2SI42CVrPZ/ig: folds
*** RIVER *** [8d Qc 5h 2c] [Th]
cFHQjKQOOKTUzoilhrXHLg: bets $1
HxeBVq06/3Bh/H986sgdbw: folds
cFHQjKQOOKTUzoilhrXHLg collected $3.60 from pot
*** SUMMARY ***
Total pot $3.75 | Rake $0.15
Board [8d Qc 5h 2c Th]
Seat 2: HZkVla4kK2SI42CVrPZ/ig (big blind) folded on the Turn
Seat 3: SWv01peOe69QQRvhQTqjQw folded before Flop (didn't bet)
Seat 4: M3JFBNQ8Bbw3FBZ/18MuXw folded before Flop (didn't bet)
Seat 5: NnQCepdIR/AOUQn1yhYx6Q folded before Flop (didn't bet)
Seat 6: 75K2MXwN65Sjfp1yHd50Hg folded before Flop (didn't bet)
Seat 7: cFHQjKQOOKTUzoilhrXHLg collected ($3.60)
Seat 8: HxeBVq06/3Bh/H986sgdbw (button) folded on the River
Seat 9: M+7+BTmX5vZatHVuoRB1nA (small blind) folded before Flop



PokerStars Game #59940638652:  Hold'em No Limit ($0.25/$0.50) - 2009/07/01 1:12:19 ET
Table '+dXkOAQyS8j9PQZusUTMpg' 2-max Seat #1 is the button
Seat 1: XFa6sBGjP2gxoIvxR3fZIg ($117 in chips)
Seat 2: 5IBeOgaApY1Bvzv2P8X4EA ($77.30 in chips)
XFa6sBGjP2gxoIvxR3fZIg: posts small blind $0.25
5IBeOgaApY1Bvzv2P8X4EA: posts big blind $0.50
*** HOLE CARDS ***
XFa6sBGjP2gxoIvxR3fZIg: raises $1 to $1.50
5IBeOgaApY1Bvzv2P8X4EA: folds
XFa6sBGjP2gxoIvxR3fZIg collected $1 from pot
XFa6sBGjP2gxoIvxR3fZIg: doesn't show hand
*** SUMMARY ***
Total pot $1 | Rake $0
Seat 1: XFa6sBGjP2gxoIvxR3fZIg (button) (small blind) collected ($1)
Seat 2: 5IBeOgaApY1Bvzv2P8X4EA (big blind) folded before Flop



PokerStars Game #59940639066:  Hold'em No Limit ($0.25/$0.50) - 2009/07/01 1:12:20 ET
Table 'EiNh8p/wGJ1FP575iMFnqg' 9-max Seat #7 is the button
Seat 1: r3ZqM1Mi0W3y4hOdssE+Sg ($67.25 in chips)
Seat 2: 8ehL7qlZzjgUh2H35iiWLw ($54.15 in chips)
Seat 3: ymLPoEIl7UL3TvZYmnadxQ ($58.90 in chips)
Seat 4: cMzaiXAM/ZAdNaEUu+LqhA ($50.75 in chips)
Seat 5: M+7+BTmX5vZatHVuoRB1nA ($79.70 in chips)
Seat 6: 3UmXLy3GfjC3EkOebduerQ ($61.60 in chips)
Seat 7: 997ViqAtWn1FPjJqcffwcA ($50 in chips)
Seat 8: mSD1pginDsyHG5PDfqzphw ($10 in chips)
Seat 9: GuPkZObrz5Zkkn8FsEdF9w ($30 in chips)
mSD1pginDsyHG5PDfqzphw: posts small blind $0.25
GuPkZObrz5Zkkn8FsEdF9w: posts big blind $0.50
*** HOLE CARDS ***
r3ZqM1Mi0W3y4hOdssE+Sg: folds
8ehL7qlZzjgUh2H35iiWLw: folds
ymLPoEIl7UL3TvZYmnadxQ: folds
cMzaiXAM/ZAdNaEUu+LqhA: folds
M+7+BTmX5vZatHVuoRB1nA: folds
3UmXLy3GfjC3EkOebduerQ: folds
997ViqAtWn1FPjJqcffwcA: folds
mSD1pginDsyHG5PDfqzphw: folds
GuPkZObrz5Zkkn8FsEdF9w collected $0.50 from pot
GuPkZObrz5Zkkn8FsEdF9w: doesn't show hand
*** SUMMARY ***
Total pot $0.50 | Rake $0
Seat 1: r3ZqM1Mi0W3y4hOdssE+Sg folded before Flop (didn't bet)
Seat 2: 8ehL7qlZzjgUh2H35iiWLw folded before Flop (didn't bet)
Seat 3: ymLPoEIl7UL3TvZYmnadxQ folded before Flop (didn't bet)
Seat 4: cMzaiXAM/ZAdNaEUu+LqhA folded before Flop (didn't bet)
Seat 5: M+7+BTmX5vZatHVuoRB1nA folded before Flop (didn't bet)
Seat 6: 3UmXLy3GfjC3EkOebduerQ folded before Flop (didn't bet)
Seat 7: 997ViqAtWn1FPjJqcffwcA (button) folded before Flop (didn't bet)
Seat 8: mSD1pginDsyHG5PDfqzphw (small blind) folded before Flop
Seat 9: GuPkZObrz5Zkkn8FsEdF9w (big blind) collected ($0.50)



PokerStars Game #59940641266:  Hold'em No Limit ($0.25/$0.50) - 2009/07/01 1:12:23 ET
Table 'lSisgp6H7Fg1hH5VfjEjYQ' 9-max Seat #1 is the button
Seat 1: 5k9fvXD9suIgCxU4HLQjTw ($50 in chips)
Seat 2: UrcnkQOiLVk8BlKDPJSy7Q ($76.05 in chips)
Seat 3: aTkyjTh3w5YLWiIERupZOA ($48.40 in chips)
Seat 4: bwv/rbH/hHhPhY6u9mu04w ($35.35 in chips)
Seat 5: mSD1pginDsyHG5PDfqzphw ($10 in chips)
Seat 6: +k7T5ocke8UwavtgUHm+Cg ($65.90 in chips)
Seat 7: IDtNLR9uFCDdjNsJWMHA5Q ($22.55 in chips)
Seat 8: a4JDWmpFQkL10XfAyuF51A ($26.25 in chips)
Seat 9: YzeKFbJVLmJGTgNH3ySQlw ($12.50 in chips)
UrcnkQOiLVk8BlKDPJSy7Q: posts small blind $0.25
aTkyjTh3w5YLWiIERupZOA: posts big blind $0.50
*** HOLE CARDS ***
bwv/rbH/hHhPhY6u9mu04w: folds
mSD1pginDsyHG5PDfqzphw: folds
+k7T5ocke8UwavtgUHm+Cg: calls $0.50
IDtNLR9uFCDdjNsJWMHA5Q: folds
a4JDWmpFQkL10XfAyuF51A: folds
YzeKFbJVLmJGTgNH3ySQlw: folds
5k9fvXD9suIgCxU4HLQjTw: folds
UrcnkQOiLVk8BlKDPJSy7Q: calls $0.25
aTkyjTh3w5YLWiIERupZOA: checks
*** FLOP *** [5c 4h As]
UrcnkQOiLVk8BlKDPJSy7Q: checks
aTkyjTh3w5YLWiIERupZOA: checks
+k7T5ocke8UwavtgUHm+Cg: checks
*** TURN *** [5c 4h As] [Ad]
UrcnkQOiLVk8BlKDPJSy7Q: checks
aTkyjTh3w5YLWiIERupZOA: checks
+k7T5ocke8UwavtgUHm+Cg: checks
*** RIVER *** [5c 4h As Ad] [2d]
UrcnkQOiLVk8BlKDPJSy7Q: bets $1
aTkyjTh3w5YLWiIERupZOA: calls $1
+k7T5ocke8UwavtgUHm+Cg: folds
*** SHOW DOWN ***
UrcnkQOiLVk8BlKDPJSy7Q: shows [3s 3h] (a straight, Ace to Five)
aTkyjTh3w5YLWiIERupZOA: mucks hand
UrcnkQOiLVk8BlKDPJSy7Q collected $3.35 from pot
*** SUMMARY ***
Total pot $3.50 | Rake $0.15
Board [5c 4h As Ad 2d]
Seat 1: 5k9fvXD9suIgCxU4HLQjTw (button) folded before Flop (didn't bet)
Seat 2: UrcnkQOiLVk8BlKDPJSy7Q (small blind) showed [3s 3h] and won ($3.35) with a straight, Ace to Five
Seat 3: aTkyjTh3w5YLWiIERupZOA (big blind) mucked
Seat 4: bwv/rbH/hHhPhY6u9mu04w folded before Flop (didn't bet)
Seat 5: mSD1pginDsyHG5PDfqzphw folded before Flop (didn't bet)
Seat 6: +k7T5ocke8UwavtgUHm+Cg folded on the River
Seat 7: IDtNLR9uFCDdjNsJWMHA5Q folded before Flop (didn't bet)
Seat 8: a4JDWmpFQkL10XfAyuF51A folded before Flop (didn't bet)
Seat 9: YzeKFbJVLmJGTgNH3ySQlw folded before Flop (didn't bet)



PokerStars Game #59940641074:  Hold'em No Limit ($0.25/$0.50) - 2009/07/01 1:12:23 ET
Table '8BQGgNetI1NOvWeu3gtMNw' 2-max Seat #2 is the button
Seat 1: bypIyrYcAAifLfhZpGlKLA ($113.30 in chips)
Seat 2: Z4HwehErEwzsv/noQlfUlg ($82.85 in chips)
Z4HwehErEwzsv/noQlfUlg: posts small blind $0.25
bypIyrYcAAifLfhZpGlKLA: posts big blind $0.50
*** HOLE CARDS ***
Z4HwehErEwzsv/noQlfUlg: calls $0.25
bypIyrYcAAifLfhZpGlKLA: checks
*** FLOP *** [4d 7s 8c]
bypIyrYcAAifLfhZpGlKLA: checks
Z4HwehErEwzsv/noQlfUlg: bets $1.50
bypIyrYcAAifLfhZpGlKLA: calls $1.50
*** TURN *** [4d 7s 8c] [8h]
bypIyrYcAAifLfhZpGlKLA: checks
Z4HwehErEwzsv/noQlfUlg: bets $3
bypIyrYcAAifLfhZpGlKLA: calls $3
*** RIVER *** [4d 7s 8c 8h] [Ks]
bypIyrYcAAifLfhZpGlKLA: checks
Z4HwehErEwzsv/noQlfUlg: checks
*** SHOW DOWN ***
bypIyrYcAAifLfhZpGlKLA: shows [Ad 6s] (a pair of Eights)
Z4HwehErEwzsv/noQlfUlg: shows [4h 3h] (two pair, Eights and Fours)
Z4HwehErEwzsv/noQlfUlg collected $9.55 from pot
*** SUMMARY ***
Total pot $10 | Rake $0.45
Board [4d 7s 8c 8h Ks]
Seat 1: bypIyrYcAAifLfhZpGlKLA (big blind) showed [Ad 6s] and lost with a pair of Eights
Seat 2: Z4HwehErEwzsv/noQlfUlg (button) (small blind) showed [4h 3h] and won ($9.55) with two pair, Eights and Fours



PokerStars Game #59940641344:  Hold'em No Limit ($0.25/$0.50) - 2009/07/01 1:12:23 ET
Table 'QOgaEqMcJ73pcUMMxoisUg' 6-max Seat #5 is the button
Seat 1: lxIzoHy0RnkfFSODHC2liw ($50 in chips)
Seat 2: oqOqoO2AyCZenUghCxMDxw ($65 in chips)
Seat 3: Rt6KgtZ8YaJoTc3FPim00w ($53.75 in chips)
Seat 4: zAcsDhG/T128Vn7XGVSgKg ($59.90 in chips)
Seat 5: 6vNxrjjCl6FwfaaymM9jjg ($16.45 in chips)
Seat 6: AdS8BJMOheS01zjCDfPMFg ($54.10 in chips)
AdS8BJMOheS01zjCDfPMFg: posts small blind $0.25
lxIzoHy0RnkfFSODHC2liw: posts big blind $0.50
*** HOLE CARDS ***
oqOqoO2AyCZenUghCxMDxw: folds
Rt6KgtZ8YaJoTc3FPim00w: folds
zAcsDhG/T128Vn7XGVSgKg: folds
6vNxrjjCl6FwfaaymM9jjg: raises $2 to $2.50
AdS8BJMOheS01zjCDfPMFg: folds
lxIzoHy0RnkfFSODHC2liw: folds
6vNxrjjCl6FwfaaymM9jjg collected $1.25 from pot
*** SUMMARY ***
Total pot $1.25 | Rake $0
Seat 1: lxIzoHy0RnkfFSODHC2liw (big blind) folded before Flop
Seat 2: oqOqoO2AyCZenUghCxMDxw folded before Flop (didn't bet)
Seat 3: Rt6KgtZ8YaJoTc3FPim00w folded before Flop (didn't bet)
Seat 4: zAcsDhG/T128Vn7XGVSgKg folded before Flop (didn't bet)
Seat 5: 6vNxrjjCl6FwfaaymM9jjg (button) collected ($1.25)
Seat 6: AdS8BJMOheS01zjCDfPMFg (small blind) folded before Flop



PokerStars Game #59940642660:  Hold'em No Limit ($0.25/$0.50) - 2009/07/01 1:12:26 ET
Table '+dXkOAQyS8j9PQZusUTMpg' 2-max Seat #2 is the button
Seat 1: XFa6sBGjP2gxoIvxR3fZIg ($117.50 in chips)
Seat 2: 5IBeOgaApY1Bvzv2P8X4EA ($76.80 in chips)
5IBeOgaApY1Bvzv2P8X4EA: posts small blind $0.25
XFa6sBGjP2gxoIvxR3fZIg: posts big blind $0.50
*** HOLE CARDS ***
5IBeOgaApY1Bvzv2P8X4EA: calls $0.25
XFa6sBGjP2gxoIvxR3fZIg: checks
*** FLOP *** [7s 2h 6c]
XFa6sBGjP2gxoIvxR3fZIg: bets $1
5IBeOgaApY1Bvzv2P8X4EA: raises $1.50 to $2.50
XFa6sBGjP2gxoIvxR3fZIg: calls $1.50
*** TURN *** [7s 2h 6c] [4c]
XFa6sBGjP2gxoIvxR3fZIg: checks
5IBeOgaApY1Bvzv2P8X4EA: bets $5.50
XFa6sBGjP2gxoIvxR3fZIg: raises $13 to $18.50
5IBeOgaApY1Bvzv2P8X4EA: folds
XFa6sBGjP2gxoIvxR3fZIg collected $16.50 from pot
*** SUMMARY ***
Total pot $17 | Rake $0.50
Board [7s 2h 6c 4c]
Seat 1: XFa6sBGjP2gxoIvxR3fZIg (big blind) collected ($16.50)
Seat 2: 5IBeOgaApY1Bvzv2P8X4EA (button) (small blind) folded on the Turn



PokerStars Game #59940643374:  Hold'em No Limit ($0.25/$0.50) - 2009/07/01 1:12:27 ET
Table '0eJtgVAXVvBgncFdcUpXcQ' 2-max Seat #2 is the button
Seat 1: Ag6DvxX4vbRheqsv2zXKTQ ($49.20 in chips)
Seat 2: KMc4R+K9ao4Ur3rF7NGe6Q ($4.55 in chips)
KMc4R+K9ao4Ur3rF7NGe6Q: posts small blind $0.25
Ag6DvxX4vbRheqsv2zXKTQ: posts big blind $0.50
*** HOLE CARDS ***
KMc4R+K9ao4Ur3rF7NGe6Q: calls $0.25
Ag6DvxX4vbRheqsv2zXKTQ: checks
*** FLOP *** [Kc Ad Ts]
Ag6DvxX4vbRheqsv2zXKTQ: checks
KMc4R+K9ao4Ur3rF7NGe6Q: checks
*** TURN *** [Kc Ad Ts] [Ks]
Ag6DvxX4vbRheqsv2zXKTQ: bets $0.50
KMc4R+K9ao4Ur3rF7NGe6Q: folds
Ag6DvxX4vbRheqsv2zXKTQ collected $0.95 from pot
*** SUMMARY ***
Total pot $1 | Rake $0.05
Board [Kc Ad Ts Ks]
Seat 1: Ag6DvxX4vbRheqsv2zXKTQ (big blind) collected ($0.95)
Seat 2: KMc4R+K9ao4Ur3rF7NGe6Q (button) (small blind) folded on the Turn



PokerStars Game #59940643354:  Hold'em No Limit ($0.25/$0.50) - 2009/07/01 1:12:27 ET
Table 'BCN5su+SsXiy1zRMJi0SJw' 6-max Seat #2 is the button
Seat 1: GxXV09ciXaOxyY2H5aMIIw ($54.90 in chips)
Seat 2: oU2kDCkT/gilYbHWrg7D8w ($42.45 in chips)
Seat 3: kwgv5lNhiFrfONXCshzxlA ($28.25 in chips)
Seat 4: 4QfsCWthT/vSLirorNXqtg ($50 in chips)
Seat 5: cEMJmfAUQZmMChZe6aacKw ($24.50 in chips)
Seat 6: b2symlOdL7+0c9Pj4N/KlA ($58.90 in chips)
kwgv5lNhiFrfONXCshzxlA: posts small blind $0.25
4QfsCWthT/vSLirorNXqtg: posts big blind $0.50
*** HOLE CARDS ***
oU2kDCkT/gilYbHWrg7D8w said, "spriggs"
cEMJmfAUQZmMChZe6aacKw: raises $1 to $1.50
b2symlOdL7+0c9Pj4N/KlA: folds
GxXV09ciXaOxyY2H5aMIIw: folds
oU2kDCkT/gilYbHWrg7D8w: folds
kwgv5lNhiFrfONXCshzxlA: folds
4QfsCWthT/vSLirorNXqtg: folds
cEMJmfAUQZmMChZe6aacKw collected $1.25 from pot
cEMJmfAUQZmMChZe6aacKw: doesn't show hand
*** SUMMARY ***
Total pot $1.25 | Rake $0
Seat 1: GxXV09ciXaOxyY2H5aMIIw folded before Flop (didn't bet)
Seat 2: oU2kDCkT/gilYbHWrg7D8w (button) folded before Flop (didn't bet)
Seat 3: kwgv5lNhiFrfONXCshzxlA (small blind) folded before Flop
Seat 4: 4QfsCWthT/vSLirorNXqtg (big blind) folded before Flop
Seat 5: cEMJmfAUQZmMChZe6aacKw collected ($1.25)
Seat 6: b2symlOdL7+0c9Pj4N/KlA folded before Flop (didn't bet)



PokerStars Game #59940644448:  Hold'em No Limit ($0.25/$0.50) - 2009/07/01 1:12:29 ET
Table 'c/CRn+68J3Y8KxD5g1ek2Q' 2-max Seat #1 is the button
Seat 1: 46qCyJ6evTkHo9al5sBMNA ($113.80 in chips)
Seat 2: BypVLsYQt3ePFm2xQL/dOA ($250.55 in chips)
46qCyJ6evTkHo9al5sBMNA: posts small blind $0.25
BypVLsYQt3ePFm2xQL/dOA: posts big blind $0.50
*** HOLE CARDS ***
46qCyJ6evTkHo9al5sBMNA: folds
BypVLsYQt3ePFm2xQL/dOA collected $0.50 from pot
BypVLsYQt3ePFm2xQL/dOA: doesn't show hand
*** SUMMARY ***
Total pot $0.50 | Rake $0
Seat 1: 46qCyJ6evTkHo9al5sBMNA (button) (small blind) folded before Flop
Seat 2: BypVLsYQt3ePFm2xQL/dOA (big blind) collected ($0.50)



PokerStars Game #59940645998:  Hold'em No Limit ($0.25/$0.50) - 2009/07/01 1:12:31 ET
Table 'PALRfuH85dr5IkDfdv6new' 9-max Seat #7 is the button
Seat 1: v/4aX0ejnaIFK4ftDk2Lyg ($49.50 in chips)
Seat 2: 1aXjSbrubyQKHeauooF5Wg ($41.90 in chips)
Seat 3: 50QWoELmpmHFrFIlWMJo9g ($91.50 in chips)
Seat 4: mZNMJI1mY40XTC0U7GZakA ($57.55 in chips)
Seat 6: ottZQkg1UDWk85BtBzGJzg ($50.10 in chips)
Seat 7: 3NcyXvr39gnK+KbTq7ezyA ($60.80 in chips)
Seat 8: NkS+CseUKx4XHszWq0PXEQ ($76.50 in chips)
Seat 9: viwBDtJsY6JfsFOdBAyJIQ ($9.50 in chips)
NkS+CseUKx4XHszWq0PXEQ: posts small blind $0.25
viwBDtJsY6JfsFOdBAyJIQ: posts big blind $0.50
qEn9ijNGtuyTxamBf07hYg: sits out
*** HOLE CARDS ***
v/4aX0ejnaIFK4ftDk2Lyg: folds
1aXjSbrubyQKHeauooF5Wg: raises $1 to $1.50
50QWoELmpmHFrFIlWMJo9g: calls $1.50
mZNMJI1mY40XTC0U7GZakA: folds
ottZQkg1UDWk85BtBzGJzg: folds
3NcyXvr39gnK+KbTq7ezyA: folds
NkS+CseUKx4XHszWq0PXEQ: folds
viwBDtJsY6JfsFOdBAyJIQ: folds
*** FLOP *** [Js 5h 7d]
1aXjSbrubyQKHeauooF5Wg: bets $2
50QWoELmpmHFrFIlWMJo9g: folds
1aXjSbrubyQKHeauooF5Wg collected $3.60 from pot
1aXjSbrubyQKHeauooF5Wg: doesn't show hand
*** SUMMARY ***
Total pot $3.75 | Rake $0.15
Board [Js 5h 7d]
Seat 1: v/4aX0ejnaIFK4ftDk2Lyg folded before Flop (didn't bet)
Seat 2: 1aXjSbrubyQKHeauooF5Wg collected ($3.60)
Seat 3: 50QWoELmpmHFrFIlWMJo9g folded on the Flop
Seat 4: mZNMJI1mY40XTC0U7GZakA folded before Flop (didn't bet)
Seat 6: ottZQkg1UDWk85BtBzGJzg folded before Flop (didn't bet)
Seat 7: 3NcyXvr39gnK+KbTq7ezyA (button) folded before Flop (didn't bet)
Seat 8: NkS+CseUKx4XHszWq0PXEQ (small blind) folded before Flop
Seat 9: viwBDtJsY6JfsFOdBAyJIQ (big blind) folded before Flop



PokerStars Game #59940646052:  Hold'em No Limit ($0.25/$0.50) - 2009/07/01 1:12:31 ET
Table '/cQuAT3ef4t+PGrXiNhGaQ' 9-max Seat #8 is the button
Seat 1: HZkVla4kK2SI42CVrPZ/ig ($14.25 in chips)
Seat 2: jXGruyaMqirTaTXNOvBdew ($67.70 in chips)
Seat 3: g4k0NXISyLCqaSWZDBjfEg ($55.35 in chips)
Seat 4: OWP/DOu+PlPK6ZZ3zYa0HA ($32.95 in chips)
Seat 5: 5SgaHdWixdClWvaEG+KUjQ ($37.10 in chips)
Seat 6: APYIOyK/4AGb+kIwlOUNBQ ($36.10 in chips)
Seat 7: J0W5D97jl5VLky+IoPvDeA ($167.75 in chips)
Seat 8: eBrej2jnlUCs/JgxFCRn2g ($42.25 in chips)
Seat 9: AjV5McH1KMMclY26QdLM5w ($25 in chips)
AjV5McH1KMMclY26QdLM5w: posts small blind $0.25
HZkVla4kK2SI42CVrPZ/ig: posts big blind $0.50
*** HOLE CARDS ***
jXGruyaMqirTaTXNOvBdew: folds
g4k0NXISyLCqaSWZDBjfEg: folds
OWP/DOu+PlPK6ZZ3zYa0HA: folds
5SgaHdWixdClWvaEG+KUjQ: folds
APYIOyK/4AGb+kIwlOUNBQ: folds
J0W5D97jl5VLky+IoPvDeA: folds
eBrej2jnlUCs/JgxFCRn2g: folds
AjV5McH1KMMclY26QdLM5w: folds
HZkVla4kK2SI42CVrPZ/ig collected $0.50 from pot
*** SUMMARY ***
Total pot $0.50 | Rake $0
Seat 1: HZkVla4kK2SI42CVrPZ/ig (big blind) collected ($0.50)
Seat 2: jXGruyaMqirTaTXNOvBdew folded before Flop (didn't bet)
Seat 3: g4k0NXISyLCqaSWZDBjfEg folded before Flop (didn't bet)
Seat 4: OWP/DOu+PlPK6ZZ3zYa0HA folded before Flop (didn't bet)
Seat 5: 5SgaHdWixdClWvaEG+KUjQ folded before Flop (didn't bet)
Seat 6: APYIOyK/4AGb+kIwlOUNBQ folded before Flop (didn't bet)
Seat 7: J0W5D97jl5VLky+IoPvDeA folded before Flop (didn't bet)
Seat 8: eBrej2jnlUCs/JgxFCRn2g (button) folded before Flop (didn't bet)
Seat 9: AjV5McH1KMMclY26QdLM5w (small blind) folded before Flop



PokerStars Game #59940646832:  Hold'em No Limit ($0.25/$0.50) - 2009/07/01 1:12:33 ET
Table 'ErOuyGLI5PT3G5MnpHgC/gQOgaEqMcJ73pcUMMxoisUg Seat #9 is the button
Seat 1: eBrej2jnlUCs/JgxFCRn2g ($40.25 in chips)
Seat 2: pciZn00ZDk4BVBMTTMcNVQ ($32.80 in chips)
Seat 3: xZCXQSXlrZkp3pZizzVXCw ($50.50 in chips)
Seat 4: 3UmXLy3GfjC3EkOebduerQ ($50 in chips)
Seat 5: JwvquocWfhTVApN5t47LgA ($64.60 in chips)
Seat 6: zE9cVigS2nW/Ljy4K4bUQA ($31.60 in chips)
Seat 7: 90Wb75h3W1BRpbqVnuk8gw ($60.45 in chips)
Seat 8: g4k0NXISyLCqaSWZDBjfEg ($50 in chips)
Seat 9: J0W5D97jl5VLky+IoPvDeA ($52.35 in chips)
eBrej2jnlUCs/JgxFCRn2g: posts small blind $0.25
pciZn00ZDk4BVBMTTMcNVQ: posts big blind $0.50
*** HOLE CARDS ***
xZCXQSXlrZkp3pZizzVXCw: folds
3UmXLy3GfjC3EkOebduerQ: folds
JwvquocWfhTVApN5t47LgA: folds
zE9cVigS2nW/Ljy4K4bUQA: folds
90Wb75h3W1BRpbqVnuk8gw: folds
g4k0NXISyLCqaSWZDBjfEg: folds
J0W5D97jl5VLky+IoPvDeA: folds
eBrej2jnlUCs/JgxFCRn2g: calls $0.25
pciZn00ZDk4BVBMTTMcNVQ: checks
*** FLOP *** [2h 3d 5s]
eBrej2jnlUCs/JgxFCRn2g: bets $0.50
pciZn00ZDk4BVBMTTMcNVQ: raises $0.50 to $1
eBrej2jnlUCs/JgxFCRn2g: calls $0.50
*** TURN *** [2h 3d 5s] [7d]
eBrej2jnlUCs/JgxFCRn2g: checks
pciZn00ZDk4BVBMTTMcNVQ: bets $1
eBrej2jnlUCs/JgxFCRn2g: calls $1
*** RIVER *** [2h 3d 5s 7d] [Js]
eBrej2jnlUCs/JgxFCRn2g: checks
pciZn00ZDk4BVBMTTMcNVQ: bets $2.50
eBrej2jnlUCs/JgxFCRn2g: calls $2.50
*** SHOW DOWN ***
pciZn00ZDk4BVBMTTMcNVQ: shows [Ad As] (a pair of Aces)
eBrej2jnlUCs/JgxFCRn2g: shows [5c 7c] (two pair, Sevens and Fives)
eBrej2jnlUCs/JgxFCRn2g collected $9.55 from pot
*** SUMMARY ***
Total pot $10 | Rake $0.45
Board [2h 3d 5s 7d Js]
Seat 1: eBrej2jnlUCs/JgxFCRn2g (small blind) showed [5c 7c] and won ($9.55) with two pair, Sevens and Fives
Seat 2: pciZn00ZDk4BVBMTTMcNVQ (big blind) showed [Ad As] and lost with a pair of Aces
Seat 3: xZCXQSXlrZkp3pZizzVXCw folded before Flop (didn't bet)
Seat 4: 3UmXLy3GfjC3EkOebduerQ folded before Flop (didn't bet)
Seat 5: JwvquocWfhTVApN5t47LgA folded before Flop (didn't bet)
Seat 6: zE9cVigS2nW/Ljy4K4bUQA folded before Flop (didn't bet)
Seat 7: 90Wb75h3W1BRpbqVnuk8gw folded before Flop (didn't bet)
Seat 8: g4k0NXISyLCqaSWZDBjfEg folded before Flop (didn't bet)
Seat 9: J0W5D97jl5VLky+IoPvDeA (button) folded before Flop (didn't bet)



PokerStars Game #59940646812:  Hold'em No Limit ($0.25/$0.50) - 2009/07/01 1:12:33 ET
Table 'ibNfFy0bCzuBaUORla0aGw' 9-max Seat #7 is the button
Seat 1: xZCXQSXlrZkp3pZizzVXCw ($50.55 in chips)
Seat 2: 90Wb75h3W1BRpbqVnuk8gw ($50 in chips)
Seat 3: AjV5McH1KMMclY26QdLM5w ($25 in chips)
Seat 4: YBN054X4blmis+B2bBlC0g ($22.65 in chips)
Seat 5: GIJAc9kPrLZHLSX8Q6i99w ($21.70 in chips)
Seat 6: H8cPaCtX7d6meGUVSM5sxw ($48.75 in chips)
Seat 7: HZkVla4kK2SI42CVrPZ/ig ($13.75 in chips)
Seat 9: pFtzb1sR4b0d1aw6aIRgDg ($56 in chips)
viwBDtJsY6JfsFOdBAyJIQ will be allowed to play after the button
pFtzb1sR4b0d1aw6aIRgDg: posts small blind $0.25
xZCXQSXlrZkp3pZizzVXCw: posts big blind $0.50
*** HOLE CARDS ***
90Wb75h3W1BRpbqVnuk8gw: folds
AjV5McH1KMMclY26QdLM5w: folds
YBN054X4blmis+B2bBlC0g: folds
GIJAc9kPrLZHLSX8Q6i99w: folds
H8cPaCtX7d6meGUVSM5sxw: folds
HZkVla4kK2SI42CVrPZ/ig: folds
pFtzb1sR4b0d1aw6aIRgDg: folds
xZCXQSXlrZkp3pZizzVXCw collected $0.50 from pot
*** SUMMARY ***
Total pot $0.50 | Rake $0
Seat 1: xZCXQSXlrZkp3pZizzVXCw (big blind) collected ($0.50)
Seat 2: 90Wb75h3W1BRpbqVnuk8gw folded before Flop (didn't bet)
Seat 3: AjV5McH1KMMclY26QdLM5w folded before Flop (didn't bet)
Seat 4: YBN054X4blmis+B2bBlC0g folded before Flop (didn't bet)
Seat 5: GIJAc9kPrLZHLSX8Q6i99w folded before Flop (didn't bet)
Seat 6: H8cPaCtX7d6meGUVSM5sxw folded before Flop (didn't bet)
Seat 7: HZkVla4kK2SI42CVrPZ/ig (button) folded before Flop (didn't bet)
Seat 9: pFtzb1sR4b0d1aw6aIRgDg (small blind) folded before Flop



PokerStars Game #59940648552:  Hold'em No Limit ($0.25/$0.50) - 2009/07/01 1:12:36 ET
Table 'c/CRn+68J3Y8KxD5g1ek2Q' 2-max Seat #2 is the button
Seat 1: 46qCyJ6evTkHo9al5sBMNA ($113.55 in chips)
Seat 2: BypVLsYQt3ePFm2xQL/dOA ($250.80 in chips)
BypVLsYQt3ePFm2xQL/dOA: posts small blind $0.25
46qCyJ6evTkHo9al5sBMNA: posts big blind $0.50
*** HOLE CARDS ***
BypVLsYQt3ePFm2xQL/dOA: calls $0.25
46qCyJ6evTkHo9al5sBMNA: checks
*** FLOP *** [4h 8s 7c]
46qCyJ6evTkHo9al5sBMNA: checks
BypVLsYQt3ePFm2xQL/dOA: checks
*** TURN *** [4h 8s 7c] [8d]
46qCyJ6evTkHo9al5sBMNA: checks
BypVLsYQt3ePFm2xQL/dOA: checks
*** RIVER *** [4h 8s 7c 8d] [Qd]
46qCyJ6evTkHo9al5sBMNA: checks
BypVLsYQt3ePFm2xQL/dOA: checks
*** SHOW DOWN ***
46qCyJ6evTkHo9al5sBMNA: shows [2s Jd] (a pair of Eights)
BypVLsYQt3ePFm2xQL/dOA: mucks hand
46qCyJ6evTkHo9al5sBMNA collected $0.95 from pot
*** SUMMARY ***
Total pot $1 | Rake $0.05
Board [4h 8s 7c 8d Qd]
Seat 1: 46qCyJ6evTkHo9al5sBMNA (big blind) showed [2s Jd] and won ($0.95) with a pair of Eights
Seat 2: BypVLsYQt3ePFm2xQL/dOA (button) (small blind) mucked



PokerStars Game #59940649114:  Hold'em No Limit ($0.25/$0.50) - 2009/07/01 1:12:37 ET
Table 'GfL/No5u5PoEnU39lP5pQg' 6-max Seat #2 is the button
Seat 1: 1WUCqNG+p+vfWRTXNu4ljw ($64.50 in chips)
Seat 2: uVwggSetzp7d+eVgowO3vg ($53.45 in chips)
Seat 3: 4pp9WxhGdbVbxCc9tlu0lw ($29 in chips)
Seat 4: r6u7MWSXF30/khcTYkrG9Q ($22.10 in chips)
Seat 5: M1KyQQvVPVuxqTAB8sR/zQ ($53.40 in chips)
Seat 6: kxPhs4ePFqMy52CInAJ2aw ($63.45 in chips)
4pp9WxhGdbVbxCc9tlu0lw: posts small blind $0.25
r6u7MWSXF30/khcTYkrG9Q: posts big blind $0.50
*** HOLE CARDS ***
M1KyQQvVPVuxqTAB8sR/zQ: folds
kxPhs4ePFqMy52CInAJ2aw: folds
1WUCqNG+p+vfWRTXNu4ljw: folds
uVwggSetzp7d+eVgowO3vg: folds
4pp9WxhGdbVbxCc9tlu0lw: calls $0.25
r6u7MWSXF30/khcTYkrG9Q: checks
*** FLOP *** [8s 4s Qc]
4pp9WxhGdbVbxCc9tlu0lw: bets $0.50
r6u7MWSXF30/khcTYkrG9Q: calls $0.50
*** TURN *** [8s 4s Qc] [Jh]
4pp9WxhGdbVbxCc9tlu0lw: bets $0.50
r6u7MWSXF30/khcTYkrG9Q: raises $1.50 to $2
4pp9WxhGdbVbxCc9tlu0lw: calls $1.50
*** RIVER *** [8s 4s Qc Jh] [6d]
4pp9WxhGdbVbxCc9tlu0lw: bets $5
r6u7MWSXF30/khcTYkrG9Q: folds
4pp9WxhGdbVbxCc9tlu0lw collected $5.75 from pot
*** SUMMARY ***
Total pot $6 | Rake $0.25
Board [8s 4s Qc Jh 6d]
Seat 1: 1WUCqNG+p+vfWRTXNu4ljw folded before Flop (didn't bet)
Seat 2: uVwggSetzp7d+eVgowO3vg (button) folded before Flop (didn't bet)
Seat 3: 4pp9WxhGdbVbxCc9tlu0lw (small blind) collected ($5.75)
Seat 4: r6u7MWSXF30/khcTYkrG9Q (big blind) folded on the River
Seat 5: M1KyQQvVPVuxqTAB8sR/zQ folded before Flop (didn't bet)
Seat 6: kxPhs4ePFqMy52CInAJ2aw folded before Flop (didn't bet)



PokerStars Game #59940652424:  Hold'em No Limit ($0.25/$0.50) - 2009/07/01 1:12:42 ET
Table 'BCN5su+SsXiy1zRMJi0SJw' 6-max Seat #3 is the button
Seat 1: GxXV09ciXaOxyY2H5aMIIw ($54.90 in chips)
Seat 2: oU2kDCkT/gilYbHWrg7D8w ($42.45 in chips)
Seat 3: kwgv5lNhiFrfONXCshzxlA ($28 in chips)
Seat 4: 4QfsCWthT/vSLirorNXqtg ($50 in chips)
Seat 5: cEMJmfAUQZmMChZe6aacKw ($25.25 in chips)
Seat 6: b2symlOdL7+0c9Pj4N/KlA ($58.90 in chips)
4QfsCWthT/vSLirorNXqtg: posts small blind $0.25
cEMJmfAUQZmMChZe6aacKw: posts big blind $0.50
*** HOLE CARDS ***
b2symlOdL7+0c9Pj4N/KlA: folds
GxXV09ciXaOxyY2H5aMIIw said, "ur welcome"
GxXV09ciXaOxyY2H5aMIIw: folds
oU2kDCkT/gilYbHWrg7D8w: folds
kwgv5lNhiFrfONXCshzxlA: calls $0.50
4QfsCWthT/vSLirorNXqtg: folds
cEMJmfAUQZmMChZe6aacKw: checks
*** FLOP *** [3c Qd Ts]
cEMJmfAUQZmMChZe6aacKw: checks
oU2kDCkT/gilYbHWrg7D8w said, "lol"
kwgv5lNhiFrfONXCshzxlA: bets $0.50
cEMJmfAUQZmMChZe6aacKw: folds
kwgv5lNhiFrfONXCshzxlA collected $1.20 from pot
*** SUMMARY ***
Total pot $1.25 | Rake $0.05
Board [3c Qd Ts]
Seat 1: GxXV09ciXaOxyY2H5aMIIw folded before Flop (didn't bet)
Seat 2: oU2kDCkT/gilYbHWrg7D8w folded before Flop (didn't bet)
Seat 3: kwgv5lNhiFrfONXCshzxlA (button) collected ($1.20)
Seat 4: 4QfsCWthT/vSLirorNXqtg (small blind) folded before Flop
Seat 5: cEMJmfAUQZmMChZe6aacKw (big blind) folded on the Flop
Seat 6: b2symlOdL7+0c9Pj4N/KlA folded before Flop (didn't bet)



PokerStars Game #59940653806:  Hold'em No Limit ($0.25/$0.50) - 2009/07/01 1:12:44 ET
Table 'otvGDROEDdqsabxskT79qg' 9-max Seat #2 is the button
Seat 1: 8ehL7qlZzjgUh2H35iiWLw ($59.75 in chips)
Seat 2: cCjTzH9jio8607WzjcfXlg ($14.40 in chips)
Seat 3: +k7T5ocke8UwavtgUHm+Cg ($69.60 in chips)
Seat 4: MG90wfSJZnOejs/KD3vlQQ ($75.90 in chips)
Seat 5: E2518gp4aFz1+kAgmGqeEg ($11.75 in chips)
Seat 6: bxLSulbgr8LmKNjOzw8URg ($56 in chips)
Seat 7: 75K2MXwN65Sjfp1yHd50Hg ($9.25 in chips)
Seat 8: zE9cVigS2nW/Ljy4K4bUQA ($30 in chips)
Seat 9: KcY3X8YpD74Kw1RHkx/g4A ($47.15 in chips)
+k7T5ocke8UwavtgUHm+Cg: posts small blind $0.25
MG90wfSJZnOejs/KD3vlQQ: posts big blind $0.50
*** HOLE CARDS ***
E2518gp4aFz1+kAgmGqeEg has timed out
E2518gp4aFz1+kAgmGqeEg: folds
E2518gp4aFz1+kAgmGqeEg is sitting out
bxLSulbgr8LmKNjOzw8URg: folds
75K2MXwN65Sjfp1yHd50Hg: folds
zE9cVigS2nW/Ljy4K4bUQA: folds
KcY3X8YpD74Kw1RHkx/g4A: calls $0.50
E2518gp4aFz1+kAgmGqeEg has returned
8ehL7qlZzjgUh2H35iiWLw: folds
cCjTzH9jio8607WzjcfXlg: folds
+k7T5ocke8UwavtgUHm+Cg: raises $2.50 to $3
MG90wfSJZnOejs/KD3vlQQ: folds
KcY3X8YpD74Kw1RHkx/g4A: calls $2.50
*** FLOP *** [Th 4c 5h]
+k7T5ocke8UwavtgUHm+Cg: bets $3
KcY3X8YpD74Kw1RHkx/g4A: calls $3
*** TURN *** [Th 4c 5h] [Ah]
+k7T5ocke8UwavtgUHm+Cg: checks
KcY3X8YpD74Kw1RHkx/g4A: checks
*** RIVER *** [Th 4c 5h Ah] [9h]
+k7T5ocke8UwavtgUHm+Cg: bets $5.50
KcY3X8YpD74Kw1RHkx/g4A: folds
+k7T5ocke8UwavtgUHm+Cg collected $11.90 from pot
+k7T5ocke8UwavtgUHm+Cg: doesn't show hand
*** SUMMARY ***
Total pot $12.50 | Rake $0.60
Board [Th 4c 5h Ah 9h]
Seat 1: 8ehL7qlZzjgUh2H35iiWLw folded before Flop (didn't bet)
Seat 2: cCjTzH9jio8607WzjcfXlg (button) folded before Flop (didn't bet)
Seat 3: +k7T5ocke8UwavtgUHm+Cg (small blind) collected ($11.90)
Seat 4: MG90wfSJZnOejs/KD3vlQQ (big blind) folded before Flop
Seat 5: E2518gp4aFz1+kAgmGqeEg folded before Flop (didn't bet)
Seat 6: bxLSulbgr8LmKNjOzw8URg folded before Flop (didn't bet)
Seat 7: 75K2MXwN65Sjfp1yHd50Hg folded before Flop (didn't bet)
Seat 8: zE9cVigS2nW/Ljy4K4bUQA folded before Flop (didn't bet)
Seat 9: KcY3X8YpD74Kw1RHkx/g4A folded on the River



PokerStars Game #59940653878:  Hold'em No Limit ($0.25/$0.50) - 2009/07/01 1:12:44 ET
Table '5EmHi+fnatGQQShcNmzOZQ' 6-max Seat #1 is the button
Seat 1: My8WkRtGx5FW6rJ1I4R3hg ($44.10 in chips)
Seat 2: bfFjgAtIoAI+pUxUwFt3aQ ($39.70 in chips)
Seat 3: 1mYbhL8CU/QYqfVmFcaHDQ ($9.55 in chips)
Seat 4: 1b+2BbjMN8qhR1WPqdE9VQ ($54.15 in chips)
Seat 5: kxPhs4ePFqMy52CInAJ2aw ($93.10 in chips)
bfFjgAtIoAI+pUxUwFt3aQ: posts small blind $0.25
1mYbhL8CU/QYqfVmFcaHDQ: posts big blind $0.50
*** HOLE CARDS ***
1b+2BbjMN8qhR1WPqdE9VQ: folds
kxPhs4ePFqMy52CInAJ2aw: raises $1.50 to $2
My8WkRtGx5FW6rJ1I4R3hg: folds
bfFjgAtIoAI+pUxUwFt3aQ: folds
1mYbhL8CU/QYqfVmFcaHDQ: folds
kxPhs4ePFqMy52CInAJ2aw collected $1.25 from pot
kxPhs4ePFqMy52CInAJ2aw: doesn't show hand
*** SUMMARY ***
Total pot $1.25 | Rake $0
Seat 1: My8WkRtGx5FW6rJ1I4R3hg (button) folded before Flop (didn't bet)
Seat 2: bfFjgAtIoAI+pUxUwFt3aQ (small blind) folded before Flop
Seat 3: 1mYbhL8CU/QYqfVmFcaHDQ (big blind) folded before Flop
Seat 4: 1b+2BbjMN8qhR1WPqdE9VQ folded before Flop (didn't bet)
Seat 5: kxPhs4ePFqMy52CInAJ2aw collected ($1.25)



PokerStars Game #59940654218:  Hold'em No Limit ($0.25/$0.50) - 2009/07/01 1:12:45 ET
Table 'EiNh8p/wGJ1FP575iMFnqg' 9-max Seat #8 is the button
Seat 1: r3ZqM1Mi0W3y4hOdssE+Sg ($67.25 in chips)
Seat 2: 8ehL7qlZzjgUh2H35iiWLw ($54.15 in chips)
Seat 3: ymLPoEIl7UL3TvZYmnadxQ ($58.90 in chips)
Seat 4: cMzaiXAM/ZAdNaEUu+LqhA ($50.75 in chips)
Seat 5: M+7+BTmX5vZatHVuoRB1nA ($79.70 in chips)
Seat 6: 3UmXLy3GfjC3EkOebduerQ ($61.60 in chips)
Seat 7: 997ViqAtWn1FPjJqcffwcA ($50 in chips)
Seat 8: mSD1pginDsyHG5PDfqzphw ($10 in chips)
Seat 9: GuPkZObrz5Zkkn8FsEdF9w ($30.25 in chips)
GuPkZObrz5Zkkn8FsEdF9w: posts small blind $0.25
r3ZqM1Mi0W3y4hOdssE+Sg: posts big blind $0.50
*** HOLE CARDS ***
8ehL7qlZzjgUh2H35iiWLw: folds
ymLPoEIl7UL3TvZYmnadxQ: raises $0.50 to $1
cMzaiXAM/ZAdNaEUu+LqhA: folds
M+7+BTmX5vZatHVuoRB1nA: folds
3UmXLy3GfjC3EkOebduerQ: folds
997ViqAtWn1FPjJqcffwcA: folds
mSD1pginDsyHG5PDfqzphw: folds
GuPkZObrz5Zkkn8FsEdF9w: calls $0.75
r3ZqM1Mi0W3y4hOdssE+Sg: folds
*** FLOP *** [8c 8d Ad]
GuPkZObrz5Zkkn8FsEdF9w: checks
ymLPoEIl7UL3TvZYmnadxQ: bets $1
GuPkZObrz5Zkkn8FsEdF9w: folds
ymLPoEIl7UL3TvZYmnadxQ collected $2.40 from pot
ymLPoEIl7UL3TvZYmnadxQ: doesn't show hand
*** SUMMARY ***
Total pot $2.50 | Rake $0.10
Board [8c 8d Ad]
Seat 1: r3ZqM1Mi0W3y4hOdssE+Sg (big blind) folded before Flop
Seat 2: 8ehL7qlZzjgUh2H35iiWLw folded before Flop (didn't bet)
Seat 3: ymLPoEIl7UL3TvZYmnadxQ collected ($2.40)
Seat 4: cMzaiXAM/ZAdNaEUu+LqhA folded before Flop (didn't bet)
Seat 5: M+7+BTmX5vZatHVuoRB1nA folded before Flop (didn't bet)
Seat 6: 3UmXLy3GfjC3EkOebduerQ folded before Flop (didn't bet)
Seat 7: 997ViqAtWn1FPjJqcffwcA folded before Flop (didn't bet)
Seat 8: mSD1pginDsyHG5PDfqzphw (button) folded before Flop (didn't bet)
Seat 9: GuPkZObrz5Zkkn8FsEdF9w (small blind) folded on the Flop



PokerStars Game #59940654472:  Hold'em No Limit ($0.25/$0.50) - 2009/07/01 1:12:45 ET
Table '0eJtgVAXVvBgncFdcUpXcQ' 2-max Seat #1 is the button
Seat 1: Ag6DvxX4vbRheqsv2zXKTQ ($49.65 in chips)
Seat 2: KMc4R+K9ao4Ur3rF7NGe6Q ($4.05 in chips)
Ag6DvxX4vbRheqsv2zXKTQ: posts small blind $0.25
KMc4R+K9ao4Ur3rF7NGe6Q: posts big blind $0.50
*** HOLE CARDS ***
Ag6DvxX4vbRheqsv2zXKTQ: folds
KMc4R+K9ao4Ur3rF7NGe6Q collected $0.50 from pot
KMc4R+K9ao4Ur3rF7NGe6Q: doesn't show hand
*** SUMMARY ***
Total pot $0.50 | Rake $0
Seat 1: Ag6DvxX4vbRheqsv2zXKTQ (button) (small blind) folded before Flop
Seat 2: KMc4R+K9ao4Ur3rF7NGe6Q (big blind) collected ($0.50)



PokerStars Game #59940655724:  Hold'em No Limit ($0.25/$0.50) - 2009/07/01 1:12:48 ET
Table '37qXEp3oe+er5q4CZip9eQ' 6-max Seat #4 is the button
Seat 1: lxIzoHy0RnkfFSODHC2liw ($50 in chips)
Seat 2: LvH4G7n+QSjT6NDaD3cREA ($59.85 in chips)
Seat 3: Rt6KgtZ8YaJoTc3FPim00w ($109.45 in chips)
Seat 4: XsmE8nXMAAMFJbWaJTmHFw ($48.20 in chips)
Seat 5: VOmI0x4dDPnTESZd5B4d1Q ($38 in chips)
Seat 6: N50kln4negd8q7Mmoz1j4g ($9.55 in chips)
VOmI0x4dDPnTESZd5B4d1Q: posts small blind $0.25
N50kln4negd8q7Mmoz1j4g: posts big blind $0.50
*** HOLE CARDS ***
XsmE8nXMAAMFJbWaJTmHFw said, "Wow"
lxIzoHy0RnkfFSODHC2liw: raises $1 to $1.50
LvH4G7n+QSjT6NDaD3cREA: folds
Rt6KgtZ8YaJoTc3FPim00w: folds
XsmE8nXMAAMFJbWaJTmHFw: folds
VOmI0x4dDPnTESZd5B4d1Q: folds
N50kln4negd8q7Mmoz1j4g: folds
lxIzoHy0RnkfFSODHC2liw collected $1.25 from pot
*** SUMMARY ***
Total pot $1.25 | Rake $0
Seat 1: lxIzoHy0RnkfFSODHC2liw collected ($1.25)
Seat 2: LvH4G7n+QSjT6NDaD3cREA folded before Flop (didn't bet)
Seat 3: Rt6KgtZ8YaJoTc3FPim00w folded before Flop (didn't bet)
Seat 4: XsmE8nXMAAMFJbWaJTmHFw (button) folded before Flop (didn't bet)
Seat 5: VOmI0x4dDPnTESZd5B4d1Q (small blind) folded before Flop
Seat 6: N50kln4negd8q7Mmoz1j4g (big blind) folded before Flop



PokerStars Game #59940656662:  Hold'em No Limit ($0.25/$0.50) - 2009/07/01 1:12:49 ET
Table 'MJxeZCzYELxiIsyUZyT0jw' 6-max Seat #2 is the button
Seat 1: +Pf9jTVizYlIo+woPvptfA ($50 in chips)
Seat 2: t3GiVMzqA9Svgr5Uol32cQ ($27.10 in chips)
Seat 3: sIG4mp8tZEI+W4nKZNkkQA ($52.10 in chips)
Seat 4: alGiiQP/wwtYnfuXII+sgw ($62.35 in chips)
Seat 5: 3jvoOXNtXE90w2BdfNZwZQ ($52.30 in chips)
Seat 6: c0n4hrn20AML9qzyFC2E8Q ($60.10 in chips)
sIG4mp8tZEI+W4nKZNkkQA: posts small blind $0.25
alGiiQP/wwtYnfuXII+sgw: posts big blind $0.50
*** HOLE CARDS ***
3jvoOXNtXE90w2BdfNZwZQ: raises $1.50 to $2
c0n4hrn20AML9qzyFC2E8Q: folds
+Pf9jTVizYlIo+woPvptfA: folds
t3GiVMzqA9Svgr5Uol32cQ: folds
sIG4mp8tZEI+W4nKZNkkQA: folds
alGiiQP/wwtYnfuXII+sgw: folds
3jvoOXNtXE90w2BdfNZwZQ collected $1.25 from pot
3jvoOXNtXE90w2BdfNZwZQ: doesn't show hand
*** SUMMARY ***
Total pot $1.25 | Rake $0
Seat 1: +Pf9jTVizYlIo+woPvptfA folded before Flop (didn't bet)
Seat 2: t3GiVMzqA9Svgr5Uol32cQ (button) folded before Flop (didn't bet)
Seat 3: sIG4mp8tZEI+W4nKZNkkQA (small blind) folded before Flop
Seat 4: alGiiQP/wwtYnfuXII+sgw (big blind) folded before Flop
Seat 5: 3jvoOXNtXE90w2BdfNZwZQ collected ($1.25)
Seat 6: c0n4hrn20AML9qzyFC2E8Q folded before Flop (didn't bet)



PokerStars Game #59940656564:  Hold'em No Limit ($0.25/$0.50) - 2009/07/01 1:12:49 ET
Table 'kgbJRsxfv64KrErDRBAkcw' 6-max Seat #3 is the button
Seat 1: VamsyhlFzXGF6/ydo0BHeA ($45.95 in chips)
Seat 2: AdS8BJMOheS01zjCDfPMFg ($58.55 in chips)
Seat 3: c4MNIaIyPMOMxrgT8FT5nA ($123 in chips)
Seat 5: eUBBn2R56C1IQ6Cs/vitwg ($59.95 in chips)
Seat 6: 1b+2BbjMN8qhR1WPqdE9VQ ($57.35 in chips)
eUBBn2R56C1IQ6Cs/vitwg: posts small blind $0.25
1b+2BbjMN8qhR1WPqdE9VQ: posts big blind $0.50
*** HOLE CARDS ***
VamsyhlFzXGF6/ydo0BHeA said, "joker"
VamsyhlFzXGF6/ydo0BHeA: raises $0.50 to $1
AdS8BJMOheS01zjCDfPMFg: folds
c4MNIaIyPMOMxrgT8FT5nA: folds
eUBBn2R56C1IQ6Cs/vitwg: folds
1b+2BbjMN8qhR1WPqdE9VQ: calls $0.50
*** FLOP *** [8s Qd As]
1b+2BbjMN8qhR1WPqdE9VQ: bets $2
VamsyhlFzXGF6/ydo0BHeA: calls $2
*** TURN *** [8s Qd As] [Td]
1b+2BbjMN8qhR1WPqdE9VQ: bets $4
VamsyhlFzXGF6/ydo0BHeA: calls $4
*** RIVER *** [8s Qd As Td] [Qh]
1b+2BbjMN8qhR1WPqdE9VQ: checks
VamsyhlFzXGF6/ydo0BHeA: checks
*** SHOW DOWN ***
1b+2BbjMN8qhR1WPqdE9VQ: shows [4s 3s] (a pair of Queens)
VamsyhlFzXGF6/ydo0BHeA: shows [Th Kd] (two pair, Queens and Tens)
VamsyhlFzXGF6/ydo0BHeA collected $13.60 from pot
*** SUMMARY ***
Total pot $14.25 | Rake $0.65
Board [8s Qd As Td Qh]
Seat 1: VamsyhlFzXGF6/ydo0BHeA showed [Th Kd] and won ($13.60) with two pair, Queens and Tens
Seat 2: AdS8BJMOheS01zjCDfPMFg folded before Flop (didn't bet)
Seat 3: c4MNIaIyPMOMxrgT8FT5nA (button) folded before Flop (didn't bet)
Seat 5: eUBBn2R56C1IQ6Cs/vitwg (small blind) folded before Flop
Seat 6: 1b+2BbjMN8qhR1WPqdE9VQ (big blind) showed [4s 3s] and lost with a pair of Queens



PokerStars Game #59940657898:  Hold'em No Limit ($0.25/$0.50) - 2009/07/01 1:12:51 ET
Table 'fx6MqwfYAj/Rt86hBz2L3Q' 9-max Seat #5 is the button
Seat 1: uw9QayAAxLM3Hb+HR7mSkg ($12 in chips)
Seat 2: C3rGXblctNcWI6JYPHhaEg ($39.90 in chips)
Seat 3: iadBi5AEt7gTBXbDSSnMYQ ($45.75 in chips)
Seat 5: iAISe3dVeua8PUn2wwgDHw ($65.25 in chips)
Seat 6: 5k9fvXD9suIgCxU4HLQjTw ($50 in chips)
Seat 7: SKnJuWHScqetA/qG5p+wCg ($30 in chips)
Seat 8: JYwJYYV9pM5KWdSiETl8rA ($29.75 in chips)
5k9fvXD9suIgCxU4HLQjTw: posts small blind $0.25
SKnJuWHScqetA/qG5p+wCg: posts big blind $0.50
rFvc7K/96V9eGvYRfmpoUQ: sits out
*** HOLE CARDS ***
JYwJYYV9pM5KWdSiETl8rA: folds
uw9QayAAxLM3Hb+HR7mSkg: folds
C3rGXblctNcWI6JYPHhaEg: folds
iadBi5AEt7gTBXbDSSnMYQ: calls $0.50
iAISe3dVeua8PUn2wwgDHw: folds
5k9fvXD9suIgCxU4HLQjTw: folds
SKnJuWHScqetA/qG5p+wCg: checks
*** FLOP *** [6s 5c 5h]
SKnJuWHScqetA/qG5p+wCg: bets $1
iadBi5AEt7gTBXbDSSnMYQ: calls $1
*** TURN *** [6s 5c 5h] [6d]
SKnJuWHScqetA/qG5p+wCg: checks
iadBi5AEt7gTBXbDSSnMYQ: bets $1.50
SKnJuWHScqetA/qG5p+wCg: raises $2.50 to $4
iadBi5AEt7gTBXbDSSnMYQ: calls $2.50
*** RIVER *** [6s 5c 5h 6d] [5d]
SKnJuWHScqetA/qG5p+wCg: checks
iadBi5AEt7gTBXbDSSnMYQ: checks
*** SHOW DOWN ***
SKnJuWHScqetA/qG5p+wCg: shows [Tc 6h] (a full house, Sixes full of Fives)
iadBi5AEt7gTBXbDSSnMYQ: mucks hand
SKnJuWHScqetA/qG5p+wCg collected $10.70 from pot
*** SUMMARY ***
Total pot $11.25 | Rake $0.55
Board [6s 5c 5h 6d 5d]
Seat 1: uw9QayAAxLM3Hb+HR7mSkg folded before Flop (didn't bet)
Seat 2: C3rGXblctNcWI6JYPHhaEg folded before Flop (didn't bet)
Seat 3: iadBi5AEt7gTBXbDSSnMYQ mucked
Seat 5: iAISe3dVeua8PUn2wwgDHw (button) folded before Flop (didn't bet)
Seat 6: 5k9fvXD9suIgCxU4HLQjTw (small blind) folded before Flop
Seat 7: SKnJuWHScqetA/qG5p+wCg (big blind) showed [Tc 6h] and won ($10.70) with a full house, Sixes full of Fives
Seat 8: JYwJYYV9pM5KWdSiETl8rA folded before Flop (didn't bet)



PokerStars Game #59940659376:  Hold'em No Limit ($0.25/$0.50) - 2009/07/01 1:12:54 ET
Table '8BQGgNetI1NOvWeu3gtMNw' 2-max Seat #1 is the button
Seat 1: bypIyrYcAAifLfhZpGlKLA ($108.30 in chips)
Seat 2: Z4HwehErEwzsv/noQlfUlg ($87.40 in chips)
bypIyrYcAAifLfhZpGlKLA: posts small blind $0.25
Z4HwehErEwzsv/noQlfUlg: posts big blind $0.50
*** HOLE CARDS ***
bypIyrYcAAifLfhZpGlKLA: raises $1 to $1.50
Z4HwehErEwzsv/noQlfUlg: calls $1
*** FLOP *** [Qs 2d As]
Z4HwehErEwzsv/noQlfUlg: checks
bypIyrYcAAifLfhZpGlKLA: bets $2.50
Z4HwehErEwzsv/noQlfUlg: folds
bypIyrYcAAifLfhZpGlKLA collected $2.85 from pot
bypIyrYcAAifLfhZpGlKLA: doesn't show hand
*** SUMMARY ***
Total pot $3 | Rake $0.15
Board [Qs 2d As]
Seat 1: bypIyrYcAAifLfhZpGlKLA (button) (small blind) collected ($2.85)
Seat 2: Z4HwehErEwzsv/noQlfUlg (big blind) folded on the Flop



PokerStars Game #59940659932:  Hold'em No Limit ($0.25/$0.50) - 2009/07/01 1:12:55 ET
Table 'ibNfFy0bCzuBaUORla0aGw' 9-max Seat #9 is the button
Seat 1: xZCXQSXlrZkp3pZizzVXCw ($50.80 in chips)
Seat 2: 90Wb75h3W1BRpbqVnuk8gw ($50 in chips)
Seat 3: AjV5McH1KMMclY26QdLM5w ($25 in chips)
Seat 4: YBN054X4blmis+B2bBlC0g ($22.65 in chips)
Seat 5: GIJAc9kPrLZHLSX8Q6i99w ($21.70 in chips)
Seat 6: H8cPaCtX7d6meGUVSM5sxw ($48.75 in chips)
Seat 7: HZkVla4kK2SI42CVrPZ/ig ($13.75 in chips)
Seat 8: viwBDtJsY6JfsFOdBAyJIQ ($10 in chips)
Seat 9: pFtzb1sR4b0d1aw6aIRgDg ($55.75 in chips)
xZCXQSXlrZkp3pZizzVXCw: posts small blind $0.25
90Wb75h3W1BRpbqVnuk8gw: posts big blind $0.50
viwBDtJsY6JfsFOdBAyJIQ: posts big blind $0.50
*** HOLE CARDS ***
AjV5McH1KMMclY26QdLM5w: folds
YBN054X4blmis+B2bBlC0g: folds
GIJAc9kPrLZHLSX8Q6i99w: folds
H8cPaCtX7d6meGUVSM5sxw: calls $0.50
HZkVla4kK2SI42CVrPZ/ig: folds
viwBDtJsY6JfsFOdBAyJIQ: checks
pFtzb1sR4b0d1aw6aIRgDg: folds
xZCXQSXlrZkp3pZizzVXCw: folds
90Wb75h3W1BRpbqVnuk8gw: checks
*** FLOP *** [8h 2c 4s]
90Wb75h3W1BRpbqVnuk8gw: bets $1.50
H8cPaCtX7d6meGUVSM5sxw: calls $1.50
viwBDtJsY6JfsFOdBAyJIQ: raises $3 to $4.50
90Wb75h3W1BRpbqVnuk8gw: folds
H8cPaCtX7d6meGUVSM5sxw: folds
viwBDtJsY6JfsFOdBAyJIQ collected $5.95 from pot
*** SUMMARY ***
Total pot $6.25 | Rake $0.30
Board [8h 2c 4s]
Seat 1: xZCXQSXlrZkp3pZizzVXCw (small blind) folded before Flop
Seat 2: 90Wb75h3W1BRpbqVnuk8gw (big blind) folded on the Flop
Seat 3: AjV5McH1KMMclY26QdLM5w folded before Flop (didn't bet)
Seat 4: YBN054X4blmis+B2bBlC0g folded before Flop (didn't bet)
Seat 5: GIJAc9kPrLZHLSX8Q6i99w folded before Flop (didn't bet)
Seat 6: H8cPaCtX7d6meGUVSM5sxw folded on the Flop
Seat 7: HZkVla4kK2SI42CVrPZ/ig folded before Flop (didn't bet)
Seat 8: viwBDtJsY6JfsFOdBAyJIQ collected ($5.95)
Seat 9: pFtzb1sR4b0d1aw6aIRgDg (button) folded before Flop (didn't bet)



PokerStars Game #59940660216:  Hold'em No Limit ($0.25/$0.50) - 2009/07/01 1:12:55 ET
Table '/cQuAT3ef4t+PGrXiNhGaQ' 9-max Seat #9 is the button
Seat 1: HZkVla4kK2SI42CVrPZ/ig ($14.50 in chips)
Seat 2: jXGruyaMqirTaTXNOvBdew ($67.70 in chips)
Seat 3: g4k0NXISyLCqaSWZDBjfEg ($55.35 in chips)
Seat 4: OWP/DOu+PlPK6ZZ3zYa0HA ($32.95 in chips)
Seat 5: 5SgaHdWixdClWvaEG+KUjQ ($37.10 in chips)
Seat 6: APYIOyK/4AGb+kIwlOUNBQ ($36.10 in chips)
Seat 7: J0W5D97jl5VLky+IoPvDeA ($167.75 in chips)
Seat 8: eBrej2jnlUCs/JgxFCRn2g ($42.25 in chips)
Seat 9: AjV5McH1KMMclY26QdLM5w ($25 in chips)
HZkVla4kK2SI42CVrPZ/ig: posts small blind $0.25
jXGruyaMqirTaTXNOvBdew: posts big blind $0.50
*** HOLE CARDS ***
g4k0NXISyLCqaSWZDBjfEg: folds
OWP/DOu+PlPK6ZZ3zYa0HA: folds
5SgaHdWixdClWvaEG+KUjQ: folds
APYIOyK/4AGb+kIwlOUNBQ: folds
J0W5D97jl5VLky+IoPvDeA: raises $1 to $1.50
eBrej2jnlUCs/JgxFCRn2g: folds
AjV5McH1KMMclY26QdLM5w: folds
HZkVla4kK2SI42CVrPZ/ig: folds
jXGruyaMqirTaTXNOvBdew: folds
J0W5D97jl5VLky+IoPvDeA collected $1.25 from pot
*** SUMMARY ***
Total pot $1.25 | Rake $0
Seat 1: HZkVla4kK2SI42CVrPZ/ig (small blind) folded before Flop
Seat 2: jXGruyaMqirTaTXNOvBdew (big blind) folded before Flop
Seat 3: g4k0NXISyLCqaSWZDBjfEg folded before Flop (didn't bet)
Seat 4: OWP/DOu+PlPK6ZZ3zYa0HA folded before Flop (didn't bet)
Seat 5: 5SgaHdWixdClWvaEG+KUjQ folded before Flop (didn't bet)
Seat 6: APYIOyK/4AGb+kIwlOUNBQ folded before Flop (didn't bet)
Seat 7: J0W5D97jl5VLky+IoPvDeA collected ($1.25)
Seat 8: eBrej2jnlUCs/JgxFCRn2g folded before Flop (didn't bet)
Seat 9: AjV5McH1KMMclY26QdLM5w (button) folded before Flop (didn't bet)



PokerStars Game #59940660590:  Hold'em No Limit ($0.25/$0.50) - 2009/07/01 1:12:56 ET
Table 'hSTs/dUsYLgJQuF2Onp0MQ' 6-max Seat #3 is the button
Seat 1: 1WUCqNG+p+vfWRTXNu4ljw ($50 in chips)
Seat 2: 6vNxrjjCl6FwfaaymM9jjg ($76.95 in chips)
Seat 3: C3qJBo7uxfFVDluE1lmK2w ($35.35 in chips)
Seat 4: L0aIPg7qefDQjdJo3HCVEA ($9.55 in chips)
Seat 5: IBNygaT1aa9Z1uPdJJilwA ($30 in chips)
Seat 6: M1KyQQvVPVuxqTAB8sR/zQ ($79.65 in chips)
L0aIPg7qefDQjdJo3HCVEA: posts small blind $0.25
IBNygaT1aa9Z1uPdJJilwA: posts big blind $0.50
*** HOLE CARDS ***
M1KyQQvVPVuxqTAB8sR/zQ: raises $1 to $1.50
1WUCqNG+p+vfWRTXNu4ljw: folds
6vNxrjjCl6FwfaaymM9jjg: calls $1.50
C3qJBo7uxfFVDluE1lmK2w: folds
L0aIPg7qefDQjdJo3HCVEA: folds
IBNygaT1aa9Z1uPdJJilwA: folds
*** FLOP *** [Qc Ks 8h]
M1KyQQvVPVuxqTAB8sR/zQ: bets $2.50
6vNxrjjCl6FwfaaymM9jjg: calls $2.50
*** TURN *** [Qc Ks 8h] [9s]
M1KyQQvVPVuxqTAB8sR/zQ: bets $5.50
6vNxrjjCl6FwfaaymM9jjg: calls $5.50
*** RIVER *** [Qc Ks 8h 9s] [Js]
M1KyQQvVPVuxqTAB8sR/zQ: checks
6vNxrjjCl6FwfaaymM9jjg: checks
*** SHOW DOWN ***
M1KyQQvVPVuxqTAB8sR/zQ: shows [Kh Jh] (two pair, Kings and Jacks)
6vNxrjjCl6FwfaaymM9jjg: mucks hand
M1KyQQvVPVuxqTAB8sR/zQ collected $18.80 from pot
*** SUMMARY ***
Total pot $19.75 | Rake $0.95
Board [Qc Ks 8h 9s Js]
Seat 1: 1WUCqNG+p+vfWRTXNu4ljw folded before Flop (didn't bet)
Seat 2: 6vNxrjjCl6FwfaaymM9jjg mucked
Seat 3: C3qJBo7uxfFVDluE1lmK2w (button) folded before Flop (didn't bet)
Seat 4: L0aIPg7qefDQjdJo3HCVEA (small blind) folded before Flop
Seat 5: IBNygaT1aa9Z1uPdJJilwA (big blind) folded before Flop
Seat 6: M1KyQQvVPVuxqTAB8sR/zQ showed [Kh Jh] and won ($18.80) with two pair, Kings and Jacks



PokerStars Game #59940661276:  Hold'em No Limit ($0.25/$0.50) - 2009/07/01 1:12:57 ET
Table '+dXkOAQyS8j9PQZusUTMpg' 2-max Seat #1 is the button
Seat 1: XFa6sBGjP2gxoIvxR3fZIg ($125.50 in chips)
Seat 2: 5IBeOgaApY1Bvzv2P8X4EA ($68.30 in chips)
XFa6sBGjP2gxoIvxR3fZIg: posts small blind $0.25
5IBeOgaApY1Bvzv2P8X4EA: posts big blind $0.50
*** HOLE CARDS ***
XFa6sBGjP2gxoIvxR3fZIg: raises $1 to $1.50
5IBeOgaApY1Bvzv2P8X4EA: folds
XFa6sBGjP2gxoIvxR3fZIg collected $1 from pot
*** SUMMARY ***
Total pot $1 | Rake $0
Seat 1: XFa6sBGjP2gxoIvxR3fZIg (button) (small blind) collected ($1)
Seat 2: 5IBeOgaApY1Bvzv2P8X4EA (big blind) folded before Flop



PokerStars Game #59940663580:  Hold'em No Limit ($0.25/$0.50) - 2009/07/01 1:13:01 ET
Table 'NCiXr0d5CEKBQr/cZgLhbA' 9-max Seat #4 is the button
Seat 1: pFtzb1sR4b0d1aw6aIRgDg ($50.20 in chips)
Seat 3: xZCXQSXlrZkp3pZizzVXCw ($51.95 in chips)
Seat 4: 5k9fvXD9suIgCxU4HLQjTw ($53.95 in chips)
Seat 5: zE9cVigS2nW/Ljy4K4bUQA ($63.60 in chips)
Seat 7: M+7+BTmX5vZatHVuoRB1nA ($52 in chips)
Seat 8: 1MJUKc3cc0QmUoz1JZLR2w ($49.30 in chips)
Seat 9: 4WLZvqBn5qv5tds5kt5A1Q ($56.25 in chips)
zE9cVigS2nW/Ljy4K4bUQA: posts small blind $0.25
SKnJuWHScqetA/qG5p+wCg: is sitting out
M+7+BTmX5vZatHVuoRB1nA: posts big blind $0.50
AjV5McH1KMMclY26QdLM5w: sits out
*** HOLE CARDS ***
SKnJuWHScqetA/qG5p+wCg leaves the table
1MJUKc3cc0QmUoz1JZLR2w: folds
4WLZvqBn5qv5tds5kt5A1Q: folds
pFtzb1sR4b0d1aw6aIRgDg: folds
xZCXQSXlrZkp3pZizzVXCw: folds
5k9fvXD9suIgCxU4HLQjTw: raises $1 to $1.50
zE9cVigS2nW/Ljy4K4bUQA: folds
M+7+BTmX5vZatHVuoRB1nA: folds
5k9fvXD9suIgCxU4HLQjTw collected $1.25 from pot
*** SUMMARY ***
Total pot $1.25 | Rake $0
Seat 1: pFtzb1sR4b0d1aw6aIRgDg folded before Flop (didn't bet)
Seat 3: xZCXQSXlrZkp3pZizzVXCw folded before Flop (didn't bet)
Seat 4: 5k9fvXD9suIgCxU4HLQjTw (button) collected ($1.25)
Seat 5: zE9cVigS2nW/Ljy4K4bUQA (small blind) folded before Flop
Seat 7: M+7+BTmX5vZatHVuoRB1nA (big blind) folded before Flop
Seat 8: 1MJUKc3cc0QmUoz1JZLR2w folded before Flop (didn't bet)
Seat 9: 4WLZvqBn5qv5tds5kt5A1Q folded before Flop (didn't bet)



PokerStars Game #59940664362:  Hold'em No Limit ($0.25/$0.50) - 2009/07/01 1:13:02 ET
Table 'BCN5su+SsXiy1zRMJi0SJw' 6-max Seat #4 is the button
Seat 1: GxXV09ciXaOxyY2H5aMIIw ($54.90 in chips)
Seat 2: oU2kDCkT/gilYbHWrg7D8w ($42.45 in chips)
Seat 3: kwgv5lNhiFrfONXCshzxlA ($28.70 in chips)
Seat 4: 4QfsCWthT/vSLirorNXqtg ($50 in chips)
Seat 5: cEMJmfAUQZmMChZe6aacKw ($24.75 in chips)
Seat 6: b2symlOdL7+0c9Pj4N/KlA ($58.90 in chips)
cEMJmfAUQZmMChZe6aacKw: posts small blind $0.25
b2symlOdL7+0c9Pj4N/KlA: posts big blind $0.50
*** HOLE CARDS ***
GxXV09ciXaOxyY2H5aMIIw: folds
oU2kDCkT/gilYbHWrg7D8w: raises $1 to $1.50
kwgv5lNhiFrfONXCshzxlA: calls $1.50
4QfsCWthT/vSLirorNXqtg: calls $1.50
cEMJmfAUQZmMChZe6aacKw: folds
b2symlOdL7+0c9Pj4N/KlA: folds
*** FLOP *** [6c 5h Qh]
oU2kDCkT/gilYbHWrg7D8w: bets $2.50
kwgv5lNhiFrfONXCshzxlA: folds
4QfsCWthT/vSLirorNXqtg: calls $2.50
*** TURN *** [6c 5h Qh] [2d]
oU2kDCkT/gilYbHWrg7D8w: checks
4QfsCWthT/vSLirorNXqtg: bets $6.75
oU2kDCkT/gilYbHWrg7D8w: folds
4QfsCWthT/vSLirorNXqtg collected $9.75 from pot
4QfsCWthT/vSLirorNXqtg: doesn't show hand
*** SUMMARY ***
Total pot $10.25 | Rake $0.50
Board [6c 5h Qh 2d]
Seat 1: GxXV09ciXaOxyY2H5aMIIw folded before Flop (didn't bet)
Seat 2: oU2kDCkT/gilYbHWrg7D8w folded on the Turn
Seat 3: kwgv5lNhiFrfONXCshzxlA folded on the Flop
Seat 4: 4QfsCWthT/vSLirorNXqtg (button) collected ($9.75)
Seat 5: cEMJmfAUQZmMChZe6aacKw (small blind) folded before Flop
Seat 6: b2symlOdL7+0c9Pj4N/KlA (big blind) folded before Flop



PokerStars Game #59940665510:  Hold'em No Limit ($0.25/$0.50) - 2009/07/01 1:13:04 ET
Table '+dXkOAQyS8j9PQZusUTMpg' 2-max Seat #2 is the button
Seat 1: XFa6sBGjP2gxoIvxR3fZIg ($126 in chips)
Seat 2: 5IBeOgaApY1Bvzv2P8X4EA ($67.80 in chips)
5IBeOgaApY1Bvzv2P8X4EA: posts small blind $0.25
XFa6sBGjP2gxoIvxR3fZIg: posts big blind $0.50
*** HOLE CARDS ***
5IBeOgaApY1Bvzv2P8X4EA: raises $1 to $1.50
XFa6sBGjP2gxoIvxR3fZIg: folds
5IBeOgaApY1Bvzv2P8X4EA collected $1 from pot
5IBeOgaApY1Bvzv2P8X4EA: doesn't show hand
*** SUMMARY ***
Total pot $1 | Rake $0
Seat 1: XFa6sBGjP2gxoIvxR3fZIg (big blind) folded before Flop
Seat 2: 5IBeOgaApY1Bvzv2P8X4EA (button) (small blind) collected ($1)



PokerStars Game #59940665108:  Hold'em No Limit ($0.25/$0.50) - 2009/07/01 1:13:04 ET
Table 'lSisgp6H7Fg1hH5VfjEjYQ' 9-max Seat #2 is the button
Seat 1: 5k9fvXD9suIgCxU4HLQjTw ($50 in chips)
Seat 2: UrcnkQOiLVk8BlKDPJSy7Q ($77.90 in chips)
Seat 3: aTkyjTh3w5YLWiIERupZOA ($46.90 in chips)
Seat 4: bwv/rbH/hHhPhY6u9mu04w ($35.35 in chips)
Seat 5: mSD1pginDsyHG5PDfqzphw ($10 in chips)
Seat 6: +k7T5ocke8UwavtgUHm+Cg ($65.40 in chips)
Seat 7: IDtNLR9uFCDdjNsJWMHA5Q ($22.55 in chips)
Seat 8: a4JDWmpFQkL10XfAyuF51A ($26.25 in chips)
Seat 9: YzeKFbJVLmJGTgNH3ySQlw ($12.50 in chips)
aTkyjTh3w5YLWiIERupZOA: posts small blind $0.25
bwv/rbH/hHhPhY6u9mu04w: posts big blind $0.50
*** HOLE CARDS ***
mSD1pginDsyHG5PDfqzphw: folds
+k7T5ocke8UwavtgUHm+Cg: folds
IDtNLR9uFCDdjNsJWMHA5Q: folds
a4JDWmpFQkL10XfAyuF51A: folds
YzeKFbJVLmJGTgNH3ySQlw: calls $0.50
5k9fvXD9suIgCxU4HLQjTw: folds
UrcnkQOiLVk8BlKDPJSy7Q: folds
aTkyjTh3w5YLWiIERupZOA: calls $0.25
bwv/rbH/hHhPhY6u9mu04w: checks
*** FLOP *** [4c Jc 8s]
aTkyjTh3w5YLWiIERupZOA: checks
bwv/rbH/hHhPhY6u9mu04w: checks
YzeKFbJVLmJGTgNH3ySQlw: bets $1
aTkyjTh3w5YLWiIERupZOA: folds
bwv/rbH/hHhPhY6u9mu04w: folds
YzeKFbJVLmJGTgNH3ySQlw collected $1.45 from pot
*** SUMMARY ***
Total pot $1.50 | Rake $0.05
Board [4c Jc 8s]
Seat 1: 5k9fvXD9suIgCxU4HLQjTw folded before Flop (didn't bet)
Seat 2: UrcnkQOiLVk8BlKDPJSy7Q (button) folded before Flop (didn't bet)
Seat 3: aTkyjTh3w5YLWiIERupZOA (small blind) folded on the Flop
Seat 4: bwv/rbH/hHhPhY6u9mu04w (big blind) folded on the Flop
Seat 5: mSD1pginDsyHG5PDfqzphw folded before Flop (didn't bet)
Seat 6: +k7T5ocke8UwavtgUHm+Cg folded before Flop (didn't bet)
Seat 7: IDtNLR9uFCDdjNsJWMHA5Q folded before Flop (didn't bet)
Seat 8: a4JDWmpFQkL10XfAyuF51A folded before Flop (didn't bet)
Seat 9: YzeKFbJVLmJGTgNH3ySQlw collected ($1.45)



PokerStars Game #59940665160:  Hold'em No Limit ($0.25/$0.50) - 2009/07/01 1:13:04 ET
Table '5EmHi+fnatGQQShcNmzOZQ' 6-max Seat #2 is the button
Seat 1: My8WkRtGx5FW6rJ1I4R3hg ($44.10 in chips)
Seat 2: bfFjgAtIoAI+pUxUwFt3aQ ($39.45 in chips)
Seat 3: 1mYbhL8CU/QYqfVmFcaHDQ ($9.05 in chips)
Seat 4: 1b+2BbjMN8qhR1WPqdE9VQ ($54.15 in chips)
Seat 5: kxPhs4ePFqMy52CInAJ2aw ($93.85 in chips)
1mYbhL8CU/QYqfVmFcaHDQ: posts small blind $0.25
1b+2BbjMN8qhR1WPqdE9VQ: posts big blind $0.50
*** HOLE CARDS ***
kxPhs4ePFqMy52CInAJ2aw: folds
+Pf9jTVizYlIo+woPvptfA joins the table at seat #6
My8WkRtGx5FW6rJ1I4R3hg: calls $0.50
bfFjgAtIoAI+pUxUwFt3aQ: calls $0.50
1mYbhL8CU/QYqfVmFcaHDQ: calls $0.25
1b+2BbjMN8qhR1WPqdE9VQ: checks
*** FLOP *** [4d 7s 2c]
1mYbhL8CU/QYqfVmFcaHDQ: bets $0.50
1b+2BbjMN8qhR1WPqdE9VQ: raises $1.50 to $2
My8WkRtGx5FW6rJ1I4R3hg: folds
bfFjgAtIoAI+pUxUwFt3aQ: folds
1mYbhL8CU/QYqfVmFcaHDQ: calls $1.50
*** TURN *** [4d 7s 2c] [Jh]
1mYbhL8CU/QYqfVmFcaHDQ: checks
1b+2BbjMN8qhR1WPqdE9VQ: checks
*** RIVER *** [4d 7s 2c Jh] [5d]
1mYbhL8CU/QYqfVmFcaHDQ: checks
1b+2BbjMN8qhR1WPqdE9VQ: checks
*** SHOW DOWN ***
1mYbhL8CU/QYqfVmFcaHDQ: shows [5s 3c] (a pair of Fives)
1b+2BbjMN8qhR1WPqdE9VQ: shows [7h Ts] (a pair of Sevens)
1b+2BbjMN8qhR1WPqdE9VQ collected $5.75 from pot
*** SUMMARY ***
Total pot $6 | Rake $0.25
Board [4d 7s 2c Jh 5d]
Seat 1: My8WkRtGx5FW6rJ1I4R3hg folded on the Flop
Seat 2: bfFjgAtIoAI+pUxUwFt3aQ (button) folded on the Flop
Seat 3: 1mYbhL8CU/QYqfVmFcaHDQ (small blind) showed [5s 3c] and lost with a pair of Fives
Seat 4: 1b+2BbjMN8qhR1WPqdE9VQ (big blind) showed [7h Ts] and won ($5.75) with a pair of Sevens
Seat 5: kxPhs4ePFqMy52CInAJ2aw folded before Flop (didn't bet)



PokerStars Game #59940667578:  Hold'em No Limit ($0.25/$0.50) - 2009/07/01 1:13:08 ET
Table 'MJxeZCzYELxiIsyUZyT0jw' 6-max Seat #3 is the button
Seat 1: +Pf9jTVizYlIo+woPvptfA ($50 in chips)
Seat 2: t3GiVMzqA9Svgr5Uol32cQ ($27.10 in chips)
Seat 3: sIG4mp8tZEI+W4nKZNkkQA ($51.85 in chips)
Seat 4: alGiiQP/wwtYnfuXII+sgw ($61.85 in chips)
Seat 5: 3jvoOXNtXE90w2BdfNZwZQ ($53.05 in chips)
Seat 6: c0n4hrn20AML9qzyFC2E8Q ($60.10 in chips)
alGiiQP/wwtYnfuXII+sgw: posts small blind $0.25
3jvoOXNtXE90w2BdfNZwZQ: posts big blind $0.50
*** HOLE CARDS ***
c0n4hrn20AML9qzyFC2E8Q: folds
+Pf9jTVizYlIo+woPvptfA: folds
t3GiVMzqA9Svgr5Uol32cQ: folds
sIG4mp8tZEI+W4nKZNkkQA: folds
alGiiQP/wwtYnfuXII+sgw: folds
3jvoOXNtXE90w2BdfNZwZQ collected $0.50 from pot
3jvoOXNtXE90w2BdfNZwZQ: doesn't show hand
*** SUMMARY ***
Total pot $0.50 | Rake $0
Seat 1: +Pf9jTVizYlIo+woPvptfA folded before Flop (didn't bet)
Seat 2: t3GiVMzqA9Svgr5Uol32cQ folded before Flop (didn't bet)
Seat 3: sIG4mp8tZEI+W4nKZNkkQA (button) folded before Flop (didn't bet)
Seat 4: alGiiQP/wwtYnfuXII+sgw (small blind) folded before Flop
Seat 5: 3jvoOXNtXE90w2BdfNZwZQ (big blind) collected ($0.50)
Seat 6: c0n4hrn20AML9qzyFC2E8Q folded before Flop (didn't bet)



PokerStars Game #59940667448:  Hold'em No Limit ($0.25/$0.50) - 2009/07/01 1:13:08 ET
Table 'lpxYasB1ClBSgTpCCITwhQ' 9-max Seat #6 is the button
Seat 1: mj7PS7wCH4PAl7+eYTFs7A ($49.25 in chips)
Seat 2: OWP/DOu+PlPK6ZZ3zYa0HA ($25.85 in chips)
Seat 3: sakr/FIfFtIZwDPmAj5Pzg ($49.20 in chips)
Seat 4: NnQCepdIR/AOUQn1yhYx6Q ($9.25 in chips)
Seat 6: SegjDnMxWMujiD57ESNL+g ($13.60 in chips)
Seat 7: bmRtaIYKthN1F+B3JLZ3Jw ($74.35 in chips)
Seat 8: /mfensKw8/iZ1Vrx33S4xg ($17.75 in chips)
Seat 9: sUIUZ+begh92dzkUmvbMrw ($12.80 in chips)
bmRtaIYKthN1F+B3JLZ3Jw: posts small blind $0.25
/mfensKw8/iZ1Vrx33S4xg: posts big blind $0.50
*** HOLE CARDS ***
sUIUZ+begh92dzkUmvbMrw: folds
mj7PS7wCH4PAl7+eYTFs7A: folds
OWP/DOu+PlPK6ZZ3zYa0HA: folds
sakr/FIfFtIZwDPmAj5Pzg: folds
NnQCepdIR/AOUQn1yhYx6Q: folds
SegjDnMxWMujiD57ESNL+g: folds
bmRtaIYKthN1F+B3JLZ3Jw: folds
/mfensKw8/iZ1Vrx33S4xg collected $0.50 from pot
/mfensKw8/iZ1Vrx33S4xg: doesn't show hand
*** SUMMARY ***
Total pot $0.50 | Rake $0
Seat 1: mj7PS7wCH4PAl7+eYTFs7A folded before Flop (didn't bet)
Seat 2: OWP/DOu+PlPK6ZZ3zYa0HA folded before Flop (didn't bet)
Seat 3: sakr/FIfFtIZwDPmAj5Pzg folded before Flop (didn't bet)
Seat 4: NnQCepdIR/AOUQn1yhYx6Q folded before Flop (didn't bet)
Seat 6: SegjDnMxWMujiD57ESNL+g (button) folded before Flop (didn't bet)
Seat 7: bmRtaIYKthN1F+B3JLZ3Jw (small blind) folded before Flop
Seat 8: /mfensKw8/iZ1Vrx33S4xg (big blind) collected ($0.50)
Seat 9: sUIUZ+begh92dzkUmvbMrw folded before Flop (didn't bet)



PokerStars Game #59940668488:  Hold'em No Limit ($0.25/$0.50) - 2009/07/01 1:13:09 ET
Table 'Nz0Vr7WMHL2g5Uk7dDZjpw' 9-max Seat #7 is the button
Seat 2: gsyXT42WLEcOS4DdEk2wlw ($30.60 in chips)
Seat 3: hoglu9inkgs6zN573/bJag ($7.60 in chips)
Seat 4: E2518gp4aFz1+kAgmGqeEg ($12.55 in chips)
Seat 5: WGW0DgjBUXs1ylURHG8vnQ ($19.15 in chips)
Seat 6: 997ViqAtWn1FPjJqcffwcA ($59.05 in chips)
Seat 7: KPLH0gELgFe2OuAnhJFI5w ($22.30 in chips)
Seat 8: aoL+R/61Kxmw69ypuPrWAQ ($28.90 in chips)
Seat 9: mSD1pginDsyHG5PDfqzphw ($10.75 in chips)
aoL+R/61Kxmw69ypuPrWAQ: posts small blind $0.25
mSD1pginDsyHG5PDfqzphw: posts big blind $0.50
*** HOLE CARDS ***
gsyXT42WLEcOS4DdEk2wlw: folds
hoglu9inkgs6zN573/bJag: folds
E2518gp4aFz1+kAgmGqeEg: folds
WGW0DgjBUXs1ylURHG8vnQ: folds
997ViqAtWn1FPjJqcffwcA: folds
KPLH0gELgFe2OuAnhJFI5w: calls $0.50
aoL+R/61Kxmw69ypuPrWAQ: calls $0.25
mSD1pginDsyHG5PDfqzphw: checks
*** FLOP *** [Jc 4d Jh]
aoL+R/61Kxmw69ypuPrWAQ: checks
mSD1pginDsyHG5PDfqzphw: checks
KPLH0gELgFe2OuAnhJFI5w: checks
*** TURN *** [Jc 4d Jh] [2c]
aoL+R/61Kxmw69ypuPrWAQ: checks
mSD1pginDsyHG5PDfqzphw: bets $1
KPLH0gELgFe2OuAnhJFI5w: calls $1
aoL+R/61Kxmw69ypuPrWAQ: folds
*** RIVER *** [Jc 4d Jh 2c] [7h]
mSD1pginDsyHG5PDfqzphw: bets $1
KPLH0gELgFe2OuAnhJFI5w: raises $1 to $2
mSD1pginDsyHG5PDfqzphw: calls $1
*** SHOW DOWN ***
KPLH0gELgFe2OuAnhJFI5w: shows [Js 9c] (three of a kind, Jacks)
mSD1pginDsyHG5PDfqzphw: mucks hand
KPLH0gELgFe2OuAnhJFI5w collected $7.15 from pot
*** SUMMARY ***
Total pot $7.50 | Rake $0.35
Board [Jc 4d Jh 2c 7h]
Seat 2: gsyXT42WLEcOS4DdEk2wlw folded before Flop (didn't bet)
Seat 3: hoglu9inkgs6zN573/bJag folded before Flop (didn't bet)
Seat 4: E2518gp4aFz1+kAgmGqeEg folded before Flop (didn't bet)
Seat 5: WGW0DgjBUXs1ylURHG8vnQ folded before Flop (didn't bet)
Seat 6: 997ViqAtWn1FPjJqcffwcA folded before Flop (didn't bet)
Seat 7: KPLH0gELgFe2OuAnhJFI5w (button) showed [Js 9c] and won ($7.15) with three of a kind, Jacks
Seat 8: aoL+R/61Kxmw69ypuPrWAQ (small blind) folded on the Turn
Seat 9: mSD1pginDsyHG5PDfqzphw (big blind) mucked



PokerStars Game #59940668470:  Hold'em No Limit ($0.25/$0.50) - 2009/07/01 1:13:09 ET
Table 'PALRfuH85dr5IkDfdv6new' 9-max Seat #8 is the button
Seat 1: v/4aX0ejnaIFK4ftDk2Lyg ($49.50 in chips)
Seat 2: 1aXjSbrubyQKHeauooF5Wg ($44 in chips)
Seat 3: 50QWoELmpmHFrFIlWMJo9g ($90 in chips)
Seat 4: mZNMJI1mY40XTC0U7GZakA ($57.55 in chips)
Seat 6: ottZQkg1UDWk85BtBzGJzg ($50.10 in chips)
Seat 7: 3NcyXvr39gnK+KbTq7ezyA ($60.80 in chips)
Seat 8: NkS+CseUKx4XHszWq0PXEQ ($76.25 in chips)
Seat 9: viwBDtJsY6JfsFOdBAyJIQ ($9 in chips)
viwBDtJsY6JfsFOdBAyJIQ: posts small blind $0.25
v/4aX0ejnaIFK4ftDk2Lyg: posts big blind $0.50
qEn9ijNGtuyTxamBf07hYg: sits out
*** HOLE CARDS ***
1aXjSbrubyQKHeauooF5Wg: folds
50QWoELmpmHFrFIlWMJo9g: folds
mZNMJI1mY40XTC0U7GZakA: folds
ottZQkg1UDWk85BtBzGJzg: folds
3NcyXvr39gnK+KbTq7ezyA: calls $0.50
NkS+CseUKx4XHszWq0PXEQ: folds
viwBDtJsY6JfsFOdBAyJIQ: calls $0.25
v/4aX0ejnaIFK4ftDk2Lyg: checks
*** FLOP *** [9s 6c 9d]
viwBDtJsY6JfsFOdBAyJIQ: checks
v/4aX0ejnaIFK4ftDk2Lyg: checks
3NcyXvr39gnK+KbTq7ezyA: checks
*** TURN *** [9s 6c 9d] [2c]
viwBDtJsY6JfsFOdBAyJIQ: checks
v/4aX0ejnaIFK4ftDk2Lyg: checks
3NcyXvr39gnK+KbTq7ezyA: checks
*** RIVER *** [9s 6c 9d 2c] [Ts]
viwBDtJsY6JfsFOdBAyJIQ: checks
v/4aX0ejnaIFK4ftDk2Lyg: checks
3NcyXvr39gnK+KbTq7ezyA: checks
*** SHOW DOWN ***
viwBDtJsY6JfsFOdBAyJIQ: shows [4s 7s] (a pair of Nines)
v/4aX0ejnaIFK4ftDk2Lyg: shows [Kh 3s] (a pair of Nines - King kicker)
3NcyXvr39gnK+KbTq7ezyA: shows [Kd Qh] (a pair of Nines - King+Queen kicker)
3NcyXvr39gnK+KbTq7ezyA collected $1.45 from pot
*** SUMMARY ***
Total pot $1.50 | Rake $0.05
Board [9s 6c 9d 2c Ts]
Seat 1: v/4aX0ejnaIFK4ftDk2Lyg (big blind) showed [Kh 3s] and lost with a pair of Nines
Seat 2: 1aXjSbrubyQKHeauooF5Wg folded before Flop (didn't bet)
Seat 3: 50QWoELmpmHFrFIlWMJo9g folded before Flop (didn't bet)
Seat 4: mZNMJI1mY40XTC0U7GZakA folded before Flop (didn't bet)
Seat 6: ottZQkg1UDWk85BtBzGJzg folded before Flop (didn't bet)
Seat 7: 3NcyXvr39gnK+KbTq7ezyA showed [Kd Qh] and won ($1.45) with a pair of Nines
Seat 8: NkS+CseUKx4XHszWq0PXEQ (button) folded before Flop (didn't bet)
Seat 9: viwBDtJsY6JfsFOdBAyJIQ (small blind) showed [4s 7s] and lost with a pair of Nines



PokerStars Game #59940668622:  Hold'em No Limit ($0.25/$0.50) - 2009/07/01 1:13:10 ET
Table 'c/CRn+68J3Y8KxD5g1ek2Q' 2-max Seat #1 is the button
Seat 1: 46qCyJ6evTkHo9al5sBMNA ($114 in chips)
Seat 2: BypVLsYQt3ePFm2xQL/dOA ($250.30 in chips)
46qCyJ6evTkHo9al5sBMNA: posts small blind $0.25
BypVLsYQt3ePFm2xQL/dOA: posts big blind $0.50
*** HOLE CARDS ***
46qCyJ6evTkHo9al5sBMNA: raises $1 to $1.50
BypVLsYQt3ePFm2xQL/dOA: calls $1
*** FLOP *** [Qd 8h As]
BypVLsYQt3ePFm2xQL/dOA: checks
46qCyJ6evTkHo9al5sBMNA: checks
*** TURN *** [Qd 8h As] [5c]
BypVLsYQt3ePFm2xQL/dOA: checks
46qCyJ6evTkHo9al5sBMNA: checks
*** RIVER *** [Qd 8h As 5c] [Ts]
BypVLsYQt3ePFm2xQL/dOA: bets $2
46qCyJ6evTkHo9al5sBMNA: calls $2
*** SHOW DOWN ***
BypVLsYQt3ePFm2xQL/dOA: shows [4s 6s] (high card Ace)
46qCyJ6evTkHo9al5sBMNA: shows [Jd Qs] (a pair of Queens)
46qCyJ6evTkHo9al5sBMNA collected $6.70 from pot
*** SUMMARY ***
Total pot $7 | Rake $0.30
Board [Qd 8h As 5c Ts]
Seat 1: 46qCyJ6evTkHo9al5sBMNA (button) (small blind) showed [Jd Qs] and won ($6.70) with a pair of Queens
Seat 2: BypVLsYQt3ePFm2xQL/dOA (big blind) showed [4s 6s] and lost with high card Ace



PokerStars Game #59940669866:  Hold'em No Limit ($0.25/$0.50) - 2009/07/01 1:13:12 ET
Table '+dXkOAQyS8j9PQZusUTMpg' 2-max Seat #1 is the button
Seat 1: XFa6sBGjP2gxoIvxR3fZIg ($125.50 in chips)
Seat 2: 5IBeOgaApY1Bvzv2P8X4EA ($68.30 in chips)
XFa6sBGjP2gxoIvxR3fZIg: posts small blind $0.25
5IBeOgaApY1Bvzv2P8X4EA: posts big blind $0.50
*** HOLE CARDS ***
XFa6sBGjP2gxoIvxR3fZIg: raises $1 to $1.50
5IBeOgaApY1Bvzv2P8X4EA: folds
XFa6sBGjP2gxoIvxR3fZIg collected $1 from pot
*** SUMMARY ***
Total pot $1 | Rake $0
Seat 1: XFa6sBGjP2gxoIvxR3fZIg (button) (small blind) collected ($1)
Seat 2: 5IBeOgaApY1Bvzv2P8X4EA (big blind) folded before Flop



PokerStars Game #59940669846:  Hold'em No Limit ($0.25/$0.50) - 2009/07/01 1:13:12 ET
Table '37qXEp3oe+er5q4CZip9eQ' 6-max Seat #5 is the button
Seat 1: lxIzoHy0RnkfFSODHC2liw ($50.75 in chips)
Seat 2: LvH4G7n+QSjT6NDaD3cREA ($59.85 in chips)
Seat 3: Rt6KgtZ8YaJoTc3FPim00w ($109.45 in chips)
Seat 4: XsmE8nXMAAMFJbWaJTmHFw ($48.20 in chips)
Seat 5: VOmI0x4dDPnTESZd5B4d1Q ($37.75 in chips)
Seat 6: N50kln4negd8q7Mmoz1j4g ($9.05 in chips)
N50kln4negd8q7Mmoz1j4g: posts small blind $0.25
lxIzoHy0RnkfFSODHC2liw: posts big blind $0.50
*** HOLE CARDS ***
LvH4G7n+QSjT6NDaD3cREA: folds
Rt6KgtZ8YaJoTc3FPim00w: folds
XsmE8nXMAAMFJbWaJTmHFw: folds
VOmI0x4dDPnTESZd5B4d1Q: raises $1.50 to $2
N50kln4negd8q7Mmoz1j4g: raises $7.05 to $9.05 and is all-in
VOmI0x4dDPnTESZd5B4d1Q said, "ffs"
lxIzoHy0RnkfFSODHC2liw: folds
VOmI0x4dDPnTESZd5B4d1Q: folds
N50kln4negd8q7Mmoz1j4g collected $4.50 from pot
*** SUMMARY ***
Total pot $4.50 | Rake $0
Seat 1: lxIzoHy0RnkfFSODHC2liw (big blind) folded before Flop
Seat 2: LvH4G7n+QSjT6NDaD3cREA folded before Flop (didn't bet)
Seat 3: Rt6KgtZ8YaJoTc3FPim00w folded before Flop (didn't bet)
Seat 4: XsmE8nXMAAMFJbWaJTmHFw folded before Flop (didn't bet)
Seat 5: VOmI0x4dDPnTESZd5B4d1Q (button) folded before Flop
Seat 6: N50kln4negd8q7Mmoz1j4g (small blind) collected ($4.50)



PokerStars Game #59940671254:  Hold'em No Limit ($0.25/$0.50) - 2009/07/01 1:13:15 ET
Table 'QOgaEqMcJ73pcUMMxoisUg' 6-max Seat #6 is the button
Seat 1: lxIzoHy0RnkfFSODHC2liw ($50 in chips)
Seat 2: oqOqoO2AyCZenUghCxMDxw ($65 in chips)
Seat 3: Rt6KgtZ8YaJoTc3FPim00w ($53.75 in chips)
Seat 4: zAcsDhG/T128Vn7XGVSgKg ($59.90 in chips)
Seat 5: 6vNxrjjCl6FwfaaymM9jjg ($17.20 in chips)
Seat 6: AdS8BJMOheS01zjCDfPMFg ($53.85 in chips)
lxIzoHy0RnkfFSODHC2liw: posts small blind $0.25
oqOqoO2AyCZenUghCxMDxw: posts big blind $0.50
*** HOLE CARDS ***
Rt6KgtZ8YaJoTc3FPim00w: folds
zAcsDhG/T128Vn7XGVSgKg: folds
6vNxrjjCl6FwfaaymM9jjg: folds
AdS8BJMOheS01zjCDfPMFg: raises $1 to $1.50
lxIzoHy0RnkfFSODHC2liw: folds
oqOqoO2AyCZenUghCxMDxw: calls $1
*** FLOP *** [Kd Ts Ad]
oqOqoO2AyCZenUghCxMDxw: checks
AdS8BJMOheS01zjCDfPMFg: bets $2.50
oqOqoO2AyCZenUghCxMDxw: calls $2.50
*** TURN *** [Kd Ts Ad] [7s]
oqOqoO2AyCZenUghCxMDxw: checks
AdS8BJMOheS01zjCDfPMFg: bets $5
oqOqoO2AyCZenUghCxMDxw: folds
AdS8BJMOheS01zjCDfPMFg collected $7.85 from pot
*** SUMMARY ***
Total pot $8.25 | Rake $0.40
Board [Kd Ts Ad 7s]
Seat 1: lxIzoHy0RnkfFSODHC2liw (small blind) folded before Flop
Seat 2: oqOqoO2AyCZenUghCxMDxw (big blind) folded on the Turn
Seat 3: Rt6KgtZ8YaJoTc3FPim00w folded before Flop (didn't bet)
Seat 4: zAcsDhG/T128Vn7XGVSgKg folded before Flop (didn't bet)
Seat 5: 6vNxrjjCl6FwfaaymM9jjg folded before Flop (didn't bet)
Seat 6: AdS8BJMOheS01zjCDfPMFg (button) collected ($7.85)



PokerStars Game #59940673738:  Hold'em No Limit ($0.25/$0.50) - 2009/07/01 1:13:19 ET
Table 'GfL/No5u5PoEnU39lP5pQg' 6-max Seat #3 is the button
Seat 1: 1WUCqNG+p+vfWRTXNu4ljw ($64.50 in chips)
Seat 2: uVwggSetzp7d+eVgowO3vg ($53.45 in chips)
Seat 3: 4pp9WxhGdbVbxCc9tlu0lw ($31.75 in chips)
Seat 4: r6u7MWSXF30/khcTYkrG9Q ($19.10 in chips)
Seat 5: M1KyQQvVPVuxqTAB8sR/zQ ($53.40 in chips)
Seat 6: kxPhs4ePFqMy52CInAJ2aw ($63.45 in chips)
r6u7MWSXF30/khcTYkrG9Q: posts small blind $0.25
M1KyQQvVPVuxqTAB8sR/zQ: posts big blind $0.50
*** HOLE CARDS ***
kxPhs4ePFqMy52CInAJ2aw: folds
1WUCqNG+p+vfWRTXNu4ljw: folds
uVwggSetzp7d+eVgowO3vg: folds
4pp9WxhGdbVbxCc9tlu0lw: calls $0.50
r6u7MWSXF30/khcTYkrG9Q: folds
M1KyQQvVPVuxqTAB8sR/zQ: checks
*** FLOP *** [4s 3h Kd]
M1KyQQvVPVuxqTAB8sR/zQ: checks
4pp9WxhGdbVbxCc9tlu0lw: bets $0.50
M1KyQQvVPVuxqTAB8sR/zQ: folds
4pp9WxhGdbVbxCc9tlu0lw collected $1.20 from pot
*** SUMMARY ***
Total pot $1.25 | Rake $0.05
Board [4s 3h Kd]
Seat 1: 1WUCqNG+p+vfWRTXNu4ljw folded before Flop (didn't bet)
Seat 2: uVwggSetzp7d+eVgowO3vg folded before Flop (didn't bet)
Seat 3: 4pp9WxhGdbVbxCc9tlu0lw (button) collected ($1.20)
Seat 4: r6u7MWSXF30/khcTYkrG9Q (small blind) folded before Flop
Seat 5: M1KyQQvVPVuxqTAB8sR/zQ (big blind) folded on the Flop
Seat 6: kxPhs4ePFqMy52CInAJ2aw folded before Flop (didn't bet)



PokerStars Game #59940674002:  Hold'em No Limit ($0.25/$0.50) - 2009/07/01 1:13:19 ET
Table 'MJxeZCzYELxiIsyUZyT0jw' 6-max Seat #4 is the button
Seat 1: +Pf9jTVizYlIo+woPvptfA ($50 in chips)
Seat 2: t3GiVMzqA9Svgr5Uol32cQ ($27.10 in chips)
Seat 3: sIG4mp8tZEI+W4nKZNkkQA ($51.85 in chips)
Seat 4: alGiiQP/wwtYnfuXII+sgw ($61.60 in chips)
Seat 5: 3jvoOXNtXE90w2BdfNZwZQ ($53.30 in chips)
Seat 6: c0n4hrn20AML9qzyFC2E8Q ($60.10 in chips)
3jvoOXNtXE90w2BdfNZwZQ: posts small blind $0.25
c0n4hrn20AML9qzyFC2E8Q: posts big blind $0.50
*** HOLE CARDS ***
+Pf9jTVizYlIo+woPvptfA: folds
t3GiVMzqA9Svgr5Uol32cQ: folds
sIG4mp8tZEI+W4nKZNkkQA: folds
alGiiQP/wwtYnfuXII+sgw: folds
3jvoOXNtXE90w2BdfNZwZQ: raises $1.50 to $2
c0n4hrn20AML9qzyFC2E8Q: folds
3jvoOXNtXE90w2BdfNZwZQ collected $1 from pot
3jvoOXNtXE90w2BdfNZwZQ: doesn't show hand
*** SUMMARY ***
Total pot $1 | Rake $0
Seat 1: +Pf9jTVizYlIo+woPvptfA folded before Flop (didn't bet)
Seat 2: t3GiVMzqA9Svgr5Uol32cQ folded before Flop (didn't bet)
Seat 3: sIG4mp8tZEI+W4nKZNkkQA folded before Flop (didn't bet)
Seat 4: alGiiQP/wwtYnfuXII+sgw (button) folded before Flop (didn't bet)
Seat 5: 3jvoOXNtXE90w2BdfNZwZQ (small blind) collected ($1)
Seat 6: c0n4hrn20AML9qzyFC2E8Q (big blind) folded before Flop



PokerStars Game #59940673808:  Hold'em No Limit ($0.25/$0.50) - 2009/07/01 1:13:19 ET
Table '+dXkOAQyS8j9PQZusUTMpg' 2-max Seat #2 is the button
Seat 1: XFa6sBGjP2gxoIvxR3fZIg ($126 in chips)
Seat 2: 5IBeOgaApY1Bvzv2P8X4EA ($67.80 in chips)
5IBeOgaApY1Bvzv2P8X4EA: posts small blind $0.25
XFa6sBGjP2gxoIvxR3fZIg: posts big blind $0.50
*** HOLE CARDS ***
5IBeOgaApY1Bvzv2P8X4EA: folds
XFa6sBGjP2gxoIvxR3fZIg collected $0.50 from pot
*** SUMMARY ***
Total pot $0.50 | Rake $0
Seat 1: XFa6sBGjP2gxoIvxR3fZIg (big blind) collected ($0.50)
Seat 2: 5IBeOgaApY1Bvzv2P8X4EA (button) (small blind) folded before Flop



PokerStars Game #59940673910:  Hold'em No Limit ($0.25/$0.50) - 2009/07/01 1:13:19 ET
Table '8BQGgNetI1NOvWeu3gtMNw' 2-max Seat #2 is the button
Seat 1: bypIyrYcAAifLfhZpGlKLA ($109.65 in chips)
Seat 2: Z4HwehErEwzsv/noQlfUlg ($85.90 in chips)
Z4HwehErEwzsv/noQlfUlg: posts small blind $0.25
bypIyrYcAAifLfhZpGlKLA: posts big blind $0.50
*** HOLE CARDS ***
Z4HwehErEwzsv/noQlfUlg: raises $2.50 to $3
bypIyrYcAAifLfhZpGlKLA: calls $2.50
*** FLOP *** [Ts 2h 9d]
bypIyrYcAAifLfhZpGlKLA: checks
Z4HwehErEwzsv/noQlfUlg: bets $5
bypIyrYcAAifLfhZpGlKLA: calls $5
*** TURN *** [Ts 2h 9d] [Jc]
bypIyrYcAAifLfhZpGlKLA: checks
Z4HwehErEwzsv/noQlfUlg: bets $0.50
bypIyrYcAAifLfhZpGlKLA: calls $0.50
*** RIVER *** [Ts 2h 9d Jc] [7h]
bypIyrYcAAifLfhZpGlKLA: bets $12
Z4HwehErEwzsv/noQlfUlg: raises $65.40 to $77.40 and is all-in
bypIyrYcAAifLfhZpGlKLA: folds
Z4HwehErEwzsv/noQlfUlg collected $40.50 from pot
Z4HwehErEwzsv/noQlfUlg: doesn't show hand
*** SUMMARY ***
Total pot $41 | Rake $0.50
Board [Ts 2h 9d Jc 7h]
Seat 1: bypIyrYcAAifLfhZpGlKLA (big blind) folded on the River
Seat 2: Z4HwehErEwzsv/noQlfUlg (button) (small blind) collected ($40.50)



PokerStars Game #59940677018:  Hold'em No Limit ($0.25/$0.50) - 2009/07/01 1:13:24 ET
Table 'tyR5AZNKV8Aadbrnrnlg7g' 6-max Seat #6 is the button
Seat 1: BgOXYI0yYSN1ULC4FqsNkg ($98.05 in chips)
Seat 2: BAjwVL+zKKd0s0fAWstzQQ ($71.55 in chips)
Seat 3: JFLrYNyQmwPhRQAtoSAuyA ($50.35 in chips)
Seat 4: 4QfsCWthT/vSLirorNXqtg ($76.15 in chips)
Seat 6: 498aWaGsW4uGfuWl+2FCGw ($37.35 in chips)
BgOXYI0yYSN1ULC4FqsNkg: posts small blind $0.25
BAjwVL+zKKd0s0fAWstzQQ: posts big blind $0.50
*** HOLE CARDS ***
ihatemullets leaves the table
JFLrYNyQmwPhRQAtoSAuyA: raises $1 to $1.50
4QfsCWthT/vSLirorNXqtg: folds
498aWaGsW4uGfuWl+2FCGw: folds
GUnvMULl2qFOO1yenu1UBw joins the table at seat #5
BgOXYI0yYSN1ULC4FqsNkg: folds
BAjwVL+zKKd0s0fAWstzQQ: calls $1
*** FLOP *** [9c Th 8h]
BAjwVL+zKKd0s0fAWstzQQ: checks
JFLrYNyQmwPhRQAtoSAuyA: checks
*** TURN *** [9c Th 8h] [Kc]
BAjwVL+zKKd0s0fAWstzQQ: checks
JFLrYNyQmwPhRQAtoSAuyA: bets $2.25
BAjwVL+zKKd0s0fAWstzQQ: folds
JFLrYNyQmwPhRQAtoSAuyA collected $3.10 from pot
JFLrYNyQmwPhRQAtoSAuyA: doesn't show hand
*** SUMMARY ***
Total pot $3.25 | Rake $0.15
Board [9c Th 8h Kc]
Seat 1: BgOXYI0yYSN1ULC4FqsNkg (small blind) folded before Flop
Seat 2: BAjwVL+zKKd0s0fAWstzQQ (big blind) folded on the Turn
Seat 3: JFLrYNyQmwPhRQAtoSAuyA collected ($3.10)
Seat 4: 4QfsCWthT/vSLirorNXqtg folded before Flop (didn't bet)
Seat 6: 498aWaGsW4uGfuWl+2FCGw (button) folded before Flop (didn't bet)



PokerStars Game #59940678026:  Hold'em No Limit ($0.25/$0.50) - 2009/07/01 1:13:26 ET
Table 'kgbJRsxfv64KrErDRBAkcw' 6-max Seat #5 is the button
Seat 1: VamsyhlFzXGF6/ydo0BHeA ($52.55 in chips)
Seat 2: AdS8BJMOheS01zjCDfPMFg ($58.55 in chips)
Seat 3: c4MNIaIyPMOMxrgT8FT5nA ($123 in chips)
Seat 5: eUBBn2R56C1IQ6Cs/vitwg ($59.70 in chips)
Seat 6: 1b+2BbjMN8qhR1WPqdE9VQ ($50.35 in chips)
1b+2BbjMN8qhR1WPqdE9VQ: posts small blind $0.25
VamsyhlFzXGF6/ydo0BHeA: posts big blind $0.50
*** HOLE CARDS ***
AdS8BJMOheS01zjCDfPMFg: raises $1 to $1.50
c4MNIaIyPMOMxrgT8FT5nA: calls $1.50
eUBBn2R56C1IQ6Cs/vitwg: raises $5.50 to $7
1b+2BbjMN8qhR1WPqdE9VQ: folds
VamsyhlFzXGF6/ydo0BHeA: folds
AdS8BJMOheS01zjCDfPMFg: calls $5.50
c4MNIaIyPMOMxrgT8FT5nA: raises $12 to $19
eUBBn2R56C1IQ6Cs/vitwg: raises $40.70 to $59.70 and is all-in
AdS8BJMOheS01zjCDfPMFg: folds
c4MNIaIyPMOMxrgT8FT5nA: calls $40.70
*** FLOP *** [8c 6c Kc]
*** TURN *** [8c 6c Kc] [2h]
*** RIVER *** [8c 6c Kc 2h] [4d]
*** SHOW DOWN ***
c4MNIaIyPMOMxrgT8FT5nA: shows [Ah Ac] (a pair of Aces)
eUBBn2R56C1IQ6Cs/vitwg: mucks hand
c4MNIaIyPMOMxrgT8FT5nA collected $125.15 from pot
*** SUMMARY ***
Total pot $127.15 | Rake $2
Board [8c 6c Kc 2h 4d]
Seat 1: VamsyhlFzXGF6/ydo0BHeA (big blind) folded before Flop
Seat 2: AdS8BJMOheS01zjCDfPMFg folded before Flop
Seat 3: c4MNIaIyPMOMxrgT8FT5nA showed [Ah Ac] and won ($125.15) with a pair of Aces
Seat 5: eUBBn2R56C1IQ6Cs/vitwg (button) mucked
Seat 6: 1b+2BbjMN8qhR1WPqdE9VQ (small blind) folded before Flop



PokerStars Game #59940677832:  Hold'em No Limit ($0.25/$0.50) - 2009/07/01 1:13:26 ET
Table '+dXkOAQyS8j9PQZusUTMpg' 2-max Seat #1 is the button
Seat 1: XFa6sBGjP2gxoIvxR3fZIg ($126.25 in chips)
Seat 2: 5IBeOgaApY1Bvzv2P8X4EA ($67.55 in chips)
XFa6sBGjP2gxoIvxR3fZIg: posts small blind $0.25
5IBeOgaApY1Bvzv2P8X4EA: posts big blind $0.50
*** HOLE CARDS ***
XFa6sBGjP2gxoIvxR3fZIg: raises $1 to $1.50
5IBeOgaApY1Bvzv2P8X4EA: calls $1
*** FLOP *** [8d Jc 7s]
5IBeOgaApY1Bvzv2P8X4EA: checks
XFa6sBGjP2gxoIvxR3fZIg: bets $2
5IBeOgaApY1Bvzv2P8X4EA: folds
XFa6sBGjP2gxoIvxR3fZIg collected $2.85 from pot
XFa6sBGjP2gxoIvxR3fZIg: doesn't show hand
*** SUMMARY ***
Total pot $3 | Rake $0.15
Board [8d Jc 7s]
Seat 1: XFa6sBGjP2gxoIvxR3fZIg (button) (small blind) collected ($2.85)
Seat 2: 5IBeOgaApY1Bvzv2P8X4EA (big blind) folded on the Flop



PokerStars Game #59940678172:  Hold'em No Limit ($0.25/$0.50) - 2009/07/01 1:13:26 ET
Table 'X6IRCRTh+20gjz8aubWnwA' 9-max Seat #9 is the button
Seat 2: HZkVla4kK2SI42CVrPZ/ig ($6.30 in chips)
Seat 3: SWv01peOe69QQRvhQTqjQw ($5.50 in chips)
Seat 4: M3JFBNQ8Bbw3FBZ/18MuXw ($25.70 in chips)
Seat 5: NnQCepdIR/AOUQn1yhYx6Q ($9.25 in chips)
Seat 6: 75K2MXwN65Sjfp1yHd50Hg ($11.70 in chips)
Seat 7: cFHQjKQOOKTUzoilhrXHLg ($15.25 in chips)
Seat 8: HxeBVq06/3Bh/H986sgdbw ($49.25 in chips)
Seat 9: M+7+BTmX5vZatHVuoRB1nA ($43 in chips)
E2518gp4aFz1+kAgmGqeEg will be allowed to play after the button
HZkVla4kK2SI42CVrPZ/ig: posts small blind $0.25
SWv01peOe69QQRvhQTqjQw: posts big blind $0.50
*** HOLE CARDS ***
M3JFBNQ8Bbw3FBZ/18MuXw: folds
NnQCepdIR/AOUQn1yhYx6Q: folds
75K2MXwN65Sjfp1yHd50Hg: folds
cFHQjKQOOKTUzoilhrXHLg: folds
HxeBVq06/3Bh/H986sgdbw: calls $0.50
M+7+BTmX5vZatHVuoRB1nA: folds
HZkVla4kK2SI42CVrPZ/ig: calls $0.25
SWv01peOe69QQRvhQTqjQw: checks
*** FLOP *** [2c 8d As]
HZkVla4kK2SI42CVrPZ/ig: checks
SWv01peOe69QQRvhQTqjQw: bets $1
HxeBVq06/3Bh/H986sgdbw: calls $1
HZkVla4kK2SI42CVrPZ/ig: folds
*** TURN *** [2c 8d As] [Ks]
SWv01peOe69QQRvhQTqjQw: bets $1.50
HxeBVq06/3Bh/H986sgdbw: calls $1.50
*** RIVER *** [2c 8d As Ks] [Kh]
SWv01peOe69QQRvhQTqjQw: bets $1.50
HxeBVq06/3Bh/H986sgdbw: calls $1.50
*** SHOW DOWN ***
SWv01peOe69QQRvhQTqjQw: shows [3h Ac] (two pair, Aces and Kings)
HxeBVq06/3Bh/H986sgdbw: shows [Ad 3d] (two pair, Aces and Kings)
SWv01peOe69QQRvhQTqjQw collected $4.55 from pot
HxeBVq06/3Bh/H986sgdbw collected $4.50 from pot
*** SUMMARY ***
Total pot $9.50 | Rake $0.45
Board [2c 8d As Ks Kh]
Seat 2: HZkVla4kK2SI42CVrPZ/ig (small blind) folded on the Flop
Seat 3: SWv01peOe69QQRvhQTqjQw (big blind) showed [3h Ac] and won ($4.55) with two pair, Aces and Kings
Seat 4: M3JFBNQ8Bbw3FBZ/18MuXw folded before Flop (didn't bet)
Seat 5: NnQCepdIR/AOUQn1yhYx6Q folded before Flop (didn't bet)
Seat 6: 75K2MXwN65Sjfp1yHd50Hg folded before Flop (didn't bet)
Seat 7: cFHQjKQOOKTUzoilhrXHLg folded before Flop (didn't bet)
Seat 8: HxeBVq06/3Bh/H986sgdbw showed [Ad 3d] and won ($4.50) with two pair, Aces and Kings
Seat 9: M+7+BTmX5vZatHVuoRB1nA (button) folded before Flop (didn't bet)



PokerStars Game #59940679120:  Hold'em No Limit ($0.25/$0.50) - 2009/07/01 1:13:28 ET
Table 'NCiXr0d5CEKBQr/cZgLhbA' 9-max Seat #5 is the button
Seat 1: pFtzb1sR4b0d1aw6aIRgDg ($50.20 in chips)
Seat 3: xZCXQSXlrZkp3pZizzVXCw ($51.95 in chips)
Seat 4: 5k9fvXD9suIgCxU4HLQjTw ($54.70 in chips)
Seat 5: zE9cVigS2nW/Ljy4K4bUQA ($63.35 in chips)
Seat 7: M+7+BTmX5vZatHVuoRB1nA ($51.50 in chips)
Seat 8: 1MJUKc3cc0QmUoz1JZLR2w ($49.30 in chips)
Seat 9: 4WLZvqBn5qv5tds5kt5A1Q ($56.25 in chips)
M+7+BTmX5vZatHVuoRB1nA: posts small blind $0.25
1MJUKc3cc0QmUoz1JZLR2w: posts big blind $0.50
AjV5McH1KMMclY26QdLM5w: sits out
*** HOLE CARDS ***
4WLZvqBn5qv5tds5kt5A1Q: calls $0.50
pFtzb1sR4b0d1aw6aIRgDg: folds
xZCXQSXlrZkp3pZizzVXCw: folds
5k9fvXD9suIgCxU4HLQjTw: folds
zE9cVigS2nW/Ljy4K4bUQA: folds
M+7+BTmX5vZatHVuoRB1nA: calls $0.25
1MJUKc3cc0QmUoz1JZLR2w: checks
*** FLOP *** [As 2s 5c]
M+7+BTmX5vZatHVuoRB1nA: checks
1MJUKc3cc0QmUoz1JZLR2w: checks
4WLZvqBn5qv5tds5kt5A1Q: bets $0.50
M+7+BTmX5vZatHVuoRB1nA: calls $0.50
1MJUKc3cc0QmUoz1JZLR2w: calls $0.50
*** TURN *** [As 2s 5c] [2d]
M+7+BTmX5vZatHVuoRB1nA: checks
1MJUKc3cc0QmUoz1JZLR2w: checks
4WLZvqBn5qv5tds5kt5A1Q: checks
*** RIVER *** [As 2s 5c 2d] [Kd]
M+7+BTmX5vZatHVuoRB1nA: checks
1MJUKc3cc0QmUoz1JZLR2w: checks
4WLZvqBn5qv5tds5kt5A1Q: checks
*** SHOW DOWN ***
M+7+BTmX5vZatHVuoRB1nA: shows [9c 9h] (two pair, Nines and Deuces)
1MJUKc3cc0QmUoz1JZLR2w: mucks hand
4WLZvqBn5qv5tds5kt5A1Q: mucks hand
M+7+BTmX5vZatHVuoRB1nA collected $2.90 from pot
*** SUMMARY ***
Total pot $3 | Rake $0.10
Board [As 2s 5c 2d Kd]
Seat 1: pFtzb1sR4b0d1aw6aIRgDg folded before Flop (didn't bet)
Seat 3: xZCXQSXlrZkp3pZizzVXCw folded before Flop (didn't bet)
Seat 4: 5k9fvXD9suIgCxU4HLQjTw folded before Flop (didn't bet)
Seat 5: zE9cVigS2nW/Ljy4K4bUQA (button) folded before Flop (didn't bet)
Seat 7: M+7+BTmX5vZatHVuoRB1nA (small blind) showed [9c 9h] and won ($2.90) with two pair, Nines and Deuces
Seat 8: 1MJUKc3cc0QmUoz1JZLR2w (big blind) mucked
Seat 9: 4WLZvqBn5qv5tds5kt5A1Q mucked



PokerStars Game #59940679282:  Hold'em No Limit ($0.25/$0.50) - 2009/07/01 1:13:28 ET
Table '/cQuAT3ef4t+PGrXiNhGaQ' 9-max Seat #1 is the button
Seat 1: HZkVla4kK2SI42CVrPZ/ig ($14.25 in chips)
Seat 2: jXGruyaMqirTaTXNOvBdew ($67.20 in chips)
Seat 3: g4k0NXISyLCqaSWZDBjfEg ($55.35 in chips)
Seat 4: OWP/DOu+PlPK6ZZ3zYa0HA ($32.95 in chips)
Seat 5: 5SgaHdWixdClWvaEG+KUjQ ($37.10 in chips)
Seat 6: APYIOyK/4AGb+kIwlOUNBQ ($36.10 in chips)
Seat 7: J0W5D97jl5VLky+IoPvDeA ($168.50 in chips)
Seat 8: eBrej2jnlUCs/JgxFCRn2g ($42.25 in chips)
Seat 9: AjV5McH1KMMclY26QdLM5w ($25 in chips)
jXGruyaMqirTaTXNOvBdew: posts small blind $0.25
g4k0NXISyLCqaSWZDBjfEg: posts big blind $0.50
*** HOLE CARDS ***
OWP/DOu+PlPK6ZZ3zYa0HA: folds
5SgaHdWixdClWvaEG+KUjQ: folds
APYIOyK/4AGb+kIwlOUNBQ: folds
J0W5D97jl5VLky+IoPvDeA: folds
eBrej2jnlUCs/JgxFCRn2g has timed out
eBrej2jnlUCs/JgxFCRn2g: folds
eBrej2jnlUCs/JgxFCRn2g is sitting out
eBrej2jnlUCs/JgxFCRn2g has returned
AjV5McH1KMMclY26QdLM5w: raises $1 to $1.50
HZkVla4kK2SI42CVrPZ/ig: folds
jXGruyaMqirTaTXNOvBdew: calls $1.25
g4k0NXISyLCqaSWZDBjfEg: folds
*** FLOP *** [Qd 4h Ac]
jXGruyaMqirTaTXNOvBdew: bets $2
AjV5McH1KMMclY26QdLM5w: calls $2
*** TURN *** [Qd 4h Ac] [2d]
jXGruyaMqirTaTXNOvBdew: bets $2.50
AjV5McH1KMMclY26QdLM5w: folds
jXGruyaMqirTaTXNOvBdew collected $7.15 from pot
*** SUMMARY ***
Total pot $7.50 | Rake $0.35
Board [Qd 4h Ac 2d]
Seat 1: HZkVla4kK2SI42CVrPZ/ig (button) folded before Flop (didn't bet)
Seat 2: jXGruyaMqirTaTXNOvBdew (small blind) collected ($7.15)
Seat 3: g4k0NXISyLCqaSWZDBjfEg (big blind) folded before Flop
Seat 4: OWP/DOu+PlPK6ZZ3zYa0HA folded before Flop (didn't bet)
Seat 5: 5SgaHdWixdClWvaEG+KUjQ folded before Flop (didn't bet)
Seat 6: APYIOyK/4AGb+kIwlOUNBQ folded before Flop (didn't bet)
Seat 7: J0W5D97jl5VLky+IoPvDeA folded before Flop (didn't bet)
Seat 8: eBrej2jnlUCs/JgxFCRn2g folded before Flop (didn't bet)
Seat 9: AjV5McH1KMMclY26QdLM5w folded on the Turn



PokerStars Game #59940681138:  Hold'em No Limit ($0.25/$0.50) - 2009/07/01 1:13:31 ET
Table 'fx6MqwfYAj/Rt86hBz2L3Q' 9-max Seat #6 is the button
Seat 1: uw9QayAAxLM3Hb+HR7mSkg ($12 in chips)
Seat 2: C3rGXblctNcWI6JYPHhaEg ($39.90 in chips)
Seat 3: iadBi5AEt7gTBXbDSSnMYQ ($40.25 in chips)
Seat 5: iAISe3dVeua8PUn2wwgDHw ($65.25 in chips)
Seat 6: 5k9fvXD9suIgCxU4HLQjTw ($50 in chips)
Seat 7: SKnJuWHScqetA/qG5p+wCg ($35.20 in chips)
Seat 8: JYwJYYV9pM5KWdSiETl8rA ($29.75 in chips)
SKnJuWHScqetA/qG5p+wCg: posts small blind $0.25
JYwJYYV9pM5KWdSiETl8rA: posts big blind $0.50
rFvc7K/96V9eGvYRfmpoUQ: sits out
*** HOLE CARDS ***
uw9QayAAxLM3Hb+HR7mSkg: folds
C3rGXblctNcWI6JYPHhaEg: raises $0.50 to $1
iadBi5AEt7gTBXbDSSnMYQ: calls $1
iAISe3dVeua8PUn2wwgDHw: folds
5k9fvXD9suIgCxU4HLQjTw: folds
SKnJuWHScqetA/qG5p+wCg: folds
JYwJYYV9pM5KWdSiETl8rA: folds
*** FLOP *** [Qh 2s As]
C3rGXblctNcWI6JYPHhaEg: checks
iadBi5AEt7gTBXbDSSnMYQ: bets $1
C3rGXblctNcWI6JYPHhaEg: calls $1
*** TURN *** [Qh 2s As] [5c]
C3rGXblctNcWI6JYPHhaEg: checks
iadBi5AEt7gTBXbDSSnMYQ: bets $1
C3rGXblctNcWI6JYPHhaEg: calls $1
*** RIVER *** [Qh 2s As 5c] [6s]
C3rGXblctNcWI6JYPHhaEg: bets $1.90
iadBi5AEt7gTBXbDSSnMYQ: raises $3.10 to $5
C3rGXblctNcWI6JYPHhaEg: folds
iadBi5AEt7gTBXbDSSnMYQ collected $10.05 from pot
*** SUMMARY ***
Total pot $10.55 | Rake $0.50
Board [Qh 2s As 5c 6s]
Seat 1: uw9QayAAxLM3Hb+HR7mSkg folded before Flop (didn't bet)
Seat 2: C3rGXblctNcWI6JYPHhaEg folded on the River
Seat 3: iadBi5AEt7gTBXbDSSnMYQ collected ($10.05)
Seat 5: iAISe3dVeua8PUn2wwgDHw folded before Flop (didn't bet)
Seat 6: 5k9fvXD9suIgCxU4HLQjTw (button) folded before Flop (didn't bet)
Seat 7: SKnJuWHScqetA/qG5p+wCg (small blind) folded before Flop
Seat 8: JYwJYYV9pM5KWdSiETl8rA (big blind) folded before Flop



PokerStars Game #59940683816:  Hold'em No Limit ($0.25/$0.50) - 2009/07/01 1:13:36 ET
Table 'EiNh8p/wGJ1FP575iMFnqg' 9-max Seat #9 is the button
Seat 1: r3ZqM1Mi0W3y4hOdssE+Sg ($66.75 in chips)
Seat 2: 8ehL7qlZzjgUh2H35iiWLw ($54.15 in chips)
Seat 3: ymLPoEIl7UL3TvZYmnadxQ ($60.30 in chips)
Seat 4: cMzaiXAM/ZAdNaEUu+LqhA ($50.75 in chips)
Seat 5: M+7+BTmX5vZatHVuoRB1nA ($79.70 in chips)
Seat 6: 3UmXLy3GfjC3EkOebduerQ ($61.60 in chips)
Seat 7: 997ViqAtWn1FPjJqcffwcA ($50 in chips)
Seat 8: mSD1pginDsyHG5PDfqzphw ($10 in chips)
Seat 9: GuPkZObrz5Zkkn8FsEdF9w ($29.25 in chips)
r3ZqM1Mi0W3y4hOdssE+Sg: posts small blind $0.25
8ehL7qlZzjgUh2H35iiWLw: posts big blind $0.50
*** HOLE CARDS ***
ymLPoEIl7UL3TvZYmnadxQ: folds
cMzaiXAM/ZAdNaEUu+LqhA: folds
M+7+BTmX5vZatHVuoRB1nA: folds
3UmXLy3GfjC3EkOebduerQ: folds
997ViqAtWn1FPjJqcffwcA: folds
mSD1pginDsyHG5PDfqzphw: folds
GuPkZObrz5Zkkn8FsEdF9w: raises $1 to $1.50
r3ZqM1Mi0W3y4hOdssE+Sg: folds
8ehL7qlZzjgUh2H35iiWLw: folds
GuPkZObrz5Zkkn8FsEdF9w collected $1.25 from pot
GuPkZObrz5Zkkn8FsEdF9w: doesn't show hand
*** SUMMARY ***
Total pot $1.25 | Rake $0
Seat 1: r3ZqM1Mi0W3y4hOdssE+Sg (small blind) folded before Flop
Seat 2: 8ehL7qlZzjgUh2H35iiWLw (big blind) folded before Flop
Seat 3: ymLPoEIl7UL3TvZYmnadxQ folded before Flop (didn't bet)
Seat 4: cMzaiXAM/ZAdNaEUu+LqhA folded before Flop (didn't bet)
Seat 5: M+7+BTmX5vZatHVuoRB1nA folded before Flop (didn't bet)
Seat 6: 3UmXLy3GfjC3EkOebduerQ folded before Flop (didn't bet)
Seat 7: 997ViqAtWn1FPjJqcffwcA folded before Flop (didn't bet)
Seat 8: mSD1pginDsyHG5PDfqzphw folded before Flop (didn't bet)
Seat 9: GuPkZObrz5Zkkn8FsEdF9w (button) collected ($1.25)



PokerStars Game #59940683670:  Hold'em No Limit ($0.25/$0.50) - 2009/07/01 1:13:36 ET
Table '+z1aekfHkpp09pc8F9aViw' 6-max Seat #3 is the button
Seat 1: 7zFtlEn2NxyROFkJdZA/yg ($50 in chips)
Seat 3: uUznlIMFnRUvwrBhYF73KA ($141.15 in chips)
Seat 4: RowCSpSURHTOL/dcjg/Iug ($50.20 in chips)
Seat 5: rplyldNweS6YyMNEALQrug ($49.80 in chips)
RowCSpSURHTOL/dcjg/Iug: posts small blind $0.25
rplyldNweS6YyMNEALQrug: posts big blind $0.50
GUnvMULl2qFOO1yenu1UBw: sits out
OZ6OtYh5Y53MCH/p0QTn5g: sits out
*** HOLE CARDS ***
7zFtlEn2NxyROFkJdZA/yg: folds
uUznlIMFnRUvwrBhYF73KA: folds
RowCSpSURHTOL/dcjg/Iug: calls $0.25
rplyldNweS6YyMNEALQrug: checks
*** FLOP *** [5s Ah 9c]
RowCSpSURHTOL/dcjg/Iug: checks
rplyldNweS6YyMNEALQrug: checks
*** TURN *** [5s Ah 9c] [2s]
RowCSpSURHTOL/dcjg/Iug: bets $1
rplyldNweS6YyMNEALQrug: folds
RowCSpSURHTOL/dcjg/Iug collected $0.95 from pot
*** SUMMARY ***
Total pot $1 | Rake $0.05
Board [5s Ah 9c 2s]
Seat 1: 7zFtlEn2NxyROFkJdZA/yg folded before Flop (didn't bet)
Seat 3: uUznlIMFnRUvwrBhYF73KA (button) folded before Flop (didn't bet)
Seat 4: RowCSpSURHTOL/dcjg/Iug (small blind) collected ($0.95)
Seat 5: rplyldNweS6YyMNEALQrug (big blind) folded on the Turn



PokerStars Game #59940684206:  Hold'em No Limit ($0.25/$0.50) - 2009/07/01 1:13:37 ET
Table 'lpxYasB1ClBSgTpCCITwhQ' 9-max Seat #7 is the button
Seat 1: mj7PS7wCH4PAl7+eYTFs7A ($49.25 in chips)
Seat 2: OWP/DOu+PlPK6ZZ3zYa0HA ($25.85 in chips)
Seat 3: sakr/FIfFtIZwDPmAj5Pzg ($49.20 in chips)
Seat 4: NnQCepdIR/AOUQn1yhYx6Q ($9.25 in chips)
Seat 6: SegjDnMxWMujiD57ESNL+g ($13.60 in chips)
Seat 7: bmRtaIYKthN1F+B3JLZ3Jw ($74.10 in chips)
Seat 8: /mfensKw8/iZ1Vrx33S4xg ($18 in chips)
Seat 9: sUIUZ+begh92dzkUmvbMrw ($12.80 in chips)
/mfensKw8/iZ1Vrx33S4xg: posts small blind $0.25
sUIUZ+begh92dzkUmvbMrw: posts big blind $0.50
*** HOLE CARDS ***
mj7PS7wCH4PAl7+eYTFs7A: folds
OWP/DOu+PlPK6ZZ3zYa0HA: folds
sakr/FIfFtIZwDPmAj5Pzg: folds
NnQCepdIR/AOUQn1yhYx6Q: folds
SegjDnMxWMujiD57ESNL+g: raises $1 to $1.50
bmRtaIYKthN1F+B3JLZ3Jw: folds
/mfensKw8/iZ1Vrx33S4xg: calls $1.25
sUIUZ+begh92dzkUmvbMrw: calls $1
*** FLOP *** [5c Qh 7s]
/mfensKw8/iZ1Vrx33S4xg: checks
sUIUZ+begh92dzkUmvbMrw: checks
SegjDnMxWMujiD57ESNL+g: bets $2.50
/mfensKw8/iZ1Vrx33S4xg: calls $2.50
sUIUZ+begh92dzkUmvbMrw: calls $2.50
*** TURN *** [5c Qh 7s] [Ts]
/mfensKw8/iZ1Vrx33S4xg: bets $2.50
sUIUZ+begh92dzkUmvbMrw: calls $2.50
SegjDnMxWMujiD57ESNL+g: calls $2.50
*** RIVER *** [5c Qh 7s Ts] [Jh]
/mfensKw8/iZ1Vrx33S4xg: checks
sUIUZ+begh92dzkUmvbMrw: checks
SegjDnMxWMujiD57ESNL+g: checks
*** SHOW DOWN ***
/mfensKw8/iZ1Vrx33S4xg: shows [3d Qd] (a pair of Queens)
sUIUZ+begh92dzkUmvbMrw: shows [Ks As] (a straight, Ten to Ace)
SegjDnMxWMujiD57ESNL+g: mucks hand
sUIUZ+begh92dzkUmvbMrw collected $18.60 from pot
*** SUMMARY ***
Total pot $19.50 | Rake $0.90
Board [5c Qh 7s Ts Jh]
Seat 1: mj7PS7wCH4PAl7+eYTFs7A folded before Flop (didn't bet)
Seat 2: OWP/DOu+PlPK6ZZ3zYa0HA folded before Flop (didn't bet)
Seat 3: sakr/FIfFtIZwDPmAj5Pzg folded before Flop (didn't bet)
Seat 4: NnQCepdIR/AOUQn1yhYx6Q folded before Flop (didn't bet)
Seat 6: SegjDnMxWMujiD57ESNL+g mucked
Seat 7: bmRtaIYKthN1F+B3JLZ3Jw (button) folded before Flop (didn't bet)
Seat 8: /mfensKw8/iZ1Vrx33S4xg (small blind) showed [3d Qd] and lost with a pair of Queens
Seat 9: sUIUZ+begh92dzkUmvbMrw (big blind) showed [Ks As] and won ($18.60) with a straight, Ten to Ace



PokerStars Game #59940686902:  Hold'em No Limit ($0.25/$0.50) - 2009/07/01 1:13:41 ET
Table '+dXkOAQyS8j9PQZusUTMpg' 2-max Seat #2 is the button
Seat 1: XFa6sBGjP2gxoIvxR3fZIg ($127.60 in chips)
Seat 2: 5IBeOgaApY1Bvzv2P8X4EA ($66.05 in chips)
5IBeOgaApY1Bvzv2P8X4EA: posts small blind $0.25
XFa6sBGjP2gxoIvxR3fZIg: posts big blind $0.50
*** HOLE CARDS ***
5IBeOgaApY1Bvzv2P8X4EA: folds
XFa6sBGjP2gxoIvxR3fZIg collected $0.50 from pot
XFa6sBGjP2gxoIvxR3fZIg: doesn't show hand
*** SUMMARY ***
Total pot $0.50 | Rake $0
Seat 1: XFa6sBGjP2gxoIvxR3fZIg (big blind) collected ($0.50)
Seat 2: 5IBeOgaApY1Bvzv2P8X4EA (button) (small blind) folded before Flop



PokerStars Game #59940687714:  Hold'em No Limit ($0.25/$0.50) - 2009/07/01 1:13:43 ET
Table 'c/CRn+68J3Y8KxD5g1ek2Q' 2-max Seat #2 is the button
Seat 1: 46qCyJ6evTkHo9al5sBMNA ($117.20 in chips)
Seat 2: BypVLsYQt3ePFm2xQL/dOA ($246.80 in chips)
BypVLsYQt3ePFm2xQL/dOA: posts small blind $0.25
46qCyJ6evTkHo9al5sBMNA: posts big blind $0.50
*** HOLE CARDS ***
BypVLsYQt3ePFm2xQL/dOA: calls $0.25
46qCyJ6evTkHo9al5sBMNA: checks
*** FLOP *** [9d 7h Jd]
46qCyJ6evTkHo9al5sBMNA: checks
BypVLsYQt3ePFm2xQL/dOA: checks
*** TURN *** [9d 7h Jd] [Ts]
46qCyJ6evTkHo9al5sBMNA: bets $1.50
BypVLsYQt3ePFm2xQL/dOA: folds
46qCyJ6evTkHo9al5sBMNA collected $0.95 from pot
46qCyJ6evTkHo9al5sBMNA: doesn't show hand
*** SUMMARY ***
Total pot $1 | Rake $0.05
Board [9d 7h Jd Ts]
Seat 1: 46qCyJ6evTkHo9al5sBMNA (big blind) collected ($0.95)
Seat 2: BypVLsYQt3ePFm2xQL/dOA (button) (small blind) folded on the Turn



PokerStars Game #59940689392:  Hold'em No Limit ($0.25/$0.50) - 2009/07/01 1:13:45 ET
Table 'GfL/No5u5PoEnU39lP5pQg' 6-max Seat #4 is the button
Seat 1: 1WUCqNG+p+vfWRTXNu4ljw ($64.50 in chips)
Seat 2: uVwggSetzp7d+eVgowO3vg ($53.45 in chips)
Seat 3: 4pp9WxhGdbVbxCc9tlu0lw ($32.45 in chips)
Seat 4: r6u7MWSXF30/khcTYkrG9Q ($18.85 in chips)
Seat 5: M1KyQQvVPVuxqTAB8sR/zQ ($52.90 in chips)
Seat 6: kxPhs4ePFqMy52CInAJ2aw ($63.45 in chips)
M1KyQQvVPVuxqTAB8sR/zQ: posts small blind $0.25
kxPhs4ePFqMy52CInAJ2aw: posts big blind $0.50
*** HOLE CARDS ***
1WUCqNG+p+vfWRTXNu4ljw: folds
uVwggSetzp7d+eVgowO3vg: folds
4pp9WxhGdbVbxCc9tlu0lw: folds
r6u7MWSXF30/khcTYkrG9Q: folds
M1KyQQvVPVuxqTAB8sR/zQ: folds
kxPhs4ePFqMy52CInAJ2aw collected $0.50 from pot
kxPhs4ePFqMy52CInAJ2aw: doesn't show hand
*** SUMMARY ***
Total pot $0.50 | Rake $0
Seat 1: 1WUCqNG+p+vfWRTXNu4ljw folded before Flop (didn't bet)
Seat 2: uVwggSetzp7d+eVgowO3vg folded before Flop (didn't bet)
Seat 3: 4pp9WxhGdbVbxCc9tlu0lw folded before Flop (didn't bet)
Seat 4: r6u7MWSXF30/khcTYkrG9Q (button) folded before Flop (didn't bet)
Seat 5: M1KyQQvVPVuxqTAB8sR/zQ (small blind) folded before Flop
Seat 6: kxPhs4ePFqMy52CInAJ2aw (big blind) collected ($0.50)



PokerStars Game #59940689858:  Hold'em No Limit ($0.25/$0.50) - 2009/07/01 1:13:46 ET
Table 'BCN5su+SsXiy1zRMJi0SJw' 6-max Seat #5 is the button
Seat 1: GxXV09ciXaOxyY2H5aMIIw ($54.90 in chips)
Seat 2: oU2kDCkT/gilYbHWrg7D8w ($38.45 in chips)
Seat 3: kwgv5lNhiFrfONXCshzxlA ($27.20 in chips)
Seat 4: 4QfsCWthT/vSLirorNXqtg ($55.75 in chips)
Seat 5: cEMJmfAUQZmMChZe6aacKw ($24.50 in chips)
Seat 6: b2symlOdL7+0c9Pj4N/KlA ($58.40 in chips)
b2symlOdL7+0c9Pj4N/KlA: posts small blind $0.25
GxXV09ciXaOxyY2H5aMIIw: posts big blind $0.50
*** HOLE CARDS ***
oU2kDCkT/gilYbHWrg7D8w: calls $0.50
kwgv5lNhiFrfONXCshzxlA: folds
4QfsCWthT/vSLirorNXqtg: folds
cEMJmfAUQZmMChZe6aacKw: folds
b2symlOdL7+0c9Pj4N/KlA: folds
GxXV09ciXaOxyY2H5aMIIw: checks
*** FLOP *** [7d 2h 4c]
GxXV09ciXaOxyY2H5aMIIw: checks
oU2kDCkT/gilYbHWrg7D8w: checks
*** TURN *** [7d 2h 4c] [Ac]
GxXV09ciXaOxyY2H5aMIIw: checks
oU2kDCkT/gilYbHWrg7D8w: checks
*** RIVER *** [7d 2h 4c Ac] [9s]
GxXV09ciXaOxyY2H5aMIIw: checks
oU2kDCkT/gilYbHWrg7D8w: checks
*** SHOW DOWN ***
GxXV09ciXaOxyY2H5aMIIw: shows [9d 3c] (a pair of Nines)
oU2kDCkT/gilYbHWrg7D8w: mucks hand
GxXV09ciXaOxyY2H5aMIIw collected $1.20 from pot
*** SUMMARY ***
Total pot $1.25 | Rake $0.05
Board [7d 2h 4c Ac 9s]
Seat 1: GxXV09ciXaOxyY2H5aMIIw (big blind) showed [9d 3c] and won ($1.20) with a pair of Nines
Seat 2: oU2kDCkT/gilYbHWrg7D8w mucked
Seat 3: kwgv5lNhiFrfONXCshzxlA folded before Flop (didn't bet)
Seat 4: 4QfsCWthT/vSLirorNXqtg folded before Flop (didn't bet)
Seat 5: cEMJmfAUQZmMChZe6aacKw (button) folded before Flop (didn't bet)
Seat 6: b2symlOdL7+0c9Pj4N/KlA (small blind) folded before Flop



PokerStars Game #59940690196:  Hold'em No Limit ($0.25/$0.50) - 2009/07/01 1:13:47 ET
Table '+dXkOAQyS8j9PQZusUTMpg' 2-max Seat #1 is the button
Seat 1: XFa6sBGjP2gxoIvxR3fZIg ($127.85 in chips)
Seat 2: 5IBeOgaApY1Bvzv2P8X4EA ($65.80 in chips)
XFa6sBGjP2gxoIvxR3fZIg: posts small blind $0.25
5IBeOgaApY1Bvzv2P8X4EA: posts big blind $0.50
*** HOLE CARDS ***
XFa6sBGjP2gxoIvxR3fZIg: raises $1 to $1.50
5IBeOgaApY1Bvzv2P8X4EA: calls $1
*** FLOP *** [8d 8h 9c]
5IBeOgaApY1Bvzv2P8X4EA: checks
XFa6sBGjP2gxoIvxR3fZIg: checks
*** TURN *** [8d 8h 9c] [Qc]
5IBeOgaApY1Bvzv2P8X4EA: checks
XFa6sBGjP2gxoIvxR3fZIg: bets $2
5IBeOgaApY1Bvzv2P8X4EA: folds
XFa6sBGjP2gxoIvxR3fZIg collected $2.85 from pot
*** SUMMARY ***
Total pot $3 | Rake $0.15
Board [8d 8h 9c Qc]
Seat 1: XFa6sBGjP2gxoIvxR3fZIg (button) (small blind) collected ($2.85)
Seat 2: 5IBeOgaApY1Bvzv2P8X4EA (big blind) folded on the Turn



PokerStars Game #59940690850:  Hold'em No Limit ($0.25/$0.50) - 2009/07/01 1:13:48 ET
Table 'lSisgp6H7Fg1hH5VfjEjYQ' 9-max Seat #3 is the button
Seat 1: 5k9fvXD9suIgCxU4HLQjTw ($50 in chips)
Seat 2: UrcnkQOiLVk8BlKDPJSy7Q ($77.90 in chips)
Seat 3: aTkyjTh3w5YLWiIERupZOA ($46.40 in chips)
Seat 4: bwv/rbH/hHhPhY6u9mu04w ($34.85 in chips)
Seat 5: mSD1pginDsyHG5PDfqzphw ($10 in chips)
Seat 6: +k7T5ocke8UwavtgUHm+Cg ($65.40 in chips)
Seat 7: IDtNLR9uFCDdjNsJWMHA5Q ($22.55 in chips)
Seat 8: a4JDWmpFQkL10XfAyuF51A ($26.25 in chips)
Seat 9: YzeKFbJVLmJGTgNH3ySQlw ($13.45 in chips)
bwv/rbH/hHhPhY6u9mu04w: posts small blind $0.25
mSD1pginDsyHG5PDfqzphw: posts big blind $0.50
*** HOLE CARDS ***
+k7T5ocke8UwavtgUHm+Cg: folds
IDtNLR9uFCDdjNsJWMHA5Q: calls $0.50
a4JDWmpFQkL10XfAyuF51A: calls $0.50
YzeKFbJVLmJGTgNH3ySQlw: calls $0.50
5k9fvXD9suIgCxU4HLQjTw: folds
UrcnkQOiLVk8BlKDPJSy7Q: folds
aTkyjTh3w5YLWiIERupZOA: folds
bwv/rbH/hHhPhY6u9mu04w: calls $0.25
mSD1pginDsyHG5PDfqzphw: checks
*** FLOP *** [Ks 8d As]
bwv/rbH/hHhPhY6u9mu04w: checks
mSD1pginDsyHG5PDfqzphw: checks
IDtNLR9uFCDdjNsJWMHA5Q: checks
a4JDWmpFQkL10XfAyuF51A: checks
YzeKFbJVLmJGTgNH3ySQlw: bets $1.50
bwv/rbH/hHhPhY6u9mu04w: folds
mSD1pginDsyHG5PDfqzphw: raises $8 to $9.50 and is all-in
IDtNLR9uFCDdjNsJWMHA5Q: folds
a4JDWmpFQkL10XfAyuF51A: folds
YzeKFbJVLmJGTgNH3ySQlw: folds
mSD1pginDsyHG5PDfqzphw collected $5.25 from pot
mSD1pginDsyHG5PDfqzphw: doesn't show hand
*** SUMMARY ***
Total pot $5.50 | Rake $0.25
Board [Ks 8d As]
Seat 1: 5k9fvXD9suIgCxU4HLQjTw folded before Flop (didn't bet)
Seat 2: UrcnkQOiLVk8BlKDPJSy7Q folded before Flop (didn't bet)
Seat 3: aTkyjTh3w5YLWiIERupZOA (button) folded before Flop (didn't bet)
Seat 4: bwv/rbH/hHhPhY6u9mu04w (small blind) folded on the Flop
Seat 5: mSD1pginDsyHG5PDfqzphw (big blind) collected ($5.25)
Seat 6: +k7T5ocke8UwavtgUHm+Cg folded before Flop (didn't bet)
Seat 7: IDtNLR9uFCDdjNsJWMHA5Q folded on the Flop
Seat 8: a4JDWmpFQkL10XfAyuF51A folded on the Flop
Seat 9: YzeKFbJVLmJGTgNH3ySQlw folded on the Flop



PokerStars Game #59940692272:  Hold'em No Limit ($0.25/$0.50) - 2009/07/01 1:13:50 ET
Table 'hSTs/dUsYLgJQuF2Onp0MQ' 6-max Seat #4 is the button
Seat 1: 1WUCqNG+p+vfWRTXNu4ljw ($50 in chips)
Seat 2: 6vNxrjjCl6FwfaaymM9jjg ($67.45 in chips)
Seat 3: C3qJBo7uxfFVDluE1lmK2w ($35.35 in chips)
Seat 4: L0aIPg7qefDQjdJo3HCVEA ($9.30 in chips)
Seat 5: IBNygaT1aa9Z1uPdJJilwA ($29.50 in chips)
Seat 6: M1KyQQvVPVuxqTAB8sR/zQ ($88.95 in chips)
IBNygaT1aa9Z1uPdJJilwA: posts small blind $0.25
M1KyQQvVPVuxqTAB8sR/zQ: posts big blind $0.50
*** HOLE CARDS ***
1WUCqNG+p+vfWRTXNu4ljw: folds
6vNxrjjCl6FwfaaymM9jjg: folds
C3qJBo7uxfFVDluE1lmK2w: folds
L0aIPg7qefDQjdJo3HCVEA: folds
IBNygaT1aa9Z1uPdJJilwA: folds
M1KyQQvVPVuxqTAB8sR/zQ collected $0.50 from pot
*** SUMMARY ***
Total pot $0.50 | Rake $0
Seat 1: 1WUCqNG+p+vfWRTXNu4ljw folded before Flop (didn't bet)
Seat 2: 6vNxrjjCl6FwfaaymM9jjg folded before Flop (didn't bet)
Seat 3: C3qJBo7uxfFVDluE1lmK2w folded before Flop (didn't bet)
Seat 4: L0aIPg7qefDQjdJo3HCVEA (button) folded before Flop (didn't bet)
Seat 5: IBNygaT1aa9Z1uPdJJilwA (small blind) folded before Flop
Seat 6: M1KyQQvVPVuxqTAB8sR/zQ (big blind) collected ($0.50)



PokerStars Game #59940695602:  Hold'em No Limit ($0.25/$0.50) - 2009/07/01 1:13:56 ET
Table '37qXEp3oe+er5q4CZip9eQ' 6-max Seat #6 is the button
Seat 1: lxIzoHy0RnkfFSODHC2liw ($50.25 in chips)
Seat 2: LvH4G7n+QSjT6NDaD3cREA ($59.85 in chips)
Seat 3: Rt6KgtZ8YaJoTc3FPim00w ($109.45 in chips)
Seat 4: XsmE8nXMAAMFJbWaJTmHFw ($48.20 in chips)
Seat 5: VOmI0x4dDPnTESZd5B4d1Q ($35.75 in chips)
Seat 6: N50kln4negd8q7Mmoz1j4g ($11.55 in chips)
lxIzoHy0RnkfFSODHC2liw: posts small blind $0.25
LvH4G7n+QSjT6NDaD3cREA: posts big blind $0.50
*** HOLE CARDS ***
Rt6KgtZ8YaJoTc3FPim00w: raises $1 to $1.50
XsmE8nXMAAMFJbWaJTmHFw: folds
VOmI0x4dDPnTESZd5B4d1Q: folds
N50kln4negd8q7Mmoz1j4g: folds
lxIzoHy0RnkfFSODHC2liw: folds
LvH4G7n+QSjT6NDaD3cREA: folds
Rt6KgtZ8YaJoTc3FPim00w collected $1.25 from pot
*** SUMMARY ***
Total pot $1.25 | Rake $0
Seat 1: lxIzoHy0RnkfFSODHC2liw (small blind) folded before Flop
Seat 2: LvH4G7n+QSjT6NDaD3cREA (big blind) folded before Flop
Seat 3: Rt6KgtZ8YaJoTc3FPim00w collected ($1.25)
Seat 4: XsmE8nXMAAMFJbWaJTmHFw folded before Flop (didn't bet)
Seat 5: VOmI0x4dDPnTESZd5B4d1Q folded before Flop (didn't bet)
Seat 6: N50kln4negd8q7Mmoz1j4g (button) folded before Flop (didn't bet)



PokerStars Game #59940696290:  Hold'em No Limit ($0.25/$0.50) - 2009/07/01 1:13:57 ET
Table 'GfL/No5u5PoEnU39lP5pQg' 6-max Seat #5 is the button
Seat 1: 1WUCqNG+p+vfWRTXNu4ljw ($64.50 in chips)
Seat 2: uVwggSetzp7d+eVgowO3vg ($53.45 in chips)
Seat 3: 4pp9WxhGdbVbxCc9tlu0lw ($32.45 in chips)
Seat 4: r6u7MWSXF30/khcTYkrG9Q ($18.85 in chips)
Seat 5: M1KyQQvVPVuxqTAB8sR/zQ ($52.65 in chips)
Seat 6: kxPhs4ePFqMy52CInAJ2aw ($63.70 in chips)
kxPhs4ePFqMy52CInAJ2aw: posts small blind $0.25
1WUCqNG+p+vfWRTXNu4ljw: posts big blind $0.50
*** HOLE CARDS ***
uVwggSetzp7d+eVgowO3vg: calls $0.50
4pp9WxhGdbVbxCc9tlu0lw: folds
r6u7MWSXF30/khcTYkrG9Q: folds
M1KyQQvVPVuxqTAB8sR/zQ: calls $0.50
kxPhs4ePFqMy52CInAJ2aw: folds
1WUCqNG+p+vfWRTXNu4ljw: checks
*** FLOP *** [Ah Jc Jd]
1WUCqNG+p+vfWRTXNu4ljw: checks
uVwggSetzp7d+eVgowO3vg: checks
M1KyQQvVPVuxqTAB8sR/zQ: checks
*** TURN *** [Ah Jc Jd] [4h]
1WUCqNG+p+vfWRTXNu4ljw: checks
uVwggSetzp7d+eVgowO3vg: checks
M1KyQQvVPVuxqTAB8sR/zQ: checks
*** RIVER *** [Ah Jc Jd 4h] [7d]
1WUCqNG+p+vfWRTXNu4ljw: checks
uVwggSetzp7d+eVgowO3vg: checks
M1KyQQvVPVuxqTAB8sR/zQ: checks
*** SHOW DOWN ***
1WUCqNG+p+vfWRTXNu4ljw: shows [4d Qd] (two pair, Jacks and Fours)
uVwggSetzp7d+eVgowO3vg: shows [6s 6h] (two pair, Jacks and Sixes)
M1KyQQvVPVuxqTAB8sR/zQ: mucks hand
uVwggSetzp7d+eVgowO3vg collected $1.70 from pot
*** SUMMARY ***
Total pot $1.75 | Rake $0.05
Board [Ah Jc Jd 4h 7d]
Seat 1: 1WUCqNG+p+vfWRTXNu4ljw (big blind) showed [4d Qd] and lost with two pair, Jacks and Fours
Seat 2: uVwggSetzp7d+eVgowO3vg showed [6s 6h] and won ($1.70) with two pair, Jacks and Sixes
Seat 3: 4pp9WxhGdbVbxCc9tlu0lw folded before Flop (didn't bet)
Seat 4: r6u7MWSXF30/khcTYkrG9Q folded before Flop (didn't bet)
Seat 5: M1KyQQvVPVuxqTAB8sR/zQ (button) mucked
Seat 6: kxPhs4ePFqMy52CInAJ2aw (small blind) folded before Flop



PokerStars Game #59940698324:  Hold'em No Limit ($0.25/$0.50) - 2009/07/01 1:14:01 ET
Table 'MJxeZCzYELxiIsyUZyT0jw' 6-max Seat #5 is the button
Seat 1: +Pf9jTVizYlIo+woPvptfA ($50 in chips)
Seat 2: t3GiVMzqA9Svgr5Uol32cQ ($27.10 in chips)
Seat 3: sIG4mp8tZEI+W4nKZNkkQA ($51.85 in chips)
Seat 4: alGiiQP/wwtYnfuXII+sgw ($61.60 in chips)
Seat 5: 3jvoOXNtXE90w2BdfNZwZQ ($53.80 in chips)
Seat 6: c0n4hrn20AML9qzyFC2E8Q ($59.60 in chips)
c0n4hrn20AML9qzyFC2E8Q: posts small blind $0.25
+Pf9jTVizYlIo+woPvptfA: posts big blind $0.50
*** HOLE CARDS ***
t3GiVMzqA9Svgr5Uol32cQ: folds
sIG4mp8tZEI+W4nKZNkkQA: folds
alGiiQP/wwtYnfuXII+sgw: folds
3jvoOXNtXE90w2BdfNZwZQ: raises $1 to $1.50
c0n4hrn20AML9qzyFC2E8Q: calls $1.25
+Pf9jTVizYlIo+woPvptfA: folds
*** FLOP *** [5s 3d 9s]
c0n4hrn20AML9qzyFC2E8Q: checks
3jvoOXNtXE90w2BdfNZwZQ: bets $2
c0n4hrn20AML9qzyFC2E8Q: calls $2
*** TURN *** [5s 3d 9s] [Js]
c0n4hrn20AML9qzyFC2E8Q: checks
3jvoOXNtXE90w2BdfNZwZQ: checks
*** RIVER *** [5s 3d 9s Js] [2c]
c0n4hrn20AML9qzyFC2E8Q: bets $5
3jvoOXNtXE90w2BdfNZwZQ: raises $10 to $15
c0n4hrn20AML9qzyFC2E8Q: folds
3jvoOXNtXE90w2BdfNZwZQ collected $16.65 from pot
3jvoOXNtXE90w2BdfNZwZQ: doesn't show hand
*** SUMMARY ***
Total pot $17.50 | Rake $0.85
Board [5s 3d 9s Js 2c]
Seat 1: +Pf9jTVizYlIo+woPvptfA (big blind) folded before Flop
Seat 2: t3GiVMzqA9Svgr5Uol32cQ folded before Flop (didn't bet)
Seat 3: sIG4mp8tZEI+W4nKZNkkQA folded before Flop (didn't bet)
Seat 4: alGiiQP/wwtYnfuXII+sgw folded before Flop (didn't bet)
Seat 5: 3jvoOXNtXE90w2BdfNZwZQ (button) collected ($16.65)
Seat 6: c0n4hrn20AML9qzyFC2E8Q (small blind) folded on the River



PokerStars Game #59940700048:  Hold'em No Limit ($0.25/$0.50) - 2009/07/01 1:14:03 ET
Table 'EiNh8p/wGJ1FP575iMFnqg' 9-max Seat #1 is the button
Seat 1: r3ZqM1Mi0W3y4hOdssE+Sg ($66.50 in chips)
Seat 2: 8ehL7qlZzjgUh2H35iiWLw ($53.65 in chips)
Seat 3: ymLPoEIl7UL3TvZYmnadxQ ($60.30 in chips)
Seat 4: cMzaiXAM/ZAdNaEUu+LqhA ($50.75 in chips)
Seat 5: M+7+BTmX5vZatHVuoRB1nA ($79.70 in chips)
Seat 6: 3UmXLy3GfjC3EkOebduerQ ($61.60 in chips)
Seat 7: 997ViqAtWn1FPjJqcffwcA ($50 in chips)
Seat 8: mSD1pginDsyHG5PDfqzphw ($10 in chips)
Seat 9: GuPkZObrz5Zkkn8FsEdF9w ($30 in chips)
8ehL7qlZzjgUh2H35iiWLw: posts small blind $0.25
ymLPoEIl7UL3TvZYmnadxQ: posts big blind $0.50
*** HOLE CARDS ***
cMzaiXAM/ZAdNaEUu+LqhA: folds
M+7+BTmX5vZatHVuoRB1nA: raises $1 to $1.50
3UmXLy3GfjC3EkOebduerQ: folds
997ViqAtWn1FPjJqcffwcA: folds
mSD1pginDsyHG5PDfqzphw: folds
GuPkZObrz5Zkkn8FsEdF9w: folds
r3ZqM1Mi0W3y4hOdssE+Sg: folds
8ehL7qlZzjgUh2H35iiWLw: folds
ymLPoEIl7UL3TvZYmnadxQ: folds
M+7+BTmX5vZatHVuoRB1nA collected $1.25 from pot
M+7+BTmX5vZatHVuoRB1nA: doesn't show hand
*** SUMMARY ***
Total pot $1.25 | Rake $0
Seat 1: r3ZqM1Mi0W3y4hOdssE+Sg (button) folded before Flop (didn't bet)
Seat 2: 8ehL7qlZzjgUh2H35iiWLw (small blind) folded before Flop
Seat 3: ymLPoEIl7UL3TvZYmnadxQ (big blind) folded before Flop
Seat 4: cMzaiXAM/ZAdNaEUu+LqhA folded before Flop (didn't bet)
Seat 5: M+7+BTmX5vZatHVuoRB1nA collected ($1.25)
Seat 6: 3UmXLy3GfjC3EkOebduerQ folded before Flop (didn't bet)
Seat 7: 997ViqAtWn1FPjJqcffwcA folded before Flop (didn't bet)
Seat 8: mSD1pginDsyHG5PDfqzphw folded before Flop (didn't bet)
Seat 9: GuPkZObrz5Zkkn8FsEdF9w folded before Flop (didn't bet)



PokerStars Game #59940699708:  Hold'em No Limit ($0.25/$0.50) - 2009/07/01 1:14:03 ET
Table '5EmHi+fnatGQQShcNmzOZQ' 6-max Seat #3 is the button
Seat 1: My8WkRtGx5FW6rJ1I4R3hg ($43.60 in chips)
Seat 2: bfFjgAtIoAI+pUxUwFt3aQ ($38.95 in chips)
Seat 3: 1mYbhL8CU/QYqfVmFcaHDQ ($6.55 in chips)
Seat 4: 1b+2BbjMN8qhR1WPqdE9VQ ($57.40 in chips)
Seat 5: kxPhs4ePFqMy52CInAJ2aw ($93.85 in chips)
1b+2BbjMN8qhR1WPqdE9VQ: posts small blind $0.25
kxPhs4ePFqMy52CInAJ2aw: posts big blind $0.50
+Pf9jTVizYlIo+woPvptfA: sits out
*** HOLE CARDS ***
My8WkRtGx5FW6rJ1I4R3hg has timed out
My8WkRtGx5FW6rJ1I4R3hg: folds
My8WkRtGx5FW6rJ1I4R3hg is sitting out
bfFjgAtIoAI+pUxUwFt3aQ: folds
1mYbhL8CU/QYqfVmFcaHDQ: calls $0.50
My8WkRtGx5FW6rJ1I4R3hg has returned
1b+2BbjMN8qhR1WPqdE9VQ: calls $0.25
kxPhs4ePFqMy52CInAJ2aw: checks
*** FLOP *** [Th 2h Jc]
1b+2BbjMN8qhR1WPqdE9VQ: bets $1
kxPhs4ePFqMy52CInAJ2aw: folds
1mYbhL8CU/QYqfVmFcaHDQ: folds
1b+2BbjMN8qhR1WPqdE9VQ collected $1.45 from pot
1b+2BbjMN8qhR1WPqdE9VQ: doesn't show hand
*** SUMMARY ***
Total pot $1.50 | Rake $0.05
Board [Th 2h Jc]
Seat 1: My8WkRtGx5FW6rJ1I4R3hg folded before Flop (didn't bet)
Seat 2: bfFjgAtIoAI+pUxUwFt3aQ folded before Flop (didn't bet)
Seat 3: 1mYbhL8CU/QYqfVmFcaHDQ (button) folded on the Flop
Seat 4: 1b+2BbjMN8qhR1WPqdE9VQ (small blind) collected ($1.45)
Seat 5: kxPhs4ePFqMy52CInAJ2aw (big blind) folded on the Flop



PokerStars Game #59940700248:  Hold'em No Limit ($0.25/$0.50) - 2009/07/01 1:14:04 ET
Table 'c/CRn+68J3Y8KxD5g1ek2Q' 2-max Seat #1 is the button
Seat 1: 46qCyJ6evTkHo9al5sBMNA ($117.65 in chips)
Seat 2: BypVLsYQt3ePFm2xQL/dOA ($246.30 in chips)
46qCyJ6evTkHo9al5sBMNA: posts small blind $0.25
BypVLsYQt3ePFm2xQL/dOA: posts big blind $0.50
*** HOLE CARDS ***
46qCyJ6evTkHo9al5sBMNA: folds
BypVLsYQt3ePFm2xQL/dOA collected $0.50 from pot
BypVLsYQt3ePFm2xQL/dOA: doesn't show hand
*** SUMMARY ***
Total pot $0.50 | Rake $0
Seat 1: 46qCyJ6evTkHo9al5sBMNA (button) (small blind) folded before Flop
Seat 2: BypVLsYQt3ePFm2xQL/dOA (big blind) collected ($0.50)



PokerStars Game #59940701468:  Hold'em No Limit ($0.25/$0.50) - 2009/07/01 1:14:06 ET
Table 'ErOuyGLI5PT3G5MnpHgC/gQOgaEqMcJ73pcUMMxoisUg Seat #1 is the button
Seat 1: eBrej2jnlUCs/JgxFCRn2g ($44.80 in chips)
Seat 2: pciZn00ZDk4BVBMTTMcNVQ ($27.80 in chips)
Seat 3: xZCXQSXlrZkp3pZizzVXCw ($50.50 in chips)
Seat 4: 3UmXLy3GfjC3EkOebduerQ ($50 in chips)
Seat 5: JwvquocWfhTVApN5t47LgA ($64.60 in chips)
Seat 6: zE9cVigS2nW/Ljy4K4bUQA ($31.60 in chips)
Seat 7: 90Wb75h3W1BRpbqVnuk8gw ($60.45 in chips)
Seat 8: g4k0NXISyLCqaSWZDBjfEg ($50 in chips)
Seat 9: J0W5D97jl5VLky+IoPvDeA ($52.35 in chips)
pciZn00ZDk4BVBMTTMcNVQ: posts small blind $0.25
xZCXQSXlrZkp3pZizzVXCw: posts big blind $0.50
*** HOLE CARDS ***
3UmXLy3GfjC3EkOebduerQ: folds
JwvquocWfhTVApN5t47LgA: raises $0.50 to $1
zE9cVigS2nW/Ljy4K4bUQA: folds
90Wb75h3W1BRpbqVnuk8gw: folds
g4k0NXISyLCqaSWZDBjfEg: folds
J0W5D97jl5VLky+IoPvDeA: raises $1.50 to $2.50
eBrej2jnlUCs/JgxFCRn2g: folds
pciZn00ZDk4BVBMTTMcNVQ: calls $2.25
xZCXQSXlrZkp3pZizzVXCw: folds
JwvquocWfhTVApN5t47LgA: calls $1.50
*** FLOP *** [5s 6s Td]
pciZn00ZDk4BVBMTTMcNVQ: bets $1.50
JwvquocWfhTVApN5t47LgA: folds
J0W5D97jl5VLky+IoPvDeA: raises $2.50 to $4
pciZn00ZDk4BVBMTTMcNVQ: calls $2.50
*** TURN *** [5s 6s Td] [2s]
pciZn00ZDk4BVBMTTMcNVQ: bets $2
J0W5D97jl5VLky+IoPvDeA: raises $43.85 to $45.85 and is all-in
pciZn00ZDk4BVBMTTMcNVQ: folds
J0W5D97jl5VLky+IoPvDeA collected $19.05 from pot
*** SUMMARY ***
Total pot $20 | Rake $0.95
Board [5s 6s Td 2s]
Seat 1: eBrej2jnlUCs/JgxFCRn2g (button) folded before Flop (didn't bet)
Seat 2: pciZn00ZDk4BVBMTTMcNVQ (small blind) folded on the Turn
Seat 3: xZCXQSXlrZkp3pZizzVXCw (big blind) folded before Flop
Seat 4: 3UmXLy3GfjC3EkOebduerQ folded before Flop (didn't bet)
Seat 5: JwvquocWfhTVApN5t47LgA folded on the Flop
Seat 6: zE9cVigS2nW/Ljy4K4bUQA folded before Flop (didn't bet)
Seat 7: 90Wb75h3W1BRpbqVnuk8gw folded before Flop (didn't bet)
Seat 8: g4k0NXISyLCqaSWZDBjfEg folded before Flop (didn't bet)
Seat 9: J0W5D97jl5VLky+IoPvDeA collected ($19.05)



PokerStars Game #59940701758:  Hold'em No Limit ($0.25/$0.50) - 2009/07/01 1:14:06 ET
Table 'ibNfFy0bCzuBaUORla0aGw' 9-max Seat #1 is the button
Seat 1: xZCXQSXlrZkp3pZizzVXCw ($50.55 in chips)
Seat 2: 90Wb75h3W1BRpbqVnuk8gw ($50 in chips)
Seat 3: AjV5McH1KMMclY26QdLM5w ($25 in chips)
Seat 4: YBN054X4blmis+B2bBlC0g ($22.65 in chips)
Seat 5: GIJAc9kPrLZHLSX8Q6i99w ($21.70 in chips)
Seat 6: H8cPaCtX7d6meGUVSM5sxw ($46.75 in chips)
Seat 7: HZkVla4kK2SI42CVrPZ/ig ($13.75 in chips)
Seat 8: viwBDtJsY6JfsFOdBAyJIQ ($13.95 in chips)
Seat 9: pFtzb1sR4b0d1aw6aIRgDg ($55.75 in chips)
90Wb75h3W1BRpbqVnuk8gw: posts small blind $0.25
AjV5McH1KMMclY26QdLM5w: posts big blind $0.50
*** HOLE CARDS ***
YBN054X4blmis+B2bBlC0g: folds
GIJAc9kPrLZHLSX8Q6i99w: calls $0.50
H8cPaCtX7d6meGUVSM5sxw: folds
HZkVla4kK2SI42CVrPZ/ig: folds
viwBDtJsY6JfsFOdBAyJIQ: folds
pFtzb1sR4b0d1aw6aIRgDg: folds
xZCXQSXlrZkp3pZizzVXCw: folds
90Wb75h3W1BRpbqVnuk8gw: calls $0.25
AjV5McH1KMMclY26QdLM5w: checks
*** FLOP *** [Ts Ks Jc]
90Wb75h3W1BRpbqVnuk8gw: checks
AjV5McH1KMMclY26QdLM5w: checks
GIJAc9kPrLZHLSX8Q6i99w: bets $1.50
90Wb75h3W1BRpbqVnuk8gw: calls $1.50
AjV5McH1KMMclY26QdLM5w: folds
*** TURN *** [Ts Ks Jc] [8s]
90Wb75h3W1BRpbqVnuk8gw: checks
GIJAc9kPrLZHLSX8Q6i99w: bets $1.50
90Wb75h3W1BRpbqVnuk8gw: calls $1.50
*** RIVER *** [Ts Ks Jc 8s] [3c]
90Wb75h3W1BRpbqVnuk8gw: checks
GIJAc9kPrLZHLSX8Q6i99w: bets $3
90Wb75h3W1BRpbqVnuk8gw: calls $3
*** SHOW DOWN ***
GIJAc9kPrLZHLSX8Q6i99w: shows [Td Kh] (two pair, Kings and Tens)
90Wb75h3W1BRpbqVnuk8gw: mucks hand
GIJAc9kPrLZHLSX8Q6i99w collected $12.85 from pot
*** SUMMARY ***
Total pot $13.50 | Rake $0.65
Board [Ts Ks Jc 8s 3c]
Seat 1: xZCXQSXlrZkp3pZizzVXCw (button) folded before Flop (didn't bet)
Seat 2: 90Wb75h3W1BRpbqVnuk8gw (small blind) mucked
Seat 3: AjV5McH1KMMclY26QdLM5w (big blind) folded on the Flop
Seat 4: YBN054X4blmis+B2bBlC0g folded before Flop (didn't bet)
Seat 5: GIJAc9kPrLZHLSX8Q6i99w showed [Td Kh] and won ($12.85) with two pair, Kings and Tens
Seat 6: H8cPaCtX7d6meGUVSM5sxw folded before Flop (didn't bet)
Seat 7: HZkVla4kK2SI42CVrPZ/ig folded before Flop (didn't bet)
Seat 8: viwBDtJsY6JfsFOdBAyJIQ folded before Flop (didn't bet)
Seat 9: pFtzb1sR4b0d1aw6aIRgDg folded before Flop (didn't bet)



PokerStars Game #59940702126:  Hold'em No Limit ($0.25/$0.50) - 2009/07/01 1:14:07 ET
Table '+dXkOAQyS8j9PQZusUTMpg' 2-max Seat #2 is the button
Seat 1: XFa6sBGjP2gxoIvxR3fZIg ($129.20 in chips)
Seat 2: 5IBeOgaApY1Bvzv2P8X4EA ($64.30 in chips)
5IBeOgaApY1Bvzv2P8X4EA: posts small blind $0.25
XFa6sBGjP2gxoIvxR3fZIg: posts big blind $0.50
*** HOLE CARDS ***
5IBeOgaApY1Bvzv2P8X4EA: folds
XFa6sBGjP2gxoIvxR3fZIg collected $0.50 from pot
XFa6sBGjP2gxoIvxR3fZIg: doesn't show hand
*** SUMMARY ***
Total pot $0.50 | Rake $0
Seat 1: XFa6sBGjP2gxoIvxR3fZIg (big blind) collected ($0.50)
Seat 2: 5IBeOgaApY1Bvzv2P8X4EA (button) (small blind) folded before Flop



PokerStars Game #59940703330:  Hold'em No Limit ($0.25/$0.50) - 2009/07/01 1:14:09 ET
Table 'hSTs/dUsYLgJQuF2Onp0MQ' 6-max Seat #5 is the button
Seat 1: 1WUCqNG+p+vfWRTXNu4ljw ($50 in chips)
Seat 2: 6vNxrjjCl6FwfaaymM9jjg ($67.45 in chips)
Seat 3: C3qJBo7uxfFVDluE1lmK2w ($35.35 in chips)
Seat 4: L0aIPg7qefDQjdJo3HCVEA ($9.30 in chips)
Seat 5: IBNygaT1aa9Z1uPdJJilwA ($29.25 in chips)
Seat 6: M1KyQQvVPVuxqTAB8sR/zQ ($89.20 in chips)
M1KyQQvVPVuxqTAB8sR/zQ: posts small blind $0.25
1WUCqNG+p+vfWRTXNu4ljw: posts big blind $0.50
*** HOLE CARDS ***
6vNxrjjCl6FwfaaymM9jjg: folds
C3qJBo7uxfFVDluE1lmK2w: raises $1 to $1.50
6vNxrjjCl6FwfaaymM9jjg is sitting out
L0aIPg7qefDQjdJo3HCVEA: folds
L0aIPg7qefDQjdJo3HCVEA leaves the table
IBNygaT1aa9Z1uPdJJilwA: folds
M1KyQQvVPVuxqTAB8sR/zQ: folds
1WUCqNG+p+vfWRTXNu4ljw: folds
C3qJBo7uxfFVDluE1lmK2w collected $1.25 from pot
*** SUMMARY ***
Total pot $1.25 | Rake $0
Seat 1: 1WUCqNG+p+vfWRTXNu4ljw (big blind) folded before Flop
Seat 2: 6vNxrjjCl6FwfaaymM9jjg folded before Flop (didn't bet)
Seat 3: C3qJBo7uxfFVDluE1lmK2w collected ($1.25)
Seat 4: L0aIPg7qefDQjdJo3HCVEA folded before Flop (didn't bet)
Seat 5: IBNygaT1aa9Z1uPdJJilwA (button) folded before Flop (didn't bet)
Seat 6: M1KyQQvVPVuxqTAB8sR/zQ (small blind) folded before Flop



PokerStars Game #59940703948:  Hold'em No Limit ($0.25/$0.50) - 2009/07/01 1:14:10 ET
Table 'c/CRn+68J3Y8KxD5g1ek2Q' 2-max Seat #2 is the button
Seat 1: 46qCyJ6evTkHo9al5sBMNA ($117.40 in chips)
Seat 2: BypVLsYQt3ePFm2xQL/dOA ($246.55 in chips)
BypVLsYQt3ePFm2xQL/dOA: posts small blind $0.25
46qCyJ6evTkHo9al5sBMNA: posts big blind $0.50
*** HOLE CARDS ***
BypVLsYQt3ePFm2xQL/dOA said, "i go to sliep"
BypVLsYQt3ePFm2xQL/dOA: calls $0.25
46qCyJ6evTkHo9al5sBMNA: checks
*** FLOP *** [As Qd 2h]
46qCyJ6evTkHo9al5sBMNA said, "more 10 min?"
46qCyJ6evTkHo9al5sBMNA: checks
BypVLsYQt3ePFm2xQL/dOA: checks
*** TURN *** [As Qd 2h] [Td]
46qCyJ6evTkHo9al5sBMNA: checks
BypVLsYQt3ePFm2xQL/dOA: checks
*** RIVER *** [As Qd 2h Td] [9h]
46qCyJ6evTkHo9al5sBMNA: checks
BypVLsYQt3ePFm2xQL/dOA: bets $1.50
46qCyJ6evTkHo9al5sBMNA: folds
BypVLsYQt3ePFm2xQL/dOA collected $0.95 from pot
BypVLsYQt3ePFm2xQL/dOA: doesn't show hand
*** SUMMARY ***
Total pot $1 | Rake $0.05
Board [As Qd 2h Td 9h]
Seat 1: 46qCyJ6evTkHo9al5sBMNA (big blind) folded on the River
Seat 2: BypVLsYQt3ePFm2xQL/dOA (button) (small blind) collected ($0.95)



PokerStars Game #59940703662:  Hold'em No Limit ($0.25/$0.50) - 2009/07/01 1:14:10 ET
Table 'PALRfuH85dr5IkDfdv6new' 9-max Seat #9 is the button
Seat 1: v/4aX0ejnaIFK4ftDk2Lyg ($49 in chips)
Seat 2: 1aXjSbrubyQKHeauooF5Wg ($44 in chips)
Seat 3: 50QWoELmpmHFrFIlWMJo9g ($90 in chips)
Seat 4: mZNMJI1mY40XTC0U7GZakA ($57.55 in chips)
Seat 6: ottZQkg1UDWk85BtBzGJzg ($50.10 in chips)
Seat 7: 3NcyXvr39gnK+KbTq7ezyA ($61.75 in chips)
Seat 8: NkS+CseUKx4XHszWq0PXEQ ($76.25 in chips)
Seat 9: viwBDtJsY6JfsFOdBAyJIQ ($8.50 in chips)
v/4aX0ejnaIFK4ftDk2Lyg: posts small blind $0.25
1aXjSbrubyQKHeauooF5Wg: posts big blind $0.50
qEn9ijNGtuyTxamBf07hYg: sits out
*** HOLE CARDS ***
50QWoELmpmHFrFIlWMJo9g: folds
mZNMJI1mY40XTC0U7GZakA: folds
ottZQkg1UDWk85BtBzGJzg: folds
3NcyXvr39gnK+KbTq7ezyA: folds
NkS+CseUKx4XHszWq0PXEQ: calls $0.50
viwBDtJsY6JfsFOdBAyJIQ: raises $2 to $2.50
v/4aX0ejnaIFK4ftDk2Lyg: folds
1aXjSbrubyQKHeauooF5Wg: folds
NkS+CseUKx4XHszWq0PXEQ: folds
viwBDtJsY6JfsFOdBAyJIQ collected $1.75 from pot
*** SUMMARY ***
Total pot $1.75 | Rake $0
Seat 1: v/4aX0ejnaIFK4ftDk2Lyg (small blind) folded before Flop
Seat 2: 1aXjSbrubyQKHeauooF5Wg (big blind) folded before Flop
Seat 3: 50QWoELmpmHFrFIlWMJo9g folded before Flop (didn't bet)
Seat 4: mZNMJI1mY40XTC0U7GZakA folded before Flop (didn't bet)
Seat 6: ottZQkg1UDWk85BtBzGJzg folded before Flop (didn't bet)
Seat 7: 3NcyXvr39gnK+KbTq7ezyA folded before Flop (didn't bet)
Seat 8: NkS+CseUKx4XHszWq0PXEQ folded before Flop
Seat 9: viwBDtJsY6JfsFOdBAyJIQ (button) collected ($1.75)



PokerStars Game #59940705780:  Hold'em No Limit ($0.25/$0.50) - 2009/07/01 1:14:13 ET
Table '+dXkOAQyS8j9PQZusUTMpg' 2-max Seat #1 is the button
Seat 1: XFa6sBGjP2gxoIvxR3fZIg ($129.45 in chips)
Seat 2: 5IBeOgaApY1Bvzv2P8X4EA ($64.05 in chips)
XFa6sBGjP2gxoIvxR3fZIg: posts small blind $0.25
5IBeOgaApY1Bvzv2P8X4EA: posts big blind $0.50
*** HOLE CARDS ***
XFa6sBGjP2gxoIvxR3fZIg: raises $1 to $1.50
5IBeOgaApY1Bvzv2P8X4EA: raises $1.50 to $3
XFa6sBGjP2gxoIvxR3fZIg: calls $1.50
*** FLOP *** [5h Jc Ks]
5IBeOgaApY1Bvzv2P8X4EA: bets $1
XFa6sBGjP2gxoIvxR3fZIg: calls $1
*** TURN *** [5h Jc Ks] [4h]
5IBeOgaApY1Bvzv2P8X4EA: bets $1.50
XFa6sBGjP2gxoIvxR3fZIg: calls $1.50
*** RIVER *** [5h Jc Ks 4h] [6d]
5IBeOgaApY1Bvzv2P8X4EA: bets $2.50
XFa6sBGjP2gxoIvxR3fZIg: folds
5IBeOgaApY1Bvzv2P8X4EA collected $10.50 from pot
5IBeOgaApY1Bvzv2P8X4EA: doesn't show hand
*** SUMMARY ***
Total pot $11 | Rake $0.50
Board [5h Jc Ks 4h 6d]
Seat 1: XFa6sBGjP2gxoIvxR3fZIg (button) (small blind) folded on the River
Seat 2: 5IBeOgaApY1Bvzv2P8X4EA (big blind) collected ($10.50)



PokerStars Game #59940707060:  Hold'em No Limit ($0.25/$0.50) - 2009/07/01 1:14:15 ET
Table '+z1aekfHkpp09pc8F9aViw' 6-max Seat #4 is the button
Seat 1: 7zFtlEn2NxyROFkJdZA/yg ($50 in chips)
Seat 3: uUznlIMFnRUvwrBhYF73KA ($141.15 in chips)
Seat 4: RowCSpSURHTOL/dcjg/Iug ($50.65 in chips)
Seat 5: rplyldNweS6YyMNEALQrug ($49.30 in chips)
Seat 6: GUnvMULl2qFOO1yenu1UBw ($50 in chips)
rplyldNweS6YyMNEALQrug: posts small blind $0.25
GUnvMULl2qFOO1yenu1UBw: posts big blind $0.50
OZ6OtYh5Y53MCH/p0QTn5g: sits out
*** HOLE CARDS ***
7zFtlEn2NxyROFkJdZA/yg: folds
uUznlIMFnRUvwrBhYF73KA: folds
RowCSpSURHTOL/dcjg/Iug: raises $1 to $1.50
rplyldNweS6YyMNEALQrug: folds
GUnvMULl2qFOO1yenu1UBw: folds
RowCSpSURHTOL/dcjg/Iug collected $1.25 from pot
*** SUMMARY ***
Total pot $1.25 | Rake $0
Seat 1: 7zFtlEn2NxyROFkJdZA/yg folded before Flop (didn't bet)
Seat 3: uUznlIMFnRUvwrBhYF73KA folded before Flop (didn't bet)
Seat 4: RowCSpSURHTOL/dcjg/Iug (button) collected ($1.25)
Seat 5: rplyldNweS6YyMNEALQrug (small blind) folded before Flop
Seat 6: GUnvMULl2qFOO1yenu1UBw (big blind) folded before Flop



PokerStars Game #59940706494:  Hold'em No Limit ($0.25/$0.50) - 2009/07/01 1:14:15 ET
Table 'tyR5AZNKV8Aadbrnrnlg7g' 6-max Seat #1 is the button
Seat 1: BgOXYI0yYSN1ULC4FqsNkg ($97.80 in chips)
Seat 2: BAjwVL+zKKd0s0fAWstzQQ ($70.05 in chips)
Seat 3: JFLrYNyQmwPhRQAtoSAuyA ($51.95 in chips)
Seat 4: 4QfsCWthT/vSLirorNXqtg ($76.15 in chips)
Seat 6: 498aWaGsW4uGfuWl+2FCGw ($37.35 in chips)
BAjwVL+zKKd0s0fAWstzQQ: posts small blind $0.25
JFLrYNyQmwPhRQAtoSAuyA: posts big blind $0.50
GUnvMULl2qFOO1yenu1UBw: sits out
*** HOLE CARDS ***
4QfsCWthT/vSLirorNXqtg: folds
498aWaGsW4uGfuWl+2FCGw: calls $0.50
BgOXYI0yYSN1ULC4FqsNkg: raises $0.50 to $1
BAjwVL+zKKd0s0fAWstzQQ: folds
JFLrYNyQmwPhRQAtoSAuyA: folds
498aWaGsW4uGfuWl+2FCGw: calls $0.50
*** FLOP *** [Jh Qs Kd]
498aWaGsW4uGfuWl+2FCGw: bets $2.50
BgOXYI0yYSN1ULC4FqsNkg: folds
498aWaGsW4uGfuWl+2FCGw collected $2.65 from pot
498aWaGsW4uGfuWl+2FCGw: doesn't show hand
*** SUMMARY ***
Total pot $2.75 | Rake $0.10
Board [Jh Qs Kd]
Seat 1: BgOXYI0yYSN1ULC4FqsNkg (button) folded on the Flop
Seat 2: BAjwVL+zKKd0s0fAWstzQQ (small blind) folded before Flop
Seat 3: JFLrYNyQmwPhRQAtoSAuyA (big blind) folded before Flop
Seat 4: 4QfsCWthT/vSLirorNXqtg folded before Flop (didn't bet)
Seat 6: 498aWaGsW4uGfuWl+2FCGw collected ($2.65)



PokerStars Game #59940707760:  Hold'em No Limit ($0.25/$0.50) - 2009/07/01 1:14:17 ET
Table 'Nz0Vr7WMHL2g5Uk7dDZjpw' 9-max Seat #8 is the button
Seat 2: gsyXT42WLEcOS4DdEk2wlw ($30.60 in chips)
Seat 3: hoglu9inkgs6zN573/bJag ($7.60 in chips)
Seat 4: E2518gp4aFz1+kAgmGqeEg ($12.55 in chips)
Seat 5: WGW0DgjBUXs1ylURHG8vnQ ($19.15 in chips)
Seat 6: 997ViqAtWn1FPjJqcffwcA ($59.05 in chips)
Seat 7: KPLH0gELgFe2OuAnhJFI5w ($25.95 in chips)
Seat 8: aoL+R/61Kxmw69ypuPrWAQ ($28.40 in chips)
Seat 9: mSD1pginDsyHG5PDfqzphw ($10 in chips)
mSD1pginDsyHG5PDfqzphw: posts small blind $0.25
gsyXT42WLEcOS4DdEk2wlw: posts big blind $0.50
*** HOLE CARDS ***
hoglu9inkgs6zN573/bJag: calls $0.50
E2518gp4aFz1+kAgmGqeEg: folds
WGW0DgjBUXs1ylURHG8vnQ: folds
997ViqAtWn1FPjJqcffwcA: folds
KPLH0gELgFe2OuAnhJFI5w: folds
aoL+R/61Kxmw69ypuPrWAQ: raises $1 to $1.50
mSD1pginDsyHG5PDfqzphw: folds
gsyXT42WLEcOS4DdEk2wlw: folds
hoglu9inkgs6zN573/bJag: calls $1
*** FLOP *** [6c Tc 3h]
hoglu9inkgs6zN573/bJag: checks
aoL+R/61Kxmw69ypuPrWAQ: bets $4.50
hoglu9inkgs6zN573/bJag: folds
aoL+R/61Kxmw69ypuPrWAQ collected $3.60 from pot
*** SUMMARY ***
Total pot $3.75 | Rake $0.15
Board [6c Tc 3h]
Seat 2: gsyXT42WLEcOS4DdEk2wlw (big blind) folded before Flop
Seat 3: hoglu9inkgs6zN573/bJag folded on the Flop
Seat 4: E2518gp4aFz1+kAgmGqeEg folded before Flop (didn't bet)
Seat 5: WGW0DgjBUXs1ylURHG8vnQ folded before Flop (didn't bet)
Seat 6: 997ViqAtWn1FPjJqcffwcA folded before Flop (didn't bet)
Seat 7: KPLH0gELgFe2OuAnhJFI5w folded before Flop (didn't bet)
Seat 8: aoL+R/61Kxmw69ypuPrWAQ (button) collected ($3.60)
Seat 9: mSD1pginDsyHG5PDfqzphw (small blind) folded before Flop



PokerStars Game #59940708754:  Hold'em No Limit ($0.25/$0.50) - 2009/07/01 1:14:18 ET
Table '8BQGgNetI1NOvWeu3gtMNw' 2-max Seat #1 is the button
Seat 1: bypIyrYcAAifLfhZpGlKLA ($89.15 in chips)
Seat 2: Z4HwehErEwzsv/noQlfUlg ($105.90 in chips)
bypIyrYcAAifLfhZpGlKLA: posts small blind $0.25
Z4HwehErEwzsv/noQlfUlg: posts big blind $0.50
*** HOLE CARDS ***
bypIyrYcAAifLfhZpGlKLA: raises $1 to $1.50
Z4HwehErEwzsv/noQlfUlg: raises $1.50 to $3
bypIyrYcAAifLfhZpGlKLA: calls $1.50
*** FLOP *** [6c 8h 3d]
Z4HwehErEwzsv/noQlfUlg: bets $3
bypIyrYcAAifLfhZpGlKLA: raises $7 to $10
Z4HwehErEwzsv/noQlfUlg: calls $7
*** TURN *** [6c 8h 3d] [Js]
Z4HwehErEwzsv/noQlfUlg: checks
bypIyrYcAAifLfhZpGlKLA: bets $14
Z4HwehErEwzsv/noQlfUlg: calls $14
*** RIVER *** [6c 8h 3d Js] [Jd]
Z4HwehErEwzsv/noQlfUlg: bets $62.10
bypIyrYcAAifLfhZpGlKLA: folds
Z4HwehErEwzsv/noQlfUlg collected $53.50 from pot
Z4HwehErEwzsv/noQlfUlg: doesn't show hand
*** SUMMARY ***
Total pot $54 | Rake $0.50
Board [6c 8h 3d Js Jd]
Seat 1: bypIyrYcAAifLfhZpGlKLA (button) (small blind) folded on the River
Seat 2: Z4HwehErEwzsv/noQlfUlg (big blind) collected ($53.50)



PokerStars Game #59940709930:  Hold'em No Limit ($0.25/$0.50) - 2009/07/01 1:14:20 ET
Table '37qXEp3oe+er5q4CZip9eQ' 6-max Seat #1 is the button
Seat 1: lxIzoHy0RnkfFSODHC2liw ($50 in chips)
Seat 2: LvH4G7n+QSjT6NDaD3cREA ($59.35 in chips)
Seat 3: Rt6KgtZ8YaJoTc3FPim00w ($110.20 in chips)
Seat 4: XsmE8nXMAAMFJbWaJTmHFw ($48.20 in chips)
Seat 5: VOmI0x4dDPnTESZd5B4d1Q ($35.75 in chips)
Seat 6: N50kln4negd8q7Mmoz1j4g ($11.55 in chips)
LvH4G7n+QSjT6NDaD3cREA: posts small blind $0.25
Rt6KgtZ8YaJoTc3FPim00w: posts big blind $0.50
*** HOLE CARDS ***
XsmE8nXMAAMFJbWaJTmHFw: raises $1 to $1.50
VOmI0x4dDPnTESZd5B4d1Q: folds
N50kln4negd8q7Mmoz1j4g: calls $1.50
lxIzoHy0RnkfFSODHC2liw: folds
LvH4G7n+QSjT6NDaD3cREA: folds
Rt6KgtZ8YaJoTc3FPim00w: calls $1
*** FLOP *** [3s 8c 9h]
Rt6KgtZ8YaJoTc3FPim00w: checks
XsmE8nXMAAMFJbWaJTmHFw: bets $2.20
N50kln4negd8q7Mmoz1j4g: folds
Rt6KgtZ8YaJoTc3FPim00w: folds
XsmE8nXMAAMFJbWaJTmHFw collected $4.55 from pot
*** SUMMARY ***
Total pot $4.75 | Rake $0.20
Board [3s 8c 9h]
Seat 1: lxIzoHy0RnkfFSODHC2liw (button) folded before Flop (didn't bet)
Seat 2: LvH4G7n+QSjT6NDaD3cREA (small blind) folded before Flop
Seat 3: Rt6KgtZ8YaJoTc3FPim00w (big blind) folded on the Flop
Seat 4: XsmE8nXMAAMFJbWaJTmHFw collected ($4.55)
Seat 5: VOmI0x4dDPnTESZd5B4d1Q folded before Flop (didn't bet)
Seat 6: N50kln4negd8q7Mmoz1j4g folded on the Flop



PokerStars Game #59940709874:  Hold'em No Limit ($0.25/$0.50) - 2009/07/01 1:14:20 ET
Table 'NCiXr0d5CEKBQr/cZgLhbA' 9-max Seat #7 is the button
Seat 1: pFtzb1sR4b0d1aw6aIRgDg ($50.20 in chips)
Seat 3: xZCXQSXlrZkp3pZizzVXCw ($51.95 in chips)
Seat 4: 5k9fvXD9suIgCxU4HLQjTw ($54.70 in chips)
Seat 5: zE9cVigS2nW/Ljy4K4bUQA ($63.35 in chips)
Seat 7: M+7+BTmX5vZatHVuoRB1nA ($53.40 in chips)
Seat 8: 1MJUKc3cc0QmUoz1JZLR2w ($48.30 in chips)
Seat 9: 4WLZvqBn5qv5tds5kt5A1Q ($55.25 in chips)
1MJUKc3cc0QmUoz1JZLR2w: posts small blind $0.25
4WLZvqBn5qv5tds5kt5A1Q: posts big blind $0.50
AjV5McH1KMMclY26QdLM5w: sits out
*** HOLE CARDS ***
pFtzb1sR4b0d1aw6aIRgDg: folds
xZCXQSXlrZkp3pZizzVXCw: folds
cards4hire joins the table at seat #6
5k9fvXD9suIgCxU4HLQjTw: folds
zE9cVigS2nW/Ljy4K4bUQA: folds
M+7+BTmX5vZatHVuoRB1nA: folds
1MJUKc3cc0QmUoz1JZLR2w: folds
4WLZvqBn5qv5tds5kt5A1Q collected $0.50 from pot
*** SUMMARY ***
Total pot $0.50 | Rake $0
Seat 1: pFtzb1sR4b0d1aw6aIRgDg folded before Flop (didn't bet)
Seat 3: xZCXQSXlrZkp3pZizzVXCw folded before Flop (didn't bet)
Seat 4: 5k9fvXD9suIgCxU4HLQjTw folded before Flop (didn't bet)
Seat 5: zE9cVigS2nW/Ljy4K4bUQA folded before Flop (didn't bet)
Seat 7: M+7+BTmX5vZatHVuoRB1nA (button) folded before Flop (didn't bet)
Seat 8: 1MJUKc3cc0QmUoz1JZLR2w (small blind) folded before Flop
Seat 9: 4WLZvqBn5qv5tds5kt5A1Q (big blind) collected ($0.50)



PokerStars Game #59940710266:  Hold'em No Limit ($0.25/$0.50) - 2009/07/01 1:14:21 ET
Table 'BCN5su+SsXiy1zRMJi0SJw' 6-max Seat #6 is the button
Seat 1: GxXV09ciXaOxyY2H5aMIIw ($55.60 in chips)
Seat 2: oU2kDCkT/gilYbHWrg7D8w ($37.95 in chips)
Seat 3: kwgv5lNhiFrfONXCshzxlA ($27.20 in chips)
Seat 4: 4QfsCWthT/vSLirorNXqtg ($55.75 in chips)
Seat 5: cEMJmfAUQZmMChZe6aacKw ($24.50 in chips)
Seat 6: b2symlOdL7+0c9Pj4N/KlA ($58.15 in chips)
GxXV09ciXaOxyY2H5aMIIw: posts small blind $0.25
oU2kDCkT/gilYbHWrg7D8w: posts big blind $0.50
*** HOLE CARDS ***
kwgv5lNhiFrfONXCshzxlA: calls $0.50
4QfsCWthT/vSLirorNXqtg: folds
cEMJmfAUQZmMChZe6aacKw: folds
b2symlOdL7+0c9Pj4N/KlA: folds
GxXV09ciXaOxyY2H5aMIIw: folds
oU2kDCkT/gilYbHWrg7D8w: raises $1.50 to $2
kwgv5lNhiFrfONXCshzxlA: folds
oU2kDCkT/gilYbHWrg7D8w collected $1.25 from pot
*** SUMMARY ***
Total pot $1.25 | Rake $0
Seat 1: GxXV09ciXaOxyY2H5aMIIw (small blind) folded before Flop
Seat 2: oU2kDCkT/gilYbHWrg7D8w (big blind) collected ($1.25)
Seat 3: kwgv5lNhiFrfONXCshzxlA folded before Flop
Seat 4: 4QfsCWthT/vSLirorNXqtg folded before Flop (didn't bet)
Seat 5: cEMJmfAUQZmMChZe6aacKw folded before Flop (didn't bet)
Seat 6: b2symlOdL7+0c9Pj4N/KlA (button) folded before Flop (didn't bet)



PokerStars Game #59940711136:  Hold'em No Limit ($0.25/$0.50) - 2009/07/01 1:14:22 ET
Table 'QOgaEqMcJ73pcUMMxoisUg' 6-max Seat #1 is the button
Seat 1: lxIzoHy0RnkfFSODHC2liw ($50 in chips)
Seat 2: oqOqoO2AyCZenUghCxMDxw ($61 in chips)
Seat 3: Rt6KgtZ8YaJoTc3FPim00w ($53.75 in chips)
Seat 4: zAcsDhG/T128Vn7XGVSgKg ($59.90 in chips)
Seat 5: 6vNxrjjCl6FwfaaymM9jjg ($17.20 in chips)
Seat 6: AdS8BJMOheS01zjCDfPMFg ($57.70 in chips)
oqOqoO2AyCZenUghCxMDxw: posts small blind $0.25
Rt6KgtZ8YaJoTc3FPim00w: posts big blind $0.50
*** HOLE CARDS ***
zAcsDhG/T128Vn7XGVSgKg: folds
6vNxrjjCl6FwfaaymM9jjg: folds
AdS8BJMOheS01zjCDfPMFg: folds
lxIzoHy0RnkfFSODHC2liw: folds
oqOqoO2AyCZenUghCxMDxw: folds
Rt6KgtZ8YaJoTc3FPim00w collected $0.50 from pot
*** SUMMARY ***
Total pot $0.50 | Rake $0
Seat 1: lxIzoHy0RnkfFSODHC2liw (button) folded before Flop (didn't bet)
Seat 2: oqOqoO2AyCZenUghCxMDxw (small blind) folded before Flop
Seat 3: Rt6KgtZ8YaJoTc3FPim00w (big blind) collected ($0.50)
Seat 4: zAcsDhG/T128Vn7XGVSgKg folded before Flop (didn't bet)
Seat 5: 6vNxrjjCl6FwfaaymM9jjg folded before Flop (didn't bet)
Seat 6: AdS8BJMOheS01zjCDfPMFg folded before Flop (didn't bet)



PokerStars Game #59940711014:  Hold'em No Limit ($0.25/$0.50) - 2009/07/01 1:14:22 ET
Table 'kgbJRsxfv64KrErDRBAkcw' 6-max Seat #6 is the button
Seat 1: VamsyhlFzXGF6/ydo0BHeA ($52.05 in chips)
Seat 2: AdS8BJMOheS01zjCDfPMFg ($51.55 in chips)
Seat 3: c4MNIaIyPMOMxrgT8FT5nA ($188.45 in chips)
Seat 5: eUBBn2R56C1IQ6Cs/vitwg ($50 in chips)
Seat 6: 1b+2BbjMN8qhR1WPqdE9VQ ($50.10 in chips)
VamsyhlFzXGF6/ydo0BHeA: posts small blind $0.25
AdS8BJMOheS01zjCDfPMFg: posts big blind $0.50
*** HOLE CARDS ***
c4MNIaIyPMOMxrgT8FT5nA: raises $1.50 to $2
eUBBn2R56C1IQ6Cs/vitwg: folds
1b+2BbjMN8qhR1WPqdE9VQ: folds
VamsyhlFzXGF6/ydo0BHeA: folds
AdS8BJMOheS01zjCDfPMFg: calls $1.50
*** FLOP *** [8s 5s Ks]
AdS8BJMOheS01zjCDfPMFg: checks
c4MNIaIyPMOMxrgT8FT5nA: bets $4.50
AdS8BJMOheS01zjCDfPMFg: calls $4.50
*** TURN *** [8s 5s Ks] [Kc]
AdS8BJMOheS01zjCDfPMFg: checks
c4MNIaIyPMOMxrgT8FT5nA: bets $9
AdS8BJMOheS01zjCDfPMFg: folds
c4MNIaIyPMOMxrgT8FT5nA collected $12.60 from pot
*** SUMMARY ***
Total pot $13.25 | Rake $0.65
Board [8s 5s Ks Kc]
Seat 1: VamsyhlFzXGF6/ydo0BHeA (small blind) folded before Flop
Seat 2: AdS8BJMOheS01zjCDfPMFg (big blind) folded on the Turn
Seat 3: c4MNIaIyPMOMxrgT8FT5nA collected ($12.60)
Seat 5: eUBBn2R56C1IQ6Cs/vitwg folded before Flop (didn't bet)
Seat 6: 1b+2BbjMN8qhR1WPqdE9VQ (button) folded before Flop (didn't bet)



PokerStars Game #59940713304:  Hold'em No Limit ($0.25/$0.50) - 2009/07/01 1:14:26 ET
Table 'otvGDROEDdqsabxskT79qg' 9-max Seat #3 is the button
Seat 1: 8ehL7qlZzjgUh2H35iiWLw ($59.75 in chips)
Seat 2: cCjTzH9jio8607WzjcfXlg ($14.40 in chips)
Seat 3: +k7T5ocke8UwavtgUHm+Cg ($75.50 in chips)
Seat 4: MG90wfSJZnOejs/KD3vlQQ ($75.40 in chips)
Seat 5: E2518gp4aFz1+kAgmGqeEg ($11.75 in chips)
Seat 6: bxLSulbgr8LmKNjOzw8URg ($56 in chips)
Seat 7: 75K2MXwN65Sjfp1yHd50Hg ($9.25 in chips)
Seat 8: zE9cVigS2nW/Ljy4K4bUQA ($30 in chips)
Seat 9: KcY3X8YpD74Kw1RHkx/g4A ($41.15 in chips)
MG90wfSJZnOejs/KD3vlQQ: posts small blind $0.25
E2518gp4aFz1+kAgmGqeEg: posts big blind $0.50
*** HOLE CARDS ***
bxLSulbgr8LmKNjOzw8URg: folds
75K2MXwN65Sjfp1yHd50Hg: folds
zE9cVigS2nW/Ljy4K4bUQA: folds
KcY3X8YpD74Kw1RHkx/g4A: folds
8ehL7qlZzjgUh2H35iiWLw: folds
cCjTzH9jio8607WzjcfXlg: folds
+k7T5ocke8UwavtgUHm+Cg: calls $0.50
MG90wfSJZnOejs/KD3vlQQ: folds
E2518gp4aFz1+kAgmGqeEg: checks
*** FLOP *** [Ac Td 7s]
E2518gp4aFz1+kAgmGqeEg: checks
+k7T5ocke8UwavtgUHm+Cg: checks
*** TURN *** [Ac Td 7s] [8h]
E2518gp4aFz1+kAgmGqeEg: checks
+k7T5ocke8UwavtgUHm+Cg: checks
*** RIVER *** [Ac Td 7s 8h] [Ks]
E2518gp4aFz1+kAgmGqeEg: checks
+k7T5ocke8UwavtgUHm+Cg: checks
*** SHOW DOWN ***
E2518gp4aFz1+kAgmGqeEg: shows [3c 7c] (a pair of Sevens)
+k7T5ocke8UwavtgUHm+Cg: mucks hand
E2518gp4aFz1+kAgmGqeEg collected $1.20 from pot
*** SUMMARY ***
Total pot $1.25 | Rake $0.05
Board [Ac Td 7s 8h Ks]
Seat 1: 8ehL7qlZzjgUh2H35iiWLw folded before Flop (didn't bet)
Seat 2: cCjTzH9jio8607WzjcfXlg folded before Flop (didn't bet)
Seat 3: +k7T5ocke8UwavtgUHm+Cg (button) mucked
Seat 4: MG90wfSJZnOejs/KD3vlQQ (small blind) folded before Flop
Seat 5: E2518gp4aFz1+kAgmGqeEg (big blind) showed [3c 7c] and won ($1.20) with a pair of Sevens
Seat 6: bxLSulbgr8LmKNjOzw8URg folded before Flop (didn't bet)
Seat 7: 75K2MXwN65Sjfp1yHd50Hg folded before Flop (didn't bet)
Seat 8: zE9cVigS2nW/Ljy4K4bUQA folded before Flop (didn't bet)
Seat 9: KcY3X8YpD74Kw1RHkx/g4A folded before Flop (didn't bet)



PokerStars Game #59940713196:  Hold'em No Limit ($0.25/$0.50) - 2009/07/01 1:14:26 ET
Table 'fx6MqwfYAj/Rt86hBz2L3Q' 9-max Seat #7 is the button
Seat 1: uw9QayAAxLM3Hb+HR7mSkg ($12 in chips)
Seat 2: C3rGXblctNcWI6JYPHhaEg ($35 in chips)
Seat 3: iadBi5AEt7gTBXbDSSnMYQ ($45.40 in chips)
Seat 5: iAISe3dVeua8PUn2wwgDHw ($65.25 in chips)
Seat 6: 5k9fvXD9suIgCxU4HLQjTw ($50 in chips)
Seat 7: SKnJuWHScqetA/qG5p+wCg ($34.95 in chips)
Seat 8: JYwJYYV9pM5KWdSiETl8rA ($29.25 in chips)
Seat 9: rFvc7K/96V9eGvYRfmpoUQ ($20 in chips)
JYwJYYV9pM5KWdSiETl8rA: posts small blind $0.25
rFvc7K/96V9eGvYRfmpoUQ: posts big blind $0.50
*** HOLE CARDS ***
uw9QayAAxLM3Hb+HR7mSkg: raises $11.50 to $12 and is all-in
C3rGXblctNcWI6JYPHhaEg: folds
iadBi5AEt7gTBXbDSSnMYQ: folds
iAISe3dVeua8PUn2wwgDHw: folds
5k9fvXD9suIgCxU4HLQjTw: folds
SKnJuWHScqetA/qG5p+wCg: folds
JYwJYYV9pM5KWdSiETl8rA: folds
rFvc7K/96V9eGvYRfmpoUQ: folds
uw9QayAAxLM3Hb+HR7mSkg collected $1.25 from pot
uw9QayAAxLM3Hb+HR7mSkg: doesn't show hand
*** SUMMARY ***
Total pot $1.25 | Rake $0
Seat 1: uw9QayAAxLM3Hb+HR7mSkg collected ($1.25)
Seat 2: C3rGXblctNcWI6JYPHhaEg folded before Flop (didn't bet)
Seat 3: iadBi5AEt7gTBXbDSSnMYQ folded before Flop (didn't bet)
Seat 5: iAISe3dVeua8PUn2wwgDHw folded before Flop (didn't bet)
Seat 6: 5k9fvXD9suIgCxU4HLQjTw folded before Flop (didn't bet)
Seat 7: SKnJuWHScqetA/qG5p+wCg (button) folded before Flop (didn't bet)
Seat 8: JYwJYYV9pM5KWdSiETl8rA (small blind) folded before Flop
Seat 9: rFvc7K/96V9eGvYRfmpoUQ (big blind) folded before Flop



PokerStars Game #59940714088:  Hold'em No Limit ($0.25/$0.50) - 2009/07/01 1:14:28 ET
Table 'X6IRCRTh+20gjz8aubWnwA' 9-max Seat #2 is the button
Seat 2: HZkVla4kK2SI42CVrPZ/ig ($5.80 in chips)
Seat 3: SWv01peOe69QQRvhQTqjQw ($5.55 in chips)
Seat 4: M3JFBNQ8Bbw3FBZ/18MuXw ($25.70 in chips)
Seat 5: NnQCepdIR/AOUQn1yhYx6Q ($9.25 in chips)
Seat 6: 75K2MXwN65Sjfp1yHd50Hg ($11.70 in chips)
Seat 7: cFHQjKQOOKTUzoilhrXHLg ($15.25 in chips)
Seat 8: HxeBVq06/3Bh/H986sgdbw ($49.25 in chips)
Seat 9: M+7+BTmX5vZatHVuoRB1nA ($43 in chips)
SWv01peOe69QQRvhQTqjQw: posts small blind $0.25
M3JFBNQ8Bbw3FBZ/18MuXw: posts big blind $0.50
E2518gp4aFz1+kAgmGqeEg: sits out
*** HOLE CARDS ***
NnQCepdIR/AOUQn1yhYx6Q: folds
75K2MXwN65Sjfp1yHd50Hg: folds
cFHQjKQOOKTUzoilhrXHLg: folds
HxeBVq06/3Bh/H986sgdbw: folds
M+7+BTmX5vZatHVuoRB1nA: folds
HZkVla4kK2SI42CVrPZ/ig: folds
SWv01peOe69QQRvhQTqjQw: calls $0.25
M3JFBNQ8Bbw3FBZ/18MuXw: checks
*** FLOP *** [3s 8s Tc]
SWv01peOe69QQRvhQTqjQw: checks
M3JFBNQ8Bbw3FBZ/18MuXw: checks
*** TURN *** [3s 8s Tc] [5d]
SWv01peOe69QQRvhQTqjQw: checks
M3JFBNQ8Bbw3FBZ/18MuXw: bets $0.50
SWv01peOe69QQRvhQTqjQw: folds
M3JFBNQ8Bbw3FBZ/18MuXw collected $0.95 from pot
*** SUMMARY ***
Total pot $1 | Rake $0.05
Board [3s 8s Tc 5d]
Seat 2: HZkVla4kK2SI42CVrPZ/ig (button) folded before Flop (didn't bet)
Seat 3: SWv01peOe69QQRvhQTqjQw (small blind) folded on the Turn
Seat 4: M3JFBNQ8Bbw3FBZ/18MuXw (big blind) collected ($0.95)
Seat 5: NnQCepdIR/AOUQn1yhYx6Q folded before Flop (didn't bet)
Seat 6: 75K2MXwN65Sjfp1yHd50Hg folded before Flop (didn't bet)
Seat 7: cFHQjKQOOKTUzoilhrXHLg folded before Flop (didn't bet)
Seat 8: HxeBVq06/3Bh/H986sgdbw folded before Flop (didn't bet)
Seat 9: M+7+BTmX5vZatHVuoRB1nA folded before Flop (didn't bet)



PokerStars Game #59940714098:  Hold'em No Limit ($0.25/$0.50) - 2009/07/01 1:14:28 ET
Table 'EiNh8p/wGJ1FP575iMFnqg' 9-max Seat #2 is the button
Seat 1: r3ZqM1Mi0W3y4hOdssE+Sg ($66.50 in chips)
Seat 2: 8ehL7qlZzjgUh2H35iiWLw ($53.40 in chips)
Seat 3: ymLPoEIl7UL3TvZYmnadxQ ($59.80 in chips)
Seat 4: cMzaiXAM/ZAdNaEUu+LqhA ($50.75 in chips)
Seat 5: M+7+BTmX5vZatHVuoRB1nA ($80.45 in chips)
Seat 6: 3UmXLy3GfjC3EkOebduerQ ($61.60 in chips)
Seat 7: 997ViqAtWn1FPjJqcffwcA ($50 in chips)
Seat 8: mSD1pginDsyHG5PDfqzphw ($10 in chips)
Seat 9: GuPkZObrz5Zkkn8FsEdF9w ($30 in chips)
ymLPoEIl7UL3TvZYmnadxQ: posts small blind $0.25
cMzaiXAM/ZAdNaEUu+LqhA: posts big blind $0.50
*** HOLE CARDS ***
M+7+BTmX5vZatHVuoRB1nA: folds
3UmXLy3GfjC3EkOebduerQ: folds
997ViqAtWn1FPjJqcffwcA: folds
mSD1pginDsyHG5PDfqzphw: folds
GuPkZObrz5Zkkn8FsEdF9w: folds
r3ZqM1Mi0W3y4hOdssE+Sg: folds
8ehL7qlZzjgUh2H35iiWLw: raises $1.50 to $2
ymLPoEIl7UL3TvZYmnadxQ: calls $1.75
cMzaiXAM/ZAdNaEUu+LqhA: folds
*** FLOP *** [Qc 2h 9h]
ymLPoEIl7UL3TvZYmnadxQ: checks
8ehL7qlZzjgUh2H35iiWLw: bets $3
ymLPoEIl7UL3TvZYmnadxQ: calls $3
*** TURN *** [Qc 2h 9h] [6d]
ymLPoEIl7UL3TvZYmnadxQ: checks
8ehL7qlZzjgUh2H35iiWLw: bets $7.25
ymLPoEIl7UL3TvZYmnadxQ: folds
8ehL7qlZzjgUh2H35iiWLw collected $10 from pot
8ehL7qlZzjgUh2H35iiWLw: doesn't show hand
*** SUMMARY ***
Total pot $10.50 | Rake $0.50
Board [Qc 2h 9h 6d]
Seat 1: r3ZqM1Mi0W3y4hOdssE+Sg folded before Flop (didn't bet)
Seat 2: 8ehL7qlZzjgUh2H35iiWLw (button) collected ($10)
Seat 3: ymLPoEIl7UL3TvZYmnadxQ (small blind) folded on the Turn
Seat 4: cMzaiXAM/ZAdNaEUu+LqhA (big blind) folded before Flop
Seat 5: M+7+BTmX5vZatHVuoRB1nA folded before Flop (didn't bet)
Seat 6: 3UmXLy3GfjC3EkOebduerQ folded before Flop (didn't bet)
Seat 7: 997ViqAtWn1FPjJqcffwcA folded before Flop (didn't bet)
Seat 8: mSD1pginDsyHG5PDfqzphw folded before Flop (didn't bet)
Seat 9: GuPkZObrz5Zkkn8FsEdF9w folded before Flop (didn't bet)



PokerStars Game #59940720870:  Hold'em No Limit ($0.25/$0.50) - 2009/07/01 1:14:39 ET
Table 'tyR5AZNKV8Aadbrnrnlg7g' 6-max Seat #2 is the button
Seat 1: BgOXYI0yYSN1ULC4FqsNkg ($96.80 in chips)
Seat 2: BAjwVL+zKKd0s0fAWstzQQ ($69.80 in chips)
Seat 3: JFLrYNyQmwPhRQAtoSAuyA ($51.45 in chips)
Seat 4: 4QfsCWthT/vSLirorNXqtg ($76.15 in chips)
Seat 6: 498aWaGsW4uGfuWl+2FCGw ($39 in chips)
JFLrYNyQmwPhRQAtoSAuyA: posts small blind $0.25
4QfsCWthT/vSLirorNXqtg: posts big blind $0.50
GUnvMULl2qFOO1yenu1UBw: sits out
*** HOLE CARDS ***
498aWaGsW4uGfuWl+2FCGw: folds
BgOXYI0yYSN1ULC4FqsNkg: folds
BAjwVL+zKKd0s0fAWstzQQ: folds
JFLrYNyQmwPhRQAtoSAuyA: folds
4QfsCWthT/vSLirorNXqtg collected $0.50 from pot
4QfsCWthT/vSLirorNXqtg: doesn't show hand
*** SUMMARY ***
Total pot $0.50 | Rake $0
Seat 1: BgOXYI0yYSN1ULC4FqsNkg folded before Flop (didn't bet)
Seat 2: BAjwVL+zKKd0s0fAWstzQQ (button) folded before Flop (didn't bet)
Seat 3: JFLrYNyQmwPhRQAtoSAuyA (small blind) folded before Flop
Seat 4: 4QfsCWthT/vSLirorNXqtg (big blind) collected ($0.50)
Seat 6: 498aWaGsW4uGfuWl+2FCGw folded before Flop (didn't bet)



PokerStars Game #59940722286:  Hold'em No Limit ($0.25/$0.50) - 2009/07/01 1:14:42 ET
Table 'BCN5su+SsXiy1zRMJi0SJw' 6-max Seat #1 is the button
Seat 1: GxXV09ciXaOxyY2H5aMIIw ($55.35 in chips)
Seat 2: oU2kDCkT/gilYbHWrg7D8w ($38.70 in chips)
Seat 3: kwgv5lNhiFrfONXCshzxlA ($26.70 in chips)
Seat 4: 4QfsCWthT/vSLirorNXqtg ($55.75 in chips)
Seat 5: cEMJmfAUQZmMChZe6aacKw ($24.50 in chips)
Seat 6: b2symlOdL7+0c9Pj4N/KlA ($58.15 in chips)
oU2kDCkT/gilYbHWrg7D8w: posts small blind $0.25
kwgv5lNhiFrfONXCshzxlA: posts big blind $0.50
*** HOLE CARDS ***
4QfsCWthT/vSLirorNXqtg: raises $1.50 to $2
cEMJmfAUQZmMChZe6aacKw: folds
b2symlOdL7+0c9Pj4N/KlA: folds
GxXV09ciXaOxyY2H5aMIIw: folds
oU2kDCkT/gilYbHWrg7D8w: folds
kwgv5lNhiFrfONXCshzxlA: calls $1.50
*** FLOP *** [Ts 3c 6s]
kwgv5lNhiFrfONXCshzxlA: checks
4QfsCWthT/vSLirorNXqtg: checks
*** TURN *** [Ts 3c 6s] [5s]
kwgv5lNhiFrfONXCshzxlA: bets $1.50
4QfsCWthT/vSLirorNXqtg: calls $1.50
*** RIVER *** [Ts 3c 6s 5s] [6h]
kwgv5lNhiFrfONXCshzxlA: bets $4.50
4QfsCWthT/vSLirorNXqtg: folds
kwgv5lNhiFrfONXCshzxlA collected $6.90 from pot
kwgv5lNhiFrfONXCshzxlA: doesn't show hand
*** SUMMARY ***
Total pot $7.25 | Rake $0.35
Board [Ts 3c 6s 5s 6h]
Seat 1: GxXV09ciXaOxyY2H5aMIIw (button) folded before Flop (didn't bet)
Seat 2: oU2kDCkT/gilYbHWrg7D8w (small blind) folded before Flop
Seat 3: kwgv5lNhiFrfONXCshzxlA (big blind) collected ($6.90)
Seat 4: 4QfsCWthT/vSLirorNXqtg folded on the River
Seat 5: cEMJmfAUQZmMChZe6aacKw folded before Flop (didn't bet)
Seat 6: b2symlOdL7+0c9Pj4N/KlA folded before Flop (didn't bet)



PokerStars Game #59940724004:  Hold'em No Limit ($0.25/$0.50) - 2009/07/01 1:14:45 ET
Table 'GfL/No5u5PoEnU39lP5pQg' 6-max Seat #6 is the button
Seat 1: 1WUCqNG+p+vfWRTXNu4ljw ($64 in chips)
Seat 2: uVwggSetzp7d+eVgowO3vg ($54.65 in chips)
Seat 3: 4pp9WxhGdbVbxCc9tlu0lw ($32.45 in chips)
Seat 4: r6u7MWSXF30/khcTYkrG9Q ($18.85 in chips)
Seat 5: M1KyQQvVPVuxqTAB8sR/zQ ($52.15 in chips)
Seat 6: kxPhs4ePFqMy52CInAJ2aw ($63.45 in chips)
1WUCqNG+p+vfWRTXNu4ljw: posts small blind $0.25
uVwggSetzp7d+eVgowO3vg: posts big blind $0.50
*** HOLE CARDS ***
4pp9WxhGdbVbxCc9tlu0lw: folds
r6u7MWSXF30/khcTYkrG9Q: folds
M1KyQQvVPVuxqTAB8sR/zQ: folds
kxPhs4ePFqMy52CInAJ2aw: folds
1WUCqNG+p+vfWRTXNu4ljw: folds
uVwggSetzp7d+eVgowO3vg collected $0.50 from pot
*** SUMMARY ***
Total pot $0.50 | Rake $0
Seat 1: 1WUCqNG+p+vfWRTXNu4ljw (small blind) folded before Flop
Seat 2: uVwggSetzp7d+eVgowO3vg (big blind) collected ($0.50)
Seat 3: 4pp9WxhGdbVbxCc9tlu0lw folded before Flop (didn't bet)
Seat 4: r6u7MWSXF30/khcTYkrG9Q folded before Flop (didn't bet)
Seat 5: M1KyQQvVPVuxqTAB8sR/zQ folded before Flop (didn't bet)
Seat 6: kxPhs4ePFqMy52CInAJ2aw (button) folded before Flop (didn't bet)



PokerStars Game #59940724402:  Hold'em No Limit ($0.25/$0.50) - 2009/07/01 1:14:46 ET
Table 'c/CRn+68J3Y8KxD5g1ek2Q' 2-max Seat #1 is the button
Seat 1: 46qCyJ6evTkHo9al5sBMNA ($116.90 in chips)
Seat 2: BypVLsYQt3ePFm2xQL/dOA ($247 in chips)
46qCyJ6evTkHo9al5sBMNA: posts small blind $0.25
BypVLsYQt3ePFm2xQL/dOA: posts big blind $0.50
*** HOLE CARDS ***
46qCyJ6evTkHo9al5sBMNA: raises $1.50 to $2
BypVLsYQt3ePFm2xQL/dOA: calls $1.50
*** FLOP *** [Qs 8s 7s]
BypVLsYQt3ePFm2xQL/dOA: checks
46qCyJ6evTkHo9al5sBMNA: checks
*** TURN *** [Qs 8s 7s] [Kh]
BypVLsYQt3ePFm2xQL/dOA: bets $3
46qCyJ6evTkHo9al5sBMNA: folds
BypVLsYQt3ePFm2xQL/dOA collected $3.80 from pot
BypVLsYQt3ePFm2xQL/dOA: doesn't show hand
*** SUMMARY ***
Total pot $4 | Rake $0.20
Board [Qs 8s 7s Kh]
Seat 1: 46qCyJ6evTkHo9al5sBMNA (button) (small blind) folded on the Turn
Seat 2: BypVLsYQt3ePFm2xQL/dOA (big blind) collected ($3.80)



PokerStars Game #59940726194:  Hold'em No Limit ($0.25/$0.50) - 2009/07/01 1:14:49 ET
Table '5EmHi+fnatGQQShcNmzOZQ' 6-max Seat #4 is the button
Seat 1: My8WkRtGx5FW6rJ1I4R3hg ($43.60 in chips)
Seat 2: bfFjgAtIoAI+pUxUwFt3aQ ($38.95 in chips)
Seat 3: 1mYbhL8CU/QYqfVmFcaHDQ ($6.05 in chips)
Seat 4: 1b+2BbjMN8qhR1WPqdE9VQ ($58.35 in chips)
Seat 5: kxPhs4ePFqMy52CInAJ2aw ($93.35 in chips)
Seat 6: +Pf9jTVizYlIo+woPvptfA ($50 in chips)
kxPhs4ePFqMy52CInAJ2aw: posts small blind $0.25
+Pf9jTVizYlIo+woPvptfA: posts big blind $0.50
*** HOLE CARDS ***
My8WkRtGx5FW6rJ1I4R3hg: calls $0.50
bfFjgAtIoAI+pUxUwFt3aQ: folds
1mYbhL8CU/QYqfVmFcaHDQ: folds
1b+2BbjMN8qhR1WPqdE9VQ: folds
kxPhs4ePFqMy52CInAJ2aw: folds
+Pf9jTVizYlIo+woPvptfA: checks
*** FLOP *** [8d Th 6d]
+Pf9jTVizYlIo+woPvptfA: bets $1.25
My8WkRtGx5FW6rJ1I4R3hg: folds
+Pf9jTVizYlIo+woPvptfA collected $1.20 from pot
+Pf9jTVizYlIo+woPvptfA: doesn't show hand
*** SUMMARY ***
Total pot $1.25 | Rake $0.05
Board [8d Th 6d]
Seat 1: My8WkRtGx5FW6rJ1I4R3hg folded on the Flop
Seat 2: bfFjgAtIoAI+pUxUwFt3aQ folded before Flop (didn't bet)
Seat 3: 1mYbhL8CU/QYqfVmFcaHDQ folded before Flop (didn't bet)
Seat 4: 1b+2BbjMN8qhR1WPqdE9VQ (button) folded before Flop (didn't bet)
Seat 5: kxPhs4ePFqMy52CInAJ2aw (small blind) folded before Flop
Seat 6: +Pf9jTVizYlIo+woPvptfA (big blind) collected ($1.20)



PokerStars Game #59940726480:  Hold'em No Limit ($0.25/$0.50) - 2009/07/01 1:14:49 ET
Table 'tyR5AZNKV8Aadbrnrnlg7g' 6-max Seat #3 is the button
Seat 1: BgOXYI0yYSN1ULC4FqsNkg ($96.80 in chips)
Seat 2: BAjwVL+zKKd0s0fAWstzQQ ($69.80 in chips)
Seat 3: JFLrYNyQmwPhRQAtoSAuyA ($51.20 in chips)
Seat 4: 4QfsCWthT/vSLirorNXqtg ($76.40 in chips)
Seat 5: GUnvMULl2qFOO1yenu1UBw ($50 in chips)
Seat 6: 498aWaGsW4uGfuWl+2FCGw ($39 in chips)
4QfsCWthT/vSLirorNXqtg: posts small blind $0.25
GUnvMULl2qFOO1yenu1UBw: posts big blind $0.50
*** HOLE CARDS ***
498aWaGsW4uGfuWl+2FCGw: calls $0.50
BgOXYI0yYSN1ULC4FqsNkg: calls $0.50
BAjwVL+zKKd0s0fAWstzQQ: folds
JFLrYNyQmwPhRQAtoSAuyA: folds
4QfsCWthT/vSLirorNXqtg: folds
GUnvMULl2qFOO1yenu1UBw: checks
*** FLOP *** [6d 4s 4c]
GUnvMULl2qFOO1yenu1UBw: checks
498aWaGsW4uGfuWl+2FCGw: checks
BgOXYI0yYSN1ULC4FqsNkg: checks
*** TURN *** [6d 4s 4c] [6h]
GUnvMULl2qFOO1yenu1UBw: checks
498aWaGsW4uGfuWl+2FCGw: checks
BgOXYI0yYSN1ULC4FqsNkg: bets $0.50
GUnvMULl2qFOO1yenu1UBw: folds
498aWaGsW4uGfuWl+2FCGw: calls $0.50
*** RIVER *** [6d 4s 4c 6h] [Ks]
498aWaGsW4uGfuWl+2FCGw: checks
BgOXYI0yYSN1ULC4FqsNkg: bets $0.50
498aWaGsW4uGfuWl+2FCGw: raises $3.50 to $4
BgOXYI0yYSN1ULC4FqsNkg: folds
498aWaGsW4uGfuWl+2FCGw collected $3.60 from pot
498aWaGsW4uGfuWl+2FCGw: doesn't show hand
*** SUMMARY ***
Total pot $3.75 | Rake $0.15
Board [6d 4s 4c 6h Ks]
Seat 1: BgOXYI0yYSN1ULC4FqsNkg folded on the River
Seat 2: BAjwVL+zKKd0s0fAWstzQQ folded before Flop (didn't bet)
Seat 3: JFLrYNyQmwPhRQAtoSAuyA (button) folded before Flop (didn't bet)
Seat 4: 4QfsCWthT/vSLirorNXqtg (small blind) folded before Flop
Seat 5: GUnvMULl2qFOO1yenu1UBw (big blind) folded on the Turn
Seat 6: 498aWaGsW4uGfuWl+2FCGw collected ($3.60)



PokerStars Game #59940726708:  Hold'em No Limit ($0.25/$0.50) - 2009/07/01 1:14:50 ET
Table '+dXkOAQyS8j9PQZusUTMpg' 2-max Seat #2 is the button
Seat 1: XFa6sBGjP2gxoIvxR3fZIg ($123.95 in chips)
Seat 2: 5IBeOgaApY1Bvzv2P8X4EA ($69.05 in chips)
5IBeOgaApY1Bvzv2P8X4EA: posts small blind $0.25
XFa6sBGjP2gxoIvxR3fZIg: posts big blind $0.50
*** HOLE CARDS ***
5IBeOgaApY1Bvzv2P8X4EA: folds
XFa6sBGjP2gxoIvxR3fZIg collected $0.50 from pot
*** SUMMARY ***
Total pot $0.50 | Rake $0
Seat 1: XFa6sBGjP2gxoIvxR3fZIg (big blind) collected ($0.50)
Seat 2: 5IBeOgaApY1Bvzv2P8X4EA (button) (small blind) folded before Flop



PokerStars Game #59940727208:  Hold'em No Limit ($0.25/$0.50) - 2009/07/01 1:14:50 ET
Table 'lpxYasB1ClBSgTpCCITwhQ' 9-max Seat #8 is the button
Seat 1: mj7PS7wCH4PAl7+eYTFs7A ($49.25 in chips)
Seat 2: OWP/DOu+PlPK6ZZ3zYa0HA ($25.85 in chips)
Seat 3: sakr/FIfFtIZwDPmAj5Pzg ($49.20 in chips)
Seat 4: NnQCepdIR/AOUQn1yhYx6Q ($9.25 in chips)
Seat 6: SegjDnMxWMujiD57ESNL+g ($7.10 in chips)
Seat 7: bmRtaIYKthN1F+B3JLZ3Jw ($74.10 in chips)
Seat 8: /mfensKw8/iZ1Vrx33S4xg ($11.50 in chips)
Seat 9: sUIUZ+begh92dzkUmvbMrw ($24.90 in chips)
sUIUZ+begh92dzkUmvbMrw: posts small blind $0.25
mj7PS7wCH4PAl7+eYTFs7A: posts big blind $0.50
*** HOLE CARDS ***
OWP/DOu+PlPK6ZZ3zYa0HA: folds
sakr/FIfFtIZwDPmAj5Pzg: folds
NnQCepdIR/AOUQn1yhYx6Q: folds
SegjDnMxWMujiD57ESNL+g: folds
bmRtaIYKthN1F+B3JLZ3Jw: folds
/mfensKw8/iZ1Vrx33S4xg: folds
sUIUZ+begh92dzkUmvbMrw: folds
mj7PS7wCH4PAl7+eYTFs7A collected $0.50 from pot
mj7PS7wCH4PAl7+eYTFs7A: doesn't show hand
*** SUMMARY ***
Total pot $0.50 | Rake $0
Seat 1: mj7PS7wCH4PAl7+eYTFs7A (big blind) collected ($0.50)
Seat 2: OWP/DOu+PlPK6ZZ3zYa0HA folded before Flop (didn't bet)
Seat 3: sakr/FIfFtIZwDPmAj5Pzg folded before Flop (didn't bet)
Seat 4: NnQCepdIR/AOUQn1yhYx6Q folded before Flop (didn't bet)
Seat 6: SegjDnMxWMujiD57ESNL+g folded before Flop (didn't bet)
Seat 7: bmRtaIYKthN1F+B3JLZ3Jw folded before Flop (didn't bet)
Seat 8: /mfensKw8/iZ1Vrx33S4xg (button) folded before Flop (didn't bet)
Seat 9: sUIUZ+begh92dzkUmvbMrw (small blind) folded before Flop



PokerStars Game #59940728174:  Hold'em No Limit ($0.25/$0.50) - 2009/07/01 1:14:52 ET
Table 'QOgaEqMcJ73pcUMMxoisUg' 6-max Seat #2 is the button
Seat 1: lxIzoHy0RnkfFSODHC2liw ($50 in chips)
Seat 2: oqOqoO2AyCZenUghCxMDxw ($60.75 in chips)
Seat 3: Rt6KgtZ8YaJoTc3FPim00w ($54 in chips)
Seat 4: zAcsDhG/T128Vn7XGVSgKg ($59.90 in chips)
Seat 5: 6vNxrjjCl6FwfaaymM9jjg ($17.20 in chips)
Seat 6: AdS8BJMOheS01zjCDfPMFg ($57.70 in chips)
Rt6KgtZ8YaJoTc3FPim00w: posts small blind $0.25
zAcsDhG/T128Vn7XGVSgKg: posts big blind $0.50
*** HOLE CARDS ***
6vNxrjjCl6FwfaaymM9jjg: folds
6vNxrjjCl6FwfaaymM9jjg is sitting out
AdS8BJMOheS01zjCDfPMFg: folds
lxIzoHy0RnkfFSODHC2liw: folds
oqOqoO2AyCZenUghCxMDxw: raises $1 to $1.50
Rt6KgtZ8YaJoTc3FPim00w: folds
zAcsDhG/T128Vn7XGVSgKg: folds
oqOqoO2AyCZenUghCxMDxw collected $1.25 from pot
*** SUMMARY ***
Total pot $1.25 | Rake $0
Seat 1: lxIzoHy0RnkfFSODHC2liw folded before Flop (didn't bet)
Seat 2: oqOqoO2AyCZenUghCxMDxw (button) collected ($1.25)
Seat 3: Rt6KgtZ8YaJoTc3FPim00w (small blind) folded before Flop
Seat 4: zAcsDhG/T128Vn7XGVSgKg (big blind) folded before Flop
Seat 5: 6vNxrjjCl6FwfaaymM9jjg folded before Flop (didn't bet)
Seat 6: AdS8BJMOheS01zjCDfPMFg folded before Flop (didn't bet)



PokerStars Game #59940728604:  Hold'em No Limit ($0.25/$0.50) - 2009/07/01 1:14:53 ET
Table '+z1aekfHkpp09pc8F9aViw' 6-max Seat #5 is the button
Seat 1: 7zFtlEn2NxyROFkJdZA/yg ($50 in chips)
Seat 3: uUznlIMFnRUvwrBhYF73KA ($141.15 in chips)
Seat 4: RowCSpSURHTOL/dcjg/Iug ($51.40 in chips)
Seat 5: rplyldNweS6YyMNEALQrug ($49.05 in chips)
Seat 6: GUnvMULl2qFOO1yenu1UBw ($50 in chips)
GUnvMULl2qFOO1yenu1UBw: posts small blind $0.25
7zFtlEn2NxyROFkJdZA/yg: posts big blind $0.50
OZ6OtYh5Y53MCH/p0QTn5g: sits out
*** HOLE CARDS ***
uUznlIMFnRUvwrBhYF73KA: calls $0.50
RowCSpSURHTOL/dcjg/Iug: calls $0.50
rplyldNweS6YyMNEALQrug: folds
GUnvMULl2qFOO1yenu1UBw: folds
7zFtlEn2NxyROFkJdZA/yg: checks
*** FLOP *** [2s Td 7d]
7zFtlEn2NxyROFkJdZA/yg: checks
uUznlIMFnRUvwrBhYF73KA: checks
RowCSpSURHTOL/dcjg/Iug: bets $1.50
7zFtlEn2NxyROFkJdZA/yg: folds
uUznlIMFnRUvwrBhYF73KA: folds
RowCSpSURHTOL/dcjg/Iug collected $1.70 from pot
*** SUMMARY ***
Total pot $1.75 | Rake $0.05
Board [2s Td 7d]
Seat 1: 7zFtlEn2NxyROFkJdZA/yg (big blind) folded on the Flop
Seat 3: uUznlIMFnRUvwrBhYF73KA folded on the Flop
Seat 4: RowCSpSURHTOL/dcjg/Iug collected ($1.70)
Seat 5: rplyldNweS6YyMNEALQrug (button) folded before Flop (didn't bet)
Seat 6: GUnvMULl2qFOO1yenu1UBw (small blind) folded before Flop



PokerStars Game #59940730552:  Hold'em No Limit ($0.25/$0.50) - 2009/07/01 1:14:56 ET
Table 'fx6MqwfYAj/Rt86hBz2L3Q' 9-max Seat #8 is the button
Seat 2: C3rGXblctNcWI6JYPHhaEg ($35 in chips)
Seat 3: iadBi5AEt7gTBXbDSSnMYQ ($45.40 in chips)
Seat 5: iAISe3dVeua8PUn2wwgDHw ($65.25 in chips)
Seat 6: 5k9fvXD9suIgCxU4HLQjTw ($50 in chips)
Seat 7: SKnJuWHScqetA/qG5p+wCg ($34.95 in chips)
Seat 8: JYwJYYV9pM5KWdSiETl8rA ($29 in chips)
Seat 9: rFvc7K/96V9eGvYRfmpoUQ ($19.50 in chips)
rFvc7K/96V9eGvYRfmpoUQ: posts small blind $0.25
uw9QayAAxLM3Hb+HR7mSkg: is sitting out
C3rGXblctNcWI6JYPHhaEg: posts big blind $0.50
*** HOLE CARDS ***
iadBi5AEt7gTBXbDSSnMYQ: raises $0.50 to $1
uw9QayAAxLM3Hb+HR7mSkg leaves the table
iAISe3dVeua8PUn2wwgDHw: folds
5k9fvXD9suIgCxU4HLQjTw: folds
SKnJuWHScqetA/qG5p+wCg: folds
v/4aX0ejnaIFK4ftDk2Lyg joins the table at seat #1
JYwJYYV9pM5KWdSiETl8rA: raises $4 to $5
rFvc7K/96V9eGvYRfmpoUQ: folds
C3rGXblctNcWI6JYPHhaEg: folds
iadBi5AEt7gTBXbDSSnMYQ: calls $4
*** FLOP *** [5h 7c 2h]
rFvc7K/96V9eGvYRfmpoUQ leaves the table
iadBi5AEt7gTBXbDSSnMYQ: bets $2.50
JYwJYYV9pM5KWdSiETl8rA: folds
iadBi5AEt7gTBXbDSSnMYQ collected $10.25 from pot
*** SUMMARY ***
Total pot $10.75 | Rake $0.50
Board [5h 7c 2h]
Seat 2: C3rGXblctNcWI6JYPHhaEg (big blind) folded before Flop
Seat 3: iadBi5AEt7gTBXbDSSnMYQ collected ($10.25)
Seat 5: iAISe3dVeua8PUn2wwgDHw folded before Flop (didn't bet)
Seat 6: 5k9fvXD9suIgCxU4HLQjTw folded before Flop (didn't bet)
Seat 7: SKnJuWHScqetA/qG5p+wCg folded before Flop (didn't bet)
Seat 8: JYwJYYV9pM5KWdSiETl8rA (button) folded on the Flop
Seat 9: rFvc7K/96V9eGvYRfmpoUQ (small blind) folded before Flop



PokerStars Game #59940730588:  Hold'em No Limit ($0.25/$0.50) - 2009/07/01 1:14:56 ET
Table '+dXkOAQyS8j9PQZusUTMpg' 2-max Seat #1 is the button
Seat 1: XFa6sBGjP2gxoIvxR3fZIg ($124.20 in chips)
Seat 2: 5IBeOgaApY1Bvzv2P8X4EA ($68.80 in chips)
XFa6sBGjP2gxoIvxR3fZIg: posts small blind $0.25
5IBeOgaApY1Bvzv2P8X4EA: posts big blind $0.50
*** HOLE CARDS ***
XFa6sBGjP2gxoIvxR3fZIg: raises $1 to $1.50
5IBeOgaApY1Bvzv2P8X4EA: folds
XFa6sBGjP2gxoIvxR3fZIg collected $1 from pot
XFa6sBGjP2gxoIvxR3fZIg: doesn't show hand
*** SUMMARY ***
Total pot $1 | Rake $0
Seat 1: XFa6sBGjP2gxoIvxR3fZIg (button) (small blind) collected ($1)
Seat 2: 5IBeOgaApY1Bvzv2P8X4EA (big blind) folded before Flop



PokerStars Game #59940732478:  Hold'em No Limit ($0.25/$0.50) - 2009/07/01 1:14:59 ET
Table 'GfL/No5u5PoEnU39lP5pQg' 6-max Seat #1 is the button
Seat 1: 1WUCqNG+p+vfWRTXNu4ljw ($63.75 in chips)
Seat 2: uVwggSetzp7d+eVgowO3vg ($54.90 in chips)
Seat 3: 4pp9WxhGdbVbxCc9tlu0lw ($32.45 in chips)
Seat 4: r6u7MWSXF30/khcTYkrG9Q ($18.85 in chips)
Seat 5: M1KyQQvVPVuxqTAB8sR/zQ ($52.15 in chips)
Seat 6: kxPhs4ePFqMy52CInAJ2aw ($63.45 in chips)
uVwggSetzp7d+eVgowO3vg: posts small blind $0.25
4pp9WxhGdbVbxCc9tlu0lw: posts big blind $0.50
*** HOLE CARDS ***
r6u7MWSXF30/khcTYkrG9Q: raises $1 to $1.50
M1KyQQvVPVuxqTAB8sR/zQ: calls $1.50
kxPhs4ePFqMy52CInAJ2aw: folds
1WUCqNG+p+vfWRTXNu4ljw: folds
uVwggSetzp7d+eVgowO3vg: folds
4pp9WxhGdbVbxCc9tlu0lw: folds
*** FLOP *** [Ad Ac 8c]
r6u7MWSXF30/khcTYkrG9Q: bets $2
M1KyQQvVPVuxqTAB8sR/zQ: folds
r6u7MWSXF30/khcTYkrG9Q collected $3.60 from pot
*** SUMMARY ***
Total pot $3.75 | Rake $0.15
Board [Ad Ac 8c]
Seat 1: 1WUCqNG+p+vfWRTXNu4ljw (button) folded before Flop (didn't bet)
Seat 2: uVwggSetzp7d+eVgowO3vg (small blind) folded before Flop
Seat 3: 4pp9WxhGdbVbxCc9tlu0lw (big blind) folded before Flop
Seat 4: r6u7MWSXF30/khcTYkrG9Q collected ($3.60)
Seat 5: M1KyQQvVPVuxqTAB8sR/zQ folded on the Flop
Seat 6: kxPhs4ePFqMy52CInAJ2aw folded before Flop (didn't bet)



PokerStars Game #59940732408:  Hold'em No Limit ($0.25/$0.50) - 2009/07/01 1:14:59 ET
Table 'lSisgp6H7Fg1hH5VfjEjYQ' 9-max Seat #4 is the button
Seat 1: 5k9fvXD9suIgCxU4HLQjTw ($50 in chips)
Seat 2: UrcnkQOiLVk8BlKDPJSy7Q ($77.90 in chips)
Seat 3: aTkyjTh3w5YLWiIERupZOA ($46.40 in chips)
Seat 4: bwv/rbH/hHhPhY6u9mu04w ($34.35 in chips)
Seat 5: mSD1pginDsyHG5PDfqzphw ($13.25 in chips)
Seat 6: +k7T5ocke8UwavtgUHm+Cg ($65.40 in chips)
Seat 7: IDtNLR9uFCDdjNsJWMHA5Q ($22.05 in chips)
Seat 8: a4JDWmpFQkL10XfAyuF51A ($25.75 in chips)
Seat 9: YzeKFbJVLmJGTgNH3ySQlw ($11.45 in chips)
mSD1pginDsyHG5PDfqzphw: posts small blind $0.25
+k7T5ocke8UwavtgUHm+Cg: posts big blind $0.50
*** HOLE CARDS ***
IDtNLR9uFCDdjNsJWMHA5Q: folds
a4JDWmpFQkL10XfAyuF51A: raises $1.50 to $2
YzeKFbJVLmJGTgNH3ySQlw: folds
5k9fvXD9suIgCxU4HLQjTw: folds
UrcnkQOiLVk8BlKDPJSy7Q: folds
aTkyjTh3w5YLWiIERupZOA: raises $2 to $4
bwv/rbH/hHhPhY6u9mu04w: folds
mSD1pginDsyHG5PDfqzphw: folds
+k7T5ocke8UwavtgUHm+Cg: folds
a4JDWmpFQkL10XfAyuF51A: calls $2
*** FLOP *** [2h 5h 7h]
a4JDWmpFQkL10XfAyuF51A: checks
aTkyjTh3w5YLWiIERupZOA: bets $5.50
a4JDWmpFQkL10XfAyuF51A: calls $5.50
*** TURN *** [2h 5h 7h] [9c]
a4JDWmpFQkL10XfAyuF51A: checks
aTkyjTh3w5YLWiIERupZOA: checks
*** RIVER *** [2h 5h 7h 9c] [As]
a4JDWmpFQkL10XfAyuF51A: checks
aTkyjTh3w5YLWiIERupZOA: checks
*** SHOW DOWN ***
a4JDWmpFQkL10XfAyuF51A: shows [Qs Qd] (a pair of Queens)
aTkyjTh3w5YLWiIERupZOA: shows [Ks Kd] (a pair of Kings)
aTkyjTh3w5YLWiIERupZOA collected $18.80 from pot
*** SUMMARY ***
Total pot $19.75 | Rake $0.95
Board [2h 5h 7h 9c As]
Seat 1: 5k9fvXD9suIgCxU4HLQjTw folded before Flop (didn't bet)
Seat 2: UrcnkQOiLVk8BlKDPJSy7Q folded before Flop (didn't bet)
Seat 3: aTkyjTh3w5YLWiIERupZOA showed [Ks Kd] and won ($18.80) with a pair of Kings
Seat 4: bwv/rbH/hHhPhY6u9mu04w (button) folded before Flop (didn't bet)
Seat 5: mSD1pginDsyHG5PDfqzphw (small blind) folded before Flop
Seat 6: +k7T5ocke8UwavtgUHm+Cg (big blind) folded before Flop
Seat 7: IDtNLR9uFCDdjNsJWMHA5Q folded before Flop (didn't bet)
Seat 8: a4JDWmpFQkL10XfAyuF51A showed [Qs Qd] and lost with a pair of Queens
Seat 9: YzeKFbJVLmJGTgNH3ySQlw folded before Flop (didn't bet)



PokerStars Game #59940734136:  Hold'em No Limit ($0.25/$0.50) - 2009/07/01 1:15:02 ET
Table 'otvGDROEDdqsabxskT79qg' 9-max Seat #4 is the button
Seat 1: 8ehL7qlZzjgUh2H35iiWLw ($59.75 in chips)
Seat 2: cCjTzH9jio8607WzjcfXlg ($14.40 in chips)
Seat 3: +k7T5ocke8UwavtgUHm+Cg ($75 in chips)
Seat 4: MG90wfSJZnOejs/KD3vlQQ ($75.15 in chips)
Seat 5: E2518gp4aFz1+kAgmGqeEg ($12.45 in chips)
Seat 6: bxLSulbgr8LmKNjOzw8URg ($56 in chips)
Seat 7: 75K2MXwN65Sjfp1yHd50Hg ($9.25 in chips)
Seat 8: zE9cVigS2nW/Ljy4K4bUQA ($30 in chips)
Seat 9: KcY3X8YpD74Kw1RHkx/g4A ($41.15 in chips)
E2518gp4aFz1+kAgmGqeEg: posts small blind $0.25
bxLSulbgr8LmKNjOzw8URg: posts big blind $0.50
*** HOLE CARDS ***
75K2MXwN65Sjfp1yHd50Hg: raises $1.50 to $2
zE9cVigS2nW/Ljy4K4bUQA: folds
KcY3X8YpD74Kw1RHkx/g4A: folds
8ehL7qlZzjgUh2H35iiWLw: folds
cCjTzH9jio8607WzjcfXlg: folds
+k7T5ocke8UwavtgUHm+Cg: folds
MG90wfSJZnOejs/KD3vlQQ: folds
E2518gp4aFz1+kAgmGqeEg: folds
bxLSulbgr8LmKNjOzw8URg: folds
75K2MXwN65Sjfp1yHd50Hg collected $1.25 from pot
75K2MXwN65Sjfp1yHd50Hg: doesn't show hand
*** SUMMARY ***
Total pot $1.25 | Rake $0
Seat 1: 8ehL7qlZzjgUh2H35iiWLw folded before Flop (didn't bet)
Seat 2: cCjTzH9jio8607WzjcfXlg folded before Flop (didn't bet)
Seat 3: +k7T5ocke8UwavtgUHm+Cg folded before Flop (didn't bet)
Seat 4: MG90wfSJZnOejs/KD3vlQQ (button) folded before Flop (didn't bet)
Seat 5: E2518gp4aFz1+kAgmGqeEg (small blind) folded before Flop
Seat 6: bxLSulbgr8LmKNjOzw8URg (big blind) folded before Flop
Seat 7: 75K2MXwN65Sjfp1yHd50Hg collected ($1.25)
Seat 8: zE9cVigS2nW/Ljy4K4bUQA folded before Flop (didn't bet)
Seat 9: KcY3X8YpD74Kw1RHkx/g4A folded before Flop (didn't bet)



PokerStars Game #59940734214:  Hold'em No Limit ($0.25/$0.50) - 2009/07/01 1:15:02 ET
Table 'hSTs/dUsYLgJQuF2Onp0MQ' 6-max Seat #6 is the button
Seat 1: 1WUCqNG+p+vfWRTXNu4ljw ($50 in chips)
Seat 3: C3qJBo7uxfFVDluE1lmK2w ($36.10 in chips)
Seat 5: IBNygaT1aa9Z1uPdJJilwA ($29.25 in chips)
Seat 6: M1KyQQvVPVuxqTAB8sR/zQ ($88.95 in chips)
1WUCqNG+p+vfWRTXNu4ljw: posts small blind $0.25
C3qJBo7uxfFVDluE1lmK2w: posts big blind $0.50
*** HOLE CARDS ***
IBNygaT1aa9Z1uPdJJilwA: folds
M1KyQQvVPVuxqTAB8sR/zQ: folds
1WUCqNG+p+vfWRTXNu4ljw: raises $1.50 to $2
C3qJBo7uxfFVDluE1lmK2w: folds
1WUCqNG+p+vfWRTXNu4ljw collected $1 from pot
*** SUMMARY ***
Total pot $1 | Rake $0
Seat 1: 1WUCqNG+p+vfWRTXNu4ljw (small blind) collected ($1)
Seat 3: C3qJBo7uxfFVDluE1lmK2w (big blind) folded before Flop
Seat 5: IBNygaT1aa9Z1uPdJJilwA folded before Flop (didn't bet)
Seat 6: M1KyQQvVPVuxqTAB8sR/zQ (button) folded before Flop (didn't bet)



PokerStars Game #59940735078:  Hold'em No Limit ($0.25/$0.50) - 2009/07/01 1:15:04 ET
Table '+dXkOAQyS8j9PQZusUTMpg' 2-max Seat #2 is the button
Seat 1: XFa6sBGjP2gxoIvxR3fZIg ($124.70 in chips)
Seat 2: 5IBeOgaApY1Bvzv2P8X4EA ($68.30 in chips)
5IBeOgaApY1Bvzv2P8X4EA: posts small blind $0.25
XFa6sBGjP2gxoIvxR3fZIg: posts big blind $0.50
*** HOLE CARDS ***
5IBeOgaApY1Bvzv2P8X4EA: folds
5IBeOgaApY1Bvzv2P8X4EA said, "well, good to play with you i have to go nice to meet you"
XFa6sBGjP2gxoIvxR3fZIg collected $0.50 from pot
*** SUMMARY ***
Total pot $0.50 | Rake $0
Seat 1: XFa6sBGjP2gxoIvxR3fZIg (big blind) collected ($0.50)
Seat 2: 5IBeOgaApY1Bvzv2P8X4EA (button) (small blind) folded before Flop



PokerStars Game #59940736178:  Hold'em No Limit ($0.25/$0.50) - 2009/07/01 1:15:06 ET
Table 'c/CRn+68J3Y8KxD5g1ek2Q' 2-max Seat #2 is the button
Seat 1: 46qCyJ6evTkHo9al5sBMNA ($114.90 in chips)
Seat 2: BypVLsYQt3ePFm2xQL/dOA ($248.80 in chips)
BypVLsYQt3ePFm2xQL/dOA: posts small blind $0.25
46qCyJ6evTkHo9al5sBMNA: posts big blind $0.50
*** HOLE CARDS ***
BypVLsYQt3ePFm2xQL/dOA: calls $0.25
46qCyJ6evTkHo9al5sBMNA: raises $1 to $1.50
BypVLsYQt3ePFm2xQL/dOA said, "hm"
BypVLsYQt3ePFm2xQL/dOA: calls $1
*** FLOP *** [7d 4h As]
46qCyJ6evTkHo9al5sBMNA: checks
BypVLsYQt3ePFm2xQL/dOA: checks
*** TURN *** [7d 4h As] [2d]
46qCyJ6evTkHo9al5sBMNA: checks
BypVLsYQt3ePFm2xQL/dOA: checks
*** RIVER *** [7d 4h As 2d] [5s]
46qCyJ6evTkHo9al5sBMNA: checks
BypVLsYQt3ePFm2xQL/dOA: checks
*** SHOW DOWN ***
46qCyJ6evTkHo9al5sBMNA: shows [Jd 9h] (high card Ace)
BypVLsYQt3ePFm2xQL/dOA: shows [5h 6s] (a pair of Fives)
BypVLsYQt3ePFm2xQL/dOA collected $2.85 from pot
*** SUMMARY ***
Total pot $3 | Rake $0.15
Board [7d 4h As 2d 5s]
Seat 1: 46qCyJ6evTkHo9al5sBMNA (big blind) showed [Jd 9h] and lost with high card Ace
Seat 2: BypVLsYQt3ePFm2xQL/dOA (button) (small blind) showed [5h 6s] and won ($2.85) with a pair of Fives



PokerStars Game #59940736336:  Hold'em No Limit ($0.25/$0.50) - 2009/07/01 1:15:06 ET
Table '37qXEp3oe+er5q4CZip9eQ' 6-max Seat #2 is the button
Seat 1: lxIzoHy0RnkfFSODHC2liw ($50 in chips)
Seat 2: LvH4G7n+QSjT6NDaD3cREA ($59.10 in chips)
Seat 3: Rt6KgtZ8YaJoTc3FPim00w ($108.70 in chips)
Seat 4: XsmE8nXMAAMFJbWaJTmHFw ($51.25 in chips)
Seat 5: VOmI0x4dDPnTESZd5B4d1Q ($35.75 in chips)
Seat 6: N50kln4negd8q7Mmoz1j4g ($10.05 in chips)
Rt6KgtZ8YaJoTc3FPim00w: posts small blind $0.25
XsmE8nXMAAMFJbWaJTmHFw: posts big blind $0.50
*** HOLE CARDS ***
VOmI0x4dDPnTESZd5B4d1Q: folds
N50kln4negd8q7Mmoz1j4g: raises $1.50 to $2
lxIzoHy0RnkfFSODHC2liw: folds
LvH4G7n+QSjT6NDaD3cREA: folds
Rt6KgtZ8YaJoTc3FPim00w: folds
XsmE8nXMAAMFJbWaJTmHFw: raises $1.50 to $3.50
N50kln4negd8q7Mmoz1j4g: raises $6.55 to $10.05 and is all-in
XsmE8nXMAAMFJbWaJTmHFw: calls $6.55
*** FLOP *** [7h 5s Qc]
*** TURN *** [7h 5s Qc] [7d]
*** RIVER *** [7h 5s Qc 7d] [Ah]
*** SHOW DOWN ***
XsmE8nXMAAMFJbWaJTmHFw: shows [Ad As] (a full house, Aces full of Sevens)
N50kln4negd8q7Mmoz1j4g: mucks hand
XsmE8nXMAAMFJbWaJTmHFw collected $19.35 from pot
*** SUMMARY ***
Total pot $20.35 | Rake $1
Board [7h 5s Qc 7d Ah]
Seat 1: lxIzoHy0RnkfFSODHC2liw folded before Flop (didn't bet)
Seat 2: LvH4G7n+QSjT6NDaD3cREA (button) folded before Flop (didn't bet)
Seat 3: Rt6KgtZ8YaJoTc3FPim00w (small blind) folded before Flop
Seat 4: XsmE8nXMAAMFJbWaJTmHFw (big blind) showed [Ad As] and won ($19.35) with a full house, Aces full of Sevens
Seat 5: VOmI0x4dDPnTESZd5B4d1Q folded before Flop (didn't bet)
Seat 6: N50kln4negd8q7Mmoz1j4g mucked



PokerStars Game #59940736186:  Hold'em No Limit ($0.25/$0.50) - 2009/07/01 1:15:06 ET
Table 'Nz0Vr7WMHL2g5Uk7dDZjpw' 9-max Seat #9 is the button
Seat 2: gsyXT42WLEcOS4DdEk2wlw ($30.10 in chips)
Seat 3: hoglu9inkgs6zN573/bJag ($6.10 in chips)
Seat 4: E2518gp4aFz1+kAgmGqeEg ($12.55 in chips)
Seat 5: WGW0DgjBUXs1ylURHG8vnQ ($19.15 in chips)
Seat 6: 997ViqAtWn1FPjJqcffwcA ($59.05 in chips)
Seat 7: KPLH0gELgFe2OuAnhJFI5w ($25.95 in chips)
Seat 8: aoL+R/61Kxmw69ypuPrWAQ ($30.50 in chips)
Seat 9: mSD1pginDsyHG5PDfqzphw ($10 in chips)
gsyXT42WLEcOS4DdEk2wlw: posts small blind $0.25
hoglu9inkgs6zN573/bJag: posts big blind $0.50
*** HOLE CARDS ***
E2518gp4aFz1+kAgmGqeEg: folds
WGW0DgjBUXs1ylURHG8vnQ: calls $0.50
997ViqAtWn1FPjJqcffwcA: folds
KPLH0gELgFe2OuAnhJFI5w: calls $0.50
aoL+R/61Kxmw69ypuPrWAQ: raises $0.50 to $1
mSD1pginDsyHG5PDfqzphw: folds
gsyXT42WLEcOS4DdEk2wlw: calls $0.75
hoglu9inkgs6zN573/bJag: calls $0.50
WGW0DgjBUXs1ylURHG8vnQ: calls $0.50
KPLH0gELgFe2OuAnhJFI5w: calls $0.50
*** FLOP *** [Qh Qc 2d]
gsyXT42WLEcOS4DdEk2wlw: checks
hoglu9inkgs6zN573/bJag: checks
WGW0DgjBUXs1ylURHG8vnQ: checks
KPLH0gELgFe2OuAnhJFI5w: checks
aoL+R/61Kxmw69ypuPrWAQ: bets $2
gsyXT42WLEcOS4DdEk2wlw: calls $2
hoglu9inkgs6zN573/bJag: folds
WGW0DgjBUXs1ylURHG8vnQ: folds
KPLH0gELgFe2OuAnhJFI5w: folds
*** TURN *** [Qh Qc 2d] [8c]
gsyXT42WLEcOS4DdEk2wlw: checks
aoL+R/61Kxmw69ypuPrWAQ: checks
*** RIVER *** [Qh Qc 2d 8c] [7h]
gsyXT42WLEcOS4DdEk2wlw: bets $2.50
aoL+R/61Kxmw69ypuPrWAQ: raises $2.50 to $5
gsyXT42WLEcOS4DdEk2wlw: calls $2.50
*** SHOW DOWN ***
aoL+R/61Kxmw69ypuPrWAQ: shows [Jc Th] (a pair of Queens)
gsyXT42WLEcOS4DdEk2wlw: shows [Ks Qd] (three of a kind, Queens)
gsyXT42WLEcOS4DdEk2wlw collected $18.10 from pot
*** SUMMARY ***
Total pot $19 | Rake $0.90
Board [Qh Qc 2d 8c 7h]
Seat 2: gsyXT42WLEcOS4DdEk2wlw (small blind) showed [Ks Qd] and won ($18.10) with three of a kind, Queens
Seat 3: hoglu9inkgs6zN573/bJag (big blind) folded on the Flop
Seat 4: E2518gp4aFz1+kAgmGqeEg folded before Flop (didn't bet)
Seat 5: WGW0DgjBUXs1ylURHG8vnQ folded on the Flop
Seat 6: 997ViqAtWn1FPjJqcffwcA folded before Flop (didn't bet)
Seat 7: KPLH0gELgFe2OuAnhJFI5w folded on the Flop
Seat 8: aoL+R/61Kxmw69ypuPrWAQ showed [Jc Th] and lost with a pair of Queens
Seat 9: mSD1pginDsyHG5PDfqzphw (button) folded before Flop (didn't bet)



PokerStars Game #59940736636:  Hold'em No Limit ($0.25/$0.50) - 2009/07/01 1:15:07 ET
Table 'X6IRCRTh+20gjz8aubWnwA' 9-max Seat #3 is the button
Seat 2: HZkVla4kK2SI42CVrPZ/ig ($5.80 in chips)
Seat 3: SWv01peOe69QQRvhQTqjQw ($5.05 in chips)
Seat 4: M3JFBNQ8Bbw3FBZ/18MuXw ($26.15 in chips)
Seat 5: NnQCepdIR/AOUQn1yhYx6Q ($9.25 in chips)
Seat 6: 75K2MXwN65Sjfp1yHd50Hg ($11.70 in chips)
Seat 7: cFHQjKQOOKTUzoilhrXHLg ($15.25 in chips)
Seat 8: HxeBVq06/3Bh/H986sgdbw ($49.25 in chips)
Seat 9: M+7+BTmX5vZatHVuoRB1nA ($43 in chips)
M3JFBNQ8Bbw3FBZ/18MuXw: posts small blind $0.25
NnQCepdIR/AOUQn1yhYx6Q: posts big blind $0.50
E2518gp4aFz1+kAgmGqeEg: sits out
*** HOLE CARDS ***
75K2MXwN65Sjfp1yHd50Hg: folds
cFHQjKQOOKTUzoilhrXHLg: calls $0.50
HxeBVq06/3Bh/H986sgdbw: folds
M+7+BTmX5vZatHVuoRB1nA: raises $1.50 to $2
HZkVla4kK2SI42CVrPZ/ig: folds
SWv01peOe69QQRvhQTqjQw: folds
M3JFBNQ8Bbw3FBZ/18MuXw: folds
NnQCepdIR/AOUQn1yhYx6Q: folds
cFHQjKQOOKTUzoilhrXHLg: calls $1.50
*** FLOP *** [Ah Jh 5d]
cFHQjKQOOKTUzoilhrXHLg: checks
M+7+BTmX5vZatHVuoRB1nA: bets $3
cFHQjKQOOKTUzoilhrXHLg: folds
M+7+BTmX5vZatHVuoRB1nA collected $4.55 from pot
M+7+BTmX5vZatHVuoRB1nA: doesn't show hand
*** SUMMARY ***
Total pot $4.75 | Rake $0.20
Board [Ah Jh 5d]
Seat 2: HZkVla4kK2SI42CVrPZ/ig folded before Flop (didn't bet)
Seat 3: SWv01peOe69QQRvhQTqjQw (button) folded before Flop (didn't bet)
Seat 4: M3JFBNQ8Bbw3FBZ/18MuXw (small blind) folded before Flop
Seat 5: NnQCepdIR/AOUQn1yhYx6Q (big blind) folded before Flop
Seat 6: 75K2MXwN65Sjfp1yHd50Hg folded before Flop (didn't bet)
Seat 7: cFHQjKQOOKTUzoilhrXHLg folded on the Flop
Seat 8: HxeBVq06/3Bh/H986sgdbw folded before Flop (didn't bet)
Seat 9: M+7+BTmX5vZatHVuoRB1nA collected ($4.55)



PokerStars Game #59940737386:  Hold'em No Limit ($0.25/$0.50) - 2009/07/01 1:15:08 ET
Table '8BQGgNetI1NOvWeu3gtMNw' 2-max Seat #2 is the button
Seat 1: bypIyrYcAAifLfhZpGlKLA ($62.15 in chips)
Seat 2: Z4HwehErEwzsv/noQlfUlg ($132.40 in chips)
Z4HwehErEwzsv/noQlfUlg: posts small blind $0.25
bypIyrYcAAifLfhZpGlKLA: posts big blind $0.50
*** HOLE CARDS ***
Z4HwehErEwzsv/noQlfUlg: raises $2.50 to $3
bypIyrYcAAifLfhZpGlKLA: calls $2.50
*** FLOP *** [7s 8c 3d]
bypIyrYcAAifLfhZpGlKLA: checks
Z4HwehErEwzsv/noQlfUlg: bets $4
bypIyrYcAAifLfhZpGlKLA: raises $8 to $12
Z4HwehErEwzsv/noQlfUlg: folds
bypIyrYcAAifLfhZpGlKLA collected $13.50 from pot
bypIyrYcAAifLfhZpGlKLA: doesn't show hand
*** SUMMARY ***
Total pot $14 | Rake $0.50
Board [7s 8c 3d]
Seat 1: bypIyrYcAAifLfhZpGlKLA (big blind) collected ($13.50)
Seat 2: Z4HwehErEwzsv/noQlfUlg (button) (small blind) folded on the Flop



PokerStars Game #59940737610:  Hold'em No Limit ($0.25/$0.50) - 2009/07/01 1:15:08 ET
Table '/cQuAT3ef4t+PGrXiNhGaQ' 9-max Seat #2 is the button
Seat 1: HZkVla4kK2SI42CVrPZ/ig ($14.25 in chips)
Seat 2: jXGruyaMqirTaTXNOvBdew ($70.85 in chips)
Seat 3: g4k0NXISyLCqaSWZDBjfEg ($54.85 in chips)
Seat 4: OWP/DOu+PlPK6ZZ3zYa0HA ($32.95 in chips)
Seat 5: 5SgaHdWixdClWvaEG+KUjQ ($37.10 in chips)
Seat 6: APYIOyK/4AGb+kIwlOUNBQ ($36.10 in chips)
Seat 7: J0W5D97jl5VLky+IoPvDeA ($168.50 in chips)
Seat 8: eBrej2jnlUCs/JgxFCRn2g ($42.25 in chips)
Seat 9: AjV5McH1KMMclY26QdLM5w ($25 in chips)
g4k0NXISyLCqaSWZDBjfEg: posts small blind $0.25
OWP/DOu+PlPK6ZZ3zYa0HA: posts big blind $0.50
*** HOLE CARDS ***
5SgaHdWixdClWvaEG+KUjQ: raises $1 to $1.50
APYIOyK/4AGb+kIwlOUNBQ: folds
J0W5D97jl5VLky+IoPvDeA: folds
eBrej2jnlUCs/JgxFCRn2g: folds
AjV5McH1KMMclY26QdLM5w: raises $2 to $3.50
HZkVla4kK2SI42CVrPZ/ig: folds
jXGruyaMqirTaTXNOvBdew: folds
g4k0NXISyLCqaSWZDBjfEg: folds
OWP/DOu+PlPK6ZZ3zYa0HA: folds
5SgaHdWixdClWvaEG+KUjQ: calls $2
*** FLOP *** [7h Ks Qs]
5SgaHdWixdClWvaEG+KUjQ: bets $4
AjV5McH1KMMclY26QdLM5w: folds
5SgaHdWixdClWvaEG+KUjQ collected $7.40 from pot
*** SUMMARY ***
Total pot $7.75 | Rake $0.35
Board [7h Ks Qs]
Seat 1: HZkVla4kK2SI42CVrPZ/ig folded before Flop (didn't bet)
Seat 2: jXGruyaMqirTaTXNOvBdew (button) folded before Flop (didn't bet)
Seat 3: g4k0NXISyLCqaSWZDBjfEg (small blind) folded before Flop
Seat 4: OWP/DOu+PlPK6ZZ3zYa0HA (big blind) folded before Flop
Seat 5: 5SgaHdWixdClWvaEG+KUjQ collected ($7.40)
Seat 6: APYIOyK/4AGb+kIwlOUNBQ folded before Flop (didn't bet)
Seat 7: J0W5D97jl5VLky+IoPvDeA folded before Flop (didn't bet)
Seat 8: eBrej2jnlUCs/JgxFCRn2g folded before Flop (didn't bet)
Seat 9: AjV5McH1KMMclY26QdLM5w folded on the Flop



PokerStars Game #59940737898:  Hold'em No Limit ($0.25/$0.50) - 2009/07/01 1:15:09 ET
Table 'NCiXr0d5CEKBQr/cZgLhbA' 9-max Seat #8 is the button
Seat 1: pFtzb1sR4b0d1aw6aIRgDg ($50.20 in chips)
Seat 3: xZCXQSXlrZkp3pZizzVXCw ($51.95 in chips)
Seat 4: 5k9fvXD9suIgCxU4HLQjTw ($54.70 in chips)
Seat 5: zE9cVigS2nW/Ljy4K4bUQA ($63.35 in chips)
Seat 7: M+7+BTmX5vZatHVuoRB1nA ($53.40 in chips)
Seat 8: 1MJUKc3cc0QmUoz1JZLR2w ($48.05 in chips)
Seat 9: 4WLZvqBn5qv5tds5kt5A1Q ($55.50 in chips)
4WLZvqBn5qv5tds5kt5A1Q: posts small blind $0.25
pFtzb1sR4b0d1aw6aIRgDg: posts big blind $0.50
AjV5McH1KMMclY26QdLM5w: sits out
cards4hire: sits out
*** HOLE CARDS ***
xZCXQSXlrZkp3pZizzVXCw: folds
5k9fvXD9suIgCxU4HLQjTw: folds
zE9cVigS2nW/Ljy4K4bUQA: raises $1 to $1.50
M+7+BTmX5vZatHVuoRB1nA: folds
1MJUKc3cc0QmUoz1JZLR2w: raises $2 to $3.50
4WLZvqBn5qv5tds5kt5A1Q: folds
pFtzb1sR4b0d1aw6aIRgDg: folds
zE9cVigS2nW/Ljy4K4bUQA: calls $2
*** FLOP *** [5d 7c 3h]
zE9cVigS2nW/Ljy4K4bUQA: checks
1MJUKc3cc0QmUoz1JZLR2w: bets $4
zE9cVigS2nW/Ljy4K4bUQA: folds
1MJUKc3cc0QmUoz1JZLR2w collected $7.40 from pot
1MJUKc3cc0QmUoz1JZLR2w: doesn't show hand
*** SUMMARY ***
Total pot $7.75 | Rake $0.35
Board [5d 7c 3h]
Seat 1: pFtzb1sR4b0d1aw6aIRgDg (big blind) folded before Flop
Seat 3: xZCXQSXlrZkp3pZizzVXCw folded before Flop (didn't bet)
Seat 4: 5k9fvXD9suIgCxU4HLQjTw folded before Flop (didn't bet)
Seat 5: zE9cVigS2nW/Ljy4K4bUQA folded on the Flop
Seat 7: M+7+BTmX5vZatHVuoRB1nA folded before Flop (didn't bet)
Seat 8: 1MJUKc3cc0QmUoz1JZLR2w (button) collected ($7.40)
Seat 9: 4WLZvqBn5qv5tds5kt5A1Q (small blind) folded before Flop



PokerStars Game #59940738112:  Hold'em No Limit ($0.25/$0.50) - 2009/07/01 1:15:09 ET
Table 'lpxYasB1ClBSgTpCCITwhQ' 9-max Seat #9 is the button
Seat 1: mj7PS7wCH4PAl7+eYTFs7A ($49.50 in chips)
Seat 2: OWP/DOu+PlPK6ZZ3zYa0HA ($25.85 in chips)
Seat 3: sakr/FIfFtIZwDPmAj5Pzg ($49.20 in chips)
Seat 4: NnQCepdIR/AOUQn1yhYx6Q ($9.25 in chips)
Seat 6: SegjDnMxWMujiD57ESNL+g ($7.10 in chips)
Seat 7: bmRtaIYKthN1F+B3JLZ3Jw ($74.10 in chips)
Seat 8: /mfensKw8/iZ1Vrx33S4xg ($11.50 in chips)
Seat 9: sUIUZ+begh92dzkUmvbMrw ($24.65 in chips)
mj7PS7wCH4PAl7+eYTFs7A: posts small blind $0.25
OWP/DOu+PlPK6ZZ3zYa0HA: posts big blind $0.50
*** HOLE CARDS ***
sakr/FIfFtIZwDPmAj5Pzg: folds
NnQCepdIR/AOUQn1yhYx6Q: folds
SegjDnMxWMujiD57ESNL+g: folds
bmRtaIYKthN1F+B3JLZ3Jw: folds
/mfensKw8/iZ1Vrx33S4xg: folds
sUIUZ+begh92dzkUmvbMrw: folds
mj7PS7wCH4PAl7+eYTFs7A: calls $0.25
OWP/DOu+PlPK6ZZ3zYa0HA: checks
*** FLOP *** [6d Ts 6s]
mj7PS7wCH4PAl7+eYTFs7A: checks
OWP/DOu+PlPK6ZZ3zYa0HA: checks
*** TURN *** [6d Ts 6s] [Ad]
mj7PS7wCH4PAl7+eYTFs7A: bets $1.50
OWP/DOu+PlPK6ZZ3zYa0HA: folds
mj7PS7wCH4PAl7+eYTFs7A collected $0.95 from pot
mj7PS7wCH4PAl7+eYTFs7A: doesn't show hand
*** SUMMARY ***
Total pot $1 | Rake $0.05
Board [6d Ts 6s Ad]
Seat 1: mj7PS7wCH4PAl7+eYTFs7A (small blind) collected ($0.95)
Seat 2: OWP/DOu+PlPK6ZZ3zYa0HA (big blind) folded on the Turn
Seat 3: sakr/FIfFtIZwDPmAj5Pzg folded before Flop (didn't bet)
Seat 4: NnQCepdIR/AOUQn1yhYx6Q folded before Flop (didn't bet)
Seat 6: SegjDnMxWMujiD57ESNL+g folded before Flop (didn't bet)
Seat 7: bmRtaIYKthN1F+B3JLZ3Jw folded before Flop (didn't bet)
Seat 8: /mfensKw8/iZ1Vrx33S4xg folded before Flop (didn't bet)
Seat 9: sUIUZ+begh92dzkUmvbMrw (button) folded before Flop (didn't bet)



PokerStars Game #59940738746:  Hold'em No Limit ($0.25/$0.50) - 2009/07/01 1:15:10 ET
Table '+dXkOAQyS8j9PQZusUTMpg' 2-max Seat #1 is the button
Seat 1: XFa6sBGjP2gxoIvxR3fZIg ($124.95 in chips)
Seat 2: 5IBeOgaApY1Bvzv2P8X4EA ($68.05 in chips)
5IBeOgaApY1Bvzv2P8X4EA said, "last hand"
XFa6sBGjP2gxoIvxR3fZIg: posts small blind $0.25
5IBeOgaApY1Bvzv2P8X4EA: posts big blind $0.50
*** HOLE CARDS ***
XFa6sBGjP2gxoIvxR3fZIg: raises $1 to $1.50
5IBeOgaApY1Bvzv2P8X4EA: folds
XFa6sBGjP2gxoIvxR3fZIg collected $1 from pot
*** SUMMARY ***
Total pot $1 | Rake $0
Seat 1: XFa6sBGjP2gxoIvxR3fZIg (button) (small blind) collected ($1)
Seat 2: 5IBeOgaApY1Bvzv2P8X4EA (big blind) folded before Flop



PokerStars Game #59940743100:  Hold'em No Limit ($0.25/$0.50) - 2009/07/01 1:15:17 ET
Table 'MJxeZCzYELxiIsyUZyT0jw' 6-max Seat #6 is the button
Seat 1: +Pf9jTVizYlIo+woPvptfA ($50 in chips)
Seat 2: t3GiVMzqA9Svgr5Uol32cQ ($27.10 in chips)
Seat 3: sIG4mp8tZEI+W4nKZNkkQA ($51.85 in chips)
Seat 4: alGiiQP/wwtYnfuXII+sgw ($61.60 in chips)
Seat 5: 3jvoOXNtXE90w2BdfNZwZQ ($61.95 in chips)
Seat 6: c0n4hrn20AML9qzyFC2E8Q ($51.10 in chips)
+Pf9jTVizYlIo+woPvptfA: posts small blind $0.25
t3GiVMzqA9Svgr5Uol32cQ: posts big blind $0.50
*** HOLE CARDS ***
sIG4mp8tZEI+W4nKZNkkQA: folds
alGiiQP/wwtYnfuXII+sgw: calls $0.50
3jvoOXNtXE90w2BdfNZwZQ: folds
c0n4hrn20AML9qzyFC2E8Q: folds
+Pf9jTVizYlIo+woPvptfA: folds
t3GiVMzqA9Svgr5Uol32cQ: checks
*** FLOP *** [3d 8c Qc]
t3GiVMzqA9Svgr5Uol32cQ: checks
alGiiQP/wwtYnfuXII+sgw: checks
*** TURN *** [3d 8c Qc] [Kc]
t3GiVMzqA9Svgr5Uol32cQ: bets $1.50
alGiiQP/wwtYnfuXII+sgw: calls $1.50
*** RIVER *** [3d 8c Qc Kc] [Js]
t3GiVMzqA9Svgr5Uol32cQ: bets $2.50
alGiiQP/wwtYnfuXII+sgw: folds
t3GiVMzqA9Svgr5Uol32cQ collected $4.05 from pot
*** SUMMARY ***
Total pot $4.25 | Rake $0.20
Board [3d 8c Qc Kc Js]
Seat 1: +Pf9jTVizYlIo+woPvptfA (small blind) folded before Flop
Seat 2: t3GiVMzqA9Svgr5Uol32cQ (big blind) collected ($4.05)
Seat 3: sIG4mp8tZEI+W4nKZNkkQA folded before Flop (didn't bet)
Seat 4: alGiiQP/wwtYnfuXII+sgw folded on the River
Seat 5: 3jvoOXNtXE90w2BdfNZwZQ folded before Flop (didn't bet)
Seat 6: c0n4hrn20AML9qzyFC2E8Q (button) folded before Flop (didn't bet)



PokerStars Game #59940742690:  Hold'em No Limit ($0.25/$0.50) - 2009/07/01 1:15:17 ET
Table 'kgbJRsxfv64KrErDRBAkcw' 6-max Seat #1 is the button
Seat 1: VamsyhlFzXGF6/ydo0BHeA ($51.80 in chips)
Seat 2: AdS8BJMOheS01zjCDfPMFg ($50 in chips)
Seat 3: c4MNIaIyPMOMxrgT8FT5nA ($194.55 in chips)
Seat 5: eUBBn2R56C1IQ6Cs/vitwg ($50 in chips)
Seat 6: 1b+2BbjMN8qhR1WPqdE9VQ ($50.10 in chips)
AdS8BJMOheS01zjCDfPMFg: posts small blind $0.25
c4MNIaIyPMOMxrgT8FT5nA: posts big blind $0.50
*** HOLE CARDS ***
eUBBn2R56C1IQ6Cs/vitwg: folds
1b+2BbjMN8qhR1WPqdE9VQ: folds
VamsyhlFzXGF6/ydo0BHeA: folds
AdS8BJMOheS01zjCDfPMFg: raises $1 to $1.50
c4MNIaIyPMOMxrgT8FT5nA: calls $1
*** FLOP *** [Qd 4c 4h]
AdS8BJMOheS01zjCDfPMFg: bets $1
c4MNIaIyPMOMxrgT8FT5nA: raises $4.50 to $5.50
AdS8BJMOheS01zjCDfPMFg: raises $8.50 to $14
c4MNIaIyPMOMxrgT8FT5nA: calls $8.50
*** TURN *** [Qd 4c 4h] [4d]
AdS8BJMOheS01zjCDfPMFg: checks
c4MNIaIyPMOMxrgT8FT5nA: bets $179.05 and is all-in
AdS8BJMOheS01zjCDfPMFg: folds
c4MNIaIyPMOMxrgT8FT5nA collected $29.50 from pot
*** SUMMARY ***
Total pot $31 | Rake $1.50
Board [Qd 4c 4h 4d]
Seat 1: VamsyhlFzXGF6/ydo0BHeA (button) folded before Flop (didn't bet)
Seat 2: AdS8BJMOheS01zjCDfPMFg (small blind) folded on the Turn
Seat 3: c4MNIaIyPMOMxrgT8FT5nA (big blind) collected ($29.50)
Seat 5: eUBBn2R56C1IQ6Cs/vitwg folded before Flop (didn't bet)
Seat 6: 1b+2BbjMN8qhR1WPqdE9VQ folded before Flop (didn't bet)



PokerStars Game #59940743438:  Hold'em No Limit ($0.25/$0.50) - 2009/07/01 1:15:18 ET
Table 'hSTs/dUsYLgJQuF2Onp0MQ' 6-max Seat #1 is the button
Seat 1: 1WUCqNG+p+vfWRTXNu4ljw ($50.50 in chips)
Seat 3: C3qJBo7uxfFVDluE1lmK2w ($35.60 in chips)
Seat 5: IBNygaT1aa9Z1uPdJJilwA ($29.25 in chips)
Seat 6: M1KyQQvVPVuxqTAB8sR/zQ ($88.95 in chips)
C3qJBo7uxfFVDluE1lmK2w: posts small blind $0.25
IBNygaT1aa9Z1uPdJJilwA: posts big blind $0.50
*** HOLE CARDS ***
M1KyQQvVPVuxqTAB8sR/zQ: folds
1WUCqNG+p+vfWRTXNu4ljw: folds
C3qJBo7uxfFVDluE1lmK2w: raises $0.50 to $1
2igtJLmvIZ+HqX4XPgMPZA joins the table at seat #4
IBNygaT1aa9Z1uPdJJilwA: raises $1.50 to $2.50
C3qJBo7uxfFVDluE1lmK2w: calls $1.50
*** FLOP *** [4d 8h Jd]
C3qJBo7uxfFVDluE1lmK2w: checks
IBNygaT1aa9Z1uPdJJilwA: bets $2
C3qJBo7uxfFVDluE1lmK2w: calls $2
*** TURN *** [4d 8h Jd] [9c]
C3qJBo7uxfFVDluE1lmK2w: checks
IBNygaT1aa9Z1uPdJJilwA: bets $4.50
C3qJBo7uxfFVDluE1lmK2w: folds
IBNygaT1aa9Z1uPdJJilwA collected $8.60 from pot
*** SUMMARY ***
Total pot $9 | Rake $0.40
Board [4d 8h Jd 9c]
Seat 1: 1WUCqNG+p+vfWRTXNu4ljw (button) folded before Flop (didn't bet)
Seat 3: C3qJBo7uxfFVDluE1lmK2w (small blind) folded on the Turn
Seat 5: IBNygaT1aa9Z1uPdJJilwA (big blind) collected ($8.60)
Seat 6: M1KyQQvVPVuxqTAB8sR/zQ folded before Flop (didn't bet)



PokerStars Game #59940743502:  Hold'em No Limit ($0.25/$0.50) - 2009/07/01 1:15:18 ET
Table '5EmHi+fnatGQQShcNmzOZQ' 6-max Seat #5 is the button
Seat 1: My8WkRtGx5FW6rJ1I4R3hg ($43.10 in chips)
Seat 2: bfFjgAtIoAI+pUxUwFt3aQ ($38.95 in chips)
Seat 3: 1mYbhL8CU/QYqfVmFcaHDQ ($6.05 in chips)
Seat 4: 1b+2BbjMN8qhR1WPqdE9VQ ($58.35 in chips)
Seat 5: kxPhs4ePFqMy52CInAJ2aw ($93.10 in chips)
Seat 6: +Pf9jTVizYlIo+woPvptfA ($50.70 in chips)
+Pf9jTVizYlIo+woPvptfA: posts small blind $0.25
My8WkRtGx5FW6rJ1I4R3hg: posts big blind $0.50
*** HOLE CARDS ***
bfFjgAtIoAI+pUxUwFt3aQ: folds
1mYbhL8CU/QYqfVmFcaHDQ: folds
1b+2BbjMN8qhR1WPqdE9VQ: folds
kxPhs4ePFqMy52CInAJ2aw: folds
+Pf9jTVizYlIo+woPvptfA: raises $1.50 to $2
My8WkRtGx5FW6rJ1I4R3hg: folds
+Pf9jTVizYlIo+woPvptfA collected $1 from pot
+Pf9jTVizYlIo+woPvptfA: doesn't show hand
*** SUMMARY ***
Total pot $1 | Rake $0
Seat 1: My8WkRtGx5FW6rJ1I4R3hg (big blind) folded before Flop
Seat 2: bfFjgAtIoAI+pUxUwFt3aQ folded before Flop (didn't bet)
Seat 3: 1mYbhL8CU/QYqfVmFcaHDQ folded before Flop (didn't bet)
Seat 4: 1b+2BbjMN8qhR1WPqdE9VQ folded before Flop (didn't bet)
Seat 5: kxPhs4ePFqMy52CInAJ2aw (button) folded before Flop (didn't bet)
Seat 6: +Pf9jTVizYlIo+woPvptfA (small blind) collected ($1)



PokerStars Game #59940743868:  Hold'em No Limit ($0.25/$0.50) - 2009/07/01 1:15:19 ET
Table '+dXkOAQyS8j9PQZusUTMpg' 2-max Seat #2 is the button
Seat 1: XFa6sBGjP2gxoIvxR3fZIg ($125.45 in chips)
Seat 2: 5IBeOgaApY1Bvzv2P8X4EA ($67.55 in chips)
5IBeOgaApY1Bvzv2P8X4EA: posts small blind $0.25
XFa6sBGjP2gxoIvxR3fZIg: posts big blind $0.50
*** HOLE CARDS ***
XFa6sBGjP2gxoIvxR3fZIg said, "ok. It has been a nice session"
5IBeOgaApY1Bvzv2P8X4EA: calls $0.25
XFa6sBGjP2gxoIvxR3fZIg: checks
*** FLOP *** [Th 2c 6h]
XFa6sBGjP2gxoIvxR3fZIg: checks
5IBeOgaApY1Bvzv2P8X4EA: bets $0.50
XFa6sBGjP2gxoIvxR3fZIg: folds
5IBeOgaApY1Bvzv2P8X4EA said, "yes see you soon"
5IBeOgaApY1Bvzv2P8X4EA collected $0.95 from pot
5IBeOgaApY1Bvzv2P8X4EA is sitting out
5IBeOgaApY1Bvzv2P8X4EA: doesn't show hand
*** SUMMARY ***
Total pot $1 | Rake $0.05
Board [Th 2c 6h]
Seat 1: XFa6sBGjP2gxoIvxR3fZIg (big blind) folded on the Flop
Seat 2: 5IBeOgaApY1Bvzv2P8X4EA (button) (small blind) collected ($0.95)



PokerStars Game #59940743956:  Hold'em No Limit ($0.25/$0.50) - 2009/07/01 1:15:19 ET
Table 'EiNh8p/wGJ1FP575iMFnqg' 9-max Seat #3 is the button
Seat 1: r3ZqM1Mi0W3y4hOdssE+Sg ($66.50 in chips)
Seat 2: 8ehL7qlZzjgUh2H35iiWLw ($58.40 in chips)
Seat 3: ymLPoEIl7UL3TvZYmnadxQ ($54.80 in chips)
Seat 4: cMzaiXAM/ZAdNaEUu+LqhA ($50.25 in chips)
Seat 5: M+7+BTmX5vZatHVuoRB1nA ($80.45 in chips)
Seat 6: 3UmXLy3GfjC3EkOebduerQ ($61.60 in chips)
Seat 7: 997ViqAtWn1FPjJqcffwcA ($50 in chips)
Seat 8: mSD1pginDsyHG5PDfqzphw ($10 in chips)
Seat 9: GuPkZObrz5Zkkn8FsEdF9w ($30 in chips)
cMzaiXAM/ZAdNaEUu+LqhA: posts small blind $0.25
M+7+BTmX5vZatHVuoRB1nA: posts big blind $0.50
*** HOLE CARDS ***
3UmXLy3GfjC3EkOebduerQ: folds
997ViqAtWn1FPjJqcffwcA: folds
mSD1pginDsyHG5PDfqzphw: folds
GuPkZObrz5Zkkn8FsEdF9w: folds
r3ZqM1Mi0W3y4hOdssE+Sg: folds
8ehL7qlZzjgUh2H35iiWLw: folds
ymLPoEIl7UL3TvZYmnadxQ: raises $0.50 to $1
cMzaiXAM/ZAdNaEUu+LqhA: folds
M+7+BTmX5vZatHVuoRB1nA: folds
ymLPoEIl7UL3TvZYmnadxQ collected $1.25 from pot
ymLPoEIl7UL3TvZYmnadxQ: doesn't show hand
*** SUMMARY ***
Total pot $1.25 | Rake $0
Seat 1: r3ZqM1Mi0W3y4hOdssE+Sg folded before Flop (didn't bet)
Seat 2: 8ehL7qlZzjgUh2H35iiWLw folded before Flop (didn't bet)
Seat 3: ymLPoEIl7UL3TvZYmnadxQ (button) collected ($1.25)
Seat 4: cMzaiXAM/ZAdNaEUu+LqhA (small blind) folded before Flop
Seat 5: M+7+BTmX5vZatHVuoRB1nA (big blind) folded before Flop
Seat 6: 3UmXLy3GfjC3EkOebduerQ folded before Flop (didn't bet)
Seat 7: 997ViqAtWn1FPjJqcffwcA folded before Flop (didn't bet)
Seat 8: mSD1pginDsyHG5PDfqzphw folded before Flop (didn't bet)
Seat 9: GuPkZObrz5Zkkn8FsEdF9w folded before Flop (didn't bet)



PokerStars Game #59940745112:  Hold'em No Limit ($0.25/$0.50) - 2009/07/01 1:15:21 ET
Table 'QOgaEqMcJ73pcUMMxoisUg' 6-max Seat #3 is the button
Seat 1: lxIzoHy0RnkfFSODHC2liw ($50 in chips)
Seat 2: oqOqoO2AyCZenUghCxMDxw ($61.50 in chips)
Seat 3: Rt6KgtZ8YaJoTc3FPim00w ($53.75 in chips)
Seat 4: zAcsDhG/T128Vn7XGVSgKg ($59.40 in chips)
Seat 6: AdS8BJMOheS01zjCDfPMFg ($57.70 in chips)
zAcsDhG/T128Vn7XGVSgKg: posts small blind $0.25
AdS8BJMOheS01zjCDfPMFg: posts big blind $0.50
*** HOLE CARDS ***
lxIzoHy0RnkfFSODHC2liw: raises $1 to $1.50
oqOqoO2AyCZenUghCxMDxw: calls $1.50
Rt6KgtZ8YaJoTc3FPim00w: folds
zAcsDhG/T128Vn7XGVSgKg: folds
AdS8BJMOheS01zjCDfPMFg: calls $1
*** FLOP *** [6h 2h Qs]
AdS8BJMOheS01zjCDfPMFg: checks
lxIzoHy0RnkfFSODHC2liw: checks
oqOqoO2AyCZenUghCxMDxw: checks
*** TURN *** [6h 2h Qs] [3d]
AdS8BJMOheS01zjCDfPMFg: bets $3
lxIzoHy0RnkfFSODHC2liw: raises $8 to $11
oqOqoO2AyCZenUghCxMDxw: folds
AdS8BJMOheS01zjCDfPMFg: calls $8
*** RIVER *** [6h 2h Qs 3d] [3h]
AdS8BJMOheS01zjCDfPMFg: bets $15
lxIzoHy0RnkfFSODHC2liw: raises $22.50 to $37.50 and is all-in
AdS8BJMOheS01zjCDfPMFg: calls $22.50
*** SHOW DOWN ***
lxIzoHy0RnkfFSODHC2liw: shows [8h Th] (a flush, Ten high)
AdS8BJMOheS01zjCDfPMFg: shows [4h Ah] (a flush, Ace high)
AdS8BJMOheS01zjCDfPMFg collected $99.75 from pot
*** SUMMARY ***
Total pot $101.75 | Rake $2
Board [6h 2h Qs 3d 3h]
Seat 1: lxIzoHy0RnkfFSODHC2liw showed [8h Th] and lost with a flush, Ten high
Seat 2: oqOqoO2AyCZenUghCxMDxw folded on the Turn
Seat 3: Rt6KgtZ8YaJoTc3FPim00w (button) folded before Flop (didn't bet)
Seat 4: zAcsDhG/T128Vn7XGVSgKg (small blind) folded before Flop
Seat 6: AdS8BJMOheS01zjCDfPMFg (big blind) showed [4h Ah] and won ($99.75) with a flush, Ace high



PokerStars Game #59940750928:  Hold'em No Limit ($0.25/$0.50) - 2009/07/01 1:15:31 ET
Table '8BQGgNetI1NOvWeu3gtMNw' 2-max Seat #1 is the button
Seat 1: bypIyrYcAAifLfhZpGlKLA ($68.65 in chips)
Seat 2: Z4HwehErEwzsv/noQlfUlg ($125.40 in chips)
bypIyrYcAAifLfhZpGlKLA: posts small blind $0.25
Z4HwehErEwzsv/noQlfUlg: posts big blind $0.50
*** HOLE CARDS ***
bypIyrYcAAifLfhZpGlKLA: raises $1 to $1.50
Z4HwehErEwzsv/noQlfUlg: raises $1 to $2.50
bypIyrYcAAifLfhZpGlKLA: calls $1
*** FLOP *** [5d Qd 2h]
Z4HwehErEwzsv/noQlfUlg: checks
bypIyrYcAAifLfhZpGlKLA: checks
*** TURN *** [5d Qd 2h] [6s]
Z4HwehErEwzsv/noQlfUlg: bets $4
bypIyrYcAAifLfhZpGlKLA: folds
Z4HwehErEwzsv/noQlfUlg collected $4.75 from pot
Z4HwehErEwzsv/noQlfUlg: doesn't show hand
*** SUMMARY ***
Total pot $5 | Rake $0.25
Board [5d Qd 2h 6s]
Seat 1: bypIyrYcAAifLfhZpGlKLA (button) (small blind) folded on the Turn
Seat 2: Z4HwehErEwzsv/noQlfUlg (big blind) collected ($4.75)



PokerStars Game #59940750854:  Hold'em No Limit ($0.25/$0.50) - 2009/07/01 1:15:31 ET
Table 'ErOuyGLI5PT3G5MnpHgC/gQOgaEqMcJ73pcUMMxoisUg Seat #2 is the button
Seat 1: eBrej2jnlUCs/JgxFCRn2g ($44.80 in chips)
Seat 2: pciZn00ZDk4BVBMTTMcNVQ ($19.30 in chips)
Seat 3: xZCXQSXlrZkp3pZizzVXCw ($50 in chips)
Seat 5: JwvquocWfhTVApN5t47LgA ($62.10 in chips)
Seat 6: zE9cVigS2nW/Ljy4K4bUQA ($31.60 in chips)
Seat 7: 90Wb75h3W1BRpbqVnuk8gw ($60.45 in chips)
Seat 8: g4k0NXISyLCqaSWZDBjfEg ($50 in chips)
Seat 9: J0W5D97jl5VLky+IoPvDeA ($62.90 in chips)
xZCXQSXlrZkp3pZizzVXCw: posts small blind $0.25
3UmXLy3GfjC3EkOebduerQ: is sitting out
3UmXLy3GfjC3EkOebduerQ leaves the table
JwvquocWfhTVApN5t47LgA: posts big blind $0.50
*** HOLE CARDS ***
zE9cVigS2nW/Ljy4K4bUQA: folds
90Wb75h3W1BRpbqVnuk8gw: folds
g4k0NXISyLCqaSWZDBjfEg: folds
J0W5D97jl5VLky+IoPvDeA: calls $0.50
eBrej2jnlUCs/JgxFCRn2g: folds
pciZn00ZDk4BVBMTTMcNVQ: folds
xZCXQSXlrZkp3pZizzVXCw: folds
JwvquocWfhTVApN5t47LgA: checks
*** FLOP *** [As 5d Qs]
JwvquocWfhTVApN5t47LgA: checks
J0W5D97jl5VLky+IoPvDeA: bets $1.50
JwvquocWfhTVApN5t47LgA: folds
J0W5D97jl5VLky+IoPvDeA collected $1.20 from pot
*** SUMMARY ***
Total pot $1.25 | Rake $0.05
Board [As 5d Qs]
Seat 1: eBrej2jnlUCs/JgxFCRn2g folded before Flop (didn't bet)
Seat 2: pciZn00ZDk4BVBMTTMcNVQ (button) folded before Flop (didn't bet)
Seat 3: xZCXQSXlrZkp3pZizzVXCw (small blind) folded before Flop
Seat 5: JwvquocWfhTVApN5t47LgA (big blind) folded on the Flop
Seat 6: zE9cVigS2nW/Ljy4K4bUQA folded before Flop (didn't bet)
Seat 7: 90Wb75h3W1BRpbqVnuk8gw folded before Flop (didn't bet)
Seat 8: g4k0NXISyLCqaSWZDBjfEg folded before Flop (didn't bet)
Seat 9: J0W5D97jl5VLky+IoPvDeA collected ($1.20)



PokerStars Game #59940752264:  Hold'em No Limit ($0.25/$0.50) - 2009/07/01 1:15:33 ET
Table 'BCN5su+SsXiy1zRMJi0SJw' 6-max Seat #2 is the button
Seat 1: GxXV09ciXaOxyY2H5aMIIw ($55.35 in chips)
Seat 2: oU2kDCkT/gilYbHWrg7D8w ($38.45 in chips)
Seat 3: kwgv5lNhiFrfONXCshzxlA ($30.10 in chips)
Seat 4: 4QfsCWthT/vSLirorNXqtg ($52.25 in chips)
Seat 5: cEMJmfAUQZmMChZe6aacKw ($24.50 in chips)
Seat 6: b2symlOdL7+0c9Pj4N/KlA ($58.15 in chips)
kwgv5lNhiFrfONXCshzxlA: posts small blind $0.25
4QfsCWthT/vSLirorNXqtg: posts big blind $0.50
*** HOLE CARDS ***
cEMJmfAUQZmMChZe6aacKw: folds
b2symlOdL7+0c9Pj4N/KlA: folds
GxXV09ciXaOxyY2H5aMIIw: folds
oU2kDCkT/gilYbHWrg7D8w: folds
kwgv5lNhiFrfONXCshzxlA: folds
4QfsCWthT/vSLirorNXqtg collected $0.50 from pot
4QfsCWthT/vSLirorNXqtg: doesn't show hand
*** SUMMARY ***
Total pot $0.50 | Rake $0
Seat 1: GxXV09ciXaOxyY2H5aMIIw folded before Flop (didn't bet)
Seat 2: oU2kDCkT/gilYbHWrg7D8w (button) folded before Flop (didn't bet)
Seat 3: kwgv5lNhiFrfONXCshzxlA (small blind) folded before Flop
Seat 4: 4QfsCWthT/vSLirorNXqtg (big blind) collected ($0.50)
Seat 5: cEMJmfAUQZmMChZe6aacKw folded before Flop (didn't bet)
Seat 6: b2symlOdL7+0c9Pj4N/KlA folded before Flop (didn't bet)



PokerStars Game #59940752946:  Hold'em No Limit ($0.25/$0.50) - 2009/07/01 1:15:34 ET
Table 'otvGDROEDdqsabxskT79qg' 9-max Seat #5 is the button
Seat 1: 8ehL7qlZzjgUh2H35iiWLw ($59.75 in chips)
Seat 2: cCjTzH9jio8607WzjcfXlg ($14.40 in chips)
Seat 3: +k7T5ocke8UwavtgUHm+Cg ($75 in chips)
Seat 4: MG90wfSJZnOejs/KD3vlQQ ($75.15 in chips)
Seat 5: E2518gp4aFz1+kAgmGqeEg ($12.20 in chips)
Seat 6: bxLSulbgr8LmKNjOzw8URg ($55.50 in chips)
Seat 7: 75K2MXwN65Sjfp1yHd50Hg ($10 in chips)
Seat 8: zE9cVigS2nW/Ljy4K4bUQA ($30 in chips)
Seat 9: KcY3X8YpD74Kw1RHkx/g4A ($41.15 in chips)
bxLSulbgr8LmKNjOzw8URg: posts small blind $0.25
75K2MXwN65Sjfp1yHd50Hg: posts big blind $0.50
*** HOLE CARDS ***
zE9cVigS2nW/Ljy4K4bUQA: folds
KcY3X8YpD74Kw1RHkx/g4A: calls $0.50
8ehL7qlZzjgUh2H35iiWLw: folds
cCjTzH9jio8607WzjcfXlg: folds
+k7T5ocke8UwavtgUHm+Cg: folds
MG90wfSJZnOejs/KD3vlQQ: raises $1.50 to $2
E2518gp4aFz1+kAgmGqeEg: folds
bxLSulbgr8LmKNjOzw8URg: folds
75K2MXwN65Sjfp1yHd50Hg: folds
KcY3X8YpD74Kw1RHkx/g4A: calls $1.50
*** FLOP *** [Qc 4s 2d]
KcY3X8YpD74Kw1RHkx/g4A: checks
MG90wfSJZnOejs/KD3vlQQ: bets $3.75
KcY3X8YpD74Kw1RHkx/g4A: calls $3.75
*** TURN *** [Qc 4s 2d] [Qd]
KcY3X8YpD74Kw1RHkx/g4A: checks
MG90wfSJZnOejs/KD3vlQQ: checks
*** RIVER *** [Qc 4s 2d Qd] [Th]
KcY3X8YpD74Kw1RHkx/g4A: checks
MG90wfSJZnOejs/KD3vlQQ: checks
*** SHOW DOWN ***
KcY3X8YpD74Kw1RHkx/g4A: shows [Ks As] (a pair of Queens)
MG90wfSJZnOejs/KD3vlQQ: shows [5c 5h] (two pair, Queens and Fives)
MG90wfSJZnOejs/KD3vlQQ collected $11.65 from pot
*** SUMMARY ***
Total pot $12.25 | Rake $0.60
Board [Qc 4s 2d Qd Th]
Seat 1: 8ehL7qlZzjgUh2H35iiWLw folded before Flop (didn't bet)
Seat 2: cCjTzH9jio8607WzjcfXlg folded before Flop (didn't bet)
Seat 3: +k7T5ocke8UwavtgUHm+Cg folded before Flop (didn't bet)
Seat 4: MG90wfSJZnOejs/KD3vlQQ showed [5c 5h] and won ($11.65) with two pair, Queens and Fives
Seat 5: E2518gp4aFz1+kAgmGqeEg (button) folded before Flop (didn't bet)
Seat 6: bxLSulbgr8LmKNjOzw8URg (small blind) folded before Flop
Seat 7: 75K2MXwN65Sjfp1yHd50Hg (big blind) folded before Flop
Seat 8: zE9cVigS2nW/Ljy4K4bUQA folded before Flop (didn't bet)
Seat 9: KcY3X8YpD74Kw1RHkx/g4A showed [Ks As] and lost with a pair of Queens



PokerStars Game #59940753054:  Hold'em No Limit ($0.25/$0.50) - 2009/07/01 1:15:35 ET
Table 'GfL/No5u5PoEnU39lP5pQg' 6-max Seat #2 is the button
Seat 1: 1WUCqNG+p+vfWRTXNu4ljw ($63.75 in chips)
Seat 2: uVwggSetzp7d+eVgowO3vg ($54.65 in chips)
Seat 3: 4pp9WxhGdbVbxCc9tlu0lw ($31.95 in chips)
Seat 4: r6u7MWSXF30/khcTYkrG9Q ($20.95 in chips)
Seat 5: M1KyQQvVPVuxqTAB8sR/zQ ($50.65 in chips)
Seat 6: kxPhs4ePFqMy52CInAJ2aw ($63.45 in chips)
4pp9WxhGdbVbxCc9tlu0lw: posts small blind $0.25
r6u7MWSXF30/khcTYkrG9Q: posts big blind $0.50
*** HOLE CARDS ***
M1KyQQvVPVuxqTAB8sR/zQ: folds
kxPhs4ePFqMy52CInAJ2aw: raises $1.50 to $2
1WUCqNG+p+vfWRTXNu4ljw: folds
uVwggSetzp7d+eVgowO3vg: folds
4pp9WxhGdbVbxCc9tlu0lw: folds
r6u7MWSXF30/khcTYkrG9Q: folds
kxPhs4ePFqMy52CInAJ2aw collected $1.25 from pot
kxPhs4ePFqMy52CInAJ2aw: doesn't show hand
*** SUMMARY ***
Total pot $1.25 | Rake $0
Seat 1: 1WUCqNG+p+vfWRTXNu4ljw folded before Flop (didn't bet)
Seat 2: uVwggSetzp7d+eVgowO3vg (button) folded before Flop (didn't bet)
Seat 3: 4pp9WxhGdbVbxCc9tlu0lw (small blind) folded before Flop
Seat 4: r6u7MWSXF30/khcTYkrG9Q (big blind) folded before Flop
Seat 5: M1KyQQvVPVuxqTAB8sR/zQ folded before Flop (didn't bet)
Seat 6: kxPhs4ePFqMy52CInAJ2aw collected ($1.25)



PokerStars Game #59940754382:  Hold'em No Limit ($0.25/$0.50) - 2009/07/01 1:15:37 ET
Table '5EmHi+fnatGQQShcNmzOZQ' 6-max Seat #6 is the button
Seat 1: My8WkRtGx5FW6rJ1I4R3hg ($42.60 in chips)
Seat 2: bfFjgAtIoAI+pUxUwFt3aQ ($38.95 in chips)
Seat 3: 1mYbhL8CU/QYqfVmFcaHDQ ($6.05 in chips)
Seat 4: 1b+2BbjMN8qhR1WPqdE9VQ ($58.35 in chips)
Seat 5: kxPhs4ePFqMy52CInAJ2aw ($93.10 in chips)
Seat 6: +Pf9jTVizYlIo+woPvptfA ($51.20 in chips)
My8WkRtGx5FW6rJ1I4R3hg: posts small blind $0.25
bfFjgAtIoAI+pUxUwFt3aQ: posts big blind $0.50
*** HOLE CARDS ***
1mYbhL8CU/QYqfVmFcaHDQ: folds
1b+2BbjMN8qhR1WPqdE9VQ: folds
kxPhs4ePFqMy52CInAJ2aw: folds
+Pf9jTVizYlIo+woPvptfA: folds
My8WkRtGx5FW6rJ1I4R3hg: calls $0.25
bfFjgAtIoAI+pUxUwFt3aQ: checks
*** FLOP *** [5c Kc 9h]
My8WkRtGx5FW6rJ1I4R3hg: checks
bfFjgAtIoAI+pUxUwFt3aQ: bets $1
My8WkRtGx5FW6rJ1I4R3hg: folds
bfFjgAtIoAI+pUxUwFt3aQ collected $0.95 from pot
*** SUMMARY ***
Total pot $1 | Rake $0.05
Board [5c Kc 9h]
Seat 1: My8WkRtGx5FW6rJ1I4R3hg (small blind) folded on the Flop
Seat 2: bfFjgAtIoAI+pUxUwFt3aQ (big blind) collected ($0.95)
Seat 3: 1mYbhL8CU/QYqfVmFcaHDQ folded before Flop (didn't bet)
Seat 4: 1b+2BbjMN8qhR1WPqdE9VQ folded before Flop (didn't bet)
Seat 5: kxPhs4ePFqMy52CInAJ2aw folded before Flop (didn't bet)
Seat 6: +Pf9jTVizYlIo+woPvptfA (button) folded before Flop (didn't bet)



PokerStars Game #59940754296:  Hold'em No Limit ($0.25/$0.50) - 2009/07/01 1:15:37 ET
Table 'ibNfFy0bCzuBaUORla0aGw' 9-max Seat #2 is the button
Seat 1: xZCXQSXlrZkp3pZizzVXCw ($50.55 in chips)
Seat 2: 90Wb75h3W1BRpbqVnuk8gw ($50 in chips)
Seat 3: AjV5McH1KMMclY26QdLM5w ($25 in chips)
Seat 4: YBN054X4blmis+B2bBlC0g ($22.65 in chips)
Seat 5: GIJAc9kPrLZHLSX8Q6i99w ($28.05 in chips)
Seat 6: H8cPaCtX7d6meGUVSM5sxw ($46.75 in chips)
Seat 7: HZkVla4kK2SI42CVrPZ/ig ($13.75 in chips)
Seat 8: viwBDtJsY6JfsFOdBAyJIQ ($13.95 in chips)
Seat 9: pFtzb1sR4b0d1aw6aIRgDg ($55.75 in chips)
AjV5McH1KMMclY26QdLM5w: posts small blind $0.25
YBN054X4blmis+B2bBlC0g: posts big blind $0.50
*** HOLE CARDS ***
GIJAc9kPrLZHLSX8Q6i99w: folds
H8cPaCtX7d6meGUVSM5sxw: calls $0.50
HZkVla4kK2SI42CVrPZ/ig: folds
viwBDtJsY6JfsFOdBAyJIQ: folds
pFtzb1sR4b0d1aw6aIRgDg: folds
xZCXQSXlrZkp3pZizzVXCw: folds
90Wb75h3W1BRpbqVnuk8gw: folds
AjV5McH1KMMclY26QdLM5w: folds
YBN054X4blmis+B2bBlC0g: checks
*** FLOP *** [8d Th As]
YBN054X4blmis+B2bBlC0g: checks
H8cPaCtX7d6meGUVSM5sxw: bets $1
YBN054X4blmis+B2bBlC0g: folds
H8cPaCtX7d6meGUVSM5sxw collected $1.20 from pot
*** SUMMARY ***
Total pot $1.25 | Rake $0.05
Board [8d Th As]
Seat 1: xZCXQSXlrZkp3pZizzVXCw folded before Flop (didn't bet)
Seat 2: 90Wb75h3W1BRpbqVnuk8gw (button) folded before Flop (didn't bet)
Seat 3: AjV5McH1KMMclY26QdLM5w (small blind) folded before Flop
Seat 4: YBN054X4blmis+B2bBlC0g (big blind) folded on the Flop
Seat 5: GIJAc9kPrLZHLSX8Q6i99w folded before Flop (didn't bet)
Seat 6: H8cPaCtX7d6meGUVSM5sxw collected ($1.20)
Seat 7: HZkVla4kK2SI42CVrPZ/ig folded before Flop (didn't bet)
Seat 8: viwBDtJsY6JfsFOdBAyJIQ folded before Flop (didn't bet)
Seat 9: pFtzb1sR4b0d1aw6aIRgDg folded before Flop (didn't bet)



PokerStars Game #59940755834:  Hold'em No Limit ($0.25/$0.50) - 2009/07/01 1:15:40 ET
Table 'PALRfuH85dr5IkDfdv6new' 9-max Seat #2 is the button
Seat 1: v/4aX0ejnaIFK4ftDk2Lyg ($48.75 in chips)
Seat 2: 1aXjSbrubyQKHeauooF5Wg ($42 in chips)
Seat 3: 50QWoELmpmHFrFIlWMJo9g ($91.85 in chips)
Seat 4: mZNMJI1mY40XTC0U7GZakA ($57.55 in chips)
Seat 6: ottZQkg1UDWk85BtBzGJzg ($50.10 in chips)
Seat 7: 3NcyXvr39gnK+KbTq7ezyA ($61.25 in chips)
Seat 8: NkS+CseUKx4XHszWq0PXEQ ($75.75 in chips)
Seat 9: viwBDtJsY6JfsFOdBAyJIQ ($9.75 in chips)
50QWoELmpmHFrFIlWMJo9g: posts small blind $0.25
mZNMJI1mY40XTC0U7GZakA: posts big blind $0.50
qEn9ijNGtuyTxamBf07hYg: sits out
*** HOLE CARDS ***
ottZQkg1UDWk85BtBzGJzg: folds
3NcyXvr39gnK+KbTq7ezyA: calls $0.50
NkS+CseUKx4XHszWq0PXEQ: folds
viwBDtJsY6JfsFOdBAyJIQ: folds
v/4aX0ejnaIFK4ftDk2Lyg: folds
1aXjSbrubyQKHeauooF5Wg: raises $2 to $2.50
50QWoELmpmHFrFIlWMJo9g: folds
mZNMJI1mY40XTC0U7GZakA: folds
3NcyXvr39gnK+KbTq7ezyA: calls $2
*** FLOP *** [Th 4s 2s]
3NcyXvr39gnK+KbTq7ezyA: checks
1aXjSbrubyQKHeauooF5Wg: bets $3.50
3NcyXvr39gnK+KbTq7ezyA: calls $3.50
*** TURN *** [Th 4s 2s] [Kd]
3NcyXvr39gnK+KbTq7ezyA: checks
1aXjSbrubyQKHeauooF5Wg: checks
*** RIVER *** [Th 4s 2s Kd] [Qs]
3NcyXvr39gnK+KbTq7ezyA: checks
1aXjSbrubyQKHeauooF5Wg: checks
*** SHOW DOWN ***
3NcyXvr39gnK+KbTq7ezyA: shows [3d Ad] (high card Ace)
1aXjSbrubyQKHeauooF5Wg: shows [Jh Jd] (a pair of Jacks)
1aXjSbrubyQKHeauooF5Wg collected $12.15 from pot
*** SUMMARY ***
Total pot $12.75 | Rake $0.60
Board [Th 4s 2s Kd Qs]
Seat 1: v/4aX0ejnaIFK4ftDk2Lyg folded before Flop (didn't bet)
Seat 2: 1aXjSbrubyQKHeauooF5Wg (button) showed [Jh Jd] and won ($12.15) with a pair of Jacks
Seat 3: 50QWoELmpmHFrFIlWMJo9g (small blind) folded before Flop
Seat 4: mZNMJI1mY40XTC0U7GZakA (big blind) folded before Flop
Seat 6: ottZQkg1UDWk85BtBzGJzg folded before Flop (didn't bet)
Seat 7: 3NcyXvr39gnK+KbTq7ezyA showed [3d Ad] and lost with high card Ace
Seat 8: NkS+CseUKx4XHszWq0PXEQ folded before Flop (didn't bet)
Seat 9: viwBDtJsY6JfsFOdBAyJIQ folded before Flop (didn't bet)



PokerStars Game #59940757074:  Hold'em No Limit ($0.25/$0.50) - 2009/07/01 1:15:42 ET
Table 'tyR5AZNKV8Aadbrnrnlg7g' 6-max Seat #4 is the button
Seat 1: BgOXYI0yYSN1ULC4FqsNkg ($95.30 in chips)
Seat 2: BAjwVL+zKKd0s0fAWstzQQ ($69.80 in chips)
Seat 3: JFLrYNyQmwPhRQAtoSAuyA ($51.20 in chips)
Seat 4: 4QfsCWthT/vSLirorNXqtg ($76.15 in chips)
Seat 5: GUnvMULl2qFOO1yenu1UBw ($50 in chips)
Seat 6: 498aWaGsW4uGfuWl+2FCGw ($41.10 in chips)
GUnvMULl2qFOO1yenu1UBw: posts small blind $0.25
498aWaGsW4uGfuWl+2FCGw: posts big blind $0.50
*** HOLE CARDS ***
BgOXYI0yYSN1ULC4FqsNkg: calls $0.50
BAjwVL+zKKd0s0fAWstzQQ: calls $0.50
JFLrYNyQmwPhRQAtoSAuyA: calls $0.50
4QfsCWthT/vSLirorNXqtg: folds
GUnvMULl2qFOO1yenu1UBw: folds
498aWaGsW4uGfuWl+2FCGw: checks
*** FLOP *** [4h 6d 3d]
498aWaGsW4uGfuWl+2FCGw: checks
BgOXYI0yYSN1ULC4FqsNkg: checks
BAjwVL+zKKd0s0fAWstzQQ: checks
JFLrYNyQmwPhRQAtoSAuyA: bets $1.50
498aWaGsW4uGfuWl+2FCGw: folds
BgOXYI0yYSN1ULC4FqsNkg: folds
BAjwVL+zKKd0s0fAWstzQQ: folds
JFLrYNyQmwPhRQAtoSAuyA collected $2.15 from pot
JFLrYNyQmwPhRQAtoSAuyA: doesn't show hand
*** SUMMARY ***
Total pot $2.25 | Rake $0.10
Board [4h 6d 3d]
Seat 1: BgOXYI0yYSN1ULC4FqsNkg folded on the Flop
Seat 2: BAjwVL+zKKd0s0fAWstzQQ folded on the Flop
Seat 3: JFLrYNyQmwPhRQAtoSAuyA collected ($2.15)
Seat 4: 4QfsCWthT/vSLirorNXqtg (button) folded before Flop (didn't bet)
Seat 5: GUnvMULl2qFOO1yenu1UBw (small blind) folded before Flop
Seat 6: 498aWaGsW4uGfuWl+2FCGw (big blind) folded on the Flop



PokerStars Game #59940757194:  Hold'em No Limit ($0.25/$0.50) - 2009/07/01 1:15:42 ET
Table 'fx6MqwfYAj/Rt86hBz2L3Q' 9-max Seat #2 is the button
Seat 1: v/4aX0ejnaIFK4ftDk2Lyg ($50 in chips)
Seat 2: C3rGXblctNcWI6JYPHhaEg ($34.50 in chips)
Seat 3: iadBi5AEt7gTBXbDSSnMYQ ($50.65 in chips)
Seat 5: iAISe3dVeua8PUn2wwgDHw ($65.25 in chips)
Seat 6: 5k9fvXD9suIgCxU4HLQjTw ($50 in chips)
Seat 7: SKnJuWHScqetA/qG5p+wCg ($34.95 in chips)
Seat 8: JYwJYYV9pM5KWdSiETl8rA ($24 in chips)
iadBi5AEt7gTBXbDSSnMYQ: posts small blind $0.25
iAISe3dVeua8PUn2wwgDHw: posts big blind $0.50
v/4aX0ejnaIFK4ftDk2Lyg: posts big blind $0.50
*** HOLE CARDS ***
5k9fvXD9suIgCxU4HLQjTw: folds
SKnJuWHScqetA/qG5p+wCg: folds
JYwJYYV9pM5KWdSiETl8rA: calls $0.50
v/4aX0ejnaIFK4ftDk2Lyg: checks
vO3QVRovWemcGMkm7ijAIA joins the table at seat #9
C3rGXblctNcWI6JYPHhaEg: calls $0.50
iadBi5AEt7gTBXbDSSnMYQ: folds
iAISe3dVeua8PUn2wwgDHw: checks
*** FLOP *** [3c 6h Kh]
iAISe3dVeua8PUn2wwgDHw: checks
JYwJYYV9pM5KWdSiETl8rA: checks
v/4aX0ejnaIFK4ftDk2Lyg: checks
C3rGXblctNcWI6JYPHhaEg: bets $2
iAISe3dVeua8PUn2wwgDHw: calls $2
JYwJYYV9pM5KWdSiETl8rA: calls $2
v/4aX0ejnaIFK4ftDk2Lyg: folds
*** TURN *** [3c 6h Kh] [8c]
iAISe3dVeua8PUn2wwgDHw: bets $0.50
JYwJYYV9pM5KWdSiETl8rA: calls $0.50
C3rGXblctNcWI6JYPHhaEg: raises $1.50 to $2
iAISe3dVeua8PUn2wwgDHw: calls $1.50
JYwJYYV9pM5KWdSiETl8rA: calls $1.50
*** RIVER *** [3c 6h Kh 8c] [Ts]
iAISe3dVeua8PUn2wwgDHw: checks
JYwJYYV9pM5KWdSiETl8rA: checks
C3rGXblctNcWI6JYPHhaEg: bets $7
iAISe3dVeua8PUn2wwgDHw: folds
JYwJYYV9pM5KWdSiETl8rA: folds
C3rGXblctNcWI6JYPHhaEg collected $13.60 from pot
C3rGXblctNcWI6JYPHhaEg: doesn't show hand
*** SUMMARY ***
Total pot $14.25 | Rake $0.65
Board [3c 6h Kh 8c Ts]
Seat 1: v/4aX0ejnaIFK4ftDk2Lyg folded on the Flop
Seat 2: C3rGXblctNcWI6JYPHhaEg (button) collected ($13.60)
Seat 3: iadBi5AEt7gTBXbDSSnMYQ (small blind) folded before Flop
Seat 5: iAISe3dVeua8PUn2wwgDHw (big blind) folded on the River
Seat 6: 5k9fvXD9suIgCxU4HLQjTw folded before Flop (didn't bet)
Seat 7: SKnJuWHScqetA/qG5p+wCg folded before Flop (didn't bet)
Seat 8: JYwJYYV9pM5KWdSiETl8rA folded on the River



PokerStars Game #59940757142:  Hold'em No Limit ($0.25/$0.50) - 2009/07/01 1:15:42 ET
Table 'c/CRn+68J3Y8KxD5g1ek2Q' 2-max Seat #1 is the button
Seat 1: 46qCyJ6evTkHo9al5sBMNA ($113.40 in chips)
Seat 2: BypVLsYQt3ePFm2xQL/dOA ($250.15 in chips)
46qCyJ6evTkHo9al5sBMNA: posts small blind $0.25
BypVLsYQt3ePFm2xQL/dOA: posts big blind $0.50
*** HOLE CARDS ***
46qCyJ6evTkHo9al5sBMNA: folds
BypVLsYQt3ePFm2xQL/dOA collected $0.50 from pot
BypVLsYQt3ePFm2xQL/dOA: doesn't show hand
*** SUMMARY ***
Total pot $0.50 | Rake $0
Seat 1: 46qCyJ6evTkHo9al5sBMNA (button) (small blind) folded before Flop
Seat 2: BypVLsYQt3ePFm2xQL/dOA (big blind) collected ($0.50)



PokerStars Game #59940761062:  Hold'em No Limit ($0.25/$0.50) - 2009/07/01 1:15:49 ET
Table '8BQGgNetI1NOvWeu3gtMNw' 2-max Seat #2 is the button
Seat 1: bypIyrYcAAifLfhZpGlKLA ($66.15 in chips)
Seat 2: Z4HwehErEwzsv/noQlfUlg ($127.65 in chips)
Z4HwehErEwzsv/noQlfUlg: posts small blind $0.25
bypIyrYcAAifLfhZpGlKLA: posts big blind $0.50
*** HOLE CARDS ***
Z4HwehErEwzsv/noQlfUlg: folds
bypIyrYcAAifLfhZpGlKLA collected $0.50 from pot
bypIyrYcAAifLfhZpGlKLA: doesn't show hand
*** SUMMARY ***
Total pot $0.50 | Rake $0
Seat 1: bypIyrYcAAifLfhZpGlKLA (big blind) collected ($0.50)
Seat 2: Z4HwehErEwzsv/noQlfUlg (button) (small blind) folded before Flop



PokerStars Game #59940761578:  Hold'em No Limit ($0.25/$0.50) - 2009/07/01 1:15:50 ET
Table '9Puy2HWN1RQe5SSjq162gA' 2-max Seat #2 is the button
Seat 1: Fp/oksNpipCrD2MJ2pH20g ($6.65 in chips)
Seat 2: bUQEKmQTneRNtujMucgwag ($41.95 in chips)
bUQEKmQTneRNtujMucgwag: posts small blind $0.25
Fp/oksNpipCrD2MJ2pH20g: posts big blind $0.50
*** HOLE CARDS ***
bUQEKmQTneRNtujMucgwag: raises $1 to $1.50
Fp/oksNpipCrD2MJ2pH20g: calls $1
*** FLOP *** [5h 5c 2s]
Fp/oksNpipCrD2MJ2pH20g: bets $5.15 and is all-in
bUQEKmQTneRNtujMucgwag: calls $5.15
*** TURN *** [5h 5c 2s] [3h]
*** RIVER *** [5h 5c 2s 3h] [5s]
*** SHOW DOWN ***
Fp/oksNpipCrD2MJ2pH20g: shows [Ks 4d] (three of a kind, Fives)
bUQEKmQTneRNtujMucgwag: shows [Qh Ah] (three of a kind, Fives - Ace kicker)
bUQEKmQTneRNtujMucgwag collected $12.80 from pot
*** SUMMARY ***
Total pot $13.30 | Rake $0.50
Board [5h 5c 2s 3h 5s]
Seat 1: Fp/oksNpipCrD2MJ2pH20g (big blind) showed [Ks 4d] and lost with three of a kind, Fives
Seat 2: bUQEKmQTneRNtujMucgwag (button) (small blind) showed [Qh Ah] and won ($12.80) with three of a kind, Fives



PokerStars Game #59940761542:  Hold'em No Limit ($0.25/$0.50) - 2009/07/01 1:15:50 ET
Table 'c/CRn+68J3Y8KxD5g1ek2Q' 2-max Seat #2 is the button
Seat 1: 46qCyJ6evTkHo9al5sBMNA ($113.15 in chips)
Seat 2: BypVLsYQt3ePFm2xQL/dOA ($250.40 in chips)
BypVLsYQt3ePFm2xQL/dOA: posts small blind $0.25
46qCyJ6evTkHo9al5sBMNA: posts big blind $0.50
*** HOLE CARDS ***
BypVLsYQt3ePFm2xQL/dOA: calls $0.25
46qCyJ6evTkHo9al5sBMNA: checks
*** FLOP *** [5c 3s 8c]
46qCyJ6evTkHo9al5sBMNA: checks
BypVLsYQt3ePFm2xQL/dOA: bets $2
46qCyJ6evTkHo9al5sBMNA: calls $2
*** TURN *** [5c 3s 8c] [9s]
46qCyJ6evTkHo9al5sBMNA: checks
BypVLsYQt3ePFm2xQL/dOA: bets $2.50
46qCyJ6evTkHo9al5sBMNA: calls $2.50
*** RIVER *** [5c 3s 8c 9s] [6h]
46qCyJ6evTkHo9al5sBMNA: checks
BypVLsYQt3ePFm2xQL/dOA: checks
*** SHOW DOWN ***
46qCyJ6evTkHo9al5sBMNA: shows [4c 2s] (a straight, Deuce to Six)
BypVLsYQt3ePFm2xQL/dOA: mucks hand
46qCyJ6evTkHo9al5sBMNA collected $9.55 from pot
*** SUMMARY ***
Total pot $10 | Rake $0.45
Board [5c 3s 8c 9s 6h]
Seat 1: 46qCyJ6evTkHo9al5sBMNA (big blind) showed [4c 2s] and won ($9.55) with a straight, Deuce to Six
Seat 2: BypVLsYQt3ePFm2xQL/dOA (button) (small blind) mucked



PokerStars Game #59940762242:  Hold'em No Limit ($0.25/$0.50) - 2009/07/01 1:15:51 ET
Table 'BCN5su+SsXiy1zRMJi0SJw' 6-max Seat #3 is the button
Seat 1: GxXV09ciXaOxyY2H5aMIIw ($55.35 in chips)
Seat 2: oU2kDCkT/gilYbHWrg7D8w ($38.45 in chips)
Seat 3: kwgv5lNhiFrfONXCshzxlA ($29.85 in chips)
Seat 4: 4QfsCWthT/vSLirorNXqtg ($52.50 in chips)
Seat 5: cEMJmfAUQZmMChZe6aacKw ($24.50 in chips)
Seat 6: b2symlOdL7+0c9Pj4N/KlA ($58.15 in chips)
4QfsCWthT/vSLirorNXqtg: posts small blind $0.25
cEMJmfAUQZmMChZe6aacKw: posts big blind $0.50
*** HOLE CARDS ***
b2symlOdL7+0c9Pj4N/KlA: raises $1.50 to $2
GxXV09ciXaOxyY2H5aMIIw: folds
oU2kDCkT/gilYbHWrg7D8w: folds
kwgv5lNhiFrfONXCshzxlA: folds
4QfsCWthT/vSLirorNXqtg: folds
cEMJmfAUQZmMChZe6aacKw: folds
b2symlOdL7+0c9Pj4N/KlA collected $1.25 from pot
b2symlOdL7+0c9Pj4N/KlA: doesn't show hand
*** SUMMARY ***
Total pot $1.25 | Rake $0
Seat 1: GxXV09ciXaOxyY2H5aMIIw folded before Flop (didn't bet)
Seat 2: oU2kDCkT/gilYbHWrg7D8w folded before Flop (didn't bet)
Seat 3: kwgv5lNhiFrfONXCshzxlA (button) folded before Flop (didn't bet)
Seat 4: 4QfsCWthT/vSLirorNXqtg (small blind) folded before Flop
Seat 5: cEMJmfAUQZmMChZe6aacKw (big blind) folded before Flop
Seat 6: b2symlOdL7+0c9Pj4N/KlA collected ($1.25)



PokerStars Game #59940762240:  Hold'em No Limit ($0.25/$0.50) - 2009/07/01 1:15:51 ET
Table 'EiNh8p/wGJ1FP575iMFnqg' 9-max Seat #4 is the button
Seat 1: r3ZqM1Mi0W3y4hOdssE+Sg ($66.50 in chips)
Seat 2: 8ehL7qlZzjgUh2H35iiWLw ($58.40 in chips)
Seat 3: ymLPoEIl7UL3TvZYmnadxQ ($55.55 in chips)
Seat 4: cMzaiXAM/ZAdNaEUu+LqhA ($50 in chips)
Seat 5: M+7+BTmX5vZatHVuoRB1nA ($79.95 in chips)
Seat 7: 997ViqAtWn1FPjJqcffwcA ($50 in chips)
Seat 8: mSD1pginDsyHG5PDfqzphw ($10 in chips)
Seat 9: GuPkZObrz5Zkkn8FsEdF9w ($30 in chips)
M+7+BTmX5vZatHVuoRB1nA: posts small blind $0.25
3UmXLy3GfjC3EkOebduerQ: is sitting out
997ViqAtWn1FPjJqcffwcA: posts big blind $0.50
*** HOLE CARDS ***
mSD1pginDsyHG5PDfqzphw: folds
3UmXLy3GfjC3EkOebduerQ leaves the table
GuPkZObrz5Zkkn8FsEdF9w: folds
r3ZqM1Mi0W3y4hOdssE+Sg: folds
8ehL7qlZzjgUh2H35iiWLw: raises $1.50 to $2
ymLPoEIl7UL3TvZYmnadxQ: folds
cMzaiXAM/ZAdNaEUu+LqhA: folds
M+7+BTmX5vZatHVuoRB1nA: folds
997ViqAtWn1FPjJqcffwcA: folds
8ehL7qlZzjgUh2H35iiWLw collected $1.25 from pot
8ehL7qlZzjgUh2H35iiWLw: doesn't show hand
*** SUMMARY ***
Total pot $1.25 | Rake $0
Seat 1: r3ZqM1Mi0W3y4hOdssE+Sg folded before Flop (didn't bet)
Seat 2: 8ehL7qlZzjgUh2H35iiWLw collected ($1.25)
Seat 3: ymLPoEIl7UL3TvZYmnadxQ folded before Flop (didn't bet)
Seat 4: cMzaiXAM/ZAdNaEUu+LqhA (button) folded before Flop (didn't bet)
Seat 5: M+7+BTmX5vZatHVuoRB1nA (small blind) folded before Flop
Seat 7: 997ViqAtWn1FPjJqcffwcA (big blind) folded before Flop
Seat 8: mSD1pginDsyHG5PDfqzphw folded before Flop (didn't bet)
Seat 9: GuPkZObrz5Zkkn8FsEdF9w folded before Flop (didn't bet)



PokerStars Game #59940762198:  Hold'em No Limit ($0.25/$0.50) - 2009/07/01 1:15:51 ET
Table 'lpxYasB1ClBSgTpCCITwhQ' 9-max Seat #1 is the button
Seat 1: mj7PS7wCH4PAl7+eYTFs7A ($49.95 in chips)
Seat 2: OWP/DOu+PlPK6ZZ3zYa0HA ($25.35 in chips)
Seat 3: sakr/FIfFtIZwDPmAj5Pzg ($49.20 in chips)
Seat 4: NnQCepdIR/AOUQn1yhYx6Q ($9.25 in chips)
Seat 6: SegjDnMxWMujiD57ESNL+g ($7.10 in chips)
Seat 7: bmRtaIYKthN1F+B3JLZ3Jw ($74.10 in chips)
Seat 8: /mfensKw8/iZ1Vrx33S4xg ($11.50 in chips)
Seat 9: sUIUZ+begh92dzkUmvbMrw ($24.65 in chips)
OWP/DOu+PlPK6ZZ3zYa0HA: posts small blind $0.25
sakr/FIfFtIZwDPmAj5Pzg: posts big blind $0.50
*** HOLE CARDS ***
NnQCepdIR/AOUQn1yhYx6Q: folds
SegjDnMxWMujiD57ESNL+g: folds
bmRtaIYKthN1F+B3JLZ3Jw: raises $0.50 to $1
/mfensKw8/iZ1Vrx33S4xg: folds
sUIUZ+begh92dzkUmvbMrw: folds
mj7PS7wCH4PAl7+eYTFs7A: folds
OWP/DOu+PlPK6ZZ3zYa0HA: folds
sakr/FIfFtIZwDPmAj5Pzg: calls $0.50
*** FLOP *** [Ah 4h 3d]
sakr/FIfFtIZwDPmAj5Pzg: checks
bmRtaIYKthN1F+B3JLZ3Jw: bets $0.50
sakr/FIfFtIZwDPmAj5Pzg: calls $0.50
*** TURN *** [Ah 4h 3d] [5s]
sakr/FIfFtIZwDPmAj5Pzg: checks
bmRtaIYKthN1F+B3JLZ3Jw: checks
*** RIVER *** [Ah 4h 3d 5s] [4d]
sakr/FIfFtIZwDPmAj5Pzg: bets $2
bmRtaIYKthN1F+B3JLZ3Jw: folds
sakr/FIfFtIZwDPmAj5Pzg collected $3.10 from pot
sakr/FIfFtIZwDPmAj5Pzg: doesn't show hand
*** SUMMARY ***
Total pot $3.25 | Rake $0.15
Board [Ah 4h 3d 5s 4d]
Seat 1: mj7PS7wCH4PAl7+eYTFs7A (button) folded before Flop (didn't bet)
Seat 2: OWP/DOu+PlPK6ZZ3zYa0HA (small blind) folded before Flop
Seat 3: sakr/FIfFtIZwDPmAj5Pzg (big blind) collected ($3.10)
Seat 4: NnQCepdIR/AOUQn1yhYx6Q folded before Flop (didn't bet)
Seat 6: SegjDnMxWMujiD57ESNL+g folded before Flop (didn't bet)
Seat 7: bmRtaIYKthN1F+B3JLZ3Jw folded on the River
Seat 8: /mfensKw8/iZ1Vrx33S4xg folded before Flop (didn't bet)
Seat 9: sUIUZ+begh92dzkUmvbMrw folded before Flop (didn't bet)



PokerStars Game #59940763848:  Hold'em No Limit ($0.25/$0.50) - 2009/07/01 1:15:54 ET
Table 'GfL/No5u5PoEnU39lP5pQg' 6-max Seat #3 is the button
Seat 1: 1WUCqNG+p+vfWRTXNu4ljw ($63.75 in chips)
Seat 2: uVwggSetzp7d+eVgowO3vg ($54.65 in chips)
Seat 3: 4pp9WxhGdbVbxCc9tlu0lw ($31.70 in chips)
Seat 4: r6u7MWSXF30/khcTYkrG9Q ($20.45 in chips)
Seat 5: M1KyQQvVPVuxqTAB8sR/zQ ($50.65 in chips)
Seat 6: kxPhs4ePFqMy52CInAJ2aw ($64.20 in chips)
r6u7MWSXF30/khcTYkrG9Q: posts small blind $0.25
M1KyQQvVPVuxqTAB8sR/zQ: posts big blind $0.50
*** HOLE CARDS ***
kxPhs4ePFqMy52CInAJ2aw: folds
1WUCqNG+p+vfWRTXNu4ljw: folds
uVwggSetzp7d+eVgowO3vg: calls $0.50
4pp9WxhGdbVbxCc9tlu0lw: folds
r6u7MWSXF30/khcTYkrG9Q: calls $0.25
M1KyQQvVPVuxqTAB8sR/zQ: checks
*** FLOP *** [5d Ah Tc]
r6u7MWSXF30/khcTYkrG9Q: checks
M1KyQQvVPVuxqTAB8sR/zQ: checks
uVwggSetzp7d+eVgowO3vg: checks
*** TURN *** [5d Ah Tc] [3d]
r6u7MWSXF30/khcTYkrG9Q: checks
M1KyQQvVPVuxqTAB8sR/zQ: checks
uVwggSetzp7d+eVgowO3vg: checks
*** RIVER *** [5d Ah Tc 3d] [Th]
r6u7MWSXF30/khcTYkrG9Q: checks
M1KyQQvVPVuxqTAB8sR/zQ: checks
uVwggSetzp7d+eVgowO3vg: checks
*** SHOW DOWN ***
r6u7MWSXF30/khcTYkrG9Q: shows [Jc 4c] (a pair of Tens)
M1KyQQvVPVuxqTAB8sR/zQ: mucks hand
uVwggSetzp7d+eVgowO3vg: shows [5s 7d] (two pair, Tens and Fives)
uVwggSetzp7d+eVgowO3vg collected $1.45 from pot
*** SUMMARY ***
Total pot $1.50 | Rake $0.05
Board [5d Ah Tc 3d Th]
Seat 1: 1WUCqNG+p+vfWRTXNu4ljw folded before Flop (didn't bet)
Seat 2: uVwggSetzp7d+eVgowO3vg showed [5s 7d] and won ($1.45) with two pair, Tens and Fives
Seat 3: 4pp9WxhGdbVbxCc9tlu0lw (button) folded before Flop (didn't bet)
Seat 4: r6u7MWSXF30/khcTYkrG9Q (small blind) showed [Jc 4c] and lost with a pair of Tens
Seat 5: M1KyQQvVPVuxqTAB8sR/zQ (big blind) mucked
Seat 6: kxPhs4ePFqMy52CInAJ2aw folded before Flop (didn't bet)



PokerStars Game #59940764654:  Hold'em No Limit ($0.25/$0.50) - 2009/07/01 1:15:55 ET
Table 'X6IRCRTh+20gjz8aubWnwA' 9-max Seat #4 is the button
Seat 2: HZkVla4kK2SI42CVrPZ/ig ($5.80 in chips)
Seat 3: SWv01peOe69QQRvhQTqjQw ($5.05 in chips)
Seat 4: M3JFBNQ8Bbw3FBZ/18MuXw ($25.90 in chips)
Seat 5: NnQCepdIR/AOUQn1yhYx6Q ($8.75 in chips)
Seat 6: 75K2MXwN65Sjfp1yHd50Hg ($11.70 in chips)
Seat 7: cFHQjKQOOKTUzoilhrXHLg ($13.25 in chips)
Seat 8: HxeBVq06/3Bh/H986sgdbw ($49.25 in chips)
Seat 9: M+7+BTmX5vZatHVuoRB1nA ($45.55 in chips)
NnQCepdIR/AOUQn1yhYx6Q: posts small blind $0.25
75K2MXwN65Sjfp1yHd50Hg: posts big blind $0.50
E2518gp4aFz1+kAgmGqeEg: sits out
*** HOLE CARDS ***
cFHQjKQOOKTUzoilhrXHLg: calls $0.50
HxeBVq06/3Bh/H986sgdbw: folds
M+7+BTmX5vZatHVuoRB1nA: folds
HZkVla4kK2SI42CVrPZ/ig: folds
SWv01peOe69QQRvhQTqjQw: folds
M3JFBNQ8Bbw3FBZ/18MuXw: folds
NnQCepdIR/AOUQn1yhYx6Q: folds
75K2MXwN65Sjfp1yHd50Hg: checks
*** FLOP *** [2d 8d Jc]
75K2MXwN65Sjfp1yHd50Hg: checks
cFHQjKQOOKTUzoilhrXHLg: checks
*** TURN *** [2d 8d Jc] [8c]
75K2MXwN65Sjfp1yHd50Hg: bets $1
cFHQjKQOOKTUzoilhrXHLg: folds
75K2MXwN65Sjfp1yHd50Hg collected $1.20 from pot
75K2MXwN65Sjfp1yHd50Hg: doesn't show hand
*** SUMMARY ***
Total pot $1.25 | Rake $0.05
Board [2d 8d Jc 8c]
Seat 2: HZkVla4kK2SI42CVrPZ/ig folded before Flop (didn't bet)
Seat 3: SWv01peOe69QQRvhQTqjQw folded before Flop (didn't bet)
Seat 4: M3JFBNQ8Bbw3FBZ/18MuXw (button) folded before Flop (didn't bet)
Seat 5: NnQCepdIR/AOUQn1yhYx6Q (small blind) folded before Flop
Seat 6: 75K2MXwN65Sjfp1yHd50Hg (big blind) collected ($1.20)
Seat 7: cFHQjKQOOKTUzoilhrXHLg folded on the Turn
Seat 8: HxeBVq06/3Bh/H986sgdbw folded before Flop (didn't bet)
Seat 9: M+7+BTmX5vZatHVuoRB1nA folded before Flop (didn't bet)



PokerStars Game #59940764530:  Hold'em No Limit ($0.25/$0.50) - 2009/07/01 1:15:55 ET
Table '37qXEp3oe+er5q4CZip9eQ' 6-max Seat #3 is the button
Seat 1: lxIzoHy0RnkfFSODHC2liw ($50 in chips)
Seat 2: LvH4G7n+QSjT6NDaD3cREA ($59.10 in chips)
Seat 3: Rt6KgtZ8YaJoTc3FPim00w ($108.45 in chips)
Seat 4: XsmE8nXMAAMFJbWaJTmHFw ($60.55 in chips)
Seat 5: VOmI0x4dDPnTESZd5B4d1Q ($35.75 in chips)
XsmE8nXMAAMFJbWaJTmHFw: posts small blind $0.25
VOmI0x4dDPnTESZd5B4d1Q: posts big blind $0.50
*** HOLE CARDS ***
lxIzoHy0RnkfFSODHC2liw: folds
LvH4G7n+QSjT6NDaD3cREA: folds
Rt6KgtZ8YaJoTc3FPim00w: folds
XsmE8nXMAAMFJbWaJTmHFw: folds
VOmI0x4dDPnTESZd5B4d1Q collected $0.50 from pot
*** SUMMARY ***
Total pot $0.50 | Rake $0
Seat 1: lxIzoHy0RnkfFSODHC2liw folded before Flop (didn't bet)
Seat 2: LvH4G7n+QSjT6NDaD3cREA folded before Flop (didn't bet)
Seat 3: Rt6KgtZ8YaJoTc3FPim00w (button) folded before Flop (didn't bet)
Seat 4: XsmE8nXMAAMFJbWaJTmHFw (small blind) folded before Flop
Seat 5: VOmI0x4dDPnTESZd5B4d1Q (big blind) collected ($0.50)



PokerStars Game #59940765048:  Hold'em No Limit ($0.25/$0.50) - 2009/07/01 1:15:56 ET
Table '8BQGgNetI1NOvWeu3gtMNw' 2-max Seat #1 is the button
Seat 1: bypIyrYcAAifLfhZpGlKLA ($66.40 in chips)
Seat 2: Z4HwehErEwzsv/noQlfUlg ($127.40 in chips)
bypIyrYcAAifLfhZpGlKLA: posts small blind $0.25
Z4HwehErEwzsv/noQlfUlg: posts big blind $0.50
*** HOLE CARDS ***
bypIyrYcAAifLfhZpGlKLA: raises $1 to $1.50
Z4HwehErEwzsv/noQlfUlg: folds
bypIyrYcAAifLfhZpGlKLA collected $1 from pot
bypIyrYcAAifLfhZpGlKLA: doesn't show hand
*** SUMMARY ***
Total pot $1 | Rake $0
Seat 1: bypIyrYcAAifLfhZpGlKLA (button) (small blind) collected ($1)
Seat 2: Z4HwehErEwzsv/noQlfUlg (big blind) folded before Flop



PokerStars Game #59940766238:  Hold'em No Limit ($0.25/$0.50) - 2009/07/01 1:15:58 ET
Table 'lSisgp6H7Fg1hH5VfjEjYQ' 9-max Seat #5 is the button
Seat 1: 5k9fvXD9suIgCxU4HLQjTw ($50 in chips)
Seat 2: UrcnkQOiLVk8BlKDPJSy7Q ($77.90 in chips)
Seat 3: aTkyjTh3w5YLWiIERupZOA ($55.70 in chips)
Seat 4: bwv/rbH/hHhPhY6u9mu04w ($34.35 in chips)
Seat 5: mSD1pginDsyHG5PDfqzphw ($13 in chips)
Seat 6: +k7T5ocke8UwavtgUHm+Cg ($64.90 in chips)
Seat 7: IDtNLR9uFCDdjNsJWMHA5Q ($22.05 in chips)
Seat 8: a4JDWmpFQkL10XfAyuF51A ($16.25 in chips)
Seat 9: YzeKFbJVLmJGTgNH3ySQlw ($11.45 in chips)
+k7T5ocke8UwavtgUHm+Cg: posts small blind $0.25
IDtNLR9uFCDdjNsJWMHA5Q: posts big blind $0.50
*** HOLE CARDS ***
a4JDWmpFQkL10XfAyuF51A: folds
YzeKFbJVLmJGTgNH3ySQlw: calls $0.50
5k9fvXD9suIgCxU4HLQjTw: folds
UrcnkQOiLVk8BlKDPJSy7Q: folds
aTkyjTh3w5YLWiIERupZOA: calls $0.50
bwv/rbH/hHhPhY6u9mu04w: calls $0.50
mSD1pginDsyHG5PDfqzphw: folds
+k7T5ocke8UwavtgUHm+Cg: calls $0.25
IDtNLR9uFCDdjNsJWMHA5Q: checks
*** FLOP *** [9c Ah 6s]
+k7T5ocke8UwavtgUHm+Cg: checks
IDtNLR9uFCDdjNsJWMHA5Q: checks
YzeKFbJVLmJGTgNH3ySQlw: checks
aTkyjTh3w5YLWiIERupZOA: checks
bwv/rbH/hHhPhY6u9mu04w: checks
*** TURN *** [9c Ah 6s] [8c]
+k7T5ocke8UwavtgUHm+Cg: checks
IDtNLR9uFCDdjNsJWMHA5Q: checks
YzeKFbJVLmJGTgNH3ySQlw: bets $2
aTkyjTh3w5YLWiIERupZOA: folds
bwv/rbH/hHhPhY6u9mu04w: folds
+k7T5ocke8UwavtgUHm+Cg: folds
IDtNLR9uFCDdjNsJWMHA5Q: folds
YzeKFbJVLmJGTgNH3ySQlw collected $2.40 from pot
*** SUMMARY ***
Total pot $2.50 | Rake $0.10
Board [9c Ah 6s 8c]
Seat 1: 5k9fvXD9suIgCxU4HLQjTw folded before Flop (didn't bet)
Seat 2: UrcnkQOiLVk8BlKDPJSy7Q folded before Flop (didn't bet)
Seat 3: aTkyjTh3w5YLWiIERupZOA folded on the Turn
Seat 4: bwv/rbH/hHhPhY6u9mu04w folded on the Turn
Seat 5: mSD1pginDsyHG5PDfqzphw (button) folded before Flop (didn't bet)
Seat 6: +k7T5ocke8UwavtgUHm+Cg (small blind) folded on the Turn
Seat 7: IDtNLR9uFCDdjNsJWMHA5Q (big blind) folded on the Turn
Seat 8: a4JDWmpFQkL10XfAyuF51A folded before Flop (didn't bet)
Seat 9: YzeKFbJVLmJGTgNH3ySQlw collected ($2.40)



PokerStars Game #59940766708:  Hold'em No Limit ($0.25/$0.50) - 2009/07/01 1:15:59 ET
Table 'hSTs/dUsYLgJQuF2Onp0MQ' 6-max Seat #3 is the button
Seat 1: 1WUCqNG+p+vfWRTXNu4ljw ($50.50 in chips)
Seat 3: C3qJBo7uxfFVDluE1lmK2w ($31.10 in chips)
Seat 5: IBNygaT1aa9Z1uPdJJilwA ($33.35 in chips)
Seat 6: M1KyQQvVPVuxqTAB8sR/zQ ($88.95 in chips)
2igtJLmvIZ+HqX4XPgMPZA will be allowed to play after the button
IBNygaT1aa9Z1uPdJJilwA: posts small blind $0.25
M1KyQQvVPVuxqTAB8sR/zQ: posts big blind $0.50
*** HOLE CARDS ***
1WUCqNG+p+vfWRTXNu4ljw: folds
C3qJBo7uxfFVDluE1lmK2w: folds
IBNygaT1aa9Z1uPdJJilwA: calls $0.25
M1KyQQvVPVuxqTAB8sR/zQ: checks
*** FLOP *** [2h 8h Ah]
IBNygaT1aa9Z1uPdJJilwA: bets $1
M1KyQQvVPVuxqTAB8sR/zQ: folds
IBNygaT1aa9Z1uPdJJilwA collected $0.95 from pot
*** SUMMARY ***
Total pot $1 | Rake $0.05
Board [2h 8h Ah]
Seat 1: 1WUCqNG+p+vfWRTXNu4ljw folded before Flop (didn't bet)
Seat 3: C3qJBo7uxfFVDluE1lmK2w (button) folded before Flop (didn't bet)
Seat 5: IBNygaT1aa9Z1uPdJJilwA (small blind) collected ($0.95)
Seat 6: M1KyQQvVPVuxqTAB8sR/zQ (big blind) folded on the Flop



PokerStars Game #59940769262:  Hold'em No Limit ($0.25/$0.50) - 2009/07/01 1:16:03 ET
Table 'NCiXr0d5CEKBQr/cZgLhbA' 9-max Seat #9 is the button
Seat 1: pFtzb1sR4b0d1aw6aIRgDg ($50 in chips)
Seat 2: AjV5McH1KMMclY26QdLM5w ($25 in chips)
Seat 3: xZCXQSXlrZkp3pZizzVXCw ($51.95 in chips)
Seat 4: 5k9fvXD9suIgCxU4HLQjTw ($54.70 in chips)
Seat 5: zE9cVigS2nW/Ljy4K4bUQA ($59.85 in chips)
Seat 7: M+7+BTmX5vZatHVuoRB1nA ($53.40 in chips)
Seat 8: 1MJUKc3cc0QmUoz1JZLR2w ($51.95 in chips)
Seat 9: 4WLZvqBn5qv5tds5kt5A1Q ($55.25 in chips)
pFtzb1sR4b0d1aw6aIRgDg: posts small blind $0.25
AjV5McH1KMMclY26QdLM5w: posts big blind $0.50
cards4hire: sits out
*** HOLE CARDS ***
xZCXQSXlrZkp3pZizzVXCw: folds
5k9fvXD9suIgCxU4HLQjTw: folds
zE9cVigS2nW/Ljy4K4bUQA: folds
zE9cVigS2nW/Ljy4K4bUQA leaves the table
M+7+BTmX5vZatHVuoRB1nA: raises $1 to $1.50
1MJUKc3cc0QmUoz1JZLR2w: calls $1.50
4WLZvqBn5qv5tds5kt5A1Q: folds
pFtzb1sR4b0d1aw6aIRgDg: folds
AjV5McH1KMMclY26QdLM5w: folds
*** FLOP *** [8c 6c 7d]
M+7+BTmX5vZatHVuoRB1nA: bets $2
1MJUKc3cc0QmUoz1JZLR2w: raises $3.50 to $5.50
M+7+BTmX5vZatHVuoRB1nA: calls $3.50
*** TURN *** [8c 6c 7d] [2c]
M+7+BTmX5vZatHVuoRB1nA: checks
1MJUKc3cc0QmUoz1JZLR2w: bets $5.50
Ja2jdidjip2UeJnRzmzAAQ joins the table at seat #5
M+7+BTmX5vZatHVuoRB1nA: calls $5.50
*** RIVER *** [8c 6c 7d 2c] [3c]
M+7+BTmX5vZatHVuoRB1nA: checks
1MJUKc3cc0QmUoz1JZLR2w: checks
*** SHOW DOWN ***
M+7+BTmX5vZatHVuoRB1nA: shows [9h 8h] (a pair of Eights)
1MJUKc3cc0QmUoz1JZLR2w: shows [4s 5s] (a straight, Four to Eight)
1MJUKc3cc0QmUoz1JZLR2w collected $24.50 from pot
*** SUMMARY ***
Total pot $25.75 | Rake $1.25
Board [8c 6c 7d 2c 3c]
Seat 1: pFtzb1sR4b0d1aw6aIRgDg (small blind) folded before Flop
Seat 2: AjV5McH1KMMclY26QdLM5w (big blind) folded before Flop
Seat 3: xZCXQSXlrZkp3pZizzVXCw folded before Flop (didn't bet)
Seat 4: 5k9fvXD9suIgCxU4HLQjTw folded before Flop (didn't bet)
Seat 5: zE9cVigS2nW/Ljy4K4bUQA folded before Flop (didn't bet)
Seat 7: M+7+BTmX5vZatHVuoRB1nA showed [9h 8h] and lost with a pair of Eights
Seat 8: 1MJUKc3cc0QmUoz1JZLR2w showed [4s 5s] and won ($24.50) with a straight, Four to Eight
Seat 9: 4WLZvqBn5qv5tds5kt5A1Q (button) folded before Flop (didn't bet)



PokerStars Game #59940769866:  Hold'em No Limit ($0.25/$0.50) - 2009/07/01 1:16:04 ET
Table '8BQGgNetI1NOvWeu3gtMNw' 2-max Seat #2 is the button
Seat 1: bypIyrYcAAifLfhZpGlKLA ($66.90 in chips)
Seat 2: Z4HwehErEwzsv/noQlfUlg ($126.90 in chips)
Z4HwehErEwzsv/noQlfUlg: posts small blind $0.25
bypIyrYcAAifLfhZpGlKLA: posts big blind $0.50
*** HOLE CARDS ***
Z4HwehErEwzsv/noQlfUlg: folds
bypIyrYcAAifLfhZpGlKLA collected $0.50 from pot
bypIyrYcAAifLfhZpGlKLA: doesn't show hand
*** SUMMARY ***
Total pot $0.50 | Rake $0
Seat 1: bypIyrYcAAifLfhZpGlKLA (big blind) collected ($0.50)
Seat 2: Z4HwehErEwzsv/noQlfUlg (button) (small blind) folded before Flop



PokerStars Game #59940771392:  Hold'em No Limit ($0.25/$0.50) - 2009/07/01 1:16:07 ET
Table 'kgbJRsxfv64KrErDRBAkcw' 6-max Seat #2 is the button
Seat 1: VamsyhlFzXGF6/ydo0BHeA ($51.80 in chips)
Seat 2: AdS8BJMOheS01zjCDfPMFg ($50 in chips)
Seat 3: c4MNIaIyPMOMxrgT8FT5nA ($208.55 in chips)
Seat 5: eUBBn2R56C1IQ6Cs/vitwg ($50 in chips)
Seat 6: 1b+2BbjMN8qhR1WPqdE9VQ ($50.10 in chips)
c4MNIaIyPMOMxrgT8FT5nA: posts small blind $0.25
eUBBn2R56C1IQ6Cs/vitwg: posts big blind $0.50
*** HOLE CARDS ***
1b+2BbjMN8qhR1WPqdE9VQ: folds
VamsyhlFzXGF6/ydo0BHeA: folds
AdS8BJMOheS01zjCDfPMFg: folds
c4MNIaIyPMOMxrgT8FT5nA: raises $2 to $2.50
eUBBn2R56C1IQ6Cs/vitwg: folds
c4MNIaIyPMOMxrgT8FT5nA collected $1 from pot
*** SUMMARY ***
Total pot $1 | Rake $0
Seat 1: VamsyhlFzXGF6/ydo0BHeA folded before Flop (didn't bet)
Seat 2: AdS8BJMOheS01zjCDfPMFg (button) folded before Flop (didn't bet)
Seat 3: c4MNIaIyPMOMxrgT8FT5nA (small blind) collected ($1)
Seat 5: eUBBn2R56C1IQ6Cs/vitwg (big blind) folded before Flop
Seat 6: 1b+2BbjMN8qhR1WPqdE9VQ folded before Flop (didn't bet)



PokerStars Game #59940772330:  Hold'em No Limit ($0.25/$0.50) - 2009/07/01 1:16:09 ET
Table '5EmHi+fnatGQQShcNmzOZQ' 6-max Seat #1 is the button
Seat 1: My8WkRtGx5FW6rJ1I4R3hg ($42.10 in chips)
Seat 2: bfFjgAtIoAI+pUxUwFt3aQ ($39.40 in chips)
Seat 3: 1mYbhL8CU/QYqfVmFcaHDQ ($6.05 in chips)
Seat 4: 1b+2BbjMN8qhR1WPqdE9VQ ($58.35 in chips)
Seat 5: kxPhs4ePFqMy52CInAJ2aw ($93.10 in chips)
Seat 6: +Pf9jTVizYlIo+woPvptfA ($51.20 in chips)
bfFjgAtIoAI+pUxUwFt3aQ: posts small blind $0.25
1mYbhL8CU/QYqfVmFcaHDQ: posts big blind $0.50
*** HOLE CARDS ***
1b+2BbjMN8qhR1WPqdE9VQ: folds
kxPhs4ePFqMy52CInAJ2aw: folds
+Pf9jTVizYlIo+woPvptfA: folds
My8WkRtGx5FW6rJ1I4R3hg: calls $0.50
bfFjgAtIoAI+pUxUwFt3aQ: folds
1mYbhL8CU/QYqfVmFcaHDQ: checks
*** FLOP *** [Td As 5s]
1mYbhL8CU/QYqfVmFcaHDQ: checks
My8WkRtGx5FW6rJ1I4R3hg: bets $1
1mYbhL8CU/QYqfVmFcaHDQ: folds
My8WkRtGx5FW6rJ1I4R3hg collected $1.20 from pot
*** SUMMARY ***
Total pot $1.25 | Rake $0.05
Board [Td As 5s]
Seat 1: My8WkRtGx5FW6rJ1I4R3hg (button) collected ($1.20)
Seat 2: bfFjgAtIoAI+pUxUwFt3aQ (small blind) folded before Flop
Seat 3: 1mYbhL8CU/QYqfVmFcaHDQ (big blind) folded on the Flop
Seat 4: 1b+2BbjMN8qhR1WPqdE9VQ folded before Flop (didn't bet)
Seat 5: kxPhs4ePFqMy52CInAJ2aw folded before Flop (didn't bet)
Seat 6: +Pf9jTVizYlIo+woPvptfA folded before Flop (didn't bet)



PokerStars Game #59940772686:  Hold'em No Limit ($0.25/$0.50) - 2009/07/01 1:16:09 ET
Table 'BCN5su+SsXiy1zRMJi0SJw' 6-max Seat #4 is the button
Seat 1: GxXV09ciXaOxyY2H5aMIIw ($55.35 in chips)
Seat 2: oU2kDCkT/gilYbHWrg7D8w ($38.45 in chips)
Seat 3: kwgv5lNhiFrfONXCshzxlA ($29.85 in chips)
Seat 4: 4QfsCWthT/vSLirorNXqtg ($52.25 in chips)
Seat 5: cEMJmfAUQZmMChZe6aacKw ($24 in chips)
Seat 6: b2symlOdL7+0c9Pj4N/KlA ($58.90 in chips)
cEMJmfAUQZmMChZe6aacKw: posts small blind $0.25
b2symlOdL7+0c9Pj4N/KlA: posts big blind $0.50
*** HOLE CARDS ***
GxXV09ciXaOxyY2H5aMIIw: folds
oU2kDCkT/gilYbHWrg7D8w: calls $0.50
kwgv5lNhiFrfONXCshzxlA: folds
4QfsCWthT/vSLirorNXqtg: folds
cEMJmfAUQZmMChZe6aacKw: raises $1 to $1.50
b2symlOdL7+0c9Pj4N/KlA: folds
oU2kDCkT/gilYbHWrg7D8w: calls $1
*** FLOP *** [3d Kc 9c]
cEMJmfAUQZmMChZe6aacKw: bets $2.50
oU2kDCkT/gilYbHWrg7D8w: calls $2.50
*** TURN *** [3d Kc 9c] [4h]
cEMJmfAUQZmMChZe6aacKw: bets $3.50
oU2kDCkT/gilYbHWrg7D8w: raises $16.50 to $20
cEMJmfAUQZmMChZe6aacKw: calls $16.50 and is all-in
*** RIVER *** [3d Kc 9c 4h] [7h]
*** SHOW DOWN ***
cEMJmfAUQZmMChZe6aacKw: shows [Kd Qc] (a pair of Kings)
oU2kDCkT/gilYbHWrg7D8w: mucks hand
oU2kDCkT/gilYbHWrg7D8w said, "nh"
cEMJmfAUQZmMChZe6aacKw collected $46.10 from pot
*** SUMMARY ***
Total pot $48.50 | Rake $2.40
Board [3d Kc 9c 4h 7h]
Seat 1: GxXV09ciXaOxyY2H5aMIIw folded before Flop (didn't bet)
Seat 2: oU2kDCkT/gilYbHWrg7D8w mucked
Seat 3: kwgv5lNhiFrfONXCshzxlA folded before Flop (didn't bet)
Seat 4: 4QfsCWthT/vSLirorNXqtg (button) folded before Flop (didn't bet)
Seat 5: cEMJmfAUQZmMChZe6aacKw (small blind) showed [Kd Qc] and won ($46.10) with a pair of Kings
Seat 6: b2symlOdL7+0c9Pj4N/KlA (big blind) folded before Flop



PokerStars Game #59940773288:  Hold'em No Limit ($0.25/$0.50) - 2009/07/01 1:16:10 ET
Table '+z1aekfHkpp09pc8F9aViw' 6-max Seat #6 is the button
Seat 1: 7zFtlEn2NxyROFkJdZA/yg ($50 in chips)
Seat 2: OZ6OtYh5Y53MCH/p0QTn5g ($50 in chips)
Seat 3: uUznlIMFnRUvwrBhYF73KA ($140.65 in chips)
Seat 4: RowCSpSURHTOL/dcjg/Iug ($52.60 in chips)
Seat 5: rplyldNweS6YyMNEALQrug ($49.05 in chips)
Seat 6: GUnvMULl2qFOO1yenu1UBw ($50 in chips)
7zFtlEn2NxyROFkJdZA/yg: posts small blind $0.25
OZ6OtYh5Y53MCH/p0QTn5g: posts big blind $0.50
*** HOLE CARDS ***
uUznlIMFnRUvwrBhYF73KA: calls $0.50
RowCSpSURHTOL/dcjg/Iug: folds
rplyldNweS6YyMNEALQrug: calls $0.50
GUnvMULl2qFOO1yenu1UBw: folds
7zFtlEn2NxyROFkJdZA/yg: raises $2.50 to $3
OZ6OtYh5Y53MCH/p0QTn5g: folds
uUznlIMFnRUvwrBhYF73KA: calls $2.50
rplyldNweS6YyMNEALQrug: calls $2.50
*** FLOP *** [5s Kh Tc]
7zFtlEn2NxyROFkJdZA/yg: bets $6
uUznlIMFnRUvwrBhYF73KA: calls $6
rplyldNweS6YyMNEALQrug: calls $6
*** TURN *** [5s Kh Tc] [Ks]
7zFtlEn2NxyROFkJdZA/yg: checks
uUznlIMFnRUvwrBhYF73KA: bets $17.50
rplyldNweS6YyMNEALQrug: folds
7zFtlEn2NxyROFkJdZA/yg: folds
uUznlIMFnRUvwrBhYF73KA collected $26.15 from pot
*** SUMMARY ***
Total pot $27.50 | Rake $1.35
Board [5s Kh Tc Ks]
Seat 1: 7zFtlEn2NxyROFkJdZA/yg (small blind) folded on the Turn
Seat 2: OZ6OtYh5Y53MCH/p0QTn5g (big blind) folded before Flop
Seat 3: uUznlIMFnRUvwrBhYF73KA collected ($26.15)
Seat 4: RowCSpSURHTOL/dcjg/Iug folded before Flop (didn't bet)
Seat 5: rplyldNweS6YyMNEALQrug folded on the Turn
Seat 6: GUnvMULl2qFOO1yenu1UBw (button) folded before Flop (didn't bet)



PokerStars Game #59940773904:  Hold'em No Limit ($0.25/$0.50) - 2009/07/01 1:16:11 ET
Table '8BQGgNetI1NOvWeu3gtMNw' 2-max Seat #1 is the button
Seat 1: bypIyrYcAAifLfhZpGlKLA ($67.15 in chips)
Seat 2: Z4HwehErEwzsv/noQlfUlg ($126.65 in chips)
bypIyrYcAAifLfhZpGlKLA: posts small blind $0.25
Z4HwehErEwzsv/noQlfUlg: posts big blind $0.50
*** HOLE CARDS ***
bypIyrYcAAifLfhZpGlKLA: raises $1 to $1.50
Z4HwehErEwzsv/noQlfUlg: folds
bypIyrYcAAifLfhZpGlKLA collected $1 from pot
bypIyrYcAAifLfhZpGlKLA: doesn't show hand
*** SUMMARY ***
Total pot $1 | Rake $0
Seat 1: bypIyrYcAAifLfhZpGlKLA (button) (small blind) collected ($1)
Seat 2: Z4HwehErEwzsv/noQlfUlg (big blind) folded before Flop



PokerStars Game #59940774498:  Hold'em No Limit ($0.25/$0.50) - 2009/07/01 1:16:12 ET
Table 'tyR5AZNKV8Aadbrnrnlg7g' 6-max Seat #5 is the button
Seat 1: BgOXYI0yYSN1ULC4FqsNkg ($94.80 in chips)
Seat 2: BAjwVL+zKKd0s0fAWstzQQ ($69.30 in chips)
Seat 3: JFLrYNyQmwPhRQAtoSAuyA ($52.85 in chips)
Seat 4: 4QfsCWthT/vSLirorNXqtg ($76.15 in chips)
Seat 5: GUnvMULl2qFOO1yenu1UBw ($50 in chips)
Seat 6: 498aWaGsW4uGfuWl+2FCGw ($40.60 in chips)
498aWaGsW4uGfuWl+2FCGw: posts small blind $0.25
BgOXYI0yYSN1ULC4FqsNkg: posts big blind $0.50
*** HOLE CARDS ***
BAjwVL+zKKd0s0fAWstzQQ: folds
JFLrYNyQmwPhRQAtoSAuyA: raises $1 to $1.50
4QfsCWthT/vSLirorNXqtg: folds
GUnvMULl2qFOO1yenu1UBw: calls $1.50
498aWaGsW4uGfuWl+2FCGw: folds
BgOXYI0yYSN1ULC4FqsNkg: folds
*** FLOP *** [7h 6c 4c]
JFLrYNyQmwPhRQAtoSAuyA: bets $2.50
GUnvMULl2qFOO1yenu1UBw: folds
JFLrYNyQmwPhRQAtoSAuyA collected $3.60 from pot
JFLrYNyQmwPhRQAtoSAuyA: doesn't show hand
*** SUMMARY ***
Total pot $3.75 | Rake $0.15
Board [7h 6c 4c]
Seat 1: BgOXYI0yYSN1ULC4FqsNkg (big blind) folded before Flop
Seat 2: BAjwVL+zKKd0s0fAWstzQQ folded before Flop (didn't bet)
Seat 3: JFLrYNyQmwPhRQAtoSAuyA collected ($3.60)
Seat 4: 4QfsCWthT/vSLirorNXqtg folded before Flop (didn't bet)
Seat 5: GUnvMULl2qFOO1yenu1UBw (button) folded on the Flop
Seat 6: 498aWaGsW4uGfuWl+2FCGw (small blind) folded before Flop



PokerStars Game #59940774412:  Hold'em No Limit ($0.25/$0.50) - 2009/07/01 1:16:12 ET
Table 'EiNh8p/wGJ1FP575iMFnqg' 9-max Seat #5 is the button
Seat 1: r3ZqM1Mi0W3y4hOdssE+Sg ($66.50 in chips)
Seat 2: 8ehL7qlZzjgUh2H35iiWLw ($59.15 in chips)
Seat 3: ymLPoEIl7UL3TvZYmnadxQ ($55.55 in chips)
Seat 4: cMzaiXAM/ZAdNaEUu+LqhA ($50 in chips)
Seat 5: M+7+BTmX5vZatHVuoRB1nA ($79.70 in chips)
Seat 7: 997ViqAtWn1FPjJqcffwcA ($50 in chips)
Seat 8: mSD1pginDsyHG5PDfqzphw ($10 in chips)
Seat 9: GuPkZObrz5Zkkn8FsEdF9w ($30 in chips)
997ViqAtWn1FPjJqcffwcA: posts small blind $0.25
mSD1pginDsyHG5PDfqzphw: posts big blind $0.50
*** HOLE CARDS ***
GuPkZObrz5Zkkn8FsEdF9w: folds
r3ZqM1Mi0W3y4hOdssE+Sg: folds
8ehL7qlZzjgUh2H35iiWLw: folds
ymLPoEIl7UL3TvZYmnadxQ: folds
cMzaiXAM/ZAdNaEUu+LqhA: folds
M+7+BTmX5vZatHVuoRB1nA: folds
997ViqAtWn1FPjJqcffwcA: folds
mSD1pginDsyHG5PDfqzphw collected $0.50 from pot
mSD1pginDsyHG5PDfqzphw: doesn't show hand
*** SUMMARY ***
Total pot $0.50 | Rake $0
Seat 1: r3ZqM1Mi0W3y4hOdssE+Sg folded before Flop (didn't bet)
Seat 2: 8ehL7qlZzjgUh2H35iiWLw folded before Flop (didn't bet)
Seat 3: ymLPoEIl7UL3TvZYmnadxQ folded before Flop (didn't bet)
Seat 4: cMzaiXAM/ZAdNaEUu+LqhA folded before Flop (didn't bet)
Seat 5: M+7+BTmX5vZatHVuoRB1nA (button) folded before Flop (didn't bet)
Seat 7: 997ViqAtWn1FPjJqcffwcA (small blind) folded before Flop
Seat 8: mSD1pginDsyHG5PDfqzphw (big blind) collected ($0.50)
Seat 9: GuPkZObrz5Zkkn8FsEdF9w folded before Flop (didn't bet)



PokerStars Game #59940775216:  Hold'em No Limit ($0.25/$0.50) - 2009/07/01 1:16:13 ET
Table 'MJxeZCzYELxiIsyUZyT0jw' 6-max Seat #1 is the button
Seat 1: +Pf9jTVizYlIo+woPvptfA ($50 in chips)
Seat 2: t3GiVMzqA9Svgr5Uol32cQ ($29.15 in chips)
Seat 3: sIG4mp8tZEI+W4nKZNkkQA ($51.85 in chips)
Seat 4: alGiiQP/wwtYnfuXII+sgw ($59.60 in chips)
Seat 5: 3jvoOXNtXE90w2BdfNZwZQ ($61.95 in chips)
Seat 6: c0n4hrn20AML9qzyFC2E8Q ($51.10 in chips)
t3GiVMzqA9Svgr5Uol32cQ: posts small blind $0.25
sIG4mp8tZEI+W4nKZNkkQA: posts big blind $0.50
*** HOLE CARDS ***
alGiiQP/wwtYnfuXII+sgw: folds
3jvoOXNtXE90w2BdfNZwZQ: folds
c0n4hrn20AML9qzyFC2E8Q: folds
+Pf9jTVizYlIo+woPvptfA: folds
t3GiVMzqA9Svgr5Uol32cQ: folds
sIG4mp8tZEI+W4nKZNkkQA collected $0.50 from pot
sIG4mp8tZEI+W4nKZNkkQA: doesn't show hand
*** SUMMARY ***
Total pot $0.50 | Rake $0
Seat 1: +Pf9jTVizYlIo+woPvptfA (button) folded before Flop (didn't bet)
Seat 2: t3GiVMzqA9Svgr5Uol32cQ (small blind) folded before Flop
Seat 3: sIG4mp8tZEI+W4nKZNkkQA (big blind) collected ($0.50)
Seat 4: alGiiQP/wwtYnfuXII+sgw folded before Flop (didn't bet)
Seat 5: 3jvoOXNtXE90w2BdfNZwZQ folded before Flop (didn't bet)
Seat 6: c0n4hrn20AML9qzyFC2E8Q folded before Flop (didn't bet)



PokerStars Game #59940776526:  Hold'em No Limit ($0.25/$0.50) - 2009/07/01 1:16:16 ET
Table 'c/CRn+68J3Y8KxD5g1ek2Q' 2-max Seat #1 is the button
Seat 1: 46qCyJ6evTkHo9al5sBMNA ($117.70 in chips)
Seat 2: BypVLsYQt3ePFm2xQL/dOA ($245.40 in chips)
46qCyJ6evTkHo9al5sBMNA: posts small blind $0.25
BypVLsYQt3ePFm2xQL/dOA: posts big blind $0.50
*** HOLE CARDS ***
46qCyJ6evTkHo9al5sBMNA: folds
BypVLsYQt3ePFm2xQL/dOA collected $0.50 from pot
BypVLsYQt3ePFm2xQL/dOA: doesn't show hand
*** SUMMARY ***
Total pot $0.50 | Rake $0
Seat 1: 46qCyJ6evTkHo9al5sBMNA (button) (small blind) folded before Flop
Seat 2: BypVLsYQt3ePFm2xQL/dOA (big blind) collected ($0.50)



PokerStars Game #59940776684:  Hold'em No Limit ($0.25/$0.50) - 2009/07/01 1:16:16 ET
Table '37qXEp3oe+er5q4CZip9eQ' 6-max Seat #4 is the button
Seat 1: lxIzoHy0RnkfFSODHC2liw ($50 in chips)
Seat 2: LvH4G7n+QSjT6NDaD3cREA ($59.10 in chips)
Seat 3: Rt6KgtZ8YaJoTc3FPim00w ($108.45 in chips)
Seat 4: XsmE8nXMAAMFJbWaJTmHFw ($60.30 in chips)
Seat 5: VOmI0x4dDPnTESZd5B4d1Q ($36 in chips)
VOmI0x4dDPnTESZd5B4d1Q: posts small blind $0.25
lxIzoHy0RnkfFSODHC2liw: posts big blind $0.50
*** HOLE CARDS ***
LvH4G7n+QSjT6NDaD3cREA: raises $1 to $1.50
Rt6KgtZ8YaJoTc3FPim00w: folds
XsmE8nXMAAMFJbWaJTmHFw: folds
VOmI0x4dDPnTESZd5B4d1Q: folds
lxIzoHy0RnkfFSODHC2liw: folds
XsmE8nXMAAMFJbWaJTmHFw said, "After Aces. A fitting time to go where I should have hours ago. To bed. Thanks for the game everyone"
LvH4G7n+QSjT6NDaD3cREA collected $1.25 from pot
*** SUMMARY ***
Total pot $1.25 | Rake $0
Seat 1: lxIzoHy0RnkfFSODHC2liw (big blind) folded before Flop
Seat 2: LvH4G7n+QSjT6NDaD3cREA collected ($1.25)
Seat 3: Rt6KgtZ8YaJoTc3FPim00w folded before Flop (didn't bet)
Seat 4: XsmE8nXMAAMFJbWaJTmHFw (button) folded before Flop (didn't bet)
Seat 5: VOmI0x4dDPnTESZd5B4d1Q (small blind) folded before Flop



PokerStars Game #59940780302:  Hold'em No Limit ($0.25/$0.50) - 2009/07/01 1:16:22 ET
Table 'c/CRn+68J3Y8KxD5g1ek2Q' 2-max Seat #2 is the button
Seat 1: 46qCyJ6evTkHo9al5sBMNA ($117.45 in chips)
Seat 2: BypVLsYQt3ePFm2xQL/dOA ($245.65 in chips)
BypVLsYQt3ePFm2xQL/dOA: posts small blind $0.25
46qCyJ6evTkHo9al5sBMNA: posts big blind $0.50
*** HOLE CARDS ***
BypVLsYQt3ePFm2xQL/dOA: calls $0.25
46qCyJ6evTkHo9al5sBMNA: checks
*** FLOP *** [7c 8c 7h]
46qCyJ6evTkHo9al5sBMNA: checks
BypVLsYQt3ePFm2xQL/dOA: bets $2
46qCyJ6evTkHo9al5sBMNA: folds
BypVLsYQt3ePFm2xQL/dOA collected $0.95 from pot
BypVLsYQt3ePFm2xQL/dOA: doesn't show hand
*** SUMMARY ***
Total pot $1 | Rake $0.05
Board [7c 8c 7h]
Seat 1: 46qCyJ6evTkHo9al5sBMNA (big blind) folded on the Flop
Seat 2: BypVLsYQt3ePFm2xQL/dOA (button) (small blind) collected ($0.95)



PokerStars Game #59940780596:  Hold'em No Limit ($0.25/$0.50) - 2009/07/01 1:16:23 ET
Table '8BQGgNetI1NOvWeu3gtMNw' 2-max Seat #2 is the button
Seat 1: bypIyrYcAAifLfhZpGlKLA ($67.65 in chips)
Seat 2: Z4HwehErEwzsv/noQlfUlg ($126.15 in chips)
Z4HwehErEwzsv/noQlfUlg: posts small blind $0.25
bypIyrYcAAifLfhZpGlKLA: posts big blind $0.50
*** HOLE CARDS ***
Z4HwehErEwzsv/noQlfUlg: raises $1 to $1.50
bypIyrYcAAifLfhZpGlKLA: folds
Z4HwehErEwzsv/noQlfUlg collected $1 from pot
Z4HwehErEwzsv/noQlfUlg: doesn't show hand
*** SUMMARY ***
Total pot $1 | Rake $0
Seat 1: bypIyrYcAAifLfhZpGlKLA (big blind) folded before Flop
Seat 2: Z4HwehErEwzsv/noQlfUlg (button) (small blind) collected ($1)



PokerStars Game #59940781592:  Hold'em No Limit ($0.25/$0.50) - 2009/07/01 1:16:25 ET
Table 'hSTs/dUsYLgJQuF2Onp0MQ' 6-max Seat #5 is the button
Seat 1: 1WUCqNG+p+vfWRTXNu4ljw ($50.50 in chips)
Seat 3: C3qJBo7uxfFVDluE1lmK2w ($31.10 in chips)
Seat 5: IBNygaT1aa9Z1uPdJJilwA ($33.80 in chips)
Seat 6: M1KyQQvVPVuxqTAB8sR/zQ ($88.45 in chips)
M1KyQQvVPVuxqTAB8sR/zQ: posts small blind $0.25
1WUCqNG+p+vfWRTXNu4ljw: posts big blind $0.50
2igtJLmvIZ+HqX4XPgMPZA: sits out
*** HOLE CARDS ***
C3qJBo7uxfFVDluE1lmK2w: folds
IBNygaT1aa9Z1uPdJJilwA: raises $1 to $1.50
M1KyQQvVPVuxqTAB8sR/zQ: folds
1WUCqNG+p+vfWRTXNu4ljw: calls $1
*** FLOP *** [4s 5c Qc]
1WUCqNG+p+vfWRTXNu4ljw: checks
IBNygaT1aa9Z1uPdJJilwA: bets $2
1WUCqNG+p+vfWRTXNu4ljw: folds
IBNygaT1aa9Z1uPdJJilwA collected $3.10 from pot
*** SUMMARY ***
Total pot $3.25 | Rake $0.15
Board [4s 5c Qc]
Seat 1: 1WUCqNG+p+vfWRTXNu4ljw (big blind) folded on the Flop
Seat 3: C3qJBo7uxfFVDluE1lmK2w folded before Flop (didn't bet)
Seat 5: IBNygaT1aa9Z1uPdJJilwA (button) collected ($3.10)
Seat 6: M1KyQQvVPVuxqTAB8sR/zQ (small blind) folded before Flop



PokerStars Game #59940782476:  Hold'em No Limit ($0.25/$0.50) - 2009/07/01 1:16:26 ET
Table 'EiNh8p/wGJ1FP575iMFnqg' 9-max Seat #7 is the button
Seat 1: r3ZqM1Mi0W3y4hOdssE+Sg ($66.50 in chips)
Seat 2: 8ehL7qlZzjgUh2H35iiWLw ($59.15 in chips)
Seat 3: ymLPoEIl7UL3TvZYmnadxQ ($55.55 in chips)
Seat 4: cMzaiXAM/ZAdNaEUu+LqhA ($50 in chips)
Seat 5: M+7+BTmX5vZatHVuoRB1nA ($79.70 in chips)
Seat 7: 997ViqAtWn1FPjJqcffwcA ($50 in chips)
Seat 8: mSD1pginDsyHG5PDfqzphw ($10.25 in chips)
Seat 9: GuPkZObrz5Zkkn8FsEdF9w ($30 in chips)
mSD1pginDsyHG5PDfqzphw: posts small blind $0.25
GuPkZObrz5Zkkn8FsEdF9w: posts big blind $0.50
*** HOLE CARDS ***
r3ZqM1Mi0W3y4hOdssE+Sg: folds
8ehL7qlZzjgUh2H35iiWLw: folds
ymLPoEIl7UL3TvZYmnadxQ: calls $0.50
cMzaiXAM/ZAdNaEUu+LqhA: folds
M+7+BTmX5vZatHVuoRB1nA: folds
997ViqAtWn1FPjJqcffwcA: folds
viwBDtJsY6JfsFOdBAyJIQ joins the table at seat #6
mSD1pginDsyHG5PDfqzphw: folds
mSD1pginDsyHG5PDfqzphw is sitting out
GuPkZObrz5Zkkn8FsEdF9w: checks
*** FLOP *** [Th Kd 5d]
GuPkZObrz5Zkkn8FsEdF9w: bets $1
ymLPoEIl7UL3TvZYmnadxQ: folds
GuPkZObrz5Zkkn8FsEdF9w collected $1.20 from pot
*** SUMMARY ***
Total pot $1.25 | Rake $0.05
Board [Th Kd 5d]
Seat 1: r3ZqM1Mi0W3y4hOdssE+Sg folded before Flop (didn't bet)
Seat 2: 8ehL7qlZzjgUh2H35iiWLw folded before Flop (didn't bet)
Seat 3: ymLPoEIl7UL3TvZYmnadxQ folded on the Flop
Seat 4: cMzaiXAM/ZAdNaEUu+LqhA folded before Flop (didn't bet)
Seat 5: M+7+BTmX5vZatHVuoRB1nA folded before Flop (didn't bet)
Seat 7: 997ViqAtWn1FPjJqcffwcA (button) folded before Flop (didn't bet)
Seat 8: mSD1pginDsyHG5PDfqzphw (small blind) folded before Flop
Seat 9: GuPkZObrz5Zkkn8FsEdF9w (big blind) collected ($1.20)



PokerStars Game #59940783824:  Hold'em No Limit ($0.25/$0.50) - 2009/07/01 1:16:28 ET
Table 'kgbJRsxfv64KrErDRBAkcw' 6-max Seat #3 is the button
Seat 1: VamsyhlFzXGF6/ydo0BHeA ($51.80 in chips)
Seat 2: AdS8BJMOheS01zjCDfPMFg ($50 in chips)
Seat 3: c4MNIaIyPMOMxrgT8FT5nA ($209.05 in chips)
Seat 5: eUBBn2R56C1IQ6Cs/vitwg ($50 in chips)
Seat 6: 1b+2BbjMN8qhR1WPqdE9VQ ($50.10 in chips)
qanMEqjABjWxC/JgQ/0l7w was removed from the table for failing to post
eUBBn2R56C1IQ6Cs/vitwg: posts small blind $0.25
1b+2BbjMN8qhR1WPqdE9VQ: posts big blind $0.50
*** HOLE CARDS ***
VamsyhlFzXGF6/ydo0BHeA: folds
AdS8BJMOheS01zjCDfPMFg: folds
c4MNIaIyPMOMxrgT8FT5nA: calls $0.50
eUBBn2R56C1IQ6Cs/vitwg: folds
1b+2BbjMN8qhR1WPqdE9VQ: checks
*** FLOP *** [8s 4c Th]
2igtJLmvIZ+HqX4XPgMPZA joins the table at seat #4
1b+2BbjMN8qhR1WPqdE9VQ: bets $1
c4MNIaIyPMOMxrgT8FT5nA: folds
1b+2BbjMN8qhR1WPqdE9VQ collected $1.20 from pot
1b+2BbjMN8qhR1WPqdE9VQ: doesn't show hand
*** SUMMARY ***
Total pot $1.25 | Rake $0.05
Board [8s 4c Th]
Seat 1: VamsyhlFzXGF6/ydo0BHeA folded before Flop (didn't bet)
Seat 2: AdS8BJMOheS01zjCDfPMFg folded before Flop (didn't bet)
Seat 3: c4MNIaIyPMOMxrgT8FT5nA (button) folded on the Flop
Seat 5: eUBBn2R56C1IQ6Cs/vitwg (small blind) folded before Flop
Seat 6: 1b+2BbjMN8qhR1WPqdE9VQ (big blind) collected ($1.20)



PokerStars Game #59940784280:  Hold'em No Limit ($0.25/$0.50) - 2009/07/01 1:16:29 ET
Table 'ibNfFy0bCzuBaUORla0aGw' 9-max Seat #3 is the button
Seat 1: xZCXQSXlrZkp3pZizzVXCw ($50.55 in chips)
Seat 2: 90Wb75h3W1BRpbqVnuk8gw ($50 in chips)
Seat 3: AjV5McH1KMMclY26QdLM5w ($25 in chips)
Seat 4: YBN054X4blmis+B2bBlC0g ($22.15 in chips)
Seat 5: GIJAc9kPrLZHLSX8Q6i99w ($28.05 in chips)
Seat 6: H8cPaCtX7d6meGUVSM5sxw ($47.45 in chips)
Seat 7: HZkVla4kK2SI42CVrPZ/ig ($13.75 in chips)
Seat 8: viwBDtJsY6JfsFOdBAyJIQ ($13.95 in chips)
Seat 9: pFtzb1sR4b0d1aw6aIRgDg ($55.75 in chips)
YBN054X4blmis+B2bBlC0g: posts small blind $0.25
GIJAc9kPrLZHLSX8Q6i99w: posts big blind $0.50
*** HOLE CARDS ***
H8cPaCtX7d6meGUVSM5sxw: raises $1 to $1.50
HZkVla4kK2SI42CVrPZ/ig: folds
viwBDtJsY6JfsFOdBAyJIQ: folds
viwBDtJsY6JfsFOdBAyJIQ leaves the table
pFtzb1sR4b0d1aw6aIRgDg: folds
xZCXQSXlrZkp3pZizzVXCw: folds
90Wb75h3W1BRpbqVnuk8gw: calls $1.50
AjV5McH1KMMclY26QdLM5w: raises $3 to $4.50
YBN054X4blmis+B2bBlC0g: folds
GIJAc9kPrLZHLSX8Q6i99w: folds
H8cPaCtX7d6meGUVSM5sxw: calls $3
90Wb75h3W1BRpbqVnuk8gw: calls $3
*** FLOP *** [Th 2h 3s]
Ja2jdidjip2UeJnRzmzAAQ joins the table at seat #8
H8cPaCtX7d6meGUVSM5sxw: checks
90Wb75h3W1BRpbqVnuk8gw: checks
AjV5McH1KMMclY26QdLM5w: checks
*** TURN *** [Th 2h 3s] [4c]
H8cPaCtX7d6meGUVSM5sxw: bets $10
90Wb75h3W1BRpbqVnuk8gw: folds
AjV5McH1KMMclY26QdLM5w: folds
H8cPaCtX7d6meGUVSM5sxw collected $13.55 from pot
H8cPaCtX7d6meGUVSM5sxw: doesn't show hand
*** SUMMARY ***
Total pot $14.25 | Rake $0.70
Board [Th 2h 3s 4c]
Seat 1: xZCXQSXlrZkp3pZizzVXCw folded before Flop (didn't bet)
Seat 2: 90Wb75h3W1BRpbqVnuk8gw folded on the Turn
Seat 3: AjV5McH1KMMclY26QdLM5w (button) folded on the Turn
Seat 4: YBN054X4blmis+B2bBlC0g (small blind) folded before Flop
Seat 5: GIJAc9kPrLZHLSX8Q6i99w (big blind) folded before Flop
Seat 6: H8cPaCtX7d6meGUVSM5sxw collected ($13.55)
Seat 7: HZkVla4kK2SI42CVrPZ/ig folded before Flop (didn't bet)
Seat 8: viwBDtJsY6JfsFOdBAyJIQ folded before Flop (didn't bet)
Seat 9: pFtzb1sR4b0d1aw6aIRgDg folded before Flop (didn't bet)



PokerStars Game #59940785650:  Hold'em No Limit ($0.25/$0.50) - 2009/07/01 1:16:31 ET
Table 'MJxeZCzYELxiIsyUZyT0jw' 6-max Seat #2 is the button
Seat 1: +Pf9jTVizYlIo+woPvptfA ($50 in chips)
Seat 2: t3GiVMzqA9Svgr5Uol32cQ ($28.90 in chips)
Seat 3: sIG4mp8tZEI+W4nKZNkkQA ($52.10 in chips)
Seat 4: alGiiQP/wwtYnfuXII+sgw ($59.60 in chips)
Seat 5: 3jvoOXNtXE90w2BdfNZwZQ ($61.95 in chips)
Seat 6: c0n4hrn20AML9qzyFC2E8Q ($51.10 in chips)
sIG4mp8tZEI+W4nKZNkkQA: posts small blind $0.25
alGiiQP/wwtYnfuXII+sgw: posts big blind $0.50
*** HOLE CARDS ***
3jvoOXNtXE90w2BdfNZwZQ: folds
c0n4hrn20AML9qzyFC2E8Q: folds
+Pf9jTVizYlIo+woPvptfA: folds
t3GiVMzqA9Svgr5Uol32cQ: folds
sIG4mp8tZEI+W4nKZNkkQA: folds
alGiiQP/wwtYnfuXII+sgw collected $0.50 from pot
*** SUMMARY ***
Total pot $0.50 | Rake $0
Seat 1: +Pf9jTVizYlIo+woPvptfA folded before Flop (didn't bet)
Seat 2: t3GiVMzqA9Svgr5Uol32cQ (button) folded before Flop (didn't bet)
Seat 3: sIG4mp8tZEI+W4nKZNkkQA (small blind) folded before Flop
Seat 4: alGiiQP/wwtYnfuXII+sgw (big blind) collected ($0.50)
Seat 5: 3jvoOXNtXE90w2BdfNZwZQ folded before Flop (didn't bet)
Seat 6: c0n4hrn20AML9qzyFC2E8Q folded before Flop (didn't bet)



PokerStars Game #59940785938:  Hold'em No Limit ($0.25/$0.50) - 2009/07/01 1:16:32 ET
Table '8BQGgNetI1NOvWeu3gtMNw' 2-max Seat #1 is the button
Seat 1: bypIyrYcAAifLfhZpGlKLA ($67.15 in chips)
Seat 2: Z4HwehErEwzsv/noQlfUlg ($126.65 in chips)
bypIyrYcAAifLfhZpGlKLA: posts small blind $0.25
Z4HwehErEwzsv/noQlfUlg: posts big blind $0.50
*** HOLE CARDS ***
bypIyrYcAAifLfhZpGlKLA: folds
Z4HwehErEwzsv/noQlfUlg collected $0.50 from pot
Z4HwehErEwzsv/noQlfUlg: doesn't show hand
*** SUMMARY ***
Total pot $0.50 | Rake $0
Seat 1: bypIyrYcAAifLfhZpGlKLA (button) (small blind) folded before Flop
Seat 2: Z4HwehErEwzsv/noQlfUlg (big blind) collected ($0.50)



PokerStars Game #59940787612:  Hold'em No Limit ($0.25/$0.50) - 2009/07/01 1:16:35 ET
Table '9Puy2HWN1RQe5SSjq162gA' 2-max Seat #1 is the button
Seat 1: Fp/oksNpipCrD2MJ2pH20g ($21 in chips)
Seat 2: bUQEKmQTneRNtujMucgwag ($48.10 in chips)
Fp/oksNpipCrD2MJ2pH20g: posts small blind $0.25
bUQEKmQTneRNtujMucgwag: posts big blind $0.50
*** HOLE CARDS ***
Fp/oksNpipCrD2MJ2pH20g: raises $1.50 to $2
bUQEKmQTneRNtujMucgwag: folds
Fp/oksNpipCrD2MJ2pH20g collected $1 from pot
Fp/oksNpipCrD2MJ2pH20g: doesn't show hand
*** SUMMARY ***
Total pot $1 | Rake $0
Seat 1: Fp/oksNpipCrD2MJ2pH20g (button) (small blind) collected ($1)
Seat 2: bUQEKmQTneRNtujMucgwag (big blind) folded before Flop



PokerStars Game #59940788436:  Hold'em No Limit ($0.25/$0.50) - 2009/07/01 1:16:36 ET
Table 'tyR5AZNKV8Aadbrnrnlg7g' 6-max Seat #6 is the button
Seat 1: BgOXYI0yYSN1ULC4FqsNkg ($94.30 in chips)
Seat 2: BAjwVL+zKKd0s0fAWstzQQ ($69.30 in chips)
Seat 3: JFLrYNyQmwPhRQAtoSAuyA ($54.95 in chips)
Seat 4: 4QfsCWthT/vSLirorNXqtg ($76.15 in chips)
Seat 5: GUnvMULl2qFOO1yenu1UBw ($50 in chips)
Seat 6: 498aWaGsW4uGfuWl+2FCGw ($40.35 in chips)
BgOXYI0yYSN1ULC4FqsNkg: posts small blind $0.25
BAjwVL+zKKd0s0fAWstzQQ: posts big blind $0.50
*** HOLE CARDS ***
JFLrYNyQmwPhRQAtoSAuyA: raises $1 to $1.50
4QfsCWthT/vSLirorNXqtg: folds
GUnvMULl2qFOO1yenu1UBw: folds
498aWaGsW4uGfuWl+2FCGw: calls $1.50
BgOXYI0yYSN1ULC4FqsNkg: folds
BAjwVL+zKKd0s0fAWstzQQ: calls $1
*** FLOP *** [7c Tc Js]
BAjwVL+zKKd0s0fAWstzQQ: checks
JFLrYNyQmwPhRQAtoSAuyA: checks
498aWaGsW4uGfuWl+2FCGw: checks
*** TURN *** [7c Tc Js] [Qc]
BAjwVL+zKKd0s0fAWstzQQ: checks
JFLrYNyQmwPhRQAtoSAuyA: bets $4
498aWaGsW4uGfuWl+2FCGw: calls $4
BAjwVL+zKKd0s0fAWstzQQ: folds
*** RIVER *** [7c Tc Js Qc] [4c]
JFLrYNyQmwPhRQAtoSAuyA: checks
498aWaGsW4uGfuWl+2FCGw: checks
*** SHOW DOWN ***
JFLrYNyQmwPhRQAtoSAuyA: shows [Kh Qs] (a pair of Queens)
498aWaGsW4uGfuWl+2FCGw: shows [Kc Ah] (a flush, King high)
498aWaGsW4uGfuWl+2FCGw collected $12.15 from pot
*** SUMMARY ***
Total pot $12.75 | Rake $0.60
Board [7c Tc Js Qc 4c]
Seat 1: BgOXYI0yYSN1ULC4FqsNkg (small blind) folded before Flop
Seat 2: BAjwVL+zKKd0s0fAWstzQQ (big blind) folded on the Turn
Seat 3: JFLrYNyQmwPhRQAtoSAuyA showed [Kh Qs] and lost with a pair of Queens
Seat 4: 4QfsCWthT/vSLirorNXqtg folded before Flop (didn't bet)
Seat 5: GUnvMULl2qFOO1yenu1UBw folded before Flop (didn't bet)
Seat 6: 498aWaGsW4uGfuWl+2FCGw (button) showed [Kc Ah] and won ($12.15) with a flush, King high



PokerStars Game #59940788768:  Hold'em No Limit ($0.25/$0.50) - 2009/07/01 1:16:37 ET
Table 'lpxYasB1ClBSgTpCCITwhQ' 9-max Seat #2 is the button
Seat 1: mj7PS7wCH4PAl7+eYTFs7A ($49.95 in chips)
Seat 2: OWP/DOu+PlPK6ZZ3zYa0HA ($25.10 in chips)
Seat 3: sakr/FIfFtIZwDPmAj5Pzg ($50.80 in chips)
Seat 4: NnQCepdIR/AOUQn1yhYx6Q ($9.25 in chips)
Seat 6: SegjDnMxWMujiD57ESNL+g ($7.10 in chips)
Seat 7: bmRtaIYKthN1F+B3JLZ3Jw ($72.60 in chips)
Seat 8: /mfensKw8/iZ1Vrx33S4xg ($11.50 in chips)
Seat 9: sUIUZ+begh92dzkUmvbMrw ($24.65 in chips)
sakr/FIfFtIZwDPmAj5Pzg: posts small blind $0.25
NnQCepdIR/AOUQn1yhYx6Q: posts big blind $0.50
*** HOLE CARDS ***
SegjDnMxWMujiD57ESNL+g: folds
bmRtaIYKthN1F+B3JLZ3Jw: folds
bmRtaIYKthN1F+B3JLZ3Jw leaves the table
/mfensKw8/iZ1Vrx33S4xg: raises $1 to $1.50
sUIUZ+begh92dzkUmvbMrw: folds
mj7PS7wCH4PAl7+eYTFs7A: calls $1.50
OWP/DOu+PlPK6ZZ3zYa0HA: folds
sakr/FIfFtIZwDPmAj5Pzg: folds
NnQCepdIR/AOUQn1yhYx6Q: calls $1
*** FLOP *** [4h 9h 2h]
NnQCepdIR/AOUQn1yhYx6Q: checks
/mfensKw8/iZ1Vrx33S4xg: checks
mj7PS7wCH4PAl7+eYTFs7A: checks
*** TURN *** [4h 9h 2h] [6c]
NnQCepdIR/AOUQn1yhYx6Q: checks
gsyXT42WLEcOS4DdEk2wlw joins the table at seat #7
/mfensKw8/iZ1Vrx33S4xg: bets $2
mj7PS7wCH4PAl7+eYTFs7A: calls $2
NnQCepdIR/AOUQn1yhYx6Q: calls $2
*** RIVER *** [4h 9h 2h 6c] [Qs]
NnQCepdIR/AOUQn1yhYx6Q: checks
/mfensKw8/iZ1Vrx33S4xg: bets $2
mj7PS7wCH4PAl7+eYTFs7A: calls $2
NnQCepdIR/AOUQn1yhYx6Q: calls $2
*** SHOW DOWN ***
/mfensKw8/iZ1Vrx33S4xg: shows [Qc Jc] (a pair of Queens)
mj7PS7wCH4PAl7+eYTFs7A: mucks hand
NnQCepdIR/AOUQn1yhYx6Q: mucks hand
/mfensKw8/iZ1Vrx33S4xg collected $15.95 from pot
*** SUMMARY ***
Total pot $16.75 | Rake $0.80
Board [4h 9h 2h 6c Qs]
Seat 1: mj7PS7wCH4PAl7+eYTFs7A mucked
Seat 2: OWP/DOu+PlPK6ZZ3zYa0HA (button) folded before Flop (didn't bet)
Seat 3: sakr/FIfFtIZwDPmAj5Pzg (small blind) folded before Flop
Seat 4: NnQCepdIR/AOUQn1yhYx6Q (big blind) mucked
Seat 6: SegjDnMxWMujiD57ESNL+g folded before Flop (didn't bet)
Seat 7: bmRtaIYKthN1F+B3JLZ3Jw folded before Flop (didn't bet)
Seat 8: /mfensKw8/iZ1Vrx33S4xg showed [Qc Jc] and won ($15.95) with a pair of Queens
Seat 9: sUIUZ+begh92dzkUmvbMrw folded before Flop (didn't bet)



PokerStars Game #59940789514:  Hold'em No Limit ($0.25/$0.50) - 2009/07/01 1:16:38 ET
Table '8BQGgNetI1NOvWeu3gtMNw' 2-max Seat #2 is the button
Seat 1: bypIyrYcAAifLfhZpGlKLA ($66.90 in chips)
Seat 2: Z4HwehErEwzsv/noQlfUlg ($126.90 in chips)
Z4HwehErEwzsv/noQlfUlg: posts small blind $0.25
bypIyrYcAAifLfhZpGlKLA: posts big blind $0.50
*** HOLE CARDS ***
Z4HwehErEwzsv/noQlfUlg: raises $1.50 to $2
bypIyrYcAAifLfhZpGlKLA: calls $1.50
*** FLOP *** [Ks 2d Kc]
bypIyrYcAAifLfhZpGlKLA: checks
Z4HwehErEwzsv/noQlfUlg: bets $2
bypIyrYcAAifLfhZpGlKLA: raises $6 to $8
Z4HwehErEwzsv/noQlfUlg: calls $6
*** TURN *** [Ks 2d Kc] [9c]
bypIyrYcAAifLfhZpGlKLA: checks
Z4HwehErEwzsv/noQlfUlg: checks
*** RIVER *** [Ks 2d Kc 9c] [7d]
bypIyrYcAAifLfhZpGlKLA: checks
Z4HwehErEwzsv/noQlfUlg: checks
*** SHOW DOWN ***
bypIyrYcAAifLfhZpGlKLA: shows [6s 8s] (a pair of Kings)
Z4HwehErEwzsv/noQlfUlg: shows [Th Td] (two pair, Kings and Tens)
Z4HwehErEwzsv/noQlfUlg collected $19.50 from pot
*** SUMMARY ***
Total pot $20 | Rake $0.50
Board [Ks 2d Kc 9c 7d]
Seat 1: bypIyrYcAAifLfhZpGlKLA (big blind) showed [6s 8s] and lost with a pair of Kings
Seat 2: Z4HwehErEwzsv/noQlfUlg (button) (small blind) showed [Th Td] and won ($19.50) with two pair, Kings and Tens



PokerStars Game #59940791460:  Hold'em No Limit ($0.25/$0.50) - 2009/07/01 1:16:41 ET
Table 'Nz0Vr7WMHL2g5Uk7dDZjpw' 9-max Seat #2 is the button
Seat 2: gsyXT42WLEcOS4DdEk2wlw ($40.20 in chips)
Seat 3: hoglu9inkgs6zN573/bJag ($5.10 in chips)
Seat 4: E2518gp4aFz1+kAgmGqeEg ($12.55 in chips)
Seat 5: WGW0DgjBUXs1ylURHG8vnQ ($18.15 in chips)
Seat 6: 997ViqAtWn1FPjJqcffwcA ($59.05 in chips)
Seat 7: KPLH0gELgFe2OuAnhJFI5w ($24.95 in chips)
Seat 8: aoL+R/61Kxmw69ypuPrWAQ ($22.50 in chips)
Seat 9: mSD1pginDsyHG5PDfqzphw ($10 in chips)
hoglu9inkgs6zN573/bJag: posts small blind $0.25
E2518gp4aFz1+kAgmGqeEg: posts big blind $0.50
*** HOLE CARDS ***
WGW0DgjBUXs1ylURHG8vnQ: folds
997ViqAtWn1FPjJqcffwcA: folds
KPLH0gELgFe2OuAnhJFI5w: folds
aoL+R/61Kxmw69ypuPrWAQ: calls $0.50
mSD1pginDsyHG5PDfqzphw: folds
mSD1pginDsyHG5PDfqzphw is sitting out
gsyXT42WLEcOS4DdEk2wlw: folds
hoglu9inkgs6zN573/bJag: folds
E2518gp4aFz1+kAgmGqeEg: checks
*** FLOP *** [2d 8h Qc]
E2518gp4aFz1+kAgmGqeEg: bets $1
aoL+R/61Kxmw69ypuPrWAQ: folds
E2518gp4aFz1+kAgmGqeEg collected $1.20 from pot
E2518gp4aFz1+kAgmGqeEg: doesn't show hand
*** SUMMARY ***
Total pot $1.25 | Rake $0.05
Board [2d 8h Qc]
Seat 2: gsyXT42WLEcOS4DdEk2wlw (button) folded before Flop (didn't bet)
Seat 3: hoglu9inkgs6zN573/bJag (small blind) folded before Flop
Seat 4: E2518gp4aFz1+kAgmGqeEg (big blind) collected ($1.20)
Seat 5: WGW0DgjBUXs1ylURHG8vnQ folded before Flop (didn't bet)
Seat 6: 997ViqAtWn1FPjJqcffwcA folded before Flop (didn't bet)
Seat 7: KPLH0gELgFe2OuAnhJFI5w folded before Flop (didn't bet)
Seat 8: aoL+R/61Kxmw69ypuPrWAQ folded on the Flop
Seat 9: mSD1pginDsyHG5PDfqzphw folded before Flop (didn't bet)



PokerStars Game #59940791622:  Hold'em No Limit ($0.25/$0.50) - 2009/07/01 1:16:42 ET
Table 'c/CRn+68J3Y8KxD5g1ek2Q' 2-max Seat #1 is the button
Seat 1: 46qCyJ6evTkHo9al5sBMNA ($116.95 in chips)
Seat 2: BypVLsYQt3ePFm2xQL/dOA ($246.10 in chips)
46qCyJ6evTkHo9al5sBMNA: posts small blind $0.25
BypVLsYQt3ePFm2xQL/dOA: posts big blind $0.50
*** HOLE CARDS ***
46qCyJ6evTkHo9al5sBMNA: folds
BypVLsYQt3ePFm2xQL/dOA collected $0.50 from pot
BypVLsYQt3ePFm2xQL/dOA: doesn't show hand
*** SUMMARY ***
Total pot $0.50 | Rake $0
Seat 1: 46qCyJ6evTkHo9al5sBMNA (button) (small blind) folded before Flop
Seat 2: BypVLsYQt3ePFm2xQL/dOA (big blind) collected ($0.50)



PokerStars Game #59940791776:  Hold'em No Limit ($0.25/$0.50) - 2009/07/01 1:16:42 ET
Table '5EmHi+fnatGQQShcNmzOZQ' 6-max Seat #2 is the button
Seat 1: My8WkRtGx5FW6rJ1I4R3hg ($42.80 in chips)
Seat 2: bfFjgAtIoAI+pUxUwFt3aQ ($39.15 in chips)
Seat 3: 1mYbhL8CU/QYqfVmFcaHDQ ($5.55 in chips)
Seat 4: 1b+2BbjMN8qhR1WPqdE9VQ ($58.35 in chips)
Seat 5: kxPhs4ePFqMy52CInAJ2aw ($93.10 in chips)
Seat 6: +Pf9jTVizYlIo+woPvptfA ($51.20 in chips)
1mYbhL8CU/QYqfVmFcaHDQ: posts small blind $0.25
1b+2BbjMN8qhR1WPqdE9VQ: posts big blind $0.50
*** HOLE CARDS ***
kxPhs4ePFqMy52CInAJ2aw: folds
+Pf9jTVizYlIo+woPvptfA: folds
My8WkRtGx5FW6rJ1I4R3hg: folds
bfFjgAtIoAI+pUxUwFt3aQ: folds
1mYbhL8CU/QYqfVmFcaHDQ: calls $0.25
1b+2BbjMN8qhR1WPqdE9VQ: raises $1 to $1.50
1mYbhL8CU/QYqfVmFcaHDQ: calls $1
*** FLOP *** [9s 5c 7d]
1mYbhL8CU/QYqfVmFcaHDQ: checks
1b+2BbjMN8qhR1WPqdE9VQ: checks
*** TURN *** [9s 5c 7d] [Ks]
1mYbhL8CU/QYqfVmFcaHDQ: bets $1
1b+2BbjMN8qhR1WPqdE9VQ: folds
1mYbhL8CU/QYqfVmFcaHDQ collected $2.85 from pot
1mYbhL8CU/QYqfVmFcaHDQ: doesn't show hand
*** SUMMARY ***
Total pot $3 | Rake $0.15
Board [9s 5c 7d Ks]
Seat 1: My8WkRtGx5FW6rJ1I4R3hg folded before Flop (didn't bet)
Seat 2: bfFjgAtIoAI+pUxUwFt3aQ (button) folded before Flop (didn't bet)
Seat 3: 1mYbhL8CU/QYqfVmFcaHDQ (small blind) collected ($2.85)
Seat 4: 1b+2BbjMN8qhR1WPqdE9VQ (big blind) folded on the Turn
Seat 5: kxPhs4ePFqMy52CInAJ2aw folded before Flop (didn't bet)
Seat 6: +Pf9jTVizYlIo+woPvptfA folded before Flop (didn't bet)



PokerStars Game #59940792902:  Hold'em No Limit ($0.25/$0.50) - 2009/07/01 1:16:44 ET
Table 'fx6MqwfYAj/Rt86hBz2L3Q' 9-max Seat #3 is the button
Seat 1: v/4aX0ejnaIFK4ftDk2Lyg ($49.50 in chips)
Seat 2: C3rGXblctNcWI6JYPHhaEg ($43.60 in chips)
Seat 3: iadBi5AEt7gTBXbDSSnMYQ ($50.40 in chips)
Seat 5: iAISe3dVeua8PUn2wwgDHw ($60.75 in chips)
Seat 6: 5k9fvXD9suIgCxU4HLQjTw ($50 in chips)
Seat 7: SKnJuWHScqetA/qG5p+wCg ($34.95 in chips)
Seat 8: JYwJYYV9pM5KWdSiETl8rA ($30 in chips)
iAISe3dVeua8PUn2wwgDHw: posts small blind $0.25
5k9fvXD9suIgCxU4HLQjTw: posts big blind $0.50
vO3QVRovWemcGMkm7ijAIA: sits out
*** HOLE CARDS ***
SKnJuWHScqetA/qG5p+wCg: folds
JYwJYYV9pM5KWdSiETl8rA: folds
v/4aX0ejnaIFK4ftDk2Lyg: folds
C3rGXblctNcWI6JYPHhaEg: calls $0.50
iadBi5AEt7gTBXbDSSnMYQ: folds
iAISe3dVeua8PUn2wwgDHw: folds
5k9fvXD9suIgCxU4HLQjTw: checks
*** FLOP *** [As 6c 5s]
5k9fvXD9suIgCxU4HLQjTw: checks
C3rGXblctNcWI6JYPHhaEg: checks
*** TURN *** [As 6c 5s] [8c]
5k9fvXD9suIgCxU4HLQjTw: checks
C3rGXblctNcWI6JYPHhaEg: bets $0.50
5k9fvXD9suIgCxU4HLQjTw: folds
C3rGXblctNcWI6JYPHhaEg collected $1.20 from pot
C3rGXblctNcWI6JYPHhaEg: doesn't show hand
*** SUMMARY ***
Total pot $1.25 | Rake $0.05
Board [As 6c 5s 8c]
Seat 1: v/4aX0ejnaIFK4ftDk2Lyg folded before Flop (didn't bet)
Seat 2: C3rGXblctNcWI6JYPHhaEg collected ($1.20)
Seat 3: iadBi5AEt7gTBXbDSSnMYQ (button) folded before Flop (didn't bet)
Seat 5: iAISe3dVeua8PUn2wwgDHw (small blind) folded before Flop
Seat 6: 5k9fvXD9suIgCxU4HLQjTw (big blind) folded on the Turn
Seat 7: SKnJuWHScqetA/qG5p+wCg folded before Flop (didn't bet)
Seat 8: JYwJYYV9pM5KWdSiETl8rA folded before Flop (didn't bet)



PokerStars Game #59940793468:  Hold'em No Limit ($0.25/$0.50) - 2009/07/01 1:16:45 ET
Table 'GfL/No5u5PoEnU39lP5pQg' 6-max Seat #4 is the button
Seat 1: 1WUCqNG+p+vfWRTXNu4ljw ($63.75 in chips)
Seat 2: uVwggSetzp7d+eVgowO3vg ($55.60 in chips)
Seat 3: 4pp9WxhGdbVbxCc9tlu0lw ($31.70 in chips)
Seat 4: r6u7MWSXF30/khcTYkrG9Q ($19.95 in chips)
Seat 5: M1KyQQvVPVuxqTAB8sR/zQ ($50.15 in chips)
Seat 6: kxPhs4ePFqMy52CInAJ2aw ($64.20 in chips)
M1KyQQvVPVuxqTAB8sR/zQ: posts small blind $0.25
kxPhs4ePFqMy52CInAJ2aw: posts big blind $0.50
*** HOLE CARDS ***
1WUCqNG+p+vfWRTXNu4ljw: folds
uVwggSetzp7d+eVgowO3vg: folds
4pp9WxhGdbVbxCc9tlu0lw: folds
r6u7MWSXF30/khcTYkrG9Q: raises $1 to $1.50
M1KyQQvVPVuxqTAB8sR/zQ: folds
kxPhs4ePFqMy52CInAJ2aw: calls $1
*** FLOP *** [5h 3d 7h]
kxPhs4ePFqMy52CInAJ2aw: checks
r6u7MWSXF30/khcTYkrG9Q: bets $2
kxPhs4ePFqMy52CInAJ2aw: folds
r6u7MWSXF30/khcTYkrG9Q collected $3.10 from pot
*** SUMMARY ***
Total pot $3.25 | Rake $0.15
Board [5h 3d 7h]
Seat 1: 1WUCqNG+p+vfWRTXNu4ljw folded before Flop (didn't bet)
Seat 2: uVwggSetzp7d+eVgowO3vg folded before Flop (didn't bet)
Seat 3: 4pp9WxhGdbVbxCc9tlu0lw folded before Flop (didn't bet)
Seat 4: r6u7MWSXF30/khcTYkrG9Q (button) collected ($3.10)
Seat 5: M1KyQQvVPVuxqTAB8sR/zQ (small blind) folded before Flop
Seat 6: kxPhs4ePFqMy52CInAJ2aw (big blind) folded on the Flop



PokerStars Game #59940793880:  Hold'em No Limit ($0.25/$0.50) - 2009/07/01 1:16:46 ET
Table 'PALRfuH85dr5IkDfdv6new' 9-max Seat #3 is the button
Seat 1: v/4aX0ejnaIFK4ftDk2Lyg ($48.75 in chips)
Seat 2: 1aXjSbrubyQKHeauooF5Wg ($48.15 in chips)
Seat 3: 50QWoELmpmHFrFIlWMJo9g ($91.60 in chips)
Seat 4: mZNMJI1mY40XTC0U7GZakA ($57.05 in chips)
Seat 5: qEn9ijNGtuyTxamBf07hYg ($50 in chips)
Seat 6: ottZQkg1UDWk85BtBzGJzg ($50.10 in chips)
Seat 7: 3NcyXvr39gnK+KbTq7ezyA ($55.25 in chips)
Seat 8: NkS+CseUKx4XHszWq0PXEQ ($75.75 in chips)
Seat 9: viwBDtJsY6JfsFOdBAyJIQ ($9.75 in chips)
mZNMJI1mY40XTC0U7GZakA: posts small blind $0.25
qEn9ijNGtuyTxamBf07hYg: posts big blind $0.50
*** HOLE CARDS ***
ottZQkg1UDWk85BtBzGJzg: folds
3NcyXvr39gnK+KbTq7ezyA: calls $0.50
NkS+CseUKx4XHszWq0PXEQ: calls $0.50
viwBDtJsY6JfsFOdBAyJIQ: folds
v/4aX0ejnaIFK4ftDk2Lyg: folds
1aXjSbrubyQKHeauooF5Wg: folds
50QWoELmpmHFrFIlWMJo9g: folds
mZNMJI1mY40XTC0U7GZakA: folds
qEn9ijNGtuyTxamBf07hYg: checks
*** FLOP *** [Jd Kd Qd]
qEn9ijNGtuyTxamBf07hYg: checks
3NcyXvr39gnK+KbTq7ezyA: checks
NkS+CseUKx4XHszWq0PXEQ: checks
*** TURN *** [Jd Kd Qd] [2s]
qEn9ijNGtuyTxamBf07hYg: checks
3NcyXvr39gnK+KbTq7ezyA: checks
NkS+CseUKx4XHszWq0PXEQ: checks
*** RIVER *** [Jd Kd Qd 2s] [5d]
qEn9ijNGtuyTxamBf07hYg: checks
3NcyXvr39gnK+KbTq7ezyA: checks
NkS+CseUKx4XHszWq0PXEQ: bets $2
qEn9ijNGtuyTxamBf07hYg: folds
qEn9ijNGtuyTxamBf07hYg is sitting out
3NcyXvr39gnK+KbTq7ezyA: folds
NkS+CseUKx4XHszWq0PXEQ collected $1.70 from pot
*** SUMMARY ***
Total pot $1.75 | Rake $0.05
Board [Jd Kd Qd 2s 5d]
Seat 1: v/4aX0ejnaIFK4ftDk2Lyg folded before Flop (didn't bet)
Seat 2: 1aXjSbrubyQKHeauooF5Wg folded before Flop (didn't bet)
Seat 3: 50QWoELmpmHFrFIlWMJo9g (button) folded before Flop (didn't bet)
Seat 4: mZNMJI1mY40XTC0U7GZakA (small blind) folded before Flop
Seat 5: qEn9ijNGtuyTxamBf07hYg (big blind) folded on the River
Seat 6: ottZQkg1UDWk85BtBzGJzg folded before Flop (didn't bet)
Seat 7: 3NcyXvr39gnK+KbTq7ezyA folded on the River
Seat 8: NkS+CseUKx4XHszWq0PXEQ collected ($1.70)
Seat 9: viwBDtJsY6JfsFOdBAyJIQ folded before Flop (didn't bet)



PokerStars Game #59940794592:  Hold'em No Limit ($0.25/$0.50) - 2009/07/01 1:16:47 ET
Table 'kgbJRsxfv64KrErDRBAkcw' 6-max Seat #5 is the button
Seat 1: VamsyhlFzXGF6/ydo0BHeA ($51.80 in chips)
Seat 2: AdS8BJMOheS01zjCDfPMFg ($50 in chips)
Seat 3: c4MNIaIyPMOMxrgT8FT5nA ($208.55 in chips)
Seat 5: eUBBn2R56C1IQ6Cs/vitwg ($50 in chips)
Seat 6: 1b+2BbjMN8qhR1WPqdE9VQ ($50.80 in chips)
1b+2BbjMN8qhR1WPqdE9VQ: posts small blind $0.25
VamsyhlFzXGF6/ydo0BHeA: posts big blind $0.50
2igtJLmvIZ+HqX4XPgMPZA: sits out
*** HOLE CARDS ***
AdS8BJMOheS01zjCDfPMFg: raises $1 to $1.50
c4MNIaIyPMOMxrgT8FT5nA: folds
eUBBn2R56C1IQ6Cs/vitwg: folds
1b+2BbjMN8qhR1WPqdE9VQ: folds
VamsyhlFzXGF6/ydo0BHeA: folds
AdS8BJMOheS01zjCDfPMFg collected $1.25 from pot
*** SUMMARY ***
Total pot $1.25 | Rake $0
Seat 1: VamsyhlFzXGF6/ydo0BHeA (big blind) folded before Flop
Seat 2: AdS8BJMOheS01zjCDfPMFg collected ($1.25)
Seat 3: c4MNIaIyPMOMxrgT8FT5nA folded before Flop (didn't bet)
Seat 5: eUBBn2R56C1IQ6Cs/vitwg (button) folded before Flop (didn't bet)
Seat 6: 1b+2BbjMN8qhR1WPqdE9VQ (small blind) folded before Flop



PokerStars Game #59940795834:  Hold'em No Limit ($0.25/$0.50) - 2009/07/01 1:16:49 ET
Table '9Puy2HWN1RQe5SSjq162gA' 2-max Seat #2 is the button
Seat 1: Fp/oksNpipCrD2MJ2pH20g ($21.50 in chips)
Seat 2: bUQEKmQTneRNtujMucgwag ($47.60 in chips)
bUQEKmQTneRNtujMucgwag: posts small blind $0.25
Fp/oksNpipCrD2MJ2pH20g: posts big blind $0.50
*** HOLE CARDS ***
bUQEKmQTneRNtujMucgwag: raises $0.50 to $1
Fp/oksNpipCrD2MJ2pH20g: calls $0.50
*** FLOP *** [Qd 9d 5s]
Fp/oksNpipCrD2MJ2pH20g: checks
bUQEKmQTneRNtujMucgwag: checks
*** TURN *** [Qd 9d 5s] [Td]
Fp/oksNpipCrD2MJ2pH20g: bets $2.50
bUQEKmQTneRNtujMucgwag: calls $2.50
*** RIVER *** [Qd 9d 5s Td] [Qc]
Fp/oksNpipCrD2MJ2pH20g: bets $5.50
bUQEKmQTneRNtujMucgwag: folds
Fp/oksNpipCrD2MJ2pH20g collected $6.70 from pot
Fp/oksNpipCrD2MJ2pH20g: doesn't show hand
*** SUMMARY ***
Total pot $7 | Rake $0.30
Board [Qd 9d 5s Td Qc]
Seat 1: Fp/oksNpipCrD2MJ2pH20g (big blind) collected ($6.70)
Seat 2: bUQEKmQTneRNtujMucgwag (button) (small blind) folded on the River



PokerStars Game #59940795958:  Hold'em No Limit ($0.25/$0.50) - 2009/07/01 1:16:49 ET
Table 'c/CRn+68J3Y8KxD5g1ek2Q' 2-max Seat #2 is the button
Seat 1: 46qCyJ6evTkHo9al5sBMNA ($116.70 in chips)
Seat 2: BypVLsYQt3ePFm2xQL/dOA ($246.35 in chips)
BypVLsYQt3ePFm2xQL/dOA: posts small blind $0.25
46qCyJ6evTkHo9al5sBMNA: posts big blind $0.50
*** HOLE CARDS ***
BypVLsYQt3ePFm2xQL/dOA: raises $0.50 to $1
46qCyJ6evTkHo9al5sBMNA: folds
BypVLsYQt3ePFm2xQL/dOA collected $1 from pot
BypVLsYQt3ePFm2xQL/dOA: doesn't show hand
*** SUMMARY ***
Total pot $1 | Rake $0
Seat 1: 46qCyJ6evTkHo9al5sBMNA (big blind) folded before Flop
Seat 2: BypVLsYQt3ePFm2xQL/dOA (button) (small blind) collected ($1)



PokerStars Game #59940796254:  Hold'em No Limit ($0.25/$0.50) - 2009/07/01 1:16:50 ET
Table 'MJxeZCzYELxiIsyUZyT0jw' 6-max Seat #3 is the button
Seat 1: +Pf9jTVizYlIo+woPvptfA ($50 in chips)
Seat 2: t3GiVMzqA9Svgr5Uol32cQ ($28.90 in chips)
Seat 3: sIG4mp8tZEI+W4nKZNkkQA ($51.85 in chips)
Seat 4: alGiiQP/wwtYnfuXII+sgw ($59.85 in chips)
Seat 5: 3jvoOXNtXE90w2BdfNZwZQ ($61.95 in chips)
Seat 6: c0n4hrn20AML9qzyFC2E8Q ($51.10 in chips)
alGiiQP/wwtYnfuXII+sgw: posts small blind $0.25
3jvoOXNtXE90w2BdfNZwZQ: posts big blind $0.50
*** HOLE CARDS ***
c0n4hrn20AML9qzyFC2E8Q: raises $1.50 to $2
+Pf9jTVizYlIo+woPvptfA: folds
t3GiVMzqA9Svgr5Uol32cQ: calls $2
sIG4mp8tZEI+W4nKZNkkQA: folds
alGiiQP/wwtYnfuXII+sgw: folds
3jvoOXNtXE90w2BdfNZwZQ: folds
*** FLOP *** [4d Kh Js]
c0n4hrn20AML9qzyFC2E8Q: checks
t3GiVMzqA9Svgr5Uol32cQ: checks
*** TURN *** [4d Kh Js] [3c]
c0n4hrn20AML9qzyFC2E8Q: checks
t3GiVMzqA9Svgr5Uol32cQ: checks
*** RIVER *** [4d Kh Js 3c] [7c]
c0n4hrn20AML9qzyFC2E8Q: bets $2
t3GiVMzqA9Svgr5Uol32cQ: raises $2 to $4
c0n4hrn20AML9qzyFC2E8Q: calls $2
*** SHOW DOWN ***
t3GiVMzqA9Svgr5Uol32cQ: shows [Ac Jc] (a pair of Jacks)
c0n4hrn20AML9qzyFC2E8Q: mucks hand
t3GiVMzqA9Svgr5Uol32cQ collected $12.15 from pot
*** SUMMARY ***
Total pot $12.75 | Rake $0.60
Board [4d Kh Js 3c 7c]
Seat 1: +Pf9jTVizYlIo+woPvptfA folded before Flop (didn't bet)
Seat 2: t3GiVMzqA9Svgr5Uol32cQ showed [Ac Jc] and won ($12.15) with a pair of Jacks
Seat 3: sIG4mp8tZEI+W4nKZNkkQA (button) folded before Flop (didn't bet)
Seat 4: alGiiQP/wwtYnfuXII+sgw (small blind) folded before Flop
Seat 5: 3jvoOXNtXE90w2BdfNZwZQ (big blind) folded before Flop
Seat 6: c0n4hrn20AML9qzyFC2E8Q mucked



PokerStars Game #59940796922:  Hold'em No Limit ($0.25/$0.50) - 2009/07/01 1:16:51 ET
Table '37qXEp3oe+er5q4CZip9eQ' 6-max Seat #5 is the button
Seat 1: lxIzoHy0RnkfFSODHC2liw ($50 in chips)
Seat 3: Rt6KgtZ8YaJoTc3FPim00w ($108.45 in chips)
Seat 4: XsmE8nXMAAMFJbWaJTmHFw ($60.30 in chips)
Seat 5: VOmI0x4dDPnTESZd5B4d1Q ($35.75 in chips)
lxIzoHy0RnkfFSODHC2liw: posts small blind $0.25
LvH4G7n+QSjT6NDaD3cREA: is sitting out
LvH4G7n+QSjT6NDaD3cREA leaves the table
Rt6KgtZ8YaJoTc3FPim00w: posts big blind $0.50
*** HOLE CARDS ***
XsmE8nXMAAMFJbWaJTmHFw: folds
XsmE8nXMAAMFJbWaJTmHFw leaves the table
VOmI0x4dDPnTESZd5B4d1Q: folds
lxIzoHy0RnkfFSODHC2liw: folds
Rt6KgtZ8YaJoTc3FPim00w collected $0.50 from pot
*** SUMMARY ***
Total pot $0.50 | Rake $0
Seat 1: lxIzoHy0RnkfFSODHC2liw (small blind) folded before Flop
Seat 3: Rt6KgtZ8YaJoTc3FPim00w (big blind) collected ($0.50)
Seat 4: XsmE8nXMAAMFJbWaJTmHFw folded before Flop (didn't bet)
Seat 5: VOmI0x4dDPnTESZd5B4d1Q (button) folded before Flop (didn't bet)



PokerStars Game #59940799580:  Hold'em No Limit ($0.25/$0.50) - 2009/07/01 1:16:56 ET
Table 'NCiXr0d5CEKBQr/cZgLhbA' 9-max Seat #1 is the button
Seat 1: pFtzb1sR4b0d1aw6aIRgDg ($50 in chips)
Seat 2: AjV5McH1KMMclY26QdLM5w ($25 in chips)
Seat 3: xZCXQSXlrZkp3pZizzVXCw ($51.95 in chips)
Seat 4: 5k9fvXD9suIgCxU4HLQjTw ($54.70 in chips)
Seat 7: M+7+BTmX5vZatHVuoRB1nA ($40.90 in chips)
Seat 8: 1MJUKc3cc0QmUoz1JZLR2w ($63.95 in chips)
Seat 9: 4WLZvqBn5qv5tds5kt5A1Q ($55.25 in chips)
AjV5McH1KMMclY26QdLM5w: posts small blind $0.25
xZCXQSXlrZkp3pZizzVXCw: posts big blind $0.50
Ja2jdidjip2UeJnRzmzAAQ: sits out
cards4hire: sits out
*** HOLE CARDS ***
5k9fvXD9suIgCxU4HLQjTw: folds
M+7+BTmX5vZatHVuoRB1nA: folds
1MJUKc3cc0QmUoz1JZLR2w: folds
4WLZvqBn5qv5tds5kt5A1Q: folds
pFtzb1sR4b0d1aw6aIRgDg: folds
AjV5McH1KMMclY26QdLM5w: raises $1 to $1.50
xZCXQSXlrZkp3pZizzVXCw: calls $1
*** FLOP *** [6c Ad 8h]
AjV5McH1KMMclY26QdLM5w: checks
xZCXQSXlrZkp3pZizzVXCw: checks
*** TURN *** [6c Ad 8h] [3c]
AjV5McH1KMMclY26QdLM5w: checks
xZCXQSXlrZkp3pZizzVXCw: checks
*** RIVER *** [6c Ad 8h 3c] [Qh]
AjV5McH1KMMclY26QdLM5w: checks
xZCXQSXlrZkp3pZizzVXCw: checks
*** SHOW DOWN ***
AjV5McH1KMMclY26QdLM5w: shows [Kc Ts] (high card Ace)
xZCXQSXlrZkp3pZizzVXCw: shows [4s 4c] (a pair of Fours)
xZCXQSXlrZkp3pZizzVXCw collected $2.85 from pot
*** SUMMARY ***
Total pot $3 | Rake $0.15
Board [6c Ad 8h 3c Qh]
Seat 1: pFtzb1sR4b0d1aw6aIRgDg (button) folded before Flop (didn't bet)
Seat 2: AjV5McH1KMMclY26QdLM5w (small blind) showed [Kc Ts] and lost with high card Ace
Seat 3: xZCXQSXlrZkp3pZizzVXCw (big blind) showed [4s 4c] and won ($2.85) with a pair of Fours
Seat 4: 5k9fvXD9suIgCxU4HLQjTw folded before Flop (didn't bet)
Seat 7: M+7+BTmX5vZatHVuoRB1nA folded before Flop (didn't bet)
Seat 8: 1MJUKc3cc0QmUoz1JZLR2w folded before Flop (didn't bet)
Seat 9: 4WLZvqBn5qv5tds5kt5A1Q folded before Flop (didn't bet)



PokerStars Game #59940799702:  Hold'em No Limit ($0.25/$0.50) - 2009/07/01 1:16:56 ET
Table 'X6IRCRTh+20gjz8aubWnwA' 9-max Seat #5 is the button
Seat 2: HZkVla4kK2SI42CVrPZ/ig ($5.80 in chips)
Seat 3: SWv01peOe69QQRvhQTqjQw ($5.05 in chips)
Seat 4: M3JFBNQ8Bbw3FBZ/18MuXw ($25.90 in chips)
Seat 5: NnQCepdIR/AOUQn1yhYx6Q ($8.50 in chips)
Seat 6: 75K2MXwN65Sjfp1yHd50Hg ($12.40 in chips)
Seat 7: cFHQjKQOOKTUzoilhrXHLg ($12.75 in chips)
Seat 8: HxeBVq06/3Bh/H986sgdbw ($49.25 in chips)
Seat 9: M+7+BTmX5vZatHVuoRB1nA ($45.55 in chips)
75K2MXwN65Sjfp1yHd50Hg: posts small blind $0.25
cFHQjKQOOKTUzoilhrXHLg: posts big blind $0.50
E2518gp4aFz1+kAgmGqeEg: sits out
*** HOLE CARDS ***
HxeBVq06/3Bh/H986sgdbw: folds
M+7+BTmX5vZatHVuoRB1nA: folds
HZkVla4kK2SI42CVrPZ/ig: folds
SWv01peOe69QQRvhQTqjQw: folds
M3JFBNQ8Bbw3FBZ/18MuXw: raises $1 to $1.50
NnQCepdIR/AOUQn1yhYx6Q: folds
75K2MXwN65Sjfp1yHd50Hg: folds
cFHQjKQOOKTUzoilhrXHLg: folds
M3JFBNQ8Bbw3FBZ/18MuXw collected $1.25 from pot
*** SUMMARY ***
Total pot $1.25 | Rake $0
Seat 2: HZkVla4kK2SI42CVrPZ/ig folded before Flop (didn't bet)
Seat 3: SWv01peOe69QQRvhQTqjQw folded before Flop (didn't bet)
Seat 4: M3JFBNQ8Bbw3FBZ/18MuXw collected ($1.25)
Seat 5: NnQCepdIR/AOUQn1yhYx6Q (button) folded before Flop (didn't bet)
Seat 6: 75K2MXwN65Sjfp1yHd50Hg (small blind) folded before Flop
Seat 7: cFHQjKQOOKTUzoilhrXHLg (big blind) folded before Flop
Seat 8: HxeBVq06/3Bh/H986sgdbw folded before Flop (didn't bet)
Seat 9: M+7+BTmX5vZatHVuoRB1nA folded before Flop (didn't bet)



PokerStars Game #59940800944:  Hold'em No Limit ($0.25/$0.50) - 2009/07/01 1:16:58 ET
Table 'c/CRn+68J3Y8KxD5g1ek2Q' 2-max Seat #1 is the button
Seat 1: 46qCyJ6evTkHo9al5sBMNA ($116.20 in chips)
Seat 2: BypVLsYQt3ePFm2xQL/dOA ($246.85 in chips)
46qCyJ6evTkHo9al5sBMNA: posts small blind $0.25
BypVLsYQt3ePFm2xQL/dOA: posts big blind $0.50
*** HOLE CARDS ***
46qCyJ6evTkHo9al5sBMNA: raises $1.50 to $2
BypVLsYQt3ePFm2xQL/dOA: calls $1.50
*** FLOP *** [7c 7d Td]
BypVLsYQt3ePFm2xQL/dOA: checks
46qCyJ6evTkHo9al5sBMNA: bets $2.50
BypVLsYQt3ePFm2xQL/dOA: calls $2.50
*** TURN *** [7c 7d Td] [Js]
BypVLsYQt3ePFm2xQL/dOA: checks
46qCyJ6evTkHo9al5sBMNA: checks
*** RIVER *** [7c 7d Td Js] [5d]
BypVLsYQt3ePFm2xQL/dOA: bets $9.50
46qCyJ6evTkHo9al5sBMNA: folds
BypVLsYQt3ePFm2xQL/dOA collected $8.60 from pot
BypVLsYQt3ePFm2xQL/dOA: doesn't show hand
*** SUMMARY ***
Total pot $9 | Rake $0.40
Board [7c 7d Td Js 5d]
Seat 1: 46qCyJ6evTkHo9al5sBMNA (button) (small blind) folded on the River
Seat 2: BypVLsYQt3ePFm2xQL/dOA (big blind) collected ($8.60)



PokerStars Game #59940800756:  Hold'em No Limit ($0.25/$0.50) - 2009/07/01 1:16:58 ET
Table 'QOgaEqMcJ73pcUMMxoisUg' 6-max Seat #4 is the button
Seat 1: lxIzoHy0RnkfFSODHC2liw ($50 in chips)
Seat 2: oqOqoO2AyCZenUghCxMDxw ($60 in chips)
Seat 3: Rt6KgtZ8YaJoTc3FPim00w ($53.75 in chips)
Seat 4: zAcsDhG/T128Vn7XGVSgKg ($59.15 in chips)
Seat 6: AdS8BJMOheS01zjCDfPMFg ($107.45 in chips)
AdS8BJMOheS01zjCDfPMFg: posts small blind $0.25
lxIzoHy0RnkfFSODHC2liw: posts big blind $0.50
*** HOLE CARDS ***
oqOqoO2AyCZenUghCxMDxw: folds
Rt6KgtZ8YaJoTc3FPim00w: folds
zAcsDhG/T128Vn7XGVSgKg: raises $1 to $1.50
AdS8BJMOheS01zjCDfPMFg: calls $1.25
lxIzoHy0RnkfFSODHC2liw: folds
*** FLOP *** [8h 6d Jd]
AdS8BJMOheS01zjCDfPMFg: checks
zAcsDhG/T128Vn7XGVSgKg: bets $2.50
AdS8BJMOheS01zjCDfPMFg: folds
zAcsDhG/T128Vn7XGVSgKg collected $3.35 from pot
*** SUMMARY ***
Total pot $3.50 | Rake $0.15
Board [8h 6d Jd]
Seat 1: lxIzoHy0RnkfFSODHC2liw (big blind) folded before Flop
Seat 2: oqOqoO2AyCZenUghCxMDxw folded before Flop (didn't bet)
Seat 3: Rt6KgtZ8YaJoTc3FPim00w folded before Flop (didn't bet)
Seat 4: zAcsDhG/T128Vn7XGVSgKg (button) collected ($3.35)
Seat 6: AdS8BJMOheS01zjCDfPMFg (small blind) folded on the Flop



PokerStars Game #59940802802:  Hold'em No Limit ($0.25/$0.50) - 2009/07/01 1:17:01 ET
Table 'lSisgp6H7Fg1hH5VfjEjYQ' 9-max Seat #6 is the button
Seat 1: 5k9fvXD9suIgCxU4HLQjTw ($50 in chips)
Seat 2: UrcnkQOiLVk8BlKDPJSy7Q ($77.90 in chips)
Seat 3: aTkyjTh3w5YLWiIERupZOA ($55.20 in chips)
Seat 4: bwv/rbH/hHhPhY6u9mu04w ($33.85 in chips)
Seat 5: mSD1pginDsyHG5PDfqzphw ($13 in chips)
Seat 6: +k7T5ocke8UwavtgUHm+Cg ($64.40 in chips)
Seat 7: IDtNLR9uFCDdjNsJWMHA5Q ($21.55 in chips)
Seat 8: a4JDWmpFQkL10XfAyuF51A ($16.25 in chips)
Seat 9: YzeKFbJVLmJGTgNH3ySQlw ($13.35 in chips)
IDtNLR9uFCDdjNsJWMHA5Q: posts small blind $0.25
a4JDWmpFQkL10XfAyuF51A: posts big blind $0.50
*** HOLE CARDS ***
YzeKFbJVLmJGTgNH3ySQlw: calls $0.50
5k9fvXD9suIgCxU4HLQjTw: folds
UrcnkQOiLVk8BlKDPJSy7Q: folds
aTkyjTh3w5YLWiIERupZOA: folds
bwv/rbH/hHhPhY6u9mu04w: folds
mSD1pginDsyHG5PDfqzphw: folds
mSD1pginDsyHG5PDfqzphw is sitting out
+k7T5ocke8UwavtgUHm+Cg: folds
IDtNLR9uFCDdjNsJWMHA5Q: calls $0.25
a4JDWmpFQkL10XfAyuF51A: checks
*** FLOP *** [Tc Kd 4s]
aTkyjTh3w5YLWiIERupZOA leaves the table
IDtNLR9uFCDdjNsJWMHA5Q: checks
a4JDWmpFQkL10XfAyuF51A: checks
YzeKFbJVLmJGTgNH3ySQlw: bets $1
IDtNLR9uFCDdjNsJWMHA5Q: folds
a4JDWmpFQkL10XfAyuF51A: folds
YzeKFbJVLmJGTgNH3ySQlw collected $1.45 from pot
*** SUMMARY ***
Total pot $1.50 | Rake $0.05
Board [Tc Kd 4s]
Seat 1: 5k9fvXD9suIgCxU4HLQjTw folded before Flop (didn't bet)
Seat 2: UrcnkQOiLVk8BlKDPJSy7Q folded before Flop (didn't bet)
Seat 3: aTkyjTh3w5YLWiIERupZOA folded before Flop (didn't bet)
Seat 4: bwv/rbH/hHhPhY6u9mu04w folded before Flop (didn't bet)
Seat 5: mSD1pginDsyHG5PDfqzphw folded before Flop (didn't bet)
Seat 6: +k7T5ocke8UwavtgUHm+Cg (button) folded before Flop (didn't bet)
Seat 7: IDtNLR9uFCDdjNsJWMHA5Q (small blind) folded on the Flop
Seat 8: a4JDWmpFQkL10XfAyuF51A (big blind) folded on the Flop
Seat 9: YzeKFbJVLmJGTgNH3ySQlw collected ($1.45)



PokerStars Game #59940803072:  Hold'em No Limit ($0.25/$0.50) - 2009/07/01 1:17:02 ET
Table 'BCN5su+SsXiy1zRMJi0SJw' 6-max Seat #5 is the button
Seat 1: GxXV09ciXaOxyY2H5aMIIw ($55.35 in chips)
Seat 2: oU2kDCkT/gilYbHWrg7D8w ($14.45 in chips)
Seat 3: kwgv5lNhiFrfONXCshzxlA ($29.85 in chips)
Seat 4: 4QfsCWthT/vSLirorNXqtg ($52.25 in chips)
Seat 5: cEMJmfAUQZmMChZe6aacKw ($46.10 in chips)
Seat 6: b2symlOdL7+0c9Pj4N/KlA ($58.40 in chips)
b2symlOdL7+0c9Pj4N/KlA: posts small blind $0.25
GxXV09ciXaOxyY2H5aMIIw: posts big blind $0.50
*** HOLE CARDS ***
oU2kDCkT/gilYbHWrg7D8w: raises $13.95 to $14.45 and is all-in
kwgv5lNhiFrfONXCshzxlA: raises $15.40 to $29.85 and is all-in
oU2kDCkT/gilYbHWrg7D8w said, "doubel me back up bb"
4QfsCWthT/vSLirorNXqtg: folds
oU2kDCkT/gilYbHWrg7D8w said, "there ya go"
oU2kDCkT/gilYbHWrg7D8w said, "gl"
cEMJmfAUQZmMChZe6aacKw: folds
b2symlOdL7+0c9Pj4N/KlA: folds
GxXV09ciXaOxyY2H5aMIIw: folds
*** FLOP *** [5s 6h 9s]
*** TURN *** [5s 6h 9s] [2s]
*** RIVER *** [5s 6h 9s 2s] [Ac]
*** SHOW DOWN ***
oU2kDCkT/gilYbHWrg7D8w: shows [7s 7h] (a pair of Sevens)
kwgv5lNhiFrfONXCshzxlA: shows [Ks Kc] (a pair of Kings)
kwgv5lNhiFrfONXCshzxlA collected $28.20 from pot
*** SUMMARY ***
Total pot $29.65 | Rake $1.45
Board [5s 6h 9s 2s Ac]
Seat 1: GxXV09ciXaOxyY2H5aMIIw (big blind) folded before Flop
Seat 2: oU2kDCkT/gilYbHWrg7D8w showed [7s 7h] and lost with a pair of Sevens
Seat 3: kwgv5lNhiFrfONXCshzxlA showed [Ks Kc] and won ($28.20) with a pair of Kings
Seat 4: 4QfsCWthT/vSLirorNXqtg folded before Flop (didn't bet)
Seat 5: cEMJmfAUQZmMChZe6aacKw (button) folded before Flop (didn't bet)
Seat 6: b2symlOdL7+0c9Pj4N/KlA (small blind) folded before Flop



PokerStars Game #59940804646:  Hold'em No Limit ($0.25/$0.50) - 2009/07/01 1:17:04 ET
Table '8BQGgNetI1NOvWeu3gtMNw' 2-max Seat #1 is the button
Seat 1: bypIyrYcAAifLfhZpGlKLA ($56.90 in chips)
Seat 2: Z4HwehErEwzsv/noQlfUlg ($136.40 in chips)
bypIyrYcAAifLfhZpGlKLA: posts small blind $0.25
Z4HwehErEwzsv/noQlfUlg: posts big blind $0.50
*** HOLE CARDS ***
bypIyrYcAAifLfhZpGlKLA: raises $1 to $1.50
Z4HwehErEwzsv/noQlfUlg: folds
bypIyrYcAAifLfhZpGlKLA collected $1 from pot
bypIyrYcAAifLfhZpGlKLA: doesn't show hand
*** SUMMARY ***
Total pot $1 | Rake $0
Seat 1: bypIyrYcAAifLfhZpGlKLA (button) (small blind) collected ($1)
Seat 2: Z4HwehErEwzsv/noQlfUlg (big blind) folded before Flop



PokerStars Game #59940806100:  Hold'em No Limit ($0.25/$0.50) - 2009/07/01 1:17:07 ET
Table 'EiNh8p/wGJ1FP575iMFnqg' 9-max Seat #9 is the button
Seat 2: 8ehL7qlZzjgUh2H35iiWLw ($59.15 in chips)
Seat 3: ymLPoEIl7UL3TvZYmnadxQ ($55.05 in chips)
Seat 4: cMzaiXAM/ZAdNaEUu+LqhA ($50 in chips)
Seat 5: M+7+BTmX5vZatHVuoRB1nA ($79.70 in chips)
Seat 6: viwBDtJsY6JfsFOdBAyJIQ ($10 in chips)
Seat 7: 997ViqAtWn1FPjJqcffwcA ($50 in chips)
Seat 9: GuPkZObrz5Zkkn8FsEdF9w ($30.70 in chips)
r3ZqM1Mi0W3y4hOdssE+Sg: is sitting out
8ehL7qlZzjgUh2H35iiWLw: posts small blind $0.25
ymLPoEIl7UL3TvZYmnadxQ: posts big blind $0.50
viwBDtJsY6JfsFOdBAyJIQ: posts big blind $0.50
*** HOLE CARDS ***
cMzaiXAM/ZAdNaEUu+LqhA: folds
r3ZqM1Mi0W3y4hOdssE+Sg leaves the table
M+7+BTmX5vZatHVuoRB1nA: folds
viwBDtJsY6JfsFOdBAyJIQ: checks
997ViqAtWn1FPjJqcffwcA: folds
GuPkZObrz5Zkkn8FsEdF9w: folds
8ehL7qlZzjgUh2H35iiWLw: folds
ymLPoEIl7UL3TvZYmnadxQ: checks
*** FLOP *** [6h 4c 6c]
ymLPoEIl7UL3TvZYmnadxQ: checks
viwBDtJsY6JfsFOdBAyJIQ: bets $0.50
ymLPoEIl7UL3TvZYmnadxQ: folds
viwBDtJsY6JfsFOdBAyJIQ collected $1.20 from pot
*** SUMMARY ***
Total pot $1.25 | Rake $0.05
Board [6h 4c 6c]
Seat 2: 8ehL7qlZzjgUh2H35iiWLw (small blind) folded before Flop
Seat 3: ymLPoEIl7UL3TvZYmnadxQ (big blind) folded on the Flop
Seat 4: cMzaiXAM/ZAdNaEUu+LqhA folded before Flop (didn't bet)
Seat 5: M+7+BTmX5vZatHVuoRB1nA folded before Flop (didn't bet)
Seat 6: viwBDtJsY6JfsFOdBAyJIQ collected ($1.20)
Seat 7: 997ViqAtWn1FPjJqcffwcA folded before Flop (didn't bet)
Seat 9: GuPkZObrz5Zkkn8FsEdF9w (button) folded before Flop (didn't bet)



PokerStars Game #59940806938:  Hold'em No Limit ($0.25/$0.50) - 2009/07/01 1:17:08 ET
Table '+dXkOAQyS8j9PQZusUTMpg' 2-max Seat #1 is the button
Seat 1: Teld4PDKla7C8/Wfu2DSkg ($50 in chips)
Seat 2: +zI4bP23YIjMkUHqeN2xfw ($30 in chips)
Teld4PDKla7C8/Wfu2DSkg: posts small blind $0.25
+zI4bP23YIjMkUHqeN2xfw: posts big blind $0.50
*** HOLE CARDS ***
Teld4PDKla7C8/Wfu2DSkg: raises $0.50 to $1
+zI4bP23YIjMkUHqeN2xfw: folds
Teld4PDKla7C8/Wfu2DSkg collected $1 from pot
Teld4PDKla7C8/Wfu2DSkg: doesn't show hand
*** SUMMARY ***
Total pot $1 | Rake $0
Seat 1: Teld4PDKla7C8/Wfu2DSkg (button) (small blind) collected ($1)
Seat 2: +zI4bP23YIjMkUHqeN2xfw (big blind) folded before Flop



PokerStars Game #59940808130:  Hold'em No Limit ($0.25/$0.50) - 2009/07/01 1:17:10 ET
Table 'hSTs/dUsYLgJQuF2Onp0MQ' 6-max Seat #6 is the button
Seat 1: 1WUCqNG+p+vfWRTXNu4ljw ($50 in chips)
Seat 3: C3qJBo7uxfFVDluE1lmK2w ($31.10 in chips)
Seat 5: IBNygaT1aa9Z1uPdJJilwA ($35.40 in chips)
Seat 6: M1KyQQvVPVuxqTAB8sR/zQ ($88.20 in chips)
1WUCqNG+p+vfWRTXNu4ljw: posts small blind $0.25
C3qJBo7uxfFVDluE1lmK2w: posts big blind $0.50
2igtJLmvIZ+HqX4XPgMPZA: sits out
*** HOLE CARDS ***
IBNygaT1aa9Z1uPdJJilwA: folds
M1KyQQvVPVuxqTAB8sR/zQ: folds
1WUCqNG+p+vfWRTXNu4ljw: folds
C3qJBo7uxfFVDluE1lmK2w collected $0.50 from pot
*** SUMMARY ***
Total pot $0.50 | Rake $0
Seat 1: 1WUCqNG+p+vfWRTXNu4ljw (small blind) folded before Flop
Seat 3: C3qJBo7uxfFVDluE1lmK2w (big blind) collected ($0.50)
Seat 5: IBNygaT1aa9Z1uPdJJilwA folded before Flop (didn't bet)
Seat 6: M1KyQQvVPVuxqTAB8sR/zQ (button) folded before Flop (didn't bet)



PokerStars Game #59940809668:  Hold'em No Limit ($0.25/$0.50) - 2009/07/01 1:17:13 ET
Table 'GfL/No5u5PoEnU39lP5pQg' 6-max Seat #5 is the button
Seat 1: 1WUCqNG+p+vfWRTXNu4ljw ($63.75 in chips)
Seat 2: uVwggSetzp7d+eVgowO3vg ($55.60 in chips)
Seat 3: 4pp9WxhGdbVbxCc9tlu0lw ($31.70 in chips)
Seat 4: r6u7MWSXF30/khcTYkrG9Q ($21.55 in chips)
Seat 5: M1KyQQvVPVuxqTAB8sR/zQ ($50 in chips)
Seat 6: kxPhs4ePFqMy52CInAJ2aw ($62.70 in chips)
kxPhs4ePFqMy52CInAJ2aw: posts small blind $0.25
1WUCqNG+p+vfWRTXNu4ljw: posts big blind $0.50
*** HOLE CARDS ***
uVwggSetzp7d+eVgowO3vg: folds
4pp9WxhGdbVbxCc9tlu0lw: folds
r6u7MWSXF30/khcTYkrG9Q: calls $0.50
M1KyQQvVPVuxqTAB8sR/zQ: folds
kxPhs4ePFqMy52CInAJ2aw: folds
1WUCqNG+p+vfWRTXNu4ljw: checks
*** FLOP *** [6c 9s 7d]
1WUCqNG+p+vfWRTXNu4ljw: checks
r6u7MWSXF30/khcTYkrG9Q: bets $1
1WUCqNG+p+vfWRTXNu4ljw: folds
r6u7MWSXF30/khcTYkrG9Q collected $1.20 from pot
r6u7MWSXF30/khcTYkrG9Q: doesn't show hand
*** SUMMARY ***
Total pot $1.25 | Rake $0.05
Board [6c 9s 7d]
Seat 1: 1WUCqNG+p+vfWRTXNu4ljw (big blind) folded on the Flop
Seat 2: uVwggSetzp7d+eVgowO3vg folded before Flop (didn't bet)
Seat 3: 4pp9WxhGdbVbxCc9tlu0lw folded before Flop (didn't bet)
Seat 4: r6u7MWSXF30/khcTYkrG9Q collected ($1.20)
Seat 5: M1KyQQvVPVuxqTAB8sR/zQ (button) folded before Flop (didn't bet)
Seat 6: kxPhs4ePFqMy52CInAJ2aw (small blind) folded before Flop



PokerStars Game #59940809854:  Hold'em No Limit ($0.25/$0.50) - 2009/07/01 1:17:14 ET
Table 'fx6MqwfYAj/Rt86hBz2L3Q' 9-max Seat #5 is the button
Seat 1: v/4aX0ejnaIFK4ftDk2Lyg ($49.50 in chips)
Seat 2: C3rGXblctNcWI6JYPHhaEg ($44.30 in chips)
Seat 3: iadBi5AEt7gTBXbDSSnMYQ ($50.40 in chips)
Seat 5: iAISe3dVeua8PUn2wwgDHw ($60.50 in chips)
Seat 6: 5k9fvXD9suIgCxU4HLQjTw ($50 in chips)
Seat 7: SKnJuWHScqetA/qG5p+wCg ($34.95 in chips)
Seat 8: JYwJYYV9pM5KWdSiETl8rA ($30 in chips)
5k9fvXD9suIgCxU4HLQjTw: posts small blind $0.25
SKnJuWHScqetA/qG5p+wCg: posts big blind $0.50
vO3QVRovWemcGMkm7ijAIA: sits out
*** HOLE CARDS ***
JYwJYYV9pM5KWdSiETl8rA: folds
v/4aX0ejnaIFK4ftDk2Lyg: folds
C3rGXblctNcWI6JYPHhaEg: calls $0.50
iadBi5AEt7gTBXbDSSnMYQ: calls $0.50
iAISe3dVeua8PUn2wwgDHw: calls $0.50
5k9fvXD9suIgCxU4HLQjTw: calls $0.25
SKnJuWHScqetA/qG5p+wCg: checks
*** FLOP *** [6c Kd 5s]
5k9fvXD9suIgCxU4HLQjTw: checks
SKnJuWHScqetA/qG5p+wCg: checks
C3rGXblctNcWI6JYPHhaEg: bets $1.80
iadBi5AEt7gTBXbDSSnMYQ: folds
iAISe3dVeua8PUn2wwgDHw: raises $1.80 to $3.60
5k9fvXD9suIgCxU4HLQjTw: folds
SKnJuWHScqetA/qG5p+wCg: folds
C3rGXblctNcWI6JYPHhaEg: calls $1.80
*** TURN *** [6c Kd 5s] [Ad]
C3rGXblctNcWI6JYPHhaEg: checks
iAISe3dVeua8PUn2wwgDHw: bets $3
C3rGXblctNcWI6JYPHhaEg: folds
iAISe3dVeua8PUn2wwgDHw collected $9.25 from pot
*** SUMMARY ***
Total pot $9.70 | Rake $0.45
Board [6c Kd 5s Ad]
Seat 1: v/4aX0ejnaIFK4ftDk2Lyg folded before Flop (didn't bet)
Seat 2: C3rGXblctNcWI6JYPHhaEg folded on the Turn
Seat 3: iadBi5AEt7gTBXbDSSnMYQ folded on the Flop
Seat 5: iAISe3dVeua8PUn2wwgDHw (button) collected ($9.25)
Seat 6: 5k9fvXD9suIgCxU4HLQjTw (small blind) folded on the Flop
Seat 7: SKnJuWHScqetA/qG5p+wCg (big blind) folded on the Flop
Seat 8: JYwJYYV9pM5KWdSiETl8rA folded before Flop (didn't bet)



PokerStars Game #59940810350:  Hold'em No Limit ($0.25/$0.50) - 2009/07/01 1:17:14 ET
Table '8BQGgNetI1NOvWeu3gtMNw' 2-max Seat #2 is the button
Seat 1: bypIyrYcAAifLfhZpGlKLA ($57.40 in chips)
Seat 2: Z4HwehErEwzsv/noQlfUlg ($135.90 in chips)
Z4HwehErEwzsv/noQlfUlg: posts small blind $0.25
bypIyrYcAAifLfhZpGlKLA: posts big blind $0.50
*** HOLE CARDS ***
Z4HwehErEwzsv/noQlfUlg: calls $0.25
bypIyrYcAAifLfhZpGlKLA: raises $1.50 to $2
Z4HwehErEwzsv/noQlfUlg: calls $1.50
*** FLOP *** [Ts 7d 3h]
bypIyrYcAAifLfhZpGlKLA: bets $3
Z4HwehErEwzsv/noQlfUlg: calls $3
*** TURN *** [Ts 7d 3h] [2h]
bypIyrYcAAifLfhZpGlKLA: checks
Z4HwehErEwzsv/noQlfUlg: bets $5
bypIyrYcAAifLfhZpGlKLA: raises $14 to $19
Z4HwehErEwzsv/noQlfUlg: calls $14
*** RIVER *** [Ts 7d 3h 2h] [Th]
bypIyrYcAAifLfhZpGlKLA: bets $33.40 and is all-in
Z4HwehErEwzsv/noQlfUlg: folds
bypIyrYcAAifLfhZpGlKLA collected $47.50 from pot
bypIyrYcAAifLfhZpGlKLA: doesn't show hand
*** SUMMARY ***
Total pot $48 | Rake $0.50
Board [Ts 7d 3h 2h Th]
Seat 1: bypIyrYcAAifLfhZpGlKLA (big blind) collected ($47.50)
Seat 2: Z4HwehErEwzsv/noQlfUlg (button) (small blind) folded on the River



PokerStars Game #59940811706:  Hold'em No Limit ($0.25/$0.50) - 2009/07/01 1:17:17 ET
Table '+dXkOAQyS8j9PQZusUTMpg' 2-max Seat #2 is the button
Seat 1: Teld4PDKla7C8/Wfu2DSkg ($50.50 in chips)
Seat 2: +zI4bP23YIjMkUHqeN2xfw ($29.50 in chips)
+zI4bP23YIjMkUHqeN2xfw: posts small blind $0.25
Teld4PDKla7C8/Wfu2DSkg: posts big blind $0.50
*** HOLE CARDS ***
+zI4bP23YIjMkUHqeN2xfw: calls $0.25
Teld4PDKla7C8/Wfu2DSkg: checks
*** FLOP *** [7s Qh 5s]
Teld4PDKla7C8/Wfu2DSkg: checks
+zI4bP23YIjMkUHqeN2xfw: checks
*** TURN *** [7s Qh 5s] [7h]
Teld4PDKla7C8/Wfu2DSkg: checks
+zI4bP23YIjMkUHqeN2xfw: checks
*** RIVER *** [7s Qh 5s 7h] [5h]
Teld4PDKla7C8/Wfu2DSkg: checks
+zI4bP23YIjMkUHqeN2xfw: checks
*** SHOW DOWN ***
Teld4PDKla7C8/Wfu2DSkg: shows [2d 8d] (two pair, Sevens and Fives)
+zI4bP23YIjMkUHqeN2xfw: shows [Js 9d] (two pair, Sevens and Fives)
Teld4PDKla7C8/Wfu2DSkg collected $0.50 from pot
+zI4bP23YIjMkUHqeN2xfw collected $0.45 from pot
*** SUMMARY ***
Total pot $1 | Rake $0.05
Board [7s Qh 5s 7h 5h]
Seat 1: Teld4PDKla7C8/Wfu2DSkg (big blind) showed [2d 8d] and won ($0.50) with two pair, Sevens and Fives
Seat 2: +zI4bP23YIjMkUHqeN2xfw (button) (small blind) showed [Js 9d] and won ($0.45) with two pair, Sevens and Fives



PokerStars Game #59940812674:  Hold'em No Limit ($0.25/$0.50) - 2009/07/01 1:17:18 ET
Table 'kgbJRsxfv64KrErDRBAkcw' 6-max Seat #6 is the button
Seat 1: VamsyhlFzXGF6/ydo0BHeA ($51.30 in chips)
Seat 2: AdS8BJMOheS01zjCDfPMFg ($50.75 in chips)
Seat 3: c4MNIaIyPMOMxrgT8FT5nA ($208.55 in chips)
Seat 5: eUBBn2R56C1IQ6Cs/vitwg ($50 in chips)
Seat 6: 1b+2BbjMN8qhR1WPqdE9VQ ($50.55 in chips)
VamsyhlFzXGF6/ydo0BHeA: posts small blind $0.25
AdS8BJMOheS01zjCDfPMFg: posts big blind $0.50
2igtJLmvIZ+HqX4XPgMPZA: sits out
*** HOLE CARDS ***
c4MNIaIyPMOMxrgT8FT5nA: raises $1 to $1.50
eUBBn2R56C1IQ6Cs/vitwg: folds
1b+2BbjMN8qhR1WPqdE9VQ: folds
VamsyhlFzXGF6/ydo0BHeA: calls $1.25
AdS8BJMOheS01zjCDfPMFg: folds
*** FLOP *** [6c Jd Ac]
VamsyhlFzXGF6/ydo0BHeA: checks
c4MNIaIyPMOMxrgT8FT5nA: bets $6
VamsyhlFzXGF6/ydo0BHeA: calls $6
*** TURN *** [6c Jd Ac] [9c]
VamsyhlFzXGF6/ydo0BHeA: checks
c4MNIaIyPMOMxrgT8FT5nA: checks
*** RIVER *** [6c Jd Ac 9c] [Ks]
VamsyhlFzXGF6/ydo0BHeA: checks
c4MNIaIyPMOMxrgT8FT5nA: checks
*** SHOW DOWN ***
VamsyhlFzXGF6/ydo0BHeA: shows [6s 5d] (a pair of Sixes)
c4MNIaIyPMOMxrgT8FT5nA: shows [Ad 5h] (a pair of Aces)
c4MNIaIyPMOMxrgT8FT5nA collected $14.75 from pot
*** SUMMARY ***
Total pot $15.50 | Rake $0.75
Board [6c Jd Ac 9c Ks]
Seat 1: VamsyhlFzXGF6/ydo0BHeA (small blind) showed [6s 5d] and lost with a pair of Sixes
Seat 2: AdS8BJMOheS01zjCDfPMFg (big blind) folded before Flop
Seat 3: c4MNIaIyPMOMxrgT8FT5nA showed [Ad 5h] and won ($14.75) with a pair of Aces
Seat 5: eUBBn2R56C1IQ6Cs/vitwg folded before Flop (didn't bet)
Seat 6: 1b+2BbjMN8qhR1WPqdE9VQ (button) folded before Flop (didn't bet)



PokerStars Game #59940814046:  Hold'em No Limit ($0.25/$0.50) - 2009/07/01 1:17:21 ET
Table '5EmHi+fnatGQQShcNmzOZQ' 6-max Seat #3 is the button
Seat 1: My8WkRtGx5FW6rJ1I4R3hg ($42.80 in chips)
Seat 2: bfFjgAtIoAI+pUxUwFt3aQ ($39.15 in chips)
Seat 3: 1mYbhL8CU/QYqfVmFcaHDQ ($6.90 in chips)
Seat 4: 1b+2BbjMN8qhR1WPqdE9VQ ($56.85 in chips)
Seat 5: kxPhs4ePFqMy52CInAJ2aw ($93.10 in chips)
Seat 6: +Pf9jTVizYlIo+woPvptfA ($51.20 in chips)
1b+2BbjMN8qhR1WPqdE9VQ: posts small blind $0.25
kxPhs4ePFqMy52CInAJ2aw: posts big blind $0.50
*** HOLE CARDS ***
+Pf9jTVizYlIo+woPvptfA: folds
My8WkRtGx5FW6rJ1I4R3hg: calls $0.50
bfFjgAtIoAI+pUxUwFt3aQ: calls $0.50
1mYbhL8CU/QYqfVmFcaHDQ: raises $1 to $1.50
1b+2BbjMN8qhR1WPqdE9VQ: folds
kxPhs4ePFqMy52CInAJ2aw: folds
My8WkRtGx5FW6rJ1I4R3hg: calls $1
bfFjgAtIoAI+pUxUwFt3aQ: calls $1
*** FLOP *** [9h 9c Ac]
My8WkRtGx5FW6rJ1I4R3hg: bets $0.50
bfFjgAtIoAI+pUxUwFt3aQ: raises $2 to $2.50
1mYbhL8CU/QYqfVmFcaHDQ: folds
My8WkRtGx5FW6rJ1I4R3hg: folds
bfFjgAtIoAI+pUxUwFt3aQ collected $5.95 from pot
*** SUMMARY ***
Total pot $6.25 | Rake $0.30
Board [9h 9c Ac]
Seat 1: My8WkRtGx5FW6rJ1I4R3hg folded on the Flop
Seat 2: bfFjgAtIoAI+pUxUwFt3aQ collected ($5.95)
Seat 3: 1mYbhL8CU/QYqfVmFcaHDQ (button) folded on the Flop
Seat 4: 1b+2BbjMN8qhR1WPqdE9VQ (small blind) folded before Flop
Seat 5: kxPhs4ePFqMy52CInAJ2aw (big blind) folded before Flop
Seat 6: +Pf9jTVizYlIo+woPvptfA folded before Flop (didn't bet)



PokerStars Game #59940815286:  Hold'em No Limit ($0.25/$0.50) - 2009/07/01 1:17:23 ET
Table 'hSTs/dUsYLgJQuF2Onp0MQ' 6-max Seat #1 is the button
Seat 1: 1WUCqNG+p+vfWRTXNu4ljw ($50 in chips)
Seat 3: C3qJBo7uxfFVDluE1lmK2w ($31.35 in chips)
Seat 4: 2igtJLmvIZ+HqX4XPgMPZA ($50 in chips)
Seat 5: IBNygaT1aa9Z1uPdJJilwA ($35.40 in chips)
Seat 6: M1KyQQvVPVuxqTAB8sR/zQ ($88.20 in chips)
C3qJBo7uxfFVDluE1lmK2w: posts small blind $0.25
2igtJLmvIZ+HqX4XPgMPZA: posts big blind $0.50
*** HOLE CARDS ***
IBNygaT1aa9Z1uPdJJilwA: raises $1 to $1.50
M1KyQQvVPVuxqTAB8sR/zQ: folds
1WUCqNG+p+vfWRTXNu4ljw: folds
C3qJBo7uxfFVDluE1lmK2w: calls $1.25
2igtJLmvIZ+HqX4XPgMPZA: folds
*** FLOP *** [3h 2d 5c]
C3qJBo7uxfFVDluE1lmK2w: checks
IBNygaT1aa9Z1uPdJJilwA: bets $1
C3qJBo7uxfFVDluE1lmK2w: folds
IBNygaT1aa9Z1uPdJJilwA collected $3.35 from pot
*** SUMMARY ***
Total pot $3.50 | Rake $0.15
Board [3h 2d 5c]
Seat 1: 1WUCqNG+p+vfWRTXNu4ljw (button) folded before Flop (didn't bet)
Seat 3: C3qJBo7uxfFVDluE1lmK2w (small blind) folded on the Flop
Seat 4: 2igtJLmvIZ+HqX4XPgMPZA (big blind) folded before Flop
Seat 5: IBNygaT1aa9Z1uPdJJilwA collected ($3.35)
Seat 6: M1KyQQvVPVuxqTAB8sR/zQ folded before Flop (didn't bet)



PokerStars Game #59940815070:  Hold'em No Limit ($0.25/$0.50) - 2009/07/01 1:17:23 ET
Table 'otvGDROEDdqsabxskT79qg' 9-max Seat #6 is the button
Seat 1: 8ehL7qlZzjgUh2H35iiWLw ($59.75 in chips)
Seat 2: cCjTzH9jio8607WzjcfXlg ($14.40 in chips)
Seat 3: +k7T5ocke8UwavtgUHm+Cg ($75 in chips)
Seat 4: MG90wfSJZnOejs/KD3vlQQ ($81.05 in chips)
Seat 5: E2518gp4aFz1+kAgmGqeEg ($12.20 in chips)
Seat 6: bxLSulbgr8LmKNjOzw8URg ($55.25 in chips)
Seat 7: 75K2MXwN65Sjfp1yHd50Hg ($9.50 in chips)
Seat 8: zE9cVigS2nW/Ljy4K4bUQA ($30 in chips)
Seat 9: KcY3X8YpD74Kw1RHkx/g4A ($35.40 in chips)
75K2MXwN65Sjfp1yHd50Hg: posts small blind $0.25
zE9cVigS2nW/Ljy4K4bUQA: posts big blind $0.50
*** HOLE CARDS ***
KcY3X8YpD74Kw1RHkx/g4A: calls $0.50
8ehL7qlZzjgUh2H35iiWLw: folds
cCjTzH9jio8607WzjcfXlg: folds
+k7T5ocke8UwavtgUHm+Cg: calls $0.50
MG90wfSJZnOejs/KD3vlQQ: calls $0.50
E2518gp4aFz1+kAgmGqeEg: folds
bxLSulbgr8LmKNjOzw8URg: folds
75K2MXwN65Sjfp1yHd50Hg: raises $9 to $9.50 and is all-in
zE9cVigS2nW/Ljy4K4bUQA: folds
KcY3X8YpD74Kw1RHkx/g4A: folds
+k7T5ocke8UwavtgUHm+Cg: folds
MG90wfSJZnOejs/KD3vlQQ: folds
75K2MXwN65Sjfp1yHd50Hg collected $2.50 from pot
75K2MXwN65Sjfp1yHd50Hg: doesn't show hand
*** SUMMARY ***
Total pot $2.50 | Rake $0
Seat 1: 8ehL7qlZzjgUh2H35iiWLw folded before Flop (didn't bet)
Seat 2: cCjTzH9jio8607WzjcfXlg folded before Flop (didn't bet)
Seat 3: +k7T5ocke8UwavtgUHm+Cg folded before Flop
Seat 4: MG90wfSJZnOejs/KD3vlQQ folded before Flop
Seat 5: E2518gp4aFz1+kAgmGqeEg folded before Flop (didn't bet)
Seat 6: bxLSulbgr8LmKNjOzw8URg (button) folded before Flop (didn't bet)
Seat 7: 75K2MXwN65Sjfp1yHd50Hg (small blind) collected ($2.50)
Seat 8: zE9cVigS2nW/Ljy4K4bUQA (big blind) folded before Flop
Seat 9: KcY3X8YpD74Kw1RHkx/g4A folded before Flop



PokerStars Game #59940817424:  Hold'em No Limit ($0.25/$0.50) - 2009/07/01 1:17:27 ET
Table 'tyR5AZNKV8Aadbrnrnlg7g' 6-max Seat #1 is the button
Seat 1: BgOXYI0yYSN1ULC4FqsNkg ($94.05 in chips)
Seat 2: BAjwVL+zKKd0s0fAWstzQQ ($67.80 in chips)
Seat 3: JFLrYNyQmwPhRQAtoSAuyA ($49.45 in chips)
Seat 4: 4QfsCWthT/vSLirorNXqtg ($76.15 in chips)
Seat 5: GUnvMULl2qFOO1yenu1UBw ($50 in chips)
Seat 6: 498aWaGsW4uGfuWl+2FCGw ($47 in chips)
BAjwVL+zKKd0s0fAWstzQQ: posts small blind $0.25
JFLrYNyQmwPhRQAtoSAuyA: posts big blind $0.50
*** HOLE CARDS ***
4QfsCWthT/vSLirorNXqtg: folds
GUnvMULl2qFOO1yenu1UBw: folds
498aWaGsW4uGfuWl+2FCGw: calls $0.50
BgOXYI0yYSN1ULC4FqsNkg: calls $0.50
BAjwVL+zKKd0s0fAWstzQQ: calls $0.25
JFLrYNyQmwPhRQAtoSAuyA: raises $2.50 to $3
498aWaGsW4uGfuWl+2FCGw: folds
BgOXYI0yYSN1ULC4FqsNkg: calls $2.50
BAjwVL+zKKd0s0fAWstzQQ: folds
*** FLOP *** [8c 4c 7d]
JFLrYNyQmwPhRQAtoSAuyA: bets $6
BgOXYI0yYSN1ULC4FqsNkg: folds
JFLrYNyQmwPhRQAtoSAuyA collected $6.65 from pot
JFLrYNyQmwPhRQAtoSAuyA: doesn't show hand
*** SUMMARY ***
Total pot $7 | Rake $0.35
Board [8c 4c 7d]
Seat 1: BgOXYI0yYSN1ULC4FqsNkg (button) folded on the Flop
Seat 2: BAjwVL+zKKd0s0fAWstzQQ (small blind) folded before Flop
Seat 3: JFLrYNyQmwPhRQAtoSAuyA (big blind) collected ($6.65)
Seat 4: 4QfsCWthT/vSLirorNXqtg folded before Flop (didn't bet)
Seat 5: GUnvMULl2qFOO1yenu1UBw folded before Flop (didn't bet)
Seat 6: 498aWaGsW4uGfuWl+2FCGw folded before Flop



PokerStars Game #59940818730:  Hold'em No Limit ($0.25/$0.50) - 2009/07/01 1:17:29 ET
Table 'Nz0Vr7WMHL2g5Uk7dDZjpw' 9-max Seat #3 is the button
Seat 2: gsyXT42WLEcOS4DdEk2wlw ($40.20 in chips)
Seat 3: hoglu9inkgs6zN573/bJag ($4.85 in chips)
Seat 4: E2518gp4aFz1+kAgmGqeEg ($13.25 in chips)
Seat 5: WGW0DgjBUXs1ylURHG8vnQ ($18.15 in chips)
Seat 6: 997ViqAtWn1FPjJqcffwcA ($59.05 in chips)
Seat 7: KPLH0gELgFe2OuAnhJFI5w ($24.95 in chips)
Seat 8: aoL+R/61Kxmw69ypuPrWAQ ($22 in chips)
E2518gp4aFz1+kAgmGqeEg: posts small blind $0.25
WGW0DgjBUXs1ylURHG8vnQ: posts big blind $0.50
*** HOLE CARDS ***
997ViqAtWn1FPjJqcffwcA: folds
KPLH0gELgFe2OuAnhJFI5w: folds
aoL+R/61Kxmw69ypuPrWAQ: raises $0.50 to $1
gsyXT42WLEcOS4DdEk2wlw: calls $1
hoglu9inkgs6zN573/bJag: folds
E2518gp4aFz1+kAgmGqeEg: folds
WGW0DgjBUXs1ylURHG8vnQ: calls $0.50
*** FLOP *** [Qd Th 2d]
WGW0DgjBUXs1ylURHG8vnQ: checks
aoL+R/61Kxmw69ypuPrWAQ: bets $1
gsyXT42WLEcOS4DdEk2wlw: calls $1
WGW0DgjBUXs1ylURHG8vnQ: calls $1
*** TURN *** [Qd Th 2d] [9d]
WGW0DgjBUXs1ylURHG8vnQ: bets $0.50
aoL+R/61Kxmw69ypuPrWAQ: calls $0.50
gsyXT42WLEcOS4DdEk2wlw: folds
*** RIVER *** [Qd Th 2d 9d] [Ks]
WGW0DgjBUXs1ylURHG8vnQ: bets $0.50
aoL+R/61Kxmw69ypuPrWAQ: raises $1.50 to $2
WGW0DgjBUXs1ylURHG8vnQ: calls $1.50
*** SHOW DOWN ***
aoL+R/61Kxmw69ypuPrWAQ: shows [Kc Tc] (two pair, Kings and Tens)
WGW0DgjBUXs1ylURHG8vnQ: mucks hand
aoL+R/61Kxmw69ypuPrWAQ collected $10.75 from pot
*** SUMMARY ***
Total pot $11.25 | Rake $0.50
Board [Qd Th 2d 9d Ks]
Seat 2: gsyXT42WLEcOS4DdEk2wlw folded on the Turn
Seat 3: hoglu9inkgs6zN573/bJag (button) folded before Flop (didn't bet)
Seat 4: E2518gp4aFz1+kAgmGqeEg (small blind) folded before Flop
Seat 5: WGW0DgjBUXs1ylURHG8vnQ (big blind) mucked
Seat 6: 997ViqAtWn1FPjJqcffwcA folded before Flop (didn't bet)
Seat 7: KPLH0gELgFe2OuAnhJFI5w folded before Flop (didn't bet)
Seat 8: aoL+R/61Kxmw69ypuPrWAQ showed [Kc Tc] and won ($10.75) with two pair, Kings and Tens



PokerStars Game #59940820260:  Hold'em No Limit ($0.25/$0.50) - 2009/07/01 1:17:32 ET
Table '9Puy2HWN1RQe5SSjq162gA' 2-max Seat #1 is the button
Seat 1: Fp/oksNpipCrD2MJ2pH20g ($24.70 in chips)
Seat 2: bUQEKmQTneRNtujMucgwag ($44.10 in chips)
Fp/oksNpipCrD2MJ2pH20g: posts small blind $0.25
bUQEKmQTneRNtujMucgwag: posts big blind $0.50
*** HOLE CARDS ***
Fp/oksNpipCrD2MJ2pH20g: raises $1.50 to $2
bUQEKmQTneRNtujMucgwag: folds
Fp/oksNpipCrD2MJ2pH20g collected $1 from pot
Fp/oksNpipCrD2MJ2pH20g: doesn't show hand
*** SUMMARY ***
Total pot $1 | Rake $0
Seat 1: Fp/oksNpipCrD2MJ2pH20g (button) (small blind) collected ($1)
Seat 2: bUQEKmQTneRNtujMucgwag (big blind) folded before Flop



PokerStars Game #59940820072:  Hold'em No Limit ($0.25/$0.50) - 2009/07/01 1:17:32 ET
Table 'QOgaEqMcJ73pcUMMxoisUg' 6-max Seat #6 is the button
Seat 1: lxIzoHy0RnkfFSODHC2liw ($50 in chips)
Seat 2: oqOqoO2AyCZenUghCxMDxw ($60 in chips)
Seat 3: Rt6KgtZ8YaJoTc3FPim00w ($53.75 in chips)
Seat 4: zAcsDhG/T128Vn7XGVSgKg ($61 in chips)
Seat 6: AdS8BJMOheS01zjCDfPMFg ($105.95 in chips)
lxIzoHy0RnkfFSODHC2liw: posts small blind $0.25
oqOqoO2AyCZenUghCxMDxw: posts big blind $0.50
*** HOLE CARDS ***
Rt6KgtZ8YaJoTc3FPim00w: folds
zAcsDhG/T128Vn7XGVSgKg: folds
AdS8BJMOheS01zjCDfPMFg: raises $1 to $1.50
lxIzoHy0RnkfFSODHC2liw: folds
oqOqoO2AyCZenUghCxMDxw: calls $1
*** FLOP *** [8s 2s 7s]
oqOqoO2AyCZenUghCxMDxw: checks
AdS8BJMOheS01zjCDfPMFg: bets $2.50
oqOqoO2AyCZenUghCxMDxw: calls $2.50
*** TURN *** [8s 2s 7s] [Qs]
oqOqoO2AyCZenUghCxMDxw: checks
AdS8BJMOheS01zjCDfPMFg: bets $5
oqOqoO2AyCZenUghCxMDxw: raises $7.50 to $12.50
AdS8BJMOheS01zjCDfPMFg: folds
oqOqoO2AyCZenUghCxMDxw collected $17.40 from pot
*** SUMMARY ***
Total pot $18.25 | Rake $0.85
Board [8s 2s 7s Qs]
Seat 1: lxIzoHy0RnkfFSODHC2liw (small blind) folded before Flop
Seat 2: oqOqoO2AyCZenUghCxMDxw (big blind) collected ($17.40)
Seat 3: Rt6KgtZ8YaJoTc3FPim00w folded before Flop (didn't bet)
Seat 4: zAcsDhG/T128Vn7XGVSgKg folded before Flop (didn't bet)
Seat 6: AdS8BJMOheS01zjCDfPMFg (button) folded on the Turn



PokerStars Game #59940820848:  Hold'em No Limit ($0.25/$0.50) - 2009/07/01 1:17:33 ET
Table 'c/CRn+68J3Y8KxD5g1ek2Q' 2-max Seat #2 is the button
Seat 1: 46qCyJ6evTkHo9al5sBMNA ($111.70 in chips)
Seat 2: BypVLsYQt3ePFm2xQL/dOA ($250.95 in chips)
BypVLsYQt3ePFm2xQL/dOA: posts small blind $0.25
46qCyJ6evTkHo9al5sBMNA: posts big blind $0.50
*** HOLE CARDS ***
BypVLsYQt3ePFm2xQL/dOA: calls $0.25
46qCyJ6evTkHo9al5sBMNA: checks
*** FLOP *** [2h 6s 7s]
46qCyJ6evTkHo9al5sBMNA: checks
BypVLsYQt3ePFm2xQL/dOA: checks
*** TURN *** [2h 6s 7s] [Jc]
46qCyJ6evTkHo9al5sBMNA: checks
BypVLsYQt3ePFm2xQL/dOA: checks
*** RIVER *** [2h 6s 7s Jc] [Ts]
46qCyJ6evTkHo9al5sBMNA: checks
BypVLsYQt3ePFm2xQL/dOA: checks
*** SHOW DOWN ***
46qCyJ6evTkHo9al5sBMNA: shows [4d 2c] (a pair of Deuces)
BypVLsYQt3ePFm2xQL/dOA: mucks hand
46qCyJ6evTkHo9al5sBMNA collected $0.95 from pot
*** SUMMARY ***
Total pot $1 | Rake $0.05
Board [2h 6s 7s Jc Ts]
Seat 1: 46qCyJ6evTkHo9al5sBMNA (big blind) showed [4d 2c] and won ($0.95) with a pair of Deuces
Seat 2: BypVLsYQt3ePFm2xQL/dOA (button) (small blind) mucked



PokerStars Game #59940821858:  Hold'em No Limit ($0.25/$0.50) - 2009/07/01 1:17:35 ET
Table '+dXkOAQyS8j9PQZusUTMpg' 2-max Seat #1 is the button
Seat 1: Teld4PDKla7C8/Wfu2DSkg ($50.50 in chips)
Seat 2: +zI4bP23YIjMkUHqeN2xfw ($29.45 in chips)
Teld4PDKla7C8/Wfu2DSkg: posts small blind $0.25
+zI4bP23YIjMkUHqeN2xfw: posts big blind $0.50
*** HOLE CARDS ***
Teld4PDKla7C8/Wfu2DSkg: folds
+zI4bP23YIjMkUHqeN2xfw collected $0.50 from pot
*** SUMMARY ***
Total pot $0.50 | Rake $0
Seat 1: Teld4PDKla7C8/Wfu2DSkg (button) (small blind) folded before Flop
Seat 2: +zI4bP23YIjMkUHqeN2xfw (big blind) collected ($0.50)



PokerStars Game #59940821898:  Hold'em No Limit ($0.25/$0.50) - 2009/07/01 1:17:35 ET
Table 'lSisgp6H7Fg1hH5VfjEjYQ' 9-max Seat #7 is the button
Seat 1: 5k9fvXD9suIgCxU4HLQjTw ($50 in chips)
Seat 2: UrcnkQOiLVk8BlKDPJSy7Q ($77.90 in chips)
Seat 4: bwv/rbH/hHhPhY6u9mu04w ($33.85 in chips)
Seat 6: +k7T5ocke8UwavtgUHm+Cg ($64.40 in chips)
Seat 7: IDtNLR9uFCDdjNsJWMHA5Q ($21.05 in chips)
Seat 8: a4JDWmpFQkL10XfAyuF51A ($15.75 in chips)
Seat 9: YzeKFbJVLmJGTgNH3ySQlw ($14.30 in chips)
a4JDWmpFQkL10XfAyuF51A: posts small blind $0.25
YzeKFbJVLmJGTgNH3ySQlw: posts big blind $0.50
*** HOLE CARDS ***
5k9fvXD9suIgCxU4HLQjTw: folds
UrcnkQOiLVk8BlKDPJSy7Q: folds
bwv/rbH/hHhPhY6u9mu04w: folds
+k7T5ocke8UwavtgUHm+Cg: folds
IDtNLR9uFCDdjNsJWMHA5Q: folds
a4JDWmpFQkL10XfAyuF51A: folds
YzeKFbJVLmJGTgNH3ySQlw collected $0.50 from pot
*** SUMMARY ***
Total pot $0.50 | Rake $0
Seat 1: 5k9fvXD9suIgCxU4HLQjTw folded before Flop (didn't bet)
Seat 2: UrcnkQOiLVk8BlKDPJSy7Q folded before Flop (didn't bet)
Seat 4: bwv/rbH/hHhPhY6u9mu04w folded before Flop (didn't bet)
Seat 6: +k7T5ocke8UwavtgUHm+Cg folded before Flop (didn't bet)
Seat 7: IDtNLR9uFCDdjNsJWMHA5Q (button) folded before Flop (didn't bet)
Seat 8: a4JDWmpFQkL10XfAyuF51A (small blind) folded before Flop
Seat 9: YzeKFbJVLmJGTgNH3ySQlw (big blind) collected ($0.50)



PokerStars Game #59940822324:  Hold'em No Limit ($0.25/$0.50) - 2009/07/01 1:17:36 ET
Table 'BCN5su+SsXiy1zRMJi0SJw' 6-max Seat #6 is the button
Seat 1: GxXV09ciXaOxyY2H5aMIIw ($54.85 in chips)
Seat 3: kwgv5lNhiFrfONXCshzxlA ($43.60 in chips)
Seat 4: 4QfsCWthT/vSLirorNXqtg ($52.25 in chips)
Seat 5: cEMJmfAUQZmMChZe6aacKw ($46.10 in chips)
Seat 6: b2symlOdL7+0c9Pj4N/KlA ($58.15 in chips)
GxXV09ciXaOxyY2H5aMIIw: posts small blind $0.25
kwgv5lNhiFrfONXCshzxlA: posts big blind $0.50
*** HOLE CARDS ***
4QfsCWthT/vSLirorNXqtg: folds
oU2kDCkT/gilYbHWrg7D8w said, "lol"
cEMJmfAUQZmMChZe6aacKw: folds
b2symlOdL7+0c9Pj4N/KlA: raises $1 to $1.50
GxXV09ciXaOxyY2H5aMIIw: folds
kwgv5lNhiFrfONXCshzxlA: calls $1
*** FLOP *** [Kh 4s Th]
oU2kDCkT/gilYbHWrg7D8w said, "nh"
oU2kDCkT/gilYbHWrg7D8w leaves the table
kwgv5lNhiFrfONXCshzxlA: checks
kwgv5lNhiFrfONXCshzxlA said, "ty"
b2symlOdL7+0c9Pj4N/KlA: bets $2.50
kwgv5lNhiFrfONXCshzxlA: calls $2.50
*** TURN *** [Kh 4s Th] [Kd]
kwgv5lNhiFrfONXCshzxlA: checks
b2symlOdL7+0c9Pj4N/KlA: checks
*** RIVER *** [Kh 4s Th Kd] [Jd]
ehFNAevCQri3trWxV6FJdA joins the table at seat #2
kwgv5lNhiFrfONXCshzxlA: bets $3.50
b2symlOdL7+0c9Pj4N/KlA: folds
kwgv5lNhiFrfONXCshzxlA collected $7.85 from pot
kwgv5lNhiFrfONXCshzxlA: doesn't show hand
*** SUMMARY ***
Total pot $8.25 | Rake $0.40
Board [Kh 4s Th Kd Jd]
Seat 1: GxXV09ciXaOxyY2H5aMIIw (small blind) folded before Flop
Seat 3: kwgv5lNhiFrfONXCshzxlA (big blind) collected ($7.85)
Seat 4: 4QfsCWthT/vSLirorNXqtg folded before Flop (didn't bet)
Seat 5: cEMJmfAUQZmMChZe6aacKw folded before Flop (didn't bet)
Seat 6: b2symlOdL7+0c9Pj4N/KlA (button) folded on the River



PokerStars Game #59940823772:  Hold'em No Limit ($0.25/$0.50) - 2009/07/01 1:17:38 ET
Table 'X6IRCRTh+20gjz8aubWnwA' 9-max Seat #6 is the button
Seat 2: HZkVla4kK2SI42CVrPZ/ig ($5.80 in chips)
Seat 3: SWv01peOe69QQRvhQTqjQw ($5.05 in chips)
Seat 4: M3JFBNQ8Bbw3FBZ/18MuXw ($26.65 in chips)
Seat 5: NnQCepdIR/AOUQn1yhYx6Q ($8.50 in chips)
Seat 6: 75K2MXwN65Sjfp1yHd50Hg ($12.15 in chips)
Seat 7: cFHQjKQOOKTUzoilhrXHLg ($12.25 in chips)
Seat 8: HxeBVq06/3Bh/H986sgdbw ($49.25 in chips)
Seat 9: M+7+BTmX5vZatHVuoRB1nA ($45.55 in chips)
cFHQjKQOOKTUzoilhrXHLg: posts small blind $0.25
HxeBVq06/3Bh/H986sgdbw: posts big blind $0.50
E2518gp4aFz1+kAgmGqeEg: sits out
*** HOLE CARDS ***
M+7+BTmX5vZatHVuoRB1nA: folds
HZkVla4kK2SI42CVrPZ/ig: folds
SWv01peOe69QQRvhQTqjQw: calls $0.50
M3JFBNQ8Bbw3FBZ/18MuXw: folds
NnQCepdIR/AOUQn1yhYx6Q: folds
75K2MXwN65Sjfp1yHd50Hg: folds
cFHQjKQOOKTUzoilhrXHLg: calls $0.25
HxeBVq06/3Bh/H986sgdbw: checks
*** FLOP *** [2c Qc Ad]
cFHQjKQOOKTUzoilhrXHLg: checks
HxeBVq06/3Bh/H986sgdbw: checks
SWv01peOe69QQRvhQTqjQw: checks
*** TURN *** [2c Qc Ad] [9d]
cFHQjKQOOKTUzoilhrXHLg: checks
HxeBVq06/3Bh/H986sgdbw: checks
SWv01peOe69QQRvhQTqjQw: bets $0.50
cFHQjKQOOKTUzoilhrXHLg: folds
HxeBVq06/3Bh/H986sgdbw: folds
SWv01peOe69QQRvhQTqjQw collected $1.45 from pot
SWv01peOe69QQRvhQTqjQw: doesn't show hand
*** SUMMARY ***
Total pot $1.50 | Rake $0.05
Board [2c Qc Ad 9d]
Seat 2: HZkVla4kK2SI42CVrPZ/ig folded before Flop (didn't bet)
Seat 3: SWv01peOe69QQRvhQTqjQw collected ($1.45)
Seat 4: M3JFBNQ8Bbw3FBZ/18MuXw folded before Flop (didn't bet)
Seat 5: NnQCepdIR/AOUQn1yhYx6Q folded before Flop (didn't bet)
Seat 6: 75K2MXwN65Sjfp1yHd50Hg (button) folded before Flop (didn't bet)
Seat 7: cFHQjKQOOKTUzoilhrXHLg (small blind) folded on the Turn
Seat 8: HxeBVq06/3Bh/H986sgdbw (big blind) folded on the Turn
Seat 9: M+7+BTmX5vZatHVuoRB1nA folded before Flop (didn't bet)



PokerStars Game #59940825276:  Hold'em No Limit ($0.25/$0.50) - 2009/07/01 1:17:41 ET
Table '+dXkOAQyS8j9PQZusUTMpg' 2-max Seat #2 is the button
Seat 1: Teld4PDKla7C8/Wfu2DSkg ($50.25 in chips)
Seat 2: +zI4bP23YIjMkUHqeN2xfw ($29.70 in chips)
+zI4bP23YIjMkUHqeN2xfw: posts small blind $0.25
Teld4PDKla7C8/Wfu2DSkg: posts big blind $0.50
*** HOLE CARDS ***
+zI4bP23YIjMkUHqeN2xfw: raises $1 to $1.50
Teld4PDKla7C8/Wfu2DSkg: folds
+zI4bP23YIjMkUHqeN2xfw collected $1 from pot
*** SUMMARY ***
Total pot $1 | Rake $0
Seat 1: Teld4PDKla7C8/Wfu2DSkg (big blind) folded before Flop
Seat 2: +zI4bP23YIjMkUHqeN2xfw (button) (small blind) collected ($1)



PokerStars Game #59940825870:  Hold'em No Limit ($0.25/$0.50) - 2009/07/01 1:17:42 ET
Table '9Puy2HWN1RQe5SSjq162gA' 2-max Seat #2 is the button
Seat 1: Fp/oksNpipCrD2MJ2pH20g ($25.20 in chips)
Seat 2: bUQEKmQTneRNtujMucgwag ($43.60 in chips)
bUQEKmQTneRNtujMucgwag: posts small blind $0.25
Fp/oksNpipCrD2MJ2pH20g: posts big blind $0.50
*** HOLE CARDS ***
bUQEKmQTneRNtujMucgwag: folds
Fp/oksNpipCrD2MJ2pH20g collected $0.50 from pot
Fp/oksNpipCrD2MJ2pH20g: doesn't show hand
*** SUMMARY ***
Total pot $0.50 | Rake $0
Seat 1: Fp/oksNpipCrD2MJ2pH20g (big blind) collected ($0.50)
Seat 2: bUQEKmQTneRNtujMucgwag (button) (small blind) folded before Flop



PokerStars Game #59940825938:  Hold'em No Limit ($0.25/$0.50) - 2009/07/01 1:17:42 ET
Table 'PALRfuH85dr5IkDfdv6new' 9-max Seat #4 is the button
Seat 1: v/4aX0ejnaIFK4ftDk2Lyg ($48.75 in chips)
Seat 2: 1aXjSbrubyQKHeauooF5Wg ($48.15 in chips)
Seat 3: 50QWoELmpmHFrFIlWMJo9g ($91.60 in chips)
Seat 4: mZNMJI1mY40XTC0U7GZakA ($56.80 in chips)
Seat 6: ottZQkg1UDWk85BtBzGJzg ($50.10 in chips)
Seat 7: 3NcyXvr39gnK+KbTq7ezyA ($54.75 in chips)
Seat 8: NkS+CseUKx4XHszWq0PXEQ ($76.95 in chips)
Seat 9: viwBDtJsY6JfsFOdBAyJIQ ($9.75 in chips)
ottZQkg1UDWk85BtBzGJzg: posts small blind $0.25
3NcyXvr39gnK+KbTq7ezyA: posts big blind $0.50
*** HOLE CARDS ***
NkS+CseUKx4XHszWq0PXEQ: folds
viwBDtJsY6JfsFOdBAyJIQ: folds
v/4aX0ejnaIFK4ftDk2Lyg: folds
1aXjSbrubyQKHeauooF5Wg: folds
50QWoELmpmHFrFIlWMJo9g: folds
mZNMJI1mY40XTC0U7GZakA: folds
ottZQkg1UDWk85BtBzGJzg: folds
3NcyXvr39gnK+KbTq7ezyA collected $0.50 from pot
*** SUMMARY ***
Total pot $0.50 | Rake $0
Seat 1: v/4aX0ejnaIFK4ftDk2Lyg folded before Flop (didn't bet)
Seat 2: 1aXjSbrubyQKHeauooF5Wg folded before Flop (didn't bet)
Seat 3: 50QWoELmpmHFrFIlWMJo9g folded before Flop (didn't bet)
Seat 4: mZNMJI1mY40XTC0U7GZakA (button) folded before Flop (didn't bet)
Seat 6: ottZQkg1UDWk85BtBzGJzg (small blind) folded before Flop
Seat 7: 3NcyXvr39gnK+KbTq7ezyA (big blind) collected ($0.50)
Seat 8: NkS+CseUKx4XHszWq0PXEQ folded before Flop (didn't bet)
Seat 9: viwBDtJsY6JfsFOdBAyJIQ folded before Flop (didn't bet)



PokerStars Game #59940826630:  Hold'em No Limit ($0.25/$0.50) - 2009/07/01 1:17:43 ET
Table 'GfL/No5u5PoEnU39lP5pQg' 6-max Seat #6 is the button
Seat 1: 1WUCqNG+p+vfWRTXNu4ljw ($63.25 in chips)
Seat 2: uVwggSetzp7d+eVgowO3vg ($55.60 in chips)
Seat 3: 4pp9WxhGdbVbxCc9tlu0lw ($31.70 in chips)
Seat 4: r6u7MWSXF30/khcTYkrG9Q ($22.25 in chips)
Seat 5: M1KyQQvVPVuxqTAB8sR/zQ ($50 in chips)
Seat 6: kxPhs4ePFqMy52CInAJ2aw ($62.45 in chips)
1WUCqNG+p+vfWRTXNu4ljw: posts small blind $0.25
uVwggSetzp7d+eVgowO3vg: posts big blind $0.50
*** HOLE CARDS ***
4pp9WxhGdbVbxCc9tlu0lw: folds
r6u7MWSXF30/khcTYkrG9Q: folds
M1KyQQvVPVuxqTAB8sR/zQ: folds
kxPhs4ePFqMy52CInAJ2aw: raises $1.50 to $2
1WUCqNG+p+vfWRTXNu4ljw: folds
uVwggSetzp7d+eVgowO3vg: folds
kxPhs4ePFqMy52CInAJ2aw collected $1.25 from pot
kxPhs4ePFqMy52CInAJ2aw: doesn't show hand
*** SUMMARY ***
Total pot $1.25 | Rake $0
Seat 1: 1WUCqNG+p+vfWRTXNu4ljw (small blind) folded before Flop
Seat 2: uVwggSetzp7d+eVgowO3vg (big blind) folded before Flop
Seat 3: 4pp9WxhGdbVbxCc9tlu0lw folded before Flop (didn't bet)
Seat 4: r6u7MWSXF30/khcTYkrG9Q folded before Flop (didn't bet)
Seat 5: M1KyQQvVPVuxqTAB8sR/zQ folded before Flop (didn't bet)
Seat 6: kxPhs4ePFqMy52CInAJ2aw (button) collected ($1.25)



PokerStars Game #59940830000:  Hold'em No Limit ($0.25/$0.50) - 2009/07/01 1:17:49 ET
Table '+z1aekfHkpp09pc8F9aViw' 6-max Seat #1 is the button
Seat 1: 7zFtlEn2NxyROFkJdZA/yg ($50 in chips)
Seat 2: OZ6OtYh5Y53MCH/p0QTn5g ($50 in chips)
Seat 3: uUznlIMFnRUvwrBhYF73KA ($157.80 in chips)
Seat 4: RowCSpSURHTOL/dcjg/Iug ($52.60 in chips)
Seat 5: rplyldNweS6YyMNEALQrug ($40.05 in chips)
Seat 6: GUnvMULl2qFOO1yenu1UBw ($50 in chips)
OZ6OtYh5Y53MCH/p0QTn5g: posts small blind $0.25
uUznlIMFnRUvwrBhYF73KA: posts big blind $0.50
*** HOLE CARDS ***
RowCSpSURHTOL/dcjg/Iug: folds
rplyldNweS6YyMNEALQrug: calls $0.50
GUnvMULl2qFOO1yenu1UBw: folds
7zFtlEn2NxyROFkJdZA/yg: folds
OZ6OtYh5Y53MCH/p0QTn5g: folds
uUznlIMFnRUvwrBhYF73KA: checks
*** FLOP *** [5h 6c Ac]
uUznlIMFnRUvwrBhYF73KA: checks
rplyldNweS6YyMNEALQrug: checks
*** TURN *** [5h 6c Ac] [7d]
uUznlIMFnRUvwrBhYF73KA: bets $1
rplyldNweS6YyMNEALQrug: raises $5 to $6
uUznlIMFnRUvwrBhYF73KA: calls $5
*** RIVER *** [5h 6c Ac 7d] [7c]
uUznlIMFnRUvwrBhYF73KA: bets $12
rplyldNweS6YyMNEALQrug: folds
uUznlIMFnRUvwrBhYF73KA collected $12.60 from pot
*** SUMMARY ***
Total pot $13.25 | Rake $0.65
Board [5h 6c Ac 7d 7c]
Seat 1: 7zFtlEn2NxyROFkJdZA/yg (button) folded before Flop (didn't bet)
Seat 2: OZ6OtYh5Y53MCH/p0QTn5g (small blind) folded before Flop
Seat 3: uUznlIMFnRUvwrBhYF73KA (big blind) collected ($12.60)
Seat 4: RowCSpSURHTOL/dcjg/Iug folded before Flop (didn't bet)
Seat 5: rplyldNweS6YyMNEALQrug folded on the River
Seat 6: GUnvMULl2qFOO1yenu1UBw folded before Flop (didn't bet)



PokerStars Game #59940829706:  Hold'em No Limit ($0.25/$0.50) - 2009/07/01 1:17:49 ET
Table '+dXkOAQyS8j9PQZusUTMpg' 2-max Seat #1 is the button
Seat 1: Teld4PDKla7C8/Wfu2DSkg ($49.75 in chips)
Seat 2: +zI4bP23YIjMkUHqeN2xfw ($30.20 in chips)
Teld4PDKla7C8/Wfu2DSkg: posts small blind $0.25
+zI4bP23YIjMkUHqeN2xfw: posts big blind $0.50
*** HOLE CARDS ***
Teld4PDKla7C8/Wfu2DSkg: folds
+zI4bP23YIjMkUHqeN2xfw collected $0.50 from pot
*** SUMMARY ***
Total pot $0.50 | Rake $0
Seat 1: Teld4PDKla7C8/Wfu2DSkg (button) (small blind) folded before Flop
Seat 2: +zI4bP23YIjMkUHqeN2xfw (big blind) collected ($0.50)



PokerStars Game #59940830768:  Hold'em No Limit ($0.25/$0.50) - 2009/07/01 1:17:50 ET
Table 'c/CRn+68J3Y8KxD5g1ek2Q' 2-max Seat #1 is the button
Seat 1: 46qCyJ6evTkHo9al5sBMNA ($112.15 in chips)
Seat 2: BypVLsYQt3ePFm2xQL/dOA ($250.45 in chips)
46qCyJ6evTkHo9al5sBMNA: posts small blind $0.25
BypVLsYQt3ePFm2xQL/dOA: posts big blind $0.50
*** HOLE CARDS ***
46qCyJ6evTkHo9al5sBMNA: folds
BypVLsYQt3ePFm2xQL/dOA collected $0.50 from pot
BypVLsYQt3ePFm2xQL/dOA: doesn't show hand
*** SUMMARY ***
Total pot $0.50 | Rake $0
Seat 1: 46qCyJ6evTkHo9al5sBMNA (button) (small blind) folded before Flop
Seat 2: BypVLsYQt3ePFm2xQL/dOA (big blind) collected ($0.50)



PokerStars Game #59940830836:  Hold'em No Limit ($0.25/$0.50) - 2009/07/01 1:17:51 ET
Table '8BQGgNetI1NOvWeu3gtMNw' 2-max Seat #1 is the button
Seat 1: bypIyrYcAAifLfhZpGlKLA ($80.90 in chips)
Seat 2: Z4HwehErEwzsv/noQlfUlg ($111.90 in chips)
bypIyrYcAAifLfhZpGlKLA: posts small blind $0.25
Z4HwehErEwzsv/noQlfUlg: posts big blind $0.50
*** HOLE CARDS ***
bypIyrYcAAifLfhZpGlKLA: raises $1 to $1.50
Z4HwehErEwzsv/noQlfUlg: raises $2 to $3.50
bypIyrYcAAifLfhZpGlKLA: calls $2
*** FLOP *** [Qc 4d 8d]
Z4HwehErEwzsv/noQlfUlg: checks
bypIyrYcAAifLfhZpGlKLA: bets $5
Z4HwehErEwzsv/noQlfUlg: calls $5
*** TURN *** [Qc 4d 8d] [4c]
Z4HwehErEwzsv/noQlfUlg: checks
bypIyrYcAAifLfhZpGlKLA: checks
*** RIVER *** [Qc 4d 8d 4c] [Tc]
Z4HwehErEwzsv/noQlfUlg: bets $18
bypIyrYcAAifLfhZpGlKLA: folds
Z4HwehErEwzsv/noQlfUlg collected $16.50 from pot
Z4HwehErEwzsv/noQlfUlg: doesn't show hand
*** SUMMARY ***
Total pot $17 | Rake $0.50
Board [Qc 4d 8d 4c Tc]
Seat 1: bypIyrYcAAifLfhZpGlKLA (button) (small blind) folded on the River
Seat 2: Z4HwehErEwzsv/noQlfUlg (big blind) collected ($16.50)



PokerStars Game #59940830912:  Hold'em No Limit ($0.25/$0.50) - 2009/07/01 1:17:51 ET
Table 'hSTs/dUsYLgJQuF2Onp0MQ' 6-max Seat #3 is the button
Seat 1: 1WUCqNG+p+vfWRTXNu4ljw ($50 in chips)
Seat 3: C3qJBo7uxfFVDluE1lmK2w ($29.85 in chips)
Seat 4: 2igtJLmvIZ+HqX4XPgMPZA ($50 in chips)
Seat 5: IBNygaT1aa9Z1uPdJJilwA ($37.25 in chips)
Seat 6: M1KyQQvVPVuxqTAB8sR/zQ ($88.20 in chips)
2igtJLmvIZ+HqX4XPgMPZA: posts small blind $0.25
IBNygaT1aa9Z1uPdJJilwA: posts big blind $0.50
*** HOLE CARDS ***
M1KyQQvVPVuxqTAB8sR/zQ: folds
1WUCqNG+p+vfWRTXNu4ljw: folds
C3qJBo7uxfFVDluE1lmK2w: folds
2igtJLmvIZ+HqX4XPgMPZA: raises $1 to $1.50
IBNygaT1aa9Z1uPdJJilwA: folds
2igtJLmvIZ+HqX4XPgMPZA collected $1 from pot
*** SUMMARY ***
Total pot $1 | Rake $0
Seat 1: 1WUCqNG+p+vfWRTXNu4ljw folded before Flop (didn't bet)
Seat 3: C3qJBo7uxfFVDluE1lmK2w (button) folded before Flop (didn't bet)
Seat 4: 2igtJLmvIZ+HqX4XPgMPZA (small blind) collected ($1)
Seat 5: IBNygaT1aa9Z1uPdJJilwA (big blind) folded before Flop
Seat 6: M1KyQQvVPVuxqTAB8sR/zQ folded before Flop (didn't bet)



PokerStars Game #59940833218:  Hold'em No Limit ($0.25/$0.50) - 2009/07/01 1:17:55 ET
Table '+dXkOAQyS8j9PQZusUTMpg' 2-max Seat #2 is the button
Seat 1: Teld4PDKla7C8/Wfu2DSkg ($49.50 in chips)
Seat 2: +zI4bP23YIjMkUHqeN2xfw ($30.45 in chips)
+zI4bP23YIjMkUHqeN2xfw: posts small blind $0.25
Teld4PDKla7C8/Wfu2DSkg: posts big blind $0.50
*** HOLE CARDS ***
+zI4bP23YIjMkUHqeN2xfw: folds
Teld4PDKla7C8/Wfu2DSkg collected $0.50 from pot
Teld4PDKla7C8/Wfu2DSkg: doesn't show hand
*** SUMMARY ***
Total pot $0.50 | Rake $0
Seat 1: Teld4PDKla7C8/Wfu2DSkg (big blind) collected ($0.50)
Seat 2: +zI4bP23YIjMkUHqeN2xfw (button) (small blind) folded before Flop



PokerStars Game #59940833214:  Hold'em No Limit ($0.25/$0.50) - 2009/07/01 1:17:55 ET
Table 'ibNfFy0bCzuBaUORla0aGw' 9-max Seat #4 is the button
Seat 1: xZCXQSXlrZkp3pZizzVXCw ($50.55 in chips)
Seat 2: 90Wb75h3W1BRpbqVnuk8gw ($50 in chips)
Seat 3: AjV5McH1KMMclY26QdLM5w ($25 in chips)
Seat 4: YBN054X4blmis+B2bBlC0g ($21.90 in chips)
Seat 5: GIJAc9kPrLZHLSX8Q6i99w ($27.55 in chips)
Seat 6: H8cPaCtX7d6meGUVSM5sxw ($56.50 in chips)
Seat 7: HZkVla4kK2SI42CVrPZ/ig ($13.75 in chips)
Seat 9: pFtzb1sR4b0d1aw6aIRgDg ($55.75 in chips)
GIJAc9kPrLZHLSX8Q6i99w: posts small blind $0.25
H8cPaCtX7d6meGUVSM5sxw: posts big blind $0.50
Ja2jdidjip2UeJnRzmzAAQ: sits out
*** HOLE CARDS ***
HZkVla4kK2SI42CVrPZ/ig: folds
pFtzb1sR4b0d1aw6aIRgDg: folds
xZCXQSXlrZkp3pZizzVXCw has timed out
xZCXQSXlrZkp3pZizzVXCw: folds
xZCXQSXlrZkp3pZizzVXCw is sitting out
90Wb75h3W1BRpbqVnuk8gw: folds
AjV5McH1KMMclY26QdLM5w: raises $1 to $1.50
YBN054X4blmis+B2bBlC0g: calls $1.50
GIJAc9kPrLZHLSX8Q6i99w: folds
H8cPaCtX7d6meGUVSM5sxw: folds
*** FLOP *** [6d 4h 6h]
AjV5McH1KMMclY26QdLM5w: checks
YBN054X4blmis+B2bBlC0g: checks
*** TURN *** [6d 4h 6h] [8d]
AjV5McH1KMMclY26QdLM5w: checks
xZCXQSXlrZkp3pZizzVXCw has returned
YBN054X4blmis+B2bBlC0g: checks
*** RIVER *** [6d 4h 6h 8d] [5h]
AjV5McH1KMMclY26QdLM5w: checks
YBN054X4blmis+B2bBlC0g: checks
*** SHOW DOWN ***
AjV5McH1KMMclY26QdLM5w: shows [3d 4d] (two pair, Sixes and Fours)
YBN054X4blmis+B2bBlC0g: mucks hand
AjV5McH1KMMclY26QdLM5w collected $3.60 from pot
*** SUMMARY ***
Total pot $3.75 | Rake $0.15
Board [6d 4h 6h 8d 5h]
Seat 1: xZCXQSXlrZkp3pZizzVXCw folded before Flop (didn't bet)
Seat 2: 90Wb75h3W1BRpbqVnuk8gw folded before Flop (didn't bet)
Seat 3: AjV5McH1KMMclY26QdLM5w showed [3d 4d] and won ($3.60) with two pair, Sixes and Fours
Seat 4: YBN054X4blmis+B2bBlC0g (button) mucked
Seat 5: GIJAc9kPrLZHLSX8Q6i99w (small blind) folded before Flop
Seat 6: H8cPaCtX7d6meGUVSM5sxw (big blind) folded before Flop
Seat 7: HZkVla4kK2SI42CVrPZ/ig folded before Flop (didn't bet)
Seat 9: pFtzb1sR4b0d1aw6aIRgDg folded before Flop (didn't bet)



PokerStars Game #59940833926:  Hold'em No Limit ($0.25/$0.50) - 2009/07/01 1:17:56 ET
Table 'EiNh8p/wGJ1FP575iMFnqg' 9-max Seat #2 is the button
Seat 2: 8ehL7qlZzjgUh2H35iiWLw ($58.90 in chips)
Seat 3: ymLPoEIl7UL3TvZYmnadxQ ($54.55 in chips)
Seat 4: cMzaiXAM/ZAdNaEUu+LqhA ($50 in chips)
Seat 5: M+7+BTmX5vZatHVuoRB1nA ($79.70 in chips)
Seat 6: viwBDtJsY6JfsFOdBAyJIQ ($10.70 in chips)
Seat 7: 997ViqAtWn1FPjJqcffwcA ($50 in chips)
Seat 9: GuPkZObrz5Zkkn8FsEdF9w ($30.70 in chips)
ymLPoEIl7UL3TvZYmnadxQ: posts small blind $0.25
cMzaiXAM/ZAdNaEUu+LqhA: posts big blind $0.50
*** HOLE CARDS ***
M+7+BTmX5vZatHVuoRB1nA: folds
viwBDtJsY6JfsFOdBAyJIQ: folds
997ViqAtWn1FPjJqcffwcA: folds
GuPkZObrz5Zkkn8FsEdF9w: folds
8ehL7qlZzjgUh2H35iiWLw: folds
ymLPoEIl7UL3TvZYmnadxQ: calls $0.25
cMzaiXAM/ZAdNaEUu+LqhA: checks
*** FLOP *** [6c Th Ad]
ymLPoEIl7UL3TvZYmnadxQ: checks
cMzaiXAM/ZAdNaEUu+LqhA: bets $0.50
ymLPoEIl7UL3TvZYmnadxQ: folds
cMzaiXAM/ZAdNaEUu+LqhA collected $0.95 from pot
cMzaiXAM/ZAdNaEUu+LqhA: doesn't show hand
*** SUMMARY ***
Total pot $1 | Rake $0.05
Board [6c Th Ad]
Seat 2: 8ehL7qlZzjgUh2H35iiWLw (button) folded before Flop (didn't bet)
Seat 3: ymLPoEIl7UL3TvZYmnadxQ (small blind) folded on the Flop
Seat 4: cMzaiXAM/ZAdNaEUu+LqhA (big blind) collected ($0.95)
Seat 5: M+7+BTmX5vZatHVuoRB1nA folded before Flop (didn't bet)
Seat 6: viwBDtJsY6JfsFOdBAyJIQ folded before Flop (didn't bet)
Seat 7: 997ViqAtWn1FPjJqcffwcA folded before Flop (didn't bet)
Seat 9: GuPkZObrz5Zkkn8FsEdF9w folded before Flop (didn't bet)



PokerStars Game #59940835736:  Hold'em No Limit ($0.25/$0.50) - 2009/07/01 1:17:59 ET
Table 'lpxYasB1ClBSgTpCCITwhQ' 9-max Seat #3 is the button
Seat 1: mj7PS7wCH4PAl7+eYTFs7A ($44.45 in chips)
Seat 2: OWP/DOu+PlPK6ZZ3zYa0HA ($25.10 in chips)
Seat 3: sakr/FIfFtIZwDPmAj5Pzg ($50.55 in chips)
Seat 4: NnQCepdIR/AOUQn1yhYx6Q ($10 in chips)
Seat 7: gsyXT42WLEcOS4DdEk2wlw ($30 in chips)
Seat 8: /mfensKw8/iZ1Vrx33S4xg ($21.95 in chips)
Seat 9: sUIUZ+begh92dzkUmvbMrw ($24.65 in chips)
NnQCepdIR/AOUQn1yhYx6Q: posts small blind $0.25
SegjDnMxWMujiD57ESNL+g: is sitting out
gsyXT42WLEcOS4DdEk2wlw: posts big blind $0.50
*** HOLE CARDS ***
/mfensKw8/iZ1Vrx33S4xg: raises $1 to $1.50
sUIUZ+begh92dzkUmvbMrw: folds
mj7PS7wCH4PAl7+eYTFs7A: folds
SegjDnMxWMujiD57ESNL+g leaves the table
OWP/DOu+PlPK6ZZ3zYa0HA: folds
sakr/FIfFtIZwDPmAj5Pzg: folds
IYd5zG8k7vdBNVHbHg2Pag has returned
NnQCepdIR/AOUQn1yhYx6Q: folds
gsyXT42WLEcOS4DdEk2wlw: folds
sUIUZ+begh92dzkUmvbMrw leaves the table
/mfensKw8/iZ1Vrx33S4xg collected $1.25 from pot
/mfensKw8/iZ1Vrx33S4xg: doesn't show hand
*** SUMMARY ***
Total pot $1.25 | Rake $0
Seat 1: mj7PS7wCH4PAl7+eYTFs7A folded before Flop (didn't bet)
Seat 2: OWP/DOu+PlPK6ZZ3zYa0HA folded before Flop (didn't bet)
Seat 3: sakr/FIfFtIZwDPmAj5Pzg (button) folded before Flop (didn't bet)
Seat 4: NnQCepdIR/AOUQn1yhYx6Q (small blind) folded before Flop
Seat 7: gsyXT42WLEcOS4DdEk2wlw (big blind) folded before Flop
Seat 8: /mfensKw8/iZ1Vrx33S4xg collected ($1.25)
Seat 9: sUIUZ+begh92dzkUmvbMrw folded before Flop (didn't bet)



PokerStars Game #59940836084:  Hold'em No Limit ($0.25/$0.50) - 2009/07/01 1:18:00 ET
Table 'c/CRn+68J3Y8KxD5g1ek2Q' 2-max Seat #2 is the button
Seat 1: 46qCyJ6evTkHo9al5sBMNA ($111.90 in chips)
Seat 2: BypVLsYQt3ePFm2xQL/dOA ($250.70 in chips)
BypVLsYQt3ePFm2xQL/dOA: posts small blind $0.25
46qCyJ6evTkHo9al5sBMNA: posts big blind $0.50
*** HOLE CARDS ***
BypVLsYQt3ePFm2xQL/dOA: raises $1 to $1.50
46qCyJ6evTkHo9al5sBMNA: folds
BypVLsYQt3ePFm2xQL/dOA collected $1 from pot
BypVLsYQt3ePFm2xQL/dOA: doesn't show hand
*** SUMMARY ***
Total pot $1 | Rake $0
Seat 1: 46qCyJ6evTkHo9al5sBMNA (big blind) folded before Flop
Seat 2: BypVLsYQt3ePFm2xQL/dOA (button) (small blind) collected ($1)



PokerStars Game #59940836568:  Hold'em No Limit ($0.25/$0.50) - 2009/07/01 1:18:01 ET
Table '+dXkOAQyS8j9PQZusUTMpg' 2-max Seat #1 is the button
Seat 1: Teld4PDKla7C8/Wfu2DSkg ($49.75 in chips)
Seat 2: +zI4bP23YIjMkUHqeN2xfw ($30.20 in chips)
Teld4PDKla7C8/Wfu2DSkg: posts small blind $0.25
+zI4bP23YIjMkUHqeN2xfw: posts big blind $0.50
*** HOLE CARDS ***
Teld4PDKla7C8/Wfu2DSkg: raises $0.50 to $1
+zI4bP23YIjMkUHqeN2xfw: calls $0.50
*** FLOP *** [4s 6h 5s]
+zI4bP23YIjMkUHqeN2xfw: checks
Teld4PDKla7C8/Wfu2DSkg: checks
*** TURN *** [4s 6h 5s] [7c]
+zI4bP23YIjMkUHqeN2xfw: bets $1
Teld4PDKla7C8/Wfu2DSkg: calls $1
*** RIVER *** [4s 6h 5s 7c] [2d]
+zI4bP23YIjMkUHqeN2xfw: checks
Teld4PDKla7C8/Wfu2DSkg: bets $6
+zI4bP23YIjMkUHqeN2xfw: folds
Teld4PDKla7C8/Wfu2DSkg collected $3.85 from pot
Teld4PDKla7C8/Wfu2DSkg: doesn't show hand
*** SUMMARY ***
Total pot $4 | Rake $0.15
Board [4s 6h 5s 7c 2d]
Seat 1: Teld4PDKla7C8/Wfu2DSkg (button) (small blind) collected ($3.85)
Seat 2: +zI4bP23YIjMkUHqeN2xfw (big blind) folded on the River



PokerStars Game #59940837202:  Hold'em No Limit ($0.25/$0.50) - 2009/07/01 1:18:02 ET
Table 'tyR5AZNKV8Aadbrnrnlg7g' 6-max Seat #2 is the button
Seat 1: BgOXYI0yYSN1ULC4FqsNkg ($91.05 in chips)
Seat 2: BAjwVL+zKKd0s0fAWstzQQ ($67.30 in chips)
Seat 3: JFLrYNyQmwPhRQAtoSAuyA ($53.10 in chips)
Seat 4: 4QfsCWthT/vSLirorNXqtg ($76.15 in chips)
Seat 5: GUnvMULl2qFOO1yenu1UBw ($50 in chips)
Seat 6: 498aWaGsW4uGfuWl+2FCGw ($46.50 in chips)
JFLrYNyQmwPhRQAtoSAuyA: posts small blind $0.25
4QfsCWthT/vSLirorNXqtg: posts big blind $0.50
*** HOLE CARDS ***
GUnvMULl2qFOO1yenu1UBw: folds
498aWaGsW4uGfuWl+2FCGw: folds
BgOXYI0yYSN1ULC4FqsNkg: calls $0.50
BAjwVL+zKKd0s0fAWstzQQ: folds
JFLrYNyQmwPhRQAtoSAuyA: folds
4QfsCWthT/vSLirorNXqtg: checks
*** FLOP *** [5h 7h 3c]
4QfsCWthT/vSLirorNXqtg: checks
BgOXYI0yYSN1ULC4FqsNkg: checks
*** TURN *** [5h 7h 3c] [Qh]
4QfsCWthT/vSLirorNXqtg: checks
BgOXYI0yYSN1ULC4FqsNkg: bets $0.50
4QfsCWthT/vSLirorNXqtg: folds
BgOXYI0yYSN1ULC4FqsNkg collected $1.20 from pot
*** SUMMARY ***
Total pot $1.25 | Rake $0.05
Board [5h 7h 3c Qh]
Seat 1: BgOXYI0yYSN1ULC4FqsNkg collected ($1.20)
Seat 2: BAjwVL+zKKd0s0fAWstzQQ (button) folded before Flop (didn't bet)
Seat 3: JFLrYNyQmwPhRQAtoSAuyA (small blind) folded before Flop
Seat 4: 4QfsCWthT/vSLirorNXqtg (big blind) folded on the Turn
Seat 5: GUnvMULl2qFOO1yenu1UBw folded before Flop (didn't bet)
Seat 6: 498aWaGsW4uGfuWl+2FCGw folded before Flop (didn't bet)



PokerStars Game #59940837342:  Hold'em No Limit ($0.25/$0.50) - 2009/07/01 1:18:02 ET
Table 'PALRfuH85dr5IkDfdv6new' 9-max Seat #6 is the button
Seat 1: v/4aX0ejnaIFK4ftDk2Lyg ($48.75 in chips)
Seat 2: 1aXjSbrubyQKHeauooF5Wg ($48.15 in chips)
Seat 3: 50QWoELmpmHFrFIlWMJo9g ($91.60 in chips)
Seat 4: mZNMJI1mY40XTC0U7GZakA ($56.80 in chips)
Seat 6: ottZQkg1UDWk85BtBzGJzg ($49.85 in chips)
Seat 7: 3NcyXvr39gnK+KbTq7ezyA ($55 in chips)
Seat 8: NkS+CseUKx4XHszWq0PXEQ ($76.95 in chips)
Seat 9: viwBDtJsY6JfsFOdBAyJIQ ($9.75 in chips)
3NcyXvr39gnK+KbTq7ezyA: posts small blind $0.25
NkS+CseUKx4XHszWq0PXEQ: posts big blind $0.50
*** HOLE CARDS ***
viwBDtJsY6JfsFOdBAyJIQ: folds
v/4aX0ejnaIFK4ftDk2Lyg: folds
qEn9ijNGtuyTxamBf07hYg leaves the table
1aXjSbrubyQKHeauooF5Wg: folds
50QWoELmpmHFrFIlWMJo9g: raises $1 to $1.50
mZNMJI1mY40XTC0U7GZakA: folds
ottZQkg1UDWk85BtBzGJzg: calls $1.50
3NcyXvr39gnK+KbTq7ezyA: calls $1.25
NkS+CseUKx4XHszWq0PXEQ: folds
*** FLOP *** [3h Ks Js]
XcLXSUMHSpshK/7Lh0M4Vg joins the table at seat #5
3NcyXvr39gnK+KbTq7ezyA: checks
50QWoELmpmHFrFIlWMJo9g: checks
ottZQkg1UDWk85BtBzGJzg: bets $2.50
3NcyXvr39gnK+KbTq7ezyA: folds
50QWoELmpmHFrFIlWMJo9g: raises $4.50 to $7
ottZQkg1UDWk85BtBzGJzg: folds
50QWoELmpmHFrFIlWMJo9g collected $9.55 from pot
50QWoELmpmHFrFIlWMJo9g: doesn't show hand
*** SUMMARY ***
Total pot $10 | Rake $0.45
Board [3h Ks Js]
Seat 1: v/4aX0ejnaIFK4ftDk2Lyg folded before Flop (didn't bet)
Seat 2: 1aXjSbrubyQKHeauooF5Wg folded before Flop (didn't bet)
Seat 3: 50QWoELmpmHFrFIlWMJo9g collected ($9.55)
Seat 4: mZNMJI1mY40XTC0U7GZakA folded before Flop (didn't bet)
Seat 6: ottZQkg1UDWk85BtBzGJzg (button) folded on the Flop
Seat 7: 3NcyXvr39gnK+KbTq7ezyA (small blind) folded on the Flop
Seat 8: NkS+CseUKx4XHszWq0PXEQ (big blind) folded before Flop
Seat 9: viwBDtJsY6JfsFOdBAyJIQ folded before Flop (didn't bet)



PokerStars Game #59940838520:  Hold'em No Limit ($0.25/$0.50) - 2009/07/01 1:18:04 ET
Table 'GfL/No5u5PoEnU39lP5pQg' 6-max Seat #1 is the button
Seat 1: 1WUCqNG+p+vfWRTXNu4ljw ($63 in chips)
Seat 2: uVwggSetzp7d+eVgowO3vg ($55.10 in chips)
Seat 3: 4pp9WxhGdbVbxCc9tlu0lw ($31.70 in chips)
Seat 4: r6u7MWSXF30/khcTYkrG9Q ($22.25 in chips)
Seat 5: M1KyQQvVPVuxqTAB8sR/zQ ($50 in chips)
Seat 6: kxPhs4ePFqMy52CInAJ2aw ($63.20 in chips)
uVwggSetzp7d+eVgowO3vg: posts small blind $0.25
4pp9WxhGdbVbxCc9tlu0lw: posts big blind $0.50
*** HOLE CARDS ***
r6u7MWSXF30/khcTYkrG9Q: folds
M1KyQQvVPVuxqTAB8sR/zQ: folds
kxPhs4ePFqMy52CInAJ2aw: folds
1WUCqNG+p+vfWRTXNu4ljw: folds
uVwggSetzp7d+eVgowO3vg: raises $0.50 to $1
4pp9WxhGdbVbxCc9tlu0lw: folds
uVwggSetzp7d+eVgowO3vg collected $1 from pot
*** SUMMARY ***
Total pot $1 | Rake $0
Seat 1: 1WUCqNG+p+vfWRTXNu4ljw (button) folded before Flop (didn't bet)
Seat 2: uVwggSetzp7d+eVgowO3vg (small blind) collected ($1)
Seat 3: 4pp9WxhGdbVbxCc9tlu0lw (big blind) folded before Flop
Seat 4: r6u7MWSXF30/khcTYkrG9Q folded before Flop (didn't bet)
Seat 5: M1KyQQvVPVuxqTAB8sR/zQ folded before Flop (didn't bet)
Seat 6: kxPhs4ePFqMy52CInAJ2aw folded before Flop (didn't bet)



PokerStars Game #59940838478:  Hold'em No Limit ($0.25/$0.50) - 2009/07/01 1:18:04 ET
Table 'lSisgp6H7Fg1hH5VfjEjYQ' 9-max Seat #8 is the button
Seat 1: 5k9fvXD9suIgCxU4HLQjTw ($50 in chips)
Seat 2: UrcnkQOiLVk8BlKDPJSy7Q ($77.90 in chips)
Seat 4: bwv/rbH/hHhPhY6u9mu04w ($33.85 in chips)
Seat 6: +k7T5ocke8UwavtgUHm+Cg ($64.40 in chips)
Seat 7: IDtNLR9uFCDdjNsJWMHA5Q ($21.05 in chips)
Seat 8: a4JDWmpFQkL10XfAyuF51A ($15.50 in chips)
Seat 9: YzeKFbJVLmJGTgNH3ySQlw ($14.55 in chips)
YzeKFbJVLmJGTgNH3ySQlw: posts small blind $0.25
5k9fvXD9suIgCxU4HLQjTw: posts big blind $0.50
*** HOLE CARDS ***
UrcnkQOiLVk8BlKDPJSy7Q: folds
bwv/rbH/hHhPhY6u9mu04w: calls $0.50
+k7T5ocke8UwavtgUHm+Cg: folds
IDtNLR9uFCDdjNsJWMHA5Q: folds
a4JDWmpFQkL10XfAyuF51A: folds
YzeKFbJVLmJGTgNH3ySQlw: calls $0.25
5k9fvXD9suIgCxU4HLQjTw: checks
*** FLOP *** [Qc 9d 6s]
SKnJuWHScqetA/qG5p+wCg joins the table at seat #3
YzeKFbJVLmJGTgNH3ySQlw: checks
5k9fvXD9suIgCxU4HLQjTw: checks
bwv/rbH/hHhPhY6u9mu04w: checks
*** TURN *** [Qc 9d 6s] [Ts]
YzeKFbJVLmJGTgNH3ySQlw: bets $1.50
5k9fvXD9suIgCxU4HLQjTw: folds
bwv/rbH/hHhPhY6u9mu04w: folds
YzeKFbJVLmJGTgNH3ySQlw collected $1.45 from pot
*** SUMMARY ***
Total pot $1.50 | Rake $0.05
Board [Qc 9d 6s Ts]
Seat 1: 5k9fvXD9suIgCxU4HLQjTw (big blind) folded on the Turn
Seat 2: UrcnkQOiLVk8BlKDPJSy7Q folded before Flop (didn't bet)
Seat 4: bwv/rbH/hHhPhY6u9mu04w folded on the Turn
Seat 6: +k7T5ocke8UwavtgUHm+Cg folded before Flop (didn't bet)
Seat 7: IDtNLR9uFCDdjNsJWMHA5Q folded before Flop (didn't bet)
Seat 8: a4JDWmpFQkL10XfAyuF51A (button) folded before Flop (didn't bet)
Seat 9: YzeKFbJVLmJGTgNH3ySQlw (small blind) collected ($1.45)



PokerStars Game #59940839312:  Hold'em No Limit ($0.25/$0.50) - 2009/07/01 1:18:05 ET
Table 'fx6MqwfYAj/Rt86hBz2L3Q' 9-max Seat #6 is the button
Seat 1: v/4aX0ejnaIFK4ftDk2Lyg ($49.50 in chips)
Seat 2: C3rGXblctNcWI6JYPHhaEg ($40.20 in chips)
Seat 3: iadBi5AEt7gTBXbDSSnMYQ ($49.90 in chips)
Seat 5: iAISe3dVeua8PUn2wwgDHw ($65.65 in chips)
Seat 6: 5k9fvXD9suIgCxU4HLQjTw ($50 in chips)
Seat 7: SKnJuWHScqetA/qG5p+wCg ($34.45 in chips)
Seat 8: JYwJYYV9pM5KWdSiETl8rA ($30 in chips)
SKnJuWHScqetA/qG5p+wCg: posts small blind $0.25
JYwJYYV9pM5KWdSiETl8rA: posts big blind $0.50
vO3QVRovWemcGMkm7ijAIA: sits out
*** HOLE CARDS ***
v/4aX0ejnaIFK4ftDk2Lyg: folds
C3rGXblctNcWI6JYPHhaEg: calls $0.50
iadBi5AEt7gTBXbDSSnMYQ: calls $0.50
iAISe3dVeua8PUn2wwgDHw: calls $0.50
5k9fvXD9suIgCxU4HLQjTw: folds
SKnJuWHScqetA/qG5p+wCg: calls $0.25
JYwJYYV9pM5KWdSiETl8rA: checks
*** FLOP *** [4s 7c 5d]
SKnJuWHScqetA/qG5p+wCg: checks
JYwJYYV9pM5KWdSiETl8rA: checks
C3rGXblctNcWI6JYPHhaEg: bets $0.70
iadBi5AEt7gTBXbDSSnMYQ: raises $1.80 to $2.50
iAISe3dVeua8PUn2wwgDHw: folds
SKnJuWHScqetA/qG5p+wCg: folds
JYwJYYV9pM5KWdSiETl8rA: folds
C3rGXblctNcWI6JYPHhaEg: calls $1.80
*** TURN *** [4s 7c 5d] [Td]
C3rGXblctNcWI6JYPHhaEg: checks
iadBi5AEt7gTBXbDSSnMYQ: checks
*** RIVER *** [4s 7c 5d Td] [6c]
C3rGXblctNcWI6JYPHhaEg: bets $1.20
iadBi5AEt7gTBXbDSSnMYQ: raises $3.80 to $5
C3rGXblctNcWI6JYPHhaEg: folds
iadBi5AEt7gTBXbDSSnMYQ collected $9.45 from pot
*** SUMMARY ***
Total pot $9.90 | Rake $0.45
Board [4s 7c 5d Td 6c]
Seat 1: v/4aX0ejnaIFK4ftDk2Lyg folded before Flop (didn't bet)
Seat 2: C3rGXblctNcWI6JYPHhaEg folded on the River
Seat 3: iadBi5AEt7gTBXbDSSnMYQ collected ($9.45)
Seat 5: iAISe3dVeua8PUn2wwgDHw folded on the Flop
Seat 6: 5k9fvXD9suIgCxU4HLQjTw (button) folded before Flop (didn't bet)
Seat 7: SKnJuWHScqetA/qG5p+wCg (small blind) folded on the Flop
Seat 8: JYwJYYV9pM5KWdSiETl8rA (big blind) folded on the Flop



PokerStars Game #59940838962:  Hold'em No Limit ($0.25/$0.50) - 2009/07/01 1:18:05 ET
Table 'MJxeZCzYELxiIsyUZyT0jw' 6-max Seat #4 is the button
Seat 1: +Pf9jTVizYlIo+woPvptfA ($50 in chips)
Seat 2: t3GiVMzqA9Svgr5Uol32cQ ($35.05 in chips)
Seat 3: sIG4mp8tZEI+W4nKZNkkQA ($51.85 in chips)
Seat 4: alGiiQP/wwtYnfuXII+sgw ($59.60 in chips)
Seat 5: 3jvoOXNtXE90w2BdfNZwZQ ($61.45 in chips)
Seat 6: c0n4hrn20AML9qzyFC2E8Q ($45.10 in chips)
3jvoOXNtXE90w2BdfNZwZQ: posts small blind $0.25
c0n4hrn20AML9qzyFC2E8Q: posts big blind $0.50
*** HOLE CARDS ***
+Pf9jTVizYlIo+woPvptfA: folds
t3GiVMzqA9Svgr5Uol32cQ: folds
sIG4mp8tZEI+W4nKZNkkQA: folds
alGiiQP/wwtYnfuXII+sgw: folds
3jvoOXNtXE90w2BdfNZwZQ: raises $1.50 to $2
c0n4hrn20AML9qzyFC2E8Q: calls $1.50
*** FLOP *** [7c Ac 6c]
3jvoOXNtXE90w2BdfNZwZQ: checks
c0n4hrn20AML9qzyFC2E8Q: bets $2
3jvoOXNtXE90w2BdfNZwZQ: folds
c0n4hrn20AML9qzyFC2E8Q collected $3.80 from pot
c0n4hrn20AML9qzyFC2E8Q: doesn't show hand
*** SUMMARY ***
Total pot $4 | Rake $0.20
Board [7c Ac 6c]
Seat 1: +Pf9jTVizYlIo+woPvptfA folded before Flop (didn't bet)
Seat 2: t3GiVMzqA9Svgr5Uol32cQ folded before Flop (didn't bet)
Seat 3: sIG4mp8tZEI+W4nKZNkkQA folded before Flop (didn't bet)
Seat 4: alGiiQP/wwtYnfuXII+sgw (button) folded before Flop (didn't bet)
Seat 5: 3jvoOXNtXE90w2BdfNZwZQ (small blind) folded on the Flop
Seat 6: c0n4hrn20AML9qzyFC2E8Q (big blind) collected ($3.80)



PokerStars Game #59940840666:  Hold'em No Limit ($0.25/$0.50) - 2009/07/01 1:18:08 ET
Table 'c/CRn+68J3Y8KxD5g1ek2Q' 2-max Seat #1 is the button
Seat 1: 46qCyJ6evTkHo9al5sBMNA ($111.40 in chips)
Seat 2: BypVLsYQt3ePFm2xQL/dOA ($251.20 in chips)
46qCyJ6evTkHo9al5sBMNA: posts small blind $0.25
BypVLsYQt3ePFm2xQL/dOA: posts big blind $0.50
*** HOLE CARDS ***
46qCyJ6evTkHo9al5sBMNA: folds
BypVLsYQt3ePFm2xQL/dOA collected $0.50 from pot
BypVLsYQt3ePFm2xQL/dOA: doesn't show hand
*** SUMMARY ***
Total pot $0.50 | Rake $0
Seat 1: 46qCyJ6evTkHo9al5sBMNA (button) (small blind) folded before Flop
Seat 2: BypVLsYQt3ePFm2xQL/dOA (big blind) collected ($0.50)



PokerStars Game #59940843488:  Hold'em No Limit ($0.25/$0.50) - 2009/07/01 1:18:13 ET
Table '5EmHi+fnatGQQShcNmzOZQ' 6-max Seat #4 is the button
Seat 1: My8WkRtGx5FW6rJ1I4R3hg ($40.80 in chips)
Seat 2: bfFjgAtIoAI+pUxUwFt3aQ ($43.10 in chips)
Seat 3: 1mYbhL8CU/QYqfVmFcaHDQ ($5.40 in chips)
Seat 4: 1b+2BbjMN8qhR1WPqdE9VQ ($56.60 in chips)
Seat 5: kxPhs4ePFqMy52CInAJ2aw ($92.60 in chips)
Seat 6: +Pf9jTVizYlIo+woPvptfA ($51.20 in chips)
kxPhs4ePFqMy52CInAJ2aw: posts small blind $0.25
+Pf9jTVizYlIo+woPvptfA: posts big blind $0.50
*** HOLE CARDS ***
My8WkRtGx5FW6rJ1I4R3hg: folds
bfFjgAtIoAI+pUxUwFt3aQ: calls $0.50
My8WkRtGx5FW6rJ1I4R3hg leaves the table
1mYbhL8CU/QYqfVmFcaHDQ: raises $1 to $1.50
1b+2BbjMN8qhR1WPqdE9VQ: calls $1.50
kxPhs4ePFqMy52CInAJ2aw: folds
+Pf9jTVizYlIo+woPvptfA: folds
bfFjgAtIoAI+pUxUwFt3aQ: calls $1
*** FLOP *** [Jh Js 8s]
bfFjgAtIoAI+pUxUwFt3aQ: bets $3.50
1mYbhL8CU/QYqfVmFcaHDQ: raises $0.40 to $3.90 and is all-in
1b+2BbjMN8qhR1WPqdE9VQ: calls $3.90
bfFjgAtIoAI+pUxUwFt3aQ: calls $0.40
*** TURN *** [Jh Js 8s] [2d]
bfFjgAtIoAI+pUxUwFt3aQ: checks
1b+2BbjMN8qhR1WPqdE9VQ: bets $11
bfFjgAtIoAI+pUxUwFt3aQ: folds
*** RIVER *** [Jh Js 8s 2d] [2h]
*** SHOW DOWN ***
1mYbhL8CU/QYqfVmFcaHDQ: shows [As Ac] (two pair, Aces and Jacks)
1b+2BbjMN8qhR1WPqdE9VQ: shows [8d 8c] (a full house, Eights full of Jacks)
1b+2BbjMN8qhR1WPqdE9VQ collected $16.15 from pot
*** SUMMARY ***
Total pot $16.95 | Rake $0.80
Board [Jh Js 8s 2d 2h]
Seat 1: My8WkRtGx5FW6rJ1I4R3hg folded before Flop (didn't bet)
Seat 2: bfFjgAtIoAI+pUxUwFt3aQ folded on the Turn
Seat 3: 1mYbhL8CU/QYqfVmFcaHDQ showed [As Ac] and lost with two pair, Aces and Jacks
Seat 4: 1b+2BbjMN8qhR1WPqdE9VQ (button) showed [8d 8c] and won ($16.15) with a full house, Eights full of Jacks
Seat 5: kxPhs4ePFqMy52CInAJ2aw (small blind) folded before Flop
Seat 6: +Pf9jTVizYlIo+woPvptfA (big blind) folded before Flop



PokerStars Game #59940845108:  Hold'em No Limit ($0.25/$0.50) - 2009/07/01 1:18:16 ET
Table 'c/CRn+68J3Y8KxD5g1ek2Q' 2-max Seat #2 is the button
Seat 1: 46qCyJ6evTkHo9al5sBMNA ($111.15 in chips)
Seat 2: BypVLsYQt3ePFm2xQL/dOA ($251.45 in chips)
BypVLsYQt3ePFm2xQL/dOA: posts small blind $0.25
46qCyJ6evTkHo9al5sBMNA: posts big blind $0.50
*** HOLE CARDS ***
BypVLsYQt3ePFm2xQL/dOA: calls $0.25
46qCyJ6evTkHo9al5sBMNA: checks
*** FLOP *** [2h 3d 4c]
46qCyJ6evTkHo9al5sBMNA: bets $1.50
BypVLsYQt3ePFm2xQL/dOA: calls $1.50
*** TURN *** [2h 3d 4c] [5h]
46qCyJ6evTkHo9al5sBMNA: checks
BypVLsYQt3ePFm2xQL/dOA: bets $3
46qCyJ6evTkHo9al5sBMNA: calls $3
*** RIVER *** [2h 3d 4c 5h] [7c]
46qCyJ6evTkHo9al5sBMNA: checks
BypVLsYQt3ePFm2xQL/dOA: bets $4.50
46qCyJ6evTkHo9al5sBMNA: calls $4.50
*** SHOW DOWN ***
BypVLsYQt3ePFm2xQL/dOA: shows [Tc Ad] (a straight, Ace to Five)
46qCyJ6evTkHo9al5sBMNA: mucks hand
BypVLsYQt3ePFm2xQL/dOA collected $18.50 from pot
*** SUMMARY ***
Total pot $19 | Rake $0.50
Board [2h 3d 4c 5h 7c]
Seat 1: 46qCyJ6evTkHo9al5sBMNA (big blind) mucked
Seat 2: BypVLsYQt3ePFm2xQL/dOA (button) (small blind) showed [Tc Ad] and won ($18.50) with a straight, Ace to Five



PokerStars Game #59940845856:  Hold'em No Limit ($0.25/$0.50) - 2009/07/01 1:18:17 ET
Table 'hSTs/dUsYLgJQuF2Onp0MQ' 6-max Seat #4 is the button
Seat 1: 1WUCqNG+p+vfWRTXNu4ljw ($50 in chips)
Seat 3: C3qJBo7uxfFVDluE1lmK2w ($29.85 in chips)
Seat 4: 2igtJLmvIZ+HqX4XPgMPZA ($50.50 in chips)
Seat 5: IBNygaT1aa9Z1uPdJJilwA ($36.75 in chips)
Seat 6: M1KyQQvVPVuxqTAB8sR/zQ ($88.20 in chips)
IBNygaT1aa9Z1uPdJJilwA: posts small blind $0.25
M1KyQQvVPVuxqTAB8sR/zQ: posts big blind $0.50
*** HOLE CARDS ***
1WUCqNG+p+vfWRTXNu4ljw: folds
C3qJBo7uxfFVDluE1lmK2w: raises $0.50 to $1
2igtJLmvIZ+HqX4XPgMPZA: folds
IBNygaT1aa9Z1uPdJJilwA: folds
M1KyQQvVPVuxqTAB8sR/zQ: folds
C3qJBo7uxfFVDluE1lmK2w collected $1.25 from pot
*** SUMMARY ***
Total pot $1.25 | Rake $0
Seat 1: 1WUCqNG+p+vfWRTXNu4ljw folded before Flop (didn't bet)
Seat 3: C3qJBo7uxfFVDluE1lmK2w collected ($1.25)
Seat 4: 2igtJLmvIZ+HqX4XPgMPZA (button) folded before Flop (didn't bet)
Seat 5: IBNygaT1aa9Z1uPdJJilwA (small blind) folded before Flop
Seat 6: M1KyQQvVPVuxqTAB8sR/zQ (big blind) folded before Flop



PokerStars Game #59940846410:  Hold'em No Limit ($0.25/$0.50) - 2009/07/01 1:18:18 ET
Table 'otvGDROEDdqsabxskT79qg' 9-max Seat #7 is the button
Seat 1: 8ehL7qlZzjgUh2H35iiWLw ($59.75 in chips)
Seat 2: cCjTzH9jio8607WzjcfXlg ($14.40 in chips)
Seat 3: +k7T5ocke8UwavtgUHm+Cg ($74.50 in chips)
Seat 4: MG90wfSJZnOejs/KD3vlQQ ($80.55 in chips)
Seat 5: E2518gp4aFz1+kAgmGqeEg ($12.20 in chips)
Seat 6: bxLSulbgr8LmKNjOzw8URg ($55.25 in chips)
Seat 7: 75K2MXwN65Sjfp1yHd50Hg ($11.50 in chips)
Seat 8: zE9cVigS2nW/Ljy4K4bUQA ($30 in chips)
Seat 9: KcY3X8YpD74Kw1RHkx/g4A ($34.90 in chips)
zE9cVigS2nW/Ljy4K4bUQA: posts small blind $0.25
KcY3X8YpD74Kw1RHkx/g4A: posts big blind $0.50
*** HOLE CARDS ***
8ehL7qlZzjgUh2H35iiWLw: folds
cCjTzH9jio8607WzjcfXlg: folds
+k7T5ocke8UwavtgUHm+Cg: folds
MG90wfSJZnOejs/KD3vlQQ: raises $1 to $1.50
E2518gp4aFz1+kAgmGqeEg: folds
bxLSulbgr8LmKNjOzw8URg: folds
75K2MXwN65Sjfp1yHd50Hg: raises $10 to $11.50 and is all-in
zE9cVigS2nW/Ljy4K4bUQA: folds
KcY3X8YpD74Kw1RHkx/g4A: folds
MG90wfSJZnOejs/KD3vlQQ: folds
75K2MXwN65Sjfp1yHd50Hg collected $3.75 from pot
75K2MXwN65Sjfp1yHd50Hg: doesn't show hand
*** SUMMARY ***
Total pot $3.75 | Rake $0
Seat 1: 8ehL7qlZzjgUh2H35iiWLw folded before Flop (didn't bet)
Seat 2: cCjTzH9jio8607WzjcfXlg folded before Flop (didn't bet)
Seat 3: +k7T5ocke8UwavtgUHm+Cg folded before Flop (didn't bet)
Seat 4: MG90wfSJZnOejs/KD3vlQQ folded before Flop
Seat 5: E2518gp4aFz1+kAgmGqeEg folded before Flop (didn't bet)
Seat 6: bxLSulbgr8LmKNjOzw8URg folded before Flop (didn't bet)
Seat 7: 75K2MXwN65Sjfp1yHd50Hg (button) collected ($3.75)
Seat 8: zE9cVigS2nW/Ljy4K4bUQA (small blind) folded before Flop
Seat 9: KcY3X8YpD74Kw1RHkx/g4A (big blind) folded before Flop



PokerStars Game #59940847184:  Hold'em No Limit ($0.25/$0.50) - 2009/07/01 1:18:19 ET
Table 'kgbJRsxfv64KrErDRBAkcw' 6-max Seat #1 is the button
Seat 1: VamsyhlFzXGF6/ydo0BHeA ($43.80 in chips)
Seat 2: AdS8BJMOheS01zjCDfPMFg ($50.25 in chips)
Seat 3: c4MNIaIyPMOMxrgT8FT5nA ($215.80 in chips)
Seat 5: eUBBn2R56C1IQ6Cs/vitwg ($50 in chips)
Seat 6: 1b+2BbjMN8qhR1WPqdE9VQ ($50.55 in chips)
AdS8BJMOheS01zjCDfPMFg: posts small blind $0.25
c4MNIaIyPMOMxrgT8FT5nA: posts big blind $0.50
2igtJLmvIZ+HqX4XPgMPZA: sits out
*** HOLE CARDS ***
eUBBn2R56C1IQ6Cs/vitwg: folds
1b+2BbjMN8qhR1WPqdE9VQ: folds
VamsyhlFzXGF6/ydo0BHeA: calls $0.50
AdS8BJMOheS01zjCDfPMFg: folds
c4MNIaIyPMOMxrgT8FT5nA: checks
*** FLOP *** [Ks 8s Jd]
c4MNIaIyPMOMxrgT8FT5nA: checks
VamsyhlFzXGF6/ydo0BHeA: checks
*** TURN *** [Ks 8s Jd] [4c]
c4MNIaIyPMOMxrgT8FT5nA: checks
VamsyhlFzXGF6/ydo0BHeA: checks
*** RIVER *** [Ks 8s Jd 4c] [7c]
c4MNIaIyPMOMxrgT8FT5nA: bets $5.50
VamsyhlFzXGF6/ydo0BHeA: folds
c4MNIaIyPMOMxrgT8FT5nA collected $1.20 from pot
c4MNIaIyPMOMxrgT8FT5nA: doesn't show hand
*** SUMMARY ***
Total pot $1.25 | Rake $0.05
Board [Ks 8s Jd 4c 7c]
Seat 1: VamsyhlFzXGF6/ydo0BHeA (button) folded on the River
Seat 2: AdS8BJMOheS01zjCDfPMFg (small blind) folded before Flop
Seat 3: c4MNIaIyPMOMxrgT8FT5nA (big blind) collected ($1.20)
Seat 5: eUBBn2R56C1IQ6Cs/vitwg folded before Flop (didn't bet)
Seat 6: 1b+2BbjMN8qhR1WPqdE9VQ folded before Flop (didn't bet)



PokerStars Game #59940847280:  Hold'em No Limit ($0.25/$0.50) - 2009/07/01 1:18:20 ET
Table '8BQGgNetI1NOvWeu3gtMNw' 2-max Seat #2 is the button
Seat 1: bypIyrYcAAifLfhZpGlKLA ($72.40 in chips)
Seat 2: Z4HwehErEwzsv/noQlfUlg ($119.90 in chips)
Z4HwehErEwzsv/noQlfUlg: posts small blind $0.25
bypIyrYcAAifLfhZpGlKLA: posts big blind $0.50
*** HOLE CARDS ***
Z4HwehErEwzsv/noQlfUlg: raises $0.50 to $1
bypIyrYcAAifLfhZpGlKLA: calls $0.50
*** FLOP *** [5c 8d Qs]
bypIyrYcAAifLfhZpGlKLA: checks
Z4HwehErEwzsv/noQlfUlg: checks
*** TURN *** [5c 8d Qs] [3c]
bypIyrYcAAifLfhZpGlKLA: bets $1.50
Z4HwehErEwzsv/noQlfUlg: calls $1.50
*** RIVER *** [5c 8d Qs 3c] [8s]
bypIyrYcAAifLfhZpGlKLA: checks
Z4HwehErEwzsv/noQlfUlg: bets $3
bypIyrYcAAifLfhZpGlKLA: calls $3
*** SHOW DOWN ***
Z4HwehErEwzsv/noQlfUlg: shows [3h Ks] (two pair, Eights and Threes)
bypIyrYcAAifLfhZpGlKLA: mucks hand
Z4HwehErEwzsv/noQlfUlg collected $10.50 from pot
*** SUMMARY ***
Total pot $11 | Rake $0.50
Board [5c 8d Qs 3c 8s]
Seat 1: bypIyrYcAAifLfhZpGlKLA (big blind) mucked
Seat 2: Z4HwehErEwzsv/noQlfUlg (button) (small blind) showed [3h Ks] and won ($10.50) with two pair, Eights and Threes



PokerStars Game #59940848432:  Hold'em No Limit ($0.25/$0.50) - 2009/07/01 1:18:22 ET
Table 'ofnd8S4IdIPph1Cbn+x7hA' 2-max Seat #2 is the button
Seat 1: PY4NvRocCFPfSIHKbh0euQ ($26.60 in chips)
Seat 2: l5WbyJ/iWYjpeCC6GCYY6w ($68.50 in chips)
l5WbyJ/iWYjpeCC6GCYY6w: posts small blind $0.25
PY4NvRocCFPfSIHKbh0euQ: posts big blind $0.50
*** HOLE CARDS ***
l5WbyJ/iWYjpeCC6GCYY6w: calls $0.25
PY4NvRocCFPfSIHKbh0euQ: raises $1.50 to $2
l5WbyJ/iWYjpeCC6GCYY6w: folds
PY4NvRocCFPfSIHKbh0euQ collected $1 from pot
*** SUMMARY ***
Total pot $1 | Rake $0
Seat 1: PY4NvRocCFPfSIHKbh0euQ (big blind) collected ($1)
Seat 2: l5WbyJ/iWYjpeCC6GCYY6w (button) (small blind) folded before Flop



PokerStars Game #59940850424:  Hold'em No Limit ($0.25/$0.50) - 2009/07/01 1:18:25 ET
Table 'QOgaEqMcJ73pcUMMxoisUg' 6-max Seat #1 is the button
Seat 1: lxIzoHy0RnkfFSODHC2liw ($50 in chips)
Seat 2: oqOqoO2AyCZenUghCxMDxw ($68.40 in chips)
Seat 3: Rt6KgtZ8YaJoTc3FPim00w ($53.75 in chips)
Seat 4: zAcsDhG/T128Vn7XGVSgKg ($61 in chips)
Seat 6: AdS8BJMOheS01zjCDfPMFg ($96.95 in chips)
oqOqoO2AyCZenUghCxMDxw: posts small blind $0.25
Rt6KgtZ8YaJoTc3FPim00w: posts big blind $0.50
*** HOLE CARDS ***
zAcsDhG/T128Vn7XGVSgKg: folds
AdS8BJMOheS01zjCDfPMFg: folds
lxIzoHy0RnkfFSODHC2liw: folds
oqOqoO2AyCZenUghCxMDxw: calls $0.25
Rt6KgtZ8YaJoTc3FPim00w: raises $1.50 to $2
oqOqoO2AyCZenUghCxMDxw: calls $1.50
*** FLOP *** [6h 2s 5h]
oqOqoO2AyCZenUghCxMDxw: checks
Rt6KgtZ8YaJoTc3FPim00w: bets $2.50
oqOqoO2AyCZenUghCxMDxw: calls $2.50
*** TURN *** [6h 2s 5h] [7d]
oqOqoO2AyCZenUghCxMDxw: checks
Rt6KgtZ8YaJoTc3FPim00w: checks
*** RIVER *** [6h 2s 5h 7d] [4d]
oqOqoO2AyCZenUghCxMDxw: checks
Rt6KgtZ8YaJoTc3FPim00w: checks
*** SHOW DOWN ***
oqOqoO2AyCZenUghCxMDxw: shows [Jd Ah] (high card Ace)
Rt6KgtZ8YaJoTc3FPim00w: shows [Ad Qh] (high card Ace - Queen kicker)
Rt6KgtZ8YaJoTc3FPim00w collected $8.60 from pot
*** SUMMARY ***
Total pot $9 | Rake $0.40
Board [6h 2s 5h 7d 4d]
Seat 1: lxIzoHy0RnkfFSODHC2liw (button) folded before Flop (didn't bet)
Seat 2: oqOqoO2AyCZenUghCxMDxw (small blind) showed [Jd Ah] and lost with high card Ace
Seat 3: Rt6KgtZ8YaJoTc3FPim00w (big blind) showed [Ad Qh] and won ($8.60) with high card Ace
Seat 4: zAcsDhG/T128Vn7XGVSgKg folded before Flop (didn't bet)
Seat 6: AdS8BJMOheS01zjCDfPMFg folded before Flop (didn't bet)



PokerStars Game #59940850928:  Hold'em No Limit ($0.25/$0.50) - 2009/07/01 1:18:26 ET
Table 'BCN5su+SsXiy1zRMJi0SJw' 6-max Seat #1 is the button
Seat 1: GxXV09ciXaOxyY2H5aMIIw ($54.60 in chips)
Seat 3: kwgv5lNhiFrfONXCshzxlA ($47.45 in chips)
Seat 5: cEMJmfAUQZmMChZe6aacKw ($46.10 in chips)
Seat 6: b2symlOdL7+0c9Pj4N/KlA ($54.15 in chips)
ehFNAevCQri3trWxV6FJdA will be allowed to play after the button
kwgv5lNhiFrfONXCshzxlA: posts small blind $0.25
4QfsCWthT/vSLirorNXqtg: is sitting out
cEMJmfAUQZmMChZe6aacKw: posts big blind $0.50
*** HOLE CARDS ***
b2symlOdL7+0c9Pj4N/KlA: folds
GxXV09ciXaOxyY2H5aMIIw: folds
4QfsCWthT/vSLirorNXqtg leaves the table
kwgv5lNhiFrfONXCshzxlA: calls $0.25
cEMJmfAUQZmMChZe6aacKw: checks
*** FLOP *** [5s 3c Ks]
kwgv5lNhiFrfONXCshzxlA: checks
cEMJmfAUQZmMChZe6aacKw: checks
*** TURN *** [5s 3c Ks] [Kd]
kwgv5lNhiFrfONXCshzxlA: checks
cEMJmfAUQZmMChZe6aacKw: checks
*** RIVER *** [5s 3c Ks Kd] [6d]
local17bob joins the table at seat #4
kwgv5lNhiFrfONXCshzxlA: checks
cEMJmfAUQZmMChZe6aacKw: bets $1
kwgv5lNhiFrfONXCshzxlA: folds
cEMJmfAUQZmMChZe6aacKw collected $0.95 from pot
cEMJmfAUQZmMChZe6aacKw: doesn't show hand
*** SUMMARY ***
Total pot $1 | Rake $0.05
Board [5s 3c Ks Kd 6d]
Seat 1: GxXV09ciXaOxyY2H5aMIIw (button) folded before Flop (didn't bet)
Seat 3: kwgv5lNhiFrfONXCshzxlA (small blind) folded on the River
Seat 5: cEMJmfAUQZmMChZe6aacKw (big blind) collected ($0.95)
Seat 6: b2symlOdL7+0c9Pj4N/KlA folded before Flop (didn't bet)



PokerStars Game #59940852414:  Hold'em No Limit ($0.25/$0.50) - 2009/07/01 1:18:29 ET
Table 'GfL/No5u5PoEnU39lP5pQg' 6-max Seat #2 is the button
Seat 1: 1WUCqNG+p+vfWRTXNu4ljw ($63 in chips)
Seat 2: uVwggSetzp7d+eVgowO3vg ($55.60 in chips)
Seat 3: 4pp9WxhGdbVbxCc9tlu0lw ($31.20 in chips)
Seat 4: r6u7MWSXF30/khcTYkrG9Q ($22.25 in chips)
Seat 5: M1KyQQvVPVuxqTAB8sR/zQ ($50 in chips)
Seat 6: kxPhs4ePFqMy52CInAJ2aw ($63.20 in chips)
4pp9WxhGdbVbxCc9tlu0lw: posts small blind $0.25
r6u7MWSXF30/khcTYkrG9Q: posts big blind $0.50
*** HOLE CARDS ***
M1KyQQvVPVuxqTAB8sR/zQ: raises $1 to $1.50
kxPhs4ePFqMy52CInAJ2aw: folds
1WUCqNG+p+vfWRTXNu4ljw: folds
uVwggSetzp7d+eVgowO3vg: folds
4pp9WxhGdbVbxCc9tlu0lw: folds
r6u7MWSXF30/khcTYkrG9Q: folds
M1KyQQvVPVuxqTAB8sR/zQ collected $1.25 from pot
M1KyQQvVPVuxqTAB8sR/zQ: doesn't show hand
*** SUMMARY ***
Total pot $1.25 | Rake $0
Seat 1: 1WUCqNG+p+vfWRTXNu4ljw folded before Flop (didn't bet)
Seat 2: uVwggSetzp7d+eVgowO3vg (button) folded before Flop (didn't bet)
Seat 3: 4pp9WxhGdbVbxCc9tlu0lw (small blind) folded before Flop
Seat 4: r6u7MWSXF30/khcTYkrG9Q (big blind) folded before Flop
Seat 5: M1KyQQvVPVuxqTAB8sR/zQ collected ($1.25)
Seat 6: kxPhs4ePFqMy52CInAJ2aw folded before Flop (didn't bet)



PokerStars Game #59940853376:  Hold'em No Limit ($0.25/$0.50) - 2009/07/01 1:18:30 ET
Table 'tyR5AZNKV8Aadbrnrnlg7g' 6-max Seat #3 is the button
Seat 1: BgOXYI0yYSN1ULC4FqsNkg ($91.75 in chips)
Seat 2: BAjwVL+zKKd0s0fAWstzQQ ($67.30 in chips)
Seat 3: JFLrYNyQmwPhRQAtoSAuyA ($52.85 in chips)
Seat 4: 4QfsCWthT/vSLirorNXqtg ($75.65 in chips)
Seat 5: GUnvMULl2qFOO1yenu1UBw ($50 in chips)
Seat 6: 498aWaGsW4uGfuWl+2FCGw ($46.50 in chips)
4QfsCWthT/vSLirorNXqtg: posts small blind $0.25
GUnvMULl2qFOO1yenu1UBw: posts big blind $0.50
*** HOLE CARDS ***
498aWaGsW4uGfuWl+2FCGw: calls $0.50
BgOXYI0yYSN1ULC4FqsNkg: calls $0.50
BAjwVL+zKKd0s0fAWstzQQ: folds
JFLrYNyQmwPhRQAtoSAuyA: raises $2 to $2.50
4QfsCWthT/vSLirorNXqtg: calls $2.25
GUnvMULl2qFOO1yenu1UBw: folds
498aWaGsW4uGfuWl+2FCGw: folds
BgOXYI0yYSN1ULC4FqsNkg: calls $2
*** FLOP *** [9d 3c 4s]
4QfsCWthT/vSLirorNXqtg: checks
BgOXYI0yYSN1ULC4FqsNkg: checks
JFLrYNyQmwPhRQAtoSAuyA: checks
*** TURN *** [9d 3c 4s] [9c]
4QfsCWthT/vSLirorNXqtg: checks
BgOXYI0yYSN1ULC4FqsNkg: checks
JFLrYNyQmwPhRQAtoSAuyA: checks
*** RIVER *** [9d 3c 4s 9c] [7h]
4QfsCWthT/vSLirorNXqtg: checks
BgOXYI0yYSN1ULC4FqsNkg: bets $0.50
JFLrYNyQmwPhRQAtoSAuyA: calls $0.50
4QfsCWthT/vSLirorNXqtg: calls $0.50
*** SHOW DOWN ***
BgOXYI0yYSN1ULC4FqsNkg: shows [6c 5c] (a straight, Three to Seven)
JFLrYNyQmwPhRQAtoSAuyA: mucks hand
4QfsCWthT/vSLirorNXqtg: mucks hand
BgOXYI0yYSN1ULC4FqsNkg collected $9.55 from pot
*** SUMMARY ***
Total pot $10 | Rake $0.45
Board [9d 3c 4s 9c 7h]
Seat 1: BgOXYI0yYSN1ULC4FqsNkg showed [6c 5c] and won ($9.55) with a straight, Three to Seven
Seat 2: BAjwVL+zKKd0s0fAWstzQQ folded before Flop (didn't bet)
Seat 3: JFLrYNyQmwPhRQAtoSAuyA (button) mucked
Seat 4: 4QfsCWthT/vSLirorNXqtg (small blind) mucked
Seat 5: GUnvMULl2qFOO1yenu1UBw (big blind) folded before Flop
Seat 6: 498aWaGsW4uGfuWl+2FCGw folded before Flop



PokerStars Game #59940854744:  Hold'em No Limit ($0.25/$0.50) - 2009/07/01 1:18:32 ET
Table 'Nz0Vr7WMHL2g5Uk7dDZjpw' 9-max Seat #4 is the button
Seat 2: gsyXT42WLEcOS4DdEk2wlw ($38.20 in chips)
Seat 3: hoglu9inkgs6zN573/bJag ($4.85 in chips)
Seat 4: E2518gp4aFz1+kAgmGqeEg ($13 in chips)
Seat 5: WGW0DgjBUXs1ylURHG8vnQ ($13.65 in chips)
Seat 6: 997ViqAtWn1FPjJqcffwcA ($59.05 in chips)
Seat 7: KPLH0gELgFe2OuAnhJFI5w ($24.95 in chips)
Seat 8: aoL+R/61Kxmw69ypuPrWAQ ($28.25 in chips)
WGW0DgjBUXs1ylURHG8vnQ: posts small blind $0.25
997ViqAtWn1FPjJqcffwcA: posts big blind $0.50
*** HOLE CARDS ***
KPLH0gELgFe2OuAnhJFI5w: calls $0.50
aoL+R/61Kxmw69ypuPrWAQ: calls $0.50
gsyXT42WLEcOS4DdEk2wlw: calls $0.50
hoglu9inkgs6zN573/bJag: folds
E2518gp4aFz1+kAgmGqeEg: folds
WGW0DgjBUXs1ylURHG8vnQ: calls $0.25
997ViqAtWn1FPjJqcffwcA: checks
*** FLOP *** [7s 5s 5h]
WGW0DgjBUXs1ylURHG8vnQ: checks
997ViqAtWn1FPjJqcffwcA: checks
KPLH0gELgFe2OuAnhJFI5w: checks
aoL+R/61Kxmw69ypuPrWAQ: checks
gsyXT42WLEcOS4DdEk2wlw: checks
*** TURN *** [7s 5s 5h] [Jh]
WGW0DgjBUXs1ylURHG8vnQ: bets $0.50
mSD1pginDsyHG5PDfqzphw has returned
997ViqAtWn1FPjJqcffwcA: folds
KPLH0gELgFe2OuAnhJFI5w: folds
aoL+R/61Kxmw69ypuPrWAQ: folds
gsyXT42WLEcOS4DdEk2wlw: calls $0.50
*** RIVER *** [7s 5s 5h Jh] [Ac]
WGW0DgjBUXs1ylURHG8vnQ: bets $0.50
gsyXT42WLEcOS4DdEk2wlw: folds
WGW0DgjBUXs1ylURHG8vnQ collected $3.35 from pot
WGW0DgjBUXs1ylURHG8vnQ: doesn't show hand
*** SUMMARY ***
Total pot $3.50 | Rake $0.15
Board [7s 5s 5h Jh Ac]
Seat 2: gsyXT42WLEcOS4DdEk2wlw folded on the River
Seat 3: hoglu9inkgs6zN573/bJag folded before Flop (didn't bet)
Seat 4: E2518gp4aFz1+kAgmGqeEg (button) folded before Flop (didn't bet)
Seat 5: WGW0DgjBUXs1ylURHG8vnQ (small blind) collected ($3.35)
Seat 6: 997ViqAtWn1FPjJqcffwcA (big blind) folded on the Turn
Seat 7: KPLH0gELgFe2OuAnhJFI5w folded on the Turn
Seat 8: aoL+R/61Kxmw69ypuPrWAQ folded on the Turn



PokerStars Game #59940856396:  Hold'em No Limit ($0.25/$0.50) - 2009/07/01 1:18:35 ET
Table '+dXkOAQyS8j9PQZusUTMpg' 2-max Seat #2 is the button
Seat 1: Teld4PDKla7C8/Wfu2DSkg ($51.60 in chips)
Seat 2: +zI4bP23YIjMkUHqeN2xfw ($28.20 in chips)
+zI4bP23YIjMkUHqeN2xfw: posts small blind $0.25
Teld4PDKla7C8/Wfu2DSkg: posts big blind $0.50
*** HOLE CARDS ***
+zI4bP23YIjMkUHqeN2xfw: folds
Teld4PDKla7C8/Wfu2DSkg collected $0.50 from pot
Teld4PDKla7C8/Wfu2DSkg: doesn't show hand
*** SUMMARY ***
Total pot $0.50 | Rake $0
Seat 1: Teld4PDKla7C8/Wfu2DSkg (big blind) collected ($0.50)
Seat 2: +zI4bP23YIjMkUHqeN2xfw (button) (small blind) folded before Flop



PokerStars Game #59940856920:  Hold'em No Limit ($0.25/$0.50) - 2009/07/01 1:18:36 ET
Table 'MJxeZCzYELxiIsyUZyT0jw' 6-max Seat #5 is the button
Seat 1: +Pf9jTVizYlIo+woPvptfA ($50 in chips)
Seat 2: t3GiVMzqA9Svgr5Uol32cQ ($35.05 in chips)
Seat 3: sIG4mp8tZEI+W4nKZNkkQA ($51.85 in chips)
Seat 4: alGiiQP/wwtYnfuXII+sgw ($59.60 in chips)
Seat 5: 3jvoOXNtXE90w2BdfNZwZQ ($59.45 in chips)
Seat 6: c0n4hrn20AML9qzyFC2E8Q ($46.90 in chips)
c0n4hrn20AML9qzyFC2E8Q: posts small blind $0.25
+Pf9jTVizYlIo+woPvptfA: posts big blind $0.50
*** HOLE CARDS ***
t3GiVMzqA9Svgr5Uol32cQ: folds
sIG4mp8tZEI+W4nKZNkkQA: folds
alGiiQP/wwtYnfuXII+sgw: raises $0.50 to $1
3jvoOXNtXE90w2BdfNZwZQ: folds
c0n4hrn20AML9qzyFC2E8Q: calls $0.75
+Pf9jTVizYlIo+woPvptfA: folds
*** FLOP *** [As 9s 7d]
c0n4hrn20AML9qzyFC2E8Q: checks
alGiiQP/wwtYnfuXII+sgw: checks
*** TURN *** [As 9s 7d] [2h]
c0n4hrn20AML9qzyFC2E8Q: checks
alGiiQP/wwtYnfuXII+sgw: checks
*** RIVER *** [As 9s 7d 2h] [6s]
c0n4hrn20AML9qzyFC2E8Q: checks
alGiiQP/wwtYnfuXII+sgw: checks
*** SHOW DOWN ***
c0n4hrn20AML9qzyFC2E8Q: shows [6h Kd] (a pair of Sixes)
alGiiQP/wwtYnfuXII+sgw: mucks hand
c0n4hrn20AML9qzyFC2E8Q collected $2.40 from pot
*** SUMMARY ***
Total pot $2.50 | Rake $0.10
Board [As 9s 7d 2h 6s]
Seat 1: +Pf9jTVizYlIo+woPvptfA (big blind) folded before Flop
Seat 2: t3GiVMzqA9Svgr5Uol32cQ folded before Flop (didn't bet)
Seat 3: sIG4mp8tZEI+W4nKZNkkQA folded before Flop (didn't bet)
Seat 4: alGiiQP/wwtYnfuXII+sgw mucked
Seat 5: 3jvoOXNtXE90w2BdfNZwZQ (button) folded before Flop (didn't bet)
Seat 6: c0n4hrn20AML9qzyFC2E8Q (small blind) showed [6h Kd] and won ($2.40) with a pair of Sixes



PokerStars Game #59940857056:  Hold'em No Limit ($0.25/$0.50) - 2009/07/01 1:18:37 ET
Table 'hSTs/dUsYLgJQuF2Onp0MQ' 6-max Seat #5 is the button
Seat 1: 1WUCqNG+p+vfWRTXNu4ljw ($50 in chips)
Seat 3: C3qJBo7uxfFVDluE1lmK2w ($30.60 in chips)
Seat 4: 2igtJLmvIZ+HqX4XPgMPZA ($50.50 in chips)
Seat 5: IBNygaT1aa9Z1uPdJJilwA ($36.50 in chips)
Seat 6: M1KyQQvVPVuxqTAB8sR/zQ ($87.70 in chips)
M1KyQQvVPVuxqTAB8sR/zQ: posts small blind $0.25
1WUCqNG+p+vfWRTXNu4ljw: posts big blind $0.50
*** HOLE CARDS ***
C3qJBo7uxfFVDluE1lmK2w: folds
2igtJLmvIZ+HqX4XPgMPZA: folds
IBNygaT1aa9Z1uPdJJilwA: folds
M1KyQQvVPVuxqTAB8sR/zQ: raises $1 to $1.50
1WUCqNG+p+vfWRTXNu4ljw: folds
M1KyQQvVPVuxqTAB8sR/zQ collected $1 from pot
M1KyQQvVPVuxqTAB8sR/zQ: doesn't show hand
*** SUMMARY ***
Total pot $1 | Rake $0
Seat 1: 1WUCqNG+p+vfWRTXNu4ljw (big blind) folded before Flop
Seat 3: C3qJBo7uxfFVDluE1lmK2w folded before Flop (didn't bet)
Seat 4: 2igtJLmvIZ+HqX4XPgMPZA folded before Flop (didn't bet)
Seat 5: IBNygaT1aa9Z1uPdJJilwA (button) folded before Flop (didn't bet)
Seat 6: M1KyQQvVPVuxqTAB8sR/zQ (small blind) collected ($1)



PokerStars Game #59940858404:  Hold'em No Limit ($0.25/$0.50) - 2009/07/01 1:18:39 ET
Table 'X6IRCRTh+20gjz8aubWnwA' 9-max Seat #7 is the button
Seat 2: HZkVla4kK2SI42CVrPZ/ig ($5.80 in chips)
Seat 3: SWv01peOe69QQRvhQTqjQw ($6 in chips)
Seat 4: M3JFBNQ8Bbw3FBZ/18MuXw ($26.65 in chips)
Seat 5: NnQCepdIR/AOUQn1yhYx6Q ($8.50 in chips)
Seat 6: 75K2MXwN65Sjfp1yHd50Hg ($12.15 in chips)
Seat 7: cFHQjKQOOKTUzoilhrXHLg ($11.75 in chips)
Seat 8: HxeBVq06/3Bh/H986sgdbw ($48.75 in chips)
Seat 9: M+7+BTmX5vZatHVuoRB1nA ($45.55 in chips)
HxeBVq06/3Bh/H986sgdbw: posts small blind $0.25
M+7+BTmX5vZatHVuoRB1nA: posts big blind $0.50
E2518gp4aFz1+kAgmGqeEg: sits out
*** HOLE CARDS ***
HZkVla4kK2SI42CVrPZ/ig: calls $0.50
SWv01peOe69QQRvhQTqjQw: folds
M3JFBNQ8Bbw3FBZ/18MuXw: folds
NnQCepdIR/AOUQn1yhYx6Q: raises $8 to $8.50 and is all-in
75K2MXwN65Sjfp1yHd50Hg: folds
cFHQjKQOOKTUzoilhrXHLg: folds
HxeBVq06/3Bh/H986sgdbw: folds
M+7+BTmX5vZatHVuoRB1nA: folds
HZkVla4kK2SI42CVrPZ/ig: calls $5.30 and is all-in
*** FLOP *** [8c Ac Qs]
*** TURN *** [8c Ac Qs] [6d]
*** RIVER *** [8c Ac Qs 6d] [9h]
*** SHOW DOWN ***
HZkVla4kK2SI42CVrPZ/ig: shows [Ad Jd] (a pair of Aces)
NnQCepdIR/AOUQn1yhYx6Q: shows [8d 8h] (three of a kind, Eights)
NnQCepdIR/AOUQn1yhYx6Q collected $11.75 from pot
*** SUMMARY ***
Total pot $12.35 | Rake $0.60
Board [8c Ac Qs 6d 9h]
Seat 2: HZkVla4kK2SI42CVrPZ/ig showed [Ad Jd] and lost with a pair of Aces
Seat 3: SWv01peOe69QQRvhQTqjQw folded before Flop (didn't bet)
Seat 4: M3JFBNQ8Bbw3FBZ/18MuXw folded before Flop (didn't bet)
Seat 5: NnQCepdIR/AOUQn1yhYx6Q showed [8d 8h] and won ($11.75) with three of a kind, Eights
Seat 6: 75K2MXwN65Sjfp1yHd50Hg folded before Flop (didn't bet)
Seat 7: cFHQjKQOOKTUzoilhrXHLg (button) folded before Flop (didn't bet)
Seat 8: HxeBVq06/3Bh/H986sgdbw (small blind) folded before Flop
Seat 9: M+7+BTmX5vZatHVuoRB1nA (big blind) folded before Flop



PokerStars Game #59940859716:  Hold'em No Limit ($0.25/$0.50) - 2009/07/01 1:18:41 ET
Table '+dXkOAQyS8j9PQZusUTMpg' 2-max Seat #1 is the button
Seat 1: Teld4PDKla7C8/Wfu2DSkg ($51.85 in chips)
Seat 2: +zI4bP23YIjMkUHqeN2xfw ($27.95 in chips)
Teld4PDKla7C8/Wfu2DSkg: posts small blind $0.25
+zI4bP23YIjMkUHqeN2xfw: posts big blind $0.50
*** HOLE CARDS ***
Teld4PDKla7C8/Wfu2DSkg: calls $0.25
+zI4bP23YIjMkUHqeN2xfw: checks
*** FLOP *** [Qh Td 9s]
+zI4bP23YIjMkUHqeN2xfw: checks
Teld4PDKla7C8/Wfu2DSkg: checks
*** TURN *** [Qh Td 9s] [8s]
+zI4bP23YIjMkUHqeN2xfw: checks
Teld4PDKla7C8/Wfu2DSkg: checks
*** RIVER *** [Qh Td 9s 8s] [3s]
+zI4bP23YIjMkUHqeN2xfw: bets $1
Teld4PDKla7C8/Wfu2DSkg: folds
+zI4bP23YIjMkUHqeN2xfw collected $0.95 from pot
*** SUMMARY ***
Total pot $1 | Rake $0.05
Board [Qh Td 9s 8s 3s]
Seat 1: Teld4PDKla7C8/Wfu2DSkg (button) (small blind) folded on the River
Seat 2: +zI4bP23YIjMkUHqeN2xfw (big blind) collected ($0.95)



PokerStars Game #59940860554:  Hold'em No Limit ($0.25/$0.50) - 2009/07/01 1:18:43 ET
Table '8BQGgNetI1NOvWeu3gtMNw' 2-max Seat #1 is the button
Seat 1: bypIyrYcAAifLfhZpGlKLA ($66.90 in chips)
Seat 2: Z4HwehErEwzsv/noQlfUlg ($124.90 in chips)
bypIyrYcAAifLfhZpGlKLA: posts small blind $0.25
Z4HwehErEwzsv/noQlfUlg: posts big blind $0.50
*** HOLE CARDS ***
bypIyrYcAAifLfhZpGlKLA: raises $1 to $1.50
Z4HwehErEwzsv/noQlfUlg: folds
bypIyrYcAAifLfhZpGlKLA collected $1 from pot
bypIyrYcAAifLfhZpGlKLA: doesn't show hand
*** SUMMARY ***
Total pot $1 | Rake $0
Seat 1: bypIyrYcAAifLfhZpGlKLA (button) (small blind) collected ($1)
Seat 2: Z4HwehErEwzsv/noQlfUlg (big blind) folded before Flop



PokerStars Game #59940862248:  Hold'em No Limit ($0.25/$0.50) - 2009/07/01 1:18:46 ET
Table 'c/CRn+68J3Y8KxD5g1ek2Q' 2-max Seat #1 is the button
Seat 1: 46qCyJ6evTkHo9al5sBMNA ($101.65 in chips)
Seat 2: BypVLsYQt3ePFm2xQL/dOA ($260.45 in chips)
46qCyJ6evTkHo9al5sBMNA: posts small blind $0.25
BypVLsYQt3ePFm2xQL/dOA: posts big blind $0.50
*** HOLE CARDS ***
46qCyJ6evTkHo9al5sBMNA: raises $1.50 to $2
BypVLsYQt3ePFm2xQL/dOA: folds
46qCyJ6evTkHo9al5sBMNA collected $1 from pot
46qCyJ6evTkHo9al5sBMNA: doesn't show hand
*** SUMMARY ***
Total pot $1 | Rake $0
Seat 1: 46qCyJ6evTkHo9al5sBMNA (button) (small blind) collected ($1)
Seat 2: BypVLsYQt3ePFm2xQL/dOA (big blind) folded before Flop



PokerStars Game #59940863286:  Hold'em No Limit ($0.25/$0.50) - 2009/07/01 1:18:47 ET
Table 'EiNh8p/wGJ1FP575iMFnqg' 9-max Seat #3 is the button
Seat 2: 8ehL7qlZzjgUh2H35iiWLw ($58.90 in chips)
Seat 3: ymLPoEIl7UL3TvZYmnadxQ ($54.05 in chips)
Seat 4: cMzaiXAM/ZAdNaEUu+LqhA ($50.45 in chips)
Seat 5: M+7+BTmX5vZatHVuoRB1nA ($79.70 in chips)
Seat 6: viwBDtJsY6JfsFOdBAyJIQ ($10.70 in chips)
Seat 7: 997ViqAtWn1FPjJqcffwcA ($50 in chips)
Seat 9: GuPkZObrz5Zkkn8FsEdF9w ($30.70 in chips)
cMzaiXAM/ZAdNaEUu+LqhA: posts small blind $0.25
M+7+BTmX5vZatHVuoRB1nA: posts big blind $0.50
*** HOLE CARDS ***
viwBDtJsY6JfsFOdBAyJIQ: folds
997ViqAtWn1FPjJqcffwcA: folds
bmRtaIYKthN1F+B3JLZ3Jw joins the table at seat #1
GuPkZObrz5Zkkn8FsEdF9w has timed out
GuPkZObrz5Zkkn8FsEdF9w: folds
GuPkZObrz5Zkkn8FsEdF9w is sitting out
8ehL7qlZzjgUh2H35iiWLw: folds
ymLPoEIl7UL3TvZYmnadxQ: folds
cMzaiXAM/ZAdNaEUu+LqhA: folds
M+7+BTmX5vZatHVuoRB1nA collected $0.50 from pot
M+7+BTmX5vZatHVuoRB1nA: doesn't show hand
*** SUMMARY ***
Total pot $0.50 | Rake $0
Seat 2: 8ehL7qlZzjgUh2H35iiWLw folded before Flop (didn't bet)
Seat 3: ymLPoEIl7UL3TvZYmnadxQ (button) folded before Flop (didn't bet)
Seat 4: cMzaiXAM/ZAdNaEUu+LqhA (small blind) folded before Flop
Seat 5: M+7+BTmX5vZatHVuoRB1nA (big blind) collected ($0.50)
Seat 6: viwBDtJsY6JfsFOdBAyJIQ folded before Flop (didn't bet)
Seat 7: 997ViqAtWn1FPjJqcffwcA folded before Flop (didn't bet)
Seat 9: GuPkZObrz5Zkkn8FsEdF9w folded before Flop (didn't bet)



PokerStars Game #59940864032:  Hold'em No Limit ($0.25/$0.50) - 2009/07/01 1:18:49 ET
Table 'lSisgp6H7Fg1hH5VfjEjYQ' 9-max Seat #9 is the button
Seat 1: 5k9fvXD9suIgCxU4HLQjTw ($50 in chips)
Seat 3: SKnJuWHScqetA/qG5p+wCg ($30 in chips)
Seat 4: bwv/rbH/hHhPhY6u9mu04w ($33.35 in chips)
Seat 6: +k7T5ocke8UwavtgUHm+Cg ($64.40 in chips)
Seat 7: IDtNLR9uFCDdjNsJWMHA5Q ($21.05 in chips)
Seat 8: a4JDWmpFQkL10XfAyuF51A ($15.50 in chips)
Seat 9: YzeKFbJVLmJGTgNH3ySQlw ($15.50 in chips)
5k9fvXD9suIgCxU4HLQjTw: posts small blind $0.25
UrcnkQOiLVk8BlKDPJSy7Q: is sitting out
SKnJuWHScqetA/qG5p+wCg: posts big blind $0.50
*** HOLE CARDS ***
bwv/rbH/hHhPhY6u9mu04w: folds
+k7T5ocke8UwavtgUHm+Cg: folds
IDtNLR9uFCDdjNsJWMHA5Q: calls $0.50
a4JDWmpFQkL10XfAyuF51A: folds
YzeKFbJVLmJGTgNH3ySQlw: calls $0.50
5k9fvXD9suIgCxU4HLQjTw: calls $0.25
SKnJuWHScqetA/qG5p+wCg: checks
*** FLOP *** [7h Ac 5h]
5k9fvXD9suIgCxU4HLQjTw: checks
mSD1pginDsyHG5PDfqzphw has returned
SKnJuWHScqetA/qG5p+wCg: checks
IDtNLR9uFCDdjNsJWMHA5Q: bets $1
YzeKFbJVLmJGTgNH3ySQlw: folds
5k9fvXD9suIgCxU4HLQjTw: folds
SKnJuWHScqetA/qG5p+wCg: folds
IDtNLR9uFCDdjNsJWMHA5Q collected $1.90 from pot
*** SUMMARY ***
Total pot $2 | Rake $0.10
Board [7h Ac 5h]
Seat 1: 5k9fvXD9suIgCxU4HLQjTw (small blind) folded on the Flop
Seat 3: SKnJuWHScqetA/qG5p+wCg (big blind) folded on the Flop
Seat 4: bwv/rbH/hHhPhY6u9mu04w folded before Flop (didn't bet)
Seat 6: +k7T5ocke8UwavtgUHm+Cg folded before Flop (didn't bet)
Seat 7: IDtNLR9uFCDdjNsJWMHA5Q collected ($1.90)
Seat 8: a4JDWmpFQkL10XfAyuF51A folded before Flop (didn't bet)
Seat 9: YzeKFbJVLmJGTgNH3ySQlw (button) folded on the Flop



PokerStars Game #59940865062:  Hold'em No Limit ($0.25/$0.50) - 2009/07/01 1:18:51 ET
Table '8BQGgNetI1NOvWeu3gtMNw' 2-max Seat #2 is the button
Seat 1: bypIyrYcAAifLfhZpGlKLA ($67.40 in chips)
Seat 2: Z4HwehErEwzsv/noQlfUlg ($124.40 in chips)
Z4HwehErEwzsv/noQlfUlg: posts small blind $0.25
bypIyrYcAAifLfhZpGlKLA: posts big blind $0.50
*** HOLE CARDS ***
Z4HwehErEwzsv/noQlfUlg: folds
bypIyrYcAAifLfhZpGlKLA collected $0.50 from pot
bypIyrYcAAifLfhZpGlKLA: doesn't show hand
*** SUMMARY ***
Total pot $0.50 | Rake $0
Seat 1: bypIyrYcAAifLfhZpGlKLA (big blind) collected ($0.50)
Seat 2: Z4HwehErEwzsv/noQlfUlg (button) (small blind) folded before Flop



PokerStars Game #59940866238:  Hold'em No Limit ($0.25/$0.50) - 2009/07/01 1:18:53 ET
Table 'ofnd8S4IdIPph1Cbn+x7hA' 2-max Seat #1 is the button
Seat 1: PY4NvRocCFPfSIHKbh0euQ ($27.10 in chips)
Seat 2: l5WbyJ/iWYjpeCC6GCYY6w ($68 in chips)
PY4NvRocCFPfSIHKbh0euQ: posts small blind $0.25
l5WbyJ/iWYjpeCC6GCYY6w: posts big blind $0.50
*** HOLE CARDS ***
PY4NvRocCFPfSIHKbh0euQ: calls $0.25
l5WbyJ/iWYjpeCC6GCYY6w: checks
*** FLOP *** [7c 5d 2s]
l5WbyJ/iWYjpeCC6GCYY6w: bets $1
PY4NvRocCFPfSIHKbh0euQ: calls $1
*** TURN *** [7c 5d 2s] [As]
l5WbyJ/iWYjpeCC6GCYY6w: bets $1.50
PY4NvRocCFPfSIHKbh0euQ: raises $1.50 to $3
l5WbyJ/iWYjpeCC6GCYY6w: folds
PY4NvRocCFPfSIHKbh0euQ collected $5.75 from pot
*** SUMMARY ***
Total pot $6 | Rake $0.25
Board [7c 5d 2s As]
Seat 1: PY4NvRocCFPfSIHKbh0euQ (button) (small blind) collected ($5.75)
Seat 2: l5WbyJ/iWYjpeCC6GCYY6w (big blind) folded on the Turn



PokerStars Game #59940866870:  Hold'em No Limit ($0.25/$0.50) - 2009/07/01 1:18:54 ET
Table 'c/CRn+68J3Y8KxD5g1ek2Q' 2-max Seat #2 is the button
Seat 1: 46qCyJ6evTkHo9al5sBMNA ($102.15 in chips)
Seat 2: BypVLsYQt3ePFm2xQL/dOA ($259.95 in chips)
BypVLsYQt3ePFm2xQL/dOA: posts small blind $0.25
46qCyJ6evTkHo9al5sBMNA: posts big blind $0.50
*** HOLE CARDS ***
BypVLsYQt3ePFm2xQL/dOA: calls $0.25
46qCyJ6evTkHo9al5sBMNA: checks
*** FLOP *** [6s 5s 5c]
46qCyJ6evTkHo9al5sBMNA: bets $1.50
BypVLsYQt3ePFm2xQL/dOA: folds
46qCyJ6evTkHo9al5sBMNA collected $0.95 from pot
46qCyJ6evTkHo9al5sBMNA: doesn't show hand
*** SUMMARY ***
Total pot $1 | Rake $0.05
Board [6s 5s 5c]
Seat 1: 46qCyJ6evTkHo9al5sBMNA (big blind) collected ($0.95)
Seat 2: BypVLsYQt3ePFm2xQL/dOA (button) (small blind) folded on the Flop



PokerStars Game #59940866956:  Hold'em No Limit ($0.25/$0.50) - 2009/07/01 1:18:54 ET
Table 'hSTs/dUsYLgJQuF2Onp0MQ' 6-max Seat #6 is the button
Seat 1: 1WUCqNG+p+vfWRTXNu4ljw ($50 in chips)
Seat 3: C3qJBo7uxfFVDluE1lmK2w ($30.60 in chips)
Seat 4: 2igtJLmvIZ+HqX4XPgMPZA ($50.50 in chips)
Seat 5: IBNygaT1aa9Z1uPdJJilwA ($36.50 in chips)
Seat 6: M1KyQQvVPVuxqTAB8sR/zQ ($88.20 in chips)
1WUCqNG+p+vfWRTXNu4ljw: posts small blind $0.25
C3qJBo7uxfFVDluE1lmK2w: posts big blind $0.50
*** HOLE CARDS ***
2igtJLmvIZ+HqX4XPgMPZA: folds
IBNygaT1aa9Z1uPdJJilwA: raises $1 to $1.50
M1KyQQvVPVuxqTAB8sR/zQ: folds
1WUCqNG+p+vfWRTXNu4ljw: folds
C3qJBo7uxfFVDluE1lmK2w: calls $1
*** FLOP *** [3d 5d 4c]
C3qJBo7uxfFVDluE1lmK2w: bets $2
IBNygaT1aa9Z1uPdJJilwA: raises $3 to $5
C3qJBo7uxfFVDluE1lmK2w: raises $24.10 to $29.10 and is all-in
IBNygaT1aa9Z1uPdJJilwA: calls $24.10
*** TURN *** [3d 5d 4c] [8h]
*** RIVER *** [3d 5d 4c 8h] [Td]
*** SHOW DOWN ***
C3qJBo7uxfFVDluE1lmK2w: shows [Ks Kd] (a pair of Kings)
IBNygaT1aa9Z1uPdJJilwA: shows [Tc Ts] (three of a kind, Tens)
IBNygaT1aa9Z1uPdJJilwA collected $59.45 from pot
*** SUMMARY ***
Total pot $61.45 | Rake $2
Board [3d 5d 4c 8h Td]
Seat 1: 1WUCqNG+p+vfWRTXNu4ljw (small blind) folded before Flop
Seat 3: C3qJBo7uxfFVDluE1lmK2w (big blind) showed [Ks Kd] and lost with a pair of Kings
Seat 4: 2igtJLmvIZ+HqX4XPgMPZA folded before Flop (didn't bet)
Seat 5: IBNygaT1aa9Z1uPdJJilwA showed [Tc Ts] and won ($59.45) with three of a kind, Tens
Seat 6: M1KyQQvVPVuxqTAB8sR/zQ (button) folded before Flop (didn't bet)



PokerStars Game #59940868380:  Hold'em No Limit ($0.25/$0.50) - 2009/07/01 1:18:56 ET
Table 'BCN5su+SsXiy1zRMJi0SJw' 6-max Seat #3 is the button
Seat 1: GxXV09ciXaOxyY2H5aMIIw ($54.60 in chips)
Seat 2: ehFNAevCQri3trWxV6FJdA ($30 in chips)
Seat 3: kwgv5lNhiFrfONXCshzxlA ($46.95 in chips)
Seat 5: cEMJmfAUQZmMChZe6aacKw ($46.55 in chips)
Seat 6: b2symlOdL7+0c9Pj4N/KlA ($54.15 in chips)
local17bob will be allowed to play after the button
cEMJmfAUQZmMChZe6aacKw: posts small blind $0.25
b2symlOdL7+0c9Pj4N/KlA: posts big blind $0.50
ehFNAevCQri3trWxV6FJdA: posts big blind $0.50
*** HOLE CARDS ***
GxXV09ciXaOxyY2H5aMIIw: folds
ehFNAevCQri3trWxV6FJdA: checks
kwgv5lNhiFrfONXCshzxlA: calls $0.50
cEMJmfAUQZmMChZe6aacKw: calls $0.25
b2symlOdL7+0c9Pj4N/KlA: raises $3 to $3.50
ehFNAevCQri3trWxV6FJdA: folds
kwgv5lNhiFrfONXCshzxlA: folds
cEMJmfAUQZmMChZe6aacKw: folds
local17bob leaves the table
b2symlOdL7+0c9Pj4N/KlA collected $2 from pot
b2symlOdL7+0c9Pj4N/KlA: doesn't show hand
*** SUMMARY ***
Total pot $2 | Rake $0
Seat 1: GxXV09ciXaOxyY2H5aMIIw folded before Flop (didn't bet)
Seat 2: ehFNAevCQri3trWxV6FJdA folded before Flop
Seat 3: kwgv5lNhiFrfONXCshzxlA (button) folded before Flop
Seat 5: cEMJmfAUQZmMChZe6aacKw (small blind) folded before Flop
Seat 6: b2symlOdL7+0c9Pj4N/KlA (big blind) collected ($2)



PokerStars Game #59940869550:  Hold'em No Limit ($0.25/$0.50) - 2009/07/01 1:18:58 ET
Table '8BQGgNetI1NOvWeu3gtMNw' 2-max Seat #1 is the button
Seat 1: bypIyrYcAAifLfhZpGlKLA ($67.65 in chips)
Seat 2: Z4HwehErEwzsv/noQlfUlg ($124.15 in chips)
bypIyrYcAAifLfhZpGlKLA: posts small blind $0.25
Z4HwehErEwzsv/noQlfUlg: posts big blind $0.50
*** HOLE CARDS ***
bypIyrYcAAifLfhZpGlKLA: raises $1 to $1.50
Z4HwehErEwzsv/noQlfUlg: folds
bypIyrYcAAifLfhZpGlKLA collected $1 from pot
bypIyrYcAAifLfhZpGlKLA: doesn't show hand
*** SUMMARY ***
Total pot $1 | Rake $0
Seat 1: bypIyrYcAAifLfhZpGlKLA (button) (small blind) collected ($1)
Seat 2: Z4HwehErEwzsv/noQlfUlg (big blind) folded before Flop



PokerStars Game #59940869310:  Hold'em No Limit ($0.25/$0.50) - 2009/07/01 1:18:58 ET
Table 'GfL/No5u5PoEnU39lP5pQg' 6-max Seat #3 is the button
Seat 1: 1WUCqNG+p+vfWRTXNu4ljw ($63 in chips)
Seat 2: uVwggSetzp7d+eVgowO3vg ($55.60 in chips)
Seat 3: 4pp9WxhGdbVbxCc9tlu0lw ($30.95 in chips)
Seat 4: r6u7MWSXF30/khcTYkrG9Q ($21.75 in chips)
Seat 5: M1KyQQvVPVuxqTAB8sR/zQ ($50.75 in chips)
Seat 6: kxPhs4ePFqMy52CInAJ2aw ($63.20 in chips)
r6u7MWSXF30/khcTYkrG9Q: posts small blind $0.25
M1KyQQvVPVuxqTAB8sR/zQ: posts big blind $0.50
*** HOLE CARDS ***
kxPhs4ePFqMy52CInAJ2aw: folds
1WUCqNG+p+vfWRTXNu4ljw: folds
uVwggSetzp7d+eVgowO3vg: raises $1 to $1.50
4pp9WxhGdbVbxCc9tlu0lw: calls $1.50
r6u7MWSXF30/khcTYkrG9Q: folds
M1KyQQvVPVuxqTAB8sR/zQ: folds
*** FLOP *** [2c 6c 9c]
uVwggSetzp7d+eVgowO3vg: checks
4pp9WxhGdbVbxCc9tlu0lw: checks
*** TURN *** [2c 6c 9c] [7c]
uVwggSetzp7d+eVgowO3vg: checks
4pp9WxhGdbVbxCc9tlu0lw: bets $1
uVwggSetzp7d+eVgowO3vg: folds
4pp9WxhGdbVbxCc9tlu0lw collected $3.60 from pot
*** SUMMARY ***
Total pot $3.75 | Rake $0.15
Board [2c 6c 9c 7c]
Seat 1: 1WUCqNG+p+vfWRTXNu4ljw folded before Flop (didn't bet)
Seat 2: uVwggSetzp7d+eVgowO3vg folded on the Turn
Seat 3: 4pp9WxhGdbVbxCc9tlu0lw (button) collected ($3.60)
Seat 4: r6u7MWSXF30/khcTYkrG9Q (small blind) folded before Flop
Seat 5: M1KyQQvVPVuxqTAB8sR/zQ (big blind) folded before Flop
Seat 6: kxPhs4ePFqMy52CInAJ2aw folded before Flop (didn't bet)



PokerStars Game #59940870004:  Hold'em No Limit ($0.25/$0.50) - 2009/07/01 1:18:59 ET
Table '+dXkOAQyS8j9PQZusUTMpg' 2-max Seat #2 is the button
Seat 1: Teld4PDKla7C8/Wfu2DSkg ($51.35 in chips)
Seat 2: +zI4bP23YIjMkUHqeN2xfw ($28.40 in chips)
+zI4bP23YIjMkUHqeN2xfw: posts small blind $0.25
Teld4PDKla7C8/Wfu2DSkg: posts big blind $0.50
*** HOLE CARDS ***
+zI4bP23YIjMkUHqeN2xfw: folds
Teld4PDKla7C8/Wfu2DSkg collected $0.50 from pot
Teld4PDKla7C8/Wfu2DSkg: doesn't show hand
*** SUMMARY ***
Total pot $0.50 | Rake $0
Seat 1: Teld4PDKla7C8/Wfu2DSkg (big blind) collected ($0.50)
Seat 2: +zI4bP23YIjMkUHqeN2xfw (button) (small blind) folded before Flop



PokerStars Game #59940871448:  Hold'em No Limit ($0.25/$0.50) - 2009/07/01 1:19:02 ET
Table 'PALRfuH85dr5IkDfdv6new' 9-max Seat #7 is the button
Seat 1: v/4aX0ejnaIFK4ftDk2Lyg ($48.75 in chips)
Seat 2: 1aXjSbrubyQKHeauooF5Wg ($48.15 in chips)
Seat 3: 50QWoELmpmHFrFIlWMJo9g ($97.15 in chips)
Seat 4: mZNMJI1mY40XTC0U7GZakA ($56.80 in chips)
Seat 6: ottZQkg1UDWk85BtBzGJzg ($45.85 in chips)
Seat 7: 3NcyXvr39gnK+KbTq7ezyA ($53.50 in chips)
Seat 8: NkS+CseUKx4XHszWq0PXEQ ($76.45 in chips)
Seat 9: viwBDtJsY6JfsFOdBAyJIQ ($9.75 in chips)
NkS+CseUKx4XHszWq0PXEQ: posts small blind $0.25
viwBDtJsY6JfsFOdBAyJIQ: posts big blind $0.50
XcLXSUMHSpshK/7Lh0M4Vg: sits out
*** HOLE CARDS ***
v/4aX0ejnaIFK4ftDk2Lyg: folds
1aXjSbrubyQKHeauooF5Wg: folds
50QWoELmpmHFrFIlWMJo9g: folds
mZNMJI1mY40XTC0U7GZakA: folds
ottZQkg1UDWk85BtBzGJzg: folds
3NcyXvr39gnK+KbTq7ezyA: folds
NkS+CseUKx4XHszWq0PXEQ: calls $0.25
viwBDtJsY6JfsFOdBAyJIQ: checks
*** FLOP *** [4s 4h 8c]
NkS+CseUKx4XHszWq0PXEQ: checks
viwBDtJsY6JfsFOdBAyJIQ: bets $1
NkS+CseUKx4XHszWq0PXEQ: folds
viwBDtJsY6JfsFOdBAyJIQ collected $0.95 from pot
*** SUMMARY ***
Total pot $1 | Rake $0.05
Board [4s 4h 8c]
Seat 1: v/4aX0ejnaIFK4ftDk2Lyg folded before Flop (didn't bet)
Seat 2: 1aXjSbrubyQKHeauooF5Wg folded before Flop (didn't bet)
Seat 3: 50QWoELmpmHFrFIlWMJo9g folded before Flop (didn't bet)
Seat 4: mZNMJI1mY40XTC0U7GZakA folded before Flop (didn't bet)
Seat 6: ottZQkg1UDWk85BtBzGJzg folded before Flop (didn't bet)
Seat 7: 3NcyXvr39gnK+KbTq7ezyA (button) folded before Flop (didn't bet)
Seat 8: NkS+CseUKx4XHszWq0PXEQ (small blind) folded on the Flop
Seat 9: viwBDtJsY6JfsFOdBAyJIQ (big blind) collected ($0.95)



PokerStars Game #59940872498:  Hold'em No Limit ($0.25/$0.50) - 2009/07/01 1:19:04 ET
Table '+z1aekfHkpp09pc8F9aViw' 6-max Seat #2 is the button
Seat 1: 7zFtlEn2NxyROFkJdZA/yg ($50 in chips)
Seat 2: OZ6OtYh5Y53MCH/p0QTn5g ($50 in chips)
Seat 3: uUznlIMFnRUvwrBhYF73KA ($163.90 in chips)
Seat 4: RowCSpSURHTOL/dcjg/Iug ($52.60 in chips)
Seat 5: rplyldNweS6YyMNEALQrug ($33.55 in chips)
Seat 6: GUnvMULl2qFOO1yenu1UBw ($50 in chips)
uUznlIMFnRUvwrBhYF73KA: posts small blind $0.25
RowCSpSURHTOL/dcjg/Iug: posts big blind $0.50
*** HOLE CARDS ***
rplyldNweS6YyMNEALQrug: calls $0.50
GUnvMULl2qFOO1yenu1UBw: folds
7zFtlEn2NxyROFkJdZA/yg: folds
OZ6OtYh5Y53MCH/p0QTn5g: folds
uUznlIMFnRUvwrBhYF73KA: calls $0.25
RowCSpSURHTOL/dcjg/Iug: raises $1 to $1.50
rplyldNweS6YyMNEALQrug: raises $6 to $7.50
uUznlIMFnRUvwrBhYF73KA: folds
RowCSpSURHTOL/dcjg/Iug: calls $6
*** FLOP *** [Jc 2s Ah]
RowCSpSURHTOL/dcjg/Iug: checks
rplyldNweS6YyMNEALQrug: bets $6.50
RowCSpSURHTOL/dcjg/Iug: calls $6.50
*** TURN *** [Jc 2s Ah] [8s]
RowCSpSURHTOL/dcjg/Iug: checks
rplyldNweS6YyMNEALQrug: bets $8
RowCSpSURHTOL/dcjg/Iug: calls $8
*** RIVER *** [Jc 2s Ah 8s] [9c]
RowCSpSURHTOL/dcjg/Iug: checks
rplyldNweS6YyMNEALQrug: bets $11.55 and is all-in
RowCSpSURHTOL/dcjg/Iug: calls $11.55
*** SHOW DOWN ***
rplyldNweS6YyMNEALQrug: shows [Qh Ks] (high card Ace)
RowCSpSURHTOL/dcjg/Iug: shows [8c Ad] (two pair, Aces and Eights)
RowCSpSURHTOL/dcjg/Iug collected $64.60 from pot
*** SUMMARY ***
Total pot $67.60 | Rake $3
Board [Jc 2s Ah 8s 9c]
Seat 1: 7zFtlEn2NxyROFkJdZA/yg folded before Flop (didn't bet)
Seat 2: OZ6OtYh5Y53MCH/p0QTn5g (button) folded before Flop (didn't bet)
Seat 3: uUznlIMFnRUvwrBhYF73KA (small blind) folded before Flop
Seat 4: RowCSpSURHTOL/dcjg/Iug (big blind) showed [8c Ad] and won ($64.60) with two pair, Aces and Eights
Seat 5: rplyldNweS6YyMNEALQrug showed [Qh Ks] and lost with high card Ace
Seat 6: GUnvMULl2qFOO1yenu1UBw folded before Flop (didn't bet)



PokerStars Game #59940872660:  Hold'em No Limit ($0.25/$0.50) - 2009/07/01 1:19:04 ET
Table 'otvGDROEDdqsabxskT79qg' 9-max Seat #8 is the button
Seat 1: 8ehL7qlZzjgUh2H35iiWLw ($59.75 in chips)
Seat 2: cCjTzH9jio8607WzjcfXlg ($14.40 in chips)
Seat 3: +k7T5ocke8UwavtgUHm+Cg ($74.50 in chips)
Seat 4: MG90wfSJZnOejs/KD3vlQQ ($79.05 in chips)
Seat 5: E2518gp4aFz1+kAgmGqeEg ($12.20 in chips)
Seat 6: bxLSulbgr8LmKNjOzw8URg ($55.25 in chips)
Seat 7: 75K2MXwN65Sjfp1yHd50Hg ($13.75 in chips)
Seat 8: zE9cVigS2nW/Ljy4K4bUQA ($30 in chips)
Seat 9: KcY3X8YpD74Kw1RHkx/g4A ($34.40 in chips)
KcY3X8YpD74Kw1RHkx/g4A: posts small blind $0.25
8ehL7qlZzjgUh2H35iiWLw: posts big blind $0.50
*** HOLE CARDS ***
cCjTzH9jio8607WzjcfXlg: calls $0.50
+k7T5ocke8UwavtgUHm+Cg: folds
MG90wfSJZnOejs/KD3vlQQ: folds
E2518gp4aFz1+kAgmGqeEg: folds
bxLSulbgr8LmKNjOzw8URg: folds
75K2MXwN65Sjfp1yHd50Hg: folds
zE9cVigS2nW/Ljy4K4bUQA: raises $1.50 to $2
KcY3X8YpD74Kw1RHkx/g4A: folds
8ehL7qlZzjgUh2H35iiWLw: folds
cCjTzH9jio8607WzjcfXlg: calls $1.50
*** FLOP *** [5s 3h Ts]
cCjTzH9jio8607WzjcfXlg: checks
zE9cVigS2nW/Ljy4K4bUQA: bets $3
cCjTzH9jio8607WzjcfXlg: folds
zE9cVigS2nW/Ljy4K4bUQA collected $4.55 from pot
zE9cVigS2nW/Ljy4K4bUQA: doesn't show hand
*** SUMMARY ***
Total pot $4.75 | Rake $0.20
Board [5s 3h Ts]
Seat 1: 8ehL7qlZzjgUh2H35iiWLw (big blind) folded before Flop
Seat 2: cCjTzH9jio8607WzjcfXlg folded on the Flop
Seat 3: +k7T5ocke8UwavtgUHm+Cg folded before Flop (didn't bet)
Seat 4: MG90wfSJZnOejs/KD3vlQQ folded before Flop (didn't bet)
Seat 5: E2518gp4aFz1+kAgmGqeEg folded before Flop (didn't bet)
Seat 6: bxLSulbgr8LmKNjOzw8URg folded before Flop (didn't bet)
Seat 7: 75K2MXwN65Sjfp1yHd50Hg folded before Flop (didn't bet)
Seat 8: zE9cVigS2nW/Ljy4K4bUQA (button) collected ($4.55)
Seat 9: KcY3X8YpD74Kw1RHkx/g4A (small blind) folded before Flop



PokerStars Game #59940873256:  Hold'em No Limit ($0.25/$0.50) - 2009/07/01 1:19:05 ET
Table '+dXkOAQyS8j9PQZusUTMpg' 2-max Seat #1 is the button
Seat 1: Teld4PDKla7C8/Wfu2DSkg ($51.60 in chips)
Seat 2: +zI4bP23YIjMkUHqeN2xfw ($28.15 in chips)
Teld4PDKla7C8/Wfu2DSkg: posts small blind $0.25
+zI4bP23YIjMkUHqeN2xfw: posts big blind $0.50
*** HOLE CARDS ***
Teld4PDKla7C8/Wfu2DSkg: folds
+zI4bP23YIjMkUHqeN2xfw collected $0.50 from pot
*** SUMMARY ***
Total pot $0.50 | Rake $0
Seat 1: Teld4PDKla7C8/Wfu2DSkg (button) (small blind) folded before Flop
Seat 2: +zI4bP23YIjMkUHqeN2xfw (big blind) collected ($0.50)



PokerStars Game #59940874176:  Hold'em No Limit ($0.25/$0.50) - 2009/07/01 1:19:07 ET
Table '8BQGgNetI1NOvWeu3gtMNw' 2-max Seat #2 is the button
Seat 1: bypIyrYcAAifLfhZpGlKLA ($68.15 in chips)
Seat 2: Z4HwehErEwzsv/noQlfUlg ($123.65 in chips)
Z4HwehErEwzsv/noQlfUlg: posts small blind $0.25
bypIyrYcAAifLfhZpGlKLA: posts big blind $0.50
*** HOLE CARDS ***
Z4HwehErEwzsv/noQlfUlg: raises $1 to $1.50
bypIyrYcAAifLfhZpGlKLA: calls $1
*** FLOP *** [7h Ks Kd]
bypIyrYcAAifLfhZpGlKLA: checks
Z4HwehErEwzsv/noQlfUlg: bets $1.50
bypIyrYcAAifLfhZpGlKLA: calls $1.50
*** TURN *** [7h Ks Kd] [5d]
bypIyrYcAAifLfhZpGlKLA: bets $3
Z4HwehErEwzsv/noQlfUlg: calls $3
*** RIVER *** [7h Ks Kd 5d] [Js]
bypIyrYcAAifLfhZpGlKLA: checks
Z4HwehErEwzsv/noQlfUlg: checks
*** SHOW DOWN ***
bypIyrYcAAifLfhZpGlKLA: shows [8s 7s] (two pair, Kings and Sevens)
Z4HwehErEwzsv/noQlfUlg: shows [8c 8h] (two pair, Kings and Eights)
Z4HwehErEwzsv/noQlfUlg collected $11.50 from pot
*** SUMMARY ***
Total pot $12 | Rake $0.50
Board [7h Ks Kd 5d Js]
Seat 1: bypIyrYcAAifLfhZpGlKLA (big blind) showed [8s 7s] and lost with two pair, Kings and Sevens
Seat 2: Z4HwehErEwzsv/noQlfUlg (button) (small blind) showed [8c 8h] and won ($11.50) with two pair, Kings and Eights



PokerStars Game #59940874458:  Hold'em No Limit ($0.25/$0.50) - 2009/07/01 1:19:07 ET
Table '5EmHi+fnatGQQShcNmzOZQ' 6-max Seat #5 is the button
Seat 2: bfFjgAtIoAI+pUxUwFt3aQ ($37.70 in chips)
Seat 4: 1b+2BbjMN8qhR1WPqdE9VQ ($67.35 in chips)
Seat 5: kxPhs4ePFqMy52CInAJ2aw ($92.35 in chips)
Seat 6: +Pf9jTVizYlIo+woPvptfA ($50.70 in chips)
+Pf9jTVizYlIo+woPvptfA: posts small blind $0.25
bfFjgAtIoAI+pUxUwFt3aQ: posts big blind $0.50
*** HOLE CARDS ***
1b+2BbjMN8qhR1WPqdE9VQ: raises $1 to $1.50
kxPhs4ePFqMy52CInAJ2aw: folds
+Pf9jTVizYlIo+woPvptfA: folds
bfFjgAtIoAI+pUxUwFt3aQ: folds
1b+2BbjMN8qhR1WPqdE9VQ collected $1.25 from pot
1b+2BbjMN8qhR1WPqdE9VQ: doesn't show hand
*** SUMMARY ***
Total pot $1.25 | Rake $0
Seat 2: bfFjgAtIoAI+pUxUwFt3aQ (big blind) folded before Flop
Seat 4: 1b+2BbjMN8qhR1WPqdE9VQ collected ($1.25)
Seat 5: kxPhs4ePFqMy52CInAJ2aw (button) folded before Flop (didn't bet)
Seat 6: +Pf9jTVizYlIo+woPvptfA (small blind) folded before Flop



PokerStars Game #59940875936:  Hold'em No Limit ($0.25/$0.50) - 2009/07/01 1:19:10 ET
Table 'c/CRn+68J3Y8KxD5g1ek2Q' 2-max Seat #1 is the button
Seat 1: 46qCyJ6evTkHo9al5sBMNA ($102.60 in chips)
Seat 2: BypVLsYQt3ePFm2xQL/dOA ($259.45 in chips)
46qCyJ6evTkHo9al5sBMNA: posts small blind $0.25
BypVLsYQt3ePFm2xQL/dOA: posts big blind $0.50
*** HOLE CARDS ***
46qCyJ6evTkHo9al5sBMNA: raises $1.50 to $2
BypVLsYQt3ePFm2xQL/dOA: calls $1.50
*** FLOP *** [7d Jc 3d]
BypVLsYQt3ePFm2xQL/dOA: checks
46qCyJ6evTkHo9al5sBMNA: bets $3
BypVLsYQt3ePFm2xQL/dOA: calls $3
*** TURN *** [7d Jc 3d] [9h]
BypVLsYQt3ePFm2xQL/dOA: checks
46qCyJ6evTkHo9al5sBMNA: bets $7
BypVLsYQt3ePFm2xQL/dOA: calls $7
*** RIVER *** [7d Jc 3d 9h] [2h]
BypVLsYQt3ePFm2xQL/dOA: checks
46qCyJ6evTkHo9al5sBMNA: bets $14.50
BypVLsYQt3ePFm2xQL/dOA: folds
46qCyJ6evTkHo9al5sBMNA collected $23.50 from pot
46qCyJ6evTkHo9al5sBMNA: doesn't show hand
*** SUMMARY ***
Total pot $24 | Rake $0.50
Board [7d Jc 3d 9h 2h]
Seat 1: 46qCyJ6evTkHo9al5sBMNA (button) (small blind) collected ($23.50)
Seat 2: BypVLsYQt3ePFm2xQL/dOA (big blind) folded on the River



PokerStars Game #59940876772:  Hold'em No Limit ($0.25/$0.50) - 2009/07/01 1:19:11 ET
Table '+dXkOAQyS8j9PQZusUTMpg' 2-max Seat #2 is the button
Seat 1: Teld4PDKla7C8/Wfu2DSkg ($51.35 in chips)
Seat 2: +zI4bP23YIjMkUHqeN2xfw ($28.40 in chips)
+zI4bP23YIjMkUHqeN2xfw: posts small blind $0.25
Teld4PDKla7C8/Wfu2DSkg: posts big blind $0.50
*** HOLE CARDS ***
+zI4bP23YIjMkUHqeN2xfw: raises $0.50 to $1
Teld4PDKla7C8/Wfu2DSkg: raises $1 to $2
+zI4bP23YIjMkUHqeN2xfw: calls $1
*** FLOP *** [Jc 7s 5d]
Teld4PDKla7C8/Wfu2DSkg: bets $2
+zI4bP23YIjMkUHqeN2xfw: folds
Teld4PDKla7C8/Wfu2DSkg collected $3.80 from pot
Teld4PDKla7C8/Wfu2DSkg: doesn't show hand
*** SUMMARY ***
Total pot $4 | Rake $0.20
Board [Jc 7s 5d]
Seat 1: Teld4PDKla7C8/Wfu2DSkg (big blind) collected ($3.80)
Seat 2: +zI4bP23YIjMkUHqeN2xfw (button) (small blind) folded on the Flop



PokerStars Game #59940878416:  Hold'em No Limit ($0.25/$0.50) - 2009/07/01 1:19:14 ET
Table 'fx6MqwfYAj/Rt86hBz2L3Q' 9-max Seat #7 is the button
Seat 1: v/4aX0ejnaIFK4ftDk2Lyg ($49.50 in chips)
Seat 2: C3rGXblctNcWI6JYPHhaEg ($36 in chips)
Seat 3: iadBi5AEt7gTBXbDSSnMYQ ($55.15 in chips)
Seat 5: iAISe3dVeua8PUn2wwgDHw ($65.15 in chips)
Seat 6: 5k9fvXD9suIgCxU4HLQjTw ($50 in chips)
Seat 7: SKnJuWHScqetA/qG5p+wCg ($33.95 in chips)
Seat 8: JYwJYYV9pM5KWdSiETl8rA ($29.50 in chips)
Seat 9: vO3QVRovWemcGMkm7ijAIA ($13 in chips)
JYwJYYV9pM5KWdSiETl8rA: posts small blind $0.25
vO3QVRovWemcGMkm7ijAIA: posts big blind $0.50
*** HOLE CARDS ***
v/4aX0ejnaIFK4ftDk2Lyg: folds
C3rGXblctNcWI6JYPHhaEg: calls $0.50
iadBi5AEt7gTBXbDSSnMYQ: folds
iAISe3dVeua8PUn2wwgDHw: folds
5k9fvXD9suIgCxU4HLQjTw: folds
SKnJuWHScqetA/qG5p+wCg: folds
JYwJYYV9pM5KWdSiETl8rA: folds
vO3QVRovWemcGMkm7ijAIA: checks
*** FLOP *** [Td 7c Kh]
vO3QVRovWemcGMkm7ijAIA: checks
C3rGXblctNcWI6JYPHhaEg: bets $0.50
vO3QVRovWemcGMkm7ijAIA: folds
C3rGXblctNcWI6JYPHhaEg collected $1.20 from pot
*** SUMMARY ***
Total pot $1.25 | Rake $0.05
Board [Td 7c Kh]
Seat 1: v/4aX0ejnaIFK4ftDk2Lyg folded before Flop (didn't bet)
Seat 2: C3rGXblctNcWI6JYPHhaEg collected ($1.20)
Seat 3: iadBi5AEt7gTBXbDSSnMYQ folded before Flop (didn't bet)
Seat 5: iAISe3dVeua8PUn2wwgDHw folded before Flop (didn't bet)
Seat 6: 5k9fvXD9suIgCxU4HLQjTw folded before Flop (didn't bet)
Seat 7: SKnJuWHScqetA/qG5p+wCg (button) folded before Flop (didn't bet)
Seat 8: JYwJYYV9pM5KWdSiETl8rA (small blind) folded before Flop
Seat 9: vO3QVRovWemcGMkm7ijAIA (big blind) folded on the Flop



PokerStars Game #59940878802:  Hold'em No Limit ($0.25/$0.50) - 2009/07/01 1:19:15 ET
Table 'NCiXr0d5CEKBQr/cZgLhbA' 9-max Seat #2 is the button
Seat 1: pFtzb1sR4b0d1aw6aIRgDg ($50 in chips)
Seat 2: AjV5McH1KMMclY26QdLM5w ($25 in chips)
Seat 3: xZCXQSXlrZkp3pZizzVXCw ($53.30 in chips)
Seat 4: 5k9fvXD9suIgCxU4HLQjTw ($54.70 in chips)
Seat 7: M+7+BTmX5vZatHVuoRB1nA ($40.90 in chips)
Seat 8: 1MJUKc3cc0QmUoz1JZLR2w ($63.95 in chips)
Seat 9: 4WLZvqBn5qv5tds5kt5A1Q ($55.25 in chips)
xZCXQSXlrZkp3pZizzVXCw: posts small blind $0.25
5k9fvXD9suIgCxU4HLQjTw: posts big blind $0.50
Ja2jdidjip2UeJnRzmzAAQ: sits out
cards4hire: sits out
*** HOLE CARDS ***
M+7+BTmX5vZatHVuoRB1nA: folds
1MJUKc3cc0QmUoz1JZLR2w: folds
4WLZvqBn5qv5tds5kt5A1Q: folds
pFtzb1sR4b0d1aw6aIRgDg: raises $2 to $2.50
AjV5McH1KMMclY26QdLM5w: calls $2.50
xZCXQSXlrZkp3pZizzVXCw: folds
5k9fvXD9suIgCxU4HLQjTw: folds
*** FLOP *** [3h 2s 6d]
pFtzb1sR4b0d1aw6aIRgDg: bets $3
AjV5McH1KMMclY26QdLM5w: calls $3
*** TURN *** [3h 2s 6d] [8h]
pFtzb1sR4b0d1aw6aIRgDg: bets $6
AjV5McH1KMMclY26QdLM5w: folds
pFtzb1sR4b0d1aw6aIRgDg collected $11.20 from pot
*** SUMMARY ***
Total pot $11.75 | Rake $0.55
Board [3h 2s 6d 8h]
Seat 1: pFtzb1sR4b0d1aw6aIRgDg collected ($11.20)
Seat 2: AjV5McH1KMMclY26QdLM5w (button) folded on the Turn
Seat 3: xZCXQSXlrZkp3pZizzVXCw (small blind) folded before Flop
Seat 4: 5k9fvXD9suIgCxU4HLQjTw (big blind) folded before Flop
Seat 7: M+7+BTmX5vZatHVuoRB1nA folded before Flop (didn't bet)
Seat 8: 1MJUKc3cc0QmUoz1JZLR2w folded before Flop (didn't bet)
Seat 9: 4WLZvqBn5qv5tds5kt5A1Q folded before Flop (didn't bet)



PokerStars Game #59940880526:  Hold'em No Limit ($0.25/$0.50) - 2009/07/01 1:19:18 ET
Table 'MJxeZCzYELxiIsyUZyT0jw' 6-max Seat #6 is the button
Seat 1: +Pf9jTVizYlIo+woPvptfA ($50 in chips)
Seat 2: t3GiVMzqA9Svgr5Uol32cQ ($35.05 in chips)
Seat 3: sIG4mp8tZEI+W4nKZNkkQA ($51.85 in chips)
Seat 4: alGiiQP/wwtYnfuXII+sgw ($58.60 in chips)
Seat 5: 3jvoOXNtXE90w2BdfNZwZQ ($59.45 in chips)
Seat 6: c0n4hrn20AML9qzyFC2E8Q ($48.30 in chips)
+Pf9jTVizYlIo+woPvptfA: posts small blind $0.25
t3GiVMzqA9Svgr5Uol32cQ: posts big blind $0.50
*** HOLE CARDS ***
sIG4mp8tZEI+W4nKZNkkQA: folds
alGiiQP/wwtYnfuXII+sgw: raises $0.50 to $1
3jvoOXNtXE90w2BdfNZwZQ: folds
c0n4hrn20AML9qzyFC2E8Q: folds
+Pf9jTVizYlIo+woPvptfA: folds
t3GiVMzqA9Svgr5Uol32cQ: calls $0.50
*** FLOP *** [Jh Th 4h]
t3GiVMzqA9Svgr5Uol32cQ: checks
alGiiQP/wwtYnfuXII+sgw: checks
*** TURN *** [Jh Th 4h] [6d]
t3GiVMzqA9Svgr5Uol32cQ: checks
alGiiQP/wwtYnfuXII+sgw: checks
*** RIVER *** [Jh Th 4h 6d] [3d]
t3GiVMzqA9Svgr5Uol32cQ: checks
alGiiQP/wwtYnfuXII+sgw: checks
*** SHOW DOWN ***
t3GiVMzqA9Svgr5Uol32cQ: shows [6s 9c] (a pair of Sixes)
alGiiQP/wwtYnfuXII+sgw: mucks hand
t3GiVMzqA9Svgr5Uol32cQ collected $2.15 from pot
*** SUMMARY ***
Total pot $2.25 | Rake $0.10
Board [Jh Th 4h 6d 3d]
Seat 1: +Pf9jTVizYlIo+woPvptfA (small blind) folded before Flop
Seat 2: t3GiVMzqA9Svgr5Uol32cQ (big blind) showed [6s 9c] and won ($2.15) with a pair of Sixes
Seat 3: sIG4mp8tZEI+W4nKZNkkQA folded before Flop (didn't bet)
Seat 4: alGiiQP/wwtYnfuXII+sgw mucked
Seat 5: 3jvoOXNtXE90w2BdfNZwZQ folded before Flop (didn't bet)
Seat 6: c0n4hrn20AML9qzyFC2E8Q (button) folded before Flop (didn't bet)



PokerStars Game #59940881414:  Hold'em No Limit ($0.25/$0.50) - 2009/07/01 1:19:19 ET
Table 'Nz0Vr7WMHL2g5Uk7dDZjpw' 9-max Seat #5 is the button
Seat 2: gsyXT42WLEcOS4DdEk2wlw ($37.20 in chips)
Seat 3: hoglu9inkgs6zN573/bJag ($4.85 in chips)
Seat 4: E2518gp4aFz1+kAgmGqeEg ($13 in chips)
Seat 5: WGW0DgjBUXs1ylURHG8vnQ ($16 in chips)
Seat 6: 997ViqAtWn1FPjJqcffwcA ($58.55 in chips)
Seat 7: KPLH0gELgFe2OuAnhJFI5w ($24.45 in chips)
Seat 8: aoL+R/61Kxmw69ypuPrWAQ ($27.75 in chips)
Seat 9: mSD1pginDsyHG5PDfqzphw ($10 in chips)
997ViqAtWn1FPjJqcffwcA: posts small blind $0.25
KPLH0gELgFe2OuAnhJFI5w: posts big blind $0.50
*** HOLE CARDS ***
aoL+R/61Kxmw69ypuPrWAQ: folds
mSD1pginDsyHG5PDfqzphw: folds
gsyXT42WLEcOS4DdEk2wlw: folds
hoglu9inkgs6zN573/bJag: calls $0.50
E2518gp4aFz1+kAgmGqeEg: folds
WGW0DgjBUXs1ylURHG8vnQ: calls $0.50
997ViqAtWn1FPjJqcffwcA: calls $0.25
KPLH0gELgFe2OuAnhJFI5w: checks
*** FLOP *** [Ah 7d 8d]
997ViqAtWn1FPjJqcffwcA: checks
KPLH0gELgFe2OuAnhJFI5w: checks
hoglu9inkgs6zN573/bJag: bets $1
WGW0DgjBUXs1ylURHG8vnQ: calls $1
997ViqAtWn1FPjJqcffwcA: folds
KPLH0gELgFe2OuAnhJFI5w: folds
*** TURN *** [Ah 7d 8d] [2s]
hoglu9inkgs6zN573/bJag: bets $3.35 and is all-in
WGW0DgjBUXs1ylURHG8vnQ: folds
hoglu9inkgs6zN573/bJag collected $3.85 from pot
*** SUMMARY ***
Total pot $4 | Rake $0.15
Board [Ah 7d 8d 2s]
Seat 2: gsyXT42WLEcOS4DdEk2wlw folded before Flop (didn't bet)
Seat 3: hoglu9inkgs6zN573/bJag collected ($3.85)
Seat 4: E2518gp4aFz1+kAgmGqeEg folded before Flop (didn't bet)
Seat 5: WGW0DgjBUXs1ylURHG8vnQ (button) folded on the Turn
Seat 6: 997ViqAtWn1FPjJqcffwcA (small blind) folded on the Flop
Seat 7: KPLH0gELgFe2OuAnhJFI5w (big blind) folded on the Flop
Seat 8: aoL+R/61Kxmw69ypuPrWAQ folded before Flop (didn't bet)
Seat 9: mSD1pginDsyHG5PDfqzphw folded before Flop (didn't bet)



PokerStars Game #59940881652:  Hold'em No Limit ($0.25/$0.50) - 2009/07/01 1:19:20 ET
Table '5EmHi+fnatGQQShcNmzOZQ' 6-max Seat #6 is the button
Seat 2: bfFjgAtIoAI+pUxUwFt3aQ ($37.20 in chips)
Seat 4: 1b+2BbjMN8qhR1WPqdE9VQ ($68.10 in chips)
Seat 5: kxPhs4ePFqMy52CInAJ2aw ($92.35 in chips)
Seat 6: +Pf9jTVizYlIo+woPvptfA ($50.45 in chips)
bfFjgAtIoAI+pUxUwFt3aQ: posts small blind $0.25
1b+2BbjMN8qhR1WPqdE9VQ: posts big blind $0.50
*** HOLE CARDS ***
kxPhs4ePFqMy52CInAJ2aw: folds
1mYbhL8CU/QYqfVmFcaHDQ leaves the table
+Pf9jTVizYlIo+woPvptfA: folds
bfFjgAtIoAI+pUxUwFt3aQ: folds
1b+2BbjMN8qhR1WPqdE9VQ collected $0.50 from pot
1b+2BbjMN8qhR1WPqdE9VQ: doesn't show hand
*** SUMMARY ***
Total pot $0.50 | Rake $0
Seat 2: bfFjgAtIoAI+pUxUwFt3aQ (small blind) folded before Flop
Seat 4: 1b+2BbjMN8qhR1WPqdE9VQ (big blind) collected ($0.50)
Seat 5: kxPhs4ePFqMy52CInAJ2aw folded before Flop (didn't bet)
Seat 6: +Pf9jTVizYlIo+woPvptfA (button) folded before Flop (didn't bet)



PokerStars Game #59940882428:  Hold'em No Limit ($0.25/$0.50) - 2009/07/01 1:19:21 ET
Table 'EiNh8p/wGJ1FP575iMFnqg' 9-max Seat #4 is the button
Seat 1: bmRtaIYKthN1F+B3JLZ3Jw ($20 in chips)
Seat 2: 8ehL7qlZzjgUh2H35iiWLw ($58.90 in chips)
Seat 3: ymLPoEIl7UL3TvZYmnadxQ ($54.05 in chips)
Seat 4: cMzaiXAM/ZAdNaEUu+LqhA ($50.20 in chips)
Seat 5: M+7+BTmX5vZatHVuoRB1nA ($79.95 in chips)
Seat 6: viwBDtJsY6JfsFOdBAyJIQ ($10.70 in chips)
Seat 7: 997ViqAtWn1FPjJqcffwcA ($50 in chips)
M+7+BTmX5vZatHVuoRB1nA: posts small blind $0.25
viwBDtJsY6JfsFOdBAyJIQ: posts big blind $0.50
bmRtaIYKthN1F+B3JLZ3Jw: posts big blind $0.50
*** HOLE CARDS ***
GuPkZObrz5Zkkn8FsEdF9w has returned
997ViqAtWn1FPjJqcffwcA: folds
mSD1pginDsyHG5PDfqzphw has returned
bmRtaIYKthN1F+B3JLZ3Jw: checks
8ehL7qlZzjgUh2H35iiWLw: folds
ymLPoEIl7UL3TvZYmnadxQ: raises $0.50 to $1
cMzaiXAM/ZAdNaEUu+LqhA: calls $1
M+7+BTmX5vZatHVuoRB1nA: folds
viwBDtJsY6JfsFOdBAyJIQ: calls $0.50
bmRtaIYKthN1F+B3JLZ3Jw: folds
*** FLOP *** [8c 6d Qh]
viwBDtJsY6JfsFOdBAyJIQ: checks
ymLPoEIl7UL3TvZYmnadxQ: bets $3
cMzaiXAM/ZAdNaEUu+LqhA: folds
viwBDtJsY6JfsFOdBAyJIQ: folds
ymLPoEIl7UL3TvZYmnadxQ collected $3.60 from pot
ymLPoEIl7UL3TvZYmnadxQ: doesn't show hand
*** SUMMARY ***
Total pot $3.75 | Rake $0.15
Board [8c 6d Qh]
Seat 1: bmRtaIYKthN1F+B3JLZ3Jw folded before Flop
Seat 2: 8ehL7qlZzjgUh2H35iiWLw folded before Flop (didn't bet)
Seat 3: ymLPoEIl7UL3TvZYmnadxQ collected ($3.60)
Seat 4: cMzaiXAM/ZAdNaEUu+LqhA (button) folded on the Flop
Seat 5: M+7+BTmX5vZatHVuoRB1nA (small blind) folded before Flop
Seat 6: viwBDtJsY6JfsFOdBAyJIQ (big blind) folded on the Flop
Seat 7: 997ViqAtWn1FPjJqcffwcA folded before Flop (didn't bet)



PokerStars Game #59940882856:  Hold'em No Limit ($0.25/$0.50) - 2009/07/01 1:19:22 ET
Table 'ofnd8S4IdIPph1Cbn+x7hA' 2-max Seat #2 is the button
Seat 1: PY4NvRocCFPfSIHKbh0euQ ($29.85 in chips)
Seat 2: l5WbyJ/iWYjpeCC6GCYY6w ($65 in chips)
l5WbyJ/iWYjpeCC6GCYY6w: posts small blind $0.25
PY4NvRocCFPfSIHKbh0euQ: posts big blind $0.50
*** HOLE CARDS ***
l5WbyJ/iWYjpeCC6GCYY6w: raises $1 to $1.50
PY4NvRocCFPfSIHKbh0euQ: calls $1
*** FLOP *** [4d 4c 4h]
PY4NvRocCFPfSIHKbh0euQ: checks
l5WbyJ/iWYjpeCC6GCYY6w: bets $1.50
PY4NvRocCFPfSIHKbh0euQ: calls $1.50
*** TURN *** [4d 4c 4h] [8d]
PY4NvRocCFPfSIHKbh0euQ: checks
l5WbyJ/iWYjpeCC6GCYY6w: checks
*** RIVER *** [4d 4c 4h 8d] [2s]
PY4NvRocCFPfSIHKbh0euQ: checks
l5WbyJ/iWYjpeCC6GCYY6w: checks
*** SHOW DOWN ***
PY4NvRocCFPfSIHKbh0euQ: shows [Ks Jd] (three of a kind, Fours)
l5WbyJ/iWYjpeCC6GCYY6w: shows [Ac Qc] (three of a kind, Fours - Ace kicker)
l5WbyJ/iWYjpeCC6GCYY6w collected $5.75 from pot
*** SUMMARY ***
Total pot $6 | Rake $0.25
Board [4d 4c 4h 8d 2s]
Seat 1: PY4NvRocCFPfSIHKbh0euQ (big blind) showed [Ks Jd] and lost with three of a kind, Fours
Seat 2: l5WbyJ/iWYjpeCC6GCYY6w (button) (small blind) showed [Ac Qc] and won ($5.75) with three of a kind, Fours



PokerStars Game #59940883108:  Hold'em No Limit ($0.25/$0.50) - 2009/07/01 1:19:22 ET
Table 'BCN5su+SsXiy1zRMJi0SJw' 6-max Seat #5 is the button
Seat 1: GxXV09ciXaOxyY2H5aMIIw ($54.60 in chips)
Seat 2: ehFNAevCQri3trWxV6FJdA ($29.50 in chips)
Seat 3: kwgv5lNhiFrfONXCshzxlA ($46.45 in chips)
Seat 5: cEMJmfAUQZmMChZe6aacKw ($46.05 in chips)
Seat 6: b2symlOdL7+0c9Pj4N/KlA ($55.65 in chips)
b2symlOdL7+0c9Pj4N/KlA: posts small blind $0.25
GxXV09ciXaOxyY2H5aMIIw: posts big blind $0.50
*** HOLE CARDS ***
ehFNAevCQri3trWxV6FJdA: folds
kwgv5lNhiFrfONXCshzxlA: folds
cEMJmfAUQZmMChZe6aacKw: folds
b2symlOdL7+0c9Pj4N/KlA: raises $1.50 to $2
GxXV09ciXaOxyY2H5aMIIw: folds
b2symlOdL7+0c9Pj4N/KlA collected $1 from pot
b2symlOdL7+0c9Pj4N/KlA: doesn't show hand
*** SUMMARY ***
Total pot $1 | Rake $0
Seat 1: GxXV09ciXaOxyY2H5aMIIw (big blind) folded before Flop
Seat 2: ehFNAevCQri3trWxV6FJdA folded before Flop (didn't bet)
Seat 3: kwgv5lNhiFrfONXCshzxlA folded before Flop (didn't bet)
Seat 5: cEMJmfAUQZmMChZe6aacKw (button) folded before Flop (didn't bet)
Seat 6: b2symlOdL7+0c9Pj4N/KlA (small blind) collected ($1)



PokerStars Game #59940884686:  Hold'em No Limit ($0.25/$0.50) - 2009/07/01 1:19:25 ET
Table 'X6IRCRTh+20gjz8aubWnwA' 9-max Seat #8 is the button
Seat 1: E2518gp4aFz1+kAgmGqeEg ($11 in chips)
Seat 2: HZkVla4kK2SI42CVrPZ/ig ($10 in chips)
Seat 3: SWv01peOe69QQRvhQTqjQw ($6 in chips)
Seat 4: M3JFBNQ8Bbw3FBZ/18MuXw ($26.65 in chips)
Seat 5: NnQCepdIR/AOUQn1yhYx6Q ($14.45 in chips)
Seat 6: 75K2MXwN65Sjfp1yHd50Hg ($12.15 in chips)
Seat 7: cFHQjKQOOKTUzoilhrXHLg ($11.75 in chips)
Seat 8: HxeBVq06/3Bh/H986sgdbw ($48.50 in chips)
Seat 9: M+7+BTmX5vZatHVuoRB1nA ($45.05 in chips)
M+7+BTmX5vZatHVuoRB1nA: posts small blind $0.25
E2518gp4aFz1+kAgmGqeEg: posts big blind $0.50
*** HOLE CARDS ***
HZkVla4kK2SI42CVrPZ/ig: calls $0.50
SWv01peOe69QQRvhQTqjQw: raises $1 to $1.50
M3JFBNQ8Bbw3FBZ/18MuXw: folds
NnQCepdIR/AOUQn1yhYx6Q: folds
75K2MXwN65Sjfp1yHd50Hg: folds
cFHQjKQOOKTUzoilhrXHLg: folds
HxeBVq06/3Bh/H986sgdbw: folds
M+7+BTmX5vZatHVuoRB1nA: folds
E2518gp4aFz1+kAgmGqeEg: folds
HZkVla4kK2SI42CVrPZ/ig: calls $1
*** FLOP *** [Ah Th Jd]
HZkVla4kK2SI42CVrPZ/ig: checks
SWv01peOe69QQRvhQTqjQw: bets $1.50
HZkVla4kK2SI42CVrPZ/ig: raises $2.50 to $4
SWv01peOe69QQRvhQTqjQw: raises $0.50 to $4.50 and is all-in
HZkVla4kK2SI42CVrPZ/ig: calls $0.50
*** TURN *** [Ah Th Jd] [Jh]
*** RIVER *** [Ah Th Jd Jh] [Kd]
*** SHOW DOWN ***
HZkVla4kK2SI42CVrPZ/ig: shows [Jc Ac] (a full house, Jacks full of Aces)
SWv01peOe69QQRvhQTqjQw: shows [Kh Kc] (a full house, Kings full of Jacks)
SWv01peOe69QQRvhQTqjQw collected $12.15 from pot
*** SUMMARY ***
Total pot $12.75 | Rake $0.60
Board [Ah Th Jd Jh Kd]
Seat 1: E2518gp4aFz1+kAgmGqeEg (big blind) folded before Flop
Seat 2: HZkVla4kK2SI42CVrPZ/ig showed [Jc Ac] and lost with a full house, Jacks full of Aces
Seat 3: SWv01peOe69QQRvhQTqjQw showed [Kh Kc] and won ($12.15) with a full house, Kings full of Jacks
Seat 4: M3JFBNQ8Bbw3FBZ/18MuXw folded before Flop (didn't bet)
Seat 5: NnQCepdIR/AOUQn1yhYx6Q folded before Flop (didn't bet)
Seat 6: 75K2MXwN65Sjfp1yHd50Hg folded before Flop (didn't bet)
Seat 7: cFHQjKQOOKTUzoilhrXHLg folded before Flop (didn't bet)
Seat 8: HxeBVq06/3Bh/H986sgdbw (button) folded before Flop (didn't bet)
Seat 9: M+7+BTmX5vZatHVuoRB1nA (small blind) folded before Flop



PokerStars Game #59940886588:  Hold'em No Limit ($0.25/$0.50) - 2009/07/01 1:19:28 ET
Table '8BQGgNetI1NOvWeu3gtMNw' 2-max Seat #1 is the button
Seat 1: bypIyrYcAAifLfhZpGlKLA ($62.15 in chips)
Seat 2: Z4HwehErEwzsv/noQlfUlg ($129.15 in chips)
bypIyrYcAAifLfhZpGlKLA: posts small blind $0.25
Z4HwehErEwzsv/noQlfUlg: posts big blind $0.50
*** HOLE CARDS ***
bypIyrYcAAifLfhZpGlKLA: raises $1 to $1.50
Z4HwehErEwzsv/noQlfUlg: folds
bypIyrYcAAifLfhZpGlKLA collected $1 from pot
bypIyrYcAAifLfhZpGlKLA: doesn't show hand
*** SUMMARY ***
Total pot $1 | Rake $0
Seat 1: bypIyrYcAAifLfhZpGlKLA (button) (small blind) collected ($1)
Seat 2: Z4HwehErEwzsv/noQlfUlg (big blind) folded before Flop



PokerStars Game #59940886404:  Hold'em No Limit ($0.25/$0.50) - 2009/07/01 1:19:28 ET
Table 'PALRfuH85dr5IkDfdv6new' 9-max Seat #8 is the button
Seat 1: v/4aX0ejnaIFK4ftDk2Lyg ($48.75 in chips)
Seat 2: 1aXjSbrubyQKHeauooF5Wg ($48.15 in chips)
Seat 3: 50QWoELmpmHFrFIlWMJo9g ($97.15 in chips)
Seat 4: mZNMJI1mY40XTC0U7GZakA ($56.80 in chips)
Seat 6: ottZQkg1UDWk85BtBzGJzg ($45.85 in chips)
Seat 7: 3NcyXvr39gnK+KbTq7ezyA ($53.50 in chips)
Seat 8: NkS+CseUKx4XHszWq0PXEQ ($75.95 in chips)
Seat 9: viwBDtJsY6JfsFOdBAyJIQ ($10.20 in chips)
viwBDtJsY6JfsFOdBAyJIQ: posts small blind $0.25
v/4aX0ejnaIFK4ftDk2Lyg: posts big blind $0.50
XcLXSUMHSpshK/7Lh0M4Vg: sits out
*** HOLE CARDS ***
1aXjSbrubyQKHeauooF5Wg: folds
50QWoELmpmHFrFIlWMJo9g: folds
mZNMJI1mY40XTC0U7GZakA: folds
ottZQkg1UDWk85BtBzGJzg: raises $2.50 to $3
3NcyXvr39gnK+KbTq7ezyA: folds
NkS+CseUKx4XHszWq0PXEQ: folds
viwBDtJsY6JfsFOdBAyJIQ: folds
v/4aX0ejnaIFK4ftDk2Lyg: folds
ottZQkg1UDWk85BtBzGJzg collected $1.25 from pot
*** SUMMARY ***
Total pot $1.25 | Rake $0
Seat 1: v/4aX0ejnaIFK4ftDk2Lyg (big blind) folded before Flop
Seat 2: 1aXjSbrubyQKHeauooF5Wg folded before Flop (didn't bet)
Seat 3: 50QWoELmpmHFrFIlWMJo9g folded before Flop (didn't bet)
Seat 4: mZNMJI1mY40XTC0U7GZakA folded before Flop (didn't bet)
Seat 6: ottZQkg1UDWk85BtBzGJzg collected ($1.25)
Seat 7: 3NcyXvr39gnK+KbTq7ezyA folded before Flop (didn't bet)
Seat 8: NkS+CseUKx4XHszWq0PXEQ (button) folded before Flop (didn't bet)
Seat 9: viwBDtJsY6JfsFOdBAyJIQ (small blind) folded before Flop



PokerStars Game #59940887792:  Hold'em No Limit ($0.25/$0.50) - 2009/07/01 1:19:30 ET
Table '5EmHi+fnatGQQShcNmzOZQ' 6-max Seat #2 is the button
Seat 2: bfFjgAtIoAI+pUxUwFt3aQ ($36.95 in chips)
Seat 4: 1b+2BbjMN8qhR1WPqdE9VQ ($68.35 in chips)
Seat 5: kxPhs4ePFqMy52CInAJ2aw ($92.35 in chips)
Seat 6: +Pf9jTVizYlIo+woPvptfA ($50.45 in chips)
1b+2BbjMN8qhR1WPqdE9VQ: posts small blind $0.25
kxPhs4ePFqMy52CInAJ2aw: posts big blind $0.50
*** HOLE CARDS ***
+Pf9jTVizYlIo+woPvptfA: folds
+Pf9jTVizYlIo+woPvptfA leaves the table
bfFjgAtIoAI+pUxUwFt3aQ: folds
1b+2BbjMN8qhR1WPqdE9VQ: folds
kxPhs4ePFqMy52CInAJ2aw collected $0.50 from pot
kxPhs4ePFqMy52CInAJ2aw: doesn't show hand
*** SUMMARY ***
Total pot $0.50 | Rake $0
Seat 2: bfFjgAtIoAI+pUxUwFt3aQ (button) folded before Flop (didn't bet)
Seat 4: 1b+2BbjMN8qhR1WPqdE9VQ (small blind) folded before Flop
Seat 5: kxPhs4ePFqMy52CInAJ2aw (big blind) collected ($0.50)
Seat 6: +Pf9jTVizYlIo+woPvptfA folded before Flop (didn't bet)



PokerStars Game #59940889138:  Hold'em No Limit ($0.25/$0.50) - 2009/07/01 1:19:33 ET
Table 'ibNfFy0bCzuBaUORla0aGw' 9-max Seat #5 is the button
Seat 1: xZCXQSXlrZkp3pZizzVXCw ($50.55 in chips)
Seat 2: 90Wb75h3W1BRpbqVnuk8gw ($50 in chips)
Seat 3: AjV5McH1KMMclY26QdLM5w ($27.10 in chips)
Seat 4: YBN054X4blmis+B2bBlC0g ($20.40 in chips)
Seat 5: GIJAc9kPrLZHLSX8Q6i99w ($27.30 in chips)
Seat 6: H8cPaCtX7d6meGUVSM5sxw ($56 in chips)
Seat 7: HZkVla4kK2SI42CVrPZ/ig ($13.75 in chips)
Seat 9: pFtzb1sR4b0d1aw6aIRgDg ($55.75 in chips)
H8cPaCtX7d6meGUVSM5sxw: posts small blind $0.25
HZkVla4kK2SI42CVrPZ/ig: posts big blind $0.50
Ja2jdidjip2UeJnRzmzAAQ: sits out
*** HOLE CARDS ***
pFtzb1sR4b0d1aw6aIRgDg: raises $2 to $2.50
xZCXQSXlrZkp3pZizzVXCw: folds
90Wb75h3W1BRpbqVnuk8gw: folds
AjV5McH1KMMclY26QdLM5w: folds
YBN054X4blmis+B2bBlC0g: folds
GIJAc9kPrLZHLSX8Q6i99w: folds
YBN054X4blmis+B2bBlC0g leaves the table
H8cPaCtX7d6meGUVSM5sxw: folds
HZkVla4kK2SI42CVrPZ/ig: folds
pFtzb1sR4b0d1aw6aIRgDg collected $1.25 from pot
pFtzb1sR4b0d1aw6aIRgDg: doesn't show hand
*** SUMMARY ***
Total pot $1.25 | Rake $0
Seat 1: xZCXQSXlrZkp3pZizzVXCw folded before Flop (didn't bet)
Seat 2: 90Wb75h3W1BRpbqVnuk8gw folded before Flop (didn't bet)
Seat 3: AjV5McH1KMMclY26QdLM5w folded before Flop (didn't bet)
Seat 4: YBN054X4blmis+B2bBlC0g folded before Flop (didn't bet)
Seat 5: GIJAc9kPrLZHLSX8Q6i99w (button) folded before Flop (didn't bet)
Seat 6: H8cPaCtX7d6meGUVSM5sxw (small blind) folded before Flop
Seat 7: HZkVla4kK2SI42CVrPZ/ig (big blind) folded before Flop
Seat 9: pFtzb1sR4b0d1aw6aIRgDg collected ($1.25)



PokerStars Game #59940889406:  Hold'em No Limit ($0.25/$0.50) - 2009/07/01 1:19:33 ET
Table '+dXkOAQyS8j9PQZusUTMpg' 2-max Seat #1 is the button
Seat 1: Teld4PDKla7C8/Wfu2DSkg ($53.15 in chips)
Seat 2: +zI4bP23YIjMkUHqeN2xfw ($26.40 in chips)
Teld4PDKla7C8/Wfu2DSkg: posts small blind $0.25
+zI4bP23YIjMkUHqeN2xfw: posts big blind $0.50
*** HOLE CARDS ***
Teld4PDKla7C8/Wfu2DSkg: raises $0.50 to $1
+zI4bP23YIjMkUHqeN2xfw: calls $0.50
*** FLOP *** [7c 5d 8s]
+zI4bP23YIjMkUHqeN2xfw: checks
Teld4PDKla7C8/Wfu2DSkg: checks
*** TURN *** [7c 5d 8s] [Qs]
+zI4bP23YIjMkUHqeN2xfw: checks
Teld4PDKla7C8/Wfu2DSkg: bets $2
+zI4bP23YIjMkUHqeN2xfw: calls $2
*** RIVER *** [7c 5d 8s Qs] [Qd]
+zI4bP23YIjMkUHqeN2xfw: checks
Teld4PDKla7C8/Wfu2DSkg: bets $6.50
+zI4bP23YIjMkUHqeN2xfw: folds
Teld4PDKla7C8/Wfu2DSkg collected $5.75 from pot
Teld4PDKla7C8/Wfu2DSkg: doesn't show hand
*** SUMMARY ***
Total pot $6 | Rake $0.25
Board [7c 5d 8s Qs Qd]
Seat 1: Teld4PDKla7C8/Wfu2DSkg (button) (small blind) collected ($5.75)
Seat 2: +zI4bP23YIjMkUHqeN2xfw (big blind) folded on the River



PokerStars Game #59940890504:  Hold'em No Limit ($0.25/$0.50) - 2009/07/01 1:19:35 ET
Table '8BQGgNetI1NOvWeu3gtMNw' 2-max Seat #2 is the button
Seat 1: bypIyrYcAAifLfhZpGlKLA ($62.65 in chips)
Seat 2: Z4HwehErEwzsv/noQlfUlg ($128.65 in chips)
Z4HwehErEwzsv/noQlfUlg: posts small blind $0.25
bypIyrYcAAifLfhZpGlKLA: posts big blind $0.50
*** HOLE CARDS ***
Z4HwehErEwzsv/noQlfUlg: raises $0.50 to $1
bypIyrYcAAifLfhZpGlKLA: raises $3 to $4
Z4HwehErEwzsv/noQlfUlg: calls $3
*** FLOP *** [Qc Ac Ts]
bypIyrYcAAifLfhZpGlKLA: bets $7.50
Z4HwehErEwzsv/noQlfUlg: folds
bypIyrYcAAifLfhZpGlKLA collected $7.60 from pot
bypIyrYcAAifLfhZpGlKLA: doesn't show hand
*** SUMMARY ***
Total pot $8 | Rake $0.40
Board [Qc Ac Ts]
Seat 1: bypIyrYcAAifLfhZpGlKLA (big blind) collected ($7.60)
Seat 2: Z4HwehErEwzsv/noQlfUlg (button) (small blind) folded on the Flop



PokerStars Game #59940892206:  Hold'em No Limit ($0.25/$0.50) - 2009/07/01 1:19:38 ET
Table 'hSTs/dUsYLgJQuF2Onp0MQ' 6-max Seat #1 is the button
Seat 1: 1WUCqNG+p+vfWRTXNu4ljw ($50 in chips)
Seat 4: 2igtJLmvIZ+HqX4XPgMPZA ($50.50 in chips)
Seat 5: IBNygaT1aa9Z1uPdJJilwA ($65.35 in chips)
Seat 6: M1KyQQvVPVuxqTAB8sR/zQ ($88.20 in chips)
2igtJLmvIZ+HqX4XPgMPZA: posts small blind $0.25
IBNygaT1aa9Z1uPdJJilwA: posts big blind $0.50
*** HOLE CARDS ***
M1KyQQvVPVuxqTAB8sR/zQ: folds
1WUCqNG+p+vfWRTXNu4ljw: folds
C3qJBo7uxfFVDluE1lmK2w leaves the table
2igtJLmvIZ+HqX4XPgMPZA: raises $1 to $1.50
IBNygaT1aa9Z1uPdJJilwA: calls $1
*** FLOP *** [5s 9d Th]
lxIzoHy0RnkfFSODHC2liw joins the table at seat #3
2igtJLmvIZ+HqX4XPgMPZA: bets $2
IBNygaT1aa9Z1uPdJJilwA: calls $2
*** TURN *** [5s 9d Th] [5d]
2igtJLmvIZ+HqX4XPgMPZA: checks
IBNygaT1aa9Z1uPdJJilwA: bets $3
2igtJLmvIZ+HqX4XPgMPZA: calls $3
*** RIVER *** [5s 9d Th 5d] [8d]
2igtJLmvIZ+HqX4XPgMPZA: checks
IBNygaT1aa9Z1uPdJJilwA: checks
*** SHOW DOWN ***
2igtJLmvIZ+HqX4XPgMPZA: shows [Jd Qc] (a straight, Eight to Queen)
IBNygaT1aa9Z1uPdJJilwA: mucks hand
2igtJLmvIZ+HqX4XPgMPZA collected $12.40 from pot
*** SUMMARY ***
Total pot $13 | Rake $0.60
Board [5s 9d Th 5d 8d]
Seat 1: 1WUCqNG+p+vfWRTXNu4ljw (button) folded before Flop (didn't bet)
Seat 4: 2igtJLmvIZ+HqX4XPgMPZA (small blind) showed [Jd Qc] and won ($12.40) with a straight, Eight to Queen
Seat 5: IBNygaT1aa9Z1uPdJJilwA (big blind) mucked
Seat 6: M1KyQQvVPVuxqTAB8sR/zQ folded before Flop (didn't bet)



PokerStars Game #59940892446:  Hold'em No Limit ($0.25/$0.50) - 2009/07/01 1:19:39 ET
Table 'tyR5AZNKV8Aadbrnrnlg7g' 6-max Seat #4 is the button
Seat 1: BgOXYI0yYSN1ULC4FqsNkg ($98.30 in chips)
Seat 2: BAjwVL+zKKd0s0fAWstzQQ ($67.30 in chips)
Seat 3: JFLrYNyQmwPhRQAtoSAuyA ($49.85 in chips)
Seat 4: 4QfsCWthT/vSLirorNXqtg ($72.65 in chips)
Seat 5: GUnvMULl2qFOO1yenu1UBw ($50 in chips)
Seat 6: 498aWaGsW4uGfuWl+2FCGw ($46 in chips)
GUnvMULl2qFOO1yenu1UBw: posts small blind $0.25
498aWaGsW4uGfuWl+2FCGw: posts big blind $0.50
*** HOLE CARDS ***
BgOXYI0yYSN1ULC4FqsNkg: folds
BAjwVL+zKKd0s0fAWstzQQ: calls $0.50
JFLrYNyQmwPhRQAtoSAuyA: folds
4QfsCWthT/vSLirorNXqtg: raises $2 to $2.50
GUnvMULl2qFOO1yenu1UBw: folds
498aWaGsW4uGfuWl+2FCGw: folds
BAjwVL+zKKd0s0fAWstzQQ: calls $2
*** FLOP *** [9d 2s Jh]
BAjwVL+zKKd0s0fAWstzQQ: checks
4QfsCWthT/vSLirorNXqtg: bets $4.25
BAjwVL+zKKd0s0fAWstzQQ: calls $4.25
*** TURN *** [9d 2s Jh] [Qc]
BAjwVL+zKKd0s0fAWstzQQ: checks
4QfsCWthT/vSLirorNXqtg: checks
*** RIVER *** [9d 2s Jh Qc] [4d]
BAjwVL+zKKd0s0fAWstzQQ: checks
4QfsCWthT/vSLirorNXqtg: bets $10.25
BAjwVL+zKKd0s0fAWstzQQ: calls $10.25
*** SHOW DOWN ***
4QfsCWthT/vSLirorNXqtg: shows [6c 9c] (a pair of Nines)
BAjwVL+zKKd0s0fAWstzQQ: mucks hand
4QfsCWthT/vSLirorNXqtg collected $33.05 from pot
*** SUMMARY ***
Total pot $34.75 | Rake $1.70
Board [9d 2s Jh Qc 4d]
Seat 1: BgOXYI0yYSN1ULC4FqsNkg folded before Flop (didn't bet)
Seat 2: BAjwVL+zKKd0s0fAWstzQQ mucked
Seat 3: JFLrYNyQmwPhRQAtoSAuyA folded before Flop (didn't bet)
Seat 4: 4QfsCWthT/vSLirorNXqtg (button) showed [6c 9c] and won ($33.05) with a pair of Nines
Seat 5: GUnvMULl2qFOO1yenu1UBw (small blind) folded before Flop
Seat 6: 498aWaGsW4uGfuWl+2FCGw (big blind) folded before Flop



PokerStars Game #59940893084:  Hold'em No Limit ($0.25/$0.50) - 2009/07/01 1:19:40 ET
Table 'lSisgp6H7Fg1hH5VfjEjYQ' 9-max Seat #1 is the button
Seat 1: 5k9fvXD9suIgCxU4HLQjTw ($50 in chips)
Seat 3: SKnJuWHScqetA/qG5p+wCg ($30 in chips)
Seat 4: bwv/rbH/hHhPhY6u9mu04w ($33.35 in chips)
Seat 5: mSD1pginDsyHG5PDfqzphw ($13 in chips)
Seat 6: +k7T5ocke8UwavtgUHm+Cg ($64.40 in chips)
Seat 7: IDtNLR9uFCDdjNsJWMHA5Q ($22.45 in chips)
Seat 8: a4JDWmpFQkL10XfAyuF51A ($15.50 in chips)
Seat 9: YzeKFbJVLmJGTgNH3ySQlw ($15 in chips)
SKnJuWHScqetA/qG5p+wCg: posts small blind $0.25
bwv/rbH/hHhPhY6u9mu04w: posts big blind $0.50
*** HOLE CARDS ***
mSD1pginDsyHG5PDfqzphw: folds
+k7T5ocke8UwavtgUHm+Cg: folds
IDtNLR9uFCDdjNsJWMHA5Q: folds
a4JDWmpFQkL10XfAyuF51A: folds
YzeKFbJVLmJGTgNH3ySQlw: calls $0.50
5k9fvXD9suIgCxU4HLQjTw: folds
SKnJuWHScqetA/qG5p+wCg: calls $0.25
bwv/rbH/hHhPhY6u9mu04w: checks
*** FLOP *** [Jd 2c 2h]
SKnJuWHScqetA/qG5p+wCg: checks
bwv/rbH/hHhPhY6u9mu04w: bets $0.50
YzeKFbJVLmJGTgNH3ySQlw: folds
SKnJuWHScqetA/qG5p+wCg: folds
bwv/rbH/hHhPhY6u9mu04w collected $1.45 from pot
*** SUMMARY ***
Total pot $1.50 | Rake $0.05
Board [Jd 2c 2h]
Seat 1: 5k9fvXD9suIgCxU4HLQjTw (button) folded before Flop (didn't bet)
Seat 3: SKnJuWHScqetA/qG5p+wCg (small blind) folded on the Flop
Seat 4: bwv/rbH/hHhPhY6u9mu04w (big blind) collected ($1.45)
Seat 5: mSD1pginDsyHG5PDfqzphw folded before Flop (didn't bet)
Seat 6: +k7T5ocke8UwavtgUHm+Cg folded before Flop (didn't bet)
Seat 7: IDtNLR9uFCDdjNsJWMHA5Q folded before Flop (didn't bet)
Seat 8: a4JDWmpFQkL10XfAyuF51A folded before Flop (didn't bet)
Seat 9: YzeKFbJVLmJGTgNH3ySQlw folded on the Flop



PokerStars Game #59940894240:  Hold'em No Limit ($0.25/$0.50) - 2009/07/01 1:19:42 ET
Table 'GfL/No5u5PoEnU39lP5pQg' 6-max Seat #4 is the button
Seat 1: 1WUCqNG+p+vfWRTXNu4ljw ($63 in chips)
Seat 2: uVwggSetzp7d+eVgowO3vg ($54.10 in chips)
Seat 3: 4pp9WxhGdbVbxCc9tlu0lw ($33.05 in chips)
Seat 4: r6u7MWSXF30/khcTYkrG9Q ($21.50 in chips)
Seat 5: M1KyQQvVPVuxqTAB8sR/zQ ($50.25 in chips)
Seat 6: kxPhs4ePFqMy52CInAJ2aw ($63.20 in chips)
M1KyQQvVPVuxqTAB8sR/zQ: posts small blind $0.25
kxPhs4ePFqMy52CInAJ2aw: posts big blind $0.50
*** HOLE CARDS ***
1WUCqNG+p+vfWRTXNu4ljw: folds
uVwggSetzp7d+eVgowO3vg: raises $1.50 to $2
4pp9WxhGdbVbxCc9tlu0lw: folds
r6u7MWSXF30/khcTYkrG9Q: folds
M1KyQQvVPVuxqTAB8sR/zQ: folds
kxPhs4ePFqMy52CInAJ2aw: folds
uVwggSetzp7d+eVgowO3vg collected $1.25 from pot
*** SUMMARY ***
Total pot $1.25 | Rake $0
Seat 1: 1WUCqNG+p+vfWRTXNu4ljw folded before Flop (didn't bet)
Seat 2: uVwggSetzp7d+eVgowO3vg collected ($1.25)
Seat 3: 4pp9WxhGdbVbxCc9tlu0lw folded before Flop (didn't bet)
Seat 4: r6u7MWSXF30/khcTYkrG9Q (button) folded before Flop (didn't bet)
Seat 5: M1KyQQvVPVuxqTAB8sR/zQ (small blind) folded before Flop
Seat 6: kxPhs4ePFqMy52CInAJ2aw (big blind) folded before Flop



PokerStars Game #59940896040:  Hold'em No Limit ($0.25/$0.50) - 2009/07/01 1:19:45 ET
Table 'BCN5su+SsXiy1zRMJi0SJw' 6-max Seat #6 is the button
Seat 1: GxXV09ciXaOxyY2H5aMIIw ($54.10 in chips)
Seat 2: ehFNAevCQri3trWxV6FJdA ($29.50 in chips)
Seat 3: kwgv5lNhiFrfONXCshzxlA ($46.45 in chips)
Seat 5: cEMJmfAUQZmMChZe6aacKw ($46.05 in chips)
Seat 6: b2symlOdL7+0c9Pj4N/KlA ($56.15 in chips)
GxXV09ciXaOxyY2H5aMIIw: posts small blind $0.25
ehFNAevCQri3trWxV6FJdA: posts big blind $0.50
*** HOLE CARDS ***
kwgv5lNhiFrfONXCshzxlA: folds
cEMJmfAUQZmMChZe6aacKw: folds
b2symlOdL7+0c9Pj4N/KlA: raises $1 to $1.50
GxXV09ciXaOxyY2H5aMIIw: folds
ehFNAevCQri3trWxV6FJdA: folds
b2symlOdL7+0c9Pj4N/KlA collected $1.25 from pot
b2symlOdL7+0c9Pj4N/KlA: doesn't show hand
*** SUMMARY ***
Total pot $1.25 | Rake $0
Seat 1: GxXV09ciXaOxyY2H5aMIIw (small blind) folded before Flop
Seat 2: ehFNAevCQri3trWxV6FJdA (big blind) folded before Flop
Seat 3: kwgv5lNhiFrfONXCshzxlA folded before Flop (didn't bet)
Seat 5: cEMJmfAUQZmMChZe6aacKw folded before Flop (didn't bet)
Seat 6: b2symlOdL7+0c9Pj4N/KlA (button) collected ($1.25)



PokerStars Game #59940896932:  Hold'em No Limit ($0.25/$0.50) - 2009/07/01 1:19:46 ET
Table 'ofnd8S4IdIPph1Cbn+x7hA' 2-max Seat #1 is the button
Seat 1: PY4NvRocCFPfSIHKbh0euQ ($26.85 in chips)
Seat 2: l5WbyJ/iWYjpeCC6GCYY6w ($67.75 in chips)
PY4NvRocCFPfSIHKbh0euQ: posts small blind $0.25
l5WbyJ/iWYjpeCC6GCYY6w: posts big blind $0.50
*** HOLE CARDS ***
PY4NvRocCFPfSIHKbh0euQ: calls $0.25
l5WbyJ/iWYjpeCC6GCYY6w: checks
*** FLOP *** [9c 4h 3d]
l5WbyJ/iWYjpeCC6GCYY6w: bets $0.50
PY4NvRocCFPfSIHKbh0euQ: calls $0.50
*** TURN *** [9c 4h 3d] [7d]
l5WbyJ/iWYjpeCC6GCYY6w: checks
PY4NvRocCFPfSIHKbh0euQ: checks
*** RIVER *** [9c 4h 3d 7d] [Jc]
l5WbyJ/iWYjpeCC6GCYY6w: checks
PY4NvRocCFPfSIHKbh0euQ: bets $2
l5WbyJ/iWYjpeCC6GCYY6w: folds
PY4NvRocCFPfSIHKbh0euQ collected $1.95 from pot
*** SUMMARY ***
Total pot $2 | Rake $0.05
Board [9c 4h 3d 7d Jc]
Seat 1: PY4NvRocCFPfSIHKbh0euQ (button) (small blind) collected ($1.95)
Seat 2: l5WbyJ/iWYjpeCC6GCYY6w (big blind) folded on the River



PokerStars Game #59940897352:  Hold'em No Limit ($0.25/$0.50) - 2009/07/01 1:19:47 ET
Table 'c/CRn+68J3Y8KxD5g1ek2Q' 2-max Seat #2 is the button
Seat 1: 46qCyJ6evTkHo9al5sBMNA ($114.10 in chips)
Seat 2: BypVLsYQt3ePFm2xQL/dOA ($247.45 in chips)
BypVLsYQt3ePFm2xQL/dOA: posts small blind $0.25
46qCyJ6evTkHo9al5sBMNA: posts big blind $0.50
*** HOLE CARDS ***
BypVLsYQt3ePFm2xQL/dOA: calls $0.25
46qCyJ6evTkHo9al5sBMNA: checks
*** FLOP *** [2s 3c Ks]
46qCyJ6evTkHo9al5sBMNA: checks
BypVLsYQt3ePFm2xQL/dOA: checks
*** TURN *** [2s 3c Ks] [Qc]
46qCyJ6evTkHo9al5sBMNA: checks
BypVLsYQt3ePFm2xQL/dOA: bets $1.50
46qCyJ6evTkHo9al5sBMNA: folds
BypVLsYQt3ePFm2xQL/dOA collected $0.95 from pot
BypVLsYQt3ePFm2xQL/dOA: doesn't show hand
*** SUMMARY ***
Total pot $1 | Rake $0.05
Board [2s 3c Ks Qc]
Seat 1: 46qCyJ6evTkHo9al5sBMNA (big blind) folded on the Turn
Seat 2: BypVLsYQt3ePFm2xQL/dOA (button) (small blind) collected ($0.95)



PokerStars Game #59940897308:  Hold'em No Limit ($0.25/$0.50) - 2009/07/01 1:19:47 ET
Table 'fx6MqwfYAj/Rt86hBz2L3Q' 9-max Seat #8 is the button
Seat 1: v/4aX0ejnaIFK4ftDk2Lyg ($49.50 in chips)
Seat 2: C3rGXblctNcWI6JYPHhaEg ($36.70 in chips)
Seat 3: iadBi5AEt7gTBXbDSSnMYQ ($55.15 in chips)
Seat 5: iAISe3dVeua8PUn2wwgDHw ($65.15 in chips)
Seat 6: 5k9fvXD9suIgCxU4HLQjTw ($50 in chips)
Seat 7: SKnJuWHScqetA/qG5p+wCg ($33.95 in chips)
Seat 8: JYwJYYV9pM5KWdSiETl8rA ($29.25 in chips)
Seat 9: vO3QVRovWemcGMkm7ijAIA ($12.50 in chips)
vO3QVRovWemcGMkm7ijAIA: posts small blind $0.25
v/4aX0ejnaIFK4ftDk2Lyg: posts big blind $0.50
*** HOLE CARDS ***
C3rGXblctNcWI6JYPHhaEg: calls $0.50
iadBi5AEt7gTBXbDSSnMYQ: folds
iAISe3dVeua8PUn2wwgDHw: folds
5k9fvXD9suIgCxU4HLQjTw: raises $1.50 to $2
SKnJuWHScqetA/qG5p+wCg: folds
JYwJYYV9pM5KWdSiETl8rA: folds
vO3QVRovWemcGMkm7ijAIA: folds
v/4aX0ejnaIFK4ftDk2Lyg: folds
C3rGXblctNcWI6JYPHhaEg: calls $1.50
*** FLOP *** [2c Td 5h]
C3rGXblctNcWI6JYPHhaEg: bets $2.70
5k9fvXD9suIgCxU4HLQjTw: raises $2.70 to $5.40
C3rGXblctNcWI6JYPHhaEg: calls $2.70
*** TURN *** [2c Td 5h] [2h]
C3rGXblctNcWI6JYPHhaEg: bets $4.30
5k9fvXD9suIgCxU4HLQjTw: folds
C3rGXblctNcWI6JYPHhaEg collected $14.80 from pot
C3rGXblctNcWI6JYPHhaEg: doesn't show hand
*** SUMMARY ***
Total pot $15.55 | Rake $0.75
Board [2c Td 5h 2h]
Seat 1: v/4aX0ejnaIFK4ftDk2Lyg (big blind) folded before Flop
Seat 2: C3rGXblctNcWI6JYPHhaEg collected ($14.80)
Seat 3: iadBi5AEt7gTBXbDSSnMYQ folded before Flop (didn't bet)
Seat 5: iAISe3dVeua8PUn2wwgDHw folded before Flop (didn't bet)
Seat 6: 5k9fvXD9suIgCxU4HLQjTw folded on the Turn
Seat 7: SKnJuWHScqetA/qG5p+wCg folded before Flop (didn't bet)
Seat 8: JYwJYYV9pM5KWdSiETl8rA (button) folded before Flop (didn't bet)
Seat 9: vO3QVRovWemcGMkm7ijAIA (small blind) folded before Flop



PokerStars Game #59940897862:  Hold'em No Limit ($0.25/$0.50) - 2009/07/01 1:19:48 ET
Table 'QOgaEqMcJ73pcUMMxoisUg' 6-max Seat #2 is the button
Seat 1: lxIzoHy0RnkfFSODHC2liw ($50 in chips)
Seat 2: oqOqoO2AyCZenUghCxMDxw ($63.90 in chips)
Seat 3: Rt6KgtZ8YaJoTc3FPim00w ($57.85 in chips)
Seat 4: zAcsDhG/T128Vn7XGVSgKg ($61 in chips)
Seat 6: AdS8BJMOheS01zjCDfPMFg ($96.95 in chips)
Rt6KgtZ8YaJoTc3FPim00w: posts small blind $0.25
zAcsDhG/T128Vn7XGVSgKg: posts big blind $0.50
*** HOLE CARDS ***
AdS8BJMOheS01zjCDfPMFg: raises $1 to $1.50
lxIzoHy0RnkfFSODHC2liw: folds
oqOqoO2AyCZenUghCxMDxw: folds
Rt6KgtZ8YaJoTc3FPim00w: folds
zAcsDhG/T128Vn7XGVSgKg: folds
AdS8BJMOheS01zjCDfPMFg collected $1.25 from pot
*** SUMMARY ***
Total pot $1.25 | Rake $0
Seat 1: lxIzoHy0RnkfFSODHC2liw folded before Flop (didn't bet)
Seat 2: oqOqoO2AyCZenUghCxMDxw (button) folded before Flop (didn't bet)
Seat 3: Rt6KgtZ8YaJoTc3FPim00w (small blind) folded before Flop
Seat 4: zAcsDhG/T128Vn7XGVSgKg (big blind) folded before Flop
Seat 6: AdS8BJMOheS01zjCDfPMFg collected ($1.25)



PokerStars Game #59940903238:  Hold'em No Limit ($0.25/$0.50) - 2009/07/01 1:19:58 ET
Table 'PALRfuH85dr5IkDfdv6new' 9-max Seat #9 is the button
Seat 1: v/4aX0ejnaIFK4ftDk2Lyg ($48.25 in chips)
Seat 2: 1aXjSbrubyQKHeauooF5Wg ($48.15 in chips)
Seat 3: 50QWoELmpmHFrFIlWMJo9g ($97.15 in chips)
Seat 4: mZNMJI1mY40XTC0U7GZakA ($56.80 in chips)
Seat 6: ottZQkg1UDWk85BtBzGJzg ($46.60 in chips)
Seat 7: 3NcyXvr39gnK+KbTq7ezyA ($53.50 in chips)
Seat 8: NkS+CseUKx4XHszWq0PXEQ ($75.95 in chips)
Seat 9: viwBDtJsY6JfsFOdBAyJIQ ($9.95 in chips)
v/4aX0ejnaIFK4ftDk2Lyg: posts small blind $0.25
1aXjSbrubyQKHeauooF5Wg: posts big blind $0.50
XcLXSUMHSpshK/7Lh0M4Vg: sits out
*** HOLE CARDS ***
50QWoELmpmHFrFIlWMJo9g: folds
mZNMJI1mY40XTC0U7GZakA: folds
ottZQkg1UDWk85BtBzGJzg: raises $3.50 to $4
3NcyXvr39gnK+KbTq7ezyA: folds
NkS+CseUKx4XHszWq0PXEQ: folds
viwBDtJsY6JfsFOdBAyJIQ: folds
v/4aX0ejnaIFK4ftDk2Lyg: folds
1aXjSbrubyQKHeauooF5Wg: folds
ottZQkg1UDWk85BtBzGJzg collected $1.25 from pot
*** SUMMARY ***
Total pot $1.25 | Rake $0
Seat 1: v/4aX0ejnaIFK4ftDk2Lyg (small blind) folded before Flop
Seat 2: 1aXjSbrubyQKHeauooF5Wg (big blind) folded before Flop
Seat 3: 50QWoELmpmHFrFIlWMJo9g folded before Flop (didn't bet)
Seat 4: mZNMJI1mY40XTC0U7GZakA folded before Flop (didn't bet)
Seat 6: ottZQkg1UDWk85BtBzGJzg collected ($1.25)
Seat 7: 3NcyXvr39gnK+KbTq7ezyA folded before Flop (didn't bet)
Seat 8: NkS+CseUKx4XHszWq0PXEQ folded before Flop (didn't bet)
Seat 9: viwBDtJsY6JfsFOdBAyJIQ (button) folded before Flop (didn't bet)



PokerStars Game #59940903686:  Hold'em No Limit ($0.25/$0.50) - 2009/07/01 1:19:59 ET
Table 'otvGDROEDdqsabxskT79qg' 9-max Seat #9 is the button
Seat 1: 8ehL7qlZzjgUh2H35iiWLw ($59.25 in chips)
Seat 2: cCjTzH9jio8607WzjcfXlg ($12.40 in chips)
Seat 3: +k7T5ocke8UwavtgUHm+Cg ($74.50 in chips)
Seat 4: MG90wfSJZnOejs/KD3vlQQ ($79.05 in chips)
Seat 5: E2518gp4aFz1+kAgmGqeEg ($12.20 in chips)
Seat 6: bxLSulbgr8LmKNjOzw8URg ($55.25 in chips)
Seat 7: 75K2MXwN65Sjfp1yHd50Hg ($13.75 in chips)
Seat 8: zE9cVigS2nW/Ljy4K4bUQA ($32.55 in chips)
Seat 9: KcY3X8YpD74Kw1RHkx/g4A ($34.15 in chips)
8ehL7qlZzjgUh2H35iiWLw: posts small blind $0.25
cCjTzH9jio8607WzjcfXlg: posts big blind $0.50
*** HOLE CARDS ***
+k7T5ocke8UwavtgUHm+Cg: folds
MG90wfSJZnOejs/KD3vlQQ: raises $1 to $1.50
E2518gp4aFz1+kAgmGqeEg: folds
bxLSulbgr8LmKNjOzw8URg: folds
75K2MXwN65Sjfp1yHd50Hg: folds
zE9cVigS2nW/Ljy4K4bUQA: folds
KcY3X8YpD74Kw1RHkx/g4A: folds
8ehL7qlZzjgUh2H35iiWLw: folds
cCjTzH9jio8607WzjcfXlg: calls $1
*** FLOP *** [7d 8s Jd]
cCjTzH9jio8607WzjcfXlg: checks
MG90wfSJZnOejs/KD3vlQQ: bets $2.50
cCjTzH9jio8607WzjcfXlg: folds
MG90wfSJZnOejs/KD3vlQQ collected $3.10 from pot
MG90wfSJZnOejs/KD3vlQQ: doesn't show hand
*** SUMMARY ***
Total pot $3.25 | Rake $0.15
Board [7d 8s Jd]
Seat 1: 8ehL7qlZzjgUh2H35iiWLw (small blind) folded before Flop
Seat 2: cCjTzH9jio8607WzjcfXlg (big blind) folded on the Flop
Seat 3: +k7T5ocke8UwavtgUHm+Cg folded before Flop (didn't bet)
Seat 4: MG90wfSJZnOejs/KD3vlQQ collected ($3.10)
Seat 5: E2518gp4aFz1+kAgmGqeEg folded before Flop (didn't bet)
Seat 6: bxLSulbgr8LmKNjOzw8URg folded before Flop (didn't bet)
Seat 7: 75K2MXwN65Sjfp1yHd50Hg folded before Flop (didn't bet)
Seat 8: zE9cVigS2nW/Ljy4K4bUQA folded before Flop (didn't bet)
Seat 9: KcY3X8YpD74Kw1RHkx/g4A (button) folded before Flop (didn't bet)



PokerStars Game #59940905592:  Hold'em No Limit ($0.25/$0.50) - 2009/07/01 1:20:02 ET
Table 'GfL/No5u5PoEnU39lP5pQg' 6-max Seat #5 is the button
Seat 1: 1WUCqNG+p+vfWRTXNu4ljw ($63 in chips)
Seat 2: uVwggSetzp7d+eVgowO3vg ($54.85 in chips)
Seat 3: 4pp9WxhGdbVbxCc9tlu0lw ($33.05 in chips)
Seat 4: r6u7MWSXF30/khcTYkrG9Q ($21.50 in chips)
Seat 5: M1KyQQvVPVuxqTAB8sR/zQ ($50 in chips)
Seat 6: kxPhs4ePFqMy52CInAJ2aw ($62.70 in chips)
kxPhs4ePFqMy52CInAJ2aw: posts small blind $0.25
1WUCqNG+p+vfWRTXNu4ljw: posts big blind $0.50
*** HOLE CARDS ***
uVwggSetzp7d+eVgowO3vg: raises $1 to $1.50
4pp9WxhGdbVbxCc9tlu0lw: folds
r6u7MWSXF30/khcTYkrG9Q: folds
M1KyQQvVPVuxqTAB8sR/zQ: calls $1.50
kxPhs4ePFqMy52CInAJ2aw: folds
1WUCqNG+p+vfWRTXNu4ljw: raises $5 to $6.50
uVwggSetzp7d+eVgowO3vg: folds
M1KyQQvVPVuxqTAB8sR/zQ: folds
1WUCqNG+p+vfWRTXNu4ljw collected $4.75 from pot
*** SUMMARY ***
Total pot $4.75 | Rake $0
Seat 1: 1WUCqNG+p+vfWRTXNu4ljw (big blind) collected ($4.75)
Seat 2: uVwggSetzp7d+eVgowO3vg folded before Flop
Seat 3: 4pp9WxhGdbVbxCc9tlu0lw folded before Flop (didn't bet)
Seat 4: r6u7MWSXF30/khcTYkrG9Q folded before Flop (didn't bet)
Seat 5: M1KyQQvVPVuxqTAB8sR/zQ (button) folded before Flop
Seat 6: kxPhs4ePFqMy52CInAJ2aw (small blind) folded before Flop



PokerStars Game #59940906876:  Hold'em No Limit ($0.25/$0.50) - 2009/07/01 1:20:04 ET
Table '8BQGgNetI1NOvWeu3gtMNw' 2-max Seat #1 is the button
Seat 1: bypIyrYcAAifLfhZpGlKLA ($66.25 in chips)
Seat 2: Z4HwehErEwzsv/noQlfUlg ($124.65 in chips)
bypIyrYcAAifLfhZpGlKLA: posts small blind $0.25
Z4HwehErEwzsv/noQlfUlg: posts big blind $0.50
*** HOLE CARDS ***
bypIyrYcAAifLfhZpGlKLA: raises $1 to $1.50
Z4HwehErEwzsv/noQlfUlg: raises $1 to $2.50
bypIyrYcAAifLfhZpGlKLA: calls $1
*** FLOP *** [Ah 5h Js]
Z4HwehErEwzsv/noQlfUlg: bets $2.50
bypIyrYcAAifLfhZpGlKLA: raises $6 to $8.50
Z4HwehErEwzsv/noQlfUlg: folds
bypIyrYcAAifLfhZpGlKLA collected $9.55 from pot
bypIyrYcAAifLfhZpGlKLA: doesn't show hand
*** SUMMARY ***
Total pot $10 | Rake $0.45
Board [Ah 5h Js]
Seat 1: bypIyrYcAAifLfhZpGlKLA (button) (small blind) collected ($9.55)
Seat 2: Z4HwehErEwzsv/noQlfUlg (big blind) folded on the Flop



PokerStars Game #59940907728:  Hold'em No Limit ($0.25/$0.50) - 2009/07/01 1:20:05 ET
Table 'c/CRn+68J3Y8KxD5g1ek2Q' 2-max Seat #1 is the button
Seat 1: 46qCyJ6evTkHo9al5sBMNA ($113.60 in chips)
Seat 2: BypVLsYQt3ePFm2xQL/dOA ($247.90 in chips)
46qCyJ6evTkHo9al5sBMNA: posts small blind $0.25
BypVLsYQt3ePFm2xQL/dOA: posts big blind $0.50
*** HOLE CARDS ***
46qCyJ6evTkHo9al5sBMNA: folds
BypVLsYQt3ePFm2xQL/dOA collected $0.50 from pot
BypVLsYQt3ePFm2xQL/dOA: doesn't show hand
*** SUMMARY ***
Total pot $0.50 | Rake $0
Seat 1: 46qCyJ6evTkHo9al5sBMNA (button) (small blind) folded before Flop
Seat 2: BypVLsYQt3ePFm2xQL/dOA (big blind) collected ($0.50)



PokerStars Game #59940909144:  Hold'em No Limit ($0.25/$0.50) - 2009/07/01 1:20:08 ET
Table 'kgbJRsxfv64KrErDRBAkcw' 6-max Seat #3 is the button
Seat 1: VamsyhlFzXGF6/ydo0BHeA ($43.30 in chips)
Seat 2: AdS8BJMOheS01zjCDfPMFg ($45 in chips)
Seat 3: c4MNIaIyPMOMxrgT8FT5nA ($222.95 in chips)
Seat 4: 2igtJLmvIZ+HqX4XPgMPZA ($50 in chips)
Seat 5: eUBBn2R56C1IQ6Cs/vitwg ($50 in chips)
Seat 6: 1b+2BbjMN8qhR1WPqdE9VQ ($50 in chips)
2igtJLmvIZ+HqX4XPgMPZA: posts small blind $0.25
eUBBn2R56C1IQ6Cs/vitwg: posts big blind $0.50
*** HOLE CARDS ***
1b+2BbjMN8qhR1WPqdE9VQ: folds
VamsyhlFzXGF6/ydo0BHeA: calls $0.50
AdS8BJMOheS01zjCDfPMFg: raises $1 to $1.50
c4MNIaIyPMOMxrgT8FT5nA: raises $2.50 to $4
2igtJLmvIZ+HqX4XPgMPZA: folds
eUBBn2R56C1IQ6Cs/vitwg: folds
VamsyhlFzXGF6/ydo0BHeA: folds
AdS8BJMOheS01zjCDfPMFg: folds
c4MNIaIyPMOMxrgT8FT5nA collected $4.25 from pot
c4MNIaIyPMOMxrgT8FT5nA is sitting out
*** SUMMARY ***
Total pot $4.25 | Rake $0
Seat 1: VamsyhlFzXGF6/ydo0BHeA folded before Flop
Seat 2: AdS8BJMOheS01zjCDfPMFg folded before Flop
Seat 3: c4MNIaIyPMOMxrgT8FT5nA (button) collected ($4.25)
Seat 4: 2igtJLmvIZ+HqX4XPgMPZA (small blind) folded before Flop
Seat 5: eUBBn2R56C1IQ6Cs/vitwg (big blind) folded before Flop
Seat 6: 1b+2BbjMN8qhR1WPqdE9VQ folded before Flop (didn't bet)



PokerStars Game #59940909452:  Hold'em No Limit ($0.25/$0.50) - 2009/07/01 1:20:09 ET
Table 'MJxeZCzYELxiIsyUZyT0jw' 6-max Seat #1 is the button
Seat 1: +Pf9jTVizYlIo+woPvptfA ($50 in chips)
Seat 2: t3GiVMzqA9Svgr5Uol32cQ ($36.20 in chips)
Seat 3: sIG4mp8tZEI+W4nKZNkkQA ($51.85 in chips)
Seat 4: alGiiQP/wwtYnfuXII+sgw ($57.60 in chips)
Seat 5: 3jvoOXNtXE90w2BdfNZwZQ ($59.45 in chips)
Seat 6: c0n4hrn20AML9qzyFC2E8Q ($48.30 in chips)
t3GiVMzqA9Svgr5Uol32cQ: posts small blind $0.25
sIG4mp8tZEI+W4nKZNkkQA: posts big blind $0.50
*** HOLE CARDS ***
alGiiQP/wwtYnfuXII+sgw: calls $0.50
3jvoOXNtXE90w2BdfNZwZQ: folds
c0n4hrn20AML9qzyFC2E8Q: calls $0.50
+Pf9jTVizYlIo+woPvptfA: folds
t3GiVMzqA9Svgr5Uol32cQ: folds
sIG4mp8tZEI+W4nKZNkkQA: checks
*** FLOP *** [6d 3c 6h]
sIG4mp8tZEI+W4nKZNkkQA: checks
alGiiQP/wwtYnfuXII+sgw: checks
c0n4hrn20AML9qzyFC2E8Q: checks
*** TURN *** [6d 3c 6h] [8d]
sIG4mp8tZEI+W4nKZNkkQA: checks
alGiiQP/wwtYnfuXII+sgw: checks
c0n4hrn20AML9qzyFC2E8Q: checks
*** RIVER *** [6d 3c 6h 8d] [Td]
sIG4mp8tZEI+W4nKZNkkQA: checks
alGiiQP/wwtYnfuXII+sgw: bets $0.50
c0n4hrn20AML9qzyFC2E8Q: raises $0.50 to $1
sIG4mp8tZEI+W4nKZNkkQA: folds
alGiiQP/wwtYnfuXII+sgw: calls $0.50
*** SHOW DOWN ***
c0n4hrn20AML9qzyFC2E8Q: shows [Qh Tc] (two pair, Tens and Sixes)
alGiiQP/wwtYnfuXII+sgw: mucks hand
c0n4hrn20AML9qzyFC2E8Q collected $3.60 from pot
*** SUMMARY ***
Total pot $3.75 | Rake $0.15
Board [6d 3c 6h 8d Td]
Seat 1: +Pf9jTVizYlIo+woPvptfA (button) folded before Flop (didn't bet)
Seat 2: t3GiVMzqA9Svgr5Uol32cQ (small blind) folded before Flop
Seat 3: sIG4mp8tZEI+W4nKZNkkQA (big blind) folded on the River
Seat 4: alGiiQP/wwtYnfuXII+sgw mucked
Seat 5: 3jvoOXNtXE90w2BdfNZwZQ folded before Flop (didn't bet)
Seat 6: c0n4hrn20AML9qzyFC2E8Q showed [Qh Tc] and won ($3.60) with two pair, Tens and Sixes



PokerStars Game #59940909486:  Hold'em No Limit ($0.25/$0.50) - 2009/07/01 1:20:09 ET
Table 'ofnd8S4IdIPph1Cbn+x7hA' 2-max Seat #2 is the button
Seat 1: PY4NvRocCFPfSIHKbh0euQ ($27.80 in chips)
Seat 2: l5WbyJ/iWYjpeCC6GCYY6w ($66.75 in chips)
l5WbyJ/iWYjpeCC6GCYY6w: posts small blind $0.25
PY4NvRocCFPfSIHKbh0euQ: posts big blind $0.50
*** HOLE CARDS ***
l5WbyJ/iWYjpeCC6GCYY6w: calls $0.25
PY4NvRocCFPfSIHKbh0euQ: checks
*** FLOP *** [3c Ts 9s]
PY4NvRocCFPfSIHKbh0euQ: checks
l5WbyJ/iWYjpeCC6GCYY6w: bets $0.50
PY4NvRocCFPfSIHKbh0euQ: calls $0.50
*** TURN *** [3c Ts 9s] [9c]
PY4NvRocCFPfSIHKbh0euQ: checks
l5WbyJ/iWYjpeCC6GCYY6w: bets $1.50
PY4NvRocCFPfSIHKbh0euQ: calls $1.50
*** RIVER *** [3c Ts 9s 9c] [Kh]
PY4NvRocCFPfSIHKbh0euQ: checks
l5WbyJ/iWYjpeCC6GCYY6w: bets $3.50
PY4NvRocCFPfSIHKbh0euQ: folds
l5WbyJ/iWYjpeCC6GCYY6w collected $4.80 from pot
l5WbyJ/iWYjpeCC6GCYY6w: doesn't show hand
*** SUMMARY ***
Total pot $5 | Rake $0.20
Board [3c Ts 9s 9c Kh]
Seat 1: PY4NvRocCFPfSIHKbh0euQ (big blind) folded on the River
Seat 2: l5WbyJ/iWYjpeCC6GCYY6w (button) (small blind) collected ($4.80)



PokerStars Game #59940910144:  Hold'em No Limit ($0.25/$0.50) - 2009/07/01 1:20:10 ET
Table '+dXkOAQyS8j9PQZusUTMpg' 2-max Seat #2 is the button
Seat 1: Teld4PDKla7C8/Wfu2DSkg ($55.90 in chips)
Seat 2: +zI4bP23YIjMkUHqeN2xfw ($23.40 in chips)
+zI4bP23YIjMkUHqeN2xfw: posts small blind $0.25
Teld4PDKla7C8/Wfu2DSkg: posts big blind $0.50
*** HOLE CARDS ***
+zI4bP23YIjMkUHqeN2xfw: raises $1 to $1.50
Teld4PDKla7C8/Wfu2DSkg: folds
+zI4bP23YIjMkUHqeN2xfw collected $1 from pot
*** SUMMARY ***
Total pot $1 | Rake $0
Seat 1: Teld4PDKla7C8/Wfu2DSkg (big blind) folded before Flop
Seat 2: +zI4bP23YIjMkUHqeN2xfw (button) (small blind) collected ($1)



PokerStars Game #59940910326:  Hold'em No Limit ($0.25/$0.50) - 2009/07/01 1:20:10 ET
Table 'iq+aXfWVQRdV0u8SRTYUEg' 9-max Seat #3 is the button
Seat 1: 3yl8Q6QaLfGtyhN4/pEFgQ ($60.65 in chips)
Seat 2: J9N0lxHFd/Js2S0xZLbsIQ ($35.95 in chips)
Seat 3: YcxPb+VB8VLtuLPBaYcMjA ($15.75 in chips)
Seat 5: 997ViqAtWn1FPjJqcffwcA ($50 in chips)
Seat 6: bTJ0WgoxefTPxIoycS7uoA ($32.35 in chips)
Seat 7: SKnJuWHScqetA/qG5p+wCg ($32.30 in chips)
Seat 8: /DtIHuxEH+3tzKefmSV+Mw ($17.55 in chips)
Seat 9: olE1Z2rKWAV8+tGqmIBK9g ($22.85 in chips)
997ViqAtWn1FPjJqcffwcA: posts small blind $0.25
bTJ0WgoxefTPxIoycS7uoA: posts big blind $0.50
3yl8Q6QaLfGtyhN4/pEFgQ: posts small & big blinds $0.75
*** HOLE CARDS ***
SKnJuWHScqetA/qG5p+wCg: folds
/DtIHuxEH+3tzKefmSV+Mw: folds
olE1Z2rKWAV8+tGqmIBK9g: folds
3yl8Q6QaLfGtyhN4/pEFgQ: checks
J9N0lxHFd/Js2S0xZLbsIQ: folds
YcxPb+VB8VLtuLPBaYcMjA: folds
997ViqAtWn1FPjJqcffwcA: folds
bTJ0WgoxefTPxIoycS7uoA: checks
*** FLOP *** [Ts 6d 7c]
bTJ0WgoxefTPxIoycS7uoA: checks
3yl8Q6QaLfGtyhN4/pEFgQ: bets $1
bTJ0WgoxefTPxIoycS7uoA: folds
3yl8Q6QaLfGtyhN4/pEFgQ collected $1.45 from pot
3yl8Q6QaLfGtyhN4/pEFgQ: doesn't show hand
*** SUMMARY ***
Total pot $1.50 | Rake $0.05
Board [Ts 6d 7c]
Seat 1: 3yl8Q6QaLfGtyhN4/pEFgQ collected ($1.45)
Seat 2: J9N0lxHFd/Js2S0xZLbsIQ folded before Flop (didn't bet)
Seat 3: YcxPb+VB8VLtuLPBaYcMjA (button) folded before Flop (didn't bet)
Seat 5: 997ViqAtWn1FPjJqcffwcA (small blind) folded before Flop
Seat 6: bTJ0WgoxefTPxIoycS7uoA (big blind) folded on the Flop
Seat 7: SKnJuWHScqetA/qG5p+wCg folded before Flop (didn't bet)
Seat 8: /DtIHuxEH+3tzKefmSV+Mw folded before Flop (didn't bet)
Seat 9: olE1Z2rKWAV8+tGqmIBK9g folded before Flop (didn't bet)



PokerStars Game #59940910132:  Hold'em No Limit ($0.25/$0.50) - 2009/07/01 1:20:10 ET
Table 'BCN5su+SsXiy1zRMJi0SJw' 6-max Seat #1 is the button
Seat 1: GxXV09ciXaOxyY2H5aMIIw ($53.85 in chips)
Seat 2: ehFNAevCQri3trWxV6FJdA ($29 in chips)
Seat 3: kwgv5lNhiFrfONXCshzxlA ($46.45 in chips)
Seat 5: cEMJmfAUQZmMChZe6aacKw ($46.05 in chips)
Seat 6: b2symlOdL7+0c9Pj4N/KlA ($56.90 in chips)
ehFNAevCQri3trWxV6FJdA: posts small blind $0.25
kwgv5lNhiFrfONXCshzxlA: posts big blind $0.50
*** HOLE CARDS ***
cEMJmfAUQZmMChZe6aacKw: folds
b2symlOdL7+0c9Pj4N/KlA: folds
GxXV09ciXaOxyY2H5aMIIw: raises $1.50 to $2
ehFNAevCQri3trWxV6FJdA: calls $1.75
kwgv5lNhiFrfONXCshzxlA: folds
*** FLOP *** [9s Jh Ks]
ehFNAevCQri3trWxV6FJdA: checks
GxXV09ciXaOxyY2H5aMIIw: bets $3.50
ehFNAevCQri3trWxV6FJdA: calls $3.50
*** TURN *** [9s Jh Ks] [Qc]
cEMJmfAUQZmMChZe6aacKw leaves the table
ehFNAevCQri3trWxV6FJdA: checks
GxXV09ciXaOxyY2H5aMIIw: checks
*** RIVER *** [9s Jh Ks Qc] [Kc]
ehFNAevCQri3trWxV6FJdA: checks
GxXV09ciXaOxyY2H5aMIIw: checks
*** SHOW DOWN ***
ehFNAevCQri3trWxV6FJdA: shows [Tc 9c] (a straight, Nine to King)
GxXV09ciXaOxyY2H5aMIIw: mucks hand
ehFNAevCQri3trWxV6FJdA collected $10.95 from pot
*** SUMMARY ***
Total pot $11.50 | Rake $0.55
Board [9s Jh Ks Qc Kc]
Seat 1: GxXV09ciXaOxyY2H5aMIIw (button) mucked
Seat 2: ehFNAevCQri3trWxV6FJdA (small blind) showed [Tc 9c] and won ($10.95) with a straight, Nine to King
Seat 3: kwgv5lNhiFrfONXCshzxlA (big blind) folded before Flop
Seat 5: cEMJmfAUQZmMChZe6aacKw folded before Flop (didn't bet)
Seat 6: b2symlOdL7+0c9Pj4N/KlA folded before Flop (didn't bet)



PokerStars Game #59940910904:  Hold'em No Limit ($0.25/$0.50) - 2009/07/01 1:20:11 ET
Table 'c/CRn+68J3Y8KxD5g1ek2Q' 2-max Seat #2 is the button
Seat 1: 46qCyJ6evTkHo9al5sBMNA ($113.35 in chips)
Seat 2: BypVLsYQt3ePFm2xQL/dOA ($248.15 in chips)
BypVLsYQt3ePFm2xQL/dOA: posts small blind $0.25
46qCyJ6evTkHo9al5sBMNA: posts big blind $0.50
*** HOLE CARDS ***
BypVLsYQt3ePFm2xQL/dOA: raises $0.50 to $1
46qCyJ6evTkHo9al5sBMNA: calls $0.50
*** FLOP *** [Qh 7c 7h]
46qCyJ6evTkHo9al5sBMNA: checks
BypVLsYQt3ePFm2xQL/dOA: bets $0.50
46qCyJ6evTkHo9al5sBMNA: calls $0.50
*** TURN *** [Qh 7c 7h] [2h]
46qCyJ6evTkHo9al5sBMNA: checks
BypVLsYQt3ePFm2xQL/dOA: bets $2
46qCyJ6evTkHo9al5sBMNA: calls $2
*** RIVER *** [Qh 7c 7h 2h] [9s]
46qCyJ6evTkHo9al5sBMNA: checks
BypVLsYQt3ePFm2xQL/dOA: bets $8.50
46qCyJ6evTkHo9al5sBMNA: folds
BypVLsYQt3ePFm2xQL/dOA collected $6.70 from pot
BypVLsYQt3ePFm2xQL/dOA: doesn't show hand
*** SUMMARY ***
Total pot $7 | Rake $0.30
Board [Qh 7c 7h 2h 9s]
Seat 1: 46qCyJ6evTkHo9al5sBMNA (big blind) folded on the River
Seat 2: BypVLsYQt3ePFm2xQL/dOA (button) (small blind) collected ($6.70)



PokerStars Game #59940914246:  Hold'em No Limit ($0.25/$0.50) - 2009/07/01 1:20:17 ET
Table '+dXkOAQyS8j9PQZusUTMpg' 2-max Seat #1 is the button
Seat 1: Teld4PDKla7C8/Wfu2DSkg ($55.40 in chips)
Seat 2: +zI4bP23YIjMkUHqeN2xfw ($23.90 in chips)
Teld4PDKla7C8/Wfu2DSkg: posts small blind $0.25
+zI4bP23YIjMkUHqeN2xfw: posts big blind $0.50
*** HOLE CARDS ***
Teld4PDKla7C8/Wfu2DSkg: calls $0.25
+zI4bP23YIjMkUHqeN2xfw: checks
*** FLOP *** [7c 5d Qh]
+zI4bP23YIjMkUHqeN2xfw: checks
Teld4PDKla7C8/Wfu2DSkg: checks
*** TURN *** [7c 5d Qh] [9h]
+zI4bP23YIjMkUHqeN2xfw: bets $1
Teld4PDKla7C8/Wfu2DSkg: folds
+zI4bP23YIjMkUHqeN2xfw collected $0.95 from pot
*** SUMMARY ***
Total pot $1 | Rake $0.05
Board [7c 5d Qh 9h]
Seat 1: Teld4PDKla7C8/Wfu2DSkg (button) (small blind) folded on the Turn
Seat 2: +zI4bP23YIjMkUHqeN2xfw (big blind) collected ($0.95)



PokerStars Game #59940915340:  Hold'em No Limit ($0.25/$0.50) - 2009/07/01 1:20:19 ET
Table 'lSisgp6H7Fg1hH5VfjEjYQ' 9-max Seat #3 is the button
Seat 1: 5k9fvXD9suIgCxU4HLQjTw ($50 in chips)
Seat 3: SKnJuWHScqetA/qG5p+wCg ($30 in chips)
Seat 4: bwv/rbH/hHhPhY6u9mu04w ($34.30 in chips)
Seat 5: mSD1pginDsyHG5PDfqzphw ($13 in chips)
Seat 6: +k7T5ocke8UwavtgUHm+Cg ($64.40 in chips)
Seat 7: IDtNLR9uFCDdjNsJWMHA5Q ($22.45 in chips)
Seat 8: a4JDWmpFQkL10XfAyuF51A ($15.50 in chips)
Seat 9: YzeKFbJVLmJGTgNH3ySQlw ($14.50 in chips)
bwv/rbH/hHhPhY6u9mu04w: posts small blind $0.25
mSD1pginDsyHG5PDfqzphw: posts big blind $0.50
*** HOLE CARDS ***
+k7T5ocke8UwavtgUHm+Cg: folds
IDtNLR9uFCDdjNsJWMHA5Q: folds
a4JDWmpFQkL10XfAyuF51A: folds
YzeKFbJVLmJGTgNH3ySQlw: calls $0.50
5k9fvXD9suIgCxU4HLQjTw: folds
SKnJuWHScqetA/qG5p+wCg: folds
bwv/rbH/hHhPhY6u9mu04w: raises $1 to $1.50
mSD1pginDsyHG5PDfqzphw: folds
YzeKFbJVLmJGTgNH3ySQlw: calls $1
*** FLOP *** [7d Kd Ks]
bwv/rbH/hHhPhY6u9mu04w: checks
YzeKFbJVLmJGTgNH3ySQlw: checks
*** TURN *** [7d Kd Ks] [3h]
bwv/rbH/hHhPhY6u9mu04w: checks
YzeKFbJVLmJGTgNH3ySQlw: checks
*** RIVER *** [7d Kd Ks 3h] [5c]
bwv/rbH/hHhPhY6u9mu04w: checks
YzeKFbJVLmJGTgNH3ySQlw: checks
*** SHOW DOWN ***
bwv/rbH/hHhPhY6u9mu04w: shows [Qh Ac] (a pair of Kings)
YzeKFbJVLmJGTgNH3ySQlw: mucks hand
bwv/rbH/hHhPhY6u9mu04w collected $3.35 from pot
*** SUMMARY ***
Total pot $3.50 | Rake $0.15
Board [7d Kd Ks 3h 5c]
Seat 1: 5k9fvXD9suIgCxU4HLQjTw folded before Flop (didn't bet)
Seat 3: SKnJuWHScqetA/qG5p+wCg (button) folded before Flop (didn't bet)
Seat 4: bwv/rbH/hHhPhY6u9mu04w (small blind) showed [Qh Ac] and won ($3.35) with a pair of Kings
Seat 5: mSD1pginDsyHG5PDfqzphw (big blind) folded before Flop
Seat 6: +k7T5ocke8UwavtgUHm+Cg folded before Flop (didn't bet)
Seat 7: IDtNLR9uFCDdjNsJWMHA5Q folded before Flop (didn't bet)
Seat 8: a4JDWmpFQkL10XfAyuF51A folded before Flop (didn't bet)
Seat 9: YzeKFbJVLmJGTgNH3ySQlw mucked



PokerStars Game #59940914832:  Hold'em No Limit ($0.25/$0.50) - 2009/07/01 1:20:19 ET
Table 'X6IRCRTh+20gjz8aubWnwA' 9-max Seat #9 is the button
Seat 1: E2518gp4aFz1+kAgmGqeEg ($10.50 in chips)
Seat 2: HZkVla4kK2SI42CVrPZ/ig ($4 in chips)
Seat 3: SWv01peOe69QQRvhQTqjQw ($12.15 in chips)
Seat 4: M3JFBNQ8Bbw3FBZ/18MuXw ($26.65 in chips)
Seat 5: NnQCepdIR/AOUQn1yhYx6Q ($14.45 in chips)
Seat 6: 75K2MXwN65Sjfp1yHd50Hg ($12.15 in chips)
Seat 7: cFHQjKQOOKTUzoilhrXHLg ($11.75 in chips)
Seat 8: HxeBVq06/3Bh/H986sgdbw ($48.50 in chips)
Seat 9: M+7+BTmX5vZatHVuoRB1nA ($44.80 in chips)
E2518gp4aFz1+kAgmGqeEg: posts small blind $0.25
HZkVla4kK2SI42CVrPZ/ig: posts big blind $0.50
*** HOLE CARDS ***
SWv01peOe69QQRvhQTqjQw: folds
HZkVla4kK2SI42CVrPZ/ig said, "ugh"
M3JFBNQ8Bbw3FBZ/18MuXw: raises $1.50 to $2
NnQCepdIR/AOUQn1yhYx6Q: folds
75K2MXwN65Sjfp1yHd50Hg: folds
NnQCepdIR/AOUQn1yhYx6Q leaves the table
cFHQjKQOOKTUzoilhrXHLg: raises $9.75 to $11.75 and is all-in
HxeBVq06/3Bh/H986sgdbw: folds
M+7+BTmX5vZatHVuoRB1nA: folds
E2518gp4aFz1+kAgmGqeEg: folds
uw9QayAAxLM3Hb+HR7mSkg joins the table at seat #5
HZkVla4kK2SI42CVrPZ/ig: folds
M3JFBNQ8Bbw3FBZ/18MuXw: folds
cFHQjKQOOKTUzoilhrXHLg collected $4.75 from pot
cFHQjKQOOKTUzoilhrXHLg: doesn't show hand
*** SUMMARY ***
Total pot $4.75 | Rake $0
Seat 1: E2518gp4aFz1+kAgmGqeEg (small blind) folded before Flop
Seat 2: HZkVla4kK2SI42CVrPZ/ig (big blind) folded before Flop
Seat 3: SWv01peOe69QQRvhQTqjQw folded before Flop (didn't bet)
Seat 4: M3JFBNQ8Bbw3FBZ/18MuXw folded before Flop
Seat 5: NnQCepdIR/AOUQn1yhYx6Q folded before Flop (didn't bet)
Seat 6: 75K2MXwN65Sjfp1yHd50Hg folded before Flop (didn't bet)
Seat 7: cFHQjKQOOKTUzoilhrXHLg collected ($4.75)
Seat 8: HxeBVq06/3Bh/H986sgdbw folded before Flop (didn't bet)
Seat 9: M+7+BTmX5vZatHVuoRB1nA (button) folded before Flop (didn't bet)



PokerStars Game #59940915110:  Hold'em No Limit ($0.25/$0.50) - 2009/07/01 1:20:19 ET
Table 'hSTs/dUsYLgJQuF2Onp0MQ' 6-max Seat #4 is the button
Seat 1: 1WUCqNG+p+vfWRTXNu4ljw ($50 in chips)
Seat 4: 2igtJLmvIZ+HqX4XPgMPZA ($56.40 in chips)
Seat 5: IBNygaT1aa9Z1uPdJJilwA ($58.85 in chips)
Seat 6: M1KyQQvVPVuxqTAB8sR/zQ ($88.20 in chips)
IBNygaT1aa9Z1uPdJJilwA: posts small blind $0.25
M1KyQQvVPVuxqTAB8sR/zQ: posts big blind $0.50
lxIzoHy0RnkfFSODHC2liw: sits out
*** HOLE CARDS ***
1WUCqNG+p+vfWRTXNu4ljw: folds
2igtJLmvIZ+HqX4XPgMPZA: raises $1 to $1.50
IBNygaT1aa9Z1uPdJJilwA: raises $2.50 to $4
M1KyQQvVPVuxqTAB8sR/zQ: folds
2igtJLmvIZ+HqX4XPgMPZA: calls $2.50
*** FLOP *** [Ah 2d 8c]
IBNygaT1aa9Z1uPdJJilwA: bets $2.50
2igtJLmvIZ+HqX4XPgMPZA: calls $2.50
*** TURN *** [Ah 2d 8c] [4c]
IBNygaT1aa9Z1uPdJJilwA: bets $5.50
2igtJLmvIZ+HqX4XPgMPZA: calls $5.50
*** RIVER *** [Ah 2d 8c 4c] [5d]
IBNygaT1aa9Z1uPdJJilwA: bets $14
2igtJLmvIZ+HqX4XPgMPZA: calls $14
*** SHOW DOWN ***
IBNygaT1aa9Z1uPdJJilwA: shows [9c 9h] (a pair of Nines)
2igtJLmvIZ+HqX4XPgMPZA: shows [As Qh] (a pair of Aces)
2igtJLmvIZ+HqX4XPgMPZA collected $50.50 from pot
*** SUMMARY ***
Total pot $52.50 | Rake $2
Board [Ah 2d 8c 4c 5d]
Seat 1: 1WUCqNG+p+vfWRTXNu4ljw folded before Flop (didn't bet)
Seat 4: 2igtJLmvIZ+HqX4XPgMPZA (button) showed [As Qh] and won ($50.50) with a pair of Aces
Seat 5: IBNygaT1aa9Z1uPdJJilwA (small blind) showed [9c 9h] and lost with a pair of Nines
Seat 6: M1KyQQvVPVuxqTAB8sR/zQ (big blind) folded before Flop



PokerStars Game #59940915406:  Hold'em No Limit ($0.25/$0.50) - 2009/07/01 1:20:20 ET
Table '+z1aekfHkpp09pc8F9aViw' 6-max Seat #3 is the button
Seat 1: 7zFtlEn2NxyROFkJdZA/yg ($50 in chips)
Seat 2: OZ6OtYh5Y53MCH/p0QTn5g ($50 in chips)
Seat 3: uUznlIMFnRUvwrBhYF73KA ($163.40 in chips)
Seat 4: RowCSpSURHTOL/dcjg/Iug ($83.65 in chips)
Seat 6: GUnvMULl2qFOO1yenu1UBw ($50 in chips)
RowCSpSURHTOL/dcjg/Iug: posts small blind $0.25
GUnvMULl2qFOO1yenu1UBw: posts big blind $0.50
*** HOLE CARDS ***
7zFtlEn2NxyROFkJdZA/yg: folds
rplyldNweS6YyMNEALQrug leaves the table
OZ6OtYh5Y53MCH/p0QTn5g: folds
uUznlIMFnRUvwrBhYF73KA: calls $0.50
RowCSpSURHTOL/dcjg/Iug: calls $0.25
2igtJLmvIZ+HqX4XPgMPZA joins the table at seat #5
GUnvMULl2qFOO1yenu1UBw: checks
*** FLOP *** [Js Td As]
RowCSpSURHTOL/dcjg/Iug: checks
GUnvMULl2qFOO1yenu1UBw: checks
uUznlIMFnRUvwrBhYF73KA: bets $1
RowCSpSURHTOL/dcjg/Iug: calls $1
GUnvMULl2qFOO1yenu1UBw: folds
*** TURN *** [Js Td As] [7d]
RowCSpSURHTOL/dcjg/Iug: checks
uUznlIMFnRUvwrBhYF73KA: checks
*** RIVER *** [Js Td As 7d] [5s]
RowCSpSURHTOL/dcjg/Iug: bets $2
uUznlIMFnRUvwrBhYF73KA: raises $3 to $5
RowCSpSURHTOL/dcjg/Iug: calls $3
*** SHOW DOWN ***
uUznlIMFnRUvwrBhYF73KA: shows [Kd 3c] (high card Ace)
RowCSpSURHTOL/dcjg/Iug: shows [Ah 3h] (a pair of Aces)
RowCSpSURHTOL/dcjg/Iug collected $12.85 from pot
*** SUMMARY ***
Total pot $13.50 | Rake $0.65
Board [Js Td As 7d 5s]
Seat 1: 7zFtlEn2NxyROFkJdZA/yg folded before Flop (didn't bet)
Seat 2: OZ6OtYh5Y53MCH/p0QTn5g folded before Flop (didn't bet)
Seat 3: uUznlIMFnRUvwrBhYF73KA (button) showed [Kd 3c] and lost with high card Ace
Seat 4: RowCSpSURHTOL/dcjg/Iug (small blind) showed [Ah 3h] and won ($12.85) with a pair of Aces
Seat 6: GUnvMULl2qFOO1yenu1UBw (big blind) folded on the Flop



PokerStars Game #59940915886:  Hold'em No Limit ($0.25/$0.50) - 2009/07/01 1:20:20 ET
Table 'PALRfuH85dr5IkDfdv6new' 9-max Seat #1 is the button
Seat 1: v/4aX0ejnaIFK4ftDk2Lyg ($48 in chips)
Seat 2: 1aXjSbrubyQKHeauooF5Wg ($47.65 in chips)
Seat 3: 50QWoELmpmHFrFIlWMJo9g ($97.15 in chips)
Seat 4: mZNMJI1mY40XTC0U7GZakA ($56.80 in chips)
Seat 6: ottZQkg1UDWk85BtBzGJzg ($47.35 in chips)
Seat 7: 3NcyXvr39gnK+KbTq7ezyA ($53.50 in chips)
Seat 8: NkS+CseUKx4XHszWq0PXEQ ($75.95 in chips)
Seat 9: viwBDtJsY6JfsFOdBAyJIQ ($9.95 in chips)
1aXjSbrubyQKHeauooF5Wg: posts small blind $0.25
50QWoELmpmHFrFIlWMJo9g: posts big blind $0.50
XcLXSUMHSpshK/7Lh0M4Vg: sits out
*** HOLE CARDS ***
mZNMJI1mY40XTC0U7GZakA: folds
ottZQkg1UDWk85BtBzGJzg: folds
3NcyXvr39gnK+KbTq7ezyA: calls $0.50
NkS+CseUKx4XHszWq0PXEQ: folds
viwBDtJsY6JfsFOdBAyJIQ: folds
v/4aX0ejnaIFK4ftDk2Lyg: folds
1aXjSbrubyQKHeauooF5Wg: calls $0.25
50QWoELmpmHFrFIlWMJo9g: checks
*** FLOP *** [Jc 8h 2h]
1aXjSbrubyQKHeauooF5Wg: bets $0.75
50QWoELmpmHFrFIlWMJo9g: folds
3NcyXvr39gnK+KbTq7ezyA: calls $0.75
*** TURN *** [Jc 8h 2h] [3h]
1aXjSbrubyQKHeauooF5Wg: bets $1.50
3NcyXvr39gnK+KbTq7ezyA: calls $1.50
*** RIVER *** [Jc 8h 2h 3h] [Js]
1aXjSbrubyQKHeauooF5Wg: bets $3.50
3NcyXvr39gnK+KbTq7ezyA: calls $3.50
*** SHOW DOWN ***
1aXjSbrubyQKHeauooF5Wg: shows [9s Tc] (a pair of Jacks)
3NcyXvr39gnK+KbTq7ezyA: shows [As Ad] (two pair, Aces and Jacks)
3NcyXvr39gnK+KbTq7ezyA collected $12.40 from pot
*** SUMMARY ***
Total pot $13 | Rake $0.60
Board [Jc 8h 2h 3h Js]
Seat 1: v/4aX0ejnaIFK4ftDk2Lyg (button) folded before Flop (didn't bet)
Seat 2: 1aXjSbrubyQKHeauooF5Wg (small blind) showed [9s Tc] and lost with a pair of Jacks
Seat 3: 50QWoELmpmHFrFIlWMJo9g (big blind) folded on the Flop
Seat 4: mZNMJI1mY40XTC0U7GZakA folded before Flop (didn't bet)
Seat 6: ottZQkg1UDWk85BtBzGJzg folded before Flop (didn't bet)
Seat 7: 3NcyXvr39gnK+KbTq7ezyA showed [As Ad] and won ($12.40) with two pair, Aces and Jacks
Seat 8: NkS+CseUKx4XHszWq0PXEQ folded before Flop (didn't bet)
Seat 9: viwBDtJsY6JfsFOdBAyJIQ folded before Flop (didn't bet)



PokerStars Game #59940918778:  Hold'em No Limit ($0.25/$0.50) - 2009/07/01 1:20:26 ET
Table '8BQGgNetI1NOvWeu3gtMNw' 2-max Seat #2 is the button
Seat 1: bypIyrYcAAifLfhZpGlKLA ($70.80 in chips)
Seat 2: Z4HwehErEwzsv/noQlfUlg ($119.65 in chips)
Z4HwehErEwzsv/noQlfUlg: posts small blind $0.25
bypIyrYcAAifLfhZpGlKLA: posts big blind $0.50
*** HOLE CARDS ***
Z4HwehErEwzsv/noQlfUlg: folds
bypIyrYcAAifLfhZpGlKLA collected $0.50 from pot
*** SUMMARY ***
Total pot $0.50 | Rake $0
Seat 1: bypIyrYcAAifLfhZpGlKLA (big blind) collected ($0.50)
Seat 2: Z4HwehErEwzsv/noQlfUlg (button) (small blind) folded before Flop



PokerStars Game #59940919034:  Hold'em No Limit ($0.25/$0.50) - 2009/07/01 1:20:26 ET
Table 'tyR5AZNKV8Aadbrnrnlg7g' 6-max Seat #5 is the button
Seat 1: BgOXYI0yYSN1ULC4FqsNkg ($98.30 in chips)
Seat 2: BAjwVL+zKKd0s0fAWstzQQ ($50.30 in chips)
Seat 3: JFLrYNyQmwPhRQAtoSAuyA ($49.85 in chips)
Seat 4: 4QfsCWthT/vSLirorNXqtg ($88.70 in chips)
Seat 5: GUnvMULl2qFOO1yenu1UBw ($50 in chips)
Seat 6: 498aWaGsW4uGfuWl+2FCGw ($45.50 in chips)
498aWaGsW4uGfuWl+2FCGw: posts small blind $0.25
BgOXYI0yYSN1ULC4FqsNkg: posts big blind $0.50
*** HOLE CARDS ***
BAjwVL+zKKd0s0fAWstzQQ: folds
JFLrYNyQmwPhRQAtoSAuyA: folds
4QfsCWthT/vSLirorNXqtg: folds
GUnvMULl2qFOO1yenu1UBw: folds
498aWaGsW4uGfuWl+2FCGw: raises $0.50 to $1
BgOXYI0yYSN1ULC4FqsNkg: calls $0.50
*** FLOP *** [6d Ad Jc]
498aWaGsW4uGfuWl+2FCGw: bets $1
BgOXYI0yYSN1ULC4FqsNkg: folds
498aWaGsW4uGfuWl+2FCGw collected $1.90 from pot
498aWaGsW4uGfuWl+2FCGw: doesn't show hand
*** SUMMARY ***
Total pot $2 | Rake $0.10
Board [6d Ad Jc]
Seat 1: BgOXYI0yYSN1ULC4FqsNkg (big blind) folded on the Flop
Seat 2: BAjwVL+zKKd0s0fAWstzQQ folded before Flop (didn't bet)
Seat 3: JFLrYNyQmwPhRQAtoSAuyA folded before Flop (didn't bet)
Seat 4: 4QfsCWthT/vSLirorNXqtg folded before Flop (didn't bet)
Seat 5: GUnvMULl2qFOO1yenu1UBw (button) folded before Flop (didn't bet)
Seat 6: 498aWaGsW4uGfuWl+2FCGw (small blind) collected ($1.90)



PokerStars Game #59940919186:  Hold'em No Limit ($0.25/$0.50) - 2009/07/01 1:20:26 ET
Table 'EiNh8p/wGJ1FP575iMFnqg' 9-max Seat #5 is the button
Seat 1: bmRtaIYKthN1F+B3JLZ3Jw ($19.50 in chips)
Seat 2: 8ehL7qlZzjgUh2H35iiWLw ($58.90 in chips)
Seat 3: ymLPoEIl7UL3TvZYmnadxQ ($56.65 in chips)
Seat 4: cMzaiXAM/ZAdNaEUu+LqhA ($50 in chips)
Seat 5: M+7+BTmX5vZatHVuoRB1nA ($79.70 in chips)
Seat 6: viwBDtJsY6JfsFOdBAyJIQ ($9.70 in chips)
Seat 7: 997ViqAtWn1FPjJqcffwcA ($50 in chips)
Seat 8: mSD1pginDsyHG5PDfqzphw ($10 in chips)
Seat 9: GuPkZObrz5Zkkn8FsEdF9w ($30.70 in chips)
viwBDtJsY6JfsFOdBAyJIQ: posts small blind $0.25
997ViqAtWn1FPjJqcffwcA: posts big blind $0.50
*** HOLE CARDS ***
mSD1pginDsyHG5PDfqzphw: folds
GuPkZObrz5Zkkn8FsEdF9w: folds
bmRtaIYKthN1F+B3JLZ3Jw has timed out
bmRtaIYKthN1F+B3JLZ3Jw: folds
bmRtaIYKthN1F+B3JLZ3Jw is sitting out
8ehL7qlZzjgUh2H35iiWLw: folds
ymLPoEIl7UL3TvZYmnadxQ: folds
cMzaiXAM/ZAdNaEUu+LqhA: folds
M+7+BTmX5vZatHVuoRB1nA: raises $1.50 to $2
bmRtaIYKthN1F+B3JLZ3Jw leaves the table
viwBDtJsY6JfsFOdBAyJIQ: folds
997ViqAtWn1FPjJqcffwcA: folds
M+7+BTmX5vZatHVuoRB1nA collected $1.25 from pot
M+7+BTmX5vZatHVuoRB1nA: doesn't show hand
*** SUMMARY ***
Total pot $1.25 | Rake $0
Seat 1: bmRtaIYKthN1F+B3JLZ3Jw folded before Flop (didn't bet)
Seat 2: 8ehL7qlZzjgUh2H35iiWLw folded before Flop (didn't bet)
Seat 3: ymLPoEIl7UL3TvZYmnadxQ folded before Flop (didn't bet)
Seat 4: cMzaiXAM/ZAdNaEUu+LqhA folded before Flop (didn't bet)
Seat 5: M+7+BTmX5vZatHVuoRB1nA (button) collected ($1.25)
Seat 6: viwBDtJsY6JfsFOdBAyJIQ (small blind) folded before Flop
Seat 7: 997ViqAtWn1FPjJqcffwcA (big blind) folded before Flop
Seat 8: mSD1pginDsyHG5PDfqzphw folded before Flop (didn't bet)
Seat 9: GuPkZObrz5Zkkn8FsEdF9w folded before Flop (didn't bet)



PokerStars Game #59940922034:  Hold'em No Limit ($0.25/$0.50) - 2009/07/01 1:20:31 ET
Table 'GfL/No5u5PoEnU39lP5pQg' 6-max Seat #6 is the button
Seat 1: 1WUCqNG+p+vfWRTXNu4ljw ($66.25 in chips)
Seat 2: uVwggSetzp7d+eVgowO3vg ($53.35 in chips)
Seat 3: 4pp9WxhGdbVbxCc9tlu0lw ($33.05 in chips)
Seat 4: r6u7MWSXF30/khcTYkrG9Q ($21.50 in chips)
Seat 5: M1KyQQvVPVuxqTAB8sR/zQ ($50 in chips)
Seat 6: kxPhs4ePFqMy52CInAJ2aw ($62.45 in chips)
1WUCqNG+p+vfWRTXNu4ljw: posts small blind $0.25
uVwggSetzp7d+eVgowO3vg: posts big blind $0.50
*** HOLE CARDS ***
4pp9WxhGdbVbxCc9tlu0lw: folds
r6u7MWSXF30/khcTYkrG9Q: raises $1 to $1.50
M1KyQQvVPVuxqTAB8sR/zQ: folds
kxPhs4ePFqMy52CInAJ2aw: folds
1WUCqNG+p+vfWRTXNu4ljw: folds
uVwggSetzp7d+eVgowO3vg: calls $1
*** FLOP *** [5s 3c Td]
uVwggSetzp7d+eVgowO3vg: checks
r6u7MWSXF30/khcTYkrG9Q: checks
*** TURN *** [5s 3c Td] [3d]
uVwggSetzp7d+eVgowO3vg: checks
r6u7MWSXF30/khcTYkrG9Q: bets $2
uVwggSetzp7d+eVgowO3vg: folds
r6u7MWSXF30/khcTYkrG9Q collected $3.10 from pot
*** SUMMARY ***
Total pot $3.25 | Rake $0.15
Board [5s 3c Td 3d]
Seat 1: 1WUCqNG+p+vfWRTXNu4ljw (small blind) folded before Flop
Seat 2: uVwggSetzp7d+eVgowO3vg (big blind) folded on the Turn
Seat 3: 4pp9WxhGdbVbxCc9tlu0lw folded before Flop (didn't bet)
Seat 4: r6u7MWSXF30/khcTYkrG9Q collected ($3.10)
Seat 5: M1KyQQvVPVuxqTAB8sR/zQ folded before Flop (didn't bet)
Seat 6: kxPhs4ePFqMy52CInAJ2aw (button) folded before Flop (didn't bet)



PokerStars Game #59940922640:  Hold'em No Limit ($0.25/$0.50) - 2009/07/01 1:20:32 ET
Table '+dXkOAQyS8j9PQZusUTMpg' 2-max Seat #2 is the button
Seat 1: Teld4PDKla7C8/Wfu2DSkg ($54.90 in chips)
Seat 2: +zI4bP23YIjMkUHqeN2xfw ($24.35 in chips)
+zI4bP23YIjMkUHqeN2xfw: posts small blind $0.25
Teld4PDKla7C8/Wfu2DSkg: posts big blind $0.50
*** HOLE CARDS ***
+zI4bP23YIjMkUHqeN2xfw: folds
Teld4PDKla7C8/Wfu2DSkg collected $0.50 from pot
Teld4PDKla7C8/Wfu2DSkg: doesn't show hand
*** SUMMARY ***
Total pot $0.50 | Rake $0
Seat 1: Teld4PDKla7C8/Wfu2DSkg (big blind) collected ($0.50)
Seat 2: +zI4bP23YIjMkUHqeN2xfw (button) (small blind) folded before Flop



PokerStars Game #59940922304:  Hold'em No Limit ($0.25/$0.50) - 2009/07/01 1:20:32 ET
Table '8BQGgNetI1NOvWeu3gtMNw' 2-max Seat #1 is the button
Seat 1: bypIyrYcAAifLfhZpGlKLA ($71.05 in chips)
Seat 2: Z4HwehErEwzsv/noQlfUlg ($119.40 in chips)
bypIyrYcAAifLfhZpGlKLA: posts small blind $0.25
Z4HwehErEwzsv/noQlfUlg: posts big blind $0.50
*** HOLE CARDS ***
bypIyrYcAAifLfhZpGlKLA: raises $0.50 to $1
Z4HwehErEwzsv/noQlfUlg: calls $0.50
*** FLOP *** [8h 5h 5c]
Z4HwehErEwzsv/noQlfUlg: bets $1
bypIyrYcAAifLfhZpGlKLA: calls $1
*** TURN *** [8h 5h 5c] [8c]
Z4HwehErEwzsv/noQlfUlg: bets $3
bypIyrYcAAifLfhZpGlKLA: raises $7 to $10
Z4HwehErEwzsv/noQlfUlg: folds
bypIyrYcAAifLfhZpGlKLA collected $9.55 from pot
bypIyrYcAAifLfhZpGlKLA: doesn't show hand
*** SUMMARY ***
Total pot $10 | Rake $0.45
Board [8h 5h 5c 8c]
Seat 1: bypIyrYcAAifLfhZpGlKLA (button) (small blind) collected ($9.55)
Seat 2: Z4HwehErEwzsv/noQlfUlg (big blind) folded on the Turn



PokerStars Game #59940924142:  Hold'em No Limit ($0.25/$0.50) - 2009/07/01 1:20:35 ET
Table 'fx6MqwfYAj/Rt86hBz2L3Q' 9-max Seat #9 is the button
Seat 1: v/4aX0ejnaIFK4ftDk2Lyg ($49 in chips)
Seat 2: C3rGXblctNcWI6JYPHhaEg ($44.10 in chips)
Seat 3: iadBi5AEt7gTBXbDSSnMYQ ($55.15 in chips)
Seat 5: iAISe3dVeua8PUn2wwgDHw ($65.15 in chips)
Seat 6: 5k9fvXD9suIgCxU4HLQjTw ($50 in chips)
Seat 7: SKnJuWHScqetA/qG5p+wCg ($33.95 in chips)
Seat 8: JYwJYYV9pM5KWdSiETl8rA ($29.25 in chips)
Seat 9: vO3QVRovWemcGMkm7ijAIA ($12.25 in chips)
v/4aX0ejnaIFK4ftDk2Lyg: posts small blind $0.25
C3rGXblctNcWI6JYPHhaEg: posts big blind $0.50
*** HOLE CARDS ***
iadBi5AEt7gTBXbDSSnMYQ: calls $0.50
iAISe3dVeua8PUn2wwgDHw: folds
5k9fvXD9suIgCxU4HLQjTw: folds
SKnJuWHScqetA/qG5p+wCg: calls $0.50
JYwJYYV9pM5KWdSiETl8rA: raises $2.50 to $3
vO3QVRovWemcGMkm7ijAIA: folds
v/4aX0ejnaIFK4ftDk2Lyg: folds
C3rGXblctNcWI6JYPHhaEg: calls $2.50
iadBi5AEt7gTBXbDSSnMYQ: calls $2.50
SKnJuWHScqetA/qG5p+wCg: calls $2.50
*** FLOP *** [Th Qc Ad]
C3rGXblctNcWI6JYPHhaEg: checks
iadBi5AEt7gTBXbDSSnMYQ: bets $1.50
SKnJuWHScqetA/qG5p+wCg: raises $6.50 to $8
JYwJYYV9pM5KWdSiETl8rA: calls $8
C3rGXblctNcWI6JYPHhaEg: folds
iadBi5AEt7gTBXbDSSnMYQ: folds
*** TURN *** [Th Qc Ad] [6s]
SKnJuWHScqetA/qG5p+wCg: bets $14
JYwJYYV9pM5KWdSiETl8rA: raises $4.25 to $18.25 and is all-in
SKnJuWHScqetA/qG5p+wCg: calls $4.25
*** RIVER *** [Th Qc Ad 6s] [3d]
*** SHOW DOWN ***
SKnJuWHScqetA/qG5p+wCg: shows [Ts Tc] (three of a kind, Tens)
JYwJYYV9pM5KWdSiETl8rA: shows [Qh Qd] (three of a kind, Queens)
JYwJYYV9pM5KWdSiETl8rA collected $63.25 from pot
*** SUMMARY ***
Total pot $66.25 | Rake $3
Board [Th Qc Ad 6s 3d]
Seat 1: v/4aX0ejnaIFK4ftDk2Lyg (small blind) folded before Flop
Seat 2: C3rGXblctNcWI6JYPHhaEg (big blind) folded on the Flop
Seat 3: iadBi5AEt7gTBXbDSSnMYQ folded on the Flop
Seat 5: iAISe3dVeua8PUn2wwgDHw folded before Flop (didn't bet)
Seat 6: 5k9fvXD9suIgCxU4HLQjTw folded before Flop (didn't bet)
Seat 7: SKnJuWHScqetA/qG5p+wCg showed [Ts Tc] and lost with three of a kind, Tens
Seat 8: JYwJYYV9pM5KWdSiETl8rA showed [Qh Qd] and won ($63.25) with three of a kind, Queens
Seat 9: vO3QVRovWemcGMkm7ijAIA (button) folded before Flop (didn't bet)



PokerStars Game #59940924796:  Hold'em No Limit ($0.25/$0.50) - 2009/07/01 1:20:36 ET
Table 'Nz0Vr7WMHL2g5Uk7dDZjpw' 9-max Seat #6 is the button
Seat 2: gsyXT42WLEcOS4DdEk2wlw ($37.20 in chips)
Seat 3: hoglu9inkgs6zN573/bJag ($7.20 in chips)
Seat 4: E2518gp4aFz1+kAgmGqeEg ($13 in chips)
Seat 5: WGW0DgjBUXs1ylURHG8vnQ ($14.50 in chips)
Seat 6: 997ViqAtWn1FPjJqcffwcA ($58.05 in chips)
Seat 7: KPLH0gELgFe2OuAnhJFI5w ($23.95 in chips)
Seat 8: aoL+R/61Kxmw69ypuPrWAQ ($27.75 in chips)
Seat 9: mSD1pginDsyHG5PDfqzphw ($10 in chips)
KPLH0gELgFe2OuAnhJFI5w: posts small blind $0.25
aoL+R/61Kxmw69ypuPrWAQ: posts big blind $0.50
*** HOLE CARDS ***
mSD1pginDsyHG5PDfqzphw: folds
gsyXT42WLEcOS4DdEk2wlw: folds
hoglu9inkgs6zN573/bJag: folds
E2518gp4aFz1+kAgmGqeEg: folds
WGW0DgjBUXs1ylURHG8vnQ: folds
997ViqAtWn1FPjJqcffwcA: folds
KPLH0gELgFe2OuAnhJFI5w: calls $0.25
aoL+R/61Kxmw69ypuPrWAQ: raises $1.50 to $2
KPLH0gELgFe2OuAnhJFI5w: calls $1.50
*** FLOP *** [Ks Kd 3c]
KPLH0gELgFe2OuAnhJFI5w: checks
aoL+R/61Kxmw69ypuPrWAQ: bets $2
KPLH0gELgFe2OuAnhJFI5w: folds
aoL+R/61Kxmw69ypuPrWAQ collected $3.80 from pot
*** SUMMARY ***
Total pot $4 | Rake $0.20
Board [Ks Kd 3c]
Seat 2: gsyXT42WLEcOS4DdEk2wlw folded before Flop (didn't bet)
Seat 3: hoglu9inkgs6zN573/bJag folded before Flop (didn't bet)
Seat 4: E2518gp4aFz1+kAgmGqeEg folded before Flop (didn't bet)
Seat 5: WGW0DgjBUXs1ylURHG8vnQ folded before Flop (didn't bet)
Seat 6: 997ViqAtWn1FPjJqcffwcA (button) folded before Flop (didn't bet)
Seat 7: KPLH0gELgFe2OuAnhJFI5w (small blind) folded on the Flop
Seat 8: aoL+R/61Kxmw69ypuPrWAQ (big blind) collected ($3.80)
Seat 9: mSD1pginDsyHG5PDfqzphw folded before Flop (didn't bet)



PokerStars Game #59940924938:  Hold'em No Limit ($0.25/$0.50) - 2009/07/01 1:20:36 ET
Table 'kgbJRsxfv64KrErDRBAkcw' 6-max Seat #4 is the button
Seat 1: VamsyhlFzXGF6/ydo0BHeA ($42.80 in chips)
Seat 2: AdS8BJMOheS01zjCDfPMFg ($50 in chips)
Seat 4: 2igtJLmvIZ+HqX4XPgMPZA ($50 in chips)
Seat 5: eUBBn2R56C1IQ6Cs/vitwg ($50 in chips)
Seat 6: 1b+2BbjMN8qhR1WPqdE9VQ ($50 in chips)
c4MNIaIyPMOMxrgT8FT5nA has returned
eUBBn2R56C1IQ6Cs/vitwg: posts small blind $0.25
1b+2BbjMN8qhR1WPqdE9VQ: posts big blind $0.50
*** HOLE CARDS ***
VamsyhlFzXGF6/ydo0BHeA: raises $1.50 to $2
AdS8BJMOheS01zjCDfPMFg: folds
2igtJLmvIZ+HqX4XPgMPZA: folds
eUBBn2R56C1IQ6Cs/vitwg: folds
1b+2BbjMN8qhR1WPqdE9VQ: folds
VamsyhlFzXGF6/ydo0BHeA collected $1.25 from pot
VamsyhlFzXGF6/ydo0BHeA: doesn't show hand
*** SUMMARY ***
Total pot $1.25 | Rake $0
Seat 1: VamsyhlFzXGF6/ydo0BHeA collected ($1.25)
Seat 2: AdS8BJMOheS01zjCDfPMFg folded before Flop (didn't bet)
Seat 4: 2igtJLmvIZ+HqX4XPgMPZA (button) folded before Flop (didn't bet)
Seat 5: eUBBn2R56C1IQ6Cs/vitwg (small blind) folded before Flop
Seat 6: 1b+2BbjMN8qhR1WPqdE9VQ (big blind) folded before Flop



PokerStars Game #59940924760:  Hold'em No Limit ($0.25/$0.50) - 2009/07/01 1:20:36 ET
Table 'QOgaEqMcJ73pcUMMxoisUg' 6-max Seat #3 is the button
Seat 1: lxIzoHy0RnkfFSODHC2liw ($50 in chips)
Seat 2: oqOqoO2AyCZenUghCxMDxw ($63.90 in chips)
Seat 3: Rt6KgtZ8YaJoTc3FPim00w ($57.60 in chips)
Seat 4: zAcsDhG/T128Vn7XGVSgKg ($60.50 in chips)
Seat 6: AdS8BJMOheS01zjCDfPMFg ($97.70 in chips)
zAcsDhG/T128Vn7XGVSgKg: posts small blind $0.25
AdS8BJMOheS01zjCDfPMFg: posts big blind $0.50
*** HOLE CARDS ***
lxIzoHy0RnkfFSODHC2liw: raises $1 to $1.50
oqOqoO2AyCZenUghCxMDxw: folds
Rt6KgtZ8YaJoTc3FPim00w: folds
zAcsDhG/T128Vn7XGVSgKg: folds
AdS8BJMOheS01zjCDfPMFg: folds
lxIzoHy0RnkfFSODHC2liw collected $1.25 from pot
*** SUMMARY ***
Total pot $1.25 | Rake $0
Seat 1: lxIzoHy0RnkfFSODHC2liw collected ($1.25)
Seat 2: oqOqoO2AyCZenUghCxMDxw folded before Flop (didn't bet)
Seat 3: Rt6KgtZ8YaJoTc3FPim00w (button) folded before Flop (didn't bet)
Seat 4: zAcsDhG/T128Vn7XGVSgKg (small blind) folded before Flop
Seat 6: AdS8BJMOheS01zjCDfPMFg (big blind) folded before Flop



PokerStars Game #59940925516:  Hold'em No Limit ($0.25/$0.50) - 2009/07/01 1:20:37 ET
Table 'NCiXr0d5CEKBQr/cZgLhbA' 9-max Seat #3 is the button
Seat 1: pFtzb1sR4b0d1aw6aIRgDg ($55.70 in chips)
Seat 2: AjV5McH1KMMclY26QdLM5w ($25 in chips)
Seat 3: xZCXQSXlrZkp3pZizzVXCw ($53.05 in chips)
Seat 4: 5k9fvXD9suIgCxU4HLQjTw ($54.20 in chips)
Seat 5: Ja2jdidjip2UeJnRzmzAAQ ($50 in chips)
Seat 7: M+7+BTmX5vZatHVuoRB1nA ($40.90 in chips)
Seat 8: 1MJUKc3cc0QmUoz1JZLR2w ($63.95 in chips)
Seat 9: 4WLZvqBn5qv5tds5kt5A1Q ($55.25 in chips)
5k9fvXD9suIgCxU4HLQjTw: posts small blind $0.25
Ja2jdidjip2UeJnRzmzAAQ: posts big blind $0.50
cards4hire: sits out
*** HOLE CARDS ***
M+7+BTmX5vZatHVuoRB1nA: calls $0.50
1MJUKc3cc0QmUoz1JZLR2w: folds
4WLZvqBn5qv5tds5kt5A1Q: calls $0.50
pFtzb1sR4b0d1aw6aIRgDg: folds
AjV5McH1KMMclY26QdLM5w: folds
xZCXQSXlrZkp3pZizzVXCw: raises $2.50 to $3
5k9fvXD9suIgCxU4HLQjTw: folds
Ja2jdidjip2UeJnRzmzAAQ: folds
M+7+BTmX5vZatHVuoRB1nA: calls $2.50
4WLZvqBn5qv5tds5kt5A1Q: folds
*** FLOP *** [3d Jd Jc]
M+7+BTmX5vZatHVuoRB1nA: checks
xZCXQSXlrZkp3pZizzVXCw: bets $5
M+7+BTmX5vZatHVuoRB1nA: calls $5
*** TURN *** [3d Jd Jc] [8d]
M+7+BTmX5vZatHVuoRB1nA: checks
xZCXQSXlrZkp3pZizzVXCw: bets $12
M+7+BTmX5vZatHVuoRB1nA: raises $12 to $24
xZCXQSXlrZkp3pZizzVXCw: raises $21.05 to $45.05 and is all-in
M+7+BTmX5vZatHVuoRB1nA: calls $8.90 and is all-in
*** RIVER *** [3d Jd Jc 8d] [Ts]
*** SHOW DOWN ***
M+7+BTmX5vZatHVuoRB1nA: shows [Ad As] (two pair, Aces and Jacks)
xZCXQSXlrZkp3pZizzVXCw: shows [7d 9d] (a flush, Jack high)
xZCXQSXlrZkp3pZizzVXCw collected $80.05 from pot
*** SUMMARY ***
Total pot $83.05 | Rake $3
Board [3d Jd Jc 8d Ts]
Seat 1: pFtzb1sR4b0d1aw6aIRgDg folded before Flop (didn't bet)
Seat 2: AjV5McH1KMMclY26QdLM5w folded before Flop (didn't bet)
Seat 3: xZCXQSXlrZkp3pZizzVXCw (button) showed [7d 9d] and won ($80.05) with a flush, Jack high
Seat 4: 5k9fvXD9suIgCxU4HLQjTw (small blind) folded before Flop
Seat 5: Ja2jdidjip2UeJnRzmzAAQ (big blind) folded before Flop
Seat 7: M+7+BTmX5vZatHVuoRB1nA showed [Ad As] and lost with two pair, Aces and Jacks
Seat 8: 1MJUKc3cc0QmUoz1JZLR2w folded before Flop (didn't bet)
Seat 9: 4WLZvqBn5qv5tds5kt5A1Q folded before Flop



PokerStars Game #59940925982:  Hold'em No Limit ($0.25/$0.50) - 2009/07/01 1:20:38 ET
Table '+dXkOAQyS8j9PQZusUTMpg' 2-max Seat #1 is the button
Seat 1: Teld4PDKla7C8/Wfu2DSkg ($55.15 in chips)
Seat 2: +zI4bP23YIjMkUHqeN2xfw ($24.10 in chips)
Teld4PDKla7C8/Wfu2DSkg: posts small blind $0.25
+zI4bP23YIjMkUHqeN2xfw: posts big blind $0.50
*** HOLE CARDS ***
Teld4PDKla7C8/Wfu2DSkg: calls $0.25
+zI4bP23YIjMkUHqeN2xfw: raises $1.50 to $2
Teld4PDKla7C8/Wfu2DSkg: folds
+zI4bP23YIjMkUHqeN2xfw collected $1 from pot
*** SUMMARY ***
Total pot $1 | Rake $0
Seat 1: Teld4PDKla7C8/Wfu2DSkg (button) (small blind) folded before Flop
Seat 2: +zI4bP23YIjMkUHqeN2xfw (big blind) collected ($1)



PokerStars Game #59940926226:  Hold'em No Limit ($0.25/$0.50) - 2009/07/01 1:20:39 ET
Table 'ibNfFy0bCzuBaUORla0aGw' 9-max Seat #6 is the button
Seat 1: xZCXQSXlrZkp3pZizzVXCw ($50.55 in chips)
Seat 2: 90Wb75h3W1BRpbqVnuk8gw ($50 in chips)
Seat 3: AjV5McH1KMMclY26QdLM5w ($27.10 in chips)
Seat 5: GIJAc9kPrLZHLSX8Q6i99w ($27.30 in chips)
Seat 6: H8cPaCtX7d6meGUVSM5sxw ($55.75 in chips)
Seat 7: HZkVla4kK2SI42CVrPZ/ig ($13.25 in chips)
Seat 8: Ja2jdidjip2UeJnRzmzAAQ ($50 in chips)
Seat 9: pFtzb1sR4b0d1aw6aIRgDg ($56.50 in chips)
HZkVla4kK2SI42CVrPZ/ig: posts small blind $0.25
Ja2jdidjip2UeJnRzmzAAQ: posts big blind $0.50
*** HOLE CARDS ***
pFtzb1sR4b0d1aw6aIRgDg: folds
konztelated joins the table at seat #4
xZCXQSXlrZkp3pZizzVXCw: folds
90Wb75h3W1BRpbqVnuk8gw: raises $1.50 to $2
AjV5McH1KMMclY26QdLM5w: folds
GIJAc9kPrLZHLSX8Q6i99w: folds
H8cPaCtX7d6meGUVSM5sxw: folds
HZkVla4kK2SI42CVrPZ/ig: folds
Ja2jdidjip2UeJnRzmzAAQ: folds
90Wb75h3W1BRpbqVnuk8gw collected $1.25 from pot
*** SUMMARY ***
Total pot $1.25 | Rake $0
Seat 1: xZCXQSXlrZkp3pZizzVXCw folded before Flop (didn't bet)
Seat 2: 90Wb75h3W1BRpbqVnuk8gw collected ($1.25)
Seat 3: AjV5McH1KMMclY26QdLM5w folded before Flop (didn't bet)
Seat 5: GIJAc9kPrLZHLSX8Q6i99w folded before Flop (didn't bet)
Seat 6: H8cPaCtX7d6meGUVSM5sxw (button) folded before Flop (didn't bet)
Seat 7: HZkVla4kK2SI42CVrPZ/ig (small blind) folded before Flop
Seat 8: Ja2jdidjip2UeJnRzmzAAQ (big blind) folded before Flop
Seat 9: pFtzb1sR4b0d1aw6aIRgDg folded before Flop (didn't bet)



PokerStars Game #59940928100:  Hold'em No Limit ($0.25/$0.50) - 2009/07/01 1:20:42 ET
Table 'ofnd8S4IdIPph1Cbn+x7hA' 2-max Seat #1 is the button
Seat 1: PY4NvRocCFPfSIHKbh0euQ ($25.30 in chips)
Seat 2: l5WbyJ/iWYjpeCC6GCYY6w ($69.05 in chips)
PY4NvRocCFPfSIHKbh0euQ: posts small blind $0.25
l5WbyJ/iWYjpeCC6GCYY6w: posts big blind $0.50
*** HOLE CARDS ***
PY4NvRocCFPfSIHKbh0euQ: raises $1 to $1.50
l5WbyJ/iWYjpeCC6GCYY6w: calls $1
*** FLOP *** [9c Kc Js]
l5WbyJ/iWYjpeCC6GCYY6w: checks
PY4NvRocCFPfSIHKbh0euQ: bets $0.50
l5WbyJ/iWYjpeCC6GCYY6w: calls $0.50
*** TURN *** [9c Kc Js] [Kd]
l5WbyJ/iWYjpeCC6GCYY6w: checks
PY4NvRocCFPfSIHKbh0euQ: bets $1.50
l5WbyJ/iWYjpeCC6GCYY6w: calls $1.50
*** RIVER *** [9c Kc Js Kd] [Kh]
l5WbyJ/iWYjpeCC6GCYY6w: checks
PY4NvRocCFPfSIHKbh0euQ: checks
*** SHOW DOWN ***
l5WbyJ/iWYjpeCC6GCYY6w: shows [Jh Th] (a full house, Kings full of Jacks)
PY4NvRocCFPfSIHKbh0euQ: mucks hand
l5WbyJ/iWYjpeCC6GCYY6w collected $6.70 from pot
*** SUMMARY ***
Total pot $7 | Rake $0.30
Board [9c Kc Js Kd Kh]
Seat 1: PY4NvRocCFPfSIHKbh0euQ (button) (small blind) mucked
Seat 2: l5WbyJ/iWYjpeCC6GCYY6w (big blind) showed [Jh Th] and won ($6.70) with a full house, Kings full of Jacks



PokerStars Game #59940929736:  Hold'em No Limit ($0.25/$0.50) - 2009/07/01 1:20:45 ET
Table 'c/CRn+68J3Y8KxD5g1ek2Q' 2-max Seat #1 is the button
Seat 1: 46qCyJ6evTkHo9al5sBMNA ($109.85 in chips)
Seat 2: BypVLsYQt3ePFm2xQL/dOA ($251.35 in chips)
46qCyJ6evTkHo9al5sBMNA: posts small blind $0.25
BypVLsYQt3ePFm2xQL/dOA: posts big blind $0.50
*** HOLE CARDS ***
46qCyJ6evTkHo9al5sBMNA: folds
BypVLsYQt3ePFm2xQL/dOA collected $0.50 from pot
BypVLsYQt3ePFm2xQL/dOA: doesn't show hand
*** SUMMARY ***
Total pot $0.50 | Rake $0
Seat 1: 46qCyJ6evTkHo9al5sBMNA (button) (small blind) folded before Flop
Seat 2: BypVLsYQt3ePFm2xQL/dOA (big blind) collected ($0.50)



PokerStars Game #59940929998:  Hold'em No Limit ($0.25/$0.50) - 2009/07/01 1:20:45 ET
Table 'iq+aXfWVQRdV0u8SRTYUEg' 9-max Seat #5 is the button
Seat 1: 3yl8Q6QaLfGtyhN4/pEFgQ ($61.35 in chips)
Seat 2: J9N0lxHFd/Js2S0xZLbsIQ ($35.95 in chips)
Seat 3: YcxPb+VB8VLtuLPBaYcMjA ($15.75 in chips)
Seat 5: 997ViqAtWn1FPjJqcffwcA ($50 in chips)
Seat 6: bTJ0WgoxefTPxIoycS7uoA ($31.85 in chips)
Seat 7: SKnJuWHScqetA/qG5p+wCg ($32.30 in chips)
Seat 8: /DtIHuxEH+3tzKefmSV+Mw ($17.55 in chips)
Seat 9: olE1Z2rKWAV8+tGqmIBK9g ($22.85 in chips)
bTJ0WgoxefTPxIoycS7uoA: posts small blind $0.25
SKnJuWHScqetA/qG5p+wCg: posts big blind $0.50
*** HOLE CARDS ***
/DtIHuxEH+3tzKefmSV+Mw: folds
olE1Z2rKWAV8+tGqmIBK9g: calls $0.50
3yl8Q6QaLfGtyhN4/pEFgQ: folds
J9N0lxHFd/Js2S0xZLbsIQ: folds
YcxPb+VB8VLtuLPBaYcMjA: folds
997ViqAtWn1FPjJqcffwcA: folds
bTJ0WgoxefTPxIoycS7uoA: folds
SKnJuWHScqetA/qG5p+wCg: checks
*** FLOP *** [Td 3c 3d]
SKnJuWHScqetA/qG5p+wCg: checks
olE1Z2rKWAV8+tGqmIBK9g: bets $0.50
SKnJuWHScqetA/qG5p+wCg: folds
olE1Z2rKWAV8+tGqmIBK9g collected $1.20 from pot
*** SUMMARY ***
Total pot $1.25 | Rake $0.05
Board [Td 3c 3d]
Seat 1: 3yl8Q6QaLfGtyhN4/pEFgQ folded before Flop (didn't bet)
Seat 2: J9N0lxHFd/Js2S0xZLbsIQ folded before Flop (didn't bet)
Seat 3: YcxPb+VB8VLtuLPBaYcMjA folded before Flop (didn't bet)
Seat 5: 997ViqAtWn1FPjJqcffwcA (button) folded before Flop (didn't bet)
Seat 6: bTJ0WgoxefTPxIoycS7uoA (small blind) folded before Flop
Seat 7: SKnJuWHScqetA/qG5p+wCg (big blind) folded on the Flop
Seat 8: /DtIHuxEH+3tzKefmSV+Mw folded before Flop (didn't bet)
Seat 9: olE1Z2rKWAV8+tGqmIBK9g collected ($1.20)



PokerStars Game #59940931278:  Hold'em No Limit ($0.25/$0.50) - 2009/07/01 1:20:48 ET
Table '+dXkOAQyS8j9PQZusUTMpg' 2-max Seat #2 is the button
Seat 1: Teld4PDKla7C8/Wfu2DSkg ($54.65 in chips)
Seat 2: +zI4bP23YIjMkUHqeN2xfw ($24.60 in chips)
+zI4bP23YIjMkUHqeN2xfw: posts small blind $0.25
Teld4PDKla7C8/Wfu2DSkg: posts big blind $0.50
*** HOLE CARDS ***
+zI4bP23YIjMkUHqeN2xfw: folds
Teld4PDKla7C8/Wfu2DSkg collected $0.50 from pot
*** SUMMARY ***
Total pot $0.50 | Rake $0
Seat 1: Teld4PDKla7C8/Wfu2DSkg (big blind) collected ($0.50)
Seat 2: +zI4bP23YIjMkUHqeN2xfw (button) (small blind) folded before Flop



PokerStars Game #59940933356:  Hold'em No Limit ($0.25/$0.50) - 2009/07/01 1:20:51 ET
Table 'c/CRn+68J3Y8KxD5g1ek2Q' 2-max Seat #2 is the button
Seat 1: 46qCyJ6evTkHo9al5sBMNA ($109.60 in chips)
Seat 2: BypVLsYQt3ePFm2xQL/dOA ($251.60 in chips)
BypVLsYQt3ePFm2xQL/dOA: posts small blind $0.25
46qCyJ6evTkHo9al5sBMNA: posts big blind $0.50
*** HOLE CARDS ***
BypVLsYQt3ePFm2xQL/dOA: calls $0.25
46qCyJ6evTkHo9al5sBMNA: raises $1.50 to $2
BypVLsYQt3ePFm2xQL/dOA: calls $1.50
*** FLOP *** [3s 3d 6h]
46qCyJ6evTkHo9al5sBMNA: checks
BypVLsYQt3ePFm2xQL/dOA: checks
*** TURN *** [3s 3d 6h] [5h]
46qCyJ6evTkHo9al5sBMNA: checks
BypVLsYQt3ePFm2xQL/dOA: bets $2.50
46qCyJ6evTkHo9al5sBMNA: folds
BypVLsYQt3ePFm2xQL/dOA collected $3.80 from pot
BypVLsYQt3ePFm2xQL/dOA: doesn't show hand
*** SUMMARY ***
Total pot $4 | Rake $0.20
Board [3s 3d 6h 5h]
Seat 1: 46qCyJ6evTkHo9al5sBMNA (big blind) folded on the Turn
Seat 2: BypVLsYQt3ePFm2xQL/dOA (button) (small blind) collected ($3.80)



PokerStars Game #59940933358:  Hold'em No Limit ($0.25/$0.50) - 2009/07/01 1:20:51 ET
Table 'otvGDROEDdqsabxskT79qg' 9-max Seat #1 is the button
Seat 1: 8ehL7qlZzjgUh2H35iiWLw ($59 in chips)
Seat 2: cCjTzH9jio8607WzjcfXlg ($10.90 in chips)
Seat 3: +k7T5ocke8UwavtgUHm+Cg ($74.50 in chips)
Seat 4: MG90wfSJZnOejs/KD3vlQQ ($80.65 in chips)
Seat 5: E2518gp4aFz1+kAgmGqeEg ($12.20 in chips)
Seat 6: bxLSulbgr8LmKNjOzw8URg ($55.25 in chips)
Seat 7: 75K2MXwN65Sjfp1yHd50Hg ($13.75 in chips)
Seat 8: zE9cVigS2nW/Ljy4K4bUQA ($32.55 in chips)
Seat 9: KcY3X8YpD74Kw1RHkx/g4A ($34.15 in chips)
cCjTzH9jio8607WzjcfXlg: posts small blind $0.25
+k7T5ocke8UwavtgUHm+Cg: posts big blind $0.50
*** HOLE CARDS ***
MG90wfSJZnOejs/KD3vlQQ: folds
E2518gp4aFz1+kAgmGqeEg: folds
bxLSulbgr8LmKNjOzw8URg: folds
75K2MXwN65Sjfp1yHd50Hg: folds
zE9cVigS2nW/Ljy4K4bUQA: raises $1 to $1.50
KcY3X8YpD74Kw1RHkx/g4A: folds
8ehL7qlZzjgUh2H35iiWLw: folds
cCjTzH9jio8607WzjcfXlg: folds
+k7T5ocke8UwavtgUHm+Cg: folds
zE9cVigS2nW/Ljy4K4bUQA collected $1.25 from pot
zE9cVigS2nW/Ljy4K4bUQA: doesn't show hand
*** SUMMARY ***
Total pot $1.25 | Rake $0
Seat 1: 8ehL7qlZzjgUh2H35iiWLw (button) folded before Flop (didn't bet)
Seat 2: cCjTzH9jio8607WzjcfXlg (small blind) folded before Flop
Seat 3: +k7T5ocke8UwavtgUHm+Cg (big blind) folded before Flop
Seat 4: MG90wfSJZnOejs/KD3vlQQ folded before Flop (didn't bet)
Seat 5: E2518gp4aFz1+kAgmGqeEg folded before Flop (didn't bet)
Seat 6: bxLSulbgr8LmKNjOzw8URg folded before Flop (didn't bet)
Seat 7: 75K2MXwN65Sjfp1yHd50Hg folded before Flop (didn't bet)
Seat 8: zE9cVigS2nW/Ljy4K4bUQA collected ($1.25)
Seat 9: KcY3X8YpD74Kw1RHkx/g4A folded before Flop (didn't bet)



PokerStars Game #59940934420:  Hold'em No Limit ($0.25/$0.50) - 2009/07/01 1:20:53 ET
Table '+dXkOAQyS8j9PQZusUTMpg' 2-max Seat #1 is the button
Seat 1: Teld4PDKla7C8/Wfu2DSkg ($54.90 in chips)
Seat 2: +zI4bP23YIjMkUHqeN2xfw ($24.35 in chips)
Teld4PDKla7C8/Wfu2DSkg: posts small blind $0.25
+zI4bP23YIjMkUHqeN2xfw: posts big blind $0.50
*** HOLE CARDS ***
Teld4PDKla7C8/Wfu2DSkg: raises $1 to $1.50
+zI4bP23YIjMkUHqeN2xfw: folds
Teld4PDKla7C8/Wfu2DSkg collected $1 from pot
Teld4PDKla7C8/Wfu2DSkg: doesn't show hand
*** SUMMARY ***
Total pot $1 | Rake $0
Seat 1: Teld4PDKla7C8/Wfu2DSkg (button) (small blind) collected ($1)
Seat 2: +zI4bP23YIjMkUHqeN2xfw (big blind) folded before Flop



PokerStars Game #59940935958:  Hold'em No Limit ($0.25/$0.50) - 2009/07/01 1:20:56 ET
Table 'tyR5AZNKV8Aadbrnrnlg7g' 6-max Seat #6 is the button
Seat 1: BgOXYI0yYSN1ULC4FqsNkg ($97.30 in chips)
Seat 2: BAjwVL+zKKd0s0fAWstzQQ ($50.30 in chips)
Seat 3: JFLrYNyQmwPhRQAtoSAuyA ($49.85 in chips)
Seat 4: 4QfsCWthT/vSLirorNXqtg ($88.70 in chips)
Seat 5: GUnvMULl2qFOO1yenu1UBw ($50 in chips)
Seat 6: 498aWaGsW4uGfuWl+2FCGw ($46.40 in chips)
BgOXYI0yYSN1ULC4FqsNkg: posts small blind $0.25
BAjwVL+zKKd0s0fAWstzQQ: posts big blind $0.50
*** HOLE CARDS ***
JFLrYNyQmwPhRQAtoSAuyA: raises $1 to $1.50
4QfsCWthT/vSLirorNXqtg: folds
GUnvMULl2qFOO1yenu1UBw: folds
498aWaGsW4uGfuWl+2FCGw: calls $1.50
BgOXYI0yYSN1ULC4FqsNkg: folds
BAjwVL+zKKd0s0fAWstzQQ: calls $1
*** FLOP *** [7d 6h 3c]
BAjwVL+zKKd0s0fAWstzQQ: checks
JFLrYNyQmwPhRQAtoSAuyA: bets $3.50
498aWaGsW4uGfuWl+2FCGw: folds
BAjwVL+zKKd0s0fAWstzQQ: calls $3.50
*** TURN *** [7d 6h 3c] [6c]
BAjwVL+zKKd0s0fAWstzQQ: checks
JFLrYNyQmwPhRQAtoSAuyA: checks
*** RIVER *** [7d 6h 3c 6c] [Kc]
BAjwVL+zKKd0s0fAWstzQQ: bets $4
JFLrYNyQmwPhRQAtoSAuyA: folds
BAjwVL+zKKd0s0fAWstzQQ collected $11.20 from pot
BAjwVL+zKKd0s0fAWstzQQ: doesn't show hand
*** SUMMARY ***
Total pot $11.75 | Rake $0.55
Board [7d 6h 3c 6c Kc]
Seat 1: BgOXYI0yYSN1ULC4FqsNkg (small blind) folded before Flop
Seat 2: BAjwVL+zKKd0s0fAWstzQQ (big blind) collected ($11.20)
Seat 3: JFLrYNyQmwPhRQAtoSAuyA folded on the River
Seat 4: 4QfsCWthT/vSLirorNXqtg folded before Flop (didn't bet)
Seat 5: GUnvMULl2qFOO1yenu1UBw folded before Flop (didn't bet)
Seat 6: 498aWaGsW4uGfuWl+2FCGw (button) folded on the Flop



PokerStars Game #59940937950:  Hold'em No Limit ($0.25/$0.50) - 2009/07/01 1:21:00 ET
Table 'kgbJRsxfv64KrErDRBAkcw' 6-max Seat #5 is the button
Seat 1: VamsyhlFzXGF6/ydo0BHeA ($43.55 in chips)
Seat 2: AdS8BJMOheS01zjCDfPMFg ($50 in chips)
Seat 3: c4MNIaIyPMOMxrgT8FT5nA ($225.70 in chips)
Seat 4: 2igtJLmvIZ+HqX4XPgMPZA ($50 in chips)
Seat 5: eUBBn2R56C1IQ6Cs/vitwg ($50 in chips)
Seat 6: 1b+2BbjMN8qhR1WPqdE9VQ ($50 in chips)
1b+2BbjMN8qhR1WPqdE9VQ: posts small blind $0.25
VamsyhlFzXGF6/ydo0BHeA: posts big blind $0.50
*** HOLE CARDS ***
AdS8BJMOheS01zjCDfPMFg: folds
c4MNIaIyPMOMxrgT8FT5nA: calls $0.50
2igtJLmvIZ+HqX4XPgMPZA: raises $2 to $2.50
eUBBn2R56C1IQ6Cs/vitwg: folds
1b+2BbjMN8qhR1WPqdE9VQ: calls $2.25
VamsyhlFzXGF6/ydo0BHeA: calls $2
c4MNIaIyPMOMxrgT8FT5nA: folds
*** FLOP *** [Qs 5s 2h]
1b+2BbjMN8qhR1WPqdE9VQ: checks
VamsyhlFzXGF6/ydo0BHeA: checks
2igtJLmvIZ+HqX4XPgMPZA: checks
*** TURN *** [Qs 5s 2h] [7s]
1b+2BbjMN8qhR1WPqdE9VQ: bets $5
VamsyhlFzXGF6/ydo0BHeA: calls $5
2igtJLmvIZ+HqX4XPgMPZA: folds
*** RIVER *** [Qs 5s 2h 7s] [Kd]
1b+2BbjMN8qhR1WPqdE9VQ: bets $13
VamsyhlFzXGF6/ydo0BHeA: folds
1b+2BbjMN8qhR1WPqdE9VQ collected $17.15 from pot
1b+2BbjMN8qhR1WPqdE9VQ: doesn't show hand
*** SUMMARY ***
Total pot $18 | Rake $0.85
Board [Qs 5s 2h 7s Kd]
Seat 1: VamsyhlFzXGF6/ydo0BHeA (big blind) folded on the River
Seat 2: AdS8BJMOheS01zjCDfPMFg folded before Flop (didn't bet)
Seat 3: c4MNIaIyPMOMxrgT8FT5nA folded before Flop
Seat 4: 2igtJLmvIZ+HqX4XPgMPZA folded on the Turn
Seat 5: eUBBn2R56C1IQ6Cs/vitwg (button) folded before Flop (didn't bet)
Seat 6: 1b+2BbjMN8qhR1WPqdE9VQ (small blind) collected ($17.15)



PokerStars Game #59940937726:  Hold'em No Limit ($0.25/$0.50) - 2009/07/01 1:21:00 ET
Table '8BQGgNetI1NOvWeu3gtMNw' 2-max Seat #2 is the button
Seat 1: bypIyrYcAAifLfhZpGlKLA ($75.60 in chips)
Seat 2: Z4HwehErEwzsv/noQlfUlg ($114.40 in chips)
Z4HwehErEwzsv/noQlfUlg: posts small blind $0.25
bypIyrYcAAifLfhZpGlKLA: posts big blind $0.50
*** HOLE CARDS ***
Z4HwehErEwzsv/noQlfUlg: raises $1.50 to $2
bypIyrYcAAifLfhZpGlKLA: raises $6 to $8
Z4HwehErEwzsv/noQlfUlg: calls $6
*** FLOP *** [3d 7d 4c]
bypIyrYcAAifLfhZpGlKLA: checks
Z4HwehErEwzsv/noQlfUlg: checks
*** TURN *** [3d 7d 4c] [Qd]
bypIyrYcAAifLfhZpGlKLA: checks
Z4HwehErEwzsv/noQlfUlg: bets $12
bypIyrYcAAifLfhZpGlKLA: folds
Z4HwehErEwzsv/noQlfUlg collected $15.50 from pot
Z4HwehErEwzsv/noQlfUlg: doesn't show hand
*** SUMMARY ***
Total pot $16 | Rake $0.50
Board [3d 7d 4c Qd]
Seat 1: bypIyrYcAAifLfhZpGlKLA (big blind) folded on the Turn
Seat 2: Z4HwehErEwzsv/noQlfUlg (button) (small blind) collected ($15.50)



PokerStars Game #59940937824:  Hold'em No Limit ($0.25/$0.50) - 2009/07/01 1:21:00 ET
Table 'BCN5su+SsXiy1zRMJi0SJw' 6-max Seat #2 is the button
Seat 1: GxXV09ciXaOxyY2H5aMIIw ($48.35 in chips)
Seat 2: ehFNAevCQri3trWxV6FJdA ($34.45 in chips)
Seat 3: kwgv5lNhiFrfONXCshzxlA ($45.95 in chips)
Seat 6: b2symlOdL7+0c9Pj4N/KlA ($56.90 in chips)
kwgv5lNhiFrfONXCshzxlA: posts small blind $0.25
b2symlOdL7+0c9Pj4N/KlA: posts big blind $0.50
*** HOLE CARDS ***
GxXV09ciXaOxyY2H5aMIIw: folds
ehFNAevCQri3trWxV6FJdA: calls $0.50
kwgv5lNhiFrfONXCshzxlA: calls $0.25
b2symlOdL7+0c9Pj4N/KlA: checks
*** FLOP *** [Ac 7d Ah]
Tjugen joins the table at seat #4
kwgv5lNhiFrfONXCshzxlA: bets $1
b2symlOdL7+0c9Pj4N/KlA: calls $1
ehFNAevCQri3trWxV6FJdA: folds
*** TURN *** [Ac 7d Ah] [5s]
kwgv5lNhiFrfONXCshzxlA: checks
b2symlOdL7+0c9Pj4N/KlA: bets $2
kwgv5lNhiFrfONXCshzxlA: folds
b2symlOdL7+0c9Pj4N/KlA collected $3.35 from pot
b2symlOdL7+0c9Pj4N/KlA: doesn't show hand
*** SUMMARY ***
Total pot $3.50 | Rake $0.15
Board [Ac 7d Ah 5s]
Seat 1: GxXV09ciXaOxyY2H5aMIIw folded before Flop (didn't bet)
Seat 2: ehFNAevCQri3trWxV6FJdA (button) folded on the Flop
Seat 3: kwgv5lNhiFrfONXCshzxlA (small blind) folded on the Turn
Seat 6: b2symlOdL7+0c9Pj4N/KlA (big blind) collected ($3.35)



PokerStars Game #59940938388:  Hold'em No Limit ($0.25/$0.50) - 2009/07/01 1:21:01 ET
Table '+dXkOAQyS8j9PQZusUTMpg' 2-max Seat #2 is the button
Seat 1: Teld4PDKla7C8/Wfu2DSkg ($55.40 in chips)
Seat 2: +zI4bP23YIjMkUHqeN2xfw ($23.85 in chips)
+zI4bP23YIjMkUHqeN2xfw: posts small blind $0.25
Teld4PDKla7C8/Wfu2DSkg: posts big blind $0.50
*** HOLE CARDS ***
+zI4bP23YIjMkUHqeN2xfw: calls $0.25
Teld4PDKla7C8/Wfu2DSkg: checks
*** FLOP *** [9h 6s 7c]
Teld4PDKla7C8/Wfu2DSkg: checks
+zI4bP23YIjMkUHqeN2xfw: checks
*** TURN *** [9h 6s 7c] [Qd]
Teld4PDKla7C8/Wfu2DSkg: checks
+zI4bP23YIjMkUHqeN2xfw: bets $1
Teld4PDKla7C8/Wfu2DSkg: calls $1
*** RIVER *** [9h 6s 7c Qd] [Qs]
Teld4PDKla7C8/Wfu2DSkg: checks
+zI4bP23YIjMkUHqeN2xfw: checks
*** SHOW DOWN ***
Teld4PDKla7C8/Wfu2DSkg: shows [3c Qh] (three of a kind, Queens)
+zI4bP23YIjMkUHqeN2xfw: mucks hand
Teld4PDKla7C8/Wfu2DSkg collected $2.90 from pot
*** SUMMARY ***
Total pot $3 | Rake $0.10
Board [9h 6s 7c Qd Qs]
Seat 1: Teld4PDKla7C8/Wfu2DSkg (big blind) showed [3c Qh] and won ($2.90) with three of a kind, Queens
Seat 2: +zI4bP23YIjMkUHqeN2xfw (button) (small blind) mucked



PokerStars Game #59940939786:  Hold'em No Limit ($0.25/$0.50) - 2009/07/01 1:21:03 ET
Table '3FhG0gl3kMX3wBEEqj+wnQ' 9-max Seat #6 is the button
Seat 1: bxLSulbgr8LmKNjOzw8URg ($50.05 in chips)
Seat 2: vacmVLJJECYI6HjAynFcpg ($52.10 in chips)
Seat 3: YXCE3WOZi8g2sIf3y/plVw ($50 in chips)
Seat 4: e2+sK/yjnj94rXOKoxPP2A ($71.75 in chips)
Seat 5: XcLXSUMHSpshK/7Lh0M4Vg ($10 in chips)
Seat 6: 997ViqAtWn1FPjJqcffwcA ($110.55 in chips)
Seat 7: mSD1pginDsyHG5PDfqzphw ($11.75 in chips)
Seat 8: j3K/Jujr7PY4ZM2RZvlH6A ($45.30 in chips)
Seat 9: KA0tkubTlbhmo4ju+qgXPg ($44.35 in chips)
mSD1pginDsyHG5PDfqzphw: posts small blind $0.25
j3K/Jujr7PY4ZM2RZvlH6A: posts big blind $0.50
*** HOLE CARDS ***
KA0tkubTlbhmo4ju+qgXPg: calls $0.50
bxLSulbgr8LmKNjOzw8URg: folds
vacmVLJJECYI6HjAynFcpg: folds
YXCE3WOZi8g2sIf3y/plVw: folds
e2+sK/yjnj94rXOKoxPP2A: folds
XcLXSUMHSpshK/7Lh0M4Vg: folds
997ViqAtWn1FPjJqcffwcA: folds
mSD1pginDsyHG5PDfqzphw: folds
j3K/Jujr7PY4ZM2RZvlH6A: checks
*** FLOP *** [Qh 5c 3d]
j3K/Jujr7PY4ZM2RZvlH6A: checks
KA0tkubTlbhmo4ju+qgXPg is disconnected
KA0tkubTlbhmo4ju+qgXPg is connected
KA0tkubTlbhmo4ju+qgXPg: checks
*** TURN *** [Qh 5c 3d] [6h]
j3K/Jujr7PY4ZM2RZvlH6A: checks
KA0tkubTlbhmo4ju+qgXPg: bets $1
j3K/Jujr7PY4ZM2RZvlH6A: raises $1 to $2
KA0tkubTlbhmo4ju+qgXPg: folds
j3K/Jujr7PY4ZM2RZvlH6A collected $3.10 from pot
j3K/Jujr7PY4ZM2RZvlH6A: doesn't show hand
*** SUMMARY ***
Total pot $3.25 | Rake $0.15
Board [Qh 5c 3d 6h]
Seat 1: bxLSulbgr8LmKNjOzw8URg folded before Flop (didn't bet)
Seat 2: vacmVLJJECYI6HjAynFcpg folded before Flop (didn't bet)
Seat 3: YXCE3WOZi8g2sIf3y/plVw folded before Flop (didn't bet)
Seat 4: e2+sK/yjnj94rXOKoxPP2A folded before Flop (didn't bet)
Seat 5: XcLXSUMHSpshK/7Lh0M4Vg folded before Flop (didn't bet)
Seat 6: 997ViqAtWn1FPjJqcffwcA (button) folded before Flop (didn't bet)
Seat 7: mSD1pginDsyHG5PDfqzphw (small blind) folded before Flop
Seat 8: j3K/Jujr7PY4ZM2RZvlH6A (big blind) collected ($3.10)
Seat 9: KA0tkubTlbhmo4ju+qgXPg folded on the Turn



PokerStars Game #59940939476:  Hold'em No Limit ($0.25/$0.50) - 2009/07/01 1:21:03 ET
Table 'QOgaEqMcJ73pcUMMxoisUg' 6-max Seat #4 is the button
Seat 1: lxIzoHy0RnkfFSODHC2liw ($50.75 in chips)
Seat 2: oqOqoO2AyCZenUghCxMDxw ($63.90 in chips)
Seat 3: Rt6KgtZ8YaJoTc3FPim00w ($57.60 in chips)
Seat 4: zAcsDhG/T128Vn7XGVSgKg ($60.25 in chips)
Seat 6: AdS8BJMOheS01zjCDfPMFg ($97.20 in chips)
AdS8BJMOheS01zjCDfPMFg: posts small blind $0.25
lxIzoHy0RnkfFSODHC2liw: posts big blind $0.50
*** HOLE CARDS ***
oqOqoO2AyCZenUghCxMDxw: folds
oqOqoO2AyCZenUghCxMDxw leaves the table
Rt6KgtZ8YaJoTc3FPim00w: raises $1 to $1.50
zAcsDhG/T128Vn7XGVSgKg: folds
AdS8BJMOheS01zjCDfPMFg: folds
lxIzoHy0RnkfFSODHC2liw: folds
Rt6KgtZ8YaJoTc3FPim00w collected $1.25 from pot
*** SUMMARY ***
Total pot $1.25 | Rake $0
Seat 1: lxIzoHy0RnkfFSODHC2liw (big blind) folded before Flop
Seat 2: oqOqoO2AyCZenUghCxMDxw folded before Flop (didn't bet)
Seat 3: Rt6KgtZ8YaJoTc3FPim00w collected ($1.25)
Seat 4: zAcsDhG/T128Vn7XGVSgKg (button) folded before Flop (didn't bet)
Seat 6: AdS8BJMOheS01zjCDfPMFg (small blind) folded before Flop



PokerStars Game #59940940180:  Hold'em No Limit ($0.25/$0.50) - 2009/07/01 1:21:04 ET
Table 'ofnd8S4IdIPph1Cbn+x7hA' 2-max Seat #2 is the button
Seat 1: PY4NvRocCFPfSIHKbh0euQ ($21.80 in chips)
Seat 2: l5WbyJ/iWYjpeCC6GCYY6w ($72.25 in chips)
l5WbyJ/iWYjpeCC6GCYY6w: posts small blind $0.25
PY4NvRocCFPfSIHKbh0euQ: posts big blind $0.50
*** HOLE CARDS ***
l5WbyJ/iWYjpeCC6GCYY6w: calls $0.25
PY4NvRocCFPfSIHKbh0euQ: checks
*** FLOP *** [5h 7h 3c]
PY4NvRocCFPfSIHKbh0euQ: checks
l5WbyJ/iWYjpeCC6GCYY6w: checks
*** TURN *** [5h 7h 3c] [Td]
PY4NvRocCFPfSIHKbh0euQ: bets $1
l5WbyJ/iWYjpeCC6GCYY6w: calls $1
*** RIVER *** [5h 7h 3c Td] [Ks]
PY4NvRocCFPfSIHKbh0euQ: bets $2.50
l5WbyJ/iWYjpeCC6GCYY6w: calls $2.50
*** SHOW DOWN ***
PY4NvRocCFPfSIHKbh0euQ: shows [Kh 2h] (a pair of Kings)
l5WbyJ/iWYjpeCC6GCYY6w: mucks hand
PY4NvRocCFPfSIHKbh0euQ collected $7.65 from pot
*** SUMMARY ***
Total pot $8 | Rake $0.35
Board [5h 7h 3c Td Ks]
Seat 1: PY4NvRocCFPfSIHKbh0euQ (big blind) showed [Kh 2h] and won ($7.65) with a pair of Kings
Seat 2: l5WbyJ/iWYjpeCC6GCYY6w (button) (small blind) mucked



PokerStars Game #59940941412:  Hold'em No Limit ($0.25/$0.50) - 2009/07/01 1:21:06 ET
Table 'X6IRCRTh+20gjz8aubWnwA' 9-max Seat #1 is the button
Seat 1: E2518gp4aFz1+kAgmGqeEg ($10.25 in chips)
Seat 2: HZkVla4kK2SI42CVrPZ/ig ($3.50 in chips)
Seat 3: SWv01peOe69QQRvhQTqjQw ($12.15 in chips)
Seat 4: M3JFBNQ8Bbw3FBZ/18MuXw ($24.65 in chips)
Seat 6: 75K2MXwN65Sjfp1yHd50Hg ($12.15 in chips)
Seat 7: cFHQjKQOOKTUzoilhrXHLg ($14.50 in chips)
Seat 8: HxeBVq06/3Bh/H986sgdbw ($48.50 in chips)
Seat 9: M+7+BTmX5vZatHVuoRB1nA ($44.80 in chips)
HZkVla4kK2SI42CVrPZ/ig: posts small blind $0.25
SWv01peOe69QQRvhQTqjQw: posts big blind $0.50
uw9QayAAxLM3Hb+HR7mSkg: sits out
*** HOLE CARDS ***
M3JFBNQ8Bbw3FBZ/18MuXw: calls $0.50
75K2MXwN65Sjfp1yHd50Hg: folds
cFHQjKQOOKTUzoilhrXHLg: calls $0.50
HxeBVq06/3Bh/H986sgdbw: folds
M+7+BTmX5vZatHVuoRB1nA: folds
E2518gp4aFz1+kAgmGqeEg: folds
HZkVla4kK2SI42CVrPZ/ig: calls $0.25
SWv01peOe69QQRvhQTqjQw: checks
*** FLOP *** [Ts 7s Ks]
HZkVla4kK2SI42CVrPZ/ig: checks
SWv01peOe69QQRvhQTqjQw: checks
M3JFBNQ8Bbw3FBZ/18MuXw: checks
cFHQjKQOOKTUzoilhrXHLg: checks
*** TURN *** [Ts 7s Ks] [2s]
HZkVla4kK2SI42CVrPZ/ig: checks
SWv01peOe69QQRvhQTqjQw: checks
M3JFBNQ8Bbw3FBZ/18MuXw: checks
cFHQjKQOOKTUzoilhrXHLg: checks
*** RIVER *** [Ts 7s Ks 2s] [8c]
HZkVla4kK2SI42CVrPZ/ig: checks
SWv01peOe69QQRvhQTqjQw: checks
M3JFBNQ8Bbw3FBZ/18MuXw: checks
cFHQjKQOOKTUzoilhrXHLg: checks
*** SHOW DOWN ***
HZkVla4kK2SI42CVrPZ/ig: shows [Ac 2h] (a pair of Deuces)
SWv01peOe69QQRvhQTqjQw: shows [Jh Kd] (a pair of Kings)
M3JFBNQ8Bbw3FBZ/18MuXw: mucks hand
cFHQjKQOOKTUzoilhrXHLg: mucks hand
SWv01peOe69QQRvhQTqjQw collected $1.90 from pot
*** SUMMARY ***
Total pot $2 | Rake $0.10
Board [Ts 7s Ks 2s 8c]
Seat 1: E2518gp4aFz1+kAgmGqeEg (button) folded before Flop (didn't bet)
Seat 2: HZkVla4kK2SI42CVrPZ/ig (small blind) showed [Ac 2h] and lost with a pair of Deuces
Seat 3: SWv01peOe69QQRvhQTqjQw (big blind) showed [Jh Kd] and won ($1.90) with a pair of Kings
Seat 4: M3JFBNQ8Bbw3FBZ/18MuXw mucked
Seat 6: 75K2MXwN65Sjfp1yHd50Hg folded before Flop (didn't bet)
Seat 7: cFHQjKQOOKTUzoilhrXHLg mucked
Seat 8: HxeBVq06/3Bh/H986sgdbw folded before Flop (didn't bet)
Seat 9: M+7+BTmX5vZatHVuoRB1nA folded before Flop (didn't bet)



PokerStars Game #59940942374:  Hold'em No Limit ($0.25/$0.50) - 2009/07/01 1:21:07 ET
Table 'EiNh8p/wGJ1FP575iMFnqg' 9-max Seat #6 is the button
Seat 2: 8ehL7qlZzjgUh2H35iiWLw ($58.90 in chips)
Seat 3: ymLPoEIl7UL3TvZYmnadxQ ($56.65 in chips)
Seat 4: cMzaiXAM/ZAdNaEUu+LqhA ($50 in chips)
Seat 5: M+7+BTmX5vZatHVuoRB1nA ($80.45 in chips)
Seat 6: viwBDtJsY6JfsFOdBAyJIQ ($9.45 in chips)
Seat 7: 997ViqAtWn1FPjJqcffwcA ($50 in chips)
Seat 8: mSD1pginDsyHG5PDfqzphw ($10 in chips)
Seat 9: GuPkZObrz5Zkkn8FsEdF9w ($30.70 in chips)
997ViqAtWn1FPjJqcffwcA: posts small blind $0.25
mSD1pginDsyHG5PDfqzphw: posts big blind $0.50
*** HOLE CARDS ***
GuPkZObrz5Zkkn8FsEdF9w: raises $1 to $1.50
xenomorph 98 joins the table at seat #1
8ehL7qlZzjgUh2H35iiWLw: folds
ymLPoEIl7UL3TvZYmnadxQ: calls $1.50
cMzaiXAM/ZAdNaEUu+LqhA: folds
M+7+BTmX5vZatHVuoRB1nA: folds
viwBDtJsY6JfsFOdBAyJIQ: folds
997ViqAtWn1FPjJqcffwcA: folds
mSD1pginDsyHG5PDfqzphw: folds
*** FLOP *** [5s 6s Tc]
GuPkZObrz5Zkkn8FsEdF9w: bets $1.50
ymLPoEIl7UL3TvZYmnadxQ: raises $3.50 to $5
GuPkZObrz5Zkkn8FsEdF9w: folds
ymLPoEIl7UL3TvZYmnadxQ collected $6.45 from pot
ymLPoEIl7UL3TvZYmnadxQ: doesn't show hand
*** SUMMARY ***
Total pot $6.75 | Rake $0.30
Board [5s 6s Tc]
Seat 2: 8ehL7qlZzjgUh2H35iiWLw folded before Flop (didn't bet)
Seat 3: ymLPoEIl7UL3TvZYmnadxQ collected ($6.45)
Seat 4: cMzaiXAM/ZAdNaEUu+LqhA folded before Flop (didn't bet)
Seat 5: M+7+BTmX5vZatHVuoRB1nA folded before Flop (didn't bet)
Seat 6: viwBDtJsY6JfsFOdBAyJIQ (button) folded before Flop (didn't bet)
Seat 7: 997ViqAtWn1FPjJqcffwcA (small blind) folded before Flop
Seat 8: mSD1pginDsyHG5PDfqzphw (big blind) folded before Flop
Seat 9: GuPkZObrz5Zkkn8FsEdF9w folded on the Flop



PokerStars Game #59940942096:  Hold'em No Limit ($0.25/$0.50) - 2009/07/01 1:21:07 ET
Table 'MJxeZCzYELxiIsyUZyT0jw' 6-max Seat #2 is the button
Seat 1: +Pf9jTVizYlIo+woPvptfA ($50 in chips)
Seat 2: t3GiVMzqA9Svgr5Uol32cQ ($35.95 in chips)
Seat 3: sIG4mp8tZEI+W4nKZNkkQA ($51.35 in chips)
Seat 6: c0n4hrn20AML9qzyFC2E8Q ($50.40 in chips)
sIG4mp8tZEI+W4nKZNkkQA: posts small blind $0.25
alGiiQP/wwtYnfuXII+sgw: is sitting out
3jvoOXNtXE90w2BdfNZwZQ: is sitting out
c0n4hrn20AML9qzyFC2E8Q: posts big blind $0.50
*** HOLE CARDS ***
+Pf9jTVizYlIo+woPvptfA: folds
3jvoOXNtXE90w2BdfNZwZQ leaves the table
t3GiVMzqA9Svgr5Uol32cQ: calls $0.50
sIG4mp8tZEI+W4nKZNkkQA: folds
c0n4hrn20AML9qzyFC2E8Q: checks
*** FLOP *** [7h 2s 7s]
sIG4mp8tZEI+W4nKZNkkQA leaves the table
c0n4hrn20AML9qzyFC2E8Q: checks
alGiiQP/wwtYnfuXII+sgw leaves the table
t3GiVMzqA9Svgr5Uol32cQ: checks
*** TURN *** [7h 2s 7s] [4s]
c0n4hrn20AML9qzyFC2E8Q: bets $1
t3GiVMzqA9Svgr5Uol32cQ: calls $1
*** RIVER *** [7h 2s 7s 4s] [Ah]
c0n4hrn20AML9qzyFC2E8Q: checks
t3GiVMzqA9Svgr5Uol32cQ: checks
*** SHOW DOWN ***
c0n4hrn20AML9qzyFC2E8Q: shows [2d Tc] (two pair, Sevens and Deuces)
t3GiVMzqA9Svgr5Uol32cQ: mucks hand
c0n4hrn20AML9qzyFC2E8Q collected $3.10 from pot
*** SUMMARY ***
Total pot $3.25 | Rake $0.15
Board [7h 2s 7s 4s Ah]
Seat 1: +Pf9jTVizYlIo+woPvptfA folded before Flop (didn't bet)
Seat 2: t3GiVMzqA9Svgr5Uol32cQ (button) mucked
Seat 3: sIG4mp8tZEI+W4nKZNkkQA (small blind) folded before Flop
Seat 6: c0n4hrn20AML9qzyFC2E8Q (big blind) showed [2d Tc] and won ($3.10) with two pair, Sevens and Deuces



PokerStars Game #59940942774:  Hold'em No Limit ($0.25/$0.50) - 2009/07/01 1:21:08 ET
Table 'hSTs/dUsYLgJQuF2Onp0MQ' 6-max Seat #5 is the button
Seat 1: 1WUCqNG+p+vfWRTXNu4ljw ($50 in chips)
Seat 4: 2igtJLmvIZ+HqX4XPgMPZA ($80.90 in chips)
Seat 5: IBNygaT1aa9Z1uPdJJilwA ($32.85 in chips)
Seat 6: M1KyQQvVPVuxqTAB8sR/zQ ($87.70 in chips)
M1KyQQvVPVuxqTAB8sR/zQ: posts small blind $0.25
1WUCqNG+p+vfWRTXNu4ljw: posts big blind $0.50
lxIzoHy0RnkfFSODHC2liw: sits out
*** HOLE CARDS ***
2igtJLmvIZ+HqX4XPgMPZA: folds
IBNygaT1aa9Z1uPdJJilwA: calls $0.50
M1KyQQvVPVuxqTAB8sR/zQ: folds
1WUCqNG+p+vfWRTXNu4ljw: raises $2 to $2.50
IBNygaT1aa9Z1uPdJJilwA: calls $2
*** FLOP *** [Ac 3c Qc]
1WUCqNG+p+vfWRTXNu4ljw: bets $3.50
IBNygaT1aa9Z1uPdJJilwA: calls $3.50
*** TURN *** [Ac 3c Qc] [5d]
1WUCqNG+p+vfWRTXNu4ljw: checks
IBNygaT1aa9Z1uPdJJilwA: bets $7.50
1WUCqNG+p+vfWRTXNu4ljw: folds
IBNygaT1aa9Z1uPdJJilwA collected $11.65 from pot
*** SUMMARY ***
Total pot $12.25 | Rake $0.60
Board [Ac 3c Qc 5d]
Seat 1: 1WUCqNG+p+vfWRTXNu4ljw (big blind) folded on the Turn
Seat 4: 2igtJLmvIZ+HqX4XPgMPZA folded before Flop (didn't bet)
Seat 5: IBNygaT1aa9Z1uPdJJilwA (button) collected ($11.65)
Seat 6: M1KyQQvVPVuxqTAB8sR/zQ (small blind) folded before Flop



PokerStars Game #59940942450:  Hold'em No Limit ($0.25/$0.50) - 2009/07/01 1:21:08 ET
Table 'GfL/No5u5PoEnU39lP5pQg' 6-max Seat #1 is the button
Seat 1: 1WUCqNG+p+vfWRTXNu4ljw ($66 in chips)
Seat 2: uVwggSetzp7d+eVgowO3vg ($51.85 in chips)
Seat 3: 4pp9WxhGdbVbxCc9tlu0lw ($33.05 in chips)
Seat 4: r6u7MWSXF30/khcTYkrG9Q ($23.10 in chips)
Seat 5: M1KyQQvVPVuxqTAB8sR/zQ ($50 in chips)
Seat 6: kxPhs4ePFqMy52CInAJ2aw ($62.45 in chips)
uVwggSetzp7d+eVgowO3vg: posts small blind $0.25
4pp9WxhGdbVbxCc9tlu0lw: posts big blind $0.50
*** HOLE CARDS ***
r6u7MWSXF30/khcTYkrG9Q: folds
M1KyQQvVPVuxqTAB8sR/zQ: raises $1 to $1.50
kxPhs4ePFqMy52CInAJ2aw: folds
1WUCqNG+p+vfWRTXNu4ljw: folds
uVwggSetzp7d+eVgowO3vg: folds
4pp9WxhGdbVbxCc9tlu0lw: calls $1
*** FLOP *** [3s 2d Kc]
4pp9WxhGdbVbxCc9tlu0lw: checks
M1KyQQvVPVuxqTAB8sR/zQ: bets $2.25
4pp9WxhGdbVbxCc9tlu0lw: calls $2.25
*** TURN *** [3s 2d Kc] [Jc]
4pp9WxhGdbVbxCc9tlu0lw: checks
M1KyQQvVPVuxqTAB8sR/zQ: checks
*** RIVER *** [3s 2d Kc Jc] [6s]
4pp9WxhGdbVbxCc9tlu0lw: bets $3.50
M1KyQQvVPVuxqTAB8sR/zQ: folds
4pp9WxhGdbVbxCc9tlu0lw collected $7.40 from pot
*** SUMMARY ***
Total pot $7.75 | Rake $0.35
Board [3s 2d Kc Jc 6s]
Seat 1: 1WUCqNG+p+vfWRTXNu4ljw (button) folded before Flop (didn't bet)
Seat 2: uVwggSetzp7d+eVgowO3vg (small blind) folded before Flop
Seat 3: 4pp9WxhGdbVbxCc9tlu0lw (big blind) collected ($7.40)
Seat 4: r6u7MWSXF30/khcTYkrG9Q folded before Flop (didn't bet)
Seat 5: M1KyQQvVPVuxqTAB8sR/zQ folded on the River
Seat 6: kxPhs4ePFqMy52CInAJ2aw folded before Flop (didn't bet)



PokerStars Game #59940944982:  Hold'em No Limit ($0.25/$0.50) - 2009/07/01 1:21:12 ET
Table 'Nz0Vr7WMHL2g5Uk7dDZjpw' 9-max Seat #7 is the button
Seat 2: gsyXT42WLEcOS4DdEk2wlw ($37.20 in chips)
Seat 3: hoglu9inkgs6zN573/bJag ($7.20 in chips)
Seat 4: E2518gp4aFz1+kAgmGqeEg ($13 in chips)
Seat 5: WGW0DgjBUXs1ylURHG8vnQ ($14.50 in chips)
Seat 6: 997ViqAtWn1FPjJqcffwcA ($58.05 in chips)
Seat 7: KPLH0gELgFe2OuAnhJFI5w ($21.95 in chips)
Seat 8: aoL+R/61Kxmw69ypuPrWAQ ($29.55 in chips)
Seat 9: mSD1pginDsyHG5PDfqzphw ($10 in chips)
aoL+R/61Kxmw69ypuPrWAQ: posts small blind $0.25
mSD1pginDsyHG5PDfqzphw: posts big blind $0.50
*** HOLE CARDS ***
gsyXT42WLEcOS4DdEk2wlw: folds
hoglu9inkgs6zN573/bJag: folds
E2518gp4aFz1+kAgmGqeEg: folds
WGW0DgjBUXs1ylURHG8vnQ: folds
997ViqAtWn1FPjJqcffwcA: folds
KPLH0gELgFe2OuAnhJFI5w: raises $1 to $1.50
aoL+R/61Kxmw69ypuPrWAQ: folds
mSD1pginDsyHG5PDfqzphw: folds
KPLH0gELgFe2OuAnhJFI5w collected $1.25 from pot
*** SUMMARY ***
Total pot $1.25 | Rake $0
Seat 2: gsyXT42WLEcOS4DdEk2wlw folded before Flop (didn't bet)
Seat 3: hoglu9inkgs6zN573/bJag folded before Flop (didn't bet)
Seat 4: E2518gp4aFz1+kAgmGqeEg folded before Flop (didn't bet)
Seat 5: WGW0DgjBUXs1ylURHG8vnQ folded before Flop (didn't bet)
Seat 6: 997ViqAtWn1FPjJqcffwcA folded before Flop (didn't bet)
Seat 7: KPLH0gELgFe2OuAnhJFI5w (button) collected ($1.25)
Seat 8: aoL+R/61Kxmw69ypuPrWAQ (small blind) folded before Flop
Seat 9: mSD1pginDsyHG5PDfqzphw (big blind) folded before Flop



PokerStars Game #59940946540:  Hold'em No Limit ($0.25/$0.50) - 2009/07/01 1:21:15 ET
Table 'iq+aXfWVQRdV0u8SRTYUEg' 9-max Seat #6 is the button
Seat 1: 3yl8Q6QaLfGtyhN4/pEFgQ ($61.35 in chips)
Seat 2: J9N0lxHFd/Js2S0xZLbsIQ ($35.95 in chips)
Seat 3: YcxPb+VB8VLtuLPBaYcMjA ($15.75 in chips)
Seat 5: 997ViqAtWn1FPjJqcffwcA ($50 in chips)
Seat 6: bTJ0WgoxefTPxIoycS7uoA ($31.60 in chips)
Seat 7: SKnJuWHScqetA/qG5p+wCg ($31.80 in chips)
Seat 8: /DtIHuxEH+3tzKefmSV+Mw ($17.55 in chips)
Seat 9: olE1Z2rKWAV8+tGqmIBK9g ($23.55 in chips)
SKnJuWHScqetA/qG5p+wCg: posts small blind $0.25
/DtIHuxEH+3tzKefmSV+Mw: posts big blind $0.50
*** HOLE CARDS ***
olE1Z2rKWAV8+tGqmIBK9g: folds
3yl8Q6QaLfGtyhN4/pEFgQ: calls $0.50
J9N0lxHFd/Js2S0xZLbsIQ: folds
YcxPb+VB8VLtuLPBaYcMjA: raises $1.50 to $2
997ViqAtWn1FPjJqcffwcA: folds
bTJ0WgoxefTPxIoycS7uoA: folds
SKnJuWHScqetA/qG5p+wCg: folds
/DtIHuxEH+3tzKefmSV+Mw: folds
3yl8Q6QaLfGtyhN4/pEFgQ: calls $1.50
*** FLOP *** [Th 6d 3c]
3yl8Q6QaLfGtyhN4/pEFgQ: checks
YcxPb+VB8VLtuLPBaYcMjA: bets $2.50
3yl8Q6QaLfGtyhN4/pEFgQ: calls $2.50
*** TURN *** [Th 6d 3c] [Td]
3yl8Q6QaLfGtyhN4/pEFgQ: checks
YcxPb+VB8VLtuLPBaYcMjA: bets $5
3yl8Q6QaLfGtyhN4/pEFgQ: raises $7.50 to $12.50
YcxPb+VB8VLtuLPBaYcMjA: calls $6.25 and is all-in
*** RIVER *** [Th 6d 3c Td] [Qd]
*** SHOW DOWN ***
3yl8Q6QaLfGtyhN4/pEFgQ: shows [Tc Qc] (a full house, Tens full of Queens)
YcxPb+VB8VLtuLPBaYcMjA: shows [Kd Ad] (a flush, Ace high)
Vandlesnake has returned
3yl8Q6QaLfGtyhN4/pEFgQ collected $30.70 from pot
*** SUMMARY ***
Total pot $32.25 | Rake $1.55
Board [Th 6d 3c Td Qd]
Seat 1: 3yl8Q6QaLfGtyhN4/pEFgQ showed [Tc Qc] and won ($30.70) with a full house, Tens full of Queens
Seat 2: J9N0lxHFd/Js2S0xZLbsIQ folded before Flop (didn't bet)
Seat 3: YcxPb+VB8VLtuLPBaYcMjA showed [Kd Ad] and lost with a flush, Ace high
Seat 5: 997ViqAtWn1FPjJqcffwcA folded before Flop (didn't bet)
Seat 6: bTJ0WgoxefTPxIoycS7uoA (button) folded before Flop (didn't bet)
Seat 7: SKnJuWHScqetA/qG5p+wCg (small blind) folded before Flop
Seat 8: /DtIHuxEH+3tzKefmSV+Mw (big blind) folded before Flop
Seat 9: olE1Z2rKWAV8+tGqmIBK9g folded before Flop (didn't bet)



PokerStars Game #59940949772:  Hold'em No Limit ($0.25/$0.50) - 2009/07/01 1:21:21 ET
Table 'lSisgp6H7Fg1hH5VfjEjYQ' 9-max Seat #4 is the button
Seat 1: 5k9fvXD9suIgCxU4HLQjTw ($50 in chips)
Seat 3: SKnJuWHScqetA/qG5p+wCg ($30 in chips)
Seat 4: bwv/rbH/hHhPhY6u9mu04w ($36.15 in chips)
Seat 5: mSD1pginDsyHG5PDfqzphw ($12.50 in chips)
Seat 6: +k7T5ocke8UwavtgUHm+Cg ($64.40 in chips)
Seat 7: IDtNLR9uFCDdjNsJWMHA5Q ($22.45 in chips)
Seat 8: a4JDWmpFQkL10XfAyuF51A ($15.50 in chips)
Seat 9: YzeKFbJVLmJGTgNH3ySQlw ($13 in chips)
mSD1pginDsyHG5PDfqzphw: posts small blind $0.25
+k7T5ocke8UwavtgUHm+Cg: posts big blind $0.50
*** HOLE CARDS ***
IDtNLR9uFCDdjNsJWMHA5Q: folds
a4JDWmpFQkL10XfAyuF51A: calls $0.50
YzeKFbJVLmJGTgNH3ySQlw: calls $0.50
5k9fvXD9suIgCxU4HLQjTw: raises $2 to $2.50
SKnJuWHScqetA/qG5p+wCg: calls $2.50
bwv/rbH/hHhPhY6u9mu04w: folds
mSD1pginDsyHG5PDfqzphw: folds
+k7T5ocke8UwavtgUHm+Cg: folds
a4JDWmpFQkL10XfAyuF51A: calls $2
YzeKFbJVLmJGTgNH3ySQlw: folds
*** FLOP *** [3s Th 3d]
a4JDWmpFQkL10XfAyuF51A: checks
5k9fvXD9suIgCxU4HLQjTw: bets $4.50
SKnJuWHScqetA/qG5p+wCg: folds
a4JDWmpFQkL10XfAyuF51A: folds
5k9fvXD9suIgCxU4HLQjTw collected $8.35 from pot
5k9fvXD9suIgCxU4HLQjTw: doesn't show hand
*** SUMMARY ***
Total pot $8.75 | Rake $0.40
Board [3s Th 3d]
Seat 1: 5k9fvXD9suIgCxU4HLQjTw collected ($8.35)
Seat 3: SKnJuWHScqetA/qG5p+wCg folded on the Flop
Seat 4: bwv/rbH/hHhPhY6u9mu04w (button) folded before Flop (didn't bet)
Seat 5: mSD1pginDsyHG5PDfqzphw (small blind) folded before Flop
Seat 6: +k7T5ocke8UwavtgUHm+Cg (big blind) folded before Flop
Seat 7: IDtNLR9uFCDdjNsJWMHA5Q folded before Flop (didn't bet)
Seat 8: a4JDWmpFQkL10XfAyuF51A folded on the Flop
Seat 9: YzeKFbJVLmJGTgNH3ySQlw folded before Flop



PokerStars Game #59940950060:  Hold'em No Limit ($0.25/$0.50) - 2009/07/01 1:21:21 ET
Table 'c/CRn+68J3Y8KxD5g1ek2Q' 2-max Seat #1 is the button
Seat 1: 46qCyJ6evTkHo9al5sBMNA ($107.60 in chips)
Seat 2: BypVLsYQt3ePFm2xQL/dOA ($253.40 in chips)
46qCyJ6evTkHo9al5sBMNA: posts small blind $0.25
BypVLsYQt3ePFm2xQL/dOA: posts big blind $0.50
*** HOLE CARDS ***
46qCyJ6evTkHo9al5sBMNA: raises $1 to $1.50
BypVLsYQt3ePFm2xQL/dOA: calls $1
*** FLOP *** [2s 5s Ts]
BypVLsYQt3ePFm2xQL/dOA: checks
46qCyJ6evTkHo9al5sBMNA: checks
*** TURN *** [2s 5s Ts] [Kh]
BypVLsYQt3ePFm2xQL/dOA: checks
46qCyJ6evTkHo9al5sBMNA: checks
*** RIVER *** [2s 5s Ts Kh] [4h]
BypVLsYQt3ePFm2xQL/dOA: checks
46qCyJ6evTkHo9al5sBMNA: bets $2
BypVLsYQt3ePFm2xQL/dOA: folds
46qCyJ6evTkHo9al5sBMNA collected $2.85 from pot
46qCyJ6evTkHo9al5sBMNA: doesn't show hand
*** SUMMARY ***
Total pot $3 | Rake $0.15
Board [2s 5s Ts Kh 4h]
Seat 1: 46qCyJ6evTkHo9al5sBMNA (button) (small blind) collected ($2.85)
Seat 2: BypVLsYQt3ePFm2xQL/dOA (big blind) folded on the River



PokerStars Game #59940950298:  Hold'em No Limit ($0.25/$0.50) - 2009/07/01 1:21:22 ET
Table 'ofnd8S4IdIPph1Cbn+x7hA' 2-max Seat #1 is the button
Seat 1: PY4NvRocCFPfSIHKbh0euQ ($25.45 in chips)
Seat 2: l5WbyJ/iWYjpeCC6GCYY6w ($68.25 in chips)
PY4NvRocCFPfSIHKbh0euQ: posts small blind $0.25
l5WbyJ/iWYjpeCC6GCYY6w: posts big blind $0.50
*** HOLE CARDS ***
PY4NvRocCFPfSIHKbh0euQ: raises $1 to $1.50
l5WbyJ/iWYjpeCC6GCYY6w: folds
PY4NvRocCFPfSIHKbh0euQ collected $1 from pot
*** SUMMARY ***
Total pot $1 | Rake $0
Seat 1: PY4NvRocCFPfSIHKbh0euQ (button) (small blind) collected ($1)
Seat 2: l5WbyJ/iWYjpeCC6GCYY6w (big blind) folded before Flop



PokerStars Game #59940952372:  Hold'em No Limit ($0.25/$0.50) - 2009/07/01 1:21:25 ET
Table 'otvGDROEDdqsabxskT79qg' 9-max Seat #2 is the button
Seat 1: 8ehL7qlZzjgUh2H35iiWLw ($59 in chips)
Seat 2: cCjTzH9jio8607WzjcfXlg ($10.65 in chips)
Seat 3: +k7T5ocke8UwavtgUHm+Cg ($74 in chips)
Seat 4: MG90wfSJZnOejs/KD3vlQQ ($80.65 in chips)
Seat 5: E2518gp4aFz1+kAgmGqeEg ($12.20 in chips)
Seat 6: bxLSulbgr8LmKNjOzw8URg ($55.25 in chips)
Seat 7: 75K2MXwN65Sjfp1yHd50Hg ($13.75 in chips)
Seat 8: zE9cVigS2nW/Ljy4K4bUQA ($33.30 in chips)
Seat 9: KcY3X8YpD74Kw1RHkx/g4A ($34.15 in chips)
+k7T5ocke8UwavtgUHm+Cg: posts small blind $0.25
MG90wfSJZnOejs/KD3vlQQ: posts big blind $0.50
*** HOLE CARDS ***
E2518gp4aFz1+kAgmGqeEg: folds
bxLSulbgr8LmKNjOzw8URg: folds
75K2MXwN65Sjfp1yHd50Hg: folds
zE9cVigS2nW/Ljy4K4bUQA: folds
KcY3X8YpD74Kw1RHkx/g4A: calls $0.50
8ehL7qlZzjgUh2H35iiWLw: raises $2 to $2.50
cCjTzH9jio8607WzjcfXlg: folds
+k7T5ocke8UwavtgUHm+Cg: folds
MG90wfSJZnOejs/KD3vlQQ: folds
KcY3X8YpD74Kw1RHkx/g4A: calls $2
*** FLOP *** [2s Ac Kd]
KcY3X8YpD74Kw1RHkx/g4A: checks
8ehL7qlZzjgUh2H35iiWLw: bets $4
KcY3X8YpD74Kw1RHkx/g4A: folds
8ehL7qlZzjgUh2H35iiWLw collected $5.50 from pot
8ehL7qlZzjgUh2H35iiWLw: doesn't show hand
*** SUMMARY ***
Total pot $5.75 | Rake $0.25
Board [2s Ac Kd]
Seat 1: 8ehL7qlZzjgUh2H35iiWLw collected ($5.50)
Seat 2: cCjTzH9jio8607WzjcfXlg (button) folded before Flop (didn't bet)
Seat 3: +k7T5ocke8UwavtgUHm+Cg (small blind) folded before Flop
Seat 4: MG90wfSJZnOejs/KD3vlQQ (big blind) folded before Flop
Seat 5: E2518gp4aFz1+kAgmGqeEg folded before Flop (didn't bet)
Seat 6: bxLSulbgr8LmKNjOzw8URg folded before Flop (didn't bet)
Seat 7: 75K2MXwN65Sjfp1yHd50Hg folded before Flop (didn't bet)
Seat 8: zE9cVigS2nW/Ljy4K4bUQA folded before Flop (didn't bet)
Seat 9: KcY3X8YpD74Kw1RHkx/g4A folded on the Flop



PokerStars Game #59940952814:  Hold'em No Limit ($0.25/$0.50) - 2009/07/01 1:21:26 ET
Table '+dXkOAQyS8j9PQZusUTMpg' 2-max Seat #1 is the button
Seat 1: Teld4PDKla7C8/Wfu2DSkg ($56.80 in chips)
Seat 2: +zI4bP23YIjMkUHqeN2xfw ($22.35 in chips)
Teld4PDKla7C8/Wfu2DSkg: posts small blind $0.25
+zI4bP23YIjMkUHqeN2xfw: posts big blind $0.50
*** HOLE CARDS ***
Teld4PDKla7C8/Wfu2DSkg: folds
+zI4bP23YIjMkUHqeN2xfw collected $0.50 from pot
*** SUMMARY ***
Total pot $0.50 | Rake $0
Seat 1: Teld4PDKla7C8/Wfu2DSkg (button) (small blind) folded before Flop
Seat 2: +zI4bP23YIjMkUHqeN2xfw (big blind) collected ($0.50)



PokerStars Game #59940952588:  Hold'em No Limit ($0.25/$0.50) - 2009/07/01 1:21:26 ET
Table '8BQGgNetI1NOvWeu3gtMNw' 2-max Seat #1 is the button
Seat 1: bypIyrYcAAifLfhZpGlKLA ($67.60 in chips)
Seat 2: Z4HwehErEwzsv/noQlfUlg ($121.90 in chips)
bypIyrYcAAifLfhZpGlKLA: posts small blind $0.25
Z4HwehErEwzsv/noQlfUlg: posts big blind $0.50
*** HOLE CARDS ***
bypIyrYcAAifLfhZpGlKLA: raises $1 to $1.50
Z4HwehErEwzsv/noQlfUlg: raises $2.50 to $4
bypIyrYcAAifLfhZpGlKLA: folds
Z4HwehErEwzsv/noQlfUlg collected $3 from pot
Z4HwehErEwzsv/noQlfUlg: doesn't show hand
*** SUMMARY ***
Total pot $3 | Rake $0
Seat 1: bypIyrYcAAifLfhZpGlKLA (button) (small blind) folded before Flop
Seat 2: Z4HwehErEwzsv/noQlfUlg (big blind) collected ($3)



