PokerStars Game #59938563700:  Hold'em No Limit ($0.50/$1.00) - 2009/07/01 0:18:00 ET
Table 'blHlQApStil0OPeQxQxPcwFKpXUINE6M3UxHG4zaMhHAx Seat #7 is the button
Seat 1: x80+i7DJL+81v3quj7KbNg ($20 in chips)
Seat 2: wIZ377kjl2fHFGnS93o6bw ($31.40 in chips)
Seat 3: o1axyw4AjQ8n4ubTwlirQQ ($27.70 in chips)
Seat 4: zanka7aAZkigmZpfopXxxA ($33.60 in chips)
Seat 6: JPQzLacMGzeh42mPgyrvVQ ($73.10 in chips)
Seat 7: vR4IO10geOgvTW+LAUBv/A ($118 in chips)
Seat 8: VtjmCz/ASIcETatNJ8YcCA ($58.85 in chips)
VtjmCz/ASIcETatNJ8YcCA: posts small blind $0.50
x80+i7DJL+81v3quj7KbNg: posts big blind $1
uXrDE6JrIi8BZK1L8oQ9bQ: sits out
*** HOLE CARDS ***
wIZ377kjl2fHFGnS93o6bw: calls $1
o1axyw4AjQ8n4ubTwlirQQ: folds
zanka7aAZkigmZpfopXxxA: folds
JPQzLacMGzeh42mPgyrvVQ: calls $1
vR4IO10geOgvTW+LAUBv/A: folds
VtjmCz/ASIcETatNJ8YcCA: calls $0.50
x80+i7DJL+81v3quj7KbNg: checks
*** FLOP *** [Jh 9c 8d]
VtjmCz/ASIcETatNJ8YcCA: checks
x80+i7DJL+81v3quj7KbNg: checks
wIZ377kjl2fHFGnS93o6bw: bets $2
JPQzLacMGzeh42mPgyrvVQ: folds
VtjmCz/ASIcETatNJ8YcCA: folds
x80+i7DJL+81v3quj7KbNg: folds
wIZ377kjl2fHFGnS93o6bw collected $3.80 from pot
*** SUMMARY ***
Total pot $4 | Rake $0.20
Board [Jh 9c 8d]
Seat 1: x80+i7DJL+81v3quj7KbNg (big blind) folded on the Flop
Seat 2: wIZ377kjl2fHFGnS93o6bw collected ($3.80)
Seat 3: o1axyw4AjQ8n4ubTwlirQQ folded before Flop (didn't bet)
Seat 4: zanka7aAZkigmZpfopXxxA folded before Flop (didn't bet)
Seat 6: JPQzLacMGzeh42mPgyrvVQ folded on the Flop
Seat 7: vR4IO10geOgvTW+LAUBv/A (button) folded before Flop (didn't bet)
Seat 8: VtjmCz/ASIcETatNJ8YcCA (small blind) folded on the Flop



PokerStars Game #59938564000:  Hold'em No Limit ($0.50/$1.00) - 2009/07/01 0:18:01 ET
Table 'vs/5jr6ciwjVQ5+Soc+u2A' 6-max Seat #2 is the button
Seat 2: XOIf9W+VAxhZqN+SYoyMKA ($125.80 in chips)
Seat 3: G5ZSSN6RSON3gkNvk/SmYg ($100 in chips)
Seat 4: KpnW5CcJ4Mg6MeclfKmLrw ($104 in chips)
Seat 5: 7Vc9JmGFQwMRh5Tj9ui5Lw ($91.60 in chips)
Seat 6: QHvTZcrKe6+maWUfVjP29Q ($100 in chips)
G5ZSSN6RSON3gkNvk/SmYg: posts small blind $0.50
KpnW5CcJ4Mg6MeclfKmLrw: posts big blind $1
*** HOLE CARDS ***
7Vc9JmGFQwMRh5Tj9ui5Lw: calls $1
QHvTZcrKe6+maWUfVjP29Q: folds
XOIf9W+VAxhZqN+SYoyMKA: calls $1
G5ZSSN6RSON3gkNvk/SmYg: folds
KpnW5CcJ4Mg6MeclfKmLrw: checks
*** FLOP *** [4c Jc 6s]
KpnW5CcJ4Mg6MeclfKmLrw: checks
7Vc9JmGFQwMRh5Tj9ui5Lw: checks
XOIf9W+VAxhZqN+SYoyMKA: bets $3
KpnW5CcJ4Mg6MeclfKmLrw: folds
7Vc9JmGFQwMRh5Tj9ui5Lw: calls $3
*** TURN *** [4c Jc 6s] [8c]
7Vc9JmGFQwMRh5Tj9ui5Lw: checks
XOIf9W+VAxhZqN+SYoyMKA: bets $5
7Vc9JmGFQwMRh5Tj9ui5Lw: calls $5
*** RIVER *** [4c Jc 6s 8c] [9c]
7Vc9JmGFQwMRh5Tj9ui5Lw: checks
XOIf9W+VAxhZqN+SYoyMKA: checks
*** SHOW DOWN ***
7Vc9JmGFQwMRh5Tj9ui5Lw: shows [7s 7c] (a flush, Jack high)
XOIf9W+VAxhZqN+SYoyMKA: mucks hand
7Vc9JmGFQwMRh5Tj9ui5Lw collected $18.55 from pot
*** SUMMARY ***
Total pot $19.50 | Rake $0.95
Board [4c Jc 6s 8c 9c]
Seat 2: XOIf9W+VAxhZqN+SYoyMKA (button) mucked
Seat 3: G5ZSSN6RSON3gkNvk/SmYg (small blind) folded before Flop
Seat 4: KpnW5CcJ4Mg6MeclfKmLrw (big blind) folded on the Flop
Seat 5: 7Vc9JmGFQwMRh5Tj9ui5Lw showed [7s 7c] and won ($18.55) with a flush, Jack high
Seat 6: QHvTZcrKe6+maWUfVjP29Q folded before Flop (didn't bet)



PokerStars Game #59938566116:  Hold'em No Limit ($0.50/$1.00) - 2009/07/01 0:18:03 ET
Table 'U9zqzC8f3oTJ2ShXFgSSOA' 6-max Seat #5 is the button
Seat 1: tS9JHB1h+FQ++qu8RwRNgg ($19.45 in chips)
Seat 2: U2CWBTv29qdCbj8RNF2sIw ($111.80 in chips)
Seat 3: yfXek8iJ7O4CFyqXrtGcfg ($36.85 in chips)
Seat 4: 33q95we0Etwgrm6guQGncw ($71.35 in chips)
Seat 5: KfwW5us6tydK81NYTtK1gw ($196.75 in chips)
Seat 6: aIxzFKdtpDSkUePKZy/niQ ($64.50 in chips)
aIxzFKdtpDSkUePKZy/niQ: posts small blind $0.50
tS9JHB1h+FQ++qu8RwRNgg: posts big blind $1
*** HOLE CARDS ***
U2CWBTv29qdCbj8RNF2sIw: folds
yfXek8iJ7O4CFyqXrtGcfg: calls $1
33q95we0Etwgrm6guQGncw: folds
KfwW5us6tydK81NYTtK1gw: raises $1 to $2
aIxzFKdtpDSkUePKZy/niQ: calls $1.50
tS9JHB1h+FQ++qu8RwRNgg: folds
yfXek8iJ7O4CFyqXrtGcfg: calls $1
*** FLOP *** [Qh 8d 2s]
aIxzFKdtpDSkUePKZy/niQ: checks
yfXek8iJ7O4CFyqXrtGcfg: bets $2
KfwW5us6tydK81NYTtK1gw: folds
aIxzFKdtpDSkUePKZy/niQ: folds
yfXek8iJ7O4CFyqXrtGcfg collected $6.65 from pot
*** SUMMARY ***
Total pot $7 | Rake $0.35
Board [Qh 8d 2s]
Seat 1: tS9JHB1h+FQ++qu8RwRNgg (big blind) folded before Flop
Seat 2: U2CWBTv29qdCbj8RNF2sIw folded before Flop (didn't bet)
Seat 3: yfXek8iJ7O4CFyqXrtGcfg collected ($6.65)
Seat 4: 33q95we0Etwgrm6guQGncw folded before Flop (didn't bet)
Seat 5: KfwW5us6tydK81NYTtK1gw (button) folded on the Flop
Seat 6: aIxzFKdtpDSkUePKZy/niQ (small blind) folded on the Flop



PokerStars Game #59938565654:  Hold'em No Limit ($0.50/$1.00) - 2009/07/01 0:18:03 ET
Table 'kBJtONSnMKK6+l5D0n+vjA' 2-max Seat #2 is the button
Seat 1: qubgcbkrXfMjdrMEd1lYMQ ($346.90 in chips)
Seat 2: 5x9BehadQB/XenOdQDZzEQ ($38.60 in chips)
5x9BehadQB/XenOdQDZzEQ: posts small blind $0.50
qubgcbkrXfMjdrMEd1lYMQ: posts big blind $1
*** HOLE CARDS ***
5x9BehadQB/XenOdQDZzEQ: raises $1 to $2
qubgcbkrXfMjdrMEd1lYMQ: folds
5x9BehadQB/XenOdQDZzEQ collected $2 from pot
5x9BehadQB/XenOdQDZzEQ: doesn't show hand
*** SUMMARY ***
Total pot $2 | Rake $0
Seat 1: qubgcbkrXfMjdrMEd1lYMQ (big blind) folded before Flop
Seat 2: 5x9BehadQB/XenOdQDZzEQ (button) (small blind) collected ($2)



PokerStars Game #59938568218:  Hold'em No Limit ($0.50/$1.00) - 2009/07/01 0:18:07 ET
Table '/FUb199IViHMJHi5YWmeuQ' 9-max Seat #7 is the button
Seat 1: TZcz9MEWDA+WydgGruqqbw ($101.50 in chips)
Seat 2: FL3MrLspcF23LYvC4ipBOA ($133.75 in chips)
Seat 3: qN483QJ1NvHbdIZB7J4ARw ($76.25 in chips)
Seat 4: qheQay5YvP2DMAb3OUSxtw ($107.30 in chips)
Seat 5: +za1iHiRgVo4OcAz0SOZqw ($17.95 in chips)
Seat 6: x80+i7DJL+81v3quj7KbNg ($24.50 in chips)
Seat 7: atVaKXE/AQGa798rpMF/Bg ($17 in chips)
Seat 8: QIWvt0R766g8KfH0vl1s0A ($59.10 in chips)
Seat 9: knewtTmBc4Tc0z/5tAABYQ ($109.35 in chips)
QIWvt0R766g8KfH0vl1s0A: posts small blind $0.50
knewtTmBc4Tc0z/5tAABYQ: posts big blind $1
*** HOLE CARDS ***
TZcz9MEWDA+WydgGruqqbw: folds
FL3MrLspcF23LYvC4ipBOA: folds
qN483QJ1NvHbdIZB7J4ARw: calls $1
qheQay5YvP2DMAb3OUSxtw: folds
+za1iHiRgVo4OcAz0SOZqw: calls $1
x80+i7DJL+81v3quj7KbNg: folds
atVaKXE/AQGa798rpMF/Bg: folds
QIWvt0R766g8KfH0vl1s0A: calls $0.50
knewtTmBc4Tc0z/5tAABYQ: checks
*** FLOP *** [3h 3d 4c]
QIWvt0R766g8KfH0vl1s0A: checks
knewtTmBc4Tc0z/5tAABYQ: checks
qN483QJ1NvHbdIZB7J4ARw: checks
+za1iHiRgVo4OcAz0SOZqw: checks
*** TURN *** [3h 3d 4c] [5h]
QIWvt0R766g8KfH0vl1s0A: checks
knewtTmBc4Tc0z/5tAABYQ: checks
qN483QJ1NvHbdIZB7J4ARw: checks
+za1iHiRgVo4OcAz0SOZqw: checks
*** RIVER *** [3h 3d 4c 5h] [Ks]
QIWvt0R766g8KfH0vl1s0A: checks
knewtTmBc4Tc0z/5tAABYQ: checks
qN483QJ1NvHbdIZB7J4ARw: checks
+za1iHiRgVo4OcAz0SOZqw: checks
*** SHOW DOWN ***
QIWvt0R766g8KfH0vl1s0A: shows [7s 8s] (a pair of Threes)
knewtTmBc4Tc0z/5tAABYQ: shows [6s 4h] (two pair, Fours and Threes)
qN483QJ1NvHbdIZB7J4ARw: mucks hand
+za1iHiRgVo4OcAz0SOZqw: mucks hand
knewtTmBc4Tc0z/5tAABYQ collected $3.80 from pot
*** SUMMARY ***
Total pot $4 | Rake $0.20
Board [3h 3d 4c 5h Ks]
Seat 1: TZcz9MEWDA+WydgGruqqbw folded before Flop (didn't bet)
Seat 2: FL3MrLspcF23LYvC4ipBOA folded before Flop (didn't bet)
Seat 3: qN483QJ1NvHbdIZB7J4ARw mucked
Seat 4: qheQay5YvP2DMAb3OUSxtw folded before Flop (didn't bet)
Seat 5: +za1iHiRgVo4OcAz0SOZqw mucked
Seat 6: x80+i7DJL+81v3quj7KbNg folded before Flop (didn't bet)
Seat 7: atVaKXE/AQGa798rpMF/Bg (button) folded before Flop (didn't bet)
Seat 8: QIWvt0R766g8KfH0vl1s0A (small blind) showed [7s 8s] and lost with a pair of Threes
Seat 9: knewtTmBc4Tc0z/5tAABYQ (big blind) showed [6s 4h] and won ($3.80) with two pair, Fours and Threes



PokerStars Game #59938568548:  Hold'em No Limit ($0.50/$1.00) - 2009/07/01 0:18:07 ET
Table 'tyUh+jyNvrceIQdKMJjQ2wZFWj23PMihdwrNWv41OG/Qeat #1 is the button
Seat 1: o8A5MUdudVKu+pAwgZOX2w ($98.70 in chips)
Seat 2: 6iVcnPw9a2oNG6sPQo3G6g ($99.25 in chips)
Seat 3: L9qfLYXrczhAPd/VckgsWw ($43.40 in chips)
Seat 5: j7NIOHLZk7V2o9fOioO5ug ($113.60 in chips)
Seat 6: YsLQ3BAvgQHWXMAv3Wv6Hg ($106.75 in chips)
6iVcnPw9a2oNG6sPQo3G6g: posts small blind $0.50
L9qfLYXrczhAPd/VckgsWw: posts big blind $1
*** HOLE CARDS ***
j7NIOHLZk7V2o9fOioO5ug: raises $2 to $3
YsLQ3BAvgQHWXMAv3Wv6Hg: folds
o8A5MUdudVKu+pAwgZOX2w: calls $3
6iVcnPw9a2oNG6sPQo3G6g: folds
L9qfLYXrczhAPd/VckgsWw: calls $2
*** FLOP *** [5s 5d 6c]
L9qfLYXrczhAPd/VckgsWw: checks
j7NIOHLZk7V2o9fOioO5ug: bets $7
o8A5MUdudVKu+pAwgZOX2w: calls $7
L9qfLYXrczhAPd/VckgsWw: folds
*** TURN *** [5s 5d 6c] [7s]
j7NIOHLZk7V2o9fOioO5ug: bets $17
o8A5MUdudVKu+pAwgZOX2w: calls $17
*** RIVER *** [5s 5d 6c 7s] [2h]
j7NIOHLZk7V2o9fOioO5ug: bets $47
o8A5MUdudVKu+pAwgZOX2w: raises $24.70 to $71.70 and is all-in
j7NIOHLZk7V2o9fOioO5ug: calls $24.70
*** SHOW DOWN ***
o8A5MUdudVKu+pAwgZOX2w: shows [6s 6h] (a full house, Sixes full of Fives)
j7NIOHLZk7V2o9fOioO5ug: mucks hand
o8A5MUdudVKu+pAwgZOX2w collected $198.90 from pot
*** SUMMARY ***
Total pot $200.90 | Rake $2
Board [5s 5d 6c 7s 2h]
Seat 1: o8A5MUdudVKu+pAwgZOX2w (button) showed [6s 6h] and won ($198.90) with a full house, Sixes full of Fives
Seat 2: 6iVcnPw9a2oNG6sPQo3G6g (small blind) folded before Flop
Seat 3: L9qfLYXrczhAPd/VckgsWw (big blind) folded on the Flop
Seat 5: j7NIOHLZk7V2o9fOioO5ug mucked
Seat 6: YsLQ3BAvgQHWXMAv3Wv6Hg folded before Flop (didn't bet)



PokerStars Game #59938568364:  Hold'em No Limit ($0.50/$1.00) - 2009/07/01 0:18:07 ET
Table 'FKpXUINE6M3UxHG4zaMhHA' 6-max Seat #6 is the button
Seat 2: Zboa6dColKGHBjLPUakZjw ($98.30 in chips)
Seat 3: ssLJburtEIqnVkx6X8R1uw ($123.90 in chips)
Seat 4: ij3giaLzheEK+z+SxbRtAg ($60.60 in chips)
Seat 5: hpxXcmRkXXI9HE5+5/j/0Q ($106.70 in chips)
Seat 6: b2a+5TkFf4xJN/Ihhma58Q ($24.80 in chips)
Zboa6dColKGHBjLPUakZjw: posts small blind $0.50
ssLJburtEIqnVkx6X8R1uw: posts big blind $1
*** HOLE CARDS ***
ij3giaLzheEK+z+SxbRtAg: folds
hpxXcmRkXXI9HE5+5/j/0Q: folds
ij3giaLzheEK+z+SxbRtAg leaves the table
b2a+5TkFf4xJN/Ihhma58Q: folds
Zboa6dColKGHBjLPUakZjw: raises $1 to $2
ssLJburtEIqnVkx6X8R1uw: calls $1
*** FLOP *** [5h Tc 6h]
ru6SCVvWcWt2SpmUsmArWQ joins the table at seat #4
Zboa6dColKGHBjLPUakZjw: bets $2
ssLJburtEIqnVkx6X8R1uw: folds
Zboa6dColKGHBjLPUakZjw collected $3.80 from pot
*** SUMMARY ***
Total pot $4 | Rake $0.20
Board [5h Tc 6h]
Seat 2: Zboa6dColKGHBjLPUakZjw (small blind) collected ($3.80)
Seat 3: ssLJburtEIqnVkx6X8R1uw (big blind) folded on the Flop
Seat 4: ij3giaLzheEK+z+SxbRtAg folded before Flop (didn't bet)
Seat 5: hpxXcmRkXXI9HE5+5/j/0Q folded before Flop (didn't bet)
Seat 6: b2a+5TkFf4xJN/Ihhma58Q (button) folded before Flop (didn't bet)



PokerStars Game #59938570094:  Hold'em No Limit ($0.50/$1.00) - 2009/07/01 0:18:09 ET
Table 'fTlPiCj0utgzC/5io+I7ew' 6-max Seat #5 is the button
Seat 1: YMJG+F++3Aj6P8dAWda5fw ($100 in chips)
Seat 2: +xUCTmR3cU7G239W+vZv6g ($140.50 in chips)
Seat 4: uJVSceLggtsrJya+WtmUEA ($101.60 in chips)
Seat 5: bFrTkDcWGTxyvNul7GVdYg ($239 in chips)
Seat 6: AdLVjddOzm+sRNo1Bc3S6Q ($100 in chips)
AdLVjddOzm+sRNo1Bc3S6Q: posts small blind $0.50
YMJG+F++3Aj6P8dAWda5fw: posts big blind $1
*** HOLE CARDS ***
+xUCTmR3cU7G239W+vZv6g: folds
uJVSceLggtsrJya+WtmUEA: folds
bFrTkDcWGTxyvNul7GVdYg: raises $2 to $3
AdLVjddOzm+sRNo1Bc3S6Q: folds
YMJG+F++3Aj6P8dAWda5fw: folds
bFrTkDcWGTxyvNul7GVdYg collected $2.50 from pot
*** SUMMARY ***
Total pot $2.50 | Rake $0
Seat 1: YMJG+F++3Aj6P8dAWda5fw (big blind) folded before Flop
Seat 2: +xUCTmR3cU7G239W+vZv6g folded before Flop (didn't bet)
Seat 4: uJVSceLggtsrJya+WtmUEA folded before Flop (didn't bet)
Seat 5: bFrTkDcWGTxyvNul7GVdYg (button) collected ($2.50)
Seat 6: AdLVjddOzm+sRNo1Bc3S6Q (small blind) folded before Flop



PokerStars Game #59938571954:  Hold'em No Limit ($0.50/$1.00) - 2009/07/01 0:18:12 ET
Table 'O96CPOtvMBWP6kzuYDfdFA' 6-max Seat #4 is the button
Seat 1: yl9aRDw7k/ieGiDoJVy+/w ($71.50 in chips)
Seat 2: vTUNrd/7qIOJpW0suEu5hQ ($212.40 in chips)
Seat 4: KOG8rG51mOvIoY96zF3kvw ($170.95 in chips)
Seat 5: wRxiu9OJzvvN84OYWW9jxQ ($117.85 in chips)
Seat 6: xNKcQzD9+/iHmtJn4vYq9w ($78.50 in chips)
wRxiu9OJzvvN84OYWW9jxQ: posts small blind $0.50
xNKcQzD9+/iHmtJn4vYq9w: posts big blind $1
V89DGjxE171oPREEbAXiyg: sits out
*** HOLE CARDS ***
yl9aRDw7k/ieGiDoJVy+/w: calls $1
vTUNrd/7qIOJpW0suEu5hQ: folds
KOG8rG51mOvIoY96zF3kvw has timed out
KOG8rG51mOvIoY96zF3kvw: folds
KOG8rG51mOvIoY96zF3kvw is sitting out
wRxiu9OJzvvN84OYWW9jxQ: raises $3 to $4
xNKcQzD9+/iHmtJn4vYq9w: calls $3
yl9aRDw7k/ieGiDoJVy+/w: raises $7 to $11
wRxiu9OJzvvN84OYWW9jxQ: raises $106.85 to $117.85 and is all-in
xNKcQzD9+/iHmtJn4vYq9w: folds
yl9aRDw7k/ieGiDoJVy+/w: folds
wRxiu9OJzvvN84OYWW9jxQ collected $26 from pot
*** SUMMARY ***
Total pot $26 | Rake $0
Seat 1: yl9aRDw7k/ieGiDoJVy+/w folded before Flop
Seat 2: vTUNrd/7qIOJpW0suEu5hQ folded before Flop (didn't bet)
Seat 4: KOG8rG51mOvIoY96zF3kvw (button) folded before Flop (didn't bet)
Seat 5: wRxiu9OJzvvN84OYWW9jxQ (small blind) collected ($26)
Seat 6: xNKcQzD9+/iHmtJn4vYq9w (big blind) folded before Flop



PokerStars Game #59938571686:  Hold'em No Limit ($0.50/$1.00) - 2009/07/01 0:18:12 ET
Table '6YvsYDPNIDx2v5z3bJnwZQ' 9-max Seat #1 is the button
Seat 1: Ogn4JDV3mp4ZDKO49IFzKA ($17 in chips)
Seat 2: q9qdvTFQkzcAZRujD6rXUA ($98.50 in chips)
Seat 3: negfosHnGOZXSHpWDRKyBQ ($18.30 in chips)
Seat 4: kEr5NYB+JIG5+szcYMr6hA ($49 in chips)
Seat 5: mBRWbnUl8diyBO1qTJaNzw ($162.80 in chips)
Seat 7: boixc27eqTYA1p0tUdMuBQ ($109.60 in chips)
Seat 8: PSFxpXgPedVZyHSu2Zhb7Q ($77.40 in chips)
Seat 9: jDwhY1kCdc6EkAHbT7PJMQ ($106.85 in chips)
q9qdvTFQkzcAZRujD6rXUA: posts small blind $0.50
negfosHnGOZXSHpWDRKyBQ: posts big blind $1
uMPEfCcGCfsxmy53tVUMug: sits out
*** HOLE CARDS ***
kEr5NYB+JIG5+szcYMr6hA: folds
mBRWbnUl8diyBO1qTJaNzw: folds
boixc27eqTYA1p0tUdMuBQ: folds
PSFxpXgPedVZyHSu2Zhb7Q: raises $2 to $3
jDwhY1kCdc6EkAHbT7PJMQ: folds
Ogn4JDV3mp4ZDKO49IFzKA: folds
q9qdvTFQkzcAZRujD6rXUA: folds
negfosHnGOZXSHpWDRKyBQ: folds
PSFxpXgPedVZyHSu2Zhb7Q collected $2.50 from pot
*** SUMMARY ***
Total pot $2.50 | Rake $0
Seat 1: Ogn4JDV3mp4ZDKO49IFzKA (button) folded before Flop (didn't bet)
Seat 2: q9qdvTFQkzcAZRujD6rXUA (small blind) folded before Flop
Seat 3: negfosHnGOZXSHpWDRKyBQ (big blind) folded before Flop
Seat 4: kEr5NYB+JIG5+szcYMr6hA folded before Flop (didn't bet)
Seat 5: mBRWbnUl8diyBO1qTJaNzw folded before Flop (didn't bet)
Seat 7: boixc27eqTYA1p0tUdMuBQ folded before Flop (didn't bet)
Seat 8: PSFxpXgPedVZyHSu2Zhb7Q collected ($2.50)
Seat 9: jDwhY1kCdc6EkAHbT7PJMQ folded before Flop (didn't bet)



PokerStars Game #59938571850:  Hold'em No Limit ($0.50/$1.00) - 2009/07/01 0:18:12 ET
Table 'kBJtONSnMKK6+l5D0n+vjA' 2-max Seat #1 is the button
Seat 1: qubgcbkrXfMjdrMEd1lYMQ ($345.90 in chips)
Seat 2: 5x9BehadQB/XenOdQDZzEQ ($39.60 in chips)
qubgcbkrXfMjdrMEd1lYMQ: posts small blind $0.50
5x9BehadQB/XenOdQDZzEQ: posts big blind $1
*** HOLE CARDS ***
qubgcbkrXfMjdrMEd1lYMQ: raises $2 to $3
5x9BehadQB/XenOdQDZzEQ: raises $2 to $5
qubgcbkrXfMjdrMEd1lYMQ: calls $2
*** FLOP *** [9c 6h Ac]
5x9BehadQB/XenOdQDZzEQ: bets $3.35
qubgcbkrXfMjdrMEd1lYMQ: folds
5x9BehadQB/XenOdQDZzEQ collected $9.50 from pot
5x9BehadQB/XenOdQDZzEQ: doesn't show hand
*** SUMMARY ***
Total pot $10 | Rake $0.50
Board [9c 6h Ac]
Seat 1: qubgcbkrXfMjdrMEd1lYMQ (button) (small blind) folded on the Flop
Seat 2: 5x9BehadQB/XenOdQDZzEQ (big blind) collected ($9.50)



PokerStars Game #59938572212:  Hold'em No Limit ($0.50/$1.00) - 2009/07/01 0:18:13 ET
Table 'ZFWj23PMihdwrNWv41OG/Q' 9-max Seat #1 is the button
Seat 1: yAbu2QsRPVcjPbqlf/jDxw ($103.30 in chips)
Seat 2: ARfmgHcEUKh68laBZy4veA ($24 in chips)
Seat 3: G9Fo2TZCN7HI43Po4zSN3A ($100 in chips)
Seat 4: PEmogYqKpuv0ozeBbXL+7Q ($15.25 in chips)
Seat 5: aNuEPl+Lh/dZypIbbfz+mA ($22.35 in chips)
Seat 6: tjhwe1V98x2spSoUQER3HQ ($100 in chips)
Seat 7: wIZ377kjl2fHFGnS93o6bw ($31.05 in chips)
Seat 8: knewtTmBc4Tc0z/5tAABYQ ($107 in chips)
Seat 9: atVaKXE/AQGa798rpMF/Bg ($57 in chips)
ARfmgHcEUKh68laBZy4veA: posts small blind $0.50
G9Fo2TZCN7HI43Po4zSN3A: posts big blind $1
*** HOLE CARDS ***
PEmogYqKpuv0ozeBbXL+7Q: raises $4 to $5
aNuEPl+Lh/dZypIbbfz+mA: folds
tjhwe1V98x2spSoUQER3HQ: folds
wIZ377kjl2fHFGnS93o6bw: folds
knewtTmBc4Tc0z/5tAABYQ: folds
atVaKXE/AQGa798rpMF/Bg: folds
yAbu2QsRPVcjPbqlf/jDxw: folds
ARfmgHcEUKh68laBZy4veA: folds
G9Fo2TZCN7HI43Po4zSN3A: folds
PEmogYqKpuv0ozeBbXL+7Q collected $2.50 from pot
*** SUMMARY ***
Total pot $2.50 | Rake $0
Seat 1: yAbu2QsRPVcjPbqlf/jDxw (button) folded before Flop (didn't bet)
Seat 2: ARfmgHcEUKh68laBZy4veA (small blind) folded before Flop
Seat 3: G9Fo2TZCN7HI43Po4zSN3A (big blind) folded before Flop
Seat 4: PEmogYqKpuv0ozeBbXL+7Q collected ($2.50)
Seat 5: aNuEPl+Lh/dZypIbbfz+mA folded before Flop (didn't bet)
Seat 6: tjhwe1V98x2spSoUQER3HQ folded before Flop (didn't bet)
Seat 7: wIZ377kjl2fHFGnS93o6bw folded before Flop (didn't bet)
Seat 8: knewtTmBc4Tc0z/5tAABYQ folded before Flop (didn't bet)
Seat 9: atVaKXE/AQGa798rpMF/Bg folded before Flop (didn't bet)



PokerStars Game #59938573580:  Hold'em No Limit ($0.50/$1.00) - 2009/07/01 0:18:15 ET
Table 'J2yEIzCSC1VzM+R2gijwtg' 9-max Seat #3 is the button
Seat 1: knewtTmBc4Tc0z/5tAABYQ ($202.95 in chips)
Seat 2: kz9ziSiGUc+857heiKSayw ($16 in chips)
Seat 3: 9swGhtpERPngKPtvpoZkoQ ($133.15 in chips)
Seat 4: vR4IO10geOgvTW+LAUBv/A ($100 in chips)
Seat 5: /kZ258i1lqmMUXbtrZIHJA ($44.10 in chips)
Seat 6: bJckevFOcg//s0qyMQI6sQ ($176.40 in chips)
Seat 7: NfnZaywKxYXxgrCRYYYG8Q ($14 in chips)
Seat 8: CIRDepY9Rc5tiDJPd0nNpQ ($93.90 in chips)
Seat 9: ZWdwcEAWYlrUhsRi6MOmoA ($31.15 in chips)
vR4IO10geOgvTW+LAUBv/A: posts small blind $0.50
/kZ258i1lqmMUXbtrZIHJA: posts big blind $1
*** HOLE CARDS ***
bJckevFOcg//s0qyMQI6sQ: folds
NfnZaywKxYXxgrCRYYYG8Q has timed out
NfnZaywKxYXxgrCRYYYG8Q: folds
NfnZaywKxYXxgrCRYYYG8Q is sitting out
CIRDepY9Rc5tiDJPd0nNpQ: folds
ZWdwcEAWYlrUhsRi6MOmoA: calls $1
knewtTmBc4Tc0z/5tAABYQ: folds
kz9ziSiGUc+857heiKSayw: folds
9swGhtpERPngKPtvpoZkoQ: folds
vR4IO10geOgvTW+LAUBv/A: calls $0.50
/kZ258i1lqmMUXbtrZIHJA: checks
*** FLOP *** [Qh Jh Th]
vR4IO10geOgvTW+LAUBv/A: checks
/kZ258i1lqmMUXbtrZIHJA: checks
ZWdwcEAWYlrUhsRi6MOmoA: bets $1
vR4IO10geOgvTW+LAUBv/A: folds
/kZ258i1lqmMUXbtrZIHJA: folds
ZWdwcEAWYlrUhsRi6MOmoA collected $2.85 from pot
*** SUMMARY ***
Total pot $3 | Rake $0.15
Board [Qh Jh Th]
Seat 1: knewtTmBc4Tc0z/5tAABYQ folded before Flop (didn't bet)
Seat 2: kz9ziSiGUc+857heiKSayw folded before Flop (didn't bet)
Seat 3: 9swGhtpERPngKPtvpoZkoQ (button) folded before Flop (didn't bet)
Seat 4: vR4IO10geOgvTW+LAUBv/A (small blind) folded on the Flop
Seat 5: /kZ258i1lqmMUXbtrZIHJA (big blind) folded on the Flop
Seat 6: bJckevFOcg//s0qyMQI6sQ folded before Flop (didn't bet)
Seat 7: NfnZaywKxYXxgrCRYYYG8Q folded before Flop (didn't bet)
Seat 8: CIRDepY9Rc5tiDJPd0nNpQ folded before Flop (didn't bet)
Seat 9: ZWdwcEAWYlrUhsRi6MOmoA collected ($2.85)



PokerStars Game #59938573862:  Hold'em No Limit ($0.50/$1.00) - 2009/07/01 0:18:15 ET
Table '+cA8mcmhaedZ7YcrDdhmeQ' 6-max Seat #3 is the button
Seat 1: lsLuWlcPA3Rh7kJVLzMh0Q ($234.50 in chips)
Seat 2: trnpu4tPju3BU8W0wQQaiQ ($99.60 in chips)
Seat 3: 0WjiuIT7/EolY1oOx1ngeA ($141.50 in chips)
Seat 5: 6WyjEXOToimYmtLdqIgHYQ ($55.60 in chips)
Seat 6: YfsTQsY/fxb+YqbdclTHuw ($88.15 in chips)
6WyjEXOToimYmtLdqIgHYQ: posts small blind $0.50
YfsTQsY/fxb+YqbdclTHuw: posts big blind $1
*** HOLE CARDS ***
lsLuWlcPA3Rh7kJVLzMh0Q: folds
trnpu4tPju3BU8W0wQQaiQ: folds
0WjiuIT7/EolY1oOx1ngeA: raises $2 to $3
6WyjEXOToimYmtLdqIgHYQ: calls $2.50
YfsTQsY/fxb+YqbdclTHuw: folds
*** FLOP *** [Qd 4s Th]
6WyjEXOToimYmtLdqIgHYQ: checks
0WjiuIT7/EolY1oOx1ngeA: bets $3
6WyjEXOToimYmtLdqIgHYQ: raises $6 to $9
0WjiuIT7/EolY1oOx1ngeA: folds
6WyjEXOToimYmtLdqIgHYQ collected $12.40 from pot
*** SUMMARY ***
Total pot $13 | Rake $0.60
Board [Qd 4s Th]
Seat 1: lsLuWlcPA3Rh7kJVLzMh0Q folded before Flop (didn't bet)
Seat 2: trnpu4tPju3BU8W0wQQaiQ folded before Flop (didn't bet)
Seat 3: 0WjiuIT7/EolY1oOx1ngeA (button) folded on the Flop
Seat 5: 6WyjEXOToimYmtLdqIgHYQ (small blind) collected ($12.40)
Seat 6: YfsTQsY/fxb+YqbdclTHuw (big blind) folded before Flop



PokerStars Game #59938574766:  Hold'em No Limit ($0.50/$1.00) - 2009/07/01 0:18:16 ET
Table 'pHrhryH8jPNdQfY62f8v+g' 6-max Seat #3 is the button
Seat 1: BdbmJTZZ47quA9vUWwXtlw ($69.75 in chips)
Seat 2: RqgF7gRoKgRNW8Zoi1ty4A ($100 in chips)
Seat 3: rw4J9hTeo4c+qBV5IU/aQQ ($25.45 in chips)
Seat 4: wenbG7TaM3H7h5kn78OFNw ($46.50 in chips)
Seat 5: Gp2euK/nqF6qXKe7U+jOfw ($121.65 in chips)
Seat 6: xNKcQzD9+/iHmtJn4vYq9w ($217.65 in chips)
wenbG7TaM3H7h5kn78OFNw: posts small blind $0.50
Gp2euK/nqF6qXKe7U+jOfw: posts big blind $1
*** HOLE CARDS ***
xNKcQzD9+/iHmtJn4vYq9w: raises $2.50 to $3.50
BdbmJTZZ47quA9vUWwXtlw: raises $5.50 to $9
RqgF7gRoKgRNW8Zoi1ty4A: folds
rw4J9hTeo4c+qBV5IU/aQQ: folds
wenbG7TaM3H7h5kn78OFNw: folds
Gp2euK/nqF6qXKe7U+jOfw: folds
xNKcQzD9+/iHmtJn4vYq9w: folds
BdbmJTZZ47quA9vUWwXtlw collected $8.50 from pot
*** SUMMARY ***
Total pot $8.50 | Rake $0
Seat 1: BdbmJTZZ47quA9vUWwXtlw collected ($8.50)
Seat 2: RqgF7gRoKgRNW8Zoi1ty4A folded before Flop (didn't bet)
Seat 3: rw4J9hTeo4c+qBV5IU/aQQ (button) folded before Flop (didn't bet)
Seat 4: wenbG7TaM3H7h5kn78OFNw (small blind) folded before Flop
Seat 5: Gp2euK/nqF6qXKe7U+jOfw (big blind) folded before Flop
Seat 6: xNKcQzD9+/iHmtJn4vYq9w folded before Flop



PokerStars Game #59938575112:  Hold'em No Limit ($0.50/$1.00) - 2009/07/01 0:18:17 ET
Table '/+ni2d7lj6E90JmAQZKSOw' 2-max Seat #2 is the button
Seat 1: qubgcbkrXfMjdrMEd1lYMQ ($262 in chips)
Seat 2: IJu7Boitu3yAxp4hjIx6zQ ($109.20 in chips)
IJu7Boitu3yAxp4hjIx6zQ: posts small blind $0.50
qubgcbkrXfMjdrMEd1lYMQ: posts big blind $1
*** HOLE CARDS ***
IJu7Boitu3yAxp4hjIx6zQ: raises $2 to $3
qubgcbkrXfMjdrMEd1lYMQ: folds
IJu7Boitu3yAxp4hjIx6zQ collected $2 from pot
IJu7Boitu3yAxp4hjIx6zQ: doesn't show hand
*** SUMMARY ***
Total pot $2 | Rake $0
Seat 1: qubgcbkrXfMjdrMEd1lYMQ (big blind) folded before Flop
Seat 2: IJu7Boitu3yAxp4hjIx6zQ (button) (small blind) collected ($2)



PokerStars Game #59938577942:  Hold'em No Limit ($0.50/$1.00) - 2009/07/01 0:18:21 ET
Table 'eU3bWpDDg3Z+9R4m4iVmog' 6-max Seat #6 is the button
Seat 2: 8CAoOzhmB8n3nRFf3V4BTg ($180.45 in chips)
Seat 4: GDVIsbEJ/DOJsMKE4Asz0A ($94.05 in chips)
Seat 5: QHvTZcrKe6+maWUfVjP29Q ($100.50 in chips)
Seat 6: hpxXcmRkXXI9HE5+5/j/0Q ($100 in chips)
8CAoOzhmB8n3nRFf3V4BTg: posts small blind $0.50
U6tnjwZRpTnM+YkqkCjwyQ has timed out while disconnected
U6tnjwZRpTnM+YkqkCjwyQ: is sitting out
GDVIsbEJ/DOJsMKE4Asz0A: posts big blind $1
*** HOLE CARDS ***
QHvTZcrKe6+maWUfVjP29Q: folds
hpxXcmRkXXI9HE5+5/j/0Q: folds
8CAoOzhmB8n3nRFf3V4BTg: calls $0.50
GDVIsbEJ/DOJsMKE4Asz0A: checks
*** FLOP *** [6d 9d 3s]
8CAoOzhmB8n3nRFf3V4BTg: checks
GDVIsbEJ/DOJsMKE4Asz0A: bets $2
8CAoOzhmB8n3nRFf3V4BTg: folds
U6tnjwZRpTnM+YkqkCjwyQ is connected
GDVIsbEJ/DOJsMKE4Asz0A collected $1.90 from pot
U6tnjwZRpTnM+YkqkCjwyQ has returned
GDVIsbEJ/DOJsMKE4Asz0A: doesn't show hand
*** SUMMARY ***
Total pot $2 | Rake $0.10
Board [6d 9d 3s]
Seat 2: 8CAoOzhmB8n3nRFf3V4BTg (small blind) folded on the Flop
Seat 4: GDVIsbEJ/DOJsMKE4Asz0A (big blind) collected ($1.90)
Seat 5: QHvTZcrKe6+maWUfVjP29Q folded before Flop (didn't bet)
Seat 6: hpxXcmRkXXI9HE5+5/j/0Q (button) folded before Flop (didn't bet)



PokerStars Game #59938578540:  Hold'em No Limit ($0.50/$1.00) - 2009/07/01 0:18:22 ET
Table 'cBDNutyLBKEk9+ptwsKmTw' 6-max Seat #2 is the button
Seat 1: tb0dt30qP2x/8f+Xta4mVg ($22.45 in chips)
Seat 2: KyaE4+hWgUNIWWOWy4D14w ($63.30 in chips)
Seat 3: G5ZSSN6RSON3gkNvk/SmYg ($105.55 in chips)
Seat 4: 0WjiuIT7/EolY1oOx1ngeA ($107.65 in chips)
Seat 5: OGMLOcTNYZXZU81au7ztUw ($106.75 in chips)
Seat 6: pyzhFUPPSNzrysiMqlA5Xw ($13.75 in chips)
G5ZSSN6RSON3gkNvk/SmYg: posts small blind $0.50
0WjiuIT7/EolY1oOx1ngeA: posts big blind $1
*** HOLE CARDS ***
OGMLOcTNYZXZU81au7ztUw: folds
pyzhFUPPSNzrysiMqlA5Xw: folds
tb0dt30qP2x/8f+Xta4mVg: raises $4 to $5
KyaE4+hWgUNIWWOWy4D14w: folds
G5ZSSN6RSON3gkNvk/SmYg: folds
0WjiuIT7/EolY1oOx1ngeA: folds
tb0dt30qP2x/8f+Xta4mVg collected $2.50 from pot
*** SUMMARY ***
Total pot $2.50 | Rake $0
Seat 1: tb0dt30qP2x/8f+Xta4mVg collected ($2.50)
Seat 2: KyaE4+hWgUNIWWOWy4D14w (button) folded before Flop (didn't bet)
Seat 3: G5ZSSN6RSON3gkNvk/SmYg (small blind) folded before Flop
Seat 4: 0WjiuIT7/EolY1oOx1ngeA (big blind) folded before Flop
Seat 5: OGMLOcTNYZXZU81au7ztUw folded before Flop (didn't bet)
Seat 6: pyzhFUPPSNzrysiMqlA5Xw folded before Flop (didn't bet)



PokerStars Game #59938579952:  Hold'em No Limit ($0.50/$1.00) - 2009/07/01 0:18:24 ET
Table 'aWHveb63HkbTmOGHOxjBkQ' 2-max Seat #2 is the button
Seat 1: xy2MQKoHoCZZIudmw8Xbow ($191.10 in chips)
Seat 2: xstEKavv3YDxpUnU4e9qAQ ($184.10 in chips)
xstEKavv3YDxpUnU4e9qAQ: posts small blind $0.50
xy2MQKoHoCZZIudmw8Xbow: posts big blind $1
*** HOLE CARDS ***
xstEKavv3YDxpUnU4e9qAQ: folds
xy2MQKoHoCZZIudmw8Xbow collected $1 from pot
xy2MQKoHoCZZIudmw8Xbow: doesn't show hand
*** SUMMARY ***
Total pot $1 | Rake $0
Seat 1: xy2MQKoHoCZZIudmw8Xbow (big blind) collected ($1)
Seat 2: xstEKavv3YDxpUnU4e9qAQ (button) (small blind) folded before Flop



PokerStars Game #59938581542:  Hold'em No Limit ($0.50/$1.00) - 2009/07/01 0:18:27 ET
Table '/+ni2d7lj6E90JmAQZKSOw' 2-max Seat #1 is the button
Seat 1: qubgcbkrXfMjdrMEd1lYMQ ($261 in chips)
Seat 2: IJu7Boitu3yAxp4hjIx6zQ ($110.20 in chips)
qubgcbkrXfMjdrMEd1lYMQ: posts small blind $0.50
IJu7Boitu3yAxp4hjIx6zQ: posts big blind $1
*** HOLE CARDS ***
qubgcbkrXfMjdrMEd1lYMQ: raises $2 to $3
IJu7Boitu3yAxp4hjIx6zQ: calls $2
*** FLOP *** [5d 7h 5s]
IJu7Boitu3yAxp4hjIx6zQ: checks
qubgcbkrXfMjdrMEd1lYMQ: bets $4
IJu7Boitu3yAxp4hjIx6zQ: folds
qubgcbkrXfMjdrMEd1lYMQ collected $5.70 from pot
*** SUMMARY ***
Total pot $6 | Rake $0.30
Board [5d 7h 5s]
Seat 1: qubgcbkrXfMjdrMEd1lYMQ (button) (small blind) collected ($5.70)
Seat 2: IJu7Boitu3yAxp4hjIx6zQ (big blind) folded on the Flop



PokerStars Game #59938582882:  Hold'em No Limit ($0.50/$1.00) - 2009/07/01 0:18:28 ET
Table 'tLrtq7gDzxEvckNAI1OS5Q' 6-max Seat #1 is the button
Seat 1: GisIe1kcC9q/xV6ifsTjgA ($143.50 in chips)
Seat 3: TPZ+m9x+lwoKpv7TMfAUWA ($324.35 in chips)
Seat 5: OGMLOcTNYZXZU81au7ztUw ($175.15 in chips)
Seat 6: XUk5GQsfNFpHvaToDZ0rZA ($24.15 in chips)
qsObMEIlRO22OlS867m/lw will be allowed to play after the button
TPZ+m9x+lwoKpv7TMfAUWA: posts small blind $0.50
KOG8rG51mOvIoY96zF3kvw: is sitting out
OGMLOcTNYZXZU81au7ztUw: posts big blind $1
*** HOLE CARDS ***
KOG8rG51mOvIoY96zF3kvw has returned
XUk5GQsfNFpHvaToDZ0rZA: folds
GisIe1kcC9q/xV6ifsTjgA: folds
TPZ+m9x+lwoKpv7TMfAUWA: folds
OGMLOcTNYZXZU81au7ztUw collected $1 from pot
OGMLOcTNYZXZU81au7ztUw: doesn't show hand
*** SUMMARY ***
Total pot $1 | Rake $0
Seat 1: GisIe1kcC9q/xV6ifsTjgA (button) folded before Flop (didn't bet)
Seat 3: TPZ+m9x+lwoKpv7TMfAUWA (small blind) folded before Flop
Seat 5: OGMLOcTNYZXZU81au7ztUw (big blind) collected ($1)
Seat 6: XUk5GQsfNFpHvaToDZ0rZA folded before Flop (didn't bet)



PokerStars Game #59938582680:  Hold'em No Limit ($0.50/$1.00) - 2009/07/01 0:18:28 ET
Table 'FKpXUINE6M3UxHG4zaMhHA' 6-max Seat #2 is the button
Seat 2: Zboa6dColKGHBjLPUakZjw ($100.10 in chips)
Seat 3: ssLJburtEIqnVkx6X8R1uw ($121.90 in chips)
Seat 4: ru6SCVvWcWt2SpmUsmArWQ ($20 in chips)
Seat 5: hpxXcmRkXXI9HE5+5/j/0Q ($106.70 in chips)
Seat 6: b2a+5TkFf4xJN/Ihhma58Q ($24.80 in chips)
ssLJburtEIqnVkx6X8R1uw: posts small blind $0.50
ru6SCVvWcWt2SpmUsmArWQ: posts big blind $1
*** HOLE CARDS ***
hpxXcmRkXXI9HE5+5/j/0Q: folds
b2a+5TkFf4xJN/Ihhma58Q: folds
Zboa6dColKGHBjLPUakZjw: folds
Zboa6dColKGHBjLPUakZjw leaves the table
ssLJburtEIqnVkx6X8R1uw: raises $23 to $24
ecfRjfaWRYbPNvaBsW5ZQQ joins the table at seat #2
ru6SCVvWcWt2SpmUsmArWQ: folds
ssLJburtEIqnVkx6X8R1uw collected $2 from pot
ssLJburtEIqnVkx6X8R1uw: doesn't show hand
*** SUMMARY ***
Total pot $2 | Rake $0
Seat 2: Zboa6dColKGHBjLPUakZjw (button) folded before Flop (didn't bet)
Seat 3: ssLJburtEIqnVkx6X8R1uw (small blind) collected ($2)
Seat 4: ru6SCVvWcWt2SpmUsmArWQ (big blind) folded before Flop
Seat 5: hpxXcmRkXXI9HE5+5/j/0Q folded before Flop (didn't bet)
Seat 6: b2a+5TkFf4xJN/Ihhma58Q folded before Flop (didn't bet)



PokerStars Game #59938582884:  Hold'em No Limit ($0.50/$1.00) - 2009/07/01 0:18:28 ET
Table 'N2bNCDHL96aCQDvZIh+yQQ' 6-max Seat #3 is the button
Seat 1: iHo1oDbrEVJ8nEGdaPrICw ($128.10 in chips)
Seat 2: KpnW5CcJ4Mg6MeclfKmLrw ($101.50 in chips)
Seat 3: PXT6kJgVX67c3EgncNqRoA ($54.95 in chips)
Seat 4: uCqEjnxh2/vFBjKYkfTOkw ($162.20 in chips)
Seat 5: rHlMOfR7kpQQxe+PFQz0xQ ($50 in chips)
uCqEjnxh2/vFBjKYkfTOkw: posts small blind $0.50
rHlMOfR7kpQQxe+PFQz0xQ: posts big blind $1
*** HOLE CARDS ***
iHo1oDbrEVJ8nEGdaPrICw: folds
KpnW5CcJ4Mg6MeclfKmLrw: folds
PXT6kJgVX67c3EgncNqRoA: folds
uCqEjnxh2/vFBjKYkfTOkw: raises $2 to $3
rHlMOfR7kpQQxe+PFQz0xQ: folds
uCqEjnxh2/vFBjKYkfTOkw collected $2 from pot
uCqEjnxh2/vFBjKYkfTOkw: doesn't show hand
*** SUMMARY ***
Total pot $2 | Rake $0
Seat 1: iHo1oDbrEVJ8nEGdaPrICw folded before Flop (didn't bet)
Seat 2: KpnW5CcJ4Mg6MeclfKmLrw folded before Flop (didn't bet)
Seat 3: PXT6kJgVX67c3EgncNqRoA (button) folded before Flop (didn't bet)
Seat 4: uCqEjnxh2/vFBjKYkfTOkw (small blind) collected ($2)
Seat 5: rHlMOfR7kpQQxe+PFQz0xQ (big blind) folded before Flop



PokerStars Game #59938583648:  Hold'em No Limit ($0.50/$1.00) - 2009/07/01 0:18:30 ET
Table 'aWHveb63HkbTmOGHOxjBkQ' 2-max Seat #1 is the button
Seat 1: xy2MQKoHoCZZIudmw8Xbow ($191.60 in chips)
Seat 2: xstEKavv3YDxpUnU4e9qAQ ($183.60 in chips)
xy2MQKoHoCZZIudmw8Xbow: posts small blind $0.50
xstEKavv3YDxpUnU4e9qAQ: posts big blind $1
*** HOLE CARDS ***
xy2MQKoHoCZZIudmw8Xbow: raises $2 to $3
xstEKavv3YDxpUnU4e9qAQ: folds
xy2MQKoHoCZZIudmw8Xbow collected $2 from pot
xy2MQKoHoCZZIudmw8Xbow: doesn't show hand
*** SUMMARY ***
Total pot $2 | Rake $0
Seat 1: xy2MQKoHoCZZIudmw8Xbow (button) (small blind) collected ($2)
Seat 2: xstEKavv3YDxpUnU4e9qAQ (big blind) folded before Flop



PokerStars Game #59938584802:  Hold'em No Limit ($0.50/$1.00) - 2009/07/01 0:18:31 ET
Table 'Zka9tv1yilg0MvXWPQrShg' 9-max Seat #3 is the button
Seat 1: TZcz9MEWDA+WydgGruqqbw ($100 in chips)
Seat 2: zBHLwg+HmbHmRtVQMhavjA ($105.55 in chips)
Seat 3: gUUvmqdVlmvpal6B8nYrmg ($100 in chips)
Seat 4: CTOae+JLIGfwfXvhqHkP2w ($146.65 in chips)
Seat 5: /zy+DB4S5fUQUSfZWFzYGw ($185.45 in chips)
Seat 6: rY8wPoax1lS+HUY+I0FZDw ($126.70 in chips)
Seat 7: p1SafS90nb3Uft5LB0NkHw ($20 in chips)
Seat 8: bL+QVeDcuEdzMGAGg2XJHg ($126.10 in chips)
Seat 9: SlhHwZrXCVifyCHK+qz1Kw ($100.45 in chips)
CTOae+JLIGfwfXvhqHkP2w: posts small blind $0.50
/zy+DB4S5fUQUSfZWFzYGw: posts big blind $1
*** HOLE CARDS ***
rY8wPoax1lS+HUY+I0FZDw: raises $2 to $3
p1SafS90nb3Uft5LB0NkHw: folds
bL+QVeDcuEdzMGAGg2XJHg: folds
SlhHwZrXCVifyCHK+qz1Kw: folds
TZcz9MEWDA+WydgGruqqbw: folds
zBHLwg+HmbHmRtVQMhavjA: folds
gUUvmqdVlmvpal6B8nYrmg: folds
CTOae+JLIGfwfXvhqHkP2w: folds
/zy+DB4S5fUQUSfZWFzYGw: calls $2
*** FLOP *** [Ad 5s 8c]
/zy+DB4S5fUQUSfZWFzYGw: checks
rY8wPoax1lS+HUY+I0FZDw: bets $5
/zy+DB4S5fUQUSfZWFzYGw: folds
rY8wPoax1lS+HUY+I0FZDw collected $6.20 from pot
*** SUMMARY ***
Total pot $6.50 | Rake $0.30
Board [Ad 5s 8c]
Seat 1: TZcz9MEWDA+WydgGruqqbw folded before Flop (didn't bet)
Seat 2: zBHLwg+HmbHmRtVQMhavjA folded before Flop (didn't bet)
Seat 3: gUUvmqdVlmvpal6B8nYrmg (button) folded before Flop (didn't bet)
Seat 4: CTOae+JLIGfwfXvhqHkP2w (small blind) folded before Flop
Seat 5: /zy+DB4S5fUQUSfZWFzYGw (big blind) folded on the Flop
Seat 6: rY8wPoax1lS+HUY+I0FZDw collected ($6.20)
Seat 7: p1SafS90nb3Uft5LB0NkHw folded before Flop (didn't bet)
Seat 8: bL+QVeDcuEdzMGAGg2XJHg folded before Flop (didn't bet)
Seat 9: SlhHwZrXCVifyCHK+qz1Kw folded before Flop (didn't bet)



PokerStars Game #59938584758:  Hold'em No Limit ($0.50/$1.00) - 2009/07/01 0:18:31 ET
Table '7Nl0ffnjeK44/vmeexh3MQ' 9-max Seat #9 is the button
Seat 1: s7D3Y+k4Cj4D1cXHv7oj+Q ($102.80 in chips)
Seat 3: 200876 ($48 in chips)
Seat 4: NfbTuCZ2txeWuV3hP7t0TA ($100 in chips)
Seat 5: bL+QVeDcuEdzMGAGg2XJHg ($104.50 in chips)
Seat 6: FVs16t7GgfWgQWt4JxsObQ ($19.05 in chips)
Seat 7: knewtTmBc4Tc0z/5tAABYQ ($108 in chips)
Seat 8: zanka7aAZkigmZpfopXxxA ($137.70 in chips)
Seat 9: Ei6tUEmph+Q+DkB6JH3thw ($78.80 in chips)
s7D3Y+k4Cj4D1cXHv7oj+Q: posts small blind $0.50
200876: posts big blind $1
*** HOLE CARDS ***
NfbTuCZ2txeWuV3hP7t0TA: folds
bL+QVeDcuEdzMGAGg2XJHg: raises $3 to $4
FVs16t7GgfWgQWt4JxsObQ: folds
knewtTmBc4Tc0z/5tAABYQ: folds
zanka7aAZkigmZpfopXxxA: folds
Ei6tUEmph+Q+DkB6JH3thw: folds
s7D3Y+k4Cj4D1cXHv7oj+Q: folds
200876: calls $3
*** FLOP *** [6c 8d Ts]
200876: checks
bL+QVeDcuEdzMGAGg2XJHg: bets $7
200876: folds
bL+QVeDcuEdzMGAGg2XJHg collected $8.10 from pot
bL+QVeDcuEdzMGAGg2XJHg: doesn't show hand
*** SUMMARY ***
Total pot $8.50 | Rake $0.40
Board [6c 8d Ts]
Seat 1: s7D3Y+k4Cj4D1cXHv7oj+Q (small blind) folded before Flop
Seat 3: 200876 (big blind) folded on the Flop
Seat 4: NfbTuCZ2txeWuV3hP7t0TA folded before Flop (didn't bet)
Seat 5: bL+QVeDcuEdzMGAGg2XJHg collected ($8.10)
Seat 6: FVs16t7GgfWgQWt4JxsObQ folded before Flop (didn't bet)
Seat 7: knewtTmBc4Tc0z/5tAABYQ folded before Flop (didn't bet)
Seat 8: zanka7aAZkigmZpfopXxxA folded before Flop (didn't bet)
Seat 9: Ei6tUEmph+Q+DkB6JH3thw (button) folded before Flop (didn't bet)



PokerStars Game #59938588246:  Hold'em No Limit ($0.50/$1.00) - 2009/07/01 0:18:36 ET
Table 'cKH9c4x6u79IqCdaKKvXrw' 9-max Seat #8 is the button
Seat 1: p1SafS90nb3Uft5LB0NkHw ($16 in chips)
Seat 2: knewtTmBc4Tc0z/5tAABYQ ($198 in chips)
Seat 3: PSKRoZctK4pmrhu1fYnndg ($96.90 in chips)
Seat 4: FL3MrLspcF23LYvC4ipBOA ($100 in chips)
Seat 5: negfosHnGOZXSHpWDRKyBQ ($27.80 in chips)
Seat 6: Bsd/K5gAcLanYbGiPirRjw ($161.50 in chips)
Seat 7: 0eFnow7+D7veCYQ+CG9FFw ($92.85 in chips)
Seat 8: 4/8w7g4QE6v0i1tIIf/1HQ ($64 in chips)
p1SafS90nb3Uft5LB0NkHw: posts small blind $0.50
knewtTmBc4Tc0z/5tAABYQ: posts big blind $1
*** HOLE CARDS ***
PSKRoZctK4pmrhu1fYnndg: folds
PSKRoZctK4pmrhu1fYnndg leaves the table
FL3MrLspcF23LYvC4ipBOA: folds
negfosHnGOZXSHpWDRKyBQ: folds
Bsd/K5gAcLanYbGiPirRjw: raises $2 to $3
0eFnow7+D7veCYQ+CG9FFw: folds
4/8w7g4QE6v0i1tIIf/1HQ: calls $3
p1SafS90nb3Uft5LB0NkHw: folds
knewtTmBc4Tc0z/5tAABYQ: folds
*** FLOP *** [5h Js 7d]
Bsd/K5gAcLanYbGiPirRjw: bets $4
4/8w7g4QE6v0i1tIIf/1HQ: calls $4
*** TURN *** [5h Js 7d] [Jd]
Bsd/K5gAcLanYbGiPirRjw: checks
4/8w7g4QE6v0i1tIIf/1HQ: checks
*** RIVER *** [5h Js 7d Jd] [2s]
Bsd/K5gAcLanYbGiPirRjw: checks
4/8w7g4QE6v0i1tIIf/1HQ: checks
*** SHOW DOWN ***
Bsd/K5gAcLanYbGiPirRjw: shows [Kd Ah] (a pair of Jacks)
4/8w7g4QE6v0i1tIIf/1HQ: mucks hand
Bsd/K5gAcLanYbGiPirRjw collected $14.75 from pot
*** SUMMARY ***
Total pot $15.50 | Rake $0.75
Board [5h Js 7d Jd 2s]
Seat 1: p1SafS90nb3Uft5LB0NkHw (small blind) folded before Flop
Seat 2: knewtTmBc4Tc0z/5tAABYQ (big blind) folded before Flop
Seat 3: PSKRoZctK4pmrhu1fYnndg folded before Flop (didn't bet)
Seat 4: FL3MrLspcF23LYvC4ipBOA folded before Flop (didn't bet)
Seat 5: negfosHnGOZXSHpWDRKyBQ folded before Flop (didn't bet)
Seat 6: Bsd/K5gAcLanYbGiPirRjw showed [Kd Ah] and won ($14.75) with a pair of Jacks
Seat 7: 0eFnow7+D7veCYQ+CG9FFw folded before Flop (didn't bet)
Seat 8: 4/8w7g4QE6v0i1tIIf/1HQ (button) mucked



PokerStars Game #59938587860:  Hold'em No Limit ($0.50/$1.00) - 2009/07/01 0:18:36 ET
Table 'aWHveb63HkbTmOGHOxjBkQ' 2-max Seat #2 is the button
Seat 1: xy2MQKoHoCZZIudmw8Xbow ($192.60 in chips)
Seat 2: xstEKavv3YDxpUnU4e9qAQ ($182.60 in chips)
xstEKavv3YDxpUnU4e9qAQ: posts small blind $0.50
xy2MQKoHoCZZIudmw8Xbow: posts big blind $1
*** HOLE CARDS ***
xstEKavv3YDxpUnU4e9qAQ: folds
xy2MQKoHoCZZIudmw8Xbow collected $1 from pot
xy2MQKoHoCZZIudmw8Xbow: doesn't show hand
*** SUMMARY ***
Total pot $1 | Rake $0
Seat 1: xy2MQKoHoCZZIudmw8Xbow (big blind) collected ($1)
Seat 2: xstEKavv3YDxpUnU4e9qAQ (button) (small blind) folded before Flop



PokerStars Game #59938588850:  Hold'em No Limit ($0.50/$1.00) - 2009/07/01 0:18:37 ET
Table 'SQLOQoANiHscJ8AL7zffbw' 9-max Seat #1 is the button
Seat 1: jPTRd6SpCp4xqAy2XQiTOw ($103.05 in chips)
Seat 2: /zy+DB4S5fUQUSfZWFzYGw ($284.85 in chips)
Seat 3: 0eFnow7+D7veCYQ+CG9FFw ($100 in chips)
Seat 4: N9n5Wc3s35DpCrOAUUNAaQ ($121.80 in chips)
Seat 5: L9njYvloJ1NdXjP8edHEAg ($100 in chips)
Seat 6: p5UKaxVobvptF0ANhR/q1A ($158.50 in chips)
Seat 7: bJckevFOcg//s0qyMQI6sQ ($100 in chips)
Seat 8: yfXek8iJ7O4CFyqXrtGcfg ($82.45 in chips)
/zy+DB4S5fUQUSfZWFzYGw: posts small blind $0.50
0eFnow7+D7veCYQ+CG9FFw: posts big blind $1
*** HOLE CARDS ***
N9n5Wc3s35DpCrOAUUNAaQ: folds
L9njYvloJ1NdXjP8edHEAg: folds
p5UKaxVobvptF0ANhR/q1A: folds
bJckevFOcg//s0qyMQI6sQ: folds
yfXek8iJ7O4CFyqXrtGcfg: raises $2 to $3
jPTRd6SpCp4xqAy2XQiTOw: folds
/zy+DB4S5fUQUSfZWFzYGw: folds
0eFnow7+D7veCYQ+CG9FFw: folds
yfXek8iJ7O4CFyqXrtGcfg collected $2.50 from pot
*** SUMMARY ***
Total pot $2.50 | Rake $0
Seat 1: jPTRd6SpCp4xqAy2XQiTOw (button) folded before Flop (didn't bet)
Seat 2: /zy+DB4S5fUQUSfZWFzYGw (small blind) folded before Flop
Seat 3: 0eFnow7+D7veCYQ+CG9FFw (big blind) folded before Flop
Seat 4: N9n5Wc3s35DpCrOAUUNAaQ folded before Flop (didn't bet)
Seat 5: L9njYvloJ1NdXjP8edHEAg folded before Flop (didn't bet)
Seat 6: p5UKaxVobvptF0ANhR/q1A folded before Flop (didn't bet)
Seat 7: bJckevFOcg//s0qyMQI6sQ folded before Flop (didn't bet)
Seat 8: yfXek8iJ7O4CFyqXrtGcfg collected ($2.50)



PokerStars Game #59938590100:  Hold'em No Limit ($0.50/$1.00) - 2009/07/01 0:18:39 ET
Table 'kS0cTQAEi+fdUlJP2gQYvw' 9-max Seat #2 is the button
Seat 1: c/9X4zftzphFxYtxp5kp9w ($41.50 in chips)
Seat 2: 4SFNYndzMeslixOnF4koZQ ($38.90 in chips)
Seat 3: 3obndzTJ6fECz8+wWhMd1w ($19 in chips)
Seat 4: TZcz9MEWDA+WydgGruqqbw ($110.30 in chips)
Seat 5: b0jO1SDhLedy1//CQlA8kw ($17 in chips)
Seat 6: yAbu2QsRPVcjPbqlf/jDxw ($102.15 in chips)
Seat 7: Ffa7Nj4X5fddtROP01hfQg ($97.65 in chips)
Seat 8: qTymj6ZQ8ZoFi6fINJZb3w ($87 in chips)
Seat 9: y8Qb94e81yI/g0saQ6gU5g ($89.25 in chips)
3obndzTJ6fECz8+wWhMd1w: posts small blind $0.50
TZcz9MEWDA+WydgGruqqbw: posts big blind $1
*** HOLE CARDS ***
b0jO1SDhLedy1//CQlA8kw: folds
yAbu2QsRPVcjPbqlf/jDxw: folds
Ffa7Nj4X5fddtROP01hfQg: calls $1
qTymj6ZQ8ZoFi6fINJZb3w: folds
y8Qb94e81yI/g0saQ6gU5g: folds
c/9X4zftzphFxYtxp5kp9w: raises $3 to $4
4SFNYndzMeslixOnF4koZQ: folds
3obndzTJ6fECz8+wWhMd1w: folds
TZcz9MEWDA+WydgGruqqbw: folds
Ffa7Nj4X5fddtROP01hfQg: calls $3
*** FLOP *** [4c As 4d]
Ffa7Nj4X5fddtROP01hfQg: bets $2
c/9X4zftzphFxYtxp5kp9w: calls $2
*** TURN *** [4c As 4d] [Qc]
Ffa7Nj4X5fddtROP01hfQg: bets $2
c/9X4zftzphFxYtxp5kp9w: raises $3 to $5
Ffa7Nj4X5fddtROP01hfQg: calls $3
*** RIVER *** [4c As 4d Qc] [3h]
Ffa7Nj4X5fddtROP01hfQg: checks
c/9X4zftzphFxYtxp5kp9w: bets $8
Ffa7Nj4X5fddtROP01hfQg: folds
c/9X4zftzphFxYtxp5kp9w collected $22.40 from pot
c/9X4zftzphFxYtxp5kp9w: shows [Ah Ad] (a full house, Aces full of Fours)
*** SUMMARY ***
Total pot $23.50 | Rake $1.10
Board [4c As 4d Qc 3h]
Seat 1: c/9X4zftzphFxYtxp5kp9w collected ($22.40)
Seat 2: 4SFNYndzMeslixOnF4koZQ (button) folded before Flop (didn't bet)
Seat 3: 3obndzTJ6fECz8+wWhMd1w (small blind) folded before Flop
Seat 4: TZcz9MEWDA+WydgGruqqbw (big blind) folded before Flop
Seat 5: b0jO1SDhLedy1//CQlA8kw folded before Flop (didn't bet)
Seat 6: yAbu2QsRPVcjPbqlf/jDxw folded before Flop (didn't bet)
Seat 7: Ffa7Nj4X5fddtROP01hfQg folded on the River
Seat 8: qTymj6ZQ8ZoFi6fINJZb3w folded before Flop (didn't bet)
Seat 9: y8Qb94e81yI/g0saQ6gU5g folded before Flop (didn't bet)



PokerStars Game #59938591022:  Hold'em No Limit ($0.50/$1.00) - 2009/07/01 0:18:40 ET
Table 'kBJtONSnMKK6+l5D0n+vjA' 2-max Seat #2 is the button
Seat 1: qubgcbkrXfMjdrMEd1lYMQ ($340.90 in chips)
Seat 2: 5x9BehadQB/XenOdQDZzEQ ($44.10 in chips)
5x9BehadQB/XenOdQDZzEQ: posts small blind $0.50
qubgcbkrXfMjdrMEd1lYMQ: posts big blind $1
*** HOLE CARDS ***
5x9BehadQB/XenOdQDZzEQ: folds
qubgcbkrXfMjdrMEd1lYMQ collected $1 from pot
*** SUMMARY ***
Total pot $1 | Rake $0
Seat 1: qubgcbkrXfMjdrMEd1lYMQ (big blind) collected ($1)
Seat 2: 5x9BehadQB/XenOdQDZzEQ (button) (small blind) folded before Flop



PokerStars Game #59938590482:  Hold'em No Limit ($0.50/$1.00) - 2009/07/01 0:18:40 ET
Table 'pHrhryH8jPNdQfY62f8v+g' 6-max Seat #4 is the button
Seat 1: BdbmJTZZ47quA9vUWwXtlw ($74.75 in chips)
Seat 2: RqgF7gRoKgRNW8Zoi1ty4A ($100 in chips)
Seat 3: rw4J9hTeo4c+qBV5IU/aQQ ($25.45 in chips)
Seat 4: wenbG7TaM3H7h5kn78OFNw ($46 in chips)
Seat 5: Gp2euK/nqF6qXKe7U+jOfw ($120.65 in chips)
Seat 6: xNKcQzD9+/iHmtJn4vYq9w ($214.15 in chips)
Gp2euK/nqF6qXKe7U+jOfw: posts small blind $0.50
xNKcQzD9+/iHmtJn4vYq9w: posts big blind $1
*** HOLE CARDS ***
BdbmJTZZ47quA9vUWwXtlw: folds
RqgF7gRoKgRNW8Zoi1ty4A: folds
rw4J9hTeo4c+qBV5IU/aQQ: raises $1 to $2
wenbG7TaM3H7h5kn78OFNw: calls $2
Gp2euK/nqF6qXKe7U+jOfw: folds
xNKcQzD9+/iHmtJn4vYq9w: folds
*** FLOP *** [Kd Ks 9s]
rw4J9hTeo4c+qBV5IU/aQQ: bets $2
wenbG7TaM3H7h5kn78OFNw: calls $2
*** TURN *** [Kd Ks 9s] [5d]
rw4J9hTeo4c+qBV5IU/aQQ: checks
wenbG7TaM3H7h5kn78OFNw: checks
*** RIVER *** [Kd Ks 9s 5d] [2c]
rw4J9hTeo4c+qBV5IU/aQQ: bets $2
wenbG7TaM3H7h5kn78OFNw: raises $3 to $5
rw4J9hTeo4c+qBV5IU/aQQ: calls $3
*** SHOW DOWN ***
wenbG7TaM3H7h5kn78OFNw: shows [7h Kh] (three of a kind, Kings)
rw4J9hTeo4c+qBV5IU/aQQ: mucks hand
wenbG7TaM3H7h5kn78OFNw collected $18.55 from pot
*** SUMMARY ***
Total pot $19.50 | Rake $0.95
Board [Kd Ks 9s 5d 2c]
Seat 1: BdbmJTZZ47quA9vUWwXtlw folded before Flop (didn't bet)
Seat 2: RqgF7gRoKgRNW8Zoi1ty4A folded before Flop (didn't bet)
Seat 3: rw4J9hTeo4c+qBV5IU/aQQ mucked
Seat 4: wenbG7TaM3H7h5kn78OFNw (button) showed [7h Kh] and won ($18.55) with three of a kind, Kings
Seat 5: Gp2euK/nqF6qXKe7U+jOfw (small blind) folded before Flop
Seat 6: xNKcQzD9+/iHmtJn4vYq9w (big blind) folded before Flop



PokerStars Game #59938590400:  Hold'em No Limit ($0.50/$1.00) - 2009/07/01 0:18:40 ET
Table 'tLrtq7gDzxEvckNAI1OS5Q' 6-max Seat #3 is the button
Seat 1: GisIe1kcC9q/xV6ifsTjgA ($143.50 in chips)
Seat 2: qsObMEIlRO22OlS867m/lw ($39.85 in chips)
Seat 3: TPZ+m9x+lwoKpv7TMfAUWA ($323.85 in chips)
Seat 5: OGMLOcTNYZXZU81au7ztUw ($175.65 in chips)
Seat 6: XUk5GQsfNFpHvaToDZ0rZA ($24.15 in chips)
KOG8rG51mOvIoY96zF3kvw will be allowed to play after the button
OGMLOcTNYZXZU81au7ztUw: posts small blind $0.50
XUk5GQsfNFpHvaToDZ0rZA: posts big blind $1
qsObMEIlRO22OlS867m/lw: posts small & big blinds $1.50
*** HOLE CARDS ***
GisIe1kcC9q/xV6ifsTjgA: raises $2 to $3
qsObMEIlRO22OlS867m/lw: calls $2
TPZ+m9x+lwoKpv7TMfAUWA: folds
OGMLOcTNYZXZU81au7ztUw: folds
XUk5GQsfNFpHvaToDZ0rZA: folds
*** FLOP *** [Tc 6h 3h]
GisIe1kcC9q/xV6ifsTjgA: bets $3
qsObMEIlRO22OlS867m/lw: folds
GisIe1kcC9q/xV6ifsTjgA collected $7.60 from pot
*** SUMMARY ***
Total pot $8 | Rake $0.40
Board [Tc 6h 3h]
Seat 1: GisIe1kcC9q/xV6ifsTjgA collected ($7.60)
Seat 2: qsObMEIlRO22OlS867m/lw folded on the Flop
Seat 3: TPZ+m9x+lwoKpv7TMfAUWA (button) folded before Flop (didn't bet)
Seat 5: OGMLOcTNYZXZU81au7ztUw (small blind) folded before Flop
Seat 6: XUk5GQsfNFpHvaToDZ0rZA (big blind) folded before Flop



PokerStars Game #59938591284:  Hold'em No Limit ($0.50/$1.00) - 2009/07/01 0:18:41 ET
Table 'W/wyObTiXZm+Ckkl3YxcSw' 6-max Seat #4 is the button
Seat 1: ssLJburtEIqnVkx6X8R1uw ($100 in chips)
Seat 2: o2BpeCDF/L1yw7HKjemvYg ($25.80 in chips)
Seat 3: b2a+5TkFf4xJN/Ihhma58Q ($37.70 in chips)
Seat 4: BdbmJTZZ47quA9vUWwXtlw ($51.60 in chips)
Seat 5: Wko+clJG9HZPPQ7Yn0Y5Zg ($46 in chips)
Seat 6: GwvR1vWAchnuOBZu0dm5Rg ($89.75 in chips)
Wko+clJG9HZPPQ7Yn0Y5Zg: posts small blind $0.50
GwvR1vWAchnuOBZu0dm5Rg: posts big blind $1
*** HOLE CARDS ***
ssLJburtEIqnVkx6X8R1uw: raises $3 to $4
o2BpeCDF/L1yw7HKjemvYg: folds
b2a+5TkFf4xJN/Ihhma58Q: folds
BdbmJTZZ47quA9vUWwXtlw: folds
Wko+clJG9HZPPQ7Yn0Y5Zg: calls $3.50
GwvR1vWAchnuOBZu0dm5Rg: folds
*** FLOP *** [Kd Ac Td]
Wko+clJG9HZPPQ7Yn0Y5Zg: checks
ssLJburtEIqnVkx6X8R1uw: bets $7
Wko+clJG9HZPPQ7Yn0Y5Zg: calls $7
*** TURN *** [Kd Ac Td] [8d]
Wko+clJG9HZPPQ7Yn0Y5Zg: checks
ssLJburtEIqnVkx6X8R1uw: checks
*** RIVER *** [Kd Ac Td 8d] [9c]
Wko+clJG9HZPPQ7Yn0Y5Zg: bets $11
ssLJburtEIqnVkx6X8R1uw: calls $11
*** SHOW DOWN ***
Wko+clJG9HZPPQ7Yn0Y5Zg: shows [Ad 7h] (a pair of Aces)
ssLJburtEIqnVkx6X8R1uw: shows [As Qc] (a pair of Aces - King+Queen kicker)
ssLJburtEIqnVkx6X8R1uw collected $42.85 from pot
*** SUMMARY ***
Total pot $45 | Rake $2.15
Board [Kd Ac Td 8d 9c]
Seat 1: ssLJburtEIqnVkx6X8R1uw showed [As Qc] and won ($42.85) with a pair of Aces
Seat 2: o2BpeCDF/L1yw7HKjemvYg folded before Flop (didn't bet)
Seat 3: b2a+5TkFf4xJN/Ihhma58Q folded before Flop (didn't bet)
Seat 4: BdbmJTZZ47quA9vUWwXtlw (button) folded before Flop (didn't bet)
Seat 5: Wko+clJG9HZPPQ7Yn0Y5Zg (small blind) showed [Ad 7h] and lost with a pair of Aces
Seat 6: GwvR1vWAchnuOBZu0dm5Rg (big blind) folded before Flop



PokerStars Game #59938591572:  Hold'em No Limit ($0.50/$1.00) - 2009/07/01 0:18:41 ET
Table 'aWHveb63HkbTmOGHOxjBkQ' 2-max Seat #1 is the button
Seat 1: xy2MQKoHoCZZIudmw8Xbow ($193.10 in chips)
Seat 2: xstEKavv3YDxpUnU4e9qAQ ($182.10 in chips)
xy2MQKoHoCZZIudmw8Xbow: posts small blind $0.50
xstEKavv3YDxpUnU4e9qAQ: posts big blind $1
*** HOLE CARDS ***
xy2MQKoHoCZZIudmw8Xbow: raises $3 to $4
xstEKavv3YDxpUnU4e9qAQ: folds
xy2MQKoHoCZZIudmw8Xbow collected $2 from pot
xy2MQKoHoCZZIudmw8Xbow: doesn't show hand
*** SUMMARY ***
Total pot $2 | Rake $0
Seat 1: xy2MQKoHoCZZIudmw8Xbow (button) (small blind) collected ($2)
Seat 2: xstEKavv3YDxpUnU4e9qAQ (big blind) folded before Flop



PokerStars Game #59938594326:  Hold'em No Limit ($0.50/$1.00) - 2009/07/01 0:18:45 ET
Table 'fTlPiCj0utgzC/5io+I7ew' 6-max Seat #6 is the button
Seat 1: YMJG+F++3Aj6P8dAWda5fw ($99 in chips)
Seat 2: +xUCTmR3cU7G239W+vZv6g ($140.50 in chips)
Seat 4: uJVSceLggtsrJya+WtmUEA ($101.60 in chips)
Seat 5: bFrTkDcWGTxyvNul7GVdYg ($240.50 in chips)
Seat 6: AdLVjddOzm+sRNo1Bc3S6Q ($100 in chips)
YMJG+F++3Aj6P8dAWda5fw: posts small blind $0.50
+xUCTmR3cU7G239W+vZv6g: posts big blind $1
*** HOLE CARDS ***
uJVSceLggtsrJya+WtmUEA: raises $2 to $3
bFrTkDcWGTxyvNul7GVdYg: folds
AdLVjddOzm+sRNo1Bc3S6Q: folds
YMJG+F++3Aj6P8dAWda5fw: folds
+xUCTmR3cU7G239W+vZv6g: folds
uJVSceLggtsrJya+WtmUEA collected $2.50 from pot
*** SUMMARY ***
Total pot $2.50 | Rake $0
Seat 1: YMJG+F++3Aj6P8dAWda5fw (small blind) folded before Flop
Seat 2: +xUCTmR3cU7G239W+vZv6g (big blind) folded before Flop
Seat 4: uJVSceLggtsrJya+WtmUEA collected ($2.50)
Seat 5: bFrTkDcWGTxyvNul7GVdYg folded before Flop (didn't bet)
Seat 6: AdLVjddOzm+sRNo1Bc3S6Q (button) folded before Flop (didn't bet)



PokerStars Game #59938595012:  Hold'em No Limit ($0.50/$1.00) - 2009/07/01 0:18:46 ET
Table '/+ni2d7lj6E90JmAQZKSOw' 2-max Seat #2 is the button
Seat 1: qubgcbkrXfMjdrMEd1lYMQ ($263.70 in chips)
Seat 2: IJu7Boitu3yAxp4hjIx6zQ ($107.20 in chips)
IJu7Boitu3yAxp4hjIx6zQ: posts small blind $0.50
qubgcbkrXfMjdrMEd1lYMQ: posts big blind $1
*** HOLE CARDS ***
IJu7Boitu3yAxp4hjIx6zQ: folds
qubgcbkrXfMjdrMEd1lYMQ collected $1 from pot
*** SUMMARY ***
Total pot $1 | Rake $0
Seat 1: qubgcbkrXfMjdrMEd1lYMQ (big blind) collected ($1)
Seat 2: IJu7Boitu3yAxp4hjIx6zQ (button) (small blind) folded before Flop



PokerStars Game #59938595732:  Hold'em No Limit ($0.50/$1.00) - 2009/07/01 0:18:47 ET
Table 'kBJtONSnMKK6+l5D0n+vjA' 2-max Seat #1 is the button
Seat 1: qubgcbkrXfMjdrMEd1lYMQ ($341.40 in chips)
Seat 2: 5x9BehadQB/XenOdQDZzEQ ($43.60 in chips)
qubgcbkrXfMjdrMEd1lYMQ: posts small blind $0.50
5x9BehadQB/XenOdQDZzEQ: posts big blind $1
*** HOLE CARDS ***
qubgcbkrXfMjdrMEd1lYMQ: raises $2 to $3
5x9BehadQB/XenOdQDZzEQ: calls $2
*** FLOP *** [2c 4h As]
5x9BehadQB/XenOdQDZzEQ: checks
qubgcbkrXfMjdrMEd1lYMQ: bets $5
5x9BehadQB/XenOdQDZzEQ: folds
qubgcbkrXfMjdrMEd1lYMQ collected $5.70 from pot
*** SUMMARY ***
Total pot $6 | Rake $0.30
Board [2c 4h As]
Seat 1: qubgcbkrXfMjdrMEd1lYMQ (button) (small blind) collected ($5.70)
Seat 2: 5x9BehadQB/XenOdQDZzEQ (big blind) folded on the Flop



PokerStars Game #59938595878:  Hold'em No Limit ($0.50/$1.00) - 2009/07/01 0:18:47 ET
Table '+cA8mcmhaedZ7YcrDdhmeQ' 6-max Seat #5 is the button
Seat 1: lsLuWlcPA3Rh7kJVLzMh0Q ($234.50 in chips)
Seat 2: trnpu4tPju3BU8W0wQQaiQ ($99.60 in chips)
Seat 3: 0WjiuIT7/EolY1oOx1ngeA ($135.50 in chips)
Seat 5: 6WyjEXOToimYmtLdqIgHYQ ($62 in chips)
Seat 6: YfsTQsY/fxb+YqbdclTHuw ($87.15 in chips)
YfsTQsY/fxb+YqbdclTHuw: posts small blind $0.50
lsLuWlcPA3Rh7kJVLzMh0Q: posts big blind $1
j0aDOn9Nft1HLTQvGu1UwA: is sitting out
*** HOLE CARDS ***
j0aDOn9Nft1HLTQvGu1UwA has returned
trnpu4tPju3BU8W0wQQaiQ: raises $3 to $4
0WjiuIT7/EolY1oOx1ngeA: folds
6WyjEXOToimYmtLdqIgHYQ: folds
YfsTQsY/fxb+YqbdclTHuw: folds
lsLuWlcPA3Rh7kJVLzMh0Q: folds
trnpu4tPju3BU8W0wQQaiQ collected $2.50 from pot
*** SUMMARY ***
Total pot $2.50 | Rake $0
Seat 1: lsLuWlcPA3Rh7kJVLzMh0Q (big blind) folded before Flop
Seat 2: trnpu4tPju3BU8W0wQQaiQ collected ($2.50)
Seat 3: 0WjiuIT7/EolY1oOx1ngeA folded before Flop (didn't bet)
Seat 5: 6WyjEXOToimYmtLdqIgHYQ (button) folded before Flop (didn't bet)
Seat 6: YfsTQsY/fxb+YqbdclTHuw (small blind) folded before Flop



PokerStars Game #59938596510:  Hold'em No Limit ($0.50/$1.00) - 2009/07/01 0:18:48 ET
Table 'FKpXUINE6M3UxHG4zaMhHA' 6-max Seat #3 is the button
Seat 2: ecfRjfaWRYbPNvaBsW5ZQQ ($20 in chips)
Seat 3: ssLJburtEIqnVkx6X8R1uw ($122.90 in chips)
Seat 4: ru6SCVvWcWt2SpmUsmArWQ ($19 in chips)
Seat 5: hpxXcmRkXXI9HE5+5/j/0Q ($106.70 in chips)
Seat 6: b2a+5TkFf4xJN/Ihhma58Q ($24.80 in chips)
ru6SCVvWcWt2SpmUsmArWQ: posts small blind $0.50
hpxXcmRkXXI9HE5+5/j/0Q: posts big blind $1
ecfRjfaWRYbPNvaBsW5ZQQ: posts big blind $1
*** HOLE CARDS ***
b2a+5TkFf4xJN/Ihhma58Q: folds
ecfRjfaWRYbPNvaBsW5ZQQ: checks
ssLJburtEIqnVkx6X8R1uw: folds
ru6SCVvWcWt2SpmUsmArWQ: raises $18 to $19 and is all-in
hpxXcmRkXXI9HE5+5/j/0Q: folds
ecfRjfaWRYbPNvaBsW5ZQQ: folds
ru6SCVvWcWt2SpmUsmArWQ collected $3 from pot
ru6SCVvWcWt2SpmUsmArWQ: doesn't show hand
*** SUMMARY ***
Total pot $3 | Rake $0
Seat 2: ecfRjfaWRYbPNvaBsW5ZQQ folded before Flop
Seat 3: ssLJburtEIqnVkx6X8R1uw (button) folded before Flop (didn't bet)
Seat 4: ru6SCVvWcWt2SpmUsmArWQ (small blind) collected ($3)
Seat 5: hpxXcmRkXXI9HE5+5/j/0Q (big blind) folded before Flop
Seat 6: b2a+5TkFf4xJN/Ihhma58Q folded before Flop (didn't bet)



PokerStars Game #59938596640:  Hold'em No Limit ($0.50/$1.00) - 2009/07/01 0:18:48 ET
Table 'aWHveb63HkbTmOGHOxjBkQ' 2-max Seat #2 is the button
Seat 1: xy2MQKoHoCZZIudmw8Xbow ($194.10 in chips)
Seat 2: xstEKavv3YDxpUnU4e9qAQ ($181.10 in chips)
xstEKavv3YDxpUnU4e9qAQ: posts small blind $0.50
xy2MQKoHoCZZIudmw8Xbow: posts big blind $1
*** HOLE CARDS ***
xstEKavv3YDxpUnU4e9qAQ: raises $3 to $4
xy2MQKoHoCZZIudmw8Xbow: calls $3
*** FLOP *** [4c Ad 5s]
xy2MQKoHoCZZIudmw8Xbow: checks
xstEKavv3YDxpUnU4e9qAQ: checks
*** TURN *** [4c Ad 5s] [5h]
xy2MQKoHoCZZIudmw8Xbow: bets $5
xstEKavv3YDxpUnU4e9qAQ: folds
xy2MQKoHoCZZIudmw8Xbow collected $7.60 from pot
xy2MQKoHoCZZIudmw8Xbow: doesn't show hand
*** SUMMARY ***
Total pot $8 | Rake $0.40
Board [4c Ad 5s 5h]
Seat 1: xy2MQKoHoCZZIudmw8Xbow (big blind) collected ($7.60)
Seat 2: xstEKavv3YDxpUnU4e9qAQ (button) (small blind) folded on the Turn



PokerStars Game #59938596116:  Hold'em No Limit ($0.50/$1.00) - 2009/07/01 0:18:48 ET
Table '/RZcOwpZpHQ+OwPwjsbnRw' 6-max Seat #3 is the button
Seat 1: jMljU/dOPMXfJi8OmbdYdw ($57.65 in chips)
Seat 2: dHC9PH9hdH3Ad2TD8ZxX0Q ($51.10 in chips)
Seat 3: OigyyiK+tTj1APPIAUmXDA ($80.60 in chips)
Seat 4: j7NIOHLZk7V2o9fOioO5ug ($100 in chips)
Seat 5: wx3sQGkVi2x9wJXuWNHPBw ($200.80 in chips)
Seat 6: XOIf9W+VAxhZqN+SYoyMKA ($151.40 in chips)
j7NIOHLZk7V2o9fOioO5ug: posts small blind $0.50
wx3sQGkVi2x9wJXuWNHPBw: posts big blind $1
*** HOLE CARDS ***
XOIf9W+VAxhZqN+SYoyMKA: folds
jMljU/dOPMXfJi8OmbdYdw: calls $1
dHC9PH9hdH3Ad2TD8ZxX0Q: calls $1
OigyyiK+tTj1APPIAUmXDA: folds
j7NIOHLZk7V2o9fOioO5ug: folds
wx3sQGkVi2x9wJXuWNHPBw: raises $6 to $7
jMljU/dOPMXfJi8OmbdYdw: calls $6
dHC9PH9hdH3Ad2TD8ZxX0Q: folds
*** FLOP *** [Jd 4h 6d]
wx3sQGkVi2x9wJXuWNHPBw: bets $10
jMljU/dOPMXfJi8OmbdYdw: folds
wx3sQGkVi2x9wJXuWNHPBw collected $14.75 from pot
*** SUMMARY ***
Total pot $15.50 | Rake $0.75
Board [Jd 4h 6d]
Seat 1: jMljU/dOPMXfJi8OmbdYdw folded on the Flop
Seat 2: dHC9PH9hdH3Ad2TD8ZxX0Q folded before Flop
Seat 3: OigyyiK+tTj1APPIAUmXDA (button) folded before Flop (didn't bet)
Seat 4: j7NIOHLZk7V2o9fOioO5ug (small blind) folded before Flop
Seat 5: wx3sQGkVi2x9wJXuWNHPBw (big blind) collected ($14.75)
Seat 6: XOIf9W+VAxhZqN+SYoyMKA folded before Flop (didn't bet)



PokerStars Game #59938596222:  Hold'em No Limit ($0.50/$1.00) - 2009/07/01 0:18:48 ET
Table 'blHlQApStil0OPeQxQxPcwFKpXUINE6M3UxHG4zaMhHAx Seat #8 is the button
Seat 1: x80+i7DJL+81v3quj7KbNg ($20 in chips)
Seat 2: wIZ377kjl2fHFGnS93o6bw ($34.20 in chips)
Seat 3: o1axyw4AjQ8n4ubTwlirQQ ($27.70 in chips)
Seat 4: zanka7aAZkigmZpfopXxxA ($33.60 in chips)
Seat 6: JPQzLacMGzeh42mPgyrvVQ ($72.10 in chips)
Seat 7: vR4IO10geOgvTW+LAUBv/A ($118 in chips)
Seat 8: VtjmCz/ASIcETatNJ8YcCA ($57.85 in chips)
x80+i7DJL+81v3quj7KbNg: posts small blind $0.50
wIZ377kjl2fHFGnS93o6bw: posts big blind $1
uXrDE6JrIi8BZK1L8oQ9bQ: sits out
*** HOLE CARDS ***
o1axyw4AjQ8n4ubTwlirQQ: folds
zanka7aAZkigmZpfopXxxA: raises $2 to $3
JPQzLacMGzeh42mPgyrvVQ: folds
vR4IO10geOgvTW+LAUBv/A: folds
VtjmCz/ASIcETatNJ8YcCA: folds
x80+i7DJL+81v3quj7KbNg: folds
wIZ377kjl2fHFGnS93o6bw: calls $2
*** FLOP *** [Kh Qc Kc]
wIZ377kjl2fHFGnS93o6bw: checks
zanka7aAZkigmZpfopXxxA: bets $4
wIZ377kjl2fHFGnS93o6bw: folds
zanka7aAZkigmZpfopXxxA collected $6.20 from pot
zanka7aAZkigmZpfopXxxA: doesn't show hand
*** SUMMARY ***
Total pot $6.50 | Rake $0.30
Board [Kh Qc Kc]
Seat 1: x80+i7DJL+81v3quj7KbNg (small blind) folded before Flop
Seat 2: wIZ377kjl2fHFGnS93o6bw (big blind) folded on the Flop
Seat 3: o1axyw4AjQ8n4ubTwlirQQ folded before Flop (didn't bet)
Seat 4: zanka7aAZkigmZpfopXxxA collected ($6.20)
Seat 6: JPQzLacMGzeh42mPgyrvVQ folded before Flop (didn't bet)
Seat 7: vR4IO10geOgvTW+LAUBv/A folded before Flop (didn't bet)
Seat 8: VtjmCz/ASIcETatNJ8YcCA (button) folded before Flop (didn't bet)



PokerStars Game #59938596890:  Hold'em No Limit ($0.50/$1.00) - 2009/07/01 0:18:49 ET
Table '3T4owEKJKyGTMePwrv50FQ' 9-max Seat #1 is the button
Seat 1: i7H4OcR0JBHUDu6bJ34rtw ($72.40 in chips)
Seat 2: p5UKaxVobvptF0ANhR/q1A ($107.15 in chips)
Seat 3: pCl9IYtMJjmAJCt7Pu4TDw ($42.45 in chips)
Seat 4: 3MYLdqcdtveb3nHZv3D1IA ($10 in chips)
Seat 5: ArTa9sSTrL++oHeXU/9PPA ($49.60 in chips)
Seat 7: brpN3NxzKqwZCeb5s2Nq4g ($40.05 in chips)
Seat 8: negfosHnGOZXSHpWDRKyBQ ($18.50 in chips)
Seat 9: vR4IO10geOgvTW+LAUBv/A ($123.50 in chips)
p5UKaxVobvptF0ANhR/q1A: posts small blind $0.50
pCl9IYtMJjmAJCt7Pu4TDw: posts big blind $1
*** HOLE CARDS ***
3MYLdqcdtveb3nHZv3D1IA: folds
ArTa9sSTrL++oHeXU/9PPA: folds
brpN3NxzKqwZCeb5s2Nq4g: folds
LUCKYONE18 leaves the table
negfosHnGOZXSHpWDRKyBQ: folds
vR4IO10geOgvTW+LAUBv/A: folds
i7H4OcR0JBHUDu6bJ34rtw: folds
p5UKaxVobvptF0ANhR/q1A: folds
pCl9IYtMJjmAJCt7Pu4TDw collected $1 from pot
*** SUMMARY ***
Total pot $1 | Rake $0
Seat 1: i7H4OcR0JBHUDu6bJ34rtw (button) folded before Flop (didn't bet)
Seat 2: p5UKaxVobvptF0ANhR/q1A (small blind) folded before Flop
Seat 3: pCl9IYtMJjmAJCt7Pu4TDw (big blind) collected ($1)
Seat 4: 3MYLdqcdtveb3nHZv3D1IA folded before Flop (didn't bet)
Seat 5: ArTa9sSTrL++oHeXU/9PPA folded before Flop (didn't bet)
Seat 7: brpN3NxzKqwZCeb5s2Nq4g folded before Flop (didn't bet)
Seat 8: negfosHnGOZXSHpWDRKyBQ folded before Flop (didn't bet)
Seat 9: vR4IO10geOgvTW+LAUBv/A folded before Flop (didn't bet)



PokerStars Game #59938598602:  Hold'em No Limit ($0.50/$1.00) - 2009/07/01 0:18:51 ET
Table 'ZFWj23PMihdwrNWv41OG/Q' 9-max Seat #2 is the button
Seat 1: yAbu2QsRPVcjPbqlf/jDxw ($103.30 in chips)
Seat 2: ARfmgHcEUKh68laBZy4veA ($23.50 in chips)
Seat 3: G9Fo2TZCN7HI43Po4zSN3A ($100 in chips)
Seat 4: PEmogYqKpuv0ozeBbXL+7Q ($16.75 in chips)
Seat 5: aNuEPl+Lh/dZypIbbfz+mA ($22.35 in chips)
Seat 6: tjhwe1V98x2spSoUQER3HQ ($100 in chips)
Seat 7: wIZ377kjl2fHFGnS93o6bw ($31.05 in chips)
Seat 8: knewtTmBc4Tc0z/5tAABYQ ($107 in chips)
Seat 9: atVaKXE/AQGa798rpMF/Bg ($57 in chips)
G9Fo2TZCN7HI43Po4zSN3A: posts small blind $0.50
PEmogYqKpuv0ozeBbXL+7Q: posts big blind $1
*** HOLE CARDS ***
aNuEPl+Lh/dZypIbbfz+mA: calls $1
tjhwe1V98x2spSoUQER3HQ: raises $4 to $5
wIZ377kjl2fHFGnS93o6bw: folds
knewtTmBc4Tc0z/5tAABYQ: folds
atVaKXE/AQGa798rpMF/Bg: folds
yAbu2QsRPVcjPbqlf/jDxw: folds
ARfmgHcEUKh68laBZy4veA: calls $5
G9Fo2TZCN7HI43Po4zSN3A: folds
PEmogYqKpuv0ozeBbXL+7Q: folds
aNuEPl+Lh/dZypIbbfz+mA: calls $4
*** FLOP *** [9d 3d Kc]
aNuEPl+Lh/dZypIbbfz+mA: bets $2
tjhwe1V98x2spSoUQER3HQ: folds
ARfmgHcEUKh68laBZy4veA: raises $13 to $15
aNuEPl+Lh/dZypIbbfz+mA: folds
ARfmgHcEUKh68laBZy4veA collected $19.55 from pot
*** SUMMARY ***
Total pot $20.50 | Rake $0.95
Board [9d 3d Kc]
Seat 1: yAbu2QsRPVcjPbqlf/jDxw folded before Flop (didn't bet)
Seat 2: ARfmgHcEUKh68laBZy4veA (button) collected ($19.55)
Seat 3: G9Fo2TZCN7HI43Po4zSN3A (small blind) folded before Flop
Seat 4: PEmogYqKpuv0ozeBbXL+7Q (big blind) folded before Flop
Seat 5: aNuEPl+Lh/dZypIbbfz+mA folded on the Flop
Seat 6: tjhwe1V98x2spSoUQER3HQ folded on the Flop
Seat 7: wIZ377kjl2fHFGnS93o6bw folded before Flop (didn't bet)
Seat 8: knewtTmBc4Tc0z/5tAABYQ folded before Flop (didn't bet)
Seat 9: atVaKXE/AQGa798rpMF/Bg folded before Flop (didn't bet)



PokerStars Game #59938599222:  Hold'em No Limit ($0.50/$1.00) - 2009/07/01 0:18:52 ET
Table 'tJq9SfN1ywY0r03VBlWlwQ' 9-max Seat #2 is the button
Seat 1: wZsU+w9r7G66x93UuvBf1Q ($329.05 in chips)
Seat 2: RqkO8O/Y3qlc3PIuCAHjVg ($76.40 in chips)
Seat 3: FVs16t7GgfWgQWt4JxsObQ ($27.05 in chips)
Seat 4: zBHLwg+HmbHmRtVQMhavjA ($98 in chips)
Seat 5: Xr5PK/FQzmiaVrphT3mMKA ($97.40 in chips)
Seat 6: gUUvmqdVlmvpal6B8nYrmg ($100.80 in chips)
Seat 8: G4DEhsZFmznGNVpy2SEocA ($23.50 in chips)
Seat 9: XE5QF1y74bpHog9JxWJMWQ ($100 in chips)
FVs16t7GgfWgQWt4JxsObQ: posts small blind $0.50
zBHLwg+HmbHmRtVQMhavjA: posts big blind $1
qVhRZ0PLZ95XRJHWAjXjOQ: sits out
*** HOLE CARDS ***
Xr5PK/FQzmiaVrphT3mMKA: folds
Xr5PK/FQzmiaVrphT3mMKA leaves the table
gUUvmqdVlmvpal6B8nYrmg: folds
G4DEhsZFmznGNVpy2SEocA: folds
Ogn4JDV3mp4ZDKO49IFzKA joins the table at seat #5
XE5QF1y74bpHog9JxWJMWQ: raises $3 to $4
wZsU+w9r7G66x93UuvBf1Q: folds
RqkO8O/Y3qlc3PIuCAHjVg: folds
FVs16t7GgfWgQWt4JxsObQ: folds
zBHLwg+HmbHmRtVQMhavjA: folds
XE5QF1y74bpHog9JxWJMWQ collected $2.50 from pot
*** SUMMARY ***
Total pot $2.50 | Rake $0
Seat 1: wZsU+w9r7G66x93UuvBf1Q folded before Flop (didn't bet)
Seat 2: RqkO8O/Y3qlc3PIuCAHjVg (button) folded before Flop (didn't bet)
Seat 3: FVs16t7GgfWgQWt4JxsObQ (small blind) folded before Flop
Seat 4: zBHLwg+HmbHmRtVQMhavjA (big blind) folded before Flop
Seat 5: Xr5PK/FQzmiaVrphT3mMKA folded before Flop (didn't bet)
Seat 6: gUUvmqdVlmvpal6B8nYrmg folded before Flop (didn't bet)
Seat 8: G4DEhsZFmznGNVpy2SEocA folded before Flop (didn't bet)
Seat 9: XE5QF1y74bpHog9JxWJMWQ collected ($2.50)



PokerStars Game #59938600052:  Hold'em No Limit ($0.50/$1.00) - 2009/07/01 0:18:53 ET
Table 'hugOjcwJvzEwZbK7tyiWuQ' 9-max Seat #3 is the button
Seat 1: N9n5Wc3s35DpCrOAUUNAaQ ($127.85 in chips)
Seat 2: r27C1nIV4NS4+qbnrgBQSw ($257.05 in chips)
Seat 3: jDwhY1kCdc6EkAHbT7PJMQ ($102.40 in chips)
Seat 4: UWB3oeddt/GObx2Mix2Anw ($195.70 in chips)
Seat 5: 5BRGWf+R3nt2WS3b5xX+zA ($25.80 in chips)
Seat 6: gUUvmqdVlmvpal6B8nYrmg ($100 in chips)
Seat 7: FL3MrLspcF23LYvC4ipBOA ($100 in chips)
Seat 8: /zy+DB4S5fUQUSfZWFzYGw ($115.75 in chips)
Seat 9: o6JyUkbzCDw8tUabqtmnlg ($57 in chips)
UWB3oeddt/GObx2Mix2Anw: posts small blind $0.50
5BRGWf+R3nt2WS3b5xX+zA: posts big blind $1
*** HOLE CARDS ***
gUUvmqdVlmvpal6B8nYrmg: folds
FL3MrLspcF23LYvC4ipBOA: raises $2 to $3
/zy+DB4S5fUQUSfZWFzYGw: folds
o6JyUkbzCDw8tUabqtmnlg: folds
N9n5Wc3s35DpCrOAUUNAaQ: folds
r27C1nIV4NS4+qbnrgBQSw: folds
jDwhY1kCdc6EkAHbT7PJMQ: calls $3
UWB3oeddt/GObx2Mix2Anw: folds
5BRGWf+R3nt2WS3b5xX+zA: folds
*** FLOP *** [7d Qh Kh]
FL3MrLspcF23LYvC4ipBOA: checks
jDwhY1kCdc6EkAHbT7PJMQ: checks
*** TURN *** [7d Qh Kh] [Ah]
FL3MrLspcF23LYvC4ipBOA: checks
jDwhY1kCdc6EkAHbT7PJMQ: checks
*** RIVER *** [7d Qh Kh Ah] [Kc]
FL3MrLspcF23LYvC4ipBOA: checks
jDwhY1kCdc6EkAHbT7PJMQ: checks
*** SHOW DOWN ***
FL3MrLspcF23LYvC4ipBOA: shows [4d 4s] (two pair, Kings and Fours)
jDwhY1kCdc6EkAHbT7PJMQ: shows [9s 9h] (two pair, Kings and Nines)
jDwhY1kCdc6EkAHbT7PJMQ collected $7.15 from pot
*** SUMMARY ***
Total pot $7.50 | Rake $0.35
Board [7d Qh Kh Ah Kc]
Seat 1: N9n5Wc3s35DpCrOAUUNAaQ folded before Flop (didn't bet)
Seat 2: r27C1nIV4NS4+qbnrgBQSw folded before Flop (didn't bet)
Seat 3: jDwhY1kCdc6EkAHbT7PJMQ (button) showed [9s 9h] and won ($7.15) with two pair, Kings and Nines
Seat 4: UWB3oeddt/GObx2Mix2Anw (small blind) folded before Flop
Seat 5: 5BRGWf+R3nt2WS3b5xX+zA (big blind) folded before Flop
Seat 6: gUUvmqdVlmvpal6B8nYrmg folded before Flop (didn't bet)
Seat 7: FL3MrLspcF23LYvC4ipBOA showed [4d 4s] and lost with two pair, Kings and Fours
Seat 8: /zy+DB4S5fUQUSfZWFzYGw folded before Flop (didn't bet)
Seat 9: o6JyUkbzCDw8tUabqtmnlg folded before Flop (didn't bet)



PokerStars Game #59938600148:  Hold'em No Limit ($0.50/$1.00) - 2009/07/01 0:18:53 ET
Table 'cBDNutyLBKEk9+ptwsKmTw' 6-max Seat #3 is the button
Seat 1: tb0dt30qP2x/8f+Xta4mVg ($23.95 in chips)
Seat 2: KyaE4+hWgUNIWWOWy4D14w ($63.30 in chips)
Seat 3: G5ZSSN6RSON3gkNvk/SmYg ($105.05 in chips)
Seat 4: 0WjiuIT7/EolY1oOx1ngeA ($106.65 in chips)
Seat 5: OGMLOcTNYZXZU81au7ztUw ($106.75 in chips)
Seat 6: pyzhFUPPSNzrysiMqlA5Xw ($13.75 in chips)
0WjiuIT7/EolY1oOx1ngeA: posts small blind $0.50
OGMLOcTNYZXZU81au7ztUw: posts big blind $1
*** HOLE CARDS ***
pyzhFUPPSNzrysiMqlA5Xw: calls $1
tb0dt30qP2x/8f+Xta4mVg: folds
KyaE4+hWgUNIWWOWy4D14w: folds
G5ZSSN6RSON3gkNvk/SmYg: calls $1
0WjiuIT7/EolY1oOx1ngeA: folds
OGMLOcTNYZXZU81au7ztUw: checks
*** FLOP *** [Qh 2s Ac]
OGMLOcTNYZXZU81au7ztUw: checks
pyzhFUPPSNzrysiMqlA5Xw: checks
G5ZSSN6RSON3gkNvk/SmYg: bets $3
OGMLOcTNYZXZU81au7ztUw: folds
pyzhFUPPSNzrysiMqlA5Xw: folds
G5ZSSN6RSON3gkNvk/SmYg collected $3.35 from pot
G5ZSSN6RSON3gkNvk/SmYg: doesn't show hand
*** SUMMARY ***
Total pot $3.50 | Rake $0.15
Board [Qh 2s Ac]
Seat 1: tb0dt30qP2x/8f+Xta4mVg folded before Flop (didn't bet)
Seat 2: KyaE4+hWgUNIWWOWy4D14w folded before Flop (didn't bet)
Seat 3: G5ZSSN6RSON3gkNvk/SmYg (button) collected ($3.35)
Seat 4: 0WjiuIT7/EolY1oOx1ngeA (small blind) folded before Flop
Seat 5: OGMLOcTNYZXZU81au7ztUw (big blind) folded on the Flop
Seat 6: pyzhFUPPSNzrysiMqlA5Xw folded on the Flop



PokerStars Game #59938600436:  Hold'em No Limit ($0.50/$1.00) - 2009/07/01 0:18:54 ET
Table '/+ni2d7lj6E90JmAQZKSOw' 2-max Seat #1 is the button
Seat 1: qubgcbkrXfMjdrMEd1lYMQ ($264.20 in chips)
Seat 2: IJu7Boitu3yAxp4hjIx6zQ ($106.70 in chips)
qubgcbkrXfMjdrMEd1lYMQ: posts small blind $0.50
IJu7Boitu3yAxp4hjIx6zQ: posts big blind $1
*** HOLE CARDS ***
qubgcbkrXfMjdrMEd1lYMQ: folds
IJu7Boitu3yAxp4hjIx6zQ collected $1 from pot
IJu7Boitu3yAxp4hjIx6zQ: doesn't show hand
*** SUMMARY ***
Total pot $1 | Rake $0
Seat 1: qubgcbkrXfMjdrMEd1lYMQ (button) (small blind) folded before Flop
Seat 2: IJu7Boitu3yAxp4hjIx6zQ (big blind) collected ($1)



PokerStars Game #59938600592:  Hold'em No Limit ($0.50/$1.00) - 2009/07/01 0:18:54 ET
Table 'N2bNCDHL96aCQDvZIh+yQQ' 6-max Seat #4 is the button
Seat 1: iHo1oDbrEVJ8nEGdaPrICw ($128.10 in chips)
Seat 2: KpnW5CcJ4Mg6MeclfKmLrw ($101.50 in chips)
Seat 3: PXT6kJgVX67c3EgncNqRoA ($54.95 in chips)
Seat 4: uCqEjnxh2/vFBjKYkfTOkw ($163.20 in chips)
Seat 5: rHlMOfR7kpQQxe+PFQz0xQ ($49 in chips)
rHlMOfR7kpQQxe+PFQz0xQ: posts small blind $0.50
iHo1oDbrEVJ8nEGdaPrICw: posts big blind $1
*** HOLE CARDS ***
KpnW5CcJ4Mg6MeclfKmLrw: folds
PXT6kJgVX67c3EgncNqRoA: folds
uCqEjnxh2/vFBjKYkfTOkw: folds
rHlMOfR7kpQQxe+PFQz0xQ: raises $2 to $3
iHo1oDbrEVJ8nEGdaPrICw: calls $2
*** FLOP *** [2d 3d Tc]
rHlMOfR7kpQQxe+PFQz0xQ: bets $3
iHo1oDbrEVJ8nEGdaPrICw: calls $3
*** TURN *** [2d 3d Tc] [4d]
rHlMOfR7kpQQxe+PFQz0xQ: checks
iHo1oDbrEVJ8nEGdaPrICw: checks
*** RIVER *** [2d 3d Tc 4d] [8c]
rHlMOfR7kpQQxe+PFQz0xQ: checks
iHo1oDbrEVJ8nEGdaPrICw: bets $6
rHlMOfR7kpQQxe+PFQz0xQ: calls $6
*** SHOW DOWN ***
iHo1oDbrEVJ8nEGdaPrICw: shows [Th Kh] (a pair of Tens)
rHlMOfR7kpQQxe+PFQz0xQ: mucks hand
iHo1oDbrEVJ8nEGdaPrICw collected $22.85 from pot
*** SUMMARY ***
Total pot $24 | Rake $1.15
Board [2d 3d Tc 4d 8c]
Seat 1: iHo1oDbrEVJ8nEGdaPrICw (big blind) showed [Th Kh] and won ($22.85) with a pair of Tens
Seat 2: KpnW5CcJ4Mg6MeclfKmLrw folded before Flop (didn't bet)
Seat 3: PXT6kJgVX67c3EgncNqRoA folded before Flop (didn't bet)
Seat 4: uCqEjnxh2/vFBjKYkfTOkw (button) folded before Flop (didn't bet)
Seat 5: rHlMOfR7kpQQxe+PFQz0xQ (small blind) mucked



PokerStars Game #59938602512:  Hold'em No Limit ($0.50/$1.00) - 2009/07/01 0:18:57 ET
Table 'U9zqzC8f3oTJ2ShXFgSSOA' 6-max Seat #6 is the button
Seat 1: tS9JHB1h+FQ++qu8RwRNgg ($18.45 in chips)
Seat 2: U2CWBTv29qdCbj8RNF2sIw ($111.80 in chips)
Seat 3: yfXek8iJ7O4CFyqXrtGcfg ($41.50 in chips)
Seat 4: 33q95we0Etwgrm6guQGncw ($71.35 in chips)
Seat 5: KfwW5us6tydK81NYTtK1gw ($194.75 in chips)
Seat 6: aIxzFKdtpDSkUePKZy/niQ ($62.50 in chips)
tS9JHB1h+FQ++qu8RwRNgg: posts small blind $0.50
U2CWBTv29qdCbj8RNF2sIw: posts big blind $1
*** HOLE CARDS ***
yfXek8iJ7O4CFyqXrtGcfg: folds
33q95we0Etwgrm6guQGncw: calls $1
KfwW5us6tydK81NYTtK1gw: folds
aIxzFKdtpDSkUePKZy/niQ: raises $3 to $4
tS9JHB1h+FQ++qu8RwRNgg: folds
U2CWBTv29qdCbj8RNF2sIw: folds
33q95we0Etwgrm6guQGncw: calls $3
*** FLOP *** [4h 2s Qc]
33q95we0Etwgrm6guQGncw: checks
aIxzFKdtpDSkUePKZy/niQ: checks
*** TURN *** [4h 2s Qc] [2h]
33q95we0Etwgrm6guQGncw: bets $3
aIxzFKdtpDSkUePKZy/niQ: folds
33q95we0Etwgrm6guQGncw collected $9.05 from pot
*** SUMMARY ***
Total pot $9.50 | Rake $0.45
Board [4h 2s Qc 2h]
Seat 1: tS9JHB1h+FQ++qu8RwRNgg (small blind) folded before Flop
Seat 2: U2CWBTv29qdCbj8RNF2sIw (big blind) folded before Flop
Seat 3: yfXek8iJ7O4CFyqXrtGcfg folded before Flop (didn't bet)
Seat 4: 33q95we0Etwgrm6guQGncw collected ($9.05)
Seat 5: KfwW5us6tydK81NYTtK1gw folded before Flop (didn't bet)
Seat 6: aIxzFKdtpDSkUePKZy/niQ (button) folded on the Turn



PokerStars Game #59938606780:  Hold'em No Limit ($0.50/$1.00) - 2009/07/01 0:19:03 ET
Table '/+ni2d7lj6E90JmAQZKSOw' 2-max Seat #2 is the button
Seat 1: qubgcbkrXfMjdrMEd1lYMQ ($263.70 in chips)
Seat 2: IJu7Boitu3yAxp4hjIx6zQ ($107.20 in chips)
IJu7Boitu3yAxp4hjIx6zQ: posts small blind $0.50
qubgcbkrXfMjdrMEd1lYMQ: posts big blind $1
*** HOLE CARDS ***
IJu7Boitu3yAxp4hjIx6zQ: raises $2 to $3
qubgcbkrXfMjdrMEd1lYMQ: calls $2
*** FLOP *** [Ts 4c Qc]
qubgcbkrXfMjdrMEd1lYMQ: checks
IJu7Boitu3yAxp4hjIx6zQ: bets $5
qubgcbkrXfMjdrMEd1lYMQ: folds
IJu7Boitu3yAxp4hjIx6zQ collected $5.70 from pot
IJu7Boitu3yAxp4hjIx6zQ: doesn't show hand
*** SUMMARY ***
Total pot $6 | Rake $0.30
Board [Ts 4c Qc]
Seat 1: qubgcbkrXfMjdrMEd1lYMQ (big blind) folded on the Flop
Seat 2: IJu7Boitu3yAxp4hjIx6zQ (button) (small blind) collected ($5.70)



PokerStars Game #59938606966:  Hold'em No Limit ($0.50/$1.00) - 2009/07/01 0:19:03 ET
Table 'b/mVBMBBjZR4F+Jsv8cuYA' 9-max Seat #3 is the button
Seat 1: 0bFSG2wtTalRoQW05hZ/uw ($40.70 in chips)
Seat 2: HPmAhANyB1+4MGzYS9i5Wg ($55.60 in chips)
Seat 3: x80+i7DJL+81v3quj7KbNg ($20 in chips)
Seat 4: 0oXWlMUwwWciWdZOQf6yUw ($123.80 in chips)
Seat 5: p5UKaxVobvptF0ANhR/q1A ($105.70 in chips)
Seat 6: FL3MrLspcF23LYvC4ipBOA ($303.90 in chips)
Seat 7: 0eFnow7+D7veCYQ+CG9FFw ($58.50 in chips)
Seat 8: L9njYvloJ1NdXjP8edHEAg ($102.50 in chips)
Seat 9: 9BZCcac3+McErkkSN2YScA ($113.95 in chips)
0oXWlMUwwWciWdZOQf6yUw: posts small blind $0.50
p5UKaxVobvptF0ANhR/q1A: posts big blind $1
*** HOLE CARDS ***
FL3MrLspcF23LYvC4ipBOA: folds
0eFnow7+D7veCYQ+CG9FFw: folds
L9njYvloJ1NdXjP8edHEAg: folds
9BZCcac3+McErkkSN2YScA: folds
0bFSG2wtTalRoQW05hZ/uw: folds
HPmAhANyB1+4MGzYS9i5Wg: raises $2 to $3
x80+i7DJL+81v3quj7KbNg: folds
0oXWlMUwwWciWdZOQf6yUw: calls $2.50
p5UKaxVobvptF0ANhR/q1A: folds
*** FLOP *** [Ah Qs 8d]
0oXWlMUwwWciWdZOQf6yUw: checks
HPmAhANyB1+4MGzYS9i5Wg: checks
*** TURN *** [Ah Qs 8d] [3h]
0oXWlMUwwWciWdZOQf6yUw: bets $5
HPmAhANyB1+4MGzYS9i5Wg: folds
0oXWlMUwwWciWdZOQf6yUw collected $6.65 from pot
0oXWlMUwwWciWdZOQf6yUw: doesn't show hand
*** SUMMARY ***
Total pot $7 | Rake $0.35
Board [Ah Qs 8d 3h]
Seat 1: 0bFSG2wtTalRoQW05hZ/uw folded before Flop (didn't bet)
Seat 2: HPmAhANyB1+4MGzYS9i5Wg folded on the Turn
Seat 3: x80+i7DJL+81v3quj7KbNg (button) folded before Flop (didn't bet)
Seat 4: 0oXWlMUwwWciWdZOQf6yUw (small blind) collected ($6.65)
Seat 5: p5UKaxVobvptF0ANhR/q1A (big blind) folded before Flop
Seat 6: FL3MrLspcF23LYvC4ipBOA folded before Flop (didn't bet)
Seat 7: 0eFnow7+D7veCYQ+CG9FFw folded before Flop (didn't bet)
Seat 8: L9njYvloJ1NdXjP8edHEAg folded before Flop (didn't bet)
Seat 9: 9BZCcac3+McErkkSN2YScA folded before Flop (didn't bet)



PokerStars Game #59938606802:  Hold'em No Limit ($0.50/$1.00) - 2009/07/01 0:19:03 ET
Table 'vs/5jr6ciwjVQ5+Soc+u2A' 6-max Seat #3 is the button
Seat 2: XOIf9W+VAxhZqN+SYoyMKA ($116.80 in chips)
Seat 3: G5ZSSN6RSON3gkNvk/SmYg ($100 in chips)
Seat 4: KpnW5CcJ4Mg6MeclfKmLrw ($103 in chips)
Seat 5: 7Vc9JmGFQwMRh5Tj9ui5Lw ($101.15 in chips)
Seat 6: QHvTZcrKe6+maWUfVjP29Q ($100 in chips)
KpnW5CcJ4Mg6MeclfKmLrw: posts small blind $0.50
7Vc9JmGFQwMRh5Tj9ui5Lw: posts big blind $1
*** HOLE CARDS ***
QHvTZcrKe6+maWUfVjP29Q: folds
XOIf9W+VAxhZqN+SYoyMKA: folds
G5ZSSN6RSON3gkNvk/SmYg: folds
KpnW5CcJ4Mg6MeclfKmLrw: folds
7Vc9JmGFQwMRh5Tj9ui5Lw collected $1 from pot
7Vc9JmGFQwMRh5Tj9ui5Lw: doesn't show hand
*** SUMMARY ***
Total pot $1 | Rake $0
Seat 2: XOIf9W+VAxhZqN+SYoyMKA folded before Flop (didn't bet)
Seat 3: G5ZSSN6RSON3gkNvk/SmYg (button) folded before Flop (didn't bet)
Seat 4: KpnW5CcJ4Mg6MeclfKmLrw (small blind) folded before Flop
Seat 5: 7Vc9JmGFQwMRh5Tj9ui5Lw (big blind) collected ($1)
Seat 6: QHvTZcrKe6+maWUfVjP29Q folded before Flop (didn't bet)



PokerStars Game #59938607204:  Hold'em No Limit ($0.50/$1.00) - 2009/07/01 0:19:04 ET
Table 'aWHveb63HkbTmOGHOxjBkQ' 2-max Seat #1 is the button
Seat 1: xy2MQKoHoCZZIudmw8Xbow ($197.70 in chips)
Seat 2: xstEKavv3YDxpUnU4e9qAQ ($177.10 in chips)
xy2MQKoHoCZZIudmw8Xbow: posts small blind $0.50
xstEKavv3YDxpUnU4e9qAQ: posts big blind $1
*** HOLE CARDS ***
xy2MQKoHoCZZIudmw8Xbow: raises $3 to $4
xstEKavv3YDxpUnU4e9qAQ: folds
xy2MQKoHoCZZIudmw8Xbow collected $2 from pot
xy2MQKoHoCZZIudmw8Xbow: doesn't show hand
*** SUMMARY ***
Total pot $2 | Rake $0
Seat 1: xy2MQKoHoCZZIudmw8Xbow (button) (small blind) collected ($2)
Seat 2: xstEKavv3YDxpUnU4e9qAQ (big blind) folded before Flop



PokerStars Game #59938608146:  Hold'em No Limit ($0.50/$1.00) - 2009/07/01 0:19:05 ET
Table 'rmZfTK+oSebeUPJNbWhdAA' 6-max Seat #4 is the button
Seat 1: u4vYQZNWtIzOJre8fvCmvQ ($50.85 in chips)
Seat 2: OigyyiK+tTj1APPIAUmXDA ($65.45 in chips)
Seat 3: 9yjOzGERLaEZS8CZ6YNHFg ($62.80 in chips)
Seat 4: OGMLOcTNYZXZU81au7ztUw ($100 in chips)
Seat 5: VuZb/hkEc4X7s93w2ZZTpA ($113.25 in chips)
Seat 6: j7NIOHLZk7V2o9fOioO5ug ($104.80 in chips)
VuZb/hkEc4X7s93w2ZZTpA: posts small blind $0.50
j7NIOHLZk7V2o9fOioO5ug: posts big blind $1
*** HOLE CARDS ***
u4vYQZNWtIzOJre8fvCmvQ: calls $1
OigyyiK+tTj1APPIAUmXDA: folds
9yjOzGERLaEZS8CZ6YNHFg: folds
OGMLOcTNYZXZU81au7ztUw: raises $3 to $4
VuZb/hkEc4X7s93w2ZZTpA: folds
j7NIOHLZk7V2o9fOioO5ug: folds
u4vYQZNWtIzOJre8fvCmvQ: calls $3
*** FLOP *** [7c Ad 8h]
u4vYQZNWtIzOJre8fvCmvQ: checks
OGMLOcTNYZXZU81au7ztUw: checks
*** TURN *** [7c Ad 8h] [7s]
u4vYQZNWtIzOJre8fvCmvQ: checks
OGMLOcTNYZXZU81au7ztUw: checks
*** RIVER *** [7c Ad 8h 7s] [Th]
u4vYQZNWtIzOJre8fvCmvQ: checks
OGMLOcTNYZXZU81au7ztUw: bets $6
u4vYQZNWtIzOJre8fvCmvQ: folds
OGMLOcTNYZXZU81au7ztUw collected $9.05 from pot
OGMLOcTNYZXZU81au7ztUw: doesn't show hand
*** SUMMARY ***
Total pot $9.50 | Rake $0.45
Board [7c Ad 8h 7s Th]
Seat 1: u4vYQZNWtIzOJre8fvCmvQ folded on the River
Seat 2: OigyyiK+tTj1APPIAUmXDA folded before Flop (didn't bet)
Seat 3: 9yjOzGERLaEZS8CZ6YNHFg folded before Flop (didn't bet)
Seat 4: OGMLOcTNYZXZU81au7ztUw (button) collected ($9.05)
Seat 5: VuZb/hkEc4X7s93w2ZZTpA (small blind) folded before Flop
Seat 6: j7NIOHLZk7V2o9fOioO5ug (big blind) folded before Flop



PokerStars Game #59938609188:  Hold'em No Limit ($0.50/$1.00) - 2009/07/01 0:19:06 ET
Table 'fTlPiCj0utgzC/5io+I7ew' 6-max Seat #1 is the button
Seat 1: YMJG+F++3Aj6P8dAWda5fw ($98.50 in chips)
Seat 2: +xUCTmR3cU7G239W+vZv6g ($139.50 in chips)
Seat 4: uJVSceLggtsrJya+WtmUEA ($103.10 in chips)
Seat 5: bFrTkDcWGTxyvNul7GVdYg ($240.50 in chips)
Seat 6: AdLVjddOzm+sRNo1Bc3S6Q ($100 in chips)
+xUCTmR3cU7G239W+vZv6g: posts small blind $0.50
uJVSceLggtsrJya+WtmUEA: posts big blind $1
*** HOLE CARDS ***
bFrTkDcWGTxyvNul7GVdYg: folds
AdLVjddOzm+sRNo1Bc3S6Q: folds
YMJG+F++3Aj6P8dAWda5fw: raises $2 to $3
+xUCTmR3cU7G239W+vZv6g: folds
uJVSceLggtsrJya+WtmUEA: folds
YMJG+F++3Aj6P8dAWda5fw collected $2.50 from pot
*** SUMMARY ***
Total pot $2.50 | Rake $0
Seat 1: YMJG+F++3Aj6P8dAWda5fw (button) collected ($2.50)
Seat 2: +xUCTmR3cU7G239W+vZv6g (small blind) folded before Flop
Seat 4: uJVSceLggtsrJya+WtmUEA (big blind) folded before Flop
Seat 5: bFrTkDcWGTxyvNul7GVdYg folded before Flop (didn't bet)
Seat 6: AdLVjddOzm+sRNo1Bc3S6Q folded before Flop (didn't bet)



PokerStars Game #59938608592:  Hold'em No Limit ($0.50/$1.00) - 2009/07/01 0:19:06 ET
Table 'tyUh+jyNvrceIQdKMJjQ2wZFWj23PMihdwrNWv41OG/Qeat #2 is the button
Seat 1: o8A5MUdudVKu+pAwgZOX2w ($198.90 in chips)
Seat 2: 6iVcnPw9a2oNG6sPQo3G6g ($98.75 in chips)
Seat 3: L9qfLYXrczhAPd/VckgsWw ($40.40 in chips)
Seat 5: j7NIOHLZk7V2o9fOioO5ug ($100 in chips)
Seat 6: YsLQ3BAvgQHWXMAv3Wv6Hg ($106.75 in chips)
L9qfLYXrczhAPd/VckgsWw: posts small blind $0.50
j7NIOHLZk7V2o9fOioO5ug: posts big blind $1
*** HOLE CARDS ***
YsLQ3BAvgQHWXMAv3Wv6Hg: folds
o8A5MUdudVKu+pAwgZOX2w: folds
6iVcnPw9a2oNG6sPQo3G6g: folds
L9qfLYXrczhAPd/VckgsWw: calls $0.50
j7NIOHLZk7V2o9fOioO5ug: raises $3 to $4
L9qfLYXrczhAPd/VckgsWw: calls $3
*** FLOP *** [7c Ts 3d]
L9qfLYXrczhAPd/VckgsWw: checks
j7NIOHLZk7V2o9fOioO5ug: bets $5
L9qfLYXrczhAPd/VckgsWw: folds
j7NIOHLZk7V2o9fOioO5ug collected $7.60 from pot
j7NIOHLZk7V2o9fOioO5ug: doesn't show hand
*** SUMMARY ***
Total pot $8 | Rake $0.40
Board [7c Ts 3d]
Seat 1: o8A5MUdudVKu+pAwgZOX2w folded before Flop (didn't bet)
Seat 2: 6iVcnPw9a2oNG6sPQo3G6g (button) folded before Flop (didn't bet)
Seat 3: L9qfLYXrczhAPd/VckgsWw (small blind) folded on the Flop
Seat 5: j7NIOHLZk7V2o9fOioO5ug (big blind) collected ($7.60)
Seat 6: YsLQ3BAvgQHWXMAv3Wv6Hg folded before Flop (didn't bet)



PokerStars Game #59938609164:  Hold'em No Limit ($0.50/$1.00) - 2009/07/01 0:19:06 ET
Table 'J2yEIzCSC1VzM+R2gijwtg' 9-max Seat #4 is the button
Seat 1: knewtTmBc4Tc0z/5tAABYQ ($202.95 in chips)
Seat 2: kz9ziSiGUc+857heiKSayw ($16 in chips)
Seat 3: 9swGhtpERPngKPtvpoZkoQ ($133.15 in chips)
Seat 4: vR4IO10geOgvTW+LAUBv/A ($100 in chips)
Seat 5: /kZ258i1lqmMUXbtrZIHJA ($43.10 in chips)
Seat 6: bJckevFOcg//s0qyMQI6sQ ($176.40 in chips)
Seat 8: CIRDepY9Rc5tiDJPd0nNpQ ($93.90 in chips)
Seat 9: ZWdwcEAWYlrUhsRi6MOmoA ($33 in chips)
/kZ258i1lqmMUXbtrZIHJA: posts small blind $0.50
bJckevFOcg//s0qyMQI6sQ: posts big blind $1
*** HOLE CARDS ***
CIRDepY9Rc5tiDJPd0nNpQ: folds
ZWdwcEAWYlrUhsRi6MOmoA: calls $1
knewtTmBc4Tc0z/5tAABYQ: folds
kz9ziSiGUc+857heiKSayw: folds
9swGhtpERPngKPtvpoZkoQ: calls $1
vR4IO10geOgvTW+LAUBv/A: folds
/kZ258i1lqmMUXbtrZIHJA: folds
bJckevFOcg//s0qyMQI6sQ: checks
*** FLOP *** [5d 3s Kh]
bJckevFOcg//s0qyMQI6sQ: checks
ZWdwcEAWYlrUhsRi6MOmoA: checks
9swGhtpERPngKPtvpoZkoQ: bets $3
bJckevFOcg//s0qyMQI6sQ: folds
ZWdwcEAWYlrUhsRi6MOmoA: calls $3
*** TURN *** [5d 3s Kh] [4h]
ZWdwcEAWYlrUhsRi6MOmoA: checks
9swGhtpERPngKPtvpoZkoQ: checks
*** RIVER *** [5d 3s Kh 4h] [6d]
ZWdwcEAWYlrUhsRi6MOmoA: bets $5
9swGhtpERPngKPtvpoZkoQ: calls $5
*** SHOW DOWN ***
ZWdwcEAWYlrUhsRi6MOmoA: shows [5h 5s] (three of a kind, Fives)
9swGhtpERPngKPtvpoZkoQ: mucks hand
ZWdwcEAWYlrUhsRi6MOmoA collected $18.55 from pot
*** SUMMARY ***
Total pot $19.50 | Rake $0.95
Board [5d 3s Kh 4h 6d]
Seat 1: knewtTmBc4Tc0z/5tAABYQ folded before Flop (didn't bet)
Seat 2: kz9ziSiGUc+857heiKSayw folded before Flop (didn't bet)
Seat 3: 9swGhtpERPngKPtvpoZkoQ mucked
Seat 4: vR4IO10geOgvTW+LAUBv/A (button) folded before Flop (didn't bet)
Seat 5: /kZ258i1lqmMUXbtrZIHJA (small blind) folded before Flop
Seat 6: bJckevFOcg//s0qyMQI6sQ (big blind) folded on the Flop
Seat 8: CIRDepY9Rc5tiDJPd0nNpQ folded before Flop (didn't bet)
Seat 9: ZWdwcEAWYlrUhsRi6MOmoA showed [5h 5s] and won ($18.55) with three of a kind, Fives



PokerStars Game #59938608590:  Hold'em No Limit ($0.50/$1.00) - 2009/07/01 0:19:06 ET
Table '6YvsYDPNIDx2v5z3bJnwZQ' 9-max Seat #2 is the button
Seat 1: Ogn4JDV3mp4ZDKO49IFzKA ($17 in chips)
Seat 2: q9qdvTFQkzcAZRujD6rXUA ($98 in chips)
Seat 3: negfosHnGOZXSHpWDRKyBQ ($17.30 in chips)
Seat 4: kEr5NYB+JIG5+szcYMr6hA ($49 in chips)
Seat 5: mBRWbnUl8diyBO1qTJaNzw ($162.80 in chips)
Seat 7: boixc27eqTYA1p0tUdMuBQ ($109.60 in chips)
Seat 8: PSFxpXgPedVZyHSu2Zhb7Q ($78.90 in chips)
Seat 9: jDwhY1kCdc6EkAHbT7PJMQ ($106.85 in chips)
negfosHnGOZXSHpWDRKyBQ: posts small blind $0.50
kEr5NYB+JIG5+szcYMr6hA: posts big blind $1
uMPEfCcGCfsxmy53tVUMug: sits out
*** HOLE CARDS ***
mBRWbnUl8diyBO1qTJaNzw: calls $1
boixc27eqTYA1p0tUdMuBQ: folds
PSFxpXgPedVZyHSu2Zhb7Q: calls $1
jDwhY1kCdc6EkAHbT7PJMQ: folds
Ogn4JDV3mp4ZDKO49IFzKA: folds
q9qdvTFQkzcAZRujD6rXUA: folds
negfosHnGOZXSHpWDRKyBQ: folds
kEr5NYB+JIG5+szcYMr6hA: checks
*** FLOP *** [Qc Td 9c]
kEr5NYB+JIG5+szcYMr6hA: checks
mBRWbnUl8diyBO1qTJaNzw: checks
PSFxpXgPedVZyHSu2Zhb7Q: checks
*** TURN *** [Qc Td 9c] [4h]
kEr5NYB+JIG5+szcYMr6hA: checks
mBRWbnUl8diyBO1qTJaNzw: checks
PSFxpXgPedVZyHSu2Zhb7Q: checks
*** RIVER *** [Qc Td 9c 4h] [2s]
kEr5NYB+JIG5+szcYMr6hA: checks
mBRWbnUl8diyBO1qTJaNzw: checks
PSFxpXgPedVZyHSu2Zhb7Q: checks
*** SHOW DOWN ***
kEr5NYB+JIG5+szcYMr6hA: shows [Kh 7d] (high card King)
mBRWbnUl8diyBO1qTJaNzw: shows [9h 8s] (a pair of Nines)
PSFxpXgPedVZyHSu2Zhb7Q: mucks hand
mBRWbnUl8diyBO1qTJaNzw collected $3.35 from pot
*** SUMMARY ***
Total pot $3.50 | Rake $0.15
Board [Qc Td 9c 4h 2s]
Seat 1: Ogn4JDV3mp4ZDKO49IFzKA folded before Flop (didn't bet)
Seat 2: q9qdvTFQkzcAZRujD6rXUA (button) folded before Flop (didn't bet)
Seat 3: negfosHnGOZXSHpWDRKyBQ (small blind) folded before Flop
Seat 4: kEr5NYB+JIG5+szcYMr6hA (big blind) showed [Kh 7d] and lost with high card King
Seat 5: mBRWbnUl8diyBO1qTJaNzw showed [9h 8s] and won ($3.35) with a pair of Nines
Seat 7: boixc27eqTYA1p0tUdMuBQ folded before Flop (didn't bet)
Seat 8: PSFxpXgPedVZyHSu2Zhb7Q mucked
Seat 9: jDwhY1kCdc6EkAHbT7PJMQ folded before Flop (didn't bet)



PokerStars Game #59938610462:  Hold'em No Limit ($0.50/$1.00) - 2009/07/01 0:19:08 ET
Table 'eU3bWpDDg3Z+9R4m4iVmog' 6-max Seat #2 is the button
Seat 2: 8CAoOzhmB8n3nRFf3V4BTg ($179.45 in chips)
Seat 4: GDVIsbEJ/DOJsMKE4Asz0A ($94.95 in chips)
Seat 5: QHvTZcrKe6+maWUfVjP29Q ($100.50 in chips)
Seat 6: hpxXcmRkXXI9HE5+5/j/0Q ($100 in chips)
U6tnjwZRpTnM+YkqkCjwyQ will be allowed to play after the button
GDVIsbEJ/DOJsMKE4Asz0A: posts small blind $0.50
QHvTZcrKe6+maWUfVjP29Q: posts big blind $1
*** HOLE CARDS ***
hpxXcmRkXXI9HE5+5/j/0Q: folds
8CAoOzhmB8n3nRFf3V4BTg: folds
GDVIsbEJ/DOJsMKE4Asz0A: folds
QHvTZcrKe6+maWUfVjP29Q collected $1 from pot
QHvTZcrKe6+maWUfVjP29Q: doesn't show hand
*** SUMMARY ***
Total pot $1 | Rake $0
Seat 2: 8CAoOzhmB8n3nRFf3V4BTg (button) folded before Flop (didn't bet)
Seat 4: GDVIsbEJ/DOJsMKE4Asz0A (small blind) folded before Flop
Seat 5: QHvTZcrKe6+maWUfVjP29Q (big blind) collected ($1)
Seat 6: hpxXcmRkXXI9HE5+5/j/0Q folded before Flop (didn't bet)



PokerStars Game #59938611414:  Hold'em No Limit ($0.50/$1.00) - 2009/07/01 0:19:10 ET
Table 'mmbQQVBTrPdE+wy+s+9VPA' 6-max Seat #5 is the button
Seat 1: P9iqlRE1diA1wRYdf4YRBQ ($116.50 in chips)
Seat 2: oEFhmBFI/N1eUlbVXORRnw ($104.70 in chips)
Seat 3: wx3sQGkVi2x9wJXuWNHPBw ($105.60 in chips)
Seat 4: RfKnhkJN8HEAuzJpH2Ajdg ($18.05 in chips)
Seat 5: YMJG+F++3Aj6P8dAWda5fw ($100 in chips)
Seat 6: klQ/ufr9lOvfLMdAu0S9cw ($27.10 in chips)
klQ/ufr9lOvfLMdAu0S9cw: posts small blind $0.50
P9iqlRE1diA1wRYdf4YRBQ: posts big blind $1
*** HOLE CARDS ***
oEFhmBFI/N1eUlbVXORRnw: folds
oEFhmBFI/N1eUlbVXORRnw leaves the table
wx3sQGkVi2x9wJXuWNHPBw: folds
RfKnhkJN8HEAuzJpH2Ajdg: folds
YMJG+F++3Aj6P8dAWda5fw: folds
klQ/ufr9lOvfLMdAu0S9cw: calls $0.50
P9iqlRE1diA1wRYdf4YRBQ: checks
*** FLOP *** [2s Qh 5s]
klQ/ufr9lOvfLMdAu0S9cw: checks
esuark2007 joins the table at seat #2
esuark2007 is sitting out
P9iqlRE1diA1wRYdf4YRBQ: checks
*** TURN *** [2s Qh 5s] [Ac]
esuark2007 leaves the table
klQ/ufr9lOvfLMdAu0S9cw: checks
P9iqlRE1diA1wRYdf4YRBQ: checks
*** RIVER *** [2s Qh 5s Ac] [8c]
klQ/ufr9lOvfLMdAu0S9cw: checks
P9iqlRE1diA1wRYdf4YRBQ: checks
*** SHOW DOWN ***
klQ/ufr9lOvfLMdAu0S9cw: shows [Kc 4s] (high card Ace)
P9iqlRE1diA1wRYdf4YRBQ: shows [7c Ks] (high card Ace - King+Queen+Eight+Seven kicker)
P9iqlRE1diA1wRYdf4YRBQ collected $1.90 from pot
*** SUMMARY ***
Total pot $2 | Rake $0.10
Board [2s Qh 5s Ac 8c]
Seat 1: P9iqlRE1diA1wRYdf4YRBQ (big blind) showed [7c Ks] and won ($1.90) with high card Ace
Seat 2: oEFhmBFI/N1eUlbVXORRnw folded before Flop (didn't bet)
Seat 3: wx3sQGkVi2x9wJXuWNHPBw folded before Flop (didn't bet)
Seat 4: RfKnhkJN8HEAuzJpH2Ajdg folded before Flop (didn't bet)
Seat 5: YMJG+F++3Aj6P8dAWda5fw (button) folded before Flop (didn't bet)
Seat 6: klQ/ufr9lOvfLMdAu0S9cw (small blind) showed [Kc 4s] and lost with high card Ace



PokerStars Game #59938611208:  Hold'em No Limit ($0.50/$1.00) - 2009/07/01 0:19:10 ET
Table 'aWHveb63HkbTmOGHOxjBkQ' 2-max Seat #2 is the button
Seat 1: xy2MQKoHoCZZIudmw8Xbow ($198.70 in chips)
Seat 2: xstEKavv3YDxpUnU4e9qAQ ($176.10 in chips)
xstEKavv3YDxpUnU4e9qAQ: posts small blind $0.50
xy2MQKoHoCZZIudmw8Xbow: posts big blind $1
*** HOLE CARDS ***
xstEKavv3YDxpUnU4e9qAQ: folds
xy2MQKoHoCZZIudmw8Xbow collected $1 from pot
xy2MQKoHoCZZIudmw8Xbow: doesn't show hand
*** SUMMARY ***
Total pot $1 | Rake $0
Seat 1: xy2MQKoHoCZZIudmw8Xbow (big blind) collected ($1)
Seat 2: xstEKavv3YDxpUnU4e9qAQ (button) (small blind) folded before Flop



PokerStars Game #59938612000:  Hold'em No Limit ($0.50/$1.00) - 2009/07/01 0:19:11 ET
Table 'kBJtONSnMKK6+l5D0n+vjA' 2-max Seat #2 is the button
Seat 1: qubgcbkrXfMjdrMEd1lYMQ ($344.10 in chips)
Seat 2: 5x9BehadQB/XenOdQDZzEQ ($40.60 in chips)
5x9BehadQB/XenOdQDZzEQ: posts small blind $0.50
qubgcbkrXfMjdrMEd1lYMQ: posts big blind $1
*** HOLE CARDS ***
5x9BehadQB/XenOdQDZzEQ: folds
qubgcbkrXfMjdrMEd1lYMQ collected $1 from pot
*** SUMMARY ***
Total pot $1 | Rake $0
Seat 1: qubgcbkrXfMjdrMEd1lYMQ (big blind) collected ($1)
Seat 2: 5x9BehadQB/XenOdQDZzEQ (button) (small blind) folded before Flop



PokerStars Game #59938613008:  Hold'em No Limit ($0.50/$1.00) - 2009/07/01 0:19:12 ET
Table '7Nl0ffnjeK44/vmeexh3MQ' 9-max Seat #1 is the button
Seat 1: s7D3Y+k4Cj4D1cXHv7oj+Q ($102.30 in chips)
Seat 3: 200876 ($44 in chips)
Seat 4: NfbTuCZ2txeWuV3hP7t0TA ($100 in chips)
Seat 5: bL+QVeDcuEdzMGAGg2XJHg ($108.60 in chips)
Seat 6: FVs16t7GgfWgQWt4JxsObQ ($19.05 in chips)
Seat 7: knewtTmBc4Tc0z/5tAABYQ ($108 in chips)
Seat 8: zanka7aAZkigmZpfopXxxA ($137.70 in chips)
Seat 9: Ei6tUEmph+Q+DkB6JH3thw ($78.80 in chips)
200876: posts small blind $0.50
NfbTuCZ2txeWuV3hP7t0TA: posts big blind $1
*** HOLE CARDS ***
bL+QVeDcuEdzMGAGg2XJHg: folds
FVs16t7GgfWgQWt4JxsObQ: folds
knewtTmBc4Tc0z/5tAABYQ: folds
zanka7aAZkigmZpfopXxxA: folds
Ei6tUEmph+Q+DkB6JH3thw: folds
s7D3Y+k4Cj4D1cXHv7oj+Q: folds
200876: calls $0.50
NfbTuCZ2txeWuV3hP7t0TA: checks
*** FLOP *** [7h Jd 9h]
200876: bets $1
NfbTuCZ2txeWuV3hP7t0TA: folds
200876 collected $1.90 from pot
*** SUMMARY ***
Total pot $2 | Rake $0.10
Board [7h Jd 9h]
Seat 1: s7D3Y+k4Cj4D1cXHv7oj+Q (button) folded before Flop (didn't bet)
Seat 3: 200876 (small blind) collected ($1.90)
Seat 4: NfbTuCZ2txeWuV3hP7t0TA (big blind) folded on the Flop
Seat 5: bL+QVeDcuEdzMGAGg2XJHg folded before Flop (didn't bet)
Seat 6: FVs16t7GgfWgQWt4JxsObQ folded before Flop (didn't bet)
Seat 7: knewtTmBc4Tc0z/5tAABYQ folded before Flop (didn't bet)
Seat 8: zanka7aAZkigmZpfopXxxA folded before Flop (didn't bet)
Seat 9: Ei6tUEmph+Q+DkB6JH3thw folded before Flop (didn't bet)



PokerStars Game #59938613404:  Hold'em No Limit ($0.50/$1.00) - 2009/07/01 0:19:13 ET
Table 'tLrtq7gDzxEvckNAI1OS5Q' 6-max Seat #5 is the button
Seat 1: GisIe1kcC9q/xV6ifsTjgA ($148.10 in chips)
Seat 2: qsObMEIlRO22OlS867m/lw ($36.35 in chips)
Seat 3: TPZ+m9x+lwoKpv7TMfAUWA ($323.85 in chips)
Seat 5: OGMLOcTNYZXZU81au7ztUw ($175.15 in chips)
Seat 6: XUk5GQsfNFpHvaToDZ0rZA ($23.15 in chips)
XUk5GQsfNFpHvaToDZ0rZA: posts small blind $0.50
GisIe1kcC9q/xV6ifsTjgA: posts big blind $1
KOG8rG51mOvIoY96zF3kvw: sits out
*** HOLE CARDS ***
qsObMEIlRO22OlS867m/lw: folds
TPZ+m9x+lwoKpv7TMfAUWA: folds
OGMLOcTNYZXZU81au7ztUw: folds
XUk5GQsfNFpHvaToDZ0rZA: folds
GisIe1kcC9q/xV6ifsTjgA collected $1 from pot
*** SUMMARY ***
Total pot $1 | Rake $0
Seat 1: GisIe1kcC9q/xV6ifsTjgA (big blind) collected ($1)
Seat 2: qsObMEIlRO22OlS867m/lw folded before Flop (didn't bet)
Seat 3: TPZ+m9x+lwoKpv7TMfAUWA folded before Flop (didn't bet)
Seat 5: OGMLOcTNYZXZU81au7ztUw (button) folded before Flop (didn't bet)
Seat 6: XUk5GQsfNFpHvaToDZ0rZA (small blind) folded before Flop



PokerStars Game #59938613982:  Hold'em No Limit ($0.50/$1.00) - 2009/07/01 0:19:14 ET
Table '+cA8mcmhaedZ7YcrDdhmeQ' 6-max Seat #6 is the button
Seat 1: lsLuWlcPA3Rh7kJVLzMh0Q ($233.50 in chips)
Seat 2: trnpu4tPju3BU8W0wQQaiQ ($101.10 in chips)
Seat 3: 0WjiuIT7/EolY1oOx1ngeA ($135.50 in chips)
Seat 4: j0aDOn9Nft1HLTQvGu1UwA ($25 in chips)
Seat 5: 6WyjEXOToimYmtLdqIgHYQ ($62 in chips)
Seat 6: YfsTQsY/fxb+YqbdclTHuw ($86.65 in chips)
lsLuWlcPA3Rh7kJVLzMh0Q: posts small blind $0.50
trnpu4tPju3BU8W0wQQaiQ: posts big blind $1
j0aDOn9Nft1HLTQvGu1UwA: posts small & big blinds $1.50
*** HOLE CARDS ***
0WjiuIT7/EolY1oOx1ngeA: raises $5 to $6
j0aDOn9Nft1HLTQvGu1UwA: calls $5
6WyjEXOToimYmtLdqIgHYQ: folds
YfsTQsY/fxb+YqbdclTHuw: folds
lsLuWlcPA3Rh7kJVLzMh0Q: folds
trnpu4tPju3BU8W0wQQaiQ: folds
*** FLOP *** [6h 3c Th]
0WjiuIT7/EolY1oOx1ngeA: bets $20
j0aDOn9Nft1HLTQvGu1UwA: folds
0WjiuIT7/EolY1oOx1ngeA collected $13.30 from pot
*** SUMMARY ***
Total pot $14 | Rake $0.70
Board [6h 3c Th]
Seat 1: lsLuWlcPA3Rh7kJVLzMh0Q (small blind) folded before Flop
Seat 2: trnpu4tPju3BU8W0wQQaiQ (big blind) folded before Flop
Seat 3: 0WjiuIT7/EolY1oOx1ngeA collected ($13.30)
Seat 4: j0aDOn9Nft1HLTQvGu1UwA folded on the Flop
Seat 5: 6WyjEXOToimYmtLdqIgHYQ folded before Flop (didn't bet)
Seat 6: YfsTQsY/fxb+YqbdclTHuw (button) folded before Flop (didn't bet)



PokerStars Game #59938613904:  Hold'em No Limit ($0.50/$1.00) - 2009/07/01 0:19:14 ET
Table 'QSIig7BLMc9wY/rgBechzw' 6-max Seat #6 is the button
Seat 2: 0WjiuIT7/EolY1oOx1ngeA ($113 in chips)
Seat 3: +W6OnF033KNM2xH0fGj98Q ($108.70 in chips)
Seat 5: 1yB1nHUkHNNY8OJnDNHZMw ($76.15 in chips)
Seat 6: KpnW5CcJ4Mg6MeclfKmLrw ($144.75 in chips)
uuA9hpFU17U5/t4cvpbpBg will be allowed to play after the button
0WjiuIT7/EolY1oOx1ngeA: posts small blind $0.50
+W6OnF033KNM2xH0fGj98Q: posts big blind $1
+uSzP8Jwnw7sKfQ4s66b7w: sits out
*** HOLE CARDS ***
1yB1nHUkHNNY8OJnDNHZMw: calls $1
KpnW5CcJ4Mg6MeclfKmLrw: folds
0WjiuIT7/EolY1oOx1ngeA: folds
+W6OnF033KNM2xH0fGj98Q: checks
*** FLOP *** [3s Th 4c]
+W6OnF033KNM2xH0fGj98Q: checks
1yB1nHUkHNNY8OJnDNHZMw: bets $2
+W6OnF033KNM2xH0fGj98Q: folds
1yB1nHUkHNNY8OJnDNHZMw collected $2.40 from pot
*** SUMMARY ***
Total pot $2.50 | Rake $0.10
Board [3s Th 4c]
Seat 2: 0WjiuIT7/EolY1oOx1ngeA (small blind) folded before Flop
Seat 3: +W6OnF033KNM2xH0fGj98Q (big blind) folded on the Flop
Seat 5: 1yB1nHUkHNNY8OJnDNHZMw collected ($2.40)
Seat 6: KpnW5CcJ4Mg6MeclfKmLrw (button) folded before Flop (didn't bet)



PokerStars Game #59938615218:  Hold'em No Limit ($0.50/$1.00) - 2009/07/01 0:19:15 ET
Table 'aWHveb63HkbTmOGHOxjBkQ' 2-max Seat #1 is the button
Seat 1: xy2MQKoHoCZZIudmw8Xbow ($199.20 in chips)
Seat 2: xstEKavv3YDxpUnU4e9qAQ ($175.60 in chips)
xy2MQKoHoCZZIudmw8Xbow: posts small blind $0.50
xstEKavv3YDxpUnU4e9qAQ: posts big blind $1
*** HOLE CARDS ***
xy2MQKoHoCZZIudmw8Xbow: raises $4 to $5
xstEKavv3YDxpUnU4e9qAQ: folds
xy2MQKoHoCZZIudmw8Xbow collected $2 from pot
xy2MQKoHoCZZIudmw8Xbow: doesn't show hand
*** SUMMARY ***
Total pot $2 | Rake $0
Seat 1: xy2MQKoHoCZZIudmw8Xbow (button) (small blind) collected ($2)
Seat 2: xstEKavv3YDxpUnU4e9qAQ (big blind) folded before Flop



PokerStars Game #59938615994:  Hold'em No Limit ($0.50/$1.00) - 2009/07/01 0:19:17 ET
Table 'FKpXUINE6M3UxHG4zaMhHA' 6-max Seat #4 is the button
Seat 2: ecfRjfaWRYbPNvaBsW5ZQQ ($19 in chips)
Seat 3: ssLJburtEIqnVkx6X8R1uw ($122.90 in chips)
Seat 4: ru6SCVvWcWt2SpmUsmArWQ ($21 in chips)
Seat 5: hpxXcmRkXXI9HE5+5/j/0Q ($105.70 in chips)
Seat 6: b2a+5TkFf4xJN/Ihhma58Q ($24.80 in chips)
hpxXcmRkXXI9HE5+5/j/0Q: posts small blind $0.50
b2a+5TkFf4xJN/Ihhma58Q: posts big blind $1
*** HOLE CARDS ***
ecfRjfaWRYbPNvaBsW5ZQQ: calls $1
ssLJburtEIqnVkx6X8R1uw: folds
ru6SCVvWcWt2SpmUsmArWQ: folds
hpxXcmRkXXI9HE5+5/j/0Q: raises $3 to $4
b2a+5TkFf4xJN/Ihhma58Q: calls $3
ecfRjfaWRYbPNvaBsW5ZQQ: calls $3
*** FLOP *** [Jh 8h 8s]
hpxXcmRkXXI9HE5+5/j/0Q: checks
b2a+5TkFf4xJN/Ihhma58Q: checks
ecfRjfaWRYbPNvaBsW5ZQQ: checks
*** TURN *** [Jh 8h 8s] [Td]
hpxXcmRkXXI9HE5+5/j/0Q: checks
b2a+5TkFf4xJN/Ihhma58Q: checks
ecfRjfaWRYbPNvaBsW5ZQQ: bets $3
hpxXcmRkXXI9HE5+5/j/0Q: calls $3
b2a+5TkFf4xJN/Ihhma58Q: calls $3
*** RIVER *** [Jh 8h 8s Td] [Th]
hpxXcmRkXXI9HE5+5/j/0Q: checks
b2a+5TkFf4xJN/Ihhma58Q: checks
ecfRjfaWRYbPNvaBsW5ZQQ: bets $3
hpxXcmRkXXI9HE5+5/j/0Q: calls $3
b2a+5TkFf4xJN/Ihhma58Q: folds
*** SHOW DOWN ***
ecfRjfaWRYbPNvaBsW5ZQQ: shows [Tc 5c] (a full house, Tens full of Eights)
hpxXcmRkXXI9HE5+5/j/0Q: mucks hand
ecfRjfaWRYbPNvaBsW5ZQQ collected $25.70 from pot
*** SUMMARY ***
Total pot $27 | Rake $1.30
Board [Jh 8h 8s Td Th]
Seat 2: ecfRjfaWRYbPNvaBsW5ZQQ showed [Tc 5c] and won ($25.70) with a full house, Tens full of Eights
Seat 3: ssLJburtEIqnVkx6X8R1uw folded before Flop (didn't bet)
Seat 4: ru6SCVvWcWt2SpmUsmArWQ (button) folded before Flop (didn't bet)
Seat 5: hpxXcmRkXXI9HE5+5/j/0Q (small blind) mucked
Seat 6: b2a+5TkFf4xJN/Ihhma58Q (big blind) folded on the River



PokerStars Game #59938616134:  Hold'em No Limit ($0.50/$1.00) - 2009/07/01 0:19:17 ET
Table 'SQLOQoANiHscJ8AL7zffbw' 9-max Seat #2 is the button
Seat 1: jPTRd6SpCp4xqAy2XQiTOw ($103.05 in chips)
Seat 2: /zy+DB4S5fUQUSfZWFzYGw ($284.35 in chips)
Seat 3: 0eFnow7+D7veCYQ+CG9FFw ($99 in chips)
Seat 4: N9n5Wc3s35DpCrOAUUNAaQ ($121.80 in chips)
Seat 5: L9njYvloJ1NdXjP8edHEAg ($100 in chips)
Seat 6: p5UKaxVobvptF0ANhR/q1A ($158.50 in chips)
Seat 7: bJckevFOcg//s0qyMQI6sQ ($100 in chips)
Seat 8: yfXek8iJ7O4CFyqXrtGcfg ($83.95 in chips)
0eFnow7+D7veCYQ+CG9FFw: posts small blind $0.50
N9n5Wc3s35DpCrOAUUNAaQ: posts big blind $1
*** HOLE CARDS ***
L9njYvloJ1NdXjP8edHEAg: folds
p5UKaxVobvptF0ANhR/q1A: folds
bJckevFOcg//s0qyMQI6sQ: raises $3 to $4
yfXek8iJ7O4CFyqXrtGcfg: folds
jPTRd6SpCp4xqAy2XQiTOw: folds
/zy+DB4S5fUQUSfZWFzYGw: calls $4
0eFnow7+D7veCYQ+CG9FFw: folds
N9n5Wc3s35DpCrOAUUNAaQ: folds
*** FLOP *** [Ac Qs Jd]
bJckevFOcg//s0qyMQI6sQ: bets $6.50
/zy+DB4S5fUQUSfZWFzYGw: folds
bJckevFOcg//s0qyMQI6sQ collected $9.05 from pot
*** SUMMARY ***
Total pot $9.50 | Rake $0.45
Board [Ac Qs Jd]
Seat 1: jPTRd6SpCp4xqAy2XQiTOw folded before Flop (didn't bet)
Seat 2: /zy+DB4S5fUQUSfZWFzYGw (button) folded on the Flop
Seat 3: 0eFnow7+D7veCYQ+CG9FFw (small blind) folded before Flop
Seat 4: N9n5Wc3s35DpCrOAUUNAaQ (big blind) folded before Flop
Seat 5: L9njYvloJ1NdXjP8edHEAg folded before Flop (didn't bet)
Seat 6: p5UKaxVobvptF0ANhR/q1A folded before Flop (didn't bet)
Seat 7: bJckevFOcg//s0qyMQI6sQ collected ($9.05)
Seat 8: yfXek8iJ7O4CFyqXrtGcfg folded before Flop (didn't bet)



PokerStars Game #59938616636:  Hold'em No Limit ($0.50/$1.00) - 2009/07/01 0:19:17 ET
Table '3T4owEKJKyGTMePwrv50FQ' 9-max Seat #2 is the button
Seat 1: i7H4OcR0JBHUDu6bJ34rtw ($72.40 in chips)
Seat 2: p5UKaxVobvptF0ANhR/q1A ($106.65 in chips)
Seat 3: pCl9IYtMJjmAJCt7Pu4TDw ($42.95 in chips)
Seat 4: 3MYLdqcdtveb3nHZv3D1IA ($10 in chips)
Seat 5: ArTa9sSTrL++oHeXU/9PPA ($49.60 in chips)
Seat 7: brpN3NxzKqwZCeb5s2Nq4g ($40.05 in chips)
Seat 8: negfosHnGOZXSHpWDRKyBQ ($18.50 in chips)
Seat 9: vR4IO10geOgvTW+LAUBv/A ($123.50 in chips)
pCl9IYtMJjmAJCt7Pu4TDw: posts small blind $0.50
3MYLdqcdtveb3nHZv3D1IA: posts big blind $1
*** HOLE CARDS ***
ArTa9sSTrL++oHeXU/9PPA: folds
brpN3NxzKqwZCeb5s2Nq4g: folds
negfosHnGOZXSHpWDRKyBQ: folds
vR4IO10geOgvTW+LAUBv/A: raises $2 to $3
i7H4OcR0JBHUDu6bJ34rtw: folds
p5UKaxVobvptF0ANhR/q1A: folds
pCl9IYtMJjmAJCt7Pu4TDw: folds
3MYLdqcdtveb3nHZv3D1IA: folds
vR4IO10geOgvTW+LAUBv/A collected $2.50 from pot
vR4IO10geOgvTW+LAUBv/A: doesn't show hand
*** SUMMARY ***
Total pot $2.50 | Rake $0
Seat 1: i7H4OcR0JBHUDu6bJ34rtw folded before Flop (didn't bet)
Seat 2: p5UKaxVobvptF0ANhR/q1A (button) folded before Flop (didn't bet)
Seat 3: pCl9IYtMJjmAJCt7Pu4TDw (small blind) folded before Flop
Seat 4: 3MYLdqcdtveb3nHZv3D1IA (big blind) folded before Flop
Seat 5: ArTa9sSTrL++oHeXU/9PPA folded before Flop (didn't bet)
Seat 7: brpN3NxzKqwZCeb5s2Nq4g folded before Flop (didn't bet)
Seat 8: negfosHnGOZXSHpWDRKyBQ folded before Flop (didn't bet)
Seat 9: vR4IO10geOgvTW+LAUBv/A collected ($2.50)



PokerStars Game #59938616828:  Hold'em No Limit ($0.50/$1.00) - 2009/07/01 0:19:18 ET
Table 'blHlQApStil0OPeQxQxPcwFKpXUINE6M3UxHG4zaMhHAx Seat #1 is the button
Seat 1: x80+i7DJL+81v3quj7KbNg ($20 in chips)
Seat 2: wIZ377kjl2fHFGnS93o6bw ($31.20 in chips)
Seat 3: o1axyw4AjQ8n4ubTwlirQQ ($27.70 in chips)
Seat 4: zanka7aAZkigmZpfopXxxA ($36.80 in chips)
Seat 6: JPQzLacMGzeh42mPgyrvVQ ($72.10 in chips)
Seat 7: vR4IO10geOgvTW+LAUBv/A ($118 in chips)
Seat 8: VtjmCz/ASIcETatNJ8YcCA ($57.85 in chips)
wIZ377kjl2fHFGnS93o6bw: posts small blind $0.50
o1axyw4AjQ8n4ubTwlirQQ: posts big blind $1
uXrDE6JrIi8BZK1L8oQ9bQ: sits out
*** HOLE CARDS ***
zanka7aAZkigmZpfopXxxA: folds
JPQzLacMGzeh42mPgyrvVQ: folds
vR4IO10geOgvTW+LAUBv/A: raises $2 to $3
VtjmCz/ASIcETatNJ8YcCA: folds
x80+i7DJL+81v3quj7KbNg: folds
wIZ377kjl2fHFGnS93o6bw: calls $2.50
o1axyw4AjQ8n4ubTwlirQQ: folds
*** FLOP *** [3h 6s Qh]
wIZ377kjl2fHFGnS93o6bw: checks
vR4IO10geOgvTW+LAUBv/A: bets $4
wIZ377kjl2fHFGnS93o6bw: raises $6 to $10
vR4IO10geOgvTW+LAUBv/A: folds
wIZ377kjl2fHFGnS93o6bw collected $14.30 from pot
*** SUMMARY ***
Total pot $15 | Rake $0.70
Board [3h 6s Qh]
Seat 1: x80+i7DJL+81v3quj7KbNg (button) folded before Flop (didn't bet)
Seat 2: wIZ377kjl2fHFGnS93o6bw (small blind) collected ($14.30)
Seat 3: o1axyw4AjQ8n4ubTwlirQQ (big blind) folded before Flop
Seat 4: zanka7aAZkigmZpfopXxxA folded before Flop (didn't bet)
Seat 6: JPQzLacMGzeh42mPgyrvVQ folded before Flop (didn't bet)
Seat 7: vR4IO10geOgvTW+LAUBv/A folded on the Flop
Seat 8: VtjmCz/ASIcETatNJ8YcCA folded before Flop (didn't bet)



PokerStars Game #59938617842:  Hold'em No Limit ($0.50/$1.00) - 2009/07/01 0:19:19 ET
Table 'eU3bWpDDg3Z+9R4m4iVmog' 6-max Seat #4 is the button
Seat 2: 8CAoOzhmB8n3nRFf3V4BTg ($179.45 in chips)
Seat 4: GDVIsbEJ/DOJsMKE4Asz0A ($94.45 in chips)
Seat 5: QHvTZcrKe6+maWUfVjP29Q ($101 in chips)
Seat 6: hpxXcmRkXXI9HE5+5/j/0Q ($100 in chips)
QHvTZcrKe6+maWUfVjP29Q: posts small blind $0.50
hpxXcmRkXXI9HE5+5/j/0Q: posts big blind $1
U6tnjwZRpTnM+YkqkCjwyQ: sits out
*** HOLE CARDS ***
8CAoOzhmB8n3nRFf3V4BTg: folds
GDVIsbEJ/DOJsMKE4Asz0A: folds
QHvTZcrKe6+maWUfVjP29Q: folds
hpxXcmRkXXI9HE5+5/j/0Q collected $1 from pot
hpxXcmRkXXI9HE5+5/j/0Q: doesn't show hand
*** SUMMARY ***
Total pot $1 | Rake $0
Seat 2: 8CAoOzhmB8n3nRFf3V4BTg folded before Flop (didn't bet)
Seat 4: GDVIsbEJ/DOJsMKE4Asz0A (button) folded before Flop (didn't bet)
Seat 5: QHvTZcrKe6+maWUfVjP29Q (small blind) folded before Flop
Seat 6: hpxXcmRkXXI9HE5+5/j/0Q (big blind) collected ($1)



PokerStars Game #59938619426:  Hold'em No Limit ($0.50/$1.00) - 2009/07/01 0:19:22 ET
Table 'aWHveb63HkbTmOGHOxjBkQ' 2-max Seat #2 is the button
Seat 1: xy2MQKoHoCZZIudmw8Xbow ($200.20 in chips)
Seat 2: xstEKavv3YDxpUnU4e9qAQ ($174.60 in chips)
xstEKavv3YDxpUnU4e9qAQ: posts small blind $0.50
xy2MQKoHoCZZIudmw8Xbow: posts big blind $1
*** HOLE CARDS ***
xstEKavv3YDxpUnU4e9qAQ: folds
xy2MQKoHoCZZIudmw8Xbow collected $1 from pot
xy2MQKoHoCZZIudmw8Xbow: doesn't show hand
*** SUMMARY ***
Total pot $1 | Rake $0
Seat 1: xy2MQKoHoCZZIudmw8Xbow (big blind) collected ($1)
Seat 2: xstEKavv3YDxpUnU4e9qAQ (button) (small blind) folded before Flop



PokerStars Game #59938620256:  Hold'em No Limit ($0.50/$1.00) - 2009/07/01 0:19:23 ET
Table '/+ni2d7lj6E90JmAQZKSOw' 2-max Seat #1 is the button
Seat 1: qubgcbkrXfMjdrMEd1lYMQ ($260.70 in chips)
Seat 2: IJu7Boitu3yAxp4hjIx6zQ ($109.90 in chips)
qubgcbkrXfMjdrMEd1lYMQ: posts small blind $0.50
IJu7Boitu3yAxp4hjIx6zQ: posts big blind $1
*** HOLE CARDS ***
qubgcbkrXfMjdrMEd1lYMQ: raises $2 to $3
IJu7Boitu3yAxp4hjIx6zQ: folds
qubgcbkrXfMjdrMEd1lYMQ collected $2 from pot
qubgcbkrXfMjdrMEd1lYMQ: doesn't show hand
*** SUMMARY ***
Total pot $2 | Rake $0
Seat 1: qubgcbkrXfMjdrMEd1lYMQ (button) (small blind) collected ($2)
Seat 2: IJu7Boitu3yAxp4hjIx6zQ (big blind) folded before Flop



PokerStars Game #59938621008:  Hold'em No Limit ($0.50/$1.00) - 2009/07/01 0:19:24 ET
Table 'W/wyObTiXZm+Ckkl3YxcSw' 6-max Seat #5 is the button
Seat 1: ssLJburtEIqnVkx6X8R1uw ($120.85 in chips)
Seat 2: o2BpeCDF/L1yw7HKjemvYg ($25.80 in chips)
Seat 3: b2a+5TkFf4xJN/Ihhma58Q ($37.70 in chips)
Seat 4: BdbmJTZZ47quA9vUWwXtlw ($51.60 in chips)
Seat 5: Wko+clJG9HZPPQ7Yn0Y5Zg ($24 in chips)
Seat 6: GwvR1vWAchnuOBZu0dm5Rg ($88.75 in chips)
GwvR1vWAchnuOBZu0dm5Rg: posts small blind $0.50
ssLJburtEIqnVkx6X8R1uw: posts big blind $1
*** HOLE CARDS ***
o2BpeCDF/L1yw7HKjemvYg: folds
b2a+5TkFf4xJN/Ihhma58Q: raises $1 to $2
BdbmJTZZ47quA9vUWwXtlw: folds
Wko+clJG9HZPPQ7Yn0Y5Zg: folds
GwvR1vWAchnuOBZu0dm5Rg: folds
ssLJburtEIqnVkx6X8R1uw: folds
b2a+5TkFf4xJN/Ihhma58Q collected $2.50 from pot
*** SUMMARY ***
Total pot $2.50 | Rake $0
Seat 1: ssLJburtEIqnVkx6X8R1uw (big blind) folded before Flop
Seat 2: o2BpeCDF/L1yw7HKjemvYg folded before Flop (didn't bet)
Seat 3: b2a+5TkFf4xJN/Ihhma58Q collected ($2.50)
Seat 4: BdbmJTZZ47quA9vUWwXtlw folded before Flop (didn't bet)
Seat 5: Wko+clJG9HZPPQ7Yn0Y5Zg (button) folded before Flop (didn't bet)
Seat 6: GwvR1vWAchnuOBZu0dm5Rg (small blind) folded before Flop



PokerStars Game #59938621180:  Hold'em No Limit ($0.50/$1.00) - 2009/07/01 0:19:24 ET
Table 'vs/5jr6ciwjVQ5+Soc+u2A' 6-max Seat #4 is the button
Seat 2: XOIf9W+VAxhZqN+SYoyMKA ($116.80 in chips)
Seat 3: G5ZSSN6RSON3gkNvk/SmYg ($100 in chips)
Seat 4: KpnW5CcJ4Mg6MeclfKmLrw ($102.50 in chips)
Seat 5: 7Vc9JmGFQwMRh5Tj9ui5Lw ($101.65 in chips)
Seat 6: QHvTZcrKe6+maWUfVjP29Q ($100 in chips)
7Vc9JmGFQwMRh5Tj9ui5Lw: posts small blind $0.50
QHvTZcrKe6+maWUfVjP29Q: posts big blind $1
*** HOLE CARDS ***
XOIf9W+VAxhZqN+SYoyMKA: folds
G5ZSSN6RSON3gkNvk/SmYg: folds
KpnW5CcJ4Mg6MeclfKmLrw: raises $2 to $3
7Vc9JmGFQwMRh5Tj9ui5Lw: calls $2.50
QHvTZcrKe6+maWUfVjP29Q: folds
*** FLOP *** [9c 6c Kh]
7Vc9JmGFQwMRh5Tj9ui5Lw: checks
KpnW5CcJ4Mg6MeclfKmLrw: checks
*** TURN *** [9c 6c Kh] [9s]
7Vc9JmGFQwMRh5Tj9ui5Lw: checks
KpnW5CcJ4Mg6MeclfKmLrw: bets $5
7Vc9JmGFQwMRh5Tj9ui5Lw: folds
KpnW5CcJ4Mg6MeclfKmLrw collected $6.65 from pot
KpnW5CcJ4Mg6MeclfKmLrw: doesn't show hand
*** SUMMARY ***
Total pot $7 | Rake $0.35
Board [9c 6c Kh 9s]
Seat 2: XOIf9W+VAxhZqN+SYoyMKA folded before Flop (didn't bet)
Seat 3: G5ZSSN6RSON3gkNvk/SmYg folded before Flop (didn't bet)
Seat 4: KpnW5CcJ4Mg6MeclfKmLrw (button) collected ($6.65)
Seat 5: 7Vc9JmGFQwMRh5Tj9ui5Lw (small blind) folded on the Turn
Seat 6: QHvTZcrKe6+maWUfVjP29Q (big blind) folded before Flop



PokerStars Game #59938622402:  Hold'em No Limit ($0.50/$1.00) - 2009/07/01 0:19:26 ET
Table 'pHrhryH8jPNdQfY62f8v+g' 6-max Seat #5 is the button
Seat 1: BdbmJTZZ47quA9vUWwXtlw ($74.75 in chips)
Seat 2: RqgF7gRoKgRNW8Zoi1ty4A ($100 in chips)
Seat 3: rw4J9hTeo4c+qBV5IU/aQQ ($16.45 in chips)
Seat 4: wenbG7TaM3H7h5kn78OFNw ($55.55 in chips)
Seat 5: Gp2euK/nqF6qXKe7U+jOfw ($120.15 in chips)
Seat 6: xNKcQzD9+/iHmtJn4vYq9w ($213.15 in chips)
xNKcQzD9+/iHmtJn4vYq9w: posts small blind $0.50
BdbmJTZZ47quA9vUWwXtlw: posts big blind $1
*** HOLE CARDS ***
rw4J9hTeo4c+qBV5IU/aQQ said, "ALAA"
RqgF7gRoKgRNW8Zoi1ty4A: folds
rw4J9hTeo4c+qBV5IU/aQQ said, "K7 KK"
rw4J9hTeo4c+qBV5IU/aQQ: calls $1
wenbG7TaM3H7h5kn78OFNw: folds
Gp2euK/nqF6qXKe7U+jOfw: folds
xNKcQzD9+/iHmtJn4vYq9w: calls $0.50
BdbmJTZZ47quA9vUWwXtlw: checks
*** FLOP *** [Js Qd 4s]
xNKcQzD9+/iHmtJn4vYq9w: checks
BdbmJTZZ47quA9vUWwXtlw: checks
rw4J9hTeo4c+qBV5IU/aQQ: checks
*** TURN *** [Js Qd 4s] [4d]
xNKcQzD9+/iHmtJn4vYq9w: checks
BdbmJTZZ47quA9vUWwXtlw: checks
rw4J9hTeo4c+qBV5IU/aQQ: bets $1
xNKcQzD9+/iHmtJn4vYq9w: folds
BdbmJTZZ47quA9vUWwXtlw: folds
rw4J9hTeo4c+qBV5IU/aQQ collected $2.85 from pot
*** SUMMARY ***
Total pot $3 | Rake $0.15
Board [Js Qd 4s 4d]
Seat 1: BdbmJTZZ47quA9vUWwXtlw (big blind) folded on the Turn
Seat 2: RqgF7gRoKgRNW8Zoi1ty4A folded before Flop (didn't bet)
Seat 3: rw4J9hTeo4c+qBV5IU/aQQ collected ($2.85)
Seat 4: wenbG7TaM3H7h5kn78OFNw folded before Flop (didn't bet)
Seat 5: Gp2euK/nqF6qXKe7U+jOfw (button) folded before Flop (didn't bet)
Seat 6: xNKcQzD9+/iHmtJn4vYq9w (small blind) folded on the Turn



PokerStars Game #59938622674:  Hold'em No Limit ($0.50/$1.00) - 2009/07/01 0:19:26 ET
Table 'cKH9c4x6u79IqCdaKKvXrw' 9-max Seat #1 is the button
Seat 1: p1SafS90nb3Uft5LB0NkHw ($20 in chips)
Seat 2: knewtTmBc4Tc0z/5tAABYQ ($197 in chips)
Seat 4: FL3MrLspcF23LYvC4ipBOA ($100 in chips)
Seat 5: negfosHnGOZXSHpWDRKyBQ ($27.80 in chips)
Seat 6: Bsd/K5gAcLanYbGiPirRjw ($169.25 in chips)
Seat 7: 0eFnow7+D7veCYQ+CG9FFw ($92.85 in chips)
Seat 8: 4/8w7g4QE6v0i1tIIf/1HQ ($57 in chips)
knewtTmBc4Tc0z/5tAABYQ: posts small blind $0.50
FL3MrLspcF23LYvC4ipBOA: posts big blind $1
*** HOLE CARDS ***
negfosHnGOZXSHpWDRKyBQ: folds
Bsd/K5gAcLanYbGiPirRjw: folds
0eFnow7+D7veCYQ+CG9FFw: raises $2 to $3
4/8w7g4QE6v0i1tIIf/1HQ: folds
p1SafS90nb3Uft5LB0NkHw: folds
knewtTmBc4Tc0z/5tAABYQ: folds
FL3MrLspcF23LYvC4ipBOA: folds
0eFnow7+D7veCYQ+CG9FFw collected $2.50 from pot
0eFnow7+D7veCYQ+CG9FFw: doesn't show hand
*** SUMMARY ***
Total pot $2.50 | Rake $0
Seat 1: p1SafS90nb3Uft5LB0NkHw (button) folded before Flop (didn't bet)
Seat 2: knewtTmBc4Tc0z/5tAABYQ (small blind) folded before Flop
Seat 4: FL3MrLspcF23LYvC4ipBOA (big blind) folded before Flop
Seat 5: negfosHnGOZXSHpWDRKyBQ folded before Flop (didn't bet)
Seat 6: Bsd/K5gAcLanYbGiPirRjw folded before Flop (didn't bet)
Seat 7: 0eFnow7+D7veCYQ+CG9FFw collected ($2.50)
Seat 8: 4/8w7g4QE6v0i1tIIf/1HQ folded before Flop (didn't bet)



PokerStars Game #59938623034:  Hold'em No Limit ($0.50/$1.00) - 2009/07/01 0:19:27 ET
Table 'aWHveb63HkbTmOGHOxjBkQ' 2-max Seat #1 is the button
Seat 1: xy2MQKoHoCZZIudmw8Xbow ($200.70 in chips)
Seat 2: xstEKavv3YDxpUnU4e9qAQ ($174.10 in chips)
xy2MQKoHoCZZIudmw8Xbow: posts small blind $0.50
xstEKavv3YDxpUnU4e9qAQ: posts big blind $1
*** HOLE CARDS ***
xy2MQKoHoCZZIudmw8Xbow: raises $3 to $4
xstEKavv3YDxpUnU4e9qAQ: folds
xy2MQKoHoCZZIudmw8Xbow collected $2 from pot
xy2MQKoHoCZZIudmw8Xbow: doesn't show hand
*** SUMMARY ***
Total pot $2 | Rake $0
Seat 1: xy2MQKoHoCZZIudmw8Xbow (button) (small blind) collected ($2)
Seat 2: xstEKavv3YDxpUnU4e9qAQ (big blind) folded before Flop



PokerStars Game #59938625126:  Hold'em No Limit ($0.50/$1.00) - 2009/07/01 0:19:30 ET
Table 'eU3bWpDDg3Z+9R4m4iVmog' 6-max Seat #5 is the button
Seat 2: 8CAoOzhmB8n3nRFf3V4BTg ($179.45 in chips)
Seat 4: GDVIsbEJ/DOJsMKE4Asz0A ($94.45 in chips)
Seat 5: QHvTZcrKe6+maWUfVjP29Q ($100.50 in chips)
Seat 6: hpxXcmRkXXI9HE5+5/j/0Q ($100.50 in chips)
hpxXcmRkXXI9HE5+5/j/0Q: posts small blind $0.50
8CAoOzhmB8n3nRFf3V4BTg: posts big blind $1
U6tnjwZRpTnM+YkqkCjwyQ: sits out
*** HOLE CARDS ***
GDVIsbEJ/DOJsMKE4Asz0A: folds
QHvTZcrKe6+maWUfVjP29Q: raises $2 to $3
hpxXcmRkXXI9HE5+5/j/0Q: folds
8CAoOzhmB8n3nRFf3V4BTg: folds
QHvTZcrKe6+maWUfVjP29Q collected $2.50 from pot
QHvTZcrKe6+maWUfVjP29Q: doesn't show hand
*** SUMMARY ***
Total pot $2.50 | Rake $0
Seat 2: 8CAoOzhmB8n3nRFf3V4BTg (big blind) folded before Flop
Seat 4: GDVIsbEJ/DOJsMKE4Asz0A folded before Flop (didn't bet)
Seat 5: QHvTZcrKe6+maWUfVjP29Q (button) collected ($2.50)
Seat 6: hpxXcmRkXXI9HE5+5/j/0Q (small blind) folded before Flop



PokerStars Game #59938625702:  Hold'em No Limit ($0.50/$1.00) - 2009/07/01 0:19:31 ET
Table 'tLrtq7gDzxEvckNAI1OS5Q' 6-max Seat #6 is the button
Seat 1: GisIe1kcC9q/xV6ifsTjgA ($148.60 in chips)
Seat 2: qsObMEIlRO22OlS867m/lw ($36.35 in chips)
Seat 3: TPZ+m9x+lwoKpv7TMfAUWA ($323.85 in chips)
Seat 5: OGMLOcTNYZXZU81au7ztUw ($175.15 in chips)
Seat 6: XUk5GQsfNFpHvaToDZ0rZA ($22.65 in chips)
GisIe1kcC9q/xV6ifsTjgA: posts small blind $0.50
qsObMEIlRO22OlS867m/lw: posts big blind $1
KOG8rG51mOvIoY96zF3kvw: sits out
*** HOLE CARDS ***
TPZ+m9x+lwoKpv7TMfAUWA: folds
OGMLOcTNYZXZU81au7ztUw: folds
XUk5GQsfNFpHvaToDZ0rZA: folds
GisIe1kcC9q/xV6ifsTjgA: raises $1 to $2
qsObMEIlRO22OlS867m/lw: raises $3 to $5
GisIe1kcC9q/xV6ifsTjgA: calls $3
*** FLOP *** [8s 9h 9d]
GisIe1kcC9q/xV6ifsTjgA: checks
qsObMEIlRO22OlS867m/lw: bets $3
GisIe1kcC9q/xV6ifsTjgA: calls $3
*** TURN *** [8s 9h 9d] [2s]
GisIe1kcC9q/xV6ifsTjgA: checks
qsObMEIlRO22OlS867m/lw: checks
*** RIVER *** [8s 9h 9d 2s] [7c]
GisIe1kcC9q/xV6ifsTjgA: checks
qsObMEIlRO22OlS867m/lw: checks
*** SHOW DOWN ***
GisIe1kcC9q/xV6ifsTjgA: shows [6c 7h] (two pair, Nines and Sevens)
qsObMEIlRO22OlS867m/lw: mucks hand
GisIe1kcC9q/xV6ifsTjgA collected $15.25 from pot
*** SUMMARY ***
Total pot $16 | Rake $0.75
Board [8s 9h 9d 2s 7c]
Seat 1: GisIe1kcC9q/xV6ifsTjgA (small blind) showed [6c 7h] and won ($15.25) with two pair, Nines and Sevens
Seat 2: qsObMEIlRO22OlS867m/lw (big blind) mucked
Seat 3: TPZ+m9x+lwoKpv7TMfAUWA folded before Flop (didn't bet)
Seat 5: OGMLOcTNYZXZU81au7ztUw folded before Flop (didn't bet)
Seat 6: XUk5GQsfNFpHvaToDZ0rZA (button) folded before Flop (didn't bet)



PokerStars Game #59938627540:  Hold'em No Limit ($0.50/$1.00) - 2009/07/01 0:19:34 ET
Table 'aWHveb63HkbTmOGHOxjBkQ' 2-max Seat #2 is the button
Seat 1: xy2MQKoHoCZZIudmw8Xbow ($201.70 in chips)
Seat 2: xstEKavv3YDxpUnU4e9qAQ ($173.10 in chips)
xstEKavv3YDxpUnU4e9qAQ: posts small blind $0.50
xy2MQKoHoCZZIudmw8Xbow: posts big blind $1
*** HOLE CARDS ***
xstEKavv3YDxpUnU4e9qAQ: folds
xy2MQKoHoCZZIudmw8Xbow collected $1 from pot
xy2MQKoHoCZZIudmw8Xbow: doesn't show hand
*** SUMMARY ***
Total pot $1 | Rake $0
Seat 1: xy2MQKoHoCZZIudmw8Xbow (big blind) collected ($1)
Seat 2: xstEKavv3YDxpUnU4e9qAQ (button) (small blind) folded before Flop



PokerStars Game #59938628192:  Hold'em No Limit ($0.50/$1.00) - 2009/07/01 0:19:34 ET
Table 'cBDNutyLBKEk9+ptwsKmTw' 6-max Seat #4 is the button
Seat 1: tb0dt30qP2x/8f+Xta4mVg ($23.95 in chips)
Seat 2: KyaE4+hWgUNIWWOWy4D14w ($63.30 in chips)
Seat 3: G5ZSSN6RSON3gkNvk/SmYg ($107.40 in chips)
Seat 4: 0WjiuIT7/EolY1oOx1ngeA ($106.15 in chips)
Seat 5: OGMLOcTNYZXZU81au7ztUw ($105.75 in chips)
Seat 6: pyzhFUPPSNzrysiMqlA5Xw ($12.75 in chips)
OGMLOcTNYZXZU81au7ztUw: posts small blind $0.50
pyzhFUPPSNzrysiMqlA5Xw: posts big blind $1
*** HOLE CARDS ***
tb0dt30qP2x/8f+Xta4mVg: folds
KyaE4+hWgUNIWWOWy4D14w: folds
G5ZSSN6RSON3gkNvk/SmYg: folds
0WjiuIT7/EolY1oOx1ngeA: raises $2 to $3
OGMLOcTNYZXZU81au7ztUw: folds
pyzhFUPPSNzrysiMqlA5Xw: folds
0WjiuIT7/EolY1oOx1ngeA collected $2.50 from pot
0WjiuIT7/EolY1oOx1ngeA: doesn't show hand
*** SUMMARY ***
Total pot $2.50 | Rake $0
Seat 1: tb0dt30qP2x/8f+Xta4mVg folded before Flop (didn't bet)
Seat 2: KyaE4+hWgUNIWWOWy4D14w folded before Flop (didn't bet)
Seat 3: G5ZSSN6RSON3gkNvk/SmYg folded before Flop (didn't bet)
Seat 4: 0WjiuIT7/EolY1oOx1ngeA (button) collected ($2.50)
Seat 5: OGMLOcTNYZXZU81au7ztUw (small blind) folded before Flop
Seat 6: pyzhFUPPSNzrysiMqlA5Xw (big blind) folded before Flop



PokerStars Game #59938629372:  Hold'em No Limit ($0.50/$1.00) - 2009/07/01 0:19:36 ET
Table 'tyUh+jyNvrceIQdKMJjQ2wZFWj23PMihdwrNWv41OG/Qeat #3 is the button
Seat 1: o8A5MUdudVKu+pAwgZOX2w ($198.90 in chips)
Seat 2: 6iVcnPw9a2oNG6sPQo3G6g ($98.75 in chips)
Seat 3: L9qfLYXrczhAPd/VckgsWw ($36.40 in chips)
Seat 5: j7NIOHLZk7V2o9fOioO5ug ($103.60 in chips)
Seat 6: YsLQ3BAvgQHWXMAv3Wv6Hg ($106.75 in chips)
j7NIOHLZk7V2o9fOioO5ug: posts small blind $0.50
YsLQ3BAvgQHWXMAv3Wv6Hg: posts big blind $1
*** HOLE CARDS ***
o8A5MUdudVKu+pAwgZOX2w: calls $1
6iVcnPw9a2oNG6sPQo3G6g: folds
L9qfLYXrczhAPd/VckgsWw: calls $1
j7NIOHLZk7V2o9fOioO5ug: folds
YsLQ3BAvgQHWXMAv3Wv6Hg: checks
*** FLOP *** [6d Jh Kh]
YsLQ3BAvgQHWXMAv3Wv6Hg: checks
o8A5MUdudVKu+pAwgZOX2w: checks
L9qfLYXrczhAPd/VckgsWw: checks
*** TURN *** [6d Jh Kh] [2d]
YsLQ3BAvgQHWXMAv3Wv6Hg: checks
o8A5MUdudVKu+pAwgZOX2w: bets $4
L9qfLYXrczhAPd/VckgsWw: folds
YsLQ3BAvgQHWXMAv3Wv6Hg: folds
o8A5MUdudVKu+pAwgZOX2w collected $3.35 from pot
o8A5MUdudVKu+pAwgZOX2w: doesn't show hand
*** SUMMARY ***
Total pot $3.50 | Rake $0.15
Board [6d Jh Kh 2d]
Seat 1: o8A5MUdudVKu+pAwgZOX2w collected ($3.35)
Seat 2: 6iVcnPw9a2oNG6sPQo3G6g folded before Flop (didn't bet)
Seat 3: L9qfLYXrczhAPd/VckgsWw (button) folded on the Turn
Seat 5: j7NIOHLZk7V2o9fOioO5ug (small blind) folded before Flop
Seat 6: YsLQ3BAvgQHWXMAv3Wv6Hg (big blind) folded on the Turn



PokerStars Game #59938630520:  Hold'em No Limit ($0.50/$1.00) - 2009/07/01 0:19:38 ET
Table '/+ni2d7lj6E90JmAQZKSOw' 2-max Seat #2 is the button
Seat 1: qubgcbkrXfMjdrMEd1lYMQ ($261.70 in chips)
Seat 2: IJu7Boitu3yAxp4hjIx6zQ ($108.90 in chips)
IJu7Boitu3yAxp4hjIx6zQ: posts small blind $0.50
qubgcbkrXfMjdrMEd1lYMQ: posts big blind $1
*** HOLE CARDS ***
IJu7Boitu3yAxp4hjIx6zQ: folds
qubgcbkrXfMjdrMEd1lYMQ collected $1 from pot
qubgcbkrXfMjdrMEd1lYMQ: doesn't show hand
*** SUMMARY ***
Total pot $1 | Rake $0
Seat 1: qubgcbkrXfMjdrMEd1lYMQ (big blind) collected ($1)
Seat 2: IJu7Boitu3yAxp4hjIx6zQ (button) (small blind) folded before Flop



PokerStars Game #59938631406:  Hold'em No Limit ($0.50/$1.00) - 2009/07/01 0:19:39 ET
Table 'aWHveb63HkbTmOGHOxjBkQ' 2-max Seat #1 is the button
Seat 1: xy2MQKoHoCZZIudmw8Xbow ($202.20 in chips)
Seat 2: xstEKavv3YDxpUnU4e9qAQ ($172.60 in chips)
xy2MQKoHoCZZIudmw8Xbow: posts small blind $0.50
xstEKavv3YDxpUnU4e9qAQ: posts big blind $1
*** HOLE CARDS ***
xy2MQKoHoCZZIudmw8Xbow: raises $3 to $4
xstEKavv3YDxpUnU4e9qAQ: folds
xy2MQKoHoCZZIudmw8Xbow collected $2 from pot
xy2MQKoHoCZZIudmw8Xbow: doesn't show hand
*** SUMMARY ***
Total pot $2 | Rake $0
Seat 1: xy2MQKoHoCZZIudmw8Xbow (button) (small blind) collected ($2)
Seat 2: xstEKavv3YDxpUnU4e9qAQ (big blind) folded before Flop



PokerStars Game #59938631662:  Hold'em No Limit ($0.50/$1.00) - 2009/07/01 0:19:39 ET
Table '3T4owEKJKyGTMePwrv50FQ' 9-max Seat #3 is the button
Seat 1: i7H4OcR0JBHUDu6bJ34rtw ($72.40 in chips)
Seat 2: p5UKaxVobvptF0ANhR/q1A ($106.65 in chips)
Seat 3: pCl9IYtMJjmAJCt7Pu4TDw ($42.45 in chips)
Seat 4: 3MYLdqcdtveb3nHZv3D1IA ($9 in chips)
Seat 5: ArTa9sSTrL++oHeXU/9PPA ($49.60 in chips)
Seat 7: brpN3NxzKqwZCeb5s2Nq4g ($40.05 in chips)
Seat 8: negfosHnGOZXSHpWDRKyBQ ($18.50 in chips)
Seat 9: vR4IO10geOgvTW+LAUBv/A ($125 in chips)
3MYLdqcdtveb3nHZv3D1IA: posts small blind $0.50
ArTa9sSTrL++oHeXU/9PPA: posts big blind $1
*** HOLE CARDS ***
brpN3NxzKqwZCeb5s2Nq4g: folds
negfosHnGOZXSHpWDRKyBQ: folds
vR4IO10geOgvTW+LAUBv/A: folds
i7H4OcR0JBHUDu6bJ34rtw: folds
p5UKaxVobvptF0ANhR/q1A: raises $2 to $3
pCl9IYtMJjmAJCt7Pu4TDw: folds
3MYLdqcdtveb3nHZv3D1IA: raises $6 to $9 and is all-in
ArTa9sSTrL++oHeXU/9PPA: calls $8
p5UKaxVobvptF0ANhR/q1A: calls $6
*** FLOP *** [Qd 8h 3s]
ArTa9sSTrL++oHeXU/9PPA: checks
p5UKaxVobvptF0ANhR/q1A: bets $15
ArTa9sSTrL++oHeXU/9PPA: folds
*** TURN *** [Qd 8h 3s] [Qh]
*** RIVER *** [Qd 8h 3s Qh] [Td]
*** SHOW DOWN ***
3MYLdqcdtveb3nHZv3D1IA: shows [Kh Ac] (a pair of Queens)
p5UKaxVobvptF0ANhR/q1A: shows [7c 7s] (two pair, Queens and Sevens)
p5UKaxVobvptF0ANhR/q1A collected $25.65 from pot
*** SUMMARY ***
Total pot $27 | Rake $1.35
Board [Qd 8h 3s Qh Td]
Seat 1: i7H4OcR0JBHUDu6bJ34rtw folded before Flop (didn't bet)
Seat 2: p5UKaxVobvptF0ANhR/q1A showed [7c 7s] and won ($25.65) with two pair, Queens and Sevens
Seat 3: pCl9IYtMJjmAJCt7Pu4TDw (button) folded before Flop (didn't bet)
Seat 4: 3MYLdqcdtveb3nHZv3D1IA (small blind) showed [Kh Ac] and lost with a pair of Queens
Seat 5: ArTa9sSTrL++oHeXU/9PPA (big blind) folded on the Flop
Seat 7: brpN3NxzKqwZCeb5s2Nq4g folded before Flop (didn't bet)
Seat 8: negfosHnGOZXSHpWDRKyBQ folded before Flop (didn't bet)
Seat 9: vR4IO10geOgvTW+LAUBv/A folded before Flop (didn't bet)



PokerStars Game #59938631706:  Hold'em No Limit ($0.50/$1.00) - 2009/07/01 0:19:39 ET
Table 'tJq9SfN1ywY0r03VBlWlwQ' 9-max Seat #3 is the button
Seat 1: wZsU+w9r7G66x93UuvBf1Q ($329.05 in chips)
Seat 2: RqkO8O/Y3qlc3PIuCAHjVg ($76.40 in chips)
Seat 3: FVs16t7GgfWgQWt4JxsObQ ($26.55 in chips)
Seat 4: zBHLwg+HmbHmRtVQMhavjA ($97 in chips)
Seat 5: Ogn4JDV3mp4ZDKO49IFzKA ($20 in chips)
Seat 6: gUUvmqdVlmvpal6B8nYrmg ($100.80 in chips)
Seat 8: G4DEhsZFmznGNVpy2SEocA ($23.50 in chips)
Seat 9: XE5QF1y74bpHog9JxWJMWQ ($101.50 in chips)
zBHLwg+HmbHmRtVQMhavjA: posts small blind $0.50
Ogn4JDV3mp4ZDKO49IFzKA: posts big blind $1
qVhRZ0PLZ95XRJHWAjXjOQ: sits out
*** HOLE CARDS ***
gUUvmqdVlmvpal6B8nYrmg: folds
G4DEhsZFmznGNVpy2SEocA: folds
XE5QF1y74bpHog9JxWJMWQ: folds
XE5QF1y74bpHog9JxWJMWQ is sitting out
wZsU+w9r7G66x93UuvBf1Q: folds
RqkO8O/Y3qlc3PIuCAHjVg: folds
FVs16t7GgfWgQWt4JxsObQ: calls $1
zBHLwg+HmbHmRtVQMhavjA: raises $3 to $4
Ogn4JDV3mp4ZDKO49IFzKA: folds
FVs16t7GgfWgQWt4JxsObQ: calls $3
*** FLOP *** [3d 8c 7c]
zBHLwg+HmbHmRtVQMhavjA: bets $6
FVs16t7GgfWgQWt4JxsObQ: calls $6
*** TURN *** [3d 8c 7c] [5s]
zBHLwg+HmbHmRtVQMhavjA: bets $17
FVs16t7GgfWgQWt4JxsObQ: calls $16.55 and is all-in
*** RIVER *** [3d 8c 7c 5s] [Jd]
*** SHOW DOWN ***
zBHLwg+HmbHmRtVQMhavjA: shows [Kd Kc] (a pair of Kings)
FVs16t7GgfWgQWt4JxsObQ: shows [9d 6d] (a straight, Five to Nine)
FVs16t7GgfWgQWt4JxsObQ collected $51.45 from pot
*** SUMMARY ***
Total pot $54.10 | Rake $2.65
Board [3d 8c 7c 5s Jd]
Seat 1: wZsU+w9r7G66x93UuvBf1Q folded before Flop (didn't bet)
Seat 2: RqkO8O/Y3qlc3PIuCAHjVg folded before Flop (didn't bet)
Seat 3: FVs16t7GgfWgQWt4JxsObQ (button) showed [9d 6d] and won ($51.45) with a straight, Five to Nine
Seat 4: zBHLwg+HmbHmRtVQMhavjA (small blind) showed [Kd Kc] and lost with a pair of Kings
Seat 5: Ogn4JDV3mp4ZDKO49IFzKA (big blind) folded before Flop
Seat 6: gUUvmqdVlmvpal6B8nYrmg folded before Flop (didn't bet)
Seat 8: G4DEhsZFmznGNVpy2SEocA folded before Flop (didn't bet)
Seat 9: XE5QF1y74bpHog9JxWJMWQ folded before Flop (didn't bet)



PokerStars Game #59938632796:  Hold'em No Limit ($0.50/$1.00) - 2009/07/01 0:19:41 ET
Table '/RZcOwpZpHQ+OwPwjsbnRw' 6-max Seat #4 is the button
Seat 1: jMljU/dOPMXfJi8OmbdYdw ($50.65 in chips)
Seat 2: dHC9PH9hdH3Ad2TD8ZxX0Q ($50.10 in chips)
Seat 3: OigyyiK+tTj1APPIAUmXDA ($80.60 in chips)
Seat 4: j7NIOHLZk7V2o9fOioO5ug ($100 in chips)
Seat 5: wx3sQGkVi2x9wJXuWNHPBw ($208.55 in chips)
Seat 6: XOIf9W+VAxhZqN+SYoyMKA ($151.40 in chips)
wx3sQGkVi2x9wJXuWNHPBw: posts small blind $0.50
XOIf9W+VAxhZqN+SYoyMKA: posts big blind $1
*** HOLE CARDS ***
jMljU/dOPMXfJi8OmbdYdw: raises $2 to $3
dHC9PH9hdH3Ad2TD8ZxX0Q: calls $3
OigyyiK+tTj1APPIAUmXDA: folds
j7NIOHLZk7V2o9fOioO5ug: calls $3
wx3sQGkVi2x9wJXuWNHPBw: folds
XOIf9W+VAxhZqN+SYoyMKA: calls $2
*** FLOP *** [3c 9s 7h]
XOIf9W+VAxhZqN+SYoyMKA: checks
jMljU/dOPMXfJi8OmbdYdw: checks
dHC9PH9hdH3Ad2TD8ZxX0Q: checks
j7NIOHLZk7V2o9fOioO5ug: bets $8
XOIf9W+VAxhZqN+SYoyMKA: folds
jMljU/dOPMXfJi8OmbdYdw: folds
dHC9PH9hdH3Ad2TD8ZxX0Q: folds
j7NIOHLZk7V2o9fOioO5ug collected $11.90 from pot
j7NIOHLZk7V2o9fOioO5ug: doesn't show hand
*** SUMMARY ***
Total pot $12.50 | Rake $0.60
Board [3c 9s 7h]
Seat 1: jMljU/dOPMXfJi8OmbdYdw folded on the Flop
Seat 2: dHC9PH9hdH3Ad2TD8ZxX0Q folded on the Flop
Seat 3: OigyyiK+tTj1APPIAUmXDA folded before Flop (didn't bet)
Seat 4: j7NIOHLZk7V2o9fOioO5ug (button) collected ($11.90)
Seat 5: wx3sQGkVi2x9wJXuWNHPBw (small blind) folded before Flop
Seat 6: XOIf9W+VAxhZqN+SYoyMKA (big blind) folded on the Flop



PokerStars Game #59938634146:  Hold'em No Limit ($0.50/$1.00) - 2009/07/01 0:19:43 ET
Table 'W/wyObTiXZm+Ckkl3YxcSw' 6-max Seat #6 is the button
Seat 1: ssLJburtEIqnVkx6X8R1uw ($119.85 in chips)
Seat 2: o2BpeCDF/L1yw7HKjemvYg ($25.80 in chips)
Seat 3: b2a+5TkFf4xJN/Ihhma58Q ($39.20 in chips)
Seat 4: BdbmJTZZ47quA9vUWwXtlw ($51.60 in chips)
Seat 5: Wko+clJG9HZPPQ7Yn0Y5Zg ($24 in chips)
Seat 6: GwvR1vWAchnuOBZu0dm5Rg ($88.25 in chips)
ssLJburtEIqnVkx6X8R1uw: posts small blind $0.50
o2BpeCDF/L1yw7HKjemvYg: posts big blind $1
*** HOLE CARDS ***
b2a+5TkFf4xJN/Ihhma58Q: folds
BdbmJTZZ47quA9vUWwXtlw: folds
Wko+clJG9HZPPQ7Yn0Y5Zg: folds
GwvR1vWAchnuOBZu0dm5Rg: calls $1
ssLJburtEIqnVkx6X8R1uw: calls $0.50
o2BpeCDF/L1yw7HKjemvYg: raises $3 to $4
GwvR1vWAchnuOBZu0dm5Rg: calls $3
ssLJburtEIqnVkx6X8R1uw: folds
*** FLOP *** [Jh 3s 9s]
o2BpeCDF/L1yw7HKjemvYg: bets $3
GwvR1vWAchnuOBZu0dm5Rg: raises $3 to $6
o2BpeCDF/L1yw7HKjemvYg: calls $3
*** TURN *** [Jh 3s 9s] [9c]
o2BpeCDF/L1yw7HKjemvYg: checks
GwvR1vWAchnuOBZu0dm5Rg: checks
*** RIVER *** [Jh 3s 9s 9c] [Qs]
o2BpeCDF/L1yw7HKjemvYg: bets $15.80 and is all-in
GwvR1vWAchnuOBZu0dm5Rg: calls $15.80
*** SHOW DOWN ***
o2BpeCDF/L1yw7HKjemvYg: shows [As Kc] (a pair of Nines)
GwvR1vWAchnuOBZu0dm5Rg: shows [Ts 8s] (a flush, Queen high)
GwvR1vWAchnuOBZu0dm5Rg collected $50.05 from pot
*** SUMMARY ***
Total pot $52.60 | Rake $2.55
Board [Jh 3s 9s 9c Qs]
Seat 1: ssLJburtEIqnVkx6X8R1uw (small blind) folded before Flop
Seat 2: o2BpeCDF/L1yw7HKjemvYg (big blind) showed [As Kc] and lost with a pair of Nines
Seat 3: b2a+5TkFf4xJN/Ihhma58Q folded before Flop (didn't bet)
Seat 4: BdbmJTZZ47quA9vUWwXtlw folded before Flop (didn't bet)
Seat 5: Wko+clJG9HZPPQ7Yn0Y5Zg folded before Flop (didn't bet)
Seat 6: GwvR1vWAchnuOBZu0dm5Rg (button) showed [Ts 8s] and won ($50.05) with a flush, Queen high



PokerStars Game #59938635566:  Hold'em No Limit ($0.50/$1.00) - 2009/07/01 0:19:45 ET
Table '/+ni2d7lj6E90JmAQZKSOw' 2-max Seat #1 is the button
Seat 1: qubgcbkrXfMjdrMEd1lYMQ ($262.20 in chips)
Seat 2: IJu7Boitu3yAxp4hjIx6zQ ($108.40 in chips)
qubgcbkrXfMjdrMEd1lYMQ: posts small blind $0.50
IJu7Boitu3yAxp4hjIx6zQ: posts big blind $1
*** HOLE CARDS ***
qubgcbkrXfMjdrMEd1lYMQ: raises $2 to $3
IJu7Boitu3yAxp4hjIx6zQ: folds
qubgcbkrXfMjdrMEd1lYMQ collected $2 from pot
qubgcbkrXfMjdrMEd1lYMQ: doesn't show hand
*** SUMMARY ***
Total pot $2 | Rake $0
Seat 1: qubgcbkrXfMjdrMEd1lYMQ (button) (small blind) collected ($2)
Seat 2: IJu7Boitu3yAxp4hjIx6zQ (big blind) folded before Flop



PokerStars Game #59938635722:  Hold'em No Limit ($0.50/$1.00) - 2009/07/01 0:19:45 ET
Table 'aWHveb63HkbTmOGHOxjBkQ' 2-max Seat #2 is the button
Seat 1: xy2MQKoHoCZZIudmw8Xbow ($203.20 in chips)
Seat 2: xstEKavv3YDxpUnU4e9qAQ ($171.60 in chips)
xstEKavv3YDxpUnU4e9qAQ: posts small blind $0.50
xy2MQKoHoCZZIudmw8Xbow: posts big blind $1
*** HOLE CARDS ***
xstEKavv3YDxpUnU4e9qAQ: raises $3 to $4
xy2MQKoHoCZZIudmw8Xbow: folds
xstEKavv3YDxpUnU4e9qAQ collected $2 from pot
*** SUMMARY ***
Total pot $2 | Rake $0
Seat 1: xy2MQKoHoCZZIudmw8Xbow (big blind) folded before Flop
Seat 2: xstEKavv3YDxpUnU4e9qAQ (button) (small blind) collected ($2)



PokerStars Game #59938635438:  Hold'em No Limit ($0.50/$1.00) - 2009/07/01 0:19:45 ET
Table 'cKH9c4x6u79IqCdaKKvXrw' 9-max Seat #2 is the button
Seat 1: p1SafS90nb3Uft5LB0NkHw ($20 in chips)
Seat 2: knewtTmBc4Tc0z/5tAABYQ ($196.50 in chips)
Seat 4: FL3MrLspcF23LYvC4ipBOA ($100 in chips)
Seat 5: negfosHnGOZXSHpWDRKyBQ ($27.80 in chips)
Seat 6: Bsd/K5gAcLanYbGiPirRjw ($169.25 in chips)
Seat 7: 0eFnow7+D7veCYQ+CG9FFw ($94.35 in chips)
Seat 8: 4/8w7g4QE6v0i1tIIf/1HQ ($57 in chips)
FL3MrLspcF23LYvC4ipBOA: posts small blind $0.50
negfosHnGOZXSHpWDRKyBQ: posts big blind $1
*** HOLE CARDS ***
Bsd/K5gAcLanYbGiPirRjw: folds
0eFnow7+D7veCYQ+CG9FFw: folds
4/8w7g4QE6v0i1tIIf/1HQ: calls $1
p1SafS90nb3Uft5LB0NkHw: folds
knewtTmBc4Tc0z/5tAABYQ: folds
FL3MrLspcF23LYvC4ipBOA: folds
negfosHnGOZXSHpWDRKyBQ: checks
*** FLOP *** [7c 2s Jd]
negfosHnGOZXSHpWDRKyBQ: checks
4/8w7g4QE6v0i1tIIf/1HQ: checks
*** TURN *** [7c 2s Jd] [4s]
negfosHnGOZXSHpWDRKyBQ: checks
ezwei joins the table at seat #3
4/8w7g4QE6v0i1tIIf/1HQ: checks
*** RIVER *** [7c 2s Jd 4s] [Ad]
negfosHnGOZXSHpWDRKyBQ: checks
4/8w7g4QE6v0i1tIIf/1HQ: checks
*** SHOW DOWN ***
negfosHnGOZXSHpWDRKyBQ: shows [4d 8h] (a pair of Fours)
4/8w7g4QE6v0i1tIIf/1HQ: mucks hand
negfosHnGOZXSHpWDRKyBQ collected $2.40 from pot
*** SUMMARY ***
Total pot $2.50 | Rake $0.10
Board [7c 2s Jd 4s Ad]
Seat 1: p1SafS90nb3Uft5LB0NkHw folded before Flop (didn't bet)
Seat 2: knewtTmBc4Tc0z/5tAABYQ (button) folded before Flop (didn't bet)
Seat 4: FL3MrLspcF23LYvC4ipBOA (small blind) folded before Flop
Seat 5: negfosHnGOZXSHpWDRKyBQ (big blind) showed [4d 8h] and won ($2.40) with a pair of Fours
Seat 6: Bsd/K5gAcLanYbGiPirRjw folded before Flop (didn't bet)
Seat 7: 0eFnow7+D7veCYQ+CG9FFw folded before Flop (didn't bet)
Seat 8: 4/8w7g4QE6v0i1tIIf/1HQ mucked



PokerStars Game #59938638006:  Hold'em No Limit ($0.50/$1.00) - 2009/07/01 0:19:49 ET
Table 'hugOjcwJvzEwZbK7tyiWuQ' 9-max Seat #4 is the button
Seat 1: N9n5Wc3s35DpCrOAUUNAaQ ($127.85 in chips)
Seat 2: r27C1nIV4NS4+qbnrgBQSw ($257.05 in chips)
Seat 3: jDwhY1kCdc6EkAHbT7PJMQ ($106.55 in chips)
Seat 4: UWB3oeddt/GObx2Mix2Anw ($195.20 in chips)
Seat 6: gUUvmqdVlmvpal6B8nYrmg ($100 in chips)
Seat 7: FL3MrLspcF23LYvC4ipBOA ($100 in chips)
Seat 8: /zy+DB4S5fUQUSfZWFzYGw ($115.75 in chips)
Seat 9: o6JyUkbzCDw8tUabqtmnlg ($57 in chips)
5BRGWf+R3nt2WS3b5xX+zA: is sitting out
gUUvmqdVlmvpal6B8nYrmg: posts small blind $0.50
FL3MrLspcF23LYvC4ipBOA: posts big blind $1
*** HOLE CARDS ***
/zy+DB4S5fUQUSfZWFzYGw: folds
o6JyUkbzCDw8tUabqtmnlg: raises $3 to $4
N9n5Wc3s35DpCrOAUUNAaQ: folds
r27C1nIV4NS4+qbnrgBQSw: folds
jDwhY1kCdc6EkAHbT7PJMQ: folds
UWB3oeddt/GObx2Mix2Anw: folds
gUUvmqdVlmvpal6B8nYrmg: folds
FL3MrLspcF23LYvC4ipBOA: calls $3
*** FLOP *** [Ks 2h 7s]
FL3MrLspcF23LYvC4ipBOA: checks
o6JyUkbzCDw8tUabqtmnlg: bets $5
FL3MrLspcF23LYvC4ipBOA: folds
o6JyUkbzCDw8tUabqtmnlg collected $8.10 from pot
*** SUMMARY ***
Total pot $8.50 | Rake $0.40
Board [Ks 2h 7s]
Seat 1: N9n5Wc3s35DpCrOAUUNAaQ folded before Flop (didn't bet)
Seat 2: r27C1nIV4NS4+qbnrgBQSw folded before Flop (didn't bet)
Seat 3: jDwhY1kCdc6EkAHbT7PJMQ folded before Flop (didn't bet)
Seat 4: UWB3oeddt/GObx2Mix2Anw (button) folded before Flop (didn't bet)
Seat 6: gUUvmqdVlmvpal6B8nYrmg (small blind) folded before Flop
Seat 7: FL3MrLspcF23LYvC4ipBOA (big blind) folded on the Flop
Seat 8: /zy+DB4S5fUQUSfZWFzYGw folded before Flop (didn't bet)
Seat 9: o6JyUkbzCDw8tUabqtmnlg collected ($8.10)



PokerStars Game #59938639882:  Hold'em No Limit ($0.50/$1.00) - 2009/07/01 0:19:51 ET
Table 'eU3bWpDDg3Z+9R4m4iVmog' 6-max Seat #6 is the button
Seat 2: 8CAoOzhmB8n3nRFf3V4BTg ($178.45 in chips)
Seat 3: U6tnjwZRpTnM+YkqkCjwyQ ($121.65 in chips)
Seat 4: GDVIsbEJ/DOJsMKE4Asz0A ($94.45 in chips)
Seat 5: QHvTZcrKe6+maWUfVjP29Q ($102 in chips)
Seat 6: hpxXcmRkXXI9HE5+5/j/0Q ($100 in chips)
8CAoOzhmB8n3nRFf3V4BTg: posts small blind $0.50
U6tnjwZRpTnM+YkqkCjwyQ: posts big blind $1
*** HOLE CARDS ***
GDVIsbEJ/DOJsMKE4Asz0A: folds
QHvTZcrKe6+maWUfVjP29Q: raises $2.50 to $3.50
hpxXcmRkXXI9HE5+5/j/0Q: folds
8CAoOzhmB8n3nRFf3V4BTg: folds
U6tnjwZRpTnM+YkqkCjwyQ: folds
QHvTZcrKe6+maWUfVjP29Q collected $2.50 from pot
QHvTZcrKe6+maWUfVjP29Q: doesn't show hand
*** SUMMARY ***
Total pot $2.50 | Rake $0
Seat 2: 8CAoOzhmB8n3nRFf3V4BTg (small blind) folded before Flop
Seat 3: U6tnjwZRpTnM+YkqkCjwyQ (big blind) folded before Flop
Seat 4: GDVIsbEJ/DOJsMKE4Asz0A folded before Flop (didn't bet)
Seat 5: QHvTZcrKe6+maWUfVjP29Q collected ($2.50)
Seat 6: hpxXcmRkXXI9HE5+5/j/0Q (button) folded before Flop (didn't bet)



PokerStars Game #59938639692:  Hold'em No Limit ($0.50/$1.00) - 2009/07/01 0:19:51 ET
Table '+cA8mcmhaedZ7YcrDdhmeQ' 6-max Seat #1 is the button
Seat 1: lsLuWlcPA3Rh7kJVLzMh0Q ($233 in chips)
Seat 2: trnpu4tPju3BU8W0wQQaiQ ($100.10 in chips)
Seat 3: 0WjiuIT7/EolY1oOx1ngeA ($142.80 in chips)
Seat 4: j0aDOn9Nft1HLTQvGu1UwA ($18.50 in chips)
Seat 5: 6WyjEXOToimYmtLdqIgHYQ ($62 in chips)
Seat 6: YfsTQsY/fxb+YqbdclTHuw ($86.65 in chips)
trnpu4tPju3BU8W0wQQaiQ: posts small blind $0.50
0WjiuIT7/EolY1oOx1ngeA: posts big blind $1
*** HOLE CARDS ***
j0aDOn9Nft1HLTQvGu1UwA: calls $1
6WyjEXOToimYmtLdqIgHYQ: folds
YfsTQsY/fxb+YqbdclTHuw: folds
lsLuWlcPA3Rh7kJVLzMh0Q: folds
trnpu4tPju3BU8W0wQQaiQ: calls $0.50
0WjiuIT7/EolY1oOx1ngeA: checks
*** FLOP *** [8c 2s 7s]
trnpu4tPju3BU8W0wQQaiQ: checks
0WjiuIT7/EolY1oOx1ngeA: checks
j0aDOn9Nft1HLTQvGu1UwA: checks
*** TURN *** [8c 2s 7s] [Qc]
trnpu4tPju3BU8W0wQQaiQ: bets $3
0WjiuIT7/EolY1oOx1ngeA: folds
j0aDOn9Nft1HLTQvGu1UwA: raises $3 to $6
trnpu4tPju3BU8W0wQQaiQ: folds
j0aDOn9Nft1HLTQvGu1UwA collected $8.60 from pot
*** SUMMARY ***
Total pot $9 | Rake $0.40
Board [8c 2s 7s Qc]
Seat 1: lsLuWlcPA3Rh7kJVLzMh0Q (button) folded before Flop (didn't bet)
Seat 2: trnpu4tPju3BU8W0wQQaiQ (small blind) folded on the Turn
Seat 3: 0WjiuIT7/EolY1oOx1ngeA (big blind) folded on the Turn
Seat 4: j0aDOn9Nft1HLTQvGu1UwA collected ($8.60)
Seat 5: 6WyjEXOToimYmtLdqIgHYQ folded before Flop (didn't bet)
Seat 6: YfsTQsY/fxb+YqbdclTHuw folded before Flop (didn't bet)



PokerStars Game #59938639794:  Hold'em No Limit ($0.50/$1.00) - 2009/07/01 0:19:51 ET
Table 'U9zqzC8f3oTJ2ShXFgSSOA' 6-max Seat #1 is the button
Seat 1: tS9JHB1h+FQ++qu8RwRNgg ($17.95 in chips)
Seat 2: U2CWBTv29qdCbj8RNF2sIw ($110.80 in chips)
Seat 3: yfXek8iJ7O4CFyqXrtGcfg ($41.50 in chips)
Seat 4: 33q95we0Etwgrm6guQGncw ($76.40 in chips)
Seat 5: KfwW5us6tydK81NYTtK1gw ($194.75 in chips)
Seat 6: aIxzFKdtpDSkUePKZy/niQ ($58.50 in chips)
U2CWBTv29qdCbj8RNF2sIw: posts small blind $0.50
yfXek8iJ7O4CFyqXrtGcfg: posts big blind $1
*** HOLE CARDS ***
33q95we0Etwgrm6guQGncw: calls $1
KfwW5us6tydK81NYTtK1gw: folds
aIxzFKdtpDSkUePKZy/niQ: folds
tS9JHB1h+FQ++qu8RwRNgg: folds
U2CWBTv29qdCbj8RNF2sIw: folds
yfXek8iJ7O4CFyqXrtGcfg: raises $4 to $5
33q95we0Etwgrm6guQGncw: folds
yfXek8iJ7O4CFyqXrtGcfg collected $2.50 from pot
*** SUMMARY ***
Total pot $2.50 | Rake $0
Seat 1: tS9JHB1h+FQ++qu8RwRNgg (button) folded before Flop (didn't bet)
Seat 2: U2CWBTv29qdCbj8RNF2sIw (small blind) folded before Flop
Seat 3: yfXek8iJ7O4CFyqXrtGcfg (big blind) collected ($2.50)
Seat 4: 33q95we0Etwgrm6guQGncw folded before Flop
Seat 5: KfwW5us6tydK81NYTtK1gw folded before Flop (didn't bet)
Seat 6: aIxzFKdtpDSkUePKZy/niQ folded before Flop (didn't bet)



PokerStars Game #59938640244:  Hold'em No Limit ($0.50/$1.00) - 2009/07/01 0:19:52 ET
Table 'QSIig7BLMc9wY/rgBechzw' 6-max Seat #2 is the button
Seat 1: uuA9hpFU17U5/t4cvpbpBg ($44.25 in chips)
Seat 2: 0WjiuIT7/EolY1oOx1ngeA ($112.50 in chips)
Seat 3: +W6OnF033KNM2xH0fGj98Q ($107.70 in chips)
Seat 4: +uSzP8Jwnw7sKfQ4s66b7w ($50 in chips)
Seat 5: 1yB1nHUkHNNY8OJnDNHZMw ($77.55 in chips)
Seat 6: KpnW5CcJ4Mg6MeclfKmLrw ($144.75 in chips)
+W6OnF033KNM2xH0fGj98Q: posts small blind $0.50
+uSzP8Jwnw7sKfQ4s66b7w: posts big blind $1
uuA9hpFU17U5/t4cvpbpBg: posts small & big blinds $1.50
*** HOLE CARDS ***
1yB1nHUkHNNY8OJnDNHZMw: raises $2 to $3
KpnW5CcJ4Mg6MeclfKmLrw: folds
uuA9hpFU17U5/t4cvpbpBg: calls $2
0WjiuIT7/EolY1oOx1ngeA: calls $3
+W6OnF033KNM2xH0fGj98Q: folds
+uSzP8Jwnw7sKfQ4s66b7w: folds
*** FLOP *** [2h 4c 2s]
1yB1nHUkHNNY8OJnDNHZMw: bets $6
uuA9hpFU17U5/t4cvpbpBg: folds
0WjiuIT7/EolY1oOx1ngeA: raises $10 to $16
1yB1nHUkHNNY8OJnDNHZMw: folds
0WjiuIT7/EolY1oOx1ngeA collected $21.90 from pot
0WjiuIT7/EolY1oOx1ngeA: doesn't show hand
*** SUMMARY ***
Total pot $23 | Rake $1.10
Board [2h 4c 2s]
Seat 1: uuA9hpFU17U5/t4cvpbpBg folded on the Flop
Seat 2: 0WjiuIT7/EolY1oOx1ngeA (button) collected ($21.90)
Seat 3: +W6OnF033KNM2xH0fGj98Q (small blind) folded before Flop
Seat 4: +uSzP8Jwnw7sKfQ4s66b7w (big blind) folded before Flop
Seat 5: 1yB1nHUkHNNY8OJnDNHZMw folded on the Flop
Seat 6: KpnW5CcJ4Mg6MeclfKmLrw folded before Flop (didn't bet)



PokerStars Game #59938640230:  Hold'em No Limit ($0.50/$1.00) - 2009/07/01 0:19:52 ET
Table 'aWHveb63HkbTmOGHOxjBkQ' 2-max Seat #1 is the button
Seat 1: xy2MQKoHoCZZIudmw8Xbow ($202.20 in chips)
Seat 2: xstEKavv3YDxpUnU4e9qAQ ($172.60 in chips)
xy2MQKoHoCZZIudmw8Xbow: posts small blind $0.50
xstEKavv3YDxpUnU4e9qAQ: posts big blind $1
*** HOLE CARDS ***
xy2MQKoHoCZZIudmw8Xbow: raises $3 to $4
xstEKavv3YDxpUnU4e9qAQ: folds
xy2MQKoHoCZZIudmw8Xbow collected $2 from pot
xy2MQKoHoCZZIudmw8Xbow: doesn't show hand
*** SUMMARY ***
Total pot $2 | Rake $0
Seat 1: xy2MQKoHoCZZIudmw8Xbow (button) (small blind) collected ($2)
Seat 2: xstEKavv3YDxpUnU4e9qAQ (big blind) folded before Flop



PokerStars Game #59938640058:  Hold'em No Limit ($0.50/$1.00) - 2009/07/01 0:19:52 ET
Table 'fTlPiCj0utgzC/5io+I7ew' 6-max Seat #2 is the button
Seat 1: YMJG+F++3Aj6P8dAWda5fw ($100 in chips)
Seat 2: +xUCTmR3cU7G239W+vZv6g ($139 in chips)
Seat 4: uJVSceLggtsrJya+WtmUEA ($102.10 in chips)
Seat 5: bFrTkDcWGTxyvNul7GVdYg ($240.50 in chips)
Seat 6: AdLVjddOzm+sRNo1Bc3S6Q ($100 in chips)
Mr. Beat ems was removed from the table for failing to post
uJVSceLggtsrJya+WtmUEA: posts small blind $0.50
bFrTkDcWGTxyvNul7GVdYg: posts big blind $1
*** HOLE CARDS ***
AdLVjddOzm+sRNo1Bc3S6Q: folds
AdLVjddOzm+sRNo1Bc3S6Q leaves the table
YMJG+F++3Aj6P8dAWda5fw: folds
+xUCTmR3cU7G239W+vZv6g: raises $2 to $3
uJVSceLggtsrJya+WtmUEA: folds
bFrTkDcWGTxyvNul7GVdYg: folds
+xUCTmR3cU7G239W+vZv6g collected $2.50 from pot
+xUCTmR3cU7G239W+vZv6g: doesn't show hand
*** SUMMARY ***
Total pot $2.50 | Rake $0
Seat 1: YMJG+F++3Aj6P8dAWda5fw folded before Flop (didn't bet)
Seat 2: +xUCTmR3cU7G239W+vZv6g (button) collected ($2.50)
Seat 4: uJVSceLggtsrJya+WtmUEA (small blind) folded before Flop
Seat 5: bFrTkDcWGTxyvNul7GVdYg (big blind) folded before Flop
Seat 6: AdLVjddOzm+sRNo1Bc3S6Q folded before Flop (didn't bet)



PokerStars Game #59938640728:  Hold'em No Limit ($0.50/$1.00) - 2009/07/01 0:19:53 ET
Table 'O96CPOtvMBWP6kzuYDfdFA' 6-max Seat #5 is the button
Seat 1: yl9aRDw7k/ieGiDoJVy+/w ($60.50 in chips)
Seat 2: vTUNrd/7qIOJpW0suEu5hQ ($212.40 in chips)
Seat 5: wRxiu9OJzvvN84OYWW9jxQ ($132.85 in chips)
Seat 6: xNKcQzD9+/iHmtJn4vYq9w ($74.50 in chips)
xNKcQzD9+/iHmtJn4vYq9w: posts small blind $0.50
yl9aRDw7k/ieGiDoJVy+/w: posts big blind $1
V89DGjxE171oPREEbAXiyg: sits out
*** HOLE CARDS ***
vTUNrd/7qIOJpW0suEu5hQ: folds
wRxiu9OJzvvN84OYWW9jxQ: calls $1
xNKcQzD9+/iHmtJn4vYq9w: folds
yl9aRDw7k/ieGiDoJVy+/w: raises $3 to $4
wRxiu9OJzvvN84OYWW9jxQ: calls $3
*** FLOP *** [8c Ks 8h]
yl9aRDw7k/ieGiDoJVy+/w: bets $6
wRxiu9OJzvvN84OYWW9jxQ: folds
yl9aRDw7k/ieGiDoJVy+/w collected $8.10 from pot
yl9aRDw7k/ieGiDoJVy+/w: doesn't show hand
*** SUMMARY ***
Total pot $8.50 | Rake $0.40
Board [8c Ks 8h]
Seat 1: yl9aRDw7k/ieGiDoJVy+/w (big blind) collected ($8.10)
Seat 2: vTUNrd/7qIOJpW0suEu5hQ folded before Flop (didn't bet)
Seat 5: wRxiu9OJzvvN84OYWW9jxQ (button) folded on the Flop
Seat 6: xNKcQzD9+/iHmtJn4vYq9w (small blind) folded before Flop



PokerStars Game #59938641464:  Hold'em No Limit ($0.50/$1.00) - 2009/07/01 0:19:54 ET
Table 'blHlQApStil0OPeQxQxPcwFKpXUINE6M3UxHG4zaMhHAx Seat #2 is the button
Seat 1: x80+i7DJL+81v3quj7KbNg ($20 in chips)
Seat 2: wIZ377kjl2fHFGnS93o6bw ($38.50 in chips)
Seat 3: o1axyw4AjQ8n4ubTwlirQQ ($26.70 in chips)
Seat 4: zanka7aAZkigmZpfopXxxA ($36.80 in chips)
Seat 6: JPQzLacMGzeh42mPgyrvVQ ($72.10 in chips)
Seat 7: vR4IO10geOgvTW+LAUBv/A ($111 in chips)
Seat 8: VtjmCz/ASIcETatNJ8YcCA ($67.25 in chips)
o1axyw4AjQ8n4ubTwlirQQ: posts small blind $0.50
zanka7aAZkigmZpfopXxxA: posts big blind $1
uXrDE6JrIi8BZK1L8oQ9bQ: sits out
*** HOLE CARDS ***
JPQzLacMGzeh42mPgyrvVQ: folds
vR4IO10geOgvTW+LAUBv/A: folds
VtjmCz/ASIcETatNJ8YcCA: calls $1
x80+i7DJL+81v3quj7KbNg: folds
wIZ377kjl2fHFGnS93o6bw: folds
o1axyw4AjQ8n4ubTwlirQQ: folds
zanka7aAZkigmZpfopXxxA: checks
*** FLOP *** [As Jd 5c]
zanka7aAZkigmZpfopXxxA: checks
VtjmCz/ASIcETatNJ8YcCA: bets $1
zanka7aAZkigmZpfopXxxA: folds
VtjmCz/ASIcETatNJ8YcCA collected $2.40 from pot
VtjmCz/ASIcETatNJ8YcCA: doesn't show hand
*** SUMMARY ***
Total pot $2.50 | Rake $0.10
Board [As Jd 5c]
Seat 1: x80+i7DJL+81v3quj7KbNg folded before Flop (didn't bet)
Seat 2: wIZ377kjl2fHFGnS93o6bw (button) folded before Flop (didn't bet)
Seat 3: o1axyw4AjQ8n4ubTwlirQQ (small blind) folded before Flop
Seat 4: zanka7aAZkigmZpfopXxxA (big blind) folded on the Flop
Seat 6: JPQzLacMGzeh42mPgyrvVQ folded before Flop (didn't bet)
Seat 7: vR4IO10geOgvTW+LAUBv/A folded before Flop (didn't bet)
Seat 8: VtjmCz/ASIcETatNJ8YcCA collected ($2.40)



PokerStars Game #59938641608:  Hold'em No Limit ($0.50/$1.00) - 2009/07/01 0:19:54 ET
Table 'rmZfTK+oSebeUPJNbWhdAA' 6-max Seat #5 is the button
Seat 1: u4vYQZNWtIzOJre8fvCmvQ ($46.85 in chips)
Seat 2: OigyyiK+tTj1APPIAUmXDA ($65.45 in chips)
Seat 3: 9yjOzGERLaEZS8CZ6YNHFg ($62.80 in chips)
Seat 4: OGMLOcTNYZXZU81au7ztUw ($105.05 in chips)
Seat 5: VuZb/hkEc4X7s93w2ZZTpA ($112.75 in chips)
Seat 6: j7NIOHLZk7V2o9fOioO5ug ($103.80 in chips)
j7NIOHLZk7V2o9fOioO5ug: posts small blind $0.50
u4vYQZNWtIzOJre8fvCmvQ: posts big blind $1
*** HOLE CARDS ***
OigyyiK+tTj1APPIAUmXDA: folds
9yjOzGERLaEZS8CZ6YNHFg: folds
OGMLOcTNYZXZU81au7ztUw: folds
VuZb/hkEc4X7s93w2ZZTpA: folds
j7NIOHLZk7V2o9fOioO5ug: raises $2 to $3
u4vYQZNWtIzOJre8fvCmvQ: folds
j7NIOHLZk7V2o9fOioO5ug collected $2 from pot
j7NIOHLZk7V2o9fOioO5ug: doesn't show hand
*** SUMMARY ***
Total pot $2 | Rake $0
Seat 1: u4vYQZNWtIzOJre8fvCmvQ (big blind) folded before Flop
Seat 2: OigyyiK+tTj1APPIAUmXDA folded before Flop (didn't bet)
Seat 3: 9yjOzGERLaEZS8CZ6YNHFg folded before Flop (didn't bet)
Seat 4: OGMLOcTNYZXZU81au7ztUw folded before Flop (didn't bet)
Seat 5: VuZb/hkEc4X7s93w2ZZTpA (button) folded before Flop (didn't bet)
Seat 6: j7NIOHLZk7V2o9fOioO5ug (small blind) collected ($2)



PokerStars Game #59938641606:  Hold'em No Limit ($0.50/$1.00) - 2009/07/01 0:19:54 ET
Table '7Nl0ffnjeK44/vmeexh3MQ' 9-max Seat #3 is the button
Seat 1: s7D3Y+k4Cj4D1cXHv7oj+Q ($102.30 in chips)
Seat 3: 200876 ($44.90 in chips)
Seat 4: NfbTuCZ2txeWuV3hP7t0TA ($100 in chips)
Seat 5: bL+QVeDcuEdzMGAGg2XJHg ($108.60 in chips)
Seat 6: FVs16t7GgfWgQWt4JxsObQ ($19.05 in chips)
Seat 7: knewtTmBc4Tc0z/5tAABYQ ($108 in chips)
Seat 8: zanka7aAZkigmZpfopXxxA ($137.70 in chips)
Seat 9: Ei6tUEmph+Q+DkB6JH3thw ($78.80 in chips)
NfbTuCZ2txeWuV3hP7t0TA: posts small blind $0.50
bL+QVeDcuEdzMGAGg2XJHg: posts big blind $1
*** HOLE CARDS ***
FVs16t7GgfWgQWt4JxsObQ: calls $1
knewtTmBc4Tc0z/5tAABYQ: folds
zanka7aAZkigmZpfopXxxA: raises $2 to $3
Ei6tUEmph+Q+DkB6JH3thw: raises $4 to $7
s7D3Y+k4Cj4D1cXHv7oj+Q: folds
200876: folds
NfbTuCZ2txeWuV3hP7t0TA: folds
bL+QVeDcuEdzMGAGg2XJHg: folds
FVs16t7GgfWgQWt4JxsObQ: calls $6
zanka7aAZkigmZpfopXxxA: raises $14 to $21
Ei6tUEmph+Q+DkB6JH3thw: calls $14
FVs16t7GgfWgQWt4JxsObQ: folds
*** FLOP *** [9s Kc 7s]
zanka7aAZkigmZpfopXxxA: bets $1
Ei6tUEmph+Q+DkB6JH3thw: raises $15 to $16
zanka7aAZkigmZpfopXxxA: raises $100.70 to $116.70 and is all-in
Ei6tUEmph+Q+DkB6JH3thw: calls $41.80 and is all-in
*** TURN *** [9s Kc 7s] [Jh]
*** RIVER *** [9s Kc 7s Jh] [As]
*** SHOW DOWN ***
zanka7aAZkigmZpfopXxxA: shows [Ks Kd] (three of a kind, Kings)
Ei6tUEmph+Q+DkB6JH3thw: mucks hand
zanka7aAZkigmZpfopXxxA collected $163.10 from pot
*** SUMMARY ***
Total pot $166.10 | Rake $3
Board [9s Kc 7s Jh As]
Seat 1: s7D3Y+k4Cj4D1cXHv7oj+Q folded before Flop (didn't bet)
Seat 3: 200876 (button) folded before Flop (didn't bet)
Seat 4: NfbTuCZ2txeWuV3hP7t0TA (small blind) folded before Flop
Seat 5: bL+QVeDcuEdzMGAGg2XJHg (big blind) folded before Flop
Seat 6: FVs16t7GgfWgQWt4JxsObQ folded before Flop
Seat 7: knewtTmBc4Tc0z/5tAABYQ folded before Flop (didn't bet)
Seat 8: zanka7aAZkigmZpfopXxxA showed [Ks Kd] and won ($163.10) with three of a kind, Kings
Seat 9: Ei6tUEmph+Q+DkB6JH3thw mucked



PokerStars Game #59938642152:  Hold'em No Limit ($0.50/$1.00) - 2009/07/01 0:19:55 ET
Table '/+ni2d7lj6E90JmAQZKSOw' 2-max Seat #2 is the button
Seat 1: qubgcbkrXfMjdrMEd1lYMQ ($263.20 in chips)
Seat 2: IJu7Boitu3yAxp4hjIx6zQ ($107.40 in chips)
IJu7Boitu3yAxp4hjIx6zQ: posts small blind $0.50
qubgcbkrXfMjdrMEd1lYMQ: posts big blind $1
*** HOLE CARDS ***
IJu7Boitu3yAxp4hjIx6zQ: raises $2 to $3
qubgcbkrXfMjdrMEd1lYMQ: raises $7 to $10
IJu7Boitu3yAxp4hjIx6zQ: raises $16 to $26
qubgcbkrXfMjdrMEd1lYMQ: folds
IJu7Boitu3yAxp4hjIx6zQ collected $20 from pot
*** SUMMARY ***
Total pot $20 | Rake $0
Seat 1: qubgcbkrXfMjdrMEd1lYMQ (big blind) folded before Flop
Seat 2: IJu7Boitu3yAxp4hjIx6zQ (button) (small blind) collected ($20)



PokerStars Game #59938643122:  Hold'em No Limit ($0.50/$1.00) - 2009/07/01 0:19:56 ET
Table '/FUb199IViHMJHi5YWmeuQ' 9-max Seat #8 is the button
Seat 1: TZcz9MEWDA+WydgGruqqbw ($101.50 in chips)
Seat 2: FL3MrLspcF23LYvC4ipBOA ($133.75 in chips)
Seat 3: qN483QJ1NvHbdIZB7J4ARw ($75.25 in chips)
Seat 4: qheQay5YvP2DMAb3OUSxtw ($107.30 in chips)
Seat 5: +za1iHiRgVo4OcAz0SOZqw ($16.95 in chips)
Seat 6: x80+i7DJL+81v3quj7KbNg ($24.50 in chips)
Seat 7: atVaKXE/AQGa798rpMF/Bg ($17 in chips)
Seat 8: QIWvt0R766g8KfH0vl1s0A ($58.10 in chips)
Seat 9: knewtTmBc4Tc0z/5tAABYQ ($112.15 in chips)
knewtTmBc4Tc0z/5tAABYQ: posts small blind $0.50
TZcz9MEWDA+WydgGruqqbw: posts big blind $1
*** HOLE CARDS ***
FL3MrLspcF23LYvC4ipBOA: folds
qN483QJ1NvHbdIZB7J4ARw: folds
qheQay5YvP2DMAb3OUSxtw: folds
+za1iHiRgVo4OcAz0SOZqw: folds
x80+i7DJL+81v3quj7KbNg: folds
atVaKXE/AQGa798rpMF/Bg: folds
QIWvt0R766g8KfH0vl1s0A: folds
knewtTmBc4Tc0z/5tAABYQ: raises $3 to $4
TZcz9MEWDA+WydgGruqqbw: folds
knewtTmBc4Tc0z/5tAABYQ collected $2 from pot
knewtTmBc4Tc0z/5tAABYQ: doesn't show hand
*** SUMMARY ***
Total pot $2 | Rake $0
Seat 1: TZcz9MEWDA+WydgGruqqbw (big blind) folded before Flop
Seat 2: FL3MrLspcF23LYvC4ipBOA folded before Flop (didn't bet)
Seat 3: qN483QJ1NvHbdIZB7J4ARw folded before Flop (didn't bet)
Seat 4: qheQay5YvP2DMAb3OUSxtw folded before Flop (didn't bet)
Seat 5: +za1iHiRgVo4OcAz0SOZqw folded before Flop (didn't bet)
Seat 6: x80+i7DJL+81v3quj7KbNg folded before Flop (didn't bet)
Seat 7: atVaKXE/AQGa798rpMF/Bg folded before Flop (didn't bet)
Seat 8: QIWvt0R766g8KfH0vl1s0A (button) folded before Flop (didn't bet)
Seat 9: knewtTmBc4Tc0z/5tAABYQ (small blind) collected ($2)



PokerStars Game #59938643666:  Hold'em No Limit ($0.50/$1.00) - 2009/07/01 0:19:57 ET
Table 'SQLOQoANiHscJ8AL7zffbw' 9-max Seat #3 is the button
Seat 1: jPTRd6SpCp4xqAy2XQiTOw ($103.05 in chips)
Seat 2: /zy+DB4S5fUQUSfZWFzYGw ($280.35 in chips)
Seat 3: 0eFnow7+D7veCYQ+CG9FFw ($98.50 in chips)
Seat 4: N9n5Wc3s35DpCrOAUUNAaQ ($120.80 in chips)
Seat 5: L9njYvloJ1NdXjP8edHEAg ($100 in chips)
Seat 6: p5UKaxVobvptF0ANhR/q1A ($158.50 in chips)
Seat 7: bJckevFOcg//s0qyMQI6sQ ($105.05 in chips)
Seat 8: yfXek8iJ7O4CFyqXrtGcfg ($83.95 in chips)
N9n5Wc3s35DpCrOAUUNAaQ: posts small blind $0.50
L9njYvloJ1NdXjP8edHEAg: posts big blind $1
*** HOLE CARDS ***
p5UKaxVobvptF0ANhR/q1A: folds
bJckevFOcg//s0qyMQI6sQ: folds
yfXek8iJ7O4CFyqXrtGcfg: raises $2 to $3
jPTRd6SpCp4xqAy2XQiTOw: folds
/zy+DB4S5fUQUSfZWFzYGw: folds
qJr25HAtvv1w/7IBvjMM3g has returned
0eFnow7+D7veCYQ+CG9FFw: folds
N9n5Wc3s35DpCrOAUUNAaQ: folds
L9njYvloJ1NdXjP8edHEAg: folds
yfXek8iJ7O4CFyqXrtGcfg collected $2.50 from pot
*** SUMMARY ***
Total pot $2.50 | Rake $0
Seat 1: jPTRd6SpCp4xqAy2XQiTOw folded before Flop (didn't bet)
Seat 2: /zy+DB4S5fUQUSfZWFzYGw folded before Flop (didn't bet)
Seat 3: 0eFnow7+D7veCYQ+CG9FFw (button) folded before Flop (didn't bet)
Seat 4: N9n5Wc3s35DpCrOAUUNAaQ (small blind) folded before Flop
Seat 5: L9njYvloJ1NdXjP8edHEAg (big blind) folded before Flop
Seat 6: p5UKaxVobvptF0ANhR/q1A folded before Flop (didn't bet)
Seat 7: bJckevFOcg//s0qyMQI6sQ folded before Flop (didn't bet)
Seat 8: yfXek8iJ7O4CFyqXrtGcfg collected ($2.50)



PokerStars Game #59938644898:  Hold'em No Limit ($0.50/$1.00) - 2009/07/01 0:19:58 ET
Table 'b/mVBMBBjZR4F+Jsv8cuYA' 9-max Seat #4 is the button
Seat 1: 0bFSG2wtTalRoQW05hZ/uw ($40.70 in chips)
Seat 2: HPmAhANyB1+4MGzYS9i5Wg ($52.60 in chips)
Seat 3: x80+i7DJL+81v3quj7KbNg ($20 in chips)
Seat 4: 0oXWlMUwwWciWdZOQf6yUw ($127.45 in chips)
Seat 5: p5UKaxVobvptF0ANhR/q1A ($104.70 in chips)
Seat 6: FL3MrLspcF23LYvC4ipBOA ($303.90 in chips)
Seat 7: 0eFnow7+D7veCYQ+CG9FFw ($58.50 in chips)
Seat 8: L9njYvloJ1NdXjP8edHEAg ($102.50 in chips)
Seat 9: 9BZCcac3+McErkkSN2YScA ($113.95 in chips)
p5UKaxVobvptF0ANhR/q1A: posts small blind $0.50
FL3MrLspcF23LYvC4ipBOA: posts big blind $1
*** HOLE CARDS ***
0eFnow7+D7veCYQ+CG9FFw: folds
0eFnow7+D7veCYQ+CG9FFw leaves the table
L9njYvloJ1NdXjP8edHEAg: folds
9BZCcac3+McErkkSN2YScA: folds
0bFSG2wtTalRoQW05hZ/uw: calls $1
HPmAhANyB1+4MGzYS9i5Wg: folds
x80+i7DJL+81v3quj7KbNg: folds
0oXWlMUwwWciWdZOQf6yUw: folds
p5UKaxVobvptF0ANhR/q1A: calls $0.50
FL3MrLspcF23LYvC4ipBOA: checks
*** FLOP *** [Qd 3s Jd]
p5UKaxVobvptF0ANhR/q1A: bets $2
FL3MrLspcF23LYvC4ipBOA: calls $2
0bFSG2wtTalRoQW05hZ/uw: folds
*** TURN *** [Qd 3s Jd] [9s]
p5UKaxVobvptF0ANhR/q1A: bets $4
5GtqC1O4Y1t1VmP51SDSJQ joins the table at seat #7
FL3MrLspcF23LYvC4ipBOA: calls $4
*** RIVER *** [Qd 3s Jd 9s] [3d]
p5UKaxVobvptF0ANhR/q1A: bets $6
FL3MrLspcF23LYvC4ipBOA: raises $8 to $14
p5UKaxVobvptF0ANhR/q1A: folds
FL3MrLspcF23LYvC4ipBOA collected $25.70 from pot
*** SUMMARY ***
Total pot $27 | Rake $1.30
Board [Qd 3s Jd 9s 3d]
Seat 1: 0bFSG2wtTalRoQW05hZ/uw folded on the Flop
Seat 2: HPmAhANyB1+4MGzYS9i5Wg folded before Flop (didn't bet)
Seat 3: x80+i7DJL+81v3quj7KbNg folded before Flop (didn't bet)
Seat 4: 0oXWlMUwwWciWdZOQf6yUw (button) folded before Flop (didn't bet)
Seat 5: p5UKaxVobvptF0ANhR/q1A (small blind) folded on the River
Seat 6: FL3MrLspcF23LYvC4ipBOA (big blind) collected ($25.70)
Seat 7: 0eFnow7+D7veCYQ+CG9FFw folded before Flop (didn't bet)
Seat 8: L9njYvloJ1NdXjP8edHEAg folded before Flop (didn't bet)
Seat 9: 9BZCcac3+McErkkSN2YScA folded before Flop (didn't bet)



PokerStars Game #59938645560:  Hold'em No Limit ($0.50/$1.00) - 2009/07/01 0:19:59 ET
Table 'aWHveb63HkbTmOGHOxjBkQ' 2-max Seat #2 is the button
Seat 1: xy2MQKoHoCZZIudmw8Xbow ($203.20 in chips)
Seat 2: xstEKavv3YDxpUnU4e9qAQ ($171.60 in chips)
xstEKavv3YDxpUnU4e9qAQ: posts small blind $0.50
xy2MQKoHoCZZIudmw8Xbow: posts big blind $1
*** HOLE CARDS ***
xstEKavv3YDxpUnU4e9qAQ: folds
xy2MQKoHoCZZIudmw8Xbow collected $1 from pot
xy2MQKoHoCZZIudmw8Xbow: doesn't show hand
*** SUMMARY ***
Total pot $1 | Rake $0
Seat 1: xy2MQKoHoCZZIudmw8Xbow (big blind) collected ($1)
Seat 2: xstEKavv3YDxpUnU4e9qAQ (button) (small blind) folded before Flop



PokerStars Game #59938644972:  Hold'em No Limit ($0.50/$1.00) - 2009/07/01 0:19:59 ET
Table 'kS0cTQAEi+fdUlJP2gQYvw' 9-max Seat #3 is the button
Seat 1: c/9X4zftzphFxYtxp5kp9w ($52.90 in chips)
Seat 2: 4SFNYndzMeslixOnF4koZQ ($38.90 in chips)
Seat 3: 3obndzTJ6fECz8+wWhMd1w ($18.50 in chips)
Seat 4: TZcz9MEWDA+WydgGruqqbw ($109.30 in chips)
Seat 6: yAbu2QsRPVcjPbqlf/jDxw ($102.15 in chips)
Seat 7: Ffa7Nj4X5fddtROP01hfQg ($86.65 in chips)
Seat 8: qTymj6ZQ8ZoFi6fINJZb3w ($87 in chips)
Seat 9: y8Qb94e81yI/g0saQ6gU5g ($89.25 in chips)
TZcz9MEWDA+WydgGruqqbw: posts small blind $0.50
b0jO1SDhLedy1//CQlA8kw: is sitting out
yAbu2QsRPVcjPbqlf/jDxw: posts big blind $1
*** HOLE CARDS ***
b0jO1SDhLedy1//CQlA8kw leaves the table
Ffa7Nj4X5fddtROP01hfQg: folds
qTymj6ZQ8ZoFi6fINJZb3w: folds
y8Qb94e81yI/g0saQ6gU5g: folds
c/9X4zftzphFxYtxp5kp9w: calls $1
2rxrMrE7koO2BNxvop/0+g joins the table at seat #5
4SFNYndzMeslixOnF4koZQ: calls $1
3obndzTJ6fECz8+wWhMd1w: folds
Ffa7Nj4X5fddtROP01hfQg said, "im glad a jack didnt come"
TZcz9MEWDA+WydgGruqqbw: folds
yAbu2QsRPVcjPbqlf/jDxw: checks
*** FLOP *** [3d Th 6h]
yAbu2QsRPVcjPbqlf/jDxw: checks
c/9X4zftzphFxYtxp5kp9w: checks
4SFNYndzMeslixOnF4koZQ: checks
*** TURN *** [3d Th 6h] [Ks]
c/9X4zftzphFxYtxp5kp9w said, ":P"
yAbu2QsRPVcjPbqlf/jDxw: checks
c/9X4zftzphFxYtxp5kp9w: checks
4SFNYndzMeslixOnF4koZQ: bets $1
yAbu2QsRPVcjPbqlf/jDxw: folds
c/9X4zftzphFxYtxp5kp9w: folds
4SFNYndzMeslixOnF4koZQ collected $3.35 from pot
*** SUMMARY ***
Total pot $3.50 | Rake $0.15
Board [3d Th 6h Ks]
Seat 1: c/9X4zftzphFxYtxp5kp9w folded on the Turn
Seat 2: 4SFNYndzMeslixOnF4koZQ collected ($3.35)
Seat 3: 3obndzTJ6fECz8+wWhMd1w (button) folded before Flop (didn't bet)
Seat 4: TZcz9MEWDA+WydgGruqqbw (small blind) folded before Flop
Seat 6: yAbu2QsRPVcjPbqlf/jDxw (big blind) folded on the Turn
Seat 7: Ffa7Nj4X5fddtROP01hfQg folded before Flop (didn't bet)
Seat 8: qTymj6ZQ8ZoFi6fINJZb3w folded before Flop (didn't bet)
Seat 9: y8Qb94e81yI/g0saQ6gU5g folded before Flop (didn't bet)



PokerStars Game #59938646664:  Hold'em No Limit ($0.50/$1.00) - 2009/07/01 0:20:01 ET
Table 'GxCPo/gd3OSthkYrAxJngg' 6-max Seat #6 is the button
Seat 1: sH8BpAFP+jGFxCgVpD1Lew ($183.60 in chips)
Seat 2: YExX2paeIHrmfIwV1ivM/w ($87.20 in chips)
Seat 3: oEFhmBFI/N1eUlbVXORRnw ($100 in chips)
Seat 4: YMJG+F++3Aj6P8dAWda5fw ($100 in chips)
Seat 5: G5ZSSN6RSON3gkNvk/SmYg ($100 in chips)
Seat 6: sS9IXedL3MiRmpVXhAILhw ($100 in chips)
sH8BpAFP+jGFxCgVpD1Lew: posts small blind $0.50
YExX2paeIHrmfIwV1ivM/w: posts big blind $1
*** HOLE CARDS ***
oEFhmBFI/N1eUlbVXORRnw: folds
YMJG+F++3Aj6P8dAWda5fw: raises $2 to $3
oEFhmBFI/N1eUlbVXORRnw leaves the table
G5ZSSN6RSON3gkNvk/SmYg: folds
sS9IXedL3MiRmpVXhAILhw: folds
sH8BpAFP+jGFxCgVpD1Lew: calls $2.50
YExX2paeIHrmfIwV1ivM/w: folds
*** FLOP *** [8d Qc 5c]
sH8BpAFP+jGFxCgVpD1Lew: checks
h2lYnlZ7Ueu3PsyB2UOfSQ joins the table at seat #3
YMJG+F++3Aj6P8dAWda5fw: bets $4
sH8BpAFP+jGFxCgVpD1Lew: folds
YMJG+F++3Aj6P8dAWda5fw collected $6.65 from pot
*** SUMMARY ***
Total pot $7 | Rake $0.35
Board [8d Qc 5c]
Seat 1: sH8BpAFP+jGFxCgVpD1Lew (small blind) folded on the Flop
Seat 2: YExX2paeIHrmfIwV1ivM/w (big blind) folded before Flop
Seat 3: oEFhmBFI/N1eUlbVXORRnw folded before Flop (didn't bet)
Seat 4: YMJG+F++3Aj6P8dAWda5fw collected ($6.65)
Seat 5: G5ZSSN6RSON3gkNvk/SmYg folded before Flop (didn't bet)
Seat 6: sS9IXedL3MiRmpVXhAILhw (button) folded before Flop (didn't bet)



PokerStars Game #59938647974:  Hold'em No Limit ($0.50/$1.00) - 2009/07/01 0:20:03 ET
Table 'tyUh+jyNvrceIQdKMJjQ2wZFWj23PMihdwrNWv41OG/Qeat #5 is the button
Seat 1: o8A5MUdudVKu+pAwgZOX2w ($201.25 in chips)
Seat 2: 6iVcnPw9a2oNG6sPQo3G6g ($98.75 in chips)
Seat 3: L9qfLYXrczhAPd/VckgsWw ($35.40 in chips)
Seat 5: j7NIOHLZk7V2o9fOioO5ug ($103.10 in chips)
Seat 6: YsLQ3BAvgQHWXMAv3Wv6Hg ($105.75 in chips)
YsLQ3BAvgQHWXMAv3Wv6Hg: posts small blind $0.50
o8A5MUdudVKu+pAwgZOX2w: posts big blind $1
*** HOLE CARDS ***
6iVcnPw9a2oNG6sPQo3G6g: folds
L9qfLYXrczhAPd/VckgsWw: raises $2 to $3
j7NIOHLZk7V2o9fOioO5ug: folds
YsLQ3BAvgQHWXMAv3Wv6Hg: folds
o8A5MUdudVKu+pAwgZOX2w: calls $2
*** FLOP *** [7d 5c Ah]
o8A5MUdudVKu+pAwgZOX2w: checks
L9qfLYXrczhAPd/VckgsWw: bets $1
o8A5MUdudVKu+pAwgZOX2w: folds
L9qfLYXrczhAPd/VckgsWw collected $6.20 from pot
L9qfLYXrczhAPd/VckgsWw: doesn't show hand
*** SUMMARY ***
Total pot $6.50 | Rake $0.30
Board [7d 5c Ah]
Seat 1: o8A5MUdudVKu+pAwgZOX2w (big blind) folded on the Flop
Seat 2: 6iVcnPw9a2oNG6sPQo3G6g folded before Flop (didn't bet)
Seat 3: L9qfLYXrczhAPd/VckgsWw collected ($6.20)
Seat 5: j7NIOHLZk7V2o9fOioO5ug (button) folded before Flop (didn't bet)
Seat 6: YsLQ3BAvgQHWXMAv3Wv6Hg (small blind) folded before Flop



PokerStars Game #59938648354:  Hold'em No Limit ($0.50/$1.00) - 2009/07/01 0:20:03 ET
Table 'N2bNCDHL96aCQDvZIh+yQQ' 6-max Seat #5 is the button
Seat 1: iHo1oDbrEVJ8nEGdaPrICw ($138.95 in chips)
Seat 2: KpnW5CcJ4Mg6MeclfKmLrw ($101.50 in chips)
Seat 3: PXT6kJgVX67c3EgncNqRoA ($54.95 in chips)
Seat 4: uCqEjnxh2/vFBjKYkfTOkw ($163.20 in chips)
Seat 5: rHlMOfR7kpQQxe+PFQz0xQ ($37 in chips)
iHo1oDbrEVJ8nEGdaPrICw: posts small blind $0.50
KpnW5CcJ4Mg6MeclfKmLrw: posts big blind $1
*** HOLE CARDS ***
PXT6kJgVX67c3EgncNqRoA: raises $1 to $2
uCqEjnxh2/vFBjKYkfTOkw: folds
rHlMOfR7kpQQxe+PFQz0xQ: folds
iHo1oDbrEVJ8nEGdaPrICw: calls $1.50
KpnW5CcJ4Mg6MeclfKmLrw: raises $8 to $10
PXT6kJgVX67c3EgncNqRoA: folds
iHo1oDbrEVJ8nEGdaPrICw: folds
KpnW5CcJ4Mg6MeclfKmLrw collected $6 from pot
KpnW5CcJ4Mg6MeclfKmLrw: doesn't show hand
*** SUMMARY ***
Total pot $6 | Rake $0
Seat 1: iHo1oDbrEVJ8nEGdaPrICw (small blind) folded before Flop
Seat 2: KpnW5CcJ4Mg6MeclfKmLrw (big blind) collected ($6)
Seat 3: PXT6kJgVX67c3EgncNqRoA folded before Flop
Seat 4: uCqEjnxh2/vFBjKYkfTOkw folded before Flop (didn't bet)
Seat 5: rHlMOfR7kpQQxe+PFQz0xQ (button) folded before Flop (didn't bet)



PokerStars Game #59938648976:  Hold'em No Limit ($0.50/$1.00) - 2009/07/01 0:20:04 ET
Table 'Zka9tv1yilg0MvXWPQrShg' 9-max Seat #4 is the button
Seat 1: TZcz9MEWDA+WydgGruqqbw ($100 in chips)
Seat 2: zBHLwg+HmbHmRtVQMhavjA ($105.55 in chips)
Seat 3: gUUvmqdVlmvpal6B8nYrmg ($100 in chips)
Seat 4: CTOae+JLIGfwfXvhqHkP2w ($146.15 in chips)
Seat 5: /zy+DB4S5fUQUSfZWFzYGw ($182.45 in chips)
Seat 6: rY8wPoax1lS+HUY+I0FZDw ($129.90 in chips)
Seat 7: p1SafS90nb3Uft5LB0NkHw ($20 in chips)
Seat 8: bL+QVeDcuEdzMGAGg2XJHg ($126.10 in chips)
Seat 9: SlhHwZrXCVifyCHK+qz1Kw ($100.45 in chips)
/zy+DB4S5fUQUSfZWFzYGw: posts small blind $0.50
rY8wPoax1lS+HUY+I0FZDw: posts big blind $1
*** HOLE CARDS ***
p1SafS90nb3Uft5LB0NkHw: folds
bL+QVeDcuEdzMGAGg2XJHg: folds
SlhHwZrXCVifyCHK+qz1Kw: folds
TZcz9MEWDA+WydgGruqqbw: folds
zBHLwg+HmbHmRtVQMhavjA: folds
gUUvmqdVlmvpal6B8nYrmg: raises $1 to $2
CTOae+JLIGfwfXvhqHkP2w: calls $2
/zy+DB4S5fUQUSfZWFzYGw: raises $9 to $11
rY8wPoax1lS+HUY+I0FZDw: folds
gUUvmqdVlmvpal6B8nYrmg: folds
CTOae+JLIGfwfXvhqHkP2w: calls $9
*** FLOP *** [Ks 7h 3d]
/zy+DB4S5fUQUSfZWFzYGw: checks
CTOae+JLIGfwfXvhqHkP2w: checks
*** TURN *** [Ks 7h 3d] [4h]
/zy+DB4S5fUQUSfZWFzYGw: bets $10
CTOae+JLIGfwfXvhqHkP2w: calls $10
*** RIVER *** [Ks 7h 3d 4h] [6d]
/zy+DB4S5fUQUSfZWFzYGw: bets $20
CTOae+JLIGfwfXvhqHkP2w: raises $40 to $60
/zy+DB4S5fUQUSfZWFzYGw: folds
CTOae+JLIGfwfXvhqHkP2w collected $82 from pot
*** SUMMARY ***
Total pot $85 | Rake $3
Board [Ks 7h 3d 4h 6d]
Seat 1: TZcz9MEWDA+WydgGruqqbw folded before Flop (didn't bet)
Seat 2: zBHLwg+HmbHmRtVQMhavjA folded before Flop (didn't bet)
Seat 3: gUUvmqdVlmvpal6B8nYrmg folded before Flop
Seat 4: CTOae+JLIGfwfXvhqHkP2w (button) collected ($82)
Seat 5: /zy+DB4S5fUQUSfZWFzYGw (small blind) folded on the River
Seat 6: rY8wPoax1lS+HUY+I0FZDw (big blind) folded before Flop
Seat 7: p1SafS90nb3Uft5LB0NkHw folded before Flop (didn't bet)
Seat 8: bL+QVeDcuEdzMGAGg2XJHg folded before Flop (didn't bet)
Seat 9: SlhHwZrXCVifyCHK+qz1Kw folded before Flop (didn't bet)



PokerStars Game #59938649688:  Hold'em No Limit ($0.50/$1.00) - 2009/07/01 0:20:05 ET
Table 'cBDNutyLBKEk9+ptwsKmTw' 6-max Seat #5 is the button
Seat 1: tb0dt30qP2x/8f+Xta4mVg ($23.95 in chips)
Seat 2: KyaE4+hWgUNIWWOWy4D14w ($63.30 in chips)
Seat 3: G5ZSSN6RSON3gkNvk/SmYg ($107.40 in chips)
Seat 4: 0WjiuIT7/EolY1oOx1ngeA ($107.65 in chips)
Seat 5: OGMLOcTNYZXZU81au7ztUw ($105.25 in chips)
Seat 6: pyzhFUPPSNzrysiMqlA5Xw ($11.75 in chips)
pyzhFUPPSNzrysiMqlA5Xw: posts small blind $0.50
tb0dt30qP2x/8f+Xta4mVg: posts big blind $1
*** HOLE CARDS ***
KyaE4+hWgUNIWWOWy4D14w: calls $1
G5ZSSN6RSON3gkNvk/SmYg: folds
0WjiuIT7/EolY1oOx1ngeA: folds
OGMLOcTNYZXZU81au7ztUw: raises $3 to $4
pyzhFUPPSNzrysiMqlA5Xw: folds
tb0dt30qP2x/8f+Xta4mVg: calls $3
KyaE4+hWgUNIWWOWy4D14w: folds
*** FLOP *** [7s 8c Kh]
tb0dt30qP2x/8f+Xta4mVg: bets $1
OGMLOcTNYZXZU81au7ztUw: raises $4 to $5
tb0dt30qP2x/8f+Xta4mVg: folds
OGMLOcTNYZXZU81au7ztUw collected $10.95 from pot
OGMLOcTNYZXZU81au7ztUw: doesn't show hand
*** SUMMARY ***
Total pot $11.50 | Rake $0.55
Board [7s 8c Kh]
Seat 1: tb0dt30qP2x/8f+Xta4mVg (big blind) folded on the Flop
Seat 2: KyaE4+hWgUNIWWOWy4D14w folded before Flop
Seat 3: G5ZSSN6RSON3gkNvk/SmYg folded before Flop (didn't bet)
Seat 4: 0WjiuIT7/EolY1oOx1ngeA folded before Flop (didn't bet)
Seat 5: OGMLOcTNYZXZU81au7ztUw (button) collected ($10.95)
Seat 6: pyzhFUPPSNzrysiMqlA5Xw (small blind) folded before Flop



PokerStars Game #59938649432:  Hold'em No Limit ($0.50/$1.00) - 2009/07/01 0:20:05 ET
Table 'aWHveb63HkbTmOGHOxjBkQ' 2-max Seat #1 is the button
Seat 1: xy2MQKoHoCZZIudmw8Xbow ($203.70 in chips)
Seat 2: xstEKavv3YDxpUnU4e9qAQ ($171.10 in chips)
xy2MQKoHoCZZIudmw8Xbow: posts small blind $0.50
xstEKavv3YDxpUnU4e9qAQ: posts big blind $1
*** HOLE CARDS ***
xy2MQKoHoCZZIudmw8Xbow: raises $3 to $4
xstEKavv3YDxpUnU4e9qAQ: folds
xy2MQKoHoCZZIudmw8Xbow collected $2 from pot
xy2MQKoHoCZZIudmw8Xbow: doesn't show hand
*** SUMMARY ***
Total pot $2 | Rake $0
Seat 1: xy2MQKoHoCZZIudmw8Xbow (button) (small blind) collected ($2)
Seat 2: xstEKavv3YDxpUnU4e9qAQ (big blind) folded before Flop



PokerStars Game #59938649866:  Hold'em No Limit ($0.50/$1.00) - 2009/07/01 0:20:06 ET
Table 'ZFWj23PMihdwrNWv41OG/Q' 9-max Seat #3 is the button
Seat 1: yAbu2QsRPVcjPbqlf/jDxw ($103.30 in chips)
Seat 2: ARfmgHcEUKh68laBZy4veA ($36.05 in chips)
Seat 3: G9Fo2TZCN7HI43Po4zSN3A ($100 in chips)
Seat 4: PEmogYqKpuv0ozeBbXL+7Q ($15.75 in chips)
Seat 5: aNuEPl+Lh/dZypIbbfz+mA ($15.35 in chips)
Seat 6: tjhwe1V98x2spSoUQER3HQ ($100 in chips)
Seat 7: wIZ377kjl2fHFGnS93o6bw ($31.05 in chips)
Seat 8: knewtTmBc4Tc0z/5tAABYQ ($107 in chips)
Seat 9: atVaKXE/AQGa798rpMF/Bg ($57 in chips)
PEmogYqKpuv0ozeBbXL+7Q: posts small blind $0.50
aNuEPl+Lh/dZypIbbfz+mA: posts big blind $1
*** HOLE CARDS ***
tjhwe1V98x2spSoUQER3HQ: folds
wIZ377kjl2fHFGnS93o6bw: calls $1
knewtTmBc4Tc0z/5tAABYQ: folds
atVaKXE/AQGa798rpMF/Bg: folds
yAbu2QsRPVcjPbqlf/jDxw: folds
ARfmgHcEUKh68laBZy4veA: folds
G9Fo2TZCN7HI43Po4zSN3A: raises $4 to $5
PEmogYqKpuv0ozeBbXL+7Q: folds
aNuEPl+Lh/dZypIbbfz+mA: calls $4
wIZ377kjl2fHFGnS93o6bw: calls $4
*** FLOP *** [4c 9d Qc]
aNuEPl+Lh/dZypIbbfz+mA: checks
wIZ377kjl2fHFGnS93o6bw: bets $3
G9Fo2TZCN7HI43Po4zSN3A: folds
aNuEPl+Lh/dZypIbbfz+mA: calls $3
*** TURN *** [4c 9d Qc] [8s]
aNuEPl+Lh/dZypIbbfz+mA: checks
wIZ377kjl2fHFGnS93o6bw: bets $5
aNuEPl+Lh/dZypIbbfz+mA: folds
aNuEPl+Lh/dZypIbbfz+mA is sitting out
aNuEPl+Lh/dZypIbbfz+mA has returned
wIZ377kjl2fHFGnS93o6bw collected $20.50 from pot
*** SUMMARY ***
Total pot $21.50 | Rake $1
Board [4c 9d Qc 8s]
Seat 1: yAbu2QsRPVcjPbqlf/jDxw folded before Flop (didn't bet)
Seat 2: ARfmgHcEUKh68laBZy4veA folded before Flop (didn't bet)
Seat 3: G9Fo2TZCN7HI43Po4zSN3A (button) folded on the Flop
Seat 4: PEmogYqKpuv0ozeBbXL+7Q (small blind) folded before Flop
Seat 5: aNuEPl+Lh/dZypIbbfz+mA (big blind) folded on the Turn
Seat 6: tjhwe1V98x2spSoUQER3HQ folded before Flop (didn't bet)
Seat 7: wIZ377kjl2fHFGnS93o6bw collected ($20.50)
Seat 8: knewtTmBc4Tc0z/5tAABYQ folded before Flop (didn't bet)
Seat 9: atVaKXE/AQGa798rpMF/Bg folded before Flop (didn't bet)



PokerStars Game #59938650324:  Hold'em No Limit ($0.50/$1.00) - 2009/07/01 0:20:06 ET
Table 'J2yEIzCSC1VzM+R2gijwtg' 9-max Seat #5 is the button
Seat 1: knewtTmBc4Tc0z/5tAABYQ ($202.95 in chips)
Seat 2: kz9ziSiGUc+857heiKSayw ($16 in chips)
Seat 3: 9swGhtpERPngKPtvpoZkoQ ($124.15 in chips)
Seat 4: vR4IO10geOgvTW+LAUBv/A ($100 in chips)
Seat 5: /kZ258i1lqmMUXbtrZIHJA ($42.60 in chips)
Seat 6: bJckevFOcg//s0qyMQI6sQ ($175.40 in chips)
Seat 8: CIRDepY9Rc5tiDJPd0nNpQ ($93.90 in chips)
Seat 9: ZWdwcEAWYlrUhsRi6MOmoA ($42.55 in chips)
bJckevFOcg//s0qyMQI6sQ: posts small blind $0.50
CIRDepY9Rc5tiDJPd0nNpQ: posts big blind $1
*** HOLE CARDS ***
ZWdwcEAWYlrUhsRi6MOmoA: folds
knewtTmBc4Tc0z/5tAABYQ: folds
kz9ziSiGUc+857heiKSayw: folds
9swGhtpERPngKPtvpoZkoQ: folds
vR4IO10geOgvTW+LAUBv/A: folds
/kZ258i1lqmMUXbtrZIHJA: folds
bJckevFOcg//s0qyMQI6sQ: raises $3 to $4
CIRDepY9Rc5tiDJPd0nNpQ: folds
bJckevFOcg//s0qyMQI6sQ collected $2 from pot
bJckevFOcg//s0qyMQI6sQ: doesn't show hand
*** SUMMARY ***
Total pot $2 | Rake $0
Seat 1: knewtTmBc4Tc0z/5tAABYQ folded before Flop (didn't bet)
Seat 2: kz9ziSiGUc+857heiKSayw folded before Flop (didn't bet)
Seat 3: 9swGhtpERPngKPtvpoZkoQ folded before Flop (didn't bet)
Seat 4: vR4IO10geOgvTW+LAUBv/A folded before Flop (didn't bet)
Seat 5: /kZ258i1lqmMUXbtrZIHJA (button) folded before Flop (didn't bet)
Seat 6: bJckevFOcg//s0qyMQI6sQ (small blind) collected ($2)
Seat 8: CIRDepY9Rc5tiDJPd0nNpQ (big blind) folded before Flop
Seat 9: ZWdwcEAWYlrUhsRi6MOmoA folded before Flop (didn't bet)



PokerStars Game #59938652402:  Hold'em No Limit ($0.50/$1.00) - 2009/07/01 0:20:09 ET
Table 'eU3bWpDDg3Z+9R4m4iVmog' 6-max Seat #2 is the button
Seat 2: 8CAoOzhmB8n3nRFf3V4BTg ($177.95 in chips)
Seat 3: U6tnjwZRpTnM+YkqkCjwyQ ($120.65 in chips)
Seat 4: GDVIsbEJ/DOJsMKE4Asz0A ($94.45 in chips)
Seat 5: QHvTZcrKe6+maWUfVjP29Q ($103.50 in chips)
Seat 6: hpxXcmRkXXI9HE5+5/j/0Q ($100 in chips)
U6tnjwZRpTnM+YkqkCjwyQ: posts small blind $0.50
GDVIsbEJ/DOJsMKE4Asz0A: posts big blind $1
*** HOLE CARDS ***
QHvTZcrKe6+maWUfVjP29Q: folds
hpxXcmRkXXI9HE5+5/j/0Q: folds
8CAoOzhmB8n3nRFf3V4BTg: raises $2 to $3
U6tnjwZRpTnM+YkqkCjwyQ: raises $8 to $11
GDVIsbEJ/DOJsMKE4Asz0A: folds
8CAoOzhmB8n3nRFf3V4BTg: folds
U6tnjwZRpTnM+YkqkCjwyQ collected $7 from pot
*** SUMMARY ***
Total pot $7 | Rake $0
Seat 2: 8CAoOzhmB8n3nRFf3V4BTg (button) folded before Flop
Seat 3: U6tnjwZRpTnM+YkqkCjwyQ (small blind) collected ($7)
Seat 4: GDVIsbEJ/DOJsMKE4Asz0A (big blind) folded before Flop
Seat 5: QHvTZcrKe6+maWUfVjP29Q folded before Flop (didn't bet)
Seat 6: hpxXcmRkXXI9HE5+5/j/0Q folded before Flop (didn't bet)



PokerStars Game #59938653802:  Hold'em No Limit ($0.50/$1.00) - 2009/07/01 0:20:11 ET
Table '6YvsYDPNIDx2v5z3bJnwZQ' 9-max Seat #3 is the button
Seat 1: Ogn4JDV3mp4ZDKO49IFzKA ($17 in chips)
Seat 2: q9qdvTFQkzcAZRujD6rXUA ($98 in chips)
Seat 3: negfosHnGOZXSHpWDRKyBQ ($16.80 in chips)
Seat 4: kEr5NYB+JIG5+szcYMr6hA ($48 in chips)
Seat 5: mBRWbnUl8diyBO1qTJaNzw ($165.15 in chips)
Seat 7: boixc27eqTYA1p0tUdMuBQ ($109.60 in chips)
Seat 8: PSFxpXgPedVZyHSu2Zhb7Q ($77.90 in chips)
Seat 9: jDwhY1kCdc6EkAHbT7PJMQ ($106.85 in chips)
kEr5NYB+JIG5+szcYMr6hA: posts small blind $0.50
mBRWbnUl8diyBO1qTJaNzw: posts big blind $1
uMPEfCcGCfsxmy53tVUMug: sits out
*** HOLE CARDS ***
boixc27eqTYA1p0tUdMuBQ: folds
PSFxpXgPedVZyHSu2Zhb7Q: folds
jDwhY1kCdc6EkAHbT7PJMQ: folds
Ogn4JDV3mp4ZDKO49IFzKA: folds
q9qdvTFQkzcAZRujD6rXUA: folds
negfosHnGOZXSHpWDRKyBQ: raises $2 to $3
kEr5NYB+JIG5+szcYMr6hA: folds
mBRWbnUl8diyBO1qTJaNzw: folds
negfosHnGOZXSHpWDRKyBQ collected $2.50 from pot
*** SUMMARY ***
Total pot $2.50 | Rake $0
Seat 1: Ogn4JDV3mp4ZDKO49IFzKA folded before Flop (didn't bet)
Seat 2: q9qdvTFQkzcAZRujD6rXUA folded before Flop (didn't bet)
Seat 3: negfosHnGOZXSHpWDRKyBQ (button) collected ($2.50)
Seat 4: kEr5NYB+JIG5+szcYMr6hA (small blind) folded before Flop
Seat 5: mBRWbnUl8diyBO1qTJaNzw (big blind) folded before Flop
Seat 7: boixc27eqTYA1p0tUdMuBQ folded before Flop (didn't bet)
Seat 8: PSFxpXgPedVZyHSu2Zhb7Q folded before Flop (didn't bet)
Seat 9: jDwhY1kCdc6EkAHbT7PJMQ folded before Flop (didn't bet)



PokerStars Game #59938653730:  Hold'em No Limit ($0.50/$1.00) - 2009/07/01 0:20:11 ET
Table 'aWHveb63HkbTmOGHOxjBkQ' 2-max Seat #2 is the button
Seat 1: xy2MQKoHoCZZIudmw8Xbow ($204.70 in chips)
Seat 2: xstEKavv3YDxpUnU4e9qAQ ($170.10 in chips)
xstEKavv3YDxpUnU4e9qAQ: posts small blind $0.50
xy2MQKoHoCZZIudmw8Xbow: posts big blind $1
*** HOLE CARDS ***
xstEKavv3YDxpUnU4e9qAQ: folds
xy2MQKoHoCZZIudmw8Xbow collected $1 from pot
xy2MQKoHoCZZIudmw8Xbow: doesn't show hand
*** SUMMARY ***
Total pot $1 | Rake $0
Seat 1: xy2MQKoHoCZZIudmw8Xbow (big blind) collected ($1)
Seat 2: xstEKavv3YDxpUnU4e9qAQ (button) (small blind) folded before Flop



PokerStars Game #59938654088:  Hold'em No Limit ($0.50/$1.00) - 2009/07/01 0:20:12 ET
Table '/+ni2d7lj6E90JmAQZKSOw' 2-max Seat #1 is the button
Seat 1: qubgcbkrXfMjdrMEd1lYMQ ($253.20 in chips)
Seat 2: IJu7Boitu3yAxp4hjIx6zQ ($117.40 in chips)
qubgcbkrXfMjdrMEd1lYMQ: posts small blind $0.50
IJu7Boitu3yAxp4hjIx6zQ: posts big blind $1
*** HOLE CARDS ***
qubgcbkrXfMjdrMEd1lYMQ: folds
IJu7Boitu3yAxp4hjIx6zQ collected $1 from pot
IJu7Boitu3yAxp4hjIx6zQ: doesn't show hand
*** SUMMARY ***
Total pot $1 | Rake $0
Seat 1: qubgcbkrXfMjdrMEd1lYMQ (button) (small blind) folded before Flop
Seat 2: IJu7Boitu3yAxp4hjIx6zQ (big blind) collected ($1)



PokerStars Game #59938654276:  Hold'em No Limit ($0.50/$1.00) - 2009/07/01 0:20:12 ET
Table 'FKpXUINE6M3UxHG4zaMhHA' 6-max Seat #5 is the button
Seat 2: ecfRjfaWRYbPNvaBsW5ZQQ ($34.70 in chips)
Seat 3: ssLJburtEIqnVkx6X8R1uw ($122.90 in chips)
Seat 4: ru6SCVvWcWt2SpmUsmArWQ ($21 in chips)
Seat 5: hpxXcmRkXXI9HE5+5/j/0Q ($100 in chips)
Seat 6: b2a+5TkFf4xJN/Ihhma58Q ($17.80 in chips)
b2a+5TkFf4xJN/Ihhma58Q: posts small blind $0.50
ecfRjfaWRYbPNvaBsW5ZQQ: posts big blind $1
*** HOLE CARDS ***
ssLJburtEIqnVkx6X8R1uw: folds
ru6SCVvWcWt2SpmUsmArWQ: folds
hpxXcmRkXXI9HE5+5/j/0Q: raises $3 to $4
b2a+5TkFf4xJN/Ihhma58Q: folds
ecfRjfaWRYbPNvaBsW5ZQQ: folds
hpxXcmRkXXI9HE5+5/j/0Q collected $2.50 from pot
hpxXcmRkXXI9HE5+5/j/0Q: doesn't show hand
*** SUMMARY ***
Total pot $2.50 | Rake $0
Seat 2: ecfRjfaWRYbPNvaBsW5ZQQ (big blind) folded before Flop
Seat 3: ssLJburtEIqnVkx6X8R1uw folded before Flop (didn't bet)
Seat 4: ru6SCVvWcWt2SpmUsmArWQ folded before Flop (didn't bet)
Seat 5: hpxXcmRkXXI9HE5+5/j/0Q (button) collected ($2.50)
Seat 6: b2a+5TkFf4xJN/Ihhma58Q (small blind) folded before Flop



PokerStars Game #59938656320:  Hold'em No Limit ($0.50/$1.00) - 2009/07/01 0:20:15 ET
Table 'rmZfTK+oSebeUPJNbWhdAA' 6-max Seat #6 is the button
Seat 1: u4vYQZNWtIzOJre8fvCmvQ ($45.85 in chips)
Seat 2: OigyyiK+tTj1APPIAUmXDA ($65.45 in chips)
Seat 3: 9yjOzGERLaEZS8CZ6YNHFg ($62.80 in chips)
Seat 4: OGMLOcTNYZXZU81au7ztUw ($105.05 in chips)
Seat 5: VuZb/hkEc4X7s93w2ZZTpA ($112.75 in chips)
Seat 6: j7NIOHLZk7V2o9fOioO5ug ($104.80 in chips)
u4vYQZNWtIzOJre8fvCmvQ: posts small blind $0.50
OigyyiK+tTj1APPIAUmXDA: posts big blind $1
*** HOLE CARDS ***
9yjOzGERLaEZS8CZ6YNHFg: folds
OGMLOcTNYZXZU81au7ztUw: folds
VuZb/hkEc4X7s93w2ZZTpA: folds
j7NIOHLZk7V2o9fOioO5ug: folds
u4vYQZNWtIzOJre8fvCmvQ: calls $0.50
OigyyiK+tTj1APPIAUmXDA: checks
*** FLOP *** [8h 6c Qs]
u4vYQZNWtIzOJre8fvCmvQ: checks
OigyyiK+tTj1APPIAUmXDA: checks
*** TURN *** [8h 6c Qs] [Ts]
u4vYQZNWtIzOJre8fvCmvQ: bets $2
OigyyiK+tTj1APPIAUmXDA: calls $2
*** RIVER *** [8h 6c Qs Ts] [6s]
u4vYQZNWtIzOJre8fvCmvQ: bets $3
OigyyiK+tTj1APPIAUmXDA: raises $7 to $10
u4vYQZNWtIzOJre8fvCmvQ: calls $7
*** SHOW DOWN ***
OigyyiK+tTj1APPIAUmXDA: shows [6d Th] (a full house, Sixes full of Tens)
u4vYQZNWtIzOJre8fvCmvQ: mucks hand
OigyyiK+tTj1APPIAUmXDA collected $24.75 from pot
*** SUMMARY ***
Total pot $26 | Rake $1.25
Board [8h 6c Qs Ts 6s]
Seat 1: u4vYQZNWtIzOJre8fvCmvQ (small blind) mucked
Seat 2: OigyyiK+tTj1APPIAUmXDA (big blind) showed [6d Th] and won ($24.75) with a full house, Sixes full of Tens
Seat 3: 9yjOzGERLaEZS8CZ6YNHFg folded before Flop (didn't bet)
Seat 4: OGMLOcTNYZXZU81au7ztUw folded before Flop (didn't bet)
Seat 5: VuZb/hkEc4X7s93w2ZZTpA folded before Flop (didn't bet)
Seat 6: j7NIOHLZk7V2o9fOioO5ug (button) folded before Flop (didn't bet)



PokerStars Game #59938657296:  Hold'em No Limit ($0.50/$1.00) - 2009/07/01 0:20:17 ET
Table 'aWHveb63HkbTmOGHOxjBkQ' 2-max Seat #1 is the button
Seat 1: xy2MQKoHoCZZIudmw8Xbow ($205.20 in chips)
Seat 2: xstEKavv3YDxpUnU4e9qAQ ($169.60 in chips)
xy2MQKoHoCZZIudmw8Xbow: posts small blind $0.50
xstEKavv3YDxpUnU4e9qAQ: posts big blind $1
*** HOLE CARDS ***
xy2MQKoHoCZZIudmw8Xbow: folds
xstEKavv3YDxpUnU4e9qAQ collected $1 from pot
*** SUMMARY ***
Total pot $1 | Rake $0
Seat 1: xy2MQKoHoCZZIudmw8Xbow (button) (small blind) folded before Flop
Seat 2: xstEKavv3YDxpUnU4e9qAQ (big blind) collected ($1)



PokerStars Game #59938658532:  Hold'em No Limit ($0.50/$1.00) - 2009/07/01 0:20:19 ET
Table '/+ni2d7lj6E90JmAQZKSOw' 2-max Seat #2 is the button
Seat 1: qubgcbkrXfMjdrMEd1lYMQ ($252.70 in chips)
Seat 2: IJu7Boitu3yAxp4hjIx6zQ ($117.90 in chips)
IJu7Boitu3yAxp4hjIx6zQ: posts small blind $0.50
qubgcbkrXfMjdrMEd1lYMQ: posts big blind $1
*** HOLE CARDS ***
IJu7Boitu3yAxp4hjIx6zQ: raises $2 to $3
qubgcbkrXfMjdrMEd1lYMQ: folds
IJu7Boitu3yAxp4hjIx6zQ collected $2 from pot
IJu7Boitu3yAxp4hjIx6zQ: doesn't show hand
*** SUMMARY ***
Total pot $2 | Rake $0
Seat 1: qubgcbkrXfMjdrMEd1lYMQ (big blind) folded before Flop
Seat 2: IJu7Boitu3yAxp4hjIx6zQ (button) (small blind) collected ($2)



PokerStars Game #59938658828:  Hold'em No Limit ($0.50/$1.00) - 2009/07/01 0:20:19 ET
Table 'U9zqzC8f3oTJ2ShXFgSSOA' 6-max Seat #2 is the button
Seat 1: tS9JHB1h+FQ++qu8RwRNgg ($17.95 in chips)
Seat 2: U2CWBTv29qdCbj8RNF2sIw ($110.30 in chips)
Seat 3: yfXek8iJ7O4CFyqXrtGcfg ($43 in chips)
Seat 4: 33q95we0Etwgrm6guQGncw ($75.40 in chips)
Seat 5: KfwW5us6tydK81NYTtK1gw ($194.75 in chips)
Seat 6: aIxzFKdtpDSkUePKZy/niQ ($58.50 in chips)
yfXek8iJ7O4CFyqXrtGcfg: posts small blind $0.50
33q95we0Etwgrm6guQGncw: posts big blind $1
*** HOLE CARDS ***
KfwW5us6tydK81NYTtK1gw: folds
aIxzFKdtpDSkUePKZy/niQ: raises $3 to $4
tS9JHB1h+FQ++qu8RwRNgg: folds
U2CWBTv29qdCbj8RNF2sIw: folds
yfXek8iJ7O4CFyqXrtGcfg: folds
33q95we0Etwgrm6guQGncw: folds
aIxzFKdtpDSkUePKZy/niQ collected $2.50 from pot
*** SUMMARY ***
Total pot $2.50 | Rake $0
Seat 1: tS9JHB1h+FQ++qu8RwRNgg folded before Flop (didn't bet)
Seat 2: U2CWBTv29qdCbj8RNF2sIw (button) folded before Flop (didn't bet)
Seat 3: yfXek8iJ7O4CFyqXrtGcfg (small blind) folded before Flop
Seat 4: 33q95we0Etwgrm6guQGncw (big blind) folded before Flop
Seat 5: KfwW5us6tydK81NYTtK1gw folded before Flop (didn't bet)
Seat 6: aIxzFKdtpDSkUePKZy/niQ collected ($2.50)



PokerStars Game #59938658424:  Hold'em No Limit ($0.50/$1.00) - 2009/07/01 0:20:19 ET
Table 'O96CPOtvMBWP6kzuYDfdFA' 6-max Seat #6 is the button
Seat 1: yl9aRDw7k/ieGiDoJVy+/w ($64.60 in chips)
Seat 2: vTUNrd/7qIOJpW0suEu5hQ ($212.40 in chips)
Seat 5: wRxiu9OJzvvN84OYWW9jxQ ($128.85 in chips)
Seat 6: xNKcQzD9+/iHmtJn4vYq9w ($74 in chips)
yl9aRDw7k/ieGiDoJVy+/w: posts small blind $0.50
vTUNrd/7qIOJpW0suEu5hQ: posts big blind $1
V89DGjxE171oPREEbAXiyg: sits out
*** HOLE CARDS ***
wRxiu9OJzvvN84OYWW9jxQ: calls $1
xNKcQzD9+/iHmtJn4vYq9w: folds
yl9aRDw7k/ieGiDoJVy+/w: raises $4 to $5
vTUNrd/7qIOJpW0suEu5hQ: folds
wRxiu9OJzvvN84OYWW9jxQ: calls $4
*** FLOP *** [Qc 3s 5h]
yl9aRDw7k/ieGiDoJVy+/w: checks
wRxiu9OJzvvN84OYWW9jxQ: checks
*** TURN *** [Qc 3s 5h] [Tc]
yl9aRDw7k/ieGiDoJVy+/w: bets $7
wRxiu9OJzvvN84OYWW9jxQ: folds
yl9aRDw7k/ieGiDoJVy+/w collected $10.45 from pot
*** SUMMARY ***
Total pot $11 | Rake $0.55
Board [Qc 3s 5h Tc]
Seat 1: yl9aRDw7k/ieGiDoJVy+/w (small blind) collected ($10.45)
Seat 2: vTUNrd/7qIOJpW0suEu5hQ (big blind) folded before Flop
Seat 5: wRxiu9OJzvvN84OYWW9jxQ folded on the Turn
Seat 6: xNKcQzD9+/iHmtJn4vYq9w (button) folded before Flop (didn't bet)



PokerStars Game #59938659198:  Hold'em No Limit ($0.50/$1.00) - 2009/07/01 0:20:20 ET
Table 'tLrtq7gDzxEvckNAI1OS5Q' 6-max Seat #1 is the button
Seat 1: GisIe1kcC9q/xV6ifsTjgA ($155.85 in chips)
Seat 2: qsObMEIlRO22OlS867m/lw ($28.35 in chips)
Seat 3: TPZ+m9x+lwoKpv7TMfAUWA ($323.85 in chips)
Seat 5: OGMLOcTNYZXZU81au7ztUw ($175.15 in chips)
Seat 6: XUk5GQsfNFpHvaToDZ0rZA ($22.65 in chips)
qsObMEIlRO22OlS867m/lw: posts small blind $0.50
TPZ+m9x+lwoKpv7TMfAUWA: posts big blind $1
KOG8rG51mOvIoY96zF3kvw: sits out
*** HOLE CARDS ***
OGMLOcTNYZXZU81au7ztUw: folds
XUk5GQsfNFpHvaToDZ0rZA: folds
GisIe1kcC9q/xV6ifsTjgA: folds
qsObMEIlRO22OlS867m/lw: calls $0.50
TPZ+m9x+lwoKpv7TMfAUWA: checks
*** FLOP *** [Ts 3s 4s]
qsObMEIlRO22OlS867m/lw: checks
TPZ+m9x+lwoKpv7TMfAUWA: bets $1
qsObMEIlRO22OlS867m/lw: folds
TPZ+m9x+lwoKpv7TMfAUWA collected $1.90 from pot
*** SUMMARY ***
Total pot $2 | Rake $0.10
Board [Ts 3s 4s]
Seat 1: GisIe1kcC9q/xV6ifsTjgA (button) folded before Flop (didn't bet)
Seat 2: qsObMEIlRO22OlS867m/lw (small blind) folded on the Flop
Seat 3: TPZ+m9x+lwoKpv7TMfAUWA (big blind) collected ($1.90)
Seat 5: OGMLOcTNYZXZU81au7ztUw folded before Flop (didn't bet)
Seat 6: XUk5GQsfNFpHvaToDZ0rZA folded before Flop (didn't bet)



PokerStars Game #59938660042:  Hold'em No Limit ($0.50/$1.00) - 2009/07/01 0:20:21 ET
Table 'vs/5jr6ciwjVQ5+Soc+u2A' 6-max Seat #5 is the button
Seat 2: XOIf9W+VAxhZqN+SYoyMKA ($116.80 in chips)
Seat 3: G5ZSSN6RSON3gkNvk/SmYg ($100 in chips)
Seat 4: KpnW5CcJ4Mg6MeclfKmLrw ($106.15 in chips)
Seat 5: 7Vc9JmGFQwMRh5Tj9ui5Lw ($98.65 in chips)
Seat 6: QHvTZcrKe6+maWUfVjP29Q ($100 in chips)
QHvTZcrKe6+maWUfVjP29Q: posts small blind $0.50
XOIf9W+VAxhZqN+SYoyMKA: posts big blind $1
*** HOLE CARDS ***
G5ZSSN6RSON3gkNvk/SmYg: folds
KpnW5CcJ4Mg6MeclfKmLrw: folds
7Vc9JmGFQwMRh5Tj9ui5Lw: folds
QHvTZcrKe6+maWUfVjP29Q: folds
XOIf9W+VAxhZqN+SYoyMKA collected $1 from pot
XOIf9W+VAxhZqN+SYoyMKA: doesn't show hand
*** SUMMARY ***
Total pot $1 | Rake $0
Seat 2: XOIf9W+VAxhZqN+SYoyMKA (big blind) collected ($1)
Seat 3: G5ZSSN6RSON3gkNvk/SmYg folded before Flop (didn't bet)
Seat 4: KpnW5CcJ4Mg6MeclfKmLrw folded before Flop (didn't bet)
Seat 5: 7Vc9JmGFQwMRh5Tj9ui5Lw (button) folded before Flop (didn't bet)
Seat 6: QHvTZcrKe6+maWUfVjP29Q (small blind) folded before Flop



PokerStars Game #59938660006:  Hold'em No Limit ($0.50/$1.00) - 2009/07/01 0:20:21 ET
Table 'fTlPiCj0utgzC/5io+I7ew' 6-max Seat #4 is the button
Seat 1: YMJG+F++3Aj6P8dAWda5fw ($100 in chips)
Seat 2: +xUCTmR3cU7G239W+vZv6g ($140.50 in chips)
Seat 4: uJVSceLggtsrJya+WtmUEA ($101.60 in chips)
Seat 5: bFrTkDcWGTxyvNul7GVdYg ($239.50 in chips)
bFrTkDcWGTxyvNul7GVdYg: posts small blind $0.50
YMJG+F++3Aj6P8dAWda5fw: posts big blind $1
*** HOLE CARDS ***
+xUCTmR3cU7G239W+vZv6g: folds
uJVSceLggtsrJya+WtmUEA: folds
bFrTkDcWGTxyvNul7GVdYg: folds
YMJG+F++3Aj6P8dAWda5fw collected $1 from pot
*** SUMMARY ***
Total pot $1 | Rake $0
Seat 1: YMJG+F++3Aj6P8dAWda5fw (big blind) collected ($1)
Seat 2: +xUCTmR3cU7G239W+vZv6g folded before Flop (didn't bet)
Seat 4: uJVSceLggtsrJya+WtmUEA (button) folded before Flop (didn't bet)
Seat 5: bFrTkDcWGTxyvNul7GVdYg (small blind) folded before Flop



PokerStars Game #59938660864:  Hold'em No Limit ($0.50/$1.00) - 2009/07/01 0:20:22 ET
Table 'pHrhryH8jPNdQfY62f8v+g' 6-max Seat #6 is the button
Seat 1: BdbmJTZZ47quA9vUWwXtlw ($73.75 in chips)
Seat 2: RqgF7gRoKgRNW8Zoi1ty4A ($100 in chips)
Seat 3: rw4J9hTeo4c+qBV5IU/aQQ ($18.30 in chips)
Seat 4: wenbG7TaM3H7h5kn78OFNw ($55.55 in chips)
Seat 5: Gp2euK/nqF6qXKe7U+jOfw ($120.15 in chips)
Seat 6: xNKcQzD9+/iHmtJn4vYq9w ($212.15 in chips)
BdbmJTZZ47quA9vUWwXtlw: posts small blind $0.50
RqgF7gRoKgRNW8Zoi1ty4A: posts big blind $1
*** HOLE CARDS ***
rw4J9hTeo4c+qBV5IU/aQQ: calls $1
wenbG7TaM3H7h5kn78OFNw: folds
Gp2euK/nqF6qXKe7U+jOfw: folds
xNKcQzD9+/iHmtJn4vYq9w: raises $3 to $4
BdbmJTZZ47quA9vUWwXtlw: calls $3.50
RqgF7gRoKgRNW8Zoi1ty4A: calls $3
rw4J9hTeo4c+qBV5IU/aQQ: folds
*** FLOP *** [3h 5s 7h]
BdbmJTZZ47quA9vUWwXtlw: checks
RqgF7gRoKgRNW8Zoi1ty4A: checks
xNKcQzD9+/iHmtJn4vYq9w: bets $9
BdbmJTZZ47quA9vUWwXtlw: folds
RqgF7gRoKgRNW8Zoi1ty4A: folds
xNKcQzD9+/iHmtJn4vYq9w collected $12.35 from pot
*** SUMMARY ***
Total pot $13 | Rake $0.65
Board [3h 5s 7h]
Seat 1: BdbmJTZZ47quA9vUWwXtlw (small blind) folded on the Flop
Seat 2: RqgF7gRoKgRNW8Zoi1ty4A (big blind) folded on the Flop
Seat 3: rw4J9hTeo4c+qBV5IU/aQQ folded before Flop
Seat 4: wenbG7TaM3H7h5kn78OFNw folded before Flop (didn't bet)
Seat 5: Gp2euK/nqF6qXKe7U+jOfw folded before Flop (didn't bet)
Seat 6: xNKcQzD9+/iHmtJn4vYq9w (button) collected ($12.35)



PokerStars Game #59938661940:  Hold'em No Limit ($0.50/$1.00) - 2009/07/01 0:20:23 ET
Table 'aWHveb63HkbTmOGHOxjBkQ' 2-max Seat #2 is the button
Seat 1: xy2MQKoHoCZZIudmw8Xbow ($204.70 in chips)
Seat 2: xstEKavv3YDxpUnU4e9qAQ ($170.10 in chips)
xstEKavv3YDxpUnU4e9qAQ: posts small blind $0.50
xy2MQKoHoCZZIudmw8Xbow: posts big blind $1
*** HOLE CARDS ***
xstEKavv3YDxpUnU4e9qAQ: folds
xy2MQKoHoCZZIudmw8Xbow collected $1 from pot
xy2MQKoHoCZZIudmw8Xbow: doesn't show hand
*** SUMMARY ***
Total pot $1 | Rake $0
Seat 1: xy2MQKoHoCZZIudmw8Xbow (big blind) collected ($1)
Seat 2: xstEKavv3YDxpUnU4e9qAQ (button) (small blind) folded before Flop



PokerStars Game #59938662052:  Hold'em No Limit ($0.50/$1.00) - 2009/07/01 0:20:24 ET
Table '/RZcOwpZpHQ+OwPwjsbnRw' 6-max Seat #5 is the button
Seat 1: jMljU/dOPMXfJi8OmbdYdw ($47.65 in chips)
Seat 2: dHC9PH9hdH3Ad2TD8ZxX0Q ($47.10 in chips)
Seat 3: OigyyiK+tTj1APPIAUmXDA ($80.60 in chips)
Seat 4: j7NIOHLZk7V2o9fOioO5ug ($108.90 in chips)
Seat 5: wx3sQGkVi2x9wJXuWNHPBw ($208.05 in chips)
Seat 6: XOIf9W+VAxhZqN+SYoyMKA ($148.40 in chips)
XOIf9W+VAxhZqN+SYoyMKA: posts small blind $0.50
jMljU/dOPMXfJi8OmbdYdw: posts big blind $1
*** HOLE CARDS ***
dHC9PH9hdH3Ad2TD8ZxX0Q: folds
OigyyiK+tTj1APPIAUmXDA: folds
j7NIOHLZk7V2o9fOioO5ug: raises $2 to $3
wx3sQGkVi2x9wJXuWNHPBw: folds
XOIf9W+VAxhZqN+SYoyMKA: raises $8 to $11
jMljU/dOPMXfJi8OmbdYdw: folds
j7NIOHLZk7V2o9fOioO5ug: calls $8
*** FLOP *** [3h Ks 4h]
XOIf9W+VAxhZqN+SYoyMKA: bets $17
j7NIOHLZk7V2o9fOioO5ug: raises $80.90 to $97.90 and is all-in
XOIf9W+VAxhZqN+SYoyMKA: calls $80.90
*** TURN *** [3h Ks 4h] [4s]
*** RIVER *** [3h Ks 4h 4s] [9s]
*** SHOW DOWN ***
XOIf9W+VAxhZqN+SYoyMKA: shows [Kd Ac] (two pair, Kings and Fours)
j7NIOHLZk7V2o9fOioO5ug: mucks hand
XOIf9W+VAxhZqN+SYoyMKA collected $215.80 from pot
*** SUMMARY ***
Total pot $218.80 | Rake $3
Board [3h Ks 4h 4s 9s]
Seat 1: jMljU/dOPMXfJi8OmbdYdw (big blind) folded before Flop
Seat 2: dHC9PH9hdH3Ad2TD8ZxX0Q folded before Flop (didn't bet)
Seat 3: OigyyiK+tTj1APPIAUmXDA folded before Flop (didn't bet)
Seat 4: j7NIOHLZk7V2o9fOioO5ug mucked
Seat 5: wx3sQGkVi2x9wJXuWNHPBw (button) folded before Flop (didn't bet)
Seat 6: XOIf9W+VAxhZqN+SYoyMKA (small blind) showed [Kd Ac] and won ($215.80) with two pair, Kings and Fours



PokerStars Game #59938664556:  Hold'em No Limit ($0.50/$1.00) - 2009/07/01 0:20:27 ET
Table '/+ni2d7lj6E90JmAQZKSOw' 2-max Seat #1 is the button
Seat 1: qubgcbkrXfMjdrMEd1lYMQ ($251.70 in chips)
Seat 2: IJu7Boitu3yAxp4hjIx6zQ ($118.90 in chips)
qubgcbkrXfMjdrMEd1lYMQ: posts small blind $0.50
IJu7Boitu3yAxp4hjIx6zQ: posts big blind $1
*** HOLE CARDS ***
qubgcbkrXfMjdrMEd1lYMQ: raises $2 to $3
IJu7Boitu3yAxp4hjIx6zQ: folds
qubgcbkrXfMjdrMEd1lYMQ collected $2 from pot
qubgcbkrXfMjdrMEd1lYMQ: doesn't show hand
*** SUMMARY ***
Total pot $2 | Rake $0
Seat 1: qubgcbkrXfMjdrMEd1lYMQ (button) (small blind) collected ($2)
Seat 2: IJu7Boitu3yAxp4hjIx6zQ (big blind) folded before Flop



PokerStars Game #59938664640:  Hold'em No Limit ($0.50/$1.00) - 2009/07/01 0:20:27 ET
Table 'blHlQApStil0OPeQxQxPcwFKpXUINE6M3UxHG4zaMhHAx Seat #3 is the button
Seat 1: x80+i7DJL+81v3quj7KbNg ($20 in chips)
Seat 2: wIZ377kjl2fHFGnS93o6bw ($38.50 in chips)
Seat 3: o1axyw4AjQ8n4ubTwlirQQ ($26.20 in chips)
Seat 4: zanka7aAZkigmZpfopXxxA ($35.80 in chips)
Seat 5: uXrDE6JrIi8BZK1L8oQ9bQ ($20 in chips)
Seat 6: JPQzLacMGzeh42mPgyrvVQ ($72.10 in chips)
Seat 7: vR4IO10geOgvTW+LAUBv/A ($111 in chips)
Seat 8: VtjmCz/ASIcETatNJ8YcCA ($68.65 in chips)
zanka7aAZkigmZpfopXxxA: posts small blind $0.50
uXrDE6JrIi8BZK1L8oQ9bQ: posts big blind $1
*** HOLE CARDS ***
JPQzLacMGzeh42mPgyrvVQ: folds
vR4IO10geOgvTW+LAUBv/A: folds
VtjmCz/ASIcETatNJ8YcCA: folds
x80+i7DJL+81v3quj7KbNg: raises $2 to $3
wIZ377kjl2fHFGnS93o6bw: calls $3
o1axyw4AjQ8n4ubTwlirQQ: folds
zanka7aAZkigmZpfopXxxA: folds
uXrDE6JrIi8BZK1L8oQ9bQ: folds
*** FLOP *** [As 4h 2c]
x80+i7DJL+81v3quj7KbNg: bets $3
wIZ377kjl2fHFGnS93o6bw: folds
x80+i7DJL+81v3quj7KbNg collected $7.15 from pot
x80+i7DJL+81v3quj7KbNg: doesn't show hand
*** SUMMARY ***
Total pot $7.50 | Rake $0.35
Board [As 4h 2c]
Seat 1: x80+i7DJL+81v3quj7KbNg collected ($7.15)
Seat 2: wIZ377kjl2fHFGnS93o6bw folded on the Flop
Seat 3: o1axyw4AjQ8n4ubTwlirQQ (button) folded before Flop (didn't bet)
Seat 4: zanka7aAZkigmZpfopXxxA (small blind) folded before Flop
Seat 5: uXrDE6JrIi8BZK1L8oQ9bQ (big blind) folded before Flop
Seat 6: JPQzLacMGzeh42mPgyrvVQ folded before Flop (didn't bet)
Seat 7: vR4IO10geOgvTW+LAUBv/A folded before Flop (didn't bet)
Seat 8: VtjmCz/ASIcETatNJ8YcCA folded before Flop (didn't bet)



PokerStars Game #59938665992:  Hold'em No Limit ($0.50/$1.00) - 2009/07/01 0:20:29 ET
Table 'tyUh+jyNvrceIQdKMJjQ2wZFWj23PMihdwrNWv41OG/Qeat #6 is the button
Seat 1: o8A5MUdudVKu+pAwgZOX2w ($198.25 in chips)
Seat 2: 6iVcnPw9a2oNG6sPQo3G6g ($98.75 in chips)
Seat 3: L9qfLYXrczhAPd/VckgsWw ($38.60 in chips)
Seat 5: j7NIOHLZk7V2o9fOioO5ug ($103.10 in chips)
Seat 6: YsLQ3BAvgQHWXMAv3Wv6Hg ($105.25 in chips)
o8A5MUdudVKu+pAwgZOX2w: posts small blind $0.50
6iVcnPw9a2oNG6sPQo3G6g: posts big blind $1
*** HOLE CARDS ***
L9qfLYXrczhAPd/VckgsWw: folds
j7NIOHLZk7V2o9fOioO5ug: folds
YsLQ3BAvgQHWXMAv3Wv6Hg: folds
o8A5MUdudVKu+pAwgZOX2w: calls $0.50
6iVcnPw9a2oNG6sPQo3G6g: checks
*** FLOP *** [2c 9s As]
o8A5MUdudVKu+pAwgZOX2w: checks
6iVcnPw9a2oNG6sPQo3G6g: checks
*** TURN *** [2c 9s As] [6h]
o8A5MUdudVKu+pAwgZOX2w: checks
6iVcnPw9a2oNG6sPQo3G6g: checks
*** RIVER *** [2c 9s As 6h] [Qd]
o8A5MUdudVKu+pAwgZOX2w: checks
6iVcnPw9a2oNG6sPQo3G6g: checks
*** SHOW DOWN ***
o8A5MUdudVKu+pAwgZOX2w: shows [7c 5d] (high card Ace)
6iVcnPw9a2oNG6sPQo3G6g: shows [Th 3s] (high card Ace - Queen+Ten kicker)
6iVcnPw9a2oNG6sPQo3G6g collected $1.90 from pot
*** SUMMARY ***
Total pot $2 | Rake $0.10
Board [2c 9s As 6h Qd]
Seat 1: o8A5MUdudVKu+pAwgZOX2w (small blind) showed [7c 5d] and lost with high card Ace
Seat 2: 6iVcnPw9a2oNG6sPQo3G6g (big blind) showed [Th 3s] and won ($1.90) with high card Ace
Seat 3: L9qfLYXrczhAPd/VckgsWw folded before Flop (didn't bet)
Seat 5: j7NIOHLZk7V2o9fOioO5ug folded before Flop (didn't bet)
Seat 6: YsLQ3BAvgQHWXMAv3Wv6Hg (button) folded before Flop (didn't bet)



PokerStars Game #59938665652:  Hold'em No Limit ($0.50/$1.00) - 2009/07/01 0:20:29 ET
Table 'aWHveb63HkbTmOGHOxjBkQ' 2-max Seat #1 is the button
Seat 1: xy2MQKoHoCZZIudmw8Xbow ($205.20 in chips)
Seat 2: xstEKavv3YDxpUnU4e9qAQ ($169.60 in chips)
xy2MQKoHoCZZIudmw8Xbow: posts small blind $0.50
xstEKavv3YDxpUnU4e9qAQ: posts big blind $1
*** HOLE CARDS ***
xy2MQKoHoCZZIudmw8Xbow: raises $3 to $4
xstEKavv3YDxpUnU4e9qAQ: calls $3
*** FLOP *** [8h Ks Tc]
xstEKavv3YDxpUnU4e9qAQ: checks
xy2MQKoHoCZZIudmw8Xbow: bets $4
xstEKavv3YDxpUnU4e9qAQ: folds
xy2MQKoHoCZZIudmw8Xbow collected $7.60 from pot
xy2MQKoHoCZZIudmw8Xbow: doesn't show hand
*** SUMMARY ***
Total pot $8 | Rake $0.40
Board [8h Ks Tc]
Seat 1: xy2MQKoHoCZZIudmw8Xbow (button) (small blind) collected ($7.60)
Seat 2: xstEKavv3YDxpUnU4e9qAQ (big blind) folded on the Flop



PokerStars Game #59938666340:  Hold'em No Limit ($0.50/$1.00) - 2009/07/01 0:20:30 ET
Table 'cKH9c4x6u79IqCdaKKvXrw' 9-max Seat #4 is the button
Seat 1: p1SafS90nb3Uft5LB0NkHw ($20 in chips)
Seat 2: knewtTmBc4Tc0z/5tAABYQ ($196.50 in chips)
Seat 4: FL3MrLspcF23LYvC4ipBOA ($100 in chips)
Seat 5: negfosHnGOZXSHpWDRKyBQ ($29.20 in chips)
Seat 6: Bsd/K5gAcLanYbGiPirRjw ($169.25 in chips)
Seat 7: 0eFnow7+D7veCYQ+CG9FFw ($94.35 in chips)
Seat 8: 4/8w7g4QE6v0i1tIIf/1HQ ($56 in chips)
negfosHnGOZXSHpWDRKyBQ: posts small blind $0.50
Bsd/K5gAcLanYbGiPirRjw: posts big blind $1
ezwei: sits out
*** HOLE CARDS ***
0eFnow7+D7veCYQ+CG9FFw: folds
0eFnow7+D7veCYQ+CG9FFw leaves the table
4/8w7g4QE6v0i1tIIf/1HQ: raises $1 to $2
p1SafS90nb3Uft5LB0NkHw: folds
knewtTmBc4Tc0z/5tAABYQ: folds
FL3MrLspcF23LYvC4ipBOA: folds
negfosHnGOZXSHpWDRKyBQ: folds
Bsd/K5gAcLanYbGiPirRjw: folds
4/8w7g4QE6v0i1tIIf/1HQ collected $2.50 from pot
*** SUMMARY ***
Total pot $2.50 | Rake $0
Seat 1: p1SafS90nb3Uft5LB0NkHw folded before Flop (didn't bet)
Seat 2: knewtTmBc4Tc0z/5tAABYQ folded before Flop (didn't bet)
Seat 4: FL3MrLspcF23LYvC4ipBOA (button) folded before Flop (didn't bet)
Seat 5: negfosHnGOZXSHpWDRKyBQ (small blind) folded before Flop
Seat 6: Bsd/K5gAcLanYbGiPirRjw (big blind) folded before Flop
Seat 7: 0eFnow7+D7veCYQ+CG9FFw folded before Flop (didn't bet)
Seat 8: 4/8w7g4QE6v0i1tIIf/1HQ collected ($2.50)



PokerStars Game #59938667654:  Hold'em No Limit ($0.50/$1.00) - 2009/07/01 0:20:32 ET
Table '+cA8mcmhaedZ7YcrDdhmeQ' 6-max Seat #2 is the button
Seat 1: lsLuWlcPA3Rh7kJVLzMh0Q ($233 in chips)
Seat 2: trnpu4tPju3BU8W0wQQaiQ ($96.10 in chips)
Seat 3: 0WjiuIT7/EolY1oOx1ngeA ($141.80 in chips)
Seat 4: j0aDOn9Nft1HLTQvGu1UwA ($23.10 in chips)
Seat 5: 6WyjEXOToimYmtLdqIgHYQ ($62 in chips)
Seat 6: YfsTQsY/fxb+YqbdclTHuw ($86.65 in chips)
0WjiuIT7/EolY1oOx1ngeA: posts small blind $0.50
j0aDOn9Nft1HLTQvGu1UwA: posts big blind $1
*** HOLE CARDS ***
6WyjEXOToimYmtLdqIgHYQ: folds
YfsTQsY/fxb+YqbdclTHuw: raises $3 to $4
lsLuWlcPA3Rh7kJVLzMh0Q: folds
trnpu4tPju3BU8W0wQQaiQ: calls $4
0WjiuIT7/EolY1oOx1ngeA: calls $3.50
j0aDOn9Nft1HLTQvGu1UwA: calls $3
*** FLOP *** [8d 4h 9c]
0WjiuIT7/EolY1oOx1ngeA: checks
j0aDOn9Nft1HLTQvGu1UwA: bets $2
YfsTQsY/fxb+YqbdclTHuw: raises $6 to $8
trnpu4tPju3BU8W0wQQaiQ: folds
0WjiuIT7/EolY1oOx1ngeA: folds
j0aDOn9Nft1HLTQvGu1UwA: folds
YfsTQsY/fxb+YqbdclTHuw collected $19.05 from pot
*** SUMMARY ***
Total pot $20 | Rake $0.95
Board [8d 4h 9c]
Seat 1: lsLuWlcPA3Rh7kJVLzMh0Q folded before Flop (didn't bet)
Seat 2: trnpu4tPju3BU8W0wQQaiQ (button) folded on the Flop
Seat 3: 0WjiuIT7/EolY1oOx1ngeA (small blind) folded on the Flop
Seat 4: j0aDOn9Nft1HLTQvGu1UwA (big blind) folded on the Flop
Seat 5: 6WyjEXOToimYmtLdqIgHYQ folded before Flop (didn't bet)
Seat 6: YfsTQsY/fxb+YqbdclTHuw collected ($19.05)



PokerStars Game #59938669912:  Hold'em No Limit ($0.50/$1.00) - 2009/07/01 0:20:35 ET
Table '/+ni2d7lj6E90JmAQZKSOw' 2-max Seat #2 is the button
Seat 1: qubgcbkrXfMjdrMEd1lYMQ ($252.70 in chips)
Seat 2: IJu7Boitu3yAxp4hjIx6zQ ($117.90 in chips)
IJu7Boitu3yAxp4hjIx6zQ: posts small blind $0.50
qubgcbkrXfMjdrMEd1lYMQ: posts big blind $1
*** HOLE CARDS ***
IJu7Boitu3yAxp4hjIx6zQ: folds
qubgcbkrXfMjdrMEd1lYMQ collected $1 from pot
*** SUMMARY ***
Total pot $1 | Rake $0
Seat 1: qubgcbkrXfMjdrMEd1lYMQ (big blind) collected ($1)
Seat 2: IJu7Boitu3yAxp4hjIx6zQ (button) (small blind) folded before Flop



PokerStars Game #59938670014:  Hold'em No Limit ($0.50/$1.00) - 2009/07/01 0:20:35 ET
Table 'W/wyObTiXZm+Ckkl3YxcSw' 6-max Seat #1 is the button
Seat 1: ssLJburtEIqnVkx6X8R1uw ($118.85 in chips)
Seat 3: b2a+5TkFf4xJN/Ihhma58Q ($39.20 in chips)
Seat 4: BdbmJTZZ47quA9vUWwXtlw ($51.60 in chips)
Seat 5: Wko+clJG9HZPPQ7Yn0Y5Zg ($24 in chips)
Seat 6: GwvR1vWAchnuOBZu0dm5Rg ($112.50 in chips)
b2a+5TkFf4xJN/Ihhma58Q: posts small blind $0.50
BdbmJTZZ47quA9vUWwXtlw: posts big blind $1
*** HOLE CARDS ***
Wko+clJG9HZPPQ7Yn0Y5Zg: calls $1
o2BpeCDF/L1yw7HKjemvYg leaves the table
GwvR1vWAchnuOBZu0dm5Rg: folds
ssLJburtEIqnVkx6X8R1uw: folds
b2a+5TkFf4xJN/Ihhma58Q: calls $0.50
oDiBRCaF0QVtd3kO6xZIXw joins the table at seat #2
BdbmJTZZ47quA9vUWwXtlw: checks
*** FLOP *** [8c Jc Ad]
b2a+5TkFf4xJN/Ihhma58Q: checks
BdbmJTZZ47quA9vUWwXtlw: checks
Wko+clJG9HZPPQ7Yn0Y5Zg: bets $2
b2a+5TkFf4xJN/Ihhma58Q: folds
GwvR1vWAchnuOBZu0dm5Rg leaves the table
BdbmJTZZ47quA9vUWwXtlw: folds
Wko+clJG9HZPPQ7Yn0Y5Zg collected $2.85 from pot
Wko+clJG9HZPPQ7Yn0Y5Zg: doesn't show hand
*** SUMMARY ***
Total pot $3 | Rake $0.15
Board [8c Jc Ad]
Seat 1: ssLJburtEIqnVkx6X8R1uw (button) folded before Flop (didn't bet)
Seat 3: b2a+5TkFf4xJN/Ihhma58Q (small blind) folded on the Flop
Seat 4: BdbmJTZZ47quA9vUWwXtlw (big blind) folded on the Flop
Seat 5: Wko+clJG9HZPPQ7Yn0Y5Zg collected ($2.85)
Seat 6: GwvR1vWAchnuOBZu0dm5Rg folded before Flop (didn't bet)



PokerStars Game #59938670346:  Hold'em No Limit ($0.50/$1.00) - 2009/07/01 0:20:36 ET
Table 'fTlPiCj0utgzC/5io+I7ew' 6-max Seat #5 is the button
Seat 1: YMJG+F++3Aj6P8dAWda5fw ($100.50 in chips)
Seat 2: +xUCTmR3cU7G239W+vZv6g ($140.50 in chips)
Seat 4: uJVSceLggtsrJya+WtmUEA ($101.60 in chips)
Seat 5: bFrTkDcWGTxyvNul7GVdYg ($239 in chips)
YMJG+F++3Aj6P8dAWda5fw: posts small blind $0.50
+xUCTmR3cU7G239W+vZv6g: posts big blind $1
oDiBRCaF0QVtd3kO6xZIXw: sits out
*** HOLE CARDS ***
uJVSceLggtsrJya+WtmUEA: raises $2 to $3
bFrTkDcWGTxyvNul7GVdYg: folds
YMJG+F++3Aj6P8dAWda5fw: folds
+xUCTmR3cU7G239W+vZv6g: folds
uJVSceLggtsrJya+WtmUEA collected $2.50 from pot
*** SUMMARY ***
Total pot $2.50 | Rake $0
Seat 1: YMJG+F++3Aj6P8dAWda5fw (small blind) folded before Flop
Seat 2: +xUCTmR3cU7G239W+vZv6g (big blind) folded before Flop
Seat 4: uJVSceLggtsrJya+WtmUEA collected ($2.50)
Seat 5: bFrTkDcWGTxyvNul7GVdYg (button) folded before Flop (didn't bet)



PokerStars Game #59938671086:  Hold'em No Limit ($0.50/$1.00) - 2009/07/01 0:20:37 ET
Table 'J2yEIzCSC1VzM+R2gijwtg' 9-max Seat #6 is the button
Seat 1: knewtTmBc4Tc0z/5tAABYQ ($202.95 in chips)
Seat 2: kz9ziSiGUc+857heiKSayw ($16 in chips)
Seat 3: 9swGhtpERPngKPtvpoZkoQ ($124.15 in chips)
Seat 4: vR4IO10geOgvTW+LAUBv/A ($100 in chips)
Seat 5: /kZ258i1lqmMUXbtrZIHJA ($42.60 in chips)
Seat 6: bJckevFOcg//s0qyMQI6sQ ($176.40 in chips)
Seat 8: CIRDepY9Rc5tiDJPd0nNpQ ($92.90 in chips)
CIRDepY9Rc5tiDJPd0nNpQ: posts small blind $0.50
ZWdwcEAWYlrUhsRi6MOmoA: is sitting out
knewtTmBc4Tc0z/5tAABYQ: posts big blind $1
*** HOLE CARDS ***
kz9ziSiGUc+857heiKSayw: folds
ZWdwcEAWYlrUhsRi6MOmoA leaves the table
9swGhtpERPngKPtvpoZkoQ: folds
vR4IO10geOgvTW+LAUBv/A: folds
/kZ258i1lqmMUXbtrZIHJA: folds
bJckevFOcg//s0qyMQI6sQ: folds
CIRDepY9Rc5tiDJPd0nNpQ: raises $3 to $4
knewtTmBc4Tc0z/5tAABYQ: folds
CIRDepY9Rc5tiDJPd0nNpQ collected $2 from pot
*** SUMMARY ***
Total pot $2 | Rake $0
Seat 1: knewtTmBc4Tc0z/5tAABYQ (big blind) folded before Flop
Seat 2: kz9ziSiGUc+857heiKSayw folded before Flop (didn't bet)
Seat 3: 9swGhtpERPngKPtvpoZkoQ folded before Flop (didn't bet)
Seat 4: vR4IO10geOgvTW+LAUBv/A folded before Flop (didn't bet)
Seat 5: /kZ258i1lqmMUXbtrZIHJA folded before Flop (didn't bet)
Seat 6: bJckevFOcg//s0qyMQI6sQ (button) folded before Flop (didn't bet)
Seat 8: CIRDepY9Rc5tiDJPd0nNpQ (small blind) collected ($2)



PokerStars Game #59938672416:  Hold'em No Limit ($0.50/$1.00) - 2009/07/01 0:20:39 ET
Table '/FUb199IViHMJHi5YWmeuQ' 9-max Seat #9 is the button
Seat 1: TZcz9MEWDA+WydgGruqqbw ($100.50 in chips)
Seat 2: FL3MrLspcF23LYvC4ipBOA ($133.75 in chips)
Seat 3: qN483QJ1NvHbdIZB7J4ARw ($75.25 in chips)
Seat 4: qheQay5YvP2DMAb3OUSxtw ($107.30 in chips)
Seat 5: +za1iHiRgVo4OcAz0SOZqw ($16.95 in chips)
Seat 6: x80+i7DJL+81v3quj7KbNg ($24.50 in chips)
Seat 7: atVaKXE/AQGa798rpMF/Bg ($17 in chips)
Seat 8: QIWvt0R766g8KfH0vl1s0A ($58.10 in chips)
Seat 9: knewtTmBc4Tc0z/5tAABYQ ($113.15 in chips)
TZcz9MEWDA+WydgGruqqbw: posts small blind $0.50
FL3MrLspcF23LYvC4ipBOA: posts big blind $1
*** HOLE CARDS ***
qN483QJ1NvHbdIZB7J4ARw: folds
qheQay5YvP2DMAb3OUSxtw: folds
+za1iHiRgVo4OcAz0SOZqw: folds
x80+i7DJL+81v3quj7KbNg: raises $2 to $3
atVaKXE/AQGa798rpMF/Bg: folds
QIWvt0R766g8KfH0vl1s0A has timed out
QIWvt0R766g8KfH0vl1s0A: folds
QIWvt0R766g8KfH0vl1s0A is sitting out
knewtTmBc4Tc0z/5tAABYQ: folds
TZcz9MEWDA+WydgGruqqbw: folds
FL3MrLspcF23LYvC4ipBOA: folds
x80+i7DJL+81v3quj7KbNg collected $2.50 from pot
x80+i7DJL+81v3quj7KbNg: doesn't show hand
*** SUMMARY ***
Total pot $2.50 | Rake $0
Seat 1: TZcz9MEWDA+WydgGruqqbw (small blind) folded before Flop
Seat 2: FL3MrLspcF23LYvC4ipBOA (big blind) folded before Flop
Seat 3: qN483QJ1NvHbdIZB7J4ARw folded before Flop (didn't bet)
Seat 4: qheQay5YvP2DMAb3OUSxtw folded before Flop (didn't bet)
Seat 5: +za1iHiRgVo4OcAz0SOZqw folded before Flop (didn't bet)
Seat 6: x80+i7DJL+81v3quj7KbNg collected ($2.50)
Seat 7: atVaKXE/AQGa798rpMF/Bg folded before Flop (didn't bet)
Seat 8: QIWvt0R766g8KfH0vl1s0A folded before Flop (didn't bet)
Seat 9: knewtTmBc4Tc0z/5tAABYQ (button) folded before Flop (didn't bet)



PokerStars Game #59938672596:  Hold'em No Limit ($0.50/$1.00) - 2009/07/01 0:20:39 ET
Table 'U9zqzC8f3oTJ2ShXFgSSOA' 6-max Seat #3 is the button
Seat 1: tS9JHB1h+FQ++qu8RwRNgg ($17.95 in chips)
Seat 2: U2CWBTv29qdCbj8RNF2sIw ($110.30 in chips)
Seat 3: yfXek8iJ7O4CFyqXrtGcfg ($42.50 in chips)
Seat 4: 33q95we0Etwgrm6guQGncw ($74.40 in chips)
Seat 5: KfwW5us6tydK81NYTtK1gw ($194.75 in chips)
Seat 6: aIxzFKdtpDSkUePKZy/niQ ($60 in chips)
33q95we0Etwgrm6guQGncw: posts small blind $0.50
KfwW5us6tydK81NYTtK1gw: posts big blind $1
*** HOLE CARDS ***
aIxzFKdtpDSkUePKZy/niQ: calls $1
tS9JHB1h+FQ++qu8RwRNgg: folds
U2CWBTv29qdCbj8RNF2sIw: folds
yfXek8iJ7O4CFyqXrtGcfg: raises $1 to $2
33q95we0Etwgrm6guQGncw: folds
KfwW5us6tydK81NYTtK1gw: folds
aIxzFKdtpDSkUePKZy/niQ: calls $1
*** FLOP *** [Qd 8c Ac]
aIxzFKdtpDSkUePKZy/niQ: checks
yfXek8iJ7O4CFyqXrtGcfg: bets $4
aIxzFKdtpDSkUePKZy/niQ: calls $4
*** TURN *** [Qd 8c Ac] [8h]
aIxzFKdtpDSkUePKZy/niQ: checks
yfXek8iJ7O4CFyqXrtGcfg: bets $9
aIxzFKdtpDSkUePKZy/niQ: calls $9
*** RIVER *** [Qd 8c Ac 8h] [5d]
aIxzFKdtpDSkUePKZy/niQ: checks
yfXek8iJ7O4CFyqXrtGcfg: checks
*** SHOW DOWN ***
aIxzFKdtpDSkUePKZy/niQ: shows [5c Jc] (two pair, Eights and Fives)
yfXek8iJ7O4CFyqXrtGcfg: shows [7c Qc] (two pair, Queens and Eights)
yfXek8iJ7O4CFyqXrtGcfg collected $30 from pot
*** SUMMARY ***
Total pot $31.50 | Rake $1.50
Board [Qd 8c Ac 8h 5d]
Seat 1: tS9JHB1h+FQ++qu8RwRNgg folded before Flop (didn't bet)
Seat 2: U2CWBTv29qdCbj8RNF2sIw folded before Flop (didn't bet)
Seat 3: yfXek8iJ7O4CFyqXrtGcfg (button) showed [7c Qc] and won ($30) with two pair, Queens and Eights
Seat 4: 33q95we0Etwgrm6guQGncw (small blind) folded before Flop
Seat 5: KfwW5us6tydK81NYTtK1gw (big blind) folded before Flop
Seat 6: aIxzFKdtpDSkUePKZy/niQ showed [5c Jc] and lost with two pair, Eights and Fives



PokerStars Game #59938672424:  Hold'em No Limit ($0.50/$1.00) - 2009/07/01 0:20:39 ET
Table 'SQLOQoANiHscJ8AL7zffbw' 9-max Seat #4 is the button
Seat 1: jPTRd6SpCp4xqAy2XQiTOw ($103.05 in chips)
Seat 2: /zy+DB4S5fUQUSfZWFzYGw ($280.35 in chips)
Seat 3: 0eFnow7+D7veCYQ+CG9FFw ($98.50 in chips)
Seat 4: N9n5Wc3s35DpCrOAUUNAaQ ($120.30 in chips)
Seat 5: L9njYvloJ1NdXjP8edHEAg ($100 in chips)
Seat 6: p5UKaxVobvptF0ANhR/q1A ($158.50 in chips)
Seat 7: bJckevFOcg//s0qyMQI6sQ ($105.05 in chips)
Seat 8: yfXek8iJ7O4CFyqXrtGcfg ($85.45 in chips)
L9njYvloJ1NdXjP8edHEAg: posts small blind $0.50
p5UKaxVobvptF0ANhR/q1A: posts big blind $1
qJr25HAtvv1w/7IBvjMM3g: sits out
*** HOLE CARDS ***
bJckevFOcg//s0qyMQI6sQ: folds
yfXek8iJ7O4CFyqXrtGcfg: folds
yfXek8iJ7O4CFyqXrtGcfg leaves the table
jPTRd6SpCp4xqAy2XQiTOw: folds
/zy+DB4S5fUQUSfZWFzYGw: folds
0eFnow7+D7veCYQ+CG9FFw: folds
N9n5Wc3s35DpCrOAUUNAaQ: folds
L9njYvloJ1NdXjP8edHEAg: raises $1 to $2
9ce+0Dl3d0BeEFIP+8HezA joins the table at seat #8
p5UKaxVobvptF0ANhR/q1A: folds
L9njYvloJ1NdXjP8edHEAg collected $2 from pot
*** SUMMARY ***
Total pot $2 | Rake $0
Seat 1: jPTRd6SpCp4xqAy2XQiTOw folded before Flop (didn't bet)
Seat 2: /zy+DB4S5fUQUSfZWFzYGw folded before Flop (didn't bet)
Seat 3: 0eFnow7+D7veCYQ+CG9FFw folded before Flop (didn't bet)
Seat 4: N9n5Wc3s35DpCrOAUUNAaQ (button) folded before Flop (didn't bet)
Seat 5: L9njYvloJ1NdXjP8edHEAg (small blind) collected ($2)
Seat 6: p5UKaxVobvptF0ANhR/q1A (big blind) folded before Flop
Seat 7: bJckevFOcg//s0qyMQI6sQ folded before Flop (didn't bet)
Seat 8: yfXek8iJ7O4CFyqXrtGcfg folded before Flop (didn't bet)



PokerStars Game #59938674042:  Hold'em No Limit ($0.50/$1.00) - 2009/07/01 0:20:41 ET
Table 'QSIig7BLMc9wY/rgBechzw' 6-max Seat #3 is the button
Seat 1: uuA9hpFU17U5/t4cvpbpBg ($40.75 in chips)
Seat 2: 0WjiuIT7/EolY1oOx1ngeA ($125.40 in chips)
Seat 3: +W6OnF033KNM2xH0fGj98Q ($107.20 in chips)
Seat 4: +uSzP8Jwnw7sKfQ4s66b7w ($49 in chips)
Seat 5: 1yB1nHUkHNNY8OJnDNHZMw ($68.55 in chips)
Seat 6: KpnW5CcJ4Mg6MeclfKmLrw ($144.75 in chips)
+uSzP8Jwnw7sKfQ4s66b7w: posts small blind $0.50
1yB1nHUkHNNY8OJnDNHZMw: posts big blind $1
*** HOLE CARDS ***
KpnW5CcJ4Mg6MeclfKmLrw: folds
uuA9hpFU17U5/t4cvpbpBg: folds
0WjiuIT7/EolY1oOx1ngeA: folds
+W6OnF033KNM2xH0fGj98Q: folds
+uSzP8Jwnw7sKfQ4s66b7w: folds
1yB1nHUkHNNY8OJnDNHZMw collected $1 from pot
1yB1nHUkHNNY8OJnDNHZMw leaves the table
*** SUMMARY ***
Total pot $1 | Rake $0
Seat 1: uuA9hpFU17U5/t4cvpbpBg folded before Flop (didn't bet)
Seat 2: 0WjiuIT7/EolY1oOx1ngeA folded before Flop (didn't bet)
Seat 3: +W6OnF033KNM2xH0fGj98Q (button) folded before Flop (didn't bet)
Seat 4: +uSzP8Jwnw7sKfQ4s66b7w (small blind) folded before Flop
Seat 5: 1yB1nHUkHNNY8OJnDNHZMw (big blind) collected ($1)
Seat 6: KpnW5CcJ4Mg6MeclfKmLrw folded before Flop (didn't bet)



PokerStars Game #59938675060:  Hold'em No Limit ($0.50/$1.00) - 2009/07/01 0:20:43 ET
Table 'cBDNutyLBKEk9+ptwsKmTw' 6-max Seat #6 is the button
Seat 1: tb0dt30qP2x/8f+Xta4mVg ($18.95 in chips)
Seat 2: KyaE4+hWgUNIWWOWy4D14w ($62.30 in chips)
Seat 3: G5ZSSN6RSON3gkNvk/SmYg ($107.40 in chips)
Seat 4: 0WjiuIT7/EolY1oOx1ngeA ($107.65 in chips)
Seat 5: OGMLOcTNYZXZU81au7ztUw ($111.20 in chips)
Seat 6: pyzhFUPPSNzrysiMqlA5Xw ($11.25 in chips)
tb0dt30qP2x/8f+Xta4mVg: posts small blind $0.50
KyaE4+hWgUNIWWOWy4D14w: posts big blind $1
*** HOLE CARDS ***
G5ZSSN6RSON3gkNvk/SmYg: folds
0WjiuIT7/EolY1oOx1ngeA: folds
OGMLOcTNYZXZU81au7ztUw: folds
pyzhFUPPSNzrysiMqlA5Xw: folds
tb0dt30qP2x/8f+Xta4mVg: calls $0.50
KyaE4+hWgUNIWWOWy4D14w: checks
*** FLOP *** [Ts 6d Kd]
tb0dt30qP2x/8f+Xta4mVg: checks
KyaE4+hWgUNIWWOWy4D14w: checks
*** TURN *** [Ts 6d Kd] [Jh]
tb0dt30qP2x/8f+Xta4mVg: bets $1
KyaE4+hWgUNIWWOWy4D14w: calls $1
*** RIVER *** [Ts 6d Kd Jh] [4h]
tb0dt30qP2x/8f+Xta4mVg: bets $1
KyaE4+hWgUNIWWOWy4D14w: folds
tb0dt30qP2x/8f+Xta4mVg collected $3.85 from pot
*** SUMMARY ***
Total pot $4 | Rake $0.15
Board [Ts 6d Kd Jh 4h]
Seat 1: tb0dt30qP2x/8f+Xta4mVg (small blind) collected ($3.85)
Seat 2: KyaE4+hWgUNIWWOWy4D14w (big blind) folded on the River
Seat 3: G5ZSSN6RSON3gkNvk/SmYg folded before Flop (didn't bet)
Seat 4: 0WjiuIT7/EolY1oOx1ngeA folded before Flop (didn't bet)
Seat 5: OGMLOcTNYZXZU81au7ztUw folded before Flop (didn't bet)
Seat 6: pyzhFUPPSNzrysiMqlA5Xw (button) folded before Flop (didn't bet)



PokerStars Game #59938675038:  Hold'em No Limit ($0.50/$1.00) - 2009/07/01 0:20:43 ET
Table 'aWHveb63HkbTmOGHOxjBkQ' 2-max Seat #2 is the button
Seat 1: xy2MQKoHoCZZIudmw8Xbow ($208.80 in chips)
Seat 2: xstEKavv3YDxpUnU4e9qAQ ($165.60 in chips)
xstEKavv3YDxpUnU4e9qAQ: posts small blind $0.50
xy2MQKoHoCZZIudmw8Xbow: posts big blind $1
*** HOLE CARDS ***
xstEKavv3YDxpUnU4e9qAQ: raises $3 to $4
xy2MQKoHoCZZIudmw8Xbow: raises $8 to $12
xstEKavv3YDxpUnU4e9qAQ: calls $8
*** FLOP *** [Qh 7s Th]
xy2MQKoHoCZZIudmw8Xbow: bets $9
xstEKavv3YDxpUnU4e9qAQ: calls $9
*** TURN *** [Qh 7s Th] [6h]
xy2MQKoHoCZZIudmw8Xbow: bets $14
xstEKavv3YDxpUnU4e9qAQ: folds
xy2MQKoHoCZZIudmw8Xbow collected $41.50 from pot
xy2MQKoHoCZZIudmw8Xbow: doesn't show hand
*** SUMMARY ***
Total pot $42 | Rake $0.50
Board [Qh 7s Th 6h]
Seat 1: xy2MQKoHoCZZIudmw8Xbow (big blind) collected ($41.50)
Seat 2: xstEKavv3YDxpUnU4e9qAQ (button) (small blind) folded on the Turn



PokerStars Game #59938676718:  Hold'em No Limit ($0.50/$1.00) - 2009/07/01 0:20:45 ET
Table '/+ni2d7lj6E90JmAQZKSOw' 2-max Seat #1 is the button
Seat 1: qubgcbkrXfMjdrMEd1lYMQ ($253.20 in chips)
Seat 2: IJu7Boitu3yAxp4hjIx6zQ ($117.40 in chips)
qubgcbkrXfMjdrMEd1lYMQ: posts small blind $0.50
IJu7Boitu3yAxp4hjIx6zQ: posts big blind $1
*** HOLE CARDS ***
qubgcbkrXfMjdrMEd1lYMQ: folds
IJu7Boitu3yAxp4hjIx6zQ collected $1 from pot
IJu7Boitu3yAxp4hjIx6zQ: doesn't show hand
*** SUMMARY ***
Total pot $1 | Rake $0
Seat 1: qubgcbkrXfMjdrMEd1lYMQ (button) (small blind) folded before Flop
Seat 2: IJu7Boitu3yAxp4hjIx6zQ (big blind) collected ($1)



PokerStars Game #59938677520:  Hold'em No Limit ($0.50/$1.00) - 2009/07/01 0:20:46 ET
Table 'N2bNCDHL96aCQDvZIh+yQQ' 6-max Seat #1 is the button
Seat 1: iHo1oDbrEVJ8nEGdaPrICw ($136.95 in chips)
Seat 2: KpnW5CcJ4Mg6MeclfKmLrw ($105.50 in chips)
Seat 3: PXT6kJgVX67c3EgncNqRoA ($52.95 in chips)
Seat 4: uCqEjnxh2/vFBjKYkfTOkw ($163.20 in chips)
Seat 5: rHlMOfR7kpQQxe+PFQz0xQ ($37 in chips)
KpnW5CcJ4Mg6MeclfKmLrw: posts small blind $0.50
PXT6kJgVX67c3EgncNqRoA: posts big blind $1
*** HOLE CARDS ***
uCqEjnxh2/vFBjKYkfTOkw: raises $3 to $4
rHlMOfR7kpQQxe+PFQz0xQ: folds
iHo1oDbrEVJ8nEGdaPrICw: raises $10 to $14
KpnW5CcJ4Mg6MeclfKmLrw: folds
PXT6kJgVX67c3EgncNqRoA: folds
uCqEjnxh2/vFBjKYkfTOkw: folds
iHo1oDbrEVJ8nEGdaPrICw collected $9.50 from pot
iHo1oDbrEVJ8nEGdaPrICw: doesn't show hand
*** SUMMARY ***
Total pot $9.50 | Rake $0
Seat 1: iHo1oDbrEVJ8nEGdaPrICw (button) collected ($9.50)
Seat 2: KpnW5CcJ4Mg6MeclfKmLrw (small blind) folded before Flop
Seat 3: PXT6kJgVX67c3EgncNqRoA (big blind) folded before Flop
Seat 4: uCqEjnxh2/vFBjKYkfTOkw folded before Flop
Seat 5: rHlMOfR7kpQQxe+PFQz0xQ folded before Flop (didn't bet)



PokerStars Game #59938677928:  Hold'em No Limit ($0.50/$1.00) - 2009/07/01 0:20:47 ET
Table 'vs/5jr6ciwjVQ5+Soc+u2A' 6-max Seat #6 is the button
Seat 2: XOIf9W+VAxhZqN+SYoyMKA ($117.30 in chips)
Seat 3: G5ZSSN6RSON3gkNvk/SmYg ($100 in chips)
Seat 4: KpnW5CcJ4Mg6MeclfKmLrw ($106.15 in chips)
Seat 5: 7Vc9JmGFQwMRh5Tj9ui5Lw ($98.65 in chips)
Seat 6: QHvTZcrKe6+maWUfVjP29Q ($100 in chips)
XOIf9W+VAxhZqN+SYoyMKA: posts small blind $0.50
G5ZSSN6RSON3gkNvk/SmYg: posts big blind $1
*** HOLE CARDS ***
KpnW5CcJ4Mg6MeclfKmLrw: folds
7Vc9JmGFQwMRh5Tj9ui5Lw: folds
QHvTZcrKe6+maWUfVjP29Q: folds
XOIf9W+VAxhZqN+SYoyMKA: raises $2 to $3
G5ZSSN6RSON3gkNvk/SmYg: calls $2
*** FLOP *** [5d 7d 3h]
XOIf9W+VAxhZqN+SYoyMKA: checks
G5ZSSN6RSON3gkNvk/SmYg: checks
*** TURN *** [5d 7d 3h] [5c]
XOIf9W+VAxhZqN+SYoyMKA: checks
G5ZSSN6RSON3gkNvk/SmYg: bets $4
XOIf9W+VAxhZqN+SYoyMKA: folds
G5ZSSN6RSON3gkNvk/SmYg collected $5.70 from pot
G5ZSSN6RSON3gkNvk/SmYg: doesn't show hand
*** SUMMARY ***
Total pot $6 | Rake $0.30
Board [5d 7d 3h 5c]
Seat 2: XOIf9W+VAxhZqN+SYoyMKA (small blind) folded on the Turn
Seat 3: G5ZSSN6RSON3gkNvk/SmYg (big blind) collected ($5.70)
Seat 4: KpnW5CcJ4Mg6MeclfKmLrw folded before Flop (didn't bet)
Seat 5: 7Vc9JmGFQwMRh5Tj9ui5Lw folded before Flop (didn't bet)
Seat 6: QHvTZcrKe6+maWUfVjP29Q (button) folded before Flop (didn't bet)



PokerStars Game #59938678902:  Hold'em No Limit ($0.50/$1.00) - 2009/07/01 0:20:48 ET
Table 'hugOjcwJvzEwZbK7tyiWuQ' 9-max Seat #6 is the button
Seat 1: N9n5Wc3s35DpCrOAUUNAaQ ($127.85 in chips)
Seat 2: r27C1nIV4NS4+qbnrgBQSw ($257.05 in chips)
Seat 3: jDwhY1kCdc6EkAHbT7PJMQ ($106.55 in chips)
Seat 4: UWB3oeddt/GObx2Mix2Anw ($195.20 in chips)
Seat 6: gUUvmqdVlmvpal6B8nYrmg ($100 in chips)
Seat 7: FL3MrLspcF23LYvC4ipBOA ($100 in chips)
Seat 8: /zy+DB4S5fUQUSfZWFzYGw ($115.75 in chips)
Seat 9: o6JyUkbzCDw8tUabqtmnlg ($61.10 in chips)
FL3MrLspcF23LYvC4ipBOA: posts small blind $0.50
/zy+DB4S5fUQUSfZWFzYGw: posts big blind $1
*** HOLE CARDS ***
o6JyUkbzCDw8tUabqtmnlg: folds
N9n5Wc3s35DpCrOAUUNAaQ: folds
r27C1nIV4NS4+qbnrgBQSw: folds
jDwhY1kCdc6EkAHbT7PJMQ: folds
UWB3oeddt/GObx2Mix2Anw: folds
gUUvmqdVlmvpal6B8nYrmg: raises $1 to $2
FL3MrLspcF23LYvC4ipBOA: folds
/zy+DB4S5fUQUSfZWFzYGw: calls $1
*** FLOP *** [2c 3s 7h]
/zy+DB4S5fUQUSfZWFzYGw: checks
gUUvmqdVlmvpal6B8nYrmg: checks
*** TURN *** [2c 3s 7h] [As]
/zy+DB4S5fUQUSfZWFzYGw: checks
gUUvmqdVlmvpal6B8nYrmg: bets $2
/zy+DB4S5fUQUSfZWFzYGw: folds
gUUvmqdVlmvpal6B8nYrmg collected $4.30 from pot
*** SUMMARY ***
Total pot $4.50 | Rake $0.20
Board [2c 3s 7h As]
Seat 1: N9n5Wc3s35DpCrOAUUNAaQ folded before Flop (didn't bet)
Seat 2: r27C1nIV4NS4+qbnrgBQSw folded before Flop (didn't bet)
Seat 3: jDwhY1kCdc6EkAHbT7PJMQ folded before Flop (didn't bet)
Seat 4: UWB3oeddt/GObx2Mix2Anw folded before Flop (didn't bet)
Seat 6: gUUvmqdVlmvpal6B8nYrmg (button) collected ($4.30)
Seat 7: FL3MrLspcF23LYvC4ipBOA (small blind) folded before Flop
Seat 8: /zy+DB4S5fUQUSfZWFzYGw (big blind) folded on the Turn
Seat 9: o6JyUkbzCDw8tUabqtmnlg folded before Flop (didn't bet)



PokerStars Game #59938678638:  Hold'em No Limit ($0.50/$1.00) - 2009/07/01 0:20:48 ET
Table 'FKpXUINE6M3UxHG4zaMhHA' 6-max Seat #6 is the button
Seat 2: ecfRjfaWRYbPNvaBsW5ZQQ ($33.70 in chips)
Seat 4: ru6SCVvWcWt2SpmUsmArWQ ($21 in chips)
Seat 5: hpxXcmRkXXI9HE5+5/j/0Q ($101.50 in chips)
Seat 6: b2a+5TkFf4xJN/Ihhma58Q ($17.30 in chips)
ecfRjfaWRYbPNvaBsW5ZQQ: posts small blind $0.50
ssLJburtEIqnVkx6X8R1uw: is sitting out
ru6SCVvWcWt2SpmUsmArWQ: posts big blind $1
*** HOLE CARDS ***
hpxXcmRkXXI9HE5+5/j/0Q: folds
b2a+5TkFf4xJN/Ihhma58Q: folds
ecfRjfaWRYbPNvaBsW5ZQQ: raises $2 to $3
ssLJburtEIqnVkx6X8R1uw leaves the table
ru6SCVvWcWt2SpmUsmArWQ: folds
ecfRjfaWRYbPNvaBsW5ZQQ collected $2 from pot
ecfRjfaWRYbPNvaBsW5ZQQ: doesn't show hand
*** SUMMARY ***
Total pot $2 | Rake $0
Seat 2: ecfRjfaWRYbPNvaBsW5ZQQ (small blind) collected ($2)
Seat 4: ru6SCVvWcWt2SpmUsmArWQ (big blind) folded before Flop
Seat 5: hpxXcmRkXXI9HE5+5/j/0Q folded before Flop (didn't bet)
Seat 6: b2a+5TkFf4xJN/Ihhma58Q (button) folded before Flop (didn't bet)



PokerStars Game #59938679554:  Hold'em No Limit ($0.50/$1.00) - 2009/07/01 0:20:49 ET
Table 'O96CPOtvMBWP6kzuYDfdFA' 6-max Seat #1 is the button
Seat 1: yl9aRDw7k/ieGiDoJVy+/w ($70.05 in chips)
Seat 2: vTUNrd/7qIOJpW0suEu5hQ ($211.40 in chips)
Seat 3: V89DGjxE171oPREEbAXiyg ($30 in chips)
Seat 5: wRxiu9OJzvvN84OYWW9jxQ ($123.85 in chips)
Seat 6: xNKcQzD9+/iHmtJn4vYq9w ($74 in chips)
vTUNrd/7qIOJpW0suEu5hQ: posts small blind $0.50
V89DGjxE171oPREEbAXiyg: posts big blind $1
*** HOLE CARDS ***
wRxiu9OJzvvN84OYWW9jxQ: folds
xNKcQzD9+/iHmtJn4vYq9w: folds
yl9aRDw7k/ieGiDoJVy+/w: calls $1
vTUNrd/7qIOJpW0suEu5hQ: folds
V89DGjxE171oPREEbAXiyg: checks
*** FLOP *** [5c 6c 2h]
V89DGjxE171oPREEbAXiyg: checks
yl9aRDw7k/ieGiDoJVy+/w: checks
*** TURN *** [5c 6c 2h] [Ac]
V89DGjxE171oPREEbAXiyg: bets $2
yl9aRDw7k/ieGiDoJVy+/w: calls $2
*** RIVER *** [5c 6c 2h Ac] [5h]
V89DGjxE171oPREEbAXiyg: checks
yl9aRDw7k/ieGiDoJVy+/w is connected
yl9aRDw7k/ieGiDoJVy+/w: checks
*** SHOW DOWN ***
V89DGjxE171oPREEbAXiyg: shows [7d 2c] (two pair, Fives and Deuces)
yl9aRDw7k/ieGiDoJVy+/w: mucks hand
V89DGjxE171oPREEbAXiyg collected $6.20 from pot
*** SUMMARY ***
Total pot $6.50 | Rake $0.30
Board [5c 6c 2h Ac 5h]
Seat 1: yl9aRDw7k/ieGiDoJVy+/w (button) mucked
Seat 2: vTUNrd/7qIOJpW0suEu5hQ (small blind) folded before Flop
Seat 3: V89DGjxE171oPREEbAXiyg (big blind) showed [7d 2c] and won ($6.20) with two pair, Fives and Deuces
Seat 5: wRxiu9OJzvvN84OYWW9jxQ folded before Flop (didn't bet)
Seat 6: xNKcQzD9+/iHmtJn4vYq9w folded before Flop (didn't bet)



PokerStars Game #59938681126:  Hold'em No Limit ($0.50/$1.00) - 2009/07/01 0:20:51 ET
Table 'eU3bWpDDg3Z+9R4m4iVmog' 6-max Seat #3 is the button
Seat 2: 8CAoOzhmB8n3nRFf3V4BTg ($174.95 in chips)
Seat 3: U6tnjwZRpTnM+YkqkCjwyQ ($124.65 in chips)
Seat 4: GDVIsbEJ/DOJsMKE4Asz0A ($93.45 in chips)
Seat 5: QHvTZcrKe6+maWUfVjP29Q ($103.50 in chips)
Seat 6: hpxXcmRkXXI9HE5+5/j/0Q ($100 in chips)
GDVIsbEJ/DOJsMKE4Asz0A: posts small blind $0.50
QHvTZcrKe6+maWUfVjP29Q: posts big blind $1
*** HOLE CARDS ***
hpxXcmRkXXI9HE5+5/j/0Q: folds
8CAoOzhmB8n3nRFf3V4BTg: folds
U6tnjwZRpTnM+YkqkCjwyQ: folds
GDVIsbEJ/DOJsMKE4Asz0A: folds
QHvTZcrKe6+maWUfVjP29Q collected $1 from pot
QHvTZcrKe6+maWUfVjP29Q: doesn't show hand
*** SUMMARY ***
Total pot $1 | Rake $0
Seat 2: 8CAoOzhmB8n3nRFf3V4BTg folded before Flop (didn't bet)
Seat 3: U6tnjwZRpTnM+YkqkCjwyQ (button) folded before Flop (didn't bet)
Seat 4: GDVIsbEJ/DOJsMKE4Asz0A (small blind) folded before Flop
Seat 5: QHvTZcrKe6+maWUfVjP29Q (big blind) collected ($1)
Seat 6: hpxXcmRkXXI9HE5+5/j/0Q folded before Flop (didn't bet)



PokerStars Game #59938681344:  Hold'em No Limit ($0.50/$1.00) - 2009/07/01 0:20:52 ET
Table '/+ni2d7lj6E90JmAQZKSOw' 2-max Seat #2 is the button
Seat 1: qubgcbkrXfMjdrMEd1lYMQ ($252.70 in chips)
Seat 2: IJu7Boitu3yAxp4hjIx6zQ ($117.90 in chips)
IJu7Boitu3yAxp4hjIx6zQ: posts small blind $0.50
qubgcbkrXfMjdrMEd1lYMQ: posts big blind $1
*** HOLE CARDS ***
IJu7Boitu3yAxp4hjIx6zQ: folds
qubgcbkrXfMjdrMEd1lYMQ collected $1 from pot
qubgcbkrXfMjdrMEd1lYMQ: doesn't show hand
*** SUMMARY ***
Total pot $1 | Rake $0
Seat 1: qubgcbkrXfMjdrMEd1lYMQ (big blind) collected ($1)
Seat 2: IJu7Boitu3yAxp4hjIx6zQ (button) (small blind) folded before Flop



PokerStars Game #59938683368:  Hold'em No Limit ($0.50/$1.00) - 2009/07/01 0:20:55 ET
Table '6YvsYDPNIDx2v5z3bJnwZQ' 9-max Seat #4 is the button
Seat 1: Ogn4JDV3mp4ZDKO49IFzKA ($17 in chips)
Seat 2: q9qdvTFQkzcAZRujD6rXUA ($98 in chips)
Seat 3: negfosHnGOZXSHpWDRKyBQ ($18.30 in chips)
Seat 4: kEr5NYB+JIG5+szcYMr6hA ($47.50 in chips)
Seat 5: mBRWbnUl8diyBO1qTJaNzw ($164.15 in chips)
Seat 6: uMPEfCcGCfsxmy53tVUMug ($100 in chips)
Seat 7: boixc27eqTYA1p0tUdMuBQ ($109.60 in chips)
Seat 8: PSFxpXgPedVZyHSu2Zhb7Q ($77.90 in chips)
Seat 9: jDwhY1kCdc6EkAHbT7PJMQ ($106.85 in chips)
mBRWbnUl8diyBO1qTJaNzw: posts small blind $0.50
uMPEfCcGCfsxmy53tVUMug: posts big blind $1
*** HOLE CARDS ***
boixc27eqTYA1p0tUdMuBQ: folds
PSFxpXgPedVZyHSu2Zhb7Q: folds
jDwhY1kCdc6EkAHbT7PJMQ: raises $3 to $4
Ogn4JDV3mp4ZDKO49IFzKA: folds
q9qdvTFQkzcAZRujD6rXUA: folds
negfosHnGOZXSHpWDRKyBQ: folds
kEr5NYB+JIG5+szcYMr6hA: folds
mBRWbnUl8diyBO1qTJaNzw: calls $3.50
uMPEfCcGCfsxmy53tVUMug: folds
*** FLOP *** [9d 6c 6s]
mBRWbnUl8diyBO1qTJaNzw: checks
jDwhY1kCdc6EkAHbT7PJMQ: checks
*** TURN *** [9d 6c 6s] [Qh]
mBRWbnUl8diyBO1qTJaNzw: bets $5
jDwhY1kCdc6EkAHbT7PJMQ: folds
mBRWbnUl8diyBO1qTJaNzw collected $8.55 from pot
*** SUMMARY ***
Total pot $9 | Rake $0.45
Board [9d 6c 6s Qh]
Seat 1: Ogn4JDV3mp4ZDKO49IFzKA folded before Flop (didn't bet)
Seat 2: q9qdvTFQkzcAZRujD6rXUA folded before Flop (didn't bet)
Seat 3: negfosHnGOZXSHpWDRKyBQ folded before Flop (didn't bet)
Seat 4: kEr5NYB+JIG5+szcYMr6hA (button) folded before Flop (didn't bet)
Seat 5: mBRWbnUl8diyBO1qTJaNzw (small blind) collected ($8.55)
Seat 6: uMPEfCcGCfsxmy53tVUMug (big blind) folded before Flop
Seat 7: boixc27eqTYA1p0tUdMuBQ folded before Flop (didn't bet)
Seat 8: PSFxpXgPedVZyHSu2Zhb7Q folded before Flop (didn't bet)
Seat 9: jDwhY1kCdc6EkAHbT7PJMQ folded on the Turn



PokerStars Game #59938683576:  Hold'em No Limit ($0.50/$1.00) - 2009/07/01 0:20:55 ET
Table 'tJq9SfN1ywY0r03VBlWlwQ' 9-max Seat #4 is the button
Seat 1: wZsU+w9r7G66x93UuvBf1Q ($329.05 in chips)
Seat 2: RqkO8O/Y3qlc3PIuCAHjVg ($76.40 in chips)
Seat 3: FVs16t7GgfWgQWt4JxsObQ ($51.45 in chips)
Seat 4: zBHLwg+HmbHmRtVQMhavjA ($70.45 in chips)
Seat 5: Ogn4JDV3mp4ZDKO49IFzKA ($19 in chips)
Seat 6: gUUvmqdVlmvpal6B8nYrmg ($100.80 in chips)
Seat 8: G4DEhsZFmznGNVpy2SEocA ($23.50 in chips)
zBHLwg+HmbHmRtVQMhavjA said, "nice fish"
Ogn4JDV3mp4ZDKO49IFzKA: posts small blind $0.50
gUUvmqdVlmvpal6B8nYrmg: posts big blind $1
qVhRZ0PLZ95XRJHWAjXjOQ: sits out
*** HOLE CARDS ***
G4DEhsZFmznGNVpy2SEocA: folds
wZsU+w9r7G66x93UuvBf1Q: folds
RqkO8O/Y3qlc3PIuCAHjVg: folds
FVs16t7GgfWgQWt4JxsObQ: calls $1
zBHLwg+HmbHmRtVQMhavjA: raises $5 to $6
Ogn4JDV3mp4ZDKO49IFzKA: folds
gUUvmqdVlmvpal6B8nYrmg: folds
FVs16t7GgfWgQWt4JxsObQ: calls $5
*** FLOP *** [9h 2s Td]
FVs16t7GgfWgQWt4JxsObQ: bets $1
zBHLwg+HmbHmRtVQMhavjA: raises $9 to $10
FVs16t7GgfWgQWt4JxsObQ: folds
zBHLwg+HmbHmRtVQMhavjA collected $14.80 from pot
*** SUMMARY ***
Total pot $15.50 | Rake $0.70
Board [9h 2s Td]
Seat 1: wZsU+w9r7G66x93UuvBf1Q folded before Flop (didn't bet)
Seat 2: RqkO8O/Y3qlc3PIuCAHjVg folded before Flop (didn't bet)
Seat 3: FVs16t7GgfWgQWt4JxsObQ folded on the Flop
Seat 4: zBHLwg+HmbHmRtVQMhavjA (button) collected ($14.80)
Seat 5: Ogn4JDV3mp4ZDKO49IFzKA (small blind) folded before Flop
Seat 6: gUUvmqdVlmvpal6B8nYrmg (big blind) folded before Flop
Seat 8: G4DEhsZFmznGNVpy2SEocA folded before Flop (didn't bet)



PokerStars Game #59938685756:  Hold'em No Limit ($0.50/$1.00) - 2009/07/01 0:20:58 ET
Table '/+ni2d7lj6E90JmAQZKSOw' 2-max Seat #1 is the button
Seat 1: qubgcbkrXfMjdrMEd1lYMQ ($253.20 in chips)
Seat 2: IJu7Boitu3yAxp4hjIx6zQ ($117.40 in chips)
qubgcbkrXfMjdrMEd1lYMQ: posts small blind $0.50
IJu7Boitu3yAxp4hjIx6zQ: posts big blind $1
*** HOLE CARDS ***
qubgcbkrXfMjdrMEd1lYMQ: raises $2 to $3
IJu7Boitu3yAxp4hjIx6zQ: calls $2
*** FLOP *** [6h 2h Jh]
IJu7Boitu3yAxp4hjIx6zQ: checks
qubgcbkrXfMjdrMEd1lYMQ: bets $4
IJu7Boitu3yAxp4hjIx6zQ: calls $4
*** TURN *** [6h 2h Jh] [6c]
IJu7Boitu3yAxp4hjIx6zQ: checks
qubgcbkrXfMjdrMEd1lYMQ: checks
*** RIVER *** [6h 2h Jh 6c] [Kc]
IJu7Boitu3yAxp4hjIx6zQ: bets $10
qubgcbkrXfMjdrMEd1lYMQ: folds
IJu7Boitu3yAxp4hjIx6zQ collected $13.50 from pot
IJu7Boitu3yAxp4hjIx6zQ: doesn't show hand
*** SUMMARY ***
Total pot $14 | Rake $0.50
Board [6h 2h Jh 6c Kc]
Seat 1: qubgcbkrXfMjdrMEd1lYMQ (button) (small blind) folded on the River
Seat 2: IJu7Boitu3yAxp4hjIx6zQ (big blind) collected ($13.50)



PokerStars Game #59938685878:  Hold'em No Limit ($0.50/$1.00) - 2009/07/01 0:20:58 ET
Table 'tLrtq7gDzxEvckNAI1OS5Q' 6-max Seat #2 is the button
Seat 1: GisIe1kcC9q/xV6ifsTjgA ($155.85 in chips)
Seat 2: qsObMEIlRO22OlS867m/lw ($27.35 in chips)
Seat 3: TPZ+m9x+lwoKpv7TMfAUWA ($324.75 in chips)
Seat 4: KOG8rG51mOvIoY96zF3kvw ($160.80 in chips)
Seat 5: OGMLOcTNYZXZU81au7ztUw ($175.15 in chips)
Seat 6: XUk5GQsfNFpHvaToDZ0rZA ($22.65 in chips)
TPZ+m9x+lwoKpv7TMfAUWA: posts small blind $0.50
KOG8rG51mOvIoY96zF3kvw: posts big blind $1
*** HOLE CARDS ***
OGMLOcTNYZXZU81au7ztUw: raises $2 to $3
XUk5GQsfNFpHvaToDZ0rZA: folds
GisIe1kcC9q/xV6ifsTjgA: folds
qsObMEIlRO22OlS867m/lw: folds
TPZ+m9x+lwoKpv7TMfAUWA: folds
KOG8rG51mOvIoY96zF3kvw: calls $2
*** FLOP *** [9s 4d 6s]
KOG8rG51mOvIoY96zF3kvw: checks
OGMLOcTNYZXZU81au7ztUw: bets $5
KOG8rG51mOvIoY96zF3kvw: folds
OGMLOcTNYZXZU81au7ztUw collected $6.20 from pot
OGMLOcTNYZXZU81au7ztUw: doesn't show hand
*** SUMMARY ***
Total pot $6.50 | Rake $0.30
Board [9s 4d 6s]
Seat 1: GisIe1kcC9q/xV6ifsTjgA folded before Flop (didn't bet)
Seat 2: qsObMEIlRO22OlS867m/lw (button) folded before Flop (didn't bet)
Seat 3: TPZ+m9x+lwoKpv7TMfAUWA (small blind) folded before Flop
Seat 4: KOG8rG51mOvIoY96zF3kvw (big blind) folded on the Flop
Seat 5: OGMLOcTNYZXZU81au7ztUw collected ($6.20)
Seat 6: XUk5GQsfNFpHvaToDZ0rZA folded before Flop (didn't bet)



PokerStars Game #59938685854:  Hold'em No Limit ($0.50/$1.00) - 2009/07/01 0:20:58 ET
Table 'tyUh+jyNvrceIQdKMJjQ2wZFWj23PMihdwrNWv41OG/Qeat #1 is the button
Seat 1: o8A5MUdudVKu+pAwgZOX2w ($197.25 in chips)
Seat 2: 6iVcnPw9a2oNG6sPQo3G6g ($99.65 in chips)
Seat 3: L9qfLYXrczhAPd/VckgsWw ($38.60 in chips)
Seat 5: j7NIOHLZk7V2o9fOioO5ug ($103.10 in chips)
Seat 6: YsLQ3BAvgQHWXMAv3Wv6Hg ($105.25 in chips)
6iVcnPw9a2oNG6sPQo3G6g: posts small blind $0.50
L9qfLYXrczhAPd/VckgsWw: posts big blind $1
*** HOLE CARDS ***
j7NIOHLZk7V2o9fOioO5ug: folds
YsLQ3BAvgQHWXMAv3Wv6Hg: folds
o8A5MUdudVKu+pAwgZOX2w: folds
6iVcnPw9a2oNG6sPQo3G6g: folds
L9qfLYXrczhAPd/VckgsWw collected $1 from pot
L9qfLYXrczhAPd/VckgsWw: doesn't show hand
*** SUMMARY ***
Total pot $1 | Rake $0
Seat 1: o8A5MUdudVKu+pAwgZOX2w (button) folded before Flop (didn't bet)
Seat 2: 6iVcnPw9a2oNG6sPQo3G6g (small blind) folded before Flop
Seat 3: L9qfLYXrczhAPd/VckgsWw (big blind) collected ($1)
Seat 5: j7NIOHLZk7V2o9fOioO5ug folded before Flop (didn't bet)
Seat 6: YsLQ3BAvgQHWXMAv3Wv6Hg folded before Flop (didn't bet)



PokerStars Game #59938685760:  Hold'em No Limit ($0.50/$1.00) - 2009/07/01 0:20:58 ET
Table 'blHlQApStil0OPeQxQxPcwFKpXUINE6M3UxHG4zaMhHAx Seat #4 is the button
Seat 1: x80+i7DJL+81v3quj7KbNg ($24.15 in chips)
Seat 2: wIZ377kjl2fHFGnS93o6bw ($35.50 in chips)
Seat 3: o1axyw4AjQ8n4ubTwlirQQ ($26.20 in chips)
Seat 4: zanka7aAZkigmZpfopXxxA ($35.30 in chips)
Seat 5: uXrDE6JrIi8BZK1L8oQ9bQ ($19 in chips)
Seat 6: JPQzLacMGzeh42mPgyrvVQ ($72.10 in chips)
Seat 7: vR4IO10geOgvTW+LAUBv/A ($111 in chips)
Seat 8: VtjmCz/ASIcETatNJ8YcCA ($68.65 in chips)
uXrDE6JrIi8BZK1L8oQ9bQ: posts small blind $0.50
JPQzLacMGzeh42mPgyrvVQ: posts big blind $1
*** HOLE CARDS ***
vR4IO10geOgvTW+LAUBv/A: folds
VtjmCz/ASIcETatNJ8YcCA: folds
x80+i7DJL+81v3quj7KbNg: folds
wIZ377kjl2fHFGnS93o6bw: folds
o1axyw4AjQ8n4ubTwlirQQ: folds
zanka7aAZkigmZpfopXxxA: folds
uXrDE6JrIi8BZK1L8oQ9bQ: folds
JPQzLacMGzeh42mPgyrvVQ collected $1 from pot
*** SUMMARY ***
Total pot $1 | Rake $0
Seat 1: x80+i7DJL+81v3quj7KbNg folded before Flop (didn't bet)
Seat 2: wIZ377kjl2fHFGnS93o6bw folded before Flop (didn't bet)
Seat 3: o1axyw4AjQ8n4ubTwlirQQ folded before Flop (didn't bet)
Seat 4: zanka7aAZkigmZpfopXxxA (button) folded before Flop (didn't bet)
Seat 5: uXrDE6JrIi8BZK1L8oQ9bQ (small blind) folded before Flop
Seat 6: JPQzLacMGzeh42mPgyrvVQ (big blind) collected ($1)
Seat 7: vR4IO10geOgvTW+LAUBv/A folded before Flop (didn't bet)
Seat 8: VtjmCz/ASIcETatNJ8YcCA folded before Flop (didn't bet)



PokerStars Game #59938687426:  Hold'em No Limit ($0.50/$1.00) - 2009/07/01 0:21:01 ET
Table 'QSIig7BLMc9wY/rgBechzw' 6-max Seat #4 is the button
Seat 1: uuA9hpFU17U5/t4cvpbpBg ($40.75 in chips)
Seat 2: 0WjiuIT7/EolY1oOx1ngeA ($125.40 in chips)
Seat 3: +W6OnF033KNM2xH0fGj98Q ($107.20 in chips)
Seat 4: +uSzP8Jwnw7sKfQ4s66b7w ($48.50 in chips)
Seat 6: KpnW5CcJ4Mg6MeclfKmLrw ($144.75 in chips)
KpnW5CcJ4Mg6MeclfKmLrw: posts small blind $0.50
uuA9hpFU17U5/t4cvpbpBg: posts big blind $1
*** HOLE CARDS ***
0WjiuIT7/EolY1oOx1ngeA: raises $2 to $3
+W6OnF033KNM2xH0fGj98Q: raises $7 to $10
+uSzP8Jwnw7sKfQ4s66b7w: folds
KpnW5CcJ4Mg6MeclfKmLrw: folds
uuA9hpFU17U5/t4cvpbpBg: folds
0WjiuIT7/EolY1oOx1ngeA: folds
+W6OnF033KNM2xH0fGj98Q collected $7.50 from pot
+W6OnF033KNM2xH0fGj98Q: doesn't show hand
*** SUMMARY ***
Total pot $7.50 | Rake $0
Seat 1: uuA9hpFU17U5/t4cvpbpBg (big blind) folded before Flop
Seat 2: 0WjiuIT7/EolY1oOx1ngeA folded before Flop
Seat 3: +W6OnF033KNM2xH0fGj98Q collected ($7.50)
Seat 4: +uSzP8Jwnw7sKfQ4s66b7w (button) folded before Flop (didn't bet)
Seat 6: KpnW5CcJ4Mg6MeclfKmLrw (small blind) folded before Flop



PokerStars Game #59938688240:  Hold'em No Limit ($0.50/$1.00) - 2009/07/01 0:21:02 ET
Table 'J2yEIzCSC1VzM+R2gijwtg' 9-max Seat #8 is the button
Seat 1: knewtTmBc4Tc0z/5tAABYQ ($201.95 in chips)
Seat 2: kz9ziSiGUc+857heiKSayw ($16 in chips)
Seat 3: 9swGhtpERPngKPtvpoZkoQ ($124.15 in chips)
Seat 4: vR4IO10geOgvTW+LAUBv/A ($100 in chips)
Seat 5: /kZ258i1lqmMUXbtrZIHJA ($42.60 in chips)
Seat 6: bJckevFOcg//s0qyMQI6sQ ($176.40 in chips)
Seat 8: CIRDepY9Rc5tiDJPd0nNpQ ($93.90 in chips)
knewtTmBc4Tc0z/5tAABYQ: posts small blind $0.50
kz9ziSiGUc+857heiKSayw: posts big blind $1
*** HOLE CARDS ***
9swGhtpERPngKPtvpoZkoQ: calls $1
vR4IO10geOgvTW+LAUBv/A: folds
/kZ258i1lqmMUXbtrZIHJA: calls $1
bJckevFOcg//s0qyMQI6sQ: folds
CIRDepY9Rc5tiDJPd0nNpQ: folds
knewtTmBc4Tc0z/5tAABYQ: folds
kz9ziSiGUc+857heiKSayw: checks
*** FLOP *** [2d 2c 7s]
kz9ziSiGUc+857heiKSayw: checks
9swGhtpERPngKPtvpoZkoQ: checks
/kZ258i1lqmMUXbtrZIHJA: bets $2
kz9ziSiGUc+857heiKSayw: calls $2
9swGhtpERPngKPtvpoZkoQ: folds
*** TURN *** [2d 2c 7s] [9d]
kz9ziSiGUc+857heiKSayw: checks
/kZ258i1lqmMUXbtrZIHJA: bets $3
kz9ziSiGUc+857heiKSayw: calls $3
*** RIVER *** [2d 2c 7s 9d] [7d]
kz9ziSiGUc+857heiKSayw: bets $6
/kZ258i1lqmMUXbtrZIHJA: raises $6 to $12
kz9ziSiGUc+857heiKSayw: calls $4 and is all-in
*** SHOW DOWN ***
/kZ258i1lqmMUXbtrZIHJA: shows [7h 8h] (a full house, Sevens full of Deuces)
kz9ziSiGUc+857heiKSayw: shows [5d 7c] (a full house, Sevens full of Deuces)
kz9ziSiGUc+857heiKSayw collected $15.95 from pot
/kZ258i1lqmMUXbtrZIHJA collected $15.95 from pot
*** SUMMARY ***
Total pot $33.50 | Rake $1.60
Board [2d 2c 7s 9d 7d]
Seat 1: knewtTmBc4Tc0z/5tAABYQ (small blind) folded before Flop
Seat 2: kz9ziSiGUc+857heiKSayw (big blind) showed [5d 7c] and won ($15.95) with a full house, Sevens full of Deuces
Seat 3: 9swGhtpERPngKPtvpoZkoQ folded on the Flop
Seat 4: vR4IO10geOgvTW+LAUBv/A folded before Flop (didn't bet)
Seat 5: /kZ258i1lqmMUXbtrZIHJA showed [7h 8h] and won ($15.95) with a full house, Sevens full of Deuces
Seat 6: bJckevFOcg//s0qyMQI6sQ folded before Flop (didn't bet)
Seat 8: CIRDepY9Rc5tiDJPd0nNpQ (button) folded before Flop (didn't bet)



PokerStars Game #59938689638:  Hold'em No Limit ($0.50/$1.00) - 2009/07/01 0:21:04 ET
Table 'aWHveb63HkbTmOGHOxjBkQ' 2-max Seat #1 is the button
Seat 1: xy2MQKoHoCZZIudmw8Xbow ($229.30 in chips)
Seat 2: xstEKavv3YDxpUnU4e9qAQ ($144.60 in chips)
xy2MQKoHoCZZIudmw8Xbow: posts small blind $0.50
xstEKavv3YDxpUnU4e9qAQ: posts big blind $1
*** HOLE CARDS ***
xy2MQKoHoCZZIudmw8Xbow: raises $3 to $4
xstEKavv3YDxpUnU4e9qAQ: folds
xy2MQKoHoCZZIudmw8Xbow collected $2 from pot
xy2MQKoHoCZZIudmw8Xbow: doesn't show hand
*** SUMMARY ***
Total pot $2 | Rake $0
Seat 1: xy2MQKoHoCZZIudmw8Xbow (button) (small blind) collected ($2)
Seat 2: xstEKavv3YDxpUnU4e9qAQ (big blind) folded before Flop



PokerStars Game #59938689806:  Hold'em No Limit ($0.50/$1.00) - 2009/07/01 0:21:04 ET
Table 'eU3bWpDDg3Z+9R4m4iVmog' 6-max Seat #4 is the button
Seat 2: 8CAoOzhmB8n3nRFf3V4BTg ($174.95 in chips)
Seat 3: U6tnjwZRpTnM+YkqkCjwyQ ($124.65 in chips)
Seat 4: GDVIsbEJ/DOJsMKE4Asz0A ($92.95 in chips)
Seat 5: QHvTZcrKe6+maWUfVjP29Q ($104 in chips)
Seat 6: hpxXcmRkXXI9HE5+5/j/0Q ($100 in chips)
QHvTZcrKe6+maWUfVjP29Q: posts small blind $0.50
hpxXcmRkXXI9HE5+5/j/0Q: posts big blind $1
*** HOLE CARDS ***
8CAoOzhmB8n3nRFf3V4BTg: folds
U6tnjwZRpTnM+YkqkCjwyQ: folds
GDVIsbEJ/DOJsMKE4Asz0A: folds
QHvTZcrKe6+maWUfVjP29Q: folds
hpxXcmRkXXI9HE5+5/j/0Q collected $1 from pot
hpxXcmRkXXI9HE5+5/j/0Q: doesn't show hand
*** SUMMARY ***
Total pot $1 | Rake $0
Seat 2: 8CAoOzhmB8n3nRFf3V4BTg folded before Flop (didn't bet)
Seat 3: U6tnjwZRpTnM+YkqkCjwyQ folded before Flop (didn't bet)
Seat 4: GDVIsbEJ/DOJsMKE4Asz0A (button) folded before Flop (didn't bet)
Seat 5: QHvTZcrKe6+maWUfVjP29Q (small blind) folded before Flop
Seat 6: hpxXcmRkXXI9HE5+5/j/0Q (big blind) collected ($1)



PokerStars Game #59938690240:  Hold'em No Limit ($0.50/$1.00) - 2009/07/01 0:21:05 ET
Table 'pHrhryH8jPNdQfY62f8v+g' 6-max Seat #1 is the button
Seat 1: BdbmJTZZ47quA9vUWwXtlw ($69.75 in chips)
Seat 2: RqgF7gRoKgRNW8Zoi1ty4A ($100 in chips)
Seat 3: rw4J9hTeo4c+qBV5IU/aQQ ($17.30 in chips)
Seat 4: wenbG7TaM3H7h5kn78OFNw ($55.55 in chips)
Seat 5: Gp2euK/nqF6qXKe7U+jOfw ($120.15 in chips)
Seat 6: xNKcQzD9+/iHmtJn4vYq9w ($220.50 in chips)
RqgF7gRoKgRNW8Zoi1ty4A: posts small blind $0.50
rw4J9hTeo4c+qBV5IU/aQQ: posts big blind $1
*** HOLE CARDS ***
wenbG7TaM3H7h5kn78OFNw: folds
Gp2euK/nqF6qXKe7U+jOfw: folds
xNKcQzD9+/iHmtJn4vYq9w: folds
BdbmJTZZ47quA9vUWwXtlw: folds
RqgF7gRoKgRNW8Zoi1ty4A: raises $2 to $3
rw4J9hTeo4c+qBV5IU/aQQ: raises $14.30 to $17.30 and is all-in
RqgF7gRoKgRNW8Zoi1ty4A: calls $14.30
*** FLOP *** [8s 7d 4h]
*** TURN *** [8s 7d 4h] [5h]
*** RIVER *** [8s 7d 4h 5h] [Ac]
*** SHOW DOWN ***
RqgF7gRoKgRNW8Zoi1ty4A: shows [Qh Qd] (a pair of Queens)
rw4J9hTeo4c+qBV5IU/aQQ: shows [Tc Kh] (high card Ace)
RqgF7gRoKgRNW8Zoi1ty4A collected $32.90 from pot
*** SUMMARY ***
Total pot $34.60 | Rake $1.70
Board [8s 7d 4h 5h Ac]
Seat 1: BdbmJTZZ47quA9vUWwXtlw (button) folded before Flop (didn't bet)
Seat 2: RqgF7gRoKgRNW8Zoi1ty4A (small blind) showed [Qh Qd] and won ($32.90) with a pair of Queens
Seat 3: rw4J9hTeo4c+qBV5IU/aQQ (big blind) showed [Tc Kh] and lost with high card Ace
Seat 4: wenbG7TaM3H7h5kn78OFNw folded before Flop (didn't bet)
Seat 5: Gp2euK/nqF6qXKe7U+jOfw folded before Flop (didn't bet)
Seat 6: xNKcQzD9+/iHmtJn4vYq9w folded before Flop (didn't bet)



PokerStars Game #59938691520:  Hold'em No Limit ($0.50/$1.00) - 2009/07/01 0:21:07 ET
Table 'rmZfTK+oSebeUPJNbWhdAA' 6-max Seat #1 is the button
Seat 1: u4vYQZNWtIzOJre8fvCmvQ ($32.85 in chips)
Seat 2: OigyyiK+tTj1APPIAUmXDA ($77.20 in chips)
Seat 3: 9yjOzGERLaEZS8CZ6YNHFg ($62.80 in chips)
Seat 4: OGMLOcTNYZXZU81au7ztUw ($105.05 in chips)
Seat 5: VuZb/hkEc4X7s93w2ZZTpA ($112.75 in chips)
Seat 6: j7NIOHLZk7V2o9fOioO5ug ($104.80 in chips)
OigyyiK+tTj1APPIAUmXDA: posts small blind $0.50
9yjOzGERLaEZS8CZ6YNHFg: posts big blind $1
*** HOLE CARDS ***
OGMLOcTNYZXZU81au7ztUw: folds
VuZb/hkEc4X7s93w2ZZTpA: folds
j7NIOHLZk7V2o9fOioO5ug: folds
u4vYQZNWtIzOJre8fvCmvQ: folds
OigyyiK+tTj1APPIAUmXDA: raises $2 to $3
9yjOzGERLaEZS8CZ6YNHFg: folds
OigyyiK+tTj1APPIAUmXDA collected $2 from pot
*** SUMMARY ***
Total pot $2 | Rake $0
Seat 1: u4vYQZNWtIzOJre8fvCmvQ (button) folded before Flop (didn't bet)
Seat 2: OigyyiK+tTj1APPIAUmXDA (small blind) collected ($2)
Seat 3: 9yjOzGERLaEZS8CZ6YNHFg (big blind) folded before Flop
Seat 4: OGMLOcTNYZXZU81au7ztUw folded before Flop (didn't bet)
Seat 5: VuZb/hkEc4X7s93w2ZZTpA folded before Flop (didn't bet)
Seat 6: j7NIOHLZk7V2o9fOioO5ug folded before Flop (didn't bet)



PokerStars Game #59938691590:  Hold'em No Limit ($0.50/$1.00) - 2009/07/01 0:21:07 ET
Table '3T4owEKJKyGTMePwrv50FQ' 9-max Seat #5 is the button
Seat 1: i7H4OcR0JBHUDu6bJ34rtw ($72.40 in chips)
Seat 2: p5UKaxVobvptF0ANhR/q1A ($123.30 in chips)
Seat 3: pCl9IYtMJjmAJCt7Pu4TDw ($42.45 in chips)
Seat 5: ArTa9sSTrL++oHeXU/9PPA ($40.60 in chips)
Seat 7: brpN3NxzKqwZCeb5s2Nq4g ($40.05 in chips)
Seat 8: negfosHnGOZXSHpWDRKyBQ ($18.50 in chips)
Seat 9: vR4IO10geOgvTW+LAUBv/A ($125 in chips)
brpN3NxzKqwZCeb5s2Nq4g: posts small blind $0.50
negfosHnGOZXSHpWDRKyBQ: posts big blind $1
*** HOLE CARDS ***
vR4IO10geOgvTW+LAUBv/A: folds
i7H4OcR0JBHUDu6bJ34rtw: folds
i7H4OcR0JBHUDu6bJ34rtw leaves the table
p5UKaxVobvptF0ANhR/q1A: folds
pCl9IYtMJjmAJCt7Pu4TDw: folds
ArTa9sSTrL++oHeXU/9PPA: folds
3MYLdqcdtveb3nHZv3D1IA leaves the table
brpN3NxzKqwZCeb5s2Nq4g: folds
negfosHnGOZXSHpWDRKyBQ collected $1 from pot
negfosHnGOZXSHpWDRKyBQ: doesn't show hand
*** SUMMARY ***
Total pot $1 | Rake $0
Seat 1: i7H4OcR0JBHUDu6bJ34rtw folded before Flop (didn't bet)
Seat 2: p5UKaxVobvptF0ANhR/q1A folded before Flop (didn't bet)
Seat 3: pCl9IYtMJjmAJCt7Pu4TDw folded before Flop (didn't bet)
Seat 5: ArTa9sSTrL++oHeXU/9PPA (button) folded before Flop (didn't bet)
Seat 7: brpN3NxzKqwZCeb5s2Nq4g (small blind) folded before Flop
Seat 8: negfosHnGOZXSHpWDRKyBQ (big blind) collected ($1)
Seat 9: vR4IO10geOgvTW+LAUBv/A folded before Flop (didn't bet)



PokerStars Game #59938694060:  Hold'em No Limit ($0.50/$1.00) - 2009/07/01 0:21:10 ET
Table 'GxCPo/gd3OSthkYrAxJngg' 6-max Seat #1 is the button
Seat 1: sH8BpAFP+jGFxCgVpD1Lew ($180.60 in chips)
Seat 2: YExX2paeIHrmfIwV1ivM/w ($86.20 in chips)
Seat 3: h2lYnlZ7Ueu3PsyB2UOfSQ ($100 in chips)
Seat 4: YMJG+F++3Aj6P8dAWda5fw ($103.65 in chips)
Seat 5: G5ZSSN6RSON3gkNvk/SmYg ($100 in chips)
Seat 6: sS9IXedL3MiRmpVXhAILhw ($100 in chips)
YExX2paeIHrmfIwV1ivM/w: posts small blind $0.50
h2lYnlZ7Ueu3PsyB2UOfSQ: posts big blind $1
*** HOLE CARDS ***
YMJG+F++3Aj6P8dAWda5fw: folds
G5ZSSN6RSON3gkNvk/SmYg: folds
sS9IXedL3MiRmpVXhAILhw: folds
sH8BpAFP+jGFxCgVpD1Lew: calls $1
YExX2paeIHrmfIwV1ivM/w: calls $0.50
h2lYnlZ7Ueu3PsyB2UOfSQ: checks
*** FLOP *** [9h 4d Js]
YExX2paeIHrmfIwV1ivM/w: checks
h2lYnlZ7Ueu3PsyB2UOfSQ: checks
sH8BpAFP+jGFxCgVpD1Lew: bets $3
YExX2paeIHrmfIwV1ivM/w: folds
h2lYnlZ7Ueu3PsyB2UOfSQ: folds
sH8BpAFP+jGFxCgVpD1Lew collected $2.85 from pot
*** SUMMARY ***
Total pot $3 | Rake $0.15
Board [9h 4d Js]
Seat 1: sH8BpAFP+jGFxCgVpD1Lew (button) collected ($2.85)
Seat 2: YExX2paeIHrmfIwV1ivM/w (small blind) folded on the Flop
Seat 3: h2lYnlZ7Ueu3PsyB2UOfSQ (big blind) folded on the Flop
Seat 4: YMJG+F++3Aj6P8dAWda5fw folded before Flop (didn't bet)
Seat 5: G5ZSSN6RSON3gkNvk/SmYg folded before Flop (didn't bet)
Seat 6: sS9IXedL3MiRmpVXhAILhw folded before Flop (didn't bet)



PokerStars Game #59938694508:  Hold'em No Limit ($0.50/$1.00) - 2009/07/01 0:21:11 ET
Table 'tyUh+jyNvrceIQdKMJjQ2wZFWj23PMihdwrNWv41OG/Qeat #2 is the button
Seat 1: o8A5MUdudVKu+pAwgZOX2w ($197.25 in chips)
Seat 2: 6iVcnPw9a2oNG6sPQo3G6g ($99.15 in chips)
Seat 3: L9qfLYXrczhAPd/VckgsWw ($39.10 in chips)
Seat 5: j7NIOHLZk7V2o9fOioO5ug ($103.10 in chips)
Seat 6: YsLQ3BAvgQHWXMAv3Wv6Hg ($105.25 in chips)
L9qfLYXrczhAPd/VckgsWw: posts small blind $0.50
j7NIOHLZk7V2o9fOioO5ug: posts big blind $1
*** HOLE CARDS ***
YsLQ3BAvgQHWXMAv3Wv6Hg: raises $3 to $4
o8A5MUdudVKu+pAwgZOX2w: folds
6iVcnPw9a2oNG6sPQo3G6g: folds
L9qfLYXrczhAPd/VckgsWw: folds
j7NIOHLZk7V2o9fOioO5ug: folds
YsLQ3BAvgQHWXMAv3Wv6Hg collected $2.50 from pot
YsLQ3BAvgQHWXMAv3Wv6Hg: doesn't show hand
*** SUMMARY ***
Total pot $2.50 | Rake $0
Seat 1: o8A5MUdudVKu+pAwgZOX2w folded before Flop (didn't bet)
Seat 2: 6iVcnPw9a2oNG6sPQo3G6g (button) folded before Flop (didn't bet)
Seat 3: L9qfLYXrczhAPd/VckgsWw (small blind) folded before Flop
Seat 5: j7NIOHLZk7V2o9fOioO5ug (big blind) folded before Flop
Seat 6: YsLQ3BAvgQHWXMAv3Wv6Hg collected ($2.50)



PokerStars Game #59938695284:  Hold'em No Limit ($0.50/$1.00) - 2009/07/01 0:21:12 ET
Table 'aWHveb63HkbTmOGHOxjBkQ' 2-max Seat #2 is the button
Seat 1: xy2MQKoHoCZZIudmw8Xbow ($230.30 in chips)
Seat 2: xstEKavv3YDxpUnU4e9qAQ ($143.60 in chips)
xstEKavv3YDxpUnU4e9qAQ: posts small blind $0.50
xy2MQKoHoCZZIudmw8Xbow: posts big blind $1
*** HOLE CARDS ***
xstEKavv3YDxpUnU4e9qAQ: folds
xy2MQKoHoCZZIudmw8Xbow collected $1 from pot
xy2MQKoHoCZZIudmw8Xbow: doesn't show hand
*** SUMMARY ***
Total pot $1 | Rake $0
Seat 1: xy2MQKoHoCZZIudmw8Xbow (big blind) collected ($1)
Seat 2: xstEKavv3YDxpUnU4e9qAQ (button) (small blind) folded before Flop



PokerStars Game #59938696050:  Hold'em No Limit ($0.50/$1.00) - 2009/07/01 0:21:13 ET
Table 'cBDNutyLBKEk9+ptwsKmTw' 6-max Seat #1 is the button
Seat 1: tb0dt30qP2x/8f+Xta4mVg ($20.80 in chips)
Seat 2: KyaE4+hWgUNIWWOWy4D14w ($60.30 in chips)
Seat 3: G5ZSSN6RSON3gkNvk/SmYg ($107.40 in chips)
Seat 4: 0WjiuIT7/EolY1oOx1ngeA ($107.65 in chips)
Seat 5: OGMLOcTNYZXZU81au7ztUw ($111.20 in chips)
Seat 6: pyzhFUPPSNzrysiMqlA5Xw ($11.25 in chips)
KyaE4+hWgUNIWWOWy4D14w: posts small blind $0.50
G5ZSSN6RSON3gkNvk/SmYg: posts big blind $1
*** HOLE CARDS ***
0WjiuIT7/EolY1oOx1ngeA: folds
OGMLOcTNYZXZU81au7ztUw: folds
pyzhFUPPSNzrysiMqlA5Xw: calls $1
tb0dt30qP2x/8f+Xta4mVg: folds
KyaE4+hWgUNIWWOWy4D14w: calls $0.50
G5ZSSN6RSON3gkNvk/SmYg: checks
*** FLOP *** [Qs 9s 2d]
KyaE4+hWgUNIWWOWy4D14w: checks
G5ZSSN6RSON3gkNvk/SmYg: checks
pyzhFUPPSNzrysiMqlA5Xw: checks
*** TURN *** [Qs 9s 2d] [Ah]
KyaE4+hWgUNIWWOWy4D14w: checks
G5ZSSN6RSON3gkNvk/SmYg: checks
pyzhFUPPSNzrysiMqlA5Xw: bets $2
KyaE4+hWgUNIWWOWy4D14w: folds
G5ZSSN6RSON3gkNvk/SmYg: folds
pyzhFUPPSNzrysiMqlA5Xw collected $2.85 from pot
*** SUMMARY ***
Total pot $3 | Rake $0.15
Board [Qs 9s 2d Ah]
Seat 1: tb0dt30qP2x/8f+Xta4mVg (button) folded before Flop (didn't bet)
Seat 2: KyaE4+hWgUNIWWOWy4D14w (small blind) folded on the Turn
Seat 3: G5ZSSN6RSON3gkNvk/SmYg (big blind) folded on the Turn
Seat 4: 0WjiuIT7/EolY1oOx1ngeA folded before Flop (didn't bet)
Seat 5: OGMLOcTNYZXZU81au7ztUw folded before Flop (didn't bet)
Seat 6: pyzhFUPPSNzrysiMqlA5Xw collected ($2.85)



PokerStars Game #59938696858:  Hold'em No Limit ($0.50/$1.00) - 2009/07/01 0:21:14 ET
Table '/RZcOwpZpHQ+OwPwjsbnRw' 6-max Seat #6 is the button
Seat 1: jMljU/dOPMXfJi8OmbdYdw ($46.65 in chips)
Seat 2: dHC9PH9hdH3Ad2TD8ZxX0Q ($47.10 in chips)
Seat 3: OigyyiK+tTj1APPIAUmXDA ($80.60 in chips)
Seat 4: j7NIOHLZk7V2o9fOioO5ug ($100 in chips)
Seat 5: wx3sQGkVi2x9wJXuWNHPBw ($208.05 in chips)
Seat 6: XOIf9W+VAxhZqN+SYoyMKA ($255.30 in chips)
jMljU/dOPMXfJi8OmbdYdw: posts small blind $0.50
dHC9PH9hdH3Ad2TD8ZxX0Q: posts big blind $1
*** HOLE CARDS ***
OigyyiK+tTj1APPIAUmXDA: folds
j7NIOHLZk7V2o9fOioO5ug: raises $2 to $3
wx3sQGkVi2x9wJXuWNHPBw: calls $3
XOIf9W+VAxhZqN+SYoyMKA: folds
jMljU/dOPMXfJi8OmbdYdw: raises $12 to $15
dHC9PH9hdH3Ad2TD8ZxX0Q: folds
j7NIOHLZk7V2o9fOioO5ug: raises $35 to $50
wx3sQGkVi2x9wJXuWNHPBw: folds
jMljU/dOPMXfJi8OmbdYdw: calls $31.65 and is all-in
*** FLOP *** [5d Jc 4d]
*** TURN *** [5d Jc 4d] [4h]
*** RIVER *** [5d Jc 4d 4h] [Ks]
*** SHOW DOWN ***
jMljU/dOPMXfJi8OmbdYdw: shows [Js Jd] (a full house, Jacks full of Fours)
j7NIOHLZk7V2o9fOioO5ug: mucks hand
jMljU/dOPMXfJi8OmbdYdw collected $94.30 from pot
*** SUMMARY ***
Total pot $97.30 | Rake $3
Board [5d Jc 4d 4h Ks]
Seat 1: jMljU/dOPMXfJi8OmbdYdw (small blind) showed [Js Jd] and won ($94.30) with a full house, Jacks full of Fours
Seat 2: dHC9PH9hdH3Ad2TD8ZxX0Q (big blind) folded before Flop
Seat 3: OigyyiK+tTj1APPIAUmXDA folded before Flop (didn't bet)
Seat 4: j7NIOHLZk7V2o9fOioO5ug mucked
Seat 5: wx3sQGkVi2x9wJXuWNHPBw folded before Flop
Seat 6: XOIf9W+VAxhZqN+SYoyMKA (button) folded before Flop (didn't bet)



PokerStars Game #59938696468:  Hold'em No Limit ($0.50/$1.00) - 2009/07/01 0:21:14 ET
Table 'kS0cTQAEi+fdUlJP2gQYvw' 9-max Seat #4 is the button
Seat 1: c/9X4zftzphFxYtxp5kp9w ($51.90 in chips)
Seat 2: 4SFNYndzMeslixOnF4koZQ ($41.25 in chips)
Seat 3: 3obndzTJ6fECz8+wWhMd1w ($18.50 in chips)
Seat 4: TZcz9MEWDA+WydgGruqqbw ($108.80 in chips)
Seat 6: yAbu2QsRPVcjPbqlf/jDxw ($101.15 in chips)
Seat 7: Ffa7Nj4X5fddtROP01hfQg ($86.65 in chips)
Seat 8: qTymj6ZQ8ZoFi6fINJZb3w ($87 in chips)
Seat 9: y8Qb94e81yI/g0saQ6gU5g ($89.25 in chips)
2rxrMrE7koO2BNxvop/0+g will be allowed to play after the button
yAbu2QsRPVcjPbqlf/jDxw: posts small blind $0.50
Ffa7Nj4X5fddtROP01hfQg: posts big blind $1
*** HOLE CARDS ***
qTymj6ZQ8ZoFi6fINJZb3w: folds
y8Qb94e81yI/g0saQ6gU5g: folds
c/9X4zftzphFxYtxp5kp9w: folds
4SFNYndzMeslixOnF4koZQ: calls $1
3obndzTJ6fECz8+wWhMd1w: folds
TZcz9MEWDA+WydgGruqqbw: raises $3 to $4
yAbu2QsRPVcjPbqlf/jDxw: folds
Ffa7Nj4X5fddtROP01hfQg: folds
4SFNYndzMeslixOnF4koZQ: calls $3
*** FLOP *** [5c Qc 4d]
4SFNYndzMeslixOnF4koZQ: bets $4
TZcz9MEWDA+WydgGruqqbw: calls $4
*** TURN *** [5c Qc 4d] [Qs]
c/9X4zftzphFxYtxp5kp9w said, "i woulda been happy for all the suck outs i've had with the aces"
4SFNYndzMeslixOnF4koZQ: bets $4
TZcz9MEWDA+WydgGruqqbw: calls $4
*** RIVER *** [5c Qc 4d Qs] [Kd]
4SFNYndzMeslixOnF4koZQ: bets $4
TZcz9MEWDA+WydgGruqqbw: calls $4
*** SHOW DOWN ***
4SFNYndzMeslixOnF4koZQ: shows [Th Qd] (three of a kind, Queens)
TZcz9MEWDA+WydgGruqqbw: mucks hand
4SFNYndzMeslixOnF4koZQ collected $31.90 from pot
*** SUMMARY ***
Total pot $33.50 | Rake $1.60
Board [5c Qc 4d Qs Kd]
Seat 1: c/9X4zftzphFxYtxp5kp9w folded before Flop (didn't bet)
Seat 2: 4SFNYndzMeslixOnF4koZQ showed [Th Qd] and won ($31.90) with three of a kind, Queens
Seat 3: 3obndzTJ6fECz8+wWhMd1w folded before Flop (didn't bet)
Seat 4: TZcz9MEWDA+WydgGruqqbw (button) mucked
Seat 6: yAbu2QsRPVcjPbqlf/jDxw (small blind) folded before Flop
Seat 7: Ffa7Nj4X5fddtROP01hfQg (big blind) folded before Flop
Seat 8: qTymj6ZQ8ZoFi6fINJZb3w folded before Flop (didn't bet)
Seat 9: y8Qb94e81yI/g0saQ6gU5g folded before Flop (didn't bet)



PokerStars Game #59938697482:  Hold'em No Limit ($0.50/$1.00) - 2009/07/01 0:21:15 ET
Table 'fTlPiCj0utgzC/5io+I7ew' 6-max Seat #1 is the button
Seat 1: YMJG+F++3Aj6P8dAWda5fw ($100 in chips)
Seat 2: +xUCTmR3cU7G239W+vZv6g ($139.50 in chips)
Seat 3: oDiBRCaF0QVtd3kO6xZIXw ($100 in chips)
Seat 4: uJVSceLggtsrJya+WtmUEA ($103.10 in chips)
Seat 5: bFrTkDcWGTxyvNul7GVdYg ($239 in chips)
+xUCTmR3cU7G239W+vZv6g: posts small blind $0.50
oDiBRCaF0QVtd3kO6xZIXw: posts big blind $1
*** HOLE CARDS ***
uJVSceLggtsrJya+WtmUEA: folds
bFrTkDcWGTxyvNul7GVdYg: folds
YMJG+F++3Aj6P8dAWda5fw: folds
+xUCTmR3cU7G239W+vZv6g: raises $2 to $3
oDiBRCaF0QVtd3kO6xZIXw: calls $2
*** FLOP *** [8c 3s 5h]
+xUCTmR3cU7G239W+vZv6g: bets $4
oDiBRCaF0QVtd3kO6xZIXw: folds
+xUCTmR3cU7G239W+vZv6g collected $5.70 from pot
*** SUMMARY ***
Total pot $6 | Rake $0.30
Board [8c 3s 5h]
Seat 1: YMJG+F++3Aj6P8dAWda5fw (button) folded before Flop (didn't bet)
Seat 2: +xUCTmR3cU7G239W+vZv6g (small blind) collected ($5.70)
Seat 3: oDiBRCaF0QVtd3kO6xZIXw (big blind) folded on the Flop
Seat 4: uJVSceLggtsrJya+WtmUEA folded before Flop (didn't bet)
Seat 5: bFrTkDcWGTxyvNul7GVdYg folded before Flop (didn't bet)



PokerStars Game #59938696928:  Hold'em No Limit ($0.50/$1.00) - 2009/07/01 0:21:15 ET
Table 'W/wyObTiXZm+Ckkl3YxcSw' 6-max Seat #3 is the button
Seat 1: ssLJburtEIqnVkx6X8R1uw ($118.85 in chips)
Seat 3: b2a+5TkFf4xJN/Ihhma58Q ($38.20 in chips)
Seat 4: BdbmJTZZ47quA9vUWwXtlw ($50.60 in chips)
Seat 5: Wko+clJG9HZPPQ7Yn0Y5Zg ($25.85 in chips)
BdbmJTZZ47quA9vUWwXtlw: posts small blind $0.50
Wko+clJG9HZPPQ7Yn0Y5Zg: posts big blind $1
oDiBRCaF0QVtd3kO6xZIXw: sits out
*** HOLE CARDS ***
ssLJburtEIqnVkx6X8R1uw: raises $2 to $3
b2a+5TkFf4xJN/Ihhma58Q: folds
BdbmJTZZ47quA9vUWwXtlw: folds
Wko+clJG9HZPPQ7Yn0Y5Zg: calls $2
*** FLOP *** [As 3c 8d]
Wko+clJG9HZPPQ7Yn0Y5Zg: checks
ssLJburtEIqnVkx6X8R1uw: bets $4
Wko+clJG9HZPPQ7Yn0Y5Zg: calls $4
*** TURN *** [As 3c 8d] [5d]
Wko+clJG9HZPPQ7Yn0Y5Zg: checks
ssLJburtEIqnVkx6X8R1uw: checks
*** RIVER *** [As 3c 8d 5d] [3h]
Wko+clJG9HZPPQ7Yn0Y5Zg: checks
ssLJburtEIqnVkx6X8R1uw: checks
*** SHOW DOWN ***
Wko+clJG9HZPPQ7Yn0Y5Zg: shows [Js 8s] (two pair, Eights and Threes)
ssLJburtEIqnVkx6X8R1uw: shows [8h 7h] (two pair, Eights and Threes)
Wko+clJG9HZPPQ7Yn0Y5Zg collected $6.90 from pot
ssLJburtEIqnVkx6X8R1uw collected $6.90 from pot
*** SUMMARY ***
Total pot $14.50 | Rake $0.70
Board [As 3c 8d 5d 3h]
Seat 1: ssLJburtEIqnVkx6X8R1uw showed [8h 7h] and won ($6.90) with two pair, Eights and Threes
Seat 3: b2a+5TkFf4xJN/Ihhma58Q (button) folded before Flop (didn't bet)
Seat 4: BdbmJTZZ47quA9vUWwXtlw (small blind) folded before Flop
Seat 5: Wko+clJG9HZPPQ7Yn0Y5Zg (big blind) showed [Js 8s] and won ($6.90) with two pair, Eights and Threes



PokerStars Game #59938697916:  Hold'em No Limit ($0.50/$1.00) - 2009/07/01 0:21:16 ET
Table 'SQLOQoANiHscJ8AL7zffbw' 9-max Seat #5 is the button
Seat 1: jPTRd6SpCp4xqAy2XQiTOw ($103.05 in chips)
Seat 2: /zy+DB4S5fUQUSfZWFzYGw ($280.35 in chips)
Seat 3: 0eFnow7+D7veCYQ+CG9FFw ($98.50 in chips)
Seat 4: N9n5Wc3s35DpCrOAUUNAaQ ($120.30 in chips)
Seat 5: L9njYvloJ1NdXjP8edHEAg ($101 in chips)
Seat 6: p5UKaxVobvptF0ANhR/q1A ($157.50 in chips)
Seat 7: bJckevFOcg//s0qyMQI6sQ ($105.05 in chips)
p5UKaxVobvptF0ANhR/q1A: posts small blind $0.50
bJckevFOcg//s0qyMQI6sQ: posts big blind $1
9ce+0Dl3d0BeEFIP+8HezA: sits out
qJr25HAtvv1w/7IBvjMM3g: sits out
*** HOLE CARDS ***
jPTRd6SpCp4xqAy2XQiTOw: calls $1
/zy+DB4S5fUQUSfZWFzYGw: folds
0eFnow7+D7veCYQ+CG9FFw: folds
N9n5Wc3s35DpCrOAUUNAaQ: folds
L9njYvloJ1NdXjP8edHEAg: raises $3 to $4
p5UKaxVobvptF0ANhR/q1A: folds
bJckevFOcg//s0qyMQI6sQ: folds
jPTRd6SpCp4xqAy2XQiTOw: calls $3
*** FLOP *** [6d 2c Ts]
jPTRd6SpCp4xqAy2XQiTOw: bets $5
L9njYvloJ1NdXjP8edHEAg: raises $10 to $15
jPTRd6SpCp4xqAy2XQiTOw: folds
L9njYvloJ1NdXjP8edHEAg collected $18.55 from pot
*** SUMMARY ***
Total pot $19.50 | Rake $0.95
Board [6d 2c Ts]
Seat 1: jPTRd6SpCp4xqAy2XQiTOw folded on the Flop
Seat 2: /zy+DB4S5fUQUSfZWFzYGw folded before Flop (didn't bet)
Seat 3: 0eFnow7+D7veCYQ+CG9FFw folded before Flop (didn't bet)
Seat 4: N9n5Wc3s35DpCrOAUUNAaQ folded before Flop (didn't bet)
Seat 5: L9njYvloJ1NdXjP8edHEAg (button) collected ($18.55)
Seat 6: p5UKaxVobvptF0ANhR/q1A (small blind) folded before Flop
Seat 7: bJckevFOcg//s0qyMQI6sQ (big blind) folded before Flop



PokerStars Game #59938697562:  Hold'em No Limit ($0.50/$1.00) - 2009/07/01 0:21:16 ET
Table 'ZFWj23PMihdwrNWv41OG/Q' 9-max Seat #4 is the button
Seat 1: yAbu2QsRPVcjPbqlf/jDxw ($103.30 in chips)
Seat 2: ARfmgHcEUKh68laBZy4veA ($36.05 in chips)
Seat 3: G9Fo2TZCN7HI43Po4zSN3A ($100 in chips)
Seat 4: PEmogYqKpuv0ozeBbXL+7Q ($15.25 in chips)
Seat 5: aNuEPl+Lh/dZypIbbfz+mA ($7.35 in chips)
Seat 6: tjhwe1V98x2spSoUQER3HQ ($100 in chips)
Seat 7: wIZ377kjl2fHFGnS93o6bw ($43.55 in chips)
Seat 8: knewtTmBc4Tc0z/5tAABYQ ($107 in chips)
Seat 9: atVaKXE/AQGa798rpMF/Bg ($57 in chips)
aNuEPl+Lh/dZypIbbfz+mA: posts small blind $0.50
tjhwe1V98x2spSoUQER3HQ: posts big blind $1
*** HOLE CARDS ***
wIZ377kjl2fHFGnS93o6bw: folds
knewtTmBc4Tc0z/5tAABYQ: folds
atVaKXE/AQGa798rpMF/Bg: folds
yAbu2QsRPVcjPbqlf/jDxw: folds
ARfmgHcEUKh68laBZy4veA: raises $2 to $3
G9Fo2TZCN7HI43Po4zSN3A: folds
PEmogYqKpuv0ozeBbXL+7Q: raises $12.25 to $15.25 and is all-in
aNuEPl+Lh/dZypIbbfz+mA: calls $6.85 and is all-in
tjhwe1V98x2spSoUQER3HQ: folds
ARfmgHcEUKh68laBZy4veA: calls $12.25
*** FLOP *** [4h 5h 9h]
*** TURN *** [4h 5h 9h] [Kd]
*** RIVER *** [4h 5h 9h Kd] [Qc]
*** SHOW DOWN ***
ARfmgHcEUKh68laBZy4veA: shows [Th Ah] (a flush, Ace high)
PEmogYqKpuv0ozeBbXL+7Q: mucks hand
ARfmgHcEUKh68laBZy4veA collected $15.05 from side pot
aNuEPl+Lh/dZypIbbfz+mA: mucks hand
ARfmgHcEUKh68laBZy4veA collected $21.90 from main pot
*** SUMMARY ***
Total pot $38.85 Main pot $21.90. Side pot $15.05. | Rake $1.90
Board [4h 5h 9h Kd Qc]
Seat 1: yAbu2QsRPVcjPbqlf/jDxw folded before Flop (didn't bet)
Seat 2: ARfmgHcEUKh68laBZy4veA showed [Th Ah] and won ($36.95) with a flush, Ace high
Seat 3: G9Fo2TZCN7HI43Po4zSN3A folded before Flop (didn't bet)
Seat 4: PEmogYqKpuv0ozeBbXL+7Q (button) mucked
Seat 5: aNuEPl+Lh/dZypIbbfz+mA (small blind) mucked
Seat 6: tjhwe1V98x2spSoUQER3HQ (big blind) folded before Flop
Seat 7: wIZ377kjl2fHFGnS93o6bw folded before Flop (didn't bet)
Seat 8: knewtTmBc4Tc0z/5tAABYQ folded before Flop (didn't bet)
Seat 9: atVaKXE/AQGa798rpMF/Bg folded before Flop (didn't bet)



PokerStars Game #59938699058:  Hold'em No Limit ($0.50/$1.00) - 2009/07/01 0:21:18 ET
Table 'aWHveb63HkbTmOGHOxjBkQ' 2-max Seat #1 is the button
Seat 1: xy2MQKoHoCZZIudmw8Xbow ($230.80 in chips)
Seat 2: xstEKavv3YDxpUnU4e9qAQ ($143.10 in chips)
xy2MQKoHoCZZIudmw8Xbow: posts small blind $0.50
xstEKavv3YDxpUnU4e9qAQ: posts big blind $1
*** HOLE CARDS ***
xy2MQKoHoCZZIudmw8Xbow: folds
xstEKavv3YDxpUnU4e9qAQ collected $1 from pot
*** SUMMARY ***
Total pot $1 | Rake $0
Seat 1: xy2MQKoHoCZZIudmw8Xbow (button) (small blind) folded before Flop
Seat 2: xstEKavv3YDxpUnU4e9qAQ (big blind) collected ($1)



PokerStars Game #59938698944:  Hold'em No Limit ($0.50/$1.00) - 2009/07/01 0:21:18 ET
Table 'eU3bWpDDg3Z+9R4m4iVmog' 6-max Seat #5 is the button
Seat 2: 8CAoOzhmB8n3nRFf3V4BTg ($174.95 in chips)
Seat 3: U6tnjwZRpTnM+YkqkCjwyQ ($124.65 in chips)
Seat 4: GDVIsbEJ/DOJsMKE4Asz0A ($92.95 in chips)
Seat 5: QHvTZcrKe6+maWUfVjP29Q ($103.50 in chips)
Seat 6: hpxXcmRkXXI9HE5+5/j/0Q ($100.50 in chips)
hpxXcmRkXXI9HE5+5/j/0Q: posts small blind $0.50
8CAoOzhmB8n3nRFf3V4BTg: posts big blind $1
*** HOLE CARDS ***
U6tnjwZRpTnM+YkqkCjwyQ: raises $3 to $4
GDVIsbEJ/DOJsMKE4Asz0A: folds
QHvTZcrKe6+maWUfVjP29Q: folds
hpxXcmRkXXI9HE5+5/j/0Q: folds
8CAoOzhmB8n3nRFf3V4BTg: calls $3
*** FLOP *** [7c Th 7d]
8CAoOzhmB8n3nRFf3V4BTg: checks
TSuRyAHnUPCFjP7Z0rEE0w is connected
U6tnjwZRpTnM+YkqkCjwyQ: bets $8
8CAoOzhmB8n3nRFf3V4BTg: calls $8
*** TURN *** [7c Th 7d] [Qh]
8CAoOzhmB8n3nRFf3V4BTg: checks
U6tnjwZRpTnM+YkqkCjwyQ: checks
*** RIVER *** [7c Th 7d Qh] [4d]
TSuRyAHnUPCFjP7Z0rEE0w has returned
8CAoOzhmB8n3nRFf3V4BTg: checks
U6tnjwZRpTnM+YkqkCjwyQ: bets $21
8CAoOzhmB8n3nRFf3V4BTg: calls $21
*** SHOW DOWN ***
U6tnjwZRpTnM+YkqkCjwyQ: shows [Ks Kh] (two pair, Kings and Sevens)
8CAoOzhmB8n3nRFf3V4BTg: mucks hand
U6tnjwZRpTnM+YkqkCjwyQ collected $64.50 from pot
*** SUMMARY ***
Total pot $66.50 | Rake $2
Board [7c Th 7d Qh 4d]
Seat 2: 8CAoOzhmB8n3nRFf3V4BTg (big blind) mucked
Seat 3: U6tnjwZRpTnM+YkqkCjwyQ showed [Ks Kh] and won ($64.50) with two pair, Kings and Sevens
Seat 4: GDVIsbEJ/DOJsMKE4Asz0A folded before Flop (didn't bet)
Seat 5: QHvTZcrKe6+maWUfVjP29Q (button) folded before Flop (didn't bet)
Seat 6: hpxXcmRkXXI9HE5+5/j/0Q (small blind) folded before Flop



PokerStars Game #59938702546:  Hold'em No Limit ($0.50/$1.00) - 2009/07/01 0:21:23 ET
Table 'mmbQQVBTrPdE+wy+s+9VPA' 6-max Seat #6 is the button
Seat 1: P9iqlRE1diA1wRYdf4YRBQ ($117.40 in chips)
Seat 3: wx3sQGkVi2x9wJXuWNHPBw ($105.60 in chips)
Seat 4: RfKnhkJN8HEAuzJpH2Ajdg ($18.05 in chips)
Seat 5: YMJG+F++3Aj6P8dAWda5fw ($100 in chips)
Seat 6: klQ/ufr9lOvfLMdAu0S9cw ($26.10 in chips)
P9iqlRE1diA1wRYdf4YRBQ: posts small blind $0.50
ru6SCVvWcWt2SpmUsmArWQ joins the table at seat #2
wx3sQGkVi2x9wJXuWNHPBw: posts big blind $1
*** HOLE CARDS ***
RfKnhkJN8HEAuzJpH2Ajdg: calls $1
YMJG+F++3Aj6P8dAWda5fw: folds
klQ/ufr9lOvfLMdAu0S9cw: folds
P9iqlRE1diA1wRYdf4YRBQ: folds
wx3sQGkVi2x9wJXuWNHPBw: checks
*** FLOP *** [9s 2s 3c]
wx3sQGkVi2x9wJXuWNHPBw: checks
RfKnhkJN8HEAuzJpH2Ajdg: checks
*** TURN *** [9s 2s 3c] [6d]
wx3sQGkVi2x9wJXuWNHPBw: bets $2
RfKnhkJN8HEAuzJpH2Ajdg: folds
wx3sQGkVi2x9wJXuWNHPBw collected $2.40 from pot
*** SUMMARY ***
Total pot $2.50 | Rake $0.10
Board [9s 2s 3c 6d]
Seat 1: P9iqlRE1diA1wRYdf4YRBQ (small blind) folded before Flop
Seat 3: wx3sQGkVi2x9wJXuWNHPBw (big blind) collected ($2.40)
Seat 4: RfKnhkJN8HEAuzJpH2Ajdg folded on the Turn
Seat 5: YMJG+F++3Aj6P8dAWda5fw folded before Flop (didn't bet)
Seat 6: klQ/ufr9lOvfLMdAu0S9cw (button) folded before Flop (didn't bet)



PokerStars Game #59938703522:  Hold'em No Limit ($0.50/$1.00) - 2009/07/01 0:21:24 ET
Table 'tyUh+jyNvrceIQdKMJjQ2wZFWj23PMihdwrNWv41OG/Qeat #3 is the button
Seat 1: o8A5MUdudVKu+pAwgZOX2w ($197.25 in chips)
Seat 2: 6iVcnPw9a2oNG6sPQo3G6g ($99.15 in chips)
Seat 3: L9qfLYXrczhAPd/VckgsWw ($38.60 in chips)
Seat 5: j7NIOHLZk7V2o9fOioO5ug ($102.10 in chips)
Seat 6: YsLQ3BAvgQHWXMAv3Wv6Hg ($106.75 in chips)
j7NIOHLZk7V2o9fOioO5ug: posts small blind $0.50
YsLQ3BAvgQHWXMAv3Wv6Hg: posts big blind $1
*** HOLE CARDS ***
o8A5MUdudVKu+pAwgZOX2w: calls $1
6iVcnPw9a2oNG6sPQo3G6g: folds
L9qfLYXrczhAPd/VckgsWw: folds
j7NIOHLZk7V2o9fOioO5ug: calls $0.50
YsLQ3BAvgQHWXMAv3Wv6Hg: checks
*** FLOP *** [Qh Ks 7c]
j7NIOHLZk7V2o9fOioO5ug: bets $3
TSuRyAHnUPCFjP7Z0rEE0w is connected
YsLQ3BAvgQHWXMAv3Wv6Hg: folds
o8A5MUdudVKu+pAwgZOX2w: folds
j7NIOHLZk7V2o9fOioO5ug collected $2.85 from pot
j7NIOHLZk7V2o9fOioO5ug: doesn't show hand
*** SUMMARY ***
Total pot $3 | Rake $0.15
Board [Qh Ks 7c]
Seat 1: o8A5MUdudVKu+pAwgZOX2w folded on the Flop
Seat 2: 6iVcnPw9a2oNG6sPQo3G6g folded before Flop (didn't bet)
Seat 3: L9qfLYXrczhAPd/VckgsWw (button) folded before Flop (didn't bet)
Seat 5: j7NIOHLZk7V2o9fOioO5ug (small blind) collected ($2.85)
Seat 6: YsLQ3BAvgQHWXMAv3Wv6Hg (big blind) folded on the Flop



PokerStars Game #59938703026:  Hold'em No Limit ($0.50/$1.00) - 2009/07/01 0:21:24 ET
Table 'aWHveb63HkbTmOGHOxjBkQ' 2-max Seat #2 is the button
Seat 1: xy2MQKoHoCZZIudmw8Xbow ($230.30 in chips)
Seat 2: xstEKavv3YDxpUnU4e9qAQ ($143.60 in chips)
xstEKavv3YDxpUnU4e9qAQ: posts small blind $0.50
xy2MQKoHoCZZIudmw8Xbow: posts big blind $1
*** HOLE CARDS ***
xstEKavv3YDxpUnU4e9qAQ: folds
xy2MQKoHoCZZIudmw8Xbow collected $1 from pot
xy2MQKoHoCZZIudmw8Xbow: doesn't show hand
*** SUMMARY ***
Total pot $1 | Rake $0
Seat 1: xy2MQKoHoCZZIudmw8Xbow (big blind) collected ($1)
Seat 2: xstEKavv3YDxpUnU4e9qAQ (button) (small blind) folded before Flop



PokerStars Game #59938703718:  Hold'em No Limit ($0.50/$1.00) - 2009/07/01 0:21:25 ET
Table 'N2bNCDHL96aCQDvZIh+yQQ' 6-max Seat #2 is the button
Seat 1: iHo1oDbrEVJ8nEGdaPrICw ($142.45 in chips)
Seat 2: KpnW5CcJ4Mg6MeclfKmLrw ($105 in chips)
Seat 3: PXT6kJgVX67c3EgncNqRoA ($51.95 in chips)
Seat 4: uCqEjnxh2/vFBjKYkfTOkw ($159.20 in chips)
Seat 5: rHlMOfR7kpQQxe+PFQz0xQ ($37 in chips)
PXT6kJgVX67c3EgncNqRoA: posts small blind $0.50
uCqEjnxh2/vFBjKYkfTOkw: posts big blind $1
*** HOLE CARDS ***
rHlMOfR7kpQQxe+PFQz0xQ: folds
iHo1oDbrEVJ8nEGdaPrICw: raises $2 to $3
KpnW5CcJ4Mg6MeclfKmLrw: calls $3
TSuRyAHnUPCFjP7Z0rEE0w is connected
PXT6kJgVX67c3EgncNqRoA: folds
uCqEjnxh2/vFBjKYkfTOkw: calls $2
*** FLOP *** [5c 7c 3d]
uCqEjnxh2/vFBjKYkfTOkw: checks
iHo1oDbrEVJ8nEGdaPrICw: bets $8
KpnW5CcJ4Mg6MeclfKmLrw: folds
uCqEjnxh2/vFBjKYkfTOkw: folds
iHo1oDbrEVJ8nEGdaPrICw collected $9.05 from pot
iHo1oDbrEVJ8nEGdaPrICw: doesn't show hand
*** SUMMARY ***
Total pot $9.50 | Rake $0.45
Board [5c 7c 3d]
Seat 1: iHo1oDbrEVJ8nEGdaPrICw collected ($9.05)
Seat 2: KpnW5CcJ4Mg6MeclfKmLrw (button) folded on the Flop
Seat 3: PXT6kJgVX67c3EgncNqRoA (small blind) folded before Flop
Seat 4: uCqEjnxh2/vFBjKYkfTOkw (big blind) folded on the Flop
Seat 5: rHlMOfR7kpQQxe+PFQz0xQ folded before Flop (didn't bet)



PokerStars Game #59938706226:  Hold'em No Limit ($0.50/$1.00) - 2009/07/01 0:21:28 ET
Table 'blHlQApStil0OPeQxQxPcwFKpXUINE6M3UxHG4zaMhHAx Seat #5 is the button
Seat 1: x80+i7DJL+81v3quj7KbNg ($24.15 in chips)
Seat 2: wIZ377kjl2fHFGnS93o6bw ($35.50 in chips)
Seat 3: o1axyw4AjQ8n4ubTwlirQQ ($26.20 in chips)
Seat 4: zanka7aAZkigmZpfopXxxA ($35.30 in chips)
Seat 5: uXrDE6JrIi8BZK1L8oQ9bQ ($18.50 in chips)
Seat 6: JPQzLacMGzeh42mPgyrvVQ ($72.60 in chips)
Seat 7: vR4IO10geOgvTW+LAUBv/A ($111 in chips)
Seat 8: VtjmCz/ASIcETatNJ8YcCA ($68.65 in chips)
JPQzLacMGzeh42mPgyrvVQ: posts small blind $0.50
vR4IO10geOgvTW+LAUBv/A: posts big blind $1
*** HOLE CARDS ***
VtjmCz/ASIcETatNJ8YcCA: raises $1 to $2
x80+i7DJL+81v3quj7KbNg: folds
wIZ377kjl2fHFGnS93o6bw: folds
o1axyw4AjQ8n4ubTwlirQQ: folds
zanka7aAZkigmZpfopXxxA: folds
uXrDE6JrIi8BZK1L8oQ9bQ: folds
JPQzLacMGzeh42mPgyrvVQ: raises $2 to $4
vR4IO10geOgvTW+LAUBv/A: folds
VtjmCz/ASIcETatNJ8YcCA: calls $2
*** FLOP *** [Kh 3d 8c]
JPQzLacMGzeh42mPgyrvVQ: checks
VtjmCz/ASIcETatNJ8YcCA: bets $5
JPQzLacMGzeh42mPgyrvVQ: raises $10 to $15
VtjmCz/ASIcETatNJ8YcCA: folds
JPQzLacMGzeh42mPgyrvVQ collected $18.10 from pot
*** SUMMARY ***
Total pot $19 | Rake $0.90
Board [Kh 3d 8c]
Seat 1: x80+i7DJL+81v3quj7KbNg folded before Flop (didn't bet)
Seat 2: wIZ377kjl2fHFGnS93o6bw folded before Flop (didn't bet)
Seat 3: o1axyw4AjQ8n4ubTwlirQQ folded before Flop (didn't bet)
Seat 4: zanka7aAZkigmZpfopXxxA folded before Flop (didn't bet)
Seat 5: uXrDE6JrIi8BZK1L8oQ9bQ (button) folded before Flop (didn't bet)
Seat 6: JPQzLacMGzeh42mPgyrvVQ (small blind) collected ($18.10)
Seat 7: vR4IO10geOgvTW+LAUBv/A (big blind) folded before Flop
Seat 8: VtjmCz/ASIcETatNJ8YcCA folded on the Flop



PokerStars Game #59938707008:  Hold'em No Limit ($0.50/$1.00) - 2009/07/01 0:21:29 ET
Table 'aWHveb63HkbTmOGHOxjBkQ' 2-max Seat #1 is the button
Seat 1: xy2MQKoHoCZZIudmw8Xbow ($230.80 in chips)
Seat 2: xstEKavv3YDxpUnU4e9qAQ ($143.10 in chips)
xy2MQKoHoCZZIudmw8Xbow: posts small blind $0.50
xstEKavv3YDxpUnU4e9qAQ: posts big blind $1
*** HOLE CARDS ***
xy2MQKoHoCZZIudmw8Xbow: raises $3 to $4
xstEKavv3YDxpUnU4e9qAQ: folds
xy2MQKoHoCZZIudmw8Xbow collected $2 from pot
xy2MQKoHoCZZIudmw8Xbow: doesn't show hand
*** SUMMARY ***
Total pot $2 | Rake $0
Seat 1: xy2MQKoHoCZZIudmw8Xbow (button) (small blind) collected ($2)
Seat 2: xstEKavv3YDxpUnU4e9qAQ (big blind) folded before Flop



PokerStars Game #59938707176:  Hold'em No Limit ($0.50/$1.00) - 2009/07/01 0:21:29 ET
Table 'tLrtq7gDzxEvckNAI1OS5Q' 6-max Seat #3 is the button
Seat 1: GisIe1kcC9q/xV6ifsTjgA ($155.85 in chips)
Seat 2: qsObMEIlRO22OlS867m/lw ($27.35 in chips)
Seat 3: TPZ+m9x+lwoKpv7TMfAUWA ($324.25 in chips)
Seat 4: KOG8rG51mOvIoY96zF3kvw ($157.80 in chips)
Seat 5: OGMLOcTNYZXZU81au7ztUw ($178.35 in chips)
Seat 6: XUk5GQsfNFpHvaToDZ0rZA ($22.65 in chips)
KOG8rG51mOvIoY96zF3kvw: posts small blind $0.50
OGMLOcTNYZXZU81au7ztUw: posts big blind $1
*** HOLE CARDS ***
XUk5GQsfNFpHvaToDZ0rZA: folds
GisIe1kcC9q/xV6ifsTjgA: folds
qsObMEIlRO22OlS867m/lw: folds
TPZ+m9x+lwoKpv7TMfAUWA: raises $2 to $3
KOG8rG51mOvIoY96zF3kvw: folds
OGMLOcTNYZXZU81au7ztUw: folds
TPZ+m9x+lwoKpv7TMfAUWA collected $2.50 from pot
*** SUMMARY ***
Total pot $2.50 | Rake $0
Seat 1: GisIe1kcC9q/xV6ifsTjgA folded before Flop (didn't bet)
Seat 2: qsObMEIlRO22OlS867m/lw folded before Flop (didn't bet)
Seat 3: TPZ+m9x+lwoKpv7TMfAUWA (button) collected ($2.50)
Seat 4: KOG8rG51mOvIoY96zF3kvw (small blind) folded before Flop
Seat 5: OGMLOcTNYZXZU81au7ztUw (big blind) folded before Flop
Seat 6: XUk5GQsfNFpHvaToDZ0rZA folded before Flop (didn't bet)



PokerStars Game #59938707282:  Hold'em No Limit ($0.50/$1.00) - 2009/07/01 0:21:30 ET
Table '+cA8mcmhaedZ7YcrDdhmeQ' 6-max Seat #3 is the button
Seat 1: lsLuWlcPA3Rh7kJVLzMh0Q ($233 in chips)
Seat 2: trnpu4tPju3BU8W0wQQaiQ ($92.10 in chips)
Seat 3: 0WjiuIT7/EolY1oOx1ngeA ($137.80 in chips)
Seat 4: j0aDOn9Nft1HLTQvGu1UwA ($17.10 in chips)
Seat 5: 6WyjEXOToimYmtLdqIgHYQ ($62 in chips)
Seat 6: YfsTQsY/fxb+YqbdclTHuw ($99.70 in chips)
j0aDOn9Nft1HLTQvGu1UwA: posts small blind $0.50
6WyjEXOToimYmtLdqIgHYQ: posts big blind $1
*** HOLE CARDS ***
YfsTQsY/fxb+YqbdclTHuw: calls $1
lsLuWlcPA3Rh7kJVLzMh0Q: folds
trnpu4tPju3BU8W0wQQaiQ: folds
0WjiuIT7/EolY1oOx1ngeA: folds
j0aDOn9Nft1HLTQvGu1UwA: raises $2 to $3
6WyjEXOToimYmtLdqIgHYQ: folds
YfsTQsY/fxb+YqbdclTHuw: calls $2
*** FLOP *** [5s 7s 3h]
j0aDOn9Nft1HLTQvGu1UwA: bets $14.10 and is all-in
YfsTQsY/fxb+YqbdclTHuw: folds
j0aDOn9Nft1HLTQvGu1UwA collected $6.65 from pot
*** SUMMARY ***
Total pot $7 | Rake $0.35
Board [5s 7s 3h]
Seat 1: lsLuWlcPA3Rh7kJVLzMh0Q folded before Flop (didn't bet)
Seat 2: trnpu4tPju3BU8W0wQQaiQ folded before Flop (didn't bet)
Seat 3: 0WjiuIT7/EolY1oOx1ngeA (button) folded before Flop (didn't bet)
Seat 4: j0aDOn9Nft1HLTQvGu1UwA (small blind) collected ($6.65)
Seat 5: 6WyjEXOToimYmtLdqIgHYQ (big blind) folded before Flop
Seat 6: YfsTQsY/fxb+YqbdclTHuw folded on the Flop



PokerStars Game #59938708904:  Hold'em No Limit ($0.50/$1.00) - 2009/07/01 0:21:32 ET
Table 'rmZfTK+oSebeUPJNbWhdAA' 6-max Seat #2 is the button
Seat 1: u4vYQZNWtIzOJre8fvCmvQ ($32.85 in chips)
Seat 2: OigyyiK+tTj1APPIAUmXDA ($78.20 in chips)
Seat 3: 9yjOzGERLaEZS8CZ6YNHFg ($61.80 in chips)
Seat 4: OGMLOcTNYZXZU81au7ztUw ($105.05 in chips)
Seat 5: VuZb/hkEc4X7s93w2ZZTpA ($112.75 in chips)
Seat 6: j7NIOHLZk7V2o9fOioO5ug ($104.80 in chips)
9yjOzGERLaEZS8CZ6YNHFg: posts small blind $0.50
OGMLOcTNYZXZU81au7ztUw: posts big blind $1
*** HOLE CARDS ***
VuZb/hkEc4X7s93w2ZZTpA: folds
j7NIOHLZk7V2o9fOioO5ug: raises $2 to $3
u4vYQZNWtIzOJre8fvCmvQ: folds
OigyyiK+tTj1APPIAUmXDA: folds
9yjOzGERLaEZS8CZ6YNHFg: folds
OGMLOcTNYZXZU81au7ztUw: folds
j7NIOHLZk7V2o9fOioO5ug collected $2.50 from pot
j7NIOHLZk7V2o9fOioO5ug: doesn't show hand
*** SUMMARY ***
Total pot $2.50 | Rake $0
Seat 1: u4vYQZNWtIzOJre8fvCmvQ folded before Flop (didn't bet)
Seat 2: OigyyiK+tTj1APPIAUmXDA (button) folded before Flop (didn't bet)
Seat 3: 9yjOzGERLaEZS8CZ6YNHFg (small blind) folded before Flop
Seat 4: OGMLOcTNYZXZU81au7ztUw (big blind) folded before Flop
Seat 5: VuZb/hkEc4X7s93w2ZZTpA folded before Flop (didn't bet)
Seat 6: j7NIOHLZk7V2o9fOioO5ug collected ($2.50)



PokerStars Game #59938708696:  Hold'em No Limit ($0.50/$1.00) - 2009/07/01 0:21:32 ET
Table 'QSIig7BLMc9wY/rgBechzw' 6-max Seat #6 is the button
Seat 1: uuA9hpFU17U5/t4cvpbpBg ($39.75 in chips)
Seat 2: 0WjiuIT7/EolY1oOx1ngeA ($122.40 in chips)
Seat 3: +W6OnF033KNM2xH0fGj98Q ($111.70 in chips)
Seat 4: +uSzP8Jwnw7sKfQ4s66b7w ($48.50 in chips)
Seat 6: KpnW5CcJ4Mg6MeclfKmLrw ($144.25 in chips)
uuA9hpFU17U5/t4cvpbpBg: posts small blind $0.50
0WjiuIT7/EolY1oOx1ngeA: posts big blind $1
*** HOLE CARDS ***
+W6OnF033KNM2xH0fGj98Q: folds
+uSzP8Jwnw7sKfQ4s66b7w: folds
KpnW5CcJ4Mg6MeclfKmLrw: folds
uuA9hpFU17U5/t4cvpbpBg: calls $0.50
0WjiuIT7/EolY1oOx1ngeA: checks
*** FLOP *** [Jd 3h Js]
uuA9hpFU17U5/t4cvpbpBg: checks
0WjiuIT7/EolY1oOx1ngeA: checks
*** TURN *** [Jd 3h Js] [7h]
uuA9hpFU17U5/t4cvpbpBg: bets $1
bvU2ZjpVnszLCFVeWbxePg joins the table at seat #5
0WjiuIT7/EolY1oOx1ngeA: calls $1
*** RIVER *** [Jd 3h Js 7h] [5d]
uuA9hpFU17U5/t4cvpbpBg: bets $2
0WjiuIT7/EolY1oOx1ngeA: calls $2
*** SHOW DOWN ***
uuA9hpFU17U5/t4cvpbpBg: shows [7d Qh] (two pair, Jacks and Sevens)
0WjiuIT7/EolY1oOx1ngeA: mucks hand
uuA9hpFU17U5/t4cvpbpBg collected $7.65 from pot
*** SUMMARY ***
Total pot $8 | Rake $0.35
Board [Jd 3h Js 7h 5d]
Seat 1: uuA9hpFU17U5/t4cvpbpBg (small blind) showed [7d Qh] and won ($7.65) with two pair, Jacks and Sevens
Seat 2: 0WjiuIT7/EolY1oOx1ngeA (big blind) mucked
Seat 3: +W6OnF033KNM2xH0fGj98Q folded before Flop (didn't bet)
Seat 4: +uSzP8Jwnw7sKfQ4s66b7w folded before Flop (didn't bet)
Seat 6: KpnW5CcJ4Mg6MeclfKmLrw (button) folded before Flop (didn't bet)



PokerStars Game #59938709676:  Hold'em No Limit ($0.50/$1.00) - 2009/07/01 0:21:33 ET
Table 'U9zqzC8f3oTJ2ShXFgSSOA' 6-max Seat #4 is the button
Seat 1: tS9JHB1h+FQ++qu8RwRNgg ($17.95 in chips)
Seat 2: U2CWBTv29qdCbj8RNF2sIw ($110.30 in chips)
Seat 3: yfXek8iJ7O4CFyqXrtGcfg ($57.50 in chips)
Seat 4: 33q95we0Etwgrm6guQGncw ($73.90 in chips)
Seat 5: KfwW5us6tydK81NYTtK1gw ($193.75 in chips)
Seat 6: aIxzFKdtpDSkUePKZy/niQ ($45 in chips)
KfwW5us6tydK81NYTtK1gw: posts small blind $0.50
aIxzFKdtpDSkUePKZy/niQ: posts big blind $1
*** HOLE CARDS ***
tS9JHB1h+FQ++qu8RwRNgg: folds
U2CWBTv29qdCbj8RNF2sIw: folds
yfXek8iJ7O4CFyqXrtGcfg: raises $2 to $3
33q95we0Etwgrm6guQGncw: folds
KfwW5us6tydK81NYTtK1gw: folds
aIxzFKdtpDSkUePKZy/niQ: folds
yfXek8iJ7O4CFyqXrtGcfg collected $2.50 from pot
*** SUMMARY ***
Total pot $2.50 | Rake $0
Seat 1: tS9JHB1h+FQ++qu8RwRNgg folded before Flop (didn't bet)
Seat 2: U2CWBTv29qdCbj8RNF2sIw folded before Flop (didn't bet)
Seat 3: yfXek8iJ7O4CFyqXrtGcfg collected ($2.50)
Seat 4: 33q95we0Etwgrm6guQGncw (button) folded before Flop (didn't bet)
Seat 5: KfwW5us6tydK81NYTtK1gw (small blind) folded before Flop
Seat 6: aIxzFKdtpDSkUePKZy/niQ (big blind) folded before Flop



PokerStars Game #59938711136:  Hold'em No Limit ($0.50/$1.00) - 2009/07/01 0:21:35 ET
Table '7Nl0ffnjeK44/vmeexh3MQ' 9-max Seat #4 is the button
Seat 1: s7D3Y+k4Cj4D1cXHv7oj+Q ($102.30 in chips)
Seat 3: 200876 ($44.90 in chips)
Seat 4: NfbTuCZ2txeWuV3hP7t0TA ($100 in chips)
Seat 5: bL+QVeDcuEdzMGAGg2XJHg ($107.60 in chips)
Seat 6: FVs16t7GgfWgQWt4JxsObQ ($12.05 in chips)
Seat 7: knewtTmBc4Tc0z/5tAABYQ ($108 in chips)
Seat 8: zanka7aAZkigmZpfopXxxA ($222 in chips)
bL+QVeDcuEdzMGAGg2XJHg: posts small blind $0.50
FVs16t7GgfWgQWt4JxsObQ: posts big blind $1
*** HOLE CARDS ***
knewtTmBc4Tc0z/5tAABYQ: folds
200876 said, "wow, that was sick"
Ei6tUEmph+Q+DkB6JH3thw leaves the table
zanka7aAZkigmZpfopXxxA has timed out
zanka7aAZkigmZpfopXxxA: folds
zanka7aAZkigmZpfopXxxA is sitting out
zanka7aAZkigmZpfopXxxA has returned
s7D3Y+k4Cj4D1cXHv7oj+Q: folds
200876: raises $1 to $2
NfbTuCZ2txeWuV3hP7t0TA: folds
bL+QVeDcuEdzMGAGg2XJHg: folds
FVs16t7GgfWgQWt4JxsObQ: calls $1
*** FLOP *** [Ah 8c Js]
FVs16t7GgfWgQWt4JxsObQ: checks
200876: bets $3
FVs16t7GgfWgQWt4JxsObQ: calls $3
*** TURN *** [Ah 8c Js] [9s]
FVs16t7GgfWgQWt4JxsObQ: checks
200876: checks
*** RIVER *** [Ah 8c Js 9s] [Qd]
FVs16t7GgfWgQWt4JxsObQ: bets $7.05 and is all-in
200876: folds
FVs16t7GgfWgQWt4JxsObQ collected $10 from pot
*** SUMMARY ***
Total pot $10.50 | Rake $0.50
Board [Ah 8c Js 9s Qd]
Seat 1: s7D3Y+k4Cj4D1cXHv7oj+Q folded before Flop (didn't bet)
Seat 3: 200876 folded on the River
Seat 4: NfbTuCZ2txeWuV3hP7t0TA (button) folded before Flop (didn't bet)
Seat 5: bL+QVeDcuEdzMGAGg2XJHg (small blind) folded before Flop
Seat 6: FVs16t7GgfWgQWt4JxsObQ (big blind) collected ($10)
Seat 7: knewtTmBc4Tc0z/5tAABYQ folded before Flop (didn't bet)
Seat 8: zanka7aAZkigmZpfopXxxA folded before Flop (didn't bet)



PokerStars Game #59938711422:  Hold'em No Limit ($0.50/$1.00) - 2009/07/01 0:21:36 ET
Table 'aWHveb63HkbTmOGHOxjBkQ' 2-max Seat #2 is the button
Seat 1: xy2MQKoHoCZZIudmw8Xbow ($231.80 in chips)
Seat 2: xstEKavv3YDxpUnU4e9qAQ ($142.10 in chips)
xstEKavv3YDxpUnU4e9qAQ: posts small blind $0.50
xy2MQKoHoCZZIudmw8Xbow: posts big blind $1
*** HOLE CARDS ***
xstEKavv3YDxpUnU4e9qAQ: folds
xy2MQKoHoCZZIudmw8Xbow collected $1 from pot
xy2MQKoHoCZZIudmw8Xbow: doesn't show hand
*** SUMMARY ***
Total pot $1 | Rake $0
Seat 1: xy2MQKoHoCZZIudmw8Xbow (big blind) collected ($1)
Seat 2: xstEKavv3YDxpUnU4e9qAQ (button) (small blind) folded before Flop



PokerStars Game #59938714008:  Hold'em No Limit ($0.50/$1.00) - 2009/07/01 0:21:39 ET
Table 'vs/5jr6ciwjVQ5+Soc+u2A' 6-max Seat #2 is the button
Seat 2: XOIf9W+VAxhZqN+SYoyMKA ($114.30 in chips)
Seat 3: G5ZSSN6RSON3gkNvk/SmYg ($102.70 in chips)
Seat 4: KpnW5CcJ4Mg6MeclfKmLrw ($106.15 in chips)
Seat 5: 7Vc9JmGFQwMRh5Tj9ui5Lw ($98.65 in chips)
Seat 6: QHvTZcrKe6+maWUfVjP29Q ($100 in chips)
G5ZSSN6RSON3gkNvk/SmYg: posts small blind $0.50
KpnW5CcJ4Mg6MeclfKmLrw: posts big blind $1
*** HOLE CARDS ***
7Vc9JmGFQwMRh5Tj9ui5Lw: folds
QHvTZcrKe6+maWUfVjP29Q: folds
XOIf9W+VAxhZqN+SYoyMKA: raises $2 to $3
G5ZSSN6RSON3gkNvk/SmYg: folds
KpnW5CcJ4Mg6MeclfKmLrw: folds
XOIf9W+VAxhZqN+SYoyMKA collected $2.50 from pot
XOIf9W+VAxhZqN+SYoyMKA: doesn't show hand
*** SUMMARY ***
Total pot $2.50 | Rake $0
Seat 2: XOIf9W+VAxhZqN+SYoyMKA (button) collected ($2.50)
Seat 3: G5ZSSN6RSON3gkNvk/SmYg (small blind) folded before Flop
Seat 4: KpnW5CcJ4Mg6MeclfKmLrw (big blind) folded before Flop
Seat 5: 7Vc9JmGFQwMRh5Tj9ui5Lw folded before Flop (didn't bet)
Seat 6: QHvTZcrKe6+maWUfVjP29Q folded before Flop (didn't bet)



PokerStars Game #59938713872:  Hold'em No Limit ($0.50/$1.00) - 2009/07/01 0:21:39 ET
Table '/FUb199IViHMJHi5YWmeuQ' 9-max Seat #1 is the button
Seat 1: TZcz9MEWDA+WydgGruqqbw ($100 in chips)
Seat 2: FL3MrLspcF23LYvC4ipBOA ($132.75 in chips)
Seat 3: qN483QJ1NvHbdIZB7J4ARw ($75.25 in chips)
Seat 4: qheQay5YvP2DMAb3OUSxtw ($107.30 in chips)
Seat 5: +za1iHiRgVo4OcAz0SOZqw ($16.95 in chips)
Seat 6: x80+i7DJL+81v3quj7KbNg ($26 in chips)
Seat 7: atVaKXE/AQGa798rpMF/Bg ($17 in chips)
Seat 9: knewtTmBc4Tc0z/5tAABYQ ($113.15 in chips)
FL3MrLspcF23LYvC4ipBOA: posts small blind $0.50
qN483QJ1NvHbdIZB7J4ARw: posts big blind $1
*** HOLE CARDS ***
qheQay5YvP2DMAb3OUSxtw: folds
QIWvt0R766g8KfH0vl1s0A has returned
+za1iHiRgVo4OcAz0SOZqw has timed out
+za1iHiRgVo4OcAz0SOZqw: folds
+za1iHiRgVo4OcAz0SOZqw is sitting out
x80+i7DJL+81v3quj7KbNg: folds
+za1iHiRgVo4OcAz0SOZqw has returned
x80+i7DJL+81v3quj7KbNg leaves the table
atVaKXE/AQGa798rpMF/Bg: folds
knewtTmBc4Tc0z/5tAABYQ: raises $2 to $3
TZcz9MEWDA+WydgGruqqbw: folds
FL3MrLspcF23LYvC4ipBOA: folds
qN483QJ1NvHbdIZB7J4ARw: folds
knewtTmBc4Tc0z/5tAABYQ collected $2.50 from pot
knewtTmBc4Tc0z/5tAABYQ: doesn't show hand
*** SUMMARY ***
Total pot $2.50 | Rake $0
Seat 1: TZcz9MEWDA+WydgGruqqbw (button) folded before Flop (didn't bet)
Seat 2: FL3MrLspcF23LYvC4ipBOA (small blind) folded before Flop
Seat 3: qN483QJ1NvHbdIZB7J4ARw (big blind) folded before Flop
Seat 4: qheQay5YvP2DMAb3OUSxtw folded before Flop (didn't bet)
Seat 5: +za1iHiRgVo4OcAz0SOZqw folded before Flop (didn't bet)
Seat 6: x80+i7DJL+81v3quj7KbNg folded before Flop (didn't bet)
Seat 7: atVaKXE/AQGa798rpMF/Bg folded before Flop (didn't bet)
Seat 9: knewtTmBc4Tc0z/5tAABYQ collected ($2.50)



PokerStars Game #59938715112:  Hold'em No Limit ($0.50/$1.00) - 2009/07/01 0:21:41 ET
Table 'aWHveb63HkbTmOGHOxjBkQ' 2-max Seat #1 is the button
Seat 1: xy2MQKoHoCZZIudmw8Xbow ($232.30 in chips)
Seat 2: xstEKavv3YDxpUnU4e9qAQ ($141.60 in chips)
xy2MQKoHoCZZIudmw8Xbow: posts small blind $0.50
xstEKavv3YDxpUnU4e9qAQ: posts big blind $1
*** HOLE CARDS ***
xy2MQKoHoCZZIudmw8Xbow: raises $2 to $3
xstEKavv3YDxpUnU4e9qAQ: folds
xy2MQKoHoCZZIudmw8Xbow collected $2 from pot
xy2MQKoHoCZZIudmw8Xbow: doesn't show hand
*** SUMMARY ***
Total pot $2 | Rake $0
Seat 1: xy2MQKoHoCZZIudmw8Xbow (button) (small blind) collected ($2)
Seat 2: xstEKavv3YDxpUnU4e9qAQ (big blind) folded before Flop



PokerStars Game #59938718612:  Hold'em No Limit ($0.50/$1.00) - 2009/07/01 0:21:46 ET
Table 'Zka9tv1yilg0MvXWPQrShg' 9-max Seat #5 is the button
Seat 1: TZcz9MEWDA+WydgGruqqbw ($100 in chips)
Seat 2: zBHLwg+HmbHmRtVQMhavjA ($105.55 in chips)
Seat 3: gUUvmqdVlmvpal6B8nYrmg ($100 in chips)
Seat 4: CTOae+JLIGfwfXvhqHkP2w ($187.15 in chips)
Seat 5: /zy+DB4S5fUQUSfZWFzYGw ($141.45 in chips)
Seat 6: rY8wPoax1lS+HUY+I0FZDw ($128.90 in chips)
Seat 7: p1SafS90nb3Uft5LB0NkHw ($20 in chips)
Seat 8: bL+QVeDcuEdzMGAGg2XJHg ($126.10 in chips)
Seat 9: SlhHwZrXCVifyCHK+qz1Kw ($100.45 in chips)
rY8wPoax1lS+HUY+I0FZDw: posts small blind $0.50
p1SafS90nb3Uft5LB0NkHw: posts big blind $1
*** HOLE CARDS ***
bL+QVeDcuEdzMGAGg2XJHg: folds
SlhHwZrXCVifyCHK+qz1Kw: folds
TZcz9MEWDA+WydgGruqqbw: folds
zBHLwg+HmbHmRtVQMhavjA: folds
gUUvmqdVlmvpal6B8nYrmg: folds
CTOae+JLIGfwfXvhqHkP2w: folds
/zy+DB4S5fUQUSfZWFzYGw: folds
rY8wPoax1lS+HUY+I0FZDw: folds
p1SafS90nb3Uft5LB0NkHw collected $1 from pot
*** SUMMARY ***
Total pot $1 | Rake $0
Seat 1: TZcz9MEWDA+WydgGruqqbw folded before Flop (didn't bet)
Seat 2: zBHLwg+HmbHmRtVQMhavjA folded before Flop (didn't bet)
Seat 3: gUUvmqdVlmvpal6B8nYrmg folded before Flop (didn't bet)
Seat 4: CTOae+JLIGfwfXvhqHkP2w folded before Flop (didn't bet)
Seat 5: /zy+DB4S5fUQUSfZWFzYGw (button) folded before Flop (didn't bet)
Seat 6: rY8wPoax1lS+HUY+I0FZDw (small blind) folded before Flop
Seat 7: p1SafS90nb3Uft5LB0NkHw (big blind) collected ($1)
Seat 8: bL+QVeDcuEdzMGAGg2XJHg folded before Flop (didn't bet)
Seat 9: SlhHwZrXCVifyCHK+qz1Kw folded before Flop (didn't bet)



PokerStars Game #59938719484:  Hold'em No Limit ($0.50/$1.00) - 2009/07/01 0:21:47 ET
Table 'W/wyObTiXZm+Ckkl3YxcSw' 6-max Seat #4 is the button
Seat 1: ssLJburtEIqnVkx6X8R1uw ($118.75 in chips)
Seat 3: b2a+5TkFf4xJN/Ihhma58Q ($38.20 in chips)
Seat 4: BdbmJTZZ47quA9vUWwXtlw ($50.10 in chips)
Seat 5: Wko+clJG9HZPPQ7Yn0Y5Zg ($25.75 in chips)
Wko+clJG9HZPPQ7Yn0Y5Zg: posts small blind $0.50
ssLJburtEIqnVkx6X8R1uw: posts big blind $1
oDiBRCaF0QVtd3kO6xZIXw: sits out
*** HOLE CARDS ***
b2a+5TkFf4xJN/Ihhma58Q: folds
BdbmJTZZ47quA9vUWwXtlw: folds
Wko+clJG9HZPPQ7Yn0Y5Zg: raises $2 to $3
ssLJburtEIqnVkx6X8R1uw: folds
Wko+clJG9HZPPQ7Yn0Y5Zg collected $2 from pot
Wko+clJG9HZPPQ7Yn0Y5Zg: doesn't show hand
*** SUMMARY ***
Total pot $2 | Rake $0
Seat 1: ssLJburtEIqnVkx6X8R1uw (big blind) folded before Flop
Seat 3: b2a+5TkFf4xJN/Ihhma58Q folded before Flop (didn't bet)
Seat 4: BdbmJTZZ47quA9vUWwXtlw (button) folded before Flop (didn't bet)
Seat 5: Wko+clJG9HZPPQ7Yn0Y5Zg (small blind) collected ($2)



PokerStars Game #59938720362:  Hold'em No Limit ($0.50/$1.00) - 2009/07/01 0:21:49 ET
Table 'aWHveb63HkbTmOGHOxjBkQ' 2-max Seat #2 is the button
Seat 1: xy2MQKoHoCZZIudmw8Xbow ($233.30 in chips)
Seat 2: xstEKavv3YDxpUnU4e9qAQ ($140.60 in chips)
xstEKavv3YDxpUnU4e9qAQ: posts small blind $0.50
xy2MQKoHoCZZIudmw8Xbow: posts big blind $1
*** HOLE CARDS ***
xstEKavv3YDxpUnU4e9qAQ: folds
xy2MQKoHoCZZIudmw8Xbow collected $1 from pot
xy2MQKoHoCZZIudmw8Xbow: doesn't show hand
*** SUMMARY ***
Total pot $1 | Rake $0
Seat 1: xy2MQKoHoCZZIudmw8Xbow (big blind) collected ($1)
Seat 2: xstEKavv3YDxpUnU4e9qAQ (button) (small blind) folded before Flop



PokerStars Game #59938721770:  Hold'em No Limit ($0.50/$1.00) - 2009/07/01 0:21:51 ET
Table 'pHrhryH8jPNdQfY62f8v+g' 6-max Seat #2 is the button
Seat 1: BdbmJTZZ47quA9vUWwXtlw ($69.75 in chips)
Seat 2: RqgF7gRoKgRNW8Zoi1ty4A ($115.60 in chips)
Seat 4: wenbG7TaM3H7h5kn78OFNw ($55.55 in chips)
Seat 5: Gp2euK/nqF6qXKe7U+jOfw ($120.15 in chips)
Seat 6: xNKcQzD9+/iHmtJn4vYq9w ($220.50 in chips)
wenbG7TaM3H7h5kn78OFNw: posts small blind $0.50
Gp2euK/nqF6qXKe7U+jOfw: posts big blind $1
*** HOLE CARDS ***
rw4J9hTeo4c+qBV5IU/aQQ leaves the table
xNKcQzD9+/iHmtJn4vYq9w: folds
BdbmJTZZ47quA9vUWwXtlw: folds
0WjiuIT7/EolY1oOx1ngeA joins the table at seat #3
RqgF7gRoKgRNW8Zoi1ty4A: raises $2 to $3
wenbG7TaM3H7h5kn78OFNw: folds
Gp2euK/nqF6qXKe7U+jOfw: folds
RqgF7gRoKgRNW8Zoi1ty4A collected $2.50 from pot
*** SUMMARY ***
Total pot $2.50 | Rake $0
Seat 1: BdbmJTZZ47quA9vUWwXtlw folded before Flop (didn't bet)
Seat 2: RqgF7gRoKgRNW8Zoi1ty4A (button) collected ($2.50)
Seat 4: wenbG7TaM3H7h5kn78OFNw (small blind) folded before Flop
Seat 5: Gp2euK/nqF6qXKe7U+jOfw (big blind) folded before Flop
Seat 6: xNKcQzD9+/iHmtJn4vYq9w folded before Flop (didn't bet)



PokerStars Game #59938721698:  Hold'em No Limit ($0.50/$1.00) - 2009/07/01 0:21:51 ET
Table 'tyUh+jyNvrceIQdKMJjQ2wZFWj23PMihdwrNWv41OG/Qeat #5 is the button
Seat 1: o8A5MUdudVKu+pAwgZOX2w ($196.25 in chips)
Seat 2: 6iVcnPw9a2oNG6sPQo3G6g ($99.15 in chips)
Seat 3: L9qfLYXrczhAPd/VckgsWw ($38.60 in chips)
Seat 5: j7NIOHLZk7V2o9fOioO5ug ($103.95 in chips)
Seat 6: YsLQ3BAvgQHWXMAv3Wv6Hg ($105.75 in chips)
YsLQ3BAvgQHWXMAv3Wv6Hg: posts small blind $0.50
o8A5MUdudVKu+pAwgZOX2w: posts big blind $1
*** HOLE CARDS ***
6iVcnPw9a2oNG6sPQo3G6g: folds
L9qfLYXrczhAPd/VckgsWw: folds
j7NIOHLZk7V2o9fOioO5ug: folds
YsLQ3BAvgQHWXMAv3Wv6Hg: raises $3 to $4
o8A5MUdudVKu+pAwgZOX2w: folds
YsLQ3BAvgQHWXMAv3Wv6Hg collected $2 from pot
YsLQ3BAvgQHWXMAv3Wv6Hg: doesn't show hand
*** SUMMARY ***
Total pot $2 | Rake $0
Seat 1: o8A5MUdudVKu+pAwgZOX2w (big blind) folded before Flop
Seat 2: 6iVcnPw9a2oNG6sPQo3G6g folded before Flop (didn't bet)
Seat 3: L9qfLYXrczhAPd/VckgsWw folded before Flop (didn't bet)
Seat 5: j7NIOHLZk7V2o9fOioO5ug (button) folded before Flop (didn't bet)
Seat 6: YsLQ3BAvgQHWXMAv3Wv6Hg (small blind) collected ($2)



PokerStars Game #59938723232:  Hold'em No Limit ($0.50/$1.00) - 2009/07/01 0:21:53 ET
Table 'tLrtq7gDzxEvckNAI1OS5Q' 6-max Seat #4 is the button
Seat 1: GisIe1kcC9q/xV6ifsTjgA ($155.85 in chips)
Seat 2: qsObMEIlRO22OlS867m/lw ($27.35 in chips)
Seat 3: TPZ+m9x+lwoKpv7TMfAUWA ($325.75 in chips)
Seat 4: KOG8rG51mOvIoY96zF3kvw ($157.30 in chips)
Seat 5: OGMLOcTNYZXZU81au7ztUw ($177.35 in chips)
Seat 6: XUk5GQsfNFpHvaToDZ0rZA ($22.65 in chips)
OGMLOcTNYZXZU81au7ztUw: posts small blind $0.50
XUk5GQsfNFpHvaToDZ0rZA: posts big blind $1
*** HOLE CARDS ***
GisIe1kcC9q/xV6ifsTjgA: calls $1
qsObMEIlRO22OlS867m/lw: calls $1
TPZ+m9x+lwoKpv7TMfAUWA: calls $1
KOG8rG51mOvIoY96zF3kvw: folds
OGMLOcTNYZXZU81au7ztUw: folds
XUk5GQsfNFpHvaToDZ0rZA: checks
*** FLOP *** [5d Ac Td]
XUk5GQsfNFpHvaToDZ0rZA: checks
GisIe1kcC9q/xV6ifsTjgA: checks
qsObMEIlRO22OlS867m/lw: bets $4
TPZ+m9x+lwoKpv7TMfAUWA: folds
XUk5GQsfNFpHvaToDZ0rZA: calls $4
GisIe1kcC9q/xV6ifsTjgA: folds
*** TURN *** [5d Ac Td] [4c]
XUk5GQsfNFpHvaToDZ0rZA: checks
qsObMEIlRO22OlS867m/lw: bets $10
XUk5GQsfNFpHvaToDZ0rZA: raises $7.65 to $17.65 and is all-in
qsObMEIlRO22OlS867m/lw: calls $7.65
*** RIVER *** [5d Ac Td 4c] [4s]
*** SHOW DOWN ***
XUk5GQsfNFpHvaToDZ0rZA: shows [8d Ah] (two pair, Aces and Fours)
qsObMEIlRO22OlS867m/lw: mucks hand
XUk5GQsfNFpHvaToDZ0rZA collected $45.45 from pot
*** SUMMARY ***
Total pot $47.80 | Rake $2.35
Board [5d Ac Td 4c 4s]
Seat 1: GisIe1kcC9q/xV6ifsTjgA folded on the Flop
Seat 2: qsObMEIlRO22OlS867m/lw mucked
Seat 3: TPZ+m9x+lwoKpv7TMfAUWA folded on the Flop
Seat 4: KOG8rG51mOvIoY96zF3kvw (button) folded before Flop (didn't bet)
Seat 5: OGMLOcTNYZXZU81au7ztUw (small blind) folded before Flop
Seat 6: XUk5GQsfNFpHvaToDZ0rZA (big blind) showed [8d Ah] and won ($45.45) with two pair, Aces and Fours



PokerStars Game #59938724330:  Hold'em No Limit ($0.50/$1.00) - 2009/07/01 0:21:55 ET
Table 'aWHveb63HkbTmOGHOxjBkQ' 2-max Seat #1 is the button
Seat 1: xy2MQKoHoCZZIudmw8Xbow ($233.80 in chips)
Seat 2: xstEKavv3YDxpUnU4e9qAQ ($140.10 in chips)
xy2MQKoHoCZZIudmw8Xbow: posts small blind $0.50
xstEKavv3YDxpUnU4e9qAQ: posts big blind $1
*** HOLE CARDS ***
xy2MQKoHoCZZIudmw8Xbow: raises $3 to $4
xstEKavv3YDxpUnU4e9qAQ: folds
xy2MQKoHoCZZIudmw8Xbow collected $2 from pot
xy2MQKoHoCZZIudmw8Xbow: doesn't show hand
*** SUMMARY ***
Total pot $2 | Rake $0
Seat 1: xy2MQKoHoCZZIudmw8Xbow (button) (small blind) collected ($2)
Seat 2: xstEKavv3YDxpUnU4e9qAQ (big blind) folded before Flop



PokerStars Game #59938724914:  Hold'em No Limit ($0.50/$1.00) - 2009/07/01 0:21:55 ET
Table 'VOs36P6NW+QyXeQ1B62kmA' 6-max Seat #6 is the button
Seat 1: AdLVjddOzm+sRNo1Bc3S6Q ($143.05 in chips)
Seat 2: KpnW5CcJ4Mg6MeclfKmLrw ($109.80 in chips)
Seat 4: VuZb/hkEc4X7s93w2ZZTpA ($144.70 in chips)
Seat 5: X7GlkHF+lkbarCLuZ4Uf0w ($20 in chips)
Seat 6: 6tvjsJrdmWg+g7FVrMnzXA ($49.65 in chips)
AdLVjddOzm+sRNo1Bc3S6Q: posts small blind $0.50
KpnW5CcJ4Mg6MeclfKmLrw: posts big blind $1
*** HOLE CARDS ***
VuZb/hkEc4X7s93w2ZZTpA: folds
X7GlkHF+lkbarCLuZ4Uf0w: folds
6tvjsJrdmWg+g7FVrMnzXA: folds
AdLVjddOzm+sRNo1Bc3S6Q: folds
KpnW5CcJ4Mg6MeclfKmLrw collected $1 from pot
KpnW5CcJ4Mg6MeclfKmLrw: doesn't show hand
*** SUMMARY ***
Total pot $1 | Rake $0
Seat 1: AdLVjddOzm+sRNo1Bc3S6Q (small blind) folded before Flop
Seat 2: KpnW5CcJ4Mg6MeclfKmLrw (big blind) collected ($1)
Seat 4: VuZb/hkEc4X7s93w2ZZTpA folded before Flop (didn't bet)
Seat 5: X7GlkHF+lkbarCLuZ4Uf0w folded before Flop (didn't bet)
Seat 6: 6tvjsJrdmWg+g7FVrMnzXA (button) folded before Flop (didn't bet)



PokerStars Game #59938725090:  Hold'em No Limit ($0.50/$1.00) - 2009/07/01 0:21:56 ET
Table 'fTlPiCj0utgzC/5io+I7ew' 6-max Seat #2 is the button
Seat 1: YMJG+F++3Aj6P8dAWda5fw ($100 in chips)
Seat 2: +xUCTmR3cU7G239W+vZv6g ($142.20 in chips)
Seat 3: oDiBRCaF0QVtd3kO6xZIXw ($100 in chips)
Seat 4: uJVSceLggtsrJya+WtmUEA ($103.10 in chips)
Seat 5: bFrTkDcWGTxyvNul7GVdYg ($239 in chips)
oDiBRCaF0QVtd3kO6xZIXw: posts small blind $0.50
uJVSceLggtsrJya+WtmUEA: posts big blind $1
*** HOLE CARDS ***
bFrTkDcWGTxyvNul7GVdYg: raises $2 to $3
YMJG+F++3Aj6P8dAWda5fw: folds
+xUCTmR3cU7G239W+vZv6g: folds
oDiBRCaF0QVtd3kO6xZIXw: folds
uJVSceLggtsrJya+WtmUEA: folds
bFrTkDcWGTxyvNul7GVdYg collected $2.50 from pot
*** SUMMARY ***
Total pot $2.50 | Rake $0
Seat 1: YMJG+F++3Aj6P8dAWda5fw folded before Flop (didn't bet)
Seat 2: +xUCTmR3cU7G239W+vZv6g (button) folded before Flop (didn't bet)
Seat 3: oDiBRCaF0QVtd3kO6xZIXw (small blind) folded before Flop
Seat 4: uJVSceLggtsrJya+WtmUEA (big blind) folded before Flop
Seat 5: bFrTkDcWGTxyvNul7GVdYg collected ($2.50)



PokerStars Game #59938726012:  Hold'em No Limit ($0.50/$1.00) - 2009/07/01 0:21:57 ET
Table 'U9zqzC8f3oTJ2ShXFgSSOA' 6-max Seat #5 is the button
Seat 1: tS9JHB1h+FQ++qu8RwRNgg ($17.95 in chips)
Seat 2: U2CWBTv29qdCbj8RNF2sIw ($110.30 in chips)
Seat 3: yfXek8iJ7O4CFyqXrtGcfg ($59 in chips)
Seat 4: 33q95we0Etwgrm6guQGncw ($73.90 in chips)
Seat 5: KfwW5us6tydK81NYTtK1gw ($193.25 in chips)
Seat 6: aIxzFKdtpDSkUePKZy/niQ ($44 in chips)
aIxzFKdtpDSkUePKZy/niQ: posts small blind $0.50
tS9JHB1h+FQ++qu8RwRNgg: posts big blind $1
*** HOLE CARDS ***
U2CWBTv29qdCbj8RNF2sIw: calls $1
yfXek8iJ7O4CFyqXrtGcfg: folds
33q95we0Etwgrm6guQGncw: folds
KfwW5us6tydK81NYTtK1gw: raises $1 to $2
aIxzFKdtpDSkUePKZy/niQ: folds
tS9JHB1h+FQ++qu8RwRNgg: calls $1
U2CWBTv29qdCbj8RNF2sIw: calls $1
*** FLOP *** [Js Th 5d]
tS9JHB1h+FQ++qu8RwRNgg: checks
U2CWBTv29qdCbj8RNF2sIw: bets $3
KfwW5us6tydK81NYTtK1gw: calls $3
tS9JHB1h+FQ++qu8RwRNgg: folds
*** TURN *** [Js Th 5d] [8s]
U2CWBTv29qdCbj8RNF2sIw: checks
KfwW5us6tydK81NYTtK1gw: bets $8
U2CWBTv29qdCbj8RNF2sIw: calls $8
*** RIVER *** [Js Th 5d 8s] [Kc]
U2CWBTv29qdCbj8RNF2sIw: checks
KfwW5us6tydK81NYTtK1gw: bets $25
U2CWBTv29qdCbj8RNF2sIw: folds
KfwW5us6tydK81NYTtK1gw collected $27.15 from pot
KfwW5us6tydK81NYTtK1gw: doesn't show hand
*** SUMMARY ***
Total pot $28.50 | Rake $1.35
Board [Js Th 5d 8s Kc]
Seat 1: tS9JHB1h+FQ++qu8RwRNgg (big blind) folded on the Flop
Seat 2: U2CWBTv29qdCbj8RNF2sIw folded on the River
Seat 3: yfXek8iJ7O4CFyqXrtGcfg folded before Flop (didn't bet)
Seat 4: 33q95we0Etwgrm6guQGncw folded before Flop (didn't bet)
Seat 5: KfwW5us6tydK81NYTtK1gw (button) collected ($27.15)
Seat 6: aIxzFKdtpDSkUePKZy/niQ (small blind) folded before Flop



PokerStars Game #59938726844:  Hold'em No Limit ($0.50/$1.00) - 2009/07/01 0:21:58 ET
Table 'mmbQQVBTrPdE+wy+s+9VPA' 6-max Seat #1 is the button
Seat 1: P9iqlRE1diA1wRYdf4YRBQ ($116.90 in chips)
Seat 3: wx3sQGkVi2x9wJXuWNHPBw ($107 in chips)
Seat 4: RfKnhkJN8HEAuzJpH2Ajdg ($17.05 in chips)
Seat 5: YMJG+F++3Aj6P8dAWda5fw ($100 in chips)
Seat 6: klQ/ufr9lOvfLMdAu0S9cw ($26.10 in chips)
ru6SCVvWcWt2SpmUsmArWQ will be allowed to play after the button
wx3sQGkVi2x9wJXuWNHPBw: posts small blind $0.50
RfKnhkJN8HEAuzJpH2Ajdg: posts big blind $1
*** HOLE CARDS ***
YMJG+F++3Aj6P8dAWda5fw: folds
klQ/ufr9lOvfLMdAu0S9cw: folds
P9iqlRE1diA1wRYdf4YRBQ: folds
wx3sQGkVi2x9wJXuWNHPBw: raises $3 to $4
RfKnhkJN8HEAuzJpH2Ajdg: calls $3
*** FLOP *** [Qh Ts Qd]
wx3sQGkVi2x9wJXuWNHPBw: checks
RfKnhkJN8HEAuzJpH2Ajdg: checks
*** TURN *** [Qh Ts Qd] [9c]
wx3sQGkVi2x9wJXuWNHPBw: checks
RfKnhkJN8HEAuzJpH2Ajdg: checks
*** RIVER *** [Qh Ts Qd 9c] [4h]
wx3sQGkVi2x9wJXuWNHPBw: checks
RfKnhkJN8HEAuzJpH2Ajdg: checks
*** SHOW DOWN ***
wx3sQGkVi2x9wJXuWNHPBw: shows [5d Ad] (a pair of Queens)
RfKnhkJN8HEAuzJpH2Ajdg: shows [7h 7s] (two pair, Queens and Sevens)
RfKnhkJN8HEAuzJpH2Ajdg collected $7.60 from pot
*** SUMMARY ***
Total pot $8 | Rake $0.40
Board [Qh Ts Qd 9c 4h]
Seat 1: P9iqlRE1diA1wRYdf4YRBQ (button) folded before Flop (didn't bet)
Seat 3: wx3sQGkVi2x9wJXuWNHPBw (small blind) showed [5d Ad] and lost with a pair of Queens
Seat 4: RfKnhkJN8HEAuzJpH2Ajdg (big blind) showed [7h 7s] and won ($7.60) with two pair, Queens and Sevens
Seat 5: YMJG+F++3Aj6P8dAWda5fw folded before Flop (didn't bet)
Seat 6: klQ/ufr9lOvfLMdAu0S9cw folded before Flop (didn't bet)



PokerStars Game #59938727556:  Hold'em No Limit ($0.50/$1.00) - 2009/07/01 0:21:59 ET
Table 'kS0cTQAEi+fdUlJP2gQYvw' 9-max Seat #6 is the button
Seat 1: c/9X4zftzphFxYtxp5kp9w ($51.90 in chips)
Seat 2: 4SFNYndzMeslixOnF4koZQ ($57.15 in chips)
Seat 3: 3obndzTJ6fECz8+wWhMd1w ($18.50 in chips)
Seat 4: TZcz9MEWDA+WydgGruqqbw ($100 in chips)
Seat 5: 2rxrMrE7koO2BNxvop/0+g ($50.45 in chips)
Seat 6: yAbu2QsRPVcjPbqlf/jDxw ($100.65 in chips)
Seat 7: Ffa7Nj4X5fddtROP01hfQg ($85.65 in chips)
Seat 8: qTymj6ZQ8ZoFi6fINJZb3w ($87 in chips)
Seat 9: y8Qb94e81yI/g0saQ6gU5g ($89.25 in chips)
Ffa7Nj4X5fddtROP01hfQg: posts small blind $0.50
qTymj6ZQ8ZoFi6fINJZb3w: posts big blind $1
2rxrMrE7koO2BNxvop/0+g: posts big blind $1
*** HOLE CARDS ***
y8Qb94e81yI/g0saQ6gU5g: folds
c/9X4zftzphFxYtxp5kp9w: folds
4SFNYndzMeslixOnF4koZQ: calls $1
3obndzTJ6fECz8+wWhMd1w: folds
TZcz9MEWDA+WydgGruqqbw: folds
2rxrMrE7koO2BNxvop/0+g: checks
yAbu2QsRPVcjPbqlf/jDxw: folds
Ffa7Nj4X5fddtROP01hfQg: calls $0.50
qTymj6ZQ8ZoFi6fINJZb3w: checks
*** FLOP *** [7c 2c As]
Ffa7Nj4X5fddtROP01hfQg: bets $2
qTymj6ZQ8ZoFi6fINJZb3w: folds
Ffa7Nj4X5fddtROP01hfQg said, "no need to worry"
4SFNYndzMeslixOnF4koZQ: folds
2rxrMrE7koO2BNxvop/0+g: calls $2
*** TURN *** [7c 2c As] [3s]
Ffa7Nj4X5fddtROP01hfQg: bets $2
2rxrMrE7koO2BNxvop/0+g: calls $2
*** RIVER *** [7c 2c As 3s] [Qs]
Ffa7Nj4X5fddtROP01hfQg said, "they always beat me"
Ffa7Nj4X5fddtROP01hfQg: bets $3
2rxrMrE7koO2BNxvop/0+g: folds
Ffa7Nj4X5fddtROP01hfQg collected $11.45 from pot
*** SUMMARY ***
Total pot $12 | Rake $0.55
Board [7c 2c As 3s Qs]
Seat 1: c/9X4zftzphFxYtxp5kp9w folded before Flop (didn't bet)
Seat 2: 4SFNYndzMeslixOnF4koZQ folded on the Flop
Seat 3: 3obndzTJ6fECz8+wWhMd1w folded before Flop (didn't bet)
Seat 4: TZcz9MEWDA+WydgGruqqbw folded before Flop (didn't bet)
Seat 5: 2rxrMrE7koO2BNxvop/0+g folded on the River
Seat 6: yAbu2QsRPVcjPbqlf/jDxw (button) folded before Flop (didn't bet)
Seat 7: Ffa7Nj4X5fddtROP01hfQg (small blind) collected ($11.45)
Seat 8: qTymj6ZQ8ZoFi6fINJZb3w (big blind) folded on the Flop
Seat 9: y8Qb94e81yI/g0saQ6gU5g folded before Flop (didn't bet)



PokerStars Game #59938727292:  Hold'em No Limit ($0.50/$1.00) - 2009/07/01 0:21:59 ET
Table 'b/mVBMBBjZR4F+Jsv8cuYA' 9-max Seat #5 is the button
Seat 1: 0bFSG2wtTalRoQW05hZ/uw ($39.70 in chips)
Seat 2: HPmAhANyB1+4MGzYS9i5Wg ($52.60 in chips)
Seat 3: x80+i7DJL+81v3quj7KbNg ($20 in chips)
Seat 4: 0oXWlMUwwWciWdZOQf6yUw ($127.45 in chips)
Seat 5: p5UKaxVobvptF0ANhR/q1A ($91.70 in chips)
Seat 6: FL3MrLspcF23LYvC4ipBOA ($316.60 in chips)
Seat 7: 5GtqC1O4Y1t1VmP51SDSJQ ($60 in chips)
Seat 8: L9njYvloJ1NdXjP8edHEAg ($102.50 in chips)
Seat 9: 9BZCcac3+McErkkSN2YScA ($113.95 in chips)
FL3MrLspcF23LYvC4ipBOA: posts small blind $0.50
5GtqC1O4Y1t1VmP51SDSJQ: posts big blind $1
*** HOLE CARDS ***
L9njYvloJ1NdXjP8edHEAg: folds
9BZCcac3+McErkkSN2YScA: folds
0bFSG2wtTalRoQW05hZ/uw: folds
HPmAhANyB1+4MGzYS9i5Wg: folds
x80+i7DJL+81v3quj7KbNg: folds
0oXWlMUwwWciWdZOQf6yUw: raises $3 to $4
p5UKaxVobvptF0ANhR/q1A: folds
FL3MrLspcF23LYvC4ipBOA: folds
5GtqC1O4Y1t1VmP51SDSJQ: folds
0oXWlMUwwWciWdZOQf6yUw collected $2.50 from pot
0oXWlMUwwWciWdZOQf6yUw: doesn't show hand
*** SUMMARY ***
Total pot $2.50 | Rake $0
Seat 1: 0bFSG2wtTalRoQW05hZ/uw folded before Flop (didn't bet)
Seat 2: HPmAhANyB1+4MGzYS9i5Wg folded before Flop (didn't bet)
Seat 3: x80+i7DJL+81v3quj7KbNg folded before Flop (didn't bet)
Seat 4: 0oXWlMUwwWciWdZOQf6yUw collected ($2.50)
Seat 5: p5UKaxVobvptF0ANhR/q1A (button) folded before Flop (didn't bet)
Seat 6: FL3MrLspcF23LYvC4ipBOA (small blind) folded before Flop
Seat 7: 5GtqC1O4Y1t1VmP51SDSJQ (big blind) folded before Flop
Seat 8: L9njYvloJ1NdXjP8edHEAg folded before Flop (didn't bet)
Seat 9: 9BZCcac3+McErkkSN2YScA folded before Flop (didn't bet)



PokerStars Game #59938727842:  Hold'em No Limit ($0.50/$1.00) - 2009/07/01 0:22:00 ET
Table 'J2yEIzCSC1VzM+R2gijwtg' 9-max Seat #1 is the button
Seat 1: knewtTmBc4Tc0z/5tAABYQ ($201.45 in chips)
Seat 2: kz9ziSiGUc+857heiKSayw ($15.95 in chips)
Seat 3: 9swGhtpERPngKPtvpoZkoQ ($123.15 in chips)
Seat 4: vR4IO10geOgvTW+LAUBv/A ($100 in chips)
Seat 5: /kZ258i1lqmMUXbtrZIHJA ($42.55 in chips)
Seat 6: bJckevFOcg//s0qyMQI6sQ ($176.40 in chips)
Seat 8: CIRDepY9Rc5tiDJPd0nNpQ ($93.90 in chips)
kz9ziSiGUc+857heiKSayw: posts small blind $0.50
9swGhtpERPngKPtvpoZkoQ: posts big blind $1
*** HOLE CARDS ***
vR4IO10geOgvTW+LAUBv/A: folds
/kZ258i1lqmMUXbtrZIHJA: calls $1
bJckevFOcg//s0qyMQI6sQ: folds
CIRDepY9Rc5tiDJPd0nNpQ: folds
knewtTmBc4Tc0z/5tAABYQ: folds
kz9ziSiGUc+857heiKSayw: calls $0.50
9swGhtpERPngKPtvpoZkoQ: checks
*** FLOP *** [2d 3s 3c]
kz9ziSiGUc+857heiKSayw: checks
9swGhtpERPngKPtvpoZkoQ: checks
/kZ258i1lqmMUXbtrZIHJA: checks
*** TURN *** [2d 3s 3c] [6d]
kz9ziSiGUc+857heiKSayw: checks
9swGhtpERPngKPtvpoZkoQ: checks
/kZ258i1lqmMUXbtrZIHJA: checks
*** RIVER *** [2d 3s 3c 6d] [Ac]
kz9ziSiGUc+857heiKSayw: checks
9swGhtpERPngKPtvpoZkoQ: checks
/kZ258i1lqmMUXbtrZIHJA: checks
*** SHOW DOWN ***
kz9ziSiGUc+857heiKSayw: shows [Jc 9s] (a pair of Threes)
9swGhtpERPngKPtvpoZkoQ: mucks hand
/kZ258i1lqmMUXbtrZIHJA: shows [Qh Js] (a pair of Threes - Ace+Queen kicker)
/kZ258i1lqmMUXbtrZIHJA collected $2.85 from pot
*** SUMMARY ***
Total pot $3 | Rake $0.15
Board [2d 3s 3c 6d Ac]
Seat 1: knewtTmBc4Tc0z/5tAABYQ (button) folded before Flop (didn't bet)
Seat 2: kz9ziSiGUc+857heiKSayw (small blind) showed [Jc 9s] and lost with a pair of Threes
Seat 3: 9swGhtpERPngKPtvpoZkoQ (big blind) mucked
Seat 4: vR4IO10geOgvTW+LAUBv/A folded before Flop (didn't bet)
Seat 5: /kZ258i1lqmMUXbtrZIHJA showed [Qh Js] and won ($2.85) with a pair of Threes
Seat 6: bJckevFOcg//s0qyMQI6sQ folded before Flop (didn't bet)
Seat 8: CIRDepY9Rc5tiDJPd0nNpQ folded before Flop (didn't bet)



PokerStars Game #59938728470:  Hold'em No Limit ($0.50/$1.00) - 2009/07/01 0:22:01 ET
Table 'aWHveb63HkbTmOGHOxjBkQ' 2-max Seat #2 is the button
Seat 1: xy2MQKoHoCZZIudmw8Xbow ($234.80 in chips)
Seat 2: xstEKavv3YDxpUnU4e9qAQ ($139.10 in chips)
xstEKavv3YDxpUnU4e9qAQ: posts small blind $0.50
xy2MQKoHoCZZIudmw8Xbow: posts big blind $1
*** HOLE CARDS ***
xstEKavv3YDxpUnU4e9qAQ: folds
xy2MQKoHoCZZIudmw8Xbow collected $1 from pot
xy2MQKoHoCZZIudmw8Xbow: doesn't show hand
*** SUMMARY ***
Total pot $1 | Rake $0
Seat 1: xy2MQKoHoCZZIudmw8Xbow (big blind) collected ($1)
Seat 2: xstEKavv3YDxpUnU4e9qAQ (button) (small blind) folded before Flop



PokerStars Game #59938729996:  Hold'em No Limit ($0.50/$1.00) - 2009/07/01 0:22:03 ET
Table 'hugOjcwJvzEwZbK7tyiWuQ' 9-max Seat #7 is the button
Seat 1: N9n5Wc3s35DpCrOAUUNAaQ ($127.85 in chips)
Seat 2: r27C1nIV4NS4+qbnrgBQSw ($257.05 in chips)
Seat 3: jDwhY1kCdc6EkAHbT7PJMQ ($106.55 in chips)
Seat 4: UWB3oeddt/GObx2Mix2Anw ($195.20 in chips)
Seat 6: gUUvmqdVlmvpal6B8nYrmg ($102.30 in chips)
Seat 7: FL3MrLspcF23LYvC4ipBOA ($100 in chips)
Seat 8: /zy+DB4S5fUQUSfZWFzYGw ($113.75 in chips)
Seat 9: o6JyUkbzCDw8tUabqtmnlg ($61.10 in chips)
/zy+DB4S5fUQUSfZWFzYGw: posts small blind $0.50
o6JyUkbzCDw8tUabqtmnlg: posts big blind $1
*** HOLE CARDS ***
N9n5Wc3s35DpCrOAUUNAaQ: folds
r27C1nIV4NS4+qbnrgBQSw: folds
jDwhY1kCdc6EkAHbT7PJMQ: folds
UWB3oeddt/GObx2Mix2Anw: folds
gUUvmqdVlmvpal6B8nYrmg: folds
FL3MrLspcF23LYvC4ipBOA: folds
/zy+DB4S5fUQUSfZWFzYGw: folds
o6JyUkbzCDw8tUabqtmnlg collected $1 from pot
o6JyUkbzCDw8tUabqtmnlg: doesn't show hand
*** SUMMARY ***
Total pot $1 | Rake $0
Seat 1: N9n5Wc3s35DpCrOAUUNAaQ folded before Flop (didn't bet)
Seat 2: r27C1nIV4NS4+qbnrgBQSw folded before Flop (didn't bet)
Seat 3: jDwhY1kCdc6EkAHbT7PJMQ folded before Flop (didn't bet)
Seat 4: UWB3oeddt/GObx2Mix2Anw folded before Flop (didn't bet)
Seat 6: gUUvmqdVlmvpal6B8nYrmg folded before Flop (didn't bet)
Seat 7: FL3MrLspcF23LYvC4ipBOA (button) folded before Flop (didn't bet)
Seat 8: /zy+DB4S5fUQUSfZWFzYGw (small blind) folded before Flop
Seat 9: o6JyUkbzCDw8tUabqtmnlg (big blind) collected ($1)



PokerStars Game #59938730852:  Hold'em No Limit ($0.50/$1.00) - 2009/07/01 0:22:04 ET
Table 'W/wyObTiXZm+Ckkl3YxcSw' 6-max Seat #5 is the button
Seat 1: ssLJburtEIqnVkx6X8R1uw ($117.75 in chips)
Seat 2: oDiBRCaF0QVtd3kO6xZIXw ($100 in chips)
Seat 3: b2a+5TkFf4xJN/Ihhma58Q ($38.20 in chips)
Seat 4: BdbmJTZZ47quA9vUWwXtlw ($50.10 in chips)
Seat 5: Wko+clJG9HZPPQ7Yn0Y5Zg ($26.75 in chips)
ssLJburtEIqnVkx6X8R1uw: posts small blind $0.50
oDiBRCaF0QVtd3kO6xZIXw: posts big blind $1
*** HOLE CARDS ***
b2a+5TkFf4xJN/Ihhma58Q: folds
BdbmJTZZ47quA9vUWwXtlw: folds
Wko+clJG9HZPPQ7Yn0Y5Zg: folds
ssLJburtEIqnVkx6X8R1uw: folds
1yB1nHUkHNNY8OJnDNHZMw joins the table at seat #6
oDiBRCaF0QVtd3kO6xZIXw collected $1 from pot
oDiBRCaF0QVtd3kO6xZIXw: doesn't show hand
*** SUMMARY ***
Total pot $1 | Rake $0
Seat 1: ssLJburtEIqnVkx6X8R1uw (small blind) folded before Flop
Seat 2: oDiBRCaF0QVtd3kO6xZIXw (big blind) collected ($1)
Seat 3: b2a+5TkFf4xJN/Ihhma58Q folded before Flop (didn't bet)
Seat 4: BdbmJTZZ47quA9vUWwXtlw folded before Flop (didn't bet)
Seat 5: Wko+clJG9HZPPQ7Yn0Y5Zg (button) folded before Flop (didn't bet)



PokerStars Game #59938732260:  Hold'em No Limit ($0.50/$1.00) - 2009/07/01 0:22:06 ET
Table 'aWHveb63HkbTmOGHOxjBkQ' 2-max Seat #1 is the button
Seat 1: xy2MQKoHoCZZIudmw8Xbow ($235.30 in chips)
Seat 2: xstEKavv3YDxpUnU4e9qAQ ($138.60 in chips)
xy2MQKoHoCZZIudmw8Xbow: posts small blind $0.50
xstEKavv3YDxpUnU4e9qAQ: posts big blind $1
*** HOLE CARDS ***
xy2MQKoHoCZZIudmw8Xbow: raises $3 to $4
xstEKavv3YDxpUnU4e9qAQ: folds
xy2MQKoHoCZZIudmw8Xbow collected $2 from pot
xy2MQKoHoCZZIudmw8Xbow: doesn't show hand
*** SUMMARY ***
Total pot $2 | Rake $0
Seat 1: xy2MQKoHoCZZIudmw8Xbow (button) (small blind) collected ($2)
Seat 2: xstEKavv3YDxpUnU4e9qAQ (big blind) folded before Flop



PokerStars Game #59938732470:  Hold'em No Limit ($0.50/$1.00) - 2009/07/01 0:22:07 ET
Table 'GxCPo/gd3OSthkYrAxJngg' 6-max Seat #2 is the button
Seat 1: sH8BpAFP+jGFxCgVpD1Lew ($182.45 in chips)
Seat 2: YExX2paeIHrmfIwV1ivM/w ($85.20 in chips)
Seat 3: h2lYnlZ7Ueu3PsyB2UOfSQ ($99 in chips)
Seat 4: YMJG+F++3Aj6P8dAWda5fw ($103.65 in chips)
Seat 5: G5ZSSN6RSON3gkNvk/SmYg ($100 in chips)
Seat 6: sS9IXedL3MiRmpVXhAILhw ($100 in chips)
h2lYnlZ7Ueu3PsyB2UOfSQ: posts small blind $0.50
YMJG+F++3Aj6P8dAWda5fw: posts big blind $1
*** HOLE CARDS ***
G5ZSSN6RSON3gkNvk/SmYg: folds
sS9IXedL3MiRmpVXhAILhw: folds
sH8BpAFP+jGFxCgVpD1Lew: raises $2 to $3
YExX2paeIHrmfIwV1ivM/w: folds
h2lYnlZ7Ueu3PsyB2UOfSQ: folds
YMJG+F++3Aj6P8dAWda5fw: raises $7 to $10
sH8BpAFP+jGFxCgVpD1Lew: folds
YMJG+F++3Aj6P8dAWda5fw collected $6.50 from pot
*** SUMMARY ***
Total pot $6.50 | Rake $0
Seat 1: sH8BpAFP+jGFxCgVpD1Lew folded before Flop
Seat 2: YExX2paeIHrmfIwV1ivM/w (button) folded before Flop (didn't bet)
Seat 3: h2lYnlZ7Ueu3PsyB2UOfSQ (small blind) folded before Flop
Seat 4: YMJG+F++3Aj6P8dAWda5fw (big blind) collected ($6.50)
Seat 5: G5ZSSN6RSON3gkNvk/SmYg folded before Flop (didn't bet)
Seat 6: sS9IXedL3MiRmpVXhAILhw folded before Flop (didn't bet)



PokerStars Game #59938734364:  Hold'em No Limit ($0.50/$1.00) - 2009/07/01 0:22:09 ET
Table '+cA8mcmhaedZ7YcrDdhmeQ' 6-max Seat #4 is the button
Seat 1: lsLuWlcPA3Rh7kJVLzMh0Q ($233 in chips)
Seat 2: trnpu4tPju3BU8W0wQQaiQ ($92.10 in chips)
Seat 3: 0WjiuIT7/EolY1oOx1ngeA ($137.80 in chips)
Seat 4: j0aDOn9Nft1HLTQvGu1UwA ($20.75 in chips)
Seat 5: 6WyjEXOToimYmtLdqIgHYQ ($61 in chips)
Seat 6: YfsTQsY/fxb+YqbdclTHuw ($96.70 in chips)
6WyjEXOToimYmtLdqIgHYQ: posts small blind $0.50
YfsTQsY/fxb+YqbdclTHuw: posts big blind $1
*** HOLE CARDS ***
lsLuWlcPA3Rh7kJVLzMh0Q: folds
trnpu4tPju3BU8W0wQQaiQ: folds
0WjiuIT7/EolY1oOx1ngeA: raises $2 to $3
j0aDOn9Nft1HLTQvGu1UwA: folds
6WyjEXOToimYmtLdqIgHYQ: folds
YfsTQsY/fxb+YqbdclTHuw: raises $2 to $5
0WjiuIT7/EolY1oOx1ngeA: calls $2
*** FLOP *** [4h 3c 5c]
YfsTQsY/fxb+YqbdclTHuw: bets $5
0WjiuIT7/EolY1oOx1ngeA: calls $5
*** TURN *** [4h 3c 5c] [9h]
YfsTQsY/fxb+YqbdclTHuw: bets $10
0WjiuIT7/EolY1oOx1ngeA: calls $10
*** RIVER *** [4h 3c 5c 9h] [3d]
YfsTQsY/fxb+YqbdclTHuw: bets $10
0WjiuIT7/EolY1oOx1ngeA: folds
YfsTQsY/fxb+YqbdclTHuw collected $38.55 from pot
*** SUMMARY ***
Total pot $40.50 | Rake $1.95
Board [4h 3c 5c 9h 3d]
Seat 1: lsLuWlcPA3Rh7kJVLzMh0Q folded before Flop (didn't bet)
Seat 2: trnpu4tPju3BU8W0wQQaiQ folded before Flop (didn't bet)
Seat 3: 0WjiuIT7/EolY1oOx1ngeA folded on the River
Seat 4: j0aDOn9Nft1HLTQvGu1UwA (button) folded before Flop (didn't bet)
Seat 5: 6WyjEXOToimYmtLdqIgHYQ (small blind) folded before Flop
Seat 6: YfsTQsY/fxb+YqbdclTHuw (big blind) collected ($38.55)



PokerStars Game #59938733748:  Hold'em No Limit ($0.50/$1.00) - 2009/07/01 0:22:09 ET
Table 'rmZfTK+oSebeUPJNbWhdAA' 6-max Seat #3 is the button
Seat 1: u4vYQZNWtIzOJre8fvCmvQ ($32.85 in chips)
Seat 2: OigyyiK+tTj1APPIAUmXDA ($78.20 in chips)
Seat 3: 9yjOzGERLaEZS8CZ6YNHFg ($61.30 in chips)
Seat 4: OGMLOcTNYZXZU81au7ztUw ($104.05 in chips)
Seat 5: VuZb/hkEc4X7s93w2ZZTpA ($112.75 in chips)
Seat 6: j7NIOHLZk7V2o9fOioO5ug ($106.30 in chips)
OGMLOcTNYZXZU81au7ztUw: posts small blind $0.50
VuZb/hkEc4X7s93w2ZZTpA: posts big blind $1
*** HOLE CARDS ***
j7NIOHLZk7V2o9fOioO5ug: folds
u4vYQZNWtIzOJre8fvCmvQ: calls $1
OigyyiK+tTj1APPIAUmXDA: folds
9yjOzGERLaEZS8CZ6YNHFg: folds
OGMLOcTNYZXZU81au7ztUw: calls $0.50
VuZb/hkEc4X7s93w2ZZTpA: checks
*** FLOP *** [6s 7c Kc]
OGMLOcTNYZXZU81au7ztUw: bets $2
VuZb/hkEc4X7s93w2ZZTpA: folds
u4vYQZNWtIzOJre8fvCmvQ: calls $2
*** TURN *** [6s 7c Kc] [4h]
OGMLOcTNYZXZU81au7ztUw: checks
u4vYQZNWtIzOJre8fvCmvQ: bets $4
OGMLOcTNYZXZU81au7ztUw: calls $4
*** RIVER *** [6s 7c Kc 4h] [4c]
OGMLOcTNYZXZU81au7ztUw: checks
u4vYQZNWtIzOJre8fvCmvQ: bets $5
OGMLOcTNYZXZU81au7ztUw: raises $12 to $17
u4vYQZNWtIzOJre8fvCmvQ: calls $12
*** SHOW DOWN ***
OGMLOcTNYZXZU81au7ztUw: shows [Jc Tc] (a flush, King high)
u4vYQZNWtIzOJre8fvCmvQ: mucks hand
OGMLOcTNYZXZU81au7ztUw collected $46.60 from pot
*** SUMMARY ***
Total pot $49 | Rake $2.40
Board [6s 7c Kc 4h 4c]
Seat 1: u4vYQZNWtIzOJre8fvCmvQ mucked
Seat 2: OigyyiK+tTj1APPIAUmXDA folded before Flop (didn't bet)
Seat 3: 9yjOzGERLaEZS8CZ6YNHFg (button) folded before Flop (didn't bet)
Seat 4: OGMLOcTNYZXZU81au7ztUw (small blind) showed [Jc Tc] and won ($46.60) with a flush, King high
Seat 5: VuZb/hkEc4X7s93w2ZZTpA (big blind) folded on the Flop
Seat 6: j7NIOHLZk7V2o9fOioO5ug folded before Flop (didn't bet)



PokerStars Game #59938734134:  Hold'em No Limit ($0.50/$1.00) - 2009/07/01 0:22:09 ET
Table 'tyUh+jyNvrceIQdKMJjQ2wZFWj23PMihdwrNWv41OG/Qeat #6 is the button
Seat 1: o8A5MUdudVKu+pAwgZOX2w ($195.25 in chips)
Seat 2: 6iVcnPw9a2oNG6sPQo3G6g ($99.15 in chips)
Seat 3: L9qfLYXrczhAPd/VckgsWw ($38.60 in chips)
Seat 5: j7NIOHLZk7V2o9fOioO5ug ($103.95 in chips)
Seat 6: YsLQ3BAvgQHWXMAv3Wv6Hg ($106.75 in chips)
o8A5MUdudVKu+pAwgZOX2w: posts small blind $0.50
6iVcnPw9a2oNG6sPQo3G6g: posts big blind $1
*** HOLE CARDS ***
L9qfLYXrczhAPd/VckgsWw: calls $1
j7NIOHLZk7V2o9fOioO5ug: folds
YsLQ3BAvgQHWXMAv3Wv6Hg: folds
o8A5MUdudVKu+pAwgZOX2w: calls $0.50
6iVcnPw9a2oNG6sPQo3G6g: checks
*** FLOP *** [4d Ac Ks]
TSuRyAHnUPCFjP7Z0rEE0w has returned
o8A5MUdudVKu+pAwgZOX2w: checks
6iVcnPw9a2oNG6sPQo3G6g: checks
L9qfLYXrczhAPd/VckgsWw: checks
*** TURN *** [4d Ac Ks] [7h]
TSuRyAHnUPCFjP7Z0rEE0w is sitting out
o8A5MUdudVKu+pAwgZOX2w: checks
6iVcnPw9a2oNG6sPQo3G6g: checks
TSuRyAHnUPCFjP7Z0rEE0w has returned
L9qfLYXrczhAPd/VckgsWw: bets $4
o8A5MUdudVKu+pAwgZOX2w: folds
6iVcnPw9a2oNG6sPQo3G6g: folds
L9qfLYXrczhAPd/VckgsWw collected $2.85 from pot
L9qfLYXrczhAPd/VckgsWw: doesn't show hand
*** SUMMARY ***
Total pot $3 | Rake $0.15
Board [4d Ac Ks 7h]
Seat 1: o8A5MUdudVKu+pAwgZOX2w (small blind) folded on the Turn
Seat 2: 6iVcnPw9a2oNG6sPQo3G6g (big blind) folded on the Turn
Seat 3: L9qfLYXrczhAPd/VckgsWw collected ($2.85)
Seat 5: j7NIOHLZk7V2o9fOioO5ug folded before Flop (didn't bet)
Seat 6: YsLQ3BAvgQHWXMAv3Wv6Hg (button) folded before Flop (didn't bet)



PokerStars Game #59938734518:  Hold'em No Limit ($0.50/$1.00) - 2009/07/01 0:22:10 ET
Table 'O96CPOtvMBWP6kzuYDfdFA' 6-max Seat #2 is the button
Seat 1: yl9aRDw7k/ieGiDoJVy+/w ($67.05 in chips)
Seat 2: vTUNrd/7qIOJpW0suEu5hQ ($210.90 in chips)
Seat 3: V89DGjxE171oPREEbAXiyg ($33.20 in chips)
Seat 5: wRxiu9OJzvvN84OYWW9jxQ ($123.85 in chips)
Seat 6: xNKcQzD9+/iHmtJn4vYq9w ($74 in chips)
V89DGjxE171oPREEbAXiyg: posts small blind $0.50
wRxiu9OJzvvN84OYWW9jxQ: posts big blind $1
*** HOLE CARDS ***
xNKcQzD9+/iHmtJn4vYq9w: folds
yl9aRDw7k/ieGiDoJVy+/w: calls $1
vTUNrd/7qIOJpW0suEu5hQ: folds
V89DGjxE171oPREEbAXiyg: raises $3 to $4
wRxiu9OJzvvN84OYWW9jxQ: calls $3
yl9aRDw7k/ieGiDoJVy+/w: folds
*** FLOP *** [7c 2h Ts]
V89DGjxE171oPREEbAXiyg: bets $10
wRxiu9OJzvvN84OYWW9jxQ: folds
V89DGjxE171oPREEbAXiyg collected $8.55 from pot
*** SUMMARY ***
Total pot $9 | Rake $0.45
Board [7c 2h Ts]
Seat 1: yl9aRDw7k/ieGiDoJVy+/w folded before Flop
Seat 2: vTUNrd/7qIOJpW0suEu5hQ (button) folded before Flop (didn't bet)
Seat 3: V89DGjxE171oPREEbAXiyg (small blind) collected ($8.55)
Seat 5: wRxiu9OJzvvN84OYWW9jxQ (big blind) folded on the Flop
Seat 6: xNKcQzD9+/iHmtJn4vYq9w folded before Flop (didn't bet)



PokerStars Game #59938735088:  Hold'em No Limit ($0.50/$1.00) - 2009/07/01 0:22:11 ET
Table 'QSIig7BLMc9wY/rgBechzw' 6-max Seat #1 is the button
Seat 1: uuA9hpFU17U5/t4cvpbpBg ($43.40 in chips)
Seat 2: 0WjiuIT7/EolY1oOx1ngeA ($118.40 in chips)
Seat 3: +W6OnF033KNM2xH0fGj98Q ($111.70 in chips)
Seat 4: +uSzP8Jwnw7sKfQ4s66b7w ($48.50 in chips)
Seat 6: KpnW5CcJ4Mg6MeclfKmLrw ($144.25 in chips)
0WjiuIT7/EolY1oOx1ngeA: posts small blind $0.50
+W6OnF033KNM2xH0fGj98Q: posts big blind $1
bvU2ZjpVnszLCFVeWbxePg: sits out
*** HOLE CARDS ***
+uSzP8Jwnw7sKfQ4s66b7w: folds
KpnW5CcJ4Mg6MeclfKmLrw has timed out
KpnW5CcJ4Mg6MeclfKmLrw: folds
KpnW5CcJ4Mg6MeclfKmLrw is sitting out
uuA9hpFU17U5/t4cvpbpBg: folds
KpnW5CcJ4Mg6MeclfKmLrw has returned
0WjiuIT7/EolY1oOx1ngeA: raises $2 to $3
+W6OnF033KNM2xH0fGj98Q: folds
0WjiuIT7/EolY1oOx1ngeA collected $2 from pot
0WjiuIT7/EolY1oOx1ngeA: doesn't show hand
*** SUMMARY ***
Total pot $2 | Rake $0
Seat 1: uuA9hpFU17U5/t4cvpbpBg (button) folded before Flop (didn't bet)
Seat 2: 0WjiuIT7/EolY1oOx1ngeA (small blind) collected ($2)
Seat 3: +W6OnF033KNM2xH0fGj98Q (big blind) folded before Flop
Seat 4: +uSzP8Jwnw7sKfQ4s66b7w folded before Flop (didn't bet)
Seat 6: KpnW5CcJ4Mg6MeclfKmLrw folded before Flop (didn't bet)



PokerStars Game #59938735130:  Hold'em No Limit ($0.50/$1.00) - 2009/07/01 0:22:11 ET
Table '6YvsYDPNIDx2v5z3bJnwZQ' 9-max Seat #5 is the button
Seat 1: Ogn4JDV3mp4ZDKO49IFzKA ($17 in chips)
Seat 2: q9qdvTFQkzcAZRujD6rXUA ($98 in chips)
Seat 3: negfosHnGOZXSHpWDRKyBQ ($18.30 in chips)
Seat 4: kEr5NYB+JIG5+szcYMr6hA ($47.50 in chips)
Seat 5: mBRWbnUl8diyBO1qTJaNzw ($168.70 in chips)
Seat 6: uMPEfCcGCfsxmy53tVUMug ($100 in chips)
Seat 7: boixc27eqTYA1p0tUdMuBQ ($109.60 in chips)
Seat 8: PSFxpXgPedVZyHSu2Zhb7Q ($77.90 in chips)
Seat 9: jDwhY1kCdc6EkAHbT7PJMQ ($102.85 in chips)
uMPEfCcGCfsxmy53tVUMug: posts small blind $0.50
boixc27eqTYA1p0tUdMuBQ: posts big blind $1
*** HOLE CARDS ***
PSFxpXgPedVZyHSu2Zhb7Q: calls $1
jDwhY1kCdc6EkAHbT7PJMQ: folds
Ogn4JDV3mp4ZDKO49IFzKA: folds
q9qdvTFQkzcAZRujD6rXUA: folds
negfosHnGOZXSHpWDRKyBQ: folds
kEr5NYB+JIG5+szcYMr6hA: folds
mBRWbnUl8diyBO1qTJaNzw: folds
uMPEfCcGCfsxmy53tVUMug: folds
boixc27eqTYA1p0tUdMuBQ: checks
*** FLOP *** [Ac 3h 9c]
boixc27eqTYA1p0tUdMuBQ: checks
PSFxpXgPedVZyHSu2Zhb7Q: bets $2
boixc27eqTYA1p0tUdMuBQ: calls $2
*** TURN *** [Ac 3h 9c] [8s]
boixc27eqTYA1p0tUdMuBQ: checks
PSFxpXgPedVZyHSu2Zhb7Q: bets $3
boixc27eqTYA1p0tUdMuBQ: raises $6 to $9
PSFxpXgPedVZyHSu2Zhb7Q: folds
boixc27eqTYA1p0tUdMuBQ collected $11.90 from pot
*** SUMMARY ***
Total pot $12.50 | Rake $0.60
Board [Ac 3h 9c 8s]
Seat 1: Ogn4JDV3mp4ZDKO49IFzKA folded before Flop (didn't bet)
Seat 2: q9qdvTFQkzcAZRujD6rXUA folded before Flop (didn't bet)
Seat 3: negfosHnGOZXSHpWDRKyBQ folded before Flop (didn't bet)
Seat 4: kEr5NYB+JIG5+szcYMr6hA folded before Flop (didn't bet)
Seat 5: mBRWbnUl8diyBO1qTJaNzw (button) folded before Flop (didn't bet)
Seat 6: uMPEfCcGCfsxmy53tVUMug (small blind) folded before Flop
Seat 7: boixc27eqTYA1p0tUdMuBQ (big blind) collected ($11.90)
Seat 8: PSFxpXgPedVZyHSu2Zhb7Q folded on the Turn
Seat 9: jDwhY1kCdc6EkAHbT7PJMQ folded before Flop (didn't bet)



PokerStars Game #59938735890:  Hold'em No Limit ($0.50/$1.00) - 2009/07/01 0:22:12 ET
Table 'tJq9SfN1ywY0r03VBlWlwQ' 9-max Seat #5 is the button
Seat 1: wZsU+w9r7G66x93UuvBf1Q ($329.05 in chips)
Seat 2: RqkO8O/Y3qlc3PIuCAHjVg ($76.40 in chips)
Seat 3: FVs16t7GgfWgQWt4JxsObQ ($44.45 in chips)
Seat 4: zBHLwg+HmbHmRtVQMhavjA ($100 in chips)
Seat 5: Ogn4JDV3mp4ZDKO49IFzKA ($18.50 in chips)
Seat 6: gUUvmqdVlmvpal6B8nYrmg ($100 in chips)
Seat 7: qVhRZ0PLZ95XRJHWAjXjOQ ($100 in chips)
Seat 8: G4DEhsZFmznGNVpy2SEocA ($23.50 in chips)
gUUvmqdVlmvpal6B8nYrmg: posts small blind $0.50
qVhRZ0PLZ95XRJHWAjXjOQ: posts big blind $1
*** HOLE CARDS ***
G4DEhsZFmznGNVpy2SEocA: folds
wZsU+w9r7G66x93UuvBf1Q: folds
RqkO8O/Y3qlc3PIuCAHjVg: calls $1
FVs16t7GgfWgQWt4JxsObQ: folds
zBHLwg+HmbHmRtVQMhavjA: folds
Ogn4JDV3mp4ZDKO49IFzKA: raises $17.50 to $18.50 and is all-in
gUUvmqdVlmvpal6B8nYrmg: folds
qVhRZ0PLZ95XRJHWAjXjOQ: calls $17.50
RqkO8O/Y3qlc3PIuCAHjVg: folds
*** FLOP *** [2d 9s 6h]
*** TURN *** [2d 9s 6h] [7c]
*** RIVER *** [2d 9s 6h 7c] [9d]
*** SHOW DOWN ***
qVhRZ0PLZ95XRJHWAjXjOQ: shows [Qh Qc] (two pair, Queens and Nines)
Ogn4JDV3mp4ZDKO49IFzKA: mucks hand
qVhRZ0PLZ95XRJHWAjXjOQ collected $36.60 from pot
*** SUMMARY ***
Total pot $38.50 | Rake $1.90
Board [2d 9s 6h 7c 9d]
Seat 1: wZsU+w9r7G66x93UuvBf1Q folded before Flop (didn't bet)
Seat 2: RqkO8O/Y3qlc3PIuCAHjVg folded before Flop
Seat 3: FVs16t7GgfWgQWt4JxsObQ folded before Flop (didn't bet)
Seat 4: zBHLwg+HmbHmRtVQMhavjA folded before Flop (didn't bet)
Seat 5: Ogn4JDV3mp4ZDKO49IFzKA (button) mucked
Seat 6: gUUvmqdVlmvpal6B8nYrmg (small blind) folded before Flop
Seat 7: qVhRZ0PLZ95XRJHWAjXjOQ (big blind) showed [Qh Qc] and won ($36.60) with two pair, Queens and Nines
Seat 8: G4DEhsZFmznGNVpy2SEocA folded before Flop (didn't bet)



PokerStars Game #59938736932:  Hold'em No Limit ($0.50/$1.00) - 2009/07/01 0:22:13 ET
Table 'pHrhryH8jPNdQfY62f8v+g' 6-max Seat #4 is the button
Seat 1: BdbmJTZZ47quA9vUWwXtlw ($69.75 in chips)
Seat 2: RqgF7gRoKgRNW8Zoi1ty4A ($117.10 in chips)
Seat 4: wenbG7TaM3H7h5kn78OFNw ($55.05 in chips)
Seat 5: Gp2euK/nqF6qXKe7U+jOfw ($119.15 in chips)
Gp2euK/nqF6qXKe7U+jOfw: posts small blind $0.50
xNKcQzD9+/iHmtJn4vYq9w: is sitting out
BdbmJTZZ47quA9vUWwXtlw: posts big blind $1
0WjiuIT7/EolY1oOx1ngeA: sits out
*** HOLE CARDS ***
xNKcQzD9+/iHmtJn4vYq9w leaves the table
RqgF7gRoKgRNW8Zoi1ty4A: raises $2 to $3
wenbG7TaM3H7h5kn78OFNw: raises $2 to $5
Gp2euK/nqF6qXKe7U+jOfw: folds
BdbmJTZZ47quA9vUWwXtlw: folds
RqgF7gRoKgRNW8Zoi1ty4A: calls $2
*** FLOP *** [Qd 4c 5s]
RqgF7gRoKgRNW8Zoi1ty4A: checks
xAU6q2/cwmby2sxmA8VcmA joins the table at seat #6
wenbG7TaM3H7h5kn78OFNw: bets $4
RqgF7gRoKgRNW8Zoi1ty4A: folds
wenbG7TaM3H7h5kn78OFNw collected $10.95 from pot
*** SUMMARY ***
Total pot $11.50 | Rake $0.55
Board [Qd 4c 5s]
Seat 1: BdbmJTZZ47quA9vUWwXtlw (big blind) folded before Flop
Seat 2: RqgF7gRoKgRNW8Zoi1ty4A folded on the Flop
Seat 4: wenbG7TaM3H7h5kn78OFNw (button) collected ($10.95)
Seat 5: Gp2euK/nqF6qXKe7U+jOfw (small blind) folded before Flop



PokerStars Game #59938736600:  Hold'em No Limit ($0.50/$1.00) - 2009/07/01 0:22:13 ET
Table 'ZFWj23PMihdwrNWv41OG/Q' 9-max Seat #6 is the button
Seat 1: yAbu2QsRPVcjPbqlf/jDxw ($103.30 in chips)
Seat 2: ARfmgHcEUKh68laBZy4veA ($57.75 in chips)
Seat 3: G9Fo2TZCN7HI43Po4zSN3A ($100 in chips)
Seat 6: tjhwe1V98x2spSoUQER3HQ ($100 in chips)
Seat 7: wIZ377kjl2fHFGnS93o6bw ($43.55 in chips)
Seat 8: knewtTmBc4Tc0z/5tAABYQ ($107 in chips)
Seat 9: atVaKXE/AQGa798rpMF/Bg ($57 in chips)
wIZ377kjl2fHFGnS93o6bw: posts small blind $0.50
knewtTmBc4Tc0z/5tAABYQ: posts big blind $1
*** HOLE CARDS ***
atVaKXE/AQGa798rpMF/Bg: folds
yAbu2QsRPVcjPbqlf/jDxw: folds
aNuEPl+Lh/dZypIbbfz+mA leaves the table
ARfmgHcEUKh68laBZy4veA: folds
G9Fo2TZCN7HI43Po4zSN3A: folds
PEmogYqKpuv0ozeBbXL+7Q has returned
tkdBeXTJlFsZdioidNqLow joins the table at seat #5
tjhwe1V98x2spSoUQER3HQ: folds
wIZ377kjl2fHFGnS93o6bw: calls $0.50
knewtTmBc4Tc0z/5tAABYQ: raises $3 to $4
wIZ377kjl2fHFGnS93o6bw: folds
knewtTmBc4Tc0z/5tAABYQ collected $2 from pot
knewtTmBc4Tc0z/5tAABYQ: doesn't show hand
*** SUMMARY ***
Total pot $2 | Rake $0
Seat 1: yAbu2QsRPVcjPbqlf/jDxw folded before Flop (didn't bet)
Seat 2: ARfmgHcEUKh68laBZy4veA folded before Flop (didn't bet)
Seat 3: G9Fo2TZCN7HI43Po4zSN3A folded before Flop (didn't bet)
Seat 6: tjhwe1V98x2spSoUQER3HQ (button) folded before Flop (didn't bet)
Seat 7: wIZ377kjl2fHFGnS93o6bw (small blind) folded before Flop
Seat 8: knewtTmBc4Tc0z/5tAABYQ (big blind) collected ($2)
Seat 9: atVaKXE/AQGa798rpMF/Bg folded before Flop (didn't bet)



PokerStars Game #59938736432:  Hold'em No Limit ($0.50/$1.00) - 2009/07/01 0:22:13 ET
Table 'aWHveb63HkbTmOGHOxjBkQ' 2-max Seat #2 is the button
Seat 1: xy2MQKoHoCZZIudmw8Xbow ($236.30 in chips)
Seat 2: xstEKavv3YDxpUnU4e9qAQ ($137.60 in chips)
xstEKavv3YDxpUnU4e9qAQ: posts small blind $0.50
xy2MQKoHoCZZIudmw8Xbow: posts big blind $1
*** HOLE CARDS ***
xstEKavv3YDxpUnU4e9qAQ: folds
xy2MQKoHoCZZIudmw8Xbow collected $1 from pot
xy2MQKoHoCZZIudmw8Xbow: doesn't show hand
*** SUMMARY ***
Total pot $1 | Rake $0
Seat 1: xy2MQKoHoCZZIudmw8Xbow (big blind) collected ($1)
Seat 2: xstEKavv3YDxpUnU4e9qAQ (button) (small blind) folded before Flop



PokerStars Game #59938737652:  Hold'em No Limit ($0.50/$1.00) - 2009/07/01 0:22:14 ET
Table 'SQLOQoANiHscJ8AL7zffbw' 9-max Seat #6 is the button
Seat 1: jPTRd6SpCp4xqAy2XQiTOw ($94.05 in chips)
Seat 2: /zy+DB4S5fUQUSfZWFzYGw ($280.35 in chips)
Seat 3: 0eFnow7+D7veCYQ+CG9FFw ($98.50 in chips)
Seat 4: N9n5Wc3s35DpCrOAUUNAaQ ($120.30 in chips)
Seat 5: L9njYvloJ1NdXjP8edHEAg ($110.55 in chips)
Seat 6: p5UKaxVobvptF0ANhR/q1A ($157 in chips)
Seat 7: bJckevFOcg//s0qyMQI6sQ ($104.05 in chips)
Seat 8: 9ce+0Dl3d0BeEFIP+8HezA ($20 in chips)
bJckevFOcg//s0qyMQI6sQ: posts small blind $0.50
9ce+0Dl3d0BeEFIP+8HezA: posts big blind $1
qJr25HAtvv1w/7IBvjMM3g: sits out
*** HOLE CARDS ***
jPTRd6SpCp4xqAy2XQiTOw: calls $1
/zy+DB4S5fUQUSfZWFzYGw: folds
0eFnow7+D7veCYQ+CG9FFw: raises $3 to $4
N9n5Wc3s35DpCrOAUUNAaQ: folds
L9njYvloJ1NdXjP8edHEAg: folds
p5UKaxVobvptF0ANhR/q1A: folds
bJckevFOcg//s0qyMQI6sQ: folds
9ce+0Dl3d0BeEFIP+8HezA: folds
jPTRd6SpCp4xqAy2XQiTOw: calls $3
*** FLOP *** [2c Kd Qh]
jPTRd6SpCp4xqAy2XQiTOw: checks
0eFnow7+D7veCYQ+CG9FFw: bets $7
jPTRd6SpCp4xqAy2XQiTOw: calls $7
*** TURN *** [2c Kd Qh] [3d]
jPTRd6SpCp4xqAy2XQiTOw: checks
0eFnow7+D7veCYQ+CG9FFw: bets $16
jPTRd6SpCp4xqAy2XQiTOw: calls $16
*** RIVER *** [2c Kd Qh 3d] [9s]
jPTRd6SpCp4xqAy2XQiTOw: bets $20
0eFnow7+D7veCYQ+CG9FFw: folds
jPTRd6SpCp4xqAy2XQiTOw collected $52.80 from pot
jPTRd6SpCp4xqAy2XQiTOw: doesn't show hand
*** SUMMARY ***
Total pot $55.50 | Rake $2.70
Board [2c Kd Qh 3d 9s]
Seat 1: jPTRd6SpCp4xqAy2XQiTOw collected ($52.80)
Seat 2: /zy+DB4S5fUQUSfZWFzYGw folded before Flop (didn't bet)
Seat 3: 0eFnow7+D7veCYQ+CG9FFw folded on the River
Seat 4: N9n5Wc3s35DpCrOAUUNAaQ folded before Flop (didn't bet)
Seat 5: L9njYvloJ1NdXjP8edHEAg folded before Flop (didn't bet)
Seat 6: p5UKaxVobvptF0ANhR/q1A (button) folded before Flop (didn't bet)
Seat 7: bJckevFOcg//s0qyMQI6sQ (small blind) folded before Flop
Seat 8: 9ce+0Dl3d0BeEFIP+8HezA (big blind) folded before Flop



PokerStars Game #59938737592:  Hold'em No Limit ($0.50/$1.00) - 2009/07/01 0:22:14 ET
Table 'fTlPiCj0utgzC/5io+I7ew' 6-max Seat #3 is the button
Seat 1: YMJG+F++3Aj6P8dAWda5fw ($100 in chips)
Seat 2: +xUCTmR3cU7G239W+vZv6g ($142.20 in chips)
Seat 3: oDiBRCaF0QVtd3kO6xZIXw ($100 in chips)
Seat 4: uJVSceLggtsrJya+WtmUEA ($102.10 in chips)
Seat 5: bFrTkDcWGTxyvNul7GVdYg ($240.50 in chips)
uJVSceLggtsrJya+WtmUEA: posts small blind $0.50
bFrTkDcWGTxyvNul7GVdYg: posts big blind $1
*** HOLE CARDS ***
YMJG+F++3Aj6P8dAWda5fw: folds
+xUCTmR3cU7G239W+vZv6g: folds
oDiBRCaF0QVtd3kO6xZIXw: folds
uJVSceLggtsrJya+WtmUEA: raises $2 to $3
bFrTkDcWGTxyvNul7GVdYg: calls $2
*** FLOP *** [3h 7h 6d]
uJVSceLggtsrJya+WtmUEA: bets $4
bFrTkDcWGTxyvNul7GVdYg: calls $4
*** TURN *** [3h 7h 6d] [Tc]
uJVSceLggtsrJya+WtmUEA: checks
bFrTkDcWGTxyvNul7GVdYg: checks
*** RIVER *** [3h 7h 6d Tc] [Qc]
uJVSceLggtsrJya+WtmUEA: checks
bFrTkDcWGTxyvNul7GVdYg: checks
*** SHOW DOWN ***
uJVSceLggtsrJya+WtmUEA: shows [Kd 8c] (high card King)
bFrTkDcWGTxyvNul7GVdYg: shows [Td Js] (a pair of Tens)
bFrTkDcWGTxyvNul7GVdYg collected $13.35 from pot
*** SUMMARY ***
Total pot $14 | Rake $0.65
Board [3h 7h 6d Tc Qc]
Seat 1: YMJG+F++3Aj6P8dAWda5fw folded before Flop (didn't bet)
Seat 2: +xUCTmR3cU7G239W+vZv6g folded before Flop (didn't bet)
Seat 3: oDiBRCaF0QVtd3kO6xZIXw (button) folded before Flop (didn't bet)
Seat 4: uJVSceLggtsrJya+WtmUEA (small blind) showed [Kd 8c] and lost with high card King
Seat 5: bFrTkDcWGTxyvNul7GVdYg (big blind) showed [Td Js] and won ($13.35) with a pair of Tens



PokerStars Game #59938740014:  Hold'em No Limit ($0.50/$1.00) - 2009/07/01 0:22:18 ET
Table 'aWHveb63HkbTmOGHOxjBkQ' 2-max Seat #1 is the button
Seat 1: xy2MQKoHoCZZIudmw8Xbow ($236.80 in chips)
Seat 2: xstEKavv3YDxpUnU4e9qAQ ($137.10 in chips)
xy2MQKoHoCZZIudmw8Xbow: posts small blind $0.50
xstEKavv3YDxpUnU4e9qAQ: posts big blind $1
*** HOLE CARDS ***
xy2MQKoHoCZZIudmw8Xbow: raises $2 to $3
xstEKavv3YDxpUnU4e9qAQ: folds
xy2MQKoHoCZZIudmw8Xbow collected $2 from pot
xy2MQKoHoCZZIudmw8Xbow: doesn't show hand
*** SUMMARY ***
Total pot $2 | Rake $0
Seat 1: xy2MQKoHoCZZIudmw8Xbow (button) (small blind) collected ($2)
Seat 2: xstEKavv3YDxpUnU4e9qAQ (big blind) folded before Flop



PokerStars Game #59938740630:  Hold'em No Limit ($0.50/$1.00) - 2009/07/01 0:22:19 ET
Table '/RZcOwpZpHQ+OwPwjsbnRw' 6-max Seat #1 is the button
Seat 1: jMljU/dOPMXfJi8OmbdYdw ($94.30 in chips)
Seat 2: dHC9PH9hdH3Ad2TD8ZxX0Q ($46.10 in chips)
Seat 3: OigyyiK+tTj1APPIAUmXDA ($80.60 in chips)
Seat 4: j7NIOHLZk7V2o9fOioO5ug ($100 in chips)
Seat 5: wx3sQGkVi2x9wJXuWNHPBw ($205.05 in chips)
Seat 6: XOIf9W+VAxhZqN+SYoyMKA ($255.30 in chips)
dHC9PH9hdH3Ad2TD8ZxX0Q: posts small blind $0.50
OigyyiK+tTj1APPIAUmXDA: posts big blind $1
*** HOLE CARDS ***
j7NIOHLZk7V2o9fOioO5ug: folds
wx3sQGkVi2x9wJXuWNHPBw: folds
XOIf9W+VAxhZqN+SYoyMKA: folds
jMljU/dOPMXfJi8OmbdYdw: folds
dHC9PH9hdH3Ad2TD8ZxX0Q: calls $0.50
OigyyiK+tTj1APPIAUmXDA: checks
*** FLOP *** [2d 7s Qs]
dHC9PH9hdH3Ad2TD8ZxX0Q: checks
OigyyiK+tTj1APPIAUmXDA: checks
*** TURN *** [2d 7s Qs] [Th]
dHC9PH9hdH3Ad2TD8ZxX0Q: checks
OigyyiK+tTj1APPIAUmXDA: checks
*** RIVER *** [2d 7s Qs Th] [8s]
dHC9PH9hdH3Ad2TD8ZxX0Q: bets $4
OigyyiK+tTj1APPIAUmXDA: calls $4
*** SHOW DOWN ***
dHC9PH9hdH3Ad2TD8ZxX0Q: shows [3c Jc] (high card Queen)
OigyyiK+tTj1APPIAUmXDA: shows [Tc 5s] (a pair of Tens)
OigyyiK+tTj1APPIAUmXDA collected $9.55 from pot
*** SUMMARY ***
Total pot $10 | Rake $0.45
Board [2d 7s Qs Th 8s]
Seat 1: jMljU/dOPMXfJi8OmbdYdw (button) folded before Flop (didn't bet)
Seat 2: dHC9PH9hdH3Ad2TD8ZxX0Q (small blind) showed [3c Jc] and lost with high card Queen
Seat 3: OigyyiK+tTj1APPIAUmXDA (big blind) showed [Tc 5s] and won ($9.55) with a pair of Tens
Seat 4: j7NIOHLZk7V2o9fOioO5ug folded before Flop (didn't bet)
Seat 5: wx3sQGkVi2x9wJXuWNHPBw folded before Flop (didn't bet)
Seat 6: XOIf9W+VAxhZqN+SYoyMKA folded before Flop (didn't bet)



PokerStars Game #59938741570:  Hold'em No Limit ($0.50/$1.00) - 2009/07/01 0:22:20 ET
Table 'VOs36P6NW+QyXeQ1B62kmA' 6-max Seat #1 is the button
Seat 1: AdLVjddOzm+sRNo1Bc3S6Q ($142.55 in chips)
Seat 2: KpnW5CcJ4Mg6MeclfKmLrw ($110.30 in chips)
Seat 5: X7GlkHF+lkbarCLuZ4Uf0w ($20 in chips)
Seat 6: 6tvjsJrdmWg+g7FVrMnzXA ($49.65 in chips)
KpnW5CcJ4Mg6MeclfKmLrw: posts small blind $0.50
VuZb/hkEc4X7s93w2ZZTpA: is sitting out
X7GlkHF+lkbarCLuZ4Uf0w: posts big blind $1
*** HOLE CARDS ***
VuZb/hkEc4X7s93w2ZZTpA leaves the table
6tvjsJrdmWg+g7FVrMnzXA: raises $2 to $3
AdLVjddOzm+sRNo1Bc3S6Q: folds
TSuRyAHnUPCFjP7Z0rEE0w has returned
KpnW5CcJ4Mg6MeclfKmLrw: folds
X7GlkHF+lkbarCLuZ4Uf0w: raises $17 to $20 and is all-in
6tvjsJrdmWg+g7FVrMnzXA: calls $17
*** FLOP *** [7s 7h Th]
*** TURN *** [7s 7h Th] [Tc]
*** RIVER *** [7s 7h Th Tc] [Jh]
*** SHOW DOWN ***
X7GlkHF+lkbarCLuZ4Uf0w: shows [As 9s] (two pair, Tens and Sevens)
6tvjsJrdmWg+g7FVrMnzXA: shows [Kc Jc] (two pair, Jacks and Tens)
6tvjsJrdmWg+g7FVrMnzXA collected $38.50 from pot
*** SUMMARY ***
Total pot $40.50 | Rake $2
Board [7s 7h Th Tc Jh]
Seat 1: AdLVjddOzm+sRNo1Bc3S6Q (button) folded before Flop (didn't bet)
Seat 2: KpnW5CcJ4Mg6MeclfKmLrw (small blind) folded before Flop
Seat 5: X7GlkHF+lkbarCLuZ4Uf0w (big blind) showed [As 9s] and lost with two pair, Tens and Sevens
Seat 6: 6tvjsJrdmWg+g7FVrMnzXA showed [Kc Jc] and won ($38.50) with two pair, Jacks and Tens



PokerStars Game #59938741090:  Hold'em No Limit ($0.50/$1.00) - 2009/07/01 0:22:20 ET
Table 'N2bNCDHL96aCQDvZIh+yQQ' 6-max Seat #3 is the button
Seat 1: iHo1oDbrEVJ8nEGdaPrICw ($148.50 in chips)
Seat 2: KpnW5CcJ4Mg6MeclfKmLrw ($102 in chips)
Seat 3: PXT6kJgVX67c3EgncNqRoA ($51.45 in chips)
Seat 4: uCqEjnxh2/vFBjKYkfTOkw ($156.20 in chips)
Seat 5: rHlMOfR7kpQQxe+PFQz0xQ ($37 in chips)
uCqEjnxh2/vFBjKYkfTOkw: posts small blind $0.50
rHlMOfR7kpQQxe+PFQz0xQ: posts big blind $1
*** HOLE CARDS ***
iHo1oDbrEVJ8nEGdaPrICw: folds
TSuRyAHnUPCFjP7Z0rEE0w has returned
TSuRyAHnUPCFjP7Z0rEE0w is sitting out
TSuRyAHnUPCFjP7Z0rEE0w has returned
KpnW5CcJ4Mg6MeclfKmLrw has timed out
KpnW5CcJ4Mg6MeclfKmLrw: folds
KpnW5CcJ4Mg6MeclfKmLrw is sitting out
PXT6kJgVX67c3EgncNqRoA: folds
KpnW5CcJ4Mg6MeclfKmLrw has returned
uCqEjnxh2/vFBjKYkfTOkw: calls $0.50
rHlMOfR7kpQQxe+PFQz0xQ: checks
*** FLOP *** [5s Kd 3d]
uCqEjnxh2/vFBjKYkfTOkw: checks
rHlMOfR7kpQQxe+PFQz0xQ: bets $1
uCqEjnxh2/vFBjKYkfTOkw: folds
rHlMOfR7kpQQxe+PFQz0xQ collected $1.90 from pot
rHlMOfR7kpQQxe+PFQz0xQ: doesn't show hand
*** SUMMARY ***
Total pot $2 | Rake $0.10
Board [5s Kd 3d]
Seat 1: iHo1oDbrEVJ8nEGdaPrICw folded before Flop (didn't bet)
Seat 2: KpnW5CcJ4Mg6MeclfKmLrw folded before Flop (didn't bet)
Seat 3: PXT6kJgVX67c3EgncNqRoA (button) folded before Flop (didn't bet)
Seat 4: uCqEjnxh2/vFBjKYkfTOkw (small blind) folded on the Flop
Seat 5: rHlMOfR7kpQQxe+PFQz0xQ (big blind) collected ($1.90)



PokerStars Game #59938741252:  Hold'em No Limit ($0.50/$1.00) - 2009/07/01 0:22:20 ET
Table 'blHlQApStil0OPeQxQxPcwFKpXUINE6M3UxHG4zaMhHAx Seat #6 is the button
Seat 1: x80+i7DJL+81v3quj7KbNg ($24.15 in chips)
Seat 2: wIZ377kjl2fHFGnS93o6bw ($35.50 in chips)
Seat 3: o1axyw4AjQ8n4ubTwlirQQ ($26.20 in chips)
Seat 4: zanka7aAZkigmZpfopXxxA ($35.30 in chips)
Seat 5: uXrDE6JrIi8BZK1L8oQ9bQ ($18.50 in chips)
Seat 6: JPQzLacMGzeh42mPgyrvVQ ($81.70 in chips)
Seat 7: vR4IO10geOgvTW+LAUBv/A ($110 in chips)
Seat 8: VtjmCz/ASIcETatNJ8YcCA ($59.65 in chips)
vR4IO10geOgvTW+LAUBv/A: posts small blind $0.50
VtjmCz/ASIcETatNJ8YcCA: posts big blind $1
*** HOLE CARDS ***
x80+i7DJL+81v3quj7KbNg: folds
wIZ377kjl2fHFGnS93o6bw: folds
x80+i7DJL+81v3quj7KbNg leaves the table
o1axyw4AjQ8n4ubTwlirQQ: folds
zanka7aAZkigmZpfopXxxA: folds
uXrDE6JrIi8BZK1L8oQ9bQ: folds
JPQzLacMGzeh42mPgyrvVQ: raises $2 to $3
vR4IO10geOgvTW+LAUBv/A: folds
VtjmCz/ASIcETatNJ8YcCA: calls $2
*** FLOP *** [Tc Qc Kh]
VtjmCz/ASIcETatNJ8YcCA: bets $6
JPQzLacMGzeh42mPgyrvVQ: calls $6
*** TURN *** [Tc Qc Kh] [6c]
VtjmCz/ASIcETatNJ8YcCA: bets $10
JPQzLacMGzeh42mPgyrvVQ: calls $10
*** RIVER *** [Tc Qc Kh 6c] [6d]
VtjmCz/ASIcETatNJ8YcCA: bets $20
JPQzLacMGzeh42mPgyrvVQ: calls $20
*** SHOW DOWN ***
VtjmCz/ASIcETatNJ8YcCA: shows [9c Qh] (two pair, Queens and Sixes)
JPQzLacMGzeh42mPgyrvVQ: shows [Js As] (a straight, Ten to Ace)
JPQzLacMGzeh42mPgyrvVQ collected $75.50 from pot
*** SUMMARY ***
Total pot $78.50 | Rake $3
Board [Tc Qc Kh 6c 6d]
Seat 1: x80+i7DJL+81v3quj7KbNg folded before Flop (didn't bet)
Seat 2: wIZ377kjl2fHFGnS93o6bw folded before Flop (didn't bet)
Seat 3: o1axyw4AjQ8n4ubTwlirQQ folded before Flop (didn't bet)
Seat 4: zanka7aAZkigmZpfopXxxA folded before Flop (didn't bet)
Seat 5: uXrDE6JrIi8BZK1L8oQ9bQ folded before Flop (didn't bet)
Seat 6: JPQzLacMGzeh42mPgyrvVQ (button) showed [Js As] and won ($75.50) with a straight, Ten to Ace
Seat 7: vR4IO10geOgvTW+LAUBv/A (small blind) folded before Flop
Seat 8: VtjmCz/ASIcETatNJ8YcCA (big blind) showed [9c Qh] and lost with two pair, Queens and Sixes



PokerStars Game #59938743138:  Hold'em No Limit ($0.50/$1.00) - 2009/07/01 0:22:23 ET
Table 'Zka9tv1yilg0MvXWPQrShg' 9-max Seat #6 is the button
Seat 1: TZcz9MEWDA+WydgGruqqbw ($100 in chips)
Seat 2: zBHLwg+HmbHmRtVQMhavjA ($105.55 in chips)
Seat 3: gUUvmqdVlmvpal6B8nYrmg ($100 in chips)
Seat 4: CTOae+JLIGfwfXvhqHkP2w ($187.15 in chips)
Seat 5: /zy+DB4S5fUQUSfZWFzYGw ($141.45 in chips)
Seat 6: rY8wPoax1lS+HUY+I0FZDw ($128.40 in chips)
Seat 7: p1SafS90nb3Uft5LB0NkHw ($20.50 in chips)
Seat 8: bL+QVeDcuEdzMGAGg2XJHg ($126.10 in chips)
Seat 9: SlhHwZrXCVifyCHK+qz1Kw ($100.45 in chips)
p1SafS90nb3Uft5LB0NkHw: posts small blind $0.50
bL+QVeDcuEdzMGAGg2XJHg: posts big blind $1
*** HOLE CARDS ***
SlhHwZrXCVifyCHK+qz1Kw: folds
TZcz9MEWDA+WydgGruqqbw: folds
zBHLwg+HmbHmRtVQMhavjA: folds
gUUvmqdVlmvpal6B8nYrmg: folds
CTOae+JLIGfwfXvhqHkP2w: folds
/zy+DB4S5fUQUSfZWFzYGw: folds
rY8wPoax1lS+HUY+I0FZDw: folds
p1SafS90nb3Uft5LB0NkHw: raises $2 to $3
bL+QVeDcuEdzMGAGg2XJHg: folds
p1SafS90nb3Uft5LB0NkHw collected $2 from pot
p1SafS90nb3Uft5LB0NkHw: doesn't show hand
*** SUMMARY ***
Total pot $2 | Rake $0
Seat 1: TZcz9MEWDA+WydgGruqqbw folded before Flop (didn't bet)
Seat 2: zBHLwg+HmbHmRtVQMhavjA folded before Flop (didn't bet)
Seat 3: gUUvmqdVlmvpal6B8nYrmg folded before Flop (didn't bet)
Seat 4: CTOae+JLIGfwfXvhqHkP2w folded before Flop (didn't bet)
Seat 5: /zy+DB4S5fUQUSfZWFzYGw folded before Flop (didn't bet)
Seat 6: rY8wPoax1lS+HUY+I0FZDw (button) folded before Flop (didn't bet)
Seat 7: p1SafS90nb3Uft5LB0NkHw (small blind) collected ($2)
Seat 8: bL+QVeDcuEdzMGAGg2XJHg (big blind) folded before Flop
Seat 9: SlhHwZrXCVifyCHK+qz1Kw folded before Flop (didn't bet)



PokerStars Game #59938743980:  Hold'em No Limit ($0.50/$1.00) - 2009/07/01 0:22:24 ET
Table 'cBDNutyLBKEk9+ptwsKmTw' 6-max Seat #2 is the button
Seat 1: tb0dt30qP2x/8f+Xta4mVg ($20.80 in chips)
Seat 2: KyaE4+hWgUNIWWOWy4D14w ($59.30 in chips)
Seat 3: G5ZSSN6RSON3gkNvk/SmYg ($106.40 in chips)
Seat 4: 0WjiuIT7/EolY1oOx1ngeA ($107.65 in chips)
Seat 5: OGMLOcTNYZXZU81au7ztUw ($111.20 in chips)
Seat 6: pyzhFUPPSNzrysiMqlA5Xw ($13.10 in chips)
G5ZSSN6RSON3gkNvk/SmYg: posts small blind $0.50
0WjiuIT7/EolY1oOx1ngeA: posts big blind $1
*** HOLE CARDS ***
OGMLOcTNYZXZU81au7ztUw: folds
pyzhFUPPSNzrysiMqlA5Xw: folds
tb0dt30qP2x/8f+Xta4mVg: folds
KyaE4+hWgUNIWWOWy4D14w: folds
G5ZSSN6RSON3gkNvk/SmYg: folds
0WjiuIT7/EolY1oOx1ngeA collected $1 from pot
0WjiuIT7/EolY1oOx1ngeA: doesn't show hand
*** SUMMARY ***
Total pot $1 | Rake $0
Seat 1: tb0dt30qP2x/8f+Xta4mVg folded before Flop (didn't bet)
Seat 2: KyaE4+hWgUNIWWOWy4D14w (button) folded before Flop (didn't bet)
Seat 3: G5ZSSN6RSON3gkNvk/SmYg (small blind) folded before Flop
Seat 4: 0WjiuIT7/EolY1oOx1ngeA (big blind) collected ($1)
Seat 5: OGMLOcTNYZXZU81au7ztUw folded before Flop (didn't bet)
Seat 6: pyzhFUPPSNzrysiMqlA5Xw folded before Flop (didn't bet)



PokerStars Game #59938744306:  Hold'em No Limit ($0.50/$1.00) - 2009/07/01 0:22:24 ET
Table 'aWHveb63HkbTmOGHOxjBkQ' 2-max Seat #2 is the button
Seat 1: xy2MQKoHoCZZIudmw8Xbow ($237.80 in chips)
Seat 2: xstEKavv3YDxpUnU4e9qAQ ($136.10 in chips)
xstEKavv3YDxpUnU4e9qAQ: posts small blind $0.50
xy2MQKoHoCZZIudmw8Xbow: posts big blind $1
*** HOLE CARDS ***
xstEKavv3YDxpUnU4e9qAQ: folds
xy2MQKoHoCZZIudmw8Xbow collected $1 from pot
xy2MQKoHoCZZIudmw8Xbow: doesn't show hand
*** SUMMARY ***
Total pot $1 | Rake $0
Seat 1: xy2MQKoHoCZZIudmw8Xbow (big blind) collected ($1)
Seat 2: xstEKavv3YDxpUnU4e9qAQ (button) (small blind) folded before Flop



PokerStars Game #59938745520:  Hold'em No Limit ($0.50/$1.00) - 2009/07/01 0:22:26 ET
Table '/FUb199IViHMJHi5YWmeuQ' 9-max Seat #2 is the button
Seat 1: TZcz9MEWDA+WydgGruqqbw ($100 in chips)
Seat 2: FL3MrLspcF23LYvC4ipBOA ($132.25 in chips)
Seat 3: qN483QJ1NvHbdIZB7J4ARw ($74.25 in chips)
Seat 4: qheQay5YvP2DMAb3OUSxtw ($107.30 in chips)
Seat 5: +za1iHiRgVo4OcAz0SOZqw ($16.95 in chips)
Seat 7: atVaKXE/AQGa798rpMF/Bg ($17 in chips)
Seat 8: QIWvt0R766g8KfH0vl1s0A ($58.10 in chips)
Seat 9: knewtTmBc4Tc0z/5tAABYQ ($114.65 in chips)
qN483QJ1NvHbdIZB7J4ARw: posts small blind $0.50
qheQay5YvP2DMAb3OUSxtw: posts big blind $1
*** HOLE CARDS ***
+za1iHiRgVo4OcAz0SOZqw: folds
atVaKXE/AQGa798rpMF/Bg: folds
QIWvt0R766g8KfH0vl1s0A: calls $1
knewtTmBc4Tc0z/5tAABYQ: raises $4 to $5
TZcz9MEWDA+WydgGruqqbw: folds
FL3MrLspcF23LYvC4ipBOA: folds
qN483QJ1NvHbdIZB7J4ARw: folds
qheQay5YvP2DMAb3OUSxtw: folds
QIWvt0R766g8KfH0vl1s0A: calls $4
*** FLOP *** [Qc Td 2d]
QIWvt0R766g8KfH0vl1s0A: bets $4
knewtTmBc4Tc0z/5tAABYQ: raises $8 to $12
QIWvt0R766g8KfH0vl1s0A: folds
ccFf7Q4z1cTGQmeoYiWEfw joins the table at seat #6
knewtTmBc4Tc0z/5tAABYQ collected $18.60 from pot
knewtTmBc4Tc0z/5tAABYQ: doesn't show hand
*** SUMMARY ***
Total pot $19.50 | Rake $0.90
Board [Qc Td 2d]
Seat 1: TZcz9MEWDA+WydgGruqqbw folded before Flop (didn't bet)
Seat 2: FL3MrLspcF23LYvC4ipBOA (button) folded before Flop (didn't bet)
Seat 3: qN483QJ1NvHbdIZB7J4ARw (small blind) folded before Flop
Seat 4: qheQay5YvP2DMAb3OUSxtw (big blind) folded before Flop
Seat 5: +za1iHiRgVo4OcAz0SOZqw folded before Flop (didn't bet)
Seat 7: atVaKXE/AQGa798rpMF/Bg folded before Flop (didn't bet)
Seat 8: QIWvt0R766g8KfH0vl1s0A folded on the Flop
Seat 9: knewtTmBc4Tc0z/5tAABYQ collected ($18.60)



PokerStars Game #59938745340:  Hold'em No Limit ($0.50/$1.00) - 2009/07/01 0:22:26 ET
Table 'vs/5jr6ciwjVQ5+Soc+u2A' 6-max Seat #3 is the button
Seat 2: XOIf9W+VAxhZqN+SYoyMKA ($115.80 in chips)
Seat 3: G5ZSSN6RSON3gkNvk/SmYg ($102.20 in chips)
Seat 4: KpnW5CcJ4Mg6MeclfKmLrw ($105.15 in chips)
Seat 5: 7Vc9JmGFQwMRh5Tj9ui5Lw ($98.65 in chips)
Seat 6: QHvTZcrKe6+maWUfVjP29Q ($100 in chips)
KpnW5CcJ4Mg6MeclfKmLrw: posts small blind $0.50
7Vc9JmGFQwMRh5Tj9ui5Lw: posts big blind $1
*** HOLE CARDS ***
QHvTZcrKe6+maWUfVjP29Q: folds
XOIf9W+VAxhZqN+SYoyMKA: folds
G5ZSSN6RSON3gkNvk/SmYg: folds
KpnW5CcJ4Mg6MeclfKmLrw: folds
7Vc9JmGFQwMRh5Tj9ui5Lw collected $1 from pot
7Vc9JmGFQwMRh5Tj9ui5Lw: doesn't show hand
*** SUMMARY ***
Total pot $1 | Rake $0
Seat 2: XOIf9W+VAxhZqN+SYoyMKA folded before Flop (didn't bet)
Seat 3: G5ZSSN6RSON3gkNvk/SmYg (button) folded before Flop (didn't bet)
Seat 4: KpnW5CcJ4Mg6MeclfKmLrw (small blind) folded before Flop
Seat 5: 7Vc9JmGFQwMRh5Tj9ui5Lw (big blind) collected ($1)
Seat 6: QHvTZcrKe6+maWUfVjP29Q folded before Flop (didn't bet)



PokerStars Game #59938745960:  Hold'em No Limit ($0.50/$1.00) - 2009/07/01 0:22:27 ET
Table 'MUPc8FEpe/nR0BKSeReX6Q' 6-max Seat #5 is the button
Seat 1: YsLQ3BAvgQHWXMAv3Wv6Hg ($100.50 in chips)
Seat 3: wx3sQGkVi2x9wJXuWNHPBw ($235.55 in chips)
Seat 4: ZA1bp6g8IwtTxkUE4eCjDQ ($111.15 in chips)
Seat 5: UBZQqpnJZdTYYY1FTb0rLA ($101.50 in chips)
Seat 6: oxnw0GLLpFanjhGkxfRSqA ($51.90 in chips)
oxnw0GLLpFanjhGkxfRSqA: posts small blind $0.50
YsLQ3BAvgQHWXMAv3Wv6Hg: posts big blind $1
*** HOLE CARDS ***
wx3sQGkVi2x9wJXuWNHPBw: folds
ZA1bp6g8IwtTxkUE4eCjDQ: raises $1 to $2
UBZQqpnJZdTYYY1FTb0rLA: folds
oxnw0GLLpFanjhGkxfRSqA: folds
YsLQ3BAvgQHWXMAv3Wv6Hg: calls $1
*** FLOP *** [7d 8s 3h]
esuark2007 leaves the table
YsLQ3BAvgQHWXMAv3Wv6Hg: checks
ZA1bp6g8IwtTxkUE4eCjDQ: bets $3
YsLQ3BAvgQHWXMAv3Wv6Hg: folds
xAU6q2/cwmby2sxmA8VcmA joins the table at seat #2
ZA1bp6g8IwtTxkUE4eCjDQ collected $4.30 from pot
ZA1bp6g8IwtTxkUE4eCjDQ: doesn't show hand
*** SUMMARY ***
Total pot $4.50 | Rake $0.20
Board [7d 8s 3h]
Seat 1: YsLQ3BAvgQHWXMAv3Wv6Hg (big blind) folded on the Flop
Seat 3: wx3sQGkVi2x9wJXuWNHPBw folded before Flop (didn't bet)
Seat 4: ZA1bp6g8IwtTxkUE4eCjDQ collected ($4.30)
Seat 5: UBZQqpnJZdTYYY1FTb0rLA (button) folded before Flop (didn't bet)
Seat 6: oxnw0GLLpFanjhGkxfRSqA (small blind) folded before Flop



PokerStars Game #59938747672:  Hold'em No Limit ($0.50/$1.00) - 2009/07/01 0:22:30 ET
Table 'W/wyObTiXZm+Ckkl3YxcSw' 6-max Seat #1 is the button
Seat 1: ssLJburtEIqnVkx6X8R1uw ($117.25 in chips)
Seat 2: oDiBRCaF0QVtd3kO6xZIXw ($100.50 in chips)
Seat 3: b2a+5TkFf4xJN/Ihhma58Q ($38.20 in chips)
Seat 4: BdbmJTZZ47quA9vUWwXtlw ($50.10 in chips)
Seat 5: Wko+clJG9HZPPQ7Yn0Y5Zg ($26.75 in chips)
oDiBRCaF0QVtd3kO6xZIXw: posts small blind $0.50
b2a+5TkFf4xJN/Ihhma58Q: posts big blind $1
1yB1nHUkHNNY8OJnDNHZMw: sits out
*** HOLE CARDS ***
BdbmJTZZ47quA9vUWwXtlw: folds
Wko+clJG9HZPPQ7Yn0Y5Zg: raises $2 to $3
ssLJburtEIqnVkx6X8R1uw: folds
oDiBRCaF0QVtd3kO6xZIXw: raises $9 to $12
b2a+5TkFf4xJN/Ihhma58Q: folds
Wko+clJG9HZPPQ7Yn0Y5Zg: raises $14.75 to $26.75 and is all-in
oDiBRCaF0QVtd3kO6xZIXw: calls $14.75
*** FLOP *** [Kc 5s Ts]
*** TURN *** [Kc 5s Ts] [Td]
*** RIVER *** [Kc 5s Ts Td] [6s]
*** SHOW DOWN ***
oDiBRCaF0QVtd3kO6xZIXw: shows [Qd As] (a pair of Tens)
Wko+clJG9HZPPQ7Yn0Y5Zg: shows [Ah Qh] (a pair of Tens)
oDiBRCaF0QVtd3kO6xZIXw collected $26.25 from pot
Wko+clJG9HZPPQ7Yn0Y5Zg collected $26.25 from pot
*** SUMMARY ***
Total pot $54.50 | Rake $2
Board [Kc 5s Ts Td 6s]
Seat 1: ssLJburtEIqnVkx6X8R1uw (button) folded before Flop (didn't bet)
Seat 2: oDiBRCaF0QVtd3kO6xZIXw (small blind) showed [Qd As] and won ($26.25) with a pair of Tens
Seat 3: b2a+5TkFf4xJN/Ihhma58Q (big blind) folded before Flop
Seat 4: BdbmJTZZ47quA9vUWwXtlw folded before Flop (didn't bet)
Seat 5: Wko+clJG9HZPPQ7Yn0Y5Zg showed [Ah Qh] and won ($26.25) with a pair of Tens



PokerStars Game #59938747714:  Hold'em No Limit ($0.50/$1.00) - 2009/07/01 0:22:30 ET
Table 'aWHveb63HkbTmOGHOxjBkQ' 2-max Seat #1 is the button
Seat 1: xy2MQKoHoCZZIudmw8Xbow ($238.30 in chips)
Seat 2: xstEKavv3YDxpUnU4e9qAQ ($135.60 in chips)
xy2MQKoHoCZZIudmw8Xbow: posts small blind $0.50
xstEKavv3YDxpUnU4e9qAQ: posts big blind $1
*** HOLE CARDS ***
xy2MQKoHoCZZIudmw8Xbow: raises $3 to $4
xstEKavv3YDxpUnU4e9qAQ: folds
xy2MQKoHoCZZIudmw8Xbow collected $2 from pot
xy2MQKoHoCZZIudmw8Xbow: doesn't show hand
*** SUMMARY ***
Total pot $2 | Rake $0
Seat 1: xy2MQKoHoCZZIudmw8Xbow (button) (small blind) collected ($2)
Seat 2: xstEKavv3YDxpUnU4e9qAQ (big blind) folded before Flop



PokerStars Game #59938752134:  Hold'em No Limit ($0.50/$1.00) - 2009/07/01 0:22:36 ET
Table 'aWHveb63HkbTmOGHOxjBkQ' 2-max Seat #2 is the button
Seat 1: xy2MQKoHoCZZIudmw8Xbow ($239.30 in chips)
Seat 2: xstEKavv3YDxpUnU4e9qAQ ($134.60 in chips)
xstEKavv3YDxpUnU4e9qAQ: posts small blind $0.50
xy2MQKoHoCZZIudmw8Xbow: posts big blind $1
*** HOLE CARDS ***
xstEKavv3YDxpUnU4e9qAQ: folds
xy2MQKoHoCZZIudmw8Xbow collected $1 from pot
xy2MQKoHoCZZIudmw8Xbow: doesn't show hand
*** SUMMARY ***
Total pot $1 | Rake $0
Seat 1: xy2MQKoHoCZZIudmw8Xbow (big blind) collected ($1)
Seat 2: xstEKavv3YDxpUnU4e9qAQ (button) (small blind) folded before Flop



PokerStars Game #59938754248:  Hold'em No Limit ($0.50/$1.00) - 2009/07/01 0:22:40 ET
Table 'b/mVBMBBjZR4F+Jsv8cuYA' 9-max Seat #6 is the button
Seat 1: 0bFSG2wtTalRoQW05hZ/uw ($39.70 in chips)
Seat 2: HPmAhANyB1+4MGzYS9i5Wg ($52.60 in chips)
Seat 3: x80+i7DJL+81v3quj7KbNg ($20 in chips)
Seat 4: 0oXWlMUwwWciWdZOQf6yUw ($128.95 in chips)
Seat 5: p5UKaxVobvptF0ANhR/q1A ($91.70 in chips)
Seat 6: FL3MrLspcF23LYvC4ipBOA ($316.10 in chips)
Seat 7: 5GtqC1O4Y1t1VmP51SDSJQ ($59 in chips)
Seat 8: L9njYvloJ1NdXjP8edHEAg ($102.50 in chips)
Seat 9: 9BZCcac3+McErkkSN2YScA ($113.95 in chips)
5GtqC1O4Y1t1VmP51SDSJQ: posts small blind $0.50
L9njYvloJ1NdXjP8edHEAg: posts big blind $1
*** HOLE CARDS ***
9BZCcac3+McErkkSN2YScA: folds
0bFSG2wtTalRoQW05hZ/uw: folds
0bFSG2wtTalRoQW05hZ/uw leaves the table
HPmAhANyB1+4MGzYS9i5Wg: calls $1
x80+i7DJL+81v3quj7KbNg: folds
0oXWlMUwwWciWdZOQf6yUw: calls $1
p5UKaxVobvptF0ANhR/q1A: folds
FL3MrLspcF23LYvC4ipBOA: folds
5GtqC1O4Y1t1VmP51SDSJQ: raises $2 to $3
Ogn4JDV3mp4ZDKO49IFzKA joins the table at seat #1
L9njYvloJ1NdXjP8edHEAg: folds
HPmAhANyB1+4MGzYS9i5Wg: calls $2
0oXWlMUwwWciWdZOQf6yUw: calls $2
*** FLOP *** [Jc 2c 7d]
5GtqC1O4Y1t1VmP51SDSJQ: bets $6
HPmAhANyB1+4MGzYS9i5Wg: calls $6
0oXWlMUwwWciWdZOQf6yUw: calls $6
*** TURN *** [Jc 2c 7d] [Th]
5GtqC1O4Y1t1VmP51SDSJQ: bets $10
HPmAhANyB1+4MGzYS9i5Wg: calls $10
0oXWlMUwwWciWdZOQf6yUw: calls $10
*** RIVER *** [Jc 2c 7d Th] [2d]
5GtqC1O4Y1t1VmP51SDSJQ: bets $10
HPmAhANyB1+4MGzYS9i5Wg: folds
0oXWlMUwwWciWdZOQf6yUw: calls $10
*** SHOW DOWN ***
5GtqC1O4Y1t1VmP51SDSJQ: shows [Ac Jh] (two pair, Jacks and Deuces)
0oXWlMUwwWciWdZOQf6yUw: mucks hand
5GtqC1O4Y1t1VmP51SDSJQ collected $75 from pot
*** SUMMARY ***
Total pot $78 | Rake $3
Board [Jc 2c 7d Th 2d]
Seat 1: 0bFSG2wtTalRoQW05hZ/uw folded before Flop (didn't bet)
Seat 2: HPmAhANyB1+4MGzYS9i5Wg folded on the River
Seat 3: x80+i7DJL+81v3quj7KbNg folded before Flop (didn't bet)
Seat 4: 0oXWlMUwwWciWdZOQf6yUw mucked
Seat 5: p5UKaxVobvptF0ANhR/q1A folded before Flop (didn't bet)
Seat 6: FL3MrLspcF23LYvC4ipBOA (button) folded before Flop (didn't bet)
Seat 7: 5GtqC1O4Y1t1VmP51SDSJQ (small blind) showed [Ac Jh] and won ($75) with two pair, Jacks and Deuces
Seat 8: L9njYvloJ1NdXjP8edHEAg (big blind) folded before Flop
Seat 9: 9BZCcac3+McErkkSN2YScA folded before Flop (didn't bet)



PokerStars Game #59938755032:  Hold'em No Limit ($0.50/$1.00) - 2009/07/01 0:22:41 ET
Table 'hugOjcwJvzEwZbK7tyiWuQ' 9-max Seat #8 is the button
Seat 1: N9n5Wc3s35DpCrOAUUNAaQ ($127.85 in chips)
Seat 2: r27C1nIV4NS4+qbnrgBQSw ($257.05 in chips)
Seat 3: jDwhY1kCdc6EkAHbT7PJMQ ($106.55 in chips)
Seat 4: UWB3oeddt/GObx2Mix2Anw ($195.20 in chips)
Seat 6: gUUvmqdVlmvpal6B8nYrmg ($102.30 in chips)
Seat 7: FL3MrLspcF23LYvC4ipBOA ($100 in chips)
Seat 8: /zy+DB4S5fUQUSfZWFzYGw ($113.25 in chips)
Seat 9: o6JyUkbzCDw8tUabqtmnlg ($61.60 in chips)
o6JyUkbzCDw8tUabqtmnlg: posts small blind $0.50
N9n5Wc3s35DpCrOAUUNAaQ: posts big blind $1
*** HOLE CARDS ***
r27C1nIV4NS4+qbnrgBQSw: folds
jDwhY1kCdc6EkAHbT7PJMQ: raises $3 to $4
UWB3oeddt/GObx2Mix2Anw: folds
gUUvmqdVlmvpal6B8nYrmg: folds
FL3MrLspcF23LYvC4ipBOA: folds
/zy+DB4S5fUQUSfZWFzYGw: folds
o6JyUkbzCDw8tUabqtmnlg: folds
N9n5Wc3s35DpCrOAUUNAaQ: folds
jDwhY1kCdc6EkAHbT7PJMQ collected $2.50 from pot
*** SUMMARY ***
Total pot $2.50 | Rake $0
Seat 1: N9n5Wc3s35DpCrOAUUNAaQ (big blind) folded before Flop
Seat 2: r27C1nIV4NS4+qbnrgBQSw folded before Flop (didn't bet)
Seat 3: jDwhY1kCdc6EkAHbT7PJMQ collected ($2.50)
Seat 4: UWB3oeddt/GObx2Mix2Anw folded before Flop (didn't bet)
Seat 6: gUUvmqdVlmvpal6B8nYrmg folded before Flop (didn't bet)
Seat 7: FL3MrLspcF23LYvC4ipBOA folded before Flop (didn't bet)
Seat 8: /zy+DB4S5fUQUSfZWFzYGw (button) folded before Flop (didn't bet)
Seat 9: o6JyUkbzCDw8tUabqtmnlg (small blind) folded before Flop



PokerStars Game #59938755712:  Hold'em No Limit ($0.50/$1.00) - 2009/07/01 0:22:42 ET
Table 'aWHveb63HkbTmOGHOxjBkQ' 2-max Seat #1 is the button
Seat 1: xy2MQKoHoCZZIudmw8Xbow ($239.80 in chips)
Seat 2: xstEKavv3YDxpUnU4e9qAQ ($134.10 in chips)
xy2MQKoHoCZZIudmw8Xbow: posts small blind $0.50
xstEKavv3YDxpUnU4e9qAQ: posts big blind $1
*** HOLE CARDS ***
xy2MQKoHoCZZIudmw8Xbow: raises $3 to $4
xstEKavv3YDxpUnU4e9qAQ: raises $8 to $12
xy2MQKoHoCZZIudmw8Xbow: folds
xstEKavv3YDxpUnU4e9qAQ collected $8 from pot
*** SUMMARY ***
Total pot $8 | Rake $0
Seat 1: xy2MQKoHoCZZIudmw8Xbow (button) (small blind) folded before Flop
Seat 2: xstEKavv3YDxpUnU4e9qAQ (big blind) collected ($8)



PokerStars Game #59938757570:  Hold'em No Limit ($0.50/$1.00) - 2009/07/01 0:22:45 ET
Table 'ZFWj23PMihdwrNWv41OG/Q' 9-max Seat #7 is the button
Seat 1: yAbu2QsRPVcjPbqlf/jDxw ($103.30 in chips)
Seat 2: ARfmgHcEUKh68laBZy4veA ($57.75 in chips)
Seat 3: G9Fo2TZCN7HI43Po4zSN3A ($100 in chips)
Seat 4: PEmogYqKpuv0ozeBbXL+7Q ($30 in chips)
Seat 6: tjhwe1V98x2spSoUQER3HQ ($100 in chips)
Seat 7: wIZ377kjl2fHFGnS93o6bw ($42.55 in chips)
Seat 8: knewtTmBc4Tc0z/5tAABYQ ($108 in chips)
knewtTmBc4Tc0z/5tAABYQ: posts small blind $0.50
atVaKXE/AQGa798rpMF/Bg: is sitting out
yAbu2QsRPVcjPbqlf/jDxw: posts big blind $1
tkdBeXTJlFsZdioidNqLow: sits out
*** HOLE CARDS ***
atVaKXE/AQGa798rpMF/Bg leaves the table
ARfmgHcEUKh68laBZy4veA: folds
G9Fo2TZCN7HI43Po4zSN3A: folds
PEmogYqKpuv0ozeBbXL+7Q: raises $4 to $5
tjhwe1V98x2spSoUQER3HQ: folds
wIZ377kjl2fHFGnS93o6bw: folds
knewtTmBc4Tc0z/5tAABYQ: folds
yAbu2QsRPVcjPbqlf/jDxw: folds
PEmogYqKpuv0ozeBbXL+7Q collected $2.50 from pot
*** SUMMARY ***
Total pot $2.50 | Rake $0
Seat 1: yAbu2QsRPVcjPbqlf/jDxw (big blind) folded before Flop
Seat 2: ARfmgHcEUKh68laBZy4veA folded before Flop (didn't bet)
Seat 3: G9Fo2TZCN7HI43Po4zSN3A folded before Flop (didn't bet)
Seat 4: PEmogYqKpuv0ozeBbXL+7Q collected ($2.50)
Seat 6: tjhwe1V98x2spSoUQER3HQ folded before Flop (didn't bet)
Seat 7: wIZ377kjl2fHFGnS93o6bw (button) folded before Flop (didn't bet)
Seat 8: knewtTmBc4Tc0z/5tAABYQ (small blind) folded before Flop



PokerStars Game #59938758648:  Hold'em No Limit ($0.50/$1.00) - 2009/07/01 0:22:46 ET
Table 'cBDNutyLBKEk9+ptwsKmTw' 6-max Seat #3 is the button
Seat 1: tb0dt30qP2x/8f+Xta4mVg ($20.80 in chips)
Seat 2: KyaE4+hWgUNIWWOWy4D14w ($59.30 in chips)
Seat 3: G5ZSSN6RSON3gkNvk/SmYg ($105.90 in chips)
Seat 4: 0WjiuIT7/EolY1oOx1ngeA ($108.15 in chips)
Seat 5: OGMLOcTNYZXZU81au7ztUw ($111.20 in chips)
Seat 6: pyzhFUPPSNzrysiMqlA5Xw ($13.10 in chips)
0WjiuIT7/EolY1oOx1ngeA: posts small blind $0.50
OGMLOcTNYZXZU81au7ztUw: posts big blind $1
*** HOLE CARDS ***
pyzhFUPPSNzrysiMqlA5Xw: folds
tb0dt30qP2x/8f+Xta4mVg: folds
KyaE4+hWgUNIWWOWy4D14w: raises $2 to $3
G5ZSSN6RSON3gkNvk/SmYg: folds
0WjiuIT7/EolY1oOx1ngeA: calls $2.50
OGMLOcTNYZXZU81au7ztUw: folds
*** FLOP *** [6s 7h Qd]
0WjiuIT7/EolY1oOx1ngeA: checks
KyaE4+hWgUNIWWOWy4D14w: bets $3
0WjiuIT7/EolY1oOx1ngeA: folds
KyaE4+hWgUNIWWOWy4D14w collected $6.65 from pot
*** SUMMARY ***
Total pot $7 | Rake $0.35
Board [6s 7h Qd]
Seat 1: tb0dt30qP2x/8f+Xta4mVg folded before Flop (didn't bet)
Seat 2: KyaE4+hWgUNIWWOWy4D14w collected ($6.65)
Seat 3: G5ZSSN6RSON3gkNvk/SmYg (button) folded before Flop (didn't bet)
Seat 4: 0WjiuIT7/EolY1oOx1ngeA (small blind) folded on the Flop
Seat 5: OGMLOcTNYZXZU81au7ztUw (big blind) folded before Flop
Seat 6: pyzhFUPPSNzrysiMqlA5Xw folded before Flop (didn't bet)



PokerStars Game #59938758524:  Hold'em No Limit ($0.50/$1.00) - 2009/07/01 0:22:46 ET
Table 'QSIig7BLMc9wY/rgBechzw' 6-max Seat #2 is the button
Seat 1: uuA9hpFU17U5/t4cvpbpBg ($43.40 in chips)
Seat 2: 0WjiuIT7/EolY1oOx1ngeA ($119.40 in chips)
Seat 3: +W6OnF033KNM2xH0fGj98Q ($110.70 in chips)
Seat 4: +uSzP8Jwnw7sKfQ4s66b7w ($48.50 in chips)
Seat 6: KpnW5CcJ4Mg6MeclfKmLrw ($144.25 in chips)
+W6OnF033KNM2xH0fGj98Q: posts small blind $0.50
+uSzP8Jwnw7sKfQ4s66b7w: posts big blind $1
bvU2ZjpVnszLCFVeWbxePg: sits out
*** HOLE CARDS ***
KpnW5CcJ4Mg6MeclfKmLrw: folds
uuA9hpFU17U5/t4cvpbpBg: calls $1
0WjiuIT7/EolY1oOx1ngeA: raises $5 to $6
+W6OnF033KNM2xH0fGj98Q: folds
+uSzP8Jwnw7sKfQ4s66b7w: folds
uuA9hpFU17U5/t4cvpbpBg: calls $5
*** FLOP *** [Jc Qc Ks]
uuA9hpFU17U5/t4cvpbpBg: checks
0WjiuIT7/EolY1oOx1ngeA: checks
*** TURN *** [Jc Qc Ks] [7h]
uuA9hpFU17U5/t4cvpbpBg: checks
0WjiuIT7/EolY1oOx1ngeA: bets $8
uuA9hpFU17U5/t4cvpbpBg: folds
0WjiuIT7/EolY1oOx1ngeA collected $12.85 from pot
0WjiuIT7/EolY1oOx1ngeA: doesn't show hand
*** SUMMARY ***
Total pot $13.50 | Rake $0.65
Board [Jc Qc Ks 7h]
Seat 1: uuA9hpFU17U5/t4cvpbpBg folded on the Turn
Seat 2: 0WjiuIT7/EolY1oOx1ngeA (button) collected ($12.85)
Seat 3: +W6OnF033KNM2xH0fGj98Q (small blind) folded before Flop
Seat 4: +uSzP8Jwnw7sKfQ4s66b7w (big blind) folded before Flop
Seat 6: KpnW5CcJ4Mg6MeclfKmLrw folded before Flop (didn't bet)



PokerStars Game #59938758912:  Hold'em No Limit ($0.50/$1.00) - 2009/07/01 0:22:46 ET
Table 'O96CPOtvMBWP6kzuYDfdFA' 6-max Seat #3 is the button
Seat 1: yl9aRDw7k/ieGiDoJVy+/w ($66.05 in chips)
Seat 2: vTUNrd/7qIOJpW0suEu5hQ ($210.90 in chips)
Seat 3: V89DGjxE171oPREEbAXiyg ($37.75 in chips)
Seat 5: wRxiu9OJzvvN84OYWW9jxQ ($119.85 in chips)
Seat 6: xNKcQzD9+/iHmtJn4vYq9w ($80 in chips)
wRxiu9OJzvvN84OYWW9jxQ: posts small blind $0.50
xNKcQzD9+/iHmtJn4vYq9w: posts big blind $1
*** HOLE CARDS ***
yl9aRDw7k/ieGiDoJVy+/w: calls $1
vTUNrd/7qIOJpW0suEu5hQ: folds
V89DGjxE171oPREEbAXiyg: calls $1
wRxiu9OJzvvN84OYWW9jxQ: calls $0.50
xNKcQzD9+/iHmtJn4vYq9w: raises $8 to $9
yl9aRDw7k/ieGiDoJVy+/w: calls $8
V89DGjxE171oPREEbAXiyg: calls $8
wRxiu9OJzvvN84OYWW9jxQ: folds
*** FLOP *** [5d Qd 7h]
xNKcQzD9+/iHmtJn4vYq9w: bets $21
yl9aRDw7k/ieGiDoJVy+/w: folds
V89DGjxE171oPREEbAXiyg: folds
xNKcQzD9+/iHmtJn4vYq9w collected $26.60 from pot
*** SUMMARY ***
Total pot $28 | Rake $1.40
Board [5d Qd 7h]
Seat 1: yl9aRDw7k/ieGiDoJVy+/w folded on the Flop
Seat 2: vTUNrd/7qIOJpW0suEu5hQ folded before Flop (didn't bet)
Seat 3: V89DGjxE171oPREEbAXiyg (button) folded on the Flop
Seat 5: wRxiu9OJzvvN84OYWW9jxQ (small blind) folded before Flop
Seat 6: xNKcQzD9+/iHmtJn4vYq9w (big blind) collected ($26.60)



PokerStars Game #59938759268:  Hold'em No Limit ($0.50/$1.00) - 2009/07/01 0:22:47 ET
Table 'GxCPo/gd3OSthkYrAxJngg' 6-max Seat #3 is the button
Seat 1: sH8BpAFP+jGFxCgVpD1Lew ($179.45 in chips)
Seat 2: YExX2paeIHrmfIwV1ivM/w ($85.20 in chips)
Seat 3: h2lYnlZ7Ueu3PsyB2UOfSQ ($98.50 in chips)
Seat 4: YMJG+F++3Aj6P8dAWda5fw ($107.15 in chips)
Seat 5: G5ZSSN6RSON3gkNvk/SmYg ($100 in chips)
Seat 6: sS9IXedL3MiRmpVXhAILhw ($100 in chips)
YMJG+F++3Aj6P8dAWda5fw: posts small blind $0.50
G5ZSSN6RSON3gkNvk/SmYg: posts big blind $1
*** HOLE CARDS ***
sS9IXedL3MiRmpVXhAILhw: folds
sH8BpAFP+jGFxCgVpD1Lew: raises $3 to $4
YExX2paeIHrmfIwV1ivM/w: folds
h2lYnlZ7Ueu3PsyB2UOfSQ: folds
YMJG+F++3Aj6P8dAWda5fw: folds
G5ZSSN6RSON3gkNvk/SmYg: folds
sH8BpAFP+jGFxCgVpD1Lew collected $2.50 from pot
*** SUMMARY ***
Total pot $2.50 | Rake $0
Seat 1: sH8BpAFP+jGFxCgVpD1Lew collected ($2.50)
Seat 2: YExX2paeIHrmfIwV1ivM/w folded before Flop (didn't bet)
Seat 3: h2lYnlZ7Ueu3PsyB2UOfSQ (button) folded before Flop (didn't bet)
Seat 4: YMJG+F++3Aj6P8dAWda5fw (small blind) folded before Flop
Seat 5: G5ZSSN6RSON3gkNvk/SmYg (big blind) folded before Flop
Seat 6: sS9IXedL3MiRmpVXhAILhw folded before Flop (didn't bet)



PokerStars Game #59938762122:  Hold'em No Limit ($0.50/$1.00) - 2009/07/01 0:22:51 ET
Table 'aWHveb63HkbTmOGHOxjBkQ' 2-max Seat #2 is the button
Seat 1: xy2MQKoHoCZZIudmw8Xbow ($235.80 in chips)
Seat 2: xstEKavv3YDxpUnU4e9qAQ ($138.10 in chips)
xstEKavv3YDxpUnU4e9qAQ: posts small blind $0.50
xy2MQKoHoCZZIudmw8Xbow: posts big blind $1
*** HOLE CARDS ***
xstEKavv3YDxpUnU4e9qAQ: folds
xy2MQKoHoCZZIudmw8Xbow collected $1 from pot
xy2MQKoHoCZZIudmw8Xbow: doesn't show hand
*** SUMMARY ***
Total pot $1 | Rake $0
Seat 1: xy2MQKoHoCZZIudmw8Xbow (big blind) collected ($1)
Seat 2: xstEKavv3YDxpUnU4e9qAQ (button) (small blind) folded before Flop



PokerStars Game #59938762918:  Hold'em No Limit ($0.50/$1.00) - 2009/07/01 0:22:52 ET
Table 'MUPc8FEpe/nR0BKSeReX6Q' 6-max Seat #6 is the button
Seat 1: YsLQ3BAvgQHWXMAv3Wv6Hg ($100 in chips)
Seat 2: xAU6q2/cwmby2sxmA8VcmA ($100 in chips)
Seat 3: wx3sQGkVi2x9wJXuWNHPBw ($235.55 in chips)
Seat 4: ZA1bp6g8IwtTxkUE4eCjDQ ($113.45 in chips)
Seat 5: UBZQqpnJZdTYYY1FTb0rLA ($101.50 in chips)
Seat 6: oxnw0GLLpFanjhGkxfRSqA ($51.40 in chips)
YsLQ3BAvgQHWXMAv3Wv6Hg: posts small blind $0.50
xAU6q2/cwmby2sxmA8VcmA: posts big blind $1
*** HOLE CARDS ***
wx3sQGkVi2x9wJXuWNHPBw: folds
ZA1bp6g8IwtTxkUE4eCjDQ: folds
UBZQqpnJZdTYYY1FTb0rLA: folds
oxnw0GLLpFanjhGkxfRSqA: folds
YsLQ3BAvgQHWXMAv3Wv6Hg: folds
xAU6q2/cwmby2sxmA8VcmA collected $1 from pot
xAU6q2/cwmby2sxmA8VcmA: doesn't show hand
*** SUMMARY ***
Total pot $1 | Rake $0
Seat 1: YsLQ3BAvgQHWXMAv3Wv6Hg (small blind) folded before Flop
Seat 2: xAU6q2/cwmby2sxmA8VcmA (big blind) collected ($1)
Seat 3: wx3sQGkVi2x9wJXuWNHPBw folded before Flop (didn't bet)
Seat 4: ZA1bp6g8IwtTxkUE4eCjDQ folded before Flop (didn't bet)
Seat 5: UBZQqpnJZdTYYY1FTb0rLA folded before Flop (didn't bet)
Seat 6: oxnw0GLLpFanjhGkxfRSqA (button) folded before Flop (didn't bet)



PokerStars Game #59938762632:  Hold'em No Limit ($0.50/$1.00) - 2009/07/01 0:22:52 ET
Table 'mmbQQVBTrPdE+wy+s+9VPA' 6-max Seat #3 is the button
Seat 1: P9iqlRE1diA1wRYdf4YRBQ ($116.90 in chips)
Seat 3: wx3sQGkVi2x9wJXuWNHPBw ($103 in chips)
Seat 4: RfKnhkJN8HEAuzJpH2Ajdg ($20.65 in chips)
Seat 5: YMJG+F++3Aj6P8dAWda5fw ($100 in chips)
Seat 6: klQ/ufr9lOvfLMdAu0S9cw ($26.10 in chips)
RfKnhkJN8HEAuzJpH2Ajdg: posts small blind $0.50
YMJG+F++3Aj6P8dAWda5fw: posts big blind $1
ru6SCVvWcWt2SpmUsmArWQ: sits out
*** HOLE CARDS ***
klQ/ufr9lOvfLMdAu0S9cw: folds
P9iqlRE1diA1wRYdf4YRBQ: raises $2 to $3
wx3sQGkVi2x9wJXuWNHPBw: folds
RfKnhkJN8HEAuzJpH2Ajdg: folds
YMJG+F++3Aj6P8dAWda5fw: folds
P9iqlRE1diA1wRYdf4YRBQ collected $2.50 from pot
P9iqlRE1diA1wRYdf4YRBQ: doesn't show hand
*** SUMMARY ***
Total pot $2.50 | Rake $0
Seat 1: P9iqlRE1diA1wRYdf4YRBQ collected ($2.50)
Seat 3: wx3sQGkVi2x9wJXuWNHPBw (button) folded before Flop (didn't bet)
Seat 4: RfKnhkJN8HEAuzJpH2Ajdg (small blind) folded before Flop
Seat 5: YMJG+F++3Aj6P8dAWda5fw (big blind) folded before Flop
Seat 6: klQ/ufr9lOvfLMdAu0S9cw folded before Flop (didn't bet)



PokerStars Game #59938763404:  Hold'em No Limit ($0.50/$1.00) - 2009/07/01 0:22:53 ET
Table 'pHrhryH8jPNdQfY62f8v+g' 6-max Seat #5 is the button
Seat 1: BdbmJTZZ47quA9vUWwXtlw ($68.75 in chips)
Seat 2: RqgF7gRoKgRNW8Zoi1ty4A ($112.10 in chips)
Seat 4: wenbG7TaM3H7h5kn78OFNw ($61 in chips)
Seat 5: Gp2euK/nqF6qXKe7U+jOfw ($118.65 in chips)
xAU6q2/cwmby2sxmA8VcmA will be allowed to play after the button
BdbmJTZZ47quA9vUWwXtlw: posts small blind $0.50
RqgF7gRoKgRNW8Zoi1ty4A: posts big blind $1
0WjiuIT7/EolY1oOx1ngeA: sits out
*** HOLE CARDS ***
wenbG7TaM3H7h5kn78OFNw: raises $4 to $5
Gp2euK/nqF6qXKe7U+jOfw: folds
BdbmJTZZ47quA9vUWwXtlw: folds
RqgF7gRoKgRNW8Zoi1ty4A: folds
wenbG7TaM3H7h5kn78OFNw collected $2.50 from pot
*** SUMMARY ***
Total pot $2.50 | Rake $0
Seat 1: BdbmJTZZ47quA9vUWwXtlw (small blind) folded before Flop
Seat 2: RqgF7gRoKgRNW8Zoi1ty4A (big blind) folded before Flop
Seat 4: wenbG7TaM3H7h5kn78OFNw collected ($2.50)
Seat 5: Gp2euK/nqF6qXKe7U+jOfw (button) folded before Flop (didn't bet)



PokerStars Game #59938763738:  Hold'em No Limit ($0.50/$1.00) - 2009/07/01 0:22:54 ET
Table 'tyUh+jyNvrceIQdKMJjQ2wZFWj23PMihdwrNWv41OG/Qeat #1 is the button
Seat 1: o8A5MUdudVKu+pAwgZOX2w ($194.25 in chips)
Seat 2: 6iVcnPw9a2oNG6sPQo3G6g ($98.15 in chips)
Seat 3: L9qfLYXrczhAPd/VckgsWw ($40.45 in chips)
Seat 5: j7NIOHLZk7V2o9fOioO5ug ($103.95 in chips)
Seat 6: YsLQ3BAvgQHWXMAv3Wv6Hg ($106.75 in chips)
6iVcnPw9a2oNG6sPQo3G6g: posts small blind $0.50
L9qfLYXrczhAPd/VckgsWw: posts big blind $1
TSuRyAHnUPCFjP7Z0rEE0w: sits out
*** HOLE CARDS ***
j7NIOHLZk7V2o9fOioO5ug: folds
YsLQ3BAvgQHWXMAv3Wv6Hg: folds
o8A5MUdudVKu+pAwgZOX2w: folds
6iVcnPw9a2oNG6sPQo3G6g: calls $0.50
L9qfLYXrczhAPd/VckgsWw: checks
*** FLOP *** [Ks As 3d]
6iVcnPw9a2oNG6sPQo3G6g: checks
L9qfLYXrczhAPd/VckgsWw: bets $1
6iVcnPw9a2oNG6sPQo3G6g: raises $3 to $4
L9qfLYXrczhAPd/VckgsWw: folds
6iVcnPw9a2oNG6sPQo3G6g collected $3.85 from pot
6iVcnPw9a2oNG6sPQo3G6g: doesn't show hand
*** SUMMARY ***
Total pot $4 | Rake $0.15
Board [Ks As 3d]
Seat 1: o8A5MUdudVKu+pAwgZOX2w (button) folded before Flop (didn't bet)
Seat 2: 6iVcnPw9a2oNG6sPQo3G6g (small blind) collected ($3.85)
Seat 3: L9qfLYXrczhAPd/VckgsWw (big blind) folded on the Flop
Seat 5: j7NIOHLZk7V2o9fOioO5ug folded before Flop (didn't bet)
Seat 6: YsLQ3BAvgQHWXMAv3Wv6Hg folded before Flop (didn't bet)



PokerStars Game #59938764818:  Hold'em No Limit ($0.50/$1.00) - 2009/07/01 0:22:55 ET
Table '/RZcOwpZpHQ+OwPwjsbnRw' 6-max Seat #2 is the button
Seat 1: jMljU/dOPMXfJi8OmbdYdw ($94.30 in chips)
Seat 2: dHC9PH9hdH3Ad2TD8ZxX0Q ($41.10 in chips)
Seat 3: OigyyiK+tTj1APPIAUmXDA ($85.15 in chips)
Seat 4: j7NIOHLZk7V2o9fOioO5ug ($100 in chips)
Seat 5: wx3sQGkVi2x9wJXuWNHPBw ($205.05 in chips)
Seat 6: XOIf9W+VAxhZqN+SYoyMKA ($255.30 in chips)
OigyyiK+tTj1APPIAUmXDA: posts small blind $0.50
j7NIOHLZk7V2o9fOioO5ug: posts big blind $1
*** HOLE CARDS ***
wx3sQGkVi2x9wJXuWNHPBw: raises $3 to $4
XOIf9W+VAxhZqN+SYoyMKA: folds
jMljU/dOPMXfJi8OmbdYdw: folds
dHC9PH9hdH3Ad2TD8ZxX0Q: folds
OigyyiK+tTj1APPIAUmXDA: folds
j7NIOHLZk7V2o9fOioO5ug: folds
wx3sQGkVi2x9wJXuWNHPBw collected $2.50 from pot
*** SUMMARY ***
Total pot $2.50 | Rake $0
Seat 1: jMljU/dOPMXfJi8OmbdYdw folded before Flop (didn't bet)
Seat 2: dHC9PH9hdH3Ad2TD8ZxX0Q (button) folded before Flop (didn't bet)
Seat 3: OigyyiK+tTj1APPIAUmXDA (small blind) folded before Flop
Seat 4: j7NIOHLZk7V2o9fOioO5ug (big blind) folded before Flop
Seat 5: wx3sQGkVi2x9wJXuWNHPBw collected ($2.50)
Seat 6: XOIf9W+VAxhZqN+SYoyMKA folded before Flop (didn't bet)



PokerStars Game #59938765770:  Hold'em No Limit ($0.50/$1.00) - 2009/07/01 0:22:57 ET
Table 'tLrtq7gDzxEvckNAI1OS5Q' 6-max Seat #5 is the button
Seat 1: GisIe1kcC9q/xV6ifsTjgA ($154.85 in chips)
Seat 2: qsObMEIlRO22OlS867m/lw ($4.70 in chips)
Seat 3: TPZ+m9x+lwoKpv7TMfAUWA ($324.75 in chips)
Seat 4: KOG8rG51mOvIoY96zF3kvw ($157.30 in chips)
Seat 5: OGMLOcTNYZXZU81au7ztUw ($176.85 in chips)
Seat 6: XUk5GQsfNFpHvaToDZ0rZA ($45.45 in chips)
XUk5GQsfNFpHvaToDZ0rZA: posts small blind $0.50
GisIe1kcC9q/xV6ifsTjgA: posts big blind $1
*** HOLE CARDS ***
qsObMEIlRO22OlS867m/lw: folds
TPZ+m9x+lwoKpv7TMfAUWA: raises $2 to $3
KOG8rG51mOvIoY96zF3kvw: raises $7 to $10
OGMLOcTNYZXZU81au7ztUw: folds
XUk5GQsfNFpHvaToDZ0rZA: folds
GisIe1kcC9q/xV6ifsTjgA: folds
TPZ+m9x+lwoKpv7TMfAUWA: folds
KOG8rG51mOvIoY96zF3kvw collected $7.50 from pot
KOG8rG51mOvIoY96zF3kvw: doesn't show hand
*** SUMMARY ***
Total pot $7.50 | Rake $0
Seat 1: GisIe1kcC9q/xV6ifsTjgA (big blind) folded before Flop
Seat 2: qsObMEIlRO22OlS867m/lw folded before Flop (didn't bet)
Seat 3: TPZ+m9x+lwoKpv7TMfAUWA folded before Flop
Seat 4: KOG8rG51mOvIoY96zF3kvw collected ($7.50)
Seat 5: OGMLOcTNYZXZU81au7ztUw (button) folded before Flop (didn't bet)
Seat 6: XUk5GQsfNFpHvaToDZ0rZA (small blind) folded before Flop



PokerStars Game #59938766164:  Hold'em No Limit ($0.50/$1.00) - 2009/07/01 0:22:57 ET
Table 'aWHveb63HkbTmOGHOxjBkQ' 2-max Seat #1 is the button
Seat 1: xy2MQKoHoCZZIudmw8Xbow ($236.30 in chips)
Seat 2: xstEKavv3YDxpUnU4e9qAQ ($137.60 in chips)
xy2MQKoHoCZZIudmw8Xbow: posts small blind $0.50
xstEKavv3YDxpUnU4e9qAQ: posts big blind $1
*** HOLE CARDS ***
xy2MQKoHoCZZIudmw8Xbow: raises $3 to $4
xstEKavv3YDxpUnU4e9qAQ: raises $8 to $12
xy2MQKoHoCZZIudmw8Xbow: calls $8
*** FLOP *** [Ts Jh 2d]
xstEKavv3YDxpUnU4e9qAQ: checks
xy2MQKoHoCZZIudmw8Xbow: checks
*** TURN *** [Ts Jh 2d] [9d]
xstEKavv3YDxpUnU4e9qAQ: checks
xy2MQKoHoCZZIudmw8Xbow: bets $10
xstEKavv3YDxpUnU4e9qAQ: calls $10
*** RIVER *** [Ts Jh 2d 9d] [4d]
xstEKavv3YDxpUnU4e9qAQ: checks
xy2MQKoHoCZZIudmw8Xbow: bets $15
xstEKavv3YDxpUnU4e9qAQ: calls $15
*** SHOW DOWN ***
xy2MQKoHoCZZIudmw8Xbow: shows [Ac Tc] (a pair of Tens)
xstEKavv3YDxpUnU4e9qAQ: mucks hand
xy2MQKoHoCZZIudmw8Xbow collected $73.50 from pot
*** SUMMARY ***
Total pot $74 | Rake $0.50
Board [Ts Jh 2d 9d 4d]
Seat 1: xy2MQKoHoCZZIudmw8Xbow (button) (small blind) showed [Ac Tc] and won ($73.50) with a pair of Tens
Seat 2: xstEKavv3YDxpUnU4e9qAQ (big blind) mucked



PokerStars Game #59938767240:  Hold'em No Limit ($0.50/$1.00) - 2009/07/01 0:22:59 ET
Table '7Nl0ffnjeK44/vmeexh3MQ' 9-max Seat #5 is the button
Seat 1: s7D3Y+k4Cj4D1cXHv7oj+Q ($102.30 in chips)
Seat 3: 200876 ($39.90 in chips)
Seat 4: NfbTuCZ2txeWuV3hP7t0TA ($100 in chips)
Seat 5: bL+QVeDcuEdzMGAGg2XJHg ($107.10 in chips)
Seat 6: FVs16t7GgfWgQWt4JxsObQ ($17.05 in chips)
Seat 7: knewtTmBc4Tc0z/5tAABYQ ($108 in chips)
Seat 8: zanka7aAZkigmZpfopXxxA ($222 in chips)
FVs16t7GgfWgQWt4JxsObQ: posts small blind $0.50
knewtTmBc4Tc0z/5tAABYQ: posts big blind $1
*** HOLE CARDS ***
zanka7aAZkigmZpfopXxxA: raises $2 to $3
s7D3Y+k4Cj4D1cXHv7oj+Q: folds
200876: folds
NfbTuCZ2txeWuV3hP7t0TA: folds
bL+QVeDcuEdzMGAGg2XJHg: folds
ouwUBGRKnKK9uhn1G4Lf+A joins the table at seat #9
FVs16t7GgfWgQWt4JxsObQ: folds
knewtTmBc4Tc0z/5tAABYQ: folds
zanka7aAZkigmZpfopXxxA collected $2.50 from pot
zanka7aAZkigmZpfopXxxA: doesn't show hand
*** SUMMARY ***
Total pot $2.50 | Rake $0
Seat 1: s7D3Y+k4Cj4D1cXHv7oj+Q folded before Flop (didn't bet)
Seat 3: 200876 folded before Flop (didn't bet)
Seat 4: NfbTuCZ2txeWuV3hP7t0TA folded before Flop (didn't bet)
Seat 5: bL+QVeDcuEdzMGAGg2XJHg (button) folded before Flop (didn't bet)
Seat 6: FVs16t7GgfWgQWt4JxsObQ (small blind) folded before Flop
Seat 7: knewtTmBc4Tc0z/5tAABYQ (big blind) folded before Flop
Seat 8: zanka7aAZkigmZpfopXxxA collected ($2.50)



PokerStars Game #59938767404:  Hold'em No Limit ($0.50/$1.00) - 2009/07/01 0:22:59 ET
Table 'tJq9SfN1ywY0r03VBlWlwQ' 9-max Seat #6 is the button
Seat 1: wZsU+w9r7G66x93UuvBf1Q ($329.05 in chips)
Seat 2: RqkO8O/Y3qlc3PIuCAHjVg ($75.40 in chips)
Seat 3: FVs16t7GgfWgQWt4JxsObQ ($44.45 in chips)
Seat 4: zBHLwg+HmbHmRtVQMhavjA ($100 in chips)
Seat 5: Ogn4JDV3mp4ZDKO49IFzKA ($20 in chips)
Seat 6: gUUvmqdVlmvpal6B8nYrmg ($100 in chips)
Seat 7: qVhRZ0PLZ95XRJHWAjXjOQ ($118.10 in chips)
Seat 8: G4DEhsZFmznGNVpy2SEocA ($23.50 in chips)
qVhRZ0PLZ95XRJHWAjXjOQ: posts small blind $0.50
G4DEhsZFmznGNVpy2SEocA: posts big blind $1
*** HOLE CARDS ***
wZsU+w9r7G66x93UuvBf1Q: folds
RqkO8O/Y3qlc3PIuCAHjVg: folds
FVs16t7GgfWgQWt4JxsObQ: folds
zBHLwg+HmbHmRtVQMhavjA: folds
Ogn4JDV3mp4ZDKO49IFzKA: raises $19 to $20 and is all-in
XE5QF1y74bpHog9JxWJMWQ has returned
gUUvmqdVlmvpal6B8nYrmg: folds
qVhRZ0PLZ95XRJHWAjXjOQ: folds
G4DEhsZFmznGNVpy2SEocA: folds
Ogn4JDV3mp4ZDKO49IFzKA collected $2.50 from pot
*** SUMMARY ***
Total pot $2.50 | Rake $0
Seat 1: wZsU+w9r7G66x93UuvBf1Q folded before Flop (didn't bet)
Seat 2: RqkO8O/Y3qlc3PIuCAHjVg folded before Flop (didn't bet)
Seat 3: FVs16t7GgfWgQWt4JxsObQ folded before Flop (didn't bet)
Seat 4: zBHLwg+HmbHmRtVQMhavjA folded before Flop (didn't bet)
Seat 5: Ogn4JDV3mp4ZDKO49IFzKA collected ($2.50)
Seat 6: gUUvmqdVlmvpal6B8nYrmg (button) folded before Flop (didn't bet)
Seat 7: qVhRZ0PLZ95XRJHWAjXjOQ (small blind) folded before Flop
Seat 8: G4DEhsZFmznGNVpy2SEocA (big blind) folded before Flop



PokerStars Game #59938768060:  Hold'em No Limit ($0.50/$1.00) - 2009/07/01 0:23:00 ET
Table 'N2bNCDHL96aCQDvZIh+yQQ' 6-max Seat #4 is the button
Seat 1: iHo1oDbrEVJ8nEGdaPrICw ($148.50 in chips)
Seat 2: KpnW5CcJ4Mg6MeclfKmLrw ($102 in chips)
Seat 3: PXT6kJgVX67c3EgncNqRoA ($51.45 in chips)
Seat 4: uCqEjnxh2/vFBjKYkfTOkw ($155.20 in chips)
Seat 5: rHlMOfR7kpQQxe+PFQz0xQ ($37.90 in chips)
Seat 6: TSuRyAHnUPCFjP7Z0rEE0w ($100 in chips)
rHlMOfR7kpQQxe+PFQz0xQ: posts small blind $0.50
TSuRyAHnUPCFjP7Z0rEE0w: posts big blind $1
*** HOLE CARDS ***
iHo1oDbrEVJ8nEGdaPrICw: raises $2.50 to $3.50
KpnW5CcJ4Mg6MeclfKmLrw: folds
PXT6kJgVX67c3EgncNqRoA: folds
uCqEjnxh2/vFBjKYkfTOkw: raises $6.50 to $10
rHlMOfR7kpQQxe+PFQz0xQ: folds
TSuRyAHnUPCFjP7Z0rEE0w: folds
iHo1oDbrEVJ8nEGdaPrICw: folds
uCqEjnxh2/vFBjKYkfTOkw collected $8.50 from pot
uCqEjnxh2/vFBjKYkfTOkw: doesn't show hand
*** SUMMARY ***
Total pot $8.50 | Rake $0
Seat 1: iHo1oDbrEVJ8nEGdaPrICw folded before Flop
Seat 2: KpnW5CcJ4Mg6MeclfKmLrw folded before Flop (didn't bet)
Seat 3: PXT6kJgVX67c3EgncNqRoA folded before Flop (didn't bet)
Seat 4: uCqEjnxh2/vFBjKYkfTOkw (button) collected ($8.50)
Seat 5: rHlMOfR7kpQQxe+PFQz0xQ (small blind) folded before Flop
Seat 6: TSuRyAHnUPCFjP7Z0rEE0w (big blind) folded before Flop



PokerStars Game #59938770528:  Hold'em No Limit ($0.50/$1.00) - 2009/07/01 0:23:04 ET
Table 'fTlPiCj0utgzC/5io+I7ew' 6-max Seat #4 is the button
Seat 1: YMJG+F++3Aj6P8dAWda5fw ($100 in chips)
Seat 2: +xUCTmR3cU7G239W+vZv6g ($142.20 in chips)
Seat 3: oDiBRCaF0QVtd3kO6xZIXw ($100 in chips)
Seat 4: uJVSceLggtsrJya+WtmUEA ($95.10 in chips)
Seat 5: bFrTkDcWGTxyvNul7GVdYg ($246.85 in chips)
bFrTkDcWGTxyvNul7GVdYg: posts small blind $0.50
YMJG+F++3Aj6P8dAWda5fw: posts big blind $1
*** HOLE CARDS ***
+xUCTmR3cU7G239W+vZv6g: raises $2 to $3
oDiBRCaF0QVtd3kO6xZIXw: folds
uJVSceLggtsrJya+WtmUEA: calls $3
bFrTkDcWGTxyvNul7GVdYg: folds
YMJG+F++3Aj6P8dAWda5fw: folds
*** FLOP *** [7c Jh Kd]
+xUCTmR3cU7G239W+vZv6g: bets $5
uJVSceLggtsrJya+WtmUEA: folds
+xUCTmR3cU7G239W+vZv6g collected $7.15 from pot
*** SUMMARY ***
Total pot $7.50 | Rake $0.35
Board [7c Jh Kd]
Seat 1: YMJG+F++3Aj6P8dAWda5fw (big blind) folded before Flop
Seat 2: +xUCTmR3cU7G239W+vZv6g collected ($7.15)
Seat 3: oDiBRCaF0QVtd3kO6xZIXw folded before Flop (didn't bet)
Seat 4: uJVSceLggtsrJya+WtmUEA (button) folded on the Flop
Seat 5: bFrTkDcWGTxyvNul7GVdYg (small blind) folded before Flop



PokerStars Game #59938771508:  Hold'em No Limit ($0.50/$1.00) - 2009/07/01 0:23:05 ET
Table 'W/wyObTiXZm+Ckkl3YxcSw' 6-max Seat #2 is the button
Seat 1: ssLJburtEIqnVkx6X8R1uw ($117.25 in chips)
Seat 2: oDiBRCaF0QVtd3kO6xZIXw ($100 in chips)
Seat 3: b2a+5TkFf4xJN/Ihhma58Q ($37.20 in chips)
Seat 4: BdbmJTZZ47quA9vUWwXtlw ($50.10 in chips)
Seat 5: Wko+clJG9HZPPQ7Yn0Y5Zg ($26.25 in chips)
Seat 6: 1yB1nHUkHNNY8OJnDNHZMw ($50 in chips)
b2a+5TkFf4xJN/Ihhma58Q: posts small blind $0.50
BdbmJTZZ47quA9vUWwXtlw: posts big blind $1
1yB1nHUkHNNY8OJnDNHZMw: posts big blind $1
*** HOLE CARDS ***
Wko+clJG9HZPPQ7Yn0Y5Zg: folds
Wko+clJG9HZPPQ7Yn0Y5Zg is sitting out
1yB1nHUkHNNY8OJnDNHZMw: raises $2 to $3
ssLJburtEIqnVkx6X8R1uw: folds
oDiBRCaF0QVtd3kO6xZIXw: folds
b2a+5TkFf4xJN/Ihhma58Q: folds
BdbmJTZZ47quA9vUWwXtlw: calls $2
*** FLOP *** [As Ks 2s]
BdbmJTZZ47quA9vUWwXtlw: checks
1yB1nHUkHNNY8OJnDNHZMw: bets $3.50
BdbmJTZZ47quA9vUWwXtlw: folds
1yB1nHUkHNNY8OJnDNHZMw collected $6.20 from pot
*** SUMMARY ***
Total pot $6.50 | Rake $0.30
Board [As Ks 2s]
Seat 1: ssLJburtEIqnVkx6X8R1uw folded before Flop (didn't bet)
Seat 2: oDiBRCaF0QVtd3kO6xZIXw (button) folded before Flop (didn't bet)
Seat 3: b2a+5TkFf4xJN/Ihhma58Q (small blind) folded before Flop
Seat 4: BdbmJTZZ47quA9vUWwXtlw (big blind) folded on the Flop
Seat 5: Wko+clJG9HZPPQ7Yn0Y5Zg folded before Flop (didn't bet)
Seat 6: 1yB1nHUkHNNY8OJnDNHZMw collected ($6.20)



PokerStars Game #59938771506:  Hold'em No Limit ($0.50/$1.00) - 2009/07/01 0:23:05 ET
Table 'J2yEIzCSC1VzM+R2gijwtg' 9-max Seat #2 is the button
Seat 1: knewtTmBc4Tc0z/5tAABYQ ($201.45 in chips)
Seat 2: kz9ziSiGUc+857heiKSayw ($14.95 in chips)
Seat 3: 9swGhtpERPngKPtvpoZkoQ ($122.15 in chips)
Seat 4: vR4IO10geOgvTW+LAUBv/A ($100 in chips)
Seat 5: /kZ258i1lqmMUXbtrZIHJA ($44.40 in chips)
Seat 6: bJckevFOcg//s0qyMQI6sQ ($176.40 in chips)
Seat 8: CIRDepY9Rc5tiDJPd0nNpQ ($93.90 in chips)
9swGhtpERPngKPtvpoZkoQ: posts small blind $0.50
vR4IO10geOgvTW+LAUBv/A: posts big blind $1
*** HOLE CARDS ***
/kZ258i1lqmMUXbtrZIHJA: folds
bJckevFOcg//s0qyMQI6sQ: folds
CIRDepY9Rc5tiDJPd0nNpQ: raises $2 to $3
knewtTmBc4Tc0z/5tAABYQ: folds
kz9ziSiGUc+857heiKSayw: folds
9swGhtpERPngKPtvpoZkoQ: calls $2.50
vR4IO10geOgvTW+LAUBv/A: folds
*** FLOP *** [Qc 6d 9s]
9swGhtpERPngKPtvpoZkoQ: checks
CIRDepY9Rc5tiDJPd0nNpQ: bets $3
9swGhtpERPngKPtvpoZkoQ: calls $3
*** TURN *** [Qc 6d 9s] [6c]
9swGhtpERPngKPtvpoZkoQ: checks
CIRDepY9Rc5tiDJPd0nNpQ: checks
*** RIVER *** [Qc 6d 9s 6c] [4s]
9swGhtpERPngKPtvpoZkoQ: checks
CIRDepY9Rc5tiDJPd0nNpQ: checks
*** SHOW DOWN ***
9swGhtpERPngKPtvpoZkoQ: shows [8h 8s] (two pair, Eights and Sixes)
CIRDepY9Rc5tiDJPd0nNpQ: shows [Qh Jd] (two pair, Queens and Sixes)
CIRDepY9Rc5tiDJPd0nNpQ collected $12.40 from pot
*** SUMMARY ***
Total pot $13 | Rake $0.60
Board [Qc 6d 9s 6c 4s]
Seat 1: knewtTmBc4Tc0z/5tAABYQ folded before Flop (didn't bet)
Seat 2: kz9ziSiGUc+857heiKSayw (button) folded before Flop (didn't bet)
Seat 3: 9swGhtpERPngKPtvpoZkoQ (small blind) showed [8h 8s] and lost with two pair, Eights and Sixes
Seat 4: vR4IO10geOgvTW+LAUBv/A (big blind) folded before Flop
Seat 5: /kZ258i1lqmMUXbtrZIHJA folded before Flop (didn't bet)
Seat 6: bJckevFOcg//s0qyMQI6sQ folded before Flop (didn't bet)
Seat 8: CIRDepY9Rc5tiDJPd0nNpQ showed [Qh Jd] and won ($12.40) with two pair, Queens and Sixes



PokerStars Game #59938772774:  Hold'em No Limit ($0.50/$1.00) - 2009/07/01 0:23:07 ET
Table 'kS0cTQAEi+fdUlJP2gQYvw' 9-max Seat #7 is the button
Seat 1: c/9X4zftzphFxYtxp5kp9w ($51.90 in chips)
Seat 2: 4SFNYndzMeslixOnF4koZQ ($56.15 in chips)
Seat 3: 3obndzTJ6fECz8+wWhMd1w ($18.50 in chips)
Seat 4: TZcz9MEWDA+WydgGruqqbw ($100 in chips)
Seat 5: 2rxrMrE7koO2BNxvop/0+g ($45.45 in chips)
Seat 6: yAbu2QsRPVcjPbqlf/jDxw ($100.65 in chips)
Seat 7: Ffa7Nj4X5fddtROP01hfQg ($92.10 in chips)
Seat 8: qTymj6ZQ8ZoFi6fINJZb3w ($86 in chips)
Seat 9: y8Qb94e81yI/g0saQ6gU5g ($89.25 in chips)
qTymj6ZQ8ZoFi6fINJZb3w: posts small blind $0.50
y8Qb94e81yI/g0saQ6gU5g: posts big blind $1
*** HOLE CARDS ***
c/9X4zftzphFxYtxp5kp9w: folds
4SFNYndzMeslixOnF4koZQ: calls $1
3obndzTJ6fECz8+wWhMd1w: folds
TZcz9MEWDA+WydgGruqqbw: folds
2rxrMrE7koO2BNxvop/0+g: calls $1
yAbu2QsRPVcjPbqlf/jDxw: folds
Ffa7Nj4X5fddtROP01hfQg: calls $1
qTymj6ZQ8ZoFi6fINJZb3w: calls $0.50
y8Qb94e81yI/g0saQ6gU5g: checks
*** FLOP *** [Td 3s 2d]
qTymj6ZQ8ZoFi6fINJZb3w: checks
y8Qb94e81yI/g0saQ6gU5g: checks
4SFNYndzMeslixOnF4koZQ: checks
2rxrMrE7koO2BNxvop/0+g: bets $3
Ffa7Nj4X5fddtROP01hfQg: folds
qTymj6ZQ8ZoFi6fINJZb3w: folds
y8Qb94e81yI/g0saQ6gU5g: folds
4SFNYndzMeslixOnF4koZQ: folds
2rxrMrE7koO2BNxvop/0+g collected $4.75 from pot
*** SUMMARY ***
Total pot $5 | Rake $0.25
Board [Td 3s 2d]
Seat 1: c/9X4zftzphFxYtxp5kp9w folded before Flop (didn't bet)
Seat 2: 4SFNYndzMeslixOnF4koZQ folded on the Flop
Seat 3: 3obndzTJ6fECz8+wWhMd1w folded before Flop (didn't bet)
Seat 4: TZcz9MEWDA+WydgGruqqbw folded before Flop (didn't bet)
Seat 5: 2rxrMrE7koO2BNxvop/0+g collected ($4.75)
Seat 6: yAbu2QsRPVcjPbqlf/jDxw folded before Flop (didn't bet)
Seat 7: Ffa7Nj4X5fddtROP01hfQg (button) folded on the Flop
Seat 8: qTymj6ZQ8ZoFi6fINJZb3w (small blind) folded on the Flop
Seat 9: y8Qb94e81yI/g0saQ6gU5g (big blind) folded on the Flop



PokerStars Game #59938773084:  Hold'em No Limit ($0.50/$1.00) - 2009/07/01 0:23:07 ET
Table 'MUPc8FEpe/nR0BKSeReX6Q' 6-max Seat #1 is the button
Seat 1: YsLQ3BAvgQHWXMAv3Wv6Hg ($100 in chips)
Seat 2: xAU6q2/cwmby2sxmA8VcmA ($100.50 in chips)
Seat 3: wx3sQGkVi2x9wJXuWNHPBw ($235.55 in chips)
Seat 4: ZA1bp6g8IwtTxkUE4eCjDQ ($113.45 in chips)
Seat 5: UBZQqpnJZdTYYY1FTb0rLA ($101.50 in chips)
Seat 6: oxnw0GLLpFanjhGkxfRSqA ($51.40 in chips)
xAU6q2/cwmby2sxmA8VcmA: posts small blind $0.50
wx3sQGkVi2x9wJXuWNHPBw: posts big blind $1
*** HOLE CARDS ***
ZA1bp6g8IwtTxkUE4eCjDQ: raises $5 to $6
UBZQqpnJZdTYYY1FTb0rLA: folds
oxnw0GLLpFanjhGkxfRSqA: folds
YsLQ3BAvgQHWXMAv3Wv6Hg: folds
xAU6q2/cwmby2sxmA8VcmA: folds
wx3sQGkVi2x9wJXuWNHPBw: folds
ZA1bp6g8IwtTxkUE4eCjDQ collected $2.50 from pot
ZA1bp6g8IwtTxkUE4eCjDQ: doesn't show hand
*** SUMMARY ***
Total pot $2.50 | Rake $0
Seat 1: YsLQ3BAvgQHWXMAv3Wv6Hg (button) folded before Flop (didn't bet)
Seat 2: xAU6q2/cwmby2sxmA8VcmA (small blind) folded before Flop
Seat 3: wx3sQGkVi2x9wJXuWNHPBw (big blind) folded before Flop
Seat 4: ZA1bp6g8IwtTxkUE4eCjDQ collected ($2.50)
Seat 5: UBZQqpnJZdTYYY1FTb0rLA folded before Flop (didn't bet)
Seat 6: oxnw0GLLpFanjhGkxfRSqA folded before Flop (didn't bet)



PokerStars Game #59938775788:  Hold'em No Limit ($0.50/$1.00) - 2009/07/01 0:23:11 ET
Table 'rmZfTK+oSebeUPJNbWhdAA' 6-max Seat #4 is the button
Seat 1: u4vYQZNWtIzOJre8fvCmvQ ($8.85 in chips)
Seat 2: OigyyiK+tTj1APPIAUmXDA ($78.20 in chips)
Seat 3: 9yjOzGERLaEZS8CZ6YNHFg ($61.30 in chips)
Seat 4: OGMLOcTNYZXZU81au7ztUw ($126.65 in chips)
Seat 5: VuZb/hkEc4X7s93w2ZZTpA ($111.75 in chips)
Seat 6: j7NIOHLZk7V2o9fOioO5ug ($106.30 in chips)
VuZb/hkEc4X7s93w2ZZTpA: posts small blind $0.50
j7NIOHLZk7V2o9fOioO5ug: posts big blind $1
*** HOLE CARDS ***
u4vYQZNWtIzOJre8fvCmvQ said, "nh"
u4vYQZNWtIzOJre8fvCmvQ: folds
OigyyiK+tTj1APPIAUmXDA: raises $2 to $3
9yjOzGERLaEZS8CZ6YNHFg: folds
u4vYQZNWtIzOJre8fvCmvQ leaves the table
OGMLOcTNYZXZU81au7ztUw: folds
VuZb/hkEc4X7s93w2ZZTpA: folds
j7NIOHLZk7V2o9fOioO5ug: folds
xAU6q2/cwmby2sxmA8VcmA joins the table at seat #1
OigyyiK+tTj1APPIAUmXDA collected $2.50 from pot
*** SUMMARY ***
Total pot $2.50 | Rake $0
Seat 1: u4vYQZNWtIzOJre8fvCmvQ folded before Flop (didn't bet)
Seat 2: OigyyiK+tTj1APPIAUmXDA collected ($2.50)
Seat 3: 9yjOzGERLaEZS8CZ6YNHFg folded before Flop (didn't bet)
Seat 4: OGMLOcTNYZXZU81au7ztUw (button) folded before Flop (didn't bet)
Seat 5: VuZb/hkEc4X7s93w2ZZTpA (small blind) folded before Flop
Seat 6: j7NIOHLZk7V2o9fOioO5ug (big blind) folded before Flop



PokerStars Game #59938775308:  Hold'em No Limit ($0.50/$1.00) - 2009/07/01 0:23:11 ET
Table 'vs/5jr6ciwjVQ5+Soc+u2A' 6-max Seat #4 is the button
Seat 2: XOIf9W+VAxhZqN+SYoyMKA ($115.80 in chips)
Seat 3: G5ZSSN6RSON3gkNvk/SmYg ($102.20 in chips)
Seat 4: KpnW5CcJ4Mg6MeclfKmLrw ($104.65 in chips)
Seat 5: 7Vc9JmGFQwMRh5Tj9ui5Lw ($99.15 in chips)
Seat 6: QHvTZcrKe6+maWUfVjP29Q ($100 in chips)
7Vc9JmGFQwMRh5Tj9ui5Lw: posts small blind $0.50
QHvTZcrKe6+maWUfVjP29Q: posts big blind $1
*** HOLE CARDS ***
XOIf9W+VAxhZqN+SYoyMKA: folds
G5ZSSN6RSON3gkNvk/SmYg: folds
KpnW5CcJ4Mg6MeclfKmLrw: folds
7Vc9JmGFQwMRh5Tj9ui5Lw: folds
QHvTZcrKe6+maWUfVjP29Q collected $1 from pot
QHvTZcrKe6+maWUfVjP29Q: doesn't show hand
*** SUMMARY ***
Total pot $1 | Rake $0
Seat 2: XOIf9W+VAxhZqN+SYoyMKA folded before Flop (didn't bet)
Seat 3: G5ZSSN6RSON3gkNvk/SmYg folded before Flop (didn't bet)
Seat 4: KpnW5CcJ4Mg6MeclfKmLrw (button) folded before Flop (didn't bet)
Seat 5: 7Vc9JmGFQwMRh5Tj9ui5Lw (small blind) folded before Flop
Seat 6: QHvTZcrKe6+maWUfVjP29Q (big blind) collected ($1)



PokerStars Game #59938776058:  Hold'em No Limit ($0.50/$1.00) - 2009/07/01 0:23:12 ET
Table '/RZcOwpZpHQ+OwPwjsbnRw' 6-max Seat #3 is the button
Seat 1: jMljU/dOPMXfJi8OmbdYdw ($94.30 in chips)
Seat 2: dHC9PH9hdH3Ad2TD8ZxX0Q ($41.10 in chips)
Seat 3: OigyyiK+tTj1APPIAUmXDA ($84.65 in chips)
Seat 4: j7NIOHLZk7V2o9fOioO5ug ($100 in chips)
Seat 5: wx3sQGkVi2x9wJXuWNHPBw ($206.55 in chips)
Seat 6: XOIf9W+VAxhZqN+SYoyMKA ($255.30 in chips)
j7NIOHLZk7V2o9fOioO5ug: posts small blind $0.50
wx3sQGkVi2x9wJXuWNHPBw: posts big blind $1
*** HOLE CARDS ***
XOIf9W+VAxhZqN+SYoyMKA: folds
jMljU/dOPMXfJi8OmbdYdw: folds
jMljU/dOPMXfJi8OmbdYdw leaves the table
dHC9PH9hdH3Ad2TD8ZxX0Q: calls $1
OigyyiK+tTj1APPIAUmXDA: folds
j7NIOHLZk7V2o9fOioO5ug: raises $5 to $6
wx3sQGkVi2x9wJXuWNHPBw: folds
dHC9PH9hdH3Ad2TD8ZxX0Q: folds
j7NIOHLZk7V2o9fOioO5ug collected $3 from pot
j7NIOHLZk7V2o9fOioO5ug: doesn't show hand
*** SUMMARY ***
Total pot $3 | Rake $0
Seat 1: jMljU/dOPMXfJi8OmbdYdw folded before Flop (didn't bet)
Seat 2: dHC9PH9hdH3Ad2TD8ZxX0Q folded before Flop
Seat 3: OigyyiK+tTj1APPIAUmXDA (button) folded before Flop (didn't bet)
Seat 4: j7NIOHLZk7V2o9fOioO5ug (small blind) collected ($3)
Seat 5: wx3sQGkVi2x9wJXuWNHPBw (big blind) folded before Flop
Seat 6: XOIf9W+VAxhZqN+SYoyMKA folded before Flop (didn't bet)



PokerStars Game #59938777408:  Hold'em No Limit ($0.50/$1.00) - 2009/07/01 0:23:14 ET
Table 'hugOjcwJvzEwZbK7tyiWuQ' 9-max Seat #9 is the button
Seat 1: N9n5Wc3s35DpCrOAUUNAaQ ($126.85 in chips)
Seat 2: r27C1nIV4NS4+qbnrgBQSw ($257.05 in chips)
Seat 3: jDwhY1kCdc6EkAHbT7PJMQ ($108.05 in chips)
Seat 4: UWB3oeddt/GObx2Mix2Anw ($195.20 in chips)
Seat 6: gUUvmqdVlmvpal6B8nYrmg ($102.30 in chips)
Seat 7: FL3MrLspcF23LYvC4ipBOA ($100 in chips)
Seat 8: /zy+DB4S5fUQUSfZWFzYGw ($113.25 in chips)
Seat 9: o6JyUkbzCDw8tUabqtmnlg ($61.10 in chips)
N9n5Wc3s35DpCrOAUUNAaQ: posts small blind $0.50
r27C1nIV4NS4+qbnrgBQSw: posts big blind $1
*** HOLE CARDS ***
jDwhY1kCdc6EkAHbT7PJMQ: folds
UWB3oeddt/GObx2Mix2Anw: folds
gUUvmqdVlmvpal6B8nYrmg: folds
FL3MrLspcF23LYvC4ipBOA: folds
/zy+DB4S5fUQUSfZWFzYGw: folds
o6JyUkbzCDw8tUabqtmnlg: folds
N9n5Wc3s35DpCrOAUUNAaQ: folds
r27C1nIV4NS4+qbnrgBQSw collected $1 from pot
*** SUMMARY ***
Total pot $1 | Rake $0
Seat 1: N9n5Wc3s35DpCrOAUUNAaQ (small blind) folded before Flop
Seat 2: r27C1nIV4NS4+qbnrgBQSw (big blind) collected ($1)
Seat 3: jDwhY1kCdc6EkAHbT7PJMQ folded before Flop (didn't bet)
Seat 4: UWB3oeddt/GObx2Mix2Anw folded before Flop (didn't bet)
Seat 6: gUUvmqdVlmvpal6B8nYrmg folded before Flop (didn't bet)
Seat 7: FL3MrLspcF23LYvC4ipBOA folded before Flop (didn't bet)
Seat 8: /zy+DB4S5fUQUSfZWFzYGw folded before Flop (didn't bet)
Seat 9: o6JyUkbzCDw8tUabqtmnlg (button) folded before Flop (didn't bet)



PokerStars Game #59938778490:  Hold'em No Limit ($0.50/$1.00) - 2009/07/01 0:23:16 ET
Table 'Zka9tv1yilg0MvXWPQrShg' 9-max Seat #7 is the button
Seat 1: TZcz9MEWDA+WydgGruqqbw ($100 in chips)
Seat 2: zBHLwg+HmbHmRtVQMhavjA ($105.55 in chips)
Seat 3: gUUvmqdVlmvpal6B8nYrmg ($100 in chips)
Seat 4: CTOae+JLIGfwfXvhqHkP2w ($187.15 in chips)
Seat 5: /zy+DB4S5fUQUSfZWFzYGw ($141.45 in chips)
Seat 6: rY8wPoax1lS+HUY+I0FZDw ($128.40 in chips)
Seat 7: p1SafS90nb3Uft5LB0NkHw ($21.50 in chips)
Seat 8: bL+QVeDcuEdzMGAGg2XJHg ($125.10 in chips)
Seat 9: SlhHwZrXCVifyCHK+qz1Kw ($100.45 in chips)
bL+QVeDcuEdzMGAGg2XJHg: posts small blind $0.50
SlhHwZrXCVifyCHK+qz1Kw: posts big blind $1
*** HOLE CARDS ***
TZcz9MEWDA+WydgGruqqbw: folds
zBHLwg+HmbHmRtVQMhavjA: calls $1
gUUvmqdVlmvpal6B8nYrmg: folds
CTOae+JLIGfwfXvhqHkP2w: raises $3 to $4
/zy+DB4S5fUQUSfZWFzYGw: folds
rY8wPoax1lS+HUY+I0FZDw: folds
p1SafS90nb3Uft5LB0NkHw: folds
bL+QVeDcuEdzMGAGg2XJHg: folds
SlhHwZrXCVifyCHK+qz1Kw: calls $3
zBHLwg+HmbHmRtVQMhavjA: raises $11 to $15
CTOae+JLIGfwfXvhqHkP2w: calls $11
SlhHwZrXCVifyCHK+qz1Kw: folds
*** FLOP *** [6c 8s Ac]
zBHLwg+HmbHmRtVQMhavjA: bets $24
CTOae+JLIGfwfXvhqHkP2w: folds
zBHLwg+HmbHmRtVQMhavjA collected $32.80 from pot
*** SUMMARY ***
Total pot $34.50 | Rake $1.70
Board [6c 8s Ac]
Seat 1: TZcz9MEWDA+WydgGruqqbw folded before Flop (didn't bet)
Seat 2: zBHLwg+HmbHmRtVQMhavjA collected ($32.80)
Seat 3: gUUvmqdVlmvpal6B8nYrmg folded before Flop (didn't bet)
Seat 4: CTOae+JLIGfwfXvhqHkP2w folded on the Flop
Seat 5: /zy+DB4S5fUQUSfZWFzYGw folded before Flop (didn't bet)
Seat 6: rY8wPoax1lS+HUY+I0FZDw folded before Flop (didn't bet)
Seat 7: p1SafS90nb3Uft5LB0NkHw (button) folded before Flop (didn't bet)
Seat 8: bL+QVeDcuEdzMGAGg2XJHg (small blind) folded before Flop
Seat 9: SlhHwZrXCVifyCHK+qz1Kw (big blind) folded before Flop



PokerStars Game #59938779132:  Hold'em No Limit ($0.50/$1.00) - 2009/07/01 0:23:17 ET
Table '+cA8mcmhaedZ7YcrDdhmeQ' 6-max Seat #5 is the button
Seat 1: lsLuWlcPA3Rh7kJVLzMh0Q ($233 in chips)
Seat 2: trnpu4tPju3BU8W0wQQaiQ ($92.10 in chips)
Seat 3: 0WjiuIT7/EolY1oOx1ngeA ($117.80 in chips)
Seat 4: j0aDOn9Nft1HLTQvGu1UwA ($20.75 in chips)
Seat 5: 6WyjEXOToimYmtLdqIgHYQ ($60.50 in chips)
Seat 6: YfsTQsY/fxb+YqbdclTHuw ($115.25 in chips)
YfsTQsY/fxb+YqbdclTHuw: posts small blind $0.50
lsLuWlcPA3Rh7kJVLzMh0Q: posts big blind $1
*** HOLE CARDS ***
trnpu4tPju3BU8W0wQQaiQ: calls $1
0WjiuIT7/EolY1oOx1ngeA: folds
j0aDOn9Nft1HLTQvGu1UwA: calls $1
6WyjEXOToimYmtLdqIgHYQ: folds
YfsTQsY/fxb+YqbdclTHuw: calls $0.50
lsLuWlcPA3Rh7kJVLzMh0Q: checks
*** FLOP *** [2d Kd 3h]
YfsTQsY/fxb+YqbdclTHuw: checks
lsLuWlcPA3Rh7kJVLzMh0Q: checks
trnpu4tPju3BU8W0wQQaiQ: bets $3
j0aDOn9Nft1HLTQvGu1UwA: folds
YfsTQsY/fxb+YqbdclTHuw: folds
lsLuWlcPA3Rh7kJVLzMh0Q: folds
trnpu4tPju3BU8W0wQQaiQ collected $3.80 from pot
*** SUMMARY ***
Total pot $4 | Rake $0.20
Board [2d Kd 3h]
Seat 1: lsLuWlcPA3Rh7kJVLzMh0Q (big blind) folded on the Flop
Seat 2: trnpu4tPju3BU8W0wQQaiQ collected ($3.80)
Seat 3: 0WjiuIT7/EolY1oOx1ngeA folded before Flop (didn't bet)
Seat 4: j0aDOn9Nft1HLTQvGu1UwA folded on the Flop
Seat 5: 6WyjEXOToimYmtLdqIgHYQ (button) folded before Flop (didn't bet)
Seat 6: YfsTQsY/fxb+YqbdclTHuw (small blind) folded on the Flop



PokerStars Game #59938780232:  Hold'em No Limit ($0.50/$1.00) - 2009/07/01 0:23:18 ET
Table 'tyUh+jyNvrceIQdKMJjQ2wZFWj23PMihdwrNWv41OG/Qeat #2 is the button
Seat 1: o8A5MUdudVKu+pAwgZOX2w ($194.25 in chips)
Seat 2: 6iVcnPw9a2oNG6sPQo3G6g ($100 in chips)
Seat 3: L9qfLYXrczhAPd/VckgsWw ($38.45 in chips)
Seat 4: TSuRyAHnUPCFjP7Z0rEE0w ($158.45 in chips)
Seat 5: j7NIOHLZk7V2o9fOioO5ug ($103.95 in chips)
Seat 6: YsLQ3BAvgQHWXMAv3Wv6Hg ($106.75 in chips)
L9qfLYXrczhAPd/VckgsWw: posts small blind $0.50
TSuRyAHnUPCFjP7Z0rEE0w: posts big blind $1
*** HOLE CARDS ***
j7NIOHLZk7V2o9fOioO5ug: folds
YsLQ3BAvgQHWXMAv3Wv6Hg: folds
o8A5MUdudVKu+pAwgZOX2w: folds
6iVcnPw9a2oNG6sPQo3G6g: folds
L9qfLYXrczhAPd/VckgsWw: folds
TSuRyAHnUPCFjP7Z0rEE0w collected $1 from pot
TSuRyAHnUPCFjP7Z0rEE0w: doesn't show hand
*** SUMMARY ***
Total pot $1 | Rake $0
Seat 1: o8A5MUdudVKu+pAwgZOX2w folded before Flop (didn't bet)
Seat 2: 6iVcnPw9a2oNG6sPQo3G6g (button) folded before Flop (didn't bet)
Seat 3: L9qfLYXrczhAPd/VckgsWw (small blind) folded before Flop
Seat 4: TSuRyAHnUPCFjP7Z0rEE0w (big blind) collected ($1)
Seat 5: j7NIOHLZk7V2o9fOioO5ug folded before Flop (didn't bet)
Seat 6: YsLQ3BAvgQHWXMAv3Wv6Hg folded before Flop (didn't bet)



PokerStars Game #59938779834:  Hold'em No Limit ($0.50/$1.00) - 2009/07/01 0:23:18 ET
Table '7Nl0ffnjeK44/vmeexh3MQ' 9-max Seat #6 is the button
Seat 1: s7D3Y+k4Cj4D1cXHv7oj+Q ($102.30 in chips)
Seat 3: 200876 ($39.90 in chips)
Seat 4: NfbTuCZ2txeWuV3hP7t0TA ($100 in chips)
Seat 5: bL+QVeDcuEdzMGAGg2XJHg ($107.10 in chips)
Seat 6: FVs16t7GgfWgQWt4JxsObQ ($16.55 in chips)
Seat 7: knewtTmBc4Tc0z/5tAABYQ ($107 in chips)
Seat 8: zanka7aAZkigmZpfopXxxA ($223.50 in chips)
knewtTmBc4Tc0z/5tAABYQ: posts small blind $0.50
zanka7aAZkigmZpfopXxxA: posts big blind $1
ouwUBGRKnKK9uhn1G4Lf+A: sits out
*** HOLE CARDS ***
s7D3Y+k4Cj4D1cXHv7oj+Q: calls $1
200876: folds
NfbTuCZ2txeWuV3hP7t0TA: folds
kiakSwxX0e64PwYGAPQvLw joins the table at seat #2
bL+QVeDcuEdzMGAGg2XJHg: folds
FVs16t7GgfWgQWt4JxsObQ: calls $1
knewtTmBc4Tc0z/5tAABYQ: folds
zanka7aAZkigmZpfopXxxA: checks
*** FLOP *** [3s 3c 5s]
zanka7aAZkigmZpfopXxxA: checks
s7D3Y+k4Cj4D1cXHv7oj+Q: bets $3
FVs16t7GgfWgQWt4JxsObQ: folds
zanka7aAZkigmZpfopXxxA: folds
s7D3Y+k4Cj4D1cXHv7oj+Q collected $3.35 from pot
*** SUMMARY ***
Total pot $3.50 | Rake $0.15
Board [3s 3c 5s]
Seat 1: s7D3Y+k4Cj4D1cXHv7oj+Q collected ($3.35)
Seat 3: 200876 folded before Flop (didn't bet)
Seat 4: NfbTuCZ2txeWuV3hP7t0TA folded before Flop (didn't bet)
Seat 5: bL+QVeDcuEdzMGAGg2XJHg folded before Flop (didn't bet)
Seat 6: FVs16t7GgfWgQWt4JxsObQ (button) folded on the Flop
Seat 7: knewtTmBc4Tc0z/5tAABYQ (small blind) folded before Flop
Seat 8: zanka7aAZkigmZpfopXxxA (big blind) folded on the Flop



PokerStars Game #59938779838:  Hold'em No Limit ($0.50/$1.00) - 2009/07/01 0:23:18 ET
Table 'eU3bWpDDg3Z+9R4m4iVmog' 6-max Seat #6 is the button
Seat 2: 8CAoOzhmB8n3nRFf3V4BTg ($141.95 in chips)
Seat 3: U6tnjwZRpTnM+YkqkCjwyQ ($156.15 in chips)
Seat 4: GDVIsbEJ/DOJsMKE4Asz0A ($92.95 in chips)
Seat 5: QHvTZcrKe6+maWUfVjP29Q ($103.50 in chips)
Seat 6: hpxXcmRkXXI9HE5+5/j/0Q ($100 in chips)
TSuRyAHnUPCFjP7Z0rEE0w will be allowed to play after the button
TSuRyAHnUPCFjP7Z0rEE0w was removed from the table for failing to post
8CAoOzhmB8n3nRFf3V4BTg: posts small blind $0.50
U6tnjwZRpTnM+YkqkCjwyQ: posts big blind $1
*** HOLE CARDS ***
GDVIsbEJ/DOJsMKE4Asz0A: folds
QHvTZcrKe6+maWUfVjP29Q: folds
hpxXcmRkXXI9HE5+5/j/0Q: folds
esuark2007 joins the table at seat #1
esuark2007 is sitting out
8CAoOzhmB8n3nRFf3V4BTg: calls $0.50
U6tnjwZRpTnM+YkqkCjwyQ: checks
*** FLOP *** [Td 7d 8h]
8CAoOzhmB8n3nRFf3V4BTg: checks
U6tnjwZRpTnM+YkqkCjwyQ: checks
*** TURN *** [Td 7d 8h] [5c]
8CAoOzhmB8n3nRFf3V4BTg: checks
U6tnjwZRpTnM+YkqkCjwyQ: checks
*** RIVER *** [Td 7d 8h 5c] [8s]
esuark2007 leaves the table
8CAoOzhmB8n3nRFf3V4BTg: checks
U6tnjwZRpTnM+YkqkCjwyQ: checks
*** SHOW DOWN ***
8CAoOzhmB8n3nRFf3V4BTg: shows [5h 4h] (two pair, Eights and Fives)
U6tnjwZRpTnM+YkqkCjwyQ: shows [Ts 2s] (two pair, Tens and Eights)
U6tnjwZRpTnM+YkqkCjwyQ collected $1.90 from pot
*** SUMMARY ***
Total pot $2 | Rake $0.10
Board [Td 7d 8h 5c 8s]
Seat 2: 8CAoOzhmB8n3nRFf3V4BTg (small blind) showed [5h 4h] and lost with two pair, Eights and Fives
Seat 3: U6tnjwZRpTnM+YkqkCjwyQ (big blind) showed [Ts 2s] and won ($1.90) with two pair, Tens and Eights
Seat 4: GDVIsbEJ/DOJsMKE4Asz0A folded before Flop (didn't bet)
Seat 5: QHvTZcrKe6+maWUfVjP29Q folded before Flop (didn't bet)
Seat 6: hpxXcmRkXXI9HE5+5/j/0Q (button) folded before Flop (didn't bet)



PokerStars Game #59938782032:  Hold'em No Limit ($0.50/$1.00) - 2009/07/01 0:23:21 ET
Table 'blHlQApStil0OPeQxQxPcwFKpXUINE6M3UxHG4zaMhHAx Seat #7 is the button
Seat 2: wIZ377kjl2fHFGnS93o6bw ($35.50 in chips)
Seat 3: o1axyw4AjQ8n4ubTwlirQQ ($26.20 in chips)
Seat 4: zanka7aAZkigmZpfopXxxA ($35.30 in chips)
Seat 5: uXrDE6JrIi8BZK1L8oQ9bQ ($18.50 in chips)
Seat 6: JPQzLacMGzeh42mPgyrvVQ ($118.20 in chips)
Seat 7: vR4IO10geOgvTW+LAUBv/A ($109.50 in chips)
Seat 8: VtjmCz/ASIcETatNJ8YcCA ($20.65 in chips)
VtjmCz/ASIcETatNJ8YcCA: posts small blind $0.50
wIZ377kjl2fHFGnS93o6bw: posts big blind $1
*** HOLE CARDS ***
o1axyw4AjQ8n4ubTwlirQQ: folds
zanka7aAZkigmZpfopXxxA: folds
uXrDE6JrIi8BZK1L8oQ9bQ: raises $2 to $3
o1axyw4AjQ8n4ubTwlirQQ leaves the table
JPQzLacMGzeh42mPgyrvVQ: calls $3
vR4IO10geOgvTW+LAUBv/A: folds
VtjmCz/ASIcETatNJ8YcCA: folds
wIZ377kjl2fHFGnS93o6bw: folds
*** FLOP *** [As 8h Ad]
uXrDE6JrIi8BZK1L8oQ9bQ: bets $5
JPQzLacMGzeh42mPgyrvVQ: calls $5
*** TURN *** [As 8h Ad] [6c]
uXrDE6JrIi8BZK1L8oQ9bQ: bets $10.50 and is all-in
JPQzLacMGzeh42mPgyrvVQ: folds
uXrDE6JrIi8BZK1L8oQ9bQ collected $16.65 from pot
ouwUBGRKnKK9uhn1G4Lf+A joins the table at seat #9
*** SUMMARY ***
Total pot $17.50 | Rake $0.85
Board [As 8h Ad 6c]
Seat 2: wIZ377kjl2fHFGnS93o6bw (big blind) folded before Flop
Seat 3: o1axyw4AjQ8n4ubTwlirQQ folded before Flop (didn't bet)
Seat 4: zanka7aAZkigmZpfopXxxA folded before Flop (didn't bet)
Seat 5: uXrDE6JrIi8BZK1L8oQ9bQ collected ($16.65)
Seat 6: JPQzLacMGzeh42mPgyrvVQ folded on the Turn
Seat 7: vR4IO10geOgvTW+LAUBv/A (button) folded before Flop (didn't bet)
Seat 8: VtjmCz/ASIcETatNJ8YcCA (small blind) folded before Flop



PokerStars Game #59938782366:  Hold'em No Limit ($0.50/$1.00) - 2009/07/01 0:23:21 ET
Table '6YvsYDPNIDx2v5z3bJnwZQ' 9-max Seat #6 is the button
Seat 1: Ogn4JDV3mp4ZDKO49IFzKA ($17 in chips)
Seat 2: q9qdvTFQkzcAZRujD6rXUA ($98 in chips)
Seat 3: negfosHnGOZXSHpWDRKyBQ ($18.30 in chips)
Seat 4: kEr5NYB+JIG5+szcYMr6hA ($47.50 in chips)
Seat 5: mBRWbnUl8diyBO1qTJaNzw ($168.70 in chips)
Seat 6: uMPEfCcGCfsxmy53tVUMug ($100 in chips)
Seat 7: boixc27eqTYA1p0tUdMuBQ ($115.50 in chips)
Seat 8: PSFxpXgPedVZyHSu2Zhb7Q ($71.90 in chips)
Seat 9: jDwhY1kCdc6EkAHbT7PJMQ ($102.85 in chips)
boixc27eqTYA1p0tUdMuBQ: posts small blind $0.50
PSFxpXgPedVZyHSu2Zhb7Q: posts big blind $1
*** HOLE CARDS ***
jDwhY1kCdc6EkAHbT7PJMQ: folds
Ogn4JDV3mp4ZDKO49IFzKA: folds
q9qdvTFQkzcAZRujD6rXUA: folds
negfosHnGOZXSHpWDRKyBQ: folds
kEr5NYB+JIG5+szcYMr6hA: folds
mBRWbnUl8diyBO1qTJaNzw: folds
uMPEfCcGCfsxmy53tVUMug: raises $2 to $3
boixc27eqTYA1p0tUdMuBQ: folds
PSFxpXgPedVZyHSu2Zhb7Q: calls $2
*** FLOP *** [3h Th Qc]
PSFxpXgPedVZyHSu2Zhb7Q: checks
uMPEfCcGCfsxmy53tVUMug: bets $4.65
PSFxpXgPedVZyHSu2Zhb7Q: calls $4.65
*** TURN *** [3h Th Qc] [Ah]
PSFxpXgPedVZyHSu2Zhb7Q: checks
uMPEfCcGCfsxmy53tVUMug: checks
*** RIVER *** [3h Th Qc Ah] [5c]
q9qdvTFQkzcAZRujD6rXUA leaves the table
PSFxpXgPedVZyHSu2Zhb7Q: checks
uMPEfCcGCfsxmy53tVUMug: checks
*** SHOW DOWN ***
PSFxpXgPedVZyHSu2Zhb7Q: shows [Jd 9s] (high card Ace)
uMPEfCcGCfsxmy53tVUMug: shows [Kd 6h] (high card Ace - King kicker)
uMPEfCcGCfsxmy53tVUMug collected $15.05 from pot
*** SUMMARY ***
Total pot $15.80 | Rake $0.75
Board [3h Th Qc Ah 5c]
Seat 1: Ogn4JDV3mp4ZDKO49IFzKA folded before Flop (didn't bet)
Seat 2: q9qdvTFQkzcAZRujD6rXUA folded before Flop (didn't bet)
Seat 3: negfosHnGOZXSHpWDRKyBQ folded before Flop (didn't bet)
Seat 4: kEr5NYB+JIG5+szcYMr6hA folded before Flop (didn't bet)
Seat 5: mBRWbnUl8diyBO1qTJaNzw folded before Flop (didn't bet)
Seat 6: uMPEfCcGCfsxmy53tVUMug (button) showed [Kd 6h] and won ($15.05) with high card Ace
Seat 7: boixc27eqTYA1p0tUdMuBQ (small blind) folded before Flop
Seat 8: PSFxpXgPedVZyHSu2Zhb7Q (big blind) showed [Jd 9s] and lost with high card Ace
Seat 9: jDwhY1kCdc6EkAHbT7PJMQ folded before Flop (didn't bet)



PokerStars Game #59938782662:  Hold'em No Limit ($0.50/$1.00) - 2009/07/01 0:23:22 ET
Table 'VOs36P6NW+QyXeQ1B62kmA' 6-max Seat #2 is the button
Seat 1: AdLVjddOzm+sRNo1Bc3S6Q ($142.55 in chips)
Seat 2: KpnW5CcJ4Mg6MeclfKmLrw ($109.80 in chips)
Seat 5: X7GlkHF+lkbarCLuZ4Uf0w ($20 in chips)
Seat 6: 6tvjsJrdmWg+g7FVrMnzXA ($68.15 in chips)
TSuRyAHnUPCFjP7Z0rEE0w will be allowed to play after the button
X7GlkHF+lkbarCLuZ4Uf0w: posts small blind $0.50
6tvjsJrdmWg+g7FVrMnzXA: posts big blind $1
*** HOLE CARDS ***
AdLVjddOzm+sRNo1Bc3S6Q: raises $3 to $4
KpnW5CcJ4Mg6MeclfKmLrw: folds
X7GlkHF+lkbarCLuZ4Uf0w: folds
6tvjsJrdmWg+g7FVrMnzXA: calls $3
*** FLOP *** [4h 5d 8h]
6tvjsJrdmWg+g7FVrMnzXA: checks
TSuRyAHnUPCFjP7Z0rEE0w was removed from the table for failing to post
AdLVjddOzm+sRNo1Bc3S6Q: checks
*** TURN *** [4h 5d 8h] [Js]
6tvjsJrdmWg+g7FVrMnzXA: checks
AdLVjddOzm+sRNo1Bc3S6Q: checks
*** RIVER *** [4h 5d 8h Js] [Qd]
TSuRyAHnUPCFjP7Z0rEE0w joins the table at seat #3
w02zQzNydODiyV9THKgo9w joins the table at seat #4
6tvjsJrdmWg+g7FVrMnzXA: checks
AdLVjddOzm+sRNo1Bc3S6Q: checks
*** SHOW DOWN ***
6tvjsJrdmWg+g7FVrMnzXA: shows [Th Jc] (a pair of Jacks)
AdLVjddOzm+sRNo1Bc3S6Q: mucks hand
6tvjsJrdmWg+g7FVrMnzXA collected $8.10 from pot
*** SUMMARY ***
Total pot $8.50 | Rake $0.40
Board [4h 5d 8h Js Qd]
Seat 1: AdLVjddOzm+sRNo1Bc3S6Q mucked
Seat 2: KpnW5CcJ4Mg6MeclfKmLrw (button) folded before Flop (didn't bet)
Seat 5: X7GlkHF+lkbarCLuZ4Uf0w (small blind) folded before Flop
Seat 6: 6tvjsJrdmWg+g7FVrMnzXA (big blind) showed [Th Jc] and won ($8.10) with a pair of Jacks



PokerStars Game #59938782730:  Hold'em No Limit ($0.50/$1.00) - 2009/07/01 0:23:22 ET
Table 'pHrhryH8jPNdQfY62f8v+g' 6-max Seat #1 is the button
Seat 1: BdbmJTZZ47quA9vUWwXtlw ($68.25 in chips)
Seat 2: RqgF7gRoKgRNW8Zoi1ty4A ($111.10 in chips)
Seat 3: 0WjiuIT7/EolY1oOx1ngeA ($100 in chips)
Seat 4: wenbG7TaM3H7h5kn78OFNw ($62.50 in chips)
Seat 5: Gp2euK/nqF6qXKe7U+jOfw ($118.65 in chips)
RqgF7gRoKgRNW8Zoi1ty4A: posts small blind $0.50
wenbG7TaM3H7h5kn78OFNw said, "post"
0WjiuIT7/EolY1oOx1ngeA: posts big blind $1
xAU6q2/cwmby2sxmA8VcmA: sits out
*** HOLE CARDS ***
wenbG7TaM3H7h5kn78OFNw: folds
Gp2euK/nqF6qXKe7U+jOfw: folds
BdbmJTZZ47quA9vUWwXtlw: folds
RqgF7gRoKgRNW8Zoi1ty4A: folds
0WjiuIT7/EolY1oOx1ngeA collected $1 from pot
*** SUMMARY ***
Total pot $1 | Rake $0
Seat 1: BdbmJTZZ47quA9vUWwXtlw (button) folded before Flop (didn't bet)
Seat 2: RqgF7gRoKgRNW8Zoi1ty4A (small blind) folded before Flop
Seat 3: 0WjiuIT7/EolY1oOx1ngeA (big blind) collected ($1)
Seat 4: wenbG7TaM3H7h5kn78OFNw folded before Flop (didn't bet)
Seat 5: Gp2euK/nqF6qXKe7U+jOfw folded before Flop (didn't bet)



PokerStars Game #59938783186:  Hold'em No Limit ($0.50/$1.00) - 2009/07/01 0:23:23 ET
Table 'aWHveb63HkbTmOGHOxjBkQ' 2-max Seat #2 is the button
Seat 1: xy2MQKoHoCZZIudmw8Xbow ($272.80 in chips)
Seat 2: xstEKavv3YDxpUnU4e9qAQ ($100.60 in chips)
xstEKavv3YDxpUnU4e9qAQ: posts small blind $0.50
xy2MQKoHoCZZIudmw8Xbow: posts big blind $1
*** HOLE CARDS ***
xstEKavv3YDxpUnU4e9qAQ: raises $3 to $4
xy2MQKoHoCZZIudmw8Xbow: calls $3
*** FLOP *** [4d 5s 3c]
xy2MQKoHoCZZIudmw8Xbow: checks
xstEKavv3YDxpUnU4e9qAQ: checks
*** TURN *** [4d 5s 3c] [3d]
xy2MQKoHoCZZIudmw8Xbow: bets $4
xstEKavv3YDxpUnU4e9qAQ: folds
xy2MQKoHoCZZIudmw8Xbow collected $7.60 from pot
xy2MQKoHoCZZIudmw8Xbow: doesn't show hand
*** SUMMARY ***
Total pot $8 | Rake $0.40
Board [4d 5s 3c 3d]
Seat 1: xy2MQKoHoCZZIudmw8Xbow (big blind) collected ($7.60)
Seat 2: xstEKavv3YDxpUnU4e9qAQ (button) (small blind) folded on the Turn



PokerStars Game #59938784892:  Hold'em No Limit ($0.50/$1.00) - 2009/07/01 0:23:25 ET
Table 'vs/5jr6ciwjVQ5+Soc+u2A' 6-max Seat #5 is the button
Seat 2: XOIf9W+VAxhZqN+SYoyMKA ($115.80 in chips)
Seat 3: G5ZSSN6RSON3gkNvk/SmYg ($102.20 in chips)
Seat 4: KpnW5CcJ4Mg6MeclfKmLrw ($104.65 in chips)
Seat 5: 7Vc9JmGFQwMRh5Tj9ui5Lw ($98.65 in chips)
Seat 6: QHvTZcrKe6+maWUfVjP29Q ($100.50 in chips)
QHvTZcrKe6+maWUfVjP29Q: posts small blind $0.50
XOIf9W+VAxhZqN+SYoyMKA: posts big blind $1
*** HOLE CARDS ***
G5ZSSN6RSON3gkNvk/SmYg: folds
KpnW5CcJ4Mg6MeclfKmLrw: raises $2 to $3
7Vc9JmGFQwMRh5Tj9ui5Lw: folds
QHvTZcrKe6+maWUfVjP29Q: folds
XOIf9W+VAxhZqN+SYoyMKA: folds
KpnW5CcJ4Mg6MeclfKmLrw collected $2.50 from pot
KpnW5CcJ4Mg6MeclfKmLrw: doesn't show hand
*** SUMMARY ***
Total pot $2.50 | Rake $0
Seat 2: XOIf9W+VAxhZqN+SYoyMKA (big blind) folded before Flop
Seat 3: G5ZSSN6RSON3gkNvk/SmYg folded before Flop (didn't bet)
Seat 4: KpnW5CcJ4Mg6MeclfKmLrw collected ($2.50)
Seat 5: 7Vc9JmGFQwMRh5Tj9ui5Lw (button) folded before Flop (didn't bet)
Seat 6: QHvTZcrKe6+maWUfVjP29Q (small blind) folded before Flop



PokerStars Game #59938785298:  Hold'em No Limit ($0.50/$1.00) - 2009/07/01 0:23:26 ET
Table 'MUPc8FEpe/nR0BKSeReX6Q' 6-max Seat #2 is the button
Seat 1: YsLQ3BAvgQHWXMAv3Wv6Hg ($100 in chips)
Seat 2: xAU6q2/cwmby2sxmA8VcmA ($100 in chips)
Seat 3: wx3sQGkVi2x9wJXuWNHPBw ($234.55 in chips)
Seat 4: ZA1bp6g8IwtTxkUE4eCjDQ ($114.95 in chips)
Seat 5: UBZQqpnJZdTYYY1FTb0rLA ($101.50 in chips)
Seat 6: oxnw0GLLpFanjhGkxfRSqA ($51.40 in chips)
wx3sQGkVi2x9wJXuWNHPBw: posts small blind $0.50
ZA1bp6g8IwtTxkUE4eCjDQ: posts big blind $1
*** HOLE CARDS ***
UBZQqpnJZdTYYY1FTb0rLA: folds
oxnw0GLLpFanjhGkxfRSqA: folds
YsLQ3BAvgQHWXMAv3Wv6Hg: folds
xAU6q2/cwmby2sxmA8VcmA: folds
wx3sQGkVi2x9wJXuWNHPBw: folds
ZA1bp6g8IwtTxkUE4eCjDQ collected $1 from pot
ZA1bp6g8IwtTxkUE4eCjDQ: doesn't show hand
*** SUMMARY ***
Total pot $1 | Rake $0
Seat 1: YsLQ3BAvgQHWXMAv3Wv6Hg folded before Flop (didn't bet)
Seat 2: xAU6q2/cwmby2sxmA8VcmA (button) folded before Flop (didn't bet)
Seat 3: wx3sQGkVi2x9wJXuWNHPBw (small blind) folded before Flop
Seat 4: ZA1bp6g8IwtTxkUE4eCjDQ (big blind) collected ($1)
Seat 5: UBZQqpnJZdTYYY1FTb0rLA folded before Flop (didn't bet)
Seat 6: oxnw0GLLpFanjhGkxfRSqA folded before Flop (didn't bet)



PokerStars Game #59938786520:  Hold'em No Limit ($0.50/$1.00) - 2009/07/01 0:23:28 ET
Table 'tLrtq7gDzxEvckNAI1OS5Q' 6-max Seat #6 is the button
Seat 1: GisIe1kcC9q/xV6ifsTjgA ($153.85 in chips)
Seat 2: qsObMEIlRO22OlS867m/lw ($4.70 in chips)
Seat 3: TPZ+m9x+lwoKpv7TMfAUWA ($321.75 in chips)
Seat 4: KOG8rG51mOvIoY96zF3kvw ($161.80 in chips)
Seat 5: OGMLOcTNYZXZU81au7ztUw ($176.85 in chips)
Seat 6: XUk5GQsfNFpHvaToDZ0rZA ($44.95 in chips)
GisIe1kcC9q/xV6ifsTjgA: posts small blind $0.50
qsObMEIlRO22OlS867m/lw: posts big blind $1
*** HOLE CARDS ***
TPZ+m9x+lwoKpv7TMfAUWA: folds
KOG8rG51mOvIoY96zF3kvw: folds
OGMLOcTNYZXZU81au7ztUw: folds
XUk5GQsfNFpHvaToDZ0rZA: folds
GisIe1kcC9q/xV6ifsTjgA: folds
qsObMEIlRO22OlS867m/lw collected $1 from pot
*** SUMMARY ***
Total pot $1 | Rake $0
Seat 1: GisIe1kcC9q/xV6ifsTjgA (small blind) folded before Flop
Seat 2: qsObMEIlRO22OlS867m/lw (big blind) collected ($1)
Seat 3: TPZ+m9x+lwoKpv7TMfAUWA folded before Flop (didn't bet)
Seat 4: KOG8rG51mOvIoY96zF3kvw folded before Flop (didn't bet)
Seat 5: OGMLOcTNYZXZU81au7ztUw folded before Flop (didn't bet)
Seat 6: XUk5GQsfNFpHvaToDZ0rZA (button) folded before Flop (didn't bet)



PokerStars Game #59938787268:  Hold'em No Limit ($0.50/$1.00) - 2009/07/01 0:23:29 ET
Table 'cBDNutyLBKEk9+ptwsKmTw' 6-max Seat #4 is the button
Seat 1: tb0dt30qP2x/8f+Xta4mVg ($20.80 in chips)
Seat 2: KyaE4+hWgUNIWWOWy4D14w ($62.95 in chips)
Seat 3: G5ZSSN6RSON3gkNvk/SmYg ($105.90 in chips)
Seat 4: 0WjiuIT7/EolY1oOx1ngeA ($105.15 in chips)
Seat 5: OGMLOcTNYZXZU81au7ztUw ($110.20 in chips)
Seat 6: pyzhFUPPSNzrysiMqlA5Xw ($13.10 in chips)
OGMLOcTNYZXZU81au7ztUw: posts small blind $0.50
pyzhFUPPSNzrysiMqlA5Xw: posts big blind $1
*** HOLE CARDS ***
tb0dt30qP2x/8f+Xta4mVg: folds
KyaE4+hWgUNIWWOWy4D14w: calls $1
G5ZSSN6RSON3gkNvk/SmYg: folds
0WjiuIT7/EolY1oOx1ngeA: folds
OGMLOcTNYZXZU81au7ztUw: folds
pyzhFUPPSNzrysiMqlA5Xw: checks
*** FLOP *** [Tc Qh 8h]
pyzhFUPPSNzrysiMqlA5Xw: checks
KyaE4+hWgUNIWWOWy4D14w: bets $1
pyzhFUPPSNzrysiMqlA5Xw: calls $1
*** TURN *** [Tc Qh 8h] [5d]
pyzhFUPPSNzrysiMqlA5Xw: checks
KyaE4+hWgUNIWWOWy4D14w: bets $1
pyzhFUPPSNzrysiMqlA5Xw: folds
KyaE4+hWgUNIWWOWy4D14w collected $4.30 from pot
*** SUMMARY ***
Total pot $4.50 | Rake $0.20
Board [Tc Qh 8h 5d]
Seat 1: tb0dt30qP2x/8f+Xta4mVg folded before Flop (didn't bet)
Seat 2: KyaE4+hWgUNIWWOWy4D14w collected ($4.30)
Seat 3: G5ZSSN6RSON3gkNvk/SmYg folded before Flop (didn't bet)
Seat 4: 0WjiuIT7/EolY1oOx1ngeA (button) folded before Flop (didn't bet)
Seat 5: OGMLOcTNYZXZU81au7ztUw (small blind) folded before Flop
Seat 6: pyzhFUPPSNzrysiMqlA5Xw (big blind) folded on the Turn



PokerStars Game #59938788574:  Hold'em No Limit ($0.50/$1.00) - 2009/07/01 0:23:31 ET
Table 'tyUh+jyNvrceIQdKMJjQ2wZFWj23PMihdwrNWv41OG/Qeat #3 is the button
Seat 1: o8A5MUdudVKu+pAwgZOX2w ($194.25 in chips)
Seat 2: 6iVcnPw9a2oNG6sPQo3G6g ($100 in chips)
Seat 3: L9qfLYXrczhAPd/VckgsWw ($37.95 in chips)
Seat 4: TSuRyAHnUPCFjP7Z0rEE0w ($158.95 in chips)
Seat 5: j7NIOHLZk7V2o9fOioO5ug ($103.95 in chips)
Seat 6: YsLQ3BAvgQHWXMAv3Wv6Hg ($106.75 in chips)
TSuRyAHnUPCFjP7Z0rEE0w: posts small blind $0.50
j7NIOHLZk7V2o9fOioO5ug: posts big blind $1
*** HOLE CARDS ***
YsLQ3BAvgQHWXMAv3Wv6Hg: folds
o8A5MUdudVKu+pAwgZOX2w: folds
6iVcnPw9a2oNG6sPQo3G6g: folds
L9qfLYXrczhAPd/VckgsWw: folds
TSuRyAHnUPCFjP7Z0rEE0w: raises $3 to $4
j7NIOHLZk7V2o9fOioO5ug: folds
TSuRyAHnUPCFjP7Z0rEE0w collected $2 from pot
TSuRyAHnUPCFjP7Z0rEE0w: doesn't show hand
*** SUMMARY ***
Total pot $2 | Rake $0
Seat 1: o8A5MUdudVKu+pAwgZOX2w folded before Flop (didn't bet)
Seat 2: 6iVcnPw9a2oNG6sPQo3G6g folded before Flop (didn't bet)
Seat 3: L9qfLYXrczhAPd/VckgsWw (button) folded before Flop (didn't bet)
Seat 4: TSuRyAHnUPCFjP7Z0rEE0w (small blind) collected ($2)
Seat 5: j7NIOHLZk7V2o9fOioO5ug (big blind) folded before Flop
Seat 6: YsLQ3BAvgQHWXMAv3Wv6Hg folded before Flop (didn't bet)



PokerStars Game #59938790344:  Hold'em No Limit ($0.50/$1.00) - 2009/07/01 0:23:34 ET
Table 'rmZfTK+oSebeUPJNbWhdAA' 6-max Seat #5 is the button
Seat 1: xAU6q2/cwmby2sxmA8VcmA ($100 in chips)
Seat 2: OigyyiK+tTj1APPIAUmXDA ($79.70 in chips)
Seat 3: 9yjOzGERLaEZS8CZ6YNHFg ($61.30 in chips)
Seat 4: OGMLOcTNYZXZU81au7ztUw ($126.65 in chips)
Seat 5: VuZb/hkEc4X7s93w2ZZTpA ($111.25 in chips)
Seat 6: j7NIOHLZk7V2o9fOioO5ug ($105.30 in chips)
j7NIOHLZk7V2o9fOioO5ug: posts small blind $0.50
xAU6q2/cwmby2sxmA8VcmA: posts big blind $1
*** HOLE CARDS ***
OigyyiK+tTj1APPIAUmXDA: folds
9yjOzGERLaEZS8CZ6YNHFg: folds
OGMLOcTNYZXZU81au7ztUw: folds
VuZb/hkEc4X7s93w2ZZTpA: folds
j7NIOHLZk7V2o9fOioO5ug: folds
xAU6q2/cwmby2sxmA8VcmA collected $1 from pot
xAU6q2/cwmby2sxmA8VcmA: doesn't show hand
*** SUMMARY ***
Total pot $1 | Rake $0
Seat 1: xAU6q2/cwmby2sxmA8VcmA (big blind) collected ($1)
Seat 2: OigyyiK+tTj1APPIAUmXDA folded before Flop (didn't bet)
Seat 3: 9yjOzGERLaEZS8CZ6YNHFg folded before Flop (didn't bet)
Seat 4: OGMLOcTNYZXZU81au7ztUw folded before Flop (didn't bet)
Seat 5: VuZb/hkEc4X7s93w2ZZTpA (button) folded before Flop (didn't bet)
Seat 6: j7NIOHLZk7V2o9fOioO5ug (small blind) folded before Flop



PokerStars Game #59938790522:  Hold'em No Limit ($0.50/$1.00) - 2009/07/01 0:23:34 ET
Table 'O96CPOtvMBWP6kzuYDfdFA' 6-max Seat #5 is the button
Seat 1: yl9aRDw7k/ieGiDoJVy+/w ($57.05 in chips)
Seat 2: vTUNrd/7qIOJpW0suEu5hQ ($210.90 in chips)
Seat 3: V89DGjxE171oPREEbAXiyg ($28.75 in chips)
Seat 5: wRxiu9OJzvvN84OYWW9jxQ ($118.85 in chips)
Seat 6: xNKcQzD9+/iHmtJn4vYq9w ($97.60 in chips)
xNKcQzD9+/iHmtJn4vYq9w: posts small blind $0.50
yl9aRDw7k/ieGiDoJVy+/w: posts big blind $1
*** HOLE CARDS ***
vTUNrd/7qIOJpW0suEu5hQ: folds
V89DGjxE171oPREEbAXiyg: calls $1
wRxiu9OJzvvN84OYWW9jxQ: calls $1
xNKcQzD9+/iHmtJn4vYq9w: raises $8 to $9
yl9aRDw7k/ieGiDoJVy+/w is disconnected
yl9aRDw7k/ieGiDoJVy+/w is connected
yl9aRDw7k/ieGiDoJVy+/w: folds
V89DGjxE171oPREEbAXiyg: folds
wRxiu9OJzvvN84OYWW9jxQ: folds
xNKcQzD9+/iHmtJn4vYq9w collected $4 from pot
*** SUMMARY ***
Total pot $4 | Rake $0
Seat 1: yl9aRDw7k/ieGiDoJVy+/w (big blind) folded before Flop
Seat 2: vTUNrd/7qIOJpW0suEu5hQ folded before Flop (didn't bet)
Seat 3: V89DGjxE171oPREEbAXiyg folded before Flop
Seat 5: wRxiu9OJzvvN84OYWW9jxQ (button) folded before Flop
Seat 6: xNKcQzD9+/iHmtJn4vYq9w (small blind) collected ($4)



PokerStars Game #59938791894:  Hold'em No Limit ($0.50/$1.00) - 2009/07/01 0:23:36 ET
Table 'SQLOQoANiHscJ8AL7zffbw' 9-max Seat #7 is the button
Seat 1: jPTRd6SpCp4xqAy2XQiTOw ($119.85 in chips)
Seat 2: /zy+DB4S5fUQUSfZWFzYGw ($280.35 in chips)
Seat 3: 0eFnow7+D7veCYQ+CG9FFw ($71.50 in chips)
Seat 4: N9n5Wc3s35DpCrOAUUNAaQ ($120.30 in chips)
Seat 5: L9njYvloJ1NdXjP8edHEAg ($110.55 in chips)
Seat 6: p5UKaxVobvptF0ANhR/q1A ($157 in chips)
Seat 7: bJckevFOcg//s0qyMQI6sQ ($103.55 in chips)
Seat 8: 9ce+0Dl3d0BeEFIP+8HezA ($19 in chips)
Seat 9: qJr25HAtvv1w/7IBvjMM3g ($215.70 in chips)
9ce+0Dl3d0BeEFIP+8HezA: posts small blind $0.50
qJr25HAtvv1w/7IBvjMM3g: posts big blind $1
*** HOLE CARDS ***
jPTRd6SpCp4xqAy2XQiTOw: folds
/zy+DB4S5fUQUSfZWFzYGw: folds
0eFnow7+D7veCYQ+CG9FFw: folds
N9n5Wc3s35DpCrOAUUNAaQ: folds
L9njYvloJ1NdXjP8edHEAg: folds
p5UKaxVobvptF0ANhR/q1A: folds
bJckevFOcg//s0qyMQI6sQ: folds
9ce+0Dl3d0BeEFIP+8HezA: folds
qJr25HAtvv1w/7IBvjMM3g collected $1 from pot
qJr25HAtvv1w/7IBvjMM3g: doesn't show hand
*** SUMMARY ***
Total pot $1 | Rake $0
Seat 1: jPTRd6SpCp4xqAy2XQiTOw folded before Flop (didn't bet)
Seat 2: /zy+DB4S5fUQUSfZWFzYGw folded before Flop (didn't bet)
Seat 3: 0eFnow7+D7veCYQ+CG9FFw folded before Flop (didn't bet)
Seat 4: N9n5Wc3s35DpCrOAUUNAaQ folded before Flop (didn't bet)
Seat 5: L9njYvloJ1NdXjP8edHEAg folded before Flop (didn't bet)
Seat 6: p5UKaxVobvptF0ANhR/q1A folded before Flop (didn't bet)
Seat 7: bJckevFOcg//s0qyMQI6sQ (button) folded before Flop (didn't bet)
Seat 8: 9ce+0Dl3d0BeEFIP+8HezA (small blind) folded before Flop
Seat 9: qJr25HAtvv1w/7IBvjMM3g (big blind) collected ($1)



PokerStars Game #59938792934:  Hold'em No Limit ($0.50/$1.00) - 2009/07/01 0:23:37 ET
Table 'aWHveb63HkbTmOGHOxjBkQ' 2-max Seat #1 is the button
Seat 1: xy2MQKoHoCZZIudmw8Xbow ($276.40 in chips)
Seat 2: xstEKavv3YDxpUnU4e9qAQ ($96.60 in chips)
xy2MQKoHoCZZIudmw8Xbow: posts small blind $0.50
xstEKavv3YDxpUnU4e9qAQ: posts big blind $1
*** HOLE CARDS ***
xy2MQKoHoCZZIudmw8Xbow: raises $3 to $4
xstEKavv3YDxpUnU4e9qAQ: folds
xy2MQKoHoCZZIudmw8Xbow collected $2 from pot
xy2MQKoHoCZZIudmw8Xbow: doesn't show hand
*** SUMMARY ***
Total pot $2 | Rake $0
Seat 1: xy2MQKoHoCZZIudmw8Xbow (button) (small blind) collected ($2)
Seat 2: xstEKavv3YDxpUnU4e9qAQ (big blind) folded before Flop



PokerStars Game #59938792814:  Hold'em No Limit ($0.50/$1.00) - 2009/07/01 0:23:37 ET
Table '/RZcOwpZpHQ+OwPwjsbnRw' 6-max Seat #4 is the button
Seat 2: dHC9PH9hdH3Ad2TD8ZxX0Q ($40.10 in chips)
Seat 3: OigyyiK+tTj1APPIAUmXDA ($84.65 in chips)
Seat 4: j7NIOHLZk7V2o9fOioO5ug ($102 in chips)
Seat 5: wx3sQGkVi2x9wJXuWNHPBw ($205.55 in chips)
Seat 6: XOIf9W+VAxhZqN+SYoyMKA ($255.30 in chips)
wx3sQGkVi2x9wJXuWNHPBw: posts small blind $0.50
XOIf9W+VAxhZqN+SYoyMKA: posts big blind $1
*** HOLE CARDS ***
dHC9PH9hdH3Ad2TD8ZxX0Q: folds
OigyyiK+tTj1APPIAUmXDA: folds
j7NIOHLZk7V2o9fOioO5ug: folds
wx3sQGkVi2x9wJXuWNHPBw: folds
XOIf9W+VAxhZqN+SYoyMKA collected $1 from pot
XOIf9W+VAxhZqN+SYoyMKA: doesn't show hand
*** SUMMARY ***
Total pot $1 | Rake $0
Seat 2: dHC9PH9hdH3Ad2TD8ZxX0Q folded before Flop (didn't bet)
Seat 3: OigyyiK+tTj1APPIAUmXDA folded before Flop (didn't bet)
Seat 4: j7NIOHLZk7V2o9fOioO5ug (button) folded before Flop (didn't bet)
Seat 5: wx3sQGkVi2x9wJXuWNHPBw (small blind) folded before Flop
Seat 6: XOIf9W+VAxhZqN+SYoyMKA (big blind) collected ($1)



PokerStars Game #59938793508:  Hold'em No Limit ($0.50/$1.00) - 2009/07/01 0:23:38 ET
Table 'ZFWj23PMihdwrNWv41OG/Q' 9-max Seat #8 is the button
Seat 1: yAbu2QsRPVcjPbqlf/jDxw ($102.30 in chips)
Seat 2: ARfmgHcEUKh68laBZy4veA ($57.75 in chips)
Seat 3: G9Fo2TZCN7HI43Po4zSN3A ($100 in chips)
Seat 4: PEmogYqKpuv0ozeBbXL+7Q ($31.50 in chips)
Seat 6: tjhwe1V98x2spSoUQER3HQ ($100 in chips)
Seat 7: wIZ377kjl2fHFGnS93o6bw ($42.55 in chips)
Seat 8: knewtTmBc4Tc0z/5tAABYQ ($107.50 in chips)
yAbu2QsRPVcjPbqlf/jDxw: posts small blind $0.50
ARfmgHcEUKh68laBZy4veA: posts big blind $1
tkdBeXTJlFsZdioidNqLow: sits out
*** HOLE CARDS ***
G9Fo2TZCN7HI43Po4zSN3A: folds
PEmogYqKpuv0ozeBbXL+7Q: folds
tjhwe1V98x2spSoUQER3HQ: folds
wIZ377kjl2fHFGnS93o6bw: calls $1
knewtTmBc4Tc0z/5tAABYQ: folds
yAbu2QsRPVcjPbqlf/jDxw: folds
ARfmgHcEUKh68laBZy4veA: checks
*** FLOP *** [6d 8h 2d]
ARfmgHcEUKh68laBZy4veA: checks
wIZ377kjl2fHFGnS93o6bw: bets $1
ARfmgHcEUKh68laBZy4veA: folds
wIZ377kjl2fHFGnS93o6bw collected $2.40 from pot
*** SUMMARY ***
Total pot $2.50 | Rake $0.10
Board [6d 8h 2d]
Seat 1: yAbu2QsRPVcjPbqlf/jDxw (small blind) folded before Flop
Seat 2: ARfmgHcEUKh68laBZy4veA (big blind) folded on the Flop
Seat 3: G9Fo2TZCN7HI43Po4zSN3A folded before Flop (didn't bet)
Seat 4: PEmogYqKpuv0ozeBbXL+7Q folded before Flop (didn't bet)
Seat 6: tjhwe1V98x2spSoUQER3HQ folded before Flop (didn't bet)
Seat 7: wIZ377kjl2fHFGnS93o6bw collected ($2.40)
Seat 8: knewtTmBc4Tc0z/5tAABYQ (button) folded before Flop (didn't bet)



PokerStars Game #59938793978:  Hold'em No Limit ($0.50/$1.00) - 2009/07/01 0:23:39 ET
Table 'W/wyObTiXZm+Ckkl3YxcSw' 6-max Seat #3 is the button
Seat 1: ssLJburtEIqnVkx6X8R1uw ($117.25 in chips)
Seat 2: oDiBRCaF0QVtd3kO6xZIXw ($100 in chips)
Seat 3: b2a+5TkFf4xJN/Ihhma58Q ($36.70 in chips)
Seat 4: BdbmJTZZ47quA9vUWwXtlw ($47.10 in chips)
Seat 6: 1yB1nHUkHNNY8OJnDNHZMw ($53.20 in chips)
BdbmJTZZ47quA9vUWwXtlw: posts small blind $0.50
1yB1nHUkHNNY8OJnDNHZMw: posts big blind $1
*** HOLE CARDS ***
ssLJburtEIqnVkx6X8R1uw: folds
oDiBRCaF0QVtd3kO6xZIXw: folds
b2a+5TkFf4xJN/Ihhma58Q: folds
BdbmJTZZ47quA9vUWwXtlw: raises $2 to $3
1yB1nHUkHNNY8OJnDNHZMw: calls $2
*** FLOP *** [5d Jh Tc]
BdbmJTZZ47quA9vUWwXtlw: checks
1yB1nHUkHNNY8OJnDNHZMw: bets $3
BdbmJTZZ47quA9vUWwXtlw: folds
1yB1nHUkHNNY8OJnDNHZMw collected $5.70 from pot
*** SUMMARY ***
Total pot $6 | Rake $0.30
Board [5d Jh Tc]
Seat 1: ssLJburtEIqnVkx6X8R1uw folded before Flop (didn't bet)
Seat 2: oDiBRCaF0QVtd3kO6xZIXw folded before Flop (didn't bet)
Seat 3: b2a+5TkFf4xJN/Ihhma58Q (button) folded before Flop (didn't bet)
Seat 4: BdbmJTZZ47quA9vUWwXtlw (small blind) folded on the Flop
Seat 6: 1yB1nHUkHNNY8OJnDNHZMw (big blind) collected ($5.70)



PokerStars Game #59938795088:  Hold'em No Limit ($0.50/$1.00) - 2009/07/01 0:23:40 ET
Table 'mmbQQVBTrPdE+wy+s+9VPA' 6-max Seat #4 is the button
Seat 1: P9iqlRE1diA1wRYdf4YRBQ ($118.40 in chips)
Seat 3: wx3sQGkVi2x9wJXuWNHPBw ($103 in chips)
Seat 4: RfKnhkJN8HEAuzJpH2Ajdg ($20.15 in chips)
Seat 5: YMJG+F++3Aj6P8dAWda5fw ($99 in chips)
Seat 6: klQ/ufr9lOvfLMdAu0S9cw ($26.10 in chips)
YMJG+F++3Aj6P8dAWda5fw: posts small blind $0.50
klQ/ufr9lOvfLMdAu0S9cw: posts big blind $1
ru6SCVvWcWt2SpmUsmArWQ: sits out
*** HOLE CARDS ***
P9iqlRE1diA1wRYdf4YRBQ: raises $2 to $3
wx3sQGkVi2x9wJXuWNHPBw: calls $3
RfKnhkJN8HEAuzJpH2Ajdg: folds
YMJG+F++3Aj6P8dAWda5fw: folds
klQ/ufr9lOvfLMdAu0S9cw: folds
*** FLOP *** [Qs 2c Jd]
P9iqlRE1diA1wRYdf4YRBQ: bets $5
wx3sQGkVi2x9wJXuWNHPBw: calls $5
*** TURN *** [Qs 2c Jd] [9h]
P9iqlRE1diA1wRYdf4YRBQ: checks
wx3sQGkVi2x9wJXuWNHPBw: bets $10.50
P9iqlRE1diA1wRYdf4YRBQ: folds
P9iqlRE1diA1wRYdf4YRBQ is sitting out
wx3sQGkVi2x9wJXuWNHPBw collected $16.65 from pot
*** SUMMARY ***
Total pot $17.50 | Rake $0.85
Board [Qs 2c Jd 9h]
Seat 1: P9iqlRE1diA1wRYdf4YRBQ folded on the Turn
Seat 3: wx3sQGkVi2x9wJXuWNHPBw collected ($16.65)
Seat 4: RfKnhkJN8HEAuzJpH2Ajdg (button) folded before Flop (didn't bet)
Seat 5: YMJG+F++3Aj6P8dAWda5fw (small blind) folded before Flop
Seat 6: klQ/ufr9lOvfLMdAu0S9cw (big blind) folded before Flop



PokerStars Game #59938796078:  Hold'em No Limit ($0.50/$1.00) - 2009/07/01 0:23:42 ET
Table 'N2bNCDHL96aCQDvZIh+yQQ' 6-max Seat #5 is the button
Seat 1: iHo1oDbrEVJ8nEGdaPrICw ($145 in chips)
Seat 2: KpnW5CcJ4Mg6MeclfKmLrw ($102 in chips)
Seat 3: PXT6kJgVX67c3EgncNqRoA ($51.45 in chips)
Seat 4: uCqEjnxh2/vFBjKYkfTOkw ($160.20 in chips)
Seat 5: rHlMOfR7kpQQxe+PFQz0xQ ($37.40 in chips)
Seat 6: TSuRyAHnUPCFjP7Z0rEE0w ($100 in chips)
TSuRyAHnUPCFjP7Z0rEE0w: posts small blind $0.50
iHo1oDbrEVJ8nEGdaPrICw: posts big blind $1
*** HOLE CARDS ***
KpnW5CcJ4Mg6MeclfKmLrw: raises $3 to $4
PXT6kJgVX67c3EgncNqRoA: folds
uCqEjnxh2/vFBjKYkfTOkw: folds
rHlMOfR7kpQQxe+PFQz0xQ: folds
TSuRyAHnUPCFjP7Z0rEE0w: folds
iHo1oDbrEVJ8nEGdaPrICw: folds
KpnW5CcJ4Mg6MeclfKmLrw collected $2.50 from pot
KpnW5CcJ4Mg6MeclfKmLrw: doesn't show hand
*** SUMMARY ***
Total pot $2.50 | Rake $0
Seat 1: iHo1oDbrEVJ8nEGdaPrICw (big blind) folded before Flop
Seat 2: KpnW5CcJ4Mg6MeclfKmLrw collected ($2.50)
Seat 3: PXT6kJgVX67c3EgncNqRoA folded before Flop (didn't bet)
Seat 4: uCqEjnxh2/vFBjKYkfTOkw folded before Flop (didn't bet)
Seat 5: rHlMOfR7kpQQxe+PFQz0xQ (button) folded before Flop (didn't bet)
Seat 6: TSuRyAHnUPCFjP7Z0rEE0w (small blind) folded before Flop



PokerStars Game #59938796830:  Hold'em No Limit ($0.50/$1.00) - 2009/07/01 0:23:43 ET
Table 'GxCPo/gd3OSthkYrAxJngg' 6-max Seat #4 is the button
Seat 1: sH8BpAFP+jGFxCgVpD1Lew ($180.95 in chips)
Seat 2: YExX2paeIHrmfIwV1ivM/w ($85.20 in chips)
Seat 3: h2lYnlZ7Ueu3PsyB2UOfSQ ($98.50 in chips)
Seat 4: YMJG+F++3Aj6P8dAWda5fw ($106.65 in chips)
Seat 5: G5ZSSN6RSON3gkNvk/SmYg ($100 in chips)
Seat 6: sS9IXedL3MiRmpVXhAILhw ($100 in chips)
G5ZSSN6RSON3gkNvk/SmYg: posts small blind $0.50
sS9IXedL3MiRmpVXhAILhw: posts big blind $1
*** HOLE CARDS ***
sH8BpAFP+jGFxCgVpD1Lew: raises $3 to $4
YExX2paeIHrmfIwV1ivM/w: folds
h2lYnlZ7Ueu3PsyB2UOfSQ: calls $4
YMJG+F++3Aj6P8dAWda5fw: folds
G5ZSSN6RSON3gkNvk/SmYg: folds
sS9IXedL3MiRmpVXhAILhw: calls $3
*** FLOP *** [4d Kd Ts]
sS9IXedL3MiRmpVXhAILhw: checks
sH8BpAFP+jGFxCgVpD1Lew: bets $10
h2lYnlZ7Ueu3PsyB2UOfSQ: raises $16 to $26
sS9IXedL3MiRmpVXhAILhw: folds
sH8BpAFP+jGFxCgVpD1Lew: calls $16
*** TURN *** [4d Kd Ts] [6h]
sH8BpAFP+jGFxCgVpD1Lew: checks
h2lYnlZ7Ueu3PsyB2UOfSQ: bets $32
sH8BpAFP+jGFxCgVpD1Lew: calls $32
*** RIVER *** [4d Kd Ts 6h] [2c]
sH8BpAFP+jGFxCgVpD1Lew: checks
h2lYnlZ7Ueu3PsyB2UOfSQ: bets $36.50 and is all-in
sH8BpAFP+jGFxCgVpD1Lew: calls $36.50
*** SHOW DOWN ***
h2lYnlZ7Ueu3PsyB2UOfSQ: shows [Qd Jc] (high card King)
sH8BpAFP+jGFxCgVpD1Lew: shows [Ks Js] (a pair of Kings)
sH8BpAFP+jGFxCgVpD1Lew collected $198.50 from pot
*** SUMMARY ***
Total pot $201.50 | Rake $3
Board [4d Kd Ts 6h 2c]
Seat 1: sH8BpAFP+jGFxCgVpD1Lew showed [Ks Js] and won ($198.50) with a pair of Kings
Seat 2: YExX2paeIHrmfIwV1ivM/w folded before Flop (didn't bet)
Seat 3: h2lYnlZ7Ueu3PsyB2UOfSQ showed [Qd Jc] and lost with high card King
Seat 4: YMJG+F++3Aj6P8dAWda5fw (button) folded before Flop (didn't bet)
Seat 5: G5ZSSN6RSON3gkNvk/SmYg (small blind) folded before Flop
Seat 6: sS9IXedL3MiRmpVXhAILhw (big blind) folded on the Flop



PokerStars Game #59938797658:  Hold'em No Limit ($0.50/$1.00) - 2009/07/01 0:23:44 ET
Table 'tLrtq7gDzxEvckNAI1OS5Q' 6-max Seat #1 is the button
Seat 1: GisIe1kcC9q/xV6ifsTjgA ($153.35 in chips)
Seat 2: qsObMEIlRO22OlS867m/lw ($5.20 in chips)
Seat 3: TPZ+m9x+lwoKpv7TMfAUWA ($321.75 in chips)
Seat 4: KOG8rG51mOvIoY96zF3kvw ($161.80 in chips)
Seat 5: OGMLOcTNYZXZU81au7ztUw ($176.85 in chips)
Seat 6: XUk5GQsfNFpHvaToDZ0rZA ($44.95 in chips)
qsObMEIlRO22OlS867m/lw: posts small blind $0.50
TPZ+m9x+lwoKpv7TMfAUWA: posts big blind $1
*** HOLE CARDS ***
KOG8rG51mOvIoY96zF3kvw: folds
OGMLOcTNYZXZU81au7ztUw: folds
XUk5GQsfNFpHvaToDZ0rZA: folds
GisIe1kcC9q/xV6ifsTjgA: folds
qsObMEIlRO22OlS867m/lw: raises $4.20 to $5.20 and is all-in
TPZ+m9x+lwoKpv7TMfAUWA: calls $4.20
*** FLOP *** [6s Qd 9s]
*** TURN *** [6s Qd 9s] [Ad]
*** RIVER *** [6s Qd 9s Ad] [Kd]
*** SHOW DOWN ***
qsObMEIlRO22OlS867m/lw: shows [As Jc] (a pair of Aces)
TPZ+m9x+lwoKpv7TMfAUWA: mucks hand
qsObMEIlRO22OlS867m/lw collected $9.90 from pot
*** SUMMARY ***
Total pot $10.40 | Rake $0.50
Board [6s Qd 9s Ad Kd]
Seat 1: GisIe1kcC9q/xV6ifsTjgA (button) folded before Flop (didn't bet)
Seat 2: qsObMEIlRO22OlS867m/lw (small blind) showed [As Jc] and won ($9.90) with a pair of Aces
Seat 3: TPZ+m9x+lwoKpv7TMfAUWA (big blind) mucked
Seat 4: KOG8rG51mOvIoY96zF3kvw folded before Flop (didn't bet)
Seat 5: OGMLOcTNYZXZU81au7ztUw folded before Flop (didn't bet)
Seat 6: XUk5GQsfNFpHvaToDZ0rZA folded before Flop (didn't bet)



PokerStars Game #59938797248:  Hold'em No Limit ($0.50/$1.00) - 2009/07/01 0:23:44 ET
Table 'vs/5jr6ciwjVQ5+Soc+u2A' 6-max Seat #6 is the button
Seat 2: XOIf9W+VAxhZqN+SYoyMKA ($114.80 in chips)
Seat 3: G5ZSSN6RSON3gkNvk/SmYg ($102.20 in chips)
Seat 4: KpnW5CcJ4Mg6MeclfKmLrw ($106.15 in chips)
Seat 5: 7Vc9JmGFQwMRh5Tj9ui5Lw ($98.65 in chips)
Seat 6: QHvTZcrKe6+maWUfVjP29Q ($100 in chips)
XOIf9W+VAxhZqN+SYoyMKA: posts small blind $0.50
G5ZSSN6RSON3gkNvk/SmYg: posts big blind $1
*** HOLE CARDS ***
KpnW5CcJ4Mg6MeclfKmLrw: folds
7Vc9JmGFQwMRh5Tj9ui5Lw: folds
QHvTZcrKe6+maWUfVjP29Q: folds
XOIf9W+VAxhZqN+SYoyMKA: raises $2 to $3
G5ZSSN6RSON3gkNvk/SmYg: folds
XOIf9W+VAxhZqN+SYoyMKA collected $2 from pot
XOIf9W+VAxhZqN+SYoyMKA: doesn't show hand
*** SUMMARY ***
Total pot $2 | Rake $0
Seat 2: XOIf9W+VAxhZqN+SYoyMKA (small blind) collected ($2)
Seat 3: G5ZSSN6RSON3gkNvk/SmYg (big blind) folded before Flop
Seat 4: KpnW5CcJ4Mg6MeclfKmLrw folded before Flop (didn't bet)
Seat 5: 7Vc9JmGFQwMRh5Tj9ui5Lw folded before Flop (didn't bet)
Seat 6: QHvTZcrKe6+maWUfVjP29Q (button) folded before Flop (didn't bet)



PokerStars Game #59938798188:  Hold'em No Limit ($0.50/$1.00) - 2009/07/01 0:23:45 ET
Table 'fTlPiCj0utgzC/5io+I7ew' 6-max Seat #5 is the button
Seat 1: YMJG+F++3Aj6P8dAWda5fw ($99 in chips)
Seat 2: +xUCTmR3cU7G239W+vZv6g ($146.35 in chips)
Seat 3: oDiBRCaF0QVtd3kO6xZIXw ($100 in chips)
Seat 4: uJVSceLggtsrJya+WtmUEA ($92.10 in chips)
Seat 5: bFrTkDcWGTxyvNul7GVdYg ($246.35 in chips)
YMJG+F++3Aj6P8dAWda5fw: posts small blind $0.50
+xUCTmR3cU7G239W+vZv6g: posts big blind $1
*** HOLE CARDS ***
oDiBRCaF0QVtd3kO6xZIXw: folds
uJVSceLggtsrJya+WtmUEA: raises $2 to $3
bFrTkDcWGTxyvNul7GVdYg: folds
YMJG+F++3Aj6P8dAWda5fw: folds
+xUCTmR3cU7G239W+vZv6g: folds
uJVSceLggtsrJya+WtmUEA collected $2.50 from pot
*** SUMMARY ***
Total pot $2.50 | Rake $0
Seat 1: YMJG+F++3Aj6P8dAWda5fw (small blind) folded before Flop
Seat 2: +xUCTmR3cU7G239W+vZv6g (big blind) folded before Flop
Seat 3: oDiBRCaF0QVtd3kO6xZIXw folded before Flop (didn't bet)
Seat 4: uJVSceLggtsrJya+WtmUEA collected ($2.50)
Seat 5: bFrTkDcWGTxyvNul7GVdYg (button) folded before Flop (didn't bet)



PokerStars Game #59938797726:  Hold'em No Limit ($0.50/$1.00) - 2009/07/01 0:23:45 ET
Table 'MUPc8FEpe/nR0BKSeReX6Q' 6-max Seat #3 is the button
Seat 1: YsLQ3BAvgQHWXMAv3Wv6Hg ($100 in chips)
Seat 2: xAU6q2/cwmby2sxmA8VcmA ($100 in chips)
Seat 3: wx3sQGkVi2x9wJXuWNHPBw ($234.05 in chips)
Seat 4: ZA1bp6g8IwtTxkUE4eCjDQ ($115.45 in chips)
Seat 5: UBZQqpnJZdTYYY1FTb0rLA ($101.50 in chips)
Seat 6: oxnw0GLLpFanjhGkxfRSqA ($51.40 in chips)
ZA1bp6g8IwtTxkUE4eCjDQ: posts small blind $0.50
UBZQqpnJZdTYYY1FTb0rLA: posts big blind $1
*** HOLE CARDS ***
oxnw0GLLpFanjhGkxfRSqA: raises $2 to $3
YsLQ3BAvgQHWXMAv3Wv6Hg: folds
xAU6q2/cwmby2sxmA8VcmA: folds
wx3sQGkVi2x9wJXuWNHPBw has timed out
wx3sQGkVi2x9wJXuWNHPBw: folds
wx3sQGkVi2x9wJXuWNHPBw is sitting out
ZA1bp6g8IwtTxkUE4eCjDQ: folds
UBZQqpnJZdTYYY1FTb0rLA: folds
wx3sQGkVi2x9wJXuWNHPBw has returned
oxnw0GLLpFanjhGkxfRSqA collected $2.50 from pot
*** SUMMARY ***
Total pot $2.50 | Rake $0
Seat 1: YsLQ3BAvgQHWXMAv3Wv6Hg folded before Flop (didn't bet)
Seat 2: xAU6q2/cwmby2sxmA8VcmA folded before Flop (didn't bet)
Seat 3: wx3sQGkVi2x9wJXuWNHPBw (button) folded before Flop (didn't bet)
Seat 4: ZA1bp6g8IwtTxkUE4eCjDQ (small blind) folded before Flop
Seat 5: UBZQqpnJZdTYYY1FTb0rLA (big blind) folded before Flop
Seat 6: oxnw0GLLpFanjhGkxfRSqA collected ($2.50)



PokerStars Game #59938798116:  Hold'em No Limit ($0.50/$1.00) - 2009/07/01 0:23:45 ET
Table 'aWHveb63HkbTmOGHOxjBkQ' 2-max Seat #2 is the button
Seat 1: xy2MQKoHoCZZIudmw8Xbow ($277.40 in chips)
Seat 2: xstEKavv3YDxpUnU4e9qAQ ($95.60 in chips)
xstEKavv3YDxpUnU4e9qAQ: posts small blind $0.50
xy2MQKoHoCZZIudmw8Xbow: posts big blind $1
*** HOLE CARDS ***
xstEKavv3YDxpUnU4e9qAQ: folds
xy2MQKoHoCZZIudmw8Xbow collected $1 from pot
xy2MQKoHoCZZIudmw8Xbow: doesn't show hand
*** SUMMARY ***
Total pot $1 | Rake $0
Seat 1: xy2MQKoHoCZZIudmw8Xbow (big blind) collected ($1)
Seat 2: xstEKavv3YDxpUnU4e9qAQ (button) (small blind) folded before Flop



PokerStars Game #59938799462:  Hold'em No Limit ($0.50/$1.00) - 2009/07/01 0:23:47 ET
Table 'tyUh+jyNvrceIQdKMJjQ2wZFWj23PMihdwrNWv41OG/Qeat #4 is the button
Seat 1: o8A5MUdudVKu+pAwgZOX2w ($194.25 in chips)
Seat 2: 6iVcnPw9a2oNG6sPQo3G6g ($100 in chips)
Seat 3: L9qfLYXrczhAPd/VckgsWw ($37.95 in chips)
Seat 4: TSuRyAHnUPCFjP7Z0rEE0w ($159.95 in chips)
Seat 5: j7NIOHLZk7V2o9fOioO5ug ($102.95 in chips)
Seat 6: YsLQ3BAvgQHWXMAv3Wv6Hg ($106.75 in chips)
j7NIOHLZk7V2o9fOioO5ug: posts small blind $0.50
YsLQ3BAvgQHWXMAv3Wv6Hg: posts big blind $1
*** HOLE CARDS ***
o8A5MUdudVKu+pAwgZOX2w: calls $1
6iVcnPw9a2oNG6sPQo3G6g: folds
L9qfLYXrczhAPd/VckgsWw: folds
TSuRyAHnUPCFjP7Z0rEE0w: folds
j7NIOHLZk7V2o9fOioO5ug: folds
YsLQ3BAvgQHWXMAv3Wv6Hg: checks
*** FLOP *** [Kd 4s 3s]
YsLQ3BAvgQHWXMAv3Wv6Hg: checks
o8A5MUdudVKu+pAwgZOX2w: bets $2
YsLQ3BAvgQHWXMAv3Wv6Hg: folds
o8A5MUdudVKu+pAwgZOX2w collected $2.40 from pot
o8A5MUdudVKu+pAwgZOX2w: doesn't show hand
*** SUMMARY ***
Total pot $2.50 | Rake $0.10
Board [Kd 4s 3s]
Seat 1: o8A5MUdudVKu+pAwgZOX2w collected ($2.40)
Seat 2: 6iVcnPw9a2oNG6sPQo3G6g folded before Flop (didn't bet)
Seat 3: L9qfLYXrczhAPd/VckgsWw folded before Flop (didn't bet)
Seat 4: TSuRyAHnUPCFjP7Z0rEE0w (button) folded before Flop (didn't bet)
Seat 5: j7NIOHLZk7V2o9fOioO5ug (small blind) folded before Flop
Seat 6: YsLQ3BAvgQHWXMAv3Wv6Hg (big blind) folded on the Flop



PokerStars Game #59938799568:  Hold'em No Limit ($0.50/$1.00) - 2009/07/01 0:23:47 ET
Table 'QSIig7BLMc9wY/rgBechzw' 6-max Seat #3 is the button
Seat 1: uuA9hpFU17U5/t4cvpbpBg ($37.40 in chips)
Seat 2: 0WjiuIT7/EolY1oOx1ngeA ($126.25 in chips)
Seat 3: +W6OnF033KNM2xH0fGj98Q ($110.20 in chips)
Seat 4: +uSzP8Jwnw7sKfQ4s66b7w ($47.50 in chips)
Seat 5: bvU2ZjpVnszLCFVeWbxePg ($100 in chips)
Seat 6: KpnW5CcJ4Mg6MeclfKmLrw ($144.25 in chips)
+uSzP8Jwnw7sKfQ4s66b7w: posts small blind $0.50
bvU2ZjpVnszLCFVeWbxePg: posts big blind $1
*** HOLE CARDS ***
KpnW5CcJ4Mg6MeclfKmLrw: folds
uuA9hpFU17U5/t4cvpbpBg: folds
0WjiuIT7/EolY1oOx1ngeA: folds
+W6OnF033KNM2xH0fGj98Q: folds
+uSzP8Jwnw7sKfQ4s66b7w: folds
bvU2ZjpVnszLCFVeWbxePg collected $1 from pot
bvU2ZjpVnszLCFVeWbxePg: doesn't show hand
*** SUMMARY ***
Total pot $1 | Rake $0
Seat 1: uuA9hpFU17U5/t4cvpbpBg folded before Flop (didn't bet)
Seat 2: 0WjiuIT7/EolY1oOx1ngeA folded before Flop (didn't bet)
Seat 3: +W6OnF033KNM2xH0fGj98Q (button) folded before Flop (didn't bet)
Seat 4: +uSzP8Jwnw7sKfQ4s66b7w (small blind) folded before Flop
Seat 5: bvU2ZjpVnszLCFVeWbxePg (big blind) collected ($1)
Seat 6: KpnW5CcJ4Mg6MeclfKmLrw folded before Flop (didn't bet)



PokerStars Game #59938800230:  Hold'em No Limit ($0.50/$1.00) - 2009/07/01 0:23:48 ET
Table 'U9zqzC8f3oTJ2ShXFgSSOA' 6-max Seat #6 is the button
Seat 1: tS9JHB1h+FQ++qu8RwRNgg ($15.95 in chips)
Seat 2: U2CWBTv29qdCbj8RNF2sIw ($97.30 in chips)
Seat 3: yfXek8iJ7O4CFyqXrtGcfg ($59 in chips)
Seat 4: 33q95we0Etwgrm6guQGncw ($73.90 in chips)
Seat 5: KfwW5us6tydK81NYTtK1gw ($207.40 in chips)
Seat 6: aIxzFKdtpDSkUePKZy/niQ ($43.50 in chips)
tS9JHB1h+FQ++qu8RwRNgg: posts small blind $0.50
U2CWBTv29qdCbj8RNF2sIw: posts big blind $1
*** HOLE CARDS ***
yfXek8iJ7O4CFyqXrtGcfg: folds
33q95we0Etwgrm6guQGncw: folds
KfwW5us6tydK81NYTtK1gw: folds
aIxzFKdtpDSkUePKZy/niQ: raises $3 to $4
tS9JHB1h+FQ++qu8RwRNgg: folds
U2CWBTv29qdCbj8RNF2sIw: folds
aIxzFKdtpDSkUePKZy/niQ collected $2.50 from pot
*** SUMMARY ***
Total pot $2.50 | Rake $0
Seat 1: tS9JHB1h+FQ++qu8RwRNgg (small blind) folded before Flop
Seat 2: U2CWBTv29qdCbj8RNF2sIw (big blind) folded before Flop
Seat 3: yfXek8iJ7O4CFyqXrtGcfg folded before Flop (didn't bet)
Seat 4: 33q95we0Etwgrm6guQGncw folded before Flop (didn't bet)
Seat 5: KfwW5us6tydK81NYTtK1gw folded before Flop (didn't bet)
Seat 6: aIxzFKdtpDSkUePKZy/niQ (button) collected ($2.50)



PokerStars Game #59938799746:  Hold'em No Limit ($0.50/$1.00) - 2009/07/01 0:23:48 ET
Table 'eU3bWpDDg3Z+9R4m4iVmog' 6-max Seat #2 is the button
Seat 2: 8CAoOzhmB8n3nRFf3V4BTg ($140.95 in chips)
Seat 3: U6tnjwZRpTnM+YkqkCjwyQ ($157.05 in chips)
Seat 4: GDVIsbEJ/DOJsMKE4Asz0A ($92.95 in chips)
Seat 5: QHvTZcrKe6+maWUfVjP29Q ($103.50 in chips)
Seat 6: hpxXcmRkXXI9HE5+5/j/0Q ($100 in chips)
U6tnjwZRpTnM+YkqkCjwyQ: posts small blind $0.50
GDVIsbEJ/DOJsMKE4Asz0A: posts big blind $1
*** HOLE CARDS ***
QHvTZcrKe6+maWUfVjP29Q: folds
hpxXcmRkXXI9HE5+5/j/0Q: raises $2 to $3
TSuRyAHnUPCFjP7Z0rEE0w joins the table at seat #1
8CAoOzhmB8n3nRFf3V4BTg: folds
U6tnjwZRpTnM+YkqkCjwyQ: calls $2.50
GDVIsbEJ/DOJsMKE4Asz0A: calls $2
*** FLOP *** [Ac 9s 7c]
U6tnjwZRpTnM+YkqkCjwyQ: checks
GDVIsbEJ/DOJsMKE4Asz0A: checks
hpxXcmRkXXI9HE5+5/j/0Q: checks
*** TURN *** [Ac 9s 7c] [6c]
U6tnjwZRpTnM+YkqkCjwyQ: checks
GDVIsbEJ/DOJsMKE4Asz0A: bets $4
hpxXcmRkXXI9HE5+5/j/0Q: folds
U6tnjwZRpTnM+YkqkCjwyQ: folds
GDVIsbEJ/DOJsMKE4Asz0A collected $8.55 from pot
GDVIsbEJ/DOJsMKE4Asz0A: doesn't show hand
*** SUMMARY ***
Total pot $9 | Rake $0.45
Board [Ac 9s 7c 6c]
Seat 2: 8CAoOzhmB8n3nRFf3V4BTg (button) folded before Flop (didn't bet)
Seat 3: U6tnjwZRpTnM+YkqkCjwyQ (small blind) folded on the Turn
Seat 4: GDVIsbEJ/DOJsMKE4Asz0A (big blind) collected ($8.55)
Seat 5: QHvTZcrKe6+maWUfVjP29Q folded before Flop (didn't bet)
Seat 6: hpxXcmRkXXI9HE5+5/j/0Q folded on the Turn



PokerStars Game #59938801930:  Hold'em No Limit ($0.50/$1.00) - 2009/07/01 0:23:51 ET
Table 'aWHveb63HkbTmOGHOxjBkQ' 2-max Seat #1 is the button
Seat 1: xy2MQKoHoCZZIudmw8Xbow ($277.90 in chips)
Seat 2: xstEKavv3YDxpUnU4e9qAQ ($95.10 in chips)
xy2MQKoHoCZZIudmw8Xbow: posts small blind $0.50
xstEKavv3YDxpUnU4e9qAQ: posts big blind $1
*** HOLE CARDS ***
xy2MQKoHoCZZIudmw8Xbow: folds
xstEKavv3YDxpUnU4e9qAQ collected $1 from pot
*** SUMMARY ***
Total pot $1 | Rake $0
Seat 1: xy2MQKoHoCZZIudmw8Xbow (button) (small blind) folded before Flop
Seat 2: xstEKavv3YDxpUnU4e9qAQ (big blind) collected ($1)



PokerStars Game #59938803332:  Hold'em No Limit ($0.50/$1.00) - 2009/07/01 0:23:53 ET
Table 'rmZfTK+oSebeUPJNbWhdAA' 6-max Seat #6 is the button
Seat 1: xAU6q2/cwmby2sxmA8VcmA ($100.50 in chips)
Seat 2: OigyyiK+tTj1APPIAUmXDA ($79.70 in chips)
Seat 3: 9yjOzGERLaEZS8CZ6YNHFg ($61.30 in chips)
Seat 4: OGMLOcTNYZXZU81au7ztUw ($126.65 in chips)
Seat 5: VuZb/hkEc4X7s93w2ZZTpA ($111.25 in chips)
Seat 6: j7NIOHLZk7V2o9fOioO5ug ($104.80 in chips)
xAU6q2/cwmby2sxmA8VcmA: posts small blind $0.50
OigyyiK+tTj1APPIAUmXDA: posts big blind $1
*** HOLE CARDS ***
9yjOzGERLaEZS8CZ6YNHFg: folds
OGMLOcTNYZXZU81au7ztUw: folds
VuZb/hkEc4X7s93w2ZZTpA: folds
j7NIOHLZk7V2o9fOioO5ug: raises $2 to $3
xAU6q2/cwmby2sxmA8VcmA: folds
OigyyiK+tTj1APPIAUmXDA: calls $2
*** FLOP *** [Qd 7s 9s]
OigyyiK+tTj1APPIAUmXDA: checks
j7NIOHLZk7V2o9fOioO5ug: bets $5
OigyyiK+tTj1APPIAUmXDA: folds
j7NIOHLZk7V2o9fOioO5ug collected $6.20 from pot
j7NIOHLZk7V2o9fOioO5ug: doesn't show hand
*** SUMMARY ***
Total pot $6.50 | Rake $0.30
Board [Qd 7s 9s]
Seat 1: xAU6q2/cwmby2sxmA8VcmA (small blind) folded before Flop
Seat 2: OigyyiK+tTj1APPIAUmXDA (big blind) folded on the Flop
Seat 3: 9yjOzGERLaEZS8CZ6YNHFg folded before Flop (didn't bet)
Seat 4: OGMLOcTNYZXZU81au7ztUw folded before Flop (didn't bet)
Seat 5: VuZb/hkEc4X7s93w2ZZTpA folded before Flop (didn't bet)
Seat 6: j7NIOHLZk7V2o9fOioO5ug (button) collected ($6.20)



PokerStars Game #59938803972:  Hold'em No Limit ($0.50/$1.00) - 2009/07/01 0:23:54 ET
Table '/FUb199IViHMJHi5YWmeuQ' 9-max Seat #3 is the button
Seat 1: TZcz9MEWDA+WydgGruqqbw ($100 in chips)
Seat 2: FL3MrLspcF23LYvC4ipBOA ($132.25 in chips)
Seat 3: qN483QJ1NvHbdIZB7J4ARw ($73.75 in chips)
Seat 4: qheQay5YvP2DMAb3OUSxtw ($106.30 in chips)
Seat 5: +za1iHiRgVo4OcAz0SOZqw ($16.95 in chips)
Seat 7: atVaKXE/AQGa798rpMF/Bg ($17 in chips)
Seat 8: QIWvt0R766g8KfH0vl1s0A ($49.10 in chips)
Seat 9: knewtTmBc4Tc0z/5tAABYQ ($124.25 in chips)
qheQay5YvP2DMAb3OUSxtw: posts small blind $0.50
+za1iHiRgVo4OcAz0SOZqw: posts big blind $1
ccFf7Q4z1cTGQmeoYiWEfw: sits out
*** HOLE CARDS ***
atVaKXE/AQGa798rpMF/Bg: folds
QIWvt0R766g8KfH0vl1s0A: folds
knewtTmBc4Tc0z/5tAABYQ: folds
TZcz9MEWDA+WydgGruqqbw: folds
FL3MrLspcF23LYvC4ipBOA: raises $2 to $3
qN483QJ1NvHbdIZB7J4ARw: folds
qheQay5YvP2DMAb3OUSxtw: folds
+za1iHiRgVo4OcAz0SOZqw: folds
FL3MrLspcF23LYvC4ipBOA collected $2.50 from pot
FL3MrLspcF23LYvC4ipBOA: doesn't show hand
*** SUMMARY ***
Total pot $2.50 | Rake $0
Seat 1: TZcz9MEWDA+WydgGruqqbw folded before Flop (didn't bet)
Seat 2: FL3MrLspcF23LYvC4ipBOA collected ($2.50)
Seat 3: qN483QJ1NvHbdIZB7J4ARw (button) folded before Flop (didn't bet)
Seat 4: qheQay5YvP2DMAb3OUSxtw (small blind) folded before Flop
Seat 5: +za1iHiRgVo4OcAz0SOZqw (big blind) folded before Flop
Seat 7: atVaKXE/AQGa798rpMF/Bg folded before Flop (didn't bet)
Seat 8: QIWvt0R766g8KfH0vl1s0A folded before Flop (didn't bet)
Seat 9: knewtTmBc4Tc0z/5tAABYQ folded before Flop (didn't bet)



PokerStars Game #59938806084:  Hold'em No Limit ($0.50/$1.00) - 2009/07/01 0:23:57 ET
Table 'aWHveb63HkbTmOGHOxjBkQ' 2-max Seat #2 is the button
Seat 1: xy2MQKoHoCZZIudmw8Xbow ($277.40 in chips)
Seat 2: xstEKavv3YDxpUnU4e9qAQ ($95.60 in chips)
xstEKavv3YDxpUnU4e9qAQ: posts small blind $0.50
xy2MQKoHoCZZIudmw8Xbow: posts big blind $1
*** HOLE CARDS ***
xstEKavv3YDxpUnU4e9qAQ: raises $3 to $4
xy2MQKoHoCZZIudmw8Xbow: folds
xstEKavv3YDxpUnU4e9qAQ collected $2 from pot
*** SUMMARY ***
Total pot $2 | Rake $0
Seat 1: xy2MQKoHoCZZIudmw8Xbow (big blind) folded before Flop
Seat 2: xstEKavv3YDxpUnU4e9qAQ (button) (small blind) collected ($2)



PokerStars Game #59938807526:  Hold'em No Limit ($0.50/$1.00) - 2009/07/01 0:23:59 ET
Table 'hugOjcwJvzEwZbK7tyiWuQ' 9-max Seat #1 is the button
Seat 1: N9n5Wc3s35DpCrOAUUNAaQ ($126.35 in chips)
Seat 2: r27C1nIV4NS4+qbnrgBQSw ($257.55 in chips)
Seat 3: jDwhY1kCdc6EkAHbT7PJMQ ($108.05 in chips)
Seat 4: UWB3oeddt/GObx2Mix2Anw ($195.20 in chips)
Seat 6: gUUvmqdVlmvpal6B8nYrmg ($102.30 in chips)
Seat 7: FL3MrLspcF23LYvC4ipBOA ($100 in chips)
Seat 8: /zy+DB4S5fUQUSfZWFzYGw ($113.25 in chips)
Seat 9: o6JyUkbzCDw8tUabqtmnlg ($61.10 in chips)
r27C1nIV4NS4+qbnrgBQSw: posts small blind $0.50
jDwhY1kCdc6EkAHbT7PJMQ: posts big blind $1
*** HOLE CARDS ***
UWB3oeddt/GObx2Mix2Anw: folds
gUUvmqdVlmvpal6B8nYrmg: raises $1 to $2
FL3MrLspcF23LYvC4ipBOA: folds
/zy+DB4S5fUQUSfZWFzYGw: calls $2
o6JyUkbzCDw8tUabqtmnlg: calls $2
N9n5Wc3s35DpCrOAUUNAaQ: folds
r27C1nIV4NS4+qbnrgBQSw: folds
jDwhY1kCdc6EkAHbT7PJMQ: folds
*** FLOP *** [Kc 7s Jh]
gUUvmqdVlmvpal6B8nYrmg: bets $3
/zy+DB4S5fUQUSfZWFzYGw: folds
o6JyUkbzCDw8tUabqtmnlg: folds
gUUvmqdVlmvpal6B8nYrmg collected $7.15 from pot
*** SUMMARY ***
Total pot $7.50 | Rake $0.35
Board [Kc 7s Jh]
Seat 1: N9n5Wc3s35DpCrOAUUNAaQ (button) folded before Flop (didn't bet)
Seat 2: r27C1nIV4NS4+qbnrgBQSw (small blind) folded before Flop
Seat 3: jDwhY1kCdc6EkAHbT7PJMQ (big blind) folded before Flop
Seat 4: UWB3oeddt/GObx2Mix2Anw folded before Flop (didn't bet)
Seat 6: gUUvmqdVlmvpal6B8nYrmg collected ($7.15)
Seat 7: FL3MrLspcF23LYvC4ipBOA folded before Flop (didn't bet)
Seat 8: /zy+DB4S5fUQUSfZWFzYGw folded on the Flop
Seat 9: o6JyUkbzCDw8tUabqtmnlg folded on the Flop



PokerStars Game #59938807604:  Hold'em No Limit ($0.50/$1.00) - 2009/07/01 0:23:59 ET
Table 'pHrhryH8jPNdQfY62f8v+g' 6-max Seat #2 is the button
Seat 1: BdbmJTZZ47quA9vUWwXtlw ($68.25 in chips)
Seat 2: RqgF7gRoKgRNW8Zoi1ty4A ($110.60 in chips)
Seat 3: 0WjiuIT7/EolY1oOx1ngeA ($100.50 in chips)
Seat 4: wenbG7TaM3H7h5kn78OFNw ($62.50 in chips)
Seat 5: Gp2euK/nqF6qXKe7U+jOfw ($118.65 in chips)
0WjiuIT7/EolY1oOx1ngeA: posts small blind $0.50
wenbG7TaM3H7h5kn78OFNw: posts big blind $1
xAU6q2/cwmby2sxmA8VcmA: sits out
*** HOLE CARDS ***
Gp2euK/nqF6qXKe7U+jOfw: folds
BdbmJTZZ47quA9vUWwXtlw: folds
RqgF7gRoKgRNW8Zoi1ty4A: raises $2 to $3
0WjiuIT7/EolY1oOx1ngeA: folds
wenbG7TaM3H7h5kn78OFNw: calls $2
*** FLOP *** [Qc 9s 7d]
wenbG7TaM3H7h5kn78OFNw: checks
RqgF7gRoKgRNW8Zoi1ty4A: checks
*** TURN *** [Qc 9s 7d] [5c]
wenbG7TaM3H7h5kn78OFNw: bets $3
RqgF7gRoKgRNW8Zoi1ty4A: calls $3
*** RIVER *** [Qc 9s 7d 5c] [3h]
wenbG7TaM3H7h5kn78OFNw: checks
RqgF7gRoKgRNW8Zoi1ty4A: checks
*** SHOW DOWN ***
wenbG7TaM3H7h5kn78OFNw: shows [Jc As] (high card Ace)
RqgF7gRoKgRNW8Zoi1ty4A: shows [9h Ks] (a pair of Nines)
RqgF7gRoKgRNW8Zoi1ty4A collected $11.90 from pot
*** SUMMARY ***
Total pot $12.50 | Rake $0.60
Board [Qc 9s 7d 5c 3h]
Seat 1: BdbmJTZZ47quA9vUWwXtlw folded before Flop (didn't bet)
Seat 2: RqgF7gRoKgRNW8Zoi1ty4A (button) showed [9h Ks] and won ($11.90) with a pair of Nines
Seat 3: 0WjiuIT7/EolY1oOx1ngeA (small blind) folded before Flop
Seat 4: wenbG7TaM3H7h5kn78OFNw (big blind) showed [Jc As] and lost with high card Ace
Seat 5: Gp2euK/nqF6qXKe7U+jOfw folded before Flop (didn't bet)



PokerStars Game #59938808938:  Hold'em No Limit ($0.50/$1.00) - 2009/07/01 0:24:01 ET
Table '/RZcOwpZpHQ+OwPwjsbnRw' 6-max Seat #5 is the button
Seat 2: dHC9PH9hdH3Ad2TD8ZxX0Q ($40.10 in chips)
Seat 3: OigyyiK+tTj1APPIAUmXDA ($84.65 in chips)
Seat 4: j7NIOHLZk7V2o9fOioO5ug ($102 in chips)
Seat 5: wx3sQGkVi2x9wJXuWNHPBw ($205.05 in chips)
Seat 6: XOIf9W+VAxhZqN+SYoyMKA ($255.80 in chips)
XOIf9W+VAxhZqN+SYoyMKA: posts small blind $0.50
dHC9PH9hdH3Ad2TD8ZxX0Q: posts big blind $1
*** HOLE CARDS ***
OigyyiK+tTj1APPIAUmXDA: folds
j7NIOHLZk7V2o9fOioO5ug: folds
wx3sQGkVi2x9wJXuWNHPBw: folds
XOIf9W+VAxhZqN+SYoyMKA: folds
dHC9PH9hdH3Ad2TD8ZxX0Q collected $1 from pot
*** SUMMARY ***
Total pot $1 | Rake $0
Seat 2: dHC9PH9hdH3Ad2TD8ZxX0Q (big blind) collected ($1)
Seat 3: OigyyiK+tTj1APPIAUmXDA folded before Flop (didn't bet)
Seat 4: j7NIOHLZk7V2o9fOioO5ug folded before Flop (didn't bet)
Seat 5: wx3sQGkVi2x9wJXuWNHPBw (button) folded before Flop (didn't bet)
Seat 6: XOIf9W+VAxhZqN+SYoyMKA (small blind) folded before Flop



PokerStars Game #59938810206:  Hold'em No Limit ($0.50/$1.00) - 2009/07/01 0:24:03 ET
Table 'aWHveb63HkbTmOGHOxjBkQ' 2-max Seat #1 is the button
Seat 1: xy2MQKoHoCZZIudmw8Xbow ($276.40 in chips)
Seat 2: xstEKavv3YDxpUnU4e9qAQ ($96.60 in chips)
xy2MQKoHoCZZIudmw8Xbow: posts small blind $0.50
xstEKavv3YDxpUnU4e9qAQ: posts big blind $1
*** HOLE CARDS ***
xy2MQKoHoCZZIudmw8Xbow: folds
xstEKavv3YDxpUnU4e9qAQ collected $1 from pot
*** SUMMARY ***
Total pot $1 | Rake $0
Seat 1: xy2MQKoHoCZZIudmw8Xbow (button) (small blind) folded before Flop
Seat 2: xstEKavv3YDxpUnU4e9qAQ (big blind) collected ($1)



PokerStars Game #59938810854:  Hold'em No Limit ($0.50/$1.00) - 2009/07/01 0:24:04 ET
Table 'vs/5jr6ciwjVQ5+Soc+u2A' 6-max Seat #2 is the button
Seat 2: XOIf9W+VAxhZqN+SYoyMKA ($115.80 in chips)
Seat 3: G5ZSSN6RSON3gkNvk/SmYg ($101.20 in chips)
Seat 4: KpnW5CcJ4Mg6MeclfKmLrw ($106.15 in chips)
Seat 5: 7Vc9JmGFQwMRh5Tj9ui5Lw ($98.65 in chips)
Seat 6: QHvTZcrKe6+maWUfVjP29Q ($100 in chips)
G5ZSSN6RSON3gkNvk/SmYg: posts small blind $0.50
KpnW5CcJ4Mg6MeclfKmLrw: posts big blind $1
*** HOLE CARDS ***
7Vc9JmGFQwMRh5Tj9ui5Lw: raises $2 to $3
QHvTZcrKe6+maWUfVjP29Q: folds
XOIf9W+VAxhZqN+SYoyMKA: raises $8 to $11
G5ZSSN6RSON3gkNvk/SmYg: folds
KpnW5CcJ4Mg6MeclfKmLrw: folds
7Vc9JmGFQwMRh5Tj9ui5Lw: folds
XOIf9W+VAxhZqN+SYoyMKA collected $7.50 from pot
XOIf9W+VAxhZqN+SYoyMKA: doesn't show hand
*** SUMMARY ***
Total pot $7.50 | Rake $0
Seat 2: XOIf9W+VAxhZqN+SYoyMKA (button) collected ($7.50)
Seat 3: G5ZSSN6RSON3gkNvk/SmYg (small blind) folded before Flop
Seat 4: KpnW5CcJ4Mg6MeclfKmLrw (big blind) folded before Flop
Seat 5: 7Vc9JmGFQwMRh5Tj9ui5Lw folded before Flop
Seat 6: QHvTZcrKe6+maWUfVjP29Q folded before Flop (didn't bet)



PokerStars Game #59938810928:  Hold'em No Limit ($0.50/$1.00) - 2009/07/01 0:24:04 ET
Table 'VOs36P6NW+QyXeQ1B62kmA' 6-max Seat #5 is the button
Seat 1: AdLVjddOzm+sRNo1Bc3S6Q ($138.55 in chips)
Seat 2: KpnW5CcJ4Mg6MeclfKmLrw ($109.80 in chips)
Seat 4: w02zQzNydODiyV9THKgo9w ($25 in chips)
Seat 5: X7GlkHF+lkbarCLuZ4Uf0w ($19.50 in chips)
Seat 6: 6tvjsJrdmWg+g7FVrMnzXA ($72.25 in chips)
6tvjsJrdmWg+g7FVrMnzXA: posts small blind $0.50
AdLVjddOzm+sRNo1Bc3S6Q: posts big blind $1
TSuRyAHnUPCFjP7Z0rEE0w: sits out
w02zQzNydODiyV9THKgo9w: posts big blind $1
*** HOLE CARDS ***
KpnW5CcJ4Mg6MeclfKmLrw: folds
w02zQzNydODiyV9THKgo9w: checks
X7GlkHF+lkbarCLuZ4Uf0w: folds
6tvjsJrdmWg+g7FVrMnzXA: calls $0.50
AdLVjddOzm+sRNo1Bc3S6Q: checks
*** FLOP *** [Kc 4h 2c]
6tvjsJrdmWg+g7FVrMnzXA: bets $2
AdLVjddOzm+sRNo1Bc3S6Q: folds
w02zQzNydODiyV9THKgo9w: folds
6tvjsJrdmWg+g7FVrMnzXA collected $2.85 from pot
6tvjsJrdmWg+g7FVrMnzXA: doesn't show hand
*** SUMMARY ***
Total pot $3 | Rake $0.15
Board [Kc 4h 2c]
Seat 1: AdLVjddOzm+sRNo1Bc3S6Q (big blind) folded on the Flop
Seat 2: KpnW5CcJ4Mg6MeclfKmLrw folded before Flop (didn't bet)
Seat 4: w02zQzNydODiyV9THKgo9w folded on the Flop
Seat 5: X7GlkHF+lkbarCLuZ4Uf0w (button) folded before Flop (didn't bet)
Seat 6: 6tvjsJrdmWg+g7FVrMnzXA (small blind) collected ($2.85)



PokerStars Game #59938811008:  Hold'em No Limit ($0.50/$1.00) - 2009/07/01 0:24:05 ET
Table 'W/wyObTiXZm+Ckkl3YxcSw' 6-max Seat #4 is the button
Seat 1: ssLJburtEIqnVkx6X8R1uw ($117.25 in chips)
Seat 2: oDiBRCaF0QVtd3kO6xZIXw ($100 in chips)
Seat 3: b2a+5TkFf4xJN/Ihhma58Q ($36.70 in chips)
Seat 4: BdbmJTZZ47quA9vUWwXtlw ($44.10 in chips)
Seat 6: 1yB1nHUkHNNY8OJnDNHZMw ($55.90 in chips)
1yB1nHUkHNNY8OJnDNHZMw: posts small blind $0.50
ssLJburtEIqnVkx6X8R1uw: posts big blind $1
*** HOLE CARDS ***
oDiBRCaF0QVtd3kO6xZIXw: folds
b2a+5TkFf4xJN/Ihhma58Q: raises $1 to $2
BdbmJTZZ47quA9vUWwXtlw: raises $3 to $5
1yB1nHUkHNNY8OJnDNHZMw: folds
ssLJburtEIqnVkx6X8R1uw: folds
b2a+5TkFf4xJN/Ihhma58Q: folds
BdbmJTZZ47quA9vUWwXtlw collected $5.50 from pot
*** SUMMARY ***
Total pot $5.50 | Rake $0
Seat 1: ssLJburtEIqnVkx6X8R1uw (big blind) folded before Flop
Seat 2: oDiBRCaF0QVtd3kO6xZIXw folded before Flop (didn't bet)
Seat 3: b2a+5TkFf4xJN/Ihhma58Q folded before Flop
Seat 4: BdbmJTZZ47quA9vUWwXtlw (button) collected ($5.50)
Seat 6: 1yB1nHUkHNNY8OJnDNHZMw (small blind) folded before Flop



PokerStars Game #59938811014:  Hold'em No Limit ($0.50/$1.00) - 2009/07/01 0:24:05 ET
Table '7Nl0ffnjeK44/vmeexh3MQ' 9-max Seat #7 is the button
Seat 1: s7D3Y+k4Cj4D1cXHv7oj+Q ($104.65 in chips)
Seat 3: 200876 ($39.90 in chips)
Seat 4: NfbTuCZ2txeWuV3hP7t0TA ($100 in chips)
Seat 5: bL+QVeDcuEdzMGAGg2XJHg ($107.10 in chips)
Seat 6: FVs16t7GgfWgQWt4JxsObQ ($15.55 in chips)
Seat 7: knewtTmBc4Tc0z/5tAABYQ ($106.50 in chips)
Seat 8: zanka7aAZkigmZpfopXxxA ($222.50 in chips)
Seat 9: ouwUBGRKnKK9uhn1G4Lf+A ($100 in chips)
zanka7aAZkigmZpfopXxxA: posts small blind $0.50
ouwUBGRKnKK9uhn1G4Lf+A: posts big blind $1
kiakSwxX0e64PwYGAPQvLw: sits out
*** HOLE CARDS ***
s7D3Y+k4Cj4D1cXHv7oj+Q: folds
200876: folds
NfbTuCZ2txeWuV3hP7t0TA: folds
bL+QVeDcuEdzMGAGg2XJHg: folds
FVs16t7GgfWgQWt4JxsObQ: folds
knewtTmBc4Tc0z/5tAABYQ: folds
zanka7aAZkigmZpfopXxxA: raises $2 to $3
ouwUBGRKnKK9uhn1G4Lf+A: folds
zanka7aAZkigmZpfopXxxA collected $2 from pot
zanka7aAZkigmZpfopXxxA: doesn't show hand
*** SUMMARY ***
Total pot $2 | Rake $0
Seat 1: s7D3Y+k4Cj4D1cXHv7oj+Q folded before Flop (didn't bet)
Seat 3: 200876 folded before Flop (didn't bet)
Seat 4: NfbTuCZ2txeWuV3hP7t0TA folded before Flop (didn't bet)
Seat 5: bL+QVeDcuEdzMGAGg2XJHg folded before Flop (didn't bet)
Seat 6: FVs16t7GgfWgQWt4JxsObQ folded before Flop (didn't bet)
Seat 7: knewtTmBc4Tc0z/5tAABYQ (button) folded before Flop (didn't bet)
Seat 8: zanka7aAZkigmZpfopXxxA (small blind) collected ($2)
Seat 9: ouwUBGRKnKK9uhn1G4Lf+A (big blind) folded before Flop



PokerStars Game #59938811412:  Hold'em No Limit ($0.50/$1.00) - 2009/07/01 0:24:05 ET
Table 'N2bNCDHL96aCQDvZIh+yQQ' 6-max Seat #6 is the button
Seat 1: iHo1oDbrEVJ8nEGdaPrICw ($144 in chips)
Seat 2: KpnW5CcJ4Mg6MeclfKmLrw ($103.50 in chips)
Seat 3: PXT6kJgVX67c3EgncNqRoA ($51.45 in chips)
Seat 4: uCqEjnxh2/vFBjKYkfTOkw ($160.20 in chips)
Seat 5: rHlMOfR7kpQQxe+PFQz0xQ ($37.40 in chips)
Seat 6: TSuRyAHnUPCFjP7Z0rEE0w ($100 in chips)
iHo1oDbrEVJ8nEGdaPrICw: posts small blind $0.50
KpnW5CcJ4Mg6MeclfKmLrw: posts big blind $1
*** HOLE CARDS ***
PXT6kJgVX67c3EgncNqRoA: folds
uCqEjnxh2/vFBjKYkfTOkw: folds
PXT6kJgVX67c3EgncNqRoA leaves the table
rHlMOfR7kpQQxe+PFQz0xQ: raises $2 to $3
TSuRyAHnUPCFjP7Z0rEE0w: folds
iHo1oDbrEVJ8nEGdaPrICw: folds
KpnW5CcJ4Mg6MeclfKmLrw: folds
rHlMOfR7kpQQxe+PFQz0xQ collected $2.50 from pot
rHlMOfR7kpQQxe+PFQz0xQ: doesn't show hand
*** SUMMARY ***
Total pot $2.50 | Rake $0
Seat 1: iHo1oDbrEVJ8nEGdaPrICw (small blind) folded before Flop
Seat 2: KpnW5CcJ4Mg6MeclfKmLrw (big blind) folded before Flop
Seat 3: PXT6kJgVX67c3EgncNqRoA folded before Flop (didn't bet)
Seat 4: uCqEjnxh2/vFBjKYkfTOkw folded before Flop (didn't bet)
Seat 5: rHlMOfR7kpQQxe+PFQz0xQ collected ($2.50)
Seat 6: TSuRyAHnUPCFjP7Z0rEE0w (button) folded before Flop (didn't bet)



PokerStars Game #59938811576:  Hold'em No Limit ($0.50/$1.00) - 2009/07/01 0:24:06 ET
Table 'J2yEIzCSC1VzM+R2gijwtg' 9-max Seat #3 is the button
Seat 1: knewtTmBc4Tc0z/5tAABYQ ($201.45 in chips)
Seat 2: kz9ziSiGUc+857heiKSayw ($14.95 in chips)
Seat 3: 9swGhtpERPngKPtvpoZkoQ ($116.15 in chips)
Seat 4: vR4IO10geOgvTW+LAUBv/A ($100 in chips)
Seat 5: /kZ258i1lqmMUXbtrZIHJA ($44.40 in chips)
Seat 6: bJckevFOcg//s0qyMQI6sQ ($176.40 in chips)
Seat 8: CIRDepY9Rc5tiDJPd0nNpQ ($100.30 in chips)
vR4IO10geOgvTW+LAUBv/A: posts small blind $0.50
/kZ258i1lqmMUXbtrZIHJA: posts big blind $1
*** HOLE CARDS ***
bJckevFOcg//s0qyMQI6sQ: folds
CIRDepY9Rc5tiDJPd0nNpQ: raises $2 to $3
knewtTmBc4Tc0z/5tAABYQ: folds
kz9ziSiGUc+857heiKSayw: folds
9swGhtpERPngKPtvpoZkoQ: calls $3
vR4IO10geOgvTW+LAUBv/A: raises $10 to $13
kiakSwxX0e64PwYGAPQvLw joins the table at seat #9
/kZ258i1lqmMUXbtrZIHJA: calls $12
CIRDepY9Rc5tiDJPd0nNpQ: calls $10
9swGhtpERPngKPtvpoZkoQ: folds
*** FLOP *** [7d 5h Qd]
9swGhtpERPngKPtvpoZkoQ leaves the table
vR4IO10geOgvTW+LAUBv/A: checks
/kZ258i1lqmMUXbtrZIHJA: bets $12
CIRDepY9Rc5tiDJPd0nNpQ: folds
vR4IO10geOgvTW+LAUBv/A: raises $25 to $37
/kZ258i1lqmMUXbtrZIHJA: calls $19.40 and is all-in
*** TURN *** [7d 5h Qd] [Jh]
*** RIVER *** [7d 5h Qd Jh] [Ts]
*** SHOW DOWN ***
vR4IO10geOgvTW+LAUBv/A: shows [Qs Qc] (three of a kind, Queens)
/kZ258i1lqmMUXbtrZIHJA: mucks hand
vR4IO10geOgvTW+LAUBv/A collected $101.80 from pot
*** SUMMARY ***
Total pot $104.80 | Rake $3
Board [7d 5h Qd Jh Ts]
Seat 1: knewtTmBc4Tc0z/5tAABYQ folded before Flop (didn't bet)
Seat 2: kz9ziSiGUc+857heiKSayw folded before Flop (didn't bet)
Seat 3: 9swGhtpERPngKPtvpoZkoQ (button) folded before Flop
Seat 4: vR4IO10geOgvTW+LAUBv/A (small blind) showed [Qs Qc] and won ($101.80) with three of a kind, Queens
Seat 5: /kZ258i1lqmMUXbtrZIHJA (big blind) mucked
Seat 6: bJckevFOcg//s0qyMQI6sQ folded before Flop (didn't bet)
Seat 8: CIRDepY9Rc5tiDJPd0nNpQ folded on the Flop



PokerStars Game #59938813240:  Hold'em No Limit ($0.50/$1.00) - 2009/07/01 0:24:08 ET
Table 'QSIig7BLMc9wY/rgBechzw' 6-max Seat #4 is the button
Seat 1: uuA9hpFU17U5/t4cvpbpBg ($37.40 in chips)
Seat 2: 0WjiuIT7/EolY1oOx1ngeA ($126.25 in chips)
Seat 3: +W6OnF033KNM2xH0fGj98Q ($110.20 in chips)
Seat 4: +uSzP8Jwnw7sKfQ4s66b7w ($47 in chips)
Seat 5: bvU2ZjpVnszLCFVeWbxePg ($100.50 in chips)
Seat 6: KpnW5CcJ4Mg6MeclfKmLrw ($144.25 in chips)
bvU2ZjpVnszLCFVeWbxePg: posts small blind $0.50
KpnW5CcJ4Mg6MeclfKmLrw: posts big blind $1
*** HOLE CARDS ***
uuA9hpFU17U5/t4cvpbpBg: folds
0WjiuIT7/EolY1oOx1ngeA: folds
+W6OnF033KNM2xH0fGj98Q: folds
+uSzP8Jwnw7sKfQ4s66b7w: folds
bvU2ZjpVnszLCFVeWbxePg: raises $3 to $4
KpnW5CcJ4Mg6MeclfKmLrw: raises $9 to $13
bvU2ZjpVnszLCFVeWbxePg: calls $9
*** FLOP *** [7d 9h Jh]
bvU2ZjpVnszLCFVeWbxePg: checks
KpnW5CcJ4Mg6MeclfKmLrw: checks
*** TURN *** [7d 9h Jh] [4h]
bvU2ZjpVnszLCFVeWbxePg: checks
KpnW5CcJ4Mg6MeclfKmLrw: checks
*** RIVER *** [7d 9h Jh 4h] [Th]
bvU2ZjpVnszLCFVeWbxePg: checks
KpnW5CcJ4Mg6MeclfKmLrw: checks
*** SHOW DOWN ***
bvU2ZjpVnszLCFVeWbxePg: shows [8s 8d] (a straight, Seven to Jack)
KpnW5CcJ4Mg6MeclfKmLrw: mucks hand
bvU2ZjpVnszLCFVeWbxePg collected $24.70 from pot
*** SUMMARY ***
Total pot $26 | Rake $1.30
Board [7d 9h Jh 4h Th]
Seat 1: uuA9hpFU17U5/t4cvpbpBg folded before Flop (didn't bet)
Seat 2: 0WjiuIT7/EolY1oOx1ngeA folded before Flop (didn't bet)
Seat 3: +W6OnF033KNM2xH0fGj98Q folded before Flop (didn't bet)
Seat 4: +uSzP8Jwnw7sKfQ4s66b7w (button) folded before Flop (didn't bet)
Seat 5: bvU2ZjpVnszLCFVeWbxePg (small blind) showed [8s 8d] and won ($24.70) with a straight, Seven to Jack
Seat 6: KpnW5CcJ4Mg6MeclfKmLrw (big blind) mucked



PokerStars Game #59938813466:  Hold'em No Limit ($0.50/$1.00) - 2009/07/01 0:24:08 ET
Table 'aWHveb63HkbTmOGHOxjBkQ' 2-max Seat #2 is the button
Seat 1: xy2MQKoHoCZZIudmw8Xbow ($275.90 in chips)
Seat 2: xstEKavv3YDxpUnU4e9qAQ ($97.10 in chips)
xstEKavv3YDxpUnU4e9qAQ: posts small blind $0.50
xy2MQKoHoCZZIudmw8Xbow: posts big blind $1
*** HOLE CARDS ***
xstEKavv3YDxpUnU4e9qAQ: folds
xy2MQKoHoCZZIudmw8Xbow collected $1 from pot
xy2MQKoHoCZZIudmw8Xbow: doesn't show hand
*** SUMMARY ***
Total pot $1 | Rake $0
Seat 1: xy2MQKoHoCZZIudmw8Xbow (big blind) collected ($1)
Seat 2: xstEKavv3YDxpUnU4e9qAQ (button) (small blind) folded before Flop



PokerStars Game #59938817408:  Hold'em No Limit ($0.50/$1.00) - 2009/07/01 0:24:14 ET
Table 'aWHveb63HkbTmOGHOxjBkQ' 2-max Seat #1 is the button
Seat 1: xy2MQKoHoCZZIudmw8Xbow ($276.40 in chips)
Seat 2: xstEKavv3YDxpUnU4e9qAQ ($96.60 in chips)
xy2MQKoHoCZZIudmw8Xbow: posts small blind $0.50
xstEKavv3YDxpUnU4e9qAQ: posts big blind $1
*** HOLE CARDS ***
xy2MQKoHoCZZIudmw8Xbow: raises $3 to $4
xstEKavv3YDxpUnU4e9qAQ: raises $8 to $12
xy2MQKoHoCZZIudmw8Xbow: calls $8
*** FLOP *** [7h Ts 6c]
xstEKavv3YDxpUnU4e9qAQ: bets $13
xy2MQKoHoCZZIudmw8Xbow: calls $13
*** TURN *** [7h Ts 6c] [Js]
xstEKavv3YDxpUnU4e9qAQ: bets $25
xy2MQKoHoCZZIudmw8Xbow: folds
xstEKavv3YDxpUnU4e9qAQ collected $49.50 from pot
*** SUMMARY ***
Total pot $50 | Rake $0.50
Board [7h Ts 6c Js]
Seat 1: xy2MQKoHoCZZIudmw8Xbow (button) (small blind) folded on the Turn
Seat 2: xstEKavv3YDxpUnU4e9qAQ (big blind) collected ($49.50)



PokerStars Game #59938816768:  Hold'em No Limit ($0.50/$1.00) - 2009/07/01 0:24:14 ET
Table 'SQLOQoANiHscJ8AL7zffbw' 9-max Seat #8 is the button
Seat 1: jPTRd6SpCp4xqAy2XQiTOw ($119.85 in chips)
Seat 2: /zy+DB4S5fUQUSfZWFzYGw ($280.35 in chips)
Seat 3: 0eFnow7+D7veCYQ+CG9FFw ($71.50 in chips)
Seat 4: N9n5Wc3s35DpCrOAUUNAaQ ($120.30 in chips)
Seat 5: L9njYvloJ1NdXjP8edHEAg ($110.55 in chips)
Seat 6: p5UKaxVobvptF0ANhR/q1A ($157 in chips)
Seat 7: bJckevFOcg//s0qyMQI6sQ ($103.55 in chips)
Seat 8: 9ce+0Dl3d0BeEFIP+8HezA ($18.50 in chips)
Seat 9: qJr25HAtvv1w/7IBvjMM3g ($216.20 in chips)
qJr25HAtvv1w/7IBvjMM3g: posts small blind $0.50
jPTRd6SpCp4xqAy2XQiTOw: posts big blind $1
*** HOLE CARDS ***
/zy+DB4S5fUQUSfZWFzYGw: folds
0eFnow7+D7veCYQ+CG9FFw: folds
N9n5Wc3s35DpCrOAUUNAaQ: folds
L9njYvloJ1NdXjP8edHEAg: folds
p5UKaxVobvptF0ANhR/q1A: folds
bJckevFOcg//s0qyMQI6sQ: folds
9ce+0Dl3d0BeEFIP+8HezA: folds
qJr25HAtvv1w/7IBvjMM3g: calls $0.50
jPTRd6SpCp4xqAy2XQiTOw: checks
*** FLOP *** [7h 5d 3h]
qJr25HAtvv1w/7IBvjMM3g: bets $2
jPTRd6SpCp4xqAy2XQiTOw: calls $2
*** TURN *** [7h 5d 3h] [9s]
qJr25HAtvv1w/7IBvjMM3g: bets $4
jPTRd6SpCp4xqAy2XQiTOw: calls $4
*** RIVER *** [7h 5d 3h 9s] [2h]
qJr25HAtvv1w/7IBvjMM3g: bets $10
jPTRd6SpCp4xqAy2XQiTOw: calls $10
*** SHOW DOWN ***
qJr25HAtvv1w/7IBvjMM3g: shows [9h Kh] (a flush, King high)
jPTRd6SpCp4xqAy2XQiTOw: mucks hand
qJr25HAtvv1w/7IBvjMM3g collected $32.35 from pot
*** SUMMARY ***
Total pot $34 | Rake $1.65
Board [7h 5d 3h 9s 2h]
Seat 1: jPTRd6SpCp4xqAy2XQiTOw (big blind) mucked
Seat 2: /zy+DB4S5fUQUSfZWFzYGw folded before Flop (didn't bet)
Seat 3: 0eFnow7+D7veCYQ+CG9FFw folded before Flop (didn't bet)
Seat 4: N9n5Wc3s35DpCrOAUUNAaQ folded before Flop (didn't bet)
Seat 5: L9njYvloJ1NdXjP8edHEAg folded before Flop (didn't bet)
Seat 6: p5UKaxVobvptF0ANhR/q1A folded before Flop (didn't bet)
Seat 7: bJckevFOcg//s0qyMQI6sQ folded before Flop (didn't bet)
Seat 8: 9ce+0Dl3d0BeEFIP+8HezA (button) folded before Flop (didn't bet)
Seat 9: qJr25HAtvv1w/7IBvjMM3g (small blind) showed [9h Kh] and won ($32.35) with a flush, King high



PokerStars Game #59938816948:  Hold'em No Limit ($0.50/$1.00) - 2009/07/01 0:24:14 ET
Table '/RZcOwpZpHQ+OwPwjsbnRw' 6-max Seat #6 is the button
Seat 2: dHC9PH9hdH3Ad2TD8ZxX0Q ($40.60 in chips)
Seat 3: OigyyiK+tTj1APPIAUmXDA ($84.65 in chips)
Seat 4: j7NIOHLZk7V2o9fOioO5ug ($102 in chips)
Seat 5: wx3sQGkVi2x9wJXuWNHPBw ($205.05 in chips)
Seat 6: XOIf9W+VAxhZqN+SYoyMKA ($255.30 in chips)
dHC9PH9hdH3Ad2TD8ZxX0Q: posts small blind $0.50
OigyyiK+tTj1APPIAUmXDA: posts big blind $1
*** HOLE CARDS ***
j7NIOHLZk7V2o9fOioO5ug: raises $2 to $3
wx3sQGkVi2x9wJXuWNHPBw: calls $3
XOIf9W+VAxhZqN+SYoyMKA: folds
dHC9PH9hdH3Ad2TD8ZxX0Q: calls $2.50
OigyyiK+tTj1APPIAUmXDA: calls $2
*** FLOP *** [5c 6c 6s]
dHC9PH9hdH3Ad2TD8ZxX0Q: checks
OigyyiK+tTj1APPIAUmXDA: checks
j7NIOHLZk7V2o9fOioO5ug: bets $8
wx3sQGkVi2x9wJXuWNHPBw: folds
dHC9PH9hdH3Ad2TD8ZxX0Q: folds
OigyyiK+tTj1APPIAUmXDA: folds
j7NIOHLZk7V2o9fOioO5ug collected $11.40 from pot
j7NIOHLZk7V2o9fOioO5ug: doesn't show hand
*** SUMMARY ***
Total pot $12 | Rake $0.60
Board [5c 6c 6s]
Seat 2: dHC9PH9hdH3Ad2TD8ZxX0Q (small blind) folded on the Flop
Seat 3: OigyyiK+tTj1APPIAUmXDA (big blind) folded on the Flop
Seat 4: j7NIOHLZk7V2o9fOioO5ug collected ($11.40)
Seat 5: wx3sQGkVi2x9wJXuWNHPBw folded on the Flop
Seat 6: XOIf9W+VAxhZqN+SYoyMKA (button) folded before Flop (didn't bet)



PokerStars Game #59938818092:  Hold'em No Limit ($0.50/$1.00) - 2009/07/01 0:24:15 ET
Table '+cA8mcmhaedZ7YcrDdhmeQ' 6-max Seat #6 is the button
Seat 1: lsLuWlcPA3Rh7kJVLzMh0Q ($232 in chips)
Seat 2: trnpu4tPju3BU8W0wQQaiQ ($94.90 in chips)
Seat 3: 0WjiuIT7/EolY1oOx1ngeA ($117.80 in chips)
Seat 4: j0aDOn9Nft1HLTQvGu1UwA ($19.75 in chips)
Seat 5: 6WyjEXOToimYmtLdqIgHYQ ($60.50 in chips)
Seat 6: YfsTQsY/fxb+YqbdclTHuw ($114.25 in chips)
lsLuWlcPA3Rh7kJVLzMh0Q: posts small blind $0.50
trnpu4tPju3BU8W0wQQaiQ: posts big blind $1
*** HOLE CARDS ***
0WjiuIT7/EolY1oOx1ngeA: folds
j0aDOn9Nft1HLTQvGu1UwA: raises $1 to $2
6WyjEXOToimYmtLdqIgHYQ: folds
YfsTQsY/fxb+YqbdclTHuw: folds
lsLuWlcPA3Rh7kJVLzMh0Q: folds
trnpu4tPju3BU8W0wQQaiQ: calls $1
*** FLOP *** [5c 2c Ts]
trnpu4tPju3BU8W0wQQaiQ: checks
j0aDOn9Nft1HLTQvGu1UwA: bets $2
trnpu4tPju3BU8W0wQQaiQ: calls $2
*** TURN *** [5c 2c Ts] [3d]
trnpu4tPju3BU8W0wQQaiQ: checks
j0aDOn9Nft1HLTQvGu1UwA: bets $3
trnpu4tPju3BU8W0wQQaiQ: calls $3
*** RIVER *** [5c 2c Ts 3d] [3s]
trnpu4tPju3BU8W0wQQaiQ: checks
j0aDOn9Nft1HLTQvGu1UwA: bets $3
trnpu4tPju3BU8W0wQQaiQ: calls $3
*** SHOW DOWN ***
j0aDOn9Nft1HLTQvGu1UwA: shows [Kh 6d] (a pair of Threes)
trnpu4tPju3BU8W0wQQaiQ: shows [As 8c] (a pair of Threes - Ace kicker)
trnpu4tPju3BU8W0wQQaiQ collected $19.55 from pot
*** SUMMARY ***
Total pot $20.50 | Rake $0.95
Board [5c 2c Ts 3d 3s]
Seat 1: lsLuWlcPA3Rh7kJVLzMh0Q (small blind) folded before Flop
Seat 2: trnpu4tPju3BU8W0wQQaiQ (big blind) showed [As 8c] and won ($19.55) with a pair of Threes
Seat 3: 0WjiuIT7/EolY1oOx1ngeA folded before Flop (didn't bet)
Seat 4: j0aDOn9Nft1HLTQvGu1UwA showed [Kh 6d] and lost with a pair of Threes
Seat 5: 6WyjEXOToimYmtLdqIgHYQ folded before Flop (didn't bet)
Seat 6: YfsTQsY/fxb+YqbdclTHuw (button) folded before Flop (didn't bet)



PokerStars Game #59938817524:  Hold'em No Limit ($0.50/$1.00) - 2009/07/01 0:24:15 ET
Table 'MUPc8FEpe/nR0BKSeReX6Q' 6-max Seat #4 is the button
Seat 1: YsLQ3BAvgQHWXMAv3Wv6Hg ($100 in chips)
Seat 2: xAU6q2/cwmby2sxmA8VcmA ($100 in chips)
Seat 3: wx3sQGkVi2x9wJXuWNHPBw ($234.05 in chips)
Seat 4: ZA1bp6g8IwtTxkUE4eCjDQ ($114.95 in chips)
Seat 5: UBZQqpnJZdTYYY1FTb0rLA ($100.50 in chips)
Seat 6: oxnw0GLLpFanjhGkxfRSqA ($52.90 in chips)
UBZQqpnJZdTYYY1FTb0rLA: posts small blind $0.50
oxnw0GLLpFanjhGkxfRSqA: posts big blind $1
*** HOLE CARDS ***
YsLQ3BAvgQHWXMAv3Wv6Hg: folds
xAU6q2/cwmby2sxmA8VcmA: folds
wx3sQGkVi2x9wJXuWNHPBw: folds
ZA1bp6g8IwtTxkUE4eCjDQ: folds
UBZQqpnJZdTYYY1FTb0rLA: raises $2 to $3
oxnw0GLLpFanjhGkxfRSqA: calls $2
*** FLOP *** [2s 2c 8d]
UBZQqpnJZdTYYY1FTb0rLA: checks
oxnw0GLLpFanjhGkxfRSqA: checks
*** TURN *** [2s 2c 8d] [Jd]
UBZQqpnJZdTYYY1FTb0rLA: checks
oxnw0GLLpFanjhGkxfRSqA: bets $3
UBZQqpnJZdTYYY1FTb0rLA: folds
oxnw0GLLpFanjhGkxfRSqA collected $5.70 from pot
*** SUMMARY ***
Total pot $6 | Rake $0.30
Board [2s 2c 8d Jd]
Seat 1: YsLQ3BAvgQHWXMAv3Wv6Hg folded before Flop (didn't bet)
Seat 2: xAU6q2/cwmby2sxmA8VcmA folded before Flop (didn't bet)
Seat 3: wx3sQGkVi2x9wJXuWNHPBw folded before Flop (didn't bet)
Seat 4: ZA1bp6g8IwtTxkUE4eCjDQ (button) folded before Flop (didn't bet)
Seat 5: UBZQqpnJZdTYYY1FTb0rLA (small blind) folded on the Turn
Seat 6: oxnw0GLLpFanjhGkxfRSqA (big blind) collected ($5.70)



PokerStars Game #59938818204:  Hold'em No Limit ($0.50/$1.00) - 2009/07/01 0:24:16 ET
Table 'U9zqzC8f3oTJ2ShXFgSSOA' 6-max Seat #1 is the button
Seat 1: tS9JHB1h+FQ++qu8RwRNgg ($15.45 in chips)
Seat 2: U2CWBTv29qdCbj8RNF2sIw ($96.30 in chips)
Seat 3: yfXek8iJ7O4CFyqXrtGcfg ($59 in chips)
Seat 4: 33q95we0Etwgrm6guQGncw ($73.90 in chips)
Seat 5: KfwW5us6tydK81NYTtK1gw ($207.40 in chips)
Seat 6: aIxzFKdtpDSkUePKZy/niQ ($45 in chips)
U2CWBTv29qdCbj8RNF2sIw: posts small blind $0.50
yfXek8iJ7O4CFyqXrtGcfg: posts big blind $1
*** HOLE CARDS ***
33q95we0Etwgrm6guQGncw: folds
KfwW5us6tydK81NYTtK1gw: folds
aIxzFKdtpDSkUePKZy/niQ: calls $1
tS9JHB1h+FQ++qu8RwRNgg: folds
U2CWBTv29qdCbj8RNF2sIw: folds
yfXek8iJ7O4CFyqXrtGcfg: checks
*** FLOP *** [Ac 6h 3s]
yfXek8iJ7O4CFyqXrtGcfg: checks
aIxzFKdtpDSkUePKZy/niQ: checks
*** TURN *** [Ac 6h 3s] [4c]
yfXek8iJ7O4CFyqXrtGcfg: checks
aIxzFKdtpDSkUePKZy/niQ: checks
*** RIVER *** [Ac 6h 3s 4c] [Kd]
yfXek8iJ7O4CFyqXrtGcfg: checks
aIxzFKdtpDSkUePKZy/niQ: checks
*** SHOW DOWN ***
yfXek8iJ7O4CFyqXrtGcfg: shows [9c Td] (high card Ace)
aIxzFKdtpDSkUePKZy/niQ: shows [Jh 7h] (high card Ace - King+Jack kicker)
aIxzFKdtpDSkUePKZy/niQ collected $2.40 from pot
*** SUMMARY ***
Total pot $2.50 | Rake $0.10
Board [Ac 6h 3s 4c Kd]
Seat 1: tS9JHB1h+FQ++qu8RwRNgg (button) folded before Flop (didn't bet)
Seat 2: U2CWBTv29qdCbj8RNF2sIw (small blind) folded before Flop
Seat 3: yfXek8iJ7O4CFyqXrtGcfg (big blind) showed [9c Td] and lost with high card Ace
Seat 4: 33q95we0Etwgrm6guQGncw folded before Flop (didn't bet)
Seat 5: KfwW5us6tydK81NYTtK1gw folded before Flop (didn't bet)
Seat 6: aIxzFKdtpDSkUePKZy/niQ showed [Jh 7h] and won ($2.40) with high card Ace



PokerStars Game #59938818888:  Hold'em No Limit ($0.50/$1.00) - 2009/07/01 0:24:17 ET
Table 'kS0cTQAEi+fdUlJP2gQYvw' 9-max Seat #8 is the button
Seat 1: c/9X4zftzphFxYtxp5kp9w ($51.90 in chips)
Seat 2: 4SFNYndzMeslixOnF4koZQ ($55.15 in chips)
Seat 3: 3obndzTJ6fECz8+wWhMd1w ($18.50 in chips)
Seat 4: TZcz9MEWDA+WydgGruqqbw ($100 in chips)
Seat 5: 2rxrMrE7koO2BNxvop/0+g ($49.20 in chips)
Seat 6: yAbu2QsRPVcjPbqlf/jDxw ($100.65 in chips)
Seat 7: Ffa7Nj4X5fddtROP01hfQg ($91.10 in chips)
Seat 8: qTymj6ZQ8ZoFi6fINJZb3w ($85 in chips)
Seat 9: y8Qb94e81yI/g0saQ6gU5g ($88.25 in chips)
y8Qb94e81yI/g0saQ6gU5g: posts small blind $0.50
c/9X4zftzphFxYtxp5kp9w: posts big blind $1
*** HOLE CARDS ***
4SFNYndzMeslixOnF4koZQ: folds
3obndzTJ6fECz8+wWhMd1w has timed out
3obndzTJ6fECz8+wWhMd1w: folds
3obndzTJ6fECz8+wWhMd1w is sitting out
TZcz9MEWDA+WydgGruqqbw: folds
2rxrMrE7koO2BNxvop/0+g has timed out
2rxrMrE7koO2BNxvop/0+g: folds
2rxrMrE7koO2BNxvop/0+g is sitting out
2rxrMrE7koO2BNxvop/0+g has returned
yAbu2QsRPVcjPbqlf/jDxw: folds
Ffa7Nj4X5fddtROP01hfQg: folds
qTymj6ZQ8ZoFi6fINJZb3w: raises $2 to $3
3obndzTJ6fECz8+wWhMd1w has returned
y8Qb94e81yI/g0saQ6gU5g: folds
c/9X4zftzphFxYtxp5kp9w: folds
qTymj6ZQ8ZoFi6fINJZb3w collected $2.50 from pot
qTymj6ZQ8ZoFi6fINJZb3w: doesn't show hand
*** SUMMARY ***
Total pot $2.50 | Rake $0
Seat 1: c/9X4zftzphFxYtxp5kp9w (big blind) folded before Flop
Seat 2: 4SFNYndzMeslixOnF4koZQ folded before Flop (didn't bet)
Seat 3: 3obndzTJ6fECz8+wWhMd1w folded before Flop (didn't bet)
Seat 4: TZcz9MEWDA+WydgGruqqbw folded before Flop (didn't bet)
Seat 5: 2rxrMrE7koO2BNxvop/0+g folded before Flop (didn't bet)
Seat 6: yAbu2QsRPVcjPbqlf/jDxw folded before Flop (didn't bet)
Seat 7: Ffa7Nj4X5fddtROP01hfQg folded before Flop (didn't bet)
Seat 8: qTymj6ZQ8ZoFi6fINJZb3w (button) collected ($2.50)
Seat 9: y8Qb94e81yI/g0saQ6gU5g (small blind) folded before Flop



PokerStars Game #59938819788:  Hold'em No Limit ($0.50/$1.00) - 2009/07/01 0:24:18 ET
Table 'rmZfTK+oSebeUPJNbWhdAA' 6-max Seat #1 is the button
Seat 1: xAU6q2/cwmby2sxmA8VcmA ($100 in chips)
Seat 2: OigyyiK+tTj1APPIAUmXDA ($76.70 in chips)
Seat 3: 9yjOzGERLaEZS8CZ6YNHFg ($61.30 in chips)
Seat 4: OGMLOcTNYZXZU81au7ztUw ($126.65 in chips)
Seat 5: VuZb/hkEc4X7s93w2ZZTpA ($111.25 in chips)
Seat 6: j7NIOHLZk7V2o9fOioO5ug ($108 in chips)
OigyyiK+tTj1APPIAUmXDA: posts small blind $0.50
9yjOzGERLaEZS8CZ6YNHFg: posts big blind $1
*** HOLE CARDS ***
OGMLOcTNYZXZU81au7ztUw: folds
VuZb/hkEc4X7s93w2ZZTpA: folds
j7NIOHLZk7V2o9fOioO5ug: folds
xAU6q2/cwmby2sxmA8VcmA: folds
OigyyiK+tTj1APPIAUmXDA: folds
9yjOzGERLaEZS8CZ6YNHFg collected $1 from pot
*** SUMMARY ***
Total pot $1 | Rake $0
Seat 1: xAU6q2/cwmby2sxmA8VcmA (button) folded before Flop (didn't bet)
Seat 2: OigyyiK+tTj1APPIAUmXDA (small blind) folded before Flop
Seat 3: 9yjOzGERLaEZS8CZ6YNHFg (big blind) collected ($1)
Seat 4: OGMLOcTNYZXZU81au7ztUw folded before Flop (didn't bet)
Seat 5: VuZb/hkEc4X7s93w2ZZTpA folded before Flop (didn't bet)
Seat 6: j7NIOHLZk7V2o9fOioO5ug folded before Flop (didn't bet)



PokerStars Game #59938820490:  Hold'em No Limit ($0.50/$1.00) - 2009/07/01 0:24:19 ET
Table 'tyUh+jyNvrceIQdKMJjQ2wZFWj23PMihdwrNWv41OG/Qeat #5 is the button
Seat 1: o8A5MUdudVKu+pAwgZOX2w ($195.65 in chips)
Seat 2: 6iVcnPw9a2oNG6sPQo3G6g ($100 in chips)
Seat 3: L9qfLYXrczhAPd/VckgsWw ($37.95 in chips)
Seat 4: TSuRyAHnUPCFjP7Z0rEE0w ($159.95 in chips)
Seat 5: j7NIOHLZk7V2o9fOioO5ug ($102.45 in chips)
Seat 6: YsLQ3BAvgQHWXMAv3Wv6Hg ($105.75 in chips)
YsLQ3BAvgQHWXMAv3Wv6Hg: posts small blind $0.50
o8A5MUdudVKu+pAwgZOX2w: posts big blind $1
*** HOLE CARDS ***
6iVcnPw9a2oNG6sPQo3G6g: folds
L9qfLYXrczhAPd/VckgsWw: folds
TSuRyAHnUPCFjP7Z0rEE0w: folds
j7NIOHLZk7V2o9fOioO5ug: folds
YsLQ3BAvgQHWXMAv3Wv6Hg: folds
o8A5MUdudVKu+pAwgZOX2w collected $1 from pot
o8A5MUdudVKu+pAwgZOX2w: doesn't show hand
*** SUMMARY ***
Total pot $1 | Rake $0
Seat 1: o8A5MUdudVKu+pAwgZOX2w (big blind) collected ($1)
Seat 2: 6iVcnPw9a2oNG6sPQo3G6g folded before Flop (didn't bet)
Seat 3: L9qfLYXrczhAPd/VckgsWw folded before Flop (didn't bet)
Seat 4: TSuRyAHnUPCFjP7Z0rEE0w folded before Flop (didn't bet)
Seat 5: j7NIOHLZk7V2o9fOioO5ug (button) folded before Flop (didn't bet)
Seat 6: YsLQ3BAvgQHWXMAv3Wv6Hg (small blind) folded before Flop



PokerStars Game #59938821050:  Hold'em No Limit ($0.50/$1.00) - 2009/07/01 0:24:20 ET
Table 'ZFWj23PMihdwrNWv41OG/Q' 9-max Seat #1 is the button
Seat 1: yAbu2QsRPVcjPbqlf/jDxw ($101.80 in chips)
Seat 2: ARfmgHcEUKh68laBZy4veA ($56.75 in chips)
Seat 3: G9Fo2TZCN7HI43Po4zSN3A ($100 in chips)
Seat 4: PEmogYqKpuv0ozeBbXL+7Q ($31.50 in chips)
Seat 6: tjhwe1V98x2spSoUQER3HQ ($100 in chips)
Seat 7: wIZ377kjl2fHFGnS93o6bw ($43.95 in chips)
Seat 8: knewtTmBc4Tc0z/5tAABYQ ($107.50 in chips)
ARfmgHcEUKh68laBZy4veA: posts small blind $0.50
G9Fo2TZCN7HI43Po4zSN3A: posts big blind $1
tkdBeXTJlFsZdioidNqLow: sits out
*** HOLE CARDS ***
PEmogYqKpuv0ozeBbXL+7Q: calls $1
tjhwe1V98x2spSoUQER3HQ: folds
wIZ377kjl2fHFGnS93o6bw: folds
knewtTmBc4Tc0z/5tAABYQ: folds
yAbu2QsRPVcjPbqlf/jDxw: folds
ARfmgHcEUKh68laBZy4veA: folds
G9Fo2TZCN7HI43Po4zSN3A: raises $4 to $5
PEmogYqKpuv0ozeBbXL+7Q: calls $4
*** FLOP *** [3c 8h As]
G9Fo2TZCN7HI43Po4zSN3A: checks
PEmogYqKpuv0ozeBbXL+7Q: bets $5
G9Fo2TZCN7HI43Po4zSN3A: folds
PEmogYqKpuv0ozeBbXL+7Q collected $10 from pot
*** SUMMARY ***
Total pot $10.50 | Rake $0.50
Board [3c 8h As]
Seat 1: yAbu2QsRPVcjPbqlf/jDxw (button) folded before Flop (didn't bet)
Seat 2: ARfmgHcEUKh68laBZy4veA (small blind) folded before Flop
Seat 3: G9Fo2TZCN7HI43Po4zSN3A (big blind) folded on the Flop
Seat 4: PEmogYqKpuv0ozeBbXL+7Q collected ($10)
Seat 6: tjhwe1V98x2spSoUQER3HQ folded before Flop (didn't bet)
Seat 7: wIZ377kjl2fHFGnS93o6bw folded before Flop (didn't bet)
Seat 8: knewtTmBc4Tc0z/5tAABYQ folded before Flop (didn't bet)



PokerStars Game #59938821540:  Hold'em No Limit ($0.50/$1.00) - 2009/07/01 0:24:21 ET
Table 'tLrtq7gDzxEvckNAI1OS5Q' 6-max Seat #2 is the button
Seat 1: GisIe1kcC9q/xV6ifsTjgA ($153.35 in chips)
Seat 2: qsObMEIlRO22OlS867m/lw ($9.90 in chips)
Seat 3: TPZ+m9x+lwoKpv7TMfAUWA ($316.55 in chips)
Seat 4: KOG8rG51mOvIoY96zF3kvw ($161.80 in chips)
Seat 5: OGMLOcTNYZXZU81au7ztUw ($176.85 in chips)
Seat 6: XUk5GQsfNFpHvaToDZ0rZA ($44.95 in chips)
TPZ+m9x+lwoKpv7TMfAUWA: posts small blind $0.50
KOG8rG51mOvIoY96zF3kvw: posts big blind $1
*** HOLE CARDS ***
OGMLOcTNYZXZU81au7ztUw: folds
XUk5GQsfNFpHvaToDZ0rZA: folds
GisIe1kcC9q/xV6ifsTjgA: folds
qsObMEIlRO22OlS867m/lw: folds
TPZ+m9x+lwoKpv7TMfAUWA: folds
KOG8rG51mOvIoY96zF3kvw collected $1 from pot
KOG8rG51mOvIoY96zF3kvw: doesn't show hand
*** SUMMARY ***
Total pot $1 | Rake $0
Seat 1: GisIe1kcC9q/xV6ifsTjgA folded before Flop (didn't bet)
Seat 2: qsObMEIlRO22OlS867m/lw (button) folded before Flop (didn't bet)
Seat 3: TPZ+m9x+lwoKpv7TMfAUWA (small blind) folded before Flop
Seat 4: KOG8rG51mOvIoY96zF3kvw (big blind) collected ($1)
Seat 5: OGMLOcTNYZXZU81au7ztUw folded before Flop (didn't bet)
Seat 6: XUk5GQsfNFpHvaToDZ0rZA folded before Flop (didn't bet)



PokerStars Game #59938822462:  Hold'em No Limit ($0.50/$1.00) - 2009/07/01 0:24:22 ET
Table 'fTlPiCj0utgzC/5io+I7ew' 6-max Seat #1 is the button
Seat 1: YMJG+F++3Aj6P8dAWda5fw ($98.50 in chips)
Seat 2: +xUCTmR3cU7G239W+vZv6g ($145.35 in chips)
Seat 3: oDiBRCaF0QVtd3kO6xZIXw ($100 in chips)
Seat 4: uJVSceLggtsrJya+WtmUEA ($93.60 in chips)
Seat 5: bFrTkDcWGTxyvNul7GVdYg ($246.35 in chips)
+xUCTmR3cU7G239W+vZv6g: posts small blind $0.50
oDiBRCaF0QVtd3kO6xZIXw: posts big blind $1
*** HOLE CARDS ***
jMljU/dOPMXfJi8OmbdYdw joins the table at seat #6
jMljU/dOPMXfJi8OmbdYdw is sitting out
uJVSceLggtsrJya+WtmUEA: folds
bFrTkDcWGTxyvNul7GVdYg: raises $2 to $3
YMJG+F++3Aj6P8dAWda5fw: folds
+xUCTmR3cU7G239W+vZv6g: folds
oDiBRCaF0QVtd3kO6xZIXw: folds
bFrTkDcWGTxyvNul7GVdYg collected $2.50 from pot
*** SUMMARY ***
Total pot $2.50 | Rake $0
Seat 1: YMJG+F++3Aj6P8dAWda5fw (button) folded before Flop (didn't bet)
Seat 2: +xUCTmR3cU7G239W+vZv6g (small blind) folded before Flop
Seat 3: oDiBRCaF0QVtd3kO6xZIXw (big blind) folded before Flop
Seat 4: uJVSceLggtsrJya+WtmUEA folded before Flop (didn't bet)
Seat 5: bFrTkDcWGTxyvNul7GVdYg collected ($2.50)



PokerStars Game #59938823318:  Hold'em No Limit ($0.50/$1.00) - 2009/07/01 0:24:23 ET
Table 'N2bNCDHL96aCQDvZIh+yQQ' 6-max Seat #1 is the button
Seat 1: iHo1oDbrEVJ8nEGdaPrICw ($143.50 in chips)
Seat 2: KpnW5CcJ4Mg6MeclfKmLrw ($102.50 in chips)
Seat 4: uCqEjnxh2/vFBjKYkfTOkw ($160.20 in chips)
Seat 5: rHlMOfR7kpQQxe+PFQz0xQ ($38.90 in chips)
Seat 6: TSuRyAHnUPCFjP7Z0rEE0w ($100 in chips)
KpnW5CcJ4Mg6MeclfKmLrw: posts small blind $0.50
uCqEjnxh2/vFBjKYkfTOkw: posts big blind $1
*** HOLE CARDS ***
rHlMOfR7kpQQxe+PFQz0xQ: folds
3LCfF9/CuJ9+kbFOcqmuaQ joins the table at seat #3
TSuRyAHnUPCFjP7Z0rEE0w: folds
iHo1oDbrEVJ8nEGdaPrICw: folds
KpnW5CcJ4Mg6MeclfKmLrw: folds
uCqEjnxh2/vFBjKYkfTOkw collected $1 from pot
uCqEjnxh2/vFBjKYkfTOkw: doesn't show hand
*** SUMMARY ***
Total pot $1 | Rake $0
Seat 1: iHo1oDbrEVJ8nEGdaPrICw (button) folded before Flop (didn't bet)
Seat 2: KpnW5CcJ4Mg6MeclfKmLrw (small blind) folded before Flop
Seat 4: uCqEjnxh2/vFBjKYkfTOkw (big blind) collected ($1)
Seat 5: rHlMOfR7kpQQxe+PFQz0xQ folded before Flop (didn't bet)
Seat 6: TSuRyAHnUPCFjP7Z0rEE0w folded before Flop (didn't bet)



PokerStars Game #59938823532:  Hold'em No Limit ($0.50/$1.00) - 2009/07/01 0:24:24 ET
Table 'Zka9tv1yilg0MvXWPQrShg' 9-max Seat #8 is the button
Seat 1: TZcz9MEWDA+WydgGruqqbw ($100 in chips)
Seat 2: zBHLwg+HmbHmRtVQMhavjA ($123.35 in chips)
Seat 3: gUUvmqdVlmvpal6B8nYrmg ($100 in chips)
Seat 4: CTOae+JLIGfwfXvhqHkP2w ($172.15 in chips)
Seat 5: /zy+DB4S5fUQUSfZWFzYGw ($141.45 in chips)
Seat 6: rY8wPoax1lS+HUY+I0FZDw ($128.40 in chips)
Seat 7: p1SafS90nb3Uft5LB0NkHw ($21.50 in chips)
Seat 8: bL+QVeDcuEdzMGAGg2XJHg ($124.60 in chips)
Seat 9: SlhHwZrXCVifyCHK+qz1Kw ($96.45 in chips)
SlhHwZrXCVifyCHK+qz1Kw: posts small blind $0.50
TZcz9MEWDA+WydgGruqqbw: posts big blind $1
*** HOLE CARDS ***
zBHLwg+HmbHmRtVQMhavjA: folds
gUUvmqdVlmvpal6B8nYrmg: folds
CTOae+JLIGfwfXvhqHkP2w: folds
/zy+DB4S5fUQUSfZWFzYGw: folds
rY8wPoax1lS+HUY+I0FZDw: folds
p1SafS90nb3Uft5LB0NkHw: folds
bL+QVeDcuEdzMGAGg2XJHg: folds
SlhHwZrXCVifyCHK+qz1Kw: raises $2 to $3
TZcz9MEWDA+WydgGruqqbw: raises $8 to $11
SlhHwZrXCVifyCHK+qz1Kw: calls $8
*** FLOP *** [9s Kd Ts]
SlhHwZrXCVifyCHK+qz1Kw: checks
TZcz9MEWDA+WydgGruqqbw: bets $16
SlhHwZrXCVifyCHK+qz1Kw: folds
SlhHwZrXCVifyCHK+qz1Kw leaves the table
TZcz9MEWDA+WydgGruqqbw collected $20.90 from pot
*** SUMMARY ***
Total pot $22 | Rake $1.10
Board [9s Kd Ts]
Seat 1: TZcz9MEWDA+WydgGruqqbw (big blind) collected ($20.90)
Seat 2: zBHLwg+HmbHmRtVQMhavjA folded before Flop (didn't bet)
Seat 3: gUUvmqdVlmvpal6B8nYrmg folded before Flop (didn't bet)
Seat 4: CTOae+JLIGfwfXvhqHkP2w folded before Flop (didn't bet)
Seat 5: /zy+DB4S5fUQUSfZWFzYGw folded before Flop (didn't bet)
Seat 6: rY8wPoax1lS+HUY+I0FZDw folded before Flop (didn't bet)
Seat 7: p1SafS90nb3Uft5LB0NkHw folded before Flop (didn't bet)
Seat 8: bL+QVeDcuEdzMGAGg2XJHg (button) folded before Flop (didn't bet)
Seat 9: SlhHwZrXCVifyCHK+qz1Kw (small blind) folded on the Flop



PokerStars Game #59938824608:  Hold'em No Limit ($0.50/$1.00) - 2009/07/01 0:24:25 ET
Table 'b/mVBMBBjZR4F+Jsv8cuYA' 9-max Seat #7 is the button
Seat 2: HPmAhANyB1+4MGzYS9i5Wg ($33.60 in chips)
Seat 3: x80+i7DJL+81v3quj7KbNg ($20 in chips)
Seat 4: 0oXWlMUwwWciWdZOQf6yUw ($99.95 in chips)
Seat 5: p5UKaxVobvptF0ANhR/q1A ($100 in chips)
Seat 6: FL3MrLspcF23LYvC4ipBOA ($316.10 in chips)
Seat 7: 5GtqC1O4Y1t1VmP51SDSJQ ($105 in chips)
Seat 8: L9njYvloJ1NdXjP8edHEAg ($101.50 in chips)
Seat 9: 9BZCcac3+McErkkSN2YScA ($113.95 in chips)
L9njYvloJ1NdXjP8edHEAg: posts small blind $0.50
9BZCcac3+McErkkSN2YScA: posts big blind $1
Ogn4JDV3mp4ZDKO49IFzKA: sits out
*** HOLE CARDS ***
HPmAhANyB1+4MGzYS9i5Wg: folds
x80+i7DJL+81v3quj7KbNg: folds
0oXWlMUwwWciWdZOQf6yUw: folds
p5UKaxVobvptF0ANhR/q1A: folds
FL3MrLspcF23LYvC4ipBOA: folds
5GtqC1O4Y1t1VmP51SDSJQ: folds
L9njYvloJ1NdXjP8edHEAg: raises $2 to $3
9BZCcac3+McErkkSN2YScA: folds
L9njYvloJ1NdXjP8edHEAg collected $2 from pot
*** SUMMARY ***
Total pot $2 | Rake $0
Seat 2: HPmAhANyB1+4MGzYS9i5Wg folded before Flop (didn't bet)
Seat 3: x80+i7DJL+81v3quj7KbNg folded before Flop (didn't bet)
Seat 4: 0oXWlMUwwWciWdZOQf6yUw folded before Flop (didn't bet)
Seat 5: p5UKaxVobvptF0ANhR/q1A folded before Flop (didn't bet)
Seat 6: FL3MrLspcF23LYvC4ipBOA folded before Flop (didn't bet)
Seat 7: 5GtqC1O4Y1t1VmP51SDSJQ (button) folded before Flop (didn't bet)
Seat 8: L9njYvloJ1NdXjP8edHEAg (small blind) collected ($2)
Seat 9: 9BZCcac3+McErkkSN2YScA (big blind) folded before Flop



PokerStars Game #59938825038:  Hold'em No Limit ($0.50/$1.00) - 2009/07/01 0:24:26 ET
Table 'W/wyObTiXZm+Ckkl3YxcSw' 6-max Seat #6 is the button
Seat 1: ssLJburtEIqnVkx6X8R1uw ($116.25 in chips)
Seat 2: oDiBRCaF0QVtd3kO6xZIXw ($100 in chips)
Seat 3: b2a+5TkFf4xJN/Ihhma58Q ($34.70 in chips)
Seat 4: BdbmJTZZ47quA9vUWwXtlw ($47.60 in chips)
Seat 6: 1yB1nHUkHNNY8OJnDNHZMw ($55.40 in chips)
ssLJburtEIqnVkx6X8R1uw: posts small blind $0.50
oDiBRCaF0QVtd3kO6xZIXw: posts big blind $1
*** HOLE CARDS ***
b2a+5TkFf4xJN/Ihhma58Q: folds
BdbmJTZZ47quA9vUWwXtlw: folds
1yB1nHUkHNNY8OJnDNHZMw has timed out
1yB1nHUkHNNY8OJnDNHZMw: folds
1yB1nHUkHNNY8OJnDNHZMw is sitting out
ssLJburtEIqnVkx6X8R1uw: folds
oDiBRCaF0QVtd3kO6xZIXw collected $1 from pot
oDiBRCaF0QVtd3kO6xZIXw: doesn't show hand
*** SUMMARY ***
Total pot $1 | Rake $0
Seat 1: ssLJburtEIqnVkx6X8R1uw (small blind) folded before Flop
Seat 2: oDiBRCaF0QVtd3kO6xZIXw (big blind) collected ($1)
Seat 3: b2a+5TkFf4xJN/Ihhma58Q folded before Flop (didn't bet)
Seat 4: BdbmJTZZ47quA9vUWwXtlw folded before Flop (didn't bet)
Seat 6: 1yB1nHUkHNNY8OJnDNHZMw (button) folded before Flop (didn't bet)



PokerStars Game #59938825710:  Hold'em No Limit ($0.50/$1.00) - 2009/07/01 0:24:27 ET
Table 'cBDNutyLBKEk9+ptwsKmTw' 6-max Seat #5 is the button
Seat 1: tb0dt30qP2x/8f+Xta4mVg ($20.80 in chips)
Seat 2: KyaE4+hWgUNIWWOWy4D14w ($65.25 in chips)
Seat 3: G5ZSSN6RSON3gkNvk/SmYg ($105.90 in chips)
Seat 4: 0WjiuIT7/EolY1oOx1ngeA ($105.15 in chips)
Seat 5: OGMLOcTNYZXZU81au7ztUw ($109.70 in chips)
Seat 6: pyzhFUPPSNzrysiMqlA5Xw ($11.10 in chips)
pyzhFUPPSNzrysiMqlA5Xw: posts small blind $0.50
tb0dt30qP2x/8f+Xta4mVg: posts big blind $1
*** HOLE CARDS ***
KyaE4+hWgUNIWWOWy4D14w: raises $1 to $2
G5ZSSN6RSON3gkNvk/SmYg: folds
0WjiuIT7/EolY1oOx1ngeA: folds
OGMLOcTNYZXZU81au7ztUw: folds
pyzhFUPPSNzrysiMqlA5Xw: folds
tb0dt30qP2x/8f+Xta4mVg: raises $2 to $4
KyaE4+hWgUNIWWOWy4D14w: calls $2
*** FLOP *** [8h 9c Th]
tb0dt30qP2x/8f+Xta4mVg: bets $16.80 and is all-in
KyaE4+hWgUNIWWOWy4D14w: calls $16.80
*** TURN *** [8h 9c Th] [4d]
*** RIVER *** [8h 9c Th 4d] [9s]
*** SHOW DOWN ***
tb0dt30qP2x/8f+Xta4mVg: shows [Ac Ks] (a pair of Nines)
KyaE4+hWgUNIWWOWy4D14w: shows [Qs Td] (two pair, Tens and Nines)
KyaE4+hWgUNIWWOWy4D14w collected $40.05 from pot
*** SUMMARY ***
Total pot $42.10 | Rake $2.05
Board [8h 9c Th 4d 9s]
Seat 1: tb0dt30qP2x/8f+Xta4mVg (big blind) showed [Ac Ks] and lost with a pair of Nines
Seat 2: KyaE4+hWgUNIWWOWy4D14w showed [Qs Td] and won ($40.05) with two pair, Tens and Nines
Seat 3: G5ZSSN6RSON3gkNvk/SmYg folded before Flop (didn't bet)
Seat 4: 0WjiuIT7/EolY1oOx1ngeA folded before Flop (didn't bet)
Seat 5: OGMLOcTNYZXZU81au7ztUw (button) folded before Flop (didn't bet)
Seat 6: pyzhFUPPSNzrysiMqlA5Xw (small blind) folded before Flop



PokerStars Game #59938827162:  Hold'em No Limit ($0.50/$1.00) - 2009/07/01 0:24:29 ET
Table 'eU3bWpDDg3Z+9R4m4iVmog' 6-max Seat #3 is the button
Seat 2: 8CAoOzhmB8n3nRFf3V4BTg ($140.95 in chips)
Seat 3: U6tnjwZRpTnM+YkqkCjwyQ ($154.05 in chips)
Seat 4: GDVIsbEJ/DOJsMKE4Asz0A ($98.50 in chips)
Seat 5: QHvTZcrKe6+maWUfVjP29Q ($103.50 in chips)
Seat 6: hpxXcmRkXXI9HE5+5/j/0Q ($100 in chips)
GDVIsbEJ/DOJsMKE4Asz0A: posts small blind $0.50
QHvTZcrKe6+maWUfVjP29Q: posts big blind $1
TSuRyAHnUPCFjP7Z0rEE0w: sits out
*** HOLE CARDS ***
hpxXcmRkXXI9HE5+5/j/0Q: raises $2 to $3
8CAoOzhmB8n3nRFf3V4BTg: folds
U6tnjwZRpTnM+YkqkCjwyQ: folds
GDVIsbEJ/DOJsMKE4Asz0A: folds
QHvTZcrKe6+maWUfVjP29Q: folds
hpxXcmRkXXI9HE5+5/j/0Q collected $2.50 from pot
hpxXcmRkXXI9HE5+5/j/0Q: doesn't show hand
*** SUMMARY ***
Total pot $2.50 | Rake $0
Seat 2: 8CAoOzhmB8n3nRFf3V4BTg folded before Flop (didn't bet)
Seat 3: U6tnjwZRpTnM+YkqkCjwyQ (button) folded before Flop (didn't bet)
Seat 4: GDVIsbEJ/DOJsMKE4Asz0A (small blind) folded before Flop
Seat 5: QHvTZcrKe6+maWUfVjP29Q (big blind) folded before Flop
Seat 6: hpxXcmRkXXI9HE5+5/j/0Q collected ($2.50)



PokerStars Game #59938828652:  Hold'em No Limit ($0.50/$1.00) - 2009/07/01 0:24:31 ET
Table 'vs/5jr6ciwjVQ5+Soc+u2A' 6-max Seat #3 is the button
Seat 2: XOIf9W+VAxhZqN+SYoyMKA ($120.30 in chips)
Seat 3: G5ZSSN6RSON3gkNvk/SmYg ($100.70 in chips)
Seat 4: KpnW5CcJ4Mg6MeclfKmLrw ($105.15 in chips)
Seat 5: 7Vc9JmGFQwMRh5Tj9ui5Lw ($95.65 in chips)
Seat 6: QHvTZcrKe6+maWUfVjP29Q ($100 in chips)
KpnW5CcJ4Mg6MeclfKmLrw: posts small blind $0.50
7Vc9JmGFQwMRh5Tj9ui5Lw: posts big blind $1
*** HOLE CARDS ***
QHvTZcrKe6+maWUfVjP29Q: folds
XOIf9W+VAxhZqN+SYoyMKA: folds
G5ZSSN6RSON3gkNvk/SmYg: folds
KpnW5CcJ4Mg6MeclfKmLrw: folds
7Vc9JmGFQwMRh5Tj9ui5Lw collected $1 from pot
7Vc9JmGFQwMRh5Tj9ui5Lw: doesn't show hand
*** SUMMARY ***
Total pot $1 | Rake $0
Seat 2: XOIf9W+VAxhZqN+SYoyMKA folded before Flop (didn't bet)
Seat 3: G5ZSSN6RSON3gkNvk/SmYg (button) folded before Flop (didn't bet)
Seat 4: KpnW5CcJ4Mg6MeclfKmLrw (small blind) folded before Flop
Seat 5: 7Vc9JmGFQwMRh5Tj9ui5Lw (big blind) collected ($1)
Seat 6: QHvTZcrKe6+maWUfVjP29Q folded before Flop (didn't bet)



PokerStars Game #59938831204:  Hold'em No Limit ($0.50/$1.00) - 2009/07/01 0:24:35 ET
Table 'VOs36P6NW+QyXeQ1B62kmA' 6-max Seat #6 is the button
Seat 1: AdLVjddOzm+sRNo1Bc3S6Q ($137.55 in chips)
Seat 2: KpnW5CcJ4Mg6MeclfKmLrw ($109.80 in chips)
Seat 4: w02zQzNydODiyV9THKgo9w ($24 in chips)
Seat 5: X7GlkHF+lkbarCLuZ4Uf0w ($19.50 in chips)
Seat 6: 6tvjsJrdmWg+g7FVrMnzXA ($74.10 in chips)
AdLVjddOzm+sRNo1Bc3S6Q: posts small blind $0.50
KpnW5CcJ4Mg6MeclfKmLrw: posts big blind $1
TSuRyAHnUPCFjP7Z0rEE0w: sits out
*** HOLE CARDS ***
w02zQzNydODiyV9THKgo9w: folds
X7GlkHF+lkbarCLuZ4Uf0w: raises $18.50 to $19.50 and is all-in
6tvjsJrdmWg+g7FVrMnzXA: folds
AdLVjddOzm+sRNo1Bc3S6Q: folds
KpnW5CcJ4Mg6MeclfKmLrw: folds
X7GlkHF+lkbarCLuZ4Uf0w collected $2.50 from pot
X7GlkHF+lkbarCLuZ4Uf0w: doesn't show hand
*** SUMMARY ***
Total pot $2.50 | Rake $0
Seat 1: AdLVjddOzm+sRNo1Bc3S6Q (small blind) folded before Flop
Seat 2: KpnW5CcJ4Mg6MeclfKmLrw (big blind) folded before Flop
Seat 4: w02zQzNydODiyV9THKgo9w folded before Flop (didn't bet)
Seat 5: X7GlkHF+lkbarCLuZ4Uf0w collected ($2.50)
Seat 6: 6tvjsJrdmWg+g7FVrMnzXA (button) folded before Flop (didn't bet)



PokerStars Game #59938832484:  Hold'em No Limit ($0.50/$1.00) - 2009/07/01 0:24:37 ET
Table 'tyUh+jyNvrceIQdKMJjQ2wZFWj23PMihdwrNWv41OG/Qeat #6 is the button
Seat 1: o8A5MUdudVKu+pAwgZOX2w ($196.15 in chips)
Seat 2: 6iVcnPw9a2oNG6sPQo3G6g ($100 in chips)
Seat 3: L9qfLYXrczhAPd/VckgsWw ($37.95 in chips)
Seat 4: TSuRyAHnUPCFjP7Z0rEE0w ($159.95 in chips)
Seat 5: j7NIOHLZk7V2o9fOioO5ug ($102.45 in chips)
Seat 6: YsLQ3BAvgQHWXMAv3Wv6Hg ($105.25 in chips)
o8A5MUdudVKu+pAwgZOX2w: posts small blind $0.50
6iVcnPw9a2oNG6sPQo3G6g: posts big blind $1
*** HOLE CARDS ***
L9qfLYXrczhAPd/VckgsWw: folds
TSuRyAHnUPCFjP7Z0rEE0w: raises $3 to $4
j7NIOHLZk7V2o9fOioO5ug: folds
YsLQ3BAvgQHWXMAv3Wv6Hg: folds
o8A5MUdudVKu+pAwgZOX2w: calls $3.50
6iVcnPw9a2oNG6sPQo3G6g: folds
*** FLOP *** [2s Qc 7d]
o8A5MUdudVKu+pAwgZOX2w: checks
TSuRyAHnUPCFjP7Z0rEE0w: bets $6
o8A5MUdudVKu+pAwgZOX2w: calls $6
*** TURN *** [2s Qc 7d] [4c]
o8A5MUdudVKu+pAwgZOX2w: checks
TSuRyAHnUPCFjP7Z0rEE0w: bets $16
o8A5MUdudVKu+pAwgZOX2w: calls $16
*** RIVER *** [2s Qc 7d 4c] [3s]
o8A5MUdudVKu+pAwgZOX2w: bets $25
TSuRyAHnUPCFjP7Z0rEE0w: folds
o8A5MUdudVKu+pAwgZOX2w collected $50.40 from pot
o8A5MUdudVKu+pAwgZOX2w: doesn't show hand
*** SUMMARY ***
Total pot $53 | Rake $2.60
Board [2s Qc 7d 4c 3s]
Seat 1: o8A5MUdudVKu+pAwgZOX2w (small blind) collected ($50.40)
Seat 2: 6iVcnPw9a2oNG6sPQo3G6g (big blind) folded before Flop
Seat 3: L9qfLYXrczhAPd/VckgsWw folded before Flop (didn't bet)
Seat 4: TSuRyAHnUPCFjP7Z0rEE0w folded on the River
Seat 5: j7NIOHLZk7V2o9fOioO5ug folded before Flop (didn't bet)
Seat 6: YsLQ3BAvgQHWXMAv3Wv6Hg (button) folded before Flop (didn't bet)



PokerStars Game #59938832994:  Hold'em No Limit ($0.50/$1.00) - 2009/07/01 0:24:38 ET
Table '/FUb199IViHMJHi5YWmeuQ' 9-max Seat #4 is the button
Seat 1: TZcz9MEWDA+WydgGruqqbw ($100 in chips)
Seat 2: FL3MrLspcF23LYvC4ipBOA ($133.75 in chips)
Seat 3: qN483QJ1NvHbdIZB7J4ARw ($73.75 in chips)
Seat 4: qheQay5YvP2DMAb3OUSxtw ($105.80 in chips)
Seat 5: +za1iHiRgVo4OcAz0SOZqw ($15.95 in chips)
Seat 6: ccFf7Q4z1cTGQmeoYiWEfw ($40 in chips)
Seat 7: atVaKXE/AQGa798rpMF/Bg ($17 in chips)
Seat 8: QIWvt0R766g8KfH0vl1s0A ($49.10 in chips)
Seat 9: knewtTmBc4Tc0z/5tAABYQ ($124.25 in chips)
+za1iHiRgVo4OcAz0SOZqw: posts small blind $0.50
ccFf7Q4z1cTGQmeoYiWEfw: posts big blind $1
*** HOLE CARDS ***
atVaKXE/AQGa798rpMF/Bg: folds
QIWvt0R766g8KfH0vl1s0A: folds
atVaKXE/AQGa798rpMF/Bg leaves the table
knewtTmBc4Tc0z/5tAABYQ: folds
TZcz9MEWDA+WydgGruqqbw: folds
FL3MrLspcF23LYvC4ipBOA: folds
qN483QJ1NvHbdIZB7J4ARw: folds
bLbSOSmSOnqE0iTcH/5dxA joins the table at seat #7
qheQay5YvP2DMAb3OUSxtw: raises $2 to $3
+za1iHiRgVo4OcAz0SOZqw: folds
ccFf7Q4z1cTGQmeoYiWEfw: folds
qheQay5YvP2DMAb3OUSxtw collected $2.50 from pot
qheQay5YvP2DMAb3OUSxtw: doesn't show hand
*** SUMMARY ***
Total pot $2.50 | Rake $0
Seat 1: TZcz9MEWDA+WydgGruqqbw folded before Flop (didn't bet)
Seat 2: FL3MrLspcF23LYvC4ipBOA folded before Flop (didn't bet)
Seat 3: qN483QJ1NvHbdIZB7J4ARw folded before Flop (didn't bet)
Seat 4: qheQay5YvP2DMAb3OUSxtw (button) collected ($2.50)
Seat 5: +za1iHiRgVo4OcAz0SOZqw (small blind) folded before Flop
Seat 6: ccFf7Q4z1cTGQmeoYiWEfw (big blind) folded before Flop
Seat 7: atVaKXE/AQGa798rpMF/Bg folded before Flop (didn't bet)
Seat 8: QIWvt0R766g8KfH0vl1s0A folded before Flop (didn't bet)
Seat 9: knewtTmBc4Tc0z/5tAABYQ folded before Flop (didn't bet)



PokerStars Game #59938833638:  Hold'em No Limit ($0.50/$1.00) - 2009/07/01 0:24:39 ET
Table 'pHrhryH8jPNdQfY62f8v+g' 6-max Seat #3 is the button
Seat 1: BdbmJTZZ47quA9vUWwXtlw ($68.25 in chips)
Seat 2: RqgF7gRoKgRNW8Zoi1ty4A ($116.50 in chips)
Seat 3: 0WjiuIT7/EolY1oOx1ngeA ($100 in chips)
Seat 4: wenbG7TaM3H7h5kn78OFNw ($56.50 in chips)
Seat 5: Gp2euK/nqF6qXKe7U+jOfw ($118.65 in chips)
wenbG7TaM3H7h5kn78OFNw: posts small blind $0.50
Gp2euK/nqF6qXKe7U+jOfw: posts big blind $1
xAU6q2/cwmby2sxmA8VcmA: sits out
*** HOLE CARDS ***
BdbmJTZZ47quA9vUWwXtlw: folds
RqgF7gRoKgRNW8Zoi1ty4A: raises $2 to $3
0WjiuIT7/EolY1oOx1ngeA: folds
wenbG7TaM3H7h5kn78OFNw: folds
Gp2euK/nqF6qXKe7U+jOfw: folds
RqgF7gRoKgRNW8Zoi1ty4A collected $2.50 from pot
*** SUMMARY ***
Total pot $2.50 | Rake $0
Seat 1: BdbmJTZZ47quA9vUWwXtlw folded before Flop (didn't bet)
Seat 2: RqgF7gRoKgRNW8Zoi1ty4A collected ($2.50)
Seat 3: 0WjiuIT7/EolY1oOx1ngeA (button) folded before Flop (didn't bet)
Seat 4: wenbG7TaM3H7h5kn78OFNw (small blind) folded before Flop
Seat 5: Gp2euK/nqF6qXKe7U+jOfw (big blind) folded before Flop



PokerStars Game #59938834432:  Hold'em No Limit ($0.50/$1.00) - 2009/07/01 0:24:40 ET
Table 'rmZfTK+oSebeUPJNbWhdAA' 6-max Seat #2 is the button
Seat 1: xAU6q2/cwmby2sxmA8VcmA ($100 in chips)
Seat 2: OigyyiK+tTj1APPIAUmXDA ($76.20 in chips)
Seat 3: 9yjOzGERLaEZS8CZ6YNHFg ($61.80 in chips)
Seat 4: OGMLOcTNYZXZU81au7ztUw ($126.65 in chips)
Seat 5: VuZb/hkEc4X7s93w2ZZTpA ($111.25 in chips)
Seat 6: j7NIOHLZk7V2o9fOioO5ug ($108 in chips)
9yjOzGERLaEZS8CZ6YNHFg: posts small blind $0.50
OGMLOcTNYZXZU81au7ztUw: posts big blind $1
*** HOLE CARDS ***
VuZb/hkEc4X7s93w2ZZTpA: folds
j7NIOHLZk7V2o9fOioO5ug: folds
xAU6q2/cwmby2sxmA8VcmA: folds
OigyyiK+tTj1APPIAUmXDA: raises $2 to $3
9yjOzGERLaEZS8CZ6YNHFg: calls $2.50
OGMLOcTNYZXZU81au7ztUw: folds
*** FLOP *** [9c 6s Qs]
9yjOzGERLaEZS8CZ6YNHFg: checks
OigyyiK+tTj1APPIAUmXDA: bets $3
9yjOzGERLaEZS8CZ6YNHFg: calls $3
*** TURN *** [9c 6s Qs] [6h]
9yjOzGERLaEZS8CZ6YNHFg: checks
OigyyiK+tTj1APPIAUmXDA: checks
*** RIVER *** [9c 6s Qs 6h] [4s]
9yjOzGERLaEZS8CZ6YNHFg: bets $7
OigyyiK+tTj1APPIAUmXDA: calls $7
*** SHOW DOWN ***
9yjOzGERLaEZS8CZ6YNHFg: shows [Ah Tc] (a pair of Sixes)
OigyyiK+tTj1APPIAUmXDA: shows [Kh 9h] (two pair, Nines and Sixes)
OigyyiK+tTj1APPIAUmXDA collected $25.70 from pot
*** SUMMARY ***
Total pot $27 | Rake $1.30
Board [9c 6s Qs 6h 4s]
Seat 1: xAU6q2/cwmby2sxmA8VcmA folded before Flop (didn't bet)
Seat 2: OigyyiK+tTj1APPIAUmXDA (button) showed [Kh 9h] and won ($25.70) with two pair, Nines and Sixes
Seat 3: 9yjOzGERLaEZS8CZ6YNHFg (small blind) showed [Ah Tc] and lost with a pair of Sixes
Seat 4: OGMLOcTNYZXZU81au7ztUw (big blind) folded before Flop
Seat 5: VuZb/hkEc4X7s93w2ZZTpA folded before Flop (didn't bet)
Seat 6: j7NIOHLZk7V2o9fOioO5ug folded before Flop (didn't bet)



PokerStars Game #59938834106:  Hold'em No Limit ($0.50/$1.00) - 2009/07/01 0:24:40 ET
Table 'aWHveb63HkbTmOGHOxjBkQ' 2-max Seat #2 is the button
Seat 1: xy2MQKoHoCZZIudmw8Xbow ($251.40 in chips)
Seat 2: xstEKavv3YDxpUnU4e9qAQ ($121.10 in chips)
xstEKavv3YDxpUnU4e9qAQ: posts small blind $0.50
xy2MQKoHoCZZIudmw8Xbow: posts big blind $1
*** HOLE CARDS ***
xstEKavv3YDxpUnU4e9qAQ: folds
xy2MQKoHoCZZIudmw8Xbow collected $1 from pot
xy2MQKoHoCZZIudmw8Xbow: doesn't show hand
*** SUMMARY ***
Total pot $1 | Rake $0
Seat 1: xy2MQKoHoCZZIudmw8Xbow (big blind) collected ($1)
Seat 2: xstEKavv3YDxpUnU4e9qAQ (button) (small blind) folded before Flop



PokerStars Game #59938835868:  Hold'em No Limit ($0.50/$1.00) - 2009/07/01 0:24:42 ET
Table 'tLrtq7gDzxEvckNAI1OS5Q' 6-max Seat #3 is the button
Seat 1: GisIe1kcC9q/xV6ifsTjgA ($153.35 in chips)
Seat 2: qsObMEIlRO22OlS867m/lw ($9.90 in chips)
Seat 3: TPZ+m9x+lwoKpv7TMfAUWA ($316.05 in chips)
Seat 4: KOG8rG51mOvIoY96zF3kvw ($162.30 in chips)
Seat 5: OGMLOcTNYZXZU81au7ztUw ($176.85 in chips)
Seat 6: XUk5GQsfNFpHvaToDZ0rZA ($44.95 in chips)
KOG8rG51mOvIoY96zF3kvw: posts small blind $0.50
OGMLOcTNYZXZU81au7ztUw: posts big blind $1
*** HOLE CARDS ***
XUk5GQsfNFpHvaToDZ0rZA: folds
GisIe1kcC9q/xV6ifsTjgA: folds
qsObMEIlRO22OlS867m/lw: raises $8.90 to $9.90 and is all-in
TPZ+m9x+lwoKpv7TMfAUWA: folds
KOG8rG51mOvIoY96zF3kvw: folds
OGMLOcTNYZXZU81au7ztUw: calls $8.90
*** FLOP *** [8s Ah 2h]
*** TURN *** [8s Ah 2h] [5d]
*** RIVER *** [8s Ah 2h 5d] [Ac]
*** SHOW DOWN ***
OGMLOcTNYZXZU81au7ztUw: shows [Ks Td] (a pair of Aces)
qsObMEIlRO22OlS867m/lw: shows [8h Jh] (two pair, Aces and Eights)
qsObMEIlRO22OlS867m/lw collected $19.30 from pot
*** SUMMARY ***
Total pot $20.30 | Rake $1
Board [8s Ah 2h 5d Ac]
Seat 1: GisIe1kcC9q/xV6ifsTjgA folded before Flop (didn't bet)
Seat 2: qsObMEIlRO22OlS867m/lw showed [8h Jh] and won ($19.30) with two pair, Aces and Eights
Seat 3: TPZ+m9x+lwoKpv7TMfAUWA (button) folded before Flop (didn't bet)
Seat 4: KOG8rG51mOvIoY96zF3kvw (small blind) folded before Flop
Seat 5: OGMLOcTNYZXZU81au7ztUw (big blind) showed [Ks Td] and lost with a pair of Aces
Seat 6: XUk5GQsfNFpHvaToDZ0rZA folded before Flop (didn't bet)



PokerStars Game #59938835448:  Hold'em No Limit ($0.50/$1.00) - 2009/07/01 0:24:42 ET
Table 'N2bNCDHL96aCQDvZIh+yQQ' 6-max Seat #2 is the button
Seat 1: iHo1oDbrEVJ8nEGdaPrICw ($143.50 in chips)
Seat 2: KpnW5CcJ4Mg6MeclfKmLrw ($102 in chips)
Seat 4: uCqEjnxh2/vFBjKYkfTOkw ($160.70 in chips)
Seat 5: rHlMOfR7kpQQxe+PFQz0xQ ($38.90 in chips)
Seat 6: TSuRyAHnUPCFjP7Z0rEE0w ($100 in chips)
3LCfF9/CuJ9+kbFOcqmuaQ will be allowed to play after the button
uCqEjnxh2/vFBjKYkfTOkw: posts small blind $0.50
rHlMOfR7kpQQxe+PFQz0xQ: posts big blind $1
*** HOLE CARDS ***
TSuRyAHnUPCFjP7Z0rEE0w: folds
iHo1oDbrEVJ8nEGdaPrICw: folds
KpnW5CcJ4Mg6MeclfKmLrw: folds
uCqEjnxh2/vFBjKYkfTOkw: folds
rHlMOfR7kpQQxe+PFQz0xQ collected $1 from pot
rHlMOfR7kpQQxe+PFQz0xQ: doesn't show hand
*** SUMMARY ***
Total pot $1 | Rake $0
Seat 1: iHo1oDbrEVJ8nEGdaPrICw folded before Flop (didn't bet)
Seat 2: KpnW5CcJ4Mg6MeclfKmLrw (button) folded before Flop (didn't bet)
Seat 4: uCqEjnxh2/vFBjKYkfTOkw (small blind) folded before Flop
Seat 5: rHlMOfR7kpQQxe+PFQz0xQ (big blind) collected ($1)
Seat 6: TSuRyAHnUPCFjP7Z0rEE0w folded before Flop (didn't bet)



PokerStars Game #59938836176:  Hold'em No Limit ($0.50/$1.00) - 2009/07/01 0:24:43 ET
Table 'eU3bWpDDg3Z+9R4m4iVmog' 6-max Seat #4 is the button
Seat 2: 8CAoOzhmB8n3nRFf3V4BTg ($140.95 in chips)
Seat 3: U6tnjwZRpTnM+YkqkCjwyQ ($154.05 in chips)
Seat 4: GDVIsbEJ/DOJsMKE4Asz0A ($98 in chips)
Seat 5: QHvTZcrKe6+maWUfVjP29Q ($102.50 in chips)
Seat 6: hpxXcmRkXXI9HE5+5/j/0Q ($101.50 in chips)
QHvTZcrKe6+maWUfVjP29Q: posts small blind $0.50
hpxXcmRkXXI9HE5+5/j/0Q: posts big blind $1
TSuRyAHnUPCFjP7Z0rEE0w: sits out
*** HOLE CARDS ***
8CAoOzhmB8n3nRFf3V4BTg: folds
U6tnjwZRpTnM+YkqkCjwyQ: raises $2 to $3
GDVIsbEJ/DOJsMKE4Asz0A: folds
QHvTZcrKe6+maWUfVjP29Q: folds
hpxXcmRkXXI9HE5+5/j/0Q: folds
U6tnjwZRpTnM+YkqkCjwyQ collected $2.50 from pot
*** SUMMARY ***
Total pot $2.50 | Rake $0
Seat 2: 8CAoOzhmB8n3nRFf3V4BTg folded before Flop (didn't bet)
Seat 3: U6tnjwZRpTnM+YkqkCjwyQ collected ($2.50)
Seat 4: GDVIsbEJ/DOJsMKE4Asz0A (button) folded before Flop (didn't bet)
Seat 5: QHvTZcrKe6+maWUfVjP29Q (small blind) folded before Flop
Seat 6: hpxXcmRkXXI9HE5+5/j/0Q (big blind) folded before Flop



PokerStars Game #59938837510:  Hold'em No Limit ($0.50/$1.00) - 2009/07/01 0:24:45 ET
Table '7Nl0ffnjeK44/vmeexh3MQ' 9-max Seat #8 is the button
Seat 1: s7D3Y+k4Cj4D1cXHv7oj+Q ($104.65 in chips)
Seat 3: 200876 ($39.90 in chips)
Seat 4: NfbTuCZ2txeWuV3hP7t0TA ($100 in chips)
Seat 5: bL+QVeDcuEdzMGAGg2XJHg ($107.10 in chips)
Seat 6: FVs16t7GgfWgQWt4JxsObQ ($15.55 in chips)
Seat 7: knewtTmBc4Tc0z/5tAABYQ ($106.50 in chips)
Seat 8: zanka7aAZkigmZpfopXxxA ($223.50 in chips)
Seat 9: ouwUBGRKnKK9uhn1G4Lf+A ($99 in chips)
ouwUBGRKnKK9uhn1G4Lf+A: posts small blind $0.50
s7D3Y+k4Cj4D1cXHv7oj+Q: posts big blind $1
kiakSwxX0e64PwYGAPQvLw: sits out
*** HOLE CARDS ***
200876: raises $1 to $2
NfbTuCZ2txeWuV3hP7t0TA: folds
bL+QVeDcuEdzMGAGg2XJHg: folds
FVs16t7GgfWgQWt4JxsObQ: calls $2
knewtTmBc4Tc0z/5tAABYQ: folds
zanka7aAZkigmZpfopXxxA: folds
ouwUBGRKnKK9uhn1G4Lf+A: folds
s7D3Y+k4Cj4D1cXHv7oj+Q: calls $1
*** FLOP *** [5d 7s 3c]
s7D3Y+k4Cj4D1cXHv7oj+Q: checks
200876: bets $3
FVs16t7GgfWgQWt4JxsObQ: folds
s7D3Y+k4Cj4D1cXHv7oj+Q: folds
200876 collected $6.20 from pot
*** SUMMARY ***
Total pot $6.50 | Rake $0.30
Board [5d 7s 3c]
Seat 1: s7D3Y+k4Cj4D1cXHv7oj+Q (big blind) folded on the Flop
Seat 3: 200876 collected ($6.20)
Seat 4: NfbTuCZ2txeWuV3hP7t0TA folded before Flop (didn't bet)
Seat 5: bL+QVeDcuEdzMGAGg2XJHg folded before Flop (didn't bet)
Seat 6: FVs16t7GgfWgQWt4JxsObQ folded on the Flop
Seat 7: knewtTmBc4Tc0z/5tAABYQ folded before Flop (didn't bet)
Seat 8: zanka7aAZkigmZpfopXxxA (button) folded before Flop (didn't bet)
Seat 9: ouwUBGRKnKK9uhn1G4Lf+A (small blind) folded before Flop



PokerStars Game #59938837730:  Hold'em No Limit ($0.50/$1.00) - 2009/07/01 0:24:45 ET
Table 'aWHveb63HkbTmOGHOxjBkQ' 2-max Seat #1 is the button
Seat 1: xy2MQKoHoCZZIudmw8Xbow ($251.90 in chips)
Seat 2: xstEKavv3YDxpUnU4e9qAQ ($120.60 in chips)
xy2MQKoHoCZZIudmw8Xbow: posts small blind $0.50
xstEKavv3YDxpUnU4e9qAQ: posts big blind $1
*** HOLE CARDS ***
xy2MQKoHoCZZIudmw8Xbow: raises $3 to $4
xstEKavv3YDxpUnU4e9qAQ: raises $8 to $12
xy2MQKoHoCZZIudmw8Xbow: calls $8
*** FLOP *** [9c 7h 5h]
xstEKavv3YDxpUnU4e9qAQ: bets $13
xy2MQKoHoCZZIudmw8Xbow: calls $13
*** TURN *** [9c 7h 5h] [4d]
xstEKavv3YDxpUnU4e9qAQ: bets $25
xy2MQKoHoCZZIudmw8Xbow: folds
xstEKavv3YDxpUnU4e9qAQ collected $49.50 from pot
*** SUMMARY ***
Total pot $50 | Rake $0.50
Board [9c 7h 5h 4d]
Seat 1: xy2MQKoHoCZZIudmw8Xbow (button) (small blind) folded on the Turn
Seat 2: xstEKavv3YDxpUnU4e9qAQ (big blind) collected ($49.50)



PokerStars Game #59938838590:  Hold'em No Limit ($0.50/$1.00) - 2009/07/01 0:24:46 ET
Table 'mmbQQVBTrPdE+wy+s+9VPA' 6-max Seat #5 is the button
Seat 2: ru6SCVvWcWt2SpmUsmArWQ ($20 in chips)
Seat 3: wx3sQGkVi2x9wJXuWNHPBw ($111.65 in chips)
Seat 4: RfKnhkJN8HEAuzJpH2Ajdg ($20.15 in chips)
Seat 5: YMJG+F++3Aj6P8dAWda5fw ($98.50 in chips)
Seat 6: klQ/ufr9lOvfLMdAu0S9cw ($25.10 in chips)
klQ/ufr9lOvfLMdAu0S9cw: posts small blind $0.50
ru6SCVvWcWt2SpmUsmArWQ: posts big blind $1
*** HOLE CARDS ***
wx3sQGkVi2x9wJXuWNHPBw: folds
RfKnhkJN8HEAuzJpH2Ajdg: calls $1
YMJG+F++3Aj6P8dAWda5fw: calls $1
klQ/ufr9lOvfLMdAu0S9cw: calls $0.50
ru6SCVvWcWt2SpmUsmArWQ: checks
*** FLOP *** [6d 6h Ah]
klQ/ufr9lOvfLMdAu0S9cw: checks
ru6SCVvWcWt2SpmUsmArWQ: bets $1.40
RfKnhkJN8HEAuzJpH2Ajdg: calls $1.40
YMJG+F++3Aj6P8dAWda5fw: folds
klQ/ufr9lOvfLMdAu0S9cw: folds
*** TURN *** [6d 6h Ah] [Th]
ru6SCVvWcWt2SpmUsmArWQ: bets $5
RfKnhkJN8HEAuzJpH2Ajdg: calls $5
*** RIVER *** [6d 6h Ah Th] [8h]
ru6SCVvWcWt2SpmUsmArWQ: bets $12.60 and is all-in
P9iqlRE1diA1wRYdf4YRBQ leaves the table
RfKnhkJN8HEAuzJpH2Ajdg: folds
ru6SCVvWcWt2SpmUsmArWQ collected $16 from pot
*** SUMMARY ***
Total pot $16.80 | Rake $0.80
Board [6d 6h Ah Th 8h]
Seat 2: ru6SCVvWcWt2SpmUsmArWQ (big blind) collected ($16)
Seat 3: wx3sQGkVi2x9wJXuWNHPBw folded before Flop (didn't bet)
Seat 4: RfKnhkJN8HEAuzJpH2Ajdg folded on the River
Seat 5: YMJG+F++3Aj6P8dAWda5fw (button) folded on the Flop
Seat 6: klQ/ufr9lOvfLMdAu0S9cw (small blind) folded on the Flop



PokerStars Game #59938840596:  Hold'em No Limit ($0.50/$1.00) - 2009/07/01 0:24:49 ET
Table 'vs/5jr6ciwjVQ5+Soc+u2A' 6-max Seat #4 is the button
Seat 2: XOIf9W+VAxhZqN+SYoyMKA ($120.30 in chips)
Seat 3: G5ZSSN6RSON3gkNvk/SmYg ($100.70 in chips)
Seat 4: KpnW5CcJ4Mg6MeclfKmLrw ($104.65 in chips)
Seat 5: 7Vc9JmGFQwMRh5Tj9ui5Lw ($96.15 in chips)
Seat 6: QHvTZcrKe6+maWUfVjP29Q ($100 in chips)
7Vc9JmGFQwMRh5Tj9ui5Lw: posts small blind $0.50
QHvTZcrKe6+maWUfVjP29Q: posts big blind $1
*** HOLE CARDS ***
XOIf9W+VAxhZqN+SYoyMKA: folds
G5ZSSN6RSON3gkNvk/SmYg: folds
KpnW5CcJ4Mg6MeclfKmLrw: raises $2 to $3
7Vc9JmGFQwMRh5Tj9ui5Lw: calls $2.50
QHvTZcrKe6+maWUfVjP29Q: raises $11 to $14
KpnW5CcJ4Mg6MeclfKmLrw: folds
7Vc9JmGFQwMRh5Tj9ui5Lw: folds
QHvTZcrKe6+maWUfVjP29Q collected $9 from pot
QHvTZcrKe6+maWUfVjP29Q: doesn't show hand
*** SUMMARY ***
Total pot $9 | Rake $0
Seat 2: XOIf9W+VAxhZqN+SYoyMKA folded before Flop (didn't bet)
Seat 3: G5ZSSN6RSON3gkNvk/SmYg folded before Flop (didn't bet)
Seat 4: KpnW5CcJ4Mg6MeclfKmLrw (button) folded before Flop
Seat 5: 7Vc9JmGFQwMRh5Tj9ui5Lw (small blind) folded before Flop
Seat 6: QHvTZcrKe6+maWUfVjP29Q (big blind) collected ($9)



PokerStars Game #59938841386:  Hold'em No Limit ($0.50/$1.00) - 2009/07/01 0:24:51 ET
Table 'W/wyObTiXZm+Ckkl3YxcSw' 6-max Seat #1 is the button
Seat 1: ssLJburtEIqnVkx6X8R1uw ($115.75 in chips)
Seat 2: oDiBRCaF0QVtd3kO6xZIXw ($100.50 in chips)
Seat 3: b2a+5TkFf4xJN/Ihhma58Q ($34.70 in chips)
Seat 4: BdbmJTZZ47quA9vUWwXtlw ($47.60 in chips)
oDiBRCaF0QVtd3kO6xZIXw: posts small blind $0.50
b2a+5TkFf4xJN/Ihhma58Q: posts big blind $1
*** HOLE CARDS ***
BdbmJTZZ47quA9vUWwXtlw: folds
ssLJburtEIqnVkx6X8R1uw: folds
oDiBRCaF0QVtd3kO6xZIXw: folds
b2a+5TkFf4xJN/Ihhma58Q collected $1 from pot
*** SUMMARY ***
Total pot $1 | Rake $0
Seat 1: ssLJburtEIqnVkx6X8R1uw (button) folded before Flop (didn't bet)
Seat 2: oDiBRCaF0QVtd3kO6xZIXw (small blind) folded before Flop
Seat 3: b2a+5TkFf4xJN/Ihhma58Q (big blind) collected ($1)
Seat 4: BdbmJTZZ47quA9vUWwXtlw folded before Flop (didn't bet)



PokerStars Game #59938841984:  Hold'em No Limit ($0.50/$1.00) - 2009/07/01 0:24:52 ET
Table '/RZcOwpZpHQ+OwPwjsbnRw' 6-max Seat #2 is the button
Seat 2: dHC9PH9hdH3Ad2TD8ZxX0Q ($37.60 in chips)
Seat 3: OigyyiK+tTj1APPIAUmXDA ($81.65 in chips)
Seat 4: j7NIOHLZk7V2o9fOioO5ug ($110.40 in chips)
Seat 5: wx3sQGkVi2x9wJXuWNHPBw ($202.05 in chips)
Seat 6: XOIf9W+VAxhZqN+SYoyMKA ($255.30 in chips)
OigyyiK+tTj1APPIAUmXDA: posts small blind $0.50
j7NIOHLZk7V2o9fOioO5ug: posts big blind $1
*** HOLE CARDS ***
wx3sQGkVi2x9wJXuWNHPBw: folds
XOIf9W+VAxhZqN+SYoyMKA: folds
dHC9PH9hdH3Ad2TD8ZxX0Q: raises $1 to $2
OigyyiK+tTj1APPIAUmXDA: raises $3 to $5
j7NIOHLZk7V2o9fOioO5ug: folds
dHC9PH9hdH3Ad2TD8ZxX0Q: calls $3
*** FLOP *** [Js Qh 4s]
OigyyiK+tTj1APPIAUmXDA: bets $4
dHC9PH9hdH3Ad2TD8ZxX0Q: raises $4 to $8
OigyyiK+tTj1APPIAUmXDA: folds
dHC9PH9hdH3Ad2TD8ZxX0Q collected $18.10 from pot
dHC9PH9hdH3Ad2TD8ZxX0Q: doesn't show hand
*** SUMMARY ***
Total pot $19 | Rake $0.90
Board [Js Qh 4s]
Seat 2: dHC9PH9hdH3Ad2TD8ZxX0Q (button) collected ($18.10)
Seat 3: OigyyiK+tTj1APPIAUmXDA (small blind) folded on the Flop
Seat 4: j7NIOHLZk7V2o9fOioO5ug (big blind) folded before Flop
Seat 5: wx3sQGkVi2x9wJXuWNHPBw folded before Flop (didn't bet)
Seat 6: XOIf9W+VAxhZqN+SYoyMKA folded before Flop (didn't bet)



PokerStars Game #59938845112:  Hold'em No Limit ($0.50/$1.00) - 2009/07/01 0:24:56 ET
Table '+cA8mcmhaedZ7YcrDdhmeQ' 6-max Seat #1 is the button
Seat 1: lsLuWlcPA3Rh7kJVLzMh0Q ($231.50 in chips)
Seat 2: trnpu4tPju3BU8W0wQQaiQ ($104.45 in chips)
Seat 3: 0WjiuIT7/EolY1oOx1ngeA ($117.80 in chips)
Seat 4: j0aDOn9Nft1HLTQvGu1UwA ($9.75 in chips)
Seat 5: 6WyjEXOToimYmtLdqIgHYQ ($60.50 in chips)
Seat 6: YfsTQsY/fxb+YqbdclTHuw ($114.25 in chips)
trnpu4tPju3BU8W0wQQaiQ: posts small blind $0.50
0WjiuIT7/EolY1oOx1ngeA: posts big blind $1
*** HOLE CARDS ***
j0aDOn9Nft1HLTQvGu1UwA: raises $8.75 to $9.75 and is all-in
6WyjEXOToimYmtLdqIgHYQ: folds
YfsTQsY/fxb+YqbdclTHuw: folds
lsLuWlcPA3Rh7kJVLzMh0Q: folds
trnpu4tPju3BU8W0wQQaiQ: folds
0WjiuIT7/EolY1oOx1ngeA: folds
j0aDOn9Nft1HLTQvGu1UwA collected $2.50 from pot
*** SUMMARY ***
Total pot $2.50 | Rake $0
Seat 1: lsLuWlcPA3Rh7kJVLzMh0Q (button) folded before Flop (didn't bet)
Seat 2: trnpu4tPju3BU8W0wQQaiQ (small blind) folded before Flop
Seat 3: 0WjiuIT7/EolY1oOx1ngeA (big blind) folded before Flop
Seat 4: j0aDOn9Nft1HLTQvGu1UwA collected ($2.50)
Seat 5: 6WyjEXOToimYmtLdqIgHYQ folded before Flop (didn't bet)
Seat 6: YfsTQsY/fxb+YqbdclTHuw folded before Flop (didn't bet)



PokerStars Game #59938845022:  Hold'em No Limit ($0.50/$1.00) - 2009/07/01 0:24:56 ET
Table 'U9zqzC8f3oTJ2ShXFgSSOA' 6-max Seat #2 is the button
Seat 1: tS9JHB1h+FQ++qu8RwRNgg ($15.45 in chips)
Seat 2: U2CWBTv29qdCbj8RNF2sIw ($100 in chips)
Seat 3: yfXek8iJ7O4CFyqXrtGcfg ($58 in chips)
Seat 4: 33q95we0Etwgrm6guQGncw ($73.90 in chips)
Seat 5: KfwW5us6tydK81NYTtK1gw ($207.40 in chips)
Seat 6: aIxzFKdtpDSkUePKZy/niQ ($46.40 in chips)
yfXek8iJ7O4CFyqXrtGcfg: posts small blind $0.50
33q95we0Etwgrm6guQGncw: posts big blind $1
*** HOLE CARDS ***
KfwW5us6tydK81NYTtK1gw: folds
aIxzFKdtpDSkUePKZy/niQ: calls $1
tS9JHB1h+FQ++qu8RwRNgg: raises $4 to $5
U2CWBTv29qdCbj8RNF2sIw: folds
yfXek8iJ7O4CFyqXrtGcfg: calls $4.50
33q95we0Etwgrm6guQGncw: folds
aIxzFKdtpDSkUePKZy/niQ: calls $4
*** FLOP *** [Qh Ac Kd]
yfXek8iJ7O4CFyqXrtGcfg: checks
aIxzFKdtpDSkUePKZy/niQ: checks
tS9JHB1h+FQ++qu8RwRNgg: checks
*** TURN *** [Qh Ac Kd] [3h]
yfXek8iJ7O4CFyqXrtGcfg: bets $5
aIxzFKdtpDSkUePKZy/niQ: folds
tS9JHB1h+FQ++qu8RwRNgg: raises $5.45 to $10.45 and is all-in
yfXek8iJ7O4CFyqXrtGcfg: calls $5.45
*** RIVER *** [Qh Ac Kd 3h] [5s]
*** SHOW DOWN ***
yfXek8iJ7O4CFyqXrtGcfg: shows [Jd Jc] (a pair of Jacks)
tS9JHB1h+FQ++qu8RwRNgg: shows [3d 3c] (three of a kind, Threes)
tS9JHB1h+FQ++qu8RwRNgg collected $35.10 from pot
*** SUMMARY ***
Total pot $36.90 | Rake $1.80
Board [Qh Ac Kd 3h 5s]
Seat 1: tS9JHB1h+FQ++qu8RwRNgg showed [3d 3c] and won ($35.10) with three of a kind, Threes
Seat 2: U2CWBTv29qdCbj8RNF2sIw (button) folded before Flop (didn't bet)
Seat 3: yfXek8iJ7O4CFyqXrtGcfg (small blind) showed [Jd Jc] and lost with a pair of Jacks
Seat 4: 33q95we0Etwgrm6guQGncw (big blind) folded before Flop
Seat 5: KfwW5us6tydK81NYTtK1gw folded before Flop (didn't bet)
Seat 6: aIxzFKdtpDSkUePKZy/niQ folded on the Turn



PokerStars Game #59938844722:  Hold'em No Limit ($0.50/$1.00) - 2009/07/01 0:24:56 ET
Table 'eU3bWpDDg3Z+9R4m4iVmog' 6-max Seat #5 is the button
Seat 1: TSuRyAHnUPCFjP7Z0rEE0w ($174.40 in chips)
Seat 2: 8CAoOzhmB8n3nRFf3V4BTg ($140.95 in chips)
Seat 3: U6tnjwZRpTnM+YkqkCjwyQ ($155.55 in chips)
Seat 4: GDVIsbEJ/DOJsMKE4Asz0A ($98 in chips)
Seat 5: QHvTZcrKe6+maWUfVjP29Q ($102 in chips)
Seat 6: hpxXcmRkXXI9HE5+5/j/0Q ($100.50 in chips)
hpxXcmRkXXI9HE5+5/j/0Q: posts small blind $0.50
TSuRyAHnUPCFjP7Z0rEE0w: posts big blind $1
*** HOLE CARDS ***
8CAoOzhmB8n3nRFf3V4BTg: folds
U6tnjwZRpTnM+YkqkCjwyQ: folds
GDVIsbEJ/DOJsMKE4Asz0A: folds
QHvTZcrKe6+maWUfVjP29Q: folds
hpxXcmRkXXI9HE5+5/j/0Q: raises $3 to $4
TSuRyAHnUPCFjP7Z0rEE0w: calls $3
*** FLOP *** [Kc Jc Ac]
hpxXcmRkXXI9HE5+5/j/0Q: checks
TSuRyAHnUPCFjP7Z0rEE0w: bets $7
hpxXcmRkXXI9HE5+5/j/0Q: folds
TSuRyAHnUPCFjP7Z0rEE0w collected $7.60 from pot
TSuRyAHnUPCFjP7Z0rEE0w: doesn't show hand
*** SUMMARY ***
Total pot $8 | Rake $0.40
Board [Kc Jc Ac]
Seat 1: TSuRyAHnUPCFjP7Z0rEE0w (big blind) collected ($7.60)
Seat 2: 8CAoOzhmB8n3nRFf3V4BTg folded before Flop (didn't bet)
Seat 3: U6tnjwZRpTnM+YkqkCjwyQ folded before Flop (didn't bet)
Seat 4: GDVIsbEJ/DOJsMKE4Asz0A folded before Flop (didn't bet)
Seat 5: QHvTZcrKe6+maWUfVjP29Q (button) folded before Flop (didn't bet)
Seat 6: hpxXcmRkXXI9HE5+5/j/0Q (small blind) folded on the Flop



PokerStars Game #59938848026:  Hold'em No Limit ($0.50/$1.00) - 2009/07/01 0:25:01 ET
Table 'pHrhryH8jPNdQfY62f8v+g' 6-max Seat #4 is the button
Seat 1: BdbmJTZZ47quA9vUWwXtlw ($68.25 in chips)
Seat 2: RqgF7gRoKgRNW8Zoi1ty4A ($118 in chips)
Seat 3: 0WjiuIT7/EolY1oOx1ngeA ($100 in chips)
Seat 4: wenbG7TaM3H7h5kn78OFNw ($56 in chips)
Seat 5: Gp2euK/nqF6qXKe7U+jOfw ($117.65 in chips)
Seat 6: xAU6q2/cwmby2sxmA8VcmA ($100 in chips)
Gp2euK/nqF6qXKe7U+jOfw: posts small blind $0.50
xAU6q2/cwmby2sxmA8VcmA: posts big blind $1
*** HOLE CARDS ***
BdbmJTZZ47quA9vUWwXtlw: folds
RqgF7gRoKgRNW8Zoi1ty4A: folds
0WjiuIT7/EolY1oOx1ngeA: raises $2 to $3
wenbG7TaM3H7h5kn78OFNw: folds
Gp2euK/nqF6qXKe7U+jOfw: folds
xAU6q2/cwmby2sxmA8VcmA: folds
0WjiuIT7/EolY1oOx1ngeA collected $2.50 from pot
*** SUMMARY ***
Total pot $2.50 | Rake $0
Seat 1: BdbmJTZZ47quA9vUWwXtlw folded before Flop (didn't bet)
Seat 2: RqgF7gRoKgRNW8Zoi1ty4A folded before Flop (didn't bet)
Seat 3: 0WjiuIT7/EolY1oOx1ngeA collected ($2.50)
Seat 4: wenbG7TaM3H7h5kn78OFNw (button) folded before Flop (didn't bet)
Seat 5: Gp2euK/nqF6qXKe7U+jOfw (small blind) folded before Flop
Seat 6: xAU6q2/cwmby2sxmA8VcmA (big blind) folded before Flop



PokerStars Game #59938848884:  Hold'em No Limit ($0.50/$1.00) - 2009/07/01 0:25:02 ET
Table 'MUPc8FEpe/nR0BKSeReX6Q' 6-max Seat #5 is the button
Seat 1: YsLQ3BAvgQHWXMAv3Wv6Hg ($100 in chips)
Seat 2: xAU6q2/cwmby2sxmA8VcmA ($100 in chips)
Seat 3: wx3sQGkVi2x9wJXuWNHPBw ($234.05 in chips)
Seat 4: ZA1bp6g8IwtTxkUE4eCjDQ ($114.95 in chips)
Seat 5: UBZQqpnJZdTYYY1FTb0rLA ($100 in chips)
Seat 6: oxnw0GLLpFanjhGkxfRSqA ($55.60 in chips)
oxnw0GLLpFanjhGkxfRSqA: posts small blind $0.50
YsLQ3BAvgQHWXMAv3Wv6Hg: posts big blind $1
*** HOLE CARDS ***
xAU6q2/cwmby2sxmA8VcmA: folds
wx3sQGkVi2x9wJXuWNHPBw: folds
ZA1bp6g8IwtTxkUE4eCjDQ: calls $1
UBZQqpnJZdTYYY1FTb0rLA: folds
oxnw0GLLpFanjhGkxfRSqA: calls $0.50
YsLQ3BAvgQHWXMAv3Wv6Hg: checks
*** FLOP *** [2c 3s 6s]
oxnw0GLLpFanjhGkxfRSqA: checks
YsLQ3BAvgQHWXMAv3Wv6Hg: checks
ZA1bp6g8IwtTxkUE4eCjDQ: checks
*** TURN *** [2c 3s 6s] [Ah]
oxnw0GLLpFanjhGkxfRSqA: checks
YsLQ3BAvgQHWXMAv3Wv6Hg: checks
ZA1bp6g8IwtTxkUE4eCjDQ: bets $2
oxnw0GLLpFanjhGkxfRSqA: folds
YsLQ3BAvgQHWXMAv3Wv6Hg: folds
ZA1bp6g8IwtTxkUE4eCjDQ collected $2.85 from pot
*** SUMMARY ***
Total pot $3 | Rake $0.15
Board [2c 3s 6s Ah]
Seat 1: YsLQ3BAvgQHWXMAv3Wv6Hg (big blind) folded on the Turn
Seat 2: xAU6q2/cwmby2sxmA8VcmA folded before Flop (didn't bet)
Seat 3: wx3sQGkVi2x9wJXuWNHPBw folded before Flop (didn't bet)
Seat 4: ZA1bp6g8IwtTxkUE4eCjDQ collected ($2.85)
Seat 5: UBZQqpnJZdTYYY1FTb0rLA (button) folded before Flop (didn't bet)
Seat 6: oxnw0GLLpFanjhGkxfRSqA (small blind) folded on the Turn



PokerStars Game #59938848704:  Hold'em No Limit ($0.50/$1.00) - 2009/07/01 0:25:02 ET
Table 'VOs36P6NW+QyXeQ1B62kmA' 6-max Seat #1 is the button
Seat 1: AdLVjddOzm+sRNo1Bc3S6Q ($137.05 in chips)
Seat 2: KpnW5CcJ4Mg6MeclfKmLrw ($108.80 in chips)
Seat 3: TSuRyAHnUPCFjP7Z0rEE0w ($113.55 in chips)
Seat 4: w02zQzNydODiyV9THKgo9w ($24 in chips)
Seat 5: X7GlkHF+lkbarCLuZ4Uf0w ($21 in chips)
Seat 6: 6tvjsJrdmWg+g7FVrMnzXA ($74.10 in chips)
KpnW5CcJ4Mg6MeclfKmLrw: posts small blind $0.50
TSuRyAHnUPCFjP7Z0rEE0w: posts big blind $1
*** HOLE CARDS ***
w02zQzNydODiyV9THKgo9w: calls $1
X7GlkHF+lkbarCLuZ4Uf0w: folds
6tvjsJrdmWg+g7FVrMnzXA: folds
AdLVjddOzm+sRNo1Bc3S6Q: folds
KpnW5CcJ4Mg6MeclfKmLrw: folds
TSuRyAHnUPCFjP7Z0rEE0w: checks
*** FLOP *** [3c 6c Td]
TSuRyAHnUPCFjP7Z0rEE0w: bets $2
w02zQzNydODiyV9THKgo9w: calls $2
*** TURN *** [3c 6c Td] [4c]
TSuRyAHnUPCFjP7Z0rEE0w: bets $4
w02zQzNydODiyV9THKgo9w: calls $4
*** RIVER *** [3c 6c Td 4c] [Ac]
TSuRyAHnUPCFjP7Z0rEE0w: checks
w02zQzNydODiyV9THKgo9w: bets $9
TSuRyAHnUPCFjP7Z0rEE0w: folds
w02zQzNydODiyV9THKgo9w collected $13.80 from pot
w02zQzNydODiyV9THKgo9w: doesn't show hand
*** SUMMARY ***
Total pot $14.50 | Rake $0.70
Board [3c 6c Td 4c Ac]
Seat 1: AdLVjddOzm+sRNo1Bc3S6Q (button) folded before Flop (didn't bet)
Seat 2: KpnW5CcJ4Mg6MeclfKmLrw (small blind) folded before Flop
Seat 3: TSuRyAHnUPCFjP7Z0rEE0w (big blind) folded on the River
Seat 4: w02zQzNydODiyV9THKgo9w collected ($13.80)
Seat 5: X7GlkHF+lkbarCLuZ4Uf0w folded before Flop (didn't bet)
Seat 6: 6tvjsJrdmWg+g7FVrMnzXA folded before Flop (didn't bet)



PokerStars Game #59938849132:  Hold'em No Limit ($0.50/$1.00) - 2009/07/01 0:25:02 ET
Table 'b/mVBMBBjZR4F+Jsv8cuYA' 9-max Seat #8 is the button
Seat 1: Ogn4JDV3mp4ZDKO49IFzKA ($20 in chips)
Seat 2: HPmAhANyB1+4MGzYS9i5Wg ($33.60 in chips)
Seat 3: x80+i7DJL+81v3quj7KbNg ($20 in chips)
Seat 4: 0oXWlMUwwWciWdZOQf6yUw ($99.95 in chips)
Seat 5: p5UKaxVobvptF0ANhR/q1A ($100 in chips)
Seat 6: FL3MrLspcF23LYvC4ipBOA ($316.10 in chips)
Seat 7: 5GtqC1O4Y1t1VmP51SDSJQ ($105 in chips)
Seat 8: L9njYvloJ1NdXjP8edHEAg ($102.50 in chips)
Seat 9: 9BZCcac3+McErkkSN2YScA ($112.95 in chips)
9BZCcac3+McErkkSN2YScA: posts small blind $0.50
Ogn4JDV3mp4ZDKO49IFzKA: posts big blind $1
*** HOLE CARDS ***
HPmAhANyB1+4MGzYS9i5Wg: folds
x80+i7DJL+81v3quj7KbNg: folds
0oXWlMUwwWciWdZOQf6yUw: raises $2 to $3
p5UKaxVobvptF0ANhR/q1A: folds
FL3MrLspcF23LYvC4ipBOA: folds
5GtqC1O4Y1t1VmP51SDSJQ: calls $3
L9njYvloJ1NdXjP8edHEAg: folds
9BZCcac3+McErkkSN2YScA: folds
Ogn4JDV3mp4ZDKO49IFzKA: raises $17 to $20 and is all-in
0oXWlMUwwWciWdZOQf6yUw: calls $17
5GtqC1O4Y1t1VmP51SDSJQ: folds
*** FLOP *** [7h 6c 5h]
*** TURN *** [7h 6c 5h] [9d]
*** RIVER *** [7h 6c 5h 9d] [5d]
*** SHOW DOWN ***
Ogn4JDV3mp4ZDKO49IFzKA: shows [Ad Ks] (a pair of Fives)
0oXWlMUwwWciWdZOQf6yUw: mucks hand
Ogn4JDV3mp4ZDKO49IFzKA collected $41.35 from pot
*** SUMMARY ***
Total pot $43.50 | Rake $2.15
Board [7h 6c 5h 9d 5d]
Seat 1: Ogn4JDV3mp4ZDKO49IFzKA (big blind) showed [Ad Ks] and won ($41.35) with a pair of Fives
Seat 2: HPmAhANyB1+4MGzYS9i5Wg folded before Flop (didn't bet)
Seat 3: x80+i7DJL+81v3quj7KbNg folded before Flop (didn't bet)
Seat 4: 0oXWlMUwwWciWdZOQf6yUw mucked
Seat 5: p5UKaxVobvptF0ANhR/q1A folded before Flop (didn't bet)
Seat 6: FL3MrLspcF23LYvC4ipBOA folded before Flop (didn't bet)
Seat 7: 5GtqC1O4Y1t1VmP51SDSJQ folded before Flop
Seat 8: L9njYvloJ1NdXjP8edHEAg (button) folded before Flop (didn't bet)
Seat 9: 9BZCcac3+McErkkSN2YScA (small blind) folded before Flop



PokerStars Game #59938849592:  Hold'em No Limit ($0.50/$1.00) - 2009/07/01 0:25:03 ET
Table 'N2bNCDHL96aCQDvZIh+yQQ' 6-max Seat #4 is the button
Seat 1: iHo1oDbrEVJ8nEGdaPrICw ($143.50 in chips)
Seat 2: KpnW5CcJ4Mg6MeclfKmLrw ($102 in chips)
Seat 3: 3LCfF9/CuJ9+kbFOcqmuaQ ($60 in chips)
Seat 4: uCqEjnxh2/vFBjKYkfTOkw ($160.20 in chips)
Seat 5: rHlMOfR7kpQQxe+PFQz0xQ ($39.40 in chips)
Seat 6: TSuRyAHnUPCFjP7Z0rEE0w ($100 in chips)
rHlMOfR7kpQQxe+PFQz0xQ: posts small blind $0.50
TSuRyAHnUPCFjP7Z0rEE0w: posts big blind $1
3LCfF9/CuJ9+kbFOcqmuaQ: posts big blind $1
*** HOLE CARDS ***
iHo1oDbrEVJ8nEGdaPrICw: folds
KpnW5CcJ4Mg6MeclfKmLrw: folds
3LCfF9/CuJ9+kbFOcqmuaQ: checks
uCqEjnxh2/vFBjKYkfTOkw: calls $1
rHlMOfR7kpQQxe+PFQz0xQ: calls $0.50
TSuRyAHnUPCFjP7Z0rEE0w: checks
*** FLOP *** [3s 7d Tc]
rHlMOfR7kpQQxe+PFQz0xQ: checks
TSuRyAHnUPCFjP7Z0rEE0w: checks
3LCfF9/CuJ9+kbFOcqmuaQ: checks
uCqEjnxh2/vFBjKYkfTOkw: checks
*** TURN *** [3s 7d Tc] [Qh]
rHlMOfR7kpQQxe+PFQz0xQ: checks
TSuRyAHnUPCFjP7Z0rEE0w: checks
3LCfF9/CuJ9+kbFOcqmuaQ: checks
uCqEjnxh2/vFBjKYkfTOkw: bets $3
rHlMOfR7kpQQxe+PFQz0xQ: folds
TSuRyAHnUPCFjP7Z0rEE0w: folds
3LCfF9/CuJ9+kbFOcqmuaQ: folds
uCqEjnxh2/vFBjKYkfTOkw collected $3.80 from pot
3LCfF9/CuJ9+kbFOcqmuaQ leaves the table
uCqEjnxh2/vFBjKYkfTOkw: doesn't show hand
*** SUMMARY ***
Total pot $4 | Rake $0.20
Board [3s 7d Tc Qh]
Seat 1: iHo1oDbrEVJ8nEGdaPrICw folded before Flop (didn't bet)
Seat 2: KpnW5CcJ4Mg6MeclfKmLrw folded before Flop (didn't bet)
Seat 3: 3LCfF9/CuJ9+kbFOcqmuaQ folded on the Turn
Seat 4: uCqEjnxh2/vFBjKYkfTOkw (button) collected ($3.80)
Seat 5: rHlMOfR7kpQQxe+PFQz0xQ (small blind) folded on the Turn
Seat 6: TSuRyAHnUPCFjP7Z0rEE0w (big blind) folded on the Turn



PokerStars Game #59938849668:  Hold'em No Limit ($0.50/$1.00) - 2009/07/01 0:25:03 ET
Table 'O96CPOtvMBWP6kzuYDfdFA' 6-max Seat #6 is the button
Seat 1: yl9aRDw7k/ieGiDoJVy+/w ($56.05 in chips)
Seat 2: vTUNrd/7qIOJpW0suEu5hQ ($210.90 in chips)
Seat 3: V89DGjxE171oPREEbAXiyg ($27.75 in chips)
Seat 5: wRxiu9OJzvvN84OYWW9jxQ ($117.85 in chips)
Seat 6: xNKcQzD9+/iHmtJn4vYq9w ($100.60 in chips)
yl9aRDw7k/ieGiDoJVy+/w: posts small blind $0.50
vTUNrd/7qIOJpW0suEu5hQ: posts big blind $1
*** HOLE CARDS ***
V89DGjxE171oPREEbAXiyg: folds
wRxiu9OJzvvN84OYWW9jxQ: calls $1
xNKcQzD9+/iHmtJn4vYq9w: folds
yl9aRDw7k/ieGiDoJVy+/w: calls $0.50
vTUNrd/7qIOJpW0suEu5hQ: checks
*** FLOP *** [Ts 5c Tc]
yl9aRDw7k/ieGiDoJVy+/w: checks
vTUNrd/7qIOJpW0suEu5hQ: checks
wRxiu9OJzvvN84OYWW9jxQ: checks
*** TURN *** [Ts 5c Tc] [8c]
yl9aRDw7k/ieGiDoJVy+/w: bets $3
vTUNrd/7qIOJpW0suEu5hQ: folds
wRxiu9OJzvvN84OYWW9jxQ: calls $3
*** RIVER *** [Ts 5c Tc 8c] [6d]
yl9aRDw7k/ieGiDoJVy+/w: bets $4
wRxiu9OJzvvN84OYWW9jxQ: raises $8 to $12
yl9aRDw7k/ieGiDoJVy+/w: calls $8
*** SHOW DOWN ***
wRxiu9OJzvvN84OYWW9jxQ: shows [7s 9s] (a straight, Six to Ten)
yl9aRDw7k/ieGiDoJVy+/w: mucks hand
wRxiu9OJzvvN84OYWW9jxQ collected $31.40 from pot
*** SUMMARY ***
Total pot $33 | Rake $1.60
Board [Ts 5c Tc 8c 6d]
Seat 1: yl9aRDw7k/ieGiDoJVy+/w (small blind) mucked
Seat 2: vTUNrd/7qIOJpW0suEu5hQ (big blind) folded on the Turn
Seat 3: V89DGjxE171oPREEbAXiyg folded before Flop (didn't bet)
Seat 5: wRxiu9OJzvvN84OYWW9jxQ showed [7s 9s] and won ($31.40) with a straight, Six to Ten
Seat 6: xNKcQzD9+/iHmtJn4vYq9w (button) folded before Flop (didn't bet)



PokerStars Game #59938849988:  Hold'em No Limit ($0.50/$1.00) - 2009/07/01 0:25:03 ET
Table 'cBDNutyLBKEk9+ptwsKmTw' 6-max Seat #6 is the button
Seat 2: KyaE4+hWgUNIWWOWy4D14w ($84.50 in chips)
Seat 3: G5ZSSN6RSON3gkNvk/SmYg ($105.90 in chips)
Seat 4: 0WjiuIT7/EolY1oOx1ngeA ($105.15 in chips)
Seat 5: OGMLOcTNYZXZU81au7ztUw ($109.70 in chips)
Seat 6: pyzhFUPPSNzrysiMqlA5Xw ($10.60 in chips)
KyaE4+hWgUNIWWOWy4D14w: posts small blind $0.50
G5ZSSN6RSON3gkNvk/SmYg: posts big blind $1
*** HOLE CARDS ***
tb0dt30qP2x/8f+Xta4mVg leaves the table
0WjiuIT7/EolY1oOx1ngeA: folds
OGMLOcTNYZXZU81au7ztUw: folds
pyzhFUPPSNzrysiMqlA5Xw: folds
KyaE4+hWgUNIWWOWy4D14w: calls $0.50
G5ZSSN6RSON3gkNvk/SmYg: raises $3 to $4
KyaE4+hWgUNIWWOWy4D14w: folds
G5ZSSN6RSON3gkNvk/SmYg collected $2 from pot
G5ZSSN6RSON3gkNvk/SmYg: doesn't show hand
*** SUMMARY ***
Total pot $2 | Rake $0
Seat 2: KyaE4+hWgUNIWWOWy4D14w (small blind) folded before Flop
Seat 3: G5ZSSN6RSON3gkNvk/SmYg (big blind) collected ($2)
Seat 4: 0WjiuIT7/EolY1oOx1ngeA folded before Flop (didn't bet)
Seat 5: OGMLOcTNYZXZU81au7ztUw folded before Flop (didn't bet)
Seat 6: pyzhFUPPSNzrysiMqlA5Xw (button) folded before Flop (didn't bet)



PokerStars Game #59938850078:  Hold'em No Limit ($0.50/$1.00) - 2009/07/01 0:25:04 ET
Table 'W/wyObTiXZm+Ckkl3YxcSw' 6-max Seat #2 is the button
Seat 1: ssLJburtEIqnVkx6X8R1uw ($115.75 in chips)
Seat 2: oDiBRCaF0QVtd3kO6xZIXw ($100 in chips)
Seat 3: b2a+5TkFf4xJN/Ihhma58Q ($35.20 in chips)
Seat 4: BdbmJTZZ47quA9vUWwXtlw ($47.60 in chips)
b2a+5TkFf4xJN/Ihhma58Q: posts small blind $0.50
BdbmJTZZ47quA9vUWwXtlw: posts big blind $1
*** HOLE CARDS ***
1yB1nHUkHNNY8OJnDNHZMw has returned
ssLJburtEIqnVkx6X8R1uw: raises $2 to $3
oDiBRCaF0QVtd3kO6xZIXw: folds
b2a+5TkFf4xJN/Ihhma58Q: folds
BdbmJTZZ47quA9vUWwXtlw: folds
ssLJburtEIqnVkx6X8R1uw collected $2.50 from pot
ssLJburtEIqnVkx6X8R1uw: doesn't show hand
*** SUMMARY ***
Total pot $2.50 | Rake $0
Seat 1: ssLJburtEIqnVkx6X8R1uw collected ($2.50)
Seat 2: oDiBRCaF0QVtd3kO6xZIXw (button) folded before Flop (didn't bet)
Seat 3: b2a+5TkFf4xJN/Ihhma58Q (small blind) folded before Flop
Seat 4: BdbmJTZZ47quA9vUWwXtlw (big blind) folded before Flop



PokerStars Game #59938851472:  Hold'em No Limit ($0.50/$1.00) - 2009/07/01 0:25:06 ET
Table 'fTlPiCj0utgzC/5io+I7ew' 6-max Seat #2 is the button
Seat 1: YMJG+F++3Aj6P8dAWda5fw ($98.50 in chips)
Seat 2: +xUCTmR3cU7G239W+vZv6g ($144.85 in chips)
Seat 3: oDiBRCaF0QVtd3kO6xZIXw ($100 in chips)
Seat 4: uJVSceLggtsrJya+WtmUEA ($93.60 in chips)
Seat 5: bFrTkDcWGTxyvNul7GVdYg ($247.85 in chips)
oDiBRCaF0QVtd3kO6xZIXw: posts small blind $0.50
uJVSceLggtsrJya+WtmUEA: posts big blind $1
*** HOLE CARDS ***
bFrTkDcWGTxyvNul7GVdYg: folds
YMJG+F++3Aj6P8dAWda5fw: folds
+xUCTmR3cU7G239W+vZv6g: raises $2 to $3
oDiBRCaF0QVtd3kO6xZIXw: folds
jMljU/dOPMXfJi8OmbdYdw has returned
uJVSceLggtsrJya+WtmUEA: calls $2
*** FLOP *** [7h 8h 3h]
uJVSceLggtsrJya+WtmUEA: checks
+xUCTmR3cU7G239W+vZv6g: checks
*** TURN *** [7h 8h 3h] [7c]
uJVSceLggtsrJya+WtmUEA: bets $5
+xUCTmR3cU7G239W+vZv6g: folds
uJVSceLggtsrJya+WtmUEA collected $6.20 from pot
*** SUMMARY ***
Total pot $6.50 | Rake $0.30
Board [7h 8h 3h 7c]
Seat 1: YMJG+F++3Aj6P8dAWda5fw folded before Flop (didn't bet)
Seat 2: +xUCTmR3cU7G239W+vZv6g (button) folded on the Turn
Seat 3: oDiBRCaF0QVtd3kO6xZIXw (small blind) folded before Flop
Seat 4: uJVSceLggtsrJya+WtmUEA (big blind) collected ($6.20)
Seat 5: bFrTkDcWGTxyvNul7GVdYg folded before Flop (didn't bet)



PokerStars Game #59938852498:  Hold'em No Limit ($0.50/$1.00) - 2009/07/01 0:25:07 ET
Table 'aWHveb63HkbTmOGHOxjBkQ' 2-max Seat #2 is the button
Seat 1: xy2MQKoHoCZZIudmw8Xbow ($226.90 in chips)
Seat 2: xstEKavv3YDxpUnU4e9qAQ ($145.10 in chips)
xstEKavv3YDxpUnU4e9qAQ: posts small blind $0.50
xy2MQKoHoCZZIudmw8Xbow: posts big blind $1
*** HOLE CARDS ***
xstEKavv3YDxpUnU4e9qAQ: folds
xy2MQKoHoCZZIudmw8Xbow collected $1 from pot
xy2MQKoHoCZZIudmw8Xbow: doesn't show hand
*** SUMMARY ***
Total pot $1 | Rake $0
Seat 1: xy2MQKoHoCZZIudmw8Xbow (big blind) collected ($1)
Seat 2: xstEKavv3YDxpUnU4e9qAQ (button) (small blind) folded before Flop



PokerStars Game #59938854246:  Hold'em No Limit ($0.50/$1.00) - 2009/07/01 0:25:10 ET
Table 'ZFWj23PMihdwrNWv41OG/Q' 9-max Seat #2 is the button
Seat 1: yAbu2QsRPVcjPbqlf/jDxw ($101.80 in chips)
Seat 2: ARfmgHcEUKh68laBZy4veA ($56.25 in chips)
Seat 3: G9Fo2TZCN7HI43Po4zSN3A ($100 in chips)
Seat 4: PEmogYqKpuv0ozeBbXL+7Q ($36.50 in chips)
Seat 6: tjhwe1V98x2spSoUQER3HQ ($100 in chips)
Seat 7: wIZ377kjl2fHFGnS93o6bw ($43.95 in chips)
Seat 8: knewtTmBc4Tc0z/5tAABYQ ($107.50 in chips)
G9Fo2TZCN7HI43Po4zSN3A: posts small blind $0.50
PEmogYqKpuv0ozeBbXL+7Q: posts big blind $1
tkdBeXTJlFsZdioidNqLow: sits out
*** HOLE CARDS ***
tjhwe1V98x2spSoUQER3HQ: folds
wIZ377kjl2fHFGnS93o6bw: folds
l4m/wWPs22DSP5xpszjXKA joins the table at seat #9
knewtTmBc4Tc0z/5tAABYQ: folds
yAbu2QsRPVcjPbqlf/jDxw: folds
ARfmgHcEUKh68laBZy4veA: calls $1
G9Fo2TZCN7HI43Po4zSN3A: raises $4 to $5
PEmogYqKpuv0ozeBbXL+7Q: folds
ARfmgHcEUKh68laBZy4veA: folds
G9Fo2TZCN7HI43Po4zSN3A collected $3 from pot
G9Fo2TZCN7HI43Po4zSN3A: doesn't show hand
*** SUMMARY ***
Total pot $3 | Rake $0
Seat 1: yAbu2QsRPVcjPbqlf/jDxw folded before Flop (didn't bet)
Seat 2: ARfmgHcEUKh68laBZy4veA (button) folded before Flop
Seat 3: G9Fo2TZCN7HI43Po4zSN3A (small blind) collected ($3)
Seat 4: PEmogYqKpuv0ozeBbXL+7Q (big blind) folded before Flop
Seat 6: tjhwe1V98x2spSoUQER3HQ folded before Flop (didn't bet)
Seat 7: wIZ377kjl2fHFGnS93o6bw folded before Flop (didn't bet)
Seat 8: knewtTmBc4Tc0z/5tAABYQ folded before Flop (didn't bet)



PokerStars Game #59938855210:  Hold'em No Limit ($0.50/$1.00) - 2009/07/01 0:25:11 ET
Table '/FUb199IViHMJHi5YWmeuQ' 9-max Seat #5 is the button
Seat 1: TZcz9MEWDA+WydgGruqqbw ($100 in chips)
Seat 2: FL3MrLspcF23LYvC4ipBOA ($133.75 in chips)
Seat 3: qN483QJ1NvHbdIZB7J4ARw ($73.75 in chips)
Seat 4: qheQay5YvP2DMAb3OUSxtw ($107.30 in chips)
Seat 5: +za1iHiRgVo4OcAz0SOZqw ($15.45 in chips)
Seat 6: ccFf7Q4z1cTGQmeoYiWEfw ($39 in chips)
Seat 7: bLbSOSmSOnqE0iTcH/5dxA ($100 in chips)
Seat 8: QIWvt0R766g8KfH0vl1s0A ($49.10 in chips)
Seat 9: knewtTmBc4Tc0z/5tAABYQ ($124.25 in chips)
ccFf7Q4z1cTGQmeoYiWEfw: posts small blind $0.50
bLbSOSmSOnqE0iTcH/5dxA: posts big blind $1
*** HOLE CARDS ***
QIWvt0R766g8KfH0vl1s0A: folds
knewtTmBc4Tc0z/5tAABYQ: folds
TZcz9MEWDA+WydgGruqqbw: raises $2.50 to $3.50
FL3MrLspcF23LYvC4ipBOA: raises $7.50 to $11
qN483QJ1NvHbdIZB7J4ARw: folds
qheQay5YvP2DMAb3OUSxtw: folds
+za1iHiRgVo4OcAz0SOZqw: folds
ccFf7Q4z1cTGQmeoYiWEfw: folds
bLbSOSmSOnqE0iTcH/5dxA: folds
TZcz9MEWDA+WydgGruqqbw: folds
FL3MrLspcF23LYvC4ipBOA collected $8.50 from pot
FL3MrLspcF23LYvC4ipBOA: doesn't show hand
*** SUMMARY ***
Total pot $8.50 | Rake $0
Seat 1: TZcz9MEWDA+WydgGruqqbw folded before Flop
Seat 2: FL3MrLspcF23LYvC4ipBOA collected ($8.50)
Seat 3: qN483QJ1NvHbdIZB7J4ARw folded before Flop (didn't bet)
Seat 4: qheQay5YvP2DMAb3OUSxtw folded before Flop (didn't bet)
Seat 5: +za1iHiRgVo4OcAz0SOZqw (button) folded before Flop (didn't bet)
Seat 6: ccFf7Q4z1cTGQmeoYiWEfw (small blind) folded before Flop
Seat 7: bLbSOSmSOnqE0iTcH/5dxA (big blind) folded before Flop
Seat 8: QIWvt0R766g8KfH0vl1s0A folded before Flop (didn't bet)
Seat 9: knewtTmBc4Tc0z/5tAABYQ folded before Flop (didn't bet)



PokerStars Game #59938855354:  Hold'em No Limit ($0.50/$1.00) - 2009/07/01 0:25:11 ET
Table 'GxCPo/gd3OSthkYrAxJngg' 6-max Seat #5 is the button
Seat 1: sH8BpAFP+jGFxCgVpD1Lew ($280.95 in chips)
Seat 2: YExX2paeIHrmfIwV1ivM/w ($85.20 in chips)
Seat 4: YMJG+F++3Aj6P8dAWda5fw ($106.65 in chips)
Seat 5: G5ZSSN6RSON3gkNvk/SmYg ($100 in chips)
Seat 6: sS9IXedL3MiRmpVXhAILhw ($96 in chips)
sS9IXedL3MiRmpVXhAILhw: posts small blind $0.50
sH8BpAFP+jGFxCgVpD1Lew: posts big blind $1
*** HOLE CARDS ***
YExX2paeIHrmfIwV1ivM/w: folds
YMJG+F++3Aj6P8dAWda5fw: folds
G5ZSSN6RSON3gkNvk/SmYg: folds
sS9IXedL3MiRmpVXhAILhw: raises $3 to $4
o6plE+MSW4XFNTeONe16xg joins the table at seat #3
sH8BpAFP+jGFxCgVpD1Lew: folds
sS9IXedL3MiRmpVXhAILhw collected $2 from pot
*** SUMMARY ***
Total pot $2 | Rake $0
Seat 1: sH8BpAFP+jGFxCgVpD1Lew (big blind) folded before Flop
Seat 2: YExX2paeIHrmfIwV1ivM/w folded before Flop (didn't bet)
Seat 4: YMJG+F++3Aj6P8dAWda5fw folded before Flop (didn't bet)
Seat 5: G5ZSSN6RSON3gkNvk/SmYg (button) folded before Flop (didn't bet)
Seat 6: sS9IXedL3MiRmpVXhAILhw (small blind) collected ($2)



PokerStars Game #59938855972:  Hold'em No Limit ($0.50/$1.00) - 2009/07/01 0:25:12 ET
Table 'aWHveb63HkbTmOGHOxjBkQ' 2-max Seat #1 is the button
Seat 1: xy2MQKoHoCZZIudmw8Xbow ($227.40 in chips)
Seat 2: xstEKavv3YDxpUnU4e9qAQ ($144.60 in chips)
xy2MQKoHoCZZIudmw8Xbow: posts small blind $0.50
xstEKavv3YDxpUnU4e9qAQ: posts big blind $1
*** HOLE CARDS ***
xy2MQKoHoCZZIudmw8Xbow: raises $3 to $4
xstEKavv3YDxpUnU4e9qAQ: folds
xy2MQKoHoCZZIudmw8Xbow collected $2 from pot
xy2MQKoHoCZZIudmw8Xbow: doesn't show hand
*** SUMMARY ***
Total pot $2 | Rake $0
Seat 1: xy2MQKoHoCZZIudmw8Xbow (button) (small blind) collected ($2)
Seat 2: xstEKavv3YDxpUnU4e9qAQ (big blind) folded before Flop



PokerStars Game #59938856162:  Hold'em No Limit ($0.50/$1.00) - 2009/07/01 0:25:13 ET
Table 'QSIig7BLMc9wY/rgBechzw' 6-max Seat #5 is the button
Seat 1: uuA9hpFU17U5/t4cvpbpBg ($37.40 in chips)
Seat 2: 0WjiuIT7/EolY1oOx1ngeA ($126.25 in chips)
Seat 3: +W6OnF033KNM2xH0fGj98Q ($110.20 in chips)
Seat 4: +uSzP8Jwnw7sKfQ4s66b7w ($47 in chips)
Seat 5: bvU2ZjpVnszLCFVeWbxePg ($112.20 in chips)
Seat 6: KpnW5CcJ4Mg6MeclfKmLrw ($131.25 in chips)
KpnW5CcJ4Mg6MeclfKmLrw: posts small blind $0.50
uuA9hpFU17U5/t4cvpbpBg: posts big blind $1
*** HOLE CARDS ***
0WjiuIT7/EolY1oOx1ngeA: folds
+W6OnF033KNM2xH0fGj98Q: raises $2 to $3
+uSzP8Jwnw7sKfQ4s66b7w: folds
bvU2ZjpVnszLCFVeWbxePg: folds
KpnW5CcJ4Mg6MeclfKmLrw: folds
uuA9hpFU17U5/t4cvpbpBg: folds
+W6OnF033KNM2xH0fGj98Q collected $2.50 from pot
+W6OnF033KNM2xH0fGj98Q: doesn't show hand
*** SUMMARY ***
Total pot $2.50 | Rake $0
Seat 1: uuA9hpFU17U5/t4cvpbpBg (big blind) folded before Flop
Seat 2: 0WjiuIT7/EolY1oOx1ngeA folded before Flop (didn't bet)
Seat 3: +W6OnF033KNM2xH0fGj98Q collected ($2.50)
Seat 4: +uSzP8Jwnw7sKfQ4s66b7w folded before Flop (didn't bet)
Seat 5: bvU2ZjpVnszLCFVeWbxePg (button) folded before Flop (didn't bet)
Seat 6: KpnW5CcJ4Mg6MeclfKmLrw (small blind) folded before Flop



PokerStars Game #59938857816:  Hold'em No Limit ($0.50/$1.00) - 2009/07/01 0:25:15 ET
Table 'tLrtq7gDzxEvckNAI1OS5Q' 6-max Seat #4 is the button
Seat 1: GisIe1kcC9q/xV6ifsTjgA ($153.35 in chips)
Seat 2: qsObMEIlRO22OlS867m/lw ($19.30 in chips)
Seat 3: TPZ+m9x+lwoKpv7TMfAUWA ($316.05 in chips)
Seat 4: KOG8rG51mOvIoY96zF3kvw ($161.80 in chips)
Seat 5: OGMLOcTNYZXZU81au7ztUw ($166.95 in chips)
Seat 6: XUk5GQsfNFpHvaToDZ0rZA ($44.95 in chips)
OGMLOcTNYZXZU81au7ztUw: posts small blind $0.50
XUk5GQsfNFpHvaToDZ0rZA: posts big blind $1
*** HOLE CARDS ***
GisIe1kcC9q/xV6ifsTjgA: folds
qsObMEIlRO22OlS867m/lw: folds
TPZ+m9x+lwoKpv7TMfAUWA: folds
KOG8rG51mOvIoY96zF3kvw: raises $2 to $3
OGMLOcTNYZXZU81au7ztUw: folds
XUk5GQsfNFpHvaToDZ0rZA: folds
KOG8rG51mOvIoY96zF3kvw collected $2.50 from pot
KOG8rG51mOvIoY96zF3kvw: doesn't show hand
*** SUMMARY ***
Total pot $2.50 | Rake $0
Seat 1: GisIe1kcC9q/xV6ifsTjgA folded before Flop (didn't bet)
Seat 2: qsObMEIlRO22OlS867m/lw folded before Flop (didn't bet)
Seat 3: TPZ+m9x+lwoKpv7TMfAUWA folded before Flop (didn't bet)
Seat 4: KOG8rG51mOvIoY96zF3kvw (button) collected ($2.50)
Seat 5: OGMLOcTNYZXZU81au7ztUw (small blind) folded before Flop
Seat 6: XUk5GQsfNFpHvaToDZ0rZA (big blind) folded before Flop



PokerStars Game #59938858670:  Hold'em No Limit ($0.50/$1.00) - 2009/07/01 0:25:17 ET
Table 'hugOjcwJvzEwZbK7tyiWuQ' 9-max Seat #2 is the button
Seat 1: N9n5Wc3s35DpCrOAUUNAaQ ($126.35 in chips)
Seat 2: r27C1nIV4NS4+qbnrgBQSw ($257.05 in chips)
Seat 3: jDwhY1kCdc6EkAHbT7PJMQ ($107.05 in chips)
Seat 4: UWB3oeddt/GObx2Mix2Anw ($195.20 in chips)
Seat 6: gUUvmqdVlmvpal6B8nYrmg ($107.45 in chips)
Seat 7: FL3MrLspcF23LYvC4ipBOA ($100 in chips)
Seat 8: /zy+DB4S5fUQUSfZWFzYGw ($111.25 in chips)
Seat 9: o6JyUkbzCDw8tUabqtmnlg ($59.10 in chips)
jDwhY1kCdc6EkAHbT7PJMQ: posts small blind $0.50
UWB3oeddt/GObx2Mix2Anw: posts big blind $1
*** HOLE CARDS ***
gUUvmqdVlmvpal6B8nYrmg: folds
FL3MrLspcF23LYvC4ipBOA: folds
/zy+DB4S5fUQUSfZWFzYGw: folds
o6JyUkbzCDw8tUabqtmnlg: folds
N9n5Wc3s35DpCrOAUUNAaQ: folds
r27C1nIV4NS4+qbnrgBQSw: folds
jDwhY1kCdc6EkAHbT7PJMQ: raises $2 to $3
UWB3oeddt/GObx2Mix2Anw: calls $2
*** FLOP *** [7d 3s Qd]
jDwhY1kCdc6EkAHbT7PJMQ: bets $5
UWB3oeddt/GObx2Mix2Anw: folds
jDwhY1kCdc6EkAHbT7PJMQ collected $5.70 from pot
*** SUMMARY ***
Total pot $6 | Rake $0.30
Board [7d 3s Qd]
Seat 1: N9n5Wc3s35DpCrOAUUNAaQ folded before Flop (didn't bet)
Seat 2: r27C1nIV4NS4+qbnrgBQSw (button) folded before Flop (didn't bet)
Seat 3: jDwhY1kCdc6EkAHbT7PJMQ (small blind) collected ($5.70)
Seat 4: UWB3oeddt/GObx2Mix2Anw (big blind) folded on the Flop
Seat 6: gUUvmqdVlmvpal6B8nYrmg folded before Flop (didn't bet)
Seat 7: FL3MrLspcF23LYvC4ipBOA folded before Flop (didn't bet)
Seat 8: /zy+DB4S5fUQUSfZWFzYGw folded before Flop (didn't bet)
Seat 9: o6JyUkbzCDw8tUabqtmnlg folded before Flop (didn't bet)



PokerStars Game #59938859940:  Hold'em No Limit ($0.50/$1.00) - 2009/07/01 0:25:19 ET
Table 'vs/5jr6ciwjVQ5+Soc+u2A' 6-max Seat #5 is the button
Seat 2: XOIf9W+VAxhZqN+SYoyMKA ($120.30 in chips)
Seat 3: G5ZSSN6RSON3gkNvk/SmYg ($100.70 in chips)
Seat 4: KpnW5CcJ4Mg6MeclfKmLrw ($101.65 in chips)
Seat 5: 7Vc9JmGFQwMRh5Tj9ui5Lw ($93.15 in chips)
Seat 6: QHvTZcrKe6+maWUfVjP29Q ($106 in chips)
QHvTZcrKe6+maWUfVjP29Q: posts small blind $0.50
XOIf9W+VAxhZqN+SYoyMKA: posts big blind $1
*** HOLE CARDS ***
G5ZSSN6RSON3gkNvk/SmYg: folds
KpnW5CcJ4Mg6MeclfKmLrw has timed out
KpnW5CcJ4Mg6MeclfKmLrw: folds
KpnW5CcJ4Mg6MeclfKmLrw is sitting out
7Vc9JmGFQwMRh5Tj9ui5Lw: folds
KpnW5CcJ4Mg6MeclfKmLrw has returned
QHvTZcrKe6+maWUfVjP29Q: folds
XOIf9W+VAxhZqN+SYoyMKA collected $1 from pot
XOIf9W+VAxhZqN+SYoyMKA: doesn't show hand
*** SUMMARY ***
Total pot $1 | Rake $0
Seat 2: XOIf9W+VAxhZqN+SYoyMKA (big blind) collected ($1)
Seat 3: G5ZSSN6RSON3gkNvk/SmYg folded before Flop (didn't bet)
Seat 4: KpnW5CcJ4Mg6MeclfKmLrw folded before Flop (didn't bet)
Seat 5: 7Vc9JmGFQwMRh5Tj9ui5Lw (button) folded before Flop (didn't bet)
Seat 6: QHvTZcrKe6+maWUfVjP29Q (small blind) folded before Flop



PokerStars Game #59938860034:  Hold'em No Limit ($0.50/$1.00) - 2009/07/01 0:25:19 ET
Table 'aWHveb63HkbTmOGHOxjBkQ' 2-max Seat #2 is the button
Seat 1: xy2MQKoHoCZZIudmw8Xbow ($228.40 in chips)
Seat 2: xstEKavv3YDxpUnU4e9qAQ ($143.60 in chips)
xstEKavv3YDxpUnU4e9qAQ: posts small blind $0.50
xy2MQKoHoCZZIudmw8Xbow: posts big blind $1
*** HOLE CARDS ***
xstEKavv3YDxpUnU4e9qAQ: raises $3 to $4
xy2MQKoHoCZZIudmw8Xbow: folds
xstEKavv3YDxpUnU4e9qAQ collected $2 from pot
*** SUMMARY ***
Total pot $2 | Rake $0
Seat 1: xy2MQKoHoCZZIudmw8Xbow (big blind) folded before Flop
Seat 2: xstEKavv3YDxpUnU4e9qAQ (button) (small blind) collected ($2)



PokerStars Game #59938860512:  Hold'em No Limit ($0.50/$1.00) - 2009/07/01 0:25:19 ET
Table 'kS0cTQAEi+fdUlJP2gQYvw' 9-max Seat #9 is the button
Seat 1: c/9X4zftzphFxYtxp5kp9w ($50.90 in chips)
Seat 2: 4SFNYndzMeslixOnF4koZQ ($55.15 in chips)
Seat 3: 3obndzTJ6fECz8+wWhMd1w ($18.50 in chips)
Seat 4: TZcz9MEWDA+WydgGruqqbw ($100 in chips)
Seat 5: 2rxrMrE7koO2BNxvop/0+g ($49.20 in chips)
Seat 6: yAbu2QsRPVcjPbqlf/jDxw ($100.65 in chips)
Seat 7: Ffa7Nj4X5fddtROP01hfQg ($91.10 in chips)
Seat 8: qTymj6ZQ8ZoFi6fINJZb3w ($86.50 in chips)
Seat 9: y8Qb94e81yI/g0saQ6gU5g ($87.75 in chips)
c/9X4zftzphFxYtxp5kp9w: posts small blind $0.50
4SFNYndzMeslixOnF4koZQ: posts big blind $1
*** HOLE CARDS ***
3obndzTJ6fECz8+wWhMd1w: folds
TZcz9MEWDA+WydgGruqqbw: folds
2rxrMrE7koO2BNxvop/0+g: folds
yAbu2QsRPVcjPbqlf/jDxw: folds
Ffa7Nj4X5fddtROP01hfQg: raises $2 to $3
qTymj6ZQ8ZoFi6fINJZb3w: folds
y8Qb94e81yI/g0saQ6gU5g: calls $3
c/9X4zftzphFxYtxp5kp9w: calls $2.50
4SFNYndzMeslixOnF4koZQ: folds
*** FLOP *** [7h Qc 8c]
c/9X4zftzphFxYtxp5kp9w: checks
Ffa7Nj4X5fddtROP01hfQg: bets $2
y8Qb94e81yI/g0saQ6gU5g: folds
c/9X4zftzphFxYtxp5kp9w: calls $2
*** TURN *** [7h Qc 8c] [2h]
c/9X4zftzphFxYtxp5kp9w: checks
Ffa7Nj4X5fddtROP01hfQg: checks
*** RIVER *** [7h Qc 8c 2h] [8s]
c/9X4zftzphFxYtxp5kp9w: checks
Ffa7Nj4X5fddtROP01hfQg: bets $4
c/9X4zftzphFxYtxp5kp9w: calls $4
*** SHOW DOWN ***
Ffa7Nj4X5fddtROP01hfQg: shows [8h As] (three of a kind, Eights)
c/9X4zftzphFxYtxp5kp9w: mucks hand
Ffa7Nj4X5fddtROP01hfQg collected $20.95 from pot
*** SUMMARY ***
Total pot $22 | Rake $1.05
Board [7h Qc 8c 2h 8s]
Seat 1: c/9X4zftzphFxYtxp5kp9w (small blind) mucked
Seat 2: 4SFNYndzMeslixOnF4koZQ (big blind) folded before Flop
Seat 3: 3obndzTJ6fECz8+wWhMd1w folded before Flop (didn't bet)
Seat 4: TZcz9MEWDA+WydgGruqqbw folded before Flop (didn't bet)
Seat 5: 2rxrMrE7koO2BNxvop/0+g folded before Flop (didn't bet)
Seat 6: yAbu2QsRPVcjPbqlf/jDxw folded before Flop (didn't bet)
Seat 7: Ffa7Nj4X5fddtROP01hfQg showed [8h As] and won ($20.95) with three of a kind, Eights
Seat 8: qTymj6ZQ8ZoFi6fINJZb3w folded before Flop (didn't bet)
Seat 9: y8Qb94e81yI/g0saQ6gU5g (button) folded on the Flop



PokerStars Game #59938861342:  Hold'em No Limit ($0.50/$1.00) - 2009/07/01 0:25:21 ET
Table '6YvsYDPNIDx2v5z3bJnwZQ' 9-max Seat #7 is the button
Seat 1: Ogn4JDV3mp4ZDKO49IFzKA ($17 in chips)
Seat 3: negfosHnGOZXSHpWDRKyBQ ($18.30 in chips)
Seat 4: kEr5NYB+JIG5+szcYMr6hA ($47.50 in chips)
Seat 5: mBRWbnUl8diyBO1qTJaNzw ($168.70 in chips)
Seat 6: uMPEfCcGCfsxmy53tVUMug ($107.40 in chips)
Seat 7: boixc27eqTYA1p0tUdMuBQ ($115 in chips)
Seat 8: PSFxpXgPedVZyHSu2Zhb7Q ($64.25 in chips)
Seat 9: jDwhY1kCdc6EkAHbT7PJMQ ($102.85 in chips)
PSFxpXgPedVZyHSu2Zhb7Q: posts small blind $0.50
jDwhY1kCdc6EkAHbT7PJMQ: posts big blind $1
*** HOLE CARDS ***
Ogn4JDV3mp4ZDKO49IFzKA: folds
negfosHnGOZXSHpWDRKyBQ: folds
kEr5NYB+JIG5+szcYMr6hA: folds
mBRWbnUl8diyBO1qTJaNzw: raises $3 to $4
35DmRulmD2MgzT6Bbt6/2w joins the table at seat #2
uMPEfCcGCfsxmy53tVUMug: folds
boixc27eqTYA1p0tUdMuBQ: folds
PSFxpXgPedVZyHSu2Zhb7Q: folds
jDwhY1kCdc6EkAHbT7PJMQ: folds
mBRWbnUl8diyBO1qTJaNzw collected $2.50 from pot
*** SUMMARY ***
Total pot $2.50 | Rake $0
Seat 1: Ogn4JDV3mp4ZDKO49IFzKA folded before Flop (didn't bet)
Seat 3: negfosHnGOZXSHpWDRKyBQ folded before Flop (didn't bet)
Seat 4: kEr5NYB+JIG5+szcYMr6hA folded before Flop (didn't bet)
Seat 5: mBRWbnUl8diyBO1qTJaNzw collected ($2.50)
Seat 6: uMPEfCcGCfsxmy53tVUMug folded before Flop (didn't bet)
Seat 7: boixc27eqTYA1p0tUdMuBQ (button) folded before Flop (didn't bet)
Seat 8: PSFxpXgPedVZyHSu2Zhb7Q (small blind) folded before Flop
Seat 9: jDwhY1kCdc6EkAHbT7PJMQ (big blind) folded before Flop



PokerStars Game #59938861984:  Hold'em No Limit ($0.50/$1.00) - 2009/07/01 0:25:22 ET
Table 'W/wyObTiXZm+Ckkl3YxcSw' 6-max Seat #3 is the button
Seat 1: ssLJburtEIqnVkx6X8R1uw ($117.25 in chips)
Seat 2: oDiBRCaF0QVtd3kO6xZIXw ($100 in chips)
Seat 3: b2a+5TkFf4xJN/Ihhma58Q ($34.70 in chips)
Seat 4: BdbmJTZZ47quA9vUWwXtlw ($46.60 in chips)
Seat 6: 1yB1nHUkHNNY8OJnDNHZMw ($55.40 in chips)
BdbmJTZZ47quA9vUWwXtlw: posts small blind $0.50
1yB1nHUkHNNY8OJnDNHZMw: posts big blind $1
*** HOLE CARDS ***
ssLJburtEIqnVkx6X8R1uw: folds
oDiBRCaF0QVtd3kO6xZIXw: folds
b2a+5TkFf4xJN/Ihhma58Q: folds
BdbmJTZZ47quA9vUWwXtlw: raises $2 to $3
1yB1nHUkHNNY8OJnDNHZMw: raises $52.40 to $55.40 and is all-in
BdbmJTZZ47quA9vUWwXtlw: folds
1yB1nHUkHNNY8OJnDNHZMw collected $6 from pot
*** SUMMARY ***
Total pot $6 | Rake $0
Seat 1: ssLJburtEIqnVkx6X8R1uw folded before Flop (didn't bet)
Seat 2: oDiBRCaF0QVtd3kO6xZIXw folded before Flop (didn't bet)
Seat 3: b2a+5TkFf4xJN/Ihhma58Q (button) folded before Flop (didn't bet)
Seat 4: BdbmJTZZ47quA9vUWwXtlw (small blind) folded before Flop
Seat 6: 1yB1nHUkHNNY8OJnDNHZMw (big blind) collected ($6)



PokerStars Game #59938863124:  Hold'em No Limit ($0.50/$1.00) - 2009/07/01 0:25:23 ET
Table 'cBDNutyLBKEk9+ptwsKmTw' 6-max Seat #2 is the button
Seat 2: KyaE4+hWgUNIWWOWy4D14w ($83.50 in chips)
Seat 3: G5ZSSN6RSON3gkNvk/SmYg ($106.90 in chips)
Seat 4: 0WjiuIT7/EolY1oOx1ngeA ($105.15 in chips)
Seat 5: OGMLOcTNYZXZU81au7ztUw ($109.70 in chips)
Seat 6: pyzhFUPPSNzrysiMqlA5Xw ($10.60 in chips)
G5ZSSN6RSON3gkNvk/SmYg: posts small blind $0.50
0WjiuIT7/EolY1oOx1ngeA: posts big blind $1
*** HOLE CARDS ***
OGMLOcTNYZXZU81au7ztUw: folds
xAU6q2/cwmby2sxmA8VcmA joins the table at seat #1
pyzhFUPPSNzrysiMqlA5Xw: folds
KyaE4+hWgUNIWWOWy4D14w: raises $1 to $2
G5ZSSN6RSON3gkNvk/SmYg: folds
0WjiuIT7/EolY1oOx1ngeA: calls $1
*** FLOP *** [4s 8c Jd]
0WjiuIT7/EolY1oOx1ngeA: bets $2
KyaE4+hWgUNIWWOWy4D14w: calls $2
*** TURN *** [4s 8c Jd] [Qc]
0WjiuIT7/EolY1oOx1ngeA: checks
KyaE4+hWgUNIWWOWy4D14w: bets $2
0WjiuIT7/EolY1oOx1ngeA: folds
KyaE4+hWgUNIWWOWy4D14w collected $8.10 from pot
*** SUMMARY ***
Total pot $8.50 | Rake $0.40
Board [4s 8c Jd Qc]
Seat 2: KyaE4+hWgUNIWWOWy4D14w (button) collected ($8.10)
Seat 3: G5ZSSN6RSON3gkNvk/SmYg (small blind) folded before Flop
Seat 4: 0WjiuIT7/EolY1oOx1ngeA (big blind) folded on the Turn
Seat 5: OGMLOcTNYZXZU81au7ztUw folded before Flop (didn't bet)
Seat 6: pyzhFUPPSNzrysiMqlA5Xw folded before Flop (didn't bet)



PokerStars Game #59938863558:  Hold'em No Limit ($0.50/$1.00) - 2009/07/01 0:25:24 ET
Table '/RZcOwpZpHQ+OwPwjsbnRw' 6-max Seat #3 is the button
Seat 2: dHC9PH9hdH3Ad2TD8ZxX0Q ($46.70 in chips)
Seat 3: OigyyiK+tTj1APPIAUmXDA ($72.65 in chips)
Seat 4: j7NIOHLZk7V2o9fOioO5ug ($109.40 in chips)
Seat 5: wx3sQGkVi2x9wJXuWNHPBw ($202.05 in chips)
Seat 6: XOIf9W+VAxhZqN+SYoyMKA ($255.30 in chips)
j7NIOHLZk7V2o9fOioO5ug: posts small blind $0.50
wx3sQGkVi2x9wJXuWNHPBw: posts big blind $1
*** HOLE CARDS ***
XOIf9W+VAxhZqN+SYoyMKA: folds
dHC9PH9hdH3Ad2TD8ZxX0Q: folds
OigyyiK+tTj1APPIAUmXDA: raises $2 to $3
j7NIOHLZk7V2o9fOioO5ug: folds
wx3sQGkVi2x9wJXuWNHPBw: folds
OigyyiK+tTj1APPIAUmXDA collected $2.50 from pot
*** SUMMARY ***
Total pot $2.50 | Rake $0
Seat 2: dHC9PH9hdH3Ad2TD8ZxX0Q folded before Flop (didn't bet)
Seat 3: OigyyiK+tTj1APPIAUmXDA (button) collected ($2.50)
Seat 4: j7NIOHLZk7V2o9fOioO5ug (small blind) folded before Flop
Seat 5: wx3sQGkVi2x9wJXuWNHPBw (big blind) folded before Flop
Seat 6: XOIf9W+VAxhZqN+SYoyMKA folded before Flop (didn't bet)



PokerStars Game #59938864070:  Hold'em No Limit ($0.50/$1.00) - 2009/07/01 0:25:25 ET
Table 'aWHveb63HkbTmOGHOxjBkQ' 2-max Seat #1 is the button
Seat 1: xy2MQKoHoCZZIudmw8Xbow ($227.40 in chips)
Seat 2: xstEKavv3YDxpUnU4e9qAQ ($144.60 in chips)
xy2MQKoHoCZZIudmw8Xbow: posts small blind $0.50
xstEKavv3YDxpUnU4e9qAQ: posts big blind $1
*** HOLE CARDS ***
xy2MQKoHoCZZIudmw8Xbow: raises $3 to $4
xstEKavv3YDxpUnU4e9qAQ: folds
xy2MQKoHoCZZIudmw8Xbow collected $2 from pot
xy2MQKoHoCZZIudmw8Xbow: doesn't show hand
*** SUMMARY ***
Total pot $2 | Rake $0
Seat 1: xy2MQKoHoCZZIudmw8Xbow (button) (small blind) collected ($2)
Seat 2: xstEKavv3YDxpUnU4e9qAQ (big blind) folded before Flop



PokerStars Game #59938865164:  Hold'em No Limit ($0.50/$1.00) - 2009/07/01 0:25:26 ET
Table 'pHrhryH8jPNdQfY62f8v+g' 6-max Seat #5 is the button
Seat 1: BdbmJTZZ47quA9vUWwXtlw ($68.25 in chips)
Seat 2: RqgF7gRoKgRNW8Zoi1ty4A ($118 in chips)
Seat 3: 0WjiuIT7/EolY1oOx1ngeA ($101.50 in chips)
Seat 4: wenbG7TaM3H7h5kn78OFNw ($56 in chips)
Seat 5: Gp2euK/nqF6qXKe7U+jOfw ($117.15 in chips)
Seat 6: xAU6q2/cwmby2sxmA8VcmA ($100 in chips)
xAU6q2/cwmby2sxmA8VcmA: posts small blind $0.50
BdbmJTZZ47quA9vUWwXtlw: posts big blind $1
*** HOLE CARDS ***
RqgF7gRoKgRNW8Zoi1ty4A: folds
0WjiuIT7/EolY1oOx1ngeA: folds
wenbG7TaM3H7h5kn78OFNw: raises $2 to $3
Gp2euK/nqF6qXKe7U+jOfw: folds
xAU6q2/cwmby2sxmA8VcmA: folds
BdbmJTZZ47quA9vUWwXtlw: folds
wenbG7TaM3H7h5kn78OFNw collected $2.50 from pot
*** SUMMARY ***
Total pot $2.50 | Rake $0
Seat 1: BdbmJTZZ47quA9vUWwXtlw (big blind) folded before Flop
Seat 2: RqgF7gRoKgRNW8Zoi1ty4A folded before Flop (didn't bet)
Seat 3: 0WjiuIT7/EolY1oOx1ngeA folded before Flop (didn't bet)
Seat 4: wenbG7TaM3H7h5kn78OFNw collected ($2.50)
Seat 5: Gp2euK/nqF6qXKe7U+jOfw (button) folded before Flop (didn't bet)
Seat 6: xAU6q2/cwmby2sxmA8VcmA (small blind) folded before Flop



PokerStars Game #59938864900:  Hold'em No Limit ($0.50/$1.00) - 2009/07/01 0:25:26 ET
Table 'rmZfTK+oSebeUPJNbWhdAA' 6-max Seat #3 is the button
Seat 1: xAU6q2/cwmby2sxmA8VcmA ($100 in chips)
Seat 2: OigyyiK+tTj1APPIAUmXDA ($88.90 in chips)
Seat 3: 9yjOzGERLaEZS8CZ6YNHFg ($48.80 in chips)
Seat 4: OGMLOcTNYZXZU81au7ztUw ($125.65 in chips)
Seat 6: j7NIOHLZk7V2o9fOioO5ug ($108 in chips)
OGMLOcTNYZXZU81au7ztUw: posts small blind $0.50
VuZb/hkEc4X7s93w2ZZTpA: is sitting out
j7NIOHLZk7V2o9fOioO5ug: posts big blind $1
*** HOLE CARDS ***
xAU6q2/cwmby2sxmA8VcmA: folds
OigyyiK+tTj1APPIAUmXDA: raises $2 to $3
9yjOzGERLaEZS8CZ6YNHFg: folds
OGMLOcTNYZXZU81au7ztUw: calls $2.50
VuZb/hkEc4X7s93w2ZZTpA leaves the table
j7NIOHLZk7V2o9fOioO5ug: folds
*** FLOP *** [2c 4h 3c]
OGMLOcTNYZXZU81au7ztUw: checks
+xW7QemQU0Fxs+4TnqBRow joins the table at seat #5
OigyyiK+tTj1APPIAUmXDA: checks
*** TURN *** [2c 4h 3c] [9s]
OGMLOcTNYZXZU81au7ztUw: checks
OigyyiK+tTj1APPIAUmXDA: checks
*** RIVER *** [2c 4h 3c 9s] [Qs]
OGMLOcTNYZXZU81au7ztUw: checks
OigyyiK+tTj1APPIAUmXDA: bets $5
OGMLOcTNYZXZU81au7ztUw: folds
OigyyiK+tTj1APPIAUmXDA collected $6.65 from pot
*** SUMMARY ***
Total pot $7 | Rake $0.35
Board [2c 4h 3c 9s Qs]
Seat 1: xAU6q2/cwmby2sxmA8VcmA folded before Flop (didn't bet)
Seat 2: OigyyiK+tTj1APPIAUmXDA collected ($6.65)
Seat 3: 9yjOzGERLaEZS8CZ6YNHFg (button) folded before Flop (didn't bet)
Seat 4: OGMLOcTNYZXZU81au7ztUw (small blind) folded on the River
Seat 6: j7NIOHLZk7V2o9fOioO5ug (big blind) folded before Flop



PokerStars Game #59938865568:  Hold'em No Limit ($0.50/$1.00) - 2009/07/01 0:25:27 ET
Table '+cA8mcmhaedZ7YcrDdhmeQ' 6-max Seat #2 is the button
Seat 1: lsLuWlcPA3Rh7kJVLzMh0Q ($231.50 in chips)
Seat 2: trnpu4tPju3BU8W0wQQaiQ ($103.95 in chips)
Seat 3: 0WjiuIT7/EolY1oOx1ngeA ($116.80 in chips)
Seat 4: j0aDOn9Nft1HLTQvGu1UwA ($11.25 in chips)
Seat 5: 6WyjEXOToimYmtLdqIgHYQ ($60.50 in chips)
Seat 6: YfsTQsY/fxb+YqbdclTHuw ($114.25 in chips)
0WjiuIT7/EolY1oOx1ngeA: posts small blind $0.50
j0aDOn9Nft1HLTQvGu1UwA: posts big blind $1
*** HOLE CARDS ***
6WyjEXOToimYmtLdqIgHYQ: folds
YfsTQsY/fxb+YqbdclTHuw: calls $1
lsLuWlcPA3Rh7kJVLzMh0Q: raises $4 to $5
trnpu4tPju3BU8W0wQQaiQ: folds
0WjiuIT7/EolY1oOx1ngeA: folds
j0aDOn9Nft1HLTQvGu1UwA: folds
YfsTQsY/fxb+YqbdclTHuw: folds
j0aDOn9Nft1HLTQvGu1UwA leaves the table
lsLuWlcPA3Rh7kJVLzMh0Q collected $3.50 from pot
*** SUMMARY ***
Total pot $3.50 | Rake $0
Seat 1: lsLuWlcPA3Rh7kJVLzMh0Q collected ($3.50)
Seat 2: trnpu4tPju3BU8W0wQQaiQ (button) folded before Flop (didn't bet)
Seat 3: 0WjiuIT7/EolY1oOx1ngeA (small blind) folded before Flop
Seat 4: j0aDOn9Nft1HLTQvGu1UwA (big blind) folded before Flop
Seat 5: 6WyjEXOToimYmtLdqIgHYQ folded before Flop (didn't bet)
Seat 6: YfsTQsY/fxb+YqbdclTHuw folded before Flop



PokerStars Game #59938866904:  Hold'em No Limit ($0.50/$1.00) - 2009/07/01 0:25:29 ET
Table 'Zka9tv1yilg0MvXWPQrShg' 9-max Seat #1 is the button
Seat 1: TZcz9MEWDA+WydgGruqqbw ($109.90 in chips)
Seat 3: gUUvmqdVlmvpal6B8nYrmg ($100 in chips)
Seat 4: CTOae+JLIGfwfXvhqHkP2w ($172.15 in chips)
Seat 5: /zy+DB4S5fUQUSfZWFzYGw ($141.45 in chips)
Seat 6: rY8wPoax1lS+HUY+I0FZDw ($128.40 in chips)
Seat 7: p1SafS90nb3Uft5LB0NkHw ($21.50 in chips)
Seat 8: bL+QVeDcuEdzMGAGg2XJHg ($124.60 in chips)
zBHLwg+HmbHmRtVQMhavjA: is sitting out
gUUvmqdVlmvpal6B8nYrmg: posts small blind $0.50
CTOae+JLIGfwfXvhqHkP2w: posts big blind $1
*** HOLE CARDS ***
zBHLwg+HmbHmRtVQMhavjA leaves the table
/zy+DB4S5fUQUSfZWFzYGw: folds
rY8wPoax1lS+HUY+I0FZDw: folds
p1SafS90nb3Uft5LB0NkHw: folds
bL+QVeDcuEdzMGAGg2XJHg: folds
TZcz9MEWDA+WydgGruqqbw: folds
gUUvmqdVlmvpal6B8nYrmg: raises $1 to $2
CTOae+JLIGfwfXvhqHkP2w: folds
gUUvmqdVlmvpal6B8nYrmg collected $2 from pot
*** SUMMARY ***
Total pot $2 | Rake $0
Seat 1: TZcz9MEWDA+WydgGruqqbw (button) folded before Flop (didn't bet)
Seat 3: gUUvmqdVlmvpal6B8nYrmg (small blind) collected ($2)
Seat 4: CTOae+JLIGfwfXvhqHkP2w (big blind) folded before Flop
Seat 5: /zy+DB4S5fUQUSfZWFzYGw folded before Flop (didn't bet)
Seat 6: rY8wPoax1lS+HUY+I0FZDw folded before Flop (didn't bet)
Seat 7: p1SafS90nb3Uft5LB0NkHw folded before Flop (didn't bet)
Seat 8: bL+QVeDcuEdzMGAGg2XJHg folded before Flop (didn't bet)



PokerStars Game #59938868288:  Hold'em No Limit ($0.50/$1.00) - 2009/07/01 0:25:31 ET
Table 'aWHveb63HkbTmOGHOxjBkQ' 2-max Seat #2 is the button
Seat 1: xy2MQKoHoCZZIudmw8Xbow ($228.40 in chips)
Seat 2: xstEKavv3YDxpUnU4e9qAQ ($143.60 in chips)
xstEKavv3YDxpUnU4e9qAQ: posts small blind $0.50
xy2MQKoHoCZZIudmw8Xbow: posts big blind $1
*** HOLE CARDS ***
xstEKavv3YDxpUnU4e9qAQ: folds
xy2MQKoHoCZZIudmw8Xbow collected $1 from pot
xy2MQKoHoCZZIudmw8Xbow: doesn't show hand
*** SUMMARY ***
Total pot $1 | Rake $0
Seat 1: xy2MQKoHoCZZIudmw8Xbow (big blind) collected ($1)
Seat 2: xstEKavv3YDxpUnU4e9qAQ (button) (small blind) folded before Flop



PokerStars Game #59938869390:  Hold'em No Limit ($0.50/$1.00) - 2009/07/01 0:25:33 ET
Table 'SQLOQoANiHscJ8AL7zffbw' 9-max Seat #9 is the button
Seat 1: jPTRd6SpCp4xqAy2XQiTOw ($102.85 in chips)
Seat 2: /zy+DB4S5fUQUSfZWFzYGw ($280.35 in chips)
Seat 3: 0eFnow7+D7veCYQ+CG9FFw ($71.50 in chips)
Seat 4: N9n5Wc3s35DpCrOAUUNAaQ ($120.30 in chips)
Seat 5: L9njYvloJ1NdXjP8edHEAg ($110.55 in chips)
Seat 6: p5UKaxVobvptF0ANhR/q1A ($157 in chips)
Seat 7: bJckevFOcg//s0qyMQI6sQ ($103.55 in chips)
Seat 8: 9ce+0Dl3d0BeEFIP+8HezA ($18.50 in chips)
Seat 9: qJr25HAtvv1w/7IBvjMM3g ($231.55 in chips)
jPTRd6SpCp4xqAy2XQiTOw: posts small blind $0.50
/zy+DB4S5fUQUSfZWFzYGw: posts big blind $1
*** HOLE CARDS ***
0eFnow7+D7veCYQ+CG9FFw: folds
N9n5Wc3s35DpCrOAUUNAaQ: calls $1
L9njYvloJ1NdXjP8edHEAg: folds
p5UKaxVobvptF0ANhR/q1A: folds
bJckevFOcg//s0qyMQI6sQ: folds
9ce+0Dl3d0BeEFIP+8HezA: folds
qJr25HAtvv1w/7IBvjMM3g: calls $1
jPTRd6SpCp4xqAy2XQiTOw: calls $0.50
/zy+DB4S5fUQUSfZWFzYGw: checks
*** FLOP *** [Kc Td Kh]
jPTRd6SpCp4xqAy2XQiTOw: checks
/zy+DB4S5fUQUSfZWFzYGw: checks
N9n5Wc3s35DpCrOAUUNAaQ: checks
qJr25HAtvv1w/7IBvjMM3g: bets $1
jPTRd6SpCp4xqAy2XQiTOw: folds
/zy+DB4S5fUQUSfZWFzYGw: folds
N9n5Wc3s35DpCrOAUUNAaQ: folds
qJr25HAtvv1w/7IBvjMM3g collected $3.80 from pot
*** SUMMARY ***
Total pot $4 | Rake $0.20
Board [Kc Td Kh]
Seat 1: jPTRd6SpCp4xqAy2XQiTOw (small blind) folded on the Flop
Seat 2: /zy+DB4S5fUQUSfZWFzYGw (big blind) folded on the Flop
Seat 3: 0eFnow7+D7veCYQ+CG9FFw folded before Flop (didn't bet)
Seat 4: N9n5Wc3s35DpCrOAUUNAaQ folded on the Flop
Seat 5: L9njYvloJ1NdXjP8edHEAg folded before Flop (didn't bet)
Seat 6: p5UKaxVobvptF0ANhR/q1A folded before Flop (didn't bet)
Seat 7: bJckevFOcg//s0qyMQI6sQ folded before Flop (didn't bet)
Seat 8: 9ce+0Dl3d0BeEFIP+8HezA folded before Flop (didn't bet)
Seat 9: qJr25HAtvv1w/7IBvjMM3g (button) collected ($3.80)



PokerStars Game #59938870028:  Hold'em No Limit ($0.50/$1.00) - 2009/07/01 0:25:34 ET
Table 'eU3bWpDDg3Z+9R4m4iVmog' 6-max Seat #6 is the button
Seat 1: TSuRyAHnUPCFjP7Z0rEE0w ($178 in chips)
Seat 2: 8CAoOzhmB8n3nRFf3V4BTg ($140.95 in chips)
Seat 3: U6tnjwZRpTnM+YkqkCjwyQ ($155.55 in chips)
Seat 4: GDVIsbEJ/DOJsMKE4Asz0A ($98 in chips)
Seat 5: QHvTZcrKe6+maWUfVjP29Q ($102 in chips)
Seat 6: hpxXcmRkXXI9HE5+5/j/0Q ($100 in chips)
TSuRyAHnUPCFjP7Z0rEE0w: posts small blind $0.50
8CAoOzhmB8n3nRFf3V4BTg: posts big blind $1
*** HOLE CARDS ***
U6tnjwZRpTnM+YkqkCjwyQ: folds
GDVIsbEJ/DOJsMKE4Asz0A: folds
QHvTZcrKe6+maWUfVjP29Q: folds
hpxXcmRkXXI9HE5+5/j/0Q: folds
TSuRyAHnUPCFjP7Z0rEE0w: folds
8CAoOzhmB8n3nRFf3V4BTg collected $1 from pot
*** SUMMARY ***
Total pot $1 | Rake $0
Seat 1: TSuRyAHnUPCFjP7Z0rEE0w (small blind) folded before Flop
Seat 2: 8CAoOzhmB8n3nRFf3V4BTg (big blind) collected ($1)
Seat 3: U6tnjwZRpTnM+YkqkCjwyQ folded before Flop (didn't bet)
Seat 4: GDVIsbEJ/DOJsMKE4Asz0A folded before Flop (didn't bet)
Seat 5: QHvTZcrKe6+maWUfVjP29Q folded before Flop (didn't bet)
Seat 6: hpxXcmRkXXI9HE5+5/j/0Q (button) folded before Flop (didn't bet)



PokerStars Game #59938872056:  Hold'em No Limit ($0.50/$1.00) - 2009/07/01 0:25:37 ET
Table 'tLrtq7gDzxEvckNAI1OS5Q' 6-max Seat #5 is the button
Seat 1: GisIe1kcC9q/xV6ifsTjgA ($153.35 in chips)
Seat 2: qsObMEIlRO22OlS867m/lw ($19.30 in chips)
Seat 3: TPZ+m9x+lwoKpv7TMfAUWA ($316.05 in chips)
Seat 4: KOG8rG51mOvIoY96zF3kvw ($163.30 in chips)
Seat 5: OGMLOcTNYZXZU81au7ztUw ($166.45 in chips)
Seat 6: XUk5GQsfNFpHvaToDZ0rZA ($43.95 in chips)
XUk5GQsfNFpHvaToDZ0rZA: posts small blind $0.50
GisIe1kcC9q/xV6ifsTjgA: posts big blind $1
*** HOLE CARDS ***
qsObMEIlRO22OlS867m/lw: folds
TPZ+m9x+lwoKpv7TMfAUWA: raises $2 to $3
KOG8rG51mOvIoY96zF3kvw: folds
OGMLOcTNYZXZU81au7ztUw: folds
XUk5GQsfNFpHvaToDZ0rZA: folds
GisIe1kcC9q/xV6ifsTjgA: calls $2
*** FLOP *** [Kh Ah Tc]
GisIe1kcC9q/xV6ifsTjgA: checks
TPZ+m9x+lwoKpv7TMfAUWA: bets $5
GisIe1kcC9q/xV6ifsTjgA: folds
TPZ+m9x+lwoKpv7TMfAUWA collected $6.20 from pot
*** SUMMARY ***
Total pot $6.50 | Rake $0.30
Board [Kh Ah Tc]
Seat 1: GisIe1kcC9q/xV6ifsTjgA (big blind) folded on the Flop
Seat 2: qsObMEIlRO22OlS867m/lw folded before Flop (didn't bet)
Seat 3: TPZ+m9x+lwoKpv7TMfAUWA collected ($6.20)
Seat 4: KOG8rG51mOvIoY96zF3kvw folded before Flop (didn't bet)
Seat 5: OGMLOcTNYZXZU81au7ztUw (button) folded before Flop (didn't bet)
Seat 6: XUk5GQsfNFpHvaToDZ0rZA (small blind) folded before Flop



PokerStars Game #59938872022:  Hold'em No Limit ($0.50/$1.00) - 2009/07/01 0:25:37 ET
Table 'aWHveb63HkbTmOGHOxjBkQ' 2-max Seat #1 is the button
Seat 1: xy2MQKoHoCZZIudmw8Xbow ($228.90 in chips)
Seat 2: xstEKavv3YDxpUnU4e9qAQ ($143.10 in chips)
xy2MQKoHoCZZIudmw8Xbow: posts small blind $0.50
xstEKavv3YDxpUnU4e9qAQ: posts big blind $1
*** HOLE CARDS ***
xy2MQKoHoCZZIudmw8Xbow: raises $3 to $4
xstEKavv3YDxpUnU4e9qAQ: raises $8 to $12
xy2MQKoHoCZZIudmw8Xbow: calls $8
*** FLOP *** [Kc 7c 6s]
xstEKavv3YDxpUnU4e9qAQ: checks
xy2MQKoHoCZZIudmw8Xbow: bets $8
xstEKavv3YDxpUnU4e9qAQ: calls $8
*** TURN *** [Kc 7c 6s] [5d]
xstEKavv3YDxpUnU4e9qAQ: checks
xy2MQKoHoCZZIudmw8Xbow: bets $13
xstEKavv3YDxpUnU4e9qAQ: calls $13
*** RIVER *** [Kc 7c 6s 5d] [Td]
xstEKavv3YDxpUnU4e9qAQ: checks
xy2MQKoHoCZZIudmw8Xbow: bets $41
xstEKavv3YDxpUnU4e9qAQ: folds
xy2MQKoHoCZZIudmw8Xbow collected $65.50 from pot
xy2MQKoHoCZZIudmw8Xbow: doesn't show hand
*** SUMMARY ***
Total pot $66 | Rake $0.50
Board [Kc 7c 6s 5d Td]
Seat 1: xy2MQKoHoCZZIudmw8Xbow (button) (small blind) collected ($65.50)
Seat 2: xstEKavv3YDxpUnU4e9qAQ (big blind) folded on the River



PokerStars Game #59938873374:  Hold'em No Limit ($0.50/$1.00) - 2009/07/01 0:25:39 ET
Table 'W/wyObTiXZm+Ckkl3YxcSw' 6-max Seat #4 is the button
Seat 1: ssLJburtEIqnVkx6X8R1uw ($117.25 in chips)
Seat 2: oDiBRCaF0QVtd3kO6xZIXw ($100 in chips)
Seat 3: b2a+5TkFf4xJN/Ihhma58Q ($34.70 in chips)
Seat 4: BdbmJTZZ47quA9vUWwXtlw ($43.60 in chips)
Seat 6: 1yB1nHUkHNNY8OJnDNHZMw ($58.40 in chips)
1yB1nHUkHNNY8OJnDNHZMw: posts small blind $0.50
ssLJburtEIqnVkx6X8R1uw: posts big blind $1
*** HOLE CARDS ***
oDiBRCaF0QVtd3kO6xZIXw: raises $2 to $3
b2a+5TkFf4xJN/Ihhma58Q: folds
BdbmJTZZ47quA9vUWwXtlw: calls $3
1yB1nHUkHNNY8OJnDNHZMw: raises $55.40 to $58.40 and is all-in
ssLJburtEIqnVkx6X8R1uw: folds
oDiBRCaF0QVtd3kO6xZIXw: folds
BdbmJTZZ47quA9vUWwXtlw: calls $40.60 and is all-in
*** FLOP *** [5c Jd 7d]
*** TURN *** [5c Jd 7d] [Qc]
*** RIVER *** [5c Jd 7d Qc] [2s]
*** SHOW DOWN ***
1yB1nHUkHNNY8OJnDNHZMw: shows [Qh Qd] (three of a kind, Queens)
BdbmJTZZ47quA9vUWwXtlw: mucks hand
1yB1nHUkHNNY8OJnDNHZMw collected $89.20 from pot
*** SUMMARY ***
Total pot $91.20 | Rake $2
Board [5c Jd 7d Qc 2s]
Seat 1: ssLJburtEIqnVkx6X8R1uw (big blind) folded before Flop
Seat 2: oDiBRCaF0QVtd3kO6xZIXw folded before Flop
Seat 3: b2a+5TkFf4xJN/Ihhma58Q folded before Flop (didn't bet)
Seat 4: BdbmJTZZ47quA9vUWwXtlw (button) mucked
Seat 6: 1yB1nHUkHNNY8OJnDNHZMw (small blind) showed [Qh Qd] and won ($89.20) with three of a kind, Queens



PokerStars Game #59938873854:  Hold'em No Limit ($0.50/$1.00) - 2009/07/01 0:25:40 ET
Table '/RZcOwpZpHQ+OwPwjsbnRw' 6-max Seat #4 is the button
Seat 2: dHC9PH9hdH3Ad2TD8ZxX0Q ($46.70 in chips)
Seat 3: OigyyiK+tTj1APPIAUmXDA ($74.15 in chips)
Seat 4: j7NIOHLZk7V2o9fOioO5ug ($108.90 in chips)
Seat 5: wx3sQGkVi2x9wJXuWNHPBw ($201.05 in chips)
Seat 6: XOIf9W+VAxhZqN+SYoyMKA ($255.30 in chips)
wx3sQGkVi2x9wJXuWNHPBw: posts small blind $0.50
XOIf9W+VAxhZqN+SYoyMKA: posts big blind $1
*** HOLE CARDS ***
dHC9PH9hdH3Ad2TD8ZxX0Q: folds
OigyyiK+tTj1APPIAUmXDA: folds
j7NIOHLZk7V2o9fOioO5ug: raises $2 to $3
wx3sQGkVi2x9wJXuWNHPBw: folds
Zboa6dColKGHBjLPUakZjw joins the table at seat #1
XOIf9W+VAxhZqN+SYoyMKA: folds
j7NIOHLZk7V2o9fOioO5ug collected $2.50 from pot
j7NIOHLZk7V2o9fOioO5ug: doesn't show hand
*** SUMMARY ***
Total pot $2.50 | Rake $0
Seat 2: dHC9PH9hdH3Ad2TD8ZxX0Q folded before Flop (didn't bet)
Seat 3: OigyyiK+tTj1APPIAUmXDA folded before Flop (didn't bet)
Seat 4: j7NIOHLZk7V2o9fOioO5ug (button) collected ($2.50)
Seat 5: wx3sQGkVi2x9wJXuWNHPBw (small blind) folded before Flop
Seat 6: XOIf9W+VAxhZqN+SYoyMKA (big blind) folded before Flop



PokerStars Game #59938873962:  Hold'em No Limit ($0.50/$1.00) - 2009/07/01 0:25:40 ET
Table 'MUPc8FEpe/nR0BKSeReX6Q' 6-max Seat #6 is the button
Seat 1: YsLQ3BAvgQHWXMAv3Wv6Hg ($100 in chips)
Seat 2: xAU6q2/cwmby2sxmA8VcmA ($100 in chips)
Seat 3: wx3sQGkVi2x9wJXuWNHPBw ($234.05 in chips)
Seat 4: ZA1bp6g8IwtTxkUE4eCjDQ ($116.80 in chips)
Seat 5: UBZQqpnJZdTYYY1FTb0rLA ($100 in chips)
Seat 6: oxnw0GLLpFanjhGkxfRSqA ($54.60 in chips)
YsLQ3BAvgQHWXMAv3Wv6Hg: posts small blind $0.50
xAU6q2/cwmby2sxmA8VcmA: posts big blind $1
*** HOLE CARDS ***
wx3sQGkVi2x9wJXuWNHPBw: folds
ZA1bp6g8IwtTxkUE4eCjDQ: folds
UBZQqpnJZdTYYY1FTb0rLA: folds
oxnw0GLLpFanjhGkxfRSqA: calls $1
YsLQ3BAvgQHWXMAv3Wv6Hg: folds
xAU6q2/cwmby2sxmA8VcmA: raises $4 to $5
oxnw0GLLpFanjhGkxfRSqA: folds
xAU6q2/cwmby2sxmA8VcmA collected $2.50 from pot
xAU6q2/cwmby2sxmA8VcmA: doesn't show hand
*** SUMMARY ***
Total pot $2.50 | Rake $0
Seat 1: YsLQ3BAvgQHWXMAv3Wv6Hg (small blind) folded before Flop
Seat 2: xAU6q2/cwmby2sxmA8VcmA (big blind) collected ($2.50)
Seat 3: wx3sQGkVi2x9wJXuWNHPBw folded before Flop (didn't bet)
Seat 4: ZA1bp6g8IwtTxkUE4eCjDQ folded before Flop (didn't bet)
Seat 5: UBZQqpnJZdTYYY1FTb0rLA folded before Flop (didn't bet)
Seat 6: oxnw0GLLpFanjhGkxfRSqA (button) folded before Flop



PokerStars Game #59938875758:  Hold'em No Limit ($0.50/$1.00) - 2009/07/01 0:25:42 ET
Table 'QSIig7BLMc9wY/rgBechzw' 6-max Seat #6 is the button
Seat 1: uuA9hpFU17U5/t4cvpbpBg ($36.40 in chips)
Seat 2: 0WjiuIT7/EolY1oOx1ngeA ($126.25 in chips)
Seat 3: +W6OnF033KNM2xH0fGj98Q ($111.70 in chips)
Seat 4: +uSzP8Jwnw7sKfQ4s66b7w ($47 in chips)
Seat 5: bvU2ZjpVnszLCFVeWbxePg ($112.20 in chips)
Seat 6: KpnW5CcJ4Mg6MeclfKmLrw ($130.75 in chips)
uuA9hpFU17U5/t4cvpbpBg: posts small blind $0.50
0WjiuIT7/EolY1oOx1ngeA: posts big blind $1
*** HOLE CARDS ***
+W6OnF033KNM2xH0fGj98Q: raises $2 to $3
+uSzP8Jwnw7sKfQ4s66b7w: folds
bvU2ZjpVnszLCFVeWbxePg: folds
KpnW5CcJ4Mg6MeclfKmLrw: folds
uuA9hpFU17U5/t4cvpbpBg: calls $2.50
0WjiuIT7/EolY1oOx1ngeA: folds
*** FLOP *** [Td 7s 2s]
uuA9hpFU17U5/t4cvpbpBg: bets $3
+W6OnF033KNM2xH0fGj98Q: calls $3
*** TURN *** [Td 7s 2s] [As]
uuA9hpFU17U5/t4cvpbpBg: checks
+W6OnF033KNM2xH0fGj98Q: checks
*** RIVER *** [Td 7s 2s As] [8h]
uuA9hpFU17U5/t4cvpbpBg: bets $4
+W6OnF033KNM2xH0fGj98Q: calls $4
*** SHOW DOWN ***
uuA9hpFU17U5/t4cvpbpBg: shows [Qh Qd] (a pair of Queens)
+W6OnF033KNM2xH0fGj98Q: shows [6h Ah] (a pair of Aces)
+W6OnF033KNM2xH0fGj98Q collected $20 from pot
*** SUMMARY ***
Total pot $21 | Rake $1
Board [Td 7s 2s As 8h]
Seat 1: uuA9hpFU17U5/t4cvpbpBg (small blind) showed [Qh Qd] and lost with a pair of Queens
Seat 2: 0WjiuIT7/EolY1oOx1ngeA (big blind) folded before Flop
Seat 3: +W6OnF033KNM2xH0fGj98Q showed [6h Ah] and won ($20) with a pair of Aces
Seat 4: +uSzP8Jwnw7sKfQ4s66b7w folded before Flop (didn't bet)
Seat 5: bvU2ZjpVnszLCFVeWbxePg folded before Flop (didn't bet)
Seat 6: KpnW5CcJ4Mg6MeclfKmLrw (button) folded before Flop (didn't bet)



PokerStars Game #59938876326:  Hold'em No Limit ($0.50/$1.00) - 2009/07/01 0:25:43 ET
Table 'tyUh+jyNvrceIQdKMJjQ2wZFWj23PMihdwrNWv41OG/Qeat #1 is the button
Seat 1: o8A5MUdudVKu+pAwgZOX2w ($220.55 in chips)
Seat 2: 6iVcnPw9a2oNG6sPQo3G6g ($99 in chips)
Seat 3: L9qfLYXrczhAPd/VckgsWw ($37.95 in chips)
Seat 4: TSuRyAHnUPCFjP7Z0rEE0w ($133.95 in chips)
Seat 5: j7NIOHLZk7V2o9fOioO5ug ($102.45 in chips)
Seat 6: YsLQ3BAvgQHWXMAv3Wv6Hg ($105.25 in chips)
6iVcnPw9a2oNG6sPQo3G6g: posts small blind $0.50
L9qfLYXrczhAPd/VckgsWw: posts big blind $1
*** HOLE CARDS ***
TSuRyAHnUPCFjP7Z0rEE0w: folds
j7NIOHLZk7V2o9fOioO5ug: folds
YsLQ3BAvgQHWXMAv3Wv6Hg: folds
o8A5MUdudVKu+pAwgZOX2w: calls $1
6iVcnPw9a2oNG6sPQo3G6g: folds
L9qfLYXrczhAPd/VckgsWw: checks
*** FLOP *** [9c As 6d]
L9qfLYXrczhAPd/VckgsWw: checks
o8A5MUdudVKu+pAwgZOX2w: checks
*** TURN *** [9c As 6d] [9d]
L9qfLYXrczhAPd/VckgsWw: checks
o8A5MUdudVKu+pAwgZOX2w: checks
*** RIVER *** [9c As 6d 9d] [Ad]
L9qfLYXrczhAPd/VckgsWw: bets $2
o8A5MUdudVKu+pAwgZOX2w: folds
L9qfLYXrczhAPd/VckgsWw collected $2.40 from pot
L9qfLYXrczhAPd/VckgsWw: doesn't show hand
*** SUMMARY ***
Total pot $2.50 | Rake $0.10
Board [9c As 6d 9d Ad]
Seat 1: o8A5MUdudVKu+pAwgZOX2w (button) folded on the River
Seat 2: 6iVcnPw9a2oNG6sPQo3G6g (small blind) folded before Flop
Seat 3: L9qfLYXrczhAPd/VckgsWw (big blind) collected ($2.40)
Seat 4: TSuRyAHnUPCFjP7Z0rEE0w folded before Flop (didn't bet)
Seat 5: j7NIOHLZk7V2o9fOioO5ug folded before Flop (didn't bet)
Seat 6: YsLQ3BAvgQHWXMAv3Wv6Hg folded before Flop (didn't bet)



PokerStars Game #59938876670:  Hold'em No Limit ($0.50/$1.00) - 2009/07/01 0:25:44 ET
Table '7Nl0ffnjeK44/vmeexh3MQ' 9-max Seat #9 is the button
Seat 1: s7D3Y+k4Cj4D1cXHv7oj+Q ($102.65 in chips)
Seat 2: kiakSwxX0e64PwYGAPQvLw ($33.35 in chips)
Seat 3: 200876 ($44.10 in chips)
Seat 4: NfbTuCZ2txeWuV3hP7t0TA ($100 in chips)
Seat 5: bL+QVeDcuEdzMGAGg2XJHg ($107.10 in chips)
Seat 6: FVs16t7GgfWgQWt4JxsObQ ($13.55 in chips)
Seat 7: knewtTmBc4Tc0z/5tAABYQ ($106.50 in chips)
Seat 8: zanka7aAZkigmZpfopXxxA ($223.50 in chips)
Seat 9: ouwUBGRKnKK9uhn1G4Lf+A ($98.50 in chips)
s7D3Y+k4Cj4D1cXHv7oj+Q: posts small blind $0.50
kiakSwxX0e64PwYGAPQvLw: posts big blind $1
*** HOLE CARDS ***
200876: folds
NfbTuCZ2txeWuV3hP7t0TA: folds
bL+QVeDcuEdzMGAGg2XJHg: calls $1
FVs16t7GgfWgQWt4JxsObQ: calls $1
knewtTmBc4Tc0z/5tAABYQ: folds
zanka7aAZkigmZpfopXxxA: folds
ouwUBGRKnKK9uhn1G4Lf+A: folds
s7D3Y+k4Cj4D1cXHv7oj+Q: raises $3 to $4
kiakSwxX0e64PwYGAPQvLw: folds
bL+QVeDcuEdzMGAGg2XJHg: calls $3
FVs16t7GgfWgQWt4JxsObQ: calls $3
*** FLOP *** [2c 4c 4d]
s7D3Y+k4Cj4D1cXHv7oj+Q: checks
bL+QVeDcuEdzMGAGg2XJHg: bets $10
FVs16t7GgfWgQWt4JxsObQ: folds
s7D3Y+k4Cj4D1cXHv7oj+Q: folds
bL+QVeDcuEdzMGAGg2XJHg collected $12.35 from pot
bL+QVeDcuEdzMGAGg2XJHg: doesn't show hand
*** SUMMARY ***
Total pot $13 | Rake $0.65
Board [2c 4c 4d]
Seat 1: s7D3Y+k4Cj4D1cXHv7oj+Q (small blind) folded on the Flop
Seat 2: kiakSwxX0e64PwYGAPQvLw (big blind) folded before Flop
Seat 3: 200876 folded before Flop (didn't bet)
Seat 4: NfbTuCZ2txeWuV3hP7t0TA folded before Flop (didn't bet)
Seat 5: bL+QVeDcuEdzMGAGg2XJHg collected ($12.35)
Seat 6: FVs16t7GgfWgQWt4JxsObQ folded on the Flop
Seat 7: knewtTmBc4Tc0z/5tAABYQ folded before Flop (didn't bet)
Seat 8: zanka7aAZkigmZpfopXxxA folded before Flop (didn't bet)
Seat 9: ouwUBGRKnKK9uhn1G4Lf+A (button) folded before Flop (didn't bet)



PokerStars Game #59938877880:  Hold'em No Limit ($0.50/$1.00) - 2009/07/01 0:25:46 ET
Table 'pHrhryH8jPNdQfY62f8v+g' 6-max Seat #6 is the button
Seat 1: BdbmJTZZ47quA9vUWwXtlw ($67.25 in chips)
Seat 2: RqgF7gRoKgRNW8Zoi1ty4A ($118 in chips)
Seat 3: 0WjiuIT7/EolY1oOx1ngeA ($101.50 in chips)
Seat 4: wenbG7TaM3H7h5kn78OFNw ($57.50 in chips)
Seat 5: Gp2euK/nqF6qXKe7U+jOfw ($117.15 in chips)
Seat 6: xAU6q2/cwmby2sxmA8VcmA ($100 in chips)
BdbmJTZZ47quA9vUWwXtlw: posts small blind $0.50
RqgF7gRoKgRNW8Zoi1ty4A: posts big blind $1
*** HOLE CARDS ***
0WjiuIT7/EolY1oOx1ngeA: folds
wenbG7TaM3H7h5kn78OFNw: folds
Gp2euK/nqF6qXKe7U+jOfw: folds
xAU6q2/cwmby2sxmA8VcmA: folds
BdbmJTZZ47quA9vUWwXtlw: folds
RqgF7gRoKgRNW8Zoi1ty4A collected $1 from pot
*** SUMMARY ***
Total pot $1 | Rake $0
Seat 1: BdbmJTZZ47quA9vUWwXtlw (small blind) folded before Flop
Seat 2: RqgF7gRoKgRNW8Zoi1ty4A (big blind) collected ($1)
Seat 3: 0WjiuIT7/EolY1oOx1ngeA folded before Flop (didn't bet)
Seat 4: wenbG7TaM3H7h5kn78OFNw folded before Flop (didn't bet)
Seat 5: Gp2euK/nqF6qXKe7U+jOfw folded before Flop (didn't bet)
Seat 6: xAU6q2/cwmby2sxmA8VcmA (button) folded before Flop (didn't bet)



PokerStars Game #59938879932:  Hold'em No Limit ($0.50/$1.00) - 2009/07/01 0:25:49 ET
Table 'GxCPo/gd3OSthkYrAxJngg' 6-max Seat #6 is the button
Seat 1: sH8BpAFP+jGFxCgVpD1Lew ($279.95 in chips)
Seat 2: YExX2paeIHrmfIwV1ivM/w ($85.20 in chips)
Seat 3: o6plE+MSW4XFNTeONe16xg ($20 in chips)
Seat 4: YMJG+F++3Aj6P8dAWda5fw ($106.65 in chips)
Seat 5: G5ZSSN6RSON3gkNvk/SmYg ($100 in chips)
Seat 6: sS9IXedL3MiRmpVXhAILhw ($97 in chips)
sH8BpAFP+jGFxCgVpD1Lew: posts small blind $0.50
YExX2paeIHrmfIwV1ivM/w: posts big blind $1
o6plE+MSW4XFNTeONe16xg: posts big blind $1
*** HOLE CARDS ***
o6plE+MSW4XFNTeONe16xg: checks
YMJG+F++3Aj6P8dAWda5fw: raises $2 to $3
G5ZSSN6RSON3gkNvk/SmYg: folds
sS9IXedL3MiRmpVXhAILhw: folds
sH8BpAFP+jGFxCgVpD1Lew: folds
YExX2paeIHrmfIwV1ivM/w: folds
o6plE+MSW4XFNTeONe16xg: folds
YMJG+F++3Aj6P8dAWda5fw collected $3.50 from pot
*** SUMMARY ***
Total pot $3.50 | Rake $0
Seat 1: sH8BpAFP+jGFxCgVpD1Lew (small blind) folded before Flop
Seat 2: YExX2paeIHrmfIwV1ivM/w (big blind) folded before Flop
Seat 3: o6plE+MSW4XFNTeONe16xg folded before Flop
Seat 4: YMJG+F++3Aj6P8dAWda5fw collected ($3.50)
Seat 5: G5ZSSN6RSON3gkNvk/SmYg folded before Flop (didn't bet)
Seat 6: sS9IXedL3MiRmpVXhAILhw (button) folded before Flop (didn't bet)



PokerStars Game #59938881220:  Hold'em No Limit ($0.50/$1.00) - 2009/07/01 0:25:51 ET
Table 'eU3bWpDDg3Z+9R4m4iVmog' 6-max Seat #1 is the button
Seat 1: TSuRyAHnUPCFjP7Z0rEE0w ($177.50 in chips)
Seat 2: 8CAoOzhmB8n3nRFf3V4BTg ($141.45 in chips)
Seat 3: U6tnjwZRpTnM+YkqkCjwyQ ($155.55 in chips)
Seat 4: GDVIsbEJ/DOJsMKE4Asz0A ($98 in chips)
Seat 5: QHvTZcrKe6+maWUfVjP29Q ($102 in chips)
Seat 6: hpxXcmRkXXI9HE5+5/j/0Q ($100 in chips)
8CAoOzhmB8n3nRFf3V4BTg: posts small blind $0.50
U6tnjwZRpTnM+YkqkCjwyQ: posts big blind $1
*** HOLE CARDS ***
GDVIsbEJ/DOJsMKE4Asz0A: folds
QHvTZcrKe6+maWUfVjP29Q: folds
hpxXcmRkXXI9HE5+5/j/0Q: folds
TSuRyAHnUPCFjP7Z0rEE0w: folds
8CAoOzhmB8n3nRFf3V4BTg: calls $0.50
U6tnjwZRpTnM+YkqkCjwyQ: checks
*** FLOP *** [As Qc 3c]
8CAoOzhmB8n3nRFf3V4BTg: checks
U6tnjwZRpTnM+YkqkCjwyQ: bets $2
8CAoOzhmB8n3nRFf3V4BTg: folds
U6tnjwZRpTnM+YkqkCjwyQ collected $1.90 from pot
*** SUMMARY ***
Total pot $2 | Rake $0.10
Board [As Qc 3c]
Seat 1: TSuRyAHnUPCFjP7Z0rEE0w (button) folded before Flop (didn't bet)
Seat 2: 8CAoOzhmB8n3nRFf3V4BTg (small blind) folded on the Flop
Seat 3: U6tnjwZRpTnM+YkqkCjwyQ (big blind) collected ($1.90)
Seat 4: GDVIsbEJ/DOJsMKE4Asz0A folded before Flop (didn't bet)
Seat 5: QHvTZcrKe6+maWUfVjP29Q folded before Flop (didn't bet)
Seat 6: hpxXcmRkXXI9HE5+5/j/0Q folded before Flop (didn't bet)



PokerStars Game #59938881870:  Hold'em No Limit ($0.50/$1.00) - 2009/07/01 0:25:52 ET
Table 'vs/5jr6ciwjVQ5+Soc+u2A' 6-max Seat #6 is the button
Seat 2: XOIf9W+VAxhZqN+SYoyMKA ($120.80 in chips)
Seat 3: G5ZSSN6RSON3gkNvk/SmYg ($100.70 in chips)
Seat 4: KpnW5CcJ4Mg6MeclfKmLrw ($101.65 in chips)
Seat 5: 7Vc9JmGFQwMRh5Tj9ui5Lw ($93.15 in chips)
Seat 6: QHvTZcrKe6+maWUfVjP29Q ($105.50 in chips)
XOIf9W+VAxhZqN+SYoyMKA: posts small blind $0.50
G5ZSSN6RSON3gkNvk/SmYg: posts big blind $1
*** HOLE CARDS ***
KpnW5CcJ4Mg6MeclfKmLrw: raises $3 to $4
7Vc9JmGFQwMRh5Tj9ui5Lw: calls $4
QHvTZcrKe6+maWUfVjP29Q: folds
XOIf9W+VAxhZqN+SYoyMKA: folds
G5ZSSN6RSON3gkNvk/SmYg: calls $3
*** FLOP *** [Jc 4s Kh]
G5ZSSN6RSON3gkNvk/SmYg: checks
KpnW5CcJ4Mg6MeclfKmLrw: bets $8
7Vc9JmGFQwMRh5Tj9ui5Lw: calls $8
G5ZSSN6RSON3gkNvk/SmYg: folds
*** TURN *** [Jc 4s Kh] [Ts]
KpnW5CcJ4Mg6MeclfKmLrw: checks
7Vc9JmGFQwMRh5Tj9ui5Lw: checks
*** RIVER *** [Jc 4s Kh Ts] [6d]
KpnW5CcJ4Mg6MeclfKmLrw: bets $20
7Vc9JmGFQwMRh5Tj9ui5Lw: folds
KpnW5CcJ4Mg6MeclfKmLrw collected $27.15 from pot
KpnW5CcJ4Mg6MeclfKmLrw: doesn't show hand
*** SUMMARY ***
Total pot $28.50 | Rake $1.35
Board [Jc 4s Kh Ts 6d]
Seat 2: XOIf9W+VAxhZqN+SYoyMKA (small blind) folded before Flop
Seat 3: G5ZSSN6RSON3gkNvk/SmYg (big blind) folded on the Flop
Seat 4: KpnW5CcJ4Mg6MeclfKmLrw collected ($27.15)
Seat 5: 7Vc9JmGFQwMRh5Tj9ui5Lw folded on the River
Seat 6: QHvTZcrKe6+maWUfVjP29Q (button) folded before Flop (didn't bet)



PokerStars Game #59938882978:  Hold'em No Limit ($0.50/$1.00) - 2009/07/01 0:25:53 ET
Table '+cA8mcmhaedZ7YcrDdhmeQ' 6-max Seat #3 is the button
Seat 1: lsLuWlcPA3Rh7kJVLzMh0Q ($234 in chips)
Seat 2: trnpu4tPju3BU8W0wQQaiQ ($103.95 in chips)
Seat 3: 0WjiuIT7/EolY1oOx1ngeA ($116.30 in chips)
Seat 5: 6WyjEXOToimYmtLdqIgHYQ ($60.50 in chips)
Seat 6: YfsTQsY/fxb+YqbdclTHuw ($113.25 in chips)
6WyjEXOToimYmtLdqIgHYQ: posts small blind $0.50
YfsTQsY/fxb+YqbdclTHuw: posts big blind $1
*** HOLE CARDS ***
lsLuWlcPA3Rh7kJVLzMh0Q: folds
trnpu4tPju3BU8W0wQQaiQ: raises $3 to $4
0WjiuIT7/EolY1oOx1ngeA: folds
6WyjEXOToimYmtLdqIgHYQ: folds
YfsTQsY/fxb+YqbdclTHuw: raises $3 to $7
LjL3AIERHn559yyW1mTUYQ joins the table at seat #4
trnpu4tPju3BU8W0wQQaiQ: raises $8 to $15
YfsTQsY/fxb+YqbdclTHuw: calls $8
*** FLOP *** [9s 9c 3h]
YfsTQsY/fxb+YqbdclTHuw: checks
trnpu4tPju3BU8W0wQQaiQ: bets $25
YfsTQsY/fxb+YqbdclTHuw: folds
trnpu4tPju3BU8W0wQQaiQ collected $29 from pot
*** SUMMARY ***
Total pot $30.50 | Rake $1.50
Board [9s 9c 3h]
Seat 1: lsLuWlcPA3Rh7kJVLzMh0Q folded before Flop (didn't bet)
Seat 2: trnpu4tPju3BU8W0wQQaiQ collected ($29)
Seat 3: 0WjiuIT7/EolY1oOx1ngeA (button) folded before Flop (didn't bet)
Seat 5: 6WyjEXOToimYmtLdqIgHYQ (small blind) folded before Flop
Seat 6: YfsTQsY/fxb+YqbdclTHuw (big blind) folded on the Flop



PokerStars Game #59938884384:  Hold'em No Limit ($0.50/$1.00) - 2009/07/01 0:25:55 ET
Table '/FUb199IViHMJHi5YWmeuQ' 9-max Seat #6 is the button
Seat 1: TZcz9MEWDA+WydgGruqqbw ($100 in chips)
Seat 2: FL3MrLspcF23LYvC4ipBOA ($138.75 in chips)
Seat 3: qN483QJ1NvHbdIZB7J4ARw ($73.75 in chips)
Seat 4: qheQay5YvP2DMAb3OUSxtw ($107.30 in chips)
Seat 5: +za1iHiRgVo4OcAz0SOZqw ($15.45 in chips)
Seat 6: ccFf7Q4z1cTGQmeoYiWEfw ($38.50 in chips)
Seat 7: bLbSOSmSOnqE0iTcH/5dxA ($100 in chips)
Seat 8: QIWvt0R766g8KfH0vl1s0A ($49.10 in chips)
Seat 9: knewtTmBc4Tc0z/5tAABYQ ($124.25 in chips)
bLbSOSmSOnqE0iTcH/5dxA: posts small blind $0.50
QIWvt0R766g8KfH0vl1s0A: posts big blind $1
*** HOLE CARDS ***
knewtTmBc4Tc0z/5tAABYQ: folds
TZcz9MEWDA+WydgGruqqbw: folds
FL3MrLspcF23LYvC4ipBOA: folds
qN483QJ1NvHbdIZB7J4ARw: folds
qheQay5YvP2DMAb3OUSxtw: folds
+za1iHiRgVo4OcAz0SOZqw: folds
ccFf7Q4z1cTGQmeoYiWEfw: folds
bLbSOSmSOnqE0iTcH/5dxA: folds
QIWvt0R766g8KfH0vl1s0A collected $1 from pot
*** SUMMARY ***
Total pot $1 | Rake $0
Seat 1: TZcz9MEWDA+WydgGruqqbw folded before Flop (didn't bet)
Seat 2: FL3MrLspcF23LYvC4ipBOA folded before Flop (didn't bet)
Seat 3: qN483QJ1NvHbdIZB7J4ARw folded before Flop (didn't bet)
Seat 4: qheQay5YvP2DMAb3OUSxtw folded before Flop (didn't bet)
Seat 5: +za1iHiRgVo4OcAz0SOZqw folded before Flop (didn't bet)
Seat 6: ccFf7Q4z1cTGQmeoYiWEfw (button) folded before Flop (didn't bet)
Seat 7: bLbSOSmSOnqE0iTcH/5dxA (small blind) folded before Flop
Seat 8: QIWvt0R766g8KfH0vl1s0A (big blind) collected ($1)
Seat 9: knewtTmBc4Tc0z/5tAABYQ folded before Flop (didn't bet)



PokerStars Game #59938885674:  Hold'em No Limit ($0.50/$1.00) - 2009/07/01 0:25:57 ET
Table '/RZcOwpZpHQ+OwPwjsbnRw' 6-max Seat #5 is the button
Seat 1: Zboa6dColKGHBjLPUakZjw ($50 in chips)
Seat 2: dHC9PH9hdH3Ad2TD8ZxX0Q ($46.70 in chips)
Seat 3: OigyyiK+tTj1APPIAUmXDA ($74.15 in chips)
Seat 4: j7NIOHLZk7V2o9fOioO5ug ($110.40 in chips)
Seat 5: wx3sQGkVi2x9wJXuWNHPBw ($200.55 in chips)
Seat 6: XOIf9W+VAxhZqN+SYoyMKA ($254.30 in chips)
XOIf9W+VAxhZqN+SYoyMKA: posts small blind $0.50
Zboa6dColKGHBjLPUakZjw: posts big blind $1
*** HOLE CARDS ***
dHC9PH9hdH3Ad2TD8ZxX0Q: raises $1 to $2
OigyyiK+tTj1APPIAUmXDA: folds
j7NIOHLZk7V2o9fOioO5ug: folds
wx3sQGkVi2x9wJXuWNHPBw: folds
XOIf9W+VAxhZqN+SYoyMKA: folds
Zboa6dColKGHBjLPUakZjw: calls $1
*** FLOP *** [5s 3s 9c]
Zboa6dColKGHBjLPUakZjw: bets $2
dHC9PH9hdH3Ad2TD8ZxX0Q: calls $2
*** TURN *** [5s 3s 9c] [8s]
Zboa6dColKGHBjLPUakZjw: bets $2
dHC9PH9hdH3Ad2TD8ZxX0Q: raises $6 to $8
Zboa6dColKGHBjLPUakZjw: folds
dHC9PH9hdH3Ad2TD8ZxX0Q collected $11.90 from pot
*** SUMMARY ***
Total pot $12.50 | Rake $0.60
Board [5s 3s 9c 8s]
Seat 1: Zboa6dColKGHBjLPUakZjw (big blind) folded on the Turn
Seat 2: dHC9PH9hdH3Ad2TD8ZxX0Q collected ($11.90)
Seat 3: OigyyiK+tTj1APPIAUmXDA folded before Flop (didn't bet)
Seat 4: j7NIOHLZk7V2o9fOioO5ug folded before Flop (didn't bet)
Seat 5: wx3sQGkVi2x9wJXuWNHPBw (button) folded before Flop (didn't bet)
Seat 6: XOIf9W+VAxhZqN+SYoyMKA (small blind) folded before Flop



PokerStars Game #59938887776:  Hold'em No Limit ($0.50/$1.00) - 2009/07/01 0:26:00 ET
Table 'MUPc8FEpe/nR0BKSeReX6Q' 6-max Seat #1 is the button
Seat 1: YsLQ3BAvgQHWXMAv3Wv6Hg ($100 in chips)
Seat 2: xAU6q2/cwmby2sxmA8VcmA ($101.50 in chips)
Seat 3: wx3sQGkVi2x9wJXuWNHPBw ($234.05 in chips)
Seat 4: ZA1bp6g8IwtTxkUE4eCjDQ ($116.80 in chips)
Seat 5: UBZQqpnJZdTYYY1FTb0rLA ($100 in chips)
Seat 6: oxnw0GLLpFanjhGkxfRSqA ($53.60 in chips)
xAU6q2/cwmby2sxmA8VcmA: posts small blind $0.50
wx3sQGkVi2x9wJXuWNHPBw: posts big blind $1
*** HOLE CARDS ***
ZA1bp6g8IwtTxkUE4eCjDQ: folds
UBZQqpnJZdTYYY1FTb0rLA: folds
oxnw0GLLpFanjhGkxfRSqA: folds
YsLQ3BAvgQHWXMAv3Wv6Hg: folds
xAU6q2/cwmby2sxmA8VcmA: folds
wx3sQGkVi2x9wJXuWNHPBw collected $1 from pot
*** SUMMARY ***
Total pot $1 | Rake $0
Seat 1: YsLQ3BAvgQHWXMAv3Wv6Hg (button) folded before Flop (didn't bet)
Seat 2: xAU6q2/cwmby2sxmA8VcmA (small blind) folded before Flop
Seat 3: wx3sQGkVi2x9wJXuWNHPBw (big blind) collected ($1)
Seat 4: ZA1bp6g8IwtTxkUE4eCjDQ folded before Flop (didn't bet)
Seat 5: UBZQqpnJZdTYYY1FTb0rLA folded before Flop (didn't bet)
Seat 6: oxnw0GLLpFanjhGkxfRSqA folded before Flop (didn't bet)



PokerStars Game #59938888036:  Hold'em No Limit ($0.50/$1.00) - 2009/07/01 0:26:01 ET
Table 'ZFWj23PMihdwrNWv41OG/Q' 9-max Seat #3 is the button
Seat 1: yAbu2QsRPVcjPbqlf/jDxw ($101.80 in chips)
Seat 2: ARfmgHcEUKh68laBZy4veA ($55.25 in chips)
Seat 3: G9Fo2TZCN7HI43Po4zSN3A ($102 in chips)
Seat 4: PEmogYqKpuv0ozeBbXL+7Q ($35.50 in chips)
Seat 5: tkdBeXTJlFsZdioidNqLow ($60 in chips)
Seat 6: tjhwe1V98x2spSoUQER3HQ ($100 in chips)
Seat 7: wIZ377kjl2fHFGnS93o6bw ($43.95 in chips)
Seat 8: knewtTmBc4Tc0z/5tAABYQ ($107.50 in chips)
Seat 9: l4m/wWPs22DSP5xpszjXKA ($20 in chips)
PEmogYqKpuv0ozeBbXL+7Q: posts small blind $0.50
tkdBeXTJlFsZdioidNqLow: posts big blind $1
l4m/wWPs22DSP5xpszjXKA: posts big blind $1
*** HOLE CARDS ***
tjhwe1V98x2spSoUQER3HQ: folds
wIZ377kjl2fHFGnS93o6bw: calls $1
knewtTmBc4Tc0z/5tAABYQ: folds
l4m/wWPs22DSP5xpszjXKA: raises $4 to $5
yAbu2QsRPVcjPbqlf/jDxw: folds
ARfmgHcEUKh68laBZy4veA: calls $5
G9Fo2TZCN7HI43Po4zSN3A: folds
PEmogYqKpuv0ozeBbXL+7Q: folds
tkdBeXTJlFsZdioidNqLow: folds
wIZ377kjl2fHFGnS93o6bw: calls $4
*** FLOP *** [4d Kc 2s]
wIZ377kjl2fHFGnS93o6bw: checks
l4m/wWPs22DSP5xpszjXKA: checks
ARfmgHcEUKh68laBZy4veA: checks
*** TURN *** [4d Kc 2s] [7c]
wIZ377kjl2fHFGnS93o6bw: bets $8
l4m/wWPs22DSP5xpszjXKA: raises $7 to $15 and is all-in
ARfmgHcEUKh68laBZy4veA: folds
wIZ377kjl2fHFGnS93o6bw: calls $7
*** RIVER *** [4d Kc 2s 7c] [5d]
*** SHOW DOWN ***
wIZ377kjl2fHFGnS93o6bw: shows [8s 8h] (a pair of Eights)
l4m/wWPs22DSP5xpszjXKA: shows [Ad Ks] (a pair of Kings)
l4m/wWPs22DSP5xpszjXKA collected $44.25 from pot
*** SUMMARY ***
Total pot $46.50 | Rake $2.25
Board [4d Kc 2s 7c 5d]
Seat 1: yAbu2QsRPVcjPbqlf/jDxw folded before Flop (didn't bet)
Seat 2: ARfmgHcEUKh68laBZy4veA folded on the Turn
Seat 3: G9Fo2TZCN7HI43Po4zSN3A (button) folded before Flop (didn't bet)
Seat 4: PEmogYqKpuv0ozeBbXL+7Q (small blind) folded before Flop
Seat 5: tkdBeXTJlFsZdioidNqLow (big blind) folded before Flop
Seat 6: tjhwe1V98x2spSoUQER3HQ folded before Flop (didn't bet)
Seat 7: wIZ377kjl2fHFGnS93o6bw showed [8s 8h] and lost with a pair of Eights
Seat 8: knewtTmBc4Tc0z/5tAABYQ folded before Flop (didn't bet)
Seat 9: l4m/wWPs22DSP5xpszjXKA showed [Ad Ks] and won ($44.25) with a pair of Kings



PokerStars Game #59938888724:  Hold'em No Limit ($0.50/$1.00) - 2009/07/01 0:26:02 ET
Table 'O96CPOtvMBWP6kzuYDfdFA' 6-max Seat #1 is the button
Seat 1: yl9aRDw7k/ieGiDoJVy+/w ($40.05 in chips)
Seat 2: vTUNrd/7qIOJpW0suEu5hQ ($209.90 in chips)
Seat 3: V89DGjxE171oPREEbAXiyg ($27.75 in chips)
Seat 5: wRxiu9OJzvvN84OYWW9jxQ ($133.25 in chips)
Seat 6: xNKcQzD9+/iHmtJn4vYq9w ($100.60 in chips)
vTUNrd/7qIOJpW0suEu5hQ: posts small blind $0.50
V89DGjxE171oPREEbAXiyg: posts big blind $1
*** HOLE CARDS ***
wRxiu9OJzvvN84OYWW9jxQ: folds
xNKcQzD9+/iHmtJn4vYq9w: raises $2 to $3
wRxiu9OJzvvN84OYWW9jxQ said, "lol"
yl9aRDw7k/ieGiDoJVy+/w: raises $5 to $8
vTUNrd/7qIOJpW0suEu5hQ: folds
V89DGjxE171oPREEbAXiyg: folds
xNKcQzD9+/iHmtJn4vYq9w: calls $5
*** FLOP *** [Ks 5h 3c]
xNKcQzD9+/iHmtJn4vYq9w: checks
yl9aRDw7k/ieGiDoJVy+/w: checks
*** TURN *** [Ks 5h 3c] [Qs]
xNKcQzD9+/iHmtJn4vYq9w: checks
yl9aRDw7k/ieGiDoJVy+/w: bets $10
xNKcQzD9+/iHmtJn4vYq9w: calls $10
*** RIVER *** [Ks 5h 3c Qs] [Jc]
xNKcQzD9+/iHmtJn4vYq9w: bets $27
yl9aRDw7k/ieGiDoJVy+/w: calls $22.05 and is all-in
*** SHOW DOWN ***
xNKcQzD9+/iHmtJn4vYq9w: shows [Jh Qc] (two pair, Queens and Jacks)
yl9aRDw7k/ieGiDoJVy+/w: mucks hand
wRxiu9OJzvvN84OYWW9jxQ said, "hahahahahahahahahahahaha"
xNKcQzD9+/iHmtJn4vYq9w collected $79.60 from pot
*** SUMMARY ***
Total pot $81.60 | Rake $2
Board [Ks 5h 3c Qs Jc]
Seat 1: yl9aRDw7k/ieGiDoJVy+/w (button) mucked
Seat 2: vTUNrd/7qIOJpW0suEu5hQ (small blind) folded before Flop
Seat 3: V89DGjxE171oPREEbAXiyg (big blind) folded before Flop
Seat 5: wRxiu9OJzvvN84OYWW9jxQ folded before Flop (didn't bet)
Seat 6: xNKcQzD9+/iHmtJn4vYq9w showed [Jh Qc] and won ($79.60) with two pair, Queens and Jacks



PokerStars Game #59938889770:  Hold'em No Limit ($0.50/$1.00) - 2009/07/01 0:26:03 ET
Table 'tLrtq7gDzxEvckNAI1OS5Q' 6-max Seat #6 is the button
Seat 1: GisIe1kcC9q/xV6ifsTjgA ($150.35 in chips)
Seat 2: qsObMEIlRO22OlS867m/lw ($19.30 in chips)
Seat 3: TPZ+m9x+lwoKpv7TMfAUWA ($319.25 in chips)
Seat 4: KOG8rG51mOvIoY96zF3kvw ($163.30 in chips)
Seat 5: OGMLOcTNYZXZU81au7ztUw ($166.45 in chips)
Seat 6: XUk5GQsfNFpHvaToDZ0rZA ($43.45 in chips)
GisIe1kcC9q/xV6ifsTjgA: posts small blind $0.50
qsObMEIlRO22OlS867m/lw: posts big blind $1
*** HOLE CARDS ***
TPZ+m9x+lwoKpv7TMfAUWA: raises $2 to $3
KOG8rG51mOvIoY96zF3kvw: folds
OGMLOcTNYZXZU81au7ztUw: folds
XUk5GQsfNFpHvaToDZ0rZA: folds
GisIe1kcC9q/xV6ifsTjgA: calls $2.50
qsObMEIlRO22OlS867m/lw: calls $2
*** FLOP *** [8c Qc 5c]
GisIe1kcC9q/xV6ifsTjgA: checks
qsObMEIlRO22OlS867m/lw: checks
TPZ+m9x+lwoKpv7TMfAUWA: bets $5
GisIe1kcC9q/xV6ifsTjgA: folds
qsObMEIlRO22OlS867m/lw: folds
TPZ+m9x+lwoKpv7TMfAUWA collected $8.55 from pot
*** SUMMARY ***
Total pot $9 | Rake $0.45
Board [8c Qc 5c]
Seat 1: GisIe1kcC9q/xV6ifsTjgA (small blind) folded on the Flop
Seat 2: qsObMEIlRO22OlS867m/lw (big blind) folded on the Flop
Seat 3: TPZ+m9x+lwoKpv7TMfAUWA collected ($8.55)
Seat 4: KOG8rG51mOvIoY96zF3kvw folded before Flop (didn't bet)
Seat 5: OGMLOcTNYZXZU81au7ztUw folded before Flop (didn't bet)
Seat 6: XUk5GQsfNFpHvaToDZ0rZA (button) folded before Flop (didn't bet)



PokerStars Game #59938891796:  Hold'em No Limit ($0.50/$1.00) - 2009/07/01 0:26:06 ET
Table 'U9zqzC8f3oTJ2ShXFgSSOA' 6-max Seat #3 is the button
Seat 1: tS9JHB1h+FQ++qu8RwRNgg ($35.10 in chips)
Seat 2: U2CWBTv29qdCbj8RNF2sIw ($100 in chips)
Seat 3: yfXek8iJ7O4CFyqXrtGcfg ($42.55 in chips)
Seat 4: 33q95we0Etwgrm6guQGncw ($72.90 in chips)
Seat 5: KfwW5us6tydK81NYTtK1gw ($207.40 in chips)
Seat 6: aIxzFKdtpDSkUePKZy/niQ ($41.40 in chips)
33q95we0Etwgrm6guQGncw: posts small blind $0.50
KfwW5us6tydK81NYTtK1gw: posts big blind $1
*** HOLE CARDS ***
aIxzFKdtpDSkUePKZy/niQ: folds
tS9JHB1h+FQ++qu8RwRNgg: folds
U2CWBTv29qdCbj8RNF2sIw: raises $2 to $3
yfXek8iJ7O4CFyqXrtGcfg: folds
33q95we0Etwgrm6guQGncw: folds
KfwW5us6tydK81NYTtK1gw: calls $2
*** FLOP *** [Kc 6s Ac]
KfwW5us6tydK81NYTtK1gw: checks
U2CWBTv29qdCbj8RNF2sIw: bets $4
KfwW5us6tydK81NYTtK1gw: raises $8 to $12
U2CWBTv29qdCbj8RNF2sIw: raises $85 to $97 and is all-in
KfwW5us6tydK81NYTtK1gw: calls $85
*** TURN *** [Kc 6s Ac] [4c]
*** RIVER *** [Kc 6s Ac 4c] [Jh]
*** SHOW DOWN ***
KfwW5us6tydK81NYTtK1gw: shows [Tc Jc] (a flush, Ace high)
U2CWBTv29qdCbj8RNF2sIw: mucks hand
KfwW5us6tydK81NYTtK1gw collected $197.50 from pot
*** SUMMARY ***
Total pot $200.50 | Rake $3
Board [Kc 6s Ac 4c Jh]
Seat 1: tS9JHB1h+FQ++qu8RwRNgg folded before Flop (didn't bet)
Seat 2: U2CWBTv29qdCbj8RNF2sIw mucked
Seat 3: yfXek8iJ7O4CFyqXrtGcfg (button) folded before Flop (didn't bet)
Seat 4: 33q95we0Etwgrm6guQGncw (small blind) folded before Flop
Seat 5: KfwW5us6tydK81NYTtK1gw (big blind) showed [Tc Jc] and won ($197.50) with a flush, Ace high
Seat 6: aIxzFKdtpDSkUePKZy/niQ folded before Flop (didn't bet)



PokerStars Game #59938892306:  Hold'em No Limit ($0.50/$1.00) - 2009/07/01 0:26:07 ET
Table 'aWHveb63HkbTmOGHOxjBkQ' 2-max Seat #2 is the button
Seat 1: xy2MQKoHoCZZIudmw8Xbow ($261.40 in chips)
Seat 2: xstEKavv3YDxpUnU4e9qAQ ($110.10 in chips)
xstEKavv3YDxpUnU4e9qAQ: posts small blind $0.50
xy2MQKoHoCZZIudmw8Xbow: posts big blind $1
*** HOLE CARDS ***
xstEKavv3YDxpUnU4e9qAQ: folds
xy2MQKoHoCZZIudmw8Xbow collected $1 from pot
xy2MQKoHoCZZIudmw8Xbow: doesn't show hand
*** SUMMARY ***
Total pot $1 | Rake $0
Seat 1: xy2MQKoHoCZZIudmw8Xbow (big blind) collected ($1)
Seat 2: xstEKavv3YDxpUnU4e9qAQ (button) (small blind) folded before Flop



PokerStars Game #59938892102:  Hold'em No Limit ($0.50/$1.00) - 2009/07/01 0:26:07 ET
Table 'rmZfTK+oSebeUPJNbWhdAA' 6-max Seat #4 is the button
Seat 1: xAU6q2/cwmby2sxmA8VcmA ($100 in chips)
Seat 2: OigyyiK+tTj1APPIAUmXDA ($92.55 in chips)
Seat 3: 9yjOzGERLaEZS8CZ6YNHFg ($48.80 in chips)
Seat 4: OGMLOcTNYZXZU81au7ztUw ($122.65 in chips)
Seat 6: j7NIOHLZk7V2o9fOioO5ug ($107 in chips)
+xW7QemQU0Fxs+4TnqBRow will be allowed to play after the button
j7NIOHLZk7V2o9fOioO5ug: posts small blind $0.50
xAU6q2/cwmby2sxmA8VcmA: posts big blind $1
*** HOLE CARDS ***
OigyyiK+tTj1APPIAUmXDA: folds
9yjOzGERLaEZS8CZ6YNHFg: folds
OGMLOcTNYZXZU81au7ztUw: folds
j7NIOHLZk7V2o9fOioO5ug: folds
xAU6q2/cwmby2sxmA8VcmA collected $1 from pot
xAU6q2/cwmby2sxmA8VcmA: doesn't show hand
*** SUMMARY ***
Total pot $1 | Rake $0
Seat 1: xAU6q2/cwmby2sxmA8VcmA (big blind) collected ($1)
Seat 2: OigyyiK+tTj1APPIAUmXDA folded before Flop (didn't bet)
Seat 3: 9yjOzGERLaEZS8CZ6YNHFg folded before Flop (didn't bet)
Seat 4: OGMLOcTNYZXZU81au7ztUw (button) folded before Flop (didn't bet)
Seat 6: j7NIOHLZk7V2o9fOioO5ug (small blind) folded before Flop



PokerStars Game #59938892282:  Hold'em No Limit ($0.50/$1.00) - 2009/07/01 0:26:07 ET
Table 'b/mVBMBBjZR4F+Jsv8cuYA' 9-max Seat #9 is the button
Seat 2: HPmAhANyB1+4MGzYS9i5Wg ($33.60 in chips)
Seat 3: x80+i7DJL+81v3quj7KbNg ($20 in chips)
Seat 4: 0oXWlMUwwWciWdZOQf6yUw ($79.95 in chips)
Seat 5: p5UKaxVobvptF0ANhR/q1A ($100 in chips)
Seat 6: FL3MrLspcF23LYvC4ipBOA ($316.10 in chips)
Seat 7: 5GtqC1O4Y1t1VmP51SDSJQ ($102 in chips)
Seat 8: L9njYvloJ1NdXjP8edHEAg ($102.50 in chips)
Seat 9: 9BZCcac3+McErkkSN2YScA ($112.45 in chips)
Ogn4JDV3mp4ZDKO49IFzKA: is sitting out
HPmAhANyB1+4MGzYS9i5Wg: posts small blind $0.50
x80+i7DJL+81v3quj7KbNg: posts big blind $1
*** HOLE CARDS ***
Ogn4JDV3mp4ZDKO49IFzKA leaves the table
0oXWlMUwwWciWdZOQf6yUw: folds
p5UKaxVobvptF0ANhR/q1A: folds
FL3MrLspcF23LYvC4ipBOA: folds
5GtqC1O4Y1t1VmP51SDSJQ: folds
L9njYvloJ1NdXjP8edHEAg: folds
9BZCcac3+McErkkSN2YScA: folds
HPmAhANyB1+4MGzYS9i5Wg: calls $0.50
x80+i7DJL+81v3quj7KbNg: checks
*** FLOP *** [Js Jh Jd]
HPmAhANyB1+4MGzYS9i5Wg: checks
x80+i7DJL+81v3quj7KbNg: checks
*** TURN *** [Js Jh Jd] [9d]
HPmAhANyB1+4MGzYS9i5Wg: checks
x80+i7DJL+81v3quj7KbNg: checks
*** RIVER *** [Js Jh Jd 9d] [Kc]
HPmAhANyB1+4MGzYS9i5Wg: checks
x80+i7DJL+81v3quj7KbNg: checks
*** SHOW DOWN ***
HPmAhANyB1+4MGzYS9i5Wg: shows [3d 4s] (three of a kind, Jacks)
x80+i7DJL+81v3quj7KbNg: shows [6s Tc] (three of a kind, Jacks - King+Ten kicker)
x80+i7DJL+81v3quj7KbNg collected $1.90 from pot
*** SUMMARY ***
Total pot $2 | Rake $0.10
Board [Js Jh Jd 9d Kc]
Seat 2: HPmAhANyB1+4MGzYS9i5Wg (small blind) showed [3d 4s] and lost with three of a kind, Jacks
Seat 3: x80+i7DJL+81v3quj7KbNg (big blind) showed [6s Tc] and won ($1.90) with three of a kind, Jacks
Seat 4: 0oXWlMUwwWciWdZOQf6yUw folded before Flop (didn't bet)
Seat 5: p5UKaxVobvptF0ANhR/q1A folded before Flop (didn't bet)
Seat 6: FL3MrLspcF23LYvC4ipBOA folded before Flop (didn't bet)
Seat 7: 5GtqC1O4Y1t1VmP51SDSJQ folded before Flop (didn't bet)
Seat 8: L9njYvloJ1NdXjP8edHEAg folded before Flop (didn't bet)
Seat 9: 9BZCcac3+McErkkSN2YScA (button) folded before Flop (didn't bet)



PokerStars Game #59938895034:  Hold'em No Limit ($0.50/$1.00) - 2009/07/01 0:26:11 ET
Table 'tyUh+jyNvrceIQdKMJjQ2wZFWj23PMihdwrNWv41OG/Qeat #2 is the button
Seat 1: o8A5MUdudVKu+pAwgZOX2w ($219.55 in chips)
Seat 2: 6iVcnPw9a2oNG6sPQo3G6g ($98.50 in chips)
Seat 3: L9qfLYXrczhAPd/VckgsWw ($39.35 in chips)
Seat 4: TSuRyAHnUPCFjP7Z0rEE0w ($133.95 in chips)
Seat 5: j7NIOHLZk7V2o9fOioO5ug ($102.45 in chips)
Seat 6: YsLQ3BAvgQHWXMAv3Wv6Hg ($105.25 in chips)
L9qfLYXrczhAPd/VckgsWw: posts small blind $0.50
TSuRyAHnUPCFjP7Z0rEE0w: posts big blind $1
*** HOLE CARDS ***
j7NIOHLZk7V2o9fOioO5ug: folds
YsLQ3BAvgQHWXMAv3Wv6Hg: folds
o8A5MUdudVKu+pAwgZOX2w: calls $1
6iVcnPw9a2oNG6sPQo3G6g: folds
L9qfLYXrczhAPd/VckgsWw: calls $0.50
TSuRyAHnUPCFjP7Z0rEE0w: checks
*** FLOP *** [4s 8s 5d]
L9qfLYXrczhAPd/VckgsWw: bets $2
TSuRyAHnUPCFjP7Z0rEE0w: folds
o8A5MUdudVKu+pAwgZOX2w: folds
o8A5MUdudVKu+pAwgZOX2w is sitting out
L9qfLYXrczhAPd/VckgsWw collected $2.85 from pot
L9qfLYXrczhAPd/VckgsWw: doesn't show hand
*** SUMMARY ***
Total pot $3 | Rake $0.15
Board [4s 8s 5d]
Seat 1: o8A5MUdudVKu+pAwgZOX2w folded on the Flop
Seat 2: 6iVcnPw9a2oNG6sPQo3G6g (button) folded before Flop (didn't bet)
Seat 3: L9qfLYXrczhAPd/VckgsWw (small blind) collected ($2.85)
Seat 4: TSuRyAHnUPCFjP7Z0rEE0w (big blind) folded on the Flop
Seat 5: j7NIOHLZk7V2o9fOioO5ug folded before Flop (didn't bet)
Seat 6: YsLQ3BAvgQHWXMAv3Wv6Hg folded before Flop (didn't bet)



PokerStars Game #59938895514:  Hold'em No Limit ($0.50/$1.00) - 2009/07/01 0:26:12 ET
Table 'pHrhryH8jPNdQfY62f8v+g' 6-max Seat #1 is the button
Seat 1: BdbmJTZZ47quA9vUWwXtlw ($66.75 in chips)
Seat 2: RqgF7gRoKgRNW8Zoi1ty4A ($118.50 in chips)
Seat 3: 0WjiuIT7/EolY1oOx1ngeA ($101.50 in chips)
Seat 4: wenbG7TaM3H7h5kn78OFNw ($57.50 in chips)
Seat 5: Gp2euK/nqF6qXKe7U+jOfw ($117.15 in chips)
Seat 6: xAU6q2/cwmby2sxmA8VcmA ($100 in chips)
RqgF7gRoKgRNW8Zoi1ty4A: posts small blind $0.50
0WjiuIT7/EolY1oOx1ngeA: posts big blind $1
*** HOLE CARDS ***
wenbG7TaM3H7h5kn78OFNw: folds
Gp2euK/nqF6qXKe7U+jOfw: folds
xAU6q2/cwmby2sxmA8VcmA: folds
BdbmJTZZ47quA9vUWwXtlw: raises $2 to $3
RqgF7gRoKgRNW8Zoi1ty4A: folds
0WjiuIT7/EolY1oOx1ngeA: folds
BdbmJTZZ47quA9vUWwXtlw collected $2.50 from pot
*** SUMMARY ***
Total pot $2.50 | Rake $0
Seat 1: BdbmJTZZ47quA9vUWwXtlw (button) collected ($2.50)
Seat 2: RqgF7gRoKgRNW8Zoi1ty4A (small blind) folded before Flop
Seat 3: 0WjiuIT7/EolY1oOx1ngeA (big blind) folded before Flop
Seat 4: wenbG7TaM3H7h5kn78OFNw folded before Flop (didn't bet)
Seat 5: Gp2euK/nqF6qXKe7U+jOfw folded before Flop (didn't bet)
Seat 6: xAU6q2/cwmby2sxmA8VcmA folded before Flop (didn't bet)



PokerStars Game #59938895260:  Hold'em No Limit ($0.50/$1.00) - 2009/07/01 0:26:12 ET
Table 'hugOjcwJvzEwZbK7tyiWuQ' 9-max Seat #3 is the button
Seat 1: N9n5Wc3s35DpCrOAUUNAaQ ($126.35 in chips)
Seat 2: r27C1nIV4NS4+qbnrgBQSw ($257.05 in chips)
Seat 3: jDwhY1kCdc6EkAHbT7PJMQ ($109.75 in chips)
Seat 4: UWB3oeddt/GObx2Mix2Anw ($192.20 in chips)
Seat 6: gUUvmqdVlmvpal6B8nYrmg ($107.45 in chips)
Seat 7: FL3MrLspcF23LYvC4ipBOA ($100 in chips)
Seat 8: /zy+DB4S5fUQUSfZWFzYGw ($111.25 in chips)
Seat 9: o6JyUkbzCDw8tUabqtmnlg ($59.10 in chips)
UWB3oeddt/GObx2Mix2Anw: posts small blind $0.50
gUUvmqdVlmvpal6B8nYrmg: posts big blind $1
*** HOLE CARDS ***
FL3MrLspcF23LYvC4ipBOA: folds
/zy+DB4S5fUQUSfZWFzYGw: folds
o6JyUkbzCDw8tUabqtmnlg: folds
N9n5Wc3s35DpCrOAUUNAaQ: folds
r27C1nIV4NS4+qbnrgBQSw: raises $2 to $3
jDwhY1kCdc6EkAHbT7PJMQ: folds
UWB3oeddt/GObx2Mix2Anw: folds
gUUvmqdVlmvpal6B8nYrmg: folds
r27C1nIV4NS4+qbnrgBQSw collected $2.50 from pot
*** SUMMARY ***
Total pot $2.50 | Rake $0
Seat 1: N9n5Wc3s35DpCrOAUUNAaQ folded before Flop (didn't bet)
Seat 2: r27C1nIV4NS4+qbnrgBQSw collected ($2.50)
Seat 3: jDwhY1kCdc6EkAHbT7PJMQ (button) folded before Flop (didn't bet)
Seat 4: UWB3oeddt/GObx2Mix2Anw (small blind) folded before Flop
Seat 6: gUUvmqdVlmvpal6B8nYrmg (big blind) folded before Flop
Seat 7: FL3MrLspcF23LYvC4ipBOA folded before Flop (didn't bet)
Seat 8: /zy+DB4S5fUQUSfZWFzYGw folded before Flop (didn't bet)
Seat 9: o6JyUkbzCDw8tUabqtmnlg folded before Flop (didn't bet)



PokerStars Game #59938896510:  Hold'em No Limit ($0.50/$1.00) - 2009/07/01 0:26:13 ET
Table 'MUPc8FEpe/nR0BKSeReX6Q' 6-max Seat #2 is the button
Seat 1: YsLQ3BAvgQHWXMAv3Wv6Hg ($100 in chips)
Seat 2: xAU6q2/cwmby2sxmA8VcmA ($101 in chips)
Seat 3: wx3sQGkVi2x9wJXuWNHPBw ($234.55 in chips)
Seat 4: ZA1bp6g8IwtTxkUE4eCjDQ ($116.80 in chips)
Seat 5: UBZQqpnJZdTYYY1FTb0rLA ($100 in chips)
Seat 6: oxnw0GLLpFanjhGkxfRSqA ($53.60 in chips)
wx3sQGkVi2x9wJXuWNHPBw: posts small blind $0.50
ZA1bp6g8IwtTxkUE4eCjDQ: posts big blind $1
*** HOLE CARDS ***
UBZQqpnJZdTYYY1FTb0rLA: folds
oxnw0GLLpFanjhGkxfRSqA: folds
YsLQ3BAvgQHWXMAv3Wv6Hg: folds
xAU6q2/cwmby2sxmA8VcmA: raises $3 to $4
wx3sQGkVi2x9wJXuWNHPBw: folds
ZA1bp6g8IwtTxkUE4eCjDQ: calls $3
*** FLOP *** [5s 9c Kh]
ZA1bp6g8IwtTxkUE4eCjDQ: checks
xAU6q2/cwmby2sxmA8VcmA: bets $6
ZA1bp6g8IwtTxkUE4eCjDQ: calls $6
*** TURN *** [5s 9c Kh] [As]
ZA1bp6g8IwtTxkUE4eCjDQ: checks
xAU6q2/cwmby2sxmA8VcmA: bets $15
ZA1bp6g8IwtTxkUE4eCjDQ: folds
xAU6q2/cwmby2sxmA8VcmA collected $19.50 from pot
xAU6q2/cwmby2sxmA8VcmA: doesn't show hand
*** SUMMARY ***
Total pot $20.50 | Rake $1
Board [5s 9c Kh As]
Seat 1: YsLQ3BAvgQHWXMAv3Wv6Hg folded before Flop (didn't bet)
Seat 2: xAU6q2/cwmby2sxmA8VcmA (button) collected ($19.50)
Seat 3: wx3sQGkVi2x9wJXuWNHPBw (small blind) folded before Flop
Seat 4: ZA1bp6g8IwtTxkUE4eCjDQ (big blind) folded on the Turn
Seat 5: UBZQqpnJZdTYYY1FTb0rLA folded before Flop (didn't bet)
Seat 6: oxnw0GLLpFanjhGkxfRSqA folded before Flop (didn't bet)



PokerStars Game #59938899568:  Hold'em No Limit ($0.50/$1.00) - 2009/07/01 0:26:18 ET
Table 'Zka9tv1yilg0MvXWPQrShg' 9-max Seat #3 is the button
Seat 1: TZcz9MEWDA+WydgGruqqbw ($109.90 in chips)
Seat 2: rR1qGAf9Q9RYorKYWH3VKw ($20 in chips)
Seat 3: gUUvmqdVlmvpal6B8nYrmg ($101 in chips)
Seat 4: CTOae+JLIGfwfXvhqHkP2w ($171.15 in chips)
Seat 5: /zy+DB4S5fUQUSfZWFzYGw ($141.45 in chips)
Seat 6: rY8wPoax1lS+HUY+I0FZDw ($128.40 in chips)
Seat 7: p1SafS90nb3Uft5LB0NkHw ($21.50 in chips)
Seat 8: bL+QVeDcuEdzMGAGg2XJHg ($124.60 in chips)
CTOae+JLIGfwfXvhqHkP2w: posts small blind $0.50
/zy+DB4S5fUQUSfZWFzYGw: posts big blind $1
rR1qGAf9Q9RYorKYWH3VKw: posts big blind $1
*** HOLE CARDS ***
rY8wPoax1lS+HUY+I0FZDw: folds
p1SafS90nb3Uft5LB0NkHw: folds
bL+QVeDcuEdzMGAGg2XJHg: folds
TZcz9MEWDA+WydgGruqqbw: folds
rR1qGAf9Q9RYorKYWH3VKw: raises $1 to $2
gUUvmqdVlmvpal6B8nYrmg: folds
CTOae+JLIGfwfXvhqHkP2w: folds
/zy+DB4S5fUQUSfZWFzYGw: folds
rR1qGAf9Q9RYorKYWH3VKw collected $2.50 from pot
*** SUMMARY ***
Total pot $2.50 | Rake $0
Seat 1: TZcz9MEWDA+WydgGruqqbw folded before Flop (didn't bet)
Seat 2: rR1qGAf9Q9RYorKYWH3VKw collected ($2.50)
Seat 3: gUUvmqdVlmvpal6B8nYrmg (button) folded before Flop (didn't bet)
Seat 4: CTOae+JLIGfwfXvhqHkP2w (small blind) folded before Flop
Seat 5: /zy+DB4S5fUQUSfZWFzYGw (big blind) folded before Flop
Seat 6: rY8wPoax1lS+HUY+I0FZDw folded before Flop (didn't bet)
Seat 7: p1SafS90nb3Uft5LB0NkHw folded before Flop (didn't bet)
Seat 8: bL+QVeDcuEdzMGAGg2XJHg folded before Flop (didn't bet)



PokerStars Game #59938900364:  Hold'em No Limit ($0.50/$1.00) - 2009/07/01 0:26:19 ET
Table 'cBDNutyLBKEk9+ptwsKmTw' 6-max Seat #3 is the button
Seat 2: KyaE4+hWgUNIWWOWy4D14w ($87.60 in chips)
Seat 3: G5ZSSN6RSON3gkNvk/SmYg ($106.40 in chips)
Seat 4: 0WjiuIT7/EolY1oOx1ngeA ($101.15 in chips)
Seat 5: OGMLOcTNYZXZU81au7ztUw ($109.70 in chips)
Seat 6: pyzhFUPPSNzrysiMqlA5Xw ($10.60 in chips)
0WjiuIT7/EolY1oOx1ngeA: posts small blind $0.50
OGMLOcTNYZXZU81au7ztUw: posts big blind $1
xAU6q2/cwmby2sxmA8VcmA: sits out
*** HOLE CARDS ***
pyzhFUPPSNzrysiMqlA5Xw: folds
KyaE4+hWgUNIWWOWy4D14w: calls $1
G5ZSSN6RSON3gkNvk/SmYg: folds
0WjiuIT7/EolY1oOx1ngeA: raises $5 to $6
OGMLOcTNYZXZU81au7ztUw: folds
KyaE4+hWgUNIWWOWy4D14w: folds
0WjiuIT7/EolY1oOx1ngeA collected $3 from pot
0WjiuIT7/EolY1oOx1ngeA: doesn't show hand
*** SUMMARY ***
Total pot $3 | Rake $0
Seat 2: KyaE4+hWgUNIWWOWy4D14w folded before Flop
Seat 3: G5ZSSN6RSON3gkNvk/SmYg (button) folded before Flop (didn't bet)
Seat 4: 0WjiuIT7/EolY1oOx1ngeA (small blind) collected ($3)
Seat 5: OGMLOcTNYZXZU81au7ztUw (big blind) folded before Flop
Seat 6: pyzhFUPPSNzrysiMqlA5Xw folded before Flop (didn't bet)



PokerStars Game #59938900852:  Hold'em No Limit ($0.50/$1.00) - 2009/07/01 0:26:20 ET
Table 'rmZfTK+oSebeUPJNbWhdAA' 6-max Seat #6 is the button
Seat 1: xAU6q2/cwmby2sxmA8VcmA ($100.50 in chips)
Seat 2: OigyyiK+tTj1APPIAUmXDA ($92.55 in chips)
Seat 3: 9yjOzGERLaEZS8CZ6YNHFg ($48.80 in chips)
Seat 4: OGMLOcTNYZXZU81au7ztUw ($122.65 in chips)
Seat 6: j7NIOHLZk7V2o9fOioO5ug ($106.50 in chips)
xAU6q2/cwmby2sxmA8VcmA: posts small blind $0.50
OigyyiK+tTj1APPIAUmXDA: posts big blind $1
+xW7QemQU0Fxs+4TnqBRow: sits out
*** HOLE CARDS ***
9yjOzGERLaEZS8CZ6YNHFg: folds
OGMLOcTNYZXZU81au7ztUw: raises $2 to $3
j7NIOHLZk7V2o9fOioO5ug: calls $3
xAU6q2/cwmby2sxmA8VcmA: folds
OigyyiK+tTj1APPIAUmXDA: calls $2
*** FLOP *** [Jc Th Qc]
OigyyiK+tTj1APPIAUmXDA: checks
OGMLOcTNYZXZU81au7ztUw: bets $6
j7NIOHLZk7V2o9fOioO5ug: folds
OigyyiK+tTj1APPIAUmXDA: folds
OGMLOcTNYZXZU81au7ztUw collected $9.05 from pot
OGMLOcTNYZXZU81au7ztUw: doesn't show hand
*** SUMMARY ***
Total pot $9.50 | Rake $0.45
Board [Jc Th Qc]
Seat 1: xAU6q2/cwmby2sxmA8VcmA (small blind) folded before Flop
Seat 2: OigyyiK+tTj1APPIAUmXDA (big blind) folded on the Flop
Seat 3: 9yjOzGERLaEZS8CZ6YNHFg folded before Flop (didn't bet)
Seat 4: OGMLOcTNYZXZU81au7ztUw collected ($9.05)
Seat 6: j7NIOHLZk7V2o9fOioO5ug (button) folded on the Flop



PokerStars Game #59938900752:  Hold'em No Limit ($0.50/$1.00) - 2009/07/01 0:26:20 ET
Table 'VOs36P6NW+QyXeQ1B62kmA' 6-max Seat #2 is the button
Seat 1: AdLVjddOzm+sRNo1Bc3S6Q ($137.05 in chips)
Seat 2: KpnW5CcJ4Mg6MeclfKmLrw ($108.30 in chips)
Seat 3: TSuRyAHnUPCFjP7Z0rEE0w ($106.55 in chips)
Seat 4: w02zQzNydODiyV9THKgo9w ($30.80 in chips)
Seat 5: X7GlkHF+lkbarCLuZ4Uf0w ($21 in chips)
Seat 6: 6tvjsJrdmWg+g7FVrMnzXA ($74.10 in chips)
TSuRyAHnUPCFjP7Z0rEE0w: posts small blind $0.50
w02zQzNydODiyV9THKgo9w: posts big blind $1
*** HOLE CARDS ***
X7GlkHF+lkbarCLuZ4Uf0w: folds
6tvjsJrdmWg+g7FVrMnzXA: calls $1
AdLVjddOzm+sRNo1Bc3S6Q: folds
KpnW5CcJ4Mg6MeclfKmLrw: folds
TSuRyAHnUPCFjP7Z0rEE0w: calls $0.50
w02zQzNydODiyV9THKgo9w: checks
*** FLOP *** [Ks 8d 7s]
TSuRyAHnUPCFjP7Z0rEE0w: checks
w02zQzNydODiyV9THKgo9w: checks
6tvjsJrdmWg+g7FVrMnzXA: checks
*** TURN *** [Ks 8d 7s] [Ac]
TSuRyAHnUPCFjP7Z0rEE0w: checks
w02zQzNydODiyV9THKgo9w: bets $2
6tvjsJrdmWg+g7FVrMnzXA: folds
TSuRyAHnUPCFjP7Z0rEE0w: folds
w02zQzNydODiyV9THKgo9w collected $2.85 from pot
w02zQzNydODiyV9THKgo9w: doesn't show hand
*** SUMMARY ***
Total pot $3 | Rake $0.15
Board [Ks 8d 7s Ac]
Seat 1: AdLVjddOzm+sRNo1Bc3S6Q folded before Flop (didn't bet)
Seat 2: KpnW5CcJ4Mg6MeclfKmLrw (button) folded before Flop (didn't bet)
Seat 3: TSuRyAHnUPCFjP7Z0rEE0w (small blind) folded on the Turn
Seat 4: w02zQzNydODiyV9THKgo9w (big blind) collected ($2.85)
Seat 5: X7GlkHF+lkbarCLuZ4Uf0w folded before Flop (didn't bet)
Seat 6: 6tvjsJrdmWg+g7FVrMnzXA folded on the Turn



PokerStars Game #59938902362:  Hold'em No Limit ($0.50/$1.00) - 2009/07/01 0:26:22 ET
Table 'eU3bWpDDg3Z+9R4m4iVmog' 6-max Seat #2 is the button
Seat 1: TSuRyAHnUPCFjP7Z0rEE0w ($177.50 in chips)
Seat 2: 8CAoOzhmB8n3nRFf3V4BTg ($140.45 in chips)
Seat 3: U6tnjwZRpTnM+YkqkCjwyQ ($156.45 in chips)
Seat 4: GDVIsbEJ/DOJsMKE4Asz0A ($98 in chips)
Seat 5: QHvTZcrKe6+maWUfVjP29Q ($102 in chips)
Seat 6: hpxXcmRkXXI9HE5+5/j/0Q ($100 in chips)
U6tnjwZRpTnM+YkqkCjwyQ: posts small blind $0.50
GDVIsbEJ/DOJsMKE4Asz0A: posts big blind $1
*** HOLE CARDS ***
QHvTZcrKe6+maWUfVjP29Q: folds
hpxXcmRkXXI9HE5+5/j/0Q: folds
TSuRyAHnUPCFjP7Z0rEE0w: folds
8CAoOzhmB8n3nRFf3V4BTg: folds
U6tnjwZRpTnM+YkqkCjwyQ: folds
GDVIsbEJ/DOJsMKE4Asz0A collected $1 from pot
*** SUMMARY ***
Total pot $1 | Rake $0
Seat 1: TSuRyAHnUPCFjP7Z0rEE0w folded before Flop (didn't bet)
Seat 2: 8CAoOzhmB8n3nRFf3V4BTg (button) folded before Flop (didn't bet)
Seat 3: U6tnjwZRpTnM+YkqkCjwyQ (small blind) folded before Flop
Seat 4: GDVIsbEJ/DOJsMKE4Asz0A (big blind) collected ($1)
Seat 5: QHvTZcrKe6+maWUfVjP29Q folded before Flop (didn't bet)
Seat 6: hpxXcmRkXXI9HE5+5/j/0Q folded before Flop (didn't bet)



PokerStars Game #59938902286:  Hold'em No Limit ($0.50/$1.00) - 2009/07/01 0:26:22 ET
Table '/FUb199IViHMJHi5YWmeuQ' 9-max Seat #7 is the button
Seat 1: TZcz9MEWDA+WydgGruqqbw ($100 in chips)
Seat 2: FL3MrLspcF23LYvC4ipBOA ($138.75 in chips)
Seat 3: qN483QJ1NvHbdIZB7J4ARw ($73.75 in chips)
Seat 4: qheQay5YvP2DMAb3OUSxtw ($107.30 in chips)
Seat 5: +za1iHiRgVo4OcAz0SOZqw ($15.45 in chips)
Seat 6: ccFf7Q4z1cTGQmeoYiWEfw ($38.50 in chips)
Seat 7: bLbSOSmSOnqE0iTcH/5dxA ($100 in chips)
Seat 8: QIWvt0R766g8KfH0vl1s0A ($49.60 in chips)
Seat 9: knewtTmBc4Tc0z/5tAABYQ ($124.25 in chips)
QIWvt0R766g8KfH0vl1s0A: posts small blind $0.50
knewtTmBc4Tc0z/5tAABYQ: posts big blind $1
*** HOLE CARDS ***
TZcz9MEWDA+WydgGruqqbw: folds
FL3MrLspcF23LYvC4ipBOA: folds
qN483QJ1NvHbdIZB7J4ARw: raises $2 to $3
qheQay5YvP2DMAb3OUSxtw: folds
+za1iHiRgVo4OcAz0SOZqw: folds
ccFf7Q4z1cTGQmeoYiWEfw: folds
bLbSOSmSOnqE0iTcH/5dxA: folds
QIWvt0R766g8KfH0vl1s0A: calls $2.50
knewtTmBc4Tc0z/5tAABYQ: folds
*** FLOP *** [Jd 3c 4c]
QIWvt0R766g8KfH0vl1s0A: checks
qN483QJ1NvHbdIZB7J4ARw: bets $4
QIWvt0R766g8KfH0vl1s0A: folds
qN483QJ1NvHbdIZB7J4ARw collected $6.65 from pot
*** SUMMARY ***
Total pot $7 | Rake $0.35
Board [Jd 3c 4c]
Seat 1: TZcz9MEWDA+WydgGruqqbw folded before Flop (didn't bet)
Seat 2: FL3MrLspcF23LYvC4ipBOA folded before Flop (didn't bet)
Seat 3: qN483QJ1NvHbdIZB7J4ARw collected ($6.65)
Seat 4: qheQay5YvP2DMAb3OUSxtw folded before Flop (didn't bet)
Seat 5: +za1iHiRgVo4OcAz0SOZqw folded before Flop (didn't bet)
Seat 6: ccFf7Q4z1cTGQmeoYiWEfw folded before Flop (didn't bet)
Seat 7: bLbSOSmSOnqE0iTcH/5dxA (button) folded before Flop (didn't bet)
Seat 8: QIWvt0R766g8KfH0vl1s0A (small blind) folded on the Flop
Seat 9: knewtTmBc4Tc0z/5tAABYQ (big blind) folded before Flop



PokerStars Game #59938903140:  Hold'em No Limit ($0.50/$1.00) - 2009/07/01 0:26:23 ET
Table 'W/wyObTiXZm+Ckkl3YxcSw' 6-max Seat #6 is the button
Seat 1: ssLJburtEIqnVkx6X8R1uw ($116.25 in chips)
Seat 2: oDiBRCaF0QVtd3kO6xZIXw ($100 in chips)
Seat 3: b2a+5TkFf4xJN/Ihhma58Q ($34.70 in chips)
Seat 6: 1yB1nHUkHNNY8OJnDNHZMw ($104 in chips)
BdbmJTZZ47quA9vUWwXtlw leaves the table
ssLJburtEIqnVkx6X8R1uw: posts small blind $0.50
oDiBRCaF0QVtd3kO6xZIXw: posts big blind $1
*** HOLE CARDS ***
b2a+5TkFf4xJN/Ihhma58Q: folds
1yB1nHUkHNNY8OJnDNHZMw: calls $1
ssLJburtEIqnVkx6X8R1uw: folds
oDiBRCaF0QVtd3kO6xZIXw: checks
*** FLOP *** [3d 7c 7d]
+xW7QemQU0Fxs+4TnqBRow joins the table at seat #4
oDiBRCaF0QVtd3kO6xZIXw: checks
1yB1nHUkHNNY8OJnDNHZMw: bets $2
oDiBRCaF0QVtd3kO6xZIXw: raises $4 to $6
1yB1nHUkHNNY8OJnDNHZMw: folds
oDiBRCaF0QVtd3kO6xZIXw collected $6.20 from pot
oDiBRCaF0QVtd3kO6xZIXw: doesn't show hand
*** SUMMARY ***
Total pot $6.50 | Rake $0.30
Board [3d 7c 7d]
Seat 1: ssLJburtEIqnVkx6X8R1uw (small blind) folded before Flop
Seat 2: oDiBRCaF0QVtd3kO6xZIXw (big blind) collected ($6.20)
Seat 3: b2a+5TkFf4xJN/Ihhma58Q folded before Flop (didn't bet)
Seat 6: 1yB1nHUkHNNY8OJnDNHZMw (button) folded on the Flop



PokerStars Game #59938904760:  Hold'em No Limit ($0.50/$1.00) - 2009/07/01 0:26:26 ET
Table 'N2bNCDHL96aCQDvZIh+yQQ' 6-max Seat #5 is the button
Seat 1: iHo1oDbrEVJ8nEGdaPrICw ($143.50 in chips)
Seat 2: KpnW5CcJ4Mg6MeclfKmLrw ($102 in chips)
Seat 4: uCqEjnxh2/vFBjKYkfTOkw ($163 in chips)
Seat 5: rHlMOfR7kpQQxe+PFQz0xQ ($38.40 in chips)
Seat 6: TSuRyAHnUPCFjP7Z0rEE0w ($100 in chips)
TSuRyAHnUPCFjP7Z0rEE0w: posts small blind $0.50
iHo1oDbrEVJ8nEGdaPrICw: posts big blind $1
*** HOLE CARDS ***
KpnW5CcJ4Mg6MeclfKmLrw: folds
uCqEjnxh2/vFBjKYkfTOkw: folds
rHlMOfR7kpQQxe+PFQz0xQ: folds
TSuRyAHnUPCFjP7Z0rEE0w: folds
iHo1oDbrEVJ8nEGdaPrICw collected $1 from pot
iHo1oDbrEVJ8nEGdaPrICw: doesn't show hand
*** SUMMARY ***
Total pot $1 | Rake $0
Seat 1: iHo1oDbrEVJ8nEGdaPrICw (big blind) collected ($1)
Seat 2: KpnW5CcJ4Mg6MeclfKmLrw folded before Flop (didn't bet)
Seat 4: uCqEjnxh2/vFBjKYkfTOkw folded before Flop (didn't bet)
Seat 5: rHlMOfR7kpQQxe+PFQz0xQ (button) folded before Flop (didn't bet)
Seat 6: TSuRyAHnUPCFjP7Z0rEE0w (small blind) folded before Flop



PokerStars Game #59938907054:  Hold'em No Limit ($0.50/$1.00) - 2009/07/01 0:26:30 ET
Table '6YvsYDPNIDx2v5z3bJnwZQ' 9-max Seat #8 is the button
Seat 1: Ogn4JDV3mp4ZDKO49IFzKA ($17 in chips)
Seat 3: negfosHnGOZXSHpWDRKyBQ ($18.30 in chips)
Seat 4: kEr5NYB+JIG5+szcYMr6hA ($47.50 in chips)
Seat 5: mBRWbnUl8diyBO1qTJaNzw ($170.20 in chips)
Seat 6: uMPEfCcGCfsxmy53tVUMug ($107.40 in chips)
Seat 7: boixc27eqTYA1p0tUdMuBQ ($115 in chips)
Seat 8: PSFxpXgPedVZyHSu2Zhb7Q ($63.75 in chips)
Seat 9: jDwhY1kCdc6EkAHbT7PJMQ ($101.85 in chips)
jDwhY1kCdc6EkAHbT7PJMQ: posts small blind $0.50
Ogn4JDV3mp4ZDKO49IFzKA: posts big blind $1
35DmRulmD2MgzT6Bbt6/2w: sits out
*** HOLE CARDS ***
negfosHnGOZXSHpWDRKyBQ: folds
kEr5NYB+JIG5+szcYMr6hA: calls $1
mBRWbnUl8diyBO1qTJaNzw: folds
uMPEfCcGCfsxmy53tVUMug: calls $1
boixc27eqTYA1p0tUdMuBQ: calls $1
PSFxpXgPedVZyHSu2Zhb7Q: folds
jDwhY1kCdc6EkAHbT7PJMQ: calls $0.50
Ogn4JDV3mp4ZDKO49IFzKA: checks
*** FLOP *** [3h Kd 8c]
jDwhY1kCdc6EkAHbT7PJMQ: checks
Ogn4JDV3mp4ZDKO49IFzKA: checks
kEr5NYB+JIG5+szcYMr6hA: checks
uMPEfCcGCfsxmy53tVUMug: checks
boixc27eqTYA1p0tUdMuBQ: checks
*** TURN *** [3h Kd 8c] [Ts]
jDwhY1kCdc6EkAHbT7PJMQ: checks
Ogn4JDV3mp4ZDKO49IFzKA: checks
kEr5NYB+JIG5+szcYMr6hA: checks
uMPEfCcGCfsxmy53tVUMug: checks
boixc27eqTYA1p0tUdMuBQ: checks
*** RIVER *** [3h Kd 8c Ts] [Td]
jDwhY1kCdc6EkAHbT7PJMQ: checks
Ogn4JDV3mp4ZDKO49IFzKA: checks
kEr5NYB+JIG5+szcYMr6hA: checks
uMPEfCcGCfsxmy53tVUMug: checks
boixc27eqTYA1p0tUdMuBQ: checks
*** SHOW DOWN ***
jDwhY1kCdc6EkAHbT7PJMQ: shows [5h Ac] (a pair of Tens)
Ogn4JDV3mp4ZDKO49IFzKA: mucks hand
kEr5NYB+JIG5+szcYMr6hA: mucks hand
uMPEfCcGCfsxmy53tVUMug: mucks hand
boixc27eqTYA1p0tUdMuBQ: mucks hand
jDwhY1kCdc6EkAHbT7PJMQ collected $4.75 from pot
*** SUMMARY ***
Total pot $5 | Rake $0.25
Board [3h Kd 8c Ts Td]
Seat 1: Ogn4JDV3mp4ZDKO49IFzKA (big blind) mucked
Seat 3: negfosHnGOZXSHpWDRKyBQ folded before Flop (didn't bet)
Seat 4: kEr5NYB+JIG5+szcYMr6hA mucked
Seat 5: mBRWbnUl8diyBO1qTJaNzw folded before Flop (didn't bet)
Seat 6: uMPEfCcGCfsxmy53tVUMug mucked
Seat 7: boixc27eqTYA1p0tUdMuBQ mucked
Seat 8: PSFxpXgPedVZyHSu2Zhb7Q (button) folded before Flop (didn't bet)
Seat 9: jDwhY1kCdc6EkAHbT7PJMQ (small blind) showed [5h Ac] and won ($4.75) with a pair of Tens



PokerStars Game #59938907676:  Hold'em No Limit ($0.50/$1.00) - 2009/07/01 0:26:31 ET
Table '8jIjWCPY0NGprquL+xcMFg' 9-max Seat #9 is the button
Seat 1: vR4IO10geOgvTW+LAUBv/A ($134.15 in chips)
Seat 2: rR1qGAf9Q9RYorKYWH3VKw ($21.15 in chips)
Seat 3: 58zdeSBSuSFX/qZfhc7YmA ($99.50 in chips)
Seat 4: by0z+YmujwI6Bf4qRFE8vA ($118.10 in chips)
Seat 5: n758Yw8Hx2S+6NQUPGqcqA ($98.50 in chips)
Seat 6: GTQkFJtSkbVbnGCktp6e3g ($100.90 in chips)
Seat 7: O3CGPwwUmamrCNHccOilrg ($34.35 in chips)
Seat 8: 9swGhtpERPngKPtvpoZkoQ ($152.80 in chips)
Seat 9: negfosHnGOZXSHpWDRKyBQ ($18.50 in chips)
vR4IO10geOgvTW+LAUBv/A: posts small blind $0.50
rR1qGAf9Q9RYorKYWH3VKw: posts big blind $1
*** HOLE CARDS ***
58zdeSBSuSFX/qZfhc7YmA: raises $2 to $3
by0z+YmujwI6Bf4qRFE8vA: folds
n758Yw8Hx2S+6NQUPGqcqA: calls $3
GTQkFJtSkbVbnGCktp6e3g: folds
O3CGPwwUmamrCNHccOilrg: folds
9swGhtpERPngKPtvpoZkoQ: folds
negfosHnGOZXSHpWDRKyBQ: folds
vR4IO10geOgvTW+LAUBv/A: folds
rR1qGAf9Q9RYorKYWH3VKw: folds
*** FLOP *** [Ts Jd 9s]
58zdeSBSuSFX/qZfhc7YmA: bets $7
n758Yw8Hx2S+6NQUPGqcqA: calls $7
*** TURN *** [Ts Jd 9s] [Td]
58zdeSBSuSFX/qZfhc7YmA: bets $21
n758Yw8Hx2S+6NQUPGqcqA: folds
58zdeSBSuSFX/qZfhc7YmA collected $20.45 from pot
*** SUMMARY ***
Total pot $21.50 | Rake $1.05
Board [Ts Jd 9s Td]
Seat 1: vR4IO10geOgvTW+LAUBv/A (small blind) folded before Flop
Seat 2: rR1qGAf9Q9RYorKYWH3VKw (big blind) folded before Flop
Seat 3: 58zdeSBSuSFX/qZfhc7YmA collected ($20.45)
Seat 4: by0z+YmujwI6Bf4qRFE8vA folded before Flop (didn't bet)
Seat 5: n758Yw8Hx2S+6NQUPGqcqA folded on the Turn
Seat 6: GTQkFJtSkbVbnGCktp6e3g folded before Flop (didn't bet)
Seat 7: O3CGPwwUmamrCNHccOilrg folded before Flop (didn't bet)
Seat 8: 9swGhtpERPngKPtvpoZkoQ folded before Flop (didn't bet)
Seat 9: negfosHnGOZXSHpWDRKyBQ (button) folded before Flop (didn't bet)



PokerStars Game #59938909454:  Hold'em No Limit ($0.50/$1.00) - 2009/07/01 0:26:33 ET
Table 'GxCPo/gd3OSthkYrAxJngg' 6-max Seat #1 is the button
Seat 1: sH8BpAFP+jGFxCgVpD1Lew ($279.45 in chips)
Seat 2: YExX2paeIHrmfIwV1ivM/w ($84.20 in chips)
Seat 3: o6plE+MSW4XFNTeONe16xg ($19 in chips)
Seat 4: YMJG+F++3Aj6P8dAWda5fw ($109.15 in chips)
Seat 5: G5ZSSN6RSON3gkNvk/SmYg ($100 in chips)
Seat 6: sS9IXedL3MiRmpVXhAILhw ($97 in chips)
YExX2paeIHrmfIwV1ivM/w: posts small blind $0.50
o6plE+MSW4XFNTeONe16xg: posts big blind $1
*** HOLE CARDS ***
YMJG+F++3Aj6P8dAWda5fw: folds
G5ZSSN6RSON3gkNvk/SmYg: folds
sS9IXedL3MiRmpVXhAILhw: folds
sH8BpAFP+jGFxCgVpD1Lew: folds
YExX2paeIHrmfIwV1ivM/w: raises $2 to $3
o6plE+MSW4XFNTeONe16xg: raises $2 to $5
YExX2paeIHrmfIwV1ivM/w: raises $10 to $15
o6plE+MSW4XFNTeONe16xg: raises $4 to $19 and is all-in
YExX2paeIHrmfIwV1ivM/w: calls $4
*** FLOP *** [Td Qc 8c]
*** TURN *** [Td Qc 8c] [5h]
*** RIVER *** [Td Qc 8c 5h] [Ks]
*** SHOW DOWN ***
YExX2paeIHrmfIwV1ivM/w: shows [Ad Qs] (a pair of Queens)
o6plE+MSW4XFNTeONe16xg: shows [Ac Kd] (a pair of Kings)
o6plE+MSW4XFNTeONe16xg collected $36.10 from pot
*** SUMMARY ***
Total pot $38 | Rake $1.90
Board [Td Qc 8c 5h Ks]
Seat 1: sH8BpAFP+jGFxCgVpD1Lew (button) folded before Flop (didn't bet)
Seat 2: YExX2paeIHrmfIwV1ivM/w (small blind) showed [Ad Qs] and lost with a pair of Queens
Seat 3: o6plE+MSW4XFNTeONe16xg (big blind) showed [Ac Kd] and won ($36.10) with a pair of Kings
Seat 4: YMJG+F++3Aj6P8dAWda5fw folded before Flop (didn't bet)
Seat 5: G5ZSSN6RSON3gkNvk/SmYg folded before Flop (didn't bet)
Seat 6: sS9IXedL3MiRmpVXhAILhw folded before Flop (didn't bet)



PokerStars Game #59938911152:  Hold'em No Limit ($0.50/$1.00) - 2009/07/01 0:26:36 ET
Table '/RZcOwpZpHQ+OwPwjsbnRw' 6-max Seat #6 is the button
Seat 1: Zboa6dColKGHBjLPUakZjw ($44 in chips)
Seat 2: dHC9PH9hdH3Ad2TD8ZxX0Q ($52.60 in chips)
Seat 3: OigyyiK+tTj1APPIAUmXDA ($74.15 in chips)
Seat 4: j7NIOHLZk7V2o9fOioO5ug ($110.40 in chips)
Seat 5: wx3sQGkVi2x9wJXuWNHPBw ($200.55 in chips)
Seat 6: XOIf9W+VAxhZqN+SYoyMKA ($253.80 in chips)
Zboa6dColKGHBjLPUakZjw: posts small blind $0.50
dHC9PH9hdH3Ad2TD8ZxX0Q: posts big blind $1
*** HOLE CARDS ***
OigyyiK+tTj1APPIAUmXDA: folds
j7NIOHLZk7V2o9fOioO5ug: folds
wx3sQGkVi2x9wJXuWNHPBw: folds
XOIf9W+VAxhZqN+SYoyMKA: folds
Zboa6dColKGHBjLPUakZjw: calls $0.50
dHC9PH9hdH3Ad2TD8ZxX0Q: raises $1 to $2
Zboa6dColKGHBjLPUakZjw: folds
dHC9PH9hdH3Ad2TD8ZxX0Q collected $2 from pot
dHC9PH9hdH3Ad2TD8ZxX0Q: doesn't show hand
*** SUMMARY ***
Total pot $2 | Rake $0
Seat 1: Zboa6dColKGHBjLPUakZjw (small blind) folded before Flop
Seat 2: dHC9PH9hdH3Ad2TD8ZxX0Q (big blind) collected ($2)
Seat 3: OigyyiK+tTj1APPIAUmXDA folded before Flop (didn't bet)
Seat 4: j7NIOHLZk7V2o9fOioO5ug folded before Flop (didn't bet)
Seat 5: wx3sQGkVi2x9wJXuWNHPBw folded before Flop (didn't bet)
Seat 6: XOIf9W+VAxhZqN+SYoyMKA (button) folded before Flop (didn't bet)



PokerStars Game #59938912142:  Hold'em No Limit ($0.50/$1.00) - 2009/07/01 0:26:37 ET
Table 'SQLOQoANiHscJ8AL7zffbw' 9-max Seat #1 is the button
Seat 1: jPTRd6SpCp4xqAy2XQiTOw ($101.85 in chips)
Seat 2: /zy+DB4S5fUQUSfZWFzYGw ($279.35 in chips)
Seat 3: 0eFnow7+D7veCYQ+CG9FFw ($71.50 in chips)
Seat 4: N9n5Wc3s35DpCrOAUUNAaQ ($119.30 in chips)
Seat 5: L9njYvloJ1NdXjP8edHEAg ($110.55 in chips)
Seat 6: p5UKaxVobvptF0ANhR/q1A ($157 in chips)
Seat 7: bJckevFOcg//s0qyMQI6sQ ($103.55 in chips)
Seat 8: 9ce+0Dl3d0BeEFIP+8HezA ($18.50 in chips)
Seat 9: qJr25HAtvv1w/7IBvjMM3g ($234.35 in chips)
/zy+DB4S5fUQUSfZWFzYGw: posts small blind $0.50
0eFnow7+D7veCYQ+CG9FFw: posts big blind $1
*** HOLE CARDS ***
N9n5Wc3s35DpCrOAUUNAaQ: folds
L9njYvloJ1NdXjP8edHEAg: folds
p5UKaxVobvptF0ANhR/q1A: folds
bJckevFOcg//s0qyMQI6sQ: folds
9ce+0Dl3d0BeEFIP+8HezA: folds
qJr25HAtvv1w/7IBvjMM3g: folds
jPTRd6SpCp4xqAy2XQiTOw: folds
/zy+DB4S5fUQUSfZWFzYGw: raises $2 to $3
0eFnow7+D7veCYQ+CG9FFw: folds
/zy+DB4S5fUQUSfZWFzYGw collected $2 from pot
*** SUMMARY ***
Total pot $2 | Rake $0
Seat 1: jPTRd6SpCp4xqAy2XQiTOw (button) folded before Flop (didn't bet)
Seat 2: /zy+DB4S5fUQUSfZWFzYGw (small blind) collected ($2)
Seat 3: 0eFnow7+D7veCYQ+CG9FFw (big blind) folded before Flop
Seat 4: N9n5Wc3s35DpCrOAUUNAaQ folded before Flop (didn't bet)
Seat 5: L9njYvloJ1NdXjP8edHEAg folded before Flop (didn't bet)
Seat 6: p5UKaxVobvptF0ANhR/q1A folded before Flop (didn't bet)
Seat 7: bJckevFOcg//s0qyMQI6sQ folded before Flop (didn't bet)
Seat 8: 9ce+0Dl3d0BeEFIP+8HezA folded before Flop (didn't bet)
Seat 9: qJr25HAtvv1w/7IBvjMM3g folded before Flop (didn't bet)



PokerStars Game #59938912112:  Hold'em No Limit ($0.50/$1.00) - 2009/07/01 0:26:37 ET
Table 'cBDNutyLBKEk9+ptwsKmTw' 6-max Seat #4 is the button
Seat 2: KyaE4+hWgUNIWWOWy4D14w ($86.60 in chips)
Seat 3: G5ZSSN6RSON3gkNvk/SmYg ($106.40 in chips)
Seat 4: 0WjiuIT7/EolY1oOx1ngeA ($103.15 in chips)
Seat 5: OGMLOcTNYZXZU81au7ztUw ($108.70 in chips)
Seat 6: pyzhFUPPSNzrysiMqlA5Xw ($10.60 in chips)
OGMLOcTNYZXZU81au7ztUw: posts small blind $0.50
pyzhFUPPSNzrysiMqlA5Xw: posts big blind $1
xAU6q2/cwmby2sxmA8VcmA: sits out
*** HOLE CARDS ***
KyaE4+hWgUNIWWOWy4D14w: folds
G5ZSSN6RSON3gkNvk/SmYg: folds
0WjiuIT7/EolY1oOx1ngeA: raises $1 to $2
OGMLOcTNYZXZU81au7ztUw: folds
pyzhFUPPSNzrysiMqlA5Xw: folds
0WjiuIT7/EolY1oOx1ngeA collected $2.50 from pot
0WjiuIT7/EolY1oOx1ngeA: doesn't show hand
*** SUMMARY ***
Total pot $2.50 | Rake $0
Seat 2: KyaE4+hWgUNIWWOWy4D14w folded before Flop (didn't bet)
Seat 3: G5ZSSN6RSON3gkNvk/SmYg folded before Flop (didn't bet)
Seat 4: 0WjiuIT7/EolY1oOx1ngeA (button) collected ($2.50)
Seat 5: OGMLOcTNYZXZU81au7ztUw (small blind) folded before Flop
Seat 6: pyzhFUPPSNzrysiMqlA5Xw (big blind) folded before Flop



PokerStars Game #59938912938:  Hold'em No Limit ($0.50/$1.00) - 2009/07/01 0:26:39 ET
Table 'fTlPiCj0utgzC/5io+I7ew' 6-max Seat #3 is the button
Seat 1: YMJG+F++3Aj6P8dAWda5fw ($98.50 in chips)
Seat 2: +xUCTmR3cU7G239W+vZv6g ($141.85 in chips)
Seat 3: oDiBRCaF0QVtd3kO6xZIXw ($100 in chips)
Seat 4: uJVSceLggtsrJya+WtmUEA ($96.80 in chips)
Seat 5: bFrTkDcWGTxyvNul7GVdYg ($247.85 in chips)
uJVSceLggtsrJya+WtmUEA: posts small blind $0.50
bFrTkDcWGTxyvNul7GVdYg: posts big blind $1
jMljU/dOPMXfJi8OmbdYdw: sits out
*** HOLE CARDS ***
YMJG+F++3Aj6P8dAWda5fw: folds
+xUCTmR3cU7G239W+vZv6g: raises $2 to $3
oDiBRCaF0QVtd3kO6xZIXw: folds
uJVSceLggtsrJya+WtmUEA: folds
bFrTkDcWGTxyvNul7GVdYg: folds
+xUCTmR3cU7G239W+vZv6g collected $2.50 from pot
*** SUMMARY ***
Total pot $2.50 | Rake $0
Seat 1: YMJG+F++3Aj6P8dAWda5fw folded before Flop (didn't bet)
Seat 2: +xUCTmR3cU7G239W+vZv6g collected ($2.50)
Seat 3: oDiBRCaF0QVtd3kO6xZIXw (button) folded before Flop (didn't bet)
Seat 4: uJVSceLggtsrJya+WtmUEA (small blind) folded before Flop
Seat 5: bFrTkDcWGTxyvNul7GVdYg (big blind) folded before Flop



PokerStars Game #59938915028:  Hold'em No Limit ($0.50/$1.00) - 2009/07/01 0:26:42 ET
Table 'pHrhryH8jPNdQfY62f8v+g' 6-max Seat #2 is the button
Seat 1: BdbmJTZZ47quA9vUWwXtlw ($68.25 in chips)
Seat 2: RqgF7gRoKgRNW8Zoi1ty4A ($118 in chips)
Seat 3: 0WjiuIT7/EolY1oOx1ngeA ($100.50 in chips)
Seat 4: wenbG7TaM3H7h5kn78OFNw ($57.50 in chips)
Seat 5: Gp2euK/nqF6qXKe7U+jOfw ($117.15 in chips)
Seat 6: xAU6q2/cwmby2sxmA8VcmA ($100 in chips)
0WjiuIT7/EolY1oOx1ngeA: posts small blind $0.50
wenbG7TaM3H7h5kn78OFNw: posts big blind $1
*** HOLE CARDS ***
Gp2euK/nqF6qXKe7U+jOfw: folds
xAU6q2/cwmby2sxmA8VcmA: raises $3 to $4
BdbmJTZZ47quA9vUWwXtlw: calls $4
RqgF7gRoKgRNW8Zoi1ty4A: folds
0WjiuIT7/EolY1oOx1ngeA: calls $3.50
wenbG7TaM3H7h5kn78OFNw: folds
*** FLOP *** [3c 8s 6c]
0WjiuIT7/EolY1oOx1ngeA: bets $6
xAU6q2/cwmby2sxmA8VcmA: raises $12 to $18
BdbmJTZZ47quA9vUWwXtlw: folds
0WjiuIT7/EolY1oOx1ngeA: folds
xAU6q2/cwmby2sxmA8VcmA collected $23.80 from pot
*** SUMMARY ***
Total pot $25 | Rake $1.20
Board [3c 8s 6c]
Seat 1: BdbmJTZZ47quA9vUWwXtlw folded on the Flop
Seat 2: RqgF7gRoKgRNW8Zoi1ty4A (button) folded before Flop (didn't bet)
Seat 3: 0WjiuIT7/EolY1oOx1ngeA (small blind) folded on the Flop
Seat 4: wenbG7TaM3H7h5kn78OFNw (big blind) folded before Flop
Seat 5: Gp2euK/nqF6qXKe7U+jOfw folded before Flop (didn't bet)
Seat 6: xAU6q2/cwmby2sxmA8VcmA collected ($23.80)



PokerStars Game #59938916520:  Hold'em No Limit ($0.50/$1.00) - 2009/07/01 0:26:44 ET
Table 'kS0cTQAEi+fdUlJP2gQYvw' 9-max Seat #1 is the button
Seat 1: c/9X4zftzphFxYtxp5kp9w ($41.90 in chips)
Seat 2: 4SFNYndzMeslixOnF4koZQ ($54.15 in chips)
Seat 3: 3obndzTJ6fECz8+wWhMd1w ($18.50 in chips)
Seat 4: TZcz9MEWDA+WydgGruqqbw ($100 in chips)
Seat 5: 2rxrMrE7koO2BNxvop/0+g ($49.20 in chips)
Seat 6: yAbu2QsRPVcjPbqlf/jDxw ($100.65 in chips)
Seat 7: Ffa7Nj4X5fddtROP01hfQg ($103.05 in chips)
Seat 8: qTymj6ZQ8ZoFi6fINJZb3w ($86.50 in chips)
Seat 9: y8Qb94e81yI/g0saQ6gU5g ($84.75 in chips)
4SFNYndzMeslixOnF4koZQ: posts small blind $0.50
3obndzTJ6fECz8+wWhMd1w: posts big blind $1
*** HOLE CARDS ***
TZcz9MEWDA+WydgGruqqbw: folds
2rxrMrE7koO2BNxvop/0+g: folds
yAbu2QsRPVcjPbqlf/jDxw: folds
c/9X4zftzphFxYtxp5kp9w said, "deam put you on ak nh"
Ffa7Nj4X5fddtROP01hfQg said, "AA?"
Ffa7Nj4X5fddtROP01hfQg said, "thx"
Ffa7Nj4X5fddtROP01hfQg: folds
qTymj6ZQ8ZoFi6fINJZb3w: raises $1 to $2
y8Qb94e81yI/g0saQ6gU5g: folds
c/9X4zftzphFxYtxp5kp9w: folds
4SFNYndzMeslixOnF4koZQ: folds
3obndzTJ6fECz8+wWhMd1w: folds
qTymj6ZQ8ZoFi6fINJZb3w collected $2.50 from pot
qTymj6ZQ8ZoFi6fINJZb3w: doesn't show hand
*** SUMMARY ***
Total pot $2.50 | Rake $0
Seat 1: c/9X4zftzphFxYtxp5kp9w (button) folded before Flop (didn't bet)
Seat 2: 4SFNYndzMeslixOnF4koZQ (small blind) folded before Flop
Seat 3: 3obndzTJ6fECz8+wWhMd1w (big blind) folded before Flop
Seat 4: TZcz9MEWDA+WydgGruqqbw folded before Flop (didn't bet)
Seat 5: 2rxrMrE7koO2BNxvop/0+g folded before Flop (didn't bet)
Seat 6: yAbu2QsRPVcjPbqlf/jDxw folded before Flop (didn't bet)
Seat 7: Ffa7Nj4X5fddtROP01hfQg folded before Flop (didn't bet)
Seat 8: qTymj6ZQ8ZoFi6fINJZb3w collected ($2.50)
Seat 9: y8Qb94e81yI/g0saQ6gU5g folded before Flop (didn't bet)



PokerStars Game #59938917204:  Hold'em No Limit ($0.50/$1.00) - 2009/07/01 0:26:45 ET
Table '7Nl0ffnjeK44/vmeexh3MQ' 9-max Seat #1 is the button
Seat 1: s7D3Y+k4Cj4D1cXHv7oj+Q ($98.65 in chips)
Seat 2: kiakSwxX0e64PwYGAPQvLw ($32.35 in chips)
Seat 5: bL+QVeDcuEdzMGAGg2XJHg ($115.45 in chips)
Seat 6: FVs16t7GgfWgQWt4JxsObQ ($9.55 in chips)
Seat 7: knewtTmBc4Tc0z/5tAABYQ ($106.50 in chips)
Seat 8: zanka7aAZkigmZpfopXxxA ($223.50 in chips)
Seat 9: ouwUBGRKnKK9uhn1G4Lf+A ($98.50 in chips)
kiakSwxX0e64PwYGAPQvLw: posts small blind $0.50
200876: is sitting out
NfbTuCZ2txeWuV3hP7t0TA: is sitting out
bL+QVeDcuEdzMGAGg2XJHg: posts big blind $1
*** HOLE CARDS ***
FVs16t7GgfWgQWt4JxsObQ: folds
NfbTuCZ2txeWuV3hP7t0TA leaves the table
knewtTmBc4Tc0z/5tAABYQ: folds
zanka7aAZkigmZpfopXxxA: raises $2 to $3
bLbSOSmSOnqE0iTcH/5dxA joins the table at seat #4
ouwUBGRKnKK9uhn1G4Lf+A: folds
s7D3Y+k4Cj4D1cXHv7oj+Q: folds
kiakSwxX0e64PwYGAPQvLw: folds
bL+QVeDcuEdzMGAGg2XJHg: folds
zanka7aAZkigmZpfopXxxA collected $2.50 from pot
200876 has returned
zanka7aAZkigmZpfopXxxA: doesn't show hand
*** SUMMARY ***
Total pot $2.50 | Rake $0
Seat 1: s7D3Y+k4Cj4D1cXHv7oj+Q (button) folded before Flop (didn't bet)
Seat 2: kiakSwxX0e64PwYGAPQvLw (small blind) folded before Flop
Seat 5: bL+QVeDcuEdzMGAGg2XJHg (big blind) folded before Flop
Seat 6: FVs16t7GgfWgQWt4JxsObQ folded before Flop (didn't bet)
Seat 7: knewtTmBc4Tc0z/5tAABYQ folded before Flop (didn't bet)
Seat 8: zanka7aAZkigmZpfopXxxA collected ($2.50)
Seat 9: ouwUBGRKnKK9uhn1G4Lf+A folded before Flop (didn't bet)



PokerStars Game #59938917416:  Hold'em No Limit ($0.50/$1.00) - 2009/07/01 0:26:46 ET
Table 'tLrtq7gDzxEvckNAI1OS5Q' 6-max Seat #1 is the button
Seat 1: GisIe1kcC9q/xV6ifsTjgA ($147.35 in chips)
Seat 2: qsObMEIlRO22OlS867m/lw ($16.30 in chips)
Seat 3: TPZ+m9x+lwoKpv7TMfAUWA ($324.80 in chips)
Seat 4: KOG8rG51mOvIoY96zF3kvw ($163.30 in chips)
Seat 5: OGMLOcTNYZXZU81au7ztUw ($166.45 in chips)
Seat 6: XUk5GQsfNFpHvaToDZ0rZA ($43.45 in chips)
qsObMEIlRO22OlS867m/lw: posts small blind $0.50
TPZ+m9x+lwoKpv7TMfAUWA: posts big blind $1
*** HOLE CARDS ***
KOG8rG51mOvIoY96zF3kvw: folds
OGMLOcTNYZXZU81au7ztUw: folds
XUk5GQsfNFpHvaToDZ0rZA: folds
GisIe1kcC9q/xV6ifsTjgA: folds
qsObMEIlRO22OlS867m/lw: folds
TPZ+m9x+lwoKpv7TMfAUWA collected $1 from pot
*** SUMMARY ***
Total pot $1 | Rake $0
Seat 1: GisIe1kcC9q/xV6ifsTjgA (button) folded before Flop (didn't bet)
Seat 2: qsObMEIlRO22OlS867m/lw (small blind) folded before Flop
Seat 3: TPZ+m9x+lwoKpv7TMfAUWA (big blind) collected ($1)
Seat 4: KOG8rG51mOvIoY96zF3kvw folded before Flop (didn't bet)
Seat 5: OGMLOcTNYZXZU81au7ztUw folded before Flop (didn't bet)
Seat 6: XUk5GQsfNFpHvaToDZ0rZA folded before Flop (didn't bet)



PokerStars Game #59938917934:  Hold'em No Limit ($0.50/$1.00) - 2009/07/01 0:26:46 ET
Table 'QSIig7BLMc9wY/rgBechzw' 6-max Seat #1 is the button
Seat 1: uuA9hpFU17U5/t4cvpbpBg ($26.40 in chips)
Seat 2: 0WjiuIT7/EolY1oOx1ngeA ($125.25 in chips)
Seat 3: +W6OnF033KNM2xH0fGj98Q ($121.70 in chips)
Seat 4: +uSzP8Jwnw7sKfQ4s66b7w ($47 in chips)
Seat 5: bvU2ZjpVnszLCFVeWbxePg ($112.20 in chips)
Seat 6: KpnW5CcJ4Mg6MeclfKmLrw ($130.75 in chips)
0WjiuIT7/EolY1oOx1ngeA: posts small blind $0.50
+W6OnF033KNM2xH0fGj98Q: posts big blind $1
*** HOLE CARDS ***
+uSzP8Jwnw7sKfQ4s66b7w: folds
bvU2ZjpVnszLCFVeWbxePg: raises $2 to $3
KpnW5CcJ4Mg6MeclfKmLrw: folds
uuA9hpFU17U5/t4cvpbpBg: folds
0WjiuIT7/EolY1oOx1ngeA: folds
+W6OnF033KNM2xH0fGj98Q: folds
bvU2ZjpVnszLCFVeWbxePg collected $2.50 from pot
bvU2ZjpVnszLCFVeWbxePg: doesn't show hand
*** SUMMARY ***
Total pot $2.50 | Rake $0
Seat 1: uuA9hpFU17U5/t4cvpbpBg (button) folded before Flop (didn't bet)
Seat 2: 0WjiuIT7/EolY1oOx1ngeA (small blind) folded before Flop
Seat 3: +W6OnF033KNM2xH0fGj98Q (big blind) folded before Flop
Seat 4: +uSzP8Jwnw7sKfQ4s66b7w folded before Flop (didn't bet)
Seat 5: bvU2ZjpVnszLCFVeWbxePg collected ($2.50)
Seat 6: KpnW5CcJ4Mg6MeclfKmLrw folded before Flop (didn't bet)



PokerStars Game #59938918972:  Hold'em No Limit ($0.50/$1.00) - 2009/07/01 0:26:48 ET
Table 'hugOjcwJvzEwZbK7tyiWuQ' 9-max Seat #4 is the button
Seat 1: N9n5Wc3s35DpCrOAUUNAaQ ($126.35 in chips)
Seat 2: r27C1nIV4NS4+qbnrgBQSw ($258.55 in chips)
Seat 3: jDwhY1kCdc6EkAHbT7PJMQ ($109.75 in chips)
Seat 4: UWB3oeddt/GObx2Mix2Anw ($191.70 in chips)
Seat 6: gUUvmqdVlmvpal6B8nYrmg ($106.45 in chips)
Seat 7: FL3MrLspcF23LYvC4ipBOA ($100 in chips)
Seat 8: /zy+DB4S5fUQUSfZWFzYGw ($111.25 in chips)
Seat 9: o6JyUkbzCDw8tUabqtmnlg ($59.10 in chips)
gUUvmqdVlmvpal6B8nYrmg: posts small blind $0.50
FL3MrLspcF23LYvC4ipBOA: posts big blind $1
*** HOLE CARDS ***
/zy+DB4S5fUQUSfZWFzYGw: folds
o6JyUkbzCDw8tUabqtmnlg: folds
N9n5Wc3s35DpCrOAUUNAaQ: raises $2.50 to $3.50
r27C1nIV4NS4+qbnrgBQSw: folds
jDwhY1kCdc6EkAHbT7PJMQ: folds
UWB3oeddt/GObx2Mix2Anw: folds
gUUvmqdVlmvpal6B8nYrmg: folds
FL3MrLspcF23LYvC4ipBOA: folds
N9n5Wc3s35DpCrOAUUNAaQ collected $2.50 from pot
*** SUMMARY ***
Total pot $2.50 | Rake $0
Seat 1: N9n5Wc3s35DpCrOAUUNAaQ collected ($2.50)
Seat 2: r27C1nIV4NS4+qbnrgBQSw folded before Flop (didn't bet)
Seat 3: jDwhY1kCdc6EkAHbT7PJMQ folded before Flop (didn't bet)
Seat 4: UWB3oeddt/GObx2Mix2Anw (button) folded before Flop (didn't bet)
Seat 6: gUUvmqdVlmvpal6B8nYrmg (small blind) folded before Flop
Seat 7: FL3MrLspcF23LYvC4ipBOA (big blind) folded before Flop
Seat 8: /zy+DB4S5fUQUSfZWFzYGw folded before Flop (didn't bet)
Seat 9: o6JyUkbzCDw8tUabqtmnlg folded before Flop (didn't bet)



PokerStars Game #59938920200:  Hold'em No Limit ($0.50/$1.00) - 2009/07/01 0:26:50 ET
Table 'tyUh+jyNvrceIQdKMJjQ2wZFWj23PMihdwrNWv41OG/Qeat #3 is the button
Seat 2: 6iVcnPw9a2oNG6sPQo3G6g ($98.50 in chips)
Seat 3: L9qfLYXrczhAPd/VckgsWw ($41.20 in chips)
Seat 4: TSuRyAHnUPCFjP7Z0rEE0w ($132.95 in chips)
Seat 5: j7NIOHLZk7V2o9fOioO5ug ($102.45 in chips)
Seat 6: YsLQ3BAvgQHWXMAv3Wv6Hg ($105.25 in chips)
TSuRyAHnUPCFjP7Z0rEE0w: posts small blind $0.50
j7NIOHLZk7V2o9fOioO5ug: posts big blind $1
*** HOLE CARDS ***
YsLQ3BAvgQHWXMAv3Wv6Hg: folds
6iVcnPw9a2oNG6sPQo3G6g: folds
L9qfLYXrczhAPd/VckgsWw: folds
TSuRyAHnUPCFjP7Z0rEE0w: folds
j7NIOHLZk7V2o9fOioO5ug collected $1 from pot
j7NIOHLZk7V2o9fOioO5ug: doesn't show hand
*** SUMMARY ***
Total pot $1 | Rake $0
Seat 2: 6iVcnPw9a2oNG6sPQo3G6g folded before Flop (didn't bet)
Seat 3: L9qfLYXrczhAPd/VckgsWw (button) folded before Flop (didn't bet)
Seat 4: TSuRyAHnUPCFjP7Z0rEE0w (small blind) folded before Flop
Seat 5: j7NIOHLZk7V2o9fOioO5ug (big blind) collected ($1)
Seat 6: YsLQ3BAvgQHWXMAv3Wv6Hg folded before Flop (didn't bet)



PokerStars Game #59938920304:  Hold'em No Limit ($0.50/$1.00) - 2009/07/01 0:26:50 ET
Table 'eU3bWpDDg3Z+9R4m4iVmog' 6-max Seat #3 is the button
Seat 1: TSuRyAHnUPCFjP7Z0rEE0w ($177.50 in chips)
Seat 2: 8CAoOzhmB8n3nRFf3V4BTg ($140.45 in chips)
Seat 3: U6tnjwZRpTnM+YkqkCjwyQ ($155.95 in chips)
Seat 4: GDVIsbEJ/DOJsMKE4Asz0A ($98.50 in chips)
Seat 5: QHvTZcrKe6+maWUfVjP29Q ($102 in chips)
Seat 6: hpxXcmRkXXI9HE5+5/j/0Q ($100 in chips)
GDVIsbEJ/DOJsMKE4Asz0A: posts small blind $0.50
QHvTZcrKe6+maWUfVjP29Q: posts big blind $1
*** HOLE CARDS ***
hpxXcmRkXXI9HE5+5/j/0Q: raises $2 to $3
TSuRyAHnUPCFjP7Z0rEE0w: folds
8CAoOzhmB8n3nRFf3V4BTg: folds
U6tnjwZRpTnM+YkqkCjwyQ: folds
GDVIsbEJ/DOJsMKE4Asz0A: folds
QHvTZcrKe6+maWUfVjP29Q: folds
hpxXcmRkXXI9HE5+5/j/0Q collected $2.50 from pot
hpxXcmRkXXI9HE5+5/j/0Q: doesn't show hand
*** SUMMARY ***
Total pot $2.50 | Rake $0
Seat 1: TSuRyAHnUPCFjP7Z0rEE0w folded before Flop (didn't bet)
Seat 2: 8CAoOzhmB8n3nRFf3V4BTg folded before Flop (didn't bet)
Seat 3: U6tnjwZRpTnM+YkqkCjwyQ (button) folded before Flop (didn't bet)
Seat 4: GDVIsbEJ/DOJsMKE4Asz0A (small blind) folded before Flop
Seat 5: QHvTZcrKe6+maWUfVjP29Q (big blind) folded before Flop
Seat 6: hpxXcmRkXXI9HE5+5/j/0Q collected ($2.50)



PokerStars Game #59938921824:  Hold'em No Limit ($0.50/$1.00) - 2009/07/01 0:26:52 ET
Table 'mmbQQVBTrPdE+wy+s+9VPA' 6-max Seat #6 is the button
Seat 2: ru6SCVvWcWt2SpmUsmArWQ ($28.60 in chips)
Seat 3: wx3sQGkVi2x9wJXuWNHPBw ($111.65 in chips)
Seat 4: RfKnhkJN8HEAuzJpH2Ajdg ($12.75 in chips)
Seat 5: YMJG+F++3Aj6P8dAWda5fw ($99 in chips)
Seat 6: klQ/ufr9lOvfLMdAu0S9cw ($24.10 in chips)
xAU6q2/cwmby2sxmA8VcmA joins the table at seat #1
ru6SCVvWcWt2SpmUsmArWQ: posts small blind $0.50
wx3sQGkVi2x9wJXuWNHPBw: posts big blind $1
*** HOLE CARDS ***
RfKnhkJN8HEAuzJpH2Ajdg: folds
YMJG+F++3Aj6P8dAWda5fw: folds
klQ/ufr9lOvfLMdAu0S9cw: raises $4 to $5
ru6SCVvWcWt2SpmUsmArWQ: folds
wx3sQGkVi2x9wJXuWNHPBw: folds
klQ/ufr9lOvfLMdAu0S9cw collected $2.50 from pot
klQ/ufr9lOvfLMdAu0S9cw: doesn't show hand
*** SUMMARY ***
Total pot $2.50 | Rake $0
Seat 2: ru6SCVvWcWt2SpmUsmArWQ (small blind) folded before Flop
Seat 3: wx3sQGkVi2x9wJXuWNHPBw (big blind) folded before Flop
Seat 4: RfKnhkJN8HEAuzJpH2Ajdg folded before Flop (didn't bet)
Seat 5: YMJG+F++3Aj6P8dAWda5fw folded before Flop (didn't bet)
Seat 6: klQ/ufr9lOvfLMdAu0S9cw (button) collected ($2.50)



PokerStars Game #59938921580:  Hold'em No Limit ($0.50/$1.00) - 2009/07/01 0:26:52 ET
Table 'rmZfTK+oSebeUPJNbWhdAA' 6-max Seat #1 is the button
Seat 1: xAU6q2/cwmby2sxmA8VcmA ($100 in chips)
Seat 2: OigyyiK+tTj1APPIAUmXDA ($89.55 in chips)
Seat 3: 9yjOzGERLaEZS8CZ6YNHFg ($48.80 in chips)
Seat 4: OGMLOcTNYZXZU81au7ztUw ($128.70 in chips)
Seat 6: j7NIOHLZk7V2o9fOioO5ug ($103.50 in chips)
OigyyiK+tTj1APPIAUmXDA: posts small blind $0.50
9yjOzGERLaEZS8CZ6YNHFg: posts big blind $1
+xW7QemQU0Fxs+4TnqBRow: sits out
*** HOLE CARDS ***
OGMLOcTNYZXZU81au7ztUw: folds
j7NIOHLZk7V2o9fOioO5ug: folds
xAU6q2/cwmby2sxmA8VcmA: raises $3 to $4
OigyyiK+tTj1APPIAUmXDA: folds
9yjOzGERLaEZS8CZ6YNHFg: calls $3
*** FLOP *** [2c Th Kd]
9yjOzGERLaEZS8CZ6YNHFg: checks
xAU6q2/cwmby2sxmA8VcmA: bets $6
9yjOzGERLaEZS8CZ6YNHFg: calls $6
*** TURN *** [2c Th Kd] [5c]
9yjOzGERLaEZS8CZ6YNHFg: checks
xAU6q2/cwmby2sxmA8VcmA: bets $16
9yjOzGERLaEZS8CZ6YNHFg: raises $22.80 to $38.80 and is all-in
xAU6q2/cwmby2sxmA8VcmA: calls $22.80
*** RIVER *** [2c Th Kd 5c] [Qc]
*** SHOW DOWN ***
9yjOzGERLaEZS8CZ6YNHFg: shows [Ts Qh] (two pair, Queens and Tens)
xAU6q2/cwmby2sxmA8VcmA: mucks hand
9yjOzGERLaEZS8CZ6YNHFg collected $96.10 from pot
*** SUMMARY ***
Total pot $98.10 | Rake $2
Board [2c Th Kd 5c Qc]
Seat 1: xAU6q2/cwmby2sxmA8VcmA (button) mucked
Seat 2: OigyyiK+tTj1APPIAUmXDA (small blind) folded before Flop
Seat 3: 9yjOzGERLaEZS8CZ6YNHFg (big blind) showed [Ts Qh] and won ($96.10) with two pair, Queens and Tens
Seat 4: OGMLOcTNYZXZU81au7ztUw folded before Flop (didn't bet)
Seat 6: j7NIOHLZk7V2o9fOioO5ug folded before Flop (didn't bet)



PokerStars Game #59938922136:  Hold'em No Limit ($0.50/$1.00) - 2009/07/01 0:26:52 ET
Table 'N2bNCDHL96aCQDvZIh+yQQ' 6-max Seat #6 is the button
Seat 1: iHo1oDbrEVJ8nEGdaPrICw ($144 in chips)
Seat 2: KpnW5CcJ4Mg6MeclfKmLrw ($102 in chips)
Seat 4: uCqEjnxh2/vFBjKYkfTOkw ($163 in chips)
Seat 5: rHlMOfR7kpQQxe+PFQz0xQ ($38.40 in chips)
Seat 6: TSuRyAHnUPCFjP7Z0rEE0w ($100 in chips)
iHo1oDbrEVJ8nEGdaPrICw: posts small blind $0.50
KpnW5CcJ4Mg6MeclfKmLrw: posts big blind $1
*** HOLE CARDS ***
uCqEjnxh2/vFBjKYkfTOkw: calls $1
rHlMOfR7kpQQxe+PFQz0xQ: folds
TSuRyAHnUPCFjP7Z0rEE0w: folds
iHo1oDbrEVJ8nEGdaPrICw: folds
KpnW5CcJ4Mg6MeclfKmLrw: checks
*** FLOP *** [6d 7s 3h]
KpnW5CcJ4Mg6MeclfKmLrw: checks
uCqEjnxh2/vFBjKYkfTOkw: checks
*** TURN *** [6d 7s 3h] [Jc]
KpnW5CcJ4Mg6MeclfKmLrw: checks
uCqEjnxh2/vFBjKYkfTOkw: bets $1
KpnW5CcJ4Mg6MeclfKmLrw: folds
uCqEjnxh2/vFBjKYkfTOkw collected $2.40 from pot
uCqEjnxh2/vFBjKYkfTOkw: doesn't show hand
*** SUMMARY ***
Total pot $2.50 | Rake $0.10
Board [6d 7s 3h Jc]
Seat 1: iHo1oDbrEVJ8nEGdaPrICw (small blind) folded before Flop
Seat 2: KpnW5CcJ4Mg6MeclfKmLrw (big blind) folded on the Turn
Seat 4: uCqEjnxh2/vFBjKYkfTOkw collected ($2.40)
Seat 5: rHlMOfR7kpQQxe+PFQz0xQ folded before Flop (didn't bet)
Seat 6: TSuRyAHnUPCFjP7Z0rEE0w (button) folded before Flop (didn't bet)



PokerStars Game #59938922200:  Hold'em No Limit ($0.50/$1.00) - 2009/07/01 0:26:53 ET
Table '+cA8mcmhaedZ7YcrDdhmeQ' 6-max Seat #5 is the button
Seat 1: lsLuWlcPA3Rh7kJVLzMh0Q ($234 in chips)
Seat 2: trnpu4tPju3BU8W0wQQaiQ ($117.95 in chips)
Seat 3: 0WjiuIT7/EolY1oOx1ngeA ($116.30 in chips)
Seat 5: 6WyjEXOToimYmtLdqIgHYQ ($60 in chips)
Seat 6: YfsTQsY/fxb+YqbdclTHuw ($98.25 in chips)
YfsTQsY/fxb+YqbdclTHuw: posts small blind $0.50
lsLuWlcPA3Rh7kJVLzMh0Q: posts big blind $1
LjL3AIERHn559yyW1mTUYQ: sits out
*** HOLE CARDS ***
trnpu4tPju3BU8W0wQQaiQ: folds
0WjiuIT7/EolY1oOx1ngeA: folds
6WyjEXOToimYmtLdqIgHYQ: folds
YfsTQsY/fxb+YqbdclTHuw: calls $0.50
lsLuWlcPA3Rh7kJVLzMh0Q: checks
*** FLOP *** [5h Th Ts]
YfsTQsY/fxb+YqbdclTHuw: checks
lsLuWlcPA3Rh7kJVLzMh0Q: checks
*** TURN *** [5h Th Ts] [4d]
YfsTQsY/fxb+YqbdclTHuw: checks
lsLuWlcPA3Rh7kJVLzMh0Q: bets $2
YfsTQsY/fxb+YqbdclTHuw: calls $2
*** RIVER *** [5h Th Ts 4d] [7s]
YfsTQsY/fxb+YqbdclTHuw: bets $5
lsLuWlcPA3Rh7kJVLzMh0Q: folds
YfsTQsY/fxb+YqbdclTHuw collected $5.75 from pot
*** SUMMARY ***
Total pot $6 | Rake $0.25
Board [5h Th Ts 4d 7s]
Seat 1: lsLuWlcPA3Rh7kJVLzMh0Q (big blind) folded on the River
Seat 2: trnpu4tPju3BU8W0wQQaiQ folded before Flop (didn't bet)
Seat 3: 0WjiuIT7/EolY1oOx1ngeA folded before Flop (didn't bet)
Seat 5: 6WyjEXOToimYmtLdqIgHYQ (button) folded before Flop (didn't bet)
Seat 6: YfsTQsY/fxb+YqbdclTHuw (small blind) collected ($5.75)



PokerStars Game #59938926090:  Hold'em No Limit ($0.50/$1.00) - 2009/07/01 0:26:58 ET
Table '/RZcOwpZpHQ+OwPwjsbnRw' 6-max Seat #1 is the button
Seat 1: Zboa6dColKGHBjLPUakZjw ($43 in chips)
Seat 2: dHC9PH9hdH3Ad2TD8ZxX0Q ($53.60 in chips)
Seat 3: OigyyiK+tTj1APPIAUmXDA ($74.15 in chips)
Seat 4: j7NIOHLZk7V2o9fOioO5ug ($110.40 in chips)
Seat 5: wx3sQGkVi2x9wJXuWNHPBw ($200.55 in chips)
Seat 6: XOIf9W+VAxhZqN+SYoyMKA ($253.80 in chips)
dHC9PH9hdH3Ad2TD8ZxX0Q: posts small blind $0.50
OigyyiK+tTj1APPIAUmXDA: posts big blind $1
*** HOLE CARDS ***
j7NIOHLZk7V2o9fOioO5ug: folds
wx3sQGkVi2x9wJXuWNHPBw: folds
XOIf9W+VAxhZqN+SYoyMKA: raises $2 to $3
Zboa6dColKGHBjLPUakZjw: folds
dHC9PH9hdH3Ad2TD8ZxX0Q: calls $2.50
OigyyiK+tTj1APPIAUmXDA: folds
*** FLOP *** [As 4c Kc]
dHC9PH9hdH3Ad2TD8ZxX0Q: checks
XOIf9W+VAxhZqN+SYoyMKA: checks
*** TURN *** [As 4c Kc] [5d]
dHC9PH9hdH3Ad2TD8ZxX0Q: checks
XOIf9W+VAxhZqN+SYoyMKA: checks
*** RIVER *** [As 4c Kc 5d] [Qs]
dHC9PH9hdH3Ad2TD8ZxX0Q: bets $4
XOIf9W+VAxhZqN+SYoyMKA: folds
dHC9PH9hdH3Ad2TD8ZxX0Q collected $6.65 from pot
*** SUMMARY ***
Total pot $7 | Rake $0.35
Board [As 4c Kc 5d Qs]
Seat 1: Zboa6dColKGHBjLPUakZjw (button) folded before Flop (didn't bet)
Seat 2: dHC9PH9hdH3Ad2TD8ZxX0Q (small blind) collected ($6.65)
Seat 3: OigyyiK+tTj1APPIAUmXDA (big blind) folded before Flop
Seat 4: j7NIOHLZk7V2o9fOioO5ug folded before Flop (didn't bet)
Seat 5: wx3sQGkVi2x9wJXuWNHPBw folded before Flop (didn't bet)
Seat 6: XOIf9W+VAxhZqN+SYoyMKA folded on the River



PokerStars Game #59938925580:  Hold'em No Limit ($0.50/$1.00) - 2009/07/01 0:26:58 ET
Table 'cBDNutyLBKEk9+ptwsKmTw' 6-max Seat #5 is the button
Seat 1: xAU6q2/cwmby2sxmA8VcmA ($100 in chips)
Seat 2: KyaE4+hWgUNIWWOWy4D14w ($86.60 in chips)
Seat 3: G5ZSSN6RSON3gkNvk/SmYg ($106.40 in chips)
Seat 4: 0WjiuIT7/EolY1oOx1ngeA ($104.65 in chips)
Seat 5: OGMLOcTNYZXZU81au7ztUw ($108.20 in chips)
Seat 6: pyzhFUPPSNzrysiMqlA5Xw ($9.60 in chips)
pyzhFUPPSNzrysiMqlA5Xw: posts small blind $0.50
xAU6q2/cwmby2sxmA8VcmA: posts big blind $1
*** HOLE CARDS ***
KyaE4+hWgUNIWWOWy4D14w: folds
G5ZSSN6RSON3gkNvk/SmYg: folds
0WjiuIT7/EolY1oOx1ngeA: raises $2 to $3
OGMLOcTNYZXZU81au7ztUw: folds
pyzhFUPPSNzrysiMqlA5Xw: folds
xAU6q2/cwmby2sxmA8VcmA: folds
0WjiuIT7/EolY1oOx1ngeA collected $2.50 from pot
0WjiuIT7/EolY1oOx1ngeA: doesn't show hand
*** SUMMARY ***
Total pot $2.50 | Rake $0
Seat 1: xAU6q2/cwmby2sxmA8VcmA (big blind) folded before Flop
Seat 2: KyaE4+hWgUNIWWOWy4D14w folded before Flop (didn't bet)
Seat 3: G5ZSSN6RSON3gkNvk/SmYg folded before Flop (didn't bet)
Seat 4: 0WjiuIT7/EolY1oOx1ngeA collected ($2.50)
Seat 5: OGMLOcTNYZXZU81au7ztUw (button) folded before Flop (didn't bet)
Seat 6: pyzhFUPPSNzrysiMqlA5Xw (small blind) folded before Flop



PokerStars Game #59938929706:  Hold'em No Limit ($0.50/$1.00) - 2009/07/01 0:27:04 ET
Table 'W/wyObTiXZm+Ckkl3YxcSw' 6-max Seat #1 is the button
Seat 1: ssLJburtEIqnVkx6X8R1uw ($115.75 in chips)
Seat 2: oDiBRCaF0QVtd3kO6xZIXw ($103.20 in chips)
Seat 3: b2a+5TkFf4xJN/Ihhma58Q ($34.70 in chips)
Seat 6: 1yB1nHUkHNNY8OJnDNHZMw ($101 in chips)
oDiBRCaF0QVtd3kO6xZIXw: posts small blind $0.50
b2a+5TkFf4xJN/Ihhma58Q: posts big blind $1
+xW7QemQU0Fxs+4TnqBRow: sits out
*** HOLE CARDS ***
1yB1nHUkHNNY8OJnDNHZMw: folds
ssLJburtEIqnVkx6X8R1uw: folds
oDiBRCaF0QVtd3kO6xZIXw: raises $2 to $3
b2a+5TkFf4xJN/Ihhma58Q: folds
oDiBRCaF0QVtd3kO6xZIXw collected $2 from pot
oDiBRCaF0QVtd3kO6xZIXw: doesn't show hand
*** SUMMARY ***
Total pot $2 | Rake $0
Seat 1: ssLJburtEIqnVkx6X8R1uw (button) folded before Flop (didn't bet)
Seat 2: oDiBRCaF0QVtd3kO6xZIXw (small blind) collected ($2)
Seat 3: b2a+5TkFf4xJN/Ihhma58Q (big blind) folded before Flop
Seat 6: 1yB1nHUkHNNY8OJnDNHZMw folded before Flop (didn't bet)



PokerStars Game #59938930584:  Hold'em No Limit ($0.50/$1.00) - 2009/07/01 0:27:05 ET
Table '/FUb199IViHMJHi5YWmeuQ' 9-max Seat #8 is the button
Seat 1: TZcz9MEWDA+WydgGruqqbw ($100 in chips)
Seat 2: FL3MrLspcF23LYvC4ipBOA ($138.75 in chips)
Seat 3: qN483QJ1NvHbdIZB7J4ARw ($77.40 in chips)
Seat 4: qheQay5YvP2DMAb3OUSxtw ($107.30 in chips)
Seat 5: +za1iHiRgVo4OcAz0SOZqw ($15.45 in chips)
Seat 6: ccFf7Q4z1cTGQmeoYiWEfw ($38.50 in chips)
Seat 7: bLbSOSmSOnqE0iTcH/5dxA ($100 in chips)
Seat 8: QIWvt0R766g8KfH0vl1s0A ($46.60 in chips)
Seat 9: knewtTmBc4Tc0z/5tAABYQ ($123.25 in chips)
knewtTmBc4Tc0z/5tAABYQ: posts small blind $0.50
TZcz9MEWDA+WydgGruqqbw: posts big blind $1
*** HOLE CARDS ***
FL3MrLspcF23LYvC4ipBOA: folds
qN483QJ1NvHbdIZB7J4ARw: calls $1
qheQay5YvP2DMAb3OUSxtw has timed out
qheQay5YvP2DMAb3OUSxtw: folds
qheQay5YvP2DMAb3OUSxtw is sitting out
+za1iHiRgVo4OcAz0SOZqw: folds
ccFf7Q4z1cTGQmeoYiWEfw: calls $1
bLbSOSmSOnqE0iTcH/5dxA: folds
QIWvt0R766g8KfH0vl1s0A: folds
knewtTmBc4Tc0z/5tAABYQ: folds
TZcz9MEWDA+WydgGruqqbw: checks
*** FLOP *** [Kc 8s Ks]
TZcz9MEWDA+WydgGruqqbw: checks
qN483QJ1NvHbdIZB7J4ARw: checks
ccFf7Q4z1cTGQmeoYiWEfw: checks
*** TURN *** [Kc 8s Ks] [Td]
TZcz9MEWDA+WydgGruqqbw: checks
qN483QJ1NvHbdIZB7J4ARw: checks
ccFf7Q4z1cTGQmeoYiWEfw: checks
*** RIVER *** [Kc 8s Ks Td] [6h]
TZcz9MEWDA+WydgGruqqbw: checks
qN483QJ1NvHbdIZB7J4ARw: checks
ccFf7Q4z1cTGQmeoYiWEfw: checks
*** SHOW DOWN ***
TZcz9MEWDA+WydgGruqqbw: shows [Tc 2h] (two pair, Kings and Tens)
qN483QJ1NvHbdIZB7J4ARw: mucks hand
ccFf7Q4z1cTGQmeoYiWEfw: mucks hand
TZcz9MEWDA+WydgGruqqbw collected $3.35 from pot
*** SUMMARY ***
Total pot $3.50 | Rake $0.15
Board [Kc 8s Ks Td 6h]
Seat 1: TZcz9MEWDA+WydgGruqqbw (big blind) showed [Tc 2h] and won ($3.35) with two pair, Kings and Tens
Seat 2: FL3MrLspcF23LYvC4ipBOA folded before Flop (didn't bet)
Seat 3: qN483QJ1NvHbdIZB7J4ARw mucked
Seat 4: qheQay5YvP2DMAb3OUSxtw folded before Flop (didn't bet)
Seat 5: +za1iHiRgVo4OcAz0SOZqw folded before Flop (didn't bet)
Seat 6: ccFf7Q4z1cTGQmeoYiWEfw mucked
Seat 7: bLbSOSmSOnqE0iTcH/5dxA folded before Flop (didn't bet)
Seat 8: QIWvt0R766g8KfH0vl1s0A (button) folded before Flop (didn't bet)
Seat 9: knewtTmBc4Tc0z/5tAABYQ (small blind) folded before Flop



PokerStars Game #59938931444:  Hold'em No Limit ($0.50/$1.00) - 2009/07/01 0:27:06 ET
Table 'tyUh+jyNvrceIQdKMJjQ2wZFWj23PMihdwrNWv41OG/Qeat #4 is the button
Seat 2: 6iVcnPw9a2oNG6sPQo3G6g ($98.50 in chips)
Seat 3: L9qfLYXrczhAPd/VckgsWw ($41.20 in chips)
Seat 4: TSuRyAHnUPCFjP7Z0rEE0w ($132.45 in chips)
Seat 5: j7NIOHLZk7V2o9fOioO5ug ($102.95 in chips)
Seat 6: YsLQ3BAvgQHWXMAv3Wv6Hg ($105.25 in chips)
j7NIOHLZk7V2o9fOioO5ug: posts small blind $0.50
YsLQ3BAvgQHWXMAv3Wv6Hg: posts big blind $1
*** HOLE CARDS ***
6iVcnPw9a2oNG6sPQo3G6g: folds
L9qfLYXrczhAPd/VckgsWw: folds
TSuRyAHnUPCFjP7Z0rEE0w: folds
j7NIOHLZk7V2o9fOioO5ug: raises $3 to $4
YsLQ3BAvgQHWXMAv3Wv6Hg: folds
j7NIOHLZk7V2o9fOioO5ug collected $2 from pot
j7NIOHLZk7V2o9fOioO5ug: doesn't show hand
*** SUMMARY ***
Total pot $2 | Rake $0
Seat 2: 6iVcnPw9a2oNG6sPQo3G6g folded before Flop (didn't bet)
Seat 3: L9qfLYXrczhAPd/VckgsWw folded before Flop (didn't bet)
Seat 4: TSuRyAHnUPCFjP7Z0rEE0w (button) folded before Flop (didn't bet)
Seat 5: j7NIOHLZk7V2o9fOioO5ug (small blind) collected ($2)
Seat 6: YsLQ3BAvgQHWXMAv3Wv6Hg (big blind) folded before Flop



PokerStars Game #59938931976:  Hold'em No Limit ($0.50/$1.00) - 2009/07/01 0:27:07 ET
Table 'ZFWj23PMihdwrNWv41OG/Q' 9-max Seat #4 is the button
Seat 1: yAbu2QsRPVcjPbqlf/jDxw ($101.80 in chips)
Seat 2: ARfmgHcEUKh68laBZy4veA ($50.25 in chips)
Seat 3: G9Fo2TZCN7HI43Po4zSN3A ($102 in chips)
Seat 4: PEmogYqKpuv0ozeBbXL+7Q ($35 in chips)
Seat 5: tkdBeXTJlFsZdioidNqLow ($60 in chips)
Seat 6: tjhwe1V98x2spSoUQER3HQ ($100 in chips)
Seat 7: wIZ377kjl2fHFGnS93o6bw ($23.95 in chips)
Seat 8: knewtTmBc4Tc0z/5tAABYQ ($107.50 in chips)
Seat 9: l4m/wWPs22DSP5xpszjXKA ($44.25 in chips)
tkdBeXTJlFsZdioidNqLow: posts small blind $0.50
tjhwe1V98x2spSoUQER3HQ: posts big blind $1
*** HOLE CARDS ***
wIZ377kjl2fHFGnS93o6bw: folds
knewtTmBc4Tc0z/5tAABYQ: folds
l4m/wWPs22DSP5xpszjXKA: folds
yAbu2QsRPVcjPbqlf/jDxw: folds
ARfmgHcEUKh68laBZy4veA: folds
G9Fo2TZCN7HI43Po4zSN3A: raises $2 to $3
PEmogYqKpuv0ozeBbXL+7Q: folds
tkdBeXTJlFsZdioidNqLow: folds
tjhwe1V98x2spSoUQER3HQ: folds
G9Fo2TZCN7HI43Po4zSN3A collected $2.50 from pot
G9Fo2TZCN7HI43Po4zSN3A: doesn't show hand
*** SUMMARY ***
Total pot $2.50 | Rake $0
Seat 1: yAbu2QsRPVcjPbqlf/jDxw folded before Flop (didn't bet)
Seat 2: ARfmgHcEUKh68laBZy4veA folded before Flop (didn't bet)
Seat 3: G9Fo2TZCN7HI43Po4zSN3A collected ($2.50)
Seat 4: PEmogYqKpuv0ozeBbXL+7Q (button) folded before Flop (didn't bet)
Seat 5: tkdBeXTJlFsZdioidNqLow (small blind) folded before Flop
Seat 6: tjhwe1V98x2spSoUQER3HQ (big blind) folded before Flop
Seat 7: wIZ377kjl2fHFGnS93o6bw folded before Flop (didn't bet)
Seat 8: knewtTmBc4Tc0z/5tAABYQ folded before Flop (didn't bet)
Seat 9: l4m/wWPs22DSP5xpszjXKA folded before Flop (didn't bet)



PokerStars Game #59938932396:  Hold'em No Limit ($0.50/$1.00) - 2009/07/01 0:27:08 ET
Table 'eU3bWpDDg3Z+9R4m4iVmog' 6-max Seat #4 is the button
Seat 1: TSuRyAHnUPCFjP7Z0rEE0w ($177.50 in chips)
Seat 2: 8CAoOzhmB8n3nRFf3V4BTg ($140.45 in chips)
Seat 3: U6tnjwZRpTnM+YkqkCjwyQ ($155.95 in chips)
Seat 4: GDVIsbEJ/DOJsMKE4Asz0A ($98 in chips)
Seat 5: QHvTZcrKe6+maWUfVjP29Q ($101 in chips)
Seat 6: hpxXcmRkXXI9HE5+5/j/0Q ($101.50 in chips)
QHvTZcrKe6+maWUfVjP29Q: posts small blind $0.50
hpxXcmRkXXI9HE5+5/j/0Q: posts big blind $1
*** HOLE CARDS ***
TSuRyAHnUPCFjP7Z0rEE0w: folds
8CAoOzhmB8n3nRFf3V4BTg: folds
U6tnjwZRpTnM+YkqkCjwyQ: folds
GDVIsbEJ/DOJsMKE4Asz0A: folds
QHvTZcrKe6+maWUfVjP29Q: folds
hpxXcmRkXXI9HE5+5/j/0Q collected $1 from pot
hpxXcmRkXXI9HE5+5/j/0Q: doesn't show hand
*** SUMMARY ***
Total pot $1 | Rake $0
Seat 1: TSuRyAHnUPCFjP7Z0rEE0w folded before Flop (didn't bet)
Seat 2: 8CAoOzhmB8n3nRFf3V4BTg folded before Flop (didn't bet)
Seat 3: U6tnjwZRpTnM+YkqkCjwyQ folded before Flop (didn't bet)
Seat 4: GDVIsbEJ/DOJsMKE4Asz0A (button) folded before Flop (didn't bet)
Seat 5: QHvTZcrKe6+maWUfVjP29Q (small blind) folded before Flop
Seat 6: hpxXcmRkXXI9HE5+5/j/0Q (big blind) collected ($1)



PokerStars Game #59938933372:  Hold'em No Limit ($0.50/$1.00) - 2009/07/01 0:27:09 ET
Table 'MUPc8FEpe/nR0BKSeReX6Q' 6-max Seat #3 is the button
Seat 1: YsLQ3BAvgQHWXMAv3Wv6Hg ($100 in chips)
Seat 2: xAU6q2/cwmby2sxmA8VcmA ($110.50 in chips)
Seat 3: wx3sQGkVi2x9wJXuWNHPBw ($234.05 in chips)
Seat 4: ZA1bp6g8IwtTxkUE4eCjDQ ($106.80 in chips)
Seat 5: UBZQqpnJZdTYYY1FTb0rLA ($100 in chips)
Seat 6: oxnw0GLLpFanjhGkxfRSqA ($53.60 in chips)
ZA1bp6g8IwtTxkUE4eCjDQ: posts small blind $0.50
UBZQqpnJZdTYYY1FTb0rLA: posts big blind $1
*** HOLE CARDS ***
oxnw0GLLpFanjhGkxfRSqA: folds
YsLQ3BAvgQHWXMAv3Wv6Hg: raises $3 to $4
xAU6q2/cwmby2sxmA8VcmA: folds
wx3sQGkVi2x9wJXuWNHPBw: folds
ZA1bp6g8IwtTxkUE4eCjDQ: folds
UBZQqpnJZdTYYY1FTb0rLA: folds
YsLQ3BAvgQHWXMAv3Wv6Hg collected $2.50 from pot
YsLQ3BAvgQHWXMAv3Wv6Hg: doesn't show hand
*** SUMMARY ***
Total pot $2.50 | Rake $0
Seat 1: YsLQ3BAvgQHWXMAv3Wv6Hg collected ($2.50)
Seat 2: xAU6q2/cwmby2sxmA8VcmA folded before Flop (didn't bet)
Seat 3: wx3sQGkVi2x9wJXuWNHPBw (button) folded before Flop (didn't bet)
Seat 4: ZA1bp6g8IwtTxkUE4eCjDQ (small blind) folded before Flop
Seat 5: UBZQqpnJZdTYYY1FTb0rLA (big blind) folded before Flop
Seat 6: oxnw0GLLpFanjhGkxfRSqA folded before Flop (didn't bet)



PokerStars Game #59938935332:  Hold'em No Limit ($0.50/$1.00) - 2009/07/01 0:27:12 ET
Table 'tLrtq7gDzxEvckNAI1OS5Q' 6-max Seat #2 is the button
Seat 1: GisIe1kcC9q/xV6ifsTjgA ($147.35 in chips)
Seat 2: qsObMEIlRO22OlS867m/lw ($15.80 in chips)
Seat 3: TPZ+m9x+lwoKpv7TMfAUWA ($325.30 in chips)
Seat 4: KOG8rG51mOvIoY96zF3kvw ($163.30 in chips)
Seat 5: OGMLOcTNYZXZU81au7ztUw ($166.45 in chips)
Seat 6: XUk5GQsfNFpHvaToDZ0rZA ($43.45 in chips)
TPZ+m9x+lwoKpv7TMfAUWA: posts small blind $0.50
KOG8rG51mOvIoY96zF3kvw: posts big blind $1
*** HOLE CARDS ***
OGMLOcTNYZXZU81au7ztUw: folds
XUk5GQsfNFpHvaToDZ0rZA: raises $2 to $3
GisIe1kcC9q/xV6ifsTjgA: folds
qsObMEIlRO22OlS867m/lw: folds
TPZ+m9x+lwoKpv7TMfAUWA: calls $2.50
KOG8rG51mOvIoY96zF3kvw: folds
*** FLOP *** [Kc 7c Jh]
TPZ+m9x+lwoKpv7TMfAUWA: checks
XUk5GQsfNFpHvaToDZ0rZA: checks
*** TURN *** [Kc 7c Jh] [9d]
TPZ+m9x+lwoKpv7TMfAUWA: bets $4
XUk5GQsfNFpHvaToDZ0rZA: calls $4
*** RIVER *** [Kc 7c Jh 9d] [Ah]
TPZ+m9x+lwoKpv7TMfAUWA: checks
XUk5GQsfNFpHvaToDZ0rZA: bets $6
TPZ+m9x+lwoKpv7TMfAUWA: folds
XUk5GQsfNFpHvaToDZ0rZA collected $14.30 from pot
XUk5GQsfNFpHvaToDZ0rZA: doesn't show hand
*** SUMMARY ***
Total pot $15 | Rake $0.70
Board [Kc 7c Jh 9d Ah]
Seat 1: GisIe1kcC9q/xV6ifsTjgA folded before Flop (didn't bet)
Seat 2: qsObMEIlRO22OlS867m/lw (button) folded before Flop (didn't bet)
Seat 3: TPZ+m9x+lwoKpv7TMfAUWA (small blind) folded on the River
Seat 4: KOG8rG51mOvIoY96zF3kvw (big blind) folded before Flop
Seat 5: OGMLOcTNYZXZU81au7ztUw folded before Flop (didn't bet)
Seat 6: XUk5GQsfNFpHvaToDZ0rZA collected ($14.30)



PokerStars Game #59938935370:  Hold'em No Limit ($0.50/$1.00) - 2009/07/01 0:27:12 ET
Table 'SQLOQoANiHscJ8AL7zffbw' 9-max Seat #2 is the button
Seat 1: jPTRd6SpCp4xqAy2XQiTOw ($101.85 in chips)
Seat 2: /zy+DB4S5fUQUSfZWFzYGw ($280.35 in chips)
Seat 3: 0eFnow7+D7veCYQ+CG9FFw ($70.50 in chips)
Seat 4: N9n5Wc3s35DpCrOAUUNAaQ ($119.30 in chips)
Seat 5: L9njYvloJ1NdXjP8edHEAg ($110.55 in chips)
Seat 6: p5UKaxVobvptF0ANhR/q1A ($157 in chips)
Seat 7: bJckevFOcg//s0qyMQI6sQ ($103.55 in chips)
Seat 8: 9ce+0Dl3d0BeEFIP+8HezA ($18.50 in chips)
Seat 9: qJr25HAtvv1w/7IBvjMM3g ($234.35 in chips)
0eFnow7+D7veCYQ+CG9FFw: posts small blind $0.50
N9n5Wc3s35DpCrOAUUNAaQ: posts big blind $1
*** HOLE CARDS ***
L9njYvloJ1NdXjP8edHEAg: folds
p5UKaxVobvptF0ANhR/q1A: folds
bJckevFOcg//s0qyMQI6sQ: folds
9ce+0Dl3d0BeEFIP+8HezA: folds
qJr25HAtvv1w/7IBvjMM3g: folds
jPTRd6SpCp4xqAy2XQiTOw: folds
/zy+DB4S5fUQUSfZWFzYGw: raises $2 to $3
0eFnow7+D7veCYQ+CG9FFw: folds
N9n5Wc3s35DpCrOAUUNAaQ: folds
/zy+DB4S5fUQUSfZWFzYGw collected $2.50 from pot
*** SUMMARY ***
Total pot $2.50 | Rake $0
Seat 1: jPTRd6SpCp4xqAy2XQiTOw folded before Flop (didn't bet)
Seat 2: /zy+DB4S5fUQUSfZWFzYGw (button) collected ($2.50)
Seat 3: 0eFnow7+D7veCYQ+CG9FFw (small blind) folded before Flop
Seat 4: N9n5Wc3s35DpCrOAUUNAaQ (big blind) folded before Flop
Seat 5: L9njYvloJ1NdXjP8edHEAg folded before Flop (didn't bet)
Seat 6: p5UKaxVobvptF0ANhR/q1A folded before Flop (didn't bet)
Seat 7: bJckevFOcg//s0qyMQI6sQ folded before Flop (didn't bet)
Seat 8: 9ce+0Dl3d0BeEFIP+8HezA folded before Flop (didn't bet)
Seat 9: qJr25HAtvv1w/7IBvjMM3g folded before Flop (didn't bet)



PokerStars Game #59938935764:  Hold'em No Limit ($0.50/$1.00) - 2009/07/01 0:27:13 ET
Table 'O96CPOtvMBWP6kzuYDfdFA' 6-max Seat #2 is the button
Seat 2: vTUNrd/7qIOJpW0suEu5hQ ($209.40 in chips)
Seat 3: V89DGjxE171oPREEbAXiyg ($26.75 in chips)
Seat 5: wRxiu9OJzvvN84OYWW9jxQ ($133.25 in chips)
Seat 6: xNKcQzD9+/iHmtJn4vYq9w ($140.15 in chips)
V89DGjxE171oPREEbAXiyg: posts small blind $0.50
wRxiu9OJzvvN84OYWW9jxQ: posts big blind $1
KOG8rG51mOvIoY96zF3kvw has returned
*** HOLE CARDS ***
xNKcQzD9+/iHmtJn4vYq9w: folds
vTUNrd/7qIOJpW0suEu5hQ: raises $2 to $3
V89DGjxE171oPREEbAXiyg: calls $2.50
yl9aRDw7k/ieGiDoJVy+/w leaves the table
wRxiu9OJzvvN84OYWW9jxQ: folds
*** FLOP *** [3c Ac Qc]
V89DGjxE171oPREEbAXiyg: checks
vTUNrd/7qIOJpW0suEu5hQ: bets $3
V89DGjxE171oPREEbAXiyg: raises $6 to $9
esuark2007 joins the table at seat #1
esuark2007 is sitting out
vTUNrd/7qIOJpW0suEu5hQ: folds
V89DGjxE171oPREEbAXiyg collected $12.40 from pot
*** SUMMARY ***
Total pot $13 | Rake $0.60
Board [3c Ac Qc]
Seat 2: vTUNrd/7qIOJpW0suEu5hQ (button) folded on the Flop
Seat 3: V89DGjxE171oPREEbAXiyg (small blind) collected ($12.40)
Seat 5: wRxiu9OJzvvN84OYWW9jxQ (big blind) folded before Flop
Seat 6: xNKcQzD9+/iHmtJn4vYq9w folded before Flop (didn't bet)



PokerStars Game #59938937762:  Hold'em No Limit ($0.50/$1.00) - 2009/07/01 0:27:16 ET
Table '8jIjWCPY0NGprquL+xcMFg' 9-max Seat #1 is the button
Seat 1: vR4IO10geOgvTW+LAUBv/A ($133.65 in chips)
Seat 2: rR1qGAf9Q9RYorKYWH3VKw ($20.15 in chips)
Seat 3: 58zdeSBSuSFX/qZfhc7YmA ($109.95 in chips)
Seat 4: by0z+YmujwI6Bf4qRFE8vA ($118.10 in chips)
Seat 5: n758Yw8Hx2S+6NQUPGqcqA ($88.50 in chips)
Seat 6: GTQkFJtSkbVbnGCktp6e3g ($100.90 in chips)
Seat 7: O3CGPwwUmamrCNHccOilrg ($34.35 in chips)
Seat 8: 9swGhtpERPngKPtvpoZkoQ ($152.80 in chips)
Seat 9: negfosHnGOZXSHpWDRKyBQ ($18.50 in chips)
rR1qGAf9Q9RYorKYWH3VKw: posts small blind $0.50
58zdeSBSuSFX/qZfhc7YmA: posts big blind $1
*** HOLE CARDS ***
by0z+YmujwI6Bf4qRFE8vA: folds
n758Yw8Hx2S+6NQUPGqcqA: folds
GTQkFJtSkbVbnGCktp6e3g: folds
O3CGPwwUmamrCNHccOilrg: calls $1
9swGhtpERPngKPtvpoZkoQ: folds
negfosHnGOZXSHpWDRKyBQ: folds
vR4IO10geOgvTW+LAUBv/A: folds
rR1qGAf9Q9RYorKYWH3VKw: raises $1 to $2
58zdeSBSuSFX/qZfhc7YmA: folds
O3CGPwwUmamrCNHccOilrg: calls $1
*** FLOP *** [Qd 5d 7c]
rR1qGAf9Q9RYorKYWH3VKw: bets $3
O3CGPwwUmamrCNHccOilrg: raises $3 to $6
rR1qGAf9Q9RYorKYWH3VKw: calls $3
*** TURN *** [Qd 5d 7c] [6h]
rR1qGAf9Q9RYorKYWH3VKw: checks
O3CGPwwUmamrCNHccOilrg: bets $4
rR1qGAf9Q9RYorKYWH3VKw: calls $4
*** RIVER *** [Qd 5d 7c 6h] [9c]
rR1qGAf9Q9RYorKYWH3VKw: checks
O3CGPwwUmamrCNHccOilrg: bets $4
rR1qGAf9Q9RYorKYWH3VKw: folds
O3CGPwwUmamrCNHccOilrg collected $23.80 from pot
O3CGPwwUmamrCNHccOilrg: doesn't show hand
*** SUMMARY ***
Total pot $25 | Rake $1.20
Board [Qd 5d 7c 6h 9c]
Seat 1: vR4IO10geOgvTW+LAUBv/A (button) folded before Flop (didn't bet)
Seat 2: rR1qGAf9Q9RYorKYWH3VKw (small blind) folded on the River
Seat 3: 58zdeSBSuSFX/qZfhc7YmA (big blind) folded before Flop
Seat 4: by0z+YmujwI6Bf4qRFE8vA folded before Flop (didn't bet)
Seat 5: n758Yw8Hx2S+6NQUPGqcqA folded before Flop (didn't bet)
Seat 6: GTQkFJtSkbVbnGCktp6e3g folded before Flop (didn't bet)
Seat 7: O3CGPwwUmamrCNHccOilrg collected ($23.80)
Seat 8: 9swGhtpERPngKPtvpoZkoQ folded before Flop (didn't bet)
Seat 9: negfosHnGOZXSHpWDRKyBQ folded before Flop (didn't bet)



PokerStars Game #59938938664:  Hold'em No Limit ($0.50/$1.00) - 2009/07/01 0:27:17 ET
Table 'VOs36P6NW+QyXeQ1B62kmA' 6-max Seat #3 is the button
Seat 1: AdLVjddOzm+sRNo1Bc3S6Q ($137.05 in chips)
Seat 2: KpnW5CcJ4Mg6MeclfKmLrw ($108.30 in chips)
Seat 3: TSuRyAHnUPCFjP7Z0rEE0w ($105.55 in chips)
Seat 4: w02zQzNydODiyV9THKgo9w ($32.65 in chips)
Seat 5: X7GlkHF+lkbarCLuZ4Uf0w ($21 in chips)
Seat 6: 6tvjsJrdmWg+g7FVrMnzXA ($73.10 in chips)
w02zQzNydODiyV9THKgo9w: posts small blind $0.50
X7GlkHF+lkbarCLuZ4Uf0w: posts big blind $1
*** HOLE CARDS ***
6tvjsJrdmWg+g7FVrMnzXA: folds
AdLVjddOzm+sRNo1Bc3S6Q: folds
KpnW5CcJ4Mg6MeclfKmLrw: raises $2 to $3
TSuRyAHnUPCFjP7Z0rEE0w: calls $3
w02zQzNydODiyV9THKgo9w: calls $2.50
X7GlkHF+lkbarCLuZ4Uf0w: folds
*** FLOP *** [5s 4h Tc]
w02zQzNydODiyV9THKgo9w: checks
KpnW5CcJ4Mg6MeclfKmLrw: bets $6
TSuRyAHnUPCFjP7Z0rEE0w: folds
w02zQzNydODiyV9THKgo9w: folds
KpnW5CcJ4Mg6MeclfKmLrw collected $9.50 from pot
KpnW5CcJ4Mg6MeclfKmLrw: doesn't show hand
*** SUMMARY ***
Total pot $10 | Rake $0.50
Board [5s 4h Tc]
Seat 1: AdLVjddOzm+sRNo1Bc3S6Q folded before Flop (didn't bet)
Seat 2: KpnW5CcJ4Mg6MeclfKmLrw collected ($9.50)
Seat 3: TSuRyAHnUPCFjP7Z0rEE0w (button) folded on the Flop
Seat 4: w02zQzNydODiyV9THKgo9w (small blind) folded on the Flop
Seat 5: X7GlkHF+lkbarCLuZ4Uf0w (big blind) folded before Flop
Seat 6: 6tvjsJrdmWg+g7FVrMnzXA folded before Flop (didn't bet)



PokerStars Game #59938939266:  Hold'em No Limit ($0.50/$1.00) - 2009/07/01 0:27:18 ET
Table '7Nl0ffnjeK44/vmeexh3MQ' 9-max Seat #2 is the button
Seat 1: s7D3Y+k4Cj4D1cXHv7oj+Q ($98.65 in chips)
Seat 2: kiakSwxX0e64PwYGAPQvLw ($31.85 in chips)
Seat 5: bL+QVeDcuEdzMGAGg2XJHg ($114.45 in chips)
Seat 6: FVs16t7GgfWgQWt4JxsObQ ($9.55 in chips)
Seat 7: knewtTmBc4Tc0z/5tAABYQ ($106.50 in chips)
Seat 8: zanka7aAZkigmZpfopXxxA ($225 in chips)
Seat 9: ouwUBGRKnKK9uhn1G4Lf+A ($98.50 in chips)
200876 will be allowed to play after the button
bLbSOSmSOnqE0iTcH/5dxA will be allowed to play after the button
bL+QVeDcuEdzMGAGg2XJHg: posts small blind $0.50
FVs16t7GgfWgQWt4JxsObQ: posts big blind $1
*** HOLE CARDS ***
200876 leaves the table
knewtTmBc4Tc0z/5tAABYQ: folds
zanka7aAZkigmZpfopXxxA: raises $2 to $3
ouwUBGRKnKK9uhn1G4Lf+A: folds
s7D3Y+k4Cj4D1cXHv7oj+Q: folds
kiakSwxX0e64PwYGAPQvLw: folds
bL+QVeDcuEdzMGAGg2XJHg: folds
FVs16t7GgfWgQWt4JxsObQ: calls $2
*** FLOP *** [8s Ts Kh]
vR4IO10geOgvTW+LAUBv/A joins the table at seat #3
FVs16t7GgfWgQWt4JxsObQ: checks
zanka7aAZkigmZpfopXxxA: bets $4
FVs16t7GgfWgQWt4JxsObQ: folds
zanka7aAZkigmZpfopXxxA collected $6.20 from pot
zanka7aAZkigmZpfopXxxA: doesn't show hand
*** SUMMARY ***
Total pot $6.50 | Rake $0.30
Board [8s Ts Kh]
Seat 1: s7D3Y+k4Cj4D1cXHv7oj+Q folded before Flop (didn't bet)
Seat 2: kiakSwxX0e64PwYGAPQvLw (button) folded before Flop (didn't bet)
Seat 5: bL+QVeDcuEdzMGAGg2XJHg (small blind) folded before Flop
Seat 6: FVs16t7GgfWgQWt4JxsObQ (big blind) folded on the Flop
Seat 7: knewtTmBc4Tc0z/5tAABYQ folded before Flop (didn't bet)
Seat 8: zanka7aAZkigmZpfopXxxA collected ($6.20)
Seat 9: ouwUBGRKnKK9uhn1G4Lf+A folded before Flop (didn't bet)



PokerStars Game #59938939028:  Hold'em No Limit ($0.50/$1.00) - 2009/07/01 0:27:18 ET
Table 'Zka9tv1yilg0MvXWPQrShg' 9-max Seat #4 is the button
Seat 1: TZcz9MEWDA+WydgGruqqbw ($109.90 in chips)
Seat 2: rR1qGAf9Q9RYorKYWH3VKw ($21.50 in chips)
Seat 3: gUUvmqdVlmvpal6B8nYrmg ($101 in chips)
Seat 4: CTOae+JLIGfwfXvhqHkP2w ($170.65 in chips)
Seat 5: /zy+DB4S5fUQUSfZWFzYGw ($140.45 in chips)
Seat 6: rY8wPoax1lS+HUY+I0FZDw ($128.40 in chips)
Seat 7: p1SafS90nb3Uft5LB0NkHw ($21.50 in chips)
Seat 8: bL+QVeDcuEdzMGAGg2XJHg ($124.60 in chips)
/zy+DB4S5fUQUSfZWFzYGw: posts small blind $0.50
rY8wPoax1lS+HUY+I0FZDw: posts big blind $1
*** HOLE CARDS ***
p1SafS90nb3Uft5LB0NkHw: folds
bL+QVeDcuEdzMGAGg2XJHg: folds
TZcz9MEWDA+WydgGruqqbw: folds
rR1qGAf9Q9RYorKYWH3VKw: folds
gUUvmqdVlmvpal6B8nYrmg: folds
CTOae+JLIGfwfXvhqHkP2w: folds
/zy+DB4S5fUQUSfZWFzYGw: folds
rY8wPoax1lS+HUY+I0FZDw collected $1 from pot
*** SUMMARY ***
Total pot $1 | Rake $0
Seat 1: TZcz9MEWDA+WydgGruqqbw folded before Flop (didn't bet)
Seat 2: rR1qGAf9Q9RYorKYWH3VKw folded before Flop (didn't bet)
Seat 3: gUUvmqdVlmvpal6B8nYrmg folded before Flop (didn't bet)
Seat 4: CTOae+JLIGfwfXvhqHkP2w (button) folded before Flop (didn't bet)
Seat 5: /zy+DB4S5fUQUSfZWFzYGw (small blind) folded before Flop
Seat 6: rY8wPoax1lS+HUY+I0FZDw (big blind) collected ($1)
Seat 7: p1SafS90nb3Uft5LB0NkHw folded before Flop (didn't bet)
Seat 8: bL+QVeDcuEdzMGAGg2XJHg folded before Flop (didn't bet)



PokerStars Game #59938938994:  Hold'em No Limit ($0.50/$1.00) - 2009/07/01 0:27:18 ET
Table 'b/mVBMBBjZR4F+Jsv8cuYA' 9-max Seat #2 is the button
Seat 2: HPmAhANyB1+4MGzYS9i5Wg ($32.60 in chips)
Seat 3: x80+i7DJL+81v3quj7KbNg ($20.90 in chips)
Seat 4: 0oXWlMUwwWciWdZOQf6yUw ($79.95 in chips)
Seat 5: p5UKaxVobvptF0ANhR/q1A ($100 in chips)
Seat 6: FL3MrLspcF23LYvC4ipBOA ($316.10 in chips)
Seat 7: 5GtqC1O4Y1t1VmP51SDSJQ ($102 in chips)
Seat 8: L9njYvloJ1NdXjP8edHEAg ($102.50 in chips)
Seat 9: 9BZCcac3+McErkkSN2YScA ($112.45 in chips)
x80+i7DJL+81v3quj7KbNg: posts small blind $0.50
0oXWlMUwwWciWdZOQf6yUw: posts big blind $1
*** HOLE CARDS ***
p5UKaxVobvptF0ANhR/q1A: folds
FL3MrLspcF23LYvC4ipBOA: folds
5GtqC1O4Y1t1VmP51SDSJQ: raises $3 to $4
L9njYvloJ1NdXjP8edHEAg: folds
9BZCcac3+McErkkSN2YScA: calls $4
HPmAhANyB1+4MGzYS9i5Wg: folds
x80+i7DJL+81v3quj7KbNg: raises $3 to $7
0oXWlMUwwWciWdZOQf6yUw: calls $6
5GtqC1O4Y1t1VmP51SDSJQ: calls $3
9BZCcac3+McErkkSN2YScA: calls $3
*** FLOP *** [6c 3s 9s]
x80+i7DJL+81v3quj7KbNg: checks
0oXWlMUwwWciWdZOQf6yUw: checks
5GtqC1O4Y1t1VmP51SDSJQ: bets $4
rocketspleas joins the table at seat #1
9BZCcac3+McErkkSN2YScA: folds
x80+i7DJL+81v3quj7KbNg: raises $9.90 to $13.90 and is all-in
0oXWlMUwwWciWdZOQf6yUw: folds
5GtqC1O4Y1t1VmP51SDSJQ: calls $9.90
*** TURN *** [6c 3s 9s] [9h]
*** RIVER *** [6c 3s 9s 9h] [4d]
*** SHOW DOWN ***
x80+i7DJL+81v3quj7KbNg: shows [7c 5h] (a straight, Three to Seven)
5GtqC1O4Y1t1VmP51SDSJQ: mucks hand
x80+i7DJL+81v3quj7KbNg collected $53.10 from pot
*** SUMMARY ***
Total pot $55.80 | Rake $2.70
Board [6c 3s 9s 9h 4d]
Seat 2: HPmAhANyB1+4MGzYS9i5Wg (button) folded before Flop (didn't bet)
Seat 3: x80+i7DJL+81v3quj7KbNg (small blind) showed [7c 5h] and won ($53.10) with a straight, Three to Seven
Seat 4: 0oXWlMUwwWciWdZOQf6yUw (big blind) folded on the Flop
Seat 5: p5UKaxVobvptF0ANhR/q1A folded before Flop (didn't bet)
Seat 6: FL3MrLspcF23LYvC4ipBOA folded before Flop (didn't bet)
Seat 7: 5GtqC1O4Y1t1VmP51SDSJQ mucked
Seat 8: L9njYvloJ1NdXjP8edHEAg folded before Flop (didn't bet)
Seat 9: 9BZCcac3+McErkkSN2YScA folded on the Flop



PokerStars Game #59938939380:  Hold'em No Limit ($0.50/$1.00) - 2009/07/01 0:27:19 ET
Table 'vs/5jr6ciwjVQ5+Soc+u2A' 6-max Seat #2 is the button
Seat 2: XOIf9W+VAxhZqN+SYoyMKA ($120.30 in chips)
Seat 3: G5ZSSN6RSON3gkNvk/SmYg ($100 in chips)
Seat 4: KpnW5CcJ4Mg6MeclfKmLrw ($116.80 in chips)
Seat 5: 7Vc9JmGFQwMRh5Tj9ui5Lw ($81.15 in chips)
Seat 6: QHvTZcrKe6+maWUfVjP29Q ($105.50 in chips)
G5ZSSN6RSON3gkNvk/SmYg: posts small blind $0.50
KpnW5CcJ4Mg6MeclfKmLrw: posts big blind $1
*** HOLE CARDS ***
7Vc9JmGFQwMRh5Tj9ui5Lw: calls $1
QHvTZcrKe6+maWUfVjP29Q: raises $4 to $5
XOIf9W+VAxhZqN+SYoyMKA: folds
G5ZSSN6RSON3gkNvk/SmYg: folds
KpnW5CcJ4Mg6MeclfKmLrw: folds
7Vc9JmGFQwMRh5Tj9ui5Lw: calls $4
*** FLOP *** [Td 2s 9h]
7Vc9JmGFQwMRh5Tj9ui5Lw: checks
QHvTZcrKe6+maWUfVjP29Q: bets $7
7Vc9JmGFQwMRh5Tj9ui5Lw: calls $7
*** TURN *** [Td 2s 9h] [2h]
7Vc9JmGFQwMRh5Tj9ui5Lw: checks
QHvTZcrKe6+maWUfVjP29Q: checks
*** RIVER *** [Td 2s 9h 2h] [6s]
7Vc9JmGFQwMRh5Tj9ui5Lw: checks
QHvTZcrKe6+maWUfVjP29Q: checks
*** SHOW DOWN ***
7Vc9JmGFQwMRh5Tj9ui5Lw: shows [Jc 9c] (two pair, Nines and Deuces)
QHvTZcrKe6+maWUfVjP29Q: mucks hand
7Vc9JmGFQwMRh5Tj9ui5Lw collected $24.30 from pot
*** SUMMARY ***
Total pot $25.50 | Rake $1.20
Board [Td 2s 9h 2h 6s]
Seat 2: XOIf9W+VAxhZqN+SYoyMKA (button) folded before Flop (didn't bet)
Seat 3: G5ZSSN6RSON3gkNvk/SmYg (small blind) folded before Flop
Seat 4: KpnW5CcJ4Mg6MeclfKmLrw (big blind) folded before Flop
Seat 5: 7Vc9JmGFQwMRh5Tj9ui5Lw showed [Jc 9c] and won ($24.30) with two pair, Nines and Deuces
Seat 6: QHvTZcrKe6+maWUfVjP29Q mucked



PokerStars Game #59938939920:  Hold'em No Limit ($0.50/$1.00) - 2009/07/01 0:27:19 ET
Table 'kS0cTQAEi+fdUlJP2gQYvw' 9-max Seat #2 is the button
Seat 1: c/9X4zftzphFxYtxp5kp9w ($41.90 in chips)
Seat 2: 4SFNYndzMeslixOnF4koZQ ($53.65 in chips)
Seat 3: 3obndzTJ6fECz8+wWhMd1w ($17.50 in chips)
Seat 4: TZcz9MEWDA+WydgGruqqbw ($100 in chips)
Seat 5: 2rxrMrE7koO2BNxvop/0+g ($49.20 in chips)
Seat 6: yAbu2QsRPVcjPbqlf/jDxw ($100.65 in chips)
Seat 7: Ffa7Nj4X5fddtROP01hfQg ($103.05 in chips)
Seat 8: qTymj6ZQ8ZoFi6fINJZb3w ($88 in chips)
Seat 9: y8Qb94e81yI/g0saQ6gU5g ($84.75 in chips)
3obndzTJ6fECz8+wWhMd1w: posts small blind $0.50
TZcz9MEWDA+WydgGruqqbw: posts big blind $1
*** HOLE CARDS ***
2rxrMrE7koO2BNxvop/0+g: folds
yAbu2QsRPVcjPbqlf/jDxw: folds
c/9X4zftzphFxYtxp5kp9w said, "no had crap"
Ffa7Nj4X5fddtROP01hfQg: folds
qTymj6ZQ8ZoFi6fINJZb3w: folds
y8Qb94e81yI/g0saQ6gU5g: folds
c/9X4zftzphFxYtxp5kp9w: folds
4SFNYndzMeslixOnF4koZQ: calls $1
3obndzTJ6fECz8+wWhMd1w: folds
c/9X4zftzphFxYtxp5kp9w said, "pair of 7"
TZcz9MEWDA+WydgGruqqbw: checks
*** FLOP *** [Ad Ks 6c]
TZcz9MEWDA+WydgGruqqbw: checks
4SFNYndzMeslixOnF4koZQ: bets $2
TZcz9MEWDA+WydgGruqqbw: folds
4SFNYndzMeslixOnF4koZQ collected $2.40 from pot
*** SUMMARY ***
Total pot $2.50 | Rake $0.10
Board [Ad Ks 6c]
Seat 1: c/9X4zftzphFxYtxp5kp9w folded before Flop (didn't bet)
Seat 2: 4SFNYndzMeslixOnF4koZQ (button) collected ($2.40)
Seat 3: 3obndzTJ6fECz8+wWhMd1w (small blind) folded before Flop
Seat 4: TZcz9MEWDA+WydgGruqqbw (big blind) folded on the Flop
Seat 5: 2rxrMrE7koO2BNxvop/0+g folded before Flop (didn't bet)
Seat 6: yAbu2QsRPVcjPbqlf/jDxw folded before Flop (didn't bet)
Seat 7: Ffa7Nj4X5fddtROP01hfQg folded before Flop (didn't bet)
Seat 8: qTymj6ZQ8ZoFi6fINJZb3w folded before Flop (didn't bet)
Seat 9: y8Qb94e81yI/g0saQ6gU5g folded before Flop (didn't bet)



PokerStars Game #59938939450:  Hold'em No Limit ($0.50/$1.00) - 2009/07/01 0:27:19 ET
Table 'QSIig7BLMc9wY/rgBechzw' 6-max Seat #2 is the button
Seat 1: uuA9hpFU17U5/t4cvpbpBg ($26.40 in chips)
Seat 2: 0WjiuIT7/EolY1oOx1ngeA ($124.75 in chips)
Seat 3: +W6OnF033KNM2xH0fGj98Q ($120.70 in chips)
Seat 4: +uSzP8Jwnw7sKfQ4s66b7w ($47 in chips)
Seat 5: bvU2ZjpVnszLCFVeWbxePg ($113.70 in chips)
Seat 6: KpnW5CcJ4Mg6MeclfKmLrw ($130.75 in chips)
+W6OnF033KNM2xH0fGj98Q: posts small blind $0.50
+uSzP8Jwnw7sKfQ4s66b7w: posts big blind $1
*** HOLE CARDS ***
bvU2ZjpVnszLCFVeWbxePg: folds
KpnW5CcJ4Mg6MeclfKmLrw: raises $2 to $3
uuA9hpFU17U5/t4cvpbpBg: calls $3
0WjiuIT7/EolY1oOx1ngeA: folds
+W6OnF033KNM2xH0fGj98Q: folds
+uSzP8Jwnw7sKfQ4s66b7w: folds
*** FLOP *** [Jd Ks 6d]
KpnW5CcJ4Mg6MeclfKmLrw: checks
uuA9hpFU17U5/t4cvpbpBg: bets $3
KpnW5CcJ4Mg6MeclfKmLrw: folds
uuA9hpFU17U5/t4cvpbpBg collected $7.15 from pot
uuA9hpFU17U5/t4cvpbpBg: doesn't show hand
*** SUMMARY ***
Total pot $7.50 | Rake $0.35
Board [Jd Ks 6d]
Seat 1: uuA9hpFU17U5/t4cvpbpBg collected ($7.15)
Seat 2: 0WjiuIT7/EolY1oOx1ngeA (button) folded before Flop (didn't bet)
Seat 3: +W6OnF033KNM2xH0fGj98Q (small blind) folded before Flop
Seat 4: +uSzP8Jwnw7sKfQ4s66b7w (big blind) folded before Flop
Seat 5: bvU2ZjpVnszLCFVeWbxePg folded before Flop (didn't bet)
Seat 6: KpnW5CcJ4Mg6MeclfKmLrw folded on the Flop



PokerStars Game #59938940464:  Hold'em No Limit ($0.50/$1.00) - 2009/07/01 0:27:20 ET
Table 'cBDNutyLBKEk9+ptwsKmTw' 6-max Seat #6 is the button
Seat 1: xAU6q2/cwmby2sxmA8VcmA ($100 in chips)
Seat 2: KyaE4+hWgUNIWWOWy4D14w ($86.60 in chips)
Seat 3: G5ZSSN6RSON3gkNvk/SmYg ($106.40 in chips)
Seat 4: 0WjiuIT7/EolY1oOx1ngeA ($106.15 in chips)
Seat 5: OGMLOcTNYZXZU81au7ztUw ($108.20 in chips)
Seat 6: pyzhFUPPSNzrysiMqlA5Xw ($9.10 in chips)
xAU6q2/cwmby2sxmA8VcmA: posts small blind $0.50
KyaE4+hWgUNIWWOWy4D14w: posts big blind $1
*** HOLE CARDS ***
G5ZSSN6RSON3gkNvk/SmYg: folds
0WjiuIT7/EolY1oOx1ngeA: folds
OGMLOcTNYZXZU81au7ztUw: raises $2 to $3
pyzhFUPPSNzrysiMqlA5Xw: raises $6.10 to $9.10 and is all-in
xAU6q2/cwmby2sxmA8VcmA: folds
KyaE4+hWgUNIWWOWy4D14w: folds
OGMLOcTNYZXZU81au7ztUw: calls $6.10
*** FLOP *** [3c Th 8s]
*** TURN *** [3c Th 8s] [Td]
*** RIVER *** [3c Th 8s Td] [8h]
*** SHOW DOWN ***
OGMLOcTNYZXZU81au7ztUw: shows [9h 9s] (two pair, Tens and Nines)
pyzhFUPPSNzrysiMqlA5Xw: mucks hand
OGMLOcTNYZXZU81au7ztUw collected $18.75 from pot
*** SUMMARY ***
Total pot $19.70 | Rake $0.95
Board [3c Th 8s Td 8h]
Seat 1: xAU6q2/cwmby2sxmA8VcmA (small blind) folded before Flop
Seat 2: KyaE4+hWgUNIWWOWy4D14w (big blind) folded before Flop
Seat 3: G5ZSSN6RSON3gkNvk/SmYg folded before Flop (didn't bet)
Seat 4: 0WjiuIT7/EolY1oOx1ngeA folded before Flop (didn't bet)
Seat 5: OGMLOcTNYZXZU81au7ztUw showed [9h 9s] and won ($18.75) with two pair, Tens and Nines
Seat 6: pyzhFUPPSNzrysiMqlA5Xw (button) mucked



PokerStars Game #59938942146:  Hold'em No Limit ($0.50/$1.00) - 2009/07/01 0:27:23 ET
Table 'eU3bWpDDg3Z+9R4m4iVmog' 6-max Seat #5 is the button
Seat 1: TSuRyAHnUPCFjP7Z0rEE0w ($177.50 in chips)
Seat 2: 8CAoOzhmB8n3nRFf3V4BTg ($140.45 in chips)
Seat 3: U6tnjwZRpTnM+YkqkCjwyQ ($155.95 in chips)
Seat 4: GDVIsbEJ/DOJsMKE4Asz0A ($98 in chips)
Seat 5: QHvTZcrKe6+maWUfVjP29Q ($100.50 in chips)
Seat 6: hpxXcmRkXXI9HE5+5/j/0Q ($102 in chips)
hpxXcmRkXXI9HE5+5/j/0Q: posts small blind $0.50
TSuRyAHnUPCFjP7Z0rEE0w: posts big blind $1
*** HOLE CARDS ***
8CAoOzhmB8n3nRFf3V4BTg: raises $2 to $3
U6tnjwZRpTnM+YkqkCjwyQ: folds
GDVIsbEJ/DOJsMKE4Asz0A: folds
QHvTZcrKe6+maWUfVjP29Q: folds
hpxXcmRkXXI9HE5+5/j/0Q: folds
TSuRyAHnUPCFjP7Z0rEE0w: folds
8CAoOzhmB8n3nRFf3V4BTg collected $2.50 from pot
8CAoOzhmB8n3nRFf3V4BTg: doesn't show hand
*** SUMMARY ***
Total pot $2.50 | Rake $0
Seat 1: TSuRyAHnUPCFjP7Z0rEE0w (big blind) folded before Flop
Seat 2: 8CAoOzhmB8n3nRFf3V4BTg collected ($2.50)
Seat 3: U6tnjwZRpTnM+YkqkCjwyQ folded before Flop (didn't bet)
Seat 4: GDVIsbEJ/DOJsMKE4Asz0A folded before Flop (didn't bet)
Seat 5: QHvTZcrKe6+maWUfVjP29Q (button) folded before Flop (didn't bet)
Seat 6: hpxXcmRkXXI9HE5+5/j/0Q (small blind) folded before Flop



PokerStars Game #59938944086:  Hold'em No Limit ($0.50/$1.00) - 2009/07/01 0:27:25 ET
Table 'fTlPiCj0utgzC/5io+I7ew' 6-max Seat #4 is the button
Seat 1: YMJG+F++3Aj6P8dAWda5fw ($98.50 in chips)
Seat 2: +xUCTmR3cU7G239W+vZv6g ($143.35 in chips)
Seat 3: oDiBRCaF0QVtd3kO6xZIXw ($100 in chips)
Seat 4: uJVSceLggtsrJya+WtmUEA ($96.30 in chips)
Seat 5: bFrTkDcWGTxyvNul7GVdYg ($246.85 in chips)
Seat 6: jMljU/dOPMXfJi8OmbdYdw ($25 in chips)
bFrTkDcWGTxyvNul7GVdYg: posts small blind $0.50
jMljU/dOPMXfJi8OmbdYdw: posts big blind $1
*** HOLE CARDS ***
YMJG+F++3Aj6P8dAWda5fw: folds
+xUCTmR3cU7G239W+vZv6g: folds
oDiBRCaF0QVtd3kO6xZIXw: folds
uJVSceLggtsrJya+WtmUEA: raises $2 to $3
bFrTkDcWGTxyvNul7GVdYg: folds
jMljU/dOPMXfJi8OmbdYdw: folds
uJVSceLggtsrJya+WtmUEA collected $2.50 from pot
*** SUMMARY ***
Total pot $2.50 | Rake $0
Seat 1: YMJG+F++3Aj6P8dAWda5fw folded before Flop (didn't bet)
Seat 2: +xUCTmR3cU7G239W+vZv6g folded before Flop (didn't bet)
Seat 3: oDiBRCaF0QVtd3kO6xZIXw folded before Flop (didn't bet)
Seat 4: uJVSceLggtsrJya+WtmUEA (button) collected ($2.50)
Seat 5: bFrTkDcWGTxyvNul7GVdYg (small blind) folded before Flop
Seat 6: jMljU/dOPMXfJi8OmbdYdw (big blind) folded before Flop



PokerStars Game #59938943906:  Hold'em No Limit ($0.50/$1.00) - 2009/07/01 0:27:25 ET
Table 'W/wyObTiXZm+Ckkl3YxcSw' 6-max Seat #2 is the button
Seat 1: ssLJburtEIqnVkx6X8R1uw ($115.75 in chips)
Seat 2: oDiBRCaF0QVtd3kO6xZIXw ($104.20 in chips)
Seat 3: b2a+5TkFf4xJN/Ihhma58Q ($33.70 in chips)
Seat 4: +xW7QemQU0Fxs+4TnqBRow ($100 in chips)
Seat 6: 1yB1nHUkHNNY8OJnDNHZMw ($101 in chips)
b2a+5TkFf4xJN/Ihhma58Q: posts small blind $0.50
+xW7QemQU0Fxs+4TnqBRow: posts big blind $1
*** HOLE CARDS ***
1yB1nHUkHNNY8OJnDNHZMw: raises $2 to $3
ssLJburtEIqnVkx6X8R1uw: folds
oDiBRCaF0QVtd3kO6xZIXw: folds
b2a+5TkFf4xJN/Ihhma58Q: folds
+xW7QemQU0Fxs+4TnqBRow: folds
1yB1nHUkHNNY8OJnDNHZMw collected $2.50 from pot
*** SUMMARY ***
Total pot $2.50 | Rake $0
Seat 1: ssLJburtEIqnVkx6X8R1uw folded before Flop (didn't bet)
Seat 2: oDiBRCaF0QVtd3kO6xZIXw (button) folded before Flop (didn't bet)
Seat 3: b2a+5TkFf4xJN/Ihhma58Q (small blind) folded before Flop
Seat 4: +xW7QemQU0Fxs+4TnqBRow (big blind) folded before Flop
Seat 6: 1yB1nHUkHNNY8OJnDNHZMw collected ($2.50)



PokerStars Game #59938946700:  Hold'em No Limit ($0.50/$1.00) - 2009/07/01 0:27:29 ET
Table 'pHrhryH8jPNdQfY62f8v+g' 6-max Seat #3 is the button
Seat 1: BdbmJTZZ47quA9vUWwXtlw ($64.25 in chips)
Seat 2: RqgF7gRoKgRNW8Zoi1ty4A ($118 in chips)
Seat 3: 0WjiuIT7/EolY1oOx1ngeA ($100 in chips)
Seat 4: wenbG7TaM3H7h5kn78OFNw ($56.50 in chips)
Seat 6: xAU6q2/cwmby2sxmA8VcmA ($113.80 in chips)
wenbG7TaM3H7h5kn78OFNw: posts small blind $0.50
Gp2euK/nqF6qXKe7U+jOfw: is sitting out
Gp2euK/nqF6qXKe7U+jOfw leaves the table
xAU6q2/cwmby2sxmA8VcmA: posts big blind $1
*** HOLE CARDS ***
BdbmJTZZ47quA9vUWwXtlw: folds
RqgF7gRoKgRNW8Zoi1ty4A: folds
0WjiuIT7/EolY1oOx1ngeA: raises $2 to $3
wenbG7TaM3H7h5kn78OFNw: folds
xAU6q2/cwmby2sxmA8VcmA: folds
0WjiuIT7/EolY1oOx1ngeA collected $2.50 from pot
*** SUMMARY ***
Total pot $2.50 | Rake $0
Seat 1: BdbmJTZZ47quA9vUWwXtlw folded before Flop (didn't bet)
Seat 2: RqgF7gRoKgRNW8Zoi1ty4A folded before Flop (didn't bet)
Seat 3: 0WjiuIT7/EolY1oOx1ngeA (button) collected ($2.50)
Seat 4: wenbG7TaM3H7h5kn78OFNw (small blind) folded before Flop
Seat 6: xAU6q2/cwmby2sxmA8VcmA (big blind) folded before Flop



PokerStars Game #59938946370:  Hold'em No Limit ($0.50/$1.00) - 2009/07/01 0:27:29 ET
Table 'hugOjcwJvzEwZbK7tyiWuQ' 9-max Seat #6 is the button
Seat 1: N9n5Wc3s35DpCrOAUUNAaQ ($127.85 in chips)
Seat 2: r27C1nIV4NS4+qbnrgBQSw ($258.55 in chips)
Seat 3: jDwhY1kCdc6EkAHbT7PJMQ ($109.75 in chips)
Seat 4: UWB3oeddt/GObx2Mix2Anw ($191.70 in chips)
Seat 6: gUUvmqdVlmvpal6B8nYrmg ($105.95 in chips)
Seat 7: FL3MrLspcF23LYvC4ipBOA ($100 in chips)
Seat 8: /zy+DB4S5fUQUSfZWFzYGw ($111.25 in chips)
Seat 9: o6JyUkbzCDw8tUabqtmnlg ($59.10 in chips)
FL3MrLspcF23LYvC4ipBOA: posts small blind $0.50
/zy+DB4S5fUQUSfZWFzYGw: posts big blind $1
*** HOLE CARDS ***
o6JyUkbzCDw8tUabqtmnlg: folds
N9n5Wc3s35DpCrOAUUNAaQ: folds
r27C1nIV4NS4+qbnrgBQSw: folds
jDwhY1kCdc6EkAHbT7PJMQ: folds
UWB3oeddt/GObx2Mix2Anw: folds
gUUvmqdVlmvpal6B8nYrmg: raises $1 to $2
FL3MrLspcF23LYvC4ipBOA: folds
/zy+DB4S5fUQUSfZWFzYGw: raises $6 to $8
gUUvmqdVlmvpal6B8nYrmg: folds
/zy+DB4S5fUQUSfZWFzYGw collected $4.50 from pot
*** SUMMARY ***
Total pot $4.50 | Rake $0
Seat 1: N9n5Wc3s35DpCrOAUUNAaQ folded before Flop (didn't bet)
Seat 2: r27C1nIV4NS4+qbnrgBQSw folded before Flop (didn't bet)
Seat 3: jDwhY1kCdc6EkAHbT7PJMQ folded before Flop (didn't bet)
Seat 4: UWB3oeddt/GObx2Mix2Anw folded before Flop (didn't bet)
Seat 6: gUUvmqdVlmvpal6B8nYrmg (button) folded before Flop
Seat 7: FL3MrLspcF23LYvC4ipBOA (small blind) folded before Flop
Seat 8: /zy+DB4S5fUQUSfZWFzYGw (big blind) collected ($4.50)
Seat 9: o6JyUkbzCDw8tUabqtmnlg folded before Flop (didn't bet)



PokerStars Game #59938951424:  Hold'em No Limit ($0.50/$1.00) - 2009/07/01 0:27:36 ET
Table 'U9zqzC8f3oTJ2ShXFgSSOA' 6-max Seat #4 is the button
Seat 1: tS9JHB1h+FQ++qu8RwRNgg ($35.10 in chips)
Seat 3: yfXek8iJ7O4CFyqXrtGcfg ($42.55 in chips)
Seat 4: 33q95we0Etwgrm6guQGncw ($72.40 in chips)
Seat 5: KfwW5us6tydK81NYTtK1gw ($304.90 in chips)
Seat 6: aIxzFKdtpDSkUePKZy/niQ ($41.40 in chips)
KfwW5us6tydK81NYTtK1gw: posts small blind $0.50
aIxzFKdtpDSkUePKZy/niQ: posts big blind $1
*** HOLE CARDS ***
tS9JHB1h+FQ++qu8RwRNgg: folds
yfXek8iJ7O4CFyqXrtGcfg: raises $2 to $3
33q95we0Etwgrm6guQGncw: folds
KfwW5us6tydK81NYTtK1gw: folds
aIxzFKdtpDSkUePKZy/niQ: folds
yfXek8iJ7O4CFyqXrtGcfg collected $2.50 from pot
*** SUMMARY ***
Total pot $2.50 | Rake $0
Seat 1: tS9JHB1h+FQ++qu8RwRNgg folded before Flop (didn't bet)
Seat 3: yfXek8iJ7O4CFyqXrtGcfg collected ($2.50)
Seat 4: 33q95we0Etwgrm6guQGncw (button) folded before Flop (didn't bet)
Seat 5: KfwW5us6tydK81NYTtK1gw (small blind) folded before Flop
Seat 6: aIxzFKdtpDSkUePKZy/niQ (big blind) folded before Flop



PokerStars Game #59938951456:  Hold'em No Limit ($0.50/$1.00) - 2009/07/01 0:27:37 ET
Table 'mmbQQVBTrPdE+wy+s+9VPA' 6-max Seat #2 is the button
Seat 2: ru6SCVvWcWt2SpmUsmArWQ ($28.10 in chips)
Seat 3: wx3sQGkVi2x9wJXuWNHPBw ($110.65 in chips)
Seat 4: RfKnhkJN8HEAuzJpH2Ajdg ($12.75 in chips)
Seat 5: YMJG+F++3Aj6P8dAWda5fw ($99 in chips)
Seat 6: klQ/ufr9lOvfLMdAu0S9cw ($25.60 in chips)
wx3sQGkVi2x9wJXuWNHPBw: posts small blind $0.50
RfKnhkJN8HEAuzJpH2Ajdg: posts big blind $1
xAU6q2/cwmby2sxmA8VcmA: sits out
*** HOLE CARDS ***
YMJG+F++3Aj6P8dAWda5fw: folds
klQ/ufr9lOvfLMdAu0S9cw: folds
ru6SCVvWcWt2SpmUsmArWQ: raises $1.50 to $2.50
wx3sQGkVi2x9wJXuWNHPBw: folds
RfKnhkJN8HEAuzJpH2Ajdg: folds
ru6SCVvWcWt2SpmUsmArWQ collected $2.50 from pot
*** SUMMARY ***
Total pot $2.50 | Rake $0
Seat 2: ru6SCVvWcWt2SpmUsmArWQ (button) collected ($2.50)
Seat 3: wx3sQGkVi2x9wJXuWNHPBw (small blind) folded before Flop
Seat 4: RfKnhkJN8HEAuzJpH2Ajdg (big blind) folded before Flop
Seat 5: YMJG+F++3Aj6P8dAWda5fw folded before Flop (didn't bet)
Seat 6: klQ/ufr9lOvfLMdAu0S9cw folded before Flop (didn't bet)



PokerStars Game #59938951628:  Hold'em No Limit ($0.50/$1.00) - 2009/07/01 0:27:37 ET
Table '/RZcOwpZpHQ+OwPwjsbnRw' 6-max Seat #2 is the button
Seat 1: Zboa6dColKGHBjLPUakZjw ($43 in chips)
Seat 2: dHC9PH9hdH3Ad2TD8ZxX0Q ($57.25 in chips)
Seat 3: OigyyiK+tTj1APPIAUmXDA ($73.15 in chips)
Seat 4: j7NIOHLZk7V2o9fOioO5ug ($110.40 in chips)
Seat 5: wx3sQGkVi2x9wJXuWNHPBw ($200.55 in chips)
Seat 6: XOIf9W+VAxhZqN+SYoyMKA ($250.80 in chips)
OigyyiK+tTj1APPIAUmXDA: posts small blind $0.50
j7NIOHLZk7V2o9fOioO5ug: posts big blind $1
*** HOLE CARDS ***
wx3sQGkVi2x9wJXuWNHPBw has timed out
wx3sQGkVi2x9wJXuWNHPBw: folds
wx3sQGkVi2x9wJXuWNHPBw is sitting out
wx3sQGkVi2x9wJXuWNHPBw has returned
XOIf9W+VAxhZqN+SYoyMKA: folds
Zboa6dColKGHBjLPUakZjw: raises $1 to $2
dHC9PH9hdH3Ad2TD8ZxX0Q: calls $2
OigyyiK+tTj1APPIAUmXDA: folds
j7NIOHLZk7V2o9fOioO5ug: raises $10 to $12
Zboa6dColKGHBjLPUakZjw: folds
dHC9PH9hdH3Ad2TD8ZxX0Q: calls $10
*** FLOP *** [Qh Tc Kc]
j7NIOHLZk7V2o9fOioO5ug: bets $17
dHC9PH9hdH3Ad2TD8ZxX0Q: folds
j7NIOHLZk7V2o9fOioO5ug collected $25.20 from pot
j7NIOHLZk7V2o9fOioO5ug: doesn't show hand
*** SUMMARY ***
Total pot $26.50 | Rake $1.30
Board [Qh Tc Kc]
Seat 1: Zboa6dColKGHBjLPUakZjw folded before Flop
Seat 2: dHC9PH9hdH3Ad2TD8ZxX0Q (button) folded on the Flop
Seat 3: OigyyiK+tTj1APPIAUmXDA (small blind) folded before Flop
Seat 4: j7NIOHLZk7V2o9fOioO5ug (big blind) collected ($25.20)
Seat 5: wx3sQGkVi2x9wJXuWNHPBw folded before Flop (didn't bet)
Seat 6: XOIf9W+VAxhZqN+SYoyMKA folded before Flop (didn't bet)



PokerStars Game #59938952342:  Hold'em No Limit ($0.50/$1.00) - 2009/07/01 0:27:38 ET
Table 'W/wyObTiXZm+Ckkl3YxcSw' 6-max Seat #3 is the button
Seat 1: ssLJburtEIqnVkx6X8R1uw ($115.75 in chips)
Seat 2: oDiBRCaF0QVtd3kO6xZIXw ($104.20 in chips)
Seat 3: b2a+5TkFf4xJN/Ihhma58Q ($33.20 in chips)
Seat 4: +xW7QemQU0Fxs+4TnqBRow ($100 in chips)
Seat 6: 1yB1nHUkHNNY8OJnDNHZMw ($102.50 in chips)
+xW7QemQU0Fxs+4TnqBRow: posts small blind $0.50
1yB1nHUkHNNY8OJnDNHZMw: posts big blind $1
*** HOLE CARDS ***
ssLJburtEIqnVkx6X8R1uw: folds
oDiBRCaF0QVtd3kO6xZIXw: folds
b2a+5TkFf4xJN/Ihhma58Q: raises $1 to $2
+xW7QemQU0Fxs+4TnqBRow: folds
1yB1nHUkHNNY8OJnDNHZMw: calls $1
*** FLOP *** [8c As 4d]
1yB1nHUkHNNY8OJnDNHZMw: checks
b2a+5TkFf4xJN/Ihhma58Q: bets $3
1yB1nHUkHNNY8OJnDNHZMw: calls $3
*** TURN *** [8c As 4d] [2h]
1yB1nHUkHNNY8OJnDNHZMw: checks
b2a+5TkFf4xJN/Ihhma58Q: checks
*** RIVER *** [8c As 4d 2h] [Qc]
1yB1nHUkHNNY8OJnDNHZMw: bets $5
b2a+5TkFf4xJN/Ihhma58Q: raises $5 to $10
1yB1nHUkHNNY8OJnDNHZMw: folds
b2a+5TkFf4xJN/Ihhma58Q collected $19.50 from pot
*** SUMMARY ***
Total pot $20.50 | Rake $1
Board [8c As 4d 2h Qc]
Seat 1: ssLJburtEIqnVkx6X8R1uw folded before Flop (didn't bet)
Seat 2: oDiBRCaF0QVtd3kO6xZIXw folded before Flop (didn't bet)
Seat 3: b2a+5TkFf4xJN/Ihhma58Q (button) collected ($19.50)
Seat 4: +xW7QemQU0Fxs+4TnqBRow (small blind) folded before Flop
Seat 6: 1yB1nHUkHNNY8OJnDNHZMw (big blind) folded on the River



PokerStars Game #59938952146:  Hold'em No Limit ($0.50/$1.00) - 2009/07/01 0:27:38 ET
Table 'tyUh+jyNvrceIQdKMJjQ2wZFWj23PMihdwrNWv41OG/Qeat #5 is the button
Seat 2: 6iVcnPw9a2oNG6sPQo3G6g ($98.50 in chips)
Seat 3: L9qfLYXrczhAPd/VckgsWw ($41.20 in chips)
Seat 4: TSuRyAHnUPCFjP7Z0rEE0w ($132.45 in chips)
Seat 5: j7NIOHLZk7V2o9fOioO5ug ($103.95 in chips)
Seat 6: YsLQ3BAvgQHWXMAv3Wv6Hg ($104.25 in chips)
YsLQ3BAvgQHWXMAv3Wv6Hg: posts small blind $0.50
6iVcnPw9a2oNG6sPQo3G6g: posts big blind $1
*** HOLE CARDS ***
L9qfLYXrczhAPd/VckgsWw: calls $1
TSuRyAHnUPCFjP7Z0rEE0w: raises $3 to $4
j7NIOHLZk7V2o9fOioO5ug: calls $4
YsLQ3BAvgQHWXMAv3Wv6Hg: folds
6iVcnPw9a2oNG6sPQo3G6g: calls $3
L9qfLYXrczhAPd/VckgsWw: folds
*** FLOP *** [4c 5c 5h]
6iVcnPw9a2oNG6sPQo3G6g: checks
TSuRyAHnUPCFjP7Z0rEE0w: bets $7.50
j7NIOHLZk7V2o9fOioO5ug: raises $17.50 to $25
6iVcnPw9a2oNG6sPQo3G6g: folds
TSuRyAHnUPCFjP7Z0rEE0w: folds
j7NIOHLZk7V2o9fOioO5ug collected $27.15 from pot
j7NIOHLZk7V2o9fOioO5ug: doesn't show hand
*** SUMMARY ***
Total pot $28.50 | Rake $1.35
Board [4c 5c 5h]
Seat 2: 6iVcnPw9a2oNG6sPQo3G6g (big blind) folded on the Flop
Seat 3: L9qfLYXrczhAPd/VckgsWw folded before Flop
Seat 4: TSuRyAHnUPCFjP7Z0rEE0w folded on the Flop
Seat 5: j7NIOHLZk7V2o9fOioO5ug (button) collected ($27.15)
Seat 6: YsLQ3BAvgQHWXMAv3Wv6Hg (small blind) folded before Flop



PokerStars Game #59938953870:  Hold'em No Limit ($0.50/$1.00) - 2009/07/01 0:27:40 ET
Table 'ZFWj23PMihdwrNWv41OG/Q' 9-max Seat #5 is the button
Seat 1: yAbu2QsRPVcjPbqlf/jDxw ($101.80 in chips)
Seat 2: ARfmgHcEUKh68laBZy4veA ($50.25 in chips)
Seat 3: G9Fo2TZCN7HI43Po4zSN3A ($103.50 in chips)
Seat 4: PEmogYqKpuv0ozeBbXL+7Q ($35 in chips)
Seat 5: tkdBeXTJlFsZdioidNqLow ($60 in chips)
Seat 6: tjhwe1V98x2spSoUQER3HQ ($100 in chips)
Seat 7: wIZ377kjl2fHFGnS93o6bw ($23.95 in chips)
Seat 8: knewtTmBc4Tc0z/5tAABYQ ($107.50 in chips)
Seat 9: l4m/wWPs22DSP5xpszjXKA ($44.25 in chips)
tjhwe1V98x2spSoUQER3HQ: posts small blind $0.50
wIZ377kjl2fHFGnS93o6bw: posts big blind $1
*** HOLE CARDS ***
knewtTmBc4Tc0z/5tAABYQ: folds
l4m/wWPs22DSP5xpszjXKA: folds
yAbu2QsRPVcjPbqlf/jDxw: folds
ARfmgHcEUKh68laBZy4veA: raises $2 to $3
G9Fo2TZCN7HI43Po4zSN3A: folds
PEmogYqKpuv0ozeBbXL+7Q: calls $3
tkdBeXTJlFsZdioidNqLow: folds
tjhwe1V98x2spSoUQER3HQ: folds
wIZ377kjl2fHFGnS93o6bw: folds
*** FLOP *** [3d Jc 7s]
ARfmgHcEUKh68laBZy4veA: bets $5
PEmogYqKpuv0ozeBbXL+7Q: raises $5 to $10
ARfmgHcEUKh68laBZy4veA: calls $5
*** TURN *** [3d Jc 7s] [Qd]
ARfmgHcEUKh68laBZy4veA: bets $15
PEmogYqKpuv0ozeBbXL+7Q: calls $15
*** RIVER *** [3d Jc 7s Qd] [6s]
ARfmgHcEUKh68laBZy4veA: bets $8
PEmogYqKpuv0ozeBbXL+7Q: calls $7 and is all-in
*** SHOW DOWN ***
ARfmgHcEUKh68laBZy4veA: shows [Qc Ad] (a pair of Queens)
PEmogYqKpuv0ozeBbXL+7Q: mucks hand
ARfmgHcEUKh68laBZy4veA collected $68.50 from pot
*** SUMMARY ***
Total pot $71.50 | Rake $3
Board [3d Jc 7s Qd 6s]
Seat 1: yAbu2QsRPVcjPbqlf/jDxw folded before Flop (didn't bet)
Seat 2: ARfmgHcEUKh68laBZy4veA showed [Qc Ad] and won ($68.50) with a pair of Queens
Seat 3: G9Fo2TZCN7HI43Po4zSN3A folded before Flop (didn't bet)
Seat 4: PEmogYqKpuv0ozeBbXL+7Q mucked
Seat 5: tkdBeXTJlFsZdioidNqLow (button) folded before Flop (didn't bet)
Seat 6: tjhwe1V98x2spSoUQER3HQ (small blind) folded before Flop
Seat 7: wIZ377kjl2fHFGnS93o6bw (big blind) folded before Flop
Seat 8: knewtTmBc4Tc0z/5tAABYQ folded before Flop (didn't bet)
Seat 9: l4m/wWPs22DSP5xpszjXKA folded before Flop (didn't bet)



PokerStars Game #59938954150:  Hold'em No Limit ($0.50/$1.00) - 2009/07/01 0:27:41 ET
Table 'rmZfTK+oSebeUPJNbWhdAA' 6-max Seat #2 is the button
Seat 1: xAU6q2/cwmby2sxmA8VcmA ($100 in chips)
Seat 2: OigyyiK+tTj1APPIAUmXDA ($89.05 in chips)
Seat 3: 9yjOzGERLaEZS8CZ6YNHFg ($96.10 in chips)
Seat 4: OGMLOcTNYZXZU81au7ztUw ($128.70 in chips)
Seat 6: j7NIOHLZk7V2o9fOioO5ug ($103.50 in chips)
9yjOzGERLaEZS8CZ6YNHFg: posts small blind $0.50
OGMLOcTNYZXZU81au7ztUw: posts big blind $1
+xW7QemQU0Fxs+4TnqBRow: sits out
*** HOLE CARDS ***
j7NIOHLZk7V2o9fOioO5ug: folds
xAU6q2/cwmby2sxmA8VcmA: folds
OigyyiK+tTj1APPIAUmXDA: raises $2 to $3
9yjOzGERLaEZS8CZ6YNHFg: folds
OGMLOcTNYZXZU81au7ztUw: folds
OigyyiK+tTj1APPIAUmXDA collected $2.50 from pot
*** SUMMARY ***
Total pot $2.50 | Rake $0
Seat 1: xAU6q2/cwmby2sxmA8VcmA folded before Flop (didn't bet)
Seat 2: OigyyiK+tTj1APPIAUmXDA (button) collected ($2.50)
Seat 3: 9yjOzGERLaEZS8CZ6YNHFg (small blind) folded before Flop
Seat 4: OGMLOcTNYZXZU81au7ztUw (big blind) folded before Flop
Seat 6: j7NIOHLZk7V2o9fOioO5ug folded before Flop (didn't bet)



PokerStars Game #59938955024:  Hold'em No Limit ($0.50/$1.00) - 2009/07/01 0:27:42 ET
Table 'MUPc8FEpe/nR0BKSeReX6Q' 6-max Seat #4 is the button
Seat 1: YsLQ3BAvgQHWXMAv3Wv6Hg ($101.50 in chips)
Seat 2: xAU6q2/cwmby2sxmA8VcmA ($110.50 in chips)
Seat 3: wx3sQGkVi2x9wJXuWNHPBw ($234.05 in chips)
Seat 4: ZA1bp6g8IwtTxkUE4eCjDQ ($106.30 in chips)
Seat 5: UBZQqpnJZdTYYY1FTb0rLA ($100 in chips)
Seat 6: oxnw0GLLpFanjhGkxfRSqA ($53.60 in chips)
UBZQqpnJZdTYYY1FTb0rLA: posts small blind $0.50
oxnw0GLLpFanjhGkxfRSqA: posts big blind $1
*** HOLE CARDS ***
YsLQ3BAvgQHWXMAv3Wv6Hg: folds
xAU6q2/cwmby2sxmA8VcmA: folds
wx3sQGkVi2x9wJXuWNHPBw: folds
ZA1bp6g8IwtTxkUE4eCjDQ: calls $1
UBZQqpnJZdTYYY1FTb0rLA: folds
oxnw0GLLpFanjhGkxfRSqA: checks
*** FLOP *** [4s Qd 4d]
oxnw0GLLpFanjhGkxfRSqA: checks
ZA1bp6g8IwtTxkUE4eCjDQ: bets $1
oxnw0GLLpFanjhGkxfRSqA: folds
ZA1bp6g8IwtTxkUE4eCjDQ collected $2.40 from pot
ZA1bp6g8IwtTxkUE4eCjDQ: doesn't show hand
*** SUMMARY ***
Total pot $2.50 | Rake $0.10
Board [4s Qd 4d]
Seat 1: YsLQ3BAvgQHWXMAv3Wv6Hg folded before Flop (didn't bet)
Seat 2: xAU6q2/cwmby2sxmA8VcmA folded before Flop (didn't bet)
Seat 3: wx3sQGkVi2x9wJXuWNHPBw folded before Flop (didn't bet)
Seat 4: ZA1bp6g8IwtTxkUE4eCjDQ (button) collected ($2.40)
Seat 5: UBZQqpnJZdTYYY1FTb0rLA (small blind) folded before Flop
Seat 6: oxnw0GLLpFanjhGkxfRSqA (big blind) folded on the Flop



PokerStars Game #59938955654:  Hold'em No Limit ($0.50/$1.00) - 2009/07/01 0:27:43 ET
Table '+cA8mcmhaedZ7YcrDdhmeQ' 6-max Seat #6 is the button
Seat 1: lsLuWlcPA3Rh7kJVLzMh0Q ($231 in chips)
Seat 2: trnpu4tPju3BU8W0wQQaiQ ($117.95 in chips)
Seat 3: 0WjiuIT7/EolY1oOx1ngeA ($116.30 in chips)
Seat 5: 6WyjEXOToimYmtLdqIgHYQ ($60 in chips)
Seat 6: YfsTQsY/fxb+YqbdclTHuw ($101 in chips)
lsLuWlcPA3Rh7kJVLzMh0Q: posts small blind $0.50
trnpu4tPju3BU8W0wQQaiQ: posts big blind $1
LjL3AIERHn559yyW1mTUYQ: sits out
*** HOLE CARDS ***
0WjiuIT7/EolY1oOx1ngeA: folds
6WyjEXOToimYmtLdqIgHYQ: folds
YfsTQsY/fxb+YqbdclTHuw: calls $1
lsLuWlcPA3Rh7kJVLzMh0Q: raises $4 to $5
trnpu4tPju3BU8W0wQQaiQ: folds
YfsTQsY/fxb+YqbdclTHuw: calls $4
*** FLOP *** [Js 8h 8c]
lsLuWlcPA3Rh7kJVLzMh0Q: bets $7
YfsTQsY/fxb+YqbdclTHuw: calls $7
*** TURN *** [Js 8h 8c] [Kc]
lsLuWlcPA3Rh7kJVLzMh0Q: bets $14
YfsTQsY/fxb+YqbdclTHuw: calls $14
*** RIVER *** [Js 8h 8c Kc] [Th]
lsLuWlcPA3Rh7kJVLzMh0Q: bets $30
YfsTQsY/fxb+YqbdclTHuw: calls $30
*** SHOW DOWN ***
lsLuWlcPA3Rh7kJVLzMh0Q: shows [Ad Kh] (two pair, Kings and Eights)
YfsTQsY/fxb+YqbdclTHuw: mucks hand
lsLuWlcPA3Rh7kJVLzMh0Q collected $111 from pot
*** SUMMARY ***
Total pot $113 | Rake $2
Board [Js 8h 8c Kc Th]
Seat 1: lsLuWlcPA3Rh7kJVLzMh0Q (small blind) showed [Ad Kh] and won ($111) with two pair, Kings and Eights
Seat 2: trnpu4tPju3BU8W0wQQaiQ (big blind) folded before Flop
Seat 3: 0WjiuIT7/EolY1oOx1ngeA folded before Flop (didn't bet)
Seat 5: 6WyjEXOToimYmtLdqIgHYQ folded before Flop (didn't bet)
Seat 6: YfsTQsY/fxb+YqbdclTHuw (button) mucked



PokerStars Game #59938958934:  Hold'em No Limit ($0.50/$1.00) - 2009/07/01 0:27:48 ET
Table 'eU3bWpDDg3Z+9R4m4iVmog' 6-max Seat #6 is the button
Seat 1: TSuRyAHnUPCFjP7Z0rEE0w ($176.50 in chips)
Seat 2: 8CAoOzhmB8n3nRFf3V4BTg ($141.95 in chips)
Seat 3: U6tnjwZRpTnM+YkqkCjwyQ ($155.95 in chips)
Seat 4: GDVIsbEJ/DOJsMKE4Asz0A ($98 in chips)
Seat 5: QHvTZcrKe6+maWUfVjP29Q ($100.50 in chips)
Seat 6: hpxXcmRkXXI9HE5+5/j/0Q ($101.50 in chips)
TSuRyAHnUPCFjP7Z0rEE0w: posts small blind $0.50
8CAoOzhmB8n3nRFf3V4BTg: posts big blind $1
*** HOLE CARDS ***
U6tnjwZRpTnM+YkqkCjwyQ: raises $2 to $3
GDVIsbEJ/DOJsMKE4Asz0A: calls $3
QHvTZcrKe6+maWUfVjP29Q: folds
hpxXcmRkXXI9HE5+5/j/0Q: folds
TSuRyAHnUPCFjP7Z0rEE0w: folds
8CAoOzhmB8n3nRFf3V4BTg: folds
*** FLOP *** [Ac 5d Js]
U6tnjwZRpTnM+YkqkCjwyQ: checks
GDVIsbEJ/DOJsMKE4Asz0A: bets $4
U6tnjwZRpTnM+YkqkCjwyQ: calls $4
*** TURN *** [Ac 5d Js] [6d]
U6tnjwZRpTnM+YkqkCjwyQ: checks
GDVIsbEJ/DOJsMKE4Asz0A: bets $4
U6tnjwZRpTnM+YkqkCjwyQ: folds
GDVIsbEJ/DOJsMKE4Asz0A collected $14.75 from pot
*** SUMMARY ***
Total pot $15.50 | Rake $0.75
Board [Ac 5d Js 6d]
Seat 1: TSuRyAHnUPCFjP7Z0rEE0w (small blind) folded before Flop
Seat 2: 8CAoOzhmB8n3nRFf3V4BTg (big blind) folded before Flop
Seat 3: U6tnjwZRpTnM+YkqkCjwyQ folded on the Turn
Seat 4: GDVIsbEJ/DOJsMKE4Asz0A collected ($14.75)
Seat 5: QHvTZcrKe6+maWUfVjP29Q folded before Flop (didn't bet)
Seat 6: hpxXcmRkXXI9HE5+5/j/0Q (button) folded before Flop (didn't bet)



PokerStars Game #59938959842:  Hold'em No Limit ($0.50/$1.00) - 2009/07/01 0:27:49 ET
Table 'cBDNutyLBKEk9+ptwsKmTw' 6-max Seat #1 is the button
Seat 1: xAU6q2/cwmby2sxmA8VcmA ($100 in chips)
Seat 2: KyaE4+hWgUNIWWOWy4D14w ($85.60 in chips)
Seat 3: G5ZSSN6RSON3gkNvk/SmYg ($106.40 in chips)
Seat 4: 0WjiuIT7/EolY1oOx1ngeA ($106.15 in chips)
Seat 5: OGMLOcTNYZXZU81au7ztUw ($117.85 in chips)
KyaE4+hWgUNIWWOWy4D14w: posts small blind $0.50
G5ZSSN6RSON3gkNvk/SmYg: posts big blind $1
*** HOLE CARDS ***
0WjiuIT7/EolY1oOx1ngeA: folds
OGMLOcTNYZXZU81au7ztUw: folds
pyzhFUPPSNzrysiMqlA5Xw leaves the table
xAU6q2/cwmby2sxmA8VcmA: raises $3 to $4
KyaE4+hWgUNIWWOWy4D14w: calls $3.50
G5ZSSN6RSON3gkNvk/SmYg: folds
*** FLOP *** [Kc Jc Td]
KyaE4+hWgUNIWWOWy4D14w: checks
xAU6q2/cwmby2sxmA8VcmA: checks
*** TURN *** [Kc Jc Td] [2d]
KyaE4+hWgUNIWWOWy4D14w: checks
xAU6q2/cwmby2sxmA8VcmA: bets $5
KyaE4+hWgUNIWWOWy4D14w: folds
xAU6q2/cwmby2sxmA8VcmA collected $8.55 from pot
xAU6q2/cwmby2sxmA8VcmA: doesn't show hand
*** SUMMARY ***
Total pot $9 | Rake $0.45
Board [Kc Jc Td 2d]
Seat 1: xAU6q2/cwmby2sxmA8VcmA (button) collected ($8.55)
Seat 2: KyaE4+hWgUNIWWOWy4D14w (small blind) folded on the Turn
Seat 3: G5ZSSN6RSON3gkNvk/SmYg (big blind) folded before Flop
Seat 4: 0WjiuIT7/EolY1oOx1ngeA folded before Flop (didn't bet)
Seat 5: OGMLOcTNYZXZU81au7ztUw folded before Flop (didn't bet)



PokerStars Game #59938959742:  Hold'em No Limit ($0.50/$1.00) - 2009/07/01 0:27:49 ET
Table 'Zka9tv1yilg0MvXWPQrShg' 9-max Seat #5 is the button
Seat 1: TZcz9MEWDA+WydgGruqqbw ($109.90 in chips)
Seat 2: rR1qGAf9Q9RYorKYWH3VKw ($21.50 in chips)
Seat 3: gUUvmqdVlmvpal6B8nYrmg ($101 in chips)
Seat 4: CTOae+JLIGfwfXvhqHkP2w ($170.65 in chips)
Seat 5: /zy+DB4S5fUQUSfZWFzYGw ($139.95 in chips)
Seat 6: rY8wPoax1lS+HUY+I0FZDw ($128.90 in chips)
Seat 7: p1SafS90nb3Uft5LB0NkHw ($21.50 in chips)
Seat 8: bL+QVeDcuEdzMGAGg2XJHg ($124.60 in chips)
rY8wPoax1lS+HUY+I0FZDw: posts small blind $0.50
p1SafS90nb3Uft5LB0NkHw: posts big blind $1
*** HOLE CARDS ***
bL+QVeDcuEdzMGAGg2XJHg: folds
TZcz9MEWDA+WydgGruqqbw: folds
rR1qGAf9Q9RYorKYWH3VKw: folds
gUUvmqdVlmvpal6B8nYrmg: raises $1 to $2
CTOae+JLIGfwfXvhqHkP2w: folds
/zy+DB4S5fUQUSfZWFzYGw: folds
rY8wPoax1lS+HUY+I0FZDw: folds
p1SafS90nb3Uft5LB0NkHw: folds
gUUvmqdVlmvpal6B8nYrmg collected $2.50 from pot
gUUvmqdVlmvpal6B8nYrmg: doesn't show hand
*** SUMMARY ***
Total pot $2.50 | Rake $0
Seat 1: TZcz9MEWDA+WydgGruqqbw folded before Flop (didn't bet)
Seat 2: rR1qGAf9Q9RYorKYWH3VKw folded before Flop (didn't bet)
Seat 3: gUUvmqdVlmvpal6B8nYrmg collected ($2.50)
Seat 4: CTOae+JLIGfwfXvhqHkP2w folded before Flop (didn't bet)
Seat 5: /zy+DB4S5fUQUSfZWFzYGw (button) folded before Flop (didn't bet)
Seat 6: rY8wPoax1lS+HUY+I0FZDw (small blind) folded before Flop
Seat 7: p1SafS90nb3Uft5LB0NkHw (big blind) folded before Flop
Seat 8: bL+QVeDcuEdzMGAGg2XJHg folded before Flop (didn't bet)



PokerStars Game #59938960758:  Hold'em No Limit ($0.50/$1.00) - 2009/07/01 0:27:51 ET
Table 'kS0cTQAEi+fdUlJP2gQYvw' 9-max Seat #3 is the button
Seat 1: c/9X4zftzphFxYtxp5kp9w ($41.90 in chips)
Seat 2: 4SFNYndzMeslixOnF4koZQ ($55.05 in chips)
Seat 3: 3obndzTJ6fECz8+wWhMd1w ($17 in chips)
Seat 4: TZcz9MEWDA+WydgGruqqbw ($100 in chips)
Seat 5: 2rxrMrE7koO2BNxvop/0+g ($49.20 in chips)
Seat 6: yAbu2QsRPVcjPbqlf/jDxw ($100.65 in chips)
Seat 7: Ffa7Nj4X5fddtROP01hfQg ($103.05 in chips)
Seat 8: qTymj6ZQ8ZoFi6fINJZb3w ($88 in chips)
Seat 9: y8Qb94e81yI/g0saQ6gU5g ($84.75 in chips)
TZcz9MEWDA+WydgGruqqbw: posts small blind $0.50
2rxrMrE7koO2BNxvop/0+g: posts big blind $1
*** HOLE CARDS ***
yAbu2QsRPVcjPbqlf/jDxw: folds
Ffa7Nj4X5fddtROP01hfQg: folds
qTymj6ZQ8ZoFi6fINJZb3w: folds
y8Qb94e81yI/g0saQ6gU5g: folds
c/9X4zftzphFxYtxp5kp9w: folds
4SFNYndzMeslixOnF4koZQ: folds
3obndzTJ6fECz8+wWhMd1w: folds
TZcz9MEWDA+WydgGruqqbw: folds
2rxrMrE7koO2BNxvop/0+g collected $1 from pot
*** SUMMARY ***
Total pot $1 | Rake $0
Seat 1: c/9X4zftzphFxYtxp5kp9w folded before Flop (didn't bet)
Seat 2: 4SFNYndzMeslixOnF4koZQ folded before Flop (didn't bet)
Seat 3: 3obndzTJ6fECz8+wWhMd1w (button) folded before Flop (didn't bet)
Seat 4: TZcz9MEWDA+WydgGruqqbw (small blind) folded before Flop
Seat 5: 2rxrMrE7koO2BNxvop/0+g (big blind) collected ($1)
Seat 6: yAbu2QsRPVcjPbqlf/jDxw folded before Flop (didn't bet)
Seat 7: Ffa7Nj4X5fddtROP01hfQg folded before Flop (didn't bet)
Seat 8: qTymj6ZQ8ZoFi6fINJZb3w folded before Flop (didn't bet)
Seat 9: y8Qb94e81yI/g0saQ6gU5g folded before Flop (didn't bet)



PokerStars Game #59938961564:  Hold'em No Limit ($0.50/$1.00) - 2009/07/01 0:27:52 ET
Table 'pHrhryH8jPNdQfY62f8v+g' 6-max Seat #4 is the button
Seat 1: BdbmJTZZ47quA9vUWwXtlw ($64.25 in chips)
Seat 2: RqgF7gRoKgRNW8Zoi1ty4A ($118 in chips)
Seat 3: 0WjiuIT7/EolY1oOx1ngeA ($101.50 in chips)
Seat 4: wenbG7TaM3H7h5kn78OFNw ($56 in chips)
Seat 6: xAU6q2/cwmby2sxmA8VcmA ($112.80 in chips)
xAU6q2/cwmby2sxmA8VcmA: posts small blind $0.50
BdbmJTZZ47quA9vUWwXtlw: posts big blind $1
*** HOLE CARDS ***
RqgF7gRoKgRNW8Zoi1ty4A: folds
0WjiuIT7/EolY1oOx1ngeA: folds
wenbG7TaM3H7h5kn78OFNw: folds
xAU6q2/cwmby2sxmA8VcmA: raises $3 to $4
BdbmJTZZ47quA9vUWwXtlw: calls $3
*** FLOP *** [6c 8c Tc]
VKAMJWCyQIT4iNxRjICMJA joins the table at seat #5
xAU6q2/cwmby2sxmA8VcmA: bets $6
BdbmJTZZ47quA9vUWwXtlw: calls $6
*** TURN *** [6c 8c Tc] [9c]
xAU6q2/cwmby2sxmA8VcmA: checks
BdbmJTZZ47quA9vUWwXtlw: checks
*** RIVER *** [6c 8c Tc 9c] [4h]
xAU6q2/cwmby2sxmA8VcmA: checks
BdbmJTZZ47quA9vUWwXtlw: checks
*** SHOW DOWN ***
xAU6q2/cwmby2sxmA8VcmA: shows [8d 8s] (three of a kind, Eights)
BdbmJTZZ47quA9vUWwXtlw: shows [Jc Ah] (a flush, Jack high)
BdbmJTZZ47quA9vUWwXtlw collected $19.05 from pot
*** SUMMARY ***
Total pot $20 | Rake $0.95
Board [6c 8c Tc 9c 4h]
Seat 1: BdbmJTZZ47quA9vUWwXtlw (big blind) showed [Jc Ah] and won ($19.05) with a flush, Jack high
Seat 2: RqgF7gRoKgRNW8Zoi1ty4A folded before Flop (didn't bet)
Seat 3: 0WjiuIT7/EolY1oOx1ngeA folded before Flop (didn't bet)
Seat 4: wenbG7TaM3H7h5kn78OFNw (button) folded before Flop (didn't bet)
Seat 6: xAU6q2/cwmby2sxmA8VcmA (small blind) showed [8d 8s] and lost with three of a kind, Eights



PokerStars Game #59938962114:  Hold'em No Limit ($0.50/$1.00) - 2009/07/01 0:27:53 ET
Table 'fTlPiCj0utgzC/5io+I7ew' 6-max Seat #5 is the button
Seat 1: YMJG+F++3Aj6P8dAWda5fw ($100 in chips)
Seat 2: +xUCTmR3cU7G239W+vZv6g ($143.35 in chips)
Seat 3: oDiBRCaF0QVtd3kO6xZIXw ($100 in chips)
Seat 4: uJVSceLggtsrJya+WtmUEA ($97.80 in chips)
Seat 5: bFrTkDcWGTxyvNul7GVdYg ($246.35 in chips)
Seat 6: jMljU/dOPMXfJi8OmbdYdw ($24 in chips)
jMljU/dOPMXfJi8OmbdYdw: posts small blind $0.50
YMJG+F++3Aj6P8dAWda5fw: posts big blind $1
*** HOLE CARDS ***
+xUCTmR3cU7G239W+vZv6g: folds
oDiBRCaF0QVtd3kO6xZIXw: folds
uJVSceLggtsrJya+WtmUEA: folds
bFrTkDcWGTxyvNul7GVdYg: raises $2 to $3
jMljU/dOPMXfJi8OmbdYdw: calls $2.50
YMJG+F++3Aj6P8dAWda5fw: folds
*** FLOP *** [Jc Th 8c]
jMljU/dOPMXfJi8OmbdYdw: checks
bFrTkDcWGTxyvNul7GVdYg: bets $6
jMljU/dOPMXfJi8OmbdYdw: calls $6
*** TURN *** [Jc Th 8c] [3s]
jMljU/dOPMXfJi8OmbdYdw: checks
bFrTkDcWGTxyvNul7GVdYg: bets $15
jMljU/dOPMXfJi8OmbdYdw: folds
bFrTkDcWGTxyvNul7GVdYg collected $18.10 from pot
*** SUMMARY ***
Total pot $19 | Rake $0.90
Board [Jc Th 8c 3s]
Seat 1: YMJG+F++3Aj6P8dAWda5fw (big blind) folded before Flop
Seat 2: +xUCTmR3cU7G239W+vZv6g folded before Flop (didn't bet)
Seat 3: oDiBRCaF0QVtd3kO6xZIXw folded before Flop (didn't bet)
Seat 4: uJVSceLggtsrJya+WtmUEA folded before Flop (didn't bet)
Seat 5: bFrTkDcWGTxyvNul7GVdYg (button) collected ($18.10)
Seat 6: jMljU/dOPMXfJi8OmbdYdw (small blind) folded on the Turn



PokerStars Game #59938963914:  Hold'em No Limit ($0.50/$1.00) - 2009/07/01 0:27:55 ET
Table '7Nl0ffnjeK44/vmeexh3MQ' 9-max Seat #5 is the button
Seat 1: s7D3Y+k4Cj4D1cXHv7oj+Q ($98.65 in chips)
Seat 2: kiakSwxX0e64PwYGAPQvLw ($31.85 in chips)
Seat 3: vR4IO10geOgvTW+LAUBv/A ($100 in chips)
Seat 5: bL+QVeDcuEdzMGAGg2XJHg ($113.95 in chips)
Seat 6: FVs16t7GgfWgQWt4JxsObQ ($6.55 in chips)
Seat 7: knewtTmBc4Tc0z/5tAABYQ ($106.50 in chips)
Seat 8: zanka7aAZkigmZpfopXxxA ($228.20 in chips)
Seat 9: ouwUBGRKnKK9uhn1G4Lf+A ($98.50 in chips)
FVs16t7GgfWgQWt4JxsObQ: posts small blind $0.50
knewtTmBc4Tc0z/5tAABYQ: posts big blind $1
vR4IO10geOgvTW+LAUBv/A: posts big blind $1
bLbSOSmSOnqE0iTcH/5dxA: sits out
*** HOLE CARDS ***
zanka7aAZkigmZpfopXxxA: folds
ouwUBGRKnKK9uhn1G4Lf+A: folds
s7D3Y+k4Cj4D1cXHv7oj+Q: calls $1
kiakSwxX0e64PwYGAPQvLw: folds
vR4IO10geOgvTW+LAUBv/A: checks
bL+QVeDcuEdzMGAGg2XJHg: folds
FVs16t7GgfWgQWt4JxsObQ: calls $0.50
knewtTmBc4Tc0z/5tAABYQ: checks
*** FLOP *** [Qd 2s Jh]
FVs16t7GgfWgQWt4JxsObQ: checks
knewtTmBc4Tc0z/5tAABYQ: checks
s7D3Y+k4Cj4D1cXHv7oj+Q: bets $3
vR4IO10geOgvTW+LAUBv/A: folds
FVs16t7GgfWgQWt4JxsObQ: folds
knewtTmBc4Tc0z/5tAABYQ: folds
s7D3Y+k4Cj4D1cXHv7oj+Q collected $3.80 from pot
*** SUMMARY ***
Total pot $4 | Rake $0.20
Board [Qd 2s Jh]
Seat 1: s7D3Y+k4Cj4D1cXHv7oj+Q collected ($3.80)
Seat 2: kiakSwxX0e64PwYGAPQvLw folded before Flop (didn't bet)
Seat 3: vR4IO10geOgvTW+LAUBv/A folded on the Flop
Seat 5: bL+QVeDcuEdzMGAGg2XJHg (button) folded before Flop (didn't bet)
Seat 6: FVs16t7GgfWgQWt4JxsObQ (small blind) folded on the Flop
Seat 7: knewtTmBc4Tc0z/5tAABYQ (big blind) folded on the Flop
Seat 8: zanka7aAZkigmZpfopXxxA folded before Flop (didn't bet)
Seat 9: ouwUBGRKnKK9uhn1G4Lf+A folded before Flop (didn't bet)



PokerStars Game #59938965230:  Hold'em No Limit ($0.50/$1.00) - 2009/07/01 0:27:57 ET
Table 'SQLOQoANiHscJ8AL7zffbw' 9-max Seat #3 is the button
Seat 1: jPTRd6SpCp4xqAy2XQiTOw ($101.85 in chips)
Seat 2: /zy+DB4S5fUQUSfZWFzYGw ($281.85 in chips)
Seat 3: 0eFnow7+D7veCYQ+CG9FFw ($70 in chips)
Seat 4: N9n5Wc3s35DpCrOAUUNAaQ ($118.30 in chips)
Seat 5: L9njYvloJ1NdXjP8edHEAg ($110.55 in chips)
Seat 6: p5UKaxVobvptF0ANhR/q1A ($157 in chips)
Seat 7: bJckevFOcg//s0qyMQI6sQ ($103.55 in chips)
Seat 8: 9ce+0Dl3d0BeEFIP+8HezA ($18.50 in chips)
Seat 9: qJr25HAtvv1w/7IBvjMM3g ($234.35 in chips)
N9n5Wc3s35DpCrOAUUNAaQ: posts small blind $0.50
L9njYvloJ1NdXjP8edHEAg: posts big blind $1
*** HOLE CARDS ***
p5UKaxVobvptF0ANhR/q1A: folds
bJckevFOcg//s0qyMQI6sQ: folds
9ce+0Dl3d0BeEFIP+8HezA: raises $2 to $3
qJr25HAtvv1w/7IBvjMM3g: calls $3
jPTRd6SpCp4xqAy2XQiTOw: folds
/zy+DB4S5fUQUSfZWFzYGw: folds
0eFnow7+D7veCYQ+CG9FFw: folds
N9n5Wc3s35DpCrOAUUNAaQ: calls $2.50
L9njYvloJ1NdXjP8edHEAg: folds
*** FLOP *** [7c Qh Jc]
N9n5Wc3s35DpCrOAUUNAaQ: checks
9ce+0Dl3d0BeEFIP+8HezA: bets $5
qJr25HAtvv1w/7IBvjMM3g: calls $5
N9n5Wc3s35DpCrOAUUNAaQ: folds
*** TURN *** [7c Qh Jc] [3s]
9ce+0Dl3d0BeEFIP+8HezA: bets $10.50 and is all-in
qJr25HAtvv1w/7IBvjMM3g: folds
9ce+0Dl3d0BeEFIP+8HezA collected $19.05 from pot
*** SUMMARY ***
Total pot $20 | Rake $0.95
Board [7c Qh Jc 3s]
Seat 1: jPTRd6SpCp4xqAy2XQiTOw folded before Flop (didn't bet)
Seat 2: /zy+DB4S5fUQUSfZWFzYGw folded before Flop (didn't bet)
Seat 3: 0eFnow7+D7veCYQ+CG9FFw (button) folded before Flop (didn't bet)
Seat 4: N9n5Wc3s35DpCrOAUUNAaQ (small blind) folded on the Flop
Seat 5: L9njYvloJ1NdXjP8edHEAg (big blind) folded before Flop
Seat 6: p5UKaxVobvptF0ANhR/q1A folded before Flop (didn't bet)
Seat 7: bJckevFOcg//s0qyMQI6sQ folded before Flop (didn't bet)
Seat 8: 9ce+0Dl3d0BeEFIP+8HezA collected ($19.05)
Seat 9: qJr25HAtvv1w/7IBvjMM3g folded on the Turn



PokerStars Game #59938966368:  Hold'em No Limit ($0.50/$1.00) - 2009/07/01 0:27:59 ET
Table 'GxCPo/gd3OSthkYrAxJngg' 6-max Seat #2 is the button
Seat 1: sH8BpAFP+jGFxCgVpD1Lew ($279.45 in chips)
Seat 2: YExX2paeIHrmfIwV1ivM/w ($65.20 in chips)
Seat 3: o6plE+MSW4XFNTeONe16xg ($36.10 in chips)
Seat 4: YMJG+F++3Aj6P8dAWda5fw ($109.15 in chips)
Seat 5: G5ZSSN6RSON3gkNvk/SmYg ($100 in chips)
Seat 6: sS9IXedL3MiRmpVXhAILhw ($97 in chips)
o6plE+MSW4XFNTeONe16xg: posts small blind $0.50
YMJG+F++3Aj6P8dAWda5fw: posts big blind $1
*** HOLE CARDS ***
G5ZSSN6RSON3gkNvk/SmYg: folds
sS9IXedL3MiRmpVXhAILhw: folds
sH8BpAFP+jGFxCgVpD1Lew: folds
YExX2paeIHrmfIwV1ivM/w: folds
o6plE+MSW4XFNTeONe16xg: calls $0.50
YMJG+F++3Aj6P8dAWda5fw: raises $2 to $3
o6plE+MSW4XFNTeONe16xg: folds
YMJG+F++3Aj6P8dAWda5fw collected $2 from pot
*** SUMMARY ***
Total pot $2 | Rake $0
Seat 1: sH8BpAFP+jGFxCgVpD1Lew folded before Flop (didn't bet)
Seat 2: YExX2paeIHrmfIwV1ivM/w (button) folded before Flop (didn't bet)
Seat 3: o6plE+MSW4XFNTeONe16xg (small blind) folded before Flop
Seat 4: YMJG+F++3Aj6P8dAWda5fw (big blind) collected ($2)
Seat 5: G5ZSSN6RSON3gkNvk/SmYg folded before Flop (didn't bet)
Seat 6: sS9IXedL3MiRmpVXhAILhw folded before Flop (didn't bet)



PokerStars Game #59938967128:  Hold'em No Limit ($0.50/$1.00) - 2009/07/01 0:28:00 ET
Table 'hugOjcwJvzEwZbK7tyiWuQ' 9-max Seat #7 is the button
Seat 1: N9n5Wc3s35DpCrOAUUNAaQ ($127.85 in chips)
Seat 2: r27C1nIV4NS4+qbnrgBQSw ($258.55 in chips)
Seat 3: jDwhY1kCdc6EkAHbT7PJMQ ($109.75 in chips)
Seat 4: UWB3oeddt/GObx2Mix2Anw ($191.70 in chips)
Seat 6: gUUvmqdVlmvpal6B8nYrmg ($103.95 in chips)
Seat 7: FL3MrLspcF23LYvC4ipBOA ($100 in chips)
Seat 8: /zy+DB4S5fUQUSfZWFzYGw ($113.75 in chips)
Seat 9: o6JyUkbzCDw8tUabqtmnlg ($59.10 in chips)
/zy+DB4S5fUQUSfZWFzYGw: posts small blind $0.50
o6JyUkbzCDw8tUabqtmnlg: posts big blind $1
*** HOLE CARDS ***
N9n5Wc3s35DpCrOAUUNAaQ: folds
r27C1nIV4NS4+qbnrgBQSw: folds
jDwhY1kCdc6EkAHbT7PJMQ: folds
UWB3oeddt/GObx2Mix2Anw: raises $3 to $4
gUUvmqdVlmvpal6B8nYrmg: calls $4
FL3MrLspcF23LYvC4ipBOA: folds
/zy+DB4S5fUQUSfZWFzYGw: folds
o6JyUkbzCDw8tUabqtmnlg: folds
*** FLOP *** [Td 2s 9d]
UWB3oeddt/GObx2Mix2Anw: bets $8
gUUvmqdVlmvpal6B8nYrmg: folds
UWB3oeddt/GObx2Mix2Anw collected $9.05 from pot
*** SUMMARY ***
Total pot $9.50 | Rake $0.45
Board [Td 2s 9d]
Seat 1: N9n5Wc3s35DpCrOAUUNAaQ folded before Flop (didn't bet)
Seat 2: r27C1nIV4NS4+qbnrgBQSw folded before Flop (didn't bet)
Seat 3: jDwhY1kCdc6EkAHbT7PJMQ folded before Flop (didn't bet)
Seat 4: UWB3oeddt/GObx2Mix2Anw collected ($9.05)
Seat 6: gUUvmqdVlmvpal6B8nYrmg folded on the Flop
Seat 7: FL3MrLspcF23LYvC4ipBOA (button) folded before Flop (didn't bet)
Seat 8: /zy+DB4S5fUQUSfZWFzYGw (small blind) folded before Flop
Seat 9: o6JyUkbzCDw8tUabqtmnlg (big blind) folded before Flop



PokerStars Game #59938967210:  Hold'em No Limit ($0.50/$1.00) - 2009/07/01 0:28:00 ET
Table '/FUb199IViHMJHi5YWmeuQ' 9-max Seat #9 is the button
Seat 1: TZcz9MEWDA+WydgGruqqbw ($102.35 in chips)
Seat 2: FL3MrLspcF23LYvC4ipBOA ($138.75 in chips)
Seat 3: qN483QJ1NvHbdIZB7J4ARw ($76.40 in chips)
Seat 5: +za1iHiRgVo4OcAz0SOZqw ($15.45 in chips)
Seat 6: ccFf7Q4z1cTGQmeoYiWEfw ($37.50 in chips)
Seat 7: bLbSOSmSOnqE0iTcH/5dxA ($100 in chips)
Seat 8: QIWvt0R766g8KfH0vl1s0A ($46.60 in chips)
Seat 9: knewtTmBc4Tc0z/5tAABYQ ($122.75 in chips)
TZcz9MEWDA+WydgGruqqbw: posts small blind $0.50
FL3MrLspcF23LYvC4ipBOA: posts big blind $1
*** HOLE CARDS ***
qN483QJ1NvHbdIZB7J4ARw: folds
+za1iHiRgVo4OcAz0SOZqw: folds
ccFf7Q4z1cTGQmeoYiWEfw: raises $2 to $3
bLbSOSmSOnqE0iTcH/5dxA: folds
QIWvt0R766g8KfH0vl1s0A: calls $3
knewtTmBc4Tc0z/5tAABYQ: folds
TZcz9MEWDA+WydgGruqqbw: folds
FL3MrLspcF23LYvC4ipBOA: folds
*** FLOP *** [7d Qh Td]
ccFf7Q4z1cTGQmeoYiWEfw: checks
QIWvt0R766g8KfH0vl1s0A: checks
*** TURN *** [7d Qh Td] [Ac]
ccFf7Q4z1cTGQmeoYiWEfw: checks
QIWvt0R766g8KfH0vl1s0A: checks
*** RIVER *** [7d Qh Td Ac] [As]
ccFf7Q4z1cTGQmeoYiWEfw: bets $3
QIWvt0R766g8KfH0vl1s0A: raises $9 to $12
ccFf7Q4z1cTGQmeoYiWEfw: calls $9
*** SHOW DOWN ***
QIWvt0R766g8KfH0vl1s0A: shows [Jc 9c] (a pair of Aces)
ccFf7Q4z1cTGQmeoYiWEfw: shows [Kd Qc] (two pair, Aces and Queens)
ccFf7Q4z1cTGQmeoYiWEfw collected $29.95 from pot
*** SUMMARY ***
Total pot $31.50 | Rake $1.55
Board [7d Qh Td Ac As]
Seat 1: TZcz9MEWDA+WydgGruqqbw (small blind) folded before Flop
Seat 2: FL3MrLspcF23LYvC4ipBOA (big blind) folded before Flop
Seat 3: qN483QJ1NvHbdIZB7J4ARw folded before Flop (didn't bet)
Seat 5: +za1iHiRgVo4OcAz0SOZqw folded before Flop (didn't bet)
Seat 6: ccFf7Q4z1cTGQmeoYiWEfw showed [Kd Qc] and won ($29.95) with two pair, Aces and Queens
Seat 7: bLbSOSmSOnqE0iTcH/5dxA folded before Flop (didn't bet)
Seat 8: QIWvt0R766g8KfH0vl1s0A showed [Jc 9c] and lost with a pair of Aces
Seat 9: knewtTmBc4Tc0z/5tAABYQ (button) folded before Flop (didn't bet)



PokerStars Game #59938968074:  Hold'em No Limit ($0.50/$1.00) - 2009/07/01 0:28:02 ET
Table 'mmbQQVBTrPdE+wy+s+9VPA' 6-max Seat #3 is the button
Seat 2: ru6SCVvWcWt2SpmUsmArWQ ($29.60 in chips)
Seat 3: wx3sQGkVi2x9wJXuWNHPBw ($110.15 in chips)
Seat 4: RfKnhkJN8HEAuzJpH2Ajdg ($11.75 in chips)
Seat 5: YMJG+F++3Aj6P8dAWda5fw ($99 in chips)
Seat 6: klQ/ufr9lOvfLMdAu0S9cw ($25.60 in chips)
RfKnhkJN8HEAuzJpH2Ajdg: posts small blind $0.50
YMJG+F++3Aj6P8dAWda5fw: posts big blind $1
xAU6q2/cwmby2sxmA8VcmA: sits out
*** HOLE CARDS ***
klQ/ufr9lOvfLMdAu0S9cw: folds
ru6SCVvWcWt2SpmUsmArWQ: folds
wx3sQGkVi2x9wJXuWNHPBw: folds
RfKnhkJN8HEAuzJpH2Ajdg: calls $0.50
YMJG+F++3Aj6P8dAWda5fw: raises $2 to $3
RfKnhkJN8HEAuzJpH2Ajdg: raises $8.75 to $11.75 and is all-in
YMJG+F++3Aj6P8dAWda5fw: calls $8.75
*** FLOP *** [7h 2s 3h]
klQ/ufr9lOvfLMdAu0S9cw leaves the table
*** TURN *** [7h 2s 3h] [6c]
*** RIVER *** [7h 2s 3h 6c] [As]
*** SHOW DOWN ***
RfKnhkJN8HEAuzJpH2Ajdg: shows [Ad 7s] (two pair, Aces and Sevens)
YMJG+F++3Aj6P8dAWda5fw: mucks hand
RfKnhkJN8HEAuzJpH2Ajdg collected $22.35 from pot
*** SUMMARY ***
Total pot $23.50 | Rake $1.15
Board [7h 2s 3h 6c As]
Seat 2: ru6SCVvWcWt2SpmUsmArWQ folded before Flop (didn't bet)
Seat 3: wx3sQGkVi2x9wJXuWNHPBw (button) folded before Flop (didn't bet)
Seat 4: RfKnhkJN8HEAuzJpH2Ajdg (small blind) showed [Ad 7s] and won ($22.35) with two pair, Aces and Sevens
Seat 5: YMJG+F++3Aj6P8dAWda5fw (big blind) mucked
Seat 6: klQ/ufr9lOvfLMdAu0S9cw folded before Flop (didn't bet)



PokerStars Game #59938969562:  Hold'em No Limit ($0.50/$1.00) - 2009/07/01 0:28:04 ET
Table 'rmZfTK+oSebeUPJNbWhdAA' 6-max Seat #3 is the button
Seat 1: xAU6q2/cwmby2sxmA8VcmA ($100 in chips)
Seat 2: OigyyiK+tTj1APPIAUmXDA ($90.55 in chips)
Seat 3: 9yjOzGERLaEZS8CZ6YNHFg ($95.60 in chips)
Seat 4: OGMLOcTNYZXZU81au7ztUw ($127.70 in chips)
Seat 5: +xW7QemQU0Fxs+4TnqBRow ($100 in chips)
Seat 6: j7NIOHLZk7V2o9fOioO5ug ($103.50 in chips)
OGMLOcTNYZXZU81au7ztUw: posts small blind $0.50
+xW7QemQU0Fxs+4TnqBRow: posts big blind $1
*** HOLE CARDS ***
j7NIOHLZk7V2o9fOioO5ug has timed out
j7NIOHLZk7V2o9fOioO5ug: folds
j7NIOHLZk7V2o9fOioO5ug is sitting out
j7NIOHLZk7V2o9fOioO5ug has returned
xAU6q2/cwmby2sxmA8VcmA: folds
OigyyiK+tTj1APPIAUmXDA: folds
9yjOzGERLaEZS8CZ6YNHFg: folds
OGMLOcTNYZXZU81au7ztUw: folds
+xW7QemQU0Fxs+4TnqBRow collected $1 from pot
+xW7QemQU0Fxs+4TnqBRow: doesn't show hand
*** SUMMARY ***
Total pot $1 | Rake $0
Seat 1: xAU6q2/cwmby2sxmA8VcmA folded before Flop (didn't bet)
Seat 2: OigyyiK+tTj1APPIAUmXDA folded before Flop (didn't bet)
Seat 3: 9yjOzGERLaEZS8CZ6YNHFg (button) folded before Flop (didn't bet)
Seat 4: OGMLOcTNYZXZU81au7ztUw (small blind) folded before Flop
Seat 5: +xW7QemQU0Fxs+4TnqBRow (big blind) collected ($1)
Seat 6: j7NIOHLZk7V2o9fOioO5ug folded before Flop (didn't bet)



PokerStars Game #59938971854:  Hold'em No Limit ($0.50/$1.00) - 2009/07/01 0:28:07 ET
Table 'U9zqzC8f3oTJ2ShXFgSSOA' 6-max Seat #5 is the button
Seat 1: tS9JHB1h+FQ++qu8RwRNgg ($35.10 in chips)
Seat 3: yfXek8iJ7O4CFyqXrtGcfg ($44.05 in chips)
Seat 4: 33q95we0Etwgrm6guQGncw ($72.40 in chips)
Seat 5: KfwW5us6tydK81NYTtK1gw ($304.40 in chips)
Seat 6: aIxzFKdtpDSkUePKZy/niQ ($40.40 in chips)
aIxzFKdtpDSkUePKZy/niQ: posts small blind $0.50
tS9JHB1h+FQ++qu8RwRNgg: posts big blind $1
*** HOLE CARDS ***
yfXek8iJ7O4CFyqXrtGcfg: folds
33q95we0Etwgrm6guQGncw: folds
KfwW5us6tydK81NYTtK1gw: folds
aIxzFKdtpDSkUePKZy/niQ: folds
U2CWBTv29qdCbj8RNF2sIw has returned
tS9JHB1h+FQ++qu8RwRNgg collected $1 from pot
tS9JHB1h+FQ++qu8RwRNgg: doesn't show hand
*** SUMMARY ***
Total pot $1 | Rake $0
Seat 1: tS9JHB1h+FQ++qu8RwRNgg (big blind) collected ($1)
Seat 3: yfXek8iJ7O4CFyqXrtGcfg folded before Flop (didn't bet)
Seat 4: 33q95we0Etwgrm6guQGncw folded before Flop (didn't bet)
Seat 5: KfwW5us6tydK81NYTtK1gw (button) folded before Flop (didn't bet)
Seat 6: aIxzFKdtpDSkUePKZy/niQ (small blind) folded before Flop



PokerStars Game #59938972850:  Hold'em No Limit ($0.50/$1.00) - 2009/07/01 0:28:09 ET
Table 'MUPc8FEpe/nR0BKSeReX6Q' 6-max Seat #5 is the button
Seat 1: YsLQ3BAvgQHWXMAv3Wv6Hg ($101.50 in chips)
Seat 2: xAU6q2/cwmby2sxmA8VcmA ($110.50 in chips)
Seat 3: wx3sQGkVi2x9wJXuWNHPBw ($234.05 in chips)
Seat 4: ZA1bp6g8IwtTxkUE4eCjDQ ($107.70 in chips)
Seat 5: UBZQqpnJZdTYYY1FTb0rLA ($100 in chips)
Seat 6: oxnw0GLLpFanjhGkxfRSqA ($52.60 in chips)
oxnw0GLLpFanjhGkxfRSqA: posts small blind $0.50
YsLQ3BAvgQHWXMAv3Wv6Hg: posts big blind $1
*** HOLE CARDS ***
xAU6q2/cwmby2sxmA8VcmA: folds
wx3sQGkVi2x9wJXuWNHPBw: folds
ZA1bp6g8IwtTxkUE4eCjDQ: calls $1
UBZQqpnJZdTYYY1FTb0rLA: folds
oxnw0GLLpFanjhGkxfRSqA: calls $0.50
YsLQ3BAvgQHWXMAv3Wv6Hg: checks
*** FLOP *** [9h Kc 4s]
oxnw0GLLpFanjhGkxfRSqA: checks
YsLQ3BAvgQHWXMAv3Wv6Hg: checks
ZA1bp6g8IwtTxkUE4eCjDQ: bets $1
oxnw0GLLpFanjhGkxfRSqA: folds
YsLQ3BAvgQHWXMAv3Wv6Hg: calls $1
*** TURN *** [9h Kc 4s] [2h]
YsLQ3BAvgQHWXMAv3Wv6Hg: checks
ZA1bp6g8IwtTxkUE4eCjDQ: checks
*** RIVER *** [9h Kc 4s 2h] [Ah]
YsLQ3BAvgQHWXMAv3Wv6Hg: checks
ZA1bp6g8IwtTxkUE4eCjDQ: bets $3
YsLQ3BAvgQHWXMAv3Wv6Hg: folds
ZA1bp6g8IwtTxkUE4eCjDQ collected $4.80 from pot
ZA1bp6g8IwtTxkUE4eCjDQ: doesn't show hand
*** SUMMARY ***
Total pot $5 | Rake $0.20
Board [9h Kc 4s 2h Ah]
Seat 1: YsLQ3BAvgQHWXMAv3Wv6Hg (big blind) folded on the River
Seat 2: xAU6q2/cwmby2sxmA8VcmA folded before Flop (didn't bet)
Seat 3: wx3sQGkVi2x9wJXuWNHPBw folded before Flop (didn't bet)
Seat 4: ZA1bp6g8IwtTxkUE4eCjDQ collected ($4.80)
Seat 5: UBZQqpnJZdTYYY1FTb0rLA (button) folded before Flop (didn't bet)
Seat 6: oxnw0GLLpFanjhGkxfRSqA (small blind) folded on the Flop



PokerStars Game #59938975518:  Hold'em No Limit ($0.50/$1.00) - 2009/07/01 0:28:13 ET
Table 'O96CPOtvMBWP6kzuYDfdFA' 6-max Seat #3 is the button
Seat 2: vTUNrd/7qIOJpW0suEu5hQ ($203.40 in chips)
Seat 3: V89DGjxE171oPREEbAXiyg ($33.15 in chips)
Seat 5: wRxiu9OJzvvN84OYWW9jxQ ($132.25 in chips)
Seat 6: xNKcQzD9+/iHmtJn4vYq9w ($140.15 in chips)
KOG8rG51mOvIoY96zF3kvw will be allowed to play after the button
wRxiu9OJzvvN84OYWW9jxQ: posts small blind $0.50
xNKcQzD9+/iHmtJn4vYq9w: posts big blind $1
*** HOLE CARDS ***
vTUNrd/7qIOJpW0suEu5hQ: folds
V89DGjxE171oPREEbAXiyg: folds
esuark2007 leaves the table
wRxiu9OJzvvN84OYWW9jxQ: folds
xNKcQzD9+/iHmtJn4vYq9w collected $1 from pot
*** SUMMARY ***
Total pot $1 | Rake $0
Seat 2: vTUNrd/7qIOJpW0suEu5hQ folded before Flop (didn't bet)
Seat 3: V89DGjxE171oPREEbAXiyg (button) folded before Flop (didn't bet)
Seat 5: wRxiu9OJzvvN84OYWW9jxQ (small blind) folded before Flop
Seat 6: xNKcQzD9+/iHmtJn4vYq9w (big blind) collected ($1)



PokerStars Game #59938975274:  Hold'em No Limit ($0.50/$1.00) - 2009/07/01 0:28:13 ET
Table 'W/wyObTiXZm+Ckkl3YxcSw' 6-max Seat #4 is the button
Seat 1: ssLJburtEIqnVkx6X8R1uw ($115.75 in chips)
Seat 2: oDiBRCaF0QVtd3kO6xZIXw ($104.20 in chips)
Seat 3: b2a+5TkFf4xJN/Ihhma58Q ($42.70 in chips)
Seat 4: +xW7QemQU0Fxs+4TnqBRow ($100 in chips)
Seat 6: 1yB1nHUkHNNY8OJnDNHZMw ($92.50 in chips)
1yB1nHUkHNNY8OJnDNHZMw: posts small blind $0.50
ssLJburtEIqnVkx6X8R1uw: posts big blind $1
*** HOLE CARDS ***
oDiBRCaF0QVtd3kO6xZIXw: folds
b2a+5TkFf4xJN/Ihhma58Q: folds
+xW7QemQU0Fxs+4TnqBRow: raises $2 to $3
1yB1nHUkHNNY8OJnDNHZMw: folds
ssLJburtEIqnVkx6X8R1uw: folds
+xW7QemQU0Fxs+4TnqBRow collected $2.50 from pot
+xW7QemQU0Fxs+4TnqBRow: doesn't show hand
*** SUMMARY ***
Total pot $2.50 | Rake $0
Seat 1: ssLJburtEIqnVkx6X8R1uw (big blind) folded before Flop
Seat 2: oDiBRCaF0QVtd3kO6xZIXw folded before Flop (didn't bet)
Seat 3: b2a+5TkFf4xJN/Ihhma58Q folded before Flop (didn't bet)
Seat 4: +xW7QemQU0Fxs+4TnqBRow (button) collected ($2.50)
Seat 6: 1yB1nHUkHNNY8OJnDNHZMw (small blind) folded before Flop



PokerStars Game #59938976454:  Hold'em No Limit ($0.50/$1.00) - 2009/07/01 0:28:14 ET
Table 'kS0cTQAEi+fdUlJP2gQYvw' 9-max Seat #4 is the button
Seat 1: c/9X4zftzphFxYtxp5kp9w ($41.90 in chips)
Seat 2: 4SFNYndzMeslixOnF4koZQ ($55.05 in chips)
Seat 3: 3obndzTJ6fECz8+wWhMd1w ($17 in chips)
Seat 4: TZcz9MEWDA+WydgGruqqbw ($100 in chips)
Seat 5: 2rxrMrE7koO2BNxvop/0+g ($49.70 in chips)
Seat 6: yAbu2QsRPVcjPbqlf/jDxw ($100.65 in chips)
Seat 7: Ffa7Nj4X5fddtROP01hfQg ($103.05 in chips)
Seat 8: qTymj6ZQ8ZoFi6fINJZb3w ($88 in chips)
Seat 9: y8Qb94e81yI/g0saQ6gU5g ($84.75 in chips)
2rxrMrE7koO2BNxvop/0+g: posts small blind $0.50
yAbu2QsRPVcjPbqlf/jDxw: posts big blind $1
*** HOLE CARDS ***
Ffa7Nj4X5fddtROP01hfQg: folds
qTymj6ZQ8ZoFi6fINJZb3w: folds
y8Qb94e81yI/g0saQ6gU5g: folds
c/9X4zftzphFxYtxp5kp9w: folds
4SFNYndzMeslixOnF4koZQ: calls $1
3obndzTJ6fECz8+wWhMd1w: folds
TZcz9MEWDA+WydgGruqqbw: folds
2rxrMrE7koO2BNxvop/0+g: calls $0.50
yAbu2QsRPVcjPbqlf/jDxw: checks
*** FLOP *** [3d As 6d]
2rxrMrE7koO2BNxvop/0+g: bets $2
yAbu2QsRPVcjPbqlf/jDxw: folds
4SFNYndzMeslixOnF4koZQ: folds
2rxrMrE7koO2BNxvop/0+g collected $2.85 from pot
*** SUMMARY ***
Total pot $3 | Rake $0.15
Board [3d As 6d]
Seat 1: c/9X4zftzphFxYtxp5kp9w folded before Flop (didn't bet)
Seat 2: 4SFNYndzMeslixOnF4koZQ folded on the Flop
Seat 3: 3obndzTJ6fECz8+wWhMd1w folded before Flop (didn't bet)
Seat 4: TZcz9MEWDA+WydgGruqqbw (button) folded before Flop (didn't bet)
Seat 5: 2rxrMrE7koO2BNxvop/0+g (small blind) collected ($2.85)
Seat 6: yAbu2QsRPVcjPbqlf/jDxw (big blind) folded on the Flop
Seat 7: Ffa7Nj4X5fddtROP01hfQg folded before Flop (didn't bet)
Seat 8: qTymj6ZQ8ZoFi6fINJZb3w folded before Flop (didn't bet)
Seat 9: y8Qb94e81yI/g0saQ6gU5g folded before Flop (didn't bet)



PokerStars Game #59938978342:  Hold'em No Limit ($0.50/$1.00) - 2009/07/01 0:28:17 ET
Table 'U9zqzC8f3oTJ2ShXFgSSOA' 6-max Seat #6 is the button
Seat 1: tS9JHB1h+FQ++qu8RwRNgg ($35.60 in chips)
Seat 2: U2CWBTv29qdCbj8RNF2sIw ($100 in chips)
Seat 3: yfXek8iJ7O4CFyqXrtGcfg ($44.05 in chips)
Seat 4: 33q95we0Etwgrm6guQGncw ($72.40 in chips)
Seat 5: KfwW5us6tydK81NYTtK1gw ($304.40 in chips)
Seat 6: aIxzFKdtpDSkUePKZy/niQ ($39.90 in chips)
tS9JHB1h+FQ++qu8RwRNgg: posts small blind $0.50
U2CWBTv29qdCbj8RNF2sIw: posts big blind $1
*** HOLE CARDS ***
yfXek8iJ7O4CFyqXrtGcfg: folds
33q95we0Etwgrm6guQGncw: folds
KfwW5us6tydK81NYTtK1gw: folds
aIxzFKdtpDSkUePKZy/niQ: calls $1
tS9JHB1h+FQ++qu8RwRNgg: calls $0.50
U2CWBTv29qdCbj8RNF2sIw: checks
*** FLOP *** [As 4h Ks]
tS9JHB1h+FQ++qu8RwRNgg: checks
U2CWBTv29qdCbj8RNF2sIw: bets $2
aIxzFKdtpDSkUePKZy/niQ: folds
tS9JHB1h+FQ++qu8RwRNgg: folds
U2CWBTv29qdCbj8RNF2sIw collected $2.85 from pot
U2CWBTv29qdCbj8RNF2sIw: doesn't show hand
*** SUMMARY ***
Total pot $3 | Rake $0.15
Board [As 4h Ks]
Seat 1: tS9JHB1h+FQ++qu8RwRNgg (small blind) folded on the Flop
Seat 2: U2CWBTv29qdCbj8RNF2sIw (big blind) collected ($2.85)
Seat 3: yfXek8iJ7O4CFyqXrtGcfg folded before Flop (didn't bet)
Seat 4: 33q95we0Etwgrm6guQGncw folded before Flop (didn't bet)
Seat 5: KfwW5us6tydK81NYTtK1gw folded before Flop (didn't bet)
Seat 6: aIxzFKdtpDSkUePKZy/niQ (button) folded on the Flop



PokerStars Game #59938978718:  Hold'em No Limit ($0.50/$1.00) - 2009/07/01 0:28:18 ET
Table '8jIjWCPY0NGprquL+xcMFg' 9-max Seat #2 is the button
Seat 1: vR4IO10geOgvTW+LAUBv/A ($133.65 in chips)
Seat 2: rR1qGAf9Q9RYorKYWH3VKw ($8.15 in chips)
Seat 3: 58zdeSBSuSFX/qZfhc7YmA ($108.95 in chips)
Seat 4: by0z+YmujwI6Bf4qRFE8vA ($118.10 in chips)
Seat 5: n758Yw8Hx2S+6NQUPGqcqA ($88.50 in chips)
Seat 6: GTQkFJtSkbVbnGCktp6e3g ($100.90 in chips)
Seat 7: O3CGPwwUmamrCNHccOilrg ($46.15 in chips)
Seat 8: 9swGhtpERPngKPtvpoZkoQ ($152.80 in chips)
Seat 9: negfosHnGOZXSHpWDRKyBQ ($18.50 in chips)
58zdeSBSuSFX/qZfhc7YmA: posts small blind $0.50
by0z+YmujwI6Bf4qRFE8vA: posts big blind $1
*** HOLE CARDS ***
n758Yw8Hx2S+6NQUPGqcqA: folds
GTQkFJtSkbVbnGCktp6e3g: raises $3 to $4
O3CGPwwUmamrCNHccOilrg: folds
9swGhtpERPngKPtvpoZkoQ: folds
negfosHnGOZXSHpWDRKyBQ: folds
vR4IO10geOgvTW+LAUBv/A: folds
rR1qGAf9Q9RYorKYWH3VKw: folds
58zdeSBSuSFX/qZfhc7YmA: folds
by0z+YmujwI6Bf4qRFE8vA: calls $3
*** FLOP *** [2c 2d Qc]
by0z+YmujwI6Bf4qRFE8vA: checks
GTQkFJtSkbVbnGCktp6e3g: bets $6
by0z+YmujwI6Bf4qRFE8vA: raises $6 to $12
GTQkFJtSkbVbnGCktp6e3g: calls $6
*** TURN *** [2c 2d Qc] [Td]
by0z+YmujwI6Bf4qRFE8vA: bets $7
GTQkFJtSkbVbnGCktp6e3g: calls $7
*** RIVER *** [2c 2d Qc Td] [8c]
by0z+YmujwI6Bf4qRFE8vA: bets $8
GTQkFJtSkbVbnGCktp6e3g: calls $8
*** SHOW DOWN ***
by0z+YmujwI6Bf4qRFE8vA: shows [Qd Ac] (two pair, Queens and Deuces)
GTQkFJtSkbVbnGCktp6e3g: mucks hand
by0z+YmujwI6Bf4qRFE8vA collected $59.50 from pot
*** SUMMARY ***
Total pot $62.50 | Rake $3
Board [2c 2d Qc Td 8c]
Seat 1: vR4IO10geOgvTW+LAUBv/A folded before Flop (didn't bet)
Seat 2: rR1qGAf9Q9RYorKYWH3VKw (button) folded before Flop (didn't bet)
Seat 3: 58zdeSBSuSFX/qZfhc7YmA (small blind) folded before Flop
Seat 4: by0z+YmujwI6Bf4qRFE8vA (big blind) showed [Qd Ac] and won ($59.50) with two pair, Queens and Deuces
Seat 5: n758Yw8Hx2S+6NQUPGqcqA folded before Flop (didn't bet)
Seat 6: GTQkFJtSkbVbnGCktp6e3g mucked
Seat 7: O3CGPwwUmamrCNHccOilrg folded before Flop (didn't bet)
Seat 8: 9swGhtpERPngKPtvpoZkoQ folded before Flop (didn't bet)
Seat 9: negfosHnGOZXSHpWDRKyBQ folded before Flop (didn't bet)



PokerStars Game #59938980358:  Hold'em No Limit ($0.50/$1.00) - 2009/07/01 0:28:20 ET
Table 'eU3bWpDDg3Z+9R4m4iVmog' 6-max Seat #1 is the button
Seat 1: TSuRyAHnUPCFjP7Z0rEE0w ($176 in chips)
Seat 2: 8CAoOzhmB8n3nRFf3V4BTg ($140.95 in chips)
Seat 3: U6tnjwZRpTnM+YkqkCjwyQ ($148.95 in chips)
Seat 4: GDVIsbEJ/DOJsMKE4Asz0A ($105.75 in chips)
Seat 5: QHvTZcrKe6+maWUfVjP29Q ($100.50 in chips)
Seat 6: hpxXcmRkXXI9HE5+5/j/0Q ($101.50 in chips)
8CAoOzhmB8n3nRFf3V4BTg: posts small blind $0.50
U6tnjwZRpTnM+YkqkCjwyQ: posts big blind $1
*** HOLE CARDS ***
GDVIsbEJ/DOJsMKE4Asz0A: folds
QHvTZcrKe6+maWUfVjP29Q: folds
hpxXcmRkXXI9HE5+5/j/0Q: folds
TSuRyAHnUPCFjP7Z0rEE0w: raises $3 to $4
8CAoOzhmB8n3nRFf3V4BTg: folds
U6tnjwZRpTnM+YkqkCjwyQ: calls $3
*** FLOP *** [7d 8h 2s]
U6tnjwZRpTnM+YkqkCjwyQ: checks
TSuRyAHnUPCFjP7Z0rEE0w: bets $6
U6tnjwZRpTnM+YkqkCjwyQ: folds
TSuRyAHnUPCFjP7Z0rEE0w collected $8.10 from pot
TSuRyAHnUPCFjP7Z0rEE0w: doesn't show hand
*** SUMMARY ***
Total pot $8.50 | Rake $0.40
Board [7d 8h 2s]
Seat 1: TSuRyAHnUPCFjP7Z0rEE0w (button) collected ($8.10)
Seat 2: 8CAoOzhmB8n3nRFf3V4BTg (small blind) folded before Flop
Seat 3: U6tnjwZRpTnM+YkqkCjwyQ (big blind) folded on the Flop
Seat 4: GDVIsbEJ/DOJsMKE4Asz0A folded before Flop (didn't bet)
Seat 5: QHvTZcrKe6+maWUfVjP29Q folded before Flop (didn't bet)
Seat 6: hpxXcmRkXXI9HE5+5/j/0Q folded before Flop (didn't bet)



PokerStars Game #59938980742:  Hold'em No Limit ($0.50/$1.00) - 2009/07/01 0:28:21 ET
Table 'N2bNCDHL96aCQDvZIh+yQQ' 6-max Seat #1 is the button
Seat 1: iHo1oDbrEVJ8nEGdaPrICw ($143.50 in chips)
Seat 2: KpnW5CcJ4Mg6MeclfKmLrw ($101 in chips)
Seat 4: uCqEjnxh2/vFBjKYkfTOkw ($164.40 in chips)
Seat 5: rHlMOfR7kpQQxe+PFQz0xQ ($38.40 in chips)
Seat 6: TSuRyAHnUPCFjP7Z0rEE0w ($100 in chips)
KpnW5CcJ4Mg6MeclfKmLrw: posts small blind $0.50
uCqEjnxh2/vFBjKYkfTOkw: posts big blind $1
*** HOLE CARDS ***
rHlMOfR7kpQQxe+PFQz0xQ: folds
TSuRyAHnUPCFjP7Z0rEE0w: folds
iHo1oDbrEVJ8nEGdaPrICw: folds
KpnW5CcJ4Mg6MeclfKmLrw: raises $3 to $4
uCqEjnxh2/vFBjKYkfTOkw: folds
KpnW5CcJ4Mg6MeclfKmLrw collected $2 from pot
KpnW5CcJ4Mg6MeclfKmLrw: doesn't show hand
*** SUMMARY ***
Total pot $2 | Rake $0
Seat 1: iHo1oDbrEVJ8nEGdaPrICw (button) folded before Flop (didn't bet)
Seat 2: KpnW5CcJ4Mg6MeclfKmLrw (small blind) collected ($2)
Seat 4: uCqEjnxh2/vFBjKYkfTOkw (big blind) folded before Flop
Seat 5: rHlMOfR7kpQQxe+PFQz0xQ folded before Flop (didn't bet)
Seat 6: TSuRyAHnUPCFjP7Z0rEE0w folded before Flop (didn't bet)



PokerStars Game #59938982184:  Hold'em No Limit ($0.50/$1.00) - 2009/07/01 0:28:23 ET
Table 'tyUh+jyNvrceIQdKMJjQ2wZFWj23PMihdwrNWv41OG/Qeat #6 is the button
Seat 2: 6iVcnPw9a2oNG6sPQo3G6g ($94.50 in chips)
Seat 3: L9qfLYXrczhAPd/VckgsWw ($40.20 in chips)
Seat 4: TSuRyAHnUPCFjP7Z0rEE0w ($120.95 in chips)
Seat 5: j7NIOHLZk7V2o9fOioO5ug ($119.60 in chips)
Seat 6: YsLQ3BAvgQHWXMAv3Wv6Hg ($103.75 in chips)
6iVcnPw9a2oNG6sPQo3G6g: posts small blind $0.50
L9qfLYXrczhAPd/VckgsWw: posts big blind $1
*** HOLE CARDS ***
TSuRyAHnUPCFjP7Z0rEE0w: folds
j7NIOHLZk7V2o9fOioO5ug: folds
YsLQ3BAvgQHWXMAv3Wv6Hg: folds
6iVcnPw9a2oNG6sPQo3G6g: folds
L9qfLYXrczhAPd/VckgsWw collected $1 from pot
L9qfLYXrczhAPd/VckgsWw: doesn't show hand
*** SUMMARY ***
Total pot $1 | Rake $0
Seat 2: 6iVcnPw9a2oNG6sPQo3G6g (small blind) folded before Flop
Seat 3: L9qfLYXrczhAPd/VckgsWw (big blind) collected ($1)
Seat 4: TSuRyAHnUPCFjP7Z0rEE0w folded before Flop (didn't bet)
Seat 5: j7NIOHLZk7V2o9fOioO5ug folded before Flop (didn't bet)
Seat 6: YsLQ3BAvgQHWXMAv3Wv6Hg (button) folded before Flop (didn't bet)



PokerStars Game #59938983020:  Hold'em No Limit ($0.50/$1.00) - 2009/07/01 0:28:24 ET
Table 'vs/5jr6ciwjVQ5+Soc+u2A' 6-max Seat #3 is the button
Seat 2: XOIf9W+VAxhZqN+SYoyMKA ($120.30 in chips)
Seat 3: G5ZSSN6RSON3gkNvk/SmYg ($100 in chips)
Seat 4: KpnW5CcJ4Mg6MeclfKmLrw ($115.80 in chips)
Seat 5: 7Vc9JmGFQwMRh5Tj9ui5Lw ($93.45 in chips)
Seat 6: QHvTZcrKe6+maWUfVjP29Q ($100 in chips)
KpnW5CcJ4Mg6MeclfKmLrw: posts small blind $0.50
7Vc9JmGFQwMRh5Tj9ui5Lw: posts big blind $1
*** HOLE CARDS ***
QHvTZcrKe6+maWUfVjP29Q: folds
XOIf9W+VAxhZqN+SYoyMKA: folds
G5ZSSN6RSON3gkNvk/SmYg: raises $2 to $3
KpnW5CcJ4Mg6MeclfKmLrw: folds
7Vc9JmGFQwMRh5Tj9ui5Lw: calls $2
*** FLOP *** [9c 5c 8h]
7Vc9JmGFQwMRh5Tj9ui5Lw: bets $5
G5ZSSN6RSON3gkNvk/SmYg: folds
7Vc9JmGFQwMRh5Tj9ui5Lw collected $6.20 from pot
7Vc9JmGFQwMRh5Tj9ui5Lw: doesn't show hand
*** SUMMARY ***
Total pot $6.50 | Rake $0.30
Board [9c 5c 8h]
Seat 2: XOIf9W+VAxhZqN+SYoyMKA folded before Flop (didn't bet)
Seat 3: G5ZSSN6RSON3gkNvk/SmYg (button) folded on the Flop
Seat 4: KpnW5CcJ4Mg6MeclfKmLrw (small blind) folded before Flop
Seat 5: 7Vc9JmGFQwMRh5Tj9ui5Lw (big blind) collected ($6.20)
Seat 6: QHvTZcrKe6+maWUfVjP29Q folded before Flop (didn't bet)



PokerStars Game #59938982754:  Hold'em No Limit ($0.50/$1.00) - 2009/07/01 0:28:24 ET
Table '/RZcOwpZpHQ+OwPwjsbnRw' 6-max Seat #3 is the button
Seat 1: Zboa6dColKGHBjLPUakZjw ($41 in chips)
Seat 2: dHC9PH9hdH3Ad2TD8ZxX0Q ($45.25 in chips)
Seat 3: OigyyiK+tTj1APPIAUmXDA ($72.65 in chips)
Seat 4: j7NIOHLZk7V2o9fOioO5ug ($123.60 in chips)
Seat 5: wx3sQGkVi2x9wJXuWNHPBw ($200.55 in chips)
Seat 6: XOIf9W+VAxhZqN+SYoyMKA ($250.80 in chips)
j7NIOHLZk7V2o9fOioO5ug: posts small blind $0.50
wx3sQGkVi2x9wJXuWNHPBw: posts big blind $1
*** HOLE CARDS ***
XOIf9W+VAxhZqN+SYoyMKA: folds
Zboa6dColKGHBjLPUakZjw: folds
dHC9PH9hdH3Ad2TD8ZxX0Q: calls $1
OigyyiK+tTj1APPIAUmXDA: folds
j7NIOHLZk7V2o9fOioO5ug: calls $0.50
wx3sQGkVi2x9wJXuWNHPBw: checks
*** FLOP *** [Jc 6s 5d]
j7NIOHLZk7V2o9fOioO5ug: bets $3
wx3sQGkVi2x9wJXuWNHPBw: calls $3
dHC9PH9hdH3Ad2TD8ZxX0Q: folds
*** TURN *** [Jc 6s 5d] [Kh]
j7NIOHLZk7V2o9fOioO5ug: checks
wx3sQGkVi2x9wJXuWNHPBw: checks
*** RIVER *** [Jc 6s 5d Kh] [3c]
j7NIOHLZk7V2o9fOioO5ug: checks
wx3sQGkVi2x9wJXuWNHPBw: checks
*** SHOW DOWN ***
j7NIOHLZk7V2o9fOioO5ug: shows [Qd 6d] (a pair of Sixes)
wx3sQGkVi2x9wJXuWNHPBw: shows [7h Jh] (a pair of Jacks)
wx3sQGkVi2x9wJXuWNHPBw collected $8.60 from pot
*** SUMMARY ***
Total pot $9 | Rake $0.40
Board [Jc 6s 5d Kh 3c]
Seat 1: Zboa6dColKGHBjLPUakZjw folded before Flop (didn't bet)
Seat 2: dHC9PH9hdH3Ad2TD8ZxX0Q folded on the Flop
Seat 3: OigyyiK+tTj1APPIAUmXDA (button) folded before Flop (didn't bet)
Seat 4: j7NIOHLZk7V2o9fOioO5ug (small blind) showed [Qd 6d] and lost with a pair of Sixes
Seat 5: wx3sQGkVi2x9wJXuWNHPBw (big blind) showed [7h Jh] and won ($8.60) with a pair of Jacks
Seat 6: XOIf9W+VAxhZqN+SYoyMKA folded before Flop (didn't bet)



PokerStars Game #59938982798:  Hold'em No Limit ($0.50/$1.00) - 2009/07/01 0:28:24 ET
Table 'QSIig7BLMc9wY/rgBechzw' 6-max Seat #3 is the button
Seat 1: uuA9hpFU17U5/t4cvpbpBg ($30.55 in chips)
Seat 2: 0WjiuIT7/EolY1oOx1ngeA ($124.75 in chips)
Seat 3: +W6OnF033KNM2xH0fGj98Q ($120.20 in chips)
Seat 4: +uSzP8Jwnw7sKfQ4s66b7w ($46 in chips)
Seat 5: bvU2ZjpVnszLCFVeWbxePg ($113.70 in chips)
Seat 6: KpnW5CcJ4Mg6MeclfKmLrw ($127.75 in chips)
+uSzP8Jwnw7sKfQ4s66b7w: posts small blind $0.50
bvU2ZjpVnszLCFVeWbxePg: posts big blind $1
*** HOLE CARDS ***
KpnW5CcJ4Mg6MeclfKmLrw: folds
uuA9hpFU17U5/t4cvpbpBg: folds
0WjiuIT7/EolY1oOx1ngeA: raises $2 to $3
+W6OnF033KNM2xH0fGj98Q: folds
+uSzP8Jwnw7sKfQ4s66b7w: folds
bvU2ZjpVnszLCFVeWbxePg: folds
0WjiuIT7/EolY1oOx1ngeA collected $2.50 from pot
0WjiuIT7/EolY1oOx1ngeA: doesn't show hand
*** SUMMARY ***
Total pot $2.50 | Rake $0
Seat 1: uuA9hpFU17U5/t4cvpbpBg folded before Flop (didn't bet)
Seat 2: 0WjiuIT7/EolY1oOx1ngeA collected ($2.50)
Seat 3: +W6OnF033KNM2xH0fGj98Q (button) folded before Flop (didn't bet)
Seat 4: +uSzP8Jwnw7sKfQ4s66b7w (small blind) folded before Flop
Seat 5: bvU2ZjpVnszLCFVeWbxePg (big blind) folded before Flop
Seat 6: KpnW5CcJ4Mg6MeclfKmLrw folded before Flop (didn't bet)



PokerStars Game #59938984632:  Hold'em No Limit ($0.50/$1.00) - 2009/07/01 0:28:27 ET
Table 'VOs36P6NW+QyXeQ1B62kmA' 6-max Seat #4 is the button
Seat 1: AdLVjddOzm+sRNo1Bc3S6Q ($137.05 in chips)
Seat 2: KpnW5CcJ4Mg6MeclfKmLrw ($114.80 in chips)
Seat 3: TSuRyAHnUPCFjP7Z0rEE0w ($102.55 in chips)
Seat 4: w02zQzNydODiyV9THKgo9w ($29.65 in chips)
Seat 5: X7GlkHF+lkbarCLuZ4Uf0w ($20 in chips)
Seat 6: 6tvjsJrdmWg+g7FVrMnzXA ($73.10 in chips)
X7GlkHF+lkbarCLuZ4Uf0w: posts small blind $0.50
6tvjsJrdmWg+g7FVrMnzXA: posts big blind $1
*** HOLE CARDS ***
AdLVjddOzm+sRNo1Bc3S6Q: raises $3 to $4
KpnW5CcJ4Mg6MeclfKmLrw: folds
TSuRyAHnUPCFjP7Z0rEE0w: folds
w02zQzNydODiyV9THKgo9w: folds
X7GlkHF+lkbarCLuZ4Uf0w: folds
6tvjsJrdmWg+g7FVrMnzXA: calls $3
*** FLOP *** [Jc Ac 9d]
6tvjsJrdmWg+g7FVrMnzXA: checks
AdLVjddOzm+sRNo1Bc3S6Q: bets $7
6tvjsJrdmWg+g7FVrMnzXA: folds
AdLVjddOzm+sRNo1Bc3S6Q collected $8.10 from pot
AdLVjddOzm+sRNo1Bc3S6Q: doesn't show hand
*** SUMMARY ***
Total pot $8.50 | Rake $0.40
Board [Jc Ac 9d]
Seat 1: AdLVjddOzm+sRNo1Bc3S6Q collected ($8.10)
Seat 2: KpnW5CcJ4Mg6MeclfKmLrw folded before Flop (didn't bet)
Seat 3: TSuRyAHnUPCFjP7Z0rEE0w folded before Flop (didn't bet)
Seat 4: w02zQzNydODiyV9THKgo9w (button) folded before Flop (didn't bet)
Seat 5: X7GlkHF+lkbarCLuZ4Uf0w (small blind) folded before Flop
Seat 6: 6tvjsJrdmWg+g7FVrMnzXA (big blind) folded on the Flop



PokerStars Game #59938985278:  Hold'em No Limit ($0.50/$1.00) - 2009/07/01 0:28:28 ET
Table 'GxCPo/gd3OSthkYrAxJngg' 6-max Seat #3 is the button
Seat 1: sH8BpAFP+jGFxCgVpD1Lew ($279.45 in chips)
Seat 2: YExX2paeIHrmfIwV1ivM/w ($65.20 in chips)
Seat 3: o6plE+MSW4XFNTeONe16xg ($35.10 in chips)
Seat 4: YMJG+F++3Aj6P8dAWda5fw ($110.15 in chips)
Seat 5: G5ZSSN6RSON3gkNvk/SmYg ($100 in chips)
Seat 6: sS9IXedL3MiRmpVXhAILhw ($97 in chips)
YMJG+F++3Aj6P8dAWda5fw: posts small blind $0.50
G5ZSSN6RSON3gkNvk/SmYg: posts big blind $1
*** HOLE CARDS ***
sS9IXedL3MiRmpVXhAILhw: folds
sH8BpAFP+jGFxCgVpD1Lew: raises $3 to $4
YExX2paeIHrmfIwV1ivM/w: folds
o6plE+MSW4XFNTeONe16xg: folds
YMJG+F++3Aj6P8dAWda5fw: folds
G5ZSSN6RSON3gkNvk/SmYg: folds
sH8BpAFP+jGFxCgVpD1Lew collected $2.50 from pot
*** SUMMARY ***
Total pot $2.50 | Rake $0
Seat 1: sH8BpAFP+jGFxCgVpD1Lew collected ($2.50)
Seat 2: YExX2paeIHrmfIwV1ivM/w folded before Flop (didn't bet)
Seat 3: o6plE+MSW4XFNTeONe16xg (button) folded before Flop (didn't bet)
Seat 4: YMJG+F++3Aj6P8dAWda5fw (small blind) folded before Flop
Seat 5: G5ZSSN6RSON3gkNvk/SmYg (big blind) folded before Flop
Seat 6: sS9IXedL3MiRmpVXhAILhw folded before Flop (didn't bet)



PokerStars Game #59938987396:  Hold'em No Limit ($0.50/$1.00) - 2009/07/01 0:28:31 ET
Table 'W/wyObTiXZm+Ckkl3YxcSw' 6-max Seat #6 is the button
Seat 1: ssLJburtEIqnVkx6X8R1uw ($114.75 in chips)
Seat 2: oDiBRCaF0QVtd3kO6xZIXw ($104.20 in chips)
Seat 3: b2a+5TkFf4xJN/Ihhma58Q ($42.70 in chips)
Seat 4: +xW7QemQU0Fxs+4TnqBRow ($101.50 in chips)
Seat 6: 1yB1nHUkHNNY8OJnDNHZMw ($92 in chips)
ssLJburtEIqnVkx6X8R1uw: posts small blind $0.50
oDiBRCaF0QVtd3kO6xZIXw: posts big blind $1
*** HOLE CARDS ***
b2a+5TkFf4xJN/Ihhma58Q: folds
+xW7QemQU0Fxs+4TnqBRow: folds
1yB1nHUkHNNY8OJnDNHZMw: raises $2 to $3
ssLJburtEIqnVkx6X8R1uw: folds
oDiBRCaF0QVtd3kO6xZIXw: folds
1yB1nHUkHNNY8OJnDNHZMw collected $2.50 from pot
*** SUMMARY ***
Total pot $2.50 | Rake $0
Seat 1: ssLJburtEIqnVkx6X8R1uw (small blind) folded before Flop
Seat 2: oDiBRCaF0QVtd3kO6xZIXw (big blind) folded before Flop
Seat 3: b2a+5TkFf4xJN/Ihhma58Q folded before Flop (didn't bet)
Seat 4: +xW7QemQU0Fxs+4TnqBRow folded before Flop (didn't bet)
Seat 6: 1yB1nHUkHNNY8OJnDNHZMw (button) collected ($2.50)



PokerStars Game #59938988216:  Hold'em No Limit ($0.50/$1.00) - 2009/07/01 0:28:32 ET
Table 'tLrtq7gDzxEvckNAI1OS5Q' 6-max Seat #3 is the button
Seat 1: GisIe1kcC9q/xV6ifsTjgA ($147.35 in chips)
Seat 2: qsObMEIlRO22OlS867m/lw ($15.80 in chips)
Seat 3: TPZ+m9x+lwoKpv7TMfAUWA ($318.30 in chips)
Seat 4: KOG8rG51mOvIoY96zF3kvw ($162.30 in chips)
Seat 5: OGMLOcTNYZXZU81au7ztUw ($166.45 in chips)
Seat 6: XUk5GQsfNFpHvaToDZ0rZA ($50.75 in chips)
KOG8rG51mOvIoY96zF3kvw: posts small blind $0.50
OGMLOcTNYZXZU81au7ztUw: posts big blind $1
*** HOLE CARDS ***
XUk5GQsfNFpHvaToDZ0rZA: folds
GisIe1kcC9q/xV6ifsTjgA: raises $3 to $4
qsObMEIlRO22OlS867m/lw: calls $4
TPZ+m9x+lwoKpv7TMfAUWA: folds
KOG8rG51mOvIoY96zF3kvw: folds
OGMLOcTNYZXZU81au7ztUw: folds
*** FLOP *** [3h 5s 2s]
GisIe1kcC9q/xV6ifsTjgA: checks
qsObMEIlRO22OlS867m/lw: bets $11.80 and is all-in
GisIe1kcC9q/xV6ifsTjgA: folds
qsObMEIlRO22OlS867m/lw collected $9.05 from pot
qsObMEIlRO22OlS867m/lw: doesn't show hand
*** SUMMARY ***
Total pot $9.50 | Rake $0.45
Board [3h 5s 2s]
Seat 1: GisIe1kcC9q/xV6ifsTjgA folded on the Flop
Seat 2: qsObMEIlRO22OlS867m/lw collected ($9.05)
Seat 3: TPZ+m9x+lwoKpv7TMfAUWA (button) folded before Flop (didn't bet)
Seat 4: KOG8rG51mOvIoY96zF3kvw (small blind) folded before Flop
Seat 5: OGMLOcTNYZXZU81au7ztUw (big blind) folded before Flop
Seat 6: XUk5GQsfNFpHvaToDZ0rZA folded before Flop (didn't bet)



PokerStars Game #59938988190:  Hold'em No Limit ($0.50/$1.00) - 2009/07/01 0:28:32 ET
Table '21a4iYFKcuezM4nYx8DWTA' 2-max Seat #1 is the button
Seat 1: NYi6JFscYNrofSXy4sM+Yw ($100 in chips)
Seat 2: +sy/nlNI20yZraIjs4AALg ($64.70 in chips)
NYi6JFscYNrofSXy4sM+Yw: posts small blind $0.50
+sy/nlNI20yZraIjs4AALg: posts big blind $1
*** HOLE CARDS ***
NYi6JFscYNrofSXy4sM+Yw: raises $2 to $3
+sy/nlNI20yZraIjs4AALg: raises $2 to $5
NYi6JFscYNrofSXy4sM+Yw: calls $2
*** FLOP *** [6d Kd 8d]
+sy/nlNI20yZraIjs4AALg: checks
NYi6JFscYNrofSXy4sM+Yw: checks
*** TURN *** [6d Kd 8d] [Th]
+sy/nlNI20yZraIjs4AALg: bets $5
NYi6JFscYNrofSXy4sM+Yw: folds
+sy/nlNI20yZraIjs4AALg collected $9.50 from pot
*** SUMMARY ***
Total pot $10 | Rake $0.50
Board [6d Kd 8d Th]
Seat 1: NYi6JFscYNrofSXy4sM+Yw (button) (small blind) folded on the Turn
Seat 2: +sy/nlNI20yZraIjs4AALg (big blind) collected ($9.50)



PokerStars Game #59938988380:  Hold'em No Limit ($0.50/$1.00) - 2009/07/01 0:28:33 ET
Table 'O96CPOtvMBWP6kzuYDfdFA' 6-max Seat #5 is the button
Seat 3: V89DGjxE171oPREEbAXiyg ($33.15 in chips)
Seat 4: KOG8rG51mOvIoY96zF3kvw ($170.95 in chips)
Seat 5: wRxiu9OJzvvN84OYWW9jxQ ($131.75 in chips)
Seat 6: xNKcQzD9+/iHmtJn4vYq9w ($140.65 in chips)
xNKcQzD9+/iHmtJn4vYq9w: posts small blind $0.50
vTUNrd/7qIOJpW0suEu5hQ: is sitting out
V89DGjxE171oPREEbAXiyg: posts big blind $1
KOG8rG51mOvIoY96zF3kvw: posts small & big blinds $1.50
*** HOLE CARDS ***
vTUNrd/7qIOJpW0suEu5hQ leaves the table
KOG8rG51mOvIoY96zF3kvw: raises $5 to $6
wRxiu9OJzvvN84OYWW9jxQ: folds
xNKcQzD9+/iHmtJn4vYq9w: folds
V89DGjxE171oPREEbAXiyg: folds
KOG8rG51mOvIoY96zF3kvw collected $3 from pot
*** SUMMARY ***
Total pot $3 | Rake $0
Seat 3: V89DGjxE171oPREEbAXiyg (big blind) folded before Flop
Seat 4: KOG8rG51mOvIoY96zF3kvw collected ($3)
Seat 5: wRxiu9OJzvvN84OYWW9jxQ (button) folded before Flop (didn't bet)
Seat 6: xNKcQzD9+/iHmtJn4vYq9w (small blind) folded before Flop



PokerStars Game #59938990688:  Hold'em No Limit ($0.50/$1.00) - 2009/07/01 0:28:36 ET
Table 'tyUh+jyNvrceIQdKMJjQ2wZFWj23PMihdwrNWv41OG/Qeat #2 is the button
Seat 2: 6iVcnPw9a2oNG6sPQo3G6g ($94 in chips)
Seat 3: L9qfLYXrczhAPd/VckgsWw ($40.70 in chips)
Seat 4: TSuRyAHnUPCFjP7Z0rEE0w ($120.95 in chips)
Seat 5: j7NIOHLZk7V2o9fOioO5ug ($119.60 in chips)
Seat 6: YsLQ3BAvgQHWXMAv3Wv6Hg ($103.75 in chips)
L9qfLYXrczhAPd/VckgsWw: posts small blind $0.50
TSuRyAHnUPCFjP7Z0rEE0w: posts big blind $1
*** HOLE CARDS ***
j7NIOHLZk7V2o9fOioO5ug: folds
YsLQ3BAvgQHWXMAv3Wv6Hg: folds
6iVcnPw9a2oNG6sPQo3G6g: folds
L9qfLYXrczhAPd/VckgsWw: calls $0.50
TSuRyAHnUPCFjP7Z0rEE0w: checks
*** FLOP *** [Qd Td 6s]
L9qfLYXrczhAPd/VckgsWw: bets $1
TSuRyAHnUPCFjP7Z0rEE0w: folds
L9qfLYXrczhAPd/VckgsWw collected $1.90 from pot
L9qfLYXrczhAPd/VckgsWw: doesn't show hand
*** SUMMARY ***
Total pot $2 | Rake $0.10
Board [Qd Td 6s]
Seat 2: 6iVcnPw9a2oNG6sPQo3G6g (button) folded before Flop (didn't bet)
Seat 3: L9qfLYXrczhAPd/VckgsWw (small blind) collected ($1.90)
Seat 4: TSuRyAHnUPCFjP7Z0rEE0w (big blind) folded on the Flop
Seat 5: j7NIOHLZk7V2o9fOioO5ug folded before Flop (didn't bet)
Seat 6: YsLQ3BAvgQHWXMAv3Wv6Hg folded before Flop (didn't bet)



PokerStars Game #59938991342:  Hold'em No Limit ($0.50/$1.00) - 2009/07/01 0:28:37 ET
Table 'rmZfTK+oSebeUPJNbWhdAA' 6-max Seat #4 is the button
Seat 1: xAU6q2/cwmby2sxmA8VcmA ($100 in chips)
Seat 2: OigyyiK+tTj1APPIAUmXDA ($90.55 in chips)
Seat 3: 9yjOzGERLaEZS8CZ6YNHFg ($95.60 in chips)
Seat 4: OGMLOcTNYZXZU81au7ztUw ($127.20 in chips)
Seat 5: +xW7QemQU0Fxs+4TnqBRow ($100.50 in chips)
Seat 6: j7NIOHLZk7V2o9fOioO5ug ($103.50 in chips)
+xW7QemQU0Fxs+4TnqBRow: posts small blind $0.50
j7NIOHLZk7V2o9fOioO5ug: posts big blind $1
*** HOLE CARDS ***
xAU6q2/cwmby2sxmA8VcmA: raises $3 to $4
OigyyiK+tTj1APPIAUmXDA: folds
9yjOzGERLaEZS8CZ6YNHFg: calls $4
OGMLOcTNYZXZU81au7ztUw: folds
+xW7QemQU0Fxs+4TnqBRow: folds
j7NIOHLZk7V2o9fOioO5ug: folds
*** FLOP *** [2c Js 3s]
xAU6q2/cwmby2sxmA8VcmA: bets $9
9yjOzGERLaEZS8CZ6YNHFg: calls $9
*** TURN *** [2c Js 3s] [8h]
xAU6q2/cwmby2sxmA8VcmA: checks
9yjOzGERLaEZS8CZ6YNHFg: bets $9
xAU6q2/cwmby2sxmA8VcmA: calls $9
*** RIVER *** [2c Js 3s 8h] [6c]
xAU6q2/cwmby2sxmA8VcmA: checks
9yjOzGERLaEZS8CZ6YNHFg: checks
*** SHOW DOWN ***
xAU6q2/cwmby2sxmA8VcmA: shows [8c 9c] (a pair of Eights)
9yjOzGERLaEZS8CZ6YNHFg: shows [Jc Ad] (a pair of Jacks)
9yjOzGERLaEZS8CZ6YNHFg collected $43.30 from pot
*** SUMMARY ***
Total pot $45.50 | Rake $2.20
Board [2c Js 3s 8h 6c]
Seat 1: xAU6q2/cwmby2sxmA8VcmA showed [8c 9c] and lost with a pair of Eights
Seat 2: OigyyiK+tTj1APPIAUmXDA folded before Flop (didn't bet)
Seat 3: 9yjOzGERLaEZS8CZ6YNHFg showed [Jc Ad] and won ($43.30) with a pair of Jacks
Seat 4: OGMLOcTNYZXZU81au7ztUw (button) folded before Flop (didn't bet)
Seat 5: +xW7QemQU0Fxs+4TnqBRow (small blind) folded before Flop
Seat 6: j7NIOHLZk7V2o9fOioO5ug (big blind) folded before Flop



PokerStars Game #59938992856:  Hold'em No Limit ($0.50/$1.00) - 2009/07/01 0:28:39 ET
Table '6YvsYDPNIDx2v5z3bJnwZQ' 9-max Seat #9 is the button
Seat 1: Ogn4JDV3mp4ZDKO49IFzKA ($16 in chips)
Seat 2: 35DmRulmD2MgzT6Bbt6/2w ($25 in chips)
Seat 3: negfosHnGOZXSHpWDRKyBQ ($18.30 in chips)
Seat 4: kEr5NYB+JIG5+szcYMr6hA ($46.50 in chips)
Seat 5: mBRWbnUl8diyBO1qTJaNzw ($170.20 in chips)
Seat 6: uMPEfCcGCfsxmy53tVUMug ($106.40 in chips)
Seat 7: boixc27eqTYA1p0tUdMuBQ ($114 in chips)
Seat 8: PSFxpXgPedVZyHSu2Zhb7Q ($63.75 in chips)
Seat 9: jDwhY1kCdc6EkAHbT7PJMQ ($105.60 in chips)
Ogn4JDV3mp4ZDKO49IFzKA: posts small blind $0.50
35DmRulmD2MgzT6Bbt6/2w: posts big blind $1
*** HOLE CARDS ***
negfosHnGOZXSHpWDRKyBQ: folds
kEr5NYB+JIG5+szcYMr6hA: folds
mBRWbnUl8diyBO1qTJaNzw: raises $3 to $4
uMPEfCcGCfsxmy53tVUMug: folds
boixc27eqTYA1p0tUdMuBQ: folds
PSFxpXgPedVZyHSu2Zhb7Q: folds
jDwhY1kCdc6EkAHbT7PJMQ: folds
Ogn4JDV3mp4ZDKO49IFzKA: folds
35DmRulmD2MgzT6Bbt6/2w: calls $3
*** FLOP *** [8h 7h 9c]
35DmRulmD2MgzT6Bbt6/2w: bets $4
mBRWbnUl8diyBO1qTJaNzw: folds
35DmRulmD2MgzT6Bbt6/2w collected $8.10 from pot
*** SUMMARY ***
Total pot $8.50 | Rake $0.40
Board [8h 7h 9c]
Seat 1: Ogn4JDV3mp4ZDKO49IFzKA (small blind) folded before Flop
Seat 2: 35DmRulmD2MgzT6Bbt6/2w (big blind) collected ($8.10)
Seat 3: negfosHnGOZXSHpWDRKyBQ folded before Flop (didn't bet)
Seat 4: kEr5NYB+JIG5+szcYMr6hA folded before Flop (didn't bet)
Seat 5: mBRWbnUl8diyBO1qTJaNzw folded on the Flop
Seat 6: uMPEfCcGCfsxmy53tVUMug folded before Flop (didn't bet)
Seat 7: boixc27eqTYA1p0tUdMuBQ folded before Flop (didn't bet)
Seat 8: PSFxpXgPedVZyHSu2Zhb7Q folded before Flop (didn't bet)
Seat 9: jDwhY1kCdc6EkAHbT7PJMQ (button) folded before Flop (didn't bet)



PokerStars Game #59938992658:  Hold'em No Limit ($0.50/$1.00) - 2009/07/01 0:28:39 ET
Table 'cBDNutyLBKEk9+ptwsKmTw' 6-max Seat #2 is the button
Seat 1: xAU6q2/cwmby2sxmA8VcmA ($104.55 in chips)
Seat 2: KyaE4+hWgUNIWWOWy4D14w ($81.60 in chips)
Seat 3: G5ZSSN6RSON3gkNvk/SmYg ($105.40 in chips)
Seat 4: 0WjiuIT7/EolY1oOx1ngeA ($106.15 in chips)
Seat 5: OGMLOcTNYZXZU81au7ztUw ($117.85 in chips)
G5ZSSN6RSON3gkNvk/SmYg: posts small blind $0.50
0WjiuIT7/EolY1oOx1ngeA: posts big blind $1
*** HOLE CARDS ***
OGMLOcTNYZXZU81au7ztUw: folds
xAU6q2/cwmby2sxmA8VcmA: raises $3 to $4
KyaE4+hWgUNIWWOWy4D14w: folds
KyaE4+hWgUNIWWOWy4D14w leaves the table
G5ZSSN6RSON3gkNvk/SmYg: raises $9 to $13
0WjiuIT7/EolY1oOx1ngeA: folds
xAU6q2/cwmby2sxmA8VcmA: folds
G5ZSSN6RSON3gkNvk/SmYg collected $9 from pot
G5ZSSN6RSON3gkNvk/SmYg: doesn't show hand
*** SUMMARY ***
Total pot $9 | Rake $0
Seat 1: xAU6q2/cwmby2sxmA8VcmA folded before Flop
Seat 2: KyaE4+hWgUNIWWOWy4D14w (button) folded before Flop (didn't bet)
Seat 3: G5ZSSN6RSON3gkNvk/SmYg (small blind) collected ($9)
Seat 4: 0WjiuIT7/EolY1oOx1ngeA (big blind) folded before Flop
Seat 5: OGMLOcTNYZXZU81au7ztUw folded before Flop (didn't bet)



PokerStars Game #59938994360:  Hold'em No Limit ($0.50/$1.00) - 2009/07/01 0:28:42 ET
Table 'Zka9tv1yilg0MvXWPQrShg' 9-max Seat #6 is the button
Seat 1: TZcz9MEWDA+WydgGruqqbw ($109.90 in chips)
Seat 2: rR1qGAf9Q9RYorKYWH3VKw ($21.50 in chips)
Seat 3: gUUvmqdVlmvpal6B8nYrmg ($102.50 in chips)
Seat 4: CTOae+JLIGfwfXvhqHkP2w ($170.65 in chips)
Seat 5: /zy+DB4S5fUQUSfZWFzYGw ($139.95 in chips)
Seat 6: rY8wPoax1lS+HUY+I0FZDw ($128.40 in chips)
Seat 7: p1SafS90nb3Uft5LB0NkHw ($20.50 in chips)
Seat 8: bL+QVeDcuEdzMGAGg2XJHg ($124.60 in chips)
p1SafS90nb3Uft5LB0NkHw: posts small blind $0.50
bL+QVeDcuEdzMGAGg2XJHg: posts big blind $1
*** HOLE CARDS ***
TZcz9MEWDA+WydgGruqqbw: folds
rR1qGAf9Q9RYorKYWH3VKw: folds
gUUvmqdVlmvpal6B8nYrmg: folds
CTOae+JLIGfwfXvhqHkP2w: folds
6daxhj43mWj04MOPTOmaYA joins the table at seat #9
/zy+DB4S5fUQUSfZWFzYGw: folds
rY8wPoax1lS+HUY+I0FZDw: raises $3 to $4
p1SafS90nb3Uft5LB0NkHw: folds
bL+QVeDcuEdzMGAGg2XJHg: folds
rY8wPoax1lS+HUY+I0FZDw collected $2.50 from pot
*** SUMMARY ***
Total pot $2.50 | Rake $0
Seat 1: TZcz9MEWDA+WydgGruqqbw folded before Flop (didn't bet)
Seat 2: rR1qGAf9Q9RYorKYWH3VKw folded before Flop (didn't bet)
Seat 3: gUUvmqdVlmvpal6B8nYrmg folded before Flop (didn't bet)
Seat 4: CTOae+JLIGfwfXvhqHkP2w folded before Flop (didn't bet)
Seat 5: /zy+DB4S5fUQUSfZWFzYGw folded before Flop (didn't bet)
Seat 6: rY8wPoax1lS+HUY+I0FZDw (button) collected ($2.50)
Seat 7: p1SafS90nb3Uft5LB0NkHw (small blind) folded before Flop
Seat 8: bL+QVeDcuEdzMGAGg2XJHg (big blind) folded before Flop



PokerStars Game #59938996324:  Hold'em No Limit ($0.50/$1.00) - 2009/07/01 0:28:45 ET
Table '7Nl0ffnjeK44/vmeexh3MQ' 9-max Seat #6 is the button
Seat 1: s7D3Y+k4Cj4D1cXHv7oj+Q ($101.45 in chips)
Seat 2: kiakSwxX0e64PwYGAPQvLw ($31.85 in chips)
Seat 3: vR4IO10geOgvTW+LAUBv/A ($100 in chips)
Seat 5: bL+QVeDcuEdzMGAGg2XJHg ($113.95 in chips)
Seat 6: FVs16t7GgfWgQWt4JxsObQ ($5.55 in chips)
Seat 7: knewtTmBc4Tc0z/5tAABYQ ($105.50 in chips)
Seat 8: zanka7aAZkigmZpfopXxxA ($228.20 in chips)
Seat 9: ouwUBGRKnKK9uhn1G4Lf+A ($98.50 in chips)
knewtTmBc4Tc0z/5tAABYQ: posts small blind $0.50
zanka7aAZkigmZpfopXxxA: posts big blind $1
bLbSOSmSOnqE0iTcH/5dxA: sits out
*** HOLE CARDS ***
ouwUBGRKnKK9uhn1G4Lf+A: folds
s7D3Y+k4Cj4D1cXHv7oj+Q: folds
kiakSwxX0e64PwYGAPQvLw: folds
vR4IO10geOgvTW+LAUBv/A: folds
bL+QVeDcuEdzMGAGg2XJHg: raises $3 to $4
FVs16t7GgfWgQWt4JxsObQ: raises $1.55 to $5.55 and is all-in
knewtTmBc4Tc0z/5tAABYQ: folds
zanka7aAZkigmZpfopXxxA: folds
bL+QVeDcuEdzMGAGg2XJHg: calls $1.55
*** FLOP *** [6s 8s 5c]
*** TURN *** [6s 8s 5c] [As]
*** RIVER *** [6s 8s 5c As] [Qh]
*** SHOW DOWN ***
bL+QVeDcuEdzMGAGg2XJHg: shows [Ks Qc] (a pair of Queens)
FVs16t7GgfWgQWt4JxsObQ: shows [Ah 3h] (a pair of Aces)
FVs16t7GgfWgQWt4JxsObQ collected $12 from pot
*** SUMMARY ***
Total pot $12.60 | Rake $0.60
Board [6s 8s 5c As Qh]
Seat 1: s7D3Y+k4Cj4D1cXHv7oj+Q folded before Flop (didn't bet)
Seat 2: kiakSwxX0e64PwYGAPQvLw folded before Flop (didn't bet)
Seat 3: vR4IO10geOgvTW+LAUBv/A folded before Flop (didn't bet)
Seat 5: bL+QVeDcuEdzMGAGg2XJHg showed [Ks Qc] and lost with a pair of Queens
Seat 6: FVs16t7GgfWgQWt4JxsObQ (button) showed [Ah 3h] and won ($12) with a pair of Aces
Seat 7: knewtTmBc4Tc0z/5tAABYQ (small blind) folded before Flop
Seat 8: zanka7aAZkigmZpfopXxxA (big blind) folded before Flop
Seat 9: ouwUBGRKnKK9uhn1G4Lf+A folded before Flop (didn't bet)



PokerStars Game #59938998020:  Hold'em No Limit ($0.50/$1.00) - 2009/07/01 0:28:47 ET
Table 'W/wyObTiXZm+Ckkl3YxcSw' 6-max Seat #1 is the button
Seat 1: ssLJburtEIqnVkx6X8R1uw ($114.25 in chips)
Seat 2: oDiBRCaF0QVtd3kO6xZIXw ($103.20 in chips)
Seat 3: b2a+5TkFf4xJN/Ihhma58Q ($42.70 in chips)
Seat 4: +xW7QemQU0Fxs+4TnqBRow ($101.50 in chips)
Seat 6: 1yB1nHUkHNNY8OJnDNHZMw ($93.50 in chips)
oDiBRCaF0QVtd3kO6xZIXw: posts small blind $0.50
b2a+5TkFf4xJN/Ihhma58Q: posts big blind $1
*** HOLE CARDS ***
+xW7QemQU0Fxs+4TnqBRow: folds
1yB1nHUkHNNY8OJnDNHZMw: folds
ssLJburtEIqnVkx6X8R1uw: folds
oDiBRCaF0QVtd3kO6xZIXw: folds
b2a+5TkFf4xJN/Ihhma58Q collected $1 from pot
*** SUMMARY ***
Total pot $1 | Rake $0
Seat 1: ssLJburtEIqnVkx6X8R1uw (button) folded before Flop (didn't bet)
Seat 2: oDiBRCaF0QVtd3kO6xZIXw (small blind) folded before Flop
Seat 3: b2a+5TkFf4xJN/Ihhma58Q (big blind) collected ($1)
Seat 4: +xW7QemQU0Fxs+4TnqBRow folded before Flop (didn't bet)
Seat 6: 1yB1nHUkHNNY8OJnDNHZMw folded before Flop (didn't bet)



PokerStars Game #59938999084:  Hold'em No Limit ($0.50/$1.00) - 2009/07/01 0:28:49 ET
Table 'fTlPiCj0utgzC/5io+I7ew' 6-max Seat #6 is the button
Seat 1: YMJG+F++3Aj6P8dAWda5fw ($99 in chips)
Seat 3: oDiBRCaF0QVtd3kO6xZIXw ($100 in chips)
Seat 4: uJVSceLggtsrJya+WtmUEA ($97.80 in chips)
Seat 5: bFrTkDcWGTxyvNul7GVdYg ($255.45 in chips)
Seat 6: jMljU/dOPMXfJi8OmbdYdw ($15 in chips)
YMJG+F++3Aj6P8dAWda5fw: posts small blind $0.50
+xUCTmR3cU7G239W+vZv6g: is sitting out
oDiBRCaF0QVtd3kO6xZIXw: posts big blind $1
*** HOLE CARDS ***
uJVSceLggtsrJya+WtmUEA: folds
+xUCTmR3cU7G239W+vZv6g leaves the table
bFrTkDcWGTxyvNul7GVdYg: folds
jMljU/dOPMXfJi8OmbdYdw: raises $2 to $3
YMJG+F++3Aj6P8dAWda5fw: folds
oDiBRCaF0QVtd3kO6xZIXw: folds
jMljU/dOPMXfJi8OmbdYdw collected $2.50 from pot
*** SUMMARY ***
Total pot $2.50 | Rake $0
Seat 1: YMJG+F++3Aj6P8dAWda5fw (small blind) folded before Flop
Seat 3: oDiBRCaF0QVtd3kO6xZIXw (big blind) folded before Flop
Seat 4: uJVSceLggtsrJya+WtmUEA folded before Flop (didn't bet)
Seat 5: bFrTkDcWGTxyvNul7GVdYg folded before Flop (didn't bet)
Seat 6: jMljU/dOPMXfJi8OmbdYdw (button) collected ($2.50)



PokerStars Game #59939000116:  Hold'em No Limit ($0.50/$1.00) - 2009/07/01 0:28:50 ET
Table 'N2bNCDHL96aCQDvZIh+yQQ' 6-max Seat #2 is the button
Seat 1: iHo1oDbrEVJ8nEGdaPrICw ($143.50 in chips)
Seat 2: KpnW5CcJ4Mg6MeclfKmLrw ($102 in chips)
Seat 4: uCqEjnxh2/vFBjKYkfTOkw ($163.40 in chips)
Seat 5: rHlMOfR7kpQQxe+PFQz0xQ ($38.40 in chips)
Seat 6: TSuRyAHnUPCFjP7Z0rEE0w ($100 in chips)
uCqEjnxh2/vFBjKYkfTOkw: posts small blind $0.50
rHlMOfR7kpQQxe+PFQz0xQ: posts big blind $1
*** HOLE CARDS ***
Qy/UBNbD2HaA0Ogxg8Sf3w joins the table at seat #3
TSuRyAHnUPCFjP7Z0rEE0w: folds
iHo1oDbrEVJ8nEGdaPrICw: raises $2 to $3
KpnW5CcJ4Mg6MeclfKmLrw: folds
uCqEjnxh2/vFBjKYkfTOkw: folds
rHlMOfR7kpQQxe+PFQz0xQ: folds
iHo1oDbrEVJ8nEGdaPrICw collected $2.50 from pot
iHo1oDbrEVJ8nEGdaPrICw: doesn't show hand
*** SUMMARY ***
Total pot $2.50 | Rake $0
Seat 1: iHo1oDbrEVJ8nEGdaPrICw collected ($2.50)
Seat 2: KpnW5CcJ4Mg6MeclfKmLrw (button) folded before Flop (didn't bet)
Seat 4: uCqEjnxh2/vFBjKYkfTOkw (small blind) folded before Flop
Seat 5: rHlMOfR7kpQQxe+PFQz0xQ (big blind) folded before Flop
Seat 6: TSuRyAHnUPCFjP7Z0rEE0w folded before Flop (didn't bet)



PokerStars Game #59938999892:  Hold'em No Limit ($0.50/$1.00) - 2009/07/01 0:28:50 ET
Table 'pHrhryH8jPNdQfY62f8v+g' 6-max Seat #6 is the button
Seat 1: BdbmJTZZ47quA9vUWwXtlw ($73.30 in chips)
Seat 2: RqgF7gRoKgRNW8Zoi1ty4A ($118 in chips)
Seat 3: 0WjiuIT7/EolY1oOx1ngeA ($101.50 in chips)
Seat 4: wenbG7TaM3H7h5kn78OFNw ($56 in chips)
Seat 5: VKAMJWCyQIT4iNxRjICMJA ($20 in chips)
Seat 6: xAU6q2/cwmby2sxmA8VcmA ($102.80 in chips)
BdbmJTZZ47quA9vUWwXtlw: posts small blind $0.50
RqgF7gRoKgRNW8Zoi1ty4A: posts big blind $1
VKAMJWCyQIT4iNxRjICMJA: posts big blind $1
*** HOLE CARDS ***
0WjiuIT7/EolY1oOx1ngeA: raises $2 to $3
wenbG7TaM3H7h5kn78OFNw: folds
VKAMJWCyQIT4iNxRjICMJA: raises $17 to $20 and is all-in
xAU6q2/cwmby2sxmA8VcmA: folds
BdbmJTZZ47quA9vUWwXtlw: folds
RqgF7gRoKgRNW8Zoi1ty4A: folds
0WjiuIT7/EolY1oOx1ngeA: calls $17
*** FLOP *** [9d 6s 2s]
*** TURN *** [9d 6s 2s] [Kh]
*** RIVER *** [9d 6s 2s Kh] [3h]
*** SHOW DOWN ***
0WjiuIT7/EolY1oOx1ngeA: shows [Jd Js] (a pair of Jacks)
VKAMJWCyQIT4iNxRjICMJA: shows [Ah Ks] (a pair of Kings)
VKAMJWCyQIT4iNxRjICMJA collected $39.45 from pot
*** SUMMARY ***
Total pot $41.50 | Rake $2.05
Board [9d 6s 2s Kh 3h]
Seat 1: BdbmJTZZ47quA9vUWwXtlw (small blind) folded before Flop
Seat 2: RqgF7gRoKgRNW8Zoi1ty4A (big blind) folded before Flop
Seat 3: 0WjiuIT7/EolY1oOx1ngeA showed [Jd Js] and lost with a pair of Jacks
Seat 4: wenbG7TaM3H7h5kn78OFNw folded before Flop (didn't bet)
Seat 5: VKAMJWCyQIT4iNxRjICMJA showed [Ah Ks] and won ($39.45) with a pair of Kings
Seat 6: xAU6q2/cwmby2sxmA8VcmA (button) folded before Flop (didn't bet)



PokerStars Game #59939000878:  Hold'em No Limit ($0.50/$1.00) - 2009/07/01 0:28:51 ET
Table 'U9zqzC8f3oTJ2ShXFgSSOA' 6-max Seat #1 is the button
Seat 1: tS9JHB1h+FQ++qu8RwRNgg ($34.60 in chips)
Seat 2: U2CWBTv29qdCbj8RNF2sIw ($101.85 in chips)
Seat 3: yfXek8iJ7O4CFyqXrtGcfg ($44.05 in chips)
Seat 4: 33q95we0Etwgrm6guQGncw ($72.40 in chips)
Seat 5: KfwW5us6tydK81NYTtK1gw ($304.40 in chips)
Seat 6: aIxzFKdtpDSkUePKZy/niQ ($38.90 in chips)
U2CWBTv29qdCbj8RNF2sIw: posts small blind $0.50
yfXek8iJ7O4CFyqXrtGcfg: posts big blind $1
*** HOLE CARDS ***
33q95we0Etwgrm6guQGncw: raises $2 to $3
KfwW5us6tydK81NYTtK1gw: calls $3
aIxzFKdtpDSkUePKZy/niQ: folds
tS9JHB1h+FQ++qu8RwRNgg: folds
U2CWBTv29qdCbj8RNF2sIw: folds
yfXek8iJ7O4CFyqXrtGcfg: folds
*** FLOP *** [4s Ks Qs]
33q95we0Etwgrm6guQGncw: checks
KfwW5us6tydK81NYTtK1gw: bets $5
33q95we0Etwgrm6guQGncw: folds
KfwW5us6tydK81NYTtK1gw collected $7.15 from pot
KfwW5us6tydK81NYTtK1gw: doesn't show hand
*** SUMMARY ***
Total pot $7.50 | Rake $0.35
Board [4s Ks Qs]
Seat 1: tS9JHB1h+FQ++qu8RwRNgg (button) folded before Flop (didn't bet)
Seat 2: U2CWBTv29qdCbj8RNF2sIw (small blind) folded before Flop
Seat 3: yfXek8iJ7O4CFyqXrtGcfg (big blind) folded before Flop
Seat 4: 33q95we0Etwgrm6guQGncw folded on the Flop
Seat 5: KfwW5us6tydK81NYTtK1gw collected ($7.15)
Seat 6: aIxzFKdtpDSkUePKZy/niQ folded before Flop (didn't bet)



PokerStars Game #59939002026:  Hold'em No Limit ($0.50/$1.00) - 2009/07/01 0:28:53 ET
Table 'JTT1XWaDZHSaMZQK7cR5uw' 2-max Seat #2 is the button
Seat 1: OLplZF6FEnLflv81Hz+Fxg ($100 in chips)
Seat 2: JvCXzbBe8819gJgUhvI1LQ ($35 in chips)
JvCXzbBe8819gJgUhvI1LQ: posts small blind $0.50
OLplZF6FEnLflv81Hz+Fxg: posts big blind $1
*** HOLE CARDS ***
JvCXzbBe8819gJgUhvI1LQ: raises $3 to $4
OLplZF6FEnLflv81Hz+Fxg: folds
OLplZF6FEnLflv81Hz+Fxg is sitting out
JvCXzbBe8819gJgUhvI1LQ collected $2 from pot
*** SUMMARY ***
Total pot $2 | Rake $0
Seat 1: OLplZF6FEnLflv81Hz+Fxg (big blind) folded before Flop
Seat 2: JvCXzbBe8819gJgUhvI1LQ (button) (small blind) collected ($2)



PokerStars Game #59939002322:  Hold'em No Limit ($0.50/$1.00) - 2009/07/01 0:28:54 ET
Table 'QSIig7BLMc9wY/rgBechzw' 6-max Seat #4 is the button
Seat 1: uuA9hpFU17U5/t4cvpbpBg ($30.55 in chips)
Seat 2: 0WjiuIT7/EolY1oOx1ngeA ($126.25 in chips)
Seat 3: +W6OnF033KNM2xH0fGj98Q ($120.20 in chips)
Seat 4: +uSzP8Jwnw7sKfQ4s66b7w ($45.50 in chips)
Seat 5: bvU2ZjpVnszLCFVeWbxePg ($112.70 in chips)
Seat 6: KpnW5CcJ4Mg6MeclfKmLrw ($127.75 in chips)
bvU2ZjpVnszLCFVeWbxePg: posts small blind $0.50
KpnW5CcJ4Mg6MeclfKmLrw: posts big blind $1
*** HOLE CARDS ***
uuA9hpFU17U5/t4cvpbpBg: folds
0WjiuIT7/EolY1oOx1ngeA: folds
+W6OnF033KNM2xH0fGj98Q: folds
+uSzP8Jwnw7sKfQ4s66b7w: folds
bvU2ZjpVnszLCFVeWbxePg: raises $3 to $4
KpnW5CcJ4Mg6MeclfKmLrw: folds
bvU2ZjpVnszLCFVeWbxePg collected $2 from pot
bvU2ZjpVnszLCFVeWbxePg: doesn't show hand
*** SUMMARY ***
Total pot $2 | Rake $0
Seat 1: uuA9hpFU17U5/t4cvpbpBg folded before Flop (didn't bet)
Seat 2: 0WjiuIT7/EolY1oOx1ngeA folded before Flop (didn't bet)
Seat 3: +W6OnF033KNM2xH0fGj98Q folded before Flop (didn't bet)
Seat 4: +uSzP8Jwnw7sKfQ4s66b7w (button) folded before Flop (didn't bet)
Seat 5: bvU2ZjpVnszLCFVeWbxePg (small blind) collected ($2)
Seat 6: KpnW5CcJ4Mg6MeclfKmLrw (big blind) folded before Flop



PokerStars Game #59939003680:  Hold'em No Limit ($0.50/$1.00) - 2009/07/01 0:28:56 ET
Table '21a4iYFKcuezM4nYx8DWTA' 2-max Seat #2 is the button
Seat 1: NYi6JFscYNrofSXy4sM+Yw ($100 in chips)
Seat 2: +sy/nlNI20yZraIjs4AALg ($69.20 in chips)
+sy/nlNI20yZraIjs4AALg: posts small blind $0.50
NYi6JFscYNrofSXy4sM+Yw: posts big blind $1
*** HOLE CARDS ***
+sy/nlNI20yZraIjs4AALg: calls $0.50
NYi6JFscYNrofSXy4sM+Yw: checks
*** FLOP *** [Ts Ac 4s]
NYi6JFscYNrofSXy4sM+Yw: bets $2
+sy/nlNI20yZraIjs4AALg: folds
NYi6JFscYNrofSXy4sM+Yw collected $1.90 from pot
*** SUMMARY ***
Total pot $2 | Rake $0.10
Board [Ts Ac 4s]
Seat 1: NYi6JFscYNrofSXy4sM+Yw (big blind) collected ($1.90)
Seat 2: +sy/nlNI20yZraIjs4AALg (button) (small blind) folded on the Flop



PokerStars Game #59939004118:  Hold'em No Limit ($0.50/$1.00) - 2009/07/01 0:28:56 ET
Table 'kS0cTQAEi+fdUlJP2gQYvw' 9-max Seat #5 is the button
Seat 1: c/9X4zftzphFxYtxp5kp9w ($41.90 in chips)
Seat 2: 4SFNYndzMeslixOnF4koZQ ($54.05 in chips)
Seat 3: 3obndzTJ6fECz8+wWhMd1w ($17 in chips)
Seat 4: TZcz9MEWDA+WydgGruqqbw ($100 in chips)
Seat 5: 2rxrMrE7koO2BNxvop/0+g ($51.55 in chips)
Seat 6: yAbu2QsRPVcjPbqlf/jDxw ($100 in chips)
Seat 7: Ffa7Nj4X5fddtROP01hfQg ($103.05 in chips)
Seat 8: qTymj6ZQ8ZoFi6fINJZb3w ($88 in chips)
Seat 9: y8Qb94e81yI/g0saQ6gU5g ($84.75 in chips)
yAbu2QsRPVcjPbqlf/jDxw: posts small blind $0.50
Ffa7Nj4X5fddtROP01hfQg: posts big blind $1
*** HOLE CARDS ***
qTymj6ZQ8ZoFi6fINJZb3w: folds
y8Qb94e81yI/g0saQ6gU5g: folds
c/9X4zftzphFxYtxp5kp9w: folds
4SFNYndzMeslixOnF4koZQ: calls $1
3obndzTJ6fECz8+wWhMd1w: folds
TZcz9MEWDA+WydgGruqqbw: folds
2rxrMrE7koO2BNxvop/0+g: folds
yAbu2QsRPVcjPbqlf/jDxw: folds
Ffa7Nj4X5fddtROP01hfQg: checks
*** FLOP *** [Jd Kh 3c]
Ffa7Nj4X5fddtROP01hfQg: checks
4SFNYndzMeslixOnF4koZQ: checks
*** TURN *** [Jd Kh 3c] [5c]
Ffa7Nj4X5fddtROP01hfQg: bets $2
4SFNYndzMeslixOnF4koZQ: folds
Ffa7Nj4X5fddtROP01hfQg collected $2.40 from pot
*** SUMMARY ***
Total pot $2.50 | Rake $0.10
Board [Jd Kh 3c 5c]
Seat 1: c/9X4zftzphFxYtxp5kp9w folded before Flop (didn't bet)
Seat 2: 4SFNYndzMeslixOnF4koZQ folded on the Turn
Seat 3: 3obndzTJ6fECz8+wWhMd1w folded before Flop (didn't bet)
Seat 4: TZcz9MEWDA+WydgGruqqbw folded before Flop (didn't bet)
Seat 5: 2rxrMrE7koO2BNxvop/0+g (button) folded before Flop (didn't bet)
Seat 6: yAbu2QsRPVcjPbqlf/jDxw (small blind) folded before Flop
Seat 7: Ffa7Nj4X5fddtROP01hfQg (big blind) collected ($2.40)
Seat 8: qTymj6ZQ8ZoFi6fINJZb3w folded before Flop (didn't bet)
Seat 9: y8Qb94e81yI/g0saQ6gU5g folded before Flop (didn't bet)



PokerStars Game #59939004620:  Hold'em No Limit ($0.50/$1.00) - 2009/07/01 0:28:57 ET
Table 'MUPc8FEpe/nR0BKSeReX6Q' 6-max Seat #6 is the button
Seat 1: YsLQ3BAvgQHWXMAv3Wv6Hg ($100 in chips)
Seat 2: xAU6q2/cwmby2sxmA8VcmA ($110.50 in chips)
Seat 3: wx3sQGkVi2x9wJXuWNHPBw ($234.05 in chips)
Seat 4: ZA1bp6g8IwtTxkUE4eCjDQ ($110.50 in chips)
Seat 5: UBZQqpnJZdTYYY1FTb0rLA ($100 in chips)
Seat 6: oxnw0GLLpFanjhGkxfRSqA ($51.60 in chips)
YsLQ3BAvgQHWXMAv3Wv6Hg: posts small blind $0.50
xAU6q2/cwmby2sxmA8VcmA: posts big blind $1
*** HOLE CARDS ***
wx3sQGkVi2x9wJXuWNHPBw: folds
ZA1bp6g8IwtTxkUE4eCjDQ: folds
UBZQqpnJZdTYYY1FTb0rLA: folds
oxnw0GLLpFanjhGkxfRSqA: raises $2 to $3
YsLQ3BAvgQHWXMAv3Wv6Hg: folds
xAU6q2/cwmby2sxmA8VcmA: folds
oxnw0GLLpFanjhGkxfRSqA collected $2.50 from pot
*** SUMMARY ***
Total pot $2.50 | Rake $0
Seat 1: YsLQ3BAvgQHWXMAv3Wv6Hg (small blind) folded before Flop
Seat 2: xAU6q2/cwmby2sxmA8VcmA (big blind) folded before Flop
Seat 3: wx3sQGkVi2x9wJXuWNHPBw folded before Flop (didn't bet)
Seat 4: ZA1bp6g8IwtTxkUE4eCjDQ folded before Flop (didn't bet)
Seat 5: UBZQqpnJZdTYYY1FTb0rLA folded before Flop (didn't bet)
Seat 6: oxnw0GLLpFanjhGkxfRSqA (button) collected ($2.50)



PokerStars Game #59939005396:  Hold'em No Limit ($0.50/$1.00) - 2009/07/01 0:28:58 ET
Table 'GxCPo/gd3OSthkYrAxJngg' 6-max Seat #4 is the button
Seat 1: sH8BpAFP+jGFxCgVpD1Lew ($280.95 in chips)
Seat 2: YExX2paeIHrmfIwV1ivM/w ($65.20 in chips)
Seat 3: o6plE+MSW4XFNTeONe16xg ($35.10 in chips)
Seat 4: YMJG+F++3Aj6P8dAWda5fw ($109.65 in chips)
Seat 5: G5ZSSN6RSON3gkNvk/SmYg ($100 in chips)
Seat 6: sS9IXedL3MiRmpVXhAILhw ($97 in chips)
G5ZSSN6RSON3gkNvk/SmYg: posts small blind $0.50
sS9IXedL3MiRmpVXhAILhw: posts big blind $1
*** HOLE CARDS ***
sH8BpAFP+jGFxCgVpD1Lew: raises $2 to $3
YExX2paeIHrmfIwV1ivM/w: folds
o6plE+MSW4XFNTeONe16xg: folds
YMJG+F++3Aj6P8dAWda5fw: folds
G5ZSSN6RSON3gkNvk/SmYg: folds
sS9IXedL3MiRmpVXhAILhw: folds
sH8BpAFP+jGFxCgVpD1Lew collected $2.50 from pot
*** SUMMARY ***
Total pot $2.50 | Rake $0
Seat 1: sH8BpAFP+jGFxCgVpD1Lew collected ($2.50)
Seat 2: YExX2paeIHrmfIwV1ivM/w folded before Flop (didn't bet)
Seat 3: o6plE+MSW4XFNTeONe16xg folded before Flop (didn't bet)
Seat 4: YMJG+F++3Aj6P8dAWda5fw (button) folded before Flop (didn't bet)
Seat 5: G5ZSSN6RSON3gkNvk/SmYg (small blind) folded before Flop
Seat 6: sS9IXedL3MiRmpVXhAILhw (big blind) folded before Flop



PokerStars Game #59939006278:  Hold'em No Limit ($0.50/$1.00) - 2009/07/01 0:28:59 ET
Table 'O96CPOtvMBWP6kzuYDfdFA' 6-max Seat #6 is the button
Seat 3: V89DGjxE171oPREEbAXiyg ($32.15 in chips)
Seat 4: KOG8rG51mOvIoY96zF3kvw ($172.45 in chips)
Seat 5: wRxiu9OJzvvN84OYWW9jxQ ($131.75 in chips)
Seat 6: xNKcQzD9+/iHmtJn4vYq9w ($140.15 in chips)
V89DGjxE171oPREEbAXiyg: posts small blind $0.50
KOG8rG51mOvIoY96zF3kvw: posts big blind $1
*** HOLE CARDS ***
sc/HX9smXU5kObrOWIYO5g joins the table at seat #2
wRxiu9OJzvvN84OYWW9jxQ: folds
xNKcQzD9+/iHmtJn4vYq9w: raises $2 to $3
V89DGjxE171oPREEbAXiyg: folds
6alLXQIITA2EZ/lBeym8Dw joins the table at seat #1
KOG8rG51mOvIoY96zF3kvw: folds
xNKcQzD9+/iHmtJn4vYq9w collected $2.50 from pot
*** SUMMARY ***
Total pot $2.50 | Rake $0
Seat 3: V89DGjxE171oPREEbAXiyg (small blind) folded before Flop
Seat 4: KOG8rG51mOvIoY96zF3kvw (big blind) folded before Flop
Seat 5: wRxiu9OJzvvN84OYWW9jxQ folded before Flop (didn't bet)
Seat 6: xNKcQzD9+/iHmtJn4vYq9w (button) collected ($2.50)



PokerStars Game #59939006140:  Hold'em No Limit ($0.50/$1.00) - 2009/07/01 0:28:59 ET
Table 'W/wyObTiXZm+Ckkl3YxcSw' 6-max Seat #2 is the button
Seat 1: ssLJburtEIqnVkx6X8R1uw ($114.25 in chips)
Seat 2: oDiBRCaF0QVtd3kO6xZIXw ($102.70 in chips)
Seat 3: b2a+5TkFf4xJN/Ihhma58Q ($43.20 in chips)
Seat 4: +xW7QemQU0Fxs+4TnqBRow ($101.50 in chips)
Seat 6: 1yB1nHUkHNNY8OJnDNHZMw ($93.50 in chips)
b2a+5TkFf4xJN/Ihhma58Q: posts small blind $0.50
+xW7QemQU0Fxs+4TnqBRow: posts big blind $1
*** HOLE CARDS ***
1yB1nHUkHNNY8OJnDNHZMw: raises $2 to $3
ssLJburtEIqnVkx6X8R1uw: folds
oDiBRCaF0QVtd3kO6xZIXw: folds
b2a+5TkFf4xJN/Ihhma58Q: folds
+xW7QemQU0Fxs+4TnqBRow: folds
1yB1nHUkHNNY8OJnDNHZMw collected $2.50 from pot
*** SUMMARY ***
Total pot $2.50 | Rake $0
Seat 1: ssLJburtEIqnVkx6X8R1uw folded before Flop (didn't bet)
Seat 2: oDiBRCaF0QVtd3kO6xZIXw (button) folded before Flop (didn't bet)
Seat 3: b2a+5TkFf4xJN/Ihhma58Q (small blind) folded before Flop
Seat 4: +xW7QemQU0Fxs+4TnqBRow (big blind) folded before Flop
Seat 6: 1yB1nHUkHNNY8OJnDNHZMw collected ($2.50)



PokerStars Game #59939006544:  Hold'em No Limit ($0.50/$1.00) - 2009/07/01 0:29:00 ET
Table 'mmbQQVBTrPdE+wy+s+9VPA' 6-max Seat #4 is the button
Seat 1: xAU6q2/cwmby2sxmA8VcmA ($100 in chips)
Seat 2: ru6SCVvWcWt2SpmUsmArWQ ($29.60 in chips)
Seat 3: wx3sQGkVi2x9wJXuWNHPBw ($110.15 in chips)
Seat 4: RfKnhkJN8HEAuzJpH2Ajdg ($22.35 in chips)
Seat 5: YMJG+F++3Aj6P8dAWda5fw ($100 in chips)
YMJG+F++3Aj6P8dAWda5fw: posts small blind $0.50
xAU6q2/cwmby2sxmA8VcmA: posts big blind $1
*** HOLE CARDS ***
ru6SCVvWcWt2SpmUsmArWQ: folds
wx3sQGkVi2x9wJXuWNHPBw: folds
RfKnhkJN8HEAuzJpH2Ajdg: folds
YMJG+F++3Aj6P8dAWda5fw: folds
xAU6q2/cwmby2sxmA8VcmA collected $1 from pot
*** SUMMARY ***
Total pot $1 | Rake $0
Seat 1: xAU6q2/cwmby2sxmA8VcmA (big blind) collected ($1)
Seat 2: ru6SCVvWcWt2SpmUsmArWQ folded before Flop (didn't bet)
Seat 3: wx3sQGkVi2x9wJXuWNHPBw folded before Flop (didn't bet)
Seat 4: RfKnhkJN8HEAuzJpH2Ajdg (button) folded before Flop (didn't bet)
Seat 5: YMJG+F++3Aj6P8dAWda5fw (small blind) folded before Flop



PokerStars Game #59939007364:  Hold'em No Limit ($0.50/$1.00) - 2009/07/01 0:29:01 ET
Table '+cA8mcmhaedZ7YcrDdhmeQ' 6-max Seat #1 is the button
Seat 1: lsLuWlcPA3Rh7kJVLzMh0Q ($286 in chips)
Seat 2: trnpu4tPju3BU8W0wQQaiQ ($116.95 in chips)
Seat 3: 0WjiuIT7/EolY1oOx1ngeA ($116.30 in chips)
Seat 5: 6WyjEXOToimYmtLdqIgHYQ ($60 in chips)
Seat 6: YfsTQsY/fxb+YqbdclTHuw ($45 in chips)
trnpu4tPju3BU8W0wQQaiQ: posts small blind $0.50
0WjiuIT7/EolY1oOx1ngeA: posts big blind $1
LjL3AIERHn559yyW1mTUYQ: sits out
*** HOLE CARDS ***
6WyjEXOToimYmtLdqIgHYQ: folds
YfsTQsY/fxb+YqbdclTHuw: folds
lsLuWlcPA3Rh7kJVLzMh0Q: folds
trnpu4tPju3BU8W0wQQaiQ: folds
0WjiuIT7/EolY1oOx1ngeA collected $1 from pot
*** SUMMARY ***
Total pot $1 | Rake $0
Seat 1: lsLuWlcPA3Rh7kJVLzMh0Q (button) folded before Flop (didn't bet)
Seat 2: trnpu4tPju3BU8W0wQQaiQ (small blind) folded before Flop
Seat 3: 0WjiuIT7/EolY1oOx1ngeA (big blind) collected ($1)
Seat 5: 6WyjEXOToimYmtLdqIgHYQ folded before Flop (didn't bet)
Seat 6: YfsTQsY/fxb+YqbdclTHuw folded before Flop (didn't bet)



PokerStars Game #59939007644:  Hold'em No Limit ($0.50/$1.00) - 2009/07/01 0:29:02 ET
Table 'tyUh+jyNvrceIQdKMJjQ2wZFWj23PMihdwrNWv41OG/Qeat #3 is the button
Seat 2: 6iVcnPw9a2oNG6sPQo3G6g ($94 in chips)
Seat 3: L9qfLYXrczhAPd/VckgsWw ($41.60 in chips)
Seat 4: TSuRyAHnUPCFjP7Z0rEE0w ($119.95 in chips)
Seat 5: j7NIOHLZk7V2o9fOioO5ug ($119.60 in chips)
Seat 6: YsLQ3BAvgQHWXMAv3Wv6Hg ($103.75 in chips)
TSuRyAHnUPCFjP7Z0rEE0w: posts small blind $0.50
j7NIOHLZk7V2o9fOioO5ug: posts big blind $1
*** HOLE CARDS ***
YsLQ3BAvgQHWXMAv3Wv6Hg: raises $3 to $4
6iVcnPw9a2oNG6sPQo3G6g: calls $4
L9qfLYXrczhAPd/VckgsWw: calls $4
TSuRyAHnUPCFjP7Z0rEE0w: folds
j7NIOHLZk7V2o9fOioO5ug: folds
*** FLOP *** [5d 9s As]
YsLQ3BAvgQHWXMAv3Wv6Hg: bets $8
6iVcnPw9a2oNG6sPQo3G6g: calls $8
L9qfLYXrczhAPd/VckgsWw: folds
*** TURN *** [5d 9s As] [7d]
YsLQ3BAvgQHWXMAv3Wv6Hg: checks
6iVcnPw9a2oNG6sPQo3G6g: bets $15
YsLQ3BAvgQHWXMAv3Wv6Hg: raises $25 to $40
6iVcnPw9a2oNG6sPQo3G6g: raises $42 to $82 and is all-in
YsLQ3BAvgQHWXMAv3Wv6Hg: calls $42
*** RIVER *** [5d 9s As 7d] [3d]
*** SHOW DOWN ***
YsLQ3BAvgQHWXMAv3Wv6Hg: shows [Kd Ah] (a pair of Aces)
6iVcnPw9a2oNG6sPQo3G6g: shows [9h 9d] (three of a kind, Nines)
6iVcnPw9a2oNG6sPQo3G6g collected $191.50 from pot
*** SUMMARY ***
Total pot $193.50 | Rake $2
Board [5d 9s As 7d 3d]
Seat 2: 6iVcnPw9a2oNG6sPQo3G6g showed [9h 9d] and won ($191.50) with three of a kind, Nines
Seat 3: L9qfLYXrczhAPd/VckgsWw (button) folded on the Flop
Seat 4: TSuRyAHnUPCFjP7Z0rEE0w (small blind) folded before Flop
Seat 5: j7NIOHLZk7V2o9fOioO5ug (big blind) folded before Flop
Seat 6: YsLQ3BAvgQHWXMAv3Wv6Hg showed [Kd Ah] and lost with a pair of Aces



PokerStars Game #59939008270:  Hold'em No Limit ($0.50/$1.00) - 2009/07/01 0:29:02 ET
Table 'hugOjcwJvzEwZbK7tyiWuQ' 9-max Seat #8 is the button
Seat 1: N9n5Wc3s35DpCrOAUUNAaQ ($127.85 in chips)
Seat 2: r27C1nIV4NS4+qbnrgBQSw ($258.55 in chips)
Seat 3: jDwhY1kCdc6EkAHbT7PJMQ ($109.75 in chips)
Seat 4: UWB3oeddt/GObx2Mix2Anw ($196.75 in chips)
Seat 6: gUUvmqdVlmvpal6B8nYrmg ($100 in chips)
Seat 7: FL3MrLspcF23LYvC4ipBOA ($100 in chips)
Seat 8: /zy+DB4S5fUQUSfZWFzYGw ($113.25 in chips)
Seat 9: o6JyUkbzCDw8tUabqtmnlg ($58.10 in chips)
o6JyUkbzCDw8tUabqtmnlg: posts small blind $0.50
N9n5Wc3s35DpCrOAUUNAaQ: posts big blind $1
*** HOLE CARDS ***
r27C1nIV4NS4+qbnrgBQSw: folds
jDwhY1kCdc6EkAHbT7PJMQ: folds
UWB3oeddt/GObx2Mix2Anw: folds
gUUvmqdVlmvpal6B8nYrmg: folds
FL3MrLspcF23LYvC4ipBOA: raises $2 to $3
/zy+DB4S5fUQUSfZWFzYGw: folds
o6JyUkbzCDw8tUabqtmnlg: folds
N9n5Wc3s35DpCrOAUUNAaQ: folds
FL3MrLspcF23LYvC4ipBOA collected $2.50 from pot
*** SUMMARY ***
Total pot $2.50 | Rake $0
Seat 1: N9n5Wc3s35DpCrOAUUNAaQ (big blind) folded before Flop
Seat 2: r27C1nIV4NS4+qbnrgBQSw folded before Flop (didn't bet)
Seat 3: jDwhY1kCdc6EkAHbT7PJMQ folded before Flop (didn't bet)
Seat 4: UWB3oeddt/GObx2Mix2Anw folded before Flop (didn't bet)
Seat 6: gUUvmqdVlmvpal6B8nYrmg folded before Flop (didn't bet)
Seat 7: FL3MrLspcF23LYvC4ipBOA collected ($2.50)
Seat 8: /zy+DB4S5fUQUSfZWFzYGw (button) folded before Flop (didn't bet)
Seat 9: o6JyUkbzCDw8tUabqtmnlg (small blind) folded before Flop



PokerStars Game #59939007860:  Hold'em No Limit ($0.50/$1.00) - 2009/07/01 0:29:02 ET
Table 'eU3bWpDDg3Z+9R4m4iVmog' 6-max Seat #2 is the button
Seat 1: TSuRyAHnUPCFjP7Z0rEE0w ($180.10 in chips)
Seat 2: 8CAoOzhmB8n3nRFf3V4BTg ($140.45 in chips)
Seat 3: U6tnjwZRpTnM+YkqkCjwyQ ($144.95 in chips)
Seat 4: GDVIsbEJ/DOJsMKE4Asz0A ($105.75 in chips)
Seat 5: QHvTZcrKe6+maWUfVjP29Q ($100.50 in chips)
Seat 6: hpxXcmRkXXI9HE5+5/j/0Q ($101.50 in chips)
U6tnjwZRpTnM+YkqkCjwyQ: posts small blind $0.50
GDVIsbEJ/DOJsMKE4Asz0A: posts big blind $1
*** HOLE CARDS ***
QHvTZcrKe6+maWUfVjP29Q: folds
hpxXcmRkXXI9HE5+5/j/0Q: folds
TSuRyAHnUPCFjP7Z0rEE0w: raises $3 to $4
8CAoOzhmB8n3nRFf3V4BTg: calls $4
U6tnjwZRpTnM+YkqkCjwyQ: calls $3.50
GDVIsbEJ/DOJsMKE4Asz0A: calls $3
*** FLOP *** [8s 2d 8d]
U6tnjwZRpTnM+YkqkCjwyQ: checks
GDVIsbEJ/DOJsMKE4Asz0A: checks
TSuRyAHnUPCFjP7Z0rEE0w: bets $10.50
8CAoOzhmB8n3nRFf3V4BTg: calls $10.50
U6tnjwZRpTnM+YkqkCjwyQ: raises $29.50 to $40
GDVIsbEJ/DOJsMKE4Asz0A: folds
TSuRyAHnUPCFjP7Z0rEE0w: folds
8CAoOzhmB8n3nRFf3V4BTg: folds
U6tnjwZRpTnM+YkqkCjwyQ collected $45.20 from pot
*** SUMMARY ***
Total pot $47.50 | Rake $2.30
Board [8s 2d 8d]
Seat 1: TSuRyAHnUPCFjP7Z0rEE0w folded on the Flop
Seat 2: 8CAoOzhmB8n3nRFf3V4BTg (button) folded on the Flop
Seat 3: U6tnjwZRpTnM+YkqkCjwyQ (small blind) collected ($45.20)
Seat 4: GDVIsbEJ/DOJsMKE4Asz0A (big blind) folded on the Flop
Seat 5: QHvTZcrKe6+maWUfVjP29Q folded before Flop (didn't bet)
Seat 6: hpxXcmRkXXI9HE5+5/j/0Q folded before Flop (didn't bet)



PokerStars Game #59939008880:  Hold'em No Limit ($0.50/$1.00) - 2009/07/01 0:29:03 ET
Table 'uNlePsyMIqzM691Xkrlk6Q' 9-max Seat #4 is the button
Seat 1: bLbSOSmSOnqE0iTcH/5dxA ($102.50 in chips)
Seat 2: +OqpStnt0FqbCfyHAWaLbg ($68.45 in chips)
Seat 3: h7qXkU57Bb8ZuPwMyxR8Ug ($25 in chips)
Seat 4: TZcz9MEWDA+WydgGruqqbw ($104.65 in chips)
Seat 5: gujOoLOu2j9hcY1eijNNDw ($91.10 in chips)
Seat 6: uMPEfCcGCfsxmy53tVUMug ($100 in chips)
Seat 7: w6cw9nzN7AvkkHBVVjykoQ ($38.65 in chips)
Seat 8: OsLmX3x/19szSV115TpL/Q ($46.95 in chips)
gujOoLOu2j9hcY1eijNNDw: posts small blind $0.50
uMPEfCcGCfsxmy53tVUMug: posts big blind $1
vR4IO10geOgvTW+LAUBv/A: sits out
+OqpStnt0FqbCfyHAWaLbg: posts big blind $1
*** HOLE CARDS ***
w6cw9nzN7AvkkHBVVjykoQ: raises $3 to $4
OsLmX3x/19szSV115TpL/Q: folds
bLbSOSmSOnqE0iTcH/5dxA: folds
+OqpStnt0FqbCfyHAWaLbg: folds
h7qXkU57Bb8ZuPwMyxR8Ug: folds
TZcz9MEWDA+WydgGruqqbw: folds
gujOoLOu2j9hcY1eijNNDw: folds
uMPEfCcGCfsxmy53tVUMug: calls $3
*** FLOP *** [Ad 8d Kh]
uMPEfCcGCfsxmy53tVUMug: checks
w6cw9nzN7AvkkHBVVjykoQ: checks
*** TURN *** [Ad 8d Kh] [5d]
uMPEfCcGCfsxmy53tVUMug: checks
w6cw9nzN7AvkkHBVVjykoQ: bets $4
uMPEfCcGCfsxmy53tVUMug: folds
w6cw9nzN7AvkkHBVVjykoQ collected $9.05 from pot
w6cw9nzN7AvkkHBVVjykoQ: doesn't show hand
*** SUMMARY ***
Total pot $9.50 | Rake $0.45
Board [Ad 8d Kh 5d]
Seat 1: bLbSOSmSOnqE0iTcH/5dxA folded before Flop (didn't bet)
Seat 2: +OqpStnt0FqbCfyHAWaLbg folded before Flop
Seat 3: h7qXkU57Bb8ZuPwMyxR8Ug folded before Flop (didn't bet)
Seat 4: TZcz9MEWDA+WydgGruqqbw (button) folded before Flop (didn't bet)
Seat 5: gujOoLOu2j9hcY1eijNNDw (small blind) folded before Flop
Seat 6: uMPEfCcGCfsxmy53tVUMug (big blind) folded on the Turn
Seat 7: w6cw9nzN7AvkkHBVVjykoQ collected ($9.05)
Seat 8: OsLmX3x/19szSV115TpL/Q folded before Flop (didn't bet)



PokerStars Game #59939009978:  Hold'em No Limit ($0.50/$1.00) - 2009/07/01 0:29:05 ET
Table '/RZcOwpZpHQ+OwPwjsbnRw' 6-max Seat #4 is the button
Seat 1: Zboa6dColKGHBjLPUakZjw ($41 in chips)
Seat 2: dHC9PH9hdH3Ad2TD8ZxX0Q ($44.25 in chips)
Seat 3: OigyyiK+tTj1APPIAUmXDA ($72.65 in chips)
Seat 4: j7NIOHLZk7V2o9fOioO5ug ($119.60 in chips)
Seat 5: wx3sQGkVi2x9wJXuWNHPBw ($205.15 in chips)
Seat 6: XOIf9W+VAxhZqN+SYoyMKA ($250.80 in chips)
wx3sQGkVi2x9wJXuWNHPBw: posts small blind $0.50
XOIf9W+VAxhZqN+SYoyMKA: posts big blind $1
*** HOLE CARDS ***
Zboa6dColKGHBjLPUakZjw: raises $2 to $3
dHC9PH9hdH3Ad2TD8ZxX0Q: folds
OigyyiK+tTj1APPIAUmXDA: folds
j7NIOHLZk7V2o9fOioO5ug: folds
wx3sQGkVi2x9wJXuWNHPBw: folds
XOIf9W+VAxhZqN+SYoyMKA: folds
Zboa6dColKGHBjLPUakZjw collected $2.50 from pot
Zboa6dColKGHBjLPUakZjw: doesn't show hand
*** SUMMARY ***
Total pot $2.50 | Rake $0
Seat 1: Zboa6dColKGHBjLPUakZjw collected ($2.50)
Seat 2: dHC9PH9hdH3Ad2TD8ZxX0Q folded before Flop (didn't bet)
Seat 3: OigyyiK+tTj1APPIAUmXDA folded before Flop (didn't bet)
Seat 4: j7NIOHLZk7V2o9fOioO5ug (button) folded before Flop (didn't bet)
Seat 5: wx3sQGkVi2x9wJXuWNHPBw (small blind) folded before Flop
Seat 6: XOIf9W+VAxhZqN+SYoyMKA (big blind) folded before Flop



PokerStars Game #59939010466:  Hold'em No Limit ($0.50/$1.00) - 2009/07/01 0:29:06 ET
Table '/FUb199IViHMJHi5YWmeuQ' 9-max Seat #1 is the button
Seat 1: TZcz9MEWDA+WydgGruqqbw ($101.85 in chips)
Seat 2: FL3MrLspcF23LYvC4ipBOA ($137.75 in chips)
Seat 3: qN483QJ1NvHbdIZB7J4ARw ($76.40 in chips)
Seat 5: +za1iHiRgVo4OcAz0SOZqw ($15.45 in chips)
Seat 6: ccFf7Q4z1cTGQmeoYiWEfw ($52.45 in chips)
Seat 7: bLbSOSmSOnqE0iTcH/5dxA ($100 in chips)
Seat 8: QIWvt0R766g8KfH0vl1s0A ($31.60 in chips)
Seat 9: knewtTmBc4Tc0z/5tAABYQ ($122.75 in chips)
FL3MrLspcF23LYvC4ipBOA: posts small blind $0.50
qN483QJ1NvHbdIZB7J4ARw: posts big blind $1
*** HOLE CARDS ***
+za1iHiRgVo4OcAz0SOZqw: folds
ccFf7Q4z1cTGQmeoYiWEfw: raises $3 to $4
bLbSOSmSOnqE0iTcH/5dxA: folds
QIWvt0R766g8KfH0vl1s0A: folds
knewtTmBc4Tc0z/5tAABYQ: folds
TZcz9MEWDA+WydgGruqqbw: folds
FL3MrLspcF23LYvC4ipBOA: folds
qN483QJ1NvHbdIZB7J4ARw: folds
ccFf7Q4z1cTGQmeoYiWEfw collected $2.50 from pot
ccFf7Q4z1cTGQmeoYiWEfw: doesn't show hand
*** SUMMARY ***
Total pot $2.50 | Rake $0
Seat 1: TZcz9MEWDA+WydgGruqqbw (button) folded before Flop (didn't bet)
Seat 2: FL3MrLspcF23LYvC4ipBOA (small blind) folded before Flop
Seat 3: qN483QJ1NvHbdIZB7J4ARw (big blind) folded before Flop
Seat 5: +za1iHiRgVo4OcAz0SOZqw folded before Flop (didn't bet)
Seat 6: ccFf7Q4z1cTGQmeoYiWEfw collected ($2.50)
Seat 7: bLbSOSmSOnqE0iTcH/5dxA folded before Flop (didn't bet)
Seat 8: QIWvt0R766g8KfH0vl1s0A folded before Flop (didn't bet)
Seat 9: knewtTmBc4Tc0z/5tAABYQ folded before Flop (didn't bet)



PokerStars Game #59939013492:  Hold'em No Limit ($0.50/$1.00) - 2009/07/01 0:29:10 ET
Table 'tLrtq7gDzxEvckNAI1OS5Q' 6-max Seat #4 is the button
Seat 1: GisIe1kcC9q/xV6ifsTjgA ($143.35 in chips)
Seat 2: qsObMEIlRO22OlS867m/lw ($20.85 in chips)
Seat 3: TPZ+m9x+lwoKpv7TMfAUWA ($318.30 in chips)
Seat 4: KOG8rG51mOvIoY96zF3kvw ($161.80 in chips)
Seat 5: OGMLOcTNYZXZU81au7ztUw ($165.45 in chips)
Seat 6: XUk5GQsfNFpHvaToDZ0rZA ($50.75 in chips)
OGMLOcTNYZXZU81au7ztUw: posts small blind $0.50
XUk5GQsfNFpHvaToDZ0rZA: posts big blind $1
*** HOLE CARDS ***
GisIe1kcC9q/xV6ifsTjgA: raises $3 to $4
qsObMEIlRO22OlS867m/lw: calls $4
TPZ+m9x+lwoKpv7TMfAUWA: folds
KOG8rG51mOvIoY96zF3kvw: folds
OGMLOcTNYZXZU81au7ztUw: folds
XUk5GQsfNFpHvaToDZ0rZA: folds
*** FLOP *** [Qs 9d 3h]
GisIe1kcC9q/xV6ifsTjgA: checks
qsObMEIlRO22OlS867m/lw: bets $16.85 and is all-in
GisIe1kcC9q/xV6ifsTjgA: calls $16.85
*** TURN *** [Qs 9d 3h] [2d]
*** RIVER *** [Qs 9d 3h 2d] [8c]
*** SHOW DOWN ***
GisIe1kcC9q/xV6ifsTjgA: shows [Kh Ks] (a pair of Kings)
qsObMEIlRO22OlS867m/lw: mucks hand
GisIe1kcC9q/xV6ifsTjgA collected $41.10 from pot
*** SUMMARY ***
Total pot $43.20 | Rake $2.10
Board [Qs 9d 3h 2d 8c]
Seat 1: GisIe1kcC9q/xV6ifsTjgA showed [Kh Ks] and won ($41.10) with a pair of Kings
Seat 2: qsObMEIlRO22OlS867m/lw mucked
Seat 3: TPZ+m9x+lwoKpv7TMfAUWA folded before Flop (didn't bet)
Seat 4: KOG8rG51mOvIoY96zF3kvw (button) folded before Flop (didn't bet)
Seat 5: OGMLOcTNYZXZU81au7ztUw (small blind) folded before Flop
Seat 6: XUk5GQsfNFpHvaToDZ0rZA (big blind) folded before Flop



PokerStars Game #59939014254:  Hold'em No Limit ($0.50/$1.00) - 2009/07/01 0:29:11 ET
Table 'ZFWj23PMihdwrNWv41OG/Q' 9-max Seat #6 is the button
Seat 1: yAbu2QsRPVcjPbqlf/jDxw ($101.80 in chips)
Seat 2: ARfmgHcEUKh68laBZy4veA ($83.75 in chips)
Seat 3: G9Fo2TZCN7HI43Po4zSN3A ($103.50 in chips)
Seat 5: tkdBeXTJlFsZdioidNqLow ($60 in chips)
Seat 6: tjhwe1V98x2spSoUQER3HQ ($100 in chips)
Seat 7: wIZ377kjl2fHFGnS93o6bw ($22.95 in chips)
Seat 8: knewtTmBc4Tc0z/5tAABYQ ($107.50 in chips)
Seat 9: l4m/wWPs22DSP5xpszjXKA ($44.25 in chips)
wIZ377kjl2fHFGnS93o6bw: posts small blind $0.50
knewtTmBc4Tc0z/5tAABYQ: posts big blind $1
*** HOLE CARDS ***
l4m/wWPs22DSP5xpszjXKA: folds
PEmogYqKpuv0ozeBbXL+7Q has returned
yAbu2QsRPVcjPbqlf/jDxw: folds
ARfmgHcEUKh68laBZy4veA: folds
G9Fo2TZCN7HI43Po4zSN3A: folds
tkdBeXTJlFsZdioidNqLow: raises $2 to $3
tjhwe1V98x2spSoUQER3HQ: raises $9 to $12
wIZ377kjl2fHFGnS93o6bw: folds
knewtTmBc4Tc0z/5tAABYQ: folds
l4m/wWPs22DSP5xpszjXKA is sitting out
tkdBeXTJlFsZdioidNqLow: folds
tjhwe1V98x2spSoUQER3HQ collected $7.50 from pot
tjhwe1V98x2spSoUQER3HQ: doesn't show hand
l4m/wWPs22DSP5xpszjXKA leaves the table
*** SUMMARY ***
Total pot $7.50 | Rake $0
Seat 1: yAbu2QsRPVcjPbqlf/jDxw folded before Flop (didn't bet)
Seat 2: ARfmgHcEUKh68laBZy4veA folded before Flop (didn't bet)
Seat 3: G9Fo2TZCN7HI43Po4zSN3A folded before Flop (didn't bet)
Seat 5: tkdBeXTJlFsZdioidNqLow folded before Flop
Seat 6: tjhwe1V98x2spSoUQER3HQ (button) collected ($7.50)
Seat 7: wIZ377kjl2fHFGnS93o6bw (small blind) folded before Flop
Seat 8: knewtTmBc4Tc0z/5tAABYQ (big blind) folded before Flop
Seat 9: l4m/wWPs22DSP5xpszjXKA folded before Flop (didn't bet)



PokerStars Game #59939014542:  Hold'em No Limit ($0.50/$1.00) - 2009/07/01 0:29:12 ET
Table 'fTlPiCj0utgzC/5io+I7ew' 6-max Seat #1 is the button
Seat 1: YMJG+F++3Aj6P8dAWda5fw ($98.50 in chips)
Seat 3: oDiBRCaF0QVtd3kO6xZIXw ($100 in chips)
Seat 4: uJVSceLggtsrJya+WtmUEA ($97.80 in chips)
Seat 5: bFrTkDcWGTxyvNul7GVdYg ($255.45 in chips)
Seat 6: jMljU/dOPMXfJi8OmbdYdw ($16.50 in chips)
Qy/UBNbD2HaA0Ogxg8Sf3w will be allowed to play after the button
oDiBRCaF0QVtd3kO6xZIXw: posts small blind $0.50
uJVSceLggtsrJya+WtmUEA: posts big blind $1
*** HOLE CARDS ***
bFrTkDcWGTxyvNul7GVdYg: folds
jMljU/dOPMXfJi8OmbdYdw: folds
YMJG+F++3Aj6P8dAWda5fw: raises $2 to $3
oDiBRCaF0QVtd3kO6xZIXw: folds
uJVSceLggtsrJya+WtmUEA: folds
YMJG+F++3Aj6P8dAWda5fw collected $2.50 from pot
*** SUMMARY ***
Total pot $2.50 | Rake $0
Seat 1: YMJG+F++3Aj6P8dAWda5fw (button) collected ($2.50)
Seat 3: oDiBRCaF0QVtd3kO6xZIXw (small blind) folded before Flop
Seat 4: uJVSceLggtsrJya+WtmUEA (big blind) folded before Flop
Seat 5: bFrTkDcWGTxyvNul7GVdYg folded before Flop (didn't bet)
Seat 6: jMljU/dOPMXfJi8OmbdYdw folded before Flop (didn't bet)



PokerStars Game #59939014478:  Hold'em No Limit ($0.50/$1.00) - 2009/07/01 0:29:12 ET
Table 'cBDNutyLBKEk9+ptwsKmTw' 6-max Seat #3 is the button
Seat 1: xAU6q2/cwmby2sxmA8VcmA ($100.55 in chips)
Seat 3: G5ZSSN6RSON3gkNvk/SmYg ($110.40 in chips)
Seat 4: 0WjiuIT7/EolY1oOx1ngeA ($105.15 in chips)
Seat 5: OGMLOcTNYZXZU81au7ztUw ($117.85 in chips)
0WjiuIT7/EolY1oOx1ngeA: posts small blind $0.50
OGMLOcTNYZXZU81au7ztUw: posts big blind $1
*** HOLE CARDS ***
xAU6q2/cwmby2sxmA8VcmA: folds
G5ZSSN6RSON3gkNvk/SmYg: folds
0WjiuIT7/EolY1oOx1ngeA: folds
OGMLOcTNYZXZU81au7ztUw collected $1 from pot
OGMLOcTNYZXZU81au7ztUw: doesn't show hand
*** SUMMARY ***
Total pot $1 | Rake $0
Seat 1: xAU6q2/cwmby2sxmA8VcmA folded before Flop (didn't bet)
Seat 3: G5ZSSN6RSON3gkNvk/SmYg (button) folded before Flop (didn't bet)
Seat 4: 0WjiuIT7/EolY1oOx1ngeA (small blind) folded before Flop
Seat 5: OGMLOcTNYZXZU81au7ztUw (big blind) collected ($1)



PokerStars Game #59939015778:  Hold'em No Limit ($0.50/$1.00) - 2009/07/01 0:29:14 ET
Table 'MUPc8FEpe/nR0BKSeReX6Q' 6-max Seat #1 is the button
Seat 1: YsLQ3BAvgQHWXMAv3Wv6Hg ($100 in chips)
Seat 2: xAU6q2/cwmby2sxmA8VcmA ($109.50 in chips)
Seat 3: wx3sQGkVi2x9wJXuWNHPBw ($234.05 in chips)
Seat 4: ZA1bp6g8IwtTxkUE4eCjDQ ($110.50 in chips)
Seat 5: UBZQqpnJZdTYYY1FTb0rLA ($100 in chips)
Seat 6: oxnw0GLLpFanjhGkxfRSqA ($53.10 in chips)
xAU6q2/cwmby2sxmA8VcmA: posts small blind $0.50
wx3sQGkVi2x9wJXuWNHPBw: posts big blind $1
*** HOLE CARDS ***
ZA1bp6g8IwtTxkUE4eCjDQ: folds
UBZQqpnJZdTYYY1FTb0rLA: folds
oxnw0GLLpFanjhGkxfRSqA: folds
YsLQ3BAvgQHWXMAv3Wv6Hg: folds
xAU6q2/cwmby2sxmA8VcmA: folds
wx3sQGkVi2x9wJXuWNHPBw collected $1 from pot
*** SUMMARY ***
Total pot $1 | Rake $0
Seat 1: YsLQ3BAvgQHWXMAv3Wv6Hg (button) folded before Flop (didn't bet)
Seat 2: xAU6q2/cwmby2sxmA8VcmA (small blind) folded before Flop
Seat 3: wx3sQGkVi2x9wJXuWNHPBw (big blind) collected ($1)
Seat 4: ZA1bp6g8IwtTxkUE4eCjDQ folded before Flop (didn't bet)
Seat 5: UBZQqpnJZdTYYY1FTb0rLA folded before Flop (didn't bet)
Seat 6: oxnw0GLLpFanjhGkxfRSqA folded before Flop (didn't bet)



PokerStars Game #59939015724:  Hold'em No Limit ($0.50/$1.00) - 2009/07/01 0:29:14 ET
Table '21a4iYFKcuezM4nYx8DWTA' 2-max Seat #1 is the button
Seat 1: NYi6JFscYNrofSXy4sM+Yw ($100.90 in chips)
Seat 2: +sy/nlNI20yZraIjs4AALg ($68.20 in chips)
NYi6JFscYNrofSXy4sM+Yw: posts small blind $0.50
+sy/nlNI20yZraIjs4AALg: posts big blind $1
*** HOLE CARDS ***
NYi6JFscYNrofSXy4sM+Yw: raises $2 to $3
+sy/nlNI20yZraIjs4AALg: raises $2 to $5
NYi6JFscYNrofSXy4sM+Yw: calls $2
*** FLOP *** [5s Kh Qd]
+sy/nlNI20yZraIjs4AALg: checks
NYi6JFscYNrofSXy4sM+Yw: bets $6
+sy/nlNI20yZraIjs4AALg: calls $6
*** TURN *** [5s Kh Qd] [Ad]
+sy/nlNI20yZraIjs4AALg: checks
NYi6JFscYNrofSXy4sM+Yw: bets $12
+sy/nlNI20yZraIjs4AALg: calls $12
*** RIVER *** [5s Kh Qd Ad] [3h]
+sy/nlNI20yZraIjs4AALg: checks
NYi6JFscYNrofSXy4sM+Yw: checks
*** SHOW DOWN ***
+sy/nlNI20yZraIjs4AALg: shows [3c 3s] (three of a kind, Threes)
NYi6JFscYNrofSXy4sM+Yw: mucks hand
+sy/nlNI20yZraIjs4AALg collected $45.50 from pot
*** SUMMARY ***
Total pot $46 | Rake $0.50
Board [5s Kh Qd Ad 3h]
Seat 1: NYi6JFscYNrofSXy4sM+Yw (button) (small blind) mucked
Seat 2: +sy/nlNI20yZraIjs4AALg (big blind) showed [3c 3s] and won ($45.50) with three of a kind, Threes



PokerStars Game #59939016422:  Hold'em No Limit ($0.50/$1.00) - 2009/07/01 0:29:15 ET
Table 'QSIig7BLMc9wY/rgBechzw' 6-max Seat #5 is the button
Seat 1: uuA9hpFU17U5/t4cvpbpBg ($30.55 in chips)
Seat 2: 0WjiuIT7/EolY1oOx1ngeA ($126.25 in chips)
Seat 3: +W6OnF033KNM2xH0fGj98Q ($120.20 in chips)
Seat 4: +uSzP8Jwnw7sKfQ4s66b7w ($45.50 in chips)
Seat 5: bvU2ZjpVnszLCFVeWbxePg ($113.70 in chips)
Seat 6: KpnW5CcJ4Mg6MeclfKmLrw ($126.75 in chips)
KpnW5CcJ4Mg6MeclfKmLrw: posts small blind $0.50
uuA9hpFU17U5/t4cvpbpBg: posts big blind $1
*** HOLE CARDS ***
0WjiuIT7/EolY1oOx1ngeA: folds
+W6OnF033KNM2xH0fGj98Q: folds
+uSzP8Jwnw7sKfQ4s66b7w: folds
bvU2ZjpVnszLCFVeWbxePg: raises $2 to $3
KpnW5CcJ4Mg6MeclfKmLrw: folds
uuA9hpFU17U5/t4cvpbpBg: calls $2
*** FLOP *** [2h Ts Ac]
uuA9hpFU17U5/t4cvpbpBg: checks
bvU2ZjpVnszLCFVeWbxePg: bets $3
uuA9hpFU17U5/t4cvpbpBg: folds
bvU2ZjpVnszLCFVeWbxePg collected $6.20 from pot
bvU2ZjpVnszLCFVeWbxePg: doesn't show hand
*** SUMMARY ***
Total pot $6.50 | Rake $0.30
Board [2h Ts Ac]
Seat 1: uuA9hpFU17U5/t4cvpbpBg (big blind) folded on the Flop
Seat 2: 0WjiuIT7/EolY1oOx1ngeA folded before Flop (didn't bet)
Seat 3: +W6OnF033KNM2xH0fGj98Q folded before Flop (didn't bet)
Seat 4: +uSzP8Jwnw7sKfQ4s66b7w folded before Flop (didn't bet)
Seat 5: bvU2ZjpVnszLCFVeWbxePg (button) collected ($6.20)
Seat 6: KpnW5CcJ4Mg6MeclfKmLrw (small blind) folded before Flop



PokerStars Game #59939016610:  Hold'em No Limit ($0.50/$1.00) - 2009/07/01 0:29:15 ET
Table 'vs/5jr6ciwjVQ5+Soc+u2A' 6-max Seat #4 is the button
Seat 2: XOIf9W+VAxhZqN+SYoyMKA ($120.30 in chips)
Seat 3: G5ZSSN6RSON3gkNvk/SmYg ($100 in chips)
Seat 4: KpnW5CcJ4Mg6MeclfKmLrw ($115.30 in chips)
Seat 5: 7Vc9JmGFQwMRh5Tj9ui5Lw ($96.65 in chips)
Seat 6: QHvTZcrKe6+maWUfVjP29Q ($100 in chips)
7Vc9JmGFQwMRh5Tj9ui5Lw: posts small blind $0.50
QHvTZcrKe6+maWUfVjP29Q: posts big blind $1
*** HOLE CARDS ***
XOIf9W+VAxhZqN+SYoyMKA: folds
G5ZSSN6RSON3gkNvk/SmYg: folds
KpnW5CcJ4Mg6MeclfKmLrw: folds
7Vc9JmGFQwMRh5Tj9ui5Lw: raises $2 to $3
QHvTZcrKe6+maWUfVjP29Q: folds
7Vc9JmGFQwMRh5Tj9ui5Lw collected $2 from pot
7Vc9JmGFQwMRh5Tj9ui5Lw: doesn't show hand
*** SUMMARY ***
Total pot $2 | Rake $0
Seat 2: XOIf9W+VAxhZqN+SYoyMKA folded before Flop (didn't bet)
Seat 3: G5ZSSN6RSON3gkNvk/SmYg folded before Flop (didn't bet)
Seat 4: KpnW5CcJ4Mg6MeclfKmLrw (button) folded before Flop (didn't bet)
Seat 5: 7Vc9JmGFQwMRh5Tj9ui5Lw (small blind) collected ($2)
Seat 6: QHvTZcrKe6+maWUfVjP29Q (big blind) folded before Flop



PokerStars Game #59939017662:  Hold'em No Limit ($0.50/$1.00) - 2009/07/01 0:29:17 ET
Table '+cA8mcmhaedZ7YcrDdhmeQ' 6-max Seat #2 is the button
Seat 1: lsLuWlcPA3Rh7kJVLzMh0Q ($286 in chips)
Seat 2: trnpu4tPju3BU8W0wQQaiQ ($116.45 in chips)
Seat 3: 0WjiuIT7/EolY1oOx1ngeA ($116.80 in chips)
Seat 4: LjL3AIERHn559yyW1mTUYQ ($100 in chips)
Seat 5: 6WyjEXOToimYmtLdqIgHYQ ($60 in chips)
Seat 6: YfsTQsY/fxb+YqbdclTHuw ($45 in chips)
0WjiuIT7/EolY1oOx1ngeA: posts small blind $0.50
LjL3AIERHn559yyW1mTUYQ: posts big blind $1
*** HOLE CARDS ***
6WyjEXOToimYmtLdqIgHYQ: folds
YfsTQsY/fxb+YqbdclTHuw: folds
lsLuWlcPA3Rh7kJVLzMh0Q: raises $2 to $3
trnpu4tPju3BU8W0wQQaiQ: folds
0WjiuIT7/EolY1oOx1ngeA: folds
LjL3AIERHn559yyW1mTUYQ: folds
lsLuWlcPA3Rh7kJVLzMh0Q collected $2.50 from pot
*** SUMMARY ***
Total pot $2.50 | Rake $0
Seat 1: lsLuWlcPA3Rh7kJVLzMh0Q collected ($2.50)
Seat 2: trnpu4tPju3BU8W0wQQaiQ (button) folded before Flop (didn't bet)
Seat 3: 0WjiuIT7/EolY1oOx1ngeA (small blind) folded before Flop
Seat 4: LjL3AIERHn559yyW1mTUYQ (big blind) folded before Flop
Seat 5: 6WyjEXOToimYmtLdqIgHYQ folded before Flop (didn't bet)
Seat 6: YfsTQsY/fxb+YqbdclTHuw folded before Flop (didn't bet)



PokerStars Game #59939019480:  Hold'em No Limit ($0.50/$1.00) - 2009/07/01 0:29:19 ET
Table 'W/wyObTiXZm+Ckkl3YxcSw' 6-max Seat #3 is the button
Seat 1: ssLJburtEIqnVkx6X8R1uw ($114.25 in chips)
Seat 2: oDiBRCaF0QVtd3kO6xZIXw ($102.70 in chips)
Seat 3: b2a+5TkFf4xJN/Ihhma58Q ($42.70 in chips)
Seat 4: +xW7QemQU0Fxs+4TnqBRow ($100.50 in chips)
Seat 6: 1yB1nHUkHNNY8OJnDNHZMw ($95 in chips)
+xW7QemQU0Fxs+4TnqBRow: posts small blind $0.50
1yB1nHUkHNNY8OJnDNHZMw: posts big blind $1
*** HOLE CARDS ***
ssLJburtEIqnVkx6X8R1uw: raises $3 to $4
oDiBRCaF0QVtd3kO6xZIXw: folds
b2a+5TkFf4xJN/Ihhma58Q: folds
+xW7QemQU0Fxs+4TnqBRow: folds
1yB1nHUkHNNY8OJnDNHZMw: calls $3
*** FLOP *** [Jd Kc 7h]
1yB1nHUkHNNY8OJnDNHZMw: checks
ssLJburtEIqnVkx6X8R1uw: checks
*** TURN *** [Jd Kc 7h] [Ts]
1yB1nHUkHNNY8OJnDNHZMw: bets $1
ssLJburtEIqnVkx6X8R1uw: raises $6 to $7
1yB1nHUkHNNY8OJnDNHZMw: folds
ssLJburtEIqnVkx6X8R1uw collected $10 from pot
ssLJburtEIqnVkx6X8R1uw: doesn't show hand
*** SUMMARY ***
Total pot $10.50 | Rake $0.50
Board [Jd Kc 7h Ts]
Seat 1: ssLJburtEIqnVkx6X8R1uw collected ($10)
Seat 2: oDiBRCaF0QVtd3kO6xZIXw folded before Flop (didn't bet)
Seat 3: b2a+5TkFf4xJN/Ihhma58Q (button) folded before Flop (didn't bet)
Seat 4: +xW7QemQU0Fxs+4TnqBRow (small blind) folded before Flop
Seat 6: 1yB1nHUkHNNY8OJnDNHZMw (big blind) folded on the Turn



PokerStars Game #59939020120:  Hold'em No Limit ($0.50/$1.00) - 2009/07/01 0:29:19 ET
Table 'N2bNCDHL96aCQDvZIh+yQQ' 6-max Seat #4 is the button
Seat 1: iHo1oDbrEVJ8nEGdaPrICw ($145 in chips)
Seat 2: KpnW5CcJ4Mg6MeclfKmLrw ($102 in chips)
Seat 4: uCqEjnxh2/vFBjKYkfTOkw ($162.90 in chips)
Seat 5: rHlMOfR7kpQQxe+PFQz0xQ ($37.40 in chips)
Seat 6: TSuRyAHnUPCFjP7Z0rEE0w ($100 in chips)
rHlMOfR7kpQQxe+PFQz0xQ: posts small blind $0.50
TSuRyAHnUPCFjP7Z0rEE0w: posts big blind $1
Qy/UBNbD2HaA0Ogxg8Sf3w: sits out
*** HOLE CARDS ***
iHo1oDbrEVJ8nEGdaPrICw: folds
KpnW5CcJ4Mg6MeclfKmLrw: folds
uCqEjnxh2/vFBjKYkfTOkw: folds
rHlMOfR7kpQQxe+PFQz0xQ: raises $2 to $3
TSuRyAHnUPCFjP7Z0rEE0w: calls $2
*** FLOP *** [Ac 8d 2c]
rHlMOfR7kpQQxe+PFQz0xQ: bets $3
TSuRyAHnUPCFjP7Z0rEE0w: folds
rHlMOfR7kpQQxe+PFQz0xQ collected $5.70 from pot
rHlMOfR7kpQQxe+PFQz0xQ: doesn't show hand
*** SUMMARY ***
Total pot $6 | Rake $0.30
Board [Ac 8d 2c]
Seat 1: iHo1oDbrEVJ8nEGdaPrICw folded before Flop (didn't bet)
Seat 2: KpnW5CcJ4Mg6MeclfKmLrw folded before Flop (didn't bet)
Seat 4: uCqEjnxh2/vFBjKYkfTOkw (button) folded before Flop (didn't bet)
Seat 5: rHlMOfR7kpQQxe+PFQz0xQ (small blind) collected ($5.70)
Seat 6: TSuRyAHnUPCFjP7Z0rEE0w (big blind) folded on the Flop



PokerStars Game #59939021410:  Hold'em No Limit ($0.50/$1.00) - 2009/07/01 0:29:21 ET
Table 'O96CPOtvMBWP6kzuYDfdFA' 6-max Seat #3 is the button
Seat 2: sc/HX9smXU5kObrOWIYO5g ($38 in chips)
Seat 3: V89DGjxE171oPREEbAXiyg ($31.65 in chips)
Seat 4: KOG8rG51mOvIoY96zF3kvw ($171.45 in chips)
Seat 5: wRxiu9OJzvvN84OYWW9jxQ ($131.75 in chips)
Seat 6: xNKcQzD9+/iHmtJn4vYq9w ($141.65 in chips)
KOG8rG51mOvIoY96zF3kvw: posts small blind $0.50
wRxiu9OJzvvN84OYWW9jxQ: posts big blind $1
6alLXQIITA2EZ/lBeym8Dw: sits out
sc/HX9smXU5kObrOWIYO5g: posts big blind $1
*** HOLE CARDS ***
xNKcQzD9+/iHmtJn4vYq9w: folds
sc/HX9smXU5kObrOWIYO5g: checks
V89DGjxE171oPREEbAXiyg: raises $3 to $4
KOG8rG51mOvIoY96zF3kvw: folds
wRxiu9OJzvvN84OYWW9jxQ: calls $3
sc/HX9smXU5kObrOWIYO5g: folds
*** FLOP *** [6h 9d Ts]
wRxiu9OJzvvN84OYWW9jxQ: checks
V89DGjxE171oPREEbAXiyg: bets $5
wRxiu9OJzvvN84OYWW9jxQ: folds
V89DGjxE171oPREEbAXiyg collected $9.05 from pot
*** SUMMARY ***
Total pot $9.50 | Rake $0.45
Board [6h 9d Ts]
Seat 2: sc/HX9smXU5kObrOWIYO5g folded before Flop
Seat 3: V89DGjxE171oPREEbAXiyg (button) collected ($9.05)
Seat 4: KOG8rG51mOvIoY96zF3kvw (small blind) folded before Flop
Seat 5: wRxiu9OJzvvN84OYWW9jxQ (big blind) folded on the Flop
Seat 6: xNKcQzD9+/iHmtJn4vYq9w folded before Flop (didn't bet)



PokerStars Game #59939021956:  Hold'em No Limit ($0.50/$1.00) - 2009/07/01 0:29:22 ET
Table '7Nl0ffnjeK44/vmeexh3MQ' 9-max Seat #7 is the button
Seat 1: s7D3Y+k4Cj4D1cXHv7oj+Q ($101.45 in chips)
Seat 2: kiakSwxX0e64PwYGAPQvLw ($31.85 in chips)
Seat 3: vR4IO10geOgvTW+LAUBv/A ($100 in chips)
Seat 5: bL+QVeDcuEdzMGAGg2XJHg ($108.40 in chips)
Seat 6: FVs16t7GgfWgQWt4JxsObQ ($12 in chips)
Seat 7: knewtTmBc4Tc0z/5tAABYQ ($105 in chips)
Seat 8: zanka7aAZkigmZpfopXxxA ($227.20 in chips)
Seat 9: ouwUBGRKnKK9uhn1G4Lf+A ($98.50 in chips)
zanka7aAZkigmZpfopXxxA: posts small blind $0.50
ouwUBGRKnKK9uhn1G4Lf+A: posts big blind $1
bLbSOSmSOnqE0iTcH/5dxA: sits out
*** HOLE CARDS ***
s7D3Y+k4Cj4D1cXHv7oj+Q: folds
kiakSwxX0e64PwYGAPQvLw: folds
vR4IO10geOgvTW+LAUBv/A: folds
bL+QVeDcuEdzMGAGg2XJHg: folds
FVs16t7GgfWgQWt4JxsObQ: calls $1
knewtTmBc4Tc0z/5tAABYQ: folds
zanka7aAZkigmZpfopXxxA: folds
ouwUBGRKnKK9uhn1G4Lf+A: checks
*** FLOP *** [9c 3d Kc]
ouwUBGRKnKK9uhn1G4Lf+A: checks
FVs16t7GgfWgQWt4JxsObQ: bets $1
ouwUBGRKnKK9uhn1G4Lf+A: folds
FVs16t7GgfWgQWt4JxsObQ collected $2.40 from pot
*** SUMMARY ***
Total pot $2.50 | Rake $0.10
Board [9c 3d Kc]
Seat 1: s7D3Y+k4Cj4D1cXHv7oj+Q folded before Flop (didn't bet)
Seat 2: kiakSwxX0e64PwYGAPQvLw folded before Flop (didn't bet)
Seat 3: vR4IO10geOgvTW+LAUBv/A folded before Flop (didn't bet)
Seat 5: bL+QVeDcuEdzMGAGg2XJHg folded before Flop (didn't bet)
Seat 6: FVs16t7GgfWgQWt4JxsObQ collected ($2.40)
Seat 7: knewtTmBc4Tc0z/5tAABYQ (button) folded before Flop (didn't bet)
Seat 8: zanka7aAZkigmZpfopXxxA (small blind) folded before Flop
Seat 9: ouwUBGRKnKK9uhn1G4Lf+A (big blind) folded on the Flop



PokerStars Game #59939023680:  Hold'em No Limit ($0.50/$1.00) - 2009/07/01 0:29:24 ET
Table 'Zka9tv1yilg0MvXWPQrShg' 9-max Seat #7 is the button
Seat 1: TZcz9MEWDA+WydgGruqqbw ($109.90 in chips)
Seat 2: rR1qGAf9Q9RYorKYWH3VKw ($21.50 in chips)
Seat 3: gUUvmqdVlmvpal6B8nYrmg ($102.50 in chips)
Seat 4: CTOae+JLIGfwfXvhqHkP2w ($170.65 in chips)
Seat 5: /zy+DB4S5fUQUSfZWFzYGw ($139.95 in chips)
Seat 6: rY8wPoax1lS+HUY+I0FZDw ($129.90 in chips)
Seat 7: p1SafS90nb3Uft5LB0NkHw ($20 in chips)
Seat 8: bL+QVeDcuEdzMGAGg2XJHg ($123.60 in chips)
Seat 9: 6daxhj43mWj04MOPTOmaYA ($100 in chips)
bL+QVeDcuEdzMGAGg2XJHg: posts small blind $0.50
6daxhj43mWj04MOPTOmaYA: posts big blind $1
*** HOLE CARDS ***
TZcz9MEWDA+WydgGruqqbw: raises $2.50 to $3.50
rR1qGAf9Q9RYorKYWH3VKw: folds
gUUvmqdVlmvpal6B8nYrmg: folds
CTOae+JLIGfwfXvhqHkP2w: folds
/zy+DB4S5fUQUSfZWFzYGw: calls $3.50
rY8wPoax1lS+HUY+I0FZDw: folds
p1SafS90nb3Uft5LB0NkHw: folds
bL+QVeDcuEdzMGAGg2XJHg: folds
6daxhj43mWj04MOPTOmaYA: calls $2.50
*** FLOP *** [6d Tc Ac]
6daxhj43mWj04MOPTOmaYA: checks
TZcz9MEWDA+WydgGruqqbw: bets $7.50
/zy+DB4S5fUQUSfZWFzYGw: folds
6daxhj43mWj04MOPTOmaYA: folds
TZcz9MEWDA+WydgGruqqbw collected $10.45 from pot
*** SUMMARY ***
Total pot $11 | Rake $0.55
Board [6d Tc Ac]
Seat 1: TZcz9MEWDA+WydgGruqqbw collected ($10.45)
Seat 2: rR1qGAf9Q9RYorKYWH3VKw folded before Flop (didn't bet)
Seat 3: gUUvmqdVlmvpal6B8nYrmg folded before Flop (didn't bet)
Seat 4: CTOae+JLIGfwfXvhqHkP2w folded before Flop (didn't bet)
Seat 5: /zy+DB4S5fUQUSfZWFzYGw folded on the Flop
Seat 6: rY8wPoax1lS+HUY+I0FZDw folded before Flop (didn't bet)
Seat 7: p1SafS90nb3Uft5LB0NkHw (button) folded before Flop (didn't bet)
Seat 8: bL+QVeDcuEdzMGAGg2XJHg (small blind) folded before Flop
Seat 9: 6daxhj43mWj04MOPTOmaYA (big blind) folded on the Flop



PokerStars Game #59939025730:  Hold'em No Limit ($0.50/$1.00) - 2009/07/01 0:29:27 ET
Table 'VOs36P6NW+QyXeQ1B62kmA' 6-max Seat #5 is the button
Seat 1: AdLVjddOzm+sRNo1Bc3S6Q ($141.15 in chips)
Seat 2: KpnW5CcJ4Mg6MeclfKmLrw ($114.80 in chips)
Seat 3: TSuRyAHnUPCFjP7Z0rEE0w ($102.55 in chips)
Seat 4: w02zQzNydODiyV9THKgo9w ($29.65 in chips)
Seat 5: X7GlkHF+lkbarCLuZ4Uf0w ($19.50 in chips)
Seat 6: 6tvjsJrdmWg+g7FVrMnzXA ($69.10 in chips)
6tvjsJrdmWg+g7FVrMnzXA: posts small blind $0.50
AdLVjddOzm+sRNo1Bc3S6Q: posts big blind $1
*** HOLE CARDS ***
KpnW5CcJ4Mg6MeclfKmLrw: folds
TSuRyAHnUPCFjP7Z0rEE0w: folds
w02zQzNydODiyV9THKgo9w: folds
X7GlkHF+lkbarCLuZ4Uf0w: raises $18.50 to $19.50 and is all-in
6tvjsJrdmWg+g7FVrMnzXA: folds
AdLVjddOzm+sRNo1Bc3S6Q: folds
X7GlkHF+lkbarCLuZ4Uf0w collected $2.50 from pot
X7GlkHF+lkbarCLuZ4Uf0w: doesn't show hand
*** SUMMARY ***
Total pot $2.50 | Rake $0
Seat 1: AdLVjddOzm+sRNo1Bc3S6Q (big blind) folded before Flop
Seat 2: KpnW5CcJ4Mg6MeclfKmLrw folded before Flop (didn't bet)
Seat 3: TSuRyAHnUPCFjP7Z0rEE0w folded before Flop (didn't bet)
Seat 4: w02zQzNydODiyV9THKgo9w folded before Flop (didn't bet)
Seat 5: X7GlkHF+lkbarCLuZ4Uf0w (button) collected ($2.50)
Seat 6: 6tvjsJrdmWg+g7FVrMnzXA (small blind) folded before Flop



PokerStars Game #59939027024:  Hold'em No Limit ($0.50/$1.00) - 2009/07/01 0:29:29 ET
Table 'cBDNutyLBKEk9+ptwsKmTw' 6-max Seat #4 is the button
Seat 1: xAU6q2/cwmby2sxmA8VcmA ($100.55 in chips)
Seat 3: G5ZSSN6RSON3gkNvk/SmYg ($110.40 in chips)
Seat 4: 0WjiuIT7/EolY1oOx1ngeA ($104.65 in chips)
Seat 5: OGMLOcTNYZXZU81au7ztUw ($118.35 in chips)
OGMLOcTNYZXZU81au7ztUw: posts small blind $0.50
xAU6q2/cwmby2sxmA8VcmA: posts big blind $1
*** HOLE CARDS ***
G5ZSSN6RSON3gkNvk/SmYg: raises $2 to $3
0WjiuIT7/EolY1oOx1ngeA: folds
OGMLOcTNYZXZU81au7ztUw: folds
xAU6q2/cwmby2sxmA8VcmA: folds
G5ZSSN6RSON3gkNvk/SmYg collected $2.50 from pot
G5ZSSN6RSON3gkNvk/SmYg: doesn't show hand
*** SUMMARY ***
Total pot $2.50 | Rake $0
Seat 1: xAU6q2/cwmby2sxmA8VcmA (big blind) folded before Flop
Seat 3: G5ZSSN6RSON3gkNvk/SmYg collected ($2.50)
Seat 4: 0WjiuIT7/EolY1oOx1ngeA (button) folded before Flop (didn't bet)
Seat 5: OGMLOcTNYZXZU81au7ztUw (small blind) folded before Flop



PokerStars Game #59939027500:  Hold'em No Limit ($0.50/$1.00) - 2009/07/01 0:29:30 ET
Table '/RZcOwpZpHQ+OwPwjsbnRw' 6-max Seat #5 is the button
Seat 1: Zboa6dColKGHBjLPUakZjw ($42.50 in chips)
Seat 2: dHC9PH9hdH3Ad2TD8ZxX0Q ($44.25 in chips)
Seat 3: OigyyiK+tTj1APPIAUmXDA ($72.65 in chips)
Seat 4: j7NIOHLZk7V2o9fOioO5ug ($119.60 in chips)
Seat 5: wx3sQGkVi2x9wJXuWNHPBw ($204.65 in chips)
Seat 6: XOIf9W+VAxhZqN+SYoyMKA ($249.80 in chips)
XOIf9W+VAxhZqN+SYoyMKA: posts small blind $0.50
Zboa6dColKGHBjLPUakZjw: posts big blind $1
*** HOLE CARDS ***
dHC9PH9hdH3Ad2TD8ZxX0Q: folds
OigyyiK+tTj1APPIAUmXDA: folds
j7NIOHLZk7V2o9fOioO5ug: raises $2 to $3
wx3sQGkVi2x9wJXuWNHPBw: folds
XOIf9W+VAxhZqN+SYoyMKA: folds
Zboa6dColKGHBjLPUakZjw: calls $2
*** FLOP *** [Tc 7s 6s]
Zboa6dColKGHBjLPUakZjw: bets $2
j7NIOHLZk7V2o9fOioO5ug: folds
Zboa6dColKGHBjLPUakZjw collected $6.20 from pot
Zboa6dColKGHBjLPUakZjw: doesn't show hand
*** SUMMARY ***
Total pot $6.50 | Rake $0.30
Board [Tc 7s 6s]
Seat 1: Zboa6dColKGHBjLPUakZjw (big blind) collected ($6.20)
Seat 2: dHC9PH9hdH3Ad2TD8ZxX0Q folded before Flop (didn't bet)
Seat 3: OigyyiK+tTj1APPIAUmXDA folded before Flop (didn't bet)
Seat 4: j7NIOHLZk7V2o9fOioO5ug folded on the Flop
Seat 5: wx3sQGkVi2x9wJXuWNHPBw (button) folded before Flop (didn't bet)
Seat 6: XOIf9W+VAxhZqN+SYoyMKA (small blind) folded before Flop



PokerStars Game #59939027240:  Hold'em No Limit ($0.50/$1.00) - 2009/07/01 0:29:30 ET
Table 'U9zqzC8f3oTJ2ShXFgSSOA' 6-max Seat #2 is the button
Seat 1: tS9JHB1h+FQ++qu8RwRNgg ($34.60 in chips)
Seat 2: U2CWBTv29qdCbj8RNF2sIw ($101.35 in chips)
Seat 3: yfXek8iJ7O4CFyqXrtGcfg ($43.05 in chips)
Seat 4: 33q95we0Etwgrm6guQGncw ($69.40 in chips)
Seat 5: KfwW5us6tydK81NYTtK1gw ($308.55 in chips)
Seat 6: aIxzFKdtpDSkUePKZy/niQ ($38.90 in chips)
yfXek8iJ7O4CFyqXrtGcfg: posts small blind $0.50
33q95we0Etwgrm6guQGncw: posts big blind $1
*** HOLE CARDS ***
KfwW5us6tydK81NYTtK1gw: folds
aIxzFKdtpDSkUePKZy/niQ: folds
tS9JHB1h+FQ++qu8RwRNgg: folds
U2CWBTv29qdCbj8RNF2sIw: raises $2 to $3
yfXek8iJ7O4CFyqXrtGcfg: folds
33q95we0Etwgrm6guQGncw: calls $2
*** FLOP *** [4s 6d 8c]
33q95we0Etwgrm6guQGncw: checks
U2CWBTv29qdCbj8RNF2sIw: bets $4
33q95we0Etwgrm6guQGncw: folds
U2CWBTv29qdCbj8RNF2sIw collected $6.20 from pot
U2CWBTv29qdCbj8RNF2sIw: doesn't show hand
*** SUMMARY ***
Total pot $6.50 | Rake $0.30
Board [4s 6d 8c]
Seat 1: tS9JHB1h+FQ++qu8RwRNgg folded before Flop (didn't bet)
Seat 2: U2CWBTv29qdCbj8RNF2sIw (button) collected ($6.20)
Seat 3: yfXek8iJ7O4CFyqXrtGcfg (small blind) folded before Flop
Seat 4: 33q95we0Etwgrm6guQGncw (big blind) folded on the Flop
Seat 5: KfwW5us6tydK81NYTtK1gw folded before Flop (didn't bet)
Seat 6: aIxzFKdtpDSkUePKZy/niQ folded before Flop (didn't bet)



PokerStars Game #59939027950:  Hold'em No Limit ($0.50/$1.00) - 2009/07/01 0:29:31 ET
Table 'vs/5jr6ciwjVQ5+Soc+u2A' 6-max Seat #5 is the button
Seat 2: XOIf9W+VAxhZqN+SYoyMKA ($120.30 in chips)
Seat 3: G5ZSSN6RSON3gkNvk/SmYg ($100 in chips)
Seat 4: KpnW5CcJ4Mg6MeclfKmLrw ($115.30 in chips)
Seat 5: 7Vc9JmGFQwMRh5Tj9ui5Lw ($97.65 in chips)
Seat 6: QHvTZcrKe6+maWUfVjP29Q ($100 in chips)
QHvTZcrKe6+maWUfVjP29Q: posts small blind $0.50
XOIf9W+VAxhZqN+SYoyMKA: posts big blind $1
*** HOLE CARDS ***
G5ZSSN6RSON3gkNvk/SmYg: folds
KpnW5CcJ4Mg6MeclfKmLrw: folds
7Vc9JmGFQwMRh5Tj9ui5Lw: raises $2 to $3
QHvTZcrKe6+maWUfVjP29Q: folds
XOIf9W+VAxhZqN+SYoyMKA: folds
7Vc9JmGFQwMRh5Tj9ui5Lw collected $2.50 from pot
7Vc9JmGFQwMRh5Tj9ui5Lw: doesn't show hand
*** SUMMARY ***
Total pot $2.50 | Rake $0
Seat 2: XOIf9W+VAxhZqN+SYoyMKA (big blind) folded before Flop
Seat 3: G5ZSSN6RSON3gkNvk/SmYg folded before Flop (didn't bet)
Seat 4: KpnW5CcJ4Mg6MeclfKmLrw folded before Flop (didn't bet)
Seat 5: 7Vc9JmGFQwMRh5Tj9ui5Lw (button) collected ($2.50)
Seat 6: QHvTZcrKe6+maWUfVjP29Q (small blind) folded before Flop



PokerStars Game #59939028978:  Hold'em No Limit ($0.50/$1.00) - 2009/07/01 0:29:32 ET
Table 'pHrhryH8jPNdQfY62f8v+g' 6-max Seat #1 is the button
Seat 1: BdbmJTZZ47quA9vUWwXtlw ($72.80 in chips)
Seat 2: RqgF7gRoKgRNW8Zoi1ty4A ($117 in chips)
Seat 3: 0WjiuIT7/EolY1oOx1ngeA ($100 in chips)
Seat 4: wenbG7TaM3H7h5kn78OFNw ($56 in chips)
Seat 5: VKAMJWCyQIT4iNxRjICMJA ($39.45 in chips)
Seat 6: xAU6q2/cwmby2sxmA8VcmA ($102.80 in chips)
RqgF7gRoKgRNW8Zoi1ty4A: posts small blind $0.50
0WjiuIT7/EolY1oOx1ngeA: posts big blind $1
*** HOLE CARDS ***
wenbG7TaM3H7h5kn78OFNw: folds
VKAMJWCyQIT4iNxRjICMJA: folds
VKAMJWCyQIT4iNxRjICMJA is sitting out
VKAMJWCyQIT4iNxRjICMJA leaves the table
xAU6q2/cwmby2sxmA8VcmA: folds
BdbmJTZZ47quA9vUWwXtlw: folds
RqgF7gRoKgRNW8Zoi1ty4A: folds
0WjiuIT7/EolY1oOx1ngeA collected $1 from pot
*** SUMMARY ***
Total pot $1 | Rake $0
Seat 1: BdbmJTZZ47quA9vUWwXtlw (button) folded before Flop (didn't bet)
Seat 2: RqgF7gRoKgRNW8Zoi1ty4A (small blind) folded before Flop
Seat 3: 0WjiuIT7/EolY1oOx1ngeA (big blind) collected ($1)
Seat 4: wenbG7TaM3H7h5kn78OFNw folded before Flop (didn't bet)
Seat 5: VKAMJWCyQIT4iNxRjICMJA folded before Flop (didn't bet)
Seat 6: xAU6q2/cwmby2sxmA8VcmA folded before Flop (didn't bet)



PokerStars Game #59939029682:  Hold'em No Limit ($0.50/$1.00) - 2009/07/01 0:29:33 ET
Table 'rmZfTK+oSebeUPJNbWhdAA' 6-max Seat #5 is the button
Seat 1: xAU6q2/cwmby2sxmA8VcmA ($100 in chips)
Seat 2: OigyyiK+tTj1APPIAUmXDA ($90.55 in chips)
Seat 3: 9yjOzGERLaEZS8CZ6YNHFg ($116.90 in chips)
Seat 4: OGMLOcTNYZXZU81au7ztUw ($127.20 in chips)
Seat 5: +xW7QemQU0Fxs+4TnqBRow ($100 in chips)
Seat 6: j7NIOHLZk7V2o9fOioO5ug ($102.50 in chips)
j7NIOHLZk7V2o9fOioO5ug: posts small blind $0.50
xAU6q2/cwmby2sxmA8VcmA: posts big blind $1
*** HOLE CARDS ***
OigyyiK+tTj1APPIAUmXDA: folds
9yjOzGERLaEZS8CZ6YNHFg: folds
OGMLOcTNYZXZU81au7ztUw: folds
+xW7QemQU0Fxs+4TnqBRow: raises $2 to $3
j7NIOHLZk7V2o9fOioO5ug: folds
xAU6q2/cwmby2sxmA8VcmA: folds
+xW7QemQU0Fxs+4TnqBRow collected $2.50 from pot
+xW7QemQU0Fxs+4TnqBRow: doesn't show hand
*** SUMMARY ***
Total pot $2.50 | Rake $0
Seat 1: xAU6q2/cwmby2sxmA8VcmA (big blind) folded before Flop
Seat 2: OigyyiK+tTj1APPIAUmXDA folded before Flop (didn't bet)
Seat 3: 9yjOzGERLaEZS8CZ6YNHFg folded before Flop (didn't bet)
Seat 4: OGMLOcTNYZXZU81au7ztUw folded before Flop (didn't bet)
Seat 5: +xW7QemQU0Fxs+4TnqBRow (button) collected ($2.50)
Seat 6: j7NIOHLZk7V2o9fOioO5ug (small blind) folded before Flop



PokerStars Game #59939029346:  Hold'em No Limit ($0.50/$1.00) - 2009/07/01 0:29:33 ET
Table 'SQLOQoANiHscJ8AL7zffbw' 9-max Seat #4 is the button
Seat 1: jPTRd6SpCp4xqAy2XQiTOw ($101.85 in chips)
Seat 2: /zy+DB4S5fUQUSfZWFzYGw ($281.85 in chips)
Seat 3: 0eFnow7+D7veCYQ+CG9FFw ($70 in chips)
Seat 4: N9n5Wc3s35DpCrOAUUNAaQ ($115.30 in chips)
Seat 5: L9njYvloJ1NdXjP8edHEAg ($109.55 in chips)
Seat 6: p5UKaxVobvptF0ANhR/q1A ($157 in chips)
Seat 7: bJckevFOcg//s0qyMQI6sQ ($103.55 in chips)
Seat 8: 9ce+0Dl3d0BeEFIP+8HezA ($29.55 in chips)
Seat 9: qJr25HAtvv1w/7IBvjMM3g ($226.35 in chips)
L9njYvloJ1NdXjP8edHEAg: posts small blind $0.50
p5UKaxVobvptF0ANhR/q1A: posts big blind $1
*** HOLE CARDS ***
bJckevFOcg//s0qyMQI6sQ: folds
9ce+0Dl3d0BeEFIP+8HezA: folds
qJr25HAtvv1w/7IBvjMM3g: calls $1
jPTRd6SpCp4xqAy2XQiTOw: folds
/zy+DB4S5fUQUSfZWFzYGw: folds
0eFnow7+D7veCYQ+CG9FFw: folds
N9n5Wc3s35DpCrOAUUNAaQ: calls $1
L9njYvloJ1NdXjP8edHEAg: folds
p5UKaxVobvptF0ANhR/q1A: checks
*** FLOP *** [5h Qh 3s]
p5UKaxVobvptF0ANhR/q1A: checks
qJr25HAtvv1w/7IBvjMM3g: checks
N9n5Wc3s35DpCrOAUUNAaQ: checks
*** TURN *** [5h Qh 3s] [4s]
p5UKaxVobvptF0ANhR/q1A: checks
qJr25HAtvv1w/7IBvjMM3g: bets $3
N9n5Wc3s35DpCrOAUUNAaQ: raises $5 to $8
p5UKaxVobvptF0ANhR/q1A: folds
qJr25HAtvv1w/7IBvjMM3g: calls $5
*** RIVER *** [5h Qh 3s 4s] [7d]
qJr25HAtvv1w/7IBvjMM3g: checks
N9n5Wc3s35DpCrOAUUNAaQ: bets $12
qJr25HAtvv1w/7IBvjMM3g: calls $12
*** SHOW DOWN ***
N9n5Wc3s35DpCrOAUUNAaQ: shows [9s 8s] (high card Queen)
qJr25HAtvv1w/7IBvjMM3g: shows [5d 5c] (three of a kind, Fives)
qJr25HAtvv1w/7IBvjMM3g collected $41.40 from pot
*** SUMMARY ***
Total pot $43.50 | Rake $2.10
Board [5h Qh 3s 4s 7d]
Seat 1: jPTRd6SpCp4xqAy2XQiTOw folded before Flop (didn't bet)
Seat 2: /zy+DB4S5fUQUSfZWFzYGw folded before Flop (didn't bet)
Seat 3: 0eFnow7+D7veCYQ+CG9FFw folded before Flop (didn't bet)
Seat 4: N9n5Wc3s35DpCrOAUUNAaQ (button) showed [9s 8s] and lost with high card Queen
Seat 5: L9njYvloJ1NdXjP8edHEAg (small blind) folded before Flop
Seat 6: p5UKaxVobvptF0ANhR/q1A (big blind) folded on the Turn
Seat 7: bJckevFOcg//s0qyMQI6sQ folded before Flop (didn't bet)
Seat 8: 9ce+0Dl3d0BeEFIP+8HezA folded before Flop (didn't bet)
Seat 9: qJr25HAtvv1w/7IBvjMM3g showed [5d 5c] and won ($41.40) with three of a kind, Fives



PokerStars Game #59939029854:  Hold'em No Limit ($0.50/$1.00) - 2009/07/01 0:29:34 ET
Table '8jIjWCPY0NGprquL+xcMFg' 9-max Seat #3 is the button
Seat 1: vR4IO10geOgvTW+LAUBv/A ($133.65 in chips)
Seat 2: rR1qGAf9Q9RYorKYWH3VKw ($8.15 in chips)
Seat 3: 58zdeSBSuSFX/qZfhc7YmA ($108.45 in chips)
Seat 4: by0z+YmujwI6Bf4qRFE8vA ($146.60 in chips)
Seat 5: n758Yw8Hx2S+6NQUPGqcqA ($88.50 in chips)
Seat 6: GTQkFJtSkbVbnGCktp6e3g ($100 in chips)
Seat 7: O3CGPwwUmamrCNHccOilrg ($46.15 in chips)
Seat 8: 9swGhtpERPngKPtvpoZkoQ ($152.80 in chips)
Seat 9: negfosHnGOZXSHpWDRKyBQ ($18.50 in chips)
by0z+YmujwI6Bf4qRFE8vA: posts small blind $0.50
n758Yw8Hx2S+6NQUPGqcqA: posts big blind $1
*** HOLE CARDS ***
GTQkFJtSkbVbnGCktp6e3g: folds
O3CGPwwUmamrCNHccOilrg: folds
9swGhtpERPngKPtvpoZkoQ: calls $1
negfosHnGOZXSHpWDRKyBQ: folds
vR4IO10geOgvTW+LAUBv/A: folds
rR1qGAf9Q9RYorKYWH3VKw: folds
58zdeSBSuSFX/qZfhc7YmA: folds
by0z+YmujwI6Bf4qRFE8vA: calls $0.50
n758Yw8Hx2S+6NQUPGqcqA: checks
*** FLOP *** [4h 6c 3s]
by0z+YmujwI6Bf4qRFE8vA: checks
n758Yw8Hx2S+6NQUPGqcqA: checks
9swGhtpERPngKPtvpoZkoQ: checks
*** TURN *** [4h 6c 3s] [Qc]
by0z+YmujwI6Bf4qRFE8vA: bets $1
n758Yw8Hx2S+6NQUPGqcqA: folds
9swGhtpERPngKPtvpoZkoQ: folds
by0z+YmujwI6Bf4qRFE8vA collected $2.85 from pot
*** SUMMARY ***
Total pot $3 | Rake $0.15
Board [4h 6c 3s Qc]
Seat 1: vR4IO10geOgvTW+LAUBv/A folded before Flop (didn't bet)
Seat 2: rR1qGAf9Q9RYorKYWH3VKw folded before Flop (didn't bet)
Seat 3: 58zdeSBSuSFX/qZfhc7YmA (button) folded before Flop (didn't bet)
Seat 4: by0z+YmujwI6Bf4qRFE8vA (small blind) collected ($2.85)
Seat 5: n758Yw8Hx2S+6NQUPGqcqA (big blind) folded on the Turn
Seat 6: GTQkFJtSkbVbnGCktp6e3g folded before Flop (didn't bet)
Seat 7: O3CGPwwUmamrCNHccOilrg folded before Flop (didn't bet)
Seat 8: 9swGhtpERPngKPtvpoZkoQ folded on the Turn
Seat 9: negfosHnGOZXSHpWDRKyBQ folded before Flop (didn't bet)



PokerStars Game #59939030214:  Hold'em No Limit ($0.50/$1.00) - 2009/07/01 0:29:34 ET
Table '/FUb199IViHMJHi5YWmeuQ' 9-max Seat #2 is the button
Seat 1: TZcz9MEWDA+WydgGruqqbw ($101.85 in chips)
Seat 2: FL3MrLspcF23LYvC4ipBOA ($137.25 in chips)
Seat 3: qN483QJ1NvHbdIZB7J4ARw ($75.40 in chips)
Seat 5: +za1iHiRgVo4OcAz0SOZqw ($15.45 in chips)
Seat 6: ccFf7Q4z1cTGQmeoYiWEfw ($53.95 in chips)
Seat 7: bLbSOSmSOnqE0iTcH/5dxA ($100 in chips)
Seat 8: QIWvt0R766g8KfH0vl1s0A ($31.60 in chips)
Seat 9: knewtTmBc4Tc0z/5tAABYQ ($122.75 in chips)
qN483QJ1NvHbdIZB7J4ARw: posts small blind $0.50
+za1iHiRgVo4OcAz0SOZqw: posts big blind $1
*** HOLE CARDS ***
ccFf7Q4z1cTGQmeoYiWEfw: folds
bLbSOSmSOnqE0iTcH/5dxA: raises $3 to $4
QIWvt0R766g8KfH0vl1s0A: folds
knewtTmBc4Tc0z/5tAABYQ: raises $9 to $13
TZcz9MEWDA+WydgGruqqbw: folds
FL3MrLspcF23LYvC4ipBOA: folds
qN483QJ1NvHbdIZB7J4ARw: calls $12.50
+za1iHiRgVo4OcAz0SOZqw: raises $2.45 to $15.45 and is all-in
bLbSOSmSOnqE0iTcH/5dxA: folds
knewtTmBc4Tc0z/5tAABYQ: calls $2.45
qN483QJ1NvHbdIZB7J4ARw: calls $2.45
*** FLOP *** [Td 3d 3h]
qN483QJ1NvHbdIZB7J4ARw: checks
knewtTmBc4Tc0z/5tAABYQ: bets $15
qN483QJ1NvHbdIZB7J4ARw: folds
*** TURN *** [Td 3d 3h] [2c]
*** RIVER *** [Td 3d 3h 2c] [8h]
*** SHOW DOWN ***
+za1iHiRgVo4OcAz0SOZqw: shows [9h 9s] (two pair, Nines and Threes)
knewtTmBc4Tc0z/5tAABYQ: shows [Kh Kd] (two pair, Kings and Threes)
knewtTmBc4Tc0z/5tAABYQ collected $47.85 from pot
*** SUMMARY ***
Total pot $50.35 | Rake $2.50
Board [Td 3d 3h 2c 8h]
Seat 1: TZcz9MEWDA+WydgGruqqbw folded before Flop (didn't bet)
Seat 2: FL3MrLspcF23LYvC4ipBOA (button) folded before Flop (didn't bet)
Seat 3: qN483QJ1NvHbdIZB7J4ARw (small blind) folded on the Flop
Seat 5: +za1iHiRgVo4OcAz0SOZqw (big blind) showed [9h 9s] and lost with two pair, Nines and Threes
Seat 6: ccFf7Q4z1cTGQmeoYiWEfw folded before Flop (didn't bet)
Seat 7: bLbSOSmSOnqE0iTcH/5dxA folded before Flop
Seat 8: QIWvt0R766g8KfH0vl1s0A folded before Flop (didn't bet)
Seat 9: knewtTmBc4Tc0z/5tAABYQ showed [Kh Kd] and won ($47.85) with two pair, Kings and Threes



PokerStars Game #59939033148:  Hold'em No Limit ($0.50/$1.00) - 2009/07/01 0:29:38 ET
Table 'mmbQQVBTrPdE+wy+s+9VPA' 6-max Seat #5 is the button
Seat 1: xAU6q2/cwmby2sxmA8VcmA ($100.50 in chips)
Seat 3: wx3sQGkVi2x9wJXuWNHPBw ($110.15 in chips)
Seat 4: RfKnhkJN8HEAuzJpH2Ajdg ($22.35 in chips)
Seat 5: YMJG+F++3Aj6P8dAWda5fw ($99.50 in chips)
xAU6q2/cwmby2sxmA8VcmA: posts small blind $0.50
ru6SCVvWcWt2SpmUsmArWQ: is sitting out
wx3sQGkVi2x9wJXuWNHPBw: posts big blind $1
*** HOLE CARDS ***
ru6SCVvWcWt2SpmUsmArWQ leaves the table
RfKnhkJN8HEAuzJpH2Ajdg: folds
YMJG+F++3Aj6P8dAWda5fw: raises $2 to $3
xAU6q2/cwmby2sxmA8VcmA: calls $2.50
wx3sQGkVi2x9wJXuWNHPBw: folds
*** FLOP *** [4c 9d Qs]
xAU6q2/cwmby2sxmA8VcmA: checks
YMJG+F++3Aj6P8dAWda5fw: bets $4
xAU6q2/cwmby2sxmA8VcmA: calls $4
*** TURN *** [4c 9d Qs] [Tc]
xAU6q2/cwmby2sxmA8VcmA: bets $11
YMJG+F++3Aj6P8dAWda5fw: calls $11
*** RIVER *** [4c 9d Qs Tc] [9h]
xAU6q2/cwmby2sxmA8VcmA: bets $18
YMJG+F++3Aj6P8dAWda5fw: folds
xAU6q2/cwmby2sxmA8VcmA collected $35.20 from pot
*** SUMMARY ***
Total pot $37 | Rake $1.80
Board [4c 9d Qs Tc 9h]
Seat 1: xAU6q2/cwmby2sxmA8VcmA (small blind) collected ($35.20)
Seat 3: wx3sQGkVi2x9wJXuWNHPBw (big blind) folded before Flop
Seat 4: RfKnhkJN8HEAuzJpH2Ajdg folded before Flop (didn't bet)
Seat 5: YMJG+F++3Aj6P8dAWda5fw (button) folded on the River



PokerStars Game #59939034052:  Hold'em No Limit ($0.50/$1.00) - 2009/07/01 0:29:40 ET
Table '+cA8mcmhaedZ7YcrDdhmeQ' 6-max Seat #3 is the button
Seat 1: lsLuWlcPA3Rh7kJVLzMh0Q ($287.50 in chips)
Seat 2: trnpu4tPju3BU8W0wQQaiQ ($116.45 in chips)
Seat 3: 0WjiuIT7/EolY1oOx1ngeA ($116.30 in chips)
Seat 4: LjL3AIERHn559yyW1mTUYQ ($99 in chips)
Seat 5: 6WyjEXOToimYmtLdqIgHYQ ($60 in chips)
Seat 6: YfsTQsY/fxb+YqbdclTHuw ($45 in chips)
LjL3AIERHn559yyW1mTUYQ: posts small blind $0.50
6WyjEXOToimYmtLdqIgHYQ: posts big blind $1
*** HOLE CARDS ***
YfsTQsY/fxb+YqbdclTHuw: calls $1
lsLuWlcPA3Rh7kJVLzMh0Q: raises $4 to $5
trnpu4tPju3BU8W0wQQaiQ: calls $5
0WjiuIT7/EolY1oOx1ngeA: folds
LjL3AIERHn559yyW1mTUYQ: folds
6WyjEXOToimYmtLdqIgHYQ: folds
YfsTQsY/fxb+YqbdclTHuw: calls $4
*** FLOP *** [5s 3d 2h]
YfsTQsY/fxb+YqbdclTHuw: checks
lsLuWlcPA3Rh7kJVLzMh0Q: bets $10
trnpu4tPju3BU8W0wQQaiQ: calls $10
YfsTQsY/fxb+YqbdclTHuw: folds
*** TURN *** [5s 3d 2h] [3c]
lsLuWlcPA3Rh7kJVLzMh0Q: checks
trnpu4tPju3BU8W0wQQaiQ: checks
*** RIVER *** [5s 3d 2h 3c] [4h]
lsLuWlcPA3Rh7kJVLzMh0Q: checks
trnpu4tPju3BU8W0wQQaiQ: checks
*** SHOW DOWN ***
lsLuWlcPA3Rh7kJVLzMh0Q: shows [Js Jc] (two pair, Jacks and Threes)
trnpu4tPju3BU8W0wQQaiQ: mucks hand
lsLuWlcPA3Rh7kJVLzMh0Q collected $34.75 from pot
*** SUMMARY ***
Total pot $36.50 | Rake $1.75
Board [5s 3d 2h 3c 4h]
Seat 1: lsLuWlcPA3Rh7kJVLzMh0Q showed [Js Jc] and won ($34.75) with two pair, Jacks and Threes
Seat 2: trnpu4tPju3BU8W0wQQaiQ mucked
Seat 3: 0WjiuIT7/EolY1oOx1ngeA (button) folded before Flop (didn't bet)
Seat 4: LjL3AIERHn559yyW1mTUYQ (small blind) folded before Flop
Seat 5: 6WyjEXOToimYmtLdqIgHYQ (big blind) folded before Flop
Seat 6: YfsTQsY/fxb+YqbdclTHuw folded on the Flop



PokerStars Game #59939033848:  Hold'em No Limit ($0.50/$1.00) - 2009/07/01 0:29:40 ET
Table 'fTlPiCj0utgzC/5io+I7ew' 6-max Seat #3 is the button
Seat 1: YMJG+F++3Aj6P8dAWda5fw ($100 in chips)
Seat 3: oDiBRCaF0QVtd3kO6xZIXw ($100 in chips)
Seat 4: uJVSceLggtsrJya+WtmUEA ($96.80 in chips)
Seat 5: bFrTkDcWGTxyvNul7GVdYg ($255.45 in chips)
Seat 6: jMljU/dOPMXfJi8OmbdYdw ($16.50 in chips)
uJVSceLggtsrJya+WtmUEA: posts small blind $0.50
bFrTkDcWGTxyvNul7GVdYg: posts big blind $1
Qy/UBNbD2HaA0Ogxg8Sf3w: sits out
*** HOLE CARDS ***
jMljU/dOPMXfJi8OmbdYdw: folds
YMJG+F++3Aj6P8dAWda5fw: folds
oDiBRCaF0QVtd3kO6xZIXw: raises $2 to $3
uJVSceLggtsrJya+WtmUEA: folds
bFrTkDcWGTxyvNul7GVdYg: folds
oDiBRCaF0QVtd3kO6xZIXw collected $2.50 from pot
oDiBRCaF0QVtd3kO6xZIXw: doesn't show hand
*** SUMMARY ***
Total pot $2.50 | Rake $0
Seat 1: YMJG+F++3Aj6P8dAWda5fw folded before Flop (didn't bet)
Seat 3: oDiBRCaF0QVtd3kO6xZIXw (button) collected ($2.50)
Seat 4: uJVSceLggtsrJya+WtmUEA (small blind) folded before Flop
Seat 5: bFrTkDcWGTxyvNul7GVdYg (big blind) folded before Flop
Seat 6: jMljU/dOPMXfJi8OmbdYdw folded before Flop (didn't bet)



PokerStars Game #59939034702:  Hold'em No Limit ($0.50/$1.00) - 2009/07/01 0:29:41 ET
Table 'hugOjcwJvzEwZbK7tyiWuQ' 9-max Seat #9 is the button
Seat 1: N9n5Wc3s35DpCrOAUUNAaQ ($126.85 in chips)
Seat 2: r27C1nIV4NS4+qbnrgBQSw ($258.55 in chips)
Seat 3: jDwhY1kCdc6EkAHbT7PJMQ ($109.75 in chips)
Seat 4: UWB3oeddt/GObx2Mix2Anw ($196.75 in chips)
Seat 6: gUUvmqdVlmvpal6B8nYrmg ($100 in chips)
Seat 7: FL3MrLspcF23LYvC4ipBOA ($101.50 in chips)
Seat 8: /zy+DB4S5fUQUSfZWFzYGw ($113.25 in chips)
Seat 9: o6JyUkbzCDw8tUabqtmnlg ($57.60 in chips)
N9n5Wc3s35DpCrOAUUNAaQ: posts small blind $0.50
r27C1nIV4NS4+qbnrgBQSw: posts big blind $1
*** HOLE CARDS ***
jDwhY1kCdc6EkAHbT7PJMQ: folds
UWB3oeddt/GObx2Mix2Anw: raises $3 to $4
gUUvmqdVlmvpal6B8nYrmg: folds
FL3MrLspcF23LYvC4ipBOA: folds
/zy+DB4S5fUQUSfZWFzYGw: folds
o6JyUkbzCDw8tUabqtmnlg: folds
N9n5Wc3s35DpCrOAUUNAaQ: calls $3.50
r27C1nIV4NS4+qbnrgBQSw: folds
*** FLOP *** [4h 3c 5s]
N9n5Wc3s35DpCrOAUUNAaQ: checks
UWB3oeddt/GObx2Mix2Anw: bets $4
N9n5Wc3s35DpCrOAUUNAaQ: folds
UWB3oeddt/GObx2Mix2Anw collected $8.55 from pot
*** SUMMARY ***
Total pot $9 | Rake $0.45
Board [4h 3c 5s]
Seat 1: N9n5Wc3s35DpCrOAUUNAaQ (small blind) folded on the Flop
Seat 2: r27C1nIV4NS4+qbnrgBQSw (big blind) folded before Flop
Seat 3: jDwhY1kCdc6EkAHbT7PJMQ folded before Flop (didn't bet)
Seat 4: UWB3oeddt/GObx2Mix2Anw collected ($8.55)
Seat 6: gUUvmqdVlmvpal6B8nYrmg folded before Flop (didn't bet)
Seat 7: FL3MrLspcF23LYvC4ipBOA folded before Flop (didn't bet)
Seat 8: /zy+DB4S5fUQUSfZWFzYGw folded before Flop (didn't bet)
Seat 9: o6JyUkbzCDw8tUabqtmnlg (button) folded before Flop (didn't bet)



PokerStars Game #59939035800:  Hold'em No Limit ($0.50/$1.00) - 2009/07/01 0:29:42 ET
Table 'GxCPo/gd3OSthkYrAxJngg' 6-max Seat #5 is the button
Seat 1: sH8BpAFP+jGFxCgVpD1Lew ($282.45 in chips)
Seat 2: YExX2paeIHrmfIwV1ivM/w ($65.20 in chips)
Seat 3: o6plE+MSW4XFNTeONe16xg ($35.10 in chips)
Seat 4: YMJG+F++3Aj6P8dAWda5fw ($109.65 in chips)
Seat 5: G5ZSSN6RSON3gkNvk/SmYg ($100 in chips)
Seat 6: sS9IXedL3MiRmpVXhAILhw ($96 in chips)
sS9IXedL3MiRmpVXhAILhw: posts small blind $0.50
sH8BpAFP+jGFxCgVpD1Lew: posts big blind $1
*** HOLE CARDS ***
YExX2paeIHrmfIwV1ivM/w: folds
o6plE+MSW4XFNTeONe16xg: folds
YMJG+F++3Aj6P8dAWda5fw: folds
G5ZSSN6RSON3gkNvk/SmYg: raises $2 to $3
sS9IXedL3MiRmpVXhAILhw: folds
sH8BpAFP+jGFxCgVpD1Lew: calls $2
*** FLOP *** [8d Ks Ad]
sH8BpAFP+jGFxCgVpD1Lew: checks
G5ZSSN6RSON3gkNvk/SmYg: bets $5
sH8BpAFP+jGFxCgVpD1Lew: folds
G5ZSSN6RSON3gkNvk/SmYg collected $6.20 from pot
*** SUMMARY ***
Total pot $6.50 | Rake $0.30
Board [8d Ks Ad]
Seat 1: sH8BpAFP+jGFxCgVpD1Lew (big blind) folded on the Flop
Seat 2: YExX2paeIHrmfIwV1ivM/w folded before Flop (didn't bet)
Seat 3: o6plE+MSW4XFNTeONe16xg folded before Flop (didn't bet)
Seat 4: YMJG+F++3Aj6P8dAWda5fw folded before Flop (didn't bet)
Seat 5: G5ZSSN6RSON3gkNvk/SmYg (button) collected ($6.20)
Seat 6: sS9IXedL3MiRmpVXhAILhw (small blind) folded before Flop



PokerStars Game #59939036216:  Hold'em No Limit ($0.50/$1.00) - 2009/07/01 0:29:43 ET
Table 'MUPc8FEpe/nR0BKSeReX6Q' 6-max Seat #2 is the button
Seat 1: YsLQ3BAvgQHWXMAv3Wv6Hg ($100 in chips)
Seat 2: xAU6q2/cwmby2sxmA8VcmA ($109 in chips)
Seat 3: wx3sQGkVi2x9wJXuWNHPBw ($234.55 in chips)
Seat 4: ZA1bp6g8IwtTxkUE4eCjDQ ($110.50 in chips)
Seat 5: UBZQqpnJZdTYYY1FTb0rLA ($100 in chips)
Seat 6: oxnw0GLLpFanjhGkxfRSqA ($53.10 in chips)
wx3sQGkVi2x9wJXuWNHPBw: posts small blind $0.50
ZA1bp6g8IwtTxkUE4eCjDQ: posts big blind $1
*** HOLE CARDS ***
UBZQqpnJZdTYYY1FTb0rLA: raises $2 to $3
oxnw0GLLpFanjhGkxfRSqA: folds
YsLQ3BAvgQHWXMAv3Wv6Hg: folds
xAU6q2/cwmby2sxmA8VcmA: folds
wx3sQGkVi2x9wJXuWNHPBw: folds
ZA1bp6g8IwtTxkUE4eCjDQ: calls $2
*** FLOP *** [Qh Ah Tc]
ZA1bp6g8IwtTxkUE4eCjDQ: checks
UBZQqpnJZdTYYY1FTb0rLA: bets $4
ZA1bp6g8IwtTxkUE4eCjDQ: calls $4
*** TURN *** [Qh Ah Tc] [4h]
ZA1bp6g8IwtTxkUE4eCjDQ: checks
UBZQqpnJZdTYYY1FTb0rLA: checks
*** RIVER *** [Qh Ah Tc 4h] [2c]
ZA1bp6g8IwtTxkUE4eCjDQ: bets $14
UBZQqpnJZdTYYY1FTb0rLA: folds
ZA1bp6g8IwtTxkUE4eCjDQ collected $13.80 from pot
ZA1bp6g8IwtTxkUE4eCjDQ: doesn't show hand
*** SUMMARY ***
Total pot $14.50 | Rake $0.70
Board [Qh Ah Tc 4h 2c]
Seat 1: YsLQ3BAvgQHWXMAv3Wv6Hg folded before Flop (didn't bet)
Seat 2: xAU6q2/cwmby2sxmA8VcmA (button) folded before Flop (didn't bet)
Seat 3: wx3sQGkVi2x9wJXuWNHPBw (small blind) folded before Flop
Seat 4: ZA1bp6g8IwtTxkUE4eCjDQ (big blind) collected ($13.80)
Seat 5: UBZQqpnJZdTYYY1FTb0rLA folded on the River
Seat 6: oxnw0GLLpFanjhGkxfRSqA folded before Flop (didn't bet)



PokerStars Game #59939038434:  Hold'em No Limit ($0.50/$1.00) - 2009/07/01 0:29:46 ET
Table 'kS0cTQAEi+fdUlJP2gQYvw' 9-max Seat #6 is the button
Seat 1: c/9X4zftzphFxYtxp5kp9w ($41.90 in chips)
Seat 2: 4SFNYndzMeslixOnF4koZQ ($53.05 in chips)
Seat 3: 3obndzTJ6fECz8+wWhMd1w ($17 in chips)
Seat 4: TZcz9MEWDA+WydgGruqqbw ($100 in chips)
Seat 5: 2rxrMrE7koO2BNxvop/0+g ($51.55 in chips)
Seat 6: yAbu2QsRPVcjPbqlf/jDxw ($100 in chips)
Seat 7: Ffa7Nj4X5fddtROP01hfQg ($104.45 in chips)
Seat 8: qTymj6ZQ8ZoFi6fINJZb3w ($88 in chips)
Seat 9: y8Qb94e81yI/g0saQ6gU5g ($84.75 in chips)
Ffa7Nj4X5fddtROP01hfQg: posts small blind $0.50
qTymj6ZQ8ZoFi6fINJZb3w: posts big blind $1
*** HOLE CARDS ***
y8Qb94e81yI/g0saQ6gU5g: folds
c/9X4zftzphFxYtxp5kp9w: folds
4SFNYndzMeslixOnF4koZQ: folds
3obndzTJ6fECz8+wWhMd1w: folds
TZcz9MEWDA+WydgGruqqbw: folds
2rxrMrE7koO2BNxvop/0+g: folds
yAbu2QsRPVcjPbqlf/jDxw: folds
Ffa7Nj4X5fddtROP01hfQg: calls $0.50
qTymj6ZQ8ZoFi6fINJZb3w: checks
*** FLOP *** [6d Jd Qd]
Ffa7Nj4X5fddtROP01hfQg: bets $2
qTymj6ZQ8ZoFi6fINJZb3w: calls $2
*** TURN *** [6d Jd Qd] [Ts]
Ffa7Nj4X5fddtROP01hfQg: bets $2
qTymj6ZQ8ZoFi6fINJZb3w: calls $2
*** RIVER *** [6d Jd Qd Ts] [6h]
Ffa7Nj4X5fddtROP01hfQg: bets $2
qTymj6ZQ8ZoFi6fINJZb3w: calls $2
*** SHOW DOWN ***
Ffa7Nj4X5fddtROP01hfQg: shows [7d 8d] (a flush, Queen high)
qTymj6ZQ8ZoFi6fINJZb3w: mucks hand
Ffa7Nj4X5fddtROP01hfQg collected $13.35 from pot
*** SUMMARY ***
Total pot $14 | Rake $0.65
Board [6d Jd Qd Ts 6h]
Seat 1: c/9X4zftzphFxYtxp5kp9w folded before Flop (didn't bet)
Seat 2: 4SFNYndzMeslixOnF4koZQ folded before Flop (didn't bet)
Seat 3: 3obndzTJ6fECz8+wWhMd1w folded before Flop (didn't bet)
Seat 4: TZcz9MEWDA+WydgGruqqbw folded before Flop (didn't bet)
Seat 5: 2rxrMrE7koO2BNxvop/0+g folded before Flop (didn't bet)
Seat 6: yAbu2QsRPVcjPbqlf/jDxw (button) folded before Flop (didn't bet)
Seat 7: Ffa7Nj4X5fddtROP01hfQg (small blind) showed [7d 8d] and won ($13.35) with a flush, Queen high
Seat 8: qTymj6ZQ8ZoFi6fINJZb3w (big blind) mucked
Seat 9: y8Qb94e81yI/g0saQ6gU5g folded before Flop (didn't bet)



PokerStars Game #59939038406:  Hold'em No Limit ($0.50/$1.00) - 2009/07/01 0:29:46 ET
Table 'N2bNCDHL96aCQDvZIh+yQQ' 6-max Seat #5 is the button
Seat 1: iHo1oDbrEVJ8nEGdaPrICw ($145 in chips)
Seat 2: KpnW5CcJ4Mg6MeclfKmLrw ($102 in chips)
Seat 4: uCqEjnxh2/vFBjKYkfTOkw ($162.90 in chips)
Seat 5: rHlMOfR7kpQQxe+PFQz0xQ ($40.10 in chips)
Seat 6: TSuRyAHnUPCFjP7Z0rEE0w ($100 in chips)
TSuRyAHnUPCFjP7Z0rEE0w: posts small blind $0.50
iHo1oDbrEVJ8nEGdaPrICw: posts big blind $1
Qy/UBNbD2HaA0Ogxg8Sf3w: sits out
*** HOLE CARDS ***
KpnW5CcJ4Mg6MeclfKmLrw: folds
uCqEjnxh2/vFBjKYkfTOkw: folds
rHlMOfR7kpQQxe+PFQz0xQ: raises $2 to $3
TSuRyAHnUPCFjP7Z0rEE0w: folds
iHo1oDbrEVJ8nEGdaPrICw: folds
rHlMOfR7kpQQxe+PFQz0xQ collected $2.50 from pot
rHlMOfR7kpQQxe+PFQz0xQ: doesn't show hand
*** SUMMARY ***
Total pot $2.50 | Rake $0
Seat 1: iHo1oDbrEVJ8nEGdaPrICw (big blind) folded before Flop
Seat 2: KpnW5CcJ4Mg6MeclfKmLrw folded before Flop (didn't bet)
Seat 4: uCqEjnxh2/vFBjKYkfTOkw folded before Flop (didn't bet)
Seat 5: rHlMOfR7kpQQxe+PFQz0xQ (button) collected ($2.50)
Seat 6: TSuRyAHnUPCFjP7Z0rEE0w (small blind) folded before Flop



PokerStars Game #59939039742:  Hold'em No Limit ($0.50/$1.00) - 2009/07/01 0:29:49 ET
Table 'cBDNutyLBKEk9+ptwsKmTw' 6-max Seat #5 is the button
Seat 1: xAU6q2/cwmby2sxmA8VcmA ($100 in chips)
Seat 3: G5ZSSN6RSON3gkNvk/SmYg ($111.90 in chips)
Seat 4: 0WjiuIT7/EolY1oOx1ngeA ($104.65 in chips)
Seat 5: OGMLOcTNYZXZU81au7ztUw ($117.85 in chips)
xAU6q2/cwmby2sxmA8VcmA: posts small blind $0.50
G5ZSSN6RSON3gkNvk/SmYg: posts big blind $1
*** HOLE CARDS ***
Gy1fd4JyD1aNBFFlOGzbJQ joins the table at seat #2
0WjiuIT7/EolY1oOx1ngeA: folds
OGMLOcTNYZXZU81au7ztUw: folds
xAU6q2/cwmby2sxmA8VcmA: raises $3 to $4
G5ZSSN6RSON3gkNvk/SmYg: folds
NqVlOSH2lp+pp/TK3vvK5g joins the table at seat #6
xAU6q2/cwmby2sxmA8VcmA collected $2 from pot
xAU6q2/cwmby2sxmA8VcmA: doesn't show hand
*** SUMMARY ***
Total pot $2 | Rake $0
Seat 1: xAU6q2/cwmby2sxmA8VcmA (small blind) collected ($2)
Seat 3: G5ZSSN6RSON3gkNvk/SmYg (big blind) folded before Flop
Seat 4: 0WjiuIT7/EolY1oOx1ngeA folded before Flop (didn't bet)
Seat 5: OGMLOcTNYZXZU81au7ztUw (button) folded before Flop (didn't bet)



PokerStars Game #59939041306:  Hold'em No Limit ($0.50/$1.00) - 2009/07/01 0:29:51 ET
Table '6YvsYDPNIDx2v5z3bJnwZQ' 9-max Seat #1 is the button
Seat 1: Ogn4JDV3mp4ZDKO49IFzKA ($15.50 in chips)
Seat 2: 35DmRulmD2MgzT6Bbt6/2w ($29.10 in chips)
Seat 3: negfosHnGOZXSHpWDRKyBQ ($18.30 in chips)
Seat 4: kEr5NYB+JIG5+szcYMr6hA ($46.50 in chips)
Seat 5: mBRWbnUl8diyBO1qTJaNzw ($166.20 in chips)
Seat 6: uMPEfCcGCfsxmy53tVUMug ($106.40 in chips)
Seat 7: boixc27eqTYA1p0tUdMuBQ ($114 in chips)
Seat 8: PSFxpXgPedVZyHSu2Zhb7Q ($63.75 in chips)
Seat 9: jDwhY1kCdc6EkAHbT7PJMQ ($105.60 in chips)
35DmRulmD2MgzT6Bbt6/2w: posts small blind $0.50
negfosHnGOZXSHpWDRKyBQ: posts big blind $1
*** HOLE CARDS ***
kEr5NYB+JIG5+szcYMr6hA: folds
mBRWbnUl8diyBO1qTJaNzw: raises $3 to $4
uMPEfCcGCfsxmy53tVUMug: folds
boixc27eqTYA1p0tUdMuBQ: folds
PSFxpXgPedVZyHSu2Zhb7Q: folds
jDwhY1kCdc6EkAHbT7PJMQ: folds
Ogn4JDV3mp4ZDKO49IFzKA: folds
35DmRulmD2MgzT6Bbt6/2w: raises $6 to $10
negfosHnGOZXSHpWDRKyBQ: folds
mBRWbnUl8diyBO1qTJaNzw: folds
35DmRulmD2MgzT6Bbt6/2w collected $9 from pot
*** SUMMARY ***
Total pot $9 | Rake $0
Seat 1: Ogn4JDV3mp4ZDKO49IFzKA (button) folded before Flop (didn't bet)
Seat 2: 35DmRulmD2MgzT6Bbt6/2w (small blind) collected ($9)
Seat 3: negfosHnGOZXSHpWDRKyBQ (big blind) folded before Flop
Seat 4: kEr5NYB+JIG5+szcYMr6hA folded before Flop (didn't bet)
Seat 5: mBRWbnUl8diyBO1qTJaNzw folded before Flop
Seat 6: uMPEfCcGCfsxmy53tVUMug folded before Flop (didn't bet)
Seat 7: boixc27eqTYA1p0tUdMuBQ folded before Flop (didn't bet)
Seat 8: PSFxpXgPedVZyHSu2Zhb7Q folded before Flop (didn't bet)
Seat 9: jDwhY1kCdc6EkAHbT7PJMQ folded before Flop (didn't bet)



PokerStars Game #59939042104:  Hold'em No Limit ($0.50/$1.00) - 2009/07/01 0:29:52 ET
Table 'pHrhryH8jPNdQfY62f8v+g' 6-max Seat #2 is the button
Seat 1: BdbmJTZZ47quA9vUWwXtlw ($72.80 in chips)
Seat 2: RqgF7gRoKgRNW8Zoi1ty4A ($116.50 in chips)
Seat 3: 0WjiuIT7/EolY1oOx1ngeA ($100.50 in chips)
Seat 4: wenbG7TaM3H7h5kn78OFNw ($56 in chips)
Seat 6: xAU6q2/cwmby2sxmA8VcmA ($102.80 in chips)
0WjiuIT7/EolY1oOx1ngeA: posts small blind $0.50
wenbG7TaM3H7h5kn78OFNw: posts big blind $1
*** HOLE CARDS ***
xAU6q2/cwmby2sxmA8VcmA: folds
BdbmJTZZ47quA9vUWwXtlw: folds
RqgF7gRoKgRNW8Zoi1ty4A: folds
0WjiuIT7/EolY1oOx1ngeA: raises $2 to $3
wenbG7TaM3H7h5kn78OFNw: calls $2
*** FLOP *** [7s 2d Jc]
0WjiuIT7/EolY1oOx1ngeA: bets $3
wenbG7TaM3H7h5kn78OFNw: calls $3
*** TURN *** [7s 2d Jc] [6c]
0WjiuIT7/EolY1oOx1ngeA: checks
wenbG7TaM3H7h5kn78OFNw: bets $4
r1/R7y0Ortgoz4lccgW8VA joins the table at seat #5
0WjiuIT7/EolY1oOx1ngeA: calls $4
*** RIVER *** [7s 2d Jc 6c] [5s]
0WjiuIT7/EolY1oOx1ngeA: checks
wenbG7TaM3H7h5kn78OFNw: checks
*** SHOW DOWN ***
0WjiuIT7/EolY1oOx1ngeA: shows [Jd 9s] (a pair of Jacks)
wenbG7TaM3H7h5kn78OFNw: mucks hand
0WjiuIT7/EolY1oOx1ngeA collected $19.05 from pot
*** SUMMARY ***
Total pot $20 | Rake $0.95
Board [7s 2d Jc 6c 5s]
Seat 1: BdbmJTZZ47quA9vUWwXtlw folded before Flop (didn't bet)
Seat 2: RqgF7gRoKgRNW8Zoi1ty4A (button) folded before Flop (didn't bet)
Seat 3: 0WjiuIT7/EolY1oOx1ngeA (small blind) showed [Jd 9s] and won ($19.05) with a pair of Jacks
Seat 4: wenbG7TaM3H7h5kn78OFNw (big blind) mucked
Seat 6: xAU6q2/cwmby2sxmA8VcmA folded before Flop (didn't bet)



PokerStars Game #59939042786:  Hold'em No Limit ($0.50/$1.00) - 2009/07/01 0:29:53 ET
Table 'vs/5jr6ciwjVQ5+Soc+u2A' 6-max Seat #6 is the button
Seat 2: XOIf9W+VAxhZqN+SYoyMKA ($119.30 in chips)
Seat 3: G5ZSSN6RSON3gkNvk/SmYg ($100 in chips)
Seat 4: KpnW5CcJ4Mg6MeclfKmLrw ($115.30 in chips)
Seat 5: 7Vc9JmGFQwMRh5Tj9ui5Lw ($99.15 in chips)
Seat 6: QHvTZcrKe6+maWUfVjP29Q ($100 in chips)
SpartanRager was removed from the table for failing to post
XOIf9W+VAxhZqN+SYoyMKA: posts small blind $0.50
G5ZSSN6RSON3gkNvk/SmYg: posts big blind $1
*** HOLE CARDS ***
KpnW5CcJ4Mg6MeclfKmLrw: folds
7Vc9JmGFQwMRh5Tj9ui5Lw: calls $1
QHvTZcrKe6+maWUfVjP29Q: folds
XOIf9W+VAxhZqN+SYoyMKA: calls $0.50
G5ZSSN6RSON3gkNvk/SmYg: checks
*** FLOP *** [Kc Qh 6s]
XOIf9W+VAxhZqN+SYoyMKA: checks
G5ZSSN6RSON3gkNvk/SmYg: checks
7Vc9JmGFQwMRh5Tj9ui5Lw: checks
*** TURN *** [Kc Qh 6s] [6d]
XOIf9W+VAxhZqN+SYoyMKA: bets $2
G5ZSSN6RSON3gkNvk/SmYg: folds
7Vc9JmGFQwMRh5Tj9ui5Lw: folds
XOIf9W+VAxhZqN+SYoyMKA collected $2.85 from pot
XOIf9W+VAxhZqN+SYoyMKA: doesn't show hand
*** SUMMARY ***
Total pot $3 | Rake $0.15
Board [Kc Qh 6s 6d]
Seat 2: XOIf9W+VAxhZqN+SYoyMKA (small blind) collected ($2.85)
Seat 3: G5ZSSN6RSON3gkNvk/SmYg (big blind) folded on the Turn
Seat 4: KpnW5CcJ4Mg6MeclfKmLrw folded before Flop (didn't bet)
Seat 5: 7Vc9JmGFQwMRh5Tj9ui5Lw folded on the Turn
Seat 6: QHvTZcrKe6+maWUfVjP29Q (button) folded before Flop (didn't bet)



PokerStars Game #59939043454:  Hold'em No Limit ($0.50/$1.00) - 2009/07/01 0:29:54 ET
Table 'QSIig7BLMc9wY/rgBechzw' 6-max Seat #6 is the button
Seat 1: uuA9hpFU17U5/t4cvpbpBg ($27.55 in chips)
Seat 2: 0WjiuIT7/EolY1oOx1ngeA ($126.25 in chips)
Seat 3: +W6OnF033KNM2xH0fGj98Q ($120.20 in chips)
Seat 4: +uSzP8Jwnw7sKfQ4s66b7w ($45.50 in chips)
Seat 5: bvU2ZjpVnszLCFVeWbxePg ($116.90 in chips)
Seat 6: KpnW5CcJ4Mg6MeclfKmLrw ($126.25 in chips)
uuA9hpFU17U5/t4cvpbpBg: posts small blind $0.50
0WjiuIT7/EolY1oOx1ngeA: posts big blind $1
*** HOLE CARDS ***
+W6OnF033KNM2xH0fGj98Q: raises $3 to $4
+uSzP8Jwnw7sKfQ4s66b7w: calls $4
bvU2ZjpVnszLCFVeWbxePg: folds
KpnW5CcJ4Mg6MeclfKmLrw: raises $10 to $14
uuA9hpFU17U5/t4cvpbpBg: folds
0WjiuIT7/EolY1oOx1ngeA: folds
+W6OnF033KNM2xH0fGj98Q: folds
+uSzP8Jwnw7sKfQ4s66b7w: calls $10
*** FLOP *** [8h 4s 5c]
+uSzP8Jwnw7sKfQ4s66b7w: checks
KpnW5CcJ4Mg6MeclfKmLrw: bets $112.25 and is all-in
+uSzP8Jwnw7sKfQ4s66b7w: folds
KpnW5CcJ4Mg6MeclfKmLrw collected $31.85 from pot
KpnW5CcJ4Mg6MeclfKmLrw: doesn't show hand
*** SUMMARY ***
Total pot $33.50 | Rake $1.65
Board [8h 4s 5c]
Seat 1: uuA9hpFU17U5/t4cvpbpBg (small blind) folded before Flop
Seat 2: 0WjiuIT7/EolY1oOx1ngeA (big blind) folded before Flop
Seat 3: +W6OnF033KNM2xH0fGj98Q folded before Flop
Seat 4: +uSzP8Jwnw7sKfQ4s66b7w folded on the Flop
Seat 5: bvU2ZjpVnszLCFVeWbxePg folded before Flop (didn't bet)
Seat 6: KpnW5CcJ4Mg6MeclfKmLrw (button) collected ($31.85)



PokerStars Game #59939043952:  Hold'em No Limit ($0.50/$1.00) - 2009/07/01 0:29:55 ET
Table 'W/wyObTiXZm+Ckkl3YxcSw' 6-max Seat #4 is the button
Seat 1: ssLJburtEIqnVkx6X8R1uw ($119.25 in chips)
Seat 2: oDiBRCaF0QVtd3kO6xZIXw ($102.70 in chips)
Seat 3: b2a+5TkFf4xJN/Ihhma58Q ($42.70 in chips)
Seat 4: +xW7QemQU0Fxs+4TnqBRow ($100 in chips)
Seat 6: 1yB1nHUkHNNY8OJnDNHZMw ($90 in chips)
Wko+clJG9HZPPQ7Yn0Y5Zg was removed from the table for failing to post
1yB1nHUkHNNY8OJnDNHZMw: posts small blind $0.50
ssLJburtEIqnVkx6X8R1uw: posts big blind $1
*** HOLE CARDS ***
oDiBRCaF0QVtd3kO6xZIXw: folds
b2a+5TkFf4xJN/Ihhma58Q: raises $1 to $2
+xW7QemQU0Fxs+4TnqBRow: folds
1yB1nHUkHNNY8OJnDNHZMw: folds
ssLJburtEIqnVkx6X8R1uw: folds
1yB1nHUkHNNY8OJnDNHZMw leaves the table
b2a+5TkFf4xJN/Ihhma58Q collected $2.50 from pot
*** SUMMARY ***
Total pot $2.50 | Rake $0
Seat 1: ssLJburtEIqnVkx6X8R1uw (big blind) folded before Flop
Seat 2: oDiBRCaF0QVtd3kO6xZIXw folded before Flop (didn't bet)
Seat 3: b2a+5TkFf4xJN/Ihhma58Q collected ($2.50)
Seat 4: +xW7QemQU0Fxs+4TnqBRow (button) folded before Flop (didn't bet)
Seat 6: 1yB1nHUkHNNY8OJnDNHZMw (small blind) folded before Flop



PokerStars Game #59939045134:  Hold'em No Limit ($0.50/$1.00) - 2009/07/01 0:29:56 ET
Table 'O96CPOtvMBWP6kzuYDfdFA' 6-max Seat #4 is the button
Seat 2: sc/HX9smXU5kObrOWIYO5g ($37 in chips)
Seat 3: V89DGjxE171oPREEbAXiyg ($36.70 in chips)
Seat 4: KOG8rG51mOvIoY96zF3kvw ($170.95 in chips)
Seat 5: wRxiu9OJzvvN84OYWW9jxQ ($127.75 in chips)
Seat 6: xNKcQzD9+/iHmtJn4vYq9w ($141.65 in chips)
wRxiu9OJzvvN84OYWW9jxQ: posts small blind $0.50
xNKcQzD9+/iHmtJn4vYq9w: posts big blind $1
6alLXQIITA2EZ/lBeym8Dw: sits out
*** HOLE CARDS ***
sc/HX9smXU5kObrOWIYO5g: folds
V89DGjxE171oPREEbAXiyg: folds
KOG8rG51mOvIoY96zF3kvw: folds
wRxiu9OJzvvN84OYWW9jxQ: folds
xNKcQzD9+/iHmtJn4vYq9w collected $1 from pot
*** SUMMARY ***
Total pot $1 | Rake $0
Seat 2: sc/HX9smXU5kObrOWIYO5g folded before Flop (didn't bet)
Seat 3: V89DGjxE171oPREEbAXiyg folded before Flop (didn't bet)
Seat 4: KOG8rG51mOvIoY96zF3kvw (button) folded before Flop (didn't bet)
Seat 5: wRxiu9OJzvvN84OYWW9jxQ (small blind) folded before Flop
Seat 6: xNKcQzD9+/iHmtJn4vYq9w (big blind) collected ($1)



PokerStars Game #59939045040:  Hold'em No Limit ($0.50/$1.00) - 2009/07/01 0:29:56 ET
Table 'eU3bWpDDg3Z+9R4m4iVmog' 6-max Seat #3 is the button
Seat 1: TSuRyAHnUPCFjP7Z0rEE0w ($165.60 in chips)
Seat 2: 8CAoOzhmB8n3nRFf3V4BTg ($125.95 in chips)
Seat 3: U6tnjwZRpTnM+YkqkCjwyQ ($175.65 in chips)
Seat 4: GDVIsbEJ/DOJsMKE4Asz0A ($101.75 in chips)
Seat 5: QHvTZcrKe6+maWUfVjP29Q ($100.50 in chips)
Seat 6: hpxXcmRkXXI9HE5+5/j/0Q ($101.50 in chips)
GDVIsbEJ/DOJsMKE4Asz0A: posts small blind $0.50
QHvTZcrKe6+maWUfVjP29Q: posts big blind $1
*** HOLE CARDS ***
hpxXcmRkXXI9HE5+5/j/0Q: folds
TSuRyAHnUPCFjP7Z0rEE0w: folds
8CAoOzhmB8n3nRFf3V4BTg: folds
U6tnjwZRpTnM+YkqkCjwyQ: folds
GDVIsbEJ/DOJsMKE4Asz0A: folds
QHvTZcrKe6+maWUfVjP29Q collected $1 from pot
QHvTZcrKe6+maWUfVjP29Q: doesn't show hand
*** SUMMARY ***
Total pot $1 | Rake $0
Seat 1: TSuRyAHnUPCFjP7Z0rEE0w folded before Flop (didn't bet)
Seat 2: 8CAoOzhmB8n3nRFf3V4BTg folded before Flop (didn't bet)
Seat 3: U6tnjwZRpTnM+YkqkCjwyQ (button) folded before Flop (didn't bet)
Seat 4: GDVIsbEJ/DOJsMKE4Asz0A (small blind) folded before Flop
Seat 5: QHvTZcrKe6+maWUfVjP29Q (big blind) collected ($1)
Seat 6: hpxXcmRkXXI9HE5+5/j/0Q folded before Flop (didn't bet)



PokerStars Game #59939045260:  Hold'em No Limit ($0.50/$1.00) - 2009/07/01 0:29:57 ET
Table 'tyUh+jyNvrceIQdKMJjQ2wZFWj23PMihdwrNWv41OG/Qeat #4 is the button
Seat 2: 6iVcnPw9a2oNG6sPQo3G6g ($191.50 in chips)
Seat 3: L9qfLYXrczhAPd/VckgsWw ($37.60 in chips)
Seat 4: TSuRyAHnUPCFjP7Z0rEE0w ($119.45 in chips)
Seat 5: j7NIOHLZk7V2o9fOioO5ug ($118.60 in chips)
Seat 6: YsLQ3BAvgQHWXMAv3Wv6Hg ($100 in chips)
j7NIOHLZk7V2o9fOioO5ug: posts small blind $0.50
YsLQ3BAvgQHWXMAv3Wv6Hg: posts big blind $1
*** HOLE CARDS ***
6iVcnPw9a2oNG6sPQo3G6g: folds
L9qfLYXrczhAPd/VckgsWw: folds
TSuRyAHnUPCFjP7Z0rEE0w: folds
j7NIOHLZk7V2o9fOioO5ug: raises $3 to $4
YsLQ3BAvgQHWXMAv3Wv6Hg: folds
j7NIOHLZk7V2o9fOioO5ug collected $2 from pot
j7NIOHLZk7V2o9fOioO5ug: doesn't show hand
*** SUMMARY ***
Total pot $2 | Rake $0
Seat 2: 6iVcnPw9a2oNG6sPQo3G6g folded before Flop (didn't bet)
Seat 3: L9qfLYXrczhAPd/VckgsWw folded before Flop (didn't bet)
Seat 4: TSuRyAHnUPCFjP7Z0rEE0w (button) folded before Flop (didn't bet)
Seat 5: j7NIOHLZk7V2o9fOioO5ug (small blind) collected ($2)
Seat 6: YsLQ3BAvgQHWXMAv3Wv6Hg (big blind) folded before Flop



PokerStars Game #59939045864:  Hold'em No Limit ($0.50/$1.00) - 2009/07/01 0:29:58 ET
Table '21a4iYFKcuezM4nYx8DWTA' 2-max Seat #2 is the button
Seat 1: NYi6JFscYNrofSXy4sM+Yw ($100 in chips)
Seat 2: +sy/nlNI20yZraIjs4AALg ($90.70 in chips)
+sy/nlNI20yZraIjs4AALg: posts small blind $0.50
NYi6JFscYNrofSXy4sM+Yw: posts big blind $1
*** HOLE CARDS ***
+sy/nlNI20yZraIjs4AALg: folds
NYi6JFscYNrofSXy4sM+Yw collected $1 from pot
NYi6JFscYNrofSXy4sM+Yw: doesn't show hand
*** SUMMARY ***
Total pot $1 | Rake $0
Seat 1: NYi6JFscYNrofSXy4sM+Yw (big blind) collected ($1)
Seat 2: +sy/nlNI20yZraIjs4AALg (button) (small blind) folded before Flop



PokerStars Game #59939046754:  Hold'em No Limit ($0.50/$1.00) - 2009/07/01 0:29:59 ET
Table 'ZFWj23PMihdwrNWv41OG/Q' 9-max Seat #7 is the button
Seat 1: yAbu2QsRPVcjPbqlf/jDxw ($101.80 in chips)
Seat 2: ARfmgHcEUKh68laBZy4veA ($83.75 in chips)
Seat 3: G9Fo2TZCN7HI43Po4zSN3A ($103.50 in chips)
Seat 4: PEmogYqKpuv0ozeBbXL+7Q ($40 in chips)
Seat 5: tkdBeXTJlFsZdioidNqLow ($60 in chips)
Seat 6: tjhwe1V98x2spSoUQER3HQ ($104.50 in chips)
Seat 7: wIZ377kjl2fHFGnS93o6bw ($22.45 in chips)
Seat 8: knewtTmBc4Tc0z/5tAABYQ ($106.50 in chips)
knewtTmBc4Tc0z/5tAABYQ: posts small blind $0.50
yAbu2QsRPVcjPbqlf/jDxw: posts big blind $1
*** HOLE CARDS ***
ARfmgHcEUKh68laBZy4veA: folds
G9Fo2TZCN7HI43Po4zSN3A: folds
PEmogYqKpuv0ozeBbXL+7Q: folds
tkdBeXTJlFsZdioidNqLow: folds
tjhwe1V98x2spSoUQER3HQ: folds
wIZ377kjl2fHFGnS93o6bw: folds
knewtTmBc4Tc0z/5tAABYQ: raises $2 to $3
yAbu2QsRPVcjPbqlf/jDxw: calls $2
*** FLOP *** [Qd 9h 8s]
knewtTmBc4Tc0z/5tAABYQ: bets $4
yAbu2QsRPVcjPbqlf/jDxw: folds
knewtTmBc4Tc0z/5tAABYQ collected $5.70 from pot
knewtTmBc4Tc0z/5tAABYQ: doesn't show hand
*** SUMMARY ***
Total pot $6 | Rake $0.30
Board [Qd 9h 8s]
Seat 1: yAbu2QsRPVcjPbqlf/jDxw (big blind) folded on the Flop
Seat 2: ARfmgHcEUKh68laBZy4veA folded before Flop (didn't bet)
Seat 3: G9Fo2TZCN7HI43Po4zSN3A folded before Flop (didn't bet)
Seat 4: PEmogYqKpuv0ozeBbXL+7Q folded before Flop (didn't bet)
Seat 5: tkdBeXTJlFsZdioidNqLow folded before Flop (didn't bet)
Seat 6: tjhwe1V98x2spSoUQER3HQ folded before Flop (didn't bet)
Seat 7: wIZ377kjl2fHFGnS93o6bw (button) folded before Flop (didn't bet)
Seat 8: knewtTmBc4Tc0z/5tAABYQ (small blind) collected ($5.70)



PokerStars Game #59939047710:  Hold'em No Limit ($0.50/$1.00) - 2009/07/01 0:30:00 ET
Table 'VOs36P6NW+QyXeQ1B62kmA' 6-max Seat #6 is the button
Seat 1: AdLVjddOzm+sRNo1Bc3S6Q ($140.15 in chips)
Seat 2: KpnW5CcJ4Mg6MeclfKmLrw ($114.80 in chips)
Seat 3: TSuRyAHnUPCFjP7Z0rEE0w ($102.55 in chips)
Seat 4: w02zQzNydODiyV9THKgo9w ($29.65 in chips)
Seat 5: X7GlkHF+lkbarCLuZ4Uf0w ($21 in chips)
Seat 6: 6tvjsJrdmWg+g7FVrMnzXA ($68.60 in chips)
AdLVjddOzm+sRNo1Bc3S6Q: posts small blind $0.50
KpnW5CcJ4Mg6MeclfKmLrw: posts big blind $1
*** HOLE CARDS ***
TSuRyAHnUPCFjP7Z0rEE0w: folds
w02zQzNydODiyV9THKgo9w: folds
X7GlkHF+lkbarCLuZ4Uf0w: folds
6tvjsJrdmWg+g7FVrMnzXA: raises $2 to $3
AdLVjddOzm+sRNo1Bc3S6Q: folds
KpnW5CcJ4Mg6MeclfKmLrw: folds
6tvjsJrdmWg+g7FVrMnzXA collected $2.50 from pot
*** SUMMARY ***
Total pot $2.50 | Rake $0
Seat 1: AdLVjddOzm+sRNo1Bc3S6Q (small blind) folded before Flop
Seat 2: KpnW5CcJ4Mg6MeclfKmLrw (big blind) folded before Flop
Seat 3: TSuRyAHnUPCFjP7Z0rEE0w folded before Flop (didn't bet)
Seat 4: w02zQzNydODiyV9THKgo9w folded before Flop (didn't bet)
Seat 5: X7GlkHF+lkbarCLuZ4Uf0w folded before Flop (didn't bet)
Seat 6: 6tvjsJrdmWg+g7FVrMnzXA (button) collected ($2.50)



PokerStars Game #59939048190:  Hold'em No Limit ($0.50/$1.00) - 2009/07/01 0:30:01 ET
Table '7Nl0ffnjeK44/vmeexh3MQ' 9-max Seat #8 is the button
Seat 1: s7D3Y+k4Cj4D1cXHv7oj+Q ($101.45 in chips)
Seat 2: kiakSwxX0e64PwYGAPQvLw ($31.85 in chips)
Seat 3: vR4IO10geOgvTW+LAUBv/A ($100 in chips)
Seat 5: bL+QVeDcuEdzMGAGg2XJHg ($108.40 in chips)
Seat 6: FVs16t7GgfWgQWt4JxsObQ ($13.40 in chips)
Seat 7: knewtTmBc4Tc0z/5tAABYQ ($105 in chips)
Seat 8: zanka7aAZkigmZpfopXxxA ($226.70 in chips)
Seat 9: ouwUBGRKnKK9uhn1G4Lf+A ($97.50 in chips)
ouwUBGRKnKK9uhn1G4Lf+A: posts small blind $0.50
s7D3Y+k4Cj4D1cXHv7oj+Q: posts big blind $1
bLbSOSmSOnqE0iTcH/5dxA: sits out
*** HOLE CARDS ***
kiakSwxX0e64PwYGAPQvLw: folds
vR4IO10geOgvTW+LAUBv/A: folds
bL+QVeDcuEdzMGAGg2XJHg: folds
FVs16t7GgfWgQWt4JxsObQ: calls $1
knewtTmBc4Tc0z/5tAABYQ: folds
zanka7aAZkigmZpfopXxxA: raises $2 to $3
ouwUBGRKnKK9uhn1G4Lf+A: folds
s7D3Y+k4Cj4D1cXHv7oj+Q: folds
FVs16t7GgfWgQWt4JxsObQ: folds
zanka7aAZkigmZpfopXxxA collected $3.50 from pot
zanka7aAZkigmZpfopXxxA: doesn't show hand
*** SUMMARY ***
Total pot $3.50 | Rake $0
Seat 1: s7D3Y+k4Cj4D1cXHv7oj+Q (big blind) folded before Flop
Seat 2: kiakSwxX0e64PwYGAPQvLw folded before Flop (didn't bet)
Seat 3: vR4IO10geOgvTW+LAUBv/A folded before Flop (didn't bet)
Seat 5: bL+QVeDcuEdzMGAGg2XJHg folded before Flop (didn't bet)
Seat 6: FVs16t7GgfWgQWt4JxsObQ folded before Flop
Seat 7: knewtTmBc4Tc0z/5tAABYQ folded before Flop (didn't bet)
Seat 8: zanka7aAZkigmZpfopXxxA (button) collected ($3.50)
Seat 9: ouwUBGRKnKK9uhn1G4Lf+A (small blind) folded before Flop



PokerStars Game #59939048234:  Hold'em No Limit ($0.50/$1.00) - 2009/07/01 0:30:01 ET
Table 'tLrtq7gDzxEvckNAI1OS5Q' 6-max Seat #5 is the button
Seat 1: GisIe1kcC9q/xV6ifsTjgA ($163.60 in chips)
Seat 3: TPZ+m9x+lwoKpv7TMfAUWA ($318.30 in chips)
Seat 4: KOG8rG51mOvIoY96zF3kvw ($161.80 in chips)
Seat 5: OGMLOcTNYZXZU81au7ztUw ($164.95 in chips)
Seat 6: XUk5GQsfNFpHvaToDZ0rZA ($49.75 in chips)
XUk5GQsfNFpHvaToDZ0rZA: posts small blind $0.50
GisIe1kcC9q/xV6ifsTjgA: posts big blind $1
*** HOLE CARDS ***
qsObMEIlRO22OlS867m/lw leaves the table
TPZ+m9x+lwoKpv7TMfAUWA: raises $2 to $3
KOG8rG51mOvIoY96zF3kvw: folds
OGMLOcTNYZXZU81au7ztUw: folds
XUk5GQsfNFpHvaToDZ0rZA: folds
GisIe1kcC9q/xV6ifsTjgA: folds
QHvTZcrKe6+maWUfVjP29Q joins the table at seat #2
TPZ+m9x+lwoKpv7TMfAUWA collected $2.50 from pot
TPZ+m9x+lwoKpv7TMfAUWA is sitting out
*** SUMMARY ***
Total pot $2.50 | Rake $0
Seat 1: GisIe1kcC9q/xV6ifsTjgA (big blind) folded before Flop
Seat 3: TPZ+m9x+lwoKpv7TMfAUWA collected ($2.50)
Seat 4: KOG8rG51mOvIoY96zF3kvw folded before Flop (didn't bet)
Seat 5: OGMLOcTNYZXZU81au7ztUw (button) folded before Flop (didn't bet)
Seat 6: XUk5GQsfNFpHvaToDZ0rZA (small blind) folded before Flop



PokerStars Game #59939049128:  Hold'em No Limit ($0.50/$1.00) - 2009/07/01 0:30:02 ET
Table 'cBDNutyLBKEk9+ptwsKmTw' 6-max Seat #1 is the button
Seat 1: xAU6q2/cwmby2sxmA8VcmA ($101 in chips)
Seat 3: G5ZSSN6RSON3gkNvk/SmYg ($110.90 in chips)
Seat 4: 0WjiuIT7/EolY1oOx1ngeA ($104.65 in chips)
Seat 5: OGMLOcTNYZXZU81au7ztUw ($117.85 in chips)
Gy1fd4JyD1aNBFFlOGzbJQ will be allowed to play after the button
G5ZSSN6RSON3gkNvk/SmYg: posts small blind $0.50
0WjiuIT7/EolY1oOx1ngeA: posts big blind $1
NqVlOSH2lp+pp/TK3vvK5g: sits out
*** HOLE CARDS ***
OGMLOcTNYZXZU81au7ztUw: folds
xAU6q2/cwmby2sxmA8VcmA: folds
G5ZSSN6RSON3gkNvk/SmYg: raises $2 to $3
0WjiuIT7/EolY1oOx1ngeA: folds
G5ZSSN6RSON3gkNvk/SmYg collected $2 from pot
G5ZSSN6RSON3gkNvk/SmYg: doesn't show hand
*** SUMMARY ***
Total pot $2 | Rake $0
Seat 1: xAU6q2/cwmby2sxmA8VcmA (button) folded before Flop (didn't bet)
Seat 3: G5ZSSN6RSON3gkNvk/SmYg (small blind) collected ($2)
Seat 4: 0WjiuIT7/EolY1oOx1ngeA (big blind) folded before Flop
Seat 5: OGMLOcTNYZXZU81au7ztUw folded before Flop (didn't bet)



PokerStars Game #59939049564:  Hold'em No Limit ($0.50/$1.00) - 2009/07/01 0:30:03 ET
Table '/RZcOwpZpHQ+OwPwjsbnRw' 6-max Seat #6 is the button
Seat 1: Zboa6dColKGHBjLPUakZjw ($45.70 in chips)
Seat 2: dHC9PH9hdH3Ad2TD8ZxX0Q ($44.25 in chips)
Seat 3: OigyyiK+tTj1APPIAUmXDA ($72.65 in chips)
Seat 4: j7NIOHLZk7V2o9fOioO5ug ($116.60 in chips)
Seat 5: wx3sQGkVi2x9wJXuWNHPBw ($204.65 in chips)
Seat 6: XOIf9W+VAxhZqN+SYoyMKA ($249.30 in chips)
Zboa6dColKGHBjLPUakZjw: posts small blind $0.50
dHC9PH9hdH3Ad2TD8ZxX0Q: posts big blind $1
*** HOLE CARDS ***
OigyyiK+tTj1APPIAUmXDA: folds
j7NIOHLZk7V2o9fOioO5ug: folds
wx3sQGkVi2x9wJXuWNHPBw: folds
XOIf9W+VAxhZqN+SYoyMKA: folds
Zboa6dColKGHBjLPUakZjw: raises $1 to $2
dHC9PH9hdH3Ad2TD8ZxX0Q: folds
Zboa6dColKGHBjLPUakZjw collected $2 from pot
*** SUMMARY ***
Total pot $2 | Rake $0
Seat 1: Zboa6dColKGHBjLPUakZjw (small blind) collected ($2)
Seat 2: dHC9PH9hdH3Ad2TD8ZxX0Q (big blind) folded before Flop
Seat 3: OigyyiK+tTj1APPIAUmXDA folded before Flop (didn't bet)
Seat 4: j7NIOHLZk7V2o9fOioO5ug folded before Flop (didn't bet)
Seat 5: wx3sQGkVi2x9wJXuWNHPBw folded before Flop (didn't bet)
Seat 6: XOIf9W+VAxhZqN+SYoyMKA (button) folded before Flop (didn't bet)



PokerStars Game #59939049780:  Hold'em No Limit ($0.50/$1.00) - 2009/07/01 0:30:03 ET
Table 'U9zqzC8f3oTJ2ShXFgSSOA' 6-max Seat #3 is the button
Seat 1: tS9JHB1h+FQ++qu8RwRNgg ($34.60 in chips)
Seat 2: U2CWBTv29qdCbj8RNF2sIw ($104.55 in chips)
Seat 3: yfXek8iJ7O4CFyqXrtGcfg ($42.55 in chips)
Seat 4: 33q95we0Etwgrm6guQGncw ($66.40 in chips)
Seat 5: KfwW5us6tydK81NYTtK1gw ($308.55 in chips)
Seat 6: aIxzFKdtpDSkUePKZy/niQ ($38.90 in chips)
33q95we0Etwgrm6guQGncw: posts small blind $0.50
KfwW5us6tydK81NYTtK1gw: posts big blind $1
*** HOLE CARDS ***
aIxzFKdtpDSkUePKZy/niQ: folds
tS9JHB1h+FQ++qu8RwRNgg: folds
U2CWBTv29qdCbj8RNF2sIw: raises $2 to $3
yfXek8iJ7O4CFyqXrtGcfg: folds
33q95we0Etwgrm6guQGncw: folds
KfwW5us6tydK81NYTtK1gw: folds
U2CWBTv29qdCbj8RNF2sIw collected $2.50 from pot
U2CWBTv29qdCbj8RNF2sIw: doesn't show hand
*** SUMMARY ***
Total pot $2.50 | Rake $0
Seat 1: tS9JHB1h+FQ++qu8RwRNgg folded before Flop (didn't bet)
Seat 2: U2CWBTv29qdCbj8RNF2sIw collected ($2.50)
Seat 3: yfXek8iJ7O4CFyqXrtGcfg (button) folded before Flop (didn't bet)
Seat 4: 33q95we0Etwgrm6guQGncw (small blind) folded before Flop
Seat 5: KfwW5us6tydK81NYTtK1gw (big blind) folded before Flop
Seat 6: aIxzFKdtpDSkUePKZy/niQ folded before Flop (didn't bet)



PokerStars Game #59939055276:  Hold'em No Limit ($0.50/$1.00) - 2009/07/01 0:30:13 ET
Table 'rmZfTK+oSebeUPJNbWhdAA' 6-max Seat #6 is the button
Seat 1: xAU6q2/cwmby2sxmA8VcmA ($100 in chips)
Seat 2: OigyyiK+tTj1APPIAUmXDA ($90.55 in chips)
Seat 3: 9yjOzGERLaEZS8CZ6YNHFg ($116.90 in chips)
Seat 4: OGMLOcTNYZXZU81au7ztUw ($127.20 in chips)
Seat 5: +xW7QemQU0Fxs+4TnqBRow ($101.50 in chips)
Seat 6: j7NIOHLZk7V2o9fOioO5ug ($102 in chips)
xAU6q2/cwmby2sxmA8VcmA: posts small blind $0.50
OigyyiK+tTj1APPIAUmXDA: posts big blind $1
*** HOLE CARDS ***
9yjOzGERLaEZS8CZ6YNHFg: folds
OGMLOcTNYZXZU81au7ztUw: folds
+xW7QemQU0Fxs+4TnqBRow: folds
j7NIOHLZk7V2o9fOioO5ug: folds
xAU6q2/cwmby2sxmA8VcmA: folds
OigyyiK+tTj1APPIAUmXDA collected $1 from pot
*** SUMMARY ***
Total pot $1 | Rake $0
Seat 1: xAU6q2/cwmby2sxmA8VcmA (small blind) folded before Flop
Seat 2: OigyyiK+tTj1APPIAUmXDA (big blind) collected ($1)
Seat 3: 9yjOzGERLaEZS8CZ6YNHFg folded before Flop (didn't bet)
Seat 4: OGMLOcTNYZXZU81au7ztUw folded before Flop (didn't bet)
Seat 5: +xW7QemQU0Fxs+4TnqBRow folded before Flop (didn't bet)
Seat 6: j7NIOHLZk7V2o9fOioO5ug (button) folded before Flop (didn't bet)



PokerStars Game #59939054806:  Hold'em No Limit ($0.50/$1.00) - 2009/07/01 0:30:13 ET
Table 'O96CPOtvMBWP6kzuYDfdFA' 6-max Seat #5 is the button
Seat 1: 6alLXQIITA2EZ/lBeym8Dw ($100 in chips)
Seat 2: sc/HX9smXU5kObrOWIYO5g ($37 in chips)
Seat 3: V89DGjxE171oPREEbAXiyg ($36.70 in chips)
Seat 4: KOG8rG51mOvIoY96zF3kvw ($170.95 in chips)
Seat 5: wRxiu9OJzvvN84OYWW9jxQ ($127.25 in chips)
Seat 6: xNKcQzD9+/iHmtJn4vYq9w ($142.15 in chips)
xNKcQzD9+/iHmtJn4vYq9w: posts small blind $0.50
6alLXQIITA2EZ/lBeym8Dw: posts big blind $1
*** HOLE CARDS ***
sc/HX9smXU5kObrOWIYO5g: folds
V89DGjxE171oPREEbAXiyg: folds
KOG8rG51mOvIoY96zF3kvw: raises $2 to $3
wRxiu9OJzvvN84OYWW9jxQ: calls $3
xNKcQzD9+/iHmtJn4vYq9w: folds
6alLXQIITA2EZ/lBeym8Dw: folds
*** FLOP *** [3h Ah Ks]
KOG8rG51mOvIoY96zF3kvw: bets $5.20
wRxiu9OJzvvN84OYWW9jxQ: calls $5.20
*** TURN *** [3h Ah Ks] [Kd]
KOG8rG51mOvIoY96zF3kvw: checks
wRxiu9OJzvvN84OYWW9jxQ: bets $10
KOG8rG51mOvIoY96zF3kvw: folds
wRxiu9OJzvvN84OYWW9jxQ collected $17.05 from pot
*** SUMMARY ***
Total pot $17.90 | Rake $0.85
Board [3h Ah Ks Kd]
Seat 1: 6alLXQIITA2EZ/lBeym8Dw (big blind) folded before Flop
Seat 2: sc/HX9smXU5kObrOWIYO5g folded before Flop (didn't bet)
Seat 3: V89DGjxE171oPREEbAXiyg folded before Flop (didn't bet)
Seat 4: KOG8rG51mOvIoY96zF3kvw folded on the Turn
Seat 5: wRxiu9OJzvvN84OYWW9jxQ (button) collected ($17.05)
Seat 6: xNKcQzD9+/iHmtJn4vYq9w (small blind) folded before Flop



PokerStars Game #59939053936:  Hold'em No Limit ($0.50/$1.00) - 2009/07/01 0:30:13 ET
Table '21a4iYFKcuezM4nYx8DWTA' 2-max Seat #1 is the button
Seat 1: NYi6JFscYNrofSXy4sM+Yw ($100.50 in chips)
Seat 2: +sy/nlNI20yZraIjs4AALg ($90.20 in chips)
NYi6JFscYNrofSXy4sM+Yw: posts small blind $0.50
+sy/nlNI20yZraIjs4AALg: posts big blind $1
*** HOLE CARDS ***
NYi6JFscYNrofSXy4sM+Yw: raises $2 to $3
+sy/nlNI20yZraIjs4AALg: raises $2 to $5
NYi6JFscYNrofSXy4sM+Yw: calls $2
*** FLOP *** [6h 8h 4h]
+sy/nlNI20yZraIjs4AALg: checks
NYi6JFscYNrofSXy4sM+Yw: bets $6
+sy/nlNI20yZraIjs4AALg: raises $6 to $12
NYi6JFscYNrofSXy4sM+Yw: folds
+sy/nlNI20yZraIjs4AALg collected $21.50 from pot
*** SUMMARY ***
Total pot $22 | Rake $0.50
Board [6h 8h 4h]
Seat 1: NYi6JFscYNrofSXy4sM+Yw (button) (small blind) folded on the Flop
Seat 2: +sy/nlNI20yZraIjs4AALg (big blind) collected ($21.50)



PokerStars Game #59939053400:  Hold'em No Limit ($0.50/$1.00) - 2009/07/01 0:30:13 ET
Table 'W/wyObTiXZm+Ckkl3YxcSw' 6-max Seat #1 is the button
Seat 1: ssLJburtEIqnVkx6X8R1uw ($118.25 in chips)
Seat 2: oDiBRCaF0QVtd3kO6xZIXw ($102.70 in chips)
Seat 3: b2a+5TkFf4xJN/Ihhma58Q ($44.20 in chips)
Seat 4: +xW7QemQU0Fxs+4TnqBRow ($100 in chips)
oDiBRCaF0QVtd3kO6xZIXw: posts small blind $0.50
b2a+5TkFf4xJN/Ihhma58Q: posts big blind $1
*** HOLE CARDS ***
+xW7QemQU0Fxs+4TnqBRow: folds
ssLJburtEIqnVkx6X8R1uw: folds
oDiBRCaF0QVtd3kO6xZIXw: calls $0.50
b2a+5TkFf4xJN/Ihhma58Q: checks
*** FLOP *** [3h 4h Tc]
oDiBRCaF0QVtd3kO6xZIXw: checks
b2a+5TkFf4xJN/Ihhma58Q: bets $1
oDiBRCaF0QVtd3kO6xZIXw: folds
b2a+5TkFf4xJN/Ihhma58Q collected $1.90 from pot
*** SUMMARY ***
Total pot $2 | Rake $0.10
Board [3h 4h Tc]
Seat 1: ssLJburtEIqnVkx6X8R1uw (button) folded before Flop (didn't bet)
Seat 2: oDiBRCaF0QVtd3kO6xZIXw (small blind) folded on the Flop
Seat 3: b2a+5TkFf4xJN/Ihhma58Q (big blind) collected ($1.90)
Seat 4: +xW7QemQU0Fxs+4TnqBRow folded before Flop (didn't bet)



PokerStars Game #59939055236:  Hold'em No Limit ($0.50/$1.00) - 2009/07/01 0:30:13 ET
Table 'uNlePsyMIqzM691Xkrlk6Q' 9-max Seat #5 is the button
Seat 1: bLbSOSmSOnqE0iTcH/5dxA ($102.50 in chips)
Seat 2: +OqpStnt0FqbCfyHAWaLbg ($67.45 in chips)
Seat 3: h7qXkU57Bb8ZuPwMyxR8Ug ($25 in chips)
Seat 4: TZcz9MEWDA+WydgGruqqbw ($104.65 in chips)
Seat 5: gujOoLOu2j9hcY1eijNNDw ($90.60 in chips)
Seat 6: uMPEfCcGCfsxmy53tVUMug ($100 in chips)
Seat 7: w6cw9nzN7AvkkHBVVjykoQ ($43.70 in chips)
Seat 8: OsLmX3x/19szSV115TpL/Q ($46.95 in chips)
uMPEfCcGCfsxmy53tVUMug: posts small blind $0.50
w6cw9nzN7AvkkHBVVjykoQ: posts big blind $1
vR4IO10geOgvTW+LAUBv/A: sits out
*** HOLE CARDS ***
OsLmX3x/19szSV115TpL/Q: folds
bLbSOSmSOnqE0iTcH/5dxA: folds
+OqpStnt0FqbCfyHAWaLbg: folds
h7qXkU57Bb8ZuPwMyxR8Ug: folds
TZcz9MEWDA+WydgGruqqbw: folds
gujOoLOu2j9hcY1eijNNDw: raises $2 to $3
uMPEfCcGCfsxmy53tVUMug: folds
w6cw9nzN7AvkkHBVVjykoQ: calls $2
*** FLOP *** [Kh Ah 7h]
w6cw9nzN7AvkkHBVVjykoQ: checks
gujOoLOu2j9hcY1eijNNDw: checks
*** TURN *** [Kh Ah 7h] [Js]
w6cw9nzN7AvkkHBVVjykoQ: checks
gujOoLOu2j9hcY1eijNNDw: checks
*** RIVER *** [Kh Ah 7h Js] [Td]
w6cw9nzN7AvkkHBVVjykoQ: bets $4
gujOoLOu2j9hcY1eijNNDw: folds
w6cw9nzN7AvkkHBVVjykoQ collected $6.20 from pot
*** SUMMARY ***
Total pot $6.50 | Rake $0.30
Board [Kh Ah 7h Js Td]
Seat 1: bLbSOSmSOnqE0iTcH/5dxA folded before Flop (didn't bet)
Seat 2: +OqpStnt0FqbCfyHAWaLbg folded before Flop (didn't bet)
Seat 3: h7qXkU57Bb8ZuPwMyxR8Ug folded before Flop (didn't bet)
Seat 4: TZcz9MEWDA+WydgGruqqbw folded before Flop (didn't bet)
Seat 5: gujOoLOu2j9hcY1eijNNDw (button) folded on the River
Seat 6: uMPEfCcGCfsxmy53tVUMug (small blind) folded before Flop
Seat 7: w6cw9nzN7AvkkHBVVjykoQ (big blind) collected ($6.20)
Seat 8: OsLmX3x/19szSV115TpL/Q folded before Flop (didn't bet)



PokerStars Game #59939056160:  Hold'em No Limit ($0.50/$1.00) - 2009/07/01 0:30:14 ET
Table 'N2bNCDHL96aCQDvZIh+yQQ' 6-max Seat #6 is the button
Seat 1: iHo1oDbrEVJ8nEGdaPrICw ($144 in chips)
Seat 2: KpnW5CcJ4Mg6MeclfKmLrw ($102 in chips)
Seat 4: uCqEjnxh2/vFBjKYkfTOkw ($162.90 in chips)
Seat 5: rHlMOfR7kpQQxe+PFQz0xQ ($41.60 in chips)
Seat 6: TSuRyAHnUPCFjP7Z0rEE0w ($100 in chips)
iHo1oDbrEVJ8nEGdaPrICw: posts small blind $0.50
KpnW5CcJ4Mg6MeclfKmLrw: posts big blind $1
Qy/UBNbD2HaA0Ogxg8Sf3w: sits out
*** HOLE CARDS ***
uCqEjnxh2/vFBjKYkfTOkw: raises $3 to $4
rHlMOfR7kpQQxe+PFQz0xQ: folds
TSuRyAHnUPCFjP7Z0rEE0w: folds
iHo1oDbrEVJ8nEGdaPrICw: folds
KpnW5CcJ4Mg6MeclfKmLrw: calls $3
*** FLOP *** [9h Jc 3h]
KpnW5CcJ4Mg6MeclfKmLrw: checks
uCqEjnxh2/vFBjKYkfTOkw: bets $7
KpnW5CcJ4Mg6MeclfKmLrw: calls $7
*** TURN *** [9h Jc 3h] [6h]
KpnW5CcJ4Mg6MeclfKmLrw: checks
uCqEjnxh2/vFBjKYkfTOkw: checks
*** RIVER *** [9h Jc 3h 6h] [Tc]
KpnW5CcJ4Mg6MeclfKmLrw: bets $33
uCqEjnxh2/vFBjKYkfTOkw: folds
KpnW5CcJ4Mg6MeclfKmLrw collected $21.40 from pot
*** SUMMARY ***
Total pot $22.50 | Rake $1.10
Board [9h Jc 3h 6h Tc]
Seat 1: iHo1oDbrEVJ8nEGdaPrICw (small blind) folded before Flop
Seat 2: KpnW5CcJ4Mg6MeclfKmLrw (big blind) collected ($21.40)
Seat 4: uCqEjnxh2/vFBjKYkfTOkw folded on the River
Seat 5: rHlMOfR7kpQQxe+PFQz0xQ folded before Flop (didn't bet)
Seat 6: TSuRyAHnUPCFjP7Z0rEE0w (button) folded before Flop (didn't bet)



PokerStars Game #59939056968:  Hold'em No Limit ($0.50/$1.00) - 2009/07/01 0:30:15 ET
Table 'eU3bWpDDg3Z+9R4m4iVmog' 6-max Seat #4 is the button
Seat 1: TSuRyAHnUPCFjP7Z0rEE0w ($165.60 in chips)
Seat 2: 8CAoOzhmB8n3nRFf3V4BTg ($125.95 in chips)
Seat 3: U6tnjwZRpTnM+YkqkCjwyQ ($175.65 in chips)
Seat 4: GDVIsbEJ/DOJsMKE4Asz0A ($101.25 in chips)
Seat 5: QHvTZcrKe6+maWUfVjP29Q ($101 in chips)
Seat 6: hpxXcmRkXXI9HE5+5/j/0Q ($101.50 in chips)
QHvTZcrKe6+maWUfVjP29Q: posts small blind $0.50
hpxXcmRkXXI9HE5+5/j/0Q: posts big blind $1
*** HOLE CARDS ***
TSuRyAHnUPCFjP7Z0rEE0w: folds
8CAoOzhmB8n3nRFf3V4BTg: folds
U6tnjwZRpTnM+YkqkCjwyQ: folds
GDVIsbEJ/DOJsMKE4Asz0A: folds
QHvTZcrKe6+maWUfVjP29Q: raises $2.50 to $3.50
hpxXcmRkXXI9HE5+5/j/0Q: folds
QHvTZcrKe6+maWUfVjP29Q collected $2 from pot
QHvTZcrKe6+maWUfVjP29Q: doesn't show hand
*** SUMMARY ***
Total pot $2 | Rake $0
Seat 1: TSuRyAHnUPCFjP7Z0rEE0w folded before Flop (didn't bet)
Seat 2: 8CAoOzhmB8n3nRFf3V4BTg folded before Flop (didn't bet)
Seat 3: U6tnjwZRpTnM+YkqkCjwyQ folded before Flop (didn't bet)
Seat 4: GDVIsbEJ/DOJsMKE4Asz0A (button) folded before Flop (didn't bet)
Seat 5: QHvTZcrKe6+maWUfVjP29Q (small blind) collected ($2)
Seat 6: hpxXcmRkXXI9HE5+5/j/0Q (big blind) folded before Flop



PokerStars Game #59939059006:  Hold'em No Limit ($0.50/$1.00) - 2009/07/01 0:30:18 ET
Table '/RZcOwpZpHQ+OwPwjsbnRw' 6-max Seat #1 is the button
Seat 1: Zboa6dColKGHBjLPUakZjw ($46.70 in chips)
Seat 2: dHC9PH9hdH3Ad2TD8ZxX0Q ($43.25 in chips)
Seat 3: OigyyiK+tTj1APPIAUmXDA ($72.65 in chips)
Seat 4: j7NIOHLZk7V2o9fOioO5ug ($116.60 in chips)
Seat 5: wx3sQGkVi2x9wJXuWNHPBw ($204.65 in chips)
Seat 6: XOIf9W+VAxhZqN+SYoyMKA ($249.30 in chips)
dHC9PH9hdH3Ad2TD8ZxX0Q: posts small blind $0.50
OigyyiK+tTj1APPIAUmXDA: posts big blind $1
*** HOLE CARDS ***
j7NIOHLZk7V2o9fOioO5ug: folds
wx3sQGkVi2x9wJXuWNHPBw: raises $3 to $4
XOIf9W+VAxhZqN+SYoyMKA: folds
Zboa6dColKGHBjLPUakZjw: folds
dHC9PH9hdH3Ad2TD8ZxX0Q: folds
OigyyiK+tTj1APPIAUmXDA: folds
wx3sQGkVi2x9wJXuWNHPBw collected $2.50 from pot
*** SUMMARY ***
Total pot $2.50 | Rake $0
Seat 1: Zboa6dColKGHBjLPUakZjw (button) folded before Flop (didn't bet)
Seat 2: dHC9PH9hdH3Ad2TD8ZxX0Q (small blind) folded before Flop
Seat 3: OigyyiK+tTj1APPIAUmXDA (big blind) folded before Flop
Seat 4: j7NIOHLZk7V2o9fOioO5ug folded before Flop (didn't bet)
Seat 5: wx3sQGkVi2x9wJXuWNHPBw collected ($2.50)
Seat 6: XOIf9W+VAxhZqN+SYoyMKA folded before Flop (didn't bet)



PokerStars Game #59939059462:  Hold'em No Limit ($0.50/$1.00) - 2009/07/01 0:30:18 ET
Table 'Zka9tv1yilg0MvXWPQrShg' 9-max Seat #8 is the button
Seat 1: TZcz9MEWDA+WydgGruqqbw ($116.85 in chips)
Seat 2: rR1qGAf9Q9RYorKYWH3VKw ($21.50 in chips)
Seat 3: gUUvmqdVlmvpal6B8nYrmg ($102.50 in chips)
Seat 4: CTOae+JLIGfwfXvhqHkP2w ($170.65 in chips)
Seat 5: /zy+DB4S5fUQUSfZWFzYGw ($136.45 in chips)
Seat 6: rY8wPoax1lS+HUY+I0FZDw ($129.90 in chips)
Seat 7: p1SafS90nb3Uft5LB0NkHw ($20 in chips)
Seat 8: bL+QVeDcuEdzMGAGg2XJHg ($123.10 in chips)
Seat 9: 6daxhj43mWj04MOPTOmaYA ($96.50 in chips)
6daxhj43mWj04MOPTOmaYA: posts small blind $0.50
TZcz9MEWDA+WydgGruqqbw: posts big blind $1
*** HOLE CARDS ***
rR1qGAf9Q9RYorKYWH3VKw: folds
gUUvmqdVlmvpal6B8nYrmg: folds
CTOae+JLIGfwfXvhqHkP2w: calls $1
/zy+DB4S5fUQUSfZWFzYGw: folds
rY8wPoax1lS+HUY+I0FZDw: raises $6 to $7
p1SafS90nb3Uft5LB0NkHw: folds
bL+QVeDcuEdzMGAGg2XJHg: folds
6daxhj43mWj04MOPTOmaYA: folds
TZcz9MEWDA+WydgGruqqbw: folds
CTOae+JLIGfwfXvhqHkP2w: calls $6
*** FLOP *** [Jc 8h 2s]
CTOae+JLIGfwfXvhqHkP2w: checks
rY8wPoax1lS+HUY+I0FZDw: bets $21
CTOae+JLIGfwfXvhqHkP2w: folds
rY8wPoax1lS+HUY+I0FZDw collected $14.75 from pot
*** SUMMARY ***
Total pot $15.50 | Rake $0.75
Board [Jc 8h 2s]
Seat 1: TZcz9MEWDA+WydgGruqqbw (big blind) folded before Flop
Seat 2: rR1qGAf9Q9RYorKYWH3VKw folded before Flop (didn't bet)
Seat 3: gUUvmqdVlmvpal6B8nYrmg folded before Flop (didn't bet)
Seat 4: CTOae+JLIGfwfXvhqHkP2w folded on the Flop
Seat 5: /zy+DB4S5fUQUSfZWFzYGw folded before Flop (didn't bet)
Seat 6: rY8wPoax1lS+HUY+I0FZDw collected ($14.75)
Seat 7: p1SafS90nb3Uft5LB0NkHw folded before Flop (didn't bet)
Seat 8: bL+QVeDcuEdzMGAGg2XJHg (button) folded before Flop (didn't bet)
Seat 9: 6daxhj43mWj04MOPTOmaYA (small blind) folded before Flop



PokerStars Game #59939059186:  Hold'em No Limit ($0.50/$1.00) - 2009/07/01 0:30:18 ET
Table 'tLrtq7gDzxEvckNAI1OS5Q' 6-max Seat #6 is the button
Seat 1: GisIe1kcC9q/xV6ifsTjgA ($162.60 in chips)
Seat 2: QHvTZcrKe6+maWUfVjP29Q ($100 in chips)
Seat 4: KOG8rG51mOvIoY96zF3kvw ($161.80 in chips)
Seat 5: OGMLOcTNYZXZU81au7ztUw ($164.95 in chips)
Seat 6: XUk5GQsfNFpHvaToDZ0rZA ($49.25 in chips)
GisIe1kcC9q/xV6ifsTjgA: posts small blind $0.50
QHvTZcrKe6+maWUfVjP29Q: posts big blind $1
*** HOLE CARDS ***
KOG8rG51mOvIoY96zF3kvw: folds
OGMLOcTNYZXZU81au7ztUw: raises $2 to $3
XUk5GQsfNFpHvaToDZ0rZA: folds
GisIe1kcC9q/xV6ifsTjgA: folds
QHvTZcrKe6+maWUfVjP29Q: folds
OGMLOcTNYZXZU81au7ztUw collected $2.50 from pot
OGMLOcTNYZXZU81au7ztUw: doesn't show hand
*** SUMMARY ***
Total pot $2.50 | Rake $0
Seat 1: GisIe1kcC9q/xV6ifsTjgA (small blind) folded before Flop
Seat 2: QHvTZcrKe6+maWUfVjP29Q (big blind) folded before Flop
Seat 4: KOG8rG51mOvIoY96zF3kvw folded before Flop (didn't bet)
Seat 5: OGMLOcTNYZXZU81au7ztUw collected ($2.50)
Seat 6: XUk5GQsfNFpHvaToDZ0rZA (button) folded before Flop (didn't bet)



PokerStars Game #59939061526:  Hold'em No Limit ($0.50/$1.00) - 2009/07/01 0:30:21 ET
Table 'tyUh+jyNvrceIQdKMJjQ2wZFWj23PMihdwrNWv41OG/Qeat #5 is the button
Seat 2: 6iVcnPw9a2oNG6sPQo3G6g ($191.50 in chips)
Seat 3: L9qfLYXrczhAPd/VckgsWw ($37.60 in chips)
Seat 4: TSuRyAHnUPCFjP7Z0rEE0w ($119.45 in chips)
Seat 5: j7NIOHLZk7V2o9fOioO5ug ($119.60 in chips)
Seat 6: YsLQ3BAvgQHWXMAv3Wv6Hg ($100 in chips)
YsLQ3BAvgQHWXMAv3Wv6Hg: posts small blind $0.50
6iVcnPw9a2oNG6sPQo3G6g: posts big blind $1
*** HOLE CARDS ***
L9qfLYXrczhAPd/VckgsWw: folds
TSuRyAHnUPCFjP7Z0rEE0w: folds
j7NIOHLZk7V2o9fOioO5ug: folds
YsLQ3BAvgQHWXMAv3Wv6Hg: folds
6iVcnPw9a2oNG6sPQo3G6g collected $1 from pot
*** SUMMARY ***
Total pot $1 | Rake $0
Seat 2: 6iVcnPw9a2oNG6sPQo3G6g (big blind) collected ($1)
Seat 3: L9qfLYXrczhAPd/VckgsWw folded before Flop (didn't bet)
Seat 4: TSuRyAHnUPCFjP7Z0rEE0w folded before Flop (didn't bet)
Seat 5: j7NIOHLZk7V2o9fOioO5ug (button) folded before Flop (didn't bet)
Seat 6: YsLQ3BAvgQHWXMAv3Wv6Hg (small blind) folded before Flop



PokerStars Game #59939062206:  Hold'em No Limit ($0.50/$1.00) - 2009/07/01 0:30:22 ET
Table 'cBDNutyLBKEk9+ptwsKmTw' 6-max Seat #3 is the button
Seat 1: xAU6q2/cwmby2sxmA8VcmA ($101 in chips)
Seat 2: Gy1fd4JyD1aNBFFlOGzbJQ ($20 in chips)
Seat 3: G5ZSSN6RSON3gkNvk/SmYg ($111.90 in chips)
Seat 4: 0WjiuIT7/EolY1oOx1ngeA ($103.65 in chips)
Seat 5: OGMLOcTNYZXZU81au7ztUw ($117.85 in chips)
0WjiuIT7/EolY1oOx1ngeA: posts small blind $0.50
OGMLOcTNYZXZU81au7ztUw: posts big blind $1
NqVlOSH2lp+pp/TK3vvK5g: sits out
Gy1fd4JyD1aNBFFlOGzbJQ: posts big blind $1
*** HOLE CARDS ***
xAU6q2/cwmby2sxmA8VcmA: folds
Gy1fd4JyD1aNBFFlOGzbJQ: checks
G5ZSSN6RSON3gkNvk/SmYg: folds
0WjiuIT7/EolY1oOx1ngeA: folds
OGMLOcTNYZXZU81au7ztUw: checks
*** FLOP *** [Ks 4c 3h]
OGMLOcTNYZXZU81au7ztUw: checks
Gy1fd4JyD1aNBFFlOGzbJQ: checks
*** TURN *** [Ks 4c 3h] [Qs]
OGMLOcTNYZXZU81au7ztUw: bets $1
Gy1fd4JyD1aNBFFlOGzbJQ: folds
OGMLOcTNYZXZU81au7ztUw collected $2.40 from pot
OGMLOcTNYZXZU81au7ztUw: doesn't show hand
*** SUMMARY ***
Total pot $2.50 | Rake $0.10
Board [Ks 4c 3h Qs]
Seat 1: xAU6q2/cwmby2sxmA8VcmA folded before Flop (didn't bet)
Seat 2: Gy1fd4JyD1aNBFFlOGzbJQ folded on the Turn
Seat 3: G5ZSSN6RSON3gkNvk/SmYg (button) folded before Flop (didn't bet)
Seat 4: 0WjiuIT7/EolY1oOx1ngeA (small blind) folded before Flop
Seat 5: OGMLOcTNYZXZU81au7ztUw (big blind) collected ($2.40)



PokerStars Game #59939062716:  Hold'em No Limit ($0.50/$1.00) - 2009/07/01 0:30:23 ET
Table 'MUPc8FEpe/nR0BKSeReX6Q' 6-max Seat #3 is the button
Seat 1: YsLQ3BAvgQHWXMAv3Wv6Hg ($100 in chips)
Seat 2: xAU6q2/cwmby2sxmA8VcmA ($109 in chips)
Seat 3: wx3sQGkVi2x9wJXuWNHPBw ($234.05 in chips)
Seat 4: ZA1bp6g8IwtTxkUE4eCjDQ ($117.30 in chips)
Seat 5: UBZQqpnJZdTYYY1FTb0rLA ($100 in chips)
Seat 6: oxnw0GLLpFanjhGkxfRSqA ($53.10 in chips)
ZA1bp6g8IwtTxkUE4eCjDQ: posts small blind $0.50
UBZQqpnJZdTYYY1FTb0rLA: posts big blind $1
*** HOLE CARDS ***
oxnw0GLLpFanjhGkxfRSqA: folds
YsLQ3BAvgQHWXMAv3Wv6Hg: folds
xAU6q2/cwmby2sxmA8VcmA: raises $3 to $4
wx3sQGkVi2x9wJXuWNHPBw: folds
ZA1bp6g8IwtTxkUE4eCjDQ: folds
UBZQqpnJZdTYYY1FTb0rLA: folds
xAU6q2/cwmby2sxmA8VcmA collected $2.50 from pot
xAU6q2/cwmby2sxmA8VcmA: doesn't show hand
*** SUMMARY ***
Total pot $2.50 | Rake $0
Seat 1: YsLQ3BAvgQHWXMAv3Wv6Hg folded before Flop (didn't bet)
Seat 2: xAU6q2/cwmby2sxmA8VcmA collected ($2.50)
Seat 3: wx3sQGkVi2x9wJXuWNHPBw (button) folded before Flop (didn't bet)
Seat 4: ZA1bp6g8IwtTxkUE4eCjDQ (small blind) folded before Flop
Seat 5: UBZQqpnJZdTYYY1FTb0rLA (big blind) folded before Flop
Seat 6: oxnw0GLLpFanjhGkxfRSqA folded before Flop (didn't bet)



PokerStars Game #59939063740:  Hold'em No Limit ($0.50/$1.00) - 2009/07/01 0:30:25 ET
Table 'fTlPiCj0utgzC/5io+I7ew' 6-max Seat #4 is the button
Seat 1: YMJG+F++3Aj6P8dAWda5fw ($100 in chips)
Seat 3: oDiBRCaF0QVtd3kO6xZIXw ($101.50 in chips)
Seat 4: uJVSceLggtsrJya+WtmUEA ($96.30 in chips)
Seat 5: bFrTkDcWGTxyvNul7GVdYg ($254.45 in chips)
Seat 6: jMljU/dOPMXfJi8OmbdYdw ($16.50 in chips)
bFrTkDcWGTxyvNul7GVdYg: posts small blind $0.50
jMljU/dOPMXfJi8OmbdYdw: posts big blind $1
Qy/UBNbD2HaA0Ogxg8Sf3w: sits out
*** HOLE CARDS ***
YMJG+F++3Aj6P8dAWda5fw: folds
oDiBRCaF0QVtd3kO6xZIXw: folds
uJVSceLggtsrJya+WtmUEA: folds
bFrTkDcWGTxyvNul7GVdYg: raises $1.50 to $2.50
jMljU/dOPMXfJi8OmbdYdw: calls $1.50
*** FLOP *** [8s Qh 7c]
bFrTkDcWGTxyvNul7GVdYg: checks
jMljU/dOPMXfJi8OmbdYdw: checks
*** TURN *** [8s Qh 7c] [Td]
bFrTkDcWGTxyvNul7GVdYg: bets $3.50
jMljU/dOPMXfJi8OmbdYdw: folds
bFrTkDcWGTxyvNul7GVdYg collected $4.75 from pot
*** SUMMARY ***
Total pot $5 | Rake $0.25
Board [8s Qh 7c Td]
Seat 1: YMJG+F++3Aj6P8dAWda5fw folded before Flop (didn't bet)
Seat 3: oDiBRCaF0QVtd3kO6xZIXw folded before Flop (didn't bet)
Seat 4: uJVSceLggtsrJya+WtmUEA (button) folded before Flop (didn't bet)
Seat 5: bFrTkDcWGTxyvNul7GVdYg (small blind) collected ($4.75)
Seat 6: jMljU/dOPMXfJi8OmbdYdw (big blind) folded on the Turn



PokerStars Game #59939065318:  Hold'em No Limit ($0.50/$1.00) - 2009/07/01 0:30:27 ET
Table 'rmZfTK+oSebeUPJNbWhdAA' 6-max Seat #1 is the button
Seat 1: xAU6q2/cwmby2sxmA8VcmA ($100 in chips)
Seat 2: OigyyiK+tTj1APPIAUmXDA ($91.05 in chips)
Seat 3: 9yjOzGERLaEZS8CZ6YNHFg ($116.90 in chips)
Seat 4: OGMLOcTNYZXZU81au7ztUw ($127.20 in chips)
Seat 5: +xW7QemQU0Fxs+4TnqBRow ($101.50 in chips)
Seat 6: j7NIOHLZk7V2o9fOioO5ug ($102 in chips)
OigyyiK+tTj1APPIAUmXDA: posts small blind $0.50
9yjOzGERLaEZS8CZ6YNHFg: posts big blind $1
*** HOLE CARDS ***
OGMLOcTNYZXZU81au7ztUw: folds
+xW7QemQU0Fxs+4TnqBRow: folds
j7NIOHLZk7V2o9fOioO5ug: raises $2 to $3
xAU6q2/cwmby2sxmA8VcmA: folds
OigyyiK+tTj1APPIAUmXDA: calls $2.50
9yjOzGERLaEZS8CZ6YNHFg: folds
*** FLOP *** [8s 6c 3d]
OigyyiK+tTj1APPIAUmXDA: checks
j7NIOHLZk7V2o9fOioO5ug: checks
*** TURN *** [8s 6c 3d] [Ac]
OigyyiK+tTj1APPIAUmXDA: checks
j7NIOHLZk7V2o9fOioO5ug: bets $5
OigyyiK+tTj1APPIAUmXDA: folds
j7NIOHLZk7V2o9fOioO5ug collected $6.65 from pot
*** SUMMARY ***
Total pot $7 | Rake $0.35
Board [8s 6c 3d Ac]
Seat 1: xAU6q2/cwmby2sxmA8VcmA (button) folded before Flop (didn't bet)
Seat 2: OigyyiK+tTj1APPIAUmXDA (small blind) folded on the Turn
Seat 3: 9yjOzGERLaEZS8CZ6YNHFg (big blind) folded before Flop
Seat 4: OGMLOcTNYZXZU81au7ztUw folded before Flop (didn't bet)
Seat 5: +xW7QemQU0Fxs+4TnqBRow folded before Flop (didn't bet)
Seat 6: j7NIOHLZk7V2o9fOioO5ug collected ($6.65)



PokerStars Game #59939065342:  Hold'em No Limit ($0.50/$1.00) - 2009/07/01 0:30:27 ET
Table '8jIjWCPY0NGprquL+xcMFg' 9-max Seat #4 is the button
Seat 1: vR4IO10geOgvTW+LAUBv/A ($133.65 in chips)
Seat 2: rR1qGAf9Q9RYorKYWH3VKw ($8.15 in chips)
Seat 3: 58zdeSBSuSFX/qZfhc7YmA ($108.45 in chips)
Seat 4: by0z+YmujwI6Bf4qRFE8vA ($148.45 in chips)
Seat 5: n758Yw8Hx2S+6NQUPGqcqA ($87.50 in chips)
Seat 6: GTQkFJtSkbVbnGCktp6e3g ($100 in chips)
Seat 7: O3CGPwwUmamrCNHccOilrg ($46.15 in chips)
Seat 8: 9swGhtpERPngKPtvpoZkoQ ($151.80 in chips)
Seat 9: negfosHnGOZXSHpWDRKyBQ ($18.50 in chips)
n758Yw8Hx2S+6NQUPGqcqA: posts small blind $0.50
GTQkFJtSkbVbnGCktp6e3g: posts big blind $1
*** HOLE CARDS ***
O3CGPwwUmamrCNHccOilrg: folds
9swGhtpERPngKPtvpoZkoQ: folds
negfosHnGOZXSHpWDRKyBQ: folds
vR4IO10geOgvTW+LAUBv/A: raises $2 to $3
rR1qGAf9Q9RYorKYWH3VKw: calls $3
58zdeSBSuSFX/qZfhc7YmA: folds
by0z+YmujwI6Bf4qRFE8vA: folds
n758Yw8Hx2S+6NQUPGqcqA: folds
GTQkFJtSkbVbnGCktp6e3g: folds
*** FLOP *** [3c Jc 4s]
vR4IO10geOgvTW+LAUBv/A: bets $6
rR1qGAf9Q9RYorKYWH3VKw: folds
vR4IO10geOgvTW+LAUBv/A collected $7.15 from pot
vR4IO10geOgvTW+LAUBv/A: doesn't show hand
*** SUMMARY ***
Total pot $7.50 | Rake $0.35
Board [3c Jc 4s]
Seat 1: vR4IO10geOgvTW+LAUBv/A collected ($7.15)
Seat 2: rR1qGAf9Q9RYorKYWH3VKw folded on the Flop
Seat 3: 58zdeSBSuSFX/qZfhc7YmA folded before Flop (didn't bet)
Seat 4: by0z+YmujwI6Bf4qRFE8vA (button) folded before Flop (didn't bet)
Seat 5: n758Yw8Hx2S+6NQUPGqcqA (small blind) folded before Flop
Seat 6: GTQkFJtSkbVbnGCktp6e3g (big blind) folded before Flop
Seat 7: O3CGPwwUmamrCNHccOilrg folded before Flop (didn't bet)
Seat 8: 9swGhtpERPngKPtvpoZkoQ folded before Flop (didn't bet)
Seat 9: negfosHnGOZXSHpWDRKyBQ folded before Flop (didn't bet)



PokerStars Game #59939065962:  Hold'em No Limit ($0.50/$1.00) - 2009/07/01 0:30:28 ET
Table 'kS0cTQAEi+fdUlJP2gQYvw' 9-max Seat #7 is the button
Seat 1: c/9X4zftzphFxYtxp5kp9w ($41.90 in chips)
Seat 2: 4SFNYndzMeslixOnF4koZQ ($53.05 in chips)
Seat 3: 3obndzTJ6fECz8+wWhMd1w ($17 in chips)
Seat 4: TZcz9MEWDA+WydgGruqqbw ($100 in chips)
Seat 5: 2rxrMrE7koO2BNxvop/0+g ($51.55 in chips)
Seat 6: yAbu2QsRPVcjPbqlf/jDxw ($100 in chips)
Seat 7: Ffa7Nj4X5fddtROP01hfQg ($110.80 in chips)
Seat 8: qTymj6ZQ8ZoFi6fINJZb3w ($81 in chips)
Seat 9: y8Qb94e81yI/g0saQ6gU5g ($84.75 in chips)
qTymj6ZQ8ZoFi6fINJZb3w: posts small blind $0.50
y8Qb94e81yI/g0saQ6gU5g: posts big blind $1
*** HOLE CARDS ***
c/9X4zftzphFxYtxp5kp9w: calls $1
4SFNYndzMeslixOnF4koZQ: folds
3obndzTJ6fECz8+wWhMd1w: raises $4 to $5
TZcz9MEWDA+WydgGruqqbw: folds
2rxrMrE7koO2BNxvop/0+g: folds
yAbu2QsRPVcjPbqlf/jDxw: folds
Ffa7Nj4X5fddtROP01hfQg: folds
qTymj6ZQ8ZoFi6fINJZb3w: folds
y8Qb94e81yI/g0saQ6gU5g: folds
c/9X4zftzphFxYtxp5kp9w: folds
3obndzTJ6fECz8+wWhMd1w collected $3.50 from pot
*** SUMMARY ***
Total pot $3.50 | Rake $0
Seat 1: c/9X4zftzphFxYtxp5kp9w folded before Flop
Seat 2: 4SFNYndzMeslixOnF4koZQ folded before Flop (didn't bet)
Seat 3: 3obndzTJ6fECz8+wWhMd1w collected ($3.50)
Seat 4: TZcz9MEWDA+WydgGruqqbw folded before Flop (didn't bet)
Seat 5: 2rxrMrE7koO2BNxvop/0+g folded before Flop (didn't bet)
Seat 6: yAbu2QsRPVcjPbqlf/jDxw folded before Flop (didn't bet)
Seat 7: Ffa7Nj4X5fddtROP01hfQg (button) folded before Flop (didn't bet)
Seat 8: qTymj6ZQ8ZoFi6fINJZb3w (small blind) folded before Flop
Seat 9: y8Qb94e81yI/g0saQ6gU5g (big blind) folded before Flop



PokerStars Game #59939066638:  Hold'em No Limit ($0.50/$1.00) - 2009/07/01 0:30:29 ET
Table 'vs/5jr6ciwjVQ5+Soc+u2A' 6-max Seat #2 is the button
Seat 2: XOIf9W+VAxhZqN+SYoyMKA ($121.15 in chips)
Seat 3: G5ZSSN6RSON3gkNvk/SmYg ($100 in chips)
Seat 4: KpnW5CcJ4Mg6MeclfKmLrw ($115.30 in chips)
Seat 5: 7Vc9JmGFQwMRh5Tj9ui5Lw ($98.15 in chips)
Seat 6: QHvTZcrKe6+maWUfVjP29Q ($100 in chips)
G5ZSSN6RSON3gkNvk/SmYg: posts small blind $0.50
KpnW5CcJ4Mg6MeclfKmLrw: posts big blind $1
*** HOLE CARDS ***
7Vc9JmGFQwMRh5Tj9ui5Lw: folds
QHvTZcrKe6+maWUfVjP29Q: raises $2.50 to $3.50
XOIf9W+VAxhZqN+SYoyMKA: folds
G5ZSSN6RSON3gkNvk/SmYg: folds
3yN2jRjZ+glIaWtGMmKOrA joins the table at seat #1
KpnW5CcJ4Mg6MeclfKmLrw: folds
QHvTZcrKe6+maWUfVjP29Q collected $2.50 from pot
QHvTZcrKe6+maWUfVjP29Q: doesn't show hand
*** SUMMARY ***
Total pot $2.50 | Rake $0
Seat 2: XOIf9W+VAxhZqN+SYoyMKA (button) folded before Flop (didn't bet)
Seat 3: G5ZSSN6RSON3gkNvk/SmYg (small blind) folded before Flop
Seat 4: KpnW5CcJ4Mg6MeclfKmLrw (big blind) folded before Flop
Seat 5: 7Vc9JmGFQwMRh5Tj9ui5Lw folded before Flop (didn't bet)
Seat 6: QHvTZcrKe6+maWUfVjP29Q collected ($2.50)



PokerStars Game #59939067996:  Hold'em No Limit ($0.50/$1.00) - 2009/07/01 0:30:32 ET
Table 'tyUh+jyNvrceIQdKMJjQ2wZFWj23PMihdwrNWv41OG/Qeat #6 is the button
Seat 2: 6iVcnPw9a2oNG6sPQo3G6g ($192 in chips)
Seat 3: L9qfLYXrczhAPd/VckgsWw ($37.60 in chips)
Seat 4: TSuRyAHnUPCFjP7Z0rEE0w ($119.45 in chips)
Seat 5: j7NIOHLZk7V2o9fOioO5ug ($119.60 in chips)
Seat 6: YsLQ3BAvgQHWXMAv3Wv6Hg ($100 in chips)
6iVcnPw9a2oNG6sPQo3G6g: posts small blind $0.50
L9qfLYXrczhAPd/VckgsWw: posts big blind $1
*** HOLE CARDS ***
TSuRyAHnUPCFjP7Z0rEE0w: folds
j7NIOHLZk7V2o9fOioO5ug: folds
YsLQ3BAvgQHWXMAv3Wv6Hg: raises $3 to $4
6iVcnPw9a2oNG6sPQo3G6g: folds
L9qfLYXrczhAPd/VckgsWw: folds
YsLQ3BAvgQHWXMAv3Wv6Hg collected $2.50 from pot
YsLQ3BAvgQHWXMAv3Wv6Hg: doesn't show hand
*** SUMMARY ***
Total pot $2.50 | Rake $0
Seat 2: 6iVcnPw9a2oNG6sPQo3G6g (small blind) folded before Flop
Seat 3: L9qfLYXrczhAPd/VckgsWw (big blind) folded before Flop
Seat 4: TSuRyAHnUPCFjP7Z0rEE0w folded before Flop (didn't bet)
Seat 5: j7NIOHLZk7V2o9fOioO5ug folded before Flop (didn't bet)
Seat 6: YsLQ3BAvgQHWXMAv3Wv6Hg (button) collected ($2.50)



PokerStars Game #59939069706:  Hold'em No Limit ($0.50/$1.00) - 2009/07/01 0:30:34 ET
Table 'tLrtq7gDzxEvckNAI1OS5Q' 6-max Seat #1 is the button
Seat 1: GisIe1kcC9q/xV6ifsTjgA ($162.10 in chips)
Seat 2: QHvTZcrKe6+maWUfVjP29Q ($100 in chips)
Seat 4: KOG8rG51mOvIoY96zF3kvw ($161.80 in chips)
Seat 5: OGMLOcTNYZXZU81au7ztUw ($166.45 in chips)
Seat 6: XUk5GQsfNFpHvaToDZ0rZA ($49.25 in chips)
QHvTZcrKe6+maWUfVjP29Q: posts small blind $0.50
KOG8rG51mOvIoY96zF3kvw: posts big blind $1
*** HOLE CARDS ***
OGMLOcTNYZXZU81au7ztUw: folds
XUk5GQsfNFpHvaToDZ0rZA: folds
GisIe1kcC9q/xV6ifsTjgA: folds
QHvTZcrKe6+maWUfVjP29Q: folds
KOG8rG51mOvIoY96zF3kvw collected $1 from pot
KOG8rG51mOvIoY96zF3kvw: doesn't show hand
*** SUMMARY ***
Total pot $1 | Rake $0
Seat 1: GisIe1kcC9q/xV6ifsTjgA (button) folded before Flop (didn't bet)
Seat 2: QHvTZcrKe6+maWUfVjP29Q (small blind) folded before Flop
Seat 4: KOG8rG51mOvIoY96zF3kvw (big blind) collected ($1)
Seat 5: OGMLOcTNYZXZU81au7ztUw folded before Flop (didn't bet)
Seat 6: XUk5GQsfNFpHvaToDZ0rZA folded before Flop (didn't bet)



PokerStars Game #59939069422:  Hold'em No Limit ($0.50/$1.00) - 2009/07/01 0:30:34 ET
Table 'hugOjcwJvzEwZbK7tyiWuQ' 9-max Seat #1 is the button
Seat 1: N9n5Wc3s35DpCrOAUUNAaQ ($122.85 in chips)
Seat 2: r27C1nIV4NS4+qbnrgBQSw ($257.55 in chips)
Seat 3: jDwhY1kCdc6EkAHbT7PJMQ ($109.75 in chips)
Seat 4: UWB3oeddt/GObx2Mix2Anw ($201.30 in chips)
Seat 6: gUUvmqdVlmvpal6B8nYrmg ($100 in chips)
Seat 7: FL3MrLspcF23LYvC4ipBOA ($101.50 in chips)
Seat 8: /zy+DB4S5fUQUSfZWFzYGw ($113.25 in chips)
Seat 9: o6JyUkbzCDw8tUabqtmnlg ($57.60 in chips)
r27C1nIV4NS4+qbnrgBQSw: posts small blind $0.50
jDwhY1kCdc6EkAHbT7PJMQ: posts big blind $1
*** HOLE CARDS ***
UWB3oeddt/GObx2Mix2Anw: folds
gUUvmqdVlmvpal6B8nYrmg: folds
FL3MrLspcF23LYvC4ipBOA: folds
/zy+DB4S5fUQUSfZWFzYGw: folds
o6JyUkbzCDw8tUabqtmnlg: folds
N9n5Wc3s35DpCrOAUUNAaQ: folds
r27C1nIV4NS4+qbnrgBQSw: folds
jDwhY1kCdc6EkAHbT7PJMQ collected $1 from pot
*** SUMMARY ***
Total pot $1 | Rake $0
Seat 1: N9n5Wc3s35DpCrOAUUNAaQ (button) folded before Flop (didn't bet)
Seat 2: r27C1nIV4NS4+qbnrgBQSw (small blind) folded before Flop
Seat 3: jDwhY1kCdc6EkAHbT7PJMQ (big blind) collected ($1)
Seat 4: UWB3oeddt/GObx2Mix2Anw folded before Flop (didn't bet)
Seat 6: gUUvmqdVlmvpal6B8nYrmg folded before Flop (didn't bet)
Seat 7: FL3MrLspcF23LYvC4ipBOA folded before Flop (didn't bet)
Seat 8: /zy+DB4S5fUQUSfZWFzYGw folded before Flop (didn't bet)
Seat 9: o6JyUkbzCDw8tUabqtmnlg folded before Flop (didn't bet)



PokerStars Game #59939069822:  Hold'em No Limit ($0.50/$1.00) - 2009/07/01 0:30:34 ET
Table 'U9zqzC8f3oTJ2ShXFgSSOA' 6-max Seat #4 is the button
Seat 1: tS9JHB1h+FQ++qu8RwRNgg ($34.60 in chips)
Seat 2: U2CWBTv29qdCbj8RNF2sIw ($106.05 in chips)
Seat 3: yfXek8iJ7O4CFyqXrtGcfg ($42.55 in chips)
Seat 4: 33q95we0Etwgrm6guQGncw ($65.90 in chips)
Seat 5: KfwW5us6tydK81NYTtK1gw ($307.55 in chips)
Seat 6: aIxzFKdtpDSkUePKZy/niQ ($38.90 in chips)
KfwW5us6tydK81NYTtK1gw: posts small blind $0.50
aIxzFKdtpDSkUePKZy/niQ: posts big blind $1
*** HOLE CARDS ***
tS9JHB1h+FQ++qu8RwRNgg: folds
U2CWBTv29qdCbj8RNF2sIw: folds
yfXek8iJ7O4CFyqXrtGcfg: raises $2 to $3
33q95we0Etwgrm6guQGncw: calls $3
KfwW5us6tydK81NYTtK1gw: folds
aIxzFKdtpDSkUePKZy/niQ: folds
*** FLOP *** [Qd Th 3s]
yfXek8iJ7O4CFyqXrtGcfg: bets $4
33q95we0Etwgrm6guQGncw: calls $4
*** TURN *** [Qd Th 3s] [5h]
yfXek8iJ7O4CFyqXrtGcfg: checks
33q95we0Etwgrm6guQGncw: bets $7
yfXek8iJ7O4CFyqXrtGcfg: folds
33q95we0Etwgrm6guQGncw collected $14.75 from pot
*** SUMMARY ***
Total pot $15.50 | Rake $0.75
Board [Qd Th 3s 5h]
Seat 1: tS9JHB1h+FQ++qu8RwRNgg folded before Flop (didn't bet)
Seat 2: U2CWBTv29qdCbj8RNF2sIw folded before Flop (didn't bet)
Seat 3: yfXek8iJ7O4CFyqXrtGcfg folded on the Turn
Seat 4: 33q95we0Etwgrm6guQGncw (button) collected ($14.75)
Seat 5: KfwW5us6tydK81NYTtK1gw (small blind) folded before Flop
Seat 6: aIxzFKdtpDSkUePKZy/niQ (big blind) folded before Flop



PokerStars Game #59939070266:  Hold'em No Limit ($0.50/$1.00) - 2009/07/01 0:30:35 ET
Table 'pHrhryH8jPNdQfY62f8v+g' 6-max Seat #3 is the button
Seat 1: BdbmJTZZ47quA9vUWwXtlw ($72.80 in chips)
Seat 2: RqgF7gRoKgRNW8Zoi1ty4A ($116.50 in chips)
Seat 3: 0WjiuIT7/EolY1oOx1ngeA ($109.55 in chips)
Seat 4: wenbG7TaM3H7h5kn78OFNw ($46 in chips)
Seat 5: r1/R7y0Ortgoz4lccgW8VA ($72.65 in chips)
Seat 6: xAU6q2/cwmby2sxmA8VcmA ($102.80 in chips)
wenbG7TaM3H7h5kn78OFNw: posts small blind $0.50
r1/R7y0Ortgoz4lccgW8VA: posts big blind $1
*** HOLE CARDS ***
xAU6q2/cwmby2sxmA8VcmA: folds
BdbmJTZZ47quA9vUWwXtlw: folds
RqgF7gRoKgRNW8Zoi1ty4A: folds
0WjiuIT7/EolY1oOx1ngeA: folds
wenbG7TaM3H7h5kn78OFNw: raises $2 to $3
r1/R7y0Ortgoz4lccgW8VA: calls $2
*** FLOP *** [3c 2h 2c]
wenbG7TaM3H7h5kn78OFNw: checks
r1/R7y0Ortgoz4lccgW8VA: checks
*** TURN *** [3c 2h 2c] [6d]
wenbG7TaM3H7h5kn78OFNw: checks
r1/R7y0Ortgoz4lccgW8VA: checks
*** RIVER *** [3c 2h 2c 6d] [4s]
wenbG7TaM3H7h5kn78OFNw: bets $3
r1/R7y0Ortgoz4lccgW8VA: calls $3
*** SHOW DOWN ***
wenbG7TaM3H7h5kn78OFNw: shows [6s Ad] (two pair, Sixes and Deuces)
r1/R7y0Ortgoz4lccgW8VA: mucks hand
wenbG7TaM3H7h5kn78OFNw collected $11.45 from pot
*** SUMMARY ***
Total pot $12 | Rake $0.55
Board [3c 2h 2c 6d 4s]
Seat 1: BdbmJTZZ47quA9vUWwXtlw folded before Flop (didn't bet)
Seat 2: RqgF7gRoKgRNW8Zoi1ty4A folded before Flop (didn't bet)
Seat 3: 0WjiuIT7/EolY1oOx1ngeA (button) folded before Flop (didn't bet)
Seat 4: wenbG7TaM3H7h5kn78OFNw (small blind) showed [6s Ad] and won ($11.45) with two pair, Sixes and Deuces
Seat 5: r1/R7y0Ortgoz4lccgW8VA (big blind) mucked
Seat 6: xAU6q2/cwmby2sxmA8VcmA folded before Flop (didn't bet)



PokerStars Game #59939070538:  Hold'em No Limit ($0.50/$1.00) - 2009/07/01 0:30:35 ET
Table 'GxCPo/gd3OSthkYrAxJngg' 6-max Seat #6 is the button
Seat 1: sH8BpAFP+jGFxCgVpD1Lew ($279.45 in chips)
Seat 2: YExX2paeIHrmfIwV1ivM/w ($65.20 in chips)
Seat 3: o6plE+MSW4XFNTeONe16xg ($35.10 in chips)
Seat 4: YMJG+F++3Aj6P8dAWda5fw ($109.65 in chips)
Seat 5: G5ZSSN6RSON3gkNvk/SmYg ($103.20 in chips)
Seat 6: sS9IXedL3MiRmpVXhAILhw ($95.50 in chips)
sH8BpAFP+jGFxCgVpD1Lew: posts small blind $0.50
YExX2paeIHrmfIwV1ivM/w: posts big blind $1
*** HOLE CARDS ***
o6plE+MSW4XFNTeONe16xg: calls $1
YMJG+F++3Aj6P8dAWda5fw: folds
G5ZSSN6RSON3gkNvk/SmYg: folds
sS9IXedL3MiRmpVXhAILhw: calls $1
sH8BpAFP+jGFxCgVpD1Lew: calls $0.50
YExX2paeIHrmfIwV1ivM/w: checks
*** FLOP *** [Jh Th 6c]
sH8BpAFP+jGFxCgVpD1Lew: checks
YExX2paeIHrmfIwV1ivM/w: checks
o6plE+MSW4XFNTeONe16xg: checks
sS9IXedL3MiRmpVXhAILhw: bets $4
sH8BpAFP+jGFxCgVpD1Lew: folds
YExX2paeIHrmfIwV1ivM/w: folds
o6plE+MSW4XFNTeONe16xg: folds
sS9IXedL3MiRmpVXhAILhw collected $3.80 from pot
*** SUMMARY ***
Total pot $4 | Rake $0.20
Board [Jh Th 6c]
Seat 1: sH8BpAFP+jGFxCgVpD1Lew (small blind) folded on the Flop
Seat 2: YExX2paeIHrmfIwV1ivM/w (big blind) folded on the Flop
Seat 3: o6plE+MSW4XFNTeONe16xg folded on the Flop
Seat 4: YMJG+F++3Aj6P8dAWda5fw folded before Flop (didn't bet)
Seat 5: G5ZSSN6RSON3gkNvk/SmYg folded before Flop (didn't bet)
Seat 6: sS9IXedL3MiRmpVXhAILhw (button) collected ($3.80)



PokerStars Game #59939071322:  Hold'em No Limit ($0.50/$1.00) - 2009/07/01 0:30:37 ET
Table '/RZcOwpZpHQ+OwPwjsbnRw' 6-max Seat #2 is the button
Seat 1: Zboa6dColKGHBjLPUakZjw ($46.70 in chips)
Seat 2: dHC9PH9hdH3Ad2TD8ZxX0Q ($42.75 in chips)
Seat 3: OigyyiK+tTj1APPIAUmXDA ($71.65 in chips)
Seat 4: j7NIOHLZk7V2o9fOioO5ug ($116.60 in chips)
Seat 5: wx3sQGkVi2x9wJXuWNHPBw ($206.15 in chips)
Seat 6: XOIf9W+VAxhZqN+SYoyMKA ($249.30 in chips)
OigyyiK+tTj1APPIAUmXDA: posts small blind $0.50
j7NIOHLZk7V2o9fOioO5ug: posts big blind $1
*** HOLE CARDS ***
wx3sQGkVi2x9wJXuWNHPBw: folds
XOIf9W+VAxhZqN+SYoyMKA: folds
Zboa6dColKGHBjLPUakZjw: folds
dHC9PH9hdH3Ad2TD8ZxX0Q: folds
OigyyiK+tTj1APPIAUmXDA: raises $2 to $3
j7NIOHLZk7V2o9fOioO5ug: folds
OigyyiK+tTj1APPIAUmXDA collected $2 from pot
*** SUMMARY ***
Total pot $2 | Rake $0
Seat 1: Zboa6dColKGHBjLPUakZjw folded before Flop (didn't bet)
Seat 2: dHC9PH9hdH3Ad2TD8ZxX0Q (button) folded before Flop (didn't bet)
Seat 3: OigyyiK+tTj1APPIAUmXDA (small blind) collected ($2)
Seat 4: j7NIOHLZk7V2o9fOioO5ug (big blind) folded before Flop
Seat 5: wx3sQGkVi2x9wJXuWNHPBw folded before Flop (didn't bet)
Seat 6: XOIf9W+VAxhZqN+SYoyMKA folded before Flop (didn't bet)



PokerStars Game #59939071770:  Hold'em No Limit ($0.50/$1.00) - 2009/07/01 0:30:37 ET
Table 'MUPc8FEpe/nR0BKSeReX6Q' 6-max Seat #4 is the button
Seat 1: YsLQ3BAvgQHWXMAv3Wv6Hg ($100 in chips)
Seat 2: xAU6q2/cwmby2sxmA8VcmA ($110.50 in chips)
Seat 3: wx3sQGkVi2x9wJXuWNHPBw ($234.05 in chips)
Seat 4: ZA1bp6g8IwtTxkUE4eCjDQ ($116.80 in chips)
Seat 5: UBZQqpnJZdTYYY1FTb0rLA ($100 in chips)
Seat 6: oxnw0GLLpFanjhGkxfRSqA ($53.10 in chips)
UBZQqpnJZdTYYY1FTb0rLA: posts small blind $0.50
oxnw0GLLpFanjhGkxfRSqA: posts big blind $1
*** HOLE CARDS ***
YsLQ3BAvgQHWXMAv3Wv6Hg: folds
xAU6q2/cwmby2sxmA8VcmA: folds
wx3sQGkVi2x9wJXuWNHPBw: folds
ZA1bp6g8IwtTxkUE4eCjDQ: calls $1
UBZQqpnJZdTYYY1FTb0rLA: folds
oxnw0GLLpFanjhGkxfRSqA: checks
*** FLOP *** [8s 6h 6c]
oxnw0GLLpFanjhGkxfRSqA: checks
ZA1bp6g8IwtTxkUE4eCjDQ: bets $1
oxnw0GLLpFanjhGkxfRSqA: calls $1
*** TURN *** [8s 6h 6c] [9c]
oxnw0GLLpFanjhGkxfRSqA: checks
ZA1bp6g8IwtTxkUE4eCjDQ: checks
*** RIVER *** [8s 6h 6c 9c] [Ah]
oxnw0GLLpFanjhGkxfRSqA: checks
ZA1bp6g8IwtTxkUE4eCjDQ: bets $3
oxnw0GLLpFanjhGkxfRSqA: folds
ZA1bp6g8IwtTxkUE4eCjDQ collected $4.30 from pot
ZA1bp6g8IwtTxkUE4eCjDQ: doesn't show hand
*** SUMMARY ***
Total pot $4.50 | Rake $0.20
Board [8s 6h 6c 9c Ah]
Seat 1: YsLQ3BAvgQHWXMAv3Wv6Hg folded before Flop (didn't bet)
Seat 2: xAU6q2/cwmby2sxmA8VcmA folded before Flop (didn't bet)
Seat 3: wx3sQGkVi2x9wJXuWNHPBw folded before Flop (didn't bet)
Seat 4: ZA1bp6g8IwtTxkUE4eCjDQ (button) collected ($4.30)
Seat 5: UBZQqpnJZdTYYY1FTb0rLA (small blind) folded before Flop
Seat 6: oxnw0GLLpFanjhGkxfRSqA (big blind) folded on the River



PokerStars Game #59939071714:  Hold'em No Limit ($0.50/$1.00) - 2009/07/01 0:30:37 ET
Table 'W/wyObTiXZm+Ckkl3YxcSw' 6-max Seat #2 is the button
Seat 1: ssLJburtEIqnVkx6X8R1uw ($118.25 in chips)
Seat 2: oDiBRCaF0QVtd3kO6xZIXw ($101.70 in chips)
Seat 3: b2a+5TkFf4xJN/Ihhma58Q ($45.10 in chips)
Seat 4: +xW7QemQU0Fxs+4TnqBRow ($100 in chips)
b2a+5TkFf4xJN/Ihhma58Q: posts small blind $0.50
+xW7QemQU0Fxs+4TnqBRow: posts big blind $1
*** HOLE CARDS ***
ssLJburtEIqnVkx6X8R1uw: folds
oDiBRCaF0QVtd3kO6xZIXw: folds
b2a+5TkFf4xJN/Ihhma58Q: calls $0.50
+xW7QemQU0Fxs+4TnqBRow: checks
*** FLOP *** [9s Js Qs]
b2a+5TkFf4xJN/Ihhma58Q: bets $2
+xW7QemQU0Fxs+4TnqBRow: folds
b2a+5TkFf4xJN/Ihhma58Q collected $1.90 from pot
*** SUMMARY ***
Total pot $2 | Rake $0.10
Board [9s Js Qs]
Seat 1: ssLJburtEIqnVkx6X8R1uw folded before Flop (didn't bet)
Seat 2: oDiBRCaF0QVtd3kO6xZIXw (button) folded before Flop (didn't bet)
Seat 3: b2a+5TkFf4xJN/Ihhma58Q (small blind) collected ($1.90)
Seat 4: +xW7QemQU0Fxs+4TnqBRow (big blind) folded on the Flop



PokerStars Game #59939071494:  Hold'em No Limit ($0.50/$1.00) - 2009/07/01 0:30:37 ET
Table '/FUb199IViHMJHi5YWmeuQ' 9-max Seat #3 is the button
Seat 1: TZcz9MEWDA+WydgGruqqbw ($101.85 in chips)
Seat 2: FL3MrLspcF23LYvC4ipBOA ($137.25 in chips)
Seat 3: qN483QJ1NvHbdIZB7J4ARw ($59.95 in chips)
Seat 6: ccFf7Q4z1cTGQmeoYiWEfw ($53.95 in chips)
Seat 7: bLbSOSmSOnqE0iTcH/5dxA ($100 in chips)
Seat 8: QIWvt0R766g8KfH0vl1s0A ($31.60 in chips)
Seat 9: knewtTmBc4Tc0z/5tAABYQ ($155.15 in chips)
ccFf7Q4z1cTGQmeoYiWEfw: posts small blind $0.50
bLbSOSmSOnqE0iTcH/5dxA: posts big blind $1
*** HOLE CARDS ***
QIWvt0R766g8KfH0vl1s0A: calls $1
knewtTmBc4Tc0z/5tAABYQ: folds
TZcz9MEWDA+WydgGruqqbw: folds
+za1iHiRgVo4OcAz0SOZqw leaves the table
FL3MrLspcF23LYvC4ipBOA: folds
qN483QJ1NvHbdIZB7J4ARw: folds
ccFf7Q4z1cTGQmeoYiWEfw: calls $0.50
bLbSOSmSOnqE0iTcH/5dxA: checks
*** FLOP *** [7h 3h Kd]
ccFf7Q4z1cTGQmeoYiWEfw: checks
bLbSOSmSOnqE0iTcH/5dxA: checks
QIWvt0R766g8KfH0vl1s0A: checks
*** TURN *** [7h 3h Kd] [9c]
ccFf7Q4z1cTGQmeoYiWEfw: bets $1
bLbSOSmSOnqE0iTcH/5dxA: folds
QIWvt0R766g8KfH0vl1s0A: calls $1
*** RIVER *** [7h 3h Kd 9c] [7d]
qheQay5YvP2DMAb3OUSxtw has returned
ccFf7Q4z1cTGQmeoYiWEfw: checks
QIWvt0R766g8KfH0vl1s0A: checks
*** SHOW DOWN ***
ccFf7Q4z1cTGQmeoYiWEfw: shows [Jh Qd] (a pair of Sevens)
QIWvt0R766g8KfH0vl1s0A: shows [2s 2c] (two pair, Sevens and Deuces)
QIWvt0R766g8KfH0vl1s0A collected $4.80 from pot
*** SUMMARY ***
Total pot $5 | Rake $0.20
Board [7h 3h Kd 9c 7d]
Seat 1: TZcz9MEWDA+WydgGruqqbw folded before Flop (didn't bet)
Seat 2: FL3MrLspcF23LYvC4ipBOA folded before Flop (didn't bet)
Seat 3: qN483QJ1NvHbdIZB7J4ARw (button) folded before Flop (didn't bet)
Seat 6: ccFf7Q4z1cTGQmeoYiWEfw (small blind) showed [Jh Qd] and lost with a pair of Sevens
Seat 7: bLbSOSmSOnqE0iTcH/5dxA (big blind) folded on the Turn
Seat 8: QIWvt0R766g8KfH0vl1s0A showed [2s 2c] and won ($4.80) with two pair, Sevens and Deuces
Seat 9: knewtTmBc4Tc0z/5tAABYQ folded before Flop (didn't bet)



PokerStars Game #59939073442:  Hold'em No Limit ($0.50/$1.00) - 2009/07/01 0:30:40 ET
Table 'eU3bWpDDg3Z+9R4m4iVmog' 6-max Seat #5 is the button
Seat 1: TSuRyAHnUPCFjP7Z0rEE0w ($165.60 in chips)
Seat 2: 8CAoOzhmB8n3nRFf3V4BTg ($125.95 in chips)
Seat 3: U6tnjwZRpTnM+YkqkCjwyQ ($175.65 in chips)
Seat 4: GDVIsbEJ/DOJsMKE4Asz0A ($101.25 in chips)
Seat 5: QHvTZcrKe6+maWUfVjP29Q ($102 in chips)
Seat 6: hpxXcmRkXXI9HE5+5/j/0Q ($100.50 in chips)
hpxXcmRkXXI9HE5+5/j/0Q: posts small blind $0.50
TSuRyAHnUPCFjP7Z0rEE0w: posts big blind $1
*** HOLE CARDS ***
8CAoOzhmB8n3nRFf3V4BTg: folds
U6tnjwZRpTnM+YkqkCjwyQ: folds
GDVIsbEJ/DOJsMKE4Asz0A: folds
QHvTZcrKe6+maWUfVjP29Q: raises $2 to $3
hpxXcmRkXXI9HE5+5/j/0Q: folds
TSuRyAHnUPCFjP7Z0rEE0w: folds
QHvTZcrKe6+maWUfVjP29Q collected $2.50 from pot
QHvTZcrKe6+maWUfVjP29Q: doesn't show hand
*** SUMMARY ***
Total pot $2.50 | Rake $0
Seat 1: TSuRyAHnUPCFjP7Z0rEE0w (big blind) folded before Flop
Seat 2: 8CAoOzhmB8n3nRFf3V4BTg folded before Flop (didn't bet)
Seat 3: U6tnjwZRpTnM+YkqkCjwyQ folded before Flop (didn't bet)
Seat 4: GDVIsbEJ/DOJsMKE4Asz0A folded before Flop (didn't bet)
Seat 5: QHvTZcrKe6+maWUfVjP29Q (button) collected ($2.50)
Seat 6: hpxXcmRkXXI9HE5+5/j/0Q (small blind) folded before Flop



PokerStars Game #59939073444:  Hold'em No Limit ($0.50/$1.00) - 2009/07/01 0:30:40 ET
Table '21a4iYFKcuezM4nYx8DWTA' 2-max Seat #2 is the button
Seat 1: NYi6JFscYNrofSXy4sM+Yw ($100 in chips)
Seat 2: +sy/nlNI20yZraIjs4AALg ($100.70 in chips)
+sy/nlNI20yZraIjs4AALg: posts small blind $0.50
NYi6JFscYNrofSXy4sM+Yw: posts big blind $1
*** HOLE CARDS ***
+sy/nlNI20yZraIjs4AALg: calls $0.50
NYi6JFscYNrofSXy4sM+Yw: raises $4 to $5
+sy/nlNI20yZraIjs4AALg: calls $4
*** FLOP *** [Ts 2d 2h]
NYi6JFscYNrofSXy4sM+Yw: bets $6
+sy/nlNI20yZraIjs4AALg: folds
NYi6JFscYNrofSXy4sM+Yw collected $9.50 from pot
*** SUMMARY ***
Total pot $10 | Rake $0.50
Board [Ts 2d 2h]
Seat 1: NYi6JFscYNrofSXy4sM+Yw (big blind) collected ($9.50)
Seat 2: +sy/nlNI20yZraIjs4AALg (button) (small blind) folded on the Flop



PokerStars Game #59939074460:  Hold'em No Limit ($0.50/$1.00) - 2009/07/01 0:30:41 ET
Table '7Nl0ffnjeK44/vmeexh3MQ' 9-max Seat #9 is the button
Seat 1: s7D3Y+k4Cj4D1cXHv7oj+Q ($100.45 in chips)
Seat 2: kiakSwxX0e64PwYGAPQvLw ($31.85 in chips)
Seat 3: vR4IO10geOgvTW+LAUBv/A ($100 in chips)
Seat 5: bL+QVeDcuEdzMGAGg2XJHg ($108.40 in chips)
Seat 6: FVs16t7GgfWgQWt4JxsObQ ($12.40 in chips)
Seat 7: knewtTmBc4Tc0z/5tAABYQ ($105 in chips)
Seat 8: zanka7aAZkigmZpfopXxxA ($229.20 in chips)
Seat 9: ouwUBGRKnKK9uhn1G4Lf+A ($97 in chips)
s7D3Y+k4Cj4D1cXHv7oj+Q: posts small blind $0.50
kiakSwxX0e64PwYGAPQvLw: posts big blind $1
bLbSOSmSOnqE0iTcH/5dxA: sits out
*** HOLE CARDS ***
vR4IO10geOgvTW+LAUBv/A: folds
bL+QVeDcuEdzMGAGg2XJHg: folds
FVs16t7GgfWgQWt4JxsObQ: folds
knewtTmBc4Tc0z/5tAABYQ: folds
zanka7aAZkigmZpfopXxxA: folds
ouwUBGRKnKK9uhn1G4Lf+A: folds
s7D3Y+k4Cj4D1cXHv7oj+Q: calls $0.50
kiakSwxX0e64PwYGAPQvLw: raises $3 to $4
s7D3Y+k4Cj4D1cXHv7oj+Q: folds
kiakSwxX0e64PwYGAPQvLw collected $2 from pot
*** SUMMARY ***
Total pot $2 | Rake $0
Seat 1: s7D3Y+k4Cj4D1cXHv7oj+Q (small blind) folded before Flop
Seat 2: kiakSwxX0e64PwYGAPQvLw (big blind) collected ($2)
Seat 3: vR4IO10geOgvTW+LAUBv/A folded before Flop (didn't bet)
Seat 5: bL+QVeDcuEdzMGAGg2XJHg folded before Flop (didn't bet)
Seat 6: FVs16t7GgfWgQWt4JxsObQ folded before Flop (didn't bet)
Seat 7: knewtTmBc4Tc0z/5tAABYQ folded before Flop (didn't bet)
Seat 8: zanka7aAZkigmZpfopXxxA folded before Flop (didn't bet)
Seat 9: ouwUBGRKnKK9uhn1G4Lf+A (button) folded before Flop (didn't bet)



PokerStars Game #59939075652:  Hold'em No Limit ($0.50/$1.00) - 2009/07/01 0:30:43 ET
Table 'VOs36P6NW+QyXeQ1B62kmA' 6-max Seat #1 is the button
Seat 1: AdLVjddOzm+sRNo1Bc3S6Q ($139.65 in chips)
Seat 2: KpnW5CcJ4Mg6MeclfKmLrw ($113.80 in chips)
Seat 3: TSuRyAHnUPCFjP7Z0rEE0w ($102.55 in chips)
Seat 4: w02zQzNydODiyV9THKgo9w ($29.65 in chips)
Seat 5: X7GlkHF+lkbarCLuZ4Uf0w ($21 in chips)
Seat 6: 6tvjsJrdmWg+g7FVrMnzXA ($70.10 in chips)
KpnW5CcJ4Mg6MeclfKmLrw: posts small blind $0.50
TSuRyAHnUPCFjP7Z0rEE0w: posts big blind $1
*** HOLE CARDS ***
w02zQzNydODiyV9THKgo9w: calls $1
X7GlkHF+lkbarCLuZ4Uf0w: folds
6tvjsJrdmWg+g7FVrMnzXA: calls $1
AdLVjddOzm+sRNo1Bc3S6Q: folds
KpnW5CcJ4Mg6MeclfKmLrw: folds
TSuRyAHnUPCFjP7Z0rEE0w: checks
*** FLOP *** [6c 6s Jh]
TSuRyAHnUPCFjP7Z0rEE0w: checks
w02zQzNydODiyV9THKgo9w: checks
6tvjsJrdmWg+g7FVrMnzXA: checks
*** TURN *** [6c 6s Jh] [Qs]
TSuRyAHnUPCFjP7Z0rEE0w: checks
w02zQzNydODiyV9THKgo9w: checks
6tvjsJrdmWg+g7FVrMnzXA: checks
*** RIVER *** [6c 6s Jh Qs] [8s]
TSuRyAHnUPCFjP7Z0rEE0w: checks
w02zQzNydODiyV9THKgo9w: checks
6tvjsJrdmWg+g7FVrMnzXA: checks
*** SHOW DOWN ***
TSuRyAHnUPCFjP7Z0rEE0w: shows [5d Js] (two pair, Jacks and Sixes)
w02zQzNydODiyV9THKgo9w: mucks hand
6tvjsJrdmWg+g7FVrMnzXA: mucks hand
TSuRyAHnUPCFjP7Z0rEE0w collected $3.35 from pot
*** SUMMARY ***
Total pot $3.50 | Rake $0.15
Board [6c 6s Jh Qs 8s]
Seat 1: AdLVjddOzm+sRNo1Bc3S6Q (button) folded before Flop (didn't bet)
Seat 2: KpnW5CcJ4Mg6MeclfKmLrw (small blind) folded before Flop
Seat 3: TSuRyAHnUPCFjP7Z0rEE0w (big blind) showed [5d Js] and won ($3.35) with two pair, Jacks and Sixes
Seat 4: w02zQzNydODiyV9THKgo9w mucked
Seat 5: X7GlkHF+lkbarCLuZ4Uf0w folded before Flop (didn't bet)
Seat 6: 6tvjsJrdmWg+g7FVrMnzXA mucked



PokerStars Game #59939077046:  Hold'em No Limit ($0.50/$1.00) - 2009/07/01 0:30:45 ET
Table 'cBDNutyLBKEk9+ptwsKmTw' 6-max Seat #4 is the button
Seat 1: xAU6q2/cwmby2sxmA8VcmA ($101 in chips)
Seat 2: Gy1fd4JyD1aNBFFlOGzbJQ ($19 in chips)
Seat 3: G5ZSSN6RSON3gkNvk/SmYg ($111.90 in chips)
Seat 4: 0WjiuIT7/EolY1oOx1ngeA ($103.15 in chips)
Seat 5: OGMLOcTNYZXZU81au7ztUw ($119.25 in chips)
Seat 6: NqVlOSH2lp+pp/TK3vvK5g ($50 in chips)
OGMLOcTNYZXZU81au7ztUw: posts small blind $0.50
NqVlOSH2lp+pp/TK3vvK5g: posts big blind $1
*** HOLE CARDS ***
xAU6q2/cwmby2sxmA8VcmA: folds
Gy1fd4JyD1aNBFFlOGzbJQ: raises $2 to $3
G5ZSSN6RSON3gkNvk/SmYg: folds
0WjiuIT7/EolY1oOx1ngeA: folds
OGMLOcTNYZXZU81au7ztUw: folds
NqVlOSH2lp+pp/TK3vvK5g: folds
Gy1fd4JyD1aNBFFlOGzbJQ collected $2.50 from pot
*** SUMMARY ***
Total pot $2.50 | Rake $0
Seat 1: xAU6q2/cwmby2sxmA8VcmA folded before Flop (didn't bet)
Seat 2: Gy1fd4JyD1aNBFFlOGzbJQ collected ($2.50)
Seat 3: G5ZSSN6RSON3gkNvk/SmYg folded before Flop (didn't bet)
Seat 4: 0WjiuIT7/EolY1oOx1ngeA (button) folded before Flop (didn't bet)
Seat 5: OGMLOcTNYZXZU81au7ztUw (small blind) folded before Flop
Seat 6: NqVlOSH2lp+pp/TK3vvK5g (big blind) folded before Flop



PokerStars Game #59939077916:  Hold'em No Limit ($0.50/$1.00) - 2009/07/01 0:30:46 ET
Table '6YvsYDPNIDx2v5z3bJnwZQ' 9-max Seat #2 is the button
Seat 1: Ogn4JDV3mp4ZDKO49IFzKA ($15.50 in chips)
Seat 2: 35DmRulmD2MgzT6Bbt6/2w ($34.10 in chips)
Seat 3: negfosHnGOZXSHpWDRKyBQ ($17.30 in chips)
Seat 4: kEr5NYB+JIG5+szcYMr6hA ($46.50 in chips)
Seat 5: mBRWbnUl8diyBO1qTJaNzw ($162.20 in chips)
Seat 6: uMPEfCcGCfsxmy53tVUMug ($106.40 in chips)
Seat 7: boixc27eqTYA1p0tUdMuBQ ($114 in chips)
Seat 8: PSFxpXgPedVZyHSu2Zhb7Q ($63.75 in chips)
Seat 9: jDwhY1kCdc6EkAHbT7PJMQ ($105.60 in chips)
negfosHnGOZXSHpWDRKyBQ: posts small blind $0.50
kEr5NYB+JIG5+szcYMr6hA: posts big blind $1
*** HOLE CARDS ***
mBRWbnUl8diyBO1qTJaNzw: folds
uMPEfCcGCfsxmy53tVUMug: folds
boixc27eqTYA1p0tUdMuBQ: folds
PSFxpXgPedVZyHSu2Zhb7Q: folds
jDwhY1kCdc6EkAHbT7PJMQ: folds
Ogn4JDV3mp4ZDKO49IFzKA: calls $1
35DmRulmD2MgzT6Bbt6/2w: folds
negfosHnGOZXSHpWDRKyBQ: raises $4 to $5
kEr5NYB+JIG5+szcYMr6hA: folds
Ogn4JDV3mp4ZDKO49IFzKA: folds
negfosHnGOZXSHpWDRKyBQ collected $3 from pot
negfosHnGOZXSHpWDRKyBQ: doesn't show hand
*** SUMMARY ***
Total pot $3 | Rake $0
Seat 1: Ogn4JDV3mp4ZDKO49IFzKA folded before Flop
Seat 2: 35DmRulmD2MgzT6Bbt6/2w (button) folded before Flop (didn't bet)
Seat 3: negfosHnGOZXSHpWDRKyBQ (small blind) collected ($3)
Seat 4: kEr5NYB+JIG5+szcYMr6hA (big blind) folded before Flop
Seat 5: mBRWbnUl8diyBO1qTJaNzw folded before Flop (didn't bet)
Seat 6: uMPEfCcGCfsxmy53tVUMug folded before Flop (didn't bet)
Seat 7: boixc27eqTYA1p0tUdMuBQ folded before Flop (didn't bet)
Seat 8: PSFxpXgPedVZyHSu2Zhb7Q folded before Flop (didn't bet)
Seat 9: jDwhY1kCdc6EkAHbT7PJMQ folded before Flop (didn't bet)



PokerStars Game #59939079212:  Hold'em No Limit ($0.50/$1.00) - 2009/07/01 0:30:49 ET
Table '+cA8mcmhaedZ7YcrDdhmeQ' 6-max Seat #4 is the button
Seat 1: lsLuWlcPA3Rh7kJVLzMh0Q ($307.25 in chips)
Seat 2: trnpu4tPju3BU8W0wQQaiQ ($101.45 in chips)
Seat 3: 0WjiuIT7/EolY1oOx1ngeA ($116.30 in chips)
Seat 4: LjL3AIERHn559yyW1mTUYQ ($98.50 in chips)
Seat 5: 6WyjEXOToimYmtLdqIgHYQ ($59 in chips)
Seat 6: YfsTQsY/fxb+YqbdclTHuw ($40 in chips)
6WyjEXOToimYmtLdqIgHYQ: posts small blind $0.50
YfsTQsY/fxb+YqbdclTHuw: posts big blind $1
*** HOLE CARDS ***
lsLuWlcPA3Rh7kJVLzMh0Q: raises $3 to $4
trnpu4tPju3BU8W0wQQaiQ: folds
0WjiuIT7/EolY1oOx1ngeA: folds
LjL3AIERHn559yyW1mTUYQ: folds
6WyjEXOToimYmtLdqIgHYQ: folds
YfsTQsY/fxb+YqbdclTHuw: folds
lsLuWlcPA3Rh7kJVLzMh0Q collected $2.50 from pot
*** SUMMARY ***
Total pot $2.50 | Rake $0
Seat 1: lsLuWlcPA3Rh7kJVLzMh0Q collected ($2.50)
Seat 2: trnpu4tPju3BU8W0wQQaiQ folded before Flop (didn't bet)
Seat 3: 0WjiuIT7/EolY1oOx1ngeA folded before Flop (didn't bet)
Seat 4: LjL3AIERHn559yyW1mTUYQ (button) folded before Flop (didn't bet)
Seat 5: 6WyjEXOToimYmtLdqIgHYQ (small blind) folded before Flop
Seat 6: YfsTQsY/fxb+YqbdclTHuw (big blind) folded before Flop



PokerStars Game #59939079910:  Hold'em No Limit ($0.50/$1.00) - 2009/07/01 0:30:50 ET
Table 'tyUh+jyNvrceIQdKMJjQ2wZFWj23PMihdwrNWv41OG/Qeat #2 is the button
Seat 2: 6iVcnPw9a2oNG6sPQo3G6g ($191.50 in chips)
Seat 3: L9qfLYXrczhAPd/VckgsWw ($36.60 in chips)
Seat 4: TSuRyAHnUPCFjP7Z0rEE0w ($119.45 in chips)
Seat 5: j7NIOHLZk7V2o9fOioO5ug ($119.60 in chips)
Seat 6: YsLQ3BAvgQHWXMAv3Wv6Hg ($101.50 in chips)
L9qfLYXrczhAPd/VckgsWw: posts small blind $0.50
TSuRyAHnUPCFjP7Z0rEE0w: posts big blind $1
*** HOLE CARDS ***
o8A5MUdudVKu+pAwgZOX2w is disconnected
j7NIOHLZk7V2o9fOioO5ug: folds
YsLQ3BAvgQHWXMAv3Wv6Hg: raises $3 to $4
6iVcnPw9a2oNG6sPQo3G6g: folds
L9qfLYXrczhAPd/VckgsWw: calls $3.50
TSuRyAHnUPCFjP7Z0rEE0w: folds
*** FLOP *** [6d Qc Ah]
L9qfLYXrczhAPd/VckgsWw: bets $5
YsLQ3BAvgQHWXMAv3Wv6Hg: calls $5
*** TURN *** [6d Qc Ah] [6s]
L9qfLYXrczhAPd/VckgsWw: checks
YsLQ3BAvgQHWXMAv3Wv6Hg: checks
*** RIVER *** [6d Qc Ah 6s] [7c]
L9qfLYXrczhAPd/VckgsWw: bets $27.60 and is all-in
YsLQ3BAvgQHWXMAv3Wv6Hg: calls $27.60
*** SHOW DOWN ***
L9qfLYXrczhAPd/VckgsWw: shows [9c Kc] (a pair of Sixes)
YsLQ3BAvgQHWXMAv3Wv6Hg: shows [Js As] (two pair, Aces and Sixes)
YsLQ3BAvgQHWXMAv3Wv6Hg collected $72.20 from pot
*** SUMMARY ***
Total pot $74.20 | Rake $2
Board [6d Qc Ah 6s 7c]
Seat 2: 6iVcnPw9a2oNG6sPQo3G6g (button) folded before Flop (didn't bet)
Seat 3: L9qfLYXrczhAPd/VckgsWw (small blind) showed [9c Kc] and lost with a pair of Sixes
Seat 4: TSuRyAHnUPCFjP7Z0rEE0w (big blind) folded before Flop
Seat 5: j7NIOHLZk7V2o9fOioO5ug folded before Flop (didn't bet)
Seat 6: YsLQ3BAvgQHWXMAv3Wv6Hg showed [Js As] and won ($72.20) with two pair, Aces and Sixes



PokerStars Game #59939082302:  Hold'em No Limit ($0.50/$1.00) - 2009/07/01 0:30:53 ET
Table 'QBLDswtHe7Ml0HwAdcMhlw' 2-max Seat #2 is the button
Seat 1: hdNlhiCwI533uwvvTTfC9Q ($102.70 in chips)
Seat 2: rAtTyvrJ8f1LaUh2O5U4nA ($24 in chips)
rAtTyvrJ8f1LaUh2O5U4nA: posts small blind $0.50
hdNlhiCwI533uwvvTTfC9Q: posts big blind $1
*** HOLE CARDS ***
rAtTyvrJ8f1LaUh2O5U4nA: raises $4 to $5
hdNlhiCwI533uwvvTTfC9Q: folds
rAtTyvrJ8f1LaUh2O5U4nA collected $2 from pot
rAtTyvrJ8f1LaUh2O5U4nA: doesn't show hand
*** SUMMARY ***
Total pot $2 | Rake $0
Seat 1: hdNlhiCwI533uwvvTTfC9Q (big blind) folded before Flop
Seat 2: rAtTyvrJ8f1LaUh2O5U4nA (button) (small blind) collected ($2)



PokerStars Game #59939082600:  Hold'em No Limit ($0.50/$1.00) - 2009/07/01 0:30:54 ET
Table 'tLrtq7gDzxEvckNAI1OS5Q' 6-max Seat #2 is the button
Seat 1: GisIe1kcC9q/xV6ifsTjgA ($162.10 in chips)
Seat 2: QHvTZcrKe6+maWUfVjP29Q ($100 in chips)
Seat 4: KOG8rG51mOvIoY96zF3kvw ($162.30 in chips)
Seat 5: OGMLOcTNYZXZU81au7ztUw ($166.45 in chips)
Seat 6: XUk5GQsfNFpHvaToDZ0rZA ($49.25 in chips)
KOG8rG51mOvIoY96zF3kvw: posts small blind $0.50
OGMLOcTNYZXZU81au7ztUw: posts big blind $1
*** HOLE CARDS ***
XUk5GQsfNFpHvaToDZ0rZA: folds
GisIe1kcC9q/xV6ifsTjgA: folds
QHvTZcrKe6+maWUfVjP29Q: raises $2 to $3
KOG8rG51mOvIoY96zF3kvw: folds
OGMLOcTNYZXZU81au7ztUw: folds
QHvTZcrKe6+maWUfVjP29Q collected $2.50 from pot
QHvTZcrKe6+maWUfVjP29Q: doesn't show hand
*** SUMMARY ***
Total pot $2.50 | Rake $0
Seat 1: GisIe1kcC9q/xV6ifsTjgA folded before Flop (didn't bet)
Seat 2: QHvTZcrKe6+maWUfVjP29Q (button) collected ($2.50)
Seat 4: KOG8rG51mOvIoY96zF3kvw (small blind) folded before Flop
Seat 5: OGMLOcTNYZXZU81au7ztUw (big blind) folded before Flop
Seat 6: XUk5GQsfNFpHvaToDZ0rZA folded before Flop (didn't bet)



PokerStars Game #59939084686:  Hold'em No Limit ($0.50/$1.00) - 2009/07/01 0:30:57 ET
Table 'hugOjcwJvzEwZbK7tyiWuQ' 9-max Seat #2 is the button
Seat 1: N9n5Wc3s35DpCrOAUUNAaQ ($122.85 in chips)
Seat 2: r27C1nIV4NS4+qbnrgBQSw ($257.05 in chips)
Seat 3: jDwhY1kCdc6EkAHbT7PJMQ ($110.25 in chips)
Seat 4: UWB3oeddt/GObx2Mix2Anw ($201.30 in chips)
Seat 6: gUUvmqdVlmvpal6B8nYrmg ($100 in chips)
Seat 7: FL3MrLspcF23LYvC4ipBOA ($101.50 in chips)
Seat 8: /zy+DB4S5fUQUSfZWFzYGw ($113.25 in chips)
Seat 9: o6JyUkbzCDw8tUabqtmnlg ($57.60 in chips)
jDwhY1kCdc6EkAHbT7PJMQ: posts small blind $0.50
UWB3oeddt/GObx2Mix2Anw: posts big blind $1
*** HOLE CARDS ***
gUUvmqdVlmvpal6B8nYrmg: folds
FL3MrLspcF23LYvC4ipBOA: folds
/zy+DB4S5fUQUSfZWFzYGw: folds
o6JyUkbzCDw8tUabqtmnlg: folds
N9n5Wc3s35DpCrOAUUNAaQ: raises $2 to $3
r27C1nIV4NS4+qbnrgBQSw: folds
jDwhY1kCdc6EkAHbT7PJMQ: folds
UWB3oeddt/GObx2Mix2Anw: folds
N9n5Wc3s35DpCrOAUUNAaQ collected $2.50 from pot
*** SUMMARY ***
Total pot $2.50 | Rake $0
Seat 1: N9n5Wc3s35DpCrOAUUNAaQ collected ($2.50)
Seat 2: r27C1nIV4NS4+qbnrgBQSw (button) folded before Flop (didn't bet)
Seat 3: jDwhY1kCdc6EkAHbT7PJMQ (small blind) folded before Flop
Seat 4: UWB3oeddt/GObx2Mix2Anw (big blind) folded before Flop
Seat 6: gUUvmqdVlmvpal6B8nYrmg folded before Flop (didn't bet)
Seat 7: FL3MrLspcF23LYvC4ipBOA folded before Flop (didn't bet)
Seat 8: /zy+DB4S5fUQUSfZWFzYGw folded before Flop (didn't bet)
Seat 9: o6JyUkbzCDw8tUabqtmnlg folded before Flop (didn't bet)



PokerStars Game #59939084570:  Hold'em No Limit ($0.50/$1.00) - 2009/07/01 0:30:57 ET
Table 'eU3bWpDDg3Z+9R4m4iVmog' 6-max Seat #6 is the button
Seat 1: TSuRyAHnUPCFjP7Z0rEE0w ($164.60 in chips)
Seat 2: 8CAoOzhmB8n3nRFf3V4BTg ($125.95 in chips)
Seat 3: U6tnjwZRpTnM+YkqkCjwyQ ($175.65 in chips)
Seat 4: GDVIsbEJ/DOJsMKE4Asz0A ($101.25 in chips)
Seat 5: QHvTZcrKe6+maWUfVjP29Q ($103.50 in chips)
Seat 6: hpxXcmRkXXI9HE5+5/j/0Q ($100 in chips)
TSuRyAHnUPCFjP7Z0rEE0w: posts small blind $0.50
8CAoOzhmB8n3nRFf3V4BTg: posts big blind $1
*** HOLE CARDS ***
U6tnjwZRpTnM+YkqkCjwyQ: folds
GDVIsbEJ/DOJsMKE4Asz0A: folds
QHvTZcrKe6+maWUfVjP29Q: folds
hpxXcmRkXXI9HE5+5/j/0Q: folds
TSuRyAHnUPCFjP7Z0rEE0w: folds
8CAoOzhmB8n3nRFf3V4BTg collected $1 from pot
*** SUMMARY ***
Total pot $1 | Rake $0
Seat 1: TSuRyAHnUPCFjP7Z0rEE0w (small blind) folded before Flop
Seat 2: 8CAoOzhmB8n3nRFf3V4BTg (big blind) collected ($1)
Seat 3: U6tnjwZRpTnM+YkqkCjwyQ folded before Flop (didn't bet)
Seat 4: GDVIsbEJ/DOJsMKE4Asz0A folded before Flop (didn't bet)
Seat 5: QHvTZcrKe6+maWUfVjP29Q folded before Flop (didn't bet)
Seat 6: hpxXcmRkXXI9HE5+5/j/0Q (button) folded before Flop (didn't bet)



PokerStars Game #59939088620:  Hold'em No Limit ($0.50/$1.00) - 2009/07/01 0:31:03 ET
Table 'ZFWj23PMihdwrNWv41OG/Q' 9-max Seat #8 is the button
Seat 1: yAbu2QsRPVcjPbqlf/jDxw ($100 in chips)
Seat 2: ARfmgHcEUKh68laBZy4veA ($83.75 in chips)
Seat 3: G9Fo2TZCN7HI43Po4zSN3A ($103.50 in chips)
Seat 4: PEmogYqKpuv0ozeBbXL+7Q ($40 in chips)
Seat 5: tkdBeXTJlFsZdioidNqLow ($60 in chips)
Seat 6: tjhwe1V98x2spSoUQER3HQ ($104.50 in chips)
Seat 7: wIZ377kjl2fHFGnS93o6bw ($22.45 in chips)
Seat 8: knewtTmBc4Tc0z/5tAABYQ ($109.20 in chips)
yAbu2QsRPVcjPbqlf/jDxw: posts small blind $0.50
ARfmgHcEUKh68laBZy4veA: posts big blind $1
*** HOLE CARDS ***
G9Fo2TZCN7HI43Po4zSN3A: folds
PEmogYqKpuv0ozeBbXL+7Q: folds
tkdBeXTJlFsZdioidNqLow: folds
tjhwe1V98x2spSoUQER3HQ: folds
wIZ377kjl2fHFGnS93o6bw: folds
knewtTmBc4Tc0z/5tAABYQ: raises $2 to $3
yAbu2QsRPVcjPbqlf/jDxw: folds
ARfmgHcEUKh68laBZy4veA: calls $2
*** FLOP *** [Jd 9s 5s]
ARfmgHcEUKh68laBZy4veA: checks
knewtTmBc4Tc0z/5tAABYQ: bets $5
ARfmgHcEUKh68laBZy4veA: calls $5
*** TURN *** [Jd 9s 5s] [2d]
ARfmgHcEUKh68laBZy4veA: checks
gIabaXO0Nq08nuXlf56f0w joins the table at seat #9
knewtTmBc4Tc0z/5tAABYQ: bets $12
ARfmgHcEUKh68laBZy4veA: folds
knewtTmBc4Tc0z/5tAABYQ collected $15.70 from pot
knewtTmBc4Tc0z/5tAABYQ: doesn't show hand
*** SUMMARY ***
Total pot $16.50 | Rake $0.80
Board [Jd 9s 5s 2d]
Seat 1: yAbu2QsRPVcjPbqlf/jDxw (small blind) folded before Flop
Seat 2: ARfmgHcEUKh68laBZy4veA (big blind) folded on the Turn
Seat 3: G9Fo2TZCN7HI43Po4zSN3A folded before Flop (didn't bet)
Seat 4: PEmogYqKpuv0ozeBbXL+7Q folded before Flop (didn't bet)
Seat 5: tkdBeXTJlFsZdioidNqLow folded before Flop (didn't bet)
Seat 6: tjhwe1V98x2spSoUQER3HQ folded before Flop (didn't bet)
Seat 7: wIZ377kjl2fHFGnS93o6bw folded before Flop (didn't bet)
Seat 8: knewtTmBc4Tc0z/5tAABYQ (button) collected ($15.70)



PokerStars Game #59939089460:  Hold'em No Limit ($0.50/$1.00) - 2009/07/01 0:31:04 ET
Table '/RZcOwpZpHQ+OwPwjsbnRw' 6-max Seat #3 is the button
Seat 1: Zboa6dColKGHBjLPUakZjw ($46.70 in chips)
Seat 2: dHC9PH9hdH3Ad2TD8ZxX0Q ($42.75 in chips)
Seat 3: OigyyiK+tTj1APPIAUmXDA ($72.65 in chips)
Seat 4: j7NIOHLZk7V2o9fOioO5ug ($115.60 in chips)
Seat 5: wx3sQGkVi2x9wJXuWNHPBw ($206.15 in chips)
Seat 6: XOIf9W+VAxhZqN+SYoyMKA ($249.30 in chips)
j7NIOHLZk7V2o9fOioO5ug: posts small blind $0.50
wx3sQGkVi2x9wJXuWNHPBw: posts big blind $1
*** HOLE CARDS ***
XOIf9W+VAxhZqN+SYoyMKA: folds
Zboa6dColKGHBjLPUakZjw: raises $1 to $2
dHC9PH9hdH3Ad2TD8ZxX0Q: folds
OigyyiK+tTj1APPIAUmXDA: folds
j7NIOHLZk7V2o9fOioO5ug: folds
wx3sQGkVi2x9wJXuWNHPBw: folds
Zboa6dColKGHBjLPUakZjw collected $2.50 from pot
*** SUMMARY ***
Total pot $2.50 | Rake $0
Seat 1: Zboa6dColKGHBjLPUakZjw collected ($2.50)
Seat 2: dHC9PH9hdH3Ad2TD8ZxX0Q folded before Flop (didn't bet)
Seat 3: OigyyiK+tTj1APPIAUmXDA (button) folded before Flop (didn't bet)
Seat 4: j7NIOHLZk7V2o9fOioO5ug (small blind) folded before Flop
Seat 5: wx3sQGkVi2x9wJXuWNHPBw (big blind) folded before Flop
Seat 6: XOIf9W+VAxhZqN+SYoyMKA folded before Flop (didn't bet)



PokerStars Game #59939089466:  Hold'em No Limit ($0.50/$1.00) - 2009/07/01 0:31:04 ET
Table '21a4iYFKcuezM4nYx8DWTA' 2-max Seat #1 is the button
Seat 1: NYi6JFscYNrofSXy4sM+Yw ($104.50 in chips)
Seat 2: +sy/nlNI20yZraIjs4AALg ($95.70 in chips)
NYi6JFscYNrofSXy4sM+Yw: posts small blind $0.50
+sy/nlNI20yZraIjs4AALg: posts big blind $1
*** HOLE CARDS ***
NYi6JFscYNrofSXy4sM+Yw: raises $2 to $3
+sy/nlNI20yZraIjs4AALg: raises $2 to $5
NYi6JFscYNrofSXy4sM+Yw: calls $2
*** FLOP *** [Qd Kh 5s]
+sy/nlNI20yZraIjs4AALg: bets $4
NYi6JFscYNrofSXy4sM+Yw: raises $9 to $13
+sy/nlNI20yZraIjs4AALg: calls $9
*** TURN *** [Qd Kh 5s] [6c]
+sy/nlNI20yZraIjs4AALg: bets $10
NYi6JFscYNrofSXy4sM+Yw: calls $10
*** RIVER *** [Qd Kh 5s 6c] [8d]
+sy/nlNI20yZraIjs4AALg: bets $24
NYi6JFscYNrofSXy4sM+Yw: calls $24
*** SHOW DOWN ***
+sy/nlNI20yZraIjs4AALg: shows [5h 4h] (a pair of Fives)
NYi6JFscYNrofSXy4sM+Yw: shows [9h 8h] (a pair of Eights)
NYi6JFscYNrofSXy4sM+Yw collected $103.50 from pot
*** SUMMARY ***
Total pot $104 | Rake $0.50
Board [Qd Kh 5s 6c 8d]
Seat 1: NYi6JFscYNrofSXy4sM+Yw (button) (small blind) showed [9h 8h] and won ($103.50) with a pair of Eights
Seat 2: +sy/nlNI20yZraIjs4AALg (big blind) showed [5h 4h] and lost with a pair of Fives



PokerStars Game #59939090606:  Hold'em No Limit ($0.50/$1.00) - 2009/07/01 0:31:05 ET
Table 'QBLDswtHe7Ml0HwAdcMhlw' 2-max Seat #1 is the button
Seat 1: hdNlhiCwI533uwvvTTfC9Q ($101.70 in chips)
Seat 2: rAtTyvrJ8f1LaUh2O5U4nA ($25 in chips)
hdNlhiCwI533uwvvTTfC9Q: posts small blind $0.50
rAtTyvrJ8f1LaUh2O5U4nA: posts big blind $1
*** HOLE CARDS ***
hdNlhiCwI533uwvvTTfC9Q: raises $2 to $3
rAtTyvrJ8f1LaUh2O5U4nA: raises $4 to $7
hdNlhiCwI533uwvvTTfC9Q: folds
rAtTyvrJ8f1LaUh2O5U4nA collected $6 from pot
rAtTyvrJ8f1LaUh2O5U4nA: doesn't show hand
*** SUMMARY ***
Total pot $6 | Rake $0
Seat 1: hdNlhiCwI533uwvvTTfC9Q (button) (small blind) folded before Flop
Seat 2: rAtTyvrJ8f1LaUh2O5U4nA (big blind) collected ($6)



PokerStars Game #59939090310:  Hold'em No Limit ($0.50/$1.00) - 2009/07/01 0:31:05 ET
Table 'mmbQQVBTrPdE+wy+s+9VPA' 6-max Seat #1 is the button
Seat 1: xAU6q2/cwmby2sxmA8VcmA ($117.70 in chips)
Seat 3: wx3sQGkVi2x9wJXuWNHPBw ($109.15 in chips)
Seat 4: RfKnhkJN8HEAuzJpH2Ajdg ($22.35 in chips)
Seat 5: YMJG+F++3Aj6P8dAWda5fw ($100 in chips)
wx3sQGkVi2x9wJXuWNHPBw: posts small blind $0.50
RfKnhkJN8HEAuzJpH2Ajdg: posts big blind $1
*** HOLE CARDS ***
YMJG+F++3Aj6P8dAWda5fw: folds
xAU6q2/cwmby2sxmA8VcmA: raises $3 to $4
wx3sQGkVi2x9wJXuWNHPBw: folds
RfKnhkJN8HEAuzJpH2Ajdg: raises $18.35 to $22.35 and is all-in
xAU6q2/cwmby2sxmA8VcmA: folds
RfKnhkJN8HEAuzJpH2Ajdg collected $8.50 from pot
*** SUMMARY ***
Total pot $8.50 | Rake $0
Seat 1: xAU6q2/cwmby2sxmA8VcmA (button) folded before Flop
Seat 3: wx3sQGkVi2x9wJXuWNHPBw (small blind) folded before Flop
Seat 4: RfKnhkJN8HEAuzJpH2Ajdg (big blind) collected ($8.50)
Seat 5: YMJG+F++3Aj6P8dAWda5fw folded before Flop (didn't bet)



PokerStars Game #59939090070:  Hold'em No Limit ($0.50/$1.00) - 2009/07/01 0:31:05 ET
Table '8jIjWCPY0NGprquL+xcMFg' 9-max Seat #5 is the button
Seat 1: vR4IO10geOgvTW+LAUBv/A ($137.80 in chips)
Seat 2: rR1qGAf9Q9RYorKYWH3VKw ($5.15 in chips)
Seat 3: 58zdeSBSuSFX/qZfhc7YmA ($108.45 in chips)
Seat 4: by0z+YmujwI6Bf4qRFE8vA ($148.45 in chips)
Seat 5: n758Yw8Hx2S+6NQUPGqcqA ($87 in chips)
Seat 6: GTQkFJtSkbVbnGCktp6e3g ($100 in chips)
Seat 7: O3CGPwwUmamrCNHccOilrg ($46.15 in chips)
Seat 8: 9swGhtpERPngKPtvpoZkoQ ($151.80 in chips)
Seat 9: negfosHnGOZXSHpWDRKyBQ ($18.50 in chips)
GTQkFJtSkbVbnGCktp6e3g: posts small blind $0.50
O3CGPwwUmamrCNHccOilrg: posts big blind $1
*** HOLE CARDS ***
9swGhtpERPngKPtvpoZkoQ: folds
negfosHnGOZXSHpWDRKyBQ: folds
vR4IO10geOgvTW+LAUBv/A: folds
rR1qGAf9Q9RYorKYWH3VKw: folds
58zdeSBSuSFX/qZfhc7YmA: folds
by0z+YmujwI6Bf4qRFE8vA: calls $1
n758Yw8Hx2S+6NQUPGqcqA: folds
GTQkFJtSkbVbnGCktp6e3g: calls $0.50
O3CGPwwUmamrCNHccOilrg: checks
*** FLOP *** [Js 6d Qd]
GTQkFJtSkbVbnGCktp6e3g: checks
O3CGPwwUmamrCNHccOilrg: checks
by0z+YmujwI6Bf4qRFE8vA: checks
*** TURN *** [Js 6d Qd] [6s]
GTQkFJtSkbVbnGCktp6e3g: checks
O3CGPwwUmamrCNHccOilrg: checks
by0z+YmujwI6Bf4qRFE8vA: checks
*** RIVER *** [Js 6d Qd 6s] [5d]
GTQkFJtSkbVbnGCktp6e3g: checks
O3CGPwwUmamrCNHccOilrg: bets $2
by0z+YmujwI6Bf4qRFE8vA: folds
GTQkFJtSkbVbnGCktp6e3g: folds
O3CGPwwUmamrCNHccOilrg collected $2.85 from pot
O3CGPwwUmamrCNHccOilrg: doesn't show hand
*** SUMMARY ***
Total pot $3 | Rake $0.15
Board [Js 6d Qd 6s 5d]
Seat 1: vR4IO10geOgvTW+LAUBv/A folded before Flop (didn't bet)
Seat 2: rR1qGAf9Q9RYorKYWH3VKw folded before Flop (didn't bet)
Seat 3: 58zdeSBSuSFX/qZfhc7YmA folded before Flop (didn't bet)
Seat 4: by0z+YmujwI6Bf4qRFE8vA folded on the River
Seat 5: n758Yw8Hx2S+6NQUPGqcqA (button) folded before Flop (didn't bet)
Seat 6: GTQkFJtSkbVbnGCktp6e3g (small blind) folded on the River
Seat 7: O3CGPwwUmamrCNHccOilrg (big blind) collected ($2.85)
Seat 8: 9swGhtpERPngKPtvpoZkoQ folded before Flop (didn't bet)
Seat 9: negfosHnGOZXSHpWDRKyBQ folded before Flop (didn't bet)



PokerStars Game #59939090208:  Hold'em No Limit ($0.50/$1.00) - 2009/07/01 0:31:05 ET
Table 'kS0cTQAEi+fdUlJP2gQYvw' 9-max Seat #8 is the button
Seat 1: c/9X4zftzphFxYtxp5kp9w ($40.90 in chips)
Seat 2: 4SFNYndzMeslixOnF4koZQ ($53.05 in chips)
Seat 3: 3obndzTJ6fECz8+wWhMd1w ($19.50 in chips)
Seat 4: TZcz9MEWDA+WydgGruqqbw ($100 in chips)
Seat 5: 2rxrMrE7koO2BNxvop/0+g ($51.55 in chips)
Seat 6: yAbu2QsRPVcjPbqlf/jDxw ($100 in chips)
Seat 7: Ffa7Nj4X5fddtROP01hfQg ($110.80 in chips)
Seat 8: qTymj6ZQ8ZoFi6fINJZb3w ($80.50 in chips)
Seat 9: y8Qb94e81yI/g0saQ6gU5g ($83.75 in chips)
y8Qb94e81yI/g0saQ6gU5g: posts small blind $0.50
c/9X4zftzphFxYtxp5kp9w: posts big blind $1
*** HOLE CARDS ***
4SFNYndzMeslixOnF4koZQ: folds
3obndzTJ6fECz8+wWhMd1w: folds
TZcz9MEWDA+WydgGruqqbw: raises $2.50 to $3.50
2rxrMrE7koO2BNxvop/0+g: folds
yAbu2QsRPVcjPbqlf/jDxw: folds
Ffa7Nj4X5fddtROP01hfQg: folds
qTymj6ZQ8ZoFi6fINJZb3w: folds
y8Qb94e81yI/g0saQ6gU5g: folds
c/9X4zftzphFxYtxp5kp9w: folds
TZcz9MEWDA+WydgGruqqbw collected $2.50 from pot
TZcz9MEWDA+WydgGruqqbw: doesn't show hand
*** SUMMARY ***
Total pot $2.50 | Rake $0
Seat 1: c/9X4zftzphFxYtxp5kp9w (big blind) folded before Flop
Seat 2: 4SFNYndzMeslixOnF4koZQ folded before Flop (didn't bet)
Seat 3: 3obndzTJ6fECz8+wWhMd1w folded before Flop (didn't bet)
Seat 4: TZcz9MEWDA+WydgGruqqbw collected ($2.50)
Seat 5: 2rxrMrE7koO2BNxvop/0+g folded before Flop (didn't bet)
Seat 6: yAbu2QsRPVcjPbqlf/jDxw folded before Flop (didn't bet)
Seat 7: Ffa7Nj4X5fddtROP01hfQg folded before Flop (didn't bet)
Seat 8: qTymj6ZQ8ZoFi6fINJZb3w (button) folded before Flop (didn't bet)
Seat 9: y8Qb94e81yI/g0saQ6gU5g (small blind) folded before Flop



PokerStars Game #59939091070:  Hold'em No Limit ($0.50/$1.00) - 2009/07/01 0:31:06 ET
Table 'uNlePsyMIqzM691Xkrlk6Q' 9-max Seat #6 is the button
Seat 1: bLbSOSmSOnqE0iTcH/5dxA ($102.50 in chips)
Seat 2: +OqpStnt0FqbCfyHAWaLbg ($67.45 in chips)
Seat 3: h7qXkU57Bb8ZuPwMyxR8Ug ($25 in chips)
Seat 4: TZcz9MEWDA+WydgGruqqbw ($104.65 in chips)
Seat 5: gujOoLOu2j9hcY1eijNNDw ($87.60 in chips)
Seat 6: uMPEfCcGCfsxmy53tVUMug ($100 in chips)
Seat 7: w6cw9nzN7AvkkHBVVjykoQ ($46.90 in chips)
Seat 8: OsLmX3x/19szSV115TpL/Q ($46.95 in chips)
w6cw9nzN7AvkkHBVVjykoQ: posts small blind $0.50
OsLmX3x/19szSV115TpL/Q: posts big blind $1
vR4IO10geOgvTW+LAUBv/A: sits out
*** HOLE CARDS ***
bLbSOSmSOnqE0iTcH/5dxA: folds
+OqpStnt0FqbCfyHAWaLbg: folds
h7qXkU57Bb8ZuPwMyxR8Ug: calls $1
TZcz9MEWDA+WydgGruqqbw: folds
gujOoLOu2j9hcY1eijNNDw: folds
uMPEfCcGCfsxmy53tVUMug: calls $1
w6cw9nzN7AvkkHBVVjykoQ: calls $0.50
OsLmX3x/19szSV115TpL/Q: checks
*** FLOP *** [Qs 3c 7c]
w6cw9nzN7AvkkHBVVjykoQ: checks
OsLmX3x/19szSV115TpL/Q: bets $1
h7qXkU57Bb8ZuPwMyxR8Ug: calls $1
uMPEfCcGCfsxmy53tVUMug: calls $1
w6cw9nzN7AvkkHBVVjykoQ: calls $1
*** TURN *** [Qs 3c 7c] [7s]
w6cw9nzN7AvkkHBVVjykoQ: checks
OsLmX3x/19szSV115TpL/Q: bets $2
h7qXkU57Bb8ZuPwMyxR8Ug: calls $2
uMPEfCcGCfsxmy53tVUMug: raises $9 to $11
w6cw9nzN7AvkkHBVVjykoQ: folds
OsLmX3x/19szSV115TpL/Q: folds
h7qXkU57Bb8ZuPwMyxR8Ug: folds
uMPEfCcGCfsxmy53tVUMug collected $13.35 from pot
*** SUMMARY ***
Total pot $14 | Rake $0.65
Board [Qs 3c 7c 7s]
Seat 1: bLbSOSmSOnqE0iTcH/5dxA folded before Flop (didn't bet)
Seat 2: +OqpStnt0FqbCfyHAWaLbg folded before Flop (didn't bet)
Seat 3: h7qXkU57Bb8ZuPwMyxR8Ug folded on the Turn
Seat 4: TZcz9MEWDA+WydgGruqqbw folded before Flop (didn't bet)
Seat 5: gujOoLOu2j9hcY1eijNNDw folded before Flop (didn't bet)
Seat 6: uMPEfCcGCfsxmy53tVUMug (button) collected ($13.35)
Seat 7: w6cw9nzN7AvkkHBVVjykoQ (small blind) folded on the Turn
Seat 8: OsLmX3x/19szSV115TpL/Q (big blind) folded on the Turn



PokerStars Game #59939093166:  Hold'em No Limit ($0.50/$1.00) - 2009/07/01 0:31:09 ET
Table 'SQLOQoANiHscJ8AL7zffbw' 9-max Seat #5 is the button
Seat 1: jPTRd6SpCp4xqAy2XQiTOw ($101.85 in chips)
Seat 2: /zy+DB4S5fUQUSfZWFzYGw ($281.85 in chips)
Seat 3: 0eFnow7+D7veCYQ+CG9FFw ($70 in chips)
Seat 4: N9n5Wc3s35DpCrOAUUNAaQ ($94.30 in chips)
Seat 5: L9njYvloJ1NdXjP8edHEAg ($109.05 in chips)
Seat 6: p5UKaxVobvptF0ANhR/q1A ($156 in chips)
Seat 7: bJckevFOcg//s0qyMQI6sQ ($103.55 in chips)
Seat 8: 9ce+0Dl3d0BeEFIP+8HezA ($29.55 in chips)
Seat 9: qJr25HAtvv1w/7IBvjMM3g ($246.75 in chips)
p5UKaxVobvptF0ANhR/q1A: posts small blind $0.50
bJckevFOcg//s0qyMQI6sQ: posts big blind $1
*** HOLE CARDS ***
9ce+0Dl3d0BeEFIP+8HezA: folds
qJr25HAtvv1w/7IBvjMM3g: folds
jPTRd6SpCp4xqAy2XQiTOw: folds
/zy+DB4S5fUQUSfZWFzYGw: folds
0eFnow7+D7veCYQ+CG9FFw: raises $2 to $3
N9n5Wc3s35DpCrOAUUNAaQ: calls $3
L9njYvloJ1NdXjP8edHEAg: folds
p5UKaxVobvptF0ANhR/q1A: folds
bJckevFOcg//s0qyMQI6sQ: folds
*** FLOP *** [3d 3s Jh]
0eFnow7+D7veCYQ+CG9FFw: bets $5
N9n5Wc3s35DpCrOAUUNAaQ: folds
0eFnow7+D7veCYQ+CG9FFw collected $7.15 from pot
*** SUMMARY ***
Total pot $7.50 | Rake $0.35
Board [3d 3s Jh]
Seat 1: jPTRd6SpCp4xqAy2XQiTOw folded before Flop (didn't bet)
Seat 2: /zy+DB4S5fUQUSfZWFzYGw folded before Flop (didn't bet)
Seat 3: 0eFnow7+D7veCYQ+CG9FFw collected ($7.15)
Seat 4: N9n5Wc3s35DpCrOAUUNAaQ folded on the Flop
Seat 5: L9njYvloJ1NdXjP8edHEAg (button) folded before Flop (didn't bet)
Seat 6: p5UKaxVobvptF0ANhR/q1A (small blind) folded before Flop
Seat 7: bJckevFOcg//s0qyMQI6sQ (big blind) folded before Flop
Seat 8: 9ce+0Dl3d0BeEFIP+8HezA folded before Flop (didn't bet)
Seat 9: qJr25HAtvv1w/7IBvjMM3g folded before Flop (didn't bet)



PokerStars Game #59939093396:  Hold'em No Limit ($0.50/$1.00) - 2009/07/01 0:31:10 ET
Table 'vs/5jr6ciwjVQ5+Soc+u2A' 6-max Seat #3 is the button
Seat 2: XOIf9W+VAxhZqN+SYoyMKA ($121.15 in chips)
Seat 3: G5ZSSN6RSON3gkNvk/SmYg ($100 in chips)
Seat 4: KpnW5CcJ4Mg6MeclfKmLrw ($114.30 in chips)
Seat 5: 7Vc9JmGFQwMRh5Tj9ui5Lw ($98.15 in chips)
Seat 6: QHvTZcrKe6+maWUfVjP29Q ($101.50 in chips)
KpnW5CcJ4Mg6MeclfKmLrw: posts small blind $0.50
7Vc9JmGFQwMRh5Tj9ui5Lw: posts big blind $1
3yN2jRjZ+glIaWtGMmKOrA: sits out
*** HOLE CARDS ***
QHvTZcrKe6+maWUfVjP29Q: raises $2.50 to $3.50
XOIf9W+VAxhZqN+SYoyMKA: folds
G5ZSSN6RSON3gkNvk/SmYg: folds
KpnW5CcJ4Mg6MeclfKmLrw: folds
7Vc9JmGFQwMRh5Tj9ui5Lw: folds
QHvTZcrKe6+maWUfVjP29Q collected $2.50 from pot
QHvTZcrKe6+maWUfVjP29Q: doesn't show hand
*** SUMMARY ***
Total pot $2.50 | Rake $0
Seat 2: XOIf9W+VAxhZqN+SYoyMKA folded before Flop (didn't bet)
Seat 3: G5ZSSN6RSON3gkNvk/SmYg (button) folded before Flop (didn't bet)
Seat 4: KpnW5CcJ4Mg6MeclfKmLrw (small blind) folded before Flop
Seat 5: 7Vc9JmGFQwMRh5Tj9ui5Lw (big blind) folded before Flop
Seat 6: QHvTZcrKe6+maWUfVjP29Q collected ($2.50)



PokerStars Game #59939094648:  Hold'em No Limit ($0.50/$1.00) - 2009/07/01 0:31:11 ET
Table '+cA8mcmhaedZ7YcrDdhmeQ' 6-max Seat #5 is the button
Seat 1: lsLuWlcPA3Rh7kJVLzMh0Q ($308.75 in chips)
Seat 2: trnpu4tPju3BU8W0wQQaiQ ($101.45 in chips)
Seat 3: 0WjiuIT7/EolY1oOx1ngeA ($116.30 in chips)
Seat 4: LjL3AIERHn559yyW1mTUYQ ($98.50 in chips)
Seat 5: 6WyjEXOToimYmtLdqIgHYQ ($58.50 in chips)
Seat 6: YfsTQsY/fxb+YqbdclTHuw ($39 in chips)
YfsTQsY/fxb+YqbdclTHuw: posts small blind $0.50
lsLuWlcPA3Rh7kJVLzMh0Q: posts big blind $1
*** HOLE CARDS ***
trnpu4tPju3BU8W0wQQaiQ: folds
trnpu4tPju3BU8W0wQQaiQ is sitting out
0WjiuIT7/EolY1oOx1ngeA: folds
LjL3AIERHn559yyW1mTUYQ: folds
6WyjEXOToimYmtLdqIgHYQ: raises $2 to $3
YfsTQsY/fxb+YqbdclTHuw: folds
lsLuWlcPA3Rh7kJVLzMh0Q: folds
trnpu4tPju3BU8W0wQQaiQ leaves the table
6WyjEXOToimYmtLdqIgHYQ collected $2.50 from pot
*** SUMMARY ***
Total pot $2.50 | Rake $0
Seat 1: lsLuWlcPA3Rh7kJVLzMh0Q (big blind) folded before Flop
Seat 2: trnpu4tPju3BU8W0wQQaiQ folded before Flop (didn't bet)
Seat 3: 0WjiuIT7/EolY1oOx1ngeA folded before Flop (didn't bet)
Seat 4: LjL3AIERHn559yyW1mTUYQ folded before Flop (didn't bet)
Seat 5: 6WyjEXOToimYmtLdqIgHYQ (button) collected ($2.50)
Seat 6: YfsTQsY/fxb+YqbdclTHuw (small blind) folded before Flop



PokerStars Game #59939094078:  Hold'em No Limit ($0.50/$1.00) - 2009/07/01 0:31:11 ET
Table 'O96CPOtvMBWP6kzuYDfdFA' 6-max Seat #6 is the button
Seat 1: 6alLXQIITA2EZ/lBeym8Dw ($100 in chips)
Seat 2: sc/HX9smXU5kObrOWIYO5g ($37 in chips)
Seat 3: V89DGjxE171oPREEbAXiyg ($36.70 in chips)
Seat 4: KOG8rG51mOvIoY96zF3kvw ($162.75 in chips)
Seat 5: wRxiu9OJzvvN84OYWW9jxQ ($136.10 in chips)
Seat 6: xNKcQzD9+/iHmtJn4vYq9w ($141.65 in chips)
6alLXQIITA2EZ/lBeym8Dw: posts small blind $0.50
sc/HX9smXU5kObrOWIYO5g: posts big blind $1
*** HOLE CARDS ***
V89DGjxE171oPREEbAXiyg: folds
KOG8rG51mOvIoY96zF3kvw: folds
wRxiu9OJzvvN84OYWW9jxQ: raises $2 to $3
xNKcQzD9+/iHmtJn4vYq9w: folds
6alLXQIITA2EZ/lBeym8Dw: folds
sc/HX9smXU5kObrOWIYO5g: folds
wRxiu9OJzvvN84OYWW9jxQ collected $2.50 from pot
*** SUMMARY ***
Total pot $2.50 | Rake $0
Seat 1: 6alLXQIITA2EZ/lBeym8Dw (small blind) folded before Flop
Seat 2: sc/HX9smXU5kObrOWIYO5g (big blind) folded before Flop
Seat 3: V89DGjxE171oPREEbAXiyg folded before Flop (didn't bet)
Seat 4: KOG8rG51mOvIoY96zF3kvw folded before Flop (didn't bet)
Seat 5: wRxiu9OJzvvN84OYWW9jxQ collected ($2.50)
Seat 6: xNKcQzD9+/iHmtJn4vYq9w (button) folded before Flop (didn't bet)



PokerStars Game #59939096068:  Hold'em No Limit ($0.50/$1.00) - 2009/07/01 0:31:14 ET
Table 'cBDNutyLBKEk9+ptwsKmTw' 6-max Seat #5 is the button
Seat 1: xAU6q2/cwmby2sxmA8VcmA ($101 in chips)
Seat 2: Gy1fd4JyD1aNBFFlOGzbJQ ($20.50 in chips)
Seat 3: G5ZSSN6RSON3gkNvk/SmYg ($111.90 in chips)
Seat 4: 0WjiuIT7/EolY1oOx1ngeA ($103.15 in chips)
Seat 5: OGMLOcTNYZXZU81au7ztUw ($118.75 in chips)
Seat 6: NqVlOSH2lp+pp/TK3vvK5g ($49 in chips)
NqVlOSH2lp+pp/TK3vvK5g: posts small blind $0.50
xAU6q2/cwmby2sxmA8VcmA: posts big blind $1
*** HOLE CARDS ***
Gy1fd4JyD1aNBFFlOGzbJQ: raises $3 to $4
G5ZSSN6RSON3gkNvk/SmYg: folds
0WjiuIT7/EolY1oOx1ngeA: folds
OGMLOcTNYZXZU81au7ztUw: folds
NqVlOSH2lp+pp/TK3vvK5g: calls $3.50
xAU6q2/cwmby2sxmA8VcmA: folds
*** FLOP *** [Jd 4d 9s]
NqVlOSH2lp+pp/TK3vvK5g: checks
Gy1fd4JyD1aNBFFlOGzbJQ: checks
*** TURN *** [Jd 4d 9s] [Ts]
NqVlOSH2lp+pp/TK3vvK5g: bets $1
Gy1fd4JyD1aNBFFlOGzbJQ: calls $1
*** RIVER *** [Jd 4d 9s Ts] [Jh]
NqVlOSH2lp+pp/TK3vvK5g: checks
Gy1fd4JyD1aNBFFlOGzbJQ: bets $3
NqVlOSH2lp+pp/TK3vvK5g: calls $3
*** SHOW DOWN ***
Gy1fd4JyD1aNBFFlOGzbJQ: shows [Kc Tc] (two pair, Jacks and Tens)
NqVlOSH2lp+pp/TK3vvK5g: mucks hand
Gy1fd4JyD1aNBFFlOGzbJQ collected $16.20 from pot
*** SUMMARY ***
Total pot $17 | Rake $0.80
Board [Jd 4d 9s Ts Jh]
Seat 1: xAU6q2/cwmby2sxmA8VcmA (big blind) folded before Flop
Seat 2: Gy1fd4JyD1aNBFFlOGzbJQ showed [Kc Tc] and won ($16.20) with two pair, Jacks and Tens
Seat 3: G5ZSSN6RSON3gkNvk/SmYg folded before Flop (didn't bet)
Seat 4: 0WjiuIT7/EolY1oOx1ngeA folded before Flop (didn't bet)
Seat 5: OGMLOcTNYZXZU81au7ztUw (button) folded before Flop (didn't bet)
Seat 6: NqVlOSH2lp+pp/TK3vvK5g (small blind) mucked



PokerStars Game #59939096410:  Hold'em No Limit ($0.50/$1.00) - 2009/07/01 0:31:14 ET
Table 'fTlPiCj0utgzC/5io+I7ew' 6-max Seat #5 is the button
Seat 1: YMJG+F++3Aj6P8dAWda5fw ($100 in chips)
Seat 3: oDiBRCaF0QVtd3kO6xZIXw ($101.50 in chips)
Seat 4: uJVSceLggtsrJya+WtmUEA ($96.30 in chips)
Seat 5: bFrTkDcWGTxyvNul7GVdYg ($256.70 in chips)
Seat 6: jMljU/dOPMXfJi8OmbdYdw ($14 in chips)
jMljU/dOPMXfJi8OmbdYdw: posts small blind $0.50
YMJG+F++3Aj6P8dAWda5fw: posts big blind $1
Qy/UBNbD2HaA0Ogxg8Sf3w: sits out
*** HOLE CARDS ***
oDiBRCaF0QVtd3kO6xZIXw: folds
uJVSceLggtsrJya+WtmUEA: raises $2 to $3
bFrTkDcWGTxyvNul7GVdYg: folds
jMljU/dOPMXfJi8OmbdYdw: folds
YMJG+F++3Aj6P8dAWda5fw: folds
uJVSceLggtsrJya+WtmUEA collected $2.50 from pot
*** SUMMARY ***
Total pot $2.50 | Rake $0
Seat 1: YMJG+F++3Aj6P8dAWda5fw (big blind) folded before Flop
Seat 3: oDiBRCaF0QVtd3kO6xZIXw folded before Flop (didn't bet)
Seat 4: uJVSceLggtsrJya+WtmUEA collected ($2.50)
Seat 5: bFrTkDcWGTxyvNul7GVdYg (button) folded before Flop (didn't bet)
Seat 6: jMljU/dOPMXfJi8OmbdYdw (small blind) folded before Flop



PokerStars Game #59939096704:  Hold'em No Limit ($0.50/$1.00) - 2009/07/01 0:31:15 ET
Table 'U9zqzC8f3oTJ2ShXFgSSOA' 6-max Seat #5 is the button
Seat 1: tS9JHB1h+FQ++qu8RwRNgg ($34.60 in chips)
Seat 2: U2CWBTv29qdCbj8RNF2sIw ($106.05 in chips)
Seat 3: yfXek8iJ7O4CFyqXrtGcfg ($35.55 in chips)
Seat 4: 33q95we0Etwgrm6guQGncw ($73.65 in chips)
Seat 5: KfwW5us6tydK81NYTtK1gw ($307.05 in chips)
Seat 6: aIxzFKdtpDSkUePKZy/niQ ($37.90 in chips)
aIxzFKdtpDSkUePKZy/niQ: posts small blind $0.50
tS9JHB1h+FQ++qu8RwRNgg: posts big blind $1
*** HOLE CARDS ***
U2CWBTv29qdCbj8RNF2sIw: folds
yfXek8iJ7O4CFyqXrtGcfg: folds
33q95we0Etwgrm6guQGncw: folds
KfwW5us6tydK81NYTtK1gw: folds
aIxzFKdtpDSkUePKZy/niQ: raises $2 to $3
tS9JHB1h+FQ++qu8RwRNgg: folds
aIxzFKdtpDSkUePKZy/niQ collected $2 from pot
*** SUMMARY ***
Total pot $2 | Rake $0
Seat 1: tS9JHB1h+FQ++qu8RwRNgg (big blind) folded before Flop
Seat 2: U2CWBTv29qdCbj8RNF2sIw folded before Flop (didn't bet)
Seat 3: yfXek8iJ7O4CFyqXrtGcfg folded before Flop (didn't bet)
Seat 4: 33q95we0Etwgrm6guQGncw folded before Flop (didn't bet)
Seat 5: KfwW5us6tydK81NYTtK1gw (button) folded before Flop (didn't bet)
Seat 6: aIxzFKdtpDSkUePKZy/niQ (small blind) collected ($2)



PokerStars Game #59939097548:  Hold'em No Limit ($0.50/$1.00) - 2009/07/01 0:31:16 ET
Table 'tLrtq7gDzxEvckNAI1OS5Q' 6-max Seat #4 is the button
Seat 1: GisIe1kcC9q/xV6ifsTjgA ($162.10 in chips)
Seat 2: QHvTZcrKe6+maWUfVjP29Q ($101.50 in chips)
Seat 4: KOG8rG51mOvIoY96zF3kvw ($161.80 in chips)
Seat 5: OGMLOcTNYZXZU81au7ztUw ($165.45 in chips)
Seat 6: XUk5GQsfNFpHvaToDZ0rZA ($49.25 in chips)
OGMLOcTNYZXZU81au7ztUw: posts small blind $0.50
XUk5GQsfNFpHvaToDZ0rZA: posts big blind $1
*** HOLE CARDS ***
GisIe1kcC9q/xV6ifsTjgA: raises $3 to $4
QHvTZcrKe6+maWUfVjP29Q: folds
KOG8rG51mOvIoY96zF3kvw: folds
OGMLOcTNYZXZU81au7ztUw: folds
XUk5GQsfNFpHvaToDZ0rZA: calls $3
*** FLOP *** [Td Qc 7c]
XUk5GQsfNFpHvaToDZ0rZA: checks
GisIe1kcC9q/xV6ifsTjgA: bets $3
XUk5GQsfNFpHvaToDZ0rZA: folds
GisIe1kcC9q/xV6ifsTjgA collected $8.10 from pot
*** SUMMARY ***
Total pot $8.50 | Rake $0.40
Board [Td Qc 7c]
Seat 1: GisIe1kcC9q/xV6ifsTjgA collected ($8.10)
Seat 2: QHvTZcrKe6+maWUfVjP29Q folded before Flop (didn't bet)
Seat 4: KOG8rG51mOvIoY96zF3kvw (button) folded before Flop (didn't bet)
Seat 5: OGMLOcTNYZXZU81au7ztUw (small blind) folded before Flop
Seat 6: XUk5GQsfNFpHvaToDZ0rZA (big blind) folded on the Flop



PokerStars Game #59939099270:  Hold'em No Limit ($0.50/$1.00) - 2009/07/01 0:31:18 ET
Table 'rmZfTK+oSebeUPJNbWhdAA' 6-max Seat #2 is the button
Seat 1: xAU6q2/cwmby2sxmA8VcmA ($100 in chips)
Seat 2: OigyyiK+tTj1APPIAUmXDA ($88.05 in chips)
Seat 3: 9yjOzGERLaEZS8CZ6YNHFg ($115.90 in chips)
Seat 4: OGMLOcTNYZXZU81au7ztUw ($127.20 in chips)
Seat 5: +xW7QemQU0Fxs+4TnqBRow ($101.50 in chips)
Seat 6: j7NIOHLZk7V2o9fOioO5ug ($105.65 in chips)
9yjOzGERLaEZS8CZ6YNHFg: posts small blind $0.50
OGMLOcTNYZXZU81au7ztUw: posts big blind $1
*** HOLE CARDS ***
+xW7QemQU0Fxs+4TnqBRow: folds
j7NIOHLZk7V2o9fOioO5ug: folds
xAU6q2/cwmby2sxmA8VcmA: folds
OigyyiK+tTj1APPIAUmXDA: folds
9yjOzGERLaEZS8CZ6YNHFg: folds
OGMLOcTNYZXZU81au7ztUw collected $1 from pot
OGMLOcTNYZXZU81au7ztUw: doesn't show hand
*** SUMMARY ***
Total pot $1 | Rake $0
Seat 1: xAU6q2/cwmby2sxmA8VcmA folded before Flop (didn't bet)
Seat 2: OigyyiK+tTj1APPIAUmXDA (button) folded before Flop (didn't bet)
Seat 3: 9yjOzGERLaEZS8CZ6YNHFg (small blind) folded before Flop
Seat 4: OGMLOcTNYZXZU81au7ztUw (big blind) collected ($1)
Seat 5: +xW7QemQU0Fxs+4TnqBRow folded before Flop (didn't bet)
Seat 6: j7NIOHLZk7V2o9fOioO5ug folded before Flop (didn't bet)



PokerStars Game #59939099130:  Hold'em No Limit ($0.50/$1.00) - 2009/07/01 0:31:18 ET
Table 'QSIig7BLMc9wY/rgBechzw' 6-max Seat #1 is the button
Seat 1: uuA9hpFU17U5/t4cvpbpBg ($27.05 in chips)
Seat 2: 0WjiuIT7/EolY1oOx1ngeA ($125.25 in chips)
Seat 3: +W6OnF033KNM2xH0fGj98Q ($116.20 in chips)
Seat 4: +uSzP8Jwnw7sKfQ4s66b7w ($31.50 in chips)
Seat 5: bvU2ZjpVnszLCFVeWbxePg ($116.90 in chips)
Seat 6: KpnW5CcJ4Mg6MeclfKmLrw ($144.10 in chips)
0WjiuIT7/EolY1oOx1ngeA: posts small blind $0.50
+W6OnF033KNM2xH0fGj98Q: posts big blind $1
*** HOLE CARDS ***
+uSzP8Jwnw7sKfQ4s66b7w: folds
bvU2ZjpVnszLCFVeWbxePg: folds
KpnW5CcJ4Mg6MeclfKmLrw: raises $2 to $3
uuA9hpFU17U5/t4cvpbpBg: folds
0WjiuIT7/EolY1oOx1ngeA: folds
+W6OnF033KNM2xH0fGj98Q: calls $2
*** FLOP *** [8c 4h Ks]
+W6OnF033KNM2xH0fGj98Q: checks
KpnW5CcJ4Mg6MeclfKmLrw: bets $5
+W6OnF033KNM2xH0fGj98Q: raises $11 to $16
KpnW5CcJ4Mg6MeclfKmLrw: folds
+W6OnF033KNM2xH0fGj98Q collected $15.70 from pot
+W6OnF033KNM2xH0fGj98Q: doesn't show hand
*** SUMMARY ***
Total pot $16.50 | Rake $0.80
Board [8c 4h Ks]
Seat 1: uuA9hpFU17U5/t4cvpbpBg (button) folded before Flop (didn't bet)
Seat 2: 0WjiuIT7/EolY1oOx1ngeA (small blind) folded before Flop
Seat 3: +W6OnF033KNM2xH0fGj98Q (big blind) collected ($15.70)
Seat 4: +uSzP8Jwnw7sKfQ4s66b7w folded before Flop (didn't bet)
Seat 5: bvU2ZjpVnszLCFVeWbxePg folded before Flop (didn't bet)
Seat 6: KpnW5CcJ4Mg6MeclfKmLrw folded on the Flop



PokerStars Game #59939099420:  Hold'em No Limit ($0.50/$1.00) - 2009/07/01 0:31:18 ET
Table 'QBLDswtHe7Ml0HwAdcMhlw' 2-max Seat #2 is the button
Seat 1: hdNlhiCwI533uwvvTTfC9Q ($100 in chips)
Seat 2: rAtTyvrJ8f1LaUh2O5U4nA ($28 in chips)
rAtTyvrJ8f1LaUh2O5U4nA: posts small blind $0.50
hdNlhiCwI533uwvvTTfC9Q: posts big blind $1
*** HOLE CARDS ***
rAtTyvrJ8f1LaUh2O5U4nA: raises $2 to $3
hdNlhiCwI533uwvvTTfC9Q: calls $2
*** FLOP *** [4c 2h Jd]
hdNlhiCwI533uwvvTTfC9Q: checks
rAtTyvrJ8f1LaUh2O5U4nA: bets $3
hdNlhiCwI533uwvvTTfC9Q: folds
rAtTyvrJ8f1LaUh2O5U4nA collected $5.70 from pot
rAtTyvrJ8f1LaUh2O5U4nA: doesn't show hand
*** SUMMARY ***
Total pot $6 | Rake $0.30
Board [4c 2h Jd]
Seat 1: hdNlhiCwI533uwvvTTfC9Q (big blind) folded on the Flop
Seat 2: rAtTyvrJ8f1LaUh2O5U4nA (button) (small blind) collected ($5.70)



PokerStars Game #59939102138:  Hold'em No Limit ($0.50/$1.00) - 2009/07/01 0:31:23 ET
Table 'Zka9tv1yilg0MvXWPQrShg' 9-max Seat #9 is the button
Seat 1: TZcz9MEWDA+WydgGruqqbw ($115.85 in chips)
Seat 2: rR1qGAf9Q9RYorKYWH3VKw ($21.50 in chips)
Seat 3: gUUvmqdVlmvpal6B8nYrmg ($102.50 in chips)
Seat 4: CTOae+JLIGfwfXvhqHkP2w ($163.65 in chips)
Seat 5: /zy+DB4S5fUQUSfZWFzYGw ($136.45 in chips)
Seat 6: rY8wPoax1lS+HUY+I0FZDw ($137.65 in chips)
Seat 7: p1SafS90nb3Uft5LB0NkHw ($20 in chips)
Seat 8: bL+QVeDcuEdzMGAGg2XJHg ($123.10 in chips)
Seat 9: 6daxhj43mWj04MOPTOmaYA ($96 in chips)
TZcz9MEWDA+WydgGruqqbw: posts small blind $0.50
rR1qGAf9Q9RYorKYWH3VKw: posts big blind $1
*** HOLE CARDS ***
gUUvmqdVlmvpal6B8nYrmg: folds
CTOae+JLIGfwfXvhqHkP2w: folds
/zy+DB4S5fUQUSfZWFzYGw: folds
rY8wPoax1lS+HUY+I0FZDw: folds
p1SafS90nb3Uft5LB0NkHw: raises $2 to $3
bL+QVeDcuEdzMGAGg2XJHg: folds
6daxhj43mWj04MOPTOmaYA: folds
TZcz9MEWDA+WydgGruqqbw: folds
rR1qGAf9Q9RYorKYWH3VKw: calls $2
*** FLOP *** [3c Jh Tc]
rR1qGAf9Q9RYorKYWH3VKw: bets $4
p1SafS90nb3Uft5LB0NkHw: folds
rR1qGAf9Q9RYorKYWH3VKw collected $6.20 from pot
*** SUMMARY ***
Total pot $6.50 | Rake $0.30
Board [3c Jh Tc]
Seat 1: TZcz9MEWDA+WydgGruqqbw (small blind) folded before Flop
Seat 2: rR1qGAf9Q9RYorKYWH3VKw (big blind) collected ($6.20)
Seat 3: gUUvmqdVlmvpal6B8nYrmg folded before Flop (didn't bet)
Seat 4: CTOae+JLIGfwfXvhqHkP2w folded before Flop (didn't bet)
Seat 5: /zy+DB4S5fUQUSfZWFzYGw folded before Flop (didn't bet)
Seat 6: rY8wPoax1lS+HUY+I0FZDw folded before Flop (didn't bet)
Seat 7: p1SafS90nb3Uft5LB0NkHw folded on the Flop
Seat 8: bL+QVeDcuEdzMGAGg2XJHg folded before Flop (didn't bet)
Seat 9: 6daxhj43mWj04MOPTOmaYA (button) folded before Flop (didn't bet)



PokerStars Game #59939104720:  Hold'em No Limit ($0.50/$1.00) - 2009/07/01 0:31:26 ET
Table '/RZcOwpZpHQ+OwPwjsbnRw' 6-max Seat #4 is the button
Seat 1: Zboa6dColKGHBjLPUakZjw ($48.20 in chips)
Seat 2: dHC9PH9hdH3Ad2TD8ZxX0Q ($42.75 in chips)
Seat 3: OigyyiK+tTj1APPIAUmXDA ($72.65 in chips)
Seat 4: j7NIOHLZk7V2o9fOioO5ug ($115.10 in chips)
Seat 5: wx3sQGkVi2x9wJXuWNHPBw ($205.15 in chips)
Seat 6: XOIf9W+VAxhZqN+SYoyMKA ($249.30 in chips)
wx3sQGkVi2x9wJXuWNHPBw: posts small blind $0.50
XOIf9W+VAxhZqN+SYoyMKA: posts big blind $1
*** HOLE CARDS ***
Zboa6dColKGHBjLPUakZjw: folds
dHC9PH9hdH3Ad2TD8ZxX0Q: raises $1 to $2
OigyyiK+tTj1APPIAUmXDA: folds
j7NIOHLZk7V2o9fOioO5ug: folds
wx3sQGkVi2x9wJXuWNHPBw: folds
XOIf9W+VAxhZqN+SYoyMKA: folds
dHC9PH9hdH3Ad2TD8ZxX0Q collected $2.50 from pot
dHC9PH9hdH3Ad2TD8ZxX0Q: doesn't show hand
*** SUMMARY ***
Total pot $2.50 | Rake $0
Seat 1: Zboa6dColKGHBjLPUakZjw folded before Flop (didn't bet)
Seat 2: dHC9PH9hdH3Ad2TD8ZxX0Q collected ($2.50)
Seat 3: OigyyiK+tTj1APPIAUmXDA folded before Flop (didn't bet)
Seat 4: j7NIOHLZk7V2o9fOioO5ug (button) folded before Flop (didn't bet)
Seat 5: wx3sQGkVi2x9wJXuWNHPBw (small blind) folded before Flop
Seat 6: XOIf9W+VAxhZqN+SYoyMKA (big blind) folded before Flop



PokerStars Game #59939104758:  Hold'em No Limit ($0.50/$1.00) - 2009/07/01 0:31:26 ET
Table 'eU3bWpDDg3Z+9R4m4iVmog' 6-max Seat #1 is the button
Seat 1: TSuRyAHnUPCFjP7Z0rEE0w ($164.10 in chips)
Seat 2: 8CAoOzhmB8n3nRFf3V4BTg ($126.45 in chips)
Seat 3: U6tnjwZRpTnM+YkqkCjwyQ ($175.65 in chips)
Seat 4: GDVIsbEJ/DOJsMKE4Asz0A ($101.25 in chips)
Seat 5: QHvTZcrKe6+maWUfVjP29Q ($103.50 in chips)
Seat 6: hpxXcmRkXXI9HE5+5/j/0Q ($100 in chips)
8CAoOzhmB8n3nRFf3V4BTg: posts small blind $0.50
U6tnjwZRpTnM+YkqkCjwyQ: posts big blind $1
*** HOLE CARDS ***
GDVIsbEJ/DOJsMKE4Asz0A: folds
QHvTZcrKe6+maWUfVjP29Q: folds
hpxXcmRkXXI9HE5+5/j/0Q: folds
TSuRyAHnUPCFjP7Z0rEE0w: raises $3 to $4
8CAoOzhmB8n3nRFf3V4BTg: folds
U6tnjwZRpTnM+YkqkCjwyQ: folds
TSuRyAHnUPCFjP7Z0rEE0w collected $2.50 from pot
TSuRyAHnUPCFjP7Z0rEE0w: doesn't show hand
*** SUMMARY ***
Total pot $2.50 | Rake $0
Seat 1: TSuRyAHnUPCFjP7Z0rEE0w (button) collected ($2.50)
Seat 2: 8CAoOzhmB8n3nRFf3V4BTg (small blind) folded before Flop
Seat 3: U6tnjwZRpTnM+YkqkCjwyQ (big blind) folded before Flop
Seat 4: GDVIsbEJ/DOJsMKE4Asz0A folded before Flop (didn't bet)
Seat 5: QHvTZcrKe6+maWUfVjP29Q folded before Flop (didn't bet)
Seat 6: hpxXcmRkXXI9HE5+5/j/0Q folded before Flop (didn't bet)



PokerStars Game #59939106386:  Hold'em No Limit ($0.50/$1.00) - 2009/07/01 0:31:29 ET
Table 'kS0cTQAEi+fdUlJP2gQYvw' 9-max Seat #9 is the button
Seat 1: c/9X4zftzphFxYtxp5kp9w ($39.90 in chips)
Seat 2: 4SFNYndzMeslixOnF4koZQ ($53.05 in chips)
Seat 3: 3obndzTJ6fECz8+wWhMd1w ($19.50 in chips)
Seat 4: TZcz9MEWDA+WydgGruqqbw ($101.50 in chips)
Seat 5: 2rxrMrE7koO2BNxvop/0+g ($51.55 in chips)
Seat 6: yAbu2QsRPVcjPbqlf/jDxw ($100 in chips)
Seat 7: Ffa7Nj4X5fddtROP01hfQg ($110.80 in chips)
Seat 8: qTymj6ZQ8ZoFi6fINJZb3w ($80.50 in chips)
Seat 9: y8Qb94e81yI/g0saQ6gU5g ($83.25 in chips)
c/9X4zftzphFxYtxp5kp9w: posts small blind $0.50
4SFNYndzMeslixOnF4koZQ: posts big blind $1
*** HOLE CARDS ***
3obndzTJ6fECz8+wWhMd1w: folds
TZcz9MEWDA+WydgGruqqbw: folds
2rxrMrE7koO2BNxvop/0+g: folds
yAbu2QsRPVcjPbqlf/jDxw: folds
Ffa7Nj4X5fddtROP01hfQg: calls $1
qTymj6ZQ8ZoFi6fINJZb3w: folds
y8Qb94e81yI/g0saQ6gU5g: raises $4 to $5
c/9X4zftzphFxYtxp5kp9w: folds
4SFNYndzMeslixOnF4koZQ: calls $4
Ffa7Nj4X5fddtROP01hfQg: folds
*** FLOP *** [Ac Jc 3h]
4SFNYndzMeslixOnF4koZQ: bets $3
y8Qb94e81yI/g0saQ6gU5g: calls $3
*** TURN *** [Ac Jc 3h] [4h]
4SFNYndzMeslixOnF4koZQ: bets $7
y8Qb94e81yI/g0saQ6gU5g: calls $7
*** RIVER *** [Ac Jc 3h 4h] [Th]
4SFNYndzMeslixOnF4koZQ: bets $13
y8Qb94e81yI/g0saQ6gU5g: calls $13
*** SHOW DOWN ***
4SFNYndzMeslixOnF4koZQ: shows [Ah 9h] (a flush, Ace high)
y8Qb94e81yI/g0saQ6gU5g: mucks hand
4SFNYndzMeslixOnF4koZQ collected $54.70 from pot
4SFNYndzMeslixOnF4koZQ is sitting out
*** SUMMARY ***
Total pot $57.50 | Rake $2.80
Board [Ac Jc 3h 4h Th]
Seat 1: c/9X4zftzphFxYtxp5kp9w (small blind) folded before Flop
Seat 2: 4SFNYndzMeslixOnF4koZQ (big blind) showed [Ah 9h] and won ($54.70) with a flush, Ace high
Seat 3: 3obndzTJ6fECz8+wWhMd1w folded before Flop (didn't bet)
Seat 4: TZcz9MEWDA+WydgGruqqbw folded before Flop (didn't bet)
Seat 5: 2rxrMrE7koO2BNxvop/0+g folded before Flop (didn't bet)
Seat 6: yAbu2QsRPVcjPbqlf/jDxw folded before Flop (didn't bet)
Seat 7: Ffa7Nj4X5fddtROP01hfQg folded before Flop
Seat 8: qTymj6ZQ8ZoFi6fINJZb3w folded before Flop (didn't bet)
Seat 9: y8Qb94e81yI/g0saQ6gU5g (button) mucked



PokerStars Game #59939107318:  Hold'em No Limit ($0.50/$1.00) - 2009/07/01 0:31:30 ET
Table 'hugOjcwJvzEwZbK7tyiWuQ' 9-max Seat #3 is the button
Seat 1: N9n5Wc3s35DpCrOAUUNAaQ ($124.35 in chips)
Seat 2: r27C1nIV4NS4+qbnrgBQSw ($257.05 in chips)
Seat 3: jDwhY1kCdc6EkAHbT7PJMQ ($109.75 in chips)
Seat 4: UWB3oeddt/GObx2Mix2Anw ($200.30 in chips)
Seat 6: gUUvmqdVlmvpal6B8nYrmg ($100 in chips)
Seat 7: FL3MrLspcF23LYvC4ipBOA ($101.50 in chips)
Seat 8: /zy+DB4S5fUQUSfZWFzYGw ($113.25 in chips)
Seat 9: o6JyUkbzCDw8tUabqtmnlg ($57.60 in chips)
UWB3oeddt/GObx2Mix2Anw: posts small blind $0.50
gUUvmqdVlmvpal6B8nYrmg: posts big blind $1
*** HOLE CARDS ***
FL3MrLspcF23LYvC4ipBOA: folds
/zy+DB4S5fUQUSfZWFzYGw: folds
o6JyUkbzCDw8tUabqtmnlg: folds
N9n5Wc3s35DpCrOAUUNAaQ: folds
r27C1nIV4NS4+qbnrgBQSw: folds
jDwhY1kCdc6EkAHbT7PJMQ: folds
UWB3oeddt/GObx2Mix2Anw: folds
gUUvmqdVlmvpal6B8nYrmg collected $1 from pot
*** SUMMARY ***
Total pot $1 | Rake $0
Seat 1: N9n5Wc3s35DpCrOAUUNAaQ folded before Flop (didn't bet)
Seat 2: r27C1nIV4NS4+qbnrgBQSw folded before Flop (didn't bet)
Seat 3: jDwhY1kCdc6EkAHbT7PJMQ (button) folded before Flop (didn't bet)
Seat 4: UWB3oeddt/GObx2Mix2Anw (small blind) folded before Flop
Seat 6: gUUvmqdVlmvpal6B8nYrmg (big blind) collected ($1)
Seat 7: FL3MrLspcF23LYvC4ipBOA folded before Flop (didn't bet)
Seat 8: /zy+DB4S5fUQUSfZWFzYGw folded before Flop (didn't bet)
Seat 9: o6JyUkbzCDw8tUabqtmnlg folded before Flop (didn't bet)



PokerStars Game #59939108792:  Hold'em No Limit ($0.50/$1.00) - 2009/07/01 0:31:32 ET
Table '7Nl0ffnjeK44/vmeexh3MQ' 9-max Seat #1 is the button
Seat 1: s7D3Y+k4Cj4D1cXHv7oj+Q ($99.45 in chips)
Seat 2: kiakSwxX0e64PwYGAPQvLw ($32.85 in chips)
Seat 3: vR4IO10geOgvTW+LAUBv/A ($100 in chips)
Seat 5: bL+QVeDcuEdzMGAGg2XJHg ($108.40 in chips)
Seat 6: FVs16t7GgfWgQWt4JxsObQ ($12.40 in chips)
Seat 7: knewtTmBc4Tc0z/5tAABYQ ($105 in chips)
Seat 8: zanka7aAZkigmZpfopXxxA ($229.20 in chips)
Seat 9: ouwUBGRKnKK9uhn1G4Lf+A ($97 in chips)
kiakSwxX0e64PwYGAPQvLw: posts small blind $0.50
vR4IO10geOgvTW+LAUBv/A: posts big blind $1
bLbSOSmSOnqE0iTcH/5dxA: sits out
*** HOLE CARDS ***
bL+QVeDcuEdzMGAGg2XJHg: folds
FVs16t7GgfWgQWt4JxsObQ: calls $1
knewtTmBc4Tc0z/5tAABYQ: folds
zanka7aAZkigmZpfopXxxA: folds
ouwUBGRKnKK9uhn1G4Lf+A: raises $5 to $6
s7D3Y+k4Cj4D1cXHv7oj+Q: folds
kiakSwxX0e64PwYGAPQvLw: folds
vR4IO10geOgvTW+LAUBv/A: folds
FVs16t7GgfWgQWt4JxsObQ: folds
ouwUBGRKnKK9uhn1G4Lf+A collected $3.50 from pot
ouwUBGRKnKK9uhn1G4Lf+A: doesn't show hand
*** SUMMARY ***
Total pot $3.50 | Rake $0
Seat 1: s7D3Y+k4Cj4D1cXHv7oj+Q (button) folded before Flop (didn't bet)
Seat 2: kiakSwxX0e64PwYGAPQvLw (small blind) folded before Flop
Seat 3: vR4IO10geOgvTW+LAUBv/A (big blind) folded before Flop
Seat 5: bL+QVeDcuEdzMGAGg2XJHg folded before Flop (didn't bet)
Seat 6: FVs16t7GgfWgQWt4JxsObQ folded before Flop
Seat 7: knewtTmBc4Tc0z/5tAABYQ folded before Flop (didn't bet)
Seat 8: zanka7aAZkigmZpfopXxxA folded before Flop (didn't bet)
Seat 9: ouwUBGRKnKK9uhn1G4Lf+A collected ($3.50)



PokerStars Game #59939108660:  Hold'em No Limit ($0.50/$1.00) - 2009/07/01 0:31:32 ET
Table 'pHrhryH8jPNdQfY62f8v+g' 6-max Seat #4 is the button
Seat 1: BdbmJTZZ47quA9vUWwXtlw ($72.80 in chips)
Seat 2: RqgF7gRoKgRNW8Zoi1ty4A ($116.50 in chips)
Seat 3: 0WjiuIT7/EolY1oOx1ngeA ($109.55 in chips)
Seat 4: wenbG7TaM3H7h5kn78OFNw ($51.45 in chips)
Seat 5: r1/R7y0Ortgoz4lccgW8VA ($66.65 in chips)
Seat 6: xAU6q2/cwmby2sxmA8VcmA ($102.80 in chips)
r1/R7y0Ortgoz4lccgW8VA: posts small blind $0.50
xAU6q2/cwmby2sxmA8VcmA: posts big blind $1
*** HOLE CARDS ***
BdbmJTZZ47quA9vUWwXtlw: folds
RqgF7gRoKgRNW8Zoi1ty4A: folds
0WjiuIT7/EolY1oOx1ngeA: folds
wenbG7TaM3H7h5kn78OFNw: folds
r1/R7y0Ortgoz4lccgW8VA: folds
xAU6q2/cwmby2sxmA8VcmA collected $1 from pot
*** SUMMARY ***
Total pot $1 | Rake $0
Seat 1: BdbmJTZZ47quA9vUWwXtlw folded before Flop (didn't bet)
Seat 2: RqgF7gRoKgRNW8Zoi1ty4A folded before Flop (didn't bet)
Seat 3: 0WjiuIT7/EolY1oOx1ngeA folded before Flop (didn't bet)
Seat 4: wenbG7TaM3H7h5kn78OFNw (button) folded before Flop (didn't bet)
Seat 5: r1/R7y0Ortgoz4lccgW8VA (small blind) folded before Flop
Seat 6: xAU6q2/cwmby2sxmA8VcmA (big blind) collected ($1)



PokerStars Game #59939108964:  Hold'em No Limit ($0.50/$1.00) - 2009/07/01 0:31:32 ET
Table '+cA8mcmhaedZ7YcrDdhmeQ' 6-max Seat #6 is the button
Seat 1: lsLuWlcPA3Rh7kJVLzMh0Q ($307.75 in chips)
Seat 2: RqgF7gRoKgRNW8Zoi1ty4A ($100 in chips)
Seat 3: 0WjiuIT7/EolY1oOx1ngeA ($116.30 in chips)
Seat 4: LjL3AIERHn559yyW1mTUYQ ($98.50 in chips)
Seat 5: 6WyjEXOToimYmtLdqIgHYQ ($60 in chips)
Seat 6: YfsTQsY/fxb+YqbdclTHuw ($38.50 in chips)
lsLuWlcPA3Rh7kJVLzMh0Q: posts small blind $0.50
RqgF7gRoKgRNW8Zoi1ty4A: posts big blind $1
*** HOLE CARDS ***
0WjiuIT7/EolY1oOx1ngeA: folds
LjL3AIERHn559yyW1mTUYQ: folds
6WyjEXOToimYmtLdqIgHYQ: raises $2 to $3
YfsTQsY/fxb+YqbdclTHuw: folds
lsLuWlcPA3Rh7kJVLzMh0Q: folds
RqgF7gRoKgRNW8Zoi1ty4A: folds
6WyjEXOToimYmtLdqIgHYQ collected $2.50 from pot
*** SUMMARY ***
Total pot $2.50 | Rake $0
Seat 1: lsLuWlcPA3Rh7kJVLzMh0Q (small blind) folded before Flop
Seat 2: RqgF7gRoKgRNW8Zoi1ty4A (big blind) folded before Flop
Seat 3: 0WjiuIT7/EolY1oOx1ngeA folded before Flop (didn't bet)
Seat 4: LjL3AIERHn559yyW1mTUYQ folded before Flop (didn't bet)
Seat 5: 6WyjEXOToimYmtLdqIgHYQ collected ($2.50)
Seat 6: YfsTQsY/fxb+YqbdclTHuw (button) folded before Flop (didn't bet)



PokerStars Game #59939109070:  Hold'em No Limit ($0.50/$1.00) - 2009/07/01 0:31:33 ET
Table 'QBLDswtHe7Ml0HwAdcMhlw' 2-max Seat #1 is the button
Seat 1: hdNlhiCwI533uwvvTTfC9Q ($100 in chips)
Seat 2: rAtTyvrJ8f1LaUh2O5U4nA ($30.70 in chips)
hdNlhiCwI533uwvvTTfC9Q: posts small blind $0.50
rAtTyvrJ8f1LaUh2O5U4nA: posts big blind $1
*** HOLE CARDS ***
hdNlhiCwI533uwvvTTfC9Q: folds
rAtTyvrJ8f1LaUh2O5U4nA collected $1 from pot
*** SUMMARY ***
Total pot $1 | Rake $0
Seat 1: hdNlhiCwI533uwvvTTfC9Q (button) (small blind) folded before Flop
Seat 2: rAtTyvrJ8f1LaUh2O5U4nA (big blind) collected ($1)



PokerStars Game #59939109588:  Hold'em No Limit ($0.50/$1.00) - 2009/07/01 0:31:33 ET
Table '/FUb199IViHMJHi5YWmeuQ' 9-max Seat #6 is the button
Seat 1: TZcz9MEWDA+WydgGruqqbw ($101.85 in chips)
Seat 2: FL3MrLspcF23LYvC4ipBOA ($137.25 in chips)
Seat 3: qN483QJ1NvHbdIZB7J4ARw ($59.95 in chips)
Seat 6: ccFf7Q4z1cTGQmeoYiWEfw ($51.95 in chips)
Seat 7: bLbSOSmSOnqE0iTcH/5dxA ($100 in chips)
Seat 8: QIWvt0R766g8KfH0vl1s0A ($34.40 in chips)
Seat 9: knewtTmBc4Tc0z/5tAABYQ ($155.15 in chips)
bLbSOSmSOnqE0iTcH/5dxA: posts small blind $0.50
QIWvt0R766g8KfH0vl1s0A: posts big blind $1
qheQay5YvP2DMAb3OUSxtw: sits out
*** HOLE CARDS ***
knewtTmBc4Tc0z/5tAABYQ: folds
TZcz9MEWDA+WydgGruqqbw: folds
FL3MrLspcF23LYvC4ipBOA: folds
qN483QJ1NvHbdIZB7J4ARw: calls $1
ccFf7Q4z1cTGQmeoYiWEfw: folds
bLbSOSmSOnqE0iTcH/5dxA: folds
QIWvt0R766g8KfH0vl1s0A: checks
*** FLOP *** [3s 2h Jc]
QIWvt0R766g8KfH0vl1s0A: checks
qN483QJ1NvHbdIZB7J4ARw: bets $3
QIWvt0R766g8KfH0vl1s0A: folds
qN483QJ1NvHbdIZB7J4ARw collected $2.40 from pot
*** SUMMARY ***
Total pot $2.50 | Rake $0.10
Board [3s 2h Jc]
Seat 1: TZcz9MEWDA+WydgGruqqbw folded before Flop (didn't bet)
Seat 2: FL3MrLspcF23LYvC4ipBOA folded before Flop (didn't bet)
Seat 3: qN483QJ1NvHbdIZB7J4ARw collected ($2.40)
Seat 6: ccFf7Q4z1cTGQmeoYiWEfw (button) folded before Flop (didn't bet)
Seat 7: bLbSOSmSOnqE0iTcH/5dxA (small blind) folded before Flop
Seat 8: QIWvt0R766g8KfH0vl1s0A (big blind) folded on the Flop
Seat 9: knewtTmBc4Tc0z/5tAABYQ folded before Flop (didn't bet)



PokerStars Game #59939110392:  Hold'em No Limit ($0.50/$1.00) - 2009/07/01 0:31:35 ET
Table 'O96CPOtvMBWP6kzuYDfdFA' 6-max Seat #1 is the button
Seat 1: 6alLXQIITA2EZ/lBeym8Dw ($100 in chips)
Seat 2: sc/HX9smXU5kObrOWIYO5g ($36 in chips)
Seat 3: V89DGjxE171oPREEbAXiyg ($36.70 in chips)
Seat 4: KOG8rG51mOvIoY96zF3kvw ($162.75 in chips)
Seat 5: wRxiu9OJzvvN84OYWW9jxQ ($137.60 in chips)
Seat 6: xNKcQzD9+/iHmtJn4vYq9w ($141.65 in chips)
sc/HX9smXU5kObrOWIYO5g: posts small blind $0.50
V89DGjxE171oPREEbAXiyg: posts big blind $1
*** HOLE CARDS ***
KOG8rG51mOvIoY96zF3kvw: folds
wRxiu9OJzvvN84OYWW9jxQ: calls $1
xNKcQzD9+/iHmtJn4vYq9w: folds
6alLXQIITA2EZ/lBeym8Dw: folds
sc/HX9smXU5kObrOWIYO5g: calls $0.50
V89DGjxE171oPREEbAXiyg: checks
*** FLOP *** [6h Ah 3s]
sc/HX9smXU5kObrOWIYO5g: checks
V89DGjxE171oPREEbAXiyg: checks
wRxiu9OJzvvN84OYWW9jxQ: checks
*** TURN *** [6h Ah 3s] [4c]
sc/HX9smXU5kObrOWIYO5g: checks
V89DGjxE171oPREEbAXiyg: bets $2
wRxiu9OJzvvN84OYWW9jxQ: folds
sc/HX9smXU5kObrOWIYO5g: folds
V89DGjxE171oPREEbAXiyg collected $2.85 from pot
*** SUMMARY ***
Total pot $3 | Rake $0.15
Board [6h Ah 3s 4c]
Seat 1: 6alLXQIITA2EZ/lBeym8Dw (button) folded before Flop (didn't bet)
Seat 2: sc/HX9smXU5kObrOWIYO5g (small blind) folded on the Turn
Seat 3: V89DGjxE171oPREEbAXiyg (big blind) collected ($2.85)
Seat 4: KOG8rG51mOvIoY96zF3kvw folded before Flop (didn't bet)
Seat 5: wRxiu9OJzvvN84OYWW9jxQ folded on the Turn
Seat 6: xNKcQzD9+/iHmtJn4vYq9w folded before Flop (didn't bet)



PokerStars Game #59939113296:  Hold'em No Limit ($0.50/$1.00) - 2009/07/01 0:31:39 ET
Table 'rmZfTK+oSebeUPJNbWhdAA' 6-max Seat #3 is the button
Seat 1: xAU6q2/cwmby2sxmA8VcmA ($100 in chips)
Seat 2: OigyyiK+tTj1APPIAUmXDA ($88.05 in chips)
Seat 3: 9yjOzGERLaEZS8CZ6YNHFg ($115.40 in chips)
Seat 4: OGMLOcTNYZXZU81au7ztUw ($127.70 in chips)
Seat 5: +xW7QemQU0Fxs+4TnqBRow ($101.50 in chips)
Seat 6: j7NIOHLZk7V2o9fOioO5ug ($105.65 in chips)
OGMLOcTNYZXZU81au7ztUw: posts small blind $0.50
+xW7QemQU0Fxs+4TnqBRow: posts big blind $1
*** HOLE CARDS ***
j7NIOHLZk7V2o9fOioO5ug: raises $2 to $3
xAU6q2/cwmby2sxmA8VcmA: folds
OigyyiK+tTj1APPIAUmXDA: raises $6 to $9
9yjOzGERLaEZS8CZ6YNHFg: folds
OGMLOcTNYZXZU81au7ztUw: folds
+xW7QemQU0Fxs+4TnqBRow: folds
j7NIOHLZk7V2o9fOioO5ug: calls $6
*** FLOP *** [3h 7h Kc]
j7NIOHLZk7V2o9fOioO5ug: bets $13
OigyyiK+tTj1APPIAUmXDA: calls $13
*** TURN *** [3h 7h Kc] [As]
j7NIOHLZk7V2o9fOioO5ug: checks
OigyyiK+tTj1APPIAUmXDA: bets $16
j7NIOHLZk7V2o9fOioO5ug: calls $16
*** RIVER *** [3h 7h Kc As] [2s]
j7NIOHLZk7V2o9fOioO5ug: checks
OigyyiK+tTj1APPIAUmXDA: checks
*** SHOW DOWN ***
j7NIOHLZk7V2o9fOioO5ug: shows [Kh Qs] (a pair of Kings)
OigyyiK+tTj1APPIAUmXDA: shows [9h Ah] (a pair of Aces)
OigyyiK+tTj1APPIAUmXDA collected $74.50 from pot
*** SUMMARY ***
Total pot $77.50 | Rake $3
Board [3h 7h Kc As 2s]
Seat 1: xAU6q2/cwmby2sxmA8VcmA folded before Flop (didn't bet)
Seat 2: OigyyiK+tTj1APPIAUmXDA showed [9h Ah] and won ($74.50) with a pair of Aces
Seat 3: 9yjOzGERLaEZS8CZ6YNHFg (button) folded before Flop (didn't bet)
Seat 4: OGMLOcTNYZXZU81au7ztUw (small blind) folded before Flop
Seat 5: +xW7QemQU0Fxs+4TnqBRow (big blind) folded before Flop
Seat 6: j7NIOHLZk7V2o9fOioO5ug showed [Kh Qs] and lost with a pair of Kings



PokerStars Game #59939113408:  Hold'em No Limit ($0.50/$1.00) - 2009/07/01 0:31:39 ET
Table 'QBLDswtHe7Ml0HwAdcMhlw' 2-max Seat #2 is the button
Seat 1: hdNlhiCwI533uwvvTTfC9Q ($100 in chips)
Seat 2: rAtTyvrJ8f1LaUh2O5U4nA ($31.20 in chips)
rAtTyvrJ8f1LaUh2O5U4nA: posts small blind $0.50
hdNlhiCwI533uwvvTTfC9Q: posts big blind $1
*** HOLE CARDS ***
rAtTyvrJ8f1LaUh2O5U4nA: folds
hdNlhiCwI533uwvvTTfC9Q collected $1 from pot
hdNlhiCwI533uwvvTTfC9Q: doesn't show hand
*** SUMMARY ***
Total pot $1 | Rake $0
Seat 1: hdNlhiCwI533uwvvTTfC9Q (big blind) collected ($1)
Seat 2: rAtTyvrJ8f1LaUh2O5U4nA (button) (small blind) folded before Flop



PokerStars Game #59939114876:  Hold'em No Limit ($0.50/$1.00) - 2009/07/01 0:31:41 ET
Table 'U9zqzC8f3oTJ2ShXFgSSOA' 6-max Seat #6 is the button
Seat 1: tS9JHB1h+FQ++qu8RwRNgg ($33.60 in chips)
Seat 2: U2CWBTv29qdCbj8RNF2sIw ($106.05 in chips)
Seat 3: yfXek8iJ7O4CFyqXrtGcfg ($35.55 in chips)
Seat 4: 33q95we0Etwgrm6guQGncw ($73.65 in chips)
Seat 5: KfwW5us6tydK81NYTtK1gw ($307.05 in chips)
Seat 6: aIxzFKdtpDSkUePKZy/niQ ($38.90 in chips)
tS9JHB1h+FQ++qu8RwRNgg: posts small blind $0.50
U2CWBTv29qdCbj8RNF2sIw: posts big blind $1
*** HOLE CARDS ***
yfXek8iJ7O4CFyqXrtGcfg: folds
33q95we0Etwgrm6guQGncw: folds
KfwW5us6tydK81NYTtK1gw: folds
aIxzFKdtpDSkUePKZy/niQ: raises $3 to $4
tS9JHB1h+FQ++qu8RwRNgg: folds
U2CWBTv29qdCbj8RNF2sIw: calls $3
*** FLOP *** [6h Ts 6c]
U2CWBTv29qdCbj8RNF2sIw: checks
aIxzFKdtpDSkUePKZy/niQ: bets $5
U2CWBTv29qdCbj8RNF2sIw: raises $5 to $10
aIxzFKdtpDSkUePKZy/niQ: raises $24.90 to $34.90 and is all-in
U2CWBTv29qdCbj8RNF2sIw: folds
aIxzFKdtpDSkUePKZy/niQ collected $27.10 from pot
*** SUMMARY ***
Total pot $28.50 | Rake $1.40
Board [6h Ts 6c]
Seat 1: tS9JHB1h+FQ++qu8RwRNgg (small blind) folded before Flop
Seat 2: U2CWBTv29qdCbj8RNF2sIw (big blind) folded on the Flop
Seat 3: yfXek8iJ7O4CFyqXrtGcfg folded before Flop (didn't bet)
Seat 4: 33q95we0Etwgrm6guQGncw folded before Flop (didn't bet)
Seat 5: KfwW5us6tydK81NYTtK1gw folded before Flop (didn't bet)
Seat 6: aIxzFKdtpDSkUePKZy/niQ (button) collected ($27.10)



PokerStars Game #59939115080:  Hold'em No Limit ($0.50/$1.00) - 2009/07/01 0:31:42 ET
Table 'MUPc8FEpe/nR0BKSeReX6Q' 6-max Seat #5 is the button
Seat 1: YsLQ3BAvgQHWXMAv3Wv6Hg ($100 in chips)
Seat 2: xAU6q2/cwmby2sxmA8VcmA ($110.50 in chips)
Seat 3: wx3sQGkVi2x9wJXuWNHPBw ($234.05 in chips)
Seat 4: ZA1bp6g8IwtTxkUE4eCjDQ ($119.10 in chips)
Seat 5: UBZQqpnJZdTYYY1FTb0rLA ($100 in chips)
Seat 6: oxnw0GLLpFanjhGkxfRSqA ($51.10 in chips)
oxnw0GLLpFanjhGkxfRSqA: posts small blind $0.50
YsLQ3BAvgQHWXMAv3Wv6Hg: posts big blind $1
*** HOLE CARDS ***
xAU6q2/cwmby2sxmA8VcmA: folds
wx3sQGkVi2x9wJXuWNHPBw: folds
ZA1bp6g8IwtTxkUE4eCjDQ: folds
UBZQqpnJZdTYYY1FTb0rLA: folds
oxnw0GLLpFanjhGkxfRSqA: folds
YsLQ3BAvgQHWXMAv3Wv6Hg collected $1 from pot
YsLQ3BAvgQHWXMAv3Wv6Hg: doesn't show hand
*** SUMMARY ***
Total pot $1 | Rake $0
Seat 1: YsLQ3BAvgQHWXMAv3Wv6Hg (big blind) collected ($1)
Seat 2: xAU6q2/cwmby2sxmA8VcmA folded before Flop (didn't bet)
Seat 3: wx3sQGkVi2x9wJXuWNHPBw folded before Flop (didn't bet)
Seat 4: ZA1bp6g8IwtTxkUE4eCjDQ folded before Flop (didn't bet)
Seat 5: UBZQqpnJZdTYYY1FTb0rLA (button) folded before Flop (didn't bet)
Seat 6: oxnw0GLLpFanjhGkxfRSqA (small blind) folded before Flop



PokerStars Game #59939115428:  Hold'em No Limit ($0.50/$1.00) - 2009/07/01 0:31:42 ET
Table 'mmbQQVBTrPdE+wy+s+9VPA' 6-max Seat #3 is the button
Seat 1: xAU6q2/cwmby2sxmA8VcmA ($113.70 in chips)
Seat 3: wx3sQGkVi2x9wJXuWNHPBw ($108.65 in chips)
Seat 4: RfKnhkJN8HEAuzJpH2Ajdg ($26.85 in chips)
Seat 5: YMJG+F++3Aj6P8dAWda5fw ($100 in chips)
RfKnhkJN8HEAuzJpH2Ajdg: posts small blind $0.50
YMJG+F++3Aj6P8dAWda5fw: posts big blind $1
*** HOLE CARDS ***
xAU6q2/cwmby2sxmA8VcmA: folds
wx3sQGkVi2x9wJXuWNHPBw: folds
RfKnhkJN8HEAuzJpH2Ajdg: calls $0.50
YMJG+F++3Aj6P8dAWda5fw: checks
*** FLOP *** [7s Kh 4c]
xAU6q2/cwmby2sxmA8VcmA leaves the table
RfKnhkJN8HEAuzJpH2Ajdg: checks
YMJG+F++3Aj6P8dAWda5fw: bets $1
RfKnhkJN8HEAuzJpH2Ajdg: folds
YMJG+F++3Aj6P8dAWda5fw collected $1.90 from pot
*** SUMMARY ***
Total pot $2 | Rake $0.10
Board [7s Kh 4c]
Seat 1: xAU6q2/cwmby2sxmA8VcmA folded before Flop (didn't bet)
Seat 3: wx3sQGkVi2x9wJXuWNHPBw (button) folded before Flop (didn't bet)
Seat 4: RfKnhkJN8HEAuzJpH2Ajdg (small blind) folded on the Flop
Seat 5: YMJG+F++3Aj6P8dAWda5fw (big blind) collected ($1.90)



PokerStars Game #59939115298:  Hold'em No Limit ($0.50/$1.00) - 2009/07/01 0:31:42 ET
Table 'tLrtq7gDzxEvckNAI1OS5Q' 6-max Seat #5 is the button
Seat 1: GisIe1kcC9q/xV6ifsTjgA ($166.20 in chips)
Seat 2: QHvTZcrKe6+maWUfVjP29Q ($101.50 in chips)
Seat 4: KOG8rG51mOvIoY96zF3kvw ($161.80 in chips)
Seat 5: OGMLOcTNYZXZU81au7ztUw ($164.95 in chips)
Seat 6: XUk5GQsfNFpHvaToDZ0rZA ($45.25 in chips)
XUk5GQsfNFpHvaToDZ0rZA: posts small blind $0.50
GisIe1kcC9q/xV6ifsTjgA: posts big blind $1
*** HOLE CARDS ***
QHvTZcrKe6+maWUfVjP29Q: folds
KOG8rG51mOvIoY96zF3kvw: raises $2 to $3
OGMLOcTNYZXZU81au7ztUw: calls $3
XUk5GQsfNFpHvaToDZ0rZA: folds
GisIe1kcC9q/xV6ifsTjgA: calls $2
*** FLOP *** [9c Th Qh]
GisIe1kcC9q/xV6ifsTjgA: checks
KOG8rG51mOvIoY96zF3kvw: checks
OGMLOcTNYZXZU81au7ztUw: bets $6
GisIe1kcC9q/xV6ifsTjgA: calls $6
KOG8rG51mOvIoY96zF3kvw: folds
*** TURN *** [9c Th Qh] [8h]
GisIe1kcC9q/xV6ifsTjgA: checks
OGMLOcTNYZXZU81au7ztUw: checks
*** RIVER *** [9c Th Qh 8h] [4h]
GisIe1kcC9q/xV6ifsTjgA: bets $16
OGMLOcTNYZXZU81au7ztUw: folds
GisIe1kcC9q/xV6ifsTjgA collected $20.45 from pot
*** SUMMARY ***
Total pot $21.50 | Rake $1.05
Board [9c Th Qh 8h 4h]
Seat 1: GisIe1kcC9q/xV6ifsTjgA (big blind) collected ($20.45)
Seat 2: QHvTZcrKe6+maWUfVjP29Q folded before Flop (didn't bet)
Seat 4: KOG8rG51mOvIoY96zF3kvw folded on the Flop
Seat 5: OGMLOcTNYZXZU81au7ztUw (button) folded on the River
Seat 6: XUk5GQsfNFpHvaToDZ0rZA (small blind) folded before Flop



PokerStars Game #59939115924:  Hold'em No Limit ($0.50/$1.00) - 2009/07/01 0:31:43 ET
Table 'vs/5jr6ciwjVQ5+Soc+u2A' 6-max Seat #4 is the button
Seat 2: XOIf9W+VAxhZqN+SYoyMKA ($121.15 in chips)
Seat 3: G5ZSSN6RSON3gkNvk/SmYg ($100 in chips)
Seat 4: KpnW5CcJ4Mg6MeclfKmLrw ($113.80 in chips)
Seat 5: 7Vc9JmGFQwMRh5Tj9ui5Lw ($97.15 in chips)
Seat 6: QHvTZcrKe6+maWUfVjP29Q ($103 in chips)
7Vc9JmGFQwMRh5Tj9ui5Lw: posts small blind $0.50
QHvTZcrKe6+maWUfVjP29Q: posts big blind $1
3yN2jRjZ+glIaWtGMmKOrA: sits out
*** HOLE CARDS ***
XOIf9W+VAxhZqN+SYoyMKA: raises $2 to $3
G5ZSSN6RSON3gkNvk/SmYg: folds
KpnW5CcJ4Mg6MeclfKmLrw: folds
7Vc9JmGFQwMRh5Tj9ui5Lw: folds
QHvTZcrKe6+maWUfVjP29Q: folds
XOIf9W+VAxhZqN+SYoyMKA collected $2.50 from pot
XOIf9W+VAxhZqN+SYoyMKA: doesn't show hand
*** SUMMARY ***
Total pot $2.50 | Rake $0
Seat 2: XOIf9W+VAxhZqN+SYoyMKA collected ($2.50)
Seat 3: G5ZSSN6RSON3gkNvk/SmYg folded before Flop (didn't bet)
Seat 4: KpnW5CcJ4Mg6MeclfKmLrw (button) folded before Flop (didn't bet)
Seat 5: 7Vc9JmGFQwMRh5Tj9ui5Lw (small blind) folded before Flop
Seat 6: QHvTZcrKe6+maWUfVjP29Q (big blind) folded before Flop



PokerStars Game #59939116030:  Hold'em No Limit ($0.50/$1.00) - 2009/07/01 0:31:43 ET
Table 'VOs36P6NW+QyXeQ1B62kmA' 6-max Seat #2 is the button
Seat 1: AdLVjddOzm+sRNo1Bc3S6Q ($139.65 in chips)
Seat 2: KpnW5CcJ4Mg6MeclfKmLrw ($113.30 in chips)
Seat 3: TSuRyAHnUPCFjP7Z0rEE0w ($104.90 in chips)
Seat 4: w02zQzNydODiyV9THKgo9w ($28.65 in chips)
Seat 5: X7GlkHF+lkbarCLuZ4Uf0w ($21 in chips)
Seat 6: 6tvjsJrdmWg+g7FVrMnzXA ($69.10 in chips)
TSuRyAHnUPCFjP7Z0rEE0w: posts small blind $0.50
w02zQzNydODiyV9THKgo9w: posts big blind $1
*** HOLE CARDS ***
X7GlkHF+lkbarCLuZ4Uf0w: folds
6tvjsJrdmWg+g7FVrMnzXA: calls $1
AdLVjddOzm+sRNo1Bc3S6Q: folds
KpnW5CcJ4Mg6MeclfKmLrw: folds
TSuRyAHnUPCFjP7Z0rEE0w: calls $0.50
w02zQzNydODiyV9THKgo9w: checks
*** FLOP *** [2d 4d 9s]
TSuRyAHnUPCFjP7Z0rEE0w: bets $2
w02zQzNydODiyV9THKgo9w: calls $2
6tvjsJrdmWg+g7FVrMnzXA: calls $2
*** TURN *** [2d 4d 9s] [7s]
TSuRyAHnUPCFjP7Z0rEE0w: bets $6
w02zQzNydODiyV9THKgo9w: calls $6
6tvjsJrdmWg+g7FVrMnzXA: folds
*** RIVER *** [2d 4d 9s 7s] [3s]
TSuRyAHnUPCFjP7Z0rEE0w: checks
w02zQzNydODiyV9THKgo9w: checks
*** SHOW DOWN ***
TSuRyAHnUPCFjP7Z0rEE0w: shows [Td Qd] (high card Queen)
w02zQzNydODiyV9THKgo9w: shows [8h 9d] (a pair of Nines)
w02zQzNydODiyV9THKgo9w collected $20 from pot
*** SUMMARY ***
Total pot $21 | Rake $1
Board [2d 4d 9s 7s 3s]
Seat 1: AdLVjddOzm+sRNo1Bc3S6Q folded before Flop (didn't bet)
Seat 2: KpnW5CcJ4Mg6MeclfKmLrw (button) folded before Flop (didn't bet)
Seat 3: TSuRyAHnUPCFjP7Z0rEE0w (small blind) showed [Td Qd] and lost with high card Queen
Seat 4: w02zQzNydODiyV9THKgo9w (big blind) showed [8h 9d] and won ($20) with a pair of Nines
Seat 5: X7GlkHF+lkbarCLuZ4Uf0w folded before Flop (didn't bet)
Seat 6: 6tvjsJrdmWg+g7FVrMnzXA folded on the Turn



PokerStars Game #59939116268:  Hold'em No Limit ($0.50/$1.00) - 2009/07/01 0:31:43 ET
Table '21a4iYFKcuezM4nYx8DWTA' 2-max Seat #2 is the button
Seat 1: NYi6JFscYNrofSXy4sM+Yw ($156 in chips)
Seat 2: +sy/nlNI20yZraIjs4AALg ($43.70 in chips)
+sy/nlNI20yZraIjs4AALg: posts small blind $0.50
NYi6JFscYNrofSXy4sM+Yw: posts big blind $1
*** HOLE CARDS ***
+sy/nlNI20yZraIjs4AALg: raises $4 to $5
NYi6JFscYNrofSXy4sM+Yw: folds
+sy/nlNI20yZraIjs4AALg collected $2 from pot
*** SUMMARY ***
Total pot $2 | Rake $0
Seat 1: NYi6JFscYNrofSXy4sM+Yw (big blind) folded before Flop
Seat 2: +sy/nlNI20yZraIjs4AALg (button) (small blind) collected ($2)



PokerStars Game #59939117598:  Hold'em No Limit ($0.50/$1.00) - 2009/07/01 0:31:45 ET
Table 'tyUh+jyNvrceIQdKMJjQ2wZFWj23PMihdwrNWv41OG/Qeat #4 is the button
Seat 2: 6iVcnPw9a2oNG6sPQo3G6g ($191.50 in chips)
Seat 4: TSuRyAHnUPCFjP7Z0rEE0w ($118.45 in chips)
Seat 5: j7NIOHLZk7V2o9fOioO5ug ($119.60 in chips)
Seat 6: YsLQ3BAvgQHWXMAv3Wv6Hg ($137.10 in chips)
j7NIOHLZk7V2o9fOioO5ug: posts small blind $0.50
YsLQ3BAvgQHWXMAv3Wv6Hg: posts big blind $1
*** HOLE CARDS ***
6iVcnPw9a2oNG6sPQo3G6g: folds
6iVcnPw9a2oNG6sPQo3G6g leaves the table
L9qfLYXrczhAPd/VckgsWw leaves the table
TSuRyAHnUPCFjP7Z0rEE0w: folds
j7NIOHLZk7V2o9fOioO5ug: folds
TalCiLYHCd+ffkmR3auPvA joins the table at seat #3
YsLQ3BAvgQHWXMAv3Wv6Hg collected $1 from pot
YsLQ3BAvgQHWXMAv3Wv6Hg: doesn't show hand
*** SUMMARY ***
Total pot $1 | Rake $0
Seat 2: 6iVcnPw9a2oNG6sPQo3G6g folded before Flop (didn't bet)
Seat 4: TSuRyAHnUPCFjP7Z0rEE0w (button) folded before Flop (didn't bet)
Seat 5: j7NIOHLZk7V2o9fOioO5ug (small blind) folded before Flop
Seat 6: YsLQ3BAvgQHWXMAv3Wv6Hg (big blind) collected ($1)



PokerStars Game #59939117832:  Hold'em No Limit ($0.50/$1.00) - 2009/07/01 0:31:46 ET
Table 'QBLDswtHe7Ml0HwAdcMhlw' 2-max Seat #1 is the button
Seat 1: hdNlhiCwI533uwvvTTfC9Q ($100.50 in chips)
Seat 2: rAtTyvrJ8f1LaUh2O5U4nA ($30.70 in chips)
hdNlhiCwI533uwvvTTfC9Q: posts small blind $0.50
rAtTyvrJ8f1LaUh2O5U4nA: posts big blind $1
*** HOLE CARDS ***
hdNlhiCwI533uwvvTTfC9Q: raises $2 to $3
rAtTyvrJ8f1LaUh2O5U4nA: folds
hdNlhiCwI533uwvvTTfC9Q collected $2 from pot
hdNlhiCwI533uwvvTTfC9Q: doesn't show hand
*** SUMMARY ***
Total pot $2 | Rake $0
Seat 1: hdNlhiCwI533uwvvTTfC9Q (button) (small blind) collected ($2)
Seat 2: rAtTyvrJ8f1LaUh2O5U4nA (big blind) folded before Flop



PokerStars Game #59939118462:  Hold'em No Limit ($0.50/$1.00) - 2009/07/01 0:31:47 ET
Table 'fTlPiCj0utgzC/5io+I7ew' 6-max Seat #6 is the button
Seat 1: YMJG+F++3Aj6P8dAWda5fw ($99 in chips)
Seat 2: Qy/UBNbD2HaA0Ogxg8Sf3w ($100 in chips)
Seat 3: oDiBRCaF0QVtd3kO6xZIXw ($101.50 in chips)
Seat 4: uJVSceLggtsrJya+WtmUEA ($97.80 in chips)
Seat 5: bFrTkDcWGTxyvNul7GVdYg ($256.70 in chips)
Seat 6: jMljU/dOPMXfJi8OmbdYdw ($13.50 in chips)
YMJG+F++3Aj6P8dAWda5fw: posts small blind $0.50
Qy/UBNbD2HaA0Ogxg8Sf3w: posts big blind $1
*** HOLE CARDS ***
oDiBRCaF0QVtd3kO6xZIXw: folds
uJVSceLggtsrJya+WtmUEA: raises $2 to $3
bFrTkDcWGTxyvNul7GVdYg: folds
jMljU/dOPMXfJi8OmbdYdw said, "zzzzzz"
jMljU/dOPMXfJi8OmbdYdw: folds
YMJG+F++3Aj6P8dAWda5fw: folds
Qy/UBNbD2HaA0Ogxg8Sf3w: folds
uJVSceLggtsrJya+WtmUEA collected $2.50 from pot
*** SUMMARY ***
Total pot $2.50 | Rake $0
Seat 1: YMJG+F++3Aj6P8dAWda5fw (small blind) folded before Flop
Seat 2: Qy/UBNbD2HaA0Ogxg8Sf3w (big blind) folded before Flop
Seat 3: oDiBRCaF0QVtd3kO6xZIXw folded before Flop (didn't bet)
Seat 4: uJVSceLggtsrJya+WtmUEA collected ($2.50)
Seat 5: bFrTkDcWGTxyvNul7GVdYg folded before Flop (didn't bet)
Seat 6: jMljU/dOPMXfJi8OmbdYdw (button) folded before Flop (didn't bet)



PokerStars Game #59939118838:  Hold'em No Limit ($0.50/$1.00) - 2009/07/01 0:31:47 ET
Table 'N2bNCDHL96aCQDvZIh+yQQ' 6-max Seat #1 is the button
Seat 1: iHo1oDbrEVJ8nEGdaPrICw ($143.50 in chips)
Seat 2: KpnW5CcJ4Mg6MeclfKmLrw ($112.40 in chips)
Seat 3: Qy/UBNbD2HaA0Ogxg8Sf3w ($100 in chips)
Seat 4: uCqEjnxh2/vFBjKYkfTOkw ($151.90 in chips)
Seat 5: rHlMOfR7kpQQxe+PFQz0xQ ($41.60 in chips)
Seat 6: TSuRyAHnUPCFjP7Z0rEE0w ($100 in chips)
KpnW5CcJ4Mg6MeclfKmLrw: posts small blind $0.50
Qy/UBNbD2HaA0Ogxg8Sf3w: posts big blind $1
*** HOLE CARDS ***
uCqEjnxh2/vFBjKYkfTOkw: folds
rHlMOfR7kpQQxe+PFQz0xQ: folds
TSuRyAHnUPCFjP7Z0rEE0w: folds
iHo1oDbrEVJ8nEGdaPrICw: folds
KpnW5CcJ4Mg6MeclfKmLrw: folds
Qy/UBNbD2HaA0Ogxg8Sf3w collected $1 from pot
Qy/UBNbD2HaA0Ogxg8Sf3w: doesn't show hand
*** SUMMARY ***
Total pot $1 | Rake $0
Seat 1: iHo1oDbrEVJ8nEGdaPrICw (button) folded before Flop (didn't bet)
Seat 2: KpnW5CcJ4Mg6MeclfKmLrw (small blind) folded before Flop
Seat 3: Qy/UBNbD2HaA0Ogxg8Sf3w (big blind) collected ($1)
Seat 4: uCqEjnxh2/vFBjKYkfTOkw folded before Flop (didn't bet)
Seat 5: rHlMOfR7kpQQxe+PFQz0xQ folded before Flop (didn't bet)
Seat 6: TSuRyAHnUPCFjP7Z0rEE0w folded before Flop (didn't bet)



PokerStars Game #59939118578:  Hold'em No Limit ($0.50/$1.00) - 2009/07/01 0:31:47 ET
Table 'eU3bWpDDg3Z+9R4m4iVmog' 6-max Seat #2 is the button
Seat 1: TSuRyAHnUPCFjP7Z0rEE0w ($165.60 in chips)
Seat 2: 8CAoOzhmB8n3nRFf3V4BTg ($125.95 in chips)
Seat 3: U6tnjwZRpTnM+YkqkCjwyQ ($174.65 in chips)
Seat 4: GDVIsbEJ/DOJsMKE4Asz0A ($101.25 in chips)
Seat 5: QHvTZcrKe6+maWUfVjP29Q ($103.50 in chips)
Seat 6: hpxXcmRkXXI9HE5+5/j/0Q ($100 in chips)
U6tnjwZRpTnM+YkqkCjwyQ: posts small blind $0.50
GDVIsbEJ/DOJsMKE4Asz0A: posts big blind $1
*** HOLE CARDS ***
QHvTZcrKe6+maWUfVjP29Q: raises $2.50 to $3.50
hpxXcmRkXXI9HE5+5/j/0Q: raises $9.50 to $13
TSuRyAHnUPCFjP7Z0rEE0w: folds
8CAoOzhmB8n3nRFf3V4BTg: folds
U6tnjwZRpTnM+YkqkCjwyQ: folds
GDVIsbEJ/DOJsMKE4Asz0A: folds
QHvTZcrKe6+maWUfVjP29Q: folds
hpxXcmRkXXI9HE5+5/j/0Q collected $8.50 from pot
hpxXcmRkXXI9HE5+5/j/0Q: doesn't show hand
*** SUMMARY ***
Total pot $8.50 | Rake $0
Seat 1: TSuRyAHnUPCFjP7Z0rEE0w folded before Flop (didn't bet)
Seat 2: 8CAoOzhmB8n3nRFf3V4BTg (button) folded before Flop (didn't bet)
Seat 3: U6tnjwZRpTnM+YkqkCjwyQ (small blind) folded before Flop
Seat 4: GDVIsbEJ/DOJsMKE4Asz0A (big blind) folded before Flop
Seat 5: QHvTZcrKe6+maWUfVjP29Q folded before Flop
Seat 6: hpxXcmRkXXI9HE5+5/j/0Q collected ($8.50)



PokerStars Game #59939120578:  Hold'em No Limit ($0.50/$1.00) - 2009/07/01 0:31:50 ET
Table 'hugOjcwJvzEwZbK7tyiWuQ' 9-max Seat #4 is the button
Seat 1: N9n5Wc3s35DpCrOAUUNAaQ ($124.35 in chips)
Seat 2: r27C1nIV4NS4+qbnrgBQSw ($257.05 in chips)
Seat 3: jDwhY1kCdc6EkAHbT7PJMQ ($109.75 in chips)
Seat 4: UWB3oeddt/GObx2Mix2Anw ($199.80 in chips)
Seat 6: gUUvmqdVlmvpal6B8nYrmg ($100.50 in chips)
Seat 7: FL3MrLspcF23LYvC4ipBOA ($101.50 in chips)
Seat 8: /zy+DB4S5fUQUSfZWFzYGw ($113.25 in chips)
Seat 9: o6JyUkbzCDw8tUabqtmnlg ($57.60 in chips)
gUUvmqdVlmvpal6B8nYrmg: posts small blind $0.50
FL3MrLspcF23LYvC4ipBOA: posts big blind $1
*** HOLE CARDS ***
/zy+DB4S5fUQUSfZWFzYGw: raises $2 to $3
o6JyUkbzCDw8tUabqtmnlg: folds
N9n5Wc3s35DpCrOAUUNAaQ: calls $3
r27C1nIV4NS4+qbnrgBQSw: folds
jDwhY1kCdc6EkAHbT7PJMQ: folds
UWB3oeddt/GObx2Mix2Anw: folds
gUUvmqdVlmvpal6B8nYrmg: folds
FL3MrLspcF23LYvC4ipBOA: folds
*** FLOP *** [Js 6d 6s]
/zy+DB4S5fUQUSfZWFzYGw: checks
N9n5Wc3s35DpCrOAUUNAaQ: bets $5
/zy+DB4S5fUQUSfZWFzYGw: folds
N9n5Wc3s35DpCrOAUUNAaQ collected $7.15 from pot
*** SUMMARY ***
Total pot $7.50 | Rake $0.35
Board [Js 6d 6s]
Seat 1: N9n5Wc3s35DpCrOAUUNAaQ collected ($7.15)
Seat 2: r27C1nIV4NS4+qbnrgBQSw folded before Flop (didn't bet)
Seat 3: jDwhY1kCdc6EkAHbT7PJMQ folded before Flop (didn't bet)
Seat 4: UWB3oeddt/GObx2Mix2Anw (button) folded before Flop (didn't bet)
Seat 6: gUUvmqdVlmvpal6B8nYrmg (small blind) folded before Flop
Seat 7: FL3MrLspcF23LYvC4ipBOA (big blind) folded before Flop
Seat 8: /zy+DB4S5fUQUSfZWFzYGw folded on the Flop
Seat 9: o6JyUkbzCDw8tUabqtmnlg folded before Flop (didn't bet)



PokerStars Game #59939121612:  Hold'em No Limit ($0.50/$1.00) - 2009/07/01 0:31:51 ET
Table '/RZcOwpZpHQ+OwPwjsbnRw' 6-max Seat #5 is the button
Seat 1: Zboa6dColKGHBjLPUakZjw ($48.20 in chips)
Seat 2: dHC9PH9hdH3Ad2TD8ZxX0Q ($44.25 in chips)
Seat 3: OigyyiK+tTj1APPIAUmXDA ($72.65 in chips)
Seat 4: j7NIOHLZk7V2o9fOioO5ug ($115.10 in chips)
Seat 5: wx3sQGkVi2x9wJXuWNHPBw ($204.65 in chips)
Seat 6: XOIf9W+VAxhZqN+SYoyMKA ($248.30 in chips)
XOIf9W+VAxhZqN+SYoyMKA: posts small blind $0.50
Zboa6dColKGHBjLPUakZjw: posts big blind $1
*** HOLE CARDS ***
dHC9PH9hdH3Ad2TD8ZxX0Q: folds
OigyyiK+tTj1APPIAUmXDA: folds
j7NIOHLZk7V2o9fOioO5ug: folds
wx3sQGkVi2x9wJXuWNHPBw: raises $2 to $3
XOIf9W+VAxhZqN+SYoyMKA: folds
Zboa6dColKGHBjLPUakZjw: calls $2
*** FLOP *** [Tc Jh Ks]
Zboa6dColKGHBjLPUakZjw: bets $2
wx3sQGkVi2x9wJXuWNHPBw: calls $2
*** TURN *** [Tc Jh Ks] [3c]
Zboa6dColKGHBjLPUakZjw: bets $2
wx3sQGkVi2x9wJXuWNHPBw: folds
Zboa6dColKGHBjLPUakZjw collected $10 from pot
Zboa6dColKGHBjLPUakZjw: doesn't show hand
*** SUMMARY ***
Total pot $10.50 | Rake $0.50
Board [Tc Jh Ks 3c]
Seat 1: Zboa6dColKGHBjLPUakZjw (big blind) collected ($10)
Seat 2: dHC9PH9hdH3Ad2TD8ZxX0Q folded before Flop (didn't bet)
Seat 3: OigyyiK+tTj1APPIAUmXDA folded before Flop (didn't bet)
Seat 4: j7NIOHLZk7V2o9fOioO5ug folded before Flop (didn't bet)
Seat 5: wx3sQGkVi2x9wJXuWNHPBw (button) folded on the Turn
Seat 6: XOIf9W+VAxhZqN+SYoyMKA (small blind) folded before Flop



PokerStars Game #59939122754:  Hold'em No Limit ($0.50/$1.00) - 2009/07/01 0:31:53 ET
Table 'pHrhryH8jPNdQfY62f8v+g' 6-max Seat #5 is the button
Seat 1: BdbmJTZZ47quA9vUWwXtlw ($72.80 in chips)
Seat 2: RqgF7gRoKgRNW8Zoi1ty4A ($116.50 in chips)
Seat 3: 0WjiuIT7/EolY1oOx1ngeA ($109.55 in chips)
Seat 4: wenbG7TaM3H7h5kn78OFNw ($51.45 in chips)
Seat 5: r1/R7y0Ortgoz4lccgW8VA ($66.15 in chips)
Seat 6: xAU6q2/cwmby2sxmA8VcmA ($103.30 in chips)
xAU6q2/cwmby2sxmA8VcmA: posts small blind $0.50
BdbmJTZZ47quA9vUWwXtlw: posts big blind $1
*** HOLE CARDS ***
RqgF7gRoKgRNW8Zoi1ty4A: folds
0WjiuIT7/EolY1oOx1ngeA: folds
wenbG7TaM3H7h5kn78OFNw: raises $2 to $3
r1/R7y0Ortgoz4lccgW8VA: calls $3
xAU6q2/cwmby2sxmA8VcmA: folds
BdbmJTZZ47quA9vUWwXtlw: folds
*** FLOP *** [2d 7s Tc]
wenbG7TaM3H7h5kn78OFNw: checks
r1/R7y0Ortgoz4lccgW8VA: checks
*** TURN *** [2d 7s Tc] [Js]
wenbG7TaM3H7h5kn78OFNw: checks
r1/R7y0Ortgoz4lccgW8VA: bets $3
wenbG7TaM3H7h5kn78OFNw: calls $3
*** RIVER *** [2d 7s Tc Js] [As]
wenbG7TaM3H7h5kn78OFNw: bets $5
r1/R7y0Ortgoz4lccgW8VA: folds
wenbG7TaM3H7h5kn78OFNw collected $12.85 from pot
*** SUMMARY ***
Total pot $13.50 | Rake $0.65
Board [2d 7s Tc Js As]
Seat 1: BdbmJTZZ47quA9vUWwXtlw (big blind) folded before Flop
Seat 2: RqgF7gRoKgRNW8Zoi1ty4A folded before Flop (didn't bet)
Seat 3: 0WjiuIT7/EolY1oOx1ngeA folded before Flop (didn't bet)
Seat 4: wenbG7TaM3H7h5kn78OFNw collected ($12.85)
Seat 5: r1/R7y0Ortgoz4lccgW8VA (button) folded on the River
Seat 6: xAU6q2/cwmby2sxmA8VcmA (small blind) folded before Flop



PokerStars Game #59939123344:  Hold'em No Limit ($0.50/$1.00) - 2009/07/01 0:31:54 ET
Table 'QBLDswtHe7Ml0HwAdcMhlw' 2-max Seat #2 is the button
Seat 1: hdNlhiCwI533uwvvTTfC9Q ($101.50 in chips)
Seat 2: rAtTyvrJ8f1LaUh2O5U4nA ($29.70 in chips)
rAtTyvrJ8f1LaUh2O5U4nA: posts small blind $0.50
hdNlhiCwI533uwvvTTfC9Q: posts big blind $1
*** HOLE CARDS ***
rAtTyvrJ8f1LaUh2O5U4nA: raises $3 to $4
hdNlhiCwI533uwvvTTfC9Q: folds
rAtTyvrJ8f1LaUh2O5U4nA collected $2 from pot
*** SUMMARY ***
Total pot $2 | Rake $0
Seat 1: hdNlhiCwI533uwvvTTfC9Q (big blind) folded before Flop
Seat 2: rAtTyvrJ8f1LaUh2O5U4nA (button) (small blind) collected ($2)



PokerStars Game #59939124082:  Hold'em No Limit ($0.50/$1.00) - 2009/07/01 0:31:55 ET
Table 'MUPc8FEpe/nR0BKSeReX6Q' 6-max Seat #6 is the button
Seat 1: YsLQ3BAvgQHWXMAv3Wv6Hg ($100.50 in chips)
Seat 2: xAU6q2/cwmby2sxmA8VcmA ($110.50 in chips)
Seat 3: wx3sQGkVi2x9wJXuWNHPBw ($234.05 in chips)
Seat 4: ZA1bp6g8IwtTxkUE4eCjDQ ($119.10 in chips)
Seat 5: UBZQqpnJZdTYYY1FTb0rLA ($100 in chips)
Seat 6: oxnw0GLLpFanjhGkxfRSqA ($50.60 in chips)
YsLQ3BAvgQHWXMAv3Wv6Hg: posts small blind $0.50
xAU6q2/cwmby2sxmA8VcmA: posts big blind $1
*** HOLE CARDS ***
wx3sQGkVi2x9wJXuWNHPBw: folds
ZA1bp6g8IwtTxkUE4eCjDQ: folds
UBZQqpnJZdTYYY1FTb0rLA: folds
oxnw0GLLpFanjhGkxfRSqA: raises $2 to $3
YsLQ3BAvgQHWXMAv3Wv6Hg: folds
xAU6q2/cwmby2sxmA8VcmA: folds
oxnw0GLLpFanjhGkxfRSqA collected $2.50 from pot
*** SUMMARY ***
Total pot $2.50 | Rake $0
Seat 1: YsLQ3BAvgQHWXMAv3Wv6Hg (small blind) folded before Flop
Seat 2: xAU6q2/cwmby2sxmA8VcmA (big blind) folded before Flop
Seat 3: wx3sQGkVi2x9wJXuWNHPBw folded before Flop (didn't bet)
Seat 4: ZA1bp6g8IwtTxkUE4eCjDQ folded before Flop (didn't bet)
Seat 5: UBZQqpnJZdTYYY1FTb0rLA folded before Flop (didn't bet)
Seat 6: oxnw0GLLpFanjhGkxfRSqA (button) collected ($2.50)



PokerStars Game #59939124258:  Hold'em No Limit ($0.50/$1.00) - 2009/07/01 0:31:56 ET
Table '6YvsYDPNIDx2v5z3bJnwZQ' 9-max Seat #3 is the button
Seat 1: Ogn4JDV3mp4ZDKO49IFzKA ($14.50 in chips)
Seat 2: 35DmRulmD2MgzT6Bbt6/2w ($34.10 in chips)
Seat 3: negfosHnGOZXSHpWDRKyBQ ($19.30 in chips)
Seat 4: kEr5NYB+JIG5+szcYMr6hA ($45.50 in chips)
Seat 5: mBRWbnUl8diyBO1qTJaNzw ($162.20 in chips)
Seat 6: uMPEfCcGCfsxmy53tVUMug ($106.40 in chips)
Seat 7: boixc27eqTYA1p0tUdMuBQ ($114 in chips)
Seat 8: PSFxpXgPedVZyHSu2Zhb7Q ($63.75 in chips)
Seat 9: jDwhY1kCdc6EkAHbT7PJMQ ($105.60 in chips)
kEr5NYB+JIG5+szcYMr6hA: posts small blind $0.50
mBRWbnUl8diyBO1qTJaNzw: posts big blind $1
*** HOLE CARDS ***
uMPEfCcGCfsxmy53tVUMug: folds
boixc27eqTYA1p0tUdMuBQ: folds
PSFxpXgPedVZyHSu2Zhb7Q: raises $2 to $3
jDwhY1kCdc6EkAHbT7PJMQ: folds
Ogn4JDV3mp4ZDKO49IFzKA: folds
35DmRulmD2MgzT6Bbt6/2w: folds
negfosHnGOZXSHpWDRKyBQ: folds
kEr5NYB+JIG5+szcYMr6hA: folds
mBRWbnUl8diyBO1qTJaNzw: folds
PSFxpXgPedVZyHSu2Zhb7Q collected $2.50 from pot
*** SUMMARY ***
Total pot $2.50 | Rake $0
Seat 1: Ogn4JDV3mp4ZDKO49IFzKA folded before Flop (didn't bet)
Seat 2: 35DmRulmD2MgzT6Bbt6/2w folded before Flop (didn't bet)
Seat 3: negfosHnGOZXSHpWDRKyBQ (button) folded before Flop (didn't bet)
Seat 4: kEr5NYB+JIG5+szcYMr6hA (small blind) folded before Flop
Seat 5: mBRWbnUl8diyBO1qTJaNzw (big blind) folded before Flop
Seat 6: uMPEfCcGCfsxmy53tVUMug folded before Flop (didn't bet)
Seat 7: boixc27eqTYA1p0tUdMuBQ folded before Flop (didn't bet)
Seat 8: PSFxpXgPedVZyHSu2Zhb7Q collected ($2.50)
Seat 9: jDwhY1kCdc6EkAHbT7PJMQ folded before Flop (didn't bet)



PokerStars Game #59939124526:  Hold'em No Limit ($0.50/$1.00) - 2009/07/01 0:31:56 ET
Table 'SQLOQoANiHscJ8AL7zffbw' 9-max Seat #6 is the button
Seat 1: jPTRd6SpCp4xqAy2XQiTOw ($101.85 in chips)
Seat 2: /zy+DB4S5fUQUSfZWFzYGw ($281.85 in chips)
Seat 3: 0eFnow7+D7veCYQ+CG9FFw ($74.15 in chips)
Seat 4: N9n5Wc3s35DpCrOAUUNAaQ ($91.30 in chips)
Seat 5: L9njYvloJ1NdXjP8edHEAg ($109.05 in chips)
Seat 6: p5UKaxVobvptF0ANhR/q1A ($155.50 in chips)
Seat 7: bJckevFOcg//s0qyMQI6sQ ($102.55 in chips)
Seat 9: qJr25HAtvv1w/7IBvjMM3g ($246.75 in chips)
bJckevFOcg//s0qyMQI6sQ: posts small blind $0.50
9ce+0Dl3d0BeEFIP+8HezA: is sitting out
qJr25HAtvv1w/7IBvjMM3g: posts big blind $1
*** HOLE CARDS ***
9ce+0Dl3d0BeEFIP+8HezA leaves the table
jPTRd6SpCp4xqAy2XQiTOw: folds
/zy+DB4S5fUQUSfZWFzYGw: raises $3 to $4
0eFnow7+D7veCYQ+CG9FFw: folds
N9n5Wc3s35DpCrOAUUNAaQ: calls $4
L9njYvloJ1NdXjP8edHEAg: folds
p5UKaxVobvptF0ANhR/q1A: folds
bJckevFOcg//s0qyMQI6sQ: folds
qJr25HAtvv1w/7IBvjMM3g: folds
*** FLOP *** [9d Qc 6s]
/zy+DB4S5fUQUSfZWFzYGw: checks
N9n5Wc3s35DpCrOAUUNAaQ: checks
*** TURN *** [9d Qc 6s] [2d]
/zy+DB4S5fUQUSfZWFzYGw: checks
N9n5Wc3s35DpCrOAUUNAaQ: bets $5
/zy+DB4S5fUQUSfZWFzYGw: folds
N9n5Wc3s35DpCrOAUUNAaQ collected $9.05 from pot
N9n5Wc3s35DpCrOAUUNAaQ: doesn't show hand
*** SUMMARY ***
Total pot $9.50 | Rake $0.45
Board [9d Qc 6s 2d]
Seat 1: jPTRd6SpCp4xqAy2XQiTOw folded before Flop (didn't bet)
Seat 2: /zy+DB4S5fUQUSfZWFzYGw folded on the Turn
Seat 3: 0eFnow7+D7veCYQ+CG9FFw folded before Flop (didn't bet)
Seat 4: N9n5Wc3s35DpCrOAUUNAaQ collected ($9.05)
Seat 5: L9njYvloJ1NdXjP8edHEAg folded before Flop (didn't bet)
Seat 6: p5UKaxVobvptF0ANhR/q1A (button) folded before Flop (didn't bet)
Seat 7: bJckevFOcg//s0qyMQI6sQ (small blind) folded before Flop
Seat 9: qJr25HAtvv1w/7IBvjMM3g (big blind) folded before Flop



PokerStars Game #59939125412:  Hold'em No Limit ($0.50/$1.00) - 2009/07/01 0:31:57 ET
Table '+cA8mcmhaedZ7YcrDdhmeQ' 6-max Seat #1 is the button
Seat 1: lsLuWlcPA3Rh7kJVLzMh0Q ($307.25 in chips)
Seat 2: RqgF7gRoKgRNW8Zoi1ty4A ($100 in chips)
Seat 4: LjL3AIERHn559yyW1mTUYQ ($98.50 in chips)
Seat 5: 6WyjEXOToimYmtLdqIgHYQ ($61.50 in chips)
Seat 6: YfsTQsY/fxb+YqbdclTHuw ($38.50 in chips)
RqgF7gRoKgRNW8Zoi1ty4A: posts small blind $0.50
0WjiuIT7/EolY1oOx1ngeA: is sitting out
LjL3AIERHn559yyW1mTUYQ: posts big blind $1
*** HOLE CARDS ***
0WjiuIT7/EolY1oOx1ngeA leaves the table
6WyjEXOToimYmtLdqIgHYQ: folds
YfsTQsY/fxb+YqbdclTHuw: calls $1
lsLuWlcPA3Rh7kJVLzMh0Q: folds
RqgF7gRoKgRNW8Zoi1ty4A: folds
LjL3AIERHn559yyW1mTUYQ: checks
*** FLOP *** [Ah 9c 4s]
LjL3AIERHn559yyW1mTUYQ: checks
YfsTQsY/fxb+YqbdclTHuw: checks
*** TURN *** [Ah 9c 4s] [9h]
LjL3AIERHn559yyW1mTUYQ: checks
YfsTQsY/fxb+YqbdclTHuw: bets $3
LjL3AIERHn559yyW1mTUYQ: folds
YfsTQsY/fxb+YqbdclTHuw collected $2.40 from pot
*** SUMMARY ***
Total pot $2.50 | Rake $0.10
Board [Ah 9c 4s 9h]
Seat 1: lsLuWlcPA3Rh7kJVLzMh0Q (button) folded before Flop (didn't bet)
Seat 2: RqgF7gRoKgRNW8Zoi1ty4A (small blind) folded before Flop
Seat 4: LjL3AIERHn559yyW1mTUYQ (big blind) folded on the Turn
Seat 5: 6WyjEXOToimYmtLdqIgHYQ folded before Flop (didn't bet)
Seat 6: YfsTQsY/fxb+YqbdclTHuw collected ($2.40)



PokerStars Game #59939125616:  Hold'em No Limit ($0.50/$1.00) - 2009/07/01 0:31:58 ET
Table '21a4iYFKcuezM4nYx8DWTA' 2-max Seat #1 is the button
Seat 1: NYi6JFscYNrofSXy4sM+Yw ($155 in chips)
Seat 2: +sy/nlNI20yZraIjs4AALg ($44.70 in chips)
NYi6JFscYNrofSXy4sM+Yw: posts small blind $0.50
+sy/nlNI20yZraIjs4AALg: posts big blind $1
*** HOLE CARDS ***
NYi6JFscYNrofSXy4sM+Yw: raises $2 to $3
+sy/nlNI20yZraIjs4AALg: raises $7 to $10
NYi6JFscYNrofSXy4sM+Yw: folds
+sy/nlNI20yZraIjs4AALg collected $6 from pot
*** SUMMARY ***
Total pot $6 | Rake $0
Seat 1: NYi6JFscYNrofSXy4sM+Yw (button) (small blind) folded before Flop
Seat 2: +sy/nlNI20yZraIjs4AALg (big blind) collected ($6)



PokerStars Game #59939128854:  Hold'em No Limit ($0.50/$1.00) - 2009/07/01 0:32:02 ET
Table '7Nl0ffnjeK44/vmeexh3MQ' 9-max Seat #2 is the button
Seat 1: s7D3Y+k4Cj4D1cXHv7oj+Q ($99.45 in chips)
Seat 2: kiakSwxX0e64PwYGAPQvLw ($32.35 in chips)
Seat 3: vR4IO10geOgvTW+LAUBv/A ($100 in chips)
Seat 4: bLbSOSmSOnqE0iTcH/5dxA ($100 in chips)
Seat 5: bL+QVeDcuEdzMGAGg2XJHg ($108.40 in chips)
Seat 6: FVs16t7GgfWgQWt4JxsObQ ($11.40 in chips)
Seat 7: knewtTmBc4Tc0z/5tAABYQ ($105 in chips)
Seat 8: zanka7aAZkigmZpfopXxxA ($229.20 in chips)
Seat 9: ouwUBGRKnKK9uhn1G4Lf+A ($99.50 in chips)
vR4IO10geOgvTW+LAUBv/A: posts small blind $0.50
bLbSOSmSOnqE0iTcH/5dxA: posts big blind $1
*** HOLE CARDS ***
bL+QVeDcuEdzMGAGg2XJHg: folds
FVs16t7GgfWgQWt4JxsObQ: folds
knewtTmBc4Tc0z/5tAABYQ: folds
zanka7aAZkigmZpfopXxxA has timed out
zanka7aAZkigmZpfopXxxA: folds
zanka7aAZkigmZpfopXxxA is sitting out
zanka7aAZkigmZpfopXxxA has returned
ouwUBGRKnKK9uhn1G4Lf+A: folds
s7D3Y+k4Cj4D1cXHv7oj+Q: folds
kiakSwxX0e64PwYGAPQvLw: raises $2 to $3
vR4IO10geOgvTW+LAUBv/A: folds
bLbSOSmSOnqE0iTcH/5dxA: folds
kiakSwxX0e64PwYGAPQvLw collected $2.50 from pot
*** SUMMARY ***
Total pot $2.50 | Rake $0
Seat 1: s7D3Y+k4Cj4D1cXHv7oj+Q folded before Flop (didn't bet)
Seat 2: kiakSwxX0e64PwYGAPQvLw (button) collected ($2.50)
Seat 3: vR4IO10geOgvTW+LAUBv/A (small blind) folded before Flop
Seat 4: bLbSOSmSOnqE0iTcH/5dxA (big blind) folded before Flop
Seat 5: bL+QVeDcuEdzMGAGg2XJHg folded before Flop (didn't bet)
Seat 6: FVs16t7GgfWgQWt4JxsObQ folded before Flop (didn't bet)
Seat 7: knewtTmBc4Tc0z/5tAABYQ folded before Flop (didn't bet)
Seat 8: zanka7aAZkigmZpfopXxxA folded before Flop (didn't bet)
Seat 9: ouwUBGRKnKK9uhn1G4Lf+A folded before Flop (didn't bet)



PokerStars Game #59939129094:  Hold'em No Limit ($0.50/$1.00) - 2009/07/01 0:32:03 ET
Table 'vs/5jr6ciwjVQ5+Soc+u2A' 6-max Seat #5 is the button
Seat 1: 3yN2jRjZ+glIaWtGMmKOrA ($20 in chips)
Seat 2: XOIf9W+VAxhZqN+SYoyMKA ($122.65 in chips)
Seat 3: G5ZSSN6RSON3gkNvk/SmYg ($100 in chips)
Seat 4: KpnW5CcJ4Mg6MeclfKmLrw ($113.80 in chips)
Seat 5: 7Vc9JmGFQwMRh5Tj9ui5Lw ($96.65 in chips)
Seat 6: QHvTZcrKe6+maWUfVjP29Q ($102 in chips)
QHvTZcrKe6+maWUfVjP29Q: posts small blind $0.50
3yN2jRjZ+glIaWtGMmKOrA: posts big blind $1
*** HOLE CARDS ***
XOIf9W+VAxhZqN+SYoyMKA: folds
G5ZSSN6RSON3gkNvk/SmYg: folds
KpnW5CcJ4Mg6MeclfKmLrw: raises $2 to $3
7Vc9JmGFQwMRh5Tj9ui5Lw: calls $3
QHvTZcrKe6+maWUfVjP29Q: folds
3yN2jRjZ+glIaWtGMmKOrA: calls $2
*** FLOP *** [Th Ks 8d]
3yN2jRjZ+glIaWtGMmKOrA: bets $1
KpnW5CcJ4Mg6MeclfKmLrw: calls $1
7Vc9JmGFQwMRh5Tj9ui5Lw: raises $4 to $5
3yN2jRjZ+glIaWtGMmKOrA: folds
KpnW5CcJ4Mg6MeclfKmLrw: folds
7Vc9JmGFQwMRh5Tj9ui5Lw collected $11.90 from pot
7Vc9JmGFQwMRh5Tj9ui5Lw: doesn't show hand
*** SUMMARY ***
Total pot $12.50 | Rake $0.60
Board [Th Ks 8d]
Seat 1: 3yN2jRjZ+glIaWtGMmKOrA (big blind) folded on the Flop
Seat 2: XOIf9W+VAxhZqN+SYoyMKA folded before Flop (didn't bet)
Seat 3: G5ZSSN6RSON3gkNvk/SmYg folded before Flop (didn't bet)
Seat 4: KpnW5CcJ4Mg6MeclfKmLrw folded on the Flop
Seat 5: 7Vc9JmGFQwMRh5Tj9ui5Lw (button) collected ($11.90)
Seat 6: QHvTZcrKe6+maWUfVjP29Q (small blind) folded before Flop



PokerStars Game #59939130946:  Hold'em No Limit ($0.50/$1.00) - 2009/07/01 0:32:05 ET
Table 'cBDNutyLBKEk9+ptwsKmTw' 6-max Seat #6 is the button
Seat 1: xAU6q2/cwmby2sxmA8VcmA ($100 in chips)
Seat 2: Gy1fd4JyD1aNBFFlOGzbJQ ($28.70 in chips)
Seat 3: G5ZSSN6RSON3gkNvk/SmYg ($111.90 in chips)
Seat 4: 0WjiuIT7/EolY1oOx1ngeA ($103.15 in chips)
Seat 5: OGMLOcTNYZXZU81au7ztUw ($118.75 in chips)
Seat 6: NqVlOSH2lp+pp/TK3vvK5g ($41 in chips)
xAU6q2/cwmby2sxmA8VcmA: posts small blind $0.50
Gy1fd4JyD1aNBFFlOGzbJQ: posts big blind $1
*** HOLE CARDS ***
G5ZSSN6RSON3gkNvk/SmYg: folds
0WjiuIT7/EolY1oOx1ngeA: folds
OGMLOcTNYZXZU81au7ztUw: folds
NqVlOSH2lp+pp/TK3vvK5g: raises $1 to $2
xAU6q2/cwmby2sxmA8VcmA: folds
Gy1fd4JyD1aNBFFlOGzbJQ: calls $1
*** FLOP *** [2c 8c Ks]
Gy1fd4JyD1aNBFFlOGzbJQ: checks
NqVlOSH2lp+pp/TK3vvK5g: bets $1
Gy1fd4JyD1aNBFFlOGzbJQ: folds
NqVlOSH2lp+pp/TK3vvK5g collected $4.30 from pot
*** SUMMARY ***
Total pot $4.50 | Rake $0.20
Board [2c 8c Ks]
Seat 1: xAU6q2/cwmby2sxmA8VcmA (small blind) folded before Flop
Seat 2: Gy1fd4JyD1aNBFFlOGzbJQ (big blind) folded on the Flop
Seat 3: G5ZSSN6RSON3gkNvk/SmYg folded before Flop (didn't bet)
Seat 4: 0WjiuIT7/EolY1oOx1ngeA folded before Flop (didn't bet)
Seat 5: OGMLOcTNYZXZU81au7ztUw folded before Flop (didn't bet)
Seat 6: NqVlOSH2lp+pp/TK3vvK5g (button) collected ($4.30)



PokerStars Game #59939130566:  Hold'em No Limit ($0.50/$1.00) - 2009/07/01 0:32:05 ET
Table 'QBLDswtHe7Ml0HwAdcMhlw' 2-max Seat #1 is the button
Seat 1: hdNlhiCwI533uwvvTTfC9Q ($100.50 in chips)
Seat 2: rAtTyvrJ8f1LaUh2O5U4nA ($30.70 in chips)
hdNlhiCwI533uwvvTTfC9Q: posts small blind $0.50
rAtTyvrJ8f1LaUh2O5U4nA: posts big blind $1
*** HOLE CARDS ***
hdNlhiCwI533uwvvTTfC9Q: folds
rAtTyvrJ8f1LaUh2O5U4nA collected $1 from pot
*** SUMMARY ***
Total pot $1 | Rake $0
Seat 1: hdNlhiCwI533uwvvTTfC9Q (button) (small blind) folded before Flop
Seat 2: rAtTyvrJ8f1LaUh2O5U4nA (big blind) collected ($1)



PokerStars Game #59939131092:  Hold'em No Limit ($0.50/$1.00) - 2009/07/01 0:32:06 ET
Table '/FUb199IViHMJHi5YWmeuQ' 9-max Seat #7 is the button
Seat 1: TZcz9MEWDA+WydgGruqqbw ($101.85 in chips)
Seat 2: FL3MrLspcF23LYvC4ipBOA ($137.25 in chips)
Seat 3: qN483QJ1NvHbdIZB7J4ARw ($61.35 in chips)
Seat 6: ccFf7Q4z1cTGQmeoYiWEfw ($51.95 in chips)
Seat 7: bLbSOSmSOnqE0iTcH/5dxA ($100 in chips)
Seat 8: QIWvt0R766g8KfH0vl1s0A ($33.40 in chips)
Seat 9: knewtTmBc4Tc0z/5tAABYQ ($155.15 in chips)
QIWvt0R766g8KfH0vl1s0A: posts small blind $0.50
knewtTmBc4Tc0z/5tAABYQ: posts big blind $1
qheQay5YvP2DMAb3OUSxtw: sits out
*** HOLE CARDS ***
TZcz9MEWDA+WydgGruqqbw: folds
FL3MrLspcF23LYvC4ipBOA: folds
qN483QJ1NvHbdIZB7J4ARw: folds
ccFf7Q4z1cTGQmeoYiWEfw: folds
bLbSOSmSOnqE0iTcH/5dxA: folds
QIWvt0R766g8KfH0vl1s0A: folds
knewtTmBc4Tc0z/5tAABYQ collected $1 from pot
knewtTmBc4Tc0z/5tAABYQ: doesn't show hand
*** SUMMARY ***
Total pot $1 | Rake $0
Seat 1: TZcz9MEWDA+WydgGruqqbw folded before Flop (didn't bet)
Seat 2: FL3MrLspcF23LYvC4ipBOA folded before Flop (didn't bet)
Seat 3: qN483QJ1NvHbdIZB7J4ARw folded before Flop (didn't bet)
Seat 6: ccFf7Q4z1cTGQmeoYiWEfw folded before Flop (didn't bet)
Seat 7: bLbSOSmSOnqE0iTcH/5dxA (button) folded before Flop (didn't bet)
Seat 8: QIWvt0R766g8KfH0vl1s0A (small blind) folded before Flop
Seat 9: knewtTmBc4Tc0z/5tAABYQ (big blind) collected ($1)



PokerStars Game #59939133982:  Hold'em No Limit ($0.50/$1.00) - 2009/07/01 0:32:10 ET
Table 'GxCPo/gd3OSthkYrAxJngg' 6-max Seat #1 is the button
Seat 1: sH8BpAFP+jGFxCgVpD1Lew ($278.45 in chips)
Seat 2: YExX2paeIHrmfIwV1ivM/w ($64.20 in chips)
Seat 3: o6plE+MSW4XFNTeONe16xg ($34.10 in chips)
Seat 4: YMJG+F++3Aj6P8dAWda5fw ($109.65 in chips)
Seat 5: G5ZSSN6RSON3gkNvk/SmYg ($103.20 in chips)
Seat 6: sS9IXedL3MiRmpVXhAILhw ($98.30 in chips)
YExX2paeIHrmfIwV1ivM/w: posts small blind $0.50
o6plE+MSW4XFNTeONe16xg: posts big blind $1
*** HOLE CARDS ***
YMJG+F++3Aj6P8dAWda5fw: folds
G5ZSSN6RSON3gkNvk/SmYg: folds
sS9IXedL3MiRmpVXhAILhw: folds
sH8BpAFP+jGFxCgVpD1Lew: folds
YExX2paeIHrmfIwV1ivM/w: folds
o6plE+MSW4XFNTeONe16xg collected $1 from pot
*** SUMMARY ***
Total pot $1 | Rake $0
Seat 1: sH8BpAFP+jGFxCgVpD1Lew (button) folded before Flop (didn't bet)
Seat 2: YExX2paeIHrmfIwV1ivM/w (small blind) folded before Flop
Seat 3: o6plE+MSW4XFNTeONe16xg (big blind) collected ($1)
Seat 4: YMJG+F++3Aj6P8dAWda5fw folded before Flop (didn't bet)
Seat 5: G5ZSSN6RSON3gkNvk/SmYg folded before Flop (didn't bet)
Seat 6: sS9IXedL3MiRmpVXhAILhw folded before Flop (didn't bet)



PokerStars Game #59939134542:  Hold'em No Limit ($0.50/$1.00) - 2009/07/01 0:32:10 ET
Table 'O96CPOtvMBWP6kzuYDfdFA' 6-max Seat #2 is the button
Seat 1: 6alLXQIITA2EZ/lBeym8Dw ($100 in chips)
Seat 2: sc/HX9smXU5kObrOWIYO5g ($35 in chips)
Seat 3: V89DGjxE171oPREEbAXiyg ($38.55 in chips)
Seat 4: KOG8rG51mOvIoY96zF3kvw ($162.75 in chips)
Seat 5: wRxiu9OJzvvN84OYWW9jxQ ($136.60 in chips)
Seat 6: xNKcQzD9+/iHmtJn4vYq9w ($141.65 in chips)
V89DGjxE171oPREEbAXiyg: posts small blind $0.50
KOG8rG51mOvIoY96zF3kvw: posts big blind $1
*** HOLE CARDS ***
wRxiu9OJzvvN84OYWW9jxQ: calls $1
xNKcQzD9+/iHmtJn4vYq9w: folds
6alLXQIITA2EZ/lBeym8Dw: folds
sc/HX9smXU5kObrOWIYO5g: folds
V89DGjxE171oPREEbAXiyg: calls $0.50
KOG8rG51mOvIoY96zF3kvw: checks
*** FLOP *** [2h 8s 2s]
V89DGjxE171oPREEbAXiyg: checks
KOG8rG51mOvIoY96zF3kvw: bets $3
wRxiu9OJzvvN84OYWW9jxQ: folds
V89DGjxE171oPREEbAXiyg: folds
KOG8rG51mOvIoY96zF3kvw collected $2.85 from pot
*** SUMMARY ***
Total pot $3 | Rake $0.15
Board [2h 8s 2s]
Seat 1: 6alLXQIITA2EZ/lBeym8Dw folded before Flop (didn't bet)
Seat 2: sc/HX9smXU5kObrOWIYO5g (button) folded before Flop (didn't bet)
Seat 3: V89DGjxE171oPREEbAXiyg (small blind) folded on the Flop
Seat 4: KOG8rG51mOvIoY96zF3kvw (big blind) collected ($2.85)
Seat 5: wRxiu9OJzvvN84OYWW9jxQ folded on the Flop
Seat 6: xNKcQzD9+/iHmtJn4vYq9w folded before Flop (didn't bet)



PokerStars Game #59939134794:  Hold'em No Limit ($0.50/$1.00) - 2009/07/01 0:32:11 ET
Table 'QBLDswtHe7Ml0HwAdcMhlw' 2-max Seat #2 is the button
Seat 1: hdNlhiCwI533uwvvTTfC9Q ($100 in chips)
Seat 2: rAtTyvrJ8f1LaUh2O5U4nA ($31.20 in chips)
rAtTyvrJ8f1LaUh2O5U4nA: posts small blind $0.50
hdNlhiCwI533uwvvTTfC9Q: posts big blind $1
*** HOLE CARDS ***
rAtTyvrJ8f1LaUh2O5U4nA: raises $2 to $3
hdNlhiCwI533uwvvTTfC9Q: folds
rAtTyvrJ8f1LaUh2O5U4nA collected $2 from pot
rAtTyvrJ8f1LaUh2O5U4nA: doesn't show hand
*** SUMMARY ***
Total pot $2 | Rake $0
Seat 1: hdNlhiCwI533uwvvTTfC9Q (big blind) folded before Flop
Seat 2: rAtTyvrJ8f1LaUh2O5U4nA (button) (small blind) collected ($2)



PokerStars Game #59939135332:  Hold'em No Limit ($0.50/$1.00) - 2009/07/01 0:32:12 ET
Table '21a4iYFKcuezM4nYx8DWTA' 2-max Seat #2 is the button
Seat 1: NYi6JFscYNrofSXy4sM+Yw ($152 in chips)
Seat 2: +sy/nlNI20yZraIjs4AALg ($47.70 in chips)
+sy/nlNI20yZraIjs4AALg: posts small blind $0.50
NYi6JFscYNrofSXy4sM+Yw: posts big blind $1
*** HOLE CARDS ***
+sy/nlNI20yZraIjs4AALg: calls $0.50
NYi6JFscYNrofSXy4sM+Yw: checks
*** FLOP *** [3s 8s 6c]
NYi6JFscYNrofSXy4sM+Yw: bets $2
+sy/nlNI20yZraIjs4AALg: raises $2 to $4
NYi6JFscYNrofSXy4sM+Yw: folds
+sy/nlNI20yZraIjs4AALg collected $5.75 from pot
*** SUMMARY ***
Total pot $6 | Rake $0.25
Board [3s 8s 6c]
Seat 1: NYi6JFscYNrofSXy4sM+Yw (big blind) folded on the Flop
Seat 2: +sy/nlNI20yZraIjs4AALg (button) (small blind) collected ($5.75)



PokerStars Game #59939135636:  Hold'em No Limit ($0.50/$1.00) - 2009/07/01 0:32:12 ET
Table 'ZFWj23PMihdwrNWv41OG/Q' 9-max Seat #1 is the button
Seat 1: yAbu2QsRPVcjPbqlf/jDxw ($100 in chips)
Seat 2: ARfmgHcEUKh68laBZy4veA ($75.75 in chips)
Seat 3: G9Fo2TZCN7HI43Po4zSN3A ($103.50 in chips)
Seat 4: PEmogYqKpuv0ozeBbXL+7Q ($40 in chips)
Seat 5: tkdBeXTJlFsZdioidNqLow ($60 in chips)
Seat 6: tjhwe1V98x2spSoUQER3HQ ($104.50 in chips)
Seat 7: wIZ377kjl2fHFGnS93o6bw ($22.45 in chips)
Seat 8: knewtTmBc4Tc0z/5tAABYQ ($116.90 in chips)
Seat 9: gIabaXO0Nq08nuXlf56f0w ($20.90 in chips)
ARfmgHcEUKh68laBZy4veA: posts small blind $0.50
G9Fo2TZCN7HI43Po4zSN3A: posts big blind $1
gIabaXO0Nq08nuXlf56f0w: posts big blind $1
*** HOLE CARDS ***
PEmogYqKpuv0ozeBbXL+7Q: folds
tkdBeXTJlFsZdioidNqLow: folds
tjhwe1V98x2spSoUQER3HQ: folds
wIZ377kjl2fHFGnS93o6bw: folds
knewtTmBc4Tc0z/5tAABYQ: folds
gIabaXO0Nq08nuXlf56f0w: checks
yAbu2QsRPVcjPbqlf/jDxw: folds
ARfmgHcEUKh68laBZy4veA: calls $0.50
G9Fo2TZCN7HI43Po4zSN3A: checks
*** FLOP *** [3h Ad 5h]
ARfmgHcEUKh68laBZy4veA: checks
G9Fo2TZCN7HI43Po4zSN3A: checks
gIabaXO0Nq08nuXlf56f0w: checks
*** TURN *** [3h Ad 5h] [7s]
ARfmgHcEUKh68laBZy4veA: checks
G9Fo2TZCN7HI43Po4zSN3A: checks
gIabaXO0Nq08nuXlf56f0w: checks
*** RIVER *** [3h Ad 5h 7s] [5c]
ARfmgHcEUKh68laBZy4veA: checks
G9Fo2TZCN7HI43Po4zSN3A: checks
gIabaXO0Nq08nuXlf56f0w: checks
*** SHOW DOWN ***
ARfmgHcEUKh68laBZy4veA: shows [5s Ts] (three of a kind, Fives)
G9Fo2TZCN7HI43Po4zSN3A: mucks hand
gIabaXO0Nq08nuXlf56f0w: mucks hand
ARfmgHcEUKh68laBZy4veA collected $2.85 from pot
*** SUMMARY ***
Total pot $3 | Rake $0.15
Board [3h Ad 5h 7s 5c]
Seat 1: yAbu2QsRPVcjPbqlf/jDxw (button) folded before Flop (didn't bet)
Seat 2: ARfmgHcEUKh68laBZy4veA (small blind) showed [5s Ts] and won ($2.85) with three of a kind, Fives
Seat 3: G9Fo2TZCN7HI43Po4zSN3A (big blind) mucked
Seat 4: PEmogYqKpuv0ozeBbXL+7Q folded before Flop (didn't bet)
Seat 5: tkdBeXTJlFsZdioidNqLow folded before Flop (didn't bet)
Seat 6: tjhwe1V98x2spSoUQER3HQ folded before Flop (didn't bet)
Seat 7: wIZ377kjl2fHFGnS93o6bw folded before Flop (didn't bet)
Seat 8: knewtTmBc4Tc0z/5tAABYQ folded before Flop (didn't bet)
Seat 9: gIabaXO0Nq08nuXlf56f0w mucked



PokerStars Game #59939138376:  Hold'em No Limit ($0.50/$1.00) - 2009/07/01 0:32:16 ET
Table '8jIjWCPY0NGprquL+xcMFg' 9-max Seat #6 is the button
Seat 1: vR4IO10geOgvTW+LAUBv/A ($137.80 in chips)
Seat 2: rR1qGAf9Q9RYorKYWH3VKw ($5.15 in chips)
Seat 3: 58zdeSBSuSFX/qZfhc7YmA ($108.45 in chips)
Seat 4: by0z+YmujwI6Bf4qRFE8vA ($147.45 in chips)
Seat 5: n758Yw8Hx2S+6NQUPGqcqA ($87 in chips)
Seat 6: GTQkFJtSkbVbnGCktp6e3g ($100 in chips)
Seat 7: O3CGPwwUmamrCNHccOilrg ($48 in chips)
Seat 8: 9swGhtpERPngKPtvpoZkoQ ($151.80 in chips)
Seat 9: negfosHnGOZXSHpWDRKyBQ ($18.50 in chips)
O3CGPwwUmamrCNHccOilrg: posts small blind $0.50
9swGhtpERPngKPtvpoZkoQ: posts big blind $1
*** HOLE CARDS ***
negfosHnGOZXSHpWDRKyBQ: raises $3 to $4
vR4IO10geOgvTW+LAUBv/A: folds
rR1qGAf9Q9RYorKYWH3VKw: folds
58zdeSBSuSFX/qZfhc7YmA: folds
by0z+YmujwI6Bf4qRFE8vA: folds
n758Yw8Hx2S+6NQUPGqcqA: folds
GTQkFJtSkbVbnGCktp6e3g: folds
O3CGPwwUmamrCNHccOilrg: folds
9swGhtpERPngKPtvpoZkoQ: folds
negfosHnGOZXSHpWDRKyBQ collected $2.50 from pot
negfosHnGOZXSHpWDRKyBQ: doesn't show hand
*** SUMMARY ***
Total pot $2.50 | Rake $0
Seat 1: vR4IO10geOgvTW+LAUBv/A folded before Flop (didn't bet)
Seat 2: rR1qGAf9Q9RYorKYWH3VKw folded before Flop (didn't bet)
Seat 3: 58zdeSBSuSFX/qZfhc7YmA folded before Flop (didn't bet)
Seat 4: by0z+YmujwI6Bf4qRFE8vA folded before Flop (didn't bet)
Seat 5: n758Yw8Hx2S+6NQUPGqcqA folded before Flop (didn't bet)
Seat 6: GTQkFJtSkbVbnGCktp6e3g (button) folded before Flop (didn't bet)
Seat 7: O3CGPwwUmamrCNHccOilrg (small blind) folded before Flop
Seat 8: 9swGhtpERPngKPtvpoZkoQ (big blind) folded before Flop
Seat 9: negfosHnGOZXSHpWDRKyBQ collected ($2.50)



PokerStars Game #59939139370:  Hold'em No Limit ($0.50/$1.00) - 2009/07/01 0:32:18 ET
Table 'N2bNCDHL96aCQDvZIh+yQQ' 6-max Seat #2 is the button
Seat 1: iHo1oDbrEVJ8nEGdaPrICw ($143.50 in chips)
Seat 2: KpnW5CcJ4Mg6MeclfKmLrw ($111.90 in chips)
Seat 3: Qy/UBNbD2HaA0Ogxg8Sf3w ($100.50 in chips)
Seat 4: uCqEjnxh2/vFBjKYkfTOkw ($151.90 in chips)
Seat 5: rHlMOfR7kpQQxe+PFQz0xQ ($41.60 in chips)
Seat 6: TSuRyAHnUPCFjP7Z0rEE0w ($100 in chips)
Qy/UBNbD2HaA0Ogxg8Sf3w: posts small blind $0.50
uCqEjnxh2/vFBjKYkfTOkw: posts big blind $1
*** HOLE CARDS ***
rHlMOfR7kpQQxe+PFQz0xQ: folds
TSuRyAHnUPCFjP7Z0rEE0w: folds
iHo1oDbrEVJ8nEGdaPrICw: folds
KpnW5CcJ4Mg6MeclfKmLrw: folds
Qy/UBNbD2HaA0Ogxg8Sf3w: folds
uCqEjnxh2/vFBjKYkfTOkw collected $1 from pot
uCqEjnxh2/vFBjKYkfTOkw: doesn't show hand
*** SUMMARY ***
Total pot $1 | Rake $0
Seat 1: iHo1oDbrEVJ8nEGdaPrICw folded before Flop (didn't bet)
Seat 2: KpnW5CcJ4Mg6MeclfKmLrw (button) folded before Flop (didn't bet)
Seat 3: Qy/UBNbD2HaA0Ogxg8Sf3w (small blind) folded before Flop
Seat 4: uCqEjnxh2/vFBjKYkfTOkw (big blind) collected ($1)
Seat 5: rHlMOfR7kpQQxe+PFQz0xQ folded before Flop (didn't bet)
Seat 6: TSuRyAHnUPCFjP7Z0rEE0w folded before Flop (didn't bet)



PokerStars Game #59939140256:  Hold'em No Limit ($0.50/$1.00) - 2009/07/01 0:32:19 ET
Table 'Zka9tv1yilg0MvXWPQrShg' 9-max Seat #1 is the button
Seat 1: TZcz9MEWDA+WydgGruqqbw ($115.35 in chips)
Seat 2: rR1qGAf9Q9RYorKYWH3VKw ($24.70 in chips)
Seat 3: gUUvmqdVlmvpal6B8nYrmg ($102.50 in chips)
Seat 4: CTOae+JLIGfwfXvhqHkP2w ($163.65 in chips)
Seat 5: /zy+DB4S5fUQUSfZWFzYGw ($136.45 in chips)
Seat 6: rY8wPoax1lS+HUY+I0FZDw ($137.65 in chips)
Seat 7: p1SafS90nb3Uft5LB0NkHw ($17 in chips)
Seat 8: bL+QVeDcuEdzMGAGg2XJHg ($123.10 in chips)
Seat 9: 6daxhj43mWj04MOPTOmaYA ($96 in chips)
rR1qGAf9Q9RYorKYWH3VKw: posts small blind $0.50
gUUvmqdVlmvpal6B8nYrmg: posts big blind $1
*** HOLE CARDS ***
CTOae+JLIGfwfXvhqHkP2w: folds
/zy+DB4S5fUQUSfZWFzYGw: raises $3 to $4
rY8wPoax1lS+HUY+I0FZDw: folds
p1SafS90nb3Uft5LB0NkHw: folds
bL+QVeDcuEdzMGAGg2XJHg: calls $4
6daxhj43mWj04MOPTOmaYA: folds
TZcz9MEWDA+WydgGruqqbw: folds
rR1qGAf9Q9RYorKYWH3VKw: folds
gUUvmqdVlmvpal6B8nYrmg: folds
*** FLOP *** [5c 5h Kc]
/zy+DB4S5fUQUSfZWFzYGw: checks
bL+QVeDcuEdzMGAGg2XJHg: checks
*** TURN *** [5c 5h Kc] [Tc]
/zy+DB4S5fUQUSfZWFzYGw: bets $7
bL+QVeDcuEdzMGAGg2XJHg: folds
/zy+DB4S5fUQUSfZWFzYGw collected $9.05 from pot
/zy+DB4S5fUQUSfZWFzYGw: doesn't show hand
*** SUMMARY ***
Total pot $9.50 | Rake $0.45
Board [5c 5h Kc Tc]
Seat 1: TZcz9MEWDA+WydgGruqqbw (button) folded before Flop (didn't bet)
Seat 2: rR1qGAf9Q9RYorKYWH3VKw (small blind) folded before Flop
Seat 3: gUUvmqdVlmvpal6B8nYrmg (big blind) folded before Flop
Seat 4: CTOae+JLIGfwfXvhqHkP2w folded before Flop (didn't bet)
Seat 5: /zy+DB4S5fUQUSfZWFzYGw collected ($9.05)
Seat 6: rY8wPoax1lS+HUY+I0FZDw folded before Flop (didn't bet)
Seat 7: p1SafS90nb3Uft5LB0NkHw folded before Flop (didn't bet)
Seat 8: bL+QVeDcuEdzMGAGg2XJHg folded on the Turn
Seat 9: 6daxhj43mWj04MOPTOmaYA folded before Flop (didn't bet)



PokerStars Game #59939140932:  Hold'em No Limit ($0.50/$1.00) - 2009/07/01 0:32:20 ET
Table 'MUPc8FEpe/nR0BKSeReX6Q' 6-max Seat #1 is the button
Seat 1: YsLQ3BAvgQHWXMAv3Wv6Hg ($100 in chips)
Seat 2: xAU6q2/cwmby2sxmA8VcmA ($109.50 in chips)
Seat 3: wx3sQGkVi2x9wJXuWNHPBw ($234.05 in chips)
Seat 4: ZA1bp6g8IwtTxkUE4eCjDQ ($119.10 in chips)
Seat 5: UBZQqpnJZdTYYY1FTb0rLA ($100 in chips)
Seat 6: oxnw0GLLpFanjhGkxfRSqA ($52.10 in chips)
xAU6q2/cwmby2sxmA8VcmA: posts small blind $0.50
wx3sQGkVi2x9wJXuWNHPBw: posts big blind $1
*** HOLE CARDS ***
ZA1bp6g8IwtTxkUE4eCjDQ: folds
UBZQqpnJZdTYYY1FTb0rLA: folds
oxnw0GLLpFanjhGkxfRSqA: folds
YsLQ3BAvgQHWXMAv3Wv6Hg: folds
xAU6q2/cwmby2sxmA8VcmA: folds
wx3sQGkVi2x9wJXuWNHPBw collected $1 from pot
*** SUMMARY ***
Total pot $1 | Rake $0
Seat 1: YsLQ3BAvgQHWXMAv3Wv6Hg (button) folded before Flop (didn't bet)
Seat 2: xAU6q2/cwmby2sxmA8VcmA (small blind) folded before Flop
Seat 3: wx3sQGkVi2x9wJXuWNHPBw (big blind) collected ($1)
Seat 4: ZA1bp6g8IwtTxkUE4eCjDQ folded before Flop (didn't bet)
Seat 5: UBZQqpnJZdTYYY1FTb0rLA folded before Flop (didn't bet)
Seat 6: oxnw0GLLpFanjhGkxfRSqA folded before Flop (didn't bet)



PokerStars Game #59939141060:  Hold'em No Limit ($0.50/$1.00) - 2009/07/01 0:32:20 ET
Table 'QBLDswtHe7Ml0HwAdcMhlw' 2-max Seat #1 is the button
Seat 1: hdNlhiCwI533uwvvTTfC9Q ($100 in chips)
Seat 2: rAtTyvrJ8f1LaUh2O5U4nA ($32.20 in chips)
hdNlhiCwI533uwvvTTfC9Q: posts small blind $0.50
rAtTyvrJ8f1LaUh2O5U4nA: posts big blind $1
*** HOLE CARDS ***
hdNlhiCwI533uwvvTTfC9Q: folds
rAtTyvrJ8f1LaUh2O5U4nA collected $1 from pot
*** SUMMARY ***
Total pot $1 | Rake $0
Seat 1: hdNlhiCwI533uwvvTTfC9Q (button) (small blind) folded before Flop
Seat 2: rAtTyvrJ8f1LaUh2O5U4nA (big blind) collected ($1)



PokerStars Game #59939141146:  Hold'em No Limit ($0.50/$1.00) - 2009/07/01 0:32:20 ET
Table 'eU3bWpDDg3Z+9R4m4iVmog' 6-max Seat #3 is the button
Seat 1: TSuRyAHnUPCFjP7Z0rEE0w ($165.60 in chips)
Seat 2: 8CAoOzhmB8n3nRFf3V4BTg ($125.95 in chips)
Seat 3: U6tnjwZRpTnM+YkqkCjwyQ ($174.15 in chips)
Seat 4: GDVIsbEJ/DOJsMKE4Asz0A ($100.25 in chips)
Seat 6: hpxXcmRkXXI9HE5+5/j/0Q ($105 in chips)
GDVIsbEJ/DOJsMKE4Asz0A: posts small blind $0.50
QHvTZcrKe6+maWUfVjP29Q: is sitting out
hpxXcmRkXXI9HE5+5/j/0Q: posts big blind $1
*** HOLE CARDS ***
TSuRyAHnUPCFjP7Z0rEE0w: folds
QHvTZcrKe6+maWUfVjP29Q leaves the table
8CAoOzhmB8n3nRFf3V4BTg: calls $1
U6tnjwZRpTnM+YkqkCjwyQ: folds
GDVIsbEJ/DOJsMKE4Asz0A: calls $0.50
AdLVjddOzm+sRNo1Bc3S6Q joins the table at seat #5
hpxXcmRkXXI9HE5+5/j/0Q: checks
*** FLOP *** [5c Jh 8s]
GDVIsbEJ/DOJsMKE4Asz0A: bets $2
hpxXcmRkXXI9HE5+5/j/0Q: folds
8CAoOzhmB8n3nRFf3V4BTg: folds
GDVIsbEJ/DOJsMKE4Asz0A collected $2.85 from pot
*** SUMMARY ***
Total pot $3 | Rake $0.15
Board [5c Jh 8s]
Seat 1: TSuRyAHnUPCFjP7Z0rEE0w folded before Flop (didn't bet)
Seat 2: 8CAoOzhmB8n3nRFf3V4BTg folded on the Flop
Seat 3: U6tnjwZRpTnM+YkqkCjwyQ (button) folded before Flop (didn't bet)
Seat 4: GDVIsbEJ/DOJsMKE4Asz0A (small blind) collected ($2.85)
Seat 6: hpxXcmRkXXI9HE5+5/j/0Q (big blind) folded on the Flop



PokerStars Game #59939142340:  Hold'em No Limit ($0.50/$1.00) - 2009/07/01 0:32:22 ET
Table 'uNlePsyMIqzM691Xkrlk6Q' 9-max Seat #7 is the button
Seat 1: bLbSOSmSOnqE0iTcH/5dxA ($102.50 in chips)
Seat 2: +OqpStnt0FqbCfyHAWaLbg ($67.45 in chips)
Seat 3: h7qXkU57Bb8ZuPwMyxR8Ug ($21 in chips)
Seat 4: TZcz9MEWDA+WydgGruqqbw ($104.65 in chips)
Seat 5: gujOoLOu2j9hcY1eijNNDw ($87.60 in chips)
Seat 6: uMPEfCcGCfsxmy53tVUMug ($109.35 in chips)
Seat 7: w6cw9nzN7AvkkHBVVjykoQ ($44.90 in chips)
Seat 8: OsLmX3x/19szSV115TpL/Q ($42.95 in chips)
Seat 9: vR4IO10geOgvTW+LAUBv/A ($112.75 in chips)
OsLmX3x/19szSV115TpL/Q: posts small blind $0.50
vR4IO10geOgvTW+LAUBv/A: posts big blind $1
*** HOLE CARDS ***
bLbSOSmSOnqE0iTcH/5dxA: folds
+OqpStnt0FqbCfyHAWaLbg: folds
h7qXkU57Bb8ZuPwMyxR8Ug: calls $1
TZcz9MEWDA+WydgGruqqbw: folds
gujOoLOu2j9hcY1eijNNDw: calls $1
uMPEfCcGCfsxmy53tVUMug: calls $1
w6cw9nzN7AvkkHBVVjykoQ: folds
OsLmX3x/19szSV115TpL/Q: calls $0.50
vR4IO10geOgvTW+LAUBv/A: checks
*** FLOP *** [Ah 9s 9h]
OsLmX3x/19szSV115TpL/Q: checks
vR4IO10geOgvTW+LAUBv/A: checks
h7qXkU57Bb8ZuPwMyxR8Ug: checks
gujOoLOu2j9hcY1eijNNDw: checks
uMPEfCcGCfsxmy53tVUMug: checks
*** TURN *** [Ah 9s 9h] [9d]
OsLmX3x/19szSV115TpL/Q: checks
vR4IO10geOgvTW+LAUBv/A: checks
h7qXkU57Bb8ZuPwMyxR8Ug: checks
gujOoLOu2j9hcY1eijNNDw: folds
gujOoLOu2j9hcY1eijNNDw leaves the table
uMPEfCcGCfsxmy53tVUMug: checks
*** RIVER *** [Ah 9s 9h 9d] [2h]
3obndzTJ6fECz8+wWhMd1w joins the table at seat #5
OsLmX3x/19szSV115TpL/Q: checks
vR4IO10geOgvTW+LAUBv/A: checks
h7qXkU57Bb8ZuPwMyxR8Ug: checks
uMPEfCcGCfsxmy53tVUMug: bets $2
OsLmX3x/19szSV115TpL/Q: folds
vR4IO10geOgvTW+LAUBv/A: folds
h7qXkU57Bb8ZuPwMyxR8Ug: folds
uMPEfCcGCfsxmy53tVUMug collected $4.75 from pot
*** SUMMARY ***
Total pot $5 | Rake $0.25
Board [Ah 9s 9h 9d 2h]
Seat 1: bLbSOSmSOnqE0iTcH/5dxA folded before Flop (didn't bet)
Seat 2: +OqpStnt0FqbCfyHAWaLbg folded before Flop (didn't bet)
Seat 3: h7qXkU57Bb8ZuPwMyxR8Ug folded on the River
Seat 4: TZcz9MEWDA+WydgGruqqbw folded before Flop (didn't bet)
Seat 5: gujOoLOu2j9hcY1eijNNDw folded on the Turn
Seat 6: uMPEfCcGCfsxmy53tVUMug collected ($4.75)
Seat 7: w6cw9nzN7AvkkHBVVjykoQ (button) folded before Flop (didn't bet)
Seat 8: OsLmX3x/19szSV115TpL/Q (small blind) folded on the River
Seat 9: vR4IO10geOgvTW+LAUBv/A (big blind) folded on the River



PokerStars Game #59939142576:  Hold'em No Limit ($0.50/$1.00) - 2009/07/01 0:32:23 ET
Table 'tyUh+jyNvrceIQdKMJjQ2wZFWj23PMihdwrNWv41OG/Qeat #5 is the button
Seat 3: TalCiLYHCd+ffkmR3auPvA ($60 in chips)
Seat 4: TSuRyAHnUPCFjP7Z0rEE0w ($118.45 in chips)
Seat 5: j7NIOHLZk7V2o9fOioO5ug ($119.10 in chips)
Seat 6: YsLQ3BAvgQHWXMAv3Wv6Hg ($137.60 in chips)
YsLQ3BAvgQHWXMAv3Wv6Hg: posts small blind $0.50
TalCiLYHCd+ffkmR3auPvA: posts big blind $1
*** HOLE CARDS ***
TSuRyAHnUPCFjP7Z0rEE0w: folds
j7NIOHLZk7V2o9fOioO5ug: folds
YsLQ3BAvgQHWXMAv3Wv6Hg: folds
TalCiLYHCd+ffkmR3auPvA collected $1 from pot
TalCiLYHCd+ffkmR3auPvA: doesn't show hand
*** SUMMARY ***
Total pot $1 | Rake $0
Seat 3: TalCiLYHCd+ffkmR3auPvA (big blind) collected ($1)
Seat 4: TSuRyAHnUPCFjP7Z0rEE0w folded before Flop (didn't bet)
Seat 5: j7NIOHLZk7V2o9fOioO5ug (button) folded before Flop (didn't bet)
Seat 6: YsLQ3BAvgQHWXMAv3Wv6Hg (small blind) folded before Flop



PokerStars Game #59939143232:  Hold'em No Limit ($0.50/$1.00) - 2009/07/01 0:32:24 ET
Table 'U9zqzC8f3oTJ2ShXFgSSOA' 6-max Seat #1 is the button
Seat 1: tS9JHB1h+FQ++qu8RwRNgg ($33.10 in chips)
Seat 2: U2CWBTv29qdCbj8RNF2sIw ($100 in chips)
Seat 3: yfXek8iJ7O4CFyqXrtGcfg ($35.55 in chips)
Seat 4: 33q95we0Etwgrm6guQGncw ($73.65 in chips)
Seat 5: KfwW5us6tydK81NYTtK1gw ($307.05 in chips)
Seat 6: aIxzFKdtpDSkUePKZy/niQ ($52 in chips)
U2CWBTv29qdCbj8RNF2sIw: posts small blind $0.50
yfXek8iJ7O4CFyqXrtGcfg: posts big blind $1
*** HOLE CARDS ***
33q95we0Etwgrm6guQGncw: folds
KfwW5us6tydK81NYTtK1gw: folds
aIxzFKdtpDSkUePKZy/niQ: folds
tS9JHB1h+FQ++qu8RwRNgg: calls $1
U2CWBTv29qdCbj8RNF2sIw: folds
yfXek8iJ7O4CFyqXrtGcfg: checks
*** FLOP *** [6h Qs 4c]
yfXek8iJ7O4CFyqXrtGcfg: checks
tS9JHB1h+FQ++qu8RwRNgg: checks
*** TURN *** [6h Qs 4c] [Ah]
yfXek8iJ7O4CFyqXrtGcfg: checks
tS9JHB1h+FQ++qu8RwRNgg: bets $2
yfXek8iJ7O4CFyqXrtGcfg: folds
tS9JHB1h+FQ++qu8RwRNgg collected $2.40 from pot
tS9JHB1h+FQ++qu8RwRNgg: doesn't show hand
*** SUMMARY ***
Total pot $2.50 | Rake $0.10
Board [6h Qs 4c Ah]
Seat 1: tS9JHB1h+FQ++qu8RwRNgg (button) collected ($2.40)
Seat 2: U2CWBTv29qdCbj8RNF2sIw (small blind) folded before Flop
Seat 3: yfXek8iJ7O4CFyqXrtGcfg (big blind) folded on the Turn
Seat 4: 33q95we0Etwgrm6guQGncw folded before Flop (didn't bet)
Seat 5: KfwW5us6tydK81NYTtK1gw folded before Flop (didn't bet)
Seat 6: aIxzFKdtpDSkUePKZy/niQ folded before Flop (didn't bet)



PokerStars Game #59939145208:  Hold'em No Limit ($0.50/$1.00) - 2009/07/01 0:32:27 ET
Table 'cBDNutyLBKEk9+ptwsKmTw' 6-max Seat #1 is the button
Seat 1: xAU6q2/cwmby2sxmA8VcmA ($100 in chips)
Seat 2: Gy1fd4JyD1aNBFFlOGzbJQ ($26.70 in chips)
Seat 3: G5ZSSN6RSON3gkNvk/SmYg ($111.90 in chips)
Seat 4: 0WjiuIT7/EolY1oOx1ngeA ($103.15 in chips)
Seat 5: OGMLOcTNYZXZU81au7ztUw ($118.75 in chips)
Seat 6: NqVlOSH2lp+pp/TK3vvK5g ($43.30 in chips)
Gy1fd4JyD1aNBFFlOGzbJQ: posts small blind $0.50
G5ZSSN6RSON3gkNvk/SmYg: posts big blind $1
*** HOLE CARDS ***
0WjiuIT7/EolY1oOx1ngeA: folds
OGMLOcTNYZXZU81au7ztUw: raises $2 to $3
NqVlOSH2lp+pp/TK3vvK5g: folds
xAU6q2/cwmby2sxmA8VcmA: calls $3
Gy1fd4JyD1aNBFFlOGzbJQ: folds
G5ZSSN6RSON3gkNvk/SmYg: folds
*** FLOP *** [Js 4s Qs]
OGMLOcTNYZXZU81au7ztUw: bets $5
xAU6q2/cwmby2sxmA8VcmA: calls $5
*** TURN *** [Js 4s Qs] [9c]
OGMLOcTNYZXZU81au7ztUw: bets $12
xAU6q2/cwmby2sxmA8VcmA: calls $12
*** RIVER *** [Js 4s Qs 9c] [Jh]
OGMLOcTNYZXZU81au7ztUw: bets $35
xAU6q2/cwmby2sxmA8VcmA: folds
OGMLOcTNYZXZU81au7ztUw collected $39.50 from pot
OGMLOcTNYZXZU81au7ztUw: doesn't show hand
*** SUMMARY ***
Total pot $41.50 | Rake $2
Board [Js 4s Qs 9c Jh]
Seat 1: xAU6q2/cwmby2sxmA8VcmA (button) folded on the River
Seat 2: Gy1fd4JyD1aNBFFlOGzbJQ (small blind) folded before Flop
Seat 3: G5ZSSN6RSON3gkNvk/SmYg (big blind) folded before Flop
Seat 4: 0WjiuIT7/EolY1oOx1ngeA folded before Flop (didn't bet)
Seat 5: OGMLOcTNYZXZU81au7ztUw collected ($39.50)
Seat 6: NqVlOSH2lp+pp/TK3vvK5g folded before Flop (didn't bet)



PokerStars Game #59939145464:  Hold'em No Limit ($0.50/$1.00) - 2009/07/01 0:32:27 ET
Table '/FUb199IViHMJHi5YWmeuQ' 9-max Seat #8 is the button
Seat 1: TZcz9MEWDA+WydgGruqqbw ($101.85 in chips)
Seat 2: FL3MrLspcF23LYvC4ipBOA ($137.25 in chips)
Seat 3: qN483QJ1NvHbdIZB7J4ARw ($61.35 in chips)
Seat 6: ccFf7Q4z1cTGQmeoYiWEfw ($51.95 in chips)
Seat 7: bLbSOSmSOnqE0iTcH/5dxA ($100 in chips)
Seat 8: QIWvt0R766g8KfH0vl1s0A ($32.90 in chips)
Seat 9: knewtTmBc4Tc0z/5tAABYQ ($155.65 in chips)
knewtTmBc4Tc0z/5tAABYQ: posts small blind $0.50
TZcz9MEWDA+WydgGruqqbw: posts big blind $1
qheQay5YvP2DMAb3OUSxtw: sits out
*** HOLE CARDS ***
FL3MrLspcF23LYvC4ipBOA: folds
qN483QJ1NvHbdIZB7J4ARw: folds
ccFf7Q4z1cTGQmeoYiWEfw: folds
bLbSOSmSOnqE0iTcH/5dxA: folds
QIWvt0R766g8KfH0vl1s0A: folds
knewtTmBc4Tc0z/5tAABYQ: folds
TZcz9MEWDA+WydgGruqqbw collected $1 from pot
TZcz9MEWDA+WydgGruqqbw: doesn't show hand
*** SUMMARY ***
Total pot $1 | Rake $0
Seat 1: TZcz9MEWDA+WydgGruqqbw (big blind) collected ($1)
Seat 2: FL3MrLspcF23LYvC4ipBOA folded before Flop (didn't bet)
Seat 3: qN483QJ1NvHbdIZB7J4ARw folded before Flop (didn't bet)
Seat 6: ccFf7Q4z1cTGQmeoYiWEfw folded before Flop (didn't bet)
Seat 7: bLbSOSmSOnqE0iTcH/5dxA folded before Flop (didn't bet)
Seat 8: QIWvt0R766g8KfH0vl1s0A (button) folded before Flop (didn't bet)
Seat 9: knewtTmBc4Tc0z/5tAABYQ (small blind) folded before Flop



PokerStars Game #59939145936:  Hold'em No Limit ($0.50/$1.00) - 2009/07/01 0:32:28 ET
Table 'QBLDswtHe7Ml0HwAdcMhlw' 2-max Seat #2 is the button
Seat 1: hdNlhiCwI533uwvvTTfC9Q ($100 in chips)
Seat 2: rAtTyvrJ8f1LaUh2O5U4nA ($32.70 in chips)
rAtTyvrJ8f1LaUh2O5U4nA: posts small blind $0.50
hdNlhiCwI533uwvvTTfC9Q: posts big blind $1
*** HOLE CARDS ***
rAtTyvrJ8f1LaUh2O5U4nA: raises $2 to $3
hdNlhiCwI533uwvvTTfC9Q: folds
rAtTyvrJ8f1LaUh2O5U4nA collected $2 from pot
rAtTyvrJ8f1LaUh2O5U4nA: doesn't show hand
*** SUMMARY ***
Total pot $2 | Rake $0
Seat 1: hdNlhiCwI533uwvvTTfC9Q (big blind) folded before Flop
Seat 2: rAtTyvrJ8f1LaUh2O5U4nA (button) (small blind) collected ($2)



PokerStars Game #59939147004:  Hold'em No Limit ($0.50/$1.00) - 2009/07/01 0:32:29 ET
Table '/RZcOwpZpHQ+OwPwjsbnRw' 6-max Seat #6 is the button
Seat 1: Zboa6dColKGHBjLPUakZjw ($53.20 in chips)
Seat 2: dHC9PH9hdH3Ad2TD8ZxX0Q ($44.25 in chips)
Seat 3: OigyyiK+tTj1APPIAUmXDA ($72.65 in chips)
Seat 4: j7NIOHLZk7V2o9fOioO5ug ($115.10 in chips)
Seat 5: wx3sQGkVi2x9wJXuWNHPBw ($199.65 in chips)
Seat 6: XOIf9W+VAxhZqN+SYoyMKA ($247.80 in chips)
Zboa6dColKGHBjLPUakZjw: posts small blind $0.50
dHC9PH9hdH3Ad2TD8ZxX0Q: posts big blind $1
*** HOLE CARDS ***
OigyyiK+tTj1APPIAUmXDA: folds
j7NIOHLZk7V2o9fOioO5ug: folds
wx3sQGkVi2x9wJXuWNHPBw: folds
XOIf9W+VAxhZqN+SYoyMKA: raises $2 to $3
Zboa6dColKGHBjLPUakZjw: folds
dHC9PH9hdH3Ad2TD8ZxX0Q: folds
XOIf9W+VAxhZqN+SYoyMKA collected $2.50 from pot
XOIf9W+VAxhZqN+SYoyMKA: doesn't show hand
*** SUMMARY ***
Total pot $2.50 | Rake $0
Seat 1: Zboa6dColKGHBjLPUakZjw (small blind) folded before Flop
Seat 2: dHC9PH9hdH3Ad2TD8ZxX0Q (big blind) folded before Flop
Seat 3: OigyyiK+tTj1APPIAUmXDA folded before Flop (didn't bet)
Seat 4: j7NIOHLZk7V2o9fOioO5ug folded before Flop (didn't bet)
Seat 5: wx3sQGkVi2x9wJXuWNHPBw folded before Flop (didn't bet)
Seat 6: XOIf9W+VAxhZqN+SYoyMKA (button) collected ($2.50)



PokerStars Game #59939147448:  Hold'em No Limit ($0.50/$1.00) - 2009/07/01 0:32:30 ET
Table '21a4iYFKcuezM4nYx8DWTA' 2-max Seat #1 is the button
Seat 1: NYi6JFscYNrofSXy4sM+Yw ($149 in chips)
Seat 2: +sy/nlNI20yZraIjs4AALg ($50.45 in chips)
NYi6JFscYNrofSXy4sM+Yw: posts small blind $0.50
+sy/nlNI20yZraIjs4AALg: posts big blind $1
*** HOLE CARDS ***
NYi6JFscYNrofSXy4sM+Yw: raises $2 to $3
+sy/nlNI20yZraIjs4AALg: raises $2 to $5
NYi6JFscYNrofSXy4sM+Yw: calls $2
*** FLOP *** [Qh 5d 7d]
+sy/nlNI20yZraIjs4AALg: checks
NYi6JFscYNrofSXy4sM+Yw: bets $3
+sy/nlNI20yZraIjs4AALg: calls $3
*** TURN *** [Qh 5d 7d] [Ac]
+sy/nlNI20yZraIjs4AALg: checks
NYi6JFscYNrofSXy4sM+Yw: bets $11.50
+sy/nlNI20yZraIjs4AALg: raises $11.50 to $23
NYi6JFscYNrofSXy4sM+Yw: raises $34.50 to $57.50
+sy/nlNI20yZraIjs4AALg: folds
NYi6JFscYNrofSXy4sM+Yw collected $61.50 from pot
*** SUMMARY ***
Total pot $62 | Rake $0.50
Board [Qh 5d 7d Ac]
Seat 1: NYi6JFscYNrofSXy4sM+Yw (button) (small blind) collected ($61.50)
Seat 2: +sy/nlNI20yZraIjs4AALg (big blind) folded on the Turn



PokerStars Game #59939150524:  Hold'em No Limit ($0.50/$1.00) - 2009/07/01 0:32:35 ET
Table 'QSIig7BLMc9wY/rgBechzw' 6-max Seat #2 is the button
Seat 1: uuA9hpFU17U5/t4cvpbpBg ($27.05 in chips)
Seat 2: 0WjiuIT7/EolY1oOx1ngeA ($124.75 in chips)
Seat 3: +W6OnF033KNM2xH0fGj98Q ($123.90 in chips)
Seat 4: +uSzP8Jwnw7sKfQ4s66b7w ($31.50 in chips)
Seat 5: bvU2ZjpVnszLCFVeWbxePg ($116.90 in chips)
Seat 6: KpnW5CcJ4Mg6MeclfKmLrw ($136.10 in chips)
+W6OnF033KNM2xH0fGj98Q: posts small blind $0.50
+uSzP8Jwnw7sKfQ4s66b7w: posts big blind $1
*** HOLE CARDS ***
bvU2ZjpVnszLCFVeWbxePg: folds
KpnW5CcJ4Mg6MeclfKmLrw: raises $3 to $4
uuA9hpFU17U5/t4cvpbpBg: folds
0WjiuIT7/EolY1oOx1ngeA: folds
+W6OnF033KNM2xH0fGj98Q: calls $3.50
+uSzP8Jwnw7sKfQ4s66b7w: folds
*** FLOP *** [5s Kc Ad]
+W6OnF033KNM2xH0fGj98Q: checks
KpnW5CcJ4Mg6MeclfKmLrw: checks
*** TURN *** [5s Kc Ad] [Jh]
+W6OnF033KNM2xH0fGj98Q: bets $6
KpnW5CcJ4Mg6MeclfKmLrw: raises $11 to $17
+W6OnF033KNM2xH0fGj98Q: calls $11
*** RIVER *** [5s Kc Ad Jh] [5h]
+W6OnF033KNM2xH0fGj98Q: checks
KpnW5CcJ4Mg6MeclfKmLrw: bets $32
+W6OnF033KNM2xH0fGj98Q: calls $32
*** SHOW DOWN ***
KpnW5CcJ4Mg6MeclfKmLrw: shows [Qc Tc] (a straight, Ten to Ace)
+W6OnF033KNM2xH0fGj98Q: mucks hand
KpnW5CcJ4Mg6MeclfKmLrw collected $104 from pot
*** SUMMARY ***
Total pot $107 | Rake $3
Board [5s Kc Ad Jh 5h]
Seat 1: uuA9hpFU17U5/t4cvpbpBg folded before Flop (didn't bet)
Seat 2: 0WjiuIT7/EolY1oOx1ngeA (button) folded before Flop (didn't bet)
Seat 3: +W6OnF033KNM2xH0fGj98Q (small blind) mucked
Seat 4: +uSzP8Jwnw7sKfQ4s66b7w (big blind) folded before Flop
Seat 5: bvU2ZjpVnszLCFVeWbxePg folded before Flop (didn't bet)
Seat 6: KpnW5CcJ4Mg6MeclfKmLrw showed [Qc Tc] and won ($104) with a straight, Ten to Ace



PokerStars Game #59939150722:  Hold'em No Limit ($0.50/$1.00) - 2009/07/01 0:32:35 ET
Table 'MUPc8FEpe/nR0BKSeReX6Q' 6-max Seat #2 is the button
Seat 1: YsLQ3BAvgQHWXMAv3Wv6Hg ($100 in chips)
Seat 2: xAU6q2/cwmby2sxmA8VcmA ($109 in chips)
Seat 3: wx3sQGkVi2x9wJXuWNHPBw ($234.55 in chips)
Seat 4: ZA1bp6g8IwtTxkUE4eCjDQ ($119.10 in chips)
Seat 5: UBZQqpnJZdTYYY1FTb0rLA ($100 in chips)
Seat 6: oxnw0GLLpFanjhGkxfRSqA ($52.10 in chips)
wx3sQGkVi2x9wJXuWNHPBw: posts small blind $0.50
ZA1bp6g8IwtTxkUE4eCjDQ: posts big blind $1
*** HOLE CARDS ***
UBZQqpnJZdTYYY1FTb0rLA: folds
oxnw0GLLpFanjhGkxfRSqA: folds
YsLQ3BAvgQHWXMAv3Wv6Hg: folds
xAU6q2/cwmby2sxmA8VcmA: folds
wx3sQGkVi2x9wJXuWNHPBw: folds
ZA1bp6g8IwtTxkUE4eCjDQ collected $1 from pot
*** SUMMARY ***
Total pot $1 | Rake $0
Seat 1: YsLQ3BAvgQHWXMAv3Wv6Hg folded before Flop (didn't bet)
Seat 2: xAU6q2/cwmby2sxmA8VcmA (button) folded before Flop (didn't bet)
Seat 3: wx3sQGkVi2x9wJXuWNHPBw (small blind) folded before Flop
Seat 4: ZA1bp6g8IwtTxkUE4eCjDQ (big blind) collected ($1)
Seat 5: UBZQqpnJZdTYYY1FTb0rLA folded before Flop (didn't bet)
Seat 6: oxnw0GLLpFanjhGkxfRSqA folded before Flop (didn't bet)



PokerStars Game #59939151912:  Hold'em No Limit ($0.50/$1.00) - 2009/07/01 0:32:37 ET
Table 'tyUh+jyNvrceIQdKMJjQ2wZFWj23PMihdwrNWv41OG/Qeat #6 is the button
Seat 3: TalCiLYHCd+ffkmR3auPvA ($60.50 in chips)
Seat 4: TSuRyAHnUPCFjP7Z0rEE0w ($118.45 in chips)
Seat 5: j7NIOHLZk7V2o9fOioO5ug ($119.10 in chips)
Seat 6: YsLQ3BAvgQHWXMAv3Wv6Hg ($137.10 in chips)
TalCiLYHCd+ffkmR3auPvA: posts small blind $0.50
TSuRyAHnUPCFjP7Z0rEE0w: posts big blind $1
*** HOLE CARDS ***
j7NIOHLZk7V2o9fOioO5ug: folds
YsLQ3BAvgQHWXMAv3Wv6Hg: folds
TalCiLYHCd+ffkmR3auPvA: calls $0.50
TSuRyAHnUPCFjP7Z0rEE0w: checks
*** FLOP *** [8c 3c Jd]
m1sJRkJZ1wu5i1BdgeO2Jw joins the table at seat #2
TalCiLYHCd+ffkmR3auPvA: checks
TSuRyAHnUPCFjP7Z0rEE0w: bets $1.50
TalCiLYHCd+ffkmR3auPvA: calls $1.50
*** TURN *** [8c 3c Jd] [Kd]
TalCiLYHCd+ffkmR3auPvA: checks
TSuRyAHnUPCFjP7Z0rEE0w: checks
*** RIVER *** [8c 3c Jd Kd] [3h]
TalCiLYHCd+ffkmR3auPvA: checks
TSuRyAHnUPCFjP7Z0rEE0w: checks
*** SHOW DOWN ***
TalCiLYHCd+ffkmR3auPvA: shows [Td 7c] (a pair of Threes)
TSuRyAHnUPCFjP7Z0rEE0w: shows [3d 6c] (three of a kind, Threes)
TSuRyAHnUPCFjP7Z0rEE0w collected $4.80 from pot
*** SUMMARY ***
Total pot $5 | Rake $0.20
Board [8c 3c Jd Kd 3h]
Seat 3: TalCiLYHCd+ffkmR3auPvA (small blind) showed [Td 7c] and lost with a pair of Threes
Seat 4: TSuRyAHnUPCFjP7Z0rEE0w (big blind) showed [3d 6c] and won ($4.80) with three of a kind, Threes
Seat 5: j7NIOHLZk7V2o9fOioO5ug folded before Flop (didn't bet)
Seat 6: YsLQ3BAvgQHWXMAv3Wv6Hg (button) folded before Flop (didn't bet)



PokerStars Game #59939153130:  Hold'em No Limit ($0.50/$1.00) - 2009/07/01 0:32:38 ET
Table '8jIjWCPY0NGprquL+xcMFg' 9-max Seat #7 is the button
Seat 1: vR4IO10geOgvTW+LAUBv/A ($137.80 in chips)
Seat 2: rR1qGAf9Q9RYorKYWH3VKw ($5.15 in chips)
Seat 3: 58zdeSBSuSFX/qZfhc7YmA ($108.45 in chips)
Seat 4: by0z+YmujwI6Bf4qRFE8vA ($147.45 in chips)
Seat 5: n758Yw8Hx2S+6NQUPGqcqA ($87 in chips)
Seat 6: GTQkFJtSkbVbnGCktp6e3g ($100 in chips)
Seat 7: O3CGPwwUmamrCNHccOilrg ($47.50 in chips)
Seat 8: 9swGhtpERPngKPtvpoZkoQ ($150.80 in chips)
Seat 9: negfosHnGOZXSHpWDRKyBQ ($20 in chips)
9swGhtpERPngKPtvpoZkoQ: posts small blind $0.50
negfosHnGOZXSHpWDRKyBQ: posts big blind $1
*** HOLE CARDS ***
vR4IO10geOgvTW+LAUBv/A: raises $3 to $4
rR1qGAf9Q9RYorKYWH3VKw: calls $4
58zdeSBSuSFX/qZfhc7YmA: folds
by0z+YmujwI6Bf4qRFE8vA: folds
n758Yw8Hx2S+6NQUPGqcqA: folds
GTQkFJtSkbVbnGCktp6e3g: folds
O3CGPwwUmamrCNHccOilrg: folds
9swGhtpERPngKPtvpoZkoQ: folds
negfosHnGOZXSHpWDRKyBQ: folds
*** FLOP *** [As 8s Js]
vR4IO10geOgvTW+LAUBv/A: checks
rR1qGAf9Q9RYorKYWH3VKw: bets $1
vR4IO10geOgvTW+LAUBv/A: folds
rR1qGAf9Q9RYorKYWH3VKw collected $9.05 from pot
*** SUMMARY ***
Total pot $9.50 | Rake $0.45
Board [As 8s Js]
Seat 1: vR4IO10geOgvTW+LAUBv/A folded on the Flop
Seat 2: rR1qGAf9Q9RYorKYWH3VKw collected ($9.05)
Seat 3: 58zdeSBSuSFX/qZfhc7YmA folded before Flop (didn't bet)
Seat 4: by0z+YmujwI6Bf4qRFE8vA folded before Flop (didn't bet)
Seat 5: n758Yw8Hx2S+6NQUPGqcqA folded before Flop (didn't bet)
Seat 6: GTQkFJtSkbVbnGCktp6e3g folded before Flop (didn't bet)
Seat 7: O3CGPwwUmamrCNHccOilrg (button) folded before Flop (didn't bet)
Seat 8: 9swGhtpERPngKPtvpoZkoQ (small blind) folded before Flop
Seat 9: negfosHnGOZXSHpWDRKyBQ (big blind) folded before Flop



PokerStars Game #59939152500:  Hold'em No Limit ($0.50/$1.00) - 2009/07/01 0:32:38 ET
Table '+cA8mcmhaedZ7YcrDdhmeQ' 6-max Seat #2 is the button
Seat 1: lsLuWlcPA3Rh7kJVLzMh0Q ($307.25 in chips)
Seat 2: RqgF7gRoKgRNW8Zoi1ty4A ($100 in chips)
Seat 4: LjL3AIERHn559yyW1mTUYQ ($97.50 in chips)
Seat 5: 6WyjEXOToimYmtLdqIgHYQ ($61.50 in chips)
Seat 6: YfsTQsY/fxb+YqbdclTHuw ($39.90 in chips)
LjL3AIERHn559yyW1mTUYQ: posts small blind $0.50
6WyjEXOToimYmtLdqIgHYQ: posts big blind $1
*** HOLE CARDS ***
YfsTQsY/fxb+YqbdclTHuw: calls $1
lsLuWlcPA3Rh7kJVLzMh0Q: folds
RqgF7gRoKgRNW8Zoi1ty4A: folds
LjL3AIERHn559yyW1mTUYQ: raises $4 to $5
6WyjEXOToimYmtLdqIgHYQ: calls $4
YfsTQsY/fxb+YqbdclTHuw: calls $4
*** FLOP *** [5s 9s Ad]
7H5WkGzGvsv56y1iaqHvRg joins the table at seat #3
LjL3AIERHn559yyW1mTUYQ: bets $10
6WyjEXOToimYmtLdqIgHYQ: raises $15 to $25
YfsTQsY/fxb+YqbdclTHuw: folds
LjL3AIERHn559yyW1mTUYQ: raises $67.50 to $92.50 and is all-in
6WyjEXOToimYmtLdqIgHYQ: calls $31.50 and is all-in
*** TURN *** [5s 9s Ad] [Ks]
*** RIVER *** [5s 9s Ad Ks] [3h]
*** SHOW DOWN ***
LjL3AIERHn559yyW1mTUYQ: shows [6s 7s] (a flush, King high)
6WyjEXOToimYmtLdqIgHYQ: shows [5h Ah] (two pair, Aces and Fives)
LjL3AIERHn559yyW1mTUYQ collected $126 from pot
*** SUMMARY ***
Total pot $128 | Rake $2
Board [5s 9s Ad Ks 3h]
Seat 1: lsLuWlcPA3Rh7kJVLzMh0Q folded before Flop (didn't bet)
Seat 2: RqgF7gRoKgRNW8Zoi1ty4A (button) folded before Flop (didn't bet)
Seat 4: LjL3AIERHn559yyW1mTUYQ (small blind) showed [6s 7s] and won ($126) with a flush, King high
Seat 5: 6WyjEXOToimYmtLdqIgHYQ (big blind) showed [5h Ah] and lost with two pair, Aces and Fives
Seat 6: YfsTQsY/fxb+YqbdclTHuw folded on the Flop



PokerStars Game #59939153938:  Hold'em No Limit ($0.50/$1.00) - 2009/07/01 0:32:40 ET
Table 'pHrhryH8jPNdQfY62f8v+g' 6-max Seat #6 is the button
Seat 1: BdbmJTZZ47quA9vUWwXtlw ($71.80 in chips)
Seat 2: RqgF7gRoKgRNW8Zoi1ty4A ($116.50 in chips)
Seat 3: 0WjiuIT7/EolY1oOx1ngeA ($109.55 in chips)
Seat 4: wenbG7TaM3H7h5kn78OFNw ($58.30 in chips)
Seat 5: r1/R7y0Ortgoz4lccgW8VA ($60.15 in chips)
Seat 6: xAU6q2/cwmby2sxmA8VcmA ($102.80 in chips)
BdbmJTZZ47quA9vUWwXtlw: posts small blind $0.50
RqgF7gRoKgRNW8Zoi1ty4A: posts big blind $1
*** HOLE CARDS ***
0WjiuIT7/EolY1oOx1ngeA: folds
wenbG7TaM3H7h5kn78OFNw: folds
0WjiuIT7/EolY1oOx1ngeA is sitting out
r1/R7y0Ortgoz4lccgW8VA: raises $2 to $3
xAU6q2/cwmby2sxmA8VcmA: folds
BdbmJTZZ47quA9vUWwXtlw: calls $2.50
RqgF7gRoKgRNW8Zoi1ty4A: folds
*** FLOP *** [6s Qc Jd]
BdbmJTZZ47quA9vUWwXtlw: checks
r1/R7y0Ortgoz4lccgW8VA: checks
*** TURN *** [6s Qc Jd] [4c]
BdbmJTZZ47quA9vUWwXtlw: checks
r1/R7y0Ortgoz4lccgW8VA: bets $4
BdbmJTZZ47quA9vUWwXtlw: calls $4
*** RIVER *** [6s Qc Jd 4c] [Kd]
BdbmJTZZ47quA9vUWwXtlw: checks
r1/R7y0Ortgoz4lccgW8VA: bets $9
BdbmJTZZ47quA9vUWwXtlw: raises $21 to $30
r1/R7y0Ortgoz4lccgW8VA: calls $21
*** SHOW DOWN ***
BdbmJTZZ47quA9vUWwXtlw: shows [Tc Ah] (a straight, Ten to Ace)
r1/R7y0Ortgoz4lccgW8VA: shows [Qs Qh] (three of a kind, Queens)
BdbmJTZZ47quA9vUWwXtlw collected $72 from pot
*** SUMMARY ***
Total pot $75 | Rake $3
Board [6s Qc Jd 4c Kd]
Seat 1: BdbmJTZZ47quA9vUWwXtlw (small blind) showed [Tc Ah] and won ($72) with a straight, Ten to Ace
Seat 2: RqgF7gRoKgRNW8Zoi1ty4A (big blind) folded before Flop
Seat 3: 0WjiuIT7/EolY1oOx1ngeA folded before Flop (didn't bet)
Seat 4: wenbG7TaM3H7h5kn78OFNw folded before Flop (didn't bet)
Seat 5: r1/R7y0Ortgoz4lccgW8VA showed [Qs Qh] and lost with three of a kind, Queens
Seat 6: xAU6q2/cwmby2sxmA8VcmA (button) folded before Flop (didn't bet)



PokerStars Game #59939154730:  Hold'em No Limit ($0.50/$1.00) - 2009/07/01 0:32:41 ET
Table 'QBLDswtHe7Ml0HwAdcMhlw' 2-max Seat #1 is the button
Seat 1: hdNlhiCwI533uwvvTTfC9Q ($100 in chips)
Seat 2: rAtTyvrJ8f1LaUh2O5U4nA ($33.70 in chips)
hdNlhiCwI533uwvvTTfC9Q: posts small blind $0.50
rAtTyvrJ8f1LaUh2O5U4nA: posts big blind $1
*** HOLE CARDS ***
hdNlhiCwI533uwvvTTfC9Q: folds
rAtTyvrJ8f1LaUh2O5U4nA collected $1 from pot
*** SUMMARY ***
Total pot $1 | Rake $0
Seat 1: hdNlhiCwI533uwvvTTfC9Q (button) (small blind) folded before Flop
Seat 2: rAtTyvrJ8f1LaUh2O5U4nA (big blind) collected ($1)



PokerStars Game #59939155656:  Hold'em No Limit ($0.50/$1.00) - 2009/07/01 0:32:42 ET
Table 'N2bNCDHL96aCQDvZIh+yQQ' 6-max Seat #3 is the button
Seat 1: iHo1oDbrEVJ8nEGdaPrICw ($143.50 in chips)
Seat 2: KpnW5CcJ4Mg6MeclfKmLrw ($111.90 in chips)
Seat 3: Qy/UBNbD2HaA0Ogxg8Sf3w ($100 in chips)
Seat 4: uCqEjnxh2/vFBjKYkfTOkw ($152.40 in chips)
Seat 5: rHlMOfR7kpQQxe+PFQz0xQ ($41.60 in chips)
Seat 6: TSuRyAHnUPCFjP7Z0rEE0w ($100 in chips)
uCqEjnxh2/vFBjKYkfTOkw: posts small blind $0.50
rHlMOfR7kpQQxe+PFQz0xQ: posts big blind $1
*** HOLE CARDS ***
TSuRyAHnUPCFjP7Z0rEE0w: folds
iHo1oDbrEVJ8nEGdaPrICw: folds
KpnW5CcJ4Mg6MeclfKmLrw: folds
Qy/UBNbD2HaA0Ogxg8Sf3w: raises $1.50 to $2.50
uCqEjnxh2/vFBjKYkfTOkw: folds
rHlMOfR7kpQQxe+PFQz0xQ: calls $1.50
*** FLOP *** [6h 6d 8d]
rHlMOfR7kpQQxe+PFQz0xQ: checks
Qy/UBNbD2HaA0Ogxg8Sf3w: bets $4
rHlMOfR7kpQQxe+PFQz0xQ: calls $4
*** TURN *** [6h 6d 8d] [3s]
rHlMOfR7kpQQxe+PFQz0xQ: checks
Qy/UBNbD2HaA0Ogxg8Sf3w: checks
*** RIVER *** [6h 6d 8d 3s] [6s]
rHlMOfR7kpQQxe+PFQz0xQ: checks
Qy/UBNbD2HaA0Ogxg8Sf3w: bets $6
rHlMOfR7kpQQxe+PFQz0xQ: calls $6
*** SHOW DOWN ***
Qy/UBNbD2HaA0Ogxg8Sf3w: shows [7d 8s] (a full house, Sixes full of Eights)
rHlMOfR7kpQQxe+PFQz0xQ: mucks hand
Qy/UBNbD2HaA0Ogxg8Sf3w collected $24.30 from pot
*** SUMMARY ***
Total pot $25.50 | Rake $1.20
Board [6h 6d 8d 3s 6s]
Seat 1: iHo1oDbrEVJ8nEGdaPrICw folded before Flop (didn't bet)
Seat 2: KpnW5CcJ4Mg6MeclfKmLrw folded before Flop (didn't bet)
Seat 3: Qy/UBNbD2HaA0Ogxg8Sf3w (button) showed [7d 8s] and won ($24.30) with a full house, Sixes full of Eights
Seat 4: uCqEjnxh2/vFBjKYkfTOkw (small blind) folded before Flop
Seat 5: rHlMOfR7kpQQxe+PFQz0xQ (big blind) mucked
Seat 6: TSuRyAHnUPCFjP7Z0rEE0w folded before Flop (didn't bet)



PokerStars Game #59939157056:  Hold'em No Limit ($0.50/$1.00) - 2009/07/01 0:32:44 ET
Table 'fTlPiCj0utgzC/5io+I7ew' 6-max Seat #1 is the button
Seat 1: YMJG+F++3Aj6P8dAWda5fw ($98.50 in chips)
Seat 2: Qy/UBNbD2HaA0Ogxg8Sf3w ($100 in chips)
Seat 3: oDiBRCaF0QVtd3kO6xZIXw ($101.50 in chips)
Seat 4: uJVSceLggtsrJya+WtmUEA ($99.30 in chips)
Seat 5: bFrTkDcWGTxyvNul7GVdYg ($256.70 in chips)
Seat 6: jMljU/dOPMXfJi8OmbdYdw ($28.50 in chips)
Qy/UBNbD2HaA0Ogxg8Sf3w: posts small blind $0.50
oDiBRCaF0QVtd3kO6xZIXw: posts big blind $1
*** HOLE CARDS ***
uJVSceLggtsrJya+WtmUEA: folds
bFrTkDcWGTxyvNul7GVdYg: folds
jMljU/dOPMXfJi8OmbdYdw: folds
YMJG+F++3Aj6P8dAWda5fw: folds
Qy/UBNbD2HaA0Ogxg8Sf3w: folds
oDiBRCaF0QVtd3kO6xZIXw collected $1 from pot
*** SUMMARY ***
Total pot $1 | Rake $0
Seat 1: YMJG+F++3Aj6P8dAWda5fw (button) folded before Flop (didn't bet)
Seat 2: Qy/UBNbD2HaA0Ogxg8Sf3w (small blind) folded before Flop
Seat 3: oDiBRCaF0QVtd3kO6xZIXw (big blind) collected ($1)
Seat 4: uJVSceLggtsrJya+WtmUEA folded before Flop (didn't bet)
Seat 5: bFrTkDcWGTxyvNul7GVdYg folded before Flop (didn't bet)
Seat 6: jMljU/dOPMXfJi8OmbdYdw folded before Flop (didn't bet)



PokerStars Game #59939157050:  Hold'em No Limit ($0.50/$1.00) - 2009/07/01 0:32:44 ET
Table 'rmZfTK+oSebeUPJNbWhdAA' 6-max Seat #4 is the button
Seat 1: xAU6q2/cwmby2sxmA8VcmA ($100 in chips)
Seat 2: OigyyiK+tTj1APPIAUmXDA ($124.55 in chips)
Seat 3: 9yjOzGERLaEZS8CZ6YNHFg ($115.40 in chips)
Seat 4: OGMLOcTNYZXZU81au7ztUw ($127.20 in chips)
Seat 5: +xW7QemQU0Fxs+4TnqBRow ($100.50 in chips)
Seat 6: j7NIOHLZk7V2o9fOioO5ug ($100 in chips)
+xW7QemQU0Fxs+4TnqBRow: posts small blind $0.50
j7NIOHLZk7V2o9fOioO5ug: posts big blind $1
*** HOLE CARDS ***
xAU6q2/cwmby2sxmA8VcmA: folds
OigyyiK+tTj1APPIAUmXDA: folds
9yjOzGERLaEZS8CZ6YNHFg: folds
OGMLOcTNYZXZU81au7ztUw: raises $2 to $3
+xW7QemQU0Fxs+4TnqBRow: calls $2.50
j7NIOHLZk7V2o9fOioO5ug: folds
*** FLOP *** [Tc 8c 3h]
+xW7QemQU0Fxs+4TnqBRow: checks
OGMLOcTNYZXZU81au7ztUw: checks
*** TURN *** [Tc 8c 3h] [Td]
+xW7QemQU0Fxs+4TnqBRow: checks
OGMLOcTNYZXZU81au7ztUw: checks
*** RIVER *** [Tc 8c 3h Td] [6s]
+xW7QemQU0Fxs+4TnqBRow: checks
OGMLOcTNYZXZU81au7ztUw: checks
*** SHOW DOWN ***
+xW7QemQU0Fxs+4TnqBRow: shows [Ad Jh] (a pair of Tens)
OGMLOcTNYZXZU81au7ztUw: shows [Ah Kd] (a pair of Tens - Ace+King kicker)
OGMLOcTNYZXZU81au7ztUw collected $6.65 from pot
*** SUMMARY ***
Total pot $7 | Rake $0.35
Board [Tc 8c 3h Td 6s]
Seat 1: xAU6q2/cwmby2sxmA8VcmA folded before Flop (didn't bet)
Seat 2: OigyyiK+tTj1APPIAUmXDA folded before Flop (didn't bet)
Seat 3: 9yjOzGERLaEZS8CZ6YNHFg folded before Flop (didn't bet)
Seat 4: OGMLOcTNYZXZU81au7ztUw (button) showed [Ah Kd] and won ($6.65) with a pair of Tens
Seat 5: +xW7QemQU0Fxs+4TnqBRow (small blind) showed [Ad Jh] and lost with a pair of Tens
Seat 6: j7NIOHLZk7V2o9fOioO5ug (big blind) folded before Flop



PokerStars Game #59939157060:  Hold'em No Limit ($0.50/$1.00) - 2009/07/01 0:32:44 ET
Table '7Nl0ffnjeK44/vmeexh3MQ' 9-max Seat #3 is the button
Seat 1: s7D3Y+k4Cj4D1cXHv7oj+Q ($99.45 in chips)
Seat 2: kiakSwxX0e64PwYGAPQvLw ($33.85 in chips)
Seat 3: vR4IO10geOgvTW+LAUBv/A ($100 in chips)
Seat 4: bLbSOSmSOnqE0iTcH/5dxA ($100 in chips)
Seat 5: bL+QVeDcuEdzMGAGg2XJHg ($108.40 in chips)
Seat 6: FVs16t7GgfWgQWt4JxsObQ ($11.40 in chips)
Seat 7: knewtTmBc4Tc0z/5tAABYQ ($105 in chips)
Seat 8: zanka7aAZkigmZpfopXxxA ($229.20 in chips)
Seat 9: ouwUBGRKnKK9uhn1G4Lf+A ($99.50 in chips)
bLbSOSmSOnqE0iTcH/5dxA: posts small blind $0.50
bL+QVeDcuEdzMGAGg2XJHg: posts big blind $1
*** HOLE CARDS ***
FVs16t7GgfWgQWt4JxsObQ: calls $1
knewtTmBc4Tc0z/5tAABYQ: folds
zanka7aAZkigmZpfopXxxA: calls $1
ouwUBGRKnKK9uhn1G4Lf+A: folds
s7D3Y+k4Cj4D1cXHv7oj+Q: calls $1
kiakSwxX0e64PwYGAPQvLw: folds
vR4IO10geOgvTW+LAUBv/A: folds
bLbSOSmSOnqE0iTcH/5dxA: folds
bL+QVeDcuEdzMGAGg2XJHg: checks
*** FLOP *** [4d 2h Tc]
bL+QVeDcuEdzMGAGg2XJHg: checks
FVs16t7GgfWgQWt4JxsObQ: checks
zanka7aAZkigmZpfopXxxA: checks
s7D3Y+k4Cj4D1cXHv7oj+Q: checks
*** TURN *** [4d 2h Tc] [Qs]
bL+QVeDcuEdzMGAGg2XJHg: checks
FVs16t7GgfWgQWt4JxsObQ: bets $1
zanka7aAZkigmZpfopXxxA: folds
s7D3Y+k4Cj4D1cXHv7oj+Q: calls $1
bL+QVeDcuEdzMGAGg2XJHg: folds
*** RIVER *** [4d 2h Tc Qs] [8c]
FVs16t7GgfWgQWt4JxsObQ: bets $2
s7D3Y+k4Cj4D1cXHv7oj+Q: folds
FVs16t7GgfWgQWt4JxsObQ collected $6.20 from pot
*** SUMMARY ***
Total pot $6.50 | Rake $0.30
Board [4d 2h Tc Qs 8c]
Seat 1: s7D3Y+k4Cj4D1cXHv7oj+Q folded on the River
Seat 2: kiakSwxX0e64PwYGAPQvLw folded before Flop (didn't bet)
Seat 3: vR4IO10geOgvTW+LAUBv/A (button) folded before Flop (didn't bet)
Seat 4: bLbSOSmSOnqE0iTcH/5dxA (small blind) folded before Flop
Seat 5: bL+QVeDcuEdzMGAGg2XJHg (big blind) folded on the Turn
Seat 6: FVs16t7GgfWgQWt4JxsObQ collected ($6.20)
Seat 7: knewtTmBc4Tc0z/5tAABYQ folded before Flop (didn't bet)
Seat 8: zanka7aAZkigmZpfopXxxA folded on the Turn
Seat 9: ouwUBGRKnKK9uhn1G4Lf+A folded before Flop (didn't bet)



PokerStars Game #59939157156:  Hold'em No Limit ($0.50/$1.00) - 2009/07/01 0:32:45 ET
Table 'tLrtq7gDzxEvckNAI1OS5Q' 6-max Seat #6 is the button
Seat 1: GisIe1kcC9q/xV6ifsTjgA ($177.65 in chips)
Seat 2: QHvTZcrKe6+maWUfVjP29Q ($101.50 in chips)
Seat 4: KOG8rG51mOvIoY96zF3kvw ($158.80 in chips)
Seat 5: OGMLOcTNYZXZU81au7ztUw ($155.95 in chips)
Seat 6: XUk5GQsfNFpHvaToDZ0rZA ($44.75 in chips)
GisIe1kcC9q/xV6ifsTjgA: posts small blind $0.50
QHvTZcrKe6+maWUfVjP29Q: posts big blind $1
*** HOLE CARDS ***
KOG8rG51mOvIoY96zF3kvw: folds
OGMLOcTNYZXZU81au7ztUw: folds
KOG8rG51mOvIoY96zF3kvw leaves the table
XUk5GQsfNFpHvaToDZ0rZA: folds
GisIe1kcC9q/xV6ifsTjgA: folds
QHvTZcrKe6+maWUfVjP29Q collected $1 from pot
QHvTZcrKe6+maWUfVjP29Q: doesn't show hand
*** SUMMARY ***
Total pot $1 | Rake $0
Seat 1: GisIe1kcC9q/xV6ifsTjgA (small blind) folded before Flop
Seat 2: QHvTZcrKe6+maWUfVjP29Q (big blind) collected ($1)
Seat 4: KOG8rG51mOvIoY96zF3kvw folded before Flop (didn't bet)
Seat 5: OGMLOcTNYZXZU81au7ztUw folded before Flop (didn't bet)
Seat 6: XUk5GQsfNFpHvaToDZ0rZA (button) folded before Flop (didn't bet)



PokerStars Game #59939158436:  Hold'em No Limit ($0.50/$1.00) - 2009/07/01 0:32:46 ET
Table 'VOs36P6NW+QyXeQ1B62kmA' 6-max Seat #3 is the button
Seat 1: AdLVjddOzm+sRNo1Bc3S6Q ($139.65 in chips)
Seat 2: KpnW5CcJ4Mg6MeclfKmLrw ($113.30 in chips)
Seat 3: TSuRyAHnUPCFjP7Z0rEE0w ($100 in chips)
Seat 4: w02zQzNydODiyV9THKgo9w ($39.65 in chips)
Seat 5: X7GlkHF+lkbarCLuZ4Uf0w ($21 in chips)
Seat 6: 6tvjsJrdmWg+g7FVrMnzXA ($66.10 in chips)
w02zQzNydODiyV9THKgo9w: posts small blind $0.50
X7GlkHF+lkbarCLuZ4Uf0w: posts big blind $1
*** HOLE CARDS ***
6tvjsJrdmWg+g7FVrMnzXA: folds
AdLVjddOzm+sRNo1Bc3S6Q: folds
KpnW5CcJ4Mg6MeclfKmLrw: folds
TSuRyAHnUPCFjP7Z0rEE0w: folds
w02zQzNydODiyV9THKgo9w: calls $0.50
X7GlkHF+lkbarCLuZ4Uf0w: raises $20 to $21 and is all-in
w02zQzNydODiyV9THKgo9w: folds
X7GlkHF+lkbarCLuZ4Uf0w collected $2 from pot
X7GlkHF+lkbarCLuZ4Uf0w: doesn't show hand
*** SUMMARY ***
Total pot $2 | Rake $0
Seat 1: AdLVjddOzm+sRNo1Bc3S6Q folded before Flop (didn't bet)
Seat 2: KpnW5CcJ4Mg6MeclfKmLrw folded before Flop (didn't bet)
Seat 3: TSuRyAHnUPCFjP7Z0rEE0w (button) folded before Flop (didn't bet)
Seat 4: w02zQzNydODiyV9THKgo9w (small blind) folded before Flop
Seat 5: X7GlkHF+lkbarCLuZ4Uf0w (big blind) collected ($2)
Seat 6: 6tvjsJrdmWg+g7FVrMnzXA folded before Flop (didn't bet)



PokerStars Game #59939158840:  Hold'em No Limit ($0.50/$1.00) - 2009/07/01 0:32:47 ET
Table 'hugOjcwJvzEwZbK7tyiWuQ' 9-max Seat #6 is the button
Seat 1: N9n5Wc3s35DpCrOAUUNAaQ ($128.50 in chips)
Seat 2: r27C1nIV4NS4+qbnrgBQSw ($257.05 in chips)
Seat 3: jDwhY1kCdc6EkAHbT7PJMQ ($109.75 in chips)
Seat 4: UWB3oeddt/GObx2Mix2Anw ($199.80 in chips)
Seat 6: gUUvmqdVlmvpal6B8nYrmg ($100 in chips)
Seat 7: FL3MrLspcF23LYvC4ipBOA ($100.50 in chips)
Seat 8: /zy+DB4S5fUQUSfZWFzYGw ($110.25 in chips)
Seat 9: o6JyUkbzCDw8tUabqtmnlg ($57.60 in chips)
FL3MrLspcF23LYvC4ipBOA: posts small blind $0.50
/zy+DB4S5fUQUSfZWFzYGw: posts big blind $1
*** HOLE CARDS ***
o6JyUkbzCDw8tUabqtmnlg: folds
N9n5Wc3s35DpCrOAUUNAaQ: folds
r27C1nIV4NS4+qbnrgBQSw: folds
jDwhY1kCdc6EkAHbT7PJMQ: raises $3 to $4
UWB3oeddt/GObx2Mix2Anw: folds
gUUvmqdVlmvpal6B8nYrmg: calls $4
FL3MrLspcF23LYvC4ipBOA: folds
/zy+DB4S5fUQUSfZWFzYGw: calls $3
*** FLOP *** [Jd Kd 2c]
/zy+DB4S5fUQUSfZWFzYGw: checks
jDwhY1kCdc6EkAHbT7PJMQ: bets $8
gUUvmqdVlmvpal6B8nYrmg: folds
/zy+DB4S5fUQUSfZWFzYGw: folds
jDwhY1kCdc6EkAHbT7PJMQ collected $11.90 from pot
*** SUMMARY ***
Total pot $12.50 | Rake $0.60
Board [Jd Kd 2c]
Seat 1: N9n5Wc3s35DpCrOAUUNAaQ folded before Flop (didn't bet)
Seat 2: r27C1nIV4NS4+qbnrgBQSw folded before Flop (didn't bet)
Seat 3: jDwhY1kCdc6EkAHbT7PJMQ collected ($11.90)
Seat 4: UWB3oeddt/GObx2Mix2Anw folded before Flop (didn't bet)
Seat 6: gUUvmqdVlmvpal6B8nYrmg (button) folded on the Flop
Seat 7: FL3MrLspcF23LYvC4ipBOA (small blind) folded before Flop
Seat 8: /zy+DB4S5fUQUSfZWFzYGw (big blind) folded on the Flop
Seat 9: o6JyUkbzCDw8tUabqtmnlg folded before Flop (didn't bet)



PokerStars Game #59939159454:  Hold'em No Limit ($0.50/$1.00) - 2009/07/01 0:32:48 ET
Table 'GxCPo/gd3OSthkYrAxJngg' 6-max Seat #2 is the button
Seat 1: sH8BpAFP+jGFxCgVpD1Lew ($278.45 in chips)
Seat 2: YExX2paeIHrmfIwV1ivM/w ($63.70 in chips)
Seat 3: o6plE+MSW4XFNTeONe16xg ($34.60 in chips)
Seat 4: YMJG+F++3Aj6P8dAWda5fw ($109.65 in chips)
Seat 5: G5ZSSN6RSON3gkNvk/SmYg ($103.20 in chips)
Seat 6: sS9IXedL3MiRmpVXhAILhw ($98.30 in chips)
o6plE+MSW4XFNTeONe16xg: posts small blind $0.50
YMJG+F++3Aj6P8dAWda5fw: posts big blind $1
*** HOLE CARDS ***
G5ZSSN6RSON3gkNvk/SmYg: folds
sS9IXedL3MiRmpVXhAILhw: raises $2 to $3
sH8BpAFP+jGFxCgVpD1Lew: calls $3
YExX2paeIHrmfIwV1ivM/w: folds
o6plE+MSW4XFNTeONe16xg: folds
YMJG+F++3Aj6P8dAWda5fw: folds
*** FLOP *** [6d Ts Jd]
sS9IXedL3MiRmpVXhAILhw: bets $4
sH8BpAFP+jGFxCgVpD1Lew: folds
sS9IXedL3MiRmpVXhAILhw collected $7.15 from pot
*** SUMMARY ***
Total pot $7.50 | Rake $0.35
Board [6d Ts Jd]
Seat 1: sH8BpAFP+jGFxCgVpD1Lew folded on the Flop
Seat 2: YExX2paeIHrmfIwV1ivM/w (button) folded before Flop (didn't bet)
Seat 3: o6plE+MSW4XFNTeONe16xg (small blind) folded before Flop
Seat 4: YMJG+F++3Aj6P8dAWda5fw (big blind) folded before Flop
Seat 5: G5ZSSN6RSON3gkNvk/SmYg folded before Flop (didn't bet)
Seat 6: sS9IXedL3MiRmpVXhAILhw collected ($7.15)



PokerStars Game #59939159760:  Hold'em No Limit ($0.50/$1.00) - 2009/07/01 0:32:48 ET
Table 'O96CPOtvMBWP6kzuYDfdFA' 6-max Seat #3 is the button
Seat 1: 6alLXQIITA2EZ/lBeym8Dw ($100 in chips)
Seat 2: sc/HX9smXU5kObrOWIYO5g ($35 in chips)
Seat 3: V89DGjxE171oPREEbAXiyg ($37.55 in chips)
Seat 4: KOG8rG51mOvIoY96zF3kvw ($164.60 in chips)
Seat 5: wRxiu9OJzvvN84OYWW9jxQ ($135.60 in chips)
Seat 6: xNKcQzD9+/iHmtJn4vYq9w ($141.65 in chips)
KOG8rG51mOvIoY96zF3kvw: posts small blind $0.50
wRxiu9OJzvvN84OYWW9jxQ: posts big blind $1
*** HOLE CARDS ***
xNKcQzD9+/iHmtJn4vYq9w: folds
6alLXQIITA2EZ/lBeym8Dw: folds
sc/HX9smXU5kObrOWIYO5g: folds
V89DGjxE171oPREEbAXiyg: folds
KOG8rG51mOvIoY96zF3kvw: folds
wRxiu9OJzvvN84OYWW9jxQ collected $1 from pot
*** SUMMARY ***
Total pot $1 | Rake $0
Seat 1: 6alLXQIITA2EZ/lBeym8Dw folded before Flop (didn't bet)
Seat 2: sc/HX9smXU5kObrOWIYO5g folded before Flop (didn't bet)
Seat 3: V89DGjxE171oPREEbAXiyg (button) folded before Flop (didn't bet)
Seat 4: KOG8rG51mOvIoY96zF3kvw (small blind) folded before Flop
Seat 5: wRxiu9OJzvvN84OYWW9jxQ (big blind) collected ($1)
Seat 6: xNKcQzD9+/iHmtJn4vYq9w folded before Flop (didn't bet)



PokerStars Game #59939159442:  Hold'em No Limit ($0.50/$1.00) - 2009/07/01 0:32:48 ET
Table 'QBLDswtHe7Ml0HwAdcMhlw' 2-max Seat #2 is the button
Seat 1: hdNlhiCwI533uwvvTTfC9Q ($100 in chips)
Seat 2: rAtTyvrJ8f1LaUh2O5U4nA ($34.20 in chips)
rAtTyvrJ8f1LaUh2O5U4nA: posts small blind $0.50
hdNlhiCwI533uwvvTTfC9Q: posts big blind $1
*** HOLE CARDS ***
rAtTyvrJ8f1LaUh2O5U4nA: folds
hdNlhiCwI533uwvvTTfC9Q collected $1 from pot
hdNlhiCwI533uwvvTTfC9Q: doesn't show hand
*** SUMMARY ***
Total pot $1 | Rake $0
Seat 1: hdNlhiCwI533uwvvTTfC9Q (big blind) collected ($1)
Seat 2: rAtTyvrJ8f1LaUh2O5U4nA (button) (small blind) folded before Flop



PokerStars Game #59939160562:  Hold'em No Limit ($0.50/$1.00) - 2009/07/01 0:32:50 ET
Table '/FUb199IViHMJHi5YWmeuQ' 9-max Seat #9 is the button
Seat 1: TZcz9MEWDA+WydgGruqqbw ($102.35 in chips)
Seat 2: FL3MrLspcF23LYvC4ipBOA ($137.25 in chips)
Seat 3: qN483QJ1NvHbdIZB7J4ARw ($61.35 in chips)
Seat 6: ccFf7Q4z1cTGQmeoYiWEfw ($51.95 in chips)
Seat 7: bLbSOSmSOnqE0iTcH/5dxA ($100 in chips)
Seat 8: QIWvt0R766g8KfH0vl1s0A ($32.90 in chips)
Seat 9: knewtTmBc4Tc0z/5tAABYQ ($155.15 in chips)
TZcz9MEWDA+WydgGruqqbw: posts small blind $0.50
FL3MrLspcF23LYvC4ipBOA: posts big blind $1
qheQay5YvP2DMAb3OUSxtw: sits out
*** HOLE CARDS ***
qN483QJ1NvHbdIZB7J4ARw: calls $1
ccFf7Q4z1cTGQmeoYiWEfw: folds
bLbSOSmSOnqE0iTcH/5dxA: folds
BbWpm6CYaA1D8P5EYEEwkQ joins the table at seat #5
QIWvt0R766g8KfH0vl1s0A: folds
knewtTmBc4Tc0z/5tAABYQ: folds
TZcz9MEWDA+WydgGruqqbw: folds
FL3MrLspcF23LYvC4ipBOA: checks
*** FLOP *** [4c Ah 9h]
FL3MrLspcF23LYvC4ipBOA: checks
qN483QJ1NvHbdIZB7J4ARw: bets $2
FL3MrLspcF23LYvC4ipBOA: folds
qN483QJ1NvHbdIZB7J4ARw collected $2.40 from pot
*** SUMMARY ***
Total pot $2.50 | Rake $0.10
Board [4c Ah 9h]
Seat 1: TZcz9MEWDA+WydgGruqqbw (small blind) folded before Flop
Seat 2: FL3MrLspcF23LYvC4ipBOA (big blind) folded on the Flop
Seat 3: qN483QJ1NvHbdIZB7J4ARw collected ($2.40)
Seat 6: ccFf7Q4z1cTGQmeoYiWEfw folded before Flop (didn't bet)
Seat 7: bLbSOSmSOnqE0iTcH/5dxA folded before Flop (didn't bet)
Seat 8: QIWvt0R766g8KfH0vl1s0A folded before Flop (didn't bet)
Seat 9: knewtTmBc4Tc0z/5tAABYQ (button) folded before Flop (didn't bet)



PokerStars Game #59939161624:  Hold'em No Limit ($0.50/$1.00) - 2009/07/01 0:32:51 ET
Table '6YvsYDPNIDx2v5z3bJnwZQ' 9-max Seat #4 is the button
Seat 1: Ogn4JDV3mp4ZDKO49IFzKA ($14.50 in chips)
Seat 2: 35DmRulmD2MgzT6Bbt6/2w ($34.10 in chips)
Seat 3: negfosHnGOZXSHpWDRKyBQ ($19.30 in chips)
Seat 4: kEr5NYB+JIG5+szcYMr6hA ($45 in chips)
Seat 5: mBRWbnUl8diyBO1qTJaNzw ($161.20 in chips)
Seat 6: uMPEfCcGCfsxmy53tVUMug ($106.40 in chips)
Seat 7: boixc27eqTYA1p0tUdMuBQ ($114 in chips)
Seat 8: PSFxpXgPedVZyHSu2Zhb7Q ($65.25 in chips)
Seat 9: jDwhY1kCdc6EkAHbT7PJMQ ($105.60 in chips)
mBRWbnUl8diyBO1qTJaNzw: posts small blind $0.50
uMPEfCcGCfsxmy53tVUMug: posts big blind $1
*** HOLE CARDS ***
boixc27eqTYA1p0tUdMuBQ: folds
PSFxpXgPedVZyHSu2Zhb7Q: calls $1
jDwhY1kCdc6EkAHbT7PJMQ: folds
Ogn4JDV3mp4ZDKO49IFzKA: folds
35DmRulmD2MgzT6Bbt6/2w: calls $1
negfosHnGOZXSHpWDRKyBQ: folds
kEr5NYB+JIG5+szcYMr6hA: folds
mBRWbnUl8diyBO1qTJaNzw: folds
uMPEfCcGCfsxmy53tVUMug: checks
*** FLOP *** [2s As 9d]
uMPEfCcGCfsxmy53tVUMug: checks
PSFxpXgPedVZyHSu2Zhb7Q: checks
35DmRulmD2MgzT6Bbt6/2w: checks
*** TURN *** [2s As 9d] [Qc]
uMPEfCcGCfsxmy53tVUMug: bets $3
PSFxpXgPedVZyHSu2Zhb7Q: calls $3
35DmRulmD2MgzT6Bbt6/2w: raises $3 to $6
uMPEfCcGCfsxmy53tVUMug: folds
PSFxpXgPedVZyHSu2Zhb7Q: calls $3
*** RIVER *** [2s As 9d Qc] [6h]
PSFxpXgPedVZyHSu2Zhb7Q: checks
35DmRulmD2MgzT6Bbt6/2w: bets $8
PSFxpXgPedVZyHSu2Zhb7Q: calls $8
*** SHOW DOWN ***
35DmRulmD2MgzT6Bbt6/2w: shows [Ac 2c] (two pair, Aces and Deuces)
PSFxpXgPedVZyHSu2Zhb7Q: mucks hand
35DmRulmD2MgzT6Bbt6/2w collected $32.85 from pot
*** SUMMARY ***
Total pot $34.50 | Rake $1.65
Board [2s As 9d Qc 6h]
Seat 1: Ogn4JDV3mp4ZDKO49IFzKA folded before Flop (didn't bet)
Seat 2: 35DmRulmD2MgzT6Bbt6/2w showed [Ac 2c] and won ($32.85) with two pair, Aces and Deuces
Seat 3: negfosHnGOZXSHpWDRKyBQ folded before Flop (didn't bet)
Seat 4: kEr5NYB+JIG5+szcYMr6hA (button) folded before Flop (didn't bet)
Seat 5: mBRWbnUl8diyBO1qTJaNzw (small blind) folded before Flop
Seat 6: uMPEfCcGCfsxmy53tVUMug (big blind) folded on the Turn
Seat 7: boixc27eqTYA1p0tUdMuBQ folded before Flop (didn't bet)
Seat 8: PSFxpXgPedVZyHSu2Zhb7Q mucked
Seat 9: jDwhY1kCdc6EkAHbT7PJMQ folded before Flop (didn't bet)



PokerStars Game #59939161226:  Hold'em No Limit ($0.50/$1.00) - 2009/07/01 0:32:51 ET
Table 'vs/5jr6ciwjVQ5+Soc+u2A' 6-max Seat #6 is the button
Seat 1: 3yN2jRjZ+glIaWtGMmKOrA ($16 in chips)
Seat 2: XOIf9W+VAxhZqN+SYoyMKA ($122.65 in chips)
Seat 3: G5ZSSN6RSON3gkNvk/SmYg ($100 in chips)
Seat 4: KpnW5CcJ4Mg6MeclfKmLrw ($109.80 in chips)
Seat 5: 7Vc9JmGFQwMRh5Tj9ui5Lw ($104.55 in chips)
Seat 6: QHvTZcrKe6+maWUfVjP29Q ($101.50 in chips)
3yN2jRjZ+glIaWtGMmKOrA: posts small blind $0.50
XOIf9W+VAxhZqN+SYoyMKA: posts big blind $1
*** HOLE CARDS ***
G5ZSSN6RSON3gkNvk/SmYg: folds
KpnW5CcJ4Mg6MeclfKmLrw: folds
7Vc9JmGFQwMRh5Tj9ui5Lw: folds
QHvTZcrKe6+maWUfVjP29Q: raises $2 to $3
3yN2jRjZ+glIaWtGMmKOrA: calls $2.50
XOIf9W+VAxhZqN+SYoyMKA: calls $2
*** FLOP *** [7s 9c Jd]
3yN2jRjZ+glIaWtGMmKOrA: bets $5
XOIf9W+VAxhZqN+SYoyMKA: folds
QHvTZcrKe6+maWUfVjP29Q: folds
3yN2jRjZ+glIaWtGMmKOrA collected $8.55 from pot
*** SUMMARY ***
Total pot $9 | Rake $0.45
Board [7s 9c Jd]
Seat 1: 3yN2jRjZ+glIaWtGMmKOrA (small blind) collected ($8.55)
Seat 2: XOIf9W+VAxhZqN+SYoyMKA (big blind) folded on the Flop
Seat 3: G5ZSSN6RSON3gkNvk/SmYg folded before Flop (didn't bet)
Seat 4: KpnW5CcJ4Mg6MeclfKmLrw folded before Flop (didn't bet)
Seat 5: 7Vc9JmGFQwMRh5Tj9ui5Lw folded before Flop (didn't bet)
Seat 6: QHvTZcrKe6+maWUfVjP29Q (button) folded on the Flop



PokerStars Game #59939162810:  Hold'em No Limit ($0.50/$1.00) - 2009/07/01 0:32:53 ET
Table 'MUPc8FEpe/nR0BKSeReX6Q' 6-max Seat #3 is the button
Seat 1: YsLQ3BAvgQHWXMAv3Wv6Hg ($100 in chips)
Seat 2: xAU6q2/cwmby2sxmA8VcmA ($109 in chips)
Seat 3: wx3sQGkVi2x9wJXuWNHPBw ($234.05 in chips)
Seat 4: ZA1bp6g8IwtTxkUE4eCjDQ ($119.60 in chips)
Seat 5: UBZQqpnJZdTYYY1FTb0rLA ($100 in chips)
Seat 6: oxnw0GLLpFanjhGkxfRSqA ($52.10 in chips)
ZA1bp6g8IwtTxkUE4eCjDQ: posts small blind $0.50
UBZQqpnJZdTYYY1FTb0rLA: posts big blind $1
*** HOLE CARDS ***
oxnw0GLLpFanjhGkxfRSqA: calls $1
YsLQ3BAvgQHWXMAv3Wv6Hg: folds
xAU6q2/cwmby2sxmA8VcmA: folds
wx3sQGkVi2x9wJXuWNHPBw: folds
ZA1bp6g8IwtTxkUE4eCjDQ: folds
UBZQqpnJZdTYYY1FTb0rLA: checks
*** FLOP *** [Td 8h 2d]
UBZQqpnJZdTYYY1FTb0rLA: bets $2
oxnw0GLLpFanjhGkxfRSqA: folds
UBZQqpnJZdTYYY1FTb0rLA collected $2.40 from pot
UBZQqpnJZdTYYY1FTb0rLA: doesn't show hand
*** SUMMARY ***
Total pot $2.50 | Rake $0.10
Board [Td 8h 2d]
Seat 1: YsLQ3BAvgQHWXMAv3Wv6Hg folded before Flop (didn't bet)
Seat 2: xAU6q2/cwmby2sxmA8VcmA folded before Flop (didn't bet)
Seat 3: wx3sQGkVi2x9wJXuWNHPBw (button) folded before Flop (didn't bet)
Seat 4: ZA1bp6g8IwtTxkUE4eCjDQ (small blind) folded before Flop
Seat 5: UBZQqpnJZdTYYY1FTb0rLA (big blind) collected ($2.40)
Seat 6: oxnw0GLLpFanjhGkxfRSqA folded on the Flop



PokerStars Game #59939164746:  Hold'em No Limit ($0.50/$1.00) - 2009/07/01 0:32:56 ET
Table 'tLrtq7gDzxEvckNAI1OS5Q' 6-max Seat #1 is the button
Seat 1: GisIe1kcC9q/xV6ifsTjgA ($177.15 in chips)
Seat 2: QHvTZcrKe6+maWUfVjP29Q ($102 in chips)
Seat 5: OGMLOcTNYZXZU81au7ztUw ($155.95 in chips)
Seat 6: XUk5GQsfNFpHvaToDZ0rZA ($44.75 in chips)
QHvTZcrKe6+maWUfVjP29Q: posts small blind $0.50
OGMLOcTNYZXZU81au7ztUw: posts big blind $1
*** HOLE CARDS ***
XUk5GQsfNFpHvaToDZ0rZA: calls $1
GisIe1kcC9q/xV6ifsTjgA: calls $1
QHvTZcrKe6+maWUfVjP29Q: calls $0.50
OGMLOcTNYZXZU81au7ztUw: checks
*** FLOP *** [Ts Jc 4d]
TPZ+m9x+lwoKpv7TMfAUWA has returned
QHvTZcrKe6+maWUfVjP29Q: checks
OGMLOcTNYZXZU81au7ztUw: checks
XUk5GQsfNFpHvaToDZ0rZA: checks
GisIe1kcC9q/xV6ifsTjgA: bets $2
QHvTZcrKe6+maWUfVjP29Q: folds
OGMLOcTNYZXZU81au7ztUw: calls $2
XUk5GQsfNFpHvaToDZ0rZA: folds
*** TURN *** [Ts Jc 4d] [7d]
OGMLOcTNYZXZU81au7ztUw: checks
GisIe1kcC9q/xV6ifsTjgA: checks
*** RIVER *** [Ts Jc 4d 7d] [Js]
OGMLOcTNYZXZU81au7ztUw: checks
GisIe1kcC9q/xV6ifsTjgA: checks
*** SHOW DOWN ***
OGMLOcTNYZXZU81au7ztUw: shows [As Th] (two pair, Jacks and Tens)
GisIe1kcC9q/xV6ifsTjgA: mucks hand
OGMLOcTNYZXZU81au7ztUw collected $7.65 from pot
*** SUMMARY ***
Total pot $8 | Rake $0.35
Board [Ts Jc 4d 7d Js]
Seat 1: GisIe1kcC9q/xV6ifsTjgA (button) mucked
Seat 2: QHvTZcrKe6+maWUfVjP29Q (small blind) folded on the Flop
Seat 5: OGMLOcTNYZXZU81au7ztUw (big blind) showed [As Th] and won ($7.65) with two pair, Jacks and Tens
Seat 6: XUk5GQsfNFpHvaToDZ0rZA folded on the Flop



PokerStars Game #59939167672:  Hold'em No Limit ($0.50/$1.00) - 2009/07/01 0:33:01 ET
Table 'kS0cTQAEi+fdUlJP2gQYvw' 9-max Seat #1 is the button
Seat 1: c/9X4zftzphFxYtxp5kp9w ($39.40 in chips)
Seat 3: 3obndzTJ6fECz8+wWhMd1w ($19.50 in chips)
Seat 4: TZcz9MEWDA+WydgGruqqbw ($101.50 in chips)
Seat 5: 2rxrMrE7koO2BNxvop/0+g ($51.55 in chips)
Seat 6: yAbu2QsRPVcjPbqlf/jDxw ($100 in chips)
Seat 7: Ffa7Nj4X5fddtROP01hfQg ($109.80 in chips)
Seat 8: qTymj6ZQ8ZoFi6fINJZb3w ($80.50 in chips)
Seat 9: y8Qb94e81yI/g0saQ6gU5g ($55.25 in chips)
3obndzTJ6fECz8+wWhMd1w: posts small blind $0.50
TZcz9MEWDA+WydgGruqqbw: posts big blind $1
*** HOLE CARDS ***
2rxrMrE7koO2BNxvop/0+g: folds
yAbu2QsRPVcjPbqlf/jDxw: folds
Ffa7Nj4X5fddtROP01hfQg: calls $1
qTymj6ZQ8ZoFi6fINJZb3w: folds
y8Qb94e81yI/g0saQ6gU5g: folds
c/9X4zftzphFxYtxp5kp9w: folds
3obndzTJ6fECz8+wWhMd1w: folds
TZcz9MEWDA+WydgGruqqbw: checks
*** FLOP *** [Tc Kd Qh]
TZcz9MEWDA+WydgGruqqbw: checks
Ffa7Nj4X5fddtROP01hfQg: bets $2
TZcz9MEWDA+WydgGruqqbw: folds
Ffa7Nj4X5fddtROP01hfQg collected $2.40 from pot
*** SUMMARY ***
Total pot $2.50 | Rake $0.10
Board [Tc Kd Qh]
Seat 1: c/9X4zftzphFxYtxp5kp9w (button) folded before Flop (didn't bet)
Seat 3: 3obndzTJ6fECz8+wWhMd1w (small blind) folded before Flop
Seat 4: TZcz9MEWDA+WydgGruqqbw (big blind) folded on the Flop
Seat 5: 2rxrMrE7koO2BNxvop/0+g folded before Flop (didn't bet)
Seat 6: yAbu2QsRPVcjPbqlf/jDxw folded before Flop (didn't bet)
Seat 7: Ffa7Nj4X5fddtROP01hfQg collected ($2.40)
Seat 8: qTymj6ZQ8ZoFi6fINJZb3w folded before Flop (didn't bet)
Seat 9: y8Qb94e81yI/g0saQ6gU5g folded before Flop (didn't bet)



PokerStars Game #59939168512:  Hold'em No Limit ($0.50/$1.00) - 2009/07/01 0:33:02 ET
Table '/RZcOwpZpHQ+OwPwjsbnRw' 6-max Seat #1 is the button
Seat 1: Zboa6dColKGHBjLPUakZjw ($52.70 in chips)
Seat 2: dHC9PH9hdH3Ad2TD8ZxX0Q ($43.25 in chips)
Seat 3: OigyyiK+tTj1APPIAUmXDA ($72.65 in chips)
Seat 4: j7NIOHLZk7V2o9fOioO5ug ($115.10 in chips)
Seat 5: wx3sQGkVi2x9wJXuWNHPBw ($199.65 in chips)
Seat 6: XOIf9W+VAxhZqN+SYoyMKA ($249.30 in chips)
dHC9PH9hdH3Ad2TD8ZxX0Q: posts small blind $0.50
OigyyiK+tTj1APPIAUmXDA: posts big blind $1
*** HOLE CARDS ***
j7NIOHLZk7V2o9fOioO5ug: folds
wx3sQGkVi2x9wJXuWNHPBw: folds
XOIf9W+VAxhZqN+SYoyMKA: raises $2 to $3
Zboa6dColKGHBjLPUakZjw: folds
dHC9PH9hdH3Ad2TD8ZxX0Q: raises $4 to $7
OigyyiK+tTj1APPIAUmXDA: folds
XOIf9W+VAxhZqN+SYoyMKA: folds
dHC9PH9hdH3Ad2TD8ZxX0Q collected $7 from pot
*** SUMMARY ***
Total pot $7 | Rake $0
Seat 1: Zboa6dColKGHBjLPUakZjw (button) folded before Flop (didn't bet)
Seat 2: dHC9PH9hdH3Ad2TD8ZxX0Q (small blind) collected ($7)
Seat 3: OigyyiK+tTj1APPIAUmXDA (big blind) folded before Flop
Seat 4: j7NIOHLZk7V2o9fOioO5ug folded before Flop (didn't bet)
Seat 5: wx3sQGkVi2x9wJXuWNHPBw folded before Flop (didn't bet)
Seat 6: XOIf9W+VAxhZqN+SYoyMKA folded before Flop



PokerStars Game #59939168454:  Hold'em No Limit ($0.50/$1.00) - 2009/07/01 0:33:02 ET
Table 'QBLDswtHe7Ml0HwAdcMhlw' 2-max Seat #1 is the button
Seat 1: hdNlhiCwI533uwvvTTfC9Q ($100.50 in chips)
Seat 2: rAtTyvrJ8f1LaUh2O5U4nA ($33.70 in chips)
hdNlhiCwI533uwvvTTfC9Q: posts small blind $0.50
rAtTyvrJ8f1LaUh2O5U4nA: posts big blind $1
*** HOLE CARDS ***
hdNlhiCwI533uwvvTTfC9Q: raises $2 to $3
rAtTyvrJ8f1LaUh2O5U4nA: calls $2
*** FLOP *** [9h Js Tc]
rAtTyvrJ8f1LaUh2O5U4nA: checks
hdNlhiCwI533uwvvTTfC9Q: checks
*** TURN *** [9h Js Tc] [5s]
rAtTyvrJ8f1LaUh2O5U4nA: checks
hdNlhiCwI533uwvvTTfC9Q: checks
*** RIVER *** [9h Js Tc 5s] [Td]
rAtTyvrJ8f1LaUh2O5U4nA: checks
hdNlhiCwI533uwvvTTfC9Q: checks
*** SHOW DOWN ***
rAtTyvrJ8f1LaUh2O5U4nA: shows [3c Ad] (a pair of Tens)
hdNlhiCwI533uwvvTTfC9Q: mucks hand
rAtTyvrJ8f1LaUh2O5U4nA collected $5.70 from pot
rAtTyvrJ8f1LaUh2O5U4nA is sitting out
*** SUMMARY ***
Total pot $6 | Rake $0.30
Board [9h Js Tc 5s Td]
Seat 1: hdNlhiCwI533uwvvTTfC9Q (button) (small blind) mucked
Seat 2: rAtTyvrJ8f1LaUh2O5U4nA (big blind) showed [3c Ad] and won ($5.70) with a pair of Tens



PokerStars Game #59939171056:  Hold'em No Limit ($0.50/$1.00) - 2009/07/01 0:33:05 ET
Table 'VOs36P6NW+QyXeQ1B62kmA' 6-max Seat #4 is the button
Seat 1: AdLVjddOzm+sRNo1Bc3S6Q ($139.65 in chips)
Seat 2: KpnW5CcJ4Mg6MeclfKmLrw ($113.30 in chips)
Seat 3: TSuRyAHnUPCFjP7Z0rEE0w ($100 in chips)
Seat 4: w02zQzNydODiyV9THKgo9w ($38.65 in chips)
Seat 5: X7GlkHF+lkbarCLuZ4Uf0w ($22 in chips)
Seat 6: 6tvjsJrdmWg+g7FVrMnzXA ($66.10 in chips)
X7GlkHF+lkbarCLuZ4Uf0w: posts small blind $0.50
6tvjsJrdmWg+g7FVrMnzXA: posts big blind $1
*** HOLE CARDS ***
AdLVjddOzm+sRNo1Bc3S6Q: folds
KpnW5CcJ4Mg6MeclfKmLrw: folds
TSuRyAHnUPCFjP7Z0rEE0w: folds
w02zQzNydODiyV9THKgo9w: folds
X7GlkHF+lkbarCLuZ4Uf0w: folds
6tvjsJrdmWg+g7FVrMnzXA collected $1 from pot
6tvjsJrdmWg+g7FVrMnzXA: doesn't show hand
*** SUMMARY ***
Total pot $1 | Rake $0
Seat 1: AdLVjddOzm+sRNo1Bc3S6Q folded before Flop (didn't bet)
Seat 2: KpnW5CcJ4Mg6MeclfKmLrw folded before Flop (didn't bet)
Seat 3: TSuRyAHnUPCFjP7Z0rEE0w folded before Flop (didn't bet)
Seat 4: w02zQzNydODiyV9THKgo9w (button) folded before Flop (didn't bet)
Seat 5: X7GlkHF+lkbarCLuZ4Uf0w (small blind) folded before Flop
Seat 6: 6tvjsJrdmWg+g7FVrMnzXA (big blind) collected ($1)



PokerStars Game #59939170514:  Hold'em No Limit ($0.50/$1.00) - 2009/07/01 0:33:05 ET
Table 'eU3bWpDDg3Z+9R4m4iVmog' 6-max Seat #4 is the button
Seat 1: TSuRyAHnUPCFjP7Z0rEE0w ($165.60 in chips)
Seat 2: 8CAoOzhmB8n3nRFf3V4BTg ($124.95 in chips)
Seat 3: U6tnjwZRpTnM+YkqkCjwyQ ($174.15 in chips)
Seat 4: GDVIsbEJ/DOJsMKE4Asz0A ($102.10 in chips)
Seat 6: hpxXcmRkXXI9HE5+5/j/0Q ($104 in chips)
AdLVjddOzm+sRNo1Bc3S6Q will be allowed to play after the button
hpxXcmRkXXI9HE5+5/j/0Q: posts small blind $0.50
TSuRyAHnUPCFjP7Z0rEE0w: posts big blind $1
*** HOLE CARDS ***
8CAoOzhmB8n3nRFf3V4BTg: folds
U6tnjwZRpTnM+YkqkCjwyQ: folds
GDVIsbEJ/DOJsMKE4Asz0A: folds
hpxXcmRkXXI9HE5+5/j/0Q: folds
TSuRyAHnUPCFjP7Z0rEE0w collected $1 from pot
TSuRyAHnUPCFjP7Z0rEE0w: doesn't show hand
*** SUMMARY ***
Total pot $1 | Rake $0
Seat 1: TSuRyAHnUPCFjP7Z0rEE0w (big blind) collected ($1)
Seat 2: 8CAoOzhmB8n3nRFf3V4BTg folded before Flop (didn't bet)
Seat 3: U6tnjwZRpTnM+YkqkCjwyQ folded before Flop (didn't bet)
Seat 4: GDVIsbEJ/DOJsMKE4Asz0A (button) folded before Flop (didn't bet)
Seat 6: hpxXcmRkXXI9HE5+5/j/0Q (small blind) folded before Flop



PokerStars Game #59939173526:  Hold'em No Limit ($0.50/$1.00) - 2009/07/01 0:33:09 ET
Table 'U9zqzC8f3oTJ2ShXFgSSOA' 6-max Seat #2 is the button
Seat 1: tS9JHB1h+FQ++qu8RwRNgg ($34.50 in chips)
Seat 2: U2CWBTv29qdCbj8RNF2sIw ($99.50 in chips)
Seat 3: yfXek8iJ7O4CFyqXrtGcfg ($34.55 in chips)
Seat 4: 33q95we0Etwgrm6guQGncw ($73.65 in chips)
Seat 5: KfwW5us6tydK81NYTtK1gw ($307.05 in chips)
Seat 6: aIxzFKdtpDSkUePKZy/niQ ($52 in chips)
yfXek8iJ7O4CFyqXrtGcfg: posts small blind $0.50
33q95we0Etwgrm6guQGncw: posts big blind $1
*** HOLE CARDS ***
KfwW5us6tydK81NYTtK1gw: folds
aIxzFKdtpDSkUePKZy/niQ: raises $3 to $4
tS9JHB1h+FQ++qu8RwRNgg: folds
U2CWBTv29qdCbj8RNF2sIw: folds
yfXek8iJ7O4CFyqXrtGcfg: folds
33q95we0Etwgrm6guQGncw: folds
aIxzFKdtpDSkUePKZy/niQ collected $2.50 from pot
*** SUMMARY ***
Total pot $2.50 | Rake $0
Seat 1: tS9JHB1h+FQ++qu8RwRNgg folded before Flop (didn't bet)
Seat 2: U2CWBTv29qdCbj8RNF2sIw (button) folded before Flop (didn't bet)
Seat 3: yfXek8iJ7O4CFyqXrtGcfg (small blind) folded before Flop
Seat 4: 33q95we0Etwgrm6guQGncw (big blind) folded before Flop
Seat 5: KfwW5us6tydK81NYTtK1gw folded before Flop (didn't bet)
Seat 6: aIxzFKdtpDSkUePKZy/niQ collected ($2.50)



PokerStars Game #59939173916:  Hold'em No Limit ($0.50/$1.00) - 2009/07/01 0:33:10 ET
Table 'O96CPOtvMBWP6kzuYDfdFA' 6-max Seat #4 is the button
Seat 1: 6alLXQIITA2EZ/lBeym8Dw ($100 in chips)
Seat 2: sc/HX9smXU5kObrOWIYO5g ($35 in chips)
Seat 3: V89DGjxE171oPREEbAXiyg ($37.55 in chips)
Seat 4: KOG8rG51mOvIoY96zF3kvw ($164.10 in chips)
Seat 5: wRxiu9OJzvvN84OYWW9jxQ ($136.10 in chips)
Seat 6: xNKcQzD9+/iHmtJn4vYq9w ($141.65 in chips)
wRxiu9OJzvvN84OYWW9jxQ: posts small blind $0.50
xNKcQzD9+/iHmtJn4vYq9w: posts big blind $1
*** HOLE CARDS ***
6alLXQIITA2EZ/lBeym8Dw: folds
sc/HX9smXU5kObrOWIYO5g: folds
V89DGjxE171oPREEbAXiyg: folds
KOG8rG51mOvIoY96zF3kvw: raises $2 to $3
wRxiu9OJzvvN84OYWW9jxQ: calls $2.50
xNKcQzD9+/iHmtJn4vYq9w: folds
*** FLOP *** [7s 3d 9c]
wRxiu9OJzvvN84OYWW9jxQ: checks
KOG8rG51mOvIoY96zF3kvw: checks
*** TURN *** [7s 3d 9c] [9h]
wRxiu9OJzvvN84OYWW9jxQ: checks
KOG8rG51mOvIoY96zF3kvw: checks
*** RIVER *** [7s 3d 9c 9h] [Td]
wRxiu9OJzvvN84OYWW9jxQ: checks
KOG8rG51mOvIoY96zF3kvw: checks
*** SHOW DOWN ***
wRxiu9OJzvvN84OYWW9jxQ: shows [5d 4h] (a pair of Nines)
KOG8rG51mOvIoY96zF3kvw: shows [Qh Ac] (a pair of Nines - Ace kicker)
KOG8rG51mOvIoY96zF3kvw collected $6.65 from pot
*** SUMMARY ***
Total pot $7 | Rake $0.35
Board [7s 3d 9c 9h Td]
Seat 1: 6alLXQIITA2EZ/lBeym8Dw folded before Flop (didn't bet)
Seat 2: sc/HX9smXU5kObrOWIYO5g folded before Flop (didn't bet)
Seat 3: V89DGjxE171oPREEbAXiyg folded before Flop (didn't bet)
Seat 4: KOG8rG51mOvIoY96zF3kvw (button) showed [Qh Ac] and won ($6.65) with a pair of Nines
Seat 5: wRxiu9OJzvvN84OYWW9jxQ (small blind) showed [5d 4h] and lost with a pair of Nines
Seat 6: xNKcQzD9+/iHmtJn4vYq9w (big blind) folded before Flop



PokerStars Game #59939175236:  Hold'em No Limit ($0.50/$1.00) - 2009/07/01 0:33:12 ET
Table 'SQLOQoANiHscJ8AL7zffbw' 9-max Seat #7 is the button
Seat 1: jPTRd6SpCp4xqAy2XQiTOw ($101.85 in chips)
Seat 2: /zy+DB4S5fUQUSfZWFzYGw ($277.85 in chips)
Seat 3: 0eFnow7+D7veCYQ+CG9FFw ($74.15 in chips)
Seat 4: N9n5Wc3s35DpCrOAUUNAaQ ($96.35 in chips)
Seat 5: L9njYvloJ1NdXjP8edHEAg ($109.05 in chips)
Seat 6: p5UKaxVobvptF0ANhR/q1A ($155.50 in chips)
Seat 7: bJckevFOcg//s0qyMQI6sQ ($102.05 in chips)
Seat 9: qJr25HAtvv1w/7IBvjMM3g ($245.75 in chips)
qJr25HAtvv1w/7IBvjMM3g: posts small blind $0.50
jPTRd6SpCp4xqAy2XQiTOw: posts big blind $1
*** HOLE CARDS ***
/zy+DB4S5fUQUSfZWFzYGw: folds
0eFnow7+D7veCYQ+CG9FFw: folds
N9n5Wc3s35DpCrOAUUNAaQ: folds
L9njYvloJ1NdXjP8edHEAg: folds
p5UKaxVobvptF0ANhR/q1A: folds
bJckevFOcg//s0qyMQI6sQ: folds
qJr25HAtvv1w/7IBvjMM3g: calls $0.50
jPTRd6SpCp4xqAy2XQiTOw: checks
*** FLOP *** [7h 5d 6h]
barrelproof7 joins the table at seat #8
qJr25HAtvv1w/7IBvjMM3g: checks
jPTRd6SpCp4xqAy2XQiTOw: bets $1
qJr25HAtvv1w/7IBvjMM3g: calls $1
*** TURN *** [7h 5d 6h] [Qs]
qJr25HAtvv1w/7IBvjMM3g: checks
jPTRd6SpCp4xqAy2XQiTOw: bets $4
qJr25HAtvv1w/7IBvjMM3g: calls $4
*** RIVER *** [7h 5d 6h Qs] [Js]
qJr25HAtvv1w/7IBvjMM3g: checks
jPTRd6SpCp4xqAy2XQiTOw: checks
*** SHOW DOWN ***
qJr25HAtvv1w/7IBvjMM3g: shows [Ks 8s] (high card King)
jPTRd6SpCp4xqAy2XQiTOw: shows [Ad 2c] (high card Ace)
jPTRd6SpCp4xqAy2XQiTOw collected $11.45 from pot
*** SUMMARY ***
Total pot $12 | Rake $0.55
Board [7h 5d 6h Qs Js]
Seat 1: jPTRd6SpCp4xqAy2XQiTOw (big blind) showed [Ad 2c] and won ($11.45) with high card Ace
Seat 2: /zy+DB4S5fUQUSfZWFzYGw folded before Flop (didn't bet)
Seat 3: 0eFnow7+D7veCYQ+CG9FFw folded before Flop (didn't bet)
Seat 4: N9n5Wc3s35DpCrOAUUNAaQ folded before Flop (didn't bet)
Seat 5: L9njYvloJ1NdXjP8edHEAg folded before Flop (didn't bet)
Seat 6: p5UKaxVobvptF0ANhR/q1A folded before Flop (didn't bet)
Seat 7: bJckevFOcg//s0qyMQI6sQ (button) folded before Flop (didn't bet)
Seat 9: qJr25HAtvv1w/7IBvjMM3g (small blind) showed [Ks 8s] and lost with high card King



PokerStars Game #59939179474:  Hold'em No Limit ($0.50/$1.00) - 2009/07/01 0:33:18 ET
Table 'eU3bWpDDg3Z+9R4m4iVmog' 6-max Seat #6 is the button
Seat 1: TSuRyAHnUPCFjP7Z0rEE0w ($166.10 in chips)
Seat 2: 8CAoOzhmB8n3nRFf3V4BTg ($124.95 in chips)
Seat 3: U6tnjwZRpTnM+YkqkCjwyQ ($174.15 in chips)
Seat 4: GDVIsbEJ/DOJsMKE4Asz0A ($102.10 in chips)
Seat 6: hpxXcmRkXXI9HE5+5/j/0Q ($103.50 in chips)
TSuRyAHnUPCFjP7Z0rEE0w: posts small blind $0.50
8CAoOzhmB8n3nRFf3V4BTg: posts big blind $1
AdLVjddOzm+sRNo1Bc3S6Q: sits out
*** HOLE CARDS ***
U6tnjwZRpTnM+YkqkCjwyQ: folds
GDVIsbEJ/DOJsMKE4Asz0A: folds
hpxXcmRkXXI9HE5+5/j/0Q: folds
TSuRyAHnUPCFjP7Z0rEE0w: folds
8CAoOzhmB8n3nRFf3V4BTg collected $1 from pot
*** SUMMARY ***
Total pot $1 | Rake $0
Seat 1: TSuRyAHnUPCFjP7Z0rEE0w (small blind) folded before Flop
Seat 2: 8CAoOzhmB8n3nRFf3V4BTg (big blind) collected ($1)
Seat 3: U6tnjwZRpTnM+YkqkCjwyQ folded before Flop (didn't bet)
Seat 4: GDVIsbEJ/DOJsMKE4Asz0A folded before Flop (didn't bet)
Seat 6: hpxXcmRkXXI9HE5+5/j/0Q (button) folded before Flop (didn't bet)



PokerStars Game #59939179102:  Hold'em No Limit ($0.50/$1.00) - 2009/07/01 0:33:18 ET
Table '21a4iYFKcuezM4nYx8DWTA' 2-max Seat #2 is the button
Seat 1: NYi6JFscYNrofSXy4sM+Yw ($179.50 in chips)
Seat 2: +sy/nlNI20yZraIjs4AALg ($19.45 in chips)
+sy/nlNI20yZraIjs4AALg: posts small blind $0.50
NYi6JFscYNrofSXy4sM+Yw: posts big blind $1
*** HOLE CARDS ***
+sy/nlNI20yZraIjs4AALg: folds
NYi6JFscYNrofSXy4sM+Yw collected $1 from pot
*** SUMMARY ***
Total pot $1 | Rake $0
Seat 1: NYi6JFscYNrofSXy4sM+Yw (big blind) collected ($1)
Seat 2: +sy/nlNI20yZraIjs4AALg (button) (small blind) folded before Flop



PokerStars Game #59939185632:  Hold'em No Limit ($0.50/$1.00) - 2009/07/01 0:33:27 ET
Table '21a4iYFKcuezM4nYx8DWTA' 2-max Seat #1 is the button
Seat 1: NYi6JFscYNrofSXy4sM+Yw ($180 in chips)
Seat 2: +sy/nlNI20yZraIjs4AALg ($18.95 in chips)
NYi6JFscYNrofSXy4sM+Yw: posts small blind $0.50
+sy/nlNI20yZraIjs4AALg: posts big blind $1
*** HOLE CARDS ***
NYi6JFscYNrofSXy4sM+Yw: raises $2 to $3
+sy/nlNI20yZraIjs4AALg: raises $15.95 to $18.95 and is all-in
NYi6JFscYNrofSXy4sM+Yw: folds
+sy/nlNI20yZraIjs4AALg collected $6 from pot
*** SUMMARY ***
Total pot $6 | Rake $0
Seat 1: NYi6JFscYNrofSXy4sM+Yw (button) (small blind) folded before Flop
Seat 2: +sy/nlNI20yZraIjs4AALg (big blind) collected ($6)



PokerStars Game #59939185950:  Hold'em No Limit ($0.50/$1.00) - 2009/07/01 0:33:28 ET
Table '/RZcOwpZpHQ+OwPwjsbnRw' 6-max Seat #2 is the button
Seat 1: Zboa6dColKGHBjLPUakZjw ($52.70 in chips)
Seat 2: dHC9PH9hdH3Ad2TD8ZxX0Q ($47.25 in chips)
Seat 3: OigyyiK+tTj1APPIAUmXDA ($71.65 in chips)
Seat 4: j7NIOHLZk7V2o9fOioO5ug ($115.10 in chips)
Seat 5: wx3sQGkVi2x9wJXuWNHPBw ($199.65 in chips)
Seat 6: XOIf9W+VAxhZqN+SYoyMKA ($246.30 in chips)
OigyyiK+tTj1APPIAUmXDA: posts small blind $0.50
j7NIOHLZk7V2o9fOioO5ug: posts big blind $1
*** HOLE CARDS ***
wx3sQGkVi2x9wJXuWNHPBw: folds
XOIf9W+VAxhZqN+SYoyMKA: folds
Zboa6dColKGHBjLPUakZjw: folds
dHC9PH9hdH3Ad2TD8ZxX0Q: raises $1 to $2
OigyyiK+tTj1APPIAUmXDA: folds
j7NIOHLZk7V2o9fOioO5ug: calls $1
*** FLOP *** [5s 6h 6d]
j7NIOHLZk7V2o9fOioO5ug: bets $4
dHC9PH9hdH3Ad2TD8ZxX0Q: folds
j7NIOHLZk7V2o9fOioO5ug collected $4.30 from pot
j7NIOHLZk7V2o9fOioO5ug: doesn't show hand
*** SUMMARY ***
Total pot $4.50 | Rake $0.20
Board [5s 6h 6d]
Seat 1: Zboa6dColKGHBjLPUakZjw folded before Flop (didn't bet)
Seat 2: dHC9PH9hdH3Ad2TD8ZxX0Q (button) folded on the Flop
Seat 3: OigyyiK+tTj1APPIAUmXDA (small blind) folded before Flop
Seat 4: j7NIOHLZk7V2o9fOioO5ug (big blind) collected ($4.30)
Seat 5: wx3sQGkVi2x9wJXuWNHPBw folded before Flop (didn't bet)
Seat 6: XOIf9W+VAxhZqN+SYoyMKA folded before Flop (didn't bet)



PokerStars Game #59939185756:  Hold'em No Limit ($0.50/$1.00) - 2009/07/01 0:33:28 ET
Table 'MUPc8FEpe/nR0BKSeReX6Q' 6-max Seat #4 is the button
Seat 1: YsLQ3BAvgQHWXMAv3Wv6Hg ($100 in chips)
Seat 2: xAU6q2/cwmby2sxmA8VcmA ($109 in chips)
Seat 3: wx3sQGkVi2x9wJXuWNHPBw ($234.05 in chips)
Seat 4: ZA1bp6g8IwtTxkUE4eCjDQ ($119.10 in chips)
Seat 5: UBZQqpnJZdTYYY1FTb0rLA ($101.40 in chips)
Seat 6: oxnw0GLLpFanjhGkxfRSqA ($51.10 in chips)
UBZQqpnJZdTYYY1FTb0rLA: posts small blind $0.50
oxnw0GLLpFanjhGkxfRSqA: posts big blind $1
*** HOLE CARDS ***
YsLQ3BAvgQHWXMAv3Wv6Hg: folds
xAU6q2/cwmby2sxmA8VcmA: folds
wx3sQGkVi2x9wJXuWNHPBw: folds
ZA1bp6g8IwtTxkUE4eCjDQ: folds
UBZQqpnJZdTYYY1FTb0rLA: folds
oxnw0GLLpFanjhGkxfRSqA collected $1 from pot
*** SUMMARY ***
Total pot $1 | Rake $0
Seat 1: YsLQ3BAvgQHWXMAv3Wv6Hg folded before Flop (didn't bet)
Seat 2: xAU6q2/cwmby2sxmA8VcmA folded before Flop (didn't bet)
Seat 3: wx3sQGkVi2x9wJXuWNHPBw folded before Flop (didn't bet)
Seat 4: ZA1bp6g8IwtTxkUE4eCjDQ (button) folded before Flop (didn't bet)
Seat 5: UBZQqpnJZdTYYY1FTb0rLA (small blind) folded before Flop
Seat 6: oxnw0GLLpFanjhGkxfRSqA (big blind) collected ($1)



PokerStars Game #59939186052:  Hold'em No Limit ($0.50/$1.00) - 2009/07/01 0:33:28 ET
Table '8jIjWCPY0NGprquL+xcMFg' 9-max Seat #8 is the button
Seat 1: vR4IO10geOgvTW+LAUBv/A ($133.80 in chips)
Seat 2: rR1qGAf9Q9RYorKYWH3VKw ($10.20 in chips)
Seat 3: 58zdeSBSuSFX/qZfhc7YmA ($108.45 in chips)
Seat 4: by0z+YmujwI6Bf4qRFE8vA ($147.45 in chips)
Seat 5: n758Yw8Hx2S+6NQUPGqcqA ($87 in chips)
Seat 6: GTQkFJtSkbVbnGCktp6e3g ($100 in chips)
Seat 7: O3CGPwwUmamrCNHccOilrg ($47.50 in chips)
Seat 8: 9swGhtpERPngKPtvpoZkoQ ($150.30 in chips)
Seat 9: negfosHnGOZXSHpWDRKyBQ ($19 in chips)
negfosHnGOZXSHpWDRKyBQ: posts small blind $0.50
vR4IO10geOgvTW+LAUBv/A: posts big blind $1
*** HOLE CARDS ***
rR1qGAf9Q9RYorKYWH3VKw: calls $1
58zdeSBSuSFX/qZfhc7YmA: folds
by0z+YmujwI6Bf4qRFE8vA: folds
n758Yw8Hx2S+6NQUPGqcqA is disconnected
58zdeSBSuSFX/qZfhc7YmA leaves the table
tjhwe1V98x2spSoUQER3HQ joins the table at seat #3
n758Yw8Hx2S+6NQUPGqcqA has timed out while disconnected
n758Yw8Hx2S+6NQUPGqcqA: folds
n758Yw8Hx2S+6NQUPGqcqA is sitting out
GTQkFJtSkbVbnGCktp6e3g: folds
O3CGPwwUmamrCNHccOilrg: calls $1
9swGhtpERPngKPtvpoZkoQ: folds
negfosHnGOZXSHpWDRKyBQ: folds
vR4IO10geOgvTW+LAUBv/A: checks
*** FLOP *** [Qs 9d Tc]
vR4IO10geOgvTW+LAUBv/A: checks
rR1qGAf9Q9RYorKYWH3VKw: checks
O3CGPwwUmamrCNHccOilrg: bets $1
vR4IO10geOgvTW+LAUBv/A: folds
rR1qGAf9Q9RYorKYWH3VKw: calls $1
*** TURN *** [Qs 9d Tc] [4c]
rR1qGAf9Q9RYorKYWH3VKw: checks
O3CGPwwUmamrCNHccOilrg: checks
*** RIVER *** [Qs 9d Tc 4c] [Qc]
rR1qGAf9Q9RYorKYWH3VKw: checks
O3CGPwwUmamrCNHccOilrg: checks
*** SHOW DOWN ***
rR1qGAf9Q9RYorKYWH3VKw: shows [Ah 8s] (a pair of Queens)
O3CGPwwUmamrCNHccOilrg: shows [7s 7h] (two pair, Queens and Sevens)
O3CGPwwUmamrCNHccOilrg collected $5.25 from pot
*** SUMMARY ***
Total pot $5.50 | Rake $0.25
Board [Qs 9d Tc 4c Qc]
Seat 1: vR4IO10geOgvTW+LAUBv/A (big blind) folded on the Flop
Seat 2: rR1qGAf9Q9RYorKYWH3VKw showed [Ah 8s] and lost with a pair of Queens
Seat 3: 58zdeSBSuSFX/qZfhc7YmA folded before Flop (didn't bet)
Seat 4: by0z+YmujwI6Bf4qRFE8vA folded before Flop (didn't bet)
Seat 5: n758Yw8Hx2S+6NQUPGqcqA folded before Flop (didn't bet)
Seat 6: GTQkFJtSkbVbnGCktp6e3g folded before Flop (didn't bet)
Seat 7: O3CGPwwUmamrCNHccOilrg showed [7s 7h] and won ($5.25) with two pair, Queens and Sevens
Seat 8: 9swGhtpERPngKPtvpoZkoQ (button) folded before Flop (didn't bet)
Seat 9: negfosHnGOZXSHpWDRKyBQ (small blind) folded before Flop



PokerStars Game #59939186218:  Hold'em No Limit ($0.50/$1.00) - 2009/07/01 0:33:28 ET
Table '+cA8mcmhaedZ7YcrDdhmeQ' 6-max Seat #4 is the button
Seat 1: lsLuWlcPA3Rh7kJVLzMh0Q ($307.25 in chips)
Seat 2: RqgF7gRoKgRNW8Zoi1ty4A ($100 in chips)
Seat 3: 7H5WkGzGvsv56y1iaqHvRg ($40 in chips)
Seat 4: LjL3AIERHn559yyW1mTUYQ ($162 in chips)
Seat 6: YfsTQsY/fxb+YqbdclTHuw ($34.90 in chips)
YfsTQsY/fxb+YqbdclTHuw: posts small blind $0.50
lsLuWlcPA3Rh7kJVLzMh0Q: posts big blind $1
6WyjEXOToimYmtLdqIgHYQ said, "OMG"
7H5WkGzGvsv56y1iaqHvRg: posts big blind $1
*** HOLE CARDS ***
RqgF7gRoKgRNW8Zoi1ty4A: raises $4 to $5
7H5WkGzGvsv56y1iaqHvRg: folds
LjL3AIERHn559yyW1mTUYQ: folds
YfsTQsY/fxb+YqbdclTHuw: folds
lsLuWlcPA3Rh7kJVLzMh0Q: folds
RqgF7gRoKgRNW8Zoi1ty4A collected $3.50 from pot
*** SUMMARY ***
Total pot $3.50 | Rake $0
Seat 1: lsLuWlcPA3Rh7kJVLzMh0Q (big blind) folded before Flop
Seat 2: RqgF7gRoKgRNW8Zoi1ty4A collected ($3.50)
Seat 3: 7H5WkGzGvsv56y1iaqHvRg folded before Flop
Seat 4: LjL3AIERHn559yyW1mTUYQ (button) folded before Flop (didn't bet)
Seat 6: YfsTQsY/fxb+YqbdclTHuw (small blind) folded before Flop



PokerStars Game #59939186784:  Hold'em No Limit ($0.50/$1.00) - 2009/07/01 0:33:29 ET
Table 'fTlPiCj0utgzC/5io+I7ew' 6-max Seat #2 is the button
Seat 1: YMJG+F++3Aj6P8dAWda5fw ($98.50 in chips)
Seat 2: Qy/UBNbD2HaA0Ogxg8Sf3w ($100 in chips)
Seat 3: oDiBRCaF0QVtd3kO6xZIXw ($102 in chips)
Seat 4: uJVSceLggtsrJya+WtmUEA ($99.30 in chips)
Seat 5: bFrTkDcWGTxyvNul7GVdYg ($256.70 in chips)
Seat 6: jMljU/dOPMXfJi8OmbdYdw ($28.50 in chips)
oDiBRCaF0QVtd3kO6xZIXw: posts small blind $0.50
uJVSceLggtsrJya+WtmUEA: posts big blind $1
*** HOLE CARDS ***
bFrTkDcWGTxyvNul7GVdYg: folds
jMljU/dOPMXfJi8OmbdYdw: folds
YMJG+F++3Aj6P8dAWda5fw: folds
Qy/UBNbD2HaA0Ogxg8Sf3w: raises $1.50 to $2.50
oDiBRCaF0QVtd3kO6xZIXw: folds
uJVSceLggtsrJya+WtmUEA: folds
Qy/UBNbD2HaA0Ogxg8Sf3w collected $2.50 from pot
*** SUMMARY ***
Total pot $2.50 | Rake $0
Seat 1: YMJG+F++3Aj6P8dAWda5fw folded before Flop (didn't bet)
Seat 2: Qy/UBNbD2HaA0Ogxg8Sf3w (button) collected ($2.50)
Seat 3: oDiBRCaF0QVtd3kO6xZIXw (small blind) folded before Flop
Seat 4: uJVSceLggtsrJya+WtmUEA (big blind) folded before Flop
Seat 5: bFrTkDcWGTxyvNul7GVdYg folded before Flop (didn't bet)
Seat 6: jMljU/dOPMXfJi8OmbdYdw folded before Flop (didn't bet)



PokerStars Game #59939187286:  Hold'em No Limit ($0.50/$1.00) - 2009/07/01 0:33:30 ET
Table 'LmXQK9xy3awB+qsPzI21Mw' 2-max Seat #2 is the button
Seat 1: NYi6JFscYNrofSXy4sM+Yw ($206.85 in chips)
Seat 2: TME8GvochpQAo8cmJwWmvA ($36.45 in chips)
TME8GvochpQAo8cmJwWmvA: posts small blind $0.50
NYi6JFscYNrofSXy4sM+Yw: posts big blind $1
*** HOLE CARDS ***
TME8GvochpQAo8cmJwWmvA: raises $1 to $2
NYi6JFscYNrofSXy4sM+Yw: folds
TME8GvochpQAo8cmJwWmvA collected $2 from pot
TME8GvochpQAo8cmJwWmvA: doesn't show hand
*** SUMMARY ***
Total pot $2 | Rake $0
Seat 1: NYi6JFscYNrofSXy4sM+Yw (big blind) folded before Flop
Seat 2: TME8GvochpQAo8cmJwWmvA (button) (small blind) collected ($2)



PokerStars Game #59939188784:  Hold'em No Limit ($0.50/$1.00) - 2009/07/01 0:33:32 ET
Table 'rmZfTK+oSebeUPJNbWhdAA' 6-max Seat #5 is the button
Seat 1: xAU6q2/cwmby2sxmA8VcmA ($100 in chips)
Seat 2: OigyyiK+tTj1APPIAUmXDA ($124.55 in chips)
Seat 3: 9yjOzGERLaEZS8CZ6YNHFg ($115.40 in chips)
Seat 4: OGMLOcTNYZXZU81au7ztUw ($130.85 in chips)
Seat 5: +xW7QemQU0Fxs+4TnqBRow ($100 in chips)
Seat 6: j7NIOHLZk7V2o9fOioO5ug ($100 in chips)
j7NIOHLZk7V2o9fOioO5ug: posts small blind $0.50
xAU6q2/cwmby2sxmA8VcmA: posts big blind $1
*** HOLE CARDS ***
OigyyiK+tTj1APPIAUmXDA: raises $2 to $3
9yjOzGERLaEZS8CZ6YNHFg: folds
OGMLOcTNYZXZU81au7ztUw: folds
+xW7QemQU0Fxs+4TnqBRow: folds
j7NIOHLZk7V2o9fOioO5ug: folds
xAU6q2/cwmby2sxmA8VcmA: folds
OigyyiK+tTj1APPIAUmXDA collected $2.50 from pot
*** SUMMARY ***
Total pot $2.50 | Rake $0
Seat 1: xAU6q2/cwmby2sxmA8VcmA (big blind) folded before Flop
Seat 2: OigyyiK+tTj1APPIAUmXDA collected ($2.50)
Seat 3: 9yjOzGERLaEZS8CZ6YNHFg folded before Flop (didn't bet)
Seat 4: OGMLOcTNYZXZU81au7ztUw folded before Flop (didn't bet)
Seat 5: +xW7QemQU0Fxs+4TnqBRow (button) folded before Flop (didn't bet)
Seat 6: j7NIOHLZk7V2o9fOioO5ug (small blind) folded before Flop



PokerStars Game #59939189200:  Hold'em No Limit ($0.50/$1.00) - 2009/07/01 0:33:33 ET
Table 'U9zqzC8f3oTJ2ShXFgSSOA' 6-max Seat #3 is the button
Seat 1: tS9JHB1h+FQ++qu8RwRNgg ($34.50 in chips)
Seat 2: U2CWBTv29qdCbj8RNF2sIw ($99.50 in chips)
Seat 3: yfXek8iJ7O4CFyqXrtGcfg ($34.05 in chips)
Seat 4: 33q95we0Etwgrm6guQGncw ($72.65 in chips)
Seat 5: KfwW5us6tydK81NYTtK1gw ($307.05 in chips)
Seat 6: aIxzFKdtpDSkUePKZy/niQ ($53.50 in chips)
33q95we0Etwgrm6guQGncw: posts small blind $0.50
KfwW5us6tydK81NYTtK1gw: posts big blind $1
*** HOLE CARDS ***
aIxzFKdtpDSkUePKZy/niQ: folds
tS9JHB1h+FQ++qu8RwRNgg: folds
U2CWBTv29qdCbj8RNF2sIw: raises $2 to $3
yfXek8iJ7O4CFyqXrtGcfg: folds
33q95we0Etwgrm6guQGncw: folds
KfwW5us6tydK81NYTtK1gw: calls $2
*** FLOP *** [Qd Kh 9s]
KfwW5us6tydK81NYTtK1gw: checks
U2CWBTv29qdCbj8RNF2sIw: checks
*** TURN *** [Qd Kh 9s] [Qs]
KfwW5us6tydK81NYTtK1gw: checks
U2CWBTv29qdCbj8RNF2sIw: checks
*** RIVER *** [Qd Kh 9s Qs] [3d]
KfwW5us6tydK81NYTtK1gw: checks
U2CWBTv29qdCbj8RNF2sIw: checks
*** SHOW DOWN ***
KfwW5us6tydK81NYTtK1gw: shows [3h 3c] (a full house, Threes full of Queens)
U2CWBTv29qdCbj8RNF2sIw: mucks hand
KfwW5us6tydK81NYTtK1gw collected $6.20 from pot
*** SUMMARY ***
Total pot $6.50 | Rake $0.30
Board [Qd Kh 9s Qs 3d]
Seat 1: tS9JHB1h+FQ++qu8RwRNgg folded before Flop (didn't bet)
Seat 2: U2CWBTv29qdCbj8RNF2sIw mucked
Seat 3: yfXek8iJ7O4CFyqXrtGcfg (button) folded before Flop (didn't bet)
Seat 4: 33q95we0Etwgrm6guQGncw (small blind) folded before Flop
Seat 5: KfwW5us6tydK81NYTtK1gw (big blind) showed [3h 3c] and won ($6.20) with a full house, Threes full of Queens
Seat 6: aIxzFKdtpDSkUePKZy/niQ folded before Flop (didn't bet)



PokerStars Game #59939190192:  Hold'em No Limit ($0.50/$1.00) - 2009/07/01 0:33:34 ET
Table 'tyUh+jyNvrceIQdKMJjQ2wZFWj23PMihdwrNWv41OG/Qeat #3 is the button
Seat 3: TalCiLYHCd+ffkmR3auPvA ($58 in chips)
Seat 4: TSuRyAHnUPCFjP7Z0rEE0w ($120.75 in chips)
Seat 5: j7NIOHLZk7V2o9fOioO5ug ($119.10 in chips)
Seat 6: YsLQ3BAvgQHWXMAv3Wv6Hg ($137.10 in chips)
TSuRyAHnUPCFjP7Z0rEE0w: posts small blind $0.50
j7NIOHLZk7V2o9fOioO5ug: posts big blind $1
m1sJRkJZ1wu5i1BdgeO2Jw: sits out
*** HOLE CARDS ***
YsLQ3BAvgQHWXMAv3Wv6Hg: folds
TalCiLYHCd+ffkmR3auPvA: folds
TSuRyAHnUPCFjP7Z0rEE0w: folds
j7NIOHLZk7V2o9fOioO5ug collected $1 from pot
j7NIOHLZk7V2o9fOioO5ug: doesn't show hand
*** SUMMARY ***
Total pot $1 | Rake $0
Seat 3: TalCiLYHCd+ffkmR3auPvA (button) folded before Flop (didn't bet)
Seat 4: TSuRyAHnUPCFjP7Z0rEE0w (small blind) folded before Flop
Seat 5: j7NIOHLZk7V2o9fOioO5ug (big blind) collected ($1)
Seat 6: YsLQ3BAvgQHWXMAv3Wv6Hg folded before Flop (didn't bet)



PokerStars Game #59939190390:  Hold'em No Limit ($0.50/$1.00) - 2009/07/01 0:33:35 ET
Table 'kS0cTQAEi+fdUlJP2gQYvw' 9-max Seat #3 is the button
Seat 1: c/9X4zftzphFxYtxp5kp9w ($39.40 in chips)
Seat 3: 3obndzTJ6fECz8+wWhMd1w ($19 in chips)
Seat 4: TZcz9MEWDA+WydgGruqqbw ($100.50 in chips)
Seat 5: 2rxrMrE7koO2BNxvop/0+g ($51.55 in chips)
Seat 6: yAbu2QsRPVcjPbqlf/jDxw ($100 in chips)
Seat 7: Ffa7Nj4X5fddtROP01hfQg ($111.20 in chips)
Seat 8: qTymj6ZQ8ZoFi6fINJZb3w ($80.50 in chips)
Seat 9: y8Qb94e81yI/g0saQ6gU5g ($55.25 in chips)
TZcz9MEWDA+WydgGruqqbw: posts small blind $0.50
2rxrMrE7koO2BNxvop/0+g: posts big blind $1
*** HOLE CARDS ***
yAbu2QsRPVcjPbqlf/jDxw: folds
Ffa7Nj4X5fddtROP01hfQg: folds
qTymj6ZQ8ZoFi6fINJZb3w: folds
y8Qb94e81yI/g0saQ6gU5g: folds
c/9X4zftzphFxYtxp5kp9w: folds
3obndzTJ6fECz8+wWhMd1w: folds
TZcz9MEWDA+WydgGruqqbw: folds
2rxrMrE7koO2BNxvop/0+g collected $1 from pot
*** SUMMARY ***
Total pot $1 | Rake $0
Seat 1: c/9X4zftzphFxYtxp5kp9w folded before Flop (didn't bet)
Seat 3: 3obndzTJ6fECz8+wWhMd1w (button) folded before Flop (didn't bet)
Seat 4: TZcz9MEWDA+WydgGruqqbw (small blind) folded before Flop
Seat 5: 2rxrMrE7koO2BNxvop/0+g (big blind) collected ($1)
Seat 6: yAbu2QsRPVcjPbqlf/jDxw folded before Flop (didn't bet)
Seat 7: Ffa7Nj4X5fddtROP01hfQg folded before Flop (didn't bet)
Seat 8: qTymj6ZQ8ZoFi6fINJZb3w folded before Flop (didn't bet)
Seat 9: y8Qb94e81yI/g0saQ6gU5g folded before Flop (didn't bet)



PokerStars Game #59939191464:  Hold'em No Limit ($0.50/$1.00) - 2009/07/01 0:33:36 ET
Table 'eU3bWpDDg3Z+9R4m4iVmog' 6-max Seat #1 is the button
Seat 1: TSuRyAHnUPCFjP7Z0rEE0w ($165.60 in chips)
Seat 2: 8CAoOzhmB8n3nRFf3V4BTg ($125.45 in chips)
Seat 3: U6tnjwZRpTnM+YkqkCjwyQ ($174.15 in chips)
Seat 4: GDVIsbEJ/DOJsMKE4Asz0A ($102.10 in chips)
Seat 6: hpxXcmRkXXI9HE5+5/j/0Q ($103.50 in chips)
8CAoOzhmB8n3nRFf3V4BTg: posts small blind $0.50
U6tnjwZRpTnM+YkqkCjwyQ: posts big blind $1
AdLVjddOzm+sRNo1Bc3S6Q: sits out
*** HOLE CARDS ***
GDVIsbEJ/DOJsMKE4Asz0A: folds
hpxXcmRkXXI9HE5+5/j/0Q: folds
TSuRyAHnUPCFjP7Z0rEE0w: raises $3 to $4
8CAoOzhmB8n3nRFf3V4BTg: folds
U6tnjwZRpTnM+YkqkCjwyQ: calls $3
*** FLOP *** [6c 4h 2c]
U6tnjwZRpTnM+YkqkCjwyQ: checks
TSuRyAHnUPCFjP7Z0rEE0w: bets $6
U6tnjwZRpTnM+YkqkCjwyQ: folds
TSuRyAHnUPCFjP7Z0rEE0w collected $8.10 from pot
TSuRyAHnUPCFjP7Z0rEE0w: doesn't show hand
*** SUMMARY ***
Total pot $8.50 | Rake $0.40
Board [6c 4h 2c]
Seat 1: TSuRyAHnUPCFjP7Z0rEE0w (button) collected ($8.10)
Seat 2: 8CAoOzhmB8n3nRFf3V4BTg (small blind) folded before Flop
Seat 3: U6tnjwZRpTnM+YkqkCjwyQ (big blind) folded on the Flop
Seat 4: GDVIsbEJ/DOJsMKE4Asz0A folded before Flop (didn't bet)
Seat 6: hpxXcmRkXXI9HE5+5/j/0Q folded before Flop (didn't bet)



PokerStars Game #59939191458:  Hold'em No Limit ($0.50/$1.00) - 2009/07/01 0:33:36 ET
Table 'LmXQK9xy3awB+qsPzI21Mw' 2-max Seat #1 is the button
Seat 1: NYi6JFscYNrofSXy4sM+Yw ($205.85 in chips)
Seat 2: TME8GvochpQAo8cmJwWmvA ($37.45 in chips)
NYi6JFscYNrofSXy4sM+Yw: posts small blind $0.50
TME8GvochpQAo8cmJwWmvA: posts big blind $1
*** HOLE CARDS ***
NYi6JFscYNrofSXy4sM+Yw: raises $2 to $3
TME8GvochpQAo8cmJwWmvA: folds
NYi6JFscYNrofSXy4sM+Yw collected $2 from pot
*** SUMMARY ***
Total pot $2 | Rake $0
Seat 1: NYi6JFscYNrofSXy4sM+Yw (button) (small blind) collected ($2)
Seat 2: TME8GvochpQAo8cmJwWmvA (big blind) folded before Flop



PokerStars Game #59939192110:  Hold'em No Limit ($0.50/$1.00) - 2009/07/01 0:33:37 ET
Table 'CxlB0XELs5P0zDlOhlhAPw' 2-max Seat #2 is the button
Seat 1: mJHc7tEZG3SVIX7QQjb5EQ ($20 in chips)
Seat 2: I4xAjioR1QwQ5TgX4Z1/qw ($50 in chips)
I4xAjioR1QwQ5TgX4Z1/qw: posts small blind $0.50
mJHc7tEZG3SVIX7QQjb5EQ: posts big blind $1
*** HOLE CARDS ***
I4xAjioR1QwQ5TgX4Z1/qw: raises $2 to $3
mJHc7tEZG3SVIX7QQjb5EQ: calls $2
*** FLOP *** [Th 4h 7c]
mJHc7tEZG3SVIX7QQjb5EQ: checks
I4xAjioR1QwQ5TgX4Z1/qw: bets $4
mJHc7tEZG3SVIX7QQjb5EQ: folds
I4xAjioR1QwQ5TgX4Z1/qw collected $5.70 from pot
*** SUMMARY ***
Total pot $6 | Rake $0.30
Board [Th 4h 7c]
Seat 1: mJHc7tEZG3SVIX7QQjb5EQ (big blind) folded on the Flop
Seat 2: I4xAjioR1QwQ5TgX4Z1/qw (button) (small blind) collected ($5.70)



PokerStars Game #59939191790:  Hold'em No Limit ($0.50/$1.00) - 2009/07/01 0:33:37 ET
Table '/FUb199IViHMJHi5YWmeuQ' 9-max Seat #1 is the button
Seat 1: TZcz9MEWDA+WydgGruqqbw ($101.85 in chips)
Seat 2: FL3MrLspcF23LYvC4ipBOA ($136.25 in chips)
Seat 3: qN483QJ1NvHbdIZB7J4ARw ($62.75 in chips)
Seat 6: ccFf7Q4z1cTGQmeoYiWEfw ($51.95 in chips)
Seat 7: bLbSOSmSOnqE0iTcH/5dxA ($100 in chips)
Seat 8: QIWvt0R766g8KfH0vl1s0A ($32.90 in chips)
Seat 9: knewtTmBc4Tc0z/5tAABYQ ($155.15 in chips)
FL3MrLspcF23LYvC4ipBOA: posts small blind $0.50
qN483QJ1NvHbdIZB7J4ARw: posts big blind $1
qheQay5YvP2DMAb3OUSxtw: sits out
BbWpm6CYaA1D8P5EYEEwkQ: sits out
*** HOLE CARDS ***
ccFf7Q4z1cTGQmeoYiWEfw: folds
bLbSOSmSOnqE0iTcH/5dxA: folds
QIWvt0R766g8KfH0vl1s0A: folds
knewtTmBc4Tc0z/5tAABYQ: folds
TZcz9MEWDA+WydgGruqqbw: folds
FL3MrLspcF23LYvC4ipBOA: calls $0.50
qN483QJ1NvHbdIZB7J4ARw: checks
*** FLOP *** [2h 2s Ah]
FL3MrLspcF23LYvC4ipBOA: checks
qN483QJ1NvHbdIZB7J4ARw: checks
*** TURN *** [2h 2s Ah] [Kd]
FL3MrLspcF23LYvC4ipBOA: checks
qN483QJ1NvHbdIZB7J4ARw: checks
*** RIVER *** [2h 2s Ah Kd] [Ks]
FL3MrLspcF23LYvC4ipBOA: checks
qN483QJ1NvHbdIZB7J4ARw: checks
*** SHOW DOWN ***
FL3MrLspcF23LYvC4ipBOA: shows [Jd 9c] (two pair, Kings and Deuces)
qN483QJ1NvHbdIZB7J4ARw: shows [8h 4d] (two pair, Kings and Deuces)
FL3MrLspcF23LYvC4ipBOA collected $0.95 from pot
qN483QJ1NvHbdIZB7J4ARw collected $0.95 from pot
*** SUMMARY ***
Total pot $2 | Rake $0.10
Board [2h 2s Ah Kd Ks]
Seat 1: TZcz9MEWDA+WydgGruqqbw (button) folded before Flop (didn't bet)
Seat 2: FL3MrLspcF23LYvC4ipBOA (small blind) showed [Jd 9c] and won ($0.95) with two pair, Kings and Deuces
Seat 3: qN483QJ1NvHbdIZB7J4ARw (big blind) showed [8h 4d] and won ($0.95) with two pair, Kings and Deuces
Seat 6: ccFf7Q4z1cTGQmeoYiWEfw folded before Flop (didn't bet)
Seat 7: bLbSOSmSOnqE0iTcH/5dxA folded before Flop (didn't bet)
Seat 8: QIWvt0R766g8KfH0vl1s0A folded before Flop (didn't bet)
Seat 9: knewtTmBc4Tc0z/5tAABYQ folded before Flop (didn't bet)



PokerStars Game #59939192376:  Hold'em No Limit ($0.50/$1.00) - 2009/07/01 0:33:38 ET
Table 'cBDNutyLBKEk9+ptwsKmTw' 6-max Seat #2 is the button
Seat 1: xAU6q2/cwmby2sxmA8VcmA ($100 in chips)
Seat 2: Gy1fd4JyD1aNBFFlOGzbJQ ($26.20 in chips)
Seat 3: G5ZSSN6RSON3gkNvk/SmYg ($110.90 in chips)
Seat 5: OGMLOcTNYZXZU81au7ztUw ($138.25 in chips)
Seat 6: NqVlOSH2lp+pp/TK3vvK5g ($43.30 in chips)
G5ZSSN6RSON3gkNvk/SmYg: posts small blind $0.50
0WjiuIT7/EolY1oOx1ngeA: is sitting out
OGMLOcTNYZXZU81au7ztUw: posts big blind $1
*** HOLE CARDS ***
0WjiuIT7/EolY1oOx1ngeA leaves the table
NqVlOSH2lp+pp/TK3vvK5g: calls $1
xAU6q2/cwmby2sxmA8VcmA: folds
Gy1fd4JyD1aNBFFlOGzbJQ: folds
G5ZSSN6RSON3gkNvk/SmYg: folds
OGMLOcTNYZXZU81au7ztUw: checks
*** FLOP *** [Qh 5s 4h]
OGMLOcTNYZXZU81au7ztUw: checks
NqVlOSH2lp+pp/TK3vvK5g: bets $1
OGMLOcTNYZXZU81au7ztUw: calls $1
*** TURN *** [Qh 5s 4h] [Qs]
OGMLOcTNYZXZU81au7ztUw: checks
NqVlOSH2lp+pp/TK3vvK5g: bets $1
OGMLOcTNYZXZU81au7ztUw: calls $1
*** RIVER *** [Qh 5s 4h Qs] [9d]
OGMLOcTNYZXZU81au7ztUw: bets $2
NqVlOSH2lp+pp/TK3vvK5g: folds
OGMLOcTNYZXZU81au7ztUw collected $6.20 from pot
OGMLOcTNYZXZU81au7ztUw: doesn't show hand
*** SUMMARY ***
Total pot $6.50 | Rake $0.30
Board [Qh 5s 4h Qs 9d]
Seat 1: xAU6q2/cwmby2sxmA8VcmA folded before Flop (didn't bet)
Seat 2: Gy1fd4JyD1aNBFFlOGzbJQ (button) folded before Flop (didn't bet)
Seat 3: G5ZSSN6RSON3gkNvk/SmYg (small blind) folded before Flop
Seat 5: OGMLOcTNYZXZU81au7ztUw (big blind) collected ($6.20)
Seat 6: NqVlOSH2lp+pp/TK3vvK5g folded on the River



PokerStars Game #59939193846:  Hold'em No Limit ($0.50/$1.00) - 2009/07/01 0:33:40 ET
Table 'Zka9tv1yilg0MvXWPQrShg' 9-max Seat #2 is the button
Seat 1: TZcz9MEWDA+WydgGruqqbw ($115.35 in chips)
Seat 2: rR1qGAf9Q9RYorKYWH3VKw ($24.20 in chips)
Seat 3: gUUvmqdVlmvpal6B8nYrmg ($101.50 in chips)
Seat 4: CTOae+JLIGfwfXvhqHkP2w ($163.65 in chips)
Seat 5: /zy+DB4S5fUQUSfZWFzYGw ($141.50 in chips)
Seat 6: rY8wPoax1lS+HUY+I0FZDw ($137.65 in chips)
Seat 7: p1SafS90nb3Uft5LB0NkHw ($17 in chips)
Seat 8: bL+QVeDcuEdzMGAGg2XJHg ($119.10 in chips)
Seat 9: 6daxhj43mWj04MOPTOmaYA ($96 in chips)
gUUvmqdVlmvpal6B8nYrmg: posts small blind $0.50
CTOae+JLIGfwfXvhqHkP2w: posts big blind $1
*** HOLE CARDS ***
/zy+DB4S5fUQUSfZWFzYGw: folds
rY8wPoax1lS+HUY+I0FZDw: folds
p1SafS90nb3Uft5LB0NkHw: folds
bL+QVeDcuEdzMGAGg2XJHg: folds
6daxhj43mWj04MOPTOmaYA: folds
TZcz9MEWDA+WydgGruqqbw: folds
rR1qGAf9Q9RYorKYWH3VKw: raises $23.20 to $24.20 and is all-in
gUUvmqdVlmvpal6B8nYrmg: folds
CTOae+JLIGfwfXvhqHkP2w: folds
rR1qGAf9Q9RYorKYWH3VKw collected $2.50 from pot
*** SUMMARY ***
Total pot $2.50 | Rake $0
Seat 1: TZcz9MEWDA+WydgGruqqbw folded before Flop (didn't bet)
Seat 2: rR1qGAf9Q9RYorKYWH3VKw (button) collected ($2.50)
Seat 3: gUUvmqdVlmvpal6B8nYrmg (small blind) folded before Flop
Seat 4: CTOae+JLIGfwfXvhqHkP2w (big blind) folded before Flop
Seat 5: /zy+DB4S5fUQUSfZWFzYGw folded before Flop (didn't bet)
Seat 6: rY8wPoax1lS+HUY+I0FZDw folded before Flop (didn't bet)
Seat 7: p1SafS90nb3Uft5LB0NkHw folded before Flop (didn't bet)
Seat 8: bL+QVeDcuEdzMGAGg2XJHg folded before Flop (didn't bet)
Seat 9: 6daxhj43mWj04MOPTOmaYA folded before Flop (didn't bet)



PokerStars Game #59939194388:  Hold'em No Limit ($0.50/$1.00) - 2009/07/01 0:33:41 ET
Table '21a4iYFKcuezM4nYx8DWTA' 2-max Seat #2 is the button
Seat 1: NYi6JFscYNrofSXy4sM+Yw ($177 in chips)
Seat 2: +sy/nlNI20yZraIjs4AALg ($21.95 in chips)
+sy/nlNI20yZraIjs4AALg: posts small blind $0.50
NYi6JFscYNrofSXy4sM+Yw: posts big blind $1
*** HOLE CARDS ***
+sy/nlNI20yZraIjs4AALg: folds
NYi6JFscYNrofSXy4sM+Yw collected $1 from pot
*** SUMMARY ***
Total pot $1 | Rake $0
Seat 1: NYi6JFscYNrofSXy4sM+Yw (big blind) collected ($1)
Seat 2: +sy/nlNI20yZraIjs4AALg (button) (small blind) folded before Flop



PokerStars Game #59939194994:  Hold'em No Limit ($0.50/$1.00) - 2009/07/01 0:33:42 ET
Table 'VOs36P6NW+QyXeQ1B62kmA' 6-max Seat #5 is the button
Seat 1: AdLVjddOzm+sRNo1Bc3S6Q ($139.65 in chips)
Seat 2: KpnW5CcJ4Mg6MeclfKmLrw ($113.30 in chips)
Seat 3: TSuRyAHnUPCFjP7Z0rEE0w ($100 in chips)
Seat 4: w02zQzNydODiyV9THKgo9w ($38.65 in chips)
Seat 5: X7GlkHF+lkbarCLuZ4Uf0w ($21.50 in chips)
Seat 6: 6tvjsJrdmWg+g7FVrMnzXA ($66.60 in chips)
6tvjsJrdmWg+g7FVrMnzXA: posts small blind $0.50
AdLVjddOzm+sRNo1Bc3S6Q: posts big blind $1
*** HOLE CARDS ***
KpnW5CcJ4Mg6MeclfKmLrw: folds
TSuRyAHnUPCFjP7Z0rEE0w: folds
w02zQzNydODiyV9THKgo9w: folds
X7GlkHF+lkbarCLuZ4Uf0w: raises $1 to $2
6tvjsJrdmWg+g7FVrMnzXA: calls $1.50
AdLVjddOzm+sRNo1Bc3S6Q: folds
*** FLOP *** [4s Ks Jh]
6tvjsJrdmWg+g7FVrMnzXA: checks
X7GlkHF+lkbarCLuZ4Uf0w: bets $4.50
6tvjsJrdmWg+g7FVrMnzXA: folds
X7GlkHF+lkbarCLuZ4Uf0w collected $4.75 from pot
X7GlkHF+lkbarCLuZ4Uf0w: doesn't show hand
*** SUMMARY ***
Total pot $5 | Rake $0.25
Board [4s Ks Jh]
Seat 1: AdLVjddOzm+sRNo1Bc3S6Q (big blind) folded before Flop
Seat 2: KpnW5CcJ4Mg6MeclfKmLrw folded before Flop (didn't bet)
Seat 3: TSuRyAHnUPCFjP7Z0rEE0w folded before Flop (didn't bet)
Seat 4: w02zQzNydODiyV9THKgo9w folded before Flop (didn't bet)
Seat 5: X7GlkHF+lkbarCLuZ4Uf0w (button) collected ($4.75)
Seat 6: 6tvjsJrdmWg+g7FVrMnzXA (small blind) folded on the Flop



PokerStars Game #59939195158:  Hold'em No Limit ($0.50/$1.00) - 2009/07/01 0:33:42 ET
Table 'pHrhryH8jPNdQfY62f8v+g' 6-max Seat #1 is the button
Seat 1: BdbmJTZZ47quA9vUWwXtlw ($106.80 in chips)
Seat 2: RqgF7gRoKgRNW8Zoi1ty4A ($115.50 in chips)
Seat 4: wenbG7TaM3H7h5kn78OFNw ($58.30 in chips)
Seat 5: r1/R7y0Ortgoz4lccgW8VA ($23.15 in chips)
Seat 6: xAU6q2/cwmby2sxmA8VcmA ($102.80 in chips)
RqgF7gRoKgRNW8Zoi1ty4A: posts small blind $0.50
wenbG7TaM3H7h5kn78OFNw: posts big blind $1
*** HOLE CARDS ***
r1/R7y0Ortgoz4lccgW8VA: folds
xAU6q2/cwmby2sxmA8VcmA: folds
BdbmJTZZ47quA9vUWwXtlw: folds
RqgF7gRoKgRNW8Zoi1ty4A: folds
wenbG7TaM3H7h5kn78OFNw collected $1 from pot
*** SUMMARY ***
Total pot $1 | Rake $0
Seat 1: BdbmJTZZ47quA9vUWwXtlw (button) folded before Flop (didn't bet)
Seat 2: RqgF7gRoKgRNW8Zoi1ty4A (small blind) folded before Flop
Seat 4: wenbG7TaM3H7h5kn78OFNw (big blind) collected ($1)
Seat 5: r1/R7y0Ortgoz4lccgW8VA folded before Flop (didn't bet)
Seat 6: xAU6q2/cwmby2sxmA8VcmA folded before Flop (didn't bet)



PokerStars Game #59939195830:  Hold'em No Limit ($0.50/$1.00) - 2009/07/01 0:33:43 ET
Table 'LmXQK9xy3awB+qsPzI21Mw' 2-max Seat #2 is the button
Seat 1: NYi6JFscYNrofSXy4sM+Yw ($206.85 in chips)
Seat 2: TME8GvochpQAo8cmJwWmvA ($36.45 in chips)
TME8GvochpQAo8cmJwWmvA: posts small blind $0.50
NYi6JFscYNrofSXy4sM+Yw: posts big blind $1
*** HOLE CARDS ***
TME8GvochpQAo8cmJwWmvA: raises $1 to $2
NYi6JFscYNrofSXy4sM+Yw: folds
TME8GvochpQAo8cmJwWmvA collected $2 from pot
TME8GvochpQAo8cmJwWmvA: doesn't show hand
*** SUMMARY ***
Total pot $2 | Rake $0
Seat 1: NYi6JFscYNrofSXy4sM+Yw (big blind) folded before Flop
Seat 2: TME8GvochpQAo8cmJwWmvA (button) (small blind) collected ($2)



PokerStars Game #59939197078:  Hold'em No Limit ($0.50/$1.00) - 2009/07/01 0:33:45 ET
Table 'tyUh+jyNvrceIQdKMJjQ2wZFWj23PMihdwrNWv41OG/Qeat #4 is the button
Seat 3: TalCiLYHCd+ffkmR3auPvA ($58 in chips)
Seat 4: TSuRyAHnUPCFjP7Z0rEE0w ($120.25 in chips)
Seat 5: j7NIOHLZk7V2o9fOioO5ug ($119.60 in chips)
Seat 6: YsLQ3BAvgQHWXMAv3Wv6Hg ($137.10 in chips)
j7NIOHLZk7V2o9fOioO5ug: posts small blind $0.50
YsLQ3BAvgQHWXMAv3Wv6Hg: posts big blind $1
m1sJRkJZ1wu5i1BdgeO2Jw: sits out
*** HOLE CARDS ***
TalCiLYHCd+ffkmR3auPvA: folds
TSuRyAHnUPCFjP7Z0rEE0w: folds
j7NIOHLZk7V2o9fOioO5ug: folds
YsLQ3BAvgQHWXMAv3Wv6Hg collected $1 from pot
YsLQ3BAvgQHWXMAv3Wv6Hg: doesn't show hand
*** SUMMARY ***
Total pot $1 | Rake $0
Seat 3: TalCiLYHCd+ffkmR3auPvA folded before Flop (didn't bet)
Seat 4: TSuRyAHnUPCFjP7Z0rEE0w (button) folded before Flop (didn't bet)
Seat 5: j7NIOHLZk7V2o9fOioO5ug (small blind) folded before Flop
Seat 6: YsLQ3BAvgQHWXMAv3Wv6Hg (big blind) collected ($1)



PokerStars Game #59939198464:  Hold'em No Limit ($0.50/$1.00) - 2009/07/01 0:33:47 ET
Table 'ZFWj23PMihdwrNWv41OG/Q' 9-max Seat #2 is the button
Seat 1: yAbu2QsRPVcjPbqlf/jDxw ($100 in chips)
Seat 2: ARfmgHcEUKh68laBZy4veA ($77.60 in chips)
Seat 3: G9Fo2TZCN7HI43Po4zSN3A ($102.50 in chips)
Seat 4: PEmogYqKpuv0ozeBbXL+7Q ($40 in chips)
Seat 5: tkdBeXTJlFsZdioidNqLow ($60 in chips)
Seat 6: tjhwe1V98x2spSoUQER3HQ ($104.50 in chips)
Seat 7: wIZ377kjl2fHFGnS93o6bw ($22.45 in chips)
Seat 8: knewtTmBc4Tc0z/5tAABYQ ($116.90 in chips)
Seat 9: gIabaXO0Nq08nuXlf56f0w ($19.90 in chips)
G9Fo2TZCN7HI43Po4zSN3A: posts small blind $0.50
PEmogYqKpuv0ozeBbXL+7Q: posts big blind $1
*** HOLE CARDS ***
tkdBeXTJlFsZdioidNqLow: folds
tjhwe1V98x2spSoUQER3HQ: folds
wIZ377kjl2fHFGnS93o6bw: folds
knewtTmBc4Tc0z/5tAABYQ: folds
gIabaXO0Nq08nuXlf56f0w: folds
yAbu2QsRPVcjPbqlf/jDxw: raises $2 to $3
ARfmgHcEUKh68laBZy4veA: folds
G9Fo2TZCN7HI43Po4zSN3A: folds
PEmogYqKpuv0ozeBbXL+7Q: calls $2
*** FLOP *** [7c 2s Ac]
PEmogYqKpuv0ozeBbXL+7Q: bets $4
yAbu2QsRPVcjPbqlf/jDxw: calls $4
*** TURN *** [7c 2s Ac] [4h]
PEmogYqKpuv0ozeBbXL+7Q: bets $10
yAbu2QsRPVcjPbqlf/jDxw: calls $10
*** RIVER *** [7c 2s Ac 4h] [5h]
PEmogYqKpuv0ozeBbXL+7Q: bets $10
yAbu2QsRPVcjPbqlf/jDxw: calls $10
*** SHOW DOWN ***
PEmogYqKpuv0ozeBbXL+7Q: shows [As 8c] (a pair of Aces)
yAbu2QsRPVcjPbqlf/jDxw: shows [Ah Th] (a pair of Aces - Ten kicker)
yAbu2QsRPVcjPbqlf/jDxw collected $51.90 from pot
*** SUMMARY ***
Total pot $54.50 | Rake $2.60
Board [7c 2s Ac 4h 5h]
Seat 1: yAbu2QsRPVcjPbqlf/jDxw showed [Ah Th] and won ($51.90) with a pair of Aces
Seat 2: ARfmgHcEUKh68laBZy4veA (button) folded before Flop (didn't bet)
Seat 3: G9Fo2TZCN7HI43Po4zSN3A (small blind) folded before Flop
Seat 4: PEmogYqKpuv0ozeBbXL+7Q (big blind) showed [As 8c] and lost with a pair of Aces
Seat 5: tkdBeXTJlFsZdioidNqLow folded before Flop (didn't bet)
Seat 6: tjhwe1V98x2spSoUQER3HQ folded before Flop (didn't bet)
Seat 7: wIZ377kjl2fHFGnS93o6bw folded before Flop (didn't bet)
Seat 8: knewtTmBc4Tc0z/5tAABYQ folded before Flop (didn't bet)
Seat 9: gIabaXO0Nq08nuXlf56f0w folded before Flop (didn't bet)



PokerStars Game #59939198928:  Hold'em No Limit ($0.50/$1.00) - 2009/07/01 0:33:48 ET
Table '7Nl0ffnjeK44/vmeexh3MQ' 9-max Seat #4 is the button
Seat 1: s7D3Y+k4Cj4D1cXHv7oj+Q ($97.45 in chips)
Seat 2: kiakSwxX0e64PwYGAPQvLw ($33.85 in chips)
Seat 3: vR4IO10geOgvTW+LAUBv/A ($100 in chips)
Seat 4: bLbSOSmSOnqE0iTcH/5dxA ($100 in chips)
Seat 5: bL+QVeDcuEdzMGAGg2XJHg ($107.40 in chips)
Seat 6: FVs16t7GgfWgQWt4JxsObQ ($15.60 in chips)
Seat 7: knewtTmBc4Tc0z/5tAABYQ ($105 in chips)
Seat 8: zanka7aAZkigmZpfopXxxA ($228.20 in chips)
Seat 9: ouwUBGRKnKK9uhn1G4Lf+A ($99.50 in chips)
bL+QVeDcuEdzMGAGg2XJHg: posts small blind $0.50
FVs16t7GgfWgQWt4JxsObQ: posts big blind $1
*** HOLE CARDS ***
knewtTmBc4Tc0z/5tAABYQ: folds
zanka7aAZkigmZpfopXxxA: folds
ouwUBGRKnKK9uhn1G4Lf+A: folds
s7D3Y+k4Cj4D1cXHv7oj+Q: folds
kiakSwxX0e64PwYGAPQvLw: folds
vR4IO10geOgvTW+LAUBv/A: folds
bLbSOSmSOnqE0iTcH/5dxA: folds
bL+QVeDcuEdzMGAGg2XJHg: raises $2 to $3
FVs16t7GgfWgQWt4JxsObQ: calls $2
*** FLOP *** [8d 5s 4c]
bL+QVeDcuEdzMGAGg2XJHg: bets $4
FVs16t7GgfWgQWt4JxsObQ: calls $4
*** TURN *** [8d 5s 4c] [7d]
bL+QVeDcuEdzMGAGg2XJHg: checks
FVs16t7GgfWgQWt4JxsObQ: checks
*** RIVER *** [8d 5s 4c 7d] [9h]
bL+QVeDcuEdzMGAGg2XJHg: checks
FVs16t7GgfWgQWt4JxsObQ: checks
*** SHOW DOWN ***
bL+QVeDcuEdzMGAGg2XJHg: shows [Qc Td] (high card Queen)
FVs16t7GgfWgQWt4JxsObQ: shows [Ks Qs] (high card King)
FVs16t7GgfWgQWt4JxsObQ collected $13.35 from pot
*** SUMMARY ***
Total pot $14 | Rake $0.65
Board [8d 5s 4c 7d 9h]
Seat 1: s7D3Y+k4Cj4D1cXHv7oj+Q folded before Flop (didn't bet)
Seat 2: kiakSwxX0e64PwYGAPQvLw folded before Flop (didn't bet)
Seat 3: vR4IO10geOgvTW+LAUBv/A folded before Flop (didn't bet)
Seat 4: bLbSOSmSOnqE0iTcH/5dxA (button) folded before Flop (didn't bet)
Seat 5: bL+QVeDcuEdzMGAGg2XJHg (small blind) showed [Qc Td] and lost with high card Queen
Seat 6: FVs16t7GgfWgQWt4JxsObQ (big blind) showed [Ks Qs] and won ($13.35) with high card King
Seat 7: knewtTmBc4Tc0z/5tAABYQ folded before Flop (didn't bet)
Seat 8: zanka7aAZkigmZpfopXxxA folded before Flop (didn't bet)
Seat 9: ouwUBGRKnKK9uhn1G4Lf+A folded before Flop (didn't bet)



PokerStars Game #59939200038:  Hold'em No Limit ($0.50/$1.00) - 2009/07/01 0:33:49 ET
Table 'LmXQK9xy3awB+qsPzI21Mw' 2-max Seat #1 is the button
Seat 1: NYi6JFscYNrofSXy4sM+Yw ($205.85 in chips)
Seat 2: TME8GvochpQAo8cmJwWmvA ($37.45 in chips)
NYi6JFscYNrofSXy4sM+Yw: posts small blind $0.50
TME8GvochpQAo8cmJwWmvA: posts big blind $1
*** HOLE CARDS ***
NYi6JFscYNrofSXy4sM+Yw: raises $2 to $3
TME8GvochpQAo8cmJwWmvA: calls $2
*** FLOP *** [6h Js As]
TME8GvochpQAo8cmJwWmvA: checks
NYi6JFscYNrofSXy4sM+Yw: checks
*** TURN *** [6h Js As] [7c]
TME8GvochpQAo8cmJwWmvA: checks
NYi6JFscYNrofSXy4sM+Yw: checks
*** RIVER *** [6h Js As 7c] [Ah]
TME8GvochpQAo8cmJwWmvA: bets $1
NYi6JFscYNrofSXy4sM+Yw: raises $4 to $5
TME8GvochpQAo8cmJwWmvA: folds
NYi6JFscYNrofSXy4sM+Yw collected $7.65 from pot
NYi6JFscYNrofSXy4sM+Yw: doesn't show hand
*** SUMMARY ***
Total pot $8 | Rake $0.35
Board [6h Js As 7c Ah]
Seat 1: NYi6JFscYNrofSXy4sM+Yw (button) (small blind) collected ($7.65)
Seat 2: TME8GvochpQAo8cmJwWmvA (big blind) folded on the River



PokerStars Game #59939199720:  Hold'em No Limit ($0.50/$1.00) - 2009/07/01 0:33:49 ET
Table 'QBLDswtHe7Ml0HwAdcMhlw' 2-max Seat #2 is the button
Seat 1: hdNlhiCwI533uwvvTTfC9Q ($100 in chips)
Seat 2: rAtTyvrJ8f1LaUh2O5U4nA ($36.40 in chips)
rAtTyvrJ8f1LaUh2O5U4nA: posts small blind $0.50
hdNlhiCwI533uwvvTTfC9Q: posts big blind $1
*** HOLE CARDS ***
rAtTyvrJ8f1LaUh2O5U4nA: raises $4 to $5
hdNlhiCwI533uwvvTTfC9Q: folds
rAtTyvrJ8f1LaUh2O5U4nA collected $2 from pot
rAtTyvrJ8f1LaUh2O5U4nA: doesn't show hand
*** SUMMARY ***
Total pot $2 | Rake $0
Seat 1: hdNlhiCwI533uwvvTTfC9Q (big blind) folded before Flop
Seat 2: rAtTyvrJ8f1LaUh2O5U4nA (button) (small blind) collected ($2)



PokerStars Game #59939199590:  Hold'em No Limit ($0.50/$1.00) - 2009/07/01 0:33:49 ET
Table 'rmZfTK+oSebeUPJNbWhdAA' 6-max Seat #6 is the button
Seat 1: xAU6q2/cwmby2sxmA8VcmA ($100 in chips)
Seat 2: OigyyiK+tTj1APPIAUmXDA ($126.05 in chips)
Seat 3: 9yjOzGERLaEZS8CZ6YNHFg ($115.40 in chips)
Seat 4: OGMLOcTNYZXZU81au7ztUw ($130.85 in chips)
Seat 5: +xW7QemQU0Fxs+4TnqBRow ($100 in chips)
Seat 6: j7NIOHLZk7V2o9fOioO5ug ($100 in chips)
xAU6q2/cwmby2sxmA8VcmA: posts small blind $0.50
OigyyiK+tTj1APPIAUmXDA: posts big blind $1
*** HOLE CARDS ***
9yjOzGERLaEZS8CZ6YNHFg: folds
OGMLOcTNYZXZU81au7ztUw: folds
+xW7QemQU0Fxs+4TnqBRow: folds
j7NIOHLZk7V2o9fOioO5ug: raises $2 to $3
xAU6q2/cwmby2sxmA8VcmA: raises $9 to $12
OigyyiK+tTj1APPIAUmXDA: folds
j7NIOHLZk7V2o9fOioO5ug: raises $23 to $35
xAU6q2/cwmby2sxmA8VcmA: folds
j7NIOHLZk7V2o9fOioO5ug collected $25 from pot
j7NIOHLZk7V2o9fOioO5ug: doesn't show hand
*** SUMMARY ***
Total pot $25 | Rake $0
Seat 1: xAU6q2/cwmby2sxmA8VcmA (small blind) folded before Flop
Seat 2: OigyyiK+tTj1APPIAUmXDA (big blind) folded before Flop
Seat 3: 9yjOzGERLaEZS8CZ6YNHFg folded before Flop (didn't bet)
Seat 4: OGMLOcTNYZXZU81au7ztUw folded before Flop (didn't bet)
Seat 5: +xW7QemQU0Fxs+4TnqBRow folded before Flop (didn't bet)
Seat 6: j7NIOHLZk7V2o9fOioO5ug (button) collected ($25)



PokerStars Game #59939200668:  Hold'em No Limit ($0.50/$1.00) - 2009/07/01 0:33:50 ET
Table '21a4iYFKcuezM4nYx8DWTA' 2-max Seat #1 is the button
Seat 1: NYi6JFscYNrofSXy4sM+Yw ($177.50 in chips)
Seat 2: +sy/nlNI20yZraIjs4AALg ($21.45 in chips)
NYi6JFscYNrofSXy4sM+Yw: posts small blind $0.50
+sy/nlNI20yZraIjs4AALg: posts big blind $1
*** HOLE CARDS ***
NYi6JFscYNrofSXy4sM+Yw: folds
+sy/nlNI20yZraIjs4AALg collected $1 from pot
*** SUMMARY ***
Total pot $1 | Rake $0
Seat 1: NYi6JFscYNrofSXy4sM+Yw (button) (small blind) folded before Flop
Seat 2: +sy/nlNI20yZraIjs4AALg (big blind) collected ($1)



PokerStars Game #59939201962:  Hold'em No Limit ($0.50/$1.00) - 2009/07/01 0:33:52 ET
Table 'vs/5jr6ciwjVQ5+Soc+u2A' 6-max Seat #1 is the button
Seat 1: 3yN2jRjZ+glIaWtGMmKOrA ($21.55 in chips)
Seat 2: XOIf9W+VAxhZqN+SYoyMKA ($119.65 in chips)
Seat 3: G5ZSSN6RSON3gkNvk/SmYg ($100 in chips)
Seat 4: KpnW5CcJ4Mg6MeclfKmLrw ($109.80 in chips)
Seat 5: 7Vc9JmGFQwMRh5Tj9ui5Lw ($104.55 in chips)
Seat 6: QHvTZcrKe6+maWUfVjP29Q ($100 in chips)
XOIf9W+VAxhZqN+SYoyMKA: posts small blind $0.50
G5ZSSN6RSON3gkNvk/SmYg: posts big blind $1
*** HOLE CARDS ***
KpnW5CcJ4Mg6MeclfKmLrw: folds
7Vc9JmGFQwMRh5Tj9ui5Lw: calls $1
QHvTZcrKe6+maWUfVjP29Q: folds
3yN2jRjZ+glIaWtGMmKOrA: folds
XOIf9W+VAxhZqN+SYoyMKA: calls $0.50
G5ZSSN6RSON3gkNvk/SmYg: checks
*** FLOP *** [4c 3s 2d]
XOIf9W+VAxhZqN+SYoyMKA: checks
G5ZSSN6RSON3gkNvk/SmYg: checks
7Vc9JmGFQwMRh5Tj9ui5Lw: bets $5
XOIf9W+VAxhZqN+SYoyMKA: folds
G5ZSSN6RSON3gkNvk/SmYg: folds
7Vc9JmGFQwMRh5Tj9ui5Lw collected $2.85 from pot
7Vc9JmGFQwMRh5Tj9ui5Lw: doesn't show hand
*** SUMMARY ***
Total pot $3 | Rake $0.15
Board [4c 3s 2d]
Seat 1: 3yN2jRjZ+glIaWtGMmKOrA (button) folded before Flop (didn't bet)
Seat 2: XOIf9W+VAxhZqN+SYoyMKA (small blind) folded on the Flop
Seat 3: G5ZSSN6RSON3gkNvk/SmYg (big blind) folded on the Flop
Seat 4: KpnW5CcJ4Mg6MeclfKmLrw folded before Flop (didn't bet)
Seat 5: 7Vc9JmGFQwMRh5Tj9ui5Lw collected ($2.85)
Seat 6: QHvTZcrKe6+maWUfVjP29Q folded before Flop (didn't bet)



PokerStars Game #59939202594:  Hold'em No Limit ($0.50/$1.00) - 2009/07/01 0:33:53 ET
Table 'N2bNCDHL96aCQDvZIh+yQQ' 6-max Seat #4 is the button
Seat 1: iHo1oDbrEVJ8nEGdaPrICw ($143.50 in chips)
Seat 2: KpnW5CcJ4Mg6MeclfKmLrw ($111.90 in chips)
Seat 3: Qy/UBNbD2HaA0Ogxg8Sf3w ($111.80 in chips)
Seat 4: uCqEjnxh2/vFBjKYkfTOkw ($151.90 in chips)
Seat 5: rHlMOfR7kpQQxe+PFQz0xQ ($29.10 in chips)
Seat 6: TSuRyAHnUPCFjP7Z0rEE0w ($100 in chips)
rHlMOfR7kpQQxe+PFQz0xQ: posts small blind $0.50
TSuRyAHnUPCFjP7Z0rEE0w: posts big blind $1
*** HOLE CARDS ***
iHo1oDbrEVJ8nEGdaPrICw: folds
KpnW5CcJ4Mg6MeclfKmLrw: folds
Qy/UBNbD2HaA0Ogxg8Sf3w: folds
uCqEjnxh2/vFBjKYkfTOkw: folds
rHlMOfR7kpQQxe+PFQz0xQ: calls $0.50
TSuRyAHnUPCFjP7Z0rEE0w: checks
*** FLOP *** [Qc 5d Th]
rHlMOfR7kpQQxe+PFQz0xQ: bets $1
TSuRyAHnUPCFjP7Z0rEE0w: folds
rHlMOfR7kpQQxe+PFQz0xQ collected $1.90 from pot
rHlMOfR7kpQQxe+PFQz0xQ: doesn't show hand
*** SUMMARY ***
Total pot $2 | Rake $0.10
Board [Qc 5d Th]
Seat 1: iHo1oDbrEVJ8nEGdaPrICw folded before Flop (didn't bet)
Seat 2: KpnW5CcJ4Mg6MeclfKmLrw folded before Flop (didn't bet)
Seat 3: Qy/UBNbD2HaA0Ogxg8Sf3w folded before Flop (didn't bet)
Seat 4: uCqEjnxh2/vFBjKYkfTOkw (button) folded before Flop (didn't bet)
Seat 5: rHlMOfR7kpQQxe+PFQz0xQ (small blind) collected ($1.90)
Seat 6: TSuRyAHnUPCFjP7Z0rEE0w (big blind) folded on the Flop



PokerStars Game #59939203356:  Hold'em No Limit ($0.50/$1.00) - 2009/07/01 0:33:54 ET
Table '/RZcOwpZpHQ+OwPwjsbnRw' 6-max Seat #3 is the button
Seat 1: Zboa6dColKGHBjLPUakZjw ($52.70 in chips)
Seat 2: dHC9PH9hdH3Ad2TD8ZxX0Q ($45.25 in chips)
Seat 3: OigyyiK+tTj1APPIAUmXDA ($71.15 in chips)
Seat 4: j7NIOHLZk7V2o9fOioO5ug ($117.40 in chips)
Seat 5: wx3sQGkVi2x9wJXuWNHPBw ($199.65 in chips)
Seat 6: XOIf9W+VAxhZqN+SYoyMKA ($246.30 in chips)
j7NIOHLZk7V2o9fOioO5ug: posts small blind $0.50
wx3sQGkVi2x9wJXuWNHPBw: posts big blind $1
*** HOLE CARDS ***
XOIf9W+VAxhZqN+SYoyMKA: folds
Zboa6dColKGHBjLPUakZjw: folds
dHC9PH9hdH3Ad2TD8ZxX0Q: folds
OigyyiK+tTj1APPIAUmXDA: folds
j7NIOHLZk7V2o9fOioO5ug: folds
wx3sQGkVi2x9wJXuWNHPBw collected $1 from pot
*** SUMMARY ***
Total pot $1 | Rake $0
Seat 1: Zboa6dColKGHBjLPUakZjw folded before Flop (didn't bet)
Seat 2: dHC9PH9hdH3Ad2TD8ZxX0Q folded before Flop (didn't bet)
Seat 3: OigyyiK+tTj1APPIAUmXDA (button) folded before Flop (didn't bet)
Seat 4: j7NIOHLZk7V2o9fOioO5ug (small blind) folded before Flop
Seat 5: wx3sQGkVi2x9wJXuWNHPBw (big blind) collected ($1)
Seat 6: XOIf9W+VAxhZqN+SYoyMKA folded before Flop (didn't bet)



PokerStars Game #59939203288:  Hold'em No Limit ($0.50/$1.00) - 2009/07/01 0:33:54 ET
Table 'hugOjcwJvzEwZbK7tyiWuQ' 9-max Seat #7 is the button
Seat 1: N9n5Wc3s35DpCrOAUUNAaQ ($128.50 in chips)
Seat 2: r27C1nIV4NS4+qbnrgBQSw ($257.05 in chips)
Seat 3: jDwhY1kCdc6EkAHbT7PJMQ ($117.65 in chips)
Seat 4: UWB3oeddt/GObx2Mix2Anw ($199.80 in chips)
Seat 6: gUUvmqdVlmvpal6B8nYrmg ($100 in chips)
Seat 7: FL3MrLspcF23LYvC4ipBOA ($100 in chips)
Seat 8: /zy+DB4S5fUQUSfZWFzYGw ($106.25 in chips)
Seat 9: o6JyUkbzCDw8tUabqtmnlg ($57.60 in chips)
/zy+DB4S5fUQUSfZWFzYGw: posts small blind $0.50
o6JyUkbzCDw8tUabqtmnlg: posts big blind $1
*** HOLE CARDS ***
N9n5Wc3s35DpCrOAUUNAaQ: folds
r27C1nIV4NS4+qbnrgBQSw: folds
jDwhY1kCdc6EkAHbT7PJMQ: folds
5BRGWf+R3nt2WS3b5xX+zA has returned
UWB3oeddt/GObx2Mix2Anw: folds
gUUvmqdVlmvpal6B8nYrmg: raises $1 to $2
FL3MrLspcF23LYvC4ipBOA: folds
/zy+DB4S5fUQUSfZWFzYGw: folds
o6JyUkbzCDw8tUabqtmnlg: calls $1
*** FLOP *** [Ad 6s Qs]
o6JyUkbzCDw8tUabqtmnlg: checks
gUUvmqdVlmvpal6B8nYrmg: bets $2
o6JyUkbzCDw8tUabqtmnlg: calls $2
*** TURN *** [Ad 6s Qs] [5s]
o6JyUkbzCDw8tUabqtmnlg: checks
gUUvmqdVlmvpal6B8nYrmg: checks
*** RIVER *** [Ad 6s Qs 5s] [4d]
o6JyUkbzCDw8tUabqtmnlg: bets $5
gUUvmqdVlmvpal6B8nYrmg: folds
o6JyUkbzCDw8tUabqtmnlg collected $8.10 from pot
*** SUMMARY ***
Total pot $8.50 | Rake $0.40
Board [Ad 6s Qs 5s 4d]
Seat 1: N9n5Wc3s35DpCrOAUUNAaQ folded before Flop (didn't bet)
Seat 2: r27C1nIV4NS4+qbnrgBQSw folded before Flop (didn't bet)
Seat 3: jDwhY1kCdc6EkAHbT7PJMQ folded before Flop (didn't bet)
Seat 4: UWB3oeddt/GObx2Mix2Anw folded before Flop (didn't bet)
Seat 6: gUUvmqdVlmvpal6B8nYrmg folded on the River
Seat 7: FL3MrLspcF23LYvC4ipBOA (button) folded before Flop (didn't bet)
Seat 8: /zy+DB4S5fUQUSfZWFzYGw (small blind) folded before Flop
Seat 9: o6JyUkbzCDw8tUabqtmnlg (big blind) collected ($8.10)



PokerStars Game #59939202892:  Hold'em No Limit ($0.50/$1.00) - 2009/07/01 0:33:54 ET
Table 'kS0cTQAEi+fdUlJP2gQYvw' 9-max Seat #4 is the button
Seat 1: c/9X4zftzphFxYtxp5kp9w ($39.40 in chips)
Seat 3: 3obndzTJ6fECz8+wWhMd1w ($19 in chips)
Seat 4: TZcz9MEWDA+WydgGruqqbw ($100 in chips)
Seat 5: 2rxrMrE7koO2BNxvop/0+g ($52.05 in chips)
Seat 6: yAbu2QsRPVcjPbqlf/jDxw ($100 in chips)
Seat 7: Ffa7Nj4X5fddtROP01hfQg ($111.20 in chips)
Seat 8: qTymj6ZQ8ZoFi6fINJZb3w ($80.50 in chips)
Seat 9: y8Qb94e81yI/g0saQ6gU5g ($55.25 in chips)
2rxrMrE7koO2BNxvop/0+g: posts small blind $0.50
yAbu2QsRPVcjPbqlf/jDxw: posts big blind $1
*** HOLE CARDS ***
Ffa7Nj4X5fddtROP01hfQg: folds
qTymj6ZQ8ZoFi6fINJZb3w: folds
y8Qb94e81yI/g0saQ6gU5g: raises $3 to $4
c/9X4zftzphFxYtxp5kp9w: folds
3obndzTJ6fECz8+wWhMd1w: folds
TZcz9MEWDA+WydgGruqqbw: folds
2rxrMrE7koO2BNxvop/0+g: folds
yAbu2QsRPVcjPbqlf/jDxw: folds
y8Qb94e81yI/g0saQ6gU5g collected $2.50 from pot
*** SUMMARY ***
Total pot $2.50 | Rake $0
Seat 1: c/9X4zftzphFxYtxp5kp9w folded before Flop (didn't bet)
Seat 3: 3obndzTJ6fECz8+wWhMd1w folded before Flop (didn't bet)
Seat 4: TZcz9MEWDA+WydgGruqqbw (button) folded before Flop (didn't bet)
Seat 5: 2rxrMrE7koO2BNxvop/0+g (small blind) folded before Flop
Seat 6: yAbu2QsRPVcjPbqlf/jDxw (big blind) folded before Flop
Seat 7: Ffa7Nj4X5fddtROP01hfQg folded before Flop (didn't bet)
Seat 8: qTymj6ZQ8ZoFi6fINJZb3w folded before Flop (didn't bet)
Seat 9: y8Qb94e81yI/g0saQ6gU5g collected ($2.50)



PokerStars Game #59939203918:  Hold'em No Limit ($0.50/$1.00) - 2009/07/01 0:33:55 ET
Table 'MUPc8FEpe/nR0BKSeReX6Q' 6-max Seat #5 is the button
Seat 1: YsLQ3BAvgQHWXMAv3Wv6Hg ($100 in chips)
Seat 2: xAU6q2/cwmby2sxmA8VcmA ($109 in chips)
Seat 3: wx3sQGkVi2x9wJXuWNHPBw ($234.05 in chips)
Seat 4: ZA1bp6g8IwtTxkUE4eCjDQ ($119.10 in chips)
Seat 5: UBZQqpnJZdTYYY1FTb0rLA ($100.90 in chips)
Seat 6: oxnw0GLLpFanjhGkxfRSqA ($51.60 in chips)
oxnw0GLLpFanjhGkxfRSqA: posts small blind $0.50
YsLQ3BAvgQHWXMAv3Wv6Hg: posts big blind $1
*** HOLE CARDS ***
xAU6q2/cwmby2sxmA8VcmA: folds
wx3sQGkVi2x9wJXuWNHPBw: folds
ZA1bp6g8IwtTxkUE4eCjDQ: calls $1
UBZQqpnJZdTYYY1FTb0rLA: calls $1
oxnw0GLLpFanjhGkxfRSqA: folds
YsLQ3BAvgQHWXMAv3Wv6Hg: checks
*** FLOP *** [3d Jc Qh]
YsLQ3BAvgQHWXMAv3Wv6Hg: checks
ZA1bp6g8IwtTxkUE4eCjDQ: checks
UBZQqpnJZdTYYY1FTb0rLA: bets $2
YsLQ3BAvgQHWXMAv3Wv6Hg: folds
ZA1bp6g8IwtTxkUE4eCjDQ: calls $2
*** TURN *** [3d Jc Qh] [As]
ZA1bp6g8IwtTxkUE4eCjDQ: checks
UBZQqpnJZdTYYY1FTb0rLA: bets $4
ZA1bp6g8IwtTxkUE4eCjDQ: calls $4
*** RIVER *** [3d Jc Qh As] [7h]
ZA1bp6g8IwtTxkUE4eCjDQ: checks
UBZQqpnJZdTYYY1FTb0rLA: checks
*** SHOW DOWN ***
ZA1bp6g8IwtTxkUE4eCjDQ: shows [Ac Th] (a pair of Aces)
UBZQqpnJZdTYYY1FTb0rLA: mucks hand
ZA1bp6g8IwtTxkUE4eCjDQ collected $14.75 from pot
*** SUMMARY ***
Total pot $15.50 | Rake $0.75
Board [3d Jc Qh As 7h]
Seat 1: YsLQ3BAvgQHWXMAv3Wv6Hg (big blind) folded on the Flop
Seat 2: xAU6q2/cwmby2sxmA8VcmA folded before Flop (didn't bet)
Seat 3: wx3sQGkVi2x9wJXuWNHPBw folded before Flop (didn't bet)
Seat 4: ZA1bp6g8IwtTxkUE4eCjDQ showed [Ac Th] and won ($14.75) with a pair of Aces
Seat 5: UBZQqpnJZdTYYY1FTb0rLA (button) mucked
Seat 6: oxnw0GLLpFanjhGkxfRSqA (small blind) folded before Flop



PokerStars Game #59939205242:  Hold'em No Limit ($0.50/$1.00) - 2009/07/01 0:33:57 ET
Table 'tyUh+jyNvrceIQdKMJjQ2wZFWj23PMihdwrNWv41OG/Qeat #5 is the button
Seat 2: m1sJRkJZ1wu5i1BdgeO2Jw ($30 in chips)
Seat 3: TalCiLYHCd+ffkmR3auPvA ($58 in chips)
Seat 4: TSuRyAHnUPCFjP7Z0rEE0w ($120.25 in chips)
Seat 5: j7NIOHLZk7V2o9fOioO5ug ($119.10 in chips)
Seat 6: YsLQ3BAvgQHWXMAv3Wv6Hg ($137.60 in chips)
YsLQ3BAvgQHWXMAv3Wv6Hg: posts small blind $0.50
m1sJRkJZ1wu5i1BdgeO2Jw: posts big blind $1
*** HOLE CARDS ***
TalCiLYHCd+ffkmR3auPvA: folds
TSuRyAHnUPCFjP7Z0rEE0w: raises $3 to $4
j7NIOHLZk7V2o9fOioO5ug: folds
YsLQ3BAvgQHWXMAv3Wv6Hg: calls $3.50
m1sJRkJZ1wu5i1BdgeO2Jw: calls $3
*** FLOP *** [8d 9s Js]
YsLQ3BAvgQHWXMAv3Wv6Hg: checks
m1sJRkJZ1wu5i1BdgeO2Jw: checks
TSuRyAHnUPCFjP7Z0rEE0w: bets $8
YsLQ3BAvgQHWXMAv3Wv6Hg: calls $8
m1sJRkJZ1wu5i1BdgeO2Jw: folds
*** TURN *** [8d 9s Js] [Qc]
YsLQ3BAvgQHWXMAv3Wv6Hg: checks
TSuRyAHnUPCFjP7Z0rEE0w: checks
*** RIVER *** [8d 9s Js Qc] [2c]
YsLQ3BAvgQHWXMAv3Wv6Hg: bets $18
TSuRyAHnUPCFjP7Z0rEE0w: folds
YsLQ3BAvgQHWXMAv3Wv6Hg collected $26.65 from pot
YsLQ3BAvgQHWXMAv3Wv6Hg: doesn't show hand
*** SUMMARY ***
Total pot $28 | Rake $1.35
Board [8d 9s Js Qc 2c]
Seat 2: m1sJRkJZ1wu5i1BdgeO2Jw (big blind) folded on the Flop
Seat 3: TalCiLYHCd+ffkmR3auPvA folded before Flop (didn't bet)
Seat 4: TSuRyAHnUPCFjP7Z0rEE0w folded on the River
Seat 5: j7NIOHLZk7V2o9fOioO5ug (button) folded before Flop (didn't bet)
Seat 6: YsLQ3BAvgQHWXMAv3Wv6Hg (small blind) collected ($26.65)



PokerStars Game #59939205902:  Hold'em No Limit ($0.50/$1.00) - 2009/07/01 0:33:58 ET
Table 'pHrhryH8jPNdQfY62f8v+g' 6-max Seat #2 is the button
Seat 1: BdbmJTZZ47quA9vUWwXtlw ($106.80 in chips)
Seat 2: RqgF7gRoKgRNW8Zoi1ty4A ($115 in chips)
Seat 4: wenbG7TaM3H7h5kn78OFNw ($58.80 in chips)
Seat 5: r1/R7y0Ortgoz4lccgW8VA ($23.15 in chips)
Seat 6: xAU6q2/cwmby2sxmA8VcmA ($102.80 in chips)
wenbG7TaM3H7h5kn78OFNw: posts small blind $0.50
r1/R7y0Ortgoz4lccgW8VA: posts big blind $1
*** HOLE CARDS ***
xAU6q2/cwmby2sxmA8VcmA: folds
BdbmJTZZ47quA9vUWwXtlw: raises $2 to $3
RqgF7gRoKgRNW8Zoi1ty4A: folds
wenbG7TaM3H7h5kn78OFNw: folds
r1/R7y0Ortgoz4lccgW8VA: calls $2
*** FLOP *** [3d Tc As]
0WjiuIT7/EolY1oOx1ngeA leaves the table
r1/R7y0Ortgoz4lccgW8VA: checks
BdbmJTZZ47quA9vUWwXtlw: bets $4
r1/R7y0Ortgoz4lccgW8VA: calls $4
*** TURN *** [3d Tc As] [6h]
r1/R7y0Ortgoz4lccgW8VA: checks
BdbmJTZZ47quA9vUWwXtlw: bets $36
r1/R7y0Ortgoz4lccgW8VA: folds
BdbmJTZZ47quA9vUWwXtlw collected $13.80 from pot
*** SUMMARY ***
Total pot $14.50 | Rake $0.70
Board [3d Tc As 6h]
Seat 1: BdbmJTZZ47quA9vUWwXtlw collected ($13.80)
Seat 2: RqgF7gRoKgRNW8Zoi1ty4A (button) folded before Flop (didn't bet)
Seat 4: wenbG7TaM3H7h5kn78OFNw (small blind) folded before Flop
Seat 5: r1/R7y0Ortgoz4lccgW8VA (big blind) folded on the Turn
Seat 6: xAU6q2/cwmby2sxmA8VcmA folded before Flop (didn't bet)



PokerStars Game #59939205600:  Hold'em No Limit ($0.50/$1.00) - 2009/07/01 0:33:58 ET
Table '21a4iYFKcuezM4nYx8DWTA' 2-max Seat #2 is the button
Seat 1: NYi6JFscYNrofSXy4sM+Yw ($177 in chips)
Seat 2: +sy/nlNI20yZraIjs4AALg ($21.95 in chips)
+sy/nlNI20yZraIjs4AALg: posts small blind $0.50
NYi6JFscYNrofSXy4sM+Yw: posts big blind $1
*** HOLE CARDS ***
+sy/nlNI20yZraIjs4AALg: folds
NYi6JFscYNrofSXy4sM+Yw collected $1 from pot
NYi6JFscYNrofSXy4sM+Yw: doesn't show hand
*** SUMMARY ***
Total pot $1 | Rake $0
Seat 1: NYi6JFscYNrofSXy4sM+Yw (big blind) collected ($1)
Seat 2: +sy/nlNI20yZraIjs4AALg (button) (small blind) folded before Flop



PokerStars Game #59939207482:  Hold'em No Limit ($0.50/$1.00) - 2009/07/01 0:34:00 ET
Table 'QBLDswtHe7Ml0HwAdcMhlw' 2-max Seat #1 is the button
Seat 1: hdNlhiCwI533uwvvTTfC9Q ($100 in chips)
Seat 2: rAtTyvrJ8f1LaUh2O5U4nA ($37.40 in chips)
hdNlhiCwI533uwvvTTfC9Q: posts small blind $0.50
rAtTyvrJ8f1LaUh2O5U4nA: posts big blind $1
*** HOLE CARDS ***
hdNlhiCwI533uwvvTTfC9Q: folds
rAtTyvrJ8f1LaUh2O5U4nA collected $1 from pot
*** SUMMARY ***
Total pot $1 | Rake $0
Seat 1: hdNlhiCwI533uwvvTTfC9Q (button) (small blind) folded before Flop
Seat 2: rAtTyvrJ8f1LaUh2O5U4nA (big blind) collected ($1)



PokerStars Game #59939207152:  Hold'em No Limit ($0.50/$1.00) - 2009/07/01 0:34:00 ET
Table '+cA8mcmhaedZ7YcrDdhmeQ' 6-max Seat #6 is the button
Seat 1: lsLuWlcPA3Rh7kJVLzMh0Q ($306.25 in chips)
Seat 2: RqgF7gRoKgRNW8Zoi1ty4A ($102.50 in chips)
Seat 3: 7H5WkGzGvsv56y1iaqHvRg ($39 in chips)
Seat 4: LjL3AIERHn559yyW1mTUYQ ($162 in chips)
Seat 6: YfsTQsY/fxb+YqbdclTHuw ($34.40 in chips)
lsLuWlcPA3Rh7kJVLzMh0Q: posts small blind $0.50
RqgF7gRoKgRNW8Zoi1ty4A: posts big blind $1
*** HOLE CARDS ***
6WyjEXOToimYmtLdqIgHYQ said, "WOWOWOWOw"
7H5WkGzGvsv56y1iaqHvRg: folds
6WyjEXOToimYmtLdqIgHYQ leaves the table
LjL3AIERHn559yyW1mTUYQ: folds
YfsTQsY/fxb+YqbdclTHuw: folds
lsLuWlcPA3Rh7kJVLzMh0Q: raises $2 to $3
RqgF7gRoKgRNW8Zoi1ty4A: folds
iHo1oDbrEVJ8nEGdaPrICw joins the table at seat #5
lsLuWlcPA3Rh7kJVLzMh0Q collected $2 from pot
lsLuWlcPA3Rh7kJVLzMh0Q: doesn't show hand
*** SUMMARY ***
Total pot $2 | Rake $0
Seat 1: lsLuWlcPA3Rh7kJVLzMh0Q (small blind) collected ($2)
Seat 2: RqgF7gRoKgRNW8Zoi1ty4A (big blind) folded before Flop
Seat 3: 7H5WkGzGvsv56y1iaqHvRg folded before Flop (didn't bet)
Seat 4: LjL3AIERHn559yyW1mTUYQ folded before Flop (didn't bet)
Seat 6: YfsTQsY/fxb+YqbdclTHuw (button) folded before Flop (didn't bet)



PokerStars Game #59939208720:  Hold'em No Limit ($0.50/$1.00) - 2009/07/01 0:34:02 ET
Table 'eU3bWpDDg3Z+9R4m4iVmog' 6-max Seat #2 is the button
Seat 1: TSuRyAHnUPCFjP7Z0rEE0w ($169.70 in chips)
Seat 2: 8CAoOzhmB8n3nRFf3V4BTg ($124.95 in chips)
Seat 3: U6tnjwZRpTnM+YkqkCjwyQ ($170.15 in chips)
Seat 4: GDVIsbEJ/DOJsMKE4Asz0A ($102.10 in chips)
Seat 6: hpxXcmRkXXI9HE5+5/j/0Q ($103.50 in chips)
U6tnjwZRpTnM+YkqkCjwyQ: posts small blind $0.50
GDVIsbEJ/DOJsMKE4Asz0A: posts big blind $1
AdLVjddOzm+sRNo1Bc3S6Q: sits out
*** HOLE CARDS ***
hpxXcmRkXXI9HE5+5/j/0Q: folds
TSuRyAHnUPCFjP7Z0rEE0w: raises $3 to $4
8CAoOzhmB8n3nRFf3V4BTg: folds
U6tnjwZRpTnM+YkqkCjwyQ: folds
GDVIsbEJ/DOJsMKE4Asz0A: folds
TSuRyAHnUPCFjP7Z0rEE0w collected $2.50 from pot
TSuRyAHnUPCFjP7Z0rEE0w: doesn't show hand
*** SUMMARY ***
Total pot $2.50 | Rake $0
Seat 1: TSuRyAHnUPCFjP7Z0rEE0w collected ($2.50)
Seat 2: 8CAoOzhmB8n3nRFf3V4BTg (button) folded before Flop (didn't bet)
Seat 3: U6tnjwZRpTnM+YkqkCjwyQ (small blind) folded before Flop
Seat 4: GDVIsbEJ/DOJsMKE4Asz0A (big blind) folded before Flop
Seat 6: hpxXcmRkXXI9HE5+5/j/0Q folded before Flop (didn't bet)



PokerStars Game #59939208552:  Hold'em No Limit ($0.50/$1.00) - 2009/07/01 0:34:02 ET
Table 'O96CPOtvMBWP6kzuYDfdFA' 6-max Seat #5 is the button
Seat 1: 6alLXQIITA2EZ/lBeym8Dw ($100 in chips)
Seat 2: sc/HX9smXU5kObrOWIYO5g ($35 in chips)
Seat 3: V89DGjxE171oPREEbAXiyg ($37.55 in chips)
Seat 4: KOG8rG51mOvIoY96zF3kvw ($167.75 in chips)
Seat 5: wRxiu9OJzvvN84OYWW9jxQ ($133.10 in chips)
Seat 6: xNKcQzD9+/iHmtJn4vYq9w ($140.65 in chips)
xNKcQzD9+/iHmtJn4vYq9w: posts small blind $0.50
6alLXQIITA2EZ/lBeym8Dw: posts big blind $1
*** HOLE CARDS ***
sc/HX9smXU5kObrOWIYO5g: calls $1
V89DGjxE171oPREEbAXiyg: folds
V89DGjxE171oPREEbAXiyg is sitting out
KOG8rG51mOvIoY96zF3kvw: folds
wRxiu9OJzvvN84OYWW9jxQ: folds
xNKcQzD9+/iHmtJn4vYq9w: folds
6alLXQIITA2EZ/lBeym8Dw: checks
*** FLOP *** [8s 9s 4c]
6alLXQIITA2EZ/lBeym8Dw: checks
sc/HX9smXU5kObrOWIYO5g: bets $3
6alLXQIITA2EZ/lBeym8Dw: folds
sc/HX9smXU5kObrOWIYO5g collected $2.40 from pot
*** SUMMARY ***
Total pot $2.50 | Rake $0.10
Board [8s 9s 4c]
Seat 1: 6alLXQIITA2EZ/lBeym8Dw (big blind) folded on the Flop
Seat 2: sc/HX9smXU5kObrOWIYO5g collected ($2.40)
Seat 3: V89DGjxE171oPREEbAXiyg folded before Flop (didn't bet)
Seat 4: KOG8rG51mOvIoY96zF3kvw folded before Flop (didn't bet)
Seat 5: wRxiu9OJzvvN84OYWW9jxQ (button) folded before Flop (didn't bet)
Seat 6: xNKcQzD9+/iHmtJn4vYq9w (small blind) folded before Flop



PokerStars Game #59939211288:  Hold'em No Limit ($0.50/$1.00) - 2009/07/01 0:34:06 ET
Table 'QSIig7BLMc9wY/rgBechzw' 6-max Seat #3 is the button
Seat 1: uuA9hpFU17U5/t4cvpbpBg ($27.05 in chips)
Seat 2: 0WjiuIT7/EolY1oOx1ngeA ($124.75 in chips)
Seat 3: +W6OnF033KNM2xH0fGj98Q ($100 in chips)
Seat 4: +uSzP8Jwnw7sKfQ4s66b7w ($30.50 in chips)
Seat 5: bvU2ZjpVnszLCFVeWbxePg ($116.90 in chips)
Seat 6: KpnW5CcJ4Mg6MeclfKmLrw ($187.10 in chips)
+uSzP8Jwnw7sKfQ4s66b7w: posts small blind $0.50
bvU2ZjpVnszLCFVeWbxePg: posts big blind $1
*** HOLE CARDS ***
KpnW5CcJ4Mg6MeclfKmLrw: raises $3 to $4
uuA9hpFU17U5/t4cvpbpBg: folds
0WjiuIT7/EolY1oOx1ngeA: folds
+W6OnF033KNM2xH0fGj98Q: folds
+uSzP8Jwnw7sKfQ4s66b7w: folds
bvU2ZjpVnszLCFVeWbxePg: folds
KpnW5CcJ4Mg6MeclfKmLrw collected $2.50 from pot
KpnW5CcJ4Mg6MeclfKmLrw: doesn't show hand
*** SUMMARY ***
Total pot $2.50 | Rake $0
Seat 1: uuA9hpFU17U5/t4cvpbpBg folded before Flop (didn't bet)
Seat 2: 0WjiuIT7/EolY1oOx1ngeA folded before Flop (didn't bet)
Seat 3: +W6OnF033KNM2xH0fGj98Q (button) folded before Flop (didn't bet)
Seat 4: +uSzP8Jwnw7sKfQ4s66b7w (small blind) folded before Flop
Seat 5: bvU2ZjpVnszLCFVeWbxePg (big blind) folded before Flop
Seat 6: KpnW5CcJ4Mg6MeclfKmLrw collected ($2.50)



PokerStars Game #59939211252:  Hold'em No Limit ($0.50/$1.00) - 2009/07/01 0:34:06 ET
Table 'QBLDswtHe7Ml0HwAdcMhlw' 2-max Seat #2 is the button
Seat 1: hdNlhiCwI533uwvvTTfC9Q ($100 in chips)
Seat 2: rAtTyvrJ8f1LaUh2O5U4nA ($37.90 in chips)
rAtTyvrJ8f1LaUh2O5U4nA: posts small blind $0.50
hdNlhiCwI533uwvvTTfC9Q: posts big blind $1
*** HOLE CARDS ***
rAtTyvrJ8f1LaUh2O5U4nA: folds
hdNlhiCwI533uwvvTTfC9Q collected $1 from pot
hdNlhiCwI533uwvvTTfC9Q: doesn't show hand
*** SUMMARY ***
Total pot $1 | Rake $0
Seat 1: hdNlhiCwI533uwvvTTfC9Q (big blind) collected ($1)
Seat 2: rAtTyvrJ8f1LaUh2O5U4nA (button) (small blind) folded before Flop



PokerStars Game #59939211878:  Hold'em No Limit ($0.50/$1.00) - 2009/07/01 0:34:07 ET
Table '21a4iYFKcuezM4nYx8DWTA' 2-max Seat #1 is the button
Seat 1: NYi6JFscYNrofSXy4sM+Yw ($177.50 in chips)
Seat 2: +sy/nlNI20yZraIjs4AALg ($21.45 in chips)
NYi6JFscYNrofSXy4sM+Yw: posts small blind $0.50
+sy/nlNI20yZraIjs4AALg: posts big blind $1
*** HOLE CARDS ***
NYi6JFscYNrofSXy4sM+Yw: raises $1 to $2
+sy/nlNI20yZraIjs4AALg: raises $19.45 to $21.45 and is all-in
NYi6JFscYNrofSXy4sM+Yw: calls $19.45
*** FLOP *** [4s Tc 5d]
*** TURN *** [4s Tc 5d] [Jd]
*** RIVER *** [4s Tc 5d Jd] [Kh]
*** SHOW DOWN ***
+sy/nlNI20yZraIjs4AALg: shows [5s 9d] (a pair of Fives)
NYi6JFscYNrofSXy4sM+Yw: shows [Th Jh] (two pair, Jacks and Tens)
NYi6JFscYNrofSXy4sM+Yw collected $42.40 from pot
*** SUMMARY ***
Total pot $42.90 | Rake $0.50
Board [4s Tc 5d Jd Kh]
Seat 1: NYi6JFscYNrofSXy4sM+Yw (button) (small blind) showed [Th Jh] and won ($42.40) with two pair, Jacks and Tens
Seat 2: +sy/nlNI20yZraIjs4AALg (big blind) showed [5s 9d] and lost with a pair of Fives



PokerStars Game #59939212200:  Hold'em No Limit ($0.50/$1.00) - 2009/07/01 0:34:08 ET
Table 'LmXQK9xy3awB+qsPzI21Mw' 2-max Seat #2 is the button
Seat 1: NYi6JFscYNrofSXy4sM+Yw ($209.50 in chips)
Seat 2: TME8GvochpQAo8cmJwWmvA ($33.45 in chips)
TME8GvochpQAo8cmJwWmvA: posts small blind $0.50
NYi6JFscYNrofSXy4sM+Yw: posts big blind $1
*** HOLE CARDS ***
TME8GvochpQAo8cmJwWmvA: calls $0.50
NYi6JFscYNrofSXy4sM+Yw: checks
*** FLOP *** [3s 3c Th]
NYi6JFscYNrofSXy4sM+Yw: bets $1
TME8GvochpQAo8cmJwWmvA: folds
NYi6JFscYNrofSXy4sM+Yw collected $1.90 from pot
NYi6JFscYNrofSXy4sM+Yw: doesn't show hand
*** SUMMARY ***
Total pot $2 | Rake $0.10
Board [3s 3c Th]
Seat 1: NYi6JFscYNrofSXy4sM+Yw (big blind) collected ($1.90)
Seat 2: TME8GvochpQAo8cmJwWmvA (button) (small blind) folded on the Flop



PokerStars Game #59939213524:  Hold'em No Limit ($0.50/$1.00) - 2009/07/01 0:34:09 ET
Table '/RZcOwpZpHQ+OwPwjsbnRw' 6-max Seat #4 is the button
Seat 1: Zboa6dColKGHBjLPUakZjw ($52.70 in chips)
Seat 2: dHC9PH9hdH3Ad2TD8ZxX0Q ($45.25 in chips)
Seat 3: OigyyiK+tTj1APPIAUmXDA ($71.15 in chips)
Seat 4: j7NIOHLZk7V2o9fOioO5ug ($116.90 in chips)
Seat 5: wx3sQGkVi2x9wJXuWNHPBw ($200.15 in chips)
Seat 6: XOIf9W+VAxhZqN+SYoyMKA ($246.30 in chips)
wx3sQGkVi2x9wJXuWNHPBw: posts small blind $0.50
XOIf9W+VAxhZqN+SYoyMKA: posts big blind $1
*** HOLE CARDS ***
Zboa6dColKGHBjLPUakZjw: folds
dHC9PH9hdH3Ad2TD8ZxX0Q: calls $1
OigyyiK+tTj1APPIAUmXDA: folds
j7NIOHLZk7V2o9fOioO5ug: folds
wx3sQGkVi2x9wJXuWNHPBw: folds
XOIf9W+VAxhZqN+SYoyMKA: checks
*** FLOP *** [3d 2h Jc]
XOIf9W+VAxhZqN+SYoyMKA: checks
dHC9PH9hdH3Ad2TD8ZxX0Q: bets $8
XOIf9W+VAxhZqN+SYoyMKA: raises $8 to $16
dHC9PH9hdH3Ad2TD8ZxX0Q: raises $8 to $24
XOIf9W+VAxhZqN+SYoyMKA: raises $104 to $128
dHC9PH9hdH3Ad2TD8ZxX0Q: calls $20.25 and is all-in
*** TURN *** [3d 2h Jc] [3c]
*** RIVER *** [3d 2h Jc 3c] [9h]
*** SHOW DOWN ***
XOIf9W+VAxhZqN+SYoyMKA: shows [3h Js] (a full house, Threes full of Jacks)
dHC9PH9hdH3Ad2TD8ZxX0Q: mucks hand
XOIf9W+VAxhZqN+SYoyMKA collected $88 from pot
dHC9PH9hdH3Ad2TD8ZxX0Q leaves the table
*** SUMMARY ***
Total pot $91 | Rake $3
Board [3d 2h Jc 3c 9h]
Seat 1: Zboa6dColKGHBjLPUakZjw folded before Flop (didn't bet)
Seat 2: dHC9PH9hdH3Ad2TD8ZxX0Q mucked
Seat 3: OigyyiK+tTj1APPIAUmXDA folded before Flop (didn't bet)
Seat 4: j7NIOHLZk7V2o9fOioO5ug (button) folded before Flop (didn't bet)
Seat 5: wx3sQGkVi2x9wJXuWNHPBw (small blind) folded before Flop
Seat 6: XOIf9W+VAxhZqN+SYoyMKA (big blind) showed [3h Js] and won ($88) with a full house, Threes full of Jacks



PokerStars Game #59939216666:  Hold'em No Limit ($0.50/$1.00) - 2009/07/01 0:34:14 ET
Table 'QBLDswtHe7Ml0HwAdcMhlw' 2-max Seat #1 is the button
Seat 1: hdNlhiCwI533uwvvTTfC9Q ($100.50 in chips)
Seat 2: rAtTyvrJ8f1LaUh2O5U4nA ($37.40 in chips)
hdNlhiCwI533uwvvTTfC9Q: posts small blind $0.50
rAtTyvrJ8f1LaUh2O5U4nA: posts big blind $1
*** HOLE CARDS ***
hdNlhiCwI533uwvvTTfC9Q: raises $2 to $3
rAtTyvrJ8f1LaUh2O5U4nA: calls $2
*** FLOP *** [3h 3d Ad]
rAtTyvrJ8f1LaUh2O5U4nA: checks
hdNlhiCwI533uwvvTTfC9Q: bets $4
rAtTyvrJ8f1LaUh2O5U4nA: folds
rAtTyvrJ8f1LaUh2O5U4nA is sitting out
rAtTyvrJ8f1LaUh2O5U4nA leaves the table
hdNlhiCwI533uwvvTTfC9Q collected $5.70 from pot
hdNlhiCwI533uwvvTTfC9Q: doesn't show hand
*** SUMMARY ***
Total pot $6 | Rake $0.30
Board [3h 3d Ad]
Seat 1: hdNlhiCwI533uwvvTTfC9Q (button) (small blind) collected ($5.70)
Seat 2: rAtTyvrJ8f1LaUh2O5U4nA (big blind) folded on the Flop



PokerStars Game #59939217140:  Hold'em No Limit ($0.50/$1.00) - 2009/07/01 0:34:15 ET
Table 'GxCPo/gd3OSthkYrAxJngg' 6-max Seat #3 is the button
Seat 1: sH8BpAFP+jGFxCgVpD1Lew ($275.45 in chips)
Seat 2: YExX2paeIHrmfIwV1ivM/w ($63.70 in chips)
Seat 3: o6plE+MSW4XFNTeONe16xg ($34.10 in chips)
Seat 4: YMJG+F++3Aj6P8dAWda5fw ($108.65 in chips)
Seat 5: G5ZSSN6RSON3gkNvk/SmYg ($103.20 in chips)
Seat 6: sS9IXedL3MiRmpVXhAILhw ($102.45 in chips)
YMJG+F++3Aj6P8dAWda5fw: posts small blind $0.50
G5ZSSN6RSON3gkNvk/SmYg: posts big blind $1
*** HOLE CARDS ***
sS9IXedL3MiRmpVXhAILhw: folds
sH8BpAFP+jGFxCgVpD1Lew: raises $2 to $3
YExX2paeIHrmfIwV1ivM/w: folds
o6plE+MSW4XFNTeONe16xg: folds
YMJG+F++3Aj6P8dAWda5fw: folds
G5ZSSN6RSON3gkNvk/SmYg: folds
sH8BpAFP+jGFxCgVpD1Lew collected $2.50 from pot
*** SUMMARY ***
Total pot $2.50 | Rake $0
Seat 1: sH8BpAFP+jGFxCgVpD1Lew collected ($2.50)
Seat 2: YExX2paeIHrmfIwV1ivM/w folded before Flop (didn't bet)
Seat 3: o6plE+MSW4XFNTeONe16xg (button) folded before Flop (didn't bet)
Seat 4: YMJG+F++3Aj6P8dAWda5fw (small blind) folded before Flop
Seat 5: G5ZSSN6RSON3gkNvk/SmYg (big blind) folded before Flop
Seat 6: sS9IXedL3MiRmpVXhAILhw folded before Flop (didn't bet)



PokerStars Game #59939218070:  Hold'em No Limit ($0.50/$1.00) - 2009/07/01 0:34:16 ET
Table 'tLrtq7gDzxEvckNAI1OS5Q' 6-max Seat #2 is the button
Seat 1: GisIe1kcC9q/xV6ifsTjgA ($174.15 in chips)
Seat 2: QHvTZcrKe6+maWUfVjP29Q ($101 in chips)
Seat 5: OGMLOcTNYZXZU81au7ztUw ($160.60 in chips)
Seat 6: XUk5GQsfNFpHvaToDZ0rZA ($43.75 in chips)
TPZ+m9x+lwoKpv7TMfAUWA will be allowed to play after the button
OGMLOcTNYZXZU81au7ztUw: posts small blind $0.50
XUk5GQsfNFpHvaToDZ0rZA: posts big blind $1
*** HOLE CARDS ***
GisIe1kcC9q/xV6ifsTjgA: folds
QHvTZcrKe6+maWUfVjP29Q: raises $2 to $3
OGMLOcTNYZXZU81au7ztUw: folds
XUk5GQsfNFpHvaToDZ0rZA: calls $2
*** FLOP *** [8c 5d 7h]
XUk5GQsfNFpHvaToDZ0rZA: checks
QHvTZcrKe6+maWUfVjP29Q: bets $5
XUk5GQsfNFpHvaToDZ0rZA: raises $9 to $14
QHvTZcrKe6+maWUfVjP29Q: raises $79 to $93
XUk5GQsfNFpHvaToDZ0rZA: calls $26.75 and is all-in
*** TURN *** [8c 5d 7h] [Td]
*** RIVER *** [8c 5d 7h Td] [3h]
*** SHOW DOWN ***
XUk5GQsfNFpHvaToDZ0rZA: shows [7d 7c] (three of a kind, Sevens)
QHvTZcrKe6+maWUfVjP29Q: mucks hand
XUk5GQsfNFpHvaToDZ0rZA collected $86 from pot
*** SUMMARY ***
Total pot $88 | Rake $2
Board [8c 5d 7h Td 3h]
Seat 1: GisIe1kcC9q/xV6ifsTjgA folded before Flop (didn't bet)
Seat 2: QHvTZcrKe6+maWUfVjP29Q (button) mucked
Seat 5: OGMLOcTNYZXZU81au7ztUw (small blind) folded before Flop
Seat 6: XUk5GQsfNFpHvaToDZ0rZA (big blind) showed [7d 7c] and won ($86) with three of a kind, Sevens



PokerStars Game #59939218746:  Hold'em No Limit ($0.50/$1.00) - 2009/07/01 0:34:17 ET
Table 'VOs36P6NW+QyXeQ1B62kmA' 6-max Seat #6 is the button
Seat 1: AdLVjddOzm+sRNo1Bc3S6Q ($138.65 in chips)
Seat 2: KpnW5CcJ4Mg6MeclfKmLrw ($113.30 in chips)
Seat 3: TSuRyAHnUPCFjP7Z0rEE0w ($100 in chips)
Seat 4: w02zQzNydODiyV9THKgo9w ($38.65 in chips)
Seat 5: X7GlkHF+lkbarCLuZ4Uf0w ($24.25 in chips)
Seat 6: 6tvjsJrdmWg+g7FVrMnzXA ($64.60 in chips)
AdLVjddOzm+sRNo1Bc3S6Q: posts small blind $0.50
KpnW5CcJ4Mg6MeclfKmLrw: posts big blind $1
*** HOLE CARDS ***
TSuRyAHnUPCFjP7Z0rEE0w: folds
w02zQzNydODiyV9THKgo9w: calls $1
X7GlkHF+lkbarCLuZ4Uf0w: folds
6tvjsJrdmWg+g7FVrMnzXA: raises $2 to $3
AdLVjddOzm+sRNo1Bc3S6Q: folds
KpnW5CcJ4Mg6MeclfKmLrw: folds
w02zQzNydODiyV9THKgo9w: calls $2
*** FLOP *** [9s Qs 8h]
w02zQzNydODiyV9THKgo9w: checks
6tvjsJrdmWg+g7FVrMnzXA: checks
*** TURN *** [9s Qs 8h] [Tc]
w02zQzNydODiyV9THKgo9w: bets $4
6tvjsJrdmWg+g7FVrMnzXA: folds
w02zQzNydODiyV9THKgo9w collected $7.15 from pot
*** SUMMARY ***
Total pot $7.50 | Rake $0.35
Board [9s Qs 8h Tc]
Seat 1: AdLVjddOzm+sRNo1Bc3S6Q (small blind) folded before Flop
Seat 2: KpnW5CcJ4Mg6MeclfKmLrw (big blind) folded before Flop
Seat 3: TSuRyAHnUPCFjP7Z0rEE0w folded before Flop (didn't bet)
Seat 4: w02zQzNydODiyV9THKgo9w collected ($7.15)
Seat 5: X7GlkHF+lkbarCLuZ4Uf0w folded before Flop (didn't bet)
Seat 6: 6tvjsJrdmWg+g7FVrMnzXA (button) folded on the Turn



PokerStars Game #59939218470:  Hold'em No Limit ($0.50/$1.00) - 2009/07/01 0:34:17 ET
Table 'uNlePsyMIqzM691Xkrlk6Q' 9-max Seat #8 is the button
Seat 1: bLbSOSmSOnqE0iTcH/5dxA ($102.50 in chips)
Seat 2: +OqpStnt0FqbCfyHAWaLbg ($67.45 in chips)
Seat 3: h7qXkU57Bb8ZuPwMyxR8Ug ($20 in chips)
Seat 4: TZcz9MEWDA+WydgGruqqbw ($104.65 in chips)
Seat 6: uMPEfCcGCfsxmy53tVUMug ($113.10 in chips)
Seat 7: w6cw9nzN7AvkkHBVVjykoQ ($44.90 in chips)
Seat 8: OsLmX3x/19szSV115TpL/Q ($41.95 in chips)
Seat 9: vR4IO10geOgvTW+LAUBv/A ($111.75 in chips)
vR4IO10geOgvTW+LAUBv/A: posts small blind $0.50
bLbSOSmSOnqE0iTcH/5dxA: posts big blind $1
3obndzTJ6fECz8+wWhMd1w: sits out
*** HOLE CARDS ***
+OqpStnt0FqbCfyHAWaLbg: folds
h7qXkU57Bb8ZuPwMyxR8Ug: folds
TZcz9MEWDA+WydgGruqqbw: folds
uMPEfCcGCfsxmy53tVUMug: folds
w6cw9nzN7AvkkHBVVjykoQ: folds
OsLmX3x/19szSV115TpL/Q: folds
vR4IO10geOgvTW+LAUBv/A: folds
bLbSOSmSOnqE0iTcH/5dxA collected $1 from pot
bLbSOSmSOnqE0iTcH/5dxA: doesn't show hand
*** SUMMARY ***
Total pot $1 | Rake $0
Seat 1: bLbSOSmSOnqE0iTcH/5dxA (big blind) collected ($1)
Seat 2: +OqpStnt0FqbCfyHAWaLbg folded before Flop (didn't bet)
Seat 3: h7qXkU57Bb8ZuPwMyxR8Ug folded before Flop (didn't bet)
Seat 4: TZcz9MEWDA+WydgGruqqbw folded before Flop (didn't bet)
Seat 6: uMPEfCcGCfsxmy53tVUMug folded before Flop (didn't bet)
Seat 7: w6cw9nzN7AvkkHBVVjykoQ folded before Flop (didn't bet)
Seat 8: OsLmX3x/19szSV115TpL/Q (button) folded before Flop (didn't bet)
Seat 9: vR4IO10geOgvTW+LAUBv/A (small blind) folded before Flop



PokerStars Game #59939219276:  Hold'em No Limit ($0.50/$1.00) - 2009/07/01 0:34:18 ET
Table 'Zka9tv1yilg0MvXWPQrShg' 9-max Seat #3 is the button
Seat 1: TZcz9MEWDA+WydgGruqqbw ($115.35 in chips)
Seat 2: rR1qGAf9Q9RYorKYWH3VKw ($25.70 in chips)
Seat 3: gUUvmqdVlmvpal6B8nYrmg ($101 in chips)
Seat 4: CTOae+JLIGfwfXvhqHkP2w ($162.65 in chips)
Seat 5: /zy+DB4S5fUQUSfZWFzYGw ($141.50 in chips)
Seat 6: rY8wPoax1lS+HUY+I0FZDw ($137.65 in chips)
Seat 7: p1SafS90nb3Uft5LB0NkHw ($17 in chips)
Seat 8: bL+QVeDcuEdzMGAGg2XJHg ($119.10 in chips)
Seat 9: 6daxhj43mWj04MOPTOmaYA ($96 in chips)
CTOae+JLIGfwfXvhqHkP2w: posts small blind $0.50
/zy+DB4S5fUQUSfZWFzYGw: posts big blind $1
*** HOLE CARDS ***
rY8wPoax1lS+HUY+I0FZDw: calls $1
p1SafS90nb3Uft5LB0NkHw: folds
bL+QVeDcuEdzMGAGg2XJHg: folds
6daxhj43mWj04MOPTOmaYA: calls $1
TZcz9MEWDA+WydgGruqqbw: folds
rR1qGAf9Q9RYorKYWH3VKw: folds
gUUvmqdVlmvpal6B8nYrmg: folds
CTOae+JLIGfwfXvhqHkP2w: calls $0.50
/zy+DB4S5fUQUSfZWFzYGw: checks
*** FLOP *** [3d 8s 9d]
CTOae+JLIGfwfXvhqHkP2w: checks
/zy+DB4S5fUQUSfZWFzYGw: checks
rY8wPoax1lS+HUY+I0FZDw: checks
6daxhj43mWj04MOPTOmaYA: bets $2
CTOae+JLIGfwfXvhqHkP2w: calls $2
/zy+DB4S5fUQUSfZWFzYGw: calls $2
rY8wPoax1lS+HUY+I0FZDw: calls $2
*** TURN *** [3d 8s 9d] [4c]
CTOae+JLIGfwfXvhqHkP2w: checks
/zy+DB4S5fUQUSfZWFzYGw: checks
rY8wPoax1lS+HUY+I0FZDw: checks
6daxhj43mWj04MOPTOmaYA: checks
*** RIVER *** [3d 8s 9d 4c] [Qd]
CTOae+JLIGfwfXvhqHkP2w: checks
/zy+DB4S5fUQUSfZWFzYGw: checks
rY8wPoax1lS+HUY+I0FZDw: bets $3
6daxhj43mWj04MOPTOmaYA: folds
CTOae+JLIGfwfXvhqHkP2w: calls $3
/zy+DB4S5fUQUSfZWFzYGw: folds
*** SHOW DOWN ***
rY8wPoax1lS+HUY+I0FZDw: shows [Ad 6d] (a flush, Ace high)
CTOae+JLIGfwfXvhqHkP2w: mucks hand
rY8wPoax1lS+HUY+I0FZDw collected $17.15 from pot
*** SUMMARY ***
Total pot $18 | Rake $0.85
Board [3d 8s 9d 4c Qd]
Seat 1: TZcz9MEWDA+WydgGruqqbw folded before Flop (didn't bet)
Seat 2: rR1qGAf9Q9RYorKYWH3VKw folded before Flop (didn't bet)
Seat 3: gUUvmqdVlmvpal6B8nYrmg (button) folded before Flop (didn't bet)
Seat 4: CTOae+JLIGfwfXvhqHkP2w (small blind) mucked
Seat 5: /zy+DB4S5fUQUSfZWFzYGw (big blind) folded on the River
Seat 6: rY8wPoax1lS+HUY+I0FZDw showed [Ad 6d] and won ($17.15) with a flush, Ace high
Seat 7: p1SafS90nb3Uft5LB0NkHw folded before Flop (didn't bet)
Seat 8: bL+QVeDcuEdzMGAGg2XJHg folded before Flop (didn't bet)
Seat 9: 6daxhj43mWj04MOPTOmaYA folded on the River



PokerStars Game #59939220360:  Hold'em No Limit ($0.50/$1.00) - 2009/07/01 0:34:20 ET
Table 'LmXQK9xy3awB+qsPzI21Mw' 2-max Seat #1 is the button
Seat 1: NYi6JFscYNrofSXy4sM+Yw ($210.40 in chips)
Seat 2: TME8GvochpQAo8cmJwWmvA ($32.45 in chips)
NYi6JFscYNrofSXy4sM+Yw: posts small blind $0.50
TME8GvochpQAo8cmJwWmvA: posts big blind $1
*** HOLE CARDS ***
NYi6JFscYNrofSXy4sM+Yw: raises $2 to $3
TME8GvochpQAo8cmJwWmvA: calls $2
*** FLOP *** [Ad 9h Qs]
TME8GvochpQAo8cmJwWmvA: checks
NYi6JFscYNrofSXy4sM+Yw: bets $2
TME8GvochpQAo8cmJwWmvA: folds
NYi6JFscYNrofSXy4sM+Yw collected $5.70 from pot
*** SUMMARY ***
Total pot $6 | Rake $0.30
Board [Ad 9h Qs]
Seat 1: NYi6JFscYNrofSXy4sM+Yw (button) (small blind) collected ($5.70)
Seat 2: TME8GvochpQAo8cmJwWmvA (big blind) folded on the Flop



PokerStars Game #59939221828:  Hold'em No Limit ($0.50/$1.00) - 2009/07/01 0:34:22 ET
Table 'kS0cTQAEi+fdUlJP2gQYvw' 9-max Seat #5 is the button
Seat 1: c/9X4zftzphFxYtxp5kp9w ($39.40 in chips)
Seat 3: 3obndzTJ6fECz8+wWhMd1w ($19 in chips)
Seat 4: TZcz9MEWDA+WydgGruqqbw ($100 in chips)
Seat 5: 2rxrMrE7koO2BNxvop/0+g ($51.55 in chips)
Seat 6: yAbu2QsRPVcjPbqlf/jDxw ($100 in chips)
Seat 7: Ffa7Nj4X5fddtROP01hfQg ($111.20 in chips)
Seat 8: qTymj6ZQ8ZoFi6fINJZb3w ($80.50 in chips)
Seat 9: y8Qb94e81yI/g0saQ6gU5g ($56.75 in chips)
yAbu2QsRPVcjPbqlf/jDxw: posts small blind $0.50
Ffa7Nj4X5fddtROP01hfQg: posts big blind $1
*** HOLE CARDS ***
qTymj6ZQ8ZoFi6fINJZb3w: folds
y8Qb94e81yI/g0saQ6gU5g: folds
c/9X4zftzphFxYtxp5kp9w: folds
3obndzTJ6fECz8+wWhMd1w: folds
TZcz9MEWDA+WydgGruqqbw: folds
2rxrMrE7koO2BNxvop/0+g: calls $1
yAbu2QsRPVcjPbqlf/jDxw: folds
Ffa7Nj4X5fddtROP01hfQg: raises $1 to $2
2rxrMrE7koO2BNxvop/0+g: calls $1
*** FLOP *** [8c 5d 2d]
Ffa7Nj4X5fddtROP01hfQg: bets $2
2rxrMrE7koO2BNxvop/0+g: calls $2
*** TURN *** [8c 5d 2d] [3d]
Ffa7Nj4X5fddtROP01hfQg: bets $1
2rxrMrE7koO2BNxvop/0+g: calls $1
*** RIVER *** [8c 5d 2d 3d] [9c]
Ffa7Nj4X5fddtROP01hfQg: checks
2rxrMrE7koO2BNxvop/0+g: bets $2
Ffa7Nj4X5fddtROP01hfQg: folds
2rxrMrE7koO2BNxvop/0+g collected $10 from pot
*** SUMMARY ***
Total pot $10.50 | Rake $0.50
Board [8c 5d 2d 3d 9c]
Seat 1: c/9X4zftzphFxYtxp5kp9w folded before Flop (didn't bet)
Seat 3: 3obndzTJ6fECz8+wWhMd1w folded before Flop (didn't bet)
Seat 4: TZcz9MEWDA+WydgGruqqbw folded before Flop (didn't bet)
Seat 5: 2rxrMrE7koO2BNxvop/0+g (button) collected ($10)
Seat 6: yAbu2QsRPVcjPbqlf/jDxw (small blind) folded before Flop
Seat 7: Ffa7Nj4X5fddtROP01hfQg (big blind) folded on the River
Seat 8: qTymj6ZQ8ZoFi6fINJZb3w folded before Flop (didn't bet)
Seat 9: y8Qb94e81yI/g0saQ6gU5g folded before Flop (didn't bet)



PokerStars Game #59939222792:  Hold'em No Limit ($0.50/$1.00) - 2009/07/01 0:34:23 ET
Table 'cBDNutyLBKEk9+ptwsKmTw' 6-max Seat #3 is the button
Seat 1: xAU6q2/cwmby2sxmA8VcmA ($100 in chips)
Seat 2: Gy1fd4JyD1aNBFFlOGzbJQ ($26.20 in chips)
Seat 3: G5ZSSN6RSON3gkNvk/SmYg ($110.40 in chips)
Seat 5: OGMLOcTNYZXZU81au7ztUw ($141.45 in chips)
Seat 6: NqVlOSH2lp+pp/TK3vvK5g ($40.30 in chips)
OGMLOcTNYZXZU81au7ztUw: posts small blind $0.50
NqVlOSH2lp+pp/TK3vvK5g: posts big blind $1
*** HOLE CARDS ***
xAU6q2/cwmby2sxmA8VcmA: folds
Gy1fd4JyD1aNBFFlOGzbJQ: folds
G5ZSSN6RSON3gkNvk/SmYg: folds
OGMLOcTNYZXZU81au7ztUw: folds
NqVlOSH2lp+pp/TK3vvK5g collected $1 from pot
*** SUMMARY ***
Total pot $1 | Rake $0
Seat 1: xAU6q2/cwmby2sxmA8VcmA folded before Flop (didn't bet)
Seat 2: Gy1fd4JyD1aNBFFlOGzbJQ folded before Flop (didn't bet)
Seat 3: G5ZSSN6RSON3gkNvk/SmYg (button) folded before Flop (didn't bet)
Seat 5: OGMLOcTNYZXZU81au7ztUw (small blind) folded before Flop
Seat 6: NqVlOSH2lp+pp/TK3vvK5g (big blind) collected ($1)



PokerStars Game #59939222496:  Hold'em No Limit ($0.50/$1.00) - 2009/07/01 0:34:23 ET
Table 'U9zqzC8f3oTJ2ShXFgSSOA' 6-max Seat #4 is the button
Seat 1: tS9JHB1h+FQ++qu8RwRNgg ($34.50 in chips)
Seat 2: U2CWBTv29qdCbj8RNF2sIw ($96.50 in chips)
Seat 3: yfXek8iJ7O4CFyqXrtGcfg ($34.05 in chips)
Seat 4: 33q95we0Etwgrm6guQGncw ($72.15 in chips)
Seat 5: KfwW5us6tydK81NYTtK1gw ($310.25 in chips)
Seat 6: aIxzFKdtpDSkUePKZy/niQ ($53.50 in chips)
KfwW5us6tydK81NYTtK1gw: posts small blind $0.50
aIxzFKdtpDSkUePKZy/niQ: posts big blind $1
*** HOLE CARDS ***
tS9JHB1h+FQ++qu8RwRNgg: folds
U2CWBTv29qdCbj8RNF2sIw said, "ha"
U2CWBTv29qdCbj8RNF2sIw: folds
yfXek8iJ7O4CFyqXrtGcfg: raises $2 to $3
33q95we0Etwgrm6guQGncw: folds
KfwW5us6tydK81NYTtK1gw: folds
aIxzFKdtpDSkUePKZy/niQ: calls $2
*** FLOP *** [8h Jh 7s]
aIxzFKdtpDSkUePKZy/niQ: checks
yfXek8iJ7O4CFyqXrtGcfg: bets $5
aIxzFKdtpDSkUePKZy/niQ: calls $5
*** TURN *** [8h Jh 7s] [Qs]
aIxzFKdtpDSkUePKZy/niQ: checks
yfXek8iJ7O4CFyqXrtGcfg: checks
*** RIVER *** [8h Jh 7s Qs] [7h]
aIxzFKdtpDSkUePKZy/niQ: bets $5
yfXek8iJ7O4CFyqXrtGcfg: calls $5
*** SHOW DOWN ***
aIxzFKdtpDSkUePKZy/niQ: shows [5h Kh] (a flush, King high)
yfXek8iJ7O4CFyqXrtGcfg: mucks hand
aIxzFKdtpDSkUePKZy/niQ collected $25.25 from pot
*** SUMMARY ***
Total pot $26.50 | Rake $1.25
Board [8h Jh 7s Qs 7h]
Seat 1: tS9JHB1h+FQ++qu8RwRNgg folded before Flop (didn't bet)
Seat 2: U2CWBTv29qdCbj8RNF2sIw folded before Flop (didn't bet)
Seat 3: yfXek8iJ7O4CFyqXrtGcfg mucked
Seat 4: 33q95we0Etwgrm6guQGncw (button) folded before Flop (didn't bet)
Seat 5: KfwW5us6tydK81NYTtK1gw (small blind) folded before Flop
Seat 6: aIxzFKdtpDSkUePKZy/niQ (big blind) showed [5h Kh] and won ($25.25) with a flush, King high



PokerStars Game #59939222742:  Hold'em No Limit ($0.50/$1.00) - 2009/07/01 0:34:23 ET
Table 'N2bNCDHL96aCQDvZIh+yQQ' 6-max Seat #5 is the button
Seat 1: iHo1oDbrEVJ8nEGdaPrICw ($143.50 in chips)
Seat 2: KpnW5CcJ4Mg6MeclfKmLrw ($111.90 in chips)
Seat 3: Qy/UBNbD2HaA0Ogxg8Sf3w ($111.80 in chips)
Seat 4: uCqEjnxh2/vFBjKYkfTOkw ($151.90 in chips)
Seat 5: rHlMOfR7kpQQxe+PFQz0xQ ($30 in chips)
Seat 6: TSuRyAHnUPCFjP7Z0rEE0w ($100 in chips)
TSuRyAHnUPCFjP7Z0rEE0w: posts small blind $0.50
iHo1oDbrEVJ8nEGdaPrICw: posts big blind $1
*** HOLE CARDS ***
KpnW5CcJ4Mg6MeclfKmLrw: folds
Qy/UBNbD2HaA0Ogxg8Sf3w: folds
uCqEjnxh2/vFBjKYkfTOkw: folds
rHlMOfR7kpQQxe+PFQz0xQ: folds
TSuRyAHnUPCFjP7Z0rEE0w: folds
iHo1oDbrEVJ8nEGdaPrICw collected $1 from pot
iHo1oDbrEVJ8nEGdaPrICw: doesn't show hand
*** SUMMARY ***
Total pot $1 | Rake $0
Seat 1: iHo1oDbrEVJ8nEGdaPrICw (big blind) collected ($1)
Seat 2: KpnW5CcJ4Mg6MeclfKmLrw folded before Flop (didn't bet)
Seat 3: Qy/UBNbD2HaA0Ogxg8Sf3w folded before Flop (didn't bet)
Seat 4: uCqEjnxh2/vFBjKYkfTOkw folded before Flop (didn't bet)
Seat 5: rHlMOfR7kpQQxe+PFQz0xQ (button) folded before Flop (didn't bet)
Seat 6: TSuRyAHnUPCFjP7Z0rEE0w (small blind) folded before Flop



PokerStars Game #59939225988:  Hold'em No Limit ($0.50/$1.00) - 2009/07/01 0:34:28 ET
Table 'QSIig7BLMc9wY/rgBechzw' 6-max Seat #4 is the button
Seat 1: uuA9hpFU17U5/t4cvpbpBg ($27.05 in chips)
Seat 2: 0WjiuIT7/EolY1oOx1ngeA ($124.75 in chips)
Seat 3: +W6OnF033KNM2xH0fGj98Q ($100 in chips)
Seat 4: +uSzP8Jwnw7sKfQ4s66b7w ($30 in chips)
Seat 5: bvU2ZjpVnszLCFVeWbxePg ($115.90 in chips)
Seat 6: KpnW5CcJ4Mg6MeclfKmLrw ($188.60 in chips)
bvU2ZjpVnszLCFVeWbxePg: posts small blind $0.50
KpnW5CcJ4Mg6MeclfKmLrw: posts big blind $1
*** HOLE CARDS ***
uuA9hpFU17U5/t4cvpbpBg: folds
0WjiuIT7/EolY1oOx1ngeA: folds
+W6OnF033KNM2xH0fGj98Q: folds
+uSzP8Jwnw7sKfQ4s66b7w: folds
bvU2ZjpVnszLCFVeWbxePg: folds
KpnW5CcJ4Mg6MeclfKmLrw collected $1 from pot
KpnW5CcJ4Mg6MeclfKmLrw: doesn't show hand
*** SUMMARY ***
Total pot $1 | Rake $0
Seat 1: uuA9hpFU17U5/t4cvpbpBg folded before Flop (didn't bet)
Seat 2: 0WjiuIT7/EolY1oOx1ngeA folded before Flop (didn't bet)
Seat 3: +W6OnF033KNM2xH0fGj98Q folded before Flop (didn't bet)
Seat 4: +uSzP8Jwnw7sKfQ4s66b7w (button) folded before Flop (didn't bet)
Seat 5: bvU2ZjpVnszLCFVeWbxePg (small blind) folded before Flop
Seat 6: KpnW5CcJ4Mg6MeclfKmLrw (big blind) collected ($1)



PokerStars Game #59939225692:  Hold'em No Limit ($0.50/$1.00) - 2009/07/01 0:34:28 ET
Table 'SQLOQoANiHscJ8AL7zffbw' 9-max Seat #9 is the button
Seat 1: jPTRd6SpCp4xqAy2XQiTOw ($107.30 in chips)
Seat 2: /zy+DB4S5fUQUSfZWFzYGw ($277.85 in chips)
Seat 3: 0eFnow7+D7veCYQ+CG9FFw ($74.15 in chips)
Seat 4: N9n5Wc3s35DpCrOAUUNAaQ ($96.35 in chips)
Seat 5: L9njYvloJ1NdXjP8edHEAg ($109.05 in chips)
Seat 6: p5UKaxVobvptF0ANhR/q1A ($155.50 in chips)
Seat 7: bJckevFOcg//s0qyMQI6sQ ($102.05 in chips)
Seat 9: qJr25HAtvv1w/7IBvjMM3g ($239.75 in chips)
jPTRd6SpCp4xqAy2XQiTOw: posts small blind $0.50
/zy+DB4S5fUQUSfZWFzYGw: posts big blind $1
barrelproof7: sits out
*** HOLE CARDS ***
0eFnow7+D7veCYQ+CG9FFw: folds
N9n5Wc3s35DpCrOAUUNAaQ: folds
L9njYvloJ1NdXjP8edHEAg: folds
p5UKaxVobvptF0ANhR/q1A: raises $2 to $3
bJckevFOcg//s0qyMQI6sQ: folds
qJr25HAtvv1w/7IBvjMM3g: folds
jPTRd6SpCp4xqAy2XQiTOw: calls $2.50
/zy+DB4S5fUQUSfZWFzYGw: folds
*** FLOP *** [5h Kh Td]
jPTRd6SpCp4xqAy2XQiTOw: checks
p5UKaxVobvptF0ANhR/q1A: bets $4
jPTRd6SpCp4xqAy2XQiTOw: calls $4
*** TURN *** [5h Kh Td] [2h]
jPTRd6SpCp4xqAy2XQiTOw: checks
p5UKaxVobvptF0ANhR/q1A: checks
*** RIVER *** [5h Kh Td 2h] [3d]
jPTRd6SpCp4xqAy2XQiTOw: bets $15
p5UKaxVobvptF0ANhR/q1A: folds
jPTRd6SpCp4xqAy2XQiTOw collected $14.30 from pot
*** SUMMARY ***
Total pot $15 | Rake $0.70
Board [5h Kh Td 2h 3d]
Seat 1: jPTRd6SpCp4xqAy2XQiTOw (small blind) collected ($14.30)
Seat 2: /zy+DB4S5fUQUSfZWFzYGw (big blind) folded before Flop
Seat 3: 0eFnow7+D7veCYQ+CG9FFw folded before Flop (didn't bet)
Seat 4: N9n5Wc3s35DpCrOAUUNAaQ folded before Flop (didn't bet)
Seat 5: L9njYvloJ1NdXjP8edHEAg folded before Flop (didn't bet)
Seat 6: p5UKaxVobvptF0ANhR/q1A folded on the River
Seat 7: bJckevFOcg//s0qyMQI6sQ folded before Flop (didn't bet)
Seat 9: qJr25HAtvv1w/7IBvjMM3g (button) folded before Flop (didn't bet)



PokerStars Game #59939227672:  Hold'em No Limit ($0.50/$1.00) - 2009/07/01 0:34:31 ET
Table '+cA8mcmhaedZ7YcrDdhmeQ' 6-max Seat #1 is the button
Seat 1: lsLuWlcPA3Rh7kJVLzMh0Q ($307.25 in chips)
Seat 2: RqgF7gRoKgRNW8Zoi1ty4A ($101.50 in chips)
Seat 3: 7H5WkGzGvsv56y1iaqHvRg ($39 in chips)
Seat 4: LjL3AIERHn559yyW1mTUYQ ($162 in chips)
Seat 6: YfsTQsY/fxb+YqbdclTHuw ($34.40 in chips)
RqgF7gRoKgRNW8Zoi1ty4A: posts small blind $0.50
7H5WkGzGvsv56y1iaqHvRg: posts big blind $1
iHo1oDbrEVJ8nEGdaPrICw: sits out
*** HOLE CARDS ***
LjL3AIERHn559yyW1mTUYQ: raises $2 to $3
YfsTQsY/fxb+YqbdclTHuw: folds
lsLuWlcPA3Rh7kJVLzMh0Q: calls $3
RqgF7gRoKgRNW8Zoi1ty4A: folds
7H5WkGzGvsv56y1iaqHvRg: calls $2
*** FLOP *** [Qc Jh 6c]
7H5WkGzGvsv56y1iaqHvRg: bets $3
LjL3AIERHn559yyW1mTUYQ: folds
lsLuWlcPA3Rh7kJVLzMh0Q: folds
7H5WkGzGvsv56y1iaqHvRg collected $9.05 from pot
*** SUMMARY ***
Total pot $9.50 | Rake $0.45
Board [Qc Jh 6c]
Seat 1: lsLuWlcPA3Rh7kJVLzMh0Q (button) folded on the Flop
Seat 2: RqgF7gRoKgRNW8Zoi1ty4A (small blind) folded before Flop
Seat 3: 7H5WkGzGvsv56y1iaqHvRg (big blind) collected ($9.05)
Seat 4: LjL3AIERHn559yyW1mTUYQ folded on the Flop
Seat 6: YfsTQsY/fxb+YqbdclTHuw folded before Flop (didn't bet)



PokerStars Game #59939228124:  Hold'em No Limit ($0.50/$1.00) - 2009/07/01 0:34:31 ET
Table 'eU3bWpDDg3Z+9R4m4iVmog' 6-max Seat #3 is the button
Seat 1: TSuRyAHnUPCFjP7Z0rEE0w ($171.20 in chips)
Seat 2: 8CAoOzhmB8n3nRFf3V4BTg ($124.95 in chips)
Seat 3: U6tnjwZRpTnM+YkqkCjwyQ ($169.65 in chips)
Seat 4: GDVIsbEJ/DOJsMKE4Asz0A ($101.10 in chips)
Seat 5: AdLVjddOzm+sRNo1Bc3S6Q ($100 in chips)
Seat 6: hpxXcmRkXXI9HE5+5/j/0Q ($103.50 in chips)
GDVIsbEJ/DOJsMKE4Asz0A: posts small blind $0.50
AdLVjddOzm+sRNo1Bc3S6Q: posts big blind $1
*** HOLE CARDS ***
hpxXcmRkXXI9HE5+5/j/0Q: folds
TSuRyAHnUPCFjP7Z0rEE0w: folds
8CAoOzhmB8n3nRFf3V4BTg: folds
U6tnjwZRpTnM+YkqkCjwyQ: folds
GDVIsbEJ/DOJsMKE4Asz0A: folds
AdLVjddOzm+sRNo1Bc3S6Q collected $1 from pot
AdLVjddOzm+sRNo1Bc3S6Q: doesn't show hand
*** SUMMARY ***
Total pot $1 | Rake $0
Seat 1: TSuRyAHnUPCFjP7Z0rEE0w folded before Flop (didn't bet)
Seat 2: 8CAoOzhmB8n3nRFf3V4BTg folded before Flop (didn't bet)
Seat 3: U6tnjwZRpTnM+YkqkCjwyQ (button) folded before Flop (didn't bet)
Seat 4: GDVIsbEJ/DOJsMKE4Asz0A (small blind) folded before Flop
Seat 5: AdLVjddOzm+sRNo1Bc3S6Q (big blind) collected ($1)
Seat 6: hpxXcmRkXXI9HE5+5/j/0Q folded before Flop (didn't bet)



PokerStars Game #59939228684:  Hold'em No Limit ($0.50/$1.00) - 2009/07/01 0:34:32 ET
Table 'LmXQK9xy3awB+qsPzI21Mw' 2-max Seat #2 is the button
Seat 1: NYi6JFscYNrofSXy4sM+Yw ($213.10 in chips)
Seat 2: TME8GvochpQAo8cmJwWmvA ($29.45 in chips)
TME8GvochpQAo8cmJwWmvA: posts small blind $0.50
NYi6JFscYNrofSXy4sM+Yw: posts big blind $1
*** HOLE CARDS ***
TME8GvochpQAo8cmJwWmvA: raises $1 to $2
NYi6JFscYNrofSXy4sM+Yw: calls $1
*** FLOP *** [Js 3c Ks]
NYi6JFscYNrofSXy4sM+Yw: checks
TME8GvochpQAo8cmJwWmvA: bets $3
NYi6JFscYNrofSXy4sM+Yw: folds
TME8GvochpQAo8cmJwWmvA collected $3.80 from pot
TME8GvochpQAo8cmJwWmvA: doesn't show hand
*** SUMMARY ***
Total pot $4 | Rake $0.20
Board [Js 3c Ks]
Seat 1: NYi6JFscYNrofSXy4sM+Yw (big blind) folded on the Flop
Seat 2: TME8GvochpQAo8cmJwWmvA (button) (small blind) collected ($3.80)



PokerStars Game #59939229012:  Hold'em No Limit ($0.50/$1.00) - 2009/07/01 0:34:33 ET
Table 'pHrhryH8jPNdQfY62f8v+g' 6-max Seat #4 is the button
Seat 1: BdbmJTZZ47quA9vUWwXtlw ($113.60 in chips)
Seat 2: RqgF7gRoKgRNW8Zoi1ty4A ($115 in chips)
Seat 4: wenbG7TaM3H7h5kn78OFNw ($58.30 in chips)
Seat 5: r1/R7y0Ortgoz4lccgW8VA ($16.15 in chips)
Seat 6: xAU6q2/cwmby2sxmA8VcmA ($102.80 in chips)
r1/R7y0Ortgoz4lccgW8VA: posts small blind $0.50
xAU6q2/cwmby2sxmA8VcmA: posts big blind $1
*** HOLE CARDS ***
BdbmJTZZ47quA9vUWwXtlw: folds
RqgF7gRoKgRNW8Zoi1ty4A: folds
wenbG7TaM3H7h5kn78OFNw: folds
r1/R7y0Ortgoz4lccgW8VA: folds
xAU6q2/cwmby2sxmA8VcmA collected $1 from pot
*** SUMMARY ***
Total pot $1 | Rake $0
Seat 1: BdbmJTZZ47quA9vUWwXtlw folded before Flop (didn't bet)
Seat 2: RqgF7gRoKgRNW8Zoi1ty4A folded before Flop (didn't bet)
Seat 4: wenbG7TaM3H7h5kn78OFNw (button) folded before Flop (didn't bet)
Seat 5: r1/R7y0Ortgoz4lccgW8VA (small blind) folded before Flop
Seat 6: xAU6q2/cwmby2sxmA8VcmA (big blind) collected ($1)



PokerStars Game #59939230596:  Hold'em No Limit ($0.50/$1.00) - 2009/07/01 0:34:35 ET
Table 'vs/5jr6ciwjVQ5+Soc+u2A' 6-max Seat #2 is the button
Seat 1: 3yN2jRjZ+glIaWtGMmKOrA ($21.55 in chips)
Seat 2: XOIf9W+VAxhZqN+SYoyMKA ($118.65 in chips)
Seat 3: G5ZSSN6RSON3gkNvk/SmYg ($100 in chips)
Seat 4: KpnW5CcJ4Mg6MeclfKmLrw ($109.80 in chips)
Seat 5: 7Vc9JmGFQwMRh5Tj9ui5Lw ($106.40 in chips)
Seat 6: QHvTZcrKe6+maWUfVjP29Q ($100 in chips)
G5ZSSN6RSON3gkNvk/SmYg: posts small blind $0.50
KpnW5CcJ4Mg6MeclfKmLrw: posts big blind $1
*** HOLE CARDS ***
7Vc9JmGFQwMRh5Tj9ui5Lw: folds
QHvTZcrKe6+maWUfVjP29Q: folds
3yN2jRjZ+glIaWtGMmKOrA: folds
XOIf9W+VAxhZqN+SYoyMKA: folds
G5ZSSN6RSON3gkNvk/SmYg: folds
KpnW5CcJ4Mg6MeclfKmLrw collected $1 from pot
KpnW5CcJ4Mg6MeclfKmLrw: doesn't show hand
*** SUMMARY ***
Total pot $1 | Rake $0
Seat 1: 3yN2jRjZ+glIaWtGMmKOrA folded before Flop (didn't bet)
Seat 2: XOIf9W+VAxhZqN+SYoyMKA (button) folded before Flop (didn't bet)
Seat 3: G5ZSSN6RSON3gkNvk/SmYg (small blind) folded before Flop
Seat 4: KpnW5CcJ4Mg6MeclfKmLrw (big blind) collected ($1)
Seat 5: 7Vc9JmGFQwMRh5Tj9ui5Lw folded before Flop (didn't bet)
Seat 6: QHvTZcrKe6+maWUfVjP29Q folded before Flop (didn't bet)



PokerStars Game #59939232442:  Hold'em No Limit ($0.50/$1.00) - 2009/07/01 0:34:38 ET
Table 'uNlePsyMIqzM691Xkrlk6Q' 9-max Seat #9 is the button
Seat 1: bLbSOSmSOnqE0iTcH/5dxA ($103 in chips)
Seat 2: +OqpStnt0FqbCfyHAWaLbg ($67.45 in chips)
Seat 3: h7qXkU57Bb8ZuPwMyxR8Ug ($20 in chips)
Seat 4: TZcz9MEWDA+WydgGruqqbw ($104.65 in chips)
Seat 6: uMPEfCcGCfsxmy53tVUMug ($113.10 in chips)
Seat 7: w6cw9nzN7AvkkHBVVjykoQ ($44.90 in chips)
Seat 8: OsLmX3x/19szSV115TpL/Q ($41.95 in chips)
Seat 9: vR4IO10geOgvTW+LAUBv/A ($111.25 in chips)
bLbSOSmSOnqE0iTcH/5dxA: posts small blind $0.50
+OqpStnt0FqbCfyHAWaLbg: posts big blind $1
3obndzTJ6fECz8+wWhMd1w: sits out
*** HOLE CARDS ***
h7qXkU57Bb8ZuPwMyxR8Ug: folds
TZcz9MEWDA+WydgGruqqbw: folds
uMPEfCcGCfsxmy53tVUMug: folds
w6cw9nzN7AvkkHBVVjykoQ: folds
OsLmX3x/19szSV115TpL/Q: calls $1
vR4IO10geOgvTW+LAUBv/A: raises $3 to $4
bLbSOSmSOnqE0iTcH/5dxA: folds
+OqpStnt0FqbCfyHAWaLbg: folds
OsLmX3x/19szSV115TpL/Q: calls $3
*** FLOP *** [Kc Th 8s]
OsLmX3x/19szSV115TpL/Q: checks
vR4IO10geOgvTW+LAUBv/A: bets $4
OsLmX3x/19szSV115TpL/Q: folds
vR4IO10geOgvTW+LAUBv/A collected $9.05 from pot
vR4IO10geOgvTW+LAUBv/A: doesn't show hand
*** SUMMARY ***
Total pot $9.50 | Rake $0.45
Board [Kc Th 8s]
Seat 1: bLbSOSmSOnqE0iTcH/5dxA (small blind) folded before Flop
Seat 2: +OqpStnt0FqbCfyHAWaLbg (big blind) folded before Flop
Seat 3: h7qXkU57Bb8ZuPwMyxR8Ug folded before Flop (didn't bet)
Seat 4: TZcz9MEWDA+WydgGruqqbw folded before Flop (didn't bet)
Seat 6: uMPEfCcGCfsxmy53tVUMug folded before Flop (didn't bet)
Seat 7: w6cw9nzN7AvkkHBVVjykoQ folded before Flop (didn't bet)
Seat 8: OsLmX3x/19szSV115TpL/Q folded on the Flop
Seat 9: vR4IO10geOgvTW+LAUBv/A (button) collected ($9.05)



PokerStars Game #59939234278:  Hold'em No Limit ($0.50/$1.00) - 2009/07/01 0:34:41 ET
Table 'MUPc8FEpe/nR0BKSeReX6Q' 6-max Seat #6 is the button
Seat 1: YsLQ3BAvgQHWXMAv3Wv6Hg ($100 in chips)
Seat 2: xAU6q2/cwmby2sxmA8VcmA ($109 in chips)
Seat 3: wx3sQGkVi2x9wJXuWNHPBw ($234.05 in chips)
Seat 4: ZA1bp6g8IwtTxkUE4eCjDQ ($126.85 in chips)
Seat 5: UBZQqpnJZdTYYY1FTb0rLA ($100 in chips)
Seat 6: oxnw0GLLpFanjhGkxfRSqA ($51.10 in chips)
YsLQ3BAvgQHWXMAv3Wv6Hg: posts small blind $0.50
xAU6q2/cwmby2sxmA8VcmA: posts big blind $1
*** HOLE CARDS ***
wx3sQGkVi2x9wJXuWNHPBw: folds
ZA1bp6g8IwtTxkUE4eCjDQ: folds
UBZQqpnJZdTYYY1FTb0rLA: folds
oxnw0GLLpFanjhGkxfRSqA: raises $2 to $3
YsLQ3BAvgQHWXMAv3Wv6Hg: folds
xAU6q2/cwmby2sxmA8VcmA: calls $2
*** FLOP *** [3s Kc Jc]
xAU6q2/cwmby2sxmA8VcmA: checks
oxnw0GLLpFanjhGkxfRSqA: checks
*** TURN *** [3s Kc Jc] [5s]
xAU6q2/cwmby2sxmA8VcmA: bets $4
oxnw0GLLpFanjhGkxfRSqA: folds
xAU6q2/cwmby2sxmA8VcmA collected $6.20 from pot
xAU6q2/cwmby2sxmA8VcmA: doesn't show hand
*** SUMMARY ***
Total pot $6.50 | Rake $0.30
Board [3s Kc Jc 5s]
Seat 1: YsLQ3BAvgQHWXMAv3Wv6Hg (small blind) folded before Flop
Seat 2: xAU6q2/cwmby2sxmA8VcmA (big blind) collected ($6.20)
Seat 3: wx3sQGkVi2x9wJXuWNHPBw folded before Flop (didn't bet)
Seat 4: ZA1bp6g8IwtTxkUE4eCjDQ folded before Flop (didn't bet)
Seat 5: UBZQqpnJZdTYYY1FTb0rLA folded before Flop (didn't bet)
Seat 6: oxnw0GLLpFanjhGkxfRSqA (button) folded on the Turn



PokerStars Game #59939235026:  Hold'em No Limit ($0.50/$1.00) - 2009/07/01 0:34:42 ET
Table 'rmZfTK+oSebeUPJNbWhdAA' 6-max Seat #1 is the button
Seat 1: xAU6q2/cwmby2sxmA8VcmA ($100 in chips)
Seat 2: OigyyiK+tTj1APPIAUmXDA ($125.05 in chips)
Seat 3: 9yjOzGERLaEZS8CZ6YNHFg ($115.40 in chips)
Seat 4: OGMLOcTNYZXZU81au7ztUw ($130.85 in chips)
Seat 5: +xW7QemQU0Fxs+4TnqBRow ($100 in chips)
Seat 6: j7NIOHLZk7V2o9fOioO5ug ($113 in chips)
OigyyiK+tTj1APPIAUmXDA: posts small blind $0.50
9yjOzGERLaEZS8CZ6YNHFg: posts big blind $1
*** HOLE CARDS ***
OGMLOcTNYZXZU81au7ztUw: folds
+xW7QemQU0Fxs+4TnqBRow: folds
j7NIOHLZk7V2o9fOioO5ug: raises $2 to $3
xAU6q2/cwmby2sxmA8VcmA: calls $3
OigyyiK+tTj1APPIAUmXDA: folds
9yjOzGERLaEZS8CZ6YNHFg: folds
*** FLOP *** [8c 9c Th]
j7NIOHLZk7V2o9fOioO5ug: bets $5
OigyyiK+tTj1APPIAUmXDA leaves the table
xAU6q2/cwmby2sxmA8VcmA: calls $5
*** TURN *** [8c 9c Th] [8s]
j7NIOHLZk7V2o9fOioO5ug: checks
xAU6q2/cwmby2sxmA8VcmA: bets $12
j7NIOHLZk7V2o9fOioO5ug: calls $12
*** RIVER *** [8c 9c Th 8s] [Tc]
j7NIOHLZk7V2o9fOioO5ug: checks
xAU6q2/cwmby2sxmA8VcmA: checks
*** SHOW DOWN ***
j7NIOHLZk7V2o9fOioO5ug: shows [Jc Ks] (two pair, Tens and Eights)
xAU6q2/cwmby2sxmA8VcmA: mucks hand
j7NIOHLZk7V2o9fOioO5ug collected $39.50 from pot
*** SUMMARY ***
Total pot $41.50 | Rake $2
Board [8c 9c Th 8s Tc]
Seat 1: xAU6q2/cwmby2sxmA8VcmA (button) mucked
Seat 2: OigyyiK+tTj1APPIAUmXDA (small blind) folded before Flop
Seat 3: 9yjOzGERLaEZS8CZ6YNHFg (big blind) folded before Flop
Seat 4: OGMLOcTNYZXZU81au7ztUw folded before Flop (didn't bet)
Seat 5: +xW7QemQU0Fxs+4TnqBRow folded before Flop (didn't bet)
Seat 6: j7NIOHLZk7V2o9fOioO5ug showed [Jc Ks] and won ($39.50) with two pair, Tens and Eights



PokerStars Game #59939234902:  Hold'em No Limit ($0.50/$1.00) - 2009/07/01 0:34:42 ET
Table 'QSIig7BLMc9wY/rgBechzw' 6-max Seat #5 is the button
Seat 1: uuA9hpFU17U5/t4cvpbpBg ($27.05 in chips)
Seat 2: 0WjiuIT7/EolY1oOx1ngeA ($124.75 in chips)
Seat 3: +W6OnF033KNM2xH0fGj98Q ($100 in chips)
Seat 4: +uSzP8Jwnw7sKfQ4s66b7w ($30 in chips)
Seat 5: bvU2ZjpVnszLCFVeWbxePg ($115.40 in chips)
Seat 6: KpnW5CcJ4Mg6MeclfKmLrw ($189.10 in chips)
KpnW5CcJ4Mg6MeclfKmLrw: posts small blind $0.50
uuA9hpFU17U5/t4cvpbpBg: posts big blind $1
*** HOLE CARDS ***
0WjiuIT7/EolY1oOx1ngeA: raises $2 to $3
+W6OnF033KNM2xH0fGj98Q: folds
+uSzP8Jwnw7sKfQ4s66b7w: calls $3
bvU2ZjpVnszLCFVeWbxePg: folds
KpnW5CcJ4Mg6MeclfKmLrw: folds
uuA9hpFU17U5/t4cvpbpBg: calls $2
*** FLOP *** [Tc 4s 5d]
uuA9hpFU17U5/t4cvpbpBg: checks
0WjiuIT7/EolY1oOx1ngeA: bets $10
+uSzP8Jwnw7sKfQ4s66b7w: raises $17 to $27 and is all-in
uuA9hpFU17U5/t4cvpbpBg: folds
0WjiuIT7/EolY1oOx1ngeA: calls $17
*** TURN *** [Tc 4s 5d] [Jh]
*** RIVER *** [Tc 4s 5d Jh] [Ah]
*** SHOW DOWN ***
0WjiuIT7/EolY1oOx1ngeA: shows [As Qh] (a pair of Aces)
+uSzP8Jwnw7sKfQ4s66b7w: shows [5c 5h] (three of a kind, Fives)
+uSzP8Jwnw7sKfQ4s66b7w collected $60.50 from pot
*** SUMMARY ***
Total pot $63.50 | Rake $3
Board [Tc 4s 5d Jh Ah]
Seat 1: uuA9hpFU17U5/t4cvpbpBg (big blind) folded on the Flop
Seat 2: 0WjiuIT7/EolY1oOx1ngeA showed [As Qh] and lost with a pair of Aces
Seat 3: +W6OnF033KNM2xH0fGj98Q folded before Flop (didn't bet)
Seat 4: +uSzP8Jwnw7sKfQ4s66b7w showed [5c 5h] and won ($60.50) with three of a kind, Fives
Seat 5: bvU2ZjpVnszLCFVeWbxePg (button) folded before Flop (didn't bet)
Seat 6: KpnW5CcJ4Mg6MeclfKmLrw (small blind) folded before Flop



PokerStars Game #59939235660:  Hold'em No Limit ($0.50/$1.00) - 2009/07/01 0:34:43 ET
Table 'O96CPOtvMBWP6kzuYDfdFA' 6-max Seat #6 is the button
Seat 1: 6alLXQIITA2EZ/lBeym8Dw ($100 in chips)
Seat 2: sc/HX9smXU5kObrOWIYO5g ($36.40 in chips)
Seat 4: KOG8rG51mOvIoY96zF3kvw ($167.75 in chips)
Seat 5: wRxiu9OJzvvN84OYWW9jxQ ($133.10 in chips)
Seat 6: xNKcQzD9+/iHmtJn4vYq9w ($140.15 in chips)
6alLXQIITA2EZ/lBeym8Dw: posts small blind $0.50
sc/HX9smXU5kObrOWIYO5g: posts big blind $1
*** HOLE CARDS ***
KOG8rG51mOvIoY96zF3kvw: folds
KOG8rG51mOvIoY96zF3kvw leaves the table
wRxiu9OJzvvN84OYWW9jxQ: calls $1
xNKcQzD9+/iHmtJn4vYq9w: folds
6alLXQIITA2EZ/lBeym8Dw: folds
sc/HX9smXU5kObrOWIYO5g: raises $3 to $4
wRxiu9OJzvvN84OYWW9jxQ: calls $3
*** FLOP *** [Kc 5c As]
sc/HX9smXU5kObrOWIYO5g: checks
wRxiu9OJzvvN84OYWW9jxQ: checks
*** TURN *** [Kc 5c As] [4h]
sc/HX9smXU5kObrOWIYO5g: bets $3
wRxiu9OJzvvN84OYWW9jxQ: folds
sc/HX9smXU5kObrOWIYO5g collected $8.10 from pot
*** SUMMARY ***
Total pot $8.50 | Rake $0.40
Board [Kc 5c As 4h]
Seat 1: 6alLXQIITA2EZ/lBeym8Dw (small blind) folded before Flop
Seat 2: sc/HX9smXU5kObrOWIYO5g (big blind) collected ($8.10)
Seat 4: KOG8rG51mOvIoY96zF3kvw folded before Flop (didn't bet)
Seat 5: wRxiu9OJzvvN84OYWW9jxQ folded on the Turn
Seat 6: xNKcQzD9+/iHmtJn4vYq9w (button) folded before Flop (didn't bet)



PokerStars Game #59939237304:  Hold'em No Limit ($0.50/$1.00) - 2009/07/01 0:34:45 ET
Table '7Nl0ffnjeK44/vmeexh3MQ' 9-max Seat #5 is the button
Seat 1: s7D3Y+k4Cj4D1cXHv7oj+Q ($97.45 in chips)
Seat 2: kiakSwxX0e64PwYGAPQvLw ($33.85 in chips)
Seat 3: vR4IO10geOgvTW+LAUBv/A ($100 in chips)
Seat 4: bLbSOSmSOnqE0iTcH/5dxA ($100 in chips)
Seat 5: bL+QVeDcuEdzMGAGg2XJHg ($100.40 in chips)
Seat 6: FVs16t7GgfWgQWt4JxsObQ ($21.95 in chips)
Seat 8: zanka7aAZkigmZpfopXxxA ($228.20 in chips)
Seat 9: ouwUBGRKnKK9uhn1G4Lf+A ($99.50 in chips)
FVs16t7GgfWgQWt4JxsObQ: posts small blind $0.50
knewtTmBc4Tc0z/5tAABYQ: is sitting out
zanka7aAZkigmZpfopXxxA: posts big blind $1
*** HOLE CARDS ***
ouwUBGRKnKK9uhn1G4Lf+A: folds
s7D3Y+k4Cj4D1cXHv7oj+Q: folds
kiakSwxX0e64PwYGAPQvLw: raises $1 to $2
vR4IO10geOgvTW+LAUBv/A: folds
bLbSOSmSOnqE0iTcH/5dxA: folds
bL+QVeDcuEdzMGAGg2XJHg: raises $8 to $10
FVs16t7GgfWgQWt4JxsObQ: folds
zanka7aAZkigmZpfopXxxA: folds
kiakSwxX0e64PwYGAPQvLw: folds
bL+QVeDcuEdzMGAGg2XJHg collected $5.50 from pot
bL+QVeDcuEdzMGAGg2XJHg: doesn't show hand
*** SUMMARY ***
Total pot $5.50 | Rake $0
Seat 1: s7D3Y+k4Cj4D1cXHv7oj+Q folded before Flop (didn't bet)
Seat 2: kiakSwxX0e64PwYGAPQvLw folded before Flop
Seat 3: vR4IO10geOgvTW+LAUBv/A folded before Flop (didn't bet)
Seat 4: bLbSOSmSOnqE0iTcH/5dxA folded before Flop (didn't bet)
Seat 5: bL+QVeDcuEdzMGAGg2XJHg (button) collected ($5.50)
Seat 6: FVs16t7GgfWgQWt4JxsObQ (small blind) folded before Flop
Seat 8: zanka7aAZkigmZpfopXxxA (big blind) folded before Flop
Seat 9: ouwUBGRKnKK9uhn1G4Lf+A folded before Flop (didn't bet)



PokerStars Game #59939236928:  Hold'em No Limit ($0.50/$1.00) - 2009/07/01 0:34:45 ET
Table 'N2bNCDHL96aCQDvZIh+yQQ' 6-max Seat #6 is the button
Seat 1: iHo1oDbrEVJ8nEGdaPrICw ($144 in chips)
Seat 2: KpnW5CcJ4Mg6MeclfKmLrw ($111.90 in chips)
Seat 3: Qy/UBNbD2HaA0Ogxg8Sf3w ($111.80 in chips)
Seat 4: uCqEjnxh2/vFBjKYkfTOkw ($151.90 in chips)
Seat 5: rHlMOfR7kpQQxe+PFQz0xQ ($30 in chips)
Seat 6: TSuRyAHnUPCFjP7Z0rEE0w ($100 in chips)
iHo1oDbrEVJ8nEGdaPrICw: posts small blind $0.50
KpnW5CcJ4Mg6MeclfKmLrw: posts big blind $1
*** HOLE CARDS ***
Qy/UBNbD2HaA0Ogxg8Sf3w: raises $3 to $4
uCqEjnxh2/vFBjKYkfTOkw: raises $8 to $12
rHlMOfR7kpQQxe+PFQz0xQ: folds
TSuRyAHnUPCFjP7Z0rEE0w: calls $12
iHo1oDbrEVJ8nEGdaPrICw: folds
KpnW5CcJ4Mg6MeclfKmLrw: folds
Qy/UBNbD2HaA0Ogxg8Sf3w: calls $8
*** FLOP *** [8h 7s Jd]
Qy/UBNbD2HaA0Ogxg8Sf3w: checks
uCqEjnxh2/vFBjKYkfTOkw: bets $25
TSuRyAHnUPCFjP7Z0rEE0w: folds
Qy/UBNbD2HaA0Ogxg8Sf3w: folds
uCqEjnxh2/vFBjKYkfTOkw collected $35.65 from pot
uCqEjnxh2/vFBjKYkfTOkw: doesn't show hand
*** SUMMARY ***
Total pot $37.50 | Rake $1.85
Board [8h 7s Jd]
Seat 1: iHo1oDbrEVJ8nEGdaPrICw (small blind) folded before Flop
Seat 2: KpnW5CcJ4Mg6MeclfKmLrw (big blind) folded before Flop
Seat 3: Qy/UBNbD2HaA0Ogxg8Sf3w folded on the Flop
Seat 4: uCqEjnxh2/vFBjKYkfTOkw collected ($35.65)
Seat 5: rHlMOfR7kpQQxe+PFQz0xQ folded before Flop (didn't bet)
Seat 6: TSuRyAHnUPCFjP7Z0rEE0w (button) folded on the Flop



PokerStars Game #59939238668:  Hold'em No Limit ($0.50/$1.00) - 2009/07/01 0:34:47 ET
Table 'LmXQK9xy3awB+qsPzI21Mw' 2-max Seat #1 is the button
Seat 1: NYi6JFscYNrofSXy4sM+Yw ($211.10 in chips)
Seat 2: TME8GvochpQAo8cmJwWmvA ($31.25 in chips)
NYi6JFscYNrofSXy4sM+Yw: posts small blind $0.50
TME8GvochpQAo8cmJwWmvA: posts big blind $1
*** HOLE CARDS ***
NYi6JFscYNrofSXy4sM+Yw: raises $2 to $3
TME8GvochpQAo8cmJwWmvA: calls $2
*** FLOP *** [5h Ks 9h]
TME8GvochpQAo8cmJwWmvA: checks
NYi6JFscYNrofSXy4sM+Yw: bets $2
TME8GvochpQAo8cmJwWmvA: folds
NYi6JFscYNrofSXy4sM+Yw collected $5.70 from pot
*** SUMMARY ***
Total pot $6 | Rake $0.30
Board [5h Ks 9h]
Seat 1: NYi6JFscYNrofSXy4sM+Yw (button) (small blind) collected ($5.70)
Seat 2: TME8GvochpQAo8cmJwWmvA (big blind) folded on the Flop



PokerStars Game #59939242312:  Hold'em No Limit ($0.50/$1.00) - 2009/07/01 0:34:53 ET
Table 'vs/5jr6ciwjVQ5+Soc+u2A' 6-max Seat #3 is the button
Seat 1: 3yN2jRjZ+glIaWtGMmKOrA ($21.55 in chips)
Seat 2: XOIf9W+VAxhZqN+SYoyMKA ($118.65 in chips)
Seat 3: G5ZSSN6RSON3gkNvk/SmYg ($100 in chips)
Seat 4: KpnW5CcJ4Mg6MeclfKmLrw ($110.30 in chips)
Seat 5: 7Vc9JmGFQwMRh5Tj9ui5Lw ($106.40 in chips)
Seat 6: QHvTZcrKe6+maWUfVjP29Q ($100 in chips)
KpnW5CcJ4Mg6MeclfKmLrw: posts small blind $0.50
7Vc9JmGFQwMRh5Tj9ui5Lw: posts big blind $1
*** HOLE CARDS ***
QHvTZcrKe6+maWUfVjP29Q: folds
3yN2jRjZ+glIaWtGMmKOrA: raises $20.55 to $21.55 and is all-in
XOIf9W+VAxhZqN+SYoyMKA: folds
G5ZSSN6RSON3gkNvk/SmYg: folds
KpnW5CcJ4Mg6MeclfKmLrw: folds
7Vc9JmGFQwMRh5Tj9ui5Lw: folds
3yN2jRjZ+glIaWtGMmKOrA collected $2.50 from pot
*** SUMMARY ***
Total pot $2.50 | Rake $0
Seat 1: 3yN2jRjZ+glIaWtGMmKOrA collected ($2.50)
Seat 2: XOIf9W+VAxhZqN+SYoyMKA folded before Flop (didn't bet)
Seat 3: G5ZSSN6RSON3gkNvk/SmYg (button) folded before Flop (didn't bet)
Seat 4: KpnW5CcJ4Mg6MeclfKmLrw (small blind) folded before Flop
Seat 5: 7Vc9JmGFQwMRh5Tj9ui5Lw (big blind) folded before Flop
Seat 6: QHvTZcrKe6+maWUfVjP29Q folded before Flop (didn't bet)



PokerStars Game #59939242100:  Hold'em No Limit ($0.50/$1.00) - 2009/07/01 0:34:53 ET
Table '/FUb199IViHMJHi5YWmeuQ' 9-max Seat #2 is the button
Seat 1: TZcz9MEWDA+WydgGruqqbw ($101.85 in chips)
Seat 2: FL3MrLspcF23LYvC4ipBOA ($136.20 in chips)
Seat 3: qN483QJ1NvHbdIZB7J4ARw ($62.70 in chips)
Seat 4: qheQay5YvP2DMAb3OUSxtw ($107.30 in chips)
Seat 6: ccFf7Q4z1cTGQmeoYiWEfw ($51.95 in chips)
Seat 7: bLbSOSmSOnqE0iTcH/5dxA ($100 in chips)
Seat 8: QIWvt0R766g8KfH0vl1s0A ($32.90 in chips)
Seat 9: knewtTmBc4Tc0z/5tAABYQ ($155.15 in chips)
qN483QJ1NvHbdIZB7J4ARw: posts small blind $0.50
qheQay5YvP2DMAb3OUSxtw: posts big blind $1
BbWpm6CYaA1D8P5EYEEwkQ: sits out
*** HOLE CARDS ***
ccFf7Q4z1cTGQmeoYiWEfw: raises $1 to $2
bLbSOSmSOnqE0iTcH/5dxA: folds
QIWvt0R766g8KfH0vl1s0A: folds
knewtTmBc4Tc0z/5tAABYQ: folds
TZcz9MEWDA+WydgGruqqbw: folds
FL3MrLspcF23LYvC4ipBOA: folds
qN483QJ1NvHbdIZB7J4ARw: calls $1.50
qheQay5YvP2DMAb3OUSxtw: folds
*** FLOP *** [7s 6d 9c]
qN483QJ1NvHbdIZB7J4ARw: checks
ccFf7Q4z1cTGQmeoYiWEfw: bets $3
qN483QJ1NvHbdIZB7J4ARw: calls $3
*** TURN *** [7s 6d 9c] [3h]
qN483QJ1NvHbdIZB7J4ARw: checks
ccFf7Q4z1cTGQmeoYiWEfw: bets $5
qN483QJ1NvHbdIZB7J4ARw: calls $5
*** RIVER *** [7s 6d 9c 3h] [2c]
qN483QJ1NvHbdIZB7J4ARw: checks
ccFf7Q4z1cTGQmeoYiWEfw: checks
*** SHOW DOWN ***
qN483QJ1NvHbdIZB7J4ARw: shows [Jc Jd] (a pair of Jacks)
ccFf7Q4z1cTGQmeoYiWEfw: mucks hand
qN483QJ1NvHbdIZB7J4ARw collected $20 from pot
*** SUMMARY ***
Total pot $21 | Rake $1
Board [7s 6d 9c 3h 2c]
Seat 1: TZcz9MEWDA+WydgGruqqbw folded before Flop (didn't bet)
Seat 2: FL3MrLspcF23LYvC4ipBOA (button) folded before Flop (didn't bet)
Seat 3: qN483QJ1NvHbdIZB7J4ARw (small blind) showed [Jc Jd] and won ($20) with a pair of Jacks
Seat 4: qheQay5YvP2DMAb3OUSxtw (big blind) folded before Flop
Seat 6: ccFf7Q4z1cTGQmeoYiWEfw mucked
Seat 7: bLbSOSmSOnqE0iTcH/5dxA folded before Flop (didn't bet)
Seat 8: QIWvt0R766g8KfH0vl1s0A folded before Flop (didn't bet)
Seat 9: knewtTmBc4Tc0z/5tAABYQ folded before Flop (didn't bet)



PokerStars Game #59939242860:  Hold'em No Limit ($0.50/$1.00) - 2009/07/01 0:34:54 ET
Table '6YvsYDPNIDx2v5z3bJnwZQ' 9-max Seat #5 is the button
Seat 1: Ogn4JDV3mp4ZDKO49IFzKA ($14.50 in chips)
Seat 2: 35DmRulmD2MgzT6Bbt6/2w ($51.95 in chips)
Seat 3: negfosHnGOZXSHpWDRKyBQ ($19.30 in chips)
Seat 4: kEr5NYB+JIG5+szcYMr6hA ($45 in chips)
Seat 5: mBRWbnUl8diyBO1qTJaNzw ($160.70 in chips)
Seat 6: uMPEfCcGCfsxmy53tVUMug ($102.40 in chips)
Seat 7: boixc27eqTYA1p0tUdMuBQ ($114 in chips)
Seat 8: PSFxpXgPedVZyHSu2Zhb7Q ($50.25 in chips)
Seat 9: jDwhY1kCdc6EkAHbT7PJMQ ($105.60 in chips)
uMPEfCcGCfsxmy53tVUMug: posts small blind $0.50
boixc27eqTYA1p0tUdMuBQ: posts big blind $1
*** HOLE CARDS ***
PSFxpXgPedVZyHSu2Zhb7Q: folds
jDwhY1kCdc6EkAHbT7PJMQ: folds
Ogn4JDV3mp4ZDKO49IFzKA: folds
35DmRulmD2MgzT6Bbt6/2w: folds
negfosHnGOZXSHpWDRKyBQ: folds
kEr5NYB+JIG5+szcYMr6hA: folds
mBRWbnUl8diyBO1qTJaNzw: folds
uMPEfCcGCfsxmy53tVUMug: folds
boixc27eqTYA1p0tUdMuBQ collected $1 from pot
boixc27eqTYA1p0tUdMuBQ: doesn't show hand
*** SUMMARY ***
Total pot $1 | Rake $0
Seat 1: Ogn4JDV3mp4ZDKO49IFzKA folded before Flop (didn't bet)
Seat 2: 35DmRulmD2MgzT6Bbt6/2w folded before Flop (didn't bet)
Seat 3: negfosHnGOZXSHpWDRKyBQ folded before Flop (didn't bet)
Seat 4: kEr5NYB+JIG5+szcYMr6hA folded before Flop (didn't bet)
Seat 5: mBRWbnUl8diyBO1qTJaNzw (button) folded before Flop (didn't bet)
Seat 6: uMPEfCcGCfsxmy53tVUMug (small blind) folded before Flop
Seat 7: boixc27eqTYA1p0tUdMuBQ (big blind) collected ($1)
Seat 8: PSFxpXgPedVZyHSu2Zhb7Q folded before Flop (didn't bet)
Seat 9: jDwhY1kCdc6EkAHbT7PJMQ folded before Flop (didn't bet)



PokerStars Game #59939243838:  Hold'em No Limit ($0.50/$1.00) - 2009/07/01 0:34:55 ET
Table 'cBDNutyLBKEk9+ptwsKmTw' 6-max Seat #5 is the button
Seat 1: xAU6q2/cwmby2sxmA8VcmA ($100 in chips)
Seat 2: Gy1fd4JyD1aNBFFlOGzbJQ ($26.20 in chips)
Seat 3: G5ZSSN6RSON3gkNvk/SmYg ($110.40 in chips)
Seat 5: OGMLOcTNYZXZU81au7ztUw ($140.95 in chips)
Seat 6: NqVlOSH2lp+pp/TK3vvK5g ($40.80 in chips)
NqVlOSH2lp+pp/TK3vvK5g: posts small blind $0.50
xAU6q2/cwmby2sxmA8VcmA: posts big blind $1
*** HOLE CARDS ***
Gy1fd4JyD1aNBFFlOGzbJQ: raises $2 to $3
G5ZSSN6RSON3gkNvk/SmYg: folds
OGMLOcTNYZXZU81au7ztUw: folds
NqVlOSH2lp+pp/TK3vvK5g: calls $2.50
xAU6q2/cwmby2sxmA8VcmA: folds
*** FLOP *** [2h Js 2c]
NqVlOSH2lp+pp/TK3vvK5g: checks
Gy1fd4JyD1aNBFFlOGzbJQ: bets $3
NqVlOSH2lp+pp/TK3vvK5g: folds
Gy1fd4JyD1aNBFFlOGzbJQ collected $6.65 from pot
*** SUMMARY ***
Total pot $7 | Rake $0.35
Board [2h Js 2c]
Seat 1: xAU6q2/cwmby2sxmA8VcmA (big blind) folded before Flop
Seat 2: Gy1fd4JyD1aNBFFlOGzbJQ collected ($6.65)
Seat 3: G5ZSSN6RSON3gkNvk/SmYg folded before Flop (didn't bet)
Seat 5: OGMLOcTNYZXZU81au7ztUw (button) folded before Flop (didn't bet)
Seat 6: NqVlOSH2lp+pp/TK3vvK5g (small blind) folded on the Flop



PokerStars Game #59939244750:  Hold'em No Limit ($0.50/$1.00) - 2009/07/01 0:34:56 ET
Table 'eU3bWpDDg3Z+9R4m4iVmog' 6-max Seat #4 is the button
Seat 1: TSuRyAHnUPCFjP7Z0rEE0w ($171.20 in chips)
Seat 2: 8CAoOzhmB8n3nRFf3V4BTg ($124.95 in chips)
Seat 3: U6tnjwZRpTnM+YkqkCjwyQ ($169.65 in chips)
Seat 4: GDVIsbEJ/DOJsMKE4Asz0A ($100.60 in chips)
Seat 5: AdLVjddOzm+sRNo1Bc3S6Q ($100.50 in chips)
Seat 6: hpxXcmRkXXI9HE5+5/j/0Q ($103.50 in chips)
AdLVjddOzm+sRNo1Bc3S6Q: posts small blind $0.50
hpxXcmRkXXI9HE5+5/j/0Q: posts big blind $1
*** HOLE CARDS ***
TSuRyAHnUPCFjP7Z0rEE0w: folds
8CAoOzhmB8n3nRFf3V4BTg: folds
U6tnjwZRpTnM+YkqkCjwyQ: folds
GDVIsbEJ/DOJsMKE4Asz0A: folds
AdLVjddOzm+sRNo1Bc3S6Q: folds
hpxXcmRkXXI9HE5+5/j/0Q collected $1 from pot
hpxXcmRkXXI9HE5+5/j/0Q: doesn't show hand
*** SUMMARY ***
Total pot $1 | Rake $0
Seat 1: TSuRyAHnUPCFjP7Z0rEE0w folded before Flop (didn't bet)
Seat 2: 8CAoOzhmB8n3nRFf3V4BTg folded before Flop (didn't bet)
Seat 3: U6tnjwZRpTnM+YkqkCjwyQ folded before Flop (didn't bet)
Seat 4: GDVIsbEJ/DOJsMKE4Asz0A (button) folded before Flop (didn't bet)
Seat 5: AdLVjddOzm+sRNo1Bc3S6Q (small blind) folded before Flop
Seat 6: hpxXcmRkXXI9HE5+5/j/0Q (big blind) collected ($1)



PokerStars Game #59939245060:  Hold'em No Limit ($0.50/$1.00) - 2009/07/01 0:34:57 ET
Table '/RZcOwpZpHQ+OwPwjsbnRw' 6-max Seat #5 is the button
Seat 1: Zboa6dColKGHBjLPUakZjw ($52.70 in chips)
Seat 3: OigyyiK+tTj1APPIAUmXDA ($71.15 in chips)
Seat 4: j7NIOHLZk7V2o9fOioO5ug ($116.90 in chips)
Seat 5: wx3sQGkVi2x9wJXuWNHPBw ($199.65 in chips)
Seat 6: XOIf9W+VAxhZqN+SYoyMKA ($289.05 in chips)
XOIf9W+VAxhZqN+SYoyMKA: posts small blind $0.50
Zboa6dColKGHBjLPUakZjw: posts big blind $1
*** HOLE CARDS ***
OigyyiK+tTj1APPIAUmXDA: folds
j7NIOHLZk7V2o9fOioO5ug: folds
OigyyiK+tTj1APPIAUmXDA leaves the table
+xW7QemQU0Fxs+4TnqBRow joins the table at seat #2
wx3sQGkVi2x9wJXuWNHPBw has timed out
wx3sQGkVi2x9wJXuWNHPBw: folds
wx3sQGkVi2x9wJXuWNHPBw is sitting out
XOIf9W+VAxhZqN+SYoyMKA: folds
Zboa6dColKGHBjLPUakZjw collected $1 from pot
wx3sQGkVi2x9wJXuWNHPBw has returned
*** SUMMARY ***
Total pot $1 | Rake $0
Seat 1: Zboa6dColKGHBjLPUakZjw (big blind) collected ($1)
Seat 3: OigyyiK+tTj1APPIAUmXDA folded before Flop (didn't bet)
Seat 4: j7NIOHLZk7V2o9fOioO5ug folded before Flop (didn't bet)
Seat 5: wx3sQGkVi2x9wJXuWNHPBw (button) folded before Flop (didn't bet)
Seat 6: XOIf9W+VAxhZqN+SYoyMKA (small blind) folded before Flop



PokerStars Game #59939246508:  Hold'em No Limit ($0.50/$1.00) - 2009/07/01 0:34:59 ET
Table 'tLrtq7gDzxEvckNAI1OS5Q' 6-max Seat #5 is the button
Seat 1: GisIe1kcC9q/xV6ifsTjgA ($174.15 in chips)
Seat 2: QHvTZcrKe6+maWUfVjP29Q ($100 in chips)
Seat 5: OGMLOcTNYZXZU81au7ztUw ($160.10 in chips)
Seat 6: XUk5GQsfNFpHvaToDZ0rZA ($86 in chips)
XUk5GQsfNFpHvaToDZ0rZA: posts small blind $0.50
GisIe1kcC9q/xV6ifsTjgA: posts big blind $1
TPZ+m9x+lwoKpv7TMfAUWA: sits out
*** HOLE CARDS ***
QHvTZcrKe6+maWUfVjP29Q: folds
OGMLOcTNYZXZU81au7ztUw: folds
XUk5GQsfNFpHvaToDZ0rZA: folds
GisIe1kcC9q/xV6ifsTjgA collected $1 from pot
*** SUMMARY ***
Total pot $1 | Rake $0
Seat 1: GisIe1kcC9q/xV6ifsTjgA (big blind) collected ($1)
Seat 2: QHvTZcrKe6+maWUfVjP29Q folded before Flop (didn't bet)
Seat 5: OGMLOcTNYZXZU81au7ztUw (button) folded before Flop (didn't bet)
Seat 6: XUk5GQsfNFpHvaToDZ0rZA (small blind) folded before Flop



PokerStars Game #59939247872:  Hold'em No Limit ($0.50/$1.00) - 2009/07/01 0:35:01 ET
Table 'LmXQK9xy3awB+qsPzI21Mw' 2-max Seat #2 is the button
Seat 1: NYi6JFscYNrofSXy4sM+Yw ($213.80 in chips)
Seat 2: TME8GvochpQAo8cmJwWmvA ($28.25 in chips)
TME8GvochpQAo8cmJwWmvA: posts small blind $0.50
NYi6JFscYNrofSXy4sM+Yw: posts big blind $1
*** HOLE CARDS ***
TME8GvochpQAo8cmJwWmvA: folds
NYi6JFscYNrofSXy4sM+Yw collected $1 from pot
*** SUMMARY ***
Total pot $1 | Rake $0
Seat 1: NYi6JFscYNrofSXy4sM+Yw (big blind) collected ($1)
Seat 2: TME8GvochpQAo8cmJwWmvA (button) (small blind) folded before Flop



PokerStars Game #59939248350:  Hold'em No Limit ($0.50/$1.00) - 2009/07/01 0:35:02 ET
Table 'tyUh+jyNvrceIQdKMJjQ2wZFWj23PMihdwrNWv41OG/Qeat #6 is the button
Seat 2: m1sJRkJZ1wu5i1BdgeO2Jw ($26 in chips)
Seat 3: TalCiLYHCd+ffkmR3auPvA ($58 in chips)
Seat 4: TSuRyAHnUPCFjP7Z0rEE0w ($108.25 in chips)
Seat 5: j7NIOHLZk7V2o9fOioO5ug ($119.10 in chips)
Seat 6: YsLQ3BAvgQHWXMAv3Wv6Hg ($152.25 in chips)
o8A5MUdudVKu+pAwgZOX2w was removed from the table for failing to post
m1sJRkJZ1wu5i1BdgeO2Jw: posts small blind $0.50
TalCiLYHCd+ffkmR3auPvA: posts big blind $1
*** HOLE CARDS ***
TSuRyAHnUPCFjP7Z0rEE0w: folds
j7NIOHLZk7V2o9fOioO5ug: folds
YsLQ3BAvgQHWXMAv3Wv6Hg: raises $3 to $4
m1sJRkJZ1wu5i1BdgeO2Jw: calls $3.50
TalCiLYHCd+ffkmR3auPvA: folds
*** FLOP *** [Jh Tc 2d]
m1sJRkJZ1wu5i1BdgeO2Jw: checks
YsLQ3BAvgQHWXMAv3Wv6Hg: bets $6
m1sJRkJZ1wu5i1BdgeO2Jw: calls $6
*** TURN *** [Jh Tc 2d] [5d]
m1sJRkJZ1wu5i1BdgeO2Jw: checks
YsLQ3BAvgQHWXMAv3Wv6Hg: bets $17
m1sJRkJZ1wu5i1BdgeO2Jw: folds
o8A5MUdudVKu+pAwgZOX2w joins the table at seat #1
YsLQ3BAvgQHWXMAv3Wv6Hg collected $20 from pot
YsLQ3BAvgQHWXMAv3Wv6Hg: doesn't show hand
*** SUMMARY ***
Total pot $21 | Rake $1
Board [Jh Tc 2d 5d]
Seat 2: m1sJRkJZ1wu5i1BdgeO2Jw (small blind) folded on the Turn
Seat 3: TalCiLYHCd+ffkmR3auPvA (big blind) folded before Flop
Seat 4: TSuRyAHnUPCFjP7Z0rEE0w folded before Flop (didn't bet)
Seat 5: j7NIOHLZk7V2o9fOioO5ug folded before Flop (didn't bet)
Seat 6: YsLQ3BAvgQHWXMAv3Wv6Hg (button) collected ($20)



PokerStars Game #59939249120:  Hold'em No Limit ($0.50/$1.00) - 2009/07/01 0:35:03 ET
Table 'pHrhryH8jPNdQfY62f8v+g' 6-max Seat #5 is the button
Seat 1: BdbmJTZZ47quA9vUWwXtlw ($113.60 in chips)
Seat 2: RqgF7gRoKgRNW8Zoi1ty4A ($115 in chips)
Seat 4: wenbG7TaM3H7h5kn78OFNw ($58.30 in chips)
Seat 5: r1/R7y0Ortgoz4lccgW8VA ($15.65 in chips)
Seat 6: xAU6q2/cwmby2sxmA8VcmA ($103.30 in chips)
xAU6q2/cwmby2sxmA8VcmA: posts small blind $0.50
BdbmJTZZ47quA9vUWwXtlw: posts big blind $1
*** HOLE CARDS ***
RqgF7gRoKgRNW8Zoi1ty4A: folds
wenbG7TaM3H7h5kn78OFNw: folds
r1/R7y0Ortgoz4lccgW8VA: raises $3 to $4
xAU6q2/cwmby2sxmA8VcmA: folds
BdbmJTZZ47quA9vUWwXtlw: calls $3
*** FLOP *** [2h Qc Qh]
BdbmJTZZ47quA9vUWwXtlw: checks
r1/R7y0Ortgoz4lccgW8VA: bets $11.65 and is all-in
BdbmJTZZ47quA9vUWwXtlw: folds
r1/R7y0Ortgoz4lccgW8VA collected $8.10 from pot
*** SUMMARY ***
Total pot $8.50 | Rake $0.40
Board [2h Qc Qh]
Seat 1: BdbmJTZZ47quA9vUWwXtlw (big blind) folded on the Flop
Seat 2: RqgF7gRoKgRNW8Zoi1ty4A folded before Flop (didn't bet)
Seat 4: wenbG7TaM3H7h5kn78OFNw folded before Flop (didn't bet)
Seat 5: r1/R7y0Ortgoz4lccgW8VA (button) collected ($8.10)
Seat 6: xAU6q2/cwmby2sxmA8VcmA (small blind) folded before Flop



PokerStars Game #59939249676:  Hold'em No Limit ($0.50/$1.00) - 2009/07/01 0:35:04 ET
Table 'fTlPiCj0utgzC/5io+I7ew' 6-max Seat #3 is the button
Seat 1: YMJG+F++3Aj6P8dAWda5fw ($98.50 in chips)
Seat 2: Qy/UBNbD2HaA0Ogxg8Sf3w ($101.50 in chips)
Seat 3: oDiBRCaF0QVtd3kO6xZIXw ($101.50 in chips)
Seat 4: uJVSceLggtsrJya+WtmUEA ($98.30 in chips)
Seat 5: bFrTkDcWGTxyvNul7GVdYg ($256.70 in chips)
Seat 6: jMljU/dOPMXfJi8OmbdYdw ($28.50 in chips)
uJVSceLggtsrJya+WtmUEA: posts small blind $0.50
bFrTkDcWGTxyvNul7GVdYg: posts big blind $1
*** HOLE CARDS ***
jMljU/dOPMXfJi8OmbdYdw: calls $1
YMJG+F++3Aj6P8dAWda5fw: folds
Qy/UBNbD2HaA0Ogxg8Sf3w: folds
oDiBRCaF0QVtd3kO6xZIXw: calls $1
uJVSceLggtsrJya+WtmUEA: calls $0.50
bFrTkDcWGTxyvNul7GVdYg: checks
*** FLOP *** [3d 7s Ks]
uJVSceLggtsrJya+WtmUEA: checks
bFrTkDcWGTxyvNul7GVdYg: checks
jMljU/dOPMXfJi8OmbdYdw: checks
oDiBRCaF0QVtd3kO6xZIXw: bets $3
uJVSceLggtsrJya+WtmUEA: folds
bFrTkDcWGTxyvNul7GVdYg: folds
jMljU/dOPMXfJi8OmbdYdw: calls $3
*** TURN *** [3d 7s Ks] [Ts]
jMljU/dOPMXfJi8OmbdYdw: bets $4
oDiBRCaF0QVtd3kO6xZIXw: raises $8 to $12
jMljU/dOPMXfJi8OmbdYdw: raises $8 to $20
oDiBRCaF0QVtd3kO6xZIXw: calls $8
*** RIVER *** [3d 7s Ks Ts] [Kc]
jMljU/dOPMXfJi8OmbdYdw: bets $2
oDiBRCaF0QVtd3kO6xZIXw: calls $2
*** SHOW DOWN ***
jMljU/dOPMXfJi8OmbdYdw: shows [Js 6s] (a flush, King high)
oDiBRCaF0QVtd3kO6xZIXw: mucks hand
jMljU/dOPMXfJi8OmbdYdw collected $51.45 from pot
*** SUMMARY ***
Total pot $54 | Rake $2.55
Board [3d 7s Ks Ts Kc]
Seat 1: YMJG+F++3Aj6P8dAWda5fw folded before Flop (didn't bet)
Seat 2: Qy/UBNbD2HaA0Ogxg8Sf3w folded before Flop (didn't bet)
Seat 3: oDiBRCaF0QVtd3kO6xZIXw (button) mucked
Seat 4: uJVSceLggtsrJya+WtmUEA (small blind) folded on the Flop
Seat 5: bFrTkDcWGTxyvNul7GVdYg (big blind) folded on the Flop
Seat 6: jMljU/dOPMXfJi8OmbdYdw showed [Js 6s] and won ($51.45) with a flush, King high



PokerStars Game #59939252666:  Hold'em No Limit ($0.50/$1.00) - 2009/07/01 0:35:08 ET
Table 'LmXQK9xy3awB+qsPzI21Mw' 2-max Seat #1 is the button
Seat 1: NYi6JFscYNrofSXy4sM+Yw ($214.30 in chips)
Seat 2: TME8GvochpQAo8cmJwWmvA ($27.75 in chips)
NYi6JFscYNrofSXy4sM+Yw: posts small blind $0.50
TME8GvochpQAo8cmJwWmvA: posts big blind $1
*** HOLE CARDS ***
NYi6JFscYNrofSXy4sM+Yw: raises $2 to $3
TME8GvochpQAo8cmJwWmvA: raises $24.75 to $27.75 and is all-in
NYi6JFscYNrofSXy4sM+Yw: calls $24.75
*** FLOP *** [Jh Tc 6h]
*** TURN *** [Jh Tc 6h] [4d]
*** RIVER *** [Jh Tc 6h 4d] [Jd]
*** SHOW DOWN ***
TME8GvochpQAo8cmJwWmvA: shows [As 8h] (a pair of Jacks)
NYi6JFscYNrofSXy4sM+Yw: shows [3h 3c] (two pair, Jacks and Threes)
NYi6JFscYNrofSXy4sM+Yw collected $55 from pot
*** SUMMARY ***
Total pot $55.50 | Rake $0.50
Board [Jh Tc 6h 4d Jd]
Seat 1: NYi6JFscYNrofSXy4sM+Yw (button) (small blind) showed [3h 3c] and won ($55) with two pair, Jacks and Threes
Seat 2: TME8GvochpQAo8cmJwWmvA (big blind) showed [As 8h] and lost with a pair of Jacks



PokerStars Game #59939253166:  Hold'em No Limit ($0.50/$1.00) - 2009/07/01 0:35:09 ET
Table 'QBLDswtHe7Ml0HwAdcMhlw' 2-max Seat #2 is the button
Seat 1: hdNlhiCwI533uwvvTTfC9Q ($103.20 in chips)
Seat 2: GBkvjkjDWVBEa1e14dh6CA ($60 in chips)
GBkvjkjDWVBEa1e14dh6CA: posts small blind $0.50
hdNlhiCwI533uwvvTTfC9Q: posts big blind $1
*** HOLE CARDS ***
GBkvjkjDWVBEa1e14dh6CA: folds
hdNlhiCwI533uwvvTTfC9Q collected $1 from pot
hdNlhiCwI533uwvvTTfC9Q: doesn't show hand
*** SUMMARY ***
Total pot $1 | Rake $0
Seat 1: hdNlhiCwI533uwvvTTfC9Q (big blind) collected ($1)
Seat 2: GBkvjkjDWVBEa1e14dh6CA (button) (small blind) folded before Flop



PokerStars Game #59939253412:  Hold'em No Limit ($0.50/$1.00) - 2009/07/01 0:35:09 ET
Table 'tLrtq7gDzxEvckNAI1OS5Q' 6-max Seat #6 is the button
Seat 1: GisIe1kcC9q/xV6ifsTjgA ($174.65 in chips)
Seat 2: QHvTZcrKe6+maWUfVjP29Q ($100 in chips)
Seat 5: OGMLOcTNYZXZU81au7ztUw ($160.10 in chips)
Seat 6: XUk5GQsfNFpHvaToDZ0rZA ($85.50 in chips)
GisIe1kcC9q/xV6ifsTjgA: posts small blind $0.50
QHvTZcrKe6+maWUfVjP29Q: posts big blind $1
TPZ+m9x+lwoKpv7TMfAUWA: sits out
*** HOLE CARDS ***
OGMLOcTNYZXZU81au7ztUw: raises $2 to $3
XUk5GQsfNFpHvaToDZ0rZA: folds
GisIe1kcC9q/xV6ifsTjgA: folds
QHvTZcrKe6+maWUfVjP29Q: folds
OGMLOcTNYZXZU81au7ztUw collected $2.50 from pot
OGMLOcTNYZXZU81au7ztUw: doesn't show hand
*** SUMMARY ***
Total pot $2.50 | Rake $0
Seat 1: GisIe1kcC9q/xV6ifsTjgA (small blind) folded before Flop
Seat 2: QHvTZcrKe6+maWUfVjP29Q (big blind) folded before Flop
Seat 5: OGMLOcTNYZXZU81au7ztUw collected ($2.50)
Seat 6: XUk5GQsfNFpHvaToDZ0rZA (button) folded before Flop (didn't bet)



PokerStars Game #59939253672:  Hold'em No Limit ($0.50/$1.00) - 2009/07/01 0:35:10 ET
Table '8jIjWCPY0NGprquL+xcMFg' 9-max Seat #9 is the button
Seat 1: vR4IO10geOgvTW+LAUBv/A ($132.80 in chips)
Seat 2: rR1qGAf9Q9RYorKYWH3VKw ($8.20 in chips)
Seat 4: by0z+YmujwI6Bf4qRFE8vA ($147.45 in chips)
Seat 6: GTQkFJtSkbVbnGCktp6e3g ($100 in chips)
Seat 7: O3CGPwwUmamrCNHccOilrg ($50.75 in chips)
Seat 8: 9swGhtpERPngKPtvpoZkoQ ($150.30 in chips)
Seat 9: negfosHnGOZXSHpWDRKyBQ ($18.50 in chips)
vR4IO10geOgvTW+LAUBv/A: posts small blind $0.50
rR1qGAf9Q9RYorKYWH3VKw: posts big blind $1
tjhwe1V98x2spSoUQER3HQ: sits out
*** HOLE CARDS ***
by0z+YmujwI6Bf4qRFE8vA: folds
GTQkFJtSkbVbnGCktp6e3g: folds
O3CGPwwUmamrCNHccOilrg: raises $1 to $2
9swGhtpERPngKPtvpoZkoQ: folds
negfosHnGOZXSHpWDRKyBQ: folds
vR4IO10geOgvTW+LAUBv/A: folds
rR1qGAf9Q9RYorKYWH3VKw: calls $1
*** FLOP *** [8s 5s 2d]
rR1qGAf9Q9RYorKYWH3VKw: checks
O3CGPwwUmamrCNHccOilrg: bets $1
rR1qGAf9Q9RYorKYWH3VKw: folds
O3CGPwwUmamrCNHccOilrg collected $4.30 from pot
O3CGPwwUmamrCNHccOilrg: doesn't show hand
*** SUMMARY ***
Total pot $4.50 | Rake $0.20
Board [8s 5s 2d]
Seat 1: vR4IO10geOgvTW+LAUBv/A (small blind) folded before Flop
Seat 2: rR1qGAf9Q9RYorKYWH3VKw (big blind) folded on the Flop
Seat 4: by0z+YmujwI6Bf4qRFE8vA folded before Flop (didn't bet)
Seat 6: GTQkFJtSkbVbnGCktp6e3g folded before Flop (didn't bet)
Seat 7: O3CGPwwUmamrCNHccOilrg collected ($4.30)
Seat 8: 9swGhtpERPngKPtvpoZkoQ folded before Flop (didn't bet)
Seat 9: negfosHnGOZXSHpWDRKyBQ (button) folded before Flop (didn't bet)



PokerStars Game #59939254708:  Hold'em No Limit ($0.50/$1.00) - 2009/07/01 0:35:11 ET
Table '7Nl0ffnjeK44/vmeexh3MQ' 9-max Seat #6 is the button
Seat 1: s7D3Y+k4Cj4D1cXHv7oj+Q ($97.45 in chips)
Seat 2: kiakSwxX0e64PwYGAPQvLw ($31.85 in chips)
Seat 3: vR4IO10geOgvTW+LAUBv/A ($100 in chips)
Seat 4: bLbSOSmSOnqE0iTcH/5dxA ($100 in chips)
Seat 5: bL+QVeDcuEdzMGAGg2XJHg ($103.90 in chips)
Seat 6: FVs16t7GgfWgQWt4JxsObQ ($21.45 in chips)
Seat 8: zanka7aAZkigmZpfopXxxA ($227.20 in chips)
Seat 9: ouwUBGRKnKK9uhn1G4Lf+A ($99.50 in chips)
zanka7aAZkigmZpfopXxxA: posts small blind $0.50
ouwUBGRKnKK9uhn1G4Lf+A: posts big blind $1
*** HOLE CARDS ***
s7D3Y+k4Cj4D1cXHv7oj+Q: calls $1
kiakSwxX0e64PwYGAPQvLw: folds
vR4IO10geOgvTW+LAUBv/A: folds
bLbSOSmSOnqE0iTcH/5dxA: folds
bL+QVeDcuEdzMGAGg2XJHg: folds
FVs16t7GgfWgQWt4JxsObQ: folds
zanka7aAZkigmZpfopXxxA: calls $0.50
ouwUBGRKnKK9uhn1G4Lf+A: checks
*** FLOP *** [5d 3c 8s]
zanka7aAZkigmZpfopXxxA: checks
ouwUBGRKnKK9uhn1G4Lf+A: checks
s7D3Y+k4Cj4D1cXHv7oj+Q: bets $2
zanka7aAZkigmZpfopXxxA: folds
ouwUBGRKnKK9uhn1G4Lf+A: folds
s7D3Y+k4Cj4D1cXHv7oj+Q collected $2.85 from pot
*** SUMMARY ***
Total pot $3 | Rake $0.15
Board [5d 3c 8s]
Seat 1: s7D3Y+k4Cj4D1cXHv7oj+Q collected ($2.85)
Seat 2: kiakSwxX0e64PwYGAPQvLw folded before Flop (didn't bet)
Seat 3: vR4IO10geOgvTW+LAUBv/A folded before Flop (didn't bet)
Seat 4: bLbSOSmSOnqE0iTcH/5dxA folded before Flop (didn't bet)
Seat 5: bL+QVeDcuEdzMGAGg2XJHg folded before Flop (didn't bet)
Seat 6: FVs16t7GgfWgQWt4JxsObQ (button) folded before Flop (didn't bet)
Seat 8: zanka7aAZkigmZpfopXxxA (small blind) folded on the Flop
Seat 9: ouwUBGRKnKK9uhn1G4Lf+A (big blind) folded on the Flop



PokerStars Game #59939256538:  Hold'em No Limit ($0.50/$1.00) - 2009/07/01 0:35:14 ET
Table 'ZFWj23PMihdwrNWv41OG/Q' 9-max Seat #3 is the button
Seat 1: yAbu2QsRPVcjPbqlf/jDxw ($124.90 in chips)
Seat 2: ARfmgHcEUKh68laBZy4veA ($77.60 in chips)
Seat 3: G9Fo2TZCN7HI43Po4zSN3A ($102 in chips)
Seat 4: PEmogYqKpuv0ozeBbXL+7Q ($13 in chips)
Seat 5: tkdBeXTJlFsZdioidNqLow ($60 in chips)
Seat 6: tjhwe1V98x2spSoUQER3HQ ($104.50 in chips)
Seat 7: wIZ377kjl2fHFGnS93o6bw ($22.45 in chips)
Seat 8: knewtTmBc4Tc0z/5tAABYQ ($116.90 in chips)
Seat 9: gIabaXO0Nq08nuXlf56f0w ($19.90 in chips)
PEmogYqKpuv0ozeBbXL+7Q: posts small blind $0.50
tkdBeXTJlFsZdioidNqLow: posts big blind $1
*** HOLE CARDS ***
tjhwe1V98x2spSoUQER3HQ: folds
wIZ377kjl2fHFGnS93o6bw: calls $1
knewtTmBc4Tc0z/5tAABYQ: folds
gIabaXO0Nq08nuXlf56f0w: folds
yAbu2QsRPVcjPbqlf/jDxw: folds
ARfmgHcEUKh68laBZy4veA: folds
G9Fo2TZCN7HI43Po4zSN3A: folds
PEmogYqKpuv0ozeBbXL+7Q: calls $0.50
tkdBeXTJlFsZdioidNqLow: checks
*** FLOP *** [8h 7h Th]
PEmogYqKpuv0ozeBbXL+7Q: bets $1
tkdBeXTJlFsZdioidNqLow: folds
wIZ377kjl2fHFGnS93o6bw: folds
PEmogYqKpuv0ozeBbXL+7Q collected $2.85 from pot
*** SUMMARY ***
Total pot $3 | Rake $0.15
Board [8h 7h Th]
Seat 1: yAbu2QsRPVcjPbqlf/jDxw folded before Flop (didn't bet)
Seat 2: ARfmgHcEUKh68laBZy4veA folded before Flop (didn't bet)
Seat 3: G9Fo2TZCN7HI43Po4zSN3A (button) folded before Flop (didn't bet)
Seat 4: PEmogYqKpuv0ozeBbXL+7Q (small blind) collected ($2.85)
Seat 5: tkdBeXTJlFsZdioidNqLow (big blind) folded on the Flop
Seat 6: tjhwe1V98x2spSoUQER3HQ folded before Flop (didn't bet)
Seat 7: wIZ377kjl2fHFGnS93o6bw folded on the Flop
Seat 8: knewtTmBc4Tc0z/5tAABYQ folded before Flop (didn't bet)
Seat 9: gIabaXO0Nq08nuXlf56f0w folded before Flop (didn't bet)



PokerStars Game #59939256010:  Hold'em No Limit ($0.50/$1.00) - 2009/07/01 0:35:14 ET
Table 'MUPc8FEpe/nR0BKSeReX6Q' 6-max Seat #1 is the button
Seat 1: YsLQ3BAvgQHWXMAv3Wv6Hg ($100 in chips)
Seat 2: xAU6q2/cwmby2sxmA8VcmA ($112.20 in chips)
Seat 3: wx3sQGkVi2x9wJXuWNHPBw ($234.05 in chips)
Seat 4: ZA1bp6g8IwtTxkUE4eCjDQ ($126.85 in chips)
Seat 5: UBZQqpnJZdTYYY1FTb0rLA ($100 in chips)
Seat 6: oxnw0GLLpFanjhGkxfRSqA ($48.10 in chips)
xAU6q2/cwmby2sxmA8VcmA: posts small blind $0.50
wx3sQGkVi2x9wJXuWNHPBw: posts big blind $1
*** HOLE CARDS ***
ZA1bp6g8IwtTxkUE4eCjDQ: folds
UBZQqpnJZdTYYY1FTb0rLA: folds
oxnw0GLLpFanjhGkxfRSqA: folds
YsLQ3BAvgQHWXMAv3Wv6Hg: folds
xAU6q2/cwmby2sxmA8VcmA: folds
wx3sQGkVi2x9wJXuWNHPBw collected $1 from pot
*** SUMMARY ***
Total pot $1 | Rake $0
Seat 1: YsLQ3BAvgQHWXMAv3Wv6Hg (button) folded before Flop (didn't bet)
Seat 2: xAU6q2/cwmby2sxmA8VcmA (small blind) folded before Flop
Seat 3: wx3sQGkVi2x9wJXuWNHPBw (big blind) collected ($1)
Seat 4: ZA1bp6g8IwtTxkUE4eCjDQ folded before Flop (didn't bet)
Seat 5: UBZQqpnJZdTYYY1FTb0rLA folded before Flop (didn't bet)
Seat 6: oxnw0GLLpFanjhGkxfRSqA folded before Flop (didn't bet)



PokerStars Game #59939257140:  Hold'em No Limit ($0.50/$1.00) - 2009/07/01 0:35:15 ET
Table '+cA8mcmhaedZ7YcrDdhmeQ' 6-max Seat #2 is the button
Seat 1: lsLuWlcPA3Rh7kJVLzMh0Q ($304.25 in chips)
Seat 2: RqgF7gRoKgRNW8Zoi1ty4A ($101 in chips)
Seat 3: 7H5WkGzGvsv56y1iaqHvRg ($45.05 in chips)
Seat 4: LjL3AIERHn559yyW1mTUYQ ($159 in chips)
Seat 6: YfsTQsY/fxb+YqbdclTHuw ($51.95 in chips)
7H5WkGzGvsv56y1iaqHvRg: posts small blind $0.50
LjL3AIERHn559yyW1mTUYQ: posts big blind $1
iHo1oDbrEVJ8nEGdaPrICw: sits out
*** HOLE CARDS ***
YfsTQsY/fxb+YqbdclTHuw: folds
lsLuWlcPA3Rh7kJVLzMh0Q: folds
RqgF7gRoKgRNW8Zoi1ty4A: raises $2 to $3
7H5WkGzGvsv56y1iaqHvRg: folds
LjL3AIERHn559yyW1mTUYQ: calls $2
*** FLOP *** [Jh Jc Js]
LjL3AIERHn559yyW1mTUYQ: checks
RqgF7gRoKgRNW8Zoi1ty4A: bets $4
LjL3AIERHn559yyW1mTUYQ: folds
RqgF7gRoKgRNW8Zoi1ty4A collected $6.20 from pot
*** SUMMARY ***
Total pot $6.50 | Rake $0.30
Board [Jh Jc Js]
Seat 1: lsLuWlcPA3Rh7kJVLzMh0Q folded before Flop (didn't bet)
Seat 2: RqgF7gRoKgRNW8Zoi1ty4A (button) collected ($6.20)
Seat 3: 7H5WkGzGvsv56y1iaqHvRg (small blind) folded before Flop
Seat 4: LjL3AIERHn559yyW1mTUYQ (big blind) folded on the Flop
Seat 6: YfsTQsY/fxb+YqbdclTHuw folded before Flop (didn't bet)



PokerStars Game #59939257400:  Hold'em No Limit ($0.50/$1.00) - 2009/07/01 0:35:16 ET
Table 'eU3bWpDDg3Z+9R4m4iVmog' 6-max Seat #5 is the button
Seat 1: TSuRyAHnUPCFjP7Z0rEE0w ($171.20 in chips)
Seat 2: 8CAoOzhmB8n3nRFf3V4BTg ($124.95 in chips)
Seat 3: U6tnjwZRpTnM+YkqkCjwyQ ($169.65 in chips)
Seat 4: GDVIsbEJ/DOJsMKE4Asz0A ($100.60 in chips)
Seat 5: AdLVjddOzm+sRNo1Bc3S6Q ($100 in chips)
Seat 6: hpxXcmRkXXI9HE5+5/j/0Q ($104 in chips)
hpxXcmRkXXI9HE5+5/j/0Q: posts small blind $0.50
TSuRyAHnUPCFjP7Z0rEE0w: posts big blind $1
*** HOLE CARDS ***
8CAoOzhmB8n3nRFf3V4BTg: calls $1
U6tnjwZRpTnM+YkqkCjwyQ: folds
GDVIsbEJ/DOJsMKE4Asz0A: folds
AdLVjddOzm+sRNo1Bc3S6Q: folds
hpxXcmRkXXI9HE5+5/j/0Q: raises $4 to $5
TSuRyAHnUPCFjP7Z0rEE0w: folds
8CAoOzhmB8n3nRFf3V4BTg: calls $4
*** FLOP *** [Ah Th Ts]
hpxXcmRkXXI9HE5+5/j/0Q: bets $7
8CAoOzhmB8n3nRFf3V4BTg: folds
hpxXcmRkXXI9HE5+5/j/0Q collected $10.45 from pot
hpxXcmRkXXI9HE5+5/j/0Q: doesn't show hand
*** SUMMARY ***
Total pot $11 | Rake $0.55
Board [Ah Th Ts]
Seat 1: TSuRyAHnUPCFjP7Z0rEE0w (big blind) folded before Flop
Seat 2: 8CAoOzhmB8n3nRFf3V4BTg folded on the Flop
Seat 3: U6tnjwZRpTnM+YkqkCjwyQ folded before Flop (didn't bet)
Seat 4: GDVIsbEJ/DOJsMKE4Asz0A folded before Flop (didn't bet)
Seat 5: AdLVjddOzm+sRNo1Bc3S6Q (button) folded before Flop (didn't bet)
Seat 6: hpxXcmRkXXI9HE5+5/j/0Q (small blind) collected ($10.45)



PokerStars Game #59939257570:  Hold'em No Limit ($0.50/$1.00) - 2009/07/01 0:35:16 ET
Table 'QBLDswtHe7Ml0HwAdcMhlw' 2-max Seat #1 is the button
Seat 1: hdNlhiCwI533uwvvTTfC9Q ($103.70 in chips)
Seat 2: GBkvjkjDWVBEa1e14dh6CA ($59.50 in chips)
hdNlhiCwI533uwvvTTfC9Q: posts small blind $0.50
GBkvjkjDWVBEa1e14dh6CA: posts big blind $1
*** HOLE CARDS ***
hdNlhiCwI533uwvvTTfC9Q: folds
GBkvjkjDWVBEa1e14dh6CA collected $1 from pot
GBkvjkjDWVBEa1e14dh6CA: doesn't show hand
*** SUMMARY ***
Total pot $1 | Rake $0
Seat 1: hdNlhiCwI533uwvvTTfC9Q (button) (small blind) folded before Flop
Seat 2: GBkvjkjDWVBEa1e14dh6CA (big blind) collected ($1)



PokerStars Game #59939260438:  Hold'em No Limit ($0.50/$1.00) - 2009/07/01 0:35:20 ET
Table 'kS0cTQAEi+fdUlJP2gQYvw' 9-max Seat #6 is the button
Seat 1: c/9X4zftzphFxYtxp5kp9w ($39.40 in chips)
Seat 3: 3obndzTJ6fECz8+wWhMd1w ($19 in chips)
Seat 4: TZcz9MEWDA+WydgGruqqbw ($100 in chips)
Seat 5: 2rxrMrE7koO2BNxvop/0+g ($56.55 in chips)
Seat 6: yAbu2QsRPVcjPbqlf/jDxw ($100 in chips)
Seat 7: Ffa7Nj4X5fddtROP01hfQg ($106.20 in chips)
Seat 9: y8Qb94e81yI/g0saQ6gU5g ($56.75 in chips)
Ffa7Nj4X5fddtROP01hfQg: posts small blind $0.50
qTymj6ZQ8ZoFi6fINJZb3w: is sitting out
y8Qb94e81yI/g0saQ6gU5g: posts big blind $1
*** HOLE CARDS ***
c/9X4zftzphFxYtxp5kp9w: folds
qTymj6ZQ8ZoFi6fINJZb3w leaves the table
barrelproof7 joins the table at seat #8
3obndzTJ6fECz8+wWhMd1w: folds
TZcz9MEWDA+WydgGruqqbw: raises $2.50 to $3.50
2rxrMrE7koO2BNxvop/0+g: folds
yAbu2QsRPVcjPbqlf/jDxw: folds
Ffa7Nj4X5fddtROP01hfQg: folds
y8Qb94e81yI/g0saQ6gU5g: folds
y8Qb94e81yI/g0saQ6gU5g is sitting out
TZcz9MEWDA+WydgGruqqbw collected $2.50 from pot
TZcz9MEWDA+WydgGruqqbw: doesn't show hand
*** SUMMARY ***
Total pot $2.50 | Rake $0
Seat 1: c/9X4zftzphFxYtxp5kp9w folded before Flop (didn't bet)
Seat 3: 3obndzTJ6fECz8+wWhMd1w folded before Flop (didn't bet)
Seat 4: TZcz9MEWDA+WydgGruqqbw collected ($2.50)
Seat 5: 2rxrMrE7koO2BNxvop/0+g folded before Flop (didn't bet)
Seat 6: yAbu2QsRPVcjPbqlf/jDxw (button) folded before Flop (didn't bet)
Seat 7: Ffa7Nj4X5fddtROP01hfQg (small blind) folded before Flop
Seat 9: y8Qb94e81yI/g0saQ6gU5g (big blind) folded before Flop



PokerStars Game #59939260594:  Hold'em No Limit ($0.50/$1.00) - 2009/07/01 0:35:20 ET
Table 'tLrtq7gDzxEvckNAI1OS5Q' 6-max Seat #1 is the button
Seat 1: GisIe1kcC9q/xV6ifsTjgA ($174.15 in chips)
Seat 2: QHvTZcrKe6+maWUfVjP29Q ($100 in chips)
Seat 3: TPZ+m9x+lwoKpv7TMfAUWA ($319.80 in chips)
Seat 5: OGMLOcTNYZXZU81au7ztUw ($161.60 in chips)
Seat 6: XUk5GQsfNFpHvaToDZ0rZA ($85.50 in chips)
QHvTZcrKe6+maWUfVjP29Q: posts small blind $0.50
TPZ+m9x+lwoKpv7TMfAUWA: posts big blind $1
*** HOLE CARDS ***
OGMLOcTNYZXZU81au7ztUw: raises $2 to $3
XUk5GQsfNFpHvaToDZ0rZA: folds
GisIe1kcC9q/xV6ifsTjgA: folds
QHvTZcrKe6+maWUfVjP29Q: raises $8 to $11
TPZ+m9x+lwoKpv7TMfAUWA: folds
OGMLOcTNYZXZU81au7ztUw: calls $8
*** FLOP *** [Js 9s Kh]
QHvTZcrKe6+maWUfVjP29Q: bets $13
OGMLOcTNYZXZU81au7ztUw: folds
QHvTZcrKe6+maWUfVjP29Q collected $21.85 from pot
QHvTZcrKe6+maWUfVjP29Q: doesn't show hand
*** SUMMARY ***
Total pot $23 | Rake $1.15
Board [Js 9s Kh]
Seat 1: GisIe1kcC9q/xV6ifsTjgA (button) folded before Flop (didn't bet)
Seat 2: QHvTZcrKe6+maWUfVjP29Q (small blind) collected ($21.85)
Seat 3: TPZ+m9x+lwoKpv7TMfAUWA (big blind) folded before Flop
Seat 5: OGMLOcTNYZXZU81au7ztUw folded on the Flop
Seat 6: XUk5GQsfNFpHvaToDZ0rZA folded before Flop (didn't bet)



PokerStars Game #59939261244:  Hold'em No Limit ($0.50/$1.00) - 2009/07/01 0:35:21 ET
Table 'vs/5jr6ciwjVQ5+Soc+u2A' 6-max Seat #4 is the button
Seat 1: 3yN2jRjZ+glIaWtGMmKOrA ($23.05 in chips)
Seat 2: XOIf9W+VAxhZqN+SYoyMKA ($118.65 in chips)
Seat 3: G5ZSSN6RSON3gkNvk/SmYg ($100 in chips)
Seat 4: KpnW5CcJ4Mg6MeclfKmLrw ($109.80 in chips)
Seat 5: 7Vc9JmGFQwMRh5Tj9ui5Lw ($105.40 in chips)
Seat 6: QHvTZcrKe6+maWUfVjP29Q ($100 in chips)
7Vc9JmGFQwMRh5Tj9ui5Lw: posts small blind $0.50
QHvTZcrKe6+maWUfVjP29Q: posts big blind $1
*** HOLE CARDS ***
3yN2jRjZ+glIaWtGMmKOrA: folds
XOIf9W+VAxhZqN+SYoyMKA: folds
G5ZSSN6RSON3gkNvk/SmYg: raises $3 to $4
KpnW5CcJ4Mg6MeclfKmLrw: folds
7Vc9JmGFQwMRh5Tj9ui5Lw: calls $3.50
QHvTZcrKe6+maWUfVjP29Q: folds
*** FLOP *** [Td 5h 7d]
7Vc9JmGFQwMRh5Tj9ui5Lw: checks
G5ZSSN6RSON3gkNvk/SmYg: bets $5
7Vc9JmGFQwMRh5Tj9ui5Lw: calls $5
*** TURN *** [Td 5h 7d] [6h]
7Vc9JmGFQwMRh5Tj9ui5Lw: checks
G5ZSSN6RSON3gkNvk/SmYg: bets $15
7Vc9JmGFQwMRh5Tj9ui5Lw: calls $15
*** RIVER *** [Td 5h 7d 6h] [As]
7Vc9JmGFQwMRh5Tj9ui5Lw: checks
G5ZSSN6RSON3gkNvk/SmYg: bets $30
7Vc9JmGFQwMRh5Tj9ui5Lw: calls $30
*** SHOW DOWN ***
G5ZSSN6RSON3gkNvk/SmYg: shows [Tc Ts] (three of a kind, Tens)
7Vc9JmGFQwMRh5Tj9ui5Lw: mucks hand
G5ZSSN6RSON3gkNvk/SmYg collected $106 from pot
*** SUMMARY ***
Total pot $109 | Rake $3
Board [Td 5h 7d 6h As]
Seat 1: 3yN2jRjZ+glIaWtGMmKOrA folded before Flop (didn't bet)
Seat 2: XOIf9W+VAxhZqN+SYoyMKA folded before Flop (didn't bet)
Seat 3: G5ZSSN6RSON3gkNvk/SmYg showed [Tc Ts] and won ($106) with three of a kind, Tens
Seat 4: KpnW5CcJ4Mg6MeclfKmLrw (button) folded before Flop (didn't bet)
Seat 5: 7Vc9JmGFQwMRh5Tj9ui5Lw (small blind) mucked
Seat 6: QHvTZcrKe6+maWUfVjP29Q (big blind) folded before Flop



PokerStars Game #59939261852:  Hold'em No Limit ($0.50/$1.00) - 2009/07/01 0:35:22 ET
Table 'U9zqzC8f3oTJ2ShXFgSSOA' 6-max Seat #5 is the button
Seat 1: tS9JHB1h+FQ++qu8RwRNgg ($34.50 in chips)
Seat 2: U2CWBTv29qdCbj8RNF2sIw ($100 in chips)
Seat 3: yfXek8iJ7O4CFyqXrtGcfg ($21.05 in chips)
Seat 4: 33q95we0Etwgrm6guQGncw ($72.15 in chips)
Seat 5: KfwW5us6tydK81NYTtK1gw ($309.75 in chips)
Seat 6: aIxzFKdtpDSkUePKZy/niQ ($65.75 in chips)
aIxzFKdtpDSkUePKZy/niQ: posts small blind $0.50
tS9JHB1h+FQ++qu8RwRNgg: posts big blind $1
*** HOLE CARDS ***
U2CWBTv29qdCbj8RNF2sIw: folds
yfXek8iJ7O4CFyqXrtGcfg: calls $1
33q95we0Etwgrm6guQGncw: folds
KfwW5us6tydK81NYTtK1gw: folds
aIxzFKdtpDSkUePKZy/niQ: calls $0.50
tS9JHB1h+FQ++qu8RwRNgg: checks
*** FLOP *** [Ah 5d Tc]
aIxzFKdtpDSkUePKZy/niQ: checks
tS9JHB1h+FQ++qu8RwRNgg: checks
yfXek8iJ7O4CFyqXrtGcfg: checks
*** TURN *** [Ah 5d Tc] [4d]
aIxzFKdtpDSkUePKZy/niQ: checks
tS9JHB1h+FQ++qu8RwRNgg: checks
yfXek8iJ7O4CFyqXrtGcfg: checks
*** RIVER *** [Ah 5d Tc 4d] [2s]
aIxzFKdtpDSkUePKZy/niQ: checks
tS9JHB1h+FQ++qu8RwRNgg: checks
yfXek8iJ7O4CFyqXrtGcfg: checks
*** SHOW DOWN ***
aIxzFKdtpDSkUePKZy/niQ: shows [4h Jh] (a pair of Fours)
tS9JHB1h+FQ++qu8RwRNgg: mucks hand
yfXek8iJ7O4CFyqXrtGcfg: mucks hand
aIxzFKdtpDSkUePKZy/niQ collected $2.85 from pot
*** SUMMARY ***
Total pot $3 | Rake $0.15
Board [Ah 5d Tc 4d 2s]
Seat 1: tS9JHB1h+FQ++qu8RwRNgg (big blind) mucked
Seat 2: U2CWBTv29qdCbj8RNF2sIw folded before Flop (didn't bet)
Seat 3: yfXek8iJ7O4CFyqXrtGcfg mucked
Seat 4: 33q95we0Etwgrm6guQGncw folded before Flop (didn't bet)
Seat 5: KfwW5us6tydK81NYTtK1gw (button) folded before Flop (didn't bet)
Seat 6: aIxzFKdtpDSkUePKZy/niQ (small blind) showed [4h Jh] and won ($2.85) with a pair of Fours



PokerStars Game #59939261692:  Hold'em No Limit ($0.50/$1.00) - 2009/07/01 0:35:22 ET
Table 'QSIig7BLMc9wY/rgBechzw' 6-max Seat #6 is the button
Seat 1: uuA9hpFU17U5/t4cvpbpBg ($24.05 in chips)
Seat 3: +W6OnF033KNM2xH0fGj98Q ($100 in chips)
Seat 4: +uSzP8Jwnw7sKfQ4s66b7w ($60.50 in chips)
Seat 5: bvU2ZjpVnszLCFVeWbxePg ($115.40 in chips)
Seat 6: KpnW5CcJ4Mg6MeclfKmLrw ($188.60 in chips)
uuA9hpFU17U5/t4cvpbpBg: posts small blind $0.50
0WjiuIT7/EolY1oOx1ngeA: is sitting out
+W6OnF033KNM2xH0fGj98Q: posts big blind $1
*** HOLE CARDS ***
0WjiuIT7/EolY1oOx1ngeA leaves the table
+uSzP8Jwnw7sKfQ4s66b7w: folds
bvU2ZjpVnszLCFVeWbxePg: raises $2 to $3
KpnW5CcJ4Mg6MeclfKmLrw: folds
uuA9hpFU17U5/t4cvpbpBg: folds
+W6OnF033KNM2xH0fGj98Q: raises $8 to $11
bvU2ZjpVnszLCFVeWbxePg: calls $8
*** FLOP *** [4h 8h 5s]
+W6OnF033KNM2xH0fGj98Q: bets $14
bvU2ZjpVnszLCFVeWbxePg: calls $14
*** TURN *** [4h 8h 5s] [4s]
+W6OnF033KNM2xH0fGj98Q: checks
bvU2ZjpVnszLCFVeWbxePg: bets $25
+W6OnF033KNM2xH0fGj98Q: folds
bvU2ZjpVnszLCFVeWbxePg collected $48.50 from pot
bvU2ZjpVnszLCFVeWbxePg: doesn't show hand
*** SUMMARY ***
Total pot $50.50 | Rake $2
Board [4h 8h 5s 4s]
Seat 1: uuA9hpFU17U5/t4cvpbpBg (small blind) folded before Flop
Seat 3: +W6OnF033KNM2xH0fGj98Q (big blind) folded on the Turn
Seat 4: +uSzP8Jwnw7sKfQ4s66b7w folded before Flop (didn't bet)
Seat 5: bvU2ZjpVnszLCFVeWbxePg collected ($48.50)
Seat 6: KpnW5CcJ4Mg6MeclfKmLrw (button) folded before Flop (didn't bet)



PokerStars Game #59939263104:  Hold'em No Limit ($0.50/$1.00) - 2009/07/01 0:35:24 ET
Table '/RZcOwpZpHQ+OwPwjsbnRw' 6-max Seat #6 is the button
Seat 1: Zboa6dColKGHBjLPUakZjw ($53.20 in chips)
Seat 2: +xW7QemQU0Fxs+4TnqBRow ($100 in chips)
Seat 4: j7NIOHLZk7V2o9fOioO5ug ($116.90 in chips)
Seat 5: wx3sQGkVi2x9wJXuWNHPBw ($199.65 in chips)
Seat 6: XOIf9W+VAxhZqN+SYoyMKA ($288.55 in chips)
Zboa6dColKGHBjLPUakZjw: posts small blind $0.50
+xW7QemQU0Fxs+4TnqBRow: posts big blind $1
*** HOLE CARDS ***
j7NIOHLZk7V2o9fOioO5ug: folds
wx3sQGkVi2x9wJXuWNHPBw: folds
XOIf9W+VAxhZqN+SYoyMKA: folds
Zboa6dColKGHBjLPUakZjw: calls $0.50
+xW7QemQU0Fxs+4TnqBRow: raises $3 to $4
Zboa6dColKGHBjLPUakZjw: folds
+xW7QemQU0Fxs+4TnqBRow collected $2 from pot
+xW7QemQU0Fxs+4TnqBRow: doesn't show hand
*** SUMMARY ***
Total pot $2 | Rake $0
Seat 1: Zboa6dColKGHBjLPUakZjw (small blind) folded before Flop
Seat 2: +xW7QemQU0Fxs+4TnqBRow (big blind) collected ($2)
Seat 4: j7NIOHLZk7V2o9fOioO5ug folded before Flop (didn't bet)
Seat 5: wx3sQGkVi2x9wJXuWNHPBw folded before Flop (didn't bet)
Seat 6: XOIf9W+VAxhZqN+SYoyMKA (button) folded before Flop (didn't bet)



PokerStars Game #59939263972:  Hold'em No Limit ($0.50/$1.00) - 2009/07/01 0:35:25 ET
Table 'uNlePsyMIqzM691Xkrlk6Q' 9-max Seat #1 is the button
Seat 1: bLbSOSmSOnqE0iTcH/5dxA ($102.50 in chips)
Seat 2: +OqpStnt0FqbCfyHAWaLbg ($66.45 in chips)
Seat 3: h7qXkU57Bb8ZuPwMyxR8Ug ($20 in chips)
Seat 4: TZcz9MEWDA+WydgGruqqbw ($104.65 in chips)
Seat 6: uMPEfCcGCfsxmy53tVUMug ($113.10 in chips)
Seat 7: w6cw9nzN7AvkkHBVVjykoQ ($44.90 in chips)
Seat 8: OsLmX3x/19szSV115TpL/Q ($37.95 in chips)
Seat 9: vR4IO10geOgvTW+LAUBv/A ($116.30 in chips)
+OqpStnt0FqbCfyHAWaLbg: posts small blind $0.50
h7qXkU57Bb8ZuPwMyxR8Ug: posts big blind $1
3obndzTJ6fECz8+wWhMd1w: sits out
*** HOLE CARDS ***
TZcz9MEWDA+WydgGruqqbw: folds
uMPEfCcGCfsxmy53tVUMug: folds
w6cw9nzN7AvkkHBVVjykoQ: folds
OsLmX3x/19szSV115TpL/Q: calls $1
vR4IO10geOgvTW+LAUBv/A: folds
bLbSOSmSOnqE0iTcH/5dxA: folds
+OqpStnt0FqbCfyHAWaLbg: calls $0.50
h7qXkU57Bb8ZuPwMyxR8Ug: checks
*** FLOP *** [Kc 5s 5d]
+OqpStnt0FqbCfyHAWaLbg: checks
h7qXkU57Bb8ZuPwMyxR8Ug: checks
OsLmX3x/19szSV115TpL/Q: bets $3
+OqpStnt0FqbCfyHAWaLbg: folds
h7qXkU57Bb8ZuPwMyxR8Ug: folds
OsLmX3x/19szSV115TpL/Q collected $2.85 from pot
*** SUMMARY ***
Total pot $3 | Rake $0.15
Board [Kc 5s 5d]
Seat 1: bLbSOSmSOnqE0iTcH/5dxA (button) folded before Flop (didn't bet)
Seat 2: +OqpStnt0FqbCfyHAWaLbg (small blind) folded on the Flop
Seat 3: h7qXkU57Bb8ZuPwMyxR8Ug (big blind) folded on the Flop
Seat 4: TZcz9MEWDA+WydgGruqqbw folded before Flop (didn't bet)
Seat 6: uMPEfCcGCfsxmy53tVUMug folded before Flop (didn't bet)
Seat 7: w6cw9nzN7AvkkHBVVjykoQ folded before Flop (didn't bet)
Seat 8: OsLmX3x/19szSV115TpL/Q collected ($2.85)
Seat 9: vR4IO10geOgvTW+LAUBv/A folded before Flop (didn't bet)



PokerStars Game #59939263640:  Hold'em No Limit ($0.50/$1.00) - 2009/07/01 0:35:25 ET
Table 'QBLDswtHe7Ml0HwAdcMhlw' 2-max Seat #2 is the button
Seat 1: hdNlhiCwI533uwvvTTfC9Q ($103.20 in chips)
Seat 2: GBkvjkjDWVBEa1e14dh6CA ($60 in chips)
GBkvjkjDWVBEa1e14dh6CA: posts small blind $0.50
hdNlhiCwI533uwvvTTfC9Q: posts big blind $1
*** HOLE CARDS ***
GBkvjkjDWVBEa1e14dh6CA: raises $2 to $3
hdNlhiCwI533uwvvTTfC9Q: folds
GBkvjkjDWVBEa1e14dh6CA collected $2 from pot
GBkvjkjDWVBEa1e14dh6CA: doesn't show hand
*** SUMMARY ***
Total pot $2 | Rake $0
Seat 1: hdNlhiCwI533uwvvTTfC9Q (big blind) folded before Flop
Seat 2: GBkvjkjDWVBEa1e14dh6CA (button) (small blind) collected ($2)



PokerStars Game #59939264316:  Hold'em No Limit ($0.50/$1.00) - 2009/07/01 0:35:26 ET
Table '6YvsYDPNIDx2v5z3bJnwZQ' 9-max Seat #6 is the button
Seat 1: Ogn4JDV3mp4ZDKO49IFzKA ($14.50 in chips)
Seat 2: 35DmRulmD2MgzT6Bbt6/2w ($51.95 in chips)
Seat 3: negfosHnGOZXSHpWDRKyBQ ($19.30 in chips)
Seat 4: kEr5NYB+JIG5+szcYMr6hA ($45 in chips)
Seat 5: mBRWbnUl8diyBO1qTJaNzw ($160.70 in chips)
Seat 6: uMPEfCcGCfsxmy53tVUMug ($101.90 in chips)
Seat 7: boixc27eqTYA1p0tUdMuBQ ($114.50 in chips)
Seat 8: PSFxpXgPedVZyHSu2Zhb7Q ($50.25 in chips)
Seat 9: jDwhY1kCdc6EkAHbT7PJMQ ($105.60 in chips)
boixc27eqTYA1p0tUdMuBQ: posts small blind $0.50
PSFxpXgPedVZyHSu2Zhb7Q: posts big blind $1
*** HOLE CARDS ***
jDwhY1kCdc6EkAHbT7PJMQ: folds
Ogn4JDV3mp4ZDKO49IFzKA: folds
35DmRulmD2MgzT6Bbt6/2w: folds
negfosHnGOZXSHpWDRKyBQ: folds
kEr5NYB+JIG5+szcYMr6hA: folds
mBRWbnUl8diyBO1qTJaNzw: folds
uMPEfCcGCfsxmy53tVUMug: raises $2 to $3
boixc27eqTYA1p0tUdMuBQ: folds
PSFxpXgPedVZyHSu2Zhb7Q: calls $2
*** FLOP *** [2h Qc Qs]
PSFxpXgPedVZyHSu2Zhb7Q: checks
uMPEfCcGCfsxmy53tVUMug: bets $4.25
PSFxpXgPedVZyHSu2Zhb7Q: folds
uMPEfCcGCfsxmy53tVUMug collected $6.20 from pot
*** SUMMARY ***
Total pot $6.50 | Rake $0.30
Board [2h Qc Qs]
Seat 1: Ogn4JDV3mp4ZDKO49IFzKA folded before Flop (didn't bet)
Seat 2: 35DmRulmD2MgzT6Bbt6/2w folded before Flop (didn't bet)
Seat 3: negfosHnGOZXSHpWDRKyBQ folded before Flop (didn't bet)
Seat 4: kEr5NYB+JIG5+szcYMr6hA folded before Flop (didn't bet)
Seat 5: mBRWbnUl8diyBO1qTJaNzw folded before Flop (didn't bet)
Seat 6: uMPEfCcGCfsxmy53tVUMug (button) collected ($6.20)
Seat 7: boixc27eqTYA1p0tUdMuBQ (small blind) folded before Flop
Seat 8: PSFxpXgPedVZyHSu2Zhb7Q (big blind) folded on the Flop
Seat 9: jDwhY1kCdc6EkAHbT7PJMQ folded before Flop (didn't bet)



PokerStars Game #59939264142:  Hold'em No Limit ($0.50/$1.00) - 2009/07/01 0:35:26 ET
Table 'hugOjcwJvzEwZbK7tyiWuQ' 9-max Seat #8 is the button
Seat 1: N9n5Wc3s35DpCrOAUUNAaQ ($128.50 in chips)
Seat 2: r27C1nIV4NS4+qbnrgBQSw ($257.05 in chips)
Seat 3: jDwhY1kCdc6EkAHbT7PJMQ ($117.65 in chips)
Seat 4: UWB3oeddt/GObx2Mix2Anw ($199.80 in chips)
Seat 6: gUUvmqdVlmvpal6B8nYrmg ($100 in chips)
Seat 7: FL3MrLspcF23LYvC4ipBOA ($100 in chips)
Seat 8: /zy+DB4S5fUQUSfZWFzYGw ($105.75 in chips)
Seat 9: o6JyUkbzCDw8tUabqtmnlg ($61.70 in chips)
o6JyUkbzCDw8tUabqtmnlg: posts small blind $0.50
N9n5Wc3s35DpCrOAUUNAaQ: posts big blind $1
5BRGWf+R3nt2WS3b5xX+zA: sits out
*** HOLE CARDS ***
r27C1nIV4NS4+qbnrgBQSw: folds
jDwhY1kCdc6EkAHbT7PJMQ: raises $3 to $4
UWB3oeddt/GObx2Mix2Anw: calls $4
gUUvmqdVlmvpal6B8nYrmg: folds
FL3MrLspcF23LYvC4ipBOA: folds
/zy+DB4S5fUQUSfZWFzYGw: folds
o6JyUkbzCDw8tUabqtmnlg: folds
N9n5Wc3s35DpCrOAUUNAaQ: folds
*** FLOP *** [6s 4h 7h]
jDwhY1kCdc6EkAHbT7PJMQ: bets $6
UWB3oeddt/GObx2Mix2Anw: raises $12 to $18
jDwhY1kCdc6EkAHbT7PJMQ: folds
UWB3oeddt/GObx2Mix2Anw collected $20.45 from pot
*** SUMMARY ***
Total pot $21.50 | Rake $1.05
Board [6s 4h 7h]
Seat 1: N9n5Wc3s35DpCrOAUUNAaQ (big blind) folded before Flop
Seat 2: r27C1nIV4NS4+qbnrgBQSw folded before Flop (didn't bet)
Seat 3: jDwhY1kCdc6EkAHbT7PJMQ folded on the Flop
Seat 4: UWB3oeddt/GObx2Mix2Anw collected ($20.45)
Seat 6: gUUvmqdVlmvpal6B8nYrmg folded before Flop (didn't bet)
Seat 7: FL3MrLspcF23LYvC4ipBOA folded before Flop (didn't bet)
Seat 8: /zy+DB4S5fUQUSfZWFzYGw (button) folded before Flop (didn't bet)
Seat 9: o6JyUkbzCDw8tUabqtmnlg (small blind) folded before Flop



PokerStars Game #59939264694:  Hold'em No Limit ($0.50/$1.00) - 2009/07/01 0:35:26 ET
Table 'cBDNutyLBKEk9+ptwsKmTw' 6-max Seat #6 is the button
Seat 1: xAU6q2/cwmby2sxmA8VcmA ($100 in chips)
Seat 2: Gy1fd4JyD1aNBFFlOGzbJQ ($29.85 in chips)
Seat 3: G5ZSSN6RSON3gkNvk/SmYg ($110.40 in chips)
Seat 5: OGMLOcTNYZXZU81au7ztUw ($140.95 in chips)
Seat 6: NqVlOSH2lp+pp/TK3vvK5g ($37.80 in chips)
xAU6q2/cwmby2sxmA8VcmA: posts small blind $0.50
Gy1fd4JyD1aNBFFlOGzbJQ: posts big blind $1
*** HOLE CARDS ***
3q7F5QtzC30pSrn0nl9i+A joins the table at seat #4
G5ZSSN6RSON3gkNvk/SmYg: folds
OGMLOcTNYZXZU81au7ztUw: folds
NqVlOSH2lp+pp/TK3vvK5g: folds
xAU6q2/cwmby2sxmA8VcmA: raises $3 to $4
Gy1fd4JyD1aNBFFlOGzbJQ: folds
xAU6q2/cwmby2sxmA8VcmA collected $2 from pot
xAU6q2/cwmby2sxmA8VcmA: doesn't show hand
*** SUMMARY ***
Total pot $2 | Rake $0
Seat 1: xAU6q2/cwmby2sxmA8VcmA (small blind) collected ($2)
Seat 2: Gy1fd4JyD1aNBFFlOGzbJQ (big blind) folded before Flop
Seat 3: G5ZSSN6RSON3gkNvk/SmYg folded before Flop (didn't bet)
Seat 5: OGMLOcTNYZXZU81au7ztUw folded before Flop (didn't bet)
Seat 6: NqVlOSH2lp+pp/TK3vvK5g (button) folded before Flop (didn't bet)



PokerStars Game #59939266322:  Hold'em No Limit ($0.50/$1.00) - 2009/07/01 0:35:29 ET
Table 'GxCPo/gd3OSthkYrAxJngg' 6-max Seat #4 is the button
Seat 1: sH8BpAFP+jGFxCgVpD1Lew ($276.95 in chips)
Seat 2: YExX2paeIHrmfIwV1ivM/w ($63.70 in chips)
Seat 3: o6plE+MSW4XFNTeONe16xg ($34.10 in chips)
Seat 4: YMJG+F++3Aj6P8dAWda5fw ($108.15 in chips)
Seat 5: G5ZSSN6RSON3gkNvk/SmYg ($102.20 in chips)
Seat 6: sS9IXedL3MiRmpVXhAILhw ($102.45 in chips)
G5ZSSN6RSON3gkNvk/SmYg: posts small blind $0.50
sS9IXedL3MiRmpVXhAILhw: posts big blind $1
*** HOLE CARDS ***
sH8BpAFP+jGFxCgVpD1Lew: folds
YExX2paeIHrmfIwV1ivM/w: folds
o6plE+MSW4XFNTeONe16xg: folds
YMJG+F++3Aj6P8dAWda5fw: folds
G5ZSSN6RSON3gkNvk/SmYg: folds
sS9IXedL3MiRmpVXhAILhw collected $1 from pot
*** SUMMARY ***
Total pot $1 | Rake $0
Seat 1: sH8BpAFP+jGFxCgVpD1Lew folded before Flop (didn't bet)
Seat 2: YExX2paeIHrmfIwV1ivM/w folded before Flop (didn't bet)
Seat 3: o6plE+MSW4XFNTeONe16xg folded before Flop (didn't bet)
Seat 4: YMJG+F++3Aj6P8dAWda5fw (button) folded before Flop (didn't bet)
Seat 5: G5ZSSN6RSON3gkNvk/SmYg (small blind) folded before Flop
Seat 6: sS9IXedL3MiRmpVXhAILhw (big blind) collected ($1)



PokerStars Game #59939266998:  Hold'em No Limit ($0.50/$1.00) - 2009/07/01 0:35:30 ET
Table 'MUPc8FEpe/nR0BKSeReX6Q' 6-max Seat #2 is the button
Seat 1: YsLQ3BAvgQHWXMAv3Wv6Hg ($100 in chips)
Seat 2: xAU6q2/cwmby2sxmA8VcmA ($111.70 in chips)
Seat 3: wx3sQGkVi2x9wJXuWNHPBw ($234.55 in chips)
Seat 4: ZA1bp6g8IwtTxkUE4eCjDQ ($126.85 in chips)
Seat 5: UBZQqpnJZdTYYY1FTb0rLA ($100 in chips)
Seat 6: oxnw0GLLpFanjhGkxfRSqA ($48.10 in chips)
wx3sQGkVi2x9wJXuWNHPBw: posts small blind $0.50
ZA1bp6g8IwtTxkUE4eCjDQ: posts big blind $1
*** HOLE CARDS ***
UBZQqpnJZdTYYY1FTb0rLA: folds
oxnw0GLLpFanjhGkxfRSqA: raises $3 to $4
YsLQ3BAvgQHWXMAv3Wv6Hg: folds
xAU6q2/cwmby2sxmA8VcmA: folds
wx3sQGkVi2x9wJXuWNHPBw: folds
ZA1bp6g8IwtTxkUE4eCjDQ: raises $11 to $15
oxnw0GLLpFanjhGkxfRSqA: raises $33.10 to $48.10 and is all-in
ZA1bp6g8IwtTxkUE4eCjDQ: calls $33.10
*** FLOP *** [7c 5d Ts]
*** TURN *** [7c 5d Ts] [4h]
*** RIVER *** [7c 5d Ts 4h] [Jh]
*** SHOW DOWN ***
ZA1bp6g8IwtTxkUE4eCjDQ: shows [Kc Ks] (a pair of Kings)
oxnw0GLLpFanjhGkxfRSqA: mucks hand
ZA1bp6g8IwtTxkUE4eCjDQ collected $93.70 from pot
*** SUMMARY ***
Total pot $96.70 | Rake $3
Board [7c 5d Ts 4h Jh]
Seat 1: YsLQ3BAvgQHWXMAv3Wv6Hg folded before Flop (didn't bet)
Seat 2: xAU6q2/cwmby2sxmA8VcmA (button) folded before Flop (didn't bet)
Seat 3: wx3sQGkVi2x9wJXuWNHPBw (small blind) folded before Flop
Seat 4: ZA1bp6g8IwtTxkUE4eCjDQ (big blind) showed [Kc Ks] and won ($93.70) with a pair of Kings
Seat 5: UBZQqpnJZdTYYY1FTb0rLA folded before Flop (didn't bet)
Seat 6: oxnw0GLLpFanjhGkxfRSqA mucked



PokerStars Game #59939268384:  Hold'em No Limit ($0.50/$1.00) - 2009/07/01 0:35:32 ET
Table 'VOs36P6NW+QyXeQ1B62kmA' 6-max Seat #1 is the button
Seat 1: AdLVjddOzm+sRNo1Bc3S6Q ($138.15 in chips)
Seat 2: KpnW5CcJ4Mg6MeclfKmLrw ($112.30 in chips)
Seat 3: TSuRyAHnUPCFjP7Z0rEE0w ($100 in chips)
Seat 4: w02zQzNydODiyV9THKgo9w ($42.80 in chips)
Seat 5: X7GlkHF+lkbarCLuZ4Uf0w ($24.25 in chips)
Seat 6: 6tvjsJrdmWg+g7FVrMnzXA ($61.60 in chips)
KpnW5CcJ4Mg6MeclfKmLrw: posts small blind $0.50
TSuRyAHnUPCFjP7Z0rEE0w: posts big blind $1
*** HOLE CARDS ***
w02zQzNydODiyV9THKgo9w: folds
X7GlkHF+lkbarCLuZ4Uf0w: folds
6tvjsJrdmWg+g7FVrMnzXA: raises $2 to $3
AdLVjddOzm+sRNo1Bc3S6Q: calls $3
KpnW5CcJ4Mg6MeclfKmLrw: folds
TSuRyAHnUPCFjP7Z0rEE0w: folds
*** FLOP *** [Qh 4s 9h]
6tvjsJrdmWg+g7FVrMnzXA: checks
AdLVjddOzm+sRNo1Bc3S6Q: bets $5
6tvjsJrdmWg+g7FVrMnzXA: folds
AdLVjddOzm+sRNo1Bc3S6Q collected $7.15 from pot
AdLVjddOzm+sRNo1Bc3S6Q: doesn't show hand
*** SUMMARY ***
Total pot $7.50 | Rake $0.35
Board [Qh 4s 9h]
Seat 1: AdLVjddOzm+sRNo1Bc3S6Q (button) collected ($7.15)
Seat 2: KpnW5CcJ4Mg6MeclfKmLrw (small blind) folded before Flop
Seat 3: TSuRyAHnUPCFjP7Z0rEE0w (big blind) folded before Flop
Seat 4: w02zQzNydODiyV9THKgo9w folded before Flop (didn't bet)
Seat 5: X7GlkHF+lkbarCLuZ4Uf0w folded before Flop (didn't bet)
Seat 6: 6tvjsJrdmWg+g7FVrMnzXA folded on the Flop



PokerStars Game #59939269566:  Hold'em No Limit ($0.50/$1.00) - 2009/07/01 0:35:34 ET
Table 'QBLDswtHe7Ml0HwAdcMhlw' 2-max Seat #1 is the button
Seat 1: hdNlhiCwI533uwvvTTfC9Q ($102.20 in chips)
Seat 2: GBkvjkjDWVBEa1e14dh6CA ($61 in chips)
hdNlhiCwI533uwvvTTfC9Q: posts small blind $0.50
GBkvjkjDWVBEa1e14dh6CA: posts big blind $1
*** HOLE CARDS ***
hdNlhiCwI533uwvvTTfC9Q: raises $1 to $2
GBkvjkjDWVBEa1e14dh6CA: raises $5 to $7
hdNlhiCwI533uwvvTTfC9Q: folds
GBkvjkjDWVBEa1e14dh6CA collected $4 from pot
GBkvjkjDWVBEa1e14dh6CA: doesn't show hand
*** SUMMARY ***
Total pot $4 | Rake $0
Seat 1: hdNlhiCwI533uwvvTTfC9Q (button) (small blind) folded before Flop
Seat 2: GBkvjkjDWVBEa1e14dh6CA (big blind) collected ($4)



PokerStars Game #59939270256:  Hold'em No Limit ($0.50/$1.00) - 2009/07/01 0:35:35 ET
Table 'pHrhryH8jPNdQfY62f8v+g' 6-max Seat #6 is the button
Seat 1: BdbmJTZZ47quA9vUWwXtlw ($109.60 in chips)
Seat 2: RqgF7gRoKgRNW8Zoi1ty4A ($115 in chips)
Seat 4: wenbG7TaM3H7h5kn78OFNw ($58.30 in chips)
Seat 5: r1/R7y0Ortgoz4lccgW8VA ($19.75 in chips)
Seat 6: xAU6q2/cwmby2sxmA8VcmA ($102.80 in chips)
BdbmJTZZ47quA9vUWwXtlw: posts small blind $0.50
RqgF7gRoKgRNW8Zoi1ty4A: posts big blind $1
*** HOLE CARDS ***
wenbG7TaM3H7h5kn78OFNw: folds
r1/R7y0Ortgoz4lccgW8VA: calls $1
xAU6q2/cwmby2sxmA8VcmA: folds
BdbmJTZZ47quA9vUWwXtlw: raises $3 to $4
RqgF7gRoKgRNW8Zoi1ty4A: folds
r1/R7y0Ortgoz4lccgW8VA: calls $3
*** FLOP *** [4d 6h 9h]
BdbmJTZZ47quA9vUWwXtlw: bets $4
r1/R7y0Ortgoz4lccgW8VA: raises $11.75 to $15.75 and is all-in
BdbmJTZZ47quA9vUWwXtlw: calls $11.75
*** TURN *** [4d 6h 9h] [Ad]
*** RIVER *** [4d 6h 9h Ad] [Td]
*** SHOW DOWN ***
BdbmJTZZ47quA9vUWwXtlw: shows [Kd Kc] (a pair of Kings)
r1/R7y0Ortgoz4lccgW8VA: shows [8s 7c] (a straight, Six to Ten)
r1/R7y0Ortgoz4lccgW8VA collected $38.50 from pot
*** SUMMARY ***
Total pot $40.50 | Rake $2
Board [4d 6h 9h Ad Td]
Seat 1: BdbmJTZZ47quA9vUWwXtlw (small blind) showed [Kd Kc] and lost with a pair of Kings
Seat 2: RqgF7gRoKgRNW8Zoi1ty4A (big blind) folded before Flop
Seat 4: wenbG7TaM3H7h5kn78OFNw folded before Flop (didn't bet)
Seat 5: r1/R7y0Ortgoz4lccgW8VA showed [8s 7c] and won ($38.50) with a straight, Six to Ten
Seat 6: xAU6q2/cwmby2sxmA8VcmA (button) folded before Flop (didn't bet)



PokerStars Game #59939277556:  Hold'em No Limit ($0.50/$1.00) - 2009/07/01 0:35:46 ET
Table 'LmXQK9xy3awB+qsPzI21Mw' 2-max Seat #2 is the button
Seat 1: NYi6JFscYNrofSXy4sM+Yw ($241.55 in chips)
Seat 2: TME8GvochpQAo8cmJwWmvA ($100 in chips)
TME8GvochpQAo8cmJwWmvA: posts small blind $0.50
NYi6JFscYNrofSXy4sM+Yw: posts big blind $1
*** HOLE CARDS ***
TME8GvochpQAo8cmJwWmvA: folds
NYi6JFscYNrofSXy4sM+Yw collected $1 from pot
*** SUMMARY ***
Total pot $1 | Rake $0
Seat 1: NYi6JFscYNrofSXy4sM+Yw (big blind) collected ($1)
Seat 2: TME8GvochpQAo8cmJwWmvA (button) (small blind) folded before Flop



PokerStars Game #59939279878:  Hold'em No Limit ($0.50/$1.00) - 2009/07/01 0:35:50 ET
Table 'rmZfTK+oSebeUPJNbWhdAA' 6-max Seat #3 is the button
Seat 1: xAU6q2/cwmby2sxmA8VcmA ($100 in chips)
Seat 3: 9yjOzGERLaEZS8CZ6YNHFg ($114.40 in chips)
Seat 4: OGMLOcTNYZXZU81au7ztUw ($130.85 in chips)
Seat 5: +xW7QemQU0Fxs+4TnqBRow ($100 in chips)
Seat 6: j7NIOHLZk7V2o9fOioO5ug ($132.50 in chips)
OGMLOcTNYZXZU81au7ztUw: posts small blind $0.50
+xW7QemQU0Fxs+4TnqBRow: posts big blind $1
*** HOLE CARDS ***
j7NIOHLZk7V2o9fOioO5ug: raises $2 to $3
xAU6q2/cwmby2sxmA8VcmA: folds
9yjOzGERLaEZS8CZ6YNHFg: folds
OGMLOcTNYZXZU81au7ztUw: folds
+xW7QemQU0Fxs+4TnqBRow: folds
j7NIOHLZk7V2o9fOioO5ug collected $2.50 from pot
j7NIOHLZk7V2o9fOioO5ug: doesn't show hand
z7O9PO/WEcqRouIydFhS9Q joins the table at seat #2
*** SUMMARY ***
Total pot $2.50 | Rake $0
Seat 1: xAU6q2/cwmby2sxmA8VcmA folded before Flop (didn't bet)
Seat 3: 9yjOzGERLaEZS8CZ6YNHFg (button) folded before Flop (didn't bet)
Seat 4: OGMLOcTNYZXZU81au7ztUw (small blind) folded before Flop
Seat 5: +xW7QemQU0Fxs+4TnqBRow (big blind) folded before Flop
Seat 6: j7NIOHLZk7V2o9fOioO5ug collected ($2.50)



PokerStars Game #59939281294:  Hold'em No Limit ($0.50/$1.00) - 2009/07/01 0:35:52 ET
Table 'LmXQK9xy3awB+qsPzI21Mw' 2-max Seat #1 is the button
Seat 1: NYi6JFscYNrofSXy4sM+Yw ($242.05 in chips)
Seat 2: TME8GvochpQAo8cmJwWmvA ($99.50 in chips)
NYi6JFscYNrofSXy4sM+Yw: posts small blind $0.50
TME8GvochpQAo8cmJwWmvA: posts big blind $1
*** HOLE CARDS ***
NYi6JFscYNrofSXy4sM+Yw: folds
TME8GvochpQAo8cmJwWmvA collected $1 from pot
TME8GvochpQAo8cmJwWmvA: doesn't show hand
*** SUMMARY ***
Total pot $1 | Rake $0
Seat 1: NYi6JFscYNrofSXy4sM+Yw (button) (small blind) folded before Flop
Seat 2: TME8GvochpQAo8cmJwWmvA (big blind) collected ($1)



PokerStars Game #59939282910:  Hold'em No Limit ($0.50/$1.00) - 2009/07/01 0:35:54 ET
Table '+cA8mcmhaedZ7YcrDdhmeQ' 6-max Seat #3 is the button
Seat 1: lsLuWlcPA3Rh7kJVLzMh0Q ($304.25 in chips)
Seat 2: RqgF7gRoKgRNW8Zoi1ty4A ($104.20 in chips)
Seat 3: 7H5WkGzGvsv56y1iaqHvRg ($44.55 in chips)
Seat 4: LjL3AIERHn559yyW1mTUYQ ($156 in chips)
Seat 5: iHo1oDbrEVJ8nEGdaPrICw ($100 in chips)
Seat 6: YfsTQsY/fxb+YqbdclTHuw ($51.95 in chips)
LjL3AIERHn559yyW1mTUYQ: posts small blind $0.50
iHo1oDbrEVJ8nEGdaPrICw: posts big blind $1
*** HOLE CARDS ***
YfsTQsY/fxb+YqbdclTHuw: calls $1
lsLuWlcPA3Rh7kJVLzMh0Q: folds
RqgF7gRoKgRNW8Zoi1ty4A: folds
7H5WkGzGvsv56y1iaqHvRg: folds
LjL3AIERHn559yyW1mTUYQ: folds
iHo1oDbrEVJ8nEGdaPrICw: checks
*** FLOP *** [Ah Qs 2c]
iHo1oDbrEVJ8nEGdaPrICw: checks
YfsTQsY/fxb+YqbdclTHuw: checks
*** TURN *** [Ah Qs 2c] [8d]
iHo1oDbrEVJ8nEGdaPrICw: checks
YfsTQsY/fxb+YqbdclTHuw: bets $2
iHo1oDbrEVJ8nEGdaPrICw: folds
YfsTQsY/fxb+YqbdclTHuw collected $2.40 from pot
*** SUMMARY ***
Total pot $2.50 | Rake $0.10
Board [Ah Qs 2c 8d]
Seat 1: lsLuWlcPA3Rh7kJVLzMh0Q folded before Flop (didn't bet)
Seat 2: RqgF7gRoKgRNW8Zoi1ty4A folded before Flop (didn't bet)
Seat 3: 7H5WkGzGvsv56y1iaqHvRg (button) folded before Flop (didn't bet)
Seat 4: LjL3AIERHn559yyW1mTUYQ (small blind) folded before Flop
Seat 5: iHo1oDbrEVJ8nEGdaPrICw (big blind) folded on the Turn
Seat 6: YfsTQsY/fxb+YqbdclTHuw collected ($2.40)



PokerStars Game #59939283672:  Hold'em No Limit ($0.50/$1.00) - 2009/07/01 0:35:55 ET
Table 'QBLDswtHe7Ml0HwAdcMhlw' 2-max Seat #2 is the button
Seat 1: hdNlhiCwI533uwvvTTfC9Q ($100.20 in chips)
Seat 2: GBkvjkjDWVBEa1e14dh6CA ($63 in chips)
GBkvjkjDWVBEa1e14dh6CA: posts small blind $0.50
hdNlhiCwI533uwvvTTfC9Q: posts big blind $1
*** HOLE CARDS ***
GBkvjkjDWVBEa1e14dh6CA: folds
hdNlhiCwI533uwvvTTfC9Q collected $1 from pot
hdNlhiCwI533uwvvTTfC9Q: doesn't show hand
*** SUMMARY ***
Total pot $1 | Rake $0
Seat 1: hdNlhiCwI533uwvvTTfC9Q (big blind) collected ($1)
Seat 2: GBkvjkjDWVBEa1e14dh6CA (button) (small blind) folded before Flop



PokerStars Game #59939283854:  Hold'em No Limit ($0.50/$1.00) - 2009/07/01 0:35:56 ET
Table '/RZcOwpZpHQ+OwPwjsbnRw' 6-max Seat #1 is the button
Seat 1: Zboa6dColKGHBjLPUakZjw ($52.20 in chips)
Seat 2: +xW7QemQU0Fxs+4TnqBRow ($101 in chips)
Seat 4: j7NIOHLZk7V2o9fOioO5ug ($116.90 in chips)
Seat 5: wx3sQGkVi2x9wJXuWNHPBw ($199.65 in chips)
Seat 6: XOIf9W+VAxhZqN+SYoyMKA ($288.55 in chips)
+xW7QemQU0Fxs+4TnqBRow: posts small blind $0.50
j7NIOHLZk7V2o9fOioO5ug: posts big blind $1
*** HOLE CARDS ***
wx3sQGkVi2x9wJXuWNHPBw: folds
XOIf9W+VAxhZqN+SYoyMKA: raises $2 to $3
Zboa6dColKGHBjLPUakZjw: folds
+xW7QemQU0Fxs+4TnqBRow: folds
j7NIOHLZk7V2o9fOioO5ug: folds
XOIf9W+VAxhZqN+SYoyMKA collected $2.50 from pot
XOIf9W+VAxhZqN+SYoyMKA: doesn't show hand
*** SUMMARY ***
Total pot $2.50 | Rake $0
Seat 1: Zboa6dColKGHBjLPUakZjw (button) folded before Flop (didn't bet)
Seat 2: +xW7QemQU0Fxs+4TnqBRow (small blind) folded before Flop
Seat 4: j7NIOHLZk7V2o9fOioO5ug (big blind) folded before Flop
Seat 5: wx3sQGkVi2x9wJXuWNHPBw folded before Flop (didn't bet)
Seat 6: XOIf9W+VAxhZqN+SYoyMKA collected ($2.50)



PokerStars Game #59939285036:  Hold'em No Limit ($0.50/$1.00) - 2009/07/01 0:35:57 ET
Table 'SQLOQoANiHscJ8AL7zffbw' 9-max Seat #1 is the button
Seat 1: jPTRd6SpCp4xqAy2XQiTOw ($114.60 in chips)
Seat 2: /zy+DB4S5fUQUSfZWFzYGw ($276.85 in chips)
Seat 3: 0eFnow7+D7veCYQ+CG9FFw ($74.15 in chips)
Seat 4: N9n5Wc3s35DpCrOAUUNAaQ ($96.35 in chips)
Seat 5: L9njYvloJ1NdXjP8edHEAg ($109.05 in chips)
Seat 6: p5UKaxVobvptF0ANhR/q1A ($148.50 in chips)
Seat 7: bJckevFOcg//s0qyMQI6sQ ($102.05 in chips)
Seat 9: qJr25HAtvv1w/7IBvjMM3g ($239.75 in chips)
/zy+DB4S5fUQUSfZWFzYGw: posts small blind $0.50
0eFnow7+D7veCYQ+CG9FFw: posts big blind $1
barrelproof7: sits out
*** HOLE CARDS ***
N9n5Wc3s35DpCrOAUUNAaQ: folds
L9njYvloJ1NdXjP8edHEAg: folds
p5UKaxVobvptF0ANhR/q1A: raises $3 to $4
bJckevFOcg//s0qyMQI6sQ: calls $4
qJr25HAtvv1w/7IBvjMM3g: folds
jPTRd6SpCp4xqAy2XQiTOw: calls $4
/zy+DB4S5fUQUSfZWFzYGw: folds
0eFnow7+D7veCYQ+CG9FFw: folds
*** FLOP *** [5c 7s Jh]
p5UKaxVobvptF0ANhR/q1A: bets $9
bJckevFOcg//s0qyMQI6sQ: calls $9
jPTRd6SpCp4xqAy2XQiTOw: folds
*** TURN *** [5c 7s Jh] [4d]
p5UKaxVobvptF0ANhR/q1A: checks
bJckevFOcg//s0qyMQI6sQ: bets $15
p5UKaxVobvptF0ANhR/q1A: calls $15
*** RIVER *** [5c 7s Jh 4d] [6s]
p5UKaxVobvptF0ANhR/q1A: bets $23
bJckevFOcg//s0qyMQI6sQ: folds
p5UKaxVobvptF0ANhR/q1A collected $58.50 from pot
*** SUMMARY ***
Total pot $61.50 | Rake $3
Board [5c 7s Jh 4d 6s]
Seat 1: jPTRd6SpCp4xqAy2XQiTOw (button) folded on the Flop
Seat 2: /zy+DB4S5fUQUSfZWFzYGw (small blind) folded before Flop
Seat 3: 0eFnow7+D7veCYQ+CG9FFw (big blind) folded before Flop
Seat 4: N9n5Wc3s35DpCrOAUUNAaQ folded before Flop (didn't bet)
Seat 5: L9njYvloJ1NdXjP8edHEAg folded before Flop (didn't bet)
Seat 6: p5UKaxVobvptF0ANhR/q1A collected ($58.50)
Seat 7: bJckevFOcg//s0qyMQI6sQ folded on the River
Seat 9: qJr25HAtvv1w/7IBvjMM3g folded before Flop (didn't bet)



PokerStars Game #59939285410:  Hold'em No Limit ($0.50/$1.00) - 2009/07/01 0:35:58 ET
Table 'LmXQK9xy3awB+qsPzI21Mw' 2-max Seat #2 is the button
Seat 1: NYi6JFscYNrofSXy4sM+Yw ($241.55 in chips)
Seat 2: TME8GvochpQAo8cmJwWmvA ($100 in chips)
TME8GvochpQAo8cmJwWmvA: posts small blind $0.50
NYi6JFscYNrofSXy4sM+Yw: posts big blind $1
*** HOLE CARDS ***
TME8GvochpQAo8cmJwWmvA: raises $1 to $2
NYi6JFscYNrofSXy4sM+Yw: calls $1
*** FLOP *** [5h Tc Kd]
NYi6JFscYNrofSXy4sM+Yw: checks
TME8GvochpQAo8cmJwWmvA: bets $2
NYi6JFscYNrofSXy4sM+Yw: folds
TME8GvochpQAo8cmJwWmvA collected $3.80 from pot
TME8GvochpQAo8cmJwWmvA: doesn't show hand
*** SUMMARY ***
Total pot $4 | Rake $0.20
Board [5h Tc Kd]
Seat 1: NYi6JFscYNrofSXy4sM+Yw (big blind) folded on the Flop
Seat 2: TME8GvochpQAo8cmJwWmvA (button) (small blind) collected ($3.80)



PokerStars Game #59939286654:  Hold'em No Limit ($0.50/$1.00) - 2009/07/01 0:36:00 ET
Table '/FUb199IViHMJHi5YWmeuQ' 9-max Seat #3 is the button
Seat 1: TZcz9MEWDA+WydgGruqqbw ($101.85 in chips)
Seat 2: FL3MrLspcF23LYvC4ipBOA ($136.20 in chips)
Seat 3: qN483QJ1NvHbdIZB7J4ARw ($72.70 in chips)
Seat 4: qheQay5YvP2DMAb3OUSxtw ($106.30 in chips)
Seat 5: BbWpm6CYaA1D8P5EYEEwkQ ($25 in chips)
Seat 6: ccFf7Q4z1cTGQmeoYiWEfw ($41.95 in chips)
Seat 7: bLbSOSmSOnqE0iTcH/5dxA ($100 in chips)
Seat 8: QIWvt0R766g8KfH0vl1s0A ($32.90 in chips)
Seat 9: knewtTmBc4Tc0z/5tAABYQ ($155.15 in chips)
qheQay5YvP2DMAb3OUSxtw: posts small blind $0.50
BbWpm6CYaA1D8P5EYEEwkQ: posts big blind $1
*** HOLE CARDS ***
ccFf7Q4z1cTGQmeoYiWEfw: folds
bLbSOSmSOnqE0iTcH/5dxA: folds
QIWvt0R766g8KfH0vl1s0A: folds
knewtTmBc4Tc0z/5tAABYQ: raises $3 to $4
TZcz9MEWDA+WydgGruqqbw: folds
FL3MrLspcF23LYvC4ipBOA: folds
qN483QJ1NvHbdIZB7J4ARw: folds
qheQay5YvP2DMAb3OUSxtw: folds
BbWpm6CYaA1D8P5EYEEwkQ: calls $3
*** FLOP *** [3s 2c Jd]
BbWpm6CYaA1D8P5EYEEwkQ: checks
knewtTmBc4Tc0z/5tAABYQ: bets $6
BbWpm6CYaA1D8P5EYEEwkQ: calls $6
*** TURN *** [3s 2c Jd] [Kc]
BbWpm6CYaA1D8P5EYEEwkQ: bets $5
knewtTmBc4Tc0z/5tAABYQ: calls $5
*** RIVER *** [3s 2c Jd Kc] [As]
BbWpm6CYaA1D8P5EYEEwkQ: bets $10 and is all-in
knewtTmBc4Tc0z/5tAABYQ: calls $10
*** SHOW DOWN ***
BbWpm6CYaA1D8P5EYEEwkQ: shows [Ac 6h] (a pair of Aces)
knewtTmBc4Tc0z/5tAABYQ: shows [Ts Qs] (a straight, Ten to Ace)
knewtTmBc4Tc0z/5tAABYQ collected $48.05 from pot
*** SUMMARY ***
Total pot $50.50 | Rake $2.45
Board [3s 2c Jd Kc As]
Seat 1: TZcz9MEWDA+WydgGruqqbw folded before Flop (didn't bet)
Seat 2: FL3MrLspcF23LYvC4ipBOA folded before Flop (didn't bet)
Seat 3: qN483QJ1NvHbdIZB7J4ARw (button) folded before Flop (didn't bet)
Seat 4: qheQay5YvP2DMAb3OUSxtw (small blind) folded before Flop
Seat 5: BbWpm6CYaA1D8P5EYEEwkQ (big blind) showed [Ac 6h] and lost with a pair of Aces
Seat 6: ccFf7Q4z1cTGQmeoYiWEfw folded before Flop (didn't bet)
Seat 7: bLbSOSmSOnqE0iTcH/5dxA folded before Flop (didn't bet)
Seat 8: QIWvt0R766g8KfH0vl1s0A folded before Flop (didn't bet)
Seat 9: knewtTmBc4Tc0z/5tAABYQ showed [Ts Qs] and won ($48.05) with a straight, Ten to Ace



PokerStars Game #59939287670:  Hold'em No Limit ($0.50/$1.00) - 2009/07/01 0:36:01 ET
Table 'tyUh+jyNvrceIQdKMJjQ2wZFWj23PMihdwrNWv41OG/Qeat #2 is the button
Seat 1: o8A5MUdudVKu+pAwgZOX2w ($218.55 in chips)
Seat 2: m1sJRkJZ1wu5i1BdgeO2Jw ($16 in chips)
Seat 3: TalCiLYHCd+ffkmR3auPvA ($57 in chips)
Seat 4: TSuRyAHnUPCFjP7Z0rEE0w ($108.25 in chips)
Seat 5: j7NIOHLZk7V2o9fOioO5ug ($119.10 in chips)
Seat 6: YsLQ3BAvgQHWXMAv3Wv6Hg ($162.25 in chips)
TalCiLYHCd+ffkmR3auPvA: posts small blind $0.50
TSuRyAHnUPCFjP7Z0rEE0w: posts big blind $1
o8A5MUdudVKu+pAwgZOX2w: posts big blind $1
*** HOLE CARDS ***
j7NIOHLZk7V2o9fOioO5ug: raises $3 to $4
YsLQ3BAvgQHWXMAv3Wv6Hg: folds
o8A5MUdudVKu+pAwgZOX2w: folds
m1sJRkJZ1wu5i1BdgeO2Jw: folds
TalCiLYHCd+ffkmR3auPvA: folds
TSuRyAHnUPCFjP7Z0rEE0w: folds
j7NIOHLZk7V2o9fOioO5ug collected $3.50 from pot
j7NIOHLZk7V2o9fOioO5ug: doesn't show hand
*** SUMMARY ***
Total pot $3.50 | Rake $0
Seat 1: o8A5MUdudVKu+pAwgZOX2w folded before Flop
Seat 2: m1sJRkJZ1wu5i1BdgeO2Jw (button) folded before Flop (didn't bet)
Seat 3: TalCiLYHCd+ffkmR3auPvA (small blind) folded before Flop
Seat 4: TSuRyAHnUPCFjP7Z0rEE0w (big blind) folded before Flop
Seat 5: j7NIOHLZk7V2o9fOioO5ug collected ($3.50)
Seat 6: YsLQ3BAvgQHWXMAv3Wv6Hg folded before Flop (didn't bet)



PokerStars Game #59939287148:  Hold'em No Limit ($0.50/$1.00) - 2009/07/01 0:36:01 ET
Table 'cBDNutyLBKEk9+ptwsKmTw' 6-max Seat #1 is the button
Seat 1: xAU6q2/cwmby2sxmA8VcmA ($101 in chips)
Seat 2: Gy1fd4JyD1aNBFFlOGzbJQ ($28.85 in chips)
Seat 3: G5ZSSN6RSON3gkNvk/SmYg ($110.40 in chips)
Seat 5: OGMLOcTNYZXZU81au7ztUw ($140.95 in chips)
Seat 6: NqVlOSH2lp+pp/TK3vvK5g ($37.80 in chips)
Gy1fd4JyD1aNBFFlOGzbJQ: posts small blind $0.50
G5ZSSN6RSON3gkNvk/SmYg: posts big blind $1
3q7F5QtzC30pSrn0nl9i+A: sits out
*** HOLE CARDS ***
OGMLOcTNYZXZU81au7ztUw: folds
NqVlOSH2lp+pp/TK3vvK5g: raises $1 to $2
xAU6q2/cwmby2sxmA8VcmA: folds
Gy1fd4JyD1aNBFFlOGzbJQ: calls $1.50
G5ZSSN6RSON3gkNvk/SmYg: folds
*** FLOP *** [9h 7s 2d]
Gy1fd4JyD1aNBFFlOGzbJQ: bets $3
NqVlOSH2lp+pp/TK3vvK5g: calls $3
*** TURN *** [9h 7s 2d] [4c]
Gy1fd4JyD1aNBFFlOGzbJQ: bets $6
NqVlOSH2lp+pp/TK3vvK5g: calls $6
*** RIVER *** [9h 7s 2d 4c] [3c]
Gy1fd4JyD1aNBFFlOGzbJQ: checks
NqVlOSH2lp+pp/TK3vvK5g: checks
*** SHOW DOWN ***
Gy1fd4JyD1aNBFFlOGzbJQ: shows [5s 8s] (high card Nine)
NqVlOSH2lp+pp/TK3vvK5g: shows [Ks Jd] (high card King)
NqVlOSH2lp+pp/TK3vvK5g collected $21.90 from pot
*** SUMMARY ***
Total pot $23 | Rake $1.10
Board [9h 7s 2d 4c 3c]
Seat 1: xAU6q2/cwmby2sxmA8VcmA (button) folded before Flop (didn't bet)
Seat 2: Gy1fd4JyD1aNBFFlOGzbJQ (small blind) showed [5s 8s] and lost with high card Nine
Seat 3: G5ZSSN6RSON3gkNvk/SmYg (big blind) folded before Flop
Seat 5: OGMLOcTNYZXZU81au7ztUw folded before Flop (didn't bet)
Seat 6: NqVlOSH2lp+pp/TK3vvK5g showed [Ks Jd] and won ($21.90) with high card King



PokerStars Game #59939288138:  Hold'em No Limit ($0.50/$1.00) - 2009/07/01 0:36:02 ET
Table 'QBLDswtHe7Ml0HwAdcMhlw' 2-max Seat #1 is the button
Seat 1: hdNlhiCwI533uwvvTTfC9Q ($100.70 in chips)
Seat 2: GBkvjkjDWVBEa1e14dh6CA ($62.50 in chips)
hdNlhiCwI533uwvvTTfC9Q: posts small blind $0.50
GBkvjkjDWVBEa1e14dh6CA: posts big blind $1
*** HOLE CARDS ***
hdNlhiCwI533uwvvTTfC9Q: raises $2 to $3
GBkvjkjDWVBEa1e14dh6CA: folds
hdNlhiCwI533uwvvTTfC9Q collected $2 from pot
hdNlhiCwI533uwvvTTfC9Q: doesn't show hand
*** SUMMARY ***
Total pot $2 | Rake $0
Seat 1: hdNlhiCwI533uwvvTTfC9Q (button) (small blind) collected ($2)
Seat 2: GBkvjkjDWVBEa1e14dh6CA (big blind) folded before Flop



PokerStars Game #59939288632:  Hold'em No Limit ($0.50/$1.00) - 2009/07/01 0:36:03 ET
Table '8jIjWCPY0NGprquL+xcMFg' 9-max Seat #1 is the button
Seat 1: vR4IO10geOgvTW+LAUBv/A ($132.30 in chips)
Seat 2: rR1qGAf9Q9RYorKYWH3VKw ($6.20 in chips)
Seat 3: tjhwe1V98x2spSoUQER3HQ ($100 in chips)
Seat 4: by0z+YmujwI6Bf4qRFE8vA ($147.45 in chips)
Seat 6: GTQkFJtSkbVbnGCktp6e3g ($100 in chips)
Seat 7: O3CGPwwUmamrCNHccOilrg ($53.05 in chips)
Seat 8: 9swGhtpERPngKPtvpoZkoQ ($150.30 in chips)
Seat 9: negfosHnGOZXSHpWDRKyBQ ($18.50 in chips)
rR1qGAf9Q9RYorKYWH3VKw: posts small blind $0.50
tjhwe1V98x2spSoUQER3HQ: posts big blind $1
*** HOLE CARDS ***
by0z+YmujwI6Bf4qRFE8vA: calls $1
GTQkFJtSkbVbnGCktp6e3g: folds
O3CGPwwUmamrCNHccOilrg: folds
9swGhtpERPngKPtvpoZkoQ: folds
negfosHnGOZXSHpWDRKyBQ: folds
vR4IO10geOgvTW+LAUBv/A: calls $1
rR1qGAf9Q9RYorKYWH3VKw: calls $0.50
tjhwe1V98x2spSoUQER3HQ: checks
*** FLOP *** [9c 2h 7s]
rR1qGAf9Q9RYorKYWH3VKw: checks
tjhwe1V98x2spSoUQER3HQ: checks
by0z+YmujwI6Bf4qRFE8vA: checks
vR4IO10geOgvTW+LAUBv/A: bets $3
rR1qGAf9Q9RYorKYWH3VKw: folds
tjhwe1V98x2spSoUQER3HQ: folds
by0z+YmujwI6Bf4qRFE8vA: folds
vR4IO10geOgvTW+LAUBv/A collected $3.80 from pot
vR4IO10geOgvTW+LAUBv/A: doesn't show hand
*** SUMMARY ***
Total pot $4 | Rake $0.20
Board [9c 2h 7s]
Seat 1: vR4IO10geOgvTW+LAUBv/A (button) collected ($3.80)
Seat 2: rR1qGAf9Q9RYorKYWH3VKw (small blind) folded on the Flop
Seat 3: tjhwe1V98x2spSoUQER3HQ (big blind) folded on the Flop
Seat 4: by0z+YmujwI6Bf4qRFE8vA folded on the Flop
Seat 6: GTQkFJtSkbVbnGCktp6e3g folded before Flop (didn't bet)
Seat 7: O3CGPwwUmamrCNHccOilrg folded before Flop (didn't bet)
Seat 8: 9swGhtpERPngKPtvpoZkoQ folded before Flop (didn't bet)
Seat 9: negfosHnGOZXSHpWDRKyBQ folded before Flop (didn't bet)



PokerStars Game #59939291302:  Hold'em No Limit ($0.50/$1.00) - 2009/07/01 0:36:07 ET
Table 'pHrhryH8jPNdQfY62f8v+g' 6-max Seat #1 is the button
Seat 1: BdbmJTZZ47quA9vUWwXtlw ($89.85 in chips)
Seat 2: RqgF7gRoKgRNW8Zoi1ty4A ($114 in chips)
Seat 4: wenbG7TaM3H7h5kn78OFNw ($58.30 in chips)
Seat 5: r1/R7y0Ortgoz4lccgW8VA ($38.50 in chips)
Seat 6: xAU6q2/cwmby2sxmA8VcmA ($102.80 in chips)
RqgF7gRoKgRNW8Zoi1ty4A: posts small blind $0.50
wenbG7TaM3H7h5kn78OFNw: posts big blind $1
*** HOLE CARDS ***
r1/R7y0Ortgoz4lccgW8VA: folds
xAU6q2/cwmby2sxmA8VcmA: folds
BdbmJTZZ47quA9vUWwXtlw: folds
RqgF7gRoKgRNW8Zoi1ty4A: raises $2 to $3
wenbG7TaM3H7h5kn78OFNw: folds
RqgF7gRoKgRNW8Zoi1ty4A collected $2 from pot
*** SUMMARY ***
Total pot $2 | Rake $0
Seat 1: BdbmJTZZ47quA9vUWwXtlw (button) folded before Flop (didn't bet)
Seat 2: RqgF7gRoKgRNW8Zoi1ty4A (small blind) collected ($2)
Seat 4: wenbG7TaM3H7h5kn78OFNw (big blind) folded before Flop
Seat 5: r1/R7y0Ortgoz4lccgW8VA folded before Flop (didn't bet)
Seat 6: xAU6q2/cwmby2sxmA8VcmA folded before Flop (didn't bet)



PokerStars Game #59939291804:  Hold'em No Limit ($0.50/$1.00) - 2009/07/01 0:36:08 ET
Table 'eU3bWpDDg3Z+9R4m4iVmog' 6-max Seat #6 is the button
Seat 1: TSuRyAHnUPCFjP7Z0rEE0w ($170.20 in chips)
Seat 2: 8CAoOzhmB8n3nRFf3V4BTg ($119.95 in chips)
Seat 3: U6tnjwZRpTnM+YkqkCjwyQ ($169.65 in chips)
Seat 4: GDVIsbEJ/DOJsMKE4Asz0A ($100.60 in chips)
Seat 5: AdLVjddOzm+sRNo1Bc3S6Q ($100 in chips)
Seat 6: hpxXcmRkXXI9HE5+5/j/0Q ($109.45 in chips)
TSuRyAHnUPCFjP7Z0rEE0w: posts small blind $0.50
8CAoOzhmB8n3nRFf3V4BTg: posts big blind $1
*** HOLE CARDS ***
U6tnjwZRpTnM+YkqkCjwyQ: folds
GDVIsbEJ/DOJsMKE4Asz0A: folds
AdLVjddOzm+sRNo1Bc3S6Q: raises $3 to $4
hpxXcmRkXXI9HE5+5/j/0Q: folds
TSuRyAHnUPCFjP7Z0rEE0w: folds
8CAoOzhmB8n3nRFf3V4BTg: raises $7 to $11
AdLVjddOzm+sRNo1Bc3S6Q: folds
8CAoOzhmB8n3nRFf3V4BTg collected $8.50 from pot
*** SUMMARY ***
Total pot $8.50 | Rake $0
Seat 1: TSuRyAHnUPCFjP7Z0rEE0w (small blind) folded before Flop
Seat 2: 8CAoOzhmB8n3nRFf3V4BTg (big blind) collected ($8.50)
Seat 3: U6tnjwZRpTnM+YkqkCjwyQ folded before Flop (didn't bet)
Seat 4: GDVIsbEJ/DOJsMKE4Asz0A folded before Flop (didn't bet)
Seat 5: AdLVjddOzm+sRNo1Bc3S6Q folded before Flop
Seat 6: hpxXcmRkXXI9HE5+5/j/0Q (button) folded before Flop (didn't bet)



PokerStars Game #59939292808:  Hold'em No Limit ($0.50/$1.00) - 2009/07/01 0:36:09 ET
Table 'GxCPo/gd3OSthkYrAxJngg' 6-max Seat #5 is the button
Seat 1: sH8BpAFP+jGFxCgVpD1Lew ($276.95 in chips)
Seat 2: YExX2paeIHrmfIwV1ivM/w ($63.70 in chips)
Seat 3: o6plE+MSW4XFNTeONe16xg ($34.10 in chips)
Seat 4: YMJG+F++3Aj6P8dAWda5fw ($108.15 in chips)
Seat 5: G5ZSSN6RSON3gkNvk/SmYg ($101.70 in chips)
Seat 6: sS9IXedL3MiRmpVXhAILhw ($102.95 in chips)
sS9IXedL3MiRmpVXhAILhw: posts small blind $0.50
sH8BpAFP+jGFxCgVpD1Lew: posts big blind $1
*** HOLE CARDS ***
YExX2paeIHrmfIwV1ivM/w: calls $1
o6plE+MSW4XFNTeONe16xg: folds
YMJG+F++3Aj6P8dAWda5fw: folds
G5ZSSN6RSON3gkNvk/SmYg: folds
sS9IXedL3MiRmpVXhAILhw: calls $0.50
sH8BpAFP+jGFxCgVpD1Lew: checks
*** FLOP *** [Ad 9d 2d]
sS9IXedL3MiRmpVXhAILhw: checks
sH8BpAFP+jGFxCgVpD1Lew: bets $2
YExX2paeIHrmfIwV1ivM/w: raises $4 to $6
sS9IXedL3MiRmpVXhAILhw: folds
sH8BpAFP+jGFxCgVpD1Lew: calls $4
*** TURN *** [Ad 9d 2d] [Kc]
sH8BpAFP+jGFxCgVpD1Lew: checks
YExX2paeIHrmfIwV1ivM/w: bets $8
sH8BpAFP+jGFxCgVpD1Lew: calls $8
*** RIVER *** [Ad 9d 2d Kc] [Ah]
sH8BpAFP+jGFxCgVpD1Lew: checks
YExX2paeIHrmfIwV1ivM/w: bets $48.70 and is all-in
sH8BpAFP+jGFxCgVpD1Lew: folds
YExX2paeIHrmfIwV1ivM/w collected $29.50 from pot
*** SUMMARY ***
Total pot $31 | Rake $1.50
Board [Ad 9d 2d Kc Ah]
Seat 1: sH8BpAFP+jGFxCgVpD1Lew (big blind) folded on the River
Seat 2: YExX2paeIHrmfIwV1ivM/w collected ($29.50)
Seat 3: o6plE+MSW4XFNTeONe16xg folded before Flop (didn't bet)
Seat 4: YMJG+F++3Aj6P8dAWda5fw folded before Flop (didn't bet)
Seat 5: G5ZSSN6RSON3gkNvk/SmYg (button) folded before Flop (didn't bet)
Seat 6: sS9IXedL3MiRmpVXhAILhw (small blind) folded on the Flop



PokerStars Game #59939292490:  Hold'em No Limit ($0.50/$1.00) - 2009/07/01 0:36:09 ET
Table 'ZFWj23PMihdwrNWv41OG/Q' 9-max Seat #4 is the button
Seat 1: yAbu2QsRPVcjPbqlf/jDxw ($124.90 in chips)
Seat 2: ARfmgHcEUKh68laBZy4veA ($77.60 in chips)
Seat 3: G9Fo2TZCN7HI43Po4zSN3A ($102 in chips)
Seat 4: PEmogYqKpuv0ozeBbXL+7Q ($14.85 in chips)
Seat 5: tkdBeXTJlFsZdioidNqLow ($60 in chips)
Seat 6: tjhwe1V98x2spSoUQER3HQ ($104.50 in chips)
Seat 7: wIZ377kjl2fHFGnS93o6bw ($21.45 in chips)
Seat 8: knewtTmBc4Tc0z/5tAABYQ ($116.90 in chips)
Seat 9: gIabaXO0Nq08nuXlf56f0w ($19.90 in chips)
tkdBeXTJlFsZdioidNqLow: posts small blind $0.50
tjhwe1V98x2spSoUQER3HQ: posts big blind $1
*** HOLE CARDS ***
wIZ377kjl2fHFGnS93o6bw: calls $1
knewtTmBc4Tc0z/5tAABYQ: folds
gIabaXO0Nq08nuXlf56f0w: folds
yAbu2QsRPVcjPbqlf/jDxw: folds
ARfmgHcEUKh68laBZy4veA: calls $1
G9Fo2TZCN7HI43Po4zSN3A: raises $4 to $5
PEmogYqKpuv0ozeBbXL+7Q: raises $9.85 to $14.85 and is all-in
tkdBeXTJlFsZdioidNqLow: folds
tjhwe1V98x2spSoUQER3HQ: folds
wIZ377kjl2fHFGnS93o6bw: folds
ARfmgHcEUKh68laBZy4veA: folds
G9Fo2TZCN7HI43Po4zSN3A: calls $9.85
*** FLOP *** [As 9d 9c]
*** TURN *** [As 9d 9c] [5d]
*** RIVER *** [As 9d 9c 5d] [7c]
*** SHOW DOWN ***
G9Fo2TZCN7HI43Po4zSN3A: shows [9s 7s] (a full house, Nines full of Sevens)
PEmogYqKpuv0ozeBbXL+7Q: mucks hand
G9Fo2TZCN7HI43Po4zSN3A collected $31.55 from pot
*** SUMMARY ***
Total pot $33.20 | Rake $1.65
Board [As 9d 9c 5d 7c]
Seat 1: yAbu2QsRPVcjPbqlf/jDxw folded before Flop (didn't bet)
Seat 2: ARfmgHcEUKh68laBZy4veA folded before Flop
Seat 3: G9Fo2TZCN7HI43Po4zSN3A showed [9s 7s] and won ($31.55) with a full house, Nines full of Sevens
Seat 4: PEmogYqKpuv0ozeBbXL+7Q (button) mucked
Seat 5: tkdBeXTJlFsZdioidNqLow (small blind) folded before Flop
Seat 6: tjhwe1V98x2spSoUQER3HQ (big blind) folded before Flop
Seat 7: wIZ377kjl2fHFGnS93o6bw folded before Flop
Seat 8: knewtTmBc4Tc0z/5tAABYQ folded before Flop (didn't bet)
Seat 9: gIabaXO0Nq08nuXlf56f0w folded before Flop (didn't bet)



PokerStars Game #59939293778:  Hold'em No Limit ($0.50/$1.00) - 2009/07/01 0:36:11 ET
Table 'LmXQK9xy3awB+qsPzI21Mw' 2-max Seat #1 is the button
Seat 1: NYi6JFscYNrofSXy4sM+Yw ($239.55 in chips)
Seat 2: TME8GvochpQAo8cmJwWmvA ($101.80 in chips)
NYi6JFscYNrofSXy4sM+Yw: posts small blind $0.50
TME8GvochpQAo8cmJwWmvA: posts big blind $1
*** HOLE CARDS ***
NYi6JFscYNrofSXy4sM+Yw: raises $2 to $3
TME8GvochpQAo8cmJwWmvA: folds
NYi6JFscYNrofSXy4sM+Yw collected $2 from pot
*** SUMMARY ***
Total pot $2 | Rake $0
Seat 1: NYi6JFscYNrofSXy4sM+Yw (button) (small blind) collected ($2)
Seat 2: TME8GvochpQAo8cmJwWmvA (big blind) folded before Flop



PokerStars Game #59939294622:  Hold'em No Limit ($0.50/$1.00) - 2009/07/01 0:36:12 ET
Table '/RZcOwpZpHQ+OwPwjsbnRw' 6-max Seat #2 is the button
Seat 1: Zboa6dColKGHBjLPUakZjw ($52.20 in chips)
Seat 2: +xW7QemQU0Fxs+4TnqBRow ($100.50 in chips)
Seat 4: j7NIOHLZk7V2o9fOioO5ug ($115.90 in chips)
Seat 5: wx3sQGkVi2x9wJXuWNHPBw ($199.65 in chips)
Seat 6: XOIf9W+VAxhZqN+SYoyMKA ($290.05 in chips)
j7NIOHLZk7V2o9fOioO5ug: posts small blind $0.50
wx3sQGkVi2x9wJXuWNHPBw: posts big blind $1
*** HOLE CARDS ***
XOIf9W+VAxhZqN+SYoyMKA: folds
Zboa6dColKGHBjLPUakZjw: raises $1 to $2
+xW7QemQU0Fxs+4TnqBRow: folds
j7NIOHLZk7V2o9fOioO5ug: folds
wx3sQGkVi2x9wJXuWNHPBw: folds
Zboa6dColKGHBjLPUakZjw collected $2.50 from pot
*** SUMMARY ***
Total pot $2.50 | Rake $0
Seat 1: Zboa6dColKGHBjLPUakZjw collected ($2.50)
Seat 2: +xW7QemQU0Fxs+4TnqBRow (button) folded before Flop (didn't bet)
Seat 4: j7NIOHLZk7V2o9fOioO5ug (small blind) folded before Flop
Seat 5: wx3sQGkVi2x9wJXuWNHPBw (big blind) folded before Flop
Seat 6: XOIf9W+VAxhZqN+SYoyMKA folded before Flop (didn't bet)



PokerStars Game #59939294952:  Hold'em No Limit ($0.50/$1.00) - 2009/07/01 0:36:13 ET
Table 'uNlePsyMIqzM691Xkrlk6Q' 9-max Seat #2 is the button
Seat 1: bLbSOSmSOnqE0iTcH/5dxA ($102.50 in chips)
Seat 2: +OqpStnt0FqbCfyHAWaLbg ($65.45 in chips)
Seat 3: h7qXkU57Bb8ZuPwMyxR8Ug ($19 in chips)
Seat 4: TZcz9MEWDA+WydgGruqqbw ($104.65 in chips)
Seat 6: uMPEfCcGCfsxmy53tVUMug ($113.10 in chips)
Seat 7: w6cw9nzN7AvkkHBVVjykoQ ($44.90 in chips)
Seat 8: OsLmX3x/19szSV115TpL/Q ($39.80 in chips)
Seat 9: vR4IO10geOgvTW+LAUBv/A ($116.30 in chips)
h7qXkU57Bb8ZuPwMyxR8Ug: posts small blind $0.50
TZcz9MEWDA+WydgGruqqbw: posts big blind $1
3obndzTJ6fECz8+wWhMd1w: sits out
*** HOLE CARDS ***
uMPEfCcGCfsxmy53tVUMug: folds
w6cw9nzN7AvkkHBVVjykoQ: folds
OsLmX3x/19szSV115TpL/Q: calls $1
vR4IO10geOgvTW+LAUBv/A: folds
bLbSOSmSOnqE0iTcH/5dxA: folds
+OqpStnt0FqbCfyHAWaLbg: folds
h7qXkU57Bb8ZuPwMyxR8Ug: calls $0.50
TZcz9MEWDA+WydgGruqqbw: checks
*** FLOP *** [9h Ks Td]
h7qXkU57Bb8ZuPwMyxR8Ug: checks
TZcz9MEWDA+WydgGruqqbw: checks
OsLmX3x/19szSV115TpL/Q: checks
*** TURN *** [9h Ks Td] [8c]
h7qXkU57Bb8ZuPwMyxR8Ug: bets $2
TZcz9MEWDA+WydgGruqqbw: folds
OsLmX3x/19szSV115TpL/Q: calls $2
*** RIVER *** [9h Ks Td 8c] [7d]
h7qXkU57Bb8ZuPwMyxR8Ug: bets $4
OsLmX3x/19szSV115TpL/Q: calls $4
*** SHOW DOWN ***
h7qXkU57Bb8ZuPwMyxR8Ug: shows [Kh Qd] (a pair of Kings)
OsLmX3x/19szSV115TpL/Q: shows [7c Jh] (a straight, Seven to Jack)
OsLmX3x/19szSV115TpL/Q collected $14.30 from pot
*** SUMMARY ***
Total pot $15 | Rake $0.70
Board [9h Ks Td 8c 7d]
Seat 1: bLbSOSmSOnqE0iTcH/5dxA folded before Flop (didn't bet)
Seat 2: +OqpStnt0FqbCfyHAWaLbg (button) folded before Flop (didn't bet)
Seat 3: h7qXkU57Bb8ZuPwMyxR8Ug (small blind) showed [Kh Qd] and lost with a pair of Kings
Seat 4: TZcz9MEWDA+WydgGruqqbw (big blind) folded on the Turn
Seat 6: uMPEfCcGCfsxmy53tVUMug folded before Flop (didn't bet)
Seat 7: w6cw9nzN7AvkkHBVVjykoQ folded before Flop (didn't bet)
Seat 8: OsLmX3x/19szSV115TpL/Q showed [7c Jh] and won ($14.30) with a straight, Seven to Jack
Seat 9: vR4IO10geOgvTW+LAUBv/A folded before Flop (didn't bet)



PokerStars Game #59939294962:  Hold'em No Limit ($0.50/$1.00) - 2009/07/01 0:36:13 ET
Table '21a4iYFKcuezM4nYx8DWTA' 2-max Seat #2 is the button
Seat 1: NYi6JFscYNrofSXy4sM+Yw ($198.45 in chips)
Seat 2: mJHc7tEZG3SVIX7QQjb5EQ ($20 in chips)
mJHc7tEZG3SVIX7QQjb5EQ: posts small blind $0.50
NYi6JFscYNrofSXy4sM+Yw: posts big blind $1
*** HOLE CARDS ***
mJHc7tEZG3SVIX7QQjb5EQ: raises $2 to $3
NYi6JFscYNrofSXy4sM+Yw: calls $2
*** FLOP *** [Tc As 7c]
NYi6JFscYNrofSXy4sM+Yw: checks
mJHc7tEZG3SVIX7QQjb5EQ: bets $4
NYi6JFscYNrofSXy4sM+Yw: calls $4
*** TURN *** [Tc As 7c] [9c]
NYi6JFscYNrofSXy4sM+Yw: checks
mJHc7tEZG3SVIX7QQjb5EQ: checks
*** RIVER *** [Tc As 7c 9c] [Jc]
NYi6JFscYNrofSXy4sM+Yw: bets $13
mJHc7tEZG3SVIX7QQjb5EQ: folds
NYi6JFscYNrofSXy4sM+Yw collected $13.50 from pot
NYi6JFscYNrofSXy4sM+Yw: doesn't show hand
*** SUMMARY ***
Total pot $14 | Rake $0.50
Board [Tc As 7c 9c Jc]
Seat 1: NYi6JFscYNrofSXy4sM+Yw (big blind) collected ($13.50)
Seat 2: mJHc7tEZG3SVIX7QQjb5EQ (button) (small blind) folded on the River



PokerStars Game #59939294928:  Hold'em No Limit ($0.50/$1.00) - 2009/07/01 0:36:13 ET
Table 'N2bNCDHL96aCQDvZIh+yQQ' 6-max Seat #1 is the button
Seat 1: iHo1oDbrEVJ8nEGdaPrICw ($143.50 in chips)
Seat 2: KpnW5CcJ4Mg6MeclfKmLrw ($110.90 in chips)
Seat 3: Qy/UBNbD2HaA0Ogxg8Sf3w ($100 in chips)
Seat 4: uCqEjnxh2/vFBjKYkfTOkw ($175.55 in chips)
Seat 5: rHlMOfR7kpQQxe+PFQz0xQ ($30 in chips)
Seat 6: TSuRyAHnUPCFjP7Z0rEE0w ($100 in chips)
KpnW5CcJ4Mg6MeclfKmLrw: posts small blind $0.50
Qy/UBNbD2HaA0Ogxg8Sf3w: posts big blind $1
*** HOLE CARDS ***
uCqEjnxh2/vFBjKYkfTOkw: folds
rHlMOfR7kpQQxe+PFQz0xQ: folds
TSuRyAHnUPCFjP7Z0rEE0w: folds
iHo1oDbrEVJ8nEGdaPrICw: folds
KpnW5CcJ4Mg6MeclfKmLrw: folds
Qy/UBNbD2HaA0Ogxg8Sf3w collected $1 from pot
Qy/UBNbD2HaA0Ogxg8Sf3w: doesn't show hand
*** SUMMARY ***
Total pot $1 | Rake $0
Seat 1: iHo1oDbrEVJ8nEGdaPrICw (button) folded before Flop (didn't bet)
Seat 2: KpnW5CcJ4Mg6MeclfKmLrw (small blind) folded before Flop
Seat 3: Qy/UBNbD2HaA0Ogxg8Sf3w (big blind) collected ($1)
Seat 4: uCqEjnxh2/vFBjKYkfTOkw folded before Flop (didn't bet)
Seat 5: rHlMOfR7kpQQxe+PFQz0xQ folded before Flop (didn't bet)
Seat 6: TSuRyAHnUPCFjP7Z0rEE0w folded before Flop (didn't bet)



PokerStars Game #59939295286:  Hold'em No Limit ($0.50/$1.00) - 2009/07/01 0:36:13 ET
Table '6YvsYDPNIDx2v5z3bJnwZQ' 9-max Seat #7 is the button
Seat 1: Ogn4JDV3mp4ZDKO49IFzKA ($14.50 in chips)
Seat 2: 35DmRulmD2MgzT6Bbt6/2w ($51.95 in chips)
Seat 3: negfosHnGOZXSHpWDRKyBQ ($19.30 in chips)
Seat 4: kEr5NYB+JIG5+szcYMr6hA ($45 in chips)
Seat 5: mBRWbnUl8diyBO1qTJaNzw ($160.70 in chips)
Seat 6: uMPEfCcGCfsxmy53tVUMug ($105.10 in chips)
Seat 7: boixc27eqTYA1p0tUdMuBQ ($114 in chips)
Seat 8: PSFxpXgPedVZyHSu2Zhb7Q ($47.25 in chips)
Seat 9: jDwhY1kCdc6EkAHbT7PJMQ ($105.60 in chips)
PSFxpXgPedVZyHSu2Zhb7Q: posts small blind $0.50
jDwhY1kCdc6EkAHbT7PJMQ: posts big blind $1
*** HOLE CARDS ***
Ogn4JDV3mp4ZDKO49IFzKA: folds
35DmRulmD2MgzT6Bbt6/2w: folds
negfosHnGOZXSHpWDRKyBQ: folds
kEr5NYB+JIG5+szcYMr6hA: folds
mBRWbnUl8diyBO1qTJaNzw: folds
uMPEfCcGCfsxmy53tVUMug: raises $2 to $3
boixc27eqTYA1p0tUdMuBQ: folds
PSFxpXgPedVZyHSu2Zhb7Q: folds
jDwhY1kCdc6EkAHbT7PJMQ: folds
uMPEfCcGCfsxmy53tVUMug collected $2.50 from pot
*** SUMMARY ***
Total pot $2.50 | Rake $0
Seat 1: Ogn4JDV3mp4ZDKO49IFzKA folded before Flop (didn't bet)
Seat 2: 35DmRulmD2MgzT6Bbt6/2w folded before Flop (didn't bet)
Seat 3: negfosHnGOZXSHpWDRKyBQ folded before Flop (didn't bet)
Seat 4: kEr5NYB+JIG5+szcYMr6hA folded before Flop (didn't bet)
Seat 5: mBRWbnUl8diyBO1qTJaNzw folded before Flop (didn't bet)
Seat 6: uMPEfCcGCfsxmy53tVUMug collected ($2.50)
Seat 7: boixc27eqTYA1p0tUdMuBQ (button) folded before Flop (didn't bet)
Seat 8: PSFxpXgPedVZyHSu2Zhb7Q (small blind) folded before Flop
Seat 9: jDwhY1kCdc6EkAHbT7PJMQ (big blind) folded before Flop



PokerStars Game #59939295546:  Hold'em No Limit ($0.50/$1.00) - 2009/07/01 0:36:14 ET
Table '7Nl0ffnjeK44/vmeexh3MQ' 9-max Seat #8 is the button
Seat 1: s7D3Y+k4Cj4D1cXHv7oj+Q ($99.30 in chips)
Seat 2: kiakSwxX0e64PwYGAPQvLw ($31.85 in chips)
Seat 3: vR4IO10geOgvTW+LAUBv/A ($100 in chips)
Seat 4: bLbSOSmSOnqE0iTcH/5dxA ($100 in chips)
Seat 5: bL+QVeDcuEdzMGAGg2XJHg ($103.90 in chips)
Seat 6: FVs16t7GgfWgQWt4JxsObQ ($21.45 in chips)
Seat 8: zanka7aAZkigmZpfopXxxA ($226.20 in chips)
Seat 9: ouwUBGRKnKK9uhn1G4Lf+A ($98.50 in chips)
ouwUBGRKnKK9uhn1G4Lf+A: posts small blind $0.50
s7D3Y+k4Cj4D1cXHv7oj+Q: posts big blind $1
*** HOLE CARDS ***
kiakSwxX0e64PwYGAPQvLw: folds
vR4IO10geOgvTW+LAUBv/A: folds
bLbSOSmSOnqE0iTcH/5dxA: folds
bL+QVeDcuEdzMGAGg2XJHg: folds
FVs16t7GgfWgQWt4JxsObQ: folds
zanka7aAZkigmZpfopXxxA: raises $2 to $3
ouwUBGRKnKK9uhn1G4Lf+A: folds
s7D3Y+k4Cj4D1cXHv7oj+Q: folds
zanka7aAZkigmZpfopXxxA collected $2.50 from pot
zanka7aAZkigmZpfopXxxA: doesn't show hand
*** SUMMARY ***
Total pot $2.50 | Rake $0
Seat 1: s7D3Y+k4Cj4D1cXHv7oj+Q (big blind) folded before Flop
Seat 2: kiakSwxX0e64PwYGAPQvLw folded before Flop (didn't bet)
Seat 3: vR4IO10geOgvTW+LAUBv/A folded before Flop (didn't bet)
Seat 4: bLbSOSmSOnqE0iTcH/5dxA folded before Flop (didn't bet)
Seat 5: bL+QVeDcuEdzMGAGg2XJHg folded before Flop (didn't bet)
Seat 6: FVs16t7GgfWgQWt4JxsObQ folded before Flop (didn't bet)
Seat 8: zanka7aAZkigmZpfopXxxA (button) collected ($2.50)
Seat 9: ouwUBGRKnKK9uhn1G4Lf+A (small blind) folded before Flop



PokerStars Game #59939295714:  Hold'em No Limit ($0.50/$1.00) - 2009/07/01 0:36:14 ET
Table 'rmZfTK+oSebeUPJNbWhdAA' 6-max Seat #4 is the button
Seat 1: xAU6q2/cwmby2sxmA8VcmA ($100 in chips)
Seat 3: 9yjOzGERLaEZS8CZ6YNHFg ($114.40 in chips)
Seat 4: OGMLOcTNYZXZU81au7ztUw ($130.35 in chips)
Seat 5: +xW7QemQU0Fxs+4TnqBRow ($100 in chips)
Seat 6: j7NIOHLZk7V2o9fOioO5ug ($134 in chips)
+xW7QemQU0Fxs+4TnqBRow: posts small blind $0.50
j7NIOHLZk7V2o9fOioO5ug: posts big blind $1
z7O9PO/WEcqRouIydFhS9Q: sits out
*** HOLE CARDS ***
xAU6q2/cwmby2sxmA8VcmA: folds
9yjOzGERLaEZS8CZ6YNHFg: raises $2 to $3
OGMLOcTNYZXZU81au7ztUw: calls $3
+xW7QemQU0Fxs+4TnqBRow: folds
j7NIOHLZk7V2o9fOioO5ug: folds
*** FLOP *** [9s 8h 3s]
9yjOzGERLaEZS8CZ6YNHFg: checks
OGMLOcTNYZXZU81au7ztUw: bets $5
9yjOzGERLaEZS8CZ6YNHFg: folds
OGMLOcTNYZXZU81au7ztUw collected $7.15 from pot
OGMLOcTNYZXZU81au7ztUw: doesn't show hand
*** SUMMARY ***
Total pot $7.50 | Rake $0.35
Board [9s 8h 3s]
Seat 1: xAU6q2/cwmby2sxmA8VcmA folded before Flop (didn't bet)
Seat 3: 9yjOzGERLaEZS8CZ6YNHFg folded on the Flop
Seat 4: OGMLOcTNYZXZU81au7ztUw (button) collected ($7.15)
Seat 5: +xW7QemQU0Fxs+4TnqBRow (small blind) folded before Flop
Seat 6: j7NIOHLZk7V2o9fOioO5ug (big blind) folded before Flop



PokerStars Game #59939296664:  Hold'em No Limit ($0.50/$1.00) - 2009/07/01 0:36:15 ET
Table 'QBLDswtHe7Ml0HwAdcMhlw' 2-max Seat #2 is the button
Seat 1: hdNlhiCwI533uwvvTTfC9Q ($101.70 in chips)
Seat 2: GBkvjkjDWVBEa1e14dh6CA ($61.50 in chips)
GBkvjkjDWVBEa1e14dh6CA: posts small blind $0.50
hdNlhiCwI533uwvvTTfC9Q: posts big blind $1
*** HOLE CARDS ***
GBkvjkjDWVBEa1e14dh6CA: raises $2 to $3
hdNlhiCwI533uwvvTTfC9Q: folds
GBkvjkjDWVBEa1e14dh6CA collected $2 from pot
GBkvjkjDWVBEa1e14dh6CA: doesn't show hand
*** SUMMARY ***
Total pot $2 | Rake $0
Seat 1: hdNlhiCwI533uwvvTTfC9Q (big blind) folded before Flop
Seat 2: GBkvjkjDWVBEa1e14dh6CA (button) (small blind) collected ($2)



PokerStars Game #59939297670:  Hold'em No Limit ($0.50/$1.00) - 2009/07/01 0:36:17 ET
Table 'LmXQK9xy3awB+qsPzI21Mw' 2-max Seat #2 is the button
Seat 1: NYi6JFscYNrofSXy4sM+Yw ($240.55 in chips)
Seat 2: TME8GvochpQAo8cmJwWmvA ($100.80 in chips)
TME8GvochpQAo8cmJwWmvA: posts small blind $0.50
NYi6JFscYNrofSXy4sM+Yw: posts big blind $1
*** HOLE CARDS ***
TME8GvochpQAo8cmJwWmvA: calls $0.50
NYi6JFscYNrofSXy4sM+Yw: raises $2 to $3
TME8GvochpQAo8cmJwWmvA: calls $2
*** FLOP *** [Qs 8h Jd]
NYi6JFscYNrofSXy4sM+Yw: bets $3
TME8GvochpQAo8cmJwWmvA: calls $3
*** TURN *** [Qs 8h Jd] [Ah]
NYi6JFscYNrofSXy4sM+Yw: bets $7
TME8GvochpQAo8cmJwWmvA: folds
NYi6JFscYNrofSXy4sM+Yw collected $11.50 from pot
*** SUMMARY ***
Total pot $12 | Rake $0.50
Board [Qs 8h Jd Ah]
Seat 1: NYi6JFscYNrofSXy4sM+Yw (big blind) collected ($11.50)
Seat 2: TME8GvochpQAo8cmJwWmvA (button) (small blind) folded on the Turn



PokerStars Game #59939298036:  Hold'em No Limit ($0.50/$1.00) - 2009/07/01 0:36:18 ET
Table 'Zka9tv1yilg0MvXWPQrShg' 9-max Seat #4 is the button
Seat 1: TZcz9MEWDA+WydgGruqqbw ($115.35 in chips)
Seat 2: rR1qGAf9Q9RYorKYWH3VKw ($25.70 in chips)
Seat 3: gUUvmqdVlmvpal6B8nYrmg ($101 in chips)
Seat 4: CTOae+JLIGfwfXvhqHkP2w ($156.65 in chips)
Seat 5: /zy+DB4S5fUQUSfZWFzYGw ($138.50 in chips)
Seat 6: rY8wPoax1lS+HUY+I0FZDw ($148.80 in chips)
Seat 7: p1SafS90nb3Uft5LB0NkHw ($17 in chips)
Seat 8: bL+QVeDcuEdzMGAGg2XJHg ($119.10 in chips)
Seat 9: 6daxhj43mWj04MOPTOmaYA ($93 in chips)
/zy+DB4S5fUQUSfZWFzYGw: posts small blind $0.50
rY8wPoax1lS+HUY+I0FZDw: posts big blind $1
*** HOLE CARDS ***
p1SafS90nb3Uft5LB0NkHw: folds
bL+QVeDcuEdzMGAGg2XJHg: folds
6daxhj43mWj04MOPTOmaYA: folds
TZcz9MEWDA+WydgGruqqbw: folds
rR1qGAf9Q9RYorKYWH3VKw: folds
gUUvmqdVlmvpal6B8nYrmg: folds
CTOae+JLIGfwfXvhqHkP2w: folds
/zy+DB4S5fUQUSfZWFzYGw: raises $2 to $3
rY8wPoax1lS+HUY+I0FZDw: calls $2
*** FLOP *** [3h As 3s]
/zy+DB4S5fUQUSfZWFzYGw: checks
rY8wPoax1lS+HUY+I0FZDw: checks
*** TURN *** [3h As 3s] [Qd]
/zy+DB4S5fUQUSfZWFzYGw: bets $4
rY8wPoax1lS+HUY+I0FZDw: folds
/zy+DB4S5fUQUSfZWFzYGw collected $5.70 from pot
*** SUMMARY ***
Total pot $6 | Rake $0.30
Board [3h As 3s Qd]
Seat 1: TZcz9MEWDA+WydgGruqqbw folded before Flop (didn't bet)
Seat 2: rR1qGAf9Q9RYorKYWH3VKw folded before Flop (didn't bet)
Seat 3: gUUvmqdVlmvpal6B8nYrmg folded before Flop (didn't bet)
Seat 4: CTOae+JLIGfwfXvhqHkP2w (button) folded before Flop (didn't bet)
Seat 5: /zy+DB4S5fUQUSfZWFzYGw (small blind) collected ($5.70)
Seat 6: rY8wPoax1lS+HUY+I0FZDw (big blind) folded on the Turn
Seat 7: p1SafS90nb3Uft5LB0NkHw folded before Flop (didn't bet)
Seat 8: bL+QVeDcuEdzMGAGg2XJHg folded before Flop (didn't bet)
Seat 9: 6daxhj43mWj04MOPTOmaYA folded before Flop (didn't bet)



PokerStars Game #59939298280:  Hold'em No Limit ($0.50/$1.00) - 2009/07/01 0:36:18 ET
Table 'MUPc8FEpe/nR0BKSeReX6Q' 6-max Seat #3 is the button
Seat 1: YsLQ3BAvgQHWXMAv3Wv6Hg ($100 in chips)
Seat 2: xAU6q2/cwmby2sxmA8VcmA ($111.70 in chips)
Seat 3: wx3sQGkVi2x9wJXuWNHPBw ($234.05 in chips)
Seat 4: ZA1bp6g8IwtTxkUE4eCjDQ ($172.45 in chips)
Seat 5: UBZQqpnJZdTYYY1FTb0rLA ($100 in chips)
ZA1bp6g8IwtTxkUE4eCjDQ: posts small blind $0.50
UBZQqpnJZdTYYY1FTb0rLA: posts big blind $1
*** HOLE CARDS ***
YsLQ3BAvgQHWXMAv3Wv6Hg: folds
xAU6q2/cwmby2sxmA8VcmA: folds
oxnw0GLLpFanjhGkxfRSqA has returned
wx3sQGkVi2x9wJXuWNHPBw: folds
ZA1bp6g8IwtTxkUE4eCjDQ: raises $2 to $3
UBZQqpnJZdTYYY1FTb0rLA: folds
ZA1bp6g8IwtTxkUE4eCjDQ collected $2 from pot
ZA1bp6g8IwtTxkUE4eCjDQ: doesn't show hand
*** SUMMARY ***
Total pot $2 | Rake $0
Seat 1: YsLQ3BAvgQHWXMAv3Wv6Hg folded before Flop (didn't bet)
Seat 2: xAU6q2/cwmby2sxmA8VcmA folded before Flop (didn't bet)
Seat 3: wx3sQGkVi2x9wJXuWNHPBw (button) folded before Flop (didn't bet)
Seat 4: ZA1bp6g8IwtTxkUE4eCjDQ (small blind) collected ($2)
Seat 5: UBZQqpnJZdTYYY1FTb0rLA (big blind) folded before Flop



PokerStars Game #59939300862:  Hold'em No Limit ($0.50/$1.00) - 2009/07/01 0:36:22 ET
Table 'tLrtq7gDzxEvckNAI1OS5Q' 6-max Seat #2 is the button
Seat 1: GisIe1kcC9q/xV6ifsTjgA ($174.15 in chips)
Seat 2: QHvTZcrKe6+maWUfVjP29Q ($110.85 in chips)
Seat 3: TPZ+m9x+lwoKpv7TMfAUWA ($318.80 in chips)
Seat 5: OGMLOcTNYZXZU81au7ztUw ($150.60 in chips)
Seat 6: XUk5GQsfNFpHvaToDZ0rZA ($85.50 in chips)
TPZ+m9x+lwoKpv7TMfAUWA: posts small blind $0.50
OGMLOcTNYZXZU81au7ztUw: posts big blind $1
*** HOLE CARDS ***
XUk5GQsfNFpHvaToDZ0rZA: folds
GisIe1kcC9q/xV6ifsTjgA: folds
QHvTZcrKe6+maWUfVjP29Q: folds
GisIe1kcC9q/xV6ifsTjgA leaves the table
TPZ+m9x+lwoKpv7TMfAUWA: folds
OGMLOcTNYZXZU81au7ztUw collected $1 from pot
OGMLOcTNYZXZU81au7ztUw: doesn't show hand
*** SUMMARY ***
Total pot $1 | Rake $0
Seat 1: GisIe1kcC9q/xV6ifsTjgA folded before Flop (didn't bet)
Seat 2: QHvTZcrKe6+maWUfVjP29Q (button) folded before Flop (didn't bet)
Seat 3: TPZ+m9x+lwoKpv7TMfAUWA (small blind) folded before Flop
Seat 5: OGMLOcTNYZXZU81au7ztUw (big blind) collected ($1)
Seat 6: XUk5GQsfNFpHvaToDZ0rZA folded before Flop (didn't bet)



PokerStars Game #59939302880:  Hold'em No Limit ($0.50/$1.00) - 2009/07/01 0:36:25 ET
Table 'QSIig7BLMc9wY/rgBechzw' 6-max Seat #1 is the button
Seat 1: uuA9hpFU17U5/t4cvpbpBg ($23.55 in chips)
Seat 3: +W6OnF033KNM2xH0fGj98Q ($100 in chips)
Seat 4: +uSzP8Jwnw7sKfQ4s66b7w ($60.50 in chips)
Seat 5: bvU2ZjpVnszLCFVeWbxePg ($138.90 in chips)
Seat 6: KpnW5CcJ4Mg6MeclfKmLrw ($188.60 in chips)
+W6OnF033KNM2xH0fGj98Q: posts small blind $0.50
+uSzP8Jwnw7sKfQ4s66b7w: posts big blind $1
*** HOLE CARDS ***
bvU2ZjpVnszLCFVeWbxePg: raises $2 to $3
KpnW5CcJ4Mg6MeclfKmLrw: folds
uuA9hpFU17U5/t4cvpbpBg: folds
+W6OnF033KNM2xH0fGj98Q: folds
+uSzP8Jwnw7sKfQ4s66b7w: calls $2
*** FLOP *** [3s 5d 4h]
+uSzP8Jwnw7sKfQ4s66b7w: checks
bvU2ZjpVnszLCFVeWbxePg: checks
*** TURN *** [3s 5d 4h] [4c]
+uSzP8Jwnw7sKfQ4s66b7w: checks
bvU2ZjpVnszLCFVeWbxePg: checks
*** RIVER *** [3s 5d 4h 4c] [Kd]
+uSzP8Jwnw7sKfQ4s66b7w: checks
bvU2ZjpVnszLCFVeWbxePg: checks
*** SHOW DOWN ***
+uSzP8Jwnw7sKfQ4s66b7w: shows [Jc Qs] (a pair of Fours)
bvU2ZjpVnszLCFVeWbxePg: shows [Jd Ac] (a pair of Fours - Ace kicker)
bvU2ZjpVnszLCFVeWbxePg collected $6.20 from pot
*** SUMMARY ***
Total pot $6.50 | Rake $0.30
Board [3s 5d 4h 4c Kd]
Seat 1: uuA9hpFU17U5/t4cvpbpBg (button) folded before Flop (didn't bet)
Seat 3: +W6OnF033KNM2xH0fGj98Q (small blind) folded before Flop
Seat 4: +uSzP8Jwnw7sKfQ4s66b7w (big blind) showed [Jc Qs] and lost with a pair of Fours
Seat 5: bvU2ZjpVnszLCFVeWbxePg showed [Jd Ac] and won ($6.20) with a pair of Fours
Seat 6: KpnW5CcJ4Mg6MeclfKmLrw folded before Flop (didn't bet)



PokerStars Game #59939305366:  Hold'em No Limit ($0.50/$1.00) - 2009/07/01 0:36:28 ET
Table 'tyUh+jyNvrceIQdKMJjQ2wZFWj23PMihdwrNWv41OG/Qeat #3 is the button
Seat 1: o8A5MUdudVKu+pAwgZOX2w ($217.55 in chips)
Seat 2: m1sJRkJZ1wu5i1BdgeO2Jw ($16 in chips)
Seat 3: TalCiLYHCd+ffkmR3auPvA ($56.50 in chips)
Seat 4: TSuRyAHnUPCFjP7Z0rEE0w ($107.25 in chips)
Seat 5: j7NIOHLZk7V2o9fOioO5ug ($121.60 in chips)
Seat 6: YsLQ3BAvgQHWXMAv3Wv6Hg ($162.25 in chips)
TSuRyAHnUPCFjP7Z0rEE0w: posts small blind $0.50
j7NIOHLZk7V2o9fOioO5ug: posts big blind $1
*** HOLE CARDS ***
YsLQ3BAvgQHWXMAv3Wv6Hg: folds
o8A5MUdudVKu+pAwgZOX2w: calls $1
m1sJRkJZ1wu5i1BdgeO2Jw: calls $1
TalCiLYHCd+ffkmR3auPvA: folds
TSuRyAHnUPCFjP7Z0rEE0w: calls $0.50
j7NIOHLZk7V2o9fOioO5ug: checks
*** FLOP *** [Qs 7c 8d]
TSuRyAHnUPCFjP7Z0rEE0w: checks
j7NIOHLZk7V2o9fOioO5ug: checks
o8A5MUdudVKu+pAwgZOX2w: checks
m1sJRkJZ1wu5i1BdgeO2Jw: checks
*** TURN *** [Qs 7c 8d] [Th]
TSuRyAHnUPCFjP7Z0rEE0w: checks
j7NIOHLZk7V2o9fOioO5ug: checks
o8A5MUdudVKu+pAwgZOX2w: checks
m1sJRkJZ1wu5i1BdgeO2Jw: checks
*** RIVER *** [Qs 7c 8d Th] [6s]
TSuRyAHnUPCFjP7Z0rEE0w: bets $2
j7NIOHLZk7V2o9fOioO5ug: folds
o8A5MUdudVKu+pAwgZOX2w: folds
m1sJRkJZ1wu5i1BdgeO2Jw: folds
TSuRyAHnUPCFjP7Z0rEE0w collected $3.80 from pot
TSuRyAHnUPCFjP7Z0rEE0w: doesn't show hand
*** SUMMARY ***
Total pot $4 | Rake $0.20
Board [Qs 7c 8d Th 6s]
Seat 1: o8A5MUdudVKu+pAwgZOX2w folded on the River
Seat 2: m1sJRkJZ1wu5i1BdgeO2Jw folded on the River
Seat 3: TalCiLYHCd+ffkmR3auPvA (button) folded before Flop (didn't bet)
Seat 4: TSuRyAHnUPCFjP7Z0rEE0w (small blind) collected ($3.80)
Seat 5: j7NIOHLZk7V2o9fOioO5ug (big blind) folded on the River
Seat 6: YsLQ3BAvgQHWXMAv3Wv6Hg folded before Flop (didn't bet)



PokerStars Game #59939306554:  Hold'em No Limit ($0.50/$1.00) - 2009/07/01 0:36:30 ET
Table 'QBLDswtHe7Ml0HwAdcMhlw' 2-max Seat #1 is the button
Seat 1: hdNlhiCwI533uwvvTTfC9Q ($100.70 in chips)
Seat 2: GBkvjkjDWVBEa1e14dh6CA ($62.50 in chips)
hdNlhiCwI533uwvvTTfC9Q: posts small blind $0.50
GBkvjkjDWVBEa1e14dh6CA: posts big blind $1
*** HOLE CARDS ***
hdNlhiCwI533uwvvTTfC9Q: raises $2 to $3
GBkvjkjDWVBEa1e14dh6CA: folds
hdNlhiCwI533uwvvTTfC9Q collected $2 from pot
hdNlhiCwI533uwvvTTfC9Q: doesn't show hand
*** SUMMARY ***
Total pot $2 | Rake $0
Seat 1: hdNlhiCwI533uwvvTTfC9Q (button) (small blind) collected ($2)
Seat 2: GBkvjkjDWVBEa1e14dh6CA (big blind) folded before Flop



PokerStars Game #59939306694:  Hold'em No Limit ($0.50/$1.00) - 2009/07/01 0:36:30 ET
Table 'pHrhryH8jPNdQfY62f8v+g' 6-max Seat #2 is the button
Seat 1: BdbmJTZZ47quA9vUWwXtlw ($89.85 in chips)
Seat 2: RqgF7gRoKgRNW8Zoi1ty4A ($115 in chips)
Seat 4: wenbG7TaM3H7h5kn78OFNw ($57.30 in chips)
Seat 5: r1/R7y0Ortgoz4lccgW8VA ($38.50 in chips)
Seat 6: xAU6q2/cwmby2sxmA8VcmA ($102.80 in chips)
wenbG7TaM3H7h5kn78OFNw: posts small blind $0.50
r1/R7y0Ortgoz4lccgW8VA: posts big blind $1
*** HOLE CARDS ***
xAU6q2/cwmby2sxmA8VcmA: raises $3 to $4
BdbmJTZZ47quA9vUWwXtlw: folds
RqgF7gRoKgRNW8Zoi1ty4A: folds
wenbG7TaM3H7h5kn78OFNw: folds
r1/R7y0Ortgoz4lccgW8VA: folds
xAU6q2/cwmby2sxmA8VcmA collected $2.50 from pot
*** SUMMARY ***
Total pot $2.50 | Rake $0
Seat 1: BdbmJTZZ47quA9vUWwXtlw folded before Flop (didn't bet)
Seat 2: RqgF7gRoKgRNW8Zoi1ty4A (button) folded before Flop (didn't bet)
Seat 4: wenbG7TaM3H7h5kn78OFNw (small blind) folded before Flop
Seat 5: r1/R7y0Ortgoz4lccgW8VA (big blind) folded before Flop
Seat 6: xAU6q2/cwmby2sxmA8VcmA collected ($2.50)



PokerStars Game #59939306516:  Hold'em No Limit ($0.50/$1.00) - 2009/07/01 0:36:30 ET
Table '/RZcOwpZpHQ+OwPwjsbnRw' 6-max Seat #4 is the button
Seat 1: Zboa6dColKGHBjLPUakZjw ($53.70 in chips)
Seat 2: +xW7QemQU0Fxs+4TnqBRow ($100.50 in chips)
Seat 4: j7NIOHLZk7V2o9fOioO5ug ($115.40 in chips)
Seat 5: wx3sQGkVi2x9wJXuWNHPBw ($198.65 in chips)
Seat 6: XOIf9W+VAxhZqN+SYoyMKA ($290.05 in chips)
wx3sQGkVi2x9wJXuWNHPBw: posts small blind $0.50
XOIf9W+VAxhZqN+SYoyMKA: posts big blind $1
*** HOLE CARDS ***
Zboa6dColKGHBjLPUakZjw: folds
+xW7QemQU0Fxs+4TnqBRow: folds
j7NIOHLZk7V2o9fOioO5ug: raises $2 to $3
wx3sQGkVi2x9wJXuWNHPBw: folds
XOIf9W+VAxhZqN+SYoyMKA: folds
j7NIOHLZk7V2o9fOioO5ug collected $2.50 from pot
j7NIOHLZk7V2o9fOioO5ug: doesn't show hand
*** SUMMARY ***
Total pot $2.50 | Rake $0
Seat 1: Zboa6dColKGHBjLPUakZjw folded before Flop (didn't bet)
Seat 2: +xW7QemQU0Fxs+4TnqBRow folded before Flop (didn't bet)
Seat 4: j7NIOHLZk7V2o9fOioO5ug (button) collected ($2.50)
Seat 5: wx3sQGkVi2x9wJXuWNHPBw (small blind) folded before Flop
Seat 6: XOIf9W+VAxhZqN+SYoyMKA (big blind) folded before Flop



PokerStars Game #59939307092:  Hold'em No Limit ($0.50/$1.00) - 2009/07/01 0:36:31 ET
Table 'hugOjcwJvzEwZbK7tyiWuQ' 9-max Seat #9 is the button
Seat 1: N9n5Wc3s35DpCrOAUUNAaQ ($127.50 in chips)
Seat 2: r27C1nIV4NS4+qbnrgBQSw ($257.05 in chips)
Seat 3: jDwhY1kCdc6EkAHbT7PJMQ ($107.65 in chips)
Seat 4: UWB3oeddt/GObx2Mix2Anw ($210.25 in chips)
Seat 6: gUUvmqdVlmvpal6B8nYrmg ($100 in chips)
Seat 7: FL3MrLspcF23LYvC4ipBOA ($100 in chips)
Seat 8: /zy+DB4S5fUQUSfZWFzYGw ($105.75 in chips)
Seat 9: o6JyUkbzCDw8tUabqtmnlg ($61.20 in chips)
N9n5Wc3s35DpCrOAUUNAaQ: posts small blind $0.50
r27C1nIV4NS4+qbnrgBQSw: posts big blind $1
5BRGWf+R3nt2WS3b5xX+zA: sits out
*** HOLE CARDS ***
jDwhY1kCdc6EkAHbT7PJMQ: raises $3 to $4
UWB3oeddt/GObx2Mix2Anw: folds
gUUvmqdVlmvpal6B8nYrmg: folds
FL3MrLspcF23LYvC4ipBOA: folds
/zy+DB4S5fUQUSfZWFzYGw: folds
o6JyUkbzCDw8tUabqtmnlg: folds
N9n5Wc3s35DpCrOAUUNAaQ: folds
r27C1nIV4NS4+qbnrgBQSw: folds
jDwhY1kCdc6EkAHbT7PJMQ collected $2.50 from pot
*** SUMMARY ***
Total pot $2.50 | Rake $0
Seat 1: N9n5Wc3s35DpCrOAUUNAaQ (small blind) folded before Flop
Seat 2: r27C1nIV4NS4+qbnrgBQSw (big blind) folded before Flop
Seat 3: jDwhY1kCdc6EkAHbT7PJMQ collected ($2.50)
Seat 4: UWB3oeddt/GObx2Mix2Anw folded before Flop (didn't bet)
Seat 6: gUUvmqdVlmvpal6B8nYrmg folded before Flop (didn't bet)
Seat 7: FL3MrLspcF23LYvC4ipBOA folded before Flop (didn't bet)
Seat 8: /zy+DB4S5fUQUSfZWFzYGw folded before Flop (didn't bet)
Seat 9: o6JyUkbzCDw8tUabqtmnlg (button) folded before Flop (didn't bet)



PokerStars Game #59939309850:  Hold'em No Limit ($0.50/$1.00) - 2009/07/01 0:36:35 ET
Table '21a4iYFKcuezM4nYx8DWTA' 2-max Seat #1 is the button
Seat 1: NYi6JFscYNrofSXy4sM+Yw ($204.95 in chips)
Seat 2: mJHc7tEZG3SVIX7QQjb5EQ ($13 in chips)
NYi6JFscYNrofSXy4sM+Yw: posts small blind $0.50
mJHc7tEZG3SVIX7QQjb5EQ: posts big blind $1
*** HOLE CARDS ***
NYi6JFscYNrofSXy4sM+Yw: raises $1 to $2
mJHc7tEZG3SVIX7QQjb5EQ: raises $11 to $13 and is all-in
NYi6JFscYNrofSXy4sM+Yw: folds
mJHc7tEZG3SVIX7QQjb5EQ collected $4 from pot
mJHc7tEZG3SVIX7QQjb5EQ: doesn't show hand
*** SUMMARY ***
Total pot $4 | Rake $0
Seat 1: NYi6JFscYNrofSXy4sM+Yw (button) (small blind) folded before Flop
Seat 2: mJHc7tEZG3SVIX7QQjb5EQ (big blind) collected ($4)



PokerStars Game #59939311386:  Hold'em No Limit ($0.50/$1.00) - 2009/07/01 0:36:37 ET
Table 'LmXQK9xy3awB+qsPzI21Mw' 2-max Seat #1 is the button
Seat 1: NYi6JFscYNrofSXy4sM+Yw ($246.05 in chips)
Seat 2: TME8GvochpQAo8cmJwWmvA ($94.80 in chips)
NYi6JFscYNrofSXy4sM+Yw: posts small blind $0.50
TME8GvochpQAo8cmJwWmvA: posts big blind $1
*** HOLE CARDS ***
NYi6JFscYNrofSXy4sM+Yw: raises $2 to $3
TME8GvochpQAo8cmJwWmvA: folds
NYi6JFscYNrofSXy4sM+Yw collected $2 from pot
NYi6JFscYNrofSXy4sM+Yw: doesn't show hand
*** SUMMARY ***
Total pot $2 | Rake $0
Seat 1: NYi6JFscYNrofSXy4sM+Yw (button) (small blind) collected ($2)
Seat 2: TME8GvochpQAo8cmJwWmvA (big blind) folded before Flop



PokerStars Game #59939311444:  Hold'em No Limit ($0.50/$1.00) - 2009/07/01 0:36:37 ET
Table '+cA8mcmhaedZ7YcrDdhmeQ' 6-max Seat #4 is the button
Seat 1: lsLuWlcPA3Rh7kJVLzMh0Q ($304.25 in chips)
Seat 2: RqgF7gRoKgRNW8Zoi1ty4A ($104.20 in chips)
Seat 3: 7H5WkGzGvsv56y1iaqHvRg ($44.55 in chips)
Seat 4: LjL3AIERHn559yyW1mTUYQ ($155.50 in chips)
Seat 5: iHo1oDbrEVJ8nEGdaPrICw ($100 in chips)
Seat 6: YfsTQsY/fxb+YqbdclTHuw ($53.35 in chips)
iHo1oDbrEVJ8nEGdaPrICw: posts small blind $0.50
YfsTQsY/fxb+YqbdclTHuw: posts big blind $1
*** HOLE CARDS ***
lsLuWlcPA3Rh7kJVLzMh0Q: folds
RqgF7gRoKgRNW8Zoi1ty4A: folds
7H5WkGzGvsv56y1iaqHvRg: folds
LjL3AIERHn559yyW1mTUYQ is disconnected
LjL3AIERHn559yyW1mTUYQ is connected
LjL3AIERHn559yyW1mTUYQ: folds
iHo1oDbrEVJ8nEGdaPrICw: raises $2 to $3
YfsTQsY/fxb+YqbdclTHuw: calls $2
*** FLOP *** [2h 5d Td]
iHo1oDbrEVJ8nEGdaPrICw: bets $5
YfsTQsY/fxb+YqbdclTHuw: folds
iHo1oDbrEVJ8nEGdaPrICw collected $5.70 from pot
*** SUMMARY ***
Total pot $6 | Rake $0.30
Board [2h 5d Td]
Seat 1: lsLuWlcPA3Rh7kJVLzMh0Q folded before Flop (didn't bet)
Seat 2: RqgF7gRoKgRNW8Zoi1ty4A folded before Flop (didn't bet)
Seat 3: 7H5WkGzGvsv56y1iaqHvRg folded before Flop (didn't bet)
Seat 4: LjL3AIERHn559yyW1mTUYQ (button) folded before Flop (didn't bet)
Seat 5: iHo1oDbrEVJ8nEGdaPrICw (small blind) collected ($5.70)
Seat 6: YfsTQsY/fxb+YqbdclTHuw (big blind) folded on the Flop



PokerStars Game #59939312104:  Hold'em No Limit ($0.50/$1.00) - 2009/07/01 0:36:38 ET
Table 'MUPc8FEpe/nR0BKSeReX6Q' 6-max Seat #4 is the button
Seat 1: YsLQ3BAvgQHWXMAv3Wv6Hg ($100 in chips)
Seat 2: xAU6q2/cwmby2sxmA8VcmA ($111.70 in chips)
Seat 3: wx3sQGkVi2x9wJXuWNHPBw ($234.05 in chips)
Seat 4: ZA1bp6g8IwtTxkUE4eCjDQ ($173.45 in chips)
Seat 5: UBZQqpnJZdTYYY1FTb0rLA ($100 in chips)
Seat 6: oxnw0GLLpFanjhGkxfRSqA ($60 in chips)
UBZQqpnJZdTYYY1FTb0rLA: posts small blind $0.50
oxnw0GLLpFanjhGkxfRSqA: posts big blind $1
*** HOLE CARDS ***
YsLQ3BAvgQHWXMAv3Wv6Hg: folds
xAU6q2/cwmby2sxmA8VcmA: folds
wx3sQGkVi2x9wJXuWNHPBw has timed out
wx3sQGkVi2x9wJXuWNHPBw: folds
wx3sQGkVi2x9wJXuWNHPBw is sitting out
ZA1bp6g8IwtTxkUE4eCjDQ: folds
wx3sQGkVi2x9wJXuWNHPBw has returned
UBZQqpnJZdTYYY1FTb0rLA: folds
oxnw0GLLpFanjhGkxfRSqA collected $1 from pot
*** SUMMARY ***
Total pot $1 | Rake $0
Seat 1: YsLQ3BAvgQHWXMAv3Wv6Hg folded before Flop (didn't bet)
Seat 2: xAU6q2/cwmby2sxmA8VcmA folded before Flop (didn't bet)
Seat 3: wx3sQGkVi2x9wJXuWNHPBw folded before Flop (didn't bet)
Seat 4: ZA1bp6g8IwtTxkUE4eCjDQ (button) folded before Flop (didn't bet)
Seat 5: UBZQqpnJZdTYYY1FTb0rLA (small blind) folded before Flop
Seat 6: oxnw0GLLpFanjhGkxfRSqA (big blind) collected ($1)



PokerStars Game #59939313206:  Hold'em No Limit ($0.50/$1.00) - 2009/07/01 0:36:40 ET
Table 'VOs36P6NW+QyXeQ1B62kmA' 6-max Seat #2 is the button
Seat 1: AdLVjddOzm+sRNo1Bc3S6Q ($142.30 in chips)
Seat 2: KpnW5CcJ4Mg6MeclfKmLrw ($111.80 in chips)
Seat 3: TSuRyAHnUPCFjP7Z0rEE0w ($100 in chips)
Seat 4: w02zQzNydODiyV9THKgo9w ($42.80 in chips)
Seat 5: X7GlkHF+lkbarCLuZ4Uf0w ($24.25 in chips)
Seat 6: 6tvjsJrdmWg+g7FVrMnzXA ($58.60 in chips)
TSuRyAHnUPCFjP7Z0rEE0w: posts small blind $0.50
w02zQzNydODiyV9THKgo9w: posts big blind $1
*** HOLE CARDS ***
X7GlkHF+lkbarCLuZ4Uf0w: folds
6tvjsJrdmWg+g7FVrMnzXA: calls $1
AdLVjddOzm+sRNo1Bc3S6Q: folds
KpnW5CcJ4Mg6MeclfKmLrw: folds
TSuRyAHnUPCFjP7Z0rEE0w: folds
w02zQzNydODiyV9THKgo9w: checks
*** FLOP *** [2s Kd 4h]
w02zQzNydODiyV9THKgo9w: checks
6tvjsJrdmWg+g7FVrMnzXA: bets $1
w02zQzNydODiyV9THKgo9w: calls $1
*** TURN *** [2s Kd 4h] [Kh]
w02zQzNydODiyV9THKgo9w: checks
6tvjsJrdmWg+g7FVrMnzXA: bets $1
w02zQzNydODiyV9THKgo9w: calls $1
*** RIVER *** [2s Kd 4h Kh] [5h]
w02zQzNydODiyV9THKgo9w: checks
6tvjsJrdmWg+g7FVrMnzXA: bets $2
w02zQzNydODiyV9THKgo9w: calls $2
*** SHOW DOWN ***
6tvjsJrdmWg+g7FVrMnzXA: shows [5d 2d] (two pair, Kings and Fives)
w02zQzNydODiyV9THKgo9w: mucks hand
6tvjsJrdmWg+g7FVrMnzXA collected $10 from pot
*** SUMMARY ***
Total pot $10.50 | Rake $0.50
Board [2s Kd 4h Kh 5h]
Seat 1: AdLVjddOzm+sRNo1Bc3S6Q folded before Flop (didn't bet)
Seat 2: KpnW5CcJ4Mg6MeclfKmLrw (button) folded before Flop (didn't bet)
Seat 3: TSuRyAHnUPCFjP7Z0rEE0w (small blind) folded before Flop
Seat 4: w02zQzNydODiyV9THKgo9w (big blind) mucked
Seat 5: X7GlkHF+lkbarCLuZ4Uf0w folded before Flop (didn't bet)
Seat 6: 6tvjsJrdmWg+g7FVrMnzXA showed [5d 2d] and won ($10) with two pair, Kings and Fives



PokerStars Game #59939313186:  Hold'em No Limit ($0.50/$1.00) - 2009/07/01 0:36:40 ET
Table 'tLrtq7gDzxEvckNAI1OS5Q' 6-max Seat #3 is the button
Seat 2: QHvTZcrKe6+maWUfVjP29Q ($110.85 in chips)
Seat 3: TPZ+m9x+lwoKpv7TMfAUWA ($318.30 in chips)
Seat 5: OGMLOcTNYZXZU81au7ztUw ($151.10 in chips)
Seat 6: XUk5GQsfNFpHvaToDZ0rZA ($85.50 in chips)
OGMLOcTNYZXZU81au7ztUw: posts small blind $0.50
XUk5GQsfNFpHvaToDZ0rZA: posts big blind $1
*** HOLE CARDS ***
QHvTZcrKe6+maWUfVjP29Q: raises $2.50 to $3.50
TPZ+m9x+lwoKpv7TMfAUWA has timed out
TPZ+m9x+lwoKpv7TMfAUWA: folds
TPZ+m9x+lwoKpv7TMfAUWA is sitting out
TPZ+m9x+lwoKpv7TMfAUWA said, "true"
OGMLOcTNYZXZU81au7ztUw: folds
XUk5GQsfNFpHvaToDZ0rZA: folds
QHvTZcrKe6+maWUfVjP29Q collected $2.50 from pot
QHvTZcrKe6+maWUfVjP29Q: doesn't show hand
*** SUMMARY ***
Total pot $2.50 | Rake $0
Seat 2: QHvTZcrKe6+maWUfVjP29Q collected ($2.50)
Seat 3: TPZ+m9x+lwoKpv7TMfAUWA (button) folded before Flop (didn't bet)
Seat 5: OGMLOcTNYZXZU81au7ztUw (small blind) folded before Flop
Seat 6: XUk5GQsfNFpHvaToDZ0rZA (big blind) folded before Flop



PokerStars Game #59939314084:  Hold'em No Limit ($0.50/$1.00) - 2009/07/01 0:36:42 ET
Table 'QBLDswtHe7Ml0HwAdcMhlw' 2-max Seat #2 is the button
Seat 1: hdNlhiCwI533uwvvTTfC9Q ($101.70 in chips)
Seat 2: GBkvjkjDWVBEa1e14dh6CA ($61.50 in chips)
GBkvjkjDWVBEa1e14dh6CA: posts small blind $0.50
hdNlhiCwI533uwvvTTfC9Q: posts big blind $1
*** HOLE CARDS ***
GBkvjkjDWVBEa1e14dh6CA: folds
hdNlhiCwI533uwvvTTfC9Q collected $1 from pot
hdNlhiCwI533uwvvTTfC9Q: doesn't show hand
*** SUMMARY ***
Total pot $1 | Rake $0
Seat 1: hdNlhiCwI533uwvvTTfC9Q (big blind) collected ($1)
Seat 2: GBkvjkjDWVBEa1e14dh6CA (button) (small blind) folded before Flop



PokerStars Game #59939315416:  Hold'em No Limit ($0.50/$1.00) - 2009/07/01 0:36:43 ET
Table 'LmXQK9xy3awB+qsPzI21Mw' 2-max Seat #2 is the button
Seat 1: NYi6JFscYNrofSXy4sM+Yw ($247.05 in chips)
Seat 2: TME8GvochpQAo8cmJwWmvA ($93.80 in chips)
TME8GvochpQAo8cmJwWmvA: posts small blind $0.50
NYi6JFscYNrofSXy4sM+Yw: posts big blind $1
*** HOLE CARDS ***
TME8GvochpQAo8cmJwWmvA: raises $1 to $2
NYi6JFscYNrofSXy4sM+Yw: folds
TME8GvochpQAo8cmJwWmvA collected $2 from pot
TME8GvochpQAo8cmJwWmvA: doesn't show hand
*** SUMMARY ***
Total pot $2 | Rake $0
Seat 1: NYi6JFscYNrofSXy4sM+Yw (big blind) folded before Flop
Seat 2: TME8GvochpQAo8cmJwWmvA (button) (small blind) collected ($2)



PokerStars Game #59939314908:  Hold'em No Limit ($0.50/$1.00) - 2009/07/01 0:36:43 ET
Table 'fTlPiCj0utgzC/5io+I7ew' 6-max Seat #4 is the button
Seat 1: YMJG+F++3Aj6P8dAWda5fw ($98.50 in chips)
Seat 2: Qy/UBNbD2HaA0Ogxg8Sf3w ($101.50 in chips)
Seat 3: oDiBRCaF0QVtd3kO6xZIXw ($89.60 in chips)
Seat 4: uJVSceLggtsrJya+WtmUEA ($97.30 in chips)
Seat 5: bFrTkDcWGTxyvNul7GVdYg ($255.70 in chips)
Seat 6: jMljU/dOPMXfJi8OmbdYdw ($53.95 in chips)
bFrTkDcWGTxyvNul7GVdYg: posts small blind $0.50
jMljU/dOPMXfJi8OmbdYdw: posts big blind $1
*** HOLE CARDS ***
YMJG+F++3Aj6P8dAWda5fw: folds
Qy/UBNbD2HaA0Ogxg8Sf3w: raises $2.50 to $3.50
oDiBRCaF0QVtd3kO6xZIXw: folds
uJVSceLggtsrJya+WtmUEA: folds
bFrTkDcWGTxyvNul7GVdYg: folds
jMljU/dOPMXfJi8OmbdYdw: calls $2.50
*** FLOP *** [6d Td 8h]
jMljU/dOPMXfJi8OmbdYdw: checks
Qy/UBNbD2HaA0Ogxg8Sf3w: checks
*** TURN *** [6d Td 8h] [3s]
jMljU/dOPMXfJi8OmbdYdw: bets $2
Qy/UBNbD2HaA0Ogxg8Sf3w: raises $2 to $4
jMljU/dOPMXfJi8OmbdYdw: calls $2
*** RIVER *** [6d Td 8h 3s] [Ts]
jMljU/dOPMXfJi8OmbdYdw: bets $4
Qy/UBNbD2HaA0Ogxg8Sf3w: folds
jMljU/dOPMXfJi8OmbdYdw collected $14.75 from pot
*** SUMMARY ***
Total pot $15.50 | Rake $0.75
Board [6d Td 8h 3s Ts]
Seat 1: YMJG+F++3Aj6P8dAWda5fw folded before Flop (didn't bet)
Seat 2: Qy/UBNbD2HaA0Ogxg8Sf3w folded on the River
Seat 3: oDiBRCaF0QVtd3kO6xZIXw folded before Flop (didn't bet)
Seat 4: uJVSceLggtsrJya+WtmUEA (button) folded before Flop (didn't bet)
Seat 5: bFrTkDcWGTxyvNul7GVdYg (small blind) folded before Flop
Seat 6: jMljU/dOPMXfJi8OmbdYdw (big blind) collected ($14.75)



PokerStars Game #59939315090:  Hold'em No Limit ($0.50/$1.00) - 2009/07/01 0:36:43 ET
Table 'N2bNCDHL96aCQDvZIh+yQQ' 6-max Seat #2 is the button
Seat 1: iHo1oDbrEVJ8nEGdaPrICw ($143.50 in chips)
Seat 2: KpnW5CcJ4Mg6MeclfKmLrw ($110.40 in chips)
Seat 3: Qy/UBNbD2HaA0Ogxg8Sf3w ($100.50 in chips)
Seat 4: uCqEjnxh2/vFBjKYkfTOkw ($175.55 in chips)
Seat 5: rHlMOfR7kpQQxe+PFQz0xQ ($30 in chips)
Seat 6: TSuRyAHnUPCFjP7Z0rEE0w ($100 in chips)
Qy/UBNbD2HaA0Ogxg8Sf3w: posts small blind $0.50
uCqEjnxh2/vFBjKYkfTOkw: posts big blind $1
*** HOLE CARDS ***
rHlMOfR7kpQQxe+PFQz0xQ: folds
TSuRyAHnUPCFjP7Z0rEE0w: folds
iHo1oDbrEVJ8nEGdaPrICw: folds
KpnW5CcJ4Mg6MeclfKmLrw: raises $2 to $3
Qy/UBNbD2HaA0Ogxg8Sf3w: folds
uCqEjnxh2/vFBjKYkfTOkw: calls $2
*** FLOP *** [Qd Ac 9c]
uCqEjnxh2/vFBjKYkfTOkw: checks
KpnW5CcJ4Mg6MeclfKmLrw: bets $5
uCqEjnxh2/vFBjKYkfTOkw: folds
KpnW5CcJ4Mg6MeclfKmLrw collected $6.20 from pot
*** SUMMARY ***
Total pot $6.50 | Rake $0.30
Board [Qd Ac 9c]
Seat 1: iHo1oDbrEVJ8nEGdaPrICw folded before Flop (didn't bet)
Seat 2: KpnW5CcJ4Mg6MeclfKmLrw (button) collected ($6.20)
Seat 3: Qy/UBNbD2HaA0Ogxg8Sf3w (small blind) folded before Flop
Seat 4: uCqEjnxh2/vFBjKYkfTOkw (big blind) folded on the Flop
Seat 5: rHlMOfR7kpQQxe+PFQz0xQ folded before Flop (didn't bet)
Seat 6: TSuRyAHnUPCFjP7Z0rEE0w folded before Flop (didn't bet)



PokerStars Game #59939315456:  Hold'em No Limit ($0.50/$1.00) - 2009/07/01 0:36:44 ET
Table '21a4iYFKcuezM4nYx8DWTA' 2-max Seat #2 is the button
Seat 1: NYi6JFscYNrofSXy4sM+Yw ($202.95 in chips)
Seat 2: mJHc7tEZG3SVIX7QQjb5EQ ($15 in chips)
mJHc7tEZG3SVIX7QQjb5EQ: posts small blind $0.50
NYi6JFscYNrofSXy4sM+Yw: posts big blind $1
*** HOLE CARDS ***
mJHc7tEZG3SVIX7QQjb5EQ: folds
NYi6JFscYNrofSXy4sM+Yw collected $1 from pot
*** SUMMARY ***
Total pot $1 | Rake $0
Seat 1: NYi6JFscYNrofSXy4sM+Yw (big blind) collected ($1)
Seat 2: mJHc7tEZG3SVIX7QQjb5EQ (button) (small blind) folded before Flop



PokerStars Game #59939316268:  Hold'em No Limit ($0.50/$1.00) - 2009/07/01 0:36:45 ET
Table 'U9zqzC8f3oTJ2ShXFgSSOA' 6-max Seat #6 is the button
Seat 1: tS9JHB1h+FQ++qu8RwRNgg ($33.50 in chips)
Seat 2: U2CWBTv29qdCbj8RNF2sIw ($100 in chips)
Seat 3: yfXek8iJ7O4CFyqXrtGcfg ($20.05 in chips)
Seat 4: 33q95we0Etwgrm6guQGncw ($72.15 in chips)
Seat 5: KfwW5us6tydK81NYTtK1gw ($309.75 in chips)
Seat 6: aIxzFKdtpDSkUePKZy/niQ ($67.60 in chips)
tS9JHB1h+FQ++qu8RwRNgg: posts small blind $0.50
U2CWBTv29qdCbj8RNF2sIw: posts big blind $1
*** HOLE CARDS ***
yfXek8iJ7O4CFyqXrtGcfg: raises $1 to $2
33q95we0Etwgrm6guQGncw: folds
KfwW5us6tydK81NYTtK1gw: folds
aIxzFKdtpDSkUePKZy/niQ: folds
tS9JHB1h+FQ++qu8RwRNgg: calls $1.50
U2CWBTv29qdCbj8RNF2sIw: calls $1
*** FLOP *** [Ac 5s 3c]
tS9JHB1h+FQ++qu8RwRNgg: checks
U2CWBTv29qdCbj8RNF2sIw: checks
yfXek8iJ7O4CFyqXrtGcfg: checks
*** TURN *** [Ac 5s 3c] [Jc]
tS9JHB1h+FQ++qu8RwRNgg: bets $2
U2CWBTv29qdCbj8RNF2sIw: folds
yfXek8iJ7O4CFyqXrtGcfg: calls $2
*** RIVER *** [Ac 5s 3c Jc] [6d]
tS9JHB1h+FQ++qu8RwRNgg: bets $11
yfXek8iJ7O4CFyqXrtGcfg: folds
tS9JHB1h+FQ++qu8RwRNgg collected $9.55 from pot
tS9JHB1h+FQ++qu8RwRNgg: doesn't show hand
*** SUMMARY ***
Total pot $10 | Rake $0.45
Board [Ac 5s 3c Jc 6d]
Seat 1: tS9JHB1h+FQ++qu8RwRNgg (small blind) collected ($9.55)
Seat 2: U2CWBTv29qdCbj8RNF2sIw (big blind) folded on the Turn
Seat 3: yfXek8iJ7O4CFyqXrtGcfg folded on the River
Seat 4: 33q95we0Etwgrm6guQGncw folded before Flop (didn't bet)
Seat 5: KfwW5us6tydK81NYTtK1gw folded before Flop (didn't bet)
Seat 6: aIxzFKdtpDSkUePKZy/niQ (button) folded before Flop (didn't bet)



PokerStars Game #59939318620:  Hold'em No Limit ($0.50/$1.00) - 2009/07/01 0:36:48 ET
Table 'QBLDswtHe7Ml0HwAdcMhlw' 2-max Seat #1 is the button
Seat 1: hdNlhiCwI533uwvvTTfC9Q ($102.20 in chips)
Seat 2: GBkvjkjDWVBEa1e14dh6CA ($61 in chips)
hdNlhiCwI533uwvvTTfC9Q: posts small blind $0.50
GBkvjkjDWVBEa1e14dh6CA: posts big blind $1
*** HOLE CARDS ***
hdNlhiCwI533uwvvTTfC9Q: raises $2 to $3
GBkvjkjDWVBEa1e14dh6CA: folds
hdNlhiCwI533uwvvTTfC9Q collected $2 from pot
hdNlhiCwI533uwvvTTfC9Q: doesn't show hand
*** SUMMARY ***
Total pot $2 | Rake $0
Seat 1: hdNlhiCwI533uwvvTTfC9Q (button) (small blind) collected ($2)
Seat 2: GBkvjkjDWVBEa1e14dh6CA (big blind) folded before Flop



PokerStars Game #59939318520:  Hold'em No Limit ($0.50/$1.00) - 2009/07/01 0:36:48 ET
Table '7Nl0ffnjeK44/vmeexh3MQ' 9-max Seat #9 is the button
Seat 1: s7D3Y+k4Cj4D1cXHv7oj+Q ($98.30 in chips)
Seat 2: kiakSwxX0e64PwYGAPQvLw ($31.85 in chips)
Seat 3: vR4IO10geOgvTW+LAUBv/A ($100 in chips)
Seat 4: bLbSOSmSOnqE0iTcH/5dxA ($100 in chips)
Seat 5: bL+QVeDcuEdzMGAGg2XJHg ($103.90 in chips)
Seat 6: FVs16t7GgfWgQWt4JxsObQ ($21.45 in chips)
Seat 8: zanka7aAZkigmZpfopXxxA ($227.70 in chips)
Seat 9: ouwUBGRKnKK9uhn1G4Lf+A ($98 in chips)
s7D3Y+k4Cj4D1cXHv7oj+Q: posts small blind $0.50
kiakSwxX0e64PwYGAPQvLw: posts big blind $1
*** HOLE CARDS ***
vR4IO10geOgvTW+LAUBv/A: folds
bLbSOSmSOnqE0iTcH/5dxA: folds
bL+QVeDcuEdzMGAGg2XJHg: raises $3 to $4
FVs16t7GgfWgQWt4JxsObQ: folds
zanka7aAZkigmZpfopXxxA: raises $8 to $12
ouwUBGRKnKK9uhn1G4Lf+A: folds
s7D3Y+k4Cj4D1cXHv7oj+Q: folds
kiakSwxX0e64PwYGAPQvLw: folds
bL+QVeDcuEdzMGAGg2XJHg: folds
zanka7aAZkigmZpfopXxxA collected $9.50 from pot
zanka7aAZkigmZpfopXxxA: doesn't show hand
*** SUMMARY ***
Total pot $9.50 | Rake $0
Seat 1: s7D3Y+k4Cj4D1cXHv7oj+Q (small blind) folded before Flop
Seat 2: kiakSwxX0e64PwYGAPQvLw (big blind) folded before Flop
Seat 3: vR4IO10geOgvTW+LAUBv/A folded before Flop (didn't bet)
Seat 4: bLbSOSmSOnqE0iTcH/5dxA folded before Flop (didn't bet)
Seat 5: bL+QVeDcuEdzMGAGg2XJHg folded before Flop
Seat 6: FVs16t7GgfWgQWt4JxsObQ folded before Flop (didn't bet)
Seat 8: zanka7aAZkigmZpfopXxxA collected ($9.50)
Seat 9: ouwUBGRKnKK9uhn1G4Lf+A (button) folded before Flop (didn't bet)



PokerStars Game #59939318862:  Hold'em No Limit ($0.50/$1.00) - 2009/07/01 0:36:49 ET
Table 'rmZfTK+oSebeUPJNbWhdAA' 6-max Seat #5 is the button
Seat 1: xAU6q2/cwmby2sxmA8VcmA ($100 in chips)
Seat 3: 9yjOzGERLaEZS8CZ6YNHFg ($111.40 in chips)
Seat 4: OGMLOcTNYZXZU81au7ztUw ($134.50 in chips)
Seat 5: +xW7QemQU0Fxs+4TnqBRow ($100 in chips)
Seat 6: j7NIOHLZk7V2o9fOioO5ug ($133 in chips)
j7NIOHLZk7V2o9fOioO5ug: posts small blind $0.50
xAU6q2/cwmby2sxmA8VcmA: posts big blind $1
z7O9PO/WEcqRouIydFhS9Q: sits out
*** HOLE CARDS ***
9yjOzGERLaEZS8CZ6YNHFg: folds
OGMLOcTNYZXZU81au7ztUw: folds
+xW7QemQU0Fxs+4TnqBRow: folds
j7NIOHLZk7V2o9fOioO5ug: folds
xAU6q2/cwmby2sxmA8VcmA collected $1 from pot
xAU6q2/cwmby2sxmA8VcmA: doesn't show hand
*** SUMMARY ***
Total pot $1 | Rake $0
Seat 1: xAU6q2/cwmby2sxmA8VcmA (big blind) collected ($1)
Seat 3: 9yjOzGERLaEZS8CZ6YNHFg folded before Flop (didn't bet)
Seat 4: OGMLOcTNYZXZU81au7ztUw folded before Flop (didn't bet)
Seat 5: +xW7QemQU0Fxs+4TnqBRow (button) folded before Flop (didn't bet)
Seat 6: j7NIOHLZk7V2o9fOioO5ug (small blind) folded before Flop



PokerStars Game #59939318658:  Hold'em No Limit ($0.50/$1.00) - 2009/07/01 0:36:49 ET
Table 'eU3bWpDDg3Z+9R4m4iVmog' 6-max Seat #1 is the button
Seat 1: TSuRyAHnUPCFjP7Z0rEE0w ($169.70 in chips)
Seat 2: 8CAoOzhmB8n3nRFf3V4BTg ($124.45 in chips)
Seat 3: U6tnjwZRpTnM+YkqkCjwyQ ($169.65 in chips)
Seat 4: GDVIsbEJ/DOJsMKE4Asz0A ($100.60 in chips)
Seat 5: AdLVjddOzm+sRNo1Bc3S6Q ($100 in chips)
Seat 6: hpxXcmRkXXI9HE5+5/j/0Q ($109.45 in chips)
8CAoOzhmB8n3nRFf3V4BTg: posts small blind $0.50
U6tnjwZRpTnM+YkqkCjwyQ: posts big blind $1
*** HOLE CARDS ***
GDVIsbEJ/DOJsMKE4Asz0A: folds
AdLVjddOzm+sRNo1Bc3S6Q: folds
hpxXcmRkXXI9HE5+5/j/0Q: folds
TSuRyAHnUPCFjP7Z0rEE0w: raises $3 to $4
8CAoOzhmB8n3nRFf3V4BTg: folds
U6tnjwZRpTnM+YkqkCjwyQ: folds
TSuRyAHnUPCFjP7Z0rEE0w collected $2.50 from pot
TSuRyAHnUPCFjP7Z0rEE0w: doesn't show hand
*** SUMMARY ***
Total pot $2.50 | Rake $0
Seat 1: TSuRyAHnUPCFjP7Z0rEE0w (button) collected ($2.50)
Seat 2: 8CAoOzhmB8n3nRFf3V4BTg (small blind) folded before Flop
Seat 3: U6tnjwZRpTnM+YkqkCjwyQ (big blind) folded before Flop
Seat 4: GDVIsbEJ/DOJsMKE4Asz0A folded before Flop (didn't bet)
Seat 5: AdLVjddOzm+sRNo1Bc3S6Q folded before Flop (didn't bet)
Seat 6: hpxXcmRkXXI9HE5+5/j/0Q folded before Flop (didn't bet)



PokerStars Game #59939319622:  Hold'em No Limit ($0.50/$1.00) - 2009/07/01 0:36:50 ET
Table 'LmXQK9xy3awB+qsPzI21Mw' 2-max Seat #1 is the button
Seat 1: NYi6JFscYNrofSXy4sM+Yw ($246.05 in chips)
Seat 2: TME8GvochpQAo8cmJwWmvA ($94.80 in chips)
NYi6JFscYNrofSXy4sM+Yw: posts small blind $0.50
TME8GvochpQAo8cmJwWmvA: posts big blind $1
*** HOLE CARDS ***
NYi6JFscYNrofSXy4sM+Yw: raises $1 to $2
TME8GvochpQAo8cmJwWmvA: folds
NYi6JFscYNrofSXy4sM+Yw collected $2 from pot
*** SUMMARY ***
Total pot $2 | Rake $0
Seat 1: NYi6JFscYNrofSXy4sM+Yw (button) (small blind) collected ($2)
Seat 2: TME8GvochpQAo8cmJwWmvA (big blind) folded before Flop



PokerStars Game #59939319804:  Hold'em No Limit ($0.50/$1.00) - 2009/07/01 0:36:50 ET
Table '/RZcOwpZpHQ+OwPwjsbnRw' 6-max Seat #5 is the button
Seat 1: Zboa6dColKGHBjLPUakZjw ($53.70 in chips)
Seat 2: +xW7QemQU0Fxs+4TnqBRow ($100.50 in chips)
Seat 4: j7NIOHLZk7V2o9fOioO5ug ($116.90 in chips)
Seat 5: wx3sQGkVi2x9wJXuWNHPBw ($198.15 in chips)
Seat 6: XOIf9W+VAxhZqN+SYoyMKA ($289.05 in chips)
XOIf9W+VAxhZqN+SYoyMKA: posts small blind $0.50
Zboa6dColKGHBjLPUakZjw: posts big blind $1
*** HOLE CARDS ***
+xW7QemQU0Fxs+4TnqBRow: raises $3 to $4
j7NIOHLZk7V2o9fOioO5ug: calls $4
wx3sQGkVi2x9wJXuWNHPBw has timed out
wx3sQGkVi2x9wJXuWNHPBw: folds
wx3sQGkVi2x9wJXuWNHPBw is sitting out
wx3sQGkVi2x9wJXuWNHPBw has returned
XOIf9W+VAxhZqN+SYoyMKA: folds
Zboa6dColKGHBjLPUakZjw: folds
*** FLOP *** [Jc 5c 9c]
+xW7QemQU0Fxs+4TnqBRow: checks
j7NIOHLZk7V2o9fOioO5ug: bets $8
+xW7QemQU0Fxs+4TnqBRow: calls $8
*** TURN *** [Jc 5c 9c] [4h]
+xW7QemQU0Fxs+4TnqBRow: checks
j7NIOHLZk7V2o9fOioO5ug: bets $17
+xW7QemQU0Fxs+4TnqBRow: calls $17
*** RIVER *** [Jc 5c 9c 4h] [7s]
+xW7QemQU0Fxs+4TnqBRow: checks
j7NIOHLZk7V2o9fOioO5ug: checks
*** SHOW DOWN ***
+xW7QemQU0Fxs+4TnqBRow: shows [Kh Js] (a pair of Jacks)
j7NIOHLZk7V2o9fOioO5ug: mucks hand
+xW7QemQU0Fxs+4TnqBRow collected $57.50 from pot
*** SUMMARY ***
Total pot $59.50 | Rake $2
Board [Jc 5c 9c 4h 7s]
Seat 1: Zboa6dColKGHBjLPUakZjw (big blind) folded before Flop
Seat 2: +xW7QemQU0Fxs+4TnqBRow showed [Kh Js] and won ($57.50) with a pair of Jacks
Seat 4: j7NIOHLZk7V2o9fOioO5ug mucked
Seat 5: wx3sQGkVi2x9wJXuWNHPBw (button) folded before Flop (didn't bet)
Seat 6: XOIf9W+VAxhZqN+SYoyMKA (small blind) folded before Flop



PokerStars Game #59939320822:  Hold'em No Limit ($0.50/$1.00) - 2009/07/01 0:36:52 ET
Table 'pHrhryH8jPNdQfY62f8v+g' 6-max Seat #4 is the button
Seat 1: BdbmJTZZ47quA9vUWwXtlw ($89.85 in chips)
Seat 2: RqgF7gRoKgRNW8Zoi1ty4A ($115 in chips)
Seat 4: wenbG7TaM3H7h5kn78OFNw ($56.80 in chips)
Seat 5: r1/R7y0Ortgoz4lccgW8VA ($37.50 in chips)
Seat 6: xAU6q2/cwmby2sxmA8VcmA ($104.30 in chips)
r1/R7y0Ortgoz4lccgW8VA: posts small blind $0.50
xAU6q2/cwmby2sxmA8VcmA: posts big blind $1
*** HOLE CARDS ***
BdbmJTZZ47quA9vUWwXtlw: folds
RqgF7gRoKgRNW8Zoi1ty4A: folds
BdbmJTZZ47quA9vUWwXtlw leaves the table
wenbG7TaM3H7h5kn78OFNw: raises $2 to $3
r1/R7y0Ortgoz4lccgW8VA: calls $2.50
xAU6q2/cwmby2sxmA8VcmA: folds
*** FLOP *** [2h Ad 2c]
r1/R7y0Ortgoz4lccgW8VA: checks
wenbG7TaM3H7h5kn78OFNw: checks
*** TURN *** [2h Ad 2c] [9c]
r1/R7y0Ortgoz4lccgW8VA: bets $5
wenbG7TaM3H7h5kn78OFNw: folds
r1/R7y0Ortgoz4lccgW8VA collected $6.65 from pot
*** SUMMARY ***
Total pot $7 | Rake $0.35
Board [2h Ad 2c 9c]
Seat 1: BdbmJTZZ47quA9vUWwXtlw folded before Flop (didn't bet)
Seat 2: RqgF7gRoKgRNW8Zoi1ty4A folded before Flop (didn't bet)
Seat 4: wenbG7TaM3H7h5kn78OFNw (button) folded on the Turn
Seat 5: r1/R7y0Ortgoz4lccgW8VA (small blind) collected ($6.65)
Seat 6: xAU6q2/cwmby2sxmA8VcmA (big blind) folded before Flop



PokerStars Game #59939320778:  Hold'em No Limit ($0.50/$1.00) - 2009/07/01 0:36:52 ET
Table '6YvsYDPNIDx2v5z3bJnwZQ' 9-max Seat #8 is the button
Seat 1: Ogn4JDV3mp4ZDKO49IFzKA ($14.50 in chips)
Seat 2: 35DmRulmD2MgzT6Bbt6/2w ($51.95 in chips)
Seat 3: negfosHnGOZXSHpWDRKyBQ ($19.30 in chips)
Seat 4: kEr5NYB+JIG5+szcYMr6hA ($45 in chips)
Seat 5: mBRWbnUl8diyBO1qTJaNzw ($160.70 in chips)
Seat 6: uMPEfCcGCfsxmy53tVUMug ($106.60 in chips)
Seat 7: boixc27eqTYA1p0tUdMuBQ ($114 in chips)
Seat 8: PSFxpXgPedVZyHSu2Zhb7Q ($46.75 in chips)
Seat 9: jDwhY1kCdc6EkAHbT7PJMQ ($104.60 in chips)
jDwhY1kCdc6EkAHbT7PJMQ: posts small blind $0.50
Ogn4JDV3mp4ZDKO49IFzKA: posts big blind $1
*** HOLE CARDS ***
35DmRulmD2MgzT6Bbt6/2w: folds
35DmRulmD2MgzT6Bbt6/2w leaves the table
negfosHnGOZXSHpWDRKyBQ: folds
kEr5NYB+JIG5+szcYMr6hA: folds
mBRWbnUl8diyBO1qTJaNzw: folds
x80+i7DJL+81v3quj7KbNg joins the table at seat #2
uMPEfCcGCfsxmy53tVUMug: raises $2 to $3
boixc27eqTYA1p0tUdMuBQ: folds
PSFxpXgPedVZyHSu2Zhb7Q: folds
jDwhY1kCdc6EkAHbT7PJMQ: folds
Ogn4JDV3mp4ZDKO49IFzKA: folds
uMPEfCcGCfsxmy53tVUMug collected $2.50 from pot
*** SUMMARY ***
Total pot $2.50 | Rake $0
Seat 1: Ogn4JDV3mp4ZDKO49IFzKA (big blind) folded before Flop
Seat 2: 35DmRulmD2MgzT6Bbt6/2w folded before Flop (didn't bet)
Seat 3: negfosHnGOZXSHpWDRKyBQ folded before Flop (didn't bet)
Seat 4: kEr5NYB+JIG5+szcYMr6hA folded before Flop (didn't bet)
Seat 5: mBRWbnUl8diyBO1qTJaNzw folded before Flop (didn't bet)
Seat 6: uMPEfCcGCfsxmy53tVUMug collected ($2.50)
Seat 7: boixc27eqTYA1p0tUdMuBQ folded before Flop (didn't bet)
Seat 8: PSFxpXgPedVZyHSu2Zhb7Q (button) folded before Flop (didn't bet)
Seat 9: jDwhY1kCdc6EkAHbT7PJMQ (small blind) folded before Flop



PokerStars Game #59939323584:  Hold'em No Limit ($0.50/$1.00) - 2009/07/01 0:36:56 ET
Table 'LmXQK9xy3awB+qsPzI21Mw' 2-max Seat #2 is the button
Seat 1: NYi6JFscYNrofSXy4sM+Yw ($247.05 in chips)
Seat 2: TME8GvochpQAo8cmJwWmvA ($93.80 in chips)
TME8GvochpQAo8cmJwWmvA: posts small blind $0.50
NYi6JFscYNrofSXy4sM+Yw: posts big blind $1
*** HOLE CARDS ***
TME8GvochpQAo8cmJwWmvA: folds
NYi6JFscYNrofSXy4sM+Yw collected $1 from pot
*** SUMMARY ***
Total pot $1 | Rake $0
Seat 1: NYi6JFscYNrofSXy4sM+Yw (big blind) collected ($1)
Seat 2: TME8GvochpQAo8cmJwWmvA (button) (small blind) folded before Flop



PokerStars Game #59939324864:  Hold'em No Limit ($0.50/$1.00) - 2009/07/01 0:36:58 ET
Table 'QBLDswtHe7Ml0HwAdcMhlw' 2-max Seat #2 is the button
Seat 1: hdNlhiCwI533uwvvTTfC9Q ($103.20 in chips)
Seat 2: GBkvjkjDWVBEa1e14dh6CA ($60 in chips)
GBkvjkjDWVBEa1e14dh6CA: posts small blind $0.50
hdNlhiCwI533uwvvTTfC9Q: posts big blind $1
*** HOLE CARDS ***
GBkvjkjDWVBEa1e14dh6CA: raises $2 to $3
hdNlhiCwI533uwvvTTfC9Q: folds
GBkvjkjDWVBEa1e14dh6CA collected $2 from pot
GBkvjkjDWVBEa1e14dh6CA: doesn't show hand
*** SUMMARY ***
Total pot $2 | Rake $0
Seat 1: hdNlhiCwI533uwvvTTfC9Q (big blind) folded before Flop
Seat 2: GBkvjkjDWVBEa1e14dh6CA (button) (small blind) collected ($2)



PokerStars Game #59939327420:  Hold'em No Limit ($0.50/$1.00) - 2009/07/01 0:37:02 ET
Table 'LmXQK9xy3awB+qsPzI21Mw' 2-max Seat #1 is the button
Seat 1: NYi6JFscYNrofSXy4sM+Yw ($247.55 in chips)
Seat 2: TME8GvochpQAo8cmJwWmvA ($93.30 in chips)
NYi6JFscYNrofSXy4sM+Yw: posts small blind $0.50
TME8GvochpQAo8cmJwWmvA: posts big blind $1
*** HOLE CARDS ***
NYi6JFscYNrofSXy4sM+Yw: raises $2 to $3
TME8GvochpQAo8cmJwWmvA: calls $2
*** FLOP *** [7c Jd 6c]
TME8GvochpQAo8cmJwWmvA: checks
NYi6JFscYNrofSXy4sM+Yw: bets $3
TME8GvochpQAo8cmJwWmvA: raises $87.30 to $90.30 and is all-in
NYi6JFscYNrofSXy4sM+Yw: folds
TME8GvochpQAo8cmJwWmvA collected $11.50 from pot
TME8GvochpQAo8cmJwWmvA: doesn't show hand
*** SUMMARY ***
Total pot $12 | Rake $0.50
Board [7c Jd 6c]
Seat 1: NYi6JFscYNrofSXy4sM+Yw (button) (small blind) folded on the Flop
Seat 2: TME8GvochpQAo8cmJwWmvA (big blind) collected ($11.50)



PokerStars Game #59939328990:  Hold'em No Limit ($0.50/$1.00) - 2009/07/01 0:37:04 ET
Table 'cBDNutyLBKEk9+ptwsKmTw' 6-max Seat #2 is the button
Seat 1: xAU6q2/cwmby2sxmA8VcmA ($101 in chips)
Seat 2: Gy1fd4JyD1aNBFFlOGzbJQ ($17.85 in chips)
Seat 3: G5ZSSN6RSON3gkNvk/SmYg ($109.40 in chips)
Seat 4: 3q7F5QtzC30pSrn0nl9i+A ($23 in chips)
Seat 5: OGMLOcTNYZXZU81au7ztUw ($140.95 in chips)
Seat 6: NqVlOSH2lp+pp/TK3vvK5g ($48.70 in chips)
G5ZSSN6RSON3gkNvk/SmYg: posts small blind $0.50
3q7F5QtzC30pSrn0nl9i+A: posts big blind $1
*** HOLE CARDS ***
OGMLOcTNYZXZU81au7ztUw: raises $2 to $3
NqVlOSH2lp+pp/TK3vvK5g: calls $3
xAU6q2/cwmby2sxmA8VcmA: folds
Gy1fd4JyD1aNBFFlOGzbJQ: raises $14.85 to $17.85 and is all-in
G5ZSSN6RSON3gkNvk/SmYg: folds
3q7F5QtzC30pSrn0nl9i+A: folds
OGMLOcTNYZXZU81au7ztUw: folds
NqVlOSH2lp+pp/TK3vvK5g: folds
Gy1fd4JyD1aNBFFlOGzbJQ collected $10.50 from pot
*** SUMMARY ***
Total pot $10.50 | Rake $0
Seat 1: xAU6q2/cwmby2sxmA8VcmA folded before Flop (didn't bet)
Seat 2: Gy1fd4JyD1aNBFFlOGzbJQ (button) collected ($10.50)
Seat 3: G5ZSSN6RSON3gkNvk/SmYg (small blind) folded before Flop
Seat 4: 3q7F5QtzC30pSrn0nl9i+A (big blind) folded before Flop
Seat 5: OGMLOcTNYZXZU81au7ztUw folded before Flop
Seat 6: NqVlOSH2lp+pp/TK3vvK5g folded before Flop



PokerStars Game #59939330074:  Hold'em No Limit ($0.50/$1.00) - 2009/07/01 0:37:06 ET
Table 'QSIig7BLMc9wY/rgBechzw' 6-max Seat #3 is the button
Seat 1: uuA9hpFU17U5/t4cvpbpBg ($23.55 in chips)
Seat 3: +W6OnF033KNM2xH0fGj98Q ($100 in chips)
Seat 4: +uSzP8Jwnw7sKfQ4s66b7w ($57.50 in chips)
Seat 5: bvU2ZjpVnszLCFVeWbxePg ($142.10 in chips)
Seat 6: KpnW5CcJ4Mg6MeclfKmLrw ($188.60 in chips)
+uSzP8Jwnw7sKfQ4s66b7w: posts small blind $0.50
bvU2ZjpVnszLCFVeWbxePg: posts big blind $1
*** HOLE CARDS ***
KpnW5CcJ4Mg6MeclfKmLrw: folds
uuA9hpFU17U5/t4cvpbpBg: folds
+W6OnF033KNM2xH0fGj98Q: folds
+uSzP8Jwnw7sKfQ4s66b7w: folds
bvU2ZjpVnszLCFVeWbxePg collected $1 from pot
bvU2ZjpVnszLCFVeWbxePg: doesn't show hand
*** SUMMARY ***
Total pot $1 | Rake $0
Seat 1: uuA9hpFU17U5/t4cvpbpBg folded before Flop (didn't bet)
Seat 3: +W6OnF033KNM2xH0fGj98Q (button) folded before Flop (didn't bet)
Seat 4: +uSzP8Jwnw7sKfQ4s66b7w (small blind) folded before Flop
Seat 5: bvU2ZjpVnszLCFVeWbxePg (big blind) collected ($1)
Seat 6: KpnW5CcJ4Mg6MeclfKmLrw folded before Flop (didn't bet)



PokerStars Game #59939330316:  Hold'em No Limit ($0.50/$1.00) - 2009/07/01 0:37:07 ET
Table 'rmZfTK+oSebeUPJNbWhdAA' 6-max Seat #6 is the button
Seat 1: xAU6q2/cwmby2sxmA8VcmA ($100.50 in chips)
Seat 2: z7O9PO/WEcqRouIydFhS9Q ($100 in chips)
Seat 3: 9yjOzGERLaEZS8CZ6YNHFg ($111.40 in chips)
Seat 4: OGMLOcTNYZXZU81au7ztUw ($134.50 in chips)
Seat 5: +xW7QemQU0Fxs+4TnqBRow ($100 in chips)
Seat 6: j7NIOHLZk7V2o9fOioO5ug ($132.50 in chips)
xAU6q2/cwmby2sxmA8VcmA: posts small blind $0.50
z7O9PO/WEcqRouIydFhS9Q: posts big blind $1
*** HOLE CARDS ***
9yjOzGERLaEZS8CZ6YNHFg: raises $2 to $3
OGMLOcTNYZXZU81au7ztUw: folds
+xW7QemQU0Fxs+4TnqBRow: folds
j7NIOHLZk7V2o9fOioO5ug: folds
xAU6q2/cwmby2sxmA8VcmA: folds
z7O9PO/WEcqRouIydFhS9Q: calls $2
*** FLOP *** [Qc Qh 4c]
z7O9PO/WEcqRouIydFhS9Q: checks
9yjOzGERLaEZS8CZ6YNHFg: bets $4
z7O9PO/WEcqRouIydFhS9Q: folds
9yjOzGERLaEZS8CZ6YNHFg collected $6.20 from pot
*** SUMMARY ***
Total pot $6.50 | Rake $0.30
Board [Qc Qh 4c]
Seat 1: xAU6q2/cwmby2sxmA8VcmA (small blind) folded before Flop
Seat 2: z7O9PO/WEcqRouIydFhS9Q (big blind) folded on the Flop
Seat 3: 9yjOzGERLaEZS8CZ6YNHFg collected ($6.20)
Seat 4: OGMLOcTNYZXZU81au7ztUw folded before Flop (didn't bet)
Seat 5: +xW7QemQU0Fxs+4TnqBRow folded before Flop (didn't bet)
Seat 6: j7NIOHLZk7V2o9fOioO5ug (button) folded before Flop (didn't bet)



PokerStars Game #59939330570:  Hold'em No Limit ($0.50/$1.00) - 2009/07/01 0:37:07 ET
Table 'QBLDswtHe7Ml0HwAdcMhlw' 2-max Seat #1 is the button
Seat 1: hdNlhiCwI533uwvvTTfC9Q ($102.20 in chips)
Seat 2: GBkvjkjDWVBEa1e14dh6CA ($61 in chips)
hdNlhiCwI533uwvvTTfC9Q: posts small blind $0.50
GBkvjkjDWVBEa1e14dh6CA: posts big blind $1
*** HOLE CARDS ***
hdNlhiCwI533uwvvTTfC9Q: folds
GBkvjkjDWVBEa1e14dh6CA collected $1 from pot
GBkvjkjDWVBEa1e14dh6CA: doesn't show hand
*** SUMMARY ***
Total pot $1 | Rake $0
Seat 1: hdNlhiCwI533uwvvTTfC9Q (button) (small blind) folded before Flop
Seat 2: GBkvjkjDWVBEa1e14dh6CA (big blind) collected ($1)



PokerStars Game #59939331400:  Hold'em No Limit ($0.50/$1.00) - 2009/07/01 0:37:08 ET
Table '/FUb199IViHMJHi5YWmeuQ' 9-max Seat #4 is the button
Seat 1: TZcz9MEWDA+WydgGruqqbw ($101.85 in chips)
Seat 2: FL3MrLspcF23LYvC4ipBOA ($136.20 in chips)
Seat 3: qN483QJ1NvHbdIZB7J4ARw ($72.70 in chips)
Seat 4: qheQay5YvP2DMAb3OUSxtw ($105.80 in chips)
Seat 6: ccFf7Q4z1cTGQmeoYiWEfw ($41.95 in chips)
Seat 7: bLbSOSmSOnqE0iTcH/5dxA ($100 in chips)
Seat 8: QIWvt0R766g8KfH0vl1s0A ($32.90 in chips)
Seat 9: knewtTmBc4Tc0z/5tAABYQ ($178.20 in chips)
ccFf7Q4z1cTGQmeoYiWEfw: posts small blind $0.50
bLbSOSmSOnqE0iTcH/5dxA: posts big blind $1
*** HOLE CARDS ***
QIWvt0R766g8KfH0vl1s0A: raises $1 to $2
knewtTmBc4Tc0z/5tAABYQ: folds
TZcz9MEWDA+WydgGruqqbw: folds
FL3MrLspcF23LYvC4ipBOA: raises $7 to $9
qN483QJ1NvHbdIZB7J4ARw: folds
BbWpm6CYaA1D8P5EYEEwkQ has returned
qheQay5YvP2DMAb3OUSxtw: folds
ccFf7Q4z1cTGQmeoYiWEfw: folds
bLbSOSmSOnqE0iTcH/5dxA: folds
QIWvt0R766g8KfH0vl1s0A: calls $7
*** FLOP *** [6h Kh Th]
QIWvt0R766g8KfH0vl1s0A: checks
FL3MrLspcF23LYvC4ipBOA: bets $10
qN483QJ1NvHbdIZB7J4ARw is sitting out
QIWvt0R766g8KfH0vl1s0A: calls $10
*** TURN *** [6h Kh Th] [Qc]
QIWvt0R766g8KfH0vl1s0A: checks
FL3MrLspcF23LYvC4ipBOA: bets $16
QIWvt0R766g8KfH0vl1s0A: calls $13.90 and is all-in
*** RIVER *** [6h Kh Th Qc] [3c]
*** SHOW DOWN ***
QIWvt0R766g8KfH0vl1s0A: shows [Ah Qd] (a pair of Queens)
FL3MrLspcF23LYvC4ipBOA: shows [Ac Ks] (a pair of Kings)
FL3MrLspcF23LYvC4ipBOA collected $64.30 from pot
*** SUMMARY ***
Total pot $67.30 | Rake $3
Board [6h Kh Th Qc 3c]
Seat 1: TZcz9MEWDA+WydgGruqqbw folded before Flop (didn't bet)
Seat 2: FL3MrLspcF23LYvC4ipBOA showed [Ac Ks] and won ($64.30) with a pair of Kings
Seat 3: qN483QJ1NvHbdIZB7J4ARw folded before Flop (didn't bet)
Seat 4: qheQay5YvP2DMAb3OUSxtw (button) folded before Flop (didn't bet)
Seat 6: ccFf7Q4z1cTGQmeoYiWEfw (small blind) folded before Flop
Seat 7: bLbSOSmSOnqE0iTcH/5dxA (big blind) folded before Flop
Seat 8: QIWvt0R766g8KfH0vl1s0A showed [Ah Qd] and lost with a pair of Queens
Seat 9: knewtTmBc4Tc0z/5tAABYQ folded before Flop (didn't bet)



PokerStars Game #59939331728:  Hold'em No Limit ($0.50/$1.00) - 2009/07/01 0:37:09 ET
Table '8jIjWCPY0NGprquL+xcMFg' 9-max Seat #2 is the button
Seat 1: vR4IO10geOgvTW+LAUBv/A ($135.10 in chips)
Seat 2: rR1qGAf9Q9RYorKYWH3VKw ($5.20 in chips)
Seat 3: tjhwe1V98x2spSoUQER3HQ ($100 in chips)
Seat 4: by0z+YmujwI6Bf4qRFE8vA ($146.45 in chips)
Seat 6: GTQkFJtSkbVbnGCktp6e3g ($100 in chips)
Seat 7: O3CGPwwUmamrCNHccOilrg ($53.05 in chips)
Seat 8: 9swGhtpERPngKPtvpoZkoQ ($150.30 in chips)
Seat 9: negfosHnGOZXSHpWDRKyBQ ($18.50 in chips)
tjhwe1V98x2spSoUQER3HQ: posts small blind $0.50
by0z+YmujwI6Bf4qRFE8vA: posts big blind $1
*** HOLE CARDS ***
GTQkFJtSkbVbnGCktp6e3g: folds
O3CGPwwUmamrCNHccOilrg: folds
9swGhtpERPngKPtvpoZkoQ: folds
negfosHnGOZXSHpWDRKyBQ: raises $3 to $4
vR4IO10geOgvTW+LAUBv/A: folds
rR1qGAf9Q9RYorKYWH3VKw: folds
tjhwe1V98x2spSoUQER3HQ: folds
by0z+YmujwI6Bf4qRFE8vA: folds
negfosHnGOZXSHpWDRKyBQ collected $2.50 from pot
negfosHnGOZXSHpWDRKyBQ: doesn't show hand
*** SUMMARY ***
Total pot $2.50 | Rake $0
Seat 1: vR4IO10geOgvTW+LAUBv/A folded before Flop (didn't bet)
Seat 2: rR1qGAf9Q9RYorKYWH3VKw (button) folded before Flop (didn't bet)
Seat 3: tjhwe1V98x2spSoUQER3HQ (small blind) folded before Flop
Seat 4: by0z+YmujwI6Bf4qRFE8vA (big blind) folded before Flop
Seat 6: GTQkFJtSkbVbnGCktp6e3g folded before Flop (didn't bet)
Seat 7: O3CGPwwUmamrCNHccOilrg folded before Flop (didn't bet)
Seat 8: 9swGhtpERPngKPtvpoZkoQ folded before Flop (didn't bet)
Seat 9: negfosHnGOZXSHpWDRKyBQ collected ($2.50)



PokerStars Game #59939332632:  Hold'em No Limit ($0.50/$1.00) - 2009/07/01 0:37:10 ET
Table 'MUPc8FEpe/nR0BKSeReX6Q' 6-max Seat #5 is the button
Seat 1: YsLQ3BAvgQHWXMAv3Wv6Hg ($100 in chips)
Seat 2: xAU6q2/cwmby2sxmA8VcmA ($111.70 in chips)
Seat 3: wx3sQGkVi2x9wJXuWNHPBw ($234.05 in chips)
Seat 4: ZA1bp6g8IwtTxkUE4eCjDQ ($173.45 in chips)
Seat 5: UBZQqpnJZdTYYY1FTb0rLA ($100 in chips)
Seat 6: oxnw0GLLpFanjhGkxfRSqA ($60.50 in chips)
oxnw0GLLpFanjhGkxfRSqA: posts small blind $0.50
YsLQ3BAvgQHWXMAv3Wv6Hg: posts big blind $1
*** HOLE CARDS ***
xAU6q2/cwmby2sxmA8VcmA: folds
wx3sQGkVi2x9wJXuWNHPBw: folds
ZA1bp6g8IwtTxkUE4eCjDQ: calls $1
UBZQqpnJZdTYYY1FTb0rLA: calls $1
oxnw0GLLpFanjhGkxfRSqA: calls $0.50
YsLQ3BAvgQHWXMAv3Wv6Hg: checks
*** FLOP *** [6d 7d Kc]
oxnw0GLLpFanjhGkxfRSqA: checks
YsLQ3BAvgQHWXMAv3Wv6Hg: checks
ZA1bp6g8IwtTxkUE4eCjDQ: bets $4
UBZQqpnJZdTYYY1FTb0rLA: folds
oxnw0GLLpFanjhGkxfRSqA: folds
YsLQ3BAvgQHWXMAv3Wv6Hg: folds
ZA1bp6g8IwtTxkUE4eCjDQ collected $3.80 from pot
*** SUMMARY ***
Total pot $4 | Rake $0.20
Board [6d 7d Kc]
Seat 1: YsLQ3BAvgQHWXMAv3Wv6Hg (big blind) folded on the Flop
Seat 2: xAU6q2/cwmby2sxmA8VcmA folded before Flop (didn't bet)
Seat 3: wx3sQGkVi2x9wJXuWNHPBw folded before Flop (didn't bet)
Seat 4: ZA1bp6g8IwtTxkUE4eCjDQ collected ($3.80)
Seat 5: UBZQqpnJZdTYYY1FTb0rLA (button) folded on the Flop
Seat 6: oxnw0GLLpFanjhGkxfRSqA (small blind) folded on the Flop



PokerStars Game #59939334898:  Hold'em No Limit ($0.50/$1.00) - 2009/07/01 0:37:14 ET
Table 'QBLDswtHe7Ml0HwAdcMhlw' 2-max Seat #2 is the button
Seat 1: hdNlhiCwI533uwvvTTfC9Q ($101.70 in chips)
Seat 2: GBkvjkjDWVBEa1e14dh6CA ($61.50 in chips)
GBkvjkjDWVBEa1e14dh6CA: posts small blind $0.50
hdNlhiCwI533uwvvTTfC9Q: posts big blind $1
*** HOLE CARDS ***
GBkvjkjDWVBEa1e14dh6CA: raises $2 to $3
hdNlhiCwI533uwvvTTfC9Q: folds
GBkvjkjDWVBEa1e14dh6CA collected $2 from pot
GBkvjkjDWVBEa1e14dh6CA: doesn't show hand
*** SUMMARY ***
Total pot $2 | Rake $0
Seat 1: hdNlhiCwI533uwvvTTfC9Q (big blind) folded before Flop
Seat 2: GBkvjkjDWVBEa1e14dh6CA (button) (small blind) collected ($2)



PokerStars Game #59939335834:  Hold'em No Limit ($0.50/$1.00) - 2009/07/01 0:37:15 ET
Table 'hugOjcwJvzEwZbK7tyiWuQ' 9-max Seat #1 is the button
Seat 1: N9n5Wc3s35DpCrOAUUNAaQ ($127 in chips)
Seat 2: r27C1nIV4NS4+qbnrgBQSw ($256.05 in chips)
Seat 3: jDwhY1kCdc6EkAHbT7PJMQ ($109.15 in chips)
Seat 4: UWB3oeddt/GObx2Mix2Anw ($210.25 in chips)
Seat 6: gUUvmqdVlmvpal6B8nYrmg ($100 in chips)
Seat 7: FL3MrLspcF23LYvC4ipBOA ($100 in chips)
Seat 8: /zy+DB4S5fUQUSfZWFzYGw ($105.75 in chips)
Seat 9: o6JyUkbzCDw8tUabqtmnlg ($61.20 in chips)
r27C1nIV4NS4+qbnrgBQSw: posts small blind $0.50
jDwhY1kCdc6EkAHbT7PJMQ: posts big blind $1
5BRGWf+R3nt2WS3b5xX+zA: sits out
*** HOLE CARDS ***
UWB3oeddt/GObx2Mix2Anw: folds
gUUvmqdVlmvpal6B8nYrmg: folds
FL3MrLspcF23LYvC4ipBOA: raises $2 to $3
/zy+DB4S5fUQUSfZWFzYGw: folds
o6JyUkbzCDw8tUabqtmnlg: folds
N9n5Wc3s35DpCrOAUUNAaQ: folds
r27C1nIV4NS4+qbnrgBQSw: folds
jDwhY1kCdc6EkAHbT7PJMQ: folds
FL3MrLspcF23LYvC4ipBOA collected $2.50 from pot
*** SUMMARY ***
Total pot $2.50 | Rake $0
Seat 1: N9n5Wc3s35DpCrOAUUNAaQ (button) folded before Flop (didn't bet)
Seat 2: r27C1nIV4NS4+qbnrgBQSw (small blind) folded before Flop
Seat 3: jDwhY1kCdc6EkAHbT7PJMQ (big blind) folded before Flop
Seat 4: UWB3oeddt/GObx2Mix2Anw folded before Flop (didn't bet)
Seat 6: gUUvmqdVlmvpal6B8nYrmg folded before Flop (didn't bet)
Seat 7: FL3MrLspcF23LYvC4ipBOA collected ($2.50)
Seat 8: /zy+DB4S5fUQUSfZWFzYGw folded before Flop (didn't bet)
Seat 9: o6JyUkbzCDw8tUabqtmnlg folded before Flop (didn't bet)



PokerStars Game #59939337814:  Hold'em No Limit ($0.50/$1.00) - 2009/07/01 0:37:18 ET
Table 'vs/5jr6ciwjVQ5+Soc+u2A' 6-max Seat #5 is the button
Seat 1: 3yN2jRjZ+glIaWtGMmKOrA ($23.05 in chips)
Seat 2: XOIf9W+VAxhZqN+SYoyMKA ($118.65 in chips)
Seat 3: G5ZSSN6RSON3gkNvk/SmYg ($152 in chips)
Seat 4: KpnW5CcJ4Mg6MeclfKmLrw ($109.80 in chips)
Seat 5: 7Vc9JmGFQwMRh5Tj9ui5Lw ($51.40 in chips)
Seat 6: QHvTZcrKe6+maWUfVjP29Q ($100 in chips)
QHvTZcrKe6+maWUfVjP29Q: posts small blind $0.50
3yN2jRjZ+glIaWtGMmKOrA: posts big blind $1
*** HOLE CARDS ***
XOIf9W+VAxhZqN+SYoyMKA: folds
G5ZSSN6RSON3gkNvk/SmYg: folds
KpnW5CcJ4Mg6MeclfKmLrw: folds
7Vc9JmGFQwMRh5Tj9ui5Lw: calls $1
QHvTZcrKe6+maWUfVjP29Q: folds
3yN2jRjZ+glIaWtGMmKOrA: checks
*** FLOP *** [7d As Ah]
3yN2jRjZ+glIaWtGMmKOrA: checks
7Vc9JmGFQwMRh5Tj9ui5Lw: checks
*** TURN *** [7d As Ah] [3c]
3yN2jRjZ+glIaWtGMmKOrA: checks
7Vc9JmGFQwMRh5Tj9ui5Lw: checks
*** RIVER *** [7d As Ah 3c] [Ts]
3yN2jRjZ+glIaWtGMmKOrA: checks
7Vc9JmGFQwMRh5Tj9ui5Lw: checks
*** SHOW DOWN ***
3yN2jRjZ+glIaWtGMmKOrA: shows [5s Jh] (a pair of Aces)
7Vc9JmGFQwMRh5Tj9ui5Lw: shows [9h Qd] (a pair of Aces - Queen kicker)
3yN2jRjZ+glIaWtGMmKOrA is sitting out
7Vc9JmGFQwMRh5Tj9ui5Lw collected $2.40 from pot
*** SUMMARY ***
Total pot $2.50 | Rake $0.10
Board [7d As Ah 3c Ts]
Seat 1: 3yN2jRjZ+glIaWtGMmKOrA (big blind) showed [5s Jh] and lost with a pair of Aces
Seat 2: XOIf9W+VAxhZqN+SYoyMKA folded before Flop (didn't bet)
Seat 3: G5ZSSN6RSON3gkNvk/SmYg folded before Flop (didn't bet)
Seat 4: KpnW5CcJ4Mg6MeclfKmLrw folded before Flop (didn't bet)
Seat 5: 7Vc9JmGFQwMRh5Tj9ui5Lw (button) showed [9h Qd] and won ($2.40) with a pair of Aces
Seat 6: QHvTZcrKe6+maWUfVjP29Q (small blind) folded before Flop



PokerStars Game #59939338442:  Hold'em No Limit ($0.50/$1.00) - 2009/07/01 0:37:19 ET
Table 'uNlePsyMIqzM691Xkrlk6Q' 9-max Seat #3 is the button
Seat 1: bLbSOSmSOnqE0iTcH/5dxA ($102.50 in chips)
Seat 2: +OqpStnt0FqbCfyHAWaLbg ($65.45 in chips)
Seat 3: h7qXkU57Bb8ZuPwMyxR8Ug ($12 in chips)
Seat 4: TZcz9MEWDA+WydgGruqqbw ($103.65 in chips)
Seat 5: 3obndzTJ6fECz8+wWhMd1w ($20 in chips)
Seat 6: uMPEfCcGCfsxmy53tVUMug ($113.10 in chips)
Seat 7: w6cw9nzN7AvkkHBVVjykoQ ($44.90 in chips)
Seat 8: OsLmX3x/19szSV115TpL/Q ($47.10 in chips)
Seat 9: vR4IO10geOgvTW+LAUBv/A ($116.30 in chips)
TZcz9MEWDA+WydgGruqqbw: posts small blind $0.50
3obndzTJ6fECz8+wWhMd1w: posts big blind $1
*** HOLE CARDS ***
uMPEfCcGCfsxmy53tVUMug: calls $1
w6cw9nzN7AvkkHBVVjykoQ: calls $1
OsLmX3x/19szSV115TpL/Q: calls $1
vR4IO10geOgvTW+LAUBv/A: calls $1
bLbSOSmSOnqE0iTcH/5dxA: folds
+OqpStnt0FqbCfyHAWaLbg: folds
h7qXkU57Bb8ZuPwMyxR8Ug: folds
TZcz9MEWDA+WydgGruqqbw: calls $0.50
3obndzTJ6fECz8+wWhMd1w: checks
*** FLOP *** [2h 9d 9c]
TZcz9MEWDA+WydgGruqqbw: checks
3obndzTJ6fECz8+wWhMd1w: checks
uMPEfCcGCfsxmy53tVUMug: checks
w6cw9nzN7AvkkHBVVjykoQ: checks
OsLmX3x/19szSV115TpL/Q: bets $1
vR4IO10geOgvTW+LAUBv/A: folds
TZcz9MEWDA+WydgGruqqbw: folds
3obndzTJ6fECz8+wWhMd1w: folds
uMPEfCcGCfsxmy53tVUMug: folds
w6cw9nzN7AvkkHBVVjykoQ: folds
OsLmX3x/19szSV115TpL/Q collected $5.70 from pot
*** SUMMARY ***
Total pot $6 | Rake $0.30
Board [2h 9d 9c]
Seat 1: bLbSOSmSOnqE0iTcH/5dxA folded before Flop (didn't bet)
Seat 2: +OqpStnt0FqbCfyHAWaLbg folded before Flop (didn't bet)
Seat 3: h7qXkU57Bb8ZuPwMyxR8Ug (button) folded before Flop (didn't bet)
Seat 4: TZcz9MEWDA+WydgGruqqbw (small blind) folded on the Flop
Seat 5: 3obndzTJ6fECz8+wWhMd1w (big blind) folded on the Flop
Seat 6: uMPEfCcGCfsxmy53tVUMug folded on the Flop
Seat 7: w6cw9nzN7AvkkHBVVjykoQ folded on the Flop
Seat 8: OsLmX3x/19szSV115TpL/Q collected ($5.70)
Seat 9: vR4IO10geOgvTW+LAUBv/A folded on the Flop



PokerStars Game #59939339512:  Hold'em No Limit ($0.50/$1.00) - 2009/07/01 0:37:20 ET
Table 'LmXQK9xy3awB+qsPzI21Mw' 2-max Seat #2 is the button
Seat 1: NYi6JFscYNrofSXy4sM+Yw ($241.55 in chips)
Seat 2: TME8GvochpQAo8cmJwWmvA ($98.80 in chips)
TME8GvochpQAo8cmJwWmvA: posts small blind $0.50
NYi6JFscYNrofSXy4sM+Yw: posts big blind $1
*** HOLE CARDS ***
TME8GvochpQAo8cmJwWmvA: calls $0.50
NYi6JFscYNrofSXy4sM+Yw: checks
*** FLOP *** [Kd Ac Th]
NYi6JFscYNrofSXy4sM+Yw: bets $1
TME8GvochpQAo8cmJwWmvA: raises $1 to $2
NYi6JFscYNrofSXy4sM+Yw: calls $1
*** TURN *** [Kd Ac Th] [6d]
NYi6JFscYNrofSXy4sM+Yw: bets $1
TME8GvochpQAo8cmJwWmvA: calls $1
*** RIVER *** [Kd Ac Th 6d] [6c]
NYi6JFscYNrofSXy4sM+Yw: checks
TME8GvochpQAo8cmJwWmvA: bets $3
NYi6JFscYNrofSXy4sM+Yw: folds
TME8GvochpQAo8cmJwWmvA collected $7.65 from pot
TME8GvochpQAo8cmJwWmvA: doesn't show hand
*** SUMMARY ***
Total pot $8 | Rake $0.35
Board [Kd Ac Th 6d 6c]
Seat 1: NYi6JFscYNrofSXy4sM+Yw (big blind) folded on the River
Seat 2: TME8GvochpQAo8cmJwWmvA (button) (small blind) collected ($7.65)



PokerStars Game #59939339188:  Hold'em No Limit ($0.50/$1.00) - 2009/07/01 0:37:20 ET
Table '7Nl0ffnjeK44/vmeexh3MQ' 9-max Seat #1 is the button
Seat 1: s7D3Y+k4Cj4D1cXHv7oj+Q ($97.80 in chips)
Seat 2: kiakSwxX0e64PwYGAPQvLw ($30.85 in chips)
Seat 3: vR4IO10geOgvTW+LAUBv/A ($100 in chips)
Seat 4: bLbSOSmSOnqE0iTcH/5dxA ($100 in chips)
Seat 5: bL+QVeDcuEdzMGAGg2XJHg ($99.90 in chips)
Seat 6: FVs16t7GgfWgQWt4JxsObQ ($21.45 in chips)
Seat 8: zanka7aAZkigmZpfopXxxA ($233.20 in chips)
Seat 9: ouwUBGRKnKK9uhn1G4Lf+A ($98 in chips)
kiakSwxX0e64PwYGAPQvLw: posts small blind $0.50
vR4IO10geOgvTW+LAUBv/A: posts big blind $1
*** HOLE CARDS ***
knewtTmBc4Tc0z/5tAABYQ leaves the table
bLbSOSmSOnqE0iTcH/5dxA: folds
amazinmets73 joins the table at seat #7
bL+QVeDcuEdzMGAGg2XJHg: folds
FVs16t7GgfWgQWt4JxsObQ: folds
zanka7aAZkigmZpfopXxxA: folds
ouwUBGRKnKK9uhn1G4Lf+A: raises $2 to $3
s7D3Y+k4Cj4D1cXHv7oj+Q: folds
kiakSwxX0e64PwYGAPQvLw: folds
vR4IO10geOgvTW+LAUBv/A: raises $8 to $11
ouwUBGRKnKK9uhn1G4Lf+A: folds
vR4IO10geOgvTW+LAUBv/A collected $6.50 from pot
vR4IO10geOgvTW+LAUBv/A: doesn't show hand
*** SUMMARY ***
Total pot $6.50 | Rake $0
Seat 1: s7D3Y+k4Cj4D1cXHv7oj+Q (button) folded before Flop (didn't bet)
Seat 2: kiakSwxX0e64PwYGAPQvLw (small blind) folded before Flop
Seat 3: vR4IO10geOgvTW+LAUBv/A (big blind) collected ($6.50)
Seat 4: bLbSOSmSOnqE0iTcH/5dxA folded before Flop (didn't bet)
Seat 5: bL+QVeDcuEdzMGAGg2XJHg folded before Flop (didn't bet)
Seat 6: FVs16t7GgfWgQWt4JxsObQ folded before Flop (didn't bet)
Seat 8: zanka7aAZkigmZpfopXxxA folded before Flop (didn't bet)
Seat 9: ouwUBGRKnKK9uhn1G4Lf+A folded before Flop



PokerStars Game #59939340440:  Hold'em No Limit ($0.50/$1.00) - 2009/07/01 0:37:22 ET
Table 'QSIig7BLMc9wY/rgBechzw' 6-max Seat #4 is the button
Seat 1: uuA9hpFU17U5/t4cvpbpBg ($23.55 in chips)
Seat 3: +W6OnF033KNM2xH0fGj98Q ($100 in chips)
Seat 4: +uSzP8Jwnw7sKfQ4s66b7w ($57 in chips)
Seat 5: bvU2ZjpVnszLCFVeWbxePg ($142.60 in chips)
Seat 6: KpnW5CcJ4Mg6MeclfKmLrw ($188.60 in chips)
bvU2ZjpVnszLCFVeWbxePg: posts small blind $0.50
KpnW5CcJ4Mg6MeclfKmLrw: posts big blind $1
*** HOLE CARDS ***
uuA9hpFU17U5/t4cvpbpBg: folds
+W6OnF033KNM2xH0fGj98Q: folds
+uSzP8Jwnw7sKfQ4s66b7w: folds
bvU2ZjpVnszLCFVeWbxePg: folds
KpnW5CcJ4Mg6MeclfKmLrw collected $1 from pot
KpnW5CcJ4Mg6MeclfKmLrw: doesn't show hand
*** SUMMARY ***
Total pot $1 | Rake $0
Seat 1: uuA9hpFU17U5/t4cvpbpBg folded before Flop (didn't bet)
Seat 3: +W6OnF033KNM2xH0fGj98Q folded before Flop (didn't bet)
Seat 4: +uSzP8Jwnw7sKfQ4s66b7w (button) folded before Flop (didn't bet)
Seat 5: bvU2ZjpVnszLCFVeWbxePg (small blind) folded before Flop
Seat 6: KpnW5CcJ4Mg6MeclfKmLrw (big blind) collected ($1)



PokerStars Game #59939341588:  Hold'em No Limit ($0.50/$1.00) - 2009/07/01 0:37:23 ET
Table 'QBLDswtHe7Ml0HwAdcMhlw' 2-max Seat #1 is the button
Seat 1: hdNlhiCwI533uwvvTTfC9Q ($100.70 in chips)
Seat 2: GBkvjkjDWVBEa1e14dh6CA ($62.50 in chips)
hdNlhiCwI533uwvvTTfC9Q: posts small blind $0.50
GBkvjkjDWVBEa1e14dh6CA: posts big blind $1
*** HOLE CARDS ***
hdNlhiCwI533uwvvTTfC9Q: raises $1 to $2
GBkvjkjDWVBEa1e14dh6CA: folds
hdNlhiCwI533uwvvTTfC9Q collected $2 from pot
hdNlhiCwI533uwvvTTfC9Q: doesn't show hand
*** SUMMARY ***
Total pot $2 | Rake $0
Seat 1: hdNlhiCwI533uwvvTTfC9Q (button) (small blind) collected ($2)
Seat 2: GBkvjkjDWVBEa1e14dh6CA (big blind) folded before Flop



PokerStars Game #59939344134:  Hold'em No Limit ($0.50/$1.00) - 2009/07/01 0:37:27 ET
Table 'ZFWj23PMihdwrNWv41OG/Q' 9-max Seat #5 is the button
Seat 1: yAbu2QsRPVcjPbqlf/jDxw ($124.90 in chips)
Seat 2: ARfmgHcEUKh68laBZy4veA ($76.60 in chips)
Seat 3: G9Fo2TZCN7HI43Po4zSN3A ($118.70 in chips)
Seat 5: tkdBeXTJlFsZdioidNqLow ($100 in chips)
Seat 6: tjhwe1V98x2spSoUQER3HQ ($103.50 in chips)
Seat 7: wIZ377kjl2fHFGnS93o6bw ($20.45 in chips)
Seat 8: knewtTmBc4Tc0z/5tAABYQ ($116.90 in chips)
Seat 9: gIabaXO0Nq08nuXlf56f0w ($19.90 in chips)
tjhwe1V98x2spSoUQER3HQ: posts small blind $0.50
wIZ377kjl2fHFGnS93o6bw: posts big blind $1
*** HOLE CARDS ***
knewtTmBc4Tc0z/5tAABYQ: folds
PEmogYqKpuv0ozeBbXL+7Q has returned
gIabaXO0Nq08nuXlf56f0w: folds
yAbu2QsRPVcjPbqlf/jDxw: folds
ARfmgHcEUKh68laBZy4veA: folds
G9Fo2TZCN7HI43Po4zSN3A: folds
PEmogYqKpuv0ozeBbXL+7Q leaves the table
barrelproof7 joins the table at seat #4
tkdBeXTJlFsZdioidNqLow: raises $1 to $2
tjhwe1V98x2spSoUQER3HQ: folds
wIZ377kjl2fHFGnS93o6bw: calls $1
*** FLOP *** [Ks 8d Jc]
wIZ377kjl2fHFGnS93o6bw: checks
tkdBeXTJlFsZdioidNqLow: bets $3
wIZ377kjl2fHFGnS93o6bw: folds
tkdBeXTJlFsZdioidNqLow collected $4.30 from pot
tkdBeXTJlFsZdioidNqLow: doesn't show hand
*** SUMMARY ***
Total pot $4.50 | Rake $0.20
Board [Ks 8d Jc]
Seat 1: yAbu2QsRPVcjPbqlf/jDxw folded before Flop (didn't bet)
Seat 2: ARfmgHcEUKh68laBZy4veA folded before Flop (didn't bet)
Seat 3: G9Fo2TZCN7HI43Po4zSN3A folded before Flop (didn't bet)
Seat 5: tkdBeXTJlFsZdioidNqLow (button) collected ($4.30)
Seat 6: tjhwe1V98x2spSoUQER3HQ (small blind) folded before Flop
Seat 7: wIZ377kjl2fHFGnS93o6bw (big blind) folded on the Flop
Seat 8: knewtTmBc4Tc0z/5tAABYQ folded before Flop (didn't bet)
Seat 9: gIabaXO0Nq08nuXlf56f0w folded before Flop (didn't bet)



PokerStars Game #59939345690:  Hold'em No Limit ($0.50/$1.00) - 2009/07/01 0:37:30 ET
Table 'SQLOQoANiHscJ8AL7zffbw' 9-max Seat #2 is the button
Seat 1: jPTRd6SpCp4xqAy2XQiTOw ($110.60 in chips)
Seat 2: /zy+DB4S5fUQUSfZWFzYGw ($276.35 in chips)
Seat 3: 0eFnow7+D7veCYQ+CG9FFw ($73.15 in chips)
Seat 4: N9n5Wc3s35DpCrOAUUNAaQ ($96.35 in chips)
Seat 5: L9njYvloJ1NdXjP8edHEAg ($109.05 in chips)
Seat 6: p5UKaxVobvptF0ANhR/q1A ($179 in chips)
Seat 7: bJckevFOcg//s0qyMQI6sQ ($100 in chips)
Seat 9: qJr25HAtvv1w/7IBvjMM3g ($239.75 in chips)
0eFnow7+D7veCYQ+CG9FFw: posts small blind $0.50
N9n5Wc3s35DpCrOAUUNAaQ: posts big blind $1
barrelproof7: sits out
*** HOLE CARDS ***
L9njYvloJ1NdXjP8edHEAg: folds
p5UKaxVobvptF0ANhR/q1A: folds
bJckevFOcg//s0qyMQI6sQ: folds
qJr25HAtvv1w/7IBvjMM3g: folds
jPTRd6SpCp4xqAy2XQiTOw: calls $1
/zy+DB4S5fUQUSfZWFzYGw: folds
0eFnow7+D7veCYQ+CG9FFw: folds
N9n5Wc3s35DpCrOAUUNAaQ: checks
*** FLOP *** [2h Kh Ac]
N9n5Wc3s35DpCrOAUUNAaQ: checks
jPTRd6SpCp4xqAy2XQiTOw: bets $3
N9n5Wc3s35DpCrOAUUNAaQ: folds
jPTRd6SpCp4xqAy2XQiTOw collected $2.40 from pot
*** SUMMARY ***
Total pot $2.50 | Rake $0.10
Board [2h Kh Ac]
Seat 1: jPTRd6SpCp4xqAy2XQiTOw collected ($2.40)
Seat 2: /zy+DB4S5fUQUSfZWFzYGw (button) folded before Flop (didn't bet)
Seat 3: 0eFnow7+D7veCYQ+CG9FFw (small blind) folded before Flop
Seat 4: N9n5Wc3s35DpCrOAUUNAaQ (big blind) folded on the Flop
Seat 5: L9njYvloJ1NdXjP8edHEAg folded before Flop (didn't bet)
Seat 6: p5UKaxVobvptF0ANhR/q1A folded before Flop (didn't bet)
Seat 7: bJckevFOcg//s0qyMQI6sQ folded before Flop (didn't bet)
Seat 9: qJr25HAtvv1w/7IBvjMM3g folded before Flop (didn't bet)



PokerStars Game #59939346556:  Hold'em No Limit ($0.50/$1.00) - 2009/07/01 0:37:31 ET
Table '6YvsYDPNIDx2v5z3bJnwZQ' 9-max Seat #9 is the button
Seat 1: Ogn4JDV3mp4ZDKO49IFzKA ($13.50 in chips)
Seat 2: x80+i7DJL+81v3quj7KbNg ($20 in chips)
Seat 3: negfosHnGOZXSHpWDRKyBQ ($19.30 in chips)
Seat 4: kEr5NYB+JIG5+szcYMr6hA ($45 in chips)
Seat 5: mBRWbnUl8diyBO1qTJaNzw ($160.70 in chips)
Seat 6: uMPEfCcGCfsxmy53tVUMug ($108.10 in chips)
Seat 7: boixc27eqTYA1p0tUdMuBQ ($114 in chips)
Seat 8: PSFxpXgPedVZyHSu2Zhb7Q ($46.75 in chips)
Seat 9: jDwhY1kCdc6EkAHbT7PJMQ ($104.10 in chips)
Ogn4JDV3mp4ZDKO49IFzKA: posts small blind $0.50
x80+i7DJL+81v3quj7KbNg: posts big blind $1
*** HOLE CARDS ***
negfosHnGOZXSHpWDRKyBQ: folds
kEr5NYB+JIG5+szcYMr6hA: calls $1
mBRWbnUl8diyBO1qTJaNzw: folds
uMPEfCcGCfsxmy53tVUMug: folds
boixc27eqTYA1p0tUdMuBQ: folds
PSFxpXgPedVZyHSu2Zhb7Q: folds
jDwhY1kCdc6EkAHbT7PJMQ: folds
Ogn4JDV3mp4ZDKO49IFzKA: calls $0.50
x80+i7DJL+81v3quj7KbNg: checks
*** FLOP *** [4d 7h 4s]
Ogn4JDV3mp4ZDKO49IFzKA: bets $2
x80+i7DJL+81v3quj7KbNg: folds
kEr5NYB+JIG5+szcYMr6hA: folds
Ogn4JDV3mp4ZDKO49IFzKA collected $2.85 from pot
*** SUMMARY ***
Total pot $3 | Rake $0.15
Board [4d 7h 4s]
Seat 1: Ogn4JDV3mp4ZDKO49IFzKA (small blind) collected ($2.85)
Seat 2: x80+i7DJL+81v3quj7KbNg (big blind) folded on the Flop
Seat 3: negfosHnGOZXSHpWDRKyBQ folded before Flop (didn't bet)
Seat 4: kEr5NYB+JIG5+szcYMr6hA folded on the Flop
Seat 5: mBRWbnUl8diyBO1qTJaNzw folded before Flop (didn't bet)
Seat 6: uMPEfCcGCfsxmy53tVUMug folded before Flop (didn't bet)
Seat 7: boixc27eqTYA1p0tUdMuBQ folded before Flop (didn't bet)
Seat 8: PSFxpXgPedVZyHSu2Zhb7Q folded before Flop (didn't bet)
Seat 9: jDwhY1kCdc6EkAHbT7PJMQ (button) folded before Flop (didn't bet)



PokerStars Game #59939347870:  Hold'em No Limit ($0.50/$1.00) - 2009/07/01 0:37:33 ET
Table 'Zka9tv1yilg0MvXWPQrShg' 9-max Seat #5 is the button
Seat 1: TZcz9MEWDA+WydgGruqqbw ($115.35 in chips)
Seat 2: rR1qGAf9Q9RYorKYWH3VKw ($25.70 in chips)
Seat 3: gUUvmqdVlmvpal6B8nYrmg ($101 in chips)
Seat 4: CTOae+JLIGfwfXvhqHkP2w ($156.65 in chips)
Seat 5: /zy+DB4S5fUQUSfZWFzYGw ($141.20 in chips)
Seat 6: rY8wPoax1lS+HUY+I0FZDw ($145.80 in chips)
Seat 7: p1SafS90nb3Uft5LB0NkHw ($17 in chips)
Seat 8: bL+QVeDcuEdzMGAGg2XJHg ($119.10 in chips)
Seat 9: 6daxhj43mWj04MOPTOmaYA ($93 in chips)
rY8wPoax1lS+HUY+I0FZDw: posts small blind $0.50
p1SafS90nb3Uft5LB0NkHw: posts big blind $1
*** HOLE CARDS ***
bL+QVeDcuEdzMGAGg2XJHg: folds
6daxhj43mWj04MOPTOmaYA: folds
TZcz9MEWDA+WydgGruqqbw: folds
rR1qGAf9Q9RYorKYWH3VKw: folds
gUUvmqdVlmvpal6B8nYrmg: raises $1 to $2
CTOae+JLIGfwfXvhqHkP2w: calls $2
/zy+DB4S5fUQUSfZWFzYGw: calls $2
rY8wPoax1lS+HUY+I0FZDw: calls $1.50
p1SafS90nb3Uft5LB0NkHw: folds
*** FLOP *** [9h 4c 6d]
rY8wPoax1lS+HUY+I0FZDw: checks
gUUvmqdVlmvpal6B8nYrmg: checks
CTOae+JLIGfwfXvhqHkP2w: checks
/zy+DB4S5fUQUSfZWFzYGw: bets $4
rY8wPoax1lS+HUY+I0FZDw: folds
gUUvmqdVlmvpal6B8nYrmg: folds
CTOae+JLIGfwfXvhqHkP2w: calls $4
*** TURN *** [9h 4c 6d] [7s]
CTOae+JLIGfwfXvhqHkP2w: checks
/zy+DB4S5fUQUSfZWFzYGw: bets $12
CTOae+JLIGfwfXvhqHkP2w: folds
/zy+DB4S5fUQUSfZWFzYGw collected $16.20 from pot
*** SUMMARY ***
Total pot $17 | Rake $0.80
Board [9h 4c 6d 7s]
Seat 1: TZcz9MEWDA+WydgGruqqbw folded before Flop (didn't bet)
Seat 2: rR1qGAf9Q9RYorKYWH3VKw folded before Flop (didn't bet)
Seat 3: gUUvmqdVlmvpal6B8nYrmg folded on the Flop
Seat 4: CTOae+JLIGfwfXvhqHkP2w folded on the Turn
Seat 5: /zy+DB4S5fUQUSfZWFzYGw (button) collected ($16.20)
Seat 6: rY8wPoax1lS+HUY+I0FZDw (small blind) folded on the Flop
Seat 7: p1SafS90nb3Uft5LB0NkHw (big blind) folded before Flop
Seat 8: bL+QVeDcuEdzMGAGg2XJHg folded before Flop (didn't bet)
Seat 9: 6daxhj43mWj04MOPTOmaYA folded before Flop (didn't bet)



PokerStars Game #59939347634:  Hold'em No Limit ($0.50/$1.00) - 2009/07/01 0:37:33 ET
Table 'QBLDswtHe7Ml0HwAdcMhlw' 2-max Seat #2 is the button
Seat 1: hdNlhiCwI533uwvvTTfC9Q ($101.70 in chips)
Seat 2: GBkvjkjDWVBEa1e14dh6CA ($61.50 in chips)
GBkvjkjDWVBEa1e14dh6CA: posts small blind $0.50
hdNlhiCwI533uwvvTTfC9Q: posts big blind $1
*** HOLE CARDS ***
GBkvjkjDWVBEa1e14dh6CA: raises $2 to $3
hdNlhiCwI533uwvvTTfC9Q: folds
GBkvjkjDWVBEa1e14dh6CA collected $2 from pot
GBkvjkjDWVBEa1e14dh6CA: doesn't show hand
*** SUMMARY ***
Total pot $2 | Rake $0
Seat 1: hdNlhiCwI533uwvvTTfC9Q (big blind) folded before Flop
Seat 2: GBkvjkjDWVBEa1e14dh6CA (button) (small blind) collected ($2)



PokerStars Game #59939347730:  Hold'em No Limit ($0.50/$1.00) - 2009/07/01 0:37:33 ET
Table 'QSIig7BLMc9wY/rgBechzw' 6-max Seat #5 is the button
Seat 1: uuA9hpFU17U5/t4cvpbpBg ($23.55 in chips)
Seat 3: +W6OnF033KNM2xH0fGj98Q ($100 in chips)
Seat 4: +uSzP8Jwnw7sKfQ4s66b7w ($57 in chips)
Seat 5: bvU2ZjpVnszLCFVeWbxePg ($142.10 in chips)
Seat 6: KpnW5CcJ4Mg6MeclfKmLrw ($189.10 in chips)
KpnW5CcJ4Mg6MeclfKmLrw: posts small blind $0.50
uuA9hpFU17U5/t4cvpbpBg: posts big blind $1
*** HOLE CARDS ***
+W6OnF033KNM2xH0fGj98Q: raises $2 to $3
+uSzP8Jwnw7sKfQ4s66b7w: folds
bvU2ZjpVnszLCFVeWbxePg: folds
KpnW5CcJ4Mg6MeclfKmLrw: folds
uuA9hpFU17U5/t4cvpbpBg: calls $2
*** FLOP *** [4s 7d Ac]
uuA9hpFU17U5/t4cvpbpBg: checks
+W6OnF033KNM2xH0fGj98Q: bets $4
uuA9hpFU17U5/t4cvpbpBg: folds
+W6OnF033KNM2xH0fGj98Q collected $6.20 from pot
+W6OnF033KNM2xH0fGj98Q: doesn't show hand
*** SUMMARY ***
Total pot $6.50 | Rake $0.30
Board [4s 7d Ac]
Seat 1: uuA9hpFU17U5/t4cvpbpBg (big blind) folded on the Flop
Seat 3: +W6OnF033KNM2xH0fGj98Q collected ($6.20)
Seat 4: +uSzP8Jwnw7sKfQ4s66b7w folded before Flop (didn't bet)
Seat 5: bvU2ZjpVnszLCFVeWbxePg (button) folded before Flop (didn't bet)
Seat 6: KpnW5CcJ4Mg6MeclfKmLrw (small blind) folded before Flop



PokerStars Game #59939348516:  Hold'em No Limit ($0.50/$1.00) - 2009/07/01 0:37:34 ET
Table 'VOs36P6NW+QyXeQ1B62kmA' 6-max Seat #3 is the button
Seat 1: AdLVjddOzm+sRNo1Bc3S6Q ($142.30 in chips)
Seat 2: KpnW5CcJ4Mg6MeclfKmLrw ($111.80 in chips)
Seat 3: TSuRyAHnUPCFjP7Z0rEE0w ($100 in chips)
Seat 4: w02zQzNydODiyV9THKgo9w ($37.80 in chips)
Seat 6: 6tvjsJrdmWg+g7FVrMnzXA ($63.60 in chips)
w02zQzNydODiyV9THKgo9w: posts small blind $0.50
X7GlkHF+lkbarCLuZ4Uf0w: is sitting out
6tvjsJrdmWg+g7FVrMnzXA: posts big blind $1
*** HOLE CARDS ***
X7GlkHF+lkbarCLuZ4Uf0w has returned
AdLVjddOzm+sRNo1Bc3S6Q is disconnected
AdLVjddOzm+sRNo1Bc3S6Q is connected
AdLVjddOzm+sRNo1Bc3S6Q: folds
KpnW5CcJ4Mg6MeclfKmLrw: folds
TSuRyAHnUPCFjP7Z0rEE0w: folds
w02zQzNydODiyV9THKgo9w: calls $0.50
6tvjsJrdmWg+g7FVrMnzXA: checks
*** FLOP *** [6d 3h 3s]
w02zQzNydODiyV9THKgo9w: checks
6tvjsJrdmWg+g7FVrMnzXA: checks
*** TURN *** [6d 3h 3s] [6h]
w02zQzNydODiyV9THKgo9w: checks
6tvjsJrdmWg+g7FVrMnzXA: checks
*** RIVER *** [6d 3h 3s 6h] [7d]
w02zQzNydODiyV9THKgo9w: checks
6tvjsJrdmWg+g7FVrMnzXA: bets $3
w02zQzNydODiyV9THKgo9w: folds
6tvjsJrdmWg+g7FVrMnzXA collected $1.90 from pot
*** SUMMARY ***
Total pot $2 | Rake $0.10
Board [6d 3h 3s 6h 7d]
Seat 1: AdLVjddOzm+sRNo1Bc3S6Q folded before Flop (didn't bet)
Seat 2: KpnW5CcJ4Mg6MeclfKmLrw folded before Flop (didn't bet)
Seat 3: TSuRyAHnUPCFjP7Z0rEE0w (button) folded before Flop (didn't bet)
Seat 4: w02zQzNydODiyV9THKgo9w (small blind) folded on the River
Seat 6: 6tvjsJrdmWg+g7FVrMnzXA (big blind) collected ($1.90)



PokerStars Game #59939348546:  Hold'em No Limit ($0.50/$1.00) - 2009/07/01 0:37:34 ET
Table 'tyUh+jyNvrceIQdKMJjQ2wZFWj23PMihdwrNWv41OG/Qeat #4 is the button
Seat 1: o8A5MUdudVKu+pAwgZOX2w ($216.55 in chips)
Seat 2: m1sJRkJZ1wu5i1BdgeO2Jw ($15 in chips)
Seat 3: TalCiLYHCd+ffkmR3auPvA ($56.50 in chips)
Seat 4: TSuRyAHnUPCFjP7Z0rEE0w ($110.05 in chips)
Seat 5: j7NIOHLZk7V2o9fOioO5ug ($120.60 in chips)
Seat 6: YsLQ3BAvgQHWXMAv3Wv6Hg ($162.25 in chips)
j7NIOHLZk7V2o9fOioO5ug: posts small blind $0.50
YsLQ3BAvgQHWXMAv3Wv6Hg: posts big blind $1
*** HOLE CARDS ***
o8A5MUdudVKu+pAwgZOX2w: folds
m1sJRkJZ1wu5i1BdgeO2Jw: folds
TalCiLYHCd+ffkmR3auPvA: raises $2 to $3
TSuRyAHnUPCFjP7Z0rEE0w: folds
j7NIOHLZk7V2o9fOioO5ug: folds
YsLQ3BAvgQHWXMAv3Wv6Hg: folds
TalCiLYHCd+ffkmR3auPvA collected $2.50 from pot
TalCiLYHCd+ffkmR3auPvA: doesn't show hand
*** SUMMARY ***
Total pot $2.50 | Rake $0
Seat 1: o8A5MUdudVKu+pAwgZOX2w folded before Flop (didn't bet)
Seat 2: m1sJRkJZ1wu5i1BdgeO2Jw folded before Flop (didn't bet)
Seat 3: TalCiLYHCd+ffkmR3auPvA collected ($2.50)
Seat 4: TSuRyAHnUPCFjP7Z0rEE0w (button) folded before Flop (didn't bet)
Seat 5: j7NIOHLZk7V2o9fOioO5ug (small blind) folded before Flop
Seat 6: YsLQ3BAvgQHWXMAv3Wv6Hg (big blind) folded before Flop



PokerStars Game #59939349616:  Hold'em No Limit ($0.50/$1.00) - 2009/07/01 0:37:36 ET
Table 'U9zqzC8f3oTJ2ShXFgSSOA' 6-max Seat #1 is the button
Seat 1: tS9JHB1h+FQ++qu8RwRNgg ($39.05 in chips)
Seat 2: U2CWBTv29qdCbj8RNF2sIw ($100 in chips)
Seat 3: yfXek8iJ7O4CFyqXrtGcfg ($16.05 in chips)
Seat 4: 33q95we0Etwgrm6guQGncw ($72.15 in chips)
Seat 5: KfwW5us6tydK81NYTtK1gw ($309.75 in chips)
Seat 6: aIxzFKdtpDSkUePKZy/niQ ($67.60 in chips)
U2CWBTv29qdCbj8RNF2sIw: posts small blind $0.50
yfXek8iJ7O4CFyqXrtGcfg: posts big blind $1
*** HOLE CARDS ***
33q95we0Etwgrm6guQGncw: folds
KfwW5us6tydK81NYTtK1gw: folds
aIxzFKdtpDSkUePKZy/niQ: raises $3 to $4
tS9JHB1h+FQ++qu8RwRNgg: calls $4
U2CWBTv29qdCbj8RNF2sIw: folds
yfXek8iJ7O4CFyqXrtGcfg: folds
*** FLOP *** [Kh 9h Th]
aIxzFKdtpDSkUePKZy/niQ: bets $5
tS9JHB1h+FQ++qu8RwRNgg: raises $30.05 to $35.05 and is all-in
aIxzFKdtpDSkUePKZy/niQ: calls $30.05
*** TURN *** [Kh 9h Th] [3h]
*** RIVER *** [Kh 9h Th 3h] [6s]
*** SHOW DOWN ***
aIxzFKdtpDSkUePKZy/niQ: shows [Kc Qd] (a pair of Kings)
tS9JHB1h+FQ++qu8RwRNgg: shows [As Ad] (a pair of Aces)
tS9JHB1h+FQ++qu8RwRNgg collected $76.60 from pot
*** SUMMARY ***
Total pot $79.60 | Rake $3
Board [Kh 9h Th 3h 6s]
Seat 1: tS9JHB1h+FQ++qu8RwRNgg (button) showed [As Ad] and won ($76.60) with a pair of Aces
Seat 2: U2CWBTv29qdCbj8RNF2sIw (small blind) folded before Flop
Seat 3: yfXek8iJ7O4CFyqXrtGcfg (big blind) folded before Flop
Seat 4: 33q95we0Etwgrm6guQGncw folded before Flop (didn't bet)
Seat 5: KfwW5us6tydK81NYTtK1gw folded before Flop (didn't bet)
Seat 6: aIxzFKdtpDSkUePKZy/niQ showed [Kc Qd] and lost with a pair of Kings



PokerStars Game #59939351906:  Hold'em No Limit ($0.50/$1.00) - 2009/07/01 0:37:39 ET
Table 'LmXQK9xy3awB+qsPzI21Mw' 2-max Seat #1 is the button
Seat 1: NYi6JFscYNrofSXy4sM+Yw ($237.55 in chips)
Seat 2: TME8GvochpQAo8cmJwWmvA ($102.45 in chips)
NYi6JFscYNrofSXy4sM+Yw: posts small blind $0.50
TME8GvochpQAo8cmJwWmvA: posts big blind $1
*** HOLE CARDS ***
NYi6JFscYNrofSXy4sM+Yw: raises $2 to $3
TME8GvochpQAo8cmJwWmvA: folds
NYi6JFscYNrofSXy4sM+Yw collected $2 from pot
*** SUMMARY ***
Total pot $2 | Rake $0
Seat 1: NYi6JFscYNrofSXy4sM+Yw (button) (small blind) collected ($2)
Seat 2: TME8GvochpQAo8cmJwWmvA (big blind) folded before Flop



PokerStars Game #59939351320:  Hold'em No Limit ($0.50/$1.00) - 2009/07/01 0:37:39 ET
Table 'pHrhryH8jPNdQfY62f8v+g' 6-max Seat #5 is the button
Seat 2: RqgF7gRoKgRNW8Zoi1ty4A ($115 in chips)
Seat 4: wenbG7TaM3H7h5kn78OFNw ($53.80 in chips)
Seat 5: r1/R7y0Ortgoz4lccgW8VA ($41.15 in chips)
Seat 6: xAU6q2/cwmby2sxmA8VcmA ($103.30 in chips)
xAU6q2/cwmby2sxmA8VcmA: posts small blind $0.50
RqgF7gRoKgRNW8Zoi1ty4A: posts big blind $1
*** HOLE CARDS ***
wenbG7TaM3H7h5kn78OFNw: folds
r1/R7y0Ortgoz4lccgW8VA: raises $3 to $4
xAU6q2/cwmby2sxmA8VcmA: folds
j0aDOn9Nft1HLTQvGu1UwA joins the table at seat #3
RqgF7gRoKgRNW8Zoi1ty4A: folds
r1/R7y0Ortgoz4lccgW8VA collected $2.50 from pot
*** SUMMARY ***
Total pot $2.50 | Rake $0
Seat 2: RqgF7gRoKgRNW8Zoi1ty4A (big blind) folded before Flop
Seat 4: wenbG7TaM3H7h5kn78OFNw folded before Flop (didn't bet)
Seat 5: r1/R7y0Ortgoz4lccgW8VA (button) collected ($2.50)
Seat 6: xAU6q2/cwmby2sxmA8VcmA (small blind) folded before Flop



PokerStars Game #59939351998:  Hold'em No Limit ($0.50/$1.00) - 2009/07/01 0:37:40 ET
Table 'N2bNCDHL96aCQDvZIh+yQQ' 6-max Seat #3 is the button
Seat 1: iHo1oDbrEVJ8nEGdaPrICw ($143.50 in chips)
Seat 2: KpnW5CcJ4Mg6MeclfKmLrw ($113.60 in chips)
Seat 3: Qy/UBNbD2HaA0Ogxg8Sf3w ($100 in chips)
Seat 4: uCqEjnxh2/vFBjKYkfTOkw ($172.55 in chips)
Seat 5: rHlMOfR7kpQQxe+PFQz0xQ ($30 in chips)
Seat 6: TSuRyAHnUPCFjP7Z0rEE0w ($100 in chips)
uCqEjnxh2/vFBjKYkfTOkw: posts small blind $0.50
rHlMOfR7kpQQxe+PFQz0xQ: posts big blind $1
*** HOLE CARDS ***
TSuRyAHnUPCFjP7Z0rEE0w: folds
iHo1oDbrEVJ8nEGdaPrICw: folds
KpnW5CcJ4Mg6MeclfKmLrw: folds
Qy/UBNbD2HaA0Ogxg8Sf3w: folds
uCqEjnxh2/vFBjKYkfTOkw: calls $0.50
rHlMOfR7kpQQxe+PFQz0xQ: checks
*** FLOP *** [Jh 8c 7d]
uCqEjnxh2/vFBjKYkfTOkw: checks
rHlMOfR7kpQQxe+PFQz0xQ: checks
*** TURN *** [Jh 8c 7d] [2h]
uCqEjnxh2/vFBjKYkfTOkw: checks
rHlMOfR7kpQQxe+PFQz0xQ: bets $1
uCqEjnxh2/vFBjKYkfTOkw: calls $1
*** RIVER *** [Jh 8c 7d 2h] [Ts]
uCqEjnxh2/vFBjKYkfTOkw: checks
rHlMOfR7kpQQxe+PFQz0xQ: checks
*** SHOW DOWN ***
uCqEjnxh2/vFBjKYkfTOkw: shows [5c 5h] (a pair of Fives)
rHlMOfR7kpQQxe+PFQz0xQ: mucks hand
uCqEjnxh2/vFBjKYkfTOkw collected $3.85 from pot
*** SUMMARY ***
Total pot $4 | Rake $0.15
Board [Jh 8c 7d 2h Ts]
Seat 1: iHo1oDbrEVJ8nEGdaPrICw folded before Flop (didn't bet)
Seat 2: KpnW5CcJ4Mg6MeclfKmLrw folded before Flop (didn't bet)
Seat 3: Qy/UBNbD2HaA0Ogxg8Sf3w (button) folded before Flop (didn't bet)
Seat 4: uCqEjnxh2/vFBjKYkfTOkw (small blind) showed [5c 5h] and won ($3.85) with a pair of Fives
Seat 5: rHlMOfR7kpQQxe+PFQz0xQ (big blind) mucked
Seat 6: TSuRyAHnUPCFjP7Z0rEE0w folded before Flop (didn't bet)



PokerStars Game #59939353300:  Hold'em No Limit ($0.50/$1.00) - 2009/07/01 0:37:42 ET
Table 'cBDNutyLBKEk9+ptwsKmTw' 6-max Seat #3 is the button
Seat 1: xAU6q2/cwmby2sxmA8VcmA ($101 in chips)
Seat 2: Gy1fd4JyD1aNBFFlOGzbJQ ($25.35 in chips)
Seat 3: G5ZSSN6RSON3gkNvk/SmYg ($108.90 in chips)
Seat 4: 3q7F5QtzC30pSrn0nl9i+A ($22 in chips)
Seat 5: OGMLOcTNYZXZU81au7ztUw ($137.95 in chips)
Seat 6: NqVlOSH2lp+pp/TK3vvK5g ($45.70 in chips)
3q7F5QtzC30pSrn0nl9i+A: posts small blind $0.50
OGMLOcTNYZXZU81au7ztUw: posts big blind $1
*** HOLE CARDS ***
NqVlOSH2lp+pp/TK3vvK5g: folds
xAU6q2/cwmby2sxmA8VcmA: folds
Gy1fd4JyD1aNBFFlOGzbJQ: folds
G5ZSSN6RSON3gkNvk/SmYg: folds
3q7F5QtzC30pSrn0nl9i+A: calls $0.50
OGMLOcTNYZXZU81au7ztUw: raises $1 to $2
3q7F5QtzC30pSrn0nl9i+A: folds
OGMLOcTNYZXZU81au7ztUw collected $2 from pot
OGMLOcTNYZXZU81au7ztUw: doesn't show hand
*** SUMMARY ***
Total pot $2 | Rake $0
Seat 1: xAU6q2/cwmby2sxmA8VcmA folded before Flop (didn't bet)
Seat 2: Gy1fd4JyD1aNBFFlOGzbJQ folded before Flop (didn't bet)
Seat 3: G5ZSSN6RSON3gkNvk/SmYg (button) folded before Flop (didn't bet)
Seat 4: 3q7F5QtzC30pSrn0nl9i+A (small blind) folded before Flop
Seat 5: OGMLOcTNYZXZU81au7ztUw (big blind) collected ($2)
Seat 6: NqVlOSH2lp+pp/TK3vvK5g folded before Flop (didn't bet)



PokerStars Game #59939354180:  Hold'em No Limit ($0.50/$1.00) - 2009/07/01 0:37:43 ET
Table 'MUPc8FEpe/nR0BKSeReX6Q' 6-max Seat #6 is the button
Seat 1: YsLQ3BAvgQHWXMAv3Wv6Hg ($100 in chips)
Seat 2: xAU6q2/cwmby2sxmA8VcmA ($111.70 in chips)
Seat 3: wx3sQGkVi2x9wJXuWNHPBw ($234.05 in chips)
Seat 4: ZA1bp6g8IwtTxkUE4eCjDQ ($176.25 in chips)
Seat 5: UBZQqpnJZdTYYY1FTb0rLA ($100 in chips)
Seat 6: oxnw0GLLpFanjhGkxfRSqA ($59.50 in chips)
YsLQ3BAvgQHWXMAv3Wv6Hg: posts small blind $0.50
xAU6q2/cwmby2sxmA8VcmA: posts big blind $1
*** HOLE CARDS ***
wx3sQGkVi2x9wJXuWNHPBw: folds
ZA1bp6g8IwtTxkUE4eCjDQ: calls $1
UBZQqpnJZdTYYY1FTb0rLA: folds
oxnw0GLLpFanjhGkxfRSqA: folds
YsLQ3BAvgQHWXMAv3Wv6Hg: folds
xAU6q2/cwmby2sxmA8VcmA: checks
*** FLOP *** [9c 9s 2d]
xAU6q2/cwmby2sxmA8VcmA: checks
ZA1bp6g8IwtTxkUE4eCjDQ: bets $1
xAU6q2/cwmby2sxmA8VcmA: folds
ZA1bp6g8IwtTxkUE4eCjDQ collected $2.40 from pot
ZA1bp6g8IwtTxkUE4eCjDQ: doesn't show hand
*** SUMMARY ***
Total pot $2.50 | Rake $0.10
Board [9c 9s 2d]
Seat 1: YsLQ3BAvgQHWXMAv3Wv6Hg (small blind) folded before Flop
Seat 2: xAU6q2/cwmby2sxmA8VcmA (big blind) folded on the Flop
Seat 3: wx3sQGkVi2x9wJXuWNHPBw folded before Flop (didn't bet)
Seat 4: ZA1bp6g8IwtTxkUE4eCjDQ collected ($2.40)
Seat 5: UBZQqpnJZdTYYY1FTb0rLA folded before Flop (didn't bet)
Seat 6: oxnw0GLLpFanjhGkxfRSqA (button) folded before Flop (didn't bet)



PokerStars Game #59939355864:  Hold'em No Limit ($0.50/$1.00) - 2009/07/01 0:37:46 ET
Table 'LmXQK9xy3awB+qsPzI21Mw' 2-max Seat #2 is the button
Seat 1: NYi6JFscYNrofSXy4sM+Yw ($238.55 in chips)
Seat 2: TME8GvochpQAo8cmJwWmvA ($101.45 in chips)
TME8GvochpQAo8cmJwWmvA: posts small blind $0.50
NYi6JFscYNrofSXy4sM+Yw: posts big blind $1
*** HOLE CARDS ***
TME8GvochpQAo8cmJwWmvA: folds
NYi6JFscYNrofSXy4sM+Yw collected $1 from pot
NYi6JFscYNrofSXy4sM+Yw: doesn't show hand
*** SUMMARY ***
Total pot $1 | Rake $0
Seat 1: NYi6JFscYNrofSXy4sM+Yw (big blind) collected ($1)
Seat 2: TME8GvochpQAo8cmJwWmvA (button) (small blind) folded before Flop



PokerStars Game #59939356956:  Hold'em No Limit ($0.50/$1.00) - 2009/07/01 0:37:47 ET
Table '+cA8mcmhaedZ7YcrDdhmeQ' 6-max Seat #5 is the button
Seat 1: lsLuWlcPA3Rh7kJVLzMh0Q ($304.25 in chips)
Seat 2: RqgF7gRoKgRNW8Zoi1ty4A ($104.20 in chips)
Seat 3: 7H5WkGzGvsv56y1iaqHvRg ($44.55 in chips)
Seat 4: LjL3AIERHn559yyW1mTUYQ ($155.50 in chips)
Seat 5: iHo1oDbrEVJ8nEGdaPrICw ($102.70 in chips)
Seat 6: YfsTQsY/fxb+YqbdclTHuw ($50.35 in chips)
YfsTQsY/fxb+YqbdclTHuw: posts small blind $0.50
lsLuWlcPA3Rh7kJVLzMh0Q: posts big blind $1
*** HOLE CARDS ***
RqgF7gRoKgRNW8Zoi1ty4A: folds
7H5WkGzGvsv56y1iaqHvRg: folds
LjL3AIERHn559yyW1mTUYQ: folds
iHo1oDbrEVJ8nEGdaPrICw: folds
YfsTQsY/fxb+YqbdclTHuw: calls $0.50
lsLuWlcPA3Rh7kJVLzMh0Q: checks
*** FLOP *** [5h Qh Jh]
YfsTQsY/fxb+YqbdclTHuw: checks
lsLuWlcPA3Rh7kJVLzMh0Q: checks
*** TURN *** [5h Qh Jh] [Ts]
YfsTQsY/fxb+YqbdclTHuw: checks
lsLuWlcPA3Rh7kJVLzMh0Q: checks
*** RIVER *** [5h Qh Jh Ts] [5s]
YfsTQsY/fxb+YqbdclTHuw: bets $3
lsLuWlcPA3Rh7kJVLzMh0Q: folds
YfsTQsY/fxb+YqbdclTHuw collected $1.90 from pot
*** SUMMARY ***
Total pot $2 | Rake $0.10
Board [5h Qh Jh Ts 5s]
Seat 1: lsLuWlcPA3Rh7kJVLzMh0Q (big blind) folded on the River
Seat 2: RqgF7gRoKgRNW8Zoi1ty4A folded before Flop (didn't bet)
Seat 3: 7H5WkGzGvsv56y1iaqHvRg folded before Flop (didn't bet)
Seat 4: LjL3AIERHn559yyW1mTUYQ folded before Flop (didn't bet)
Seat 5: iHo1oDbrEVJ8nEGdaPrICw (button) folded before Flop (didn't bet)
Seat 6: YfsTQsY/fxb+YqbdclTHuw (small blind) collected ($1.90)



PokerStars Game #59939356754:  Hold'em No Limit ($0.50/$1.00) - 2009/07/01 0:37:47 ET
Table '8jIjWCPY0NGprquL+xcMFg' 9-max Seat #3 is the button
Seat 1: vR4IO10geOgvTW+LAUBv/A ($135.10 in chips)
Seat 2: rR1qGAf9Q9RYorKYWH3VKw ($5.20 in chips)
Seat 3: tjhwe1V98x2spSoUQER3HQ ($100 in chips)
Seat 4: by0z+YmujwI6Bf4qRFE8vA ($145.45 in chips)
Seat 6: GTQkFJtSkbVbnGCktp6e3g ($100 in chips)
Seat 7: O3CGPwwUmamrCNHccOilrg ($53.05 in chips)
Seat 8: 9swGhtpERPngKPtvpoZkoQ ($150.30 in chips)
Seat 9: negfosHnGOZXSHpWDRKyBQ ($20 in chips)
by0z+YmujwI6Bf4qRFE8vA: posts small blind $0.50
GTQkFJtSkbVbnGCktp6e3g: posts big blind $1
*** HOLE CARDS ***
O3CGPwwUmamrCNHccOilrg: raises $1 to $2
9swGhtpERPngKPtvpoZkoQ: folds
negfosHnGOZXSHpWDRKyBQ: folds
vR4IO10geOgvTW+LAUBv/A: folds
rR1qGAf9Q9RYorKYWH3VKw: folds
tjhwe1V98x2spSoUQER3HQ: folds
by0z+YmujwI6Bf4qRFE8vA: folds
GTQkFJtSkbVbnGCktp6e3g: folds
O3CGPwwUmamrCNHccOilrg collected $2.50 from pot
O3CGPwwUmamrCNHccOilrg: doesn't show hand
*** SUMMARY ***
Total pot $2.50 | Rake $0
Seat 1: vR4IO10geOgvTW+LAUBv/A folded before Flop (didn't bet)
Seat 2: rR1qGAf9Q9RYorKYWH3VKw folded before Flop (didn't bet)
Seat 3: tjhwe1V98x2spSoUQER3HQ (button) folded before Flop (didn't bet)
Seat 4: by0z+YmujwI6Bf4qRFE8vA (small blind) folded before Flop
Seat 6: GTQkFJtSkbVbnGCktp6e3g (big blind) folded before Flop
Seat 7: O3CGPwwUmamrCNHccOilrg collected ($2.50)
Seat 8: 9swGhtpERPngKPtvpoZkoQ folded before Flop (didn't bet)
Seat 9: negfosHnGOZXSHpWDRKyBQ folded before Flop (didn't bet)



PokerStars Game #59939358926:  Hold'em No Limit ($0.50/$1.00) - 2009/07/01 0:37:50 ET
Table 'rmZfTK+oSebeUPJNbWhdAA' 6-max Seat #1 is the button
Seat 1: xAU6q2/cwmby2sxmA8VcmA ($100 in chips)
Seat 2: z7O9PO/WEcqRouIydFhS9Q ($97 in chips)
Seat 3: 9yjOzGERLaEZS8CZ6YNHFg ($114.60 in chips)
Seat 4: OGMLOcTNYZXZU81au7ztUw ($134.50 in chips)
Seat 5: +xW7QemQU0Fxs+4TnqBRow ($100 in chips)
Seat 6: j7NIOHLZk7V2o9fOioO5ug ($132.50 in chips)
z7O9PO/WEcqRouIydFhS9Q: posts small blind $0.50
9yjOzGERLaEZS8CZ6YNHFg: posts big blind $1
*** HOLE CARDS ***
OGMLOcTNYZXZU81au7ztUw: folds
+xW7QemQU0Fxs+4TnqBRow: folds
j7NIOHLZk7V2o9fOioO5ug: folds
xAU6q2/cwmby2sxmA8VcmA: folds
z7O9PO/WEcqRouIydFhS9Q: calls $0.50
9yjOzGERLaEZS8CZ6YNHFg: checks
*** FLOP *** [5s 3h 8h]
z7O9PO/WEcqRouIydFhS9Q: checks
9yjOzGERLaEZS8CZ6YNHFg: checks
*** TURN *** [5s 3h 8h] [Ah]
z7O9PO/WEcqRouIydFhS9Q: bets $2
9yjOzGERLaEZS8CZ6YNHFg: calls $2
*** RIVER *** [5s 3h 8h Ah] [6d]
z7O9PO/WEcqRouIydFhS9Q: checks
9yjOzGERLaEZS8CZ6YNHFg: checks
*** SHOW DOWN ***
z7O9PO/WEcqRouIydFhS9Q: shows [Jc Td] (high card Ace)
9yjOzGERLaEZS8CZ6YNHFg: shows [2h Qc] (high card Ace - Queen kicker)
9yjOzGERLaEZS8CZ6YNHFg collected $5.75 from pot
*** SUMMARY ***
Total pot $6 | Rake $0.25
Board [5s 3h 8h Ah 6d]
Seat 1: xAU6q2/cwmby2sxmA8VcmA (button) folded before Flop (didn't bet)
Seat 2: z7O9PO/WEcqRouIydFhS9Q (small blind) showed [Jc Td] and lost with high card Ace
Seat 3: 9yjOzGERLaEZS8CZ6YNHFg (big blind) showed [2h Qc] and won ($5.75) with high card Ace
Seat 4: OGMLOcTNYZXZU81au7ztUw folded before Flop (didn't bet)
Seat 5: +xW7QemQU0Fxs+4TnqBRow folded before Flop (didn't bet)
Seat 6: j7NIOHLZk7V2o9fOioO5ug folded before Flop (didn't bet)



PokerStars Game #59939359776:  Hold'em No Limit ($0.50/$1.00) - 2009/07/01 0:37:52 ET
Table 'LmXQK9xy3awB+qsPzI21Mw' 2-max Seat #1 is the button
Seat 1: NYi6JFscYNrofSXy4sM+Yw ($239.05 in chips)
Seat 2: TME8GvochpQAo8cmJwWmvA ($100.95 in chips)
NYi6JFscYNrofSXy4sM+Yw: posts small blind $0.50
TME8GvochpQAo8cmJwWmvA: posts big blind $1
*** HOLE CARDS ***
NYi6JFscYNrofSXy4sM+Yw: folds
TME8GvochpQAo8cmJwWmvA collected $1 from pot
TME8GvochpQAo8cmJwWmvA: doesn't show hand
*** SUMMARY ***
Total pot $1 | Rake $0
Seat 1: NYi6JFscYNrofSXy4sM+Yw (button) (small blind) folded before Flop
Seat 2: TME8GvochpQAo8cmJwWmvA (big blind) collected ($1)



PokerStars Game #59939361584:  Hold'em No Limit ($0.50/$1.00) - 2009/07/01 0:37:54 ET
Table 'QBLDswtHe7Ml0HwAdcMhlw' 2-max Seat #1 is the button
Seat 1: hdNlhiCwI533uwvvTTfC9Q ($100.70 in chips)
Seat 2: GBkvjkjDWVBEa1e14dh6CA ($62.50 in chips)
hdNlhiCwI533uwvvTTfC9Q: posts small blind $0.50
GBkvjkjDWVBEa1e14dh6CA: posts big blind $1
*** HOLE CARDS ***
hdNlhiCwI533uwvvTTfC9Q: raises $2 to $3
GBkvjkjDWVBEa1e14dh6CA: raises $8 to $11
hdNlhiCwI533uwvvTTfC9Q: folds
GBkvjkjDWVBEa1e14dh6CA collected $6 from pot
GBkvjkjDWVBEa1e14dh6CA: doesn't show hand
*** SUMMARY ***
Total pot $6 | Rake $0
Seat 1: hdNlhiCwI533uwvvTTfC9Q (button) (small blind) folded before Flop
Seat 2: GBkvjkjDWVBEa1e14dh6CA (big blind) collected ($6)



PokerStars Game #59939363480:  Hold'em No Limit ($0.50/$1.00) - 2009/07/01 0:37:57 ET
Table 'LmXQK9xy3awB+qsPzI21Mw' 2-max Seat #2 is the button
Seat 1: NYi6JFscYNrofSXy4sM+Yw ($238.55 in chips)
Seat 2: TME8GvochpQAo8cmJwWmvA ($101.45 in chips)
TME8GvochpQAo8cmJwWmvA: posts small blind $0.50
NYi6JFscYNrofSXy4sM+Yw: posts big blind $1
*** HOLE CARDS ***
TME8GvochpQAo8cmJwWmvA: raises $2 to $3
NYi6JFscYNrofSXy4sM+Yw: calls $2
*** FLOP *** [8c Qs 2s]
NYi6JFscYNrofSXy4sM+Yw: checks
TME8GvochpQAo8cmJwWmvA: checks
*** TURN *** [8c Qs 2s] [7c]
NYi6JFscYNrofSXy4sM+Yw: bets $3
TME8GvochpQAo8cmJwWmvA: calls $3
*** RIVER *** [8c Qs 2s 7c] [7s]
NYi6JFscYNrofSXy4sM+Yw: bets $6
TME8GvochpQAo8cmJwWmvA: folds
NYi6JFscYNrofSXy4sM+Yw collected $11.50 from pot
*** SUMMARY ***
Total pot $12 | Rake $0.50
Board [8c Qs 2s 7c 7s]
Seat 1: NYi6JFscYNrofSXy4sM+Yw (big blind) collected ($11.50)
Seat 2: TME8GvochpQAo8cmJwWmvA (button) (small blind) folded on the River



PokerStars Game #59939363832:  Hold'em No Limit ($0.50/$1.00) - 2009/07/01 0:37:58 ET
Table 'GPp0HyAuggN8oE0sUWzPpA' 9-max Seat #6 is the button
Seat 1: qJr25HAtvv1w/7IBvjMM3g ($40.35 in chips)
Seat 2: Ogn4JDV3mp4ZDKO49IFzKA ($18.50 in chips)
Seat 3: L9njYvloJ1NdXjP8edHEAg ($100 in chips)
Seat 4: mBRWbnUl8diyBO1qTJaNzw ($112.70 in chips)
Seat 5: 0fXz44fzDo5QmhAaJCvFfA ($20.80 in chips)
Seat 6: negfosHnGOZXSHpWDRKyBQ ($33.60 in chips)
Seat 8: tkdBeXTJlFsZdioidNqLow ($60.50 in chips)
tkdBeXTJlFsZdioidNqLow: posts small blind $0.50
9ce+0Dl3d0BeEFIP+8HezA: is sitting out
qJr25HAtvv1w/7IBvjMM3g: posts big blind $1
*** HOLE CARDS ***
Lizard K1ng joins the table at seat #7
9ce+0Dl3d0BeEFIP+8HezA leaves the table
Ogn4JDV3mp4ZDKO49IFzKA: folds
craizer joins the table at seat #9
L9njYvloJ1NdXjP8edHEAg: folds
mBRWbnUl8diyBO1qTJaNzw: folds
0fXz44fzDo5QmhAaJCvFfA: folds
negfosHnGOZXSHpWDRKyBQ: folds
tkdBeXTJlFsZdioidNqLow: raises $2 to $3
qJr25HAtvv1w/7IBvjMM3g: folds
tkdBeXTJlFsZdioidNqLow collected $2 from pot
tkdBeXTJlFsZdioidNqLow: doesn't show hand
*** SUMMARY ***
Total pot $2 | Rake $0
Seat 1: qJr25HAtvv1w/7IBvjMM3g (big blind) folded before Flop
Seat 2: Ogn4JDV3mp4ZDKO49IFzKA folded before Flop (didn't bet)
Seat 3: L9njYvloJ1NdXjP8edHEAg folded before Flop (didn't bet)
Seat 4: mBRWbnUl8diyBO1qTJaNzw folded before Flop (didn't bet)
Seat 5: 0fXz44fzDo5QmhAaJCvFfA folded before Flop (didn't bet)
Seat 6: negfosHnGOZXSHpWDRKyBQ (button) folded before Flop (didn't bet)
Seat 8: tkdBeXTJlFsZdioidNqLow (small blind) collected ($2)



PokerStars Game #59939364542:  Hold'em No Limit ($0.50/$1.00) - 2009/07/01 0:37:59 ET
Table '7Nl0ffnjeK44/vmeexh3MQ' 9-max Seat #2 is the button
Seat 1: s7D3Y+k4Cj4D1cXHv7oj+Q ($97.80 in chips)
Seat 2: kiakSwxX0e64PwYGAPQvLw ($30.35 in chips)
Seat 3: vR4IO10geOgvTW+LAUBv/A ($103.50 in chips)
Seat 4: bLbSOSmSOnqE0iTcH/5dxA ($100 in chips)
Seat 5: bL+QVeDcuEdzMGAGg2XJHg ($99.90 in chips)
Seat 6: FVs16t7GgfWgQWt4JxsObQ ($21.45 in chips)
Seat 8: zanka7aAZkigmZpfopXxxA ($233.20 in chips)
Seat 9: ouwUBGRKnKK9uhn1G4Lf+A ($95 in chips)
vR4IO10geOgvTW+LAUBv/A: posts small blind $0.50
bLbSOSmSOnqE0iTcH/5dxA: posts big blind $1
amazinmets73: sits out
*** HOLE CARDS ***
bL+QVeDcuEdzMGAGg2XJHg: folds
FVs16t7GgfWgQWt4JxsObQ: folds
zanka7aAZkigmZpfopXxxA: folds
ouwUBGRKnKK9uhn1G4Lf+A: folds
s7D3Y+k4Cj4D1cXHv7oj+Q: folds
kiakSwxX0e64PwYGAPQvLw: raises $2 to $3
vR4IO10geOgvTW+LAUBv/A: folds
bLbSOSmSOnqE0iTcH/5dxA: folds
kiakSwxX0e64PwYGAPQvLw collected $2.50 from pot
*** SUMMARY ***
Total pot $2.50 | Rake $0
Seat 1: s7D3Y+k4Cj4D1cXHv7oj+Q folded before Flop (didn't bet)
Seat 2: kiakSwxX0e64PwYGAPQvLw (button) collected ($2.50)
Seat 3: vR4IO10geOgvTW+LAUBv/A (small blind) folded before Flop
Seat 4: bLbSOSmSOnqE0iTcH/5dxA (big blind) folded before Flop
Seat 5: bL+QVeDcuEdzMGAGg2XJHg folded before Flop (didn't bet)
Seat 6: FVs16t7GgfWgQWt4JxsObQ folded before Flop (didn't bet)
Seat 8: zanka7aAZkigmZpfopXxxA folded before Flop (didn't bet)
Seat 9: ouwUBGRKnKK9uhn1G4Lf+A folded before Flop (didn't bet)



PokerStars Game #59939365258:  Hold'em No Limit ($0.50/$1.00) - 2009/07/01 0:38:00 ET
Table 'hugOjcwJvzEwZbK7tyiWuQ' 9-max Seat #2 is the button
Seat 1: N9n5Wc3s35DpCrOAUUNAaQ ($127 in chips)
Seat 2: r27C1nIV4NS4+qbnrgBQSw ($255.55 in chips)
Seat 3: jDwhY1kCdc6EkAHbT7PJMQ ($108.15 in chips)
Seat 4: UWB3oeddt/GObx2Mix2Anw ($210.25 in chips)
Seat 6: gUUvmqdVlmvpal6B8nYrmg ($100 in chips)
Seat 7: FL3MrLspcF23LYvC4ipBOA ($101.50 in chips)
Seat 8: /zy+DB4S5fUQUSfZWFzYGw ($105.75 in chips)
Seat 9: o6JyUkbzCDw8tUabqtmnlg ($61.20 in chips)
jDwhY1kCdc6EkAHbT7PJMQ: posts small blind $0.50
UWB3oeddt/GObx2Mix2Anw: posts big blind $1
5BRGWf+R3nt2WS3b5xX+zA: sits out
*** HOLE CARDS ***
gUUvmqdVlmvpal6B8nYrmg: folds
FL3MrLspcF23LYvC4ipBOA: folds
/zy+DB4S5fUQUSfZWFzYGw: folds
o6JyUkbzCDw8tUabqtmnlg: folds
N9n5Wc3s35DpCrOAUUNAaQ: folds
r27C1nIV4NS4+qbnrgBQSw: folds
jDwhY1kCdc6EkAHbT7PJMQ: folds
UWB3oeddt/GObx2Mix2Anw collected $1 from pot
*** SUMMARY ***
Total pot $1 | Rake $0
Seat 1: N9n5Wc3s35DpCrOAUUNAaQ folded before Flop (didn't bet)
Seat 2: r27C1nIV4NS4+qbnrgBQSw (button) folded before Flop (didn't bet)
Seat 3: jDwhY1kCdc6EkAHbT7PJMQ (small blind) folded before Flop
Seat 4: UWB3oeddt/GObx2Mix2Anw (big blind) collected ($1)
Seat 6: gUUvmqdVlmvpal6B8nYrmg folded before Flop (didn't bet)
Seat 7: FL3MrLspcF23LYvC4ipBOA folded before Flop (didn't bet)
Seat 8: /zy+DB4S5fUQUSfZWFzYGw folded before Flop (didn't bet)
Seat 9: o6JyUkbzCDw8tUabqtmnlg folded before Flop (didn't bet)



PokerStars Game #59939366668:  Hold'em No Limit ($0.50/$1.00) - 2009/07/01 0:38:02 ET
Table 'tyUh+jyNvrceIQdKMJjQ2wZFWj23PMihdwrNWv41OG/Qeat #5 is the button
Seat 1: o8A5MUdudVKu+pAwgZOX2w ($216.55 in chips)
Seat 2: m1sJRkJZ1wu5i1BdgeO2Jw ($15 in chips)
Seat 3: TalCiLYHCd+ffkmR3auPvA ($58 in chips)
Seat 4: TSuRyAHnUPCFjP7Z0rEE0w ($110.05 in chips)
Seat 5: j7NIOHLZk7V2o9fOioO5ug ($120.10 in chips)
Seat 6: YsLQ3BAvgQHWXMAv3Wv6Hg ($161.25 in chips)
YsLQ3BAvgQHWXMAv3Wv6Hg: posts small blind $0.50
o8A5MUdudVKu+pAwgZOX2w: posts big blind $1
*** HOLE CARDS ***
m1sJRkJZ1wu5i1BdgeO2Jw: calls $1
TalCiLYHCd+ffkmR3auPvA: folds
TSuRyAHnUPCFjP7Z0rEE0w: folds
j7NIOHLZk7V2o9fOioO5ug: raises $2 to $3
YsLQ3BAvgQHWXMAv3Wv6Hg: folds
o8A5MUdudVKu+pAwgZOX2w: calls $2
m1sJRkJZ1wu5i1BdgeO2Jw: calls $2
*** FLOP *** [Ah Jc 7h]
o8A5MUdudVKu+pAwgZOX2w: checks
m1sJRkJZ1wu5i1BdgeO2Jw: bets $4
j7NIOHLZk7V2o9fOioO5ug: folds
o8A5MUdudVKu+pAwgZOX2w: calls $4
*** TURN *** [Ah Jc 7h] [5h]
o8A5MUdudVKu+pAwgZOX2w: checks
m1sJRkJZ1wu5i1BdgeO2Jw: checks
*** RIVER *** [Ah Jc 7h 5h] [3d]
o8A5MUdudVKu+pAwgZOX2w: bets $8
m1sJRkJZ1wu5i1BdgeO2Jw: calls $8 and is all-in
*** SHOW DOWN ***
o8A5MUdudVKu+pAwgZOX2w: shows [Th Qh] (a flush, Ace high)
m1sJRkJZ1wu5i1BdgeO2Jw: mucks hand
o8A5MUdudVKu+pAwgZOX2w collected $31.90 from pot
*** SUMMARY ***
Total pot $33.50 | Rake $1.60
Board [Ah Jc 7h 5h 3d]
Seat 1: o8A5MUdudVKu+pAwgZOX2w (big blind) showed [Th Qh] and won ($31.90) with a flush, Ace high
Seat 2: m1sJRkJZ1wu5i1BdgeO2Jw mucked
Seat 3: TalCiLYHCd+ffkmR3auPvA folded before Flop (didn't bet)
Seat 4: TSuRyAHnUPCFjP7Z0rEE0w folded before Flop (didn't bet)
Seat 5: j7NIOHLZk7V2o9fOioO5ug (button) folded on the Flop
Seat 6: YsLQ3BAvgQHWXMAv3Wv6Hg (small blind) folded before Flop



PokerStars Game #59939366728:  Hold'em No Limit ($0.50/$1.00) - 2009/07/01 0:38:02 ET
Table 'FKpXUINE6M3UxHG4zaMhHA' 6-max Seat #2 is the button
Seat 1: qNezhXOOUXqwG7b9X5XJAA ($105.80 in chips)
Seat 2: nDKgwwXJ45hcJfJe01cdxQ ($37.10 in chips)
Seat 3: GOHDYcxP1gP29069kB9HFw ($119.35 in chips)
Seat 4: vw0eLNLy3Huccth4CUZNPQ ($60 in chips)
Seat 5: eUBBn2R56C1IQ6Cs/vitwg ($100.50 in chips)
Seat 6: b2a+5TkFf4xJN/Ihhma58Q ($17.90 in chips)
GOHDYcxP1gP29069kB9HFw: posts small blind $0.50
vw0eLNLy3Huccth4CUZNPQ: posts big blind $1
*** HOLE CARDS ***
eUBBn2R56C1IQ6Cs/vitwg: folds
b2a+5TkFf4xJN/Ihhma58Q: raises $1 to $2
qNezhXOOUXqwG7b9X5XJAA: folds
nDKgwwXJ45hcJfJe01cdxQ: folds
GOHDYcxP1gP29069kB9HFw: folds
vw0eLNLy3Huccth4CUZNPQ: raises $5 to $7
b2a+5TkFf4xJN/Ihhma58Q: folds
vw0eLNLy3Huccth4CUZNPQ collected $4.50 from pot
vw0eLNLy3Huccth4CUZNPQ: doesn't show hand
*** SUMMARY ***
Total pot $4.50 | Rake $0
Seat 1: qNezhXOOUXqwG7b9X5XJAA folded before Flop (didn't bet)
Seat 2: nDKgwwXJ45hcJfJe01cdxQ (button) folded before Flop (didn't bet)
Seat 3: GOHDYcxP1gP29069kB9HFw (small blind) folded before Flop
Seat 4: vw0eLNLy3Huccth4CUZNPQ (big blind) collected ($4.50)
Seat 5: eUBBn2R56C1IQ6Cs/vitwg folded before Flop (didn't bet)
Seat 6: b2a+5TkFf4xJN/Ihhma58Q folded before Flop



PokerStars Game #59939367944:  Hold'em No Limit ($0.50/$1.00) - 2009/07/01 0:38:04 ET
Table 'SQLOQoANiHscJ8AL7zffbw' 9-max Seat #3 is the button
Seat 1: jPTRd6SpCp4xqAy2XQiTOw ($112 in chips)
Seat 2: /zy+DB4S5fUQUSfZWFzYGw ($276.35 in chips)
Seat 3: 0eFnow7+D7veCYQ+CG9FFw ($72.65 in chips)
Seat 4: N9n5Wc3s35DpCrOAUUNAaQ ($95.35 in chips)
Seat 5: L9njYvloJ1NdXjP8edHEAg ($109.05 in chips)
Seat 6: p5UKaxVobvptF0ANhR/q1A ($179 in chips)
Seat 7: bJckevFOcg//s0qyMQI6sQ ($100 in chips)
Seat 9: qJr25HAtvv1w/7IBvjMM3g ($239.75 in chips)
N9n5Wc3s35DpCrOAUUNAaQ: posts small blind $0.50
L9njYvloJ1NdXjP8edHEAg: posts big blind $1
barrelproof7: sits out
*** HOLE CARDS ***
p5UKaxVobvptF0ANhR/q1A: raises $2 to $3
bJckevFOcg//s0qyMQI6sQ: folds
qJr25HAtvv1w/7IBvjMM3g: calls $3
jPTRd6SpCp4xqAy2XQiTOw: folds
/zy+DB4S5fUQUSfZWFzYGw: folds
0eFnow7+D7veCYQ+CG9FFw: calls $3
N9n5Wc3s35DpCrOAUUNAaQ: calls $2.50
L9njYvloJ1NdXjP8edHEAg: calls $2
*** FLOP *** [9s 7d 9c]
N9n5Wc3s35DpCrOAUUNAaQ: checks
L9njYvloJ1NdXjP8edHEAg: checks
p5UKaxVobvptF0ANhR/q1A: checks
qJr25HAtvv1w/7IBvjMM3g: checks
0eFnow7+D7veCYQ+CG9FFw: bets $9
N9n5Wc3s35DpCrOAUUNAaQ: folds
L9njYvloJ1NdXjP8edHEAg: folds
p5UKaxVobvptF0ANhR/q1A: folds
qJr25HAtvv1w/7IBvjMM3g: folds
0eFnow7+D7veCYQ+CG9FFw collected $14.25 from pot
*** SUMMARY ***
Total pot $15 | Rake $0.75
Board [9s 7d 9c]
Seat 1: jPTRd6SpCp4xqAy2XQiTOw folded before Flop (didn't bet)
Seat 2: /zy+DB4S5fUQUSfZWFzYGw folded before Flop (didn't bet)
Seat 3: 0eFnow7+D7veCYQ+CG9FFw (button) collected ($14.25)
Seat 4: N9n5Wc3s35DpCrOAUUNAaQ (small blind) folded on the Flop
Seat 5: L9njYvloJ1NdXjP8edHEAg (big blind) folded on the Flop
Seat 6: p5UKaxVobvptF0ANhR/q1A folded on the Flop
Seat 7: bJckevFOcg//s0qyMQI6sQ folded before Flop (didn't bet)
Seat 9: qJr25HAtvv1w/7IBvjMM3g folded on the Flop



PokerStars Game #59939368742:  Hold'em No Limit ($0.50/$1.00) - 2009/07/01 0:38:05 ET
Table 'pHrhryH8jPNdQfY62f8v+g' 6-max Seat #6 is the button
Seat 2: RqgF7gRoKgRNW8Zoi1ty4A ($114 in chips)
Seat 3: j0aDOn9Nft1HLTQvGu1UwA ($20 in chips)
Seat 4: wenbG7TaM3H7h5kn78OFNw ($53.80 in chips)
Seat 5: r1/R7y0Ortgoz4lccgW8VA ($42.65 in chips)
Seat 6: xAU6q2/cwmby2sxmA8VcmA ($102.80 in chips)
RqgF7gRoKgRNW8Zoi1ty4A: posts small blind $0.50
j0aDOn9Nft1HLTQvGu1UwA: posts big blind $1
*** HOLE CARDS ***
wenbG7TaM3H7h5kn78OFNw: folds
r1/R7y0Ortgoz4lccgW8VA: calls $1
xAU6q2/cwmby2sxmA8VcmA: raises $4 to $5
RqgF7gRoKgRNW8Zoi1ty4A: folds
j0aDOn9Nft1HLTQvGu1UwA: folds
r1/R7y0Ortgoz4lccgW8VA: calls $4
*** FLOP *** [5c Td 3d]
r1/R7y0Ortgoz4lccgW8VA: checks
playt0i joins the table at seat #1
xAU6q2/cwmby2sxmA8VcmA: bets $8
r1/R7y0Ortgoz4lccgW8VA: folds
xAU6q2/cwmby2sxmA8VcmA collected $10.95 from pot
*** SUMMARY ***
Total pot $11.50 | Rake $0.55
Board [5c Td 3d]
Seat 2: RqgF7gRoKgRNW8Zoi1ty4A (small blind) folded before Flop
Seat 3: j0aDOn9Nft1HLTQvGu1UwA (big blind) folded before Flop
Seat 4: wenbG7TaM3H7h5kn78OFNw folded before Flop (didn't bet)
Seat 5: r1/R7y0Ortgoz4lccgW8VA folded on the Flop
Seat 6: xAU6q2/cwmby2sxmA8VcmA (button) collected ($10.95)



PokerStars Game #59939369382:  Hold'em No Limit ($0.50/$1.00) - 2009/07/01 0:38:06 ET
Table 'MUPc8FEpe/nR0BKSeReX6Q' 6-max Seat #1 is the button
Seat 1: YsLQ3BAvgQHWXMAv3Wv6Hg ($100 in chips)
Seat 2: xAU6q2/cwmby2sxmA8VcmA ($110.70 in chips)
Seat 3: wx3sQGkVi2x9wJXuWNHPBw ($234.05 in chips)
Seat 4: ZA1bp6g8IwtTxkUE4eCjDQ ($177.65 in chips)
Seat 5: UBZQqpnJZdTYYY1FTb0rLA ($100 in chips)
Seat 6: oxnw0GLLpFanjhGkxfRSqA ($59.50 in chips)
xAU6q2/cwmby2sxmA8VcmA: posts small blind $0.50
wx3sQGkVi2x9wJXuWNHPBw: posts big blind $1
*** HOLE CARDS ***
ZA1bp6g8IwtTxkUE4eCjDQ: calls $1
UBZQqpnJZdTYYY1FTb0rLA: folds
oxnw0GLLpFanjhGkxfRSqA: folds
YsLQ3BAvgQHWXMAv3Wv6Hg: raises $4 to $5
xAU6q2/cwmby2sxmA8VcmA: folds
wx3sQGkVi2x9wJXuWNHPBw: folds
ZA1bp6g8IwtTxkUE4eCjDQ: folds
YsLQ3BAvgQHWXMAv3Wv6Hg collected $3.50 from pot
YsLQ3BAvgQHWXMAv3Wv6Hg: doesn't show hand
*** SUMMARY ***
Total pot $3.50 | Rake $0
Seat 1: YsLQ3BAvgQHWXMAv3Wv6Hg (button) collected ($3.50)
Seat 2: xAU6q2/cwmby2sxmA8VcmA (small blind) folded before Flop
Seat 3: wx3sQGkVi2x9wJXuWNHPBw (big blind) folded before Flop
Seat 4: ZA1bp6g8IwtTxkUE4eCjDQ folded before Flop
Seat 5: UBZQqpnJZdTYYY1FTb0rLA folded before Flop (didn't bet)
Seat 6: oxnw0GLLpFanjhGkxfRSqA folded before Flop (didn't bet)



PokerStars Game #59939372214:  Hold'em No Limit ($0.50/$1.00) - 2009/07/01 0:38:10 ET
Table 'cBDNutyLBKEk9+ptwsKmTw' 6-max Seat #4 is the button
Seat 1: xAU6q2/cwmby2sxmA8VcmA ($101 in chips)
Seat 2: Gy1fd4JyD1aNBFFlOGzbJQ ($25.35 in chips)
Seat 3: G5ZSSN6RSON3gkNvk/SmYg ($108.90 in chips)
Seat 4: 3q7F5QtzC30pSrn0nl9i+A ($21 in chips)
Seat 5: OGMLOcTNYZXZU81au7ztUw ($138.95 in chips)
Seat 6: NqVlOSH2lp+pp/TK3vvK5g ($45.70 in chips)
OGMLOcTNYZXZU81au7ztUw: posts small blind $0.50
NqVlOSH2lp+pp/TK3vvK5g: posts big blind $1
*** HOLE CARDS ***
xAU6q2/cwmby2sxmA8VcmA: folds
Gy1fd4JyD1aNBFFlOGzbJQ: folds
G5ZSSN6RSON3gkNvk/SmYg: folds
3q7F5QtzC30pSrn0nl9i+A: raises $1 to $2
OGMLOcTNYZXZU81au7ztUw: folds
NqVlOSH2lp+pp/TK3vvK5g: calls $1
*** FLOP *** [2s Jd As]
NqVlOSH2lp+pp/TK3vvK5g: checks
3q7F5QtzC30pSrn0nl9i+A: bets $3
NqVlOSH2lp+pp/TK3vvK5g: folds
3q7F5QtzC30pSrn0nl9i+A collected $4.30 from pot
*** SUMMARY ***
Total pot $4.50 | Rake $0.20
Board [2s Jd As]
Seat 1: xAU6q2/cwmby2sxmA8VcmA folded before Flop (didn't bet)
Seat 2: Gy1fd4JyD1aNBFFlOGzbJQ folded before Flop (didn't bet)
Seat 3: G5ZSSN6RSON3gkNvk/SmYg folded before Flop (didn't bet)
Seat 4: 3q7F5QtzC30pSrn0nl9i+A (button) collected ($4.30)
Seat 5: OGMLOcTNYZXZU81au7ztUw (small blind) folded before Flop
Seat 6: NqVlOSH2lp+pp/TK3vvK5g (big blind) folded on the Flop



PokerStars Game #59939372124:  Hold'em No Limit ($0.50/$1.00) - 2009/07/01 0:38:10 ET
Table 'QBLDswtHe7Ml0HwAdcMhlw' 2-max Seat #2 is the button
Seat 1: hdNlhiCwI533uwvvTTfC9Q ($100 in chips)
Seat 2: GBkvjkjDWVBEa1e14dh6CA ($65.50 in chips)
GBkvjkjDWVBEa1e14dh6CA: posts small blind $0.50
hdNlhiCwI533uwvvTTfC9Q: posts big blind $1
*** HOLE CARDS ***
GBkvjkjDWVBEa1e14dh6CA: folds
hdNlhiCwI533uwvvTTfC9Q collected $1 from pot
hdNlhiCwI533uwvvTTfC9Q: doesn't show hand
*** SUMMARY ***
Total pot $1 | Rake $0
Seat 1: hdNlhiCwI533uwvvTTfC9Q (big blind) collected ($1)
Seat 2: GBkvjkjDWVBEa1e14dh6CA (button) (small blind) folded before Flop



PokerStars Game #59939371776:  Hold'em No Limit ($0.50/$1.00) - 2009/07/01 0:38:10 ET
Table 'ZFWj23PMihdwrNWv41OG/Q' 9-max Seat #6 is the button
Seat 1: yAbu2QsRPVcjPbqlf/jDxw ($124.90 in chips)
Seat 2: ARfmgHcEUKh68laBZy4veA ($76.60 in chips)
Seat 3: G9Fo2TZCN7HI43Po4zSN3A ($118.70 in chips)
Seat 5: tkdBeXTJlFsZdioidNqLow ($102.30 in chips)
Seat 6: tjhwe1V98x2spSoUQER3HQ ($103 in chips)
Seat 7: wIZ377kjl2fHFGnS93o6bw ($18.45 in chips)
Seat 9: gIabaXO0Nq08nuXlf56f0w ($19.90 in chips)
wIZ377kjl2fHFGnS93o6bw: posts small blind $0.50
knewtTmBc4Tc0z/5tAABYQ: is sitting out
gIabaXO0Nq08nuXlf56f0w: posts big blind $1
barrelproof7: sits out
*** HOLE CARDS ***
knewtTmBc4Tc0z/5tAABYQ leaves the table
yAbu2QsRPVcjPbqlf/jDxw: folds
ARfmgHcEUKh68laBZy4veA: folds
amazinmets73 joins the table at seat #8
G9Fo2TZCN7HI43Po4zSN3A: folds
tkdBeXTJlFsZdioidNqLow: folds
tjhwe1V98x2spSoUQER3HQ: folds
wIZ377kjl2fHFGnS93o6bw: calls $0.50
gIabaXO0Nq08nuXlf56f0w: checks
*** FLOP *** [Kh 6c Td]
wIZ377kjl2fHFGnS93o6bw: checks
gIabaXO0Nq08nuXlf56f0w: checks
*** TURN *** [Kh 6c Td] [2d]
wIZ377kjl2fHFGnS93o6bw: bets $1
gIabaXO0Nq08nuXlf56f0w: calls $1
*** RIVER *** [Kh 6c Td 2d] [Jc]
wIZ377kjl2fHFGnS93o6bw: checks
gIabaXO0Nq08nuXlf56f0w: checks
*** SHOW DOWN ***
wIZ377kjl2fHFGnS93o6bw: shows [9d Qc] (a straight, Nine to King)
gIabaXO0Nq08nuXlf56f0w: mucks hand
wIZ377kjl2fHFGnS93o6bw collected $3.85 from pot
*** SUMMARY ***
Total pot $4 | Rake $0.15
Board [Kh 6c Td 2d Jc]
Seat 1: yAbu2QsRPVcjPbqlf/jDxw folded before Flop (didn't bet)
Seat 2: ARfmgHcEUKh68laBZy4veA folded before Flop (didn't bet)
Seat 3: G9Fo2TZCN7HI43Po4zSN3A folded before Flop (didn't bet)
Seat 5: tkdBeXTJlFsZdioidNqLow folded before Flop (didn't bet)
Seat 6: tjhwe1V98x2spSoUQER3HQ (button) folded before Flop (didn't bet)
Seat 7: wIZ377kjl2fHFGnS93o6bw (small blind) showed [9d Qc] and won ($3.85) with a straight, Nine to King
Seat 9: gIabaXO0Nq08nuXlf56f0w (big blind) mucked



PokerStars Game #59939373106:  Hold'em No Limit ($0.50/$1.00) - 2009/07/01 0:38:12 ET
Table 'vs/5jr6ciwjVQ5+Soc+u2A' 6-max Seat #6 is the button
Seat 2: XOIf9W+VAxhZqN+SYoyMKA ($118.65 in chips)
Seat 3: G5ZSSN6RSON3gkNvk/SmYg ($152 in chips)
Seat 4: KpnW5CcJ4Mg6MeclfKmLrw ($109.80 in chips)
Seat 5: 7Vc9JmGFQwMRh5Tj9ui5Lw ($52.80 in chips)
Seat 6: QHvTZcrKe6+maWUfVjP29Q ($100 in chips)
XOIf9W+VAxhZqN+SYoyMKA: posts small blind $0.50
3yN2jRjZ+glIaWtGMmKOrA leaves the table
G5ZSSN6RSON3gkNvk/SmYg: posts big blind $1
*** HOLE CARDS ***
KpnW5CcJ4Mg6MeclfKmLrw: folds
7Vc9JmGFQwMRh5Tj9ui5Lw: folds
QHvTZcrKe6+maWUfVjP29Q: raises $2 to $3
XOIf9W+VAxhZqN+SYoyMKA: folds
1C0rFAGdnnX4GWK9B0YPww joins the table at seat #1
G5ZSSN6RSON3gkNvk/SmYg: folds
QHvTZcrKe6+maWUfVjP29Q collected $2.50 from pot
QHvTZcrKe6+maWUfVjP29Q: doesn't show hand
*** SUMMARY ***
Total pot $2.50 | Rake $0
Seat 2: XOIf9W+VAxhZqN+SYoyMKA (small blind) folded before Flop
Seat 3: G5ZSSN6RSON3gkNvk/SmYg (big blind) folded before Flop
Seat 4: KpnW5CcJ4Mg6MeclfKmLrw folded before Flop (didn't bet)
Seat 5: 7Vc9JmGFQwMRh5Tj9ui5Lw folded before Flop (didn't bet)
Seat 6: QHvTZcrKe6+maWUfVjP29Q (button) collected ($2.50)



PokerStars Game #59939375698:  Hold'em No Limit ($0.50/$1.00) - 2009/07/01 0:38:16 ET
Table 'QSIig7BLMc9wY/rgBechzw' 6-max Seat #6 is the button
Seat 1: uuA9hpFU17U5/t4cvpbpBg ($20.55 in chips)
Seat 3: +W6OnF033KNM2xH0fGj98Q ($103.20 in chips)
Seat 4: +uSzP8Jwnw7sKfQ4s66b7w ($57 in chips)
Seat 5: bvU2ZjpVnszLCFVeWbxePg ($142.10 in chips)
Seat 6: KpnW5CcJ4Mg6MeclfKmLrw ($188.60 in chips)
uuA9hpFU17U5/t4cvpbpBg: posts small blind $0.50
+W6OnF033KNM2xH0fGj98Q: posts big blind $1
*** HOLE CARDS ***
+uSzP8Jwnw7sKfQ4s66b7w: folds
bvU2ZjpVnszLCFVeWbxePg: folds
KpnW5CcJ4Mg6MeclfKmLrw: folds
uuA9hpFU17U5/t4cvpbpBg: calls $0.50
+W6OnF033KNM2xH0fGj98Q: checks
*** FLOP *** [2h Ts Jd]
uuA9hpFU17U5/t4cvpbpBg: bets $1
+W6OnF033KNM2xH0fGj98Q: folds
uuA9hpFU17U5/t4cvpbpBg collected $1.90 from pot
uuA9hpFU17U5/t4cvpbpBg: doesn't show hand
*** SUMMARY ***
Total pot $2 | Rake $0.10
Board [2h Ts Jd]
Seat 1: uuA9hpFU17U5/t4cvpbpBg (small blind) collected ($1.90)
Seat 3: +W6OnF033KNM2xH0fGj98Q (big blind) folded on the Flop
Seat 4: +uSzP8Jwnw7sKfQ4s66b7w folded before Flop (didn't bet)
Seat 5: bvU2ZjpVnszLCFVeWbxePg folded before Flop (didn't bet)
Seat 6: KpnW5CcJ4Mg6MeclfKmLrw (button) folded before Flop (didn't bet)



PokerStars Game #59939375688:  Hold'em No Limit ($0.50/$1.00) - 2009/07/01 0:38:16 ET
Table 'LmXQK9xy3awB+qsPzI21Mw' 2-max Seat #1 is the button
Seat 1: NYi6JFscYNrofSXy4sM+Yw ($244.05 in chips)
Seat 2: TME8GvochpQAo8cmJwWmvA ($95.45 in chips)
NYi6JFscYNrofSXy4sM+Yw: posts small blind $0.50
TME8GvochpQAo8cmJwWmvA: posts big blind $1
*** HOLE CARDS ***
NYi6JFscYNrofSXy4sM+Yw: raises $2 to $3
TME8GvochpQAo8cmJwWmvA: calls $2
*** FLOP *** [Qh Qs 4h]
TME8GvochpQAo8cmJwWmvA: checks
NYi6JFscYNrofSXy4sM+Yw: checks
*** TURN *** [Qh Qs 4h] [Kc]
TME8GvochpQAo8cmJwWmvA: bets $2
NYi6JFscYNrofSXy4sM+Yw: folds
TME8GvochpQAo8cmJwWmvA collected $5.70 from pot
TME8GvochpQAo8cmJwWmvA: doesn't show hand
*** SUMMARY ***
Total pot $6 | Rake $0.30
Board [Qh Qs 4h Kc]
Seat 1: NYi6JFscYNrofSXy4sM+Yw (button) (small blind) folded on the Turn
Seat 2: TME8GvochpQAo8cmJwWmvA (big blind) collected ($5.70)



PokerStars Game #59939376070:  Hold'em No Limit ($0.50/$1.00) - 2009/07/01 0:38:16 ET
Table 'QBLDswtHe7Ml0HwAdcMhlw' 2-max Seat #1 is the button
Seat 1: hdNlhiCwI533uwvvTTfC9Q ($100.50 in chips)
Seat 2: GBkvjkjDWVBEa1e14dh6CA ($65 in chips)
hdNlhiCwI533uwvvTTfC9Q: posts small blind $0.50
GBkvjkjDWVBEa1e14dh6CA: posts big blind $1
*** HOLE CARDS ***
hdNlhiCwI533uwvvTTfC9Q: folds
GBkvjkjDWVBEa1e14dh6CA collected $1 from pot
GBkvjkjDWVBEa1e14dh6CA: doesn't show hand
*** SUMMARY ***
Total pot $1 | Rake $0
Seat 1: hdNlhiCwI533uwvvTTfC9Q (button) (small blind) folded before Flop
Seat 2: GBkvjkjDWVBEa1e14dh6CA (big blind) collected ($1)



PokerStars Game #59939376572:  Hold'em No Limit ($0.50/$1.00) - 2009/07/01 0:38:17 ET
Table 'fTlPiCj0utgzC/5io+I7ew' 6-max Seat #5 is the button
Seat 1: YMJG+F++3Aj6P8dAWda5fw ($98.50 in chips)
Seat 2: Qy/UBNbD2HaA0Ogxg8Sf3w ($100 in chips)
Seat 3: oDiBRCaF0QVtd3kO6xZIXw ($89.60 in chips)
Seat 4: uJVSceLggtsrJya+WtmUEA ($97.30 in chips)
Seat 5: bFrTkDcWGTxyvNul7GVdYg ($255.20 in chips)
Seat 6: jMljU/dOPMXfJi8OmbdYdw ($61.20 in chips)
jMljU/dOPMXfJi8OmbdYdw: posts small blind $0.50
YMJG+F++3Aj6P8dAWda5fw: posts big blind $1
*** HOLE CARDS ***
Qy/UBNbD2HaA0Ogxg8Sf3w: raises $3 to $4
oDiBRCaF0QVtd3kO6xZIXw: folds
uJVSceLggtsrJya+WtmUEA: folds
bFrTkDcWGTxyvNul7GVdYg: folds
jMljU/dOPMXfJi8OmbdYdw: folds
YMJG+F++3Aj6P8dAWda5fw: folds
Qy/UBNbD2HaA0Ogxg8Sf3w collected $2.50 from pot
*** SUMMARY ***
Total pot $2.50 | Rake $0
Seat 1: YMJG+F++3Aj6P8dAWda5fw (big blind) folded before Flop
Seat 2: Qy/UBNbD2HaA0Ogxg8Sf3w collected ($2.50)
Seat 3: oDiBRCaF0QVtd3kO6xZIXw folded before Flop (didn't bet)
Seat 4: uJVSceLggtsrJya+WtmUEA folded before Flop (didn't bet)
Seat 5: bFrTkDcWGTxyvNul7GVdYg (button) folded before Flop (didn't bet)
Seat 6: jMljU/dOPMXfJi8OmbdYdw (small blind) folded before Flop



PokerStars Game #59939376262:  Hold'em No Limit ($0.50/$1.00) - 2009/07/01 0:38:17 ET
Table 'uNlePsyMIqzM691Xkrlk6Q' 9-max Seat #4 is the button
Seat 1: bLbSOSmSOnqE0iTcH/5dxA ($102.50 in chips)
Seat 2: +OqpStnt0FqbCfyHAWaLbg ($65.45 in chips)
Seat 3: h7qXkU57Bb8ZuPwMyxR8Ug ($12 in chips)
Seat 4: TZcz9MEWDA+WydgGruqqbw ($102.65 in chips)
Seat 5: 3obndzTJ6fECz8+wWhMd1w ($19 in chips)
Seat 6: uMPEfCcGCfsxmy53tVUMug ($112.10 in chips)
Seat 7: w6cw9nzN7AvkkHBVVjykoQ ($43.90 in chips)
Seat 8: OsLmX3x/19szSV115TpL/Q ($51.80 in chips)
Seat 9: vR4IO10geOgvTW+LAUBv/A ($115.30 in chips)
3obndzTJ6fECz8+wWhMd1w: posts small blind $0.50
uMPEfCcGCfsxmy53tVUMug: posts big blind $1
*** HOLE CARDS ***
w6cw9nzN7AvkkHBVVjykoQ: folds
OsLmX3x/19szSV115TpL/Q: folds
vR4IO10geOgvTW+LAUBv/A: folds
bLbSOSmSOnqE0iTcH/5dxA: folds
+OqpStnt0FqbCfyHAWaLbg: raises $2 to $3
h7qXkU57Bb8ZuPwMyxR8Ug: calls $3
TZcz9MEWDA+WydgGruqqbw: folds
3obndzTJ6fECz8+wWhMd1w: folds
uMPEfCcGCfsxmy53tVUMug: folds
*** FLOP *** [3d Th 6d]
+OqpStnt0FqbCfyHAWaLbg: bets $4
h7qXkU57Bb8ZuPwMyxR8Ug: folds
+OqpStnt0FqbCfyHAWaLbg collected $7.15 from pot
*** SUMMARY ***
Total pot $7.50 | Rake $0.35
Board [3d Th 6d]
Seat 1: bLbSOSmSOnqE0iTcH/5dxA folded before Flop (didn't bet)
Seat 2: +OqpStnt0FqbCfyHAWaLbg collected ($7.15)
Seat 3: h7qXkU57Bb8ZuPwMyxR8Ug folded on the Flop
Seat 4: TZcz9MEWDA+WydgGruqqbw (button) folded before Flop (didn't bet)
Seat 5: 3obndzTJ6fECz8+wWhMd1w (small blind) folded before Flop
Seat 6: uMPEfCcGCfsxmy53tVUMug (big blind) folded before Flop
Seat 7: w6cw9nzN7AvkkHBVVjykoQ folded before Flop (didn't bet)
Seat 8: OsLmX3x/19szSV115TpL/Q folded before Flop (didn't bet)
Seat 9: vR4IO10geOgvTW+LAUBv/A folded before Flop (didn't bet)



PokerStars Game #59939377024:  Hold'em No Limit ($0.50/$1.00) - 2009/07/01 0:38:18 ET
Table '/RZcOwpZpHQ+OwPwjsbnRw' 6-max Seat #6 is the button
Seat 1: Zboa6dColKGHBjLPUakZjw ($52.70 in chips)
Seat 2: +xW7QemQU0Fxs+4TnqBRow ($129 in chips)
Seat 4: j7NIOHLZk7V2o9fOioO5ug ($100 in chips)
Seat 5: wx3sQGkVi2x9wJXuWNHPBw ($198.15 in chips)
Seat 6: XOIf9W+VAxhZqN+SYoyMKA ($288.55 in chips)
Zboa6dColKGHBjLPUakZjw: posts small blind $0.50
+xW7QemQU0Fxs+4TnqBRow: posts big blind $1
*** HOLE CARDS ***
j7NIOHLZk7V2o9fOioO5ug: folds
wx3sQGkVi2x9wJXuWNHPBw: folds
XOIf9W+VAxhZqN+SYoyMKA: folds
Zboa6dColKGHBjLPUakZjw: raises $1 to $2
+xW7QemQU0Fxs+4TnqBRow: folds
Zboa6dColKGHBjLPUakZjw collected $2 from pot
Zboa6dColKGHBjLPUakZjw: doesn't show hand
*** SUMMARY ***
Total pot $2 | Rake $0
Seat 1: Zboa6dColKGHBjLPUakZjw (small blind) collected ($2)
Seat 2: +xW7QemQU0Fxs+4TnqBRow (big blind) folded before Flop
Seat 4: j7NIOHLZk7V2o9fOioO5ug folded before Flop (didn't bet)
Seat 5: wx3sQGkVi2x9wJXuWNHPBw folded before Flop (didn't bet)
Seat 6: XOIf9W+VAxhZqN+SYoyMKA (button) folded before Flop (didn't bet)



PokerStars Game #59939379094:  Hold'em No Limit ($0.50/$1.00) - 2009/07/01 0:38:21 ET
Table 'GxCPo/gd3OSthkYrAxJngg' 6-max Seat #6 is the button
Seat 1: sH8BpAFP+jGFxCgVpD1Lew ($261.95 in chips)
Seat 2: YExX2paeIHrmfIwV1ivM/w ($78.20 in chips)
Seat 3: o6plE+MSW4XFNTeONe16xg ($34.10 in chips)
Seat 4: YMJG+F++3Aj6P8dAWda5fw ($108.15 in chips)
Seat 5: G5ZSSN6RSON3gkNvk/SmYg ($101.70 in chips)
Seat 6: sS9IXedL3MiRmpVXhAILhw ($101.95 in chips)
sH8BpAFP+jGFxCgVpD1Lew: posts small blind $0.50
YExX2paeIHrmfIwV1ivM/w: posts big blind $1
*** HOLE CARDS ***
o6plE+MSW4XFNTeONe16xg: folds
YMJG+F++3Aj6P8dAWda5fw: folds
G5ZSSN6RSON3gkNvk/SmYg: folds
sS9IXedL3MiRmpVXhAILhw: folds
sH8BpAFP+jGFxCgVpD1Lew: raises $2 to $3
YExX2paeIHrmfIwV1ivM/w: folds
sH8BpAFP+jGFxCgVpD1Lew collected $2 from pot
*** SUMMARY ***
Total pot $2 | Rake $0
Seat 1: sH8BpAFP+jGFxCgVpD1Lew (small blind) collected ($2)
Seat 2: YExX2paeIHrmfIwV1ivM/w (big blind) folded before Flop
Seat 3: o6plE+MSW4XFNTeONe16xg folded before Flop (didn't bet)
Seat 4: YMJG+F++3Aj6P8dAWda5fw folded before Flop (didn't bet)
Seat 5: G5ZSSN6RSON3gkNvk/SmYg folded before Flop (didn't bet)
Seat 6: sS9IXedL3MiRmpVXhAILhw (button) folded before Flop (didn't bet)



PokerStars Game #59939379824:  Hold'em No Limit ($0.50/$1.00) - 2009/07/01 0:38:22 ET
Table 'FKpXUINE6M3UxHG4zaMhHA' 6-max Seat #3 is the button
Seat 1: qNezhXOOUXqwG7b9X5XJAA ($105.80 in chips)
Seat 2: nDKgwwXJ45hcJfJe01cdxQ ($37.10 in chips)
Seat 3: GOHDYcxP1gP29069kB9HFw ($118.85 in chips)
Seat 4: vw0eLNLy3Huccth4CUZNPQ ($62.50 in chips)
Seat 5: eUBBn2R56C1IQ6Cs/vitwg ($100.50 in chips)
Seat 6: b2a+5TkFf4xJN/Ihhma58Q ($15.90 in chips)
vw0eLNLy3Huccth4CUZNPQ: posts small blind $0.50
eUBBn2R56C1IQ6Cs/vitwg: posts big blind $1
*** HOLE CARDS ***
b2a+5TkFf4xJN/Ihhma58Q: folds
qNezhXOOUXqwG7b9X5XJAA: raises $2 to $3
nDKgwwXJ45hcJfJe01cdxQ: folds
GOHDYcxP1gP29069kB9HFw: folds
vw0eLNLy3Huccth4CUZNPQ: calls $2.50
eUBBn2R56C1IQ6Cs/vitwg: folds
*** FLOP *** [Ts 5s 6c]
vw0eLNLy3Huccth4CUZNPQ: checks
qNezhXOOUXqwG7b9X5XJAA: bets $4
vw0eLNLy3Huccth4CUZNPQ: raises $5 to $9
qNezhXOOUXqwG7b9X5XJAA: calls $5
*** TURN *** [Ts 5s 6c] [3c]
vw0eLNLy3Huccth4CUZNPQ: checks
qNezhXOOUXqwG7b9X5XJAA: checks
*** RIVER *** [Ts 5s 6c 3c] [7d]
vw0eLNLy3Huccth4CUZNPQ: bets $7
qNezhXOOUXqwG7b9X5XJAA: folds
vw0eLNLy3Huccth4CUZNPQ collected $23.80 from pot
vw0eLNLy3Huccth4CUZNPQ: doesn't show hand
*** SUMMARY ***
Total pot $25 | Rake $1.20
Board [Ts 5s 6c 3c 7d]
Seat 1: qNezhXOOUXqwG7b9X5XJAA folded on the River
Seat 2: nDKgwwXJ45hcJfJe01cdxQ folded before Flop (didn't bet)
Seat 3: GOHDYcxP1gP29069kB9HFw (button) folded before Flop (didn't bet)
Seat 4: vw0eLNLy3Huccth4CUZNPQ (small blind) collected ($23.80)
Seat 5: eUBBn2R56C1IQ6Cs/vitwg (big blind) folded before Flop
Seat 6: b2a+5TkFf4xJN/Ihhma58Q folded before Flop (didn't bet)



PokerStars Game #59939380796:  Hold'em No Limit ($0.50/$1.00) - 2009/07/01 0:38:24 ET
Table '7Nl0ffnjeK44/vmeexh3MQ' 9-max Seat #3 is the button
Seat 1: s7D3Y+k4Cj4D1cXHv7oj+Q ($97.80 in chips)
Seat 2: kiakSwxX0e64PwYGAPQvLw ($31.85 in chips)
Seat 3: vR4IO10geOgvTW+LAUBv/A ($103 in chips)
Seat 4: bLbSOSmSOnqE0iTcH/5dxA ($100 in chips)
Seat 5: bL+QVeDcuEdzMGAGg2XJHg ($99.90 in chips)
Seat 6: FVs16t7GgfWgQWt4JxsObQ ($21.45 in chips)
Seat 8: zanka7aAZkigmZpfopXxxA ($233.20 in chips)
Seat 9: ouwUBGRKnKK9uhn1G4Lf+A ($95 in chips)
bLbSOSmSOnqE0iTcH/5dxA: posts small blind $0.50
bL+QVeDcuEdzMGAGg2XJHg: posts big blind $1
amazinmets73: sits out
*** HOLE CARDS ***
FVs16t7GgfWgQWt4JxsObQ: calls $1
zanka7aAZkigmZpfopXxxA: calls $1
ouwUBGRKnKK9uhn1G4Lf+A: folds
s7D3Y+k4Cj4D1cXHv7oj+Q: folds
kiakSwxX0e64PwYGAPQvLw: folds
vR4IO10geOgvTW+LAUBv/A: folds
bLbSOSmSOnqE0iTcH/5dxA: folds
bL+QVeDcuEdzMGAGg2XJHg: checks
*** FLOP *** [4c 8d 6d]
bL+QVeDcuEdzMGAGg2XJHg: checks
FVs16t7GgfWgQWt4JxsObQ: bets $2
zanka7aAZkigmZpfopXxxA: folds
bL+QVeDcuEdzMGAGg2XJHg: folds
FVs16t7GgfWgQWt4JxsObQ collected $3.35 from pot
*** SUMMARY ***
Total pot $3.50 | Rake $0.15
Board [4c 8d 6d]
Seat 1: s7D3Y+k4Cj4D1cXHv7oj+Q folded before Flop (didn't bet)
Seat 2: kiakSwxX0e64PwYGAPQvLw folded before Flop (didn't bet)
Seat 3: vR4IO10geOgvTW+LAUBv/A (button) folded before Flop (didn't bet)
Seat 4: bLbSOSmSOnqE0iTcH/5dxA (small blind) folded before Flop
Seat 5: bL+QVeDcuEdzMGAGg2XJHg (big blind) folded on the Flop
Seat 6: FVs16t7GgfWgQWt4JxsObQ collected ($3.35)
Seat 8: zanka7aAZkigmZpfopXxxA folded on the Flop
Seat 9: ouwUBGRKnKK9uhn1G4Lf+A folded before Flop (didn't bet)



PokerStars Game #59939381586:  Hold'em No Limit ($0.50/$1.00) - 2009/07/01 0:38:25 ET
Table 'Evb7VW0qfDhFkbgBL3gcqQ' 2-max Seat #2 is the button
Seat 1: NYi6JFscYNrofSXy4sM+Yw ($100 in chips)
Seat 2: mJHc7tEZG3SVIX7QQjb5EQ ($20 in chips)
mJHc7tEZG3SVIX7QQjb5EQ: posts small blind $0.50
NYi6JFscYNrofSXy4sM+Yw: posts big blind $1
*** HOLE CARDS ***
mJHc7tEZG3SVIX7QQjb5EQ: raises $2 to $3
NYi6JFscYNrofSXy4sM+Yw: calls $2
*** FLOP *** [7d 8s Js]
NYi6JFscYNrofSXy4sM+Yw: checks
mJHc7tEZG3SVIX7QQjb5EQ: bets $4
NYi6JFscYNrofSXy4sM+Yw: raises $4 to $8
mJHc7tEZG3SVIX7QQjb5EQ: raises $9 to $17 and is all-in
NYi6JFscYNrofSXy4sM+Yw: calls $9
*** TURN *** [7d 8s Js] [6d]
*** RIVER *** [7d 8s Js 6d] [Ac]
*** SHOW DOWN ***
NYi6JFscYNrofSXy4sM+Yw: shows [Jc Ts] (a pair of Jacks)
mJHc7tEZG3SVIX7QQjb5EQ: shows [8d As] (two pair, Aces and Eights)
mJHc7tEZG3SVIX7QQjb5EQ collected $39.50 from pot
*** SUMMARY ***
Total pot $40 | Rake $0.50
Board [7d 8s Js 6d Ac]
Seat 1: NYi6JFscYNrofSXy4sM+Yw (big blind) showed [Jc Ts] and lost with a pair of Jacks
Seat 2: mJHc7tEZG3SVIX7QQjb5EQ (button) (small blind) showed [8d As] and won ($39.50) with two pair, Aces and Eights



PokerStars Game #59939382118:  Hold'em No Limit ($0.50/$1.00) - 2009/07/01 0:38:26 ET
Table 'eU3bWpDDg3Z+9R4m4iVmog' 6-max Seat #3 is the button
Seat 1: TSuRyAHnUPCFjP7Z0rEE0w ($186.10 in chips)
Seat 2: 8CAoOzhmB8n3nRFf3V4BTg ($123.95 in chips)
Seat 3: U6tnjwZRpTnM+YkqkCjwyQ ($168.15 in chips)
Seat 4: GDVIsbEJ/DOJsMKE4Asz0A ($84.60 in chips)
Seat 5: AdLVjddOzm+sRNo1Bc3S6Q ($100 in chips)
Seat 6: hpxXcmRkXXI9HE5+5/j/0Q ($109.45 in chips)
GDVIsbEJ/DOJsMKE4Asz0A: posts small blind $0.50
AdLVjddOzm+sRNo1Bc3S6Q: posts big blind $1
*** HOLE CARDS ***
hpxXcmRkXXI9HE5+5/j/0Q: folds
TSuRyAHnUPCFjP7Z0rEE0w: folds
8CAoOzhmB8n3nRFf3V4BTg: calls $1
U6tnjwZRpTnM+YkqkCjwyQ: folds
GDVIsbEJ/DOJsMKE4Asz0A: calls $0.50
AdLVjddOzm+sRNo1Bc3S6Q: checks
*** FLOP *** [8d 4d 4c]
GDVIsbEJ/DOJsMKE4Asz0A: checks
AdLVjddOzm+sRNo1Bc3S6Q: checks
8CAoOzhmB8n3nRFf3V4BTg: checks
*** TURN *** [8d 4d 4c] [5h]
GDVIsbEJ/DOJsMKE4Asz0A: checks
AdLVjddOzm+sRNo1Bc3S6Q: checks
8CAoOzhmB8n3nRFf3V4BTg: bets $2
GDVIsbEJ/DOJsMKE4Asz0A: folds
AdLVjddOzm+sRNo1Bc3S6Q: folds
8CAoOzhmB8n3nRFf3V4BTg collected $2.85 from pot
*** SUMMARY ***
Total pot $3 | Rake $0.15
Board [8d 4d 4c 5h]
Seat 1: TSuRyAHnUPCFjP7Z0rEE0w folded before Flop (didn't bet)
Seat 2: 8CAoOzhmB8n3nRFf3V4BTg collected ($2.85)
Seat 3: U6tnjwZRpTnM+YkqkCjwyQ (button) folded before Flop (didn't bet)
Seat 4: GDVIsbEJ/DOJsMKE4Asz0A (small blind) folded on the Turn
Seat 5: AdLVjddOzm+sRNo1Bc3S6Q (big blind) folded on the Turn
Seat 6: hpxXcmRkXXI9HE5+5/j/0Q folded before Flop (didn't bet)



PokerStars Game #59939381974:  Hold'em No Limit ($0.50/$1.00) - 2009/07/01 0:38:26 ET
Table '8jIjWCPY0NGprquL+xcMFg' 9-max Seat #4 is the button
Seat 1: vR4IO10geOgvTW+LAUBv/A ($135.10 in chips)
Seat 2: rR1qGAf9Q9RYorKYWH3VKw ($5.20 in chips)
Seat 3: tjhwe1V98x2spSoUQER3HQ ($100 in chips)
Seat 4: by0z+YmujwI6Bf4qRFE8vA ($144.95 in chips)
Seat 6: GTQkFJtSkbVbnGCktp6e3g ($100 in chips)
Seat 7: O3CGPwwUmamrCNHccOilrg ($54.55 in chips)
Seat 8: 9swGhtpERPngKPtvpoZkoQ ($150.30 in chips)
Seat 9: negfosHnGOZXSHpWDRKyBQ ($20 in chips)
GTQkFJtSkbVbnGCktp6e3g: posts small blind $0.50
O3CGPwwUmamrCNHccOilrg: posts big blind $1
*** HOLE CARDS ***
9swGhtpERPngKPtvpoZkoQ: folds
negfosHnGOZXSHpWDRKyBQ: folds
vR4IO10geOgvTW+LAUBv/A: folds
rR1qGAf9Q9RYorKYWH3VKw: folds
tjhwe1V98x2spSoUQER3HQ: raises $3 to $4
by0z+YmujwI6Bf4qRFE8vA: calls $4
GTQkFJtSkbVbnGCktp6e3g: calls $3.50
O3CGPwwUmamrCNHccOilrg: folds
*** FLOP *** [3s Ts Kh]
GTQkFJtSkbVbnGCktp6e3g: checks
tjhwe1V98x2spSoUQER3HQ: checks
by0z+YmujwI6Bf4qRFE8vA: checks
*** TURN *** [3s Ts Kh] [6c]
GTQkFJtSkbVbnGCktp6e3g: checks
tjhwe1V98x2spSoUQER3HQ: checks
by0z+YmujwI6Bf4qRFE8vA: checks
*** RIVER *** [3s Ts Kh 6c] [5c]
GTQkFJtSkbVbnGCktp6e3g: checks
tjhwe1V98x2spSoUQER3HQ: checks
by0z+YmujwI6Bf4qRFE8vA: checks
*** SHOW DOWN ***
GTQkFJtSkbVbnGCktp6e3g: shows [As Qc] (high card Ace)
tjhwe1V98x2spSoUQER3HQ: mucks hand
by0z+YmujwI6Bf4qRFE8vA: mucks hand
GTQkFJtSkbVbnGCktp6e3g collected $12.35 from pot
*** SUMMARY ***
Total pot $13 | Rake $0.65
Board [3s Ts Kh 6c 5c]
Seat 1: vR4IO10geOgvTW+LAUBv/A folded before Flop (didn't bet)
Seat 2: rR1qGAf9Q9RYorKYWH3VKw folded before Flop (didn't bet)
Seat 3: tjhwe1V98x2spSoUQER3HQ mucked
Seat 4: by0z+YmujwI6Bf4qRFE8vA (button) mucked
Seat 6: GTQkFJtSkbVbnGCktp6e3g (small blind) showed [As Qc] and won ($12.35) with high card Ace
Seat 7: O3CGPwwUmamrCNHccOilrg (big blind) folded before Flop
Seat 8: 9swGhtpERPngKPtvpoZkoQ folded before Flop (didn't bet)
Seat 9: negfosHnGOZXSHpWDRKyBQ folded before Flop (didn't bet)



PokerStars Game #59939383820:  Hold'em No Limit ($0.50/$1.00) - 2009/07/01 0:38:28 ET
Table 'N2bNCDHL96aCQDvZIh+yQQ' 6-max Seat #4 is the button
Seat 1: iHo1oDbrEVJ8nEGdaPrICw ($143.50 in chips)
Seat 2: KpnW5CcJ4Mg6MeclfKmLrw ($113.60 in chips)
Seat 3: Qy/UBNbD2HaA0Ogxg8Sf3w ($100 in chips)
Seat 4: uCqEjnxh2/vFBjKYkfTOkw ($174.40 in chips)
Seat 5: rHlMOfR7kpQQxe+PFQz0xQ ($28 in chips)
Seat 6: TSuRyAHnUPCFjP7Z0rEE0w ($100 in chips)
rHlMOfR7kpQQxe+PFQz0xQ: posts small blind $0.50
TSuRyAHnUPCFjP7Z0rEE0w: posts big blind $1
*** HOLE CARDS ***
iHo1oDbrEVJ8nEGdaPrICw: folds
KpnW5CcJ4Mg6MeclfKmLrw: folds
Qy/UBNbD2HaA0Ogxg8Sf3w: folds
uCqEjnxh2/vFBjKYkfTOkw: raises $1 to $2
rHlMOfR7kpQQxe+PFQz0xQ: calls $1.50
TSuRyAHnUPCFjP7Z0rEE0w: folds
*** FLOP *** [Jh 4s 8c]
rHlMOfR7kpQQxe+PFQz0xQ: checks
uCqEjnxh2/vFBjKYkfTOkw: checks
*** TURN *** [Jh 4s 8c] [8h]
rHlMOfR7kpQQxe+PFQz0xQ: checks
uCqEjnxh2/vFBjKYkfTOkw: checks
*** RIVER *** [Jh 4s 8c 8h] [4d]
rHlMOfR7kpQQxe+PFQz0xQ: checks
uCqEjnxh2/vFBjKYkfTOkw: checks
*** SHOW DOWN ***
rHlMOfR7kpQQxe+PFQz0xQ: shows [Ac 7s] (two pair, Eights and Fours)
uCqEjnxh2/vFBjKYkfTOkw: mucks hand
rHlMOfR7kpQQxe+PFQz0xQ collected $4.75 from pot
*** SUMMARY ***
Total pot $5 | Rake $0.25
Board [Jh 4s 8c 8h 4d]
Seat 1: iHo1oDbrEVJ8nEGdaPrICw folded before Flop (didn't bet)
Seat 2: KpnW5CcJ4Mg6MeclfKmLrw folded before Flop (didn't bet)
Seat 3: Qy/UBNbD2HaA0Ogxg8Sf3w folded before Flop (didn't bet)
Seat 4: uCqEjnxh2/vFBjKYkfTOkw (button) mucked
Seat 5: rHlMOfR7kpQQxe+PFQz0xQ (small blind) showed [Ac 7s] and won ($4.75) with two pair, Eights and Fours
Seat 6: TSuRyAHnUPCFjP7Z0rEE0w (big blind) folded before Flop



PokerStars Game #59939384300:  Hold'em No Limit ($0.50/$1.00) - 2009/07/01 0:38:29 ET
Table 'rmZfTK+oSebeUPJNbWhdAA' 6-max Seat #2 is the button
Seat 1: xAU6q2/cwmby2sxmA8VcmA ($100 in chips)
Seat 2: z7O9PO/WEcqRouIydFhS9Q ($94 in chips)
Seat 3: 9yjOzGERLaEZS8CZ6YNHFg ($117.35 in chips)
Seat 4: OGMLOcTNYZXZU81au7ztUw ($134.50 in chips)
Seat 5: +xW7QemQU0Fxs+4TnqBRow ($100 in chips)
Seat 6: j7NIOHLZk7V2o9fOioO5ug ($132.50 in chips)
9yjOzGERLaEZS8CZ6YNHFg: posts small blind $0.50
OGMLOcTNYZXZU81au7ztUw: posts big blind $1
*** HOLE CARDS ***
+xW7QemQU0Fxs+4TnqBRow: folds
j7NIOHLZk7V2o9fOioO5ug: folds
z7O9PO/WEcqRouIydFhS9Q said, "oh ok...."
xAU6q2/cwmby2sxmA8VcmA: raises $3 to $4
z7O9PO/WEcqRouIydFhS9Q: folds
9yjOzGERLaEZS8CZ6YNHFg: calls $3.50
OGMLOcTNYZXZU81au7ztUw: folds
*** FLOP *** [Kc Ts 5c]
9yjOzGERLaEZS8CZ6YNHFg: checks
xAU6q2/cwmby2sxmA8VcmA: bets $6
9yjOzGERLaEZS8CZ6YNHFg: folds
xAU6q2/cwmby2sxmA8VcmA collected $8.55 from pot
xAU6q2/cwmby2sxmA8VcmA: doesn't show hand
*** SUMMARY ***
Total pot $9 | Rake $0.45
Board [Kc Ts 5c]
Seat 1: xAU6q2/cwmby2sxmA8VcmA collected ($8.55)
Seat 2: z7O9PO/WEcqRouIydFhS9Q (button) folded before Flop (didn't bet)
Seat 3: 9yjOzGERLaEZS8CZ6YNHFg (small blind) folded on the Flop
Seat 4: OGMLOcTNYZXZU81au7ztUw (big blind) folded before Flop
Seat 5: +xW7QemQU0Fxs+4TnqBRow folded before Flop (didn't bet)
Seat 6: j7NIOHLZk7V2o9fOioO5ug folded before Flop (didn't bet)



PokerStars Game #59939384186:  Hold'em No Limit ($0.50/$1.00) - 2009/07/01 0:38:29 ET
Table 'VOs36P6NW+QyXeQ1B62kmA' 6-max Seat #4 is the button
Seat 1: AdLVjddOzm+sRNo1Bc3S6Q ($142.30 in chips)
Seat 2: KpnW5CcJ4Mg6MeclfKmLrw ($111.80 in chips)
Seat 3: TSuRyAHnUPCFjP7Z0rEE0w ($100 in chips)
Seat 4: w02zQzNydODiyV9THKgo9w ($36.80 in chips)
Seat 6: 6tvjsJrdmWg+g7FVrMnzXA ($64.50 in chips)
X7GlkHF+lkbarCLuZ4Uf0w will be allowed to play after the button
6tvjsJrdmWg+g7FVrMnzXA: posts small blind $0.50
AdLVjddOzm+sRNo1Bc3S6Q: posts big blind $1
*** HOLE CARDS ***
KpnW5CcJ4Mg6MeclfKmLrw: raises $3 to $4
TSuRyAHnUPCFjP7Z0rEE0w: folds
w02zQzNydODiyV9THKgo9w: folds
6tvjsJrdmWg+g7FVrMnzXA: calls $3.50
AdLVjddOzm+sRNo1Bc3S6Q: folds
*** FLOP *** [3h 4c Ah]
6tvjsJrdmWg+g7FVrMnzXA: checks
KpnW5CcJ4Mg6MeclfKmLrw: bets $6
6tvjsJrdmWg+g7FVrMnzXA: folds
KpnW5CcJ4Mg6MeclfKmLrw collected $8.55 from pot
KpnW5CcJ4Mg6MeclfKmLrw: doesn't show hand
*** SUMMARY ***
Total pot $9 | Rake $0.45
Board [3h 4c Ah]
Seat 1: AdLVjddOzm+sRNo1Bc3S6Q (big blind) folded before Flop
Seat 2: KpnW5CcJ4Mg6MeclfKmLrw collected ($8.55)
Seat 3: TSuRyAHnUPCFjP7Z0rEE0w folded before Flop (didn't bet)
Seat 4: w02zQzNydODiyV9THKgo9w (button) folded before Flop (didn't bet)
Seat 6: 6tvjsJrdmWg+g7FVrMnzXA (small blind) folded on the Flop



PokerStars Game #59939385308:  Hold'em No Limit ($0.50/$1.00) - 2009/07/01 0:38:30 ET
Table 'LmXQK9xy3awB+qsPzI21Mw' 2-max Seat #2 is the button
Seat 1: NYi6JFscYNrofSXy4sM+Yw ($241.05 in chips)
Seat 2: TME8GvochpQAo8cmJwWmvA ($98.15 in chips)
TME8GvochpQAo8cmJwWmvA: posts small blind $0.50
NYi6JFscYNrofSXy4sM+Yw: posts big blind $1
*** HOLE CARDS ***
TME8GvochpQAo8cmJwWmvA: raises $1 to $2
NYi6JFscYNrofSXy4sM+Yw: folds
TME8GvochpQAo8cmJwWmvA collected $2 from pot
TME8GvochpQAo8cmJwWmvA: doesn't show hand
*** SUMMARY ***
Total pot $2 | Rake $0
Seat 1: NYi6JFscYNrofSXy4sM+Yw (big blind) folded before Flop
Seat 2: TME8GvochpQAo8cmJwWmvA (button) (small blind) collected ($2)



PokerStars Game #59939385074:  Hold'em No Limit ($0.50/$1.00) - 2009/07/01 0:38:30 ET
Table 'hugOjcwJvzEwZbK7tyiWuQ' 9-max Seat #3 is the button
Seat 1: N9n5Wc3s35DpCrOAUUNAaQ ($127 in chips)
Seat 2: r27C1nIV4NS4+qbnrgBQSw ($255.55 in chips)
Seat 3: jDwhY1kCdc6EkAHbT7PJMQ ($107.65 in chips)
Seat 4: UWB3oeddt/GObx2Mix2Anw ($210.75 in chips)
Seat 5: 5BRGWf+R3nt2WS3b5xX+zA ($24.80 in chips)
Seat 6: gUUvmqdVlmvpal6B8nYrmg ($100 in chips)
Seat 7: FL3MrLspcF23LYvC4ipBOA ($101.50 in chips)
Seat 8: /zy+DB4S5fUQUSfZWFzYGw ($105.75 in chips)
Seat 9: o6JyUkbzCDw8tUabqtmnlg ($61.20 in chips)
UWB3oeddt/GObx2Mix2Anw: posts small blind $0.50
5BRGWf+R3nt2WS3b5xX+zA: posts big blind $1
*** HOLE CARDS ***
gUUvmqdVlmvpal6B8nYrmg: folds
FL3MrLspcF23LYvC4ipBOA: folds
/zy+DB4S5fUQUSfZWFzYGw: folds
o6JyUkbzCDw8tUabqtmnlg: folds
N9n5Wc3s35DpCrOAUUNAaQ: raises $2 to $3
r27C1nIV4NS4+qbnrgBQSw: folds
jDwhY1kCdc6EkAHbT7PJMQ: folds
UWB3oeddt/GObx2Mix2Anw: folds
5BRGWf+R3nt2WS3b5xX+zA: folds
N9n5Wc3s35DpCrOAUUNAaQ collected $2.50 from pot
*** SUMMARY ***
Total pot $2.50 | Rake $0
Seat 1: N9n5Wc3s35DpCrOAUUNAaQ collected ($2.50)
Seat 2: r27C1nIV4NS4+qbnrgBQSw folded before Flop (didn't bet)
Seat 3: jDwhY1kCdc6EkAHbT7PJMQ (button) folded before Flop (didn't bet)
Seat 4: UWB3oeddt/GObx2Mix2Anw (small blind) folded before Flop
Seat 5: 5BRGWf+R3nt2WS3b5xX+zA (big blind) folded before Flop
Seat 6: gUUvmqdVlmvpal6B8nYrmg folded before Flop (didn't bet)
Seat 7: FL3MrLspcF23LYvC4ipBOA folded before Flop (didn't bet)
Seat 8: /zy+DB4S5fUQUSfZWFzYGw folded before Flop (didn't bet)
Seat 9: o6JyUkbzCDw8tUabqtmnlg folded before Flop (didn't bet)



PokerStars Game #59939386630:  Hold'em No Limit ($0.50/$1.00) - 2009/07/01 0:38:32 ET
Table 'U9zqzC8f3oTJ2ShXFgSSOA' 6-max Seat #2 is the button
Seat 1: tS9JHB1h+FQ++qu8RwRNgg ($76.60 in chips)
Seat 2: U2CWBTv29qdCbj8RNF2sIw ($99.50 in chips)
Seat 3: yfXek8iJ7O4CFyqXrtGcfg ($15.05 in chips)
Seat 4: 33q95we0Etwgrm6guQGncw ($72.15 in chips)
Seat 5: KfwW5us6tydK81NYTtK1gw ($309.75 in chips)
Seat 6: aIxzFKdtpDSkUePKZy/niQ ($28.55 in chips)
aIxzFKdtpDSkUePKZy/niQ said, "nh"
yfXek8iJ7O4CFyqXrtGcfg: posts small blind $0.50
33q95we0Etwgrm6guQGncw: posts big blind $1
*** HOLE CARDS ***
KfwW5us6tydK81NYTtK1gw: folds
aIxzFKdtpDSkUePKZy/niQ: folds
tS9JHB1h+FQ++qu8RwRNgg said, "ty"
tS9JHB1h+FQ++qu8RwRNgg: raises $2 to $3
U2CWBTv29qdCbj8RNF2sIw: folds
yfXek8iJ7O4CFyqXrtGcfg: calls $2.50
33q95we0Etwgrm6guQGncw: calls $2
*** FLOP *** [Qs Jc 5c]
yfXek8iJ7O4CFyqXrtGcfg: checks
33q95we0Etwgrm6guQGncw: checks
tS9JHB1h+FQ++qu8RwRNgg: bets $8
yfXek8iJ7O4CFyqXrtGcfg: folds
33q95we0Etwgrm6guQGncw: folds
tS9JHB1h+FQ++qu8RwRNgg collected $8.55 from pot
tS9JHB1h+FQ++qu8RwRNgg: doesn't show hand
*** SUMMARY ***
Total pot $9 | Rake $0.45
Board [Qs Jc 5c]
Seat 1: tS9JHB1h+FQ++qu8RwRNgg collected ($8.55)
Seat 2: U2CWBTv29qdCbj8RNF2sIw (button) folded before Flop (didn't bet)
Seat 3: yfXek8iJ7O4CFyqXrtGcfg (small blind) folded on the Flop
Seat 4: 33q95we0Etwgrm6guQGncw (big blind) folded on the Flop
Seat 5: KfwW5us6tydK81NYTtK1gw folded before Flop (didn't bet)
Seat 6: aIxzFKdtpDSkUePKZy/niQ folded before Flop (didn't bet)



PokerStars Game #59939388394:  Hold'em No Limit ($0.50/$1.00) - 2009/07/01 0:38:35 ET
Table '6YvsYDPNIDx2v5z3bJnwZQ' 9-max Seat #1 is the button
Seat 1: Ogn4JDV3mp4ZDKO49IFzKA ($15.35 in chips)
Seat 2: x80+i7DJL+81v3quj7KbNg ($20 in chips)
Seat 3: negfosHnGOZXSHpWDRKyBQ ($19.30 in chips)
Seat 4: kEr5NYB+JIG5+szcYMr6hA ($44 in chips)
Seat 5: mBRWbnUl8diyBO1qTJaNzw ($160.70 in chips)
Seat 6: uMPEfCcGCfsxmy53tVUMug ($108.10 in chips)
Seat 7: boixc27eqTYA1p0tUdMuBQ ($114 in chips)
Seat 8: PSFxpXgPedVZyHSu2Zhb7Q ($46.75 in chips)
Seat 9: jDwhY1kCdc6EkAHbT7PJMQ ($104.10 in chips)
x80+i7DJL+81v3quj7KbNg: posts small blind $0.50
negfosHnGOZXSHpWDRKyBQ: posts big blind $1
*** HOLE CARDS ***
kEr5NYB+JIG5+szcYMr6hA: folds
mBRWbnUl8diyBO1qTJaNzw: folds
uMPEfCcGCfsxmy53tVUMug: folds
boixc27eqTYA1p0tUdMuBQ: folds
PSFxpXgPedVZyHSu2Zhb7Q: folds
jDwhY1kCdc6EkAHbT7PJMQ: folds
Ogn4JDV3mp4ZDKO49IFzKA: raises $14.35 to $15.35 and is all-in
x80+i7DJL+81v3quj7KbNg: folds
negfosHnGOZXSHpWDRKyBQ: folds
Ogn4JDV3mp4ZDKO49IFzKA collected $2.50 from pot
*** SUMMARY ***
Total pot $2.50 | Rake $0
Seat 1: Ogn4JDV3mp4ZDKO49IFzKA (button) collected ($2.50)
Seat 2: x80+i7DJL+81v3quj7KbNg (small blind) folded before Flop
Seat 3: negfosHnGOZXSHpWDRKyBQ (big blind) folded before Flop
Seat 4: kEr5NYB+JIG5+szcYMr6hA folded before Flop (didn't bet)
Seat 5: mBRWbnUl8diyBO1qTJaNzw folded before Flop (didn't bet)
Seat 6: uMPEfCcGCfsxmy53tVUMug folded before Flop (didn't bet)
Seat 7: boixc27eqTYA1p0tUdMuBQ folded before Flop (didn't bet)
Seat 8: PSFxpXgPedVZyHSu2Zhb7Q folded before Flop (didn't bet)
Seat 9: jDwhY1kCdc6EkAHbT7PJMQ folded before Flop (didn't bet)



PokerStars Game #59939389198:  Hold'em No Limit ($0.50/$1.00) - 2009/07/01 0:38:36 ET
Table 'QBLDswtHe7Ml0HwAdcMhlw' 2-max Seat #2 is the button
Seat 1: hdNlhiCwI533uwvvTTfC9Q ($100 in chips)
Seat 2: GBkvjkjDWVBEa1e14dh6CA ($65.50 in chips)
GBkvjkjDWVBEa1e14dh6CA: posts small blind $0.50
hdNlhiCwI533uwvvTTfC9Q: posts big blind $1
*** HOLE CARDS ***
GBkvjkjDWVBEa1e14dh6CA: raises $2 to $3
hdNlhiCwI533uwvvTTfC9Q: folds
GBkvjkjDWVBEa1e14dh6CA collected $2 from pot
GBkvjkjDWVBEa1e14dh6CA: doesn't show hand
*** SUMMARY ***
Total pot $2 | Rake $0
Seat 1: hdNlhiCwI533uwvvTTfC9Q (big blind) folded before Flop
Seat 2: GBkvjkjDWVBEa1e14dh6CA (button) (small blind) collected ($2)



PokerStars Game #59939389958:  Hold'em No Limit ($0.50/$1.00) - 2009/07/01 0:38:39 ET
Table 'LmXQK9xy3awB+qsPzI21Mw' 2-max Seat #1 is the button
Seat 1: NYi6JFscYNrofSXy4sM+Yw ($240.05 in chips)
Seat 2: TME8GvochpQAo8cmJwWmvA ($99.15 in chips)
NYi6JFscYNrofSXy4sM+Yw: posts small blind $0.50
TME8GvochpQAo8cmJwWmvA: posts big blind $1
*** HOLE CARDS ***
NYi6JFscYNrofSXy4sM+Yw: folds
TME8GvochpQAo8cmJwWmvA collected $1 from pot
TME8GvochpQAo8cmJwWmvA: doesn't show hand
*** SUMMARY ***
Total pot $1 | Rake $0
Seat 1: NYi6JFscYNrofSXy4sM+Yw (button) (small blind) folded before Flop
Seat 2: TME8GvochpQAo8cmJwWmvA (big blind) collected ($1)



PokerStars Game #59939390286:  Hold'em No Limit ($0.50/$1.00) - 2009/07/01 0:38:39 ET
Table 'QSIig7BLMc9wY/rgBechzw' 6-max Seat #1 is the button
Seat 1: uuA9hpFU17U5/t4cvpbpBg ($21.45 in chips)
Seat 3: +W6OnF033KNM2xH0fGj98Q ($102.20 in chips)
Seat 4: +uSzP8Jwnw7sKfQ4s66b7w ($57 in chips)
Seat 5: bvU2ZjpVnszLCFVeWbxePg ($142.10 in chips)
Seat 6: KpnW5CcJ4Mg6MeclfKmLrw ($188.60 in chips)
+W6OnF033KNM2xH0fGj98Q: posts small blind $0.50
+uSzP8Jwnw7sKfQ4s66b7w: posts big blind $1
*** HOLE CARDS ***
bvU2ZjpVnszLCFVeWbxePg: folds
KpnW5CcJ4Mg6MeclfKmLrw: raises $2 to $3
uuA9hpFU17U5/t4cvpbpBg: folds
+W6OnF033KNM2xH0fGj98Q: raises $7 to $10
+uSzP8Jwnw7sKfQ4s66b7w: folds
KpnW5CcJ4Mg6MeclfKmLrw: folds
+W6OnF033KNM2xH0fGj98Q collected $7 from pot
+W6OnF033KNM2xH0fGj98Q: doesn't show hand
*** SUMMARY ***
Total pot $7 | Rake $0
Seat 1: uuA9hpFU17U5/t4cvpbpBg (button) folded before Flop (didn't bet)
Seat 3: +W6OnF033KNM2xH0fGj98Q (small blind) collected ($7)
Seat 4: +uSzP8Jwnw7sKfQ4s66b7w (big blind) folded before Flop
Seat 5: bvU2ZjpVnszLCFVeWbxePg folded before Flop (didn't bet)
Seat 6: KpnW5CcJ4Mg6MeclfKmLrw folded before Flop



PokerStars Game #59939392816:  Hold'em No Limit ($0.50/$1.00) - 2009/07/01 0:38:42 ET
Table '/RZcOwpZpHQ+OwPwjsbnRw' 6-max Seat #1 is the button
Seat 1: Zboa6dColKGHBjLPUakZjw ($53.70 in chips)
Seat 2: +xW7QemQU0Fxs+4TnqBRow ($128 in chips)
Seat 4: j7NIOHLZk7V2o9fOioO5ug ($100 in chips)
Seat 5: wx3sQGkVi2x9wJXuWNHPBw ($198.15 in chips)
Seat 6: XOIf9W+VAxhZqN+SYoyMKA ($288.55 in chips)
+xW7QemQU0Fxs+4TnqBRow: posts small blind $0.50
j7NIOHLZk7V2o9fOioO5ug: posts big blind $1
*** HOLE CARDS ***
wx3sQGkVi2x9wJXuWNHPBw: folds
XOIf9W+VAxhZqN+SYoyMKA: folds
Zboa6dColKGHBjLPUakZjw: raises $1 to $2
+xW7QemQU0Fxs+4TnqBRow: folds
j7NIOHLZk7V2o9fOioO5ug: folds
Zboa6dColKGHBjLPUakZjw collected $2.50 from pot
*** SUMMARY ***
Total pot $2.50 | Rake $0
Seat 1: Zboa6dColKGHBjLPUakZjw (button) collected ($2.50)
Seat 2: +xW7QemQU0Fxs+4TnqBRow (small blind) folded before Flop
Seat 4: j7NIOHLZk7V2o9fOioO5ug (big blind) folded before Flop
Seat 5: wx3sQGkVi2x9wJXuWNHPBw folded before Flop (didn't bet)
Seat 6: XOIf9W+VAxhZqN+SYoyMKA folded before Flop (didn't bet)



PokerStars Game #59939393152:  Hold'em No Limit ($0.50/$1.00) - 2009/07/01 0:38:42 ET
Table 'MUPc8FEpe/nR0BKSeReX6Q' 6-max Seat #2 is the button
Seat 1: YsLQ3BAvgQHWXMAv3Wv6Hg ($102.50 in chips)
Seat 2: xAU6q2/cwmby2sxmA8VcmA ($110.20 in chips)
Seat 3: wx3sQGkVi2x9wJXuWNHPBw ($233.05 in chips)
Seat 4: ZA1bp6g8IwtTxkUE4eCjDQ ($176.65 in chips)
Seat 5: UBZQqpnJZdTYYY1FTb0rLA ($100 in chips)
Seat 6: oxnw0GLLpFanjhGkxfRSqA ($59.50 in chips)
wx3sQGkVi2x9wJXuWNHPBw: posts small blind $0.50
ZA1bp6g8IwtTxkUE4eCjDQ: posts big blind $1
*** HOLE CARDS ***
UBZQqpnJZdTYYY1FTb0rLA: folds
oxnw0GLLpFanjhGkxfRSqA: folds
YsLQ3BAvgQHWXMAv3Wv6Hg: folds
xAU6q2/cwmby2sxmA8VcmA: raises $3 to $4
wx3sQGkVi2x9wJXuWNHPBw: folds
ZA1bp6g8IwtTxkUE4eCjDQ: calls $3
*** FLOP *** [Qh 9d 7h]
ZA1bp6g8IwtTxkUE4eCjDQ: checks
xAU6q2/cwmby2sxmA8VcmA: bets $7
ZA1bp6g8IwtTxkUE4eCjDQ: folds
xAU6q2/cwmby2sxmA8VcmA collected $8.10 from pot
xAU6q2/cwmby2sxmA8VcmA: doesn't show hand
*** SUMMARY ***
Total pot $8.50 | Rake $0.40
Board [Qh 9d 7h]
Seat 1: YsLQ3BAvgQHWXMAv3Wv6Hg folded before Flop (didn't bet)
Seat 2: xAU6q2/cwmby2sxmA8VcmA (button) collected ($8.10)
Seat 3: wx3sQGkVi2x9wJXuWNHPBw (small blind) folded before Flop
Seat 4: ZA1bp6g8IwtTxkUE4eCjDQ (big blind) folded on the Flop
Seat 5: UBZQqpnJZdTYYY1FTb0rLA folded before Flop (didn't bet)
Seat 6: oxnw0GLLpFanjhGkxfRSqA folded before Flop (didn't bet)



PokerStars Game #59939394516:  Hold'em No Limit ($0.50/$1.00) - 2009/07/01 0:38:45 ET
Table 'cBDNutyLBKEk9+ptwsKmTw' 6-max Seat #5 is the button
Seat 1: xAU6q2/cwmby2sxmA8VcmA ($101 in chips)
Seat 2: Gy1fd4JyD1aNBFFlOGzbJQ ($25.35 in chips)
Seat 3: G5ZSSN6RSON3gkNvk/SmYg ($108.90 in chips)
Seat 4: 3q7F5QtzC30pSrn0nl9i+A ($23.30 in chips)
Seat 5: OGMLOcTNYZXZU81au7ztUw ($138.45 in chips)
Seat 6: NqVlOSH2lp+pp/TK3vvK5g ($43.70 in chips)
NqVlOSH2lp+pp/TK3vvK5g: posts small blind $0.50
xAU6q2/cwmby2sxmA8VcmA: posts big blind $1
*** HOLE CARDS ***
Gy1fd4JyD1aNBFFlOGzbJQ: raises $3 to $4
G5ZSSN6RSON3gkNvk/SmYg: folds
3q7F5QtzC30pSrn0nl9i+A: folds
OGMLOcTNYZXZU81au7ztUw: folds
NqVlOSH2lp+pp/TK3vvK5g: folds
xAU6q2/cwmby2sxmA8VcmA: folds
Gy1fd4JyD1aNBFFlOGzbJQ collected $2.50 from pot
*** SUMMARY ***
Total pot $2.50 | Rake $0
Seat 1: xAU6q2/cwmby2sxmA8VcmA (big blind) folded before Flop
Seat 2: Gy1fd4JyD1aNBFFlOGzbJQ collected ($2.50)
Seat 3: G5ZSSN6RSON3gkNvk/SmYg folded before Flop (didn't bet)
Seat 4: 3q7F5QtzC30pSrn0nl9i+A folded before Flop (didn't bet)
Seat 5: OGMLOcTNYZXZU81au7ztUw (button) folded before Flop (didn't bet)
Seat 6: NqVlOSH2lp+pp/TK3vvK5g (small blind) folded before Flop



PokerStars Game #59939394532:  Hold'em No Limit ($0.50/$1.00) - 2009/07/01 0:38:45 ET
Table 'LmXQK9xy3awB+qsPzI21Mw' 2-max Seat #2 is the button
Seat 1: NYi6JFscYNrofSXy4sM+Yw ($239.55 in chips)
Seat 2: TME8GvochpQAo8cmJwWmvA ($99.65 in chips)
TME8GvochpQAo8cmJwWmvA: posts small blind $0.50
NYi6JFscYNrofSXy4sM+Yw: posts big blind $1
*** HOLE CARDS ***
TME8GvochpQAo8cmJwWmvA: calls $0.50
NYi6JFscYNrofSXy4sM+Yw: raises $2 to $3
TME8GvochpQAo8cmJwWmvA: calls $2
*** FLOP *** [5h 8s Kd]
NYi6JFscYNrofSXy4sM+Yw: bets $3
TME8GvochpQAo8cmJwWmvA: folds
NYi6JFscYNrofSXy4sM+Yw collected $5.70 from pot
*** SUMMARY ***
Total pot $6 | Rake $0.30
Board [5h 8s Kd]
Seat 1: NYi6JFscYNrofSXy4sM+Yw (big blind) collected ($5.70)
Seat 2: TME8GvochpQAo8cmJwWmvA (button) (small blind) folded on the Flop



PokerStars Game #59939395770:  Hold'em No Limit ($0.50/$1.00) - 2009/07/01 0:38:47 ET
Table 'vs/5jr6ciwjVQ5+Soc+u2A' 6-max Seat #2 is the button
Seat 1: 1C0rFAGdnnX4GWK9B0YPww ($25 in chips)
Seat 2: XOIf9W+VAxhZqN+SYoyMKA ($118.15 in chips)
Seat 3: G5ZSSN6RSON3gkNvk/SmYg ($151 in chips)
Seat 4: KpnW5CcJ4Mg6MeclfKmLrw ($109.80 in chips)
Seat 5: 7Vc9JmGFQwMRh5Tj9ui5Lw ($52.80 in chips)
Seat 6: QHvTZcrKe6+maWUfVjP29Q ($101.50 in chips)
G5ZSSN6RSON3gkNvk/SmYg: posts small blind $0.50
KpnW5CcJ4Mg6MeclfKmLrw: posts big blind $1
1C0rFAGdnnX4GWK9B0YPww: posts big blind $1
*** HOLE CARDS ***
7Vc9JmGFQwMRh5Tj9ui5Lw: raises $2 to $3
QHvTZcrKe6+maWUfVjP29Q: calls $3
1C0rFAGdnnX4GWK9B0YPww: folds
XOIf9W+VAxhZqN+SYoyMKA: folds
G5ZSSN6RSON3gkNvk/SmYg: folds
KpnW5CcJ4Mg6MeclfKmLrw: folds
*** FLOP *** [6s 8h 6d]
7Vc9JmGFQwMRh5Tj9ui5Lw: checks
QHvTZcrKe6+maWUfVjP29Q: bets $6
7Vc9JmGFQwMRh5Tj9ui5Lw: folds
QHvTZcrKe6+maWUfVjP29Q collected $8.10 from pot
7Vc9JmGFQwMRh5Tj9ui5Lw leaves the table
QHvTZcrKe6+maWUfVjP29Q: doesn't show hand
*** SUMMARY ***
Total pot $8.50 | Rake $0.40
Board [6s 8h 6d]
Seat 1: 1C0rFAGdnnX4GWK9B0YPww folded before Flop
Seat 2: XOIf9W+VAxhZqN+SYoyMKA (button) folded before Flop (didn't bet)
Seat 3: G5ZSSN6RSON3gkNvk/SmYg (small blind) folded before Flop
Seat 4: KpnW5CcJ4Mg6MeclfKmLrw (big blind) folded before Flop
Seat 5: 7Vc9JmGFQwMRh5Tj9ui5Lw folded on the Flop
Seat 6: QHvTZcrKe6+maWUfVjP29Q collected ($8.10)



PokerStars Game #59939397456:  Hold'em No Limit ($0.50/$1.00) - 2009/07/01 0:38:49 ET
Table 'Evb7VW0qfDhFkbgBL3gcqQ' 2-max Seat #1 is the button
Seat 1: NYi6JFscYNrofSXy4sM+Yw ($100 in chips)
Seat 2: mJHc7tEZG3SVIX7QQjb5EQ ($39.50 in chips)
NYi6JFscYNrofSXy4sM+Yw: posts small blind $0.50
mJHc7tEZG3SVIX7QQjb5EQ: posts big blind $1
*** HOLE CARDS ***
NYi6JFscYNrofSXy4sM+Yw: raises $2 to $3
mJHc7tEZG3SVIX7QQjb5EQ: folds
NYi6JFscYNrofSXy4sM+Yw collected $2 from pot
*** SUMMARY ***
Total pot $2 | Rake $0
Seat 1: NYi6JFscYNrofSXy4sM+Yw (button) (small blind) collected ($2)
Seat 2: mJHc7tEZG3SVIX7QQjb5EQ (big blind) folded before Flop



PokerStars Game #59939398456:  Hold'em No Limit ($0.50/$1.00) - 2009/07/01 0:38:51 ET
Table 'QBLDswtHe7Ml0HwAdcMhlw' 2-max Seat #1 is the button
Seat 1: hdNlhiCwI533uwvvTTfC9Q ($100 in chips)
Seat 2: GBkvjkjDWVBEa1e14dh6CA ($66.50 in chips)
hdNlhiCwI533uwvvTTfC9Q: posts small blind $0.50
GBkvjkjDWVBEa1e14dh6CA: posts big blind $1
*** HOLE CARDS ***
hdNlhiCwI533uwvvTTfC9Q: raises $2 to $3
GBkvjkjDWVBEa1e14dh6CA: folds
hdNlhiCwI533uwvvTTfC9Q collected $2 from pot
hdNlhiCwI533uwvvTTfC9Q: doesn't show hand
*** SUMMARY ***
Total pot $2 | Rake $0
Seat 1: hdNlhiCwI533uwvvTTfC9Q (button) (small blind) collected ($2)
Seat 2: GBkvjkjDWVBEa1e14dh6CA (big blind) folded before Flop



PokerStars Game #59939398788:  Hold'em No Limit ($0.50/$1.00) - 2009/07/01 0:38:51 ET
Table '+cA8mcmhaedZ7YcrDdhmeQ' 6-max Seat #6 is the button
Seat 1: lsLuWlcPA3Rh7kJVLzMh0Q ($303.25 in chips)
Seat 2: RqgF7gRoKgRNW8Zoi1ty4A ($104.20 in chips)
Seat 3: 7H5WkGzGvsv56y1iaqHvRg ($44.55 in chips)
Seat 4: LjL3AIERHn559yyW1mTUYQ ($155.50 in chips)
Seat 5: iHo1oDbrEVJ8nEGdaPrICw ($102.70 in chips)
Seat 6: YfsTQsY/fxb+YqbdclTHuw ($51.25 in chips)
lsLuWlcPA3Rh7kJVLzMh0Q: posts small blind $0.50
RqgF7gRoKgRNW8Zoi1ty4A: posts big blind $1
*** HOLE CARDS ***
7H5WkGzGvsv56y1iaqHvRg: calls $1
LjL3AIERHn559yyW1mTUYQ: folds
iHo1oDbrEVJ8nEGdaPrICw: folds
YfsTQsY/fxb+YqbdclTHuw: calls $1
lsLuWlcPA3Rh7kJVLzMh0Q: folds
RqgF7gRoKgRNW8Zoi1ty4A: checks
*** FLOP *** [9c Ac 4s]
RqgF7gRoKgRNW8Zoi1ty4A: checks
7H5WkGzGvsv56y1iaqHvRg: checks
YfsTQsY/fxb+YqbdclTHuw: bets $3
RqgF7gRoKgRNW8Zoi1ty4A: folds
7H5WkGzGvsv56y1iaqHvRg: calls $3
*** TURN *** [9c Ac 4s] [Jc]
7H5WkGzGvsv56y1iaqHvRg: checks
YfsTQsY/fxb+YqbdclTHuw: bets $3
7H5WkGzGvsv56y1iaqHvRg: calls $3
*** RIVER *** [9c Ac 4s Jc] [As]
7H5WkGzGvsv56y1iaqHvRg: bets $5
YfsTQsY/fxb+YqbdclTHuw: calls $5
*** SHOW DOWN ***
7H5WkGzGvsv56y1iaqHvRg: shows [Ks 9d] (two pair, Aces and Nines)
YfsTQsY/fxb+YqbdclTHuw: shows [Ad 7c] (three of a kind, Aces)
YfsTQsY/fxb+YqbdclTHuw collected $24.30 from pot
*** SUMMARY ***
Total pot $25.50 | Rake $1.20
Board [9c Ac 4s Jc As]
Seat 1: lsLuWlcPA3Rh7kJVLzMh0Q (small blind) folded before Flop
Seat 2: RqgF7gRoKgRNW8Zoi1ty4A (big blind) folded on the Flop
Seat 3: 7H5WkGzGvsv56y1iaqHvRg showed [Ks 9d] and lost with two pair, Aces and Nines
Seat 4: LjL3AIERHn559yyW1mTUYQ folded before Flop (didn't bet)
Seat 5: iHo1oDbrEVJ8nEGdaPrICw folded before Flop (didn't bet)
Seat 6: YfsTQsY/fxb+YqbdclTHuw (button) showed [Ad 7c] and won ($24.30) with three of a kind, Aces



PokerStars Game #59939401956:  Hold'em No Limit ($0.50/$1.00) - 2009/07/01 0:38:56 ET
Table 'uNlePsyMIqzM691Xkrlk6Q' 9-max Seat #5 is the button
Seat 1: bLbSOSmSOnqE0iTcH/5dxA ($102.50 in chips)
Seat 2: +OqpStnt0FqbCfyHAWaLbg ($69.60 in chips)
Seat 3: h7qXkU57Bb8ZuPwMyxR8Ug ($9 in chips)
Seat 4: TZcz9MEWDA+WydgGruqqbw ($102.65 in chips)
Seat 5: 3obndzTJ6fECz8+wWhMd1w ($18.50 in chips)
Seat 6: uMPEfCcGCfsxmy53tVUMug ($111.10 in chips)
Seat 7: w6cw9nzN7AvkkHBVVjykoQ ($43.90 in chips)
Seat 8: OsLmX3x/19szSV115TpL/Q ($51.80 in chips)
Seat 9: vR4IO10geOgvTW+LAUBv/A ($115.30 in chips)
uMPEfCcGCfsxmy53tVUMug: posts small blind $0.50
w6cw9nzN7AvkkHBVVjykoQ: posts big blind $1
*** HOLE CARDS ***
OsLmX3x/19szSV115TpL/Q: calls $1
vR4IO10geOgvTW+LAUBv/A: raises $4 to $5
bLbSOSmSOnqE0iTcH/5dxA: folds
+OqpStnt0FqbCfyHAWaLbg: folds
h7qXkU57Bb8ZuPwMyxR8Ug: folds
TZcz9MEWDA+WydgGruqqbw: folds
3obndzTJ6fECz8+wWhMd1w: folds
uMPEfCcGCfsxmy53tVUMug: folds
w6cw9nzN7AvkkHBVVjykoQ: folds
OsLmX3x/19szSV115TpL/Q: calls $4
*** FLOP *** [5h Qh As]
OsLmX3x/19szSV115TpL/Q: checks
vR4IO10geOgvTW+LAUBv/A: bets $6
OsLmX3x/19szSV115TpL/Q: folds
vR4IO10geOgvTW+LAUBv/A collected $10.95 from pot
vR4IO10geOgvTW+LAUBv/A: doesn't show hand
*** SUMMARY ***
Total pot $11.50 | Rake $0.55
Board [5h Qh As]
Seat 1: bLbSOSmSOnqE0iTcH/5dxA folded before Flop (didn't bet)
Seat 2: +OqpStnt0FqbCfyHAWaLbg folded before Flop (didn't bet)
Seat 3: h7qXkU57Bb8ZuPwMyxR8Ug folded before Flop (didn't bet)
Seat 4: TZcz9MEWDA+WydgGruqqbw folded before Flop (didn't bet)
Seat 5: 3obndzTJ6fECz8+wWhMd1w (button) folded before Flop (didn't bet)
Seat 6: uMPEfCcGCfsxmy53tVUMug (small blind) folded before Flop
Seat 7: w6cw9nzN7AvkkHBVVjykoQ (big blind) folded before Flop
Seat 8: OsLmX3x/19szSV115TpL/Q folded on the Flop
Seat 9: vR4IO10geOgvTW+LAUBv/A collected ($10.95)



PokerStars Game #59939402310:  Hold'em No Limit ($0.50/$1.00) - 2009/07/01 0:38:57 ET
Table 'Evb7VW0qfDhFkbgBL3gcqQ' 2-max Seat #2 is the button
Seat 1: NYi6JFscYNrofSXy4sM+Yw ($101 in chips)
Seat 2: mJHc7tEZG3SVIX7QQjb5EQ ($38.50 in chips)
mJHc7tEZG3SVIX7QQjb5EQ: posts small blind $0.50
NYi6JFscYNrofSXy4sM+Yw: posts big blind $1
*** HOLE CARDS ***
mJHc7tEZG3SVIX7QQjb5EQ: raises $2 to $3
NYi6JFscYNrofSXy4sM+Yw: calls $2
*** FLOP *** [2h Kd 9d]
NYi6JFscYNrofSXy4sM+Yw: checks
mJHc7tEZG3SVIX7QQjb5EQ: checks
*** TURN *** [2h Kd 9d] [Ac]
NYi6JFscYNrofSXy4sM+Yw: bets $2
mJHc7tEZG3SVIX7QQjb5EQ: calls $2
*** RIVER *** [2h Kd 9d Ac] [4c]
NYi6JFscYNrofSXy4sM+Yw: checks
mJHc7tEZG3SVIX7QQjb5EQ: bets $3
NYi6JFscYNrofSXy4sM+Yw: folds
mJHc7tEZG3SVIX7QQjb5EQ collected $9.55 from pot
mJHc7tEZG3SVIX7QQjb5EQ: doesn't show hand
*** SUMMARY ***
Total pot $10 | Rake $0.45
Board [2h Kd 9d Ac 4c]
Seat 1: NYi6JFscYNrofSXy4sM+Yw (big blind) folded on the River
Seat 2: mJHc7tEZG3SVIX7QQjb5EQ (button) (small blind) collected ($9.55)



PokerStars Game #59939403362:  Hold'em No Limit ($0.50/$1.00) - 2009/07/01 0:38:58 ET
Table 'ZFWj23PMihdwrNWv41OG/Q' 9-max Seat #7 is the button
Seat 1: yAbu2QsRPVcjPbqlf/jDxw ($124.90 in chips)
Seat 2: ARfmgHcEUKh68laBZy4veA ($76.60 in chips)
Seat 3: G9Fo2TZCN7HI43Po4zSN3A ($118.70 in chips)
Seat 5: tkdBeXTJlFsZdioidNqLow ($102.30 in chips)
Seat 6: tjhwe1V98x2spSoUQER3HQ ($103 in chips)
Seat 7: wIZ377kjl2fHFGnS93o6bw ($20.30 in chips)
Seat 9: gIabaXO0Nq08nuXlf56f0w ($17.90 in chips)
amazinmets73 will be allowed to play after the button
gIabaXO0Nq08nuXlf56f0w: posts small blind $0.50
yAbu2QsRPVcjPbqlf/jDxw: posts big blind $1
barrelproof7: sits out
*** HOLE CARDS ***
ARfmgHcEUKh68laBZy4veA: calls $1
G9Fo2TZCN7HI43Po4zSN3A: folds
tkdBeXTJlFsZdioidNqLow: folds
tjhwe1V98x2spSoUQER3HQ: folds
wIZ377kjl2fHFGnS93o6bw: folds
gIabaXO0Nq08nuXlf56f0w: calls $0.50
yAbu2QsRPVcjPbqlf/jDxw: checks
*** FLOP *** [Kc Td 5d]
gIabaXO0Nq08nuXlf56f0w: checks
yAbu2QsRPVcjPbqlf/jDxw: checks
ARfmgHcEUKh68laBZy4veA: checks
*** TURN *** [Kc Td 5d] [4h]
gIabaXO0Nq08nuXlf56f0w: bets $2
yAbu2QsRPVcjPbqlf/jDxw: folds
ARfmgHcEUKh68laBZy4veA: folds
gIabaXO0Nq08nuXlf56f0w collected $2.85 from pot
gIabaXO0Nq08nuXlf56f0w: doesn't show hand
*** SUMMARY ***
Total pot $3 | Rake $0.15
Board [Kc Td 5d 4h]
Seat 1: yAbu2QsRPVcjPbqlf/jDxw (big blind) folded on the Turn
Seat 2: ARfmgHcEUKh68laBZy4veA folded on the Turn
Seat 3: G9Fo2TZCN7HI43Po4zSN3A folded before Flop (didn't bet)
Seat 5: tkdBeXTJlFsZdioidNqLow folded before Flop (didn't bet)
Seat 6: tjhwe1V98x2spSoUQER3HQ folded before Flop (didn't bet)
Seat 7: wIZ377kjl2fHFGnS93o6bw (button) folded before Flop (didn't bet)
Seat 9: gIabaXO0Nq08nuXlf56f0w (small blind) collected ($2.85)



PokerStars Game #59939403668:  Hold'em No Limit ($0.50/$1.00) - 2009/07/01 0:38:59 ET
Table 'pHrhryH8jPNdQfY62f8v+g' 6-max Seat #2 is the button
Seat 2: RqgF7gRoKgRNW8Zoi1ty4A ($113.50 in chips)
Seat 3: j0aDOn9Nft1HLTQvGu1UwA ($19 in chips)
Seat 4: wenbG7TaM3H7h5kn78OFNw ($53.80 in chips)
Seat 5: r1/R7y0Ortgoz4lccgW8VA ($37.65 in chips)
Seat 6: xAU6q2/cwmby2sxmA8VcmA ($108.75 in chips)
j0aDOn9Nft1HLTQvGu1UwA: posts small blind $0.50
wenbG7TaM3H7h5kn78OFNw: posts big blind $1
playt0i: sits out
*** HOLE CARDS ***
r1/R7y0Ortgoz4lccgW8VA: folds
xAU6q2/cwmby2sxmA8VcmA: folds
RqgF7gRoKgRNW8Zoi1ty4A: raises $2 to $3
j0aDOn9Nft1HLTQvGu1UwA: calls $2.50
wenbG7TaM3H7h5kn78OFNw: calls $2
*** FLOP *** [Jh 9d Th]
j0aDOn9Nft1HLTQvGu1UwA: bets $3
wenbG7TaM3H7h5kn78OFNw: calls $3
RqgF7gRoKgRNW8Zoi1ty4A: raises $16 to $19
j0aDOn9Nft1HLTQvGu1UwA: folds
wenbG7TaM3H7h5kn78OFNw: folds
RqgF7gRoKgRNW8Zoi1ty4A collected $17.15 from pot
*** SUMMARY ***
Total pot $18 | Rake $0.85
Board [Jh 9d Th]
Seat 2: RqgF7gRoKgRNW8Zoi1ty4A (button) collected ($17.15)
Seat 3: j0aDOn9Nft1HLTQvGu1UwA (small blind) folded on the Flop
Seat 4: wenbG7TaM3H7h5kn78OFNw (big blind) folded on the Flop
Seat 5: r1/R7y0Ortgoz4lccgW8VA folded before Flop (didn't bet)
Seat 6: xAU6q2/cwmby2sxmA8VcmA folded before Flop (didn't bet)



PokerStars Game #59939403990:  Hold'em No Limit ($0.50/$1.00) - 2009/07/01 0:38:59 ET
Table '/RZcOwpZpHQ+OwPwjsbnRw' 6-max Seat #2 is the button
Seat 1: Zboa6dColKGHBjLPUakZjw ($55.20 in chips)
Seat 2: +xW7QemQU0Fxs+4TnqBRow ($127.50 in chips)
Seat 4: j7NIOHLZk7V2o9fOioO5ug ($100 in chips)
Seat 5: wx3sQGkVi2x9wJXuWNHPBw ($198.15 in chips)
Seat 6: XOIf9W+VAxhZqN+SYoyMKA ($288.55 in chips)
j7NIOHLZk7V2o9fOioO5ug: posts small blind $0.50
wx3sQGkVi2x9wJXuWNHPBw: posts big blind $1
*** HOLE CARDS ***
XOIf9W+VAxhZqN+SYoyMKA: folds
Zboa6dColKGHBjLPUakZjw: folds
+xW7QemQU0Fxs+4TnqBRow: raises $2 to $3
j7NIOHLZk7V2o9fOioO5ug: folds
wx3sQGkVi2x9wJXuWNHPBw: folds
+xW7QemQU0Fxs+4TnqBRow collected $2.50 from pot
+xW7QemQU0Fxs+4TnqBRow: doesn't show hand
*** SUMMARY ***
Total pot $2.50 | Rake $0
Seat 1: Zboa6dColKGHBjLPUakZjw folded before Flop (didn't bet)
Seat 2: +xW7QemQU0Fxs+4TnqBRow (button) collected ($2.50)
Seat 4: j7NIOHLZk7V2o9fOioO5ug (small blind) folded before Flop
Seat 5: wx3sQGkVi2x9wJXuWNHPBw (big blind) folded before Flop
Seat 6: XOIf9W+VAxhZqN+SYoyMKA folded before Flop (didn't bet)



PokerStars Game #59939404744:  Hold'em No Limit ($0.50/$1.00) - 2009/07/01 0:39:01 ET
Table 'LmXQK9xy3awB+qsPzI21Mw' 2-max Seat #1 is the button
Seat 1: NYi6JFscYNrofSXy4sM+Yw ($242.25 in chips)
Seat 2: TME8GvochpQAo8cmJwWmvA ($96.65 in chips)
NYi6JFscYNrofSXy4sM+Yw: posts small blind $0.50
TME8GvochpQAo8cmJwWmvA: posts big blind $1
*** HOLE CARDS ***
NYi6JFscYNrofSXy4sM+Yw: raises $1 to $2
TME8GvochpQAo8cmJwWmvA: calls $1
*** FLOP *** [2c 2d Kd]
TME8GvochpQAo8cmJwWmvA: checks
NYi6JFscYNrofSXy4sM+Yw: bets $2
TME8GvochpQAo8cmJwWmvA: calls $2
*** TURN *** [2c 2d Kd] [7h]
TME8GvochpQAo8cmJwWmvA: checks
NYi6JFscYNrofSXy4sM+Yw: checks
*** RIVER *** [2c 2d Kd 7h] [9d]
TME8GvochpQAo8cmJwWmvA: bets $4
NYi6JFscYNrofSXy4sM+Yw: folds
TME8GvochpQAo8cmJwWmvA collected $7.65 from pot
TME8GvochpQAo8cmJwWmvA: doesn't show hand
*** SUMMARY ***
Total pot $8 | Rake $0.35
Board [2c 2d Kd 7h 9d]
Seat 1: NYi6JFscYNrofSXy4sM+Yw (button) (small blind) folded on the River
Seat 2: TME8GvochpQAo8cmJwWmvA (big blind) collected ($7.65)



PokerStars Game #59939405324:  Hold'em No Limit ($0.50/$1.00) - 2009/07/01 0:39:01 ET
Table 'QBLDswtHe7Ml0HwAdcMhlw' 2-max Seat #2 is the button
Seat 1: hdNlhiCwI533uwvvTTfC9Q ($101 in chips)
Seat 2: GBkvjkjDWVBEa1e14dh6CA ($65.50 in chips)
GBkvjkjDWVBEa1e14dh6CA: posts small blind $0.50
hdNlhiCwI533uwvvTTfC9Q: posts big blind $1
*** HOLE CARDS ***
GBkvjkjDWVBEa1e14dh6CA: raises $1 to $2
hdNlhiCwI533uwvvTTfC9Q: folds
GBkvjkjDWVBEa1e14dh6CA collected $2 from pot
GBkvjkjDWVBEa1e14dh6CA: doesn't show hand
*** SUMMARY ***
Total pot $2 | Rake $0
Seat 1: hdNlhiCwI533uwvvTTfC9Q (big blind) folded before Flop
Seat 2: GBkvjkjDWVBEa1e14dh6CA (button) (small blind) collected ($2)



PokerStars Game #59939407784:  Hold'em No Limit ($0.50/$1.00) - 2009/07/01 0:39:05 ET
Table 'rmZfTK+oSebeUPJNbWhdAA' 6-max Seat #3 is the button
Seat 1: xAU6q2/cwmby2sxmA8VcmA ($104.55 in chips)
Seat 2: z7O9PO/WEcqRouIydFhS9Q ($94 in chips)
Seat 3: 9yjOzGERLaEZS8CZ6YNHFg ($113.35 in chips)
Seat 4: OGMLOcTNYZXZU81au7ztUw ($133.50 in chips)
Seat 5: +xW7QemQU0Fxs+4TnqBRow ($100 in chips)
Seat 6: j7NIOHLZk7V2o9fOioO5ug ($132.50 in chips)
OGMLOcTNYZXZU81au7ztUw: posts small blind $0.50
+xW7QemQU0Fxs+4TnqBRow: posts big blind $1
*** HOLE CARDS ***
j7NIOHLZk7V2o9fOioO5ug: folds
xAU6q2/cwmby2sxmA8VcmA: folds
z7O9PO/WEcqRouIydFhS9Q: folds
9yjOzGERLaEZS8CZ6YNHFg: folds
OGMLOcTNYZXZU81au7ztUw: calls $0.50
+xW7QemQU0Fxs+4TnqBRow: raises $3 to $4
OGMLOcTNYZXZU81au7ztUw: folds
+xW7QemQU0Fxs+4TnqBRow collected $2 from pot
+xW7QemQU0Fxs+4TnqBRow: doesn't show hand
*** SUMMARY ***
Total pot $2 | Rake $0
Seat 1: xAU6q2/cwmby2sxmA8VcmA folded before Flop (didn't bet)
Seat 2: z7O9PO/WEcqRouIydFhS9Q folded before Flop (didn't bet)
Seat 3: 9yjOzGERLaEZS8CZ6YNHFg (button) folded before Flop (didn't bet)
Seat 4: OGMLOcTNYZXZU81au7ztUw (small blind) folded before Flop
Seat 5: +xW7QemQU0Fxs+4TnqBRow (big blind) collected ($2)
Seat 6: j7NIOHLZk7V2o9fOioO5ug folded before Flop (didn't bet)



PokerStars Game #59939407432:  Hold'em No Limit ($0.50/$1.00) - 2009/07/01 0:39:05 ET
Table 'VOs36P6NW+QyXeQ1B62kmA' 6-max Seat #6 is the button
Seat 1: AdLVjddOzm+sRNo1Bc3S6Q ($141.30 in chips)
Seat 2: KpnW5CcJ4Mg6MeclfKmLrw ($116.35 in chips)
Seat 3: TSuRyAHnUPCFjP7Z0rEE0w ($100 in chips)
Seat 4: w02zQzNydODiyV9THKgo9w ($36.80 in chips)
Seat 6: 6tvjsJrdmWg+g7FVrMnzXA ($60.50 in chips)
AdLVjddOzm+sRNo1Bc3S6Q: posts small blind $0.50
KpnW5CcJ4Mg6MeclfKmLrw: posts big blind $1
X7GlkHF+lkbarCLuZ4Uf0w: sits out
*** HOLE CARDS ***
TSuRyAHnUPCFjP7Z0rEE0w: folds
w02zQzNydODiyV9THKgo9w: folds
6tvjsJrdmWg+g7FVrMnzXA: folds
AdLVjddOzm+sRNo1Bc3S6Q: folds
KpnW5CcJ4Mg6MeclfKmLrw collected $1 from pot
KpnW5CcJ4Mg6MeclfKmLrw: doesn't show hand
*** SUMMARY ***
Total pot $1 | Rake $0
Seat 1: AdLVjddOzm+sRNo1Bc3S6Q (small blind) folded before Flop
Seat 2: KpnW5CcJ4Mg6MeclfKmLrw (big blind) collected ($1)
Seat 3: TSuRyAHnUPCFjP7Z0rEE0w folded before Flop (didn't bet)
Seat 4: w02zQzNydODiyV9THKgo9w folded before Flop (didn't bet)
Seat 6: 6tvjsJrdmWg+g7FVrMnzXA (button) folded before Flop (didn't bet)



PokerStars Game #59939408528:  Hold'em No Limit ($0.50/$1.00) - 2009/07/01 0:39:06 ET
Table '7Nl0ffnjeK44/vmeexh3MQ' 9-max Seat #4 is the button
Seat 1: s7D3Y+k4Cj4D1cXHv7oj+Q ($97.80 in chips)
Seat 2: kiakSwxX0e64PwYGAPQvLw ($31.85 in chips)
Seat 3: vR4IO10geOgvTW+LAUBv/A ($103 in chips)
Seat 4: bLbSOSmSOnqE0iTcH/5dxA ($100 in chips)
Seat 5: bL+QVeDcuEdzMGAGg2XJHg ($100 in chips)
Seat 6: FVs16t7GgfWgQWt4JxsObQ ($23.80 in chips)
Seat 8: zanka7aAZkigmZpfopXxxA ($232.20 in chips)
Seat 9: ouwUBGRKnKK9uhn1G4Lf+A ($95 in chips)
bL+QVeDcuEdzMGAGg2XJHg: posts small blind $0.50
FVs16t7GgfWgQWt4JxsObQ: posts big blind $1
amazinmets73: sits out
*** HOLE CARDS ***
zanka7aAZkigmZpfopXxxA: raises $2 to $3
ouwUBGRKnKK9uhn1G4Lf+A: folds
s7D3Y+k4Cj4D1cXHv7oj+Q: folds
kiakSwxX0e64PwYGAPQvLw: folds
vR4IO10geOgvTW+LAUBv/A: folds
bLbSOSmSOnqE0iTcH/5dxA: folds
bL+QVeDcuEdzMGAGg2XJHg: folds
FVs16t7GgfWgQWt4JxsObQ: calls $2
*** FLOP *** [5d As 3s]
FVs16t7GgfWgQWt4JxsObQ: checks
zanka7aAZkigmZpfopXxxA: bets $4
FVs16t7GgfWgQWt4JxsObQ: calls $4
*** TURN *** [5d As 3s] [Th]
FVs16t7GgfWgQWt4JxsObQ: checks
zanka7aAZkigmZpfopXxxA: bets $7
FVs16t7GgfWgQWt4JxsObQ: calls $7
*** RIVER *** [5d As 3s Th] [Td]
FVs16t7GgfWgQWt4JxsObQ: checks
zanka7aAZkigmZpfopXxxA: bets $9
FVs16t7GgfWgQWt4JxsObQ: raises $0.80 to $9.80 and is all-in
zanka7aAZkigmZpfopXxxA: calls $0.80
*** SHOW DOWN ***
FVs16t7GgfWgQWt4JxsObQ: shows [9s Ts] (three of a kind, Tens)
zanka7aAZkigmZpfopXxxA: shows [Tc Ah] (a full house, Tens full of Aces)
zanka7aAZkigmZpfopXxxA collected $45.80 from pot
*** SUMMARY ***
Total pot $48.10 | Rake $2.30
Board [5d As 3s Th Td]
Seat 1: s7D3Y+k4Cj4D1cXHv7oj+Q folded before Flop (didn't bet)
Seat 2: kiakSwxX0e64PwYGAPQvLw folded before Flop (didn't bet)
Seat 3: vR4IO10geOgvTW+LAUBv/A folded before Flop (didn't bet)
Seat 4: bLbSOSmSOnqE0iTcH/5dxA (button) folded before Flop (didn't bet)
Seat 5: bL+QVeDcuEdzMGAGg2XJHg (small blind) folded before Flop
Seat 6: FVs16t7GgfWgQWt4JxsObQ (big blind) showed [9s Ts] and lost with three of a kind, Tens
Seat 8: zanka7aAZkigmZpfopXxxA showed [Tc Ah] and won ($45.80) with a full house, Tens full of Aces
Seat 9: ouwUBGRKnKK9uhn1G4Lf+A folded before Flop (didn't bet)



PokerStars Game #59939409282:  Hold'em No Limit ($0.50/$1.00) - 2009/07/01 0:39:08 ET
Table 'GxCPo/gd3OSthkYrAxJngg' 6-max Seat #1 is the button
Seat 1: sH8BpAFP+jGFxCgVpD1Lew ($262.95 in chips)
Seat 2: YExX2paeIHrmfIwV1ivM/w ($77.20 in chips)
Seat 3: o6plE+MSW4XFNTeONe16xg ($34.10 in chips)
Seat 4: YMJG+F++3Aj6P8dAWda5fw ($108.15 in chips)
Seat 5: G5ZSSN6RSON3gkNvk/SmYg ($101.70 in chips)
Seat 6: sS9IXedL3MiRmpVXhAILhw ($101.95 in chips)
YExX2paeIHrmfIwV1ivM/w: posts small blind $0.50
o6plE+MSW4XFNTeONe16xg: posts big blind $1
*** HOLE CARDS ***
YMJG+F++3Aj6P8dAWda5fw: folds
G5ZSSN6RSON3gkNvk/SmYg: raises $3 to $4
sS9IXedL3MiRmpVXhAILhw: folds
sH8BpAFP+jGFxCgVpD1Lew: calls $4
YExX2paeIHrmfIwV1ivM/w: folds
o6plE+MSW4XFNTeONe16xg: folds
*** FLOP *** [8c Ah Ad]
G5ZSSN6RSON3gkNvk/SmYg: checks
sH8BpAFP+jGFxCgVpD1Lew: checks
*** TURN *** [8c Ah Ad] [Qd]
G5ZSSN6RSON3gkNvk/SmYg: bets $5
sH8BpAFP+jGFxCgVpD1Lew: calls $5
*** RIVER *** [8c Ah Ad Qd] [Js]
G5ZSSN6RSON3gkNvk/SmYg: checks
sH8BpAFP+jGFxCgVpD1Lew: checks
*** SHOW DOWN ***
G5ZSSN6RSON3gkNvk/SmYg: shows [Ks As] (three of a kind, Aces)
sH8BpAFP+jGFxCgVpD1Lew: mucks hand
G5ZSSN6RSON3gkNvk/SmYg collected $18.55 from pot
*** SUMMARY ***
Total pot $19.50 | Rake $0.95
Board [8c Ah Ad Qd Js]
Seat 1: sH8BpAFP+jGFxCgVpD1Lew (button) mucked
Seat 2: YExX2paeIHrmfIwV1ivM/w (small blind) folded before Flop
Seat 3: o6plE+MSW4XFNTeONe16xg (big blind) folded before Flop
Seat 4: YMJG+F++3Aj6P8dAWda5fw folded before Flop (didn't bet)
Seat 5: G5ZSSN6RSON3gkNvk/SmYg showed [Ks As] and won ($18.55) with three of a kind, Aces
Seat 6: sS9IXedL3MiRmpVXhAILhw folded before Flop (didn't bet)



PokerStars Game #59939409774:  Hold'em No Limit ($0.50/$1.00) - 2009/07/01 0:39:08 ET
Table 'cBDNutyLBKEk9+ptwsKmTw' 6-max Seat #6 is the button
Seat 1: xAU6q2/cwmby2sxmA8VcmA ($100 in chips)
Seat 2: Gy1fd4JyD1aNBFFlOGzbJQ ($26.85 in chips)
Seat 3: G5ZSSN6RSON3gkNvk/SmYg ($108.90 in chips)
Seat 4: 3q7F5QtzC30pSrn0nl9i+A ($23.30 in chips)
Seat 5: OGMLOcTNYZXZU81au7ztUw ($138.45 in chips)
Seat 6: NqVlOSH2lp+pp/TK3vvK5g ($43.20 in chips)
xAU6q2/cwmby2sxmA8VcmA: posts small blind $0.50
Gy1fd4JyD1aNBFFlOGzbJQ: posts big blind $1
*** HOLE CARDS ***
G5ZSSN6RSON3gkNvk/SmYg: folds
3q7F5QtzC30pSrn0nl9i+A: folds
OGMLOcTNYZXZU81au7ztUw: raises $2 to $3
NqVlOSH2lp+pp/TK3vvK5g: calls $3
xAU6q2/cwmby2sxmA8VcmA: folds
Gy1fd4JyD1aNBFFlOGzbJQ: calls $2
*** FLOP *** [4c 9s 7d]
Gy1fd4JyD1aNBFFlOGzbJQ: bets $10
OGMLOcTNYZXZU81au7ztUw: folds
NqVlOSH2lp+pp/TK3vvK5g: calls $10
*** TURN *** [4c 9s 7d] [Jh]
Gy1fd4JyD1aNBFFlOGzbJQ: bets $13.85 and is all-in
NqVlOSH2lp+pp/TK3vvK5g: calls $13.85
*** RIVER *** [4c 9s 7d Jh] [Td]
*** SHOW DOWN ***
Gy1fd4JyD1aNBFFlOGzbJQ: shows [7h 5h] (a pair of Sevens)
NqVlOSH2lp+pp/TK3vvK5g: shows [7c 9c] (two pair, Nines and Sevens)
NqVlOSH2lp+pp/TK3vvK5g collected $54.45 from pot
*** SUMMARY ***
Total pot $57.20 | Rake $2.75
Board [4c 9s 7d Jh Td]
Seat 1: xAU6q2/cwmby2sxmA8VcmA (small blind) folded before Flop
Seat 2: Gy1fd4JyD1aNBFFlOGzbJQ (big blind) showed [7h 5h] and lost with a pair of Sevens
Seat 3: G5ZSSN6RSON3gkNvk/SmYg folded before Flop (didn't bet)
Seat 4: 3q7F5QtzC30pSrn0nl9i+A folded before Flop (didn't bet)
Seat 5: OGMLOcTNYZXZU81au7ztUw folded on the Flop
Seat 6: NqVlOSH2lp+pp/TK3vvK5g (button) showed [7c 9c] and won ($54.45) with two pair, Nines and Sevens



PokerStars Game #59939410158:  Hold'em No Limit ($0.50/$1.00) - 2009/07/01 0:39:09 ET
Table 'QBLDswtHe7Ml0HwAdcMhlw' 2-max Seat #1 is the button
Seat 1: hdNlhiCwI533uwvvTTfC9Q ($100 in chips)
Seat 2: GBkvjkjDWVBEa1e14dh6CA ($66.50 in chips)
hdNlhiCwI533uwvvTTfC9Q: posts small blind $0.50
GBkvjkjDWVBEa1e14dh6CA: posts big blind $1
*** HOLE CARDS ***
hdNlhiCwI533uwvvTTfC9Q: raises $2 to $3
GBkvjkjDWVBEa1e14dh6CA: raises $8 to $11
hdNlhiCwI533uwvvTTfC9Q: folds
GBkvjkjDWVBEa1e14dh6CA collected $6 from pot
*** SUMMARY ***
Total pot $6 | Rake $0
Seat 1: hdNlhiCwI533uwvvTTfC9Q (button) (small blind) folded before Flop
Seat 2: GBkvjkjDWVBEa1e14dh6CA (big blind) collected ($6)



PokerStars Game #59939409894:  Hold'em No Limit ($0.50/$1.00) - 2009/07/01 0:39:09 ET
Table 'GPp0HyAuggN8oE0sUWzPpA' 9-max Seat #8 is the button
Seat 1: qJr25HAtvv1w/7IBvjMM3g ($39.35 in chips)
Seat 2: Ogn4JDV3mp4ZDKO49IFzKA ($18.50 in chips)
Seat 3: L9njYvloJ1NdXjP8edHEAg ($100 in chips)
Seat 4: mBRWbnUl8diyBO1qTJaNzw ($112.70 in chips)
Seat 5: 0fXz44fzDo5QmhAaJCvFfA ($20.80 in chips)
Seat 6: negfosHnGOZXSHpWDRKyBQ ($33.60 in chips)
Seat 8: tkdBeXTJlFsZdioidNqLow ($61.50 in chips)
craizer will be allowed to play after the button
qJr25HAtvv1w/7IBvjMM3g: posts small blind $0.50
Ogn4JDV3mp4ZDKO49IFzKA: posts big blind $1
Lizard K1ng: sits out
*** HOLE CARDS ***
L9njYvloJ1NdXjP8edHEAg: folds
mBRWbnUl8diyBO1qTJaNzw: folds
0fXz44fzDo5QmhAaJCvFfA: folds
negfosHnGOZXSHpWDRKyBQ: folds
tkdBeXTJlFsZdioidNqLow: raises $2 to $3
qJr25HAtvv1w/7IBvjMM3g: calls $2.50
Ogn4JDV3mp4ZDKO49IFzKA: folds
*** FLOP *** [7c 9c Jc]
qJr25HAtvv1w/7IBvjMM3g: checks
tkdBeXTJlFsZdioidNqLow: bets $4
qJr25HAtvv1w/7IBvjMM3g: folds
tkdBeXTJlFsZdioidNqLow collected $6.65 from pot
*** SUMMARY ***
Total pot $7 | Rake $0.35
Board [7c 9c Jc]
Seat 1: qJr25HAtvv1w/7IBvjMM3g (small blind) folded on the Flop
Seat 2: Ogn4JDV3mp4ZDKO49IFzKA (big blind) folded before Flop
Seat 3: L9njYvloJ1NdXjP8edHEAg folded before Flop (didn't bet)
Seat 4: mBRWbnUl8diyBO1qTJaNzw folded before Flop (didn't bet)
Seat 5: 0fXz44fzDo5QmhAaJCvFfA folded before Flop (didn't bet)
Seat 6: negfosHnGOZXSHpWDRKyBQ folded before Flop (didn't bet)
Seat 8: tkdBeXTJlFsZdioidNqLow (button) collected ($6.65)



PokerStars Game #59939410718:  Hold'em No Limit ($0.50/$1.00) - 2009/07/01 0:39:10 ET
Table '7O9fB8yx1u7sJveJn8w6jA' 6-max Seat #3 is the button
Seat 1: jy52+7FotjH63o5tEEVgKw ($119.40 in chips)
Seat 2: wx3sQGkVi2x9wJXuWNHPBw ($195.50 in chips)
Seat 3: hpxXcmRkXXI9HE5+5/j/0Q ($100 in chips)
Seat 5: BCEV3COoKY607AzLWayfRA ($101.60 in chips)
Seat 6: UBZQqpnJZdTYYY1FTb0rLA ($134.85 in chips)
bran42 will be allowed to play after the button
BCEV3COoKY607AzLWayfRA: posts small blind $0.50
UBZQqpnJZdTYYY1FTb0rLA: posts big blind $1
*** HOLE CARDS ***
jy52+7FotjH63o5tEEVgKw: calls $1
wx3sQGkVi2x9wJXuWNHPBw: folds
hpxXcmRkXXI9HE5+5/j/0Q: folds
BCEV3COoKY607AzLWayfRA: raises $4 to $5
UBZQqpnJZdTYYY1FTb0rLA: calls $4
jy52+7FotjH63o5tEEVgKw: calls $4
*** FLOP *** [7c Qc Jd]
BCEV3COoKY607AzLWayfRA: bets $11
UBZQqpnJZdTYYY1FTb0rLA: folds
jy52+7FotjH63o5tEEVgKw: folds
BCEV3COoKY607AzLWayfRA collected $14.25 from pot
BCEV3COoKY607AzLWayfRA: doesn't show hand
*** SUMMARY ***
Total pot $15 | Rake $0.75
Board [7c Qc Jd]
Seat 1: jy52+7FotjH63o5tEEVgKw folded on the Flop
Seat 2: wx3sQGkVi2x9wJXuWNHPBw folded before Flop (didn't bet)
Seat 3: hpxXcmRkXXI9HE5+5/j/0Q (button) folded before Flop (didn't bet)
Seat 5: BCEV3COoKY607AzLWayfRA (small blind) collected ($14.25)
Seat 6: UBZQqpnJZdTYYY1FTb0rLA (big blind) folded on the Flop



PokerStars Game #59939411840:  Hold'em No Limit ($0.50/$1.00) - 2009/07/01 0:39:12 ET
Table 'fTlPiCj0utgzC/5io+I7ew' 6-max Seat #6 is the button
Seat 1: YMJG+F++3Aj6P8dAWda5fw ($97.50 in chips)
Seat 2: Qy/UBNbD2HaA0Ogxg8Sf3w ($101.50 in chips)
Seat 3: oDiBRCaF0QVtd3kO6xZIXw ($89.60 in chips)
Seat 4: uJVSceLggtsrJya+WtmUEA ($97.30 in chips)
Seat 5: bFrTkDcWGTxyvNul7GVdYg ($255.20 in chips)
Seat 6: jMljU/dOPMXfJi8OmbdYdw ($60.70 in chips)
YMJG+F++3Aj6P8dAWda5fw: posts small blind $0.50
Qy/UBNbD2HaA0Ogxg8Sf3w: posts big blind $1
*** HOLE CARDS ***
oDiBRCaF0QVtd3kO6xZIXw: folds
uJVSceLggtsrJya+WtmUEA: raises $2 to $3
bFrTkDcWGTxyvNul7GVdYg: folds
jMljU/dOPMXfJi8OmbdYdw: folds
YMJG+F++3Aj6P8dAWda5fw: folds
Qy/UBNbD2HaA0Ogxg8Sf3w: folds
uJVSceLggtsrJya+WtmUEA collected $2.50 from pot
*** SUMMARY ***
Total pot $2.50 | Rake $0
Seat 1: YMJG+F++3Aj6P8dAWda5fw (small blind) folded before Flop
Seat 2: Qy/UBNbD2HaA0Ogxg8Sf3w (big blind) folded before Flop
Seat 3: oDiBRCaF0QVtd3kO6xZIXw folded before Flop (didn't bet)
Seat 4: uJVSceLggtsrJya+WtmUEA collected ($2.50)
Seat 5: bFrTkDcWGTxyvNul7GVdYg folded before Flop (didn't bet)
Seat 6: jMljU/dOPMXfJi8OmbdYdw (button) folded before Flop (didn't bet)



