PokerStars Game #59939412950:  Hold'em No Limit ($0.50/$1.00) - 2009/07/01 0:39:13 ET
Table 'eU3bWpDDg3Z+9R4m4iVmog' 6-max Seat #4 is the button
Seat 1: TSuRyAHnUPCFjP7Z0rEE0w ($186.10 in chips)
Seat 2: 8CAoOzhmB8n3nRFf3V4BTg ($125.80 in chips)
Seat 3: U6tnjwZRpTnM+YkqkCjwyQ ($168.15 in chips)
Seat 4: GDVIsbEJ/DOJsMKE4Asz0A ($83.60 in chips)
Seat 5: AdLVjddOzm+sRNo1Bc3S6Q ($100 in chips)
Seat 6: hpxXcmRkXXI9HE5+5/j/0Q ($109.45 in chips)
AdLVjddOzm+sRNo1Bc3S6Q: posts small blind $0.50
hpxXcmRkXXI9HE5+5/j/0Q: posts big blind $1
*** HOLE CARDS ***
TSuRyAHnUPCFjP7Z0rEE0w: raises $3 to $4
8CAoOzhmB8n3nRFf3V4BTg: folds
U6tnjwZRpTnM+YkqkCjwyQ: folds
GDVIsbEJ/DOJsMKE4Asz0A: folds
AdLVjddOzm+sRNo1Bc3S6Q: folds
hpxXcmRkXXI9HE5+5/j/0Q: folds
TSuRyAHnUPCFjP7Z0rEE0w collected $2.50 from pot
TSuRyAHnUPCFjP7Z0rEE0w: doesn't show hand
*** SUMMARY ***
Total pot $2.50 | Rake $0
Seat 1: TSuRyAHnUPCFjP7Z0rEE0w collected ($2.50)
Seat 2: 8CAoOzhmB8n3nRFf3V4BTg folded before Flop (didn't bet)
Seat 3: U6tnjwZRpTnM+YkqkCjwyQ folded before Flop (didn't bet)
Seat 4: GDVIsbEJ/DOJsMKE4Asz0A (button) folded before Flop (didn't bet)
Seat 5: AdLVjddOzm+sRNo1Bc3S6Q (small blind) folded before Flop
Seat 6: hpxXcmRkXXI9HE5+5/j/0Q (big blind) folded before Flop



PokerStars Game #59939412452:  Hold'em No Limit ($0.50/$1.00) - 2009/07/01 0:39:13 ET
Table '/RZcOwpZpHQ+OwPwjsbnRw' 6-max Seat #4 is the button
Seat 1: Zboa6dColKGHBjLPUakZjw ($55.20 in chips)
Seat 2: +xW7QemQU0Fxs+4TnqBRow ($129 in chips)
Seat 4: j7NIOHLZk7V2o9fOioO5ug ($100 in chips)
Seat 5: wx3sQGkVi2x9wJXuWNHPBw ($197.15 in chips)
Seat 6: XOIf9W+VAxhZqN+SYoyMKA ($288.55 in chips)
wx3sQGkVi2x9wJXuWNHPBw: posts small blind $0.50
XOIf9W+VAxhZqN+SYoyMKA: posts big blind $1
*** HOLE CARDS ***
Zboa6dColKGHBjLPUakZjw: folds
+xW7QemQU0Fxs+4TnqBRow: folds
j7NIOHLZk7V2o9fOioO5ug: folds
wx3sQGkVi2x9wJXuWNHPBw: folds
XOIf9W+VAxhZqN+SYoyMKA collected $1 from pot
XOIf9W+VAxhZqN+SYoyMKA: doesn't show hand
*** SUMMARY ***
Total pot $1 | Rake $0
Seat 1: Zboa6dColKGHBjLPUakZjw folded before Flop (didn't bet)
Seat 2: +xW7QemQU0Fxs+4TnqBRow folded before Flop (didn't bet)
Seat 4: j7NIOHLZk7V2o9fOioO5ug (button) folded before Flop (didn't bet)
Seat 5: wx3sQGkVi2x9wJXuWNHPBw (small blind) folded before Flop
Seat 6: XOIf9W+VAxhZqN+SYoyMKA (big blind) collected ($1)



PokerStars Game #59939413648:  Hold'em No Limit ($0.50/$1.00) - 2009/07/01 0:39:14 ET
Table 'tyUh+jyNvrceIQdKMJjQ2wZFWj23PMihdwrNWv41OG/Qeat #6 is the button
Seat 1: o8A5MUdudVKu+pAwgZOX2w ($233.45 in chips)
Seat 3: TalCiLYHCd+ffkmR3auPvA ($58 in chips)
Seat 4: TSuRyAHnUPCFjP7Z0rEE0w ($110.05 in chips)
Seat 5: j7NIOHLZk7V2o9fOioO5ug ($117.10 in chips)
Seat 6: YsLQ3BAvgQHWXMAv3Wv6Hg ($160.75 in chips)
o8A5MUdudVKu+pAwgZOX2w: posts small blind $0.50
TalCiLYHCd+ffkmR3auPvA: posts big blind $1
*** HOLE CARDS ***
TSuRyAHnUPCFjP7Z0rEE0w: raises $3 to $4
goodFolk leaves the table
j7NIOHLZk7V2o9fOioO5ug: calls $4
YsLQ3BAvgQHWXMAv3Wv6Hg: folds
o8A5MUdudVKu+pAwgZOX2w: calls $3.50
TalCiLYHCd+ffkmR3auPvA: calls $3
*** FLOP *** [Kh Ad 3d]
XvUbOIg94d25feWeQlOTVg joins the table at seat #2
o8A5MUdudVKu+pAwgZOX2w: checks
TalCiLYHCd+ffkmR3auPvA: checks
TSuRyAHnUPCFjP7Z0rEE0w: checks
j7NIOHLZk7V2o9fOioO5ug: checks
*** TURN *** [Kh Ad 3d] [4s]
o8A5MUdudVKu+pAwgZOX2w: checks
TalCiLYHCd+ffkmR3auPvA: checks
TSuRyAHnUPCFjP7Z0rEE0w: checks
j7NIOHLZk7V2o9fOioO5ug: checks
*** RIVER *** [Kh Ad 3d 4s] [Kc]
o8A5MUdudVKu+pAwgZOX2w: checks
TalCiLYHCd+ffkmR3auPvA: checks
TSuRyAHnUPCFjP7Z0rEE0w: checks
j7NIOHLZk7V2o9fOioO5ug: checks
*** SHOW DOWN ***
o8A5MUdudVKu+pAwgZOX2w: shows [5d 6h] (a pair of Kings)
TalCiLYHCd+ffkmR3auPvA: shows [Td 9d] (a pair of Kings - Ace+Ten kicker)
TSuRyAHnUPCFjP7Z0rEE0w: shows [Jc Th] (a pair of Kings - Ace+Jack kicker)
j7NIOHLZk7V2o9fOioO5ug: mucks hand
TSuRyAHnUPCFjP7Z0rEE0w collected $15.20 from pot
*** SUMMARY ***
Total pot $16 | Rake $0.80
Board [Kh Ad 3d 4s Kc]
Seat 1: o8A5MUdudVKu+pAwgZOX2w (small blind) showed [5d 6h] and lost with a pair of Kings
Seat 3: TalCiLYHCd+ffkmR3auPvA (big blind) showed [Td 9d] and lost with a pair of Kings
Seat 4: TSuRyAHnUPCFjP7Z0rEE0w showed [Jc Th] and won ($15.20) with a pair of Kings
Seat 5: j7NIOHLZk7V2o9fOioO5ug mucked
Seat 6: YsLQ3BAvgQHWXMAv3Wv6Hg (button) folded before Flop (didn't bet)



PokerStars Game #59939413300:  Hold'em No Limit ($0.50/$1.00) - 2009/07/01 0:39:14 ET
Table 'U9zqzC8f3oTJ2ShXFgSSOA' 6-max Seat #3 is the button
Seat 1: tS9JHB1h+FQ++qu8RwRNgg ($82.15 in chips)
Seat 2: U2CWBTv29qdCbj8RNF2sIw ($99.50 in chips)
Seat 3: yfXek8iJ7O4CFyqXrtGcfg ($12.05 in chips)
Seat 4: 33q95we0Etwgrm6guQGncw ($69.15 in chips)
Seat 5: KfwW5us6tydK81NYTtK1gw ($309.75 in chips)
Seat 6: aIxzFKdtpDSkUePKZy/niQ ($28.55 in chips)
33q95we0Etwgrm6guQGncw: posts small blind $0.50
KfwW5us6tydK81NYTtK1gw: posts big blind $1
*** HOLE CARDS ***
aIxzFKdtpDSkUePKZy/niQ: raises $2 to $3
tS9JHB1h+FQ++qu8RwRNgg: folds
U2CWBTv29qdCbj8RNF2sIw: folds
yfXek8iJ7O4CFyqXrtGcfg: folds
33q95we0Etwgrm6guQGncw: calls $2.50
KfwW5us6tydK81NYTtK1gw: raises $11 to $14
aIxzFKdtpDSkUePKZy/niQ: folds
33q95we0Etwgrm6guQGncw: calls $11
*** FLOP *** [7h 3c Kc]
33q95we0Etwgrm6guQGncw: bets $10
KfwW5us6tydK81NYTtK1gw: folds
33q95we0Etwgrm6guQGncw collected $29.45 from pot
*** SUMMARY ***
Total pot $31 | Rake $1.55
Board [7h 3c Kc]
Seat 1: tS9JHB1h+FQ++qu8RwRNgg folded before Flop (didn't bet)
Seat 2: U2CWBTv29qdCbj8RNF2sIw folded before Flop (didn't bet)
Seat 3: yfXek8iJ7O4CFyqXrtGcfg (button) folded before Flop (didn't bet)
Seat 4: 33q95we0Etwgrm6guQGncw (small blind) collected ($29.45)
Seat 5: KfwW5us6tydK81NYTtK1gw (big blind) folded on the Flop
Seat 6: aIxzFKdtpDSkUePKZy/niQ folded before Flop



PokerStars Game #59939414348:  Hold'em No Limit ($0.50/$1.00) - 2009/07/01 0:39:16 ET
Table 'FKpXUINE6M3UxHG4zaMhHA' 6-max Seat #4 is the button
Seat 1: qNezhXOOUXqwG7b9X5XJAA ($100 in chips)
Seat 2: nDKgwwXJ45hcJfJe01cdxQ ($37.10 in chips)
Seat 3: GOHDYcxP1gP29069kB9HFw ($118.85 in chips)
Seat 4: vw0eLNLy3Huccth4CUZNPQ ($74.30 in chips)
Seat 5: eUBBn2R56C1IQ6Cs/vitwg ($100 in chips)
Seat 6: b2a+5TkFf4xJN/Ihhma58Q ($15.90 in chips)
eUBBn2R56C1IQ6Cs/vitwg: posts small blind $0.50
b2a+5TkFf4xJN/Ihhma58Q: posts big blind $1
*** HOLE CARDS ***
qNezhXOOUXqwG7b9X5XJAA: folds
nDKgwwXJ45hcJfJe01cdxQ: raises $1 to $2
GOHDYcxP1gP29069kB9HFw: calls $2
vw0eLNLy3Huccth4CUZNPQ: folds
eUBBn2R56C1IQ6Cs/vitwg: folds
b2a+5TkFf4xJN/Ihhma58Q: calls $1
*** FLOP *** [6s 7d Td]
b2a+5TkFf4xJN/Ihhma58Q: checks
nDKgwwXJ45hcJfJe01cdxQ: checks
GOHDYcxP1gP29069kB9HFw: bets $4
b2a+5TkFf4xJN/Ihhma58Q: folds
nDKgwwXJ45hcJfJe01cdxQ: folds
GOHDYcxP1gP29069kB9HFw collected $6.20 from pot
GOHDYcxP1gP29069kB9HFw: doesn't show hand
*** SUMMARY ***
Total pot $6.50 | Rake $0.30
Board [6s 7d Td]
Seat 1: qNezhXOOUXqwG7b9X5XJAA folded before Flop (didn't bet)
Seat 2: nDKgwwXJ45hcJfJe01cdxQ folded on the Flop
Seat 3: GOHDYcxP1gP29069kB9HFw collected ($6.20)
Seat 4: vw0eLNLy3Huccth4CUZNPQ (button) folded before Flop (didn't bet)
Seat 5: eUBBn2R56C1IQ6Cs/vitwg (small blind) folded before Flop
Seat 6: b2a+5TkFf4xJN/Ihhma58Q (big blind) folded on the Flop



PokerStars Game #59939416396:  Hold'em No Limit ($0.50/$1.00) - 2009/07/01 0:39:19 ET
Table 'MUPc8FEpe/nR0BKSeReX6Q' 6-max Seat #3 is the button
Seat 1: YsLQ3BAvgQHWXMAv3Wv6Hg ($102.50 in chips)
Seat 2: xAU6q2/cwmby2sxmA8VcmA ($114.30 in chips)
Seat 3: wx3sQGkVi2x9wJXuWNHPBw ($232.55 in chips)
Seat 4: ZA1bp6g8IwtTxkUE4eCjDQ ($172.65 in chips)
Seat 5: UBZQqpnJZdTYYY1FTb0rLA ($100 in chips)
Seat 6: oxnw0GLLpFanjhGkxfRSqA ($59.50 in chips)
ZA1bp6g8IwtTxkUE4eCjDQ: posts small blind $0.50
UBZQqpnJZdTYYY1FTb0rLA: posts big blind $1
*** HOLE CARDS ***
oxnw0GLLpFanjhGkxfRSqA: folds
YsLQ3BAvgQHWXMAv3Wv6Hg: raises $3 to $4
xAU6q2/cwmby2sxmA8VcmA: folds
wx3sQGkVi2x9wJXuWNHPBw: folds
ZA1bp6g8IwtTxkUE4eCjDQ: folds
UBZQqpnJZdTYYY1FTb0rLA: folds
YsLQ3BAvgQHWXMAv3Wv6Hg collected $2.50 from pot
YsLQ3BAvgQHWXMAv3Wv6Hg: doesn't show hand
*** SUMMARY ***
Total pot $2.50 | Rake $0
Seat 1: YsLQ3BAvgQHWXMAv3Wv6Hg collected ($2.50)
Seat 2: xAU6q2/cwmby2sxmA8VcmA folded before Flop (didn't bet)
Seat 3: wx3sQGkVi2x9wJXuWNHPBw (button) folded before Flop (didn't bet)
Seat 4: ZA1bp6g8IwtTxkUE4eCjDQ (small blind) folded before Flop
Seat 5: UBZQqpnJZdTYYY1FTb0rLA (big blind) folded before Flop
Seat 6: oxnw0GLLpFanjhGkxfRSqA folded before Flop (didn't bet)



PokerStars Game #59939416656:  Hold'em No Limit ($0.50/$1.00) - 2009/07/01 0:39:19 ET
Table 'Zka9tv1yilg0MvXWPQrShg' 9-max Seat #6 is the button
Seat 1: TZcz9MEWDA+WydgGruqqbw ($115.35 in chips)
Seat 2: rR1qGAf9Q9RYorKYWH3VKw ($25.70 in chips)
Seat 3: gUUvmqdVlmvpal6B8nYrmg ($100 in chips)
Seat 4: CTOae+JLIGfwfXvhqHkP2w ($150.65 in chips)
Seat 5: /zy+DB4S5fUQUSfZWFzYGw ($151.40 in chips)
Seat 6: rY8wPoax1lS+HUY+I0FZDw ($143.80 in chips)
Seat 7: p1SafS90nb3Uft5LB0NkHw ($16 in chips)
Seat 8: bL+QVeDcuEdzMGAGg2XJHg ($119.10 in chips)
Seat 9: 6daxhj43mWj04MOPTOmaYA ($93 in chips)
p1SafS90nb3Uft5LB0NkHw: posts small blind $0.50
bL+QVeDcuEdzMGAGg2XJHg: posts big blind $1
*** HOLE CARDS ***
6daxhj43mWj04MOPTOmaYA: folds
TZcz9MEWDA+WydgGruqqbw: folds
rR1qGAf9Q9RYorKYWH3VKw: calls $1
gUUvmqdVlmvpal6B8nYrmg: folds
CTOae+JLIGfwfXvhqHkP2w: folds
/zy+DB4S5fUQUSfZWFzYGw: folds
rY8wPoax1lS+HUY+I0FZDw: raises $3 to $4
p1SafS90nb3Uft5LB0NkHw: folds
bL+QVeDcuEdzMGAGg2XJHg: folds
rR1qGAf9Q9RYorKYWH3VKw: folds
rY8wPoax1lS+HUY+I0FZDw collected $3.50 from pot
*** SUMMARY ***
Total pot $3.50 | Rake $0
Seat 1: TZcz9MEWDA+WydgGruqqbw folded before Flop (didn't bet)
Seat 2: rR1qGAf9Q9RYorKYWH3VKw folded before Flop
Seat 3: gUUvmqdVlmvpal6B8nYrmg folded before Flop (didn't bet)
Seat 4: CTOae+JLIGfwfXvhqHkP2w folded before Flop (didn't bet)
Seat 5: /zy+DB4S5fUQUSfZWFzYGw folded before Flop (didn't bet)
Seat 6: rY8wPoax1lS+HUY+I0FZDw (button) collected ($3.50)
Seat 7: p1SafS90nb3Uft5LB0NkHw (small blind) folded before Flop
Seat 8: bL+QVeDcuEdzMGAGg2XJHg (big blind) folded before Flop
Seat 9: 6daxhj43mWj04MOPTOmaYA folded before Flop (didn't bet)



PokerStars Game #59939416700:  Hold'em No Limit ($0.50/$1.00) - 2009/07/01 0:39:19 ET
Table 'VOs36P6NW+QyXeQ1B62kmA' 6-max Seat #1 is the button
Seat 1: AdLVjddOzm+sRNo1Bc3S6Q ($140.80 in chips)
Seat 2: KpnW5CcJ4Mg6MeclfKmLrw ($116.85 in chips)
Seat 3: TSuRyAHnUPCFjP7Z0rEE0w ($100 in chips)
Seat 4: w02zQzNydODiyV9THKgo9w ($36.80 in chips)
Seat 6: 6tvjsJrdmWg+g7FVrMnzXA ($60.50 in chips)
KpnW5CcJ4Mg6MeclfKmLrw: posts small blind $0.50
TSuRyAHnUPCFjP7Z0rEE0w: posts big blind $1
X7GlkHF+lkbarCLuZ4Uf0w: sits out
*** HOLE CARDS ***
w02zQzNydODiyV9THKgo9w: folds
6tvjsJrdmWg+g7FVrMnzXA: folds
AdLVjddOzm+sRNo1Bc3S6Q: folds
KpnW5CcJ4Mg6MeclfKmLrw: folds
TSuRyAHnUPCFjP7Z0rEE0w collected $1 from pot
TSuRyAHnUPCFjP7Z0rEE0w: doesn't show hand
*** SUMMARY ***
Total pot $1 | Rake $0
Seat 1: AdLVjddOzm+sRNo1Bc3S6Q (button) folded before Flop (didn't bet)
Seat 2: KpnW5CcJ4Mg6MeclfKmLrw (small blind) folded before Flop
Seat 3: TSuRyAHnUPCFjP7Z0rEE0w (big blind) collected ($1)
Seat 4: w02zQzNydODiyV9THKgo9w folded before Flop (didn't bet)
Seat 6: 6tvjsJrdmWg+g7FVrMnzXA folded before Flop (didn't bet)



PokerStars Game #59939417218:  Hold'em No Limit ($0.50/$1.00) - 2009/07/01 0:39:20 ET
Table 'QSIig7BLMc9wY/rgBechzw' 6-max Seat #3 is the button
Seat 1: uuA9hpFU17U5/t4cvpbpBg ($21.45 in chips)
Seat 3: +W6OnF033KNM2xH0fGj98Q ($106.20 in chips)
Seat 4: +uSzP8Jwnw7sKfQ4s66b7w ($56 in chips)
Seat 6: KpnW5CcJ4Mg6MeclfKmLrw ($185.60 in chips)
+uSzP8Jwnw7sKfQ4s66b7w: posts small blind $0.50
smartmoney8: is sitting out
KpnW5CcJ4Mg6MeclfKmLrw: posts big blind $1
*** HOLE CARDS ***
smartmoney8 leaves the table
uuA9hpFU17U5/t4cvpbpBg: folds
+W6OnF033KNM2xH0fGj98Q: folds
+uSzP8Jwnw7sKfQ4s66b7w: folds
KpnW5CcJ4Mg6MeclfKmLrw collected $1 from pot
KpnW5CcJ4Mg6MeclfKmLrw: doesn't show hand
*** SUMMARY ***
Total pot $1 | Rake $0
Seat 1: uuA9hpFU17U5/t4cvpbpBg folded before Flop (didn't bet)
Seat 3: +W6OnF033KNM2xH0fGj98Q (button) folded before Flop (didn't bet)
Seat 4: +uSzP8Jwnw7sKfQ4s66b7w (small blind) folded before Flop
Seat 6: KpnW5CcJ4Mg6MeclfKmLrw (big blind) collected ($1)



PokerStars Game #59939416976:  Hold'em No Limit ($0.50/$1.00) - 2009/07/01 0:39:20 ET
Table 'hugOjcwJvzEwZbK7tyiWuQ' 9-max Seat #4 is the button
Seat 1: N9n5Wc3s35DpCrOAUUNAaQ ($128.50 in chips)
Seat 2: r27C1nIV4NS4+qbnrgBQSw ($255.55 in chips)
Seat 3: jDwhY1kCdc6EkAHbT7PJMQ ($107.65 in chips)
Seat 4: UWB3oeddt/GObx2Mix2Anw ($210.25 in chips)
Seat 5: 5BRGWf+R3nt2WS3b5xX+zA ($23.80 in chips)
Seat 6: gUUvmqdVlmvpal6B8nYrmg ($100 in chips)
Seat 7: FL3MrLspcF23LYvC4ipBOA ($101.50 in chips)
Seat 8: /zy+DB4S5fUQUSfZWFzYGw ($105.75 in chips)
Seat 9: o6JyUkbzCDw8tUabqtmnlg ($61.20 in chips)
5BRGWf+R3nt2WS3b5xX+zA: posts small blind $0.50
gUUvmqdVlmvpal6B8nYrmg: posts big blind $1
*** HOLE CARDS ***
FL3MrLspcF23LYvC4ipBOA: folds
/zy+DB4S5fUQUSfZWFzYGw: folds
o6JyUkbzCDw8tUabqtmnlg: folds
N9n5Wc3s35DpCrOAUUNAaQ: folds
r27C1nIV4NS4+qbnrgBQSw: folds
jDwhY1kCdc6EkAHbT7PJMQ: folds
UWB3oeddt/GObx2Mix2Anw: raises $2 to $3
5BRGWf+R3nt2WS3b5xX+zA: folds
gUUvmqdVlmvpal6B8nYrmg: calls $2
*** FLOP *** [Ah 6h Ks]
gUUvmqdVlmvpal6B8nYrmg: checks
UWB3oeddt/GObx2Mix2Anw: bets $3
gUUvmqdVlmvpal6B8nYrmg: calls $3
*** TURN *** [Ah 6h Ks] [5s]
gUUvmqdVlmvpal6B8nYrmg: checks
UWB3oeddt/GObx2Mix2Anw: checks
*** RIVER *** [Ah 6h Ks 5s] [6s]
gUUvmqdVlmvpal6B8nYrmg: checks
UWB3oeddt/GObx2Mix2Anw: checks
*** SHOW DOWN ***
gUUvmqdVlmvpal6B8nYrmg: shows [9h Kh] (two pair, Kings and Sixes)
UWB3oeddt/GObx2Mix2Anw: mucks hand
gUUvmqdVlmvpal6B8nYrmg collected $11.90 from pot
*** SUMMARY ***
Total pot $12.50 | Rake $0.60
Board [Ah 6h Ks 5s 6s]
Seat 1: N9n5Wc3s35DpCrOAUUNAaQ folded before Flop (didn't bet)
Seat 2: r27C1nIV4NS4+qbnrgBQSw folded before Flop (didn't bet)
Seat 3: jDwhY1kCdc6EkAHbT7PJMQ folded before Flop (didn't bet)
Seat 4: UWB3oeddt/GObx2Mix2Anw (button) mucked
Seat 5: 5BRGWf+R3nt2WS3b5xX+zA (small blind) folded before Flop
Seat 6: gUUvmqdVlmvpal6B8nYrmg (big blind) showed [9h Kh] and won ($11.90) with two pair, Kings and Sixes
Seat 7: FL3MrLspcF23LYvC4ipBOA folded before Flop (didn't bet)
Seat 8: /zy+DB4S5fUQUSfZWFzYGw folded before Flop (didn't bet)
Seat 9: o6JyUkbzCDw8tUabqtmnlg folded before Flop (didn't bet)



PokerStars Game #59939417374:  Hold'em No Limit ($0.50/$1.00) - 2009/07/01 0:39:20 ET
Table 'Evb7VW0qfDhFkbgBL3gcqQ' 2-max Seat #1 is the button
Seat 1: NYi6JFscYNrofSXy4sM+Yw ($100 in chips)
Seat 2: mJHc7tEZG3SVIX7QQjb5EQ ($43.05 in chips)
NYi6JFscYNrofSXy4sM+Yw: posts small blind $0.50
mJHc7tEZG3SVIX7QQjb5EQ: posts big blind $1
*** HOLE CARDS ***
NYi6JFscYNrofSXy4sM+Yw: raises $2 to $3
mJHc7tEZG3SVIX7QQjb5EQ: calls $2
*** FLOP *** [5c 2s 9s]
mJHc7tEZG3SVIX7QQjb5EQ: checks
NYi6JFscYNrofSXy4sM+Yw: bets $3
mJHc7tEZG3SVIX7QQjb5EQ: calls $3
*** TURN *** [5c 2s 9s] [8s]
mJHc7tEZG3SVIX7QQjb5EQ: checks
NYi6JFscYNrofSXy4sM+Yw: checks
*** RIVER *** [5c 2s 9s 8s] [5s]
mJHc7tEZG3SVIX7QQjb5EQ: checks
NYi6JFscYNrofSXy4sM+Yw: checks
*** SHOW DOWN ***
mJHc7tEZG3SVIX7QQjb5EQ: shows [3d 3h] (two pair, Fives and Threes)
NYi6JFscYNrofSXy4sM+Yw: shows [4h 4d] (two pair, Fives and Fours)
NYi6JFscYNrofSXy4sM+Yw collected $11.50 from pot
*** SUMMARY ***
Total pot $12 | Rake $0.50
Board [5c 2s 9s 8s 5s]
Seat 1: NYi6JFscYNrofSXy4sM+Yw (button) (small blind) showed [4h 4d] and won ($11.50) with two pair, Fives and Fours
Seat 2: mJHc7tEZG3SVIX7QQjb5EQ (big blind) showed [3d 3h] and lost with two pair, Fives and Threes



PokerStars Game #59939419006:  Hold'em No Limit ($0.50/$1.00) - 2009/07/01 0:39:23 ET
Table 'N2bNCDHL96aCQDvZIh+yQQ' 6-max Seat #5 is the button
Seat 1: iHo1oDbrEVJ8nEGdaPrICw ($143.50 in chips)
Seat 2: KpnW5CcJ4Mg6MeclfKmLrw ($113.60 in chips)
Seat 3: Qy/UBNbD2HaA0Ogxg8Sf3w ($100 in chips)
Seat 4: uCqEjnxh2/vFBjKYkfTOkw ($172.40 in chips)
Seat 5: rHlMOfR7kpQQxe+PFQz0xQ ($30.75 in chips)
Seat 6: TSuRyAHnUPCFjP7Z0rEE0w ($100 in chips)
TSuRyAHnUPCFjP7Z0rEE0w: posts small blind $0.50
iHo1oDbrEVJ8nEGdaPrICw: posts big blind $1
*** HOLE CARDS ***
KpnW5CcJ4Mg6MeclfKmLrw: raises $3 to $4
Qy/UBNbD2HaA0Ogxg8Sf3w: folds
uCqEjnxh2/vFBjKYkfTOkw: folds
rHlMOfR7kpQQxe+PFQz0xQ: folds
TSuRyAHnUPCFjP7Z0rEE0w: folds
iHo1oDbrEVJ8nEGdaPrICw: folds
KpnW5CcJ4Mg6MeclfKmLrw collected $2.50 from pot
KpnW5CcJ4Mg6MeclfKmLrw: doesn't show hand
*** SUMMARY ***
Total pot $2.50 | Rake $0
Seat 1: iHo1oDbrEVJ8nEGdaPrICw (big blind) folded before Flop
Seat 2: KpnW5CcJ4Mg6MeclfKmLrw collected ($2.50)
Seat 3: Qy/UBNbD2HaA0Ogxg8Sf3w folded before Flop (didn't bet)
Seat 4: uCqEjnxh2/vFBjKYkfTOkw folded before Flop (didn't bet)
Seat 5: rHlMOfR7kpQQxe+PFQz0xQ (button) folded before Flop (didn't bet)
Seat 6: TSuRyAHnUPCFjP7Z0rEE0w (small blind) folded before Flop



PokerStars Game #59939420054:  Hold'em No Limit ($0.50/$1.00) - 2009/07/01 0:39:25 ET
Table 'LmXQK9xy3awB+qsPzI21Mw' 2-max Seat #2 is the button
Seat 1: NYi6JFscYNrofSXy4sM+Yw ($238.25 in chips)
Seat 2: TME8GvochpQAo8cmJwWmvA ($100.30 in chips)
TME8GvochpQAo8cmJwWmvA: posts small blind $0.50
NYi6JFscYNrofSXy4sM+Yw: posts big blind $1
*** HOLE CARDS ***
TME8GvochpQAo8cmJwWmvA: calls $0.50
NYi6JFscYNrofSXy4sM+Yw: checks
*** FLOP *** [4h 2c Qs]
NYi6JFscYNrofSXy4sM+Yw: checks
TME8GvochpQAo8cmJwWmvA: bets $2
NYi6JFscYNrofSXy4sM+Yw: folds
TME8GvochpQAo8cmJwWmvA collected $1.90 from pot
TME8GvochpQAo8cmJwWmvA: doesn't show hand
*** SUMMARY ***
Total pot $2 | Rake $0.10
Board [4h 2c Qs]
Seat 1: NYi6JFscYNrofSXy4sM+Yw (big blind) folded on the Flop
Seat 2: TME8GvochpQAo8cmJwWmvA (button) (small blind) collected ($1.90)



PokerStars Game #59939420978:  Hold'em No Limit ($0.50/$1.00) - 2009/07/01 0:39:26 ET
Table 'QBLDswtHe7Ml0HwAdcMhlw' 2-max Seat #2 is the button
Seat 1: hdNlhiCwI533uwvvTTfC9Q ($100 in chips)
Seat 2: GBkvjkjDWVBEa1e14dh6CA ($69.50 in chips)
GBkvjkjDWVBEa1e14dh6CA: posts small blind $0.50
hdNlhiCwI533uwvvTTfC9Q: posts big blind $1
*** HOLE CARDS ***
GBkvjkjDWVBEa1e14dh6CA: folds
hdNlhiCwI533uwvvTTfC9Q collected $1 from pot
hdNlhiCwI533uwvvTTfC9Q: doesn't show hand
*** SUMMARY ***
Total pot $1 | Rake $0
Seat 1: hdNlhiCwI533uwvvTTfC9Q (big blind) collected ($1)
Seat 2: GBkvjkjDWVBEa1e14dh6CA (button) (small blind) folded before Flop



PokerStars Game #59939421980:  Hold'em No Limit ($0.50/$1.00) - 2009/07/01 0:39:28 ET
Table 'eU3bWpDDg3Z+9R4m4iVmog' 6-max Seat #5 is the button
Seat 1: TSuRyAHnUPCFjP7Z0rEE0w ($187.60 in chips)
Seat 2: 8CAoOzhmB8n3nRFf3V4BTg ($125.80 in chips)
Seat 3: U6tnjwZRpTnM+YkqkCjwyQ ($168.15 in chips)
Seat 4: GDVIsbEJ/DOJsMKE4Asz0A ($83.60 in chips)
Seat 5: AdLVjddOzm+sRNo1Bc3S6Q ($100 in chips)
Seat 6: hpxXcmRkXXI9HE5+5/j/0Q ($108.45 in chips)
hpxXcmRkXXI9HE5+5/j/0Q: posts small blind $0.50
TSuRyAHnUPCFjP7Z0rEE0w: posts big blind $1
*** HOLE CARDS ***
8CAoOzhmB8n3nRFf3V4BTg: calls $1
U6tnjwZRpTnM+YkqkCjwyQ: folds
GDVIsbEJ/DOJsMKE4Asz0A: raises $3 to $4
AdLVjddOzm+sRNo1Bc3S6Q: folds
hpxXcmRkXXI9HE5+5/j/0Q: calls $3.50
TSuRyAHnUPCFjP7Z0rEE0w: folds
8CAoOzhmB8n3nRFf3V4BTg: calls $3
*** FLOP *** [Td 3d 3s]
hpxXcmRkXXI9HE5+5/j/0Q: checks
8CAoOzhmB8n3nRFf3V4BTg: checks
GDVIsbEJ/DOJsMKE4Asz0A: bets $4
hpxXcmRkXXI9HE5+5/j/0Q: calls $4
8CAoOzhmB8n3nRFf3V4BTg: folds
*** TURN *** [Td 3d 3s] [Kd]
hpxXcmRkXXI9HE5+5/j/0Q: checks
GDVIsbEJ/DOJsMKE4Asz0A: checks
*** RIVER *** [Td 3d 3s Kd] [Tc]
hpxXcmRkXXI9HE5+5/j/0Q: checks
GDVIsbEJ/DOJsMKE4Asz0A: checks
*** SHOW DOWN ***
hpxXcmRkXXI9HE5+5/j/0Q: shows [Jh Jc] (two pair, Jacks and Tens)
GDVIsbEJ/DOJsMKE4Asz0A: mucks hand
hpxXcmRkXXI9HE5+5/j/0Q collected $20 from pot
*** SUMMARY ***
Total pot $21 | Rake $1
Board [Td 3d 3s Kd Tc]
Seat 1: TSuRyAHnUPCFjP7Z0rEE0w (big blind) folded before Flop
Seat 2: 8CAoOzhmB8n3nRFf3V4BTg folded on the Flop
Seat 3: U6tnjwZRpTnM+YkqkCjwyQ folded before Flop (didn't bet)
Seat 4: GDVIsbEJ/DOJsMKE4Asz0A mucked
Seat 5: AdLVjddOzm+sRNo1Bc3S6Q (button) folded before Flop (didn't bet)
Seat 6: hpxXcmRkXXI9HE5+5/j/0Q (small blind) showed [Jh Jc] and won ($20) with two pair, Jacks and Tens



PokerStars Game #59939423376:  Hold'em No Limit ($0.50/$1.00) - 2009/07/01 0:39:30 ET
Table 'SQLOQoANiHscJ8AL7zffbw' 9-max Seat #4 is the button
Seat 1: jPTRd6SpCp4xqAy2XQiTOw ($112 in chips)
Seat 2: /zy+DB4S5fUQUSfZWFzYGw ($276.35 in chips)
Seat 3: 0eFnow7+D7veCYQ+CG9FFw ($83.90 in chips)
Seat 4: N9n5Wc3s35DpCrOAUUNAaQ ($92.35 in chips)
Seat 5: L9njYvloJ1NdXjP8edHEAg ($106.05 in chips)
Seat 6: p5UKaxVobvptF0ANhR/q1A ($176 in chips)
Seat 7: bJckevFOcg//s0qyMQI6sQ ($100 in chips)
Seat 9: qJr25HAtvv1w/7IBvjMM3g ($236.75 in chips)
L9njYvloJ1NdXjP8edHEAg: posts small blind $0.50
p5UKaxVobvptF0ANhR/q1A: posts big blind $1
Pp/KTcXkfZKKUHkjyaLTdg: sits out
*** HOLE CARDS ***
bJckevFOcg//s0qyMQI6sQ: raises $3 to $4
qJr25HAtvv1w/7IBvjMM3g: calls $4
jPTRd6SpCp4xqAy2XQiTOw: calls $4
/zy+DB4S5fUQUSfZWFzYGw: folds
0eFnow7+D7veCYQ+CG9FFw: calls $4
N9n5Wc3s35DpCrOAUUNAaQ: folds
L9njYvloJ1NdXjP8edHEAg: folds
p5UKaxVobvptF0ANhR/q1A: folds
*** FLOP *** [Td 3s 8c]
bJckevFOcg//s0qyMQI6sQ: bets $11
qJr25HAtvv1w/7IBvjMM3g: folds
jPTRd6SpCp4xqAy2XQiTOw: calls $11
0eFnow7+D7veCYQ+CG9FFw: folds
*** TURN *** [Td 3s 8c] [4c]
bJckevFOcg//s0qyMQI6sQ: checks
jPTRd6SpCp4xqAy2XQiTOw: bets $30
bJckevFOcg//s0qyMQI6sQ: folds
jPTRd6SpCp4xqAy2XQiTOw collected $37.60 from pot
jPTRd6SpCp4xqAy2XQiTOw: doesn't show hand
p5UKaxVobvptF0ANhR/q1A said, "hahahah rock"
*** SUMMARY ***
Total pot $39.50 | Rake $1.90
Board [Td 3s 8c 4c]
Seat 1: jPTRd6SpCp4xqAy2XQiTOw collected ($37.60)
Seat 2: /zy+DB4S5fUQUSfZWFzYGw folded before Flop (didn't bet)
Seat 3: 0eFnow7+D7veCYQ+CG9FFw folded on the Flop
Seat 4: N9n5Wc3s35DpCrOAUUNAaQ (button) folded before Flop (didn't bet)
Seat 5: L9njYvloJ1NdXjP8edHEAg (small blind) folded before Flop
Seat 6: p5UKaxVobvptF0ANhR/q1A (big blind) folded before Flop
Seat 7: bJckevFOcg//s0qyMQI6sQ folded on the Turn
Seat 9: qJr25HAtvv1w/7IBvjMM3g folded on the Flop



PokerStars Game #59939425554:  Hold'em No Limit ($0.50/$1.00) - 2009/07/01 0:39:33 ET
Table 'QBLDswtHe7Ml0HwAdcMhlw' 2-max Seat #1 is the button
Seat 1: hdNlhiCwI533uwvvTTfC9Q ($100.50 in chips)
Seat 2: GBkvjkjDWVBEa1e14dh6CA ($69 in chips)
hdNlhiCwI533uwvvTTfC9Q: posts small blind $0.50
GBkvjkjDWVBEa1e14dh6CA: posts big blind $1
*** HOLE CARDS ***
hdNlhiCwI533uwvvTTfC9Q: raises $2 to $3
GBkvjkjDWVBEa1e14dh6CA: calls $2
*** FLOP *** [Kh 8h Jh]
GBkvjkjDWVBEa1e14dh6CA: checks
hdNlhiCwI533uwvvTTfC9Q: bets $3
GBkvjkjDWVBEa1e14dh6CA: raises $4 to $7
hdNlhiCwI533uwvvTTfC9Q: calls $4
*** TURN *** [Kh 8h Jh] [2h]
GBkvjkjDWVBEa1e14dh6CA: bets $9
hdNlhiCwI533uwvvTTfC9Q: calls $9
*** RIVER *** [Kh 8h Jh 2h] [Ah]
GBkvjkjDWVBEa1e14dh6CA: checks
hdNlhiCwI533uwvvTTfC9Q: bets $81.50 and is all-in
hdNlhiCwI533uwvvTTfC9Q said, "zzz"
GBkvjkjDWVBEa1e14dh6CA: folds
hdNlhiCwI533uwvvTTfC9Q collected $37.50 from pot
hdNlhiCwI533uwvvTTfC9Q: doesn't show hand
*** SUMMARY ***
Total pot $38 | Rake $0.50
Board [Kh 8h Jh 2h Ah]
Seat 1: hdNlhiCwI533uwvvTTfC9Q (button) (small blind) collected ($37.50)
Seat 2: GBkvjkjDWVBEa1e14dh6CA (big blind) folded on the River



PokerStars Game #59939426538:  Hold'em No Limit ($0.50/$1.00) - 2009/07/01 0:39:34 ET
Table 'QSIig7BLMc9wY/rgBechzw' 6-max Seat #4 is the button
Seat 1: uuA9hpFU17U5/t4cvpbpBg ($21.45 in chips)
Seat 3: +W6OnF033KNM2xH0fGj98Q ($106.20 in chips)
Seat 4: +uSzP8Jwnw7sKfQ4s66b7w ($55.50 in chips)
Seat 6: KpnW5CcJ4Mg6MeclfKmLrw ($186.10 in chips)
KpnW5CcJ4Mg6MeclfKmLrw: posts small blind $0.50
uuA9hpFU17U5/t4cvpbpBg: posts big blind $1
*** HOLE CARDS ***
+W6OnF033KNM2xH0fGj98Q: folds
+W6OnF033KNM2xH0fGj98Q leaves the table
+uSzP8Jwnw7sKfQ4s66b7w: raises $3 to $4
KpnW5CcJ4Mg6MeclfKmLrw: folds
uuA9hpFU17U5/t4cvpbpBg: folds
+uSzP8Jwnw7sKfQ4s66b7w collected $2.50 from pot
*** SUMMARY ***
Total pot $2.50 | Rake $0
Seat 1: uuA9hpFU17U5/t4cvpbpBg (big blind) folded before Flop
Seat 3: +W6OnF033KNM2xH0fGj98Q folded before Flop (didn't bet)
Seat 4: +uSzP8Jwnw7sKfQ4s66b7w (button) collected ($2.50)
Seat 6: KpnW5CcJ4Mg6MeclfKmLrw (small blind) folded before Flop



PokerStars Game #59939427146:  Hold'em No Limit ($0.50/$1.00) - 2009/07/01 0:39:35 ET
Table 'fTlPiCj0utgzC/5io+I7ew' 6-max Seat #1 is the button
Seat 1: YMJG+F++3Aj6P8dAWda5fw ($97 in chips)
Seat 2: Qy/UBNbD2HaA0Ogxg8Sf3w ($100.50 in chips)
Seat 3: oDiBRCaF0QVtd3kO6xZIXw ($89.60 in chips)
Seat 4: uJVSceLggtsrJya+WtmUEA ($98.80 in chips)
Seat 5: bFrTkDcWGTxyvNul7GVdYg ($255.20 in chips)
Seat 6: jMljU/dOPMXfJi8OmbdYdw ($60.70 in chips)
Qy/UBNbD2HaA0Ogxg8Sf3w: posts small blind $0.50
oDiBRCaF0QVtd3kO6xZIXw: posts big blind $1
*** HOLE CARDS ***
uJVSceLggtsrJya+WtmUEA: folds
bFrTkDcWGTxyvNul7GVdYg: raises $2 to $3
jMljU/dOPMXfJi8OmbdYdw: folds
YMJG+F++3Aj6P8dAWda5fw: folds
Qy/UBNbD2HaA0Ogxg8Sf3w: folds
oDiBRCaF0QVtd3kO6xZIXw: folds
bFrTkDcWGTxyvNul7GVdYg collected $2.50 from pot
*** SUMMARY ***
Total pot $2.50 | Rake $0
Seat 1: YMJG+F++3Aj6P8dAWda5fw (button) folded before Flop (didn't bet)
Seat 2: Qy/UBNbD2HaA0Ogxg8Sf3w (small blind) folded before Flop
Seat 3: oDiBRCaF0QVtd3kO6xZIXw (big blind) folded before Flop
Seat 4: uJVSceLggtsrJya+WtmUEA folded before Flop (didn't bet)
Seat 5: bFrTkDcWGTxyvNul7GVdYg collected ($2.50)
Seat 6: jMljU/dOPMXfJi8OmbdYdw folded before Flop (didn't bet)



PokerStars Game #59939428074:  Hold'em No Limit ($0.50/$1.00) - 2009/07/01 0:39:37 ET
Table 'rmZfTK+oSebeUPJNbWhdAA' 6-max Seat #4 is the button
Seat 1: xAU6q2/cwmby2sxmA8VcmA ($104.55 in chips)
Seat 2: z7O9PO/WEcqRouIydFhS9Q ($94 in chips)
Seat 3: 9yjOzGERLaEZS8CZ6YNHFg ($113.35 in chips)
Seat 4: OGMLOcTNYZXZU81au7ztUw ($132.50 in chips)
Seat 5: +xW7QemQU0Fxs+4TnqBRow ($101 in chips)
Seat 6: j7NIOHLZk7V2o9fOioO5ug ($132.50 in chips)
+xW7QemQU0Fxs+4TnqBRow: posts small blind $0.50
j7NIOHLZk7V2o9fOioO5ug: posts big blind $1
*** HOLE CARDS ***
xAU6q2/cwmby2sxmA8VcmA: folds
z7O9PO/WEcqRouIydFhS9Q: folds
9yjOzGERLaEZS8CZ6YNHFg: folds
OGMLOcTNYZXZU81au7ztUw: raises $2 to $3
+xW7QemQU0Fxs+4TnqBRow: folds
j7NIOHLZk7V2o9fOioO5ug: folds
OGMLOcTNYZXZU81au7ztUw collected $2.50 from pot
OGMLOcTNYZXZU81au7ztUw: doesn't show hand
*** SUMMARY ***
Total pot $2.50 | Rake $0
Seat 1: xAU6q2/cwmby2sxmA8VcmA folded before Flop (didn't bet)
Seat 2: z7O9PO/WEcqRouIydFhS9Q folded before Flop (didn't bet)
Seat 3: 9yjOzGERLaEZS8CZ6YNHFg folded before Flop (didn't bet)
Seat 4: OGMLOcTNYZXZU81au7ztUw (button) collected ($2.50)
Seat 5: +xW7QemQU0Fxs+4TnqBRow (small blind) folded before Flop
Seat 6: j7NIOHLZk7V2o9fOioO5ug (big blind) folded before Flop



PokerStars Game #59939429444:  Hold'em No Limit ($0.50/$1.00) - 2009/07/01 0:39:39 ET
Table '/RZcOwpZpHQ+OwPwjsbnRw' 6-max Seat #5 is the button
Seat 1: Zboa6dColKGHBjLPUakZjw ($55.20 in chips)
Seat 2: +xW7QemQU0Fxs+4TnqBRow ($129 in chips)
Seat 4: j7NIOHLZk7V2o9fOioO5ug ($100 in chips)
Seat 5: wx3sQGkVi2x9wJXuWNHPBw ($196.65 in chips)
Seat 6: XOIf9W+VAxhZqN+SYoyMKA ($289.05 in chips)
XOIf9W+VAxhZqN+SYoyMKA: posts small blind $0.50
Zboa6dColKGHBjLPUakZjw: posts big blind $1
*** HOLE CARDS ***
+xW7QemQU0Fxs+4TnqBRow: folds
j7NIOHLZk7V2o9fOioO5ug: folds
wx3sQGkVi2x9wJXuWNHPBw: folds
XOIf9W+VAxhZqN+SYoyMKA: folds
Zboa6dColKGHBjLPUakZjw collected $1 from pot
*** SUMMARY ***
Total pot $1 | Rake $0
Seat 1: Zboa6dColKGHBjLPUakZjw (big blind) collected ($1)
Seat 2: +xW7QemQU0Fxs+4TnqBRow folded before Flop (didn't bet)
Seat 4: j7NIOHLZk7V2o9fOioO5ug folded before Flop (didn't bet)
Seat 5: wx3sQGkVi2x9wJXuWNHPBw (button) folded before Flop (didn't bet)
Seat 6: XOIf9W+VAxhZqN+SYoyMKA (small blind) folded before Flop



PokerStars Game #59939430386:  Hold'em No Limit ($0.50/$1.00) - 2009/07/01 0:39:40 ET
Table 'Evb7VW0qfDhFkbgBL3gcqQ' 2-max Seat #2 is the button
Seat 1: NYi6JFscYNrofSXy4sM+Yw ($105.50 in chips)
Seat 2: mJHc7tEZG3SVIX7QQjb5EQ ($37.05 in chips)
mJHc7tEZG3SVIX7QQjb5EQ: posts small blind $0.50
NYi6JFscYNrofSXy4sM+Yw: posts big blind $1
*** HOLE CARDS ***
mJHc7tEZG3SVIX7QQjb5EQ: raises $1 to $2
NYi6JFscYNrofSXy4sM+Yw: folds
mJHc7tEZG3SVIX7QQjb5EQ collected $2 from pot
mJHc7tEZG3SVIX7QQjb5EQ: doesn't show hand
*** SUMMARY ***
Total pot $2 | Rake $0
Seat 1: NYi6JFscYNrofSXy4sM+Yw (big blind) folded before Flop
Seat 2: mJHc7tEZG3SVIX7QQjb5EQ (button) (small blind) collected ($2)



PokerStars Game #59939430666:  Hold'em No Limit ($0.50/$1.00) - 2009/07/01 0:39:41 ET
Table 'LmXQK9xy3awB+qsPzI21Mw' 2-max Seat #1 is the button
Seat 1: NYi6JFscYNrofSXy4sM+Yw ($237.25 in chips)
Seat 2: TME8GvochpQAo8cmJwWmvA ($101.20 in chips)
NYi6JFscYNrofSXy4sM+Yw: posts small blind $0.50
TME8GvochpQAo8cmJwWmvA: posts big blind $1
*** HOLE CARDS ***
NYi6JFscYNrofSXy4sM+Yw: raises $2 to $3
TME8GvochpQAo8cmJwWmvA: calls $2
*** FLOP *** [Kh 7h Jc]
TME8GvochpQAo8cmJwWmvA: checks
NYi6JFscYNrofSXy4sM+Yw: bets $3
TME8GvochpQAo8cmJwWmvA: calls $3
*** TURN *** [Kh 7h Jc] [5c]
TME8GvochpQAo8cmJwWmvA: checks
NYi6JFscYNrofSXy4sM+Yw: checks
*** RIVER *** [Kh 7h Jc 5c] [6h]
TME8GvochpQAo8cmJwWmvA: bets $3
NYi6JFscYNrofSXy4sM+Yw: raises $8 to $11
TME8GvochpQAo8cmJwWmvA: folds
NYi6JFscYNrofSXy4sM+Yw collected $17.50 from pot
*** SUMMARY ***
Total pot $18 | Rake $0.50
Board [Kh 7h Jc 5c 6h]
Seat 1: NYi6JFscYNrofSXy4sM+Yw (button) (small blind) collected ($17.50)
Seat 2: TME8GvochpQAo8cmJwWmvA (big blind) folded on the River



PokerStars Game #59939430890:  Hold'em No Limit ($0.50/$1.00) - 2009/07/01 0:39:41 ET
Table 'VOs36P6NW+QyXeQ1B62kmA' 6-max Seat #2 is the button
Seat 1: AdLVjddOzm+sRNo1Bc3S6Q ($140.80 in chips)
Seat 2: KpnW5CcJ4Mg6MeclfKmLrw ($116.35 in chips)
Seat 3: TSuRyAHnUPCFjP7Z0rEE0w ($100.50 in chips)
Seat 4: w02zQzNydODiyV9THKgo9w ($36.80 in chips)
Seat 6: 6tvjsJrdmWg+g7FVrMnzXA ($60.50 in chips)
TSuRyAHnUPCFjP7Z0rEE0w: posts small blind $0.50
w02zQzNydODiyV9THKgo9w: posts big blind $1
X7GlkHF+lkbarCLuZ4Uf0w: sits out
*** HOLE CARDS ***
6tvjsJrdmWg+g7FVrMnzXA: calls $1
AdLVjddOzm+sRNo1Bc3S6Q: folds
KpnW5CcJ4Mg6MeclfKmLrw: folds
TSuRyAHnUPCFjP7Z0rEE0w: folds
w02zQzNydODiyV9THKgo9w: checks
*** FLOP *** [Tc Qd Ad]
w02zQzNydODiyV9THKgo9w: checks
6tvjsJrdmWg+g7FVrMnzXA: bets $1
w02zQzNydODiyV9THKgo9w: folds
6tvjsJrdmWg+g7FVrMnzXA collected $2.40 from pot
*** SUMMARY ***
Total pot $2.50 | Rake $0.10
Board [Tc Qd Ad]
Seat 1: AdLVjddOzm+sRNo1Bc3S6Q folded before Flop (didn't bet)
Seat 2: KpnW5CcJ4Mg6MeclfKmLrw (button) folded before Flop (didn't bet)
Seat 3: TSuRyAHnUPCFjP7Z0rEE0w (small blind) folded before Flop
Seat 4: w02zQzNydODiyV9THKgo9w (big blind) folded on the Flop
Seat 6: 6tvjsJrdmWg+g7FVrMnzXA collected ($2.40)



PokerStars Game #59939432464:  Hold'em No Limit ($0.50/$1.00) - 2009/07/01 0:39:43 ET
Table 'ZFWj23PMihdwrNWv41OG/Q' 9-max Seat #9 is the button
Seat 1: yAbu2QsRPVcjPbqlf/jDxw ($123.90 in chips)
Seat 2: ARfmgHcEUKh68laBZy4veA ($75.60 in chips)
Seat 3: G9Fo2TZCN7HI43Po4zSN3A ($118.70 in chips)
Seat 5: tkdBeXTJlFsZdioidNqLow ($102.30 in chips)
Seat 6: tjhwe1V98x2spSoUQER3HQ ($103 in chips)
Seat 7: wIZ377kjl2fHFGnS93o6bw ($20.30 in chips)
Seat 9: gIabaXO0Nq08nuXlf56f0w ($19.75 in chips)
yAbu2QsRPVcjPbqlf/jDxw: posts small blind $0.50
ARfmgHcEUKh68laBZy4veA: posts big blind $1
Pp/KTcXkfZKKUHkjyaLTdg: sits out
997ViqAtWn1FPjJqcffwcA: sits out
*** HOLE CARDS ***
G9Fo2TZCN7HI43Po4zSN3A: folds
tkdBeXTJlFsZdioidNqLow: folds
tjhwe1V98x2spSoUQER3HQ: folds
wIZ377kjl2fHFGnS93o6bw: folds
gIabaXO0Nq08nuXlf56f0w: calls $1
yAbu2QsRPVcjPbqlf/jDxw: folds
ARfmgHcEUKh68laBZy4veA: raises $2 to $3
gIabaXO0Nq08nuXlf56f0w: calls $2
*** FLOP *** [Qs Jd 2c]
ARfmgHcEUKh68laBZy4veA: bets $3
gIabaXO0Nq08nuXlf56f0w: raises $13.75 to $16.75 and is all-in
ARfmgHcEUKh68laBZy4veA: calls $13.75
*** TURN *** [Qs Jd 2c] [9s]
*** RIVER *** [Qs Jd 2c 9s] [Qd]
*** SHOW DOWN ***
ARfmgHcEUKh68laBZy4veA: shows [Ac Jc] (two pair, Queens and Jacks)
gIabaXO0Nq08nuXlf56f0w: mucks hand
ARfmgHcEUKh68laBZy4veA collected $38.05 from pot
*** SUMMARY ***
Total pot $40 | Rake $1.95
Board [Qs Jd 2c 9s Qd]
Seat 1: yAbu2QsRPVcjPbqlf/jDxw (small blind) folded before Flop
Seat 2: ARfmgHcEUKh68laBZy4veA (big blind) showed [Ac Jc] and won ($38.05) with two pair, Queens and Jacks
Seat 3: G9Fo2TZCN7HI43Po4zSN3A folded before Flop (didn't bet)
Seat 5: tkdBeXTJlFsZdioidNqLow folded before Flop (didn't bet)
Seat 6: tjhwe1V98x2spSoUQER3HQ folded before Flop (didn't bet)
Seat 7: wIZ377kjl2fHFGnS93o6bw folded before Flop (didn't bet)
Seat 9: gIabaXO0Nq08nuXlf56f0w (button) mucked



PokerStars Game #59939433442:  Hold'em No Limit ($0.50/$1.00) - 2009/07/01 0:39:45 ET
Table '8jIjWCPY0NGprquL+xcMFg' 9-max Seat #6 is the button
Seat 1: vR4IO10geOgvTW+LAUBv/A ($135.10 in chips)
Seat 2: rR1qGAf9Q9RYorKYWH3VKw ($5.20 in chips)
Seat 3: tjhwe1V98x2spSoUQER3HQ ($100 in chips)
Seat 4: by0z+YmujwI6Bf4qRFE8vA ($140.95 in chips)
Seat 6: GTQkFJtSkbVbnGCktp6e3g ($108.35 in chips)
Seat 7: O3CGPwwUmamrCNHccOilrg ($53.55 in chips)
Seat 8: 9swGhtpERPngKPtvpoZkoQ ($150.30 in chips)
Seat 9: negfosHnGOZXSHpWDRKyBQ ($20 in chips)
O3CGPwwUmamrCNHccOilrg: posts small blind $0.50
9swGhtpERPngKPtvpoZkoQ: posts big blind $1
*** HOLE CARDS ***
negfosHnGOZXSHpWDRKyBQ: folds
vR4IO10geOgvTW+LAUBv/A: folds
rR1qGAf9Q9RYorKYWH3VKw: folds
tjhwe1V98x2spSoUQER3HQ: folds
by0z+YmujwI6Bf4qRFE8vA: folds
GTQkFJtSkbVbnGCktp6e3g: folds
O3CGPwwUmamrCNHccOilrg: raises $1 to $2
9swGhtpERPngKPtvpoZkoQ: calls $1
*** FLOP *** [6h 6c Js]
O3CGPwwUmamrCNHccOilrg: bets $1
9swGhtpERPngKPtvpoZkoQ: calls $1
*** TURN *** [6h 6c Js] [Qd]
O3CGPwwUmamrCNHccOilrg: checks
9swGhtpERPngKPtvpoZkoQ: checks
*** RIVER *** [6h 6c Js Qd] [Ah]
O3CGPwwUmamrCNHccOilrg: bets $2
9swGhtpERPngKPtvpoZkoQ: calls $2
*** SHOW DOWN ***
O3CGPwwUmamrCNHccOilrg: shows [Tc 8d] (a pair of Sixes)
9swGhtpERPngKPtvpoZkoQ: shows [4c Ad] (two pair, Aces and Sixes)
9swGhtpERPngKPtvpoZkoQ collected $9.55 from pot
*** SUMMARY ***
Total pot $10 | Rake $0.45
Board [6h 6c Js Qd Ah]
Seat 1: vR4IO10geOgvTW+LAUBv/A folded before Flop (didn't bet)
Seat 2: rR1qGAf9Q9RYorKYWH3VKw folded before Flop (didn't bet)
Seat 3: tjhwe1V98x2spSoUQER3HQ folded before Flop (didn't bet)
Seat 4: by0z+YmujwI6Bf4qRFE8vA folded before Flop (didn't bet)
Seat 6: GTQkFJtSkbVbnGCktp6e3g (button) folded before Flop (didn't bet)
Seat 7: O3CGPwwUmamrCNHccOilrg (small blind) showed [Tc 8d] and lost with a pair of Sixes
Seat 8: 9swGhtpERPngKPtvpoZkoQ (big blind) showed [4c Ad] and won ($9.55) with two pair, Aces and Sixes
Seat 9: negfosHnGOZXSHpWDRKyBQ folded before Flop (didn't bet)



PokerStars Game #59939433844:  Hold'em No Limit ($0.50/$1.00) - 2009/07/01 0:39:46 ET
Table 'uNlePsyMIqzM691Xkrlk6Q' 9-max Seat #6 is the button
Seat 1: bLbSOSmSOnqE0iTcH/5dxA ($102.50 in chips)
Seat 2: +OqpStnt0FqbCfyHAWaLbg ($69.60 in chips)
Seat 3: h7qXkU57Bb8ZuPwMyxR8Ug ($9 in chips)
Seat 4: TZcz9MEWDA+WydgGruqqbw ($102.65 in chips)
Seat 5: 3obndzTJ6fECz8+wWhMd1w ($18.50 in chips)
Seat 6: uMPEfCcGCfsxmy53tVUMug ($110.60 in chips)
Seat 7: w6cw9nzN7AvkkHBVVjykoQ ($42.90 in chips)
Seat 8: OsLmX3x/19szSV115TpL/Q ($46.80 in chips)
Seat 9: vR4IO10geOgvTW+LAUBv/A ($121.25 in chips)
w6cw9nzN7AvkkHBVVjykoQ: posts small blind $0.50
OsLmX3x/19szSV115TpL/Q: posts big blind $1
*** HOLE CARDS ***
vR4IO10geOgvTW+LAUBv/A: folds
bLbSOSmSOnqE0iTcH/5dxA: calls $1
+OqpStnt0FqbCfyHAWaLbg: raises $3 to $4
h7qXkU57Bb8ZuPwMyxR8Ug: folds
TZcz9MEWDA+WydgGruqqbw: folds
3obndzTJ6fECz8+wWhMd1w: folds
uMPEfCcGCfsxmy53tVUMug: folds
w6cw9nzN7AvkkHBVVjykoQ: folds
OsLmX3x/19szSV115TpL/Q: folds
bLbSOSmSOnqE0iTcH/5dxA: calls $3
*** FLOP *** [4c Jh 4s]
bLbSOSmSOnqE0iTcH/5dxA: checks
+OqpStnt0FqbCfyHAWaLbg: bets $5
bLbSOSmSOnqE0iTcH/5dxA: calls $5
*** TURN *** [4c Jh 4s] [8h]
bLbSOSmSOnqE0iTcH/5dxA: checks
+OqpStnt0FqbCfyHAWaLbg: bets $10
bLbSOSmSOnqE0iTcH/5dxA: folds
+OqpStnt0FqbCfyHAWaLbg collected $18.55 from pot
*** SUMMARY ***
Total pot $19.50 | Rake $0.95
Board [4c Jh 4s 8h]
Seat 1: bLbSOSmSOnqE0iTcH/5dxA folded on the Turn
Seat 2: +OqpStnt0FqbCfyHAWaLbg collected ($18.55)
Seat 3: h7qXkU57Bb8ZuPwMyxR8Ug folded before Flop (didn't bet)
Seat 4: TZcz9MEWDA+WydgGruqqbw folded before Flop (didn't bet)
Seat 5: 3obndzTJ6fECz8+wWhMd1w folded before Flop (didn't bet)
Seat 6: uMPEfCcGCfsxmy53tVUMug (button) folded before Flop (didn't bet)
Seat 7: w6cw9nzN7AvkkHBVVjykoQ (small blind) folded before Flop
Seat 8: OsLmX3x/19szSV115TpL/Q (big blind) folded before Flop
Seat 9: vR4IO10geOgvTW+LAUBv/A folded before Flop (didn't bet)



PokerStars Game #59939435052:  Hold'em No Limit ($0.50/$1.00) - 2009/07/01 0:39:47 ET
Table 'N2bNCDHL96aCQDvZIh+yQQ' 6-max Seat #6 is the button
Seat 1: iHo1oDbrEVJ8nEGdaPrICw ($142.50 in chips)
Seat 2: KpnW5CcJ4Mg6MeclfKmLrw ($115.10 in chips)
Seat 3: Qy/UBNbD2HaA0Ogxg8Sf3w ($100 in chips)
Seat 4: uCqEjnxh2/vFBjKYkfTOkw ($172.40 in chips)
Seat 5: rHlMOfR7kpQQxe+PFQz0xQ ($30.75 in chips)
Seat 6: TSuRyAHnUPCFjP7Z0rEE0w ($100 in chips)
iHo1oDbrEVJ8nEGdaPrICw: posts small blind $0.50
KpnW5CcJ4Mg6MeclfKmLrw: posts big blind $1
*** HOLE CARDS ***
Qy/UBNbD2HaA0Ogxg8Sf3w: raises $3 to $4
uCqEjnxh2/vFBjKYkfTOkw: folds
rHlMOfR7kpQQxe+PFQz0xQ: folds
TSuRyAHnUPCFjP7Z0rEE0w: folds
iHo1oDbrEVJ8nEGdaPrICw: raises $8 to $12
KpnW5CcJ4Mg6MeclfKmLrw: folds
Qy/UBNbD2HaA0Ogxg8Sf3w: raises $24 to $36
iHo1oDbrEVJ8nEGdaPrICw: raises $106.50 to $142.50 and is all-in
Qy/UBNbD2HaA0Ogxg8Sf3w: calls $64 and is all-in
*** FLOP *** [Kd 7c 6s]
*** TURN *** [Kd 7c 6s] [5h]
*** RIVER *** [Kd 7c 6s 5h] [Ks]
iHo1oDbrEVJ8nEGdaPrICw said, "****"
*** SHOW DOWN ***
iHo1oDbrEVJ8nEGdaPrICw: shows [Ac Ad] (two pair, Aces and Kings)
Qy/UBNbD2HaA0Ogxg8Sf3w: shows [Kh Kc] (four of a kind, Kings)
Qy/UBNbD2HaA0Ogxg8Sf3w collected $198 from pot
*** SUMMARY ***
Total pot $201 | Rake $3
Board [Kd 7c 6s 5h Ks]
Seat 1: iHo1oDbrEVJ8nEGdaPrICw (small blind) showed [Ac Ad] and lost with two pair, Aces and Kings
Seat 2: KpnW5CcJ4Mg6MeclfKmLrw (big blind) folded before Flop
Seat 3: Qy/UBNbD2HaA0Ogxg8Sf3w showed [Kh Kc] and won ($198) with four of a kind, Kings
Seat 4: uCqEjnxh2/vFBjKYkfTOkw folded before Flop (didn't bet)
Seat 5: rHlMOfR7kpQQxe+PFQz0xQ folded before Flop (didn't bet)
Seat 6: TSuRyAHnUPCFjP7Z0rEE0w (button) folded before Flop (didn't bet)



PokerStars Game #59939435030:  Hold'em No Limit ($0.50/$1.00) - 2009/07/01 0:39:47 ET
Table 'vs/5jr6ciwjVQ5+Soc+u2A' 6-max Seat #3 is the button
Seat 1: 1C0rFAGdnnX4GWK9B0YPww ($24 in chips)
Seat 2: XOIf9W+VAxhZqN+SYoyMKA ($118.15 in chips)
Seat 3: G5ZSSN6RSON3gkNvk/SmYg ($150.50 in chips)
Seat 4: KpnW5CcJ4Mg6MeclfKmLrw ($108.80 in chips)
Seat 6: QHvTZcrKe6+maWUfVjP29Q ($106.60 in chips)
KpnW5CcJ4Mg6MeclfKmLrw: posts small blind $0.50
QHvTZcrKe6+maWUfVjP29Q: posts big blind $1
*** HOLE CARDS ***
1C0rFAGdnnX4GWK9B0YPww: folds
XOIf9W+VAxhZqN+SYoyMKA: folds
G5ZSSN6RSON3gkNvk/SmYg: raises $2 to $3
KpnW5CcJ4Mg6MeclfKmLrw: folds
QHvTZcrKe6+maWUfVjP29Q: folds
G5ZSSN6RSON3gkNvk/SmYg collected $2.50 from pot
G5ZSSN6RSON3gkNvk/SmYg: doesn't show hand
*** SUMMARY ***
Total pot $2.50 | Rake $0
Seat 1: 1C0rFAGdnnX4GWK9B0YPww folded before Flop (didn't bet)
Seat 2: XOIf9W+VAxhZqN+SYoyMKA folded before Flop (didn't bet)
Seat 3: G5ZSSN6RSON3gkNvk/SmYg (button) collected ($2.50)
Seat 4: KpnW5CcJ4Mg6MeclfKmLrw (small blind) folded before Flop
Seat 6: QHvTZcrKe6+maWUfVjP29Q (big blind) folded before Flop



PokerStars Game #59939435242:  Hold'em No Limit ($0.50/$1.00) - 2009/07/01 0:39:48 ET
Table 'Evb7VW0qfDhFkbgBL3gcqQ' 2-max Seat #1 is the button
Seat 1: NYi6JFscYNrofSXy4sM+Yw ($104.50 in chips)
Seat 2: mJHc7tEZG3SVIX7QQjb5EQ ($38.05 in chips)
NYi6JFscYNrofSXy4sM+Yw: posts small blind $0.50
mJHc7tEZG3SVIX7QQjb5EQ: posts big blind $1
*** HOLE CARDS ***
NYi6JFscYNrofSXy4sM+Yw: raises $2 to $3
mJHc7tEZG3SVIX7QQjb5EQ: raises $35.05 to $38.05 and is all-in
NYi6JFscYNrofSXy4sM+Yw: folds
mJHc7tEZG3SVIX7QQjb5EQ collected $6 from pot
mJHc7tEZG3SVIX7QQjb5EQ: doesn't show hand
*** SUMMARY ***
Total pot $6 | Rake $0
Seat 1: NYi6JFscYNrofSXy4sM+Yw (button) (small blind) folded before Flop
Seat 2: mJHc7tEZG3SVIX7QQjb5EQ (big blind) collected ($6)



PokerStars Game #59939439526:  Hold'em No Limit ($0.50/$1.00) - 2009/07/01 0:39:55 ET
Table 'rmZfTK+oSebeUPJNbWhdAA' 6-max Seat #5 is the button
Seat 1: xAU6q2/cwmby2sxmA8VcmA ($104.55 in chips)
Seat 2: z7O9PO/WEcqRouIydFhS9Q ($94 in chips)
Seat 3: 9yjOzGERLaEZS8CZ6YNHFg ($113.35 in chips)
Seat 4: OGMLOcTNYZXZU81au7ztUw ($134 in chips)
Seat 5: +xW7QemQU0Fxs+4TnqBRow ($100.50 in chips)
Seat 6: j7NIOHLZk7V2o9fOioO5ug ($131.50 in chips)
j7NIOHLZk7V2o9fOioO5ug: posts small blind $0.50
xAU6q2/cwmby2sxmA8VcmA: posts big blind $1
*** HOLE CARDS ***
z7O9PO/WEcqRouIydFhS9Q: folds
9yjOzGERLaEZS8CZ6YNHFg: folds
OGMLOcTNYZXZU81au7ztUw: raises $2 to $3
+xW7QemQU0Fxs+4TnqBRow: folds
j7NIOHLZk7V2o9fOioO5ug: folds
xAU6q2/cwmby2sxmA8VcmA: folds
OGMLOcTNYZXZU81au7ztUw collected $2.50 from pot
OGMLOcTNYZXZU81au7ztUw: doesn't show hand
*** SUMMARY ***
Total pot $2.50 | Rake $0
Seat 1: xAU6q2/cwmby2sxmA8VcmA (big blind) folded before Flop
Seat 2: z7O9PO/WEcqRouIydFhS9Q folded before Flop (didn't bet)
Seat 3: 9yjOzGERLaEZS8CZ6YNHFg folded before Flop (didn't bet)
Seat 4: OGMLOcTNYZXZU81au7ztUw collected ($2.50)
Seat 5: +xW7QemQU0Fxs+4TnqBRow (button) folded before Flop (didn't bet)
Seat 6: j7NIOHLZk7V2o9fOioO5ug (small blind) folded before Flop



PokerStars Game #59939439482:  Hold'em No Limit ($0.50/$1.00) - 2009/07/01 0:39:55 ET
Table 'MUPc8FEpe/nR0BKSeReX6Q' 6-max Seat #4 is the button
Seat 1: YsLQ3BAvgQHWXMAv3Wv6Hg ($104 in chips)
Seat 2: xAU6q2/cwmby2sxmA8VcmA ($114.30 in chips)
Seat 3: wx3sQGkVi2x9wJXuWNHPBw ($232.55 in chips)
Seat 4: ZA1bp6g8IwtTxkUE4eCjDQ ($172.15 in chips)
Seat 5: UBZQqpnJZdTYYY1FTb0rLA ($100 in chips)
Seat 6: oxnw0GLLpFanjhGkxfRSqA ($59.50 in chips)
UBZQqpnJZdTYYY1FTb0rLA: posts small blind $0.50
oxnw0GLLpFanjhGkxfRSqA: posts big blind $1
*** HOLE CARDS ***
YsLQ3BAvgQHWXMAv3Wv6Hg: raises $3 to $4
xAU6q2/cwmby2sxmA8VcmA: folds
wx3sQGkVi2x9wJXuWNHPBw: calls $4
ZA1bp6g8IwtTxkUE4eCjDQ: folds
UBZQqpnJZdTYYY1FTb0rLA: folds
oxnw0GLLpFanjhGkxfRSqA: folds
*** FLOP *** [Td 2c Tc]
YsLQ3BAvgQHWXMAv3Wv6Hg: bets $7
wx3sQGkVi2x9wJXuWNHPBw: calls $7
*** TURN *** [Td 2c Tc] [3h]
YsLQ3BAvgQHWXMAv3Wv6Hg: bets $16
wx3sQGkVi2x9wJXuWNHPBw: folds
YsLQ3BAvgQHWXMAv3Wv6Hg collected $22.35 from pot
YsLQ3BAvgQHWXMAv3Wv6Hg: doesn't show hand
*** SUMMARY ***
Total pot $23.50 | Rake $1.15
Board [Td 2c Tc 3h]
Seat 1: YsLQ3BAvgQHWXMAv3Wv6Hg collected ($22.35)
Seat 2: xAU6q2/cwmby2sxmA8VcmA folded before Flop (didn't bet)
Seat 3: wx3sQGkVi2x9wJXuWNHPBw folded on the Turn
Seat 4: ZA1bp6g8IwtTxkUE4eCjDQ (button) folded before Flop (didn't bet)
Seat 5: UBZQqpnJZdTYYY1FTb0rLA (small blind) folded before Flop
Seat 6: oxnw0GLLpFanjhGkxfRSqA (big blind) folded before Flop



PokerStars Game #59939442072:  Hold'em No Limit ($0.50/$1.00) - 2009/07/01 0:39:58 ET
Table 'Evb7VW0qfDhFkbgBL3gcqQ' 2-max Seat #2 is the button
Seat 1: NYi6JFscYNrofSXy4sM+Yw ($101.50 in chips)
Seat 2: mJHc7tEZG3SVIX7QQjb5EQ ($41.05 in chips)
mJHc7tEZG3SVIX7QQjb5EQ: posts small blind $0.50
NYi6JFscYNrofSXy4sM+Yw: posts big blind $1
*** HOLE CARDS ***
mJHc7tEZG3SVIX7QQjb5EQ: raises $1 to $2
NYi6JFscYNrofSXy4sM+Yw: calls $1
*** FLOP *** [4c Kc 7h]
NYi6JFscYNrofSXy4sM+Yw: bets $2
mJHc7tEZG3SVIX7QQjb5EQ: calls $2
*** TURN *** [4c Kc 7h] [Tc]
NYi6JFscYNrofSXy4sM+Yw: checks
mJHc7tEZG3SVIX7QQjb5EQ: bets $5
NYi6JFscYNrofSXy4sM+Yw: folds
mJHc7tEZG3SVIX7QQjb5EQ collected $7.65 from pot
mJHc7tEZG3SVIX7QQjb5EQ: doesn't show hand
*** SUMMARY ***
Total pot $8 | Rake $0.35
Board [4c Kc 7h Tc]
Seat 1: NYi6JFscYNrofSXy4sM+Yw (big blind) folded on the Turn
Seat 2: mJHc7tEZG3SVIX7QQjb5EQ (button) (small blind) collected ($7.65)



PokerStars Game #59939442410:  Hold'em No Limit ($0.50/$1.00) - 2009/07/01 0:39:59 ET
Table 'FKpXUINE6M3UxHG4zaMhHA' 6-max Seat #5 is the button
Seat 1: qNezhXOOUXqwG7b9X5XJAA ($100 in chips)
Seat 2: nDKgwwXJ45hcJfJe01cdxQ ($35.10 in chips)
Seat 3: GOHDYcxP1gP29069kB9HFw ($123.05 in chips)
Seat 4: vw0eLNLy3Huccth4CUZNPQ ($74.30 in chips)
Seat 5: eUBBn2R56C1IQ6Cs/vitwg ($100 in chips)
Seat 6: b2a+5TkFf4xJN/Ihhma58Q ($13.90 in chips)
b2a+5TkFf4xJN/Ihhma58Q: posts small blind $0.50
qNezhXOOUXqwG7b9X5XJAA: posts big blind $1
*** HOLE CARDS ***
nDKgwwXJ45hcJfJe01cdxQ: raises $1 to $2
GOHDYcxP1gP29069kB9HFw: calls $2
vw0eLNLy3Huccth4CUZNPQ: folds
eUBBn2R56C1IQ6Cs/vitwg: folds
b2a+5TkFf4xJN/Ihhma58Q: folds
qNezhXOOUXqwG7b9X5XJAA: folds
*** FLOP *** [2s 7d Ah]
nDKgwwXJ45hcJfJe01cdxQ: bets $4
GOHDYcxP1gP29069kB9HFw: folds
nDKgwwXJ45hcJfJe01cdxQ collected $5.25 from pot
nDKgwwXJ45hcJfJe01cdxQ: doesn't show hand
*** SUMMARY ***
Total pot $5.50 | Rake $0.25
Board [2s 7d Ah]
Seat 1: qNezhXOOUXqwG7b9X5XJAA (big blind) folded before Flop
Seat 2: nDKgwwXJ45hcJfJe01cdxQ collected ($5.25)
Seat 3: GOHDYcxP1gP29069kB9HFw folded on the Flop
Seat 4: vw0eLNLy3Huccth4CUZNPQ folded before Flop (didn't bet)
Seat 5: eUBBn2R56C1IQ6Cs/vitwg (button) folded before Flop (didn't bet)
Seat 6: b2a+5TkFf4xJN/Ihhma58Q (small blind) folded before Flop



PokerStars Game #59939443938:  Hold'em No Limit ($0.50/$1.00) - 2009/07/01 0:40:01 ET
Table '6YvsYDPNIDx2v5z3bJnwZQ' 9-max Seat #2 is the button
Seat 1: Ogn4JDV3mp4ZDKO49IFzKA ($16.85 in chips)
Seat 2: x80+i7DJL+81v3quj7KbNg ($20 in chips)
Seat 3: negfosHnGOZXSHpWDRKyBQ ($18.30 in chips)
Seat 4: kEr5NYB+JIG5+szcYMr6hA ($44 in chips)
Seat 5: mBRWbnUl8diyBO1qTJaNzw ($160.70 in chips)
Seat 6: uMPEfCcGCfsxmy53tVUMug ($108.10 in chips)
Seat 7: boixc27eqTYA1p0tUdMuBQ ($114 in chips)
Seat 8: PSFxpXgPedVZyHSu2Zhb7Q ($46.75 in chips)
Seat 9: jDwhY1kCdc6EkAHbT7PJMQ ($104.10 in chips)
negfosHnGOZXSHpWDRKyBQ: posts small blind $0.50
kEr5NYB+JIG5+szcYMr6hA: posts big blind $1
*** HOLE CARDS ***
mBRWbnUl8diyBO1qTJaNzw: folds
uMPEfCcGCfsxmy53tVUMug: folds
boixc27eqTYA1p0tUdMuBQ: folds
PSFxpXgPedVZyHSu2Zhb7Q: folds
jDwhY1kCdc6EkAHbT7PJMQ: folds
Ogn4JDV3mp4ZDKO49IFzKA: calls $1
x80+i7DJL+81v3quj7KbNg: folds
negfosHnGOZXSHpWDRKyBQ: calls $0.50
kEr5NYB+JIG5+szcYMr6hA: checks
*** FLOP *** [Jd 9s 6h]
negfosHnGOZXSHpWDRKyBQ: checks
kEr5NYB+JIG5+szcYMr6hA: checks
Ogn4JDV3mp4ZDKO49IFzKA: bets $2
negfosHnGOZXSHpWDRKyBQ: folds
kEr5NYB+JIG5+szcYMr6hA: folds
Ogn4JDV3mp4ZDKO49IFzKA collected $2.85 from pot
*** SUMMARY ***
Total pot $3 | Rake $0.15
Board [Jd 9s 6h]
Seat 1: Ogn4JDV3mp4ZDKO49IFzKA collected ($2.85)
Seat 2: x80+i7DJL+81v3quj7KbNg (button) folded before Flop (didn't bet)
Seat 3: negfosHnGOZXSHpWDRKyBQ (small blind) folded on the Flop
Seat 4: kEr5NYB+JIG5+szcYMr6hA (big blind) folded on the Flop
Seat 5: mBRWbnUl8diyBO1qTJaNzw folded before Flop (didn't bet)
Seat 6: uMPEfCcGCfsxmy53tVUMug folded before Flop (didn't bet)
Seat 7: boixc27eqTYA1p0tUdMuBQ folded before Flop (didn't bet)
Seat 8: PSFxpXgPedVZyHSu2Zhb7Q folded before Flop (didn't bet)
Seat 9: jDwhY1kCdc6EkAHbT7PJMQ folded before Flop (didn't bet)



PokerStars Game #59939444054:  Hold'em No Limit ($0.50/$1.00) - 2009/07/01 0:40:01 ET
Table 'cBDNutyLBKEk9+ptwsKmTw' 6-max Seat #1 is the button
Seat 1: xAU6q2/cwmby2sxmA8VcmA ($100 in chips)
Seat 3: G5ZSSN6RSON3gkNvk/SmYg ($108.90 in chips)
Seat 4: 3q7F5QtzC30pSrn0nl9i+A ($23.30 in chips)
Seat 5: OGMLOcTNYZXZU81au7ztUw ($135.45 in chips)
Seat 6: NqVlOSH2lp+pp/TK3vvK5g ($70.80 in chips)
G5ZSSN6RSON3gkNvk/SmYg: posts small blind $0.50
3q7F5QtzC30pSrn0nl9i+A: posts big blind $1
*** HOLE CARDS ***
Chase_Dem leaves the table
OGMLOcTNYZXZU81au7ztUw: folds
NqVlOSH2lp+pp/TK3vvK5g: folds
xAU6q2/cwmby2sxmA8VcmA: folds
G5ZSSN6RSON3gkNvk/SmYg: folds
3q7F5QtzC30pSrn0nl9i+A collected $1 from pot
*** SUMMARY ***
Total pot $1 | Rake $0
Seat 1: xAU6q2/cwmby2sxmA8VcmA (button) folded before Flop (didn't bet)
Seat 3: G5ZSSN6RSON3gkNvk/SmYg (small blind) folded before Flop
Seat 4: 3q7F5QtzC30pSrn0nl9i+A (big blind) collected ($1)
Seat 5: OGMLOcTNYZXZU81au7ztUw folded before Flop (didn't bet)
Seat 6: NqVlOSH2lp+pp/TK3vvK5g folded before Flop (didn't bet)



PokerStars Game #59939444700:  Hold'em No Limit ($0.50/$1.00) - 2009/07/01 0:40:02 ET
Table 'pHrhryH8jPNdQfY62f8v+g' 6-max Seat #3 is the button
Seat 2: RqgF7gRoKgRNW8Zoi1ty4A ($124.65 in chips)
Seat 3: j0aDOn9Nft1HLTQvGu1UwA ($13 in chips)
Seat 4: wenbG7TaM3H7h5kn78OFNw ($47.80 in chips)
Seat 5: r1/R7y0Ortgoz4lccgW8VA ($37.65 in chips)
Seat 6: xAU6q2/cwmby2sxmA8VcmA ($108.75 in chips)
wenbG7TaM3H7h5kn78OFNw: posts small blind $0.50
r1/R7y0Ortgoz4lccgW8VA: posts big blind $1
fF4botNMr8/ieVPO1YYRLw: sits out
*** HOLE CARDS ***
xAU6q2/cwmby2sxmA8VcmA: folds
RqgF7gRoKgRNW8Zoi1ty4A: folds
j0aDOn9Nft1HLTQvGu1UwA: calls $1
wenbG7TaM3H7h5kn78OFNw: folds
r1/R7y0Ortgoz4lccgW8VA: checks
*** FLOP *** [8d Jd Kh]
r1/R7y0Ortgoz4lccgW8VA: checks
j0aDOn9Nft1HLTQvGu1UwA: checks
*** TURN *** [8d Jd Kh] [8s]
r1/R7y0Ortgoz4lccgW8VA: checks
j0aDOn9Nft1HLTQvGu1UwA: bets $4
r1/R7y0Ortgoz4lccgW8VA: folds
j0aDOn9Nft1HLTQvGu1UwA collected $2.40 from pot
*** SUMMARY ***
Total pot $2.50 | Rake $0.10
Board [8d Jd Kh 8s]
Seat 2: RqgF7gRoKgRNW8Zoi1ty4A folded before Flop (didn't bet)
Seat 3: j0aDOn9Nft1HLTQvGu1UwA (button) collected ($2.40)
Seat 4: wenbG7TaM3H7h5kn78OFNw (small blind) folded before Flop
Seat 5: r1/R7y0Ortgoz4lccgW8VA (big blind) folded on the Turn
Seat 6: xAU6q2/cwmby2sxmA8VcmA folded before Flop (didn't bet)



PokerStars Game #59939445960:  Hold'em No Limit ($0.50/$1.00) - 2009/07/01 0:40:04 ET
Table 'fTlPiCj0utgzC/5io+I7ew' 6-max Seat #2 is the button
Seat 1: YMJG+F++3Aj6P8dAWda5fw ($97 in chips)
Seat 2: Qy/UBNbD2HaA0Ogxg8Sf3w ($100 in chips)
Seat 3: oDiBRCaF0QVtd3kO6xZIXw ($88.60 in chips)
Seat 4: uJVSceLggtsrJya+WtmUEA ($98.80 in chips)
Seat 5: bFrTkDcWGTxyvNul7GVdYg ($256.70 in chips)
Seat 6: jMljU/dOPMXfJi8OmbdYdw ($60.70 in chips)
oDiBRCaF0QVtd3kO6xZIXw: posts small blind $0.50
uJVSceLggtsrJya+WtmUEA: posts big blind $1
*** HOLE CARDS ***
bFrTkDcWGTxyvNul7GVdYg: folds
jMljU/dOPMXfJi8OmbdYdw: folds
YMJG+F++3Aj6P8dAWda5fw: folds
Qy/UBNbD2HaA0Ogxg8Sf3w: raises $1.50 to $2.50
oDiBRCaF0QVtd3kO6xZIXw: calls $2
uJVSceLggtsrJya+WtmUEA: folds
*** FLOP *** [5s 7s 6h]
oDiBRCaF0QVtd3kO6xZIXw: checks
Qy/UBNbD2HaA0Ogxg8Sf3w: checks
*** TURN *** [5s 7s 6h] [7d]
oDiBRCaF0QVtd3kO6xZIXw: bets $3
Qy/UBNbD2HaA0Ogxg8Sf3w: calls $3
*** RIVER *** [5s 7s 6h 7d] [3d]
oDiBRCaF0QVtd3kO6xZIXw: checks
Qy/UBNbD2HaA0Ogxg8Sf3w: checks
*** SHOW DOWN ***
oDiBRCaF0QVtd3kO6xZIXw: shows [8h Jd] (a pair of Sevens)
Qy/UBNbD2HaA0Ogxg8Sf3w: shows [Kh Jh] (a pair of Sevens - King kicker)
Qy/UBNbD2HaA0Ogxg8Sf3w collected $11.45 from pot
*** SUMMARY ***
Total pot $12 | Rake $0.55
Board [5s 7s 6h 7d 3d]
Seat 1: YMJG+F++3Aj6P8dAWda5fw folded before Flop (didn't bet)
Seat 2: Qy/UBNbD2HaA0Ogxg8Sf3w (button) showed [Kh Jh] and won ($11.45) with a pair of Sevens
Seat 3: oDiBRCaF0QVtd3kO6xZIXw (small blind) showed [8h Jd] and lost with a pair of Sevens
Seat 4: uJVSceLggtsrJya+WtmUEA (big blind) folded before Flop
Seat 5: bFrTkDcWGTxyvNul7GVdYg folded before Flop (didn't bet)
Seat 6: jMljU/dOPMXfJi8OmbdYdw folded before Flop (didn't bet)



PokerStars Game #59939445632:  Hold'em No Limit ($0.50/$1.00) - 2009/07/01 0:40:04 ET
Table '7O9fB8yx1u7sJveJn8w6jA' 6-max Seat #5 is the button
Seat 1: jy52+7FotjH63o5tEEVgKw ($114.40 in chips)
Seat 2: wx3sQGkVi2x9wJXuWNHPBw ($195.50 in chips)
Seat 3: hpxXcmRkXXI9HE5+5/j/0Q ($100 in chips)
Seat 4: XIZSmlGttGgSRaIU42K4Fg ($100 in chips)
Seat 5: BCEV3COoKY607AzLWayfRA ($110.85 in chips)
Seat 6: UBZQqpnJZdTYYY1FTb0rLA ($129.85 in chips)
UBZQqpnJZdTYYY1FTb0rLA: posts small blind $0.50
jy52+7FotjH63o5tEEVgKw: posts big blind $1
XIZSmlGttGgSRaIU42K4Fg: posts small & big blinds $1.50
*** HOLE CARDS ***
wx3sQGkVi2x9wJXuWNHPBw: folds
hpxXcmRkXXI9HE5+5/j/0Q: folds
XIZSmlGttGgSRaIU42K4Fg: checks
BCEV3COoKY607AzLWayfRA: folds
UBZQqpnJZdTYYY1FTb0rLA: folds
jy52+7FotjH63o5tEEVgKw: checks
*** FLOP *** [Ac Ah 2d]
jy52+7FotjH63o5tEEVgKw: checks
XIZSmlGttGgSRaIU42K4Fg: checks
*** TURN *** [Ac Ah 2d] [Js]
jy52+7FotjH63o5tEEVgKw: checks
XIZSmlGttGgSRaIU42K4Fg: checks
*** RIVER *** [Ac Ah 2d Js] [5h]
jy52+7FotjH63o5tEEVgKw: checks
XIZSmlGttGgSRaIU42K4Fg: checks
*** SHOW DOWN ***
jy52+7FotjH63o5tEEVgKw: shows [7d 3h] (a pair of Aces)
XIZSmlGttGgSRaIU42K4Fg: shows [6d 7s] (a pair of Aces - Jack+Seven+Six kicker)
XIZSmlGttGgSRaIU42K4Fg collected $2.85 from pot
*** SUMMARY ***
Total pot $3 | Rake $0.15
Board [Ac Ah 2d Js 5h]
Seat 1: jy52+7FotjH63o5tEEVgKw (big blind) showed [7d 3h] and lost with a pair of Aces
Seat 2: wx3sQGkVi2x9wJXuWNHPBw folded before Flop (didn't bet)
Seat 3: hpxXcmRkXXI9HE5+5/j/0Q folded before Flop (didn't bet)
Seat 4: XIZSmlGttGgSRaIU42K4Fg showed [6d 7s] and won ($2.85) with a pair of Aces
Seat 5: BCEV3COoKY607AzLWayfRA (button) folded before Flop (didn't bet)
Seat 6: UBZQqpnJZdTYYY1FTb0rLA (small blind) folded before Flop



PokerStars Game #59939446402:  Hold'em No Limit ($0.50/$1.00) - 2009/07/01 0:40:05 ET
Table 'U9zqzC8f3oTJ2ShXFgSSOA' 6-max Seat #4 is the button
Seat 1: tS9JHB1h+FQ++qu8RwRNgg ($82.15 in chips)
Seat 2: U2CWBTv29qdCbj8RNF2sIw ($99.50 in chips)
Seat 3: yfXek8iJ7O4CFyqXrtGcfg ($12.05 in chips)
Seat 4: 33q95we0Etwgrm6guQGncw ($84.60 in chips)
Seat 5: KfwW5us6tydK81NYTtK1gw ($295.75 in chips)
Seat 6: aIxzFKdtpDSkUePKZy/niQ ($25.55 in chips)
KfwW5us6tydK81NYTtK1gw: posts small blind $0.50
aIxzFKdtpDSkUePKZy/niQ: posts big blind $1
*** HOLE CARDS ***
tS9JHB1h+FQ++qu8RwRNgg: calls $1
U2CWBTv29qdCbj8RNF2sIw: folds
yfXek8iJ7O4CFyqXrtGcfg: folds
33q95we0Etwgrm6guQGncw: folds
KfwW5us6tydK81NYTtK1gw: folds
aIxzFKdtpDSkUePKZy/niQ: checks
*** FLOP *** [5s 8h 2h]
aIxzFKdtpDSkUePKZy/niQ: checks
tS9JHB1h+FQ++qu8RwRNgg: bets $2
aIxzFKdtpDSkUePKZy/niQ: calls $2
*** TURN *** [5s 8h 2h] [9s]
aIxzFKdtpDSkUePKZy/niQ: checks
tS9JHB1h+FQ++qu8RwRNgg: checks
*** RIVER *** [5s 8h 2h 9s] [6c]
aIxzFKdtpDSkUePKZy/niQ: bets $4
tS9JHB1h+FQ++qu8RwRNgg: folds
aIxzFKdtpDSkUePKZy/niQ collected $6.20 from pot
*** SUMMARY ***
Total pot $6.50 | Rake $0.30
Board [5s 8h 2h 9s 6c]
Seat 1: tS9JHB1h+FQ++qu8RwRNgg folded on the River
Seat 2: U2CWBTv29qdCbj8RNF2sIw folded before Flop (didn't bet)
Seat 3: yfXek8iJ7O4CFyqXrtGcfg folded before Flop (didn't bet)
Seat 4: 33q95we0Etwgrm6guQGncw (button) folded before Flop (didn't bet)
Seat 5: KfwW5us6tydK81NYTtK1gw (small blind) folded before Flop
Seat 6: aIxzFKdtpDSkUePKZy/niQ (big blind) collected ($6.20)



PokerStars Game #59939446450:  Hold'em No Limit ($0.50/$1.00) - 2009/07/01 0:40:05 ET
Table '/RZcOwpZpHQ+OwPwjsbnRw' 6-max Seat #6 is the button
Seat 1: Zboa6dColKGHBjLPUakZjw ($55.70 in chips)
Seat 2: +xW7QemQU0Fxs+4TnqBRow ($129 in chips)
Seat 4: j7NIOHLZk7V2o9fOioO5ug ($100 in chips)
Seat 5: wx3sQGkVi2x9wJXuWNHPBw ($196.65 in chips)
Seat 6: XOIf9W+VAxhZqN+SYoyMKA ($288.55 in chips)
Zboa6dColKGHBjLPUakZjw: posts small blind $0.50
+xW7QemQU0Fxs+4TnqBRow: posts big blind $1
*** HOLE CARDS ***
j7NIOHLZk7V2o9fOioO5ug: folds
wx3sQGkVi2x9wJXuWNHPBw: folds
XOIf9W+VAxhZqN+SYoyMKA: folds
Zboa6dColKGHBjLPUakZjw: raises $1 to $2
+xW7QemQU0Fxs+4TnqBRow: folds
Zboa6dColKGHBjLPUakZjw collected $2 from pot
Zboa6dColKGHBjLPUakZjw: doesn't show hand
*** SUMMARY ***
Total pot $2 | Rake $0
Seat 1: Zboa6dColKGHBjLPUakZjw (small blind) collected ($2)
Seat 2: +xW7QemQU0Fxs+4TnqBRow (big blind) folded before Flop
Seat 4: j7NIOHLZk7V2o9fOioO5ug folded before Flop (didn't bet)
Seat 5: wx3sQGkVi2x9wJXuWNHPBw folded before Flop (didn't bet)
Seat 6: XOIf9W+VAxhZqN+SYoyMKA (button) folded before Flop (didn't bet)



PokerStars Game #59939446928:  Hold'em No Limit ($0.50/$1.00) - 2009/07/01 0:40:06 ET
Table '+cA8mcmhaedZ7YcrDdhmeQ' 6-max Seat #1 is the button
Seat 1: lsLuWlcPA3Rh7kJVLzMh0Q ($302.75 in chips)
Seat 2: RqgF7gRoKgRNW8Zoi1ty4A ($103.20 in chips)
Seat 3: 7H5WkGzGvsv56y1iaqHvRg ($32.55 in chips)
Seat 4: LjL3AIERHn559yyW1mTUYQ ($155.50 in chips)
Seat 5: iHo1oDbrEVJ8nEGdaPrICw ($102.70 in chips)
Seat 6: YfsTQsY/fxb+YqbdclTHuw ($63.55 in chips)
RqgF7gRoKgRNW8Zoi1ty4A: posts small blind $0.50
7H5WkGzGvsv56y1iaqHvRg: posts big blind $1
*** HOLE CARDS ***
LjL3AIERHn559yyW1mTUYQ: folds
iHo1oDbrEVJ8nEGdaPrICw: folds
YfsTQsY/fxb+YqbdclTHuw: calls $1
lsLuWlcPA3Rh7kJVLzMh0Q: raises $4 to $5
RqgF7gRoKgRNW8Zoi1ty4A: folds
7H5WkGzGvsv56y1iaqHvRg: calls $4
YfsTQsY/fxb+YqbdclTHuw: folds
*** FLOP *** [5d 9h 2d]
7H5WkGzGvsv56y1iaqHvRg: checks
lsLuWlcPA3Rh7kJVLzMh0Q: bets $7
7H5WkGzGvsv56y1iaqHvRg: folds
lsLuWlcPA3Rh7kJVLzMh0Q collected $10.95 from pot
lsLuWlcPA3Rh7kJVLzMh0Q: doesn't show hand
*** SUMMARY ***
Total pot $11.50 | Rake $0.55
Board [5d 9h 2d]
Seat 1: lsLuWlcPA3Rh7kJVLzMh0Q (button) collected ($10.95)
Seat 2: RqgF7gRoKgRNW8Zoi1ty4A (small blind) folded before Flop
Seat 3: 7H5WkGzGvsv56y1iaqHvRg (big blind) folded on the Flop
Seat 4: LjL3AIERHn559yyW1mTUYQ folded before Flop (didn't bet)
Seat 5: iHo1oDbrEVJ8nEGdaPrICw folded before Flop (didn't bet)
Seat 6: YfsTQsY/fxb+YqbdclTHuw folded before Flop



PokerStars Game #59939448046:  Hold'em No Limit ($0.50/$1.00) - 2009/07/01 0:40:08 ET
Table 'LmXQK9xy3awB+qsPzI21Mw' 2-max Seat #2 is the button
Seat 1: NYi6JFscYNrofSXy4sM+Yw ($245.75 in chips)
Seat 2: TME8GvochpQAo8cmJwWmvA ($92.20 in chips)
TME8GvochpQAo8cmJwWmvA: posts small blind $0.50
NYi6JFscYNrofSXy4sM+Yw: posts big blind $1
*** HOLE CARDS ***
TME8GvochpQAo8cmJwWmvA: raises $1 to $2
NYi6JFscYNrofSXy4sM+Yw: calls $1
*** FLOP *** [4s Th 7d]
NYi6JFscYNrofSXy4sM+Yw: checks
TME8GvochpQAo8cmJwWmvA: bets $2
NYi6JFscYNrofSXy4sM+Yw: calls $2
*** TURN *** [4s Th 7d] [8s]
NYi6JFscYNrofSXy4sM+Yw: checks
TME8GvochpQAo8cmJwWmvA: checks
*** RIVER *** [4s Th 7d 8s] [4d]
NYi6JFscYNrofSXy4sM+Yw: checks
TME8GvochpQAo8cmJwWmvA: bets $3
NYi6JFscYNrofSXy4sM+Yw: folds
TME8GvochpQAo8cmJwWmvA collected $7.65 from pot
TME8GvochpQAo8cmJwWmvA: doesn't show hand
*** SUMMARY ***
Total pot $8 | Rake $0.35
Board [4s Th 7d 8s 4d]
Seat 1: NYi6JFscYNrofSXy4sM+Yw (big blind) folded on the River
Seat 2: TME8GvochpQAo8cmJwWmvA (button) (small blind) collected ($7.65)



PokerStars Game #59939448272:  Hold'em No Limit ($0.50/$1.00) - 2009/07/01 0:40:08 ET
Table 'vs/5jr6ciwjVQ5+Soc+u2A' 6-max Seat #4 is the button
Seat 1: 1C0rFAGdnnX4GWK9B0YPww ($24 in chips)
Seat 2: XOIf9W+VAxhZqN+SYoyMKA ($118.15 in chips)
Seat 3: G5ZSSN6RSON3gkNvk/SmYg ($152 in chips)
Seat 4: KpnW5CcJ4Mg6MeclfKmLrw ($108.30 in chips)
Seat 6: QHvTZcrKe6+maWUfVjP29Q ($105.60 in chips)
QHvTZcrKe6+maWUfVjP29Q: posts small blind $0.50
1C0rFAGdnnX4GWK9B0YPww: posts big blind $1
*** HOLE CARDS ***
XOIf9W+VAxhZqN+SYoyMKA: folds
G5ZSSN6RSON3gkNvk/SmYg: folds
KpnW5CcJ4Mg6MeclfKmLrw: folds
QHvTZcrKe6+maWUfVjP29Q: folds
1C0rFAGdnnX4GWK9B0YPww collected $1 from pot
*** SUMMARY ***
Total pot $1 | Rake $0
Seat 1: 1C0rFAGdnnX4GWK9B0YPww (big blind) collected ($1)
Seat 2: XOIf9W+VAxhZqN+SYoyMKA folded before Flop (didn't bet)
Seat 3: G5ZSSN6RSON3gkNvk/SmYg folded before Flop (didn't bet)
Seat 4: KpnW5CcJ4Mg6MeclfKmLrw (button) folded before Flop (didn't bet)
Seat 6: QHvTZcrKe6+maWUfVjP29Q (small blind) folded before Flop



PokerStars Game #59939449432:  Hold'em No Limit ($0.50/$1.00) - 2009/07/01 0:40:10 ET
Table '7Nl0ffnjeK44/vmeexh3MQ' 9-max Seat #5 is the button
Seat 1: s7D3Y+k4Cj4D1cXHv7oj+Q ($97.80 in chips)
Seat 2: kiakSwxX0e64PwYGAPQvLw ($31.85 in chips)
Seat 3: vR4IO10geOgvTW+LAUBv/A ($103 in chips)
Seat 4: bLbSOSmSOnqE0iTcH/5dxA ($100 in chips)
Seat 5: bL+QVeDcuEdzMGAGg2XJHg ($99.50 in chips)
Seat 8: zanka7aAZkigmZpfopXxxA ($254.20 in chips)
Seat 9: ouwUBGRKnKK9uhn1G4Lf+A ($95 in chips)
997ViqAtWn1FPjJqcffwcA will be allowed to play after the button
zanka7aAZkigmZpfopXxxA: posts small blind $0.50
ouwUBGRKnKK9uhn1G4Lf+A: posts big blind $1
*** HOLE CARDS ***
s7D3Y+k4Cj4D1cXHv7oj+Q: folds
kiakSwxX0e64PwYGAPQvLw: folds
vR4IO10geOgvTW+LAUBv/A: folds
FVs16t7GgfWgQWt4JxsObQ has returned
bLbSOSmSOnqE0iTcH/5dxA: folds
bL+QVeDcuEdzMGAGg2XJHg: folds
zanka7aAZkigmZpfopXxxA: folds
ouwUBGRKnKK9uhn1G4Lf+A collected $1 from pot
ouwUBGRKnKK9uhn1G4Lf+A: doesn't show hand
*** SUMMARY ***
Total pot $1 | Rake $0
Seat 1: s7D3Y+k4Cj4D1cXHv7oj+Q folded before Flop (didn't bet)
Seat 2: kiakSwxX0e64PwYGAPQvLw folded before Flop (didn't bet)
Seat 3: vR4IO10geOgvTW+LAUBv/A folded before Flop (didn't bet)
Seat 4: bLbSOSmSOnqE0iTcH/5dxA folded before Flop (didn't bet)
Seat 5: bL+QVeDcuEdzMGAGg2XJHg (button) folded before Flop (didn't bet)
Seat 8: zanka7aAZkigmZpfopXxxA (small blind) folded before Flop
Seat 9: ouwUBGRKnKK9uhn1G4Lf+A (big blind) collected ($1)



PokerStars Game #59939451082:  Hold'em No Limit ($0.50/$1.00) - 2009/07/01 0:40:12 ET
Table 'Zka9tv1yilg0MvXWPQrShg' 9-max Seat #7 is the button
Seat 1: TZcz9MEWDA+WydgGruqqbw ($115.35 in chips)
Seat 2: rR1qGAf9Q9RYorKYWH3VKw ($24.70 in chips)
Seat 3: gUUvmqdVlmvpal6B8nYrmg ($100 in chips)
Seat 4: CTOae+JLIGfwfXvhqHkP2w ($150.65 in chips)
Seat 5: /zy+DB4S5fUQUSfZWFzYGw ($151.40 in chips)
Seat 6: rY8wPoax1lS+HUY+I0FZDw ($146.30 in chips)
Seat 7: p1SafS90nb3Uft5LB0NkHw ($20 in chips)
Seat 8: bL+QVeDcuEdzMGAGg2XJHg ($118.10 in chips)
Seat 9: 6daxhj43mWj04MOPTOmaYA ($93 in chips)
bL+QVeDcuEdzMGAGg2XJHg: posts small blind $0.50
6daxhj43mWj04MOPTOmaYA: posts big blind $1
*** HOLE CARDS ***
TZcz9MEWDA+WydgGruqqbw: folds
rR1qGAf9Q9RYorKYWH3VKw: calls $1
gUUvmqdVlmvpal6B8nYrmg: folds
CTOae+JLIGfwfXvhqHkP2w: raises $3 to $4
/zy+DB4S5fUQUSfZWFzYGw: calls $4
rY8wPoax1lS+HUY+I0FZDw: folds
p1SafS90nb3Uft5LB0NkHw: folds
bL+QVeDcuEdzMGAGg2XJHg: folds
6daxhj43mWj04MOPTOmaYA: folds
rR1qGAf9Q9RYorKYWH3VKw: folds
*** FLOP *** [Ah 8c Tc]
CTOae+JLIGfwfXvhqHkP2w: bets $6
/zy+DB4S5fUQUSfZWFzYGw: raises $9 to $15
CTOae+JLIGfwfXvhqHkP2w: calls $9
*** TURN *** [Ah 8c Tc] [4c]
CTOae+JLIGfwfXvhqHkP2w: checks
/zy+DB4S5fUQUSfZWFzYGw: checks
*** RIVER *** [Ah 8c Tc 4c] [Ks]
CTOae+JLIGfwfXvhqHkP2w: checks
/zy+DB4S5fUQUSfZWFzYGw: checks
*** SHOW DOWN ***
CTOae+JLIGfwfXvhqHkP2w: shows [Ad Jc] (a pair of Aces)
/zy+DB4S5fUQUSfZWFzYGw: mucks hand
CTOae+JLIGfwfXvhqHkP2w collected $38.50 from pot
*** SUMMARY ***
Total pot $40.50 | Rake $2
Board [Ah 8c Tc 4c Ks]
Seat 1: TZcz9MEWDA+WydgGruqqbw folded before Flop (didn't bet)
Seat 2: rR1qGAf9Q9RYorKYWH3VKw folded before Flop
Seat 3: gUUvmqdVlmvpal6B8nYrmg folded before Flop (didn't bet)
Seat 4: CTOae+JLIGfwfXvhqHkP2w showed [Ad Jc] and won ($38.50) with a pair of Aces
Seat 5: /zy+DB4S5fUQUSfZWFzYGw mucked
Seat 6: rY8wPoax1lS+HUY+I0FZDw folded before Flop (didn't bet)
Seat 7: p1SafS90nb3Uft5LB0NkHw (button) folded before Flop (didn't bet)
Seat 8: bL+QVeDcuEdzMGAGg2XJHg (small blind) folded before Flop
Seat 9: 6daxhj43mWj04MOPTOmaYA (big blind) folded before Flop



PokerStars Game #59939451206:  Hold'em No Limit ($0.50/$1.00) - 2009/07/01 0:40:13 ET
Table 'GPp0HyAuggN8oE0sUWzPpA' 9-max Seat #1 is the button
Seat 1: qJr25HAtvv1w/7IBvjMM3g ($36.35 in chips)
Seat 2: Ogn4JDV3mp4ZDKO49IFzKA ($17.50 in chips)
Seat 3: L9njYvloJ1NdXjP8edHEAg ($100 in chips)
Seat 4: mBRWbnUl8diyBO1qTJaNzw ($112.70 in chips)
Seat 5: 0fXz44fzDo5QmhAaJCvFfA ($20.80 in chips)
Seat 6: negfosHnGOZXSHpWDRKyBQ ($33.60 in chips)
Seat 8: tkdBeXTJlFsZdioidNqLow ($65.15 in chips)
Ogn4JDV3mp4ZDKO49IFzKA: posts small blind $0.50
L9njYvloJ1NdXjP8edHEAg: posts big blind $1
laA8va+Yv8WuMqT1zdR91g: sits out
VPF+HjszMvUIpy0CHIwH3A: sits out
*** HOLE CARDS ***
mBRWbnUl8diyBO1qTJaNzw: folds
0fXz44fzDo5QmhAaJCvFfA: folds
negfosHnGOZXSHpWDRKyBQ: folds
tkdBeXTJlFsZdioidNqLow: folds
qJr25HAtvv1w/7IBvjMM3g: raises $3 to $4
Ogn4JDV3mp4ZDKO49IFzKA: raises $13.50 to $17.50 and is all-in
L9njYvloJ1NdXjP8edHEAg: folds
qJr25HAtvv1w/7IBvjMM3g: calls $13.50
*** FLOP *** [3c Js 3s]
*** TURN *** [3c Js 3s] [Kh]
*** RIVER *** [3c Js 3s Kh] [3d]
*** SHOW DOWN ***
Ogn4JDV3mp4ZDKO49IFzKA: shows [Ad Kd] (a full house, Threes full of Kings)
qJr25HAtvv1w/7IBvjMM3g: mucks hand
Ogn4JDV3mp4ZDKO49IFzKA collected $34.20 from pot
*** SUMMARY ***
Total pot $36 | Rake $1.80
Board [3c Js 3s Kh 3d]
Seat 1: qJr25HAtvv1w/7IBvjMM3g (button) mucked
Seat 2: Ogn4JDV3mp4ZDKO49IFzKA (small blind) showed [Ad Kd] and won ($34.20) with a full house, Threes full of Kings
Seat 3: L9njYvloJ1NdXjP8edHEAg (big blind) folded before Flop
Seat 4: mBRWbnUl8diyBO1qTJaNzw folded before Flop (didn't bet)
Seat 5: 0fXz44fzDo5QmhAaJCvFfA folded before Flop (didn't bet)
Seat 6: negfosHnGOZXSHpWDRKyBQ folded before Flop (didn't bet)
Seat 8: tkdBeXTJlFsZdioidNqLow folded before Flop (didn't bet)



PokerStars Game #59939452216:  Hold'em No Limit ($0.50/$1.00) - 2009/07/01 0:40:14 ET
Table 'VOs36P6NW+QyXeQ1B62kmA' 6-max Seat #3 is the button
Seat 1: AdLVjddOzm+sRNo1Bc3S6Q ($140.80 in chips)
Seat 2: KpnW5CcJ4Mg6MeclfKmLrw ($116.35 in chips)
Seat 3: TSuRyAHnUPCFjP7Z0rEE0w ($100 in chips)
Seat 4: w02zQzNydODiyV9THKgo9w ($35.80 in chips)
Seat 5: X7GlkHF+lkbarCLuZ4Uf0w ($24.25 in chips)
Seat 6: 6tvjsJrdmWg+g7FVrMnzXA ($61.90 in chips)
w02zQzNydODiyV9THKgo9w: posts small blind $0.50
X7GlkHF+lkbarCLuZ4Uf0w: posts big blind $1
*** HOLE CARDS ***
6tvjsJrdmWg+g7FVrMnzXA: folds
AdLVjddOzm+sRNo1Bc3S6Q: folds
KpnW5CcJ4Mg6MeclfKmLrw: raises $2 to $3
TSuRyAHnUPCFjP7Z0rEE0w: folds
w02zQzNydODiyV9THKgo9w: folds
X7GlkHF+lkbarCLuZ4Uf0w: folds
KpnW5CcJ4Mg6MeclfKmLrw collected $2.50 from pot
KpnW5CcJ4Mg6MeclfKmLrw: doesn't show hand
*** SUMMARY ***
Total pot $2.50 | Rake $0
Seat 1: AdLVjddOzm+sRNo1Bc3S6Q folded before Flop (didn't bet)
Seat 2: KpnW5CcJ4Mg6MeclfKmLrw collected ($2.50)
Seat 3: TSuRyAHnUPCFjP7Z0rEE0w (button) folded before Flop (didn't bet)
Seat 4: w02zQzNydODiyV9THKgo9w (small blind) folded before Flop
Seat 5: X7GlkHF+lkbarCLuZ4Uf0w (big blind) folded before Flop
Seat 6: 6tvjsJrdmWg+g7FVrMnzXA folded before Flop (didn't bet)



PokerStars Game #59939454680:  Hold'em No Limit ($0.50/$1.00) - 2009/07/01 0:40:18 ET
Table 'eU3bWpDDg3Z+9R4m4iVmog' 6-max Seat #6 is the button
Seat 1: TSuRyAHnUPCFjP7Z0rEE0w ($186.60 in chips)
Seat 2: 8CAoOzhmB8n3nRFf3V4BTg ($121.80 in chips)
Seat 3: U6tnjwZRpTnM+YkqkCjwyQ ($168.15 in chips)
Seat 4: GDVIsbEJ/DOJsMKE4Asz0A ($75.60 in chips)
Seat 5: AdLVjddOzm+sRNo1Bc3S6Q ($100 in chips)
Seat 6: hpxXcmRkXXI9HE5+5/j/0Q ($120.45 in chips)
TSuRyAHnUPCFjP7Z0rEE0w: posts small blind $0.50
8CAoOzhmB8n3nRFf3V4BTg: posts big blind $1
*** HOLE CARDS ***
U6tnjwZRpTnM+YkqkCjwyQ: raises $3 to $4
GDVIsbEJ/DOJsMKE4Asz0A: folds
AdLVjddOzm+sRNo1Bc3S6Q: folds
hpxXcmRkXXI9HE5+5/j/0Q: folds
TSuRyAHnUPCFjP7Z0rEE0w: folds
8CAoOzhmB8n3nRFf3V4BTg: calls $3
*** FLOP *** [3s 4h Js]
8CAoOzhmB8n3nRFf3V4BTg: checks
U6tnjwZRpTnM+YkqkCjwyQ: checks
*** TURN *** [3s 4h Js] [Jc]
8CAoOzhmB8n3nRFf3V4BTg: bets $5
U6tnjwZRpTnM+YkqkCjwyQ: calls $5
*** RIVER *** [3s 4h Js Jc] [Kd]
8CAoOzhmB8n3nRFf3V4BTg: bets $13
U6tnjwZRpTnM+YkqkCjwyQ: calls $13
*** SHOW DOWN ***
8CAoOzhmB8n3nRFf3V4BTg: shows [9s Tc] (a pair of Jacks)
U6tnjwZRpTnM+YkqkCjwyQ: shows [Ac Kc] (two pair, Kings and Jacks)
U6tnjwZRpTnM+YkqkCjwyQ collected $42.35 from pot
*** SUMMARY ***
Total pot $44.50 | Rake $2.15
Board [3s 4h Js Jc Kd]
Seat 1: TSuRyAHnUPCFjP7Z0rEE0w (small blind) folded before Flop
Seat 2: 8CAoOzhmB8n3nRFf3V4BTg (big blind) showed [9s Tc] and lost with a pair of Jacks
Seat 3: U6tnjwZRpTnM+YkqkCjwyQ showed [Ac Kc] and won ($42.35) with two pair, Kings and Jacks
Seat 4: GDVIsbEJ/DOJsMKE4Asz0A folded before Flop (didn't bet)
Seat 5: AdLVjddOzm+sRNo1Bc3S6Q folded before Flop (didn't bet)
Seat 6: hpxXcmRkXXI9HE5+5/j/0Q (button) folded before Flop (didn't bet)



PokerStars Game #59939455670:  Hold'em No Limit ($0.50/$1.00) - 2009/07/01 0:40:19 ET
Table 'Evb7VW0qfDhFkbgBL3gcqQ' 2-max Seat #1 is the button
Seat 1: NYi6JFscYNrofSXy4sM+Yw ($100 in chips)
Seat 2: mJHc7tEZG3SVIX7QQjb5EQ ($44.70 in chips)
NYi6JFscYNrofSXy4sM+Yw: posts small blind $0.50
mJHc7tEZG3SVIX7QQjb5EQ: posts big blind $1
*** HOLE CARDS ***
NYi6JFscYNrofSXy4sM+Yw: raises $2 to $3
mJHc7tEZG3SVIX7QQjb5EQ: raises $41.70 to $44.70 and is all-in
NYi6JFscYNrofSXy4sM+Yw: folds
mJHc7tEZG3SVIX7QQjb5EQ collected $6 from pot
mJHc7tEZG3SVIX7QQjb5EQ: doesn't show hand
*** SUMMARY ***
Total pot $6 | Rake $0
Seat 1: NYi6JFscYNrofSXy4sM+Yw (button) (small blind) folded before Flop
Seat 2: mJHc7tEZG3SVIX7QQjb5EQ (big blind) collected ($6)



PokerStars Game #59939456144:  Hold'em No Limit ($0.50/$1.00) - 2009/07/01 0:40:20 ET
Table 'rmZfTK+oSebeUPJNbWhdAA' 6-max Seat #6 is the button
Seat 1: xAU6q2/cwmby2sxmA8VcmA ($103.55 in chips)
Seat 2: z7O9PO/WEcqRouIydFhS9Q ($94 in chips)
Seat 3: 9yjOzGERLaEZS8CZ6YNHFg ($113.35 in chips)
Seat 4: OGMLOcTNYZXZU81au7ztUw ($135.50 in chips)
Seat 5: +xW7QemQU0Fxs+4TnqBRow ($100.50 in chips)
Seat 6: j7NIOHLZk7V2o9fOioO5ug ($131 in chips)
xAU6q2/cwmby2sxmA8VcmA: posts small blind $0.50
z7O9PO/WEcqRouIydFhS9Q: posts big blind $1
*** HOLE CARDS ***
9yjOzGERLaEZS8CZ6YNHFg: folds
OGMLOcTNYZXZU81au7ztUw: folds
+xW7QemQU0Fxs+4TnqBRow: folds
j7NIOHLZk7V2o9fOioO5ug: raises $2 to $3
xAU6q2/cwmby2sxmA8VcmA: folds
z7O9PO/WEcqRouIydFhS9Q: folds
j7NIOHLZk7V2o9fOioO5ug collected $2.50 from pot
j7NIOHLZk7V2o9fOioO5ug: doesn't show hand
*** SUMMARY ***
Total pot $2.50 | Rake $0
Seat 1: xAU6q2/cwmby2sxmA8VcmA (small blind) folded before Flop
Seat 2: z7O9PO/WEcqRouIydFhS9Q (big blind) folded before Flop
Seat 3: 9yjOzGERLaEZS8CZ6YNHFg folded before Flop (didn't bet)
Seat 4: OGMLOcTNYZXZU81au7ztUw folded before Flop (didn't bet)
Seat 5: +xW7QemQU0Fxs+4TnqBRow folded before Flop (didn't bet)
Seat 6: j7NIOHLZk7V2o9fOioO5ug (button) collected ($2.50)



PokerStars Game #59939458298:  Hold'em No Limit ($0.50/$1.00) - 2009/07/01 0:40:23 ET
Table '/RZcOwpZpHQ+OwPwjsbnRw' 6-max Seat #1 is the button
Seat 1: Zboa6dColKGHBjLPUakZjw ($56.70 in chips)
Seat 2: +xW7QemQU0Fxs+4TnqBRow ($128 in chips)
Seat 4: j7NIOHLZk7V2o9fOioO5ug ($100 in chips)
Seat 5: wx3sQGkVi2x9wJXuWNHPBw ($196.65 in chips)
Seat 6: XOIf9W+VAxhZqN+SYoyMKA ($288.55 in chips)
+xW7QemQU0Fxs+4TnqBRow: posts small blind $0.50
j7NIOHLZk7V2o9fOioO5ug: posts big blind $1
*** HOLE CARDS ***
wx3sQGkVi2x9wJXuWNHPBw: folds
XOIf9W+VAxhZqN+SYoyMKA: raises $2 to $3
Zboa6dColKGHBjLPUakZjw: folds
+xW7QemQU0Fxs+4TnqBRow: folds
j7NIOHLZk7V2o9fOioO5ug: folds
XOIf9W+VAxhZqN+SYoyMKA collected $2.50 from pot
XOIf9W+VAxhZqN+SYoyMKA: doesn't show hand
*** SUMMARY ***
Total pot $2.50 | Rake $0
Seat 1: Zboa6dColKGHBjLPUakZjw (button) folded before Flop (didn't bet)
Seat 2: +xW7QemQU0Fxs+4TnqBRow (small blind) folded before Flop
Seat 4: j7NIOHLZk7V2o9fOioO5ug (big blind) folded before Flop
Seat 5: wx3sQGkVi2x9wJXuWNHPBw folded before Flop (didn't bet)
Seat 6: XOIf9W+VAxhZqN+SYoyMKA collected ($2.50)



PokerStars Game #59939458746:  Hold'em No Limit ($0.50/$1.00) - 2009/07/01 0:40:24 ET
Table 'tyUh+jyNvrceIQdKMJjQ2wZFWj23PMihdwrNWv41OG/Qeat #1 is the button
Seat 1: o8A5MUdudVKu+pAwgZOX2w ($229.45 in chips)
Seat 3: TalCiLYHCd+ffkmR3auPvA ($54 in chips)
Seat 4: TSuRyAHnUPCFjP7Z0rEE0w ($121.25 in chips)
Seat 5: j7NIOHLZk7V2o9fOioO5ug ($113.10 in chips)
Seat 6: YsLQ3BAvgQHWXMAv3Wv6Hg ($160.75 in chips)
XvUbOIg94d25feWeQlOTVg will be allowed to play after the button
TalCiLYHCd+ffkmR3auPvA: posts small blind $0.50
TSuRyAHnUPCFjP7Z0rEE0w: posts big blind $1
*** HOLE CARDS ***
j7NIOHLZk7V2o9fOioO5ug: folds
YsLQ3BAvgQHWXMAv3Wv6Hg: raises $3 to $4
o8A5MUdudVKu+pAwgZOX2w: folds
TalCiLYHCd+ffkmR3auPvA: folds
TSuRyAHnUPCFjP7Z0rEE0w: folds
YsLQ3BAvgQHWXMAv3Wv6Hg collected $2.50 from pot
YsLQ3BAvgQHWXMAv3Wv6Hg: doesn't show hand
*** SUMMARY ***
Total pot $2.50 | Rake $0
Seat 1: o8A5MUdudVKu+pAwgZOX2w (button) folded before Flop (didn't bet)
Seat 3: TalCiLYHCd+ffkmR3auPvA (small blind) folded before Flop
Seat 4: TSuRyAHnUPCFjP7Z0rEE0w (big blind) folded before Flop
Seat 5: j7NIOHLZk7V2o9fOioO5ug folded before Flop (didn't bet)
Seat 6: YsLQ3BAvgQHWXMAv3Wv6Hg collected ($2.50)



PokerStars Game #59939459770:  Hold'em No Limit ($0.50/$1.00) - 2009/07/01 0:40:26 ET
Table '7Nl0ffnjeK44/vmeexh3MQ' 9-max Seat #8 is the button
Seat 1: s7D3Y+k4Cj4D1cXHv7oj+Q ($97.80 in chips)
Seat 2: kiakSwxX0e64PwYGAPQvLw ($31.85 in chips)
Seat 3: vR4IO10geOgvTW+LAUBv/A ($103 in chips)
Seat 4: bLbSOSmSOnqE0iTcH/5dxA ($100 in chips)
Seat 5: bL+QVeDcuEdzMGAGg2XJHg ($99.50 in chips)
Seat 6: FVs16t7GgfWgQWt4JxsObQ ($20 in chips)
Seat 8: zanka7aAZkigmZpfopXxxA ($253.70 in chips)
Seat 9: ouwUBGRKnKK9uhn1G4Lf+A ($95.50 in chips)
ouwUBGRKnKK9uhn1G4Lf+A: posts small blind $0.50
s7D3Y+k4Cj4D1cXHv7oj+Q: posts big blind $1
FVs16t7GgfWgQWt4JxsObQ: posts small blind $0.50
997ViqAtWn1FPjJqcffwcA: sits out
*** HOLE CARDS ***
kiakSwxX0e64PwYGAPQvLw: folds
vR4IO10geOgvTW+LAUBv/A: folds
bLbSOSmSOnqE0iTcH/5dxA: folds
bL+QVeDcuEdzMGAGg2XJHg: folds
FVs16t7GgfWgQWt4JxsObQ: calls $1
zanka7aAZkigmZpfopXxxA: folds
ouwUBGRKnKK9uhn1G4Lf+A: folds
s7D3Y+k4Cj4D1cXHv7oj+Q: checks
*** FLOP *** [7c Kh 8d]
s7D3Y+k4Cj4D1cXHv7oj+Q: checks
FVs16t7GgfWgQWt4JxsObQ: checks
*** TURN *** [7c Kh 8d] [3h]
s7D3Y+k4Cj4D1cXHv7oj+Q: bets $2
FVs16t7GgfWgQWt4JxsObQ: calls $2
*** RIVER *** [7c Kh 8d 3h] [3s]
s7D3Y+k4Cj4D1cXHv7oj+Q: checks
FVs16t7GgfWgQWt4JxsObQ: bets $3
s7D3Y+k4Cj4D1cXHv7oj+Q: calls $3
*** SHOW DOWN ***
FVs16t7GgfWgQWt4JxsObQ: shows [Jc 3c] (three of a kind, Threes)
s7D3Y+k4Cj4D1cXHv7oj+Q: mucks hand
FVs16t7GgfWgQWt4JxsObQ collected $12.40 from pot
*** SUMMARY ***
Total pot $13 | Rake $0.60
Board [7c Kh 8d 3h 3s]
Seat 1: s7D3Y+k4Cj4D1cXHv7oj+Q (big blind) mucked
Seat 2: kiakSwxX0e64PwYGAPQvLw folded before Flop (didn't bet)
Seat 3: vR4IO10geOgvTW+LAUBv/A folded before Flop (didn't bet)
Seat 4: bLbSOSmSOnqE0iTcH/5dxA folded before Flop (didn't bet)
Seat 5: bL+QVeDcuEdzMGAGg2XJHg folded before Flop (didn't bet)
Seat 6: FVs16t7GgfWgQWt4JxsObQ showed [Jc 3c] and won ($12.40) with three of a kind, Threes
Seat 8: zanka7aAZkigmZpfopXxxA (button) folded before Flop (didn't bet)
Seat 9: ouwUBGRKnKK9uhn1G4Lf+A (small blind) folded before Flop



PokerStars Game #59939463542:  Hold'em No Limit ($0.50/$1.00) - 2009/07/01 0:40:31 ET
Table 'vs/5jr6ciwjVQ5+Soc+u2A' 6-max Seat #6 is the button
Seat 1: 1C0rFAGdnnX4GWK9B0YPww ($24.50 in chips)
Seat 2: XOIf9W+VAxhZqN+SYoyMKA ($118.15 in chips)
Seat 3: G5ZSSN6RSON3gkNvk/SmYg ($152 in chips)
Seat 4: KpnW5CcJ4Mg6MeclfKmLrw ($108.30 in chips)
Seat 6: QHvTZcrKe6+maWUfVjP29Q ($105.10 in chips)
1C0rFAGdnnX4GWK9B0YPww: posts small blind $0.50
XOIf9W+VAxhZqN+SYoyMKA: posts big blind $1
*** HOLE CARDS ***
G5ZSSN6RSON3gkNvk/SmYg: folds
KpnW5CcJ4Mg6MeclfKmLrw: folds
QHvTZcrKe6+maWUfVjP29Q: folds
1C0rFAGdnnX4GWK9B0YPww: raises $3 to $4
XOIf9W+VAxhZqN+SYoyMKA: folds
1C0rFAGdnnX4GWK9B0YPww collected $2 from pot
*** SUMMARY ***
Total pot $2 | Rake $0
Seat 1: 1C0rFAGdnnX4GWK9B0YPww (small blind) collected ($2)
Seat 2: XOIf9W+VAxhZqN+SYoyMKA (big blind) folded before Flop
Seat 3: G5ZSSN6RSON3gkNvk/SmYg folded before Flop (didn't bet)
Seat 4: KpnW5CcJ4Mg6MeclfKmLrw folded before Flop (didn't bet)
Seat 6: QHvTZcrKe6+maWUfVjP29Q (button) folded before Flop (didn't bet)



PokerStars Game #59939463820:  Hold'em No Limit ($0.50/$1.00) - 2009/07/01 0:40:32 ET
Table 'Evb7VW0qfDhFkbgBL3gcqQ' 2-max Seat #2 is the button
Seat 1: NYi6JFscYNrofSXy4sM+Yw ($100 in chips)
Seat 2: mJHc7tEZG3SVIX7QQjb5EQ ($47.70 in chips)
mJHc7tEZG3SVIX7QQjb5EQ: posts small blind $0.50
NYi6JFscYNrofSXy4sM+Yw: posts big blind $1
*** HOLE CARDS ***
mJHc7tEZG3SVIX7QQjb5EQ: folds
NYi6JFscYNrofSXy4sM+Yw collected $1 from pot
*** SUMMARY ***
Total pot $1 | Rake $0
Seat 1: NYi6JFscYNrofSXy4sM+Yw (big blind) collected ($1)
Seat 2: mJHc7tEZG3SVIX7QQjb5EQ (button) (small blind) folded before Flop



PokerStars Game #59939464898:  Hold'em No Limit ($0.50/$1.00) - 2009/07/01 0:40:34 ET
Table 'LmXQK9xy3awB+qsPzI21Mw' 2-max Seat #1 is the button
Seat 1: NYi6JFscYNrofSXy4sM+Yw ($241.75 in chips)
Seat 2: TME8GvochpQAo8cmJwWmvA ($95.85 in chips)
NYi6JFscYNrofSXy4sM+Yw: posts small blind $0.50
TME8GvochpQAo8cmJwWmvA: posts big blind $1
*** HOLE CARDS ***
NYi6JFscYNrofSXy4sM+Yw: raises $2 to $3
TME8GvochpQAo8cmJwWmvA: calls $2
*** FLOP *** [3h Qh 9c]
TME8GvochpQAo8cmJwWmvA: checks
NYi6JFscYNrofSXy4sM+Yw: checks
*** TURN *** [3h Qh 9c] [7s]
TME8GvochpQAo8cmJwWmvA: checks
NYi6JFscYNrofSXy4sM+Yw: checks
*** RIVER *** [3h Qh 9c 7s] [8s]
TME8GvochpQAo8cmJwWmvA: checks
NYi6JFscYNrofSXy4sM+Yw: checks
*** SHOW DOWN ***
TME8GvochpQAo8cmJwWmvA: shows [Th 2h] (high card Queen)
NYi6JFscYNrofSXy4sM+Yw: shows [4c Kd] (high card King)
NYi6JFscYNrofSXy4sM+Yw collected $5.70 from pot
*** SUMMARY ***
Total pot $6 | Rake $0.30
Board [3h Qh 9c 7s 8s]
Seat 1: NYi6JFscYNrofSXy4sM+Yw (button) (small blind) showed [4c Kd] and won ($5.70) with high card King
Seat 2: TME8GvochpQAo8cmJwWmvA (big blind) showed [Th 2h] and lost with high card Queen



PokerStars Game #59939464970:  Hold'em No Limit ($0.50/$1.00) - 2009/07/01 0:40:34 ET
Table 'pHrhryH8jPNdQfY62f8v+g' 6-max Seat #4 is the button
Seat 2: RqgF7gRoKgRNW8Zoi1ty4A ($124.65 in chips)
Seat 3: j0aDOn9Nft1HLTQvGu1UwA ($14.40 in chips)
Seat 4: wenbG7TaM3H7h5kn78OFNw ($47.30 in chips)
Seat 5: r1/R7y0Ortgoz4lccgW8VA ($36.65 in chips)
Seat 6: xAU6q2/cwmby2sxmA8VcmA ($108.75 in chips)
r1/R7y0Ortgoz4lccgW8VA: posts small blind $0.50
xAU6q2/cwmby2sxmA8VcmA: posts big blind $1
fF4botNMr8/ieVPO1YYRLw: sits out
*** HOLE CARDS ***
RqgF7gRoKgRNW8Zoi1ty4A: folds
j0aDOn9Nft1HLTQvGu1UwA: raises $1 to $2
wenbG7TaM3H7h5kn78OFNw: folds
r1/R7y0Ortgoz4lccgW8VA: calls $1.50
xAU6q2/cwmby2sxmA8VcmA: raises $10 to $12
j0aDOn9Nft1HLTQvGu1UwA: folds
r1/R7y0Ortgoz4lccgW8VA: folds
j0aDOn9Nft1HLTQvGu1UwA leaves the table
xAU6q2/cwmby2sxmA8VcmA collected $6 from pot
*** SUMMARY ***
Total pot $6 | Rake $0
Seat 2: RqgF7gRoKgRNW8Zoi1ty4A folded before Flop (didn't bet)
Seat 3: j0aDOn9Nft1HLTQvGu1UwA folded before Flop
Seat 4: wenbG7TaM3H7h5kn78OFNw (button) folded before Flop (didn't bet)
Seat 5: r1/R7y0Ortgoz4lccgW8VA (small blind) folded before Flop
Seat 6: xAU6q2/cwmby2sxmA8VcmA (big blind) collected ($6)



PokerStars Game #59939465224:  Hold'em No Limit ($0.50/$1.00) - 2009/07/01 0:40:34 ET
Table '/RZcOwpZpHQ+OwPwjsbnRw' 6-max Seat #2 is the button
Seat 1: Zboa6dColKGHBjLPUakZjw ($56.70 in chips)
Seat 2: +xW7QemQU0Fxs+4TnqBRow ($127.50 in chips)
Seat 4: j7NIOHLZk7V2o9fOioO5ug ($100 in chips)
Seat 5: wx3sQGkVi2x9wJXuWNHPBw ($196.65 in chips)
Seat 6: XOIf9W+VAxhZqN+SYoyMKA ($290.05 in chips)
j7NIOHLZk7V2o9fOioO5ug: posts small blind $0.50
wx3sQGkVi2x9wJXuWNHPBw: posts big blind $1
*** HOLE CARDS ***
XOIf9W+VAxhZqN+SYoyMKA: folds
Zboa6dColKGHBjLPUakZjw: folds
+xW7QemQU0Fxs+4TnqBRow: raises $2 to $3
j7NIOHLZk7V2o9fOioO5ug: folds
wx3sQGkVi2x9wJXuWNHPBw: folds
+xW7QemQU0Fxs+4TnqBRow collected $2.50 from pot
+xW7QemQU0Fxs+4TnqBRow: doesn't show hand
*** SUMMARY ***
Total pot $2.50 | Rake $0
Seat 1: Zboa6dColKGHBjLPUakZjw folded before Flop (didn't bet)
Seat 2: +xW7QemQU0Fxs+4TnqBRow (button) collected ($2.50)
Seat 4: j7NIOHLZk7V2o9fOioO5ug (small blind) folded before Flop
Seat 5: wx3sQGkVi2x9wJXuWNHPBw (big blind) folded before Flop
Seat 6: XOIf9W+VAxhZqN+SYoyMKA folded before Flop (didn't bet)



PokerStars Game #59939465226:  Hold'em No Limit ($0.50/$1.00) - 2009/07/01 0:40:34 ET
Table 'cBDNutyLBKEk9+ptwsKmTw' 6-max Seat #3 is the button
Seat 1: xAU6q2/cwmby2sxmA8VcmA ($100 in chips)
Seat 3: G5ZSSN6RSON3gkNvk/SmYg ($108.40 in chips)
Seat 4: 3q7F5QtzC30pSrn0nl9i+A ($23.80 in chips)
Seat 5: OGMLOcTNYZXZU81au7ztUw ($135.45 in chips)
Seat 6: NqVlOSH2lp+pp/TK3vvK5g ($70.80 in chips)
3q7F5QtzC30pSrn0nl9i+A: posts small blind $0.50
OGMLOcTNYZXZU81au7ztUw: posts big blind $1
*** HOLE CARDS ***
NqVlOSH2lp+pp/TK3vvK5g: calls $1
5lY8d6Cnm4HUkt/8FZSj4g joins the table at seat #2
xAU6q2/cwmby2sxmA8VcmA: folds
G5ZSSN6RSON3gkNvk/SmYg: folds
3q7F5QtzC30pSrn0nl9i+A: folds
OGMLOcTNYZXZU81au7ztUw: checks
*** FLOP *** [7c Tc 3c]
OGMLOcTNYZXZU81au7ztUw: checks
NqVlOSH2lp+pp/TK3vvK5g: checks
*** TURN *** [7c Tc 3c] [Td]
OGMLOcTNYZXZU81au7ztUw: checks
NqVlOSH2lp+pp/TK3vvK5g: bets $1
OGMLOcTNYZXZU81au7ztUw: folds
NqVlOSH2lp+pp/TK3vvK5g collected $2.40 from pot
*** SUMMARY ***
Total pot $2.50 | Rake $0.10
Board [7c Tc 3c Td]
Seat 1: xAU6q2/cwmby2sxmA8VcmA folded before Flop (didn't bet)
Seat 3: G5ZSSN6RSON3gkNvk/SmYg (button) folded before Flop (didn't bet)
Seat 4: 3q7F5QtzC30pSrn0nl9i+A (small blind) folded before Flop
Seat 5: OGMLOcTNYZXZU81au7ztUw (big blind) folded on the Turn
Seat 6: NqVlOSH2lp+pp/TK3vvK5g collected ($2.40)



PokerStars Game #59939467416:  Hold'em No Limit ($0.50/$1.00) - 2009/07/01 0:40:37 ET
Table 'Evb7VW0qfDhFkbgBL3gcqQ' 2-max Seat #1 is the button
Seat 1: NYi6JFscYNrofSXy4sM+Yw ($100.50 in chips)
Seat 2: mJHc7tEZG3SVIX7QQjb5EQ ($47.20 in chips)
NYi6JFscYNrofSXy4sM+Yw: posts small blind $0.50
mJHc7tEZG3SVIX7QQjb5EQ: posts big blind $1
*** HOLE CARDS ***
NYi6JFscYNrofSXy4sM+Yw: raises $2 to $3
mJHc7tEZG3SVIX7QQjb5EQ: calls $2
*** FLOP *** [Qs 3s 7c]
mJHc7tEZG3SVIX7QQjb5EQ: checks
NYi6JFscYNrofSXy4sM+Yw: bets $3
mJHc7tEZG3SVIX7QQjb5EQ: calls $3
*** TURN *** [Qs 3s 7c] [7s]
mJHc7tEZG3SVIX7QQjb5EQ: checks
NYi6JFscYNrofSXy4sM+Yw: checks
*** RIVER *** [Qs 3s 7c 7s] [4h]
mJHc7tEZG3SVIX7QQjb5EQ: bets $5
NYi6JFscYNrofSXy4sM+Yw: folds
mJHc7tEZG3SVIX7QQjb5EQ collected $11.50 from pot
mJHc7tEZG3SVIX7QQjb5EQ: doesn't show hand
*** SUMMARY ***
Total pot $12 | Rake $0.50
Board [Qs 3s 7c 7s 4h]
Seat 1: NYi6JFscYNrofSXy4sM+Yw (button) (small blind) folded on the River
Seat 2: mJHc7tEZG3SVIX7QQjb5EQ (big blind) collected ($11.50)



PokerStars Game #59939467704:  Hold'em No Limit ($0.50/$1.00) - 2009/07/01 0:40:38 ET
Table 'FKpXUINE6M3UxHG4zaMhHA' 6-max Seat #6 is the button
Seat 1: qNezhXOOUXqwG7b9X5XJAA ($100 in chips)
Seat 2: nDKgwwXJ45hcJfJe01cdxQ ($38.35 in chips)
Seat 3: GOHDYcxP1gP29069kB9HFw ($121.05 in chips)
Seat 4: vw0eLNLy3Huccth4CUZNPQ ($74.30 in chips)
Seat 5: eUBBn2R56C1IQ6Cs/vitwg ($100 in chips)
Seat 6: b2a+5TkFf4xJN/Ihhma58Q ($13.40 in chips)
qNezhXOOUXqwG7b9X5XJAA: posts small blind $0.50
nDKgwwXJ45hcJfJe01cdxQ: posts big blind $1
*** HOLE CARDS ***
GOHDYcxP1gP29069kB9HFw: folds
vw0eLNLy3Huccth4CUZNPQ: folds
eUBBn2R56C1IQ6Cs/vitwg: raises $2 to $3
b2a+5TkFf4xJN/Ihhma58Q: folds
qNezhXOOUXqwG7b9X5XJAA: folds
nDKgwwXJ45hcJfJe01cdxQ: folds
eUBBn2R56C1IQ6Cs/vitwg collected $2.50 from pot
*** SUMMARY ***
Total pot $2.50 | Rake $0
Seat 1: qNezhXOOUXqwG7b9X5XJAA (small blind) folded before Flop
Seat 2: nDKgwwXJ45hcJfJe01cdxQ (big blind) folded before Flop
Seat 3: GOHDYcxP1gP29069kB9HFw folded before Flop (didn't bet)
Seat 4: vw0eLNLy3Huccth4CUZNPQ folded before Flop (didn't bet)
Seat 5: eUBBn2R56C1IQ6Cs/vitwg collected ($2.50)
Seat 6: b2a+5TkFf4xJN/Ihhma58Q (button) folded before Flop (didn't bet)



PokerStars Game #59939468166:  Hold'em No Limit ($0.50/$1.00) - 2009/07/01 0:40:39 ET
Table '+cA8mcmhaedZ7YcrDdhmeQ' 6-max Seat #2 is the button
Seat 1: lsLuWlcPA3Rh7kJVLzMh0Q ($308.70 in chips)
Seat 2: RqgF7gRoKgRNW8Zoi1ty4A ($102.70 in chips)
Seat 3: 7H5WkGzGvsv56y1iaqHvRg ($27.55 in chips)
Seat 4: LjL3AIERHn559yyW1mTUYQ ($155.50 in chips)
Seat 5: iHo1oDbrEVJ8nEGdaPrICw ($102.70 in chips)
Seat 6: YfsTQsY/fxb+YqbdclTHuw ($62.55 in chips)
7H5WkGzGvsv56y1iaqHvRg: posts small blind $0.50
LjL3AIERHn559yyW1mTUYQ: posts big blind $1
*** HOLE CARDS ***
iHo1oDbrEVJ8nEGdaPrICw: raises $2 to $3
YfsTQsY/fxb+YqbdclTHuw: folds
lsLuWlcPA3Rh7kJVLzMh0Q: folds
RqgF7gRoKgRNW8Zoi1ty4A: calls $3
7H5WkGzGvsv56y1iaqHvRg: folds
LjL3AIERHn559yyW1mTUYQ: folds
*** FLOP *** [4d 6s 6c]
iHo1oDbrEVJ8nEGdaPrICw: bets $5
RqgF7gRoKgRNW8Zoi1ty4A: folds
iHo1oDbrEVJ8nEGdaPrICw collected $7.15 from pot
*** SUMMARY ***
Total pot $7.50 | Rake $0.35
Board [4d 6s 6c]
Seat 1: lsLuWlcPA3Rh7kJVLzMh0Q folded before Flop (didn't bet)
Seat 2: RqgF7gRoKgRNW8Zoi1ty4A (button) folded on the Flop
Seat 3: 7H5WkGzGvsv56y1iaqHvRg (small blind) folded before Flop
Seat 4: LjL3AIERHn559yyW1mTUYQ (big blind) folded before Flop
Seat 5: iHo1oDbrEVJ8nEGdaPrICw collected ($7.15)
Seat 6: YfsTQsY/fxb+YqbdclTHuw folded before Flop (didn't bet)



PokerStars Game #59939469938:  Hold'em No Limit ($0.50/$1.00) - 2009/07/01 0:40:41 ET
Table '8jIjWCPY0NGprquL+xcMFg' 9-max Seat #7 is the button
Seat 1: vR4IO10geOgvTW+LAUBv/A ($135.10 in chips)
Seat 2: rR1qGAf9Q9RYorKYWH3VKw ($5.20 in chips)
Seat 3: tjhwe1V98x2spSoUQER3HQ ($100 in chips)
Seat 4: by0z+YmujwI6Bf4qRFE8vA ($140.95 in chips)
Seat 6: GTQkFJtSkbVbnGCktp6e3g ($108.35 in chips)
Seat 7: O3CGPwwUmamrCNHccOilrg ($48.55 in chips)
Seat 8: 9swGhtpERPngKPtvpoZkoQ ($154.85 in chips)
Seat 9: negfosHnGOZXSHpWDRKyBQ ($20 in chips)
9swGhtpERPngKPtvpoZkoQ: posts small blind $0.50
negfosHnGOZXSHpWDRKyBQ: posts big blind $1
*** HOLE CARDS ***
vR4IO10geOgvTW+LAUBv/A: folds
rR1qGAf9Q9RYorKYWH3VKw: folds
tjhwe1V98x2spSoUQER3HQ: folds
by0z+YmujwI6Bf4qRFE8vA: calls $1
GTQkFJtSkbVbnGCktp6e3g: folds
O3CGPwwUmamrCNHccOilrg: calls $1
9swGhtpERPngKPtvpoZkoQ: folds
negfosHnGOZXSHpWDRKyBQ: checks
*** FLOP *** [Tc 4c 4h]
negfosHnGOZXSHpWDRKyBQ: checks
by0z+YmujwI6Bf4qRFE8vA: bets $3
O3CGPwwUmamrCNHccOilrg: folds
negfosHnGOZXSHpWDRKyBQ: folds
by0z+YmujwI6Bf4qRFE8vA collected $3.35 from pot
*** SUMMARY ***
Total pot $3.50 | Rake $0.15
Board [Tc 4c 4h]
Seat 1: vR4IO10geOgvTW+LAUBv/A folded before Flop (didn't bet)
Seat 2: rR1qGAf9Q9RYorKYWH3VKw folded before Flop (didn't bet)
Seat 3: tjhwe1V98x2spSoUQER3HQ folded before Flop (didn't bet)
Seat 4: by0z+YmujwI6Bf4qRFE8vA collected ($3.35)
Seat 6: GTQkFJtSkbVbnGCktp6e3g folded before Flop (didn't bet)
Seat 7: O3CGPwwUmamrCNHccOilrg (button) folded on the Flop
Seat 8: 9swGhtpERPngKPtvpoZkoQ (small blind) folded before Flop
Seat 9: negfosHnGOZXSHpWDRKyBQ (big blind) folded on the Flop



PokerStars Game #59939471532:  Hold'em No Limit ($0.50/$1.00) - 2009/07/01 0:40:44 ET
Table 'VOs36P6NW+QyXeQ1B62kmA' 6-max Seat #4 is the button
Seat 1: AdLVjddOzm+sRNo1Bc3S6Q ($140.80 in chips)
Seat 2: KpnW5CcJ4Mg6MeclfKmLrw ($117.85 in chips)
Seat 3: TSuRyAHnUPCFjP7Z0rEE0w ($100 in chips)
Seat 4: w02zQzNydODiyV9THKgo9w ($35.30 in chips)
Seat 5: X7GlkHF+lkbarCLuZ4Uf0w ($23.25 in chips)
Seat 6: 6tvjsJrdmWg+g7FVrMnzXA ($61.90 in chips)
X7GlkHF+lkbarCLuZ4Uf0w: posts small blind $0.50
6tvjsJrdmWg+g7FVrMnzXA: posts big blind $1
*** HOLE CARDS ***
AdLVjddOzm+sRNo1Bc3S6Q: folds
KpnW5CcJ4Mg6MeclfKmLrw: folds
TSuRyAHnUPCFjP7Z0rEE0w: folds
w02zQzNydODiyV9THKgo9w: raises $3 to $4
X7GlkHF+lkbarCLuZ4Uf0w: folds
6tvjsJrdmWg+g7FVrMnzXA: folds
w02zQzNydODiyV9THKgo9w collected $2.50 from pot
*** SUMMARY ***
Total pot $2.50 | Rake $0
Seat 1: AdLVjddOzm+sRNo1Bc3S6Q folded before Flop (didn't bet)
Seat 2: KpnW5CcJ4Mg6MeclfKmLrw folded before Flop (didn't bet)
Seat 3: TSuRyAHnUPCFjP7Z0rEE0w folded before Flop (didn't bet)
Seat 4: w02zQzNydODiyV9THKgo9w (button) collected ($2.50)
Seat 5: X7GlkHF+lkbarCLuZ4Uf0w (small blind) folded before Flop
Seat 6: 6tvjsJrdmWg+g7FVrMnzXA (big blind) folded before Flop



PokerStars Game #59939471890:  Hold'em No Limit ($0.50/$1.00) - 2009/07/01 0:40:45 ET
Table 'rmZfTK+oSebeUPJNbWhdAA' 6-max Seat #1 is the button
Seat 1: xAU6q2/cwmby2sxmA8VcmA ($103.05 in chips)
Seat 2: z7O9PO/WEcqRouIydFhS9Q ($93 in chips)
Seat 3: 9yjOzGERLaEZS8CZ6YNHFg ($113.35 in chips)
Seat 4: OGMLOcTNYZXZU81au7ztUw ($135.50 in chips)
Seat 5: +xW7QemQU0Fxs+4TnqBRow ($100.50 in chips)
Seat 6: j7NIOHLZk7V2o9fOioO5ug ($132.50 in chips)
z7O9PO/WEcqRouIydFhS9Q: posts small blind $0.50
9yjOzGERLaEZS8CZ6YNHFg: posts big blind $1
*** HOLE CARDS ***
OGMLOcTNYZXZU81au7ztUw: raises $2 to $3
+xW7QemQU0Fxs+4TnqBRow: folds
j7NIOHLZk7V2o9fOioO5ug: folds
xAU6q2/cwmby2sxmA8VcmA: folds
z7O9PO/WEcqRouIydFhS9Q: folds
9yjOzGERLaEZS8CZ6YNHFg: folds
OGMLOcTNYZXZU81au7ztUw collected $2.50 from pot
OGMLOcTNYZXZU81au7ztUw: doesn't show hand
*** SUMMARY ***
Total pot $2.50 | Rake $0
Seat 1: xAU6q2/cwmby2sxmA8VcmA (button) folded before Flop (didn't bet)
Seat 2: z7O9PO/WEcqRouIydFhS9Q (small blind) folded before Flop
Seat 3: 9yjOzGERLaEZS8CZ6YNHFg (big blind) folded before Flop
Seat 4: OGMLOcTNYZXZU81au7ztUw collected ($2.50)
Seat 5: +xW7QemQU0Fxs+4TnqBRow folded before Flop (didn't bet)
Seat 6: j7NIOHLZk7V2o9fOioO5ug folded before Flop (didn't bet)



PokerStars Game #59939472332:  Hold'em No Limit ($0.50/$1.00) - 2009/07/01 0:40:45 ET
Table 'MUPc8FEpe/nR0BKSeReX6Q' 6-max Seat #5 is the button
Seat 1: YsLQ3BAvgQHWXMAv3Wv6Hg ($115.35 in chips)
Seat 2: xAU6q2/cwmby2sxmA8VcmA ($114.30 in chips)
Seat 3: wx3sQGkVi2x9wJXuWNHPBw ($221.55 in chips)
Seat 4: ZA1bp6g8IwtTxkUE4eCjDQ ($172.15 in chips)
Seat 5: UBZQqpnJZdTYYY1FTb0rLA ($100 in chips)
Seat 6: oxnw0GLLpFanjhGkxfRSqA ($58.50 in chips)
oxnw0GLLpFanjhGkxfRSqA: posts small blind $0.50
YsLQ3BAvgQHWXMAv3Wv6Hg: posts big blind $1
*** HOLE CARDS ***
xAU6q2/cwmby2sxmA8VcmA: folds
wx3sQGkVi2x9wJXuWNHPBw: folds
ZA1bp6g8IwtTxkUE4eCjDQ: folds
UBZQqpnJZdTYYY1FTb0rLA: raises $2 to $3
oxnw0GLLpFanjhGkxfRSqA: folds
YsLQ3BAvgQHWXMAv3Wv6Hg: folds
UBZQqpnJZdTYYY1FTb0rLA collected $2.50 from pot
UBZQqpnJZdTYYY1FTb0rLA: doesn't show hand
*** SUMMARY ***
Total pot $2.50 | Rake $0
Seat 1: YsLQ3BAvgQHWXMAv3Wv6Hg (big blind) folded before Flop
Seat 2: xAU6q2/cwmby2sxmA8VcmA folded before Flop (didn't bet)
Seat 3: wx3sQGkVi2x9wJXuWNHPBw folded before Flop (didn't bet)
Seat 4: ZA1bp6g8IwtTxkUE4eCjDQ folded before Flop (didn't bet)
Seat 5: UBZQqpnJZdTYYY1FTb0rLA (button) collected ($2.50)
Seat 6: oxnw0GLLpFanjhGkxfRSqA (small blind) folded before Flop



PokerStars Game #59939472890:  Hold'em No Limit ($0.50/$1.00) - 2009/07/01 0:40:46 ET
Table 'tyUh+jyNvrceIQdKMJjQ2wZFWj23PMihdwrNWv41OG/Qeat #3 is the button
Seat 1: o8A5MUdudVKu+pAwgZOX2w ($229.45 in chips)
Seat 2: XvUbOIg94d25feWeQlOTVg ($60 in chips)
Seat 3: TalCiLYHCd+ffkmR3auPvA ($53.50 in chips)
Seat 4: TSuRyAHnUPCFjP7Z0rEE0w ($120.25 in chips)
Seat 5: j7NIOHLZk7V2o9fOioO5ug ($113.10 in chips)
Seat 6: YsLQ3BAvgQHWXMAv3Wv6Hg ($162.25 in chips)
TSuRyAHnUPCFjP7Z0rEE0w: posts small blind $0.50
j7NIOHLZk7V2o9fOioO5ug: posts big blind $1
XvUbOIg94d25feWeQlOTVg: posts big blind $1
*** HOLE CARDS ***
YsLQ3BAvgQHWXMAv3Wv6Hg: raises $3 to $4
o8A5MUdudVKu+pAwgZOX2w: folds
XvUbOIg94d25feWeQlOTVg: folds
TalCiLYHCd+ffkmR3auPvA: calls $4
TSuRyAHnUPCFjP7Z0rEE0w: folds
j7NIOHLZk7V2o9fOioO5ug: folds
*** FLOP *** [5h 4d 2s]
YsLQ3BAvgQHWXMAv3Wv6Hg: bets $7
TalCiLYHCd+ffkmR3auPvA: raises $10 to $17
YsLQ3BAvgQHWXMAv3Wv6Hg: folds
TalCiLYHCd+ffkmR3auPvA collected $23.30 from pot
TalCiLYHCd+ffkmR3auPvA: doesn't show hand
*** SUMMARY ***
Total pot $24.50 | Rake $1.20
Board [5h 4d 2s]
Seat 1: o8A5MUdudVKu+pAwgZOX2w folded before Flop (didn't bet)
Seat 2: XvUbOIg94d25feWeQlOTVg folded before Flop
Seat 3: TalCiLYHCd+ffkmR3auPvA (button) collected ($23.30)
Seat 4: TSuRyAHnUPCFjP7Z0rEE0w (small blind) folded before Flop
Seat 5: j7NIOHLZk7V2o9fOioO5ug (big blind) folded before Flop
Seat 6: YsLQ3BAvgQHWXMAv3Wv6Hg folded on the Flop



PokerStars Game #59939472388:  Hold'em No Limit ($0.50/$1.00) - 2009/07/01 0:40:46 ET
Table 'uNlePsyMIqzM691Xkrlk6Q' 9-max Seat #7 is the button
Seat 1: bLbSOSmSOnqE0iTcH/5dxA ($100 in chips)
Seat 2: +OqpStnt0FqbCfyHAWaLbg ($79.15 in chips)
Seat 3: h7qXkU57Bb8ZuPwMyxR8Ug ($9 in chips)
Seat 4: TZcz9MEWDA+WydgGruqqbw ($102.65 in chips)
Seat 5: 3obndzTJ6fECz8+wWhMd1w ($18.50 in chips)
Seat 6: uMPEfCcGCfsxmy53tVUMug ($110.60 in chips)
Seat 7: w6cw9nzN7AvkkHBVVjykoQ ($42.40 in chips)
Seat 8: OsLmX3x/19szSV115TpL/Q ($45.80 in chips)
Seat 9: vR4IO10geOgvTW+LAUBv/A ($121.25 in chips)
OsLmX3x/19szSV115TpL/Q: posts small blind $0.50
vR4IO10geOgvTW+LAUBv/A: posts big blind $1
*** HOLE CARDS ***
bLbSOSmSOnqE0iTcH/5dxA: calls $1
+OqpStnt0FqbCfyHAWaLbg: calls $1
h7qXkU57Bb8ZuPwMyxR8Ug: calls $1
TZcz9MEWDA+WydgGruqqbw: folds
3obndzTJ6fECz8+wWhMd1w: folds
uMPEfCcGCfsxmy53tVUMug: folds
w6cw9nzN7AvkkHBVVjykoQ: calls $1
OsLmX3x/19szSV115TpL/Q: calls $0.50
vR4IO10geOgvTW+LAUBv/A: checks
*** FLOP *** [4h 3d 3h]
OsLmX3x/19szSV115TpL/Q: checks
vR4IO10geOgvTW+LAUBv/A: bets $2
bLbSOSmSOnqE0iTcH/5dxA: folds
+OqpStnt0FqbCfyHAWaLbg: folds
h7qXkU57Bb8ZuPwMyxR8Ug: calls $2
w6cw9nzN7AvkkHBVVjykoQ: folds
OsLmX3x/19szSV115TpL/Q: folds
*** TURN *** [4h 3d 3h] [2c]
vR4IO10geOgvTW+LAUBv/A: bets $6
h7qXkU57Bb8ZuPwMyxR8Ug: calls $6 and is all-in
*** RIVER *** [4h 3d 3h 2c] [Kh]
*** SHOW DOWN ***
vR4IO10geOgvTW+LAUBv/A: shows [9h 3s] (three of a kind, Threes)
h7qXkU57Bb8ZuPwMyxR8Ug: shows [3c Kc] (a full house, Threes full of Kings)
h7qXkU57Bb8ZuPwMyxR8Ug collected $20.95 from pot
OsLmX3x/19szSV115TpL/Q is sitting out
*** SUMMARY ***
Total pot $22 | Rake $1.05
Board [4h 3d 3h 2c Kh]
Seat 1: bLbSOSmSOnqE0iTcH/5dxA folded on the Flop
Seat 2: +OqpStnt0FqbCfyHAWaLbg folded on the Flop
Seat 3: h7qXkU57Bb8ZuPwMyxR8Ug showed [3c Kc] and won ($20.95) with a full house, Threes full of Kings
Seat 4: TZcz9MEWDA+WydgGruqqbw folded before Flop (didn't bet)
Seat 5: 3obndzTJ6fECz8+wWhMd1w folded before Flop (didn't bet)
Seat 6: uMPEfCcGCfsxmy53tVUMug folded before Flop (didn't bet)
Seat 7: w6cw9nzN7AvkkHBVVjykoQ (button) folded on the Flop
Seat 8: OsLmX3x/19szSV115TpL/Q (small blind) folded on the Flop
Seat 9: vR4IO10geOgvTW+LAUBv/A (big blind) showed [9h 3s] and lost with three of a kind, Threes



PokerStars Game #59939475870:  Hold'em No Limit ($0.50/$1.00) - 2009/07/01 0:40:51 ET
Table 'GxCPo/gd3OSthkYrAxJngg' 6-max Seat #2 is the button
Seat 1: sH8BpAFP+jGFxCgVpD1Lew ($253.95 in chips)
Seat 2: YExX2paeIHrmfIwV1ivM/w ($76.70 in chips)
Seat 3: o6plE+MSW4XFNTeONe16xg ($33.10 in chips)
Seat 4: YMJG+F++3Aj6P8dAWda5fw ($108.15 in chips)
Seat 5: G5ZSSN6RSON3gkNvk/SmYg ($111.25 in chips)
Seat 6: sS9IXedL3MiRmpVXhAILhw ($101.95 in chips)
o6plE+MSW4XFNTeONe16xg: posts small blind $0.50
YMJG+F++3Aj6P8dAWda5fw: posts big blind $1
*** HOLE CARDS ***
G5ZSSN6RSON3gkNvk/SmYg: folds
sS9IXedL3MiRmpVXhAILhw: folds
sH8BpAFP+jGFxCgVpD1Lew: folds
YExX2paeIHrmfIwV1ivM/w: raises $2 to $3
o6plE+MSW4XFNTeONe16xg: folds
YMJG+F++3Aj6P8dAWda5fw: folds
YExX2paeIHrmfIwV1ivM/w collected $2.50 from pot
*** SUMMARY ***
Total pot $2.50 | Rake $0
Seat 1: sH8BpAFP+jGFxCgVpD1Lew folded before Flop (didn't bet)
Seat 2: YExX2paeIHrmfIwV1ivM/w (button) collected ($2.50)
Seat 3: o6plE+MSW4XFNTeONe16xg (small blind) folded before Flop
Seat 4: YMJG+F++3Aj6P8dAWda5fw (big blind) folded before Flop
Seat 5: G5ZSSN6RSON3gkNvk/SmYg folded before Flop (didn't bet)
Seat 6: sS9IXedL3MiRmpVXhAILhw folded before Flop (didn't bet)



PokerStars Game #59939476240:  Hold'em No Limit ($0.50/$1.00) - 2009/07/01 0:40:51 ET
Table 'vs/5jr6ciwjVQ5+Soc+u2A' 6-max Seat #1 is the button
Seat 1: 1C0rFAGdnnX4GWK9B0YPww ($25.50 in chips)
Seat 2: XOIf9W+VAxhZqN+SYoyMKA ($117.15 in chips)
Seat 3: G5ZSSN6RSON3gkNvk/SmYg ($152 in chips)
Seat 4: KpnW5CcJ4Mg6MeclfKmLrw ($108.30 in chips)
Seat 6: QHvTZcrKe6+maWUfVjP29Q ($105.10 in chips)
XOIf9W+VAxhZqN+SYoyMKA: posts small blind $0.50
G5ZSSN6RSON3gkNvk/SmYg: posts big blind $1
*** HOLE CARDS ***
KpnW5CcJ4Mg6MeclfKmLrw: raises $3 to $4
QHvTZcrKe6+maWUfVjP29Q: calls $4
1C0rFAGdnnX4GWK9B0YPww: folds
imUnjybOc/YBYCgM7m/qSA joins the table at seat #5
XOIf9W+VAxhZqN+SYoyMKA: raises $11 to $15
G5ZSSN6RSON3gkNvk/SmYg: folds
KpnW5CcJ4Mg6MeclfKmLrw: folds
QHvTZcrKe6+maWUfVjP29Q: folds
XOIf9W+VAxhZqN+SYoyMKA collected $13 from pot
XOIf9W+VAxhZqN+SYoyMKA: doesn't show hand
*** SUMMARY ***
Total pot $13 | Rake $0
Seat 1: 1C0rFAGdnnX4GWK9B0YPww (button) folded before Flop (didn't bet)
Seat 2: XOIf9W+VAxhZqN+SYoyMKA (small blind) collected ($13)
Seat 3: G5ZSSN6RSON3gkNvk/SmYg (big blind) folded before Flop
Seat 4: KpnW5CcJ4Mg6MeclfKmLrw folded before Flop
Seat 6: QHvTZcrKe6+maWUfVjP29Q folded before Flop



PokerStars Game #59939477078:  Hold'em No Limit ($0.50/$1.00) - 2009/07/01 0:40:53 ET
Table 'LmXQK9xy3awB+qsPzI21Mw' 2-max Seat #2 is the button
Seat 1: NYi6JFscYNrofSXy4sM+Yw ($244.45 in chips)
Seat 2: TME8GvochpQAo8cmJwWmvA ($92.85 in chips)
TME8GvochpQAo8cmJwWmvA: posts small blind $0.50
NYi6JFscYNrofSXy4sM+Yw: posts big blind $1
*** HOLE CARDS ***
TME8GvochpQAo8cmJwWmvA: raises $1 to $2
NYi6JFscYNrofSXy4sM+Yw: folds
TME8GvochpQAo8cmJwWmvA collected $2 from pot
TME8GvochpQAo8cmJwWmvA: doesn't show hand
*** SUMMARY ***
Total pot $2 | Rake $0
Seat 1: NYi6JFscYNrofSXy4sM+Yw (big blind) folded before Flop
Seat 2: TME8GvochpQAo8cmJwWmvA (button) (small blind) collected ($2)



PokerStars Game #59939479498:  Hold'em No Limit ($0.50/$1.00) - 2009/07/01 0:40:56 ET
Table 'N2bNCDHL96aCQDvZIh+yQQ' 6-max Seat #1 is the button
Seat 1: iHo1oDbrEVJ8nEGdaPrICw ($100 in chips)
Seat 2: KpnW5CcJ4Mg6MeclfKmLrw ($114.10 in chips)
Seat 3: Qy/UBNbD2HaA0Ogxg8Sf3w ($198 in chips)
Seat 4: uCqEjnxh2/vFBjKYkfTOkw ($172.40 in chips)
Seat 5: rHlMOfR7kpQQxe+PFQz0xQ ($30.75 in chips)
Seat 6: TSuRyAHnUPCFjP7Z0rEE0w ($100 in chips)
KpnW5CcJ4Mg6MeclfKmLrw: posts small blind $0.50
Qy/UBNbD2HaA0Ogxg8Sf3w: posts big blind $1
*** HOLE CARDS ***
uCqEjnxh2/vFBjKYkfTOkw: folds
rHlMOfR7kpQQxe+PFQz0xQ: folds
iHo1oDbrEVJ8nEGdaPrICw said, "thats reeeetarded"
TSuRyAHnUPCFjP7Z0rEE0w: folds
iHo1oDbrEVJ8nEGdaPrICw: raises $2 to $3
KpnW5CcJ4Mg6MeclfKmLrw: raises $9 to $12
Qy/UBNbD2HaA0Ogxg8Sf3w: folds
iHo1oDbrEVJ8nEGdaPrICw said, "lol and you 3bet me the next hand"
iHo1oDbrEVJ8nEGdaPrICw said, "you guys rule"
iHo1oDbrEVJ8nEGdaPrICw: folds
KpnW5CcJ4Mg6MeclfKmLrw collected $7 from pot
KpnW5CcJ4Mg6MeclfKmLrw: doesn't show hand
*** SUMMARY ***
Total pot $7 | Rake $0
Seat 1: iHo1oDbrEVJ8nEGdaPrICw (button) folded before Flop
Seat 2: KpnW5CcJ4Mg6MeclfKmLrw (small blind) collected ($7)
Seat 3: Qy/UBNbD2HaA0Ogxg8Sf3w (big blind) folded before Flop
Seat 4: uCqEjnxh2/vFBjKYkfTOkw folded before Flop (didn't bet)
Seat 5: rHlMOfR7kpQQxe+PFQz0xQ folded before Flop (didn't bet)
Seat 6: TSuRyAHnUPCFjP7Z0rEE0w folded before Flop (didn't bet)



PokerStars Game #59939479952:  Hold'em No Limit ($0.50/$1.00) - 2009/07/01 0:40:57 ET
Table 'QBLDswtHe7Ml0HwAdcMhlw' 2-max Seat #2 is the button
Seat 1: hdNlhiCwI533uwvvTTfC9Q ($119 in chips)
Seat 2: GBkvjkjDWVBEa1e14dh6CA ($50 in chips)
GBkvjkjDWVBEa1e14dh6CA: posts small blind $0.50
hdNlhiCwI533uwvvTTfC9Q: posts big blind $1
*** HOLE CARDS ***
GBkvjkjDWVBEa1e14dh6CA: raises $2 to $3
hdNlhiCwI533uwvvTTfC9Q: calls $2
*** FLOP *** [2h Tc Ks]
hdNlhiCwI533uwvvTTfC9Q: checks
GBkvjkjDWVBEa1e14dh6CA: bets $5
hdNlhiCwI533uwvvTTfC9Q: folds
GBkvjkjDWVBEa1e14dh6CA collected $5.70 from pot
GBkvjkjDWVBEa1e14dh6CA: doesn't show hand
*** SUMMARY ***
Total pot $6 | Rake $0.30
Board [2h Tc Ks]
Seat 1: hdNlhiCwI533uwvvTTfC9Q (big blind) folded on the Flop
Seat 2: GBkvjkjDWVBEa1e14dh6CA (button) (small blind) collected ($5.70)



PokerStars Game #59939480562:  Hold'em No Limit ($0.50/$1.00) - 2009/07/01 0:40:58 ET
Table 'U9zqzC8f3oTJ2ShXFgSSOA' 6-max Seat #5 is the button
Seat 1: tS9JHB1h+FQ++qu8RwRNgg ($79.15 in chips)
Seat 2: U2CWBTv29qdCbj8RNF2sIw ($99.50 in chips)
Seat 3: yfXek8iJ7O4CFyqXrtGcfg ($12.05 in chips)
Seat 4: 33q95we0Etwgrm6guQGncw ($84.60 in chips)
Seat 5: KfwW5us6tydK81NYTtK1gw ($295.25 in chips)
Seat 6: aIxzFKdtpDSkUePKZy/niQ ($28.75 in chips)
aIxzFKdtpDSkUePKZy/niQ: posts small blind $0.50
tS9JHB1h+FQ++qu8RwRNgg: posts big blind $1
*** HOLE CARDS ***
U2CWBTv29qdCbj8RNF2sIw: folds
yfXek8iJ7O4CFyqXrtGcfg: folds
33q95we0Etwgrm6guQGncw: raises $2 to $3
KfwW5us6tydK81NYTtK1gw: folds
aIxzFKdtpDSkUePKZy/niQ: calls $2.50
tS9JHB1h+FQ++qu8RwRNgg: folds
*** FLOP *** [2d 8h 9h]
aIxzFKdtpDSkUePKZy/niQ: checks
33q95we0Etwgrm6guQGncw: checks
*** TURN *** [2d 8h 9h] [4s]
aIxzFKdtpDSkUePKZy/niQ: checks
33q95we0Etwgrm6guQGncw: bets $2
aIxzFKdtpDSkUePKZy/niQ: calls $2
*** RIVER *** [2d 8h 9h 4s] [8d]
aIxzFKdtpDSkUePKZy/niQ: checks
33q95we0Etwgrm6guQGncw: checks
*** SHOW DOWN ***
aIxzFKdtpDSkUePKZy/niQ: shows [6s 7c] (a pair of Eights)
33q95we0Etwgrm6guQGncw: shows [Ah 6h] (a pair of Eights - Ace kicker)
33q95we0Etwgrm6guQGncw collected $10.50 from pot
*** SUMMARY ***
Total pot $11 | Rake $0.50
Board [2d 8h 9h 4s 8d]
Seat 1: tS9JHB1h+FQ++qu8RwRNgg (big blind) folded before Flop
Seat 2: U2CWBTv29qdCbj8RNF2sIw folded before Flop (didn't bet)
Seat 3: yfXek8iJ7O4CFyqXrtGcfg folded before Flop (didn't bet)
Seat 4: 33q95we0Etwgrm6guQGncw showed [Ah 6h] and won ($10.50) with a pair of Eights
Seat 5: KfwW5us6tydK81NYTtK1gw (button) folded before Flop (didn't bet)
Seat 6: aIxzFKdtpDSkUePKZy/niQ (small blind) showed [6s 7c] and lost with a pair of Eights



PokerStars Game #59939480690:  Hold'em No Limit ($0.50/$1.00) - 2009/07/01 0:40:58 ET
Table '/RZcOwpZpHQ+OwPwjsbnRw' 6-max Seat #4 is the button
Seat 1: Zboa6dColKGHBjLPUakZjw ($56.70 in chips)
Seat 2: +xW7QemQU0Fxs+4TnqBRow ($129 in chips)
Seat 4: j7NIOHLZk7V2o9fOioO5ug ($100 in chips)
Seat 5: wx3sQGkVi2x9wJXuWNHPBw ($195.65 in chips)
Seat 6: XOIf9W+VAxhZqN+SYoyMKA ($290.05 in chips)
wx3sQGkVi2x9wJXuWNHPBw: posts small blind $0.50
XOIf9W+VAxhZqN+SYoyMKA: posts big blind $1
*** HOLE CARDS ***
Zboa6dColKGHBjLPUakZjw: folds
+xW7QemQU0Fxs+4TnqBRow: raises $3 to $4
j7NIOHLZk7V2o9fOioO5ug: calls $4
wx3sQGkVi2x9wJXuWNHPBw: folds
XOIf9W+VAxhZqN+SYoyMKA: folds
*** FLOP *** [3d 2c 4d]
+xW7QemQU0Fxs+4TnqBRow: bets $6
j7NIOHLZk7V2o9fOioO5ug: calls $6
*** TURN *** [3d 2c 4d] [8c]
XnT1yK2DD/5FL+0bwuEhqg joins the table at seat #3
+xW7QemQU0Fxs+4TnqBRow: bets $15
j7NIOHLZk7V2o9fOioO5ug: calls $15
*** RIVER *** [3d 2c 4d 8c] [8h]
+xW7QemQU0Fxs+4TnqBRow: bets $41
j7NIOHLZk7V2o9fOioO5ug: calls $41
*** SHOW DOWN ***
+xW7QemQU0Fxs+4TnqBRow: shows [4s 4c] (a full house, Fours full of Eights)
j7NIOHLZk7V2o9fOioO5ug: mucks hand
+xW7QemQU0Fxs+4TnqBRow collected $131.50 from pot
*** SUMMARY ***
Total pot $133.50 | Rake $2
Board [3d 2c 4d 8c 8h]
Seat 1: Zboa6dColKGHBjLPUakZjw folded before Flop (didn't bet)
Seat 2: +xW7QemQU0Fxs+4TnqBRow showed [4s 4c] and won ($131.50) with a full house, Fours full of Eights
Seat 4: j7NIOHLZk7V2o9fOioO5ug (button) mucked
Seat 5: wx3sQGkVi2x9wJXuWNHPBw (small blind) folded before Flop
Seat 6: XOIf9W+VAxhZqN+SYoyMKA (big blind) folded before Flop



PokerStars Game #59939481294:  Hold'em No Limit ($0.50/$1.00) - 2009/07/01 0:40:59 ET
Table 'LmXQK9xy3awB+qsPzI21Mw' 2-max Seat #1 is the button
Seat 1: NYi6JFscYNrofSXy4sM+Yw ($243.45 in chips)
Seat 2: TME8GvochpQAo8cmJwWmvA ($93.85 in chips)
NYi6JFscYNrofSXy4sM+Yw: posts small blind $0.50
TME8GvochpQAo8cmJwWmvA: posts big blind $1
*** HOLE CARDS ***
NYi6JFscYNrofSXy4sM+Yw: folds
TME8GvochpQAo8cmJwWmvA collected $1 from pot
TME8GvochpQAo8cmJwWmvA: doesn't show hand
*** SUMMARY ***
Total pot $1 | Rake $0
Seat 1: NYi6JFscYNrofSXy4sM+Yw (button) (small blind) folded before Flop
Seat 2: TME8GvochpQAo8cmJwWmvA (big blind) collected ($1)



PokerStars Game #59939481502:  Hold'em No Limit ($0.50/$1.00) - 2009/07/01 0:41:00 ET
Table 'Evb7VW0qfDhFkbgBL3gcqQ' 2-max Seat #2 is the button
Seat 1: NYi6JFscYNrofSXy4sM+Yw ($100 in chips)
Seat 2: mJHc7tEZG3SVIX7QQjb5EQ ($52.70 in chips)
mJHc7tEZG3SVIX7QQjb5EQ: posts small blind $0.50
NYi6JFscYNrofSXy4sM+Yw: posts big blind $1
*** HOLE CARDS ***
mJHc7tEZG3SVIX7QQjb5EQ: raises $1 to $2
NYi6JFscYNrofSXy4sM+Yw: calls $1
*** FLOP *** [4c Qh Jc]
NYi6JFscYNrofSXy4sM+Yw: checks
mJHc7tEZG3SVIX7QQjb5EQ: checks
*** TURN *** [4c Qh Jc] [9d]
NYi6JFscYNrofSXy4sM+Yw: checks
mJHc7tEZG3SVIX7QQjb5EQ: checks
*** RIVER *** [4c Qh Jc 9d] [Qc]
NYi6JFscYNrofSXy4sM+Yw: checks
mJHc7tEZG3SVIX7QQjb5EQ: bets $2
NYi6JFscYNrofSXy4sM+Yw: folds
mJHc7tEZG3SVIX7QQjb5EQ collected $3.80 from pot
mJHc7tEZG3SVIX7QQjb5EQ: doesn't show hand
*** SUMMARY ***
Total pot $4 | Rake $0.20
Board [4c Qh Jc 9d Qc]
Seat 1: NYi6JFscYNrofSXy4sM+Yw (big blind) folded on the River
Seat 2: mJHc7tEZG3SVIX7QQjb5EQ (button) (small blind) collected ($3.80)



PokerStars Game #59939481584:  Hold'em No Limit ($0.50/$1.00) - 2009/07/01 0:41:00 ET
Table 'SQLOQoANiHscJ8AL7zffbw' 9-max Seat #5 is the button
Seat 1: jPTRd6SpCp4xqAy2XQiTOw ($134.60 in chips)
Seat 2: /zy+DB4S5fUQUSfZWFzYGw ($276.35 in chips)
Seat 3: 0eFnow7+D7veCYQ+CG9FFw ($79.90 in chips)
Seat 4: N9n5Wc3s35DpCrOAUUNAaQ ($92.35 in chips)
Seat 5: L9njYvloJ1NdXjP8edHEAg ($105.55 in chips)
Seat 6: p5UKaxVobvptF0ANhR/q1A ($175 in chips)
Seat 7: bJckevFOcg//s0qyMQI6sQ ($100 in chips)
Seat 9: qJr25HAtvv1w/7IBvjMM3g ($232.75 in chips)
p5UKaxVobvptF0ANhR/q1A: posts small blind $0.50
bJckevFOcg//s0qyMQI6sQ: posts big blind $1
Pp/KTcXkfZKKUHkjyaLTdg: sits out
*** HOLE CARDS ***
qJr25HAtvv1w/7IBvjMM3g: folds
jPTRd6SpCp4xqAy2XQiTOw: folds
/zy+DB4S5fUQUSfZWFzYGw: folds
0eFnow7+D7veCYQ+CG9FFw: folds
N9n5Wc3s35DpCrOAUUNAaQ: folds
L9njYvloJ1NdXjP8edHEAg: raises $2 to $3
p5UKaxVobvptF0ANhR/q1A: folds
bJckevFOcg//s0qyMQI6sQ: folds
L9njYvloJ1NdXjP8edHEAg collected $2.50 from pot
*** SUMMARY ***
Total pot $2.50 | Rake $0
Seat 1: jPTRd6SpCp4xqAy2XQiTOw folded before Flop (didn't bet)
Seat 2: /zy+DB4S5fUQUSfZWFzYGw folded before Flop (didn't bet)
Seat 3: 0eFnow7+D7veCYQ+CG9FFw folded before Flop (didn't bet)
Seat 4: N9n5Wc3s35DpCrOAUUNAaQ folded before Flop (didn't bet)
Seat 5: L9njYvloJ1NdXjP8edHEAg (button) collected ($2.50)
Seat 6: p5UKaxVobvptF0ANhR/q1A (small blind) folded before Flop
Seat 7: bJckevFOcg//s0qyMQI6sQ (big blind) folded before Flop
Seat 9: qJr25HAtvv1w/7IBvjMM3g folded before Flop (didn't bet)



PokerStars Game #59939483112:  Hold'em No Limit ($0.50/$1.00) - 2009/07/01 0:41:02 ET
Table 'hugOjcwJvzEwZbK7tyiWuQ' 9-max Seat #5 is the button
Seat 1: N9n5Wc3s35DpCrOAUUNAaQ ($128.50 in chips)
Seat 2: r27C1nIV4NS4+qbnrgBQSw ($255.55 in chips)
Seat 3: jDwhY1kCdc6EkAHbT7PJMQ ($107.65 in chips)
Seat 4: UWB3oeddt/GObx2Mix2Anw ($204.25 in chips)
Seat 5: 5BRGWf+R3nt2WS3b5xX+zA ($23.30 in chips)
Seat 6: gUUvmqdVlmvpal6B8nYrmg ($105.90 in chips)
Seat 7: FL3MrLspcF23LYvC4ipBOA ($101.50 in chips)
Seat 8: /zy+DB4S5fUQUSfZWFzYGw ($105.75 in chips)
Seat 9: o6JyUkbzCDw8tUabqtmnlg ($61.20 in chips)
gUUvmqdVlmvpal6B8nYrmg: posts small blind $0.50
FL3MrLspcF23LYvC4ipBOA: posts big blind $1
*** HOLE CARDS ***
/zy+DB4S5fUQUSfZWFzYGw: folds
o6JyUkbzCDw8tUabqtmnlg: folds
N9n5Wc3s35DpCrOAUUNAaQ: folds
r27C1nIV4NS4+qbnrgBQSw: folds
jDwhY1kCdc6EkAHbT7PJMQ: folds
UWB3oeddt/GObx2Mix2Anw: raises $3 to $4
5BRGWf+R3nt2WS3b5xX+zA: folds
gUUvmqdVlmvpal6B8nYrmg: folds
FL3MrLspcF23LYvC4ipBOA: folds
UWB3oeddt/GObx2Mix2Anw collected $2.50 from pot
*** SUMMARY ***
Total pot $2.50 | Rake $0
Seat 1: N9n5Wc3s35DpCrOAUUNAaQ folded before Flop (didn't bet)
Seat 2: r27C1nIV4NS4+qbnrgBQSw folded before Flop (didn't bet)
Seat 3: jDwhY1kCdc6EkAHbT7PJMQ folded before Flop (didn't bet)
Seat 4: UWB3oeddt/GObx2Mix2Anw collected ($2.50)
Seat 5: 5BRGWf+R3nt2WS3b5xX+zA (button) folded before Flop (didn't bet)
Seat 6: gUUvmqdVlmvpal6B8nYrmg (small blind) folded before Flop
Seat 7: FL3MrLspcF23LYvC4ipBOA (big blind) folded before Flop
Seat 8: /zy+DB4S5fUQUSfZWFzYGw folded before Flop (didn't bet)
Seat 9: o6JyUkbzCDw8tUabqtmnlg folded before Flop (didn't bet)



PokerStars Game #59939484848:  Hold'em No Limit ($0.50/$1.00) - 2009/07/01 0:41:05 ET
Table 'LmXQK9xy3awB+qsPzI21Mw' 2-max Seat #2 is the button
Seat 1: NYi6JFscYNrofSXy4sM+Yw ($242.95 in chips)
Seat 2: TME8GvochpQAo8cmJwWmvA ($94.35 in chips)
TME8GvochpQAo8cmJwWmvA: posts small blind $0.50
NYi6JFscYNrofSXy4sM+Yw: posts big blind $1
*** HOLE CARDS ***
TME8GvochpQAo8cmJwWmvA: calls $0.50
NYi6JFscYNrofSXy4sM+Yw: raises $2 to $3
TME8GvochpQAo8cmJwWmvA: calls $2
*** FLOP *** [9c 7d Kd]
NYi6JFscYNrofSXy4sM+Yw: bets $3
TME8GvochpQAo8cmJwWmvA: folds
NYi6JFscYNrofSXy4sM+Yw collected $5.70 from pot
*** SUMMARY ***
Total pot $6 | Rake $0.30
Board [9c 7d Kd]
Seat 1: NYi6JFscYNrofSXy4sM+Yw (big blind) collected ($5.70)
Seat 2: TME8GvochpQAo8cmJwWmvA (button) (small blind) folded on the Flop



PokerStars Game #59939486914:  Hold'em No Limit ($0.50/$1.00) - 2009/07/01 0:41:08 ET
Table 'FKpXUINE6M3UxHG4zaMhHA' 6-max Seat #1 is the button
Seat 1: qNezhXOOUXqwG7b9X5XJAA ($100 in chips)
Seat 2: nDKgwwXJ45hcJfJe01cdxQ ($37.35 in chips)
Seat 3: GOHDYcxP1gP29069kB9HFw ($121.05 in chips)
Seat 4: vw0eLNLy3Huccth4CUZNPQ ($74.30 in chips)
Seat 5: eUBBn2R56C1IQ6Cs/vitwg ($101.50 in chips)
Seat 6: b2a+5TkFf4xJN/Ihhma58Q ($13.40 in chips)
nDKgwwXJ45hcJfJe01cdxQ: posts small blind $0.50
GOHDYcxP1gP29069kB9HFw: posts big blind $1
*** HOLE CARDS ***
vw0eLNLy3Huccth4CUZNPQ: folds
eUBBn2R56C1IQ6Cs/vitwg: folds
b2a+5TkFf4xJN/Ihhma58Q: folds
qNezhXOOUXqwG7b9X5XJAA: raises $2 to $3
nDKgwwXJ45hcJfJe01cdxQ: folds
GOHDYcxP1gP29069kB9HFw: calls $2
*** FLOP *** [Js Ts 9d]
GOHDYcxP1gP29069kB9HFw: bets $3
qNezhXOOUXqwG7b9X5XJAA: folds
GOHDYcxP1gP29069kB9HFw collected $6.20 from pot
GOHDYcxP1gP29069kB9HFw: doesn't show hand
*** SUMMARY ***
Total pot $6.50 | Rake $0.30
Board [Js Ts 9d]
Seat 1: qNezhXOOUXqwG7b9X5XJAA (button) folded on the Flop
Seat 2: nDKgwwXJ45hcJfJe01cdxQ (small blind) folded before Flop
Seat 3: GOHDYcxP1gP29069kB9HFw (big blind) collected ($6.20)
Seat 4: vw0eLNLy3Huccth4CUZNPQ folded before Flop (didn't bet)
Seat 5: eUBBn2R56C1IQ6Cs/vitwg folded before Flop (didn't bet)
Seat 6: b2a+5TkFf4xJN/Ihhma58Q folded before Flop (didn't bet)



PokerStars Game #59939488522:  Hold'em No Limit ($0.50/$1.00) - 2009/07/01 0:41:11 ET
Table 'rmZfTK+oSebeUPJNbWhdAA' 6-max Seat #2 is the button
Seat 1: xAU6q2/cwmby2sxmA8VcmA ($103.05 in chips)
Seat 2: z7O9PO/WEcqRouIydFhS9Q ($92.50 in chips)
Seat 3: 9yjOzGERLaEZS8CZ6YNHFg ($112.35 in chips)
Seat 4: OGMLOcTNYZXZU81au7ztUw ($137 in chips)
Seat 5: +xW7QemQU0Fxs+4TnqBRow ($100.50 in chips)
Seat 6: j7NIOHLZk7V2o9fOioO5ug ($132.50 in chips)
9yjOzGERLaEZS8CZ6YNHFg: posts small blind $0.50
OGMLOcTNYZXZU81au7ztUw: posts big blind $1
*** HOLE CARDS ***
+xW7QemQU0Fxs+4TnqBRow: raises $3 to $4
j7NIOHLZk7V2o9fOioO5ug: folds
xAU6q2/cwmby2sxmA8VcmA: folds
z7O9PO/WEcqRouIydFhS9Q: folds
9yjOzGERLaEZS8CZ6YNHFg: folds
OGMLOcTNYZXZU81au7ztUw: calls $3
*** FLOP *** [5s 4c 8h]
OGMLOcTNYZXZU81au7ztUw: checks
+xW7QemQU0Fxs+4TnqBRow: checks
*** TURN *** [5s 4c 8h] [9d]
OGMLOcTNYZXZU81au7ztUw: bets $6
+xW7QemQU0Fxs+4TnqBRow: folds
OGMLOcTNYZXZU81au7ztUw collected $8.10 from pot
OGMLOcTNYZXZU81au7ztUw: doesn't show hand
*** SUMMARY ***
Total pot $8.50 | Rake $0.40
Board [5s 4c 8h 9d]
Seat 1: xAU6q2/cwmby2sxmA8VcmA folded before Flop (didn't bet)
Seat 2: z7O9PO/WEcqRouIydFhS9Q (button) folded before Flop (didn't bet)
Seat 3: 9yjOzGERLaEZS8CZ6YNHFg (small blind) folded before Flop
Seat 4: OGMLOcTNYZXZU81au7ztUw (big blind) collected ($8.10)
Seat 5: +xW7QemQU0Fxs+4TnqBRow folded on the Turn
Seat 6: j7NIOHLZk7V2o9fOioO5ug folded before Flop (didn't bet)



PokerStars Game #59939490146:  Hold'em No Limit ($0.50/$1.00) - 2009/07/01 0:41:13 ET
Table '+cA8mcmhaedZ7YcrDdhmeQ' 6-max Seat #3 is the button
Seat 1: lsLuWlcPA3Rh7kJVLzMh0Q ($308.70 in chips)
Seat 2: RqgF7gRoKgRNW8Zoi1ty4A ($100 in chips)
Seat 3: 7H5WkGzGvsv56y1iaqHvRg ($27.05 in chips)
Seat 4: LjL3AIERHn559yyW1mTUYQ ($154.50 in chips)
Seat 5: iHo1oDbrEVJ8nEGdaPrICw ($106.85 in chips)
Seat 6: YfsTQsY/fxb+YqbdclTHuw ($62.55 in chips)
LjL3AIERHn559yyW1mTUYQ: posts small blind $0.50
iHo1oDbrEVJ8nEGdaPrICw: posts big blind $1
*** HOLE CARDS ***
YfsTQsY/fxb+YqbdclTHuw: calls $1
lsLuWlcPA3Rh7kJVLzMh0Q: folds
RqgF7gRoKgRNW8Zoi1ty4A: folds
7H5WkGzGvsv56y1iaqHvRg: raises $2 to $3
LjL3AIERHn559yyW1mTUYQ: folds
iHo1oDbrEVJ8nEGdaPrICw: folds
YfsTQsY/fxb+YqbdclTHuw: calls $2
*** FLOP *** [6s 8c 3s]
YfsTQsY/fxb+YqbdclTHuw: checks
7H5WkGzGvsv56y1iaqHvRg: bets $4
YfsTQsY/fxb+YqbdclTHuw: folds
7H5WkGzGvsv56y1iaqHvRg collected $7.15 from pot
*** SUMMARY ***
Total pot $7.50 | Rake $0.35
Board [6s 8c 3s]
Seat 1: lsLuWlcPA3Rh7kJVLzMh0Q folded before Flop (didn't bet)
Seat 2: RqgF7gRoKgRNW8Zoi1ty4A folded before Flop (didn't bet)
Seat 3: 7H5WkGzGvsv56y1iaqHvRg (button) collected ($7.15)
Seat 4: LjL3AIERHn559yyW1mTUYQ (small blind) folded before Flop
Seat 5: iHo1oDbrEVJ8nEGdaPrICw (big blind) folded before Flop
Seat 6: YfsTQsY/fxb+YqbdclTHuw folded on the Flop



PokerStars Game #59939491366:  Hold'em No Limit ($0.50/$1.00) - 2009/07/01 0:41:15 ET
Table 'eU3bWpDDg3Z+9R4m4iVmog' 6-max Seat #1 is the button
Seat 1: TSuRyAHnUPCFjP7Z0rEE0w ($186.10 in chips)
Seat 2: 8CAoOzhmB8n3nRFf3V4BTg ($99.80 in chips)
Seat 3: U6tnjwZRpTnM+YkqkCjwyQ ($188.50 in chips)
Seat 4: GDVIsbEJ/DOJsMKE4Asz0A ($75.60 in chips)
Seat 5: AdLVjddOzm+sRNo1Bc3S6Q ($100 in chips)
Seat 6: hpxXcmRkXXI9HE5+5/j/0Q ($120.45 in chips)
8CAoOzhmB8n3nRFf3V4BTg: posts small blind $0.50
U6tnjwZRpTnM+YkqkCjwyQ: posts big blind $1
*** HOLE CARDS ***
GDVIsbEJ/DOJsMKE4Asz0A: folds
AdLVjddOzm+sRNo1Bc3S6Q: raises $3 to $4
hpxXcmRkXXI9HE5+5/j/0Q: folds
TSuRyAHnUPCFjP7Z0rEE0w: calls $4
8CAoOzhmB8n3nRFf3V4BTg: folds
U6tnjwZRpTnM+YkqkCjwyQ: folds
*** FLOP *** [4d 4c 6h]
AdLVjddOzm+sRNo1Bc3S6Q: checks
TSuRyAHnUPCFjP7Z0rEE0w: bets $6
AdLVjddOzm+sRNo1Bc3S6Q: folds
TSuRyAHnUPCFjP7Z0rEE0w collected $9.05 from pot
TSuRyAHnUPCFjP7Z0rEE0w: doesn't show hand
*** SUMMARY ***
Total pot $9.50 | Rake $0.45
Board [4d 4c 6h]
Seat 1: TSuRyAHnUPCFjP7Z0rEE0w (button) collected ($9.05)
Seat 2: 8CAoOzhmB8n3nRFf3V4BTg (small blind) folded before Flop
Seat 3: U6tnjwZRpTnM+YkqkCjwyQ (big blind) folded before Flop
Seat 4: GDVIsbEJ/DOJsMKE4Asz0A folded before Flop (didn't bet)
Seat 5: AdLVjddOzm+sRNo1Bc3S6Q folded on the Flop
Seat 6: hpxXcmRkXXI9HE5+5/j/0Q folded before Flop (didn't bet)



PokerStars Game #59939491192:  Hold'em No Limit ($0.50/$1.00) - 2009/07/01 0:41:15 ET
Table 'OEonapnv+AHzisWWNNua0Q' 2-max Seat #2 is the button
Seat 1: 8IItNAJFln4siZ+XXuzGhg ($45 in chips)
Seat 2: iXXpsR/zdmiswg1I4gJ8kw ($45 in chips)
iXXpsR/zdmiswg1I4gJ8kw: posts small blind $0.50
8IItNAJFln4siZ+XXuzGhg: posts big blind $1
*** HOLE CARDS ***
iXXpsR/zdmiswg1I4gJ8kw: raises $5 to $6
8IItNAJFln4siZ+XXuzGhg: calls $5
*** FLOP *** [2s 6c Ah]
8IItNAJFln4siZ+XXuzGhg: checks
iXXpsR/zdmiswg1I4gJ8kw: bets $9
8IItNAJFln4siZ+XXuzGhg: calls $9
*** TURN *** [2s 6c Ah] [9s]
8IItNAJFln4siZ+XXuzGhg: checks
iXXpsR/zdmiswg1I4gJ8kw: bets $8
8IItNAJFln4siZ+XXuzGhg: raises $8 to $16
iXXpsR/zdmiswg1I4gJ8kw: calls $8
*** RIVER *** [2s 6c Ah 9s] [8h]
8IItNAJFln4siZ+XXuzGhg: checks
iXXpsR/zdmiswg1I4gJ8kw: bets $10
8IItNAJFln4siZ+XXuzGhg: raises $4 to $14 and is all-in
iXXpsR/zdmiswg1I4gJ8kw: folds
8IItNAJFln4siZ+XXuzGhg collected $81.50 from pot
*** SUMMARY ***
Total pot $82 | Rake $0.50
Board [2s 6c Ah 9s 8h]
Seat 1: 8IItNAJFln4siZ+XXuzGhg (big blind) collected ($81.50)
Seat 2: iXXpsR/zdmiswg1I4gJ8kw (button) (small blind) folded on the River



PokerStars Game #59939492188:  Hold'em No Limit ($0.50/$1.00) - 2009/07/01 0:41:16 ET
Table 'LmXQK9xy3awB+qsPzI21Mw' 2-max Seat #1 is the button
Seat 1: NYi6JFscYNrofSXy4sM+Yw ($245.65 in chips)
Seat 2: TME8GvochpQAo8cmJwWmvA ($91.35 in chips)
NYi6JFscYNrofSXy4sM+Yw: posts small blind $0.50
TME8GvochpQAo8cmJwWmvA: posts big blind $1
*** HOLE CARDS ***
NYi6JFscYNrofSXy4sM+Yw: raises $2 to $3
TME8GvochpQAo8cmJwWmvA: calls $2
*** FLOP *** [7s 2d Jd]
TME8GvochpQAo8cmJwWmvA: checks
NYi6JFscYNrofSXy4sM+Yw: bets $3
TME8GvochpQAo8cmJwWmvA: folds
NYi6JFscYNrofSXy4sM+Yw collected $5.70 from pot
*** SUMMARY ***
Total pot $6 | Rake $0.30
Board [7s 2d Jd]
Seat 1: NYi6JFscYNrofSXy4sM+Yw (button) (small blind) collected ($5.70)
Seat 2: TME8GvochpQAo8cmJwWmvA (big blind) folded on the Flop



PokerStars Game #59939491866:  Hold'em No Limit ($0.50/$1.00) - 2009/07/01 0:41:16 ET
Table 'pHrhryH8jPNdQfY62f8v+g' 6-max Seat #5 is the button
Seat 1: fF4botNMr8/ieVPO1YYRLw ($60 in chips)
Seat 2: RqgF7gRoKgRNW8Zoi1ty4A ($124.65 in chips)
Seat 4: wenbG7TaM3H7h5kn78OFNw ($47.30 in chips)
Seat 5: r1/R7y0Ortgoz4lccgW8VA ($34.65 in chips)
Seat 6: xAU6q2/cwmby2sxmA8VcmA ($112.75 in chips)
xAU6q2/cwmby2sxmA8VcmA: posts small blind $0.50
fF4botNMr8/ieVPO1YYRLw: posts big blind $1
*** HOLE CARDS ***
RqgF7gRoKgRNW8Zoi1ty4A: folds
wenbG7TaM3H7h5kn78OFNw: folds
r1/R7y0Ortgoz4lccgW8VA: folds
xAU6q2/cwmby2sxmA8VcmA: raises $3 to $4
fF4botNMr8/ieVPO1YYRLw: folds
xAU6q2/cwmby2sxmA8VcmA collected $2 from pot
*** SUMMARY ***
Total pot $2 | Rake $0
Seat 1: fF4botNMr8/ieVPO1YYRLw (big blind) folded before Flop
Seat 2: RqgF7gRoKgRNW8Zoi1ty4A folded before Flop (didn't bet)
Seat 4: wenbG7TaM3H7h5kn78OFNw folded before Flop (didn't bet)
Seat 5: r1/R7y0Ortgoz4lccgW8VA (button) folded before Flop (didn't bet)
Seat 6: xAU6q2/cwmby2sxmA8VcmA (small blind) collected ($2)



PokerStars Game #59939493636:  Hold'em No Limit ($0.50/$1.00) - 2009/07/01 0:41:18 ET
Table 'MUPc8FEpe/nR0BKSeReX6Q' 6-max Seat #6 is the button
Seat 1: YsLQ3BAvgQHWXMAv3Wv6Hg ($114.35 in chips)
Seat 2: xAU6q2/cwmby2sxmA8VcmA ($114.30 in chips)
Seat 3: wx3sQGkVi2x9wJXuWNHPBw ($221.55 in chips)
Seat 4: ZA1bp6g8IwtTxkUE4eCjDQ ($172.15 in chips)
Seat 5: UBZQqpnJZdTYYY1FTb0rLA ($101.50 in chips)
Seat 6: oxnw0GLLpFanjhGkxfRSqA ($58 in chips)
YsLQ3BAvgQHWXMAv3Wv6Hg: posts small blind $0.50
xAU6q2/cwmby2sxmA8VcmA: posts big blind $1
*** HOLE CARDS ***
wx3sQGkVi2x9wJXuWNHPBw: folds
ZA1bp6g8IwtTxkUE4eCjDQ: raises $1 to $2
UBZQqpnJZdTYYY1FTb0rLA: folds
oxnw0GLLpFanjhGkxfRSqA: folds
YsLQ3BAvgQHWXMAv3Wv6Hg: folds
xAU6q2/cwmby2sxmA8VcmA: calls $1
*** FLOP *** [7c Qh 2s]
xAU6q2/cwmby2sxmA8VcmA: checks
ZA1bp6g8IwtTxkUE4eCjDQ: checks
*** TURN *** [7c Qh 2s] [7d]
xAU6q2/cwmby2sxmA8VcmA: bets $3
ZA1bp6g8IwtTxkUE4eCjDQ: calls $3
*** RIVER *** [7c Qh 2s 7d] [6h]
xAU6q2/cwmby2sxmA8VcmA: bets $6
ZA1bp6g8IwtTxkUE4eCjDQ: raises $21 to $27
xAU6q2/cwmby2sxmA8VcmA: calls $21
*** SHOW DOWN ***
ZA1bp6g8IwtTxkUE4eCjDQ: shows [2c 2d] (a full house, Deuces full of Sevens)
xAU6q2/cwmby2sxmA8VcmA: mucks hand
ZA1bp6g8IwtTxkUE4eCjDQ collected $61.50 from pot
*** SUMMARY ***
Total pot $64.50 | Rake $3
Board [7c Qh 2s 7d 6h]
Seat 1: YsLQ3BAvgQHWXMAv3Wv6Hg (small blind) folded before Flop
Seat 2: xAU6q2/cwmby2sxmA8VcmA (big blind) mucked
Seat 3: wx3sQGkVi2x9wJXuWNHPBw folded before Flop (didn't bet)
Seat 4: ZA1bp6g8IwtTxkUE4eCjDQ showed [2c 2d] and won ($61.50) with a full house, Deuces full of Sevens
Seat 5: UBZQqpnJZdTYYY1FTb0rLA folded before Flop (didn't bet)
Seat 6: oxnw0GLLpFanjhGkxfRSqA (button) folded before Flop (didn't bet)



PokerStars Game #59939494276:  Hold'em No Limit ($0.50/$1.00) - 2009/07/01 0:41:20 ET
Table 'VOs36P6NW+QyXeQ1B62kmA' 6-max Seat #5 is the button
Seat 1: AdLVjddOzm+sRNo1Bc3S6Q ($140.80 in chips)
Seat 2: KpnW5CcJ4Mg6MeclfKmLrw ($117.85 in chips)
Seat 3: TSuRyAHnUPCFjP7Z0rEE0w ($100 in chips)
Seat 4: w02zQzNydODiyV9THKgo9w ($36.80 in chips)
Seat 5: X7GlkHF+lkbarCLuZ4Uf0w ($22.75 in chips)
Seat 6: 6tvjsJrdmWg+g7FVrMnzXA ($60.90 in chips)
6tvjsJrdmWg+g7FVrMnzXA: posts small blind $0.50
AdLVjddOzm+sRNo1Bc3S6Q: posts big blind $1
*** HOLE CARDS ***
KpnW5CcJ4Mg6MeclfKmLrw has timed out
KpnW5CcJ4Mg6MeclfKmLrw: folds
KpnW5CcJ4Mg6MeclfKmLrw is sitting out
TSuRyAHnUPCFjP7Z0rEE0w: folds
w02zQzNydODiyV9THKgo9w: folds
KpnW5CcJ4Mg6MeclfKmLrw has returned
X7GlkHF+lkbarCLuZ4Uf0w: raises $1 to $2
6tvjsJrdmWg+g7FVrMnzXA: raises $5 to $7
AdLVjddOzm+sRNo1Bc3S6Q: folds
X7GlkHF+lkbarCLuZ4Uf0w: folds
6tvjsJrdmWg+g7FVrMnzXA collected $5 from pot
6tvjsJrdmWg+g7FVrMnzXA: doesn't show hand
*** SUMMARY ***
Total pot $5 | Rake $0
Seat 1: AdLVjddOzm+sRNo1Bc3S6Q (big blind) folded before Flop
Seat 2: KpnW5CcJ4Mg6MeclfKmLrw folded before Flop (didn't bet)
Seat 3: TSuRyAHnUPCFjP7Z0rEE0w folded before Flop (didn't bet)
Seat 4: w02zQzNydODiyV9THKgo9w folded before Flop (didn't bet)
Seat 5: X7GlkHF+lkbarCLuZ4Uf0w (button) folded before Flop
Seat 6: 6tvjsJrdmWg+g7FVrMnzXA (small blind) collected ($5)



PokerStars Game #59939494326:  Hold'em No Limit ($0.50/$1.00) - 2009/07/01 0:41:20 ET
Table 'Evb7VW0qfDhFkbgBL3gcqQ' 2-max Seat #1 is the button
Seat 1: NYi6JFscYNrofSXy4sM+Yw ($100 in chips)
Seat 2: mJHc7tEZG3SVIX7QQjb5EQ ($54.50 in chips)
NYi6JFscYNrofSXy4sM+Yw: posts small blind $0.50
mJHc7tEZG3SVIX7QQjb5EQ: posts big blind $1
*** HOLE CARDS ***
NYi6JFscYNrofSXy4sM+Yw: raises $2 to $3
mJHc7tEZG3SVIX7QQjb5EQ: folds
NYi6JFscYNrofSXy4sM+Yw collected $2 from pot
*** SUMMARY ***
Total pot $2 | Rake $0
Seat 1: NYi6JFscYNrofSXy4sM+Yw (button) (small blind) collected ($2)
Seat 2: mJHc7tEZG3SVIX7QQjb5EQ (big blind) folded before Flop



PokerStars Game #59939494620:  Hold'em No Limit ($0.50/$1.00) - 2009/07/01 0:41:20 ET
Table 'QBLDswtHe7Ml0HwAdcMhlw' 2-max Seat #1 is the button
Seat 1: hdNlhiCwI533uwvvTTfC9Q ($116 in chips)
Seat 2: GBkvjkjDWVBEa1e14dh6CA ($52.70 in chips)
hdNlhiCwI533uwvvTTfC9Q: posts small blind $0.50
GBkvjkjDWVBEa1e14dh6CA: posts big blind $1
*** HOLE CARDS ***
hdNlhiCwI533uwvvTTfC9Q: raises $1 to $2
GBkvjkjDWVBEa1e14dh6CA: folds
hdNlhiCwI533uwvvTTfC9Q collected $2 from pot
hdNlhiCwI533uwvvTTfC9Q: doesn't show hand
*** SUMMARY ***
Total pot $2 | Rake $0
Seat 1: hdNlhiCwI533uwvvTTfC9Q (button) (small blind) collected ($2)
Seat 2: GBkvjkjDWVBEa1e14dh6CA (big blind) folded before Flop



PokerStars Game #59939498712:  Hold'em No Limit ($0.50/$1.00) - 2009/07/01 0:41:27 ET
Table 'Evb7VW0qfDhFkbgBL3gcqQ' 2-max Seat #2 is the button
Seat 1: NYi6JFscYNrofSXy4sM+Yw ($101 in chips)
Seat 2: mJHc7tEZG3SVIX7QQjb5EQ ($53.50 in chips)
mJHc7tEZG3SVIX7QQjb5EQ: posts small blind $0.50
NYi6JFscYNrofSXy4sM+Yw: posts big blind $1
*** HOLE CARDS ***
mJHc7tEZG3SVIX7QQjb5EQ: folds
NYi6JFscYNrofSXy4sM+Yw collected $1 from pot
*** SUMMARY ***
Total pot $1 | Rake $0
Seat 1: NYi6JFscYNrofSXy4sM+Yw (big blind) collected ($1)
Seat 2: mJHc7tEZG3SVIX7QQjb5EQ (button) (small blind) folded before Flop



PokerStars Game #59939499050:  Hold'em No Limit ($0.50/$1.00) - 2009/07/01 0:41:27 ET
Table 'tyUh+jyNvrceIQdKMJjQ2wZFWj23PMihdwrNWv41OG/Qeat #4 is the button
Seat 1: o8A5MUdudVKu+pAwgZOX2w ($229.45 in chips)
Seat 2: XvUbOIg94d25feWeQlOTVg ($59 in chips)
Seat 3: TalCiLYHCd+ffkmR3auPvA ($65.80 in chips)
Seat 4: TSuRyAHnUPCFjP7Z0rEE0w ($119.75 in chips)
Seat 5: j7NIOHLZk7V2o9fOioO5ug ($112.10 in chips)
Seat 6: YsLQ3BAvgQHWXMAv3Wv6Hg ($151.25 in chips)
j7NIOHLZk7V2o9fOioO5ug: posts small blind $0.50
YsLQ3BAvgQHWXMAv3Wv6Hg: posts big blind $1
*** HOLE CARDS ***
o8A5MUdudVKu+pAwgZOX2w has timed out
o8A5MUdudVKu+pAwgZOX2w: folds
o8A5MUdudVKu+pAwgZOX2w is sitting out
XvUbOIg94d25feWeQlOTVg: folds
TalCiLYHCd+ffkmR3auPvA: calls $1
TSuRyAHnUPCFjP7Z0rEE0w: folds
j7NIOHLZk7V2o9fOioO5ug: folds
YsLQ3BAvgQHWXMAv3Wv6Hg: checks
*** FLOP *** [Jh 9s 5h]
YsLQ3BAvgQHWXMAv3Wv6Hg: checks
o8A5MUdudVKu+pAwgZOX2w has returned
TalCiLYHCd+ffkmR3auPvA: bets $3
YsLQ3BAvgQHWXMAv3Wv6Hg: folds
TalCiLYHCd+ffkmR3auPvA collected $2.40 from pot
TalCiLYHCd+ffkmR3auPvA: doesn't show hand
*** SUMMARY ***
Total pot $2.50 | Rake $0.10
Board [Jh 9s 5h]
Seat 1: o8A5MUdudVKu+pAwgZOX2w folded before Flop (didn't bet)
Seat 2: XvUbOIg94d25feWeQlOTVg folded before Flop (didn't bet)
Seat 3: TalCiLYHCd+ffkmR3auPvA collected ($2.40)
Seat 4: TSuRyAHnUPCFjP7Z0rEE0w (button) folded before Flop (didn't bet)
Seat 5: j7NIOHLZk7V2o9fOioO5ug (small blind) folded before Flop
Seat 6: YsLQ3BAvgQHWXMAv3Wv6Hg (big blind) folded on the Flop



PokerStars Game #59939500454:  Hold'em No Limit ($0.50/$1.00) - 2009/07/01 0:41:29 ET
Table 'LmXQK9xy3awB+qsPzI21Mw' 2-max Seat #2 is the button
Seat 1: NYi6JFscYNrofSXy4sM+Yw ($248.35 in chips)
Seat 2: TME8GvochpQAo8cmJwWmvA ($88.35 in chips)
TME8GvochpQAo8cmJwWmvA: posts small blind $0.50
NYi6JFscYNrofSXy4sM+Yw: posts big blind $1
*** HOLE CARDS ***
TME8GvochpQAo8cmJwWmvA: raises $1 to $2
NYi6JFscYNrofSXy4sM+Yw: calls $1
*** FLOP *** [5h Kh Tc]
NYi6JFscYNrofSXy4sM+Yw: checks
TME8GvochpQAo8cmJwWmvA: bets $1
NYi6JFscYNrofSXy4sM+Yw: raises $3 to $4
TME8GvochpQAo8cmJwWmvA: folds
NYi6JFscYNrofSXy4sM+Yw collected $5.75 from pot
*** SUMMARY ***
Total pot $6 | Rake $0.25
Board [5h Kh Tc]
Seat 1: NYi6JFscYNrofSXy4sM+Yw (big blind) collected ($5.75)
Seat 2: TME8GvochpQAo8cmJwWmvA (button) (small blind) folded on the Flop



PokerStars Game #59939500624:  Hold'em No Limit ($0.50/$1.00) - 2009/07/01 0:41:30 ET
Table 'U9zqzC8f3oTJ2ShXFgSSOA' 6-max Seat #6 is the button
Seat 1: tS9JHB1h+FQ++qu8RwRNgg ($78.15 in chips)
Seat 2: U2CWBTv29qdCbj8RNF2sIw ($99.50 in chips)
Seat 3: yfXek8iJ7O4CFyqXrtGcfg ($12.05 in chips)
Seat 4: 33q95we0Etwgrm6guQGncw ($90.10 in chips)
Seat 5: KfwW5us6tydK81NYTtK1gw ($295.25 in chips)
Seat 6: aIxzFKdtpDSkUePKZy/niQ ($23.75 in chips)
tS9JHB1h+FQ++qu8RwRNgg: posts small blind $0.50
U2CWBTv29qdCbj8RNF2sIw: posts big blind $1
*** HOLE CARDS ***
yfXek8iJ7O4CFyqXrtGcfg: folds
33q95we0Etwgrm6guQGncw: folds
KfwW5us6tydK81NYTtK1gw: folds
aIxzFKdtpDSkUePKZy/niQ: folds
tS9JHB1h+FQ++qu8RwRNgg: calls $0.50
U2CWBTv29qdCbj8RNF2sIw: checks
*** FLOP *** [6h 8c 4c]
tS9JHB1h+FQ++qu8RwRNgg: checks
U2CWBTv29qdCbj8RNF2sIw: checks
*** TURN *** [6h 8c 4c] [Js]
tS9JHB1h+FQ++qu8RwRNgg: bets $2
U2CWBTv29qdCbj8RNF2sIw: folds
tS9JHB1h+FQ++qu8RwRNgg collected $1.90 from pot
tS9JHB1h+FQ++qu8RwRNgg: doesn't show hand
*** SUMMARY ***
Total pot $2 | Rake $0.10
Board [6h 8c 4c Js]
Seat 1: tS9JHB1h+FQ++qu8RwRNgg (small blind) collected ($1.90)
Seat 2: U2CWBTv29qdCbj8RNF2sIw (big blind) folded on the Turn
Seat 3: yfXek8iJ7O4CFyqXrtGcfg folded before Flop (didn't bet)
Seat 4: 33q95we0Etwgrm6guQGncw folded before Flop (didn't bet)
Seat 5: KfwW5us6tydK81NYTtK1gw folded before Flop (didn't bet)
Seat 6: aIxzFKdtpDSkUePKZy/niQ (button) folded before Flop (didn't bet)



PokerStars Game #59939501202:  Hold'em No Limit ($0.50/$1.00) - 2009/07/01 0:41:31 ET
Table '6YvsYDPNIDx2v5z3bJnwZQ' 9-max Seat #3 is the button
Seat 1: Ogn4JDV3mp4ZDKO49IFzKA ($18.70 in chips)
Seat 2: x80+i7DJL+81v3quj7KbNg ($20 in chips)
Seat 3: negfosHnGOZXSHpWDRKyBQ ($17.30 in chips)
Seat 4: kEr5NYB+JIG5+szcYMr6hA ($43 in chips)
Seat 5: mBRWbnUl8diyBO1qTJaNzw ($160.70 in chips)
Seat 6: uMPEfCcGCfsxmy53tVUMug ($108.10 in chips)
Seat 7: boixc27eqTYA1p0tUdMuBQ ($114 in chips)
Seat 8: PSFxpXgPedVZyHSu2Zhb7Q ($46.75 in chips)
Seat 9: jDwhY1kCdc6EkAHbT7PJMQ ($104.10 in chips)
kEr5NYB+JIG5+szcYMr6hA: posts small blind $0.50
mBRWbnUl8diyBO1qTJaNzw: posts big blind $1
*** HOLE CARDS ***
uMPEfCcGCfsxmy53tVUMug: folds
boixc27eqTYA1p0tUdMuBQ: raises $2 to $3
PSFxpXgPedVZyHSu2Zhb7Q: raises $3 to $6
jDwhY1kCdc6EkAHbT7PJMQ: folds
Ogn4JDV3mp4ZDKO49IFzKA: folds
x80+i7DJL+81v3quj7KbNg: folds
negfosHnGOZXSHpWDRKyBQ: folds
kEr5NYB+JIG5+szcYMr6hA: folds
mBRWbnUl8diyBO1qTJaNzw: folds
boixc27eqTYA1p0tUdMuBQ: calls $3
*** FLOP *** [Ts 9d 6d]
boixc27eqTYA1p0tUdMuBQ: checks
PSFxpXgPedVZyHSu2Zhb7Q: bets $8
boixc27eqTYA1p0tUdMuBQ: raises $14 to $22
PSFxpXgPedVZyHSu2Zhb7Q: calls $14
*** TURN *** [Ts 9d 6d] [7c]
boixc27eqTYA1p0tUdMuBQ: bets $30
PSFxpXgPedVZyHSu2Zhb7Q: calls $18.75 and is all-in
*** RIVER *** [Ts 9d 6d 7c] [4s]
*** SHOW DOWN ***
boixc27eqTYA1p0tUdMuBQ: shows [Kd Ad] (high card Ace)
PSFxpXgPedVZyHSu2Zhb7Q: shows [Kc Ks] (a pair of Kings)
PSFxpXgPedVZyHSu2Zhb7Q collected $92 from pot
*** SUMMARY ***
Total pot $95 | Rake $3
Board [Ts 9d 6d 7c 4s]
Seat 1: Ogn4JDV3mp4ZDKO49IFzKA folded before Flop (didn't bet)
Seat 2: x80+i7DJL+81v3quj7KbNg folded before Flop (didn't bet)
Seat 3: negfosHnGOZXSHpWDRKyBQ (button) folded before Flop (didn't bet)
Seat 4: kEr5NYB+JIG5+szcYMr6hA (small blind) folded before Flop
Seat 5: mBRWbnUl8diyBO1qTJaNzw (big blind) folded before Flop
Seat 6: uMPEfCcGCfsxmy53tVUMug folded before Flop (didn't bet)
Seat 7: boixc27eqTYA1p0tUdMuBQ showed [Kd Ad] and lost with high card Ace
Seat 8: PSFxpXgPedVZyHSu2Zhb7Q showed [Kc Ks] and won ($92) with a pair of Kings
Seat 9: jDwhY1kCdc6EkAHbT7PJMQ folded before Flop (didn't bet)



PokerStars Game #59939501562:  Hold'em No Limit ($0.50/$1.00) - 2009/07/01 0:41:31 ET
Table '8jIjWCPY0NGprquL+xcMFg' 9-max Seat #8 is the button
Seat 1: vR4IO10geOgvTW+LAUBv/A ($135.10 in chips)
Seat 2: rR1qGAf9Q9RYorKYWH3VKw ($5.20 in chips)
Seat 3: tjhwe1V98x2spSoUQER3HQ ($100 in chips)
Seat 4: by0z+YmujwI6Bf4qRFE8vA ($143.30 in chips)
Seat 6: GTQkFJtSkbVbnGCktp6e3g ($108.35 in chips)
Seat 7: O3CGPwwUmamrCNHccOilrg ($47.55 in chips)
Seat 8: 9swGhtpERPngKPtvpoZkoQ ($154.35 in chips)
Seat 9: negfosHnGOZXSHpWDRKyBQ ($19 in chips)
negfosHnGOZXSHpWDRKyBQ: posts small blind $0.50
vR4IO10geOgvTW+LAUBv/A: posts big blind $1
*** HOLE CARDS ***
rR1qGAf9Q9RYorKYWH3VKw: folds
tjhwe1V98x2spSoUQER3HQ: folds
by0z+YmujwI6Bf4qRFE8vA: folds
by0z+YmujwI6Bf4qRFE8vA leaves the table
GTQkFJtSkbVbnGCktp6e3g: raises $3 to $4
O3CGPwwUmamrCNHccOilrg: folds
9swGhtpERPngKPtvpoZkoQ: folds
negfosHnGOZXSHpWDRKyBQ: folds
vR4IO10geOgvTW+LAUBv/A: folds
GTQkFJtSkbVbnGCktp6e3g collected $2.50 from pot
GTQkFJtSkbVbnGCktp6e3g: doesn't show hand
*** SUMMARY ***
Total pot $2.50 | Rake $0
Seat 1: vR4IO10geOgvTW+LAUBv/A (big blind) folded before Flop
Seat 2: rR1qGAf9Q9RYorKYWH3VKw folded before Flop (didn't bet)
Seat 3: tjhwe1V98x2spSoUQER3HQ folded before Flop (didn't bet)
Seat 4: by0z+YmujwI6Bf4qRFE8vA folded before Flop (didn't bet)
Seat 6: GTQkFJtSkbVbnGCktp6e3g collected ($2.50)
Seat 7: O3CGPwwUmamrCNHccOilrg folded before Flop (didn't bet)
Seat 8: 9swGhtpERPngKPtvpoZkoQ (button) folded before Flop (didn't bet)
Seat 9: negfosHnGOZXSHpWDRKyBQ (small blind) folded before Flop



PokerStars Game #59939502042:  Hold'em No Limit ($0.50/$1.00) - 2009/07/01 0:41:32 ET
Table 'GPp0HyAuggN8oE0sUWzPpA' 9-max Seat #2 is the button
Seat 1: qJr25HAtvv1w/7IBvjMM3g ($18.85 in chips)
Seat 2: Ogn4JDV3mp4ZDKO49IFzKA ($34.20 in chips)
Seat 3: L9njYvloJ1NdXjP8edHEAg ($100 in chips)
Seat 4: mBRWbnUl8diyBO1qTJaNzw ($112.70 in chips)
Seat 5: 0fXz44fzDo5QmhAaJCvFfA ($20.80 in chips)
Seat 6: negfosHnGOZXSHpWDRKyBQ ($33.60 in chips)
Seat 8: tkdBeXTJlFsZdioidNqLow ($65.15 in chips)
L9njYvloJ1NdXjP8edHEAg: posts small blind $0.50
mBRWbnUl8diyBO1qTJaNzw: posts big blind $1
laA8va+Yv8WuMqT1zdR91g: sits out
VPF+HjszMvUIpy0CHIwH3A: sits out
*** HOLE CARDS ***
0fXz44fzDo5QmhAaJCvFfA: folds
negfosHnGOZXSHpWDRKyBQ: raises $3 to $4
tkdBeXTJlFsZdioidNqLow: folds
qJr25HAtvv1w/7IBvjMM3g: folds
Ogn4JDV3mp4ZDKO49IFzKA: folds
L9njYvloJ1NdXjP8edHEAg: folds
mBRWbnUl8diyBO1qTJaNzw: folds
negfosHnGOZXSHpWDRKyBQ collected $2.50 from pot
*** SUMMARY ***
Total pot $2.50 | Rake $0
Seat 1: qJr25HAtvv1w/7IBvjMM3g folded before Flop (didn't bet)
Seat 2: Ogn4JDV3mp4ZDKO49IFzKA (button) folded before Flop (didn't bet)
Seat 3: L9njYvloJ1NdXjP8edHEAg (small blind) folded before Flop
Seat 4: mBRWbnUl8diyBO1qTJaNzw (big blind) folded before Flop
Seat 5: 0fXz44fzDo5QmhAaJCvFfA folded before Flop (didn't bet)
Seat 6: negfosHnGOZXSHpWDRKyBQ collected ($2.50)
Seat 8: tkdBeXTJlFsZdioidNqLow folded before Flop (didn't bet)



PokerStars Game #59939502204:  Hold'em No Limit ($0.50/$1.00) - 2009/07/01 0:41:32 ET
Table 'Evb7VW0qfDhFkbgBL3gcqQ' 2-max Seat #1 is the button
Seat 1: NYi6JFscYNrofSXy4sM+Yw ($101.50 in chips)
Seat 2: mJHc7tEZG3SVIX7QQjb5EQ ($53 in chips)
NYi6JFscYNrofSXy4sM+Yw: posts small blind $0.50
mJHc7tEZG3SVIX7QQjb5EQ: posts big blind $1
*** HOLE CARDS ***
NYi6JFscYNrofSXy4sM+Yw: raises $2 to $3
mJHc7tEZG3SVIX7QQjb5EQ: folds
NYi6JFscYNrofSXy4sM+Yw collected $2 from pot
NYi6JFscYNrofSXy4sM+Yw: doesn't show hand
*** SUMMARY ***
Total pot $2 | Rake $0
Seat 1: NYi6JFscYNrofSXy4sM+Yw (button) (small blind) collected ($2)
Seat 2: mJHc7tEZG3SVIX7QQjb5EQ (big blind) folded before Flop



PokerStars Game #59939502936:  Hold'em No Limit ($0.50/$1.00) - 2009/07/01 0:41:33 ET
Table 'QBLDswtHe7Ml0HwAdcMhlw' 2-max Seat #2 is the button
Seat 1: hdNlhiCwI533uwvvTTfC9Q ($117 in chips)
Seat 2: GBkvjkjDWVBEa1e14dh6CA ($51.70 in chips)
GBkvjkjDWVBEa1e14dh6CA: posts small blind $0.50
hdNlhiCwI533uwvvTTfC9Q: posts big blind $1
*** HOLE CARDS ***
GBkvjkjDWVBEa1e14dh6CA: raises $2 to $3
hdNlhiCwI533uwvvTTfC9Q: folds
GBkvjkjDWVBEa1e14dh6CA collected $2 from pot
GBkvjkjDWVBEa1e14dh6CA: doesn't show hand
*** SUMMARY ***
Total pot $2 | Rake $0
Seat 1: hdNlhiCwI533uwvvTTfC9Q (big blind) folded before Flop
Seat 2: GBkvjkjDWVBEa1e14dh6CA (button) (small blind) collected ($2)



PokerStars Game #59939503152:  Hold'em No Limit ($0.50/$1.00) - 2009/07/01 0:41:34 ET
Table 'FKpXUINE6M3UxHG4zaMhHA' 6-max Seat #2 is the button
Seat 1: qNezhXOOUXqwG7b9X5XJAA ($100 in chips)
Seat 2: nDKgwwXJ45hcJfJe01cdxQ ($36.85 in chips)
Seat 3: GOHDYcxP1gP29069kB9HFw ($124.25 in chips)
Seat 4: vw0eLNLy3Huccth4CUZNPQ ($74.30 in chips)
Seat 5: eUBBn2R56C1IQ6Cs/vitwg ($101.50 in chips)
Seat 6: b2a+5TkFf4xJN/Ihhma58Q ($13.40 in chips)
GOHDYcxP1gP29069kB9HFw: posts small blind $0.50
vw0eLNLy3Huccth4CUZNPQ: posts big blind $1
*** HOLE CARDS ***
eUBBn2R56C1IQ6Cs/vitwg: folds
b2a+5TkFf4xJN/Ihhma58Q: folds
qNezhXOOUXqwG7b9X5XJAA: folds
nDKgwwXJ45hcJfJe01cdxQ: calls $1
GOHDYcxP1gP29069kB9HFw: calls $0.50
vw0eLNLy3Huccth4CUZNPQ: checks
*** FLOP *** [As 7s Ac]
GOHDYcxP1gP29069kB9HFw: bets $2
vw0eLNLy3Huccth4CUZNPQ: folds
nDKgwwXJ45hcJfJe01cdxQ: folds
GOHDYcxP1gP29069kB9HFw collected $2.85 from pot
GOHDYcxP1gP29069kB9HFw: doesn't show hand
*** SUMMARY ***
Total pot $3 | Rake $0.15
Board [As 7s Ac]
Seat 1: qNezhXOOUXqwG7b9X5XJAA folded before Flop (didn't bet)
Seat 2: nDKgwwXJ45hcJfJe01cdxQ (button) folded on the Flop
Seat 3: GOHDYcxP1gP29069kB9HFw (small blind) collected ($2.85)
Seat 4: vw0eLNLy3Huccth4CUZNPQ (big blind) folded on the Flop
Seat 5: eUBBn2R56C1IQ6Cs/vitwg folded before Flop (didn't bet)
Seat 6: b2a+5TkFf4xJN/Ihhma58Q folded before Flop (didn't bet)



PokerStars Game #59939505154:  Hold'em No Limit ($0.50/$1.00) - 2009/07/01 0:41:37 ET
Table 'pHrhryH8jPNdQfY62f8v+g' 6-max Seat #6 is the button
Seat 1: fF4botNMr8/ieVPO1YYRLw ($59 in chips)
Seat 2: RqgF7gRoKgRNW8Zoi1ty4A ($124.65 in chips)
Seat 4: wenbG7TaM3H7h5kn78OFNw ($47.30 in chips)
Seat 5: r1/R7y0Ortgoz4lccgW8VA ($34.65 in chips)
Seat 6: xAU6q2/cwmby2sxmA8VcmA ($113.75 in chips)
fF4botNMr8/ieVPO1YYRLw: posts small blind $0.50
RqgF7gRoKgRNW8Zoi1ty4A: posts big blind $1
*** HOLE CARDS ***
wenbG7TaM3H7h5kn78OFNw: folds
r1/R7y0Ortgoz4lccgW8VA: folds
xAU6q2/cwmby2sxmA8VcmA: folds
fF4botNMr8/ieVPO1YYRLw: folds
RqgF7gRoKgRNW8Zoi1ty4A collected $1 from pot
*** SUMMARY ***
Total pot $1 | Rake $0
Seat 1: fF4botNMr8/ieVPO1YYRLw (small blind) folded before Flop
Seat 2: RqgF7gRoKgRNW8Zoi1ty4A (big blind) collected ($1)
Seat 4: wenbG7TaM3H7h5kn78OFNw folded before Flop (didn't bet)
Seat 5: r1/R7y0Ortgoz4lccgW8VA folded before Flop (didn't bet)
Seat 6: xAU6q2/cwmby2sxmA8VcmA (button) folded before Flop (didn't bet)



PokerStars Game #59939506124:  Hold'em No Limit ($0.50/$1.00) - 2009/07/01 0:41:38 ET
Table 'uNlePsyMIqzM691Xkrlk6Q' 9-max Seat #9 is the button
Seat 1: bLbSOSmSOnqE0iTcH/5dxA ($100 in chips)
Seat 2: +OqpStnt0FqbCfyHAWaLbg ($78.15 in chips)
Seat 3: h7qXkU57Bb8ZuPwMyxR8Ug ($20.95 in chips)
Seat 4: TZcz9MEWDA+WydgGruqqbw ($102.65 in chips)
Seat 5: 3obndzTJ6fECz8+wWhMd1w ($18.50 in chips)
Seat 6: uMPEfCcGCfsxmy53tVUMug ($110.60 in chips)
Seat 7: w6cw9nzN7AvkkHBVVjykoQ ($41.40 in chips)
Seat 9: vR4IO10geOgvTW+LAUBv/A ($112.25 in chips)
bLbSOSmSOnqE0iTcH/5dxA: posts small blind $0.50
+OqpStnt0FqbCfyHAWaLbg: posts big blind $1
*** HOLE CARDS ***
OsLmX3x/19szSV115TpL/Q leaves the table
h7qXkU57Bb8ZuPwMyxR8Ug: folds
TZcz9MEWDA+WydgGruqqbw: raises $2.50 to $3.50
laA8va+Yv8WuMqT1zdR91g joins the table at seat #8
3obndzTJ6fECz8+wWhMd1w: folds
uMPEfCcGCfsxmy53tVUMug: folds
w6cw9nzN7AvkkHBVVjykoQ: folds
vR4IO10geOgvTW+LAUBv/A: folds
bLbSOSmSOnqE0iTcH/5dxA: folds
+OqpStnt0FqbCfyHAWaLbg: folds
TZcz9MEWDA+WydgGruqqbw collected $2.50 from pot
TZcz9MEWDA+WydgGruqqbw: doesn't show hand
*** SUMMARY ***
Total pot $2.50 | Rake $0
Seat 1: bLbSOSmSOnqE0iTcH/5dxA (small blind) folded before Flop
Seat 2: +OqpStnt0FqbCfyHAWaLbg (big blind) folded before Flop
Seat 3: h7qXkU57Bb8ZuPwMyxR8Ug folded before Flop (didn't bet)
Seat 4: TZcz9MEWDA+WydgGruqqbw collected ($2.50)
Seat 5: 3obndzTJ6fECz8+wWhMd1w folded before Flop (didn't bet)
Seat 6: uMPEfCcGCfsxmy53tVUMug folded before Flop (didn't bet)
Seat 7: w6cw9nzN7AvkkHBVVjykoQ folded before Flop (didn't bet)
Seat 9: vR4IO10geOgvTW+LAUBv/A (button) folded before Flop (didn't bet)



PokerStars Game #59939505952:  Hold'em No Limit ($0.50/$1.00) - 2009/07/01 0:41:38 ET
Table 'hugOjcwJvzEwZbK7tyiWuQ' 9-max Seat #6 is the button
Seat 1: N9n5Wc3s35DpCrOAUUNAaQ ($128.50 in chips)
Seat 2: r27C1nIV4NS4+qbnrgBQSw ($255.55 in chips)
Seat 3: jDwhY1kCdc6EkAHbT7PJMQ ($107.65 in chips)
Seat 4: UWB3oeddt/GObx2Mix2Anw ($205.75 in chips)
Seat 5: 5BRGWf+R3nt2WS3b5xX+zA ($23.30 in chips)
Seat 6: gUUvmqdVlmvpal6B8nYrmg ($105.40 in chips)
Seat 7: FL3MrLspcF23LYvC4ipBOA ($100.50 in chips)
Seat 8: /zy+DB4S5fUQUSfZWFzYGw ($105.75 in chips)
Seat 9: o6JyUkbzCDw8tUabqtmnlg ($61.20 in chips)
FL3MrLspcF23LYvC4ipBOA: posts small blind $0.50
/zy+DB4S5fUQUSfZWFzYGw: posts big blind $1
*** HOLE CARDS ***
o6JyUkbzCDw8tUabqtmnlg: folds
N9n5Wc3s35DpCrOAUUNAaQ: folds
r27C1nIV4NS4+qbnrgBQSw: folds
jDwhY1kCdc6EkAHbT7PJMQ: folds
UWB3oeddt/GObx2Mix2Anw: folds
o6JyUkbzCDw8tUabqtmnlg leaves the table
5BRGWf+R3nt2WS3b5xX+zA: raises $2 to $3
gUUvmqdVlmvpal6B8nYrmg: folds
FL3MrLspcF23LYvC4ipBOA: folds
/zy+DB4S5fUQUSfZWFzYGw: folds
5BRGWf+R3nt2WS3b5xX+zA collected $2.50 from pot
*** SUMMARY ***
Total pot $2.50 | Rake $0
Seat 1: N9n5Wc3s35DpCrOAUUNAaQ folded before Flop (didn't bet)
Seat 2: r27C1nIV4NS4+qbnrgBQSw folded before Flop (didn't bet)
Seat 3: jDwhY1kCdc6EkAHbT7PJMQ folded before Flop (didn't bet)
Seat 4: UWB3oeddt/GObx2Mix2Anw folded before Flop (didn't bet)
Seat 5: 5BRGWf+R3nt2WS3b5xX+zA collected ($2.50)
Seat 6: gUUvmqdVlmvpal6B8nYrmg (button) folded before Flop (didn't bet)
Seat 7: FL3MrLspcF23LYvC4ipBOA (small blind) folded before Flop
Seat 8: /zy+DB4S5fUQUSfZWFzYGw (big blind) folded before Flop
Seat 9: o6JyUkbzCDw8tUabqtmnlg folded before Flop (didn't bet)



PokerStars Game #59939506608:  Hold'em No Limit ($0.50/$1.00) - 2009/07/01 0:41:39 ET
Table 'cBDNutyLBKEk9+ptwsKmTw' 6-max Seat #4 is the button
Seat 1: xAU6q2/cwmby2sxmA8VcmA ($100 in chips)
Seat 2: 5lY8d6Cnm4HUkt/8FZSj4g ($100 in chips)
Seat 3: G5ZSSN6RSON3gkNvk/SmYg ($108.40 in chips)
Seat 4: 3q7F5QtzC30pSrn0nl9i+A ($23.30 in chips)
Seat 5: OGMLOcTNYZXZU81au7ztUw ($134.45 in chips)
Seat 6: NqVlOSH2lp+pp/TK3vvK5g ($72.20 in chips)
OGMLOcTNYZXZU81au7ztUw: posts small blind $0.50
NqVlOSH2lp+pp/TK3vvK5g: posts big blind $1
5lY8d6Cnm4HUkt/8FZSj4g: posts big blind $1
*** HOLE CARDS ***
xAU6q2/cwmby2sxmA8VcmA: folds
5lY8d6Cnm4HUkt/8FZSj4g: checks
G5ZSSN6RSON3gkNvk/SmYg: folds
3q7F5QtzC30pSrn0nl9i+A: raises $1 to $2
OGMLOcTNYZXZU81au7ztUw: folds
NqVlOSH2lp+pp/TK3vvK5g: calls $1
5lY8d6Cnm4HUkt/8FZSj4g: calls $1
*** FLOP *** [Kd Qd Qc]
NqVlOSH2lp+pp/TK3vvK5g: checks
5lY8d6Cnm4HUkt/8FZSj4g: bets $4
3q7F5QtzC30pSrn0nl9i+A: calls $4
NqVlOSH2lp+pp/TK3vvK5g: folds
*** TURN *** [Kd Qd Qc] [8h]
5lY8d6Cnm4HUkt/8FZSj4g: bets $12
3q7F5QtzC30pSrn0nl9i+A: folds
5lY8d6Cnm4HUkt/8FZSj4g collected $13.80 from pot
5lY8d6Cnm4HUkt/8FZSj4g: doesn't show hand
*** SUMMARY ***
Total pot $14.50 | Rake $0.70
Board [Kd Qd Qc 8h]
Seat 1: xAU6q2/cwmby2sxmA8VcmA folded before Flop (didn't bet)
Seat 2: 5lY8d6Cnm4HUkt/8FZSj4g collected ($13.80)
Seat 3: G5ZSSN6RSON3gkNvk/SmYg folded before Flop (didn't bet)
Seat 4: 3q7F5QtzC30pSrn0nl9i+A (button) folded on the Turn
Seat 5: OGMLOcTNYZXZU81au7ztUw (small blind) folded before Flop
Seat 6: NqVlOSH2lp+pp/TK3vvK5g (big blind) folded on the Flop



PokerStars Game #59939507164:  Hold'em No Limit ($0.50/$1.00) - 2009/07/01 0:41:40 ET
Table 'Evb7VW0qfDhFkbgBL3gcqQ' 2-max Seat #2 is the button
Seat 1: NYi6JFscYNrofSXy4sM+Yw ($102.50 in chips)
Seat 2: mJHc7tEZG3SVIX7QQjb5EQ ($52 in chips)
mJHc7tEZG3SVIX7QQjb5EQ: posts small blind $0.50
NYi6JFscYNrofSXy4sM+Yw: posts big blind $1
*** HOLE CARDS ***
mJHc7tEZG3SVIX7QQjb5EQ: raises $2 to $3
NYi6JFscYNrofSXy4sM+Yw: calls $2
*** FLOP *** [5s Td Qh]
NYi6JFscYNrofSXy4sM+Yw: checks
mJHc7tEZG3SVIX7QQjb5EQ: checks
*** TURN *** [5s Td Qh] [7d]
NYi6JFscYNrofSXy4sM+Yw: checks
mJHc7tEZG3SVIX7QQjb5EQ: checks
*** RIVER *** [5s Td Qh 7d] [7h]
NYi6JFscYNrofSXy4sM+Yw: checks
mJHc7tEZG3SVIX7QQjb5EQ: checks
*** SHOW DOWN ***
NYi6JFscYNrofSXy4sM+Yw: shows [4s 4h] (two pair, Sevens and Fours)
mJHc7tEZG3SVIX7QQjb5EQ: mucks hand
NYi6JFscYNrofSXy4sM+Yw collected $5.70 from pot
*** SUMMARY ***
Total pot $6 | Rake $0.30
Board [5s Td Qh 7d 7h]
Seat 1: NYi6JFscYNrofSXy4sM+Yw (big blind) showed [4s 4h] and won ($5.70) with two pair, Sevens and Fours
Seat 2: mJHc7tEZG3SVIX7QQjb5EQ (button) (small blind) mucked



PokerStars Game #59939509582:  Hold'em No Limit ($0.50/$1.00) - 2009/07/01 0:41:43 ET
Table 'eU3bWpDDg3Z+9R4m4iVmog' 6-max Seat #2 is the button
Seat 1: TSuRyAHnUPCFjP7Z0rEE0w ($191.15 in chips)
Seat 2: 8CAoOzhmB8n3nRFf3V4BTg ($99.30 in chips)
Seat 3: U6tnjwZRpTnM+YkqkCjwyQ ($187.50 in chips)
Seat 4: GDVIsbEJ/DOJsMKE4Asz0A ($75.60 in chips)
Seat 5: AdLVjddOzm+sRNo1Bc3S6Q ($100 in chips)
Seat 6: hpxXcmRkXXI9HE5+5/j/0Q ($120.45 in chips)
U6tnjwZRpTnM+YkqkCjwyQ: posts small blind $0.50
GDVIsbEJ/DOJsMKE4Asz0A: posts big blind $1
*** HOLE CARDS ***
AdLVjddOzm+sRNo1Bc3S6Q: folds
hpxXcmRkXXI9HE5+5/j/0Q: folds
TSuRyAHnUPCFjP7Z0rEE0w: raises $3 to $4
8CAoOzhmB8n3nRFf3V4BTg: folds
U6tnjwZRpTnM+YkqkCjwyQ: folds
GDVIsbEJ/DOJsMKE4Asz0A: folds
TSuRyAHnUPCFjP7Z0rEE0w collected $2.50 from pot
TSuRyAHnUPCFjP7Z0rEE0w: doesn't show hand
*** SUMMARY ***
Total pot $2.50 | Rake $0
Seat 1: TSuRyAHnUPCFjP7Z0rEE0w collected ($2.50)
Seat 2: 8CAoOzhmB8n3nRFf3V4BTg (button) folded before Flop (didn't bet)
Seat 3: U6tnjwZRpTnM+YkqkCjwyQ (small blind) folded before Flop
Seat 4: GDVIsbEJ/DOJsMKE4Asz0A (big blind) folded before Flop
Seat 5: AdLVjddOzm+sRNo1Bc3S6Q folded before Flop (didn't bet)
Seat 6: hpxXcmRkXXI9HE5+5/j/0Q folded before Flop (didn't bet)



PokerStars Game #59939511500:  Hold'em No Limit ($0.50/$1.00) - 2009/07/01 0:41:46 ET
Table 'QBLDswtHe7Ml0HwAdcMhlw' 2-max Seat #1 is the button
Seat 1: hdNlhiCwI533uwvvTTfC9Q ($116 in chips)
Seat 2: GBkvjkjDWVBEa1e14dh6CA ($52.70 in chips)
hdNlhiCwI533uwvvTTfC9Q: posts small blind $0.50
GBkvjkjDWVBEa1e14dh6CA: posts big blind $1
*** HOLE CARDS ***
hdNlhiCwI533uwvvTTfC9Q: raises $2 to $3
GBkvjkjDWVBEa1e14dh6CA: calls $2
*** FLOP *** [Kd Kc Qh]
GBkvjkjDWVBEa1e14dh6CA: bets $4
hdNlhiCwI533uwvvTTfC9Q: folds
GBkvjkjDWVBEa1e14dh6CA collected $5.70 from pot
GBkvjkjDWVBEa1e14dh6CA: doesn't show hand
*** SUMMARY ***
Total pot $6 | Rake $0.30
Board [Kd Kc Qh]
Seat 1: hdNlhiCwI533uwvvTTfC9Q (button) (small blind) folded on the Flop
Seat 2: GBkvjkjDWVBEa1e14dh6CA (big blind) collected ($5.70)



PokerStars Game #59939511880:  Hold'em No Limit ($0.50/$1.00) - 2009/07/01 0:41:47 ET
Table '+cA8mcmhaedZ7YcrDdhmeQ' 6-max Seat #4 is the button
Seat 1: lsLuWlcPA3Rh7kJVLzMh0Q ($308.70 in chips)
Seat 2: RqgF7gRoKgRNW8Zoi1ty4A ($100 in chips)
Seat 3: 7H5WkGzGvsv56y1iaqHvRg ($31.20 in chips)
Seat 4: LjL3AIERHn559yyW1mTUYQ ($154 in chips)
Seat 5: iHo1oDbrEVJ8nEGdaPrICw ($105.85 in chips)
Seat 6: YfsTQsY/fxb+YqbdclTHuw ($59.55 in chips)
iHo1oDbrEVJ8nEGdaPrICw: posts small blind $0.50
YfsTQsY/fxb+YqbdclTHuw: posts big blind $1
*** HOLE CARDS ***
lsLuWlcPA3Rh7kJVLzMh0Q: folds
RqgF7gRoKgRNW8Zoi1ty4A: folds
7H5WkGzGvsv56y1iaqHvRg: folds
LjL3AIERHn559yyW1mTUYQ: folds
iHo1oDbrEVJ8nEGdaPrICw: folds
YfsTQsY/fxb+YqbdclTHuw collected $1 from pot
*** SUMMARY ***
Total pot $1 | Rake $0
Seat 1: lsLuWlcPA3Rh7kJVLzMh0Q folded before Flop (didn't bet)
Seat 2: RqgF7gRoKgRNW8Zoi1ty4A folded before Flop (didn't bet)
Seat 3: 7H5WkGzGvsv56y1iaqHvRg folded before Flop (didn't bet)
Seat 4: LjL3AIERHn559yyW1mTUYQ (button) folded before Flop (didn't bet)
Seat 5: iHo1oDbrEVJ8nEGdaPrICw (small blind) folded before Flop
Seat 6: YfsTQsY/fxb+YqbdclTHuw (big blind) collected ($1)



PokerStars Game #59939511718:  Hold'em No Limit ($0.50/$1.00) - 2009/07/01 0:41:47 ET
Table 'GxCPo/gd3OSthkYrAxJngg' 6-max Seat #3 is the button
Seat 1: sH8BpAFP+jGFxCgVpD1Lew ($253.95 in chips)
Seat 2: YExX2paeIHrmfIwV1ivM/w ($78.20 in chips)
Seat 3: o6plE+MSW4XFNTeONe16xg ($32.60 in chips)
Seat 4: YMJG+F++3Aj6P8dAWda5fw ($107.15 in chips)
Seat 5: G5ZSSN6RSON3gkNvk/SmYg ($111.25 in chips)
Seat 6: sS9IXedL3MiRmpVXhAILhw ($101.95 in chips)
YMJG+F++3Aj6P8dAWda5fw: posts small blind $0.50
G5ZSSN6RSON3gkNvk/SmYg: posts big blind $1
*** HOLE CARDS ***
sS9IXedL3MiRmpVXhAILhw: folds
sH8BpAFP+jGFxCgVpD1Lew: raises $2 to $3
YExX2paeIHrmfIwV1ivM/w: folds
o6plE+MSW4XFNTeONe16xg: folds
YMJG+F++3Aj6P8dAWda5fw: folds
G5ZSSN6RSON3gkNvk/SmYg: folds
sH8BpAFP+jGFxCgVpD1Lew collected $2.50 from pot
*** SUMMARY ***
Total pot $2.50 | Rake $0
Seat 1: sH8BpAFP+jGFxCgVpD1Lew collected ($2.50)
Seat 2: YExX2paeIHrmfIwV1ivM/w folded before Flop (didn't bet)
Seat 3: o6plE+MSW4XFNTeONe16xg (button) folded before Flop (didn't bet)
Seat 4: YMJG+F++3Aj6P8dAWda5fw (small blind) folded before Flop
Seat 5: G5ZSSN6RSON3gkNvk/SmYg (big blind) folded before Flop
Seat 6: sS9IXedL3MiRmpVXhAILhw folded before Flop (didn't bet)



PokerStars Game #59939513038:  Hold'em No Limit ($0.50/$1.00) - 2009/07/01 0:41:49 ET
Table 'Zka9tv1yilg0MvXWPQrShg' 9-max Seat #8 is the button
Seat 1: TZcz9MEWDA+WydgGruqqbw ($115.35 in chips)
Seat 2: rR1qGAf9Q9RYorKYWH3VKw ($23.70 in chips)
Seat 3: gUUvmqdVlmvpal6B8nYrmg ($100 in chips)
Seat 4: CTOae+JLIGfwfXvhqHkP2w ($170.15 in chips)
Seat 5: /zy+DB4S5fUQUSfZWFzYGw ($132.40 in chips)
Seat 6: rY8wPoax1lS+HUY+I0FZDw ($146.30 in chips)
Seat 7: p1SafS90nb3Uft5LB0NkHw ($20 in chips)
Seat 8: bL+QVeDcuEdzMGAGg2XJHg ($117.60 in chips)
Seat 9: 6daxhj43mWj04MOPTOmaYA ($92 in chips)
6daxhj43mWj04MOPTOmaYA: posts small blind $0.50
TZcz9MEWDA+WydgGruqqbw: posts big blind $1
*** HOLE CARDS ***
rR1qGAf9Q9RYorKYWH3VKw: raises $1 to $2
gUUvmqdVlmvpal6B8nYrmg: folds
CTOae+JLIGfwfXvhqHkP2w: calls $2
/zy+DB4S5fUQUSfZWFzYGw: folds
rY8wPoax1lS+HUY+I0FZDw: folds
p1SafS90nb3Uft5LB0NkHw: folds
bL+QVeDcuEdzMGAGg2XJHg: folds
6daxhj43mWj04MOPTOmaYA: folds
TZcz9MEWDA+WydgGruqqbw: folds
*** FLOP *** [5c Jd 8c]
rR1qGAf9Q9RYorKYWH3VKw: bets $4
CTOae+JLIGfwfXvhqHkP2w: raises $8 to $12
rR1qGAf9Q9RYorKYWH3VKw: calls $8
*** TURN *** [5c Jd 8c] [6s]
rR1qGAf9Q9RYorKYWH3VKw: checks
CTOae+JLIGfwfXvhqHkP2w: checks
*** RIVER *** [5c Jd 8c 6s] [Qh]
rR1qGAf9Q9RYorKYWH3VKw: bets $9.70 and is all-in
CTOae+JLIGfwfXvhqHkP2w: calls $9.70
*** SHOW DOWN ***
rR1qGAf9Q9RYorKYWH3VKw: shows [8s As] (a pair of Eights)
CTOae+JLIGfwfXvhqHkP2w: shows [Qd Jh] (two pair, Queens and Jacks)
CTOae+JLIGfwfXvhqHkP2w collected $46.55 from pot
*** SUMMARY ***
Total pot $48.90 | Rake $2.35
Board [5c Jd 8c 6s Qh]
Seat 1: TZcz9MEWDA+WydgGruqqbw (big blind) folded before Flop
Seat 2: rR1qGAf9Q9RYorKYWH3VKw showed [8s As] and lost with a pair of Eights
Seat 3: gUUvmqdVlmvpal6B8nYrmg folded before Flop (didn't bet)
Seat 4: CTOae+JLIGfwfXvhqHkP2w showed [Qd Jh] and won ($46.55) with two pair, Queens and Jacks
Seat 5: /zy+DB4S5fUQUSfZWFzYGw folded before Flop (didn't bet)
Seat 6: rY8wPoax1lS+HUY+I0FZDw folded before Flop (didn't bet)
Seat 7: p1SafS90nb3Uft5LB0NkHw folded before Flop (didn't bet)
Seat 8: bL+QVeDcuEdzMGAGg2XJHg (button) folded before Flop (didn't bet)
Seat 9: 6daxhj43mWj04MOPTOmaYA (small blind) folded before Flop



PokerStars Game #59939513598:  Hold'em No Limit ($0.50/$1.00) - 2009/07/01 0:41:50 ET
Table 'vs/5jr6ciwjVQ5+Soc+u2A' 6-max Seat #2 is the button
Seat 1: 1C0rFAGdnnX4GWK9B0YPww ($25.50 in chips)
Seat 2: XOIf9W+VAxhZqN+SYoyMKA ($126.15 in chips)
Seat 3: G5ZSSN6RSON3gkNvk/SmYg ($151 in chips)
Seat 4: KpnW5CcJ4Mg6MeclfKmLrw ($104.30 in chips)
Seat 5: imUnjybOc/YBYCgM7m/qSA ($20 in chips)
Seat 6: QHvTZcrKe6+maWUfVjP29Q ($101.10 in chips)
G5ZSSN6RSON3gkNvk/SmYg: posts small blind $0.50
KpnW5CcJ4Mg6MeclfKmLrw: posts big blind $1
imUnjybOc/YBYCgM7m/qSA: posts big blind $1
*** HOLE CARDS ***
imUnjybOc/YBYCgM7m/qSA: checks
QHvTZcrKe6+maWUfVjP29Q: folds
1C0rFAGdnnX4GWK9B0YPww: raises $3 to $4
XOIf9W+VAxhZqN+SYoyMKA: folds
G5ZSSN6RSON3gkNvk/SmYg: folds
KpnW5CcJ4Mg6MeclfKmLrw: folds
imUnjybOc/YBYCgM7m/qSA: calls $3
*** FLOP *** [3c 9d 3d]
imUnjybOc/YBYCgM7m/qSA: bets $3
1C0rFAGdnnX4GWK9B0YPww: raises $5 to $8
imUnjybOc/YBYCgM7m/qSA: calls $5
*** TURN *** [3c 9d 3d] [6h]
imUnjybOc/YBYCgM7m/qSA: checks
1C0rFAGdnnX4GWK9B0YPww: checks
*** RIVER *** [3c 9d 3d 6h] [Th]
imUnjybOc/YBYCgM7m/qSA: bets $5
1C0rFAGdnnX4GWK9B0YPww: folds
imUnjybOc/YBYCgM7m/qSA collected $24.25 from pot
*** SUMMARY ***
Total pot $25.50 | Rake $1.25
Board [3c 9d 3d 6h Th]
Seat 1: 1C0rFAGdnnX4GWK9B0YPww folded on the River
Seat 2: XOIf9W+VAxhZqN+SYoyMKA (button) folded before Flop (didn't bet)
Seat 3: G5ZSSN6RSON3gkNvk/SmYg (small blind) folded before Flop
Seat 4: KpnW5CcJ4Mg6MeclfKmLrw (big blind) folded before Flop
Seat 5: imUnjybOc/YBYCgM7m/qSA collected ($24.25)
Seat 6: QHvTZcrKe6+maWUfVjP29Q folded before Flop (didn't bet)



PokerStars Game #59939513696:  Hold'em No Limit ($0.50/$1.00) - 2009/07/01 0:41:50 ET
Table '7Nl0ffnjeK44/vmeexh3MQ' 9-max Seat #9 is the button
Seat 1: s7D3Y+k4Cj4D1cXHv7oj+Q ($91.80 in chips)
Seat 2: kiakSwxX0e64PwYGAPQvLw ($31.85 in chips)
Seat 3: vR4IO10geOgvTW+LAUBv/A ($103 in chips)
Seat 4: bLbSOSmSOnqE0iTcH/5dxA ($100 in chips)
Seat 5: bL+QVeDcuEdzMGAGg2XJHg ($99.50 in chips)
Seat 6: FVs16t7GgfWgQWt4JxsObQ ($25.90 in chips)
Seat 8: zanka7aAZkigmZpfopXxxA ($253.70 in chips)
Seat 9: ouwUBGRKnKK9uhn1G4Lf+A ($95 in chips)
s7D3Y+k4Cj4D1cXHv7oj+Q: posts small blind $0.50
kiakSwxX0e64PwYGAPQvLw: posts big blind $1
997ViqAtWn1FPjJqcffwcA: sits out
*** HOLE CARDS ***
vR4IO10geOgvTW+LAUBv/A: folds
bLbSOSmSOnqE0iTcH/5dxA: calls $1
bL+QVeDcuEdzMGAGg2XJHg: folds
FVs16t7GgfWgQWt4JxsObQ: calls $1
zanka7aAZkigmZpfopXxxA: folds
ouwUBGRKnKK9uhn1G4Lf+A: folds
s7D3Y+k4Cj4D1cXHv7oj+Q: folds
kiakSwxX0e64PwYGAPQvLw: checks
*** FLOP *** [7h 9s 7d]
kiakSwxX0e64PwYGAPQvLw: checks
bLbSOSmSOnqE0iTcH/5dxA: checks
FVs16t7GgfWgQWt4JxsObQ: checks
*** TURN *** [7h 9s 7d] [2h]
kiakSwxX0e64PwYGAPQvLw: checks
bLbSOSmSOnqE0iTcH/5dxA: checks
FVs16t7GgfWgQWt4JxsObQ: bets $2
kiakSwxX0e64PwYGAPQvLw: folds
bLbSOSmSOnqE0iTcH/5dxA: folds
FVs16t7GgfWgQWt4JxsObQ collected $3.35 from pot
*** SUMMARY ***
Total pot $3.50 | Rake $0.15
Board [7h 9s 7d 2h]
Seat 1: s7D3Y+k4Cj4D1cXHv7oj+Q (small blind) folded before Flop
Seat 2: kiakSwxX0e64PwYGAPQvLw (big blind) folded on the Turn
Seat 3: vR4IO10geOgvTW+LAUBv/A folded before Flop (didn't bet)
Seat 4: bLbSOSmSOnqE0iTcH/5dxA folded on the Turn
Seat 5: bL+QVeDcuEdzMGAGg2XJHg folded before Flop (didn't bet)
Seat 6: FVs16t7GgfWgQWt4JxsObQ collected ($3.35)
Seat 8: zanka7aAZkigmZpfopXxxA folded before Flop (didn't bet)
Seat 9: ouwUBGRKnKK9uhn1G4Lf+A (button) folded before Flop (didn't bet)



PokerStars Game #59939515882:  Hold'em No Limit ($0.50/$1.00) - 2009/07/01 0:41:53 ET
Table 'OEonapnv+AHzisWWNNua0Q' 2-max Seat #1 is the button
Seat 1: 8IItNAJFln4siZ+XXuzGhg ($85.50 in chips)
Seat 2: iXXpsR/zdmiswg1I4gJ8kw ($4 in chips)
8IItNAJFln4siZ+XXuzGhg: posts small blind $0.50
iXXpsR/zdmiswg1I4gJ8kw: posts big blind $1
*** HOLE CARDS ***
8IItNAJFln4siZ+XXuzGhg: calls $0.50
iXXpsR/zdmiswg1I4gJ8kw: raises $1 to $2
8IItNAJFln4siZ+XXuzGhg: raises $3 to $5
iXXpsR/zdmiswg1I4gJ8kw: folds
8IItNAJFln4siZ+XXuzGhg collected $4 from pot
*** SUMMARY ***
Total pot $4 | Rake $0
Seat 1: 8IItNAJFln4siZ+XXuzGhg (button) (small blind) collected ($4)
Seat 2: iXXpsR/zdmiswg1I4gJ8kw (big blind) folded before Flop



PokerStars Game #59939517320:  Hold'em No Limit ($0.50/$1.00) - 2009/07/01 0:41:55 ET
Table 'eU3bWpDDg3Z+9R4m4iVmog' 6-max Seat #3 is the button
Seat 1: TSuRyAHnUPCFjP7Z0rEE0w ($192.65 in chips)
Seat 2: 8CAoOzhmB8n3nRFf3V4BTg ($99.30 in chips)
Seat 3: U6tnjwZRpTnM+YkqkCjwyQ ($187 in chips)
Seat 4: GDVIsbEJ/DOJsMKE4Asz0A ($74.60 in chips)
Seat 5: AdLVjddOzm+sRNo1Bc3S6Q ($100 in chips)
Seat 6: hpxXcmRkXXI9HE5+5/j/0Q ($120.45 in chips)
GDVIsbEJ/DOJsMKE4Asz0A: posts small blind $0.50
AdLVjddOzm+sRNo1Bc3S6Q: posts big blind $1
*** HOLE CARDS ***
hpxXcmRkXXI9HE5+5/j/0Q: raises $2 to $3
TSuRyAHnUPCFjP7Z0rEE0w: folds
8CAoOzhmB8n3nRFf3V4BTg: folds
U6tnjwZRpTnM+YkqkCjwyQ: folds
GDVIsbEJ/DOJsMKE4Asz0A: folds
AdLVjddOzm+sRNo1Bc3S6Q: folds
hpxXcmRkXXI9HE5+5/j/0Q collected $2.50 from pot
hpxXcmRkXXI9HE5+5/j/0Q: doesn't show hand
*** SUMMARY ***
Total pot $2.50 | Rake $0
Seat 1: TSuRyAHnUPCFjP7Z0rEE0w folded before Flop (didn't bet)
Seat 2: 8CAoOzhmB8n3nRFf3V4BTg folded before Flop (didn't bet)
Seat 3: U6tnjwZRpTnM+YkqkCjwyQ (button) folded before Flop (didn't bet)
Seat 4: GDVIsbEJ/DOJsMKE4Asz0A (small blind) folded before Flop
Seat 5: AdLVjddOzm+sRNo1Bc3S6Q (big blind) folded before Flop
Seat 6: hpxXcmRkXXI9HE5+5/j/0Q collected ($2.50)



PokerStars Game #59939516930:  Hold'em No Limit ($0.50/$1.00) - 2009/07/01 0:41:55 ET
Table 'pHrhryH8jPNdQfY62f8v+g' 6-max Seat #1 is the button
Seat 1: fF4botNMr8/ieVPO1YYRLw ($58.50 in chips)
Seat 2: RqgF7gRoKgRNW8Zoi1ty4A ($125.15 in chips)
Seat 4: wenbG7TaM3H7h5kn78OFNw ($47.30 in chips)
Seat 5: r1/R7y0Ortgoz4lccgW8VA ($34.65 in chips)
Seat 6: xAU6q2/cwmby2sxmA8VcmA ($113.75 in chips)
RqgF7gRoKgRNW8Zoi1ty4A: posts small blind $0.50
wenbG7TaM3H7h5kn78OFNw: posts big blind $1
*** HOLE CARDS ***
r1/R7y0Ortgoz4lccgW8VA: folds
xAU6q2/cwmby2sxmA8VcmA: folds
fF4botNMr8/ieVPO1YYRLw: raises $1.50 to $2.50
RqgF7gRoKgRNW8Zoi1ty4A: folds
wenbG7TaM3H7h5kn78OFNw: folds
fF4botNMr8/ieVPO1YYRLw collected $2.50 from pot
*** SUMMARY ***
Total pot $2.50 | Rake $0
Seat 1: fF4botNMr8/ieVPO1YYRLw (button) collected ($2.50)
Seat 2: RqgF7gRoKgRNW8Zoi1ty4A (small blind) folded before Flop
Seat 4: wenbG7TaM3H7h5kn78OFNw (big blind) folded before Flop
Seat 5: r1/R7y0Ortgoz4lccgW8VA folded before Flop (didn't bet)
Seat 6: xAU6q2/cwmby2sxmA8VcmA folded before Flop (didn't bet)



PokerStars Game #59939517444:  Hold'em No Limit ($0.50/$1.00) - 2009/07/01 0:41:56 ET
Table 'N2bNCDHL96aCQDvZIh+yQQ' 6-max Seat #2 is the button
Seat 1: iHo1oDbrEVJ8nEGdaPrICw ($100 in chips)
Seat 2: KpnW5CcJ4Mg6MeclfKmLrw ($118.10 in chips)
Seat 3: Qy/UBNbD2HaA0Ogxg8Sf3w ($197 in chips)
Seat 4: uCqEjnxh2/vFBjKYkfTOkw ($172.40 in chips)
Seat 5: rHlMOfR7kpQQxe+PFQz0xQ ($30.75 in chips)
Seat 6: TSuRyAHnUPCFjP7Z0rEE0w ($100 in chips)
Qy/UBNbD2HaA0Ogxg8Sf3w: posts small blind $0.50
uCqEjnxh2/vFBjKYkfTOkw: posts big blind $1
*** HOLE CARDS ***
rHlMOfR7kpQQxe+PFQz0xQ: folds
TSuRyAHnUPCFjP7Z0rEE0w: folds
iHo1oDbrEVJ8nEGdaPrICw: raises $2 to $3
KpnW5CcJ4Mg6MeclfKmLrw: folds
Qy/UBNbD2HaA0Ogxg8Sf3w: folds
uCqEjnxh2/vFBjKYkfTOkw: folds
iHo1oDbrEVJ8nEGdaPrICw collected $2.50 from pot
iHo1oDbrEVJ8nEGdaPrICw: doesn't show hand
*** SUMMARY ***
Total pot $2.50 | Rake $0
Seat 1: iHo1oDbrEVJ8nEGdaPrICw collected ($2.50)
Seat 2: KpnW5CcJ4Mg6MeclfKmLrw (button) folded before Flop (didn't bet)
Seat 3: Qy/UBNbD2HaA0Ogxg8Sf3w (small blind) folded before Flop
Seat 4: uCqEjnxh2/vFBjKYkfTOkw (big blind) folded before Flop
Seat 5: rHlMOfR7kpQQxe+PFQz0xQ folded before Flop (didn't bet)
Seat 6: TSuRyAHnUPCFjP7Z0rEE0w folded before Flop (didn't bet)



PokerStars Game #59939519112:  Hold'em No Limit ($0.50/$1.00) - 2009/07/01 0:41:58 ET
Table 'Evb7VW0qfDhFkbgBL3gcqQ' 2-max Seat #1 is the button
Seat 1: NYi6JFscYNrofSXy4sM+Yw ($105.20 in chips)
Seat 2: mJHc7tEZG3SVIX7QQjb5EQ ($49 in chips)
NYi6JFscYNrofSXy4sM+Yw: posts small blind $0.50
mJHc7tEZG3SVIX7QQjb5EQ: posts big blind $1
*** HOLE CARDS ***
NYi6JFscYNrofSXy4sM+Yw: folds
mJHc7tEZG3SVIX7QQjb5EQ collected $1 from pot
mJHc7tEZG3SVIX7QQjb5EQ: doesn't show hand
*** SUMMARY ***
Total pot $1 | Rake $0
Seat 1: NYi6JFscYNrofSXy4sM+Yw (button) (small blind) folded before Flop
Seat 2: mJHc7tEZG3SVIX7QQjb5EQ (big blind) collected ($1)



PokerStars Game #59939518958:  Hold'em No Limit ($0.50/$1.00) - 2009/07/01 0:41:58 ET
Table 'rmZfTK+oSebeUPJNbWhdAA' 6-max Seat #3 is the button
Seat 1: xAU6q2/cwmby2sxmA8VcmA ($103.05 in chips)
Seat 2: z7O9PO/WEcqRouIydFhS9Q ($92.50 in chips)
Seat 3: 9yjOzGERLaEZS8CZ6YNHFg ($111.85 in chips)
Seat 4: OGMLOcTNYZXZU81au7ztUw ($141.10 in chips)
Seat 6: j7NIOHLZk7V2o9fOioO5ug ($132.50 in chips)
OGMLOcTNYZXZU81au7ztUw: posts small blind $0.50
+xW7QemQU0Fxs+4TnqBRow: is sitting out
j7NIOHLZk7V2o9fOioO5ug: posts big blind $1
*** HOLE CARDS ***
xAU6q2/cwmby2sxmA8VcmA: folds
z7O9PO/WEcqRouIydFhS9Q: folds
9yjOzGERLaEZS8CZ6YNHFg: folds
OGMLOcTNYZXZU81au7ztUw: folds
j7NIOHLZk7V2o9fOioO5ug collected $1 from pot
j7NIOHLZk7V2o9fOioO5ug: doesn't show hand
*** SUMMARY ***
Total pot $1 | Rake $0
Seat 1: xAU6q2/cwmby2sxmA8VcmA folded before Flop (didn't bet)
Seat 2: z7O9PO/WEcqRouIydFhS9Q folded before Flop (didn't bet)
Seat 3: 9yjOzGERLaEZS8CZ6YNHFg (button) folded before Flop (didn't bet)
Seat 4: OGMLOcTNYZXZU81au7ztUw (small blind) folded before Flop
Seat 6: j7NIOHLZk7V2o9fOioO5ug (big blind) collected ($1)



PokerStars Game #59939522266:  Hold'em No Limit ($0.50/$1.00) - 2009/07/01 0:42:01 ET
Table '/RZcOwpZpHQ+OwPwjsbnRw' 6-max Seat #5 is the button
Seat 1: Zboa6dColKGHBjLPUakZjw ($56.70 in chips)
Seat 2: +xW7QemQU0Fxs+4TnqBRow ($194.50 in chips)
Seat 4: j7NIOHLZk7V2o9fOioO5ug ($100 in chips)
Seat 5: wx3sQGkVi2x9wJXuWNHPBw ($195.15 in chips)
Seat 6: XOIf9W+VAxhZqN+SYoyMKA ($289.05 in chips)
XOIf9W+VAxhZqN+SYoyMKA: posts small blind $0.50
Zboa6dColKGHBjLPUakZjw: posts big blind $1
XnT1yK2DD/5FL+0bwuEhqg: sits out
*** HOLE CARDS ***
+xW7QemQU0Fxs+4TnqBRow: folds
j7NIOHLZk7V2o9fOioO5ug: folds
wx3sQGkVi2x9wJXuWNHPBw: folds
XOIf9W+VAxhZqN+SYoyMKA: folds
Zboa6dColKGHBjLPUakZjw collected $1 from pot
*** SUMMARY ***
Total pot $1 | Rake $0
Seat 1: Zboa6dColKGHBjLPUakZjw (big blind) collected ($1)
Seat 2: +xW7QemQU0Fxs+4TnqBRow folded before Flop (didn't bet)
Seat 4: j7NIOHLZk7V2o9fOioO5ug folded before Flop (didn't bet)
Seat 5: wx3sQGkVi2x9wJXuWNHPBw (button) folded before Flop (didn't bet)
Seat 6: XOIf9W+VAxhZqN+SYoyMKA (small blind) folded before Flop



PokerStars Game #59939522602:  Hold'em No Limit ($0.50/$1.00) - 2009/07/01 0:42:02 ET
Table 'LmXQK9xy3awB+qsPzI21Mw' 2-max Seat #1 is the button
Seat 1: NYi6JFscYNrofSXy4sM+Yw ($251.10 in chips)
Seat 2: TME8GvochpQAo8cmJwWmvA ($85.35 in chips)
NYi6JFscYNrofSXy4sM+Yw: posts small blind $0.50
TME8GvochpQAo8cmJwWmvA: posts big blind $1
*** HOLE CARDS ***
NYi6JFscYNrofSXy4sM+Yw: raises $2 to $3
TME8GvochpQAo8cmJwWmvA: calls $2
*** FLOP *** [7h 6d 8h]
TME8GvochpQAo8cmJwWmvA: checks
NYi6JFscYNrofSXy4sM+Yw: bets $3
TME8GvochpQAo8cmJwWmvA: raises $79.35 to $82.35 and is all-in
NYi6JFscYNrofSXy4sM+Yw: folds
TME8GvochpQAo8cmJwWmvA collected $11.50 from pot
TME8GvochpQAo8cmJwWmvA: doesn't show hand
*** SUMMARY ***
Total pot $12 | Rake $0.50
Board [7h 6d 8h]
Seat 1: NYi6JFscYNrofSXy4sM+Yw (button) (small blind) folded on the Flop
Seat 2: TME8GvochpQAo8cmJwWmvA (big blind) collected ($11.50)



PokerStars Game #59939522610:  Hold'em No Limit ($0.50/$1.00) - 2009/07/01 0:42:02 ET
Table 'SQLOQoANiHscJ8AL7zffbw' 9-max Seat #6 is the button
Seat 1: jPTRd6SpCp4xqAy2XQiTOw ($134.60 in chips)
Seat 2: /zy+DB4S5fUQUSfZWFzYGw ($276.35 in chips)
Seat 3: 0eFnow7+D7veCYQ+CG9FFw ($79.90 in chips)
Seat 4: N9n5Wc3s35DpCrOAUUNAaQ ($92.35 in chips)
Seat 5: L9njYvloJ1NdXjP8edHEAg ($107.05 in chips)
Seat 6: p5UKaxVobvptF0ANhR/q1A ($174.50 in chips)
Seat 7: bJckevFOcg//s0qyMQI6sQ ($100 in chips)
Seat 8: Pp/KTcXkfZKKUHkjyaLTdg ($20 in chips)
Seat 9: qJr25HAtvv1w/7IBvjMM3g ($232.75 in chips)
bJckevFOcg//s0qyMQI6sQ: posts small blind $0.50
Pp/KTcXkfZKKUHkjyaLTdg: posts big blind $1
*** HOLE CARDS ***
qJr25HAtvv1w/7IBvjMM3g: calls $1
jPTRd6SpCp4xqAy2XQiTOw: raises $3 to $4
/zy+DB4S5fUQUSfZWFzYGw: folds
0eFnow7+D7veCYQ+CG9FFw: folds
N9n5Wc3s35DpCrOAUUNAaQ: folds
L9njYvloJ1NdXjP8edHEAg: folds
p5UKaxVobvptF0ANhR/q1A: folds
bJckevFOcg//s0qyMQI6sQ: calls $3.50
Pp/KTcXkfZKKUHkjyaLTdg: raises $16 to $20 and is all-in
qJr25HAtvv1w/7IBvjMM3g: folds
jPTRd6SpCp4xqAy2XQiTOw: folds
bJckevFOcg//s0qyMQI6sQ: folds
Pp/KTcXkfZKKUHkjyaLTdg collected $13 from pot
*** SUMMARY ***
Total pot $13 | Rake $0
Seat 1: jPTRd6SpCp4xqAy2XQiTOw folded before Flop
Seat 2: /zy+DB4S5fUQUSfZWFzYGw folded before Flop (didn't bet)
Seat 3: 0eFnow7+D7veCYQ+CG9FFw folded before Flop (didn't bet)
Seat 4: N9n5Wc3s35DpCrOAUUNAaQ folded before Flop (didn't bet)
Seat 5: L9njYvloJ1NdXjP8edHEAg folded before Flop (didn't bet)
Seat 6: p5UKaxVobvptF0ANhR/q1A (button) folded before Flop (didn't bet)
Seat 7: bJckevFOcg//s0qyMQI6sQ (small blind) folded before Flop
Seat 8: Pp/KTcXkfZKKUHkjyaLTdg (big blind) collected ($13)
Seat 9: qJr25HAtvv1w/7IBvjMM3g folded before Flop



PokerStars Game #59939523668:  Hold'em No Limit ($0.50/$1.00) - 2009/07/01 0:42:04 ET
Table 'Evb7VW0qfDhFkbgBL3gcqQ' 2-max Seat #2 is the button
Seat 1: NYi6JFscYNrofSXy4sM+Yw ($104.70 in chips)
Seat 2: mJHc7tEZG3SVIX7QQjb5EQ ($49.50 in chips)
mJHc7tEZG3SVIX7QQjb5EQ: posts small blind $0.50
NYi6JFscYNrofSXy4sM+Yw: posts big blind $1
*** HOLE CARDS ***
mJHc7tEZG3SVIX7QQjb5EQ: raises $2 to $3
NYi6JFscYNrofSXy4sM+Yw: raises $7 to $10
mJHc7tEZG3SVIX7QQjb5EQ: folds
mJHc7tEZG3SVIX7QQjb5EQ is sitting out
mJHc7tEZG3SVIX7QQjb5EQ has returned
NYi6JFscYNrofSXy4sM+Yw collected $6 from pot
mJHc7tEZG3SVIX7QQjb5EQ leaves the table
*** SUMMARY ***
Total pot $6 | Rake $0
Seat 1: NYi6JFscYNrofSXy4sM+Yw (big blind) collected ($6)
Seat 2: mJHc7tEZG3SVIX7QQjb5EQ (button) (small blind) folded before Flop



PokerStars Game #59939523946:  Hold'em No Limit ($0.50/$1.00) - 2009/07/01 0:42:04 ET
Table 'QBLDswtHe7Ml0HwAdcMhlw' 2-max Seat #2 is the button
Seat 1: hdNlhiCwI533uwvvTTfC9Q ($113 in chips)
Seat 2: GBkvjkjDWVBEa1e14dh6CA ($55.40 in chips)
GBkvjkjDWVBEa1e14dh6CA: posts small blind $0.50
hdNlhiCwI533uwvvTTfC9Q: posts big blind $1
*** HOLE CARDS ***
GBkvjkjDWVBEa1e14dh6CA: raises $2 to $3
hdNlhiCwI533uwvvTTfC9Q: raises $8 to $11
GBkvjkjDWVBEa1e14dh6CA: folds
hdNlhiCwI533uwvvTTfC9Q collected $6 from pot
hdNlhiCwI533uwvvTTfC9Q: doesn't show hand
*** SUMMARY ***
Total pot $6 | Rake $0
Seat 1: hdNlhiCwI533uwvvTTfC9Q (big blind) collected ($6)
Seat 2: GBkvjkjDWVBEa1e14dh6CA (button) (small blind) folded before Flop



PokerStars Game #59939524142:  Hold'em No Limit ($0.50/$1.00) - 2009/07/01 0:42:04 ET
Table 'U9zqzC8f3oTJ2ShXFgSSOA' 6-max Seat #1 is the button
Seat 1: tS9JHB1h+FQ++qu8RwRNgg ($79.05 in chips)
Seat 2: U2CWBTv29qdCbj8RNF2sIw ($98.50 in chips)
Seat 3: yfXek8iJ7O4CFyqXrtGcfg ($12.05 in chips)
Seat 4: 33q95we0Etwgrm6guQGncw ($90.10 in chips)
Seat 5: KfwW5us6tydK81NYTtK1gw ($295.25 in chips)
Seat 6: aIxzFKdtpDSkUePKZy/niQ ($23.75 in chips)
U2CWBTv29qdCbj8RNF2sIw: posts small blind $0.50
yfXek8iJ7O4CFyqXrtGcfg: posts big blind $1
*** HOLE CARDS ***
33q95we0Etwgrm6guQGncw: folds
KfwW5us6tydK81NYTtK1gw: folds
aIxzFKdtpDSkUePKZy/niQ: raises $2 to $3
tS9JHB1h+FQ++qu8RwRNgg: folds
U2CWBTv29qdCbj8RNF2sIw: calls $2.50
yfXek8iJ7O4CFyqXrtGcfg: folds
*** FLOP *** [9s Ac 8d]
U2CWBTv29qdCbj8RNF2sIw: checks
aIxzFKdtpDSkUePKZy/niQ: bets $5
U2CWBTv29qdCbj8RNF2sIw: folds
U2CWBTv29qdCbj8RNF2sIw is sitting out
aIxzFKdtpDSkUePKZy/niQ collected $6.65 from pot
U2CWBTv29qdCbj8RNF2sIw has returned
*** SUMMARY ***
Total pot $7 | Rake $0.35
Board [9s Ac 8d]
Seat 1: tS9JHB1h+FQ++qu8RwRNgg (button) folded before Flop (didn't bet)
Seat 2: U2CWBTv29qdCbj8RNF2sIw (small blind) folded on the Flop
Seat 3: yfXek8iJ7O4CFyqXrtGcfg (big blind) folded before Flop
Seat 4: 33q95we0Etwgrm6guQGncw folded before Flop (didn't bet)
Seat 5: KfwW5us6tydK81NYTtK1gw folded before Flop (didn't bet)
Seat 6: aIxzFKdtpDSkUePKZy/niQ collected ($6.65)



PokerStars Game #59939524212:  Hold'em No Limit ($0.50/$1.00) - 2009/07/01 0:42:04 ET
Table 'tyUh+jyNvrceIQdKMJjQ2wZFWj23PMihdwrNWv41OG/Qeat #5 is the button
Seat 1: o8A5MUdudVKu+pAwgZOX2w ($229.45 in chips)
Seat 2: XvUbOIg94d25feWeQlOTVg ($59 in chips)
Seat 3: TalCiLYHCd+ffkmR3auPvA ($67.20 in chips)
Seat 4: TSuRyAHnUPCFjP7Z0rEE0w ($119.75 in chips)
Seat 5: j7NIOHLZk7V2o9fOioO5ug ($111.60 in chips)
Seat 6: YsLQ3BAvgQHWXMAv3Wv6Hg ($150.25 in chips)
YsLQ3BAvgQHWXMAv3Wv6Hg: posts small blind $0.50
o8A5MUdudVKu+pAwgZOX2w: posts big blind $1
*** HOLE CARDS ***
XvUbOIg94d25feWeQlOTVg: raises $1 to $2
TalCiLYHCd+ffkmR3auPvA: folds
TSuRyAHnUPCFjP7Z0rEE0w: folds
j7NIOHLZk7V2o9fOioO5ug: folds
YsLQ3BAvgQHWXMAv3Wv6Hg: folds
o8A5MUdudVKu+pAwgZOX2w: calls $1
*** FLOP *** [Kh 2d 8d]
o8A5MUdudVKu+pAwgZOX2w: checks
XvUbOIg94d25feWeQlOTVg: bets $3
o8A5MUdudVKu+pAwgZOX2w: folds
XvUbOIg94d25feWeQlOTVg collected $4.30 from pot
*** SUMMARY ***
Total pot $4.50 | Rake $0.20
Board [Kh 2d 8d]
Seat 1: o8A5MUdudVKu+pAwgZOX2w (big blind) folded on the Flop
Seat 2: XvUbOIg94d25feWeQlOTVg collected ($4.30)
Seat 3: TalCiLYHCd+ffkmR3auPvA folded before Flop (didn't bet)
Seat 4: TSuRyAHnUPCFjP7Z0rEE0w folded before Flop (didn't bet)
Seat 5: j7NIOHLZk7V2o9fOioO5ug (button) folded before Flop (didn't bet)
Seat 6: YsLQ3BAvgQHWXMAv3Wv6Hg (small blind) folded before Flop



PokerStars Game #59939524308:  Hold'em No Limit ($0.50/$1.00) - 2009/07/01 0:42:05 ET
Table '+cA8mcmhaedZ7YcrDdhmeQ' 6-max Seat #5 is the button
Seat 1: lsLuWlcPA3Rh7kJVLzMh0Q ($308.70 in chips)
Seat 2: RqgF7gRoKgRNW8Zoi1ty4A ($100 in chips)
Seat 3: 7H5WkGzGvsv56y1iaqHvRg ($31.20 in chips)
Seat 4: LjL3AIERHn559yyW1mTUYQ ($154 in chips)
Seat 5: iHo1oDbrEVJ8nEGdaPrICw ($105.35 in chips)
Seat 6: YfsTQsY/fxb+YqbdclTHuw ($60.05 in chips)
YfsTQsY/fxb+YqbdclTHuw: posts small blind $0.50
lsLuWlcPA3Rh7kJVLzMh0Q: posts big blind $1
*** HOLE CARDS ***
RqgF7gRoKgRNW8Zoi1ty4A: raises $3 to $4
7H5WkGzGvsv56y1iaqHvRg: folds
LjL3AIERHn559yyW1mTUYQ: folds
iHo1oDbrEVJ8nEGdaPrICw: folds
YfsTQsY/fxb+YqbdclTHuw: folds
lsLuWlcPA3Rh7kJVLzMh0Q: folds
RqgF7gRoKgRNW8Zoi1ty4A collected $2.50 from pot
*** SUMMARY ***
Total pot $2.50 | Rake $0
Seat 1: lsLuWlcPA3Rh7kJVLzMh0Q (big blind) folded before Flop
Seat 2: RqgF7gRoKgRNW8Zoi1ty4A collected ($2.50)
Seat 3: 7H5WkGzGvsv56y1iaqHvRg folded before Flop (didn't bet)
Seat 4: LjL3AIERHn559yyW1mTUYQ folded before Flop (didn't bet)
Seat 5: iHo1oDbrEVJ8nEGdaPrICw (button) folded before Flop (didn't bet)
Seat 6: YfsTQsY/fxb+YqbdclTHuw (small blind) folded before Flop



PokerStars Game #59939526158:  Hold'em No Limit ($0.50/$1.00) - 2009/07/01 0:42:08 ET
Table 'fTlPiCj0utgzC/5io+I7ew' 6-max Seat #3 is the button
Seat 1: YMJG+F++3Aj6P8dAWda5fw ($97 in chips)
Seat 2: Qy/UBNbD2HaA0Ogxg8Sf3w ($105.95 in chips)
Seat 3: oDiBRCaF0QVtd3kO6xZIXw ($83.10 in chips)
Seat 4: uJVSceLggtsrJya+WtmUEA ($97.80 in chips)
Seat 5: bFrTkDcWGTxyvNul7GVdYg ($256.70 in chips)
Seat 6: jMljU/dOPMXfJi8OmbdYdw ($60.70 in chips)
uJVSceLggtsrJya+WtmUEA: posts small blind $0.50
bFrTkDcWGTxyvNul7GVdYg: posts big blind $1
*** HOLE CARDS ***
jMljU/dOPMXfJi8OmbdYdw: folds
jMljU/dOPMXfJi8OmbdYdw leaves the table
YMJG+F++3Aj6P8dAWda5fw: folds
Qy/UBNbD2HaA0Ogxg8Sf3w: folds
oDiBRCaF0QVtd3kO6xZIXw: raises $2 to $3
uJVSceLggtsrJya+WtmUEA: folds
bFrTkDcWGTxyvNul7GVdYg: folds
oDiBRCaF0QVtd3kO6xZIXw collected $2.50 from pot
*** SUMMARY ***
Total pot $2.50 | Rake $0
Seat 1: YMJG+F++3Aj6P8dAWda5fw folded before Flop (didn't bet)
Seat 2: Qy/UBNbD2HaA0Ogxg8Sf3w folded before Flop (didn't bet)
Seat 3: oDiBRCaF0QVtd3kO6xZIXw (button) collected ($2.50)
Seat 4: uJVSceLggtsrJya+WtmUEA (small blind) folded before Flop
Seat 5: bFrTkDcWGTxyvNul7GVdYg (big blind) folded before Flop
Seat 6: jMljU/dOPMXfJi8OmbdYdw folded before Flop (didn't bet)



PokerStars Game #59939526364:  Hold'em No Limit ($0.50/$1.00) - 2009/07/01 0:42:08 ET
Table 'uNlePsyMIqzM691Xkrlk6Q' 9-max Seat #1 is the button
Seat 1: bLbSOSmSOnqE0iTcH/5dxA ($100 in chips)
Seat 2: +OqpStnt0FqbCfyHAWaLbg ($77.15 in chips)
Seat 3: h7qXkU57Bb8ZuPwMyxR8Ug ($20.95 in chips)
Seat 4: TZcz9MEWDA+WydgGruqqbw ($104.15 in chips)
Seat 5: 3obndzTJ6fECz8+wWhMd1w ($18.50 in chips)
Seat 6: uMPEfCcGCfsxmy53tVUMug ($110.60 in chips)
Seat 7: w6cw9nzN7AvkkHBVVjykoQ ($41.40 in chips)
Seat 9: vR4IO10geOgvTW+LAUBv/A ($112.25 in chips)
+OqpStnt0FqbCfyHAWaLbg: posts small blind $0.50
h7qXkU57Bb8ZuPwMyxR8Ug: posts big blind $1
laA8va+Yv8WuMqT1zdR91g: sits out
*** HOLE CARDS ***
TZcz9MEWDA+WydgGruqqbw: folds
3obndzTJ6fECz8+wWhMd1w: folds
uMPEfCcGCfsxmy53tVUMug: folds
w6cw9nzN7AvkkHBVVjykoQ: folds
vR4IO10geOgvTW+LAUBv/A: raises $2 to $3
bLbSOSmSOnqE0iTcH/5dxA: folds
+OqpStnt0FqbCfyHAWaLbg: folds
h7qXkU57Bb8ZuPwMyxR8Ug: calls $2
*** FLOP *** [4s Qd 9c]
h7qXkU57Bb8ZuPwMyxR8Ug: checks
vR4IO10geOgvTW+LAUBv/A: bets $3
h7qXkU57Bb8ZuPwMyxR8Ug: calls $3
*** TURN *** [4s Qd 9c] [3c]
h7qXkU57Bb8ZuPwMyxR8Ug: checks
vR4IO10geOgvTW+LAUBv/A: checks
*** RIVER *** [4s Qd 9c 3c] [Ts]
h7qXkU57Bb8ZuPwMyxR8Ug: bets $4
vR4IO10geOgvTW+LAUBv/A: calls $4
*** SHOW DOWN ***
h7qXkU57Bb8ZuPwMyxR8Ug: shows [9d 9s] (three of a kind, Nines)
vR4IO10geOgvTW+LAUBv/A: mucks hand
h7qXkU57Bb8ZuPwMyxR8Ug collected $19.55 from pot
*** SUMMARY ***
Total pot $20.50 | Rake $0.95
Board [4s Qd 9c 3c Ts]
Seat 1: bLbSOSmSOnqE0iTcH/5dxA (button) folded before Flop (didn't bet)
Seat 2: +OqpStnt0FqbCfyHAWaLbg (small blind) folded before Flop
Seat 3: h7qXkU57Bb8ZuPwMyxR8Ug (big blind) showed [9d 9s] and won ($19.55) with three of a kind, Nines
Seat 4: TZcz9MEWDA+WydgGruqqbw folded before Flop (didn't bet)
Seat 5: 3obndzTJ6fECz8+wWhMd1w folded before Flop (didn't bet)
Seat 6: uMPEfCcGCfsxmy53tVUMug folded before Flop (didn't bet)
Seat 7: w6cw9nzN7AvkkHBVVjykoQ folded before Flop (didn't bet)
Seat 9: vR4IO10geOgvTW+LAUBv/A mucked



PokerStars Game #59939526880:  Hold'em No Limit ($0.50/$1.00) - 2009/07/01 0:42:09 ET
Table 'OEonapnv+AHzisWWNNua0Q' 2-max Seat #2 is the button
Seat 1: 8IItNAJFln4siZ+XXuzGhg ($87.50 in chips)
Seat 2: iXXpsR/zdmiswg1I4gJ8kw ($2 in chips)
iXXpsR/zdmiswg1I4gJ8kw: posts small blind $0.50
8IItNAJFln4siZ+XXuzGhg: posts big blind $1
*** HOLE CARDS ***
iXXpsR/zdmiswg1I4gJ8kw: calls $0.50
8IItNAJFln4siZ+XXuzGhg: raises $1 to $2
iXXpsR/zdmiswg1I4gJ8kw: folds
8IItNAJFln4siZ+XXuzGhg collected $2 from pot
*** SUMMARY ***
Total pot $2 | Rake $0
Seat 1: 8IItNAJFln4siZ+XXuzGhg (big blind) collected ($2)
Seat 2: iXXpsR/zdmiswg1I4gJ8kw (button) (small blind) folded before Flop



PokerStars Game #59939528954:  Hold'em No Limit ($0.50/$1.00) - 2009/07/01 0:42:12 ET
Table 'eU3bWpDDg3Z+9R4m4iVmog' 6-max Seat #4 is the button
Seat 1: TSuRyAHnUPCFjP7Z0rEE0w ($192.65 in chips)
Seat 2: 8CAoOzhmB8n3nRFf3V4BTg ($99.30 in chips)
Seat 3: U6tnjwZRpTnM+YkqkCjwyQ ($187 in chips)
Seat 4: GDVIsbEJ/DOJsMKE4Asz0A ($74.10 in chips)
Seat 5: AdLVjddOzm+sRNo1Bc3S6Q ($100 in chips)
Seat 6: hpxXcmRkXXI9HE5+5/j/0Q ($121.95 in chips)
AdLVjddOzm+sRNo1Bc3S6Q: posts small blind $0.50
hpxXcmRkXXI9HE5+5/j/0Q: posts big blind $1
*** HOLE CARDS ***
TSuRyAHnUPCFjP7Z0rEE0w: folds
8CAoOzhmB8n3nRFf3V4BTg: folds
U6tnjwZRpTnM+YkqkCjwyQ: folds
GDVIsbEJ/DOJsMKE4Asz0A: folds
AdLVjddOzm+sRNo1Bc3S6Q: folds
hpxXcmRkXXI9HE5+5/j/0Q collected $1 from pot
hpxXcmRkXXI9HE5+5/j/0Q: doesn't show hand
*** SUMMARY ***
Total pot $1 | Rake $0
Seat 1: TSuRyAHnUPCFjP7Z0rEE0w folded before Flop (didn't bet)
Seat 2: 8CAoOzhmB8n3nRFf3V4BTg folded before Flop (didn't bet)
Seat 3: U6tnjwZRpTnM+YkqkCjwyQ folded before Flop (didn't bet)
Seat 4: GDVIsbEJ/DOJsMKE4Asz0A (button) folded before Flop (didn't bet)
Seat 5: AdLVjddOzm+sRNo1Bc3S6Q (small blind) folded before Flop
Seat 6: hpxXcmRkXXI9HE5+5/j/0Q (big blind) collected ($1)



PokerStars Game #59939528870:  Hold'em No Limit ($0.50/$1.00) - 2009/07/01 0:42:12 ET
Table 'hugOjcwJvzEwZbK7tyiWuQ' 9-max Seat #7 is the button
Seat 1: N9n5Wc3s35DpCrOAUUNAaQ ($128.50 in chips)
Seat 2: r27C1nIV4NS4+qbnrgBQSw ($255.55 in chips)
Seat 3: jDwhY1kCdc6EkAHbT7PJMQ ($107.65 in chips)
Seat 4: UWB3oeddt/GObx2Mix2Anw ($205.75 in chips)
Seat 5: 5BRGWf+R3nt2WS3b5xX+zA ($24.80 in chips)
Seat 6: gUUvmqdVlmvpal6B8nYrmg ($105.40 in chips)
Seat 7: FL3MrLspcF23LYvC4ipBOA ($100 in chips)
Seat 8: /zy+DB4S5fUQUSfZWFzYGw ($104.75 in chips)
/zy+DB4S5fUQUSfZWFzYGw: posts small blind $0.50
N9n5Wc3s35DpCrOAUUNAaQ: posts big blind $1
*** HOLE CARDS ***
r27C1nIV4NS4+qbnrgBQSw: folds
jDwhY1kCdc6EkAHbT7PJMQ: folds
UWB3oeddt/GObx2Mix2Anw: folds
5BRGWf+R3nt2WS3b5xX+zA: folds
gUUvmqdVlmvpal6B8nYrmg: raises $1 to $2
FL3MrLspcF23LYvC4ipBOA: folds
W8P9bUKCs43TO1xHm0dL6w joins the table at seat #9
/zy+DB4S5fUQUSfZWFzYGw: folds
N9n5Wc3s35DpCrOAUUNAaQ: calls $1
*** FLOP *** [Ad 4c 5h]
N9n5Wc3s35DpCrOAUUNAaQ: checks
gUUvmqdVlmvpal6B8nYrmg: bets $2
N9n5Wc3s35DpCrOAUUNAaQ: folds
gUUvmqdVlmvpal6B8nYrmg collected $4.30 from pot
*** SUMMARY ***
Total pot $4.50 | Rake $0.20
Board [Ad 4c 5h]
Seat 1: N9n5Wc3s35DpCrOAUUNAaQ (big blind) folded on the Flop
Seat 2: r27C1nIV4NS4+qbnrgBQSw folded before Flop (didn't bet)
Seat 3: jDwhY1kCdc6EkAHbT7PJMQ folded before Flop (didn't bet)
Seat 4: UWB3oeddt/GObx2Mix2Anw folded before Flop (didn't bet)
Seat 5: 5BRGWf+R3nt2WS3b5xX+zA folded before Flop (didn't bet)
Seat 6: gUUvmqdVlmvpal6B8nYrmg collected ($4.30)
Seat 7: FL3MrLspcF23LYvC4ipBOA (button) folded before Flop (didn't bet)
Seat 8: /zy+DB4S5fUQUSfZWFzYGw (small blind) folded before Flop



PokerStars Game #59939530320:  Hold'em No Limit ($0.50/$1.00) - 2009/07/01 0:42:14 ET
Table 'VOs36P6NW+QyXeQ1B62kmA' 6-max Seat #6 is the button
Seat 1: AdLVjddOzm+sRNo1Bc3S6Q ($139.80 in chips)
Seat 2: KpnW5CcJ4Mg6MeclfKmLrw ($117.85 in chips)
Seat 3: TSuRyAHnUPCFjP7Z0rEE0w ($100 in chips)
Seat 4: w02zQzNydODiyV9THKgo9w ($36.80 in chips)
Seat 5: X7GlkHF+lkbarCLuZ4Uf0w ($20.75 in chips)
Seat 6: 6tvjsJrdmWg+g7FVrMnzXA ($63.90 in chips)
AdLVjddOzm+sRNo1Bc3S6Q: posts small blind $0.50
KpnW5CcJ4Mg6MeclfKmLrw: posts big blind $1
*** HOLE CARDS ***
TSuRyAHnUPCFjP7Z0rEE0w: folds
w02zQzNydODiyV9THKgo9w: folds
X7GlkHF+lkbarCLuZ4Uf0w: folds
6tvjsJrdmWg+g7FVrMnzXA: folds
AdLVjddOzm+sRNo1Bc3S6Q: folds
KpnW5CcJ4Mg6MeclfKmLrw collected $1 from pot
KpnW5CcJ4Mg6MeclfKmLrw: doesn't show hand
*** SUMMARY ***
Total pot $1 | Rake $0
Seat 1: AdLVjddOzm+sRNo1Bc3S6Q (small blind) folded before Flop
Seat 2: KpnW5CcJ4Mg6MeclfKmLrw (big blind) collected ($1)
Seat 3: TSuRyAHnUPCFjP7Z0rEE0w folded before Flop (didn't bet)
Seat 4: w02zQzNydODiyV9THKgo9w folded before Flop (didn't bet)
Seat 5: X7GlkHF+lkbarCLuZ4Uf0w folded before Flop (didn't bet)
Seat 6: 6tvjsJrdmWg+g7FVrMnzXA (button) folded before Flop (didn't bet)



PokerStars Game #59939531968:  Hold'em No Limit ($0.50/$1.00) - 2009/07/01 0:42:17 ET
Table 'MUPc8FEpe/nR0BKSeReX6Q' 6-max Seat #1 is the button
Seat 1: YsLQ3BAvgQHWXMAv3Wv6Hg ($113.85 in chips)
Seat 2: xAU6q2/cwmby2sxmA8VcmA ($100 in chips)
Seat 3: wx3sQGkVi2x9wJXuWNHPBw ($221.55 in chips)
Seat 4: ZA1bp6g8IwtTxkUE4eCjDQ ($201.65 in chips)
Seat 5: UBZQqpnJZdTYYY1FTb0rLA ($101.50 in chips)
Seat 6: oxnw0GLLpFanjhGkxfRSqA ($58 in chips)
xAU6q2/cwmby2sxmA8VcmA: posts small blind $0.50
wx3sQGkVi2x9wJXuWNHPBw: posts big blind $1
*** HOLE CARDS ***
ZA1bp6g8IwtTxkUE4eCjDQ: calls $1
UBZQqpnJZdTYYY1FTb0rLA: folds
oxnw0GLLpFanjhGkxfRSqA: folds
YsLQ3BAvgQHWXMAv3Wv6Hg: folds
xAU6q2/cwmby2sxmA8VcmA: folds
wx3sQGkVi2x9wJXuWNHPBw: checks
*** FLOP *** [Kh 6h Ac]
wx3sQGkVi2x9wJXuWNHPBw: checks
ZA1bp6g8IwtTxkUE4eCjDQ: bets $1
wx3sQGkVi2x9wJXuWNHPBw: folds
ZA1bp6g8IwtTxkUE4eCjDQ collected $2.40 from pot
ZA1bp6g8IwtTxkUE4eCjDQ: doesn't show hand
*** SUMMARY ***
Total pot $2.50 | Rake $0.10
Board [Kh 6h Ac]
Seat 1: YsLQ3BAvgQHWXMAv3Wv6Hg (button) folded before Flop (didn't bet)
Seat 2: xAU6q2/cwmby2sxmA8VcmA (small blind) folded before Flop
Seat 3: wx3sQGkVi2x9wJXuWNHPBw (big blind) folded on the Flop
Seat 4: ZA1bp6g8IwtTxkUE4eCjDQ collected ($2.40)
Seat 5: UBZQqpnJZdTYYY1FTb0rLA folded before Flop (didn't bet)
Seat 6: oxnw0GLLpFanjhGkxfRSqA folded before Flop (didn't bet)



PokerStars Game #59939533452:  Hold'em No Limit ($0.50/$1.00) - 2009/07/01 0:42:19 ET
Table 'QBLDswtHe7Ml0HwAdcMhlw' 2-max Seat #1 is the button
Seat 1: hdNlhiCwI533uwvvTTfC9Q ($116 in chips)
Seat 2: GBkvjkjDWVBEa1e14dh6CA ($52.40 in chips)
hdNlhiCwI533uwvvTTfC9Q: posts small blind $0.50
GBkvjkjDWVBEa1e14dh6CA: posts big blind $1
*** HOLE CARDS ***
hdNlhiCwI533uwvvTTfC9Q: raises $1 to $2
GBkvjkjDWVBEa1e14dh6CA: folds
hdNlhiCwI533uwvvTTfC9Q collected $2 from pot
hdNlhiCwI533uwvvTTfC9Q: doesn't show hand
*** SUMMARY ***
Total pot $2 | Rake $0
Seat 1: hdNlhiCwI533uwvvTTfC9Q (button) (small blind) collected ($2)
Seat 2: GBkvjkjDWVBEa1e14dh6CA (big blind) folded before Flop



PokerStars Game #59939534492:  Hold'em No Limit ($0.50/$1.00) - 2009/07/01 0:42:20 ET
Table '7O9fB8yx1u7sJveJn8w6jA' 6-max Seat #1 is the button
Seat 1: jy52+7FotjH63o5tEEVgKw ($117.95 in chips)
Seat 2: wx3sQGkVi2x9wJXuWNHPBw ($194.50 in chips)
Seat 3: hpxXcmRkXXI9HE5+5/j/0Q ($100 in chips)
Seat 4: XIZSmlGttGgSRaIU42K4Fg ($101.35 in chips)
Seat 5: BCEV3COoKY607AzLWayfRA ($106.85 in chips)
Seat 6: UBZQqpnJZdTYYY1FTb0rLA ($129.35 in chips)
wx3sQGkVi2x9wJXuWNHPBw: posts small blind $0.50
hpxXcmRkXXI9HE5+5/j/0Q: posts big blind $1
*** HOLE CARDS ***
XIZSmlGttGgSRaIU42K4Fg: folds
BCEV3COoKY607AzLWayfRA: folds
UBZQqpnJZdTYYY1FTb0rLA: folds
jy52+7FotjH63o5tEEVgKw: calls $1
wx3sQGkVi2x9wJXuWNHPBw: folds
hpxXcmRkXXI9HE5+5/j/0Q: checks
*** FLOP *** [7s Jc 3s]
hpxXcmRkXXI9HE5+5/j/0Q: checks
jy52+7FotjH63o5tEEVgKw: checks
*** TURN *** [7s Jc 3s] [2d]
hpxXcmRkXXI9HE5+5/j/0Q: checks
jy52+7FotjH63o5tEEVgKw: checks
*** RIVER *** [7s Jc 3s 2d] [4c]
hpxXcmRkXXI9HE5+5/j/0Q: checks
jy52+7FotjH63o5tEEVgKw: checks
*** SHOW DOWN ***
hpxXcmRkXXI9HE5+5/j/0Q: shows [8d 6c] (high card Jack)
jy52+7FotjH63o5tEEVgKw: shows [9s Tc] (high card Jack - Ten kicker)
jy52+7FotjH63o5tEEVgKw collected $2.40 from pot
*** SUMMARY ***
Total pot $2.50 | Rake $0.10
Board [7s Jc 3s 2d 4c]
Seat 1: jy52+7FotjH63o5tEEVgKw (button) showed [9s Tc] and won ($2.40) with high card Jack
Seat 2: wx3sQGkVi2x9wJXuWNHPBw (small blind) folded before Flop
Seat 3: hpxXcmRkXXI9HE5+5/j/0Q (big blind) showed [8d 6c] and lost with high card Jack
Seat 4: XIZSmlGttGgSRaIU42K4Fg folded before Flop (didn't bet)
Seat 5: BCEV3COoKY607AzLWayfRA folded before Flop (didn't bet)
Seat 6: UBZQqpnJZdTYYY1FTb0rLA folded before Flop (didn't bet)



PokerStars Game #59939534176:  Hold'em No Limit ($0.50/$1.00) - 2009/07/01 0:42:20 ET
Table 'pHrhryH8jPNdQfY62f8v+g' 6-max Seat #2 is the button
Seat 1: fF4botNMr8/ieVPO1YYRLw ($60 in chips)
Seat 2: RqgF7gRoKgRNW8Zoi1ty4A ($124.65 in chips)
Seat 4: wenbG7TaM3H7h5kn78OFNw ($46.30 in chips)
Seat 5: r1/R7y0Ortgoz4lccgW8VA ($34.65 in chips)
Seat 6: xAU6q2/cwmby2sxmA8VcmA ($113.75 in chips)
wenbG7TaM3H7h5kn78OFNw: posts small blind $0.50
r1/R7y0Ortgoz4lccgW8VA: posts big blind $1
*** HOLE CARDS ***
xAU6q2/cwmby2sxmA8VcmA: folds
fF4botNMr8/ieVPO1YYRLw: calls $1
RqgF7gRoKgRNW8Zoi1ty4A: raises $4 to $5
wenbG7TaM3H7h5kn78OFNw: folds
r1/R7y0Ortgoz4lccgW8VA: folds
fF4botNMr8/ieVPO1YYRLw: folds
RqgF7gRoKgRNW8Zoi1ty4A collected $3.50 from pot
*** SUMMARY ***
Total pot $3.50 | Rake $0
Seat 1: fF4botNMr8/ieVPO1YYRLw folded before Flop
Seat 2: RqgF7gRoKgRNW8Zoi1ty4A (button) collected ($3.50)
Seat 4: wenbG7TaM3H7h5kn78OFNw (small blind) folded before Flop
Seat 5: r1/R7y0Ortgoz4lccgW8VA (big blind) folded before Flop
Seat 6: xAU6q2/cwmby2sxmA8VcmA folded before Flop (didn't bet)



PokerStars Game #59939536394:  Hold'em No Limit ($0.50/$1.00) - 2009/07/01 0:42:23 ET
Table 'GxCPo/gd3OSthkYrAxJngg' 6-max Seat #4 is the button
Seat 1: sH8BpAFP+jGFxCgVpD1Lew ($255.45 in chips)
Seat 2: YExX2paeIHrmfIwV1ivM/w ($78.20 in chips)
Seat 3: o6plE+MSW4XFNTeONe16xg ($32.60 in chips)
Seat 4: YMJG+F++3Aj6P8dAWda5fw ($106.65 in chips)
Seat 5: G5ZSSN6RSON3gkNvk/SmYg ($110.25 in chips)
Seat 6: sS9IXedL3MiRmpVXhAILhw ($101.95 in chips)
G5ZSSN6RSON3gkNvk/SmYg: posts small blind $0.50
sS9IXedL3MiRmpVXhAILhw: posts big blind $1
*** HOLE CARDS ***
sH8BpAFP+jGFxCgVpD1Lew: folds
YExX2paeIHrmfIwV1ivM/w: raises $3 to $4
o6plE+MSW4XFNTeONe16xg: folds
YMJG+F++3Aj6P8dAWda5fw: folds
G5ZSSN6RSON3gkNvk/SmYg: folds
sS9IXedL3MiRmpVXhAILhw: folds
YExX2paeIHrmfIwV1ivM/w collected $2.50 from pot
*** SUMMARY ***
Total pot $2.50 | Rake $0
Seat 1: sH8BpAFP+jGFxCgVpD1Lew folded before Flop (didn't bet)
Seat 2: YExX2paeIHrmfIwV1ivM/w collected ($2.50)
Seat 3: o6plE+MSW4XFNTeONe16xg folded before Flop (didn't bet)
Seat 4: YMJG+F++3Aj6P8dAWda5fw (button) folded before Flop (didn't bet)
Seat 5: G5ZSSN6RSON3gkNvk/SmYg (small blind) folded before Flop
Seat 6: sS9IXedL3MiRmpVXhAILhw (big blind) folded before Flop



PokerStars Game #59939536472:  Hold'em No Limit ($0.50/$1.00) - 2009/07/01 0:42:24 ET
Table 'rmZfTK+oSebeUPJNbWhdAA' 6-max Seat #4 is the button
Seat 1: xAU6q2/cwmby2sxmA8VcmA ($103.05 in chips)
Seat 2: z7O9PO/WEcqRouIydFhS9Q ($92.50 in chips)
Seat 3: 9yjOzGERLaEZS8CZ6YNHFg ($111.85 in chips)
Seat 4: OGMLOcTNYZXZU81au7ztUw ($140.60 in chips)
Seat 6: j7NIOHLZk7V2o9fOioO5ug ($133 in chips)
j7NIOHLZk7V2o9fOioO5ug: posts small blind $0.50
xAU6q2/cwmby2sxmA8VcmA: posts big blind $1
*** HOLE CARDS ***
+xW7QemQU0Fxs+4TnqBRow has returned
z7O9PO/WEcqRouIydFhS9Q: folds
9yjOzGERLaEZS8CZ6YNHFg: folds
+xW7QemQU0Fxs+4TnqBRow leaves the table
OGMLOcTNYZXZU81au7ztUw: folds
j7NIOHLZk7V2o9fOioO5ug: folds
xAU6q2/cwmby2sxmA8VcmA collected $1 from pot
xAU6q2/cwmby2sxmA8VcmA: doesn't show hand
*** SUMMARY ***
Total pot $1 | Rake $0
Seat 1: xAU6q2/cwmby2sxmA8VcmA (big blind) collected ($1)
Seat 2: z7O9PO/WEcqRouIydFhS9Q folded before Flop (didn't bet)
Seat 3: 9yjOzGERLaEZS8CZ6YNHFg folded before Flop (didn't bet)
Seat 4: OGMLOcTNYZXZU81au7ztUw (button) folded before Flop (didn't bet)
Seat 6: j7NIOHLZk7V2o9fOioO5ug (small blind) folded before Flop



PokerStars Game #59939537296:  Hold'em No Limit ($0.50/$1.00) - 2009/07/01 0:42:25 ET
Table '/RZcOwpZpHQ+OwPwjsbnRw' 6-max Seat #6 is the button
Seat 1: Zboa6dColKGHBjLPUakZjw ($57.20 in chips)
Seat 2: +xW7QemQU0Fxs+4TnqBRow ($194.50 in chips)
Seat 4: j7NIOHLZk7V2o9fOioO5ug ($100 in chips)
Seat 5: wx3sQGkVi2x9wJXuWNHPBw ($195.15 in chips)
Seat 6: XOIf9W+VAxhZqN+SYoyMKA ($288.55 in chips)
Zboa6dColKGHBjLPUakZjw: posts small blind $0.50
+xW7QemQU0Fxs+4TnqBRow: posts big blind $1
XnT1yK2DD/5FL+0bwuEhqg: sits out
*** HOLE CARDS ***
j7NIOHLZk7V2o9fOioO5ug: folds
wx3sQGkVi2x9wJXuWNHPBw: folds
XOIf9W+VAxhZqN+SYoyMKA: folds
Zboa6dColKGHBjLPUakZjw: raises $1 to $2
+xW7QemQU0Fxs+4TnqBRow: folds
Zboa6dColKGHBjLPUakZjw collected $2 from pot
*** SUMMARY ***
Total pot $2 | Rake $0
Seat 1: Zboa6dColKGHBjLPUakZjw (small blind) collected ($2)
Seat 2: +xW7QemQU0Fxs+4TnqBRow (big blind) folded before Flop
Seat 4: j7NIOHLZk7V2o9fOioO5ug folded before Flop (didn't bet)
Seat 5: wx3sQGkVi2x9wJXuWNHPBw folded before Flop (didn't bet)
Seat 6: XOIf9W+VAxhZqN+SYoyMKA (button) folded before Flop (didn't bet)



PokerStars Game #59939537630:  Hold'em No Limit ($0.50/$1.00) - 2009/07/01 0:42:25 ET
Table 'LmXQK9xy3awB+qsPzI21Mw' 2-max Seat #2 is the button
Seat 1: NYi6JFscYNrofSXy4sM+Yw ($245.10 in chips)
Seat 2: TME8GvochpQAo8cmJwWmvA ($90.85 in chips)
TME8GvochpQAo8cmJwWmvA: posts small blind $0.50
NYi6JFscYNrofSXy4sM+Yw: posts big blind $1
*** HOLE CARDS ***
TME8GvochpQAo8cmJwWmvA: folds
NYi6JFscYNrofSXy4sM+Yw collected $1 from pot
NYi6JFscYNrofSXy4sM+Yw: doesn't show hand
*** SUMMARY ***
Total pot $1 | Rake $0
Seat 1: NYi6JFscYNrofSXy4sM+Yw (big blind) collected ($1)
Seat 2: TME8GvochpQAo8cmJwWmvA (button) (small blind) folded before Flop



PokerStars Game #59939537768:  Hold'em No Limit ($0.50/$1.00) - 2009/07/01 0:42:26 ET
Table '+cA8mcmhaedZ7YcrDdhmeQ' 6-max Seat #6 is the button
Seat 1: lsLuWlcPA3Rh7kJVLzMh0Q ($307.70 in chips)
Seat 2: RqgF7gRoKgRNW8Zoi1ty4A ($101.50 in chips)
Seat 3: 7H5WkGzGvsv56y1iaqHvRg ($31.20 in chips)
Seat 4: LjL3AIERHn559yyW1mTUYQ ($154 in chips)
Seat 5: iHo1oDbrEVJ8nEGdaPrICw ($105.35 in chips)
Seat 6: YfsTQsY/fxb+YqbdclTHuw ($59.55 in chips)
lsLuWlcPA3Rh7kJVLzMh0Q: posts small blind $0.50
RqgF7gRoKgRNW8Zoi1ty4A: posts big blind $1
*** HOLE CARDS ***
7H5WkGzGvsv56y1iaqHvRg: calls $1
LjL3AIERHn559yyW1mTUYQ: calls $1
iHo1oDbrEVJ8nEGdaPrICw: folds
YfsTQsY/fxb+YqbdclTHuw: calls $1
lsLuWlcPA3Rh7kJVLzMh0Q: calls $0.50
RqgF7gRoKgRNW8Zoi1ty4A: checks
*** FLOP *** [6d 6c 5d]
lsLuWlcPA3Rh7kJVLzMh0Q: checks
RqgF7gRoKgRNW8Zoi1ty4A: checks
7H5WkGzGvsv56y1iaqHvRg: checks
LjL3AIERHn559yyW1mTUYQ: checks
iHo1oDbrEVJ8nEGdaPrICw is sitting out
YfsTQsY/fxb+YqbdclTHuw: checks
*** TURN *** [6d 6c 5d] [As]
iHo1oDbrEVJ8nEGdaPrICw leaves the table
lsLuWlcPA3Rh7kJVLzMh0Q: checks
RqgF7gRoKgRNW8Zoi1ty4A: checks
7H5WkGzGvsv56y1iaqHvRg: bets $4
LjL3AIERHn559yyW1mTUYQ: calls $4
YfsTQsY/fxb+YqbdclTHuw: calls $4
lsLuWlcPA3Rh7kJVLzMh0Q: folds
RqgF7gRoKgRNW8Zoi1ty4A: folds
*** RIVER *** [6d 6c 5d As] [Td]
7H5WkGzGvsv56y1iaqHvRg: bets $9
LjL3AIERHn559yyW1mTUYQ: calls $9
YfsTQsY/fxb+YqbdclTHuw: folds
*** SHOW DOWN ***
7H5WkGzGvsv56y1iaqHvRg: shows [Tc Ah] (two pair, Aces and Tens)
LjL3AIERHn559yyW1mTUYQ: shows [7d 8d] (a flush, Ten high)
+7hFKAL0b0O/n8G72TclJA joins the table at seat #5
LjL3AIERHn559yyW1mTUYQ collected $33.30 from pot
*** SUMMARY ***
Total pot $35 | Rake $1.70
Board [6d 6c 5d As Td]
Seat 1: lsLuWlcPA3Rh7kJVLzMh0Q (small blind) folded on the Turn
Seat 2: RqgF7gRoKgRNW8Zoi1ty4A (big blind) folded on the Turn
Seat 3: 7H5WkGzGvsv56y1iaqHvRg showed [Tc Ah] and lost with two pair, Aces and Tens
Seat 4: LjL3AIERHn559yyW1mTUYQ showed [7d 8d] and won ($33.30) with a flush, Ten high
Seat 5: iHo1oDbrEVJ8nEGdaPrICw folded before Flop (didn't bet)
Seat 6: YfsTQsY/fxb+YqbdclTHuw (button) folded on the River



PokerStars Game #59939539098:  Hold'em No Limit ($0.50/$1.00) - 2009/07/01 0:42:28 ET
Table 'QBLDswtHe7Ml0HwAdcMhlw' 2-max Seat #2 is the button
Seat 1: hdNlhiCwI533uwvvTTfC9Q ($117 in chips)
Seat 2: GBkvjkjDWVBEa1e14dh6CA ($51.40 in chips)
GBkvjkjDWVBEa1e14dh6CA: posts small blind $0.50
hdNlhiCwI533uwvvTTfC9Q: posts big blind $1
*** HOLE CARDS ***
GBkvjkjDWVBEa1e14dh6CA: raises $2 to $3
hdNlhiCwI533uwvvTTfC9Q: folds
GBkvjkjDWVBEa1e14dh6CA collected $2 from pot
GBkvjkjDWVBEa1e14dh6CA: doesn't show hand
*** SUMMARY ***
Total pot $2 | Rake $0
Seat 1: hdNlhiCwI533uwvvTTfC9Q (big blind) folded before Flop
Seat 2: GBkvjkjDWVBEa1e14dh6CA (button) (small blind) collected ($2)



PokerStars Game #59939540526:  Hold'em No Limit ($0.50/$1.00) - 2009/07/01 0:42:30 ET
Table 'eU3bWpDDg3Z+9R4m4iVmog' 6-max Seat #5 is the button
Seat 1: TSuRyAHnUPCFjP7Z0rEE0w ($192.65 in chips)
Seat 2: 8CAoOzhmB8n3nRFf3V4BTg ($99.30 in chips)
Seat 3: U6tnjwZRpTnM+YkqkCjwyQ ($187 in chips)
Seat 4: GDVIsbEJ/DOJsMKE4Asz0A ($74.10 in chips)
Seat 5: AdLVjddOzm+sRNo1Bc3S6Q ($100 in chips)
Seat 6: hpxXcmRkXXI9HE5+5/j/0Q ($122.45 in chips)
hpxXcmRkXXI9HE5+5/j/0Q: posts small blind $0.50
TSuRyAHnUPCFjP7Z0rEE0w: posts big blind $1
*** HOLE CARDS ***
8CAoOzhmB8n3nRFf3V4BTg: folds
U6tnjwZRpTnM+YkqkCjwyQ: raises $2 to $3
GDVIsbEJ/DOJsMKE4Asz0A: folds
AdLVjddOzm+sRNo1Bc3S6Q: calls $3
hpxXcmRkXXI9HE5+5/j/0Q: folds
TSuRyAHnUPCFjP7Z0rEE0w: folds
*** FLOP *** [8c 7d 7h]
U6tnjwZRpTnM+YkqkCjwyQ: bets $4
AdLVjddOzm+sRNo1Bc3S6Q: folds
U6tnjwZRpTnM+YkqkCjwyQ collected $7.15 from pot
*** SUMMARY ***
Total pot $7.50 | Rake $0.35
Board [8c 7d 7h]
Seat 1: TSuRyAHnUPCFjP7Z0rEE0w (big blind) folded before Flop
Seat 2: 8CAoOzhmB8n3nRFf3V4BTg folded before Flop (didn't bet)
Seat 3: U6tnjwZRpTnM+YkqkCjwyQ collected ($7.15)
Seat 4: GDVIsbEJ/DOJsMKE4Asz0A folded before Flop (didn't bet)
Seat 5: AdLVjddOzm+sRNo1Bc3S6Q (button) folded on the Flop
Seat 6: hpxXcmRkXXI9HE5+5/j/0Q (small blind) folded before Flop



PokerStars Game #59939541080:  Hold'em No Limit ($0.50/$1.00) - 2009/07/01 0:42:31 ET
Table 'LmXQK9xy3awB+qsPzI21Mw' 2-max Seat #1 is the button
Seat 1: NYi6JFscYNrofSXy4sM+Yw ($245.60 in chips)
Seat 2: TME8GvochpQAo8cmJwWmvA ($90.35 in chips)
NYi6JFscYNrofSXy4sM+Yw: posts small blind $0.50
TME8GvochpQAo8cmJwWmvA: posts big blind $1
*** HOLE CARDS ***
NYi6JFscYNrofSXy4sM+Yw: raises $2 to $3
TME8GvochpQAo8cmJwWmvA: folds
NYi6JFscYNrofSXy4sM+Yw collected $2 from pot
*** SUMMARY ***
Total pot $2 | Rake $0
Seat 1: NYi6JFscYNrofSXy4sM+Yw (button) (small blind) collected ($2)
Seat 2: TME8GvochpQAo8cmJwWmvA (big blind) folded before Flop



PokerStars Game #59939542318:  Hold'em No Limit ($0.50/$1.00) - 2009/07/01 0:42:33 ET
Table 'N2bNCDHL96aCQDvZIh+yQQ' 6-max Seat #3 is the button
Seat 1: iHo1oDbrEVJ8nEGdaPrICw ($101.50 in chips)
Seat 2: KpnW5CcJ4Mg6MeclfKmLrw ($118.10 in chips)
Seat 3: Qy/UBNbD2HaA0Ogxg8Sf3w ($196.50 in chips)
Seat 4: uCqEjnxh2/vFBjKYkfTOkw ($171.40 in chips)
Seat 5: rHlMOfR7kpQQxe+PFQz0xQ ($30.75 in chips)
Seat 6: TSuRyAHnUPCFjP7Z0rEE0w ($100 in chips)
uCqEjnxh2/vFBjKYkfTOkw: posts small blind $0.50
rHlMOfR7kpQQxe+PFQz0xQ: posts big blind $1
*** HOLE CARDS ***
TSuRyAHnUPCFjP7Z0rEE0w: folds
iHo1oDbrEVJ8nEGdaPrICw: folds
KpnW5CcJ4Mg6MeclfKmLrw: folds
Qy/UBNbD2HaA0Ogxg8Sf3w: raises $1.50 to $2.50
uCqEjnxh2/vFBjKYkfTOkw: calls $2
rHlMOfR7kpQQxe+PFQz0xQ: folds
*** FLOP *** [Qc Jd Ac]
uCqEjnxh2/vFBjKYkfTOkw: checks
Qy/UBNbD2HaA0Ogxg8Sf3w: checks
*** TURN *** [Qc Jd Ac] [6d]
uCqEjnxh2/vFBjKYkfTOkw: checks
Qy/UBNbD2HaA0Ogxg8Sf3w: bets $4
uCqEjnxh2/vFBjKYkfTOkw: folds
Qy/UBNbD2HaA0Ogxg8Sf3w collected $5.70 from pot
Qy/UBNbD2HaA0Ogxg8Sf3w: doesn't show hand
*** SUMMARY ***
Total pot $6 | Rake $0.30
Board [Qc Jd Ac 6d]
Seat 1: iHo1oDbrEVJ8nEGdaPrICw folded before Flop (didn't bet)
Seat 2: KpnW5CcJ4Mg6MeclfKmLrw folded before Flop (didn't bet)
Seat 3: Qy/UBNbD2HaA0Ogxg8Sf3w (button) collected ($5.70)
Seat 4: uCqEjnxh2/vFBjKYkfTOkw (small blind) folded on the Turn
Seat 5: rHlMOfR7kpQQxe+PFQz0xQ (big blind) folded before Flop
Seat 6: TSuRyAHnUPCFjP7Z0rEE0w folded before Flop (didn't bet)



PokerStars Game #59939542748:  Hold'em No Limit ($0.50/$1.00) - 2009/07/01 0:42:34 ET
Table 'FKpXUINE6M3UxHG4zaMhHA' 6-max Seat #3 is the button
Seat 1: qNezhXOOUXqwG7b9X5XJAA ($100 in chips)
Seat 2: nDKgwwXJ45hcJfJe01cdxQ ($35.85 in chips)
Seat 3: GOHDYcxP1gP29069kB9HFw ($126.10 in chips)
Seat 4: vw0eLNLy3Huccth4CUZNPQ ($73.30 in chips)
Seat 5: eUBBn2R56C1IQ6Cs/vitwg ($101.50 in chips)
Seat 6: b2a+5TkFf4xJN/Ihhma58Q ($13.40 in chips)
vw0eLNLy3Huccth4CUZNPQ: posts small blind $0.50
eUBBn2R56C1IQ6Cs/vitwg: posts big blind $1
*** HOLE CARDS ***
b2a+5TkFf4xJN/Ihhma58Q: folds
qNezhXOOUXqwG7b9X5XJAA: folds
nDKgwwXJ45hcJfJe01cdxQ: raises $1 to $2
GOHDYcxP1gP29069kB9HFw: folds
vw0eLNLy3Huccth4CUZNPQ: folds
b2a+5TkFf4xJN/Ihhma58Q is sitting out
eUBBn2R56C1IQ6Cs/vitwg: folds
b2a+5TkFf4xJN/Ihhma58Q leaves the table
nDKgwwXJ45hcJfJe01cdxQ collected $2.50 from pot
nDKgwwXJ45hcJfJe01cdxQ: doesn't show hand
*** SUMMARY ***
Total pot $2.50 | Rake $0
Seat 1: qNezhXOOUXqwG7b9X5XJAA folded before Flop (didn't bet)
Seat 2: nDKgwwXJ45hcJfJe01cdxQ collected ($2.50)
Seat 3: GOHDYcxP1gP29069kB9HFw (button) folded before Flop (didn't bet)
Seat 4: vw0eLNLy3Huccth4CUZNPQ (small blind) folded before Flop
Seat 5: eUBBn2R56C1IQ6Cs/vitwg (big blind) folded before Flop
Seat 6: b2a+5TkFf4xJN/Ihhma58Q folded before Flop (didn't bet)



PokerStars Game #59939543852:  Hold'em No Limit ($0.50/$1.00) - 2009/07/01 0:42:35 ET
Table 'tyUh+jyNvrceIQdKMJjQ2wZFWj23PMihdwrNWv41OG/Qeat #6 is the button
Seat 1: o8A5MUdudVKu+pAwgZOX2w ($227.45 in chips)
Seat 2: XvUbOIg94d25feWeQlOTVg ($61.30 in chips)
Seat 3: TalCiLYHCd+ffkmR3auPvA ($67.20 in chips)
Seat 4: TSuRyAHnUPCFjP7Z0rEE0w ($119.75 in chips)
Seat 5: j7NIOHLZk7V2o9fOioO5ug ($111.60 in chips)
Seat 6: YsLQ3BAvgQHWXMAv3Wv6Hg ($149.75 in chips)
o8A5MUdudVKu+pAwgZOX2w: posts small blind $0.50
XvUbOIg94d25feWeQlOTVg: posts big blind $1
*** HOLE CARDS ***
TalCiLYHCd+ffkmR3auPvA: calls $1
TSuRyAHnUPCFjP7Z0rEE0w: folds
j7NIOHLZk7V2o9fOioO5ug: folds
YsLQ3BAvgQHWXMAv3Wv6Hg: folds
o8A5MUdudVKu+pAwgZOX2w: calls $0.50
XvUbOIg94d25feWeQlOTVg: checks
*** FLOP *** [Jc 3s 7s]
o8A5MUdudVKu+pAwgZOX2w: bets $3
XvUbOIg94d25feWeQlOTVg: folds
TalCiLYHCd+ffkmR3auPvA: calls $3
*** TURN *** [Jc 3s 7s] [Js]
o8A5MUdudVKu+pAwgZOX2w: checks
TalCiLYHCd+ffkmR3auPvA: bets $5
o8A5MUdudVKu+pAwgZOX2w: folds
TalCiLYHCd+ffkmR3auPvA collected $8.60 from pot
TalCiLYHCd+ffkmR3auPvA: doesn't show hand
*** SUMMARY ***
Total pot $9 | Rake $0.40
Board [Jc 3s 7s Js]
Seat 1: o8A5MUdudVKu+pAwgZOX2w (small blind) folded on the Turn
Seat 2: XvUbOIg94d25feWeQlOTVg (big blind) folded on the Flop
Seat 3: TalCiLYHCd+ffkmR3auPvA collected ($8.60)
Seat 4: TSuRyAHnUPCFjP7Z0rEE0w folded before Flop (didn't bet)
Seat 5: j7NIOHLZk7V2o9fOioO5ug folded before Flop (didn't bet)
Seat 6: YsLQ3BAvgQHWXMAv3Wv6Hg (button) folded before Flop (didn't bet)



PokerStars Game #59939544224:  Hold'em No Limit ($0.50/$1.00) - 2009/07/01 0:42:36 ET
Table 'QBLDswtHe7Ml0HwAdcMhlw' 2-max Seat #1 is the button
Seat 1: hdNlhiCwI533uwvvTTfC9Q ($116 in chips)
Seat 2: GBkvjkjDWVBEa1e14dh6CA ($52.40 in chips)
hdNlhiCwI533uwvvTTfC9Q: posts small blind $0.50
GBkvjkjDWVBEa1e14dh6CA: posts big blind $1
*** HOLE CARDS ***
hdNlhiCwI533uwvvTTfC9Q: raises $2 to $3
GBkvjkjDWVBEa1e14dh6CA: folds
hdNlhiCwI533uwvvTTfC9Q collected $2 from pot
hdNlhiCwI533uwvvTTfC9Q: doesn't show hand
*** SUMMARY ***
Total pot $2 | Rake $0
Seat 1: hdNlhiCwI533uwvvTTfC9Q (button) (small blind) collected ($2)
Seat 2: GBkvjkjDWVBEa1e14dh6CA (big blind) folded before Flop



PokerStars Game #59939545768:  Hold'em No Limit ($0.50/$1.00) - 2009/07/01 0:42:38 ET
Table 'LmXQK9xy3awB+qsPzI21Mw' 2-max Seat #2 is the button
Seat 1: NYi6JFscYNrofSXy4sM+Yw ($246.60 in chips)
Seat 2: TME8GvochpQAo8cmJwWmvA ($89.35 in chips)
TME8GvochpQAo8cmJwWmvA: posts small blind $0.50
NYi6JFscYNrofSXy4sM+Yw: posts big blind $1
*** HOLE CARDS ***
TME8GvochpQAo8cmJwWmvA: raises $1 to $2
NYi6JFscYNrofSXy4sM+Yw: folds
TME8GvochpQAo8cmJwWmvA collected $2 from pot
*** SUMMARY ***
Total pot $2 | Rake $0
Seat 1: NYi6JFscYNrofSXy4sM+Yw (big blind) folded before Flop
Seat 2: TME8GvochpQAo8cmJwWmvA (button) (small blind) collected ($2)



PokerStars Game #59939545186:  Hold'em No Limit ($0.50/$1.00) - 2009/07/01 0:42:38 ET
Table 'U9zqzC8f3oTJ2ShXFgSSOA' 6-max Seat #2 is the button
Seat 1: tS9JHB1h+FQ++qu8RwRNgg ($79.05 in chips)
Seat 2: U2CWBTv29qdCbj8RNF2sIw ($95.50 in chips)
Seat 3: yfXek8iJ7O4CFyqXrtGcfg ($11.05 in chips)
Seat 4: 33q95we0Etwgrm6guQGncw ($90.10 in chips)
Seat 5: KfwW5us6tydK81NYTtK1gw ($295.25 in chips)
Seat 6: aIxzFKdtpDSkUePKZy/niQ ($27.40 in chips)
yfXek8iJ7O4CFyqXrtGcfg: posts small blind $0.50
33q95we0Etwgrm6guQGncw: posts big blind $1
*** HOLE CARDS ***
KfwW5us6tydK81NYTtK1gw: folds
aIxzFKdtpDSkUePKZy/niQ: raises $3 to $4
tS9JHB1h+FQ++qu8RwRNgg: folds
U2CWBTv29qdCbj8RNF2sIw: folds
yfXek8iJ7O4CFyqXrtGcfg: folds
33q95we0Etwgrm6guQGncw: folds
aIxzFKdtpDSkUePKZy/niQ collected $2.50 from pot
*** SUMMARY ***
Total pot $2.50 | Rake $0
Seat 1: tS9JHB1h+FQ++qu8RwRNgg folded before Flop (didn't bet)
Seat 2: U2CWBTv29qdCbj8RNF2sIw (button) folded before Flop (didn't bet)
Seat 3: yfXek8iJ7O4CFyqXrtGcfg (small blind) folded before Flop
Seat 4: 33q95we0Etwgrm6guQGncw (big blind) folded before Flop
Seat 5: KfwW5us6tydK81NYTtK1gw folded before Flop (didn't bet)
Seat 6: aIxzFKdtpDSkUePKZy/niQ collected ($2.50)



PokerStars Game #59939545428:  Hold'em No Limit ($0.50/$1.00) - 2009/07/01 0:42:38 ET
Table 'VOs36P6NW+QyXeQ1B62kmA' 6-max Seat #1 is the button
Seat 1: AdLVjddOzm+sRNo1Bc3S6Q ($139.30 in chips)
Seat 2: KpnW5CcJ4Mg6MeclfKmLrw ($118.35 in chips)
Seat 3: TSuRyAHnUPCFjP7Z0rEE0w ($100 in chips)
Seat 4: w02zQzNydODiyV9THKgo9w ($36.80 in chips)
Seat 5: X7GlkHF+lkbarCLuZ4Uf0w ($20.75 in chips)
Seat 6: 6tvjsJrdmWg+g7FVrMnzXA ($63.90 in chips)
KpnW5CcJ4Mg6MeclfKmLrw: posts small blind $0.50
TSuRyAHnUPCFjP7Z0rEE0w: posts big blind $1
*** HOLE CARDS ***
w02zQzNydODiyV9THKgo9w: folds
X7GlkHF+lkbarCLuZ4Uf0w: raises $1 to $2
6tvjsJrdmWg+g7FVrMnzXA: calls $2
AdLVjddOzm+sRNo1Bc3S6Q: folds
KpnW5CcJ4Mg6MeclfKmLrw: folds
TSuRyAHnUPCFjP7Z0rEE0w: folds
*** FLOP *** [9h 3h Jc]
X7GlkHF+lkbarCLuZ4Uf0w: bets $6.50
6tvjsJrdmWg+g7FVrMnzXA: calls $6.50
*** TURN *** [9h 3h Jc] [7d]
X7GlkHF+lkbarCLuZ4Uf0w: bets $12.25 and is all-in
6tvjsJrdmWg+g7FVrMnzXA: folds
X7GlkHF+lkbarCLuZ4Uf0w collected $17.60 from pot
X7GlkHF+lkbarCLuZ4Uf0w: doesn't show hand
*** SUMMARY ***
Total pot $18.50 | Rake $0.90
Board [9h 3h Jc 7d]
Seat 1: AdLVjddOzm+sRNo1Bc3S6Q (button) folded before Flop (didn't bet)
Seat 2: KpnW5CcJ4Mg6MeclfKmLrw (small blind) folded before Flop
Seat 3: TSuRyAHnUPCFjP7Z0rEE0w (big blind) folded before Flop
Seat 4: w02zQzNydODiyV9THKgo9w folded before Flop (didn't bet)
Seat 5: X7GlkHF+lkbarCLuZ4Uf0w collected ($17.60)
Seat 6: 6tvjsJrdmWg+g7FVrMnzXA folded on the Turn



PokerStars Game #59939546560:  Hold'em No Limit ($0.50/$1.00) - 2009/07/01 0:42:40 ET
Table 'rmZfTK+oSebeUPJNbWhdAA' 6-max Seat #6 is the button
Seat 1: xAU6q2/cwmby2sxmA8VcmA ($103.55 in chips)
Seat 2: z7O9PO/WEcqRouIydFhS9Q ($92.50 in chips)
Seat 3: 9yjOzGERLaEZS8CZ6YNHFg ($111.85 in chips)
Seat 4: OGMLOcTNYZXZU81au7ztUw ($140.60 in chips)
Seat 6: j7NIOHLZk7V2o9fOioO5ug ($132.50 in chips)
xAU6q2/cwmby2sxmA8VcmA: posts small blind $0.50
z7O9PO/WEcqRouIydFhS9Q: posts big blind $1
*** HOLE CARDS ***
9yjOzGERLaEZS8CZ6YNHFg: folds
OGMLOcTNYZXZU81au7ztUw: folds
j7NIOHLZk7V2o9fOioO5ug: raises $2 to $3
xAU6q2/cwmby2sxmA8VcmA: folds
z7O9PO/WEcqRouIydFhS9Q: folds
j7NIOHLZk7V2o9fOioO5ug collected $2.50 from pot
j7NIOHLZk7V2o9fOioO5ug: doesn't show hand
*** SUMMARY ***
Total pot $2.50 | Rake $0
Seat 1: xAU6q2/cwmby2sxmA8VcmA (small blind) folded before Flop
Seat 2: z7O9PO/WEcqRouIydFhS9Q (big blind) folded before Flop
Seat 3: 9yjOzGERLaEZS8CZ6YNHFg folded before Flop (didn't bet)
Seat 4: OGMLOcTNYZXZU81au7ztUw folded before Flop (didn't bet)
Seat 6: j7NIOHLZk7V2o9fOioO5ug (button) collected ($2.50)



PokerStars Game #59939551292:  Hold'em No Limit ($0.50/$1.00) - 2009/07/01 0:42:47 ET
Table 'LmXQK9xy3awB+qsPzI21Mw' 2-max Seat #1 is the button
Seat 1: NYi6JFscYNrofSXy4sM+Yw ($245.60 in chips)
Seat 2: TME8GvochpQAo8cmJwWmvA ($90.35 in chips)
NYi6JFscYNrofSXy4sM+Yw: posts small blind $0.50
TME8GvochpQAo8cmJwWmvA: posts big blind $1
*** HOLE CARDS ***
NYi6JFscYNrofSXy4sM+Yw: raises $2 to $3
TME8GvochpQAo8cmJwWmvA: folds
NYi6JFscYNrofSXy4sM+Yw collected $2 from pot
*** SUMMARY ***
Total pot $2 | Rake $0
Seat 1: NYi6JFscYNrofSXy4sM+Yw (button) (small blind) collected ($2)
Seat 2: TME8GvochpQAo8cmJwWmvA (big blind) folded before Flop



PokerStars Game #59939552628:  Hold'em No Limit ($0.50/$1.00) - 2009/07/01 0:42:49 ET
Table 'QBLDswtHe7Ml0HwAdcMhlw' 2-max Seat #2 is the button
Seat 1: hdNlhiCwI533uwvvTTfC9Q ($117 in chips)
Seat 2: GBkvjkjDWVBEa1e14dh6CA ($51.40 in chips)
GBkvjkjDWVBEa1e14dh6CA: posts small blind $0.50
hdNlhiCwI533uwvvTTfC9Q: posts big blind $1
*** HOLE CARDS ***
GBkvjkjDWVBEa1e14dh6CA: raises $2 to $3
hdNlhiCwI533uwvvTTfC9Q: folds
GBkvjkjDWVBEa1e14dh6CA collected $2 from pot
GBkvjkjDWVBEa1e14dh6CA: doesn't show hand
*** SUMMARY ***
Total pot $2 | Rake $0
Seat 1: hdNlhiCwI533uwvvTTfC9Q (big blind) folded before Flop
Seat 2: GBkvjkjDWVBEa1e14dh6CA (button) (small blind) collected ($2)



PokerStars Game #59939554002:  Hold'em No Limit ($0.50/$1.00) - 2009/07/01 0:42:51 ET
Table 'FKpXUINE6M3UxHG4zaMhHA' 6-max Seat #4 is the button
Seat 2: nDKgwwXJ45hcJfJe01cdxQ ($37.35 in chips)
Seat 3: GOHDYcxP1gP29069kB9HFw ($126.10 in chips)
Seat 4: vw0eLNLy3Huccth4CUZNPQ ($72.80 in chips)
Seat 5: eUBBn2R56C1IQ6Cs/vitwg ($100.50 in chips)
eUBBn2R56C1IQ6Cs/vitwg: posts small blind $0.50
qNezhXOOUXqwG7b9X5XJAA: is sitting out
nDKgwwXJ45hcJfJe01cdxQ: posts big blind $1
*** HOLE CARDS ***
qNezhXOOUXqwG7b9X5XJAA leaves the table
GOHDYcxP1gP29069kB9HFw: folds
vw0eLNLy3Huccth4CUZNPQ: calls $1
eUBBn2R56C1IQ6Cs/vitwg: folds
nDKgwwXJ45hcJfJe01cdxQ: checks
*** FLOP *** [Kc 9h Ks]
nDKgwwXJ45hcJfJe01cdxQ: checks
vw0eLNLy3Huccth4CUZNPQ: checks
*** TURN *** [Kc 9h Ks] [Qs]
nDKgwwXJ45hcJfJe01cdxQ: bets $1
vw0eLNLy3Huccth4CUZNPQ: folds
nDKgwwXJ45hcJfJe01cdxQ collected $2.40 from pot
nDKgwwXJ45hcJfJe01cdxQ: doesn't show hand
*** SUMMARY ***
Total pot $2.50 | Rake $0.10
Board [Kc 9h Ks Qs]
Seat 2: nDKgwwXJ45hcJfJe01cdxQ (big blind) collected ($2.40)
Seat 3: GOHDYcxP1gP29069kB9HFw folded before Flop (didn't bet)
Seat 4: vw0eLNLy3Huccth4CUZNPQ (button) folded on the Turn
Seat 5: eUBBn2R56C1IQ6Cs/vitwg (small blind) folded before Flop



PokerStars Game #59939554854:  Hold'em No Limit ($0.50/$1.00) - 2009/07/01 0:42:53 ET
Table '/RZcOwpZpHQ+OwPwjsbnRw' 6-max Seat #1 is the button
Seat 1: Zboa6dColKGHBjLPUakZjw ($58.20 in chips)
Seat 2: +xW7QemQU0Fxs+4TnqBRow ($193.50 in chips)
Seat 3: XnT1yK2DD/5FL+0bwuEhqg ($42.20 in chips)
Seat 4: j7NIOHLZk7V2o9fOioO5ug ($100 in chips)
Seat 5: wx3sQGkVi2x9wJXuWNHPBw ($195.15 in chips)
Seat 6: XOIf9W+VAxhZqN+SYoyMKA ($288.55 in chips)
+xW7QemQU0Fxs+4TnqBRow: posts small blind $0.50
XnT1yK2DD/5FL+0bwuEhqg: posts big blind $1
*** HOLE CARDS ***
j7NIOHLZk7V2o9fOioO5ug: folds
wx3sQGkVi2x9wJXuWNHPBw: folds
XOIf9W+VAxhZqN+SYoyMKA: folds
Zboa6dColKGHBjLPUakZjw: raises $1 to $2
+xW7QemQU0Fxs+4TnqBRow: folds
XnT1yK2DD/5FL+0bwuEhqg: calls $1
*** FLOP *** [6h 3d Ks]
XnT1yK2DD/5FL+0bwuEhqg: checks
Zboa6dColKGHBjLPUakZjw: bets $2
XnT1yK2DD/5FL+0bwuEhqg: calls $2
*** TURN *** [6h 3d Ks] [6s]
XnT1yK2DD/5FL+0bwuEhqg: checks
Zboa6dColKGHBjLPUakZjw: bets $2
XnT1yK2DD/5FL+0bwuEhqg: calls $2
*** RIVER *** [6h 3d Ks 6s] [2h]
XnT1yK2DD/5FL+0bwuEhqg: checks
Zboa6dColKGHBjLPUakZjw: bets $2
XnT1yK2DD/5FL+0bwuEhqg: calls $2
*** SHOW DOWN ***
Zboa6dColKGHBjLPUakZjw: shows [7c Ad] (a pair of Sixes)
XnT1yK2DD/5FL+0bwuEhqg: shows [4d 2d] (two pair, Sixes and Deuces)
XnT1yK2DD/5FL+0bwuEhqg collected $15.75 from pot
*** SUMMARY ***
Total pot $16.50 | Rake $0.75
Board [6h 3d Ks 6s 2h]
Seat 1: Zboa6dColKGHBjLPUakZjw (button) showed [7c Ad] and lost with a pair of Sixes
Seat 2: +xW7QemQU0Fxs+4TnqBRow (small blind) folded before Flop
Seat 3: XnT1yK2DD/5FL+0bwuEhqg (big blind) showed [4d 2d] and won ($15.75) with two pair, Sixes and Deuces
Seat 4: j7NIOHLZk7V2o9fOioO5ug folded before Flop (didn't bet)
Seat 5: wx3sQGkVi2x9wJXuWNHPBw folded before Flop (didn't bet)
Seat 6: XOIf9W+VAxhZqN+SYoyMKA folded before Flop (didn't bet)



PokerStars Game #59939554956:  Hold'em No Limit ($0.50/$1.00) - 2009/07/01 0:42:53 ET
Table 'U9zqzC8f3oTJ2ShXFgSSOA' 6-max Seat #3 is the button
Seat 1: tS9JHB1h+FQ++qu8RwRNgg ($79.05 in chips)
Seat 2: U2CWBTv29qdCbj8RNF2sIw ($95.50 in chips)
Seat 3: yfXek8iJ7O4CFyqXrtGcfg ($10.55 in chips)
Seat 4: 33q95we0Etwgrm6guQGncw ($89.10 in chips)
Seat 5: KfwW5us6tydK81NYTtK1gw ($295.25 in chips)
Seat 6: aIxzFKdtpDSkUePKZy/niQ ($28.90 in chips)
33q95we0Etwgrm6guQGncw: posts small blind $0.50
KfwW5us6tydK81NYTtK1gw: posts big blind $1
*** HOLE CARDS ***
aIxzFKdtpDSkUePKZy/niQ: folds
tS9JHB1h+FQ++qu8RwRNgg: folds
U2CWBTv29qdCbj8RNF2sIw: raises $2 to $3
yfXek8iJ7O4CFyqXrtGcfg: folds
33q95we0Etwgrm6guQGncw: folds
KfwW5us6tydK81NYTtK1gw: folds
U2CWBTv29qdCbj8RNF2sIw collected $2.50 from pot
U2CWBTv29qdCbj8RNF2sIw: doesn't show hand
*** SUMMARY ***
Total pot $2.50 | Rake $0
Seat 1: tS9JHB1h+FQ++qu8RwRNgg folded before Flop (didn't bet)
Seat 2: U2CWBTv29qdCbj8RNF2sIw collected ($2.50)
Seat 3: yfXek8iJ7O4CFyqXrtGcfg (button) folded before Flop (didn't bet)
Seat 4: 33q95we0Etwgrm6guQGncw (small blind) folded before Flop
Seat 5: KfwW5us6tydK81NYTtK1gw (big blind) folded before Flop
Seat 6: aIxzFKdtpDSkUePKZy/niQ folded before Flop (didn't bet)



PokerStars Game #59939555406:  Hold'em No Limit ($0.50/$1.00) - 2009/07/01 0:42:53 ET
Table 'pHrhryH8jPNdQfY62f8v+g' 6-max Seat #4 is the button
Seat 1: fF4botNMr8/ieVPO1YYRLw ($59 in chips)
Seat 2: RqgF7gRoKgRNW8Zoi1ty4A ($127.15 in chips)
Seat 4: wenbG7TaM3H7h5kn78OFNw ($45.80 in chips)
Seat 5: r1/R7y0Ortgoz4lccgW8VA ($33.65 in chips)
Seat 6: xAU6q2/cwmby2sxmA8VcmA ($113.75 in chips)
r1/R7y0Ortgoz4lccgW8VA: posts small blind $0.50
xAU6q2/cwmby2sxmA8VcmA: posts big blind $1
*** HOLE CARDS ***
fF4botNMr8/ieVPO1YYRLw: folds
RqgF7gRoKgRNW8Zoi1ty4A: folds
wenbG7TaM3H7h5kn78OFNw: folds
r1/R7y0Ortgoz4lccgW8VA: folds
xAU6q2/cwmby2sxmA8VcmA collected $1 from pot
*** SUMMARY ***
Total pot $1 | Rake $0
Seat 1: fF4botNMr8/ieVPO1YYRLw folded before Flop (didn't bet)
Seat 2: RqgF7gRoKgRNW8Zoi1ty4A folded before Flop (didn't bet)
Seat 4: wenbG7TaM3H7h5kn78OFNw (button) folded before Flop (didn't bet)
Seat 5: r1/R7y0Ortgoz4lccgW8VA (small blind) folded before Flop
Seat 6: xAU6q2/cwmby2sxmA8VcmA (big blind) collected ($1)



PokerStars Game #59939555492:  Hold'em No Limit ($0.50/$1.00) - 2009/07/01 0:42:53 ET
Table 'hugOjcwJvzEwZbK7tyiWuQ' 9-max Seat #8 is the button
Seat 1: N9n5Wc3s35DpCrOAUUNAaQ ($126.50 in chips)
Seat 2: r27C1nIV4NS4+qbnrgBQSw ($255.55 in chips)
Seat 3: jDwhY1kCdc6EkAHbT7PJMQ ($107.65 in chips)
Seat 4: UWB3oeddt/GObx2Mix2Anw ($205.75 in chips)
Seat 5: 5BRGWf+R3nt2WS3b5xX+zA ($24.80 in chips)
Seat 6: gUUvmqdVlmvpal6B8nYrmg ($107.70 in chips)
Seat 7: FL3MrLspcF23LYvC4ipBOA ($100 in chips)
Seat 8: /zy+DB4S5fUQUSfZWFzYGw ($104.25 in chips)
W8P9bUKCs43TO1xHm0dL6w will be allowed to play after the button
N9n5Wc3s35DpCrOAUUNAaQ: posts small blind $0.50
r27C1nIV4NS4+qbnrgBQSw: posts big blind $1
*** HOLE CARDS ***
jDwhY1kCdc6EkAHbT7PJMQ: folds
UWB3oeddt/GObx2Mix2Anw: folds
5BRGWf+R3nt2WS3b5xX+zA: folds
gUUvmqdVlmvpal6B8nYrmg: folds
FL3MrLspcF23LYvC4ipBOA: folds
/zy+DB4S5fUQUSfZWFzYGw: raises $2 to $3
N9n5Wc3s35DpCrOAUUNAaQ: raises $7 to $10
r27C1nIV4NS4+qbnrgBQSw: folds
/zy+DB4S5fUQUSfZWFzYGw: folds
N9n5Wc3s35DpCrOAUUNAaQ collected $7 from pot
*** SUMMARY ***
Total pot $7 | Rake $0
Seat 1: N9n5Wc3s35DpCrOAUUNAaQ (small blind) collected ($7)
Seat 2: r27C1nIV4NS4+qbnrgBQSw (big blind) folded before Flop
Seat 3: jDwhY1kCdc6EkAHbT7PJMQ folded before Flop (didn't bet)
Seat 4: UWB3oeddt/GObx2Mix2Anw folded before Flop (didn't bet)
Seat 5: 5BRGWf+R3nt2WS3b5xX+zA folded before Flop (didn't bet)
Seat 6: gUUvmqdVlmvpal6B8nYrmg folded before Flop (didn't bet)
Seat 7: FL3MrLspcF23LYvC4ipBOA folded before Flop (didn't bet)
Seat 8: /zy+DB4S5fUQUSfZWFzYGw (button) folded before Flop



PokerStars Game #59939556134:  Hold'em No Limit ($0.50/$1.00) - 2009/07/01 0:42:54 ET
Table '7Nl0ffnjeK44/vmeexh3MQ' 9-max Seat #1 is the button
Seat 1: s7D3Y+k4Cj4D1cXHv7oj+Q ($91.30 in chips)
Seat 2: kiakSwxX0e64PwYGAPQvLw ($30.85 in chips)
Seat 3: vR4IO10geOgvTW+LAUBv/A ($103 in chips)
Seat 4: bLbSOSmSOnqE0iTcH/5dxA ($100 in chips)
Seat 5: bL+QVeDcuEdzMGAGg2XJHg ($99.50 in chips)
Seat 6: FVs16t7GgfWgQWt4JxsObQ ($28.25 in chips)
Seat 8: zanka7aAZkigmZpfopXxxA ($253.70 in chips)
Seat 9: ouwUBGRKnKK9uhn1G4Lf+A ($95 in chips)
kiakSwxX0e64PwYGAPQvLw: posts small blind $0.50
vR4IO10geOgvTW+LAUBv/A: posts big blind $1
997ViqAtWn1FPjJqcffwcA: sits out
*** HOLE CARDS ***
bLbSOSmSOnqE0iTcH/5dxA: folds
bL+QVeDcuEdzMGAGg2XJHg: folds
FVs16t7GgfWgQWt4JxsObQ: raises $1 to $2
zanka7aAZkigmZpfopXxxA: folds
ouwUBGRKnKK9uhn1G4Lf+A: folds
s7D3Y+k4Cj4D1cXHv7oj+Q: calls $2
kiakSwxX0e64PwYGAPQvLw: folds
vR4IO10geOgvTW+LAUBv/A: folds
*** FLOP *** [3s Ts Qd]
FVs16t7GgfWgQWt4JxsObQ: checks
s7D3Y+k4Cj4D1cXHv7oj+Q: checks
*** TURN *** [3s Ts Qd] [6c]
FVs16t7GgfWgQWt4JxsObQ: bets $2
s7D3Y+k4Cj4D1cXHv7oj+Q: calls $2
*** RIVER *** [3s Ts Qd 6c] [Kh]
FVs16t7GgfWgQWt4JxsObQ: bets $4
s7D3Y+k4Cj4D1cXHv7oj+Q: folds
FVs16t7GgfWgQWt4JxsObQ collected $9.05 from pot
*** SUMMARY ***
Total pot $9.50 | Rake $0.45
Board [3s Ts Qd 6c Kh]
Seat 1: s7D3Y+k4Cj4D1cXHv7oj+Q (button) folded on the River
Seat 2: kiakSwxX0e64PwYGAPQvLw (small blind) folded before Flop
Seat 3: vR4IO10geOgvTW+LAUBv/A (big blind) folded before Flop
Seat 4: bLbSOSmSOnqE0iTcH/5dxA folded before Flop (didn't bet)
Seat 5: bL+QVeDcuEdzMGAGg2XJHg folded before Flop (didn't bet)
Seat 6: FVs16t7GgfWgQWt4JxsObQ collected ($9.05)
Seat 8: zanka7aAZkigmZpfopXxxA folded before Flop (didn't bet)
Seat 9: ouwUBGRKnKK9uhn1G4Lf+A folded before Flop (didn't bet)



PokerStars Game #59939555608:  Hold'em No Limit ($0.50/$1.00) - 2009/07/01 0:42:54 ET
Table 'cBDNutyLBKEk9+ptwsKmTw' 6-max Seat #5 is the button
Seat 1: xAU6q2/cwmby2sxmA8VcmA ($100 in chips)
Seat 2: 5lY8d6Cnm4HUkt/8FZSj4g ($107.80 in chips)
Seat 3: G5ZSSN6RSON3gkNvk/SmYg ($108.40 in chips)
Seat 4: 3q7F5QtzC30pSrn0nl9i+A ($17.30 in chips)
Seat 5: OGMLOcTNYZXZU81au7ztUw ($133.95 in chips)
Seat 6: NqVlOSH2lp+pp/TK3vvK5g ($70.20 in chips)
NqVlOSH2lp+pp/TK3vvK5g: posts small blind $0.50
xAU6q2/cwmby2sxmA8VcmA: posts big blind $1
*** HOLE CARDS ***
5lY8d6Cnm4HUkt/8FZSj4g: folds
G5ZSSN6RSON3gkNvk/SmYg: folds
3q7F5QtzC30pSrn0nl9i+A: folds
OGMLOcTNYZXZU81au7ztUw: raises $2 to $3
NqVlOSH2lp+pp/TK3vvK5g: calls $2.50
xAU6q2/cwmby2sxmA8VcmA: folds
*** FLOP *** [Ks 8h 4s]
NqVlOSH2lp+pp/TK3vvK5g: checks
OGMLOcTNYZXZU81au7ztUw: bets $5
NqVlOSH2lp+pp/TK3vvK5g: folds
OGMLOcTNYZXZU81au7ztUw collected $6.65 from pot
OGMLOcTNYZXZU81au7ztUw: doesn't show hand
*** SUMMARY ***
Total pot $7 | Rake $0.35
Board [Ks 8h 4s]
Seat 1: xAU6q2/cwmby2sxmA8VcmA (big blind) folded before Flop
Seat 2: 5lY8d6Cnm4HUkt/8FZSj4g folded before Flop (didn't bet)
Seat 3: G5ZSSN6RSON3gkNvk/SmYg folded before Flop (didn't bet)
Seat 4: 3q7F5QtzC30pSrn0nl9i+A folded before Flop (didn't bet)
Seat 5: OGMLOcTNYZXZU81au7ztUw (button) collected ($6.65)
Seat 6: NqVlOSH2lp+pp/TK3vvK5g (small blind) folded on the Flop



PokerStars Game #59939555778:  Hold'em No Limit ($0.50/$1.00) - 2009/07/01 0:42:54 ET
Table 'LmXQK9xy3awB+qsPzI21Mw' 2-max Seat #2 is the button
Seat 1: NYi6JFscYNrofSXy4sM+Yw ($246.60 in chips)
Seat 2: TME8GvochpQAo8cmJwWmvA ($89.35 in chips)
TME8GvochpQAo8cmJwWmvA: posts small blind $0.50
NYi6JFscYNrofSXy4sM+Yw: posts big blind $1
*** HOLE CARDS ***
TME8GvochpQAo8cmJwWmvA: raises $1 to $2
NYi6JFscYNrofSXy4sM+Yw: folds
TME8GvochpQAo8cmJwWmvA collected $2 from pot
*** SUMMARY ***
Total pot $2 | Rake $0
Seat 1: NYi6JFscYNrofSXy4sM+Yw (big blind) folded before Flop
Seat 2: TME8GvochpQAo8cmJwWmvA (button) (small blind) collected ($2)



PokerStars Game #59939556768:  Hold'em No Limit ($0.50/$1.00) - 2009/07/01 0:42:56 ET
Table 'MUPc8FEpe/nR0BKSeReX6Q' 6-max Seat #2 is the button
Seat 1: YsLQ3BAvgQHWXMAv3Wv6Hg ($113.85 in chips)
Seat 2: xAU6q2/cwmby2sxmA8VcmA ($100 in chips)
Seat 3: wx3sQGkVi2x9wJXuWNHPBw ($220.55 in chips)
Seat 4: ZA1bp6g8IwtTxkUE4eCjDQ ($203.05 in chips)
Seat 5: UBZQqpnJZdTYYY1FTb0rLA ($101.50 in chips)
Seat 6: oxnw0GLLpFanjhGkxfRSqA ($58 in chips)
wx3sQGkVi2x9wJXuWNHPBw: posts small blind $0.50
ZA1bp6g8IwtTxkUE4eCjDQ: posts big blind $1
*** HOLE CARDS ***
UBZQqpnJZdTYYY1FTb0rLA: folds
oxnw0GLLpFanjhGkxfRSqA has timed out
oxnw0GLLpFanjhGkxfRSqA: folds
oxnw0GLLpFanjhGkxfRSqA is sitting out
YsLQ3BAvgQHWXMAv3Wv6Hg: folds
xAU6q2/cwmby2sxmA8VcmA: raises $3 to $4
wx3sQGkVi2x9wJXuWNHPBw: folds
oxnw0GLLpFanjhGkxfRSqA has returned
ZA1bp6g8IwtTxkUE4eCjDQ: calls $3
*** FLOP *** [7c 5s 8c]
ZA1bp6g8IwtTxkUE4eCjDQ: checks
xAU6q2/cwmby2sxmA8VcmA: checks
*** TURN *** [7c 5s 8c] [9d]
ZA1bp6g8IwtTxkUE4eCjDQ: bets $13
xAU6q2/cwmby2sxmA8VcmA: calls $13
*** RIVER *** [7c 5s 8c 9d] [Ad]
ZA1bp6g8IwtTxkUE4eCjDQ: checks
xAU6q2/cwmby2sxmA8VcmA: checks
*** SHOW DOWN ***
ZA1bp6g8IwtTxkUE4eCjDQ: shows [Js Kh] (high card Ace)
xAU6q2/cwmby2sxmA8VcmA: shows [9c Jh] (a pair of Nines)
xAU6q2/cwmby2sxmA8VcmA collected $32.80 from pot
*** SUMMARY ***
Total pot $34.50 | Rake $1.70
Board [7c 5s 8c 9d Ad]
Seat 1: YsLQ3BAvgQHWXMAv3Wv6Hg folded before Flop (didn't bet)
Seat 2: xAU6q2/cwmby2sxmA8VcmA (button) showed [9c Jh] and won ($32.80) with a pair of Nines
Seat 3: wx3sQGkVi2x9wJXuWNHPBw (small blind) folded before Flop
Seat 4: ZA1bp6g8IwtTxkUE4eCjDQ (big blind) showed [Js Kh] and lost with high card Ace
Seat 5: UBZQqpnJZdTYYY1FTb0rLA folded before Flop (didn't bet)
Seat 6: oxnw0GLLpFanjhGkxfRSqA folded before Flop (didn't bet)



PokerStars Game #59939557222:  Hold'em No Limit ($0.50/$1.00) - 2009/07/01 0:42:56 ET
Table 'rmZfTK+oSebeUPJNbWhdAA' 6-max Seat #1 is the button
Seat 1: xAU6q2/cwmby2sxmA8VcmA ($103.05 in chips)
Seat 2: z7O9PO/WEcqRouIydFhS9Q ($91.50 in chips)
Seat 3: 9yjOzGERLaEZS8CZ6YNHFg ($111.85 in chips)
Seat 4: OGMLOcTNYZXZU81au7ztUw ($140.60 in chips)
Seat 6: j7NIOHLZk7V2o9fOioO5ug ($134 in chips)
z7O9PO/WEcqRouIydFhS9Q: posts small blind $0.50
9yjOzGERLaEZS8CZ6YNHFg: posts big blind $1
*** HOLE CARDS ***
OGMLOcTNYZXZU81au7ztUw: folds
j7NIOHLZk7V2o9fOioO5ug: folds
xAU6q2/cwmby2sxmA8VcmA: raises $3 to $4
z7O9PO/WEcqRouIydFhS9Q: folds
9yjOzGERLaEZS8CZ6YNHFg: raises $8 to $12
xAU6q2/cwmby2sxmA8VcmA: folds
5lY8d6Cnm4HUkt/8FZSj4g joins the table at seat #5
9yjOzGERLaEZS8CZ6YNHFg collected $8.50 from pot
*** SUMMARY ***
Total pot $8.50 | Rake $0
Seat 1: xAU6q2/cwmby2sxmA8VcmA (button) folded before Flop
Seat 2: z7O9PO/WEcqRouIydFhS9Q (small blind) folded before Flop
Seat 3: 9yjOzGERLaEZS8CZ6YNHFg (big blind) collected ($8.50)
Seat 4: OGMLOcTNYZXZU81au7ztUw folded before Flop (didn't bet)
Seat 6: j7NIOHLZk7V2o9fOioO5ug folded before Flop (didn't bet)



PokerStars Game #59939558166:  Hold'em No Limit ($0.50/$1.00) - 2009/07/01 0:42:58 ET
Table 'QBLDswtHe7Ml0HwAdcMhlw' 2-max Seat #1 is the button
Seat 1: hdNlhiCwI533uwvvTTfC9Q ($116 in chips)
Seat 2: GBkvjkjDWVBEa1e14dh6CA ($52.40 in chips)
hdNlhiCwI533uwvvTTfC9Q: posts small blind $0.50
GBkvjkjDWVBEa1e14dh6CA: posts big blind $1
*** HOLE CARDS ***
hdNlhiCwI533uwvvTTfC9Q: folds
GBkvjkjDWVBEa1e14dh6CA collected $1 from pot
GBkvjkjDWVBEa1e14dh6CA: doesn't show hand
*** SUMMARY ***
Total pot $1 | Rake $0
Seat 1: hdNlhiCwI533uwvvTTfC9Q (button) (small blind) folded before Flop
Seat 2: GBkvjkjDWVBEa1e14dh6CA (big blind) collected ($1)



PokerStars Game #59939559008:  Hold'em No Limit ($0.50/$1.00) - 2009/07/01 0:42:59 ET
Table 'uNlePsyMIqzM691Xkrlk6Q' 9-max Seat #2 is the button
Seat 1: bLbSOSmSOnqE0iTcH/5dxA ($100 in chips)
Seat 2: +OqpStnt0FqbCfyHAWaLbg ($76.65 in chips)
Seat 3: h7qXkU57Bb8ZuPwMyxR8Ug ($30.50 in chips)
Seat 4: TZcz9MEWDA+WydgGruqqbw ($104.15 in chips)
Seat 5: 3obndzTJ6fECz8+wWhMd1w ($18.50 in chips)
Seat 6: uMPEfCcGCfsxmy53tVUMug ($110.60 in chips)
Seat 7: w6cw9nzN7AvkkHBVVjykoQ ($41.40 in chips)
Seat 9: vR4IO10geOgvTW+LAUBv/A ($102.25 in chips)
h7qXkU57Bb8ZuPwMyxR8Ug: posts small blind $0.50
TZcz9MEWDA+WydgGruqqbw: posts big blind $1
laA8va+Yv8WuMqT1zdR91g: sits out
*** HOLE CARDS ***
3obndzTJ6fECz8+wWhMd1w: folds
uMPEfCcGCfsxmy53tVUMug: folds
w6cw9nzN7AvkkHBVVjykoQ: raises $3 to $4
vR4IO10geOgvTW+LAUBv/A: folds
bLbSOSmSOnqE0iTcH/5dxA: folds
+OqpStnt0FqbCfyHAWaLbg: folds
h7qXkU57Bb8ZuPwMyxR8Ug: folds
TZcz9MEWDA+WydgGruqqbw: folds
w6cw9nzN7AvkkHBVVjykoQ collected $2.50 from pot
*** SUMMARY ***
Total pot $2.50 | Rake $0
Seat 1: bLbSOSmSOnqE0iTcH/5dxA folded before Flop (didn't bet)
Seat 2: +OqpStnt0FqbCfyHAWaLbg (button) folded before Flop (didn't bet)
Seat 3: h7qXkU57Bb8ZuPwMyxR8Ug (small blind) folded before Flop
Seat 4: TZcz9MEWDA+WydgGruqqbw (big blind) folded before Flop
Seat 5: 3obndzTJ6fECz8+wWhMd1w folded before Flop (didn't bet)
Seat 6: uMPEfCcGCfsxmy53tVUMug folded before Flop (didn't bet)
Seat 7: w6cw9nzN7AvkkHBVVjykoQ collected ($2.50)
Seat 9: vR4IO10geOgvTW+LAUBv/A folded before Flop (didn't bet)



PokerStars Game #59939560484:  Hold'em No Limit ($0.50/$1.00) - 2009/07/01 0:43:01 ET
Table 'LmXQK9xy3awB+qsPzI21Mw' 2-max Seat #1 is the button
Seat 1: NYi6JFscYNrofSXy4sM+Yw ($245.60 in chips)
Seat 2: TME8GvochpQAo8cmJwWmvA ($90.35 in chips)
NYi6JFscYNrofSXy4sM+Yw: posts small blind $0.50
TME8GvochpQAo8cmJwWmvA: posts big blind $1
*** HOLE CARDS ***
NYi6JFscYNrofSXy4sM+Yw: folds
TME8GvochpQAo8cmJwWmvA collected $1 from pot
TME8GvochpQAo8cmJwWmvA: doesn't show hand
*** SUMMARY ***
Total pot $1 | Rake $0
Seat 1: NYi6JFscYNrofSXy4sM+Yw (button) (small blind) folded before Flop
Seat 2: TME8GvochpQAo8cmJwWmvA (big blind) collected ($1)



PokerStars Game #59939559996:  Hold'em No Limit ($0.50/$1.00) - 2009/07/01 0:43:01 ET
Table 'GPp0HyAuggN8oE0sUWzPpA' 9-max Seat #3 is the button
Seat 1: qJr25HAtvv1w/7IBvjMM3g ($18.85 in chips)
Seat 2: Ogn4JDV3mp4ZDKO49IFzKA ($34.20 in chips)
Seat 3: L9njYvloJ1NdXjP8edHEAg ($100 in chips)
Seat 4: mBRWbnUl8diyBO1qTJaNzw ($111.70 in chips)
Seat 5: 0fXz44fzDo5QmhAaJCvFfA ($20.80 in chips)
Seat 6: negfosHnGOZXSHpWDRKyBQ ($35.10 in chips)
Seat 8: tkdBeXTJlFsZdioidNqLow ($65.15 in chips)
mBRWbnUl8diyBO1qTJaNzw: posts small blind $0.50
0fXz44fzDo5QmhAaJCvFfA: posts big blind $1
laA8va+Yv8WuMqT1zdR91g: sits out
VPF+HjszMvUIpy0CHIwH3A: sits out
*** HOLE CARDS ***
negfosHnGOZXSHpWDRKyBQ: folds
tkdBeXTJlFsZdioidNqLow: folds
qJr25HAtvv1w/7IBvjMM3g: raises $3 to $4
Ogn4JDV3mp4ZDKO49IFzKA: folds
L9njYvloJ1NdXjP8edHEAg: folds
mBRWbnUl8diyBO1qTJaNzw: folds
0fXz44fzDo5QmhAaJCvFfA: folds
qJr25HAtvv1w/7IBvjMM3g collected $2.50 from pot
*** SUMMARY ***
Total pot $2.50 | Rake $0
Seat 1: qJr25HAtvv1w/7IBvjMM3g collected ($2.50)
Seat 2: Ogn4JDV3mp4ZDKO49IFzKA folded before Flop (didn't bet)
Seat 3: L9njYvloJ1NdXjP8edHEAg (button) folded before Flop (didn't bet)
Seat 4: mBRWbnUl8diyBO1qTJaNzw (small blind) folded before Flop
Seat 5: 0fXz44fzDo5QmhAaJCvFfA (big blind) folded before Flop
Seat 6: negfosHnGOZXSHpWDRKyBQ folded before Flop (didn't bet)
Seat 8: tkdBeXTJlFsZdioidNqLow folded before Flop (didn't bet)



PokerStars Game #59939560590:  Hold'em No Limit ($0.50/$1.00) - 2009/07/01 0:43:02 ET
Table 'GxCPo/gd3OSthkYrAxJngg' 6-max Seat #5 is the button
Seat 1: sH8BpAFP+jGFxCgVpD1Lew ($255.45 in chips)
Seat 2: YExX2paeIHrmfIwV1ivM/w ($79.70 in chips)
Seat 3: o6plE+MSW4XFNTeONe16xg ($32.60 in chips)
Seat 4: YMJG+F++3Aj6P8dAWda5fw ($106.65 in chips)
Seat 5: G5ZSSN6RSON3gkNvk/SmYg ($109.75 in chips)
Seat 6: sS9IXedL3MiRmpVXhAILhw ($100.95 in chips)
sS9IXedL3MiRmpVXhAILhw: posts small blind $0.50
sH8BpAFP+jGFxCgVpD1Lew: posts big blind $1
*** HOLE CARDS ***
YExX2paeIHrmfIwV1ivM/w: folds
o6plE+MSW4XFNTeONe16xg: folds
YMJG+F++3Aj6P8dAWda5fw: folds
G5ZSSN6RSON3gkNvk/SmYg: folds
sS9IXedL3MiRmpVXhAILhw: folds
sH8BpAFP+jGFxCgVpD1Lew collected $1 from pot
*** SUMMARY ***
Total pot $1 | Rake $0
Seat 1: sH8BpAFP+jGFxCgVpD1Lew (big blind) collected ($1)
Seat 2: YExX2paeIHrmfIwV1ivM/w folded before Flop (didn't bet)
Seat 3: o6plE+MSW4XFNTeONe16xg folded before Flop (didn't bet)
Seat 4: YMJG+F++3Aj6P8dAWda5fw folded before Flop (didn't bet)
Seat 5: G5ZSSN6RSON3gkNvk/SmYg (button) folded before Flop (didn't bet)
Seat 6: sS9IXedL3MiRmpVXhAILhw (small blind) folded before Flop



PokerStars Game #59939561866:  Hold'em No Limit ($0.50/$1.00) - 2009/07/01 0:43:04 ET
Table 'Zka9tv1yilg0MvXWPQrShg' 9-max Seat #9 is the button
Seat 1: TZcz9MEWDA+WydgGruqqbw ($114.35 in chips)
Seat 3: gUUvmqdVlmvpal6B8nYrmg ($100 in chips)
Seat 4: CTOae+JLIGfwfXvhqHkP2w ($193 in chips)
Seat 5: /zy+DB4S5fUQUSfZWFzYGw ($132.40 in chips)
Seat 6: rY8wPoax1lS+HUY+I0FZDw ($146.30 in chips)
Seat 7: p1SafS90nb3Uft5LB0NkHw ($20 in chips)
Seat 8: bL+QVeDcuEdzMGAGg2XJHg ($117.60 in chips)
Seat 9: 6daxhj43mWj04MOPTOmaYA ($91.50 in chips)
TZcz9MEWDA+WydgGruqqbw: posts small blind $0.50
gUUvmqdVlmvpal6B8nYrmg: posts big blind $1
*** HOLE CARDS ***
CTOae+JLIGfwfXvhqHkP2w: folds
rR1qGAf9Q9RYorKYWH3VKw leaves the table
CTOae+JLIGfwfXvhqHkP2w leaves the table
/zy+DB4S5fUQUSfZWFzYGw: folds
rY8wPoax1lS+HUY+I0FZDw: raises $3 to $4
p1SafS90nb3Uft5LB0NkHw: folds
bL+QVeDcuEdzMGAGg2XJHg: folds
6daxhj43mWj04MOPTOmaYA: folds
TZcz9MEWDA+WydgGruqqbw: folds
gUUvmqdVlmvpal6B8nYrmg: folds
rY8wPoax1lS+HUY+I0FZDw collected $2.50 from pot
*** SUMMARY ***
Total pot $2.50 | Rake $0
Seat 1: TZcz9MEWDA+WydgGruqqbw (small blind) folded before Flop
Seat 3: gUUvmqdVlmvpal6B8nYrmg (big blind) folded before Flop
Seat 4: CTOae+JLIGfwfXvhqHkP2w folded before Flop (didn't bet)
Seat 5: /zy+DB4S5fUQUSfZWFzYGw folded before Flop (didn't bet)
Seat 6: rY8wPoax1lS+HUY+I0FZDw collected ($2.50)
Seat 7: p1SafS90nb3Uft5LB0NkHw folded before Flop (didn't bet)
Seat 8: bL+QVeDcuEdzMGAGg2XJHg folded before Flop (didn't bet)
Seat 9: 6daxhj43mWj04MOPTOmaYA (button) folded before Flop (didn't bet)



PokerStars Game #59939562602:  Hold'em No Limit ($0.50/$1.00) - 2009/07/01 0:43:05 ET
Table '7O9fB8yx1u7sJveJn8w6jA' 6-max Seat #2 is the button
Seat 1: jy52+7FotjH63o5tEEVgKw ($119.35 in chips)
Seat 2: wx3sQGkVi2x9wJXuWNHPBw ($194 in chips)
Seat 3: hpxXcmRkXXI9HE5+5/j/0Q ($100 in chips)
Seat 4: XIZSmlGttGgSRaIU42K4Fg ($101.35 in chips)
Seat 5: BCEV3COoKY607AzLWayfRA ($106.85 in chips)
Seat 6: UBZQqpnJZdTYYY1FTb0rLA ($129.35 in chips)
hpxXcmRkXXI9HE5+5/j/0Q: posts small blind $0.50
XIZSmlGttGgSRaIU42K4Fg: posts big blind $1
*** HOLE CARDS ***
BCEV3COoKY607AzLWayfRA: folds
UBZQqpnJZdTYYY1FTb0rLA: folds
jy52+7FotjH63o5tEEVgKw: calls $1
wx3sQGkVi2x9wJXuWNHPBw: folds
hpxXcmRkXXI9HE5+5/j/0Q: folds
XIZSmlGttGgSRaIU42K4Fg: checks
*** FLOP *** [2s 2h Td]
XIZSmlGttGgSRaIU42K4Fg: bets $2
jy52+7FotjH63o5tEEVgKw: folds
XIZSmlGttGgSRaIU42K4Fg collected $2.40 from pot
*** SUMMARY ***
Total pot $2.50 | Rake $0.10
Board [2s 2h Td]
Seat 1: jy52+7FotjH63o5tEEVgKw folded on the Flop
Seat 2: wx3sQGkVi2x9wJXuWNHPBw (button) folded before Flop (didn't bet)
Seat 3: hpxXcmRkXXI9HE5+5/j/0Q (small blind) folded before Flop
Seat 4: XIZSmlGttGgSRaIU42K4Fg (big blind) collected ($2.40)
Seat 5: BCEV3COoKY607AzLWayfRA folded before Flop (didn't bet)
Seat 6: UBZQqpnJZdTYYY1FTb0rLA folded before Flop (didn't bet)



PokerStars Game #59939564398:  Hold'em No Limit ($0.50/$1.00) - 2009/07/01 0:43:07 ET
Table 'LmXQK9xy3awB+qsPzI21Mw' 2-max Seat #2 is the button
Seat 1: NYi6JFscYNrofSXy4sM+Yw ($245.10 in chips)
Seat 2: TME8GvochpQAo8cmJwWmvA ($90.85 in chips)
TME8GvochpQAo8cmJwWmvA: posts small blind $0.50
NYi6JFscYNrofSXy4sM+Yw: posts big blind $1
*** HOLE CARDS ***
TME8GvochpQAo8cmJwWmvA: raises $1 to $2
NYi6JFscYNrofSXy4sM+Yw: calls $1
*** FLOP *** [7h Ts Ks]
NYi6JFscYNrofSXy4sM+Yw: checks
TME8GvochpQAo8cmJwWmvA: bets $2
NYi6JFscYNrofSXy4sM+Yw: folds
TME8GvochpQAo8cmJwWmvA collected $3.80 from pot
*** SUMMARY ***
Total pot $4 | Rake $0.20
Board [7h Ts Ks]
Seat 1: NYi6JFscYNrofSXy4sM+Yw (big blind) folded on the Flop
Seat 2: TME8GvochpQAo8cmJwWmvA (button) (small blind) collected ($3.80)



PokerStars Game #59939564504:  Hold'em No Limit ($0.50/$1.00) - 2009/07/01 0:43:07 ET
Table 'pHrhryH8jPNdQfY62f8v+g' 6-max Seat #5 is the button
Seat 1: fF4botNMr8/ieVPO1YYRLw ($59 in chips)
Seat 2: RqgF7gRoKgRNW8Zoi1ty4A ($127.15 in chips)
Seat 4: wenbG7TaM3H7h5kn78OFNw ($45.80 in chips)
Seat 5: r1/R7y0Ortgoz4lccgW8VA ($33.15 in chips)
Seat 6: xAU6q2/cwmby2sxmA8VcmA ($114.25 in chips)
xAU6q2/cwmby2sxmA8VcmA: posts small blind $0.50
fF4botNMr8/ieVPO1YYRLw: posts big blind $1
*** HOLE CARDS ***
RqgF7gRoKgRNW8Zoi1ty4A: folds
wenbG7TaM3H7h5kn78OFNw: folds
r1/R7y0Ortgoz4lccgW8VA: folds
xAU6q2/cwmby2sxmA8VcmA: folds
fF4botNMr8/ieVPO1YYRLw collected $1 from pot
*** SUMMARY ***
Total pot $1 | Rake $0
Seat 1: fF4botNMr8/ieVPO1YYRLw (big blind) collected ($1)
Seat 2: RqgF7gRoKgRNW8Zoi1ty4A folded before Flop (didn't bet)
Seat 4: wenbG7TaM3H7h5kn78OFNw folded before Flop (didn't bet)
Seat 5: r1/R7y0Ortgoz4lccgW8VA (button) folded before Flop (didn't bet)
Seat 6: xAU6q2/cwmby2sxmA8VcmA (small blind) folded before Flop



PokerStars Game #59939565184:  Hold'em No Limit ($0.50/$1.00) - 2009/07/01 0:43:08 ET
Table 'U9zqzC8f3oTJ2ShXFgSSOA' 6-max Seat #4 is the button
Seat 1: tS9JHB1h+FQ++qu8RwRNgg ($79.05 in chips)
Seat 2: U2CWBTv29qdCbj8RNF2sIw ($97 in chips)
Seat 3: yfXek8iJ7O4CFyqXrtGcfg ($10.55 in chips)
Seat 4: 33q95we0Etwgrm6guQGncw ($88.60 in chips)
Seat 5: KfwW5us6tydK81NYTtK1gw ($294.25 in chips)
Seat 6: aIxzFKdtpDSkUePKZy/niQ ($28.90 in chips)
KfwW5us6tydK81NYTtK1gw: posts small blind $0.50
aIxzFKdtpDSkUePKZy/niQ: posts big blind $1
*** HOLE CARDS ***
tS9JHB1h+FQ++qu8RwRNgg: folds
U2CWBTv29qdCbj8RNF2sIw: folds
tS9JHB1h+FQ++qu8RwRNgg leaves the table
yfXek8iJ7O4CFyqXrtGcfg: folds
33q95we0Etwgrm6guQGncw: folds
KfwW5us6tydK81NYTtK1gw: raises $2 to $3
aIxzFKdtpDSkUePKZy/niQ: raises $5 to $8
+xW7QemQU0Fxs+4TnqBRow joins the table at seat #1
KfwW5us6tydK81NYTtK1gw: folds
aIxzFKdtpDSkUePKZy/niQ collected $6 from pot
*** SUMMARY ***
Total pot $6 | Rake $0
Seat 1: tS9JHB1h+FQ++qu8RwRNgg folded before Flop (didn't bet)
Seat 2: U2CWBTv29qdCbj8RNF2sIw folded before Flop (didn't bet)
Seat 3: yfXek8iJ7O4CFyqXrtGcfg folded before Flop (didn't bet)
Seat 4: 33q95we0Etwgrm6guQGncw (button) folded before Flop (didn't bet)
Seat 5: KfwW5us6tydK81NYTtK1gw (small blind) folded before Flop
Seat 6: aIxzFKdtpDSkUePKZy/niQ (big blind) collected ($6)



PokerStars Game #59939566186:  Hold'em No Limit ($0.50/$1.00) - 2009/07/01 0:43:10 ET
Table 'eU3bWpDDg3Z+9R4m4iVmog' 6-max Seat #6 is the button
Seat 1: TSuRyAHnUPCFjP7Z0rEE0w ($191.65 in chips)
Seat 2: 8CAoOzhmB8n3nRFf3V4BTg ($99.30 in chips)
Seat 3: U6tnjwZRpTnM+YkqkCjwyQ ($191.15 in chips)
Seat 4: GDVIsbEJ/DOJsMKE4Asz0A ($74.10 in chips)
Seat 5: AdLVjddOzm+sRNo1Bc3S6Q ($100 in chips)
Seat 6: hpxXcmRkXXI9HE5+5/j/0Q ($121.95 in chips)
TSuRyAHnUPCFjP7Z0rEE0w: posts small blind $0.50
8CAoOzhmB8n3nRFf3V4BTg: posts big blind $1
*** HOLE CARDS ***
U6tnjwZRpTnM+YkqkCjwyQ: folds
GDVIsbEJ/DOJsMKE4Asz0A: calls $1
AdLVjddOzm+sRNo1Bc3S6Q: raises $4 to $5
hpxXcmRkXXI9HE5+5/j/0Q: folds
TSuRyAHnUPCFjP7Z0rEE0w: folds
8CAoOzhmB8n3nRFf3V4BTg: folds
GDVIsbEJ/DOJsMKE4Asz0A: folds
AdLVjddOzm+sRNo1Bc3S6Q collected $3.50 from pot
AdLVjddOzm+sRNo1Bc3S6Q: doesn't show hand
*** SUMMARY ***
Total pot $3.50 | Rake $0
Seat 1: TSuRyAHnUPCFjP7Z0rEE0w (small blind) folded before Flop
Seat 2: 8CAoOzhmB8n3nRFf3V4BTg (big blind) folded before Flop
Seat 3: U6tnjwZRpTnM+YkqkCjwyQ folded before Flop (didn't bet)
Seat 4: GDVIsbEJ/DOJsMKE4Asz0A folded before Flop
Seat 5: AdLVjddOzm+sRNo1Bc3S6Q collected ($3.50)
Seat 6: hpxXcmRkXXI9HE5+5/j/0Q (button) folded before Flop (didn't bet)



PokerStars Game #59939566456:  Hold'em No Limit ($0.50/$1.00) - 2009/07/01 0:43:10 ET
Table 'fTlPiCj0utgzC/5io+I7ew' 6-max Seat #4 is the button
Seat 1: YMJG+F++3Aj6P8dAWda5fw ($97 in chips)
Seat 2: Qy/UBNbD2HaA0Ogxg8Sf3w ($105.95 in chips)
Seat 3: oDiBRCaF0QVtd3kO6xZIXw ($84.60 in chips)
Seat 4: uJVSceLggtsrJya+WtmUEA ($97.30 in chips)
Seat 5: bFrTkDcWGTxyvNul7GVdYg ($255.70 in chips)
bFrTkDcWGTxyvNul7GVdYg: posts small blind $0.50
YMJG+F++3Aj6P8dAWda5fw: posts big blind $1
*** HOLE CARDS ***
Qy/UBNbD2HaA0Ogxg8Sf3w: folds
oDiBRCaF0QVtd3kO6xZIXw: calls $1
uJVSceLggtsrJya+WtmUEA: folds
bFrTkDcWGTxyvNul7GVdYg: folds
YMJG+F++3Aj6P8dAWda5fw: raises $3 to $4
oDiBRCaF0QVtd3kO6xZIXw: folds
YMJG+F++3Aj6P8dAWda5fw collected $2.50 from pot
*** SUMMARY ***
Total pot $2.50 | Rake $0
Seat 1: YMJG+F++3Aj6P8dAWda5fw (big blind) collected ($2.50)
Seat 2: Qy/UBNbD2HaA0Ogxg8Sf3w folded before Flop (didn't bet)
Seat 3: oDiBRCaF0QVtd3kO6xZIXw folded before Flop
Seat 4: uJVSceLggtsrJya+WtmUEA (button) folded before Flop (didn't bet)
Seat 5: bFrTkDcWGTxyvNul7GVdYg (small blind) folded before Flop



PokerStars Game #59939566892:  Hold'em No Limit ($0.50/$1.00) - 2009/07/01 0:43:11 ET
Table 'vs/5jr6ciwjVQ5+Soc+u2A' 6-max Seat #3 is the button
Seat 1: 1C0rFAGdnnX4GWK9B0YPww ($13.50 in chips)
Seat 2: XOIf9W+VAxhZqN+SYoyMKA ($126.15 in chips)
Seat 3: G5ZSSN6RSON3gkNvk/SmYg ($150.50 in chips)
Seat 4: KpnW5CcJ4Mg6MeclfKmLrw ($103.30 in chips)
Seat 5: imUnjybOc/YBYCgM7m/qSA ($32.25 in chips)
Seat 6: QHvTZcrKe6+maWUfVjP29Q ($101.10 in chips)
KpnW5CcJ4Mg6MeclfKmLrw: posts small blind $0.50
imUnjybOc/YBYCgM7m/qSA: posts big blind $1
*** HOLE CARDS ***
QHvTZcrKe6+maWUfVjP29Q: folds
1C0rFAGdnnX4GWK9B0YPww: folds
XOIf9W+VAxhZqN+SYoyMKA: folds
G5ZSSN6RSON3gkNvk/SmYg: folds
KpnW5CcJ4Mg6MeclfKmLrw: folds
imUnjybOc/YBYCgM7m/qSA collected $1 from pot
*** SUMMARY ***
Total pot $1 | Rake $0
Seat 1: 1C0rFAGdnnX4GWK9B0YPww folded before Flop (didn't bet)
Seat 2: XOIf9W+VAxhZqN+SYoyMKA folded before Flop (didn't bet)
Seat 3: G5ZSSN6RSON3gkNvk/SmYg (button) folded before Flop (didn't bet)
Seat 4: KpnW5CcJ4Mg6MeclfKmLrw (small blind) folded before Flop
Seat 5: imUnjybOc/YBYCgM7m/qSA (big blind) collected ($1)
Seat 6: QHvTZcrKe6+maWUfVjP29Q folded before Flop (didn't bet)



PokerStars Game #59939568234:  Hold'em No Limit ($0.50/$1.00) - 2009/07/01 0:43:13 ET
Table 'QBLDswtHe7Ml0HwAdcMhlw' 2-max Seat #2 is the button
Seat 1: hdNlhiCwI533uwvvTTfC9Q ($115.50 in chips)
Seat 2: GBkvjkjDWVBEa1e14dh6CA ($52.90 in chips)
GBkvjkjDWVBEa1e14dh6CA: posts small blind $0.50
hdNlhiCwI533uwvvTTfC9Q: posts big blind $1
*** HOLE CARDS ***
GBkvjkjDWVBEa1e14dh6CA: raises $2 to $3
hdNlhiCwI533uwvvTTfC9Q: folds
GBkvjkjDWVBEa1e14dh6CA collected $2 from pot
GBkvjkjDWVBEa1e14dh6CA: doesn't show hand
*** SUMMARY ***
Total pot $2 | Rake $0
Seat 1: hdNlhiCwI533uwvvTTfC9Q (big blind) folded before Flop
Seat 2: GBkvjkjDWVBEa1e14dh6CA (button) (small blind) collected ($2)



PokerStars Game #59939568444:  Hold'em No Limit ($0.50/$1.00) - 2009/07/01 0:43:13 ET
Table 'SQLOQoANiHscJ8AL7zffbw' 9-max Seat #7 is the button
Seat 1: jPTRd6SpCp4xqAy2XQiTOw ($130.60 in chips)
Seat 2: /zy+DB4S5fUQUSfZWFzYGw ($276.35 in chips)
Seat 3: 0eFnow7+D7veCYQ+CG9FFw ($79.90 in chips)
Seat 4: N9n5Wc3s35DpCrOAUUNAaQ ($92.35 in chips)
Seat 5: L9njYvloJ1NdXjP8edHEAg ($107.05 in chips)
Seat 6: p5UKaxVobvptF0ANhR/q1A ($174.50 in chips)
Seat 7: bJckevFOcg//s0qyMQI6sQ ($100 in chips)
Seat 8: Pp/KTcXkfZKKUHkjyaLTdg ($29 in chips)
Seat 9: qJr25HAtvv1w/7IBvjMM3g ($231.75 in chips)
Pp/KTcXkfZKKUHkjyaLTdg: posts small blind $0.50
qJr25HAtvv1w/7IBvjMM3g: posts big blind $1
*** HOLE CARDS ***
jPTRd6SpCp4xqAy2XQiTOw: folds
/zy+DB4S5fUQUSfZWFzYGw: folds
0eFnow7+D7veCYQ+CG9FFw: folds
N9n5Wc3s35DpCrOAUUNAaQ: calls $1
L9njYvloJ1NdXjP8edHEAg: folds
p5UKaxVobvptF0ANhR/q1A: folds
bJckevFOcg//s0qyMQI6sQ: folds
Pp/KTcXkfZKKUHkjyaLTdg: folds
qJr25HAtvv1w/7IBvjMM3g: checks
*** FLOP *** [Jd 5h 2h]
qJr25HAtvv1w/7IBvjMM3g: checks
N9n5Wc3s35DpCrOAUUNAaQ: bets $2
qJr25HAtvv1w/7IBvjMM3g: folds
N9n5Wc3s35DpCrOAUUNAaQ collected $2.40 from pot
*** SUMMARY ***
Total pot $2.50 | Rake $0.10
Board [Jd 5h 2h]
Seat 1: jPTRd6SpCp4xqAy2XQiTOw folded before Flop (didn't bet)
Seat 2: /zy+DB4S5fUQUSfZWFzYGw folded before Flop (didn't bet)
Seat 3: 0eFnow7+D7veCYQ+CG9FFw folded before Flop (didn't bet)
Seat 4: N9n5Wc3s35DpCrOAUUNAaQ collected ($2.40)
Seat 5: L9njYvloJ1NdXjP8edHEAg folded before Flop (didn't bet)
Seat 6: p5UKaxVobvptF0ANhR/q1A folded before Flop (didn't bet)
Seat 7: bJckevFOcg//s0qyMQI6sQ (button) folded before Flop (didn't bet)
Seat 8: Pp/KTcXkfZKKUHkjyaLTdg (small blind) folded before Flop
Seat 9: qJr25HAtvv1w/7IBvjMM3g (big blind) folded on the Flop



PokerStars Game #59939570002:  Hold'em No Limit ($0.50/$1.00) - 2009/07/01 0:43:16 ET
Table 'tyUh+jyNvrceIQdKMJjQ2wZFWj23PMihdwrNWv41OG/Qeat #1 is the button
Seat 1: o8A5MUdudVKu+pAwgZOX2w ($223.45 in chips)
Seat 2: XvUbOIg94d25feWeQlOTVg ($60.30 in chips)
Seat 3: TalCiLYHCd+ffkmR3auPvA ($71.80 in chips)
Seat 4: TSuRyAHnUPCFjP7Z0rEE0w ($119.75 in chips)
Seat 5: j7NIOHLZk7V2o9fOioO5ug ($111.60 in chips)
Seat 6: YsLQ3BAvgQHWXMAv3Wv6Hg ($149.75 in chips)
XvUbOIg94d25feWeQlOTVg: posts small blind $0.50
TalCiLYHCd+ffkmR3auPvA: posts big blind $1
*** HOLE CARDS ***
TSuRyAHnUPCFjP7Z0rEE0w: folds
j7NIOHLZk7V2o9fOioO5ug: folds
YsLQ3BAvgQHWXMAv3Wv6Hg: raises $3 to $4
o8A5MUdudVKu+pAwgZOX2w: calls $4
XvUbOIg94d25feWeQlOTVg: calls $3.50
TalCiLYHCd+ffkmR3auPvA: calls $3
*** FLOP *** [Kc Ks As]
XvUbOIg94d25feWeQlOTVg: checks
TalCiLYHCd+ffkmR3auPvA: checks
YsLQ3BAvgQHWXMAv3Wv6Hg: checks
o8A5MUdudVKu+pAwgZOX2w: checks
*** TURN *** [Kc Ks As] [9d]
XvUbOIg94d25feWeQlOTVg: checks
TalCiLYHCd+ffkmR3auPvA: bets $4
YsLQ3BAvgQHWXMAv3Wv6Hg: folds
o8A5MUdudVKu+pAwgZOX2w: folds
XvUbOIg94d25feWeQlOTVg: calls $4
*** RIVER *** [Kc Ks As 9d] [4h]
XvUbOIg94d25feWeQlOTVg: checks
TalCiLYHCd+ffkmR3auPvA: checks
*** SHOW DOWN ***
XvUbOIg94d25feWeQlOTVg: shows [9s 8d] (two pair, Kings and Nines)
TalCiLYHCd+ffkmR3auPvA: mucks hand
XvUbOIg94d25feWeQlOTVg collected $22.85 from pot
*** SUMMARY ***
Total pot $24 | Rake $1.15
Board [Kc Ks As 9d 4h]
Seat 1: o8A5MUdudVKu+pAwgZOX2w (button) folded on the Turn
Seat 2: XvUbOIg94d25feWeQlOTVg (small blind) showed [9s 8d] and won ($22.85) with two pair, Kings and Nines
Seat 3: TalCiLYHCd+ffkmR3auPvA (big blind) mucked
Seat 4: TSuRyAHnUPCFjP7Z0rEE0w folded before Flop (didn't bet)
Seat 5: j7NIOHLZk7V2o9fOioO5ug folded before Flop (didn't bet)
Seat 6: YsLQ3BAvgQHWXMAv3Wv6Hg folded on the Turn



PokerStars Game #59939571970:  Hold'em No Limit ($0.50/$1.00) - 2009/07/01 0:43:19 ET
Table 'N2bNCDHL96aCQDvZIh+yQQ' 6-max Seat #4 is the button
Seat 1: iHo1oDbrEVJ8nEGdaPrICw ($101.50 in chips)
Seat 2: KpnW5CcJ4Mg6MeclfKmLrw ($118.10 in chips)
Seat 3: Qy/UBNbD2HaA0Ogxg8Sf3w ($199.70 in chips)
Seat 4: uCqEjnxh2/vFBjKYkfTOkw ($168.90 in chips)
Seat 5: rHlMOfR7kpQQxe+PFQz0xQ ($29.75 in chips)
Seat 6: TSuRyAHnUPCFjP7Z0rEE0w ($100 in chips)
rHlMOfR7kpQQxe+PFQz0xQ: posts small blind $0.50
TSuRyAHnUPCFjP7Z0rEE0w: posts big blind $1
*** HOLE CARDS ***
iHo1oDbrEVJ8nEGdaPrICw: folds
KpnW5CcJ4Mg6MeclfKmLrw: folds
Qy/UBNbD2HaA0Ogxg8Sf3w: folds
uCqEjnxh2/vFBjKYkfTOkw: folds
rHlMOfR7kpQQxe+PFQz0xQ: folds
TSuRyAHnUPCFjP7Z0rEE0w collected $1 from pot
TSuRyAHnUPCFjP7Z0rEE0w: doesn't show hand
*** SUMMARY ***
Total pot $1 | Rake $0
Seat 1: iHo1oDbrEVJ8nEGdaPrICw folded before Flop (didn't bet)
Seat 2: KpnW5CcJ4Mg6MeclfKmLrw folded before Flop (didn't bet)
Seat 3: Qy/UBNbD2HaA0Ogxg8Sf3w folded before Flop (didn't bet)
Seat 4: uCqEjnxh2/vFBjKYkfTOkw (button) folded before Flop (didn't bet)
Seat 5: rHlMOfR7kpQQxe+PFQz0xQ (small blind) folded before Flop
Seat 6: TSuRyAHnUPCFjP7Z0rEE0w (big blind) collected ($1)



PokerStars Game #59939572220:  Hold'em No Limit ($0.50/$1.00) - 2009/07/01 0:43:19 ET
Table '6YvsYDPNIDx2v5z3bJnwZQ' 9-max Seat #4 is the button
Seat 1: Ogn4JDV3mp4ZDKO49IFzKA ($18.70 in chips)
Seat 2: x80+i7DJL+81v3quj7KbNg ($20 in chips)
Seat 3: negfosHnGOZXSHpWDRKyBQ ($17.30 in chips)
Seat 4: kEr5NYB+JIG5+szcYMr6hA ($42.50 in chips)
Seat 5: mBRWbnUl8diyBO1qTJaNzw ($159.70 in chips)
Seat 6: uMPEfCcGCfsxmy53tVUMug ($108.10 in chips)
Seat 7: boixc27eqTYA1p0tUdMuBQ ($100 in chips)
Seat 8: PSFxpXgPedVZyHSu2Zhb7Q ($92 in chips)
Seat 9: jDwhY1kCdc6EkAHbT7PJMQ ($104.10 in chips)
mBRWbnUl8diyBO1qTJaNzw: posts small blind $0.50
uMPEfCcGCfsxmy53tVUMug: posts big blind $1
*** HOLE CARDS ***
boixc27eqTYA1p0tUdMuBQ: folds
PSFxpXgPedVZyHSu2Zhb7Q: calls $1
jDwhY1kCdc6EkAHbT7PJMQ: folds
boixc27eqTYA1p0tUdMuBQ leaves the table
Ogn4JDV3mp4ZDKO49IFzKA: folds
x80+i7DJL+81v3quj7KbNg: folds
negfosHnGOZXSHpWDRKyBQ: folds
kEr5NYB+JIG5+szcYMr6hA: calls $1
mBRWbnUl8diyBO1qTJaNzw: folds
uMPEfCcGCfsxmy53tVUMug: checks
*** FLOP *** [Ad 2s Kd]
uMPEfCcGCfsxmy53tVUMug: checks
PSFxpXgPedVZyHSu2Zhb7Q: bets $2
kEr5NYB+JIG5+szcYMr6hA: folds
mae7OMTaJ/MFimNbZegCkg joins the table at seat #7
uMPEfCcGCfsxmy53tVUMug: calls $2
*** TURN *** [Ad 2s Kd] [7d]
uMPEfCcGCfsxmy53tVUMug: checks
PSFxpXgPedVZyHSu2Zhb7Q: bets $4
uMPEfCcGCfsxmy53tVUMug: folds
PSFxpXgPedVZyHSu2Zhb7Q collected $7.15 from pot
*** SUMMARY ***
Total pot $7.50 | Rake $0.35
Board [Ad 2s Kd 7d]
Seat 1: Ogn4JDV3mp4ZDKO49IFzKA folded before Flop (didn't bet)
Seat 2: x80+i7DJL+81v3quj7KbNg folded before Flop (didn't bet)
Seat 3: negfosHnGOZXSHpWDRKyBQ folded before Flop (didn't bet)
Seat 4: kEr5NYB+JIG5+szcYMr6hA (button) folded on the Flop
Seat 5: mBRWbnUl8diyBO1qTJaNzw (small blind) folded before Flop
Seat 6: uMPEfCcGCfsxmy53tVUMug (big blind) folded on the Turn
Seat 7: boixc27eqTYA1p0tUdMuBQ folded before Flop (didn't bet)
Seat 8: PSFxpXgPedVZyHSu2Zhb7Q collected ($7.15)
Seat 9: jDwhY1kCdc6EkAHbT7PJMQ folded before Flop (didn't bet)



PokerStars Game #59939573282:  Hold'em No Limit ($0.50/$1.00) - 2009/07/01 0:43:21 ET
Table 'LmXQK9xy3awB+qsPzI21Mw' 2-max Seat #1 is the button
Seat 1: NYi6JFscYNrofSXy4sM+Yw ($243.10 in chips)
Seat 2: TME8GvochpQAo8cmJwWmvA ($92.65 in chips)
NYi6JFscYNrofSXy4sM+Yw: posts small blind $0.50
TME8GvochpQAo8cmJwWmvA: posts big blind $1
*** HOLE CARDS ***
NYi6JFscYNrofSXy4sM+Yw: raises $1 to $2
TME8GvochpQAo8cmJwWmvA: calls $1
*** FLOP *** [9c 6c 3h]
TME8GvochpQAo8cmJwWmvA: checks
NYi6JFscYNrofSXy4sM+Yw: bets $2
TME8GvochpQAo8cmJwWmvA: folds
NYi6JFscYNrofSXy4sM+Yw collected $3.80 from pot
*** SUMMARY ***
Total pot $4 | Rake $0.20
Board [9c 6c 3h]
Seat 1: NYi6JFscYNrofSXy4sM+Yw (button) (small blind) collected ($3.80)
Seat 2: TME8GvochpQAo8cmJwWmvA (big blind) folded on the Flop



PokerStars Game #59939573900:  Hold'em No Limit ($0.50/$1.00) - 2009/07/01 0:43:22 ET
Table 'pHrhryH8jPNdQfY62f8v+g' 6-max Seat #6 is the button
Seat 1: fF4botNMr8/ieVPO1YYRLw ($59.50 in chips)
Seat 2: RqgF7gRoKgRNW8Zoi1ty4A ($127.15 in chips)
Seat 4: wenbG7TaM3H7h5kn78OFNw ($45.80 in chips)
Seat 5: r1/R7y0Ortgoz4lccgW8VA ($33.15 in chips)
Seat 6: xAU6q2/cwmby2sxmA8VcmA ($113.75 in chips)
fF4botNMr8/ieVPO1YYRLw: posts small blind $0.50
RqgF7gRoKgRNW8Zoi1ty4A: posts big blind $1
*** HOLE CARDS ***
wenbG7TaM3H7h5kn78OFNw: folds
r1/R7y0Ortgoz4lccgW8VA: folds
xAU6q2/cwmby2sxmA8VcmA: raises $3 to $4
fF4botNMr8/ieVPO1YYRLw: folds
RqgF7gRoKgRNW8Zoi1ty4A: folds
xAU6q2/cwmby2sxmA8VcmA collected $2.50 from pot
*** SUMMARY ***
Total pot $2.50 | Rake $0
Seat 1: fF4botNMr8/ieVPO1YYRLw (small blind) folded before Flop
Seat 2: RqgF7gRoKgRNW8Zoi1ty4A (big blind) folded before Flop
Seat 4: wenbG7TaM3H7h5kn78OFNw folded before Flop (didn't bet)
Seat 5: r1/R7y0Ortgoz4lccgW8VA folded before Flop (didn't bet)
Seat 6: xAU6q2/cwmby2sxmA8VcmA (button) collected ($2.50)



PokerStars Game #59939573870:  Hold'em No Limit ($0.50/$1.00) - 2009/07/01 0:43:22 ET
Table 'rmZfTK+oSebeUPJNbWhdAA' 6-max Seat #2 is the button
Seat 1: xAU6q2/cwmby2sxmA8VcmA ($100 in chips)
Seat 2: z7O9PO/WEcqRouIydFhS9Q ($91 in chips)
Seat 3: 9yjOzGERLaEZS8CZ6YNHFg ($116.35 in chips)
Seat 5: 5lY8d6Cnm4HUkt/8FZSj4g ($100 in chips)
Seat 6: j7NIOHLZk7V2o9fOioO5ug ($134 in chips)
9yjOzGERLaEZS8CZ6YNHFg: posts small blind $0.50
OGMLOcTNYZXZU81au7ztUw: is sitting out
5lY8d6Cnm4HUkt/8FZSj4g: posts big blind $1
*** HOLE CARDS ***
j7NIOHLZk7V2o9fOioO5ug: folds
OGMLOcTNYZXZU81au7ztUw leaves the table
xAU6q2/cwmby2sxmA8VcmA: folds
z7O9PO/WEcqRouIydFhS9Q: raises $2 to $3
9yjOzGERLaEZS8CZ6YNHFg: folds
5lY8d6Cnm4HUkt/8FZSj4g: folds
z7O9PO/WEcqRouIydFhS9Q collected $2.50 from pot
*** SUMMARY ***
Total pot $2.50 | Rake $0
Seat 1: xAU6q2/cwmby2sxmA8VcmA folded before Flop (didn't bet)
Seat 2: z7O9PO/WEcqRouIydFhS9Q (button) collected ($2.50)
Seat 3: 9yjOzGERLaEZS8CZ6YNHFg (small blind) folded before Flop
Seat 5: 5lY8d6Cnm4HUkt/8FZSj4g (big blind) folded before Flop
Seat 6: j7NIOHLZk7V2o9fOioO5ug folded before Flop (didn't bet)



PokerStars Game #59939575138:  Hold'em No Limit ($0.50/$1.00) - 2009/07/01 0:43:24 ET
Table 'W/wyObTiXZm+Ckkl3YxcSw' 6-max Seat #5 is the button
Seat 1: eUBBn2R56C1IQ6Cs/vitwg ($100 in chips)
Seat 2: oDiBRCaF0QVtd3kO6xZIXw ($80.25 in chips)
Seat 3: ybGsYWp1MLwy1vSnP8egXg ($34 in chips)
Seat 4: +xW7QemQU0Fxs+4TnqBRow ($133.90 in chips)
Seat 5: BdbmJTZZ47quA9vUWwXtlw ($59 in chips)
eUBBn2R56C1IQ6Cs/vitwg: posts small blind $0.50
oDiBRCaF0QVtd3kO6xZIXw: posts big blind $1
*** HOLE CARDS ***
ybGsYWp1MLwy1vSnP8egXg: folds
+twYdIw+izmdFyX5TTFzjg joins the table at seat #6
+xW7QemQU0Fxs+4TnqBRow: folds
BdbmJTZZ47quA9vUWwXtlw: raises $2 to $3
eUBBn2R56C1IQ6Cs/vitwg: folds
oDiBRCaF0QVtd3kO6xZIXw: folds
BdbmJTZZ47quA9vUWwXtlw collected $2.50 from pot
*** SUMMARY ***
Total pot $2.50 | Rake $0
Seat 1: eUBBn2R56C1IQ6Cs/vitwg (small blind) folded before Flop
Seat 2: oDiBRCaF0QVtd3kO6xZIXw (big blind) folded before Flop
Seat 3: ybGsYWp1MLwy1vSnP8egXg folded before Flop (didn't bet)
Seat 4: +xW7QemQU0Fxs+4TnqBRow folded before Flop (didn't bet)
Seat 5: BdbmJTZZ47quA9vUWwXtlw (button) collected ($2.50)



PokerStars Game #59939575648:  Hold'em No Limit ($0.50/$1.00) - 2009/07/01 0:43:25 ET
Table 'FKpXUINE6M3UxHG4zaMhHA' 6-max Seat #5 is the button
Seat 2: nDKgwwXJ45hcJfJe01cdxQ ($38.75 in chips)
Seat 3: GOHDYcxP1gP29069kB9HFw ($126.10 in chips)
Seat 4: vw0eLNLy3Huccth4CUZNPQ ($71.80 in chips)
Seat 5: eUBBn2R56C1IQ6Cs/vitwg ($100 in chips)
nDKgwwXJ45hcJfJe01cdxQ: posts small blind $0.50
GOHDYcxP1gP29069kB9HFw: posts big blind $1
*** HOLE CARDS ***
vw0eLNLy3Huccth4CUZNPQ: folds
SFkeelhauled joins the table at seat #6
eUBBn2R56C1IQ6Cs/vitwg: folds
nDKgwwXJ45hcJfJe01cdxQ: raises $1 to $2
GOHDYcxP1gP29069kB9HFw: calls $1
*** FLOP *** [Jc Js 4c]
iHo1oDbrEVJ8nEGdaPrICw joins the table at seat #1
nDKgwwXJ45hcJfJe01cdxQ: bets $1
GOHDYcxP1gP29069kB9HFw: folds
GOHDYcxP1gP29069kB9HFw is sitting out
nDKgwwXJ45hcJfJe01cdxQ collected $3.80 from pot
nDKgwwXJ45hcJfJe01cdxQ: doesn't show hand
*** SUMMARY ***
Total pot $4 | Rake $0.20
Board [Jc Js 4c]
Seat 2: nDKgwwXJ45hcJfJe01cdxQ (small blind) collected ($3.80)
Seat 3: GOHDYcxP1gP29069kB9HFw (big blind) folded on the Flop
Seat 4: vw0eLNLy3Huccth4CUZNPQ folded before Flop (didn't bet)
Seat 5: eUBBn2R56C1IQ6Cs/vitwg (button) folded before Flop (didn't bet)



PokerStars Game #59939577076:  Hold'em No Limit ($0.50/$1.00) - 2009/07/01 0:43:27 ET
Table 'QBLDswtHe7Ml0HwAdcMhlw' 2-max Seat #1 is the button
Seat 1: hdNlhiCwI533uwvvTTfC9Q ($114.50 in chips)
Seat 2: GBkvjkjDWVBEa1e14dh6CA ($53.90 in chips)
hdNlhiCwI533uwvvTTfC9Q: posts small blind $0.50
GBkvjkjDWVBEa1e14dh6CA: posts big blind $1
*** HOLE CARDS ***
hdNlhiCwI533uwvvTTfC9Q: raises $2 to $3
GBkvjkjDWVBEa1e14dh6CA: raises $7 to $10
hdNlhiCwI533uwvvTTfC9Q: raises $104.50 to $114.50 and is all-in
GBkvjkjDWVBEa1e14dh6CA: folds
hdNlhiCwI533uwvvTTfC9Q collected $20 from pot
hdNlhiCwI533uwvvTTfC9Q: doesn't show hand
*** SUMMARY ***
Total pot $20 | Rake $0
Seat 1: hdNlhiCwI533uwvvTTfC9Q (button) (small blind) collected ($20)
Seat 2: GBkvjkjDWVBEa1e14dh6CA (big blind) folded before Flop



PokerStars Game #59939577250:  Hold'em No Limit ($0.50/$1.00) - 2009/07/01 0:43:27 ET
Table 'cBDNutyLBKEk9+ptwsKmTw' 6-max Seat #6 is the button
Seat 1: xAU6q2/cwmby2sxmA8VcmA ($100 in chips)
Seat 2: 5lY8d6Cnm4HUkt/8FZSj4g ($107.80 in chips)
Seat 3: G5ZSSN6RSON3gkNvk/SmYg ($108.40 in chips)
Seat 4: 3q7F5QtzC30pSrn0nl9i+A ($17.30 in chips)
Seat 5: OGMLOcTNYZXZU81au7ztUw ($137.60 in chips)
Seat 6: NqVlOSH2lp+pp/TK3vvK5g ($67.20 in chips)
xAU6q2/cwmby2sxmA8VcmA: posts small blind $0.50
5lY8d6Cnm4HUkt/8FZSj4g: posts big blind $1
*** HOLE CARDS ***
G5ZSSN6RSON3gkNvk/SmYg: folds
3q7F5QtzC30pSrn0nl9i+A: calls $1
OGMLOcTNYZXZU81au7ztUw: folds
NqVlOSH2lp+pp/TK3vvK5g: calls $1
xAU6q2/cwmby2sxmA8VcmA: calls $0.50
5lY8d6Cnm4HUkt/8FZSj4g: checks
*** FLOP *** [Qd 7h Ah]
xAU6q2/cwmby2sxmA8VcmA: checks
5lY8d6Cnm4HUkt/8FZSj4g: checks
3q7F5QtzC30pSrn0nl9i+A: bets $1
NqVlOSH2lp+pp/TK3vvK5g: calls $1
xAU6q2/cwmby2sxmA8VcmA: calls $1
5lY8d6Cnm4HUkt/8FZSj4g: calls $1
*** TURN *** [Qd 7h Ah] [Jh]
xAU6q2/cwmby2sxmA8VcmA: checks
5lY8d6Cnm4HUkt/8FZSj4g: checks
3q7F5QtzC30pSrn0nl9i+A: bets $15.30 and is all-in
NqVlOSH2lp+pp/TK3vvK5g: raises $15.30 to $30.60
xAU6q2/cwmby2sxmA8VcmA: folds
5lY8d6Cnm4HUkt/8FZSj4g: folds
*** RIVER *** [Qd 7h Ah Jh] [3d]
*** SHOW DOWN ***
3q7F5QtzC30pSrn0nl9i+A: shows [Qc Jd] (two pair, Queens and Jacks)
NqVlOSH2lp+pp/TK3vvK5g: mucks hand
3q7F5QtzC30pSrn0nl9i+A collected $36.70 from pot
*** SUMMARY ***
Total pot $38.60 | Rake $1.90
Board [Qd 7h Ah Jh 3d]
Seat 1: xAU6q2/cwmby2sxmA8VcmA (small blind) folded on the Turn
Seat 2: 5lY8d6Cnm4HUkt/8FZSj4g (big blind) folded on the Turn
Seat 3: G5ZSSN6RSON3gkNvk/SmYg folded before Flop (didn't bet)
Seat 4: 3q7F5QtzC30pSrn0nl9i+A showed [Qc Jd] and won ($36.70) with two pair, Queens and Jacks
Seat 5: OGMLOcTNYZXZU81au7ztUw folded before Flop (didn't bet)
Seat 6: NqVlOSH2lp+pp/TK3vvK5g (button) mucked



PokerStars Game #59939577208:  Hold'em No Limit ($0.50/$1.00) - 2009/07/01 0:43:27 ET
Table 'uNlePsyMIqzM691Xkrlk6Q' 9-max Seat #3 is the button
Seat 1: bLbSOSmSOnqE0iTcH/5dxA ($100 in chips)
Seat 2: +OqpStnt0FqbCfyHAWaLbg ($76.65 in chips)
Seat 3: h7qXkU57Bb8ZuPwMyxR8Ug ($30 in chips)
Seat 4: TZcz9MEWDA+WydgGruqqbw ($103.15 in chips)
Seat 5: 3obndzTJ6fECz8+wWhMd1w ($18.50 in chips)
Seat 6: uMPEfCcGCfsxmy53tVUMug ($110.60 in chips)
Seat 7: w6cw9nzN7AvkkHBVVjykoQ ($42.90 in chips)
Seat 9: vR4IO10geOgvTW+LAUBv/A ($102.25 in chips)
TZcz9MEWDA+WydgGruqqbw: posts small blind $0.50
3obndzTJ6fECz8+wWhMd1w: posts big blind $1
laA8va+Yv8WuMqT1zdR91g: sits out
*** HOLE CARDS ***
uMPEfCcGCfsxmy53tVUMug: folds
w6cw9nzN7AvkkHBVVjykoQ: folds
vR4IO10geOgvTW+LAUBv/A: folds
bLbSOSmSOnqE0iTcH/5dxA: folds
+OqpStnt0FqbCfyHAWaLbg: calls $1
h7qXkU57Bb8ZuPwMyxR8Ug: folds
TZcz9MEWDA+WydgGruqqbw: folds
3obndzTJ6fECz8+wWhMd1w: checks
*** FLOP *** [6c 3d As]
3obndzTJ6fECz8+wWhMd1w: checks
+OqpStnt0FqbCfyHAWaLbg: bets $3
3obndzTJ6fECz8+wWhMd1w: folds
+OqpStnt0FqbCfyHAWaLbg collected $2.40 from pot
*** SUMMARY ***
Total pot $2.50 | Rake $0.10
Board [6c 3d As]
Seat 1: bLbSOSmSOnqE0iTcH/5dxA folded before Flop (didn't bet)
Seat 2: +OqpStnt0FqbCfyHAWaLbg collected ($2.40)
Seat 3: h7qXkU57Bb8ZuPwMyxR8Ug (button) folded before Flop (didn't bet)
Seat 4: TZcz9MEWDA+WydgGruqqbw (small blind) folded before Flop
Seat 5: 3obndzTJ6fECz8+wWhMd1w (big blind) folded on the Flop
Seat 6: uMPEfCcGCfsxmy53tVUMug folded before Flop (didn't bet)
Seat 7: w6cw9nzN7AvkkHBVVjykoQ folded before Flop (didn't bet)
Seat 9: vR4IO10geOgvTW+LAUBv/A folded before Flop (didn't bet)



PokerStars Game #59939579904:  Hold'em No Limit ($0.50/$1.00) - 2009/07/01 0:43:31 ET
Table 'VOs36P6NW+QyXeQ1B62kmA' 6-max Seat #2 is the button
Seat 1: AdLVjddOzm+sRNo1Bc3S6Q ($139.30 in chips)
Seat 2: KpnW5CcJ4Mg6MeclfKmLrw ($117.85 in chips)
Seat 3: TSuRyAHnUPCFjP7Z0rEE0w ($100 in chips)
Seat 4: w02zQzNydODiyV9THKgo9w ($36.80 in chips)
Seat 5: X7GlkHF+lkbarCLuZ4Uf0w ($29.85 in chips)
Seat 6: 6tvjsJrdmWg+g7FVrMnzXA ($55.40 in chips)
TSuRyAHnUPCFjP7Z0rEE0w: posts small blind $0.50
w02zQzNydODiyV9THKgo9w: posts big blind $1
*** HOLE CARDS ***
X7GlkHF+lkbarCLuZ4Uf0w: folds
6tvjsJrdmWg+g7FVrMnzXA: folds
AdLVjddOzm+sRNo1Bc3S6Q: folds
KpnW5CcJ4Mg6MeclfKmLrw: folds
TSuRyAHnUPCFjP7Z0rEE0w: folds
w02zQzNydODiyV9THKgo9w collected $1 from pot
*** SUMMARY ***
Total pot $1 | Rake $0
Seat 1: AdLVjddOzm+sRNo1Bc3S6Q folded before Flop (didn't bet)
Seat 2: KpnW5CcJ4Mg6MeclfKmLrw (button) folded before Flop (didn't bet)
Seat 3: TSuRyAHnUPCFjP7Z0rEE0w (small blind) folded before Flop
Seat 4: w02zQzNydODiyV9THKgo9w (big blind) collected ($1)
Seat 5: X7GlkHF+lkbarCLuZ4Uf0w folded before Flop (didn't bet)
Seat 6: 6tvjsJrdmWg+g7FVrMnzXA folded before Flop (didn't bet)



PokerStars Game #59939579516:  Hold'em No Limit ($0.50/$1.00) - 2009/07/01 0:43:31 ET
Table 'tJq9SfN1ywY0r03VBlWlwQ' 9-max Seat #4 is the button
Seat 1: wZsU+w9r7G66x93UuvBf1Q ($334.30 in chips)
Seat 2: RqkO8O/Y3qlc3PIuCAHjVg ($69.40 in chips)
Seat 3: FVs16t7GgfWgQWt4JxsObQ ($40.55 in chips)
Seat 4: bLbSOSmSOnqE0iTcH/5dxA ($102.30 in chips)
Seat 5: Ogn4JDV3mp4ZDKO49IFzKA ($20.40 in chips)
Seat 6: gUUvmqdVlmvpal6B8nYrmg ($127.55 in chips)
Seat 7: qVhRZ0PLZ95XRJHWAjXjOQ ($129.70 in chips)
Seat 8: G4DEhsZFmznGNVpy2SEocA ($20.50 in chips)
Seat 9: XE5QF1y74bpHog9JxWJMWQ ($104.20 in chips)
Ogn4JDV3mp4ZDKO49IFzKA: posts small blind $0.50
gUUvmqdVlmvpal6B8nYrmg: posts big blind $1
*** HOLE CARDS ***
qVhRZ0PLZ95XRJHWAjXjOQ: folds
G4DEhsZFmznGNVpy2SEocA: folds
XE5QF1y74bpHog9JxWJMWQ: folds
wZsU+w9r7G66x93UuvBf1Q: folds
RqkO8O/Y3qlc3PIuCAHjVg: calls $1
FVs16t7GgfWgQWt4JxsObQ: folds
bLbSOSmSOnqE0iTcH/5dxA: raises $4 to $5
Ogn4JDV3mp4ZDKO49IFzKA: folds
gUUvmqdVlmvpal6B8nYrmg: folds
RqkO8O/Y3qlc3PIuCAHjVg: folds
bLbSOSmSOnqE0iTcH/5dxA collected $3.50 from pot
bLbSOSmSOnqE0iTcH/5dxA: doesn't show hand
*** SUMMARY ***
Total pot $3.50 | Rake $0
Seat 1: wZsU+w9r7G66x93UuvBf1Q folded before Flop (didn't bet)
Seat 2: RqkO8O/Y3qlc3PIuCAHjVg folded before Flop
Seat 3: FVs16t7GgfWgQWt4JxsObQ folded before Flop (didn't bet)
Seat 4: bLbSOSmSOnqE0iTcH/5dxA (button) collected ($3.50)
Seat 5: Ogn4JDV3mp4ZDKO49IFzKA (small blind) folded before Flop
Seat 6: gUUvmqdVlmvpal6B8nYrmg (big blind) folded before Flop
Seat 7: qVhRZ0PLZ95XRJHWAjXjOQ folded before Flop (didn't bet)
Seat 8: G4DEhsZFmznGNVpy2SEocA folded before Flop (didn't bet)
Seat 9: XE5QF1y74bpHog9JxWJMWQ folded before Flop (didn't bet)



PokerStars Game #59939580544:  Hold'em No Limit ($0.50/$1.00) - 2009/07/01 0:43:32 ET
Table 'LmXQK9xy3awB+qsPzI21Mw' 2-max Seat #2 is the button
Seat 1: NYi6JFscYNrofSXy4sM+Yw ($244.90 in chips)
Seat 2: TME8GvochpQAo8cmJwWmvA ($90.65 in chips)
TME8GvochpQAo8cmJwWmvA: posts small blind $0.50
NYi6JFscYNrofSXy4sM+Yw: posts big blind $1
*** HOLE CARDS ***
TME8GvochpQAo8cmJwWmvA: calls $0.50
NYi6JFscYNrofSXy4sM+Yw: checks
*** FLOP *** [Qh 3d 5d]
NYi6JFscYNrofSXy4sM+Yw: bets $1.50
TME8GvochpQAo8cmJwWmvA: folds
NYi6JFscYNrofSXy4sM+Yw collected $1.90 from pot
NYi6JFscYNrofSXy4sM+Yw: doesn't show hand
*** SUMMARY ***
Total pot $2 | Rake $0.10
Board [Qh 3d 5d]
Seat 1: NYi6JFscYNrofSXy4sM+Yw (big blind) collected ($1.90)
Seat 2: TME8GvochpQAo8cmJwWmvA (button) (small blind) folded on the Flop



PokerStars Game #59939580324:  Hold'em No Limit ($0.50/$1.00) - 2009/07/01 0:43:32 ET
Table 'vs/5jr6ciwjVQ5+Soc+u2A' 6-max Seat #4 is the button
Seat 1: 1C0rFAGdnnX4GWK9B0YPww ($13.50 in chips)
Seat 2: XOIf9W+VAxhZqN+SYoyMKA ($126.15 in chips)
Seat 3: G5ZSSN6RSON3gkNvk/SmYg ($150.50 in chips)
Seat 4: KpnW5CcJ4Mg6MeclfKmLrw ($102.80 in chips)
Seat 5: imUnjybOc/YBYCgM7m/qSA ($32.75 in chips)
imUnjybOc/YBYCgM7m/qSA: posts small blind $0.50
QHvTZcrKe6+maWUfVjP29Q: is sitting out
1C0rFAGdnnX4GWK9B0YPww: posts big blind $1
*** HOLE CARDS ***
XOIf9W+VAxhZqN+SYoyMKA: folds
G5ZSSN6RSON3gkNvk/SmYg: folds
KpnW5CcJ4Mg6MeclfKmLrw: folds
imUnjybOc/YBYCgM7m/qSA: calls $0.50
1C0rFAGdnnX4GWK9B0YPww: checks
*** FLOP *** [6s 5d 6c]
QHvTZcrKe6+maWUfVjP29Q leaves the table
imUnjybOc/YBYCgM7m/qSA: bets $3
1C0rFAGdnnX4GWK9B0YPww: calls $3
*** TURN *** [6s 5d 6c] [Qh]
imUnjybOc/YBYCgM7m/qSA: bets $3
1C0rFAGdnnX4GWK9B0YPww: calls $3
*** RIVER *** [6s 5d 6c Qh] [Qc]
imUnjybOc/YBYCgM7m/qSA: bets $6
1C0rFAGdnnX4GWK9B0YPww: raises $0.50 to $6.50 and is all-in
imUnjybOc/YBYCgM7m/qSA: calls $0.50
*** SHOW DOWN ***
1C0rFAGdnnX4GWK9B0YPww: shows [6h 7h] (a full house, Sixes full of Queens)
imUnjybOc/YBYCgM7m/qSA: shows [2d Td] (two pair, Queens and Sixes)
1C0rFAGdnnX4GWK9B0YPww collected $25.70 from pot
*** SUMMARY ***
Total pot $27 | Rake $1.30
Board [6s 5d 6c Qh Qc]
Seat 1: 1C0rFAGdnnX4GWK9B0YPww (big blind) showed [6h 7h] and won ($25.70) with a full house, Sixes full of Queens
Seat 2: XOIf9W+VAxhZqN+SYoyMKA folded before Flop (didn't bet)
Seat 3: G5ZSSN6RSON3gkNvk/SmYg folded before Flop (didn't bet)
Seat 4: KpnW5CcJ4Mg6MeclfKmLrw (button) folded before Flop (didn't bet)
Seat 5: imUnjybOc/YBYCgM7m/qSA (small blind) showed [2d Td] and lost with two pair, Queens and Sixes



PokerStars Game #59939580978:  Hold'em No Limit ($0.50/$1.00) - 2009/07/01 0:43:33 ET
Table 'eU3bWpDDg3Z+9R4m4iVmog' 6-max Seat #1 is the button
Seat 1: TSuRyAHnUPCFjP7Z0rEE0w ($191.15 in chips)
Seat 2: 8CAoOzhmB8n3nRFf3V4BTg ($98.30 in chips)
Seat 3: U6tnjwZRpTnM+YkqkCjwyQ ($191.15 in chips)
Seat 4: GDVIsbEJ/DOJsMKE4Asz0A ($73.10 in chips)
Seat 5: AdLVjddOzm+sRNo1Bc3S6Q ($102.50 in chips)
Seat 6: hpxXcmRkXXI9HE5+5/j/0Q ($121.95 in chips)
8CAoOzhmB8n3nRFf3V4BTg: posts small blind $0.50
U6tnjwZRpTnM+YkqkCjwyQ: posts big blind $1
*** HOLE CARDS ***
GDVIsbEJ/DOJsMKE4Asz0A: raises $2 to $3
AdLVjddOzm+sRNo1Bc3S6Q: folds
hpxXcmRkXXI9HE5+5/j/0Q: folds
TSuRyAHnUPCFjP7Z0rEE0w: folds
8CAoOzhmB8n3nRFf3V4BTg: folds
U6tnjwZRpTnM+YkqkCjwyQ: folds
GDVIsbEJ/DOJsMKE4Asz0A collected $2.50 from pot
*** SUMMARY ***
Total pot $2.50 | Rake $0
Seat 1: TSuRyAHnUPCFjP7Z0rEE0w (button) folded before Flop (didn't bet)
Seat 2: 8CAoOzhmB8n3nRFf3V4BTg (small blind) folded before Flop
Seat 3: U6tnjwZRpTnM+YkqkCjwyQ (big blind) folded before Flop
Seat 4: GDVIsbEJ/DOJsMKE4Asz0A collected ($2.50)
Seat 5: AdLVjddOzm+sRNo1Bc3S6Q folded before Flop (didn't bet)
Seat 6: hpxXcmRkXXI9HE5+5/j/0Q folded before Flop (didn't bet)



PokerStars Game #59939580954:  Hold'em No Limit ($0.50/$1.00) - 2009/07/01 0:43:33 ET
Table 'Zka9tv1yilg0MvXWPQrShg' 9-max Seat #1 is the button
Seat 1: TZcz9MEWDA+WydgGruqqbw ($113.85 in chips)
Seat 3: gUUvmqdVlmvpal6B8nYrmg ($100 in chips)
Seat 5: /zy+DB4S5fUQUSfZWFzYGw ($132.40 in chips)
Seat 6: rY8wPoax1lS+HUY+I0FZDw ($147.80 in chips)
Seat 7: p1SafS90nb3Uft5LB0NkHw ($20 in chips)
Seat 8: bL+QVeDcuEdzMGAGg2XJHg ($117.60 in chips)
Seat 9: 6daxhj43mWj04MOPTOmaYA ($91.50 in chips)
kz9ziSiGUc+857heiKSayw will be allowed to play after the button
gUUvmqdVlmvpal6B8nYrmg: posts small blind $0.50
/zy+DB4S5fUQUSfZWFzYGw: posts big blind $1
*** HOLE CARDS ***
rY8wPoax1lS+HUY+I0FZDw: calls $1
p1SafS90nb3Uft5LB0NkHw: folds
stxmTgSicxShtrDxhOOX2g joins the table at seat #4
bL+QVeDcuEdzMGAGg2XJHg: folds
6daxhj43mWj04MOPTOmaYA: raises $2 to $3
TZcz9MEWDA+WydgGruqqbw: folds
gUUvmqdVlmvpal6B8nYrmg: folds
/zy+DB4S5fUQUSfZWFzYGw: folds
rY8wPoax1lS+HUY+I0FZDw: calls $2
*** FLOP *** [4d 3h 2d]
rY8wPoax1lS+HUY+I0FZDw: checks
6daxhj43mWj04MOPTOmaYA: checks
*** TURN *** [4d 3h 2d] [6h]
rY8wPoax1lS+HUY+I0FZDw: checks
6daxhj43mWj04MOPTOmaYA: bets $5
rY8wPoax1lS+HUY+I0FZDw: folds
6daxhj43mWj04MOPTOmaYA collected $7.15 from pot
*** SUMMARY ***
Total pot $7.50 | Rake $0.35
Board [4d 3h 2d 6h]
Seat 1: TZcz9MEWDA+WydgGruqqbw (button) folded before Flop (didn't bet)
Seat 3: gUUvmqdVlmvpal6B8nYrmg (small blind) folded before Flop
Seat 5: /zy+DB4S5fUQUSfZWFzYGw (big blind) folded before Flop
Seat 6: rY8wPoax1lS+HUY+I0FZDw folded on the Turn
Seat 7: p1SafS90nb3Uft5LB0NkHw folded before Flop (didn't bet)
Seat 8: bL+QVeDcuEdzMGAGg2XJHg folded before Flop (didn't bet)
Seat 9: 6daxhj43mWj04MOPTOmaYA collected ($7.15)



PokerStars Game #59939581840:  Hold'em No Limit ($0.50/$1.00) - 2009/07/01 0:43:34 ET
Table 'U9zqzC8f3oTJ2ShXFgSSOA' 6-max Seat #5 is the button
Seat 1: +xW7QemQU0Fxs+4TnqBRow ($100 in chips)
Seat 2: U2CWBTv29qdCbj8RNF2sIw ($97 in chips)
Seat 3: yfXek8iJ7O4CFyqXrtGcfg ($10.55 in chips)
Seat 4: 33q95we0Etwgrm6guQGncw ($88.60 in chips)
Seat 5: KfwW5us6tydK81NYTtK1gw ($291.25 in chips)
Seat 6: aIxzFKdtpDSkUePKZy/niQ ($31.90 in chips)
aIxzFKdtpDSkUePKZy/niQ: posts small blind $0.50
+xW7QemQU0Fxs+4TnqBRow: posts big blind $1
*** HOLE CARDS ***
U2CWBTv29qdCbj8RNF2sIw: folds
U2CWBTv29qdCbj8RNF2sIw is sitting out
U2CWBTv29qdCbj8RNF2sIw leaves the table
yfXek8iJ7O4CFyqXrtGcfg: folds
33q95we0Etwgrm6guQGncw: folds
KfwW5us6tydK81NYTtK1gw: folds
aIxzFKdtpDSkUePKZy/niQ: calls $0.50
+xW7QemQU0Fxs+4TnqBRow: checks
*** FLOP *** [9s 5s 7h]
aIxzFKdtpDSkUePKZy/niQ: checks
+xW7QemQU0Fxs+4TnqBRow: checks
*** TURN *** [9s 5s 7h] [4c]
aIxzFKdtpDSkUePKZy/niQ: checks
+xW7QemQU0Fxs+4TnqBRow: checks
*** RIVER *** [9s 5s 7h 4c] [3c]
aIxzFKdtpDSkUePKZy/niQ: checks
+xW7QemQU0Fxs+4TnqBRow: checks
*** SHOW DOWN ***
aIxzFKdtpDSkUePKZy/niQ: shows [8d 5h] (a pair of Fives)
+xW7QemQU0Fxs+4TnqBRow: mucks hand
aIxzFKdtpDSkUePKZy/niQ collected $1.90 from pot
*** SUMMARY ***
Total pot $2 | Rake $0.10
Board [9s 5s 7h 4c 3c]
Seat 1: +xW7QemQU0Fxs+4TnqBRow (big blind) mucked
Seat 2: U2CWBTv29qdCbj8RNF2sIw folded before Flop (didn't bet)
Seat 3: yfXek8iJ7O4CFyqXrtGcfg folded before Flop (didn't bet)
Seat 4: 33q95we0Etwgrm6guQGncw folded before Flop (didn't bet)
Seat 5: KfwW5us6tydK81NYTtK1gw (button) folded before Flop (didn't bet)
Seat 6: aIxzFKdtpDSkUePKZy/niQ (small blind) showed [8d 5h] and won ($1.90) with a pair of Fives



PokerStars Game #59939583284:  Hold'em No Limit ($0.50/$1.00) - 2009/07/01 0:43:37 ET
Table 'N2bNCDHL96aCQDvZIh+yQQ' 6-max Seat #5 is the button
Seat 1: iHo1oDbrEVJ8nEGdaPrICw ($101.50 in chips)
Seat 2: KpnW5CcJ4Mg6MeclfKmLrw ($118.10 in chips)
Seat 3: Qy/UBNbD2HaA0Ogxg8Sf3w ($199.70 in chips)
Seat 4: uCqEjnxh2/vFBjKYkfTOkw ($168.90 in chips)
Seat 5: rHlMOfR7kpQQxe+PFQz0xQ ($29.25 in chips)
Seat 6: TSuRyAHnUPCFjP7Z0rEE0w ($100.50 in chips)
TSuRyAHnUPCFjP7Z0rEE0w: posts small blind $0.50
iHo1oDbrEVJ8nEGdaPrICw: posts big blind $1
*** HOLE CARDS ***
KpnW5CcJ4Mg6MeclfKmLrw: folds
Qy/UBNbD2HaA0Ogxg8Sf3w: raises $2.50 to $3.50
uCqEjnxh2/vFBjKYkfTOkw: folds
rHlMOfR7kpQQxe+PFQz0xQ: folds
TSuRyAHnUPCFjP7Z0rEE0w: folds
iHo1oDbrEVJ8nEGdaPrICw: folds
Qy/UBNbD2HaA0Ogxg8Sf3w collected $2.50 from pot
Qy/UBNbD2HaA0Ogxg8Sf3w: doesn't show hand
*** SUMMARY ***
Total pot $2.50 | Rake $0
Seat 1: iHo1oDbrEVJ8nEGdaPrICw (big blind) folded before Flop
Seat 2: KpnW5CcJ4Mg6MeclfKmLrw folded before Flop (didn't bet)
Seat 3: Qy/UBNbD2HaA0Ogxg8Sf3w collected ($2.50)
Seat 4: uCqEjnxh2/vFBjKYkfTOkw folded before Flop (didn't bet)
Seat 5: rHlMOfR7kpQQxe+PFQz0xQ (button) folded before Flop (didn't bet)
Seat 6: TSuRyAHnUPCFjP7Z0rEE0w (small blind) folded before Flop



PokerStars Game #59939585052:  Hold'em No Limit ($0.50/$1.00) - 2009/07/01 0:43:40 ET
Table '/RZcOwpZpHQ+OwPwjsbnRw' 6-max Seat #2 is the button
Seat 1: Zboa6dColKGHBjLPUakZjw ($50.20 in chips)
Seat 2: +xW7QemQU0Fxs+4TnqBRow ($193 in chips)
Seat 3: XnT1yK2DD/5FL+0bwuEhqg ($49.95 in chips)
Seat 4: j7NIOHLZk7V2o9fOioO5ug ($100 in chips)
Seat 5: wx3sQGkVi2x9wJXuWNHPBw ($195.15 in chips)
Seat 6: XOIf9W+VAxhZqN+SYoyMKA ($288.55 in chips)
XnT1yK2DD/5FL+0bwuEhqg: posts small blind $0.50
j7NIOHLZk7V2o9fOioO5ug: posts big blind $1
*** HOLE CARDS ***
wx3sQGkVi2x9wJXuWNHPBw: folds
XOIf9W+VAxhZqN+SYoyMKA: folds
Zboa6dColKGHBjLPUakZjw: folds
+xW7QemQU0Fxs+4TnqBRow: raises $2 to $3
XnT1yK2DD/5FL+0bwuEhqg: folds
j7NIOHLZk7V2o9fOioO5ug: folds
+xW7QemQU0Fxs+4TnqBRow collected $2.50 from pot
+xW7QemQU0Fxs+4TnqBRow: doesn't show hand
*** SUMMARY ***
Total pot $2.50 | Rake $0
Seat 1: Zboa6dColKGHBjLPUakZjw folded before Flop (didn't bet)
Seat 2: +xW7QemQU0Fxs+4TnqBRow (button) collected ($2.50)
Seat 3: XnT1yK2DD/5FL+0bwuEhqg (small blind) folded before Flop
Seat 4: j7NIOHLZk7V2o9fOioO5ug (big blind) folded before Flop
Seat 5: wx3sQGkVi2x9wJXuWNHPBw folded before Flop (didn't bet)
Seat 6: XOIf9W+VAxhZqN+SYoyMKA folded before Flop (didn't bet)



PokerStars Game #59939586370:  Hold'em No Limit ($0.50/$1.00) - 2009/07/01 0:43:42 ET
Table 'GxCPo/gd3OSthkYrAxJngg' 6-max Seat #6 is the button
Seat 1: sH8BpAFP+jGFxCgVpD1Lew ($255.95 in chips)
Seat 2: YExX2paeIHrmfIwV1ivM/w ($79.70 in chips)
Seat 3: o6plE+MSW4XFNTeONe16xg ($32.60 in chips)
Seat 4: YMJG+F++3Aj6P8dAWda5fw ($106.65 in chips)
Seat 5: G5ZSSN6RSON3gkNvk/SmYg ($109.75 in chips)
Seat 6: sS9IXedL3MiRmpVXhAILhw ($100.45 in chips)
sH8BpAFP+jGFxCgVpD1Lew: posts small blind $0.50
YExX2paeIHrmfIwV1ivM/w: posts big blind $1
*** HOLE CARDS ***
o6plE+MSW4XFNTeONe16xg: folds
YMJG+F++3Aj6P8dAWda5fw: folds
G5ZSSN6RSON3gkNvk/SmYg: folds
sS9IXedL3MiRmpVXhAILhw: raises $3 to $4
sH8BpAFP+jGFxCgVpD1Lew: folds
YExX2paeIHrmfIwV1ivM/w: folds
sS9IXedL3MiRmpVXhAILhw collected $2.50 from pot
*** SUMMARY ***
Total pot $2.50 | Rake $0
Seat 1: sH8BpAFP+jGFxCgVpD1Lew (small blind) folded before Flop
Seat 2: YExX2paeIHrmfIwV1ivM/w (big blind) folded before Flop
Seat 3: o6plE+MSW4XFNTeONe16xg folded before Flop (didn't bet)
Seat 4: YMJG+F++3Aj6P8dAWda5fw folded before Flop (didn't bet)
Seat 5: G5ZSSN6RSON3gkNvk/SmYg folded before Flop (didn't bet)
Seat 6: sS9IXedL3MiRmpVXhAILhw (button) collected ($2.50)



PokerStars Game #59939587378:  Hold'em No Limit ($0.50/$1.00) - 2009/07/01 0:43:43 ET
Table 'GPp0HyAuggN8oE0sUWzPpA' 9-max Seat #4 is the button
Seat 1: qJr25HAtvv1w/7IBvjMM3g ($20.35 in chips)
Seat 2: Ogn4JDV3mp4ZDKO49IFzKA ($34.20 in chips)
Seat 3: L9njYvloJ1NdXjP8edHEAg ($100 in chips)
Seat 4: mBRWbnUl8diyBO1qTJaNzw ($111.20 in chips)
Seat 5: 0fXz44fzDo5QmhAaJCvFfA ($19.80 in chips)
Seat 7: laA8va+Yv8WuMqT1zdR91g ($100 in chips)
Seat 8: tkdBeXTJlFsZdioidNqLow ($65.15 in chips)
0fXz44fzDo5QmhAaJCvFfA: posts small blind $0.50
negfosHnGOZXSHpWDRKyBQ: is sitting out
negfosHnGOZXSHpWDRKyBQ leaves the table
laA8va+Yv8WuMqT1zdR91g: posts big blind $1
VPF+HjszMvUIpy0CHIwH3A: sits out
*** HOLE CARDS ***
tkdBeXTJlFsZdioidNqLow: raises $2 to $3
qJr25HAtvv1w/7IBvjMM3g: folds
Ogn4JDV3mp4ZDKO49IFzKA: folds
L9njYvloJ1NdXjP8edHEAg: folds
mBRWbnUl8diyBO1qTJaNzw: calls $3
0fXz44fzDo5QmhAaJCvFfA: folds
laA8va+Yv8WuMqT1zdR91g: calls $2
*** FLOP *** [4s 3c 6d]
laA8va+Yv8WuMqT1zdR91g: checks
tkdBeXTJlFsZdioidNqLow: bets $7
mBRWbnUl8diyBO1qTJaNzw: folds
BK/GtNPkSx0TdUDj82id5A joins the table at seat #6
laA8va+Yv8WuMqT1zdR91g: folds
tkdBeXTJlFsZdioidNqLow collected $9.05 from pot
*** SUMMARY ***
Total pot $9.50 | Rake $0.45
Board [4s 3c 6d]
Seat 1: qJr25HAtvv1w/7IBvjMM3g folded before Flop (didn't bet)
Seat 2: Ogn4JDV3mp4ZDKO49IFzKA folded before Flop (didn't bet)
Seat 3: L9njYvloJ1NdXjP8edHEAg folded before Flop (didn't bet)
Seat 4: mBRWbnUl8diyBO1qTJaNzw (button) folded on the Flop
Seat 5: 0fXz44fzDo5QmhAaJCvFfA (small blind) folded before Flop
Seat 7: laA8va+Yv8WuMqT1zdR91g (big blind) folded on the Flop
Seat 8: tkdBeXTJlFsZdioidNqLow collected ($9.05)



PokerStars Game #59939587586:  Hold'em No Limit ($0.50/$1.00) - 2009/07/01 0:43:44 ET
Table 'W/wyObTiXZm+Ckkl3YxcSw' 6-max Seat #1 is the button
Seat 1: eUBBn2R56C1IQ6Cs/vitwg ($100 in chips)
Seat 2: oDiBRCaF0QVtd3kO6xZIXw ($79.25 in chips)
Seat 3: ybGsYWp1MLwy1vSnP8egXg ($34 in chips)
Seat 4: +xW7QemQU0Fxs+4TnqBRow ($133.90 in chips)
Seat 5: BdbmJTZZ47quA9vUWwXtlw ($60.50 in chips)
Seat 6: +twYdIw+izmdFyX5TTFzjg ($35 in chips)
oDiBRCaF0QVtd3kO6xZIXw: posts small blind $0.50
ybGsYWp1MLwy1vSnP8egXg: posts big blind $1
+twYdIw+izmdFyX5TTFzjg: posts big blind $1
*** HOLE CARDS ***
+xW7QemQU0Fxs+4TnqBRow: folds
BdbmJTZZ47quA9vUWwXtlw: calls $1
+twYdIw+izmdFyX5TTFzjg: checks
eUBBn2R56C1IQ6Cs/vitwg: raises $6 to $7
oDiBRCaF0QVtd3kO6xZIXw: folds
ybGsYWp1MLwy1vSnP8egXg: folds
BdbmJTZZ47quA9vUWwXtlw: calls $6
+twYdIw+izmdFyX5TTFzjg: folds
*** FLOP *** [7s 9s 6s]
+twYdIw+izmdFyX5TTFzjg leaves the table
BdbmJTZZ47quA9vUWwXtlw: checks
eUBBn2R56C1IQ6Cs/vitwg: checks
*** TURN *** [7s 9s 6s] [4s]
BdbmJTZZ47quA9vUWwXtlw: checks
eUBBn2R56C1IQ6Cs/vitwg: bets $10
BdbmJTZZ47quA9vUWwXtlw: folds
eUBBn2R56C1IQ6Cs/vitwg collected $15.70 from pot
*** SUMMARY ***
Total pot $16.50 | Rake $0.80
Board [7s 9s 6s 4s]
Seat 1: eUBBn2R56C1IQ6Cs/vitwg (button) collected ($15.70)
Seat 2: oDiBRCaF0QVtd3kO6xZIXw (small blind) folded before Flop
Seat 3: ybGsYWp1MLwy1vSnP8egXg (big blind) folded before Flop
Seat 4: +xW7QemQU0Fxs+4TnqBRow folded before Flop (didn't bet)
Seat 5: BdbmJTZZ47quA9vUWwXtlw folded on the Turn
Seat 6: +twYdIw+izmdFyX5TTFzjg folded before Flop



PokerStars Game #59939587610:  Hold'em No Limit ($0.50/$1.00) - 2009/07/01 0:43:44 ET
Table 'LmXQK9xy3awB+qsPzI21Mw' 2-max Seat #1 is the button
Seat 1: NYi6JFscYNrofSXy4sM+Yw ($245.80 in chips)
Seat 2: TME8GvochpQAo8cmJwWmvA ($89.65 in chips)
NYi6JFscYNrofSXy4sM+Yw: posts small blind $0.50
TME8GvochpQAo8cmJwWmvA: posts big blind $1
*** HOLE CARDS ***
NYi6JFscYNrofSXy4sM+Yw: raises $2 to $3
TME8GvochpQAo8cmJwWmvA: calls $2
*** FLOP *** [7c 8d 4s]
TME8GvochpQAo8cmJwWmvA: checks
NYi6JFscYNrofSXy4sM+Yw: bets $2
TME8GvochpQAo8cmJwWmvA: folds
NYi6JFscYNrofSXy4sM+Yw collected $5.70 from pot
*** SUMMARY ***
Total pot $6 | Rake $0.30
Board [7c 8d 4s]
Seat 1: NYi6JFscYNrofSXy4sM+Yw (button) (small blind) collected ($5.70)
Seat 2: TME8GvochpQAo8cmJwWmvA (big blind) folded on the Flop



PokerStars Game #59939588956:  Hold'em No Limit ($0.50/$1.00) - 2009/07/01 0:43:46 ET
Table 'pHrhryH8jPNdQfY62f8v+g' 6-max Seat #1 is the button
Seat 1: fF4botNMr8/ieVPO1YYRLw ($59 in chips)
Seat 2: RqgF7gRoKgRNW8Zoi1ty4A ($126.15 in chips)
Seat 4: wenbG7TaM3H7h5kn78OFNw ($45.80 in chips)
Seat 5: r1/R7y0Ortgoz4lccgW8VA ($33.15 in chips)
Seat 6: xAU6q2/cwmby2sxmA8VcmA ($115.25 in chips)
RqgF7gRoKgRNW8Zoi1ty4A: posts small blind $0.50
wenbG7TaM3H7h5kn78OFNw: posts big blind $1
*** HOLE CARDS ***
r1/R7y0Ortgoz4lccgW8VA: calls $1
xAU6q2/cwmby2sxmA8VcmA: folds
fF4botNMr8/ieVPO1YYRLw: calls $1
RqgF7gRoKgRNW8Zoi1ty4A: folds
wenbG7TaM3H7h5kn78OFNw: checks
*** FLOP *** [Ks Ah 7h]
wenbG7TaM3H7h5kn78OFNw: checks
r1/R7y0Ortgoz4lccgW8VA: bets $2
fF4botNMr8/ieVPO1YYRLw: calls $2
wenbG7TaM3H7h5kn78OFNw: raises $3 to $5
r1/R7y0Ortgoz4lccgW8VA: folds
fF4botNMr8/ieVPO1YYRLw: calls $3
*** TURN *** [Ks Ah 7h] [As]
wenbG7TaM3H7h5kn78OFNw: checks
fF4botNMr8/ieVPO1YYRLw: checks
*** RIVER *** [Ks Ah 7h As] [Qs]
wenbG7TaM3H7h5kn78OFNw: checks
fF4botNMr8/ieVPO1YYRLw: bets $9
wenbG7TaM3H7h5kn78OFNw: calls $9
*** SHOW DOWN ***
fF4botNMr8/ieVPO1YYRLw: shows [8h 9h] (a pair of Aces)
wenbG7TaM3H7h5kn78OFNw: shows [Kh 7d] (two pair, Aces and Kings)
wenbG7TaM3H7h5kn78OFNw collected $31.90 from pot
*** SUMMARY ***
Total pot $33.50 | Rake $1.60
Board [Ks Ah 7h As Qs]
Seat 1: fF4botNMr8/ieVPO1YYRLw (button) showed [8h 9h] and lost with a pair of Aces
Seat 2: RqgF7gRoKgRNW8Zoi1ty4A (small blind) folded before Flop
Seat 4: wenbG7TaM3H7h5kn78OFNw (big blind) showed [Kh 7d] and won ($31.90) with two pair, Aces and Kings
Seat 5: r1/R7y0Ortgoz4lccgW8VA folded on the Flop
Seat 6: xAU6q2/cwmby2sxmA8VcmA folded before Flop (didn't bet)



PokerStars Game #59939589766:  Hold'em No Limit ($0.50/$1.00) - 2009/07/01 0:43:47 ET
Table 'eU3bWpDDg3Z+9R4m4iVmog' 6-max Seat #2 is the button
Seat 1: TSuRyAHnUPCFjP7Z0rEE0w ($191.15 in chips)
Seat 2: 8CAoOzhmB8n3nRFf3V4BTg ($97.80 in chips)
Seat 3: U6tnjwZRpTnM+YkqkCjwyQ ($190.15 in chips)
Seat 4: GDVIsbEJ/DOJsMKE4Asz0A ($74.60 in chips)
Seat 5: AdLVjddOzm+sRNo1Bc3S6Q ($102.50 in chips)
Seat 6: hpxXcmRkXXI9HE5+5/j/0Q ($121.95 in chips)
U6tnjwZRpTnM+YkqkCjwyQ: posts small blind $0.50
GDVIsbEJ/DOJsMKE4Asz0A: posts big blind $1
*** HOLE CARDS ***
AdLVjddOzm+sRNo1Bc3S6Q: folds
hpxXcmRkXXI9HE5+5/j/0Q: folds
TSuRyAHnUPCFjP7Z0rEE0w: folds
8CAoOzhmB8n3nRFf3V4BTg: folds
U6tnjwZRpTnM+YkqkCjwyQ: folds
GDVIsbEJ/DOJsMKE4Asz0A collected $1 from pot
*** SUMMARY ***
Total pot $1 | Rake $0
Seat 1: TSuRyAHnUPCFjP7Z0rEE0w folded before Flop (didn't bet)
Seat 2: 8CAoOzhmB8n3nRFf3V4BTg (button) folded before Flop (didn't bet)
Seat 3: U6tnjwZRpTnM+YkqkCjwyQ (small blind) folded before Flop
Seat 4: GDVIsbEJ/DOJsMKE4Asz0A (big blind) collected ($1)
Seat 5: AdLVjddOzm+sRNo1Bc3S6Q folded before Flop (didn't bet)
Seat 6: hpxXcmRkXXI9HE5+5/j/0Q folded before Flop (didn't bet)



PokerStars Game #59939590528:  Hold'em No Limit ($0.50/$1.00) - 2009/07/01 0:43:48 ET
Table 'rmZfTK+oSebeUPJNbWhdAA' 6-max Seat #3 is the button
Seat 1: xAU6q2/cwmby2sxmA8VcmA ($100 in chips)
Seat 2: z7O9PO/WEcqRouIydFhS9Q ($92.50 in chips)
Seat 3: 9yjOzGERLaEZS8CZ6YNHFg ($115.85 in chips)
Seat 5: 5lY8d6Cnm4HUkt/8FZSj4g ($99 in chips)
Seat 6: j7NIOHLZk7V2o9fOioO5ug ($134 in chips)
5lY8d6Cnm4HUkt/8FZSj4g: posts small blind $0.50
j7NIOHLZk7V2o9fOioO5ug: posts big blind $1
*** HOLE CARDS ***
1/mIuXfgx1ZyVkodrmfQDw joins the table at seat #4
xAU6q2/cwmby2sxmA8VcmA: folds
z7O9PO/WEcqRouIydFhS9Q: raises $2 to $3
9yjOzGERLaEZS8CZ6YNHFg: folds
5lY8d6Cnm4HUkt/8FZSj4g: calls $2.50
j7NIOHLZk7V2o9fOioO5ug: folds
*** FLOP *** [Td 5d 6c]
5lY8d6Cnm4HUkt/8FZSj4g: checks
z7O9PO/WEcqRouIydFhS9Q: bets $5
5lY8d6Cnm4HUkt/8FZSj4g: calls $5
*** TURN *** [Td 5d 6c] [Kh]
5lY8d6Cnm4HUkt/8FZSj4g: checks
z7O9PO/WEcqRouIydFhS9Q: checks
*** RIVER *** [Td 5d 6c Kh] [Kc]
5lY8d6Cnm4HUkt/8FZSj4g: bets $13
z7O9PO/WEcqRouIydFhS9Q: calls $13
*** SHOW DOWN ***
5lY8d6Cnm4HUkt/8FZSj4g: shows [7s 4s] (a pair of Kings)
z7O9PO/WEcqRouIydFhS9Q: shows [Ac Th] (two pair, Kings and Tens)
z7O9PO/WEcqRouIydFhS9Q collected $41 from pot
*** SUMMARY ***
Total pot $43 | Rake $2
Board [Td 5d 6c Kh Kc]
Seat 1: xAU6q2/cwmby2sxmA8VcmA folded before Flop (didn't bet)
Seat 2: z7O9PO/WEcqRouIydFhS9Q showed [Ac Th] and won ($41) with two pair, Kings and Tens
Seat 3: 9yjOzGERLaEZS8CZ6YNHFg (button) folded before Flop (didn't bet)
Seat 5: 5lY8d6Cnm4HUkt/8FZSj4g (small blind) showed [7s 4s] and lost with a pair of Kings
Seat 6: j7NIOHLZk7V2o9fOioO5ug (big blind) folded before Flop



PokerStars Game #59939590560:  Hold'em No Limit ($0.50/$1.00) - 2009/07/01 0:43:48 ET
Table '7Nl0ffnjeK44/vmeexh3MQ' 9-max Seat #2 is the button
Seat 1: s7D3Y+k4Cj4D1cXHv7oj+Q ($87.30 in chips)
Seat 2: kiakSwxX0e64PwYGAPQvLw ($30.35 in chips)
Seat 3: vR4IO10geOgvTW+LAUBv/A ($102 in chips)
Seat 4: bLbSOSmSOnqE0iTcH/5dxA ($100 in chips)
Seat 5: bL+QVeDcuEdzMGAGg2XJHg ($99.50 in chips)
Seat 6: FVs16t7GgfWgQWt4JxsObQ ($33.30 in chips)
Seat 8: zanka7aAZkigmZpfopXxxA ($253.70 in chips)
Seat 9: ouwUBGRKnKK9uhn1G4Lf+A ($95 in chips)
vR4IO10geOgvTW+LAUBv/A: posts small blind $0.50
bLbSOSmSOnqE0iTcH/5dxA: posts big blind $1
997ViqAtWn1FPjJqcffwcA: sits out
*** HOLE CARDS ***
bL+QVeDcuEdzMGAGg2XJHg: folds
FVs16t7GgfWgQWt4JxsObQ: calls $1
zanka7aAZkigmZpfopXxxA: folds
ouwUBGRKnKK9uhn1G4Lf+A: folds
s7D3Y+k4Cj4D1cXHv7oj+Q: raises $3 to $4
kiakSwxX0e64PwYGAPQvLw: folds
vR4IO10geOgvTW+LAUBv/A: folds
bLbSOSmSOnqE0iTcH/5dxA: folds
FVs16t7GgfWgQWt4JxsObQ: calls $3
*** FLOP *** [Th Ts 9s]
FVs16t7GgfWgQWt4JxsObQ: checks
s7D3Y+k4Cj4D1cXHv7oj+Q: bets $4
FVs16t7GgfWgQWt4JxsObQ: folds
s7D3Y+k4Cj4D1cXHv7oj+Q collected $9.05 from pot
*** SUMMARY ***
Total pot $9.50 | Rake $0.45
Board [Th Ts 9s]
Seat 1: s7D3Y+k4Cj4D1cXHv7oj+Q collected ($9.05)
Seat 2: kiakSwxX0e64PwYGAPQvLw (button) folded before Flop (didn't bet)
Seat 3: vR4IO10geOgvTW+LAUBv/A (small blind) folded before Flop
Seat 4: bLbSOSmSOnqE0iTcH/5dxA (big blind) folded before Flop
Seat 5: bL+QVeDcuEdzMGAGg2XJHg folded before Flop (didn't bet)
Seat 6: FVs16t7GgfWgQWt4JxsObQ folded on the Flop
Seat 8: zanka7aAZkigmZpfopXxxA folded before Flop (didn't bet)
Seat 9: ouwUBGRKnKK9uhn1G4Lf+A folded before Flop (didn't bet)



PokerStars Game #59939591756:  Hold'em No Limit ($0.50/$1.00) - 2009/07/01 0:43:50 ET
Table 'VOs36P6NW+QyXeQ1B62kmA' 6-max Seat #3 is the button
Seat 1: AdLVjddOzm+sRNo1Bc3S6Q ($139.30 in chips)
Seat 2: KpnW5CcJ4Mg6MeclfKmLrw ($117.85 in chips)
Seat 3: TSuRyAHnUPCFjP7Z0rEE0w ($100 in chips)
Seat 4: w02zQzNydODiyV9THKgo9w ($37.30 in chips)
Seat 6: 6tvjsJrdmWg+g7FVrMnzXA ($55.40 in chips)
w02zQzNydODiyV9THKgo9w: posts small blind $0.50
X7GlkHF+lkbarCLuZ4Uf0w: is sitting out
6tvjsJrdmWg+g7FVrMnzXA: posts big blind $1
*** HOLE CARDS ***
X7GlkHF+lkbarCLuZ4Uf0w has returned
AdLVjddOzm+sRNo1Bc3S6Q: folds
X7GlkHF+lkbarCLuZ4Uf0w leaves the table
KpnW5CcJ4Mg6MeclfKmLrw: raises $2 to $3
TSuRyAHnUPCFjP7Z0rEE0w: folds
w02zQzNydODiyV9THKgo9w: folds
6tvjsJrdmWg+g7FVrMnzXA: folds
KpnW5CcJ4Mg6MeclfKmLrw collected $2.50 from pot
KpnW5CcJ4Mg6MeclfKmLrw: doesn't show hand
*** SUMMARY ***
Total pot $2.50 | Rake $0
Seat 1: AdLVjddOzm+sRNo1Bc3S6Q folded before Flop (didn't bet)
Seat 2: KpnW5CcJ4Mg6MeclfKmLrw collected ($2.50)
Seat 3: TSuRyAHnUPCFjP7Z0rEE0w (button) folded before Flop (didn't bet)
Seat 4: w02zQzNydODiyV9THKgo9w (small blind) folded before Flop
Seat 6: 6tvjsJrdmWg+g7FVrMnzXA (big blind) folded before Flop



PokerStars Game #59939594516:  Hold'em No Limit ($0.50/$1.00) - 2009/07/01 0:43:54 ET
Table 'fTlPiCj0utgzC/5io+I7ew' 6-max Seat #5 is the button
Seat 1: YMJG+F++3Aj6P8dAWda5fw ($98.50 in chips)
Seat 2: Qy/UBNbD2HaA0Ogxg8Sf3w ($105.95 in chips)
Seat 3: oDiBRCaF0QVtd3kO6xZIXw ($83.60 in chips)
Seat 4: uJVSceLggtsrJya+WtmUEA ($97.30 in chips)
Seat 5: bFrTkDcWGTxyvNul7GVdYg ($255.20 in chips)
YMJG+F++3Aj6P8dAWda5fw: posts small blind $0.50
Qy/UBNbD2HaA0Ogxg8Sf3w: posts big blind $1
*** HOLE CARDS ***
oDiBRCaF0QVtd3kO6xZIXw: folds
uJVSceLggtsrJya+WtmUEA: folds
bFrTkDcWGTxyvNul7GVdYg: raises $2 to $3
YMJG+F++3Aj6P8dAWda5fw: folds
Qy/UBNbD2HaA0Ogxg8Sf3w: raises $7.50 to $10.50
bFrTkDcWGTxyvNul7GVdYg: folds
Qy/UBNbD2HaA0Ogxg8Sf3w collected $6.50 from pot
*** SUMMARY ***
Total pot $6.50 | Rake $0
Seat 1: YMJG+F++3Aj6P8dAWda5fw (small blind) folded before Flop
Seat 2: Qy/UBNbD2HaA0Ogxg8Sf3w (big blind) collected ($6.50)
Seat 3: oDiBRCaF0QVtd3kO6xZIXw folded before Flop (didn't bet)
Seat 4: uJVSceLggtsrJya+WtmUEA folded before Flop (didn't bet)
Seat 5: bFrTkDcWGTxyvNul7GVdYg (button) folded before Flop



PokerStars Game #59939594624:  Hold'em No Limit ($0.50/$1.00) - 2009/07/01 0:43:54 ET
Table '+cA8mcmhaedZ7YcrDdhmeQ' 6-max Seat #1 is the button
Seat 1: lsLuWlcPA3Rh7kJVLzMh0Q ($306.70 in chips)
Seat 2: RqgF7gRoKgRNW8Zoi1ty4A ($100.50 in chips)
Seat 3: 7H5WkGzGvsv56y1iaqHvRg ($17.20 in chips)
Seat 4: LjL3AIERHn559yyW1mTUYQ ($173.30 in chips)
Seat 6: YfsTQsY/fxb+YqbdclTHuw ($54.55 in chips)
RqgF7gRoKgRNW8Zoi1ty4A: posts small blind $0.50
7H5WkGzGvsv56y1iaqHvRg: posts big blind $1
+7hFKAL0b0O/n8G72TclJA: sits out
*** HOLE CARDS ***
LjL3AIERHn559yyW1mTUYQ: folds
YfsTQsY/fxb+YqbdclTHuw: folds
lsLuWlcPA3Rh7kJVLzMh0Q: folds
RqgF7gRoKgRNW8Zoi1ty4A: raises $2 to $3
7H5WkGzGvsv56y1iaqHvRg: folds
RqgF7gRoKgRNW8Zoi1ty4A collected $2 from pot
RqgF7gRoKgRNW8Zoi1ty4A: doesn't show hand
*** SUMMARY ***
Total pot $2 | Rake $0
Seat 1: lsLuWlcPA3Rh7kJVLzMh0Q (button) folded before Flop (didn't bet)
Seat 2: RqgF7gRoKgRNW8Zoi1ty4A (small blind) collected ($2)
Seat 3: 7H5WkGzGvsv56y1iaqHvRg (big blind) folded before Flop
Seat 4: LjL3AIERHn559yyW1mTUYQ folded before Flop (didn't bet)
Seat 6: YfsTQsY/fxb+YqbdclTHuw folded before Flop (didn't bet)



PokerStars Game #59939594826:  Hold'em No Limit ($0.50/$1.00) - 2009/07/01 0:43:55 ET
Table '/RZcOwpZpHQ+OwPwjsbnRw' 6-max Seat #3 is the button
Seat 1: Zboa6dColKGHBjLPUakZjw ($50.20 in chips)
Seat 2: +xW7QemQU0Fxs+4TnqBRow ($194.50 in chips)
Seat 3: XnT1yK2DD/5FL+0bwuEhqg ($49.45 in chips)
Seat 4: j7NIOHLZk7V2o9fOioO5ug ($100 in chips)
Seat 5: wx3sQGkVi2x9wJXuWNHPBw ($195.15 in chips)
Seat 6: XOIf9W+VAxhZqN+SYoyMKA ($288.55 in chips)
j7NIOHLZk7V2o9fOioO5ug: posts small blind $0.50
wx3sQGkVi2x9wJXuWNHPBw: posts big blind $1
*** HOLE CARDS ***
XOIf9W+VAxhZqN+SYoyMKA: folds
Zboa6dColKGHBjLPUakZjw: folds
+xW7QemQU0Fxs+4TnqBRow: raises $3 to $4
XnT1yK2DD/5FL+0bwuEhqg: folds
j7NIOHLZk7V2o9fOioO5ug: folds
wx3sQGkVi2x9wJXuWNHPBw: folds
+xW7QemQU0Fxs+4TnqBRow collected $2.50 from pot
+xW7QemQU0Fxs+4TnqBRow: doesn't show hand
*** SUMMARY ***
Total pot $2.50 | Rake $0
Seat 1: Zboa6dColKGHBjLPUakZjw folded before Flop (didn't bet)
Seat 2: +xW7QemQU0Fxs+4TnqBRow collected ($2.50)
Seat 3: XnT1yK2DD/5FL+0bwuEhqg (button) folded before Flop (didn't bet)
Seat 4: j7NIOHLZk7V2o9fOioO5ug (small blind) folded before Flop
Seat 5: wx3sQGkVi2x9wJXuWNHPBw (big blind) folded before Flop
Seat 6: XOIf9W+VAxhZqN+SYoyMKA folded before Flop (didn't bet)



PokerStars Game #59939595164:  Hold'em No Limit ($0.50/$1.00) - 2009/07/01 0:43:55 ET
Table '7O9fB8yx1u7sJveJn8w6jA' 6-max Seat #3 is the button
Seat 1: jy52+7FotjH63o5tEEVgKw ($118.35 in chips)
Seat 2: wx3sQGkVi2x9wJXuWNHPBw ($194 in chips)
Seat 3: hpxXcmRkXXI9HE5+5/j/0Q ($100 in chips)
Seat 4: XIZSmlGttGgSRaIU42K4Fg ($102.75 in chips)
Seat 5: BCEV3COoKY607AzLWayfRA ($106.85 in chips)
Seat 6: UBZQqpnJZdTYYY1FTb0rLA ($129.35 in chips)
XIZSmlGttGgSRaIU42K4Fg: posts small blind $0.50
BCEV3COoKY607AzLWayfRA: posts big blind $1
*** HOLE CARDS ***
UBZQqpnJZdTYYY1FTb0rLA: folds
jy52+7FotjH63o5tEEVgKw: calls $1
wx3sQGkVi2x9wJXuWNHPBw: folds
hpxXcmRkXXI9HE5+5/j/0Q: folds
XIZSmlGttGgSRaIU42K4Fg: calls $0.50
BCEV3COoKY607AzLWayfRA: checks
*** FLOP *** [2d 4s 3c]
XIZSmlGttGgSRaIU42K4Fg: checks
BCEV3COoKY607AzLWayfRA: checks
jy52+7FotjH63o5tEEVgKw: bets $2
XIZSmlGttGgSRaIU42K4Fg: calls $2
BCEV3COoKY607AzLWayfRA: raises $7 to $9
jy52+7FotjH63o5tEEVgKw: calls $7
XIZSmlGttGgSRaIU42K4Fg: calls $7
*** TURN *** [2d 4s 3c] [9s]
XIZSmlGttGgSRaIU42K4Fg: checks
BCEV3COoKY607AzLWayfRA: bets $15
jy52+7FotjH63o5tEEVgKw: calls $15
XIZSmlGttGgSRaIU42K4Fg: calls $15
*** RIVER *** [2d 4s 3c 9s] [Tc]
XIZSmlGttGgSRaIU42K4Fg: checks
BCEV3COoKY607AzLWayfRA: checks
jy52+7FotjH63o5tEEVgKw: bets $16
XIZSmlGttGgSRaIU42K4Fg: folds
BCEV3COoKY607AzLWayfRA: folds
jy52+7FotjH63o5tEEVgKw collected $72 from pot
*** SUMMARY ***
Total pot $75 | Rake $3
Board [2d 4s 3c 9s Tc]
Seat 1: jy52+7FotjH63o5tEEVgKw collected ($72)
Seat 2: wx3sQGkVi2x9wJXuWNHPBw folded before Flop (didn't bet)
Seat 3: hpxXcmRkXXI9HE5+5/j/0Q (button) folded before Flop (didn't bet)
Seat 4: XIZSmlGttGgSRaIU42K4Fg (small blind) folded on the River
Seat 5: BCEV3COoKY607AzLWayfRA (big blind) folded on the River
Seat 6: UBZQqpnJZdTYYY1FTb0rLA folded before Flop (didn't bet)



PokerStars Game #59939594964:  Hold'em No Limit ($0.50/$1.00) - 2009/07/01 0:43:55 ET
Table 'hugOjcwJvzEwZbK7tyiWuQ' 9-max Seat #1 is the button
Seat 1: N9n5Wc3s35DpCrOAUUNAaQ ($130.50 in chips)
Seat 2: r27C1nIV4NS4+qbnrgBQSw ($254.55 in chips)
Seat 3: jDwhY1kCdc6EkAHbT7PJMQ ($107.65 in chips)
Seat 4: UWB3oeddt/GObx2Mix2Anw ($205.75 in chips)
Seat 5: 5BRGWf+R3nt2WS3b5xX+zA ($24.80 in chips)
Seat 6: gUUvmqdVlmvpal6B8nYrmg ($107.70 in chips)
Seat 7: FL3MrLspcF23LYvC4ipBOA ($100 in chips)
Seat 8: /zy+DB4S5fUQUSfZWFzYGw ($101.25 in chips)
Seat 9: W8P9bUKCs43TO1xHm0dL6w ($89.15 in chips)
r27C1nIV4NS4+qbnrgBQSw: posts small blind $0.50
jDwhY1kCdc6EkAHbT7PJMQ: posts big blind $1
W8P9bUKCs43TO1xHm0dL6w: posts big blind $1
*** HOLE CARDS ***
UWB3oeddt/GObx2Mix2Anw: folds
5BRGWf+R3nt2WS3b5xX+zA: folds
gUUvmqdVlmvpal6B8nYrmg: folds
FL3MrLspcF23LYvC4ipBOA: folds
/zy+DB4S5fUQUSfZWFzYGw: folds
W8P9bUKCs43TO1xHm0dL6w: checks
N9n5Wc3s35DpCrOAUUNAaQ: raises $2.50 to $3.50
r27C1nIV4NS4+qbnrgBQSw: calls $3
jDwhY1kCdc6EkAHbT7PJMQ: folds
W8P9bUKCs43TO1xHm0dL6w: folds
*** FLOP *** [Jd Ah 3h]
r27C1nIV4NS4+qbnrgBQSw: checks
N9n5Wc3s35DpCrOAUUNAaQ: checks
*** TURN *** [Jd Ah 3h] [Ts]
r27C1nIV4NS4+qbnrgBQSw: checks
N9n5Wc3s35DpCrOAUUNAaQ: bets $7
r27C1nIV4NS4+qbnrgBQSw: calls $7
*** RIVER *** [Jd Ah 3h Ts] [Ac]
r27C1nIV4NS4+qbnrgBQSw: checks
N9n5Wc3s35DpCrOAUUNAaQ: bets $20
r27C1nIV4NS4+qbnrgBQSw: calls $20
*** SHOW DOWN ***
N9n5Wc3s35DpCrOAUUNAaQ: shows [Ks Qd] (a straight, Ten to Ace)
r27C1nIV4NS4+qbnrgBQSw: shows [Kh Qh] (a straight, Ten to Ace)
r27C1nIV4NS4+qbnrgBQSw collected $30 from pot
N9n5Wc3s35DpCrOAUUNAaQ collected $30 from pot
*** SUMMARY ***
Total pot $63 | Rake $3
Board [Jd Ah 3h Ts Ac]
Seat 1: N9n5Wc3s35DpCrOAUUNAaQ (button) showed [Ks Qd] and won ($30) with a straight, Ten to Ace
Seat 2: r27C1nIV4NS4+qbnrgBQSw (small blind) showed [Kh Qh] and won ($30) with a straight, Ten to Ace
Seat 3: jDwhY1kCdc6EkAHbT7PJMQ (big blind) folded before Flop
Seat 4: UWB3oeddt/GObx2Mix2Anw folded before Flop (didn't bet)
Seat 5: 5BRGWf+R3nt2WS3b5xX+zA folded before Flop (didn't bet)
Seat 6: gUUvmqdVlmvpal6B8nYrmg folded before Flop (didn't bet)
Seat 7: FL3MrLspcF23LYvC4ipBOA folded before Flop (didn't bet)
Seat 8: /zy+DB4S5fUQUSfZWFzYGw folded before Flop (didn't bet)
Seat 9: W8P9bUKCs43TO1xHm0dL6w folded before Flop



PokerStars Game #59939595532:  Hold'em No Limit ($0.50/$1.00) - 2009/07/01 0:43:56 ET
Table 'LmXQK9xy3awB+qsPzI21Mw' 2-max Seat #2 is the button
Seat 1: NYi6JFscYNrofSXy4sM+Yw ($248.50 in chips)
Seat 2: TME8GvochpQAo8cmJwWmvA ($86.65 in chips)
TME8GvochpQAo8cmJwWmvA: posts small blind $0.50
NYi6JFscYNrofSXy4sM+Yw: posts big blind $1
*** HOLE CARDS ***
TME8GvochpQAo8cmJwWmvA: raises $1 to $2
NYi6JFscYNrofSXy4sM+Yw: calls $1
*** FLOP *** [8h Qd Ah]
NYi6JFscYNrofSXy4sM+Yw: bets $2
TME8GvochpQAo8cmJwWmvA: calls $2
*** TURN *** [8h Qd Ah] [2c]
NYi6JFscYNrofSXy4sM+Yw: checks
TME8GvochpQAo8cmJwWmvA: bets $3
NYi6JFscYNrofSXy4sM+Yw: folds
TME8GvochpQAo8cmJwWmvA collected $7.65 from pot
TME8GvochpQAo8cmJwWmvA: doesn't show hand
*** SUMMARY ***
Total pot $8 | Rake $0.35
Board [8h Qd Ah 2c]
Seat 1: NYi6JFscYNrofSXy4sM+Yw (big blind) folded on the Turn
Seat 2: TME8GvochpQAo8cmJwWmvA (button) (small blind) collected ($7.65)



PokerStars Game #59939596596:  Hold'em No Limit ($0.50/$1.00) - 2009/07/01 0:43:57 ET
Table 'eU3bWpDDg3Z+9R4m4iVmog' 6-max Seat #3 is the button
Seat 1: TSuRyAHnUPCFjP7Z0rEE0w ($191.15 in chips)
Seat 2: 8CAoOzhmB8n3nRFf3V4BTg ($97.80 in chips)
Seat 3: U6tnjwZRpTnM+YkqkCjwyQ ($189.65 in chips)
Seat 4: GDVIsbEJ/DOJsMKE4Asz0A ($75.10 in chips)
Seat 5: AdLVjddOzm+sRNo1Bc3S6Q ($102.50 in chips)
Seat 6: hpxXcmRkXXI9HE5+5/j/0Q ($121.95 in chips)
GDVIsbEJ/DOJsMKE4Asz0A: posts small blind $0.50
AdLVjddOzm+sRNo1Bc3S6Q: posts big blind $1
*** HOLE CARDS ***
hpxXcmRkXXI9HE5+5/j/0Q: folds
TSuRyAHnUPCFjP7Z0rEE0w: folds
8CAoOzhmB8n3nRFf3V4BTg: folds
U6tnjwZRpTnM+YkqkCjwyQ: raises $2 to $3
GDVIsbEJ/DOJsMKE4Asz0A: folds
AdLVjddOzm+sRNo1Bc3S6Q: folds
U6tnjwZRpTnM+YkqkCjwyQ collected $2.50 from pot
*** SUMMARY ***
Total pot $2.50 | Rake $0
Seat 1: TSuRyAHnUPCFjP7Z0rEE0w folded before Flop (didn't bet)
Seat 2: 8CAoOzhmB8n3nRFf3V4BTg folded before Flop (didn't bet)
Seat 3: U6tnjwZRpTnM+YkqkCjwyQ (button) collected ($2.50)
Seat 4: GDVIsbEJ/DOJsMKE4Asz0A (small blind) folded before Flop
Seat 5: AdLVjddOzm+sRNo1Bc3S6Q (big blind) folded before Flop
Seat 6: hpxXcmRkXXI9HE5+5/j/0Q folded before Flop (didn't bet)



PokerStars Game #59939596232:  Hold'em No Limit ($0.50/$1.00) - 2009/07/01 0:43:57 ET
Table 'SQLOQoANiHscJ8AL7zffbw' 9-max Seat #8 is the button
Seat 1: jPTRd6SpCp4xqAy2XQiTOw ($130.60 in chips)
Seat 2: /zy+DB4S5fUQUSfZWFzYGw ($276.35 in chips)
Seat 3: 0eFnow7+D7veCYQ+CG9FFw ($79.90 in chips)
Seat 4: N9n5Wc3s35DpCrOAUUNAaQ ($93.75 in chips)
Seat 5: L9njYvloJ1NdXjP8edHEAg ($107.05 in chips)
Seat 6: p5UKaxVobvptF0ANhR/q1A ($174.50 in chips)
Seat 7: bJckevFOcg//s0qyMQI6sQ ($100 in chips)
Seat 8: Pp/KTcXkfZKKUHkjyaLTdg ($28.50 in chips)
Seat 9: qJr25HAtvv1w/7IBvjMM3g ($230.75 in chips)
qJr25HAtvv1w/7IBvjMM3g: posts small blind $0.50
jPTRd6SpCp4xqAy2XQiTOw: posts big blind $1
*** HOLE CARDS ***
/zy+DB4S5fUQUSfZWFzYGw: folds
0eFnow7+D7veCYQ+CG9FFw: raises $2 to $3
N9n5Wc3s35DpCrOAUUNAaQ: folds
L9njYvloJ1NdXjP8edHEAg: folds
p5UKaxVobvptF0ANhR/q1A: folds
bJckevFOcg//s0qyMQI6sQ: folds
Pp/KTcXkfZKKUHkjyaLTdg: folds
qJr25HAtvv1w/7IBvjMM3g: folds
jPTRd6SpCp4xqAy2XQiTOw: calls $2
*** FLOP *** [7s Kd 4s]
jPTRd6SpCp4xqAy2XQiTOw: bets $3
0eFnow7+D7veCYQ+CG9FFw: calls $3
*** TURN *** [7s Kd 4s] [Qc]
jPTRd6SpCp4xqAy2XQiTOw: checks
0eFnow7+D7veCYQ+CG9FFw: checks
*** RIVER *** [7s Kd 4s Qc] [9h]
jPTRd6SpCp4xqAy2XQiTOw: bets $10
0eFnow7+D7veCYQ+CG9FFw: calls $10
*** SHOW DOWN ***
jPTRd6SpCp4xqAy2XQiTOw: shows [2h 8h] (high card King)
0eFnow7+D7veCYQ+CG9FFw: shows [Ac Qh] (a pair of Queens)
0eFnow7+D7veCYQ+CG9FFw collected $30.95 from pot
*** SUMMARY ***
Total pot $32.50 | Rake $1.55
Board [7s Kd 4s Qc 9h]
Seat 1: jPTRd6SpCp4xqAy2XQiTOw (big blind) showed [2h 8h] and lost with high card King
Seat 2: /zy+DB4S5fUQUSfZWFzYGw folded before Flop (didn't bet)
Seat 3: 0eFnow7+D7veCYQ+CG9FFw showed [Ac Qh] and won ($30.95) with a pair of Queens
Seat 4: N9n5Wc3s35DpCrOAUUNAaQ folded before Flop (didn't bet)
Seat 5: L9njYvloJ1NdXjP8edHEAg folded before Flop (didn't bet)
Seat 6: p5UKaxVobvptF0ANhR/q1A folded before Flop (didn't bet)
Seat 7: bJckevFOcg//s0qyMQI6sQ folded before Flop (didn't bet)
Seat 8: Pp/KTcXkfZKKUHkjyaLTdg (button) folded before Flop (didn't bet)
Seat 9: qJr25HAtvv1w/7IBvjMM3g (small blind) folded before Flop



PokerStars Game #59939596414:  Hold'em No Limit ($0.50/$1.00) - 2009/07/01 0:43:57 ET
Table 'uNlePsyMIqzM691Xkrlk6Q' 9-max Seat #4 is the button
Seat 1: bLbSOSmSOnqE0iTcH/5dxA ($100 in chips)
Seat 2: +OqpStnt0FqbCfyHAWaLbg ($78.05 in chips)
Seat 3: h7qXkU57Bb8ZuPwMyxR8Ug ($30 in chips)
Seat 4: TZcz9MEWDA+WydgGruqqbw ($102.65 in chips)
Seat 5: 3obndzTJ6fECz8+wWhMd1w ($17.50 in chips)
Seat 6: uMPEfCcGCfsxmy53tVUMug ($110.60 in chips)
Seat 7: w6cw9nzN7AvkkHBVVjykoQ ($42.90 in chips)
Seat 9: vR4IO10geOgvTW+LAUBv/A ($102.25 in chips)
3obndzTJ6fECz8+wWhMd1w: posts small blind $0.50
uMPEfCcGCfsxmy53tVUMug: posts big blind $1
laA8va+Yv8WuMqT1zdR91g: sits out
*** HOLE CARDS ***
w6cw9nzN7AvkkHBVVjykoQ: folds
vR4IO10geOgvTW+LAUBv/A: folds
bLbSOSmSOnqE0iTcH/5dxA: folds
+OqpStnt0FqbCfyHAWaLbg: folds
h7qXkU57Bb8ZuPwMyxR8Ug: raises $3 to $4
TZcz9MEWDA+WydgGruqqbw: folds
3obndzTJ6fECz8+wWhMd1w: folds
uMPEfCcGCfsxmy53tVUMug: folds
h7qXkU57Bb8ZuPwMyxR8Ug collected $2.50 from pot
*** SUMMARY ***
Total pot $2.50 | Rake $0
Seat 1: bLbSOSmSOnqE0iTcH/5dxA folded before Flop (didn't bet)
Seat 2: +OqpStnt0FqbCfyHAWaLbg folded before Flop (didn't bet)
Seat 3: h7qXkU57Bb8ZuPwMyxR8Ug collected ($2.50)
Seat 4: TZcz9MEWDA+WydgGruqqbw (button) folded before Flop (didn't bet)
Seat 5: 3obndzTJ6fECz8+wWhMd1w (small blind) folded before Flop
Seat 6: uMPEfCcGCfsxmy53tVUMug (big blind) folded before Flop
Seat 7: w6cw9nzN7AvkkHBVVjykoQ folded before Flop (didn't bet)
Seat 9: vR4IO10geOgvTW+LAUBv/A folded before Flop (didn't bet)



PokerStars Game #59939598434:  Hold'em No Limit ($0.50/$1.00) - 2009/07/01 0:44:00 ET
Table 'N2bNCDHL96aCQDvZIh+yQQ' 6-max Seat #6 is the button
Seat 1: iHo1oDbrEVJ8nEGdaPrICw ($100.50 in chips)
Seat 2: KpnW5CcJ4Mg6MeclfKmLrw ($118.10 in chips)
Seat 3: Qy/UBNbD2HaA0Ogxg8Sf3w ($201.20 in chips)
Seat 4: uCqEjnxh2/vFBjKYkfTOkw ($168.90 in chips)
Seat 5: rHlMOfR7kpQQxe+PFQz0xQ ($29.25 in chips)
Seat 6: TSuRyAHnUPCFjP7Z0rEE0w ($100 in chips)
iHo1oDbrEVJ8nEGdaPrICw: posts small blind $0.50
KpnW5CcJ4Mg6MeclfKmLrw: posts big blind $1
*** HOLE CARDS ***
Qy/UBNbD2HaA0Ogxg8Sf3w: raises $3 to $4
uCqEjnxh2/vFBjKYkfTOkw: folds
rHlMOfR7kpQQxe+PFQz0xQ: folds
TSuRyAHnUPCFjP7Z0rEE0w: folds
iHo1oDbrEVJ8nEGdaPrICw: calls $3.50
KpnW5CcJ4Mg6MeclfKmLrw: raises $12 to $16
Qy/UBNbD2HaA0Ogxg8Sf3w: calls $12
iHo1oDbrEVJ8nEGdaPrICw: folds
*** FLOP *** [8h Js 5h]
KpnW5CcJ4Mg6MeclfKmLrw: checks
Qy/UBNbD2HaA0Ogxg8Sf3w: checks
*** TURN *** [8h Js 5h] [7d]
KpnW5CcJ4Mg6MeclfKmLrw: bets $24
Qy/UBNbD2HaA0Ogxg8Sf3w: calls $24
*** RIVER *** [8h Js 5h 7d] [As]
KpnW5CcJ4Mg6MeclfKmLrw: bets $78.10 and is all-in
Qy/UBNbD2HaA0Ogxg8Sf3w: folds
KpnW5CcJ4Mg6MeclfKmLrw collected $81 from pot
KpnW5CcJ4Mg6MeclfKmLrw: doesn't show hand
*** SUMMARY ***
Total pot $84 | Rake $3
Board [8h Js 5h 7d As]
Seat 1: iHo1oDbrEVJ8nEGdaPrICw (small blind) folded before Flop
Seat 2: KpnW5CcJ4Mg6MeclfKmLrw (big blind) collected ($81)
Seat 3: Qy/UBNbD2HaA0Ogxg8Sf3w folded on the River
Seat 4: uCqEjnxh2/vFBjKYkfTOkw folded before Flop (didn't bet)
Seat 5: rHlMOfR7kpQQxe+PFQz0xQ folded before Flop (didn't bet)
Seat 6: TSuRyAHnUPCFjP7Z0rEE0w (button) folded before Flop (didn't bet)



PokerStars Game #59939600534:  Hold'em No Limit ($0.50/$1.00) - 2009/07/01 0:44:04 ET
Table 'QBLDswtHe7Ml0HwAdcMhlw' 2-max Seat #2 is the button
Seat 1: hdNlhiCwI533uwvvTTfC9Q ($124.50 in chips)
Seat 2: GBkvjkjDWVBEa1e14dh6CA ($43.90 in chips)
GBkvjkjDWVBEa1e14dh6CA: posts small blind $0.50
hdNlhiCwI533uwvvTTfC9Q: posts big blind $1
*** HOLE CARDS ***
GBkvjkjDWVBEa1e14dh6CA: raises $2 to $3
hdNlhiCwI533uwvvTTfC9Q: folds
GBkvjkjDWVBEa1e14dh6CA collected $2 from pot
GBkvjkjDWVBEa1e14dh6CA: doesn't show hand
*** SUMMARY ***
Total pot $2 | Rake $0
Seat 1: hdNlhiCwI533uwvvTTfC9Q (big blind) folded before Flop
Seat 2: GBkvjkjDWVBEa1e14dh6CA (button) (small blind) collected ($2)



PokerStars Game #59939601190:  Hold'em No Limit ($0.50/$1.00) - 2009/07/01 0:44:05 ET
Table 'MUPc8FEpe/nR0BKSeReX6Q' 6-max Seat #3 is the button
Seat 1: YsLQ3BAvgQHWXMAv3Wv6Hg ($113.85 in chips)
Seat 2: xAU6q2/cwmby2sxmA8VcmA ($115.80 in chips)
Seat 3: wx3sQGkVi2x9wJXuWNHPBw ($220.05 in chips)
Seat 4: ZA1bp6g8IwtTxkUE4eCjDQ ($186.05 in chips)
Seat 5: UBZQqpnJZdTYYY1FTb0rLA ($101.50 in chips)
Seat 6: oxnw0GLLpFanjhGkxfRSqA ($58 in chips)
ZA1bp6g8IwtTxkUE4eCjDQ: posts small blind $0.50
UBZQqpnJZdTYYY1FTb0rLA: posts big blind $1
*** HOLE CARDS ***
oxnw0GLLpFanjhGkxfRSqA: folds
YsLQ3BAvgQHWXMAv3Wv6Hg: folds
xAU6q2/cwmby2sxmA8VcmA: raises $3 to $4
wx3sQGkVi2x9wJXuWNHPBw: folds
ZA1bp6g8IwtTxkUE4eCjDQ: calls $3.50
UBZQqpnJZdTYYY1FTb0rLA: folds
*** FLOP *** [Kd 8s 2s]
ZA1bp6g8IwtTxkUE4eCjDQ: checks
xAU6q2/cwmby2sxmA8VcmA: checks
*** TURN *** [Kd 8s 2s] [Js]
ZA1bp6g8IwtTxkUE4eCjDQ: bets $1
xAU6q2/cwmby2sxmA8VcmA: raises $5 to $6
ZA1bp6g8IwtTxkUE4eCjDQ: folds
xAU6q2/cwmby2sxmA8VcmA collected $10.50 from pot
xAU6q2/cwmby2sxmA8VcmA: doesn't show hand
*** SUMMARY ***
Total pot $11 | Rake $0.50
Board [Kd 8s 2s Js]
Seat 1: YsLQ3BAvgQHWXMAv3Wv6Hg folded before Flop (didn't bet)
Seat 2: xAU6q2/cwmby2sxmA8VcmA collected ($10.50)
Seat 3: wx3sQGkVi2x9wJXuWNHPBw (button) folded before Flop (didn't bet)
Seat 4: ZA1bp6g8IwtTxkUE4eCjDQ (small blind) folded on the Turn
Seat 5: UBZQqpnJZdTYYY1FTb0rLA (big blind) folded before Flop
Seat 6: oxnw0GLLpFanjhGkxfRSqA folded before Flop (didn't bet)



PokerStars Game #59939602126:  Hold'em No Limit ($0.50/$1.00) - 2009/07/01 0:44:06 ET
Table 'VOs36P6NW+QyXeQ1B62kmA' 6-max Seat #4 is the button
Seat 1: AdLVjddOzm+sRNo1Bc3S6Q ($139.30 in chips)
Seat 2: KpnW5CcJ4Mg6MeclfKmLrw ($119.35 in chips)
Seat 3: TSuRyAHnUPCFjP7Z0rEE0w ($100 in chips)
Seat 4: w02zQzNydODiyV9THKgo9w ($36.80 in chips)
Seat 6: 6tvjsJrdmWg+g7FVrMnzXA ($54.40 in chips)
6tvjsJrdmWg+g7FVrMnzXA: posts small blind $0.50
AdLVjddOzm+sRNo1Bc3S6Q: posts big blind $1
*** HOLE CARDS ***
KpnW5CcJ4Mg6MeclfKmLrw: folds
TSuRyAHnUPCFjP7Z0rEE0w: raises $3 to $4
w02zQzNydODiyV9THKgo9w: folds
6tvjsJrdmWg+g7FVrMnzXA: calls $3.50
AdLVjddOzm+sRNo1Bc3S6Q: folds
*** FLOP *** [7h Td Qs]
6tvjsJrdmWg+g7FVrMnzXA: checks
TSuRyAHnUPCFjP7Z0rEE0w: bets $6
6tvjsJrdmWg+g7FVrMnzXA: calls $6
*** TURN *** [7h Td Qs] [Kd]
6tvjsJrdmWg+g7FVrMnzXA: checks
TSuRyAHnUPCFjP7Z0rEE0w: bets $16
6tvjsJrdmWg+g7FVrMnzXA: calls $16
*** RIVER *** [7h Td Qs Kd] [9h]
6tvjsJrdmWg+g7FVrMnzXA: bets $28.40 and is all-in
TSuRyAHnUPCFjP7Z0rEE0w: folds
6tvjsJrdmWg+g7FVrMnzXA collected $51 from pot
6tvjsJrdmWg+g7FVrMnzXA: doesn't show hand
*** SUMMARY ***
Total pot $53 | Rake $2
Board [7h Td Qs Kd 9h]
Seat 1: AdLVjddOzm+sRNo1Bc3S6Q (big blind) folded before Flop
Seat 2: KpnW5CcJ4Mg6MeclfKmLrw folded before Flop (didn't bet)
Seat 3: TSuRyAHnUPCFjP7Z0rEE0w folded on the River
Seat 4: w02zQzNydODiyV9THKgo9w (button) folded before Flop (didn't bet)
Seat 6: 6tvjsJrdmWg+g7FVrMnzXA (small blind) collected ($51)



PokerStars Game #59939605120:  Hold'em No Limit ($0.50/$1.00) - 2009/07/01 0:44:11 ET
Table 'U9zqzC8f3oTJ2ShXFgSSOA' 6-max Seat #6 is the button
Seat 1: +xW7QemQU0Fxs+4TnqBRow ($100 in chips)
Seat 3: yfXek8iJ7O4CFyqXrtGcfg ($10.55 in chips)
Seat 4: 33q95we0Etwgrm6guQGncw ($88.60 in chips)
Seat 5: KfwW5us6tydK81NYTtK1gw ($291.25 in chips)
Seat 6: aIxzFKdtpDSkUePKZy/niQ ($32.80 in chips)
+xW7QemQU0Fxs+4TnqBRow: posts small blind $0.50
yfXek8iJ7O4CFyqXrtGcfg: posts big blind $1
*** HOLE CARDS ***
33q95we0Etwgrm6guQGncw: folds
KfwW5us6tydK81NYTtK1gw: folds
aIxzFKdtpDSkUePKZy/niQ: calls $1
+xW7QemQU0Fxs+4TnqBRow: folds
yfXek8iJ7O4CFyqXrtGcfg: checks
*** FLOP *** [6d 8c 3c]
yfXek8iJ7O4CFyqXrtGcfg: bets $2
aIxzFKdtpDSkUePKZy/niQ: calls $2
*** TURN *** [6d 8c 3c] [Kh]
yfXek8iJ7O4CFyqXrtGcfg: bets $3
aIxzFKdtpDSkUePKZy/niQ: calls $3
*** RIVER *** [6d 8c 3c Kh] [Jd]
yfXek8iJ7O4CFyqXrtGcfg: checks
aIxzFKdtpDSkUePKZy/niQ: bets $5
yfXek8iJ7O4CFyqXrtGcfg: calls $4.55 and is all-in
*** SHOW DOWN ***
aIxzFKdtpDSkUePKZy/niQ: shows [4c 5h] (high card King)
yfXek8iJ7O4CFyqXrtGcfg: shows [Ad 8s] (a pair of Eights)
yfXek8iJ7O4CFyqXrtGcfg collected $20.55 from pot
*** SUMMARY ***
Total pot $21.60 | Rake $1.05
Board [6d 8c 3c Kh Jd]
Seat 1: +xW7QemQU0Fxs+4TnqBRow (small blind) folded before Flop
Seat 3: yfXek8iJ7O4CFyqXrtGcfg (big blind) showed [Ad 8s] and won ($20.55) with a pair of Eights
Seat 4: 33q95we0Etwgrm6guQGncw folded before Flop (didn't bet)
Seat 5: KfwW5us6tydK81NYTtK1gw folded before Flop (didn't bet)
Seat 6: aIxzFKdtpDSkUePKZy/niQ (button) showed [4c 5h] and lost with high card King



PokerStars Game #59939606466:  Hold'em No Limit ($0.50/$1.00) - 2009/07/01 0:44:13 ET
Table '/RZcOwpZpHQ+OwPwjsbnRw' 6-max Seat #4 is the button
Seat 1: Zboa6dColKGHBjLPUakZjw ($50.20 in chips)
Seat 2: +xW7QemQU0Fxs+4TnqBRow ($196 in chips)
Seat 3: XnT1yK2DD/5FL+0bwuEhqg ($49.45 in chips)
Seat 4: j7NIOHLZk7V2o9fOioO5ug ($100 in chips)
Seat 5: wx3sQGkVi2x9wJXuWNHPBw ($194.15 in chips)
Seat 6: XOIf9W+VAxhZqN+SYoyMKA ($288.55 in chips)
wx3sQGkVi2x9wJXuWNHPBw: posts small blind $0.50
XOIf9W+VAxhZqN+SYoyMKA: posts big blind $1
*** HOLE CARDS ***
Zboa6dColKGHBjLPUakZjw: folds
+xW7QemQU0Fxs+4TnqBRow: folds
XnT1yK2DD/5FL+0bwuEhqg: folds
j7NIOHLZk7V2o9fOioO5ug: folds
wx3sQGkVi2x9wJXuWNHPBw: folds
XOIf9W+VAxhZqN+SYoyMKA collected $1 from pot
XOIf9W+VAxhZqN+SYoyMKA: doesn't show hand
*** SUMMARY ***
Total pot $1 | Rake $0
Seat 1: Zboa6dColKGHBjLPUakZjw folded before Flop (didn't bet)
Seat 2: +xW7QemQU0Fxs+4TnqBRow folded before Flop (didn't bet)
Seat 3: XnT1yK2DD/5FL+0bwuEhqg folded before Flop (didn't bet)
Seat 4: j7NIOHLZk7V2o9fOioO5ug (button) folded before Flop (didn't bet)
Seat 5: wx3sQGkVi2x9wJXuWNHPBw (small blind) folded before Flop
Seat 6: XOIf9W+VAxhZqN+SYoyMKA (big blind) collected ($1)



PokerStars Game #59939606338:  Hold'em No Limit ($0.50/$1.00) - 2009/07/01 0:44:13 ET
Table 'tyUh+jyNvrceIQdKMJjQ2wZFWj23PMihdwrNWv41OG/Qeat #2 is the button
Seat 1: o8A5MUdudVKu+pAwgZOX2w ($219.45 in chips)
Seat 2: XvUbOIg94d25feWeQlOTVg ($75.15 in chips)
Seat 3: TalCiLYHCd+ffkmR3auPvA ($63.80 in chips)
Seat 4: TSuRyAHnUPCFjP7Z0rEE0w ($119.75 in chips)
Seat 5: j7NIOHLZk7V2o9fOioO5ug ($111.60 in chips)
Seat 6: YsLQ3BAvgQHWXMAv3Wv6Hg ($145.75 in chips)
TalCiLYHCd+ffkmR3auPvA: posts small blind $0.50
TSuRyAHnUPCFjP7Z0rEE0w: posts big blind $1
*** HOLE CARDS ***
j7NIOHLZk7V2o9fOioO5ug: folds
YsLQ3BAvgQHWXMAv3Wv6Hg: folds
o8A5MUdudVKu+pAwgZOX2w: folds
o8A5MUdudVKu+pAwgZOX2w is sitting out
XvUbOIg94d25feWeQlOTVg: calls $1
TalCiLYHCd+ffkmR3auPvA: calls $0.50
TSuRyAHnUPCFjP7Z0rEE0w: checks
*** FLOP *** [6c 3h 9d]
TalCiLYHCd+ffkmR3auPvA: checks
TSuRyAHnUPCFjP7Z0rEE0w: checks
XvUbOIg94d25feWeQlOTVg: bets $3
TalCiLYHCd+ffkmR3auPvA: folds
TSuRyAHnUPCFjP7Z0rEE0w: folds
XvUbOIg94d25feWeQlOTVg collected $2.85 from pot
*** SUMMARY ***
Total pot $3 | Rake $0.15
Board [6c 3h 9d]
Seat 1: o8A5MUdudVKu+pAwgZOX2w folded before Flop (didn't bet)
Seat 2: XvUbOIg94d25feWeQlOTVg (button) collected ($2.85)
Seat 3: TalCiLYHCd+ffkmR3auPvA (small blind) folded on the Flop
Seat 4: TSuRyAHnUPCFjP7Z0rEE0w (big blind) folded on the Flop
Seat 5: j7NIOHLZk7V2o9fOioO5ug folded before Flop (didn't bet)
Seat 6: YsLQ3BAvgQHWXMAv3Wv6Hg folded before Flop (didn't bet)



PokerStars Game #59939608030:  Hold'em No Limit ($0.50/$1.00) - 2009/07/01 0:44:15 ET
Table 'LmXQK9xy3awB+qsPzI21Mw' 2-max Seat #1 is the button
Seat 1: NYi6JFscYNrofSXy4sM+Yw ($244.50 in chips)
Seat 2: TME8GvochpQAo8cmJwWmvA ($90.30 in chips)
NYi6JFscYNrofSXy4sM+Yw: posts small blind $0.50
TME8GvochpQAo8cmJwWmvA: posts big blind $1
*** HOLE CARDS ***
NYi6JFscYNrofSXy4sM+Yw: folds
TME8GvochpQAo8cmJwWmvA collected $1 from pot
TME8GvochpQAo8cmJwWmvA: doesn't show hand
*** SUMMARY ***
Total pot $1 | Rake $0
Seat 1: NYi6JFscYNrofSXy4sM+Yw (button) (small blind) folded before Flop
Seat 2: TME8GvochpQAo8cmJwWmvA (big blind) collected ($1)



PokerStars Game #59939608438:  Hold'em No Limit ($0.50/$1.00) - 2009/07/01 0:44:16 ET
Table 'eU3bWpDDg3Z+9R4m4iVmog' 6-max Seat #4 is the button
Seat 1: TSuRyAHnUPCFjP7Z0rEE0w ($191.15 in chips)
Seat 2: 8CAoOzhmB8n3nRFf3V4BTg ($97.80 in chips)
Seat 3: U6tnjwZRpTnM+YkqkCjwyQ ($191.15 in chips)
Seat 4: GDVIsbEJ/DOJsMKE4Asz0A ($74.60 in chips)
Seat 5: AdLVjddOzm+sRNo1Bc3S6Q ($101.50 in chips)
Seat 6: hpxXcmRkXXI9HE5+5/j/0Q ($121.95 in chips)
AdLVjddOzm+sRNo1Bc3S6Q: posts small blind $0.50
hpxXcmRkXXI9HE5+5/j/0Q: posts big blind $1
*** HOLE CARDS ***
TSuRyAHnUPCFjP7Z0rEE0w: folds
8CAoOzhmB8n3nRFf3V4BTg: folds
U6tnjwZRpTnM+YkqkCjwyQ: folds
GDVIsbEJ/DOJsMKE4Asz0A: raises $2 to $3
AdLVjddOzm+sRNo1Bc3S6Q: folds
hpxXcmRkXXI9HE5+5/j/0Q: folds
GDVIsbEJ/DOJsMKE4Asz0A collected $2.50 from pot
GDVIsbEJ/DOJsMKE4Asz0A: doesn't show hand
*** SUMMARY ***
Total pot $2.50 | Rake $0
Seat 1: TSuRyAHnUPCFjP7Z0rEE0w folded before Flop (didn't bet)
Seat 2: 8CAoOzhmB8n3nRFf3V4BTg folded before Flop (didn't bet)
Seat 3: U6tnjwZRpTnM+YkqkCjwyQ folded before Flop (didn't bet)
Seat 4: GDVIsbEJ/DOJsMKE4Asz0A (button) collected ($2.50)
Seat 5: AdLVjddOzm+sRNo1Bc3S6Q (small blind) folded before Flop
Seat 6: hpxXcmRkXXI9HE5+5/j/0Q (big blind) folded before Flop



PokerStars Game #59939608594:  Hold'em No Limit ($0.50/$1.00) - 2009/07/01 0:44:16 ET
Table 'tJq9SfN1ywY0r03VBlWlwQ' 9-max Seat #5 is the button
Seat 1: wZsU+w9r7G66x93UuvBf1Q ($334.30 in chips)
Seat 2: RqkO8O/Y3qlc3PIuCAHjVg ($68.40 in chips)
Seat 3: FVs16t7GgfWgQWt4JxsObQ ($40.55 in chips)
Seat 4: bLbSOSmSOnqE0iTcH/5dxA ($104.80 in chips)
Seat 5: Ogn4JDV3mp4ZDKO49IFzKA ($19.90 in chips)
Seat 6: gUUvmqdVlmvpal6B8nYrmg ($126.55 in chips)
Seat 7: qVhRZ0PLZ95XRJHWAjXjOQ ($129.70 in chips)
Seat 8: G4DEhsZFmznGNVpy2SEocA ($20.50 in chips)
Seat 9: XE5QF1y74bpHog9JxWJMWQ ($104.20 in chips)
gUUvmqdVlmvpal6B8nYrmg: posts small blind $0.50
qVhRZ0PLZ95XRJHWAjXjOQ: posts big blind $1
*** HOLE CARDS ***
G4DEhsZFmznGNVpy2SEocA: folds
XE5QF1y74bpHog9JxWJMWQ: folds
wZsU+w9r7G66x93UuvBf1Q: folds
RqkO8O/Y3qlc3PIuCAHjVg: folds
FVs16t7GgfWgQWt4JxsObQ: calls $1
bLbSOSmSOnqE0iTcH/5dxA: raises $4 to $5
Ogn4JDV3mp4ZDKO49IFzKA: folds
gUUvmqdVlmvpal6B8nYrmg: folds
qVhRZ0PLZ95XRJHWAjXjOQ: folds
FVs16t7GgfWgQWt4JxsObQ: calls $4
*** FLOP *** [Ac 8c 9s]
FVs16t7GgfWgQWt4JxsObQ: bets $1
bLbSOSmSOnqE0iTcH/5dxA: raises $9 to $10
FVs16t7GgfWgQWt4JxsObQ: folds
bLbSOSmSOnqE0iTcH/5dxA collected $12.90 from pot
*** SUMMARY ***
Total pot $13.50 | Rake $0.60
Board [Ac 8c 9s]
Seat 1: wZsU+w9r7G66x93UuvBf1Q folded before Flop (didn't bet)
Seat 2: RqkO8O/Y3qlc3PIuCAHjVg folded before Flop (didn't bet)
Seat 3: FVs16t7GgfWgQWt4JxsObQ folded on the Flop
Seat 4: bLbSOSmSOnqE0iTcH/5dxA collected ($12.90)
Seat 5: Ogn4JDV3mp4ZDKO49IFzKA (button) folded before Flop (didn't bet)
Seat 6: gUUvmqdVlmvpal6B8nYrmg (small blind) folded before Flop
Seat 7: qVhRZ0PLZ95XRJHWAjXjOQ (big blind) folded before Flop
Seat 8: G4DEhsZFmznGNVpy2SEocA folded before Flop (didn't bet)
Seat 9: XE5QF1y74bpHog9JxWJMWQ folded before Flop (didn't bet)



PokerStars Game #59939609402:  Hold'em No Limit ($0.50/$1.00) - 2009/07/01 0:44:17 ET
Table 'Zka9tv1yilg0MvXWPQrShg' 9-max Seat #3 is the button
Seat 1: TZcz9MEWDA+WydgGruqqbw ($113.85 in chips)
Seat 3: gUUvmqdVlmvpal6B8nYrmg ($100 in chips)
Seat 5: /zy+DB4S5fUQUSfZWFzYGw ($131.40 in chips)
Seat 6: rY8wPoax1lS+HUY+I0FZDw ($144.80 in chips)
Seat 7: p1SafS90nb3Uft5LB0NkHw ($20 in chips)
Seat 8: bL+QVeDcuEdzMGAGg2XJHg ($117.60 in chips)
Seat 9: 6daxhj43mWj04MOPTOmaYA ($95.65 in chips)
stxmTgSicxShtrDxhOOX2g will be allowed to play after the button
/zy+DB4S5fUQUSfZWFzYGw: posts small blind $0.50
rY8wPoax1lS+HUY+I0FZDw: posts big blind $1
kz9ziSiGUc+857heiKSayw: sits out
*** HOLE CARDS ***
p1SafS90nb3Uft5LB0NkHw: folds
bL+QVeDcuEdzMGAGg2XJHg: folds
6daxhj43mWj04MOPTOmaYA: folds
TZcz9MEWDA+WydgGruqqbw: folds
gUUvmqdVlmvpal6B8nYrmg: raises $1 to $2
/zy+DB4S5fUQUSfZWFzYGw: folds
rY8wPoax1lS+HUY+I0FZDw: raises $6 to $8
gUUvmqdVlmvpal6B8nYrmg: folds
rY8wPoax1lS+HUY+I0FZDw collected $4.50 from pot
*** SUMMARY ***
Total pot $4.50 | Rake $0
Seat 1: TZcz9MEWDA+WydgGruqqbw folded before Flop (didn't bet)
Seat 3: gUUvmqdVlmvpal6B8nYrmg (button) folded before Flop
Seat 5: /zy+DB4S5fUQUSfZWFzYGw (small blind) folded before Flop
Seat 6: rY8wPoax1lS+HUY+I0FZDw (big blind) collected ($4.50)
Seat 7: p1SafS90nb3Uft5LB0NkHw folded before Flop (didn't bet)
Seat 8: bL+QVeDcuEdzMGAGg2XJHg folded before Flop (didn't bet)
Seat 9: 6daxhj43mWj04MOPTOmaYA folded before Flop (didn't bet)



PokerStars Game #59939609266:  Hold'em No Limit ($0.50/$1.00) - 2009/07/01 0:44:17 ET
Table 'GxCPo/gd3OSthkYrAxJngg' 6-max Seat #1 is the button
Seat 1: sH8BpAFP+jGFxCgVpD1Lew ($255.45 in chips)
Seat 2: YExX2paeIHrmfIwV1ivM/w ($78.70 in chips)
Seat 3: o6plE+MSW4XFNTeONe16xg ($32.60 in chips)
Seat 4: YMJG+F++3Aj6P8dAWda5fw ($106.65 in chips)
Seat 5: G5ZSSN6RSON3gkNvk/SmYg ($109.75 in chips)
Seat 6: sS9IXedL3MiRmpVXhAILhw ($101.95 in chips)
YExX2paeIHrmfIwV1ivM/w: posts small blind $0.50
o6plE+MSW4XFNTeONe16xg: posts big blind $1
*** HOLE CARDS ***
YMJG+F++3Aj6P8dAWda5fw: folds
G5ZSSN6RSON3gkNvk/SmYg: folds
sS9IXedL3MiRmpVXhAILhw: folds
sH8BpAFP+jGFxCgVpD1Lew: calls $1
YExX2paeIHrmfIwV1ivM/w: folds
o6plE+MSW4XFNTeONe16xg: checks
*** FLOP *** [2h 5h 2d]
o6plE+MSW4XFNTeONe16xg: checks
sH8BpAFP+jGFxCgVpD1Lew: bets $2
o6plE+MSW4XFNTeONe16xg: folds
sH8BpAFP+jGFxCgVpD1Lew collected $2.40 from pot
*** SUMMARY ***
Total pot $2.50 | Rake $0.10
Board [2h 5h 2d]
Seat 1: sH8BpAFP+jGFxCgVpD1Lew (button) collected ($2.40)
Seat 2: YExX2paeIHrmfIwV1ivM/w (small blind) folded before Flop
Seat 3: o6plE+MSW4XFNTeONe16xg (big blind) folded on the Flop
Seat 4: YMJG+F++3Aj6P8dAWda5fw folded before Flop (didn't bet)
Seat 5: G5ZSSN6RSON3gkNvk/SmYg folded before Flop (didn't bet)
Seat 6: sS9IXedL3MiRmpVXhAILhw folded before Flop (didn't bet)



PokerStars Game #59939609238:  Hold'em No Limit ($0.50/$1.00) - 2009/07/01 0:44:17 ET
Table 'QBLDswtHe7Ml0HwAdcMhlw' 2-max Seat #1 is the button
Seat 1: hdNlhiCwI533uwvvTTfC9Q ($123.50 in chips)
Seat 2: GBkvjkjDWVBEa1e14dh6CA ($44.90 in chips)
hdNlhiCwI533uwvvTTfC9Q: posts small blind $0.50
GBkvjkjDWVBEa1e14dh6CA: posts big blind $1
*** HOLE CARDS ***
hdNlhiCwI533uwvvTTfC9Q: raises $2 to $3
GBkvjkjDWVBEa1e14dh6CA: folds
hdNlhiCwI533uwvvTTfC9Q collected $2 from pot
hdNlhiCwI533uwvvTTfC9Q: doesn't show hand
*** SUMMARY ***
Total pot $2 | Rake $0
Seat 1: hdNlhiCwI533uwvvTTfC9Q (button) (small blind) collected ($2)
Seat 2: GBkvjkjDWVBEa1e14dh6CA (big blind) folded before Flop



PokerStars Game #59939611470:  Hold'em No Limit ($0.50/$1.00) - 2009/07/01 0:44:21 ET
Table 'LmXQK9xy3awB+qsPzI21Mw' 2-max Seat #2 is the button
Seat 1: NYi6JFscYNrofSXy4sM+Yw ($244 in chips)
Seat 2: TME8GvochpQAo8cmJwWmvA ($90.80 in chips)
TME8GvochpQAo8cmJwWmvA: posts small blind $0.50
NYi6JFscYNrofSXy4sM+Yw: posts big blind $1
*** HOLE CARDS ***
TME8GvochpQAo8cmJwWmvA: raises $1 to $2
NYi6JFscYNrofSXy4sM+Yw: calls $1
*** FLOP *** [4s 7s 6s]
NYi6JFscYNrofSXy4sM+Yw: checks
TME8GvochpQAo8cmJwWmvA: bets $2
NYi6JFscYNrofSXy4sM+Yw: folds
TME8GvochpQAo8cmJwWmvA collected $3.80 from pot
TME8GvochpQAo8cmJwWmvA: doesn't show hand
*** SUMMARY ***
Total pot $4 | Rake $0.20
Board [4s 7s 6s]
Seat 1: NYi6JFscYNrofSXy4sM+Yw (big blind) folded on the Flop
Seat 2: TME8GvochpQAo8cmJwWmvA (button) (small blind) collected ($3.80)



PokerStars Game #59939616744:  Hold'em No Limit ($0.50/$1.00) - 2009/07/01 0:44:29 ET
Table 'QBLDswtHe7Ml0HwAdcMhlw' 2-max Seat #2 is the button
Seat 1: hdNlhiCwI533uwvvTTfC9Q ($124.50 in chips)
Seat 2: GBkvjkjDWVBEa1e14dh6CA ($43.90 in chips)
GBkvjkjDWVBEa1e14dh6CA: posts small blind $0.50
hdNlhiCwI533uwvvTTfC9Q: posts big blind $1
*** HOLE CARDS ***
GBkvjkjDWVBEa1e14dh6CA: raises $2 to $3
hdNlhiCwI533uwvvTTfC9Q: folds
GBkvjkjDWVBEa1e14dh6CA collected $2 from pot
GBkvjkjDWVBEa1e14dh6CA: doesn't show hand
*** SUMMARY ***
Total pot $2 | Rake $0
Seat 1: hdNlhiCwI533uwvvTTfC9Q (big blind) folded before Flop
Seat 2: GBkvjkjDWVBEa1e14dh6CA (button) (small blind) collected ($2)



PokerStars Game #59939617628:  Hold'em No Limit ($0.50/$1.00) - 2009/07/01 0:44:30 ET
Table '/RZcOwpZpHQ+OwPwjsbnRw' 6-max Seat #5 is the button
Seat 1: Zboa6dColKGHBjLPUakZjw ($50.20 in chips)
Seat 2: +xW7QemQU0Fxs+4TnqBRow ($196 in chips)
Seat 3: XnT1yK2DD/5FL+0bwuEhqg ($49.45 in chips)
Seat 4: j7NIOHLZk7V2o9fOioO5ug ($100 in chips)
Seat 5: wx3sQGkVi2x9wJXuWNHPBw ($193.65 in chips)
Seat 6: XOIf9W+VAxhZqN+SYoyMKA ($289.05 in chips)
XOIf9W+VAxhZqN+SYoyMKA: posts small blind $0.50
Zboa6dColKGHBjLPUakZjw: posts big blind $1
*** HOLE CARDS ***
+xW7QemQU0Fxs+4TnqBRow: folds
XnT1yK2DD/5FL+0bwuEhqg: folds
j7NIOHLZk7V2o9fOioO5ug: raises $2 to $3
wx3sQGkVi2x9wJXuWNHPBw: folds
XOIf9W+VAxhZqN+SYoyMKA: folds
Zboa6dColKGHBjLPUakZjw: folds
j7NIOHLZk7V2o9fOioO5ug collected $2.50 from pot
j7NIOHLZk7V2o9fOioO5ug: doesn't show hand
*** SUMMARY ***
Total pot $2.50 | Rake $0
Seat 1: Zboa6dColKGHBjLPUakZjw (big blind) folded before Flop
Seat 2: +xW7QemQU0Fxs+4TnqBRow folded before Flop (didn't bet)
Seat 3: XnT1yK2DD/5FL+0bwuEhqg folded before Flop (didn't bet)
Seat 4: j7NIOHLZk7V2o9fOioO5ug collected ($2.50)
Seat 5: wx3sQGkVi2x9wJXuWNHPBw (button) folded before Flop (didn't bet)
Seat 6: XOIf9W+VAxhZqN+SYoyMKA (small blind) folded before Flop



PokerStars Game #59939618050:  Hold'em No Limit ($0.50/$1.00) - 2009/07/01 0:44:31 ET
Table '+cA8mcmhaedZ7YcrDdhmeQ' 6-max Seat #2 is the button
Seat 1: lsLuWlcPA3Rh7kJVLzMh0Q ($306.70 in chips)
Seat 2: RqgF7gRoKgRNW8Zoi1ty4A ($101.50 in chips)
Seat 3: 7H5WkGzGvsv56y1iaqHvRg ($16.20 in chips)
Seat 4: LjL3AIERHn559yyW1mTUYQ ($173.30 in chips)
Seat 6: YfsTQsY/fxb+YqbdclTHuw ($54.55 in chips)
7H5WkGzGvsv56y1iaqHvRg: posts small blind $0.50
LjL3AIERHn559yyW1mTUYQ: posts big blind $1
+7hFKAL0b0O/n8G72TclJA: sits out
*** HOLE CARDS ***
YfsTQsY/fxb+YqbdclTHuw: folds
lsLuWlcPA3Rh7kJVLzMh0Q: raises $2 to $3
RqgF7gRoKgRNW8Zoi1ty4A: folds
7H5WkGzGvsv56y1iaqHvRg: calls $2.50
LjL3AIERHn559yyW1mTUYQ: folds
*** FLOP *** [7d 7s Kd]
7H5WkGzGvsv56y1iaqHvRg: checks
lsLuWlcPA3Rh7kJVLzMh0Q: bets $4
7H5WkGzGvsv56y1iaqHvRg: raises $9.20 to $13.20 and is all-in
lsLuWlcPA3Rh7kJVLzMh0Q: calls $9.20
*** TURN *** [7d 7s Kd] [Ac]
*** RIVER *** [7d 7s Kd Ac] [3h]
*** SHOW DOWN ***
7H5WkGzGvsv56y1iaqHvRg: shows [8d Kc] (two pair, Kings and Sevens)
lsLuWlcPA3Rh7kJVLzMh0Q: mucks hand
7H5WkGzGvsv56y1iaqHvRg collected $31.75 from pot
*** SUMMARY ***
Total pot $33.40 | Rake $1.65
Board [7d 7s Kd Ac 3h]
Seat 1: lsLuWlcPA3Rh7kJVLzMh0Q mucked
Seat 2: RqgF7gRoKgRNW8Zoi1ty4A (button) folded before Flop (didn't bet)
Seat 3: 7H5WkGzGvsv56y1iaqHvRg (small blind) showed [8d Kc] and won ($31.75) with two pair, Kings and Sevens
Seat 4: LjL3AIERHn559yyW1mTUYQ (big blind) folded before Flop
Seat 6: YfsTQsY/fxb+YqbdclTHuw folded before Flop (didn't bet)



PokerStars Game #59939618370:  Hold'em No Limit ($0.50/$1.00) - 2009/07/01 0:44:31 ET
Table '7Nl0ffnjeK44/vmeexh3MQ' 9-max Seat #3 is the button
Seat 1: s7D3Y+k4Cj4D1cXHv7oj+Q ($92.35 in chips)
Seat 2: kiakSwxX0e64PwYGAPQvLw ($30.35 in chips)
Seat 3: vR4IO10geOgvTW+LAUBv/A ($101.50 in chips)
Seat 4: bLbSOSmSOnqE0iTcH/5dxA ($100 in chips)
Seat 5: bL+QVeDcuEdzMGAGg2XJHg ($99.50 in chips)
Seat 6: FVs16t7GgfWgQWt4JxsObQ ($29.30 in chips)
Seat 8: zanka7aAZkigmZpfopXxxA ($253.70 in chips)
Seat 9: ouwUBGRKnKK9uhn1G4Lf+A ($95 in chips)
bLbSOSmSOnqE0iTcH/5dxA: posts small blind $0.50
bL+QVeDcuEdzMGAGg2XJHg: posts big blind $1
997ViqAtWn1FPjJqcffwcA: sits out
*** HOLE CARDS ***
FVs16t7GgfWgQWt4JxsObQ: folds
zanka7aAZkigmZpfopXxxA: folds
ouwUBGRKnKK9uhn1G4Lf+A: folds
s7D3Y+k4Cj4D1cXHv7oj+Q: folds
kiakSwxX0e64PwYGAPQvLw: raises $2 to $3
vR4IO10geOgvTW+LAUBv/A: folds
bLbSOSmSOnqE0iTcH/5dxA: folds
bL+QVeDcuEdzMGAGg2XJHg: folds
kiakSwxX0e64PwYGAPQvLw collected $2.50 from pot
*** SUMMARY ***
Total pot $2.50 | Rake $0
Seat 1: s7D3Y+k4Cj4D1cXHv7oj+Q folded before Flop (didn't bet)
Seat 2: kiakSwxX0e64PwYGAPQvLw collected ($2.50)
Seat 3: vR4IO10geOgvTW+LAUBv/A (button) folded before Flop (didn't bet)
Seat 4: bLbSOSmSOnqE0iTcH/5dxA (small blind) folded before Flop
Seat 5: bL+QVeDcuEdzMGAGg2XJHg (big blind) folded before Flop
Seat 6: FVs16t7GgfWgQWt4JxsObQ folded before Flop (didn't bet)
Seat 8: zanka7aAZkigmZpfopXxxA folded before Flop (didn't bet)
Seat 9: ouwUBGRKnKK9uhn1G4Lf+A folded before Flop (didn't bet)



PokerStars Game #59939619162:  Hold'em No Limit ($0.50/$1.00) - 2009/07/01 0:44:32 ET
Table 'eU3bWpDDg3Z+9R4m4iVmog' 6-max Seat #5 is the button
Seat 1: TSuRyAHnUPCFjP7Z0rEE0w ($191.15 in chips)
Seat 2: 8CAoOzhmB8n3nRFf3V4BTg ($97.80 in chips)
Seat 3: U6tnjwZRpTnM+YkqkCjwyQ ($191.15 in chips)
Seat 4: GDVIsbEJ/DOJsMKE4Asz0A ($76.10 in chips)
Seat 5: AdLVjddOzm+sRNo1Bc3S6Q ($101 in chips)
Seat 6: hpxXcmRkXXI9HE5+5/j/0Q ($120.95 in chips)
hpxXcmRkXXI9HE5+5/j/0Q: posts small blind $0.50
TSuRyAHnUPCFjP7Z0rEE0w: posts big blind $1
*** HOLE CARDS ***
8CAoOzhmB8n3nRFf3V4BTg: folds
U6tnjwZRpTnM+YkqkCjwyQ: folds
GDVIsbEJ/DOJsMKE4Asz0A: raises $2 to $3
AdLVjddOzm+sRNo1Bc3S6Q: raises $7 to $10
hpxXcmRkXXI9HE5+5/j/0Q: folds
TSuRyAHnUPCFjP7Z0rEE0w: folds
GDVIsbEJ/DOJsMKE4Asz0A: calls $7
*** FLOP *** [Qs 8s 6d]
GDVIsbEJ/DOJsMKE4Asz0A: checks
AdLVjddOzm+sRNo1Bc3S6Q: checks
*** TURN *** [Qs 8s 6d] [Ah]
GDVIsbEJ/DOJsMKE4Asz0A: checks
AdLVjddOzm+sRNo1Bc3S6Q: bets $13
GDVIsbEJ/DOJsMKE4Asz0A: folds
AdLVjddOzm+sRNo1Bc3S6Q collected $20.45 from pot
AdLVjddOzm+sRNo1Bc3S6Q: doesn't show hand
*** SUMMARY ***
Total pot $21.50 | Rake $1.05
Board [Qs 8s 6d Ah]
Seat 1: TSuRyAHnUPCFjP7Z0rEE0w (big blind) folded before Flop
Seat 2: 8CAoOzhmB8n3nRFf3V4BTg folded before Flop (didn't bet)
Seat 3: U6tnjwZRpTnM+YkqkCjwyQ folded before Flop (didn't bet)
Seat 4: GDVIsbEJ/DOJsMKE4Asz0A folded on the Turn
Seat 5: AdLVjddOzm+sRNo1Bc3S6Q (button) collected ($20.45)
Seat 6: hpxXcmRkXXI9HE5+5/j/0Q (small blind) folded before Flop



PokerStars Game #59939619722:  Hold'em No Limit ($0.50/$1.00) - 2009/07/01 0:44:33 ET
Table 'LmXQK9xy3awB+qsPzI21Mw' 2-max Seat #1 is the button
Seat 1: NYi6JFscYNrofSXy4sM+Yw ($242 in chips)
Seat 2: TME8GvochpQAo8cmJwWmvA ($92.60 in chips)
NYi6JFscYNrofSXy4sM+Yw: posts small blind $0.50
TME8GvochpQAo8cmJwWmvA: posts big blind $1
*** HOLE CARDS ***
NYi6JFscYNrofSXy4sM+Yw: raises $2 to $3
TME8GvochpQAo8cmJwWmvA: folds
NYi6JFscYNrofSXy4sM+Yw collected $2 from pot
*** SUMMARY ***
Total pot $2 | Rake $0
Seat 1: NYi6JFscYNrofSXy4sM+Yw (button) (small blind) collected ($2)
Seat 2: TME8GvochpQAo8cmJwWmvA (big blind) folded before Flop



PokerStars Game #59939619274:  Hold'em No Limit ($0.50/$1.00) - 2009/07/01 0:44:33 ET
Table 'uNlePsyMIqzM691Xkrlk6Q' 9-max Seat #5 is the button
Seat 1: bLbSOSmSOnqE0iTcH/5dxA ($100 in chips)
Seat 2: +OqpStnt0FqbCfyHAWaLbg ($78.05 in chips)
Seat 3: h7qXkU57Bb8ZuPwMyxR8Ug ($31.50 in chips)
Seat 4: TZcz9MEWDA+WydgGruqqbw ($102.65 in chips)
Seat 5: 3obndzTJ6fECz8+wWhMd1w ($17 in chips)
Seat 6: uMPEfCcGCfsxmy53tVUMug ($109.60 in chips)
Seat 7: w6cw9nzN7AvkkHBVVjykoQ ($42.90 in chips)
Seat 9: vR4IO10geOgvTW+LAUBv/A ($102.25 in chips)
uMPEfCcGCfsxmy53tVUMug: posts small blind $0.50
w6cw9nzN7AvkkHBVVjykoQ: posts big blind $1
laA8va+Yv8WuMqT1zdR91g: sits out
*** HOLE CARDS ***
vR4IO10geOgvTW+LAUBv/A: folds
bLbSOSmSOnqE0iTcH/5dxA: raises $3 to $4
+OqpStnt0FqbCfyHAWaLbg: folds
h7qXkU57Bb8ZuPwMyxR8Ug: folds
TZcz9MEWDA+WydgGruqqbw: folds
3obndzTJ6fECz8+wWhMd1w: folds
uMPEfCcGCfsxmy53tVUMug: folds
w6cw9nzN7AvkkHBVVjykoQ: folds
bLbSOSmSOnqE0iTcH/5dxA collected $2.50 from pot
bLbSOSmSOnqE0iTcH/5dxA: doesn't show hand
*** SUMMARY ***
Total pot $2.50 | Rake $0
Seat 1: bLbSOSmSOnqE0iTcH/5dxA collected ($2.50)
Seat 2: +OqpStnt0FqbCfyHAWaLbg folded before Flop (didn't bet)
Seat 3: h7qXkU57Bb8ZuPwMyxR8Ug folded before Flop (didn't bet)
Seat 4: TZcz9MEWDA+WydgGruqqbw folded before Flop (didn't bet)
Seat 5: 3obndzTJ6fECz8+wWhMd1w (button) folded before Flop (didn't bet)
Seat 6: uMPEfCcGCfsxmy53tVUMug (small blind) folded before Flop
Seat 7: w6cw9nzN7AvkkHBVVjykoQ (big blind) folded before Flop
Seat 9: vR4IO10geOgvTW+LAUBv/A folded before Flop (didn't bet)



PokerStars Game #59939620586:  Hold'em No Limit ($0.50/$1.00) - 2009/07/01 0:44:35 ET
Table 'CASNP0uy1C+jGLml/I4PtA' 9-max Seat #7 is the button
Seat 1: WjoOp1nORyC1VJMAde77xg ($66.25 in chips)
Seat 2: tjhwe1V98x2spSoUQER3HQ ($100 in chips)
Seat 3: bJckevFOcg//s0qyMQI6sQ ($114.45 in chips)
Seat 4: B/G0GJacqZ8K59/ZVdq4kQ ($49.95 in chips)
Seat 6: 0eFnow7+D7veCYQ+CG9FFw ($99.85 in chips)
Seat 7: RpMNxqeYPSeOh0tflU772w ($163.85 in chips)
Seat 8: L9njYvloJ1NdXjP8edHEAg ($100 in chips)
Seat 9: 4oiD3zp7JlvK3PEQyVa3gA ($266.55 in chips)
L9njYvloJ1NdXjP8edHEAg: posts small blind $0.50
4oiD3zp7JlvK3PEQyVa3gA: posts big blind $1
xskinef: sits out
*** HOLE CARDS ***
WjoOp1nORyC1VJMAde77xg has timed out
WjoOp1nORyC1VJMAde77xg: folds
WjoOp1nORyC1VJMAde77xg is sitting out
tjhwe1V98x2spSoUQER3HQ: raises $3 to $4
bJckevFOcg//s0qyMQI6sQ: folds
B/G0GJacqZ8K59/ZVdq4kQ: folds
0eFnow7+D7veCYQ+CG9FFw: folds
RpMNxqeYPSeOh0tflU772w: folds
L9njYvloJ1NdXjP8edHEAg: folds
4oiD3zp7JlvK3PEQyVa3gA: calls $3
*** FLOP *** [3d 6s 3c]
4oiD3zp7JlvK3PEQyVa3gA: checks
WjoOp1nORyC1VJMAde77xg leaves the table
tjhwe1V98x2spSoUQER3HQ: bets $6
4oiD3zp7JlvK3PEQyVa3gA: folds
tjhwe1V98x2spSoUQER3HQ collected $8.10 from pot
tjhwe1V98x2spSoUQER3HQ: doesn't show hand
*** SUMMARY ***
Total pot $8.50 | Rake $0.40
Board [3d 6s 3c]
Seat 1: WjoOp1nORyC1VJMAde77xg folded before Flop (didn't bet)
Seat 2: tjhwe1V98x2spSoUQER3HQ collected ($8.10)
Seat 3: bJckevFOcg//s0qyMQI6sQ folded before Flop (didn't bet)
Seat 4: B/G0GJacqZ8K59/ZVdq4kQ folded before Flop (didn't bet)
Seat 6: 0eFnow7+D7veCYQ+CG9FFw folded before Flop (didn't bet)
Seat 7: RpMNxqeYPSeOh0tflU772w (button) folded before Flop (didn't bet)
Seat 8: L9njYvloJ1NdXjP8edHEAg (small blind) folded before Flop
Seat 9: 4oiD3zp7JlvK3PEQyVa3gA (big blind) folded on the Flop



PokerStars Game #59939621714:  Hold'em No Limit ($0.50/$1.00) - 2009/07/01 0:44:36 ET
Table 'vs/5jr6ciwjVQ5+Soc+u2A' 6-max Seat #5 is the button
Seat 1: 1C0rFAGdnnX4GWK9B0YPww ($25.70 in chips)
Seat 2: XOIf9W+VAxhZqN+SYoyMKA ($126.15 in chips)
Seat 3: G5ZSSN6RSON3gkNvk/SmYg ($150.50 in chips)
Seat 4: KpnW5CcJ4Mg6MeclfKmLrw ($102.80 in chips)
Seat 5: imUnjybOc/YBYCgM7m/qSA ($19.25 in chips)
1C0rFAGdnnX4GWK9B0YPww: posts small blind $0.50
XOIf9W+VAxhZqN+SYoyMKA: posts big blind $1
*** HOLE CARDS ***
G5ZSSN6RSON3gkNvk/SmYg: folds
KpnW5CcJ4Mg6MeclfKmLrw: raises $2 to $3
imUnjybOc/YBYCgM7m/qSA: folds
imUnjybOc/YBYCgM7m/qSA leaves the table
1C0rFAGdnnX4GWK9B0YPww: folds
XOIf9W+VAxhZqN+SYoyMKA: calls $2
*** FLOP *** [2d Td Qc]
XOIf9W+VAxhZqN+SYoyMKA: checks
KpnW5CcJ4Mg6MeclfKmLrw: checks
*** TURN *** [2d Td Qc] [4h]
XOIf9W+VAxhZqN+SYoyMKA: bets $3
KpnW5CcJ4Mg6MeclfKmLrw: folds
XOIf9W+VAxhZqN+SYoyMKA collected $6.20 from pot
XOIf9W+VAxhZqN+SYoyMKA: doesn't show hand
*** SUMMARY ***
Total pot $6.50 | Rake $0.30
Board [2d Td Qc 4h]
Seat 1: 1C0rFAGdnnX4GWK9B0YPww (small blind) folded before Flop
Seat 2: XOIf9W+VAxhZqN+SYoyMKA (big blind) collected ($6.20)
Seat 3: G5ZSSN6RSON3gkNvk/SmYg folded before Flop (didn't bet)
Seat 4: KpnW5CcJ4Mg6MeclfKmLrw folded on the Turn
Seat 5: imUnjybOc/YBYCgM7m/qSA (button) folded before Flop (didn't bet)



PokerStars Game #59939623592:  Hold'em No Limit ($0.50/$1.00) - 2009/07/01 0:44:39 ET
Table 'LmXQK9xy3awB+qsPzI21Mw' 2-max Seat #2 is the button
Seat 1: NYi6JFscYNrofSXy4sM+Yw ($243 in chips)
Seat 2: TME8GvochpQAo8cmJwWmvA ($91.60 in chips)
TME8GvochpQAo8cmJwWmvA: posts small blind $0.50
NYi6JFscYNrofSXy4sM+Yw: posts big blind $1
*** HOLE CARDS ***
TME8GvochpQAo8cmJwWmvA: raises $1 to $2
NYi6JFscYNrofSXy4sM+Yw: calls $1
*** FLOP *** [Qh 9c Js]
NYi6JFscYNrofSXy4sM+Yw: checks
TME8GvochpQAo8cmJwWmvA: checks
*** TURN *** [Qh 9c Js] [Kc]
NYi6JFscYNrofSXy4sM+Yw: bets $2
TME8GvochpQAo8cmJwWmvA: calls $2
*** RIVER *** [Qh 9c Js Kc] [8c]
NYi6JFscYNrofSXy4sM+Yw: bets $5
TME8GvochpQAo8cmJwWmvA: folds
NYi6JFscYNrofSXy4sM+Yw collected $7.65 from pot
*** SUMMARY ***
Total pot $8 | Rake $0.35
Board [Qh 9c Js Kc 8c]
Seat 1: NYi6JFscYNrofSXy4sM+Yw (big blind) collected ($7.65)
Seat 2: TME8GvochpQAo8cmJwWmvA (button) (small blind) folded on the River



PokerStars Game #59939624074:  Hold'em No Limit ($0.50/$1.00) - 2009/07/01 0:44:40 ET
Table 'rmZfTK+oSebeUPJNbWhdAA' 6-max Seat #5 is the button
Seat 1: xAU6q2/cwmby2sxmA8VcmA ($100 in chips)
Seat 2: z7O9PO/WEcqRouIydFhS9Q ($112.50 in chips)
Seat 3: 9yjOzGERLaEZS8CZ6YNHFg ($115.85 in chips)
Seat 5: 5lY8d6Cnm4HUkt/8FZSj4g ($78 in chips)
Seat 6: j7NIOHLZk7V2o9fOioO5ug ($133 in chips)
j7NIOHLZk7V2o9fOioO5ug: posts small blind $0.50
xAU6q2/cwmby2sxmA8VcmA: posts big blind $1
1/mIuXfgx1ZyVkodrmfQDw: sits out
*** HOLE CARDS ***
z7O9PO/WEcqRouIydFhS9Q: raises $2 to $3
9yjOzGERLaEZS8CZ6YNHFg: folds
5lY8d6Cnm4HUkt/8FZSj4g: calls $3
j7NIOHLZk7V2o9fOioO5ug: folds
xAU6q2/cwmby2sxmA8VcmA: folds
*** FLOP *** [Tc 7c 5h]
z7O9PO/WEcqRouIydFhS9Q: checks
5lY8d6Cnm4HUkt/8FZSj4g: bets $4
z7O9PO/WEcqRouIydFhS9Q: calls $4
*** TURN *** [Tc 7c 5h] [4d]
z7O9PO/WEcqRouIydFhS9Q: checks
5lY8d6Cnm4HUkt/8FZSj4g: checks
*** RIVER *** [Tc 7c 5h 4d] [Td]
z7O9PO/WEcqRouIydFhS9Q: checks
5lY8d6Cnm4HUkt/8FZSj4g: checks
*** SHOW DOWN ***
z7O9PO/WEcqRouIydFhS9Q: shows [Ac Qs] (a pair of Tens)
5lY8d6Cnm4HUkt/8FZSj4g: shows [Ks 5c] (two pair, Tens and Fives)
5lY8d6Cnm4HUkt/8FZSj4g collected $14.75 from pot
*** SUMMARY ***
Total pot $15.50 | Rake $0.75
Board [Tc 7c 5h 4d Td]
Seat 1: xAU6q2/cwmby2sxmA8VcmA (big blind) folded before Flop
Seat 2: z7O9PO/WEcqRouIydFhS9Q showed [Ac Qs] and lost with a pair of Tens
Seat 3: 9yjOzGERLaEZS8CZ6YNHFg folded before Flop (didn't bet)
Seat 5: 5lY8d6Cnm4HUkt/8FZSj4g (button) showed [Ks 5c] and won ($14.75) with two pair, Tens and Fives
Seat 6: j7NIOHLZk7V2o9fOioO5ug (small blind) folded before Flop



PokerStars Game #59939625960:  Hold'em No Limit ($0.50/$1.00) - 2009/07/01 0:44:43 ET
Table 'QBLDswtHe7Ml0HwAdcMhlw' 2-max Seat #1 is the button
Seat 1: hdNlhiCwI533uwvvTTfC9Q ($123.50 in chips)
Seat 2: GBkvjkjDWVBEa1e14dh6CA ($44.90 in chips)
hdNlhiCwI533uwvvTTfC9Q: posts small blind $0.50
GBkvjkjDWVBEa1e14dh6CA: posts big blind $1
*** HOLE CARDS ***
hdNlhiCwI533uwvvTTfC9Q: folds
GBkvjkjDWVBEa1e14dh6CA collected $1 from pot
GBkvjkjDWVBEa1e14dh6CA: doesn't show hand
*** SUMMARY ***
Total pot $1 | Rake $0
Seat 1: hdNlhiCwI533uwvvTTfC9Q (button) (small blind) folded before Flop
Seat 2: GBkvjkjDWVBEa1e14dh6CA (big blind) collected ($1)



PokerStars Game #59939626826:  Hold'em No Limit ($0.50/$1.00) - 2009/07/01 0:44:44 ET
Table '6YvsYDPNIDx2v5z3bJnwZQ' 9-max Seat #5 is the button
Seat 1: Ogn4JDV3mp4ZDKO49IFzKA ($18.70 in chips)
Seat 2: x80+i7DJL+81v3quj7KbNg ($20 in chips)
Seat 3: negfosHnGOZXSHpWDRKyBQ ($17.30 in chips)
Seat 4: kEr5NYB+JIG5+szcYMr6hA ($41.50 in chips)
Seat 5: mBRWbnUl8diyBO1qTJaNzw ($159.20 in chips)
Seat 6: uMPEfCcGCfsxmy53tVUMug ($105.10 in chips)
Seat 8: PSFxpXgPedVZyHSu2Zhb7Q ($96.15 in chips)
Seat 9: jDwhY1kCdc6EkAHbT7PJMQ ($104.10 in chips)
uMPEfCcGCfsxmy53tVUMug: posts small blind $0.50
mae7OMTaJ/MFimNbZegCkg: is sitting out
PSFxpXgPedVZyHSu2Zhb7Q: posts big blind $1
*** HOLE CARDS ***
mae7OMTaJ/MFimNbZegCkg has returned
jDwhY1kCdc6EkAHbT7PJMQ: folds
Ogn4JDV3mp4ZDKO49IFzKA: folds
x80+i7DJL+81v3quj7KbNg: folds
negfosHnGOZXSHpWDRKyBQ: folds
kEr5NYB+JIG5+szcYMr6hA: folds
mBRWbnUl8diyBO1qTJaNzw: raises $3 to $4
uMPEfCcGCfsxmy53tVUMug: folds
PSFxpXgPedVZyHSu2Zhb7Q: folds
mBRWbnUl8diyBO1qTJaNzw collected $2.50 from pot
*** SUMMARY ***
Total pot $2.50 | Rake $0
Seat 1: Ogn4JDV3mp4ZDKO49IFzKA folded before Flop (didn't bet)
Seat 2: x80+i7DJL+81v3quj7KbNg folded before Flop (didn't bet)
Seat 3: negfosHnGOZXSHpWDRKyBQ folded before Flop (didn't bet)
Seat 4: kEr5NYB+JIG5+szcYMr6hA folded before Flop (didn't bet)
Seat 5: mBRWbnUl8diyBO1qTJaNzw (button) collected ($2.50)
Seat 6: uMPEfCcGCfsxmy53tVUMug (small blind) folded before Flop
Seat 8: PSFxpXgPedVZyHSu2Zhb7Q (big blind) folded before Flop
Seat 9: jDwhY1kCdc6EkAHbT7PJMQ folded before Flop (didn't bet)



PokerStars Game #59939629356:  Hold'em No Limit ($0.50/$1.00) - 2009/07/01 0:44:48 ET
Table 'fTlPiCj0utgzC/5io+I7ew' 6-max Seat #1 is the button
Seat 1: YMJG+F++3Aj6P8dAWda5fw ($98 in chips)
Seat 2: Qy/UBNbD2HaA0Ogxg8Sf3w ($109.45 in chips)
Seat 3: oDiBRCaF0QVtd3kO6xZIXw ($83.60 in chips)
Seat 4: uJVSceLggtsrJya+WtmUEA ($97.30 in chips)
Seat 5: bFrTkDcWGTxyvNul7GVdYg ($252.20 in chips)
Qy/UBNbD2HaA0Ogxg8Sf3w: posts small blind $0.50
oDiBRCaF0QVtd3kO6xZIXw: posts big blind $1
*** HOLE CARDS ***
uJVSceLggtsrJya+WtmUEA: folds
bFrTkDcWGTxyvNul7GVdYg: raises $2 to $3
YMJG+F++3Aj6P8dAWda5fw: folds
Qy/UBNbD2HaA0Ogxg8Sf3w: folds
oDiBRCaF0QVtd3kO6xZIXw: folds
bFrTkDcWGTxyvNul7GVdYg collected $2.50 from pot
*** SUMMARY ***
Total pot $2.50 | Rake $0
Seat 1: YMJG+F++3Aj6P8dAWda5fw (button) folded before Flop (didn't bet)
Seat 2: Qy/UBNbD2HaA0Ogxg8Sf3w (small blind) folded before Flop
Seat 3: oDiBRCaF0QVtd3kO6xZIXw (big blind) folded before Flop
Seat 4: uJVSceLggtsrJya+WtmUEA folded before Flop (didn't bet)
Seat 5: bFrTkDcWGTxyvNul7GVdYg collected ($2.50)



PokerStars Game #59939629742:  Hold'em No Limit ($0.50/$1.00) - 2009/07/01 0:44:49 ET
Table 'QBLDswtHe7Ml0HwAdcMhlw' 2-max Seat #2 is the button
Seat 1: hdNlhiCwI533uwvvTTfC9Q ($123 in chips)
Seat 2: GBkvjkjDWVBEa1e14dh6CA ($45.40 in chips)
GBkvjkjDWVBEa1e14dh6CA: posts small blind $0.50
hdNlhiCwI533uwvvTTfC9Q: posts big blind $1
*** HOLE CARDS ***
GBkvjkjDWVBEa1e14dh6CA: folds
hdNlhiCwI533uwvvTTfC9Q collected $1 from pot
hdNlhiCwI533uwvvTTfC9Q: doesn't show hand
*** SUMMARY ***
Total pot $1 | Rake $0
Seat 1: hdNlhiCwI533uwvvTTfC9Q (big blind) collected ($1)
Seat 2: GBkvjkjDWVBEa1e14dh6CA (button) (small blind) folded before Flop



PokerStars Game #59939632372:  Hold'em No Limit ($0.50/$1.00) - 2009/07/01 0:44:53 ET
Table 'pHrhryH8jPNdQfY62f8v+g' 6-max Seat #2 is the button
Seat 1: fF4botNMr8/ieVPO1YYRLw ($44 in chips)
Seat 2: RqgF7gRoKgRNW8Zoi1ty4A ($125.65 in chips)
Seat 4: wenbG7TaM3H7h5kn78OFNw ($62.70 in chips)
Seat 5: r1/R7y0Ortgoz4lccgW8VA ($30.15 in chips)
Seat 6: xAU6q2/cwmby2sxmA8VcmA ($115.25 in chips)
wenbG7TaM3H7h5kn78OFNw: posts small blind $0.50
r1/R7y0Ortgoz4lccgW8VA: posts big blind $1
*** HOLE CARDS ***
8oS5O7iD/qnFXFXJrGIgNQ joins the table at seat #3
xAU6q2/cwmby2sxmA8VcmA: folds
fF4botNMr8/ieVPO1YYRLw: calls $1
RqgF7gRoKgRNW8Zoi1ty4A: folds
wenbG7TaM3H7h5kn78OFNw: calls $0.50
r1/R7y0Ortgoz4lccgW8VA: checks
*** FLOP *** [9s 6c As]
wenbG7TaM3H7h5kn78OFNw: checks
r1/R7y0Ortgoz4lccgW8VA: checks
fF4botNMr8/ieVPO1YYRLw: bets $3
wenbG7TaM3H7h5kn78OFNw: folds
r1/R7y0Ortgoz4lccgW8VA: folds
fF4botNMr8/ieVPO1YYRLw collected $2.85 from pot
*** SUMMARY ***
Total pot $3 | Rake $0.15
Board [9s 6c As]
Seat 1: fF4botNMr8/ieVPO1YYRLw collected ($2.85)
Seat 2: RqgF7gRoKgRNW8Zoi1ty4A (button) folded before Flop (didn't bet)
Seat 4: wenbG7TaM3H7h5kn78OFNw (small blind) folded on the Flop
Seat 5: r1/R7y0Ortgoz4lccgW8VA (big blind) folded on the Flop
Seat 6: xAU6q2/cwmby2sxmA8VcmA folded before Flop (didn't bet)



PokerStars Game #59939633302:  Hold'em No Limit ($0.50/$1.00) - 2009/07/01 0:44:54 ET
Table '/RZcOwpZpHQ+OwPwjsbnRw' 6-max Seat #6 is the button
Seat 1: Zboa6dColKGHBjLPUakZjw ($49.20 in chips)
Seat 2: +xW7QemQU0Fxs+4TnqBRow ($196 in chips)
Seat 3: XnT1yK2DD/5FL+0bwuEhqg ($49.45 in chips)
Seat 4: j7NIOHLZk7V2o9fOioO5ug ($101.50 in chips)
Seat 5: wx3sQGkVi2x9wJXuWNHPBw ($193.65 in chips)
Seat 6: XOIf9W+VAxhZqN+SYoyMKA ($288.55 in chips)
Zboa6dColKGHBjLPUakZjw: posts small blind $0.50
+xW7QemQU0Fxs+4TnqBRow: posts big blind $1
*** HOLE CARDS ***
XnT1yK2DD/5FL+0bwuEhqg: folds
j7NIOHLZk7V2o9fOioO5ug: folds
wx3sQGkVi2x9wJXuWNHPBw: folds
XOIf9W+VAxhZqN+SYoyMKA: folds
Zboa6dColKGHBjLPUakZjw: raises $1 to $2
+xW7QemQU0Fxs+4TnqBRow: folds
Zboa6dColKGHBjLPUakZjw collected $2 from pot
*** SUMMARY ***
Total pot $2 | Rake $0
Seat 1: Zboa6dColKGHBjLPUakZjw (small blind) collected ($2)
Seat 2: +xW7QemQU0Fxs+4TnqBRow (big blind) folded before Flop
Seat 3: XnT1yK2DD/5FL+0bwuEhqg folded before Flop (didn't bet)
Seat 4: j7NIOHLZk7V2o9fOioO5ug folded before Flop (didn't bet)
Seat 5: wx3sQGkVi2x9wJXuWNHPBw folded before Flop (didn't bet)
Seat 6: XOIf9W+VAxhZqN+SYoyMKA (button) folded before Flop (didn't bet)



PokerStars Game #59939633630:  Hold'em No Limit ($0.50/$1.00) - 2009/07/01 0:44:55 ET
Table 'MUPc8FEpe/nR0BKSeReX6Q' 6-max Seat #4 is the button
Seat 1: YsLQ3BAvgQHWXMAv3Wv6Hg ($113.85 in chips)
Seat 2: xAU6q2/cwmby2sxmA8VcmA ($121.30 in chips)
Seat 3: wx3sQGkVi2x9wJXuWNHPBw ($220.05 in chips)
Seat 4: ZA1bp6g8IwtTxkUE4eCjDQ ($181.05 in chips)
Seat 5: UBZQqpnJZdTYYY1FTb0rLA ($100.50 in chips)
Seat 6: oxnw0GLLpFanjhGkxfRSqA ($58 in chips)
UBZQqpnJZdTYYY1FTb0rLA: posts small blind $0.50
oxnw0GLLpFanjhGkxfRSqA: posts big blind $1
*** HOLE CARDS ***
YsLQ3BAvgQHWXMAv3Wv6Hg: folds
xAU6q2/cwmby2sxmA8VcmA: folds
wx3sQGkVi2x9wJXuWNHPBw: folds
ZA1bp6g8IwtTxkUE4eCjDQ: folds
UBZQqpnJZdTYYY1FTb0rLA: folds
oxnw0GLLpFanjhGkxfRSqA collected $1 from pot
*** SUMMARY ***
Total pot $1 | Rake $0
Seat 1: YsLQ3BAvgQHWXMAv3Wv6Hg folded before Flop (didn't bet)
Seat 2: xAU6q2/cwmby2sxmA8VcmA folded before Flop (didn't bet)
Seat 3: wx3sQGkVi2x9wJXuWNHPBw folded before Flop (didn't bet)
Seat 4: ZA1bp6g8IwtTxkUE4eCjDQ (button) folded before Flop (didn't bet)
Seat 5: UBZQqpnJZdTYYY1FTb0rLA (small blind) folded before Flop
Seat 6: oxnw0GLLpFanjhGkxfRSqA (big blind) collected ($1)



PokerStars Game #59939634004:  Hold'em No Limit ($0.50/$1.00) - 2009/07/01 0:44:56 ET
Table 'QBLDswtHe7Ml0HwAdcMhlw' 2-max Seat #1 is the button
Seat 1: hdNlhiCwI533uwvvTTfC9Q ($123.50 in chips)
Seat 2: GBkvjkjDWVBEa1e14dh6CA ($44.90 in chips)
hdNlhiCwI533uwvvTTfC9Q: posts small blind $0.50
GBkvjkjDWVBEa1e14dh6CA: posts big blind $1
*** HOLE CARDS ***
hdNlhiCwI533uwvvTTfC9Q: folds
GBkvjkjDWVBEa1e14dh6CA collected $1 from pot
GBkvjkjDWVBEa1e14dh6CA: doesn't show hand
*** SUMMARY ***
Total pot $1 | Rake $0
Seat 1: hdNlhiCwI533uwvvTTfC9Q (button) (small blind) folded before Flop
Seat 2: GBkvjkjDWVBEa1e14dh6CA (big blind) collected ($1)



PokerStars Game #59939634428:  Hold'em No Limit ($0.50/$1.00) - 2009/07/01 0:44:56 ET
Table '7Nl0ffnjeK44/vmeexh3MQ' 9-max Seat #4 is the button
Seat 1: s7D3Y+k4Cj4D1cXHv7oj+Q ($92.35 in chips)
Seat 2: kiakSwxX0e64PwYGAPQvLw ($31.85 in chips)
Seat 3: vR4IO10geOgvTW+LAUBv/A ($101.50 in chips)
Seat 4: bLbSOSmSOnqE0iTcH/5dxA ($100 in chips)
Seat 5: bL+QVeDcuEdzMGAGg2XJHg ($100 in chips)
Seat 6: FVs16t7GgfWgQWt4JxsObQ ($29.30 in chips)
Seat 8: zanka7aAZkigmZpfopXxxA ($253.70 in chips)
Seat 9: ouwUBGRKnKK9uhn1G4Lf+A ($95 in chips)
bL+QVeDcuEdzMGAGg2XJHg: posts small blind $0.50
FVs16t7GgfWgQWt4JxsObQ: posts big blind $1
997ViqAtWn1FPjJqcffwcA: sits out
*** HOLE CARDS ***
zanka7aAZkigmZpfopXxxA: folds
ouwUBGRKnKK9uhn1G4Lf+A: folds
s7D3Y+k4Cj4D1cXHv7oj+Q: folds
kiakSwxX0e64PwYGAPQvLw: folds
vR4IO10geOgvTW+LAUBv/A: folds
bLbSOSmSOnqE0iTcH/5dxA: folds
bL+QVeDcuEdzMGAGg2XJHg: raises $2 to $3
FVs16t7GgfWgQWt4JxsObQ: calls $2
*** FLOP *** [Kd Kc 6s]
bL+QVeDcuEdzMGAGg2XJHg: checks
FVs16t7GgfWgQWt4JxsObQ: checks
*** TURN *** [Kd Kc 6s] [6d]
bL+QVeDcuEdzMGAGg2XJHg: checks
FVs16t7GgfWgQWt4JxsObQ: bets $2
bL+QVeDcuEdzMGAGg2XJHg: folds
FVs16t7GgfWgQWt4JxsObQ collected $5.70 from pot
*** SUMMARY ***
Total pot $6 | Rake $0.30
Board [Kd Kc 6s 6d]
Seat 1: s7D3Y+k4Cj4D1cXHv7oj+Q folded before Flop (didn't bet)
Seat 2: kiakSwxX0e64PwYGAPQvLw folded before Flop (didn't bet)
Seat 3: vR4IO10geOgvTW+LAUBv/A folded before Flop (didn't bet)
Seat 4: bLbSOSmSOnqE0iTcH/5dxA (button) folded before Flop (didn't bet)
Seat 5: bL+QVeDcuEdzMGAGg2XJHg (small blind) folded on the Turn
Seat 6: FVs16t7GgfWgQWt4JxsObQ (big blind) collected ($5.70)
Seat 8: zanka7aAZkigmZpfopXxxA folded before Flop (didn't bet)
Seat 9: ouwUBGRKnKK9uhn1G4Lf+A folded before Flop (didn't bet)



PokerStars Game #59939634764:  Hold'em No Limit ($0.50/$1.00) - 2009/07/01 0:44:57 ET
Table 'LmXQK9xy3awB+qsPzI21Mw' 2-max Seat #1 is the button
Seat 1: NYi6JFscYNrofSXy4sM+Yw ($246.65 in chips)
Seat 2: TME8GvochpQAo8cmJwWmvA ($87.60 in chips)
NYi6JFscYNrofSXy4sM+Yw: posts small blind $0.50
TME8GvochpQAo8cmJwWmvA: posts big blind $1
*** HOLE CARDS ***
NYi6JFscYNrofSXy4sM+Yw: folds
TME8GvochpQAo8cmJwWmvA collected $1 from pot
TME8GvochpQAo8cmJwWmvA: doesn't show hand
*** SUMMARY ***
Total pot $1 | Rake $0
Seat 1: NYi6JFscYNrofSXy4sM+Yw (button) (small blind) folded before Flop
Seat 2: TME8GvochpQAo8cmJwWmvA (big blind) collected ($1)



PokerStars Game #59939635806:  Hold'em No Limit ($0.50/$1.00) - 2009/07/01 0:44:58 ET
Table 'GPp0HyAuggN8oE0sUWzPpA' 9-max Seat #5 is the button
Seat 1: qJr25HAtvv1w/7IBvjMM3g ($20.35 in chips)
Seat 2: Ogn4JDV3mp4ZDKO49IFzKA ($34.20 in chips)
Seat 3: L9njYvloJ1NdXjP8edHEAg ($100 in chips)
Seat 4: mBRWbnUl8diyBO1qTJaNzw ($108.20 in chips)
Seat 5: 0fXz44fzDo5QmhAaJCvFfA ($19.30 in chips)
Seat 7: laA8va+Yv8WuMqT1zdR91g ($100 in chips)
Seat 8: tkdBeXTJlFsZdioidNqLow ($71.20 in chips)
BK/GtNPkSx0TdUDj82id5A will be allowed to play after the button
laA8va+Yv8WuMqT1zdR91g: posts small blind $0.50
tkdBeXTJlFsZdioidNqLow: posts big blind $1
VPF+HjszMvUIpy0CHIwH3A: sits out
*** HOLE CARDS ***
qJr25HAtvv1w/7IBvjMM3g: folds
Ogn4JDV3mp4ZDKO49IFzKA: folds
L9njYvloJ1NdXjP8edHEAg: folds
mBRWbnUl8diyBO1qTJaNzw: raises $3 to $4
0fXz44fzDo5QmhAaJCvFfA: folds
laA8va+Yv8WuMqT1zdR91g: folds
tkdBeXTJlFsZdioidNqLow: folds
mBRWbnUl8diyBO1qTJaNzw collected $2.50 from pot
*** SUMMARY ***
Total pot $2.50 | Rake $0
Seat 1: qJr25HAtvv1w/7IBvjMM3g folded before Flop (didn't bet)
Seat 2: Ogn4JDV3mp4ZDKO49IFzKA folded before Flop (didn't bet)
Seat 3: L9njYvloJ1NdXjP8edHEAg folded before Flop (didn't bet)
Seat 4: mBRWbnUl8diyBO1qTJaNzw collected ($2.50)
Seat 5: 0fXz44fzDo5QmhAaJCvFfA (button) folded before Flop (didn't bet)
Seat 7: laA8va+Yv8WuMqT1zdR91g (small blind) folded before Flop
Seat 8: tkdBeXTJlFsZdioidNqLow (big blind) folded before Flop



PokerStars Game #59939635406:  Hold'em No Limit ($0.50/$1.00) - 2009/07/01 0:44:58 ET
Table 'VOs36P6NW+QyXeQ1B62kmA' 6-max Seat #6 is the button
Seat 1: AdLVjddOzm+sRNo1Bc3S6Q ($138.30 in chips)
Seat 2: KpnW5CcJ4Mg6MeclfKmLrw ($119.35 in chips)
Seat 3: TSuRyAHnUPCFjP7Z0rEE0w ($100 in chips)
Seat 4: w02zQzNydODiyV9THKgo9w ($36.80 in chips)
Seat 6: 6tvjsJrdmWg+g7FVrMnzXA ($79.40 in chips)
AdLVjddOzm+sRNo1Bc3S6Q: posts small blind $0.50
KpnW5CcJ4Mg6MeclfKmLrw: posts big blind $1
*** HOLE CARDS ***
TSuRyAHnUPCFjP7Z0rEE0w: folds
w02zQzNydODiyV9THKgo9w: folds
6tvjsJrdmWg+g7FVrMnzXA: folds
AdLVjddOzm+sRNo1Bc3S6Q: folds
KpnW5CcJ4Mg6MeclfKmLrw collected $1 from pot
*** SUMMARY ***
Total pot $1 | Rake $0
Seat 1: AdLVjddOzm+sRNo1Bc3S6Q (small blind) folded before Flop
Seat 2: KpnW5CcJ4Mg6MeclfKmLrw (big blind) collected ($1)
Seat 3: TSuRyAHnUPCFjP7Z0rEE0w folded before Flop (didn't bet)
Seat 4: w02zQzNydODiyV9THKgo9w folded before Flop (didn't bet)
Seat 6: 6tvjsJrdmWg+g7FVrMnzXA (button) folded before Flop (didn't bet)



PokerStars Game #59939637868:  Hold'em No Limit ($0.50/$1.00) - 2009/07/01 0:45:01 ET
Table 'QBLDswtHe7Ml0HwAdcMhlw' 2-max Seat #2 is the button
Seat 1: hdNlhiCwI533uwvvTTfC9Q ($123 in chips)
Seat 2: GBkvjkjDWVBEa1e14dh6CA ($45.40 in chips)
GBkvjkjDWVBEa1e14dh6CA: posts small blind $0.50
hdNlhiCwI533uwvvTTfC9Q: posts big blind $1
*** HOLE CARDS ***
GBkvjkjDWVBEa1e14dh6CA: folds
hdNlhiCwI533uwvvTTfC9Q collected $1 from pot
hdNlhiCwI533uwvvTTfC9Q: doesn't show hand
*** SUMMARY ***
Total pot $1 | Rake $0
Seat 1: hdNlhiCwI533uwvvTTfC9Q (big blind) collected ($1)
Seat 2: GBkvjkjDWVBEa1e14dh6CA (button) (small blind) folded before Flop



PokerStars Game #59939638416:  Hold'em No Limit ($0.50/$1.00) - 2009/07/01 0:45:02 ET
Table 'LmXQK9xy3awB+qsPzI21Mw' 2-max Seat #2 is the button
Seat 1: NYi6JFscYNrofSXy4sM+Yw ($246.15 in chips)
Seat 2: TME8GvochpQAo8cmJwWmvA ($88.10 in chips)
TME8GvochpQAo8cmJwWmvA: posts small blind $0.50
NYi6JFscYNrofSXy4sM+Yw: posts big blind $1
*** HOLE CARDS ***
TME8GvochpQAo8cmJwWmvA: calls $0.50
NYi6JFscYNrofSXy4sM+Yw: checks
*** FLOP *** [Jh 7c 6d]
NYi6JFscYNrofSXy4sM+Yw: bets $2
TME8GvochpQAo8cmJwWmvA: calls $2
*** TURN *** [Jh 7c 6d] [8h]
NYi6JFscYNrofSXy4sM+Yw: checks
TME8GvochpQAo8cmJwWmvA: bets $2
NYi6JFscYNrofSXy4sM+Yw: folds
TME8GvochpQAo8cmJwWmvA collected $5.75 from pot
TME8GvochpQAo8cmJwWmvA: doesn't show hand
*** SUMMARY ***
Total pot $6 | Rake $0.25
Board [Jh 7c 6d 8h]
Seat 1: NYi6JFscYNrofSXy4sM+Yw (big blind) folded on the Turn
Seat 2: TME8GvochpQAo8cmJwWmvA (button) (small blind) collected ($5.75)



PokerStars Game #59939640102:  Hold'em No Limit ($0.50/$1.00) - 2009/07/01 0:45:05 ET
Table 'uNlePsyMIqzM691Xkrlk6Q' 9-max Seat #6 is the button
Seat 1: bLbSOSmSOnqE0iTcH/5dxA ($101.50 in chips)
Seat 2: +OqpStnt0FqbCfyHAWaLbg ($78.05 in chips)
Seat 3: h7qXkU57Bb8ZuPwMyxR8Ug ($31.50 in chips)
Seat 4: TZcz9MEWDA+WydgGruqqbw ($102.65 in chips)
Seat 5: 3obndzTJ6fECz8+wWhMd1w ($17 in chips)
Seat 6: uMPEfCcGCfsxmy53tVUMug ($109.10 in chips)
Seat 7: w6cw9nzN7AvkkHBVVjykoQ ($41.90 in chips)
Seat 8: laA8va+Yv8WuMqT1zdR91g ($100 in chips)
Seat 9: vR4IO10geOgvTW+LAUBv/A ($102.25 in chips)
w6cw9nzN7AvkkHBVVjykoQ: posts small blind $0.50
laA8va+Yv8WuMqT1zdR91g: posts big blind $1
*** HOLE CARDS ***
vR4IO10geOgvTW+LAUBv/A: folds
bLbSOSmSOnqE0iTcH/5dxA: folds
+OqpStnt0FqbCfyHAWaLbg: folds
h7qXkU57Bb8ZuPwMyxR8Ug: folds
TZcz9MEWDA+WydgGruqqbw: folds
3obndzTJ6fECz8+wWhMd1w: raises $2 to $3
uMPEfCcGCfsxmy53tVUMug: folds
w6cw9nzN7AvkkHBVVjykoQ: folds
laA8va+Yv8WuMqT1zdR91g: folds
3obndzTJ6fECz8+wWhMd1w collected $2.50 from pot
3obndzTJ6fECz8+wWhMd1w: doesn't show hand
*** SUMMARY ***
Total pot $2.50 | Rake $0
Seat 1: bLbSOSmSOnqE0iTcH/5dxA folded before Flop (didn't bet)
Seat 2: +OqpStnt0FqbCfyHAWaLbg folded before Flop (didn't bet)
Seat 3: h7qXkU57Bb8ZuPwMyxR8Ug folded before Flop (didn't bet)
Seat 4: TZcz9MEWDA+WydgGruqqbw folded before Flop (didn't bet)
Seat 5: 3obndzTJ6fECz8+wWhMd1w collected ($2.50)
Seat 6: uMPEfCcGCfsxmy53tVUMug (button) folded before Flop (didn't bet)
Seat 7: w6cw9nzN7AvkkHBVVjykoQ (small blind) folded before Flop
Seat 8: laA8va+Yv8WuMqT1zdR91g (big blind) folded before Flop
Seat 9: vR4IO10geOgvTW+LAUBv/A folded before Flop (didn't bet)



PokerStars Game #59939640288:  Hold'em No Limit ($0.50/$1.00) - 2009/07/01 0:45:05 ET
Table 'tyUh+jyNvrceIQdKMJjQ2wZFWj23PMihdwrNWv41OG/Qeat #3 is the button
Seat 2: XvUbOIg94d25feWeQlOTVg ($77 in chips)
Seat 3: TalCiLYHCd+ffkmR3auPvA ($62.80 in chips)
Seat 4: TSuRyAHnUPCFjP7Z0rEE0w ($118.75 in chips)
Seat 5: j7NIOHLZk7V2o9fOioO5ug ($111.60 in chips)
Seat 6: YsLQ3BAvgQHWXMAv3Wv6Hg ($145.75 in chips)
TSuRyAHnUPCFjP7Z0rEE0w: posts small blind $0.50
j7NIOHLZk7V2o9fOioO5ug: posts big blind $1
*** HOLE CARDS ***
YsLQ3BAvgQHWXMAv3Wv6Hg: folds
XvUbOIg94d25feWeQlOTVg: calls $1
TalCiLYHCd+ffkmR3auPvA: folds
TSuRyAHnUPCFjP7Z0rEE0w: folds
j7NIOHLZk7V2o9fOioO5ug: checks
*** FLOP *** [Kh Tc 4s]
j7NIOHLZk7V2o9fOioO5ug: checks
XvUbOIg94d25feWeQlOTVg: checks
*** TURN *** [Kh Tc 4s] [6c]
j7NIOHLZk7V2o9fOioO5ug: checks
XvUbOIg94d25feWeQlOTVg: checks
*** RIVER *** [Kh Tc 4s 6c] [5c]
j7NIOHLZk7V2o9fOioO5ug: checks
XvUbOIg94d25feWeQlOTVg: checks
*** SHOW DOWN ***
j7NIOHLZk7V2o9fOioO5ug: shows [Jh 2d] (high card King)
XvUbOIg94d25feWeQlOTVg: shows [7d 5d] (a pair of Fives)
XvUbOIg94d25feWeQlOTVg collected $2.40 from pot
*** SUMMARY ***
Total pot $2.50 | Rake $0.10
Board [Kh Tc 4s 6c 5c]
Seat 2: XvUbOIg94d25feWeQlOTVg showed [7d 5d] and won ($2.40) with a pair of Fives
Seat 3: TalCiLYHCd+ffkmR3auPvA (button) folded before Flop (didn't bet)
Seat 4: TSuRyAHnUPCFjP7Z0rEE0w (small blind) folded before Flop
Seat 5: j7NIOHLZk7V2o9fOioO5ug (big blind) showed [Jh 2d] and lost with high card King
Seat 6: YsLQ3BAvgQHWXMAv3Wv6Hg folded before Flop (didn't bet)



PokerStars Game #59939640758:  Hold'em No Limit ($0.50/$1.00) - 2009/07/01 0:45:06 ET
Table 'W/wyObTiXZm+Ckkl3YxcSw' 6-max Seat #2 is the button
Seat 1: eUBBn2R56C1IQ6Cs/vitwg ($108.70 in chips)
Seat 2: oDiBRCaF0QVtd3kO6xZIXw ($78.75 in chips)
Seat 3: ybGsYWp1MLwy1vSnP8egXg ($33 in chips)
Seat 4: +xW7QemQU0Fxs+4TnqBRow ($133.90 in chips)
Seat 5: BdbmJTZZ47quA9vUWwXtlw ($53.50 in chips)
ybGsYWp1MLwy1vSnP8egXg: posts small blind $0.50
+xW7QemQU0Fxs+4TnqBRow: posts big blind $1
*** HOLE CARDS ***
BdbmJTZZ47quA9vUWwXtlw: folds
eUBBn2R56C1IQ6Cs/vitwg: folds
oDiBRCaF0QVtd3kO6xZIXw: folds
ybGsYWp1MLwy1vSnP8egXg: folds
+xW7QemQU0Fxs+4TnqBRow collected $1 from pot
+xW7QemQU0Fxs+4TnqBRow: doesn't show hand
*** SUMMARY ***
Total pot $1 | Rake $0
Seat 1: eUBBn2R56C1IQ6Cs/vitwg folded before Flop (didn't bet)
Seat 2: oDiBRCaF0QVtd3kO6xZIXw (button) folded before Flop (didn't bet)
Seat 3: ybGsYWp1MLwy1vSnP8egXg (small blind) folded before Flop
Seat 4: +xW7QemQU0Fxs+4TnqBRow (big blind) collected ($1)
Seat 5: BdbmJTZZ47quA9vUWwXtlw folded before Flop (didn't bet)



PokerStars Game #59939640676:  Hold'em No Limit ($0.50/$1.00) - 2009/07/01 0:45:06 ET
Table 'Zka9tv1yilg0MvXWPQrShg' 9-max Seat #5 is the button
Seat 1: TZcz9MEWDA+WydgGruqqbw ($113.85 in chips)
Seat 3: gUUvmqdVlmvpal6B8nYrmg ($100 in chips)
Seat 4: stxmTgSicxShtrDxhOOX2g ($60 in chips)
Seat 5: /zy+DB4S5fUQUSfZWFzYGw ($130.90 in chips)
Seat 6: rY8wPoax1lS+HUY+I0FZDw ($147.30 in chips)
Seat 7: p1SafS90nb3Uft5LB0NkHw ($20 in chips)
Seat 8: bL+QVeDcuEdzMGAGg2XJHg ($117.60 in chips)
Seat 9: 6daxhj43mWj04MOPTOmaYA ($95.65 in chips)
rY8wPoax1lS+HUY+I0FZDw: posts small blind $0.50
p1SafS90nb3Uft5LB0NkHw: posts big blind $1
kz9ziSiGUc+857heiKSayw: sits out
stxmTgSicxShtrDxhOOX2g: posts big blind $1
*** HOLE CARDS ***
bL+QVeDcuEdzMGAGg2XJHg: folds
6daxhj43mWj04MOPTOmaYA: folds
TZcz9MEWDA+WydgGruqqbw: folds
gUUvmqdVlmvpal6B8nYrmg: folds
stxmTgSicxShtrDxhOOX2g: raises $1 to $2
/zy+DB4S5fUQUSfZWFzYGw: calls $2
rY8wPoax1lS+HUY+I0FZDw: calls $1.50
p1SafS90nb3Uft5LB0NkHw: calls $1
*** FLOP *** [8h 7d Ac]
rY8wPoax1lS+HUY+I0FZDw: checks
p1SafS90nb3Uft5LB0NkHw: checks
stxmTgSicxShtrDxhOOX2g: bets $4
/zy+DB4S5fUQUSfZWFzYGw: calls $4
rY8wPoax1lS+HUY+I0FZDw: folds
p1SafS90nb3Uft5LB0NkHw: folds
*** TURN *** [8h 7d Ac] [7s]
stxmTgSicxShtrDxhOOX2g: checks
/zy+DB4S5fUQUSfZWFzYGw: checks
*** RIVER *** [8h 7d Ac 7s] [2h]
stxmTgSicxShtrDxhOOX2g: bets $5
/zy+DB4S5fUQUSfZWFzYGw: folds
stxmTgSicxShtrDxhOOX2g collected $15.25 from pot
*** SUMMARY ***
Total pot $16 | Rake $0.75
Board [8h 7d Ac 7s 2h]
Seat 1: TZcz9MEWDA+WydgGruqqbw folded before Flop (didn't bet)
Seat 3: gUUvmqdVlmvpal6B8nYrmg folded before Flop (didn't bet)
Seat 4: stxmTgSicxShtrDxhOOX2g collected ($15.25)
Seat 5: /zy+DB4S5fUQUSfZWFzYGw (button) folded on the River
Seat 6: rY8wPoax1lS+HUY+I0FZDw (small blind) folded on the Flop
Seat 7: p1SafS90nb3Uft5LB0NkHw (big blind) folded on the Flop
Seat 8: bL+QVeDcuEdzMGAGg2XJHg folded before Flop (didn't bet)
Seat 9: 6daxhj43mWj04MOPTOmaYA folded before Flop (didn't bet)



PokerStars Game #59939641352:  Hold'em No Limit ($0.50/$1.00) - 2009/07/01 0:45:07 ET
Table 'QBLDswtHe7Ml0HwAdcMhlw' 2-max Seat #1 is the button
Seat 1: hdNlhiCwI533uwvvTTfC9Q ($123.50 in chips)
Seat 2: GBkvjkjDWVBEa1e14dh6CA ($44.90 in chips)
hdNlhiCwI533uwvvTTfC9Q: posts small blind $0.50
GBkvjkjDWVBEa1e14dh6CA: posts big blind $1
*** HOLE CARDS ***
hdNlhiCwI533uwvvTTfC9Q: raises $1 to $2
GBkvjkjDWVBEa1e14dh6CA: calls $1
*** FLOP *** [5d 2c 6c]
GBkvjkjDWVBEa1e14dh6CA: checks
hdNlhiCwI533uwvvTTfC9Q: checks
*** TURN *** [5d 2c 6c] [3h]
GBkvjkjDWVBEa1e14dh6CA: bets $3
hdNlhiCwI533uwvvTTfC9Q: folds
GBkvjkjDWVBEa1e14dh6CA collected $3.80 from pot
GBkvjkjDWVBEa1e14dh6CA: doesn't show hand
*** SUMMARY ***
Total pot $4 | Rake $0.20
Board [5d 2c 6c 3h]
Seat 1: hdNlhiCwI533uwvvTTfC9Q (button) (small blind) folded on the Turn
Seat 2: GBkvjkjDWVBEa1e14dh6CA (big blind) collected ($3.80)



PokerStars Game #59939640976:  Hold'em No Limit ($0.50/$1.00) - 2009/07/01 0:45:07 ET
Table 'GxCPo/gd3OSthkYrAxJngg' 6-max Seat #2 is the button
Seat 1: sH8BpAFP+jGFxCgVpD1Lew ($256.85 in chips)
Seat 2: YExX2paeIHrmfIwV1ivM/w ($78.20 in chips)
Seat 3: o6plE+MSW4XFNTeONe16xg ($31.60 in chips)
Seat 4: YMJG+F++3Aj6P8dAWda5fw ($106.65 in chips)
Seat 5: G5ZSSN6RSON3gkNvk/SmYg ($109.75 in chips)
Seat 6: sS9IXedL3MiRmpVXhAILhw ($101.95 in chips)
o6plE+MSW4XFNTeONe16xg: posts small blind $0.50
YMJG+F++3Aj6P8dAWda5fw: posts big blind $1
*** HOLE CARDS ***
G5ZSSN6RSON3gkNvk/SmYg: folds
sS9IXedL3MiRmpVXhAILhw: folds
sH8BpAFP+jGFxCgVpD1Lew: raises $3 to $4
YExX2paeIHrmfIwV1ivM/w: folds
o6plE+MSW4XFNTeONe16xg: folds
YMJG+F++3Aj6P8dAWda5fw: folds
sH8BpAFP+jGFxCgVpD1Lew collected $2.50 from pot
sH8BpAFP+jGFxCgVpD1Lew: doesn't show hand
*** SUMMARY ***
Total pot $2.50 | Rake $0
Seat 1: sH8BpAFP+jGFxCgVpD1Lew collected ($2.50)
Seat 2: YExX2paeIHrmfIwV1ivM/w (button) folded before Flop (didn't bet)
Seat 3: o6plE+MSW4XFNTeONe16xg (small blind) folded before Flop
Seat 4: YMJG+F++3Aj6P8dAWda5fw (big blind) folded before Flop
Seat 5: G5ZSSN6RSON3gkNvk/SmYg folded before Flop (didn't bet)
Seat 6: sS9IXedL3MiRmpVXhAILhw folded before Flop (didn't bet)



PokerStars Game #59939642416:  Hold'em No Limit ($0.50/$1.00) - 2009/07/01 0:45:09 ET
Table 'fTlPiCj0utgzC/5io+I7ew' 6-max Seat #2 is the button
Seat 1: YMJG+F++3Aj6P8dAWda5fw ($98 in chips)
Seat 2: Qy/UBNbD2HaA0Ogxg8Sf3w ($108.95 in chips)
Seat 3: oDiBRCaF0QVtd3kO6xZIXw ($82.60 in chips)
Seat 4: uJVSceLggtsrJya+WtmUEA ($97.30 in chips)
Seat 5: bFrTkDcWGTxyvNul7GVdYg ($253.70 in chips)
oDiBRCaF0QVtd3kO6xZIXw: posts small blind $0.50
uJVSceLggtsrJya+WtmUEA: posts big blind $1
*** HOLE CARDS ***
bFrTkDcWGTxyvNul7GVdYg: folds
YMJG+F++3Aj6P8dAWda5fw: raises $2 to $3
Qy/UBNbD2HaA0Ogxg8Sf3w: folds
oDiBRCaF0QVtd3kO6xZIXw: calls $2.50
uJVSceLggtsrJya+WtmUEA: raises $9 to $12
YMJG+F++3Aj6P8dAWda5fw: folds
oDiBRCaF0QVtd3kO6xZIXw: calls $9
*** FLOP *** [2d Js 8d]
oDiBRCaF0QVtd3kO6xZIXw: bets $14
uJVSceLggtsrJya+WtmUEA: folds
oDiBRCaF0QVtd3kO6xZIXw collected $25.65 from pot
*** SUMMARY ***
Total pot $27 | Rake $1.35
Board [2d Js 8d]
Seat 1: YMJG+F++3Aj6P8dAWda5fw folded before Flop
Seat 2: Qy/UBNbD2HaA0Ogxg8Sf3w (button) folded before Flop (didn't bet)
Seat 3: oDiBRCaF0QVtd3kO6xZIXw (small blind) collected ($25.65)
Seat 4: uJVSceLggtsrJya+WtmUEA (big blind) folded on the Flop
Seat 5: bFrTkDcWGTxyvNul7GVdYg folded before Flop (didn't bet)



PokerStars Game #59939642874:  Hold'em No Limit ($0.50/$1.00) - 2009/07/01 0:45:09 ET
Table 'VOs36P6NW+QyXeQ1B62kmA' 6-max Seat #1 is the button
Seat 1: AdLVjddOzm+sRNo1Bc3S6Q ($137.80 in chips)
Seat 2: KpnW5CcJ4Mg6MeclfKmLrw ($119.85 in chips)
Seat 3: TSuRyAHnUPCFjP7Z0rEE0w ($100 in chips)
Seat 4: w02zQzNydODiyV9THKgo9w ($36.80 in chips)
Seat 6: 6tvjsJrdmWg+g7FVrMnzXA ($79.40 in chips)
KpnW5CcJ4Mg6MeclfKmLrw: posts small blind $0.50
TSuRyAHnUPCFjP7Z0rEE0w: posts big blind $1
*** HOLE CARDS ***
w02zQzNydODiyV9THKgo9w: calls $1
6tvjsJrdmWg+g7FVrMnzXA: calls $1
AdLVjddOzm+sRNo1Bc3S6Q: folds
KpnW5CcJ4Mg6MeclfKmLrw: folds
TSuRyAHnUPCFjP7Z0rEE0w: checks
*** FLOP *** [6s Qd 2h]
TSuRyAHnUPCFjP7Z0rEE0w: checks
w02zQzNydODiyV9THKgo9w: checks
6tvjsJrdmWg+g7FVrMnzXA: checks
*** TURN *** [6s Qd 2h] [Ad]
AdLVjddOzm+sRNo1Bc3S6Q is disconnected
TSuRyAHnUPCFjP7Z0rEE0w: checks
w02zQzNydODiyV9THKgo9w: checks
AdLVjddOzm+sRNo1Bc3S6Q is connected
6tvjsJrdmWg+g7FVrMnzXA: bets $2
TSuRyAHnUPCFjP7Z0rEE0w: folds
w02zQzNydODiyV9THKgo9w: folds
6tvjsJrdmWg+g7FVrMnzXA collected $3.35 from pot
6tvjsJrdmWg+g7FVrMnzXA: doesn't show hand
*** SUMMARY ***
Total pot $3.50 | Rake $0.15
Board [6s Qd 2h Ad]
Seat 1: AdLVjddOzm+sRNo1Bc3S6Q (button) folded before Flop (didn't bet)
Seat 2: KpnW5CcJ4Mg6MeclfKmLrw (small blind) folded before Flop
Seat 3: TSuRyAHnUPCFjP7Z0rEE0w (big blind) folded on the Turn
Seat 4: w02zQzNydODiyV9THKgo9w folded on the Turn
Seat 6: 6tvjsJrdmWg+g7FVrMnzXA collected ($3.35)



PokerStars Game #59939643404:  Hold'em No Limit ($0.50/$1.00) - 2009/07/01 0:45:10 ET
Table 'MUPc8FEpe/nR0BKSeReX6Q' 6-max Seat #5 is the button
Seat 1: YsLQ3BAvgQHWXMAv3Wv6Hg ($113.85 in chips)
Seat 2: xAU6q2/cwmby2sxmA8VcmA ($121.30 in chips)
Seat 3: wx3sQGkVi2x9wJXuWNHPBw ($220.05 in chips)
Seat 4: ZA1bp6g8IwtTxkUE4eCjDQ ($181.05 in chips)
Seat 5: UBZQqpnJZdTYYY1FTb0rLA ($100 in chips)
Seat 6: oxnw0GLLpFanjhGkxfRSqA ($58.50 in chips)
oxnw0GLLpFanjhGkxfRSqA: posts small blind $0.50
YsLQ3BAvgQHWXMAv3Wv6Hg: posts big blind $1
*** HOLE CARDS ***
xAU6q2/cwmby2sxmA8VcmA: folds
wx3sQGkVi2x9wJXuWNHPBw: folds
ZA1bp6g8IwtTxkUE4eCjDQ: folds
UBZQqpnJZdTYYY1FTb0rLA: folds
oxnw0GLLpFanjhGkxfRSqA: folds
YsLQ3BAvgQHWXMAv3Wv6Hg collected $1 from pot
YsLQ3BAvgQHWXMAv3Wv6Hg: doesn't show hand
*** SUMMARY ***
Total pot $1 | Rake $0
Seat 1: YsLQ3BAvgQHWXMAv3Wv6Hg (big blind) collected ($1)
Seat 2: xAU6q2/cwmby2sxmA8VcmA folded before Flop (didn't bet)
Seat 3: wx3sQGkVi2x9wJXuWNHPBw folded before Flop (didn't bet)
Seat 4: ZA1bp6g8IwtTxkUE4eCjDQ folded before Flop (didn't bet)
Seat 5: UBZQqpnJZdTYYY1FTb0rLA (button) folded before Flop (didn't bet)
Seat 6: oxnw0GLLpFanjhGkxfRSqA (small blind) folded before Flop



PokerStars Game #59939643586:  Hold'em No Limit ($0.50/$1.00) - 2009/07/01 0:45:11 ET
Table 'U9zqzC8f3oTJ2ShXFgSSOA' 6-max Seat #1 is the button
Seat 1: +xW7QemQU0Fxs+4TnqBRow ($100 in chips)
Seat 3: yfXek8iJ7O4CFyqXrtGcfg ($20.55 in chips)
Seat 4: 33q95we0Etwgrm6guQGncw ($88.60 in chips)
Seat 5: KfwW5us6tydK81NYTtK1gw ($291.25 in chips)
Seat 6: aIxzFKdtpDSkUePKZy/niQ ($22.25 in chips)
yfXek8iJ7O4CFyqXrtGcfg: posts small blind $0.50
33q95we0Etwgrm6guQGncw: posts big blind $1
*** HOLE CARDS ***
KfwW5us6tydK81NYTtK1gw: folds
aIxzFKdtpDSkUePKZy/niQ: raises $2 to $3
+xW7QemQU0Fxs+4TnqBRow: folds
yfXek8iJ7O4CFyqXrtGcfg: calls $2.50
33q95we0Etwgrm6guQGncw: calls $2
*** FLOP *** [2c 5h 7s]
yfXek8iJ7O4CFyqXrtGcfg: checks
33q95we0Etwgrm6guQGncw: bets $3
JwCcjZl0bjJzG7hmE0dnTA joins the table at seat #2
aIxzFKdtpDSkUePKZy/niQ: raises $6 to $9
yfXek8iJ7O4CFyqXrtGcfg: folds
33q95we0Etwgrm6guQGncw: folds
aIxzFKdtpDSkUePKZy/niQ collected $14.30 from pot
*** SUMMARY ***
Total pot $15 | Rake $0.70
Board [2c 5h 7s]
Seat 1: +xW7QemQU0Fxs+4TnqBRow (button) folded before Flop (didn't bet)
Seat 3: yfXek8iJ7O4CFyqXrtGcfg (small blind) folded on the Flop
Seat 4: 33q95we0Etwgrm6guQGncw (big blind) folded on the Flop
Seat 5: KfwW5us6tydK81NYTtK1gw folded before Flop (didn't bet)
Seat 6: aIxzFKdtpDSkUePKZy/niQ collected ($14.30)



PokerStars Game #59939644752:  Hold'em No Limit ($0.50/$1.00) - 2009/07/01 0:45:12 ET
Table 'tJq9SfN1ywY0r03VBlWlwQ' 9-max Seat #6 is the button
Seat 1: wZsU+w9r7G66x93UuvBf1Q ($334.30 in chips)
Seat 2: RqkO8O/Y3qlc3PIuCAHjVg ($68.40 in chips)
Seat 3: FVs16t7GgfWgQWt4JxsObQ ($34.55 in chips)
Seat 4: bLbSOSmSOnqE0iTcH/5dxA ($111.70 in chips)
Seat 5: Ogn4JDV3mp4ZDKO49IFzKA ($19.90 in chips)
Seat 6: gUUvmqdVlmvpal6B8nYrmg ($126.05 in chips)
Seat 7: qVhRZ0PLZ95XRJHWAjXjOQ ($128.70 in chips)
Seat 8: G4DEhsZFmznGNVpy2SEocA ($20.50 in chips)
Seat 9: XE5QF1y74bpHog9JxWJMWQ ($104.20 in chips)
qVhRZ0PLZ95XRJHWAjXjOQ: posts small blind $0.50
G4DEhsZFmznGNVpy2SEocA: posts big blind $1
*** HOLE CARDS ***
XE5QF1y74bpHog9JxWJMWQ: folds
wZsU+w9r7G66x93UuvBf1Q: folds
RqkO8O/Y3qlc3PIuCAHjVg: folds
FVs16t7GgfWgQWt4JxsObQ: raises $2 to $3
bLbSOSmSOnqE0iTcH/5dxA: folds
Ogn4JDV3mp4ZDKO49IFzKA: folds
gUUvmqdVlmvpal6B8nYrmg: folds
qVhRZ0PLZ95XRJHWAjXjOQ: folds
G4DEhsZFmznGNVpy2SEocA: folds
FVs16t7GgfWgQWt4JxsObQ collected $2.50 from pot
*** SUMMARY ***
Total pot $2.50 | Rake $0
Seat 1: wZsU+w9r7G66x93UuvBf1Q folded before Flop (didn't bet)
Seat 2: RqkO8O/Y3qlc3PIuCAHjVg folded before Flop (didn't bet)
Seat 3: FVs16t7GgfWgQWt4JxsObQ collected ($2.50)
Seat 4: bLbSOSmSOnqE0iTcH/5dxA folded before Flop (didn't bet)
Seat 5: Ogn4JDV3mp4ZDKO49IFzKA folded before Flop (didn't bet)
Seat 6: gUUvmqdVlmvpal6B8nYrmg (button) folded before Flop (didn't bet)
Seat 7: qVhRZ0PLZ95XRJHWAjXjOQ (small blind) folded before Flop
Seat 8: G4DEhsZFmznGNVpy2SEocA (big blind) folded before Flop
Seat 9: XE5QF1y74bpHog9JxWJMWQ folded before Flop (didn't bet)



PokerStars Game #59939645234:  Hold'em No Limit ($0.50/$1.00) - 2009/07/01 0:45:13 ET
Table '/RZcOwpZpHQ+OwPwjsbnRw' 6-max Seat #1 is the button
Seat 1: Zboa6dColKGHBjLPUakZjw ($50.20 in chips)
Seat 2: +xW7QemQU0Fxs+4TnqBRow ($195 in chips)
Seat 3: XnT1yK2DD/5FL+0bwuEhqg ($49.45 in chips)
Seat 4: j7NIOHLZk7V2o9fOioO5ug ($101.50 in chips)
Seat 5: wx3sQGkVi2x9wJXuWNHPBw ($193.65 in chips)
Seat 6: XOIf9W+VAxhZqN+SYoyMKA ($288.55 in chips)
+xW7QemQU0Fxs+4TnqBRow: posts small blind $0.50
XnT1yK2DD/5FL+0bwuEhqg: posts big blind $1
*** HOLE CARDS ***
j7NIOHLZk7V2o9fOioO5ug: folds
wx3sQGkVi2x9wJXuWNHPBw: folds
XOIf9W+VAxhZqN+SYoyMKA: folds
Zboa6dColKGHBjLPUakZjw: raises $1 to $2
+xW7QemQU0Fxs+4TnqBRow: folds
XnT1yK2DD/5FL+0bwuEhqg: folds
Zboa6dColKGHBjLPUakZjw collected $2.50 from pot
Zboa6dColKGHBjLPUakZjw: doesn't show hand
*** SUMMARY ***
Total pot $2.50 | Rake $0
Seat 1: Zboa6dColKGHBjLPUakZjw (button) collected ($2.50)
Seat 2: +xW7QemQU0Fxs+4TnqBRow (small blind) folded before Flop
Seat 3: XnT1yK2DD/5FL+0bwuEhqg (big blind) folded before Flop
Seat 4: j7NIOHLZk7V2o9fOioO5ug folded before Flop (didn't bet)
Seat 5: wx3sQGkVi2x9wJXuWNHPBw folded before Flop (didn't bet)
Seat 6: XOIf9W+VAxhZqN+SYoyMKA folded before Flop (didn't bet)



PokerStars Game #59939647582:  Hold'em No Limit ($0.50/$1.00) - 2009/07/01 0:45:17 ET
Table 'eU3bWpDDg3Z+9R4m4iVmog' 6-max Seat #6 is the button
Seat 1: TSuRyAHnUPCFjP7Z0rEE0w ($190.15 in chips)
Seat 2: 8CAoOzhmB8n3nRFf3V4BTg ($97.80 in chips)
Seat 3: U6tnjwZRpTnM+YkqkCjwyQ ($191.15 in chips)
Seat 4: GDVIsbEJ/DOJsMKE4Asz0A ($66.10 in chips)
Seat 5: AdLVjddOzm+sRNo1Bc3S6Q ($111.45 in chips)
Seat 6: hpxXcmRkXXI9HE5+5/j/0Q ($120.45 in chips)
TSuRyAHnUPCFjP7Z0rEE0w: posts small blind $0.50
8CAoOzhmB8n3nRFf3V4BTg: posts big blind $1
*** HOLE CARDS ***
U6tnjwZRpTnM+YkqkCjwyQ: folds
GDVIsbEJ/DOJsMKE4Asz0A: folds
AdLVjddOzm+sRNo1Bc3S6Q: folds
hpxXcmRkXXI9HE5+5/j/0Q: folds
TSuRyAHnUPCFjP7Z0rEE0w: folds
8CAoOzhmB8n3nRFf3V4BTg collected $1 from pot
*** SUMMARY ***
Total pot $1 | Rake $0
Seat 1: TSuRyAHnUPCFjP7Z0rEE0w (small blind) folded before Flop
Seat 2: 8CAoOzhmB8n3nRFf3V4BTg (big blind) collected ($1)
Seat 3: U6tnjwZRpTnM+YkqkCjwyQ folded before Flop (didn't bet)
Seat 4: GDVIsbEJ/DOJsMKE4Asz0A folded before Flop (didn't bet)
Seat 5: AdLVjddOzm+sRNo1Bc3S6Q folded before Flop (didn't bet)
Seat 6: hpxXcmRkXXI9HE5+5/j/0Q (button) folded before Flop (didn't bet)



PokerStars Game #59939647648:  Hold'em No Limit ($0.50/$1.00) - 2009/07/01 0:45:17 ET
Table 'LmXQK9xy3awB+qsPzI21Mw' 2-max Seat #1 is the button
Seat 1: NYi6JFscYNrofSXy4sM+Yw ($243.15 in chips)
Seat 2: TME8GvochpQAo8cmJwWmvA ($90.85 in chips)
NYi6JFscYNrofSXy4sM+Yw: posts small blind $0.50
TME8GvochpQAo8cmJwWmvA: posts big blind $1
*** HOLE CARDS ***
NYi6JFscYNrofSXy4sM+Yw: raises $2 to $3
TME8GvochpQAo8cmJwWmvA: folds
NYi6JFscYNrofSXy4sM+Yw collected $2 from pot
NYi6JFscYNrofSXy4sM+Yw: doesn't show hand
*** SUMMARY ***
Total pot $2 | Rake $0
Seat 1: NYi6JFscYNrofSXy4sM+Yw (button) (small blind) collected ($2)
Seat 2: TME8GvochpQAo8cmJwWmvA (big blind) folded before Flop



PokerStars Game #59939647916:  Hold'em No Limit ($0.50/$1.00) - 2009/07/01 0:45:17 ET
Table 'SQLOQoANiHscJ8AL7zffbw' 9-max Seat #9 is the button
Seat 1: jPTRd6SpCp4xqAy2XQiTOw ($114.60 in chips)
Seat 2: /zy+DB4S5fUQUSfZWFzYGw ($276.35 in chips)
Seat 3: 0eFnow7+D7veCYQ+CG9FFw ($94.85 in chips)
Seat 4: N9n5Wc3s35DpCrOAUUNAaQ ($93.75 in chips)
Seat 5: L9njYvloJ1NdXjP8edHEAg ($107.05 in chips)
Seat 6: p5UKaxVobvptF0ANhR/q1A ($174.50 in chips)
Seat 7: bJckevFOcg//s0qyMQI6sQ ($100 in chips)
Seat 8: Pp/KTcXkfZKKUHkjyaLTdg ($28.50 in chips)
Seat 9: qJr25HAtvv1w/7IBvjMM3g ($230.25 in chips)
jPTRd6SpCp4xqAy2XQiTOw: posts small blind $0.50
/zy+DB4S5fUQUSfZWFzYGw: posts big blind $1
*** HOLE CARDS ***
0eFnow7+D7veCYQ+CG9FFw: folds
N9n5Wc3s35DpCrOAUUNAaQ: folds
L9njYvloJ1NdXjP8edHEAg: folds
p5UKaxVobvptF0ANhR/q1A: folds
bJckevFOcg//s0qyMQI6sQ: folds
Pp/KTcXkfZKKUHkjyaLTdg: raises $2.50 to $3.50
qJr25HAtvv1w/7IBvjMM3g: calls $3.50
jPTRd6SpCp4xqAy2XQiTOw: calls $3
/zy+DB4S5fUQUSfZWFzYGw: folds
*** FLOP *** [6h 9h Jh]
jPTRd6SpCp4xqAy2XQiTOw: checks
Pp/KTcXkfZKKUHkjyaLTdg: checks
qJr25HAtvv1w/7IBvjMM3g: bets $6
jPTRd6SpCp4xqAy2XQiTOw: folds
Pp/KTcXkfZKKUHkjyaLTdg: raises $19 to $25 and is all-in
qJr25HAtvv1w/7IBvjMM3g: calls $19
*** TURN *** [6h 9h Jh] [Td]
*** RIVER *** [6h 9h Jh Td] [Ks]
*** SHOW DOWN ***
Pp/KTcXkfZKKUHkjyaLTdg: shows [Qh Ac] (a straight, Ten to Ace)
qJr25HAtvv1w/7IBvjMM3g: mucks hand
Pp/KTcXkfZKKUHkjyaLTdg collected $58.50 from pot
*** SUMMARY ***
Total pot $61.50 | Rake $3
Board [6h 9h Jh Td Ks]
Seat 1: jPTRd6SpCp4xqAy2XQiTOw (small blind) folded on the Flop
Seat 2: /zy+DB4S5fUQUSfZWFzYGw (big blind) folded before Flop
Seat 3: 0eFnow7+D7veCYQ+CG9FFw folded before Flop (didn't bet)
Seat 4: N9n5Wc3s35DpCrOAUUNAaQ folded before Flop (didn't bet)
Seat 5: L9njYvloJ1NdXjP8edHEAg folded before Flop (didn't bet)
Seat 6: p5UKaxVobvptF0ANhR/q1A folded before Flop (didn't bet)
Seat 7: bJckevFOcg//s0qyMQI6sQ folded before Flop (didn't bet)
Seat 8: Pp/KTcXkfZKKUHkjyaLTdg showed [Qh Ac] and won ($58.50) with a straight, Ten to Ace
Seat 9: qJr25HAtvv1w/7IBvjMM3g (button) mucked



PokerStars Game #59939648490:  Hold'em No Limit ($0.50/$1.00) - 2009/07/01 0:45:18 ET
Table 'W/wyObTiXZm+Ckkl3YxcSw' 6-max Seat #3 is the button
Seat 1: eUBBn2R56C1IQ6Cs/vitwg ($108.70 in chips)
Seat 2: oDiBRCaF0QVtd3kO6xZIXw ($78.75 in chips)
Seat 3: ybGsYWp1MLwy1vSnP8egXg ($32.50 in chips)
Seat 4: +xW7QemQU0Fxs+4TnqBRow ($134.40 in chips)
Seat 5: BdbmJTZZ47quA9vUWwXtlw ($53.50 in chips)
+xW7QemQU0Fxs+4TnqBRow: posts small blind $0.50
BdbmJTZZ47quA9vUWwXtlw: posts big blind $1
*** HOLE CARDS ***
eUBBn2R56C1IQ6Cs/vitwg: folds
oDiBRCaF0QVtd3kO6xZIXw: folds
ybGsYWp1MLwy1vSnP8egXg: raises $3 to $4
+xW7QemQU0Fxs+4TnqBRow: folds
tS9JHB1h+FQ++qu8RwRNgg joins the table at seat #6
BdbmJTZZ47quA9vUWwXtlw: folds
ybGsYWp1MLwy1vSnP8egXg collected $2.50 from pot
*** SUMMARY ***
Total pot $2.50 | Rake $0
Seat 1: eUBBn2R56C1IQ6Cs/vitwg folded before Flop (didn't bet)
Seat 2: oDiBRCaF0QVtd3kO6xZIXw folded before Flop (didn't bet)
Seat 3: ybGsYWp1MLwy1vSnP8egXg (button) collected ($2.50)
Seat 4: +xW7QemQU0Fxs+4TnqBRow (small blind) folded before Flop
Seat 5: BdbmJTZZ47quA9vUWwXtlw (big blind) folded before Flop



PokerStars Game #59939650688:  Hold'em No Limit ($0.50/$1.00) - 2009/07/01 0:45:22 ET
Table 'rmZfTK+oSebeUPJNbWhdAA' 6-max Seat #6 is the button
Seat 1: xAU6q2/cwmby2sxmA8VcmA ($100 in chips)
Seat 2: z7O9PO/WEcqRouIydFhS9Q ($105.50 in chips)
Seat 3: 9yjOzGERLaEZS8CZ6YNHFg ($115.85 in chips)
Seat 5: 5lY8d6Cnm4HUkt/8FZSj4g ($85.75 in chips)
Seat 6: j7NIOHLZk7V2o9fOioO5ug ($132.50 in chips)
xAU6q2/cwmby2sxmA8VcmA: posts small blind $0.50
z7O9PO/WEcqRouIydFhS9Q: posts big blind $1
1/mIuXfgx1ZyVkodrmfQDw: sits out
*** HOLE CARDS ***
9yjOzGERLaEZS8CZ6YNHFg: folds
5lY8d6Cnm4HUkt/8FZSj4g: folds
j7NIOHLZk7V2o9fOioO5ug: raises $2 to $3
xAU6q2/cwmby2sxmA8VcmA: folds
z7O9PO/WEcqRouIydFhS9Q: folds
j7NIOHLZk7V2o9fOioO5ug collected $2.50 from pot
j7NIOHLZk7V2o9fOioO5ug: doesn't show hand
*** SUMMARY ***
Total pot $2.50 | Rake $0
Seat 1: xAU6q2/cwmby2sxmA8VcmA (small blind) folded before Flop
Seat 2: z7O9PO/WEcqRouIydFhS9Q (big blind) folded before Flop
Seat 3: 9yjOzGERLaEZS8CZ6YNHFg folded before Flop (didn't bet)
Seat 5: 5lY8d6Cnm4HUkt/8FZSj4g folded before Flop (didn't bet)
Seat 6: j7NIOHLZk7V2o9fOioO5ug (button) collected ($2.50)



PokerStars Game #59939651812:  Hold'em No Limit ($0.50/$1.00) - 2009/07/01 0:45:23 ET
Table 'LmXQK9xy3awB+qsPzI21Mw' 2-max Seat #2 is the button
Seat 1: NYi6JFscYNrofSXy4sM+Yw ($244.15 in chips)
Seat 2: TME8GvochpQAo8cmJwWmvA ($89.85 in chips)
TME8GvochpQAo8cmJwWmvA: posts small blind $0.50
NYi6JFscYNrofSXy4sM+Yw: posts big blind $1
*** HOLE CARDS ***
TME8GvochpQAo8cmJwWmvA: calls $0.50
NYi6JFscYNrofSXy4sM+Yw: raises $2 to $3
TME8GvochpQAo8cmJwWmvA: folds
NYi6JFscYNrofSXy4sM+Yw collected $2 from pot
NYi6JFscYNrofSXy4sM+Yw: doesn't show hand
*** SUMMARY ***
Total pot $2 | Rake $0
Seat 1: NYi6JFscYNrofSXy4sM+Yw (big blind) collected ($2)
Seat 2: TME8GvochpQAo8cmJwWmvA (button) (small blind) folded before Flop



PokerStars Game #59939653470:  Hold'em No Limit ($0.50/$1.00) - 2009/07/01 0:45:26 ET
Table 'CxlB0XELs5P0zDlOhlhAPw' 2-max Seat #1 is the button
Seat 1: +B2wRsLpIMFnVA7qiRoGfg ($29 in chips)
Seat 2: I4xAjioR1QwQ5TgX4Z1/qw ($52.70 in chips)
+B2wRsLpIMFnVA7qiRoGfg: posts small blind $0.50
I4xAjioR1QwQ5TgX4Z1/qw: posts big blind $1
*** HOLE CARDS ***
+B2wRsLpIMFnVA7qiRoGfg: raises $1 to $2
I4xAjioR1QwQ5TgX4Z1/qw: calls $1
*** FLOP *** [7d Kc 3h]
I4xAjioR1QwQ5TgX4Z1/qw: checks
+B2wRsLpIMFnVA7qiRoGfg: checks
*** TURN *** [7d Kc 3h] [8c]
I4xAjioR1QwQ5TgX4Z1/qw: checks
+B2wRsLpIMFnVA7qiRoGfg: bets $3
I4xAjioR1QwQ5TgX4Z1/qw: calls $3
*** RIVER *** [7d Kc 3h 8c] [4s]
I4xAjioR1QwQ5TgX4Z1/qw: checks
+B2wRsLpIMFnVA7qiRoGfg: bets $6
I4xAjioR1QwQ5TgX4Z1/qw: calls $6
*** SHOW DOWN ***
+B2wRsLpIMFnVA7qiRoGfg: shows [Ks 2h] (a pair of Kings)
I4xAjioR1QwQ5TgX4Z1/qw: mucks hand
+B2wRsLpIMFnVA7qiRoGfg collected $21.50 from pot
*** SUMMARY ***
Total pot $22 | Rake $0.50
Board [7d Kc 3h 8c 4s]
Seat 1: +B2wRsLpIMFnVA7qiRoGfg (button) (small blind) showed [Ks 2h] and won ($21.50) with a pair of Kings
Seat 2: I4xAjioR1QwQ5TgX4Z1/qw (big blind) mucked



PokerStars Game #59939653330:  Hold'em No Limit ($0.50/$1.00) - 2009/07/01 0:45:26 ET
Table 'vs/5jr6ciwjVQ5+Soc+u2A' 6-max Seat #1 is the button
Seat 1: 1C0rFAGdnnX4GWK9B0YPww ($25.20 in chips)
Seat 2: XOIf9W+VAxhZqN+SYoyMKA ($129.35 in chips)
Seat 3: G5ZSSN6RSON3gkNvk/SmYg ($150.50 in chips)
Seat 4: KpnW5CcJ4Mg6MeclfKmLrw ($100 in chips)
XOIf9W+VAxhZqN+SYoyMKA: posts small blind $0.50
G5ZSSN6RSON3gkNvk/SmYg: posts big blind $1
*** HOLE CARDS ***
hppygolcky56 joins the table at seat #6
KpnW5CcJ4Mg6MeclfKmLrw: folds
1C0rFAGdnnX4GWK9B0YPww: folds
XOIf9W+VAxhZqN+SYoyMKA: folds
G5ZSSN6RSON3gkNvk/SmYg collected $1 from pot
G5ZSSN6RSON3gkNvk/SmYg: doesn't show hand
*** SUMMARY ***
Total pot $1 | Rake $0
Seat 1: 1C0rFAGdnnX4GWK9B0YPww (button) folded before Flop (didn't bet)
Seat 2: XOIf9W+VAxhZqN+SYoyMKA (small blind) folded before Flop
Seat 3: G5ZSSN6RSON3gkNvk/SmYg (big blind) collected ($1)
Seat 4: KpnW5CcJ4Mg6MeclfKmLrw folded before Flop (didn't bet)



PokerStars Game #59939653838:  Hold'em No Limit ($0.50/$1.00) - 2009/07/01 0:45:27 ET
Table 'pHrhryH8jPNdQfY62f8v+g' 6-max Seat #4 is the button
Seat 1: fF4botNMr8/ieVPO1YYRLw ($45.85 in chips)
Seat 2: RqgF7gRoKgRNW8Zoi1ty4A ($125.65 in chips)
Seat 3: 8oS5O7iD/qnFXFXJrGIgNQ ($100 in chips)
Seat 4: wenbG7TaM3H7h5kn78OFNw ($61.70 in chips)
Seat 5: r1/R7y0Ortgoz4lccgW8VA ($29.15 in chips)
Seat 6: xAU6q2/cwmby2sxmA8VcmA ($115.25 in chips)
r1/R7y0Ortgoz4lccgW8VA: posts small blind $0.50
xAU6q2/cwmby2sxmA8VcmA: posts big blind $1
8oS5O7iD/qnFXFXJrGIgNQ: posts big blind $1
*** HOLE CARDS ***
fF4botNMr8/ieVPO1YYRLw: calls $1
RqgF7gRoKgRNW8Zoi1ty4A: raises $5 to $6
8oS5O7iD/qnFXFXJrGIgNQ: folds
wenbG7TaM3H7h5kn78OFNw: calls $6
r1/R7y0Ortgoz4lccgW8VA: folds
xAU6q2/cwmby2sxmA8VcmA: folds
fF4botNMr8/ieVPO1YYRLw: folds
*** FLOP *** [8c 9c Ad]
RqgF7gRoKgRNW8Zoi1ty4A: bets $9
wenbG7TaM3H7h5kn78OFNw: folds
RqgF7gRoKgRNW8Zoi1ty4A collected $14.75 from pot
*** SUMMARY ***
Total pot $15.50 | Rake $0.75
Board [8c 9c Ad]
Seat 1: fF4botNMr8/ieVPO1YYRLw folded before Flop
Seat 2: RqgF7gRoKgRNW8Zoi1ty4A collected ($14.75)
Seat 3: 8oS5O7iD/qnFXFXJrGIgNQ folded before Flop
Seat 4: wenbG7TaM3H7h5kn78OFNw (button) folded on the Flop
Seat 5: r1/R7y0Ortgoz4lccgW8VA (small blind) folded before Flop
Seat 6: xAU6q2/cwmby2sxmA8VcmA (big blind) folded before Flop



PokerStars Game #59939654464:  Hold'em No Limit ($0.50/$1.00) - 2009/07/01 0:45:27 ET
Table '+cA8mcmhaedZ7YcrDdhmeQ' 6-max Seat #3 is the button
Seat 1: lsLuWlcPA3Rh7kJVLzMh0Q ($290.50 in chips)
Seat 2: RqgF7gRoKgRNW8Zoi1ty4A ($101.50 in chips)
Seat 3: 7H5WkGzGvsv56y1iaqHvRg ($31.75 in chips)
Seat 4: LjL3AIERHn559yyW1mTUYQ ($172.30 in chips)
Seat 5: +7hFKAL0b0O/n8G72TclJA ($50 in chips)
Seat 6: YfsTQsY/fxb+YqbdclTHuw ($54.55 in chips)
LjL3AIERHn559yyW1mTUYQ: posts small blind $0.50
+7hFKAL0b0O/n8G72TclJA: posts big blind $1
*** HOLE CARDS ***
YfsTQsY/fxb+YqbdclTHuw: calls $1
lsLuWlcPA3Rh7kJVLzMh0Q: folds
RqgF7gRoKgRNW8Zoi1ty4A: folds
7H5WkGzGvsv56y1iaqHvRg: calls $1
LjL3AIERHn559yyW1mTUYQ: folds
+7hFKAL0b0O/n8G72TclJA: raises $3 to $4
YfsTQsY/fxb+YqbdclTHuw: calls $3
7H5WkGzGvsv56y1iaqHvRg: calls $3
*** FLOP *** [6c 8c 9c]
+7hFKAL0b0O/n8G72TclJA: bets $6
YfsTQsY/fxb+YqbdclTHuw: calls $6
7H5WkGzGvsv56y1iaqHvRg: calls $6
*** TURN *** [6c 8c 9c] [7h]
+7hFKAL0b0O/n8G72TclJA: checks
YfsTQsY/fxb+YqbdclTHuw: checks
7H5WkGzGvsv56y1iaqHvRg: checks
*** RIVER *** [6c 8c 9c 7h] [2h]
+7hFKAL0b0O/n8G72TclJA: checks
YfsTQsY/fxb+YqbdclTHuw: bets $8
7H5WkGzGvsv56y1iaqHvRg: calls $8
+7hFKAL0b0O/n8G72TclJA: folds
*** SHOW DOWN ***
YfsTQsY/fxb+YqbdclTHuw: shows [9s Kd] (a pair of Nines)
7H5WkGzGvsv56y1iaqHvRg: shows [Kh 9h] (a pair of Nines)
YfsTQsY/fxb+YqbdclTHuw collected $22.15 from pot
7H5WkGzGvsv56y1iaqHvRg collected $22.10 from pot
*** SUMMARY ***
Total pot $46.50 | Rake $2.25
Board [6c 8c 9c 7h 2h]
Seat 1: lsLuWlcPA3Rh7kJVLzMh0Q folded before Flop (didn't bet)
Seat 2: RqgF7gRoKgRNW8Zoi1ty4A folded before Flop (didn't bet)
Seat 3: 7H5WkGzGvsv56y1iaqHvRg (button) showed [Kh 9h] and won ($22.10) with a pair of Nines
Seat 4: LjL3AIERHn559yyW1mTUYQ (small blind) folded before Flop
Seat 5: +7hFKAL0b0O/n8G72TclJA (big blind) folded on the River
Seat 6: YfsTQsY/fxb+YqbdclTHuw showed [9s Kd] and won ($22.15) with a pair of Nines



PokerStars Game #59939654764:  Hold'em No Limit ($0.50/$1.00) - 2009/07/01 0:45:28 ET
Table 'MUPc8FEpe/nR0BKSeReX6Q' 6-max Seat #6 is the button
Seat 1: YsLQ3BAvgQHWXMAv3Wv6Hg ($114.35 in chips)
Seat 2: xAU6q2/cwmby2sxmA8VcmA ($121.30 in chips)
Seat 3: wx3sQGkVi2x9wJXuWNHPBw ($220.05 in chips)
Seat 4: ZA1bp6g8IwtTxkUE4eCjDQ ($181.05 in chips)
Seat 5: UBZQqpnJZdTYYY1FTb0rLA ($100 in chips)
Seat 6: oxnw0GLLpFanjhGkxfRSqA ($58 in chips)
YsLQ3BAvgQHWXMAv3Wv6Hg: posts small blind $0.50
xAU6q2/cwmby2sxmA8VcmA: posts big blind $1
*** HOLE CARDS ***
wx3sQGkVi2x9wJXuWNHPBw: folds
ZA1bp6g8IwtTxkUE4eCjDQ: raises $1 to $2
UBZQqpnJZdTYYY1FTb0rLA: folds
oxnw0GLLpFanjhGkxfRSqA: folds
YsLQ3BAvgQHWXMAv3Wv6Hg: folds
xAU6q2/cwmby2sxmA8VcmA: calls $1
*** FLOP *** [6d 4d 3d]
xAU6q2/cwmby2sxmA8VcmA: bets $4
ZA1bp6g8IwtTxkUE4eCjDQ: calls $4
*** TURN *** [6d 4d 3d] [5d]
xAU6q2/cwmby2sxmA8VcmA: bets $6
ZA1bp6g8IwtTxkUE4eCjDQ: calls $6
*** RIVER *** [6d 4d 3d 5d] [9h]
xAU6q2/cwmby2sxmA8VcmA: checks
ZA1bp6g8IwtTxkUE4eCjDQ: bets $30
xAU6q2/cwmby2sxmA8VcmA: folds
ZA1bp6g8IwtTxkUE4eCjDQ collected $23.35 from pot
ZA1bp6g8IwtTxkUE4eCjDQ: shows [5h 5c] (three of a kind, Fives)
*** SUMMARY ***
Total pot $24.50 | Rake $1.15
Board [6d 4d 3d 5d 9h]
Seat 1: YsLQ3BAvgQHWXMAv3Wv6Hg (small blind) folded before Flop
Seat 2: xAU6q2/cwmby2sxmA8VcmA (big blind) folded on the River
Seat 3: wx3sQGkVi2x9wJXuWNHPBw folded before Flop (didn't bet)
Seat 4: ZA1bp6g8IwtTxkUE4eCjDQ collected ($23.35)
Seat 5: UBZQqpnJZdTYYY1FTb0rLA folded before Flop (didn't bet)
Seat 6: oxnw0GLLpFanjhGkxfRSqA (button) folded before Flop (didn't bet)



PokerStars Game #59939655774:  Hold'em No Limit ($0.50/$1.00) - 2009/07/01 0:45:30 ET
Table 'QBLDswtHe7Ml0HwAdcMhlw' 2-max Seat #2 is the button
Seat 1: hdNlhiCwI533uwvvTTfC9Q ($121.50 in chips)
Seat 2: GBkvjkjDWVBEa1e14dh6CA ($46.70 in chips)
GBkvjkjDWVBEa1e14dh6CA: posts small blind $0.50
hdNlhiCwI533uwvvTTfC9Q: posts big blind $1
*** HOLE CARDS ***
GBkvjkjDWVBEa1e14dh6CA: raises $1 to $2
hdNlhiCwI533uwvvTTfC9Q: folds
GBkvjkjDWVBEa1e14dh6CA collected $2 from pot
GBkvjkjDWVBEa1e14dh6CA: doesn't show hand
*** SUMMARY ***
Total pot $2 | Rake $0
Seat 1: hdNlhiCwI533uwvvTTfC9Q (big blind) folded before Flop
Seat 2: GBkvjkjDWVBEa1e14dh6CA (button) (small blind) collected ($2)



PokerStars Game #59939656126:  Hold'em No Limit ($0.50/$1.00) - 2009/07/01 0:45:30 ET
Table '7Nl0ffnjeK44/vmeexh3MQ' 9-max Seat #5 is the button
Seat 1: s7D3Y+k4Cj4D1cXHv7oj+Q ($92.35 in chips)
Seat 2: kiakSwxX0e64PwYGAPQvLw ($31.85 in chips)
Seat 3: vR4IO10geOgvTW+LAUBv/A ($101.50 in chips)
Seat 4: bLbSOSmSOnqE0iTcH/5dxA ($100 in chips)
Seat 5: bL+QVeDcuEdzMGAGg2XJHg ($100 in chips)
Seat 6: FVs16t7GgfWgQWt4JxsObQ ($32 in chips)
Seat 7: 997ViqAtWn1FPjJqcffwcA ($100 in chips)
Seat 8: zanka7aAZkigmZpfopXxxA ($253.70 in chips)
Seat 9: ouwUBGRKnKK9uhn1G4Lf+A ($95 in chips)
FVs16t7GgfWgQWt4JxsObQ: posts small blind $0.50
997ViqAtWn1FPjJqcffwcA: posts big blind $1
*** HOLE CARDS ***
zanka7aAZkigmZpfopXxxA: folds
ouwUBGRKnKK9uhn1G4Lf+A: folds
s7D3Y+k4Cj4D1cXHv7oj+Q: folds
kiakSwxX0e64PwYGAPQvLw: raises $2 to $3
vR4IO10geOgvTW+LAUBv/A: folds
bLbSOSmSOnqE0iTcH/5dxA: folds
bL+QVeDcuEdzMGAGg2XJHg: folds
FVs16t7GgfWgQWt4JxsObQ: folds
997ViqAtWn1FPjJqcffwcA: folds
kiakSwxX0e64PwYGAPQvLw collected $2.50 from pot
*** SUMMARY ***
Total pot $2.50 | Rake $0
Seat 1: s7D3Y+k4Cj4D1cXHv7oj+Q folded before Flop (didn't bet)
Seat 2: kiakSwxX0e64PwYGAPQvLw collected ($2.50)
Seat 3: vR4IO10geOgvTW+LAUBv/A folded before Flop (didn't bet)
Seat 4: bLbSOSmSOnqE0iTcH/5dxA folded before Flop (didn't bet)
Seat 5: bL+QVeDcuEdzMGAGg2XJHg (button) folded before Flop (didn't bet)
Seat 6: FVs16t7GgfWgQWt4JxsObQ (small blind) folded before Flop
Seat 7: 997ViqAtWn1FPjJqcffwcA (big blind) folded before Flop
Seat 8: zanka7aAZkigmZpfopXxxA folded before Flop (didn't bet)
Seat 9: ouwUBGRKnKK9uhn1G4Lf+A folded before Flop (didn't bet)



PokerStars Game #59939657680:  Hold'em No Limit ($0.50/$1.00) - 2009/07/01 0:45:32 ET
Table 'LmXQK9xy3awB+qsPzI21Mw' 2-max Seat #1 is the button
Seat 1: NYi6JFscYNrofSXy4sM+Yw ($245.15 in chips)
Seat 2: TME8GvochpQAo8cmJwWmvA ($88.85 in chips)
NYi6JFscYNrofSXy4sM+Yw: posts small blind $0.50
TME8GvochpQAo8cmJwWmvA: posts big blind $1
*** HOLE CARDS ***
NYi6JFscYNrofSXy4sM+Yw: raises $1 to $2
TME8GvochpQAo8cmJwWmvA: calls $1
*** FLOP *** [7s 8c 6c]
TME8GvochpQAo8cmJwWmvA: checks
NYi6JFscYNrofSXy4sM+Yw: bets $2
TME8GvochpQAo8cmJwWmvA: calls $2
*** TURN *** [7s 8c 6c] [Kc]
TME8GvochpQAo8cmJwWmvA: bets $1
NYi6JFscYNrofSXy4sM+Yw: calls $1
*** RIVER *** [7s 8c 6c Kc] [3s]
TME8GvochpQAo8cmJwWmvA: bets $3
NYi6JFscYNrofSXy4sM+Yw: folds
TME8GvochpQAo8cmJwWmvA collected $9.55 from pot
TME8GvochpQAo8cmJwWmvA: doesn't show hand
*** SUMMARY ***
Total pot $10 | Rake $0.45
Board [7s 8c 6c Kc 3s]
Seat 1: NYi6JFscYNrofSXy4sM+Yw (button) (small blind) folded on the River
Seat 2: TME8GvochpQAo8cmJwWmvA (big blind) collected ($9.55)



PokerStars Game #59939658714:  Hold'em No Limit ($0.50/$1.00) - 2009/07/01 0:45:34 ET
Table 'N2bNCDHL96aCQDvZIh+yQQ' 6-max Seat #1 is the button
Seat 1: iHo1oDbrEVJ8nEGdaPrICw ($100 in chips)
Seat 2: KpnW5CcJ4Mg6MeclfKmLrw ($159.10 in chips)
Seat 3: Qy/UBNbD2HaA0Ogxg8Sf3w ($161.20 in chips)
Seat 4: uCqEjnxh2/vFBjKYkfTOkw ($168.90 in chips)
Seat 5: rHlMOfR7kpQQxe+PFQz0xQ ($29.25 in chips)
Seat 6: TSuRyAHnUPCFjP7Z0rEE0w ($100 in chips)
KpnW5CcJ4Mg6MeclfKmLrw: posts small blind $0.50
Qy/UBNbD2HaA0Ogxg8Sf3w: posts big blind $1
*** HOLE CARDS ***
uCqEjnxh2/vFBjKYkfTOkw: raises $3 to $4
rHlMOfR7kpQQxe+PFQz0xQ: folds
TSuRyAHnUPCFjP7Z0rEE0w: folds
iHo1oDbrEVJ8nEGdaPrICw: folds
KpnW5CcJ4Mg6MeclfKmLrw: folds
Qy/UBNbD2HaA0Ogxg8Sf3w: folds
uCqEjnxh2/vFBjKYkfTOkw collected $2.50 from pot
uCqEjnxh2/vFBjKYkfTOkw: doesn't show hand
*** SUMMARY ***
Total pot $2.50 | Rake $0
Seat 1: iHo1oDbrEVJ8nEGdaPrICw (button) folded before Flop (didn't bet)
Seat 2: KpnW5CcJ4Mg6MeclfKmLrw (small blind) folded before Flop
Seat 3: Qy/UBNbD2HaA0Ogxg8Sf3w (big blind) folded before Flop
Seat 4: uCqEjnxh2/vFBjKYkfTOkw collected ($2.50)
Seat 5: rHlMOfR7kpQQxe+PFQz0xQ folded before Flop (didn't bet)
Seat 6: TSuRyAHnUPCFjP7Z0rEE0w folded before Flop (didn't bet)



PokerStars Game #59939660704:  Hold'em No Limit ($0.50/$1.00) - 2009/07/01 0:45:37 ET
Table 'QBLDswtHe7Ml0HwAdcMhlw' 2-max Seat #1 is the button
Seat 1: hdNlhiCwI533uwvvTTfC9Q ($120.50 in chips)
Seat 2: GBkvjkjDWVBEa1e14dh6CA ($47.70 in chips)
hdNlhiCwI533uwvvTTfC9Q: posts small blind $0.50
GBkvjkjDWVBEa1e14dh6CA: posts big blind $1
*** HOLE CARDS ***
hdNlhiCwI533uwvvTTfC9Q: raises $1 to $2
GBkvjkjDWVBEa1e14dh6CA: raises $5 to $7
hdNlhiCwI533uwvvTTfC9Q: folds
GBkvjkjDWVBEa1e14dh6CA collected $4 from pot
GBkvjkjDWVBEa1e14dh6CA: doesn't show hand
*** SUMMARY ***
Total pot $4 | Rake $0
Seat 1: hdNlhiCwI533uwvvTTfC9Q (button) (small blind) folded before Flop
Seat 2: GBkvjkjDWVBEa1e14dh6CA (big blind) collected ($4)



PokerStars Game #59939660604:  Hold'em No Limit ($0.50/$1.00) - 2009/07/01 0:45:37 ET
Table '6YvsYDPNIDx2v5z3bJnwZQ' 9-max Seat #6 is the button
Seat 1: Ogn4JDV3mp4ZDKO49IFzKA ($18.70 in chips)
Seat 2: x80+i7DJL+81v3quj7KbNg ($20 in chips)
Seat 3: negfosHnGOZXSHpWDRKyBQ ($17.30 in chips)
Seat 4: kEr5NYB+JIG5+szcYMr6hA ($41.50 in chips)
Seat 5: mBRWbnUl8diyBO1qTJaNzw ($160.70 in chips)
Seat 6: uMPEfCcGCfsxmy53tVUMug ($104.60 in chips)
Seat 8: PSFxpXgPedVZyHSu2Zhb7Q ($95.15 in chips)
mae7OMTaJ/MFimNbZegCkg will be allowed to play after the button
PSFxpXgPedVZyHSu2Zhb7Q: posts small blind $0.50
jDwhY1kCdc6EkAHbT7PJMQ: is sitting out
Ogn4JDV3mp4ZDKO49IFzKA: posts big blind $1
*** HOLE CARDS ***
x80+i7DJL+81v3quj7KbNg: folds
negfosHnGOZXSHpWDRKyBQ: folds
kEr5NYB+JIG5+szcYMr6hA: folds
mBRWbnUl8diyBO1qTJaNzw: folds
uMPEfCcGCfsxmy53tVUMug: raises $2 to $3
PSFxpXgPedVZyHSu2Zhb7Q: calls $2.50
Ogn4JDV3mp4ZDKO49IFzKA: folds
*** FLOP *** [6c Qh As]
PSFxpXgPedVZyHSu2Zhb7Q: checks
uMPEfCcGCfsxmy53tVUMug: bets $4.65
PSFxpXgPedVZyHSu2Zhb7Q: raises $4.65 to $9.30
uMPEfCcGCfsxmy53tVUMug: folds
PSFxpXgPedVZyHSu2Zhb7Q collected $15.55 from pot
*** SUMMARY ***
Total pot $16.30 | Rake $0.75
Board [6c Qh As]
Seat 1: Ogn4JDV3mp4ZDKO49IFzKA (big blind) folded before Flop
Seat 2: x80+i7DJL+81v3quj7KbNg folded before Flop (didn't bet)
Seat 3: negfosHnGOZXSHpWDRKyBQ folded before Flop (didn't bet)
Seat 4: kEr5NYB+JIG5+szcYMr6hA folded before Flop (didn't bet)
Seat 5: mBRWbnUl8diyBO1qTJaNzw folded before Flop (didn't bet)
Seat 6: uMPEfCcGCfsxmy53tVUMug (button) folded on the Flop
Seat 8: PSFxpXgPedVZyHSu2Zhb7Q (small blind) collected ($15.55)



PokerStars Game #59939660876:  Hold'em No Limit ($0.50/$1.00) - 2009/07/01 0:45:38 ET
Table 'uNlePsyMIqzM691Xkrlk6Q' 9-max Seat #7 is the button
Seat 1: bLbSOSmSOnqE0iTcH/5dxA ($101.50 in chips)
Seat 2: +OqpStnt0FqbCfyHAWaLbg ($78.05 in chips)
Seat 3: h7qXkU57Bb8ZuPwMyxR8Ug ($31.50 in chips)
Seat 4: TZcz9MEWDA+WydgGruqqbw ($102.65 in chips)
Seat 5: 3obndzTJ6fECz8+wWhMd1w ($18.50 in chips)
Seat 6: uMPEfCcGCfsxmy53tVUMug ($109.10 in chips)
Seat 7: w6cw9nzN7AvkkHBVVjykoQ ($41.40 in chips)
Seat 8: laA8va+Yv8WuMqT1zdR91g ($100 in chips)
Seat 9: vR4IO10geOgvTW+LAUBv/A ($102.25 in chips)
laA8va+Yv8WuMqT1zdR91g: posts small blind $0.50
vR4IO10geOgvTW+LAUBv/A: posts big blind $1
*** HOLE CARDS ***
bLbSOSmSOnqE0iTcH/5dxA: folds
+OqpStnt0FqbCfyHAWaLbg: folds
h7qXkU57Bb8ZuPwMyxR8Ug: folds
TZcz9MEWDA+WydgGruqqbw: folds
3obndzTJ6fECz8+wWhMd1w: folds
uMPEfCcGCfsxmy53tVUMug: raises $2 to $3
w6cw9nzN7AvkkHBVVjykoQ: raises $3 to $6
laA8va+Yv8WuMqT1zdR91g: folds
vR4IO10geOgvTW+LAUBv/A: folds
uMPEfCcGCfsxmy53tVUMug: folds
w6cw9nzN7AvkkHBVVjykoQ collected $7.50 from pot
*** SUMMARY ***
Total pot $7.50 | Rake $0
Seat 1: bLbSOSmSOnqE0iTcH/5dxA folded before Flop (didn't bet)
Seat 2: +OqpStnt0FqbCfyHAWaLbg folded before Flop (didn't bet)
Seat 3: h7qXkU57Bb8ZuPwMyxR8Ug folded before Flop (didn't bet)
Seat 4: TZcz9MEWDA+WydgGruqqbw folded before Flop (didn't bet)
Seat 5: 3obndzTJ6fECz8+wWhMd1w folded before Flop (didn't bet)
Seat 6: uMPEfCcGCfsxmy53tVUMug folded before Flop
Seat 7: w6cw9nzN7AvkkHBVVjykoQ (button) collected ($7.50)
Seat 8: laA8va+Yv8WuMqT1zdR91g (small blind) folded before Flop
Seat 9: vR4IO10geOgvTW+LAUBv/A (big blind) folded before Flop



PokerStars Game #59939661538:  Hold'em No Limit ($0.50/$1.00) - 2009/07/01 0:45:39 ET
Table '/RZcOwpZpHQ+OwPwjsbnRw' 6-max Seat #2 is the button
Seat 1: Zboa6dColKGHBjLPUakZjw ($51.70 in chips)
Seat 2: +xW7QemQU0Fxs+4TnqBRow ($194.50 in chips)
Seat 3: XnT1yK2DD/5FL+0bwuEhqg ($48.45 in chips)
Seat 4: j7NIOHLZk7V2o9fOioO5ug ($101.50 in chips)
Seat 5: wx3sQGkVi2x9wJXuWNHPBw ($193.65 in chips)
Seat 6: XOIf9W+VAxhZqN+SYoyMKA ($288.55 in chips)
XnT1yK2DD/5FL+0bwuEhqg: posts small blind $0.50
j7NIOHLZk7V2o9fOioO5ug: posts big blind $1
*** HOLE CARDS ***
wx3sQGkVi2x9wJXuWNHPBw: folds
XOIf9W+VAxhZqN+SYoyMKA: folds
Zboa6dColKGHBjLPUakZjw: raises $2 to $3
+xW7QemQU0Fxs+4TnqBRow: folds
XnT1yK2DD/5FL+0bwuEhqg: folds
j7NIOHLZk7V2o9fOioO5ug: folds
Zboa6dColKGHBjLPUakZjw collected $2.50 from pot
*** SUMMARY ***
Total pot $2.50 | Rake $0
Seat 1: Zboa6dColKGHBjLPUakZjw collected ($2.50)
Seat 2: +xW7QemQU0Fxs+4TnqBRow (button) folded before Flop (didn't bet)
Seat 3: XnT1yK2DD/5FL+0bwuEhqg (small blind) folded before Flop
Seat 4: j7NIOHLZk7V2o9fOioO5ug (big blind) folded before Flop
Seat 5: wx3sQGkVi2x9wJXuWNHPBw folded before Flop (didn't bet)
Seat 6: XOIf9W+VAxhZqN+SYoyMKA folded before Flop (didn't bet)



PokerStars Game #59939661860:  Hold'em No Limit ($0.50/$1.00) - 2009/07/01 0:45:39 ET
Table 'cBDNutyLBKEk9+ptwsKmTw' 6-max Seat #1 is the button
Seat 1: xAU6q2/cwmby2sxmA8VcmA ($100 in chips)
Seat 2: 5lY8d6Cnm4HUkt/8FZSj4g ($105.80 in chips)
Seat 3: G5ZSSN6RSON3gkNvk/SmYg ($108.40 in chips)
Seat 4: 3q7F5QtzC30pSrn0nl9i+A ($36.70 in chips)
Seat 5: OGMLOcTNYZXZU81au7ztUw ($137.60 in chips)
Seat 6: NqVlOSH2lp+pp/TK3vvK5g ($49.90 in chips)
5lY8d6Cnm4HUkt/8FZSj4g: posts small blind $0.50
G5ZSSN6RSON3gkNvk/SmYg: posts big blind $1
*** HOLE CARDS ***
3q7F5QtzC30pSrn0nl9i+A: folds
OGMLOcTNYZXZU81au7ztUw: raises $2 to $3
NqVlOSH2lp+pp/TK3vvK5g: calls $3
xAU6q2/cwmby2sxmA8VcmA: folds
5lY8d6Cnm4HUkt/8FZSj4g: calls $2.50
G5ZSSN6RSON3gkNvk/SmYg: folds
*** FLOP *** [Ah 3h Ts]
5lY8d6Cnm4HUkt/8FZSj4g: checks
OGMLOcTNYZXZU81au7ztUw: checks
NqVlOSH2lp+pp/TK3vvK5g: checks
*** TURN *** [Ah 3h Ts] [Qh]
5lY8d6Cnm4HUkt/8FZSj4g: checks
OGMLOcTNYZXZU81au7ztUw: checks
NqVlOSH2lp+pp/TK3vvK5g: checks
*** RIVER *** [Ah 3h Ts Qh] [4d]
5lY8d6Cnm4HUkt/8FZSj4g: checks
OGMLOcTNYZXZU81au7ztUw: checks
NqVlOSH2lp+pp/TK3vvK5g: bets $1
5lY8d6Cnm4HUkt/8FZSj4g: folds
OGMLOcTNYZXZU81au7ztUw: calls $1
*** SHOW DOWN ***
NqVlOSH2lp+pp/TK3vvK5g: shows [9s Ks] (high card Ace)
OGMLOcTNYZXZU81au7ztUw: shows [7s 7h] (a pair of Sevens)
OGMLOcTNYZXZU81au7ztUw collected $11.45 from pot
*** SUMMARY ***
Total pot $12 | Rake $0.55
Board [Ah 3h Ts Qh 4d]
Seat 1: xAU6q2/cwmby2sxmA8VcmA (button) folded before Flop (didn't bet)
Seat 2: 5lY8d6Cnm4HUkt/8FZSj4g (small blind) folded on the River
Seat 3: G5ZSSN6RSON3gkNvk/SmYg (big blind) folded before Flop
Seat 4: 3q7F5QtzC30pSrn0nl9i+A folded before Flop (didn't bet)
Seat 5: OGMLOcTNYZXZU81au7ztUw showed [7s 7h] and won ($11.45) with a pair of Sevens
Seat 6: NqVlOSH2lp+pp/TK3vvK5g showed [9s Ks] and lost with high card Ace



PokerStars Game #59939662630:  Hold'em No Limit ($0.50/$1.00) - 2009/07/01 0:45:40 ET
Table 'GxCPo/gd3OSthkYrAxJngg' 6-max Seat #3 is the button
Seat 1: sH8BpAFP+jGFxCgVpD1Lew ($258.35 in chips)
Seat 2: YExX2paeIHrmfIwV1ivM/w ($78.20 in chips)
Seat 3: o6plE+MSW4XFNTeONe16xg ($31.10 in chips)
Seat 4: YMJG+F++3Aj6P8dAWda5fw ($105.65 in chips)
Seat 5: G5ZSSN6RSON3gkNvk/SmYg ($109.75 in chips)
Seat 6: sS9IXedL3MiRmpVXhAILhw ($101.95 in chips)
YMJG+F++3Aj6P8dAWda5fw: posts small blind $0.50
G5ZSSN6RSON3gkNvk/SmYg: posts big blind $1
*** HOLE CARDS ***
sS9IXedL3MiRmpVXhAILhw: folds
sH8BpAFP+jGFxCgVpD1Lew: raises $2 to $3
YExX2paeIHrmfIwV1ivM/w: folds
o6plE+MSW4XFNTeONe16xg: folds
YMJG+F++3Aj6P8dAWda5fw: folds
G5ZSSN6RSON3gkNvk/SmYg: folds
sH8BpAFP+jGFxCgVpD1Lew collected $2.50 from pot
*** SUMMARY ***
Total pot $2.50 | Rake $0
Seat 1: sH8BpAFP+jGFxCgVpD1Lew collected ($2.50)
Seat 2: YExX2paeIHrmfIwV1ivM/w folded before Flop (didn't bet)
Seat 3: o6plE+MSW4XFNTeONe16xg (button) folded before Flop (didn't bet)
Seat 4: YMJG+F++3Aj6P8dAWda5fw (small blind) folded before Flop
Seat 5: G5ZSSN6RSON3gkNvk/SmYg (big blind) folded before Flop
Seat 6: sS9IXedL3MiRmpVXhAILhw folded before Flop (didn't bet)



PokerStars Game #59939663174:  Hold'em No Limit ($0.50/$1.00) - 2009/07/01 0:45:41 ET
Table 'hugOjcwJvzEwZbK7tyiWuQ' 9-max Seat #2 is the button
Seat 1: N9n5Wc3s35DpCrOAUUNAaQ ($130 in chips)
Seat 2: r27C1nIV4NS4+qbnrgBQSw ($254.05 in chips)
Seat 3: jDwhY1kCdc6EkAHbT7PJMQ ($106.65 in chips)
Seat 4: UWB3oeddt/GObx2Mix2Anw ($205.75 in chips)
Seat 5: 5BRGWf+R3nt2WS3b5xX+zA ($24.80 in chips)
Seat 6: gUUvmqdVlmvpal6B8nYrmg ($107.70 in chips)
Seat 7: FL3MrLspcF23LYvC4ipBOA ($100 in chips)
Seat 8: /zy+DB4S5fUQUSfZWFzYGw ($101.25 in chips)
Seat 9: W8P9bUKCs43TO1xHm0dL6w ($88.15 in chips)
jDwhY1kCdc6EkAHbT7PJMQ: posts small blind $0.50
UWB3oeddt/GObx2Mix2Anw: posts big blind $1
*** HOLE CARDS ***
5BRGWf+R3nt2WS3b5xX+zA: calls $1
gUUvmqdVlmvpal6B8nYrmg: folds
FL3MrLspcF23LYvC4ipBOA: folds
/zy+DB4S5fUQUSfZWFzYGw: folds
W8P9bUKCs43TO1xHm0dL6w: folds
N9n5Wc3s35DpCrOAUUNAaQ: folds
r27C1nIV4NS4+qbnrgBQSw: raises $3 to $4
jDwhY1kCdc6EkAHbT7PJMQ: folds
UWB3oeddt/GObx2Mix2Anw: folds
5BRGWf+R3nt2WS3b5xX+zA: calls $3
*** FLOP *** [3c Qh Qd]
5BRGWf+R3nt2WS3b5xX+zA: checks
r27C1nIV4NS4+qbnrgBQSw: checks
*** TURN *** [3c Qh Qd] [4d]
5BRGWf+R3nt2WS3b5xX+zA: checks
r27C1nIV4NS4+qbnrgBQSw: bets $6.50
5BRGWf+R3nt2WS3b5xX+zA: folds
r27C1nIV4NS4+qbnrgBQSw collected $9.05 from pot
*** SUMMARY ***
Total pot $9.50 | Rake $0.45
Board [3c Qh Qd 4d]
Seat 1: N9n5Wc3s35DpCrOAUUNAaQ folded before Flop (didn't bet)
Seat 2: r27C1nIV4NS4+qbnrgBQSw (button) collected ($9.05)
Seat 3: jDwhY1kCdc6EkAHbT7PJMQ (small blind) folded before Flop
Seat 4: UWB3oeddt/GObx2Mix2Anw (big blind) folded before Flop
Seat 5: 5BRGWf+R3nt2WS3b5xX+zA folded on the Turn
Seat 6: gUUvmqdVlmvpal6B8nYrmg folded before Flop (didn't bet)
Seat 7: FL3MrLspcF23LYvC4ipBOA folded before Flop (didn't bet)
Seat 8: /zy+DB4S5fUQUSfZWFzYGw folded before Flop (didn't bet)
Seat 9: W8P9bUKCs43TO1xHm0dL6w folded before Flop (didn't bet)



PokerStars Game #59939666762:  Hold'em No Limit ($0.50/$1.00) - 2009/07/01 0:45:47 ET
Table 'rmZfTK+oSebeUPJNbWhdAA' 6-max Seat #1 is the button
Seat 1: xAU6q2/cwmby2sxmA8VcmA ($100 in chips)
Seat 2: z7O9PO/WEcqRouIydFhS9Q ($104.50 in chips)
Seat 3: 9yjOzGERLaEZS8CZ6YNHFg ($115.85 in chips)
Seat 5: 5lY8d6Cnm4HUkt/8FZSj4g ($85.75 in chips)
Seat 6: j7NIOHLZk7V2o9fOioO5ug ($134 in chips)
z7O9PO/WEcqRouIydFhS9Q: posts small blind $0.50
9yjOzGERLaEZS8CZ6YNHFg: posts big blind $1
1/mIuXfgx1ZyVkodrmfQDw: sits out
*** HOLE CARDS ***
5lY8d6Cnm4HUkt/8FZSj4g: calls $1
j7NIOHLZk7V2o9fOioO5ug: calls $1
xAU6q2/cwmby2sxmA8VcmA: folds
z7O9PO/WEcqRouIydFhS9Q: calls $0.50
9yjOzGERLaEZS8CZ6YNHFg: checks
*** FLOP *** [4s Qh 2d]
z7O9PO/WEcqRouIydFhS9Q: checks
9yjOzGERLaEZS8CZ6YNHFg: checks
5lY8d6Cnm4HUkt/8FZSj4g: checks
j7NIOHLZk7V2o9fOioO5ug: bets $4
z7O9PO/WEcqRouIydFhS9Q: folds
9yjOzGERLaEZS8CZ6YNHFg: folds
5lY8d6Cnm4HUkt/8FZSj4g: folds
j7NIOHLZk7V2o9fOioO5ug collected $3.80 from pot
j7NIOHLZk7V2o9fOioO5ug: doesn't show hand
*** SUMMARY ***
Total pot $4 | Rake $0.20
Board [4s Qh 2d]
Seat 1: xAU6q2/cwmby2sxmA8VcmA (button) folded before Flop (didn't bet)
Seat 2: z7O9PO/WEcqRouIydFhS9Q (small blind) folded on the Flop
Seat 3: 9yjOzGERLaEZS8CZ6YNHFg (big blind) folded on the Flop
Seat 5: 5lY8d6Cnm4HUkt/8FZSj4g folded on the Flop
Seat 6: j7NIOHLZk7V2o9fOioO5ug collected ($3.80)



PokerStars Game #59939667750:  Hold'em No Limit ($0.50/$1.00) - 2009/07/01 0:45:48 ET
Table 'U9zqzC8f3oTJ2ShXFgSSOA' 6-max Seat #3 is the button
Seat 1: +xW7QemQU0Fxs+4TnqBRow ($100 in chips)
Seat 3: yfXek8iJ7O4CFyqXrtGcfg ($17.55 in chips)
Seat 4: 33q95we0Etwgrm6guQGncw ($82.60 in chips)
Seat 5: KfwW5us6tydK81NYTtK1gw ($291.25 in chips)
Seat 6: aIxzFKdtpDSkUePKZy/niQ ($30.55 in chips)
33q95we0Etwgrm6guQGncw: posts small blind $0.50
KfwW5us6tydK81NYTtK1gw: posts big blind $1
JwCcjZl0bjJzG7hmE0dnTA: sits out
*** HOLE CARDS ***
aIxzFKdtpDSkUePKZy/niQ: folds
+xW7QemQU0Fxs+4TnqBRow: folds
yfXek8iJ7O4CFyqXrtGcfg: raises $2 to $3
33q95we0Etwgrm6guQGncw: calls $2.50
KfwW5us6tydK81NYTtK1gw: folds
*** FLOP *** [7s 9d 9c]
33q95we0Etwgrm6guQGncw: checks
yfXek8iJ7O4CFyqXrtGcfg: checks
*** TURN *** [7s 9d 9c] [7c]
33q95we0Etwgrm6guQGncw: checks
yfXek8iJ7O4CFyqXrtGcfg: checks
*** RIVER *** [7s 9d 9c 7c] [Jh]
33q95we0Etwgrm6guQGncw: bets $3
yfXek8iJ7O4CFyqXrtGcfg: folds
33q95we0Etwgrm6guQGncw collected $6.65 from pot
33q95we0Etwgrm6guQGncw: doesn't show hand
*** SUMMARY ***
Total pot $7 | Rake $0.35
Board [7s 9d 9c 7c Jh]
Seat 1: +xW7QemQU0Fxs+4TnqBRow folded before Flop (didn't bet)
Seat 3: yfXek8iJ7O4CFyqXrtGcfg (button) folded on the River
Seat 4: 33q95we0Etwgrm6guQGncw (small blind) collected ($6.65)
Seat 5: KfwW5us6tydK81NYTtK1gw (big blind) folded before Flop
Seat 6: aIxzFKdtpDSkUePKZy/niQ folded before Flop (didn't bet)



PokerStars Game #59939668164:  Hold'em No Limit ($0.50/$1.00) - 2009/07/01 0:45:49 ET
Table 'vs/5jr6ciwjVQ5+Soc+u2A' 6-max Seat #2 is the button
Seat 1: 1C0rFAGdnnX4GWK9B0YPww ($25.20 in chips)
Seat 2: XOIf9W+VAxhZqN+SYoyMKA ($128.85 in chips)
Seat 3: G5ZSSN6RSON3gkNvk/SmYg ($151 in chips)
Seat 4: KpnW5CcJ4Mg6MeclfKmLrw ($100 in chips)
G5ZSSN6RSON3gkNvk/SmYg: posts small blind $0.50
KpnW5CcJ4Mg6MeclfKmLrw: posts big blind $1
hppygolcky56: sits out
*** HOLE CARDS ***
1C0rFAGdnnX4GWK9B0YPww: folds
XOIf9W+VAxhZqN+SYoyMKA: folds
G5ZSSN6RSON3gkNvk/SmYg: folds
KpnW5CcJ4Mg6MeclfKmLrw collected $1 from pot
KpnW5CcJ4Mg6MeclfKmLrw: doesn't show hand
*** SUMMARY ***
Total pot $1 | Rake $0
Seat 1: 1C0rFAGdnnX4GWK9B0YPww folded before Flop (didn't bet)
Seat 2: XOIf9W+VAxhZqN+SYoyMKA (button) folded before Flop (didn't bet)
Seat 3: G5ZSSN6RSON3gkNvk/SmYg (small blind) folded before Flop
Seat 4: KpnW5CcJ4Mg6MeclfKmLrw (big blind) collected ($1)



PokerStars Game #59939668434:  Hold'em No Limit ($0.50/$1.00) - 2009/07/01 0:45:49 ET
Table 'W/wyObTiXZm+Ckkl3YxcSw' 6-max Seat #4 is the button
Seat 1: eUBBn2R56C1IQ6Cs/vitwg ($108.70 in chips)
Seat 2: oDiBRCaF0QVtd3kO6xZIXw ($78.75 in chips)
Seat 3: ybGsYWp1MLwy1vSnP8egXg ($34 in chips)
Seat 4: +xW7QemQU0Fxs+4TnqBRow ($133.90 in chips)
Seat 5: BdbmJTZZ47quA9vUWwXtlw ($52.50 in chips)
Seat 6: tS9JHB1h+FQ++qu8RwRNgg ($29 in chips)
BdbmJTZZ47quA9vUWwXtlw: posts small blind $0.50
tS9JHB1h+FQ++qu8RwRNgg: posts big blind $1
*** HOLE CARDS ***
eUBBn2R56C1IQ6Cs/vitwg: raises $3 to $4
oDiBRCaF0QVtd3kO6xZIXw: folds
ybGsYWp1MLwy1vSnP8egXg: calls $4
+xW7QemQU0Fxs+4TnqBRow: folds
BdbmJTZZ47quA9vUWwXtlw: folds
tS9JHB1h+FQ++qu8RwRNgg: folds
*** FLOP *** [3s 2h Tc]
eUBBn2R56C1IQ6Cs/vitwg: bets $7
ybGsYWp1MLwy1vSnP8egXg: folds
eUBBn2R56C1IQ6Cs/vitwg collected $9.05 from pot
*** SUMMARY ***
Total pot $9.50 | Rake $0.45
Board [3s 2h Tc]
Seat 1: eUBBn2R56C1IQ6Cs/vitwg collected ($9.05)
Seat 2: oDiBRCaF0QVtd3kO6xZIXw folded before Flop (didn't bet)
Seat 3: ybGsYWp1MLwy1vSnP8egXg folded on the Flop
Seat 4: +xW7QemQU0Fxs+4TnqBRow (button) folded before Flop (didn't bet)
Seat 5: BdbmJTZZ47quA9vUWwXtlw (small blind) folded before Flop
Seat 6: tS9JHB1h+FQ++qu8RwRNgg (big blind) folded before Flop



PokerStars Game #59939667784:  Hold'em No Limit ($0.50/$1.00) - 2009/07/01 0:45:49 ET
Table 'eU3bWpDDg3Z+9R4m4iVmog' 6-max Seat #1 is the button
Seat 1: TSuRyAHnUPCFjP7Z0rEE0w ($189.65 in chips)
Seat 2: 8CAoOzhmB8n3nRFf3V4BTg ($98.30 in chips)
Seat 3: U6tnjwZRpTnM+YkqkCjwyQ ($191.15 in chips)
Seat 4: GDVIsbEJ/DOJsMKE4Asz0A ($66.10 in chips)
Seat 5: AdLVjddOzm+sRNo1Bc3S6Q ($111.45 in chips)
Seat 6: hpxXcmRkXXI9HE5+5/j/0Q ($120.45 in chips)
8CAoOzhmB8n3nRFf3V4BTg: posts small blind $0.50
U6tnjwZRpTnM+YkqkCjwyQ: posts big blind $1
*** HOLE CARDS ***
GDVIsbEJ/DOJsMKE4Asz0A: folds
AdLVjddOzm+sRNo1Bc3S6Q is disconnected
AdLVjddOzm+sRNo1Bc3S6Q is connected
AdLVjddOzm+sRNo1Bc3S6Q: folds
hpxXcmRkXXI9HE5+5/j/0Q: raises $2 to $3
TSuRyAHnUPCFjP7Z0rEE0w: folds
8CAoOzhmB8n3nRFf3V4BTg: folds
U6tnjwZRpTnM+YkqkCjwyQ: folds
hpxXcmRkXXI9HE5+5/j/0Q collected $2.50 from pot
hpxXcmRkXXI9HE5+5/j/0Q: doesn't show hand
*** SUMMARY ***
Total pot $2.50 | Rake $0
Seat 1: TSuRyAHnUPCFjP7Z0rEE0w (button) folded before Flop (didn't bet)
Seat 2: 8CAoOzhmB8n3nRFf3V4BTg (small blind) folded before Flop
Seat 3: U6tnjwZRpTnM+YkqkCjwyQ (big blind) folded before Flop
Seat 4: GDVIsbEJ/DOJsMKE4Asz0A folded before Flop (didn't bet)
Seat 5: AdLVjddOzm+sRNo1Bc3S6Q folded before Flop (didn't bet)
Seat 6: hpxXcmRkXXI9HE5+5/j/0Q collected ($2.50)



PokerStars Game #59939669310:  Hold'em No Limit ($0.50/$1.00) - 2009/07/01 0:45:51 ET
Table 'LmXQK9xy3awB+qsPzI21Mw' 2-max Seat #2 is the button
Seat 1: NYi6JFscYNrofSXy4sM+Yw ($240.15 in chips)
Seat 2: TME8GvochpQAo8cmJwWmvA ($93.40 in chips)
TME8GvochpQAo8cmJwWmvA: posts small blind $0.50
NYi6JFscYNrofSXy4sM+Yw: posts big blind $1
*** HOLE CARDS ***
TME8GvochpQAo8cmJwWmvA: calls $0.50
NYi6JFscYNrofSXy4sM+Yw: raises $2 to $3
TME8GvochpQAo8cmJwWmvA: calls $2
*** FLOP *** [Qh 9c 9d]
NYi6JFscYNrofSXy4sM+Yw: bets $3
TME8GvochpQAo8cmJwWmvA: calls $3
*** TURN *** [Qh 9c 9d] [Qc]
NYi6JFscYNrofSXy4sM+Yw: checks
TME8GvochpQAo8cmJwWmvA: bets $4
NYi6JFscYNrofSXy4sM+Yw: folds
TME8GvochpQAo8cmJwWmvA collected $11.50 from pot
TME8GvochpQAo8cmJwWmvA: doesn't show hand
*** SUMMARY ***
Total pot $12 | Rake $0.50
Board [Qh 9c 9d Qc]
Seat 1: NYi6JFscYNrofSXy4sM+Yw (big blind) folded on the Turn
Seat 2: TME8GvochpQAo8cmJwWmvA (button) (small blind) collected ($11.50)



PokerStars Game #59939671754:  Hold'em No Limit ($0.50/$1.00) - 2009/07/01 0:45:55 ET
Table '/RZcOwpZpHQ+OwPwjsbnRw' 6-max Seat #3 is the button
Seat 1: Zboa6dColKGHBjLPUakZjw ($53.20 in chips)
Seat 2: +xW7QemQU0Fxs+4TnqBRow ($194.50 in chips)
Seat 3: XnT1yK2DD/5FL+0bwuEhqg ($47.95 in chips)
Seat 4: j7NIOHLZk7V2o9fOioO5ug ($100.50 in chips)
Seat 5: wx3sQGkVi2x9wJXuWNHPBw ($193.65 in chips)
Seat 6: XOIf9W+VAxhZqN+SYoyMKA ($288.55 in chips)
j7NIOHLZk7V2o9fOioO5ug: posts small blind $0.50
wx3sQGkVi2x9wJXuWNHPBw: posts big blind $1
*** HOLE CARDS ***
XOIf9W+VAxhZqN+SYoyMKA: folds
Zboa6dColKGHBjLPUakZjw: raises $2 to $3
+xW7QemQU0Fxs+4TnqBRow: folds
XnT1yK2DD/5FL+0bwuEhqg: calls $3
j7NIOHLZk7V2o9fOioO5ug: raises $9 to $12
wx3sQGkVi2x9wJXuWNHPBw: folds
Zboa6dColKGHBjLPUakZjw: calls $9
XnT1yK2DD/5FL+0bwuEhqg: folds
*** FLOP *** [3s Th Jc]
j7NIOHLZk7V2o9fOioO5ug: bets $17
Zboa6dColKGHBjLPUakZjw: folds
j7NIOHLZk7V2o9fOioO5ug collected $26.60 from pot
j7NIOHLZk7V2o9fOioO5ug: doesn't show hand
*** SUMMARY ***
Total pot $28 | Rake $1.40
Board [3s Th Jc]
Seat 1: Zboa6dColKGHBjLPUakZjw folded on the Flop
Seat 2: +xW7QemQU0Fxs+4TnqBRow folded before Flop (didn't bet)
Seat 3: XnT1yK2DD/5FL+0bwuEhqg (button) folded before Flop
Seat 4: j7NIOHLZk7V2o9fOioO5ug (small blind) collected ($26.60)
Seat 5: wx3sQGkVi2x9wJXuWNHPBw (big blind) folded before Flop
Seat 6: XOIf9W+VAxhZqN+SYoyMKA folded before Flop (didn't bet)



PokerStars Game #59939672104:  Hold'em No Limit ($0.50/$1.00) - 2009/07/01 0:45:55 ET
Table 'tJq9SfN1ywY0r03VBlWlwQ' 9-max Seat #7 is the button
Seat 1: wZsU+w9r7G66x93UuvBf1Q ($334.30 in chips)
Seat 2: RqkO8O/Y3qlc3PIuCAHjVg ($68.40 in chips)
Seat 3: FVs16t7GgfWgQWt4JxsObQ ($36.05 in chips)
Seat 4: bLbSOSmSOnqE0iTcH/5dxA ($111.70 in chips)
Seat 5: Ogn4JDV3mp4ZDKO49IFzKA ($19.90 in chips)
Seat 6: gUUvmqdVlmvpal6B8nYrmg ($126.05 in chips)
Seat 7: qVhRZ0PLZ95XRJHWAjXjOQ ($128.20 in chips)
Seat 8: G4DEhsZFmznGNVpy2SEocA ($19.50 in chips)
Seat 9: XE5QF1y74bpHog9JxWJMWQ ($104.20 in chips)
G4DEhsZFmznGNVpy2SEocA: posts small blind $0.50
XE5QF1y74bpHog9JxWJMWQ: posts big blind $1
*** HOLE CARDS ***
wZsU+w9r7G66x93UuvBf1Q: raises $3 to $4
RqkO8O/Y3qlc3PIuCAHjVg: folds
FVs16t7GgfWgQWt4JxsObQ: folds
bLbSOSmSOnqE0iTcH/5dxA: folds
Ogn4JDV3mp4ZDKO49IFzKA: folds
gUUvmqdVlmvpal6B8nYrmg: folds
qVhRZ0PLZ95XRJHWAjXjOQ: folds
G4DEhsZFmznGNVpy2SEocA: folds
XE5QF1y74bpHog9JxWJMWQ: folds
wZsU+w9r7G66x93UuvBf1Q collected $2.50 from pot
*** SUMMARY ***
Total pot $2.50 | Rake $0
Seat 1: wZsU+w9r7G66x93UuvBf1Q collected ($2.50)
Seat 2: RqkO8O/Y3qlc3PIuCAHjVg folded before Flop (didn't bet)
Seat 3: FVs16t7GgfWgQWt4JxsObQ folded before Flop (didn't bet)
Seat 4: bLbSOSmSOnqE0iTcH/5dxA folded before Flop (didn't bet)
Seat 5: Ogn4JDV3mp4ZDKO49IFzKA folded before Flop (didn't bet)
Seat 6: gUUvmqdVlmvpal6B8nYrmg folded before Flop (didn't bet)
Seat 7: qVhRZ0PLZ95XRJHWAjXjOQ (button) folded before Flop (didn't bet)
Seat 8: G4DEhsZFmznGNVpy2SEocA (small blind) folded before Flop
Seat 9: XE5QF1y74bpHog9JxWJMWQ (big blind) folded before Flop



PokerStars Game #59939673728:  Hold'em No Limit ($0.50/$1.00) - 2009/07/01 0:45:58 ET
Table 'GPp0HyAuggN8oE0sUWzPpA' 9-max Seat #7 is the button
Seat 1: qJr25HAtvv1w/7IBvjMM3g ($20.35 in chips)
Seat 2: Ogn4JDV3mp4ZDKO49IFzKA ($34.20 in chips)
Seat 3: L9njYvloJ1NdXjP8edHEAg ($100 in chips)
Seat 4: mBRWbnUl8diyBO1qTJaNzw ($109.70 in chips)
Seat 5: 0fXz44fzDo5QmhAaJCvFfA ($19.30 in chips)
Seat 6: BK/GtNPkSx0TdUDj82id5A ($20 in chips)
Seat 7: laA8va+Yv8WuMqT1zdR91g ($100 in chips)
Seat 8: tkdBeXTJlFsZdioidNqLow ($70.20 in chips)
Seat 9: VPF+HjszMvUIpy0CHIwH3A ($20 in chips)
tkdBeXTJlFsZdioidNqLow: posts small blind $0.50
VPF+HjszMvUIpy0CHIwH3A: posts big blind $1
BK/GtNPkSx0TdUDj82id5A: posts big blind $1
*** HOLE CARDS ***
qJr25HAtvv1w/7IBvjMM3g: calls $1
Ogn4JDV3mp4ZDKO49IFzKA: folds
L9njYvloJ1NdXjP8edHEAg: folds
mBRWbnUl8diyBO1qTJaNzw: folds
0fXz44fzDo5QmhAaJCvFfA: folds
BK/GtNPkSx0TdUDj82id5A: raises $3 to $4
laA8va+Yv8WuMqT1zdR91g: folds
tkdBeXTJlFsZdioidNqLow: folds
VPF+HjszMvUIpy0CHIwH3A: folds
qJr25HAtvv1w/7IBvjMM3g: calls $3
*** FLOP *** [3h 2c 8d]
qJr25HAtvv1w/7IBvjMM3g: checks
BK/GtNPkSx0TdUDj82id5A: bets $4
qJr25HAtvv1w/7IBvjMM3g: calls $4
*** TURN *** [3h 2c 8d] [Qh]
qJr25HAtvv1w/7IBvjMM3g: checks
BK/GtNPkSx0TdUDj82id5A: checks
*** RIVER *** [3h 2c 8d Qh] [6h]
qJr25HAtvv1w/7IBvjMM3g: bets $12
BK/GtNPkSx0TdUDj82id5A: folds
qJr25HAtvv1w/7IBvjMM3g collected $16.65 from pot
*** SUMMARY ***
Total pot $17.50 | Rake $0.85
Board [3h 2c 8d Qh 6h]
Seat 1: qJr25HAtvv1w/7IBvjMM3g collected ($16.65)
Seat 2: Ogn4JDV3mp4ZDKO49IFzKA folded before Flop (didn't bet)
Seat 3: L9njYvloJ1NdXjP8edHEAg folded before Flop (didn't bet)
Seat 4: mBRWbnUl8diyBO1qTJaNzw folded before Flop (didn't bet)
Seat 5: 0fXz44fzDo5QmhAaJCvFfA folded before Flop (didn't bet)
Seat 6: BK/GtNPkSx0TdUDj82id5A folded on the River
Seat 7: laA8va+Yv8WuMqT1zdR91g (button) folded before Flop (didn't bet)
Seat 8: tkdBeXTJlFsZdioidNqLow (small blind) folded before Flop
Seat 9: VPF+HjszMvUIpy0CHIwH3A (big blind) folded before Flop



PokerStars Game #59939674864:  Hold'em No Limit ($0.50/$1.00) - 2009/07/01 0:45:59 ET
Table 'N2bNCDHL96aCQDvZIh+yQQ' 6-max Seat #2 is the button
Seat 1: iHo1oDbrEVJ8nEGdaPrICw ($100 in chips)
Seat 2: KpnW5CcJ4Mg6MeclfKmLrw ($158.60 in chips)
Seat 3: Qy/UBNbD2HaA0Ogxg8Sf3w ($160.20 in chips)
Seat 4: uCqEjnxh2/vFBjKYkfTOkw ($170.40 in chips)
Seat 5: rHlMOfR7kpQQxe+PFQz0xQ ($29.25 in chips)
Seat 6: TSuRyAHnUPCFjP7Z0rEE0w ($100 in chips)
Qy/UBNbD2HaA0Ogxg8Sf3w: posts small blind $0.50
uCqEjnxh2/vFBjKYkfTOkw: posts big blind $1
*** HOLE CARDS ***
rHlMOfR7kpQQxe+PFQz0xQ: folds
TSuRyAHnUPCFjP7Z0rEE0w: folds
iHo1oDbrEVJ8nEGdaPrICw: folds
KpnW5CcJ4Mg6MeclfKmLrw: raises $2 to $3
Qy/UBNbD2HaA0Ogxg8Sf3w: folds
uCqEjnxh2/vFBjKYkfTOkw: calls $2
*** FLOP *** [3d 7h 2d]
uCqEjnxh2/vFBjKYkfTOkw: checks
KpnW5CcJ4Mg6MeclfKmLrw: bets $5
uCqEjnxh2/vFBjKYkfTOkw: folds
KpnW5CcJ4Mg6MeclfKmLrw collected $6.20 from pot
KpnW5CcJ4Mg6MeclfKmLrw: doesn't show hand
*** SUMMARY ***
Total pot $6.50 | Rake $0.30
Board [3d 7h 2d]
Seat 1: iHo1oDbrEVJ8nEGdaPrICw folded before Flop (didn't bet)
Seat 2: KpnW5CcJ4Mg6MeclfKmLrw (button) collected ($6.20)
Seat 3: Qy/UBNbD2HaA0Ogxg8Sf3w (small blind) folded before Flop
Seat 4: uCqEjnxh2/vFBjKYkfTOkw (big blind) folded on the Flop
Seat 5: rHlMOfR7kpQQxe+PFQz0xQ folded before Flop (didn't bet)
Seat 6: TSuRyAHnUPCFjP7Z0rEE0w folded before Flop (didn't bet)



PokerStars Game #59939675402:  Hold'em No Limit ($0.50/$1.00) - 2009/07/01 0:46:00 ET
Table 'vs/5jr6ciwjVQ5+Soc+u2A' 6-max Seat #3 is the button
Seat 1: 1C0rFAGdnnX4GWK9B0YPww ($25.20 in chips)
Seat 2: XOIf9W+VAxhZqN+SYoyMKA ($128.85 in chips)
Seat 3: G5ZSSN6RSON3gkNvk/SmYg ($150.50 in chips)
Seat 4: KpnW5CcJ4Mg6MeclfKmLrw ($100.50 in chips)
KpnW5CcJ4Mg6MeclfKmLrw: posts small blind $0.50
hppygolcky56: is sitting out
1C0rFAGdnnX4GWK9B0YPww: posts big blind $1
*** HOLE CARDS ***
XOIf9W+VAxhZqN+SYoyMKA: folds
hppygolcky56 has returned
G5ZSSN6RSON3gkNvk/SmYg: folds
KpnW5CcJ4Mg6MeclfKmLrw: raises $3 to $4
hppygolcky56 leaves the table
1C0rFAGdnnX4GWK9B0YPww: folds
KpnW5CcJ4Mg6MeclfKmLrw collected $2 from pot
KpnW5CcJ4Mg6MeclfKmLrw: doesn't show hand
*** SUMMARY ***
Total pot $2 | Rake $0
Seat 1: 1C0rFAGdnnX4GWK9B0YPww (big blind) folded before Flop
Seat 2: XOIf9W+VAxhZqN+SYoyMKA folded before Flop (didn't bet)
Seat 3: G5ZSSN6RSON3gkNvk/SmYg (button) folded before Flop (didn't bet)
Seat 4: KpnW5CcJ4Mg6MeclfKmLrw (small blind) collected ($2)



PokerStars Game #59939676836:  Hold'em No Limit ($0.50/$1.00) - 2009/07/01 0:46:02 ET
Table 'tyUh+jyNvrceIQdKMJjQ2wZFWj23PMihdwrNWv41OG/Qeat #4 is the button
Seat 2: XvUbOIg94d25feWeQlOTVg ($78.40 in chips)
Seat 3: TalCiLYHCd+ffkmR3auPvA ($62.80 in chips)
Seat 4: TSuRyAHnUPCFjP7Z0rEE0w ($118.25 in chips)
Seat 5: j7NIOHLZk7V2o9fOioO5ug ($110.60 in chips)
Seat 6: YsLQ3BAvgQHWXMAv3Wv6Hg ($145.75 in chips)
j7NIOHLZk7V2o9fOioO5ug: posts small blind $0.50
YsLQ3BAvgQHWXMAv3Wv6Hg: posts big blind $1
*** HOLE CARDS ***
XvUbOIg94d25feWeQlOTVg: calls $1
TalCiLYHCd+ffkmR3auPvA: folds
TSuRyAHnUPCFjP7Z0rEE0w: folds
j7NIOHLZk7V2o9fOioO5ug: folds
YsLQ3BAvgQHWXMAv3Wv6Hg: checks
*** FLOP *** [5c 4s 4d]
YsLQ3BAvgQHWXMAv3Wv6Hg: checks
XvUbOIg94d25feWeQlOTVg: checks
*** TURN *** [5c 4s 4d] [2h]
YsLQ3BAvgQHWXMAv3Wv6Hg: checks
XvUbOIg94d25feWeQlOTVg: checks
*** RIVER *** [5c 4s 4d 2h] [7h]
YsLQ3BAvgQHWXMAv3Wv6Hg: bets $2
XvUbOIg94d25feWeQlOTVg: folds
YsLQ3BAvgQHWXMAv3Wv6Hg collected $2.40 from pot
YsLQ3BAvgQHWXMAv3Wv6Hg: doesn't show hand
*** SUMMARY ***
Total pot $2.50 | Rake $0.10
Board [5c 4s 4d 2h 7h]
Seat 2: XvUbOIg94d25feWeQlOTVg folded on the River
Seat 3: TalCiLYHCd+ffkmR3auPvA folded before Flop (didn't bet)
Seat 4: TSuRyAHnUPCFjP7Z0rEE0w (button) folded before Flop (didn't bet)
Seat 5: j7NIOHLZk7V2o9fOioO5ug (small blind) folded before Flop
Seat 6: YsLQ3BAvgQHWXMAv3Wv6Hg (big blind) collected ($2.40)



PokerStars Game #59939676928:  Hold'em No Limit ($0.50/$1.00) - 2009/07/01 0:46:03 ET
Table 'fTlPiCj0utgzC/5io+I7ew' 6-max Seat #3 is the button
Seat 1: YMJG+F++3Aj6P8dAWda5fw ($95 in chips)
Seat 2: Qy/UBNbD2HaA0Ogxg8Sf3w ($108.95 in chips)
Seat 3: oDiBRCaF0QVtd3kO6xZIXw ($96.25 in chips)
Seat 4: uJVSceLggtsrJya+WtmUEA ($100 in chips)
Seat 5: bFrTkDcWGTxyvNul7GVdYg ($253.70 in chips)
uJVSceLggtsrJya+WtmUEA: posts small blind $0.50
bFrTkDcWGTxyvNul7GVdYg: posts big blind $1
*** HOLE CARDS ***
YMJG+F++3Aj6P8dAWda5fw: folds
Qy/UBNbD2HaA0Ogxg8Sf3w: raises $2 to $3
oDiBRCaF0QVtd3kO6xZIXw: folds
uJVSceLggtsrJya+WtmUEA: folds
bFrTkDcWGTxyvNul7GVdYg: folds
Qy/UBNbD2HaA0Ogxg8Sf3w collected $2.50 from pot
*** SUMMARY ***
Total pot $2.50 | Rake $0
Seat 1: YMJG+F++3Aj6P8dAWda5fw folded before Flop (didn't bet)
Seat 2: Qy/UBNbD2HaA0Ogxg8Sf3w collected ($2.50)
Seat 3: oDiBRCaF0QVtd3kO6xZIXw (button) folded before Flop (didn't bet)
Seat 4: uJVSceLggtsrJya+WtmUEA (small blind) folded before Flop
Seat 5: bFrTkDcWGTxyvNul7GVdYg (big blind) folded before Flop



PokerStars Game #59939677296:  Hold'em No Limit ($0.50/$1.00) - 2009/07/01 0:46:03 ET
Table '7Nl0ffnjeK44/vmeexh3MQ' 9-max Seat #6 is the button
Seat 1: s7D3Y+k4Cj4D1cXHv7oj+Q ($92.35 in chips)
Seat 2: kiakSwxX0e64PwYGAPQvLw ($33.35 in chips)
Seat 3: vR4IO10geOgvTW+LAUBv/A ($101.50 in chips)
Seat 4: bLbSOSmSOnqE0iTcH/5dxA ($100 in chips)
Seat 5: bL+QVeDcuEdzMGAGg2XJHg ($100 in chips)
Seat 6: FVs16t7GgfWgQWt4JxsObQ ($31.50 in chips)
Seat 7: 997ViqAtWn1FPjJqcffwcA ($100 in chips)
Seat 8: zanka7aAZkigmZpfopXxxA ($253.70 in chips)
Seat 9: ouwUBGRKnKK9uhn1G4Lf+A ($95 in chips)
997ViqAtWn1FPjJqcffwcA: posts small blind $0.50
zanka7aAZkigmZpfopXxxA: posts big blind $1
*** HOLE CARDS ***
ouwUBGRKnKK9uhn1G4Lf+A: folds
s7D3Y+k4Cj4D1cXHv7oj+Q: folds
kiakSwxX0e64PwYGAPQvLw: folds
vR4IO10geOgvTW+LAUBv/A: folds
bLbSOSmSOnqE0iTcH/5dxA: folds
bL+QVeDcuEdzMGAGg2XJHg: raises $3 to $4
FVs16t7GgfWgQWt4JxsObQ: calls $4
997ViqAtWn1FPjJqcffwcA: folds
zanka7aAZkigmZpfopXxxA: folds
*** FLOP *** [6d Ah 2s]
bL+QVeDcuEdzMGAGg2XJHg: checks
FVs16t7GgfWgQWt4JxsObQ: checks
*** TURN *** [6d Ah 2s] [9h]
bL+QVeDcuEdzMGAGg2XJHg: checks
FVs16t7GgfWgQWt4JxsObQ: checks
*** RIVER *** [6d Ah 2s 9h] [6s]
bL+QVeDcuEdzMGAGg2XJHg: checks
FVs16t7GgfWgQWt4JxsObQ: checks
*** SHOW DOWN ***
bL+QVeDcuEdzMGAGg2XJHg: shows [9s Ts] (two pair, Nines and Sixes)
FVs16t7GgfWgQWt4JxsObQ: mucks hand
bL+QVeDcuEdzMGAGg2XJHg collected $9.05 from pot
*** SUMMARY ***
Total pot $9.50 | Rake $0.45
Board [6d Ah 2s 9h 6s]
Seat 1: s7D3Y+k4Cj4D1cXHv7oj+Q folded before Flop (didn't bet)
Seat 2: kiakSwxX0e64PwYGAPQvLw folded before Flop (didn't bet)
Seat 3: vR4IO10geOgvTW+LAUBv/A folded before Flop (didn't bet)
Seat 4: bLbSOSmSOnqE0iTcH/5dxA folded before Flop (didn't bet)
Seat 5: bL+QVeDcuEdzMGAGg2XJHg showed [9s Ts] and won ($9.05) with two pair, Nines and Sixes
Seat 6: FVs16t7GgfWgQWt4JxsObQ (button) mucked
Seat 7: 997ViqAtWn1FPjJqcffwcA (small blind) folded before Flop
Seat 8: zanka7aAZkigmZpfopXxxA (big blind) folded before Flop
Seat 9: ouwUBGRKnKK9uhn1G4Lf+A folded before Flop (didn't bet)



PokerStars Game #59939678106:  Hold'em No Limit ($0.50/$1.00) - 2009/07/01 0:46:04 ET
Table 'CxlB0XELs5P0zDlOhlhAPw' 2-max Seat #2 is the button
Seat 1: +B2wRsLpIMFnVA7qiRoGfg ($39.50 in chips)
Seat 2: I4xAjioR1QwQ5TgX4Z1/qw ($41.70 in chips)
I4xAjioR1QwQ5TgX4Z1/qw: posts small blind $0.50
+B2wRsLpIMFnVA7qiRoGfg: posts big blind $1
*** HOLE CARDS ***
I4xAjioR1QwQ5TgX4Z1/qw: folds
+B2wRsLpIMFnVA7qiRoGfg collected $1 from pot
+B2wRsLpIMFnVA7qiRoGfg: doesn't show hand
*** SUMMARY ***
Total pot $1 | Rake $0
Seat 1: +B2wRsLpIMFnVA7qiRoGfg (big blind) collected ($1)
Seat 2: I4xAjioR1QwQ5TgX4Z1/qw (button) (small blind) folded before Flop



PokerStars Game #59939682134:  Hold'em No Limit ($0.50/$1.00) - 2009/07/01 0:46:11 ET
Table 'VOs36P6NW+QyXeQ1B62kmA' 6-max Seat #2 is the button
Seat 1: AdLVjddOzm+sRNo1Bc3S6Q ($137.80 in chips)
Seat 2: KpnW5CcJ4Mg6MeclfKmLrw ($119.35 in chips)
Seat 3: TSuRyAHnUPCFjP7Z0rEE0w ($100 in chips)
Seat 4: w02zQzNydODiyV9THKgo9w ($35.80 in chips)
Seat 6: 6tvjsJrdmWg+g7FVrMnzXA ($81.75 in chips)
TSuRyAHnUPCFjP7Z0rEE0w: posts small blind $0.50
w02zQzNydODiyV9THKgo9w: posts big blind $1
*** HOLE CARDS ***
6tvjsJrdmWg+g7FVrMnzXA: folds
AdLVjddOzm+sRNo1Bc3S6Q: folds
KpnW5CcJ4Mg6MeclfKmLrw: folds
TSuRyAHnUPCFjP7Z0rEE0w: folds
w02zQzNydODiyV9THKgo9w collected $1 from pot
*** SUMMARY ***
Total pot $1 | Rake $0
Seat 1: AdLVjddOzm+sRNo1Bc3S6Q folded before Flop (didn't bet)
Seat 2: KpnW5CcJ4Mg6MeclfKmLrw (button) folded before Flop (didn't bet)
Seat 3: TSuRyAHnUPCFjP7Z0rEE0w (small blind) folded before Flop
Seat 4: w02zQzNydODiyV9THKgo9w (big blind) collected ($1)
Seat 6: 6tvjsJrdmWg+g7FVrMnzXA folded before Flop (didn't bet)



PokerStars Game #59939682752:  Hold'em No Limit ($0.50/$1.00) - 2009/07/01 0:46:12 ET
Table 'LmXQK9xy3awB+qsPzI21Mw' 2-max Seat #1 is the button
Seat 1: NYi6JFscYNrofSXy4sM+Yw ($234.15 in chips)
Seat 2: TME8GvochpQAo8cmJwWmvA ($98.90 in chips)
NYi6JFscYNrofSXy4sM+Yw: posts small blind $0.50
TME8GvochpQAo8cmJwWmvA: posts big blind $1
*** HOLE CARDS ***
NYi6JFscYNrofSXy4sM+Yw: raises $2 to $3
TME8GvochpQAo8cmJwWmvA: folds
NYi6JFscYNrofSXy4sM+Yw collected $2 from pot
*** SUMMARY ***
Total pot $2 | Rake $0
Seat 1: NYi6JFscYNrofSXy4sM+Yw (button) (small blind) collected ($2)
Seat 2: TME8GvochpQAo8cmJwWmvA (big blind) folded before Flop



PokerStars Game #59939682972:  Hold'em No Limit ($0.50/$1.00) - 2009/07/01 0:46:12 ET
Table 'eU3bWpDDg3Z+9R4m4iVmog' 6-max Seat #2 is the button
Seat 1: TSuRyAHnUPCFjP7Z0rEE0w ($189.65 in chips)
Seat 2: 8CAoOzhmB8n3nRFf3V4BTg ($97.80 in chips)
Seat 3: U6tnjwZRpTnM+YkqkCjwyQ ($190.15 in chips)
Seat 4: GDVIsbEJ/DOJsMKE4Asz0A ($66.10 in chips)
Seat 5: AdLVjddOzm+sRNo1Bc3S6Q ($111.45 in chips)
Seat 6: hpxXcmRkXXI9HE5+5/j/0Q ($121.95 in chips)
U6tnjwZRpTnM+YkqkCjwyQ: posts small blind $0.50
GDVIsbEJ/DOJsMKE4Asz0A: posts big blind $1
*** HOLE CARDS ***
AdLVjddOzm+sRNo1Bc3S6Q: folds
hpxXcmRkXXI9HE5+5/j/0Q: folds
TSuRyAHnUPCFjP7Z0rEE0w: folds
8CAoOzhmB8n3nRFf3V4BTg: folds
U6tnjwZRpTnM+YkqkCjwyQ: calls $0.50
GDVIsbEJ/DOJsMKE4Asz0A: raises $2 to $3
U6tnjwZRpTnM+YkqkCjwyQ: calls $2
*** FLOP *** [2h 3h Qh]
U6tnjwZRpTnM+YkqkCjwyQ: checks
GDVIsbEJ/DOJsMKE4Asz0A: bets $4
U6tnjwZRpTnM+YkqkCjwyQ: folds
GDVIsbEJ/DOJsMKE4Asz0A collected $5.70 from pot
GDVIsbEJ/DOJsMKE4Asz0A: doesn't show hand
*** SUMMARY ***
Total pot $6 | Rake $0.30
Board [2h 3h Qh]
Seat 1: TSuRyAHnUPCFjP7Z0rEE0w folded before Flop (didn't bet)
Seat 2: 8CAoOzhmB8n3nRFf3V4BTg (button) folded before Flop (didn't bet)
Seat 3: U6tnjwZRpTnM+YkqkCjwyQ (small blind) folded on the Flop
Seat 4: GDVIsbEJ/DOJsMKE4Asz0A (big blind) collected ($5.70)
Seat 5: AdLVjddOzm+sRNo1Bc3S6Q folded before Flop (didn't bet)
Seat 6: hpxXcmRkXXI9HE5+5/j/0Q folded before Flop (didn't bet)



PokerStars Game #59939683396:  Hold'em No Limit ($0.50/$1.00) - 2009/07/01 0:46:13 ET
Table 'CxlB0XELs5P0zDlOhlhAPw' 2-max Seat #1 is the button
Seat 1: +B2wRsLpIMFnVA7qiRoGfg ($40 in chips)
Seat 2: I4xAjioR1QwQ5TgX4Z1/qw ($41.20 in chips)
+B2wRsLpIMFnVA7qiRoGfg: posts small blind $0.50
I4xAjioR1QwQ5TgX4Z1/qw: posts big blind $1
*** HOLE CARDS ***
+B2wRsLpIMFnVA7qiRoGfg: calls $0.50
I4xAjioR1QwQ5TgX4Z1/qw: checks
*** FLOP *** [Kh 2h 7s]
I4xAjioR1QwQ5TgX4Z1/qw: checks
+B2wRsLpIMFnVA7qiRoGfg: bets $1
I4xAjioR1QwQ5TgX4Z1/qw: folds
+B2wRsLpIMFnVA7qiRoGfg collected $1.90 from pot
*** SUMMARY ***
Total pot $2 | Rake $0.10
Board [Kh 2h 7s]
Seat 1: +B2wRsLpIMFnVA7qiRoGfg (button) (small blind) collected ($1.90)
Seat 2: I4xAjioR1QwQ5TgX4Z1/qw (big blind) folded on the Flop



PokerStars Game #59939684398:  Hold'em No Limit ($0.50/$1.00) - 2009/07/01 0:46:14 ET
Table '7O9fB8yx1u7sJveJn8w6jA' 6-max Seat #4 is the button
Seat 1: jy52+7FotjH63o5tEEVgKw ($165.35 in chips)
Seat 2: wx3sQGkVi2x9wJXuWNHPBw ($194 in chips)
Seat 3: hpxXcmRkXXI9HE5+5/j/0Q ($100 in chips)
Seat 4: XIZSmlGttGgSRaIU42K4Fg ($77.75 in chips)
Seat 5: BCEV3COoKY607AzLWayfRA ($100 in chips)
Seat 6: UBZQqpnJZdTYYY1FTb0rLA ($129.35 in chips)
BCEV3COoKY607AzLWayfRA: posts small blind $0.50
UBZQqpnJZdTYYY1FTb0rLA: posts big blind $1
*** HOLE CARDS ***
jy52+7FotjH63o5tEEVgKw: calls $1
wx3sQGkVi2x9wJXuWNHPBw: folds
hpxXcmRkXXI9HE5+5/j/0Q: folds
XIZSmlGttGgSRaIU42K4Fg: calls $1
BCEV3COoKY607AzLWayfRA: folds
UBZQqpnJZdTYYY1FTb0rLA: checks
*** FLOP *** [2d 4c Kc]
UBZQqpnJZdTYYY1FTb0rLA: checks
jy52+7FotjH63o5tEEVgKw: checks
XIZSmlGttGgSRaIU42K4Fg: bets $3
UBZQqpnJZdTYYY1FTb0rLA: folds
jy52+7FotjH63o5tEEVgKw: folds
XIZSmlGttGgSRaIU42K4Fg collected $3.35 from pot
*** SUMMARY ***
Total pot $3.50 | Rake $0.15
Board [2d 4c Kc]
Seat 1: jy52+7FotjH63o5tEEVgKw folded on the Flop
Seat 2: wx3sQGkVi2x9wJXuWNHPBw folded before Flop (didn't bet)
Seat 3: hpxXcmRkXXI9HE5+5/j/0Q folded before Flop (didn't bet)
Seat 4: XIZSmlGttGgSRaIU42K4Fg (button) collected ($3.35)
Seat 5: BCEV3COoKY607AzLWayfRA (small blind) folded before Flop
Seat 6: UBZQqpnJZdTYYY1FTb0rLA (big blind) folded on the Flop



PokerStars Game #59939686632:  Hold'em No Limit ($0.50/$1.00) - 2009/07/01 0:46:18 ET
Table 'GxCPo/gd3OSthkYrAxJngg' 6-max Seat #4 is the button
Seat 1: sH8BpAFP+jGFxCgVpD1Lew ($259.85 in chips)
Seat 2: YExX2paeIHrmfIwV1ivM/w ($78.20 in chips)
Seat 3: o6plE+MSW4XFNTeONe16xg ($31.10 in chips)
Seat 4: YMJG+F++3Aj6P8dAWda5fw ($105.15 in chips)
Seat 5: G5ZSSN6RSON3gkNvk/SmYg ($108.75 in chips)
Seat 6: sS9IXedL3MiRmpVXhAILhw ($101.95 in chips)
G5ZSSN6RSON3gkNvk/SmYg: posts small blind $0.50
sS9IXedL3MiRmpVXhAILhw: posts big blind $1
*** HOLE CARDS ***
sH8BpAFP+jGFxCgVpD1Lew: folds
YExX2paeIHrmfIwV1ivM/w: folds
o6plE+MSW4XFNTeONe16xg: folds
YMJG+F++3Aj6P8dAWda5fw: folds
G5ZSSN6RSON3gkNvk/SmYg: folds
sS9IXedL3MiRmpVXhAILhw collected $1 from pot
*** SUMMARY ***
Total pot $1 | Rake $0
Seat 1: sH8BpAFP+jGFxCgVpD1Lew folded before Flop (didn't bet)
Seat 2: YExX2paeIHrmfIwV1ivM/w folded before Flop (didn't bet)
Seat 3: o6plE+MSW4XFNTeONe16xg folded before Flop (didn't bet)
Seat 4: YMJG+F++3Aj6P8dAWda5fw (button) folded before Flop (didn't bet)
Seat 5: G5ZSSN6RSON3gkNvk/SmYg (small blind) folded before Flop
Seat 6: sS9IXedL3MiRmpVXhAILhw (big blind) collected ($1)



PokerStars Game #59939687184:  Hold'em No Limit ($0.50/$1.00) - 2009/07/01 0:46:19 ET
Table 'W/wyObTiXZm+Ckkl3YxcSw' 6-max Seat #5 is the button
Seat 1: eUBBn2R56C1IQ6Cs/vitwg ($113.75 in chips)
Seat 2: oDiBRCaF0QVtd3kO6xZIXw ($78.75 in chips)
Seat 3: ybGsYWp1MLwy1vSnP8egXg ($30 in chips)
Seat 4: +xW7QemQU0Fxs+4TnqBRow ($133.90 in chips)
Seat 5: BdbmJTZZ47quA9vUWwXtlw ($52 in chips)
Seat 6: tS9JHB1h+FQ++qu8RwRNgg ($28 in chips)
tS9JHB1h+FQ++qu8RwRNgg: posts small blind $0.50
eUBBn2R56C1IQ6Cs/vitwg: posts big blind $1
*** HOLE CARDS ***
oDiBRCaF0QVtd3kO6xZIXw: folds
ybGsYWp1MLwy1vSnP8egXg: folds
+xW7QemQU0Fxs+4TnqBRow: folds
eUBBn2R56C1IQ6Cs/vitwg is disconnected
BdbmJTZZ47quA9vUWwXtlw: calls $1
tS9JHB1h+FQ++qu8RwRNgg: calls $0.50
eUBBn2R56C1IQ6Cs/vitwg is connected
eUBBn2R56C1IQ6Cs/vitwg: checks
*** FLOP *** [4h Qh Tc]
tS9JHB1h+FQ++qu8RwRNgg: checks
eUBBn2R56C1IQ6Cs/vitwg: checks
BdbmJTZZ47quA9vUWwXtlw: checks
*** TURN *** [4h Qh Tc] [Jh]
tS9JHB1h+FQ++qu8RwRNgg: checks
eUBBn2R56C1IQ6Cs/vitwg: checks
BdbmJTZZ47quA9vUWwXtlw: checks
*** RIVER *** [4h Qh Tc Jh] [Jc]
tS9JHB1h+FQ++qu8RwRNgg: checks
eUBBn2R56C1IQ6Cs/vitwg: checks
BdbmJTZZ47quA9vUWwXtlw: checks
*** SHOW DOWN ***
tS9JHB1h+FQ++qu8RwRNgg: shows [5c 2c] (a pair of Jacks)
eUBBn2R56C1IQ6Cs/vitwg: shows [7s 4c] (two pair, Jacks and Fours)
BdbmJTZZ47quA9vUWwXtlw: shows [5s 5d] (two pair, Jacks and Fives)
BdbmJTZZ47quA9vUWwXtlw collected $2.85 from pot
*** SUMMARY ***
Total pot $3 | Rake $0.15
Board [4h Qh Tc Jh Jc]
Seat 1: eUBBn2R56C1IQ6Cs/vitwg (big blind) showed [7s 4c] and lost with two pair, Jacks and Fours
Seat 2: oDiBRCaF0QVtd3kO6xZIXw folded before Flop (didn't bet)
Seat 3: ybGsYWp1MLwy1vSnP8egXg folded before Flop (didn't bet)
Seat 4: +xW7QemQU0Fxs+4TnqBRow folded before Flop (didn't bet)
Seat 5: BdbmJTZZ47quA9vUWwXtlw (button) showed [5s 5d] and won ($2.85) with two pair, Jacks and Fives
Seat 6: tS9JHB1h+FQ++qu8RwRNgg (small blind) showed [5c 2c] and lost with a pair of Jacks



PokerStars Game #59939688964:  Hold'em No Limit ($0.50/$1.00) - 2009/07/01 0:46:22 ET
Table 'uNlePsyMIqzM691Xkrlk6Q' 9-max Seat #8 is the button
Seat 1: bLbSOSmSOnqE0iTcH/5dxA ($101.50 in chips)
Seat 2: +OqpStnt0FqbCfyHAWaLbg ($78.05 in chips)
Seat 3: h7qXkU57Bb8ZuPwMyxR8Ug ($31.50 in chips)
Seat 4: TZcz9MEWDA+WydgGruqqbw ($102.65 in chips)
Seat 5: 3obndzTJ6fECz8+wWhMd1w ($18.50 in chips)
Seat 6: uMPEfCcGCfsxmy53tVUMug ($106.10 in chips)
Seat 7: w6cw9nzN7AvkkHBVVjykoQ ($45.90 in chips)
Seat 8: laA8va+Yv8WuMqT1zdR91g ($100 in chips)
Seat 9: vR4IO10geOgvTW+LAUBv/A ($101.25 in chips)
vR4IO10geOgvTW+LAUBv/A: posts small blind $0.50
bLbSOSmSOnqE0iTcH/5dxA: posts big blind $1
*** HOLE CARDS ***
+OqpStnt0FqbCfyHAWaLbg: raises $3 to $4
h7qXkU57Bb8ZuPwMyxR8Ug: folds
TZcz9MEWDA+WydgGruqqbw: folds
3obndzTJ6fECz8+wWhMd1w: folds
uMPEfCcGCfsxmy53tVUMug: folds
w6cw9nzN7AvkkHBVVjykoQ: folds
laA8va+Yv8WuMqT1zdR91g: folds
vR4IO10geOgvTW+LAUBv/A: folds
bLbSOSmSOnqE0iTcH/5dxA: folds
+OqpStnt0FqbCfyHAWaLbg collected $2.50 from pot
*** SUMMARY ***
Total pot $2.50 | Rake $0
Seat 1: bLbSOSmSOnqE0iTcH/5dxA (big blind) folded before Flop
Seat 2: +OqpStnt0FqbCfyHAWaLbg collected ($2.50)
Seat 3: h7qXkU57Bb8ZuPwMyxR8Ug folded before Flop (didn't bet)
Seat 4: TZcz9MEWDA+WydgGruqqbw folded before Flop (didn't bet)
Seat 5: 3obndzTJ6fECz8+wWhMd1w folded before Flop (didn't bet)
Seat 6: uMPEfCcGCfsxmy53tVUMug folded before Flop (didn't bet)
Seat 7: w6cw9nzN7AvkkHBVVjykoQ folded before Flop (didn't bet)
Seat 8: laA8va+Yv8WuMqT1zdR91g (button) folded before Flop (didn't bet)
Seat 9: vR4IO10geOgvTW+LAUBv/A (small blind) folded before Flop



PokerStars Game #59939690724:  Hold'em No Limit ($0.50/$1.00) - 2009/07/01 0:46:24 ET
Table 'vs/5jr6ciwjVQ5+Soc+u2A' 6-max Seat #4 is the button
Seat 1: 1C0rFAGdnnX4GWK9B0YPww ($24.20 in chips)
Seat 2: XOIf9W+VAxhZqN+SYoyMKA ($128.85 in chips)
Seat 3: G5ZSSN6RSON3gkNvk/SmYg ($150.50 in chips)
Seat 4: KpnW5CcJ4Mg6MeclfKmLrw ($101.50 in chips)
1C0rFAGdnnX4GWK9B0YPww: posts small blind $0.50
XOIf9W+VAxhZqN+SYoyMKA: posts big blind $1
*** HOLE CARDS ***
G5ZSSN6RSON3gkNvk/SmYg: folds
2DwLxMUbmzvwY7o4/i47Xg joins the table at seat #5
KpnW5CcJ4Mg6MeclfKmLrw: raises $2 to $3
1C0rFAGdnnX4GWK9B0YPww: calls $2.50
qAdBJlVNsNTwiHia50eMvg joins the table at seat #6
XOIf9W+VAxhZqN+SYoyMKA: folds
*** FLOP *** [4c Kh Ah]
1C0rFAGdnnX4GWK9B0YPww: checks
KpnW5CcJ4Mg6MeclfKmLrw: bets $5
1C0rFAGdnnX4GWK9B0YPww: raises $8 to $13
KpnW5CcJ4Mg6MeclfKmLrw: raises $9 to $22
1C0rFAGdnnX4GWK9B0YPww: calls $8.20 and is all-in
*** TURN *** [4c Kh Ah] [9d]
*** RIVER *** [4c Kh Ah 9d] [Jc]
*** SHOW DOWN ***
1C0rFAGdnnX4GWK9B0YPww: shows [Jd Ad] (two pair, Aces and Jacks)
KpnW5CcJ4Mg6MeclfKmLrw: shows [As Kc] (two pair, Aces and Kings)
KpnW5CcJ4Mg6MeclfKmLrw collected $47.40 from pot
*** SUMMARY ***
Total pot $49.40 | Rake $2
Board [4c Kh Ah 9d Jc]
Seat 1: 1C0rFAGdnnX4GWK9B0YPww (small blind) showed [Jd Ad] and lost with two pair, Aces and Jacks
Seat 2: XOIf9W+VAxhZqN+SYoyMKA (big blind) folded before Flop
Seat 3: G5ZSSN6RSON3gkNvk/SmYg folded before Flop (didn't bet)
Seat 4: KpnW5CcJ4Mg6MeclfKmLrw (button) showed [As Kc] and won ($47.40) with two pair, Aces and Kings



PokerStars Game #59939690444:  Hold'em No Limit ($0.50/$1.00) - 2009/07/01 0:46:24 ET
Table 'CASNP0uy1C+jGLml/I4PtA' 9-max Seat #8 is the button
Seat 2: tjhwe1V98x2spSoUQER3HQ ($104.10 in chips)
Seat 3: bJckevFOcg//s0qyMQI6sQ ($114.45 in chips)
Seat 4: B/G0GJacqZ8K59/ZVdq4kQ ($49.95 in chips)
Seat 6: 0eFnow7+D7veCYQ+CG9FFw ($99.85 in chips)
Seat 7: RpMNxqeYPSeOh0tflU772w ($163.85 in chips)
Seat 8: L9njYvloJ1NdXjP8edHEAg ($100 in chips)
Seat 9: 4oiD3zp7JlvK3PEQyVa3gA ($262.55 in chips)
4oiD3zp7JlvK3PEQyVa3gA: posts small blind $0.50
tjhwe1V98x2spSoUQER3HQ: posts big blind $1
xskinef: sits out
*** HOLE CARDS ***
bJckevFOcg//s0qyMQI6sQ: folds
B/G0GJacqZ8K59/ZVdq4kQ: calls $1
0eFnow7+D7veCYQ+CG9FFw: folds
tkdBeXTJlFsZdioidNqLow joins the table at seat #1
RpMNxqeYPSeOh0tflU772w: calls $1
L9njYvloJ1NdXjP8edHEAg: folds
4oiD3zp7JlvK3PEQyVa3gA: raises $5 to $6
tjhwe1V98x2spSoUQER3HQ: folds
B/G0GJacqZ8K59/ZVdq4kQ: calls $5
RpMNxqeYPSeOh0tflU772w: folds
*** FLOP *** [Js 3s 2h]
4oiD3zp7JlvK3PEQyVa3gA: bets $5
B/G0GJacqZ8K59/ZVdq4kQ: calls $5
*** TURN *** [Js 3s 2h] [6s]
4oiD3zp7JlvK3PEQyVa3gA: checks
B/G0GJacqZ8K59/ZVdq4kQ: checks
*** RIVER *** [Js 3s 2h 6s] [Qc]
4oiD3zp7JlvK3PEQyVa3gA: bets $20
B/G0GJacqZ8K59/ZVdq4kQ: folds
4oiD3zp7JlvK3PEQyVa3gA collected $22.85 from pot
*** SUMMARY ***
Total pot $24 | Rake $1.15
Board [Js 3s 2h 6s Qc]
Seat 2: tjhwe1V98x2spSoUQER3HQ (big blind) folded before Flop
Seat 3: bJckevFOcg//s0qyMQI6sQ folded before Flop (didn't bet)
Seat 4: B/G0GJacqZ8K59/ZVdq4kQ folded on the River
Seat 6: 0eFnow7+D7veCYQ+CG9FFw folded before Flop (didn't bet)
Seat 7: RpMNxqeYPSeOh0tflU772w folded before Flop
Seat 8: L9njYvloJ1NdXjP8edHEAg (button) folded before Flop (didn't bet)
Seat 9: 4oiD3zp7JlvK3PEQyVa3gA (small blind) collected ($22.85)



PokerStars Game #59939691510:  Hold'em No Limit ($0.50/$1.00) - 2009/07/01 0:46:25 ET
Table 'mmbQQVBTrPdE+wy+s+9VPA' 6-max Seat #4 is the button
Seat 1: lsLuWlcPA3Rh7kJVLzMh0Q ($103.20 in chips)
Seat 2: +W6OnF033KNM2xH0fGj98Q ($123.60 in chips)
Seat 3: wx3sQGkVi2x9wJXuWNHPBw ($113.25 in chips)
Seat 4: RfKnhkJN8HEAuzJpH2Ajdg ($17.05 in chips)
Seat 5: YMJG+F++3Aj6P8dAWda5fw ($99 in chips)
Seat 6: U2CWBTv29qdCbj8RNF2sIw ($100 in chips)
YMJG+F++3Aj6P8dAWda5fw: posts small blind $0.50
U2CWBTv29qdCbj8RNF2sIw: posts big blind $1
*** HOLE CARDS ***
lsLuWlcPA3Rh7kJVLzMh0Q: raises $3 to $4
+W6OnF033KNM2xH0fGj98Q: folds
wx3sQGkVi2x9wJXuWNHPBw: folds
RfKnhkJN8HEAuzJpH2Ajdg: folds
YMJG+F++3Aj6P8dAWda5fw: calls $3.50
U2CWBTv29qdCbj8RNF2sIw: calls $3
*** FLOP *** [2s As Ks]
YMJG+F++3Aj6P8dAWda5fw: checks
U2CWBTv29qdCbj8RNF2sIw: checks
lsLuWlcPA3Rh7kJVLzMh0Q: checks
*** TURN *** [2s As Ks] [9c]
YMJG+F++3Aj6P8dAWda5fw: checks
U2CWBTv29qdCbj8RNF2sIw: checks
lsLuWlcPA3Rh7kJVLzMh0Q: checks
*** RIVER *** [2s As Ks 9c] [8d]
YMJG+F++3Aj6P8dAWda5fw: checks
U2CWBTv29qdCbj8RNF2sIw: checks
lsLuWlcPA3Rh7kJVLzMh0Q: checks
*** SHOW DOWN ***
YMJG+F++3Aj6P8dAWda5fw: shows [Td Th] (a pair of Tens)
U2CWBTv29qdCbj8RNF2sIw: mucks hand
lsLuWlcPA3Rh7kJVLzMh0Q: shows [Kc Qd] (a pair of Kings)
lsLuWlcPA3Rh7kJVLzMh0Q collected $11.40 from pot
*** SUMMARY ***
Total pot $12 | Rake $0.60
Board [2s As Ks 9c 8d]
Seat 1: lsLuWlcPA3Rh7kJVLzMh0Q showed [Kc Qd] and won ($11.40) with a pair of Kings
Seat 2: +W6OnF033KNM2xH0fGj98Q folded before Flop (didn't bet)
Seat 3: wx3sQGkVi2x9wJXuWNHPBw folded before Flop (didn't bet)
Seat 4: RfKnhkJN8HEAuzJpH2Ajdg (button) folded before Flop (didn't bet)
Seat 5: YMJG+F++3Aj6P8dAWda5fw (small blind) showed [Td Th] and lost with a pair of Tens
Seat 6: U2CWBTv29qdCbj8RNF2sIw (big blind) mucked



PokerStars Game #59939691252:  Hold'em No Limit ($0.50/$1.00) - 2009/07/01 0:46:25 ET
Table 'fTlPiCj0utgzC/5io+I7ew' 6-max Seat #4 is the button
Seat 1: YMJG+F++3Aj6P8dAWda5fw ($95 in chips)
Seat 2: Qy/UBNbD2HaA0Ogxg8Sf3w ($110.45 in chips)
Seat 3: oDiBRCaF0QVtd3kO6xZIXw ($96.25 in chips)
Seat 4: uJVSceLggtsrJya+WtmUEA ($99.50 in chips)
Seat 5: bFrTkDcWGTxyvNul7GVdYg ($252.70 in chips)
bFrTkDcWGTxyvNul7GVdYg: posts small blind $0.50
YMJG+F++3Aj6P8dAWda5fw: posts big blind $1
*** HOLE CARDS ***
Qy/UBNbD2HaA0Ogxg8Sf3w: raises $2.50 to $3.50
oDiBRCaF0QVtd3kO6xZIXw: folds
uJVSceLggtsrJya+WtmUEA has timed out
uJVSceLggtsrJya+WtmUEA: folds
uJVSceLggtsrJya+WtmUEA is sitting out
uJVSceLggtsrJya+WtmUEA has returned
bFrTkDcWGTxyvNul7GVdYg: folds
YMJG+F++3Aj6P8dAWda5fw: folds
Qy/UBNbD2HaA0Ogxg8Sf3w collected $2.50 from pot
*** SUMMARY ***
Total pot $2.50 | Rake $0
Seat 1: YMJG+F++3Aj6P8dAWda5fw (big blind) folded before Flop
Seat 2: Qy/UBNbD2HaA0Ogxg8Sf3w collected ($2.50)
Seat 3: oDiBRCaF0QVtd3kO6xZIXw folded before Flop (didn't bet)
Seat 4: uJVSceLggtsrJya+WtmUEA (button) folded before Flop (didn't bet)
Seat 5: bFrTkDcWGTxyvNul7GVdYg (small blind) folded before Flop



PokerStars Game #59939692474:  Hold'em No Limit ($0.50/$1.00) - 2009/07/01 0:46:27 ET
Table 'CxlB0XELs5P0zDlOhlhAPw' 2-max Seat #2 is the button
Seat 1: +B2wRsLpIMFnVA7qiRoGfg ($40.90 in chips)
Seat 2: I4xAjioR1QwQ5TgX4Z1/qw ($40.20 in chips)
I4xAjioR1QwQ5TgX4Z1/qw: posts small blind $0.50
+B2wRsLpIMFnVA7qiRoGfg: posts big blind $1
*** HOLE CARDS ***
I4xAjioR1QwQ5TgX4Z1/qw: folds
+B2wRsLpIMFnVA7qiRoGfg collected $1 from pot
*** SUMMARY ***
Total pot $1 | Rake $0
Seat 1: +B2wRsLpIMFnVA7qiRoGfg (big blind) collected ($1)
Seat 2: I4xAjioR1QwQ5TgX4Z1/qw (button) (small blind) folded before Flop



PokerStars Game #59939695010:  Hold'em No Limit ($0.50/$1.00) - 2009/07/01 0:46:31 ET
Table 'MUPc8FEpe/nR0BKSeReX6Q' 6-max Seat #1 is the button
Seat 1: YsLQ3BAvgQHWXMAv3Wv6Hg ($113.85 in chips)
Seat 2: xAU6q2/cwmby2sxmA8VcmA ($109.30 in chips)
Seat 3: wx3sQGkVi2x9wJXuWNHPBw ($220.05 in chips)
Seat 4: ZA1bp6g8IwtTxkUE4eCjDQ ($192.40 in chips)
Seat 5: UBZQqpnJZdTYYY1FTb0rLA ($100 in chips)
Seat 6: oxnw0GLLpFanjhGkxfRSqA ($58 in chips)
xAU6q2/cwmby2sxmA8VcmA: posts small blind $0.50
wx3sQGkVi2x9wJXuWNHPBw: posts big blind $1
*** HOLE CARDS ***
ZA1bp6g8IwtTxkUE4eCjDQ: raises $1 to $2
UBZQqpnJZdTYYY1FTb0rLA: folds
oxnw0GLLpFanjhGkxfRSqA: calls $2
YsLQ3BAvgQHWXMAv3Wv6Hg: folds
xAU6q2/cwmby2sxmA8VcmA: folds
wx3sQGkVi2x9wJXuWNHPBw: folds
*** FLOP *** [8h Jd 6s]
ZA1bp6g8IwtTxkUE4eCjDQ: checks
oxnw0GLLpFanjhGkxfRSqA: bets $2
ZA1bp6g8IwtTxkUE4eCjDQ: raises $3 to $5
oxnw0GLLpFanjhGkxfRSqA: calls $3
*** TURN *** [8h Jd 6s] [Jc]
ZA1bp6g8IwtTxkUE4eCjDQ: checks
oxnw0GLLpFanjhGkxfRSqA: bets $4
ZA1bp6g8IwtTxkUE4eCjDQ: calls $4
*** RIVER *** [8h Jd 6s Jc] [Kh]
ZA1bp6g8IwtTxkUE4eCjDQ: checks
oxnw0GLLpFanjhGkxfRSqA: checks
*** SHOW DOWN ***
ZA1bp6g8IwtTxkUE4eCjDQ: shows [Kd As] (two pair, Kings and Jacks)
oxnw0GLLpFanjhGkxfRSqA: mucks hand
ZA1bp6g8IwtTxkUE4eCjDQ collected $22.40 from pot
*** SUMMARY ***
Total pot $23.50 | Rake $1.10
Board [8h Jd 6s Jc Kh]
Seat 1: YsLQ3BAvgQHWXMAv3Wv6Hg (button) folded before Flop (didn't bet)
Seat 2: xAU6q2/cwmby2sxmA8VcmA (small blind) folded before Flop
Seat 3: wx3sQGkVi2x9wJXuWNHPBw (big blind) folded before Flop
Seat 4: ZA1bp6g8IwtTxkUE4eCjDQ showed [Kd As] and won ($22.40) with two pair, Kings and Jacks
Seat 5: UBZQqpnJZdTYYY1FTb0rLA folded before Flop (didn't bet)
Seat 6: oxnw0GLLpFanjhGkxfRSqA mucked



PokerStars Game #59939694742:  Hold'em No Limit ($0.50/$1.00) - 2009/07/01 0:46:31 ET
Table 'Zka9tv1yilg0MvXWPQrShg' 9-max Seat #6 is the button
Seat 1: TZcz9MEWDA+WydgGruqqbw ($113.85 in chips)
Seat 3: gUUvmqdVlmvpal6B8nYrmg ($100 in chips)
Seat 4: stxmTgSicxShtrDxhOOX2g ($69.25 in chips)
Seat 5: /zy+DB4S5fUQUSfZWFzYGw ($124.90 in chips)
Seat 6: rY8wPoax1lS+HUY+I0FZDw ($145.30 in chips)
Seat 7: p1SafS90nb3Uft5LB0NkHw ($18 in chips)
Seat 8: bL+QVeDcuEdzMGAGg2XJHg ($117.60 in chips)
Seat 9: 6daxhj43mWj04MOPTOmaYA ($95.65 in chips)
p1SafS90nb3Uft5LB0NkHw: posts small blind $0.50
bL+QVeDcuEdzMGAGg2XJHg: posts big blind $1
kz9ziSiGUc+857heiKSayw: sits out
*** HOLE CARDS ***
6daxhj43mWj04MOPTOmaYA: folds
TZcz9MEWDA+WydgGruqqbw: folds
gUUvmqdVlmvpal6B8nYrmg: folds
stxmTgSicxShtrDxhOOX2g: folds
/zy+DB4S5fUQUSfZWFzYGw: folds
rY8wPoax1lS+HUY+I0FZDw: calls $1
p1SafS90nb3Uft5LB0NkHw: folds
bL+QVeDcuEdzMGAGg2XJHg: raises $4 to $5
rY8wPoax1lS+HUY+I0FZDw: calls $4
*** FLOP *** [Qs Ks 5d]
bL+QVeDcuEdzMGAGg2XJHg: bets $10
rY8wPoax1lS+HUY+I0FZDw: folds
bL+QVeDcuEdzMGAGg2XJHg collected $10 from pot
*** SUMMARY ***
Total pot $10.50 | Rake $0.50
Board [Qs Ks 5d]
Seat 1: TZcz9MEWDA+WydgGruqqbw folded before Flop (didn't bet)
Seat 3: gUUvmqdVlmvpal6B8nYrmg folded before Flop (didn't bet)
Seat 4: stxmTgSicxShtrDxhOOX2g folded before Flop (didn't bet)
Seat 5: /zy+DB4S5fUQUSfZWFzYGw folded before Flop (didn't bet)
Seat 6: rY8wPoax1lS+HUY+I0FZDw (button) folded on the Flop
Seat 7: p1SafS90nb3Uft5LB0NkHw (small blind) folded before Flop
Seat 8: bL+QVeDcuEdzMGAGg2XJHg (big blind) collected ($10)
Seat 9: 6daxhj43mWj04MOPTOmaYA folded before Flop (didn't bet)



PokerStars Game #59939697036:  Hold'em No Limit ($0.50/$1.00) - 2009/07/01 0:46:34 ET
Table '/RZcOwpZpHQ+OwPwjsbnRw' 6-max Seat #4 is the button
Seat 1: Zboa6dColKGHBjLPUakZjw ($41.20 in chips)
Seat 2: +xW7QemQU0Fxs+4TnqBRow ($194.50 in chips)
Seat 3: XnT1yK2DD/5FL+0bwuEhqg ($44.95 in chips)
Seat 4: j7NIOHLZk7V2o9fOioO5ug ($115.10 in chips)
Seat 5: wx3sQGkVi2x9wJXuWNHPBw ($192.65 in chips)
Seat 6: XOIf9W+VAxhZqN+SYoyMKA ($288.55 in chips)
wx3sQGkVi2x9wJXuWNHPBw: posts small blind $0.50
XOIf9W+VAxhZqN+SYoyMKA: posts big blind $1
*** HOLE CARDS ***
Zboa6dColKGHBjLPUakZjw: folds
+xW7QemQU0Fxs+4TnqBRow: folds
XnT1yK2DD/5FL+0bwuEhqg: folds
j7NIOHLZk7V2o9fOioO5ug: raises $2 to $3
wx3sQGkVi2x9wJXuWNHPBw: folds
XOIf9W+VAxhZqN+SYoyMKA: calls $2
*** FLOP *** [Kd 7c Jd]
XOIf9W+VAxhZqN+SYoyMKA: checks
j7NIOHLZk7V2o9fOioO5ug: bets $5
XOIf9W+VAxhZqN+SYoyMKA: calls $5
*** TURN *** [Kd 7c Jd] [5d]
XOIf9W+VAxhZqN+SYoyMKA: checks
j7NIOHLZk7V2o9fOioO5ug: checks
*** RIVER *** [Kd 7c Jd 5d] [Jh]
XOIf9W+VAxhZqN+SYoyMKA: checks
j7NIOHLZk7V2o9fOioO5ug: checks
*** SHOW DOWN ***
XOIf9W+VAxhZqN+SYoyMKA: shows [Ts Kc] (two pair, Kings and Jacks)
j7NIOHLZk7V2o9fOioO5ug: mucks hand
XOIf9W+VAxhZqN+SYoyMKA collected $15.70 from pot
*** SUMMARY ***
Total pot $16.50 | Rake $0.80
Board [Kd 7c Jd 5d Jh]
Seat 1: Zboa6dColKGHBjLPUakZjw folded before Flop (didn't bet)
Seat 2: +xW7QemQU0Fxs+4TnqBRow folded before Flop (didn't bet)
Seat 3: XnT1yK2DD/5FL+0bwuEhqg folded before Flop (didn't bet)
Seat 4: j7NIOHLZk7V2o9fOioO5ug (button) mucked
Seat 5: wx3sQGkVi2x9wJXuWNHPBw (small blind) folded before Flop
Seat 6: XOIf9W+VAxhZqN+SYoyMKA (big blind) showed [Ts Kc] and won ($15.70) with two pair, Kings and Jacks



PokerStars Game #59939696556:  Hold'em No Limit ($0.50/$1.00) - 2009/07/01 0:46:34 ET
Table 'CxlB0XELs5P0zDlOhlhAPw' 2-max Seat #1 is the button
Seat 1: +B2wRsLpIMFnVA7qiRoGfg ($41.40 in chips)
Seat 2: I4xAjioR1QwQ5TgX4Z1/qw ($39.70 in chips)
+B2wRsLpIMFnVA7qiRoGfg: posts small blind $0.50
I4xAjioR1QwQ5TgX4Z1/qw: posts big blind $1
*** HOLE CARDS ***
+B2wRsLpIMFnVA7qiRoGfg: calls $0.50
I4xAjioR1QwQ5TgX4Z1/qw: raises $3 to $4
+B2wRsLpIMFnVA7qiRoGfg: folds
I4xAjioR1QwQ5TgX4Z1/qw collected $2 from pot
*** SUMMARY ***
Total pot $2 | Rake $0
Seat 1: +B2wRsLpIMFnVA7qiRoGfg (button) (small blind) folded before Flop
Seat 2: I4xAjioR1QwQ5TgX4Z1/qw (big blind) collected ($2)



PokerStars Game #59939697896:  Hold'em No Limit ($0.50/$1.00) - 2009/07/01 0:46:36 ET
Table 'pHrhryH8jPNdQfY62f8v+g' 6-max Seat #5 is the button
Seat 1: fF4botNMr8/ieVPO1YYRLw ($44.85 in chips)
Seat 2: RqgF7gRoKgRNW8Zoi1ty4A ($134.40 in chips)
Seat 3: 8oS5O7iD/qnFXFXJrGIgNQ ($100 in chips)
Seat 4: wenbG7TaM3H7h5kn78OFNw ($55.70 in chips)
Seat 5: r1/R7y0Ortgoz4lccgW8VA ($28.65 in chips)
Seat 6: xAU6q2/cwmby2sxmA8VcmA ($114.25 in chips)
xAU6q2/cwmby2sxmA8VcmA: posts small blind $0.50
fF4botNMr8/ieVPO1YYRLw: posts big blind $1
*** HOLE CARDS ***
RqgF7gRoKgRNW8Zoi1ty4A: raises $3 to $4
8oS5O7iD/qnFXFXJrGIgNQ: folds
wenbG7TaM3H7h5kn78OFNw: folds
r1/R7y0Ortgoz4lccgW8VA: calls $4
xAU6q2/cwmby2sxmA8VcmA: folds
fF4botNMr8/ieVPO1YYRLw: folds
*** FLOP *** [8c Jh Th]
RqgF7gRoKgRNW8Zoi1ty4A: bets $8
r1/R7y0Ortgoz4lccgW8VA: raises $16.65 to $24.65 and is all-in
RqgF7gRoKgRNW8Zoi1ty4A: calls $16.65
*** TURN *** [8c Jh Th] [6c]
*** RIVER *** [8c Jh Th 6c] [6s]
*** SHOW DOWN ***
RqgF7gRoKgRNW8Zoi1ty4A: shows [Ah Qh] (a pair of Sixes)
r1/R7y0Ortgoz4lccgW8VA: shows [Js Qs] (two pair, Jacks and Sixes)
r1/R7y0Ortgoz4lccgW8VA collected $55.90 from pot
*** SUMMARY ***
Total pot $58.80 | Rake $2.90
Board [8c Jh Th 6c 6s]
Seat 1: fF4botNMr8/ieVPO1YYRLw (big blind) folded before Flop
Seat 2: RqgF7gRoKgRNW8Zoi1ty4A showed [Ah Qh] and lost with a pair of Sixes
Seat 3: 8oS5O7iD/qnFXFXJrGIgNQ folded before Flop (didn't bet)
Seat 4: wenbG7TaM3H7h5kn78OFNw folded before Flop (didn't bet)
Seat 5: r1/R7y0Ortgoz4lccgW8VA (button) showed [Js Qs] and won ($55.90) with two pair, Jacks and Sixes
Seat 6: xAU6q2/cwmby2sxmA8VcmA (small blind) folded before Flop



PokerStars Game #59939698494:  Hold'em No Limit ($0.50/$1.00) - 2009/07/01 0:46:37 ET
Table 'LmXQK9xy3awB+qsPzI21Mw' 2-max Seat #2 is the button
Seat 1: NYi6JFscYNrofSXy4sM+Yw ($235.15 in chips)
Seat 2: TME8GvochpQAo8cmJwWmvA ($97.90 in chips)
TME8GvochpQAo8cmJwWmvA: posts small blind $0.50
NYi6JFscYNrofSXy4sM+Yw: posts big blind $1
*** HOLE CARDS ***
TME8GvochpQAo8cmJwWmvA: folds
NYi6JFscYNrofSXy4sM+Yw collected $1 from pot
*** SUMMARY ***
Total pot $1 | Rake $0
Seat 1: NYi6JFscYNrofSXy4sM+Yw (big blind) collected ($1)
Seat 2: TME8GvochpQAo8cmJwWmvA (button) (small blind) folded before Flop



PokerStars Game #59939699224:  Hold'em No Limit ($0.50/$1.00) - 2009/07/01 0:46:38 ET
Table 'VOs36P6NW+QyXeQ1B62kmA' 6-max Seat #3 is the button
Seat 1: AdLVjddOzm+sRNo1Bc3S6Q ($137.80 in chips)
Seat 2: KpnW5CcJ4Mg6MeclfKmLrw ($119.35 in chips)
Seat 3: TSuRyAHnUPCFjP7Z0rEE0w ($100 in chips)
Seat 4: w02zQzNydODiyV9THKgo9w ($36.30 in chips)
Seat 6: 6tvjsJrdmWg+g7FVrMnzXA ($81.75 in chips)
w02zQzNydODiyV9THKgo9w: posts small blind $0.50
6tvjsJrdmWg+g7FVrMnzXA: posts big blind $1
*** HOLE CARDS ***
AdLVjddOzm+sRNo1Bc3S6Q: folds
KpnW5CcJ4Mg6MeclfKmLrw: folds
TSuRyAHnUPCFjP7Z0rEE0w: folds
w02zQzNydODiyV9THKgo9w: calls $0.50
6tvjsJrdmWg+g7FVrMnzXA: checks
*** FLOP *** [2h 5h 6s]
w02zQzNydODiyV9THKgo9w: bets $2
6tvjsJrdmWg+g7FVrMnzXA: calls $2
*** TURN *** [2h 5h 6s] [As]
w02zQzNydODiyV9THKgo9w: bets $2
6tvjsJrdmWg+g7FVrMnzXA: calls $2
*** RIVER *** [2h 5h 6s As] [3c]
w02zQzNydODiyV9THKgo9w: bets $2
6tvjsJrdmWg+g7FVrMnzXA: raises $6 to $8
w02zQzNydODiyV9THKgo9w: folds
ozrlafxxh1HmYdA0/h+MuA joins the table at seat #5
6tvjsJrdmWg+g7FVrMnzXA collected $13.35 from pot
6tvjsJrdmWg+g7FVrMnzXA: doesn't show hand
*** SUMMARY ***
Total pot $14 | Rake $0.65
Board [2h 5h 6s As 3c]
Seat 1: AdLVjddOzm+sRNo1Bc3S6Q folded before Flop (didn't bet)
Seat 2: KpnW5CcJ4Mg6MeclfKmLrw folded before Flop (didn't bet)
Seat 3: TSuRyAHnUPCFjP7Z0rEE0w (button) folded before Flop (didn't bet)
Seat 4: w02zQzNydODiyV9THKgo9w (small blind) folded on the River
Seat 6: 6tvjsJrdmWg+g7FVrMnzXA (big blind) collected ($13.35)



PokerStars Game #59939700028:  Hold'em No Limit ($0.50/$1.00) - 2009/07/01 0:46:39 ET
Table 'U9zqzC8f3oTJ2ShXFgSSOA' 6-max Seat #4 is the button
Seat 1: +xW7QemQU0Fxs+4TnqBRow ($100 in chips)
Seat 3: yfXek8iJ7O4CFyqXrtGcfg ($14.55 in chips)
Seat 4: 33q95we0Etwgrm6guQGncw ($86.25 in chips)
Seat 5: KfwW5us6tydK81NYTtK1gw ($290.25 in chips)
Seat 6: aIxzFKdtpDSkUePKZy/niQ ($30.55 in chips)
KfwW5us6tydK81NYTtK1gw: posts small blind $0.50
aIxzFKdtpDSkUePKZy/niQ: posts big blind $1
JwCcjZl0bjJzG7hmE0dnTA: sits out
*** HOLE CARDS ***
+xW7QemQU0Fxs+4TnqBRow: folds
yfXek8iJ7O4CFyqXrtGcfg: folds
33q95we0Etwgrm6guQGncw: folds
KfwW5us6tydK81NYTtK1gw: folds
aIxzFKdtpDSkUePKZy/niQ collected $1 from pot
*** SUMMARY ***
Total pot $1 | Rake $0
Seat 1: +xW7QemQU0Fxs+4TnqBRow folded before Flop (didn't bet)
Seat 3: yfXek8iJ7O4CFyqXrtGcfg folded before Flop (didn't bet)
Seat 4: 33q95we0Etwgrm6guQGncw (button) folded before Flop (didn't bet)
Seat 5: KfwW5us6tydK81NYTtK1gw (small blind) folded before Flop
Seat 6: aIxzFKdtpDSkUePKZy/niQ (big blind) collected ($1)



PokerStars Game #59939700066:  Hold'em No Limit ($0.50/$1.00) - 2009/07/01 0:46:39 ET
Table 'tyUh+jyNvrceIQdKMJjQ2wZFWj23PMihdwrNWv41OG/Qeat #5 is the button
Seat 2: XvUbOIg94d25feWeQlOTVg ($77.40 in chips)
Seat 3: TalCiLYHCd+ffkmR3auPvA ($62.80 in chips)
Seat 4: TSuRyAHnUPCFjP7Z0rEE0w ($118.25 in chips)
Seat 5: j7NIOHLZk7V2o9fOioO5ug ($110.10 in chips)
Seat 6: YsLQ3BAvgQHWXMAv3Wv6Hg ($147.15 in chips)
YsLQ3BAvgQHWXMAv3Wv6Hg: posts small blind $0.50
XvUbOIg94d25feWeQlOTVg: posts big blind $1
*** HOLE CARDS ***
TalCiLYHCd+ffkmR3auPvA: raises $2 to $3
TSuRyAHnUPCFjP7Z0rEE0w: folds
j7NIOHLZk7V2o9fOioO5ug: folds
YsLQ3BAvgQHWXMAv3Wv6Hg: folds
XvUbOIg94d25feWeQlOTVg: raises $2 to $5
TalCiLYHCd+ffkmR3auPvA: calls $2
*** FLOP *** [9c 3h Qs]
XvUbOIg94d25feWeQlOTVg: checks
TalCiLYHCd+ffkmR3auPvA: bets $6
XvUbOIg94d25feWeQlOTVg: folds
TalCiLYHCd+ffkmR3auPvA collected $10 from pot
TalCiLYHCd+ffkmR3auPvA: doesn't show hand
*** SUMMARY ***
Total pot $10.50 | Rake $0.50
Board [9c 3h Qs]
Seat 2: XvUbOIg94d25feWeQlOTVg (big blind) folded on the Flop
Seat 3: TalCiLYHCd+ffkmR3auPvA collected ($10)
Seat 4: TSuRyAHnUPCFjP7Z0rEE0w folded before Flop (didn't bet)
Seat 5: j7NIOHLZk7V2o9fOioO5ug (button) folded before Flop (didn't bet)
Seat 6: YsLQ3BAvgQHWXMAv3Wv6Hg (small blind) folded before Flop



PokerStars Game #59939700168:  Hold'em No Limit ($0.50/$1.00) - 2009/07/01 0:46:39 ET
Table 'cKH9c4x6u79IqCdaKKvXrw' 9-max Seat #1 is the button
Seat 1: Pp/KTcXkfZKKUHkjyaLTdg ($17 in chips)
Seat 2: 8S3JMH4TY3whgIlZmMv66w ($59.35 in chips)
Seat 3: 997ViqAtWn1FPjJqcffwcA ($158.60 in chips)
Seat 4: FL3MrLspcF23LYvC4ipBOA ($100 in chips)
Seat 5: x80+i7DJL+81v3quj7KbNg ($23 in chips)
Seat 6: Bsd/K5gAcLanYbGiPirRjw ($168.55 in chips)
Seat 7: 1GkkVBhlJ92guE6K5mS5Ig ($50.55 in chips)
Seat 8: 4/8w7g4QE6v0i1tIIf/1HQ ($42.15 in chips)
Seat 9: 6XkTu4ahxzHnvjjc1R8YjQ ($37.65 in chips)
8S3JMH4TY3whgIlZmMv66w: posts small blind $0.50
997ViqAtWn1FPjJqcffwcA: posts big blind $1
*** HOLE CARDS ***
FL3MrLspcF23LYvC4ipBOA: folds
x80+i7DJL+81v3quj7KbNg: folds
Bsd/K5gAcLanYbGiPirRjw: folds
1GkkVBhlJ92guE6K5mS5Ig: folds
4/8w7g4QE6v0i1tIIf/1HQ: folds
6XkTu4ahxzHnvjjc1R8YjQ: folds
Pp/KTcXkfZKKUHkjyaLTdg: folds
8S3JMH4TY3whgIlZmMv66w: folds
997ViqAtWn1FPjJqcffwcA collected $1 from pot
*** SUMMARY ***
Total pot $1 | Rake $0
Seat 1: Pp/KTcXkfZKKUHkjyaLTdg (button) folded before Flop (didn't bet)
Seat 2: 8S3JMH4TY3whgIlZmMv66w (small blind) folded before Flop
Seat 3: 997ViqAtWn1FPjJqcffwcA (big blind) collected ($1)
Seat 4: FL3MrLspcF23LYvC4ipBOA folded before Flop (didn't bet)
Seat 5: x80+i7DJL+81v3quj7KbNg folded before Flop (didn't bet)
Seat 6: Bsd/K5gAcLanYbGiPirRjw folded before Flop (didn't bet)
Seat 7: 1GkkVBhlJ92guE6K5mS5Ig folded before Flop (didn't bet)
Seat 8: 4/8w7g4QE6v0i1tIIf/1HQ folded before Flop (didn't bet)
Seat 9: 6XkTu4ahxzHnvjjc1R8YjQ folded before Flop (didn't bet)



PokerStars Game #59939702480:  Hold'em No Limit ($0.50/$1.00) - 2009/07/01 0:46:43 ET
Table 'LmXQK9xy3awB+qsPzI21Mw' 2-max Seat #1 is the button
Seat 1: NYi6JFscYNrofSXy4sM+Yw ($235.65 in chips)
Seat 2: TME8GvochpQAo8cmJwWmvA ($97.40 in chips)
NYi6JFscYNrofSXy4sM+Yw: posts small blind $0.50
TME8GvochpQAo8cmJwWmvA: posts big blind $1
*** HOLE CARDS ***
NYi6JFscYNrofSXy4sM+Yw: raises $2 to $3
TME8GvochpQAo8cmJwWmvA: calls $2
*** FLOP *** [7d Ts Tc]
TME8GvochpQAo8cmJwWmvA: checks
NYi6JFscYNrofSXy4sM+Yw: bets $3
TME8GvochpQAo8cmJwWmvA: folds
NYi6JFscYNrofSXy4sM+Yw collected $5.70 from pot
*** SUMMARY ***
Total pot $6 | Rake $0.30
Board [7d Ts Tc]
Seat 1: NYi6JFscYNrofSXy4sM+Yw (button) (small blind) collected ($5.70)
Seat 2: TME8GvochpQAo8cmJwWmvA (big blind) folded on the Flop



PokerStars Game #59939702416:  Hold'em No Limit ($0.50/$1.00) - 2009/07/01 0:46:43 ET
Table 'rmZfTK+oSebeUPJNbWhdAA' 6-max Seat #2 is the button
Seat 1: xAU6q2/cwmby2sxmA8VcmA ($100 in chips)
Seat 2: z7O9PO/WEcqRouIydFhS9Q ($103.50 in chips)
Seat 3: 9yjOzGERLaEZS8CZ6YNHFg ($114.85 in chips)
Seat 4: 1/mIuXfgx1ZyVkodrmfQDw ($100 in chips)
Seat 5: 5lY8d6Cnm4HUkt/8FZSj4g ($84.75 in chips)
Seat 6: j7NIOHLZk7V2o9fOioO5ug ($136.80 in chips)
9yjOzGERLaEZS8CZ6YNHFg: posts small blind $0.50
1/mIuXfgx1ZyVkodrmfQDw: posts big blind $1
*** HOLE CARDS ***
5lY8d6Cnm4HUkt/8FZSj4g: calls $1
j7NIOHLZk7V2o9fOioO5ug: folds
xAU6q2/cwmby2sxmA8VcmA: folds
z7O9PO/WEcqRouIydFhS9Q: folds
9yjOzGERLaEZS8CZ6YNHFg: folds
1/mIuXfgx1ZyVkodrmfQDw: checks
*** FLOP *** [2s 8c 2h]
1/mIuXfgx1ZyVkodrmfQDw: bets $2
5lY8d6Cnm4HUkt/8FZSj4g: calls $2
*** TURN *** [2s 8c 2h] [7c]
1/mIuXfgx1ZyVkodrmfQDw: checks
5lY8d6Cnm4HUkt/8FZSj4g: bets $3
1/mIuXfgx1ZyVkodrmfQDw: folds
5lY8d6Cnm4HUkt/8FZSj4g collected $6.20 from pot
5lY8d6Cnm4HUkt/8FZSj4g: doesn't show hand
*** SUMMARY ***
Total pot $6.50 | Rake $0.30
Board [2s 8c 2h 7c]
Seat 1: xAU6q2/cwmby2sxmA8VcmA folded before Flop (didn't bet)
Seat 2: z7O9PO/WEcqRouIydFhS9Q (button) folded before Flop (didn't bet)
Seat 3: 9yjOzGERLaEZS8CZ6YNHFg (small blind) folded before Flop
Seat 4: 1/mIuXfgx1ZyVkodrmfQDw (big blind) folded on the Turn
Seat 5: 5lY8d6Cnm4HUkt/8FZSj4g collected ($6.20)
Seat 6: j7NIOHLZk7V2o9fOioO5ug folded before Flop (didn't bet)



PokerStars Game #59939702640:  Hold'em No Limit ($0.50/$1.00) - 2009/07/01 0:46:43 ET
Table 'eU3bWpDDg3Z+9R4m4iVmog' 6-max Seat #3 is the button
Seat 1: TSuRyAHnUPCFjP7Z0rEE0w ($189.65 in chips)
Seat 2: 8CAoOzhmB8n3nRFf3V4BTg ($97.80 in chips)
Seat 3: U6tnjwZRpTnM+YkqkCjwyQ ($187.15 in chips)
Seat 4: GDVIsbEJ/DOJsMKE4Asz0A ($68.80 in chips)
Seat 5: AdLVjddOzm+sRNo1Bc3S6Q ($111.45 in chips)
Seat 6: hpxXcmRkXXI9HE5+5/j/0Q ($121.95 in chips)
GDVIsbEJ/DOJsMKE4Asz0A: posts small blind $0.50
AdLVjddOzm+sRNo1Bc3S6Q: posts big blind $1
*** HOLE CARDS ***
hpxXcmRkXXI9HE5+5/j/0Q: raises $2 to $3
TSuRyAHnUPCFjP7Z0rEE0w: folds
8CAoOzhmB8n3nRFf3V4BTg: folds
U6tnjwZRpTnM+YkqkCjwyQ: folds
GDVIsbEJ/DOJsMKE4Asz0A: folds
AdLVjddOzm+sRNo1Bc3S6Q: folds
hpxXcmRkXXI9HE5+5/j/0Q collected $2.50 from pot
hpxXcmRkXXI9HE5+5/j/0Q: doesn't show hand
*** SUMMARY ***
Total pot $2.50 | Rake $0
Seat 1: TSuRyAHnUPCFjP7Z0rEE0w folded before Flop (didn't bet)
Seat 2: 8CAoOzhmB8n3nRFf3V4BTg folded before Flop (didn't bet)
Seat 3: U6tnjwZRpTnM+YkqkCjwyQ (button) folded before Flop (didn't bet)
Seat 4: GDVIsbEJ/DOJsMKE4Asz0A (small blind) folded before Flop
Seat 5: AdLVjddOzm+sRNo1Bc3S6Q (big blind) folded before Flop
Seat 6: hpxXcmRkXXI9HE5+5/j/0Q collected ($2.50)



PokerStars Game #59939703824:  Hold'em No Limit ($0.50/$1.00) - 2009/07/01 0:46:45 ET
Table 'tJq9SfN1ywY0r03VBlWlwQ' 9-max Seat #8 is the button
Seat 1: wZsU+w9r7G66x93UuvBf1Q ($335.80 in chips)
Seat 2: RqkO8O/Y3qlc3PIuCAHjVg ($68.40 in chips)
Seat 3: FVs16t7GgfWgQWt4JxsObQ ($36.05 in chips)
Seat 4: bLbSOSmSOnqE0iTcH/5dxA ($111.70 in chips)
Seat 5: Ogn4JDV3mp4ZDKO49IFzKA ($19.90 in chips)
Seat 6: gUUvmqdVlmvpal6B8nYrmg ($126.05 in chips)
Seat 7: qVhRZ0PLZ95XRJHWAjXjOQ ($128.20 in chips)
Seat 8: G4DEhsZFmznGNVpy2SEocA ($19 in chips)
Seat 9: XE5QF1y74bpHog9JxWJMWQ ($103.20 in chips)
XE5QF1y74bpHog9JxWJMWQ: posts small blind $0.50
wZsU+w9r7G66x93UuvBf1Q: posts big blind $1
*** HOLE CARDS ***
RqkO8O/Y3qlc3PIuCAHjVg: folds
FVs16t7GgfWgQWt4JxsObQ: calls $1
bLbSOSmSOnqE0iTcH/5dxA: folds
Ogn4JDV3mp4ZDKO49IFzKA: folds
gUUvmqdVlmvpal6B8nYrmg: raises $1 to $2
qVhRZ0PLZ95XRJHWAjXjOQ: folds
G4DEhsZFmznGNVpy2SEocA: raises $17 to $19 and is all-in
XE5QF1y74bpHog9JxWJMWQ: folds
wZsU+w9r7G66x93UuvBf1Q: folds
FVs16t7GgfWgQWt4JxsObQ: folds
gUUvmqdVlmvpal6B8nYrmg: folds
G4DEhsZFmznGNVpy2SEocA collected $6.50 from pot
*** SUMMARY ***
Total pot $6.50 | Rake $0
Seat 1: wZsU+w9r7G66x93UuvBf1Q (big blind) folded before Flop
Seat 2: RqkO8O/Y3qlc3PIuCAHjVg folded before Flop (didn't bet)
Seat 3: FVs16t7GgfWgQWt4JxsObQ folded before Flop
Seat 4: bLbSOSmSOnqE0iTcH/5dxA folded before Flop (didn't bet)
Seat 5: Ogn4JDV3mp4ZDKO49IFzKA folded before Flop (didn't bet)
Seat 6: gUUvmqdVlmvpal6B8nYrmg folded before Flop
Seat 7: qVhRZ0PLZ95XRJHWAjXjOQ folded before Flop (didn't bet)
Seat 8: G4DEhsZFmznGNVpy2SEocA (button) collected ($6.50)
Seat 9: XE5QF1y74bpHog9JxWJMWQ (small blind) folded before Flop



PokerStars Game #59939703890:  Hold'em No Limit ($0.50/$1.00) - 2009/07/01 0:46:45 ET
Table '6YvsYDPNIDx2v5z3bJnwZQ' 9-max Seat #8 is the button
Seat 1: Ogn4JDV3mp4ZDKO49IFzKA ($17.70 in chips)
Seat 2: x80+i7DJL+81v3quj7KbNg ($20 in chips)
Seat 3: negfosHnGOZXSHpWDRKyBQ ($17.30 in chips)
Seat 4: kEr5NYB+JIG5+szcYMr6hA ($41.50 in chips)
Seat 5: mBRWbnUl8diyBO1qTJaNzw ($160.70 in chips)
Seat 6: uMPEfCcGCfsxmy53tVUMug ($100 in chips)
Seat 7: mae7OMTaJ/MFimNbZegCkg ($50 in chips)
Seat 8: PSFxpXgPedVZyHSu2Zhb7Q ($103.05 in chips)
Ogn4JDV3mp4ZDKO49IFzKA: posts small blind $0.50
x80+i7DJL+81v3quj7KbNg: posts big blind $1
mae7OMTaJ/MFimNbZegCkg: posts big blind $1
*** HOLE CARDS ***
negfosHnGOZXSHpWDRKyBQ: folds
kEr5NYB+JIG5+szcYMr6hA: folds
mBRWbnUl8diyBO1qTJaNzw: raises $4 to $5
jDwhY1kCdc6EkAHbT7PJMQ leaves the table
uMPEfCcGCfsxmy53tVUMug: folds
mae7OMTaJ/MFimNbZegCkg: folds
PSFxpXgPedVZyHSu2Zhb7Q: folds
ZgMRSHJ9EOtPeVHmdeV9kQ joins the table at seat #9
Ogn4JDV3mp4ZDKO49IFzKA: folds
x80+i7DJL+81v3quj7KbNg: folds
mBRWbnUl8diyBO1qTJaNzw collected $3.50 from pot
*** SUMMARY ***
Total pot $3.50 | Rake $0
Seat 1: Ogn4JDV3mp4ZDKO49IFzKA (small blind) folded before Flop
Seat 2: x80+i7DJL+81v3quj7KbNg (big blind) folded before Flop
Seat 3: negfosHnGOZXSHpWDRKyBQ folded before Flop (didn't bet)
Seat 4: kEr5NYB+JIG5+szcYMr6hA folded before Flop (didn't bet)
Seat 5: mBRWbnUl8diyBO1qTJaNzw collected ($3.50)
Seat 6: uMPEfCcGCfsxmy53tVUMug folded before Flop (didn't bet)
Seat 7: mae7OMTaJ/MFimNbZegCkg folded before Flop
Seat 8: PSFxpXgPedVZyHSu2Zhb7Q (button) folded before Flop (didn't bet)



PokerStars Game #59939706090:  Hold'em No Limit ($0.50/$1.00) - 2009/07/01 0:46:49 ET
Table 'cBDNutyLBKEk9+ptwsKmTw' 6-max Seat #2 is the button
Seat 1: xAU6q2/cwmby2sxmA8VcmA ($100 in chips)
Seat 2: 5lY8d6Cnm4HUkt/8FZSj4g ($102.80 in chips)
Seat 3: G5ZSSN6RSON3gkNvk/SmYg ($107.40 in chips)
Seat 4: 3q7F5QtzC30pSrn0nl9i+A ($36.70 in chips)
Seat 5: OGMLOcTNYZXZU81au7ztUw ($145.05 in chips)
Seat 6: NqVlOSH2lp+pp/TK3vvK5g ($45.90 in chips)
G5ZSSN6RSON3gkNvk/SmYg: posts small blind $0.50
3q7F5QtzC30pSrn0nl9i+A: posts big blind $1
*** HOLE CARDS ***
OGMLOcTNYZXZU81au7ztUw: folds
NqVlOSH2lp+pp/TK3vvK5g: calls $1
xAU6q2/cwmby2sxmA8VcmA: folds
5lY8d6Cnm4HUkt/8FZSj4g: folds
G5ZSSN6RSON3gkNvk/SmYg: folds
3q7F5QtzC30pSrn0nl9i+A: checks
*** FLOP *** [2h 9s 5h]
3q7F5QtzC30pSrn0nl9i+A: checks
NqVlOSH2lp+pp/TK3vvK5g: bets $2
3q7F5QtzC30pSrn0nl9i+A: folds
NqVlOSH2lp+pp/TK3vvK5g collected $2.40 from pot
*** SUMMARY ***
Total pot $2.50 | Rake $0.10
Board [2h 9s 5h]
Seat 1: xAU6q2/cwmby2sxmA8VcmA folded before Flop (didn't bet)
Seat 2: 5lY8d6Cnm4HUkt/8FZSj4g (button) folded before Flop (didn't bet)
Seat 3: G5ZSSN6RSON3gkNvk/SmYg (small blind) folded before Flop
Seat 4: 3q7F5QtzC30pSrn0nl9i+A (big blind) folded on the Flop
Seat 5: OGMLOcTNYZXZU81au7ztUw folded before Flop (didn't bet)
Seat 6: NqVlOSH2lp+pp/TK3vvK5g collected ($2.40)



PokerStars Game #59939706712:  Hold'em No Limit ($0.50/$1.00) - 2009/07/01 0:46:50 ET
Table 'CxlB0XELs5P0zDlOhlhAPw' 2-max Seat #2 is the button
Seat 1: +B2wRsLpIMFnVA7qiRoGfg ($40.40 in chips)
Seat 2: I4xAjioR1QwQ5TgX4Z1/qw ($40.70 in chips)
I4xAjioR1QwQ5TgX4Z1/qw: posts small blind $0.50
+B2wRsLpIMFnVA7qiRoGfg: posts big blind $1
*** HOLE CARDS ***
I4xAjioR1QwQ5TgX4Z1/qw: calls $0.50
+B2wRsLpIMFnVA7qiRoGfg: raises $2 to $3
I4xAjioR1QwQ5TgX4Z1/qw: calls $2
*** FLOP *** [Qh Ad 2s]
+B2wRsLpIMFnVA7qiRoGfg: bets $3
I4xAjioR1QwQ5TgX4Z1/qw: folds
+B2wRsLpIMFnVA7qiRoGfg collected $5.70 from pot
*** SUMMARY ***
Total pot $6 | Rake $0.30
Board [Qh Ad 2s]
Seat 1: +B2wRsLpIMFnVA7qiRoGfg (big blind) collected ($5.70)
Seat 2: I4xAjioR1QwQ5TgX4Z1/qw (button) (small blind) folded on the Flop



PokerStars Game #59939707760:  Hold'em No Limit ($0.50/$1.00) - 2009/07/01 0:46:51 ET
Table 'uNlePsyMIqzM691Xkrlk6Q' 9-max Seat #9 is the button
Seat 1: bLbSOSmSOnqE0iTcH/5dxA ($100.50 in chips)
Seat 2: +OqpStnt0FqbCfyHAWaLbg ($79.55 in chips)
Seat 3: h7qXkU57Bb8ZuPwMyxR8Ug ($31.50 in chips)
Seat 4: TZcz9MEWDA+WydgGruqqbw ($102.65 in chips)
Seat 5: 3obndzTJ6fECz8+wWhMd1w ($18.50 in chips)
Seat 6: uMPEfCcGCfsxmy53tVUMug ($106.10 in chips)
Seat 7: w6cw9nzN7AvkkHBVVjykoQ ($45.90 in chips)
Seat 8: laA8va+Yv8WuMqT1zdR91g ($100 in chips)
Seat 9: vR4IO10geOgvTW+LAUBv/A ($100.75 in chips)
bLbSOSmSOnqE0iTcH/5dxA: posts small blind $0.50
+OqpStnt0FqbCfyHAWaLbg: posts big blind $1
*** HOLE CARDS ***
h7qXkU57Bb8ZuPwMyxR8Ug: folds
TZcz9MEWDA+WydgGruqqbw: folds
3obndzTJ6fECz8+wWhMd1w: folds
uMPEfCcGCfsxmy53tVUMug: folds
w6cw9nzN7AvkkHBVVjykoQ: folds
laA8va+Yv8WuMqT1zdR91g: folds
vR4IO10geOgvTW+LAUBv/A: folds
bLbSOSmSOnqE0iTcH/5dxA: folds
+OqpStnt0FqbCfyHAWaLbg collected $1 from pot
*** SUMMARY ***
Total pot $1 | Rake $0
Seat 1: bLbSOSmSOnqE0iTcH/5dxA (small blind) folded before Flop
Seat 2: +OqpStnt0FqbCfyHAWaLbg (big blind) collected ($1)
Seat 3: h7qXkU57Bb8ZuPwMyxR8Ug folded before Flop (didn't bet)
Seat 4: TZcz9MEWDA+WydgGruqqbw folded before Flop (didn't bet)
Seat 5: 3obndzTJ6fECz8+wWhMd1w folded before Flop (didn't bet)
Seat 6: uMPEfCcGCfsxmy53tVUMug folded before Flop (didn't bet)
Seat 7: w6cw9nzN7AvkkHBVVjykoQ folded before Flop (didn't bet)
Seat 8: laA8va+Yv8WuMqT1zdR91g folded before Flop (didn't bet)
Seat 9: vR4IO10geOgvTW+LAUBv/A (button) folded before Flop (didn't bet)



PokerStars Game #59939709292:  Hold'em No Limit ($0.50/$1.00) - 2009/07/01 0:46:54 ET
Table 'N2bNCDHL96aCQDvZIh+yQQ' 6-max Seat #3 is the button
Seat 1: iHo1oDbrEVJ8nEGdaPrICw ($100 in chips)
Seat 2: KpnW5CcJ4Mg6MeclfKmLrw ($161.80 in chips)
Seat 3: Qy/UBNbD2HaA0Ogxg8Sf3w ($159.70 in chips)
Seat 4: uCqEjnxh2/vFBjKYkfTOkw ($167.40 in chips)
Seat 6: TSuRyAHnUPCFjP7Z0rEE0w ($100 in chips)
uCqEjnxh2/vFBjKYkfTOkw: posts small blind $0.50
rHlMOfR7kpQQxe+PFQz0xQ: is sitting out
TSuRyAHnUPCFjP7Z0rEE0w: posts big blind $1
*** HOLE CARDS ***
rHlMOfR7kpQQxe+PFQz0xQ leaves the table
iHo1oDbrEVJ8nEGdaPrICw: raises $2 to $3
KpnW5CcJ4Mg6MeclfKmLrw has timed out
KpnW5CcJ4Mg6MeclfKmLrw: folds
KpnW5CcJ4Mg6MeclfKmLrw is sitting out
KpnW5CcJ4Mg6MeclfKmLrw has returned
Qy/UBNbD2HaA0Ogxg8Sf3w: folds
uCqEjnxh2/vFBjKYkfTOkw: raises $5 to $8
TSuRyAHnUPCFjP7Z0rEE0w: folds
iHo1oDbrEVJ8nEGdaPrICw: calls $5
*** FLOP *** [3c 8s 2c]
uCqEjnxh2/vFBjKYkfTOkw: bets $10
iHo1oDbrEVJ8nEGdaPrICw: folds
uCqEjnxh2/vFBjKYkfTOkw collected $16.15 from pot
uCqEjnxh2/vFBjKYkfTOkw: doesn't show hand
*** SUMMARY ***
Total pot $17 | Rake $0.85
Board [3c 8s 2c]
Seat 1: iHo1oDbrEVJ8nEGdaPrICw folded on the Flop
Seat 2: KpnW5CcJ4Mg6MeclfKmLrw folded before Flop (didn't bet)
Seat 3: Qy/UBNbD2HaA0Ogxg8Sf3w (button) folded before Flop (didn't bet)
Seat 4: uCqEjnxh2/vFBjKYkfTOkw (small blind) collected ($16.15)
Seat 6: TSuRyAHnUPCFjP7Z0rEE0w (big blind) folded before Flop



PokerStars Game #59939710702:  Hold'em No Limit ($0.50/$1.00) - 2009/07/01 0:46:56 ET
Table 'hugOjcwJvzEwZbK7tyiWuQ' 9-max Seat #3 is the button
Seat 1: N9n5Wc3s35DpCrOAUUNAaQ ($130 in chips)
Seat 2: r27C1nIV4NS4+qbnrgBQSw ($259.10 in chips)
Seat 3: jDwhY1kCdc6EkAHbT7PJMQ ($106.15 in chips)
Seat 4: UWB3oeddt/GObx2Mix2Anw ($204.75 in chips)
Seat 5: 5BRGWf+R3nt2WS3b5xX+zA ($20.80 in chips)
Seat 6: gUUvmqdVlmvpal6B8nYrmg ($107.70 in chips)
Seat 7: FL3MrLspcF23LYvC4ipBOA ($100 in chips)
Seat 8: /zy+DB4S5fUQUSfZWFzYGw ($101.25 in chips)
Seat 9: W8P9bUKCs43TO1xHm0dL6w ($88.15 in chips)
UWB3oeddt/GObx2Mix2Anw: posts small blind $0.50
5BRGWf+R3nt2WS3b5xX+zA: posts big blind $1
*** HOLE CARDS ***
gUUvmqdVlmvpal6B8nYrmg: folds
FL3MrLspcF23LYvC4ipBOA: folds
/zy+DB4S5fUQUSfZWFzYGw: folds
W8P9bUKCs43TO1xHm0dL6w: folds
N9n5Wc3s35DpCrOAUUNAaQ: folds
r27C1nIV4NS4+qbnrgBQSw: folds
jDwhY1kCdc6EkAHbT7PJMQ: raises $3 to $4
UWB3oeddt/GObx2Mix2Anw: folds
5BRGWf+R3nt2WS3b5xX+zA: folds
jDwhY1kCdc6EkAHbT7PJMQ collected $2.50 from pot
*** SUMMARY ***
Total pot $2.50 | Rake $0
Seat 1: N9n5Wc3s35DpCrOAUUNAaQ folded before Flop (didn't bet)
Seat 2: r27C1nIV4NS4+qbnrgBQSw folded before Flop (didn't bet)
Seat 3: jDwhY1kCdc6EkAHbT7PJMQ (button) collected ($2.50)
Seat 4: UWB3oeddt/GObx2Mix2Anw (small blind) folded before Flop
Seat 5: 5BRGWf+R3nt2WS3b5xX+zA (big blind) folded before Flop
Seat 6: gUUvmqdVlmvpal6B8nYrmg folded before Flop (didn't bet)
Seat 7: FL3MrLspcF23LYvC4ipBOA folded before Flop (didn't bet)
Seat 8: /zy+DB4S5fUQUSfZWFzYGw folded before Flop (didn't bet)
Seat 9: W8P9bUKCs43TO1xHm0dL6w folded before Flop (didn't bet)



PokerStars Game #59939710922:  Hold'em No Limit ($0.50/$1.00) - 2009/07/01 0:46:56 ET
Table 'LmXQK9xy3awB+qsPzI21Mw' 2-max Seat #2 is the button
Seat 1: NYi6JFscYNrofSXy4sM+Yw ($238.35 in chips)
Seat 2: TME8GvochpQAo8cmJwWmvA ($94.40 in chips)
TME8GvochpQAo8cmJwWmvA: posts small blind $0.50
NYi6JFscYNrofSXy4sM+Yw: posts big blind $1
*** HOLE CARDS ***
TME8GvochpQAo8cmJwWmvA: folds
NYi6JFscYNrofSXy4sM+Yw collected $1 from pot
*** SUMMARY ***
Total pot $1 | Rake $0
Seat 1: NYi6JFscYNrofSXy4sM+Yw (big blind) collected ($1)
Seat 2: TME8GvochpQAo8cmJwWmvA (button) (small blind) folded before Flop



PokerStars Game #59939713156:  Hold'em No Limit ($0.50/$1.00) - 2009/07/01 0:46:59 ET
Table '+cA8mcmhaedZ7YcrDdhmeQ' 6-max Seat #4 is the button
Seat 1: lsLuWlcPA3Rh7kJVLzMh0Q ($290.50 in chips)
Seat 2: RqgF7gRoKgRNW8Zoi1ty4A ($101.50 in chips)
Seat 3: 7H5WkGzGvsv56y1iaqHvRg ($35.85 in chips)
Seat 4: LjL3AIERHn559yyW1mTUYQ ($171.80 in chips)
Seat 5: +7hFKAL0b0O/n8G72TclJA ($40 in chips)
Seat 6: YfsTQsY/fxb+YqbdclTHuw ($58.70 in chips)
+7hFKAL0b0O/n8G72TclJA: posts small blind $0.50
YfsTQsY/fxb+YqbdclTHuw: posts big blind $1
*** HOLE CARDS ***
lsLuWlcPA3Rh7kJVLzMh0Q: folds
RqgF7gRoKgRNW8Zoi1ty4A: folds
7H5WkGzGvsv56y1iaqHvRg: folds
LjL3AIERHn559yyW1mTUYQ: folds
+7hFKAL0b0O/n8G72TclJA: raises $2 to $3
YfsTQsY/fxb+YqbdclTHuw: calls $2
*** FLOP *** [3h Jc 4d]
+7hFKAL0b0O/n8G72TclJA: checks
YfsTQsY/fxb+YqbdclTHuw: checks
*** TURN *** [3h Jc 4d] [7c]
+7hFKAL0b0O/n8G72TclJA: checks
YfsTQsY/fxb+YqbdclTHuw: checks
*** RIVER *** [3h Jc 4d 7c] [2c]
+7hFKAL0b0O/n8G72TclJA: checks
YfsTQsY/fxb+YqbdclTHuw: checks
*** SHOW DOWN ***
+7hFKAL0b0O/n8G72TclJA: shows [Ah 8d] (high card Ace)
YfsTQsY/fxb+YqbdclTHuw: mucks hand
+7hFKAL0b0O/n8G72TclJA collected $5.70 from pot
*** SUMMARY ***
Total pot $6 | Rake $0.30
Board [3h Jc 4d 7c 2c]
Seat 1: lsLuWlcPA3Rh7kJVLzMh0Q folded before Flop (didn't bet)
Seat 2: RqgF7gRoKgRNW8Zoi1ty4A folded before Flop (didn't bet)
Seat 3: 7H5WkGzGvsv56y1iaqHvRg folded before Flop (didn't bet)
Seat 4: LjL3AIERHn559yyW1mTUYQ (button) folded before Flop (didn't bet)
Seat 5: +7hFKAL0b0O/n8G72TclJA (small blind) showed [Ah 8d] and won ($5.70) with high card Ace
Seat 6: YfsTQsY/fxb+YqbdclTHuw (big blind) mucked



PokerStars Game #59939713078:  Hold'em No Limit ($0.50/$1.00) - 2009/07/01 0:46:59 ET
Table 'GxCPo/gd3OSthkYrAxJngg' 6-max Seat #5 is the button
Seat 1: sH8BpAFP+jGFxCgVpD1Lew ($259.85 in chips)
Seat 2: YExX2paeIHrmfIwV1ivM/w ($78.20 in chips)
Seat 3: o6plE+MSW4XFNTeONe16xg ($31.10 in chips)
Seat 4: YMJG+F++3Aj6P8dAWda5fw ($105.15 in chips)
Seat 5: G5ZSSN6RSON3gkNvk/SmYg ($108.25 in chips)
Seat 6: sS9IXedL3MiRmpVXhAILhw ($102.45 in chips)
sS9IXedL3MiRmpVXhAILhw: posts small blind $0.50
sH8BpAFP+jGFxCgVpD1Lew: posts big blind $1
*** HOLE CARDS ***
YExX2paeIHrmfIwV1ivM/w: folds
o6plE+MSW4XFNTeONe16xg: folds
YMJG+F++3Aj6P8dAWda5fw: folds
G5ZSSN6RSON3gkNvk/SmYg: folds
sS9IXedL3MiRmpVXhAILhw: folds
sH8BpAFP+jGFxCgVpD1Lew collected $1 from pot
sH8BpAFP+jGFxCgVpD1Lew: doesn't show hand
*** SUMMARY ***
Total pot $1 | Rake $0
Seat 1: sH8BpAFP+jGFxCgVpD1Lew (big blind) collected ($1)
Seat 2: YExX2paeIHrmfIwV1ivM/w folded before Flop (didn't bet)
Seat 3: o6plE+MSW4XFNTeONe16xg folded before Flop (didn't bet)
Seat 4: YMJG+F++3Aj6P8dAWda5fw folded before Flop (didn't bet)
Seat 5: G5ZSSN6RSON3gkNvk/SmYg (button) folded before Flop (didn't bet)
Seat 6: sS9IXedL3MiRmpVXhAILhw (small blind) folded before Flop



PokerStars Game #59939712488:  Hold'em No Limit ($0.50/$1.00) - 2009/07/01 0:46:59 ET
Table 'U9zqzC8f3oTJ2ShXFgSSOA' 6-max Seat #5 is the button
Seat 2: JwCcjZl0bjJzG7hmE0dnTA ($100 in chips)
Seat 3: yfXek8iJ7O4CFyqXrtGcfg ($14.55 in chips)
Seat 4: 33q95we0Etwgrm6guQGncw ($86.25 in chips)
Seat 5: KfwW5us6tydK81NYTtK1gw ($289.75 in chips)
Seat 6: aIxzFKdtpDSkUePKZy/niQ ($31.05 in chips)
aIxzFKdtpDSkUePKZy/niQ: posts small blind $0.50
+xW7QemQU0Fxs+4TnqBRow: is sitting out
JwCcjZl0bjJzG7hmE0dnTA: posts big blind $1
*** HOLE CARDS ***
yfXek8iJ7O4CFyqXrtGcfg: folds
+xW7QemQU0Fxs+4TnqBRow leaves the table
33q95we0Etwgrm6guQGncw: calls $1
iHo1oDbrEVJ8nEGdaPrICw joins the table at seat #1
KfwW5us6tydK81NYTtK1gw: folds
aIxzFKdtpDSkUePKZy/niQ: raises $3 to $4
JwCcjZl0bjJzG7hmE0dnTA: folds
33q95we0Etwgrm6guQGncw: calls $3
*** FLOP *** [3s Jd 8h]
aIxzFKdtpDSkUePKZy/niQ: bets $5
33q95we0Etwgrm6guQGncw: calls $5
*** TURN *** [3s Jd 8h] [Td]
aIxzFKdtpDSkUePKZy/niQ: checks
33q95we0Etwgrm6guQGncw: bets $12
aIxzFKdtpDSkUePKZy/niQ: folds
33q95we0Etwgrm6guQGncw collected $18.10 from pot
33q95we0Etwgrm6guQGncw: doesn't show hand
*** SUMMARY ***
Total pot $19 | Rake $0.90
Board [3s Jd 8h Td]
Seat 2: JwCcjZl0bjJzG7hmE0dnTA (big blind) folded before Flop
Seat 3: yfXek8iJ7O4CFyqXrtGcfg folded before Flop (didn't bet)
Seat 4: 33q95we0Etwgrm6guQGncw collected ($18.10)
Seat 5: KfwW5us6tydK81NYTtK1gw (button) folded before Flop (didn't bet)
Seat 6: aIxzFKdtpDSkUePKZy/niQ (small blind) folded on the Turn



PokerStars Game #59939713740:  Hold'em No Limit ($0.50/$1.00) - 2009/07/01 0:47:00 ET
Table 'eU3bWpDDg3Z+9R4m4iVmog' 6-max Seat #4 is the button
Seat 1: TSuRyAHnUPCFjP7Z0rEE0w ($189.65 in chips)
Seat 2: 8CAoOzhmB8n3nRFf3V4BTg ($97.80 in chips)
Seat 3: U6tnjwZRpTnM+YkqkCjwyQ ($187.15 in chips)
Seat 4: GDVIsbEJ/DOJsMKE4Asz0A ($68.30 in chips)
Seat 5: AdLVjddOzm+sRNo1Bc3S6Q ($110.45 in chips)
Seat 6: hpxXcmRkXXI9HE5+5/j/0Q ($123.45 in chips)
AdLVjddOzm+sRNo1Bc3S6Q: posts small blind $0.50
hpxXcmRkXXI9HE5+5/j/0Q: posts big blind $1
*** HOLE CARDS ***
TSuRyAHnUPCFjP7Z0rEE0w: folds
8CAoOzhmB8n3nRFf3V4BTg: folds
U6tnjwZRpTnM+YkqkCjwyQ: raises $2 to $3
GDVIsbEJ/DOJsMKE4Asz0A: folds
AdLVjddOzm+sRNo1Bc3S6Q: folds
hpxXcmRkXXI9HE5+5/j/0Q: folds
U6tnjwZRpTnM+YkqkCjwyQ collected $2.50 from pot
*** SUMMARY ***
Total pot $2.50 | Rake $0
Seat 1: TSuRyAHnUPCFjP7Z0rEE0w folded before Flop (didn't bet)
Seat 2: 8CAoOzhmB8n3nRFf3V4BTg folded before Flop (didn't bet)
Seat 3: U6tnjwZRpTnM+YkqkCjwyQ collected ($2.50)
Seat 4: GDVIsbEJ/DOJsMKE4Asz0A (button) folded before Flop (didn't bet)
Seat 5: AdLVjddOzm+sRNo1Bc3S6Q (small blind) folded before Flop
Seat 6: hpxXcmRkXXI9HE5+5/j/0Q (big blind) folded before Flop



PokerStars Game #59939713960:  Hold'em No Limit ($0.50/$1.00) - 2009/07/01 0:47:01 ET
Table 'SQLOQoANiHscJ8AL7zffbw' 9-max Seat #1 is the button
Seat 1: jPTRd6SpCp4xqAy2XQiTOw ($111.10 in chips)
Seat 2: /zy+DB4S5fUQUSfZWFzYGw ($275.35 in chips)
Seat 3: 0eFnow7+D7veCYQ+CG9FFw ($94.85 in chips)
Seat 4: N9n5Wc3s35DpCrOAUUNAaQ ($93.75 in chips)
Seat 5: L9njYvloJ1NdXjP8edHEAg ($107.05 in chips)
Seat 6: p5UKaxVobvptF0ANhR/q1A ($174.50 in chips)
Seat 7: bJckevFOcg//s0qyMQI6sQ ($100 in chips)
Seat 8: Pp/KTcXkfZKKUHkjyaLTdg ($58.50 in chips)
Seat 9: qJr25HAtvv1w/7IBvjMM3g ($201.75 in chips)
/zy+DB4S5fUQUSfZWFzYGw: posts small blind $0.50
0eFnow7+D7veCYQ+CG9FFw: posts big blind $1
*** HOLE CARDS ***
jPTRd6SpCp4xqAy2XQiTOw said, "ROFL"
N9n5Wc3s35DpCrOAUUNAaQ: folds
L9njYvloJ1NdXjP8edHEAg: folds
p5UKaxVobvptF0ANhR/q1A: folds
bJckevFOcg//s0qyMQI6sQ: folds
Pp/KTcXkfZKKUHkjyaLTdg: folds
qJr25HAtvv1w/7IBvjMM3g: folds
jPTRd6SpCp4xqAy2XQiTOw: folds
/zy+DB4S5fUQUSfZWFzYGw: folds
0eFnow7+D7veCYQ+CG9FFw collected $1 from pot
*** SUMMARY ***
Total pot $1 | Rake $0
Seat 1: jPTRd6SpCp4xqAy2XQiTOw (button) folded before Flop (didn't bet)
Seat 2: /zy+DB4S5fUQUSfZWFzYGw (small blind) folded before Flop
Seat 3: 0eFnow7+D7veCYQ+CG9FFw (big blind) collected ($1)
Seat 4: N9n5Wc3s35DpCrOAUUNAaQ folded before Flop (didn't bet)
Seat 5: L9njYvloJ1NdXjP8edHEAg folded before Flop (didn't bet)
Seat 6: p5UKaxVobvptF0ANhR/q1A folded before Flop (didn't bet)
Seat 7: bJckevFOcg//s0qyMQI6sQ folded before Flop (didn't bet)
Seat 8: Pp/KTcXkfZKKUHkjyaLTdg folded before Flop (didn't bet)
Seat 9: qJr25HAtvv1w/7IBvjMM3g folded before Flop (didn't bet)



PokerStars Game #59939714582:  Hold'em No Limit ($0.50/$1.00) - 2009/07/01 0:47:02 ET
Table 'LmXQK9xy3awB+qsPzI21Mw' 2-max Seat #1 is the button
Seat 1: NYi6JFscYNrofSXy4sM+Yw ($238.85 in chips)
Seat 2: TME8GvochpQAo8cmJwWmvA ($93.90 in chips)
NYi6JFscYNrofSXy4sM+Yw: posts small blind $0.50
TME8GvochpQAo8cmJwWmvA: posts big blind $1
*** HOLE CARDS ***
NYi6JFscYNrofSXy4sM+Yw: raises $2 to $3
TME8GvochpQAo8cmJwWmvA: folds
NYi6JFscYNrofSXy4sM+Yw collected $2 from pot
*** SUMMARY ***
Total pot $2 | Rake $0
Seat 1: NYi6JFscYNrofSXy4sM+Yw (button) (small blind) collected ($2)
Seat 2: TME8GvochpQAo8cmJwWmvA (big blind) folded before Flop



PokerStars Game #59939716242:  Hold'em No Limit ($0.50/$1.00) - 2009/07/01 0:47:04 ET
Table '7O9fB8yx1u7sJveJn8w6jA' 6-max Seat #5 is the button
Seat 1: jy52+7FotjH63o5tEEVgKw ($164.35 in chips)
Seat 2: wx3sQGkVi2x9wJXuWNHPBw ($194 in chips)
Seat 3: hpxXcmRkXXI9HE5+5/j/0Q ($100 in chips)
Seat 4: XIZSmlGttGgSRaIU42K4Fg ($80.10 in chips)
Seat 5: BCEV3COoKY607AzLWayfRA ($100 in chips)
Seat 6: UBZQqpnJZdTYYY1FTb0rLA ($128.35 in chips)
UBZQqpnJZdTYYY1FTb0rLA: posts small blind $0.50
jy52+7FotjH63o5tEEVgKw: posts big blind $1
*** HOLE CARDS ***
wx3sQGkVi2x9wJXuWNHPBw: folds
hpxXcmRkXXI9HE5+5/j/0Q: raises $3 to $4
XIZSmlGttGgSRaIU42K4Fg: folds
BCEV3COoKY607AzLWayfRA: folds
UBZQqpnJZdTYYY1FTb0rLA: folds
jy52+7FotjH63o5tEEVgKw: folds
hpxXcmRkXXI9HE5+5/j/0Q collected $2.50 from pot
hpxXcmRkXXI9HE5+5/j/0Q: doesn't show hand
*** SUMMARY ***
Total pot $2.50 | Rake $0
Seat 1: jy52+7FotjH63o5tEEVgKw (big blind) folded before Flop
Seat 2: wx3sQGkVi2x9wJXuWNHPBw folded before Flop (didn't bet)
Seat 3: hpxXcmRkXXI9HE5+5/j/0Q collected ($2.50)
Seat 4: XIZSmlGttGgSRaIU42K4Fg folded before Flop (didn't bet)
Seat 5: BCEV3COoKY607AzLWayfRA (button) folded before Flop (didn't bet)
Seat 6: UBZQqpnJZdTYYY1FTb0rLA (small blind) folded before Flop



PokerStars Game #59939716640:  Hold'em No Limit ($0.50/$1.00) - 2009/07/01 0:47:05 ET
Table 'pg7VTpbaJ2VPd8AutJs72Q' 2-max Seat #1 is the button
Seat 1: StueJevXbc+rCdUVXnk/GA ($41.10 in chips)
Seat 2: 6alLXQIITA2EZ/lBeym8Dw ($101 in chips)
StueJevXbc+rCdUVXnk/GA: posts small blind $0.50
6alLXQIITA2EZ/lBeym8Dw: posts big blind $1
*** HOLE CARDS ***
StueJevXbc+rCdUVXnk/GA: folds
6alLXQIITA2EZ/lBeym8Dw collected $1 from pot
6alLXQIITA2EZ/lBeym8Dw: doesn't show hand
*** SUMMARY ***
Total pot $1 | Rake $0
Seat 1: StueJevXbc+rCdUVXnk/GA (button) (small blind) folded before Flop
Seat 2: 6alLXQIITA2EZ/lBeym8Dw (big blind) collected ($1)



PokerStars Game #59939719320:  Hold'em No Limit ($0.50/$1.00) - 2009/07/01 0:47:09 ET
Table 'LmXQK9xy3awB+qsPzI21Mw' 2-max Seat #2 is the button
Seat 1: NYi6JFscYNrofSXy4sM+Yw ($239.85 in chips)
Seat 2: TME8GvochpQAo8cmJwWmvA ($92.90 in chips)
TME8GvochpQAo8cmJwWmvA: posts small blind $0.50
NYi6JFscYNrofSXy4sM+Yw: posts big blind $1
*** HOLE CARDS ***
TME8GvochpQAo8cmJwWmvA: calls $0.50
NYi6JFscYNrofSXy4sM+Yw: raises $2 to $3
TME8GvochpQAo8cmJwWmvA: calls $2
*** FLOP *** [9s Qc 8s]
NYi6JFscYNrofSXy4sM+Yw: bets $3
TME8GvochpQAo8cmJwWmvA: calls $3
*** TURN *** [9s Qc 8s] [4s]
NYi6JFscYNrofSXy4sM+Yw: checks
TME8GvochpQAo8cmJwWmvA: bets $4
NYi6JFscYNrofSXy4sM+Yw: calls $4
*** RIVER *** [9s Qc 8s 4s] [3s]
NYi6JFscYNrofSXy4sM+Yw: checks
TME8GvochpQAo8cmJwWmvA: bets $6
NYi6JFscYNrofSXy4sM+Yw: folds
TME8GvochpQAo8cmJwWmvA collected $19.50 from pot
TME8GvochpQAo8cmJwWmvA: doesn't show hand
*** SUMMARY ***
Total pot $20 | Rake $0.50
Board [9s Qc 8s 4s 3s]
Seat 1: NYi6JFscYNrofSXy4sM+Yw (big blind) folded on the River
Seat 2: TME8GvochpQAo8cmJwWmvA (button) (small blind) collected ($19.50)



PokerStars Game #59939720042:  Hold'em No Limit ($0.50/$1.00) - 2009/07/01 0:47:10 ET
Table '7Nl0ffnjeK44/vmeexh3MQ' 9-max Seat #7 is the button
Seat 1: s7D3Y+k4Cj4D1cXHv7oj+Q ($92.35 in chips)
Seat 2: kiakSwxX0e64PwYGAPQvLw ($33.35 in chips)
Seat 3: vR4IO10geOgvTW+LAUBv/A ($101.50 in chips)
Seat 4: bLbSOSmSOnqE0iTcH/5dxA ($100 in chips)
Seat 5: bL+QVeDcuEdzMGAGg2XJHg ($105.05 in chips)
Seat 6: FVs16t7GgfWgQWt4JxsObQ ($27.50 in chips)
Seat 7: 997ViqAtWn1FPjJqcffwcA ($100 in chips)
Seat 8: zanka7aAZkigmZpfopXxxA ($252.70 in chips)
Seat 9: ouwUBGRKnKK9uhn1G4Lf+A ($95 in chips)
zanka7aAZkigmZpfopXxxA: posts small blind $0.50
ouwUBGRKnKK9uhn1G4Lf+A: posts big blind $1
*** HOLE CARDS ***
s7D3Y+k4Cj4D1cXHv7oj+Q: folds
kiakSwxX0e64PwYGAPQvLw: folds
vR4IO10geOgvTW+LAUBv/A: folds
bLbSOSmSOnqE0iTcH/5dxA: folds
bL+QVeDcuEdzMGAGg2XJHg: folds
FVs16t7GgfWgQWt4JxsObQ: folds
997ViqAtWn1FPjJqcffwcA: folds
zanka7aAZkigmZpfopXxxA: folds
ouwUBGRKnKK9uhn1G4Lf+A collected $1 from pot
ouwUBGRKnKK9uhn1G4Lf+A: doesn't show hand
*** SUMMARY ***
Total pot $1 | Rake $0
Seat 1: s7D3Y+k4Cj4D1cXHv7oj+Q folded before Flop (didn't bet)
Seat 2: kiakSwxX0e64PwYGAPQvLw folded before Flop (didn't bet)
Seat 3: vR4IO10geOgvTW+LAUBv/A folded before Flop (didn't bet)
Seat 4: bLbSOSmSOnqE0iTcH/5dxA folded before Flop (didn't bet)
Seat 5: bL+QVeDcuEdzMGAGg2XJHg folded before Flop (didn't bet)
Seat 6: FVs16t7GgfWgQWt4JxsObQ folded before Flop (didn't bet)
Seat 7: 997ViqAtWn1FPjJqcffwcA (button) folded before Flop (didn't bet)
Seat 8: zanka7aAZkigmZpfopXxxA (small blind) folded before Flop
Seat 9: ouwUBGRKnKK9uhn1G4Lf+A (big blind) collected ($1)



PokerStars Game #59939726500:  Hold'em No Limit ($0.50/$1.00) - 2009/07/01 0:47:21 ET
Table 'cKH9c4x6u79IqCdaKKvXrw' 9-max Seat #2 is the button
Seat 1: Pp/KTcXkfZKKUHkjyaLTdg ($17 in chips)
Seat 2: 8S3JMH4TY3whgIlZmMv66w ($58.85 in chips)
Seat 3: 997ViqAtWn1FPjJqcffwcA ($159.10 in chips)
Seat 4: FL3MrLspcF23LYvC4ipBOA ($100 in chips)
Seat 5: x80+i7DJL+81v3quj7KbNg ($23 in chips)
Seat 6: Bsd/K5gAcLanYbGiPirRjw ($168.55 in chips)
Seat 7: 1GkkVBhlJ92guE6K5mS5Ig ($50.55 in chips)
Seat 8: 4/8w7g4QE6v0i1tIIf/1HQ ($42.15 in chips)
Seat 9: 6XkTu4ahxzHnvjjc1R8YjQ ($37.65 in chips)
997ViqAtWn1FPjJqcffwcA: posts small blind $0.50
FL3MrLspcF23LYvC4ipBOA: posts big blind $1
*** HOLE CARDS ***
x80+i7DJL+81v3quj7KbNg: raises $2 to $3
Bsd/K5gAcLanYbGiPirRjw: folds
1GkkVBhlJ92guE6K5mS5Ig: folds
4/8w7g4QE6v0i1tIIf/1HQ: calls $3
6XkTu4ahxzHnvjjc1R8YjQ: folds
Pp/KTcXkfZKKUHkjyaLTdg: folds
8S3JMH4TY3whgIlZmMv66w: folds
997ViqAtWn1FPjJqcffwcA: folds
FL3MrLspcF23LYvC4ipBOA: folds
*** FLOP *** [7d 3c 5d]
x80+i7DJL+81v3quj7KbNg: bets $5
4/8w7g4QE6v0i1tIIf/1HQ: folds
x80+i7DJL+81v3quj7KbNg collected $7.15 from pot
x80+i7DJL+81v3quj7KbNg: doesn't show hand
*** SUMMARY ***
Total pot $7.50 | Rake $0.35
Board [7d 3c 5d]
Seat 1: Pp/KTcXkfZKKUHkjyaLTdg folded before Flop (didn't bet)
Seat 2: 8S3JMH4TY3whgIlZmMv66w (button) folded before Flop (didn't bet)
Seat 3: 997ViqAtWn1FPjJqcffwcA (small blind) folded before Flop
Seat 4: FL3MrLspcF23LYvC4ipBOA (big blind) folded before Flop
Seat 5: x80+i7DJL+81v3quj7KbNg collected ($7.15)
Seat 6: Bsd/K5gAcLanYbGiPirRjw folded before Flop (didn't bet)
Seat 7: 1GkkVBhlJ92guE6K5mS5Ig folded before Flop (didn't bet)
Seat 8: 4/8w7g4QE6v0i1tIIf/1HQ folded on the Flop
Seat 9: 6XkTu4ahxzHnvjjc1R8YjQ folded before Flop (didn't bet)



PokerStars Game #59939728038:  Hold'em No Limit ($0.50/$1.00) - 2009/07/01 0:47:23 ET
Table '/RZcOwpZpHQ+OwPwjsbnRw' 6-max Seat #5 is the button
Seat 1: Zboa6dColKGHBjLPUakZjw ($41.20 in chips)
Seat 2: +xW7QemQU0Fxs+4TnqBRow ($194.50 in chips)
Seat 3: XnT1yK2DD/5FL+0bwuEhqg ($44.95 in chips)
Seat 4: j7NIOHLZk7V2o9fOioO5ug ($107.10 in chips)
Seat 5: wx3sQGkVi2x9wJXuWNHPBw ($192.15 in chips)
Seat 6: XOIf9W+VAxhZqN+SYoyMKA ($296.25 in chips)
XOIf9W+VAxhZqN+SYoyMKA: posts small blind $0.50
Zboa6dColKGHBjLPUakZjw: posts big blind $1
*** HOLE CARDS ***
+xW7QemQU0Fxs+4TnqBRow: folds
XnT1yK2DD/5FL+0bwuEhqg: folds
j7NIOHLZk7V2o9fOioO5ug: folds
wx3sQGkVi2x9wJXuWNHPBw: folds
XOIf9W+VAxhZqN+SYoyMKA: raises $2 to $3
Zboa6dColKGHBjLPUakZjw: calls $2
*** FLOP *** [4h 5c 8d]
XOIf9W+VAxhZqN+SYoyMKA: checks
Zboa6dColKGHBjLPUakZjw: bets $2
XOIf9W+VAxhZqN+SYoyMKA: folds
Zboa6dColKGHBjLPUakZjw collected $5.70 from pot
Zboa6dColKGHBjLPUakZjw: doesn't show hand
*** SUMMARY ***
Total pot $6 | Rake $0.30
Board [4h 5c 8d]
Seat 1: Zboa6dColKGHBjLPUakZjw (big blind) collected ($5.70)
Seat 2: +xW7QemQU0Fxs+4TnqBRow folded before Flop (didn't bet)
Seat 3: XnT1yK2DD/5FL+0bwuEhqg folded before Flop (didn't bet)
Seat 4: j7NIOHLZk7V2o9fOioO5ug folded before Flop (didn't bet)
Seat 5: wx3sQGkVi2x9wJXuWNHPBw (button) folded before Flop (didn't bet)
Seat 6: XOIf9W+VAxhZqN+SYoyMKA (small blind) folded on the Flop



PokerStars Game #59939728766:  Hold'em No Limit ($0.50/$1.00) - 2009/07/01 0:47:24 ET
Table 'hugOjcwJvzEwZbK7tyiWuQ' 9-max Seat #4 is the button
Seat 1: N9n5Wc3s35DpCrOAUUNAaQ ($130 in chips)
Seat 2: r27C1nIV4NS4+qbnrgBQSw ($259.10 in chips)
Seat 3: jDwhY1kCdc6EkAHbT7PJMQ ($107.65 in chips)
Seat 4: UWB3oeddt/GObx2Mix2Anw ($204.25 in chips)
Seat 5: 5BRGWf+R3nt2WS3b5xX+zA ($19.80 in chips)
Seat 6: gUUvmqdVlmvpal6B8nYrmg ($107.70 in chips)
Seat 7: FL3MrLspcF23LYvC4ipBOA ($100 in chips)
Seat 8: /zy+DB4S5fUQUSfZWFzYGw ($101.25 in chips)
Seat 9: W8P9bUKCs43TO1xHm0dL6w ($88.15 in chips)
5BRGWf+R3nt2WS3b5xX+zA: posts small blind $0.50
gUUvmqdVlmvpal6B8nYrmg: posts big blind $1
*** HOLE CARDS ***
FL3MrLspcF23LYvC4ipBOA: folds
/zy+DB4S5fUQUSfZWFzYGw: folds
W8P9bUKCs43TO1xHm0dL6w: folds
N9n5Wc3s35DpCrOAUUNAaQ: folds
r27C1nIV4NS4+qbnrgBQSw: raises $2 to $3
jDwhY1kCdc6EkAHbT7PJMQ: folds
UWB3oeddt/GObx2Mix2Anw: folds
5BRGWf+R3nt2WS3b5xX+zA: folds
gUUvmqdVlmvpal6B8nYrmg: folds
r27C1nIV4NS4+qbnrgBQSw collected $2.50 from pot
*** SUMMARY ***
Total pot $2.50 | Rake $0
Seat 1: N9n5Wc3s35DpCrOAUUNAaQ folded before Flop (didn't bet)
Seat 2: r27C1nIV4NS4+qbnrgBQSw collected ($2.50)
Seat 3: jDwhY1kCdc6EkAHbT7PJMQ folded before Flop (didn't bet)
Seat 4: UWB3oeddt/GObx2Mix2Anw (button) folded before Flop (didn't bet)
Seat 5: 5BRGWf+R3nt2WS3b5xX+zA (small blind) folded before Flop
Seat 6: gUUvmqdVlmvpal6B8nYrmg (big blind) folded before Flop
Seat 7: FL3MrLspcF23LYvC4ipBOA folded before Flop (didn't bet)
Seat 8: /zy+DB4S5fUQUSfZWFzYGw folded before Flop (didn't bet)
Seat 9: W8P9bUKCs43TO1xHm0dL6w folded before Flop (didn't bet)



PokerStars Game #59939728336:  Hold'em No Limit ($0.50/$1.00) - 2009/07/01 0:47:24 ET
Table '6YvsYDPNIDx2v5z3bJnwZQ' 9-max Seat #1 is the button
Seat 1: Ogn4JDV3mp4ZDKO49IFzKA ($17.20 in chips)
Seat 2: x80+i7DJL+81v3quj7KbNg ($20 in chips)
Seat 3: negfosHnGOZXSHpWDRKyBQ ($17.30 in chips)
Seat 4: kEr5NYB+JIG5+szcYMr6hA ($41.50 in chips)
Seat 5: mBRWbnUl8diyBO1qTJaNzw ($163.20 in chips)
Seat 6: uMPEfCcGCfsxmy53tVUMug ($100 in chips)
Seat 7: mae7OMTaJ/MFimNbZegCkg ($49 in chips)
Seat 8: PSFxpXgPedVZyHSu2Zhb7Q ($103.05 in chips)
Seat 9: ZgMRSHJ9EOtPeVHmdeV9kQ ($60 in chips)
x80+i7DJL+81v3quj7KbNg: posts small blind $0.50
negfosHnGOZXSHpWDRKyBQ: posts big blind $1
ZgMRSHJ9EOtPeVHmdeV9kQ: posts big blind $1
*** HOLE CARDS ***
kEr5NYB+JIG5+szcYMr6hA: calls $1
mBRWbnUl8diyBO1qTJaNzw: raises $5 to $6
uMPEfCcGCfsxmy53tVUMug: folds
uMPEfCcGCfsxmy53tVUMug leaves the table
mae7OMTaJ/MFimNbZegCkg: folds
PSFxpXgPedVZyHSu2Zhb7Q: folds
ZgMRSHJ9EOtPeVHmdeV9kQ: folds
Ogn4JDV3mp4ZDKO49IFzKA: folds
x80+i7DJL+81v3quj7KbNg: folds
negfosHnGOZXSHpWDRKyBQ: folds
kEr5NYB+JIG5+szcYMr6hA: folds
7RSwrjMohkYrZAhOd1uaZg joins the table at seat #6
mBRWbnUl8diyBO1qTJaNzw collected $4.50 from pot
*** SUMMARY ***
Total pot $4.50 | Rake $0
Seat 1: Ogn4JDV3mp4ZDKO49IFzKA (button) folded before Flop (didn't bet)
Seat 2: x80+i7DJL+81v3quj7KbNg (small blind) folded before Flop
Seat 3: negfosHnGOZXSHpWDRKyBQ (big blind) folded before Flop
Seat 4: kEr5NYB+JIG5+szcYMr6hA folded before Flop
Seat 5: mBRWbnUl8diyBO1qTJaNzw collected ($4.50)
Seat 6: uMPEfCcGCfsxmy53tVUMug folded before Flop (didn't bet)
Seat 7: mae7OMTaJ/MFimNbZegCkg folded before Flop (didn't bet)
Seat 8: PSFxpXgPedVZyHSu2Zhb7Q folded before Flop (didn't bet)
Seat 9: ZgMRSHJ9EOtPeVHmdeV9kQ folded before Flop



PokerStars Game #59939728922:  Hold'em No Limit ($0.50/$1.00) - 2009/07/01 0:47:25 ET
Table 'uNlePsyMIqzM691Xkrlk6Q' 9-max Seat #1 is the button
Seat 1: bLbSOSmSOnqE0iTcH/5dxA ($100 in chips)
Seat 2: +OqpStnt0FqbCfyHAWaLbg ($80.05 in chips)
Seat 3: h7qXkU57Bb8ZuPwMyxR8Ug ($31.50 in chips)
Seat 4: TZcz9MEWDA+WydgGruqqbw ($102.65 in chips)
Seat 5: 3obndzTJ6fECz8+wWhMd1w ($18.50 in chips)
Seat 6: uMPEfCcGCfsxmy53tVUMug ($106.10 in chips)
Seat 7: w6cw9nzN7AvkkHBVVjykoQ ($45.90 in chips)
Seat 8: laA8va+Yv8WuMqT1zdR91g ($100 in chips)
Seat 9: vR4IO10geOgvTW+LAUBv/A ($100.75 in chips)
+OqpStnt0FqbCfyHAWaLbg: posts small blind $0.50
h7qXkU57Bb8ZuPwMyxR8Ug: posts big blind $1
*** HOLE CARDS ***
TZcz9MEWDA+WydgGruqqbw: folds
3obndzTJ6fECz8+wWhMd1w: folds
uMPEfCcGCfsxmy53tVUMug: calls $1
w6cw9nzN7AvkkHBVVjykoQ: folds
laA8va+Yv8WuMqT1zdR91g: folds
vR4IO10geOgvTW+LAUBv/A: folds
bLbSOSmSOnqE0iTcH/5dxA: folds
+OqpStnt0FqbCfyHAWaLbg: calls $0.50
h7qXkU57Bb8ZuPwMyxR8Ug: checks
*** FLOP *** [2c 4s Qc]
+OqpStnt0FqbCfyHAWaLbg: checks
h7qXkU57Bb8ZuPwMyxR8Ug: checks
uMPEfCcGCfsxmy53tVUMug: folds
*** TURN *** [2c 4s Qc] [Td]
uMPEfCcGCfsxmy53tVUMug leaves the table
+OqpStnt0FqbCfyHAWaLbg: checks
h7qXkU57Bb8ZuPwMyxR8Ug: checks
*** RIVER *** [2c 4s Qc Td] [Ad]
myIxN7otsyr846M539YR8Q joins the table at seat #6
+OqpStnt0FqbCfyHAWaLbg: checks
h7qXkU57Bb8ZuPwMyxR8Ug: checks
*** SHOW DOWN ***
+OqpStnt0FqbCfyHAWaLbg: shows [3c 6s] (high card Ace)
h7qXkU57Bb8ZuPwMyxR8Ug: shows [3h 4c] (a pair of Fours)
h7qXkU57Bb8ZuPwMyxR8Ug collected $2.85 from pot
*** SUMMARY ***
Total pot $3 | Rake $0.15
Board [2c 4s Qc Td Ad]
Seat 1: bLbSOSmSOnqE0iTcH/5dxA (button) folded before Flop (didn't bet)
Seat 2: +OqpStnt0FqbCfyHAWaLbg (small blind) showed [3c 6s] and lost with high card Ace
Seat 3: h7qXkU57Bb8ZuPwMyxR8Ug (big blind) showed [3h 4c] and won ($2.85) with a pair of Fours
Seat 4: TZcz9MEWDA+WydgGruqqbw folded before Flop (didn't bet)
Seat 5: 3obndzTJ6fECz8+wWhMd1w folded before Flop (didn't bet)
Seat 6: uMPEfCcGCfsxmy53tVUMug folded on the Flop
Seat 7: w6cw9nzN7AvkkHBVVjykoQ folded before Flop (didn't bet)
Seat 8: laA8va+Yv8WuMqT1zdR91g folded before Flop (didn't bet)
Seat 9: vR4IO10geOgvTW+LAUBv/A folded before Flop (didn't bet)



PokerStars Game #59939729444:  Hold'em No Limit ($0.50/$1.00) - 2009/07/01 0:47:25 ET
Table 'fTlPiCj0utgzC/5io+I7ew' 6-max Seat #5 is the button
Seat 1: YMJG+F++3Aj6P8dAWda5fw ($94 in chips)
Seat 2: Qy/UBNbD2HaA0Ogxg8Sf3w ($111.95 in chips)
Seat 3: oDiBRCaF0QVtd3kO6xZIXw ($96.25 in chips)
Seat 4: uJVSceLggtsrJya+WtmUEA ($99.50 in chips)
Seat 5: bFrTkDcWGTxyvNul7GVdYg ($252.20 in chips)
YMJG+F++3Aj6P8dAWda5fw: posts small blind $0.50
Qy/UBNbD2HaA0Ogxg8Sf3w: posts big blind $1
*** HOLE CARDS ***
oDiBRCaF0QVtd3kO6xZIXw: raises $2 to $3
uJVSceLggtsrJya+WtmUEA: folds
bFrTkDcWGTxyvNul7GVdYg: folds
YMJG+F++3Aj6P8dAWda5fw: folds
Qy/UBNbD2HaA0Ogxg8Sf3w: folds
oDiBRCaF0QVtd3kO6xZIXw collected $2.50 from pot
*** SUMMARY ***
Total pot $2.50 | Rake $0
Seat 1: YMJG+F++3Aj6P8dAWda5fw (small blind) folded before Flop
Seat 2: Qy/UBNbD2HaA0Ogxg8Sf3w (big blind) folded before Flop
Seat 3: oDiBRCaF0QVtd3kO6xZIXw collected ($2.50)
Seat 4: uJVSceLggtsrJya+WtmUEA folded before Flop (didn't bet)
Seat 5: bFrTkDcWGTxyvNul7GVdYg (button) folded before Flop (didn't bet)



PokerStars Game #59939730468:  Hold'em No Limit ($0.50/$1.00) - 2009/07/01 0:47:27 ET
Table 'JTT1XWaDZHSaMZQK7cR5uw' 2-max Seat #1 is the button
Seat 1: OLplZF6FEnLflv81Hz+Fxg ($99 in chips)
Seat 2: BcqgegiOUxmBD3F3umsljg ($60 in chips)
OLplZF6FEnLflv81Hz+Fxg: posts small blind $0.50
BcqgegiOUxmBD3F3umsljg: posts big blind $1
*** HOLE CARDS ***
OLplZF6FEnLflv81Hz+Fxg: folds
BcqgegiOUxmBD3F3umsljg collected $1 from pot
OLplZF6FEnLflv81Hz+Fxg said, "100"
*** SUMMARY ***
Total pot $1 | Rake $0
Seat 1: OLplZF6FEnLflv81Hz+Fxg (button) (small blind) folded before Flop
Seat 2: BcqgegiOUxmBD3F3umsljg (big blind) collected ($1)



PokerStars Game #59939731334:  Hold'em No Limit ($0.50/$1.00) - 2009/07/01 0:47:28 ET
Table 'rmZfTK+oSebeUPJNbWhdAA' 6-max Seat #3 is the button
Seat 1: xAU6q2/cwmby2sxmA8VcmA ($100 in chips)
Seat 2: z7O9PO/WEcqRouIydFhS9Q ($103.50 in chips)
Seat 3: 9yjOzGERLaEZS8CZ6YNHFg ($114.35 in chips)
Seat 4: 1/mIuXfgx1ZyVkodrmfQDw ($100 in chips)
Seat 5: 5lY8d6Cnm4HUkt/8FZSj4g ($87.95 in chips)
Seat 6: j7NIOHLZk7V2o9fOioO5ug ($136.80 in chips)
1/mIuXfgx1ZyVkodrmfQDw: posts small blind $0.50
5lY8d6Cnm4HUkt/8FZSj4g: posts big blind $1
*** HOLE CARDS ***
j7NIOHLZk7V2o9fOioO5ug: folds
xAU6q2/cwmby2sxmA8VcmA: folds
z7O9PO/WEcqRouIydFhS9Q: raises $2 to $3
9yjOzGERLaEZS8CZ6YNHFg: folds
1/mIuXfgx1ZyVkodrmfQDw: folds
5lY8d6Cnm4HUkt/8FZSj4g: calls $2
*** FLOP *** [3s 2c Ac]
5lY8d6Cnm4HUkt/8FZSj4g: checks
z7O9PO/WEcqRouIydFhS9Q: checks
*** TURN *** [3s 2c Ac] [4h]
5lY8d6Cnm4HUkt/8FZSj4g: checks
z7O9PO/WEcqRouIydFhS9Q: bets $4
5lY8d6Cnm4HUkt/8FZSj4g: calls $4
*** RIVER *** [3s 2c Ac 4h] [8c]
5lY8d6Cnm4HUkt/8FZSj4g: checks
z7O9PO/WEcqRouIydFhS9Q: checks
*** SHOW DOWN ***
5lY8d6Cnm4HUkt/8FZSj4g: shows [Qh 4d] (a pair of Fours)
z7O9PO/WEcqRouIydFhS9Q: shows [5c Ad] (a straight, Ace to Five)
z7O9PO/WEcqRouIydFhS9Q collected $13.80 from pot
*** SUMMARY ***
Total pot $14.50 | Rake $0.70
Board [3s 2c Ac 4h 8c]
Seat 1: xAU6q2/cwmby2sxmA8VcmA folded before Flop (didn't bet)
Seat 2: z7O9PO/WEcqRouIydFhS9Q showed [5c Ad] and won ($13.80) with a straight, Ace to Five
Seat 3: 9yjOzGERLaEZS8CZ6YNHFg (button) folded before Flop (didn't bet)
Seat 4: 1/mIuXfgx1ZyVkodrmfQDw (small blind) folded before Flop
Seat 5: 5lY8d6Cnm4HUkt/8FZSj4g (big blind) showed [Qh 4d] and lost with a pair of Fours
Seat 6: j7NIOHLZk7V2o9fOioO5ug folded before Flop (didn't bet)



PokerStars Game #59939732792:  Hold'em No Limit ($0.50/$1.00) - 2009/07/01 0:47:30 ET
Table 'MUPc8FEpe/nR0BKSeReX6Q' 6-max Seat #2 is the button
Seat 1: YsLQ3BAvgQHWXMAv3Wv6Hg ($113.85 in chips)
Seat 2: xAU6q2/cwmby2sxmA8VcmA ($108.80 in chips)
Seat 3: wx3sQGkVi2x9wJXuWNHPBw ($219.05 in chips)
Seat 4: ZA1bp6g8IwtTxkUE4eCjDQ ($203.80 in chips)
Seat 5: UBZQqpnJZdTYYY1FTb0rLA ($100 in chips)
Seat 6: oxnw0GLLpFanjhGkxfRSqA ($47 in chips)
wx3sQGkVi2x9wJXuWNHPBw: posts small blind $0.50
ZA1bp6g8IwtTxkUE4eCjDQ: posts big blind $1
*** HOLE CARDS ***
UBZQqpnJZdTYYY1FTb0rLA: folds
oxnw0GLLpFanjhGkxfRSqA said, "you goddam suck ouf ****ing diiot"
oxnw0GLLpFanjhGkxfRSqA said, "you are a goddam ****ing donkey"
oxnw0GLLpFanjhGkxfRSqA: folds
YsLQ3BAvgQHWXMAv3Wv6Hg: folds
xAU6q2/cwmby2sxmA8VcmA: folds
wx3sQGkVi2x9wJXuWNHPBw: folds
ZA1bp6g8IwtTxkUE4eCjDQ said, "lol"
ZA1bp6g8IwtTxkUE4eCjDQ collected $1 from pot
*** SUMMARY ***
Total pot $1 | Rake $0
Seat 1: YsLQ3BAvgQHWXMAv3Wv6Hg folded before Flop (didn't bet)
Seat 2: xAU6q2/cwmby2sxmA8VcmA (button) folded before Flop (didn't bet)
Seat 3: wx3sQGkVi2x9wJXuWNHPBw (small blind) folded before Flop
Seat 4: ZA1bp6g8IwtTxkUE4eCjDQ (big blind) collected ($1)
Seat 5: UBZQqpnJZdTYYY1FTb0rLA folded before Flop (didn't bet)
Seat 6: oxnw0GLLpFanjhGkxfRSqA folded before Flop (didn't bet)



PokerStars Game #59939732458:  Hold'em No Limit ($0.50/$1.00) - 2009/07/01 0:47:30 ET
Table 'cBDNutyLBKEk9+ptwsKmTw' 6-max Seat #3 is the button
Seat 1: xAU6q2/cwmby2sxmA8VcmA ($100 in chips)
Seat 2: 5lY8d6Cnm4HUkt/8FZSj4g ($102.80 in chips)
Seat 3: G5ZSSN6RSON3gkNvk/SmYg ($106.90 in chips)
Seat 4: 3q7F5QtzC30pSrn0nl9i+A ($35.70 in chips)
Seat 5: OGMLOcTNYZXZU81au7ztUw ($145.05 in chips)
Seat 6: NqVlOSH2lp+pp/TK3vvK5g ($47.30 in chips)
3q7F5QtzC30pSrn0nl9i+A: posts small blind $0.50
OGMLOcTNYZXZU81au7ztUw: posts big blind $1
*** HOLE CARDS ***
NqVlOSH2lp+pp/TK3vvK5g: raises $1 to $2
xAU6q2/cwmby2sxmA8VcmA: folds
5lY8d6Cnm4HUkt/8FZSj4g: calls $2
G5ZSSN6RSON3gkNvk/SmYg: folds
3q7F5QtzC30pSrn0nl9i+A: folds
OGMLOcTNYZXZU81au7ztUw: calls $1
*** FLOP *** [7h Jc 7d]
OGMLOcTNYZXZU81au7ztUw: checks
NqVlOSH2lp+pp/TK3vvK5g: bets $2
5lY8d6Cnm4HUkt/8FZSj4g: folds
OGMLOcTNYZXZU81au7ztUw: folds
NqVlOSH2lp+pp/TK3vvK5g collected $6.20 from pot
*** SUMMARY ***
Total pot $6.50 | Rake $0.30
Board [7h Jc 7d]
Seat 1: xAU6q2/cwmby2sxmA8VcmA folded before Flop (didn't bet)
Seat 2: 5lY8d6Cnm4HUkt/8FZSj4g folded on the Flop
Seat 3: G5ZSSN6RSON3gkNvk/SmYg (button) folded before Flop (didn't bet)
Seat 4: 3q7F5QtzC30pSrn0nl9i+A (small blind) folded before Flop
Seat 5: OGMLOcTNYZXZU81au7ztUw (big blind) folded on the Flop
Seat 6: NqVlOSH2lp+pp/TK3vvK5g collected ($6.20)



PokerStars Game #59939732540:  Hold'em No Limit ($0.50/$1.00) - 2009/07/01 0:47:30 ET
Table 'tyUh+jyNvrceIQdKMJjQ2wZFWj23PMihdwrNWv41OG/Qeat #6 is the button
Seat 2: XvUbOIg94d25feWeQlOTVg ($72.40 in chips)
Seat 3: TalCiLYHCd+ffkmR3auPvA ($67.80 in chips)
Seat 4: TSuRyAHnUPCFjP7Z0rEE0w ($118.25 in chips)
Seat 5: j7NIOHLZk7V2o9fOioO5ug ($110.10 in chips)
Seat 6: YsLQ3BAvgQHWXMAv3Wv6Hg ($146.65 in chips)
XvUbOIg94d25feWeQlOTVg: posts small blind $0.50
TalCiLYHCd+ffkmR3auPvA: posts big blind $1
*** HOLE CARDS ***
TSuRyAHnUPCFjP7Z0rEE0w: folds
j7NIOHLZk7V2o9fOioO5ug: folds
YsLQ3BAvgQHWXMAv3Wv6Hg: raises $3 to $4
XvUbOIg94d25feWeQlOTVg: folds
TalCiLYHCd+ffkmR3auPvA: folds
YsLQ3BAvgQHWXMAv3Wv6Hg collected $2.50 from pot
YsLQ3BAvgQHWXMAv3Wv6Hg: doesn't show hand
*** SUMMARY ***
Total pot $2.50 | Rake $0
Seat 2: XvUbOIg94d25feWeQlOTVg (small blind) folded before Flop
Seat 3: TalCiLYHCd+ffkmR3auPvA (big blind) folded before Flop
Seat 4: TSuRyAHnUPCFjP7Z0rEE0w folded before Flop (didn't bet)
Seat 5: j7NIOHLZk7V2o9fOioO5ug folded before Flop (didn't bet)
Seat 6: YsLQ3BAvgQHWXMAv3Wv6Hg (button) collected ($2.50)



PokerStars Game #59939733136:  Hold'em No Limit ($0.50/$1.00) - 2009/07/01 0:47:31 ET
Table 'pHrhryH8jPNdQfY62f8v+g' 6-max Seat #6 is the button
Seat 1: fF4botNMr8/ieVPO1YYRLw ($43.85 in chips)
Seat 2: RqgF7gRoKgRNW8Zoi1ty4A ($105.75 in chips)
Seat 3: 8oS5O7iD/qnFXFXJrGIgNQ ($100 in chips)
Seat 4: wenbG7TaM3H7h5kn78OFNw ($55.70 in chips)
Seat 5: r1/R7y0Ortgoz4lccgW8VA ($55.90 in chips)
Seat 6: xAU6q2/cwmby2sxmA8VcmA ($113.75 in chips)
fF4botNMr8/ieVPO1YYRLw: posts small blind $0.50
RqgF7gRoKgRNW8Zoi1ty4A: posts big blind $1
*** HOLE CARDS ***
8oS5O7iD/qnFXFXJrGIgNQ: folds
wenbG7TaM3H7h5kn78OFNw: raises $2 to $3
r1/R7y0Ortgoz4lccgW8VA: folds
xAU6q2/cwmby2sxmA8VcmA: folds
fF4botNMr8/ieVPO1YYRLw: folds
RqgF7gRoKgRNW8Zoi1ty4A: folds
wenbG7TaM3H7h5kn78OFNw collected $2.50 from pot
*** SUMMARY ***
Total pot $2.50 | Rake $0
Seat 1: fF4botNMr8/ieVPO1YYRLw (small blind) folded before Flop
Seat 2: RqgF7gRoKgRNW8Zoi1ty4A (big blind) folded before Flop
Seat 3: 8oS5O7iD/qnFXFXJrGIgNQ folded before Flop (didn't bet)
Seat 4: wenbG7TaM3H7h5kn78OFNw collected ($2.50)
Seat 5: r1/R7y0Ortgoz4lccgW8VA folded before Flop (didn't bet)
Seat 6: xAU6q2/cwmby2sxmA8VcmA (button) folded before Flop (didn't bet)



PokerStars Game #59939733092:  Hold'em No Limit ($0.50/$1.00) - 2009/07/01 0:47:31 ET
Table '7O9fB8yx1u7sJveJn8w6jA' 6-max Seat #6 is the button
Seat 1: jy52+7FotjH63o5tEEVgKw ($163.35 in chips)
Seat 2: wx3sQGkVi2x9wJXuWNHPBw ($194 in chips)
Seat 3: hpxXcmRkXXI9HE5+5/j/0Q ($101.50 in chips)
Seat 4: XIZSmlGttGgSRaIU42K4Fg ($80.10 in chips)
Seat 5: BCEV3COoKY607AzLWayfRA ($100 in chips)
Seat 6: UBZQqpnJZdTYYY1FTb0rLA ($127.85 in chips)
jy52+7FotjH63o5tEEVgKw: posts small blind $0.50
wx3sQGkVi2x9wJXuWNHPBw: posts big blind $1
*** HOLE CARDS ***
hpxXcmRkXXI9HE5+5/j/0Q: folds
XIZSmlGttGgSRaIU42K4Fg: folds
BCEV3COoKY607AzLWayfRA: folds
UBZQqpnJZdTYYY1FTb0rLA: raises $2 to $3
jy52+7FotjH63o5tEEVgKw: calls $2.50
wx3sQGkVi2x9wJXuWNHPBw: folds
*** FLOP *** [Th 8s 4c]
jy52+7FotjH63o5tEEVgKw: checks
UBZQqpnJZdTYYY1FTb0rLA: bets $4
jy52+7FotjH63o5tEEVgKw: folds
UBZQqpnJZdTYYY1FTb0rLA collected $6.65 from pot
UBZQqpnJZdTYYY1FTb0rLA: doesn't show hand
*** SUMMARY ***
Total pot $7 | Rake $0.35
Board [Th 8s 4c]
Seat 1: jy52+7FotjH63o5tEEVgKw (small blind) folded on the Flop
Seat 2: wx3sQGkVi2x9wJXuWNHPBw (big blind) folded before Flop
Seat 3: hpxXcmRkXXI9HE5+5/j/0Q folded before Flop (didn't bet)
Seat 4: XIZSmlGttGgSRaIU42K4Fg folded before Flop (didn't bet)
Seat 5: BCEV3COoKY607AzLWayfRA folded before Flop (didn't bet)
Seat 6: UBZQqpnJZdTYYY1FTb0rLA (button) collected ($6.65)



PokerStars Game #59939733356:  Hold'em No Limit ($0.50/$1.00) - 2009/07/01 0:47:31 ET
Table 'CxlB0XELs5P0zDlOhlhAPw' 2-max Seat #1 is the button
Seat 1: +B2wRsLpIMFnVA7qiRoGfg ($43.10 in chips)
Seat 2: I4xAjioR1QwQ5TgX4Z1/qw ($37.70 in chips)
+B2wRsLpIMFnVA7qiRoGfg: posts small blind $0.50
I4xAjioR1QwQ5TgX4Z1/qw: posts big blind $1
*** HOLE CARDS ***
+B2wRsLpIMFnVA7qiRoGfg: folds
I4xAjioR1QwQ5TgX4Z1/qw collected $1 from pot
*** SUMMARY ***
Total pot $1 | Rake $0
Seat 1: +B2wRsLpIMFnVA7qiRoGfg (button) (small blind) folded before Flop
Seat 2: I4xAjioR1QwQ5TgX4Z1/qw (big blind) collected ($1)



PokerStars Game #59939736054:  Hold'em No Limit ($0.50/$1.00) - 2009/07/01 0:47:36 ET
Table 'LmXQK9xy3awB+qsPzI21Mw' 2-max Seat #1 is the button
Seat 1: NYi6JFscYNrofSXy4sM+Yw ($229.85 in chips)
Seat 2: TME8GvochpQAo8cmJwWmvA ($102.40 in chips)
NYi6JFscYNrofSXy4sM+Yw: posts small blind $0.50
TME8GvochpQAo8cmJwWmvA: posts big blind $1
*** HOLE CARDS ***
NYi6JFscYNrofSXy4sM+Yw: raises $2 to $3
TME8GvochpQAo8cmJwWmvA: calls $2
*** FLOP *** [6c Qc Ts]
TME8GvochpQAo8cmJwWmvA: checks
NYi6JFscYNrofSXy4sM+Yw: bets $2
TME8GvochpQAo8cmJwWmvA: folds
NYi6JFscYNrofSXy4sM+Yw collected $5.70 from pot
NYi6JFscYNrofSXy4sM+Yw: doesn't show hand
*** SUMMARY ***
Total pot $6 | Rake $0.30
Board [6c Qc Ts]
Seat 1: NYi6JFscYNrofSXy4sM+Yw (button) (small blind) collected ($5.70)
Seat 2: TME8GvochpQAo8cmJwWmvA (big blind) folded on the Flop



PokerStars Game #59939736122:  Hold'em No Limit ($0.50/$1.00) - 2009/07/01 0:47:36 ET
Table 'eU3bWpDDg3Z+9R4m4iVmog' 6-max Seat #5 is the button
Seat 1: TSuRyAHnUPCFjP7Z0rEE0w ($189.65 in chips)
Seat 2: 8CAoOzhmB8n3nRFf3V4BTg ($97.80 in chips)
Seat 3: U6tnjwZRpTnM+YkqkCjwyQ ($188.65 in chips)
Seat 4: GDVIsbEJ/DOJsMKE4Asz0A ($68.30 in chips)
Seat 5: AdLVjddOzm+sRNo1Bc3S6Q ($109.95 in chips)
Seat 6: hpxXcmRkXXI9HE5+5/j/0Q ($122.45 in chips)
hpxXcmRkXXI9HE5+5/j/0Q: posts small blind $0.50
TSuRyAHnUPCFjP7Z0rEE0w: posts big blind $1
*** HOLE CARDS ***
8CAoOzhmB8n3nRFf3V4BTg: folds
U6tnjwZRpTnM+YkqkCjwyQ: folds
GDVIsbEJ/DOJsMKE4Asz0A: folds
AdLVjddOzm+sRNo1Bc3S6Q: folds
hpxXcmRkXXI9HE5+5/j/0Q: folds
TSuRyAHnUPCFjP7Z0rEE0w collected $1 from pot
TSuRyAHnUPCFjP7Z0rEE0w: doesn't show hand
*** SUMMARY ***
Total pot $1 | Rake $0
Seat 1: TSuRyAHnUPCFjP7Z0rEE0w (big blind) collected ($1)
Seat 2: 8CAoOzhmB8n3nRFf3V4BTg folded before Flop (didn't bet)
Seat 3: U6tnjwZRpTnM+YkqkCjwyQ folded before Flop (didn't bet)
Seat 4: GDVIsbEJ/DOJsMKE4Asz0A folded before Flop (didn't bet)
Seat 5: AdLVjddOzm+sRNo1Bc3S6Q (button) folded before Flop (didn't bet)
Seat 6: hpxXcmRkXXI9HE5+5/j/0Q (small blind) folded before Flop



PokerStars Game #59939736686:  Hold'em No Limit ($0.50/$1.00) - 2009/07/01 0:47:37 ET
Table 'tJq9SfN1ywY0r03VBlWlwQ' 9-max Seat #9 is the button
Seat 1: wZsU+w9r7G66x93UuvBf1Q ($334.80 in chips)
Seat 2: RqkO8O/Y3qlc3PIuCAHjVg ($68.40 in chips)
Seat 3: FVs16t7GgfWgQWt4JxsObQ ($35.05 in chips)
Seat 4: bLbSOSmSOnqE0iTcH/5dxA ($111.70 in chips)
Seat 5: Ogn4JDV3mp4ZDKO49IFzKA ($19.90 in chips)
Seat 6: gUUvmqdVlmvpal6B8nYrmg ($124.05 in chips)
Seat 7: qVhRZ0PLZ95XRJHWAjXjOQ ($128.20 in chips)
Seat 8: G4DEhsZFmznGNVpy2SEocA ($23.50 in chips)
Seat 9: XE5QF1y74bpHog9JxWJMWQ ($102.70 in chips)
wZsU+w9r7G66x93UuvBf1Q: posts small blind $0.50
RqkO8O/Y3qlc3PIuCAHjVg: posts big blind $1
*** HOLE CARDS ***
FVs16t7GgfWgQWt4JxsObQ: calls $1
bLbSOSmSOnqE0iTcH/5dxA: folds
Ogn4JDV3mp4ZDKO49IFzKA: folds
gUUvmqdVlmvpal6B8nYrmg: folds
qVhRZ0PLZ95XRJHWAjXjOQ: folds
G4DEhsZFmznGNVpy2SEocA: folds
XE5QF1y74bpHog9JxWJMWQ: raises $4 to $5
wZsU+w9r7G66x93UuvBf1Q: folds
RqkO8O/Y3qlc3PIuCAHjVg: raises $13 to $18
FVs16t7GgfWgQWt4JxsObQ: folds
XE5QF1y74bpHog9JxWJMWQ: folds
RqkO8O/Y3qlc3PIuCAHjVg collected $11.50 from pot
*** SUMMARY ***
Total pot $11.50 | Rake $0
Seat 1: wZsU+w9r7G66x93UuvBf1Q (small blind) folded before Flop
Seat 2: RqkO8O/Y3qlc3PIuCAHjVg (big blind) collected ($11.50)
Seat 3: FVs16t7GgfWgQWt4JxsObQ folded before Flop
Seat 4: bLbSOSmSOnqE0iTcH/5dxA folded before Flop (didn't bet)
Seat 5: Ogn4JDV3mp4ZDKO49IFzKA folded before Flop (didn't bet)
Seat 6: gUUvmqdVlmvpal6B8nYrmg folded before Flop (didn't bet)
Seat 7: qVhRZ0PLZ95XRJHWAjXjOQ folded before Flop (didn't bet)
Seat 8: G4DEhsZFmznGNVpy2SEocA folded before Flop (didn't bet)
Seat 9: XE5QF1y74bpHog9JxWJMWQ (button) folded before Flop



PokerStars Game #59939736842:  Hold'em No Limit ($0.50/$1.00) - 2009/07/01 0:47:37 ET
Table 'VOs36P6NW+QyXeQ1B62kmA' 6-max Seat #4 is the button
Seat 1: AdLVjddOzm+sRNo1Bc3S6Q ($137.80 in chips)
Seat 2: KpnW5CcJ4Mg6MeclfKmLrw ($119.35 in chips)
Seat 3: TSuRyAHnUPCFjP7Z0rEE0w ($100 in chips)
Seat 4: w02zQzNydODiyV9THKgo9w ($29.30 in chips)
Seat 6: 6tvjsJrdmWg+g7FVrMnzXA ($88.10 in chips)
ozrlafxxh1HmYdA0/h+MuA will be allowed to play after the button
6tvjsJrdmWg+g7FVrMnzXA: posts small blind $0.50
AdLVjddOzm+sRNo1Bc3S6Q: posts big blind $1
*** HOLE CARDS ***
KpnW5CcJ4Mg6MeclfKmLrw has timed out
KpnW5CcJ4Mg6MeclfKmLrw: folds
KpnW5CcJ4Mg6MeclfKmLrw is sitting out
KpnW5CcJ4Mg6MeclfKmLrw has returned
TSuRyAHnUPCFjP7Z0rEE0w: folds
w02zQzNydODiyV9THKgo9w: folds
6tvjsJrdmWg+g7FVrMnzXA: calls $0.50
AdLVjddOzm+sRNo1Bc3S6Q: checks
*** FLOP *** [9d 2s 6c]
6tvjsJrdmWg+g7FVrMnzXA: bets $1
AdLVjddOzm+sRNo1Bc3S6Q: folds
6tvjsJrdmWg+g7FVrMnzXA collected $1.90 from pot
6tvjsJrdmWg+g7FVrMnzXA: doesn't show hand
*** SUMMARY ***
Total pot $2 | Rake $0.10
Board [9d 2s 6c]
Seat 1: AdLVjddOzm+sRNo1Bc3S6Q (big blind) folded on the Flop
Seat 2: KpnW5CcJ4Mg6MeclfKmLrw folded before Flop (didn't bet)
Seat 3: TSuRyAHnUPCFjP7Z0rEE0w folded before Flop (didn't bet)
Seat 4: w02zQzNydODiyV9THKgo9w (button) folded before Flop (didn't bet)
Seat 6: 6tvjsJrdmWg+g7FVrMnzXA (small blind) collected ($1.90)



PokerStars Game #59939738444:  Hold'em No Limit ($0.50/$1.00) - 2009/07/01 0:47:39 ET
Table 'SQLOQoANiHscJ8AL7zffbw' 9-max Seat #2 is the button
Seat 1: jPTRd6SpCp4xqAy2XQiTOw ($111.10 in chips)
Seat 2: /zy+DB4S5fUQUSfZWFzYGw ($274.85 in chips)
Seat 3: 0eFnow7+D7veCYQ+CG9FFw ($95.35 in chips)
Seat 5: L9njYvloJ1NdXjP8edHEAg ($107.05 in chips)
Seat 6: p5UKaxVobvptF0ANhR/q1A ($174.50 in chips)
Seat 7: bJckevFOcg//s0qyMQI6sQ ($100 in chips)
Seat 8: Pp/KTcXkfZKKUHkjyaLTdg ($58.50 in chips)
Seat 9: qJr25HAtvv1w/7IBvjMM3g ($201.75 in chips)
0eFnow7+D7veCYQ+CG9FFw: posts small blind $0.50
N9n5Wc3s35DpCrOAUUNAaQ: is sitting out
L9njYvloJ1NdXjP8edHEAg: posts big blind $1
*** HOLE CARDS ***
N9n5Wc3s35DpCrOAUUNAaQ leaves the table
p5UKaxVobvptF0ANhR/q1A: folds
bJckevFOcg//s0qyMQI6sQ: folds
Pp/KTcXkfZKKUHkjyaLTdg: folds
qJr25HAtvv1w/7IBvjMM3g: calls $1
jPTRd6SpCp4xqAy2XQiTOw: raises $2 to $3
/zy+DB4S5fUQUSfZWFzYGw: calls $3
0eFnow7+D7veCYQ+CG9FFw: folds
L9njYvloJ1NdXjP8edHEAg: folds
qJr25HAtvv1w/7IBvjMM3g: calls $2
*** FLOP *** [4d 7c 6h]
qJr25HAtvv1w/7IBvjMM3g: checks
jPTRd6SpCp4xqAy2XQiTOw: bets $10
/zy+DB4S5fUQUSfZWFzYGw: folds
qJr25HAtvv1w/7IBvjMM3g: folds
jPTRd6SpCp4xqAy2XQiTOw collected $10 from pot
*** SUMMARY ***
Total pot $10.50 | Rake $0.50
Board [4d 7c 6h]
Seat 1: jPTRd6SpCp4xqAy2XQiTOw collected ($10)
Seat 2: /zy+DB4S5fUQUSfZWFzYGw (button) folded on the Flop
Seat 3: 0eFnow7+D7veCYQ+CG9FFw (small blind) folded before Flop
Seat 5: L9njYvloJ1NdXjP8edHEAg (big blind) folded before Flop
Seat 6: p5UKaxVobvptF0ANhR/q1A folded before Flop (didn't bet)
Seat 7: bJckevFOcg//s0qyMQI6sQ folded before Flop (didn't bet)
Seat 8: Pp/KTcXkfZKKUHkjyaLTdg folded before Flop (didn't bet)
Seat 9: qJr25HAtvv1w/7IBvjMM3g folded on the Flop



PokerStars Game #59939738726:  Hold'em No Limit ($0.50/$1.00) - 2009/07/01 0:47:40 ET
Table 'CxlB0XELs5P0zDlOhlhAPw' 2-max Seat #2 is the button
Seat 1: +B2wRsLpIMFnVA7qiRoGfg ($42.60 in chips)
Seat 2: I4xAjioR1QwQ5TgX4Z1/qw ($38.20 in chips)
I4xAjioR1QwQ5TgX4Z1/qw: posts small blind $0.50
+B2wRsLpIMFnVA7qiRoGfg: posts big blind $1
*** HOLE CARDS ***
I4xAjioR1QwQ5TgX4Z1/qw: raises $2 to $3
+B2wRsLpIMFnVA7qiRoGfg: folds
I4xAjioR1QwQ5TgX4Z1/qw collected $2 from pot
*** SUMMARY ***
Total pot $2 | Rake $0
Seat 1: +B2wRsLpIMFnVA7qiRoGfg (big blind) folded before Flop
Seat 2: I4xAjioR1QwQ5TgX4Z1/qw (button) (small blind) collected ($2)



PokerStars Game #59939740210:  Hold'em No Limit ($0.50/$1.00) - 2009/07/01 0:47:42 ET
Table 'vs/5jr6ciwjVQ5+Soc+u2A' 6-max Seat #2 is the button
Seat 2: XOIf9W+VAxhZqN+SYoyMKA ($127.85 in chips)
Seat 3: G5ZSSN6RSON3gkNvk/SmYg ($150.50 in chips)
Seat 4: KpnW5CcJ4Mg6MeclfKmLrw ($124.70 in chips)
Seat 5: 2DwLxMUbmzvwY7o4/i47Xg ($40 in chips)
Seat 6: qAdBJlVNsNTwiHia50eMvg ($79.50 in chips)
G5ZSSN6RSON3gkNvk/SmYg: posts small blind $0.50
KpnW5CcJ4Mg6MeclfKmLrw: posts big blind $1
2DwLxMUbmzvwY7o4/i47Xg: posts big blind $1
qAdBJlVNsNTwiHia50eMvg: posts big blind $1
*** HOLE CARDS ***
1C0rFAGdnnX4GWK9B0YPww leaves the table
2DwLxMUbmzvwY7o4/i47Xg: checks
qAdBJlVNsNTwiHia50eMvg: checks
XOIf9W+VAxhZqN+SYoyMKA: calls $1
G5ZSSN6RSON3gkNvk/SmYg: folds
KpnW5CcJ4Mg6MeclfKmLrw: checks
*** FLOP *** [Kd 2d 9s]
KpnW5CcJ4Mg6MeclfKmLrw: bets $3
2DwLxMUbmzvwY7o4/i47Xg: folds
qAdBJlVNsNTwiHia50eMvg: folds
XOIf9W+VAxhZqN+SYoyMKA: folds
KpnW5CcJ4Mg6MeclfKmLrw collected $4.30 from pot
KpnW5CcJ4Mg6MeclfKmLrw: doesn't show hand
*** SUMMARY ***
Total pot $4.50 | Rake $0.20
Board [Kd 2d 9s]
Seat 2: XOIf9W+VAxhZqN+SYoyMKA (button) folded on the Flop
Seat 3: G5ZSSN6RSON3gkNvk/SmYg (small blind) folded before Flop
Seat 4: KpnW5CcJ4Mg6MeclfKmLrw (big blind) collected ($4.30)
Seat 5: 2DwLxMUbmzvwY7o4/i47Xg folded on the Flop
Seat 6: qAdBJlVNsNTwiHia50eMvg folded on the Flop



PokerStars Game #59939741992:  Hold'em No Limit ($0.50/$1.00) - 2009/07/01 0:47:45 ET
Table '/RZcOwpZpHQ+OwPwjsbnRw' 6-max Seat #6 is the button
Seat 1: Zboa6dColKGHBjLPUakZjw ($43.90 in chips)
Seat 2: +xW7QemQU0Fxs+4TnqBRow ($194.50 in chips)
Seat 3: XnT1yK2DD/5FL+0bwuEhqg ($44.95 in chips)
Seat 4: j7NIOHLZk7V2o9fOioO5ug ($107.10 in chips)
Seat 5: wx3sQGkVi2x9wJXuWNHPBw ($192.15 in chips)
Seat 6: XOIf9W+VAxhZqN+SYoyMKA ($293.25 in chips)
Zboa6dColKGHBjLPUakZjw: posts small blind $0.50
+xW7QemQU0Fxs+4TnqBRow: posts big blind $1
*** HOLE CARDS ***
XnT1yK2DD/5FL+0bwuEhqg: folds
j7NIOHLZk7V2o9fOioO5ug: raises $2 to $3
wx3sQGkVi2x9wJXuWNHPBw: calls $3
XOIf9W+VAxhZqN+SYoyMKA: folds
Zboa6dColKGHBjLPUakZjw: calls $2.50
+xW7QemQU0Fxs+4TnqBRow: folds
*** FLOP *** [4s Jc 7c]
Zboa6dColKGHBjLPUakZjw: bets $2
j7NIOHLZk7V2o9fOioO5ug: raises $5 to $7
wx3sQGkVi2x9wJXuWNHPBw: calls $7
Zboa6dColKGHBjLPUakZjw: folds
*** TURN *** [4s Jc 7c] [Qs]
j7NIOHLZk7V2o9fOioO5ug: bets $17
wx3sQGkVi2x9wJXuWNHPBw: folds
j7NIOHLZk7V2o9fOioO5ug collected $24.75 from pot
j7NIOHLZk7V2o9fOioO5ug: doesn't show hand
*** SUMMARY ***
Total pot $26 | Rake $1.25
Board [4s Jc 7c Qs]
Seat 1: Zboa6dColKGHBjLPUakZjw (small blind) folded on the Flop
Seat 2: +xW7QemQU0Fxs+4TnqBRow (big blind) folded before Flop
Seat 3: XnT1yK2DD/5FL+0bwuEhqg folded before Flop (didn't bet)
Seat 4: j7NIOHLZk7V2o9fOioO5ug collected ($24.75)
Seat 5: wx3sQGkVi2x9wJXuWNHPBw folded on the Turn
Seat 6: XOIf9W+VAxhZqN+SYoyMKA (button) folded before Flop (didn't bet)



PokerStars Game #59939742966:  Hold'em No Limit ($0.50/$1.00) - 2009/07/01 0:47:46 ET
Table 'CASNP0uy1C+jGLml/I4PtA' 9-max Seat #9 is the button
Seat 2: tjhwe1V98x2spSoUQER3HQ ($103.10 in chips)
Seat 3: bJckevFOcg//s0qyMQI6sQ ($114.45 in chips)
Seat 4: B/G0GJacqZ8K59/ZVdq4kQ ($38.95 in chips)
Seat 6: 0eFnow7+D7veCYQ+CG9FFw ($99.85 in chips)
Seat 7: RpMNxqeYPSeOh0tflU772w ($162.85 in chips)
Seat 8: L9njYvloJ1NdXjP8edHEAg ($100 in chips)
Seat 9: 4oiD3zp7JlvK3PEQyVa3gA ($274.40 in chips)
tkdBeXTJlFsZdioidNqLow will be allowed to play after the button
tjhwe1V98x2spSoUQER3HQ: posts small blind $0.50
bJckevFOcg//s0qyMQI6sQ: posts big blind $1
xskinef: sits out
*** HOLE CARDS ***
B/G0GJacqZ8K59/ZVdq4kQ: folds
0eFnow7+D7veCYQ+CG9FFw: raises $2 to $3
RpMNxqeYPSeOh0tflU772w: folds
L9njYvloJ1NdXjP8edHEAg: folds
4oiD3zp7JlvK3PEQyVa3gA: folds
tjhwe1V98x2spSoUQER3HQ: raises $9 to $12
bJckevFOcg//s0qyMQI6sQ: folds
0eFnow7+D7veCYQ+CG9FFw: folds
tjhwe1V98x2spSoUQER3HQ collected $7 from pot
*** SUMMARY ***
Total pot $7 | Rake $0
Seat 2: tjhwe1V98x2spSoUQER3HQ (small blind) collected ($7)
Seat 3: bJckevFOcg//s0qyMQI6sQ (big blind) folded before Flop
Seat 4: B/G0GJacqZ8K59/ZVdq4kQ folded before Flop (didn't bet)
Seat 6: 0eFnow7+D7veCYQ+CG9FFw folded before Flop
Seat 7: RpMNxqeYPSeOh0tflU772w folded before Flop (didn't bet)
Seat 8: L9njYvloJ1NdXjP8edHEAg folded before Flop (didn't bet)
Seat 9: 4oiD3zp7JlvK3PEQyVa3gA (button) folded before Flop (didn't bet)



PokerStars Game #59939742416:  Hold'em No Limit ($0.50/$1.00) - 2009/07/01 0:47:46 ET
Table 'mmbQQVBTrPdE+wy+s+9VPA' 6-max Seat #5 is the button
Seat 2: +W6OnF033KNM2xH0fGj98Q ($123.60 in chips)
Seat 3: wx3sQGkVi2x9wJXuWNHPBw ($113.25 in chips)
Seat 4: RfKnhkJN8HEAuzJpH2Ajdg ($17.05 in chips)
Seat 5: YMJG+F++3Aj6P8dAWda5fw ($95 in chips)
Seat 6: U2CWBTv29qdCbj8RNF2sIw ($96 in chips)
U2CWBTv29qdCbj8RNF2sIw: posts small blind $0.50
lsLuWlcPA3Rh7kJVLzMh0Q: is sitting out
+W6OnF033KNM2xH0fGj98Q: posts big blind $1
*** HOLE CARDS ***
lsLuWlcPA3Rh7kJVLzMh0Q leaves the table
wx3sQGkVi2x9wJXuWNHPBw: folds
RfKnhkJN8HEAuzJpH2Ajdg: calls $1
JwCcjZl0bjJzG7hmE0dnTA joins the table at seat #1
YMJG+F++3Aj6P8dAWda5fw: folds
U2CWBTv29qdCbj8RNF2sIw: folds
+W6OnF033KNM2xH0fGj98Q: checks
*** FLOP *** [7c 6s Qh]
+W6OnF033KNM2xH0fGj98Q: checks
RfKnhkJN8HEAuzJpH2Ajdg: checks
*** TURN *** [7c 6s Qh] [2s]
+W6OnF033KNM2xH0fGj98Q: bets $2
RfKnhkJN8HEAuzJpH2Ajdg: calls $2
*** RIVER *** [7c 6s Qh 2s] [3c]
+W6OnF033KNM2xH0fGj98Q: checks
RfKnhkJN8HEAuzJpH2Ajdg: bets $3
+W6OnF033KNM2xH0fGj98Q: folds
RfKnhkJN8HEAuzJpH2Ajdg collected $6.20 from pot
*** SUMMARY ***
Total pot $6.50 | Rake $0.30
Board [7c 6s Qh 2s 3c]
Seat 2: +W6OnF033KNM2xH0fGj98Q (big blind) folded on the River
Seat 3: wx3sQGkVi2x9wJXuWNHPBw folded before Flop (didn't bet)
Seat 4: RfKnhkJN8HEAuzJpH2Ajdg collected ($6.20)
Seat 5: YMJG+F++3Aj6P8dAWda5fw (button) folded before Flop (didn't bet)
Seat 6: U2CWBTv29qdCbj8RNF2sIw (small blind) folded before Flop



PokerStars Game #59939743632:  Hold'em No Limit ($0.50/$1.00) - 2009/07/01 0:47:47 ET
Table 'N2bNCDHL96aCQDvZIh+yQQ' 6-max Seat #4 is the button
Seat 1: iHo1oDbrEVJ8nEGdaPrICw ($100 in chips)
Seat 2: KpnW5CcJ4Mg6MeclfKmLrw ($161.80 in chips)
Seat 3: Qy/UBNbD2HaA0Ogxg8Sf3w ($159.70 in chips)
Seat 4: uCqEjnxh2/vFBjKYkfTOkw ($175.55 in chips)
Seat 6: TSuRyAHnUPCFjP7Z0rEE0w ($100 in chips)
TSuRyAHnUPCFjP7Z0rEE0w: posts small blind $0.50
iHo1oDbrEVJ8nEGdaPrICw: posts big blind $1
*** HOLE CARDS ***
ZIdFTzUiF+cFsap66otbHg joins the table at seat #5
KpnW5CcJ4Mg6MeclfKmLrw: folds
Qy/UBNbD2HaA0Ogxg8Sf3w: folds
uCqEjnxh2/vFBjKYkfTOkw: folds
TSuRyAHnUPCFjP7Z0rEE0w: folds
iHo1oDbrEVJ8nEGdaPrICw collected $1 from pot
iHo1oDbrEVJ8nEGdaPrICw: doesn't show hand
*** SUMMARY ***
Total pot $1 | Rake $0
Seat 1: iHo1oDbrEVJ8nEGdaPrICw (big blind) collected ($1)
Seat 2: KpnW5CcJ4Mg6MeclfKmLrw folded before Flop (didn't bet)
Seat 3: Qy/UBNbD2HaA0Ogxg8Sf3w folded before Flop (didn't bet)
Seat 4: uCqEjnxh2/vFBjKYkfTOkw (button) folded before Flop (didn't bet)
Seat 6: TSuRyAHnUPCFjP7Z0rEE0w (small blind) folded before Flop



PokerStars Game #59939743076:  Hold'em No Limit ($0.50/$1.00) - 2009/07/01 0:47:47 ET
Table 'GPp0HyAuggN8oE0sUWzPpA' 9-max Seat #8 is the button
Seat 1: qJr25HAtvv1w/7IBvjMM3g ($29 in chips)
Seat 2: Ogn4JDV3mp4ZDKO49IFzKA ($34.20 in chips)
Seat 3: L9njYvloJ1NdXjP8edHEAg ($100 in chips)
Seat 4: mBRWbnUl8diyBO1qTJaNzw ($109.70 in chips)
Seat 5: 0fXz44fzDo5QmhAaJCvFfA ($19.30 in chips)
Seat 6: BK/GtNPkSx0TdUDj82id5A ($12 in chips)
Seat 7: laA8va+Yv8WuMqT1zdR91g ($100 in chips)
Seat 8: tkdBeXTJlFsZdioidNqLow ($69.70 in chips)
Seat 9: VPF+HjszMvUIpy0CHIwH3A ($19 in chips)
VPF+HjszMvUIpy0CHIwH3A: posts small blind $0.50
qJr25HAtvv1w/7IBvjMM3g: posts big blind $1
*** HOLE CARDS ***
Ogn4JDV3mp4ZDKO49IFzKA: folds
L9njYvloJ1NdXjP8edHEAg: raises $1 to $2
mBRWbnUl8diyBO1qTJaNzw: folds
0fXz44fzDo5QmhAaJCvFfA: folds
BK/GtNPkSx0TdUDj82id5A: folds
laA8va+Yv8WuMqT1zdR91g: folds
tkdBeXTJlFsZdioidNqLow: folds
VPF+HjszMvUIpy0CHIwH3A: raises $17 to $19 and is all-in
qJr25HAtvv1w/7IBvjMM3g: folds
L9njYvloJ1NdXjP8edHEAg: folds
VPF+HjszMvUIpy0CHIwH3A collected $5 from pot
*** SUMMARY ***
Total pot $5 | Rake $0
Seat 1: qJr25HAtvv1w/7IBvjMM3g (big blind) folded before Flop
Seat 2: Ogn4JDV3mp4ZDKO49IFzKA folded before Flop (didn't bet)
Seat 3: L9njYvloJ1NdXjP8edHEAg folded before Flop
Seat 4: mBRWbnUl8diyBO1qTJaNzw folded before Flop (didn't bet)
Seat 5: 0fXz44fzDo5QmhAaJCvFfA folded before Flop (didn't bet)
Seat 6: BK/GtNPkSx0TdUDj82id5A folded before Flop (didn't bet)
Seat 7: laA8va+Yv8WuMqT1zdR91g folded before Flop (didn't bet)
Seat 8: tkdBeXTJlFsZdioidNqLow (button) folded before Flop (didn't bet)
Seat 9: VPF+HjszMvUIpy0CHIwH3A (small blind) collected ($5)



PokerStars Game #59939743312:  Hold'em No Limit ($0.50/$1.00) - 2009/07/01 0:47:47 ET
Table '+cA8mcmhaedZ7YcrDdhmeQ' 6-max Seat #5 is the button
Seat 1: lsLuWlcPA3Rh7kJVLzMh0Q ($290.50 in chips)
Seat 2: RqgF7gRoKgRNW8Zoi1ty4A ($101.50 in chips)
Seat 3: 7H5WkGzGvsv56y1iaqHvRg ($35.85 in chips)
Seat 4: LjL3AIERHn559yyW1mTUYQ ($171.80 in chips)
Seat 5: +7hFKAL0b0O/n8G72TclJA ($42.70 in chips)
Seat 6: YfsTQsY/fxb+YqbdclTHuw ($55.70 in chips)
YfsTQsY/fxb+YqbdclTHuw: posts small blind $0.50
lsLuWlcPA3Rh7kJVLzMh0Q: posts big blind $1
*** HOLE CARDS ***
RqgF7gRoKgRNW8Zoi1ty4A: folds
7H5WkGzGvsv56y1iaqHvRg: folds
LjL3AIERHn559yyW1mTUYQ: folds
+7hFKAL0b0O/n8G72TclJA: raises $2 to $3
YfsTQsY/fxb+YqbdclTHuw: calls $2.50
lsLuWlcPA3Rh7kJVLzMh0Q: folds
*** FLOP *** [7h Js Ad]
YfsTQsY/fxb+YqbdclTHuw: checks
+7hFKAL0b0O/n8G72TclJA: checks
*** TURN *** [7h Js Ad] [2h]
YfsTQsY/fxb+YqbdclTHuw: checks
+7hFKAL0b0O/n8G72TclJA: checks
*** RIVER *** [7h Js Ad 2h] [8h]
YfsTQsY/fxb+YqbdclTHuw: checks
+7hFKAL0b0O/n8G72TclJA: bets $4
YfsTQsY/fxb+YqbdclTHuw: calls $4
*** SHOW DOWN ***
+7hFKAL0b0O/n8G72TclJA: shows [4d As] (a pair of Aces)
YfsTQsY/fxb+YqbdclTHuw: mucks hand
+7hFKAL0b0O/n8G72TclJA collected $14.30 from pot
*** SUMMARY ***
Total pot $15 | Rake $0.70
Board [7h Js Ad 2h 8h]
Seat 1: lsLuWlcPA3Rh7kJVLzMh0Q (big blind) folded before Flop
Seat 2: RqgF7gRoKgRNW8Zoi1ty4A folded before Flop (didn't bet)
Seat 3: 7H5WkGzGvsv56y1iaqHvRg folded before Flop (didn't bet)
Seat 4: LjL3AIERHn559yyW1mTUYQ folded before Flop (didn't bet)
Seat 5: +7hFKAL0b0O/n8G72TclJA (button) showed [4d As] and won ($14.30) with a pair of Aces
Seat 6: YfsTQsY/fxb+YqbdclTHuw (small blind) mucked



PokerStars Game #59939743852:  Hold'em No Limit ($0.50/$1.00) - 2009/07/01 0:47:48 ET
Table 'W/wyObTiXZm+Ckkl3YxcSw' 6-max Seat #6 is the button
Seat 1: eUBBn2R56C1IQ6Cs/vitwg ($112.75 in chips)
Seat 2: oDiBRCaF0QVtd3kO6xZIXw ($78.75 in chips)
Seat 3: ybGsYWp1MLwy1vSnP8egXg ($30 in chips)
Seat 4: +xW7QemQU0Fxs+4TnqBRow ($133.90 in chips)
Seat 5: BdbmJTZZ47quA9vUWwXtlw ($53.85 in chips)
Seat 6: tS9JHB1h+FQ++qu8RwRNgg ($27 in chips)
eUBBn2R56C1IQ6Cs/vitwg: posts small blind $0.50
oDiBRCaF0QVtd3kO6xZIXw: posts big blind $1
*** HOLE CARDS ***
ybGsYWp1MLwy1vSnP8egXg: folds
+xW7QemQU0Fxs+4TnqBRow: folds
BdbmJTZZ47quA9vUWwXtlw: raises $2 to $3
tS9JHB1h+FQ++qu8RwRNgg: folds
eUBBn2R56C1IQ6Cs/vitwg: folds
oDiBRCaF0QVtd3kO6xZIXw: folds
BdbmJTZZ47quA9vUWwXtlw collected $2.50 from pot
*** SUMMARY ***
Total pot $2.50 | Rake $0
Seat 1: eUBBn2R56C1IQ6Cs/vitwg (small blind) folded before Flop
Seat 2: oDiBRCaF0QVtd3kO6xZIXw (big blind) folded before Flop
Seat 3: ybGsYWp1MLwy1vSnP8egXg folded before Flop (didn't bet)
Seat 4: +xW7QemQU0Fxs+4TnqBRow folded before Flop (didn't bet)
Seat 5: BdbmJTZZ47quA9vUWwXtlw collected ($2.50)
Seat 6: tS9JHB1h+FQ++qu8RwRNgg (button) folded before Flop (didn't bet)



PokerStars Game #59939743908:  Hold'em No Limit ($0.50/$1.00) - 2009/07/01 0:47:48 ET
Table 'Zka9tv1yilg0MvXWPQrShg' 9-max Seat #7 is the button
Seat 1: TZcz9MEWDA+WydgGruqqbw ($113.85 in chips)
Seat 3: gUUvmqdVlmvpal6B8nYrmg ($100 in chips)
Seat 4: stxmTgSicxShtrDxhOOX2g ($69.25 in chips)
Seat 5: /zy+DB4S5fUQUSfZWFzYGw ($124.90 in chips)
Seat 6: rY8wPoax1lS+HUY+I0FZDw ($140.30 in chips)
Seat 7: p1SafS90nb3Uft5LB0NkHw ($17.50 in chips)
Seat 8: bL+QVeDcuEdzMGAGg2XJHg ($122.60 in chips)
Seat 9: 6daxhj43mWj04MOPTOmaYA ($95.65 in chips)
bL+QVeDcuEdzMGAGg2XJHg: posts small blind $0.50
6daxhj43mWj04MOPTOmaYA: posts big blind $1
kz9ziSiGUc+857heiKSayw: sits out
*** HOLE CARDS ***
TZcz9MEWDA+WydgGruqqbw: folds
gUUvmqdVlmvpal6B8nYrmg: folds
stxmTgSicxShtrDxhOOX2g: folds
/zy+DB4S5fUQUSfZWFzYGw: folds
rY8wPoax1lS+HUY+I0FZDw: raises $4 to $5
p1SafS90nb3Uft5LB0NkHw: folds
bL+QVeDcuEdzMGAGg2XJHg: folds
6daxhj43mWj04MOPTOmaYA: folds
rY8wPoax1lS+HUY+I0FZDw collected $2.50 from pot
*** SUMMARY ***
Total pot $2.50 | Rake $0
Seat 1: TZcz9MEWDA+WydgGruqqbw folded before Flop (didn't bet)
Seat 3: gUUvmqdVlmvpal6B8nYrmg folded before Flop (didn't bet)
Seat 4: stxmTgSicxShtrDxhOOX2g folded before Flop (didn't bet)
Seat 5: /zy+DB4S5fUQUSfZWFzYGw folded before Flop (didn't bet)
Seat 6: rY8wPoax1lS+HUY+I0FZDw collected ($2.50)
Seat 7: p1SafS90nb3Uft5LB0NkHw (button) folded before Flop (didn't bet)
Seat 8: bL+QVeDcuEdzMGAGg2XJHg (small blind) folded before Flop
Seat 9: 6daxhj43mWj04MOPTOmaYA (big blind) folded before Flop



PokerStars Game #59939745248:  Hold'em No Limit ($0.50/$1.00) - 2009/07/01 0:47:50 ET
Table 'pHrhryH8jPNdQfY62f8v+g' 6-max Seat #1 is the button
Seat 1: fF4botNMr8/ieVPO1YYRLw ($43.35 in chips)
Seat 2: RqgF7gRoKgRNW8Zoi1ty4A ($104.75 in chips)
Seat 3: 8oS5O7iD/qnFXFXJrGIgNQ ($100 in chips)
Seat 4: wenbG7TaM3H7h5kn78OFNw ($57.20 in chips)
Seat 5: r1/R7y0Ortgoz4lccgW8VA ($55.90 in chips)
Seat 6: xAU6q2/cwmby2sxmA8VcmA ($113.75 in chips)
RqgF7gRoKgRNW8Zoi1ty4A: posts small blind $0.50
8oS5O7iD/qnFXFXJrGIgNQ: posts big blind $1
*** HOLE CARDS ***
wenbG7TaM3H7h5kn78OFNw: folds
r1/R7y0Ortgoz4lccgW8VA: folds
xAU6q2/cwmby2sxmA8VcmA: folds
fF4botNMr8/ieVPO1YYRLw: calls $1
RqgF7gRoKgRNW8Zoi1ty4A: folds
8oS5O7iD/qnFXFXJrGIgNQ: checks
*** FLOP *** [Th 3c Ah]
8oS5O7iD/qnFXFXJrGIgNQ: checks
fF4botNMr8/ieVPO1YYRLw: checks
*** TURN *** [Th 3c Ah] [Tc]
8oS5O7iD/qnFXFXJrGIgNQ: bets $2.50
fF4botNMr8/ieVPO1YYRLw: calls $2.50
*** RIVER *** [Th 3c Ah Tc] [2c]
8oS5O7iD/qnFXFXJrGIgNQ said, "5"
8oS5O7iD/qnFXFXJrGIgNQ: bets $5
fF4botNMr8/ieVPO1YYRLw: raises $5 to $10
8oS5O7iD/qnFXFXJrGIgNQ: calls $5
*** SHOW DOWN ***
fF4botNMr8/ieVPO1YYRLw: shows [9c 6c] (a flush, Ten high)
8oS5O7iD/qnFXFXJrGIgNQ: mucks hand
fF4botNMr8/ieVPO1YYRLw collected $26.15 from pot
*** SUMMARY ***
Total pot $27.50 | Rake $1.35
Board [Th 3c Ah Tc 2c]
Seat 1: fF4botNMr8/ieVPO1YYRLw (button) showed [9c 6c] and won ($26.15) with a flush, Ten high
Seat 2: RqgF7gRoKgRNW8Zoi1ty4A (small blind) folded before Flop
Seat 3: 8oS5O7iD/qnFXFXJrGIgNQ (big blind) mucked
Seat 4: wenbG7TaM3H7h5kn78OFNw folded before Flop (didn't bet)
Seat 5: r1/R7y0Ortgoz4lccgW8VA folded before Flop (didn't bet)
Seat 6: xAU6q2/cwmby2sxmA8VcmA folded before Flop (didn't bet)



PokerStars Game #59939745472:  Hold'em No Limit ($0.50/$1.00) - 2009/07/01 0:47:50 ET
Table 'LmXQK9xy3awB+qsPzI21Mw' 2-max Seat #2 is the button
Seat 1: NYi6JFscYNrofSXy4sM+Yw ($232.55 in chips)
Seat 2: TME8GvochpQAo8cmJwWmvA ($99.40 in chips)
TME8GvochpQAo8cmJwWmvA: posts small blind $0.50
NYi6JFscYNrofSXy4sM+Yw: posts big blind $1
*** HOLE CARDS ***
TME8GvochpQAo8cmJwWmvA: calls $0.50
NYi6JFscYNrofSXy4sM+Yw: raises $2 to $3
TME8GvochpQAo8cmJwWmvA: folds
NYi6JFscYNrofSXy4sM+Yw collected $2 from pot
NYi6JFscYNrofSXy4sM+Yw: doesn't show hand
*** SUMMARY ***
Total pot $2 | Rake $0
Seat 1: NYi6JFscYNrofSXy4sM+Yw (big blind) collected ($2)
Seat 2: TME8GvochpQAo8cmJwWmvA (button) (small blind) folded before Flop



PokerStars Game #59939746478:  Hold'em No Limit ($0.50/$1.00) - 2009/07/01 0:47:52 ET
Table 'cKH9c4x6u79IqCdaKKvXrw' 9-max Seat #3 is the button
Seat 1: Pp/KTcXkfZKKUHkjyaLTdg ($17 in chips)
Seat 2: 8S3JMH4TY3whgIlZmMv66w ($58.85 in chips)
Seat 3: 997ViqAtWn1FPjJqcffwcA ($158.60 in chips)
Seat 4: FL3MrLspcF23LYvC4ipBOA ($100 in chips)
Seat 5: x80+i7DJL+81v3quj7KbNg ($27.15 in chips)
Seat 6: Bsd/K5gAcLanYbGiPirRjw ($168.55 in chips)
Seat 7: 1GkkVBhlJ92guE6K5mS5Ig ($50.55 in chips)
Seat 8: 4/8w7g4QE6v0i1tIIf/1HQ ($39.15 in chips)
Seat 9: 6XkTu4ahxzHnvjjc1R8YjQ ($37.65 in chips)
FL3MrLspcF23LYvC4ipBOA: posts small blind $0.50
x80+i7DJL+81v3quj7KbNg: posts big blind $1
*** HOLE CARDS ***
Bsd/K5gAcLanYbGiPirRjw: folds
1GkkVBhlJ92guE6K5mS5Ig: calls $1
4/8w7g4QE6v0i1tIIf/1HQ: calls $1
6XkTu4ahxzHnvjjc1R8YjQ: folds
Pp/KTcXkfZKKUHkjyaLTdg: folds
8S3JMH4TY3whgIlZmMv66w: folds
997ViqAtWn1FPjJqcffwcA: folds
FL3MrLspcF23LYvC4ipBOA: folds
x80+i7DJL+81v3quj7KbNg: checks
*** FLOP *** [8c 8h 2d]
x80+i7DJL+81v3quj7KbNg: checks
1GkkVBhlJ92guE6K5mS5Ig: checks
4/8w7g4QE6v0i1tIIf/1HQ: checks
*** TURN *** [8c 8h 2d] [Kc]
x80+i7DJL+81v3quj7KbNg: checks
1GkkVBhlJ92guE6K5mS5Ig: checks
4/8w7g4QE6v0i1tIIf/1HQ: checks
*** RIVER *** [8c 8h 2d Kc] [Qs]
x80+i7DJL+81v3quj7KbNg: checks
1GkkVBhlJ92guE6K5mS5Ig: checks
4/8w7g4QE6v0i1tIIf/1HQ: bets $2
x80+i7DJL+81v3quj7KbNg: folds
1GkkVBhlJ92guE6K5mS5Ig: folds
x80+i7DJL+81v3quj7KbNg leaves the table
4/8w7g4QE6v0i1tIIf/1HQ collected $3.35 from pot
4/8w7g4QE6v0i1tIIf/1HQ: doesn't show hand
*** SUMMARY ***
Total pot $3.50 | Rake $0.15
Board [8c 8h 2d Kc Qs]
Seat 1: Pp/KTcXkfZKKUHkjyaLTdg folded before Flop (didn't bet)
Seat 2: 8S3JMH4TY3whgIlZmMv66w folded before Flop (didn't bet)
Seat 3: 997ViqAtWn1FPjJqcffwcA (button) folded before Flop (didn't bet)
Seat 4: FL3MrLspcF23LYvC4ipBOA (small blind) folded before Flop
Seat 5: x80+i7DJL+81v3quj7KbNg (big blind) folded on the River
Seat 6: Bsd/K5gAcLanYbGiPirRjw folded before Flop (didn't bet)
Seat 7: 1GkkVBhlJ92guE6K5mS5Ig folded on the River
Seat 8: 4/8w7g4QE6v0i1tIIf/1HQ collected ($3.35)
Seat 9: 6XkTu4ahxzHnvjjc1R8YjQ folded before Flop (didn't bet)



PokerStars Game #59939746714:  Hold'em No Limit ($0.50/$1.00) - 2009/07/01 0:47:52 ET
Table '7Nl0ffnjeK44/vmeexh3MQ' 9-max Seat #8 is the button
Seat 1: s7D3Y+k4Cj4D1cXHv7oj+Q ($92.35 in chips)
Seat 2: kiakSwxX0e64PwYGAPQvLw ($33.35 in chips)
Seat 3: vR4IO10geOgvTW+LAUBv/A ($101.50 in chips)
Seat 4: bLbSOSmSOnqE0iTcH/5dxA ($100 in chips)
Seat 5: bL+QVeDcuEdzMGAGg2XJHg ($105.05 in chips)
Seat 6: FVs16t7GgfWgQWt4JxsObQ ($27.50 in chips)
Seat 7: 997ViqAtWn1FPjJqcffwcA ($100 in chips)
Seat 8: zanka7aAZkigmZpfopXxxA ($252.20 in chips)
Seat 9: ouwUBGRKnKK9uhn1G4Lf+A ($95.50 in chips)
ouwUBGRKnKK9uhn1G4Lf+A: posts small blind $0.50
s7D3Y+k4Cj4D1cXHv7oj+Q: posts big blind $1
*** HOLE CARDS ***
kiakSwxX0e64PwYGAPQvLw: folds
kiakSwxX0e64PwYGAPQvLw leaves the table
vR4IO10geOgvTW+LAUBv/A: raises $2 to $3
bLbSOSmSOnqE0iTcH/5dxA: folds
bL+QVeDcuEdzMGAGg2XJHg: folds
FVs16t7GgfWgQWt4JxsObQ: folds
997ViqAtWn1FPjJqcffwcA: folds
zanka7aAZkigmZpfopXxxA: calls $3
OGgaARGdJQT4awWVNQ957w joins the table at seat #2
ouwUBGRKnKK9uhn1G4Lf+A: folds
s7D3Y+k4Cj4D1cXHv7oj+Q: folds
*** FLOP *** [Kh 4d Qd]
vR4IO10geOgvTW+LAUBv/A: checks
zanka7aAZkigmZpfopXxxA: bets $4
vR4IO10geOgvTW+LAUBv/A: folds
zanka7aAZkigmZpfopXxxA collected $7.15 from pot
zanka7aAZkigmZpfopXxxA: doesn't show hand
*** SUMMARY ***
Total pot $7.50 | Rake $0.35
Board [Kh 4d Qd]
Seat 1: s7D3Y+k4Cj4D1cXHv7oj+Q (big blind) folded before Flop
Seat 2: kiakSwxX0e64PwYGAPQvLw folded before Flop (didn't bet)
Seat 3: vR4IO10geOgvTW+LAUBv/A folded on the Flop
Seat 4: bLbSOSmSOnqE0iTcH/5dxA folded before Flop (didn't bet)
Seat 5: bL+QVeDcuEdzMGAGg2XJHg folded before Flop (didn't bet)
Seat 6: FVs16t7GgfWgQWt4JxsObQ folded before Flop (didn't bet)
Seat 7: 997ViqAtWn1FPjJqcffwcA folded before Flop (didn't bet)
Seat 8: zanka7aAZkigmZpfopXxxA (button) collected ($7.15)
Seat 9: ouwUBGRKnKK9uhn1G4Lf+A (small blind) folded before Flop



PokerStars Game #59939746800:  Hold'em No Limit ($0.50/$1.00) - 2009/07/01 0:47:53 ET
Table 'eU3bWpDDg3Z+9R4m4iVmog' 6-max Seat #6 is the button
Seat 1: TSuRyAHnUPCFjP7Z0rEE0w ($190.15 in chips)
Seat 2: 8CAoOzhmB8n3nRFf3V4BTg ($97.80 in chips)
Seat 3: U6tnjwZRpTnM+YkqkCjwyQ ($188.65 in chips)
Seat 4: GDVIsbEJ/DOJsMKE4Asz0A ($68.30 in chips)
Seat 5: AdLVjddOzm+sRNo1Bc3S6Q ($109.95 in chips)
Seat 6: hpxXcmRkXXI9HE5+5/j/0Q ($121.95 in chips)
TSuRyAHnUPCFjP7Z0rEE0w: posts small blind $0.50
8CAoOzhmB8n3nRFf3V4BTg: posts big blind $1
*** HOLE CARDS ***
U6tnjwZRpTnM+YkqkCjwyQ: folds
GDVIsbEJ/DOJsMKE4Asz0A: folds
AdLVjddOzm+sRNo1Bc3S6Q: raises $3 to $4
hpxXcmRkXXI9HE5+5/j/0Q: folds
TSuRyAHnUPCFjP7Z0rEE0w: folds
8CAoOzhmB8n3nRFf3V4BTg: calls $3
*** FLOP *** [7d Ad 7c]
8CAoOzhmB8n3nRFf3V4BTg: checks
AdLVjddOzm+sRNo1Bc3S6Q: bets $7
8CAoOzhmB8n3nRFf3V4BTg: folds
AdLVjddOzm+sRNo1Bc3S6Q collected $8.10 from pot
AdLVjddOzm+sRNo1Bc3S6Q: doesn't show hand
*** SUMMARY ***
Total pot $8.50 | Rake $0.40
Board [7d Ad 7c]
Seat 1: TSuRyAHnUPCFjP7Z0rEE0w (small blind) folded before Flop
Seat 2: 8CAoOzhmB8n3nRFf3V4BTg (big blind) folded on the Flop
Seat 3: U6tnjwZRpTnM+YkqkCjwyQ folded before Flop (didn't bet)
Seat 4: GDVIsbEJ/DOJsMKE4Asz0A folded before Flop (didn't bet)
Seat 5: AdLVjddOzm+sRNo1Bc3S6Q collected ($8.10)
Seat 6: hpxXcmRkXXI9HE5+5/j/0Q (button) folded before Flop (didn't bet)



PokerStars Game #59939748544:  Hold'em No Limit ($0.50/$1.00) - 2009/07/01 0:47:55 ET
Table 'tyUh+jyNvrceIQdKMJjQ2wZFWj23PMihdwrNWv41OG/Qeat #2 is the button
Seat 2: XvUbOIg94d25feWeQlOTVg ($71.90 in chips)
Seat 3: TalCiLYHCd+ffkmR3auPvA ($66.80 in chips)
Seat 4: TSuRyAHnUPCFjP7Z0rEE0w ($118.25 in chips)
Seat 5: j7NIOHLZk7V2o9fOioO5ug ($110.10 in chips)
Seat 6: YsLQ3BAvgQHWXMAv3Wv6Hg ($148.15 in chips)
TalCiLYHCd+ffkmR3auPvA: posts small blind $0.50
TSuRyAHnUPCFjP7Z0rEE0w: posts big blind $1
*** HOLE CARDS ***
j7NIOHLZk7V2o9fOioO5ug: raises $2 to $3
YsLQ3BAvgQHWXMAv3Wv6Hg: folds
XvUbOIg94d25feWeQlOTVg has timed out
XvUbOIg94d25feWeQlOTVg: folds
XvUbOIg94d25feWeQlOTVg is sitting out
TalCiLYHCd+ffkmR3auPvA: calls $2.50
XvUbOIg94d25feWeQlOTVg has returned
o8A5MUdudVKu+pAwgZOX2w has returned
TSuRyAHnUPCFjP7Z0rEE0w: folds
*** FLOP *** [Jd 5c 8h]
TalCiLYHCd+ffkmR3auPvA: checks
j7NIOHLZk7V2o9fOioO5ug: bets $6
TalCiLYHCd+ffkmR3auPvA: calls $6
*** TURN *** [Jd 5c 8h] [7h]
TalCiLYHCd+ffkmR3auPvA: checks
j7NIOHLZk7V2o9fOioO5ug: checks
*** RIVER *** [Jd 5c 8h 7h] [9h]
TalCiLYHCd+ffkmR3auPvA: bets $10
j7NIOHLZk7V2o9fOioO5ug: folds
TalCiLYHCd+ffkmR3auPvA collected $18.10 from pot
TalCiLYHCd+ffkmR3auPvA: doesn't show hand
*** SUMMARY ***
Total pot $19 | Rake $0.90
Board [Jd 5c 8h 7h 9h]
Seat 2: XvUbOIg94d25feWeQlOTVg (button) folded before Flop (didn't bet)
Seat 3: TalCiLYHCd+ffkmR3auPvA (small blind) collected ($18.10)
Seat 4: TSuRyAHnUPCFjP7Z0rEE0w (big blind) folded before Flop
Seat 5: j7NIOHLZk7V2o9fOioO5ug folded on the River
Seat 6: YsLQ3BAvgQHWXMAv3Wv6Hg folded before Flop (didn't bet)



PokerStars Game #59939748878:  Hold'em No Limit ($0.50/$1.00) - 2009/07/01 0:47:56 ET
Table 'hugOjcwJvzEwZbK7tyiWuQ' 9-max Seat #5 is the button
Seat 1: N9n5Wc3s35DpCrOAUUNAaQ ($130 in chips)
Seat 2: r27C1nIV4NS4+qbnrgBQSw ($260.60 in chips)
Seat 3: jDwhY1kCdc6EkAHbT7PJMQ ($107.65 in chips)
Seat 4: UWB3oeddt/GObx2Mix2Anw ($204.25 in chips)
Seat 5: 5BRGWf+R3nt2WS3b5xX+zA ($19.30 in chips)
Seat 6: gUUvmqdVlmvpal6B8nYrmg ($106.70 in chips)
Seat 7: FL3MrLspcF23LYvC4ipBOA ($100 in chips)
Seat 8: /zy+DB4S5fUQUSfZWFzYGw ($101.25 in chips)
Seat 9: W8P9bUKCs43TO1xHm0dL6w ($88.15 in chips)
gUUvmqdVlmvpal6B8nYrmg: posts small blind $0.50
FL3MrLspcF23LYvC4ipBOA: posts big blind $1
*** HOLE CARDS ***
/zy+DB4S5fUQUSfZWFzYGw: folds
W8P9bUKCs43TO1xHm0dL6w: folds
N9n5Wc3s35DpCrOAUUNAaQ: folds
r27C1nIV4NS4+qbnrgBQSw: folds
jDwhY1kCdc6EkAHbT7PJMQ: raises $3 to $4
UWB3oeddt/GObx2Mix2Anw: folds
5BRGWf+R3nt2WS3b5xX+zA: calls $4
gUUvmqdVlmvpal6B8nYrmg: folds
FL3MrLspcF23LYvC4ipBOA: calls $3
*** FLOP *** [8h 8d 6s]
FL3MrLspcF23LYvC4ipBOA: checks
jDwhY1kCdc6EkAHbT7PJMQ: checks
5BRGWf+R3nt2WS3b5xX+zA: bets $8
FL3MrLspcF23LYvC4ipBOA: folds
jDwhY1kCdc6EkAHbT7PJMQ: folds
5BRGWf+R3nt2WS3b5xX+zA collected $11.90 from pot
*** SUMMARY ***
Total pot $12.50 | Rake $0.60
Board [8h 8d 6s]
Seat 1: N9n5Wc3s35DpCrOAUUNAaQ folded before Flop (didn't bet)
Seat 2: r27C1nIV4NS4+qbnrgBQSw folded before Flop (didn't bet)
Seat 3: jDwhY1kCdc6EkAHbT7PJMQ folded on the Flop
Seat 4: UWB3oeddt/GObx2Mix2Anw folded before Flop (didn't bet)
Seat 5: 5BRGWf+R3nt2WS3b5xX+zA (button) collected ($11.90)
Seat 6: gUUvmqdVlmvpal6B8nYrmg (small blind) folded before Flop
Seat 7: FL3MrLspcF23LYvC4ipBOA (big blind) folded on the Flop
Seat 8: /zy+DB4S5fUQUSfZWFzYGw folded before Flop (didn't bet)
Seat 9: W8P9bUKCs43TO1xHm0dL6w folded before Flop (didn't bet)



PokerStars Game #59939750060:  Hold'em No Limit ($0.50/$1.00) - 2009/07/01 0:47:58 ET
Table 'CxlB0XELs5P0zDlOhlhAPw' 2-max Seat #1 is the button
Seat 1: +B2wRsLpIMFnVA7qiRoGfg ($41.60 in chips)
Seat 2: I4xAjioR1QwQ5TgX4Z1/qw ($39.20 in chips)
+B2wRsLpIMFnVA7qiRoGfg: posts small blind $0.50
I4xAjioR1QwQ5TgX4Z1/qw: posts big blind $1
*** HOLE CARDS ***
+B2wRsLpIMFnVA7qiRoGfg: raises $1 to $2
I4xAjioR1QwQ5TgX4Z1/qw: calls $1
*** FLOP *** [2d Ac 2c]
I4xAjioR1QwQ5TgX4Z1/qw: checks
+B2wRsLpIMFnVA7qiRoGfg: bets $2
I4xAjioR1QwQ5TgX4Z1/qw: folds
+B2wRsLpIMFnVA7qiRoGfg collected $3.80 from pot
*** SUMMARY ***
Total pot $4 | Rake $0.20
Board [2d Ac 2c]
Seat 1: +B2wRsLpIMFnVA7qiRoGfg (button) (small blind) collected ($3.80)
Seat 2: I4xAjioR1QwQ5TgX4Z1/qw (big blind) folded on the Flop



PokerStars Game #59939750936:  Hold'em No Limit ($0.50/$1.00) - 2009/07/01 0:47:59 ET
Table 'MUPc8FEpe/nR0BKSeReX6Q' 6-max Seat #3 is the button
Seat 1: YsLQ3BAvgQHWXMAv3Wv6Hg ($113.85 in chips)
Seat 2: xAU6q2/cwmby2sxmA8VcmA ($108.80 in chips)
Seat 3: wx3sQGkVi2x9wJXuWNHPBw ($218.55 in chips)
Seat 4: ZA1bp6g8IwtTxkUE4eCjDQ ($204.30 in chips)
Seat 5: UBZQqpnJZdTYYY1FTb0rLA ($100 in chips)
Seat 6: oxnw0GLLpFanjhGkxfRSqA ($47 in chips)
ZA1bp6g8IwtTxkUE4eCjDQ: posts small blind $0.50
UBZQqpnJZdTYYY1FTb0rLA: posts big blind $1
*** HOLE CARDS ***
oxnw0GLLpFanjhGkxfRSqA: calls $1
ZA1bp6g8IwtTxkUE4eCjDQ said, "what"
YsLQ3BAvgQHWXMAv3Wv6Hg: folds
xAU6q2/cwmby2sxmA8VcmA: folds
ZA1bp6g8IwtTxkUE4eCjDQ said, "what u have"
wx3sQGkVi2x9wJXuWNHPBw: calls $1
ZA1bp6g8IwtTxkUE4eCjDQ: folds
oxnw0GLLpFanjhGkxfRSqA said, "keep calling with nothing stupid c.u.n.t"
ZA1bp6g8IwtTxkUE4eCjDQ said, "8"
UBZQqpnJZdTYYY1FTb0rLA: checks
*** FLOP *** [8d 4h Jd]
UBZQqpnJZdTYYY1FTb0rLA: checks
oxnw0GLLpFanjhGkxfRSqA: checks
ZA1bp6g8IwtTxkUE4eCjDQ said, "\i have da bbest hand"
wx3sQGkVi2x9wJXuWNHPBw: bets $2.50
UBZQqpnJZdTYYY1FTb0rLA: folds
oxnw0GLLpFanjhGkxfRSqA said, "sucked out on river stupid c.u.n.t"
oxnw0GLLpFanjhGkxfRSqA: folds
wx3sQGkVi2x9wJXuWNHPBw collected $3.35 from pot
*** SUMMARY ***
Total pot $3.50 | Rake $0.15
Board [8d 4h Jd]
Seat 1: YsLQ3BAvgQHWXMAv3Wv6Hg folded before Flop (didn't bet)
Seat 2: xAU6q2/cwmby2sxmA8VcmA folded before Flop (didn't bet)
Seat 3: wx3sQGkVi2x9wJXuWNHPBw (button) collected ($3.35)
Seat 4: ZA1bp6g8IwtTxkUE4eCjDQ (small blind) folded before Flop
Seat 5: UBZQqpnJZdTYYY1FTb0rLA (big blind) folded on the Flop
Seat 6: oxnw0GLLpFanjhGkxfRSqA folded on the Flop



PokerStars Game #59939750378:  Hold'em No Limit ($0.50/$1.00) - 2009/07/01 0:47:59 ET
Table 'fTlPiCj0utgzC/5io+I7ew' 6-max Seat #1 is the button
Seat 1: YMJG+F++3Aj6P8dAWda5fw ($93.50 in chips)
Seat 2: Qy/UBNbD2HaA0Ogxg8Sf3w ($110.95 in chips)
Seat 3: oDiBRCaF0QVtd3kO6xZIXw ($97.75 in chips)
Seat 4: uJVSceLggtsrJya+WtmUEA ($99.50 in chips)
Seat 5: bFrTkDcWGTxyvNul7GVdYg ($252.20 in chips)
Qy/UBNbD2HaA0Ogxg8Sf3w: posts small blind $0.50
oDiBRCaF0QVtd3kO6xZIXw: posts big blind $1
*** HOLE CARDS ***
uJVSceLggtsrJya+WtmUEA: folds
bFrTkDcWGTxyvNul7GVdYg: folds
YMJG+F++3Aj6P8dAWda5fw: folds
Qy/UBNbD2HaA0Ogxg8Sf3w: folds
oDiBRCaF0QVtd3kO6xZIXw collected $1 from pot
*** SUMMARY ***
Total pot $1 | Rake $0
Seat 1: YMJG+F++3Aj6P8dAWda5fw (button) folded before Flop (didn't bet)
Seat 2: Qy/UBNbD2HaA0Ogxg8Sf3w (small blind) folded before Flop
Seat 3: oDiBRCaF0QVtd3kO6xZIXw (big blind) collected ($1)
Seat 4: uJVSceLggtsrJya+WtmUEA folded before Flop (didn't bet)
Seat 5: bFrTkDcWGTxyvNul7GVdYg folded before Flop (didn't bet)



PokerStars Game #59939750754:  Hold'em No Limit ($0.50/$1.00) - 2009/07/01 0:47:59 ET
Table 'U9zqzC8f3oTJ2ShXFgSSOA' 6-max Seat #6 is the button
Seat 2: JwCcjZl0bjJzG7hmE0dnTA ($100 in chips)
Seat 3: yfXek8iJ7O4CFyqXrtGcfg ($14.55 in chips)
Seat 4: 33q95we0Etwgrm6guQGncw ($95.35 in chips)
Seat 5: KfwW5us6tydK81NYTtK1gw ($289.75 in chips)
Seat 6: aIxzFKdtpDSkUePKZy/niQ ($22.05 in chips)
iHo1oDbrEVJ8nEGdaPrICw will be allowed to play after the button
JwCcjZl0bjJzG7hmE0dnTA: posts small blind $0.50
yfXek8iJ7O4CFyqXrtGcfg: posts big blind $1
*** HOLE CARDS ***
33q95we0Etwgrm6guQGncw: folds
KfwW5us6tydK81NYTtK1gw: folds
aIxzFKdtpDSkUePKZy/niQ: raises $2 to $3
JwCcjZl0bjJzG7hmE0dnTA: raises $8 to $11
yfXek8iJ7O4CFyqXrtGcfg: folds
aIxzFKdtpDSkUePKZy/niQ: raises $11.05 to $22.05 and is all-in
JwCcjZl0bjJzG7hmE0dnTA: calls $11.05
*** FLOP *** [8h 2c 2s]
*** TURN *** [8h 2c 2s] [9d]
*** RIVER *** [8h 2c 2s 9d] [3s]
*** SHOW DOWN ***
JwCcjZl0bjJzG7hmE0dnTA: shows [8c 8d] (a full house, Eights full of Deuces)
aIxzFKdtpDSkUePKZy/niQ: mucks hand
JwCcjZl0bjJzG7hmE0dnTA collected $43.10 from pot
*** SUMMARY ***
Total pot $45.10 | Rake $2
Board [8h 2c 2s 9d 3s]
Seat 2: JwCcjZl0bjJzG7hmE0dnTA (small blind) showed [8c 8d] and won ($43.10) with a full house, Eights full of Deuces
Seat 3: yfXek8iJ7O4CFyqXrtGcfg (big blind) folded before Flop
Seat 4: 33q95we0Etwgrm6guQGncw folded before Flop (didn't bet)
Seat 5: KfwW5us6tydK81NYTtK1gw folded before Flop (didn't bet)
Seat 6: aIxzFKdtpDSkUePKZy/niQ (button) mucked



PokerStars Game #59939751924:  Hold'em No Limit ($0.50/$1.00) - 2009/07/01 0:48:00 ET
Table 'GxCPo/gd3OSthkYrAxJngg' 6-max Seat #6 is the button
Seat 1: sH8BpAFP+jGFxCgVpD1Lew ($260.35 in chips)
Seat 2: YExX2paeIHrmfIwV1ivM/w ($78.20 in chips)
Seat 3: o6plE+MSW4XFNTeONe16xg ($31.10 in chips)
Seat 4: YMJG+F++3Aj6P8dAWda5fw ($105.15 in chips)
Seat 5: G5ZSSN6RSON3gkNvk/SmYg ($108.25 in chips)
Seat 6: sS9IXedL3MiRmpVXhAILhw ($101.95 in chips)
sH8BpAFP+jGFxCgVpD1Lew: posts small blind $0.50
YExX2paeIHrmfIwV1ivM/w: posts big blind $1
*** HOLE CARDS ***
o6plE+MSW4XFNTeONe16xg: folds
YMJG+F++3Aj6P8dAWda5fw: folds
G5ZSSN6RSON3gkNvk/SmYg: folds
sS9IXedL3MiRmpVXhAILhw: raises $3 to $4
sH8BpAFP+jGFxCgVpD1Lew: folds
YExX2paeIHrmfIwV1ivM/w: folds
sS9IXedL3MiRmpVXhAILhw collected $2.50 from pot
*** SUMMARY ***
Total pot $2.50 | Rake $0
Seat 1: sH8BpAFP+jGFxCgVpD1Lew (small blind) folded before Flop
Seat 2: YExX2paeIHrmfIwV1ivM/w (big blind) folded before Flop
Seat 3: o6plE+MSW4XFNTeONe16xg folded before Flop (didn't bet)
Seat 4: YMJG+F++3Aj6P8dAWda5fw folded before Flop (didn't bet)
Seat 5: G5ZSSN6RSON3gkNvk/SmYg folded before Flop (didn't bet)
Seat 6: sS9IXedL3MiRmpVXhAILhw (button) collected ($2.50)



PokerStars Game #59939751860:  Hold'em No Limit ($0.50/$1.00) - 2009/07/01 0:48:00 ET
Table 'LmXQK9xy3awB+qsPzI21Mw' 2-max Seat #1 is the button
Seat 1: NYi6JFscYNrofSXy4sM+Yw ($233.55 in chips)
Seat 2: TME8GvochpQAo8cmJwWmvA ($98.40 in chips)
NYi6JFscYNrofSXy4sM+Yw: posts small blind $0.50
TME8GvochpQAo8cmJwWmvA: posts big blind $1
*** HOLE CARDS ***
NYi6JFscYNrofSXy4sM+Yw: raises $2 to $3
TME8GvochpQAo8cmJwWmvA: calls $2
*** FLOP *** [4c 9c Kh]
TME8GvochpQAo8cmJwWmvA: checks
NYi6JFscYNrofSXy4sM+Yw: bets $2
TME8GvochpQAo8cmJwWmvA: raises $2 to $4
NYi6JFscYNrofSXy4sM+Yw: raises $11 to $15
TME8GvochpQAo8cmJwWmvA: calls $11
*** TURN *** [4c 9c Kh] [2s]
TME8GvochpQAo8cmJwWmvA: checks
NYi6JFscYNrofSXy4sM+Yw: checks
*** RIVER *** [4c 9c Kh 2s] [7d]
TME8GvochpQAo8cmJwWmvA: bets $7
NYi6JFscYNrofSXy4sM+Yw: calls $7
*** SHOW DOWN ***
TME8GvochpQAo8cmJwWmvA: shows [Js Kd] (a pair of Kings)
NYi6JFscYNrofSXy4sM+Yw: mucks hand
TME8GvochpQAo8cmJwWmvA collected $49.50 from pot
*** SUMMARY ***
Total pot $50 | Rake $0.50
Board [4c 9c Kh 2s 7d]
Seat 1: NYi6JFscYNrofSXy4sM+Yw (button) (small blind) mucked
Seat 2: TME8GvochpQAo8cmJwWmvA (big blind) showed [Js Kd] and won ($49.50) with a pair of Kings



PokerStars Game #59939756110:  Hold'em No Limit ($0.50/$1.00) - 2009/07/01 0:48:07 ET
Table '7O9fB8yx1u7sJveJn8w6jA' 6-max Seat #1 is the button
Seat 1: jy52+7FotjH63o5tEEVgKw ($160.35 in chips)
Seat 2: wx3sQGkVi2x9wJXuWNHPBw ($193 in chips)
Seat 3: hpxXcmRkXXI9HE5+5/j/0Q ($101.50 in chips)
Seat 4: XIZSmlGttGgSRaIU42K4Fg ($80.10 in chips)
Seat 5: BCEV3COoKY607AzLWayfRA ($100 in chips)
Seat 6: UBZQqpnJZdTYYY1FTb0rLA ($131.50 in chips)
wx3sQGkVi2x9wJXuWNHPBw: posts small blind $0.50
hpxXcmRkXXI9HE5+5/j/0Q: posts big blind $1
*** HOLE CARDS ***
XIZSmlGttGgSRaIU42K4Fg: calls $1
BCEV3COoKY607AzLWayfRA: folds
UBZQqpnJZdTYYY1FTb0rLA: raises $4 to $5
jy52+7FotjH63o5tEEVgKw: folds
wx3sQGkVi2x9wJXuWNHPBw: folds
hpxXcmRkXXI9HE5+5/j/0Q: folds
XIZSmlGttGgSRaIU42K4Fg: calls $4
*** FLOP *** [Qc Qh 5c]
XIZSmlGttGgSRaIU42K4Fg: checks
UBZQqpnJZdTYYY1FTb0rLA: bets $6
XIZSmlGttGgSRaIU42K4Fg: folds
UBZQqpnJZdTYYY1FTb0rLA collected $10.95 from pot
UBZQqpnJZdTYYY1FTb0rLA: doesn't show hand
*** SUMMARY ***
Total pot $11.50 | Rake $0.55
Board [Qc Qh 5c]
Seat 1: jy52+7FotjH63o5tEEVgKw (button) folded before Flop (didn't bet)
Seat 2: wx3sQGkVi2x9wJXuWNHPBw (small blind) folded before Flop
Seat 3: hpxXcmRkXXI9HE5+5/j/0Q (big blind) folded before Flop
Seat 4: XIZSmlGttGgSRaIU42K4Fg folded on the Flop
Seat 5: BCEV3COoKY607AzLWayfRA folded before Flop (didn't bet)
Seat 6: UBZQqpnJZdTYYY1FTb0rLA collected ($10.95)



PokerStars Game #59939755898:  Hold'em No Limit ($0.50/$1.00) - 2009/07/01 0:48:07 ET
Table 'cBDNutyLBKEk9+ptwsKmTw' 6-max Seat #4 is the button
Seat 1: xAU6q2/cwmby2sxmA8VcmA ($100 in chips)
Seat 2: 5lY8d6Cnm4HUkt/8FZSj4g ($100.80 in chips)
Seat 3: G5ZSSN6RSON3gkNvk/SmYg ($106.90 in chips)
Seat 4: 3q7F5QtzC30pSrn0nl9i+A ($35.20 in chips)
Seat 5: OGMLOcTNYZXZU81au7ztUw ($143.05 in chips)
Seat 6: NqVlOSH2lp+pp/TK3vvK5g ($51.50 in chips)
OGMLOcTNYZXZU81au7ztUw: posts small blind $0.50
NqVlOSH2lp+pp/TK3vvK5g: posts big blind $1
*** HOLE CARDS ***
xAU6q2/cwmby2sxmA8VcmA: folds
5lY8d6Cnm4HUkt/8FZSj4g: calls $1
G5ZSSN6RSON3gkNvk/SmYg: raises $4 to $5
3q7F5QtzC30pSrn0nl9i+A: folds
OGMLOcTNYZXZU81au7ztUw: folds
NqVlOSH2lp+pp/TK3vvK5g: calls $4
5lY8d6Cnm4HUkt/8FZSj4g: calls $4
*** FLOP *** [4c 7c Jc]
NqVlOSH2lp+pp/TK3vvK5g: checks
5lY8d6Cnm4HUkt/8FZSj4g: checks
G5ZSSN6RSON3gkNvk/SmYg: bets $8
NqVlOSH2lp+pp/TK3vvK5g: folds
5lY8d6Cnm4HUkt/8FZSj4g: folds
G5ZSSN6RSON3gkNvk/SmYg collected $14.75 from pot
G5ZSSN6RSON3gkNvk/SmYg: doesn't show hand
*** SUMMARY ***
Total pot $15.50 | Rake $0.75
Board [4c 7c Jc]
Seat 1: xAU6q2/cwmby2sxmA8VcmA folded before Flop (didn't bet)
Seat 2: 5lY8d6Cnm4HUkt/8FZSj4g folded on the Flop
Seat 3: G5ZSSN6RSON3gkNvk/SmYg collected ($14.75)
Seat 4: 3q7F5QtzC30pSrn0nl9i+A (button) folded before Flop (didn't bet)
Seat 5: OGMLOcTNYZXZU81au7ztUw (small blind) folded before Flop
Seat 6: NqVlOSH2lp+pp/TK3vvK5g (big blind) folded on the Flop



PokerStars Game #59939759980:  Hold'em No Limit ($0.50/$1.00) - 2009/07/01 0:48:13 ET
Table 'W/wyObTiXZm+Ckkl3YxcSw' 6-max Seat #1 is the button
Seat 1: eUBBn2R56C1IQ6Cs/vitwg ($112.25 in chips)
Seat 2: oDiBRCaF0QVtd3kO6xZIXw ($77.75 in chips)
Seat 3: ybGsYWp1MLwy1vSnP8egXg ($30 in chips)
Seat 4: +xW7QemQU0Fxs+4TnqBRow ($133.90 in chips)
Seat 5: BdbmJTZZ47quA9vUWwXtlw ($55.35 in chips)
Seat 6: tS9JHB1h+FQ++qu8RwRNgg ($27 in chips)
oDiBRCaF0QVtd3kO6xZIXw: posts small blind $0.50
ybGsYWp1MLwy1vSnP8egXg: posts big blind $1
*** HOLE CARDS ***
+xW7QemQU0Fxs+4TnqBRow: raises $3 to $4
BdbmJTZZ47quA9vUWwXtlw: folds
tS9JHB1h+FQ++qu8RwRNgg: folds
eUBBn2R56C1IQ6Cs/vitwg: folds
oDiBRCaF0QVtd3kO6xZIXw: calls $3.50
ybGsYWp1MLwy1vSnP8egXg: folds
*** FLOP *** [5c 8c Kh]
oDiBRCaF0QVtd3kO6xZIXw: bets $6
+xW7QemQU0Fxs+4TnqBRow: calls $6
*** TURN *** [5c 8c Kh] [3d]
oDiBRCaF0QVtd3kO6xZIXw: bets $13
+xW7QemQU0Fxs+4TnqBRow: calls $13
*** RIVER *** [5c 8c Kh 3d] [Qd]
oDiBRCaF0QVtd3kO6xZIXw: bets $22
+xW7QemQU0Fxs+4TnqBRow: folds
oDiBRCaF0QVtd3kO6xZIXw collected $44.70 from pot
oDiBRCaF0QVtd3kO6xZIXw: doesn't show hand
*** SUMMARY ***
Total pot $47 | Rake $2.30
Board [5c 8c Kh 3d Qd]
Seat 1: eUBBn2R56C1IQ6Cs/vitwg (button) folded before Flop (didn't bet)
Seat 2: oDiBRCaF0QVtd3kO6xZIXw (small blind) collected ($44.70)
Seat 3: ybGsYWp1MLwy1vSnP8egXg (big blind) folded before Flop
Seat 4: +xW7QemQU0Fxs+4TnqBRow folded on the River
Seat 5: BdbmJTZZ47quA9vUWwXtlw folded before Flop (didn't bet)
Seat 6: tS9JHB1h+FQ++qu8RwRNgg folded before Flop (didn't bet)



PokerStars Game #59939762610:  Hold'em No Limit ($0.50/$1.00) - 2009/07/01 0:48:17 ET
Table 'CxlB0XELs5P0zDlOhlhAPw' 2-max Seat #2 is the button
Seat 1: +B2wRsLpIMFnVA7qiRoGfg ($43.40 in chips)
Seat 2: I4xAjioR1QwQ5TgX4Z1/qw ($37.20 in chips)
I4xAjioR1QwQ5TgX4Z1/qw: posts small blind $0.50
+B2wRsLpIMFnVA7qiRoGfg: posts big blind $1
*** HOLE CARDS ***
I4xAjioR1QwQ5TgX4Z1/qw: raises $2 to $3
+B2wRsLpIMFnVA7qiRoGfg: calls $2
*** FLOP *** [Kd Qh Js]
+B2wRsLpIMFnVA7qiRoGfg: checks
I4xAjioR1QwQ5TgX4Z1/qw: bets $3
+B2wRsLpIMFnVA7qiRoGfg: calls $3
*** TURN *** [Kd Qh Js] [7c]
+B2wRsLpIMFnVA7qiRoGfg: checks
I4xAjioR1QwQ5TgX4Z1/qw: bets $6
+B2wRsLpIMFnVA7qiRoGfg: calls $6
*** RIVER *** [Kd Qh Js 7c] [Ah]
+B2wRsLpIMFnVA7qiRoGfg: bets $9
I4xAjioR1QwQ5TgX4Z1/qw: raises $16.20 to $25.20 and is all-in
+B2wRsLpIMFnVA7qiRoGfg: folds
I4xAjioR1QwQ5TgX4Z1/qw collected $41.50 from pot
*** SUMMARY ***
Total pot $42 | Rake $0.50
Board [Kd Qh Js 7c Ah]
Seat 1: +B2wRsLpIMFnVA7qiRoGfg (big blind) folded on the River
Seat 2: I4xAjioR1QwQ5TgX4Z1/qw (button) (small blind) collected ($41.50)



PokerStars Game #59939763160:  Hold'em No Limit ($0.50/$1.00) - 2009/07/01 0:48:18 ET
Table 'rmZfTK+oSebeUPJNbWhdAA' 6-max Seat #4 is the button
Seat 1: xAU6q2/cwmby2sxmA8VcmA ($100 in chips)
Seat 2: z7O9PO/WEcqRouIydFhS9Q ($110.30 in chips)
Seat 3: 9yjOzGERLaEZS8CZ6YNHFg ($114.35 in chips)
Seat 4: 1/mIuXfgx1ZyVkodrmfQDw ($100 in chips)
Seat 5: 5lY8d6Cnm4HUkt/8FZSj4g ($80.95 in chips)
Seat 6: j7NIOHLZk7V2o9fOioO5ug ($136.80 in chips)
5lY8d6Cnm4HUkt/8FZSj4g: posts small blind $0.50
j7NIOHLZk7V2o9fOioO5ug: posts big blind $1
*** HOLE CARDS ***
xAU6q2/cwmby2sxmA8VcmA: folds
z7O9PO/WEcqRouIydFhS9Q: raises $2 to $3
9yjOzGERLaEZS8CZ6YNHFg: folds
1/mIuXfgx1ZyVkodrmfQDw: calls $3
5lY8d6Cnm4HUkt/8FZSj4g: folds
j7NIOHLZk7V2o9fOioO5ug: folds
*** FLOP *** [Ac 7c 7d]
z7O9PO/WEcqRouIydFhS9Q: checks
1/mIuXfgx1ZyVkodrmfQDw: checks
*** TURN *** [Ac 7c 7d] [Qh]
z7O9PO/WEcqRouIydFhS9Q: checks
1/mIuXfgx1ZyVkodrmfQDw: checks
*** RIVER *** [Ac 7c 7d Qh] [Jh]
z7O9PO/WEcqRouIydFhS9Q: checks
1/mIuXfgx1ZyVkodrmfQDw: checks
*** SHOW DOWN ***
z7O9PO/WEcqRouIydFhS9Q: shows [Ad 5d] (two pair, Aces and Sevens)
1/mIuXfgx1ZyVkodrmfQDw: mucks hand
z7O9PO/WEcqRouIydFhS9Q collected $7.15 from pot
*** SUMMARY ***
Total pot $7.50 | Rake $0.35
Board [Ac 7c 7d Qh Jh]
Seat 1: xAU6q2/cwmby2sxmA8VcmA folded before Flop (didn't bet)
Seat 2: z7O9PO/WEcqRouIydFhS9Q showed [Ad 5d] and won ($7.15) with two pair, Aces and Sevens
Seat 3: 9yjOzGERLaEZS8CZ6YNHFg folded before Flop (didn't bet)
Seat 4: 1/mIuXfgx1ZyVkodrmfQDw (button) mucked
Seat 5: 5lY8d6Cnm4HUkt/8FZSj4g (small blind) folded before Flop
Seat 6: j7NIOHLZk7V2o9fOioO5ug (big blind) folded before Flop



PokerStars Game #59939764494:  Hold'em No Limit ($0.50/$1.00) - 2009/07/01 0:48:20 ET
Table 'uNlePsyMIqzM691Xkrlk6Q' 9-max Seat #2 is the button
Seat 1: bLbSOSmSOnqE0iTcH/5dxA ($100 in chips)
Seat 2: +OqpStnt0FqbCfyHAWaLbg ($79.05 in chips)
Seat 3: h7qXkU57Bb8ZuPwMyxR8Ug ($33.35 in chips)
Seat 4: TZcz9MEWDA+WydgGruqqbw ($102.65 in chips)
Seat 5: 3obndzTJ6fECz8+wWhMd1w ($18.50 in chips)
Seat 7: w6cw9nzN7AvkkHBVVjykoQ ($45.90 in chips)
Seat 8: laA8va+Yv8WuMqT1zdR91g ($100 in chips)
Seat 9: vR4IO10geOgvTW+LAUBv/A ($100.75 in chips)
h7qXkU57Bb8ZuPwMyxR8Ug: posts small blind $0.50
TZcz9MEWDA+WydgGruqqbw: posts big blind $1
myIxN7otsyr846M539YR8Q: sits out
*** HOLE CARDS ***
3obndzTJ6fECz8+wWhMd1w: folds
w6cw9nzN7AvkkHBVVjykoQ: folds
laA8va+Yv8WuMqT1zdR91g: raises $3 to $4
vR4IO10geOgvTW+LAUBv/A: folds
bLbSOSmSOnqE0iTcH/5dxA: folds
+OqpStnt0FqbCfyHAWaLbg: calls $4
h7qXkU57Bb8ZuPwMyxR8Ug: folds
TZcz9MEWDA+WydgGruqqbw: folds
*** FLOP *** [2d Th 8s]
laA8va+Yv8WuMqT1zdR91g: checks
+OqpStnt0FqbCfyHAWaLbg: bets $5
laA8va+Yv8WuMqT1zdR91g: calls $5
*** TURN *** [2d Th 8s] [6d]
laA8va+Yv8WuMqT1zdR91g: checks
+OqpStnt0FqbCfyHAWaLbg: bets $7
laA8va+Yv8WuMqT1zdR91g: folds
+OqpStnt0FqbCfyHAWaLbg collected $18.55 from pot
*** SUMMARY ***
Total pot $19.50 | Rake $0.95
Board [2d Th 8s 6d]
Seat 1: bLbSOSmSOnqE0iTcH/5dxA folded before Flop (didn't bet)
Seat 2: +OqpStnt0FqbCfyHAWaLbg (button) collected ($18.55)
Seat 3: h7qXkU57Bb8ZuPwMyxR8Ug (small blind) folded before Flop
Seat 4: TZcz9MEWDA+WydgGruqqbw (big blind) folded before Flop
Seat 5: 3obndzTJ6fECz8+wWhMd1w folded before Flop (didn't bet)
Seat 7: w6cw9nzN7AvkkHBVVjykoQ folded before Flop (didn't bet)
Seat 8: laA8va+Yv8WuMqT1zdR91g folded on the Turn
Seat 9: vR4IO10geOgvTW+LAUBv/A folded before Flop (didn't bet)



PokerStars Game #59939767824:  Hold'em No Limit ($0.50/$1.00) - 2009/07/01 0:48:25 ET
Table 'Zka9tv1yilg0MvXWPQrShg' 9-max Seat #8 is the button
Seat 1: TZcz9MEWDA+WydgGruqqbw ($113.85 in chips)
Seat 3: gUUvmqdVlmvpal6B8nYrmg ($100 in chips)
Seat 4: stxmTgSicxShtrDxhOOX2g ($69.25 in chips)
Seat 5: /zy+DB4S5fUQUSfZWFzYGw ($124.90 in chips)
Seat 6: rY8wPoax1lS+HUY+I0FZDw ($141.80 in chips)
Seat 7: p1SafS90nb3Uft5LB0NkHw ($17.50 in chips)
Seat 8: bL+QVeDcuEdzMGAGg2XJHg ($122.10 in chips)
Seat 9: 6daxhj43mWj04MOPTOmaYA ($94.65 in chips)
6daxhj43mWj04MOPTOmaYA: posts small blind $0.50
TZcz9MEWDA+WydgGruqqbw: posts big blind $1
kz9ziSiGUc+857heiKSayw: sits out
*** HOLE CARDS ***
gUUvmqdVlmvpal6B8nYrmg: raises $1 to $2
stxmTgSicxShtrDxhOOX2g: folds
/zy+DB4S5fUQUSfZWFzYGw: folds
rY8wPoax1lS+HUY+I0FZDw: calls $2
p1SafS90nb3Uft5LB0NkHw: folds
bL+QVeDcuEdzMGAGg2XJHg: folds
6daxhj43mWj04MOPTOmaYA: calls $1.50
TZcz9MEWDA+WydgGruqqbw: folds
*** FLOP *** [9c 9s 3d]
6daxhj43mWj04MOPTOmaYA: checks
gUUvmqdVlmvpal6B8nYrmg: checks
rY8wPoax1lS+HUY+I0FZDw: bets $3
6daxhj43mWj04MOPTOmaYA: folds
gUUvmqdVlmvpal6B8nYrmg: folds
rY8wPoax1lS+HUY+I0FZDw collected $6.65 from pot
rY8wPoax1lS+HUY+I0FZDw: doesn't show hand
*** SUMMARY ***
Total pot $7 | Rake $0.35
Board [9c 9s 3d]
Seat 1: TZcz9MEWDA+WydgGruqqbw (big blind) folded before Flop
Seat 3: gUUvmqdVlmvpal6B8nYrmg folded on the Flop
Seat 4: stxmTgSicxShtrDxhOOX2g folded before Flop (didn't bet)
Seat 5: /zy+DB4S5fUQUSfZWFzYGw folded before Flop (didn't bet)
Seat 6: rY8wPoax1lS+HUY+I0FZDw collected ($6.65)
Seat 7: p1SafS90nb3Uft5LB0NkHw folded before Flop (didn't bet)
Seat 8: bL+QVeDcuEdzMGAGg2XJHg (button) folded before Flop (didn't bet)
Seat 9: 6daxhj43mWj04MOPTOmaYA (small blind) folded on the Flop



PokerStars Game #59939767940:  Hold'em No Limit ($0.50/$1.00) - 2009/07/01 0:48:26 ET
Table 'fTlPiCj0utgzC/5io+I7ew' 6-max Seat #2 is the button
Seat 1: YMJG+F++3Aj6P8dAWda5fw ($93.50 in chips)
Seat 2: Qy/UBNbD2HaA0Ogxg8Sf3w ($110.45 in chips)
Seat 3: oDiBRCaF0QVtd3kO6xZIXw ($98.25 in chips)
Seat 4: uJVSceLggtsrJya+WtmUEA ($99.50 in chips)
Seat 5: bFrTkDcWGTxyvNul7GVdYg ($252.20 in chips)
oDiBRCaF0QVtd3kO6xZIXw: posts small blind $0.50
uJVSceLggtsrJya+WtmUEA: posts big blind $1
*** HOLE CARDS ***
bFrTkDcWGTxyvNul7GVdYg: folds
YMJG+F++3Aj6P8dAWda5fw: folds
Qy/UBNbD2HaA0Ogxg8Sf3w: folds
oDiBRCaF0QVtd3kO6xZIXw: calls $0.50
uJVSceLggtsrJya+WtmUEA: checks
*** FLOP *** [7h 2d 4s]
oDiBRCaF0QVtd3kO6xZIXw: bets $1
uJVSceLggtsrJya+WtmUEA: raises $3 to $4
oDiBRCaF0QVtd3kO6xZIXw: calls $3
*** TURN *** [7h 2d 4s] [5s]
/P4w1pHg2zHYg/4ubJ0dPw joins the table at seat #6
oDiBRCaF0QVtd3kO6xZIXw: bets $6
uJVSceLggtsrJya+WtmUEA: calls $6
*** RIVER *** [7h 2d 4s 5s] [Ac]
oDiBRCaF0QVtd3kO6xZIXw: checks
uJVSceLggtsrJya+WtmUEA: bets $15
oDiBRCaF0QVtd3kO6xZIXw: calls $15
*** SHOW DOWN ***
uJVSceLggtsrJya+WtmUEA: shows [3h 5d] (a straight, Ace to Five)
oDiBRCaF0QVtd3kO6xZIXw: mucks hand
uJVSceLggtsrJya+WtmUEA collected $50 from pot
*** SUMMARY ***
Total pot $52 | Rake $2
Board [7h 2d 4s 5s Ac]
Seat 1: YMJG+F++3Aj6P8dAWda5fw folded before Flop (didn't bet)
Seat 2: Qy/UBNbD2HaA0Ogxg8Sf3w (button) folded before Flop (didn't bet)
Seat 3: oDiBRCaF0QVtd3kO6xZIXw (small blind) mucked
Seat 4: uJVSceLggtsrJya+WtmUEA (big blind) showed [3h 5d] and won ($50) with a straight, Ace to Five
Seat 5: bFrTkDcWGTxyvNul7GVdYg folded before Flop (didn't bet)



PokerStars Game #59939769186:  Hold'em No Limit ($0.50/$1.00) - 2009/07/01 0:48:28 ET
Table 'eU3bWpDDg3Z+9R4m4iVmog' 6-max Seat #1 is the button
Seat 1: TSuRyAHnUPCFjP7Z0rEE0w ($189.65 in chips)
Seat 2: 8CAoOzhmB8n3nRFf3V4BTg ($93.80 in chips)
Seat 3: U6tnjwZRpTnM+YkqkCjwyQ ($188.65 in chips)
Seat 4: GDVIsbEJ/DOJsMKE4Asz0A ($68.30 in chips)
Seat 5: AdLVjddOzm+sRNo1Bc3S6Q ($114.05 in chips)
Seat 6: hpxXcmRkXXI9HE5+5/j/0Q ($121.95 in chips)
8CAoOzhmB8n3nRFf3V4BTg: posts small blind $0.50
U6tnjwZRpTnM+YkqkCjwyQ: posts big blind $1
*** HOLE CARDS ***
GDVIsbEJ/DOJsMKE4Asz0A: folds
AdLVjddOzm+sRNo1Bc3S6Q: folds
hpxXcmRkXXI9HE5+5/j/0Q: folds
TSuRyAHnUPCFjP7Z0rEE0w: raises $3 to $4
8CAoOzhmB8n3nRFf3V4BTg: folds
U6tnjwZRpTnM+YkqkCjwyQ: folds
TSuRyAHnUPCFjP7Z0rEE0w collected $2.50 from pot
TSuRyAHnUPCFjP7Z0rEE0w: doesn't show hand
*** SUMMARY ***
Total pot $2.50 | Rake $0
Seat 1: TSuRyAHnUPCFjP7Z0rEE0w (button) collected ($2.50)
Seat 2: 8CAoOzhmB8n3nRFf3V4BTg (small blind) folded before Flop
Seat 3: U6tnjwZRpTnM+YkqkCjwyQ (big blind) folded before Flop
Seat 4: GDVIsbEJ/DOJsMKE4Asz0A folded before Flop (didn't bet)
Seat 5: AdLVjddOzm+sRNo1Bc3S6Q folded before Flop (didn't bet)
Seat 6: hpxXcmRkXXI9HE5+5/j/0Q folded before Flop (didn't bet)



PokerStars Game #59939770198:  Hold'em No Limit ($0.50/$1.00) - 2009/07/01 0:48:29 ET
Table 'VOs36P6NW+QyXeQ1B62kmA' 6-max Seat #6 is the button
Seat 1: AdLVjddOzm+sRNo1Bc3S6Q ($136.80 in chips)
Seat 2: KpnW5CcJ4Mg6MeclfKmLrw ($119.35 in chips)
Seat 3: TSuRyAHnUPCFjP7Z0rEE0w ($100 in chips)
Seat 4: w02zQzNydODiyV9THKgo9w ($29.30 in chips)
Seat 5: ozrlafxxh1HmYdA0/h+MuA ($20 in chips)
Seat 6: 6tvjsJrdmWg+g7FVrMnzXA ($89 in chips)
AdLVjddOzm+sRNo1Bc3S6Q: posts small blind $0.50
KpnW5CcJ4Mg6MeclfKmLrw: posts big blind $1
ozrlafxxh1HmYdA0/h+MuA: posts big blind $1
*** HOLE CARDS ***
TSuRyAHnUPCFjP7Z0rEE0w: folds
w02zQzNydODiyV9THKgo9w: folds
ozrlafxxh1HmYdA0/h+MuA: checks
6tvjsJrdmWg+g7FVrMnzXA: calls $1
AdLVjddOzm+sRNo1Bc3S6Q: raises $5 to $6
KpnW5CcJ4Mg6MeclfKmLrw: folds
ozrlafxxh1HmYdA0/h+MuA: calls $5
6tvjsJrdmWg+g7FVrMnzXA: folds
*** FLOP *** [Jc 8h 6d]
AdLVjddOzm+sRNo1Bc3S6Q: checks
ozrlafxxh1HmYdA0/h+MuA: checks
*** TURN *** [Jc 8h 6d] [7c]
AdLVjddOzm+sRNo1Bc3S6Q: checks
ozrlafxxh1HmYdA0/h+MuA: checks
*** RIVER *** [Jc 8h 6d 7c] [8c]
AdLVjddOzm+sRNo1Bc3S6Q: checks
ozrlafxxh1HmYdA0/h+MuA: checks
*** SHOW DOWN ***
AdLVjddOzm+sRNo1Bc3S6Q: shows [Qc Kd] (a pair of Eights)
ozrlafxxh1HmYdA0/h+MuA: shows [Ts Ad] (a pair of Eights - Ace kicker)
ozrlafxxh1HmYdA0/h+MuA collected $13.30 from pot
*** SUMMARY ***
Total pot $14 | Rake $0.70
Board [Jc 8h 6d 7c 8c]
Seat 1: AdLVjddOzm+sRNo1Bc3S6Q (small blind) showed [Qc Kd] and lost with a pair of Eights
Seat 2: KpnW5CcJ4Mg6MeclfKmLrw (big blind) folded before Flop
Seat 3: TSuRyAHnUPCFjP7Z0rEE0w folded before Flop (didn't bet)
Seat 4: w02zQzNydODiyV9THKgo9w folded before Flop (didn't bet)
Seat 5: ozrlafxxh1HmYdA0/h+MuA showed [Ts Ad] and won ($13.30) with a pair of Eights
Seat 6: 6tvjsJrdmWg+g7FVrMnzXA (button) folded before Flop



PokerStars Game #59939770830:  Hold'em No Limit ($0.50/$1.00) - 2009/07/01 0:48:30 ET
Table 'LmXQK9xy3awB+qsPzI21Mw' 2-max Seat #2 is the button
Seat 1: NYi6JFscYNrofSXy4sM+Yw ($208.55 in chips)
Seat 2: TME8GvochpQAo8cmJwWmvA ($122.90 in chips)
TME8GvochpQAo8cmJwWmvA: posts small blind $0.50
NYi6JFscYNrofSXy4sM+Yw: posts big blind $1
*** HOLE CARDS ***
TME8GvochpQAo8cmJwWmvA: calls $0.50
NYi6JFscYNrofSXy4sM+Yw: checks
*** FLOP *** [3d Jd Qc]
NYi6JFscYNrofSXy4sM+Yw: bets $2
TME8GvochpQAo8cmJwWmvA: calls $2
*** TURN *** [3d Jd Qc] [Kh]
NYi6JFscYNrofSXy4sM+Yw: checks
TME8GvochpQAo8cmJwWmvA: checks
*** RIVER *** [3d Jd Qc Kh] [6s]
NYi6JFscYNrofSXy4sM+Yw: checks
TME8GvochpQAo8cmJwWmvA: bets $3
NYi6JFscYNrofSXy4sM+Yw: folds
TME8GvochpQAo8cmJwWmvA collected $5.75 from pot
TME8GvochpQAo8cmJwWmvA: doesn't show hand
*** SUMMARY ***
Total pot $6 | Rake $0.25
Board [3d Jd Qc Kh 6s]
Seat 1: NYi6JFscYNrofSXy4sM+Yw (big blind) folded on the River
Seat 2: TME8GvochpQAo8cmJwWmvA (button) (small blind) collected ($5.75)



PokerStars Game #59939770656:  Hold'em No Limit ($0.50/$1.00) - 2009/07/01 0:48:30 ET
Table 'vs/5jr6ciwjVQ5+Soc+u2A' 6-max Seat #3 is the button
Seat 2: XOIf9W+VAxhZqN+SYoyMKA ($126.85 in chips)
Seat 3: G5ZSSN6RSON3gkNvk/SmYg ($150 in chips)
Seat 4: KpnW5CcJ4Mg6MeclfKmLrw ($128 in chips)
Seat 5: 2DwLxMUbmzvwY7o4/i47Xg ($39 in chips)
Seat 6: qAdBJlVNsNTwiHia50eMvg ($78.50 in chips)
KpnW5CcJ4Mg6MeclfKmLrw: posts small blind $0.50
2DwLxMUbmzvwY7o4/i47Xg: posts big blind $1
*** HOLE CARDS ***
qAdBJlVNsNTwiHia50eMvg has timed out
qAdBJlVNsNTwiHia50eMvg: folds
qAdBJlVNsNTwiHia50eMvg is sitting out
XOIf9W+VAxhZqN+SYoyMKA: folds
/P4w1pHg2zHYg/4ubJ0dPw joins the table at seat #1
G5ZSSN6RSON3gkNvk/SmYg: folds
qAdBJlVNsNTwiHia50eMvg has returned
KpnW5CcJ4Mg6MeclfKmLrw: folds
2DwLxMUbmzvwY7o4/i47Xg collected $1 from pot
2DwLxMUbmzvwY7o4/i47Xg: doesn't show hand
*** SUMMARY ***
Total pot $1 | Rake $0
Seat 2: XOIf9W+VAxhZqN+SYoyMKA folded before Flop (didn't bet)
Seat 3: G5ZSSN6RSON3gkNvk/SmYg (button) folded before Flop (didn't bet)
Seat 4: KpnW5CcJ4Mg6MeclfKmLrw (small blind) folded before Flop
Seat 5: 2DwLxMUbmzvwY7o4/i47Xg (big blind) collected ($1)
Seat 6: qAdBJlVNsNTwiHia50eMvg folded before Flop (didn't bet)



PokerStars Game #59939772522:  Hold'em No Limit ($0.50/$1.00) - 2009/07/01 0:48:33 ET
Table '7Nl0ffnjeK44/vmeexh3MQ' 9-max Seat #9 is the button
Seat 1: s7D3Y+k4Cj4D1cXHv7oj+Q ($91.35 in chips)
Seat 2: OGgaARGdJQT4awWVNQ957w ($100 in chips)
Seat 3: vR4IO10geOgvTW+LAUBv/A ($100 in chips)
Seat 4: bLbSOSmSOnqE0iTcH/5dxA ($100 in chips)
Seat 5: bL+QVeDcuEdzMGAGg2XJHg ($105.05 in chips)
Seat 6: FVs16t7GgfWgQWt4JxsObQ ($27.50 in chips)
Seat 7: 997ViqAtWn1FPjJqcffwcA ($100 in chips)
Seat 8: zanka7aAZkigmZpfopXxxA ($256.35 in chips)
Seat 9: ouwUBGRKnKK9uhn1G4Lf+A ($95 in chips)
s7D3Y+k4Cj4D1cXHv7oj+Q: posts small blind $0.50
OGgaARGdJQT4awWVNQ957w: posts big blind $1
*** HOLE CARDS ***
vR4IO10geOgvTW+LAUBv/A: folds
bLbSOSmSOnqE0iTcH/5dxA: calls $1
bL+QVeDcuEdzMGAGg2XJHg: folds
FVs16t7GgfWgQWt4JxsObQ: calls $1
997ViqAtWn1FPjJqcffwcA: raises $5 to $6
zanka7aAZkigmZpfopXxxA: folds
ouwUBGRKnKK9uhn1G4Lf+A: folds
s7D3Y+k4Cj4D1cXHv7oj+Q: folds
OGgaARGdJQT4awWVNQ957w: folds
bLbSOSmSOnqE0iTcH/5dxA: raises $14 to $20
FVs16t7GgfWgQWt4JxsObQ: folds
997ViqAtWn1FPjJqcffwcA: folds
bLbSOSmSOnqE0iTcH/5dxA collected $14.50 from pot
bLbSOSmSOnqE0iTcH/5dxA: doesn't show hand
*** SUMMARY ***
Total pot $14.50 | Rake $0
Seat 1: s7D3Y+k4Cj4D1cXHv7oj+Q (small blind) folded before Flop
Seat 2: OGgaARGdJQT4awWVNQ957w (big blind) folded before Flop
Seat 3: vR4IO10geOgvTW+LAUBv/A folded before Flop (didn't bet)
Seat 4: bLbSOSmSOnqE0iTcH/5dxA collected ($14.50)
Seat 5: bL+QVeDcuEdzMGAGg2XJHg folded before Flop (didn't bet)
Seat 6: FVs16t7GgfWgQWt4JxsObQ folded before Flop
Seat 7: 997ViqAtWn1FPjJqcffwcA folded before Flop
Seat 8: zanka7aAZkigmZpfopXxxA folded before Flop (didn't bet)
Seat 9: ouwUBGRKnKK9uhn1G4Lf+A (button) folded before Flop (didn't bet)



PokerStars Game #59939773138:  Hold'em No Limit ($0.50/$1.00) - 2009/07/01 0:48:34 ET
Table 'GxCPo/gd3OSthkYrAxJngg' 6-max Seat #1 is the button
Seat 1: sH8BpAFP+jGFxCgVpD1Lew ($259.85 in chips)
Seat 2: YExX2paeIHrmfIwV1ivM/w ($77.20 in chips)
Seat 3: o6plE+MSW4XFNTeONe16xg ($31.10 in chips)
Seat 4: YMJG+F++3Aj6P8dAWda5fw ($105.15 in chips)
Seat 5: G5ZSSN6RSON3gkNvk/SmYg ($108.25 in chips)
Seat 6: sS9IXedL3MiRmpVXhAILhw ($103.45 in chips)
YExX2paeIHrmfIwV1ivM/w: posts small blind $0.50
o6plE+MSW4XFNTeONe16xg: posts big blind $1
*** HOLE CARDS ***
sS9IXedL3MiRmpVXhAILhw said, "bout to leave this weak as nitty table"
YMJG+F++3Aj6P8dAWda5fw: raises $2 to $3
G5ZSSN6RSON3gkNvk/SmYg: folds
sS9IXedL3MiRmpVXhAILhw said, "*weak ***"
sS9IXedL3MiRmpVXhAILhw said, "a ss"
sS9IXedL3MiRmpVXhAILhw: folds
o6plE+MSW4XFNTeONe16xg said, "make a play then"
sH8BpAFP+jGFxCgVpD1Lew: folds
o6plE+MSW4XFNTeONe16xg said, "big shot"
YExX2paeIHrmfIwV1ivM/w: folds
o6plE+MSW4XFNTeONe16xg: folds
YMJG+F++3Aj6P8dAWda5fw collected $2.50 from pot
*** SUMMARY ***
Total pot $2.50 | Rake $0
Seat 1: sH8BpAFP+jGFxCgVpD1Lew (button) folded before Flop (didn't bet)
Seat 2: YExX2paeIHrmfIwV1ivM/w (small blind) folded before Flop
Seat 3: o6plE+MSW4XFNTeONe16xg (big blind) folded before Flop
Seat 4: YMJG+F++3Aj6P8dAWda5fw collected ($2.50)
Seat 5: G5ZSSN6RSON3gkNvk/SmYg folded before Flop (didn't bet)
Seat 6: sS9IXedL3MiRmpVXhAILhw folded before Flop (didn't bet)



PokerStars Game #59939774312:  Hold'em No Limit ($0.50/$1.00) - 2009/07/01 0:48:36 ET
Table 'tJq9SfN1ywY0r03VBlWlwQ' 9-max Seat #1 is the button
Seat 1: wZsU+w9r7G66x93UuvBf1Q ($334.30 in chips)
Seat 2: RqkO8O/Y3qlc3PIuCAHjVg ($74.90 in chips)
Seat 3: FVs16t7GgfWgQWt4JxsObQ ($34.05 in chips)
Seat 4: bLbSOSmSOnqE0iTcH/5dxA ($111.70 in chips)
Seat 5: Ogn4JDV3mp4ZDKO49IFzKA ($19.90 in chips)
Seat 6: gUUvmqdVlmvpal6B8nYrmg ($124.05 in chips)
Seat 7: qVhRZ0PLZ95XRJHWAjXjOQ ($128.20 in chips)
Seat 8: G4DEhsZFmznGNVpy2SEocA ($23.50 in chips)
Seat 9: XE5QF1y74bpHog9JxWJMWQ ($100 in chips)
RqkO8O/Y3qlc3PIuCAHjVg: posts small blind $0.50
FVs16t7GgfWgQWt4JxsObQ: posts big blind $1
*** HOLE CARDS ***
bLbSOSmSOnqE0iTcH/5dxA: folds
Ogn4JDV3mp4ZDKO49IFzKA: folds
gUUvmqdVlmvpal6B8nYrmg: raises $1 to $2
qVhRZ0PLZ95XRJHWAjXjOQ: folds
G4DEhsZFmznGNVpy2SEocA: folds
XE5QF1y74bpHog9JxWJMWQ: folds
wZsU+w9r7G66x93UuvBf1Q: raises $6 to $8
RqkO8O/Y3qlc3PIuCAHjVg: folds
FVs16t7GgfWgQWt4JxsObQ: folds
gUUvmqdVlmvpal6B8nYrmg: folds
wZsU+w9r7G66x93UuvBf1Q collected $5.50 from pot
*** SUMMARY ***
Total pot $5.50 | Rake $0
Seat 1: wZsU+w9r7G66x93UuvBf1Q (button) collected ($5.50)
Seat 2: RqkO8O/Y3qlc3PIuCAHjVg (small blind) folded before Flop
Seat 3: FVs16t7GgfWgQWt4JxsObQ (big blind) folded before Flop
Seat 4: bLbSOSmSOnqE0iTcH/5dxA folded before Flop (didn't bet)
Seat 5: Ogn4JDV3mp4ZDKO49IFzKA folded before Flop (didn't bet)
Seat 6: gUUvmqdVlmvpal6B8nYrmg folded before Flop
Seat 7: qVhRZ0PLZ95XRJHWAjXjOQ folded before Flop (didn't bet)
Seat 8: G4DEhsZFmznGNVpy2SEocA folded before Flop (didn't bet)
Seat 9: XE5QF1y74bpHog9JxWJMWQ folded before Flop (didn't bet)



PokerStars Game #59939774354:  Hold'em No Limit ($0.50/$1.00) - 2009/07/01 0:48:36 ET
Table 'N2bNCDHL96aCQDvZIh+yQQ' 6-max Seat #6 is the button
Seat 1: iHo1oDbrEVJ8nEGdaPrICw ($100.50 in chips)
Seat 2: KpnW5CcJ4Mg6MeclfKmLrw ($161.80 in chips)
Seat 3: Qy/UBNbD2HaA0Ogxg8Sf3w ($159.70 in chips)
Seat 4: uCqEjnxh2/vFBjKYkfTOkw ($175.55 in chips)
Seat 6: TSuRyAHnUPCFjP7Z0rEE0w ($100 in chips)
iHo1oDbrEVJ8nEGdaPrICw: posts small blind $0.50
KpnW5CcJ4Mg6MeclfKmLrw: posts big blind $1
ZIdFTzUiF+cFsap66otbHg: sits out
*** HOLE CARDS ***
Qy/UBNbD2HaA0Ogxg8Sf3w: folds
uCqEjnxh2/vFBjKYkfTOkw: folds
TSuRyAHnUPCFjP7Z0rEE0w: raises $3 to $4
iHo1oDbrEVJ8nEGdaPrICw: raises $9 to $13
KpnW5CcJ4Mg6MeclfKmLrw: folds
TSuRyAHnUPCFjP7Z0rEE0w: folds
iHo1oDbrEVJ8nEGdaPrICw collected $9 from pot
iHo1oDbrEVJ8nEGdaPrICw: doesn't show hand
*** SUMMARY ***
Total pot $9 | Rake $0
Seat 1: iHo1oDbrEVJ8nEGdaPrICw (small blind) collected ($9)
Seat 2: KpnW5CcJ4Mg6MeclfKmLrw (big blind) folded before Flop
Seat 3: Qy/UBNbD2HaA0Ogxg8Sf3w folded before Flop (didn't bet)
Seat 4: uCqEjnxh2/vFBjKYkfTOkw folded before Flop (didn't bet)
Seat 6: TSuRyAHnUPCFjP7Z0rEE0w (button) folded before Flop



PokerStars Game #59939775692:  Hold'em No Limit ($0.50/$1.00) - 2009/07/01 0:48:38 ET
Table 'cKH9c4x6u79IqCdaKKvXrw' 9-max Seat #4 is the button
Seat 1: Pp/KTcXkfZKKUHkjyaLTdg ($17 in chips)
Seat 2: 8S3JMH4TY3whgIlZmMv66w ($58.85 in chips)
Seat 3: 997ViqAtWn1FPjJqcffwcA ($158.60 in chips)
Seat 4: FL3MrLspcF23LYvC4ipBOA ($100 in chips)
Seat 6: Bsd/K5gAcLanYbGiPirRjw ($168.55 in chips)
Seat 7: 1GkkVBhlJ92guE6K5mS5Ig ($49.55 in chips)
Seat 8: 4/8w7g4QE6v0i1tIIf/1HQ ($41.50 in chips)
Seat 9: 6XkTu4ahxzHnvjjc1R8YjQ ($37.65 in chips)
Bsd/K5gAcLanYbGiPirRjw: posts small blind $0.50
1GkkVBhlJ92guE6K5mS5Ig: posts big blind $1
*** HOLE CARDS ***
4/8w7g4QE6v0i1tIIf/1HQ: raises $2 to $3
Jjc7EHWzs4//xUAjJ0UWoA joins the table at seat #5
6XkTu4ahxzHnvjjc1R8YjQ: calls $3
Pp/KTcXkfZKKUHkjyaLTdg: folds
8S3JMH4TY3whgIlZmMv66w: folds
997ViqAtWn1FPjJqcffwcA: folds
FL3MrLspcF23LYvC4ipBOA: folds
Bsd/K5gAcLanYbGiPirRjw: folds
1GkkVBhlJ92guE6K5mS5Ig: folds
*** FLOP *** [7d 2d 4s]
4/8w7g4QE6v0i1tIIf/1HQ: checks
6XkTu4ahxzHnvjjc1R8YjQ: checks
*** TURN *** [7d 2d 4s] [4h]
4/8w7g4QE6v0i1tIIf/1HQ: bets $2
6XkTu4ahxzHnvjjc1R8YjQ: calls $2
*** RIVER *** [7d 2d 4s 4h] [8c]
4/8w7g4QE6v0i1tIIf/1HQ: checks
6XkTu4ahxzHnvjjc1R8YjQ: checks
*** SHOW DOWN ***
4/8w7g4QE6v0i1tIIf/1HQ: shows [Ac Th] (a pair of Fours)
6XkTu4ahxzHnvjjc1R8YjQ: shows [Qc Ah] (a pair of Fours - Ace+Queen kicker)
6XkTu4ahxzHnvjjc1R8YjQ collected $10.95 from pot
*** SUMMARY ***
Total pot $11.50 | Rake $0.55
Board [7d 2d 4s 4h 8c]
Seat 1: Pp/KTcXkfZKKUHkjyaLTdg folded before Flop (didn't bet)
Seat 2: 8S3JMH4TY3whgIlZmMv66w folded before Flop (didn't bet)
Seat 3: 997ViqAtWn1FPjJqcffwcA folded before Flop (didn't bet)
Seat 4: FL3MrLspcF23LYvC4ipBOA (button) folded before Flop (didn't bet)
Seat 6: Bsd/K5gAcLanYbGiPirRjw (small blind) folded before Flop
Seat 7: 1GkkVBhlJ92guE6K5mS5Ig (big blind) folded before Flop
Seat 8: 4/8w7g4QE6v0i1tIIf/1HQ showed [Ac Th] and lost with a pair of Fours
Seat 9: 6XkTu4ahxzHnvjjc1R8YjQ showed [Qc Ah] and won ($10.95) with a pair of Fours



PokerStars Game #59939776118:  Hold'em No Limit ($0.50/$1.00) - 2009/07/01 0:48:39 ET
Table 'U9zqzC8f3oTJ2ShXFgSSOA' 6-max Seat #2 is the button
Seat 2: JwCcjZl0bjJzG7hmE0dnTA ($121.05 in chips)
Seat 3: yfXek8iJ7O4CFyqXrtGcfg ($13.55 in chips)
Seat 4: 33q95we0Etwgrm6guQGncw ($95.35 in chips)
Seat 5: KfwW5us6tydK81NYTtK1gw ($289.75 in chips)
yfXek8iJ7O4CFyqXrtGcfg: posts small blind $0.50
33q95we0Etwgrm6guQGncw: posts big blind $1
iHo1oDbrEVJ8nEGdaPrICw: sits out
*** HOLE CARDS ***
KfwW5us6tydK81NYTtK1gw: folds
aIxzFKdtpDSkUePKZy/niQ leaves the table
4OO5v3AVduL0tePNx8wk5A joins the table at seat #6
JwCcjZl0bjJzG7hmE0dnTA: folds
yfXek8iJ7O4CFyqXrtGcfg: calls $0.50
33q95we0Etwgrm6guQGncw: checks
*** FLOP *** [Jc Ah Ks]
yfXek8iJ7O4CFyqXrtGcfg: bets $2
33q95we0Etwgrm6guQGncw: folds
yfXek8iJ7O4CFyqXrtGcfg collected $1.90 from pot
*** SUMMARY ***
Total pot $2 | Rake $0.10
Board [Jc Ah Ks]
Seat 2: JwCcjZl0bjJzG7hmE0dnTA (button) folded before Flop (didn't bet)
Seat 3: yfXek8iJ7O4CFyqXrtGcfg (small blind) collected ($1.90)
Seat 4: 33q95we0Etwgrm6guQGncw (big blind) folded on the Flop
Seat 5: KfwW5us6tydK81NYTtK1gw folded before Flop (didn't bet)



PokerStars Game #59939777232:  Hold'em No Limit ($0.50/$1.00) - 2009/07/01 0:48:40 ET
Table '6YvsYDPNIDx2v5z3bJnwZQ' 9-max Seat #2 is the button
Seat 1: Ogn4JDV3mp4ZDKO49IFzKA ($17.20 in chips)
Seat 2: x80+i7DJL+81v3quj7KbNg ($20 in chips)
Seat 3: negfosHnGOZXSHpWDRKyBQ ($16.30 in chips)
Seat 4: kEr5NYB+JIG5+szcYMr6hA ($40.50 in chips)
Seat 5: mBRWbnUl8diyBO1qTJaNzw ($166.70 in chips)
Seat 6: 7RSwrjMohkYrZAhOd1uaZg ($20 in chips)
Seat 7: mae7OMTaJ/MFimNbZegCkg ($49 in chips)
Seat 8: PSFxpXgPedVZyHSu2Zhb7Q ($103.05 in chips)
Seat 9: ZgMRSHJ9EOtPeVHmdeV9kQ ($59 in chips)
negfosHnGOZXSHpWDRKyBQ: posts small blind $0.50
kEr5NYB+JIG5+szcYMr6hA: posts big blind $1
7RSwrjMohkYrZAhOd1uaZg: posts big blind $1
*** HOLE CARDS ***
mBRWbnUl8diyBO1qTJaNzw: folds
7RSwrjMohkYrZAhOd1uaZg: checks
mae7OMTaJ/MFimNbZegCkg: folds
PSFxpXgPedVZyHSu2Zhb7Q: folds
ZgMRSHJ9EOtPeVHmdeV9kQ: folds
Ogn4JDV3mp4ZDKO49IFzKA: raises $16.20 to $17.20 and is all-in
x80+i7DJL+81v3quj7KbNg: folds
negfosHnGOZXSHpWDRKyBQ: folds
kEr5NYB+JIG5+szcYMr6hA: folds
7RSwrjMohkYrZAhOd1uaZg: folds
Ogn4JDV3mp4ZDKO49IFzKA collected $3.50 from pot
Ogn4JDV3mp4ZDKO49IFzKA: doesn't show hand
*** SUMMARY ***
Total pot $3.50 | Rake $0
Seat 1: Ogn4JDV3mp4ZDKO49IFzKA collected ($3.50)
Seat 2: x80+i7DJL+81v3quj7KbNg (button) folded before Flop (didn't bet)
Seat 3: negfosHnGOZXSHpWDRKyBQ (small blind) folded before Flop
Seat 4: kEr5NYB+JIG5+szcYMr6hA (big blind) folded before Flop
Seat 5: mBRWbnUl8diyBO1qTJaNzw folded before Flop (didn't bet)
Seat 6: 7RSwrjMohkYrZAhOd1uaZg folded before Flop
Seat 7: mae7OMTaJ/MFimNbZegCkg folded before Flop (didn't bet)
Seat 8: PSFxpXgPedVZyHSu2Zhb7Q folded before Flop (didn't bet)
Seat 9: ZgMRSHJ9EOtPeVHmdeV9kQ folded before Flop (didn't bet)



PokerStars Game #59939777412:  Hold'em No Limit ($0.50/$1.00) - 2009/07/01 0:48:41 ET
Table 'SQLOQoANiHscJ8AL7zffbw' 9-max Seat #3 is the button
Seat 1: jPTRd6SpCp4xqAy2XQiTOw ($118.10 in chips)
Seat 2: /zy+DB4S5fUQUSfZWFzYGw ($271.85 in chips)
Seat 3: 0eFnow7+D7veCYQ+CG9FFw ($94.85 in chips)
Seat 5: L9njYvloJ1NdXjP8edHEAg ($106.05 in chips)
Seat 6: p5UKaxVobvptF0ANhR/q1A ($174.50 in chips)
Seat 7: bJckevFOcg//s0qyMQI6sQ ($100 in chips)
Seat 8: Pp/KTcXkfZKKUHkjyaLTdg ($58.50 in chips)
Seat 9: qJr25HAtvv1w/7IBvjMM3g ($198.75 in chips)
L9njYvloJ1NdXjP8edHEAg: posts small blind $0.50
p5UKaxVobvptF0ANhR/q1A: posts big blind $1
*** HOLE CARDS ***
bJckevFOcg//s0qyMQI6sQ: folds
/mfensKw8/iZ1Vrx33S4xg joins the table at seat #4
Pp/KTcXkfZKKUHkjyaLTdg: folds
qJr25HAtvv1w/7IBvjMM3g: folds
jPTRd6SpCp4xqAy2XQiTOw: folds
/zy+DB4S5fUQUSfZWFzYGw: raises $3 to $4
0eFnow7+D7veCYQ+CG9FFw: folds
jPTRd6SpCp4xqAy2XQiTOw said, "come on folks its only a 50 cent game here whats there to think about?"
L9njYvloJ1NdXjP8edHEAg: folds
p5UKaxVobvptF0ANhR/q1A: folds
/zy+DB4S5fUQUSfZWFzYGw collected $2.50 from pot
*** SUMMARY ***
Total pot $2.50 | Rake $0
Seat 1: jPTRd6SpCp4xqAy2XQiTOw folded before Flop (didn't bet)
Seat 2: /zy+DB4S5fUQUSfZWFzYGw collected ($2.50)
Seat 3: 0eFnow7+D7veCYQ+CG9FFw (button) folded before Flop (didn't bet)
Seat 5: L9njYvloJ1NdXjP8edHEAg (small blind) folded before Flop
Seat 6: p5UKaxVobvptF0ANhR/q1A (big blind) folded before Flop
Seat 7: bJckevFOcg//s0qyMQI6sQ folded before Flop (didn't bet)
Seat 8: Pp/KTcXkfZKKUHkjyaLTdg folded before Flop (didn't bet)
Seat 9: qJr25HAtvv1w/7IBvjMM3g folded before Flop (didn't bet)



PokerStars Game #59939778082:  Hold'em No Limit ($0.50/$1.00) - 2009/07/01 0:48:42 ET
Table 'mmbQQVBTrPdE+wy+s+9VPA' 6-max Seat #6 is the button
Seat 2: +W6OnF033KNM2xH0fGj98Q ($120.60 in chips)
Seat 3: wx3sQGkVi2x9wJXuWNHPBw ($113.25 in chips)
Seat 4: RfKnhkJN8HEAuzJpH2Ajdg ($20.25 in chips)
Seat 5: YMJG+F++3Aj6P8dAWda5fw ($95 in chips)
Seat 6: U2CWBTv29qdCbj8RNF2sIw ($100 in chips)
JwCcjZl0bjJzG7hmE0dnTA will be allowed to play after the button
+W6OnF033KNM2xH0fGj98Q: posts small blind $0.50
wx3sQGkVi2x9wJXuWNHPBw: posts big blind $1
*** HOLE CARDS ***
RfKnhkJN8HEAuzJpH2Ajdg: calls $1
YMJG+F++3Aj6P8dAWda5fw: folds
U2CWBTv29qdCbj8RNF2sIw: folds
+W6OnF033KNM2xH0fGj98Q: folds
wx3sQGkVi2x9wJXuWNHPBw: checks
*** FLOP *** [Kd Ts 5h]
wx3sQGkVi2x9wJXuWNHPBw: checks
RfKnhkJN8HEAuzJpH2Ajdg: checks
*** TURN *** [Kd Ts 5h] [7d]
wx3sQGkVi2x9wJXuWNHPBw: checks
RfKnhkJN8HEAuzJpH2Ajdg: checks
*** RIVER *** [Kd Ts 5h 7d] [4h]
wx3sQGkVi2x9wJXuWNHPBw: checks
RfKnhkJN8HEAuzJpH2Ajdg: checks
*** SHOW DOWN ***
wx3sQGkVi2x9wJXuWNHPBw: shows [Ac 8c] (high card Ace)
RfKnhkJN8HEAuzJpH2Ajdg: mucks hand
wx3sQGkVi2x9wJXuWNHPBw collected $2.40 from pot
*** SUMMARY ***
Total pot $2.50 | Rake $0.10
Board [Kd Ts 5h 7d 4h]
Seat 2: +W6OnF033KNM2xH0fGj98Q (small blind) folded before Flop
Seat 3: wx3sQGkVi2x9wJXuWNHPBw (big blind) showed [Ac 8c] and won ($2.40) with high card Ace
Seat 4: RfKnhkJN8HEAuzJpH2Ajdg mucked
Seat 5: YMJG+F++3Aj6P8dAWda5fw folded before Flop (didn't bet)
Seat 6: U2CWBTv29qdCbj8RNF2sIw (button) folded before Flop (didn't bet)



PokerStars Game #59939778450:  Hold'em No Limit ($0.50/$1.00) - 2009/07/01 0:48:42 ET
Table '+cA8mcmhaedZ7YcrDdhmeQ' 6-max Seat #6 is the button
Seat 1: lsLuWlcPA3Rh7kJVLzMh0Q ($289.50 in chips)
Seat 2: RqgF7gRoKgRNW8Zoi1ty4A ($101.50 in chips)
Seat 3: 7H5WkGzGvsv56y1iaqHvRg ($35.85 in chips)
Seat 4: LjL3AIERHn559yyW1mTUYQ ($171.80 in chips)
Seat 5: +7hFKAL0b0O/n8G72TclJA ($50 in chips)
Seat 6: YfsTQsY/fxb+YqbdclTHuw ($48.70 in chips)
lsLuWlcPA3Rh7kJVLzMh0Q: posts small blind $0.50
RqgF7gRoKgRNW8Zoi1ty4A: posts big blind $1
*** HOLE CARDS ***
7H5WkGzGvsv56y1iaqHvRg: folds
LjL3AIERHn559yyW1mTUYQ: raises $2 to $3
+7hFKAL0b0O/n8G72TclJA: folds
YfsTQsY/fxb+YqbdclTHuw: folds
lsLuWlcPA3Rh7kJVLzMh0Q: folds
RqgF7gRoKgRNW8Zoi1ty4A: folds
LjL3AIERHn559yyW1mTUYQ collected $2.50 from pot
*** SUMMARY ***
Total pot $2.50 | Rake $0
Seat 1: lsLuWlcPA3Rh7kJVLzMh0Q (small blind) folded before Flop
Seat 2: RqgF7gRoKgRNW8Zoi1ty4A (big blind) folded before Flop
Seat 3: 7H5WkGzGvsv56y1iaqHvRg folded before Flop (didn't bet)
Seat 4: LjL3AIERHn559yyW1mTUYQ collected ($2.50)
Seat 5: +7hFKAL0b0O/n8G72TclJA folded before Flop (didn't bet)
Seat 6: YfsTQsY/fxb+YqbdclTHuw (button) folded before Flop (didn't bet)



PokerStars Game #59939781208:  Hold'em No Limit ($0.50/$1.00) - 2009/07/01 0:48:47 ET
Table 'CASNP0uy1C+jGLml/I4PtA' 9-max Seat #2 is the button
Seat 2: tjhwe1V98x2spSoUQER3HQ ($107.10 in chips)
Seat 3: bJckevFOcg//s0qyMQI6sQ ($113.45 in chips)
Seat 4: B/G0GJacqZ8K59/ZVdq4kQ ($38.95 in chips)
Seat 6: 0eFnow7+D7veCYQ+CG9FFw ($96.85 in chips)
Seat 7: RpMNxqeYPSeOh0tflU772w ($162.85 in chips)
Seat 8: L9njYvloJ1NdXjP8edHEAg ($100 in chips)
Seat 9: 4oiD3zp7JlvK3PEQyVa3gA ($274.40 in chips)
bJckevFOcg//s0qyMQI6sQ: posts small blind $0.50
B/G0GJacqZ8K59/ZVdq4kQ: posts big blind $1
xskinef: sits out
tkdBeXTJlFsZdioidNqLow: sits out
*** HOLE CARDS ***
0eFnow7+D7veCYQ+CG9FFw: folds
RpMNxqeYPSeOh0tflU772w: raises $1 to $2
L9njYvloJ1NdXjP8edHEAg: folds
4oiD3zp7JlvK3PEQyVa3gA: folds
tjhwe1V98x2spSoUQER3HQ: folds
bJckevFOcg//s0qyMQI6sQ: folds
B/G0GJacqZ8K59/ZVdq4kQ: calls $1
*** FLOP *** [9h Qd 3c]
B/G0GJacqZ8K59/ZVdq4kQ: checks
RpMNxqeYPSeOh0tflU772w: bets $3
B/G0GJacqZ8K59/ZVdq4kQ: calls $3
*** TURN *** [9h Qd 3c] [6h]
B/G0GJacqZ8K59/ZVdq4kQ: checks
RpMNxqeYPSeOh0tflU772w: bets $3
B/G0GJacqZ8K59/ZVdq4kQ: calls $3
*** RIVER *** [9h Qd 3c 6h] [2s]
B/G0GJacqZ8K59/ZVdq4kQ: checks
RpMNxqeYPSeOh0tflU772w: checks
*** SHOW DOWN ***
B/G0GJacqZ8K59/ZVdq4kQ: shows [5c 3h] (a pair of Threes)
RpMNxqeYPSeOh0tflU772w: shows [4c Qc] (a pair of Queens)
RpMNxqeYPSeOh0tflU772w collected $15.70 from pot
*** SUMMARY ***
Total pot $16.50 | Rake $0.80
Board [9h Qd 3c 6h 2s]
Seat 2: tjhwe1V98x2spSoUQER3HQ (button) folded before Flop (didn't bet)
Seat 3: bJckevFOcg//s0qyMQI6sQ (small blind) folded before Flop
Seat 4: B/G0GJacqZ8K59/ZVdq4kQ (big blind) showed [5c 3h] and lost with a pair of Threes
Seat 6: 0eFnow7+D7veCYQ+CG9FFw folded before Flop (didn't bet)
Seat 7: RpMNxqeYPSeOh0tflU772w showed [4c Qc] and won ($15.70) with a pair of Queens
Seat 8: L9njYvloJ1NdXjP8edHEAg folded before Flop (didn't bet)
Seat 9: 4oiD3zp7JlvK3PEQyVa3gA folded before Flop (didn't bet)



PokerStars Game #59939781916:  Hold'em No Limit ($0.50/$1.00) - 2009/07/01 0:48:48 ET
Table 'GPp0HyAuggN8oE0sUWzPpA' 9-max Seat #9 is the button
Seat 1: qJr25HAtvv1w/7IBvjMM3g ($28 in chips)
Seat 4: mBRWbnUl8diyBO1qTJaNzw ($109.70 in chips)
Seat 5: 0fXz44fzDo5QmhAaJCvFfA ($19.30 in chips)
Seat 6: BK/GtNPkSx0TdUDj82id5A ($12 in chips)
Seat 7: laA8va+Yv8WuMqT1zdR91g ($100 in chips)
Seat 8: tkdBeXTJlFsZdioidNqLow ($69.70 in chips)
Seat 9: VPF+HjszMvUIpy0CHIwH3A ($22 in chips)
qJr25HAtvv1w/7IBvjMM3g: posts small blind $0.50
Ogn4JDV3mp4ZDKO49IFzKA: is sitting out
Ogn4JDV3mp4ZDKO49IFzKA leaves the table
L9njYvloJ1NdXjP8edHEAg: is sitting out
L9njYvloJ1NdXjP8edHEAg leaves the table
mBRWbnUl8diyBO1qTJaNzw: posts big blind $1
*** HOLE CARDS ***
0fXz44fzDo5QmhAaJCvFfA: folds
BK/GtNPkSx0TdUDj82id5A: folds
laA8va+Yv8WuMqT1zdR91g: folds
tkdBeXTJlFsZdioidNqLow: folds
VPF+HjszMvUIpy0CHIwH3A: raises $21 to $22 and is all-in
qJr25HAtvv1w/7IBvjMM3g: folds
mBRWbnUl8diyBO1qTJaNzw: folds
VPF+HjszMvUIpy0CHIwH3A collected $2.50 from pot
*** SUMMARY ***
Total pot $2.50 | Rake $0
Seat 1: qJr25HAtvv1w/7IBvjMM3g (small blind) folded before Flop
Seat 4: mBRWbnUl8diyBO1qTJaNzw (big blind) folded before Flop
Seat 5: 0fXz44fzDo5QmhAaJCvFfA folded before Flop (didn't bet)
Seat 6: BK/GtNPkSx0TdUDj82id5A folded before Flop (didn't bet)
Seat 7: laA8va+Yv8WuMqT1zdR91g folded before Flop (didn't bet)
Seat 8: tkdBeXTJlFsZdioidNqLow folded before Flop (didn't bet)
Seat 9: VPF+HjszMvUIpy0CHIwH3A (button) collected ($2.50)



PokerStars Game #59939783356:  Hold'em No Limit ($0.50/$1.00) - 2009/07/01 0:48:50 ET
Table 'hugOjcwJvzEwZbK7tyiWuQ' 9-max Seat #6 is the button
Seat 1: N9n5Wc3s35DpCrOAUUNAaQ ($130 in chips)
Seat 2: r27C1nIV4NS4+qbnrgBQSw ($260.60 in chips)
Seat 3: jDwhY1kCdc6EkAHbT7PJMQ ($103.65 in chips)
Seat 4: UWB3oeddt/GObx2Mix2Anw ($204.25 in chips)
Seat 5: 5BRGWf+R3nt2WS3b5xX+zA ($27.20 in chips)
Seat 6: gUUvmqdVlmvpal6B8nYrmg ($106.20 in chips)
Seat 7: FL3MrLspcF23LYvC4ipBOA ($100 in chips)
Seat 8: /zy+DB4S5fUQUSfZWFzYGw ($101.25 in chips)
Seat 9: W8P9bUKCs43TO1xHm0dL6w ($88.15 in chips)
FL3MrLspcF23LYvC4ipBOA: posts small blind $0.50
/zy+DB4S5fUQUSfZWFzYGw: posts big blind $1
*** HOLE CARDS ***
W8P9bUKCs43TO1xHm0dL6w: folds
N9n5Wc3s35DpCrOAUUNAaQ has timed out
N9n5Wc3s35DpCrOAUUNAaQ: folds
N9n5Wc3s35DpCrOAUUNAaQ is sitting out
r27C1nIV4NS4+qbnrgBQSw: folds
jDwhY1kCdc6EkAHbT7PJMQ: folds
UWB3oeddt/GObx2Mix2Anw: raises $2 to $3
5BRGWf+R3nt2WS3b5xX+zA: folds
gUUvmqdVlmvpal6B8nYrmg: folds
FL3MrLspcF23LYvC4ipBOA: folds
/zy+DB4S5fUQUSfZWFzYGw: folds
UWB3oeddt/GObx2Mix2Anw collected $2.50 from pot
*** SUMMARY ***
Total pot $2.50 | Rake $0
Seat 1: N9n5Wc3s35DpCrOAUUNAaQ folded before Flop (didn't bet)
Seat 2: r27C1nIV4NS4+qbnrgBQSw folded before Flop (didn't bet)
Seat 3: jDwhY1kCdc6EkAHbT7PJMQ folded before Flop (didn't bet)
Seat 4: UWB3oeddt/GObx2Mix2Anw collected ($2.50)
Seat 5: 5BRGWf+R3nt2WS3b5xX+zA folded before Flop (didn't bet)
Seat 6: gUUvmqdVlmvpal6B8nYrmg (button) folded before Flop (didn't bet)
Seat 7: FL3MrLspcF23LYvC4ipBOA (small blind) folded before Flop
Seat 8: /zy+DB4S5fUQUSfZWFzYGw (big blind) folded before Flop
Seat 9: W8P9bUKCs43TO1xHm0dL6w folded before Flop (didn't bet)



PokerStars Game #59939783258:  Hold'em No Limit ($0.50/$1.00) - 2009/07/01 0:48:50 ET
Table 'CxlB0XELs5P0zDlOhlhAPw' 2-max Seat #1 is the button
Seat 1: +B2wRsLpIMFnVA7qiRoGfg ($22.40 in chips)
Seat 2: I4xAjioR1QwQ5TgX4Z1/qw ($57.70 in chips)
+B2wRsLpIMFnVA7qiRoGfg: posts small blind $0.50
I4xAjioR1QwQ5TgX4Z1/qw: posts big blind $1
*** HOLE CARDS ***
+B2wRsLpIMFnVA7qiRoGfg: calls $0.50
I4xAjioR1QwQ5TgX4Z1/qw: checks
*** FLOP *** [Ad Qc 3h]
I4xAjioR1QwQ5TgX4Z1/qw: checks
+B2wRsLpIMFnVA7qiRoGfg: bets $2
I4xAjioR1QwQ5TgX4Z1/qw: folds
+B2wRsLpIMFnVA7qiRoGfg collected $1.90 from pot
*** SUMMARY ***
Total pot $2 | Rake $0.10
Board [Ad Qc 3h]
Seat 1: +B2wRsLpIMFnVA7qiRoGfg (button) (small blind) collected ($1.90)
Seat 2: I4xAjioR1QwQ5TgX4Z1/qw (big blind) folded on the Flop



PokerStars Game #59939784678:  Hold'em No Limit ($0.50/$1.00) - 2009/07/01 0:48:52 ET
Table 'LmXQK9xy3awB+qsPzI21Mw' 2-max Seat #1 is the button
Seat 1: NYi6JFscYNrofSXy4sM+Yw ($205.55 in chips)
Seat 2: TME8GvochpQAo8cmJwWmvA ($125.65 in chips)
NYi6JFscYNrofSXy4sM+Yw: posts small blind $0.50
TME8GvochpQAo8cmJwWmvA: posts big blind $1
*** HOLE CARDS ***
NYi6JFscYNrofSXy4sM+Yw: raises $2 to $3
TME8GvochpQAo8cmJwWmvA: folds
NYi6JFscYNrofSXy4sM+Yw collected $2 from pot
*** SUMMARY ***
Total pot $2 | Rake $0
Seat 1: NYi6JFscYNrofSXy4sM+Yw (button) (small blind) collected ($2)
Seat 2: TME8GvochpQAo8cmJwWmvA (big blind) folded before Flop



PokerStars Game #59939785654:  Hold'em No Limit ($0.50/$1.00) - 2009/07/01 0:48:54 ET
Table 'cBDNutyLBKEk9+ptwsKmTw' 6-max Seat #5 is the button
Seat 1: xAU6q2/cwmby2sxmA8VcmA ($100 in chips)
Seat 2: 5lY8d6Cnm4HUkt/8FZSj4g ($95.80 in chips)
Seat 3: G5ZSSN6RSON3gkNvk/SmYg ($116.65 in chips)
Seat 4: 3q7F5QtzC30pSrn0nl9i+A ($35.20 in chips)
Seat 5: OGMLOcTNYZXZU81au7ztUw ($142.55 in chips)
Seat 6: NqVlOSH2lp+pp/TK3vvK5g ($46.50 in chips)
NqVlOSH2lp+pp/TK3vvK5g: posts small blind $0.50
xAU6q2/cwmby2sxmA8VcmA: posts big blind $1
*** HOLE CARDS ***
5lY8d6Cnm4HUkt/8FZSj4g: calls $1
G5ZSSN6RSON3gkNvk/SmYg: calls $1
3q7F5QtzC30pSrn0nl9i+A: folds
OGMLOcTNYZXZU81au7ztUw: raises $3 to $4
NqVlOSH2lp+pp/TK3vvK5g: folds
xAU6q2/cwmby2sxmA8VcmA: folds
5lY8d6Cnm4HUkt/8FZSj4g: calls $3
G5ZSSN6RSON3gkNvk/SmYg: calls $3
*** FLOP *** [4c 3c 6d]
5lY8d6Cnm4HUkt/8FZSj4g: checks
G5ZSSN6RSON3gkNvk/SmYg: checks
OGMLOcTNYZXZU81au7ztUw: bets $8
5lY8d6Cnm4HUkt/8FZSj4g: folds
G5ZSSN6RSON3gkNvk/SmYg: calls $8
*** TURN *** [4c 3c 6d] [3s]
G5ZSSN6RSON3gkNvk/SmYg: checks
OGMLOcTNYZXZU81au7ztUw: checks
*** RIVER *** [4c 3c 6d 3s] [Kh]
G5ZSSN6RSON3gkNvk/SmYg: checks
OGMLOcTNYZXZU81au7ztUw: checks
*** SHOW DOWN ***
G5ZSSN6RSON3gkNvk/SmYg: shows [7s 7d] (two pair, Sevens and Threes)
OGMLOcTNYZXZU81au7ztUw: shows [Kc 5c] (two pair, Kings and Threes)
OGMLOcTNYZXZU81au7ztUw collected $28.10 from pot
*** SUMMARY ***
Total pot $29.50 | Rake $1.40
Board [4c 3c 6d 3s Kh]
Seat 1: xAU6q2/cwmby2sxmA8VcmA (big blind) folded before Flop
Seat 2: 5lY8d6Cnm4HUkt/8FZSj4g folded on the Flop
Seat 3: G5ZSSN6RSON3gkNvk/SmYg showed [7s 7d] and lost with two pair, Sevens and Threes
Seat 4: 3q7F5QtzC30pSrn0nl9i+A folded before Flop (didn't bet)
Seat 5: OGMLOcTNYZXZU81au7ztUw (button) showed [Kc 5c] and won ($28.10) with two pair, Kings and Threes
Seat 6: NqVlOSH2lp+pp/TK3vvK5g (small blind) folded before Flop



PokerStars Game #59939787746:  Hold'em No Limit ($0.50/$1.00) - 2009/07/01 0:48:57 ET
Table 'eU3bWpDDg3Z+9R4m4iVmog' 6-max Seat #2 is the button
Seat 1: TSuRyAHnUPCFjP7Z0rEE0w ($191.15 in chips)
Seat 2: 8CAoOzhmB8n3nRFf3V4BTg ($93.30 in chips)
Seat 3: U6tnjwZRpTnM+YkqkCjwyQ ($187.65 in chips)
Seat 4: GDVIsbEJ/DOJsMKE4Asz0A ($68.30 in chips)
Seat 5: AdLVjddOzm+sRNo1Bc3S6Q ($114.05 in chips)
Seat 6: hpxXcmRkXXI9HE5+5/j/0Q ($121.95 in chips)
U6tnjwZRpTnM+YkqkCjwyQ: posts small blind $0.50
GDVIsbEJ/DOJsMKE4Asz0A: posts big blind $1
*** HOLE CARDS ***
AdLVjddOzm+sRNo1Bc3S6Q: folds
hpxXcmRkXXI9HE5+5/j/0Q: folds
TSuRyAHnUPCFjP7Z0rEE0w: folds
8CAoOzhmB8n3nRFf3V4BTg: raises $2 to $3
U6tnjwZRpTnM+YkqkCjwyQ: folds
GDVIsbEJ/DOJsMKE4Asz0A: folds
8CAoOzhmB8n3nRFf3V4BTg collected $2.50 from pot
8CAoOzhmB8n3nRFf3V4BTg: doesn't show hand
*** SUMMARY ***
Total pot $2.50 | Rake $0
Seat 1: TSuRyAHnUPCFjP7Z0rEE0w folded before Flop (didn't bet)
Seat 2: 8CAoOzhmB8n3nRFf3V4BTg (button) collected ($2.50)
Seat 3: U6tnjwZRpTnM+YkqkCjwyQ (small blind) folded before Flop
Seat 4: GDVIsbEJ/DOJsMKE4Asz0A (big blind) folded before Flop
Seat 5: AdLVjddOzm+sRNo1Bc3S6Q folded before Flop (didn't bet)
Seat 6: hpxXcmRkXXI9HE5+5/j/0Q folded before Flop (didn't bet)



PokerStars Game #59939788188:  Hold'em No Limit ($0.50/$1.00) - 2009/07/01 0:48:58 ET
Table 'MUPc8FEpe/nR0BKSeReX6Q' 6-max Seat #4 is the button
Seat 1: YsLQ3BAvgQHWXMAv3Wv6Hg ($113.85 in chips)
Seat 2: xAU6q2/cwmby2sxmA8VcmA ($108.80 in chips)
Seat 3: wx3sQGkVi2x9wJXuWNHPBw ($220.90 in chips)
Seat 4: ZA1bp6g8IwtTxkUE4eCjDQ ($203.80 in chips)
Seat 5: UBZQqpnJZdTYYY1FTb0rLA ($100 in chips)
Seat 6: oxnw0GLLpFanjhGkxfRSqA ($46 in chips)
UBZQqpnJZdTYYY1FTb0rLA: posts small blind $0.50
oxnw0GLLpFanjhGkxfRSqA: posts big blind $1
*** HOLE CARDS ***
YsLQ3BAvgQHWXMAv3Wv6Hg: folds
xAU6q2/cwmby2sxmA8VcmA: raises $3 to $4
wx3sQGkVi2x9wJXuWNHPBw: folds
ZA1bp6g8IwtTxkUE4eCjDQ said, "why u play with 8 q"
ZA1bp6g8IwtTxkUE4eCjDQ: folds
UBZQqpnJZdTYYY1FTb0rLA: folds
oxnw0GLLpFanjhGkxfRSqA: calls $3
*** FLOP *** [4c 3c 6d]
oxnw0GLLpFanjhGkxfRSqA: checks
xAU6q2/cwmby2sxmA8VcmA: bets $6
oxnw0GLLpFanjhGkxfRSqA: calls $6
*** TURN *** [4c 3c 6d] [Ad]
oxnw0GLLpFanjhGkxfRSqA: checks
xAU6q2/cwmby2sxmA8VcmA: checks
*** RIVER *** [4c 3c 6d Ad] [9s]
oxnw0GLLpFanjhGkxfRSqA: bets $4
xAU6q2/cwmby2sxmA8VcmA: folds
oxnw0GLLpFanjhGkxfRSqA collected $19.50 from pot
*** SUMMARY ***
Total pot $20.50 | Rake $1
Board [4c 3c 6d Ad 9s]
Seat 1: YsLQ3BAvgQHWXMAv3Wv6Hg folded before Flop (didn't bet)
Seat 2: xAU6q2/cwmby2sxmA8VcmA folded on the River
Seat 3: wx3sQGkVi2x9wJXuWNHPBw folded before Flop (didn't bet)
Seat 4: ZA1bp6g8IwtTxkUE4eCjDQ (button) folded before Flop (didn't bet)
Seat 5: UBZQqpnJZdTYYY1FTb0rLA (small blind) folded before Flop
Seat 6: oxnw0GLLpFanjhGkxfRSqA (big blind) collected ($19.50)



PokerStars Game #59939788416:  Hold'em No Limit ($0.50/$1.00) - 2009/07/01 0:48:58 ET
Table 'LmXQK9xy3awB+qsPzI21Mw' 2-max Seat #2 is the button
Seat 1: NYi6JFscYNrofSXy4sM+Yw ($206.55 in chips)
Seat 2: TME8GvochpQAo8cmJwWmvA ($124.65 in chips)
TME8GvochpQAo8cmJwWmvA: posts small blind $0.50
NYi6JFscYNrofSXy4sM+Yw: posts big blind $1
*** HOLE CARDS ***
TME8GvochpQAo8cmJwWmvA: calls $0.50
NYi6JFscYNrofSXy4sM+Yw: checks
*** FLOP *** [2d Td Jc]
NYi6JFscYNrofSXy4sM+Yw: bets $1
TME8GvochpQAo8cmJwWmvA: folds
NYi6JFscYNrofSXy4sM+Yw collected $1.90 from pot
*** SUMMARY ***
Total pot $2 | Rake $0.10
Board [2d Td Jc]
Seat 1: NYi6JFscYNrofSXy4sM+Yw (big blind) collected ($1.90)
Seat 2: TME8GvochpQAo8cmJwWmvA (button) (small blind) folded on the Flop



PokerStars Game #59939791648:  Hold'em No Limit ($0.50/$1.00) - 2009/07/01 0:49:03 ET
Table 'pHrhryH8jPNdQfY62f8v+g' 6-max Seat #2 is the button
Seat 1: fF4botNMr8/ieVPO1YYRLw ($56 in chips)
Seat 2: RqgF7gRoKgRNW8Zoi1ty4A ($104.25 in chips)
Seat 3: 8oS5O7iD/qnFXFXJrGIgNQ ($100 in chips)
Seat 4: wenbG7TaM3H7h5kn78OFNw ($57.20 in chips)
Seat 5: r1/R7y0Ortgoz4lccgW8VA ($55.90 in chips)
Seat 6: xAU6q2/cwmby2sxmA8VcmA ($113.75 in chips)
8oS5O7iD/qnFXFXJrGIgNQ: posts small blind $0.50
wenbG7TaM3H7h5kn78OFNw: posts big blind $1
*** HOLE CARDS ***
r1/R7y0Ortgoz4lccgW8VA: folds
xAU6q2/cwmby2sxmA8VcmA: raises $3 to $4
fF4botNMr8/ieVPO1YYRLw: folds
RqgF7gRoKgRNW8Zoi1ty4A: calls $4
8oS5O7iD/qnFXFXJrGIgNQ: folds
wenbG7TaM3H7h5kn78OFNw: folds
*** FLOP *** [Qd Kc 9d]
xAU6q2/cwmby2sxmA8VcmA: bets $7
RqgF7gRoKgRNW8Zoi1ty4A: folds
xAU6q2/cwmby2sxmA8VcmA collected $9.05 from pot
*** SUMMARY ***
Total pot $9.50 | Rake $0.45
Board [Qd Kc 9d]
Seat 1: fF4botNMr8/ieVPO1YYRLw folded before Flop (didn't bet)
Seat 2: RqgF7gRoKgRNW8Zoi1ty4A (button) folded on the Flop
Seat 3: 8oS5O7iD/qnFXFXJrGIgNQ (small blind) folded before Flop
Seat 4: wenbG7TaM3H7h5kn78OFNw (big blind) folded before Flop
Seat 5: r1/R7y0Ortgoz4lccgW8VA folded before Flop (didn't bet)
Seat 6: xAU6q2/cwmby2sxmA8VcmA collected ($9.05)



PokerStars Game #59939791610:  Hold'em No Limit ($0.50/$1.00) - 2009/07/01 0:49:03 ET
Table '/RZcOwpZpHQ+OwPwjsbnRw' 6-max Seat #1 is the button
Seat 1: Zboa6dColKGHBjLPUakZjw ($38.90 in chips)
Seat 2: +xW7QemQU0Fxs+4TnqBRow ($193.50 in chips)
Seat 3: XnT1yK2DD/5FL+0bwuEhqg ($44.95 in chips)
Seat 4: j7NIOHLZk7V2o9fOioO5ug ($121.85 in chips)
Seat 5: wx3sQGkVi2x9wJXuWNHPBw ($182.15 in chips)
Seat 6: XOIf9W+VAxhZqN+SYoyMKA ($293.25 in chips)
+xW7QemQU0Fxs+4TnqBRow: posts small blind $0.50
XnT1yK2DD/5FL+0bwuEhqg: posts big blind $1
*** HOLE CARDS ***
j7NIOHLZk7V2o9fOioO5ug: folds
wx3sQGkVi2x9wJXuWNHPBw: folds
XOIf9W+VAxhZqN+SYoyMKA: folds
Zboa6dColKGHBjLPUakZjw: folds
+xW7QemQU0Fxs+4TnqBRow: folds
XnT1yK2DD/5FL+0bwuEhqg collected $1 from pot
*** SUMMARY ***
Total pot $1 | Rake $0
Seat 1: Zboa6dColKGHBjLPUakZjw (button) folded before Flop (didn't bet)
Seat 2: +xW7QemQU0Fxs+4TnqBRow (small blind) folded before Flop
Seat 3: XnT1yK2DD/5FL+0bwuEhqg (big blind) collected ($1)
Seat 4: j7NIOHLZk7V2o9fOioO5ug folded before Flop (didn't bet)
Seat 5: wx3sQGkVi2x9wJXuWNHPBw folded before Flop (didn't bet)
Seat 6: XOIf9W+VAxhZqN+SYoyMKA folded before Flop (didn't bet)



PokerStars Game #59939794384:  Hold'em No Limit ($0.50/$1.00) - 2009/07/01 0:49:07 ET
Table 'tJq9SfN1ywY0r03VBlWlwQ' 9-max Seat #2 is the button
Seat 1: wZsU+w9r7G66x93UuvBf1Q ($337.80 in chips)
Seat 2: RqkO8O/Y3qlc3PIuCAHjVg ($74.40 in chips)
Seat 3: FVs16t7GgfWgQWt4JxsObQ ($33.05 in chips)
Seat 4: bLbSOSmSOnqE0iTcH/5dxA ($111.70 in chips)
Seat 5: Ogn4JDV3mp4ZDKO49IFzKA ($19.90 in chips)
Seat 6: gUUvmqdVlmvpal6B8nYrmg ($122.05 in chips)
Seat 7: qVhRZ0PLZ95XRJHWAjXjOQ ($128.20 in chips)
Seat 8: G4DEhsZFmznGNVpy2SEocA ($23.50 in chips)
Seat 9: XE5QF1y74bpHog9JxWJMWQ ($100 in chips)
FVs16t7GgfWgQWt4JxsObQ: posts small blind $0.50
bLbSOSmSOnqE0iTcH/5dxA: posts big blind $1
*** HOLE CARDS ***
Ogn4JDV3mp4ZDKO49IFzKA: folds
gUUvmqdVlmvpal6B8nYrmg: folds
qVhRZ0PLZ95XRJHWAjXjOQ: folds
G4DEhsZFmznGNVpy2SEocA: folds
XE5QF1y74bpHog9JxWJMWQ: folds
wZsU+w9r7G66x93UuvBf1Q: folds
RqkO8O/Y3qlc3PIuCAHjVg: folds
FVs16t7GgfWgQWt4JxsObQ: calls $0.50
bLbSOSmSOnqE0iTcH/5dxA: checks
*** FLOP *** [Js Kc 6c]
FVs16t7GgfWgQWt4JxsObQ: checks
bLbSOSmSOnqE0iTcH/5dxA: checks
*** TURN *** [Js Kc 6c] [8d]
FVs16t7GgfWgQWt4JxsObQ: bets $3
bLbSOSmSOnqE0iTcH/5dxA: folds
FVs16t7GgfWgQWt4JxsObQ collected $1.90 from pot
*** SUMMARY ***
Total pot $2 | Rake $0.10
Board [Js Kc 6c 8d]
Seat 1: wZsU+w9r7G66x93UuvBf1Q folded before Flop (didn't bet)
Seat 2: RqkO8O/Y3qlc3PIuCAHjVg (button) folded before Flop (didn't bet)
Seat 3: FVs16t7GgfWgQWt4JxsObQ (small blind) collected ($1.90)
Seat 4: bLbSOSmSOnqE0iTcH/5dxA (big blind) folded on the Turn
Seat 5: Ogn4JDV3mp4ZDKO49IFzKA folded before Flop (didn't bet)
Seat 6: gUUvmqdVlmvpal6B8nYrmg folded before Flop (didn't bet)
Seat 7: qVhRZ0PLZ95XRJHWAjXjOQ folded before Flop (didn't bet)
Seat 8: G4DEhsZFmznGNVpy2SEocA folded before Flop (didn't bet)
Seat 9: XE5QF1y74bpHog9JxWJMWQ folded before Flop (didn't bet)



PokerStars Game #59939796192:  Hold'em No Limit ($0.50/$1.00) - 2009/07/01 0:49:10 ET
Table 'U9zqzC8f3oTJ2ShXFgSSOA' 6-max Seat #3 is the button
Seat 2: JwCcjZl0bjJzG7hmE0dnTA ($121.05 in chips)
Seat 3: yfXek8iJ7O4CFyqXrtGcfg ($14.45 in chips)
Seat 4: 33q95we0Etwgrm6guQGncw ($94.35 in chips)
Seat 5: KfwW5us6tydK81NYTtK1gw ($289.75 in chips)
33q95we0Etwgrm6guQGncw: posts small blind $0.50
KfwW5us6tydK81NYTtK1gw: posts big blind $1
4OO5v3AVduL0tePNx8wk5A: sits out
iHo1oDbrEVJ8nEGdaPrICw: sits out
*** HOLE CARDS ***
JwCcjZl0bjJzG7hmE0dnTA: raises $2 to $3
yfXek8iJ7O4CFyqXrtGcfg: folds
33q95we0Etwgrm6guQGncw: folds
KfwW5us6tydK81NYTtK1gw: calls $2
*** FLOP *** [As 6s 4s]
KfwW5us6tydK81NYTtK1gw: checks
JwCcjZl0bjJzG7hmE0dnTA: bets $3
KfwW5us6tydK81NYTtK1gw: calls $3
*** TURN *** [As 6s 4s] [3c]
KfwW5us6tydK81NYTtK1gw: checks
JwCcjZl0bjJzG7hmE0dnTA: checks
*** RIVER *** [As 6s 4s 3c] [9s]
KfwW5us6tydK81NYTtK1gw: bets $5
JwCcjZl0bjJzG7hmE0dnTA: folds
KfwW5us6tydK81NYTtK1gw collected $11.90 from pot
KfwW5us6tydK81NYTtK1gw: doesn't show hand
*** SUMMARY ***
Total pot $12.50 | Rake $0.60
Board [As 6s 4s 3c 9s]
Seat 2: JwCcjZl0bjJzG7hmE0dnTA folded on the River
Seat 3: yfXek8iJ7O4CFyqXrtGcfg (button) folded before Flop (didn't bet)
Seat 4: 33q95we0Etwgrm6guQGncw (small blind) folded before Flop
Seat 5: KfwW5us6tydK81NYTtK1gw (big blind) collected ($11.90)



PokerStars Game #59939797692:  Hold'em No Limit ($0.50/$1.00) - 2009/07/01 0:49:12 ET
Table '7O9fB8yx1u7sJveJn8w6jA' 6-max Seat #2 is the button
Seat 1: jy52+7FotjH63o5tEEVgKw ($160.35 in chips)
Seat 2: wx3sQGkVi2x9wJXuWNHPBw ($192.50 in chips)
Seat 3: hpxXcmRkXXI9HE5+5/j/0Q ($100.50 in chips)
Seat 4: XIZSmlGttGgSRaIU42K4Fg ($75.10 in chips)
Seat 5: BCEV3COoKY607AzLWayfRA ($100 in chips)
Seat 6: UBZQqpnJZdTYYY1FTb0rLA ($137.45 in chips)
hpxXcmRkXXI9HE5+5/j/0Q: posts small blind $0.50
XIZSmlGttGgSRaIU42K4Fg: posts big blind $1
*** HOLE CARDS ***
BCEV3COoKY607AzLWayfRA: folds
UBZQqpnJZdTYYY1FTb0rLA: raises $2 to $3
jy52+7FotjH63o5tEEVgKw: folds
wx3sQGkVi2x9wJXuWNHPBw: folds
hpxXcmRkXXI9HE5+5/j/0Q: folds
XIZSmlGttGgSRaIU42K4Fg: calls $2
*** FLOP *** [3h 3c Th]
XIZSmlGttGgSRaIU42K4Fg: checks
UBZQqpnJZdTYYY1FTb0rLA: checks
*** TURN *** [3h 3c Th] [5d]
XIZSmlGttGgSRaIU42K4Fg: checks
UBZQqpnJZdTYYY1FTb0rLA: checks
*** RIVER *** [3h 3c Th 5d] [4c]
XIZSmlGttGgSRaIU42K4Fg: bets $4
UBZQqpnJZdTYYY1FTb0rLA: calls $4
*** SHOW DOWN ***
XIZSmlGttGgSRaIU42K4Fg: shows [7c 6c] (a straight, Three to Seven)
UBZQqpnJZdTYYY1FTb0rLA: mucks hand
XIZSmlGttGgSRaIU42K4Fg collected $13.80 from pot
*** SUMMARY ***
Total pot $14.50 | Rake $0.70
Board [3h 3c Th 5d 4c]
Seat 1: jy52+7FotjH63o5tEEVgKw folded before Flop (didn't bet)
Seat 2: wx3sQGkVi2x9wJXuWNHPBw (button) folded before Flop (didn't bet)
Seat 3: hpxXcmRkXXI9HE5+5/j/0Q (small blind) folded before Flop
Seat 4: XIZSmlGttGgSRaIU42K4Fg (big blind) showed [7c 6c] and won ($13.80) with a straight, Three to Seven
Seat 5: BCEV3COoKY607AzLWayfRA folded before Flop (didn't bet)
Seat 6: UBZQqpnJZdTYYY1FTb0rLA mucked



PokerStars Game #59939798952:  Hold'em No Limit ($0.50/$1.00) - 2009/07/01 0:49:14 ET
Table 'eU3bWpDDg3Z+9R4m4iVmog' 6-max Seat #3 is the button
Seat 1: TSuRyAHnUPCFjP7Z0rEE0w ($191.15 in chips)
Seat 2: 8CAoOzhmB8n3nRFf3V4BTg ($94.80 in chips)
Seat 3: U6tnjwZRpTnM+YkqkCjwyQ ($187.15 in chips)
Seat 4: GDVIsbEJ/DOJsMKE4Asz0A ($67.30 in chips)
Seat 5: AdLVjddOzm+sRNo1Bc3S6Q ($114.05 in chips)
Seat 6: hpxXcmRkXXI9HE5+5/j/0Q ($121.95 in chips)
GDVIsbEJ/DOJsMKE4Asz0A: posts small blind $0.50
AdLVjddOzm+sRNo1Bc3S6Q: posts big blind $1
*** HOLE CARDS ***
hpxXcmRkXXI9HE5+5/j/0Q: folds
TSuRyAHnUPCFjP7Z0rEE0w: raises $3 to $4
8CAoOzhmB8n3nRFf3V4BTg: folds
U6tnjwZRpTnM+YkqkCjwyQ: folds
GDVIsbEJ/DOJsMKE4Asz0A: folds
AdLVjddOzm+sRNo1Bc3S6Q: folds
TSuRyAHnUPCFjP7Z0rEE0w collected $2.50 from pot
*** SUMMARY ***
Total pot $2.50 | Rake $0
Seat 1: TSuRyAHnUPCFjP7Z0rEE0w collected ($2.50)
Seat 2: 8CAoOzhmB8n3nRFf3V4BTg folded before Flop (didn't bet)
Seat 3: U6tnjwZRpTnM+YkqkCjwyQ (button) folded before Flop (didn't bet)
Seat 4: GDVIsbEJ/DOJsMKE4Asz0A (small blind) folded before Flop
Seat 5: AdLVjddOzm+sRNo1Bc3S6Q (big blind) folded before Flop
Seat 6: hpxXcmRkXXI9HE5+5/j/0Q folded before Flop (didn't bet)



PokerStars Game #59939799134:  Hold'em No Limit ($0.50/$1.00) - 2009/07/01 0:49:15 ET
Table 'LmXQK9xy3awB+qsPzI21Mw' 2-max Seat #1 is the button
Seat 1: NYi6JFscYNrofSXy4sM+Yw ($207.45 in chips)
Seat 2: TME8GvochpQAo8cmJwWmvA ($123.65 in chips)
NYi6JFscYNrofSXy4sM+Yw: posts small blind $0.50
TME8GvochpQAo8cmJwWmvA: posts big blind $1
*** HOLE CARDS ***
NYi6JFscYNrofSXy4sM+Yw: raises $2 to $3
TME8GvochpQAo8cmJwWmvA: calls $2
*** FLOP *** [Qh Kc 3h]
TME8GvochpQAo8cmJwWmvA: checks
NYi6JFscYNrofSXy4sM+Yw: bets $3
TME8GvochpQAo8cmJwWmvA: calls $3
*** TURN *** [Qh Kc 3h] [6d]
TME8GvochpQAo8cmJwWmvA: checks
NYi6JFscYNrofSXy4sM+Yw: checks
*** RIVER *** [Qh Kc 3h 6d] [7h]
TME8GvochpQAo8cmJwWmvA: bets $3
NYi6JFscYNrofSXy4sM+Yw: calls $3
*** SHOW DOWN ***
TME8GvochpQAo8cmJwWmvA: shows [8d Ks] (a pair of Kings)
NYi6JFscYNrofSXy4sM+Yw: mucks hand
TME8GvochpQAo8cmJwWmvA collected $17.50 from pot
*** SUMMARY ***
Total pot $18 | Rake $0.50
Board [Qh Kc 3h 6d 7h]
Seat 1: NYi6JFscYNrofSXy4sM+Yw (button) (small blind) mucked
Seat 2: TME8GvochpQAo8cmJwWmvA (big blind) showed [8d Ks] and won ($17.50) with a pair of Kings



PokerStars Game #59939799732:  Hold'em No Limit ($0.50/$1.00) - 2009/07/01 0:49:16 ET
Table 'CxlB0XELs5P0zDlOhlhAPw' 2-max Seat #2 is the button
Seat 1: +B2wRsLpIMFnVA7qiRoGfg ($23.30 in chips)
Seat 2: I4xAjioR1QwQ5TgX4Z1/qw ($56.70 in chips)
I4xAjioR1QwQ5TgX4Z1/qw: posts small blind $0.50
+B2wRsLpIMFnVA7qiRoGfg: posts big blind $1
*** HOLE CARDS ***
I4xAjioR1QwQ5TgX4Z1/qw: raises $2 to $3
+B2wRsLpIMFnVA7qiRoGfg: calls $2
*** FLOP *** [2s Qc Ah]
+B2wRsLpIMFnVA7qiRoGfg: checks
I4xAjioR1QwQ5TgX4Z1/qw: bets $4
+B2wRsLpIMFnVA7qiRoGfg: folds
I4xAjioR1QwQ5TgX4Z1/qw collected $5.70 from pot
*** SUMMARY ***
Total pot $6 | Rake $0.30
Board [2s Qc Ah]
Seat 1: +B2wRsLpIMFnVA7qiRoGfg (big blind) folded on the Flop
Seat 2: I4xAjioR1QwQ5TgX4Z1/qw (button) (small blind) collected ($5.70)



PokerStars Game #59939799990:  Hold'em No Limit ($0.50/$1.00) - 2009/07/01 0:49:16 ET
Table 'tyUh+jyNvrceIQdKMJjQ2wZFWj23PMihdwrNWv41OG/Qeat #3 is the button
Seat 1: o8A5MUdudVKu+pAwgZOX2w ($219.45 in chips)
Seat 2: XvUbOIg94d25feWeQlOTVg ($71.90 in chips)
Seat 3: TalCiLYHCd+ffkmR3auPvA ($75.90 in chips)
Seat 4: TSuRyAHnUPCFjP7Z0rEE0w ($117.25 in chips)
Seat 5: j7NIOHLZk7V2o9fOioO5ug ($101.10 in chips)
Seat 6: YsLQ3BAvgQHWXMAv3Wv6Hg ($148.15 in chips)
TSuRyAHnUPCFjP7Z0rEE0w: posts small blind $0.50
j7NIOHLZk7V2o9fOioO5ug: posts big blind $1
o8A5MUdudVKu+pAwgZOX2w: posts small & big blinds $1.50
*** HOLE CARDS ***
YsLQ3BAvgQHWXMAv3Wv6Hg: folds
o8A5MUdudVKu+pAwgZOX2w: checks
XvUbOIg94d25feWeQlOTVg: folds
TalCiLYHCd+ffkmR3auPvA: raises $3 to $4
TSuRyAHnUPCFjP7Z0rEE0w: folds
j7NIOHLZk7V2o9fOioO5ug: calls $3
o8A5MUdudVKu+pAwgZOX2w: calls $3
*** FLOP *** [7d 8d Js]
j7NIOHLZk7V2o9fOioO5ug: checks
o8A5MUdudVKu+pAwgZOX2w: bets $4
TalCiLYHCd+ffkmR3auPvA: calls $4
j7NIOHLZk7V2o9fOioO5ug: folds
*** TURN *** [7d 8d Js] [2c]
o8A5MUdudVKu+pAwgZOX2w: bets $5
TalCiLYHCd+ffkmR3auPvA: calls $5
*** RIVER *** [7d 8d Js 2c] [Ts]
o8A5MUdudVKu+pAwgZOX2w: checks
TalCiLYHCd+ffkmR3auPvA: bets $15
o8A5MUdudVKu+pAwgZOX2w: folds
TalCiLYHCd+ffkmR3auPvA collected $29.50 from pot
TalCiLYHCd+ffkmR3auPvA: doesn't show hand
*** SUMMARY ***
Total pot $31 | Rake $1.50
Board [7d 8d Js 2c Ts]
Seat 1: o8A5MUdudVKu+pAwgZOX2w folded on the River
Seat 2: XvUbOIg94d25feWeQlOTVg folded before Flop (didn't bet)
Seat 3: TalCiLYHCd+ffkmR3auPvA (button) collected ($29.50)
Seat 4: TSuRyAHnUPCFjP7Z0rEE0w (small blind) folded before Flop
Seat 5: j7NIOHLZk7V2o9fOioO5ug (big blind) folded on the Flop
Seat 6: YsLQ3BAvgQHWXMAv3Wv6Hg folded before Flop (didn't bet)



PokerStars Game #59939801572:  Hold'em No Limit ($0.50/$1.00) - 2009/07/01 0:49:18 ET
Table '+cA8mcmhaedZ7YcrDdhmeQ' 6-max Seat #1 is the button
Seat 1: lsLuWlcPA3Rh7kJVLzMh0Q ($289 in chips)
Seat 2: RqgF7gRoKgRNW8Zoi1ty4A ($100.50 in chips)
Seat 3: 7H5WkGzGvsv56y1iaqHvRg ($35.85 in chips)
Seat 4: LjL3AIERHn559yyW1mTUYQ ($173.30 in chips)
Seat 5: +7hFKAL0b0O/n8G72TclJA ($50 in chips)
Seat 6: YfsTQsY/fxb+YqbdclTHuw ($48.70 in chips)
RqgF7gRoKgRNW8Zoi1ty4A: posts small blind $0.50
7H5WkGzGvsv56y1iaqHvRg: posts big blind $1
*** HOLE CARDS ***
LjL3AIERHn559yyW1mTUYQ: calls $1
+7hFKAL0b0O/n8G72TclJA: folds
YfsTQsY/fxb+YqbdclTHuw: folds
lsLuWlcPA3Rh7kJVLzMh0Q: folds
RqgF7gRoKgRNW8Zoi1ty4A: folds
7H5WkGzGvsv56y1iaqHvRg: checks
*** FLOP *** [3d Qh 8h]
7H5WkGzGvsv56y1iaqHvRg: checks
LjL3AIERHn559yyW1mTUYQ: bets $2
7H5WkGzGvsv56y1iaqHvRg: folds
LjL3AIERHn559yyW1mTUYQ collected $2.40 from pot
*** SUMMARY ***
Total pot $2.50 | Rake $0.10
Board [3d Qh 8h]
Seat 1: lsLuWlcPA3Rh7kJVLzMh0Q (button) folded before Flop (didn't bet)
Seat 2: RqgF7gRoKgRNW8Zoi1ty4A (small blind) folded before Flop
Seat 3: 7H5WkGzGvsv56y1iaqHvRg (big blind) folded on the Flop
Seat 4: LjL3AIERHn559yyW1mTUYQ collected ($2.40)
Seat 5: +7hFKAL0b0O/n8G72TclJA folded before Flop (didn't bet)
Seat 6: YfsTQsY/fxb+YqbdclTHuw folded before Flop (didn't bet)



PokerStars Game #59939803280:  Hold'em No Limit ($0.50/$1.00) - 2009/07/01 0:49:21 ET
Table 'rmZfTK+oSebeUPJNbWhdAA' 6-max Seat #5 is the button
Seat 1: xAU6q2/cwmby2sxmA8VcmA ($100 in chips)
Seat 2: z7O9PO/WEcqRouIydFhS9Q ($114.45 in chips)
Seat 3: 9yjOzGERLaEZS8CZ6YNHFg ($114.35 in chips)
Seat 4: 1/mIuXfgx1ZyVkodrmfQDw ($100 in chips)
Seat 5: 5lY8d6Cnm4HUkt/8FZSj4g ($80.45 in chips)
Seat 6: j7NIOHLZk7V2o9fOioO5ug ($135.80 in chips)
j7NIOHLZk7V2o9fOioO5ug: posts small blind $0.50
xAU6q2/cwmby2sxmA8VcmA: posts big blind $1
*** HOLE CARDS ***
z7O9PO/WEcqRouIydFhS9Q: folds
9yjOzGERLaEZS8CZ6YNHFg: folds
1/mIuXfgx1ZyVkodrmfQDw: raises $2 to $3
5lY8d6Cnm4HUkt/8FZSj4g: calls $3
j7NIOHLZk7V2o9fOioO5ug: folds
xAU6q2/cwmby2sxmA8VcmA: folds
*** FLOP *** [7d 3s Ts]
1/mIuXfgx1ZyVkodrmfQDw: bets $5
5lY8d6Cnm4HUkt/8FZSj4g: calls $5
*** TURN *** [7d 3s Ts] [5s]
1/mIuXfgx1ZyVkodrmfQDw: checks
5lY8d6Cnm4HUkt/8FZSj4g: bets $8
1/mIuXfgx1ZyVkodrmfQDw: calls $8
*** RIVER *** [7d 3s Ts 5s] [9h]
9yjOzGERLaEZS8CZ6YNHFg leaves the table
1/mIuXfgx1ZyVkodrmfQDw: checks
5lY8d6Cnm4HUkt/8FZSj4g: checks
*** SHOW DOWN ***
1/mIuXfgx1ZyVkodrmfQDw: shows [9s Td] (two pair, Tens and Nines)
5lY8d6Cnm4HUkt/8FZSj4g: shows [3d 3c] (three of a kind, Threes)
5lY8d6Cnm4HUkt/8FZSj4g collected $31.90 from pot
*** SUMMARY ***
Total pot $33.50 | Rake $1.60
Board [7d 3s Ts 5s 9h]
Seat 1: xAU6q2/cwmby2sxmA8VcmA (big blind) folded before Flop
Seat 2: z7O9PO/WEcqRouIydFhS9Q folded before Flop (didn't bet)
Seat 3: 9yjOzGERLaEZS8CZ6YNHFg folded before Flop (didn't bet)
Seat 4: 1/mIuXfgx1ZyVkodrmfQDw showed [9s Td] and lost with two pair, Tens and Nines
Seat 5: 5lY8d6Cnm4HUkt/8FZSj4g (button) showed [3d 3c] and won ($31.90) with three of a kind, Threes
Seat 6: j7NIOHLZk7V2o9fOioO5ug (small blind) folded before Flop



PokerStars Game #59939804438:  Hold'em No Limit ($0.50/$1.00) - 2009/07/01 0:49:23 ET
Table 'N2bNCDHL96aCQDvZIh+yQQ' 6-max Seat #1 is the button
Seat 1: iHo1oDbrEVJ8nEGdaPrICw ($105.50 in chips)
Seat 3: Qy/UBNbD2HaA0Ogxg8Sf3w ($159.70 in chips)
Seat 4: uCqEjnxh2/vFBjKYkfTOkw ($175.55 in chips)
Seat 6: TSuRyAHnUPCFjP7Z0rEE0w ($100 in chips)
KpnW5CcJ4Mg6MeclfKmLrw: is sitting out
Qy/UBNbD2HaA0Ogxg8Sf3w: posts small blind $0.50
uCqEjnxh2/vFBjKYkfTOkw: posts big blind $1
ZIdFTzUiF+cFsap66otbHg: sits out
*** HOLE CARDS ***
TSuRyAHnUPCFjP7Z0rEE0w: folds
iHo1oDbrEVJ8nEGdaPrICw: raises $2 to $3
Qy/UBNbD2HaA0Ogxg8Sf3w: folds
uCqEjnxh2/vFBjKYkfTOkw: folds
iHo1oDbrEVJ8nEGdaPrICw collected $2.50 from pot
iHo1oDbrEVJ8nEGdaPrICw: doesn't show hand
*** SUMMARY ***
Total pot $2.50 | Rake $0
Seat 1: iHo1oDbrEVJ8nEGdaPrICw (button) collected ($2.50)
Seat 3: Qy/UBNbD2HaA0Ogxg8Sf3w (small blind) folded before Flop
Seat 4: uCqEjnxh2/vFBjKYkfTOkw (big blind) folded before Flop
Seat 6: TSuRyAHnUPCFjP7Z0rEE0w folded before Flop (didn't bet)



PokerStars Game #59939804652:  Hold'em No Limit ($0.50/$1.00) - 2009/07/01 0:49:23 ET
Table 'vs/5jr6ciwjVQ5+Soc+u2A' 6-max Seat #4 is the button
Seat 2: XOIf9W+VAxhZqN+SYoyMKA ($126.85 in chips)
Seat 3: G5ZSSN6RSON3gkNvk/SmYg ($150 in chips)
Seat 4: KpnW5CcJ4Mg6MeclfKmLrw ($127.50 in chips)
Seat 5: 2DwLxMUbmzvwY7o4/i47Xg ($39.50 in chips)
Seat 6: qAdBJlVNsNTwiHia50eMvg ($78.50 in chips)
2DwLxMUbmzvwY7o4/i47Xg: posts small blind $0.50
qAdBJlVNsNTwiHia50eMvg: posts big blind $1
/P4w1pHg2zHYg/4ubJ0dPw: sits out
*** HOLE CARDS ***
XOIf9W+VAxhZqN+SYoyMKA: folds
G5ZSSN6RSON3gkNvk/SmYg: folds
KpnW5CcJ4Mg6MeclfKmLrw: raises $2 to $3
2DwLxMUbmzvwY7o4/i47Xg: folds
qAdBJlVNsNTwiHia50eMvg: calls $2
*** FLOP *** [Ts Kc 7d]
qAdBJlVNsNTwiHia50eMvg: checks
KpnW5CcJ4Mg6MeclfKmLrw: bets $5
qAdBJlVNsNTwiHia50eMvg: folds
KpnW5CcJ4Mg6MeclfKmLrw collected $6.20 from pot
KpnW5CcJ4Mg6MeclfKmLrw: doesn't show hand
*** SUMMARY ***
Total pot $6.50 | Rake $0.30
Board [Ts Kc 7d]
Seat 2: XOIf9W+VAxhZqN+SYoyMKA folded before Flop (didn't bet)
Seat 3: G5ZSSN6RSON3gkNvk/SmYg folded before Flop (didn't bet)
Seat 4: KpnW5CcJ4Mg6MeclfKmLrw (button) collected ($6.20)
Seat 5: 2DwLxMUbmzvwY7o4/i47Xg (small blind) folded before Flop
Seat 6: qAdBJlVNsNTwiHia50eMvg (big blind) folded on the Flop



PokerStars Game #59939804210:  Hold'em No Limit ($0.50/$1.00) - 2009/07/01 0:49:23 ET
Table 'uNlePsyMIqzM691Xkrlk6Q' 9-max Seat #3 is the button
Seat 1: bLbSOSmSOnqE0iTcH/5dxA ($100 in chips)
Seat 2: +OqpStnt0FqbCfyHAWaLbg ($88.60 in chips)
Seat 3: h7qXkU57Bb8ZuPwMyxR8Ug ($32.85 in chips)
Seat 4: TZcz9MEWDA+WydgGruqqbw ($101.65 in chips)
Seat 5: 3obndzTJ6fECz8+wWhMd1w ($18.50 in chips)
Seat 7: w6cw9nzN7AvkkHBVVjykoQ ($45.90 in chips)
Seat 8: laA8va+Yv8WuMqT1zdR91g ($100 in chips)
Seat 9: vR4IO10geOgvTW+LAUBv/A ($100.75 in chips)
TZcz9MEWDA+WydgGruqqbw: posts small blind $0.50
3obndzTJ6fECz8+wWhMd1w: posts big blind $1
myIxN7otsyr846M539YR8Q: sits out
*** HOLE CARDS ***
w6cw9nzN7AvkkHBVVjykoQ: folds
laA8va+Yv8WuMqT1zdR91g: folds
vR4IO10geOgvTW+LAUBv/A: raises $2 to $3
bLbSOSmSOnqE0iTcH/5dxA: folds
+OqpStnt0FqbCfyHAWaLbg: folds
h7qXkU57Bb8ZuPwMyxR8Ug: folds
TZcz9MEWDA+WydgGruqqbw: folds
3obndzTJ6fECz8+wWhMd1w: folds
vR4IO10geOgvTW+LAUBv/A collected $2.50 from pot
vR4IO10geOgvTW+LAUBv/A: doesn't show hand
*** SUMMARY ***
Total pot $2.50 | Rake $0
Seat 1: bLbSOSmSOnqE0iTcH/5dxA folded before Flop (didn't bet)
Seat 2: +OqpStnt0FqbCfyHAWaLbg folded before Flop (didn't bet)
Seat 3: h7qXkU57Bb8ZuPwMyxR8Ug (button) folded before Flop (didn't bet)
Seat 4: TZcz9MEWDA+WydgGruqqbw (small blind) folded before Flop
Seat 5: 3obndzTJ6fECz8+wWhMd1w (big blind) folded before Flop
Seat 7: w6cw9nzN7AvkkHBVVjykoQ folded before Flop (didn't bet)
Seat 8: laA8va+Yv8WuMqT1zdR91g folded before Flop (didn't bet)
Seat 9: vR4IO10geOgvTW+LAUBv/A collected ($2.50)



PokerStars Game #59939805114:  Hold'em No Limit ($0.50/$1.00) - 2009/07/01 0:49:24 ET
Table '7Nl0ffnjeK44/vmeexh3MQ' 9-max Seat #1 is the button
Seat 1: s7D3Y+k4Cj4D1cXHv7oj+Q ($90.85 in chips)
Seat 2: OGgaARGdJQT4awWVNQ957w ($100 in chips)
Seat 3: vR4IO10geOgvTW+LAUBv/A ($100 in chips)
Seat 4: bLbSOSmSOnqE0iTcH/5dxA ($108.50 in chips)
Seat 5: bL+QVeDcuEdzMGAGg2XJHg ($105.05 in chips)
Seat 6: FVs16t7GgfWgQWt4JxsObQ ($26.50 in chips)
Seat 7: 997ViqAtWn1FPjJqcffwcA ($100 in chips)
Seat 8: zanka7aAZkigmZpfopXxxA ($256.35 in chips)
Seat 9: ouwUBGRKnKK9uhn1G4Lf+A ($95 in chips)
OGgaARGdJQT4awWVNQ957w: posts small blind $0.50
vR4IO10geOgvTW+LAUBv/A: posts big blind $1
*** HOLE CARDS ***
bLbSOSmSOnqE0iTcH/5dxA: folds
bL+QVeDcuEdzMGAGg2XJHg: folds
FVs16t7GgfWgQWt4JxsObQ: folds
997ViqAtWn1FPjJqcffwcA: folds
zanka7aAZkigmZpfopXxxA: raises $2 to $3
ouwUBGRKnKK9uhn1G4Lf+A: raises $6 to $9
s7D3Y+k4Cj4D1cXHv7oj+Q: folds
OGgaARGdJQT4awWVNQ957w: folds
vR4IO10geOgvTW+LAUBv/A: folds
zanka7aAZkigmZpfopXxxA: folds
ouwUBGRKnKK9uhn1G4Lf+A collected $7.50 from pot
ouwUBGRKnKK9uhn1G4Lf+A: doesn't show hand
*** SUMMARY ***
Total pot $7.50 | Rake $0
Seat 1: s7D3Y+k4Cj4D1cXHv7oj+Q (button) folded before Flop (didn't bet)
Seat 2: OGgaARGdJQT4awWVNQ957w (small blind) folded before Flop
Seat 3: vR4IO10geOgvTW+LAUBv/A (big blind) folded before Flop
Seat 4: bLbSOSmSOnqE0iTcH/5dxA folded before Flop (didn't bet)
Seat 5: bL+QVeDcuEdzMGAGg2XJHg folded before Flop (didn't bet)
Seat 6: FVs16t7GgfWgQWt4JxsObQ folded before Flop (didn't bet)
Seat 7: 997ViqAtWn1FPjJqcffwcA folded before Flop (didn't bet)
Seat 8: zanka7aAZkigmZpfopXxxA folded before Flop
Seat 9: ouwUBGRKnKK9uhn1G4Lf+A collected ($7.50)



PokerStars Game #59939807386:  Hold'em No Limit ($0.50/$1.00) - 2009/07/01 0:49:28 ET
Table 'Zka9tv1yilg0MvXWPQrShg' 9-max Seat #9 is the button
Seat 1: TZcz9MEWDA+WydgGruqqbw ($112.85 in chips)
Seat 2: kz9ziSiGUc+857heiKSayw ($20 in chips)
Seat 3: gUUvmqdVlmvpal6B8nYrmg ($100 in chips)
Seat 4: stxmTgSicxShtrDxhOOX2g ($69.25 in chips)
Seat 5: /zy+DB4S5fUQUSfZWFzYGw ($124.90 in chips)
Seat 6: rY8wPoax1lS+HUY+I0FZDw ($146.45 in chips)
Seat 7: p1SafS90nb3Uft5LB0NkHw ($17.50 in chips)
Seat 8: bL+QVeDcuEdzMGAGg2XJHg ($122.10 in chips)
Seat 9: 6daxhj43mWj04MOPTOmaYA ($92.65 in chips)
TZcz9MEWDA+WydgGruqqbw: posts small blind $0.50
kz9ziSiGUc+857heiKSayw: posts big blind $1
*** HOLE CARDS ***
gUUvmqdVlmvpal6B8nYrmg: folds
stxmTgSicxShtrDxhOOX2g: folds
/zy+DB4S5fUQUSfZWFzYGw: folds
rY8wPoax1lS+HUY+I0FZDw: folds
p1SafS90nb3Uft5LB0NkHw: folds
bL+QVeDcuEdzMGAGg2XJHg: folds
6daxhj43mWj04MOPTOmaYA: folds
TZcz9MEWDA+WydgGruqqbw: folds
kz9ziSiGUc+857heiKSayw collected $1 from pot
*** SUMMARY ***
Total pot $1 | Rake $0
Seat 1: TZcz9MEWDA+WydgGruqqbw (small blind) folded before Flop
Seat 2: kz9ziSiGUc+857heiKSayw (big blind) collected ($1)
Seat 3: gUUvmqdVlmvpal6B8nYrmg folded before Flop (didn't bet)
Seat 4: stxmTgSicxShtrDxhOOX2g folded before Flop (didn't bet)
Seat 5: /zy+DB4S5fUQUSfZWFzYGw folded before Flop (didn't bet)
Seat 6: rY8wPoax1lS+HUY+I0FZDw folded before Flop (didn't bet)
Seat 7: p1SafS90nb3Uft5LB0NkHw folded before Flop (didn't bet)
Seat 8: bL+QVeDcuEdzMGAGg2XJHg folded before Flop (didn't bet)
Seat 9: 6daxhj43mWj04MOPTOmaYA (button) folded before Flop (didn't bet)



PokerStars Game #59939808574:  Hold'em No Limit ($0.50/$1.00) - 2009/07/01 0:49:30 ET
Table '/RZcOwpZpHQ+OwPwjsbnRw' 6-max Seat #2 is the button
Seat 1: Zboa6dColKGHBjLPUakZjw ($38.90 in chips)
Seat 2: +xW7QemQU0Fxs+4TnqBRow ($193 in chips)
Seat 3: XnT1yK2DD/5FL+0bwuEhqg ($45.45 in chips)
Seat 4: j7NIOHLZk7V2o9fOioO5ug ($121.85 in chips)
Seat 5: wx3sQGkVi2x9wJXuWNHPBw ($182.15 in chips)
Seat 6: XOIf9W+VAxhZqN+SYoyMKA ($293.25 in chips)
XnT1yK2DD/5FL+0bwuEhqg: posts small blind $0.50
j7NIOHLZk7V2o9fOioO5ug: posts big blind $1
*** HOLE CARDS ***
wx3sQGkVi2x9wJXuWNHPBw: folds
XOIf9W+VAxhZqN+SYoyMKA: folds
Zboa6dColKGHBjLPUakZjw: raises $1 to $2
+xW7QemQU0Fxs+4TnqBRow: folds
XnT1yK2DD/5FL+0bwuEhqg: folds
j7NIOHLZk7V2o9fOioO5ug: folds
Zboa6dColKGHBjLPUakZjw collected $2.50 from pot
*** SUMMARY ***
Total pot $2.50 | Rake $0
Seat 1: Zboa6dColKGHBjLPUakZjw collected ($2.50)
Seat 2: +xW7QemQU0Fxs+4TnqBRow (button) folded before Flop (didn't bet)
Seat 3: XnT1yK2DD/5FL+0bwuEhqg (small blind) folded before Flop
Seat 4: j7NIOHLZk7V2o9fOioO5ug (big blind) folded before Flop
Seat 5: wx3sQGkVi2x9wJXuWNHPBw folded before Flop (didn't bet)
Seat 6: XOIf9W+VAxhZqN+SYoyMKA folded before Flop (didn't bet)



PokerStars Game #59939809264:  Hold'em No Limit ($0.50/$1.00) - 2009/07/01 0:49:31 ET
Table 'cKH9c4x6u79IqCdaKKvXrw' 9-max Seat #6 is the button
Seat 1: Pp/KTcXkfZKKUHkjyaLTdg ($17 in chips)
Seat 2: 8S3JMH4TY3whgIlZmMv66w ($58.85 in chips)
Seat 3: 997ViqAtWn1FPjJqcffwcA ($158.60 in chips)
Seat 4: FL3MrLspcF23LYvC4ipBOA ($100 in chips)
Seat 6: Bsd/K5gAcLanYbGiPirRjw ($168.05 in chips)
Seat 7: 1GkkVBhlJ92guE6K5mS5Ig ($48.55 in chips)
Seat 8: 4/8w7g4QE6v0i1tIIf/1HQ ($36.50 in chips)
Seat 9: 6XkTu4ahxzHnvjjc1R8YjQ ($43.60 in chips)
1GkkVBhlJ92guE6K5mS5Ig: posts small blind $0.50
4/8w7g4QE6v0i1tIIf/1HQ: posts big blind $1
Jjc7EHWzs4//xUAjJ0UWoA: sits out
*** HOLE CARDS ***
6XkTu4ahxzHnvjjc1R8YjQ: folds
Pp/KTcXkfZKKUHkjyaLTdg: folds
8S3JMH4TY3whgIlZmMv66w: raises $2 to $3
997ViqAtWn1FPjJqcffwcA: folds
FL3MrLspcF23LYvC4ipBOA: folds
Bsd/K5gAcLanYbGiPirRjw: calls $3
1GkkVBhlJ92guE6K5mS5Ig: calls $2.50
4/8w7g4QE6v0i1tIIf/1HQ: calls $2
*** FLOP *** [2s 6h Jh]
1GkkVBhlJ92guE6K5mS5Ig: checks
4/8w7g4QE6v0i1tIIf/1HQ: checks
8S3JMH4TY3whgIlZmMv66w: checks
Bsd/K5gAcLanYbGiPirRjw: bets $7
1GkkVBhlJ92guE6K5mS5Ig: folds
4/8w7g4QE6v0i1tIIf/1HQ: calls $7
8S3JMH4TY3whgIlZmMv66w: folds
*** TURN *** [2s 6h Jh] [6s]
4/8w7g4QE6v0i1tIIf/1HQ: checks
Bsd/K5gAcLanYbGiPirRjw: bets $14
4/8w7g4QE6v0i1tIIf/1HQ: calls $14
*** RIVER *** [2s 6h Jh 6s] [5s]
4/8w7g4QE6v0i1tIIf/1HQ: bets $12.50 and is all-in
Bsd/K5gAcLanYbGiPirRjw: calls $12.50
*** SHOW DOWN ***
4/8w7g4QE6v0i1tIIf/1HQ: shows [2h 3h] (two pair, Sixes and Deuces)
Bsd/K5gAcLanYbGiPirRjw: shows [Jc Kc] (two pair, Jacks and Sixes)
Bsd/K5gAcLanYbGiPirRjw collected $76 from pot
*** SUMMARY ***
Total pot $79 | Rake $3
Board [2s 6h Jh 6s 5s]
Seat 1: Pp/KTcXkfZKKUHkjyaLTdg folded before Flop (didn't bet)
Seat 2: 8S3JMH4TY3whgIlZmMv66w folded on the Flop
Seat 3: 997ViqAtWn1FPjJqcffwcA folded before Flop (didn't bet)
Seat 4: FL3MrLspcF23LYvC4ipBOA folded before Flop (didn't bet)
Seat 6: Bsd/K5gAcLanYbGiPirRjw (button) showed [Jc Kc] and won ($76) with two pair, Jacks and Sixes
Seat 7: 1GkkVBhlJ92guE6K5mS5Ig (small blind) folded on the Flop
Seat 8: 4/8w7g4QE6v0i1tIIf/1HQ (big blind) showed [2h 3h] and lost with two pair, Sixes and Deuces
Seat 9: 6XkTu4ahxzHnvjjc1R8YjQ folded before Flop (didn't bet)



PokerStars Game #59939809800:  Hold'em No Limit ($0.50/$1.00) - 2009/07/01 0:49:31 ET
Table 'mmbQQVBTrPdE+wy+s+9VPA' 6-max Seat #2 is the button
Seat 2: +W6OnF033KNM2xH0fGj98Q ($120.10 in chips)
Seat 3: wx3sQGkVi2x9wJXuWNHPBw ($114.65 in chips)
Seat 4: RfKnhkJN8HEAuzJpH2Ajdg ($19.25 in chips)
Seat 5: YMJG+F++3Aj6P8dAWda5fw ($95 in chips)
Seat 6: U2CWBTv29qdCbj8RNF2sIw ($100 in chips)
wx3sQGkVi2x9wJXuWNHPBw: posts small blind $0.50
RfKnhkJN8HEAuzJpH2Ajdg: posts big blind $1
JwCcjZl0bjJzG7hmE0dnTA: sits out
*** HOLE CARDS ***
YMJG+F++3Aj6P8dAWda5fw: folds
U2CWBTv29qdCbj8RNF2sIw: folds
+W6OnF033KNM2xH0fGj98Q: raises $2 to $3
wx3sQGkVi2x9wJXuWNHPBw: folds
RfKnhkJN8HEAuzJpH2Ajdg: calls $2
*** FLOP *** [Ad 8d Ts]
RfKnhkJN8HEAuzJpH2Ajdg: checks
+W6OnF033KNM2xH0fGj98Q: bets $4
RfKnhkJN8HEAuzJpH2Ajdg: folds
+W6OnF033KNM2xH0fGj98Q collected $6.20 from pot
*** SUMMARY ***
Total pot $6.50 | Rake $0.30
Board [Ad 8d Ts]
Seat 2: +W6OnF033KNM2xH0fGj98Q (button) collected ($6.20)
Seat 3: wx3sQGkVi2x9wJXuWNHPBw (small blind) folded before Flop
Seat 4: RfKnhkJN8HEAuzJpH2Ajdg (big blind) folded on the Flop
Seat 5: YMJG+F++3Aj6P8dAWda5fw folded before Flop (didn't bet)
Seat 6: U2CWBTv29qdCbj8RNF2sIw folded before Flop (didn't bet)



PokerStars Game #59939810518:  Hold'em No Limit ($0.50/$1.00) - 2009/07/01 0:49:32 ET
Table 'CxlB0XELs5P0zDlOhlhAPw' 2-max Seat #1 is the button
Seat 1: +B2wRsLpIMFnVA7qiRoGfg ($20.30 in chips)
Seat 2: I4xAjioR1QwQ5TgX4Z1/qw ($59.40 in chips)
+B2wRsLpIMFnVA7qiRoGfg: posts small blind $0.50
I4xAjioR1QwQ5TgX4Z1/qw: posts big blind $1
*** HOLE CARDS ***
+B2wRsLpIMFnVA7qiRoGfg: raises $3 to $4
I4xAjioR1QwQ5TgX4Z1/qw: folds
+B2wRsLpIMFnVA7qiRoGfg collected $2 from pot
*** SUMMARY ***
Total pot $2 | Rake $0
Seat 1: +B2wRsLpIMFnVA7qiRoGfg (button) (small blind) collected ($2)
Seat 2: I4xAjioR1QwQ5TgX4Z1/qw (big blind) folded before Flop



PokerStars Game #59939810188:  Hold'em No Limit ($0.50/$1.00) - 2009/07/01 0:49:32 ET
Table '6YvsYDPNIDx2v5z3bJnwZQ' 9-max Seat #3 is the button
Seat 1: Ogn4JDV3mp4ZDKO49IFzKA ($19.70 in chips)
Seat 2: x80+i7DJL+81v3quj7KbNg ($20 in chips)
Seat 3: negfosHnGOZXSHpWDRKyBQ ($20 in chips)
Seat 4: kEr5NYB+JIG5+szcYMr6hA ($39.50 in chips)
Seat 5: mBRWbnUl8diyBO1qTJaNzw ($166.70 in chips)
Seat 6: 7RSwrjMohkYrZAhOd1uaZg ($19 in chips)
Seat 7: mae7OMTaJ/MFimNbZegCkg ($49 in chips)
Seat 8: PSFxpXgPedVZyHSu2Zhb7Q ($103.05 in chips)
Seat 9: ZgMRSHJ9EOtPeVHmdeV9kQ ($59 in chips)
kEr5NYB+JIG5+szcYMr6hA: posts small blind $0.50
mBRWbnUl8diyBO1qTJaNzw: posts big blind $1
*** HOLE CARDS ***
7RSwrjMohkYrZAhOd1uaZg: folds
mae7OMTaJ/MFimNbZegCkg: folds
PSFxpXgPedVZyHSu2Zhb7Q: folds
ZgMRSHJ9EOtPeVHmdeV9kQ: raises $1 to $2
Ogn4JDV3mp4ZDKO49IFzKA: folds
x80+i7DJL+81v3quj7KbNg: folds
negfosHnGOZXSHpWDRKyBQ: folds
kEr5NYB+JIG5+szcYMr6hA: calls $1.50
mBRWbnUl8diyBO1qTJaNzw: folds
*** FLOP *** [4s 8c Jc]
kEr5NYB+JIG5+szcYMr6hA: checks
ZgMRSHJ9EOtPeVHmdeV9kQ: checks
*** TURN *** [4s 8c Jc] [Qd]
kEr5NYB+JIG5+szcYMr6hA: checks
ZgMRSHJ9EOtPeVHmdeV9kQ: checks
*** RIVER *** [4s 8c Jc Qd] [5h]
kEr5NYB+JIG5+szcYMr6hA: bets $3
ZgMRSHJ9EOtPeVHmdeV9kQ: folds
kEr5NYB+JIG5+szcYMr6hA collected $4.75 from pot
*** SUMMARY ***
Total pot $5 | Rake $0.25
Board [4s 8c Jc Qd 5h]
Seat 1: Ogn4JDV3mp4ZDKO49IFzKA folded before Flop (didn't bet)
Seat 2: x80+i7DJL+81v3quj7KbNg folded before Flop (didn't bet)
Seat 3: negfosHnGOZXSHpWDRKyBQ (button) folded before Flop (didn't bet)
Seat 4: kEr5NYB+JIG5+szcYMr6hA (small blind) collected ($4.75)
Seat 5: mBRWbnUl8diyBO1qTJaNzw (big blind) folded before Flop
Seat 6: 7RSwrjMohkYrZAhOd1uaZg folded before Flop (didn't bet)
Seat 7: mae7OMTaJ/MFimNbZegCkg folded before Flop (didn't bet)
Seat 8: PSFxpXgPedVZyHSu2Zhb7Q folded before Flop (didn't bet)
Seat 9: ZgMRSHJ9EOtPeVHmdeV9kQ folded on the River



PokerStars Game #59939812342:  Hold'em No Limit ($0.50/$1.00) - 2009/07/01 0:49:35 ET
Table 'tLrtq7gDzxEvckNAI1OS5Q' 6-max Seat #3 is the button
Seat 1: xNKcQzD9+/iHmtJn4vYq9w ($98.55 in chips)
Seat 2: QHvTZcrKe6+maWUfVjP29Q ($105.35 in chips)
Seat 3: TPZ+m9x+lwoKpv7TMfAUWA ($216.20 in chips)
Seat 4: +uSzP8Jwnw7sKfQ4s66b7w ($45.50 in chips)
Seat 5: OGMLOcTNYZXZU81au7ztUw ($154.25 in chips)
Seat 6: XUk5GQsfNFpHvaToDZ0rZA ($168.20 in chips)
+uSzP8Jwnw7sKfQ4s66b7w: posts small blind $0.50
OGMLOcTNYZXZU81au7ztUw: posts big blind $1
*** HOLE CARDS ***
XUk5GQsfNFpHvaToDZ0rZA: folds
xNKcQzD9+/iHmtJn4vYq9w: folds
QHvTZcrKe6+maWUfVjP29Q: folds
TPZ+m9x+lwoKpv7TMfAUWA: raises $2 to $3
+uSzP8Jwnw7sKfQ4s66b7w: folds
OGMLOcTNYZXZU81au7ztUw: folds
TPZ+m9x+lwoKpv7TMfAUWA collected $2.50 from pot
*** SUMMARY ***
Total pot $2.50 | Rake $0
Seat 1: xNKcQzD9+/iHmtJn4vYq9w folded before Flop (didn't bet)
Seat 2: QHvTZcrKe6+maWUfVjP29Q folded before Flop (didn't bet)
Seat 3: TPZ+m9x+lwoKpv7TMfAUWA (button) collected ($2.50)
Seat 4: +uSzP8Jwnw7sKfQ4s66b7w (small blind) folded before Flop
Seat 5: OGMLOcTNYZXZU81au7ztUw (big blind) folded before Flop
Seat 6: XUk5GQsfNFpHvaToDZ0rZA folded before Flop (didn't bet)



PokerStars Game #59939813608:  Hold'em No Limit ($0.50/$1.00) - 2009/07/01 0:49:37 ET
Table 'LmXQK9xy3awB+qsPzI21Mw' 2-max Seat #2 is the button
Seat 1: NYi6JFscYNrofSXy4sM+Yw ($198.45 in chips)
Seat 2: TME8GvochpQAo8cmJwWmvA ($132.15 in chips)
TME8GvochpQAo8cmJwWmvA: posts small blind $0.50
NYi6JFscYNrofSXy4sM+Yw: posts big blind $1
*** HOLE CARDS ***
TME8GvochpQAo8cmJwWmvA: calls $0.50
NYi6JFscYNrofSXy4sM+Yw: raises $2 to $3
TME8GvochpQAo8cmJwWmvA: calls $2
*** FLOP *** [8h 4c 7d]
NYi6JFscYNrofSXy4sM+Yw: checks
TME8GvochpQAo8cmJwWmvA: checks
*** TURN *** [8h 4c 7d] [9s]
NYi6JFscYNrofSXy4sM+Yw: bets $2
TME8GvochpQAo8cmJwWmvA: calls $2
*** RIVER *** [8h 4c 7d 9s] [7s]
NYi6JFscYNrofSXy4sM+Yw: checks
TME8GvochpQAo8cmJwWmvA: bets $3
NYi6JFscYNrofSXy4sM+Yw: folds
TME8GvochpQAo8cmJwWmvA collected $9.55 from pot
TME8GvochpQAo8cmJwWmvA: doesn't show hand
*** SUMMARY ***
Total pot $10 | Rake $0.45
Board [8h 4c 7d 9s 7s]
Seat 1: NYi6JFscYNrofSXy4sM+Yw (big blind) folded on the River
Seat 2: TME8GvochpQAo8cmJwWmvA (button) (small blind) collected ($9.55)



PokerStars Game #59939814128:  Hold'em No Limit ($0.50/$1.00) - 2009/07/01 0:49:38 ET
Table 'GxCPo/gd3OSthkYrAxJngg' 6-max Seat #2 is the button
Seat 1: sH8BpAFP+jGFxCgVpD1Lew ($259.85 in chips)
Seat 2: YExX2paeIHrmfIwV1ivM/w ($76.70 in chips)
Seat 3: o6plE+MSW4XFNTeONe16xg ($30.10 in chips)
Seat 4: YMJG+F++3Aj6P8dAWda5fw ($106.65 in chips)
Seat 5: G5ZSSN6RSON3gkNvk/SmYg ($108.25 in chips)
Seat 6: sS9IXedL3MiRmpVXhAILhw ($103.45 in chips)
o6plE+MSW4XFNTeONe16xg: posts small blind $0.50
YMJG+F++3Aj6P8dAWda5fw: posts big blind $1
*** HOLE CARDS ***
G5ZSSN6RSON3gkNvk/SmYg: folds
sS9IXedL3MiRmpVXhAILhw: folds
sH8BpAFP+jGFxCgVpD1Lew: raises $3 to $4
YExX2paeIHrmfIwV1ivM/w: folds
o6plE+MSW4XFNTeONe16xg: folds
YMJG+F++3Aj6P8dAWda5fw: folds
sH8BpAFP+jGFxCgVpD1Lew collected $2.50 from pot
*** SUMMARY ***
Total pot $2.50 | Rake $0
Seat 1: sH8BpAFP+jGFxCgVpD1Lew collected ($2.50)
Seat 2: YExX2paeIHrmfIwV1ivM/w (button) folded before Flop (didn't bet)
Seat 3: o6plE+MSW4XFNTeONe16xg (small blind) folded before Flop
Seat 4: YMJG+F++3Aj6P8dAWda5fw (big blind) folded before Flop
Seat 5: G5ZSSN6RSON3gkNvk/SmYg folded before Flop (didn't bet)
Seat 6: sS9IXedL3MiRmpVXhAILhw folded before Flop (didn't bet)



PokerStars Game #59939814310:  Hold'em No Limit ($0.50/$1.00) - 2009/07/01 0:49:39 ET
Table 'N2bNCDHL96aCQDvZIh+yQQ' 6-max Seat #3 is the button
Seat 1: iHo1oDbrEVJ8nEGdaPrICw ($107 in chips)
Seat 3: Qy/UBNbD2HaA0Ogxg8Sf3w ($159.20 in chips)
Seat 4: uCqEjnxh2/vFBjKYkfTOkw ($174.55 in chips)
Seat 5: ZIdFTzUiF+cFsap66otbHg ($22 in chips)
Seat 6: TSuRyAHnUPCFjP7Z0rEE0w ($100 in chips)
uCqEjnxh2/vFBjKYkfTOkw: posts small blind $0.50
ZIdFTzUiF+cFsap66otbHg: posts big blind $1
*** HOLE CARDS ***
TSuRyAHnUPCFjP7Z0rEE0w: folds
iHo1oDbrEVJ8nEGdaPrICw: folds
Qy/UBNbD2HaA0Ogxg8Sf3w: raises $1.50 to $2.50
uCqEjnxh2/vFBjKYkfTOkw: folds
ZIdFTzUiF+cFsap66otbHg: folds
Qy/UBNbD2HaA0Ogxg8Sf3w collected $2.50 from pot
Qy/UBNbD2HaA0Ogxg8Sf3w: doesn't show hand
*** SUMMARY ***
Total pot $2.50 | Rake $0
Seat 1: iHo1oDbrEVJ8nEGdaPrICw folded before Flop (didn't bet)
Seat 3: Qy/UBNbD2HaA0Ogxg8Sf3w (button) collected ($2.50)
Seat 4: uCqEjnxh2/vFBjKYkfTOkw (small blind) folded before Flop
Seat 5: ZIdFTzUiF+cFsap66otbHg (big blind) folded before Flop
Seat 6: TSuRyAHnUPCFjP7Z0rEE0w folded before Flop (didn't bet)



PokerStars Game #59939815330:  Hold'em No Limit ($0.50/$1.00) - 2009/07/01 0:49:40 ET
Table 'SQLOQoANiHscJ8AL7zffbw' 9-max Seat #5 is the button
Seat 1: jPTRd6SpCp4xqAy2XQiTOw ($118.10 in chips)
Seat 2: /zy+DB4S5fUQUSfZWFzYGw ($273.35 in chips)
Seat 3: 0eFnow7+D7veCYQ+CG9FFw ($94.85 in chips)
Seat 4: /mfensKw8/iZ1Vrx33S4xg ($20 in chips)
Seat 5: L9njYvloJ1NdXjP8edHEAg ($105.55 in chips)
Seat 6: p5UKaxVobvptF0ANhR/q1A ($173.50 in chips)
Seat 7: bJckevFOcg//s0qyMQI6sQ ($100 in chips)
Seat 8: Pp/KTcXkfZKKUHkjyaLTdg ($58.50 in chips)
Seat 9: qJr25HAtvv1w/7IBvjMM3g ($198.75 in chips)
p5UKaxVobvptF0ANhR/q1A: posts small blind $0.50
bJckevFOcg//s0qyMQI6sQ: posts big blind $1
/mfensKw8/iZ1Vrx33S4xg: posts big blind $1
*** HOLE CARDS ***
Pp/KTcXkfZKKUHkjyaLTdg: folds
Pp/KTcXkfZKKUHkjyaLTdg leaves the table
qJr25HAtvv1w/7IBvjMM3g: folds
jPTRd6SpCp4xqAy2XQiTOw: folds
/zy+DB4S5fUQUSfZWFzYGw: folds
0eFnow7+D7veCYQ+CG9FFw: folds
/mfensKw8/iZ1Vrx33S4xg: checks
L9njYvloJ1NdXjP8edHEAg: raises $3 to $4
2BV+oJIQYr65IO6nEChvbA joins the table at seat #8
p5UKaxVobvptF0ANhR/q1A: folds
bJckevFOcg//s0qyMQI6sQ: folds
/mfensKw8/iZ1Vrx33S4xg: calls $3
*** FLOP *** [Ah Qs 4c]
/mfensKw8/iZ1Vrx33S4xg: checks
L9njYvloJ1NdXjP8edHEAg: bets $4
/mfensKw8/iZ1Vrx33S4xg: folds
L9njYvloJ1NdXjP8edHEAg collected $9.05 from pot
*** SUMMARY ***
Total pot $9.50 | Rake $0.45
Board [Ah Qs 4c]
Seat 1: jPTRd6SpCp4xqAy2XQiTOw folded before Flop (didn't bet)
Seat 2: /zy+DB4S5fUQUSfZWFzYGw folded before Flop (didn't bet)
Seat 3: 0eFnow7+D7veCYQ+CG9FFw folded before Flop (didn't bet)
Seat 4: /mfensKw8/iZ1Vrx33S4xg folded on the Flop
Seat 5: L9njYvloJ1NdXjP8edHEAg (button) collected ($9.05)
Seat 6: p5UKaxVobvptF0ANhR/q1A (small blind) folded before Flop
Seat 7: bJckevFOcg//s0qyMQI6sQ (big blind) folded before Flop
Seat 8: Pp/KTcXkfZKKUHkjyaLTdg folded before Flop (didn't bet)
Seat 9: qJr25HAtvv1w/7IBvjMM3g folded before Flop (didn't bet)



PokerStars Game #59939816942:  Hold'em No Limit ($0.50/$1.00) - 2009/07/01 0:49:43 ET
Table 'pHrhryH8jPNdQfY62f8v+g' 6-max Seat #3 is the button
Seat 1: fF4botNMr8/ieVPO1YYRLw ($56 in chips)
Seat 2: RqgF7gRoKgRNW8Zoi1ty4A ($100.25 in chips)
Seat 3: 8oS5O7iD/qnFXFXJrGIgNQ ($100 in chips)
Seat 4: wenbG7TaM3H7h5kn78OFNw ($56.20 in chips)
Seat 5: r1/R7y0Ortgoz4lccgW8VA ($55.90 in chips)
Seat 6: xAU6q2/cwmby2sxmA8VcmA ($118.80 in chips)
wenbG7TaM3H7h5kn78OFNw: posts small blind $0.50
r1/R7y0Ortgoz4lccgW8VA: posts big blind $1
*** HOLE CARDS ***
xAU6q2/cwmby2sxmA8VcmA: folds
fF4botNMr8/ieVPO1YYRLw: folds
RqgF7gRoKgRNW8Zoi1ty4A: raises $2 to $3
8oS5O7iD/qnFXFXJrGIgNQ: folds
wenbG7TaM3H7h5kn78OFNw: folds
r1/R7y0Ortgoz4lccgW8VA: folds
RqgF7gRoKgRNW8Zoi1ty4A collected $2.50 from pot
*** SUMMARY ***
Total pot $2.50 | Rake $0
Seat 1: fF4botNMr8/ieVPO1YYRLw folded before Flop (didn't bet)
Seat 2: RqgF7gRoKgRNW8Zoi1ty4A collected ($2.50)
Seat 3: 8oS5O7iD/qnFXFXJrGIgNQ (button) folded before Flop (didn't bet)
Seat 4: wenbG7TaM3H7h5kn78OFNw (small blind) folded before Flop
Seat 5: r1/R7y0Ortgoz4lccgW8VA (big blind) folded before Flop
Seat 6: xAU6q2/cwmby2sxmA8VcmA folded before Flop (didn't bet)



PokerStars Game #59939817292:  Hold'em No Limit ($0.50/$1.00) - 2009/07/01 0:49:43 ET
Table '/RZcOwpZpHQ+OwPwjsbnRw' 6-max Seat #3 is the button
Seat 1: Zboa6dColKGHBjLPUakZjw ($40.40 in chips)
Seat 2: +xW7QemQU0Fxs+4TnqBRow ($193 in chips)
Seat 3: XnT1yK2DD/5FL+0bwuEhqg ($44.95 in chips)
Seat 4: j7NIOHLZk7V2o9fOioO5ug ($120.85 in chips)
Seat 5: wx3sQGkVi2x9wJXuWNHPBw ($182.15 in chips)
Seat 6: XOIf9W+VAxhZqN+SYoyMKA ($293.25 in chips)
j7NIOHLZk7V2o9fOioO5ug: posts small blind $0.50
wx3sQGkVi2x9wJXuWNHPBw: posts big blind $1
*** HOLE CARDS ***
XOIf9W+VAxhZqN+SYoyMKA: folds
Zboa6dColKGHBjLPUakZjw: folds
+xW7QemQU0Fxs+4TnqBRow: folds
XnT1yK2DD/5FL+0bwuEhqg: raises $2 to $3
j7NIOHLZk7V2o9fOioO5ug: folds
wx3sQGkVi2x9wJXuWNHPBw: folds
XnT1yK2DD/5FL+0bwuEhqg collected $2.50 from pot
XnT1yK2DD/5FL+0bwuEhqg: doesn't show hand
*** SUMMARY ***
Total pot $2.50 | Rake $0
Seat 1: Zboa6dColKGHBjLPUakZjw folded before Flop (didn't bet)
Seat 2: +xW7QemQU0Fxs+4TnqBRow folded before Flop (didn't bet)
Seat 3: XnT1yK2DD/5FL+0bwuEhqg (button) collected ($2.50)
Seat 4: j7NIOHLZk7V2o9fOioO5ug (small blind) folded before Flop
Seat 5: wx3sQGkVi2x9wJXuWNHPBw (big blind) folded before Flop
Seat 6: XOIf9W+VAxhZqN+SYoyMKA folded before Flop (didn't bet)



PokerStars Game #59939818222:  Hold'em No Limit ($0.50/$1.00) - 2009/07/01 0:49:44 ET
Table 'eU3bWpDDg3Z+9R4m4iVmog' 6-max Seat #4 is the button
Seat 1: TSuRyAHnUPCFjP7Z0rEE0w ($192.65 in chips)
Seat 2: 8CAoOzhmB8n3nRFf3V4BTg ($94.80 in chips)
Seat 3: U6tnjwZRpTnM+YkqkCjwyQ ($187.15 in chips)
Seat 4: GDVIsbEJ/DOJsMKE4Asz0A ($66.80 in chips)
Seat 5: AdLVjddOzm+sRNo1Bc3S6Q ($113.05 in chips)
Seat 6: hpxXcmRkXXI9HE5+5/j/0Q ($121.95 in chips)
AdLVjddOzm+sRNo1Bc3S6Q: posts small blind $0.50
hpxXcmRkXXI9HE5+5/j/0Q: posts big blind $1
*** HOLE CARDS ***
TSuRyAHnUPCFjP7Z0rEE0w: folds
8CAoOzhmB8n3nRFf3V4BTg: raises $2 to $3
U6tnjwZRpTnM+YkqkCjwyQ: folds
GDVIsbEJ/DOJsMKE4Asz0A: folds
AdLVjddOzm+sRNo1Bc3S6Q: calls $2.50
hpxXcmRkXXI9HE5+5/j/0Q: folds
*** FLOP *** [5h 6h 6s]
AdLVjddOzm+sRNo1Bc3S6Q: checks
8CAoOzhmB8n3nRFf3V4BTg: bets $5
AdLVjddOzm+sRNo1Bc3S6Q: calls $5
*** TURN *** [5h 6h 6s] [8h]
AdLVjddOzm+sRNo1Bc3S6Q: checks
8CAoOzhmB8n3nRFf3V4BTg: checks
*** RIVER *** [5h 6h 6s 8h] [3h]
AdLVjddOzm+sRNo1Bc3S6Q: checks
8CAoOzhmB8n3nRFf3V4BTg: checks
*** SHOW DOWN ***
AdLVjddOzm+sRNo1Bc3S6Q: shows [As Js] (a pair of Sixes)
8CAoOzhmB8n3nRFf3V4BTg: shows [9h Ad] (a flush, Nine high)
8CAoOzhmB8n3nRFf3V4BTg collected $16.20 from pot
*** SUMMARY ***
Total pot $17 | Rake $0.80
Board [5h 6h 6s 8h 3h]
Seat 1: TSuRyAHnUPCFjP7Z0rEE0w folded before Flop (didn't bet)
Seat 2: 8CAoOzhmB8n3nRFf3V4BTg showed [9h Ad] and won ($16.20) with a flush, Nine high
Seat 3: U6tnjwZRpTnM+YkqkCjwyQ folded before Flop (didn't bet)
Seat 4: GDVIsbEJ/DOJsMKE4Asz0A (button) folded before Flop (didn't bet)
Seat 5: AdLVjddOzm+sRNo1Bc3S6Q (small blind) showed [As Js] and lost with a pair of Sixes
Seat 6: hpxXcmRkXXI9HE5+5/j/0Q (big blind) folded before Flop



PokerStars Game #59939819020:  Hold'em No Limit ($0.50/$1.00) - 2009/07/01 0:49:46 ET
Table 'VOs36P6NW+QyXeQ1B62kmA' 6-max Seat #1 is the button
Seat 1: AdLVjddOzm+sRNo1Bc3S6Q ($130.80 in chips)
Seat 2: KpnW5CcJ4Mg6MeclfKmLrw ($118.35 in chips)
Seat 3: TSuRyAHnUPCFjP7Z0rEE0w ($100 in chips)
Seat 4: w02zQzNydODiyV9THKgo9w ($29.30 in chips)
Seat 5: ozrlafxxh1HmYdA0/h+MuA ($27.30 in chips)
Seat 6: 6tvjsJrdmWg+g7FVrMnzXA ($88 in chips)
KpnW5CcJ4Mg6MeclfKmLrw: posts small blind $0.50
TSuRyAHnUPCFjP7Z0rEE0w: posts big blind $1
*** HOLE CARDS ***
w02zQzNydODiyV9THKgo9w: calls $1
ozrlafxxh1HmYdA0/h+MuA: calls $1
6tvjsJrdmWg+g7FVrMnzXA: folds
AdLVjddOzm+sRNo1Bc3S6Q: folds
KpnW5CcJ4Mg6MeclfKmLrw: raises $5 to $6
TSuRyAHnUPCFjP7Z0rEE0w: folds
w02zQzNydODiyV9THKgo9w: folds
ozrlafxxh1HmYdA0/h+MuA: folds
KpnW5CcJ4Mg6MeclfKmLrw collected $4 from pot
KpnW5CcJ4Mg6MeclfKmLrw: doesn't show hand
*** SUMMARY ***
Total pot $4 | Rake $0
Seat 1: AdLVjddOzm+sRNo1Bc3S6Q (button) folded before Flop (didn't bet)
Seat 2: KpnW5CcJ4Mg6MeclfKmLrw (small blind) collected ($4)
Seat 3: TSuRyAHnUPCFjP7Z0rEE0w (big blind) folded before Flop
Seat 4: w02zQzNydODiyV9THKgo9w folded before Flop
Seat 5: ozrlafxxh1HmYdA0/h+MuA folded before Flop
Seat 6: 6tvjsJrdmWg+g7FVrMnzXA folded before Flop (didn't bet)



PokerStars Game #59939819850:  Hold'em No Limit ($0.50/$1.00) - 2009/07/01 0:49:47 ET
Table 'uNlePsyMIqzM691Xkrlk6Q' 9-max Seat #4 is the button
Seat 1: bLbSOSmSOnqE0iTcH/5dxA ($100 in chips)
Seat 2: +OqpStnt0FqbCfyHAWaLbg ($88.60 in chips)
Seat 3: h7qXkU57Bb8ZuPwMyxR8Ug ($32.85 in chips)
Seat 4: TZcz9MEWDA+WydgGruqqbw ($101.15 in chips)
Seat 5: 3obndzTJ6fECz8+wWhMd1w ($17.50 in chips)
Seat 6: myIxN7otsyr846M539YR8Q ($20 in chips)
Seat 7: w6cw9nzN7AvkkHBVVjykoQ ($45.90 in chips)
Seat 8: laA8va+Yv8WuMqT1zdR91g ($100 in chips)
Seat 9: vR4IO10geOgvTW+LAUBv/A ($102.25 in chips)
3obndzTJ6fECz8+wWhMd1w: posts small blind $0.50
myIxN7otsyr846M539YR8Q: posts big blind $1
*** HOLE CARDS ***
w6cw9nzN7AvkkHBVVjykoQ: folds
laA8va+Yv8WuMqT1zdR91g: folds
vR4IO10geOgvTW+LAUBv/A: raises $2 to $3
bLbSOSmSOnqE0iTcH/5dxA: folds
+OqpStnt0FqbCfyHAWaLbg: folds
h7qXkU57Bb8ZuPwMyxR8Ug: folds
TZcz9MEWDA+WydgGruqqbw: folds
3obndzTJ6fECz8+wWhMd1w: folds
myIxN7otsyr846M539YR8Q: folds
vR4IO10geOgvTW+LAUBv/A collected $2.50 from pot
vR4IO10geOgvTW+LAUBv/A: doesn't show hand
*** SUMMARY ***
Total pot $2.50 | Rake $0
Seat 1: bLbSOSmSOnqE0iTcH/5dxA folded before Flop (didn't bet)
Seat 2: +OqpStnt0FqbCfyHAWaLbg folded before Flop (didn't bet)
Seat 3: h7qXkU57Bb8ZuPwMyxR8Ug folded before Flop (didn't bet)
Seat 4: TZcz9MEWDA+WydgGruqqbw (button) folded before Flop (didn't bet)
Seat 5: 3obndzTJ6fECz8+wWhMd1w (small blind) folded before Flop
Seat 6: myIxN7otsyr846M539YR8Q (big blind) folded before Flop
Seat 7: w6cw9nzN7AvkkHBVVjykoQ folded before Flop (didn't bet)
Seat 8: laA8va+Yv8WuMqT1zdR91g folded before Flop (didn't bet)
Seat 9: vR4IO10geOgvTW+LAUBv/A collected ($2.50)



PokerStars Game #59939821066:  Hold'em No Limit ($0.50/$1.00) - 2009/07/01 0:49:49 ET
Table 'W/wyObTiXZm+Ckkl3YxcSw' 6-max Seat #2 is the button
Seat 1: eUBBn2R56C1IQ6Cs/vitwg ($112.25 in chips)
Seat 2: oDiBRCaF0QVtd3kO6xZIXw ($99.45 in chips)
Seat 3: ybGsYWp1MLwy1vSnP8egXg ($29 in chips)
Seat 4: +xW7QemQU0Fxs+4TnqBRow ($110.90 in chips)
Seat 5: BdbmJTZZ47quA9vUWwXtlw ($55.35 in chips)
Seat 6: tS9JHB1h+FQ++qu8RwRNgg ($27 in chips)
ybGsYWp1MLwy1vSnP8egXg: posts small blind $0.50
+xW7QemQU0Fxs+4TnqBRow: posts big blind $1
*** HOLE CARDS ***
BdbmJTZZ47quA9vUWwXtlw: raises $2 to $3
tS9JHB1h+FQ++qu8RwRNgg: folds
eUBBn2R56C1IQ6Cs/vitwg: folds
oDiBRCaF0QVtd3kO6xZIXw: folds
ybGsYWp1MLwy1vSnP8egXg: folds
+xW7QemQU0Fxs+4TnqBRow: folds
BdbmJTZZ47quA9vUWwXtlw collected $2.50 from pot
*** SUMMARY ***
Total pot $2.50 | Rake $0
Seat 1: eUBBn2R56C1IQ6Cs/vitwg folded before Flop (didn't bet)
Seat 2: oDiBRCaF0QVtd3kO6xZIXw (button) folded before Flop (didn't bet)
Seat 3: ybGsYWp1MLwy1vSnP8egXg (small blind) folded before Flop
Seat 4: +xW7QemQU0Fxs+4TnqBRow (big blind) folded before Flop
Seat 5: BdbmJTZZ47quA9vUWwXtlw collected ($2.50)
Seat 6: tS9JHB1h+FQ++qu8RwRNgg folded before Flop (didn't bet)



PokerStars Game #59939822044:  Hold'em No Limit ($0.50/$1.00) - 2009/07/01 0:49:51 ET
Table 'GPp0HyAuggN8oE0sUWzPpA' 9-max Seat #1 is the button
Seat 1: qJr25HAtvv1w/7IBvjMM3g ($27.50 in chips)
Seat 4: mBRWbnUl8diyBO1qTJaNzw ($108.70 in chips)
Seat 5: 0fXz44fzDo5QmhAaJCvFfA ($19.30 in chips)
Seat 6: BK/GtNPkSx0TdUDj82id5A ($12 in chips)
Seat 7: laA8va+Yv8WuMqT1zdR91g ($100 in chips)
Seat 8: tkdBeXTJlFsZdioidNqLow ($69.70 in chips)
Seat 9: VPF+HjszMvUIpy0CHIwH3A ($23.50 in chips)
mBRWbnUl8diyBO1qTJaNzw: posts small blind $0.50
0fXz44fzDo5QmhAaJCvFfA: posts big blind $1
*** HOLE CARDS ***
BK/GtNPkSx0TdUDj82id5A: folds
laA8va+Yv8WuMqT1zdR91g: folds
tkdBeXTJlFsZdioidNqLow: raises $2 to $3
VPF+HjszMvUIpy0CHIwH3A: folds
qJr25HAtvv1w/7IBvjMM3g: folds
mBRWbnUl8diyBO1qTJaNzw: folds
0fXz44fzDo5QmhAaJCvFfA: folds
tkdBeXTJlFsZdioidNqLow collected $2.50 from pot
tkdBeXTJlFsZdioidNqLow: doesn't show hand
CCCXsirC+bO7ginAuUUVlQ joins the table at seat #3
*** SUMMARY ***
Total pot $2.50 | Rake $0
Seat 1: qJr25HAtvv1w/7IBvjMM3g (button) folded before Flop (didn't bet)
Seat 4: mBRWbnUl8diyBO1qTJaNzw (small blind) folded before Flop
Seat 5: 0fXz44fzDo5QmhAaJCvFfA (big blind) folded before Flop
Seat 6: BK/GtNPkSx0TdUDj82id5A folded before Flop (didn't bet)
Seat 7: laA8va+Yv8WuMqT1zdR91g folded before Flop (didn't bet)
Seat 8: tkdBeXTJlFsZdioidNqLow collected ($2.50)
Seat 9: VPF+HjszMvUIpy0CHIwH3A folded before Flop (didn't bet)



PokerStars Game #59939823198:  Hold'em No Limit ($0.50/$1.00) - 2009/07/01 0:49:52 ET
Table 'MUPc8FEpe/nR0BKSeReX6Q' 6-max Seat #5 is the button
Seat 1: YsLQ3BAvgQHWXMAv3Wv6Hg ($113.85 in chips)
Seat 2: xAU6q2/cwmby2sxmA8VcmA ($100 in chips)
Seat 3: wx3sQGkVi2x9wJXuWNHPBw ($220.90 in chips)
Seat 4: ZA1bp6g8IwtTxkUE4eCjDQ ($203.80 in chips)
Seat 5: UBZQqpnJZdTYYY1FTb0rLA ($100 in chips)
Seat 6: oxnw0GLLpFanjhGkxfRSqA ($55.50 in chips)
oxnw0GLLpFanjhGkxfRSqA: posts small blind $0.50
YsLQ3BAvgQHWXMAv3Wv6Hg: posts big blind $1
*** HOLE CARDS ***
xAU6q2/cwmby2sxmA8VcmA: raises $3 to $4
oxnw0GLLpFanjhGkxfRSqA said, "i had a 8 suited stupid c.u.n.t"
wx3sQGkVi2x9wJXuWNHPBw: folds
ZA1bp6g8IwtTxkUE4eCjDQ: folds
UBZQqpnJZdTYYY1FTb0rLA: folds
oxnw0GLLpFanjhGkxfRSqA: folds
YsLQ3BAvgQHWXMAv3Wv6Hg: folds
xAU6q2/cwmby2sxmA8VcmA collected $2.50 from pot
xAU6q2/cwmby2sxmA8VcmA: doesn't show hand
*** SUMMARY ***
Total pot $2.50 | Rake $0
Seat 1: YsLQ3BAvgQHWXMAv3Wv6Hg (big blind) folded before Flop
Seat 2: xAU6q2/cwmby2sxmA8VcmA collected ($2.50)
Seat 3: wx3sQGkVi2x9wJXuWNHPBw folded before Flop (didn't bet)
Seat 4: ZA1bp6g8IwtTxkUE4eCjDQ folded before Flop (didn't bet)
Seat 5: UBZQqpnJZdTYYY1FTb0rLA (button) folded before Flop (didn't bet)
Seat 6: oxnw0GLLpFanjhGkxfRSqA (small blind) folded before Flop



PokerStars Game #59939823148:  Hold'em No Limit ($0.50/$1.00) - 2009/07/01 0:49:52 ET
Table 'hugOjcwJvzEwZbK7tyiWuQ' 9-max Seat #7 is the button
Seat 2: r27C1nIV4NS4+qbnrgBQSw ($260.60 in chips)
Seat 3: jDwhY1kCdc6EkAHbT7PJMQ ($103.65 in chips)
Seat 4: UWB3oeddt/GObx2Mix2Anw ($205.75 in chips)
Seat 5: 5BRGWf+R3nt2WS3b5xX+zA ($27.20 in chips)
Seat 6: gUUvmqdVlmvpal6B8nYrmg ($106.20 in chips)
Seat 7: FL3MrLspcF23LYvC4ipBOA ($100 in chips)
Seat 8: /zy+DB4S5fUQUSfZWFzYGw ($100.25 in chips)
Seat 9: W8P9bUKCs43TO1xHm0dL6w ($88.15 in chips)
/zy+DB4S5fUQUSfZWFzYGw: posts small blind $0.50
W8P9bUKCs43TO1xHm0dL6w: posts big blind $1
*** HOLE CARDS ***
r27C1nIV4NS4+qbnrgBQSw: folds
jDwhY1kCdc6EkAHbT7PJMQ: folds
UWB3oeddt/GObx2Mix2Anw: folds
5BRGWf+R3nt2WS3b5xX+zA: folds
gUUvmqdVlmvpal6B8nYrmg: folds
FL3MrLspcF23LYvC4ipBOA: folds
/zy+DB4S5fUQUSfZWFzYGw: calls $0.50
W8P9bUKCs43TO1xHm0dL6w: checks
*** FLOP *** [5s Ts Kc]
/zy+DB4S5fUQUSfZWFzYGw: checks
W8P9bUKCs43TO1xHm0dL6w: checks
*** TURN *** [5s Ts Kc] [2c]
/zy+DB4S5fUQUSfZWFzYGw: checks
W8P9bUKCs43TO1xHm0dL6w: bets $1
/zy+DB4S5fUQUSfZWFzYGw: folds
W8P9bUKCs43TO1xHm0dL6w collected $1.90 from pot
*** SUMMARY ***
Total pot $2 | Rake $0.10
Board [5s Ts Kc 2c]
Seat 2: r27C1nIV4NS4+qbnrgBQSw folded before Flop (didn't bet)
Seat 3: jDwhY1kCdc6EkAHbT7PJMQ folded before Flop (didn't bet)
Seat 4: UWB3oeddt/GObx2Mix2Anw folded before Flop (didn't bet)
Seat 5: 5BRGWf+R3nt2WS3b5xX+zA folded before Flop (didn't bet)
Seat 6: gUUvmqdVlmvpal6B8nYrmg folded before Flop (didn't bet)
Seat 7: FL3MrLspcF23LYvC4ipBOA (button) folded before Flop (didn't bet)
Seat 8: /zy+DB4S5fUQUSfZWFzYGw (small blind) folded on the Turn
Seat 9: W8P9bUKCs43TO1xHm0dL6w (big blind) collected ($1.90)



PokerStars Game #59939825062:  Hold'em No Limit ($0.50/$1.00) - 2009/07/01 0:49:55 ET
Table '+cA8mcmhaedZ7YcrDdhmeQ' 6-max Seat #2 is the button
Seat 1: lsLuWlcPA3Rh7kJVLzMh0Q ($289 in chips)
Seat 2: RqgF7gRoKgRNW8Zoi1ty4A ($100 in chips)
Seat 3: 7H5WkGzGvsv56y1iaqHvRg ($34.85 in chips)
Seat 5: +7hFKAL0b0O/n8G72TclJA ($50 in chips)
Seat 6: YfsTQsY/fxb+YqbdclTHuw ($48.70 in chips)
7H5WkGzGvsv56y1iaqHvRg: posts small blind $0.50
LjL3AIERHn559yyW1mTUYQ: is sitting out
LjL3AIERHn559yyW1mTUYQ leaves the table
+7hFKAL0b0O/n8G72TclJA: posts big blind $1
*** HOLE CARDS ***
YfsTQsY/fxb+YqbdclTHuw: calls $1
JwCcjZl0bjJzG7hmE0dnTA joins the table at seat #4
lsLuWlcPA3Rh7kJVLzMh0Q: folds
RqgF7gRoKgRNW8Zoi1ty4A: raises $4 to $5
7H5WkGzGvsv56y1iaqHvRg: calls $4.50
+7hFKAL0b0O/n8G72TclJA: folds
YfsTQsY/fxb+YqbdclTHuw: calls $4
*** FLOP *** [8c 3s Jh]
7H5WkGzGvsv56y1iaqHvRg: bets $5
YfsTQsY/fxb+YqbdclTHuw: calls $5
RqgF7gRoKgRNW8Zoi1ty4A: folds
*** TURN *** [8c 3s Jh] [Ah]
7H5WkGzGvsv56y1iaqHvRg: bets $7
YfsTQsY/fxb+YqbdclTHuw: calls $7
*** RIVER *** [8c 3s Jh Ah] [Qc]
7H5WkGzGvsv56y1iaqHvRg: bets $17.85 and is all-in
YfsTQsY/fxb+YqbdclTHuw: folds
7H5WkGzGvsv56y1iaqHvRg collected $38.10 from pot
*** SUMMARY ***
Total pot $40 | Rake $1.90
Board [8c 3s Jh Ah Qc]
Seat 1: lsLuWlcPA3Rh7kJVLzMh0Q folded before Flop (didn't bet)
Seat 2: RqgF7gRoKgRNW8Zoi1ty4A (button) folded on the Flop
Seat 3: 7H5WkGzGvsv56y1iaqHvRg (small blind) collected ($38.10)
Seat 5: +7hFKAL0b0O/n8G72TclJA (big blind) folded before Flop
Seat 6: YfsTQsY/fxb+YqbdclTHuw folded on the River



PokerStars Game #59939825150:  Hold'em No Limit ($0.50/$1.00) - 2009/07/01 0:49:55 ET
Table 'vs/5jr6ciwjVQ5+Soc+u2A' 6-max Seat #5 is the button
Seat 1: /P4w1pHg2zHYg/4ubJ0dPw ($60 in chips)
Seat 2: XOIf9W+VAxhZqN+SYoyMKA ($126.85 in chips)
Seat 3: G5ZSSN6RSON3gkNvk/SmYg ($150 in chips)
Seat 4: KpnW5CcJ4Mg6MeclfKmLrw ($130.70 in chips)
Seat 5: 2DwLxMUbmzvwY7o4/i47Xg ($39 in chips)
Seat 6: qAdBJlVNsNTwiHia50eMvg ($75.50 in chips)
qAdBJlVNsNTwiHia50eMvg: posts small blind $0.50
/P4w1pHg2zHYg/4ubJ0dPw: posts big blind $1
*** HOLE CARDS ***
XOIf9W+VAxhZqN+SYoyMKA: folds
G5ZSSN6RSON3gkNvk/SmYg: folds
KpnW5CcJ4Mg6MeclfKmLrw: raises $2 to $3
2DwLxMUbmzvwY7o4/i47Xg: folds
qAdBJlVNsNTwiHia50eMvg: calls $2.50
/P4w1pHg2zHYg/4ubJ0dPw: folds
*** FLOP *** [Tc Qc Kh]
qAdBJlVNsNTwiHia50eMvg: bets $5
KpnW5CcJ4Mg6MeclfKmLrw: folds
qAdBJlVNsNTwiHia50eMvg collected $6.65 from pot
*** SUMMARY ***
Total pot $7 | Rake $0.35
Board [Tc Qc Kh]
Seat 1: /P4w1pHg2zHYg/4ubJ0dPw (big blind) folded before Flop
Seat 2: XOIf9W+VAxhZqN+SYoyMKA folded before Flop (didn't bet)
Seat 3: G5ZSSN6RSON3gkNvk/SmYg folded before Flop (didn't bet)
Seat 4: KpnW5CcJ4Mg6MeclfKmLrw folded on the Flop
Seat 5: 2DwLxMUbmzvwY7o4/i47Xg (button) folded before Flop (didn't bet)
Seat 6: qAdBJlVNsNTwiHia50eMvg (small blind) collected ($6.65)



PokerStars Game #59939825104:  Hold'em No Limit ($0.50/$1.00) - 2009/07/01 0:49:55 ET
Table 'Zka9tv1yilg0MvXWPQrShg' 9-max Seat #1 is the button
Seat 1: TZcz9MEWDA+WydgGruqqbw ($112.35 in chips)
Seat 2: kz9ziSiGUc+857heiKSayw ($20.50 in chips)
Seat 3: gUUvmqdVlmvpal6B8nYrmg ($100 in chips)
Seat 4: stxmTgSicxShtrDxhOOX2g ($69.25 in chips)
Seat 5: /zy+DB4S5fUQUSfZWFzYGw ($124.90 in chips)
Seat 6: rY8wPoax1lS+HUY+I0FZDw ($146.45 in chips)
Seat 7: p1SafS90nb3Uft5LB0NkHw ($17.50 in chips)
Seat 8: bL+QVeDcuEdzMGAGg2XJHg ($122.10 in chips)
Seat 9: 6daxhj43mWj04MOPTOmaYA ($92.65 in chips)
kz9ziSiGUc+857heiKSayw: posts small blind $0.50
gUUvmqdVlmvpal6B8nYrmg: posts big blind $1
*** HOLE CARDS ***
stxmTgSicxShtrDxhOOX2g: calls $1
/zy+DB4S5fUQUSfZWFzYGw: folds
rY8wPoax1lS+HUY+I0FZDw: folds
p1SafS90nb3Uft5LB0NkHw: folds
bL+QVeDcuEdzMGAGg2XJHg: folds
6daxhj43mWj04MOPTOmaYA: folds
TZcz9MEWDA+WydgGruqqbw: folds
kz9ziSiGUc+857heiKSayw: folds
gUUvmqdVlmvpal6B8nYrmg: checks
*** FLOP *** [6c Jc Ad]
gUUvmqdVlmvpal6B8nYrmg: checks
stxmTgSicxShtrDxhOOX2g: bets $1
gUUvmqdVlmvpal6B8nYrmg: folds
stxmTgSicxShtrDxhOOX2g collected $2.40 from pot
*** SUMMARY ***
Total pot $2.50 | Rake $0.10
Board [6c Jc Ad]
Seat 1: TZcz9MEWDA+WydgGruqqbw (button) folded before Flop (didn't bet)
Seat 2: kz9ziSiGUc+857heiKSayw (small blind) folded before Flop
Seat 3: gUUvmqdVlmvpal6B8nYrmg (big blind) folded on the Flop
Seat 4: stxmTgSicxShtrDxhOOX2g collected ($2.40)
Seat 5: /zy+DB4S5fUQUSfZWFzYGw folded before Flop (didn't bet)
Seat 6: rY8wPoax1lS+HUY+I0FZDw folded before Flop (didn't bet)
Seat 7: p1SafS90nb3Uft5LB0NkHw folded before Flop (didn't bet)
Seat 8: bL+QVeDcuEdzMGAGg2XJHg folded before Flop (didn't bet)
Seat 9: 6daxhj43mWj04MOPTOmaYA folded before Flop (didn't bet)



PokerStars Game #59939825652:  Hold'em No Limit ($0.50/$1.00) - 2009/07/01 0:49:56 ET
Table 'tJq9SfN1ywY0r03VBlWlwQ' 9-max Seat #3 is the button
Seat 1: wZsU+w9r7G66x93UuvBf1Q ($337.80 in chips)
Seat 2: RqkO8O/Y3qlc3PIuCAHjVg ($74.40 in chips)
Seat 3: FVs16t7GgfWgQWt4JxsObQ ($33.95 in chips)
Seat 4: bLbSOSmSOnqE0iTcH/5dxA ($110.70 in chips)
Seat 5: Ogn4JDV3mp4ZDKO49IFzKA ($19.90 in chips)
Seat 6: gUUvmqdVlmvpal6B8nYrmg ($122.05 in chips)
Seat 7: qVhRZ0PLZ95XRJHWAjXjOQ ($128.20 in chips)
Seat 8: G4DEhsZFmznGNVpy2SEocA ($23.50 in chips)
Seat 9: XE5QF1y74bpHog9JxWJMWQ ($100 in chips)
bLbSOSmSOnqE0iTcH/5dxA: posts small blind $0.50
Ogn4JDV3mp4ZDKO49IFzKA: posts big blind $1
*** HOLE CARDS ***
gUUvmqdVlmvpal6B8nYrmg: folds
qVhRZ0PLZ95XRJHWAjXjOQ: folds
G4DEhsZFmznGNVpy2SEocA: folds
XE5QF1y74bpHog9JxWJMWQ: folds
wZsU+w9r7G66x93UuvBf1Q: raises $3 to $4
RqkO8O/Y3qlc3PIuCAHjVg: folds
FVs16t7GgfWgQWt4JxsObQ: folds
bLbSOSmSOnqE0iTcH/5dxA: folds
Ogn4JDV3mp4ZDKO49IFzKA: folds
wZsU+w9r7G66x93UuvBf1Q collected $2.50 from pot
*** SUMMARY ***
Total pot $2.50 | Rake $0
Seat 1: wZsU+w9r7G66x93UuvBf1Q collected ($2.50)
Seat 2: RqkO8O/Y3qlc3PIuCAHjVg folded before Flop (didn't bet)
Seat 3: FVs16t7GgfWgQWt4JxsObQ (button) folded before Flop (didn't bet)
Seat 4: bLbSOSmSOnqE0iTcH/5dxA (small blind) folded before Flop
Seat 5: Ogn4JDV3mp4ZDKO49IFzKA (big blind) folded before Flop
Seat 6: gUUvmqdVlmvpal6B8nYrmg folded before Flop (didn't bet)
Seat 7: qVhRZ0PLZ95XRJHWAjXjOQ folded before Flop (didn't bet)
Seat 8: G4DEhsZFmznGNVpy2SEocA folded before Flop (didn't bet)
Seat 9: XE5QF1y74bpHog9JxWJMWQ folded before Flop (didn't bet)



PokerStars Game #59939825926:  Hold'em No Limit ($0.50/$1.00) - 2009/07/01 0:49:57 ET
Table 'JOIm/fogLA7vSG0Vc6ME1A' 2-max Seat #1 is the button
Seat 1: NYi6JFscYNrofSXy4sM+Yw ($100 in chips)
Seat 2: F5lNTyZLIX9W2wQZ0plwgg ($113.15 in chips)
NYi6JFscYNrofSXy4sM+Yw: posts small blind $0.50
F5lNTyZLIX9W2wQZ0plwgg: posts big blind $1
*** HOLE CARDS ***
NYi6JFscYNrofSXy4sM+Yw: folds
F5lNTyZLIX9W2wQZ0plwgg collected $1 from pot
*** SUMMARY ***
Total pot $1 | Rake $0
Seat 1: NYi6JFscYNrofSXy4sM+Yw (button) (small blind) folded before Flop
Seat 2: F5lNTyZLIX9W2wQZ0plwgg (big blind) collected ($1)



PokerStars Game #59939827314:  Hold'em No Limit ($0.50/$1.00) - 2009/07/01 0:49:59 ET
Table 'LmXQK9xy3awB+qsPzI21Mw' 2-max Seat #1 is the button
Seat 1: NYi6JFscYNrofSXy4sM+Yw ($193.45 in chips)
Seat 2: TME8GvochpQAo8cmJwWmvA ($136.70 in chips)
NYi6JFscYNrofSXy4sM+Yw: posts small blind $0.50
TME8GvochpQAo8cmJwWmvA: posts big blind $1
*** HOLE CARDS ***
NYi6JFscYNrofSXy4sM+Yw: raises $2 to $3
TME8GvochpQAo8cmJwWmvA: folds
NYi6JFscYNrofSXy4sM+Yw collected $2 from pot
NYi6JFscYNrofSXy4sM+Yw: doesn't show hand
*** SUMMARY ***
Total pot $2 | Rake $0
Seat 1: NYi6JFscYNrofSXy4sM+Yw (button) (small blind) collected ($2)
Seat 2: TME8GvochpQAo8cmJwWmvA (big blind) folded before Flop



PokerStars Game #59939828080:  Hold'em No Limit ($0.50/$1.00) - 2009/07/01 0:50:00 ET
Table 'N2bNCDHL96aCQDvZIh+yQQ' 6-max Seat #4 is the button
Seat 1: iHo1oDbrEVJ8nEGdaPrICw ($107 in chips)
Seat 3: Qy/UBNbD2HaA0Ogxg8Sf3w ($160.70 in chips)
Seat 4: uCqEjnxh2/vFBjKYkfTOkw ($174.05 in chips)
Seat 5: ZIdFTzUiF+cFsap66otbHg ($21 in chips)
Seat 6: TSuRyAHnUPCFjP7Z0rEE0w ($100 in chips)
ZIdFTzUiF+cFsap66otbHg: posts small blind $0.50
TSuRyAHnUPCFjP7Z0rEE0w: posts big blind $1
*** HOLE CARDS ***
iHo1oDbrEVJ8nEGdaPrICw: folds
Qy/UBNbD2HaA0Ogxg8Sf3w: folds
uCqEjnxh2/vFBjKYkfTOkw: folds
ZIdFTzUiF+cFsap66otbHg: calls $0.50
TSuRyAHnUPCFjP7Z0rEE0w: checks
*** FLOP *** [Kd Td 7d]
ZIdFTzUiF+cFsap66otbHg: checks
TSuRyAHnUPCFjP7Z0rEE0w: checks
*** TURN *** [Kd Td 7d] [Qc]
ZIdFTzUiF+cFsap66otbHg: bets $1
TSuRyAHnUPCFjP7Z0rEE0w: folds
ZIdFTzUiF+cFsap66otbHg collected $1.90 from pot
*** SUMMARY ***
Total pot $2 | Rake $0.10
Board [Kd Td 7d Qc]
Seat 1: iHo1oDbrEVJ8nEGdaPrICw folded before Flop (didn't bet)
Seat 3: Qy/UBNbD2HaA0Ogxg8Sf3w folded before Flop (didn't bet)
Seat 4: uCqEjnxh2/vFBjKYkfTOkw (button) folded before Flop (didn't bet)
Seat 5: ZIdFTzUiF+cFsap66otbHg (small blind) collected ($1.90)
Seat 6: TSuRyAHnUPCFjP7Z0rEE0w (big blind) folded on the Turn



PokerStars Game #59939829336:  Hold'em No Limit ($0.50/$1.00) - 2009/07/01 0:50:02 ET
Table 'JOIm/fogLA7vSG0Vc6ME1A' 2-max Seat #2 is the button
Seat 1: NYi6JFscYNrofSXy4sM+Yw ($100 in chips)
Seat 2: F5lNTyZLIX9W2wQZ0plwgg ($113.65 in chips)
F5lNTyZLIX9W2wQZ0plwgg: posts small blind $0.50
NYi6JFscYNrofSXy4sM+Yw: posts big blind $1
*** HOLE CARDS ***
F5lNTyZLIX9W2wQZ0plwgg: raises $1 to $2
NYi6JFscYNrofSXy4sM+Yw: calls $1
*** FLOP *** [9d 5d Tc]
NYi6JFscYNrofSXy4sM+Yw: checks
F5lNTyZLIX9W2wQZ0plwgg: checks
*** TURN *** [9d 5d Tc] [6d]
NYi6JFscYNrofSXy4sM+Yw: bets $2
F5lNTyZLIX9W2wQZ0plwgg: calls $2
*** RIVER *** [9d 5d Tc 6d] [Ah]
NYi6JFscYNrofSXy4sM+Yw: checks
F5lNTyZLIX9W2wQZ0plwgg: bets $11
NYi6JFscYNrofSXy4sM+Yw: folds
F5lNTyZLIX9W2wQZ0plwgg collected $7.65 from pot
*** SUMMARY ***
Total pot $8 | Rake $0.35
Board [9d 5d Tc 6d Ah]
Seat 1: NYi6JFscYNrofSXy4sM+Yw (big blind) folded on the River
Seat 2: F5lNTyZLIX9W2wQZ0plwgg (button) (small blind) collected ($7.65)



PokerStars Game #59939830522:  Hold'em No Limit ($0.50/$1.00) - 2009/07/01 0:50:04 ET
Table '7Nl0ffnjeK44/vmeexh3MQ' 9-max Seat #2 is the button
Seat 1: s7D3Y+k4Cj4D1cXHv7oj+Q ($90.85 in chips)
Seat 2: OGgaARGdJQT4awWVNQ957w ($100 in chips)
Seat 3: vR4IO10geOgvTW+LAUBv/A ($100 in chips)
Seat 4: bLbSOSmSOnqE0iTcH/5dxA ($108.50 in chips)
Seat 5: bL+QVeDcuEdzMGAGg2XJHg ($105.05 in chips)
Seat 6: FVs16t7GgfWgQWt4JxsObQ ($26.50 in chips)
Seat 7: 997ViqAtWn1FPjJqcffwcA ($100 in chips)
Seat 8: zanka7aAZkigmZpfopXxxA ($253.35 in chips)
Seat 9: ouwUBGRKnKK9uhn1G4Lf+A ($99.50 in chips)
vR4IO10geOgvTW+LAUBv/A: posts small blind $0.50
bLbSOSmSOnqE0iTcH/5dxA: posts big blind $1
*** HOLE CARDS ***
bL+QVeDcuEdzMGAGg2XJHg: folds
FVs16t7GgfWgQWt4JxsObQ: folds
997ViqAtWn1FPjJqcffwcA: folds
zanka7aAZkigmZpfopXxxA: folds
ouwUBGRKnKK9uhn1G4Lf+A: folds
s7D3Y+k4Cj4D1cXHv7oj+Q: folds
OGgaARGdJQT4awWVNQ957w: folds
vR4IO10geOgvTW+LAUBv/A: folds
bLbSOSmSOnqE0iTcH/5dxA collected $1 from pot
bLbSOSmSOnqE0iTcH/5dxA: doesn't show hand
*** SUMMARY ***
Total pot $1 | Rake $0
Seat 1: s7D3Y+k4Cj4D1cXHv7oj+Q folded before Flop (didn't bet)
Seat 2: OGgaARGdJQT4awWVNQ957w (button) folded before Flop (didn't bet)
Seat 3: vR4IO10geOgvTW+LAUBv/A (small blind) folded before Flop
Seat 4: bLbSOSmSOnqE0iTcH/5dxA (big blind) collected ($1)
Seat 5: bL+QVeDcuEdzMGAGg2XJHg folded before Flop (didn't bet)
Seat 6: FVs16t7GgfWgQWt4JxsObQ folded before Flop (didn't bet)
Seat 7: 997ViqAtWn1FPjJqcffwcA folded before Flop (didn't bet)
Seat 8: zanka7aAZkigmZpfopXxxA folded before Flop (didn't bet)
Seat 9: ouwUBGRKnKK9uhn1G4Lf+A folded before Flop (didn't bet)



PokerStars Game #59939831620:  Hold'em No Limit ($0.50/$1.00) - 2009/07/01 0:50:06 ET
Table 'LmXQK9xy3awB+qsPzI21Mw' 2-max Seat #2 is the button
Seat 1: NYi6JFscYNrofSXy4sM+Yw ($194.45 in chips)
Seat 2: TME8GvochpQAo8cmJwWmvA ($135.70 in chips)
TME8GvochpQAo8cmJwWmvA: posts small blind $0.50
NYi6JFscYNrofSXy4sM+Yw: posts big blind $1
*** HOLE CARDS ***
TME8GvochpQAo8cmJwWmvA: calls $0.50
NYi6JFscYNrofSXy4sM+Yw: raises $3 to $4
TME8GvochpQAo8cmJwWmvA: calls $3
*** FLOP *** [5h As Ad]
NYi6JFscYNrofSXy4sM+Yw: bets $4
TME8GvochpQAo8cmJwWmvA: folds
NYi6JFscYNrofSXy4sM+Yw collected $7.60 from pot
NYi6JFscYNrofSXy4sM+Yw: doesn't show hand
*** SUMMARY ***
Total pot $8 | Rake $0.40
Board [5h As Ad]
Seat 1: NYi6JFscYNrofSXy4sM+Yw (big blind) collected ($7.60)
Seat 2: TME8GvochpQAo8cmJwWmvA (button) (small blind) folded on the Flop



PokerStars Game #59939832050:  Hold'em No Limit ($0.50/$1.00) - 2009/07/01 0:50:07 ET
Table '/RZcOwpZpHQ+OwPwjsbnRw' 6-max Seat #4 is the button
Seat 1: Zboa6dColKGHBjLPUakZjw ($40.40 in chips)
Seat 2: +xW7QemQU0Fxs+4TnqBRow ($193 in chips)
Seat 3: XnT1yK2DD/5FL+0bwuEhqg ($46.45 in chips)
Seat 4: j7NIOHLZk7V2o9fOioO5ug ($120.35 in chips)
Seat 5: wx3sQGkVi2x9wJXuWNHPBw ($181.15 in chips)
Seat 6: XOIf9W+VAxhZqN+SYoyMKA ($293.25 in chips)
wx3sQGkVi2x9wJXuWNHPBw: posts small blind $0.50
XOIf9W+VAxhZqN+SYoyMKA: posts big blind $1
*** HOLE CARDS ***
Zboa6dColKGHBjLPUakZjw: folds
+xW7QemQU0Fxs+4TnqBRow: folds
XnT1yK2DD/5FL+0bwuEhqg: raises $2 to $3
j7NIOHLZk7V2o9fOioO5ug: folds
wx3sQGkVi2x9wJXuWNHPBw: folds
XOIf9W+VAxhZqN+SYoyMKA: folds
XnT1yK2DD/5FL+0bwuEhqg collected $2.50 from pot
*** SUMMARY ***
Total pot $2.50 | Rake $0
Seat 1: Zboa6dColKGHBjLPUakZjw folded before Flop (didn't bet)
Seat 2: +xW7QemQU0Fxs+4TnqBRow folded before Flop (didn't bet)
Seat 3: XnT1yK2DD/5FL+0bwuEhqg collected ($2.50)
Seat 4: j7NIOHLZk7V2o9fOioO5ug (button) folded before Flop (didn't bet)
Seat 5: wx3sQGkVi2x9wJXuWNHPBw (small blind) folded before Flop
Seat 6: XOIf9W+VAxhZqN+SYoyMKA (big blind) folded before Flop



PokerStars Game #59939834444:  Hold'em No Limit ($0.50/$1.00) - 2009/07/01 0:50:10 ET
Table 'U9zqzC8f3oTJ2ShXFgSSOA' 6-max Seat #4 is the button
Seat 2: JwCcjZl0bjJzG7hmE0dnTA ($115.05 in chips)
Seat 3: yfXek8iJ7O4CFyqXrtGcfg ($14.45 in chips)
Seat 4: 33q95we0Etwgrm6guQGncw ($93.85 in chips)
Seat 5: KfwW5us6tydK81NYTtK1gw ($295.65 in chips)
Seat 6: 4OO5v3AVduL0tePNx8wk5A ($100 in chips)
KfwW5us6tydK81NYTtK1gw: posts small blind $0.50
4OO5v3AVduL0tePNx8wk5A: posts big blind $1
iHo1oDbrEVJ8nEGdaPrICw: sits out
*** HOLE CARDS ***
JwCcjZl0bjJzG7hmE0dnTA: folds
JwCcjZl0bjJzG7hmE0dnTA leaves the table
yfXek8iJ7O4CFyqXrtGcfg: folds
TSuRyAHnUPCFjP7Z0rEE0w joins the table at seat #2
33q95we0Etwgrm6guQGncw: folds
KfwW5us6tydK81NYTtK1gw: raises $1 to $2
4OO5v3AVduL0tePNx8wk5A: folds
KfwW5us6tydK81NYTtK1gw collected $2 from pot
KfwW5us6tydK81NYTtK1gw: doesn't show hand
*** SUMMARY ***
Total pot $2 | Rake $0
Seat 2: JwCcjZl0bjJzG7hmE0dnTA folded before Flop (didn't bet)
Seat 3: yfXek8iJ7O4CFyqXrtGcfg folded before Flop (didn't bet)
Seat 4: 33q95we0Etwgrm6guQGncw (button) folded before Flop (didn't bet)
Seat 5: KfwW5us6tydK81NYTtK1gw (small blind) collected ($2)
Seat 6: 4OO5v3AVduL0tePNx8wk5A (big blind) folded before Flop



PokerStars Game #59939834730:  Hold'em No Limit ($0.50/$1.00) - 2009/07/01 0:50:11 ET
Table 'fTlPiCj0utgzC/5io+I7ew' 6-max Seat #3 is the button
Seat 1: YMJG+F++3Aj6P8dAWda5fw ($93.50 in chips)
Seat 2: Qy/UBNbD2HaA0Ogxg8Sf3w ($110.45 in chips)
Seat 3: oDiBRCaF0QVtd3kO6xZIXw ($72.25 in chips)
Seat 4: uJVSceLggtsrJya+WtmUEA ($123.50 in chips)
Seat 5: bFrTkDcWGTxyvNul7GVdYg ($252.20 in chips)
uJVSceLggtsrJya+WtmUEA: posts small blind $0.50
bFrTkDcWGTxyvNul7GVdYg: posts big blind $1
/P4w1pHg2zHYg/4ubJ0dPw: sits out
*** HOLE CARDS ***
YMJG+F++3Aj6P8dAWda5fw: folds
Qy/UBNbD2HaA0Ogxg8Sf3w: raises $2 to $3
oDiBRCaF0QVtd3kO6xZIXw: folds
uJVSceLggtsrJya+WtmUEA: calls $2.50
bFrTkDcWGTxyvNul7GVdYg: folds
*** FLOP *** [Ah Js Tc]
uJVSceLggtsrJya+WtmUEA: checks
Qy/UBNbD2HaA0Ogxg8Sf3w: checks
*** TURN *** [Ah Js Tc] [4s]
uJVSceLggtsrJya+WtmUEA: bets $4
Qy/UBNbD2HaA0Ogxg8Sf3w: calls $4
*** RIVER *** [Ah Js Tc 4s] [Jh]
uJVSceLggtsrJya+WtmUEA: bets $9
Qy/UBNbD2HaA0Ogxg8Sf3w: calls $9
*** SHOW DOWN ***
uJVSceLggtsrJya+WtmUEA: shows [Td As] (two pair, Aces and Jacks)
Qy/UBNbD2HaA0Ogxg8Sf3w: shows [Qs Jc] (three of a kind, Jacks)
Qy/UBNbD2HaA0Ogxg8Sf3w collected $31.40 from pot
*** SUMMARY ***
Total pot $33 | Rake $1.60
Board [Ah Js Tc 4s Jh]
Seat 1: YMJG+F++3Aj6P8dAWda5fw folded before Flop (didn't bet)
Seat 2: Qy/UBNbD2HaA0Ogxg8Sf3w showed [Qs Jc] and won ($31.40) with three of a kind, Jacks
Seat 3: oDiBRCaF0QVtd3kO6xZIXw (button) folded before Flop (didn't bet)
Seat 4: uJVSceLggtsrJya+WtmUEA (small blind) showed [Td As] and lost with two pair, Aces and Jacks
Seat 5: bFrTkDcWGTxyvNul7GVdYg (big blind) folded before Flop



PokerStars Game #59939835874:  Hold'em No Limit ($0.50/$1.00) - 2009/07/01 0:50:13 ET
Table 'GxCPo/gd3OSthkYrAxJngg' 6-max Seat #3 is the button
Seat 1: sH8BpAFP+jGFxCgVpD1Lew ($261.35 in chips)
Seat 2: YExX2paeIHrmfIwV1ivM/w ($76.70 in chips)
Seat 3: o6plE+MSW4XFNTeONe16xg ($29.60 in chips)
Seat 4: YMJG+F++3Aj6P8dAWda5fw ($105.65 in chips)
Seat 5: G5ZSSN6RSON3gkNvk/SmYg ($108.25 in chips)
Seat 6: sS9IXedL3MiRmpVXhAILhw ($103.45 in chips)
YMJG+F++3Aj6P8dAWda5fw: posts small blind $0.50
G5ZSSN6RSON3gkNvk/SmYg: posts big blind $1
*** HOLE CARDS ***
sS9IXedL3MiRmpVXhAILhw: folds
sH8BpAFP+jGFxCgVpD1Lew: calls $1
YExX2paeIHrmfIwV1ivM/w: folds
o6plE+MSW4XFNTeONe16xg: folds
YMJG+F++3Aj6P8dAWda5fw: folds
G5ZSSN6RSON3gkNvk/SmYg: checks
*** FLOP *** [2c 3c 3h]
G5ZSSN6RSON3gkNvk/SmYg: checks
sH8BpAFP+jGFxCgVpD1Lew: checks
*** TURN *** [2c 3c 3h] [4c]
G5ZSSN6RSON3gkNvk/SmYg: checks
sH8BpAFP+jGFxCgVpD1Lew: bets $2
G5ZSSN6RSON3gkNvk/SmYg: folds
sH8BpAFP+jGFxCgVpD1Lew collected $2.40 from pot
sH8BpAFP+jGFxCgVpD1Lew: doesn't show hand
*** SUMMARY ***
Total pot $2.50 | Rake $0.10
Board [2c 3c 3h 4c]
Seat 1: sH8BpAFP+jGFxCgVpD1Lew collected ($2.40)
Seat 2: YExX2paeIHrmfIwV1ivM/w folded before Flop (didn't bet)
Seat 3: o6plE+MSW4XFNTeONe16xg (button) folded before Flop (didn't bet)
Seat 4: YMJG+F++3Aj6P8dAWda5fw (small blind) folded before Flop
Seat 5: G5ZSSN6RSON3gkNvk/SmYg (big blind) folded on the Turn
Seat 6: sS9IXedL3MiRmpVXhAILhw folded before Flop (didn't bet)



PokerStars Game #59939836634:  Hold'em No Limit ($0.50/$1.00) - 2009/07/01 0:50:14 ET
Table 'W/wyObTiXZm+Ckkl3YxcSw' 6-max Seat #3 is the button
Seat 1: eUBBn2R56C1IQ6Cs/vitwg ($112.25 in chips)
Seat 2: oDiBRCaF0QVtd3kO6xZIXw ($99.45 in chips)
Seat 3: ybGsYWp1MLwy1vSnP8egXg ($28.50 in chips)
Seat 4: +xW7QemQU0Fxs+4TnqBRow ($109.90 in chips)
Seat 5: BdbmJTZZ47quA9vUWwXtlw ($56.85 in chips)
Seat 6: tS9JHB1h+FQ++qu8RwRNgg ($27 in chips)
+xW7QemQU0Fxs+4TnqBRow: posts small blind $0.50
BdbmJTZZ47quA9vUWwXtlw: posts big blind $1
*** HOLE CARDS ***
tS9JHB1h+FQ++qu8RwRNgg: folds
eUBBn2R56C1IQ6Cs/vitwg: folds
oDiBRCaF0QVtd3kO6xZIXw: folds
ybGsYWp1MLwy1vSnP8egXg: folds
+xW7QemQU0Fxs+4TnqBRow: raises $2 to $3
BdbmJTZZ47quA9vUWwXtlw: folds
+xW7QemQU0Fxs+4TnqBRow collected $2 from pot
+xW7QemQU0Fxs+4TnqBRow: doesn't show hand
*** SUMMARY ***
Total pot $2 | Rake $0
Seat 1: eUBBn2R56C1IQ6Cs/vitwg folded before Flop (didn't bet)
Seat 2: oDiBRCaF0QVtd3kO6xZIXw folded before Flop (didn't bet)
Seat 3: ybGsYWp1MLwy1vSnP8egXg (button) folded before Flop (didn't bet)
Seat 4: +xW7QemQU0Fxs+4TnqBRow (small blind) collected ($2)
Seat 5: BdbmJTZZ47quA9vUWwXtlw (big blind) folded before Flop
Seat 6: tS9JHB1h+FQ++qu8RwRNgg folded before Flop (didn't bet)



PokerStars Game #59939837968:  Hold'em No Limit ($0.50/$1.00) - 2009/07/01 0:50:16 ET
Table 'pHrhryH8jPNdQfY62f8v+g' 6-max Seat #4 is the button
Seat 1: fF4botNMr8/ieVPO1YYRLw ($56 in chips)
Seat 2: RqgF7gRoKgRNW8Zoi1ty4A ($101.75 in chips)
Seat 3: 8oS5O7iD/qnFXFXJrGIgNQ ($100 in chips)
Seat 4: wenbG7TaM3H7h5kn78OFNw ($55.70 in chips)
Seat 5: r1/R7y0Ortgoz4lccgW8VA ($54.90 in chips)
Seat 6: xAU6q2/cwmby2sxmA8VcmA ($118.80 in chips)
r1/R7y0Ortgoz4lccgW8VA: posts small blind $0.50
xAU6q2/cwmby2sxmA8VcmA: posts big blind $1
*** HOLE CARDS ***
fF4botNMr8/ieVPO1YYRLw: folds
RqgF7gRoKgRNW8Zoi1ty4A: folds
8oS5O7iD/qnFXFXJrGIgNQ: folds
wenbG7TaM3H7h5kn78OFNw: raises $2 to $3
r1/R7y0Ortgoz4lccgW8VA: folds
xAU6q2/cwmby2sxmA8VcmA: folds
wenbG7TaM3H7h5kn78OFNw collected $2.50 from pot
*** SUMMARY ***
Total pot $2.50 | Rake $0
Seat 1: fF4botNMr8/ieVPO1YYRLw folded before Flop (didn't bet)
Seat 2: RqgF7gRoKgRNW8Zoi1ty4A folded before Flop (didn't bet)
Seat 3: 8oS5O7iD/qnFXFXJrGIgNQ folded before Flop (didn't bet)
Seat 4: wenbG7TaM3H7h5kn78OFNw (button) collected ($2.50)
Seat 5: r1/R7y0Ortgoz4lccgW8VA (small blind) folded before Flop
Seat 6: xAU6q2/cwmby2sxmA8VcmA (big blind) folded before Flop



PokerStars Game #59939837684:  Hold'em No Limit ($0.50/$1.00) - 2009/07/01 0:50:16 ET
Table 'MUPc8FEpe/nR0BKSeReX6Q' 6-max Seat #6 is the button
Seat 1: YsLQ3BAvgQHWXMAv3Wv6Hg ($112.85 in chips)
Seat 2: xAU6q2/cwmby2sxmA8VcmA ($101.50 in chips)
Seat 3: wx3sQGkVi2x9wJXuWNHPBw ($220.90 in chips)
Seat 4: ZA1bp6g8IwtTxkUE4eCjDQ ($203.80 in chips)
Seat 5: UBZQqpnJZdTYYY1FTb0rLA ($100 in chips)
Seat 6: oxnw0GLLpFanjhGkxfRSqA ($55 in chips)
YsLQ3BAvgQHWXMAv3Wv6Hg: posts small blind $0.50
xAU6q2/cwmby2sxmA8VcmA: posts big blind $1
*** HOLE CARDS ***
wx3sQGkVi2x9wJXuWNHPBw: raises $3 to $4
ZA1bp6g8IwtTxkUE4eCjDQ: folds
UBZQqpnJZdTYYY1FTb0rLA: calls $4
oxnw0GLLpFanjhGkxfRSqA: folds
YsLQ3BAvgQHWXMAv3Wv6Hg: folds
xAU6q2/cwmby2sxmA8VcmA: folds
*** FLOP *** [7d 7s Jc]
wx3sQGkVi2x9wJXuWNHPBw: checks
UBZQqpnJZdTYYY1FTb0rLA: bets $6
ZA1bp6g8IwtTxkUE4eCjDQ said, "forget it"
wx3sQGkVi2x9wJXuWNHPBw: folds
UBZQqpnJZdTYYY1FTb0rLA collected $9.05 from pot
UBZQqpnJZdTYYY1FTb0rLA: doesn't show hand
*** SUMMARY ***
Total pot $9.50 | Rake $0.45
Board [7d 7s Jc]
Seat 1: YsLQ3BAvgQHWXMAv3Wv6Hg (small blind) folded before Flop
Seat 2: xAU6q2/cwmby2sxmA8VcmA (big blind) folded before Flop
Seat 3: wx3sQGkVi2x9wJXuWNHPBw folded on the Flop
Seat 4: ZA1bp6g8IwtTxkUE4eCjDQ folded before Flop (didn't bet)
Seat 5: UBZQqpnJZdTYYY1FTb0rLA collected ($9.05)
Seat 6: oxnw0GLLpFanjhGkxfRSqA (button) folded before Flop (didn't bet)



PokerStars Game #59939838758:  Hold'em No Limit ($0.50/$1.00) - 2009/07/01 0:50:17 ET
Table 'tLrtq7gDzxEvckNAI1OS5Q' 6-max Seat #4 is the button
Seat 1: xNKcQzD9+/iHmtJn4vYq9w ($98.55 in chips)
Seat 2: QHvTZcrKe6+maWUfVjP29Q ($105.35 in chips)
Seat 3: TPZ+m9x+lwoKpv7TMfAUWA ($217.70 in chips)
Seat 4: +uSzP8Jwnw7sKfQ4s66b7w ($45 in chips)
Seat 5: OGMLOcTNYZXZU81au7ztUw ($153.25 in chips)
Seat 6: XUk5GQsfNFpHvaToDZ0rZA ($168.20 in chips)
OGMLOcTNYZXZU81au7ztUw: posts small blind $0.50
XUk5GQsfNFpHvaToDZ0rZA: posts big blind $1
*** HOLE CARDS ***
xNKcQzD9+/iHmtJn4vYq9w: folds
QHvTZcrKe6+maWUfVjP29Q: folds
TPZ+m9x+lwoKpv7TMfAUWA: folds
+uSzP8Jwnw7sKfQ4s66b7w: folds
OGMLOcTNYZXZU81au7ztUw: folds
XUk5GQsfNFpHvaToDZ0rZA collected $1 from pot
XUk5GQsfNFpHvaToDZ0rZA: doesn't show hand
*** SUMMARY ***
Total pot $1 | Rake $0
Seat 1: xNKcQzD9+/iHmtJn4vYq9w folded before Flop (didn't bet)
Seat 2: QHvTZcrKe6+maWUfVjP29Q folded before Flop (didn't bet)
Seat 3: TPZ+m9x+lwoKpv7TMfAUWA folded before Flop (didn't bet)
Seat 4: +uSzP8Jwnw7sKfQ4s66b7w (button) folded before Flop (didn't bet)
Seat 5: OGMLOcTNYZXZU81au7ztUw (small blind) folded before Flop
Seat 6: XUk5GQsfNFpHvaToDZ0rZA (big blind) collected ($1)



PokerStars Game #59939839928:  Hold'em No Limit ($0.50/$1.00) - 2009/07/01 0:50:19 ET
Table '7O9fB8yx1u7sJveJn8w6jA' 6-max Seat #3 is the button
Seat 1: jy52+7FotjH63o5tEEVgKw ($160.35 in chips)
Seat 2: wx3sQGkVi2x9wJXuWNHPBw ($192.50 in chips)
Seat 3: hpxXcmRkXXI9HE5+5/j/0Q ($100 in chips)
Seat 4: XIZSmlGttGgSRaIU42K4Fg ($81.90 in chips)
Seat 5: BCEV3COoKY607AzLWayfRA ($100 in chips)
Seat 6: UBZQqpnJZdTYYY1FTb0rLA ($130.45 in chips)
XIZSmlGttGgSRaIU42K4Fg: posts small blind $0.50
BCEV3COoKY607AzLWayfRA: posts big blind $1
*** HOLE CARDS ***
UBZQqpnJZdTYYY1FTb0rLA: folds
jy52+7FotjH63o5tEEVgKw: calls $1
wx3sQGkVi2x9wJXuWNHPBw: folds
hpxXcmRkXXI9HE5+5/j/0Q: folds
XIZSmlGttGgSRaIU42K4Fg: folds
BCEV3COoKY607AzLWayfRA: checks
*** FLOP *** [7d Ks 2s]
BCEV3COoKY607AzLWayfRA: checks
jy52+7FotjH63o5tEEVgKw: checks
*** TURN *** [7d Ks 2s] [9c]
BCEV3COoKY607AzLWayfRA: checks
jy52+7FotjH63o5tEEVgKw: checks
*** RIVER *** [7d Ks 2s 9c] [Ts]
BCEV3COoKY607AzLWayfRA: checks
jy52+7FotjH63o5tEEVgKw: checks
*** SHOW DOWN ***
BCEV3COoKY607AzLWayfRA: shows [2h 3d] (a pair of Deuces)
jy52+7FotjH63o5tEEVgKw: mucks hand
BCEV3COoKY607AzLWayfRA collected $2.40 from pot
*** SUMMARY ***
Total pot $2.50 | Rake $0.10
Board [7d Ks 2s 9c Ts]
Seat 1: jy52+7FotjH63o5tEEVgKw mucked
Seat 2: wx3sQGkVi2x9wJXuWNHPBw folded before Flop (didn't bet)
Seat 3: hpxXcmRkXXI9HE5+5/j/0Q (button) folded before Flop (didn't bet)
Seat 4: XIZSmlGttGgSRaIU42K4Fg (small blind) folded before Flop
Seat 5: BCEV3COoKY607AzLWayfRA (big blind) showed [2h 3d] and won ($2.40) with a pair of Deuces
Seat 6: UBZQqpnJZdTYYY1FTb0rLA folded before Flop (didn't bet)



PokerStars Game #59939840916:  Hold'em No Limit ($0.50/$1.00) - 2009/07/01 0:50:21 ET
Table 'cBDNutyLBKEk9+ptwsKmTw' 6-max Seat #6 is the button
Seat 1: xAU6q2/cwmby2sxmA8VcmA ($100 in chips)
Seat 2: 5lY8d6Cnm4HUkt/8FZSj4g ($91.80 in chips)
Seat 3: G5ZSSN6RSON3gkNvk/SmYg ($104.65 in chips)
Seat 4: 3q7F5QtzC30pSrn0nl9i+A ($35.20 in chips)
Seat 5: OGMLOcTNYZXZU81au7ztUw ($158.65 in chips)
Seat 6: NqVlOSH2lp+pp/TK3vvK5g ($46 in chips)
xAU6q2/cwmby2sxmA8VcmA: posts small blind $0.50
5lY8d6Cnm4HUkt/8FZSj4g: posts big blind $1
*** HOLE CARDS ***
G5ZSSN6RSON3gkNvk/SmYg: folds
3q7F5QtzC30pSrn0nl9i+A: calls $1
OGMLOcTNYZXZU81au7ztUw: folds
NqVlOSH2lp+pp/TK3vvK5g: calls $1
xAU6q2/cwmby2sxmA8VcmA: calls $0.50
5lY8d6Cnm4HUkt/8FZSj4g: checks
*** FLOP *** [4d 5h Jh]
xAU6q2/cwmby2sxmA8VcmA: checks
5lY8d6Cnm4HUkt/8FZSj4g: bets $3
3q7F5QtzC30pSrn0nl9i+A: folds
NqVlOSH2lp+pp/TK3vvK5g: folds
xAU6q2/cwmby2sxmA8VcmA: folds
5lY8d6Cnm4HUkt/8FZSj4g collected $3.80 from pot
*** SUMMARY ***
Total pot $4 | Rake $0.20
Board [4d 5h Jh]
Seat 1: xAU6q2/cwmby2sxmA8VcmA (small blind) folded on the Flop
Seat 2: 5lY8d6Cnm4HUkt/8FZSj4g (big blind) collected ($3.80)
Seat 3: G5ZSSN6RSON3gkNvk/SmYg folded before Flop (didn't bet)
Seat 4: 3q7F5QtzC30pSrn0nl9i+A folded on the Flop
Seat 5: OGMLOcTNYZXZU81au7ztUw folded before Flop (didn't bet)
Seat 6: NqVlOSH2lp+pp/TK3vvK5g (button) folded on the Flop



PokerStars Game #59939840972:  Hold'em No Limit ($0.50/$1.00) - 2009/07/01 0:50:21 ET
Table 'LmXQK9xy3awB+qsPzI21Mw' 2-max Seat #1 is the button
Seat 1: NYi6JFscYNrofSXy4sM+Yw ($198.05 in chips)
Seat 2: TME8GvochpQAo8cmJwWmvA ($131.70 in chips)
NYi6JFscYNrofSXy4sM+Yw: posts small blind $0.50
TME8GvochpQAo8cmJwWmvA: posts big blind $1
*** HOLE CARDS ***
NYi6JFscYNrofSXy4sM+Yw: raises $2 to $3
TME8GvochpQAo8cmJwWmvA: folds
NYi6JFscYNrofSXy4sM+Yw collected $2 from pot
NYi6JFscYNrofSXy4sM+Yw: doesn't show hand
*** SUMMARY ***
Total pot $2 | Rake $0
Seat 1: NYi6JFscYNrofSXy4sM+Yw (button) (small blind) collected ($2)
Seat 2: TME8GvochpQAo8cmJwWmvA (big blind) folded before Flop



PokerStars Game #59939841276:  Hold'em No Limit ($0.50/$1.00) - 2009/07/01 0:50:21 ET
Table 'uNlePsyMIqzM691Xkrlk6Q' 9-max Seat #5 is the button
Seat 1: bLbSOSmSOnqE0iTcH/5dxA ($100 in chips)
Seat 2: +OqpStnt0FqbCfyHAWaLbg ($88.60 in chips)
Seat 3: h7qXkU57Bb8ZuPwMyxR8Ug ($32.85 in chips)
Seat 4: TZcz9MEWDA+WydgGruqqbw ($101.15 in chips)
Seat 5: 3obndzTJ6fECz8+wWhMd1w ($17 in chips)
Seat 6: myIxN7otsyr846M539YR8Q ($19 in chips)
Seat 7: w6cw9nzN7AvkkHBVVjykoQ ($45.90 in chips)
Seat 8: laA8va+Yv8WuMqT1zdR91g ($100 in chips)
Seat 9: vR4IO10geOgvTW+LAUBv/A ($103.75 in chips)
myIxN7otsyr846M539YR8Q: posts small blind $0.50
w6cw9nzN7AvkkHBVVjykoQ: posts big blind $1
*** HOLE CARDS ***
laA8va+Yv8WuMqT1zdR91g: folds
vR4IO10geOgvTW+LAUBv/A: folds
bLbSOSmSOnqE0iTcH/5dxA: folds
+OqpStnt0FqbCfyHAWaLbg: folds
h7qXkU57Bb8ZuPwMyxR8Ug: folds
TZcz9MEWDA+WydgGruqqbw: folds
3obndzTJ6fECz8+wWhMd1w: raises $2 to $3
myIxN7otsyr846M539YR8Q: folds
w6cw9nzN7AvkkHBVVjykoQ: folds
3obndzTJ6fECz8+wWhMd1w collected $2.50 from pot
*** SUMMARY ***
Total pot $2.50 | Rake $0
Seat 1: bLbSOSmSOnqE0iTcH/5dxA folded before Flop (didn't bet)
Seat 2: +OqpStnt0FqbCfyHAWaLbg folded before Flop (didn't bet)
Seat 3: h7qXkU57Bb8ZuPwMyxR8Ug folded before Flop (didn't bet)
Seat 4: TZcz9MEWDA+WydgGruqqbw folded before Flop (didn't bet)
Seat 5: 3obndzTJ6fECz8+wWhMd1w (button) collected ($2.50)
Seat 6: myIxN7otsyr846M539YR8Q (small blind) folded before Flop
Seat 7: w6cw9nzN7AvkkHBVVjykoQ (big blind) folded before Flop
Seat 8: laA8va+Yv8WuMqT1zdR91g folded before Flop (didn't bet)
Seat 9: vR4IO10geOgvTW+LAUBv/A folded before Flop (didn't bet)



PokerStars Game #59939840994:  Hold'em No Limit ($0.50/$1.00) - 2009/07/01 0:50:21 ET
Table 'rmZfTK+oSebeUPJNbWhdAA' 6-max Seat #6 is the button
Seat 1: xAU6q2/cwmby2sxmA8VcmA ($100 in chips)
Seat 2: z7O9PO/WEcqRouIydFhS9Q ($114.45 in chips)
Seat 4: 1/mIuXfgx1ZyVkodrmfQDw ($100 in chips)
Seat 5: 5lY8d6Cnm4HUkt/8FZSj4g ($96.35 in chips)
Seat 6: j7NIOHLZk7V2o9fOioO5ug ($135.30 in chips)
xAU6q2/cwmby2sxmA8VcmA: posts small blind $0.50
z7O9PO/WEcqRouIydFhS9Q: posts big blind $1
*** HOLE CARDS ***
1/mIuXfgx1ZyVkodrmfQDw: raises $2 to $3
5lY8d6Cnm4HUkt/8FZSj4g: folds
j7NIOHLZk7V2o9fOioO5ug: folds
xAU6q2/cwmby2sxmA8VcmA: folds
z7O9PO/WEcqRouIydFhS9Q: folds
1/mIuXfgx1ZyVkodrmfQDw collected $2.50 from pot
1/mIuXfgx1ZyVkodrmfQDw: doesn't show hand
*** SUMMARY ***
Total pot $2.50 | Rake $0
Seat 1: xAU6q2/cwmby2sxmA8VcmA (small blind) folded before Flop
Seat 2: z7O9PO/WEcqRouIydFhS9Q (big blind) folded before Flop
Seat 4: 1/mIuXfgx1ZyVkodrmfQDw collected ($2.50)
Seat 5: 5lY8d6Cnm4HUkt/8FZSj4g folded before Flop (didn't bet)
Seat 6: j7NIOHLZk7V2o9fOioO5ug (button) folded before Flop (didn't bet)



PokerStars Game #59939841490:  Hold'em No Limit ($0.50/$1.00) - 2009/07/01 0:50:22 ET
Table 'JOIm/fogLA7vSG0Vc6ME1A' 2-max Seat #1 is the button
Seat 1: NYi6JFscYNrofSXy4sM+Yw ($100 in chips)
Seat 2: F5lNTyZLIX9W2wQZ0plwgg ($117.30 in chips)
NYi6JFscYNrofSXy4sM+Yw: posts small blind $0.50
F5lNTyZLIX9W2wQZ0plwgg: posts big blind $1
*** HOLE CARDS ***
NYi6JFscYNrofSXy4sM+Yw: raises $2 to $3
F5lNTyZLIX9W2wQZ0plwgg: calls $2
*** FLOP *** [3c 8d 5d]
F5lNTyZLIX9W2wQZ0plwgg: bets $1
NYi6JFscYNrofSXy4sM+Yw: raises $4 to $5
F5lNTyZLIX9W2wQZ0plwgg: folds
NYi6JFscYNrofSXy4sM+Yw collected $7.65 from pot
*** SUMMARY ***
Total pot $8 | Rake $0.35
Board [3c 8d 5d]
Seat 1: NYi6JFscYNrofSXy4sM+Yw (button) (small blind) collected ($7.65)
Seat 2: F5lNTyZLIX9W2wQZ0plwgg (big blind) folded on the Flop



PokerStars Game #59939842346:  Hold'em No Limit ($0.50/$1.00) - 2009/07/01 0:50:23 ET
Table 'VOs36P6NW+QyXeQ1B62kmA' 6-max Seat #2 is the button
Seat 1: AdLVjddOzm+sRNo1Bc3S6Q ($130.80 in chips)
Seat 2: KpnW5CcJ4Mg6MeclfKmLrw ($121.35 in chips)
Seat 3: TSuRyAHnUPCFjP7Z0rEE0w ($100 in chips)
Seat 4: w02zQzNydODiyV9THKgo9w ($28.30 in chips)
Seat 5: ozrlafxxh1HmYdA0/h+MuA ($26.30 in chips)
Seat 6: 6tvjsJrdmWg+g7FVrMnzXA ($88 in chips)
TSuRyAHnUPCFjP7Z0rEE0w: posts small blind $0.50
w02zQzNydODiyV9THKgo9w: posts big blind $1
*** HOLE CARDS ***
ozrlafxxh1HmYdA0/h+MuA: calls $1
6tvjsJrdmWg+g7FVrMnzXA: folds
AdLVjddOzm+sRNo1Bc3S6Q: folds
KpnW5CcJ4Mg6MeclfKmLrw: folds
TSuRyAHnUPCFjP7Z0rEE0w: folds
w02zQzNydODiyV9THKgo9w: checks
*** FLOP *** [Qd 4s Qh]
w02zQzNydODiyV9THKgo9w: bets $3
ozrlafxxh1HmYdA0/h+MuA: folds
w02zQzNydODiyV9THKgo9w collected $2.40 from pot
*** SUMMARY ***
Total pot $2.50 | Rake $0.10
Board [Qd 4s Qh]
Seat 1: AdLVjddOzm+sRNo1Bc3S6Q folded before Flop (didn't bet)
Seat 2: KpnW5CcJ4Mg6MeclfKmLrw (button) folded before Flop (didn't bet)
Seat 3: TSuRyAHnUPCFjP7Z0rEE0w (small blind) folded before Flop
Seat 4: w02zQzNydODiyV9THKgo9w (big blind) collected ($2.40)
Seat 5: ozrlafxxh1HmYdA0/h+MuA folded on the Flop
Seat 6: 6tvjsJrdmWg+g7FVrMnzXA folded before Flop (didn't bet)



PokerStars Game #59939843032:  Hold'em No Limit ($0.50/$1.00) - 2009/07/01 0:50:24 ET
Table '6YvsYDPNIDx2v5z3bJnwZQ' 9-max Seat #4 is the button
Seat 1: Ogn4JDV3mp4ZDKO49IFzKA ($19.70 in chips)
Seat 2: x80+i7DJL+81v3quj7KbNg ($20 in chips)
Seat 3: negfosHnGOZXSHpWDRKyBQ ($20 in chips)
Seat 4: kEr5NYB+JIG5+szcYMr6hA ($42.25 in chips)
Seat 5: mBRWbnUl8diyBO1qTJaNzw ($165.70 in chips)
Seat 6: 7RSwrjMohkYrZAhOd1uaZg ($19 in chips)
Seat 7: mae7OMTaJ/MFimNbZegCkg ($49 in chips)
Seat 8: PSFxpXgPedVZyHSu2Zhb7Q ($103.05 in chips)
Seat 9: ZgMRSHJ9EOtPeVHmdeV9kQ ($57 in chips)
mBRWbnUl8diyBO1qTJaNzw: posts small blind $0.50
7RSwrjMohkYrZAhOd1uaZg: posts big blind $1
*** HOLE CARDS ***
mae7OMTaJ/MFimNbZegCkg: folds
PSFxpXgPedVZyHSu2Zhb7Q: calls $1
ZgMRSHJ9EOtPeVHmdeV9kQ: folds
Ogn4JDV3mp4ZDKO49IFzKA: folds
x80+i7DJL+81v3quj7KbNg: folds
negfosHnGOZXSHpWDRKyBQ: folds
kEr5NYB+JIG5+szcYMr6hA: calls $1
mBRWbnUl8diyBO1qTJaNzw: folds
7RSwrjMohkYrZAhOd1uaZg: checks
*** FLOP *** [6s 8h 9s]
7RSwrjMohkYrZAhOd1uaZg: checks
PSFxpXgPedVZyHSu2Zhb7Q: bets $2
kEr5NYB+JIG5+szcYMr6hA: folds
7RSwrjMohkYrZAhOd1uaZg: folds
PSFxpXgPedVZyHSu2Zhb7Q collected $3.35 from pot
*** SUMMARY ***
Total pot $3.50 | Rake $0.15
Board [6s 8h 9s]
Seat 1: Ogn4JDV3mp4ZDKO49IFzKA folded before Flop (didn't bet)
Seat 2: x80+i7DJL+81v3quj7KbNg folded before Flop (didn't bet)
Seat 3: negfosHnGOZXSHpWDRKyBQ folded before Flop (didn't bet)
Seat 4: kEr5NYB+JIG5+szcYMr6hA (button) folded on the Flop
Seat 5: mBRWbnUl8diyBO1qTJaNzw (small blind) folded before Flop
Seat 6: 7RSwrjMohkYrZAhOd1uaZg (big blind) folded on the Flop
Seat 7: mae7OMTaJ/MFimNbZegCkg folded before Flop (didn't bet)
Seat 8: PSFxpXgPedVZyHSu2Zhb7Q collected ($3.35)
Seat 9: ZgMRSHJ9EOtPeVHmdeV9kQ folded before Flop (didn't bet)



PokerStars Game #59939842996:  Hold'em No Limit ($0.50/$1.00) - 2009/07/01 0:50:24 ET
Table 'GPp0HyAuggN8oE0sUWzPpA' 9-max Seat #4 is the button
Seat 1: qJr25HAtvv1w/7IBvjMM3g ($27.50 in chips)
Seat 3: CCCXsirC+bO7ginAuUUVlQ ($60 in chips)
Seat 4: mBRWbnUl8diyBO1qTJaNzw ($108.20 in chips)
Seat 5: 0fXz44fzDo5QmhAaJCvFfA ($18.30 in chips)
Seat 6: BK/GtNPkSx0TdUDj82id5A ($12 in chips)
Seat 7: laA8va+Yv8WuMqT1zdR91g ($100 in chips)
Seat 8: tkdBeXTJlFsZdioidNqLow ($71.20 in chips)
Seat 9: VPF+HjszMvUIpy0CHIwH3A ($23.50 in chips)
0fXz44fzDo5QmhAaJCvFfA: posts small blind $0.50
BK/GtNPkSx0TdUDj82id5A: posts big blind $1
CCCXsirC+bO7ginAuUUVlQ: posts big blind $1
*** HOLE CARDS ***
laA8va+Yv8WuMqT1zdR91g: folds
laA8va+Yv8WuMqT1zdR91g leaves the table
tkdBeXTJlFsZdioidNqLow: folds
VPF+HjszMvUIpy0CHIwH3A: folds
qJr25HAtvv1w/7IBvjMM3g: folds
CCCXsirC+bO7ginAuUUVlQ: checks
mBRWbnUl8diyBO1qTJaNzw: calls $1
m3U8I35Pn3gxKhoS2nmYIg joins the table at seat #2
DHdbHyysD15wCAtx+BhUjA joins the table at seat #7
0fXz44fzDo5QmhAaJCvFfA: calls $0.50
BK/GtNPkSx0TdUDj82id5A: checks
*** FLOP *** [Qh Kc 5c]
0fXz44fzDo5QmhAaJCvFfA: checks
BK/GtNPkSx0TdUDj82id5A: checks
CCCXsirC+bO7ginAuUUVlQ: checks
mBRWbnUl8diyBO1qTJaNzw: checks
*** TURN *** [Qh Kc 5c] [4s]
0fXz44fzDo5QmhAaJCvFfA: checks
BK/GtNPkSx0TdUDj82id5A: checks
CCCXsirC+bO7ginAuUUVlQ: checks
mBRWbnUl8diyBO1qTJaNzw: checks
*** RIVER *** [Qh Kc 5c 4s] [6s]
0fXz44fzDo5QmhAaJCvFfA: checks
BK/GtNPkSx0TdUDj82id5A: checks
CCCXsirC+bO7ginAuUUVlQ: checks
mBRWbnUl8diyBO1qTJaNzw: checks
*** SHOW DOWN ***
0fXz44fzDo5QmhAaJCvFfA: shows [9s Jh] (high card King)
BK/GtNPkSx0TdUDj82id5A: shows [2c Ac] (high card Ace)
CCCXsirC+bO7ginAuUUVlQ: shows [5h 9d] (a pair of Fives)
mBRWbnUl8diyBO1qTJaNzw: mucks hand
CCCXsirC+bO7ginAuUUVlQ collected $3.80 from pot
*** SUMMARY ***
Total pot $4 | Rake $0.20
Board [Qh Kc 5c 4s 6s]
Seat 1: qJr25HAtvv1w/7IBvjMM3g folded before Flop (didn't bet)
Seat 3: CCCXsirC+bO7ginAuUUVlQ showed [5h 9d] and won ($3.80) with a pair of Fives
Seat 4: mBRWbnUl8diyBO1qTJaNzw (button) mucked
Seat 5: 0fXz44fzDo5QmhAaJCvFfA (small blind) showed [9s Jh] and lost with high card King
Seat 6: BK/GtNPkSx0TdUDj82id5A (big blind) showed [2c Ac] and lost with high card Ace
Seat 7: laA8va+Yv8WuMqT1zdR91g folded before Flop (didn't bet)
Seat 8: tkdBeXTJlFsZdioidNqLow folded before Flop (didn't bet)
Seat 9: VPF+HjszMvUIpy0CHIwH3A folded before Flop (didn't bet)



PokerStars Game #59939844674:  Hold'em No Limit ($0.50/$1.00) - 2009/07/01 0:50:27 ET
Table '7Nl0ffnjeK44/vmeexh3MQ' 9-max Seat #3 is the button
Seat 1: s7D3Y+k4Cj4D1cXHv7oj+Q ($90.85 in chips)
Seat 2: OGgaARGdJQT4awWVNQ957w ($100 in chips)
Seat 3: vR4IO10geOgvTW+LAUBv/A ($100 in chips)
Seat 4: bLbSOSmSOnqE0iTcH/5dxA ($109 in chips)
Seat 5: bL+QVeDcuEdzMGAGg2XJHg ($105.05 in chips)
Seat 6: FVs16t7GgfWgQWt4JxsObQ ($26.50 in chips)
Seat 7: 997ViqAtWn1FPjJqcffwcA ($100 in chips)
Seat 8: zanka7aAZkigmZpfopXxxA ($253.35 in chips)
Seat 9: ouwUBGRKnKK9uhn1G4Lf+A ($99.50 in chips)
bLbSOSmSOnqE0iTcH/5dxA: posts small blind $0.50
bL+QVeDcuEdzMGAGg2XJHg: posts big blind $1
*** HOLE CARDS ***
FVs16t7GgfWgQWt4JxsObQ: folds
997ViqAtWn1FPjJqcffwcA: folds
zanka7aAZkigmZpfopXxxA: raises $2 to $3
ouwUBGRKnKK9uhn1G4Lf+A: folds
s7D3Y+k4Cj4D1cXHv7oj+Q: calls $3
OGgaARGdJQT4awWVNQ957w: folds
vR4IO10geOgvTW+LAUBv/A: folds
bLbSOSmSOnqE0iTcH/5dxA: folds
bL+QVeDcuEdzMGAGg2XJHg: folds
*** FLOP *** [6d Ts Jh]
zanka7aAZkigmZpfopXxxA: checks
s7D3Y+k4Cj4D1cXHv7oj+Q: checks
*** TURN *** [6d Ts Jh] [9d]
zanka7aAZkigmZpfopXxxA: bets $3
s7D3Y+k4Cj4D1cXHv7oj+Q: calls $3
*** RIVER *** [6d Ts Jh 9d] [3s]
zanka7aAZkigmZpfopXxxA: checks
s7D3Y+k4Cj4D1cXHv7oj+Q: checks
*** SHOW DOWN ***
zanka7aAZkigmZpfopXxxA: shows [Ad Qc] (high card Ace)
s7D3Y+k4Cj4D1cXHv7oj+Q: shows [9h Ah] (a pair of Nines)
s7D3Y+k4Cj4D1cXHv7oj+Q collected $12.85 from pot
*** SUMMARY ***
Total pot $13.50 | Rake $0.65
Board [6d Ts Jh 9d 3s]
Seat 1: s7D3Y+k4Cj4D1cXHv7oj+Q showed [9h Ah] and won ($12.85) with a pair of Nines
Seat 2: OGgaARGdJQT4awWVNQ957w folded before Flop (didn't bet)
Seat 3: vR4IO10geOgvTW+LAUBv/A (button) folded before Flop (didn't bet)
Seat 4: bLbSOSmSOnqE0iTcH/5dxA (small blind) folded before Flop
Seat 5: bL+QVeDcuEdzMGAGg2XJHg (big blind) folded before Flop
Seat 6: FVs16t7GgfWgQWt4JxsObQ folded before Flop (didn't bet)
Seat 7: 997ViqAtWn1FPjJqcffwcA folded before Flop (didn't bet)
Seat 8: zanka7aAZkigmZpfopXxxA showed [Ad Qc] and lost with high card Ace
Seat 9: ouwUBGRKnKK9uhn1G4Lf+A folded before Flop (didn't bet)



PokerStars Game #59939844830:  Hold'em No Limit ($0.50/$1.00) - 2009/07/01 0:50:27 ET
Table 'LmXQK9xy3awB+qsPzI21Mw' 2-max Seat #2 is the button
Seat 1: NYi6JFscYNrofSXy4sM+Yw ($199.05 in chips)
Seat 2: TME8GvochpQAo8cmJwWmvA ($130.70 in chips)
TME8GvochpQAo8cmJwWmvA: posts small blind $0.50
NYi6JFscYNrofSXy4sM+Yw: posts big blind $1
*** HOLE CARDS ***
TME8GvochpQAo8cmJwWmvA: calls $0.50
NYi6JFscYNrofSXy4sM+Yw: raises $3 to $4
TME8GvochpQAo8cmJwWmvA: folds
NYi6JFscYNrofSXy4sM+Yw collected $2 from pot
*** SUMMARY ***
Total pot $2 | Rake $0
Seat 1: NYi6JFscYNrofSXy4sM+Yw (big blind) collected ($2)
Seat 2: TME8GvochpQAo8cmJwWmvA (button) (small blind) folded before Flop



PokerStars Game #59939845492:  Hold'em No Limit ($0.50/$1.00) - 2009/07/01 0:50:28 ET
Table 'tyUh+jyNvrceIQdKMJjQ2wZFWj23PMihdwrNWv41OG/Qeat #4 is the button
Seat 1: o8A5MUdudVKu+pAwgZOX2w ($205.95 in chips)
Seat 2: XvUbOIg94d25feWeQlOTVg ($71.90 in chips)
Seat 3: TalCiLYHCd+ffkmR3auPvA ($92.40 in chips)
Seat 4: TSuRyAHnUPCFjP7Z0rEE0w ($116.75 in chips)
Seat 5: j7NIOHLZk7V2o9fOioO5ug ($100 in chips)
Seat 6: YsLQ3BAvgQHWXMAv3Wv6Hg ($148.15 in chips)
j7NIOHLZk7V2o9fOioO5ug: posts small blind $0.50
YsLQ3BAvgQHWXMAv3Wv6Hg: posts big blind $1
*** HOLE CARDS ***
o8A5MUdudVKu+pAwgZOX2w: folds
XvUbOIg94d25feWeQlOTVg: calls $1
TalCiLYHCd+ffkmR3auPvA: calls $1
TSuRyAHnUPCFjP7Z0rEE0w: folds
j7NIOHLZk7V2o9fOioO5ug: folds
YsLQ3BAvgQHWXMAv3Wv6Hg: raises $5 to $6
XvUbOIg94d25feWeQlOTVg: folds
TalCiLYHCd+ffkmR3auPvA: folds
YsLQ3BAvgQHWXMAv3Wv6Hg collected $3.50 from pot
YsLQ3BAvgQHWXMAv3Wv6Hg: doesn't show hand
*** SUMMARY ***
Total pot $3.50 | Rake $0
Seat 1: o8A5MUdudVKu+pAwgZOX2w folded before Flop (didn't bet)
Seat 2: XvUbOIg94d25feWeQlOTVg folded before Flop
Seat 3: TalCiLYHCd+ffkmR3auPvA folded before Flop
Seat 4: TSuRyAHnUPCFjP7Z0rEE0w (button) folded before Flop (didn't bet)
Seat 5: j7NIOHLZk7V2o9fOioO5ug (small blind) folded before Flop
Seat 6: YsLQ3BAvgQHWXMAv3Wv6Hg (big blind) collected ($3.50)



PokerStars Game #59939845642:  Hold'em No Limit ($0.50/$1.00) - 2009/07/01 0:50:28 ET
Table 'hugOjcwJvzEwZbK7tyiWuQ' 9-max Seat #8 is the button
Seat 2: r27C1nIV4NS4+qbnrgBQSw ($260.60 in chips)
Seat 3: jDwhY1kCdc6EkAHbT7PJMQ ($103.65 in chips)
Seat 4: UWB3oeddt/GObx2Mix2Anw ($205.75 in chips)
Seat 5: 5BRGWf+R3nt2WS3b5xX+zA ($27.20 in chips)
Seat 6: gUUvmqdVlmvpal6B8nYrmg ($106.20 in chips)
Seat 7: FL3MrLspcF23LYvC4ipBOA ($100 in chips)
Seat 8: /zy+DB4S5fUQUSfZWFzYGw ($100 in chips)
Seat 9: W8P9bUKCs43TO1xHm0dL6w ($89.05 in chips)
W8P9bUKCs43TO1xHm0dL6w: posts small blind $0.50
r27C1nIV4NS4+qbnrgBQSw: posts big blind $1
*** HOLE CARDS ***
jDwhY1kCdc6EkAHbT7PJMQ: folds
UWB3oeddt/GObx2Mix2Anw: folds
5BRGWf+R3nt2WS3b5xX+zA: folds
gUUvmqdVlmvpal6B8nYrmg: folds
FL3MrLspcF23LYvC4ipBOA: folds
/zy+DB4S5fUQUSfZWFzYGw: folds
W8P9bUKCs43TO1xHm0dL6w: calls $0.50
r27C1nIV4NS4+qbnrgBQSw: checks
*** FLOP *** [Qc 2c Qd]
W8P9bUKCs43TO1xHm0dL6w: checks
r27C1nIV4NS4+qbnrgBQSw: bets $2
W8P9bUKCs43TO1xHm0dL6w: folds
r27C1nIV4NS4+qbnrgBQSw collected $1.90 from pot
r27C1nIV4NS4+qbnrgBQSw: doesn't show hand
*** SUMMARY ***
Total pot $2 | Rake $0.10
Board [Qc 2c Qd]
Seat 2: r27C1nIV4NS4+qbnrgBQSw (big blind) collected ($1.90)
Seat 3: jDwhY1kCdc6EkAHbT7PJMQ folded before Flop (didn't bet)
Seat 4: UWB3oeddt/GObx2Mix2Anw folded before Flop (didn't bet)
Seat 5: 5BRGWf+R3nt2WS3b5xX+zA folded before Flop (didn't bet)
Seat 6: gUUvmqdVlmvpal6B8nYrmg folded before Flop (didn't bet)
Seat 7: FL3MrLspcF23LYvC4ipBOA folded before Flop (didn't bet)
Seat 8: /zy+DB4S5fUQUSfZWFzYGw (button) folded before Flop (didn't bet)
Seat 9: W8P9bUKCs43TO1xHm0dL6w (small blind) folded on the Flop



PokerStars Game #59939846126:  Hold'em No Limit ($0.50/$1.00) - 2009/07/01 0:50:29 ET
Table '/RZcOwpZpHQ+OwPwjsbnRw' 6-max Seat #5 is the button
Seat 1: Zboa6dColKGHBjLPUakZjw ($40.40 in chips)
Seat 2: +xW7QemQU0Fxs+4TnqBRow ($193 in chips)
Seat 3: XnT1yK2DD/5FL+0bwuEhqg ($47.95 in chips)
Seat 4: j7NIOHLZk7V2o9fOioO5ug ($120.35 in chips)
Seat 5: wx3sQGkVi2x9wJXuWNHPBw ($180.65 in chips)
Seat 6: XOIf9W+VAxhZqN+SYoyMKA ($292.25 in chips)
XOIf9W+VAxhZqN+SYoyMKA: posts small blind $0.50
Zboa6dColKGHBjLPUakZjw: posts big blind $1
*** HOLE CARDS ***
+xW7QemQU0Fxs+4TnqBRow: folds
XnT1yK2DD/5FL+0bwuEhqg: folds
j7NIOHLZk7V2o9fOioO5ug: folds
wx3sQGkVi2x9wJXuWNHPBw: raises $2 to $3
XOIf9W+VAxhZqN+SYoyMKA: folds
Zboa6dColKGHBjLPUakZjw: folds
wx3sQGkVi2x9wJXuWNHPBw collected $2.50 from pot
*** SUMMARY ***
Total pot $2.50 | Rake $0
Seat 1: Zboa6dColKGHBjLPUakZjw (big blind) folded before Flop
Seat 2: +xW7QemQU0Fxs+4TnqBRow folded before Flop (didn't bet)
Seat 3: XnT1yK2DD/5FL+0bwuEhqg folded before Flop (didn't bet)
Seat 4: j7NIOHLZk7V2o9fOioO5ug folded before Flop (didn't bet)
Seat 5: wx3sQGkVi2x9wJXuWNHPBw (button) collected ($2.50)
Seat 6: XOIf9W+VAxhZqN+SYoyMKA (small blind) folded before Flop



PokerStars Game #59939847128:  Hold'em No Limit ($0.50/$1.00) - 2009/07/01 0:50:31 ET
Table 'mmbQQVBTrPdE+wy+s+9VPA' 6-max Seat #3 is the button
Seat 2: +W6OnF033KNM2xH0fGj98Q ($123.30 in chips)
Seat 3: wx3sQGkVi2x9wJXuWNHPBw ($114.15 in chips)
Seat 4: RfKnhkJN8HEAuzJpH2Ajdg ($16.25 in chips)
Seat 5: YMJG+F++3Aj6P8dAWda5fw ($95 in chips)
Seat 6: U2CWBTv29qdCbj8RNF2sIw ($100 in chips)
RfKnhkJN8HEAuzJpH2Ajdg: posts small blind $0.50
YMJG+F++3Aj6P8dAWda5fw: posts big blind $1
JwCcjZl0bjJzG7hmE0dnTA: sits out
*** HOLE CARDS ***
U2CWBTv29qdCbj8RNF2sIw: folds
+W6OnF033KNM2xH0fGj98Q: folds
wx3sQGkVi2x9wJXuWNHPBw: folds
RfKnhkJN8HEAuzJpH2Ajdg: calls $0.50
YMJG+F++3Aj6P8dAWda5fw: checks
*** FLOP *** [4d 9h Qh]
RfKnhkJN8HEAuzJpH2Ajdg: checks
YMJG+F++3Aj6P8dAWda5fw: checks
*** TURN *** [4d 9h Qh] [Jd]
RfKnhkJN8HEAuzJpH2Ajdg: checks
YMJG+F++3Aj6P8dAWda5fw: bets $1
RfKnhkJN8HEAuzJpH2Ajdg: calls $1
*** RIVER *** [4d 9h Qh Jd] [6c]
RfKnhkJN8HEAuzJpH2Ajdg: checks
YMJG+F++3Aj6P8dAWda5fw: bets $2
RfKnhkJN8HEAuzJpH2Ajdg: folds
YMJG+F++3Aj6P8dAWda5fw collected $3.85 from pot
*** SUMMARY ***
Total pot $4 | Rake $0.15
Board [4d 9h Qh Jd 6c]
Seat 2: +W6OnF033KNM2xH0fGj98Q folded before Flop (didn't bet)
Seat 3: wx3sQGkVi2x9wJXuWNHPBw (button) folded before Flop (didn't bet)
Seat 4: RfKnhkJN8HEAuzJpH2Ajdg (small blind) folded on the River
Seat 5: YMJG+F++3Aj6P8dAWda5fw (big blind) collected ($3.85)
Seat 6: U2CWBTv29qdCbj8RNF2sIw folded before Flop (didn't bet)



PokerStars Game #59939847990:  Hold'em No Limit ($0.50/$1.00) - 2009/07/01 0:50:32 ET
Table 'pHrhryH8jPNdQfY62f8v+g' 6-max Seat #5 is the button
Seat 1: fF4botNMr8/ieVPO1YYRLw ($56 in chips)
Seat 2: RqgF7gRoKgRNW8Zoi1ty4A ($101.75 in chips)
Seat 3: 8oS5O7iD/qnFXFXJrGIgNQ ($100 in chips)
Seat 4: wenbG7TaM3H7h5kn78OFNw ($57.20 in chips)
Seat 5: r1/R7y0Ortgoz4lccgW8VA ($54.40 in chips)
Seat 6: xAU6q2/cwmby2sxmA8VcmA ($117.80 in chips)
xAU6q2/cwmby2sxmA8VcmA: posts small blind $0.50
fF4botNMr8/ieVPO1YYRLw: posts big blind $1
*** HOLE CARDS ***
RqgF7gRoKgRNW8Zoi1ty4A: folds
8oS5O7iD/qnFXFXJrGIgNQ: folds
wenbG7TaM3H7h5kn78OFNw: raises $2 to $3
r1/R7y0Ortgoz4lccgW8VA: folds
xAU6q2/cwmby2sxmA8VcmA: folds
fF4botNMr8/ieVPO1YYRLw: folds
wenbG7TaM3H7h5kn78OFNw collected $2.50 from pot
*** SUMMARY ***
Total pot $2.50 | Rake $0
Seat 1: fF4botNMr8/ieVPO1YYRLw (big blind) folded before Flop
Seat 2: RqgF7gRoKgRNW8Zoi1ty4A folded before Flop (didn't bet)
Seat 3: 8oS5O7iD/qnFXFXJrGIgNQ folded before Flop (didn't bet)
Seat 4: wenbG7TaM3H7h5kn78OFNw collected ($2.50)
Seat 5: r1/R7y0Ortgoz4lccgW8VA (button) folded before Flop (didn't bet)
Seat 6: xAU6q2/cwmby2sxmA8VcmA (small blind) folded before Flop



PokerStars Game #59939848484:  Hold'em No Limit ($0.50/$1.00) - 2009/07/01 0:50:33 ET
Table 'eU3bWpDDg3Z+9R4m4iVmog' 6-max Seat #5 is the button
Seat 1: TSuRyAHnUPCFjP7Z0rEE0w ($192.65 in chips)
Seat 2: 8CAoOzhmB8n3nRFf3V4BTg ($103 in chips)
Seat 3: U6tnjwZRpTnM+YkqkCjwyQ ($187.15 in chips)
Seat 4: GDVIsbEJ/DOJsMKE4Asz0A ($66.80 in chips)
Seat 5: AdLVjddOzm+sRNo1Bc3S6Q ($105.05 in chips)
Seat 6: hpxXcmRkXXI9HE5+5/j/0Q ($120.95 in chips)
hpxXcmRkXXI9HE5+5/j/0Q: posts small blind $0.50
TSuRyAHnUPCFjP7Z0rEE0w: posts big blind $1
*** HOLE CARDS ***
8CAoOzhmB8n3nRFf3V4BTg: folds
U6tnjwZRpTnM+YkqkCjwyQ: raises $2 to $3
GDVIsbEJ/DOJsMKE4Asz0A: folds
AdLVjddOzm+sRNo1Bc3S6Q: folds
hpxXcmRkXXI9HE5+5/j/0Q: folds
TSuRyAHnUPCFjP7Z0rEE0w: folds
U6tnjwZRpTnM+YkqkCjwyQ collected $2.50 from pot
*** SUMMARY ***
Total pot $2.50 | Rake $0
Seat 1: TSuRyAHnUPCFjP7Z0rEE0w (big blind) folded before Flop
Seat 2: 8CAoOzhmB8n3nRFf3V4BTg folded before Flop (didn't bet)
Seat 3: U6tnjwZRpTnM+YkqkCjwyQ collected ($2.50)
Seat 4: GDVIsbEJ/DOJsMKE4Asz0A folded before Flop (didn't bet)
Seat 5: AdLVjddOzm+sRNo1Bc3S6Q (button) folded before Flop (didn't bet)
Seat 6: hpxXcmRkXXI9HE5+5/j/0Q (small blind) folded before Flop



PokerStars Game #59939850018:  Hold'em No Limit ($0.50/$1.00) - 2009/07/01 0:50:35 ET
Table 'JOIm/fogLA7vSG0Vc6ME1A' 2-max Seat #2 is the button
Seat 1: NYi6JFscYNrofSXy4sM+Yw ($103.65 in chips)
Seat 2: F5lNTyZLIX9W2wQZ0plwgg ($113.30 in chips)
F5lNTyZLIX9W2wQZ0plwgg: posts small blind $0.50
NYi6JFscYNrofSXy4sM+Yw: posts big blind $1
*** HOLE CARDS ***
F5lNTyZLIX9W2wQZ0plwgg: raises $1 to $2
NYi6JFscYNrofSXy4sM+Yw: raises $7 to $9
F5lNTyZLIX9W2wQZ0plwgg: folds
NYi6JFscYNrofSXy4sM+Yw collected $4 from pot
*** SUMMARY ***
Total pot $4 | Rake $0
Seat 1: NYi6JFscYNrofSXy4sM+Yw (big blind) collected ($4)
Seat 2: F5lNTyZLIX9W2wQZ0plwgg (button) (small blind) folded before Flop



PokerStars Game #59939850728:  Hold'em No Limit ($0.50/$1.00) - 2009/07/01 0:50:36 ET
Table 'Zka9tv1yilg0MvXWPQrShg' 9-max Seat #2 is the button
Seat 1: TZcz9MEWDA+WydgGruqqbw ($112.35 in chips)
Seat 2: kz9ziSiGUc+857heiKSayw ($20 in chips)
Seat 3: gUUvmqdVlmvpal6B8nYrmg ($100 in chips)
Seat 4: stxmTgSicxShtrDxhOOX2g ($70.65 in chips)
Seat 5: /zy+DB4S5fUQUSfZWFzYGw ($124.90 in chips)
Seat 6: rY8wPoax1lS+HUY+I0FZDw ($146.45 in chips)
Seat 7: p1SafS90nb3Uft5LB0NkHw ($20 in chips)
Seat 8: bL+QVeDcuEdzMGAGg2XJHg ($122.10 in chips)
Seat 9: 6daxhj43mWj04MOPTOmaYA ($92.65 in chips)
gUUvmqdVlmvpal6B8nYrmg: posts small blind $0.50
stxmTgSicxShtrDxhOOX2g: posts big blind $1
*** HOLE CARDS ***
/zy+DB4S5fUQUSfZWFzYGw: folds
rY8wPoax1lS+HUY+I0FZDw: calls $1
p1SafS90nb3Uft5LB0NkHw: raises $4 to $5
bL+QVeDcuEdzMGAGg2XJHg: folds
6daxhj43mWj04MOPTOmaYA: folds
TZcz9MEWDA+WydgGruqqbw: folds
kz9ziSiGUc+857heiKSayw: folds
gUUvmqdVlmvpal6B8nYrmg: folds
stxmTgSicxShtrDxhOOX2g: folds
rY8wPoax1lS+HUY+I0FZDw: folds
p1SafS90nb3Uft5LB0NkHw collected $3.50 from pot
*** SUMMARY ***
Total pot $3.50 | Rake $0
Seat 1: TZcz9MEWDA+WydgGruqqbw folded before Flop (didn't bet)
Seat 2: kz9ziSiGUc+857heiKSayw (button) folded before Flop (didn't bet)
Seat 3: gUUvmqdVlmvpal6B8nYrmg (small blind) folded before Flop
Seat 4: stxmTgSicxShtrDxhOOX2g (big blind) folded before Flop
Seat 5: /zy+DB4S5fUQUSfZWFzYGw folded before Flop (didn't bet)
Seat 6: rY8wPoax1lS+HUY+I0FZDw folded before Flop
Seat 7: p1SafS90nb3Uft5LB0NkHw collected ($3.50)
Seat 8: bL+QVeDcuEdzMGAGg2XJHg folded before Flop (didn't bet)
Seat 9: 6daxhj43mWj04MOPTOmaYA folded before Flop (didn't bet)



PokerStars Game #59939851364:  Hold'em No Limit ($0.50/$1.00) - 2009/07/01 0:50:37 ET
Table 'W/wyObTiXZm+Ckkl3YxcSw' 6-max Seat #4 is the button
Seat 1: eUBBn2R56C1IQ6Cs/vitwg ($112.25 in chips)
Seat 2: oDiBRCaF0QVtd3kO6xZIXw ($99.45 in chips)
Seat 3: ybGsYWp1MLwy1vSnP8egXg ($28.50 in chips)
Seat 4: +xW7QemQU0Fxs+4TnqBRow ($110.90 in chips)
Seat 5: BdbmJTZZ47quA9vUWwXtlw ($55.85 in chips)
Seat 6: tS9JHB1h+FQ++qu8RwRNgg ($27 in chips)
BdbmJTZZ47quA9vUWwXtlw: posts small blind $0.50
tS9JHB1h+FQ++qu8RwRNgg: posts big blind $1
*** HOLE CARDS ***
eUBBn2R56C1IQ6Cs/vitwg: folds
oDiBRCaF0QVtd3kO6xZIXw: folds
ybGsYWp1MLwy1vSnP8egXg: folds
+xW7QemQU0Fxs+4TnqBRow: folds
BdbmJTZZ47quA9vUWwXtlw: folds
tS9JHB1h+FQ++qu8RwRNgg collected $1 from pot
tS9JHB1h+FQ++qu8RwRNgg: doesn't show hand
*** SUMMARY ***
Total pot $1 | Rake $0
Seat 1: eUBBn2R56C1IQ6Cs/vitwg folded before Flop (didn't bet)
Seat 2: oDiBRCaF0QVtd3kO6xZIXw folded before Flop (didn't bet)
Seat 3: ybGsYWp1MLwy1vSnP8egXg folded before Flop (didn't bet)
Seat 4: +xW7QemQU0Fxs+4TnqBRow (button) folded before Flop (didn't bet)
Seat 5: BdbmJTZZ47quA9vUWwXtlw (small blind) folded before Flop
Seat 6: tS9JHB1h+FQ++qu8RwRNgg (big blind) collected ($1)



PokerStars Game #59939852536:  Hold'em No Limit ($0.50/$1.00) - 2009/07/01 0:50:39 ET
Table 'LmXQK9xy3awB+qsPzI21Mw' 2-max Seat #1 is the button
Seat 1: NYi6JFscYNrofSXy4sM+Yw ($200.05 in chips)
Seat 2: TME8GvochpQAo8cmJwWmvA ($129.70 in chips)
NYi6JFscYNrofSXy4sM+Yw: posts small blind $0.50
TME8GvochpQAo8cmJwWmvA: posts big blind $1
*** HOLE CARDS ***
NYi6JFscYNrofSXy4sM+Yw: raises $2 to $3
TME8GvochpQAo8cmJwWmvA: calls $2
*** FLOP *** [8c 3d 2d]
TME8GvochpQAo8cmJwWmvA: checks
NYi6JFscYNrofSXy4sM+Yw: bets $3
TME8GvochpQAo8cmJwWmvA: calls $3
*** TURN *** [8c 3d 2d] [9c]
TME8GvochpQAo8cmJwWmvA: checks
NYi6JFscYNrofSXy4sM+Yw: bets $8.50
TME8GvochpQAo8cmJwWmvA: calls $8.50
*** RIVER *** [8c 3d 2d 9c] [3h]
TME8GvochpQAo8cmJwWmvA: bets $115.20 and is all-in
NYi6JFscYNrofSXy4sM+Yw: folds
TME8GvochpQAo8cmJwWmvA collected $28.50 from pot
TME8GvochpQAo8cmJwWmvA: doesn't show hand
*** SUMMARY ***
Total pot $29 | Rake $0.50
Board [8c 3d 2d 9c 3h]
Seat 1: NYi6JFscYNrofSXy4sM+Yw (button) (small blind) folded on the River
Seat 2: TME8GvochpQAo8cmJwWmvA (big blind) collected ($28.50)



PokerStars Game #59939853786:  Hold'em No Limit ($0.50/$1.00) - 2009/07/01 0:50:41 ET
Table 'rmZfTK+oSebeUPJNbWhdAA' 6-max Seat #1 is the button
Seat 1: xAU6q2/cwmby2sxmA8VcmA ($100 in chips)
Seat 2: z7O9PO/WEcqRouIydFhS9Q ($113.45 in chips)
Seat 4: 1/mIuXfgx1ZyVkodrmfQDw ($101.50 in chips)
Seat 5: 5lY8d6Cnm4HUkt/8FZSj4g ($96.35 in chips)
Seat 6: j7NIOHLZk7V2o9fOioO5ug ($135.30 in chips)
z7O9PO/WEcqRouIydFhS9Q: posts small blind $0.50
1/mIuXfgx1ZyVkodrmfQDw: posts big blind $1
*** HOLE CARDS ***
5lY8d6Cnm4HUkt/8FZSj4g: folds
BCEV3COoKY607AzLWayfRA joins the table at seat #3
j7NIOHLZk7V2o9fOioO5ug: folds
xAU6q2/cwmby2sxmA8VcmA: folds
z7O9PO/WEcqRouIydFhS9Q: calls $0.50
1/mIuXfgx1ZyVkodrmfQDw: raises $2 to $3
z7O9PO/WEcqRouIydFhS9Q: folds
1/mIuXfgx1ZyVkodrmfQDw collected $2 from pot
1/mIuXfgx1ZyVkodrmfQDw: doesn't show hand
*** SUMMARY ***
Total pot $2 | Rake $0
Seat 1: xAU6q2/cwmby2sxmA8VcmA (button) folded before Flop (didn't bet)
Seat 2: z7O9PO/WEcqRouIydFhS9Q (small blind) folded before Flop
Seat 4: 1/mIuXfgx1ZyVkodrmfQDw (big blind) collected ($2)
Seat 5: 5lY8d6Cnm4HUkt/8FZSj4g folded before Flop (didn't bet)
Seat 6: j7NIOHLZk7V2o9fOioO5ug folded before Flop (didn't bet)



PokerStars Game #59939854528:  Hold'em No Limit ($0.50/$1.00) - 2009/07/01 0:50:42 ET
Table 'vs/5jr6ciwjVQ5+Soc+u2A' 6-max Seat #6 is the button
Seat 1: /P4w1pHg2zHYg/4ubJ0dPw ($60 in chips)
Seat 2: XOIf9W+VAxhZqN+SYoyMKA ($126.85 in chips)
Seat 3: G5ZSSN6RSON3gkNvk/SmYg ($150 in chips)
Seat 4: KpnW5CcJ4Mg6MeclfKmLrw ($127.70 in chips)
Seat 5: 2DwLxMUbmzvwY7o4/i47Xg ($39 in chips)
Seat 6: qAdBJlVNsNTwiHia50eMvg ($79.15 in chips)
/P4w1pHg2zHYg/4ubJ0dPw: posts small blind $0.50
XOIf9W+VAxhZqN+SYoyMKA: posts big blind $1
*** HOLE CARDS ***
G5ZSSN6RSON3gkNvk/SmYg: folds
KpnW5CcJ4Mg6MeclfKmLrw: folds
2DwLxMUbmzvwY7o4/i47Xg: calls $1
qAdBJlVNsNTwiHia50eMvg: calls $1
/P4w1pHg2zHYg/4ubJ0dPw: folds
XOIf9W+VAxhZqN+SYoyMKA: checks
*** FLOP *** [Ac 2d Td]
XOIf9W+VAxhZqN+SYoyMKA: checks
2DwLxMUbmzvwY7o4/i47Xg: checks
qAdBJlVNsNTwiHia50eMvg: bets $3
XOIf9W+VAxhZqN+SYoyMKA: folds
2DwLxMUbmzvwY7o4/i47Xg: folds
qAdBJlVNsNTwiHia50eMvg collected $3.35 from pot
*** SUMMARY ***
Total pot $3.50 | Rake $0.15
Board [Ac 2d Td]
Seat 1: /P4w1pHg2zHYg/4ubJ0dPw (small blind) folded before Flop
Seat 2: XOIf9W+VAxhZqN+SYoyMKA (big blind) folded on the Flop
Seat 3: G5ZSSN6RSON3gkNvk/SmYg folded before Flop (didn't bet)
Seat 4: KpnW5CcJ4Mg6MeclfKmLrw folded before Flop (didn't bet)
Seat 5: 2DwLxMUbmzvwY7o4/i47Xg folded on the Flop
Seat 6: qAdBJlVNsNTwiHia50eMvg (button) collected ($3.35)



PokerStars Game #59939855204:  Hold'em No Limit ($0.50/$1.00) - 2009/07/01 0:50:43 ET
Table 'tLrtq7gDzxEvckNAI1OS5Q' 6-max Seat #5 is the button
Seat 1: xNKcQzD9+/iHmtJn4vYq9w ($98.55 in chips)
Seat 2: QHvTZcrKe6+maWUfVjP29Q ($105.35 in chips)
Seat 3: TPZ+m9x+lwoKpv7TMfAUWA ($217.70 in chips)
Seat 4: +uSzP8Jwnw7sKfQ4s66b7w ($45 in chips)
Seat 5: OGMLOcTNYZXZU81au7ztUw ($152.75 in chips)
Seat 6: XUk5GQsfNFpHvaToDZ0rZA ($168.70 in chips)
XUk5GQsfNFpHvaToDZ0rZA: posts small blind $0.50
xNKcQzD9+/iHmtJn4vYq9w: posts big blind $1
*** HOLE CARDS ***
QHvTZcrKe6+maWUfVjP29Q: folds
TPZ+m9x+lwoKpv7TMfAUWA: folds
+uSzP8Jwnw7sKfQ4s66b7w: folds
OGMLOcTNYZXZU81au7ztUw: raises $2 to $3
XUk5GQsfNFpHvaToDZ0rZA: folds
xNKcQzD9+/iHmtJn4vYq9w: folds
OGMLOcTNYZXZU81au7ztUw collected $2.50 from pot
OGMLOcTNYZXZU81au7ztUw: doesn't show hand
*** SUMMARY ***
Total pot $2.50 | Rake $0
Seat 1: xNKcQzD9+/iHmtJn4vYq9w (big blind) folded before Flop
Seat 2: QHvTZcrKe6+maWUfVjP29Q folded before Flop (didn't bet)
Seat 3: TPZ+m9x+lwoKpv7TMfAUWA folded before Flop (didn't bet)
Seat 4: +uSzP8Jwnw7sKfQ4s66b7w folded before Flop (didn't bet)
Seat 5: OGMLOcTNYZXZU81au7ztUw (button) collected ($2.50)
Seat 6: XUk5GQsfNFpHvaToDZ0rZA (small blind) folded before Flop



PokerStars Game #59939855758:  Hold'em No Limit ($0.50/$1.00) - 2009/07/01 0:50:44 ET
Table 'JOIm/fogLA7vSG0Vc6ME1A' 2-max Seat #1 is the button
Seat 1: NYi6JFscYNrofSXy4sM+Yw ($105.65 in chips)
Seat 2: F5lNTyZLIX9W2wQZ0plwgg ($111.30 in chips)
NYi6JFscYNrofSXy4sM+Yw: posts small blind $0.50
F5lNTyZLIX9W2wQZ0plwgg: posts big blind $1
*** HOLE CARDS ***
NYi6JFscYNrofSXy4sM+Yw: folds
F5lNTyZLIX9W2wQZ0plwgg collected $1 from pot
*** SUMMARY ***
Total pot $1 | Rake $0
Seat 1: NYi6JFscYNrofSXy4sM+Yw (button) (small blind) folded before Flop
Seat 2: F5lNTyZLIX9W2wQZ0plwgg (big blind) collected ($1)



PokerStars Game #59939856998:  Hold'em No Limit ($0.50/$1.00) - 2009/07/01 0:50:46 ET
Table '/RZcOwpZpHQ+OwPwjsbnRw' 6-max Seat #6 is the button
Seat 1: Zboa6dColKGHBjLPUakZjw ($39.40 in chips)
Seat 2: +xW7QemQU0Fxs+4TnqBRow ($193 in chips)
Seat 3: XnT1yK2DD/5FL+0bwuEhqg ($47.95 in chips)
Seat 4: j7NIOHLZk7V2o9fOioO5ug ($120.35 in chips)
Seat 5: wx3sQGkVi2x9wJXuWNHPBw ($182.15 in chips)
Seat 6: XOIf9W+VAxhZqN+SYoyMKA ($291.75 in chips)
Zboa6dColKGHBjLPUakZjw: posts small blind $0.50
+xW7QemQU0Fxs+4TnqBRow: posts big blind $1
*** HOLE CARDS ***
XnT1yK2DD/5FL+0bwuEhqg: folds
j7NIOHLZk7V2o9fOioO5ug: folds
wx3sQGkVi2x9wJXuWNHPBw: folds
XOIf9W+VAxhZqN+SYoyMKA: raises $2 to $3
Zboa6dColKGHBjLPUakZjw: folds
+xW7QemQU0Fxs+4TnqBRow: folds
XOIf9W+VAxhZqN+SYoyMKA collected $2.50 from pot
XOIf9W+VAxhZqN+SYoyMKA: doesn't show hand
*** SUMMARY ***
Total pot $2.50 | Rake $0
Seat 1: Zboa6dColKGHBjLPUakZjw (small blind) folded before Flop
Seat 2: +xW7QemQU0Fxs+4TnqBRow (big blind) folded before Flop
Seat 3: XnT1yK2DD/5FL+0bwuEhqg folded before Flop (didn't bet)
Seat 4: j7NIOHLZk7V2o9fOioO5ug folded before Flop (didn't bet)
Seat 5: wx3sQGkVi2x9wJXuWNHPBw folded before Flop (didn't bet)
Seat 6: XOIf9W+VAxhZqN+SYoyMKA (button) collected ($2.50)



PokerStars Game #59939857160:  Hold'em No Limit ($0.50/$1.00) - 2009/07/01 0:50:47 ET
Table 'W/wyObTiXZm+Ckkl3YxcSw' 6-max Seat #5 is the button
Seat 1: eUBBn2R56C1IQ6Cs/vitwg ($112.25 in chips)
Seat 2: oDiBRCaF0QVtd3kO6xZIXw ($99.45 in chips)
Seat 3: ybGsYWp1MLwy1vSnP8egXg ($28.50 in chips)
Seat 4: +xW7QemQU0Fxs+4TnqBRow ($110.90 in chips)
Seat 5: BdbmJTZZ47quA9vUWwXtlw ($55.35 in chips)
Seat 6: tS9JHB1h+FQ++qu8RwRNgg ($27.50 in chips)
tS9JHB1h+FQ++qu8RwRNgg: posts small blind $0.50
eUBBn2R56C1IQ6Cs/vitwg: posts big blind $1
*** HOLE CARDS ***
oDiBRCaF0QVtd3kO6xZIXw: folds
ybGsYWp1MLwy1vSnP8egXg: folds
+xW7QemQU0Fxs+4TnqBRow: folds
BdbmJTZZ47quA9vUWwXtlw: raises $2 to $3
tS9JHB1h+FQ++qu8RwRNgg: folds
eUBBn2R56C1IQ6Cs/vitwg: folds
BdbmJTZZ47quA9vUWwXtlw collected $2.50 from pot
*** SUMMARY ***
Total pot $2.50 | Rake $0
Seat 1: eUBBn2R56C1IQ6Cs/vitwg (big blind) folded before Flop
Seat 2: oDiBRCaF0QVtd3kO6xZIXw folded before Flop (didn't bet)
Seat 3: ybGsYWp1MLwy1vSnP8egXg folded before Flop (didn't bet)
Seat 4: +xW7QemQU0Fxs+4TnqBRow folded before Flop (didn't bet)
Seat 5: BdbmJTZZ47quA9vUWwXtlw (button) collected ($2.50)
Seat 6: tS9JHB1h+FQ++qu8RwRNgg (small blind) folded before Flop



PokerStars Game #59939858298:  Hold'em No Limit ($0.50/$1.00) - 2009/07/01 0:50:48 ET
Table 'U9zqzC8f3oTJ2ShXFgSSOA' 6-max Seat #5 is the button
Seat 1: iHo1oDbrEVJ8nEGdaPrICw ($100 in chips)
Seat 3: yfXek8iJ7O4CFyqXrtGcfg ($14.45 in chips)
Seat 4: 33q95we0Etwgrm6guQGncw ($93.85 in chips)
Seat 5: KfwW5us6tydK81NYTtK1gw ($296.65 in chips)
Seat 6: 4OO5v3AVduL0tePNx8wk5A ($100 in chips)
4OO5v3AVduL0tePNx8wk5A: posts small blind $0.50
iHo1oDbrEVJ8nEGdaPrICw: posts big blind $1
TSuRyAHnUPCFjP7Z0rEE0w: sits out
*** HOLE CARDS ***
yfXek8iJ7O4CFyqXrtGcfg: folds
33q95we0Etwgrm6guQGncw: raises $3 to $4
KfwW5us6tydK81NYTtK1gw: folds
4OO5v3AVduL0tePNx8wk5A: folds
iHo1oDbrEVJ8nEGdaPrICw: calls $3
*** FLOP *** [Ad 9c 3s]
iHo1oDbrEVJ8nEGdaPrICw: checks
33q95we0Etwgrm6guQGncw: checks
*** TURN *** [Ad 9c 3s] [8s]
iHo1oDbrEVJ8nEGdaPrICw: bets $6
33q95we0Etwgrm6guQGncw: calls $6
*** RIVER *** [Ad 9c 3s 8s] [2c]
iHo1oDbrEVJ8nEGdaPrICw: checks
33q95we0Etwgrm6guQGncw: checks
*** SHOW DOWN ***
iHo1oDbrEVJ8nEGdaPrICw: shows [Ac 4c] (a pair of Aces)
33q95we0Etwgrm6guQGncw: mucks hand
iHo1oDbrEVJ8nEGdaPrICw collected $19.50 from pot
*** SUMMARY ***
Total pot $20.50 | Rake $1
Board [Ad 9c 3s 8s 2c]
Seat 1: iHo1oDbrEVJ8nEGdaPrICw (big blind) showed [Ac 4c] and won ($19.50) with a pair of Aces
Seat 3: yfXek8iJ7O4CFyqXrtGcfg folded before Flop (didn't bet)
Seat 4: 33q95we0Etwgrm6guQGncw mucked
Seat 5: KfwW5us6tydK81NYTtK1gw (button) folded before Flop (didn't bet)
Seat 6: 4OO5v3AVduL0tePNx8wk5A (small blind) folded before Flop



PokerStars Game #59939858690:  Hold'em No Limit ($0.50/$1.00) - 2009/07/01 0:50:49 ET
Table 'SQLOQoANiHscJ8AL7zffbw' 9-max Seat #6 is the button
Seat 1: jPTRd6SpCp4xqAy2XQiTOw ($118.10 in chips)
Seat 2: /zy+DB4S5fUQUSfZWFzYGw ($273.35 in chips)
Seat 3: 0eFnow7+D7veCYQ+CG9FFw ($94.85 in chips)
Seat 4: /mfensKw8/iZ1Vrx33S4xg ($20 in chips)
Seat 5: L9njYvloJ1NdXjP8edHEAg ($110.60 in chips)
Seat 6: p5UKaxVobvptF0ANhR/q1A ($173 in chips)
Seat 7: bJckevFOcg//s0qyMQI6sQ ($100 in chips)
Seat 8: 2BV+oJIQYr65IO6nEChvbA ($60 in chips)
Seat 9: qJr25HAtvv1w/7IBvjMM3g ($198.75 in chips)
bJckevFOcg//s0qyMQI6sQ: posts small blind $0.50
2BV+oJIQYr65IO6nEChvbA: posts big blind $1
*** HOLE CARDS ***
qJr25HAtvv1w/7IBvjMM3g: folds
jPTRd6SpCp4xqAy2XQiTOw: calls $1
/zy+DB4S5fUQUSfZWFzYGw: raises $4 to $5
0eFnow7+D7veCYQ+CG9FFw: folds
/mfensKw8/iZ1Vrx33S4xg: folds
L9njYvloJ1NdXjP8edHEAg: calls $5
p5UKaxVobvptF0ANhR/q1A: folds
bJckevFOcg//s0qyMQI6sQ: folds
2BV+oJIQYr65IO6nEChvbA: folds
jPTRd6SpCp4xqAy2XQiTOw: calls $4
*** FLOP *** [Ad Kc Qh]
jPTRd6SpCp4xqAy2XQiTOw: checks
/zy+DB4S5fUQUSfZWFzYGw: bets $11
L9njYvloJ1NdXjP8edHEAg: folds
jPTRd6SpCp4xqAy2XQiTOw: folds
/zy+DB4S5fUQUSfZWFzYGw collected $15.70 from pot
*** SUMMARY ***
Total pot $16.50 | Rake $0.80
Board [Ad Kc Qh]
Seat 1: jPTRd6SpCp4xqAy2XQiTOw folded on the Flop
Seat 2: /zy+DB4S5fUQUSfZWFzYGw collected ($15.70)
Seat 3: 0eFnow7+D7veCYQ+CG9FFw folded before Flop (didn't bet)
Seat 4: /mfensKw8/iZ1Vrx33S4xg folded before Flop (didn't bet)
Seat 5: L9njYvloJ1NdXjP8edHEAg folded on the Flop
Seat 6: p5UKaxVobvptF0ANhR/q1A (button) folded before Flop (didn't bet)
Seat 7: bJckevFOcg//s0qyMQI6sQ (small blind) folded before Flop
Seat 8: 2BV+oJIQYr65IO6nEChvbA (big blind) folded before Flop
Seat 9: qJr25HAtvv1w/7IBvjMM3g folded before Flop (didn't bet)



PokerStars Game #59939859326:  Hold'em No Limit ($0.50/$1.00) - 2009/07/01 0:50:50 ET
Table 'uNlePsyMIqzM691Xkrlk6Q' 9-max Seat #6 is the button
Seat 1: bLbSOSmSOnqE0iTcH/5dxA ($100 in chips)
Seat 2: +OqpStnt0FqbCfyHAWaLbg ($88.60 in chips)
Seat 3: h7qXkU57Bb8ZuPwMyxR8Ug ($32.85 in chips)
Seat 4: TZcz9MEWDA+WydgGruqqbw ($101.15 in chips)
Seat 5: 3obndzTJ6fECz8+wWhMd1w ($18.50 in chips)
Seat 6: myIxN7otsyr846M539YR8Q ($18.50 in chips)
Seat 7: w6cw9nzN7AvkkHBVVjykoQ ($44.90 in chips)
Seat 8: laA8va+Yv8WuMqT1zdR91g ($100 in chips)
Seat 9: vR4IO10geOgvTW+LAUBv/A ($103.75 in chips)
w6cw9nzN7AvkkHBVVjykoQ: posts small blind $0.50
laA8va+Yv8WuMqT1zdR91g: posts big blind $1
*** HOLE CARDS ***
vR4IO10geOgvTW+LAUBv/A: folds
bLbSOSmSOnqE0iTcH/5dxA: folds
+OqpStnt0FqbCfyHAWaLbg: calls $1
h7qXkU57Bb8ZuPwMyxR8Ug: folds
TZcz9MEWDA+WydgGruqqbw: folds
3obndzTJ6fECz8+wWhMd1w: folds
myIxN7otsyr846M539YR8Q: folds
w6cw9nzN7AvkkHBVVjykoQ: raises $4 to $5
laA8va+Yv8WuMqT1zdR91g: folds
+OqpStnt0FqbCfyHAWaLbg: folds
w6cw9nzN7AvkkHBVVjykoQ collected $3 from pot
*** SUMMARY ***
Total pot $3 | Rake $0
Seat 1: bLbSOSmSOnqE0iTcH/5dxA folded before Flop (didn't bet)
Seat 2: +OqpStnt0FqbCfyHAWaLbg folded before Flop
Seat 3: h7qXkU57Bb8ZuPwMyxR8Ug folded before Flop (didn't bet)
Seat 4: TZcz9MEWDA+WydgGruqqbw folded before Flop (didn't bet)
Seat 5: 3obndzTJ6fECz8+wWhMd1w folded before Flop (didn't bet)
Seat 6: myIxN7otsyr846M539YR8Q (button) folded before Flop (didn't bet)
Seat 7: w6cw9nzN7AvkkHBVVjykoQ (small blind) collected ($3)
Seat 8: laA8va+Yv8WuMqT1zdR91g (big blind) folded before Flop
Seat 9: vR4IO10geOgvTW+LAUBv/A folded before Flop (didn't bet)



PokerStars Game #59939859060:  Hold'em No Limit ($0.50/$1.00) - 2009/07/01 0:50:50 ET
Table 'eU3bWpDDg3Z+9R4m4iVmog' 6-max Seat #6 is the button
Seat 1: TSuRyAHnUPCFjP7Z0rEE0w ($191.65 in chips)
Seat 2: 8CAoOzhmB8n3nRFf3V4BTg ($103 in chips)
Seat 3: U6tnjwZRpTnM+YkqkCjwyQ ($188.65 in chips)
Seat 4: GDVIsbEJ/DOJsMKE4Asz0A ($66.80 in chips)
Seat 5: AdLVjddOzm+sRNo1Bc3S6Q ($105.05 in chips)
Seat 6: hpxXcmRkXXI9HE5+5/j/0Q ($120.45 in chips)
TSuRyAHnUPCFjP7Z0rEE0w: posts small blind $0.50
8CAoOzhmB8n3nRFf3V4BTg: posts big blind $1
*** HOLE CARDS ***
U6tnjwZRpTnM+YkqkCjwyQ: folds
GDVIsbEJ/DOJsMKE4Asz0A: raises $2 to $3
AdLVjddOzm+sRNo1Bc3S6Q: folds
hpxXcmRkXXI9HE5+5/j/0Q: folds
TSuRyAHnUPCFjP7Z0rEE0w: folds
8CAoOzhmB8n3nRFf3V4BTg: calls $2
*** FLOP *** [2d Qh 7h]
8CAoOzhmB8n3nRFf3V4BTg: checks
GDVIsbEJ/DOJsMKE4Asz0A: bets $3
8CAoOzhmB8n3nRFf3V4BTg: calls $3
*** TURN *** [2d Qh 7h] [5d]
8CAoOzhmB8n3nRFf3V4BTg: checks
GDVIsbEJ/DOJsMKE4Asz0A: bets $6
8CAoOzhmB8n3nRFf3V4BTg: raises $8 to $14
GDVIsbEJ/DOJsMKE4Asz0A: calls $8
*** RIVER *** [2d Qh 7h 5d] [2h]
8CAoOzhmB8n3nRFf3V4BTg: bets $8
GDVIsbEJ/DOJsMKE4Asz0A: calls $8
*** SHOW DOWN ***
8CAoOzhmB8n3nRFf3V4BTg: shows [Qd Jd] (two pair, Queens and Deuces)
GDVIsbEJ/DOJsMKE4Asz0A: shows [Ks Qs] (two pair, Queens and Deuces - King kicker)
GDVIsbEJ/DOJsMKE4Asz0A collected $53.80 from pot
*** SUMMARY ***
Total pot $56.50 | Rake $2.70
Board [2d Qh 7h 5d 2h]
Seat 1: TSuRyAHnUPCFjP7Z0rEE0w (small blind) folded before Flop
Seat 2: 8CAoOzhmB8n3nRFf3V4BTg (big blind) showed [Qd Jd] and lost with two pair, Queens and Deuces
Seat 3: U6tnjwZRpTnM+YkqkCjwyQ folded before Flop (didn't bet)
Seat 4: GDVIsbEJ/DOJsMKE4Asz0A showed [Ks Qs] and won ($53.80) with two pair, Queens and Deuces
Seat 5: AdLVjddOzm+sRNo1Bc3S6Q folded before Flop (didn't bet)
Seat 6: hpxXcmRkXXI9HE5+5/j/0Q (button) folded before Flop (didn't bet)



PokerStars Game #59939859552:  Hold'em No Limit ($0.50/$1.00) - 2009/07/01 0:50:50 ET
Table 'JOIm/fogLA7vSG0Vc6ME1A' 2-max Seat #2 is the button
Seat 1: NYi6JFscYNrofSXy4sM+Yw ($105.15 in chips)
Seat 2: F5lNTyZLIX9W2wQZ0plwgg ($111.80 in chips)
F5lNTyZLIX9W2wQZ0plwgg: posts small blind $0.50
NYi6JFscYNrofSXy4sM+Yw: posts big blind $1
*** HOLE CARDS ***
F5lNTyZLIX9W2wQZ0plwgg: raises $1 to $2
NYi6JFscYNrofSXy4sM+Yw: folds
F5lNTyZLIX9W2wQZ0plwgg collected $2 from pot
*** SUMMARY ***
Total pot $2 | Rake $0
Seat 1: NYi6JFscYNrofSXy4sM+Yw (big blind) folded before Flop
Seat 2: F5lNTyZLIX9W2wQZ0plwgg (button) (small blind) collected ($2)



PokerStars Game #59939863582:  Hold'em No Limit ($0.50/$1.00) - 2009/07/01 0:50:56 ET
Table 'tyUh+jyNvrceIQdKMJjQ2wZFWj23PMihdwrNWv41OG/Qeat #5 is the button
Seat 1: o8A5MUdudVKu+pAwgZOX2w ($205.95 in chips)
Seat 2: XvUbOIg94d25feWeQlOTVg ($70.90 in chips)
Seat 3: TalCiLYHCd+ffkmR3auPvA ($91.40 in chips)
Seat 4: TSuRyAHnUPCFjP7Z0rEE0w ($116.75 in chips)
Seat 5: j7NIOHLZk7V2o9fOioO5ug ($100 in chips)
Seat 6: YsLQ3BAvgQHWXMAv3Wv6Hg ($150.65 in chips)
YsLQ3BAvgQHWXMAv3Wv6Hg: posts small blind $0.50
o8A5MUdudVKu+pAwgZOX2w: posts big blind $1
*** HOLE CARDS ***
XvUbOIg94d25feWeQlOTVg: calls $1
TalCiLYHCd+ffkmR3auPvA: calls $1
TSuRyAHnUPCFjP7Z0rEE0w: folds
j7NIOHLZk7V2o9fOioO5ug: folds
YsLQ3BAvgQHWXMAv3Wv6Hg: folds
o8A5MUdudVKu+pAwgZOX2w: checks
*** FLOP *** [6c 2s 5d]
o8A5MUdudVKu+pAwgZOX2w: bets $5
XvUbOIg94d25feWeQlOTVg: folds
TalCiLYHCd+ffkmR3auPvA: folds
o8A5MUdudVKu+pAwgZOX2w collected $3.35 from pot
o8A5MUdudVKu+pAwgZOX2w: doesn't show hand
*** SUMMARY ***
Total pot $3.50 | Rake $0.15
Board [6c 2s 5d]
Seat 1: o8A5MUdudVKu+pAwgZOX2w (big blind) collected ($3.35)
Seat 2: XvUbOIg94d25feWeQlOTVg folded on the Flop
Seat 3: TalCiLYHCd+ffkmR3auPvA folded on the Flop
Seat 4: TSuRyAHnUPCFjP7Z0rEE0w folded before Flop (didn't bet)
Seat 5: j7NIOHLZk7V2o9fOioO5ug (button) folded before Flop (didn't bet)
Seat 6: YsLQ3BAvgQHWXMAv3Wv6Hg (small blind) folded before Flop



PokerStars Game #59939863676:  Hold'em No Limit ($0.50/$1.00) - 2009/07/01 0:50:57 ET
Table 'pHrhryH8jPNdQfY62f8v+g' 6-max Seat #6 is the button
Seat 1: fF4botNMr8/ieVPO1YYRLw ($55 in chips)
Seat 2: RqgF7gRoKgRNW8Zoi1ty4A ($101.75 in chips)
Seat 3: 8oS5O7iD/qnFXFXJrGIgNQ ($100 in chips)
Seat 4: wenbG7TaM3H7h5kn78OFNw ($58.70 in chips)
Seat 5: r1/R7y0Ortgoz4lccgW8VA ($54.40 in chips)
Seat 6: xAU6q2/cwmby2sxmA8VcmA ($117.30 in chips)
fF4botNMr8/ieVPO1YYRLw: posts small blind $0.50
RqgF7gRoKgRNW8Zoi1ty4A: posts big blind $1
*** HOLE CARDS ***
8oS5O7iD/qnFXFXJrGIgNQ: folds
wenbG7TaM3H7h5kn78OFNw: folds
r1/R7y0Ortgoz4lccgW8VA: folds
xAU6q2/cwmby2sxmA8VcmA: raises $3 to $4
fF4botNMr8/ieVPO1YYRLw: folds
RqgF7gRoKgRNW8Zoi1ty4A: folds
xAU6q2/cwmby2sxmA8VcmA collected $2.50 from pot
xAU6q2/cwmby2sxmA8VcmA: doesn't show hand
*** SUMMARY ***
Total pot $2.50 | Rake $0
Seat 1: fF4botNMr8/ieVPO1YYRLw (small blind) folded before Flop
Seat 2: RqgF7gRoKgRNW8Zoi1ty4A (big blind) folded before Flop
Seat 3: 8oS5O7iD/qnFXFXJrGIgNQ folded before Flop (didn't bet)
Seat 4: wenbG7TaM3H7h5kn78OFNw folded before Flop (didn't bet)
Seat 5: r1/R7y0Ortgoz4lccgW8VA folded before Flop (didn't bet)
Seat 6: xAU6q2/cwmby2sxmA8VcmA (button) collected ($2.50)



PokerStars Game #59939864604:  Hold'em No Limit ($0.50/$1.00) - 2009/07/01 0:50:58 ET
Table 'JOIm/fogLA7vSG0Vc6ME1A' 2-max Seat #1 is the button
Seat 1: NYi6JFscYNrofSXy4sM+Yw ($104.15 in chips)
Seat 2: F5lNTyZLIX9W2wQZ0plwgg ($112.80 in chips)
NYi6JFscYNrofSXy4sM+Yw: posts small blind $0.50
F5lNTyZLIX9W2wQZ0plwgg: posts big blind $1
*** HOLE CARDS ***
NYi6JFscYNrofSXy4sM+Yw: raises $2 to $3
F5lNTyZLIX9W2wQZ0plwgg: calls $2
*** FLOP *** [6d Td 6s]
F5lNTyZLIX9W2wQZ0plwgg: checks
NYi6JFscYNrofSXy4sM+Yw: checks
*** TURN *** [6d Td 6s] [4s]
F5lNTyZLIX9W2wQZ0plwgg: bets $3
NYi6JFscYNrofSXy4sM+Yw: calls $3
*** RIVER *** [6d Td 6s 4s] [7c]
F5lNTyZLIX9W2wQZ0plwgg: bets $3
NYi6JFscYNrofSXy4sM+Yw: calls $3
*** SHOW DOWN ***
F5lNTyZLIX9W2wQZ0plwgg: shows [5s 6c] (three of a kind, Sixes)
NYi6JFscYNrofSXy4sM+Yw: mucks hand
F5lNTyZLIX9W2wQZ0plwgg collected $17.50 from pot
*** SUMMARY ***
Total pot $18 | Rake $0.50
Board [6d Td 6s 4s 7c]
Seat 1: NYi6JFscYNrofSXy4sM+Yw (button) (small blind) mucked
Seat 2: F5lNTyZLIX9W2wQZ0plwgg (big blind) showed [5s 6c] and won ($17.50) with three of a kind, Sixes



PokerStars Game #59939866112:  Hold'em No Limit ($0.50/$1.00) - 2009/07/01 0:51:00 ET
Table '/RZcOwpZpHQ+OwPwjsbnRw' 6-max Seat #1 is the button
Seat 1: Zboa6dColKGHBjLPUakZjw ($38.90 in chips)
Seat 2: +xW7QemQU0Fxs+4TnqBRow ($192 in chips)
Seat 3: XnT1yK2DD/5FL+0bwuEhqg ($47.95 in chips)
Seat 4: j7NIOHLZk7V2o9fOioO5ug ($120.35 in chips)
Seat 5: wx3sQGkVi2x9wJXuWNHPBw ($182.15 in chips)
Seat 6: XOIf9W+VAxhZqN+SYoyMKA ($293.25 in chips)
+xW7QemQU0Fxs+4TnqBRow: posts small blind $0.50
XnT1yK2DD/5FL+0bwuEhqg: posts big blind $1
*** HOLE CARDS ***
j7NIOHLZk7V2o9fOioO5ug: folds
wx3sQGkVi2x9wJXuWNHPBw: folds
XOIf9W+VAxhZqN+SYoyMKA: folds
Zboa6dColKGHBjLPUakZjw: folds
+xW7QemQU0Fxs+4TnqBRow: raises $2 to $3
XnT1yK2DD/5FL+0bwuEhqg: folds
+xW7QemQU0Fxs+4TnqBRow collected $2 from pot
+xW7QemQU0Fxs+4TnqBRow: doesn't show hand
*** SUMMARY ***
Total pot $2 | Rake $0
Seat 1: Zboa6dColKGHBjLPUakZjw (button) folded before Flop (didn't bet)
Seat 2: +xW7QemQU0Fxs+4TnqBRow (small blind) collected ($2)
Seat 3: XnT1yK2DD/5FL+0bwuEhqg (big blind) folded before Flop
Seat 4: j7NIOHLZk7V2o9fOioO5ug folded before Flop (didn't bet)
Seat 5: wx3sQGkVi2x9wJXuWNHPBw folded before Flop (didn't bet)
Seat 6: XOIf9W+VAxhZqN+SYoyMKA folded before Flop (didn't bet)



PokerStars Game #59939865650:  Hold'em No Limit ($0.50/$1.00) - 2009/07/01 0:51:00 ET
Table 'MUPc8FEpe/nR0BKSeReX6Q' 6-max Seat #1 is the button
Seat 1: YsLQ3BAvgQHWXMAv3Wv6Hg ($112.35 in chips)
Seat 2: xAU6q2/cwmby2sxmA8VcmA ($100.50 in chips)
Seat 3: wx3sQGkVi2x9wJXuWNHPBw ($216.90 in chips)
Seat 4: ZA1bp6g8IwtTxkUE4eCjDQ ($203.80 in chips)
Seat 5: UBZQqpnJZdTYYY1FTb0rLA ($105.05 in chips)
Seat 6: oxnw0GLLpFanjhGkxfRSqA ($55 in chips)
xAU6q2/cwmby2sxmA8VcmA: posts small blind $0.50
wx3sQGkVi2x9wJXuWNHPBw: posts big blind $1
*** HOLE CARDS ***
ZA1bp6g8IwtTxkUE4eCjDQ: folds
UBZQqpnJZdTYYY1FTb0rLA: folds
oxnw0GLLpFanjhGkxfRSqA: folds
YsLQ3BAvgQHWXMAv3Wv6Hg: folds
xAU6q2/cwmby2sxmA8VcmA: folds
wx3sQGkVi2x9wJXuWNHPBw collected $1 from pot
*** SUMMARY ***
Total pot $1 | Rake $0
Seat 1: YsLQ3BAvgQHWXMAv3Wv6Hg (button) folded before Flop (didn't bet)
Seat 2: xAU6q2/cwmby2sxmA8VcmA (small blind) folded before Flop
Seat 3: wx3sQGkVi2x9wJXuWNHPBw (big blind) collected ($1)
Seat 4: ZA1bp6g8IwtTxkUE4eCjDQ folded before Flop (didn't bet)
Seat 5: UBZQqpnJZdTYYY1FTb0rLA folded before Flop (didn't bet)
Seat 6: oxnw0GLLpFanjhGkxfRSqA folded before Flop (didn't bet)



PokerStars Game #59939866778:  Hold'em No Limit ($0.50/$1.00) - 2009/07/01 0:51:01 ET
Table 'LmXQK9xy3awB+qsPzI21Mw' 2-max Seat #2 is the button
Seat 1: NYi6JFscYNrofSXy4sM+Yw ($185.55 in chips)
Seat 2: TME8GvochpQAo8cmJwWmvA ($143.70 in chips)
TME8GvochpQAo8cmJwWmvA: posts small blind $0.50
NYi6JFscYNrofSXy4sM+Yw: posts big blind $1
*** HOLE CARDS ***
TME8GvochpQAo8cmJwWmvA: calls $0.50
NYi6JFscYNrofSXy4sM+Yw: checks
*** FLOP *** [Qc Qs 6c]
NYi6JFscYNrofSXy4sM+Yw: bets $2
TME8GvochpQAo8cmJwWmvA: raises $2 to $4
NYi6JFscYNrofSXy4sM+Yw: folds
TME8GvochpQAo8cmJwWmvA collected $5.75 from pot
TME8GvochpQAo8cmJwWmvA: doesn't show hand
*** SUMMARY ***
Total pot $6 | Rake $0.25
Board [Qc Qs 6c]
Seat 1: NYi6JFscYNrofSXy4sM+Yw (big blind) folded on the Flop
Seat 2: TME8GvochpQAo8cmJwWmvA (button) (small blind) collected ($5.75)



PokerStars Game #59939868030:  Hold'em No Limit ($0.50/$1.00) - 2009/07/01 0:51:03 ET
Table 'VOs36P6NW+QyXeQ1B62kmA' 6-max Seat #3 is the button
Seat 1: AdLVjddOzm+sRNo1Bc3S6Q ($130.80 in chips)
Seat 2: KpnW5CcJ4Mg6MeclfKmLrw ($121.35 in chips)
Seat 3: TSuRyAHnUPCFjP7Z0rEE0w ($100 in chips)
Seat 4: w02zQzNydODiyV9THKgo9w ($29.70 in chips)
Seat 5: ozrlafxxh1HmYdA0/h+MuA ($25.30 in chips)
Seat 6: 6tvjsJrdmWg+g7FVrMnzXA ($88 in chips)
w02zQzNydODiyV9THKgo9w: posts small blind $0.50
ozrlafxxh1HmYdA0/h+MuA: posts big blind $1
*** HOLE CARDS ***
6tvjsJrdmWg+g7FVrMnzXA: folds
AdLVjddOzm+sRNo1Bc3S6Q: folds
KpnW5CcJ4Mg6MeclfKmLrw: folds
TSuRyAHnUPCFjP7Z0rEE0w: folds
w02zQzNydODiyV9THKgo9w: calls $0.50
ozrlafxxh1HmYdA0/h+MuA: checks
*** FLOP *** [4s Kh 8s]
w02zQzNydODiyV9THKgo9w: bets $2
ozrlafxxh1HmYdA0/h+MuA: folds
w02zQzNydODiyV9THKgo9w collected $1.90 from pot
*** SUMMARY ***
Total pot $2 | Rake $0.10
Board [4s Kh 8s]
Seat 1: AdLVjddOzm+sRNo1Bc3S6Q folded before Flop (didn't bet)
Seat 2: KpnW5CcJ4Mg6MeclfKmLrw folded before Flop (didn't bet)
Seat 3: TSuRyAHnUPCFjP7Z0rEE0w (button) folded before Flop (didn't bet)
Seat 4: w02zQzNydODiyV9THKgo9w (small blind) collected ($1.90)
Seat 5: ozrlafxxh1HmYdA0/h+MuA (big blind) folded on the Flop
Seat 6: 6tvjsJrdmWg+g7FVrMnzXA folded before Flop (didn't bet)



PokerStars Game #59939868088:  Hold'em No Limit ($0.50/$1.00) - 2009/07/01 0:51:04 ET
Table 'tLrtq7gDzxEvckNAI1OS5Q' 6-max Seat #6 is the button
Seat 1: xNKcQzD9+/iHmtJn4vYq9w ($97.55 in chips)
Seat 2: QHvTZcrKe6+maWUfVjP29Q ($105.35 in chips)
Seat 3: TPZ+m9x+lwoKpv7TMfAUWA ($217.70 in chips)
Seat 4: +uSzP8Jwnw7sKfQ4s66b7w ($45 in chips)
Seat 5: OGMLOcTNYZXZU81au7ztUw ($154.25 in chips)
Seat 6: XUk5GQsfNFpHvaToDZ0rZA ($168.20 in chips)
xNKcQzD9+/iHmtJn4vYq9w: posts small blind $0.50
QHvTZcrKe6+maWUfVjP29Q: posts big blind $1
*** HOLE CARDS ***
TPZ+m9x+lwoKpv7TMfAUWA: folds
+uSzP8Jwnw7sKfQ4s66b7w: folds
OGMLOcTNYZXZU81au7ztUw: folds
XUk5GQsfNFpHvaToDZ0rZA: folds
xNKcQzD9+/iHmtJn4vYq9w: folds
QHvTZcrKe6+maWUfVjP29Q collected $1 from pot
QHvTZcrKe6+maWUfVjP29Q: doesn't show hand
*** SUMMARY ***
Total pot $1 | Rake $0
Seat 1: xNKcQzD9+/iHmtJn4vYq9w (small blind) folded before Flop
Seat 2: QHvTZcrKe6+maWUfVjP29Q (big blind) collected ($1)
Seat 3: TPZ+m9x+lwoKpv7TMfAUWA folded before Flop (didn't bet)
Seat 4: +uSzP8Jwnw7sKfQ4s66b7w folded before Flop (didn't bet)
Seat 5: OGMLOcTNYZXZU81au7ztUw folded before Flop (didn't bet)
Seat 6: XUk5GQsfNFpHvaToDZ0rZA (button) folded before Flop (didn't bet)



PokerStars Game #59939870554:  Hold'em No Limit ($0.50/$1.00) - 2009/07/01 0:51:07 ET
Table 'cKH9c4x6u79IqCdaKKvXrw' 9-max Seat #7 is the button
Seat 1: Pp/KTcXkfZKKUHkjyaLTdg ($17 in chips)
Seat 2: 8S3JMH4TY3whgIlZmMv66w ($55.85 in chips)
Seat 3: 997ViqAtWn1FPjJqcffwcA ($158.60 in chips)
Seat 4: FL3MrLspcF23LYvC4ipBOA ($100 in chips)
Seat 5: Jjc7EHWzs4//xUAjJ0UWoA ($20 in chips)
Seat 6: Bsd/K5gAcLanYbGiPirRjw ($207.55 in chips)
Seat 7: 1GkkVBhlJ92guE6K5mS5Ig ($45.55 in chips)
Seat 9: 6XkTu4ahxzHnvjjc1R8YjQ ($43.60 in chips)
6XkTu4ahxzHnvjjc1R8YjQ: posts small blind $0.50
Pp/KTcXkfZKKUHkjyaLTdg: posts big blind $1
Jjc7EHWzs4//xUAjJ0UWoA: posts big blind $1
*** HOLE CARDS ***
8S3JMH4TY3whgIlZmMv66w: calls $1
997ViqAtWn1FPjJqcffwcA: folds
FL3MrLspcF23LYvC4ipBOA: folds
4/8w7g4QE6v0i1tIIf/1HQ leaves the table
Jjc7EHWzs4//xUAjJ0UWoA: raises $4 to $5
Bsd/K5gAcLanYbGiPirRjw: folds
1GkkVBhlJ92guE6K5mS5Ig: folds
myIxN7otsyr846M539YR8Q joins the table at seat #8
6XkTu4ahxzHnvjjc1R8YjQ: folds
Pp/KTcXkfZKKUHkjyaLTdg: folds
8S3JMH4TY3whgIlZmMv66w: calls $4
*** FLOP *** [Jc 6h 5c]
8S3JMH4TY3whgIlZmMv66w: bets $15
Jjc7EHWzs4//xUAjJ0UWoA: calls $15 and is all-in
*** TURN *** [Jc 6h 5c] [6c]
*** RIVER *** [Jc 6h 5c 6c] [3s]
*** SHOW DOWN ***
8S3JMH4TY3whgIlZmMv66w: shows [Js Ks] (two pair, Jacks and Sixes)
Jjc7EHWzs4//xUAjJ0UWoA: shows [Qs Qd] (two pair, Queens and Sixes)
Jjc7EHWzs4//xUAjJ0UWoA collected $39.50 from pot
*** SUMMARY ***
Total pot $41.50 | Rake $2
Board [Jc 6h 5c 6c 3s]
Seat 1: Pp/KTcXkfZKKUHkjyaLTdg (big blind) folded before Flop
Seat 2: 8S3JMH4TY3whgIlZmMv66w showed [Js Ks] and lost with two pair, Jacks and Sixes
Seat 3: 997ViqAtWn1FPjJqcffwcA folded before Flop (didn't bet)
Seat 4: FL3MrLspcF23LYvC4ipBOA folded before Flop (didn't bet)
Seat 5: Jjc7EHWzs4//xUAjJ0UWoA showed [Qs Qd] and won ($39.50) with two pair, Queens and Sixes
Seat 6: Bsd/K5gAcLanYbGiPirRjw folded before Flop (didn't bet)
Seat 7: 1GkkVBhlJ92guE6K5mS5Ig (button) folded before Flop (didn't bet)
Seat 9: 6XkTu4ahxzHnvjjc1R8YjQ (small blind) folded before Flop



PokerStars Game #59939871538:  Hold'em No Limit ($0.50/$1.00) - 2009/07/01 0:51:09 ET
Table 'cBDNutyLBKEk9+ptwsKmTw' 6-max Seat #1 is the button
Seat 1: xAU6q2/cwmby2sxmA8VcmA ($100 in chips)
Seat 2: 5lY8d6Cnm4HUkt/8FZSj4g ($94.60 in chips)
Seat 3: G5ZSSN6RSON3gkNvk/SmYg ($104.65 in chips)
Seat 4: 3q7F5QtzC30pSrn0nl9i+A ($34.20 in chips)
Seat 5: OGMLOcTNYZXZU81au7ztUw ($158.65 in chips)
Seat 6: NqVlOSH2lp+pp/TK3vvK5g ($45 in chips)
5lY8d6Cnm4HUkt/8FZSj4g: posts small blind $0.50
G5ZSSN6RSON3gkNvk/SmYg: posts big blind $1
*** HOLE CARDS ***
3q7F5QtzC30pSrn0nl9i+A: calls $1
OGMLOcTNYZXZU81au7ztUw: folds
NqVlOSH2lp+pp/TK3vvK5g: calls $1
xAU6q2/cwmby2sxmA8VcmA: folds
5lY8d6Cnm4HUkt/8FZSj4g: calls $0.50
G5ZSSN6RSON3gkNvk/SmYg: checks
*** FLOP *** [9s Th 6c]
5lY8d6Cnm4HUkt/8FZSj4g: checks
G5ZSSN6RSON3gkNvk/SmYg: checks
3q7F5QtzC30pSrn0nl9i+A: checks
NqVlOSH2lp+pp/TK3vvK5g: bets $2
5lY8d6Cnm4HUkt/8FZSj4g: calls $2
G5ZSSN6RSON3gkNvk/SmYg: folds
3q7F5QtzC30pSrn0nl9i+A: folds
*** TURN *** [9s Th 6c] [4d]
5lY8d6Cnm4HUkt/8FZSj4g: checks
NqVlOSH2lp+pp/TK3vvK5g: bets $6
5lY8d6Cnm4HUkt/8FZSj4g: calls $6
*** RIVER *** [9s Th 6c 4d] [Jd]
5lY8d6Cnm4HUkt/8FZSj4g: checks
NqVlOSH2lp+pp/TK3vvK5g: checks
*** SHOW DOWN ***
5lY8d6Cnm4HUkt/8FZSj4g: shows [7h 9d] (a pair of Nines)
NqVlOSH2lp+pp/TK3vvK5g: mucks hand
5lY8d6Cnm4HUkt/8FZSj4g collected $19.05 from pot
*** SUMMARY ***
Total pot $20 | Rake $0.95
Board [9s Th 6c 4d Jd]
Seat 1: xAU6q2/cwmby2sxmA8VcmA (button) folded before Flop (didn't bet)
Seat 2: 5lY8d6Cnm4HUkt/8FZSj4g (small blind) showed [7h 9d] and won ($19.05) with a pair of Nines
Seat 3: G5ZSSN6RSON3gkNvk/SmYg (big blind) folded on the Flop
Seat 4: 3q7F5QtzC30pSrn0nl9i+A folded on the Flop
Seat 5: OGMLOcTNYZXZU81au7ztUw folded before Flop (didn't bet)
Seat 6: NqVlOSH2lp+pp/TK3vvK5g mucked



PokerStars Game #59939872850:  Hold'em No Limit ($0.50/$1.00) - 2009/07/01 0:51:11 ET
Table 'hugOjcwJvzEwZbK7tyiWuQ' 9-max Seat #9 is the button
Seat 2: r27C1nIV4NS4+qbnrgBQSw ($261.50 in chips)
Seat 3: jDwhY1kCdc6EkAHbT7PJMQ ($103.65 in chips)
Seat 4: UWB3oeddt/GObx2Mix2Anw ($205.75 in chips)
Seat 5: 5BRGWf+R3nt2WS3b5xX+zA ($27.20 in chips)
Seat 6: gUUvmqdVlmvpal6B8nYrmg ($106.20 in chips)
Seat 7: FL3MrLspcF23LYvC4ipBOA ($100 in chips)
Seat 8: /zy+DB4S5fUQUSfZWFzYGw ($100 in chips)
Seat 9: W8P9bUKCs43TO1xHm0dL6w ($88.05 in chips)
r27C1nIV4NS4+qbnrgBQSw: posts small blind $0.50
jDwhY1kCdc6EkAHbT7PJMQ: posts big blind $1
*** HOLE CARDS ***
UWB3oeddt/GObx2Mix2Anw: folds
5BRGWf+R3nt2WS3b5xX+zA: folds
gUUvmqdVlmvpal6B8nYrmg: raises $2 to $3
FL3MrLspcF23LYvC4ipBOA: calls $3
/zy+DB4S5fUQUSfZWFzYGw: calls $3
W8P9bUKCs43TO1xHm0dL6w: folds
r27C1nIV4NS4+qbnrgBQSw: folds
jDwhY1kCdc6EkAHbT7PJMQ: folds
*** FLOP *** [7d 5s 3c]
gUUvmqdVlmvpal6B8nYrmg: checks
FL3MrLspcF23LYvC4ipBOA: checks
/zy+DB4S5fUQUSfZWFzYGw: bets $7
gUUvmqdVlmvpal6B8nYrmg: folds
FL3MrLspcF23LYvC4ipBOA: calls $7
*** TURN *** [7d 5s 3c] [2h]
FL3MrLspcF23LYvC4ipBOA: checks
/zy+DB4S5fUQUSfZWFzYGw: checks
*** RIVER *** [7d 5s 3c 2h] [8h]
FL3MrLspcF23LYvC4ipBOA: bets $15
/zy+DB4S5fUQUSfZWFzYGw: folds
FL3MrLspcF23LYvC4ipBOA collected $23.30 from pot
*** SUMMARY ***
Total pot $24.50 | Rake $1.20
Board [7d 5s 3c 2h 8h]
Seat 2: r27C1nIV4NS4+qbnrgBQSw (small blind) folded before Flop
Seat 3: jDwhY1kCdc6EkAHbT7PJMQ (big blind) folded before Flop
Seat 4: UWB3oeddt/GObx2Mix2Anw folded before Flop (didn't bet)
Seat 5: 5BRGWf+R3nt2WS3b5xX+zA folded before Flop (didn't bet)
Seat 6: gUUvmqdVlmvpal6B8nYrmg folded on the Flop
Seat 7: FL3MrLspcF23LYvC4ipBOA collected ($23.30)
Seat 8: /zy+DB4S5fUQUSfZWFzYGw folded on the River
Seat 9: W8P9bUKCs43TO1xHm0dL6w (button) folded before Flop (didn't bet)



PokerStars Game #59939873044:  Hold'em No Limit ($0.50/$1.00) - 2009/07/01 0:51:11 ET
Table '+cA8mcmhaedZ7YcrDdhmeQ' 6-max Seat #3 is the button
Seat 1: lsLuWlcPA3Rh7kJVLzMh0Q ($289 in chips)
Seat 2: RqgF7gRoKgRNW8Zoi1ty4A ($100 in chips)
Seat 3: 7H5WkGzGvsv56y1iaqHvRg ($55.95 in chips)
Seat 5: +7hFKAL0b0O/n8G72TclJA ($49 in chips)
Seat 6: YfsTQsY/fxb+YqbdclTHuw ($31.70 in chips)
JwCcjZl0bjJzG7hmE0dnTA will be allowed to play after the button
+7hFKAL0b0O/n8G72TclJA: posts small blind $0.50
YfsTQsY/fxb+YqbdclTHuw: posts big blind $1
*** HOLE CARDS ***
lsLuWlcPA3Rh7kJVLzMh0Q: folds
RqgF7gRoKgRNW8Zoi1ty4A: folds
7H5WkGzGvsv56y1iaqHvRg: folds
+7hFKAL0b0O/n8G72TclJA: calls $0.50
YfsTQsY/fxb+YqbdclTHuw: checks
*** FLOP *** [Kc 8s 9h]
+7hFKAL0b0O/n8G72TclJA: checks
YfsTQsY/fxb+YqbdclTHuw: bets $4
+7hFKAL0b0O/n8G72TclJA: folds
YfsTQsY/fxb+YqbdclTHuw collected $1.90 from pot
*** SUMMARY ***
Total pot $2 | Rake $0.10
Board [Kc 8s 9h]
Seat 1: lsLuWlcPA3Rh7kJVLzMh0Q folded before Flop (didn't bet)
Seat 2: RqgF7gRoKgRNW8Zoi1ty4A folded before Flop (didn't bet)
Seat 3: 7H5WkGzGvsv56y1iaqHvRg (button) folded before Flop (didn't bet)
Seat 5: +7hFKAL0b0O/n8G72TclJA (small blind) folded on the Flop
Seat 6: YfsTQsY/fxb+YqbdclTHuw (big blind) collected ($1.90)



PokerStars Game #59939873334:  Hold'em No Limit ($0.50/$1.00) - 2009/07/01 0:51:12 ET
Table 'W/wyObTiXZm+Ckkl3YxcSw' 6-max Seat #6 is the button
Seat 1: eUBBn2R56C1IQ6Cs/vitwg ($111.25 in chips)
Seat 2: oDiBRCaF0QVtd3kO6xZIXw ($99.45 in chips)
Seat 3: ybGsYWp1MLwy1vSnP8egXg ($28.50 in chips)
Seat 4: +xW7QemQU0Fxs+4TnqBRow ($110.90 in chips)
Seat 5: BdbmJTZZ47quA9vUWwXtlw ($56.85 in chips)
Seat 6: tS9JHB1h+FQ++qu8RwRNgg ($27 in chips)
eUBBn2R56C1IQ6Cs/vitwg: posts small blind $0.50
oDiBRCaF0QVtd3kO6xZIXw: posts big blind $1
*** HOLE CARDS ***
ybGsYWp1MLwy1vSnP8egXg: calls $1
+xW7QemQU0Fxs+4TnqBRow: raises $4 to $5
BdbmJTZZ47quA9vUWwXtlw: folds
tS9JHB1h+FQ++qu8RwRNgg: folds
eUBBn2R56C1IQ6Cs/vitwg: folds
oDiBRCaF0QVtd3kO6xZIXw: folds
ybGsYWp1MLwy1vSnP8egXg: folds
+xW7QemQU0Fxs+4TnqBRow collected $3.50 from pot
+xW7QemQU0Fxs+4TnqBRow: doesn't show hand
*** SUMMARY ***
Total pot $3.50 | Rake $0
Seat 1: eUBBn2R56C1IQ6Cs/vitwg (small blind) folded before Flop
Seat 2: oDiBRCaF0QVtd3kO6xZIXw (big blind) folded before Flop
Seat 3: ybGsYWp1MLwy1vSnP8egXg folded before Flop
Seat 4: +xW7QemQU0Fxs+4TnqBRow collected ($3.50)
Seat 5: BdbmJTZZ47quA9vUWwXtlw folded before Flop (didn't bet)
Seat 6: tS9JHB1h+FQ++qu8RwRNgg (button) folded before Flop (didn't bet)



PokerStars Game #59939875024:  Hold'em No Limit ($0.50/$1.00) - 2009/07/01 0:51:14 ET
Table 'LmXQK9xy3awB+qsPzI21Mw' 2-max Seat #1 is the button
Seat 1: NYi6JFscYNrofSXy4sM+Yw ($182.55 in chips)
Seat 2: TME8GvochpQAo8cmJwWmvA ($146.45 in chips)
NYi6JFscYNrofSXy4sM+Yw: posts small blind $0.50
TME8GvochpQAo8cmJwWmvA: posts big blind $1
*** HOLE CARDS ***
NYi6JFscYNrofSXy4sM+Yw: folds
TME8GvochpQAo8cmJwWmvA collected $1 from pot
TME8GvochpQAo8cmJwWmvA: doesn't show hand
*** SUMMARY ***
Total pot $1 | Rake $0
Seat 1: NYi6JFscYNrofSXy4sM+Yw (button) (small blind) folded before Flop
Seat 2: TME8GvochpQAo8cmJwWmvA (big blind) collected ($1)



PokerStars Game #59939874726:  Hold'em No Limit ($0.50/$1.00) - 2009/07/01 0:51:14 ET
Table 'tJq9SfN1ywY0r03VBlWlwQ' 9-max Seat #4 is the button
Seat 1: wZsU+w9r7G66x93UuvBf1Q ($339.30 in chips)
Seat 2: RqkO8O/Y3qlc3PIuCAHjVg ($74.40 in chips)
Seat 3: FVs16t7GgfWgQWt4JxsObQ ($33.95 in chips)
Seat 4: bLbSOSmSOnqE0iTcH/5dxA ($110.20 in chips)
Seat 5: Ogn4JDV3mp4ZDKO49IFzKA ($18.90 in chips)
Seat 6: gUUvmqdVlmvpal6B8nYrmg ($122.05 in chips)
Seat 7: qVhRZ0PLZ95XRJHWAjXjOQ ($128.20 in chips)
Seat 8: G4DEhsZFmznGNVpy2SEocA ($23.50 in chips)
Seat 9: XE5QF1y74bpHog9JxWJMWQ ($100 in chips)
Ogn4JDV3mp4ZDKO49IFzKA: posts small blind $0.50
gUUvmqdVlmvpal6B8nYrmg: posts big blind $1
*** HOLE CARDS ***
qVhRZ0PLZ95XRJHWAjXjOQ: folds
G4DEhsZFmznGNVpy2SEocA: folds
XE5QF1y74bpHog9JxWJMWQ: folds
wZsU+w9r7G66x93UuvBf1Q: raises $3 to $4
RqkO8O/Y3qlc3PIuCAHjVg: folds
FVs16t7GgfWgQWt4JxsObQ: folds
bLbSOSmSOnqE0iTcH/5dxA: folds
Ogn4JDV3mp4ZDKO49IFzKA: folds
gUUvmqdVlmvpal6B8nYrmg: folds
wZsU+w9r7G66x93UuvBf1Q collected $2.50 from pot
*** SUMMARY ***
Total pot $2.50 | Rake $0
Seat 1: wZsU+w9r7G66x93UuvBf1Q collected ($2.50)
Seat 2: RqkO8O/Y3qlc3PIuCAHjVg folded before Flop (didn't bet)
Seat 3: FVs16t7GgfWgQWt4JxsObQ folded before Flop (didn't bet)
Seat 4: bLbSOSmSOnqE0iTcH/5dxA (button) folded before Flop (didn't bet)
Seat 5: Ogn4JDV3mp4ZDKO49IFzKA (small blind) folded before Flop
Seat 6: gUUvmqdVlmvpal6B8nYrmg (big blind) folded before Flop
Seat 7: qVhRZ0PLZ95XRJHWAjXjOQ folded before Flop (didn't bet)
Seat 8: G4DEhsZFmznGNVpy2SEocA folded before Flop (didn't bet)
Seat 9: XE5QF1y74bpHog9JxWJMWQ folded before Flop (didn't bet)



PokerStars Game #59939875152:  Hold'em No Limit ($0.50/$1.00) - 2009/07/01 0:51:15 ET
Table 'GxCPo/gd3OSthkYrAxJngg' 6-max Seat #4 is the button
Seat 1: sH8BpAFP+jGFxCgVpD1Lew ($262.75 in chips)
Seat 2: YExX2paeIHrmfIwV1ivM/w ($76.70 in chips)
Seat 3: o6plE+MSW4XFNTeONe16xg ($29.60 in chips)
Seat 4: YMJG+F++3Aj6P8dAWda5fw ($105.15 in chips)
Seat 5: G5ZSSN6RSON3gkNvk/SmYg ($107.25 in chips)
Seat 6: sS9IXedL3MiRmpVXhAILhw ($103.45 in chips)
G5ZSSN6RSON3gkNvk/SmYg: posts small blind $0.50
sS9IXedL3MiRmpVXhAILhw: posts big blind $1
*** HOLE CARDS ***
sH8BpAFP+jGFxCgVpD1Lew: folds
YExX2paeIHrmfIwV1ivM/w: folds
o6plE+MSW4XFNTeONe16xg: folds
YMJG+F++3Aj6P8dAWda5fw: raises $2 to $3
G5ZSSN6RSON3gkNvk/SmYg: folds
sS9IXedL3MiRmpVXhAILhw said, "made plenty"
sS9IXedL3MiRmpVXhAILhw: calls $2
*** FLOP *** [Kh Ts Ad]
sS9IXedL3MiRmpVXhAILhw: bets $4
YMJG+F++3Aj6P8dAWda5fw: raises $9 to $13
sS9IXedL3MiRmpVXhAILhw: calls $9
*** TURN *** [Kh Ts Ad] [5c]
sS9IXedL3MiRmpVXhAILhw: checks
YMJG+F++3Aj6P8dAWda5fw: bets $18
sS9IXedL3MiRmpVXhAILhw: raises $69.45 to $87.45 and is all-in
YMJG+F++3Aj6P8dAWda5fw: calls $69.45
*** RIVER *** [Kh Ts Ad 5c] [Kc]
*** SHOW DOWN ***
sS9IXedL3MiRmpVXhAILhw: shows [Ah Th] (two pair, Aces and Kings)
YMJG+F++3Aj6P8dAWda5fw: shows [5h 5s] (a full house, Fives full of Kings)
YMJG+F++3Aj6P8dAWda5fw collected $204.40 from pot
*** SUMMARY ***
Total pot $207.40 | Rake $3
Board [Kh Ts Ad 5c Kc]
Seat 1: sH8BpAFP+jGFxCgVpD1Lew folded before Flop (didn't bet)
Seat 2: YExX2paeIHrmfIwV1ivM/w folded before Flop (didn't bet)
Seat 3: o6plE+MSW4XFNTeONe16xg folded before Flop (didn't bet)
Seat 4: YMJG+F++3Aj6P8dAWda5fw (button) showed [5h 5s] and won ($204.40) with a full house, Fives full of Kings
Seat 5: G5ZSSN6RSON3gkNvk/SmYg (small blind) folded before Flop
Seat 6: sS9IXedL3MiRmpVXhAILhw (big blind) showed [Ah Th] and lost with two pair, Aces and Kings



PokerStars Game #59939875610:  Hold'em No Limit ($0.50/$1.00) - 2009/07/01 0:51:15 ET
Table 'MUPc8FEpe/nR0BKSeReX6Q' 6-max Seat #2 is the button
Seat 1: YsLQ3BAvgQHWXMAv3Wv6Hg ($112.35 in chips)
Seat 2: xAU6q2/cwmby2sxmA8VcmA ($100 in chips)
Seat 3: wx3sQGkVi2x9wJXuWNHPBw ($217.40 in chips)
Seat 4: ZA1bp6g8IwtTxkUE4eCjDQ ($203.80 in chips)
Seat 5: UBZQqpnJZdTYYY1FTb0rLA ($105.05 in chips)
Seat 6: oxnw0GLLpFanjhGkxfRSqA ($55 in chips)
wx3sQGkVi2x9wJXuWNHPBw: posts small blind $0.50
ZA1bp6g8IwtTxkUE4eCjDQ: posts big blind $1
*** HOLE CARDS ***
oxnw0GLLpFanjhGkxfRSqA said, "im gonna bury you ****ing donkey"
UBZQqpnJZdTYYY1FTb0rLA: folds
oxnw0GLLpFanjhGkxfRSqA: folds
YsLQ3BAvgQHWXMAv3Wv6Hg: folds
xAU6q2/cwmby2sxmA8VcmA: folds
wx3sQGkVi2x9wJXuWNHPBw: folds
ZA1bp6g8IwtTxkUE4eCjDQ collected $1 from pot
*** SUMMARY ***
Total pot $1 | Rake $0
Seat 1: YsLQ3BAvgQHWXMAv3Wv6Hg folded before Flop (didn't bet)
Seat 2: xAU6q2/cwmby2sxmA8VcmA (button) folded before Flop (didn't bet)
Seat 3: wx3sQGkVi2x9wJXuWNHPBw (small blind) folded before Flop
Seat 4: ZA1bp6g8IwtTxkUE4eCjDQ (big blind) collected ($1)
Seat 5: UBZQqpnJZdTYYY1FTb0rLA folded before Flop (didn't bet)
Seat 6: oxnw0GLLpFanjhGkxfRSqA folded before Flop (didn't bet)



PokerStars Game #59939876056:  Hold'em No Limit ($0.50/$1.00) - 2009/07/01 0:51:16 ET
Table 'vs/5jr6ciwjVQ5+Soc+u2A' 6-max Seat #1 is the button
Seat 1: /P4w1pHg2zHYg/4ubJ0dPw ($60 in chips)
Seat 2: XOIf9W+VAxhZqN+SYoyMKA ($125.85 in chips)
Seat 3: G5ZSSN6RSON3gkNvk/SmYg ($150 in chips)
Seat 4: KpnW5CcJ4Mg6MeclfKmLrw ($127.70 in chips)
Seat 5: 2DwLxMUbmzvwY7o4/i47Xg ($38 in chips)
Seat 6: qAdBJlVNsNTwiHia50eMvg ($81.50 in chips)
XOIf9W+VAxhZqN+SYoyMKA: posts small blind $0.50
G5ZSSN6RSON3gkNvk/SmYg: posts big blind $1
*** HOLE CARDS ***
KpnW5CcJ4Mg6MeclfKmLrw: folds
2DwLxMUbmzvwY7o4/i47Xg: folds
qAdBJlVNsNTwiHia50eMvg: folds
KpnW5CcJ4Mg6MeclfKmLrw leaves the table
/P4w1pHg2zHYg/4ubJ0dPw: raises $2 to $3
XOIf9W+VAxhZqN+SYoyMKA: folds
G5ZSSN6RSON3gkNvk/SmYg: folds
/P4w1pHg2zHYg/4ubJ0dPw collected $2.50 from pot
wk6Ohn4GDozoOMHc4eb2rw joins the table at seat #4
/P4w1pHg2zHYg/4ubJ0dPw: doesn't show hand
*** SUMMARY ***
Total pot $2.50 | Rake $0
Seat 1: /P4w1pHg2zHYg/4ubJ0dPw (button) collected ($2.50)
Seat 2: XOIf9W+VAxhZqN+SYoyMKA (small blind) folded before Flop
Seat 3: G5ZSSN6RSON3gkNvk/SmYg (big blind) folded before Flop
Seat 4: KpnW5CcJ4Mg6MeclfKmLrw folded before Flop (didn't bet)
Seat 5: 2DwLxMUbmzvwY7o4/i47Xg folded before Flop (didn't bet)
Seat 6: qAdBJlVNsNTwiHia50eMvg folded before Flop (didn't bet)



PokerStars Game #59939876082:  Hold'em No Limit ($0.50/$1.00) - 2009/07/01 0:51:16 ET
Table '/RZcOwpZpHQ+OwPwjsbnRw' 6-max Seat #2 is the button
Seat 1: Zboa6dColKGHBjLPUakZjw ($38.90 in chips)
Seat 2: +xW7QemQU0Fxs+4TnqBRow ($193 in chips)
Seat 3: XnT1yK2DD/5FL+0bwuEhqg ($46.95 in chips)
Seat 4: j7NIOHLZk7V2o9fOioO5ug ($120.35 in chips)
Seat 5: wx3sQGkVi2x9wJXuWNHPBw ($182.15 in chips)
Seat 6: XOIf9W+VAxhZqN+SYoyMKA ($293.25 in chips)
XnT1yK2DD/5FL+0bwuEhqg: posts small blind $0.50
j7NIOHLZk7V2o9fOioO5ug: posts big blind $1
*** HOLE CARDS ***
wx3sQGkVi2x9wJXuWNHPBw: folds
XOIf9W+VAxhZqN+SYoyMKA: folds
Zboa6dColKGHBjLPUakZjw: raises $1 to $2
+xW7QemQU0Fxs+4TnqBRow: folds
XnT1yK2DD/5FL+0bwuEhqg: folds
j7NIOHLZk7V2o9fOioO5ug: calls $1
*** FLOP *** [Tc 3s Th]
j7NIOHLZk7V2o9fOioO5ug: checks
Zboa6dColKGHBjLPUakZjw: bets $2
j7NIOHLZk7V2o9fOioO5ug: folds
Zboa6dColKGHBjLPUakZjw collected $4.30 from pot
*** SUMMARY ***
Total pot $4.50 | Rake $0.20
Board [Tc 3s Th]
Seat 1: Zboa6dColKGHBjLPUakZjw collected ($4.30)
Seat 2: +xW7QemQU0Fxs+4TnqBRow (button) folded before Flop (didn't bet)
Seat 3: XnT1yK2DD/5FL+0bwuEhqg (small blind) folded before Flop
Seat 4: j7NIOHLZk7V2o9fOioO5ug (big blind) folded on the Flop
Seat 5: wx3sQGkVi2x9wJXuWNHPBw folded before Flop (didn't bet)
Seat 6: XOIf9W+VAxhZqN+SYoyMKA folded before Flop (didn't bet)



PokerStars Game #59939875858:  Hold'em No Limit ($0.50/$1.00) - 2009/07/01 0:51:16 ET
Table 'Zka9tv1yilg0MvXWPQrShg' 9-max Seat #3 is the button
Seat 1: TZcz9MEWDA+WydgGruqqbw ($112.35 in chips)
Seat 2: kz9ziSiGUc+857heiKSayw ($20 in chips)
Seat 3: gUUvmqdVlmvpal6B8nYrmg ($100 in chips)
Seat 4: stxmTgSicxShtrDxhOOX2g ($69.65 in chips)
Seat 5: /zy+DB4S5fUQUSfZWFzYGw ($124.90 in chips)
Seat 6: rY8wPoax1lS+HUY+I0FZDw ($145.45 in chips)
Seat 7: p1SafS90nb3Uft5LB0NkHw ($22.50 in chips)
Seat 8: bL+QVeDcuEdzMGAGg2XJHg ($122.10 in chips)
Seat 9: 6daxhj43mWj04MOPTOmaYA ($92.65 in chips)
stxmTgSicxShtrDxhOOX2g: posts small blind $0.50
/zy+DB4S5fUQUSfZWFzYGw: posts big blind $1
*** HOLE CARDS ***
rY8wPoax1lS+HUY+I0FZDw: folds
p1SafS90nb3Uft5LB0NkHw: folds
bL+QVeDcuEdzMGAGg2XJHg: folds
6daxhj43mWj04MOPTOmaYA: folds
TZcz9MEWDA+WydgGruqqbw: raises $2.50 to $3.50
kz9ziSiGUc+857heiKSayw: folds
gUUvmqdVlmvpal6B8nYrmg: calls $3.50
stxmTgSicxShtrDxhOOX2g: folds
/zy+DB4S5fUQUSfZWFzYGw: folds
*** FLOP *** [Td Kd 3s]
TZcz9MEWDA+WydgGruqqbw: checks
gUUvmqdVlmvpal6B8nYrmg: checks
*** TURN *** [Td Kd 3s] [9d]
TZcz9MEWDA+WydgGruqqbw: bets $5.50
gUUvmqdVlmvpal6B8nYrmg: calls $5.50
*** RIVER *** [Td Kd 3s 9d] [4d]
TZcz9MEWDA+WydgGruqqbw: checks
gUUvmqdVlmvpal6B8nYrmg: checks
*** SHOW DOWN ***
TZcz9MEWDA+WydgGruqqbw: shows [Qs Qd] (a flush, King high)
gUUvmqdVlmvpal6B8nYrmg: mucks hand
TZcz9MEWDA+WydgGruqqbw collected $18.55 from pot
*** SUMMARY ***
Total pot $19.50 | Rake $0.95
Board [Td Kd 3s 9d 4d]
Seat 1: TZcz9MEWDA+WydgGruqqbw showed [Qs Qd] and won ($18.55) with a flush, King high
Seat 2: kz9ziSiGUc+857heiKSayw folded before Flop (didn't bet)
Seat 3: gUUvmqdVlmvpal6B8nYrmg (button) mucked
Seat 4: stxmTgSicxShtrDxhOOX2g (small blind) folded before Flop
Seat 5: /zy+DB4S5fUQUSfZWFzYGw (big blind) folded before Flop
Seat 6: rY8wPoax1lS+HUY+I0FZDw folded before Flop (didn't bet)
Seat 7: p1SafS90nb3Uft5LB0NkHw folded before Flop (didn't bet)
Seat 8: bL+QVeDcuEdzMGAGg2XJHg folded before Flop (didn't bet)
Seat 9: 6daxhj43mWj04MOPTOmaYA folded before Flop (didn't bet)



PokerStars Game #59939876590:  Hold'em No Limit ($0.50/$1.00) - 2009/07/01 0:51:17 ET
Table 'rmZfTK+oSebeUPJNbWhdAA' 6-max Seat #2 is the button
Seat 1: xAU6q2/cwmby2sxmA8VcmA ($100 in chips)
Seat 2: z7O9PO/WEcqRouIydFhS9Q ($112.45 in chips)
Seat 4: 1/mIuXfgx1ZyVkodrmfQDw ($102.50 in chips)
Seat 5: 5lY8d6Cnm4HUkt/8FZSj4g ($96.35 in chips)
Seat 6: j7NIOHLZk7V2o9fOioO5ug ($135.30 in chips)
BCEV3COoKY607AzLWayfRA will be allowed to play after the button
1/mIuXfgx1ZyVkodrmfQDw: posts small blind $0.50
5lY8d6Cnm4HUkt/8FZSj4g: posts big blind $1
*** HOLE CARDS ***
j7NIOHLZk7V2o9fOioO5ug: folds
xAU6q2/cwmby2sxmA8VcmA: folds
z7O9PO/WEcqRouIydFhS9Q: folds
1/mIuXfgx1ZyVkodrmfQDw: raises $2 to $3
5lY8d6Cnm4HUkt/8FZSj4g: calls $2
*** FLOP *** [Ad 8h Td]
1/mIuXfgx1ZyVkodrmfQDw: bets $5
5lY8d6Cnm4HUkt/8FZSj4g: calls $5
*** TURN *** [Ad 8h Td] [Ts]
1/mIuXfgx1ZyVkodrmfQDw: bets $11
5lY8d6Cnm4HUkt/8FZSj4g: calls $11
*** RIVER *** [Ad 8h Td Ts] [7h]
1/mIuXfgx1ZyVkodrmfQDw: checks
5lY8d6Cnm4HUkt/8FZSj4g: checks
*** SHOW DOWN ***
1/mIuXfgx1ZyVkodrmfQDw: shows [Ks Jd] (a pair of Tens)
5lY8d6Cnm4HUkt/8FZSj4g: shows [As Qh] (two pair, Aces and Tens)
5lY8d6Cnm4HUkt/8FZSj4g collected $36.15 from pot
*** SUMMARY ***
Total pot $38 | Rake $1.85
Board [Ad 8h Td Ts 7h]
Seat 1: xAU6q2/cwmby2sxmA8VcmA folded before Flop (didn't bet)
Seat 2: z7O9PO/WEcqRouIydFhS9Q (button) folded before Flop (didn't bet)
Seat 4: 1/mIuXfgx1ZyVkodrmfQDw (small blind) showed [Ks Jd] and lost with a pair of Tens
Seat 5: 5lY8d6Cnm4HUkt/8FZSj4g (big blind) showed [As Qh] and won ($36.15) with two pair, Aces and Tens
Seat 6: j7NIOHLZk7V2o9fOioO5ug folded before Flop (didn't bet)



PokerStars Game #59939877378:  Hold'em No Limit ($0.50/$1.00) - 2009/07/01 0:51:18 ET
Table '7O9fB8yx1u7sJveJn8w6jA' 6-max Seat #4 is the button
Seat 1: jy52+7FotjH63o5tEEVgKw ($159.35 in chips)
Seat 2: wx3sQGkVi2x9wJXuWNHPBw ($192.50 in chips)
Seat 3: hpxXcmRkXXI9HE5+5/j/0Q ($100 in chips)
Seat 4: XIZSmlGttGgSRaIU42K4Fg ($81.40 in chips)
Seat 5: BCEV3COoKY607AzLWayfRA ($101.40 in chips)
Seat 6: UBZQqpnJZdTYYY1FTb0rLA ($130.45 in chips)
BCEV3COoKY607AzLWayfRA: posts small blind $0.50
UBZQqpnJZdTYYY1FTb0rLA: posts big blind $1
*** HOLE CARDS ***
jy52+7FotjH63o5tEEVgKw: calls $1
wx3sQGkVi2x9wJXuWNHPBw: folds
hpxXcmRkXXI9HE5+5/j/0Q: folds
XIZSmlGttGgSRaIU42K4Fg: calls $1
BCEV3COoKY607AzLWayfRA: calls $0.50
UBZQqpnJZdTYYY1FTb0rLA: checks
*** FLOP *** [4h Ad 4c]
BCEV3COoKY607AzLWayfRA: checks
UBZQqpnJZdTYYY1FTb0rLA: checks
jy52+7FotjH63o5tEEVgKw: checks
XIZSmlGttGgSRaIU42K4Fg: checks
*** TURN *** [4h Ad 4c] [8c]
BCEV3COoKY607AzLWayfRA: checks
UBZQqpnJZdTYYY1FTb0rLA: checks
jy52+7FotjH63o5tEEVgKw: bets $3
XIZSmlGttGgSRaIU42K4Fg: calls $3
BCEV3COoKY607AzLWayfRA: folds
UBZQqpnJZdTYYY1FTb0rLA: folds
*** RIVER *** [4h Ad 4c 8c] [Kc]
jy52+7FotjH63o5tEEVgKw: bets $4
XIZSmlGttGgSRaIU42K4Fg: raises $12 to $16
jy52+7FotjH63o5tEEVgKw: calls $12
*** SHOW DOWN ***
XIZSmlGttGgSRaIU42K4Fg: shows [4d Ah] (a full house, Fours full of Aces)
jy52+7FotjH63o5tEEVgKw: mucks hand
XIZSmlGttGgSRaIU42K4Fg collected $39.95 from pot
*** SUMMARY ***
Total pot $42 | Rake $2.05
Board [4h Ad 4c 8c Kc]
Seat 1: jy52+7FotjH63o5tEEVgKw mucked
Seat 2: wx3sQGkVi2x9wJXuWNHPBw folded before Flop (didn't bet)
Seat 3: hpxXcmRkXXI9HE5+5/j/0Q folded before Flop (didn't bet)
Seat 4: XIZSmlGttGgSRaIU42K4Fg (button) showed [4d Ah] and won ($39.95) with a full house, Fours full of Aces
Seat 5: BCEV3COoKY607AzLWayfRA (small blind) folded on the Turn
Seat 6: UBZQqpnJZdTYYY1FTb0rLA (big blind) folded on the Turn



PokerStars Game #59939878006:  Hold'em No Limit ($0.50/$1.00) - 2009/07/01 0:51:19 ET
Table 'pHrhryH8jPNdQfY62f8v+g' 6-max Seat #1 is the button
Seat 1: fF4botNMr8/ieVPO1YYRLw ($54.50 in chips)
Seat 2: RqgF7gRoKgRNW8Zoi1ty4A ($100.75 in chips)
Seat 3: 8oS5O7iD/qnFXFXJrGIgNQ ($100 in chips)
Seat 4: wenbG7TaM3H7h5kn78OFNw ($58.70 in chips)
Seat 5: r1/R7y0Ortgoz4lccgW8VA ($54.40 in chips)
Seat 6: xAU6q2/cwmby2sxmA8VcmA ($118.80 in chips)
RqgF7gRoKgRNW8Zoi1ty4A: posts small blind $0.50
8oS5O7iD/qnFXFXJrGIgNQ: posts big blind $1
*** HOLE CARDS ***
wenbG7TaM3H7h5kn78OFNw: folds
r1/R7y0Ortgoz4lccgW8VA: raises $2 to $3
xAU6q2/cwmby2sxmA8VcmA: folds
fF4botNMr8/ieVPO1YYRLw: folds
RqgF7gRoKgRNW8Zoi1ty4A: folds
8oS5O7iD/qnFXFXJrGIgNQ: calls $2
*** FLOP *** [5c 8d 8h]
8oS5O7iD/qnFXFXJrGIgNQ: checks
r1/R7y0Ortgoz4lccgW8VA: checks
*** TURN *** [5c 8d 8h] [7d]
8oS5O7iD/qnFXFXJrGIgNQ: bets $5
r1/R7y0Ortgoz4lccgW8VA: folds
8oS5O7iD/qnFXFXJrGIgNQ collected $6.20 from pot
*** SUMMARY ***
Total pot $6.50 | Rake $0.30
Board [5c 8d 8h 7d]
Seat 1: fF4botNMr8/ieVPO1YYRLw (button) folded before Flop (didn't bet)
Seat 2: RqgF7gRoKgRNW8Zoi1ty4A (small blind) folded before Flop
Seat 3: 8oS5O7iD/qnFXFXJrGIgNQ (big blind) collected ($6.20)
Seat 4: wenbG7TaM3H7h5kn78OFNw folded before Flop (didn't bet)
Seat 5: r1/R7y0Ortgoz4lccgW8VA folded on the Turn
Seat 6: xAU6q2/cwmby2sxmA8VcmA folded before Flop (didn't bet)



PokerStars Game #59939877954:  Hold'em No Limit ($0.50/$1.00) - 2009/07/01 0:51:19 ET
Table 'tLrtq7gDzxEvckNAI1OS5Q' 6-max Seat #1 is the button
Seat 1: xNKcQzD9+/iHmtJn4vYq9w ($97.05 in chips)
Seat 2: QHvTZcrKe6+maWUfVjP29Q ($105.85 in chips)
Seat 3: TPZ+m9x+lwoKpv7TMfAUWA ($217.70 in chips)
Seat 4: +uSzP8Jwnw7sKfQ4s66b7w ($45 in chips)
Seat 5: OGMLOcTNYZXZU81au7ztUw ($154.25 in chips)
Seat 6: XUk5GQsfNFpHvaToDZ0rZA ($168.20 in chips)
QHvTZcrKe6+maWUfVjP29Q: posts small blind $0.50
TPZ+m9x+lwoKpv7TMfAUWA: posts big blind $1
*** HOLE CARDS ***
+uSzP8Jwnw7sKfQ4s66b7w: raises $2 to $3
OGMLOcTNYZXZU81au7ztUw: folds
XUk5GQsfNFpHvaToDZ0rZA: folds
xNKcQzD9+/iHmtJn4vYq9w: folds
QHvTZcrKe6+maWUfVjP29Q: calls $2.50
TPZ+m9x+lwoKpv7TMfAUWA: folds
*** FLOP *** [8s Jd 6c]
QHvTZcrKe6+maWUfVjP29Q: checks
+uSzP8Jwnw7sKfQ4s66b7w: bets $4
QHvTZcrKe6+maWUfVjP29Q: folds
+uSzP8Jwnw7sKfQ4s66b7w collected $6.65 from pot
*** SUMMARY ***
Total pot $7 | Rake $0.35
Board [8s Jd 6c]
Seat 1: xNKcQzD9+/iHmtJn4vYq9w (button) folded before Flop (didn't bet)
Seat 2: QHvTZcrKe6+maWUfVjP29Q (small blind) folded on the Flop
Seat 3: TPZ+m9x+lwoKpv7TMfAUWA (big blind) folded before Flop
Seat 4: +uSzP8Jwnw7sKfQ4s66b7w collected ($6.65)
Seat 5: OGMLOcTNYZXZU81au7ztUw folded before Flop (didn't bet)
Seat 6: XUk5GQsfNFpHvaToDZ0rZA folded before Flop (didn't bet)



PokerStars Game #59939878040:  Hold'em No Limit ($0.50/$1.00) - 2009/07/01 0:51:19 ET
Table 'JOIm/fogLA7vSG0Vc6ME1A' 2-max Seat #2 is the button
Seat 1: NYi6JFscYNrofSXy4sM+Yw ($100 in chips)
Seat 2: F5lNTyZLIX9W2wQZ0plwgg ($121.30 in chips)
F5lNTyZLIX9W2wQZ0plwgg: posts small blind $0.50
NYi6JFscYNrofSXy4sM+Yw: posts big blind $1
*** HOLE CARDS ***
F5lNTyZLIX9W2wQZ0plwgg: raises $1 to $2
NYi6JFscYNrofSXy4sM+Yw: raises $6 to $8
F5lNTyZLIX9W2wQZ0plwgg: calls $6
*** FLOP *** [Ac 3s 2d]
NYi6JFscYNrofSXy4sM+Yw: bets $11
F5lNTyZLIX9W2wQZ0plwgg: folds
NYi6JFscYNrofSXy4sM+Yw collected $15.50 from pot
*** SUMMARY ***
Total pot $16 | Rake $0.50
Board [Ac 3s 2d]
Seat 1: NYi6JFscYNrofSXy4sM+Yw (big blind) collected ($15.50)
Seat 2: F5lNTyZLIX9W2wQZ0plwgg (button) (small blind) folded on the Flop



PokerStars Game #59939878564:  Hold'em No Limit ($0.50/$1.00) - 2009/07/01 0:51:20 ET
Table 'LmXQK9xy3awB+qsPzI21Mw' 2-max Seat #2 is the button
Seat 1: NYi6JFscYNrofSXy4sM+Yw ($182.05 in chips)
Seat 2: TME8GvochpQAo8cmJwWmvA ($146.95 in chips)
TME8GvochpQAo8cmJwWmvA: posts small blind $0.50
NYi6JFscYNrofSXy4sM+Yw: posts big blind $1
*** HOLE CARDS ***
TME8GvochpQAo8cmJwWmvA: calls $0.50
NYi6JFscYNrofSXy4sM+Yw: raises $3 to $4
TME8GvochpQAo8cmJwWmvA: calls $3
*** FLOP *** [5h 5c As]
NYi6JFscYNrofSXy4sM+Yw: bets $4
TME8GvochpQAo8cmJwWmvA: calls $4
*** TURN *** [5h 5c As] [6c]
NYi6JFscYNrofSXy4sM+Yw: checks
TME8GvochpQAo8cmJwWmvA: bets $4
NYi6JFscYNrofSXy4sM+Yw: folds
TME8GvochpQAo8cmJwWmvA collected $15.50 from pot
TME8GvochpQAo8cmJwWmvA: doesn't show hand
*** SUMMARY ***
Total pot $16 | Rake $0.50
Board [5h 5c As 6c]
Seat 1: NYi6JFscYNrofSXy4sM+Yw (big blind) folded on the Turn
Seat 2: TME8GvochpQAo8cmJwWmvA (button) (small blind) collected ($15.50)



PokerStars Game #59939880292:  Hold'em No Limit ($0.50/$1.00) - 2009/07/01 0:51:23 ET
Table 'tyUh+jyNvrceIQdKMJjQ2wZFWj23PMihdwrNWv41OG/Qeat #6 is the button
Seat 1: o8A5MUdudVKu+pAwgZOX2w ($208.30 in chips)
Seat 2: XvUbOIg94d25feWeQlOTVg ($69.90 in chips)
Seat 3: TalCiLYHCd+ffkmR3auPvA ($90.40 in chips)
Seat 4: TSuRyAHnUPCFjP7Z0rEE0w ($116.75 in chips)
Seat 5: j7NIOHLZk7V2o9fOioO5ug ($100 in chips)
Seat 6: YsLQ3BAvgQHWXMAv3Wv6Hg ($150.15 in chips)
o8A5MUdudVKu+pAwgZOX2w: posts small blind $0.50
XvUbOIg94d25feWeQlOTVg: posts big blind $1
*** HOLE CARDS ***
TalCiLYHCd+ffkmR3auPvA: folds
TSuRyAHnUPCFjP7Z0rEE0w: raises $3 to $4
j7NIOHLZk7V2o9fOioO5ug: calls $4
YsLQ3BAvgQHWXMAv3Wv6Hg: folds
o8A5MUdudVKu+pAwgZOX2w: folds
XvUbOIg94d25feWeQlOTVg: calls $3
*** FLOP *** [7c 7d 2c]
XvUbOIg94d25feWeQlOTVg: checks
TSuRyAHnUPCFjP7Z0rEE0w: checks
j7NIOHLZk7V2o9fOioO5ug: bets $8
XvUbOIg94d25feWeQlOTVg: folds
TSuRyAHnUPCFjP7Z0rEE0w: folds
j7NIOHLZk7V2o9fOioO5ug collected $11.90 from pot
j7NIOHLZk7V2o9fOioO5ug: doesn't show hand
*** SUMMARY ***
Total pot $12.50 | Rake $0.60
Board [7c 7d 2c]
Seat 1: o8A5MUdudVKu+pAwgZOX2w (small blind) folded before Flop
Seat 2: XvUbOIg94d25feWeQlOTVg (big blind) folded on the Flop
Seat 3: TalCiLYHCd+ffkmR3auPvA folded before Flop (didn't bet)
Seat 4: TSuRyAHnUPCFjP7Z0rEE0w folded on the Flop
Seat 5: j7NIOHLZk7V2o9fOioO5ug collected ($11.90)
Seat 6: YsLQ3BAvgQHWXMAv3Wv6Hg (button) folded before Flop (didn't bet)



PokerStars Game #59939882262:  Hold'em No Limit ($0.50/$1.00) - 2009/07/01 0:51:26 ET
Table 'eU3bWpDDg3Z+9R4m4iVmog' 6-max Seat #1 is the button
Seat 1: TSuRyAHnUPCFjP7Z0rEE0w ($191.15 in chips)
Seat 2: 8CAoOzhmB8n3nRFf3V4BTg ($75 in chips)
Seat 3: U6tnjwZRpTnM+YkqkCjwyQ ($188.65 in chips)
Seat 4: GDVIsbEJ/DOJsMKE4Asz0A ($92.60 in chips)
Seat 5: AdLVjddOzm+sRNo1Bc3S6Q ($105.05 in chips)
Seat 6: hpxXcmRkXXI9HE5+5/j/0Q ($120.45 in chips)
8CAoOzhmB8n3nRFf3V4BTg: posts small blind $0.50
U6tnjwZRpTnM+YkqkCjwyQ: posts big blind $1
*** HOLE CARDS ***
GDVIsbEJ/DOJsMKE4Asz0A: folds
AdLVjddOzm+sRNo1Bc3S6Q: raises $3 to $4
hpxXcmRkXXI9HE5+5/j/0Q: raises $10 to $14
TSuRyAHnUPCFjP7Z0rEE0w: folds
8CAoOzhmB8n3nRFf3V4BTg: folds
U6tnjwZRpTnM+YkqkCjwyQ: folds
AdLVjddOzm+sRNo1Bc3S6Q: raises $24 to $38
hpxXcmRkXXI9HE5+5/j/0Q: folds
AdLVjddOzm+sRNo1Bc3S6Q collected $29.50 from pot
AdLVjddOzm+sRNo1Bc3S6Q: doesn't show hand
*** SUMMARY ***
Total pot $29.50 | Rake $0
Seat 1: TSuRyAHnUPCFjP7Z0rEE0w (button) folded before Flop (didn't bet)
Seat 2: 8CAoOzhmB8n3nRFf3V4BTg (small blind) folded before Flop
Seat 3: U6tnjwZRpTnM+YkqkCjwyQ (big blind) folded before Flop
Seat 4: GDVIsbEJ/DOJsMKE4Asz0A folded before Flop (didn't bet)
Seat 5: AdLVjddOzm+sRNo1Bc3S6Q collected ($29.50)
Seat 6: hpxXcmRkXXI9HE5+5/j/0Q folded before Flop



PokerStars Game #59939882374:  Hold'em No Limit ($0.50/$1.00) - 2009/07/01 0:51:26 ET
Table 'VOs36P6NW+QyXeQ1B62kmA' 6-max Seat #4 is the button
Seat 1: AdLVjddOzm+sRNo1Bc3S6Q ($130.80 in chips)
Seat 2: KpnW5CcJ4Mg6MeclfKmLrw ($121.35 in chips)
Seat 3: TSuRyAHnUPCFjP7Z0rEE0w ($100 in chips)
Seat 4: w02zQzNydODiyV9THKgo9w ($30.60 in chips)
Seat 5: ozrlafxxh1HmYdA0/h+MuA ($24.30 in chips)
Seat 6: 6tvjsJrdmWg+g7FVrMnzXA ($88 in chips)
ozrlafxxh1HmYdA0/h+MuA: posts small blind $0.50
6tvjsJrdmWg+g7FVrMnzXA: posts big blind $1
*** HOLE CARDS ***
AdLVjddOzm+sRNo1Bc3S6Q: folds
KpnW5CcJ4Mg6MeclfKmLrw: raises $2 to $3
TSuRyAHnUPCFjP7Z0rEE0w: folds
w02zQzNydODiyV9THKgo9w: folds
ozrlafxxh1HmYdA0/h+MuA: folds
6tvjsJrdmWg+g7FVrMnzXA: calls $2
*** FLOP *** [8s 2d Ah]
6tvjsJrdmWg+g7FVrMnzXA: checks
KpnW5CcJ4Mg6MeclfKmLrw: bets $5
6tvjsJrdmWg+g7FVrMnzXA: calls $5
*** TURN *** [8s 2d Ah] [Ks]
6tvjsJrdmWg+g7FVrMnzXA: checks
KpnW5CcJ4Mg6MeclfKmLrw: bets $12
6tvjsJrdmWg+g7FVrMnzXA: folds
KpnW5CcJ4Mg6MeclfKmLrw collected $15.70 from pot
KpnW5CcJ4Mg6MeclfKmLrw: doesn't show hand
*** SUMMARY ***
Total pot $16.50 | Rake $0.80
Board [8s 2d Ah Ks]
Seat 1: AdLVjddOzm+sRNo1Bc3S6Q folded before Flop (didn't bet)
Seat 2: KpnW5CcJ4Mg6MeclfKmLrw collected ($15.70)
Seat 3: TSuRyAHnUPCFjP7Z0rEE0w folded before Flop (didn't bet)
Seat 4: w02zQzNydODiyV9THKgo9w (button) folded before Flop (didn't bet)
Seat 5: ozrlafxxh1HmYdA0/h+MuA (small blind) folded before Flop
Seat 6: 6tvjsJrdmWg+g7FVrMnzXA (big blind) folded on the Turn



PokerStars Game #59939882746:  Hold'em No Limit ($0.50/$1.00) - 2009/07/01 0:51:27 ET
Table 'mmbQQVBTrPdE+wy+s+9VPA' 6-max Seat #4 is the button
Seat 2: +W6OnF033KNM2xH0fGj98Q ($123.30 in chips)
Seat 3: wx3sQGkVi2x9wJXuWNHPBw ($114.15 in chips)
Seat 4: RfKnhkJN8HEAuzJpH2Ajdg ($14.25 in chips)
Seat 5: YMJG+F++3Aj6P8dAWda5fw ($100 in chips)
Seat 6: U2CWBTv29qdCbj8RNF2sIw ($100 in chips)
YMJG+F++3Aj6P8dAWda5fw: posts small blind $0.50
U2CWBTv29qdCbj8RNF2sIw: posts big blind $1
JwCcjZl0bjJzG7hmE0dnTA: sits out
*** HOLE CARDS ***
+W6OnF033KNM2xH0fGj98Q: raises $2 to $3
wx3sQGkVi2x9wJXuWNHPBw: folds
RfKnhkJN8HEAuzJpH2Ajdg: calls $3
YMJG+F++3Aj6P8dAWda5fw: folds
U2CWBTv29qdCbj8RNF2sIw: folds
*** FLOP *** [Kd 5h 3c]
+W6OnF033KNM2xH0fGj98Q: bets $5
RfKnhkJN8HEAuzJpH2Ajdg: raises $6.25 to $11.25 and is all-in
+W6OnF033KNM2xH0fGj98Q: calls $6.25
*** TURN *** [Kd 5h 3c] [Kh]
*** RIVER *** [Kd 5h 3c Kh] [9d]
*** SHOW DOWN ***
+W6OnF033KNM2xH0fGj98Q: shows [6c 6h] (two pair, Kings and Sixes)
RfKnhkJN8HEAuzJpH2Ajdg: mucks hand
+W6OnF033KNM2xH0fGj98Q collected $28.55 from pot
*** SUMMARY ***
Total pot $30 | Rake $1.45
Board [Kd 5h 3c Kh 9d]
Seat 2: +W6OnF033KNM2xH0fGj98Q showed [6c 6h] and won ($28.55) with two pair, Kings and Sixes
Seat 3: wx3sQGkVi2x9wJXuWNHPBw folded before Flop (didn't bet)
Seat 4: RfKnhkJN8HEAuzJpH2Ajdg (button) mucked
Seat 5: YMJG+F++3Aj6P8dAWda5fw (small blind) folded before Flop
Seat 6: U2CWBTv29qdCbj8RNF2sIw (big blind) folded before Flop



PokerStars Game #59939883734:  Hold'em No Limit ($0.50/$1.00) - 2009/07/01 0:51:28 ET
Table 'uNlePsyMIqzM691Xkrlk6Q' 9-max Seat #7 is the button
Seat 1: bLbSOSmSOnqE0iTcH/5dxA ($100 in chips)
Seat 2: +OqpStnt0FqbCfyHAWaLbg ($87.60 in chips)
Seat 3: h7qXkU57Bb8ZuPwMyxR8Ug ($32.85 in chips)
Seat 4: TZcz9MEWDA+WydgGruqqbw ($101.15 in chips)
Seat 5: 3obndzTJ6fECz8+wWhMd1w ($18.50 in chips)
Seat 6: myIxN7otsyr846M539YR8Q ($18.50 in chips)
Seat 7: w6cw9nzN7AvkkHBVVjykoQ ($46.90 in chips)
Seat 8: laA8va+Yv8WuMqT1zdR91g ($100 in chips)
Seat 9: vR4IO10geOgvTW+LAUBv/A ($103.75 in chips)
laA8va+Yv8WuMqT1zdR91g: posts small blind $0.50
vR4IO10geOgvTW+LAUBv/A: posts big blind $1
*** HOLE CARDS ***
bLbSOSmSOnqE0iTcH/5dxA: folds
+OqpStnt0FqbCfyHAWaLbg: folds
h7qXkU57Bb8ZuPwMyxR8Ug: folds
TZcz9MEWDA+WydgGruqqbw: folds
3obndzTJ6fECz8+wWhMd1w: folds
myIxN7otsyr846M539YR8Q: folds
w6cw9nzN7AvkkHBVVjykoQ: folds
laA8va+Yv8WuMqT1zdR91g: raises $2 to $3
vR4IO10geOgvTW+LAUBv/A: folds
laA8va+Yv8WuMqT1zdR91g collected $2 from pot
laA8va+Yv8WuMqT1zdR91g: doesn't show hand
*** SUMMARY ***
Total pot $2 | Rake $0
Seat 1: bLbSOSmSOnqE0iTcH/5dxA folded before Flop (didn't bet)
Seat 2: +OqpStnt0FqbCfyHAWaLbg folded before Flop (didn't bet)
Seat 3: h7qXkU57Bb8ZuPwMyxR8Ug folded before Flop (didn't bet)
Seat 4: TZcz9MEWDA+WydgGruqqbw folded before Flop (didn't bet)
Seat 5: 3obndzTJ6fECz8+wWhMd1w folded before Flop (didn't bet)
Seat 6: myIxN7otsyr846M539YR8Q folded before Flop (didn't bet)
Seat 7: w6cw9nzN7AvkkHBVVjykoQ (button) folded before Flop (didn't bet)
Seat 8: laA8va+Yv8WuMqT1zdR91g (small blind) collected ($2)
Seat 9: vR4IO10geOgvTW+LAUBv/A (big blind) folded before Flop



PokerStars Game #59939886118:  Hold'em No Limit ($0.50/$1.00) - 2009/07/01 0:51:32 ET
Table 'MUPc8FEpe/nR0BKSeReX6Q' 6-max Seat #3 is the button
Seat 1: YsLQ3BAvgQHWXMAv3Wv6Hg ($112.35 in chips)
Seat 2: xAU6q2/cwmby2sxmA8VcmA ($100 in chips)
Seat 3: wx3sQGkVi2x9wJXuWNHPBw ($216.90 in chips)
Seat 4: ZA1bp6g8IwtTxkUE4eCjDQ ($204.30 in chips)
Seat 5: UBZQqpnJZdTYYY1FTb0rLA ($105.05 in chips)
Seat 6: oxnw0GLLpFanjhGkxfRSqA ($55 in chips)
ZA1bp6g8IwtTxkUE4eCjDQ: posts small blind $0.50
UBZQqpnJZdTYYY1FTb0rLA: posts big blind $1
*** HOLE CARDS ***
oxnw0GLLpFanjhGkxfRSqA: folds
YsLQ3BAvgQHWXMAv3Wv6Hg: folds
xAU6q2/cwmby2sxmA8VcmA: folds
wx3sQGkVi2x9wJXuWNHPBw: folds
ZA1bp6g8IwtTxkUE4eCjDQ: folds
UBZQqpnJZdTYYY1FTb0rLA collected $1 from pot
UBZQqpnJZdTYYY1FTb0rLA: doesn't show hand
*** SUMMARY ***
Total pot $1 | Rake $0
Seat 1: YsLQ3BAvgQHWXMAv3Wv6Hg folded before Flop (didn't bet)
Seat 2: xAU6q2/cwmby2sxmA8VcmA folded before Flop (didn't bet)
Seat 3: wx3sQGkVi2x9wJXuWNHPBw (button) folded before Flop (didn't bet)
Seat 4: ZA1bp6g8IwtTxkUE4eCjDQ (small blind) folded before Flop
Seat 5: UBZQqpnJZdTYYY1FTb0rLA (big blind) collected ($1)
Seat 6: oxnw0GLLpFanjhGkxfRSqA folded before Flop (didn't bet)



PokerStars Game #59939886550:  Hold'em No Limit ($0.50/$1.00) - 2009/07/01 0:51:33 ET
Table 'JOIm/fogLA7vSG0Vc6ME1A' 2-max Seat #1 is the button
Seat 1: NYi6JFscYNrofSXy4sM+Yw ($107.50 in chips)
Seat 2: F5lNTyZLIX9W2wQZ0plwgg ($113.30 in chips)
NYi6JFscYNrofSXy4sM+Yw: posts small blind $0.50
F5lNTyZLIX9W2wQZ0plwgg: posts big blind $1
*** HOLE CARDS ***
NYi6JFscYNrofSXy4sM+Yw: raises $2 to $3
F5lNTyZLIX9W2wQZ0plwgg: raises $2 to $5
NYi6JFscYNrofSXy4sM+Yw: calls $2
*** FLOP *** [Js 9d 5h]
F5lNTyZLIX9W2wQZ0plwgg: bets $3
NYi6JFscYNrofSXy4sM+Yw: calls $3
*** TURN *** [Js 9d 5h] [Qh]
F5lNTyZLIX9W2wQZ0plwgg: bets $4
NYi6JFscYNrofSXy4sM+Yw: calls $4
*** RIVER *** [Js 9d 5h Qh] [4h]
F5lNTyZLIX9W2wQZ0plwgg: bets $4
NYi6JFscYNrofSXy4sM+Yw: calls $4
*** SHOW DOWN ***
F5lNTyZLIX9W2wQZ0plwgg: shows [Td Qd] (a pair of Queens)
NYi6JFscYNrofSXy4sM+Yw: mucks hand
F5lNTyZLIX9W2wQZ0plwgg collected $31.50 from pot
*** SUMMARY ***
Total pot $32 | Rake $0.50
Board [Js 9d 5h Qh 4h]
Seat 1: NYi6JFscYNrofSXy4sM+Yw (button) (small blind) mucked
Seat 2: F5lNTyZLIX9W2wQZ0plwgg (big blind) showed [Td Qd] and won ($31.50) with a pair of Queens



PokerStars Game #59939887092:  Hold'em No Limit ($0.50/$1.00) - 2009/07/01 0:51:34 ET
Table '6YvsYDPNIDx2v5z3bJnwZQ' 9-max Seat #5 is the button
Seat 1: Ogn4JDV3mp4ZDKO49IFzKA ($19.70 in chips)
Seat 2: x80+i7DJL+81v3quj7KbNg ($20 in chips)
Seat 3: negfosHnGOZXSHpWDRKyBQ ($20 in chips)
Seat 4: kEr5NYB+JIG5+szcYMr6hA ($41.25 in chips)
Seat 5: mBRWbnUl8diyBO1qTJaNzw ($165.20 in chips)
Seat 6: 7RSwrjMohkYrZAhOd1uaZg ($18 in chips)
Seat 7: mae7OMTaJ/MFimNbZegCkg ($49 in chips)
Seat 8: PSFxpXgPedVZyHSu2Zhb7Q ($105.40 in chips)
Seat 9: ZgMRSHJ9EOtPeVHmdeV9kQ ($57 in chips)
7RSwrjMohkYrZAhOd1uaZg: posts small blind $0.50
mae7OMTaJ/MFimNbZegCkg: posts big blind $1
*** HOLE CARDS ***
PSFxpXgPedVZyHSu2Zhb7Q: calls $1
ZgMRSHJ9EOtPeVHmdeV9kQ: folds
Ogn4JDV3mp4ZDKO49IFzKA: folds
x80+i7DJL+81v3quj7KbNg: folds
negfosHnGOZXSHpWDRKyBQ: folds
kEr5NYB+JIG5+szcYMr6hA: folds
mBRWbnUl8diyBO1qTJaNzw: folds
7RSwrjMohkYrZAhOd1uaZg: calls $0.50
mae7OMTaJ/MFimNbZegCkg: raises $3 to $4
PSFxpXgPedVZyHSu2Zhb7Q: folds
7RSwrjMohkYrZAhOd1uaZg: folds
mae7OMTaJ/MFimNbZegCkg collected $3 from pot
*** SUMMARY ***
Total pot $3 | Rake $0
Seat 1: Ogn4JDV3mp4ZDKO49IFzKA folded before Flop (didn't bet)
Seat 2: x80+i7DJL+81v3quj7KbNg folded before Flop (didn't bet)
Seat 3: negfosHnGOZXSHpWDRKyBQ folded before Flop (didn't bet)
Seat 4: kEr5NYB+JIG5+szcYMr6hA folded before Flop (didn't bet)
Seat 5: mBRWbnUl8diyBO1qTJaNzw (button) folded before Flop (didn't bet)
Seat 6: 7RSwrjMohkYrZAhOd1uaZg (small blind) folded before Flop
Seat 7: mae7OMTaJ/MFimNbZegCkg (big blind) collected ($3)
Seat 8: PSFxpXgPedVZyHSu2Zhb7Q folded before Flop
Seat 9: ZgMRSHJ9EOtPeVHmdeV9kQ folded before Flop (didn't bet)



PokerStars Game #59939888440:  Hold'em No Limit ($0.50/$1.00) - 2009/07/01 0:51:36 ET
Table '7Nl0ffnjeK44/vmeexh3MQ' 9-max Seat #4 is the button
Seat 1: s7D3Y+k4Cj4D1cXHv7oj+Q ($97.70 in chips)
Seat 2: OGgaARGdJQT4awWVNQ957w ($100 in chips)
Seat 3: vR4IO10geOgvTW+LAUBv/A ($100 in chips)
Seat 4: bLbSOSmSOnqE0iTcH/5dxA ($108.50 in chips)
Seat 5: bL+QVeDcuEdzMGAGg2XJHg ($104.05 in chips)
Seat 6: FVs16t7GgfWgQWt4JxsObQ ($26.50 in chips)
Seat 7: 997ViqAtWn1FPjJqcffwcA ($100 in chips)
Seat 8: zanka7aAZkigmZpfopXxxA ($247.35 in chips)
Seat 9: ouwUBGRKnKK9uhn1G4Lf+A ($99.50 in chips)
bL+QVeDcuEdzMGAGg2XJHg: posts small blind $0.50
FVs16t7GgfWgQWt4JxsObQ: posts big blind $1
*** HOLE CARDS ***
997ViqAtWn1FPjJqcffwcA: folds
zanka7aAZkigmZpfopXxxA: folds
ouwUBGRKnKK9uhn1G4Lf+A: folds
s7D3Y+k4Cj4D1cXHv7oj+Q: folds
OGgaARGdJQT4awWVNQ957w: folds
vR4IO10geOgvTW+LAUBv/A: folds
bLbSOSmSOnqE0iTcH/5dxA: folds
bL+QVeDcuEdzMGAGg2XJHg: raises $2 to $3
FVs16t7GgfWgQWt4JxsObQ: calls $2
*** FLOP *** [Jh 7c 9h]
bL+QVeDcuEdzMGAGg2XJHg: bets $4
FVs16t7GgfWgQWt4JxsObQ: folds
bL+QVeDcuEdzMGAGg2XJHg collected $5.70 from pot
bL+QVeDcuEdzMGAGg2XJHg: doesn't show hand
*** SUMMARY ***
Total pot $6 | Rake $0.30
Board [Jh 7c 9h]
Seat 1: s7D3Y+k4Cj4D1cXHv7oj+Q folded before Flop (didn't bet)
Seat 2: OGgaARGdJQT4awWVNQ957w folded before Flop (didn't bet)
Seat 3: vR4IO10geOgvTW+LAUBv/A folded before Flop (didn't bet)
Seat 4: bLbSOSmSOnqE0iTcH/5dxA (button) folded before Flop (didn't bet)
Seat 5: bL+QVeDcuEdzMGAGg2XJHg (small blind) collected ($5.70)
Seat 6: FVs16t7GgfWgQWt4JxsObQ (big blind) folded on the Flop
Seat 7: 997ViqAtWn1FPjJqcffwcA folded before Flop (didn't bet)
Seat 8: zanka7aAZkigmZpfopXxxA folded before Flop (didn't bet)
Seat 9: ouwUBGRKnKK9uhn1G4Lf+A folded before Flop (didn't bet)



PokerStars Game #59939889786:  Hold'em No Limit ($0.50/$1.00) - 2009/07/01 0:51:38 ET
Table 'fTlPiCj0utgzC/5io+I7ew' 6-max Seat #4 is the button
Seat 1: YMJG+F++3Aj6P8dAWda5fw ($93.50 in chips)
Seat 2: Qy/UBNbD2HaA0Ogxg8Sf3w ($125.85 in chips)
Seat 3: oDiBRCaF0QVtd3kO6xZIXw ($72.25 in chips)
Seat 4: uJVSceLggtsrJya+WtmUEA ($107.50 in chips)
Seat 5: bFrTkDcWGTxyvNul7GVdYg ($251.20 in chips)
Seat 6: /P4w1pHg2zHYg/4ubJ0dPw ($60 in chips)
bFrTkDcWGTxyvNul7GVdYg: posts small blind $0.50
/P4w1pHg2zHYg/4ubJ0dPw: posts big blind $1
*** HOLE CARDS ***
YMJG+F++3Aj6P8dAWda5fw: folds
Qy/UBNbD2HaA0Ogxg8Sf3w: raises $2.50 to $3.50
oDiBRCaF0QVtd3kO6xZIXw: folds
uJVSceLggtsrJya+WtmUEA: folds
bFrTkDcWGTxyvNul7GVdYg: folds
/P4w1pHg2zHYg/4ubJ0dPw: folds
Qy/UBNbD2HaA0Ogxg8Sf3w collected $2.50 from pot
*** SUMMARY ***
Total pot $2.50 | Rake $0
Seat 1: YMJG+F++3Aj6P8dAWda5fw folded before Flop (didn't bet)
Seat 2: Qy/UBNbD2HaA0Ogxg8Sf3w collected ($2.50)
Seat 3: oDiBRCaF0QVtd3kO6xZIXw folded before Flop (didn't bet)
Seat 4: uJVSceLggtsrJya+WtmUEA (button) folded before Flop (didn't bet)
Seat 5: bFrTkDcWGTxyvNul7GVdYg (small blind) folded before Flop
Seat 6: /P4w1pHg2zHYg/4ubJ0dPw (big blind) folded before Flop



PokerStars Game #59939889648:  Hold'em No Limit ($0.50/$1.00) - 2009/07/01 0:51:38 ET
Table 'vs/5jr6ciwjVQ5+Soc+u2A' 6-max Seat #2 is the button
Seat 1: /P4w1pHg2zHYg/4ubJ0dPw ($61.50 in chips)
Seat 2: XOIf9W+VAxhZqN+SYoyMKA ($125.35 in chips)
Seat 3: G5ZSSN6RSON3gkNvk/SmYg ($149 in chips)
Seat 4: wk6Ohn4GDozoOMHc4eb2rw ($38.30 in chips)
Seat 5: 2DwLxMUbmzvwY7o4/i47Xg ($38 in chips)
Seat 6: qAdBJlVNsNTwiHia50eMvg ($81.50 in chips)
G5ZSSN6RSON3gkNvk/SmYg: posts small blind $0.50
wk6Ohn4GDozoOMHc4eb2rw: posts big blind $1
*** HOLE CARDS ***
2DwLxMUbmzvwY7o4/i47Xg: folds
qAdBJlVNsNTwiHia50eMvg: folds
/P4w1pHg2zHYg/4ubJ0dPw: folds
XOIf9W+VAxhZqN+SYoyMKA: raises $2 to $3
G5ZSSN6RSON3gkNvk/SmYg: folds
wk6Ohn4GDozoOMHc4eb2rw: calls $2
*** FLOP *** [4h 5d 3c]
wk6Ohn4GDozoOMHc4eb2rw: bets $3
XOIf9W+VAxhZqN+SYoyMKA: folds
wk6Ohn4GDozoOMHc4eb2rw collected $6.20 from pot
wk6Ohn4GDozoOMHc4eb2rw: doesn't show hand
*** SUMMARY ***
Total pot $6.50 | Rake $0.30
Board [4h 5d 3c]
Seat 1: /P4w1pHg2zHYg/4ubJ0dPw folded before Flop (didn't bet)
Seat 2: XOIf9W+VAxhZqN+SYoyMKA (button) folded on the Flop
Seat 3: G5ZSSN6RSON3gkNvk/SmYg (small blind) folded before Flop
Seat 4: wk6Ohn4GDozoOMHc4eb2rw (big blind) collected ($6.20)
Seat 5: 2DwLxMUbmzvwY7o4/i47Xg folded before Flop (didn't bet)
Seat 6: qAdBJlVNsNTwiHia50eMvg folded before Flop (didn't bet)



PokerStars Game #59939890174:  Hold'em No Limit ($0.50/$1.00) - 2009/07/01 0:51:39 ET
Table 'W/wyObTiXZm+Ckkl3YxcSw' 6-max Seat #1 is the button
Seat 1: eUBBn2R56C1IQ6Cs/vitwg ($110.75 in chips)
Seat 2: oDiBRCaF0QVtd3kO6xZIXw ($98.45 in chips)
Seat 3: ybGsYWp1MLwy1vSnP8egXg ($27.50 in chips)
Seat 4: +xW7QemQU0Fxs+4TnqBRow ($113.40 in chips)
Seat 5: BdbmJTZZ47quA9vUWwXtlw ($56.85 in chips)
Seat 6: tS9JHB1h+FQ++qu8RwRNgg ($27 in chips)
oDiBRCaF0QVtd3kO6xZIXw: posts small blind $0.50
ybGsYWp1MLwy1vSnP8egXg: posts big blind $1
*** HOLE CARDS ***
+xW7QemQU0Fxs+4TnqBRow: folds
BdbmJTZZ47quA9vUWwXtlw: raises $2 to $3
tS9JHB1h+FQ++qu8RwRNgg: calls $3
eUBBn2R56C1IQ6Cs/vitwg: folds
oDiBRCaF0QVtd3kO6xZIXw: folds
ybGsYWp1MLwy1vSnP8egXg: folds
*** FLOP *** [Qh Td 9d]
BdbmJTZZ47quA9vUWwXtlw: checks
tS9JHB1h+FQ++qu8RwRNgg: bets $5
BdbmJTZZ47quA9vUWwXtlw: calls $5
*** TURN *** [Qh Td 9d] [3d]
BdbmJTZZ47quA9vUWwXtlw: checks
tS9JHB1h+FQ++qu8RwRNgg: checks
*** RIVER *** [Qh Td 9d 3d] [As]
BdbmJTZZ47quA9vUWwXtlw: bets $20
tS9JHB1h+FQ++qu8RwRNgg: folds
BdbmJTZZ47quA9vUWwXtlw collected $16.65 from pot
*** SUMMARY ***
Total pot $17.50 | Rake $0.85
Board [Qh Td 9d 3d As]
Seat 1: eUBBn2R56C1IQ6Cs/vitwg (button) folded before Flop (didn't bet)
Seat 2: oDiBRCaF0QVtd3kO6xZIXw (small blind) folded before Flop
Seat 3: ybGsYWp1MLwy1vSnP8egXg (big blind) folded before Flop
Seat 4: +xW7QemQU0Fxs+4TnqBRow folded before Flop (didn't bet)
Seat 5: BdbmJTZZ47quA9vUWwXtlw collected ($16.65)
Seat 6: tS9JHB1h+FQ++qu8RwRNgg folded on the River



PokerStars Game #59939890458:  Hold'em No Limit ($0.50/$1.00) - 2009/07/01 0:51:39 ET
Table '+cA8mcmhaedZ7YcrDdhmeQ' 6-max Seat #5 is the button
Seat 1: lsLuWlcPA3Rh7kJVLzMh0Q ($289 in chips)
Seat 2: RqgF7gRoKgRNW8Zoi1ty4A ($100 in chips)
Seat 3: 7H5WkGzGvsv56y1iaqHvRg ($55.95 in chips)
Seat 5: +7hFKAL0b0O/n8G72TclJA ($48 in chips)
Seat 6: YfsTQsY/fxb+YqbdclTHuw ($32.60 in chips)
YfsTQsY/fxb+YqbdclTHuw: posts small blind $0.50
lsLuWlcPA3Rh7kJVLzMh0Q: posts big blind $1
JwCcjZl0bjJzG7hmE0dnTA: sits out
*** HOLE CARDS ***
RqgF7gRoKgRNW8Zoi1ty4A: folds
7H5WkGzGvsv56y1iaqHvRg: folds
+7hFKAL0b0O/n8G72TclJA: folds
YfsTQsY/fxb+YqbdclTHuw: raises $1 to $2
lsLuWlcPA3Rh7kJVLzMh0Q: folds
YfsTQsY/fxb+YqbdclTHuw collected $2 from pot
*** SUMMARY ***
Total pot $2 | Rake $0
Seat 1: lsLuWlcPA3Rh7kJVLzMh0Q (big blind) folded before Flop
Seat 2: RqgF7gRoKgRNW8Zoi1ty4A folded before Flop (didn't bet)
Seat 3: 7H5WkGzGvsv56y1iaqHvRg folded before Flop (didn't bet)
Seat 5: +7hFKAL0b0O/n8G72TclJA (button) folded before Flop (didn't bet)
Seat 6: YfsTQsY/fxb+YqbdclTHuw (small blind) collected ($2)



PokerStars Game #59939892104:  Hold'em No Limit ($0.50/$1.00) - 2009/07/01 0:51:42 ET
Table 'U9zqzC8f3oTJ2ShXFgSSOA' 6-max Seat #6 is the button
Seat 1: iHo1oDbrEVJ8nEGdaPrICw ($109.50 in chips)
Seat 2: TSuRyAHnUPCFjP7Z0rEE0w ($100 in chips)
Seat 3: yfXek8iJ7O4CFyqXrtGcfg ($14.45 in chips)
Seat 4: 33q95we0Etwgrm6guQGncw ($83.85 in chips)
Seat 5: KfwW5us6tydK81NYTtK1gw ($296.65 in chips)
Seat 6: 4OO5v3AVduL0tePNx8wk5A ($100 in chips)
iHo1oDbrEVJ8nEGdaPrICw: posts small blind $0.50
TSuRyAHnUPCFjP7Z0rEE0w: posts big blind $1
*** HOLE CARDS ***
yfXek8iJ7O4CFyqXrtGcfg: folds
33q95we0Etwgrm6guQGncw: calls $1
KfwW5us6tydK81NYTtK1gw: folds
4OO5v3AVduL0tePNx8wk5A: folds
iHo1oDbrEVJ8nEGdaPrICw: folds
TSuRyAHnUPCFjP7Z0rEE0w: checks
*** FLOP *** [3c As 2c]
TSuRyAHnUPCFjP7Z0rEE0w: checks
33q95we0Etwgrm6guQGncw: checks
*** TURN *** [3c As 2c] [9h]
TSuRyAHnUPCFjP7Z0rEE0w: checks
33q95we0Etwgrm6guQGncw: checks
*** RIVER *** [3c As 2c 9h] [6d]
TSuRyAHnUPCFjP7Z0rEE0w: checks
33q95we0Etwgrm6guQGncw: checks
*** SHOW DOWN ***
TSuRyAHnUPCFjP7Z0rEE0w: shows [4c 8s] (high card Ace)
33q95we0Etwgrm6guQGncw: shows [Qc Kh] (high card Ace - King kicker)
33q95we0Etwgrm6guQGncw collected $2.40 from pot
*** SUMMARY ***
Total pot $2.50 | Rake $0.10
Board [3c As 2c 9h 6d]
Seat 1: iHo1oDbrEVJ8nEGdaPrICw (small blind) folded before Flop
Seat 2: TSuRyAHnUPCFjP7Z0rEE0w (big blind) showed [4c 8s] and lost with high card Ace
Seat 3: yfXek8iJ7O4CFyqXrtGcfg folded before Flop (didn't bet)
Seat 4: 33q95we0Etwgrm6guQGncw showed [Qc Kh] and won ($2.40) with high card Ace
Seat 5: KfwW5us6tydK81NYTtK1gw folded before Flop (didn't bet)
Seat 6: 4OO5v3AVduL0tePNx8wk5A (button) folded before Flop (didn't bet)



PokerStars Game #59939892512:  Hold'em No Limit ($0.50/$1.00) - 2009/07/01 0:51:42 ET
Table 'LmXQK9xy3awB+qsPzI21Mw' 2-max Seat #1 is the button
Seat 1: NYi6JFscYNrofSXy4sM+Yw ($174.05 in chips)
Seat 2: TME8GvochpQAo8cmJwWmvA ($154.45 in chips)
NYi6JFscYNrofSXy4sM+Yw: posts small blind $0.50
TME8GvochpQAo8cmJwWmvA: posts big blind $1
*** HOLE CARDS ***
NYi6JFscYNrofSXy4sM+Yw: raises $2 to $3
TME8GvochpQAo8cmJwWmvA: calls $2
*** FLOP *** [Ah 4c 4h]
TME8GvochpQAo8cmJwWmvA: checks
NYi6JFscYNrofSXy4sM+Yw: bets $2
TME8GvochpQAo8cmJwWmvA: raises $2 to $4
NYi6JFscYNrofSXy4sM+Yw: folds
TME8GvochpQAo8cmJwWmvA collected $9.55 from pot
TME8GvochpQAo8cmJwWmvA: doesn't show hand
*** SUMMARY ***
Total pot $10 | Rake $0.45
Board [Ah 4c 4h]
Seat 1: NYi6JFscYNrofSXy4sM+Yw (button) (small blind) folded on the Flop
Seat 2: TME8GvochpQAo8cmJwWmvA (big blind) collected ($9.55)



PokerStars Game #59939898202:  Hold'em No Limit ($0.50/$1.00) - 2009/07/01 0:51:51 ET
Table '/RZcOwpZpHQ+OwPwjsbnRw' 6-max Seat #3 is the button
Seat 1: Zboa6dColKGHBjLPUakZjw ($41.20 in chips)
Seat 2: +xW7QemQU0Fxs+4TnqBRow ($193 in chips)
Seat 3: XnT1yK2DD/5FL+0bwuEhqg ($46.45 in chips)
Seat 4: j7NIOHLZk7V2o9fOioO5ug ($118.35 in chips)
Seat 5: wx3sQGkVi2x9wJXuWNHPBw ($182.15 in chips)
Seat 6: XOIf9W+VAxhZqN+SYoyMKA ($293.25 in chips)
j7NIOHLZk7V2o9fOioO5ug: posts small blind $0.50
wx3sQGkVi2x9wJXuWNHPBw: posts big blind $1
*** HOLE CARDS ***
XOIf9W+VAxhZqN+SYoyMKA: folds
Zboa6dColKGHBjLPUakZjw: folds
+xW7QemQU0Fxs+4TnqBRow: raises $3 to $4
XnT1yK2DD/5FL+0bwuEhqg: folds
j7NIOHLZk7V2o9fOioO5ug: folds
wx3sQGkVi2x9wJXuWNHPBw: folds
+xW7QemQU0Fxs+4TnqBRow collected $2.50 from pot
+xW7QemQU0Fxs+4TnqBRow: doesn't show hand
*** SUMMARY ***
Total pot $2.50 | Rake $0
Seat 1: Zboa6dColKGHBjLPUakZjw folded before Flop (didn't bet)
Seat 2: +xW7QemQU0Fxs+4TnqBRow collected ($2.50)
Seat 3: XnT1yK2DD/5FL+0bwuEhqg (button) folded before Flop (didn't bet)
Seat 4: j7NIOHLZk7V2o9fOioO5ug (small blind) folded before Flop
Seat 5: wx3sQGkVi2x9wJXuWNHPBw (big blind) folded before Flop
Seat 6: XOIf9W+VAxhZqN+SYoyMKA folded before Flop (didn't bet)



PokerStars Game #59939900388:  Hold'em No Limit ($0.50/$1.00) - 2009/07/01 0:51:55 ET
Table 'pHrhryH8jPNdQfY62f8v+g' 6-max Seat #2 is the button
Seat 1: fF4botNMr8/ieVPO1YYRLw ($54.50 in chips)
Seat 2: RqgF7gRoKgRNW8Zoi1ty4A ($100.25 in chips)
Seat 3: 8oS5O7iD/qnFXFXJrGIgNQ ($103.20 in chips)
Seat 4: wenbG7TaM3H7h5kn78OFNw ($58.70 in chips)
Seat 5: r1/R7y0Ortgoz4lccgW8VA ($51.40 in chips)
Seat 6: xAU6q2/cwmby2sxmA8VcmA ($118.80 in chips)
8oS5O7iD/qnFXFXJrGIgNQ: posts small blind $0.50
wenbG7TaM3H7h5kn78OFNw: posts big blind $1
*** HOLE CARDS ***
r1/R7y0Ortgoz4lccgW8VA: folds
xAU6q2/cwmby2sxmA8VcmA: folds
fF4botNMr8/ieVPO1YYRLw: folds
RqgF7gRoKgRNW8Zoi1ty4A: folds
8oS5O7iD/qnFXFXJrGIgNQ: folds
wenbG7TaM3H7h5kn78OFNw collected $1 from pot
*** SUMMARY ***
Total pot $1 | Rake $0
Seat 1: fF4botNMr8/ieVPO1YYRLw folded before Flop (didn't bet)
Seat 2: RqgF7gRoKgRNW8Zoi1ty4A (button) folded before Flop (didn't bet)
Seat 3: 8oS5O7iD/qnFXFXJrGIgNQ (small blind) folded before Flop
Seat 4: wenbG7TaM3H7h5kn78OFNw (big blind) collected ($1)
Seat 5: r1/R7y0Ortgoz4lccgW8VA folded before Flop (didn't bet)
Seat 6: xAU6q2/cwmby2sxmA8VcmA folded before Flop (didn't bet)



PokerStars Game #59939901164:  Hold'em No Limit ($0.50/$1.00) - 2009/07/01 0:51:56 ET
Table 'uNlePsyMIqzM691Xkrlk6Q' 9-max Seat #8 is the button
Seat 1: bLbSOSmSOnqE0iTcH/5dxA ($100 in chips)
Seat 2: +OqpStnt0FqbCfyHAWaLbg ($87.60 in chips)
Seat 3: h7qXkU57Bb8ZuPwMyxR8Ug ($32.85 in chips)
Seat 4: TZcz9MEWDA+WydgGruqqbw ($101.15 in chips)
Seat 5: 3obndzTJ6fECz8+wWhMd1w ($18.50 in chips)
Seat 6: myIxN7otsyr846M539YR8Q ($18.50 in chips)
Seat 7: w6cw9nzN7AvkkHBVVjykoQ ($46.90 in chips)
Seat 8: laA8va+Yv8WuMqT1zdR91g ($101 in chips)
Seat 9: vR4IO10geOgvTW+LAUBv/A ($102.75 in chips)
vR4IO10geOgvTW+LAUBv/A: posts small blind $0.50
bLbSOSmSOnqE0iTcH/5dxA: posts big blind $1
*** HOLE CARDS ***
+OqpStnt0FqbCfyHAWaLbg: folds
h7qXkU57Bb8ZuPwMyxR8Ug: calls $1
TZcz9MEWDA+WydgGruqqbw: folds
3obndzTJ6fECz8+wWhMd1w: folds
myIxN7otsyr846M539YR8Q: folds
w6cw9nzN7AvkkHBVVjykoQ: folds
laA8va+Yv8WuMqT1zdR91g: folds
vR4IO10geOgvTW+LAUBv/A: folds
bLbSOSmSOnqE0iTcH/5dxA: checks
*** FLOP *** [Td Ac Ah]
bLbSOSmSOnqE0iTcH/5dxA: checks
h7qXkU57Bb8ZuPwMyxR8Ug: checks
*** TURN *** [Td Ac Ah] [7c]
bLbSOSmSOnqE0iTcH/5dxA: checks
h7qXkU57Bb8ZuPwMyxR8Ug: checks
*** RIVER *** [Td Ac Ah 7c] [8c]
bLbSOSmSOnqE0iTcH/5dxA: checks
h7qXkU57Bb8ZuPwMyxR8Ug: checks
*** SHOW DOWN ***
bLbSOSmSOnqE0iTcH/5dxA: shows [Jd 3d] (a pair of Aces)
h7qXkU57Bb8ZuPwMyxR8Ug: shows [Kh 9d] (a pair of Aces - King kicker)
h7qXkU57Bb8ZuPwMyxR8Ug collected $2.40 from pot
*** SUMMARY ***
Total pot $2.50 | Rake $0.10
Board [Td Ac Ah 7c 8c]
Seat 1: bLbSOSmSOnqE0iTcH/5dxA (big blind) showed [Jd 3d] and lost with a pair of Aces
Seat 2: +OqpStnt0FqbCfyHAWaLbg folded before Flop (didn't bet)
Seat 3: h7qXkU57Bb8ZuPwMyxR8Ug showed [Kh 9d] and won ($2.40) with a pair of Aces
Seat 4: TZcz9MEWDA+WydgGruqqbw folded before Flop (didn't bet)
Seat 5: 3obndzTJ6fECz8+wWhMd1w folded before Flop (didn't bet)
Seat 6: myIxN7otsyr846M539YR8Q folded before Flop (didn't bet)
Seat 7: w6cw9nzN7AvkkHBVVjykoQ folded before Flop (didn't bet)
Seat 8: laA8va+Yv8WuMqT1zdR91g (button) folded before Flop (didn't bet)
Seat 9: vR4IO10geOgvTW+LAUBv/A (small blind) folded before Flop



PokerStars Game #59939902014:  Hold'em No Limit ($0.50/$1.00) - 2009/07/01 0:51:57 ET
Table 'JOIm/fogLA7vSG0Vc6ME1A' 2-max Seat #2 is the button
Seat 1: NYi6JFscYNrofSXy4sM+Yw ($100 in chips)
Seat 2: F5lNTyZLIX9W2wQZ0plwgg ($128.80 in chips)
F5lNTyZLIX9W2wQZ0plwgg: posts small blind $0.50
NYi6JFscYNrofSXy4sM+Yw: posts big blind $1
*** HOLE CARDS ***
F5lNTyZLIX9W2wQZ0plwgg: calls $0.50
NYi6JFscYNrofSXy4sM+Yw: raises $1 to $2
F5lNTyZLIX9W2wQZ0plwgg: calls $1
*** FLOP *** [Jh 5s Tc]
NYi6JFscYNrofSXy4sM+Yw: bets $2
F5lNTyZLIX9W2wQZ0plwgg: folds
NYi6JFscYNrofSXy4sM+Yw collected $3.80 from pot
*** SUMMARY ***
Total pot $4 | Rake $0.20
Board [Jh 5s Tc]
Seat 1: NYi6JFscYNrofSXy4sM+Yw (big blind) collected ($3.80)
Seat 2: F5lNTyZLIX9W2wQZ0plwgg (button) (small blind) folded on the Flop



PokerStars Game #59939902362:  Hold'em No Limit ($0.50/$1.00) - 2009/07/01 0:51:58 ET
Table 'LmXQK9xy3awB+qsPzI21Mw' 2-max Seat #2 is the button
Seat 1: NYi6JFscYNrofSXy4sM+Yw ($169.05 in chips)
Seat 2: TME8GvochpQAo8cmJwWmvA ($159 in chips)
TME8GvochpQAo8cmJwWmvA: posts small blind $0.50
NYi6JFscYNrofSXy4sM+Yw: posts big blind $1
*** HOLE CARDS ***
TME8GvochpQAo8cmJwWmvA: calls $0.50
NYi6JFscYNrofSXy4sM+Yw: checks
*** FLOP *** [Ad 3d 2s]
NYi6JFscYNrofSXy4sM+Yw: bets $2
TME8GvochpQAo8cmJwWmvA: folds
NYi6JFscYNrofSXy4sM+Yw collected $1.90 from pot
NYi6JFscYNrofSXy4sM+Yw: doesn't show hand
*** SUMMARY ***
Total pot $2 | Rake $0.10
Board [Ad 3d 2s]
Seat 1: NYi6JFscYNrofSXy4sM+Yw (big blind) collected ($1.90)
Seat 2: TME8GvochpQAo8cmJwWmvA (button) (small blind) folded on the Flop



PokerStars Game #59939903326:  Hold'em No Limit ($0.50/$1.00) - 2009/07/01 0:51:59 ET
Table 'SQLOQoANiHscJ8AL7zffbw' 9-max Seat #7 is the button
Seat 1: jPTRd6SpCp4xqAy2XQiTOw ($113.10 in chips)
Seat 2: /zy+DB4S5fUQUSfZWFzYGw ($284.05 in chips)
Seat 3: 0eFnow7+D7veCYQ+CG9FFw ($94.85 in chips)
Seat 4: /mfensKw8/iZ1Vrx33S4xg ($20 in chips)
Seat 5: L9njYvloJ1NdXjP8edHEAg ($105.60 in chips)
Seat 6: p5UKaxVobvptF0ANhR/q1A ($173 in chips)
Seat 7: bJckevFOcg//s0qyMQI6sQ ($100 in chips)
Seat 8: 2BV+oJIQYr65IO6nEChvbA ($60 in chips)
Seat 9: qJr25HAtvv1w/7IBvjMM3g ($198.75 in chips)
2BV+oJIQYr65IO6nEChvbA: posts small blind $0.50
qJr25HAtvv1w/7IBvjMM3g: posts big blind $1
*** HOLE CARDS ***
jPTRd6SpCp4xqAy2XQiTOw: folds
/zy+DB4S5fUQUSfZWFzYGw: folds
0eFnow7+D7veCYQ+CG9FFw: folds
/mfensKw8/iZ1Vrx33S4xg: raises $2 to $3
L9njYvloJ1NdXjP8edHEAg: folds
p5UKaxVobvptF0ANhR/q1A: folds
bJckevFOcg//s0qyMQI6sQ: folds
2BV+oJIQYr65IO6nEChvbA: folds
qJr25HAtvv1w/7IBvjMM3g: folds
/mfensKw8/iZ1Vrx33S4xg collected $2.50 from pot
*** SUMMARY ***
Total pot $2.50 | Rake $0
Seat 1: jPTRd6SpCp4xqAy2XQiTOw folded before Flop (didn't bet)
Seat 2: /zy+DB4S5fUQUSfZWFzYGw folded before Flop (didn't bet)
Seat 3: 0eFnow7+D7veCYQ+CG9FFw folded before Flop (didn't bet)
Seat 4: /mfensKw8/iZ1Vrx33S4xg collected ($2.50)
Seat 5: L9njYvloJ1NdXjP8edHEAg folded before Flop (didn't bet)
Seat 6: p5UKaxVobvptF0ANhR/q1A folded before Flop (didn't bet)
Seat 7: bJckevFOcg//s0qyMQI6sQ (button) folded before Flop (didn't bet)
Seat 8: 2BV+oJIQYr65IO6nEChvbA (small blind) folded before Flop
Seat 9: qJr25HAtvv1w/7IBvjMM3g (big blind) folded before Flop



PokerStars Game #59939902824:  Hold'em No Limit ($0.50/$1.00) - 2009/07/01 0:51:59 ET
Table 'cKH9c4x6u79IqCdaKKvXrw' 9-max Seat #9 is the button
Seat 1: Pp/KTcXkfZKKUHkjyaLTdg ($16 in chips)
Seat 2: 8S3JMH4TY3whgIlZmMv66w ($35.85 in chips)
Seat 3: 997ViqAtWn1FPjJqcffwcA ($158.60 in chips)
Seat 4: FL3MrLspcF23LYvC4ipBOA ($100 in chips)
Seat 5: Jjc7EHWzs4//xUAjJ0UWoA ($39.50 in chips)
Seat 6: Bsd/K5gAcLanYbGiPirRjw ($207.55 in chips)
Seat 7: 1GkkVBhlJ92guE6K5mS5Ig ($45.55 in chips)
Seat 9: 6XkTu4ahxzHnvjjc1R8YjQ ($43.10 in chips)
Pp/KTcXkfZKKUHkjyaLTdg: posts small blind $0.50
8S3JMH4TY3whgIlZmMv66w: posts big blind $1
myIxN7otsyr846M539YR8Q: sits out
*** HOLE CARDS ***
997ViqAtWn1FPjJqcffwcA: folds
FL3MrLspcF23LYvC4ipBOA: folds
Jjc7EHWzs4//xUAjJ0UWoA: folds
Bsd/K5gAcLanYbGiPirRjw: folds
1GkkVBhlJ92guE6K5mS5Ig: calls $1
6XkTu4ahxzHnvjjc1R8YjQ: folds
Pp/KTcXkfZKKUHkjyaLTdg: folds
8S3JMH4TY3whgIlZmMv66w: checks
*** FLOP *** [7c Ac Th]
8S3JMH4TY3whgIlZmMv66w: bets $3
1GkkVBhlJ92guE6K5mS5Ig: calls $3
*** TURN *** [7c Ac Th] [8h]
8S3JMH4TY3whgIlZmMv66w: bets $6
1GkkVBhlJ92guE6K5mS5Ig: calls $6
*** RIVER *** [7c Ac Th 8h] [4d]
8S3JMH4TY3whgIlZmMv66w: checks
1GkkVBhlJ92guE6K5mS5Ig: checks
*** SHOW DOWN ***
8S3JMH4TY3whgIlZmMv66w: shows [2h Ah] (a pair of Aces)
1GkkVBhlJ92guE6K5mS5Ig: mucks hand
8S3JMH4TY3whgIlZmMv66w collected $19.50 from pot
*** SUMMARY ***
Total pot $20.50 | Rake $1
Board [7c Ac Th 8h 4d]
Seat 1: Pp/KTcXkfZKKUHkjyaLTdg (small blind) folded before Flop
Seat 2: 8S3JMH4TY3whgIlZmMv66w (big blind) showed [2h Ah] and won ($19.50) with a pair of Aces
Seat 3: 997ViqAtWn1FPjJqcffwcA folded before Flop (didn't bet)
Seat 4: FL3MrLspcF23LYvC4ipBOA folded before Flop (didn't bet)
Seat 5: Jjc7EHWzs4//xUAjJ0UWoA folded before Flop (didn't bet)
Seat 6: Bsd/K5gAcLanYbGiPirRjw folded before Flop (didn't bet)
Seat 7: 1GkkVBhlJ92guE6K5mS5Ig mucked
Seat 9: 6XkTu4ahxzHnvjjc1R8YjQ (button) folded before Flop (didn't bet)



PokerStars Game #59939903952:  Hold'em No Limit ($0.50/$1.00) - 2009/07/01 0:52:00 ET
Table 'fTlPiCj0utgzC/5io+I7ew' 6-max Seat #5 is the button
Seat 1: YMJG+F++3Aj6P8dAWda5fw ($93.50 in chips)
Seat 2: Qy/UBNbD2HaA0Ogxg8Sf3w ($127.35 in chips)
Seat 3: oDiBRCaF0QVtd3kO6xZIXw ($72.25 in chips)
Seat 4: uJVSceLggtsrJya+WtmUEA ($107.50 in chips)
Seat 5: bFrTkDcWGTxyvNul7GVdYg ($250.70 in chips)
Seat 6: /P4w1pHg2zHYg/4ubJ0dPw ($60 in chips)
/P4w1pHg2zHYg/4ubJ0dPw: posts small blind $0.50
YMJG+F++3Aj6P8dAWda5fw: posts big blind $1
*** HOLE CARDS ***
Qy/UBNbD2HaA0Ogxg8Sf3w: folds
oDiBRCaF0QVtd3kO6xZIXw: folds
uJVSceLggtsrJya+WtmUEA: folds
bFrTkDcWGTxyvNul7GVdYg: folds
/P4w1pHg2zHYg/4ubJ0dPw: folds
YMJG+F++3Aj6P8dAWda5fw collected $1 from pot
*** SUMMARY ***
Total pot $1 | Rake $0
Seat 1: YMJG+F++3Aj6P8dAWda5fw (big blind) collected ($1)
Seat 2: Qy/UBNbD2HaA0Ogxg8Sf3w folded before Flop (didn't bet)
Seat 3: oDiBRCaF0QVtd3kO6xZIXw folded before Flop (didn't bet)
Seat 4: uJVSceLggtsrJya+WtmUEA folded before Flop (didn't bet)
Seat 5: bFrTkDcWGTxyvNul7GVdYg (button) folded before Flop (didn't bet)
Seat 6: /P4w1pHg2zHYg/4ubJ0dPw (small blind) folded before Flop



PokerStars Game #59939903564:  Hold'em No Limit ($0.50/$1.00) - 2009/07/01 0:52:00 ET
Table 'MUPc8FEpe/nR0BKSeReX6Q' 6-max Seat #4 is the button
Seat 1: YsLQ3BAvgQHWXMAv3Wv6Hg ($112.35 in chips)
Seat 2: xAU6q2/cwmby2sxmA8VcmA ($100 in chips)
Seat 3: wx3sQGkVi2x9wJXuWNHPBw ($216.90 in chips)
Seat 4: ZA1bp6g8IwtTxkUE4eCjDQ ($203.80 in chips)
Seat 5: UBZQqpnJZdTYYY1FTb0rLA ($105.55 in chips)
Seat 6: oxnw0GLLpFanjhGkxfRSqA ($55 in chips)
UBZQqpnJZdTYYY1FTb0rLA: posts small blind $0.50
oxnw0GLLpFanjhGkxfRSqA: posts big blind $1
*** HOLE CARDS ***
YsLQ3BAvgQHWXMAv3Wv6Hg: folds
xAU6q2/cwmby2sxmA8VcmA: folds
wx3sQGkVi2x9wJXuWNHPBw: folds
ZA1bp6g8IwtTxkUE4eCjDQ: raises $1 to $2
UBZQqpnJZdTYYY1FTb0rLA: folds
oxnw0GLLpFanjhGkxfRSqA: calls $1
*** FLOP *** [5h Qs 8s]
oxnw0GLLpFanjhGkxfRSqA: checks
ZA1bp6g8IwtTxkUE4eCjDQ: checks
*** TURN *** [5h Qs 8s] [2c]
oxnw0GLLpFanjhGkxfRSqA: checks
ZA1bp6g8IwtTxkUE4eCjDQ: bets $1
oxnw0GLLpFanjhGkxfRSqA: calls $1
*** RIVER *** [5h Qs 8s 2c] [Th]
oxnw0GLLpFanjhGkxfRSqA: checks
ZA1bp6g8IwtTxkUE4eCjDQ: checks
*** SHOW DOWN ***
oxnw0GLLpFanjhGkxfRSqA: shows [Kd 2s] (a pair of Deuces)
ZA1bp6g8IwtTxkUE4eCjDQ: mucks hand
oxnw0GLLpFanjhGkxfRSqA collected $6.20 from pot
*** SUMMARY ***
Total pot $6.50 | Rake $0.30
Board [5h Qs 8s 2c Th]
Seat 1: YsLQ3BAvgQHWXMAv3Wv6Hg folded before Flop (didn't bet)
Seat 2: xAU6q2/cwmby2sxmA8VcmA folded before Flop (didn't bet)
Seat 3: wx3sQGkVi2x9wJXuWNHPBw folded before Flop (didn't bet)
Seat 4: ZA1bp6g8IwtTxkUE4eCjDQ (button) mucked
Seat 5: UBZQqpnJZdTYYY1FTb0rLA (small blind) folded before Flop
Seat 6: oxnw0GLLpFanjhGkxfRSqA (big blind) showed [Kd 2s] and won ($6.20) with a pair of Deuces



PokerStars Game #59939905924:  Hold'em No Limit ($0.50/$1.00) - 2009/07/01 0:52:04 ET
Table 'tyUh+jyNvrceIQdKMJjQ2wZFWj23PMihdwrNWv41OG/Qeat #1 is the button
Seat 1: o8A5MUdudVKu+pAwgZOX2w ($207.80 in chips)
Seat 2: XvUbOIg94d25feWeQlOTVg ($65.90 in chips)
Seat 3: TalCiLYHCd+ffkmR3auPvA ($90.40 in chips)
Seat 4: TSuRyAHnUPCFjP7Z0rEE0w ($112.75 in chips)
Seat 5: j7NIOHLZk7V2o9fOioO5ug ($107.90 in chips)
Seat 6: YsLQ3BAvgQHWXMAv3Wv6Hg ($150.15 in chips)
XvUbOIg94d25feWeQlOTVg: posts small blind $0.50
TalCiLYHCd+ffkmR3auPvA: posts big blind $1
*** HOLE CARDS ***
TSuRyAHnUPCFjP7Z0rEE0w: folds
j7NIOHLZk7V2o9fOioO5ug: folds
YsLQ3BAvgQHWXMAv3Wv6Hg: folds
o8A5MUdudVKu+pAwgZOX2w: calls $1
XvUbOIg94d25feWeQlOTVg: calls $0.50
TalCiLYHCd+ffkmR3auPvA: checks
*** FLOP *** [Ad Jh 9s]
XvUbOIg94d25feWeQlOTVg: checks
TalCiLYHCd+ffkmR3auPvA: checks
o8A5MUdudVKu+pAwgZOX2w: checks
*** TURN *** [Ad Jh 9s] [Th]
XvUbOIg94d25feWeQlOTVg: bets $3
TalCiLYHCd+ffkmR3auPvA: calls $3
o8A5MUdudVKu+pAwgZOX2w: calls $3
*** RIVER *** [Ad Jh 9s Th] [6s]
XvUbOIg94d25feWeQlOTVg: bets $5
TalCiLYHCd+ffkmR3auPvA: folds
o8A5MUdudVKu+pAwgZOX2w: calls $5
*** SHOW DOWN ***
XvUbOIg94d25feWeQlOTVg: shows [6d Jd] (two pair, Jacks and Sixes)
o8A5MUdudVKu+pAwgZOX2w: mucks hand
XvUbOIg94d25feWeQlOTVg collected $20.95 from pot
*** SUMMARY ***
Total pot $22 | Rake $1.05
Board [Ad Jh 9s Th 6s]
Seat 1: o8A5MUdudVKu+pAwgZOX2w (button) mucked
Seat 2: XvUbOIg94d25feWeQlOTVg (small blind) showed [6d Jd] and won ($20.95) with two pair, Jacks and Sixes
Seat 3: TalCiLYHCd+ffkmR3auPvA (big blind) folded on the River
Seat 4: TSuRyAHnUPCFjP7Z0rEE0w folded before Flop (didn't bet)
Seat 5: j7NIOHLZk7V2o9fOioO5ug folded before Flop (didn't bet)
Seat 6: YsLQ3BAvgQHWXMAv3Wv6Hg folded before Flop (didn't bet)



PokerStars Game #59939905956:  Hold'em No Limit ($0.50/$1.00) - 2009/07/01 0:52:04 ET
Table 'rmZfTK+oSebeUPJNbWhdAA' 6-max Seat #4 is the button
Seat 1: xAU6q2/cwmby2sxmA8VcmA ($100 in chips)
Seat 2: z7O9PO/WEcqRouIydFhS9Q ($112.45 in chips)
Seat 4: 1/mIuXfgx1ZyVkodrmfQDw ($100 in chips)
Seat 5: 5lY8d6Cnm4HUkt/8FZSj4g ($113.50 in chips)
Seat 6: j7NIOHLZk7V2o9fOioO5ug ($135.30 in chips)
5lY8d6Cnm4HUkt/8FZSj4g: posts small blind $0.50
j7NIOHLZk7V2o9fOioO5ug: posts big blind $1
BCEV3COoKY607AzLWayfRA: sits out
*** HOLE CARDS ***
xAU6q2/cwmby2sxmA8VcmA: folds
z7O9PO/WEcqRouIydFhS9Q: raises $2 to $3
1/mIuXfgx1ZyVkodrmfQDw: folds
5lY8d6Cnm4HUkt/8FZSj4g: calls $2.50
j7NIOHLZk7V2o9fOioO5ug: folds
*** FLOP *** [3c 6s 9h]
5lY8d6Cnm4HUkt/8FZSj4g: bets $4
z7O9PO/WEcqRouIydFhS9Q: calls $4
*** TURN *** [3c 6s 9h] [7c]
5lY8d6Cnm4HUkt/8FZSj4g: bets $12
z7O9PO/WEcqRouIydFhS9Q: calls $12
*** RIVER *** [3c 6s 9h 7c] [4h]
5lY8d6Cnm4HUkt/8FZSj4g: bets $10
z7O9PO/WEcqRouIydFhS9Q: calls $10
*** SHOW DOWN ***
5lY8d6Cnm4HUkt/8FZSj4g: shows [Kd Kh] (a pair of Kings)
z7O9PO/WEcqRouIydFhS9Q: mucks hand
5lY8d6Cnm4HUkt/8FZSj4g collected $57 from pot
*** SUMMARY ***
Total pot $59 | Rake $2
Board [3c 6s 9h 7c 4h]
Seat 1: xAU6q2/cwmby2sxmA8VcmA folded before Flop (didn't bet)
Seat 2: z7O9PO/WEcqRouIydFhS9Q mucked
Seat 4: 1/mIuXfgx1ZyVkodrmfQDw (button) folded before Flop (didn't bet)
Seat 5: 5lY8d6Cnm4HUkt/8FZSj4g (small blind) showed [Kd Kh] and won ($57) with a pair of Kings
Seat 6: j7NIOHLZk7V2o9fOioO5ug (big blind) folded before Flop



PokerStars Game #59939907416:  Hold'em No Limit ($0.50/$1.00) - 2009/07/01 0:52:06 ET
Table 'vs/5jr6ciwjVQ5+Soc+u2A' 6-max Seat #3 is the button
Seat 1: /P4w1pHg2zHYg/4ubJ0dPw ($61.50 in chips)
Seat 2: XOIf9W+VAxhZqN+SYoyMKA ($122.35 in chips)
Seat 3: G5ZSSN6RSON3gkNvk/SmYg ($148.50 in chips)
Seat 4: wk6Ohn4GDozoOMHc4eb2rw ($41.50 in chips)
Seat 5: 2DwLxMUbmzvwY7o4/i47Xg ($38 in chips)
Seat 6: qAdBJlVNsNTwiHia50eMvg ($81.50 in chips)
wk6Ohn4GDozoOMHc4eb2rw: posts small blind $0.50
2DwLxMUbmzvwY7o4/i47Xg: posts big blind $1
*** HOLE CARDS ***
qAdBJlVNsNTwiHia50eMvg: calls $1
/P4w1pHg2zHYg/4ubJ0dPw: folds
XOIf9W+VAxhZqN+SYoyMKA: folds
G5ZSSN6RSON3gkNvk/SmYg: calls $1
wk6Ohn4GDozoOMHc4eb2rw: raises $2 to $3
2DwLxMUbmzvwY7o4/i47Xg: calls $2
qAdBJlVNsNTwiHia50eMvg: calls $2
G5ZSSN6RSON3gkNvk/SmYg: calls $2
*** FLOP *** [Qd 2h 7c]
wk6Ohn4GDozoOMHc4eb2rw: bets $5
2DwLxMUbmzvwY7o4/i47Xg: folds
qAdBJlVNsNTwiHia50eMvg: folds
G5ZSSN6RSON3gkNvk/SmYg: calls $5
*** TURN *** [Qd 2h 7c] [4c]
wk6Ohn4GDozoOMHc4eb2rw: bets $10
G5ZSSN6RSON3gkNvk/SmYg: folds
wk6Ohn4GDozoOMHc4eb2rw collected $20.95 from pot
wk6Ohn4GDozoOMHc4eb2rw: doesn't show hand
*** SUMMARY ***
Total pot $22 | Rake $1.05
Board [Qd 2h 7c 4c]
Seat 1: /P4w1pHg2zHYg/4ubJ0dPw folded before Flop (didn't bet)
Seat 2: XOIf9W+VAxhZqN+SYoyMKA folded before Flop (didn't bet)
Seat 3: G5ZSSN6RSON3gkNvk/SmYg (button) folded on the Turn
Seat 4: wk6Ohn4GDozoOMHc4eb2rw (small blind) collected ($20.95)
Seat 5: 2DwLxMUbmzvwY7o4/i47Xg (big blind) folded on the Flop
Seat 6: qAdBJlVNsNTwiHia50eMvg folded on the Flop



PokerStars Game #59939907964:  Hold'em No Limit ($0.50/$1.00) - 2009/07/01 0:52:07 ET
Table 'tJq9SfN1ywY0r03VBlWlwQ' 9-max Seat #5 is the button
Seat 1: wZsU+w9r7G66x93UuvBf1Q ($340.80 in chips)
Seat 2: RqkO8O/Y3qlc3PIuCAHjVg ($74.40 in chips)
Seat 3: FVs16t7GgfWgQWt4JxsObQ ($33.95 in chips)
Seat 4: bLbSOSmSOnqE0iTcH/5dxA ($110.20 in chips)
Seat 5: Ogn4JDV3mp4ZDKO49IFzKA ($18.40 in chips)
Seat 6: gUUvmqdVlmvpal6B8nYrmg ($121.05 in chips)
Seat 7: qVhRZ0PLZ95XRJHWAjXjOQ ($128.20 in chips)
Seat 8: G4DEhsZFmznGNVpy2SEocA ($23.50 in chips)
Seat 9: XE5QF1y74bpHog9JxWJMWQ ($100 in chips)
gUUvmqdVlmvpal6B8nYrmg: posts small blind $0.50
qVhRZ0PLZ95XRJHWAjXjOQ: posts big blind $1
*** HOLE CARDS ***
G4DEhsZFmznGNVpy2SEocA: folds
XE5QF1y74bpHog9JxWJMWQ: folds
wZsU+w9r7G66x93UuvBf1Q: folds
RqkO8O/Y3qlc3PIuCAHjVg: folds
FVs16t7GgfWgQWt4JxsObQ: folds
bLbSOSmSOnqE0iTcH/5dxA: folds
Ogn4JDV3mp4ZDKO49IFzKA: calls $1
gUUvmqdVlmvpal6B8nYrmg: calls $0.50
qVhRZ0PLZ95XRJHWAjXjOQ: checks
*** FLOP *** [3h Ac Kc]
gUUvmqdVlmvpal6B8nYrmg: checks
qVhRZ0PLZ95XRJHWAjXjOQ: checks
Ogn4JDV3mp4ZDKO49IFzKA: bets $2
gUUvmqdVlmvpal6B8nYrmg: folds
qVhRZ0PLZ95XRJHWAjXjOQ: folds
Ogn4JDV3mp4ZDKO49IFzKA collected $2.85 from pot
*** SUMMARY ***
Total pot $3 | Rake $0.15
Board [3h Ac Kc]
Seat 1: wZsU+w9r7G66x93UuvBf1Q folded before Flop (didn't bet)
Seat 2: RqkO8O/Y3qlc3PIuCAHjVg folded before Flop (didn't bet)
Seat 3: FVs16t7GgfWgQWt4JxsObQ folded before Flop (didn't bet)
Seat 4: bLbSOSmSOnqE0iTcH/5dxA folded before Flop (didn't bet)
Seat 5: Ogn4JDV3mp4ZDKO49IFzKA (button) collected ($2.85)
Seat 6: gUUvmqdVlmvpal6B8nYrmg (small blind) folded on the Flop
Seat 7: qVhRZ0PLZ95XRJHWAjXjOQ (big blind) folded on the Flop
Seat 8: G4DEhsZFmznGNVpy2SEocA folded before Flop (didn't bet)
Seat 9: XE5QF1y74bpHog9JxWJMWQ folded before Flop (didn't bet)



PokerStars Game #59939909458:  Hold'em No Limit ($0.50/$1.00) - 2009/07/01 0:52:09 ET
Table 'LmXQK9xy3awB+qsPzI21Mw' 2-max Seat #1 is the button
Seat 1: NYi6JFscYNrofSXy4sM+Yw ($169.95 in chips)
Seat 2: TME8GvochpQAo8cmJwWmvA ($158 in chips)
NYi6JFscYNrofSXy4sM+Yw: posts small blind $0.50
TME8GvochpQAo8cmJwWmvA: posts big blind $1
*** HOLE CARDS ***
NYi6JFscYNrofSXy4sM+Yw: raises $2 to $3
TME8GvochpQAo8cmJwWmvA: folds
NYi6JFscYNrofSXy4sM+Yw collected $2 from pot
*** SUMMARY ***
Total pot $2 | Rake $0
Seat 1: NYi6JFscYNrofSXy4sM+Yw (button) (small blind) collected ($2)
Seat 2: TME8GvochpQAo8cmJwWmvA (big blind) folded before Flop



PokerStars Game #59939910070:  Hold'em No Limit ($0.50/$1.00) - 2009/07/01 0:52:10 ET
Table 'JOIm/fogLA7vSG0Vc6ME1A' 2-max Seat #1 is the button
Seat 1: NYi6JFscYNrofSXy4sM+Yw ($101.80 in chips)
Seat 2: F5lNTyZLIX9W2wQZ0plwgg ($126.80 in chips)
NYi6JFscYNrofSXy4sM+Yw: posts small blind $0.50
F5lNTyZLIX9W2wQZ0plwgg: posts big blind $1
*** HOLE CARDS ***
NYi6JFscYNrofSXy4sM+Yw: raises $2 to $3
F5lNTyZLIX9W2wQZ0plwgg: calls $2
*** FLOP *** [Tc 2s 6c]
F5lNTyZLIX9W2wQZ0plwgg: checks
NYi6JFscYNrofSXy4sM+Yw: bets $4.50
F5lNTyZLIX9W2wQZ0plwgg: folds
NYi6JFscYNrofSXy4sM+Yw collected $5.70 from pot
*** SUMMARY ***
Total pot $6 | Rake $0.30
Board [Tc 2s 6c]
Seat 1: NYi6JFscYNrofSXy4sM+Yw (button) (small blind) collected ($5.70)
Seat 2: F5lNTyZLIX9W2wQZ0plwgg (big blind) folded on the Flop



PokerStars Game #59939910032:  Hold'em No Limit ($0.50/$1.00) - 2009/07/01 0:52:10 ET
Table '+cA8mcmhaedZ7YcrDdhmeQ' 6-max Seat #6 is the button
Seat 1: lsLuWlcPA3Rh7kJVLzMh0Q ($288 in chips)
Seat 2: RqgF7gRoKgRNW8Zoi1ty4A ($100 in chips)
Seat 3: 7H5WkGzGvsv56y1iaqHvRg ($55.95 in chips)
Seat 5: +7hFKAL0b0O/n8G72TclJA ($48 in chips)
Seat 6: YfsTQsY/fxb+YqbdclTHuw ($33.60 in chips)
lsLuWlcPA3Rh7kJVLzMh0Q: posts small blind $0.50
RqgF7gRoKgRNW8Zoi1ty4A: posts big blind $1
JwCcjZl0bjJzG7hmE0dnTA: sits out
*** HOLE CARDS ***
7H5WkGzGvsv56y1iaqHvRg: calls $1
+7hFKAL0b0O/n8G72TclJA: folds
YfsTQsY/fxb+YqbdclTHuw: calls $1
lsLuWlcPA3Rh7kJVLzMh0Q: folds
RqgF7gRoKgRNW8Zoi1ty4A: checks
*** FLOP *** [Jh Ts Qc]
RqgF7gRoKgRNW8Zoi1ty4A: checks
7H5WkGzGvsv56y1iaqHvRg: checks
YfsTQsY/fxb+YqbdclTHuw: bets $3
RqgF7gRoKgRNW8Zoi1ty4A: folds
7H5WkGzGvsv56y1iaqHvRg: folds
YfsTQsY/fxb+YqbdclTHuw collected $3.35 from pot
*** SUMMARY ***
Total pot $3.50 | Rake $0.15
Board [Jh Ts Qc]
Seat 1: lsLuWlcPA3Rh7kJVLzMh0Q (small blind) folded before Flop
Seat 2: RqgF7gRoKgRNW8Zoi1ty4A (big blind) folded on the Flop
Seat 3: 7H5WkGzGvsv56y1iaqHvRg folded on the Flop
Seat 5: +7hFKAL0b0O/n8G72TclJA folded before Flop (didn't bet)
Seat 6: YfsTQsY/fxb+YqbdclTHuw (button) collected ($3.35)



PokerStars Game #59939911006:  Hold'em No Limit ($0.50/$1.00) - 2009/07/01 0:52:12 ET
Table 'VOs36P6NW+QyXeQ1B62kmA' 6-max Seat #5 is the button
Seat 1: AdLVjddOzm+sRNo1Bc3S6Q ($130.80 in chips)
Seat 2: KpnW5CcJ4Mg6MeclfKmLrw ($129.05 in chips)
Seat 3: TSuRyAHnUPCFjP7Z0rEE0w ($100 in chips)
Seat 4: w02zQzNydODiyV9THKgo9w ($30.60 in chips)
Seat 5: ozrlafxxh1HmYdA0/h+MuA ($23.80 in chips)
Seat 6: 6tvjsJrdmWg+g7FVrMnzXA ($80 in chips)
6tvjsJrdmWg+g7FVrMnzXA: posts small blind $0.50
AdLVjddOzm+sRNo1Bc3S6Q: posts big blind $1
*** HOLE CARDS ***
KpnW5CcJ4Mg6MeclfKmLrw: raises $3 to $4
TSuRyAHnUPCFjP7Z0rEE0w: folds
w02zQzNydODiyV9THKgo9w: folds
ozrlafxxh1HmYdA0/h+MuA: calls $4
6tvjsJrdmWg+g7FVrMnzXA: folds
AdLVjddOzm+sRNo1Bc3S6Q: folds
*** FLOP *** [2s Kc 5d]
KpnW5CcJ4Mg6MeclfKmLrw: bets $7
ozrlafxxh1HmYdA0/h+MuA: calls $7
*** TURN *** [2s Kc 5d] [Qc]
KpnW5CcJ4Mg6MeclfKmLrw: bets $15
ozrlafxxh1HmYdA0/h+MuA: calls $12.80 and is all-in
*** RIVER *** [2s Kc 5d Qc] [4c]
*** SHOW DOWN ***
KpnW5CcJ4Mg6MeclfKmLrw: shows [9c 9s] (a pair of Nines)
ozrlafxxh1HmYdA0/h+MuA: shows [Ks 6s] (a pair of Kings)
ozrlafxxh1HmYdA0/h+MuA collected $46.75 from pot
*** SUMMARY ***
Total pot $49.10 | Rake $2.35
Board [2s Kc 5d Qc 4c]
Seat 1: AdLVjddOzm+sRNo1Bc3S6Q (big blind) folded before Flop
Seat 2: KpnW5CcJ4Mg6MeclfKmLrw showed [9c 9s] and lost with a pair of Nines
Seat 3: TSuRyAHnUPCFjP7Z0rEE0w folded before Flop (didn't bet)
Seat 4: w02zQzNydODiyV9THKgo9w folded before Flop (didn't bet)
Seat 5: ozrlafxxh1HmYdA0/h+MuA (button) showed [Ks 6s] and won ($46.75) with a pair of Kings
Seat 6: 6tvjsJrdmWg+g7FVrMnzXA (small blind) folded before Flop



PokerStars Game #59939913600:  Hold'em No Limit ($0.50/$1.00) - 2009/07/01 0:52:16 ET
Table '/RZcOwpZpHQ+OwPwjsbnRw' 6-max Seat #4 is the button
Seat 1: Zboa6dColKGHBjLPUakZjw ($41.20 in chips)
Seat 2: +xW7QemQU0Fxs+4TnqBRow ($194.50 in chips)
Seat 3: XnT1yK2DD/5FL+0bwuEhqg ($46.45 in chips)
Seat 4: j7NIOHLZk7V2o9fOioO5ug ($117.85 in chips)
Seat 5: wx3sQGkVi2x9wJXuWNHPBw ($181.15 in chips)
Seat 6: XOIf9W+VAxhZqN+SYoyMKA ($293.25 in chips)
wx3sQGkVi2x9wJXuWNHPBw: posts small blind $0.50
XOIf9W+VAxhZqN+SYoyMKA: posts big blind $1
*** HOLE CARDS ***
Zboa6dColKGHBjLPUakZjw: folds
+xW7QemQU0Fxs+4TnqBRow: raises $3 to $4
XnT1yK2DD/5FL+0bwuEhqg: folds
j7NIOHLZk7V2o9fOioO5ug: folds
wx3sQGkVi2x9wJXuWNHPBw: folds
XOIf9W+VAxhZqN+SYoyMKA: folds
+xW7QemQU0Fxs+4TnqBRow collected $2.50 from pot
+xW7QemQU0Fxs+4TnqBRow: doesn't show hand
*** SUMMARY ***
Total pot $2.50 | Rake $0
Seat 1: Zboa6dColKGHBjLPUakZjw folded before Flop (didn't bet)
Seat 2: +xW7QemQU0Fxs+4TnqBRow collected ($2.50)
Seat 3: XnT1yK2DD/5FL+0bwuEhqg folded before Flop (didn't bet)
Seat 4: j7NIOHLZk7V2o9fOioO5ug (button) folded before Flop (didn't bet)
Seat 5: wx3sQGkVi2x9wJXuWNHPBw (small blind) folded before Flop
Seat 6: XOIf9W+VAxhZqN+SYoyMKA (big blind) folded before Flop



PokerStars Game #59939913590:  Hold'em No Limit ($0.50/$1.00) - 2009/07/01 0:52:16 ET
Table 'LmXQK9xy3awB+qsPzI21Mw' 2-max Seat #2 is the button
Seat 1: NYi6JFscYNrofSXy4sM+Yw ($170.95 in chips)
Seat 2: TME8GvochpQAo8cmJwWmvA ($157 in chips)
TME8GvochpQAo8cmJwWmvA: posts small blind $0.50
NYi6JFscYNrofSXy4sM+Yw: posts big blind $1
*** HOLE CARDS ***
TME8GvochpQAo8cmJwWmvA: raises $1 to $2
NYi6JFscYNrofSXy4sM+Yw: folds
TME8GvochpQAo8cmJwWmvA collected $2 from pot
*** SUMMARY ***
Total pot $2 | Rake $0
Seat 1: NYi6JFscYNrofSXy4sM+Yw (big blind) folded before Flop
Seat 2: TME8GvochpQAo8cmJwWmvA (button) (small blind) collected ($2)



PokerStars Game #59939915232:  Hold'em No Limit ($0.50/$1.00) - 2009/07/01 0:52:18 ET
Table '7Nl0ffnjeK44/vmeexh3MQ' 9-max Seat #5 is the button
Seat 1: s7D3Y+k4Cj4D1cXHv7oj+Q ($97.70 in chips)
Seat 2: OGgaARGdJQT4awWVNQ957w ($100 in chips)
Seat 3: vR4IO10geOgvTW+LAUBv/A ($100 in chips)
Seat 4: bLbSOSmSOnqE0iTcH/5dxA ($108.50 in chips)
Seat 5: bL+QVeDcuEdzMGAGg2XJHg ($106.75 in chips)
Seat 6: FVs16t7GgfWgQWt4JxsObQ ($23.50 in chips)
Seat 7: 997ViqAtWn1FPjJqcffwcA ($100 in chips)
Seat 8: zanka7aAZkigmZpfopXxxA ($247.35 in chips)
Seat 9: ouwUBGRKnKK9uhn1G4Lf+A ($99.50 in chips)
FVs16t7GgfWgQWt4JxsObQ: posts small blind $0.50
997ViqAtWn1FPjJqcffwcA: posts big blind $1
*** HOLE CARDS ***
zanka7aAZkigmZpfopXxxA: raises $2 to $3
ouwUBGRKnKK9uhn1G4Lf+A: folds
s7D3Y+k4Cj4D1cXHv7oj+Q: folds
OGgaARGdJQT4awWVNQ957w: folds
vR4IO10geOgvTW+LAUBv/A: folds
bLbSOSmSOnqE0iTcH/5dxA: folds
bL+QVeDcuEdzMGAGg2XJHg: folds
FVs16t7GgfWgQWt4JxsObQ: folds
997ViqAtWn1FPjJqcffwcA: folds
zanka7aAZkigmZpfopXxxA collected $2.50 from pot
zanka7aAZkigmZpfopXxxA: doesn't show hand
*** SUMMARY ***
Total pot $2.50 | Rake $0
Seat 1: s7D3Y+k4Cj4D1cXHv7oj+Q folded before Flop (didn't bet)
Seat 2: OGgaARGdJQT4awWVNQ957w folded before Flop (didn't bet)
Seat 3: vR4IO10geOgvTW+LAUBv/A folded before Flop (didn't bet)
Seat 4: bLbSOSmSOnqE0iTcH/5dxA folded before Flop (didn't bet)
Seat 5: bL+QVeDcuEdzMGAGg2XJHg (button) folded before Flop (didn't bet)
Seat 6: FVs16t7GgfWgQWt4JxsObQ (small blind) folded before Flop
Seat 7: 997ViqAtWn1FPjJqcffwcA (big blind) folded before Flop
Seat 8: zanka7aAZkigmZpfopXxxA collected ($2.50)
Seat 9: ouwUBGRKnKK9uhn1G4Lf+A folded before Flop (didn't bet)



PokerStars Game #59939915402:  Hold'em No Limit ($0.50/$1.00) - 2009/07/01 0:52:19 ET
Table 'U9zqzC8f3oTJ2ShXFgSSOA' 6-max Seat #1 is the button
Seat 1: iHo1oDbrEVJ8nEGdaPrICw ($109 in chips)
Seat 2: TSuRyAHnUPCFjP7Z0rEE0w ($100 in chips)
Seat 3: yfXek8iJ7O4CFyqXrtGcfg ($14.45 in chips)
Seat 4: 33q95we0Etwgrm6guQGncw ($85.25 in chips)
Seat 5: KfwW5us6tydK81NYTtK1gw ($296.65 in chips)
Seat 6: 4OO5v3AVduL0tePNx8wk5A ($100 in chips)
TSuRyAHnUPCFjP7Z0rEE0w: posts small blind $0.50
yfXek8iJ7O4CFyqXrtGcfg: posts big blind $1
*** HOLE CARDS ***
33q95we0Etwgrm6guQGncw: folds
KfwW5us6tydK81NYTtK1gw: folds
4OO5v3AVduL0tePNx8wk5A: folds
iHo1oDbrEVJ8nEGdaPrICw: folds
TSuRyAHnUPCFjP7Z0rEE0w: folds
yfXek8iJ7O4CFyqXrtGcfg collected $1 from pot
*** SUMMARY ***
Total pot $1 | Rake $0
Seat 1: iHo1oDbrEVJ8nEGdaPrICw (button) folded before Flop (didn't bet)
Seat 2: TSuRyAHnUPCFjP7Z0rEE0w (small blind) folded before Flop
Seat 3: yfXek8iJ7O4CFyqXrtGcfg (big blind) collected ($1)
Seat 4: 33q95we0Etwgrm6guQGncw folded before Flop (didn't bet)
Seat 5: KfwW5us6tydK81NYTtK1gw folded before Flop (didn't bet)
Seat 6: 4OO5v3AVduL0tePNx8wk5A folded before Flop (didn't bet)



PokerStars Game #59939917272:  Hold'em No Limit ($0.50/$1.00) - 2009/07/01 0:52:22 ET
Table 'JOIm/fogLA7vSG0Vc6ME1A' 2-max Seat #2 is the button
Seat 1: NYi6JFscYNrofSXy4sM+Yw ($104.50 in chips)
Seat 2: F5lNTyZLIX9W2wQZ0plwgg ($123.80 in chips)
F5lNTyZLIX9W2wQZ0plwgg: posts small blind $0.50
NYi6JFscYNrofSXy4sM+Yw: posts big blind $1
*** HOLE CARDS ***
F5lNTyZLIX9W2wQZ0plwgg: raises $1 to $2
NYi6JFscYNrofSXy4sM+Yw: raises $7 to $9
F5lNTyZLIX9W2wQZ0plwgg: folds
NYi6JFscYNrofSXy4sM+Yw collected $4 from pot
*** SUMMARY ***
Total pot $4 | Rake $0
Seat 1: NYi6JFscYNrofSXy4sM+Yw (big blind) collected ($4)
Seat 2: F5lNTyZLIX9W2wQZ0plwgg (button) (small blind) folded before Flop



PokerStars Game #59939917846:  Hold'em No Limit ($0.50/$1.00) - 2009/07/01 0:52:23 ET
Table 'LmXQK9xy3awB+qsPzI21Mw' 2-max Seat #1 is the button
Seat 1: NYi6JFscYNrofSXy4sM+Yw ($169.95 in chips)
Seat 2: TME8GvochpQAo8cmJwWmvA ($158 in chips)
NYi6JFscYNrofSXy4sM+Yw: posts small blind $0.50
TME8GvochpQAo8cmJwWmvA: posts big blind $1
*** HOLE CARDS ***
NYi6JFscYNrofSXy4sM+Yw: raises $2 to $3
TME8GvochpQAo8cmJwWmvA: folds
NYi6JFscYNrofSXy4sM+Yw collected $2 from pot
*** SUMMARY ***
Total pot $2 | Rake $0
Seat 1: NYi6JFscYNrofSXy4sM+Yw (button) (small blind) collected ($2)
Seat 2: TME8GvochpQAo8cmJwWmvA (big blind) folded before Flop



PokerStars Game #59939918964:  Hold'em No Limit ($0.50/$1.00) - 2009/07/01 0:52:24 ET
Table 'GPp0HyAuggN8oE0sUWzPpA' 9-max Seat #5 is the button
Seat 1: qJr25HAtvv1w/7IBvjMM3g ($27.50 in chips)
Seat 2: m3U8I35Pn3gxKhoS2nmYIg ($67.20 in chips)
Seat 3: CCCXsirC+bO7ginAuUUVlQ ($62.80 in chips)
Seat 4: mBRWbnUl8diyBO1qTJaNzw ($107.20 in chips)
Seat 5: 0fXz44fzDo5QmhAaJCvFfA ($17.30 in chips)
Seat 6: BK/GtNPkSx0TdUDj82id5A ($11 in chips)
Seat 7: DHdbHyysD15wCAtx+BhUjA ($100 in chips)
Seat 8: tkdBeXTJlFsZdioidNqLow ($71.20 in chips)
Seat 9: VPF+HjszMvUIpy0CHIwH3A ($23.50 in chips)
BK/GtNPkSx0TdUDj82id5A: posts small blind $0.50
DHdbHyysD15wCAtx+BhUjA: posts big blind $1
m3U8I35Pn3gxKhoS2nmYIg: posts big blind $1
*** HOLE CARDS ***
tkdBeXTJlFsZdioidNqLow: folds
VPF+HjszMvUIpy0CHIwH3A: folds
qJr25HAtvv1w/7IBvjMM3g: folds
m3U8I35Pn3gxKhoS2nmYIg: checks
CCCXsirC+bO7ginAuUUVlQ: folds
mBRWbnUl8diyBO1qTJaNzw: folds
0fXz44fzDo5QmhAaJCvFfA: calls $1
BK/GtNPkSx0TdUDj82id5A: calls $0.50
DHdbHyysD15wCAtx+BhUjA: checks
*** FLOP *** [8s 3h Ac]
BK/GtNPkSx0TdUDj82id5A: checks
DHdbHyysD15wCAtx+BhUjA: checks
m3U8I35Pn3gxKhoS2nmYIg: checks
0fXz44fzDo5QmhAaJCvFfA: checks
*** TURN *** [8s 3h Ac] [Ks]
BK/GtNPkSx0TdUDj82id5A: checks
DHdbHyysD15wCAtx+BhUjA: checks
m3U8I35Pn3gxKhoS2nmYIg: bets $1
0fXz44fzDo5QmhAaJCvFfA: raises $4 to $5
BK/GtNPkSx0TdUDj82id5A: folds
DHdbHyysD15wCAtx+BhUjA: folds
m3U8I35Pn3gxKhoS2nmYIg: calls $4
*** RIVER *** [8s 3h Ac Ks] [Qc]
m3U8I35Pn3gxKhoS2nmYIg: checks
0fXz44fzDo5QmhAaJCvFfA: bets $11.30 and is all-in
m3U8I35Pn3gxKhoS2nmYIg: folds
0fXz44fzDo5QmhAaJCvFfA collected $13.35 from pot
*** SUMMARY ***
Total pot $14 | Rake $0.65
Board [8s 3h Ac Ks Qc]
Seat 1: qJr25HAtvv1w/7IBvjMM3g folded before Flop (didn't bet)
Seat 2: m3U8I35Pn3gxKhoS2nmYIg folded on the River
Seat 3: CCCXsirC+bO7ginAuUUVlQ folded before Flop (didn't bet)
Seat 4: mBRWbnUl8diyBO1qTJaNzw folded before Flop (didn't bet)
Seat 5: 0fXz44fzDo5QmhAaJCvFfA (button) collected ($13.35)
Seat 6: BK/GtNPkSx0TdUDj82id5A (small blind) folded on the Turn
Seat 7: DHdbHyysD15wCAtx+BhUjA (big blind) folded on the Turn
Seat 8: tkdBeXTJlFsZdioidNqLow folded before Flop (didn't bet)
Seat 9: VPF+HjszMvUIpy0CHIwH3A folded before Flop (didn't bet)



PokerStars Game #59939919128:  Hold'em No Limit ($0.50/$1.00) - 2009/07/01 0:52:25 ET
Table 'fTlPiCj0utgzC/5io+I7ew' 6-max Seat #6 is the button
Seat 1: YMJG+F++3Aj6P8dAWda5fw ($94 in chips)
Seat 2: Qy/UBNbD2HaA0Ogxg8Sf3w ($127.35 in chips)
Seat 3: oDiBRCaF0QVtd3kO6xZIXw ($72.25 in chips)
Seat 4: uJVSceLggtsrJya+WtmUEA ($107.50 in chips)
Seat 5: bFrTkDcWGTxyvNul7GVdYg ($250.70 in chips)
Seat 6: /P4w1pHg2zHYg/4ubJ0dPw ($60 in chips)
YMJG+F++3Aj6P8dAWda5fw: posts small blind $0.50
Qy/UBNbD2HaA0Ogxg8Sf3w: posts big blind $1
*** HOLE CARDS ***
oDiBRCaF0QVtd3kO6xZIXw: calls $1
uJVSceLggtsrJya+WtmUEA: raises $3 to $4
bFrTkDcWGTxyvNul7GVdYg: folds
/P4w1pHg2zHYg/4ubJ0dPw: folds
YMJG+F++3Aj6P8dAWda5fw: folds
Qy/UBNbD2HaA0Ogxg8Sf3w: folds
oDiBRCaF0QVtd3kO6xZIXw: calls $3
*** FLOP *** [Js 2d 9d]
oDiBRCaF0QVtd3kO6xZIXw: bets $7
uJVSceLggtsrJya+WtmUEA: raises $11 to $18
oDiBRCaF0QVtd3kO6xZIXw: calls $11
*** TURN *** [Js 2d 9d] [6s]
oDiBRCaF0QVtd3kO6xZIXw: bets $18
uJVSceLggtsrJya+WtmUEA: raises $67.50 to $85.50 and is all-in
oDiBRCaF0QVtd3kO6xZIXw: calls $32.25 and is all-in
*** RIVER *** [Js 2d 9d 6s] [Kc]
*** SHOW DOWN ***
oDiBRCaF0QVtd3kO6xZIXw: shows [4h 9h] (a pair of Nines)
uJVSceLggtsrJya+WtmUEA: shows [As Ac] (a pair of Aces)
uJVSceLggtsrJya+WtmUEA collected $143 from pot
*** SUMMARY ***
Total pot $146 | Rake $3
Board [Js 2d 9d 6s Kc]
Seat 1: YMJG+F++3Aj6P8dAWda5fw (small blind) folded before Flop
Seat 2: Qy/UBNbD2HaA0Ogxg8Sf3w (big blind) folded before Flop
Seat 3: oDiBRCaF0QVtd3kO6xZIXw showed [4h 9h] and lost with a pair of Nines
Seat 4: uJVSceLggtsrJya+WtmUEA showed [As Ac] and won ($143) with a pair of Aces
Seat 5: bFrTkDcWGTxyvNul7GVdYg folded before Flop (didn't bet)
Seat 6: /P4w1pHg2zHYg/4ubJ0dPw (button) folded before Flop (didn't bet)



PokerStars Game #59939919940:  Hold'em No Limit ($0.50/$1.00) - 2009/07/01 0:52:26 ET
Table 'pHrhryH8jPNdQfY62f8v+g' 6-max Seat #3 is the button
Seat 1: fF4botNMr8/ieVPO1YYRLw ($54.50 in chips)
Seat 2: RqgF7gRoKgRNW8Zoi1ty4A ($100.25 in chips)
Seat 3: 8oS5O7iD/qnFXFXJrGIgNQ ($102.70 in chips)
Seat 4: wenbG7TaM3H7h5kn78OFNw ($59.20 in chips)
Seat 5: r1/R7y0Ortgoz4lccgW8VA ($51.40 in chips)
Seat 6: xAU6q2/cwmby2sxmA8VcmA ($118.80 in chips)
wenbG7TaM3H7h5kn78OFNw: posts small blind $0.50
r1/R7y0Ortgoz4lccgW8VA: posts big blind $1
*** HOLE CARDS ***
xAU6q2/cwmby2sxmA8VcmA: folds
fF4botNMr8/ieVPO1YYRLw: folds
RqgF7gRoKgRNW8Zoi1ty4A: raises $2 to $3
8oS5O7iD/qnFXFXJrGIgNQ: folds
wenbG7TaM3H7h5kn78OFNw: folds
r1/R7y0Ortgoz4lccgW8VA: folds
RqgF7gRoKgRNW8Zoi1ty4A collected $2.50 from pot
*** SUMMARY ***
Total pot $2.50 | Rake $0
Seat 1: fF4botNMr8/ieVPO1YYRLw folded before Flop (didn't bet)
Seat 2: RqgF7gRoKgRNW8Zoi1ty4A collected ($2.50)
Seat 3: 8oS5O7iD/qnFXFXJrGIgNQ (button) folded before Flop (didn't bet)
Seat 4: wenbG7TaM3H7h5kn78OFNw (small blind) folded before Flop
Seat 5: r1/R7y0Ortgoz4lccgW8VA (big blind) folded before Flop
Seat 6: xAU6q2/cwmby2sxmA8VcmA folded before Flop (didn't bet)



PokerStars Game #59939920828:  Hold'em No Limit ($0.50/$1.00) - 2009/07/01 0:52:27 ET
Table 'W/wyObTiXZm+Ckkl3YxcSw' 6-max Seat #2 is the button
Seat 1: eUBBn2R56C1IQ6Cs/vitwg ($110.75 in chips)
Seat 2: oDiBRCaF0QVtd3kO6xZIXw ($97.95 in chips)
Seat 3: ybGsYWp1MLwy1vSnP8egXg ($26.50 in chips)
Seat 4: +xW7QemQU0Fxs+4TnqBRow ($113.40 in chips)
Seat 5: BdbmJTZZ47quA9vUWwXtlw ($65.50 in chips)
Seat 6: tS9JHB1h+FQ++qu8RwRNgg ($19 in chips)
ybGsYWp1MLwy1vSnP8egXg: posts small blind $0.50
+xW7QemQU0Fxs+4TnqBRow: posts big blind $1
*** HOLE CARDS ***
BdbmJTZZ47quA9vUWwXtlw: calls $1
tS9JHB1h+FQ++qu8RwRNgg: folds
eUBBn2R56C1IQ6Cs/vitwg: folds
oDiBRCaF0QVtd3kO6xZIXw: calls $1
ybGsYWp1MLwy1vSnP8egXg: folds
+xW7QemQU0Fxs+4TnqBRow: checks
*** FLOP *** [8c Kd 5d]
+xW7QemQU0Fxs+4TnqBRow: checks
BdbmJTZZ47quA9vUWwXtlw: bets $3
oDiBRCaF0QVtd3kO6xZIXw: raises $6 to $9
+xW7QemQU0Fxs+4TnqBRow: folds
BdbmJTZZ47quA9vUWwXtlw: calls $6
*** TURN *** [8c Kd 5d] [7s]
BdbmJTZZ47quA9vUWwXtlw: checks
oDiBRCaF0QVtd3kO6xZIXw: checks
*** RIVER *** [8c Kd 5d 7s] [6s]
BdbmJTZZ47quA9vUWwXtlw: bets $9
oDiBRCaF0QVtd3kO6xZIXw: raises $9 to $18
BdbmJTZZ47quA9vUWwXtlw: calls $9
*** SHOW DOWN ***
oDiBRCaF0QVtd3kO6xZIXw: shows [5h 9h] (a straight, Five to Nine)
BdbmJTZZ47quA9vUWwXtlw: shows [Ad 9d] (a straight, Five to Nine)
BdbmJTZZ47quA9vUWwXtlw collected $27.35 from pot
oDiBRCaF0QVtd3kO6xZIXw collected $27.35 from pot
*** SUMMARY ***
Total pot $57.50 | Rake $2.80
Board [8c Kd 5d 7s 6s]
Seat 1: eUBBn2R56C1IQ6Cs/vitwg folded before Flop (didn't bet)
Seat 2: oDiBRCaF0QVtd3kO6xZIXw (button) showed [5h 9h] and won ($27.35) with a straight, Five to Nine
Seat 3: ybGsYWp1MLwy1vSnP8egXg (small blind) folded before Flop
Seat 4: +xW7QemQU0Fxs+4TnqBRow (big blind) folded on the Flop
Seat 5: BdbmJTZZ47quA9vUWwXtlw showed [Ad 9d] and won ($27.35) with a straight, Five to Nine
Seat 6: tS9JHB1h+FQ++qu8RwRNgg folded before Flop (didn't bet)



PokerStars Game #59939922572:  Hold'em No Limit ($0.50/$1.00) - 2009/07/01 0:52:30 ET
Table 'JOIm/fogLA7vSG0Vc6ME1A' 2-max Seat #1 is the button
Seat 1: NYi6JFscYNrofSXy4sM+Yw ($106.50 in chips)
Seat 2: F5lNTyZLIX9W2wQZ0plwgg ($121.80 in chips)
NYi6JFscYNrofSXy4sM+Yw: posts small blind $0.50
F5lNTyZLIX9W2wQZ0plwgg: posts big blind $1
*** HOLE CARDS ***
NYi6JFscYNrofSXy4sM+Yw: raises $2 to $3
F5lNTyZLIX9W2wQZ0plwgg: calls $2
*** FLOP *** [Qc As 7c]
F5lNTyZLIX9W2wQZ0plwgg: bets $1
NYi6JFscYNrofSXy4sM+Yw: raises $4 to $5
F5lNTyZLIX9W2wQZ0plwgg: calls $4
*** TURN *** [Qc As 7c] [6h]
F5lNTyZLIX9W2wQZ0plwgg: bets $3
NYi6JFscYNrofSXy4sM+Yw: folds
F5lNTyZLIX9W2wQZ0plwgg collected $15.50 from pot
*** SUMMARY ***
Total pot $16 | Rake $0.50
Board [Qc As 7c 6h]
Seat 1: NYi6JFscYNrofSXy4sM+Yw (button) (small blind) folded on the Turn
Seat 2: F5lNTyZLIX9W2wQZ0plwgg (big blind) collected ($15.50)



PokerStars Game #59939922200:  Hold'em No Limit ($0.50/$1.00) - 2009/07/01 0:52:30 ET
Table 'mmbQQVBTrPdE+wy+s+9VPA' 6-max Seat #5 is the button
Seat 1: JwCcjZl0bjJzG7hmE0dnTA ($100 in chips)
Seat 2: +W6OnF033KNM2xH0fGj98Q ($137.60 in chips)
Seat 3: wx3sQGkVi2x9wJXuWNHPBw ($114.15 in chips)
Seat 5: YMJG+F++3Aj6P8dAWda5fw ($99.50 in chips)
Seat 6: U2CWBTv29qdCbj8RNF2sIw ($99 in chips)
U2CWBTv29qdCbj8RNF2sIw: posts small blind $0.50
JwCcjZl0bjJzG7hmE0dnTA: posts big blind $1
*** HOLE CARDS ***
+W6OnF033KNM2xH0fGj98Q: folds
RfKnhkJN8HEAuzJpH2Ajdg leaves the table
wx3sQGkVi2x9wJXuWNHPBw: raises $3 to $4
YMJG+F++3Aj6P8dAWda5fw: folds
V3iZdcw61nXF3g5hD2RrsQ joins the table at seat #4
U2CWBTv29qdCbj8RNF2sIw: folds
JwCcjZl0bjJzG7hmE0dnTA: folds
wx3sQGkVi2x9wJXuWNHPBw collected $2.50 from pot
*** SUMMARY ***
Total pot $2.50 | Rake $0
Seat 1: JwCcjZl0bjJzG7hmE0dnTA (big blind) folded before Flop
Seat 2: +W6OnF033KNM2xH0fGj98Q folded before Flop (didn't bet)
Seat 3: wx3sQGkVi2x9wJXuWNHPBw collected ($2.50)
Seat 5: YMJG+F++3Aj6P8dAWda5fw (button) folded before Flop (didn't bet)
Seat 6: U2CWBTv29qdCbj8RNF2sIw (small blind) folded before Flop



PokerStars Game #59939922992:  Hold'em No Limit ($0.50/$1.00) - 2009/07/01 0:52:31 ET
Table 'LmXQK9xy3awB+qsPzI21Mw' 2-max Seat #2 is the button
Seat 1: NYi6JFscYNrofSXy4sM+Yw ($170.95 in chips)
Seat 2: TME8GvochpQAo8cmJwWmvA ($157 in chips)
TME8GvochpQAo8cmJwWmvA: posts small blind $0.50
NYi6JFscYNrofSXy4sM+Yw: posts big blind $1
*** HOLE CARDS ***
TME8GvochpQAo8cmJwWmvA: calls $0.50
NYi6JFscYNrofSXy4sM+Yw: raises $3 to $4
TME8GvochpQAo8cmJwWmvA: calls $3
*** FLOP *** [9h 4d 6h]
NYi6JFscYNrofSXy4sM+Yw: bets $5
TME8GvochpQAo8cmJwWmvA: folds
NYi6JFscYNrofSXy4sM+Yw collected $7.60 from pot
NYi6JFscYNrofSXy4sM+Yw: doesn't show hand
*** SUMMARY ***
Total pot $8 | Rake $0.40
Board [9h 4d 6h]
Seat 1: NYi6JFscYNrofSXy4sM+Yw (big blind) collected ($7.60)
Seat 2: TME8GvochpQAo8cmJwWmvA (button) (small blind) folded on the Flop



PokerStars Game #59939922952:  Hold'em No Limit ($0.50/$1.00) - 2009/07/01 0:52:31 ET
Table 'tLrtq7gDzxEvckNAI1OS5Q' 6-max Seat #2 is the button
Seat 1: xNKcQzD9+/iHmtJn4vYq9w ($97.05 in chips)
Seat 2: QHvTZcrKe6+maWUfVjP29Q ($102.85 in chips)
Seat 3: TPZ+m9x+lwoKpv7TMfAUWA ($216.70 in chips)
Seat 4: +uSzP8Jwnw7sKfQ4s66b7w ($48.65 in chips)
Seat 5: OGMLOcTNYZXZU81au7ztUw ($154.25 in chips)
Seat 6: XUk5GQsfNFpHvaToDZ0rZA ($168.20 in chips)
TPZ+m9x+lwoKpv7TMfAUWA: posts small blind $0.50
+uSzP8Jwnw7sKfQ4s66b7w: posts big blind $1
*** HOLE CARDS ***
OGMLOcTNYZXZU81au7ztUw: folds
XUk5GQsfNFpHvaToDZ0rZA: folds
xNKcQzD9+/iHmtJn4vYq9w: folds
QHvTZcrKe6+maWUfVjP29Q: raises $2 to $3
TPZ+m9x+lwoKpv7TMfAUWA: folds
+uSzP8Jwnw7sKfQ4s66b7w: folds
QHvTZcrKe6+maWUfVjP29Q collected $2.50 from pot
QHvTZcrKe6+maWUfVjP29Q: doesn't show hand
*** SUMMARY ***
Total pot $2.50 | Rake $0
Seat 1: xNKcQzD9+/iHmtJn4vYq9w folded before Flop (didn't bet)
Seat 2: QHvTZcrKe6+maWUfVjP29Q (button) collected ($2.50)
Seat 3: TPZ+m9x+lwoKpv7TMfAUWA (small blind) folded before Flop
Seat 4: +uSzP8Jwnw7sKfQ4s66b7w (big blind) folded before Flop
Seat 5: OGMLOcTNYZXZU81au7ztUw folded before Flop (didn't bet)
Seat 6: XUk5GQsfNFpHvaToDZ0rZA folded before Flop (didn't bet)



PokerStars Game #59939923758:  Hold'em No Limit ($0.50/$1.00) - 2009/07/01 0:52:32 ET
Table '/RZcOwpZpHQ+OwPwjsbnRw' 6-max Seat #5 is the button
Seat 1: Zboa6dColKGHBjLPUakZjw ($41.20 in chips)
Seat 2: +xW7QemQU0Fxs+4TnqBRow ($196 in chips)
Seat 3: XnT1yK2DD/5FL+0bwuEhqg ($46.45 in chips)
Seat 4: j7NIOHLZk7V2o9fOioO5ug ($117.85 in chips)
Seat 5: wx3sQGkVi2x9wJXuWNHPBw ($180.65 in chips)
Seat 6: XOIf9W+VAxhZqN+SYoyMKA ($292.25 in chips)
XOIf9W+VAxhZqN+SYoyMKA: posts small blind $0.50
Zboa6dColKGHBjLPUakZjw: posts big blind $1
*** HOLE CARDS ***
+xW7QemQU0Fxs+4TnqBRow: raises $3 to $4
XnT1yK2DD/5FL+0bwuEhqg: folds
j7NIOHLZk7V2o9fOioO5ug: calls $4
wx3sQGkVi2x9wJXuWNHPBw: folds
XOIf9W+VAxhZqN+SYoyMKA: folds
Zboa6dColKGHBjLPUakZjw: calls $3
*** FLOP *** [9d As 8s]
Zboa6dColKGHBjLPUakZjw: bets $2
+xW7QemQU0Fxs+4TnqBRow: raises $8 to $10
j7NIOHLZk7V2o9fOioO5ug: folds
Zboa6dColKGHBjLPUakZjw: folds
+xW7QemQU0Fxs+4TnqBRow collected $15.75 from pot
+xW7QemQU0Fxs+4TnqBRow: doesn't show hand
*** SUMMARY ***
Total pot $16.50 | Rake $0.75
Board [9d As 8s]
Seat 1: Zboa6dColKGHBjLPUakZjw (big blind) folded on the Flop
Seat 2: +xW7QemQU0Fxs+4TnqBRow collected ($15.75)
Seat 3: XnT1yK2DD/5FL+0bwuEhqg folded before Flop (didn't bet)
Seat 4: j7NIOHLZk7V2o9fOioO5ug folded on the Flop
Seat 5: wx3sQGkVi2x9wJXuWNHPBw (button) folded before Flop (didn't bet)
Seat 6: XOIf9W+VAxhZqN+SYoyMKA (small blind) folded before Flop



PokerStars Game #59939923560:  Hold'em No Limit ($0.50/$1.00) - 2009/07/01 0:52:32 ET
Table 'hugOjcwJvzEwZbK7tyiWuQ' 9-max Seat #2 is the button
Seat 2: r27C1nIV4NS4+qbnrgBQSw ($261 in chips)
Seat 3: jDwhY1kCdc6EkAHbT7PJMQ ($102.65 in chips)
Seat 4: UWB3oeddt/GObx2Mix2Anw ($205.75 in chips)
Seat 5: 5BRGWf+R3nt2WS3b5xX+zA ($27.20 in chips)
Seat 6: gUUvmqdVlmvpal6B8nYrmg ($103.20 in chips)
Seat 7: FL3MrLspcF23LYvC4ipBOA ($113.30 in chips)
Seat 8: /zy+DB4S5fUQUSfZWFzYGw ($100 in chips)
Seat 9: W8P9bUKCs43TO1xHm0dL6w ($88.05 in chips)
jDwhY1kCdc6EkAHbT7PJMQ: posts small blind $0.50
UWB3oeddt/GObx2Mix2Anw: posts big blind $1
*** HOLE CARDS ***
5BRGWf+R3nt2WS3b5xX+zA: raises $2 to $3
gUUvmqdVlmvpal6B8nYrmg: folds
FL3MrLspcF23LYvC4ipBOA: folds
/zy+DB4S5fUQUSfZWFzYGw: folds
W8P9bUKCs43TO1xHm0dL6w: folds
r27C1nIV4NS4+qbnrgBQSw: folds
jDwhY1kCdc6EkAHbT7PJMQ: folds
UWB3oeddt/GObx2Mix2Anw: folds
5BRGWf+R3nt2WS3b5xX+zA collected $2.50 from pot
*** SUMMARY ***
Total pot $2.50 | Rake $0
Seat 2: r27C1nIV4NS4+qbnrgBQSw (button) folded before Flop (didn't bet)
Seat 3: jDwhY1kCdc6EkAHbT7PJMQ (small blind) folded before Flop
Seat 4: UWB3oeddt/GObx2Mix2Anw (big blind) folded before Flop
Seat 5: 5BRGWf+R3nt2WS3b5xX+zA collected ($2.50)
Seat 6: gUUvmqdVlmvpal6B8nYrmg folded before Flop (didn't bet)
Seat 7: FL3MrLspcF23LYvC4ipBOA folded before Flop (didn't bet)
Seat 8: /zy+DB4S5fUQUSfZWFzYGw folded before Flop (didn't bet)
Seat 9: W8P9bUKCs43TO1xHm0dL6w folded before Flop (didn't bet)



PokerStars Game #59939925366:  Hold'em No Limit ($0.50/$1.00) - 2009/07/01 0:52:34 ET
Table 'SQLOQoANiHscJ8AL7zffbw' 9-max Seat #8 is the button
Seat 1: jPTRd6SpCp4xqAy2XQiTOw ($113.10 in chips)
Seat 2: /zy+DB4S5fUQUSfZWFzYGw ($284.05 in chips)
Seat 3: 0eFnow7+D7veCYQ+CG9FFw ($94.85 in chips)
Seat 4: /mfensKw8/iZ1Vrx33S4xg ($21.50 in chips)
Seat 5: L9njYvloJ1NdXjP8edHEAg ($105.60 in chips)
Seat 6: p5UKaxVobvptF0ANhR/q1A ($173 in chips)
Seat 7: bJckevFOcg//s0qyMQI6sQ ($100 in chips)
Seat 8: 2BV+oJIQYr65IO6nEChvbA ($60 in chips)
Seat 9: qJr25HAtvv1w/7IBvjMM3g ($197.75 in chips)
qJr25HAtvv1w/7IBvjMM3g: posts small blind $0.50
jPTRd6SpCp4xqAy2XQiTOw: posts big blind $1
*** HOLE CARDS ***
/zy+DB4S5fUQUSfZWFzYGw: raises $2 to $3
0eFnow7+D7veCYQ+CG9FFw: folds
/mfensKw8/iZ1Vrx33S4xg: folds
L9njYvloJ1NdXjP8edHEAg: folds
p5UKaxVobvptF0ANhR/q1A: folds
bJckevFOcg//s0qyMQI6sQ: folds
2BV+oJIQYr65IO6nEChvbA: folds
qJr25HAtvv1w/7IBvjMM3g: folds
jPTRd6SpCp4xqAy2XQiTOw: calls $2
*** FLOP *** [Tc Ad Qs]
jPTRd6SpCp4xqAy2XQiTOw: bets $5
/zy+DB4S5fUQUSfZWFzYGw: calls $5
*** TURN *** [Tc Ad Qs] [7s]
jPTRd6SpCp4xqAy2XQiTOw: bets $15
/zy+DB4S5fUQUSfZWFzYGw: calls $15
*** RIVER *** [Tc Ad Qs 7s] [2d]
jPTRd6SpCp4xqAy2XQiTOw: bets $20
/zy+DB4S5fUQUSfZWFzYGw: calls $20
*** SHOW DOWN ***
jPTRd6SpCp4xqAy2XQiTOw: shows [Jc 8d] (high card Ace)
/zy+DB4S5fUQUSfZWFzYGw: shows [Kc Ac] (a pair of Aces)
/zy+DB4S5fUQUSfZWFzYGw collected $83.50 from pot
*** SUMMARY ***
Total pot $86.50 | Rake $3
Board [Tc Ad Qs 7s 2d]
Seat 1: jPTRd6SpCp4xqAy2XQiTOw (big blind) showed [Jc 8d] and lost with high card Ace
Seat 2: /zy+DB4S5fUQUSfZWFzYGw showed [Kc Ac] and won ($83.50) with a pair of Aces
Seat 3: 0eFnow7+D7veCYQ+CG9FFw folded before Flop (didn't bet)
Seat 4: /mfensKw8/iZ1Vrx33S4xg folded before Flop (didn't bet)
Seat 5: L9njYvloJ1NdXjP8edHEAg folded before Flop (didn't bet)
Seat 6: p5UKaxVobvptF0ANhR/q1A folded before Flop (didn't bet)
Seat 7: bJckevFOcg//s0qyMQI6sQ folded before Flop (didn't bet)
Seat 8: 2BV+oJIQYr65IO6nEChvbA (button) folded before Flop (didn't bet)
Seat 9: qJr25HAtvv1w/7IBvjMM3g (small blind) folded before Flop



PokerStars Game #59939926894:  Hold'em No Limit ($0.50/$1.00) - 2009/07/01 0:52:37 ET
Table 'U9zqzC8f3oTJ2ShXFgSSOA' 6-max Seat #2 is the button
Seat 1: iHo1oDbrEVJ8nEGdaPrICw ($109 in chips)
Seat 2: TSuRyAHnUPCFjP7Z0rEE0w ($100 in chips)
Seat 3: yfXek8iJ7O4CFyqXrtGcfg ($14.95 in chips)
Seat 4: 33q95we0Etwgrm6guQGncw ($85.25 in chips)
Seat 5: KfwW5us6tydK81NYTtK1gw ($296.65 in chips)
Seat 6: 4OO5v3AVduL0tePNx8wk5A ($100 in chips)
yfXek8iJ7O4CFyqXrtGcfg: posts small blind $0.50
33q95we0Etwgrm6guQGncw: posts big blind $1
*** HOLE CARDS ***
KfwW5us6tydK81NYTtK1gw: raises $1 to $2
4OO5v3AVduL0tePNx8wk5A: folds
iHo1oDbrEVJ8nEGdaPrICw: folds
TSuRyAHnUPCFjP7Z0rEE0w: folds
yfXek8iJ7O4CFyqXrtGcfg: folds
33q95we0Etwgrm6guQGncw: calls $1
*** FLOP *** [3c 8s 4h]
33q95we0Etwgrm6guQGncw: checks
KfwW5us6tydK81NYTtK1gw: checks
*** TURN *** [3c 8s 4h] [2d]
33q95we0Etwgrm6guQGncw: checks
KfwW5us6tydK81NYTtK1gw: bets $3
33q95we0Etwgrm6guQGncw: folds
KfwW5us6tydK81NYTtK1gw collected $4.30 from pot
KfwW5us6tydK81NYTtK1gw: doesn't show hand
*** SUMMARY ***
Total pot $4.50 | Rake $0.20
Board [3c 8s 4h 2d]
Seat 1: iHo1oDbrEVJ8nEGdaPrICw folded before Flop (didn't bet)
Seat 2: TSuRyAHnUPCFjP7Z0rEE0w (button) folded before Flop (didn't bet)
Seat 3: yfXek8iJ7O4CFyqXrtGcfg (small blind) folded before Flop
Seat 4: 33q95we0Etwgrm6guQGncw (big blind) folded on the Turn
Seat 5: KfwW5us6tydK81NYTtK1gw collected ($4.30)
Seat 6: 4OO5v3AVduL0tePNx8wk5A folded before Flop (didn't bet)



PokerStars Game #59939928544:  Hold'em No Limit ($0.50/$1.00) - 2009/07/01 0:52:40 ET
Table '7Nl0ffnjeK44/vmeexh3MQ' 9-max Seat #6 is the button
Seat 1: s7D3Y+k4Cj4D1cXHv7oj+Q ($97.70 in chips)
Seat 2: OGgaARGdJQT4awWVNQ957w ($100 in chips)
Seat 3: vR4IO10geOgvTW+LAUBv/A ($100 in chips)
Seat 4: bLbSOSmSOnqE0iTcH/5dxA ($108.50 in chips)
Seat 5: bL+QVeDcuEdzMGAGg2XJHg ($106.75 in chips)
Seat 6: FVs16t7GgfWgQWt4JxsObQ ($23 in chips)
Seat 7: 997ViqAtWn1FPjJqcffwcA ($100 in chips)
Seat 9: ouwUBGRKnKK9uhn1G4Lf+A ($99.50 in chips)
997ViqAtWn1FPjJqcffwcA: posts small blind $0.50
zanka7aAZkigmZpfopXxxA: is sitting out
ouwUBGRKnKK9uhn1G4Lf+A: posts big blind $1
*** HOLE CARDS ***
s7D3Y+k4Cj4D1cXHv7oj+Q: folds
zanka7aAZkigmZpfopXxxA leaves the table
OGgaARGdJQT4awWVNQ957w: folds
D+W9Me7w6Hcx/WRUSKV0dw joins the table at seat #8
vR4IO10geOgvTW+LAUBv/A: raises $2 to $3
bLbSOSmSOnqE0iTcH/5dxA: raises $9 to $12
bL+QVeDcuEdzMGAGg2XJHg: folds
FVs16t7GgfWgQWt4JxsObQ: folds
997ViqAtWn1FPjJqcffwcA: folds
ouwUBGRKnKK9uhn1G4Lf+A: folds
vR4IO10geOgvTW+LAUBv/A: folds
bLbSOSmSOnqE0iTcH/5dxA collected $7.50 from pot
bLbSOSmSOnqE0iTcH/5dxA: doesn't show hand
*** SUMMARY ***
Total pot $7.50 | Rake $0
Seat 1: s7D3Y+k4Cj4D1cXHv7oj+Q folded before Flop (didn't bet)
Seat 2: OGgaARGdJQT4awWVNQ957w folded before Flop (didn't bet)
Seat 3: vR4IO10geOgvTW+LAUBv/A folded before Flop
Seat 4: bLbSOSmSOnqE0iTcH/5dxA collected ($7.50)
Seat 5: bL+QVeDcuEdzMGAGg2XJHg folded before Flop (didn't bet)
Seat 6: FVs16t7GgfWgQWt4JxsObQ (button) folded before Flop (didn't bet)
Seat 7: 997ViqAtWn1FPjJqcffwcA (small blind) folded before Flop
Seat 9: ouwUBGRKnKK9uhn1G4Lf+A (big blind) folded before Flop



PokerStars Game #59939929950:  Hold'em No Limit ($0.50/$1.00) - 2009/07/01 0:52:42 ET
Table '+cA8mcmhaedZ7YcrDdhmeQ' 6-max Seat #1 is the button
Seat 1: lsLuWlcPA3Rh7kJVLzMh0Q ($287.50 in chips)
Seat 2: RqgF7gRoKgRNW8Zoi1ty4A ($100 in chips)
Seat 3: 7H5WkGzGvsv56y1iaqHvRg ($54.95 in chips)
Seat 5: +7hFKAL0b0O/n8G72TclJA ($48 in chips)
Seat 6: YfsTQsY/fxb+YqbdclTHuw ($35.95 in chips)
RqgF7gRoKgRNW8Zoi1ty4A: posts small blind $0.50
7H5WkGzGvsv56y1iaqHvRg: posts big blind $1
JwCcjZl0bjJzG7hmE0dnTA: sits out
*** HOLE CARDS ***
+7hFKAL0b0O/n8G72TclJA: raises $2 to $3
YfsTQsY/fxb+YqbdclTHuw: folds
lsLuWlcPA3Rh7kJVLzMh0Q: folds
RqgF7gRoKgRNW8Zoi1ty4A: folds
7H5WkGzGvsv56y1iaqHvRg: folds
+7hFKAL0b0O/n8G72TclJA collected $2.50 from pot
*** SUMMARY ***
Total pot $2.50 | Rake $0
Seat 1: lsLuWlcPA3Rh7kJVLzMh0Q (button) folded before Flop (didn't bet)
Seat 2: RqgF7gRoKgRNW8Zoi1ty4A (small blind) folded before Flop
Seat 3: 7H5WkGzGvsv56y1iaqHvRg (big blind) folded before Flop
Seat 5: +7hFKAL0b0O/n8G72TclJA collected ($2.50)
Seat 6: YfsTQsY/fxb+YqbdclTHuw folded before Flop (didn't bet)



PokerStars Game #59939931616:  Hold'em No Limit ($0.50/$1.00) - 2009/07/01 0:52:44 ET
Table 'cBDNutyLBKEk9+ptwsKmTw' 6-max Seat #2 is the button
Seat 1: xAU6q2/cwmby2sxmA8VcmA ($100 in chips)
Seat 2: 5lY8d6Cnm4HUkt/8FZSj4g ($104.65 in chips)
Seat 3: G5ZSSN6RSON3gkNvk/SmYg ($103.65 in chips)
Seat 4: 3q7F5QtzC30pSrn0nl9i+A ($33.20 in chips)
Seat 5: OGMLOcTNYZXZU81au7ztUw ($158.65 in chips)
Seat 6: NqVlOSH2lp+pp/TK3vvK5g ($36 in chips)
G5ZSSN6RSON3gkNvk/SmYg: posts small blind $0.50
3q7F5QtzC30pSrn0nl9i+A: posts big blind $1
*** HOLE CARDS ***
OGMLOcTNYZXZU81au7ztUw: folds
NqVlOSH2lp+pp/TK3vvK5g: folds
xAU6q2/cwmby2sxmA8VcmA: folds
5lY8d6Cnm4HUkt/8FZSj4g: calls $1
G5ZSSN6RSON3gkNvk/SmYg: folds
3q7F5QtzC30pSrn0nl9i+A: checks
*** FLOP *** [Jh 2d 3c]
3q7F5QtzC30pSrn0nl9i+A: bets $2
5lY8d6Cnm4HUkt/8FZSj4g: folds
3q7F5QtzC30pSrn0nl9i+A collected $2.40 from pot
*** SUMMARY ***
Total pot $2.50 | Rake $0.10
Board [Jh 2d 3c]
Seat 1: xAU6q2/cwmby2sxmA8VcmA folded before Flop (didn't bet)
Seat 2: 5lY8d6Cnm4HUkt/8FZSj4g (button) folded on the Flop
Seat 3: G5ZSSN6RSON3gkNvk/SmYg (small blind) folded before Flop
Seat 4: 3q7F5QtzC30pSrn0nl9i+A (big blind) collected ($2.40)
Seat 5: OGMLOcTNYZXZU81au7ztUw folded before Flop (didn't bet)
Seat 6: NqVlOSH2lp+pp/TK3vvK5g folded before Flop (didn't bet)



PokerStars Game #59939932702:  Hold'em No Limit ($0.50/$1.00) - 2009/07/01 0:52:46 ET
Table 'eU3bWpDDg3Z+9R4m4iVmog' 6-max Seat #2 is the button
Seat 1: TSuRyAHnUPCFjP7Z0rEE0w ($191.15 in chips)
Seat 2: 8CAoOzhmB8n3nRFf3V4BTg ($74.50 in chips)
Seat 3: U6tnjwZRpTnM+YkqkCjwyQ ($187.65 in chips)
Seat 4: GDVIsbEJ/DOJsMKE4Asz0A ($92.60 in chips)
Seat 5: AdLVjddOzm+sRNo1Bc3S6Q ($120.55 in chips)
Seat 6: hpxXcmRkXXI9HE5+5/j/0Q ($106.45 in chips)
U6tnjwZRpTnM+YkqkCjwyQ: posts small blind $0.50
GDVIsbEJ/DOJsMKE4Asz0A: posts big blind $1
*** HOLE CARDS ***
AdLVjddOzm+sRNo1Bc3S6Q: raises $3 to $4
hpxXcmRkXXI9HE5+5/j/0Q: folds
TSuRyAHnUPCFjP7Z0rEE0w: folds
8CAoOzhmB8n3nRFf3V4BTg: calls $4
U6tnjwZRpTnM+YkqkCjwyQ: folds
GDVIsbEJ/DOJsMKE4Asz0A: folds
*** FLOP *** [Ks Jc Jh]
AdLVjddOzm+sRNo1Bc3S6Q: bets $6
8CAoOzhmB8n3nRFf3V4BTg: calls $6
*** TURN *** [Ks Jc Jh] [2h]
AdLVjddOzm+sRNo1Bc3S6Q: checks
8CAoOzhmB8n3nRFf3V4BTg: bets $13
AdLVjddOzm+sRNo1Bc3S6Q: folds
8CAoOzhmB8n3nRFf3V4BTg collected $20.45 from pot
8CAoOzhmB8n3nRFf3V4BTg: doesn't show hand
*** SUMMARY ***
Total pot $21.50 | Rake $1.05
Board [Ks Jc Jh 2h]
Seat 1: TSuRyAHnUPCFjP7Z0rEE0w folded before Flop (didn't bet)
Seat 2: 8CAoOzhmB8n3nRFf3V4BTg (button) collected ($20.45)
Seat 3: U6tnjwZRpTnM+YkqkCjwyQ (small blind) folded before Flop
Seat 4: GDVIsbEJ/DOJsMKE4Asz0A (big blind) folded before Flop
Seat 5: AdLVjddOzm+sRNo1Bc3S6Q folded on the Turn
Seat 6: hpxXcmRkXXI9HE5+5/j/0Q folded before Flop (didn't bet)



PokerStars Game #59939933534:  Hold'em No Limit ($0.50/$1.00) - 2009/07/01 0:52:47 ET
Table 'LmXQK9xy3awB+qsPzI21Mw' 2-max Seat #1 is the button
Seat 1: NYi6JFscYNrofSXy4sM+Yw ($174.55 in chips)
Seat 2: TME8GvochpQAo8cmJwWmvA ($153 in chips)
NYi6JFscYNrofSXy4sM+Yw: posts small blind $0.50
TME8GvochpQAo8cmJwWmvA: posts big blind $1
*** HOLE CARDS ***
NYi6JFscYNrofSXy4sM+Yw: raises $2 to $3
TME8GvochpQAo8cmJwWmvA: folds
NYi6JFscYNrofSXy4sM+Yw collected $2 from pot
NYi6JFscYNrofSXy4sM+Yw: doesn't show hand
*** SUMMARY ***
Total pot $2 | Rake $0
Seat 1: NYi6JFscYNrofSXy4sM+Yw (button) (small blind) collected ($2)
Seat 2: TME8GvochpQAo8cmJwWmvA (big blind) folded before Flop



PokerStars Game #59939933548:  Hold'em No Limit ($0.50/$1.00) - 2009/07/01 0:52:47 ET
Table '6YvsYDPNIDx2v5z3bJnwZQ' 9-max Seat #6 is the button
Seat 1: Ogn4JDV3mp4ZDKO49IFzKA ($19.70 in chips)
Seat 2: x80+i7DJL+81v3quj7KbNg ($20 in chips)
Seat 3: negfosHnGOZXSHpWDRKyBQ ($20 in chips)
Seat 4: kEr5NYB+JIG5+szcYMr6hA ($41.25 in chips)
Seat 5: mBRWbnUl8diyBO1qTJaNzw ($165.20 in chips)
Seat 6: 7RSwrjMohkYrZAhOd1uaZg ($17 in chips)
Seat 7: mae7OMTaJ/MFimNbZegCkg ($51 in chips)
Seat 8: PSFxpXgPedVZyHSu2Zhb7Q ($104.40 in chips)
Seat 9: ZgMRSHJ9EOtPeVHmdeV9kQ ($57 in chips)
mae7OMTaJ/MFimNbZegCkg: posts small blind $0.50
PSFxpXgPedVZyHSu2Zhb7Q: posts big blind $1
*** HOLE CARDS ***
ZgMRSHJ9EOtPeVHmdeV9kQ: folds
Ogn4JDV3mp4ZDKO49IFzKA: folds
x80+i7DJL+81v3quj7KbNg: folds
negfosHnGOZXSHpWDRKyBQ: folds
kEr5NYB+JIG5+szcYMr6hA: folds
mBRWbnUl8diyBO1qTJaNzw: folds
7RSwrjMohkYrZAhOd1uaZg: calls $1
mae7OMTaJ/MFimNbZegCkg: calls $0.50
PSFxpXgPedVZyHSu2Zhb7Q: checks
*** FLOP *** [Td 3c Jd]
mae7OMTaJ/MFimNbZegCkg: checks
PSFxpXgPedVZyHSu2Zhb7Q: checks
7RSwrjMohkYrZAhOd1uaZg: bets $1
mae7OMTaJ/MFimNbZegCkg: raises $2 to $3
PSFxpXgPedVZyHSu2Zhb7Q: folds
7RSwrjMohkYrZAhOd1uaZg: folds
mae7OMTaJ/MFimNbZegCkg collected $4.80 from pot
*** SUMMARY ***
Total pot $5 | Rake $0.20
Board [Td 3c Jd]
Seat 1: Ogn4JDV3mp4ZDKO49IFzKA folded before Flop (didn't bet)
Seat 2: x80+i7DJL+81v3quj7KbNg folded before Flop (didn't bet)
Seat 3: negfosHnGOZXSHpWDRKyBQ folded before Flop (didn't bet)
Seat 4: kEr5NYB+JIG5+szcYMr6hA folded before Flop (didn't bet)
Seat 5: mBRWbnUl8diyBO1qTJaNzw folded before Flop (didn't bet)
Seat 6: 7RSwrjMohkYrZAhOd1uaZg (button) folded on the Flop
Seat 7: mae7OMTaJ/MFimNbZegCkg (small blind) collected ($4.80)
Seat 8: PSFxpXgPedVZyHSu2Zhb7Q (big blind) folded on the Flop
Seat 9: ZgMRSHJ9EOtPeVHmdeV9kQ folded before Flop (didn't bet)



PokerStars Game #59939934524:  Hold'em No Limit ($0.50/$1.00) - 2009/07/01 0:52:49 ET
Table 'JOIm/fogLA7vSG0Vc6ME1A' 2-max Seat #2 is the button
Seat 1: NYi6JFscYNrofSXy4sM+Yw ($100 in chips)
Seat 2: F5lNTyZLIX9W2wQZ0plwgg ($129.30 in chips)
F5lNTyZLIX9W2wQZ0plwgg: posts small blind $0.50
NYi6JFscYNrofSXy4sM+Yw: posts big blind $1
*** HOLE CARDS ***
F5lNTyZLIX9W2wQZ0plwgg: raises $1 to $2
NYi6JFscYNrofSXy4sM+Yw: raises $7 to $9
F5lNTyZLIX9W2wQZ0plwgg: calls $7
*** FLOP *** [Th 8c 5c]
NYi6JFscYNrofSXy4sM+Yw: bets $11
F5lNTyZLIX9W2wQZ0plwgg: calls $11
*** TURN *** [Th 8c 5c] [7d]
NYi6JFscYNrofSXy4sM+Yw: checks
F5lNTyZLIX9W2wQZ0plwgg: checks
*** RIVER *** [Th 8c 5c 7d] [Jh]
NYi6JFscYNrofSXy4sM+Yw: checks
F5lNTyZLIX9W2wQZ0plwgg: bets $5
NYi6JFscYNrofSXy4sM+Yw: calls $5
*** SHOW DOWN ***
F5lNTyZLIX9W2wQZ0plwgg: shows [Jc 8h] (two pair, Jacks and Eights)
NYi6JFscYNrofSXy4sM+Yw: mucks hand
F5lNTyZLIX9W2wQZ0plwgg collected $49.50 from pot
*** SUMMARY ***
Total pot $50 | Rake $0.50
Board [Th 8c 5c 7d Jh]
Seat 1: NYi6JFscYNrofSXy4sM+Yw (big blind) mucked
Seat 2: F5lNTyZLIX9W2wQZ0plwgg (button) (small blind) showed [Jc 8h] and won ($49.50) with two pair, Jacks and Eights



PokerStars Game #59939936134:  Hold'em No Limit ($0.50/$1.00) - 2009/07/01 0:52:52 ET
Table 'uNlePsyMIqzM691Xkrlk6Q' 9-max Seat #9 is the button
Seat 1: bLbSOSmSOnqE0iTcH/5dxA ($100 in chips)
Seat 2: +OqpStnt0FqbCfyHAWaLbg ($87.60 in chips)
Seat 3: h7qXkU57Bb8ZuPwMyxR8Ug ($34.25 in chips)
Seat 4: TZcz9MEWDA+WydgGruqqbw ($101.15 in chips)
Seat 5: 3obndzTJ6fECz8+wWhMd1w ($18.50 in chips)
Seat 6: myIxN7otsyr846M539YR8Q ($18.50 in chips)
Seat 7: w6cw9nzN7AvkkHBVVjykoQ ($46.90 in chips)
Seat 8: laA8va+Yv8WuMqT1zdR91g ($101 in chips)
Seat 9: vR4IO10geOgvTW+LAUBv/A ($102.25 in chips)
bLbSOSmSOnqE0iTcH/5dxA: posts small blind $0.50
+OqpStnt0FqbCfyHAWaLbg: posts big blind $1
*** HOLE CARDS ***
h7qXkU57Bb8ZuPwMyxR8Ug: calls $1
TZcz9MEWDA+WydgGruqqbw: folds
3obndzTJ6fECz8+wWhMd1w: folds
myIxN7otsyr846M539YR8Q: folds
w6cw9nzN7AvkkHBVVjykoQ: raises $3 to $4
laA8va+Yv8WuMqT1zdR91g: folds
vR4IO10geOgvTW+LAUBv/A: calls $4
bLbSOSmSOnqE0iTcH/5dxA: folds
+OqpStnt0FqbCfyHAWaLbg: folds
h7qXkU57Bb8ZuPwMyxR8Ug: calls $3
*** FLOP *** [5c 5d 4s]
h7qXkU57Bb8ZuPwMyxR8Ug: checks
w6cw9nzN7AvkkHBVVjykoQ: bets $4
vR4IO10geOgvTW+LAUBv/A: folds
h7qXkU57Bb8ZuPwMyxR8Ug: folds
w6cw9nzN7AvkkHBVVjykoQ collected $12.85 from pot
w6cw9nzN7AvkkHBVVjykoQ: doesn't show hand
*** SUMMARY ***
Total pot $13.50 | Rake $0.65
Board [5c 5d 4s]
Seat 1: bLbSOSmSOnqE0iTcH/5dxA (small blind) folded before Flop
Seat 2: +OqpStnt0FqbCfyHAWaLbg (big blind) folded before Flop
Seat 3: h7qXkU57Bb8ZuPwMyxR8Ug folded on the Flop
Seat 4: TZcz9MEWDA+WydgGruqqbw folded before Flop (didn't bet)
Seat 5: 3obndzTJ6fECz8+wWhMd1w folded before Flop (didn't bet)
Seat 6: myIxN7otsyr846M539YR8Q folded before Flop (didn't bet)
Seat 7: w6cw9nzN7AvkkHBVVjykoQ collected ($12.85)
Seat 8: laA8va+Yv8WuMqT1zdR91g folded before Flop (didn't bet)
Seat 9: vR4IO10geOgvTW+LAUBv/A (button) folded on the Flop



PokerStars Game #59939937022:  Hold'em No Limit ($0.50/$1.00) - 2009/07/01 0:52:53 ET
Table 'pHrhryH8jPNdQfY62f8v+g' 6-max Seat #4 is the button
Seat 1: fF4botNMr8/ieVPO1YYRLw ($54.50 in chips)
Seat 2: RqgF7gRoKgRNW8Zoi1ty4A ($101.75 in chips)
Seat 3: 8oS5O7iD/qnFXFXJrGIgNQ ($102.70 in chips)
Seat 4: wenbG7TaM3H7h5kn78OFNw ($58.70 in chips)
Seat 5: r1/R7y0Ortgoz4lccgW8VA ($50.40 in chips)
Seat 6: xAU6q2/cwmby2sxmA8VcmA ($118.80 in chips)
r1/R7y0Ortgoz4lccgW8VA: posts small blind $0.50
xAU6q2/cwmby2sxmA8VcmA: posts big blind $1
*** HOLE CARDS ***
fF4botNMr8/ieVPO1YYRLw: folds
RqgF7gRoKgRNW8Zoi1ty4A: folds
8oS5O7iD/qnFXFXJrGIgNQ: folds
wenbG7TaM3H7h5kn78OFNw: folds
r1/R7y0Ortgoz4lccgW8VA: folds
xAU6q2/cwmby2sxmA8VcmA collected $1 from pot
*** SUMMARY ***
Total pot $1 | Rake $0
Seat 1: fF4botNMr8/ieVPO1YYRLw folded before Flop (didn't bet)
Seat 2: RqgF7gRoKgRNW8Zoi1ty4A folded before Flop (didn't bet)
Seat 3: 8oS5O7iD/qnFXFXJrGIgNQ folded before Flop (didn't bet)
Seat 4: wenbG7TaM3H7h5kn78OFNw (button) folded before Flop (didn't bet)
Seat 5: r1/R7y0Ortgoz4lccgW8VA (small blind) folded before Flop
Seat 6: xAU6q2/cwmby2sxmA8VcmA (big blind) collected ($1)



PokerStars Game #59939937598:  Hold'em No Limit ($0.50/$1.00) - 2009/07/01 0:52:54 ET
Table 'MUPc8FEpe/nR0BKSeReX6Q' 6-max Seat #5 is the button
Seat 1: YsLQ3BAvgQHWXMAv3Wv6Hg ($112.35 in chips)
Seat 2: xAU6q2/cwmby2sxmA8VcmA ($100 in chips)
Seat 3: wx3sQGkVi2x9wJXuWNHPBw ($216.90 in chips)
Seat 4: ZA1bp6g8IwtTxkUE4eCjDQ ($200.80 in chips)
Seat 5: UBZQqpnJZdTYYY1FTb0rLA ($105.05 in chips)
Seat 6: oxnw0GLLpFanjhGkxfRSqA ($58.20 in chips)
oxnw0GLLpFanjhGkxfRSqA: posts small blind $0.50
ZA1bp6g8IwtTxkUE4eCjDQ said, "lol"
YsLQ3BAvgQHWXMAv3Wv6Hg: posts big blind $1
*** HOLE CARDS ***
ZA1bp6g8IwtTxkUE4eCjDQ said, "be carfull"
xAU6q2/cwmby2sxmA8VcmA: folds
oxnw0GLLpFanjhGkxfRSqA said, "**** off stupid ****"
wx3sQGkVi2x9wJXuWNHPBw: raises $3 to $4
oxnw0GLLpFanjhGkxfRSqA said, "im gonna bury you goddam moron"
ZA1bp6g8IwtTxkUE4eCjDQ: folds
UBZQqpnJZdTYYY1FTb0rLA: folds
ZA1bp6g8IwtTxkUE4eCjDQ said, "ok deal"
oxnw0GLLpFanjhGkxfRSqA: folds
YsLQ3BAvgQHWXMAv3Wv6Hg: folds
wx3sQGkVi2x9wJXuWNHPBw collected $2.50 from pot
*** SUMMARY ***
Total pot $2.50 | Rake $0
Seat 1: YsLQ3BAvgQHWXMAv3Wv6Hg (big blind) folded before Flop
Seat 2: xAU6q2/cwmby2sxmA8VcmA folded before Flop (didn't bet)
Seat 3: wx3sQGkVi2x9wJXuWNHPBw collected ($2.50)
Seat 4: ZA1bp6g8IwtTxkUE4eCjDQ folded before Flop (didn't bet)
Seat 5: UBZQqpnJZdTYYY1FTb0rLA (button) folded before Flop (didn't bet)
Seat 6: oxnw0GLLpFanjhGkxfRSqA (small blind) folded before Flop



PokerStars Game #59939938216:  Hold'em No Limit ($0.50/$1.00) - 2009/07/01 0:52:55 ET
Table 'LmXQK9xy3awB+qsPzI21Mw' 2-max Seat #2 is the button
Seat 1: NYi6JFscYNrofSXy4sM+Yw ($175.55 in chips)
Seat 2: TME8GvochpQAo8cmJwWmvA ($152 in chips)
TME8GvochpQAo8cmJwWmvA: posts small blind $0.50
NYi6JFscYNrofSXy4sM+Yw: posts big blind $1
*** HOLE CARDS ***
TME8GvochpQAo8cmJwWmvA: raises $1 to $2
NYi6JFscYNrofSXy4sM+Yw: calls $1
*** FLOP *** [6s Qs 5s]
NYi6JFscYNrofSXy4sM+Yw: checks
TME8GvochpQAo8cmJwWmvA: bets $2
NYi6JFscYNrofSXy4sM+Yw: folds
TME8GvochpQAo8cmJwWmvA collected $3.80 from pot
TME8GvochpQAo8cmJwWmvA: doesn't show hand
*** SUMMARY ***
Total pot $4 | Rake $0.20
Board [6s Qs 5s]
Seat 1: NYi6JFscYNrofSXy4sM+Yw (big blind) folded on the Flop
Seat 2: TME8GvochpQAo8cmJwWmvA (button) (small blind) collected ($3.80)



PokerStars Game #59939937980:  Hold'em No Limit ($0.50/$1.00) - 2009/07/01 0:52:55 ET
Table 'VOs36P6NW+QyXeQ1B62kmA' 6-max Seat #6 is the button
Seat 1: AdLVjddOzm+sRNo1Bc3S6Q ($129.80 in chips)
Seat 3: TSuRyAHnUPCFjP7Z0rEE0w ($100 in chips)
Seat 4: w02zQzNydODiyV9THKgo9w ($30.60 in chips)
Seat 5: ozrlafxxh1HmYdA0/h+MuA ($46.75 in chips)
Seat 6: 6tvjsJrdmWg+g7FVrMnzXA ($79.50 in chips)
AdLVjddOzm+sRNo1Bc3S6Q: posts small blind $0.50
KpnW5CcJ4Mg6MeclfKmLrw: is sitting out
TSuRyAHnUPCFjP7Z0rEE0w: posts big blind $1
*** HOLE CARDS ***
KpnW5CcJ4Mg6MeclfKmLrw leaves the table
w02zQzNydODiyV9THKgo9w: folds
ozrlafxxh1HmYdA0/h+MuA: folds
6tvjsJrdmWg+g7FVrMnzXA: folds
AdLVjddOzm+sRNo1Bc3S6Q: folds
TSuRyAHnUPCFjP7Z0rEE0w collected $1 from pot
TSuRyAHnUPCFjP7Z0rEE0w: doesn't show hand
*** SUMMARY ***
Total pot $1 | Rake $0
Seat 1: AdLVjddOzm+sRNo1Bc3S6Q (small blind) folded before Flop
Seat 3: TSuRyAHnUPCFjP7Z0rEE0w (big blind) collected ($1)
Seat 4: w02zQzNydODiyV9THKgo9w folded before Flop (didn't bet)
Seat 5: ozrlafxxh1HmYdA0/h+MuA folded before Flop (didn't bet)
Seat 6: 6tvjsJrdmWg+g7FVrMnzXA (button) folded before Flop (didn't bet)



PokerStars Game #59939939796:  Hold'em No Limit ($0.50/$1.00) - 2009/07/01 0:52:57 ET
Table 'tLrtq7gDzxEvckNAI1OS5Q' 6-max Seat #3 is the button
Seat 1: xNKcQzD9+/iHmtJn4vYq9w ($97.05 in chips)
Seat 2: QHvTZcrKe6+maWUfVjP29Q ($104.35 in chips)
Seat 3: TPZ+m9x+lwoKpv7TMfAUWA ($216.20 in chips)
Seat 4: +uSzP8Jwnw7sKfQ4s66b7w ($47.65 in chips)
Seat 5: OGMLOcTNYZXZU81au7ztUw ($154.25 in chips)
Seat 6: XUk5GQsfNFpHvaToDZ0rZA ($168.20 in chips)
+uSzP8Jwnw7sKfQ4s66b7w: posts small blind $0.50
OGMLOcTNYZXZU81au7ztUw: posts big blind $1
*** HOLE CARDS ***
XUk5GQsfNFpHvaToDZ0rZA: folds
xNKcQzD9+/iHmtJn4vYq9w: folds
QHvTZcrKe6+maWUfVjP29Q: raises $2.50 to $3.50
TPZ+m9x+lwoKpv7TMfAUWA: calls $3.50
+uSzP8Jwnw7sKfQ4s66b7w: folds
OGMLOcTNYZXZU81au7ztUw: raises $10.50 to $14
QHvTZcrKe6+maWUfVjP29Q: folds
TPZ+m9x+lwoKpv7TMfAUWA: calls $10.50
*** FLOP *** [Jc 2s 8h]
OGMLOcTNYZXZU81au7ztUw: bets $21
TPZ+m9x+lwoKpv7TMfAUWA: folds
OGMLOcTNYZXZU81au7ztUw collected $30.40 from pot
OGMLOcTNYZXZU81au7ztUw: doesn't show hand
*** SUMMARY ***
Total pot $32 | Rake $1.60
Board [Jc 2s 8h]
Seat 1: xNKcQzD9+/iHmtJn4vYq9w folded before Flop (didn't bet)
Seat 2: QHvTZcrKe6+maWUfVjP29Q folded before Flop
Seat 3: TPZ+m9x+lwoKpv7TMfAUWA (button) folded on the Flop
Seat 4: +uSzP8Jwnw7sKfQ4s66b7w (small blind) folded before Flop
Seat 5: OGMLOcTNYZXZU81au7ztUw (big blind) collected ($30.40)
Seat 6: XUk5GQsfNFpHvaToDZ0rZA folded before Flop (didn't bet)



PokerStars Game #59939939608:  Hold'em No Limit ($0.50/$1.00) - 2009/07/01 0:52:57 ET
Table 'tyUh+jyNvrceIQdKMJjQ2wZFWj23PMihdwrNWv41OG/Qeat #2 is the button
Seat 1: o8A5MUdudVKu+pAwgZOX2w ($198.80 in chips)
Seat 2: XvUbOIg94d25feWeQlOTVg ($77.85 in chips)
Seat 3: TalCiLYHCd+ffkmR3auPvA ($86.40 in chips)
Seat 4: TSuRyAHnUPCFjP7Z0rEE0w ($112.75 in chips)
Seat 5: j7NIOHLZk7V2o9fOioO5ug ($107.90 in chips)
Seat 6: YsLQ3BAvgQHWXMAv3Wv6Hg ($150.15 in chips)
TalCiLYHCd+ffkmR3auPvA: posts small blind $0.50
TSuRyAHnUPCFjP7Z0rEE0w: posts big blind $1
*** HOLE CARDS ***
j7NIOHLZk7V2o9fOioO5ug: raises $2 to $3
YsLQ3BAvgQHWXMAv3Wv6Hg: folds
o8A5MUdudVKu+pAwgZOX2w: calls $3
XvUbOIg94d25feWeQlOTVg: folds
TalCiLYHCd+ffkmR3auPvA: folds
TSuRyAHnUPCFjP7Z0rEE0w: folds
*** FLOP *** [Td 8d 5h]
j7NIOHLZk7V2o9fOioO5ug: bets $6
o8A5MUdudVKu+pAwgZOX2w: folds
j7NIOHLZk7V2o9fOioO5ug collected $7.15 from pot
j7NIOHLZk7V2o9fOioO5ug: doesn't show hand
*** SUMMARY ***
Total pot $7.50 | Rake $0.35
Board [Td 8d 5h]
Seat 1: o8A5MUdudVKu+pAwgZOX2w folded on the Flop
Seat 2: XvUbOIg94d25feWeQlOTVg (button) folded before Flop (didn't bet)
Seat 3: TalCiLYHCd+ffkmR3auPvA (small blind) folded before Flop
Seat 4: TSuRyAHnUPCFjP7Z0rEE0w (big blind) folded before Flop
Seat 5: j7NIOHLZk7V2o9fOioO5ug collected ($7.15)
Seat 6: YsLQ3BAvgQHWXMAv3Wv6Hg folded before Flop (didn't bet)



PokerStars Game #59939940586:  Hold'em No Limit ($0.50/$1.00) - 2009/07/01 0:52:59 ET
Table '7O9fB8yx1u7sJveJn8w6jA' 6-max Seat #5 is the button
Seat 1: jy52+7FotjH63o5tEEVgKw ($139.35 in chips)
Seat 2: wx3sQGkVi2x9wJXuWNHPBw ($192.50 in chips)
Seat 3: hpxXcmRkXXI9HE5+5/j/0Q ($100 in chips)
Seat 4: XIZSmlGttGgSRaIU42K4Fg ($101.35 in chips)
Seat 5: BCEV3COoKY607AzLWayfRA ($100.40 in chips)
Seat 6: UBZQqpnJZdTYYY1FTb0rLA ($129.45 in chips)
UBZQqpnJZdTYYY1FTb0rLA: posts small blind $0.50
jy52+7FotjH63o5tEEVgKw: posts big blind $1
*** HOLE CARDS ***
wx3sQGkVi2x9wJXuWNHPBw: folds
hpxXcmRkXXI9HE5+5/j/0Q: folds
XIZSmlGttGgSRaIU42K4Fg: calls $1
BCEV3COoKY607AzLWayfRA: folds
UBZQqpnJZdTYYY1FTb0rLA: folds
jy52+7FotjH63o5tEEVgKw: checks
*** FLOP *** [Qs Qh 9s]
jy52+7FotjH63o5tEEVgKw: checks
XIZSmlGttGgSRaIU42K4Fg: checks
*** TURN *** [Qs Qh 9s] [Js]
jy52+7FotjH63o5tEEVgKw: checks
XIZSmlGttGgSRaIU42K4Fg: bets $2
jy52+7FotjH63o5tEEVgKw: calls $2
*** RIVER *** [Qs Qh 9s Js] [4s]
jy52+7FotjH63o5tEEVgKw: checks
XIZSmlGttGgSRaIU42K4Fg: checks
*** SHOW DOWN ***
jy52+7FotjH63o5tEEVgKw: shows [Jh 9d] (two pair, Queens and Jacks)
XIZSmlGttGgSRaIU42K4Fg: shows [7s 5s] (a flush, Queen high)
XIZSmlGttGgSRaIU42K4Fg collected $6.20 from pot
*** SUMMARY ***
Total pot $6.50 | Rake $0.30
Board [Qs Qh 9s Js 4s]
Seat 1: jy52+7FotjH63o5tEEVgKw (big blind) showed [Jh 9d] and lost with two pair, Queens and Jacks
Seat 2: wx3sQGkVi2x9wJXuWNHPBw folded before Flop (didn't bet)
Seat 3: hpxXcmRkXXI9HE5+5/j/0Q folded before Flop (didn't bet)
Seat 4: XIZSmlGttGgSRaIU42K4Fg showed [7s 5s] and won ($6.20) with a flush, Queen high
Seat 5: BCEV3COoKY607AzLWayfRA (button) folded before Flop (didn't bet)
Seat 6: UBZQqpnJZdTYYY1FTb0rLA (small blind) folded before Flop



PokerStars Game #59939941156:  Hold'em No Limit ($0.50/$1.00) - 2009/07/01 0:53:00 ET
Table '+cA8mcmhaedZ7YcrDdhmeQ' 6-max Seat #2 is the button
Seat 1: lsLuWlcPA3Rh7kJVLzMh0Q ($287.50 in chips)
Seat 2: RqgF7gRoKgRNW8Zoi1ty4A ($100 in chips)
Seat 3: 7H5WkGzGvsv56y1iaqHvRg ($53.95 in chips)
Seat 4: JwCcjZl0bjJzG7hmE0dnTA ($100 in chips)
Seat 5: +7hFKAL0b0O/n8G72TclJA ($49.50 in chips)
Seat 6: YfsTQsY/fxb+YqbdclTHuw ($35.95 in chips)
7H5WkGzGvsv56y1iaqHvRg: posts small blind $0.50
JwCcjZl0bjJzG7hmE0dnTA: posts big blind $1
*** HOLE CARDS ***
+7hFKAL0b0O/n8G72TclJA: folds
YfsTQsY/fxb+YqbdclTHuw: calls $1
lsLuWlcPA3Rh7kJVLzMh0Q: folds
RqgF7gRoKgRNW8Zoi1ty4A: raises $4 to $5
7H5WkGzGvsv56y1iaqHvRg: folds
JwCcjZl0bjJzG7hmE0dnTA: folds
YfsTQsY/fxb+YqbdclTHuw: calls $4
*** FLOP *** [Qc 9h Th]
YfsTQsY/fxb+YqbdclTHuw: checks
RqgF7gRoKgRNW8Zoi1ty4A: bets $8
YfsTQsY/fxb+YqbdclTHuw: folds
RqgF7gRoKgRNW8Zoi1ty4A collected $10.95 from pot
RqgF7gRoKgRNW8Zoi1ty4A: doesn't show hand
*** SUMMARY ***
Total pot $11.50 | Rake $0.55
Board [Qc 9h Th]
Seat 1: lsLuWlcPA3Rh7kJVLzMh0Q folded before Flop (didn't bet)
Seat 2: RqgF7gRoKgRNW8Zoi1ty4A (button) collected ($10.95)
Seat 3: 7H5WkGzGvsv56y1iaqHvRg (small blind) folded before Flop
Seat 4: JwCcjZl0bjJzG7hmE0dnTA (big blind) folded before Flop
Seat 5: +7hFKAL0b0O/n8G72TclJA folded before Flop (didn't bet)
Seat 6: YfsTQsY/fxb+YqbdclTHuw folded on the Flop



PokerStars Game #59939944852:  Hold'em No Limit ($0.50/$1.00) - 2009/07/01 0:53:06 ET
Table 'vs/5jr6ciwjVQ5+Soc+u2A' 6-max Seat #4 is the button
Seat 1: /P4w1pHg2zHYg/4ubJ0dPw ($61.50 in chips)
Seat 2: XOIf9W+VAxhZqN+SYoyMKA ($122.35 in chips)
Seat 3: G5ZSSN6RSON3gkNvk/SmYg ($140.50 in chips)
Seat 4: wk6Ohn4GDozoOMHc4eb2rw ($54.45 in chips)
Seat 5: 2DwLxMUbmzvwY7o4/i47Xg ($35 in chips)
Seat 6: qAdBJlVNsNTwiHia50eMvg ($78.50 in chips)
2DwLxMUbmzvwY7o4/i47Xg: posts small blind $0.50
qAdBJlVNsNTwiHia50eMvg: posts big blind $1
*** HOLE CARDS ***
/P4w1pHg2zHYg/4ubJ0dPw: folds
XOIf9W+VAxhZqN+SYoyMKA: folds
G5ZSSN6RSON3gkNvk/SmYg: folds
wk6Ohn4GDozoOMHc4eb2rw: folds
2DwLxMUbmzvwY7o4/i47Xg: folds
qAdBJlVNsNTwiHia50eMvg collected $1 from pot
*** SUMMARY ***
Total pot $1 | Rake $0
Seat 1: /P4w1pHg2zHYg/4ubJ0dPw folded before Flop (didn't bet)
Seat 2: XOIf9W+VAxhZqN+SYoyMKA folded before Flop (didn't bet)
Seat 3: G5ZSSN6RSON3gkNvk/SmYg folded before Flop (didn't bet)
Seat 4: wk6Ohn4GDozoOMHc4eb2rw (button) folded before Flop (didn't bet)
Seat 5: 2DwLxMUbmzvwY7o4/i47Xg (small blind) folded before Flop
Seat 6: qAdBJlVNsNTwiHia50eMvg (big blind) collected ($1)



PokerStars Game #59939945284:  Hold'em No Limit ($0.50/$1.00) - 2009/07/01 0:53:06 ET
Table 'mmbQQVBTrPdE+wy+s+9VPA' 6-max Seat #6 is the button
Seat 1: JwCcjZl0bjJzG7hmE0dnTA ($100 in chips)
Seat 2: +W6OnF033KNM2xH0fGj98Q ($137.60 in chips)
Seat 3: wx3sQGkVi2x9wJXuWNHPBw ($115.65 in chips)
Seat 5: YMJG+F++3Aj6P8dAWda5fw ($99.50 in chips)
Seat 6: U2CWBTv29qdCbj8RNF2sIw ($98.50 in chips)
JwCcjZl0bjJzG7hmE0dnTA: posts small blind $0.50
+W6OnF033KNM2xH0fGj98Q: posts big blind $1
V3iZdcw61nXF3g5hD2RrsQ: sits out
*** HOLE CARDS ***
wx3sQGkVi2x9wJXuWNHPBw: folds
YMJG+F++3Aj6P8dAWda5fw: folds
U2CWBTv29qdCbj8RNF2sIw: folds
JwCcjZl0bjJzG7hmE0dnTA: raises $2 to $3
+W6OnF033KNM2xH0fGj98Q: folds
JwCcjZl0bjJzG7hmE0dnTA collected $2 from pot
JwCcjZl0bjJzG7hmE0dnTA: doesn't show hand
*** SUMMARY ***
Total pot $2 | Rake $0
Seat 1: JwCcjZl0bjJzG7hmE0dnTA (small blind) collected ($2)
Seat 2: +W6OnF033KNM2xH0fGj98Q (big blind) folded before Flop
Seat 3: wx3sQGkVi2x9wJXuWNHPBw folded before Flop (didn't bet)
Seat 5: YMJG+F++3Aj6P8dAWda5fw folded before Flop (didn't bet)
Seat 6: U2CWBTv29qdCbj8RNF2sIw (button) folded before Flop (didn't bet)



PokerStars Game #59939946830:  Hold'em No Limit ($0.50/$1.00) - 2009/07/01 0:53:09 ET
Table 'rmZfTK+oSebeUPJNbWhdAA' 6-max Seat #5 is the button
Seat 1: xAU6q2/cwmby2sxmA8VcmA ($100 in chips)
Seat 2: z7O9PO/WEcqRouIydFhS9Q ($83.45 in chips)
Seat 4: 1/mIuXfgx1ZyVkodrmfQDw ($100 in chips)
Seat 5: 5lY8d6Cnm4HUkt/8FZSj4g ($141.50 in chips)
Seat 6: j7NIOHLZk7V2o9fOioO5ug ($134.30 in chips)
j7NIOHLZk7V2o9fOioO5ug: posts small blind $0.50
xAU6q2/cwmby2sxmA8VcmA: posts big blind $1
BCEV3COoKY607AzLWayfRA: sits out
*** HOLE CARDS ***
z7O9PO/WEcqRouIydFhS9Q: raises $2 to $3
1/mIuXfgx1ZyVkodrmfQDw: folds
5lY8d6Cnm4HUkt/8FZSj4g: folds
j7NIOHLZk7V2o9fOioO5ug: folds
xAU6q2/cwmby2sxmA8VcmA: folds
z7O9PO/WEcqRouIydFhS9Q collected $2.50 from pot
*** SUMMARY ***
Total pot $2.50 | Rake $0
Seat 1: xAU6q2/cwmby2sxmA8VcmA (big blind) folded before Flop
Seat 2: z7O9PO/WEcqRouIydFhS9Q collected ($2.50)
Seat 4: 1/mIuXfgx1ZyVkodrmfQDw folded before Flop (didn't bet)
Seat 5: 5lY8d6Cnm4HUkt/8FZSj4g (button) folded before Flop (didn't bet)
Seat 6: j7NIOHLZk7V2o9fOioO5ug (small blind) folded before Flop



PokerStars Game #59939946662:  Hold'em No Limit ($0.50/$1.00) - 2009/07/01 0:53:09 ET
Table 'VOs36P6NW+QyXeQ1B62kmA' 6-max Seat #1 is the button
Seat 1: AdLVjddOzm+sRNo1Bc3S6Q ($129.30 in chips)
Seat 3: TSuRyAHnUPCFjP7Z0rEE0w ($100.50 in chips)
Seat 4: w02zQzNydODiyV9THKgo9w ($30.60 in chips)
Seat 5: ozrlafxxh1HmYdA0/h+MuA ($46.75 in chips)
Seat 6: 6tvjsJrdmWg+g7FVrMnzXA ($79.50 in chips)
TSuRyAHnUPCFjP7Z0rEE0w: posts small blind $0.50
w02zQzNydODiyV9THKgo9w: posts big blind $1
*** HOLE CARDS ***
ozrlafxxh1HmYdA0/h+MuA: folds
2UMlbaZ8n8AbRli0Yr0mDw joins the table at seat #2
6tvjsJrdmWg+g7FVrMnzXA: folds
AdLVjddOzm+sRNo1Bc3S6Q: folds
TSuRyAHnUPCFjP7Z0rEE0w: folds
w02zQzNydODiyV9THKgo9w collected $1 from pot
w02zQzNydODiyV9THKgo9w: doesn't show hand
*** SUMMARY ***
Total pot $1 | Rake $0
Seat 1: AdLVjddOzm+sRNo1Bc3S6Q (button) folded before Flop (didn't bet)
Seat 3: TSuRyAHnUPCFjP7Z0rEE0w (small blind) folded before Flop
Seat 4: w02zQzNydODiyV9THKgo9w (big blind) collected ($1)
Seat 5: ozrlafxxh1HmYdA0/h+MuA folded before Flop (didn't bet)
Seat 6: 6tvjsJrdmWg+g7FVrMnzXA folded before Flop (didn't bet)



PokerStars Game #59939946680:  Hold'em No Limit ($0.50/$1.00) - 2009/07/01 0:53:09 ET
Table '7Nl0ffnjeK44/vmeexh3MQ' 9-max Seat #7 is the button
Seat 1: s7D3Y+k4Cj4D1cXHv7oj+Q ($97.70 in chips)
Seat 2: OGgaARGdJQT4awWVNQ957w ($100 in chips)
Seat 3: vR4IO10geOgvTW+LAUBv/A ($100 in chips)
Seat 4: bLbSOSmSOnqE0iTcH/5dxA ($113 in chips)
Seat 5: bL+QVeDcuEdzMGAGg2XJHg ($106.75 in chips)
Seat 6: FVs16t7GgfWgQWt4JxsObQ ($23 in chips)
Seat 7: 997ViqAtWn1FPjJqcffwcA ($100 in chips)
Seat 9: ouwUBGRKnKK9uhn1G4Lf+A ($98.50 in chips)
D+W9Me7w6Hcx/WRUSKV0dw will be allowed to play after the button
ouwUBGRKnKK9uhn1G4Lf+A: posts small blind $0.50
s7D3Y+k4Cj4D1cXHv7oj+Q: posts big blind $1
*** HOLE CARDS ***
OGgaARGdJQT4awWVNQ957w: folds
vR4IO10geOgvTW+LAUBv/A: folds
bLbSOSmSOnqE0iTcH/5dxA: folds
bL+QVeDcuEdzMGAGg2XJHg: folds
FVs16t7GgfWgQWt4JxsObQ: calls $1
997ViqAtWn1FPjJqcffwcA: folds
ouwUBGRKnKK9uhn1G4Lf+A: folds
s7D3Y+k4Cj4D1cXHv7oj+Q: checks
*** FLOP *** [5s 5h Ts]
s7D3Y+k4Cj4D1cXHv7oj+Q: checks
FVs16t7GgfWgQWt4JxsObQ: checks
*** TURN *** [5s 5h Ts] [Qs]
s7D3Y+k4Cj4D1cXHv7oj+Q: bets $2
FVs16t7GgfWgQWt4JxsObQ: calls $2
*** RIVER *** [5s 5h Ts Qs] [As]
s7D3Y+k4Cj4D1cXHv7oj+Q: checks
FVs16t7GgfWgQWt4JxsObQ: bets $3
s7D3Y+k4Cj4D1cXHv7oj+Q: folds
FVs16t7GgfWgQWt4JxsObQ collected $6.20 from pot
*** SUMMARY ***
Total pot $6.50 | Rake $0.30
Board [5s 5h Ts Qs As]
Seat 1: s7D3Y+k4Cj4D1cXHv7oj+Q (big blind) folded on the River
Seat 2: OGgaARGdJQT4awWVNQ957w folded before Flop (didn't bet)
Seat 3: vR4IO10geOgvTW+LAUBv/A folded before Flop (didn't bet)
Seat 4: bLbSOSmSOnqE0iTcH/5dxA folded before Flop (didn't bet)
Seat 5: bL+QVeDcuEdzMGAGg2XJHg folded before Flop (didn't bet)
Seat 6: FVs16t7GgfWgQWt4JxsObQ collected ($6.20)
Seat 7: 997ViqAtWn1FPjJqcffwcA (button) folded before Flop (didn't bet)
Seat 9: ouwUBGRKnKK9uhn1G4Lf+A (small blind) folded before Flop



PokerStars Game #59939946538:  Hold'em No Limit ($0.50/$1.00) - 2009/07/01 0:53:09 ET
Table 'LmXQK9xy3awB+qsPzI21Mw' 2-max Seat #1 is the button
Seat 1: NYi6JFscYNrofSXy4sM+Yw ($173.55 in chips)
Seat 2: TME8GvochpQAo8cmJwWmvA ($153.80 in chips)
NYi6JFscYNrofSXy4sM+Yw: posts small blind $0.50
TME8GvochpQAo8cmJwWmvA: posts big blind $1
*** HOLE CARDS ***
NYi6JFscYNrofSXy4sM+Yw: raises $2 to $3
TME8GvochpQAo8cmJwWmvA: folds
NYi6JFscYNrofSXy4sM+Yw collected $2 from pot
*** SUMMARY ***
Total pot $2 | Rake $0
Seat 1: NYi6JFscYNrofSXy4sM+Yw (button) (small blind) collected ($2)
Seat 2: TME8GvochpQAo8cmJwWmvA (big blind) folded before Flop



PokerStars Game #59939947320:  Hold'em No Limit ($0.50/$1.00) - 2009/07/01 0:53:10 ET
Table 'iSx0wTgVb4o7MyZeOe06ZA' 9-max Seat #8 is the button
Seat 1: RSlQ91LM/HQyM+SR8KWgqw ($17.95 in chips)
Seat 3: XQV7mCMbzd2Wh/l74wmbug ($104.60 in chips)
Seat 4: Ogn4JDV3mp4ZDKO49IFzKA ($46.55 in chips)
Seat 5: o1axyw4AjQ8n4ubTwlirQQ ($23.50 in chips)
Seat 6: T5/PXFS/W+LLcIXBo1G/RA ($100.15 in chips)
Seat 7: w4NnqVr/Sfoj65ux/fEUyQ ($71.50 in chips)
Seat 8: gUUvmqdVlmvpal6B8nYrmg ($100 in chips)
Seat 9: DMQXVuViR4IFzRccosBkJw ($97 in chips)
DMQXVuViR4IFzRccosBkJw: posts small blind $0.50
RSlQ91LM/HQyM+SR8KWgqw: posts big blind $1
*** HOLE CARDS ***
616jap leaves the table
myIxN7otsyr846M539YR8Q joins the table at seat #2
XQV7mCMbzd2Wh/l74wmbug: calls $1
Ogn4JDV3mp4ZDKO49IFzKA: folds
gUUvmqdVlmvpal6B8nYrmg said, "bs"
o1axyw4AjQ8n4ubTwlirQQ: folds
T5/PXFS/W+LLcIXBo1G/RA: folds
w4NnqVr/Sfoj65ux/fEUyQ: folds
gUUvmqdVlmvpal6B8nYrmg: folds
DMQXVuViR4IFzRccosBkJw: calls $0.50
RSlQ91LM/HQyM+SR8KWgqw: checks
*** FLOP *** [Kd 2h 9d]
DMQXVuViR4IFzRccosBkJw: bets $7
RSlQ91LM/HQyM+SR8KWgqw: raises $7 to $14
XQV7mCMbzd2Wh/l74wmbug: calls $14
DMQXVuViR4IFzRccosBkJw: calls $7
*** TURN *** [Kd 2h 9d] [4h]
DMQXVuViR4IFzRccosBkJw: checks
RSlQ91LM/HQyM+SR8KWgqw: checks
XQV7mCMbzd2Wh/l74wmbug: checks
*** RIVER *** [Kd 2h 9d 4h] [Kh]
DMQXVuViR4IFzRccosBkJw: checks
RSlQ91LM/HQyM+SR8KWgqw: bets $2.95 and is all-in
XQV7mCMbzd2Wh/l74wmbug: calls $2.95
DMQXVuViR4IFzRccosBkJw: calls $2.95
*** SHOW DOWN ***
RSlQ91LM/HQyM+SR8KWgqw: shows [Ks Ac] (three of a kind, Kings)
XQV7mCMbzd2Wh/l74wmbug: mucks hand
DMQXVuViR4IFzRccosBkJw: mucks hand
RSlQ91LM/HQyM+SR8KWgqw collected $51.30 from pot
*** SUMMARY ***
Total pot $53.85 | Rake $2.55
Board [Kd 2h 9d 4h Kh]
Seat 1: RSlQ91LM/HQyM+SR8KWgqw (big blind) showed [Ks Ac] and won ($51.30) with three of a kind, Kings
Seat 3: XQV7mCMbzd2Wh/l74wmbug mucked
Seat 4: Ogn4JDV3mp4ZDKO49IFzKA folded before Flop (didn't bet)
Seat 5: o1axyw4AjQ8n4ubTwlirQQ folded before Flop (didn't bet)
Seat 6: T5/PXFS/W+LLcIXBo1G/RA folded before Flop (didn't bet)
Seat 7: w4NnqVr/Sfoj65ux/fEUyQ folded before Flop (didn't bet)
Seat 8: gUUvmqdVlmvpal6B8nYrmg (button) folded before Flop (didn't bet)
Seat 9: DMQXVuViR4IFzRccosBkJw (small blind) mucked



PokerStars Game #59939948548:  Hold'em No Limit ($0.50/$1.00) - 2009/07/01 0:53:12 ET
Table 'JOIm/fogLA7vSG0Vc6ME1A' 2-max Seat #1 is the button
Seat 1: NYi6JFscYNrofSXy4sM+Yw ($100 in chips)
Seat 2: F5lNTyZLIX9W2wQZ0plwgg ($153.80 in chips)
NYi6JFscYNrofSXy4sM+Yw: posts small blind $0.50
F5lNTyZLIX9W2wQZ0plwgg: posts big blind $1
*** HOLE CARDS ***
NYi6JFscYNrofSXy4sM+Yw: raises $2 to $3
F5lNTyZLIX9W2wQZ0plwgg: folds
NYi6JFscYNrofSXy4sM+Yw collected $2 from pot
*** SUMMARY ***
Total pot $2 | Rake $0
Seat 1: NYi6JFscYNrofSXy4sM+Yw (button) (small blind) collected ($2)
Seat 2: F5lNTyZLIX9W2wQZ0plwgg (big blind) folded before Flop



PokerStars Game #59939949674:  Hold'em No Limit ($0.50/$1.00) - 2009/07/01 0:53:14 ET
Table 'pHrhryH8jPNdQfY62f8v+g' 6-max Seat #5 is the button
Seat 1: fF4botNMr8/ieVPO1YYRLw ($54.50 in chips)
Seat 2: RqgF7gRoKgRNW8Zoi1ty4A ($101.75 in chips)
Seat 3: 8oS5O7iD/qnFXFXJrGIgNQ ($102.70 in chips)
Seat 4: wenbG7TaM3H7h5kn78OFNw ($58.70 in chips)
Seat 5: r1/R7y0Ortgoz4lccgW8VA ($49.90 in chips)
Seat 6: xAU6q2/cwmby2sxmA8VcmA ($119.30 in chips)
xAU6q2/cwmby2sxmA8VcmA: posts small blind $0.50
fF4botNMr8/ieVPO1YYRLw: posts big blind $1
*** HOLE CARDS ***
RqgF7gRoKgRNW8Zoi1ty4A: folds
8oS5O7iD/qnFXFXJrGIgNQ: folds
wenbG7TaM3H7h5kn78OFNw: folds
r1/R7y0Ortgoz4lccgW8VA: folds
xAU6q2/cwmby2sxmA8VcmA: folds
fF4botNMr8/ieVPO1YYRLw collected $1 from pot
*** SUMMARY ***
Total pot $1 | Rake $0
Seat 1: fF4botNMr8/ieVPO1YYRLw (big blind) collected ($1)
Seat 2: RqgF7gRoKgRNW8Zoi1ty4A folded before Flop (didn't bet)
Seat 3: 8oS5O7iD/qnFXFXJrGIgNQ folded before Flop (didn't bet)
Seat 4: wenbG7TaM3H7h5kn78OFNw folded before Flop (didn't bet)
Seat 5: r1/R7y0Ortgoz4lccgW8VA (button) folded before Flop (didn't bet)
Seat 6: xAU6q2/cwmby2sxmA8VcmA (small blind) folded before Flop



PokerStars Game #59939950128:  Hold'em No Limit ($0.50/$1.00) - 2009/07/01 0:53:14 ET
Table '/RZcOwpZpHQ+OwPwjsbnRw' 6-max Seat #6 is the button
Seat 1: Zboa6dColKGHBjLPUakZjw ($35.20 in chips)
Seat 2: +xW7QemQU0Fxs+4TnqBRow ($205.75 in chips)
Seat 3: XnT1yK2DD/5FL+0bwuEhqg ($46.45 in chips)
Seat 4: j7NIOHLZk7V2o9fOioO5ug ($113.85 in chips)
Seat 5: wx3sQGkVi2x9wJXuWNHPBw ($180.65 in chips)
Seat 6: XOIf9W+VAxhZqN+SYoyMKA ($291.75 in chips)
Zboa6dColKGHBjLPUakZjw: posts small blind $0.50
+xW7QemQU0Fxs+4TnqBRow: posts big blind $1
*** HOLE CARDS ***
XnT1yK2DD/5FL+0bwuEhqg: folds
j7NIOHLZk7V2o9fOioO5ug: folds
wx3sQGkVi2x9wJXuWNHPBw: folds
XOIf9W+VAxhZqN+SYoyMKA: folds
Zboa6dColKGHBjLPUakZjw: calls $0.50
+xW7QemQU0Fxs+4TnqBRow: checks
*** FLOP *** [Ad 5h Kd]
Zboa6dColKGHBjLPUakZjw: checks
+xW7QemQU0Fxs+4TnqBRow: bets $2
Zboa6dColKGHBjLPUakZjw: folds
+xW7QemQU0Fxs+4TnqBRow collected $1.90 from pot
+xW7QemQU0Fxs+4TnqBRow: doesn't show hand
*** SUMMARY ***
Total pot $2 | Rake $0.10
Board [Ad 5h Kd]
Seat 1: Zboa6dColKGHBjLPUakZjw (small blind) folded on the Flop
Seat 2: +xW7QemQU0Fxs+4TnqBRow (big blind) collected ($1.90)
Seat 3: XnT1yK2DD/5FL+0bwuEhqg folded before Flop (didn't bet)
Seat 4: j7NIOHLZk7V2o9fOioO5ug folded before Flop (didn't bet)
Seat 5: wx3sQGkVi2x9wJXuWNHPBw folded before Flop (didn't bet)
Seat 6: XOIf9W+VAxhZqN+SYoyMKA (button) folded before Flop (didn't bet)



PokerStars Game #59939950604:  Hold'em No Limit ($0.50/$1.00) - 2009/07/01 0:53:15 ET
Table 'GxCPo/gd3OSthkYrAxJngg' 6-max Seat #5 is the button
Seat 1: sH8BpAFP+jGFxCgVpD1Lew ($262.75 in chips)
Seat 2: YExX2paeIHrmfIwV1ivM/w ($76.70 in chips)
Seat 3: o6plE+MSW4XFNTeONe16xg ($29.60 in chips)
Seat 4: YMJG+F++3Aj6P8dAWda5fw ($206.10 in chips)
Seat 5: G5ZSSN6RSON3gkNvk/SmYg ($106.75 in chips)
sH8BpAFP+jGFxCgVpD1Lew: posts small blind $0.50
YExX2paeIHrmfIwV1ivM/w: posts big blind $1
*** HOLE CARDS ***
o6plE+MSW4XFNTeONe16xg said, "wow"
o6plE+MSW4XFNTeONe16xg: folds
YMJG+F++3Aj6P8dAWda5fw: folds
G5ZSSN6RSON3gkNvk/SmYg: folds
sH8BpAFP+jGFxCgVpD1Lew: folds
YExX2paeIHrmfIwV1ivM/w collected $1 from pot
*** SUMMARY ***
Total pot $1 | Rake $0
Seat 1: sH8BpAFP+jGFxCgVpD1Lew (small blind) folded before Flop
Seat 2: YExX2paeIHrmfIwV1ivM/w (big blind) collected ($1)
Seat 3: o6plE+MSW4XFNTeONe16xg folded before Flop (didn't bet)
Seat 4: YMJG+F++3Aj6P8dAWda5fw folded before Flop (didn't bet)
Seat 5: G5ZSSN6RSON3gkNvk/SmYg (button) folded before Flop (didn't bet)



PokerStars Game #59939952866:  Hold'em No Limit ($0.50/$1.00) - 2009/07/01 0:53:18 ET
Table 'vs/5jr6ciwjVQ5+Soc+u2A' 6-max Seat #5 is the button
Seat 1: /P4w1pHg2zHYg/4ubJ0dPw ($61.50 in chips)
Seat 2: XOIf9W+VAxhZqN+SYoyMKA ($122.35 in chips)
Seat 3: G5ZSSN6RSON3gkNvk/SmYg ($140.50 in chips)
Seat 4: wk6Ohn4GDozoOMHc4eb2rw ($54.45 in chips)
Seat 5: 2DwLxMUbmzvwY7o4/i47Xg ($34.50 in chips)
Seat 6: qAdBJlVNsNTwiHia50eMvg ($79 in chips)
qAdBJlVNsNTwiHia50eMvg: posts small blind $0.50
/P4w1pHg2zHYg/4ubJ0dPw: posts big blind $1
*** HOLE CARDS ***
XOIf9W+VAxhZqN+SYoyMKA: raises $2 to $3
G5ZSSN6RSON3gkNvk/SmYg: folds
wk6Ohn4GDozoOMHc4eb2rw: folds
2DwLxMUbmzvwY7o4/i47Xg: calls $3
qAdBJlVNsNTwiHia50eMvg: calls $2.50
/P4w1pHg2zHYg/4ubJ0dPw: folds
*** FLOP *** [Qh 4s Jh]
qAdBJlVNsNTwiHia50eMvg: checks
XOIf9W+VAxhZqN+SYoyMKA: checks
2DwLxMUbmzvwY7o4/i47Xg: checks
*** TURN *** [Qh 4s Jh] [Qc]
qAdBJlVNsNTwiHia50eMvg: checks
XOIf9W+VAxhZqN+SYoyMKA: checks
2DwLxMUbmzvwY7o4/i47Xg: checks
*** RIVER *** [Qh 4s Jh Qc] [7c]
qAdBJlVNsNTwiHia50eMvg: checks
XOIf9W+VAxhZqN+SYoyMKA: checks
2DwLxMUbmzvwY7o4/i47Xg: checks
*** SHOW DOWN ***
qAdBJlVNsNTwiHia50eMvg: shows [Jd Jc] (a full house, Jacks full of Queens)
XOIf9W+VAxhZqN+SYoyMKA: mucks hand
2DwLxMUbmzvwY7o4/i47Xg: mucks hand
qAdBJlVNsNTwiHia50eMvg collected $9.50 from pot
*** SUMMARY ***
Total pot $10 | Rake $0.50
Board [Qh 4s Jh Qc 7c]
Seat 1: /P4w1pHg2zHYg/4ubJ0dPw (big blind) folded before Flop
Seat 2: XOIf9W+VAxhZqN+SYoyMKA mucked
Seat 3: G5ZSSN6RSON3gkNvk/SmYg folded before Flop (didn't bet)
Seat 4: wk6Ohn4GDozoOMHc4eb2rw folded before Flop (didn't bet)
Seat 5: 2DwLxMUbmzvwY7o4/i47Xg (button) mucked
Seat 6: qAdBJlVNsNTwiHia50eMvg (small blind) showed [Jd Jc] and won ($9.50) with a full house, Jacks full of Queens



PokerStars Game #59939952892:  Hold'em No Limit ($0.50/$1.00) - 2009/07/01 0:53:18 ET
Table 'JOIm/fogLA7vSG0Vc6ME1A' 2-max Seat #2 is the button
Seat 1: NYi6JFscYNrofSXy4sM+Yw ($101 in chips)
Seat 2: F5lNTyZLIX9W2wQZ0plwgg ($152.80 in chips)
F5lNTyZLIX9W2wQZ0plwgg: posts small blind $0.50
NYi6JFscYNrofSXy4sM+Yw: posts big blind $1
*** HOLE CARDS ***
F5lNTyZLIX9W2wQZ0plwgg: raises $1 to $2
NYi6JFscYNrofSXy4sM+Yw: calls $1
*** FLOP *** [Qc 2d Kd]
NYi6JFscYNrofSXy4sM+Yw: checks
F5lNTyZLIX9W2wQZ0plwgg: checks
*** TURN *** [Qc 2d Kd] [Td]
NYi6JFscYNrofSXy4sM+Yw: checks
F5lNTyZLIX9W2wQZ0plwgg: bets $2
NYi6JFscYNrofSXy4sM+Yw: folds
F5lNTyZLIX9W2wQZ0plwgg collected $3.80 from pot
*** SUMMARY ***
Total pot $4 | Rake $0.20
Board [Qc 2d Kd Td]
Seat 1: NYi6JFscYNrofSXy4sM+Yw (big blind) folded on the Turn
Seat 2: F5lNTyZLIX9W2wQZ0plwgg (button) (small blind) collected ($3.80)



PokerStars Game #59939953200:  Hold'em No Limit ($0.50/$1.00) - 2009/07/01 0:53:19 ET
Table 'LmXQK9xy3awB+qsPzI21Mw' 2-max Seat #2 is the button
Seat 1: NYi6JFscYNrofSXy4sM+Yw ($174.55 in chips)
Seat 2: TME8GvochpQAo8cmJwWmvA ($152.80 in chips)
TME8GvochpQAo8cmJwWmvA: posts small blind $0.50
NYi6JFscYNrofSXy4sM+Yw: posts big blind $1
*** HOLE CARDS ***
TME8GvochpQAo8cmJwWmvA: raises $1 to $2
NYi6JFscYNrofSXy4sM+Yw: calls $1
*** FLOP *** [4s 5s 8h]
NYi6JFscYNrofSXy4sM+Yw: bets $3
TME8GvochpQAo8cmJwWmvA: raises $6 to $9
NYi6JFscYNrofSXy4sM+Yw: raises $16 to $25
TME8GvochpQAo8cmJwWmvA: raises $125.80 to $150.80 and is all-in
NYi6JFscYNrofSXy4sM+Yw: calls $125.80
*** TURN *** [4s 5s 8h] [Ts]
*** RIVER *** [4s 5s 8h Ts] [3s]
*** SHOW DOWN ***
NYi6JFscYNrofSXy4sM+Yw: shows [4d 4h] (three of a kind, Fours)
TME8GvochpQAo8cmJwWmvA: mucks hand
NYi6JFscYNrofSXy4sM+Yw collected $305.10 from pot
*** SUMMARY ***
Total pot $305.60 | Rake $0.50
Board [4s 5s 8h Ts 3s]
Seat 1: NYi6JFscYNrofSXy4sM+Yw (big blind) showed [4d 4h] and won ($305.10) with three of a kind, Fours
Seat 2: TME8GvochpQAo8cmJwWmvA (button) (small blind) mucked



PokerStars Game #59939955830:  Hold'em No Limit ($0.50/$1.00) - 2009/07/01 0:53:23 ET
Table 'U9zqzC8f3oTJ2ShXFgSSOA' 6-max Seat #3 is the button
Seat 1: iHo1oDbrEVJ8nEGdaPrICw ($109 in chips)
Seat 2: TSuRyAHnUPCFjP7Z0rEE0w ($100 in chips)
Seat 3: yfXek8iJ7O4CFyqXrtGcfg ($14.45 in chips)
Seat 4: 33q95we0Etwgrm6guQGncw ($83.25 in chips)
Seat 5: KfwW5us6tydK81NYTtK1gw ($298.95 in chips)
Seat 6: 4OO5v3AVduL0tePNx8wk5A ($100 in chips)
33q95we0Etwgrm6guQGncw: posts small blind $0.50
KfwW5us6tydK81NYTtK1gw: posts big blind $1
*** HOLE CARDS ***
4OO5v3AVduL0tePNx8wk5A: folds
iHo1oDbrEVJ8nEGdaPrICw: folds
TSuRyAHnUPCFjP7Z0rEE0w: folds
yfXek8iJ7O4CFyqXrtGcfg: raises $2 to $3
33q95we0Etwgrm6guQGncw: folds
KfwW5us6tydK81NYTtK1gw: folds
yfXek8iJ7O4CFyqXrtGcfg collected $2.50 from pot
*** SUMMARY ***
Total pot $2.50 | Rake $0
Seat 1: iHo1oDbrEVJ8nEGdaPrICw folded before Flop (didn't bet)
Seat 2: TSuRyAHnUPCFjP7Z0rEE0w folded before Flop (didn't bet)
Seat 3: yfXek8iJ7O4CFyqXrtGcfg (button) collected ($2.50)
Seat 4: 33q95we0Etwgrm6guQGncw (small blind) folded before Flop
Seat 5: KfwW5us6tydK81NYTtK1gw (big blind) folded before Flop
Seat 6: 4OO5v3AVduL0tePNx8wk5A folded before Flop (didn't bet)



PokerStars Game #59939955564:  Hold'em No Limit ($0.50/$1.00) - 2009/07/01 0:53:23 ET
Table 'cKH9c4x6u79IqCdaKKvXrw' 9-max Seat #1 is the button
Seat 1: Pp/KTcXkfZKKUHkjyaLTdg ($15.50 in chips)
Seat 2: 8S3JMH4TY3whgIlZmMv66w ($45.35 in chips)
Seat 3: 997ViqAtWn1FPjJqcffwcA ($158.60 in chips)
Seat 4: FL3MrLspcF23LYvC4ipBOA ($100 in chips)
Seat 5: Jjc7EHWzs4//xUAjJ0UWoA ($39.50 in chips)
Seat 6: Bsd/K5gAcLanYbGiPirRjw ($207.55 in chips)
Seat 7: 1GkkVBhlJ92guE6K5mS5Ig ($35.55 in chips)
Seat 9: 6XkTu4ahxzHnvjjc1R8YjQ ($43.10 in chips)
8S3JMH4TY3whgIlZmMv66w: posts small blind $0.50
997ViqAtWn1FPjJqcffwcA: posts big blind $1
myIxN7otsyr846M539YR8Q: sits out
*** HOLE CARDS ***
FL3MrLspcF23LYvC4ipBOA: folds
Jjc7EHWzs4//xUAjJ0UWoA: folds
Bsd/K5gAcLanYbGiPirRjw: folds
1GkkVBhlJ92guE6K5mS5Ig: calls $1
6XkTu4ahxzHnvjjc1R8YjQ: folds
Pp/KTcXkfZKKUHkjyaLTdg: folds
8S3JMH4TY3whgIlZmMv66w: calls $0.50
997ViqAtWn1FPjJqcffwcA: checks
*** FLOP *** [Qs 6c 6s]
8S3JMH4TY3whgIlZmMv66w: checks
997ViqAtWn1FPjJqcffwcA: checks
1GkkVBhlJ92guE6K5mS5Ig: checks
*** TURN *** [Qs 6c 6s] [7c]
8S3JMH4TY3whgIlZmMv66w: checks
997ViqAtWn1FPjJqcffwcA: checks
1GkkVBhlJ92guE6K5mS5Ig: bets $3
8S3JMH4TY3whgIlZmMv66w: folds
997ViqAtWn1FPjJqcffwcA: folds
1GkkVBhlJ92guE6K5mS5Ig collected $2.85 from pot
*** SUMMARY ***
Total pot $3 | Rake $0.15
Board [Qs 6c 6s 7c]
Seat 1: Pp/KTcXkfZKKUHkjyaLTdg (button) folded before Flop (didn't bet)
Seat 2: 8S3JMH4TY3whgIlZmMv66w (small blind) folded on the Turn
Seat 3: 997ViqAtWn1FPjJqcffwcA (big blind) folded on the Turn
Seat 4: FL3MrLspcF23LYvC4ipBOA folded before Flop (didn't bet)
Seat 5: Jjc7EHWzs4//xUAjJ0UWoA folded before Flop (didn't bet)
Seat 6: Bsd/K5gAcLanYbGiPirRjw folded before Flop (didn't bet)
Seat 7: 1GkkVBhlJ92guE6K5mS5Ig collected ($2.85)
Seat 9: 6XkTu4ahxzHnvjjc1R8YjQ folded before Flop (didn't bet)



PokerStars Game #59939957396:  Hold'em No Limit ($0.50/$1.00) - 2009/07/01 0:53:26 ET
Table 'eU3bWpDDg3Z+9R4m4iVmog' 6-max Seat #3 is the button
Seat 1: TSuRyAHnUPCFjP7Z0rEE0w ($191.15 in chips)
Seat 2: 8CAoOzhmB8n3nRFf3V4BTg ($84.95 in chips)
Seat 3: U6tnjwZRpTnM+YkqkCjwyQ ($187.15 in chips)
Seat 4: GDVIsbEJ/DOJsMKE4Asz0A ($91.60 in chips)
Seat 5: AdLVjddOzm+sRNo1Bc3S6Q ($110.55 in chips)
Seat 6: hpxXcmRkXXI9HE5+5/j/0Q ($106.45 in chips)
GDVIsbEJ/DOJsMKE4Asz0A: posts small blind $0.50
AdLVjddOzm+sRNo1Bc3S6Q: posts big blind $1
*** HOLE CARDS ***
hpxXcmRkXXI9HE5+5/j/0Q: folds
TSuRyAHnUPCFjP7Z0rEE0w: folds
8CAoOzhmB8n3nRFf3V4BTg: folds
U6tnjwZRpTnM+YkqkCjwyQ: folds
GDVIsbEJ/DOJsMKE4Asz0A: folds
AdLVjddOzm+sRNo1Bc3S6Q collected $1 from pot
AdLVjddOzm+sRNo1Bc3S6Q: doesn't show hand
*** SUMMARY ***
Total pot $1 | Rake $0
Seat 1: TSuRyAHnUPCFjP7Z0rEE0w folded before Flop (didn't bet)
Seat 2: 8CAoOzhmB8n3nRFf3V4BTg folded before Flop (didn't bet)
Seat 3: U6tnjwZRpTnM+YkqkCjwyQ (button) folded before Flop (didn't bet)
Seat 4: GDVIsbEJ/DOJsMKE4Asz0A (small blind) folded before Flop
Seat 5: AdLVjddOzm+sRNo1Bc3S6Q (big blind) collected ($1)
Seat 6: hpxXcmRkXXI9HE5+5/j/0Q folded before Flop (didn't bet)



PokerStars Game #59939958298:  Hold'em No Limit ($0.50/$1.00) - 2009/07/01 0:53:27 ET
Table 'hugOjcwJvzEwZbK7tyiWuQ' 9-max Seat #3 is the button
Seat 2: r27C1nIV4NS4+qbnrgBQSw ($261 in chips)
Seat 3: jDwhY1kCdc6EkAHbT7PJMQ ($102.15 in chips)
Seat 4: UWB3oeddt/GObx2Mix2Anw ($204.75 in chips)
Seat 5: 5BRGWf+R3nt2WS3b5xX+zA ($28.70 in chips)
Seat 6: gUUvmqdVlmvpal6B8nYrmg ($103.20 in chips)
Seat 7: FL3MrLspcF23LYvC4ipBOA ($113.30 in chips)
Seat 8: /zy+DB4S5fUQUSfZWFzYGw ($100 in chips)
Seat 9: W8P9bUKCs43TO1xHm0dL6w ($88.05 in chips)
UWB3oeddt/GObx2Mix2Anw: posts small blind $0.50
5BRGWf+R3nt2WS3b5xX+zA: posts big blind $1
*** HOLE CARDS ***
gUUvmqdVlmvpal6B8nYrmg: folds
FL3MrLspcF23LYvC4ipBOA: folds
/zy+DB4S5fUQUSfZWFzYGw: folds
W8P9bUKCs43TO1xHm0dL6w: calls $1
r27C1nIV4NS4+qbnrgBQSw: folds
jDwhY1kCdc6EkAHbT7PJMQ: folds
UWB3oeddt/GObx2Mix2Anw: folds
N9n5Wc3s35DpCrOAUUNAaQ leaves the table
5BRGWf+R3nt2WS3b5xX+zA: checks
*** FLOP *** [Td Ah 5c]
5BRGWf+R3nt2WS3b5xX+zA: checks
W8P9bUKCs43TO1xHm0dL6w: bets $2
5BRGWf+R3nt2WS3b5xX+zA: folds
W8P9bUKCs43TO1xHm0dL6w collected $2.40 from pot
*** SUMMARY ***
Total pot $2.50 | Rake $0.10
Board [Td Ah 5c]
Seat 2: r27C1nIV4NS4+qbnrgBQSw folded before Flop (didn't bet)
Seat 3: jDwhY1kCdc6EkAHbT7PJMQ (button) folded before Flop (didn't bet)
Seat 4: UWB3oeddt/GObx2Mix2Anw (small blind) folded before Flop
Seat 5: 5BRGWf+R3nt2WS3b5xX+zA (big blind) folded on the Flop
Seat 6: gUUvmqdVlmvpal6B8nYrmg folded before Flop (didn't bet)
Seat 7: FL3MrLspcF23LYvC4ipBOA folded before Flop (didn't bet)
Seat 8: /zy+DB4S5fUQUSfZWFzYGw folded before Flop (didn't bet)
Seat 9: W8P9bUKCs43TO1xHm0dL6w collected ($2.40)



PokerStars Game #59939958712:  Hold'em No Limit ($0.50/$1.00) - 2009/07/01 0:53:28 ET
Table 'cBDNutyLBKEk9+ptwsKmTw' 6-max Seat #3 is the button
Seat 1: xAU6q2/cwmby2sxmA8VcmA ($100 in chips)
Seat 2: 5lY8d6Cnm4HUkt/8FZSj4g ($103.65 in chips)
Seat 3: G5ZSSN6RSON3gkNvk/SmYg ($103.15 in chips)
Seat 4: 3q7F5QtzC30pSrn0nl9i+A ($34.60 in chips)
Seat 5: OGMLOcTNYZXZU81au7ztUw ($158.65 in chips)
Seat 6: NqVlOSH2lp+pp/TK3vvK5g ($36 in chips)
3q7F5QtzC30pSrn0nl9i+A: posts small blind $0.50
OGMLOcTNYZXZU81au7ztUw: posts big blind $1
*** HOLE CARDS ***
NqVlOSH2lp+pp/TK3vvK5g: folds
xAU6q2/cwmby2sxmA8VcmA: folds
5lY8d6Cnm4HUkt/8FZSj4g: folds
G5ZSSN6RSON3gkNvk/SmYg: folds
3q7F5QtzC30pSrn0nl9i+A: folds
OGMLOcTNYZXZU81au7ztUw collected $1 from pot
OGMLOcTNYZXZU81au7ztUw: doesn't show hand
*** SUMMARY ***
Total pot $1 | Rake $0
Seat 1: xAU6q2/cwmby2sxmA8VcmA folded before Flop (didn't bet)
Seat 2: 5lY8d6Cnm4HUkt/8FZSj4g folded before Flop (didn't bet)
Seat 3: G5ZSSN6RSON3gkNvk/SmYg (button) folded before Flop (didn't bet)
Seat 4: 3q7F5QtzC30pSrn0nl9i+A (small blind) folded before Flop
Seat 5: OGMLOcTNYZXZU81au7ztUw (big blind) collected ($1)
Seat 6: NqVlOSH2lp+pp/TK3vvK5g folded before Flop (didn't bet)



PokerStars Game #59939960128:  Hold'em No Limit ($0.50/$1.00) - 2009/07/01 0:53:30 ET
Table 'rmZfTK+oSebeUPJNbWhdAA' 6-max Seat #6 is the button
Seat 1: xAU6q2/cwmby2sxmA8VcmA ($100 in chips)
Seat 2: z7O9PO/WEcqRouIydFhS9Q ($84.95 in chips)
Seat 4: 1/mIuXfgx1ZyVkodrmfQDw ($100 in chips)
Seat 5: 5lY8d6Cnm4HUkt/8FZSj4g ($141.50 in chips)
Seat 6: j7NIOHLZk7V2o9fOioO5ug ($133.80 in chips)
xAU6q2/cwmby2sxmA8VcmA: posts small blind $0.50
z7O9PO/WEcqRouIydFhS9Q: posts big blind $1
BCEV3COoKY607AzLWayfRA: sits out
*** HOLE CARDS ***
1/mIuXfgx1ZyVkodrmfQDw: folds
5lY8d6Cnm4HUkt/8FZSj4g: calls $1
j7NIOHLZk7V2o9fOioO5ug: raises $4 to $5
xAU6q2/cwmby2sxmA8VcmA: folds
z7O9PO/WEcqRouIydFhS9Q: folds
5lY8d6Cnm4HUkt/8FZSj4g: calls $4
*** FLOP *** [4c 4h Qc]
5lY8d6Cnm4HUkt/8FZSj4g: checks
j7NIOHLZk7V2o9fOioO5ug: bets $9
5lY8d6Cnm4HUkt/8FZSj4g: calls $9
*** TURN *** [4c 4h Qc] [7s]
5lY8d6Cnm4HUkt/8FZSj4g: checks
j7NIOHLZk7V2o9fOioO5ug: checks
*** RIVER *** [4c 4h Qc 7s] [6c]
5lY8d6Cnm4HUkt/8FZSj4g: checks
j7NIOHLZk7V2o9fOioO5ug: checks
*** SHOW DOWN ***
5lY8d6Cnm4HUkt/8FZSj4g: shows [5d 5h] (two pair, Fives and Fours)
j7NIOHLZk7V2o9fOioO5ug: mucks hand
5lY8d6Cnm4HUkt/8FZSj4g collected $28.10 from pot
*** SUMMARY ***
Total pot $29.50 | Rake $1.40
Board [4c 4h Qc 7s 6c]
Seat 1: xAU6q2/cwmby2sxmA8VcmA (small blind) folded before Flop
Seat 2: z7O9PO/WEcqRouIydFhS9Q (big blind) folded before Flop
Seat 4: 1/mIuXfgx1ZyVkodrmfQDw folded before Flop (didn't bet)
Seat 5: 5lY8d6Cnm4HUkt/8FZSj4g showed [5d 5h] and won ($28.10) with two pair, Fives and Fours
Seat 6: j7NIOHLZk7V2o9fOioO5ug (button) mucked



PokerStars Game #59939961238:  Hold'em No Limit ($0.50/$1.00) - 2009/07/01 0:53:32 ET
Table 'JOIm/fogLA7vSG0Vc6ME1A' 2-max Seat #1 is the button
Seat 1: NYi6JFscYNrofSXy4sM+Yw ($100 in chips)
Seat 2: F5lNTyZLIX9W2wQZ0plwgg ($154.60 in chips)
NYi6JFscYNrofSXy4sM+Yw: posts small blind $0.50
F5lNTyZLIX9W2wQZ0plwgg: posts big blind $1
*** HOLE CARDS ***
NYi6JFscYNrofSXy4sM+Yw: raises $2 to $3
F5lNTyZLIX9W2wQZ0plwgg: folds
NYi6JFscYNrofSXy4sM+Yw collected $2 from pot
*** SUMMARY ***
Total pot $2 | Rake $0
Seat 1: NYi6JFscYNrofSXy4sM+Yw (button) (small blind) collected ($2)
Seat 2: F5lNTyZLIX9W2wQZ0plwgg (big blind) folded before Flop



PokerStars Game #59939962988:  Hold'em No Limit ($0.50/$1.00) - 2009/07/01 0:53:35 ET
Table 'tyUh+jyNvrceIQdKMJjQ2wZFWj23PMihdwrNWv41OG/Qeat #3 is the button
Seat 1: o8A5MUdudVKu+pAwgZOX2w ($195.80 in chips)
Seat 2: XvUbOIg94d25feWeQlOTVg ($77.85 in chips)
Seat 3: TalCiLYHCd+ffkmR3auPvA ($85.90 in chips)
Seat 4: TSuRyAHnUPCFjP7Z0rEE0w ($111.75 in chips)
Seat 5: j7NIOHLZk7V2o9fOioO5ug ($112.05 in chips)
Seat 6: YsLQ3BAvgQHWXMAv3Wv6Hg ($150.15 in chips)
TSuRyAHnUPCFjP7Z0rEE0w: posts small blind $0.50
j7NIOHLZk7V2o9fOioO5ug: posts big blind $1
*** HOLE CARDS ***
YsLQ3BAvgQHWXMAv3Wv6Hg: folds
o8A5MUdudVKu+pAwgZOX2w: calls $1
XvUbOIg94d25feWeQlOTVg: calls $1
TalCiLYHCd+ffkmR3auPvA: folds
TSuRyAHnUPCFjP7Z0rEE0w: folds
j7NIOHLZk7V2o9fOioO5ug: raises $5 to $6
o8A5MUdudVKu+pAwgZOX2w: folds
XvUbOIg94d25feWeQlOTVg: calls $5
*** FLOP *** [9c Jc Qh]
j7NIOHLZk7V2o9fOioO5ug: bets $9
XvUbOIg94d25feWeQlOTVg: raises $22 to $31
j7NIOHLZk7V2o9fOioO5ug: raises $70 to $101
XvUbOIg94d25feWeQlOTVg: calls $40.85 and is all-in
*** TURN *** [9c Jc Qh] [5h]
*** RIVER *** [9c Jc Qh 5h] [Th]
*** SHOW DOWN ***
j7NIOHLZk7V2o9fOioO5ug: shows [Qs Ad] (a pair of Queens)
XvUbOIg94d25feWeQlOTVg: shows [Js Qd] (two pair, Queens and Jacks)
XvUbOIg94d25feWeQlOTVg collected $154.20 from pot
*** SUMMARY ***
Total pot $157.20 | Rake $3
Board [9c Jc Qh 5h Th]
Seat 1: o8A5MUdudVKu+pAwgZOX2w folded before Flop
Seat 2: XvUbOIg94d25feWeQlOTVg showed [Js Qd] and won ($154.20) with two pair, Queens and Jacks
Seat 3: TalCiLYHCd+ffkmR3auPvA (button) folded before Flop (didn't bet)
Seat 4: TSuRyAHnUPCFjP7Z0rEE0w (small blind) folded before Flop
Seat 5: j7NIOHLZk7V2o9fOioO5ug (big blind) showed [Qs Ad] and lost with a pair of Queens
Seat 6: YsLQ3BAvgQHWXMAv3Wv6Hg folded before Flop (didn't bet)



PokerStars Game #59939964386:  Hold'em No Limit ($0.50/$1.00) - 2009/07/01 0:53:37 ET
Table 'eU3bWpDDg3Z+9R4m4iVmog' 6-max Seat #4 is the button
Seat 1: TSuRyAHnUPCFjP7Z0rEE0w ($191.15 in chips)
Seat 2: 8CAoOzhmB8n3nRFf3V4BTg ($84.95 in chips)
Seat 3: U6tnjwZRpTnM+YkqkCjwyQ ($187.15 in chips)
Seat 4: GDVIsbEJ/DOJsMKE4Asz0A ($91.10 in chips)
Seat 5: AdLVjddOzm+sRNo1Bc3S6Q ($111.05 in chips)
Seat 6: hpxXcmRkXXI9HE5+5/j/0Q ($106.45 in chips)
AdLVjddOzm+sRNo1Bc3S6Q: posts small blind $0.50
hpxXcmRkXXI9HE5+5/j/0Q: posts big blind $1
*** HOLE CARDS ***
TSuRyAHnUPCFjP7Z0rEE0w: raises $3 to $4
8CAoOzhmB8n3nRFf3V4BTg: folds
U6tnjwZRpTnM+YkqkCjwyQ: folds
GDVIsbEJ/DOJsMKE4Asz0A: folds
AdLVjddOzm+sRNo1Bc3S6Q: folds
hpxXcmRkXXI9HE5+5/j/0Q: folds
TSuRyAHnUPCFjP7Z0rEE0w collected $2.50 from pot
TSuRyAHnUPCFjP7Z0rEE0w: doesn't show hand
*** SUMMARY ***
Total pot $2.50 | Rake $0
Seat 1: TSuRyAHnUPCFjP7Z0rEE0w collected ($2.50)
Seat 2: 8CAoOzhmB8n3nRFf3V4BTg folded before Flop (didn't bet)
Seat 3: U6tnjwZRpTnM+YkqkCjwyQ folded before Flop (didn't bet)
Seat 4: GDVIsbEJ/DOJsMKE4Asz0A (button) folded before Flop (didn't bet)
Seat 5: AdLVjddOzm+sRNo1Bc3S6Q (small blind) folded before Flop
Seat 6: hpxXcmRkXXI9HE5+5/j/0Q (big blind) folded before Flop



PokerStars Game #59939965478:  Hold'em No Limit ($0.50/$1.00) - 2009/07/01 0:53:39 ET
Table 'W/wyObTiXZm+Ckkl3YxcSw' 6-max Seat #3 is the button
Seat 1: eUBBn2R56C1IQ6Cs/vitwg ($110.75 in chips)
Seat 2: oDiBRCaF0QVtd3kO6xZIXw ($97.30 in chips)
Seat 3: ybGsYWp1MLwy1vSnP8egXg ($26 in chips)
Seat 4: +xW7QemQU0Fxs+4TnqBRow ($112.40 in chips)
Seat 5: BdbmJTZZ47quA9vUWwXtlw ($64.85 in chips)
Seat 6: tS9JHB1h+FQ++qu8RwRNgg ($19 in chips)
+xW7QemQU0Fxs+4TnqBRow: posts small blind $0.50
BdbmJTZZ47quA9vUWwXtlw: posts big blind $1
*** HOLE CARDS ***
tS9JHB1h+FQ++qu8RwRNgg: folds
eUBBn2R56C1IQ6Cs/vitwg: folds
oDiBRCaF0QVtd3kO6xZIXw: folds
ybGsYWp1MLwy1vSnP8egXg: calls $1
+xW7QemQU0Fxs+4TnqBRow: folds
BdbmJTZZ47quA9vUWwXtlw: raises $3 to $4
ybGsYWp1MLwy1vSnP8egXg: folds
BdbmJTZZ47quA9vUWwXtlw collected $2.50 from pot
*** SUMMARY ***
Total pot $2.50 | Rake $0
Seat 1: eUBBn2R56C1IQ6Cs/vitwg folded before Flop (didn't bet)
Seat 2: oDiBRCaF0QVtd3kO6xZIXw folded before Flop (didn't bet)
Seat 3: ybGsYWp1MLwy1vSnP8egXg (button) folded before Flop
Seat 4: +xW7QemQU0Fxs+4TnqBRow (small blind) folded before Flop
Seat 5: BdbmJTZZ47quA9vUWwXtlw (big blind) collected ($2.50)
Seat 6: tS9JHB1h+FQ++qu8RwRNgg folded before Flop (didn't bet)



PokerStars Game #59939965538:  Hold'em No Limit ($0.50/$1.00) - 2009/07/01 0:53:39 ET
Table 'mmbQQVBTrPdE+wy+s+9VPA' 6-max Seat #1 is the button
Seat 1: JwCcjZl0bjJzG7hmE0dnTA ($101 in chips)
Seat 2: +W6OnF033KNM2xH0fGj98Q ($136.60 in chips)
Seat 3: wx3sQGkVi2x9wJXuWNHPBw ($115.65 in chips)
Seat 5: YMJG+F++3Aj6P8dAWda5fw ($99.50 in chips)
Seat 6: U2CWBTv29qdCbj8RNF2sIw ($98.50 in chips)
+W6OnF033KNM2xH0fGj98Q: posts small blind $0.50
wx3sQGkVi2x9wJXuWNHPBw: posts big blind $1
V3iZdcw61nXF3g5hD2RrsQ: sits out
*** HOLE CARDS ***
YMJG+F++3Aj6P8dAWda5fw: folds
U2CWBTv29qdCbj8RNF2sIw: folds
JwCcjZl0bjJzG7hmE0dnTA: raises $2 to $3
+W6OnF033KNM2xH0fGj98Q: raises $7 to $10
wx3sQGkVi2x9wJXuWNHPBw: folds
JwCcjZl0bjJzG7hmE0dnTA: folds
+W6OnF033KNM2xH0fGj98Q collected $7 from pot
*** SUMMARY ***
Total pot $7 | Rake $0
Seat 1: JwCcjZl0bjJzG7hmE0dnTA (button) folded before Flop
Seat 2: +W6OnF033KNM2xH0fGj98Q (small blind) collected ($7)
Seat 3: wx3sQGkVi2x9wJXuWNHPBw (big blind) folded before Flop
Seat 5: YMJG+F++3Aj6P8dAWda5fw folded before Flop (didn't bet)
Seat 6: U2CWBTv29qdCbj8RNF2sIw folded before Flop (didn't bet)



PokerStars Game #59939966394:  Hold'em No Limit ($0.50/$1.00) - 2009/07/01 0:53:40 ET
Table 'VOs36P6NW+QyXeQ1B62kmA' 6-max Seat #3 is the button
Seat 1: AdLVjddOzm+sRNo1Bc3S6Q ($129.30 in chips)
Seat 2: 2UMlbaZ8n8AbRli0Yr0mDw ($39 in chips)
Seat 3: TSuRyAHnUPCFjP7Z0rEE0w ($100 in chips)
Seat 4: w02zQzNydODiyV9THKgo9w ($31.10 in chips)
Seat 5: ozrlafxxh1HmYdA0/h+MuA ($46.75 in chips)
Seat 6: 6tvjsJrdmWg+g7FVrMnzXA ($79.50 in chips)
w02zQzNydODiyV9THKgo9w: posts small blind $0.50
ozrlafxxh1HmYdA0/h+MuA: posts big blind $1
2UMlbaZ8n8AbRli0Yr0mDw: posts big blind $1
*** HOLE CARDS ***
6tvjsJrdmWg+g7FVrMnzXA: folds
AdLVjddOzm+sRNo1Bc3S6Q: folds
2UMlbaZ8n8AbRli0Yr0mDw: checks
TSuRyAHnUPCFjP7Z0rEE0w: folds
w02zQzNydODiyV9THKgo9w: calls $0.50
ozrlafxxh1HmYdA0/h+MuA: checks
*** FLOP *** [9d Qc Th]
w02zQzNydODiyV9THKgo9w: bets $3
ozrlafxxh1HmYdA0/h+MuA: folds
2UMlbaZ8n8AbRli0Yr0mDw: calls $3
*** TURN *** [9d Qc Th] [Ts]
w02zQzNydODiyV9THKgo9w: bets $3
2UMlbaZ8n8AbRli0Yr0mDw: calls $3
*** RIVER *** [9d Qc Th Ts] [8d]
w02zQzNydODiyV9THKgo9w: bets $9
2UMlbaZ8n8AbRli0Yr0mDw: calls $9
*** SHOW DOWN ***
w02zQzNydODiyV9THKgo9w: shows [Qd Jh] (a straight, Eight to Queen)
2UMlbaZ8n8AbRli0Yr0mDw: mucks hand
w02zQzNydODiyV9THKgo9w collected $31.40 from pot
*** SUMMARY ***
Total pot $33 | Rake $1.60
Board [9d Qc Th Ts 8d]
Seat 1: AdLVjddOzm+sRNo1Bc3S6Q folded before Flop (didn't bet)
Seat 2: 2UMlbaZ8n8AbRli0Yr0mDw mucked
Seat 3: TSuRyAHnUPCFjP7Z0rEE0w (button) folded before Flop (didn't bet)
Seat 4: w02zQzNydODiyV9THKgo9w (small blind) showed [Qd Jh] and won ($31.40) with a straight, Eight to Queen
Seat 5: ozrlafxxh1HmYdA0/h+MuA (big blind) folded on the Flop
Seat 6: 6tvjsJrdmWg+g7FVrMnzXA folded before Flop (didn't bet)



PokerStars Game #59939966100:  Hold'em No Limit ($0.50/$1.00) - 2009/07/01 0:53:40 ET
Table 'JOIm/fogLA7vSG0Vc6ME1A' 2-max Seat #2 is the button
Seat 1: NYi6JFscYNrofSXy4sM+Yw ($101 in chips)
Seat 2: F5lNTyZLIX9W2wQZ0plwgg ($153.60 in chips)
F5lNTyZLIX9W2wQZ0plwgg: posts small blind $0.50
NYi6JFscYNrofSXy4sM+Yw: posts big blind $1
*** HOLE CARDS ***
F5lNTyZLIX9W2wQZ0plwgg: raises $1 to $2
NYi6JFscYNrofSXy4sM+Yw: raises $7 to $9
F5lNTyZLIX9W2wQZ0plwgg: calls $7
*** FLOP *** [Qs Qh Jd]
NYi6JFscYNrofSXy4sM+Yw: bets $11
F5lNTyZLIX9W2wQZ0plwgg: calls $11
*** TURN *** [Qs Qh Jd] [Jc]
NYi6JFscYNrofSXy4sM+Yw: checks
F5lNTyZLIX9W2wQZ0plwgg: checks
*** RIVER *** [Qs Qh Jd Jc] [3c]
NYi6JFscYNrofSXy4sM+Yw: checks
F5lNTyZLIX9W2wQZ0plwgg: checks
*** SHOW DOWN ***
NYi6JFscYNrofSXy4sM+Yw: shows [5d Ad] (two pair, Queens and Jacks)
F5lNTyZLIX9W2wQZ0plwgg: mucks hand
NYi6JFscYNrofSXy4sM+Yw collected $39.50 from pot
*** SUMMARY ***
Total pot $40 | Rake $0.50
Board [Qs Qh Jd Jc 3c]
Seat 1: NYi6JFscYNrofSXy4sM+Yw (big blind) showed [5d Ad] and won ($39.50) with two pair, Queens and Jacks
Seat 2: F5lNTyZLIX9W2wQZ0plwgg (button) (small blind) mucked



PokerStars Game #59939967622:  Hold'em No Limit ($0.50/$1.00) - 2009/07/01 0:53:42 ET
Table 'Zka9tv1yilg0MvXWPQrShg' 9-max Seat #4 is the button
Seat 1: TZcz9MEWDA+WydgGruqqbw ($121.90 in chips)
Seat 2: kz9ziSiGUc+857heiKSayw ($20 in chips)
Seat 3: gUUvmqdVlmvpal6B8nYrmg ($100 in chips)
Seat 4: stxmTgSicxShtrDxhOOX2g ($69.15 in chips)
Seat 5: /zy+DB4S5fUQUSfZWFzYGw ($123.90 in chips)
Seat 6: rY8wPoax1lS+HUY+I0FZDw ($145.45 in chips)
Seat 7: p1SafS90nb3Uft5LB0NkHw ($22.50 in chips)
Seat 8: bL+QVeDcuEdzMGAGg2XJHg ($122.10 in chips)
Seat 9: 6daxhj43mWj04MOPTOmaYA ($92.65 in chips)
/zy+DB4S5fUQUSfZWFzYGw: posts small blind $0.50
rY8wPoax1lS+HUY+I0FZDw: posts big blind $1
*** HOLE CARDS ***
p1SafS90nb3Uft5LB0NkHw: folds
bL+QVeDcuEdzMGAGg2XJHg: folds
6daxhj43mWj04MOPTOmaYA: folds
TZcz9MEWDA+WydgGruqqbw: folds
kz9ziSiGUc+857heiKSayw: folds
gUUvmqdVlmvpal6B8nYrmg: raises $1 to $2
stxmTgSicxShtrDxhOOX2g: folds
/zy+DB4S5fUQUSfZWFzYGw: folds
rY8wPoax1lS+HUY+I0FZDw: calls $1
*** FLOP *** [9d 9s 3c]
rY8wPoax1lS+HUY+I0FZDw: checks
gUUvmqdVlmvpal6B8nYrmg: bets $2
rY8wPoax1lS+HUY+I0FZDw: folds
gUUvmqdVlmvpal6B8nYrmg collected $4.30 from pot
*** SUMMARY ***
Total pot $4.50 | Rake $0.20
Board [9d 9s 3c]
Seat 1: TZcz9MEWDA+WydgGruqqbw folded before Flop (didn't bet)
Seat 2: kz9ziSiGUc+857heiKSayw folded before Flop (didn't bet)
Seat 3: gUUvmqdVlmvpal6B8nYrmg collected ($4.30)
Seat 4: stxmTgSicxShtrDxhOOX2g (button) folded before Flop (didn't bet)
Seat 5: /zy+DB4S5fUQUSfZWFzYGw (small blind) folded before Flop
Seat 6: rY8wPoax1lS+HUY+I0FZDw (big blind) folded on the Flop
Seat 7: p1SafS90nb3Uft5LB0NkHw folded before Flop (didn't bet)
Seat 8: bL+QVeDcuEdzMGAGg2XJHg folded before Flop (didn't bet)
Seat 9: 6daxhj43mWj04MOPTOmaYA folded before Flop (didn't bet)



PokerStars Game #59939967742:  Hold'em No Limit ($0.50/$1.00) - 2009/07/01 0:53:43 ET
Table 'pHrhryH8jPNdQfY62f8v+g' 6-max Seat #6 is the button
Seat 1: fF4botNMr8/ieVPO1YYRLw ($55 in chips)
Seat 2: RqgF7gRoKgRNW8Zoi1ty4A ($101.75 in chips)
Seat 3: 8oS5O7iD/qnFXFXJrGIgNQ ($102.70 in chips)
Seat 4: wenbG7TaM3H7h5kn78OFNw ($58.70 in chips)
Seat 5: r1/R7y0Ortgoz4lccgW8VA ($49.90 in chips)
Seat 6: xAU6q2/cwmby2sxmA8VcmA ($118.80 in chips)
fF4botNMr8/ieVPO1YYRLw: posts small blind $0.50
RqgF7gRoKgRNW8Zoi1ty4A: posts big blind $1
*** HOLE CARDS ***
8oS5O7iD/qnFXFXJrGIgNQ: raises $2.50 to $3.50
wenbG7TaM3H7h5kn78OFNw: folds
r1/R7y0Ortgoz4lccgW8VA: folds
xAU6q2/cwmby2sxmA8VcmA: folds
fF4botNMr8/ieVPO1YYRLw: calls $3
RqgF7gRoKgRNW8Zoi1ty4A: folds
*** FLOP *** [Kd 6c 7d]
fF4botNMr8/ieVPO1YYRLw: checks
8oS5O7iD/qnFXFXJrGIgNQ: bets $6
fF4botNMr8/ieVPO1YYRLw: calls $6
*** TURN *** [Kd 6c 7d] [4c]
fF4botNMr8/ieVPO1YYRLw: checks
8oS5O7iD/qnFXFXJrGIgNQ: bets $18
fF4botNMr8/ieVPO1YYRLw: raises $27.50 to $45.50 and is all-in
8oS5O7iD/qnFXFXJrGIgNQ: calls $27.50
*** RIVER *** [Kd 6c 7d 4c] [5s]
*** SHOW DOWN ***
fF4botNMr8/ieVPO1YYRLw: shows [9d Td] (high card King)
8oS5O7iD/qnFXFXJrGIgNQ: shows [Kc Jh] (a pair of Kings)
8oS5O7iD/qnFXFXJrGIgNQ collected $108 from pot
*** SUMMARY ***
Total pot $111 | Rake $3
Board [Kd 6c 7d 4c 5s]
Seat 1: fF4botNMr8/ieVPO1YYRLw (small blind) showed [9d Td] and lost with high card King
Seat 2: RqgF7gRoKgRNW8Zoi1ty4A (big blind) folded before Flop
Seat 3: 8oS5O7iD/qnFXFXJrGIgNQ showed [Kc Jh] and won ($108) with a pair of Kings
Seat 4: wenbG7TaM3H7h5kn78OFNw folded before Flop (didn't bet)
Seat 5: r1/R7y0Ortgoz4lccgW8VA folded before Flop (didn't bet)
Seat 6: xAU6q2/cwmby2sxmA8VcmA (button) folded before Flop (didn't bet)



PokerStars Game #59939970020:  Hold'em No Limit ($0.50/$1.00) - 2009/07/01 0:53:46 ET
Table 'GxCPo/gd3OSthkYrAxJngg' 6-max Seat #1 is the button
Seat 1: sH8BpAFP+jGFxCgVpD1Lew ($262.25 in chips)
Seat 2: YExX2paeIHrmfIwV1ivM/w ($77.20 in chips)
Seat 3: o6plE+MSW4XFNTeONe16xg ($29.60 in chips)
Seat 4: YMJG+F++3Aj6P8dAWda5fw ($206.10 in chips)
Seat 5: G5ZSSN6RSON3gkNvk/SmYg ($106.75 in chips)
YExX2paeIHrmfIwV1ivM/w: posts small blind $0.50
o6plE+MSW4XFNTeONe16xg: posts big blind $1
*** HOLE CARDS ***
YMJG+F++3Aj6P8dAWda5fw: raises $2 to $3
G5ZSSN6RSON3gkNvk/SmYg: folds
sH8BpAFP+jGFxCgVpD1Lew: folds
YExX2paeIHrmfIwV1ivM/w: folds
o6plE+MSW4XFNTeONe16xg: folds
YMJG+F++3Aj6P8dAWda5fw collected $2.50 from pot
*** SUMMARY ***
Total pot $2.50 | Rake $0
Seat 1: sH8BpAFP+jGFxCgVpD1Lew (button) folded before Flop (didn't bet)
Seat 2: YExX2paeIHrmfIwV1ivM/w (small blind) folded before Flop
Seat 3: o6plE+MSW4XFNTeONe16xg (big blind) folded before Flop
Seat 4: YMJG+F++3Aj6P8dAWda5fw collected ($2.50)
Seat 5: G5ZSSN6RSON3gkNvk/SmYg folded before Flop (didn't bet)



PokerStars Game #59939971396:  Hold'em No Limit ($0.50/$1.00) - 2009/07/01 0:53:49 ET
Table 'U9zqzC8f3oTJ2ShXFgSSOA' 6-max Seat #4 is the button
Seat 1: iHo1oDbrEVJ8nEGdaPrICw ($109 in chips)
Seat 2: TSuRyAHnUPCFjP7Z0rEE0w ($100 in chips)
Seat 3: yfXek8iJ7O4CFyqXrtGcfg ($15.95 in chips)
Seat 4: 33q95we0Etwgrm6guQGncw ($82.75 in chips)
Seat 5: KfwW5us6tydK81NYTtK1gw ($297.95 in chips)
Seat 6: 4OO5v3AVduL0tePNx8wk5A ($100 in chips)
KfwW5us6tydK81NYTtK1gw: posts small blind $0.50
4OO5v3AVduL0tePNx8wk5A: posts big blind $1
*** HOLE CARDS ***
iHo1oDbrEVJ8nEGdaPrICw: folds
TSuRyAHnUPCFjP7Z0rEE0w: raises $3 to $4
yfXek8iJ7O4CFyqXrtGcfg: folds
33q95we0Etwgrm6guQGncw: folds
KfwW5us6tydK81NYTtK1gw: folds
4OO5v3AVduL0tePNx8wk5A: calls $3
*** FLOP *** [2s 5h Th]
4OO5v3AVduL0tePNx8wk5A: checks
TSuRyAHnUPCFjP7Z0rEE0w: bets $6
4OO5v3AVduL0tePNx8wk5A: raises $13 to $19
TSuRyAHnUPCFjP7Z0rEE0w: folds
4OO5v3AVduL0tePNx8wk5A collected $19.50 from pot
4OO5v3AVduL0tePNx8wk5A: doesn't show hand
*** SUMMARY ***
Total pot $20.50 | Rake $1
Board [2s 5h Th]
Seat 1: iHo1oDbrEVJ8nEGdaPrICw folded before Flop (didn't bet)
Seat 2: TSuRyAHnUPCFjP7Z0rEE0w folded on the Flop
Seat 3: yfXek8iJ7O4CFyqXrtGcfg folded before Flop (didn't bet)
Seat 4: 33q95we0Etwgrm6guQGncw (button) folded before Flop (didn't bet)
Seat 5: KfwW5us6tydK81NYTtK1gw (small blind) folded before Flop
Seat 6: 4OO5v3AVduL0tePNx8wk5A (big blind) collected ($19.50)



PokerStars Game #59939971994:  Hold'em No Limit ($0.50/$1.00) - 2009/07/01 0:53:50 ET
Table 'MUPc8FEpe/nR0BKSeReX6Q' 6-max Seat #6 is the button
Seat 1: YsLQ3BAvgQHWXMAv3Wv6Hg ($111.35 in chips)
Seat 2: xAU6q2/cwmby2sxmA8VcmA ($100 in chips)
Seat 3: wx3sQGkVi2x9wJXuWNHPBw ($218.40 in chips)
Seat 4: ZA1bp6g8IwtTxkUE4eCjDQ ($200.80 in chips)
Seat 5: UBZQqpnJZdTYYY1FTb0rLA ($105.05 in chips)
Seat 6: oxnw0GLLpFanjhGkxfRSqA ($57.70 in chips)
YsLQ3BAvgQHWXMAv3Wv6Hg: posts small blind $0.50
xAU6q2/cwmby2sxmA8VcmA: posts big blind $1
*** HOLE CARDS ***
wx3sQGkVi2x9wJXuWNHPBw: folds
ZA1bp6g8IwtTxkUE4eCjDQ: folds
UBZQqpnJZdTYYY1FTb0rLA: folds
oxnw0GLLpFanjhGkxfRSqA: folds
YsLQ3BAvgQHWXMAv3Wv6Hg: raises $3 to $4
xAU6q2/cwmby2sxmA8VcmA: folds
YsLQ3BAvgQHWXMAv3Wv6Hg collected $2 from pot
YsLQ3BAvgQHWXMAv3Wv6Hg: doesn't show hand
*** SUMMARY ***
Total pot $2 | Rake $0
Seat 1: YsLQ3BAvgQHWXMAv3Wv6Hg (small blind) collected ($2)
Seat 2: xAU6q2/cwmby2sxmA8VcmA (big blind) folded before Flop
Seat 3: wx3sQGkVi2x9wJXuWNHPBw folded before Flop (didn't bet)
Seat 4: ZA1bp6g8IwtTxkUE4eCjDQ folded before Flop (didn't bet)
Seat 5: UBZQqpnJZdTYYY1FTb0rLA folded before Flop (didn't bet)
Seat 6: oxnw0GLLpFanjhGkxfRSqA (button) folded before Flop (didn't bet)



PokerStars Game #59939972448:  Hold'em No Limit ($0.50/$1.00) - 2009/07/01 0:53:50 ET
Table 'fTlPiCj0utgzC/5io+I7ew' 6-max Seat #1 is the button
Seat 1: YMJG+F++3Aj6P8dAWda5fw ($93.50 in chips)
Seat 2: Qy/UBNbD2HaA0Ogxg8Sf3w ($126.35 in chips)
Seat 4: uJVSceLggtsrJya+WtmUEA ($178.25 in chips)
Seat 5: bFrTkDcWGTxyvNul7GVdYg ($250.70 in chips)
Seat 6: /P4w1pHg2zHYg/4ubJ0dPw ($60 in chips)
Qy/UBNbD2HaA0Ogxg8Sf3w: posts small blind $0.50
uJVSceLggtsrJya+WtmUEA: posts big blind $1
*** HOLE CARDS ***
bFrTkDcWGTxyvNul7GVdYg: raises $2 to $3
/P4w1pHg2zHYg/4ubJ0dPw: folds
YMJG+F++3Aj6P8dAWda5fw: folds
oDiBRCaF0QVtd3kO6xZIXw leaves the table
Qy/UBNbD2HaA0Ogxg8Sf3w: folds
uJVSceLggtsrJya+WtmUEA: calls $2
*** FLOP *** [8s 3s Qh]
uJVSceLggtsrJya+WtmUEA: checks
bFrTkDcWGTxyvNul7GVdYg: bets $4
uJVSceLggtsrJya+WtmUEA: calls $4
*** TURN *** [8s 3s Qh] [3h]
wL5HjWHHOSGc53xWMNKB9Q joins the table at seat #3
uJVSceLggtsrJya+WtmUEA: checks
bFrTkDcWGTxyvNul7GVdYg: bets $9.50
uJVSceLggtsrJya+WtmUEA: calls $9.50
*** RIVER *** [8s 3s Qh 3h] [Ac]
uJVSceLggtsrJya+WtmUEA: checks
bFrTkDcWGTxyvNul7GVdYg: bets $27
uJVSceLggtsrJya+WtmUEA: calls $27
*** SHOW DOWN ***
bFrTkDcWGTxyvNul7GVdYg: shows [Ad As] (a full house, Aces full of Threes)
uJVSceLggtsrJya+WtmUEA: mucks hand
bFrTkDcWGTxyvNul7GVdYg collected $85.50 from pot
*** SUMMARY ***
Total pot $87.50 | Rake $2
Board [8s 3s Qh 3h Ac]
Seat 1: YMJG+F++3Aj6P8dAWda5fw (button) folded before Flop (didn't bet)
Seat 2: Qy/UBNbD2HaA0Ogxg8Sf3w (small blind) folded before Flop
Seat 4: uJVSceLggtsrJya+WtmUEA (big blind) mucked
Seat 5: bFrTkDcWGTxyvNul7GVdYg showed [Ad As] and won ($85.50) with a full house, Aces full of Threes
Seat 6: /P4w1pHg2zHYg/4ubJ0dPw folded before Flop (didn't bet)



PokerStars Game #59939972822:  Hold'em No Limit ($0.50/$1.00) - 2009/07/01 0:53:51 ET
Table '+cA8mcmhaedZ7YcrDdhmeQ' 6-max Seat #3 is the button
Seat 1: lsLuWlcPA3Rh7kJVLzMh0Q ($287.50 in chips)
Seat 2: RqgF7gRoKgRNW8Zoi1ty4A ($105.95 in chips)
Seat 3: 7H5WkGzGvsv56y1iaqHvRg ($53.45 in chips)
Seat 4: JwCcjZl0bjJzG7hmE0dnTA ($100 in chips)
Seat 5: +7hFKAL0b0O/n8G72TclJA ($49.50 in chips)
Seat 6: YfsTQsY/fxb+YqbdclTHuw ($30.95 in chips)
JwCcjZl0bjJzG7hmE0dnTA: posts small blind $0.50
+7hFKAL0b0O/n8G72TclJA: posts big blind $1
*** HOLE CARDS ***
YfsTQsY/fxb+YqbdclTHuw: folds
lsLuWlcPA3Rh7kJVLzMh0Q: folds
RqgF7gRoKgRNW8Zoi1ty4A: folds
7H5WkGzGvsv56y1iaqHvRg: calls $1
JwCcjZl0bjJzG7hmE0dnTA: folds
+7hFKAL0b0O/n8G72TclJA: checks
*** FLOP *** [Ad Qs 8d]
+7hFKAL0b0O/n8G72TclJA: checks
7H5WkGzGvsv56y1iaqHvRg: bets $3
+7hFKAL0b0O/n8G72TclJA: folds
7H5WkGzGvsv56y1iaqHvRg collected $2.40 from pot
*** SUMMARY ***
Total pot $2.50 | Rake $0.10
Board [Ad Qs 8d]
Seat 1: lsLuWlcPA3Rh7kJVLzMh0Q folded before Flop (didn't bet)
Seat 2: RqgF7gRoKgRNW8Zoi1ty4A folded before Flop (didn't bet)
Seat 3: 7H5WkGzGvsv56y1iaqHvRg (button) collected ($2.40)
Seat 4: JwCcjZl0bjJzG7hmE0dnTA (small blind) folded before Flop
Seat 5: +7hFKAL0b0O/n8G72TclJA (big blind) folded on the Flop
Seat 6: YfsTQsY/fxb+YqbdclTHuw folded before Flop (didn't bet)



PokerStars Game #59939973234:  Hold'em No Limit ($0.50/$1.00) - 2009/07/01 0:53:51 ET
Table 'tJq9SfN1ywY0r03VBlWlwQ' 9-max Seat #6 is the button
Seat 1: wZsU+w9r7G66x93UuvBf1Q ($340.80 in chips)
Seat 2: RqkO8O/Y3qlc3PIuCAHjVg ($74.40 in chips)
Seat 3: FVs16t7GgfWgQWt4JxsObQ ($33.95 in chips)
Seat 4: bLbSOSmSOnqE0iTcH/5dxA ($110.20 in chips)
Seat 5: Ogn4JDV3mp4ZDKO49IFzKA ($20.25 in chips)
Seat 6: gUUvmqdVlmvpal6B8nYrmg ($120.05 in chips)
Seat 7: qVhRZ0PLZ95XRJHWAjXjOQ ($127.20 in chips)
Seat 8: G4DEhsZFmznGNVpy2SEocA ($23.50 in chips)
Seat 9: XE5QF1y74bpHog9JxWJMWQ ($100 in chips)
qVhRZ0PLZ95XRJHWAjXjOQ: posts small blind $0.50
G4DEhsZFmznGNVpy2SEocA: posts big blind $1
*** HOLE CARDS ***
XE5QF1y74bpHog9JxWJMWQ: folds
wZsU+w9r7G66x93UuvBf1Q: folds
RqkO8O/Y3qlc3PIuCAHjVg: folds
FVs16t7GgfWgQWt4JxsObQ: folds
bLbSOSmSOnqE0iTcH/5dxA: folds
Ogn4JDV3mp4ZDKO49IFzKA: calls $1
gUUvmqdVlmvpal6B8nYrmg: folds
qVhRZ0PLZ95XRJHWAjXjOQ: calls $0.50
G4DEhsZFmznGNVpy2SEocA: checks
*** FLOP *** [5s 7c 9c]
qVhRZ0PLZ95XRJHWAjXjOQ: checks
G4DEhsZFmznGNVpy2SEocA: checks
Ogn4JDV3mp4ZDKO49IFzKA: bets $2
qVhRZ0PLZ95XRJHWAjXjOQ: raises $4 to $6
G4DEhsZFmznGNVpy2SEocA: folds
Ogn4JDV3mp4ZDKO49IFzKA: folds
qVhRZ0PLZ95XRJHWAjXjOQ collected $6.70 from pot
*** SUMMARY ***
Total pot $7 | Rake $0.30
Board [5s 7c 9c]
Seat 1: wZsU+w9r7G66x93UuvBf1Q folded before Flop (didn't bet)
Seat 2: RqkO8O/Y3qlc3PIuCAHjVg folded before Flop (didn't bet)
Seat 3: FVs16t7GgfWgQWt4JxsObQ folded before Flop (didn't bet)
Seat 4: bLbSOSmSOnqE0iTcH/5dxA folded before Flop (didn't bet)
Seat 5: Ogn4JDV3mp4ZDKO49IFzKA folded on the Flop
Seat 6: gUUvmqdVlmvpal6B8nYrmg (button) folded before Flop (didn't bet)
Seat 7: qVhRZ0PLZ95XRJHWAjXjOQ (small blind) collected ($6.70)
Seat 8: G4DEhsZFmznGNVpy2SEocA (big blind) folded on the Flop
Seat 9: XE5QF1y74bpHog9JxWJMWQ folded before Flop (didn't bet)



PokerStars Game #59939973276:  Hold'em No Limit ($0.50/$1.00) - 2009/07/01 0:53:52 ET
Table 'vs/5jr6ciwjVQ5+Soc+u2A' 6-max Seat #6 is the button
Seat 1: /P4w1pHg2zHYg/4ubJ0dPw ($60.50 in chips)
Seat 2: XOIf9W+VAxhZqN+SYoyMKA ($119.35 in chips)
Seat 3: G5ZSSN6RSON3gkNvk/SmYg ($140.50 in chips)
Seat 4: wk6Ohn4GDozoOMHc4eb2rw ($54.45 in chips)
Seat 5: 2DwLxMUbmzvwY7o4/i47Xg ($31.50 in chips)
Seat 6: qAdBJlVNsNTwiHia50eMvg ($85.50 in chips)
/P4w1pHg2zHYg/4ubJ0dPw: posts small blind $0.50
XOIf9W+VAxhZqN+SYoyMKA: posts big blind $1
*** HOLE CARDS ***
G5ZSSN6RSON3gkNvk/SmYg: folds
wk6Ohn4GDozoOMHc4eb2rw: raises $3 to $4
2DwLxMUbmzvwY7o4/i47Xg: folds
qAdBJlVNsNTwiHia50eMvg: calls $4
/P4w1pHg2zHYg/4ubJ0dPw: folds
XOIf9W+VAxhZqN+SYoyMKA: folds
*** FLOP *** [4d 7s 3h]
wk6Ohn4GDozoOMHc4eb2rw: checks
qAdBJlVNsNTwiHia50eMvg: checks
*** TURN *** [4d 7s 3h] [5s]
wk6Ohn4GDozoOMHc4eb2rw: checks
qAdBJlVNsNTwiHia50eMvg: checks
*** RIVER *** [4d 7s 3h 5s] [6h]
wk6Ohn4GDozoOMHc4eb2rw: checks
qAdBJlVNsNTwiHia50eMvg: bets $4
wk6Ohn4GDozoOMHc4eb2rw: calls $4
*** SHOW DOWN ***
qAdBJlVNsNTwiHia50eMvg: shows [Kh Qh] (a straight, Three to Seven)
wk6Ohn4GDozoOMHc4eb2rw: shows [Ad Ks] (a straight, Three to Seven)
wk6Ohn4GDozoOMHc4eb2rw collected $8.35 from pot
qAdBJlVNsNTwiHia50eMvg collected $8.30 from pot
*** SUMMARY ***
Total pot $17.50 | Rake $0.85
Board [4d 7s 3h 5s 6h]
Seat 1: /P4w1pHg2zHYg/4ubJ0dPw (small blind) folded before Flop
Seat 2: XOIf9W+VAxhZqN+SYoyMKA (big blind) folded before Flop
Seat 3: G5ZSSN6RSON3gkNvk/SmYg folded before Flop (didn't bet)
Seat 4: wk6Ohn4GDozoOMHc4eb2rw showed [Ad Ks] and won ($8.35) with a straight, Three to Seven
Seat 5: 2DwLxMUbmzvwY7o4/i47Xg folded before Flop (didn't bet)
Seat 6: qAdBJlVNsNTwiHia50eMvg (button) showed [Kh Qh] and won ($8.30) with a straight, Three to Seven



PokerStars Game #59939974224:  Hold'em No Limit ($0.50/$1.00) - 2009/07/01 0:53:53 ET
Table 'cBDNutyLBKEk9+ptwsKmTw' 6-max Seat #4 is the button
Seat 1: xAU6q2/cwmby2sxmA8VcmA ($100 in chips)
Seat 2: 5lY8d6Cnm4HUkt/8FZSj4g ($103.65 in chips)
Seat 3: G5ZSSN6RSON3gkNvk/SmYg ($103.15 in chips)
Seat 4: 3q7F5QtzC30pSrn0nl9i+A ($34.10 in chips)
Seat 5: OGMLOcTNYZXZU81au7ztUw ($159.15 in chips)
Seat 6: NqVlOSH2lp+pp/TK3vvK5g ($36 in chips)
OGMLOcTNYZXZU81au7ztUw: posts small blind $0.50
NqVlOSH2lp+pp/TK3vvK5g: posts big blind $1
*** HOLE CARDS ***
xAU6q2/cwmby2sxmA8VcmA: folds
5lY8d6Cnm4HUkt/8FZSj4g: folds
G5ZSSN6RSON3gkNvk/SmYg: folds
3q7F5QtzC30pSrn0nl9i+A: calls $1
OGMLOcTNYZXZU81au7ztUw: folds
NqVlOSH2lp+pp/TK3vvK5g: checks
*** FLOP *** [Ts 8c Jh]
NqVlOSH2lp+pp/TK3vvK5g: checks
3q7F5QtzC30pSrn0nl9i+A: bets $2
NqVlOSH2lp+pp/TK3vvK5g: folds
3q7F5QtzC30pSrn0nl9i+A collected $2.40 from pot
*** SUMMARY ***
Total pot $2.50 | Rake $0.10
Board [Ts 8c Jh]
Seat 1: xAU6q2/cwmby2sxmA8VcmA folded before Flop (didn't bet)
Seat 2: 5lY8d6Cnm4HUkt/8FZSj4g folded before Flop (didn't bet)
Seat 3: G5ZSSN6RSON3gkNvk/SmYg folded before Flop (didn't bet)
Seat 4: 3q7F5QtzC30pSrn0nl9i+A (button) collected ($2.40)
Seat 5: OGMLOcTNYZXZU81au7ztUw (small blind) folded before Flop
Seat 6: NqVlOSH2lp+pp/TK3vvK5g (big blind) folded on the Flop



PokerStars Game #59939974670:  Hold'em No Limit ($0.50/$1.00) - 2009/07/01 0:53:54 ET
Table 'eU3bWpDDg3Z+9R4m4iVmog' 6-max Seat #5 is the button
Seat 1: TSuRyAHnUPCFjP7Z0rEE0w ($192.65 in chips)
Seat 2: 8CAoOzhmB8n3nRFf3V4BTg ($84.95 in chips)
Seat 3: U6tnjwZRpTnM+YkqkCjwyQ ($187.15 in chips)
Seat 4: GDVIsbEJ/DOJsMKE4Asz0A ($91.10 in chips)
Seat 5: AdLVjddOzm+sRNo1Bc3S6Q ($110.55 in chips)
Seat 6: hpxXcmRkXXI9HE5+5/j/0Q ($105.45 in chips)
hpxXcmRkXXI9HE5+5/j/0Q: posts small blind $0.50
TSuRyAHnUPCFjP7Z0rEE0w: posts big blind $1
*** HOLE CARDS ***
8CAoOzhmB8n3nRFf3V4BTg: folds
U6tnjwZRpTnM+YkqkCjwyQ: raises $2 to $3
GDVIsbEJ/DOJsMKE4Asz0A: folds
AdLVjddOzm+sRNo1Bc3S6Q: folds
hpxXcmRkXXI9HE5+5/j/0Q: folds
TSuRyAHnUPCFjP7Z0rEE0w: folds
U6tnjwZRpTnM+YkqkCjwyQ collected $2.50 from pot
*** SUMMARY ***
Total pot $2.50 | Rake $0
Seat 1: TSuRyAHnUPCFjP7Z0rEE0w (big blind) folded before Flop
Seat 2: 8CAoOzhmB8n3nRFf3V4BTg folded before Flop (didn't bet)
Seat 3: U6tnjwZRpTnM+YkqkCjwyQ collected ($2.50)
Seat 4: GDVIsbEJ/DOJsMKE4Asz0A folded before Flop (didn't bet)
Seat 5: AdLVjddOzm+sRNo1Bc3S6Q (button) folded before Flop (didn't bet)
Seat 6: hpxXcmRkXXI9HE5+5/j/0Q (small blind) folded before Flop



PokerStars Game #59939974746:  Hold'em No Limit ($0.50/$1.00) - 2009/07/01 0:53:54 ET
Table '7O9fB8yx1u7sJveJn8w6jA' 6-max Seat #6 is the button
Seat 1: jy52+7FotjH63o5tEEVgKw ($136.35 in chips)
Seat 2: wx3sQGkVi2x9wJXuWNHPBw ($192.50 in chips)
Seat 3: hpxXcmRkXXI9HE5+5/j/0Q ($100 in chips)
Seat 4: XIZSmlGttGgSRaIU42K4Fg ($104.55 in chips)
Seat 5: BCEV3COoKY607AzLWayfRA ($100.40 in chips)
Seat 6: UBZQqpnJZdTYYY1FTb0rLA ($128.95 in chips)
jy52+7FotjH63o5tEEVgKw: posts small blind $0.50
wx3sQGkVi2x9wJXuWNHPBw: posts big blind $1
*** HOLE CARDS ***
hpxXcmRkXXI9HE5+5/j/0Q: folds
XIZSmlGttGgSRaIU42K4Fg: raises $2 to $3
BCEV3COoKY607AzLWayfRA: calls $3
UBZQqpnJZdTYYY1FTb0rLA: folds
jy52+7FotjH63o5tEEVgKw: folds
wx3sQGkVi2x9wJXuWNHPBw: folds
*** FLOP *** [4c 3h 5h]
XIZSmlGttGgSRaIU42K4Fg: bets $4
BCEV3COoKY607AzLWayfRA: calls $4
*** TURN *** [4c 3h 5h] [5s]
XIZSmlGttGgSRaIU42K4Fg: checks
BCEV3COoKY607AzLWayfRA: bets $11
XIZSmlGttGgSRaIU42K4Fg: calls $11
*** RIVER *** [4c 3h 5h 5s] [5d]
XIZSmlGttGgSRaIU42K4Fg: checks
BCEV3COoKY607AzLWayfRA: checks
*** SHOW DOWN ***
XIZSmlGttGgSRaIU42K4Fg: shows [Ac Kh] (three of a kind, Fives)
BCEV3COoKY607AzLWayfRA: mucks hand
XIZSmlGttGgSRaIU42K4Fg collected $35.70 from pot
*** SUMMARY ***
Total pot $37.50 | Rake $1.80
Board [4c 3h 5h 5s 5d]
Seat 1: jy52+7FotjH63o5tEEVgKw (small blind) folded before Flop
Seat 2: wx3sQGkVi2x9wJXuWNHPBw (big blind) folded before Flop
Seat 3: hpxXcmRkXXI9HE5+5/j/0Q folded before Flop (didn't bet)
Seat 4: XIZSmlGttGgSRaIU42K4Fg showed [Ac Kh] and won ($35.70) with three of a kind, Fives
Seat 5: BCEV3COoKY607AzLWayfRA mucked
Seat 6: UBZQqpnJZdTYYY1FTb0rLA (button) folded before Flop (didn't bet)



PokerStars Game #59939976784:  Hold'em No Limit ($0.50/$1.00) - 2009/07/01 0:53:57 ET
Table 'tLrtq7gDzxEvckNAI1OS5Q' 6-max Seat #4 is the button
Seat 1: xNKcQzD9+/iHmtJn4vYq9w ($97.05 in chips)
Seat 2: QHvTZcrKe6+maWUfVjP29Q ($100.85 in chips)
Seat 3: TPZ+m9x+lwoKpv7TMfAUWA ($202.20 in chips)
Seat 4: +uSzP8Jwnw7sKfQ4s66b7w ($47.15 in chips)
Seat 5: OGMLOcTNYZXZU81au7ztUw ($170.65 in chips)
Seat 6: XUk5GQsfNFpHvaToDZ0rZA ($168.20 in chips)
OGMLOcTNYZXZU81au7ztUw: posts small blind $0.50
XUk5GQsfNFpHvaToDZ0rZA: posts big blind $1
*** HOLE CARDS ***
xNKcQzD9+/iHmtJn4vYq9w: folds
QHvTZcrKe6+maWUfVjP29Q: folds
TPZ+m9x+lwoKpv7TMfAUWA: folds
+uSzP8Jwnw7sKfQ4s66b7w: folds
OGMLOcTNYZXZU81au7ztUw: folds
XUk5GQsfNFpHvaToDZ0rZA collected $1 from pot
XUk5GQsfNFpHvaToDZ0rZA: doesn't show hand
*** SUMMARY ***
Total pot $1 | Rake $0
Seat 1: xNKcQzD9+/iHmtJn4vYq9w folded before Flop (didn't bet)
Seat 2: QHvTZcrKe6+maWUfVjP29Q folded before Flop (didn't bet)
Seat 3: TPZ+m9x+lwoKpv7TMfAUWA folded before Flop (didn't bet)
Seat 4: +uSzP8Jwnw7sKfQ4s66b7w (button) folded before Flop (didn't bet)
Seat 5: OGMLOcTNYZXZU81au7ztUw (small blind) folded before Flop
Seat 6: XUk5GQsfNFpHvaToDZ0rZA (big blind) collected ($1)



PokerStars Game #59939976748:  Hold'em No Limit ($0.50/$1.00) - 2009/07/01 0:53:57 ET
Table 'uNlePsyMIqzM691Xkrlk6Q' 9-max Seat #1 is the button
Seat 1: bLbSOSmSOnqE0iTcH/5dxA ($100 in chips)
Seat 2: +OqpStnt0FqbCfyHAWaLbg ($86.60 in chips)
Seat 3: h7qXkU57Bb8ZuPwMyxR8Ug ($30.25 in chips)
Seat 4: TZcz9MEWDA+WydgGruqqbw ($101.15 in chips)
Seat 5: 3obndzTJ6fECz8+wWhMd1w ($18.50 in chips)
Seat 6: myIxN7otsyr846M539YR8Q ($18.50 in chips)
Seat 7: w6cw9nzN7AvkkHBVVjykoQ ($55.75 in chips)
Seat 8: laA8va+Yv8WuMqT1zdR91g ($101 in chips)
Seat 9: vR4IO10geOgvTW+LAUBv/A ($100 in chips)
+OqpStnt0FqbCfyHAWaLbg: posts small blind $0.50
h7qXkU57Bb8ZuPwMyxR8Ug: posts big blind $1
*** HOLE CARDS ***
TZcz9MEWDA+WydgGruqqbw: raises $2.50 to $3.50
3obndzTJ6fECz8+wWhMd1w: folds
myIxN7otsyr846M539YR8Q: folds
w6cw9nzN7AvkkHBVVjykoQ: folds
laA8va+Yv8WuMqT1zdR91g: folds
vR4IO10geOgvTW+LAUBv/A: folds
bLbSOSmSOnqE0iTcH/5dxA: folds
+OqpStnt0FqbCfyHAWaLbg: folds
h7qXkU57Bb8ZuPwMyxR8Ug: folds
TZcz9MEWDA+WydgGruqqbw collected $2.50 from pot
TZcz9MEWDA+WydgGruqqbw: doesn't show hand
*** SUMMARY ***
Total pot $2.50 | Rake $0
Seat 1: bLbSOSmSOnqE0iTcH/5dxA (button) folded before Flop (didn't bet)
Seat 2: +OqpStnt0FqbCfyHAWaLbg (small blind) folded before Flop
Seat 3: h7qXkU57Bb8ZuPwMyxR8Ug (big blind) folded before Flop
Seat 4: TZcz9MEWDA+WydgGruqqbw collected ($2.50)
Seat 5: 3obndzTJ6fECz8+wWhMd1w folded before Flop (didn't bet)
Seat 6: myIxN7otsyr846M539YR8Q folded before Flop (didn't bet)
Seat 7: w6cw9nzN7AvkkHBVVjykoQ folded before Flop (didn't bet)
Seat 8: laA8va+Yv8WuMqT1zdR91g folded before Flop (didn't bet)
Seat 9: vR4IO10geOgvTW+LAUBv/A folded before Flop (didn't bet)



PokerStars Game #59939977644:  Hold'em No Limit ($0.50/$1.00) - 2009/07/01 0:53:58 ET
Table '8jIjWCPY0NGprquL+xcMFg' 9-max Seat #1 is the button
Seat 1: vR4IO10geOgvTW+LAUBv/A ($134.55 in chips)
Seat 2: laA8va+Yv8WuMqT1zdR91g ($106.55 in chips)
Seat 3: tjhwe1V98x2spSoUQER3HQ ($104.50 in chips)
Seat 4: Jjc7EHWzs4//xUAjJ0UWoA ($20 in chips)
Seat 5: 2YpnxJiexJHyERfbqgwEcw ($87.05 in chips)
Seat 6: GTQkFJtSkbVbnGCktp6e3g ($102.85 in chips)
Seat 7: O3CGPwwUmamrCNHccOilrg ($45.45 in chips)
Seat 9: negfosHnGOZXSHpWDRKyBQ ($20 in chips)
laA8va+Yv8WuMqT1zdR91g: posts small blind $0.50
tjhwe1V98x2spSoUQER3HQ: posts big blind $1
D+W9Me7w6Hcx/WRUSKV0dw: sits out
*** HOLE CARDS ***
Jjc7EHWzs4//xUAjJ0UWoA: folds
2YpnxJiexJHyERfbqgwEcw: folds
GTQkFJtSkbVbnGCktp6e3g: folds
O3CGPwwUmamrCNHccOilrg: folds
negfosHnGOZXSHpWDRKyBQ: raises $2 to $3
vR4IO10geOgvTW+LAUBv/A: folds
laA8va+Yv8WuMqT1zdR91g: folds
tjhwe1V98x2spSoUQER3HQ: folds
negfosHnGOZXSHpWDRKyBQ collected $2.50 from pot
negfosHnGOZXSHpWDRKyBQ: doesn't show hand
*** SUMMARY ***
Total pot $2.50 | Rake $0
Seat 1: vR4IO10geOgvTW+LAUBv/A (button) folded before Flop (didn't bet)
Seat 2: laA8va+Yv8WuMqT1zdR91g (small blind) folded before Flop
Seat 3: tjhwe1V98x2spSoUQER3HQ (big blind) folded before Flop
Seat 4: Jjc7EHWzs4//xUAjJ0UWoA folded before Flop (didn't bet)
Seat 5: 2YpnxJiexJHyERfbqgwEcw folded before Flop (didn't bet)
Seat 6: GTQkFJtSkbVbnGCktp6e3g folded before Flop (didn't bet)
Seat 7: O3CGPwwUmamrCNHccOilrg folded before Flop (didn't bet)
Seat 9: negfosHnGOZXSHpWDRKyBQ collected ($2.50)



PokerStars Game #59939978088:  Hold'em No Limit ($0.50/$1.00) - 2009/07/01 0:53:59 ET
Table 'GPp0HyAuggN8oE0sUWzPpA' 9-max Seat #6 is the button
Seat 1: qJr25HAtvv1w/7IBvjMM3g ($27.50 in chips)
Seat 2: m3U8I35Pn3gxKhoS2nmYIg ($61.20 in chips)
Seat 3: CCCXsirC+bO7ginAuUUVlQ ($62.80 in chips)
Seat 4: mBRWbnUl8diyBO1qTJaNzw ($107.20 in chips)
Seat 5: 0fXz44fzDo5QmhAaJCvFfA ($24.65 in chips)
Seat 6: BK/GtNPkSx0TdUDj82id5A ($10 in chips)
Seat 7: DHdbHyysD15wCAtx+BhUjA ($99 in chips)
Seat 9: VPF+HjszMvUIpy0CHIwH3A ($23.50 in chips)
DHdbHyysD15wCAtx+BhUjA: posts small blind $0.50
tkdBeXTJlFsZdioidNqLow: is sitting out
VPF+HjszMvUIpy0CHIwH3A: posts big blind $1
*** HOLE CARDS ***
qJr25HAtvv1w/7IBvjMM3g: folds
m3U8I35Pn3gxKhoS2nmYIg: folds
tkdBeXTJlFsZdioidNqLow leaves the table
CCCXsirC+bO7ginAuUUVlQ has timed out
CCCXsirC+bO7ginAuUUVlQ: folds
CCCXsirC+bO7ginAuUUVlQ is sitting out
mBRWbnUl8diyBO1qTJaNzw: raises $3 to $4
0fXz44fzDo5QmhAaJCvFfA: folds
BK/GtNPkSx0TdUDj82id5A: folds
DHdbHyysD15wCAtx+BhUjA: folds
VPF+HjszMvUIpy0CHIwH3A: folds
mBRWbnUl8diyBO1qTJaNzw collected $2.50 from pot
*** SUMMARY ***
Total pot $2.50 | Rake $0
Seat 1: qJr25HAtvv1w/7IBvjMM3g folded before Flop (didn't bet)
Seat 2: m3U8I35Pn3gxKhoS2nmYIg folded before Flop (didn't bet)
Seat 3: CCCXsirC+bO7ginAuUUVlQ folded before Flop (didn't bet)
Seat 4: mBRWbnUl8diyBO1qTJaNzw collected ($2.50)
Seat 5: 0fXz44fzDo5QmhAaJCvFfA folded before Flop (didn't bet)
Seat 6: BK/GtNPkSx0TdUDj82id5A (button) folded before Flop (didn't bet)
Seat 7: DHdbHyysD15wCAtx+BhUjA (small blind) folded before Flop
Seat 9: VPF+HjszMvUIpy0CHIwH3A (big blind) folded before Flop



PokerStars Game #59939978326:  Hold'em No Limit ($0.50/$1.00) - 2009/07/01 0:53:59 ET
Table '6YvsYDPNIDx2v5z3bJnwZQ' 9-max Seat #7 is the button
Seat 1: Ogn4JDV3mp4ZDKO49IFzKA ($19.70 in chips)
Seat 2: x80+i7DJL+81v3quj7KbNg ($20 in chips)
Seat 3: negfosHnGOZXSHpWDRKyBQ ($20 in chips)
Seat 4: kEr5NYB+JIG5+szcYMr6hA ($41.25 in chips)
Seat 5: mBRWbnUl8diyBO1qTJaNzw ($165.20 in chips)
Seat 6: 7RSwrjMohkYrZAhOd1uaZg ($15 in chips)
Seat 7: mae7OMTaJ/MFimNbZegCkg ($53.80 in chips)
Seat 8: PSFxpXgPedVZyHSu2Zhb7Q ($103.40 in chips)
Seat 9: ZgMRSHJ9EOtPeVHmdeV9kQ ($57 in chips)
PSFxpXgPedVZyHSu2Zhb7Q: posts small blind $0.50
ZgMRSHJ9EOtPeVHmdeV9kQ: posts big blind $1
*** HOLE CARDS ***
Ogn4JDV3mp4ZDKO49IFzKA: folds
x80+i7DJL+81v3quj7KbNg: folds
negfosHnGOZXSHpWDRKyBQ: folds
kEr5NYB+JIG5+szcYMr6hA: folds
mBRWbnUl8diyBO1qTJaNzw: folds
7RSwrjMohkYrZAhOd1uaZg: folds
mae7OMTaJ/MFimNbZegCkg: raises $2 to $3
PSFxpXgPedVZyHSu2Zhb7Q: folds
ZgMRSHJ9EOtPeVHmdeV9kQ: folds
mae7OMTaJ/MFimNbZegCkg collected $2.50 from pot
*** SUMMARY ***
Total pot $2.50 | Rake $0
Seat 1: Ogn4JDV3mp4ZDKO49IFzKA folded before Flop (didn't bet)
Seat 2: x80+i7DJL+81v3quj7KbNg folded before Flop (didn't bet)
Seat 3: negfosHnGOZXSHpWDRKyBQ folded before Flop (didn't bet)
Seat 4: kEr5NYB+JIG5+szcYMr6hA folded before Flop (didn't bet)
Seat 5: mBRWbnUl8diyBO1qTJaNzw folded before Flop (didn't bet)
Seat 6: 7RSwrjMohkYrZAhOd1uaZg folded before Flop (didn't bet)
Seat 7: mae7OMTaJ/MFimNbZegCkg (button) collected ($2.50)
Seat 8: PSFxpXgPedVZyHSu2Zhb7Q (small blind) folded before Flop
Seat 9: ZgMRSHJ9EOtPeVHmdeV9kQ (big blind) folded before Flop



PokerStars Game #59939978464:  Hold'em No Limit ($0.50/$1.00) - 2009/07/01 0:54:00 ET
Table '/RZcOwpZpHQ+OwPwjsbnRw' 6-max Seat #1 is the button
Seat 1: Zboa6dColKGHBjLPUakZjw ($34.20 in chips)
Seat 2: +xW7QemQU0Fxs+4TnqBRow ($206.65 in chips)
Seat 3: XnT1yK2DD/5FL+0bwuEhqg ($46.45 in chips)
Seat 4: j7NIOHLZk7V2o9fOioO5ug ($113.85 in chips)
Seat 5: wx3sQGkVi2x9wJXuWNHPBw ($180.65 in chips)
Seat 6: XOIf9W+VAxhZqN+SYoyMKA ($291.75 in chips)
+xW7QemQU0Fxs+4TnqBRow: posts small blind $0.50
XnT1yK2DD/5FL+0bwuEhqg: posts big blind $1
*** HOLE CARDS ***
j7NIOHLZk7V2o9fOioO5ug: folds
wx3sQGkVi2x9wJXuWNHPBw: folds
XOIf9W+VAxhZqN+SYoyMKA: folds
Zboa6dColKGHBjLPUakZjw: raises $1 to $2
+xW7QemQU0Fxs+4TnqBRow: folds
XnT1yK2DD/5FL+0bwuEhqg: folds
Zboa6dColKGHBjLPUakZjw collected $2.50 from pot
*** SUMMARY ***
Total pot $2.50 | Rake $0
Seat 1: Zboa6dColKGHBjLPUakZjw (button) collected ($2.50)
Seat 2: +xW7QemQU0Fxs+4TnqBRow (small blind) folded before Flop
Seat 3: XnT1yK2DD/5FL+0bwuEhqg (big blind) folded before Flop
Seat 4: j7NIOHLZk7V2o9fOioO5ug folded before Flop (didn't bet)
Seat 5: wx3sQGkVi2x9wJXuWNHPBw folded before Flop (didn't bet)
Seat 6: XOIf9W+VAxhZqN+SYoyMKA folded before Flop (didn't bet)



PokerStars Game #59939978460:  Hold'em No Limit ($0.50/$1.00) - 2009/07/01 0:54:00 ET
Table 'JOIm/fogLA7vSG0Vc6ME1A' 2-max Seat #1 is the button
Seat 1: NYi6JFscYNrofSXy4sM+Yw ($120.50 in chips)
Seat 2: F5lNTyZLIX9W2wQZ0plwgg ($133.60 in chips)
NYi6JFscYNrofSXy4sM+Yw: posts small blind $0.50
F5lNTyZLIX9W2wQZ0plwgg: posts big blind $1
*** HOLE CARDS ***
NYi6JFscYNrofSXy4sM+Yw: raises $2 to $3
F5lNTyZLIX9W2wQZ0plwgg: raises $2 to $5
NYi6JFscYNrofSXy4sM+Yw: calls $2
*** FLOP *** [7s 3h As]
F5lNTyZLIX9W2wQZ0plwgg: bets $4
NYi6JFscYNrofSXy4sM+Yw: calls $4
*** TURN *** [7s 3h As] [4s]
F5lNTyZLIX9W2wQZ0plwgg: bets $6
NYi6JFscYNrofSXy4sM+Yw: calls $6
*** RIVER *** [7s 3h As 4s] [5c]
F5lNTyZLIX9W2wQZ0plwgg: bets $4
NYi6JFscYNrofSXy4sM+Yw: raises $21 to $25
F5lNTyZLIX9W2wQZ0plwgg: folds
NYi6JFscYNrofSXy4sM+Yw collected $37.50 from pot
*** SUMMARY ***
Total pot $38 | Rake $0.50
Board [7s 3h As 4s 5c]
Seat 1: NYi6JFscYNrofSXy4sM+Yw (button) (small blind) collected ($37.50)
Seat 2: F5lNTyZLIX9W2wQZ0plwgg (big blind) folded on the River



PokerStars Game #59939980630:  Hold'em No Limit ($0.50/$1.00) - 2009/07/01 0:54:03 ET
Table 'LmXQK9xy3awB+qsPzI21Mw' 2-max Seat #1 is the button
Seat 1: NYi6JFscYNrofSXy4sM+Yw ($326.85 in chips)
Seat 2: TME8GvochpQAo8cmJwWmvA ($65.30 in chips)
NYi6JFscYNrofSXy4sM+Yw: posts small blind $0.50
TME8GvochpQAo8cmJwWmvA: posts big blind $1
*** HOLE CARDS ***
NYi6JFscYNrofSXy4sM+Yw: raises $2 to $3
TME8GvochpQAo8cmJwWmvA: folds
NYi6JFscYNrofSXy4sM+Yw collected $2 from pot
*** SUMMARY ***
Total pot $2 | Rake $0
Seat 1: NYi6JFscYNrofSXy4sM+Yw (button) (small blind) collected ($2)
Seat 2: TME8GvochpQAo8cmJwWmvA (big blind) folded before Flop



PokerStars Game #59939984432:  Hold'em No Limit ($0.50/$1.00) - 2009/07/01 0:54:09 ET
Table 'LmXQK9xy3awB+qsPzI21Mw' 2-max Seat #2 is the button
Seat 1: NYi6JFscYNrofSXy4sM+Yw ($327.85 in chips)
Seat 2: TME8GvochpQAo8cmJwWmvA ($64.30 in chips)
TME8GvochpQAo8cmJwWmvA: posts small blind $0.50
NYi6JFscYNrofSXy4sM+Yw: posts big blind $1
*** HOLE CARDS ***
TME8GvochpQAo8cmJwWmvA: calls $0.50
NYi6JFscYNrofSXy4sM+Yw: checks
*** FLOP *** [7s Qh Jc]
NYi6JFscYNrofSXy4sM+Yw: checks
TME8GvochpQAo8cmJwWmvA: checks
*** TURN *** [7s Qh Jc] [2d]
NYi6JFscYNrofSXy4sM+Yw: bets $2
TME8GvochpQAo8cmJwWmvA: raises $2 to $4
NYi6JFscYNrofSXy4sM+Yw: folds
TME8GvochpQAo8cmJwWmvA collected $5.75 from pot
TME8GvochpQAo8cmJwWmvA: doesn't show hand
*** SUMMARY ***
Total pot $6 | Rake $0.25
Board [7s Qh Jc 2d]
Seat 1: NYi6JFscYNrofSXy4sM+Yw (big blind) folded on the Turn
Seat 2: TME8GvochpQAo8cmJwWmvA (button) (small blind) collected ($5.75)



PokerStars Game #59939984834:  Hold'em No Limit ($0.50/$1.00) - 2009/07/01 0:54:10 ET
Table 'W/wyObTiXZm+Ckkl3YxcSw' 6-max Seat #4 is the button
Seat 1: eUBBn2R56C1IQ6Cs/vitwg ($110.75 in chips)
Seat 2: oDiBRCaF0QVtd3kO6xZIXw ($97.30 in chips)
Seat 3: ybGsYWp1MLwy1vSnP8egXg ($25 in chips)
Seat 4: +xW7QemQU0Fxs+4TnqBRow ($111.90 in chips)
Seat 5: BdbmJTZZ47quA9vUWwXtlw ($66.35 in chips)
Seat 6: tS9JHB1h+FQ++qu8RwRNgg ($19 in chips)
BdbmJTZZ47quA9vUWwXtlw: posts small blind $0.50
tS9JHB1h+FQ++qu8RwRNgg: posts big blind $1
*** HOLE CARDS ***
eUBBn2R56C1IQ6Cs/vitwg: folds
oDiBRCaF0QVtd3kO6xZIXw: folds
ybGsYWp1MLwy1vSnP8egXg: calls $1
+xW7QemQU0Fxs+4TnqBRow: folds
BdbmJTZZ47quA9vUWwXtlw: folds
tS9JHB1h+FQ++qu8RwRNgg: checks
*** FLOP *** [7d 5d 3d]
tS9JHB1h+FQ++qu8RwRNgg: bets $3
ybGsYWp1MLwy1vSnP8egXg: folds
ybGsYWp1MLwy1vSnP8egXg leaves the table
tS9JHB1h+FQ++qu8RwRNgg collected $2.40 from pot
tS9JHB1h+FQ++qu8RwRNgg: doesn't show hand
*** SUMMARY ***
Total pot $2.50 | Rake $0.10
Board [7d 5d 3d]
Seat 1: eUBBn2R56C1IQ6Cs/vitwg folded before Flop (didn't bet)
Seat 2: oDiBRCaF0QVtd3kO6xZIXw folded before Flop (didn't bet)
Seat 3: ybGsYWp1MLwy1vSnP8egXg folded on the Flop
Seat 4: +xW7QemQU0Fxs+4TnqBRow (button) folded before Flop (didn't bet)
Seat 5: BdbmJTZZ47quA9vUWwXtlw (small blind) folded before Flop
Seat 6: tS9JHB1h+FQ++qu8RwRNgg (big blind) collected ($2.40)



PokerStars Game #59939986420:  Hold'em No Limit ($0.50/$1.00) - 2009/07/01 0:54:13 ET
Table 'eU3bWpDDg3Z+9R4m4iVmog' 6-max Seat #6 is the button
Seat 1: TSuRyAHnUPCFjP7Z0rEE0w ($191.65 in chips)
Seat 2: 8CAoOzhmB8n3nRFf3V4BTg ($84.95 in chips)
Seat 3: U6tnjwZRpTnM+YkqkCjwyQ ($188.65 in chips)
Seat 4: GDVIsbEJ/DOJsMKE4Asz0A ($91.10 in chips)
Seat 5: AdLVjddOzm+sRNo1Bc3S6Q ($110.55 in chips)
Seat 6: hpxXcmRkXXI9HE5+5/j/0Q ($104.95 in chips)
TSuRyAHnUPCFjP7Z0rEE0w: posts small blind $0.50
8CAoOzhmB8n3nRFf3V4BTg: posts big blind $1
*** HOLE CARDS ***
U6tnjwZRpTnM+YkqkCjwyQ: folds
U6tnjwZRpTnM+YkqkCjwyQ leaves the table
GDVIsbEJ/DOJsMKE4Asz0A: folds
AdLVjddOzm+sRNo1Bc3S6Q: folds
hpxXcmRkXXI9HE5+5/j/0Q: folds
TSuRyAHnUPCFjP7Z0rEE0w: raises $3 to $4
8CAoOzhmB8n3nRFf3V4BTg: folds
TSuRyAHnUPCFjP7Z0rEE0w collected $2 from pot
TSuRyAHnUPCFjP7Z0rEE0w: doesn't show hand
*** SUMMARY ***
Total pot $2 | Rake $0
Seat 1: TSuRyAHnUPCFjP7Z0rEE0w (small blind) collected ($2)
Seat 2: 8CAoOzhmB8n3nRFf3V4BTg (big blind) folded before Flop
Seat 3: U6tnjwZRpTnM+YkqkCjwyQ folded before Flop (didn't bet)
Seat 4: GDVIsbEJ/DOJsMKE4Asz0A folded before Flop (didn't bet)
Seat 5: AdLVjddOzm+sRNo1Bc3S6Q folded before Flop (didn't bet)
Seat 6: hpxXcmRkXXI9HE5+5/j/0Q (button) folded before Flop (didn't bet)



PokerStars Game #59939987050:  Hold'em No Limit ($0.50/$1.00) - 2009/07/01 0:54:14 ET
Table 'mmbQQVBTrPdE+wy+s+9VPA' 6-max Seat #2 is the button
Seat 1: JwCcjZl0bjJzG7hmE0dnTA ($100 in chips)
Seat 2: +W6OnF033KNM2xH0fGj98Q ($140.60 in chips)
Seat 3: wx3sQGkVi2x9wJXuWNHPBw ($114.65 in chips)
Seat 4: V3iZdcw61nXF3g5hD2RrsQ ($100 in chips)
Seat 5: YMJG+F++3Aj6P8dAWda5fw ($99.50 in chips)
Seat 6: U2CWBTv29qdCbj8RNF2sIw ($98.50 in chips)
wx3sQGkVi2x9wJXuWNHPBw: posts small blind $0.50
V3iZdcw61nXF3g5hD2RrsQ: posts big blind $1
*** HOLE CARDS ***
YMJG+F++3Aj6P8dAWda5fw: folds
U2CWBTv29qdCbj8RNF2sIw: folds
JwCcjZl0bjJzG7hmE0dnTA: folds
+W6OnF033KNM2xH0fGj98Q: folds
wx3sQGkVi2x9wJXuWNHPBw: folds
V3iZdcw61nXF3g5hD2RrsQ collected $1 from pot
*** SUMMARY ***
Total pot $1 | Rake $0
Seat 1: JwCcjZl0bjJzG7hmE0dnTA folded before Flop (didn't bet)
Seat 2: +W6OnF033KNM2xH0fGj98Q (button) folded before Flop (didn't bet)
Seat 3: wx3sQGkVi2x9wJXuWNHPBw (small blind) folded before Flop
Seat 4: V3iZdcw61nXF3g5hD2RrsQ (big blind) collected ($1)
Seat 5: YMJG+F++3Aj6P8dAWda5fw folded before Flop (didn't bet)
Seat 6: U2CWBTv29qdCbj8RNF2sIw folded before Flop (didn't bet)



PokerStars Game #59939987134:  Hold'em No Limit ($0.50/$1.00) - 2009/07/01 0:54:14 ET
Table '3T4owEKJKyGTMePwrv50FQ' 9-max Seat #1 is the button
Seat 1: OGgaARGdJQT4awWVNQ957w ($102.60 in chips)
Seat 2: t+Id2O6herCLgwnC4m49PA ($29 in chips)
Seat 3: mcIWimayoaliQO9lAWdq2g ($19 in chips)
Seat 4: O5Go3jrzbQWxRB6ESK+Ptg ($41 in chips)
Seat 5: Zf2bR/kn7jUw/jpKsEjTNQ ($30.55 in chips)
Seat 6: uY5fSGrOE/U7/OY5kEpYWg ($46.25 in chips)
Seat 7: cU0jfiXoeVju/8azkW6LFw ($15.80 in chips)
Seat 9: 61sfw5QTu62YYIt68OsdrA ($61.30 in chips)
t+Id2O6herCLgwnC4m49PA: posts small blind $0.50
mcIWimayoaliQO9lAWdq2g: posts big blind $1
negfosHnGOZXSHpWDRKyBQ: sits out
*** HOLE CARDS ***
O5Go3jrzbQWxRB6ESK+Ptg: raises $4 to $5
Zf2bR/kn7jUw/jpKsEjTNQ: folds
uY5fSGrOE/U7/OY5kEpYWg: calls $5
cU0jfiXoeVju/8azkW6LFw: folds
61sfw5QTu62YYIt68OsdrA: folds
OGgaARGdJQT4awWVNQ957w: folds
t+Id2O6herCLgwnC4m49PA: folds
mcIWimayoaliQO9lAWdq2g: folds
*** FLOP *** [Kc 2s 8h]
O5Go3jrzbQWxRB6ESK+Ptg: checks
uY5fSGrOE/U7/OY5kEpYWg: checks
*** TURN *** [Kc 2s 8h] [Ad]
O5Go3jrzbQWxRB6ESK+Ptg: checks
uY5fSGrOE/U7/OY5kEpYWg: bets $3
O5Go3jrzbQWxRB6ESK+Ptg: raises $3 to $6
uY5fSGrOE/U7/OY5kEpYWg: calls $3
*** RIVER *** [Kc 2s 8h Ad] [2d]
O5Go3jrzbQWxRB6ESK+Ptg: bets $6
uY5fSGrOE/U7/OY5kEpYWg: raises $6 to $12
O5Go3jrzbQWxRB6ESK+Ptg: calls $6
*** SHOW DOWN ***
uY5fSGrOE/U7/OY5kEpYWg: shows [Td Ah] (two pair, Aces and Deuces)
O5Go3jrzbQWxRB6ESK+Ptg: shows [Qd Ac] (two pair, Aces and Deuces)
O5Go3jrzbQWxRB6ESK+Ptg collected $22.60 from pot
uY5fSGrOE/U7/OY5kEpYWg collected $22.60 from pot
*** SUMMARY ***
Total pot $47.50 | Rake $2.30
Board [Kc 2s 8h Ad 2d]
Seat 1: OGgaARGdJQT4awWVNQ957w (button) folded before Flop (didn't bet)
Seat 2: t+Id2O6herCLgwnC4m49PA (small blind) folded before Flop
Seat 3: mcIWimayoaliQO9lAWdq2g (big blind) folded before Flop
Seat 4: O5Go3jrzbQWxRB6ESK+Ptg showed [Qd Ac] and won ($22.60) with two pair, Aces and Deuces
Seat 5: Zf2bR/kn7jUw/jpKsEjTNQ folded before Flop (didn't bet)
Seat 6: uY5fSGrOE/U7/OY5kEpYWg showed [Td Ah] and won ($22.60) with two pair, Aces and Deuces
Seat 7: cU0jfiXoeVju/8azkW6LFw folded before Flop (didn't bet)
Seat 9: 61sfw5QTu62YYIt68OsdrA folded before Flop (didn't bet)



PokerStars Game #59939987928:  Hold'em No Limit ($0.50/$1.00) - 2009/07/01 0:54:15 ET
Table 'SQLOQoANiHscJ8AL7zffbw' 9-max Seat #9 is the button
Seat 1: jPTRd6SpCp4xqAy2XQiTOw ($70.10 in chips)
Seat 2: /zy+DB4S5fUQUSfZWFzYGw ($324.55 in chips)
Seat 3: 0eFnow7+D7veCYQ+CG9FFw ($94.85 in chips)
Seat 4: /mfensKw8/iZ1Vrx33S4xg ($21.50 in chips)
Seat 5: L9njYvloJ1NdXjP8edHEAg ($105.60 in chips)
Seat 6: p5UKaxVobvptF0ANhR/q1A ($173 in chips)
Seat 7: bJckevFOcg//s0qyMQI6sQ ($100 in chips)
Seat 8: 2BV+oJIQYr65IO6nEChvbA ($60 in chips)
Seat 9: qJr25HAtvv1w/7IBvjMM3g ($197.25 in chips)
jPTRd6SpCp4xqAy2XQiTOw: posts small blind $0.50
/zy+DB4S5fUQUSfZWFzYGw: posts big blind $1
*** HOLE CARDS ***
0eFnow7+D7veCYQ+CG9FFw: folds
/mfensKw8/iZ1Vrx33S4xg: folds
L9njYvloJ1NdXjP8edHEAg: folds
p5UKaxVobvptF0ANhR/q1A: folds
bJckevFOcg//s0qyMQI6sQ: folds
2BV+oJIQYr65IO6nEChvbA: folds
qJr25HAtvv1w/7IBvjMM3g: raises $2 to $3
jPTRd6SpCp4xqAy2XQiTOw: calls $2.50
/zy+DB4S5fUQUSfZWFzYGw: folds
*** FLOP *** [Th 3h 9c]
jPTRd6SpCp4xqAy2XQiTOw: checks
qJr25HAtvv1w/7IBvjMM3g: bets $4
jPTRd6SpCp4xqAy2XQiTOw: folds
qJr25HAtvv1w/7IBvjMM3g collected $6.65 from pot
*** SUMMARY ***
Total pot $7 | Rake $0.35
Board [Th 3h 9c]
Seat 1: jPTRd6SpCp4xqAy2XQiTOw (small blind) folded on the Flop
Seat 2: /zy+DB4S5fUQUSfZWFzYGw (big blind) folded before Flop
Seat 3: 0eFnow7+D7veCYQ+CG9FFw folded before Flop (didn't bet)
Seat 4: /mfensKw8/iZ1Vrx33S4xg folded before Flop (didn't bet)
Seat 5: L9njYvloJ1NdXjP8edHEAg folded before Flop (didn't bet)
Seat 6: p5UKaxVobvptF0ANhR/q1A folded before Flop (didn't bet)
Seat 7: bJckevFOcg//s0qyMQI6sQ folded before Flop (didn't bet)
Seat 8: 2BV+oJIQYr65IO6nEChvbA folded before Flop (didn't bet)
Seat 9: qJr25HAtvv1w/7IBvjMM3g (button) collected ($6.65)



PokerStars Game #59939988548:  Hold'em No Limit ($0.50/$1.00) - 2009/07/01 0:54:16 ET
Table '/RZcOwpZpHQ+OwPwjsbnRw' 6-max Seat #2 is the button
Seat 1: Zboa6dColKGHBjLPUakZjw ($35.70 in chips)
Seat 2: +xW7QemQU0Fxs+4TnqBRow ($206.15 in chips)
Seat 3: XnT1yK2DD/5FL+0bwuEhqg ($45.45 in chips)
Seat 4: j7NIOHLZk7V2o9fOioO5ug ($113.85 in chips)
Seat 5: wx3sQGkVi2x9wJXuWNHPBw ($180.65 in chips)
Seat 6: XOIf9W+VAxhZqN+SYoyMKA ($291.75 in chips)
XnT1yK2DD/5FL+0bwuEhqg: posts small blind $0.50
j7NIOHLZk7V2o9fOioO5ug: posts big blind $1
*** HOLE CARDS ***
wx3sQGkVi2x9wJXuWNHPBw: folds
XOIf9W+VAxhZqN+SYoyMKA: folds
Zboa6dColKGHBjLPUakZjw: raises $1 to $2
+xW7QemQU0Fxs+4TnqBRow: folds
XnT1yK2DD/5FL+0bwuEhqg: folds
j7NIOHLZk7V2o9fOioO5ug: raises $6 to $8
Zboa6dColKGHBjLPUakZjw: calls $6
*** FLOP *** [Ks 9h 7h]
j7NIOHLZk7V2o9fOioO5ug: bets $11
Zboa6dColKGHBjLPUakZjw: calls $11
*** TURN *** [Ks 9h 7h] [5h]
j7NIOHLZk7V2o9fOioO5ug: bets $17
Zboa6dColKGHBjLPUakZjw: calls $16.70 and is all-in
*** RIVER *** [Ks 9h 7h 5h] [8c]
*** SHOW DOWN ***
j7NIOHLZk7V2o9fOioO5ug: shows [Td Ts] (a pair of Tens)
Zboa6dColKGHBjLPUakZjw: shows [Kh Js] (a pair of Kings)
Zboa6dColKGHBjLPUakZjw collected $68.90 from pot
*** SUMMARY ***
Total pot $71.90 | Rake $3
Board [Ks 9h 7h 5h 8c]
Seat 1: Zboa6dColKGHBjLPUakZjw showed [Kh Js] and won ($68.90) with a pair of Kings
Seat 2: +xW7QemQU0Fxs+4TnqBRow (button) folded before Flop (didn't bet)
Seat 3: XnT1yK2DD/5FL+0bwuEhqg (small blind) folded before Flop
Seat 4: j7NIOHLZk7V2o9fOioO5ug (big blind) showed [Td Ts] and lost with a pair of Tens
Seat 5: wx3sQGkVi2x9wJXuWNHPBw folded before Flop (didn't bet)
Seat 6: XOIf9W+VAxhZqN+SYoyMKA folded before Flop (didn't bet)



PokerStars Game #59939989208:  Hold'em No Limit ($0.50/$1.00) - 2009/07/01 0:54:17 ET
Table '7Nl0ffnjeK44/vmeexh3MQ' 9-max Seat #9 is the button
Seat 1: s7D3Y+k4Cj4D1cXHv7oj+Q ($94.70 in chips)
Seat 2: OGgaARGdJQT4awWVNQ957w ($100 in chips)
Seat 3: vR4IO10geOgvTW+LAUBv/A ($100 in chips)
Seat 4: bLbSOSmSOnqE0iTcH/5dxA ($113 in chips)
Seat 5: bL+QVeDcuEdzMGAGg2XJHg ($106.75 in chips)
Seat 6: FVs16t7GgfWgQWt4JxsObQ ($26.20 in chips)
Seat 7: 997ViqAtWn1FPjJqcffwcA ($100 in chips)
Seat 9: ouwUBGRKnKK9uhn1G4Lf+A ($98 in chips)
s7D3Y+k4Cj4D1cXHv7oj+Q: posts small blind $0.50
OGgaARGdJQT4awWVNQ957w: posts big blind $1
D+W9Me7w6Hcx/WRUSKV0dw: sits out
*** HOLE CARDS ***
vR4IO10geOgvTW+LAUBv/A: folds
bLbSOSmSOnqE0iTcH/5dxA: folds
bL+QVeDcuEdzMGAGg2XJHg: folds
FVs16t7GgfWgQWt4JxsObQ: folds
997ViqAtWn1FPjJqcffwcA: folds
ouwUBGRKnKK9uhn1G4Lf+A: raises $2 to $3
s7D3Y+k4Cj4D1cXHv7oj+Q: folds
OGgaARGdJQT4awWVNQ957w: folds
ouwUBGRKnKK9uhn1G4Lf+A collected $2.50 from pot
ouwUBGRKnKK9uhn1G4Lf+A: doesn't show hand
*** SUMMARY ***
Total pot $2.50 | Rake $0
Seat 1: s7D3Y+k4Cj4D1cXHv7oj+Q (small blind) folded before Flop
Seat 2: OGgaARGdJQT4awWVNQ957w (big blind) folded before Flop
Seat 3: vR4IO10geOgvTW+LAUBv/A folded before Flop (didn't bet)
Seat 4: bLbSOSmSOnqE0iTcH/5dxA folded before Flop (didn't bet)
Seat 5: bL+QVeDcuEdzMGAGg2XJHg folded before Flop (didn't bet)
Seat 6: FVs16t7GgfWgQWt4JxsObQ folded before Flop (didn't bet)
Seat 7: 997ViqAtWn1FPjJqcffwcA folded before Flop (didn't bet)
Seat 9: ouwUBGRKnKK9uhn1G4Lf+A (button) collected ($2.50)



PokerStars Game #59939989856:  Hold'em No Limit ($0.50/$1.00) - 2009/07/01 0:54:18 ET
Table 'hugOjcwJvzEwZbK7tyiWuQ' 9-max Seat #4 is the button
Seat 2: r27C1nIV4NS4+qbnrgBQSw ($261 in chips)
Seat 3: jDwhY1kCdc6EkAHbT7PJMQ ($102.15 in chips)
Seat 4: UWB3oeddt/GObx2Mix2Anw ($204.25 in chips)
Seat 5: 5BRGWf+R3nt2WS3b5xX+zA ($27.70 in chips)
Seat 6: gUUvmqdVlmvpal6B8nYrmg ($103.20 in chips)
Seat 7: FL3MrLspcF23LYvC4ipBOA ($113.30 in chips)
Seat 8: /zy+DB4S5fUQUSfZWFzYGw ($100 in chips)
Seat 9: W8P9bUKCs43TO1xHm0dL6w ($89.45 in chips)
5BRGWf+R3nt2WS3b5xX+zA: posts small blind $0.50
gUUvmqdVlmvpal6B8nYrmg: posts big blind $1
*** HOLE CARDS ***
FL3MrLspcF23LYvC4ipBOA: folds
D+W9Me7w6Hcx/WRUSKV0dw joins the table at seat #1
/zy+DB4S5fUQUSfZWFzYGw: folds
W8P9bUKCs43TO1xHm0dL6w: folds
r27C1nIV4NS4+qbnrgBQSw: raises $2 to $3
jDwhY1kCdc6EkAHbT7PJMQ: folds
UWB3oeddt/GObx2Mix2Anw: folds
5BRGWf+R3nt2WS3b5xX+zA: folds
gUUvmqdVlmvpal6B8nYrmg: folds
r27C1nIV4NS4+qbnrgBQSw collected $2.50 from pot
*** SUMMARY ***
Total pot $2.50 | Rake $0
Seat 2: r27C1nIV4NS4+qbnrgBQSw collected ($2.50)
Seat 3: jDwhY1kCdc6EkAHbT7PJMQ folded before Flop (didn't bet)
Seat 4: UWB3oeddt/GObx2Mix2Anw (button) folded before Flop (didn't bet)
Seat 5: 5BRGWf+R3nt2WS3b5xX+zA (small blind) folded before Flop
Seat 6: gUUvmqdVlmvpal6B8nYrmg (big blind) folded before Flop
Seat 7: FL3MrLspcF23LYvC4ipBOA folded before Flop (didn't bet)
Seat 8: /zy+DB4S5fUQUSfZWFzYGw folded before Flop (didn't bet)
Seat 9: W8P9bUKCs43TO1xHm0dL6w folded before Flop (didn't bet)



PokerStars Game #59939990294:  Hold'em No Limit ($0.50/$1.00) - 2009/07/01 0:54:19 ET
Table 'GxCPo/gd3OSthkYrAxJngg' 6-max Seat #2 is the button
Seat 1: sH8BpAFP+jGFxCgVpD1Lew ($262.25 in chips)
Seat 2: YExX2paeIHrmfIwV1ivM/w ($76.70 in chips)
Seat 3: o6plE+MSW4XFNTeONe16xg ($28.60 in chips)
Seat 4: YMJG+F++3Aj6P8dAWda5fw ($207.60 in chips)
Seat 5: G5ZSSN6RSON3gkNvk/SmYg ($106.75 in chips)
o6plE+MSW4XFNTeONe16xg: posts small blind $0.50
YMJG+F++3Aj6P8dAWda5fw: posts big blind $1
*** HOLE CARDS ***
G5ZSSN6RSON3gkNvk/SmYg: folds
sH8BpAFP+jGFxCgVpD1Lew: calls $1
YExX2paeIHrmfIwV1ivM/w: raises $4 to $5
o6plE+MSW4XFNTeONe16xg: folds
YMJG+F++3Aj6P8dAWda5fw: folds
sH8BpAFP+jGFxCgVpD1Lew: folds
YExX2paeIHrmfIwV1ivM/w collected $3.50 from pot
*** SUMMARY ***
Total pot $3.50 | Rake $0
Seat 1: sH8BpAFP+jGFxCgVpD1Lew folded before Flop
Seat 2: YExX2paeIHrmfIwV1ivM/w (button) collected ($3.50)
Seat 3: o6plE+MSW4XFNTeONe16xg (small blind) folded before Flop
Seat 4: YMJG+F++3Aj6P8dAWda5fw (big blind) folded before Flop
Seat 5: G5ZSSN6RSON3gkNvk/SmYg folded before Flop (didn't bet)



PokerStars Game #59939990624:  Hold'em No Limit ($0.50/$1.00) - 2009/07/01 0:54:19 ET
Table 'MUPc8FEpe/nR0BKSeReX6Q' 6-max Seat #1 is the button
Seat 1: YsLQ3BAvgQHWXMAv3Wv6Hg ($112.35 in chips)
Seat 2: xAU6q2/cwmby2sxmA8VcmA ($100 in chips)
Seat 3: wx3sQGkVi2x9wJXuWNHPBw ($218.40 in chips)
Seat 4: ZA1bp6g8IwtTxkUE4eCjDQ ($200.80 in chips)
Seat 5: UBZQqpnJZdTYYY1FTb0rLA ($105.05 in chips)
Seat 6: oxnw0GLLpFanjhGkxfRSqA ($57.70 in chips)
xAU6q2/cwmby2sxmA8VcmA: posts small blind $0.50
wx3sQGkVi2x9wJXuWNHPBw: posts big blind $1
*** HOLE CARDS ***
ZA1bp6g8IwtTxkUE4eCjDQ: folds
UBZQqpnJZdTYYY1FTb0rLA: folds
oxnw0GLLpFanjhGkxfRSqA: folds
YsLQ3BAvgQHWXMAv3Wv6Hg: folds
xAU6q2/cwmby2sxmA8VcmA: raises $3 to $4
wx3sQGkVi2x9wJXuWNHPBw: folds
xAU6q2/cwmby2sxmA8VcmA collected $2 from pot
xAU6q2/cwmby2sxmA8VcmA: doesn't show hand
*** SUMMARY ***
Total pot $2 | Rake $0
Seat 1: YsLQ3BAvgQHWXMAv3Wv6Hg (button) folded before Flop (didn't bet)
Seat 2: xAU6q2/cwmby2sxmA8VcmA (small blind) collected ($2)
Seat 3: wx3sQGkVi2x9wJXuWNHPBw (big blind) folded before Flop
Seat 4: ZA1bp6g8IwtTxkUE4eCjDQ folded before Flop (didn't bet)
Seat 5: UBZQqpnJZdTYYY1FTb0rLA folded before Flop (didn't bet)
Seat 6: oxnw0GLLpFanjhGkxfRSqA folded before Flop (didn't bet)



PokerStars Game #59939990914:  Hold'em No Limit ($0.50/$1.00) - 2009/07/01 0:54:20 ET
Table 'tLrtq7gDzxEvckNAI1OS5Q' 6-max Seat #5 is the button
Seat 1: xNKcQzD9+/iHmtJn4vYq9w ($97.05 in chips)
Seat 2: QHvTZcrKe6+maWUfVjP29Q ($100.85 in chips)
Seat 3: TPZ+m9x+lwoKpv7TMfAUWA ($202.20 in chips)
Seat 4: +uSzP8Jwnw7sKfQ4s66b7w ($47.15 in chips)
Seat 5: OGMLOcTNYZXZU81au7ztUw ($170.15 in chips)
Seat 6: XUk5GQsfNFpHvaToDZ0rZA ($168.70 in chips)
XUk5GQsfNFpHvaToDZ0rZA: posts small blind $0.50
xNKcQzD9+/iHmtJn4vYq9w: posts big blind $1
*** HOLE CARDS ***
QHvTZcrKe6+maWUfVjP29Q: folds
TPZ+m9x+lwoKpv7TMfAUWA: raises $2 to $3
+uSzP8Jwnw7sKfQ4s66b7w: folds
OGMLOcTNYZXZU81au7ztUw: folds
XUk5GQsfNFpHvaToDZ0rZA: folds
xNKcQzD9+/iHmtJn4vYq9w: folds
TPZ+m9x+lwoKpv7TMfAUWA collected $2.50 from pot
*** SUMMARY ***
Total pot $2.50 | Rake $0
Seat 1: xNKcQzD9+/iHmtJn4vYq9w (big blind) folded before Flop
Seat 2: QHvTZcrKe6+maWUfVjP29Q folded before Flop (didn't bet)
Seat 3: TPZ+m9x+lwoKpv7TMfAUWA collected ($2.50)
Seat 4: +uSzP8Jwnw7sKfQ4s66b7w folded before Flop (didn't bet)
Seat 5: OGMLOcTNYZXZU81au7ztUw (button) folded before Flop (didn't bet)
Seat 6: XUk5GQsfNFpHvaToDZ0rZA (small blind) folded before Flop



PokerStars Game #59939990724:  Hold'em No Limit ($0.50/$1.00) - 2009/07/01 0:54:20 ET
Table 'vs/5jr6ciwjVQ5+Soc+u2A' 6-max Seat #1 is the button
Seat 1: /P4w1pHg2zHYg/4ubJ0dPw ($60 in chips)
Seat 2: XOIf9W+VAxhZqN+SYoyMKA ($118.35 in chips)
Seat 3: G5ZSSN6RSON3gkNvk/SmYg ($140.50 in chips)
Seat 4: wk6Ohn4GDozoOMHc4eb2rw ($54.80 in chips)
Seat 5: 2DwLxMUbmzvwY7o4/i47Xg ($31.50 in chips)
Seat 6: qAdBJlVNsNTwiHia50eMvg ($85.80 in chips)
XOIf9W+VAxhZqN+SYoyMKA: posts small blind $0.50
G5ZSSN6RSON3gkNvk/SmYg: posts big blind $1
*** HOLE CARDS ***
wk6Ohn4GDozoOMHc4eb2rw: folds
2DwLxMUbmzvwY7o4/i47Xg: folds
qAdBJlVNsNTwiHia50eMvg: calls $1
/P4w1pHg2zHYg/4ubJ0dPw: folds
XOIf9W+VAxhZqN+SYoyMKA: calls $0.50
G5ZSSN6RSON3gkNvk/SmYg: checks
*** FLOP *** [6s Kd Jd]
XOIf9W+VAxhZqN+SYoyMKA: checks
G5ZSSN6RSON3gkNvk/SmYg: checks
qAdBJlVNsNTwiHia50eMvg: checks
*** TURN *** [6s Kd Jd] [4d]
XOIf9W+VAxhZqN+SYoyMKA: checks
G5ZSSN6RSON3gkNvk/SmYg: bets $2.25
qAdBJlVNsNTwiHia50eMvg: folds
XOIf9W+VAxhZqN+SYoyMKA: folds
G5ZSSN6RSON3gkNvk/SmYg collected $2.85 from pot
G5ZSSN6RSON3gkNvk/SmYg: doesn't show hand
*** SUMMARY ***
Total pot $3 | Rake $0.15
Board [6s Kd Jd 4d]
Seat 1: /P4w1pHg2zHYg/4ubJ0dPw (button) folded before Flop (didn't bet)
Seat 2: XOIf9W+VAxhZqN+SYoyMKA (small blind) folded on the Turn
Seat 3: G5ZSSN6RSON3gkNvk/SmYg (big blind) collected ($2.85)
Seat 4: wk6Ohn4GDozoOMHc4eb2rw folded before Flop (didn't bet)
Seat 5: 2DwLxMUbmzvwY7o4/i47Xg folded before Flop (didn't bet)
Seat 6: qAdBJlVNsNTwiHia50eMvg folded on the Turn



PokerStars Game #59939992566:  Hold'em No Limit ($0.50/$1.00) - 2009/07/01 0:54:22 ET
Table 'cKH9c4x6u79IqCdaKKvXrw' 9-max Seat #2 is the button
Seat 1: Pp/KTcXkfZKKUHkjyaLTdg ($15.50 in chips)
Seat 2: 8S3JMH4TY3whgIlZmMv66w ($44.35 in chips)
Seat 3: 997ViqAtWn1FPjJqcffwcA ($157.60 in chips)
Seat 4: FL3MrLspcF23LYvC4ipBOA ($100 in chips)
Seat 5: Jjc7EHWzs4//xUAjJ0UWoA ($39.50 in chips)
Seat 6: Bsd/K5gAcLanYbGiPirRjw ($207.55 in chips)
Seat 7: 1GkkVBhlJ92guE6K5mS5Ig ($37.40 in chips)
Seat 9: 6XkTu4ahxzHnvjjc1R8YjQ ($43.10 in chips)
997ViqAtWn1FPjJqcffwcA: posts small blind $0.50
FL3MrLspcF23LYvC4ipBOA: posts big blind $1
myIxN7otsyr846M539YR8Q: sits out
*** HOLE CARDS ***
Jjc7EHWzs4//xUAjJ0UWoA: folds
Bsd/K5gAcLanYbGiPirRjw: folds
1GkkVBhlJ92guE6K5mS5Ig: calls $1
6XkTu4ahxzHnvjjc1R8YjQ: folds
Pp/KTcXkfZKKUHkjyaLTdg: folds
8S3JMH4TY3whgIlZmMv66w: folds
997ViqAtWn1FPjJqcffwcA: folds
FL3MrLspcF23LYvC4ipBOA: checks
*** FLOP *** [Qc 6d 4c]
FL3MrLspcF23LYvC4ipBOA: checks
1GkkVBhlJ92guE6K5mS5Ig: bets $2
FL3MrLspcF23LYvC4ipBOA: folds
1GkkVBhlJ92guE6K5mS5Ig collected $2.40 from pot
*** SUMMARY ***
Total pot $2.50 | Rake $0.10
Board [Qc 6d 4c]
Seat 1: Pp/KTcXkfZKKUHkjyaLTdg folded before Flop (didn't bet)
Seat 2: 8S3JMH4TY3whgIlZmMv66w (button) folded before Flop (didn't bet)
Seat 3: 997ViqAtWn1FPjJqcffwcA (small blind) folded before Flop
Seat 4: FL3MrLspcF23LYvC4ipBOA (big blind) folded on the Flop
Seat 5: Jjc7EHWzs4//xUAjJ0UWoA folded before Flop (didn't bet)
Seat 6: Bsd/K5gAcLanYbGiPirRjw folded before Flop (didn't bet)
Seat 7: 1GkkVBhlJ92guE6K5mS5Ig collected ($2.40)
Seat 9: 6XkTu4ahxzHnvjjc1R8YjQ folded before Flop (didn't bet)



PokerStars Game #59939994052:  Hold'em No Limit ($0.50/$1.00) - 2009/07/01 0:54:25 ET
Table 'JOIm/fogLA7vSG0Vc6ME1A' 2-max Seat #2 is the button
Seat 1: NYi6JFscYNrofSXy4sM+Yw ($139 in chips)
Seat 2: F5lNTyZLIX9W2wQZ0plwgg ($114.60 in chips)
F5lNTyZLIX9W2wQZ0plwgg: posts small blind $0.50
NYi6JFscYNrofSXy4sM+Yw: posts big blind $1
*** HOLE CARDS ***
F5lNTyZLIX9W2wQZ0plwgg: raises $3 to $4
NYi6JFscYNrofSXy4sM+Yw: folds
F5lNTyZLIX9W2wQZ0plwgg collected $2 from pot
F5lNTyZLIX9W2wQZ0plwgg: doesn't show hand
*** SUMMARY ***
Total pot $2 | Rake $0
Seat 1: NYi6JFscYNrofSXy4sM+Yw (big blind) folded before Flop
Seat 2: F5lNTyZLIX9W2wQZ0plwgg (button) (small blind) collected ($2)



PokerStars Game #59939996624:  Hold'em No Limit ($0.50/$1.00) - 2009/07/01 0:54:29 ET
Table '+cA8mcmhaedZ7YcrDdhmeQ' 6-max Seat #4 is the button
Seat 1: lsLuWlcPA3Rh7kJVLzMh0Q ($287.50 in chips)
Seat 2: RqgF7gRoKgRNW8Zoi1ty4A ($105.95 in chips)
Seat 3: 7H5WkGzGvsv56y1iaqHvRg ($54.85 in chips)
Seat 4: JwCcjZl0bjJzG7hmE0dnTA ($100 in chips)
Seat 5: +7hFKAL0b0O/n8G72TclJA ($48.50 in chips)
Seat 6: YfsTQsY/fxb+YqbdclTHuw ($30.95 in chips)
+7hFKAL0b0O/n8G72TclJA: posts small blind $0.50
YfsTQsY/fxb+YqbdclTHuw: posts big blind $1
*** HOLE CARDS ***
lsLuWlcPA3Rh7kJVLzMh0Q: folds
RqgF7gRoKgRNW8Zoi1ty4A: folds
7H5WkGzGvsv56y1iaqHvRg: folds
JwCcjZl0bjJzG7hmE0dnTA: raises $2 to $3
+7hFKAL0b0O/n8G72TclJA: calls $2.50
YfsTQsY/fxb+YqbdclTHuw: calls $2
*** FLOP *** [9s 7c 8h]
+7hFKAL0b0O/n8G72TclJA: bets $5
YfsTQsY/fxb+YqbdclTHuw: folds
JwCcjZl0bjJzG7hmE0dnTA: folds
+7hFKAL0b0O/n8G72TclJA collected $8.55 from pot
*** SUMMARY ***
Total pot $9 | Rake $0.45
Board [9s 7c 8h]
Seat 1: lsLuWlcPA3Rh7kJVLzMh0Q folded before Flop (didn't bet)
Seat 2: RqgF7gRoKgRNW8Zoi1ty4A folded before Flop (didn't bet)
Seat 3: 7H5WkGzGvsv56y1iaqHvRg folded before Flop (didn't bet)
Seat 4: JwCcjZl0bjJzG7hmE0dnTA (button) folded on the Flop
Seat 5: +7hFKAL0b0O/n8G72TclJA (small blind) collected ($8.55)
Seat 6: YfsTQsY/fxb+YqbdclTHuw (big blind) folded on the Flop



PokerStars Game #59939997652:  Hold'em No Limit ($0.50/$1.00) - 2009/07/01 0:54:31 ET
Table 'LmXQK9xy3awB+qsPzI21Mw' 2-max Seat #1 is the button
Seat 1: NYi6JFscYNrofSXy4sM+Yw ($324.85 in chips)
Seat 2: TME8GvochpQAo8cmJwWmvA ($67.05 in chips)
NYi6JFscYNrofSXy4sM+Yw: posts small blind $0.50
TME8GvochpQAo8cmJwWmvA: posts big blind $1
*** HOLE CARDS ***
NYi6JFscYNrofSXy4sM+Yw: raises $2 to $3
TME8GvochpQAo8cmJwWmvA: calls $2
*** FLOP *** [5c 7s 9d]
TME8GvochpQAo8cmJwWmvA: checks
NYi6JFscYNrofSXy4sM+Yw: bets $2
TME8GvochpQAo8cmJwWmvA: raises $2 to $4
NYi6JFscYNrofSXy4sM+Yw: calls $2
*** TURN *** [5c 7s 9d] [7h]
TME8GvochpQAo8cmJwWmvA: checks
NYi6JFscYNrofSXy4sM+Yw: checks
*** RIVER *** [5c 7s 9d 7h] [Qd]
TME8GvochpQAo8cmJwWmvA: bets $3
NYi6JFscYNrofSXy4sM+Yw: calls $3
*** SHOW DOWN ***
TME8GvochpQAo8cmJwWmvA: shows [2c Ad] (a pair of Sevens)
NYi6JFscYNrofSXy4sM+Yw: shows [Kc 5s] (two pair, Sevens and Fives)
NYi6JFscYNrofSXy4sM+Yw collected $19.50 from pot
*** SUMMARY ***
Total pot $20 | Rake $0.50
Board [5c 7s 9d 7h Qd]
Seat 1: NYi6JFscYNrofSXy4sM+Yw (button) (small blind) showed [Kc 5s] and won ($19.50) with two pair, Sevens and Fives
Seat 2: TME8GvochpQAo8cmJwWmvA (big blind) showed [2c Ad] and lost with a pair of Sevens



PokerStars Game #59939998122:  Hold'em No Limit ($0.50/$1.00) - 2009/07/01 0:54:32 ET
Table 'JOIm/fogLA7vSG0Vc6ME1A' 2-max Seat #1 is the button
Seat 1: NYi6JFscYNrofSXy4sM+Yw ($138 in chips)
Seat 2: F5lNTyZLIX9W2wQZ0plwgg ($115.60 in chips)
NYi6JFscYNrofSXy4sM+Yw: posts small blind $0.50
F5lNTyZLIX9W2wQZ0plwgg: posts big blind $1
*** HOLE CARDS ***
NYi6JFscYNrofSXy4sM+Yw: raises $2 to $3
F5lNTyZLIX9W2wQZ0plwgg: calls $2
*** FLOP *** [Qd 2s Js]
F5lNTyZLIX9W2wQZ0plwgg: checks
NYi6JFscYNrofSXy4sM+Yw: bets $3
F5lNTyZLIX9W2wQZ0plwgg: folds
NYi6JFscYNrofSXy4sM+Yw collected $5.70 from pot
*** SUMMARY ***
Total pot $6 | Rake $0.30
Board [Qd 2s Js]
Seat 1: NYi6JFscYNrofSXy4sM+Yw (button) (small blind) collected ($5.70)
Seat 2: F5lNTyZLIX9W2wQZ0plwgg (big blind) folded on the Flop



PokerStars Game #59940000284:  Hold'em No Limit ($0.50/$1.00) - 2009/07/01 0:54:35 ET
Table 'MUPc8FEpe/nR0BKSeReX6Q' 6-max Seat #2 is the button
Seat 1: YsLQ3BAvgQHWXMAv3Wv6Hg ($112.35 in chips)
Seat 2: xAU6q2/cwmby2sxmA8VcmA ($101 in chips)
Seat 3: wx3sQGkVi2x9wJXuWNHPBw ($217.40 in chips)
Seat 4: ZA1bp6g8IwtTxkUE4eCjDQ ($200.80 in chips)
Seat 5: UBZQqpnJZdTYYY1FTb0rLA ($105.05 in chips)
Seat 6: oxnw0GLLpFanjhGkxfRSqA ($57.70 in chips)
wx3sQGkVi2x9wJXuWNHPBw: posts small blind $0.50
ZA1bp6g8IwtTxkUE4eCjDQ: posts big blind $1
*** HOLE CARDS ***
UBZQqpnJZdTYYY1FTb0rLA: folds
oxnw0GLLpFanjhGkxfRSqA: folds
YsLQ3BAvgQHWXMAv3Wv6Hg: folds
xAU6q2/cwmby2sxmA8VcmA: folds
wx3sQGkVi2x9wJXuWNHPBw: raises $3 to $4
ZA1bp6g8IwtTxkUE4eCjDQ: calls $3
*** FLOP *** [Ah Qd 6h]
wx3sQGkVi2x9wJXuWNHPBw: checks
ZA1bp6g8IwtTxkUE4eCjDQ: bets $3
wx3sQGkVi2x9wJXuWNHPBw: calls $3
*** TURN *** [Ah Qd 6h] [Ac]
wx3sQGkVi2x9wJXuWNHPBw: checks
ZA1bp6g8IwtTxkUE4eCjDQ: bets $9
wx3sQGkVi2x9wJXuWNHPBw: calls $9
*** RIVER *** [Ah Qd 6h Ac] [Jc]
wx3sQGkVi2x9wJXuWNHPBw: checks
ZA1bp6g8IwtTxkUE4eCjDQ: checks
*** SHOW DOWN ***
wx3sQGkVi2x9wJXuWNHPBw: shows [Ad 8d] (three of a kind, Aces)
ZA1bp6g8IwtTxkUE4eCjDQ: mucks hand
wx3sQGkVi2x9wJXuWNHPBw collected $30.45 from pot
*** SUMMARY ***
Total pot $32 | Rake $1.55
Board [Ah Qd 6h Ac Jc]
Seat 1: YsLQ3BAvgQHWXMAv3Wv6Hg folded before Flop (didn't bet)
Seat 2: xAU6q2/cwmby2sxmA8VcmA (button) folded before Flop (didn't bet)
Seat 3: wx3sQGkVi2x9wJXuWNHPBw (small blind) showed [Ad 8d] and won ($30.45) with three of a kind, Aces
Seat 4: ZA1bp6g8IwtTxkUE4eCjDQ (big blind) mucked
Seat 5: UBZQqpnJZdTYYY1FTb0rLA folded before Flop (didn't bet)
Seat 6: oxnw0GLLpFanjhGkxfRSqA folded before Flop (didn't bet)



PokerStars Game #59940001000:  Hold'em No Limit ($0.50/$1.00) - 2009/07/01 0:54:36 ET
Table 'eU3bWpDDg3Z+9R4m4iVmog' 6-max Seat #1 is the button
Seat 1: TSuRyAHnUPCFjP7Z0rEE0w ($192.65 in chips)
Seat 2: 8CAoOzhmB8n3nRFf3V4BTg ($83.95 in chips)
Seat 4: GDVIsbEJ/DOJsMKE4Asz0A ($91.10 in chips)
Seat 5: AdLVjddOzm+sRNo1Bc3S6Q ($110.55 in chips)
Seat 6: hpxXcmRkXXI9HE5+5/j/0Q ($104.95 in chips)
8CAoOzhmB8n3nRFf3V4BTg: posts small blind $0.50
GDVIsbEJ/DOJsMKE4Asz0A: posts big blind $1
*** HOLE CARDS ***
AdLVjddOzm+sRNo1Bc3S6Q: folds
hpxXcmRkXXI9HE5+5/j/0Q: folds
TSuRyAHnUPCFjP7Z0rEE0w: folds
8CAoOzhmB8n3nRFf3V4BTg: calls $0.50
GDVIsbEJ/DOJsMKE4Asz0A: checks
*** FLOP *** [Th Kd 7c]
8CAoOzhmB8n3nRFf3V4BTg: checks
GDVIsbEJ/DOJsMKE4Asz0A: checks
*** TURN *** [Th Kd 7c] [Kh]
8CAoOzhmB8n3nRFf3V4BTg: checks
GDVIsbEJ/DOJsMKE4Asz0A: checks
*** RIVER *** [Th Kd 7c Kh] [Ah]
8CAoOzhmB8n3nRFf3V4BTg: bets $1
GDVIsbEJ/DOJsMKE4Asz0A: calls $1
*** SHOW DOWN ***
8CAoOzhmB8n3nRFf3V4BTg: shows [Ac 2h] (two pair, Aces and Kings)
GDVIsbEJ/DOJsMKE4Asz0A: mucks hand
8CAoOzhmB8n3nRFf3V4BTg collected $3.85 from pot
*** SUMMARY ***
Total pot $4 | Rake $0.15
Board [Th Kd 7c Kh Ah]
Seat 1: TSuRyAHnUPCFjP7Z0rEE0w (button) folded before Flop (didn't bet)
Seat 2: 8CAoOzhmB8n3nRFf3V4BTg (small blind) showed [Ac 2h] and won ($3.85) with two pair, Aces and Kings
Seat 4: GDVIsbEJ/DOJsMKE4Asz0A (big blind) mucked
Seat 5: AdLVjddOzm+sRNo1Bc3S6Q folded before Flop (didn't bet)
Seat 6: hpxXcmRkXXI9HE5+5/j/0Q folded before Flop (didn't bet)



PokerStars Game #59940003198:  Hold'em No Limit ($0.50/$1.00) - 2009/07/01 0:54:40 ET
Table 'W/wyObTiXZm+Ckkl3YxcSw' 6-max Seat #5 is the button
Seat 1: eUBBn2R56C1IQ6Cs/vitwg ($110.75 in chips)
Seat 2: oDiBRCaF0QVtd3kO6xZIXw ($97.30 in chips)
Seat 4: +xW7QemQU0Fxs+4TnqBRow ($111.90 in chips)
Seat 5: BdbmJTZZ47quA9vUWwXtlw ($65.85 in chips)
Seat 6: tS9JHB1h+FQ++qu8RwRNgg ($20.40 in chips)
tS9JHB1h+FQ++qu8RwRNgg: posts small blind $0.50
eUBBn2R56C1IQ6Cs/vitwg: posts big blind $1
*** HOLE CARDS ***
oDiBRCaF0QVtd3kO6xZIXw: folds
+xW7QemQU0Fxs+4TnqBRow: raises $3 to $4
BdbmJTZZ47quA9vUWwXtlw: folds
tS9JHB1h+FQ++qu8RwRNgg: raises $16.40 to $20.40 and is all-in
eUBBn2R56C1IQ6Cs/vitwg: folds
+xW7QemQU0Fxs+4TnqBRow: calls $16.40
*** FLOP *** [9h Ts 3d]
*** TURN *** [9h Ts 3d] [7d]
*** RIVER *** [9h Ts 3d 7d] [4h]
*** SHOW DOWN ***
tS9JHB1h+FQ++qu8RwRNgg: shows [Ac Qs] (high card Ace)
+xW7QemQU0Fxs+4TnqBRow: mucks hand
tS9JHB1h+FQ++qu8RwRNgg collected $39.80 from pot
*** SUMMARY ***
Total pot $41.80 | Rake $2
Board [9h Ts 3d 7d 4h]
Seat 1: eUBBn2R56C1IQ6Cs/vitwg (big blind) folded before Flop
Seat 2: oDiBRCaF0QVtd3kO6xZIXw folded before Flop (didn't bet)
Seat 4: +xW7QemQU0Fxs+4TnqBRow mucked
Seat 5: BdbmJTZZ47quA9vUWwXtlw (button) folded before Flop (didn't bet)
Seat 6: tS9JHB1h+FQ++qu8RwRNgg (small blind) showed [Ac Qs] and won ($39.80) with high card Ace



PokerStars Game #59940003422:  Hold'em No Limit ($0.50/$1.00) - 2009/07/01 0:54:40 ET
Table '8jIjWCPY0NGprquL+xcMFg' 9-max Seat #2 is the button
Seat 1: vR4IO10geOgvTW+LAUBv/A ($134.55 in chips)
Seat 2: laA8va+Yv8WuMqT1zdR91g ($106.05 in chips)
Seat 3: tjhwe1V98x2spSoUQER3HQ ($103.50 in chips)
Seat 4: Jjc7EHWzs4//xUAjJ0UWoA ($20 in chips)
Seat 5: 2YpnxJiexJHyERfbqgwEcw ($87.05 in chips)
Seat 6: GTQkFJtSkbVbnGCktp6e3g ($102.85 in chips)
Seat 7: O3CGPwwUmamrCNHccOilrg ($45.45 in chips)
Seat 9: negfosHnGOZXSHpWDRKyBQ ($21.50 in chips)
tjhwe1V98x2spSoUQER3HQ: posts small blind $0.50
Jjc7EHWzs4//xUAjJ0UWoA: posts big blind $1
D+W9Me7w6Hcx/WRUSKV0dw: sits out
*** HOLE CARDS ***
2YpnxJiexJHyERfbqgwEcw: folds
GTQkFJtSkbVbnGCktp6e3g: folds
O3CGPwwUmamrCNHccOilrg: folds
negfosHnGOZXSHpWDRKyBQ: raises $3 to $4
vR4IO10geOgvTW+LAUBv/A: folds
laA8va+Yv8WuMqT1zdR91g: folds
tjhwe1V98x2spSoUQER3HQ: folds
Jjc7EHWzs4//xUAjJ0UWoA: folds
negfosHnGOZXSHpWDRKyBQ collected $2.50 from pot
negfosHnGOZXSHpWDRKyBQ: doesn't show hand
*** SUMMARY ***
Total pot $2.50 | Rake $0
Seat 1: vR4IO10geOgvTW+LAUBv/A folded before Flop (didn't bet)
Seat 2: laA8va+Yv8WuMqT1zdR91g (button) folded before Flop (didn't bet)
Seat 3: tjhwe1V98x2spSoUQER3HQ (small blind) folded before Flop
Seat 4: Jjc7EHWzs4//xUAjJ0UWoA (big blind) folded before Flop
Seat 5: 2YpnxJiexJHyERfbqgwEcw folded before Flop (didn't bet)
Seat 6: GTQkFJtSkbVbnGCktp6e3g folded before Flop (didn't bet)
Seat 7: O3CGPwwUmamrCNHccOilrg folded before Flop (didn't bet)
Seat 9: negfosHnGOZXSHpWDRKyBQ collected ($2.50)



PokerStars Game #59940003280:  Hold'em No Limit ($0.50/$1.00) - 2009/07/01 0:54:40 ET
Table 'tLrtq7gDzxEvckNAI1OS5Q' 6-max Seat #6 is the button
Seat 1: xNKcQzD9+/iHmtJn4vYq9w ($96.05 in chips)
Seat 2: QHvTZcrKe6+maWUfVjP29Q ($100.85 in chips)
Seat 3: TPZ+m9x+lwoKpv7TMfAUWA ($203.70 in chips)
Seat 4: +uSzP8Jwnw7sKfQ4s66b7w ($47.15 in chips)
Seat 5: OGMLOcTNYZXZU81au7ztUw ($170.15 in chips)
Seat 6: XUk5GQsfNFpHvaToDZ0rZA ($168.20 in chips)
xNKcQzD9+/iHmtJn4vYq9w: posts small blind $0.50
QHvTZcrKe6+maWUfVjP29Q: posts big blind $1
*** HOLE CARDS ***
TPZ+m9x+lwoKpv7TMfAUWA: folds
+uSzP8Jwnw7sKfQ4s66b7w: raises $2 to $3
OGMLOcTNYZXZU81au7ztUw: calls $3
XUk5GQsfNFpHvaToDZ0rZA: folds
xNKcQzD9+/iHmtJn4vYq9w: folds
QHvTZcrKe6+maWUfVjP29Q: folds
*** FLOP *** [6s 8d 5c]
+uSzP8Jwnw7sKfQ4s66b7w: bets $5
OGMLOcTNYZXZU81au7ztUw: folds
+uSzP8Jwnw7sKfQ4s66b7w collected $7.15 from pot
*** SUMMARY ***
Total pot $7.50 | Rake $0.35
Board [6s 8d 5c]
Seat 1: xNKcQzD9+/iHmtJn4vYq9w (small blind) folded before Flop
Seat 2: QHvTZcrKe6+maWUfVjP29Q (big blind) folded before Flop
Seat 3: TPZ+m9x+lwoKpv7TMfAUWA folded before Flop (didn't bet)
Seat 4: +uSzP8Jwnw7sKfQ4s66b7w collected ($7.15)
Seat 5: OGMLOcTNYZXZU81au7ztUw folded on the Flop
Seat 6: XUk5GQsfNFpHvaToDZ0rZA (button) folded before Flop (didn't bet)



PokerStars Game #59940003278:  Hold'em No Limit ($0.50/$1.00) - 2009/07/01 0:54:40 ET
Table 'tyUh+jyNvrceIQdKMJjQ2wZFWj23PMihdwrNWv41OG/Qeat #4 is the button
Seat 1: o8A5MUdudVKu+pAwgZOX2w ($194.80 in chips)
Seat 2: XvUbOIg94d25feWeQlOTVg ($154.20 in chips)
Seat 3: TalCiLYHCd+ffkmR3auPvA ($85.90 in chips)
Seat 4: TSuRyAHnUPCFjP7Z0rEE0w ($111.25 in chips)
Seat 5: j7NIOHLZk7V2o9fOioO5ug ($100 in chips)
Seat 6: YsLQ3BAvgQHWXMAv3Wv6Hg ($150.15 in chips)
j7NIOHLZk7V2o9fOioO5ug: posts small blind $0.50
YsLQ3BAvgQHWXMAv3Wv6Hg: posts big blind $1
*** HOLE CARDS ***
o8A5MUdudVKu+pAwgZOX2w: calls $1
XvUbOIg94d25feWeQlOTVg: calls $1
TalCiLYHCd+ffkmR3auPvA: folds
TSuRyAHnUPCFjP7Z0rEE0w: folds
j7NIOHLZk7V2o9fOioO5ug: calls $0.50
YsLQ3BAvgQHWXMAv3Wv6Hg: checks
*** FLOP *** [7c Jd 5h]
j7NIOHLZk7V2o9fOioO5ug: checks
YsLQ3BAvgQHWXMAv3Wv6Hg: bets $3
o8A5MUdudVKu+pAwgZOX2w: calls $3
XvUbOIg94d25feWeQlOTVg: folds
j7NIOHLZk7V2o9fOioO5ug: raises $11 to $14
YsLQ3BAvgQHWXMAv3Wv6Hg: folds
o8A5MUdudVKu+pAwgZOX2w: calls $11
*** TURN *** [7c Jd 5h] [Ks]
j7NIOHLZk7V2o9fOioO5ug: bets $28
o8A5MUdudVKu+pAwgZOX2w: folds
j7NIOHLZk7V2o9fOioO5ug collected $33.30 from pot
j7NIOHLZk7V2o9fOioO5ug: doesn't show hand
*** SUMMARY ***
Total pot $35 | Rake $1.70
Board [7c Jd 5h Ks]
Seat 1: o8A5MUdudVKu+pAwgZOX2w folded on the Turn
Seat 2: XvUbOIg94d25feWeQlOTVg folded on the Flop
Seat 3: TalCiLYHCd+ffkmR3auPvA folded before Flop (didn't bet)
Seat 4: TSuRyAHnUPCFjP7Z0rEE0w (button) folded before Flop (didn't bet)
Seat 5: j7NIOHLZk7V2o9fOioO5ug (small blind) collected ($33.30)
Seat 6: YsLQ3BAvgQHWXMAv3Wv6Hg (big blind) folded on the Flop



PokerStars Game #59940003070:  Hold'em No Limit ($0.50/$1.00) - 2009/07/01 0:54:40 ET
Table 'cBDNutyLBKEk9+ptwsKmTw' 6-max Seat #5 is the button
Seat 1: xAU6q2/cwmby2sxmA8VcmA ($100 in chips)
Seat 2: 5lY8d6Cnm4HUkt/8FZSj4g ($103.65 in chips)
Seat 3: G5ZSSN6RSON3gkNvk/SmYg ($103.15 in chips)
Seat 4: 3q7F5QtzC30pSrn0nl9i+A ($35.50 in chips)
Seat 5: OGMLOcTNYZXZU81au7ztUw ($158.65 in chips)
Seat 6: NqVlOSH2lp+pp/TK3vvK5g ($35 in chips)
NqVlOSH2lp+pp/TK3vvK5g: posts small blind $0.50
xAU6q2/cwmby2sxmA8VcmA: posts big blind $1
*** HOLE CARDS ***
5lY8d6Cnm4HUkt/8FZSj4g: calls $1
G5ZSSN6RSON3gkNvk/SmYg: folds
3q7F5QtzC30pSrn0nl9i+A: folds
OGMLOcTNYZXZU81au7ztUw: folds
NqVlOSH2lp+pp/TK3vvK5g: folds
xAU6q2/cwmby2sxmA8VcmA: checks
*** FLOP *** [Jh 7d 2s]
xAU6q2/cwmby2sxmA8VcmA: checks
5lY8d6Cnm4HUkt/8FZSj4g: bets $3
xAU6q2/cwmby2sxmA8VcmA: calls $3
*** TURN *** [Jh 7d 2s] [Ac]
xAU6q2/cwmby2sxmA8VcmA: checks
5lY8d6Cnm4HUkt/8FZSj4g: bets $7
xAU6q2/cwmby2sxmA8VcmA: calls $7
*** RIVER *** [Jh 7d 2s Ac] [Js]
xAU6q2/cwmby2sxmA8VcmA: bets $11
5lY8d6Cnm4HUkt/8FZSj4g: calls $11
*** SHOW DOWN ***
xAU6q2/cwmby2sxmA8VcmA: shows [Jc 4h] (three of a kind, Jacks)
5lY8d6Cnm4HUkt/8FZSj4g: mucks hand
xAU6q2/cwmby2sxmA8VcmA collected $42.35 from pot
*** SUMMARY ***
Total pot $44.50 | Rake $2.15
Board [Jh 7d 2s Ac Js]
Seat 1: xAU6q2/cwmby2sxmA8VcmA (big blind) showed [Jc 4h] and won ($42.35) with three of a kind, Jacks
Seat 2: 5lY8d6Cnm4HUkt/8FZSj4g mucked
Seat 3: G5ZSSN6RSON3gkNvk/SmYg folded before Flop (didn't bet)
Seat 4: 3q7F5QtzC30pSrn0nl9i+A folded before Flop (didn't bet)
Seat 5: OGMLOcTNYZXZU81au7ztUw (button) folded before Flop (didn't bet)
Seat 6: NqVlOSH2lp+pp/TK3vvK5g (small blind) folded before Flop



PokerStars Game #59940003762:  Hold'em No Limit ($0.50/$1.00) - 2009/07/01 0:54:41 ET
Table 'U9zqzC8f3oTJ2ShXFgSSOA' 6-max Seat #5 is the button
Seat 1: iHo1oDbrEVJ8nEGdaPrICw ($109 in chips)
Seat 2: TSuRyAHnUPCFjP7Z0rEE0w ($100 in chips)
Seat 3: yfXek8iJ7O4CFyqXrtGcfg ($15.95 in chips)
Seat 4: 33q95we0Etwgrm6guQGncw ($82.75 in chips)
Seat 5: KfwW5us6tydK81NYTtK1gw ($297.45 in chips)
Seat 6: 4OO5v3AVduL0tePNx8wk5A ($109.50 in chips)
4OO5v3AVduL0tePNx8wk5A: posts small blind $0.50
iHo1oDbrEVJ8nEGdaPrICw: posts big blind $1
*** HOLE CARDS ***
TSuRyAHnUPCFjP7Z0rEE0w: folds
yfXek8iJ7O4CFyqXrtGcfg: calls $1
33q95we0Etwgrm6guQGncw: folds
KfwW5us6tydK81NYTtK1gw: folds
4OO5v3AVduL0tePNx8wk5A: folds
iHo1oDbrEVJ8nEGdaPrICw: checks
*** FLOP *** [As 5h 6s]
iHo1oDbrEVJ8nEGdaPrICw: checks
yfXek8iJ7O4CFyqXrtGcfg: checks
*** TURN *** [As 5h 6s] [9d]
iHo1oDbrEVJ8nEGdaPrICw: bets $2
yfXek8iJ7O4CFyqXrtGcfg: folds
iHo1oDbrEVJ8nEGdaPrICw collected $2.40 from pot
iHo1oDbrEVJ8nEGdaPrICw: doesn't show hand
*** SUMMARY ***
Total pot $2.50 | Rake $0.10
Board [As 5h 6s 9d]
Seat 1: iHo1oDbrEVJ8nEGdaPrICw (big blind) collected ($2.40)
Seat 2: TSuRyAHnUPCFjP7Z0rEE0w folded before Flop (didn't bet)
Seat 3: yfXek8iJ7O4CFyqXrtGcfg folded on the Turn
Seat 4: 33q95we0Etwgrm6guQGncw folded before Flop (didn't bet)
Seat 5: KfwW5us6tydK81NYTtK1gw (button) folded before Flop (didn't bet)
Seat 6: 4OO5v3AVduL0tePNx8wk5A (small blind) folded before Flop



PokerStars Game #59940004002:  Hold'em No Limit ($0.50/$1.00) - 2009/07/01 0:54:41 ET
Table 'Zka9tv1yilg0MvXWPQrShg' 9-max Seat #5 is the button
Seat 1: TZcz9MEWDA+WydgGruqqbw ($121.90 in chips)
Seat 2: kz9ziSiGUc+857heiKSayw ($20 in chips)
Seat 3: gUUvmqdVlmvpal6B8nYrmg ($102.30 in chips)
Seat 4: stxmTgSicxShtrDxhOOX2g ($69.15 in chips)
Seat 5: /zy+DB4S5fUQUSfZWFzYGw ($123.40 in chips)
Seat 6: rY8wPoax1lS+HUY+I0FZDw ($143.45 in chips)
Seat 7: p1SafS90nb3Uft5LB0NkHw ($22.50 in chips)
Seat 8: bL+QVeDcuEdzMGAGg2XJHg ($122.10 in chips)
Seat 9: 6daxhj43mWj04MOPTOmaYA ($92.65 in chips)
rY8wPoax1lS+HUY+I0FZDw: posts small blind $0.50
p1SafS90nb3Uft5LB0NkHw: posts big blind $1
*** HOLE CARDS ***
bL+QVeDcuEdzMGAGg2XJHg: folds
6daxhj43mWj04MOPTOmaYA: folds
TZcz9MEWDA+WydgGruqqbw: folds
kz9ziSiGUc+857heiKSayw: raises $2 to $3
gUUvmqdVlmvpal6B8nYrmg: raises $4 to $7
stxmTgSicxShtrDxhOOX2g: folds
/zy+DB4S5fUQUSfZWFzYGw: folds
rY8wPoax1lS+HUY+I0FZDw: folds
p1SafS90nb3Uft5LB0NkHw: folds
kz9ziSiGUc+857heiKSayw: folds
gUUvmqdVlmvpal6B8nYrmg collected $7.50 from pot
*** SUMMARY ***
Total pot $7.50 | Rake $0
Seat 1: TZcz9MEWDA+WydgGruqqbw folded before Flop (didn't bet)
Seat 2: kz9ziSiGUc+857heiKSayw folded before Flop
Seat 3: gUUvmqdVlmvpal6B8nYrmg collected ($7.50)
Seat 4: stxmTgSicxShtrDxhOOX2g folded before Flop (didn't bet)
Seat 5: /zy+DB4S5fUQUSfZWFzYGw (button) folded before Flop (didn't bet)
Seat 6: rY8wPoax1lS+HUY+I0FZDw (small blind) folded before Flop
Seat 7: p1SafS90nb3Uft5LB0NkHw (big blind) folded before Flop
Seat 8: bL+QVeDcuEdzMGAGg2XJHg folded before Flop (didn't bet)
Seat 9: 6daxhj43mWj04MOPTOmaYA folded before Flop (didn't bet)



PokerStars Game #59940004710:  Hold'em No Limit ($0.50/$1.00) - 2009/07/01 0:54:42 ET
Table '6YvsYDPNIDx2v5z3bJnwZQ' 9-max Seat #8 is the button
Seat 1: Ogn4JDV3mp4ZDKO49IFzKA ($19.70 in chips)
Seat 2: x80+i7DJL+81v3quj7KbNg ($20 in chips)
Seat 3: negfosHnGOZXSHpWDRKyBQ ($20 in chips)
Seat 4: kEr5NYB+JIG5+szcYMr6hA ($41.25 in chips)
Seat 5: mBRWbnUl8diyBO1qTJaNzw ($165.20 in chips)
Seat 6: 7RSwrjMohkYrZAhOd1uaZg ($15 in chips)
Seat 7: mae7OMTaJ/MFimNbZegCkg ($55.30 in chips)
Seat 8: PSFxpXgPedVZyHSu2Zhb7Q ($102.90 in chips)
Seat 9: ZgMRSHJ9EOtPeVHmdeV9kQ ($56 in chips)
ZgMRSHJ9EOtPeVHmdeV9kQ: posts small blind $0.50
Ogn4JDV3mp4ZDKO49IFzKA: posts big blind $1
*** HOLE CARDS ***
x80+i7DJL+81v3quj7KbNg: folds
negfosHnGOZXSHpWDRKyBQ: folds
kEr5NYB+JIG5+szcYMr6hA: folds
mBRWbnUl8diyBO1qTJaNzw: folds
7RSwrjMohkYrZAhOd1uaZg: folds
mae7OMTaJ/MFimNbZegCkg: folds
PSFxpXgPedVZyHSu2Zhb7Q: raises $2 to $3
ZgMRSHJ9EOtPeVHmdeV9kQ: calls $2.50
Ogn4JDV3mp4ZDKO49IFzKA: folds
*** FLOP *** [4c 5s 5d]
ZgMRSHJ9EOtPeVHmdeV9kQ: checks
PSFxpXgPedVZyHSu2Zhb7Q: checks
*** TURN *** [4c 5s 5d] [4h]
ZgMRSHJ9EOtPeVHmdeV9kQ: bets $3
PSFxpXgPedVZyHSu2Zhb7Q: calls $3
*** RIVER *** [4c 5s 5d 4h] [3d]
ZgMRSHJ9EOtPeVHmdeV9kQ: checks
PSFxpXgPedVZyHSu2Zhb7Q: checks
*** SHOW DOWN ***
ZgMRSHJ9EOtPeVHmdeV9kQ: shows [Qs Kc] (two pair, Fives and Fours)
PSFxpXgPedVZyHSu2Zhb7Q: shows [Qh As] (two pair, Fives and Fours - Ace kicker)
PSFxpXgPedVZyHSu2Zhb7Q collected $12.40 from pot
*** SUMMARY ***
Total pot $13 | Rake $0.60
Board [4c 5s 5d 4h 3d]
Seat 1: Ogn4JDV3mp4ZDKO49IFzKA (big blind) folded before Flop
Seat 2: x80+i7DJL+81v3quj7KbNg folded before Flop (didn't bet)
Seat 3: negfosHnGOZXSHpWDRKyBQ folded before Flop (didn't bet)
Seat 4: kEr5NYB+JIG5+szcYMr6hA folded before Flop (didn't bet)
Seat 5: mBRWbnUl8diyBO1qTJaNzw folded before Flop (didn't bet)
Seat 6: 7RSwrjMohkYrZAhOd1uaZg folded before Flop (didn't bet)
Seat 7: mae7OMTaJ/MFimNbZegCkg folded before Flop (didn't bet)
Seat 8: PSFxpXgPedVZyHSu2Zhb7Q (button) showed [Qh As] and won ($12.40) with two pair, Fives and Fours
Seat 9: ZgMRSHJ9EOtPeVHmdeV9kQ (small blind) showed [Qs Kc] and lost with two pair, Fives and Fours



PokerStars Game #59940004338:  Hold'em No Limit ($0.50/$1.00) - 2009/07/01 0:54:42 ET
Table 'VOs36P6NW+QyXeQ1B62kmA' 6-max Seat #4 is the button
Seat 1: AdLVjddOzm+sRNo1Bc3S6Q ($129.30 in chips)
Seat 2: 2UMlbaZ8n8AbRli0Yr0mDw ($23 in chips)
Seat 3: TSuRyAHnUPCFjP7Z0rEE0w ($100 in chips)
Seat 4: w02zQzNydODiyV9THKgo9w ($46.50 in chips)
Seat 5: ozrlafxxh1HmYdA0/h+MuA ($45.75 in chips)
ozrlafxxh1HmYdA0/h+MuA: posts small blind $0.50
6tvjsJrdmWg+g7FVrMnzXA: is sitting out
AdLVjddOzm+sRNo1Bc3S6Q: posts big blind $1
*** HOLE CARDS ***
2UMlbaZ8n8AbRli0Yr0mDw: folds
TSuRyAHnUPCFjP7Z0rEE0w: folds
w02zQzNydODiyV9THKgo9w: calls $1
ozrlafxxh1HmYdA0/h+MuA: calls $0.50
AdLVjddOzm+sRNo1Bc3S6Q: raises $5 to $6
w02zQzNydODiyV9THKgo9w: folds
ozrlafxxh1HmYdA0/h+MuA: folds
6tvjsJrdmWg+g7FVrMnzXA leaves the table
AdLVjddOzm+sRNo1Bc3S6Q collected $3 from pot
AdLVjddOzm+sRNo1Bc3S6Q: doesn't show hand
*** SUMMARY ***
Total pot $3 | Rake $0
Seat 1: AdLVjddOzm+sRNo1Bc3S6Q (big blind) collected ($3)
Seat 2: 2UMlbaZ8n8AbRli0Yr0mDw folded before Flop (didn't bet)
Seat 3: TSuRyAHnUPCFjP7Z0rEE0w folded before Flop (didn't bet)
Seat 4: w02zQzNydODiyV9THKgo9w (button) folded before Flop
Seat 5: ozrlafxxh1HmYdA0/h+MuA (small blind) folded before Flop



PokerStars Game #59940005374:  Hold'em No Limit ($0.50/$1.00) - 2009/07/01 0:54:43 ET
Table 'uNlePsyMIqzM691Xkrlk6Q' 9-max Seat #2 is the button
Seat 1: bLbSOSmSOnqE0iTcH/5dxA ($100 in chips)
Seat 2: +OqpStnt0FqbCfyHAWaLbg ($86.10 in chips)
Seat 3: h7qXkU57Bb8ZuPwMyxR8Ug ($29.25 in chips)
Seat 4: TZcz9MEWDA+WydgGruqqbw ($102.65 in chips)
Seat 5: 3obndzTJ6fECz8+wWhMd1w ($18.50 in chips)
Seat 6: myIxN7otsyr846M539YR8Q ($18.50 in chips)
Seat 7: w6cw9nzN7AvkkHBVVjykoQ ($55.75 in chips)
Seat 8: laA8va+Yv8WuMqT1zdR91g ($101 in chips)
Seat 9: vR4IO10geOgvTW+LAUBv/A ($100 in chips)
h7qXkU57Bb8ZuPwMyxR8Ug: posts small blind $0.50
TZcz9MEWDA+WydgGruqqbw: posts big blind $1
*** HOLE CARDS ***
3obndzTJ6fECz8+wWhMd1w: folds
myIxN7otsyr846M539YR8Q: folds
w6cw9nzN7AvkkHBVVjykoQ: folds
laA8va+Yv8WuMqT1zdR91g: folds
vR4IO10geOgvTW+LAUBv/A: folds
bLbSOSmSOnqE0iTcH/5dxA: folds
+OqpStnt0FqbCfyHAWaLbg: folds
h7qXkU57Bb8ZuPwMyxR8Ug: calls $0.50
TZcz9MEWDA+WydgGruqqbw: checks
*** FLOP *** [Qc 4d 9d]
h7qXkU57Bb8ZuPwMyxR8Ug: bets $1
TZcz9MEWDA+WydgGruqqbw: folds
h7qXkU57Bb8ZuPwMyxR8Ug collected $1.90 from pot
*** SUMMARY ***
Total pot $2 | Rake $0.10
Board [Qc 4d 9d]
Seat 1: bLbSOSmSOnqE0iTcH/5dxA folded before Flop (didn't bet)
Seat 2: +OqpStnt0FqbCfyHAWaLbg (button) folded before Flop (didn't bet)
Seat 3: h7qXkU57Bb8ZuPwMyxR8Ug (small blind) collected ($1.90)
Seat 4: TZcz9MEWDA+WydgGruqqbw (big blind) folded on the Flop
Seat 5: 3obndzTJ6fECz8+wWhMd1w folded before Flop (didn't bet)
Seat 6: myIxN7otsyr846M539YR8Q folded before Flop (didn't bet)
Seat 7: w6cw9nzN7AvkkHBVVjykoQ folded before Flop (didn't bet)
Seat 8: laA8va+Yv8WuMqT1zdR91g folded before Flop (didn't bet)
Seat 9: vR4IO10geOgvTW+LAUBv/A folded before Flop (didn't bet)



PokerStars Game #59940005244:  Hold'em No Limit ($0.50/$1.00) - 2009/07/01 0:54:43 ET
Table 'JOIm/fogLA7vSG0Vc6ME1A' 2-max Seat #2 is the button
Seat 1: NYi6JFscYNrofSXy4sM+Yw ($140.70 in chips)
Seat 2: F5lNTyZLIX9W2wQZ0plwgg ($112.60 in chips)
F5lNTyZLIX9W2wQZ0plwgg: posts small blind $0.50
NYi6JFscYNrofSXy4sM+Yw: posts big blind $1
*** HOLE CARDS ***
F5lNTyZLIX9W2wQZ0plwgg: raises $4 to $5
NYi6JFscYNrofSXy4sM+Yw: calls $4
*** FLOP *** [Ts Jd Th]
NYi6JFscYNrofSXy4sM+Yw: checks
F5lNTyZLIX9W2wQZ0plwgg: bets $3
NYi6JFscYNrofSXy4sM+Yw: calls $3
*** TURN *** [Ts Jd Th] [Qh]
NYi6JFscYNrofSXy4sM+Yw: checks
F5lNTyZLIX9W2wQZ0plwgg: bets $13
NYi6JFscYNrofSXy4sM+Yw: folds
F5lNTyZLIX9W2wQZ0plwgg collected $15.50 from pot
F5lNTyZLIX9W2wQZ0plwgg: doesn't show hand
*** SUMMARY ***
Total pot $16 | Rake $0.50
Board [Ts Jd Th Qh]
Seat 1: NYi6JFscYNrofSXy4sM+Yw (big blind) folded on the Turn
Seat 2: F5lNTyZLIX9W2wQZ0plwgg (button) (small blind) collected ($15.50)



PokerStars Game #59940006584:  Hold'em No Limit ($0.50/$1.00) - 2009/07/01 0:54:45 ET
Table '7Nl0ffnjeK44/vmeexh3MQ' 9-max Seat #1 is the button
Seat 1: s7D3Y+k4Cj4D1cXHv7oj+Q ($94.20 in chips)
Seat 2: OGgaARGdJQT4awWVNQ957w ($100 in chips)
Seat 3: vR4IO10geOgvTW+LAUBv/A ($100 in chips)
Seat 4: bLbSOSmSOnqE0iTcH/5dxA ($113 in chips)
Seat 5: bL+QVeDcuEdzMGAGg2XJHg ($106.75 in chips)
Seat 6: FVs16t7GgfWgQWt4JxsObQ ($26.20 in chips)
Seat 7: 997ViqAtWn1FPjJqcffwcA ($100 in chips)
Seat 9: ouwUBGRKnKK9uhn1G4Lf+A ($99.50 in chips)
OGgaARGdJQT4awWVNQ957w: posts small blind $0.50
vR4IO10geOgvTW+LAUBv/A: posts big blind $1
D+W9Me7w6Hcx/WRUSKV0dw: sits out
*** HOLE CARDS ***
bLbSOSmSOnqE0iTcH/5dxA: folds
bL+QVeDcuEdzMGAGg2XJHg: folds
FVs16t7GgfWgQWt4JxsObQ: folds
997ViqAtWn1FPjJqcffwcA: folds
ouwUBGRKnKK9uhn1G4Lf+A: raises $3 to $4
s7D3Y+k4Cj4D1cXHv7oj+Q: folds
OGgaARGdJQT4awWVNQ957w: raises $8.50 to $12.50
vR4IO10geOgvTW+LAUBv/A: folds
ouwUBGRKnKK9uhn1G4Lf+A: raises $13.50 to $26
OGgaARGdJQT4awWVNQ957w: raises $74 to $100 and is all-in
ouwUBGRKnKK9uhn1G4Lf+A: calls $73.50 and is all-in
*** FLOP *** [8c 9h 3s]
*** TURN *** [8c 9h 3s] [4d]
*** RIVER *** [8c 9h 3s 4d] [9c]
*** SHOW DOWN ***
OGgaARGdJQT4awWVNQ957w: shows [As Ks] (a pair of Nines)
ouwUBGRKnKK9uhn1G4Lf+A: shows [Qc Qh] (two pair, Queens and Nines)
ouwUBGRKnKK9uhn1G4Lf+A collected $197 from pot
*** SUMMARY ***
Total pot $200 | Rake $3
Board [8c 9h 3s 4d 9c]
Seat 1: s7D3Y+k4Cj4D1cXHv7oj+Q (button) folded before Flop (didn't bet)
Seat 2: OGgaARGdJQT4awWVNQ957w (small blind) showed [As Ks] and lost with a pair of Nines
Seat 3: vR4IO10geOgvTW+LAUBv/A (big blind) folded before Flop
Seat 4: bLbSOSmSOnqE0iTcH/5dxA folded before Flop (didn't bet)
Seat 5: bL+QVeDcuEdzMGAGg2XJHg folded before Flop (didn't bet)
Seat 6: FVs16t7GgfWgQWt4JxsObQ folded before Flop (didn't bet)
Seat 7: 997ViqAtWn1FPjJqcffwcA folded before Flop (didn't bet)
Seat 9: ouwUBGRKnKK9uhn1G4Lf+A showed [Qc Qh] and won ($197) with two pair, Queens and Nines



PokerStars Game #59940008000:  Hold'em No Limit ($0.50/$1.00) - 2009/07/01 0:54:47 ET
Table 'iSx0wTgVb4o7MyZeOe06ZA' 9-max Seat #9 is the button
Seat 1: RSlQ91LM/HQyM+SR8KWgqw ($51.30 in chips)
Seat 2: myIxN7otsyr846M539YR8Q ($20 in chips)
Seat 3: XQV7mCMbzd2Wh/l74wmbug ($86.65 in chips)
Seat 4: Ogn4JDV3mp4ZDKO49IFzKA ($46.55 in chips)
Seat 5: o1axyw4AjQ8n4ubTwlirQQ ($23.50 in chips)
Seat 6: T5/PXFS/W+LLcIXBo1G/RA ($100.15 in chips)
Seat 7: w4NnqVr/Sfoj65ux/fEUyQ ($71.50 in chips)
Seat 8: gUUvmqdVlmvpal6B8nYrmg ($100 in chips)
Seat 9: DMQXVuViR4IFzRccosBkJw ($79.05 in chips)
RSlQ91LM/HQyM+SR8KWgqw: posts small blind $0.50
myIxN7otsyr846M539YR8Q: posts big blind $1
*** HOLE CARDS ***
XQV7mCMbzd2Wh/l74wmbug: folds
Ogn4JDV3mp4ZDKO49IFzKA: folds
o1axyw4AjQ8n4ubTwlirQQ: folds
T5/PXFS/W+LLcIXBo1G/RA: folds
w4NnqVr/Sfoj65ux/fEUyQ: folds
gUUvmqdVlmvpal6B8nYrmg: folds
DMQXVuViR4IFzRccosBkJw: folds
RSlQ91LM/HQyM+SR8KWgqw: calls $0.50
myIxN7otsyr846M539YR8Q: checks
*** FLOP *** [4d 9d Tc]
RSlQ91LM/HQyM+SR8KWgqw: bets $1
myIxN7otsyr846M539YR8Q: folds
RSlQ91LM/HQyM+SR8KWgqw collected $1.90 from pot
*** SUMMARY ***
Total pot $2 | Rake $0.10
Board [4d 9d Tc]
Seat 1: RSlQ91LM/HQyM+SR8KWgqw (small blind) collected ($1.90)
Seat 2: myIxN7otsyr846M539YR8Q (big blind) folded on the Flop
Seat 3: XQV7mCMbzd2Wh/l74wmbug folded before Flop (didn't bet)
Seat 4: Ogn4JDV3mp4ZDKO49IFzKA folded before Flop (didn't bet)
Seat 5: o1axyw4AjQ8n4ubTwlirQQ folded before Flop (didn't bet)
Seat 6: T5/PXFS/W+LLcIXBo1G/RA folded before Flop (didn't bet)
Seat 7: w4NnqVr/Sfoj65ux/fEUyQ folded before Flop (didn't bet)
Seat 8: gUUvmqdVlmvpal6B8nYrmg folded before Flop (didn't bet)
Seat 9: DMQXVuViR4IFzRccosBkJw (button) folded before Flop (didn't bet)



PokerStars Game #59940008340:  Hold'em No Limit ($0.50/$1.00) - 2009/07/01 0:54:48 ET
Table 'hugOjcwJvzEwZbK7tyiWuQ' 9-max Seat #5 is the button
Seat 2: r27C1nIV4NS4+qbnrgBQSw ($262.50 in chips)
Seat 3: jDwhY1kCdc6EkAHbT7PJMQ ($102.15 in chips)
Seat 4: UWB3oeddt/GObx2Mix2Anw ($204.25 in chips)
Seat 5: 5BRGWf+R3nt2WS3b5xX+zA ($27.20 in chips)
Seat 6: gUUvmqdVlmvpal6B8nYrmg ($102.20 in chips)
Seat 7: FL3MrLspcF23LYvC4ipBOA ($113.30 in chips)
Seat 8: /zy+DB4S5fUQUSfZWFzYGw ($100 in chips)
Seat 9: W8P9bUKCs43TO1xHm0dL6w ($89.45 in chips)
gUUvmqdVlmvpal6B8nYrmg: posts small blind $0.50
FL3MrLspcF23LYvC4ipBOA: posts big blind $1
D+W9Me7w6Hcx/WRUSKV0dw: sits out
*** HOLE CARDS ***
/zy+DB4S5fUQUSfZWFzYGw: folds
W8P9bUKCs43TO1xHm0dL6w: folds
r27C1nIV4NS4+qbnrgBQSw: folds
jDwhY1kCdc6EkAHbT7PJMQ: folds
UWB3oeddt/GObx2Mix2Anw: folds
5BRGWf+R3nt2WS3b5xX+zA: calls $1
gUUvmqdVlmvpal6B8nYrmg: calls $0.50
FL3MrLspcF23LYvC4ipBOA: checks
*** FLOP *** [Qc 8h 5h]
gUUvmqdVlmvpal6B8nYrmg: bets $2
FL3MrLspcF23LYvC4ipBOA: folds
5BRGWf+R3nt2WS3b5xX+zA: calls $2
*** TURN *** [Qc 8h 5h] [4s]
gUUvmqdVlmvpal6B8nYrmg: checks
5BRGWf+R3nt2WS3b5xX+zA: checks
*** RIVER *** [Qc 8h 5h 4s] [Ah]
gUUvmqdVlmvpal6B8nYrmg: bets $4
5BRGWf+R3nt2WS3b5xX+zA: folds
gUUvmqdVlmvpal6B8nYrmg collected $6.70 from pot
*** SUMMARY ***
Total pot $7 | Rake $0.30
Board [Qc 8h 5h 4s Ah]
Seat 2: r27C1nIV4NS4+qbnrgBQSw folded before Flop (didn't bet)
Seat 3: jDwhY1kCdc6EkAHbT7PJMQ folded before Flop (didn't bet)
Seat 4: UWB3oeddt/GObx2Mix2Anw folded before Flop (didn't bet)
Seat 5: 5BRGWf+R3nt2WS3b5xX+zA (button) folded on the River
Seat 6: gUUvmqdVlmvpal6B8nYrmg (small blind) collected ($6.70)
Seat 7: FL3MrLspcF23LYvC4ipBOA (big blind) folded on the Flop
Seat 8: /zy+DB4S5fUQUSfZWFzYGw folded before Flop (didn't bet)
Seat 9: W8P9bUKCs43TO1xHm0dL6w folded before Flop (didn't bet)



PokerStars Game #59940010008:  Hold'em No Limit ($0.50/$1.00) - 2009/07/01 0:54:51 ET
Table 'LmXQK9xy3awB+qsPzI21Mw' 2-max Seat #2 is the button
Seat 1: NYi6JFscYNrofSXy4sM+Yw ($334.35 in chips)
Seat 2: TME8GvochpQAo8cmJwWmvA ($57.05 in chips)
TME8GvochpQAo8cmJwWmvA: posts small blind $0.50
NYi6JFscYNrofSXy4sM+Yw: posts big blind $1
*** HOLE CARDS ***
TME8GvochpQAo8cmJwWmvA: raises $1 to $2
NYi6JFscYNrofSXy4sM+Yw: folds
TME8GvochpQAo8cmJwWmvA collected $2 from pot
TME8GvochpQAo8cmJwWmvA: doesn't show hand
*** SUMMARY ***
Total pot $2 | Rake $0
Seat 1: NYi6JFscYNrofSXy4sM+Yw (big blind) folded before Flop
Seat 2: TME8GvochpQAo8cmJwWmvA (button) (small blind) collected ($2)



PokerStars Game #59940010436:  Hold'em No Limit ($0.50/$1.00) - 2009/07/01 0:54:51 ET
Table 'rmZfTK+oSebeUPJNbWhdAA' 6-max Seat #1 is the button
Seat 1: xAU6q2/cwmby2sxmA8VcmA ($100 in chips)
Seat 2: z7O9PO/WEcqRouIydFhS9Q ($83.95 in chips)
Seat 3: BCEV3COoKY607AzLWayfRA ($100 in chips)
Seat 4: 1/mIuXfgx1ZyVkodrmfQDw ($100 in chips)
Seat 5: 5lY8d6Cnm4HUkt/8FZSj4g ($155.60 in chips)
Seat 6: j7NIOHLZk7V2o9fOioO5ug ($119.80 in chips)
z7O9PO/WEcqRouIydFhS9Q: posts small blind $0.50
BCEV3COoKY607AzLWayfRA: posts big blind $1
*** HOLE CARDS ***
1/mIuXfgx1ZyVkodrmfQDw: folds
5lY8d6Cnm4HUkt/8FZSj4g: folds
j7NIOHLZk7V2o9fOioO5ug: folds
xAU6q2/cwmby2sxmA8VcmA: raises $3 to $4
z7O9PO/WEcqRouIydFhS9Q: folds
BCEV3COoKY607AzLWayfRA: folds
xAU6q2/cwmby2sxmA8VcmA collected $2.50 from pot
xAU6q2/cwmby2sxmA8VcmA: doesn't show hand
*** SUMMARY ***
Total pot $2.50 | Rake $0
Seat 1: xAU6q2/cwmby2sxmA8VcmA (button) collected ($2.50)
Seat 2: z7O9PO/WEcqRouIydFhS9Q (small blind) folded before Flop
Seat 3: BCEV3COoKY607AzLWayfRA (big blind) folded before Flop
Seat 4: 1/mIuXfgx1ZyVkodrmfQDw folded before Flop (didn't bet)
Seat 5: 5lY8d6Cnm4HUkt/8FZSj4g folded before Flop (didn't bet)
Seat 6: j7NIOHLZk7V2o9fOioO5ug folded before Flop (didn't bet)



PokerStars Game #59940010910:  Hold'em No Limit ($0.50/$1.00) - 2009/07/01 0:54:52 ET
Table 'mmbQQVBTrPdE+wy+s+9VPA' 6-max Seat #3 is the button
Seat 1: JwCcjZl0bjJzG7hmE0dnTA ($100 in chips)
Seat 2: +W6OnF033KNM2xH0fGj98Q ($140.60 in chips)
Seat 3: wx3sQGkVi2x9wJXuWNHPBw ($114.15 in chips)
Seat 4: V3iZdcw61nXF3g5hD2RrsQ ($100.50 in chips)
Seat 5: YMJG+F++3Aj6P8dAWda5fw ($99.50 in chips)
Seat 6: U2CWBTv29qdCbj8RNF2sIw ($98.50 in chips)
V3iZdcw61nXF3g5hD2RrsQ: posts small blind $0.50
YMJG+F++3Aj6P8dAWda5fw: posts big blind $1
*** HOLE CARDS ***
U2CWBTv29qdCbj8RNF2sIw: folds
JwCcjZl0bjJzG7hmE0dnTA: folds
+W6OnF033KNM2xH0fGj98Q: folds
wx3sQGkVi2x9wJXuWNHPBw: folds
V3iZdcw61nXF3g5hD2RrsQ: folds
YMJG+F++3Aj6P8dAWda5fw collected $1 from pot
*** SUMMARY ***
Total pot $1 | Rake $0
Seat 1: JwCcjZl0bjJzG7hmE0dnTA folded before Flop (didn't bet)
Seat 2: +W6OnF033KNM2xH0fGj98Q folded before Flop (didn't bet)
Seat 3: wx3sQGkVi2x9wJXuWNHPBw (button) folded before Flop (didn't bet)
Seat 4: V3iZdcw61nXF3g5hD2RrsQ (small blind) folded before Flop
Seat 5: YMJG+F++3Aj6P8dAWda5fw (big blind) collected ($1)
Seat 6: U2CWBTv29qdCbj8RNF2sIw folded before Flop (didn't bet)



PokerStars Game #59940012186:  Hold'em No Limit ($0.50/$1.00) - 2009/07/01 0:54:54 ET
Table 'pHrhryH8jPNdQfY62f8v+g' 6-max Seat #2 is the button
Seat 2: RqgF7gRoKgRNW8Zoi1ty4A ($100.75 in chips)
Seat 3: 8oS5O7iD/qnFXFXJrGIgNQ ($155.70 in chips)
Seat 4: wenbG7TaM3H7h5kn78OFNw ($58.70 in chips)
Seat 5: r1/R7y0Ortgoz4lccgW8VA ($49.90 in chips)
Seat 6: xAU6q2/cwmby2sxmA8VcmA ($118.80 in chips)
8oS5O7iD/qnFXFXJrGIgNQ: posts small blind $0.50
wenbG7TaM3H7h5kn78OFNw: posts big blind $1
*** HOLE CARDS ***
r1/R7y0Ortgoz4lccgW8VA: folds
xAU6q2/cwmby2sxmA8VcmA: raises $3 to $4
RqgF7gRoKgRNW8Zoi1ty4A: folds
8oS5O7iD/qnFXFXJrGIgNQ: folds
wenbG7TaM3H7h5kn78OFNw: calls $3
*** FLOP *** [Kc 7h 5s]
wenbG7TaM3H7h5kn78OFNw: bets $3
xAU6q2/cwmby2sxmA8VcmA: folds
wenbG7TaM3H7h5kn78OFNw collected $8.10 from pot
*** SUMMARY ***
Total pot $8.50 | Rake $0.40
Board [Kc 7h 5s]
Seat 2: RqgF7gRoKgRNW8Zoi1ty4A (button) folded before Flop (didn't bet)
Seat 3: 8oS5O7iD/qnFXFXJrGIgNQ (small blind) folded before Flop
Seat 4: wenbG7TaM3H7h5kn78OFNw (big blind) collected ($8.10)
Seat 5: r1/R7y0Ortgoz4lccgW8VA folded before Flop (didn't bet)
Seat 6: xAU6q2/cwmby2sxmA8VcmA folded on the Flop



PokerStars Game #59940014872:  Hold'em No Limit ($0.50/$1.00) - 2009/07/01 0:54:59 ET
Table 'cKH9c4x6u79IqCdaKKvXrw' 9-max Seat #3 is the button
Seat 1: Pp/KTcXkfZKKUHkjyaLTdg ($15.50 in chips)
Seat 2: 8S3JMH4TY3whgIlZmMv66w ($44.35 in chips)
Seat 3: 997ViqAtWn1FPjJqcffwcA ($157.10 in chips)
Seat 4: FL3MrLspcF23LYvC4ipBOA ($100 in chips)
Seat 5: Jjc7EHWzs4//xUAjJ0UWoA ($39.50 in chips)
Seat 6: Bsd/K5gAcLanYbGiPirRjw ($207.55 in chips)
Seat 7: 1GkkVBhlJ92guE6K5mS5Ig ($38.80 in chips)
Seat 9: 6XkTu4ahxzHnvjjc1R8YjQ ($43.10 in chips)
FL3MrLspcF23LYvC4ipBOA: posts small blind $0.50
Jjc7EHWzs4//xUAjJ0UWoA: posts big blind $1
myIxN7otsyr846M539YR8Q: sits out
*** HOLE CARDS ***
Bsd/K5gAcLanYbGiPirRjw: folds
1GkkVBhlJ92guE6K5mS5Ig: raises $2 to $3
6XkTu4ahxzHnvjjc1R8YjQ: folds
Pp/KTcXkfZKKUHkjyaLTdg: folds
8S3JMH4TY3whgIlZmMv66w: calls $3
997ViqAtWn1FPjJqcffwcA: folds
FL3MrLspcF23LYvC4ipBOA: folds
Jjc7EHWzs4//xUAjJ0UWoA: folds
*** FLOP *** [Ks Kh Qd]
1GkkVBhlJ92guE6K5mS5Ig: bets $3
8S3JMH4TY3whgIlZmMv66w: calls $3
*** TURN *** [Ks Kh Qd] [6h]
1GkkVBhlJ92guE6K5mS5Ig: bets $3
8S3JMH4TY3whgIlZmMv66w: calls $3
*** RIVER *** [Ks Kh Qd 6h] [2h]
1GkkVBhlJ92guE6K5mS5Ig: bets $9
8S3JMH4TY3whgIlZmMv66w: raises $9 to $18
1GkkVBhlJ92guE6K5mS5Ig: calls $9
*** SHOW DOWN ***
8S3JMH4TY3whgIlZmMv66w: shows [Qs Kc] (a full house, Kings full of Queens)
1GkkVBhlJ92guE6K5mS5Ig: mucks hand
8S3JMH4TY3whgIlZmMv66w collected $52.80 from pot
*** SUMMARY ***
Total pot $55.50 | Rake $2.70
Board [Ks Kh Qd 6h 2h]
Seat 1: Pp/KTcXkfZKKUHkjyaLTdg folded before Flop (didn't bet)
Seat 2: 8S3JMH4TY3whgIlZmMv66w showed [Qs Kc] and won ($52.80) with a full house, Kings full of Queens
Seat 3: 997ViqAtWn1FPjJqcffwcA (button) folded before Flop (didn't bet)
Seat 4: FL3MrLspcF23LYvC4ipBOA (small blind) folded before Flop
Seat 5: Jjc7EHWzs4//xUAjJ0UWoA (big blind) folded before Flop
Seat 6: Bsd/K5gAcLanYbGiPirRjw folded before Flop (didn't bet)
Seat 7: 1GkkVBhlJ92guE6K5mS5Ig mucked
Seat 9: 6XkTu4ahxzHnvjjc1R8YjQ folded before Flop (didn't bet)



PokerStars Game #59940015574:  Hold'em No Limit ($0.50/$1.00) - 2009/07/01 0:55:00 ET
Table 'GxCPo/gd3OSthkYrAxJngg' 6-max Seat #3 is the button
Seat 1: sH8BpAFP+jGFxCgVpD1Lew ($261.25 in chips)
Seat 2: YExX2paeIHrmfIwV1ivM/w ($79.20 in chips)
Seat 3: o6plE+MSW4XFNTeONe16xg ($28.10 in chips)
Seat 4: YMJG+F++3Aj6P8dAWda5fw ($206.60 in chips)
Seat 5: G5ZSSN6RSON3gkNvk/SmYg ($106.75 in chips)
YMJG+F++3Aj6P8dAWda5fw: posts small blind $0.50
G5ZSSN6RSON3gkNvk/SmYg: posts big blind $1
*** HOLE CARDS ***
sH8BpAFP+jGFxCgVpD1Lew: calls $1
YExX2paeIHrmfIwV1ivM/w: folds
o6plE+MSW4XFNTeONe16xg: folds
YMJG+F++3Aj6P8dAWda5fw: folds
G5ZSSN6RSON3gkNvk/SmYg: checks
*** FLOP *** [7d 8s 5c]
G5ZSSN6RSON3gkNvk/SmYg: checks
sS9IXedL3MiRmpVXhAILhw leaves the table
sH8BpAFP+jGFxCgVpD1Lew: bets $2
G5ZSSN6RSON3gkNvk/SmYg: folds
sH8BpAFP+jGFxCgVpD1Lew collected $2.40 from pot
*** SUMMARY ***
Total pot $2.50 | Rake $0.10
Board [7d 8s 5c]
Seat 1: sH8BpAFP+jGFxCgVpD1Lew collected ($2.40)
Seat 2: YExX2paeIHrmfIwV1ivM/w folded before Flop (didn't bet)
Seat 3: o6plE+MSW4XFNTeONe16xg (button) folded before Flop (didn't bet)
Seat 4: YMJG+F++3Aj6P8dAWda5fw (small blind) folded before Flop
Seat 5: G5ZSSN6RSON3gkNvk/SmYg (big blind) folded on the Flop



PokerStars Game #59940015654:  Hold'em No Limit ($0.50/$1.00) - 2009/07/01 0:55:00 ET
Table 'LmXQK9xy3awB+qsPzI21Mw' 2-max Seat #1 is the button
Seat 1: NYi6JFscYNrofSXy4sM+Yw ($333.35 in chips)
Seat 2: TME8GvochpQAo8cmJwWmvA ($58.05 in chips)
NYi6JFscYNrofSXy4sM+Yw: posts small blind $0.50
TME8GvochpQAo8cmJwWmvA: posts big blind $1
*** HOLE CARDS ***
NYi6JFscYNrofSXy4sM+Yw: raises $2 to $3
TME8GvochpQAo8cmJwWmvA: folds
NYi6JFscYNrofSXy4sM+Yw collected $2 from pot
*** SUMMARY ***
Total pot $2 | Rake $0
Seat 1: NYi6JFscYNrofSXy4sM+Yw (button) (small blind) collected ($2)
Seat 2: TME8GvochpQAo8cmJwWmvA (big blind) folded before Flop



PokerStars Game #59940017410:  Hold'em No Limit ($0.50/$1.00) - 2009/07/01 0:55:02 ET
Table '/RZcOwpZpHQ+OwPwjsbnRw' 6-max Seat #3 is the button
Seat 1: Zboa6dColKGHBjLPUakZjw ($68.90 in chips)
Seat 2: +xW7QemQU0Fxs+4TnqBRow ($206.15 in chips)
Seat 3: XnT1yK2DD/5FL+0bwuEhqg ($44.95 in chips)
Seat 4: j7NIOHLZk7V2o9fOioO5ug ($100 in chips)
Seat 5: wx3sQGkVi2x9wJXuWNHPBw ($180.65 in chips)
Seat 6: XOIf9W+VAxhZqN+SYoyMKA ($291.75 in chips)
j7NIOHLZk7V2o9fOioO5ug: posts small blind $0.50
wx3sQGkVi2x9wJXuWNHPBw: posts big blind $1
*** HOLE CARDS ***
XOIf9W+VAxhZqN+SYoyMKA: folds
Zboa6dColKGHBjLPUakZjw: folds
+xW7QemQU0Fxs+4TnqBRow: folds
XnT1yK2DD/5FL+0bwuEhqg: raises $2 to $3
j7NIOHLZk7V2o9fOioO5ug: folds
wx3sQGkVi2x9wJXuWNHPBw: folds
XnT1yK2DD/5FL+0bwuEhqg collected $2.50 from pot
*** SUMMARY ***
Total pot $2.50 | Rake $0
Seat 1: Zboa6dColKGHBjLPUakZjw folded before Flop (didn't bet)
Seat 2: +xW7QemQU0Fxs+4TnqBRow folded before Flop (didn't bet)
Seat 3: XnT1yK2DD/5FL+0bwuEhqg (button) collected ($2.50)
Seat 4: j7NIOHLZk7V2o9fOioO5ug (small blind) folded before Flop
Seat 5: wx3sQGkVi2x9wJXuWNHPBw (big blind) folded before Flop
Seat 6: XOIf9W+VAxhZqN+SYoyMKA folded before Flop (didn't bet)



PokerStars Game #59940018172:  Hold'em No Limit ($0.50/$1.00) - 2009/07/01 0:55:04 ET
Table '+cA8mcmhaedZ7YcrDdhmeQ' 6-max Seat #5 is the button
Seat 1: lsLuWlcPA3Rh7kJVLzMh0Q ($287.50 in chips)
Seat 2: RqgF7gRoKgRNW8Zoi1ty4A ($105.95 in chips)
Seat 3: 7H5WkGzGvsv56y1iaqHvRg ($54.85 in chips)
Seat 4: JwCcjZl0bjJzG7hmE0dnTA ($100 in chips)
Seat 5: +7hFKAL0b0O/n8G72TclJA ($54.05 in chips)
Seat 6: YfsTQsY/fxb+YqbdclTHuw ($27.95 in chips)
YfsTQsY/fxb+YqbdclTHuw: posts small blind $0.50
lsLuWlcPA3Rh7kJVLzMh0Q: posts big blind $1
*** HOLE CARDS ***
RqgF7gRoKgRNW8Zoi1ty4A: folds
7H5WkGzGvsv56y1iaqHvRg: folds
JwCcjZl0bjJzG7hmE0dnTA: raises $2 to $3
+7hFKAL0b0O/n8G72TclJA: folds
YfsTQsY/fxb+YqbdclTHuw: folds
lsLuWlcPA3Rh7kJVLzMh0Q: folds
JwCcjZl0bjJzG7hmE0dnTA collected $2.50 from pot
*** SUMMARY ***
Total pot $2.50 | Rake $0
Seat 1: lsLuWlcPA3Rh7kJVLzMh0Q (big blind) folded before Flop
Seat 2: RqgF7gRoKgRNW8Zoi1ty4A folded before Flop (didn't bet)
Seat 3: 7H5WkGzGvsv56y1iaqHvRg folded before Flop (didn't bet)
Seat 4: JwCcjZl0bjJzG7hmE0dnTA collected ($2.50)
Seat 5: +7hFKAL0b0O/n8G72TclJA (button) folded before Flop (didn't bet)
Seat 6: YfsTQsY/fxb+YqbdclTHuw (small blind) folded before Flop



PokerStars Game #59940018924:  Hold'em No Limit ($0.50/$1.00) - 2009/07/01 0:55:05 ET
Table 'JOIm/fogLA7vSG0Vc6ME1A' 2-max Seat #1 is the button
Seat 1: NYi6JFscYNrofSXy4sM+Yw ($132.70 in chips)
Seat 2: F5lNTyZLIX9W2wQZ0plwgg ($120.10 in chips)
NYi6JFscYNrofSXy4sM+Yw: posts small blind $0.50
F5lNTyZLIX9W2wQZ0plwgg: posts big blind $1
*** HOLE CARDS ***
NYi6JFscYNrofSXy4sM+Yw: folds
F5lNTyZLIX9W2wQZ0plwgg collected $1 from pot
*** SUMMARY ***
Total pot $1 | Rake $0
Seat 1: NYi6JFscYNrofSXy4sM+Yw (button) (small blind) folded before Flop
Seat 2: F5lNTyZLIX9W2wQZ0plwgg (big blind) collected ($1)



PokerStars Game #59940019486:  Hold'em No Limit ($0.50/$1.00) - 2009/07/01 0:55:06 ET
Table 'LmXQK9xy3awB+qsPzI21Mw' 2-max Seat #2 is the button
Seat 1: NYi6JFscYNrofSXy4sM+Yw ($334.35 in chips)
Seat 2: TME8GvochpQAo8cmJwWmvA ($57.05 in chips)
TME8GvochpQAo8cmJwWmvA: posts small blind $0.50
NYi6JFscYNrofSXy4sM+Yw: posts big blind $1
*** HOLE CARDS ***
TME8GvochpQAo8cmJwWmvA: calls $0.50
NYi6JFscYNrofSXy4sM+Yw: checks
*** FLOP *** [Qd Qc 9s]
NYi6JFscYNrofSXy4sM+Yw: bets $1
TME8GvochpQAo8cmJwWmvA: folds
NYi6JFscYNrofSXy4sM+Yw collected $1.90 from pot
NYi6JFscYNrofSXy4sM+Yw: doesn't show hand
*** SUMMARY ***
Total pot $2 | Rake $0.10
Board [Qd Qc 9s]
Seat 1: NYi6JFscYNrofSXy4sM+Yw (big blind) collected ($1.90)
Seat 2: TME8GvochpQAo8cmJwWmvA (button) (small blind) folded on the Flop



PokerStars Game #59940022320:  Hold'em No Limit ($0.50/$1.00) - 2009/07/01 0:55:10 ET
Table 'eU3bWpDDg3Z+9R4m4iVmog' 6-max Seat #2 is the button
Seat 1: TSuRyAHnUPCFjP7Z0rEE0w ($192.65 in chips)
Seat 2: 8CAoOzhmB8n3nRFf3V4BTg ($85.80 in chips)
Seat 4: GDVIsbEJ/DOJsMKE4Asz0A ($89.10 in chips)
Seat 5: AdLVjddOzm+sRNo1Bc3S6Q ($110.55 in chips)
Seat 6: hpxXcmRkXXI9HE5+5/j/0Q ($104.95 in chips)
GDVIsbEJ/DOJsMKE4Asz0A: posts small blind $0.50
AdLVjddOzm+sRNo1Bc3S6Q: posts big blind $1
*** HOLE CARDS ***
hpxXcmRkXXI9HE5+5/j/0Q: raises $3 to $4
TSuRyAHnUPCFjP7Z0rEE0w: folds
8CAoOzhmB8n3nRFf3V4BTg: calls $4
GDVIsbEJ/DOJsMKE4Asz0A: folds
AdLVjddOzm+sRNo1Bc3S6Q: calls $3
*** FLOP *** [Tc Qd 3c]
AdLVjddOzm+sRNo1Bc3S6Q: checks
hpxXcmRkXXI9HE5+5/j/0Q: bets $8
8CAoOzhmB8n3nRFf3V4BTg: folds
AdLVjddOzm+sRNo1Bc3S6Q: calls $8
*** TURN *** [Tc Qd 3c] [4s]
AdLVjddOzm+sRNo1Bc3S6Q: checks
hpxXcmRkXXI9HE5+5/j/0Q: checks
*** RIVER *** [Tc Qd 3c 4s] [7h]
AdLVjddOzm+sRNo1Bc3S6Q: checks
hpxXcmRkXXI9HE5+5/j/0Q: bets $15
AdLVjddOzm+sRNo1Bc3S6Q: folds
hpxXcmRkXXI9HE5+5/j/0Q collected $27.15 from pot
hpxXcmRkXXI9HE5+5/j/0Q: doesn't show hand
*** SUMMARY ***
Total pot $28.50 | Rake $1.35
Board [Tc Qd 3c 4s 7h]
Seat 1: TSuRyAHnUPCFjP7Z0rEE0w folded before Flop (didn't bet)
Seat 2: 8CAoOzhmB8n3nRFf3V4BTg (button) folded on the Flop
Seat 4: GDVIsbEJ/DOJsMKE4Asz0A (small blind) folded before Flop
Seat 5: AdLVjddOzm+sRNo1Bc3S6Q (big blind) folded on the River
Seat 6: hpxXcmRkXXI9HE5+5/j/0Q collected ($27.15)



PokerStars Game #59940023052:  Hold'em No Limit ($0.50/$1.00) - 2009/07/01 0:55:11 ET
Table 'W/wyObTiXZm+Ckkl3YxcSw' 6-max Seat #6 is the button
Seat 1: eUBBn2R56C1IQ6Cs/vitwg ($109.75 in chips)
Seat 2: oDiBRCaF0QVtd3kO6xZIXw ($97.30 in chips)
Seat 4: +xW7QemQU0Fxs+4TnqBRow ($100 in chips)
Seat 5: BdbmJTZZ47quA9vUWwXtlw ($65.85 in chips)
Seat 6: tS9JHB1h+FQ++qu8RwRNgg ($39.80 in chips)
eUBBn2R56C1IQ6Cs/vitwg: posts small blind $0.50
oDiBRCaF0QVtd3kO6xZIXw: posts big blind $1
*** HOLE CARDS ***
+xW7QemQU0Fxs+4TnqBRow: folds
BdbmJTZZ47quA9vUWwXtlw: folds
tS9JHB1h+FQ++qu8RwRNgg: folds
eUBBn2R56C1IQ6Cs/vitwg: folds
oDiBRCaF0QVtd3kO6xZIXw collected $1 from pot
oDiBRCaF0QVtd3kO6xZIXw: doesn't show hand
*** SUMMARY ***
Total pot $1 | Rake $0
Seat 1: eUBBn2R56C1IQ6Cs/vitwg (small blind) folded before Flop
Seat 2: oDiBRCaF0QVtd3kO6xZIXw (big blind) collected ($1)
Seat 4: +xW7QemQU0Fxs+4TnqBRow folded before Flop (didn't bet)
Seat 5: BdbmJTZZ47quA9vUWwXtlw folded before Flop (didn't bet)
Seat 6: tS9JHB1h+FQ++qu8RwRNgg (button) folded before Flop (didn't bet)



PokerStars Game #59940022988:  Hold'em No Limit ($0.50/$1.00) - 2009/07/01 0:55:11 ET
Table 'VOs36P6NW+QyXeQ1B62kmA' 6-max Seat #5 is the button
Seat 1: AdLVjddOzm+sRNo1Bc3S6Q ($131.30 in chips)
Seat 2: 2UMlbaZ8n8AbRli0Yr0mDw ($23 in chips)
Seat 3: TSuRyAHnUPCFjP7Z0rEE0w ($100 in chips)
Seat 4: w02zQzNydODiyV9THKgo9w ($45.50 in chips)
Seat 5: ozrlafxxh1HmYdA0/h+MuA ($44.75 in chips)
AdLVjddOzm+sRNo1Bc3S6Q: posts small blind $0.50
2UMlbaZ8n8AbRli0Yr0mDw: posts big blind $1
*** HOLE CARDS ***
TSuRyAHnUPCFjP7Z0rEE0w: raises $3 to $4
w02zQzNydODiyV9THKgo9w: calls $4
ozrlafxxh1HmYdA0/h+MuA: folds
AdLVjddOzm+sRNo1Bc3S6Q: folds
2UMlbaZ8n8AbRli0Yr0mDw: calls $3
*** FLOP *** [Td 5c 3h]
2UMlbaZ8n8AbRli0Yr0mDw: checks
TSuRyAHnUPCFjP7Z0rEE0w: bets $7
w02zQzNydODiyV9THKgo9w: folds
2UMlbaZ8n8AbRli0Yr0mDw: folds
TSuRyAHnUPCFjP7Z0rEE0w collected $11.90 from pot
TSuRyAHnUPCFjP7Z0rEE0w: doesn't show hand
*** SUMMARY ***
Total pot $12.50 | Rake $0.60
Board [Td 5c 3h]
Seat 1: AdLVjddOzm+sRNo1Bc3S6Q (small blind) folded before Flop
Seat 2: 2UMlbaZ8n8AbRli0Yr0mDw (big blind) folded on the Flop
Seat 3: TSuRyAHnUPCFjP7Z0rEE0w collected ($11.90)
Seat 4: w02zQzNydODiyV9THKgo9w folded on the Flop
Seat 5: ozrlafxxh1HmYdA0/h+MuA (button) folded before Flop (didn't bet)



PokerStars Game #59940022722:  Hold'em No Limit ($0.50/$1.00) - 2009/07/01 0:55:11 ET
Table 'JOIm/fogLA7vSG0Vc6ME1A' 2-max Seat #2 is the button
Seat 1: NYi6JFscYNrofSXy4sM+Yw ($132.20 in chips)
Seat 2: F5lNTyZLIX9W2wQZ0plwgg ($120.60 in chips)
F5lNTyZLIX9W2wQZ0plwgg: posts small blind $0.50
NYi6JFscYNrofSXy4sM+Yw: posts big blind $1
*** HOLE CARDS ***
F5lNTyZLIX9W2wQZ0plwgg: raises $4 to $5
NYi6JFscYNrofSXy4sM+Yw: folds
F5lNTyZLIX9W2wQZ0plwgg collected $2 from pot
F5lNTyZLIX9W2wQZ0plwgg: doesn't show hand
*** SUMMARY ***
Total pot $2 | Rake $0
Seat 1: NYi6JFscYNrofSXy4sM+Yw (big blind) folded before Flop
Seat 2: F5lNTyZLIX9W2wQZ0plwgg (button) (small blind) collected ($2)



PokerStars Game #59940025960:  Hold'em No Limit ($0.50/$1.00) - 2009/07/01 0:55:16 ET
Table 'LmXQK9xy3awB+qsPzI21Mw' 2-max Seat #1 is the button
Seat 1: NYi6JFscYNrofSXy4sM+Yw ($335.25 in chips)
Seat 2: TME8GvochpQAo8cmJwWmvA ($56.05 in chips)
NYi6JFscYNrofSXy4sM+Yw: posts small blind $0.50
TME8GvochpQAo8cmJwWmvA: posts big blind $1
*** HOLE CARDS ***
NYi6JFscYNrofSXy4sM+Yw: raises $2 to $3
TME8GvochpQAo8cmJwWmvA: raises $53.05 to $56.05 and is all-in
NYi6JFscYNrofSXy4sM+Yw: folds
TME8GvochpQAo8cmJwWmvA collected $6 from pot
TME8GvochpQAo8cmJwWmvA: doesn't show hand
*** SUMMARY ***
Total pot $6 | Rake $0
Seat 1: NYi6JFscYNrofSXy4sM+Yw (button) (small blind) folded before Flop
Seat 2: TME8GvochpQAo8cmJwWmvA (big blind) collected ($6)



PokerStars Game #59940027140:  Hold'em No Limit ($0.50/$1.00) - 2009/07/01 0:55:18 ET
Table 'JOIm/fogLA7vSG0Vc6ME1A' 2-max Seat #1 is the button
Seat 1: NYi6JFscYNrofSXy4sM+Yw ($131.20 in chips)
Seat 2: F5lNTyZLIX9W2wQZ0plwgg ($121.60 in chips)
NYi6JFscYNrofSXy4sM+Yw: posts small blind $0.50
F5lNTyZLIX9W2wQZ0plwgg: posts big blind $1
*** HOLE CARDS ***
NYi6JFscYNrofSXy4sM+Yw: raises $1 to $2
F5lNTyZLIX9W2wQZ0plwgg: calls $1
*** FLOP *** [4d 5s 6c]
F5lNTyZLIX9W2wQZ0plwgg: bets $1
NYi6JFscYNrofSXy4sM+Yw: raises $3 to $4
F5lNTyZLIX9W2wQZ0plwgg: calls $3
*** TURN *** [4d 5s 6c] [Qh]
F5lNTyZLIX9W2wQZ0plwgg: bets $3
NYi6JFscYNrofSXy4sM+Yw: raises $17 to $20
F5lNTyZLIX9W2wQZ0plwgg: folds
NYi6JFscYNrofSXy4sM+Yw collected $17.50 from pot
*** SUMMARY ***
Total pot $18 | Rake $0.50
Board [4d 5s 6c Qh]
Seat 1: NYi6JFscYNrofSXy4sM+Yw (button) (small blind) collected ($17.50)
Seat 2: F5lNTyZLIX9W2wQZ0plwgg (big blind) folded on the Turn



PokerStars Game #59940027180:  Hold'em No Limit ($0.50/$1.00) - 2009/07/01 0:55:18 ET
Table 'tLrtq7gDzxEvckNAI1OS5Q' 6-max Seat #1 is the button
Seat 1: xNKcQzD9+/iHmtJn4vYq9w ($95.55 in chips)
Seat 2: QHvTZcrKe6+maWUfVjP29Q ($100 in chips)
Seat 3: TPZ+m9x+lwoKpv7TMfAUWA ($203.70 in chips)
Seat 4: +uSzP8Jwnw7sKfQ4s66b7w ($51.30 in chips)
Seat 5: OGMLOcTNYZXZU81au7ztUw ($167.15 in chips)
Seat 6: XUk5GQsfNFpHvaToDZ0rZA ($168.20 in chips)
QHvTZcrKe6+maWUfVjP29Q: posts small blind $0.50
TPZ+m9x+lwoKpv7TMfAUWA: posts big blind $1
*** HOLE CARDS ***
+uSzP8Jwnw7sKfQ4s66b7w: folds
OGMLOcTNYZXZU81au7ztUw: folds
XUk5GQsfNFpHvaToDZ0rZA: folds
xNKcQzD9+/iHmtJn4vYq9w: folds
QHvTZcrKe6+maWUfVjP29Q: folds
TPZ+m9x+lwoKpv7TMfAUWA collected $1 from pot
*** SUMMARY ***
Total pot $1 | Rake $0
Seat 1: xNKcQzD9+/iHmtJn4vYq9w (button) folded before Flop (didn't bet)
Seat 2: QHvTZcrKe6+maWUfVjP29Q (small blind) folded before Flop
Seat 3: TPZ+m9x+lwoKpv7TMfAUWA (big blind) collected ($1)
Seat 4: +uSzP8Jwnw7sKfQ4s66b7w folded before Flop (didn't bet)
Seat 5: OGMLOcTNYZXZU81au7ztUw folded before Flop (didn't bet)
Seat 6: XUk5GQsfNFpHvaToDZ0rZA folded before Flop (didn't bet)



PokerStars Game #59940027110:  Hold'em No Limit ($0.50/$1.00) - 2009/07/01 0:55:18 ET
Table '8jIjWCPY0NGprquL+xcMFg' 9-max Seat #3 is the button
Seat 1: vR4IO10geOgvTW+LAUBv/A ($134.55 in chips)
Seat 2: laA8va+Yv8WuMqT1zdR91g ($106.05 in chips)
Seat 3: tjhwe1V98x2spSoUQER3HQ ($103 in chips)
Seat 4: Jjc7EHWzs4//xUAjJ0UWoA ($19 in chips)
Seat 5: 2YpnxJiexJHyERfbqgwEcw ($87.05 in chips)
Seat 6: GTQkFJtSkbVbnGCktp6e3g ($102.85 in chips)
Seat 7: O3CGPwwUmamrCNHccOilrg ($45.45 in chips)
Seat 9: negfosHnGOZXSHpWDRKyBQ ($23 in chips)
Jjc7EHWzs4//xUAjJ0UWoA: posts small blind $0.50
2YpnxJiexJHyERfbqgwEcw: posts big blind $1
D+W9Me7w6Hcx/WRUSKV0dw: sits out
*** HOLE CARDS ***
GTQkFJtSkbVbnGCktp6e3g: folds
O3CGPwwUmamrCNHccOilrg: folds
negfosHnGOZXSHpWDRKyBQ: folds
vR4IO10geOgvTW+LAUBv/A: raises $2 to $3
laA8va+Yv8WuMqT1zdR91g: folds
tjhwe1V98x2spSoUQER3HQ: folds
Jjc7EHWzs4//xUAjJ0UWoA: folds
2YpnxJiexJHyERfbqgwEcw: folds
vR4IO10geOgvTW+LAUBv/A collected $2.50 from pot
vR4IO10geOgvTW+LAUBv/A: doesn't show hand
*** SUMMARY ***
Total pot $2.50 | Rake $0
Seat 1: vR4IO10geOgvTW+LAUBv/A collected ($2.50)
Seat 2: laA8va+Yv8WuMqT1zdR91g folded before Flop (didn't bet)
Seat 3: tjhwe1V98x2spSoUQER3HQ (button) folded before Flop (didn't bet)
Seat 4: Jjc7EHWzs4//xUAjJ0UWoA (small blind) folded before Flop
Seat 5: 2YpnxJiexJHyERfbqgwEcw (big blind) folded before Flop
Seat 6: GTQkFJtSkbVbnGCktp6e3g folded before Flop (didn't bet)
Seat 7: O3CGPwwUmamrCNHccOilrg folded before Flop (didn't bet)
Seat 9: negfosHnGOZXSHpWDRKyBQ folded before Flop (didn't bet)



PokerStars Game #59940027476:  Hold'em No Limit ($0.50/$1.00) - 2009/07/01 0:55:19 ET
Table 'U9zqzC8f3oTJ2ShXFgSSOA' 6-max Seat #6 is the button
Seat 1: iHo1oDbrEVJ8nEGdaPrICw ($110.40 in chips)
Seat 2: TSuRyAHnUPCFjP7Z0rEE0w ($100 in chips)
Seat 3: yfXek8iJ7O4CFyqXrtGcfg ($14.95 in chips)
Seat 4: 33q95we0Etwgrm6guQGncw ($82.75 in chips)
Seat 5: KfwW5us6tydK81NYTtK1gw ($297.45 in chips)
Seat 6: 4OO5v3AVduL0tePNx8wk5A ($109 in chips)
iHo1oDbrEVJ8nEGdaPrICw: posts small blind $0.50
TSuRyAHnUPCFjP7Z0rEE0w: posts big blind $1
*** HOLE CARDS ***
yfXek8iJ7O4CFyqXrtGcfg: folds
33q95we0Etwgrm6guQGncw: calls $1
KfwW5us6tydK81NYTtK1gw: folds
4OO5v3AVduL0tePNx8wk5A: raises $4 to $5
iHo1oDbrEVJ8nEGdaPrICw: calls $4.50
TSuRyAHnUPCFjP7Z0rEE0w: folds
33q95we0Etwgrm6guQGncw: calls $4
*** FLOP *** [Ts 6c 2c]
iHo1oDbrEVJ8nEGdaPrICw: checks
33q95we0Etwgrm6guQGncw: checks
4OO5v3AVduL0tePNx8wk5A: bets $11
iHo1oDbrEVJ8nEGdaPrICw: folds
33q95we0Etwgrm6guQGncw: folds
4OO5v3AVduL0tePNx8wk5A collected $15.20 from pot
4OO5v3AVduL0tePNx8wk5A: doesn't show hand
*** SUMMARY ***
Total pot $16 | Rake $0.80
Board [Ts 6c 2c]
Seat 1: iHo1oDbrEVJ8nEGdaPrICw (small blind) folded on the Flop
Seat 2: TSuRyAHnUPCFjP7Z0rEE0w (big blind) folded before Flop
Seat 3: yfXek8iJ7O4CFyqXrtGcfg folded before Flop (didn't bet)
Seat 4: 33q95we0Etwgrm6guQGncw folded on the Flop
Seat 5: KfwW5us6tydK81NYTtK1gw folded before Flop (didn't bet)
Seat 6: 4OO5v3AVduL0tePNx8wk5A (button) collected ($15.20)



PokerStars Game #59940028758:  Hold'em No Limit ($0.50/$1.00) - 2009/07/01 0:55:21 ET
Table 'SQLOQoANiHscJ8AL7zffbw' 9-max Seat #1 is the button
Seat 1: jPTRd6SpCp4xqAy2XQiTOw ($67.10 in chips)
Seat 2: /zy+DB4S5fUQUSfZWFzYGw ($323.55 in chips)
Seat 3: 0eFnow7+D7veCYQ+CG9FFw ($94.85 in chips)
Seat 4: /mfensKw8/iZ1Vrx33S4xg ($21.50 in chips)
Seat 5: L9njYvloJ1NdXjP8edHEAg ($105.60 in chips)
Seat 6: p5UKaxVobvptF0ANhR/q1A ($173 in chips)
Seat 7: bJckevFOcg//s0qyMQI6sQ ($100 in chips)
Seat 8: 2BV+oJIQYr65IO6nEChvbA ($60 in chips)
Seat 9: qJr25HAtvv1w/7IBvjMM3g ($200.90 in chips)
/zy+DB4S5fUQUSfZWFzYGw: posts small blind $0.50
0eFnow7+D7veCYQ+CG9FFw: posts big blind $1
*** HOLE CARDS ***
/mfensKw8/iZ1Vrx33S4xg: folds
L9njYvloJ1NdXjP8edHEAg: folds
p5UKaxVobvptF0ANhR/q1A: folds
bJckevFOcg//s0qyMQI6sQ: folds
2BV+oJIQYr65IO6nEChvbA: raises $1.50 to $2.50
qJr25HAtvv1w/7IBvjMM3g: folds
jPTRd6SpCp4xqAy2XQiTOw: folds
/zy+DB4S5fUQUSfZWFzYGw: calls $2
0eFnow7+D7veCYQ+CG9FFw: folds
*** FLOP *** [6h Ac 5s]
/zy+DB4S5fUQUSfZWFzYGw: checks
2BV+oJIQYr65IO6nEChvbA: bets $3
/zy+DB4S5fUQUSfZWFzYGw: calls $3
*** TURN *** [6h Ac 5s] [4c]
/zy+DB4S5fUQUSfZWFzYGw: checks
2BV+oJIQYr65IO6nEChvbA: checks
*** RIVER *** [6h Ac 5s 4c] [7d]
/zy+DB4S5fUQUSfZWFzYGw: bets $6
2BV+oJIQYr65IO6nEChvbA: folds
/zy+DB4S5fUQUSfZWFzYGw collected $11.45 from pot
*** SUMMARY ***
Total pot $12 | Rake $0.55
Board [6h Ac 5s 4c 7d]
Seat 1: jPTRd6SpCp4xqAy2XQiTOw (button) folded before Flop (didn't bet)
Seat 2: /zy+DB4S5fUQUSfZWFzYGw (small blind) collected ($11.45)
Seat 3: 0eFnow7+D7veCYQ+CG9FFw (big blind) folded before Flop
Seat 4: /mfensKw8/iZ1Vrx33S4xg folded before Flop (didn't bet)
Seat 5: L9njYvloJ1NdXjP8edHEAg folded before Flop (didn't bet)
Seat 6: p5UKaxVobvptF0ANhR/q1A folded before Flop (didn't bet)
Seat 7: bJckevFOcg//s0qyMQI6sQ folded before Flop (didn't bet)
Seat 8: 2BV+oJIQYr65IO6nEChvbA folded on the River
Seat 9: qJr25HAtvv1w/7IBvjMM3g folded before Flop (didn't bet)



PokerStars Game #59940030950:  Hold'em No Limit ($0.50/$1.00) - 2009/07/01 0:55:24 ET
Table 'GPp0HyAuggN8oE0sUWzPpA' 9-max Seat #7 is the button
Seat 1: qJr25HAtvv1w/7IBvjMM3g ($27.50 in chips)
Seat 2: m3U8I35Pn3gxKhoS2nmYIg ($61.20 in chips)
Seat 4: mBRWbnUl8diyBO1qTJaNzw ($108.70 in chips)
Seat 5: 0fXz44fzDo5QmhAaJCvFfA ($24.65 in chips)
Seat 6: BK/GtNPkSx0TdUDj82id5A ($10 in chips)
Seat 7: DHdbHyysD15wCAtx+BhUjA ($98.50 in chips)
Seat 9: VPF+HjszMvUIpy0CHIwH3A ($22.50 in chips)
VPF+HjszMvUIpy0CHIwH3A: posts small blind $0.50
CCCXsirC+bO7ginAuUUVlQ has returned
qJr25HAtvv1w/7IBvjMM3g: posts big blind $1
*** HOLE CARDS ***
John86sand joins the table at seat #8
m3U8I35Pn3gxKhoS2nmYIg: folds
mBRWbnUl8diyBO1qTJaNzw: raises $3 to $4
0fXz44fzDo5QmhAaJCvFfA: folds
BK/GtNPkSx0TdUDj82id5A: folds
DHdbHyysD15wCAtx+BhUjA: folds
VPF+HjszMvUIpy0CHIwH3A: raises $18.50 to $22.50 and is all-in
qJr25HAtvv1w/7IBvjMM3g: folds
mBRWbnUl8diyBO1qTJaNzw: folds
VPF+HjszMvUIpy0CHIwH3A collected $9 from pot
VPF+HjszMvUIpy0CHIwH3A: doesn't show hand
*** SUMMARY ***
Total pot $9 | Rake $0
Seat 1: qJr25HAtvv1w/7IBvjMM3g (big blind) folded before Flop
Seat 2: m3U8I35Pn3gxKhoS2nmYIg folded before Flop (didn't bet)
Seat 4: mBRWbnUl8diyBO1qTJaNzw folded before Flop
Seat 5: 0fXz44fzDo5QmhAaJCvFfA folded before Flop (didn't bet)
Seat 6: BK/GtNPkSx0TdUDj82id5A folded before Flop (didn't bet)
Seat 7: DHdbHyysD15wCAtx+BhUjA (button) folded before Flop (didn't bet)
Seat 9: VPF+HjszMvUIpy0CHIwH3A (small blind) collected ($9)



PokerStars Game #59940031142:  Hold'em No Limit ($0.50/$1.00) - 2009/07/01 0:55:24 ET
Table 'LmXQK9xy3awB+qsPzI21Mw' 2-max Seat #2 is the button
Seat 1: NYi6JFscYNrofSXy4sM+Yw ($332.25 in chips)
Seat 2: TME8GvochpQAo8cmJwWmvA ($59.05 in chips)
TME8GvochpQAo8cmJwWmvA: posts small blind $0.50
NYi6JFscYNrofSXy4sM+Yw: posts big blind $1
*** HOLE CARDS ***
TME8GvochpQAo8cmJwWmvA: calls $0.50
NYi6JFscYNrofSXy4sM+Yw: checks
*** FLOP *** [6d Ks Jh]
NYi6JFscYNrofSXy4sM+Yw: bets $2
TME8GvochpQAo8cmJwWmvA: calls $2
*** TURN *** [6d Ks Jh] [Qd]
NYi6JFscYNrofSXy4sM+Yw: checks
TME8GvochpQAo8cmJwWmvA: checks
*** RIVER *** [6d Ks Jh Qd] [2c]
NYi6JFscYNrofSXy4sM+Yw: checks
TME8GvochpQAo8cmJwWmvA: bets $3
NYi6JFscYNrofSXy4sM+Yw: folds
TME8GvochpQAo8cmJwWmvA collected $5.75 from pot
TME8GvochpQAo8cmJwWmvA: doesn't show hand
*** SUMMARY ***
Total pot $6 | Rake $0.25
Board [6d Ks Jh Qd 2c]
Seat 1: NYi6JFscYNrofSXy4sM+Yw (big blind) folded on the River
Seat 2: TME8GvochpQAo8cmJwWmvA (button) (small blind) collected ($5.75)



PokerStars Game #59940030850:  Hold'em No Limit ($0.50/$1.00) - 2009/07/01 0:55:24 ET
Table 'fTlPiCj0utgzC/5io+I7ew' 6-max Seat #2 is the button
Seat 1: YMJG+F++3Aj6P8dAWda5fw ($93.50 in chips)
Seat 2: Qy/UBNbD2HaA0Ogxg8Sf3w ($125.85 in chips)
Seat 4: uJVSceLggtsrJya+WtmUEA ($134.75 in chips)
Seat 5: bFrTkDcWGTxyvNul7GVdYg ($292.70 in chips)
Seat 6: /P4w1pHg2zHYg/4ubJ0dPw ($60 in chips)
wL5HjWHHOSGc53xWMNKB9Q will be allowed to play after the button
uJVSceLggtsrJya+WtmUEA: posts small blind $0.50
bFrTkDcWGTxyvNul7GVdYg: posts big blind $1
*** HOLE CARDS ***
/P4w1pHg2zHYg/4ubJ0dPw: folds
YMJG+F++3Aj6P8dAWda5fw: folds
Qy/UBNbD2HaA0Ogxg8Sf3w: folds
uJVSceLggtsrJya+WtmUEA: raises $2 to $3
bFrTkDcWGTxyvNul7GVdYg: calls $2
*** FLOP *** [4s Qd 5h]
uJVSceLggtsrJya+WtmUEA: bets $4
bFrTkDcWGTxyvNul7GVdYg: calls $4
*** TURN *** [4s Qd 5h] [3c]
uJVSceLggtsrJya+WtmUEA: checks
bFrTkDcWGTxyvNul7GVdYg: bets $10
uJVSceLggtsrJya+WtmUEA: calls $10
*** RIVER *** [4s Qd 5h 3c] [2h]
uJVSceLggtsrJya+WtmUEA: checks
bFrTkDcWGTxyvNul7GVdYg: bets $20.50
uJVSceLggtsrJya+WtmUEA: folds
bFrTkDcWGTxyvNul7GVdYg collected $32.35 from pot
*** SUMMARY ***
Total pot $34 | Rake $1.65
Board [4s Qd 5h 3c 2h]
Seat 1: YMJG+F++3Aj6P8dAWda5fw folded before Flop (didn't bet)
Seat 2: Qy/UBNbD2HaA0Ogxg8Sf3w (button) folded before Flop (didn't bet)
Seat 4: uJVSceLggtsrJya+WtmUEA (small blind) folded on the River
Seat 5: bFrTkDcWGTxyvNul7GVdYg (big blind) collected ($32.35)
Seat 6: /P4w1pHg2zHYg/4ubJ0dPw folded before Flop (didn't bet)



PokerStars Game #59940032780:  Hold'em No Limit ($0.50/$1.00) - 2009/07/01 0:55:27 ET
Table 'W/wyObTiXZm+Ckkl3YxcSw' 6-max Seat #1 is the button
Seat 1: eUBBn2R56C1IQ6Cs/vitwg ($109.25 in chips)
Seat 2: oDiBRCaF0QVtd3kO6xZIXw ($97.80 in chips)
Seat 5: BdbmJTZZ47quA9vUWwXtlw ($65.85 in chips)
Seat 6: tS9JHB1h+FQ++qu8RwRNgg ($39.80 in chips)
oDiBRCaF0QVtd3kO6xZIXw: posts small blind $0.50
+xW7QemQU0Fxs+4TnqBRow: is sitting out
BdbmJTZZ47quA9vUWwXtlw: posts big blind $1
*** HOLE CARDS ***
tS9JHB1h+FQ++qu8RwRNgg: folds
eUBBn2R56C1IQ6Cs/vitwg: raises $2 to $3
dxyNCn/qxfkGDUIf28Cbng joins the table at seat #3
oDiBRCaF0QVtd3kO6xZIXw: calls $2.50
+xW7QemQU0Fxs+4TnqBRow leaves the table
BdbmJTZZ47quA9vUWwXtlw: folds
*** FLOP *** [3h 8c 9c]
oDiBRCaF0QVtd3kO6xZIXw: checks
eUBBn2R56C1IQ6Cs/vitwg: bets $4
oDiBRCaF0QVtd3kO6xZIXw: folds
eUBBn2R56C1IQ6Cs/vitwg collected $6.65 from pot
*** SUMMARY ***
Total pot $7 | Rake $0.35
Board [3h 8c 9c]
Seat 1: eUBBn2R56C1IQ6Cs/vitwg (button) collected ($6.65)
Seat 2: oDiBRCaF0QVtd3kO6xZIXw (small blind) folded on the Flop
Seat 5: BdbmJTZZ47quA9vUWwXtlw (big blind) folded before Flop
Seat 6: tS9JHB1h+FQ++qu8RwRNgg folded before Flop (didn't bet)



PokerStars Game #59940032766:  Hold'em No Limit ($0.50/$1.00) - 2009/07/01 0:55:27 ET
Table 'tJq9SfN1ywY0r03VBlWlwQ' 9-max Seat #7 is the button
Seat 1: wZsU+w9r7G66x93UuvBf1Q ($340.80 in chips)
Seat 2: RqkO8O/Y3qlc3PIuCAHjVg ($74.40 in chips)
Seat 3: FVs16t7GgfWgQWt4JxsObQ ($33.95 in chips)
Seat 4: bLbSOSmSOnqE0iTcH/5dxA ($110.20 in chips)
Seat 5: Ogn4JDV3mp4ZDKO49IFzKA ($17.25 in chips)
Seat 6: gUUvmqdVlmvpal6B8nYrmg ($120.05 in chips)
Seat 7: qVhRZ0PLZ95XRJHWAjXjOQ ($130.90 in chips)
Seat 8: G4DEhsZFmznGNVpy2SEocA ($22.50 in chips)
Seat 9: XE5QF1y74bpHog9JxWJMWQ ($100 in chips)
G4DEhsZFmznGNVpy2SEocA: posts small blind $0.50
XE5QF1y74bpHog9JxWJMWQ: posts big blind $1
*** HOLE CARDS ***
wZsU+w9r7G66x93UuvBf1Q: raises $3 to $4
RqkO8O/Y3qlc3PIuCAHjVg: folds
FVs16t7GgfWgQWt4JxsObQ: folds
bLbSOSmSOnqE0iTcH/5dxA: folds
Ogn4JDV3mp4ZDKO49IFzKA: folds
gUUvmqdVlmvpal6B8nYrmg: folds
qVhRZ0PLZ95XRJHWAjXjOQ: folds
G4DEhsZFmznGNVpy2SEocA: folds
XE5QF1y74bpHog9JxWJMWQ: folds
wZsU+w9r7G66x93UuvBf1Q collected $2.50 from pot
*** SUMMARY ***
Total pot $2.50 | Rake $0
Seat 1: wZsU+w9r7G66x93UuvBf1Q collected ($2.50)
Seat 2: RqkO8O/Y3qlc3PIuCAHjVg folded before Flop (didn't bet)
Seat 3: FVs16t7GgfWgQWt4JxsObQ folded before Flop (didn't bet)
Seat 4: bLbSOSmSOnqE0iTcH/5dxA folded before Flop (didn't bet)
Seat 5: Ogn4JDV3mp4ZDKO49IFzKA folded before Flop (didn't bet)
Seat 6: gUUvmqdVlmvpal6B8nYrmg folded before Flop (didn't bet)
Seat 7: qVhRZ0PLZ95XRJHWAjXjOQ (button) folded before Flop (didn't bet)
Seat 8: G4DEhsZFmznGNVpy2SEocA (small blind) folded before Flop
Seat 9: XE5QF1y74bpHog9JxWJMWQ (big blind) folded before Flop



PokerStars Game #59940033706:  Hold'em No Limit ($0.50/$1.00) - 2009/07/01 0:55:28 ET
Table 'pHrhryH8jPNdQfY62f8v+g' 6-max Seat #3 is the button
Seat 2: RqgF7gRoKgRNW8Zoi1ty4A ($100.75 in chips)
Seat 3: 8oS5O7iD/qnFXFXJrGIgNQ ($155.20 in chips)
Seat 5: r1/R7y0Ortgoz4lccgW8VA ($49.90 in chips)
Seat 6: xAU6q2/cwmby2sxmA8VcmA ($114.80 in chips)
wenbG7TaM3H7h5kn78OFNw: is sitting out
r1/R7y0Ortgoz4lccgW8VA: posts small blind $0.50
xAU6q2/cwmby2sxmA8VcmA: posts big blind $1
*** HOLE CARDS ***
RqgF7gRoKgRNW8Zoi1ty4A: folds
8oS5O7iD/qnFXFXJrGIgNQ: raises $2.50 to $3.50
wenbG7TaM3H7h5kn78OFNw leaves the table
r1/R7y0Ortgoz4lccgW8VA: calls $3
xAU6q2/cwmby2sxmA8VcmA: folds
*** FLOP *** [6s 3c 4c]
r1/R7y0Ortgoz4lccgW8VA: checks
8oS5O7iD/qnFXFXJrGIgNQ: checks
*** TURN *** [6s 3c 4c] [Js]
r1/R7y0Ortgoz4lccgW8VA: checks
OvwYHV65yUbgdBjSmo1+5g joins the table at seat #1
8oS5O7iD/qnFXFXJrGIgNQ: bets $6
r1/R7y0Ortgoz4lccgW8VA: folds
8oS5O7iD/qnFXFXJrGIgNQ collected $7.60 from pot
*** SUMMARY ***
Total pot $8 | Rake $0.40
Board [6s 3c 4c Js]
Seat 2: RqgF7gRoKgRNW8Zoi1ty4A folded before Flop (didn't bet)
Seat 3: 8oS5O7iD/qnFXFXJrGIgNQ (button) collected ($7.60)
Seat 5: r1/R7y0Ortgoz4lccgW8VA (small blind) folded on the Turn
Seat 6: xAU6q2/cwmby2sxmA8VcmA (big blind) folded before Flop



PokerStars Game #59940033244:  Hold'em No Limit ($0.50/$1.00) - 2009/07/01 0:55:28 ET
Table 'vs/5jr6ciwjVQ5+Soc+u2A' 6-max Seat #2 is the button
Seat 1: /P4w1pHg2zHYg/4ubJ0dPw ($60 in chips)
Seat 2: XOIf9W+VAxhZqN+SYoyMKA ($117.35 in chips)
Seat 3: G5ZSSN6RSON3gkNvk/SmYg ($142.35 in chips)
Seat 4: wk6Ohn4GDozoOMHc4eb2rw ($54.80 in chips)
Seat 5: 2DwLxMUbmzvwY7o4/i47Xg ($31.50 in chips)
Seat 6: qAdBJlVNsNTwiHia50eMvg ($84.80 in chips)
G5ZSSN6RSON3gkNvk/SmYg: posts small blind $0.50
wk6Ohn4GDozoOMHc4eb2rw: posts big blind $1
*** HOLE CARDS ***
2DwLxMUbmzvwY7o4/i47Xg: calls $1
qAdBJlVNsNTwiHia50eMvg: calls $1
/P4w1pHg2zHYg/4ubJ0dPw: folds
XOIf9W+VAxhZqN+SYoyMKA: folds
G5ZSSN6RSON3gkNvk/SmYg: folds
wk6Ohn4GDozoOMHc4eb2rw: checks
*** FLOP *** [4c As Qs]
wk6Ohn4GDozoOMHc4eb2rw: checks
2DwLxMUbmzvwY7o4/i47Xg: checks
qAdBJlVNsNTwiHia50eMvg: folds
*** TURN *** [4c As Qs] [Qd]
qAdBJlVNsNTwiHia50eMvg leaves the table
wk6Ohn4GDozoOMHc4eb2rw: checks
2DwLxMUbmzvwY7o4/i47Xg: checks
*** RIVER *** [4c As Qs Qd] [Ad]
wk6Ohn4GDozoOMHc4eb2rw: bets $1
2DwLxMUbmzvwY7o4/i47Xg: folds
wk6Ohn4GDozoOMHc4eb2rw collected $3.35 from pot
wk6Ohn4GDozoOMHc4eb2rw: doesn't show hand
*** SUMMARY ***
Total pot $3.50 | Rake $0.15
Board [4c As Qs Qd Ad]
Seat 1: /P4w1pHg2zHYg/4ubJ0dPw folded before Flop (didn't bet)
Seat 2: XOIf9W+VAxhZqN+SYoyMKA (button) folded before Flop (didn't bet)
Seat 3: G5ZSSN6RSON3gkNvk/SmYg (small blind) folded before Flop
Seat 4: wk6Ohn4GDozoOMHc4eb2rw (big blind) collected ($3.35)
Seat 5: 2DwLxMUbmzvwY7o4/i47Xg folded on the River
Seat 6: qAdBJlVNsNTwiHia50eMvg folded on the Flop



PokerStars Game #59940034230:  Hold'em No Limit ($0.50/$1.00) - 2009/07/01 0:55:29 ET
Table 'mmbQQVBTrPdE+wy+s+9VPA' 6-max Seat #4 is the button
Seat 1: JwCcjZl0bjJzG7hmE0dnTA ($100 in chips)
Seat 2: +W6OnF033KNM2xH0fGj98Q ($140.60 in chips)
Seat 3: wx3sQGkVi2x9wJXuWNHPBw ($114.15 in chips)
Seat 4: V3iZdcw61nXF3g5hD2RrsQ ($100 in chips)
Seat 5: YMJG+F++3Aj6P8dAWda5fw ($100 in chips)
Seat 6: U2CWBTv29qdCbj8RNF2sIw ($98.50 in chips)
YMJG+F++3Aj6P8dAWda5fw: posts small blind $0.50
U2CWBTv29qdCbj8RNF2sIw: posts big blind $1
*** HOLE CARDS ***
JwCcjZl0bjJzG7hmE0dnTA: folds
+W6OnF033KNM2xH0fGj98Q: folds
JwCcjZl0bjJzG7hmE0dnTA leaves the table
wx3sQGkVi2x9wJXuWNHPBw: folds
V3iZdcw61nXF3g5hD2RrsQ: raises $2 to $3
YMJG+F++3Aj6P8dAWda5fw: folds
U2CWBTv29qdCbj8RNF2sIw: folds
V3iZdcw61nXF3g5hD2RrsQ collected $2.50 from pot
*** SUMMARY ***
Total pot $2.50 | Rake $0
Seat 1: JwCcjZl0bjJzG7hmE0dnTA folded before Flop (didn't bet)
Seat 2: +W6OnF033KNM2xH0fGj98Q folded before Flop (didn't bet)
Seat 3: wx3sQGkVi2x9wJXuWNHPBw folded before Flop (didn't bet)
Seat 4: V3iZdcw61nXF3g5hD2RrsQ (button) collected ($2.50)
Seat 5: YMJG+F++3Aj6P8dAWda5fw (small blind) folded before Flop
Seat 6: U2CWBTv29qdCbj8RNF2sIw (big blind) folded before Flop



PokerStars Game #59940034212:  Hold'em No Limit ($0.50/$1.00) - 2009/07/01 0:55:29 ET
Table 'uNlePsyMIqzM691Xkrlk6Q' 9-max Seat #3 is the button
Seat 1: bLbSOSmSOnqE0iTcH/5dxA ($100 in chips)
Seat 2: +OqpStnt0FqbCfyHAWaLbg ($86.10 in chips)
Seat 3: h7qXkU57Bb8ZuPwMyxR8Ug ($30.15 in chips)
Seat 4: TZcz9MEWDA+WydgGruqqbw ($101.65 in chips)
Seat 5: 3obndzTJ6fECz8+wWhMd1w ($18.50 in chips)
Seat 6: myIxN7otsyr846M539YR8Q ($18.50 in chips)
Seat 7: w6cw9nzN7AvkkHBVVjykoQ ($55.75 in chips)
Seat 8: laA8va+Yv8WuMqT1zdR91g ($101 in chips)
Seat 9: vR4IO10geOgvTW+LAUBv/A ($100 in chips)
TZcz9MEWDA+WydgGruqqbw: posts small blind $0.50
3obndzTJ6fECz8+wWhMd1w: posts big blind $1
*** HOLE CARDS ***
myIxN7otsyr846M539YR8Q: folds
w6cw9nzN7AvkkHBVVjykoQ: folds
laA8va+Yv8WuMqT1zdR91g: folds
vR4IO10geOgvTW+LAUBv/A: folds
bLbSOSmSOnqE0iTcH/5dxA: folds
+OqpStnt0FqbCfyHAWaLbg: raises $3 to $4
h7qXkU57Bb8ZuPwMyxR8Ug: calls $4
TZcz9MEWDA+WydgGruqqbw: folds
3obndzTJ6fECz8+wWhMd1w: folds
*** FLOP *** [Qd Qc 5d]
+OqpStnt0FqbCfyHAWaLbg: checks
h7qXkU57Bb8ZuPwMyxR8Ug: bets $4
+OqpStnt0FqbCfyHAWaLbg: raises $6 to $10
h7qXkU57Bb8ZuPwMyxR8Ug: calls $6
*** TURN *** [Qd Qc 5d] [Ad]
+OqpStnt0FqbCfyHAWaLbg: bets $15
h7qXkU57Bb8ZuPwMyxR8Ug: folds
+OqpStnt0FqbCfyHAWaLbg collected $28.05 from pot
*** SUMMARY ***
Total pot $29.50 | Rake $1.45
Board [Qd Qc 5d Ad]
Seat 1: bLbSOSmSOnqE0iTcH/5dxA folded before Flop (didn't bet)
Seat 2: +OqpStnt0FqbCfyHAWaLbg collected ($28.05)
Seat 3: h7qXkU57Bb8ZuPwMyxR8Ug (button) folded on the Turn
Seat 4: TZcz9MEWDA+WydgGruqqbw (small blind) folded before Flop
Seat 5: 3obndzTJ6fECz8+wWhMd1w (big blind) folded before Flop
Seat 6: myIxN7otsyr846M539YR8Q folded before Flop (didn't bet)
Seat 7: w6cw9nzN7AvkkHBVVjykoQ folded before Flop (didn't bet)
Seat 8: laA8va+Yv8WuMqT1zdR91g folded before Flop (didn't bet)
Seat 9: vR4IO10geOgvTW+LAUBv/A folded before Flop (didn't bet)



PokerStars Game #59940034962:  Hold'em No Limit ($0.50/$1.00) - 2009/07/01 0:55:30 ET
Table 'rmZfTK+oSebeUPJNbWhdAA' 6-max Seat #2 is the button
Seat 1: xAU6q2/cwmby2sxmA8VcmA ($101.50 in chips)
Seat 2: z7O9PO/WEcqRouIydFhS9Q ($83.45 in chips)
Seat 3: BCEV3COoKY607AzLWayfRA ($99 in chips)
Seat 4: 1/mIuXfgx1ZyVkodrmfQDw ($100 in chips)
Seat 5: 5lY8d6Cnm4HUkt/8FZSj4g ($155.60 in chips)
Seat 6: j7NIOHLZk7V2o9fOioO5ug ($119.80 in chips)
BCEV3COoKY607AzLWayfRA: posts small blind $0.50
1/mIuXfgx1ZyVkodrmfQDw: posts big blind $1
*** HOLE CARDS ***
5lY8d6Cnm4HUkt/8FZSj4g: calls $1
j7NIOHLZk7V2o9fOioO5ug: folds
xAU6q2/cwmby2sxmA8VcmA: raises $4 to $5
z7O9PO/WEcqRouIydFhS9Q: calls $5
BCEV3COoKY607AzLWayfRA: folds
1/mIuXfgx1ZyVkodrmfQDw: folds
5lY8d6Cnm4HUkt/8FZSj4g: calls $4
*** FLOP *** [7d Kh 6h]
5lY8d6Cnm4HUkt/8FZSj4g: checks
xAU6q2/cwmby2sxmA8VcmA: bets $12
z7O9PO/WEcqRouIydFhS9Q: folds
5lY8d6Cnm4HUkt/8FZSj4g: calls $12
*** TURN *** [7d Kh 6h] [Ts]
5lY8d6Cnm4HUkt/8FZSj4g: checks
xAU6q2/cwmby2sxmA8VcmA: checks
*** RIVER *** [7d Kh 6h Ts] [5s]
5lY8d6Cnm4HUkt/8FZSj4g: checks
xAU6q2/cwmby2sxmA8VcmA: bets $26
5lY8d6Cnm4HUkt/8FZSj4g: calls $26
*** SHOW DOWN ***
xAU6q2/cwmby2sxmA8VcmA: shows [5d 5h] (three of a kind, Fives)
5lY8d6Cnm4HUkt/8FZSj4g: mucks hand
xAU6q2/cwmby2sxmA8VcmA collected $89.50 from pot
*** SUMMARY ***
Total pot $92.50 | Rake $3
Board [7d Kh 6h Ts 5s]
Seat 1: xAU6q2/cwmby2sxmA8VcmA showed [5d 5h] and won ($89.50) with three of a kind, Fives
Seat 2: z7O9PO/WEcqRouIydFhS9Q (button) folded on the Flop
Seat 3: BCEV3COoKY607AzLWayfRA (small blind) folded before Flop
Seat 4: 1/mIuXfgx1ZyVkodrmfQDw (big blind) folded before Flop
Seat 5: 5lY8d6Cnm4HUkt/8FZSj4g mucked
Seat 6: j7NIOHLZk7V2o9fOioO5ug folded before Flop (didn't bet)



PokerStars Game #59940035774:  Hold'em No Limit ($0.50/$1.00) - 2009/07/01 0:55:32 ET
Table '/RZcOwpZpHQ+OwPwjsbnRw' 6-max Seat #4 is the button
Seat 1: Zboa6dColKGHBjLPUakZjw ($68.90 in chips)
Seat 2: +xW7QemQU0Fxs+4TnqBRow ($206.15 in chips)
Seat 3: XnT1yK2DD/5FL+0bwuEhqg ($46.45 in chips)
Seat 4: j7NIOHLZk7V2o9fOioO5ug ($100 in chips)
Seat 5: wx3sQGkVi2x9wJXuWNHPBw ($179.65 in chips)
Seat 6: XOIf9W+VAxhZqN+SYoyMKA ($291.75 in chips)
wx3sQGkVi2x9wJXuWNHPBw: posts small blind $0.50
XOIf9W+VAxhZqN+SYoyMKA: posts big blind $1
*** HOLE CARDS ***
Zboa6dColKGHBjLPUakZjw: raises $2 to $3
+xW7QemQU0Fxs+4TnqBRow: calls $3
XnT1yK2DD/5FL+0bwuEhqg: folds
j7NIOHLZk7V2o9fOioO5ug: folds
wx3sQGkVi2x9wJXuWNHPBw: folds
XOIf9W+VAxhZqN+SYoyMKA: folds
*** FLOP *** [Qs Kh Th]
Zboa6dColKGHBjLPUakZjw: bets $2
+xW7QemQU0Fxs+4TnqBRow: raises $8 to $10
Zboa6dColKGHBjLPUakZjw: calls $8
*** TURN *** [Qs Kh Th] [Qh]
Zboa6dColKGHBjLPUakZjw: bets $3
+xW7QemQU0Fxs+4TnqBRow: raises $18 to $21
Zboa6dColKGHBjLPUakZjw: calls $18
*** RIVER *** [Qs Kh Th Qh] [Tc]
Zboa6dColKGHBjLPUakZjw: checks
+xW7QemQU0Fxs+4TnqBRow: checks
*** SHOW DOWN ***
Zboa6dColKGHBjLPUakZjw: shows [Ah 8d] (two pair, Queens and Tens)
+xW7QemQU0Fxs+4TnqBRow: shows [Jd Ac] (a straight, Ten to Ace)
+xW7QemQU0Fxs+4TnqBRow collected $66.50 from pot
*** SUMMARY ***
Total pot $69.50 | Rake $3
Board [Qs Kh Th Qh Tc]
Seat 1: Zboa6dColKGHBjLPUakZjw showed [Ah 8d] and lost with two pair, Queens and Tens
Seat 2: +xW7QemQU0Fxs+4TnqBRow showed [Jd Ac] and won ($66.50) with a straight, Ten to Ace
Seat 3: XnT1yK2DD/5FL+0bwuEhqg folded before Flop (didn't bet)
Seat 4: j7NIOHLZk7V2o9fOioO5ug (button) folded before Flop (didn't bet)
Seat 5: wx3sQGkVi2x9wJXuWNHPBw (small blind) folded before Flop
Seat 6: XOIf9W+VAxhZqN+SYoyMKA (big blind) folded before Flop



PokerStars Game #59940036718:  Hold'em No Limit ($0.50/$1.00) - 2009/07/01 0:55:33 ET
Table '+cA8mcmhaedZ7YcrDdhmeQ' 6-max Seat #6 is the button
Seat 1: lsLuWlcPA3Rh7kJVLzMh0Q ($286.50 in chips)
Seat 2: RqgF7gRoKgRNW8Zoi1ty4A ($105.95 in chips)
Seat 3: 7H5WkGzGvsv56y1iaqHvRg ($54.85 in chips)
Seat 4: JwCcjZl0bjJzG7hmE0dnTA ($101.50 in chips)
Seat 5: +7hFKAL0b0O/n8G72TclJA ($54.05 in chips)
Seat 6: YfsTQsY/fxb+YqbdclTHuw ($27.45 in chips)
lsLuWlcPA3Rh7kJVLzMh0Q: posts small blind $0.50
RqgF7gRoKgRNW8Zoi1ty4A: posts big blind $1
*** HOLE CARDS ***
7H5WkGzGvsv56y1iaqHvRg: folds
JwCcjZl0bjJzG7hmE0dnTA: folds
+7hFKAL0b0O/n8G72TclJA: folds
YfsTQsY/fxb+YqbdclTHuw: folds
lsLuWlcPA3Rh7kJVLzMh0Q: folds
RqgF7gRoKgRNW8Zoi1ty4A collected $1 from pot
*** SUMMARY ***
Total pot $1 | Rake $0
Seat 1: lsLuWlcPA3Rh7kJVLzMh0Q (small blind) folded before Flop
Seat 2: RqgF7gRoKgRNW8Zoi1ty4A (big blind) collected ($1)
Seat 3: 7H5WkGzGvsv56y1iaqHvRg folded before Flop (didn't bet)
Seat 4: JwCcjZl0bjJzG7hmE0dnTA folded before Flop (didn't bet)
Seat 5: +7hFKAL0b0O/n8G72TclJA folded before Flop (didn't bet)
Seat 6: YfsTQsY/fxb+YqbdclTHuw (button) folded before Flop (didn't bet)



PokerStars Game #59940036360:  Hold'em No Limit ($0.50/$1.00) - 2009/07/01 0:55:33 ET
Table 'Zka9tv1yilg0MvXWPQrShg' 9-max Seat #6 is the button
Seat 1: TZcz9MEWDA+WydgGruqqbw ($121.90 in chips)
Seat 2: kz9ziSiGUc+857heiKSayw ($17 in chips)
Seat 3: gUUvmqdVlmvpal6B8nYrmg ($106.80 in chips)
Seat 4: stxmTgSicxShtrDxhOOX2g ($69.15 in chips)
Seat 5: /zy+DB4S5fUQUSfZWFzYGw ($123.40 in chips)
Seat 6: rY8wPoax1lS+HUY+I0FZDw ($142.95 in chips)
Seat 7: p1SafS90nb3Uft5LB0NkHw ($21.50 in chips)
Seat 9: 6daxhj43mWj04MOPTOmaYA ($92.65 in chips)
p1SafS90nb3Uft5LB0NkHw: posts small blind $0.50
bL+QVeDcuEdzMGAGg2XJHg: is sitting out
bL+QVeDcuEdzMGAGg2XJHg leaves the table
6daxhj43mWj04MOPTOmaYA: posts big blind $1
*** HOLE CARDS ***
TZcz9MEWDA+WydgGruqqbw: folds
kz9ziSiGUc+857heiKSayw: folds
gUUvmqdVlmvpal6B8nYrmg: folds
D+W9Me7w6Hcx/WRUSKV0dw joins the table at seat #8
stxmTgSicxShtrDxhOOX2g: calls $1
/zy+DB4S5fUQUSfZWFzYGw: folds
rY8wPoax1lS+HUY+I0FZDw: folds
p1SafS90nb3Uft5LB0NkHw: calls $0.50
6daxhj43mWj04MOPTOmaYA: checks
*** FLOP *** [Js 5h Th]
p1SafS90nb3Uft5LB0NkHw: checks
6daxhj43mWj04MOPTOmaYA: checks
stxmTgSicxShtrDxhOOX2g: checks
*** TURN *** [Js 5h Th] [2d]
p1SafS90nb3Uft5LB0NkHw: checks
6daxhj43mWj04MOPTOmaYA: bets $3
stxmTgSicxShtrDxhOOX2g: folds
p1SafS90nb3Uft5LB0NkHw: folds
6daxhj43mWj04MOPTOmaYA collected $2.85 from pot
*** SUMMARY ***
Total pot $3 | Rake $0.15
Board [Js 5h Th 2d]
Seat 1: TZcz9MEWDA+WydgGruqqbw folded before Flop (didn't bet)
Seat 2: kz9ziSiGUc+857heiKSayw folded before Flop (didn't bet)
Seat 3: gUUvmqdVlmvpal6B8nYrmg folded before Flop (didn't bet)
Seat 4: stxmTgSicxShtrDxhOOX2g folded on the Turn
Seat 5: /zy+DB4S5fUQUSfZWFzYGw folded before Flop (didn't bet)
Seat 6: rY8wPoax1lS+HUY+I0FZDw (button) folded before Flop (didn't bet)
Seat 7: p1SafS90nb3Uft5LB0NkHw (small blind) folded on the Turn
Seat 9: 6daxhj43mWj04MOPTOmaYA (big blind) collected ($2.85)



PokerStars Game #59940036900:  Hold'em No Limit ($0.50/$1.00) - 2009/07/01 0:55:34 ET
Table 'tLrtq7gDzxEvckNAI1OS5Q' 6-max Seat #2 is the button
Seat 1: xNKcQzD9+/iHmtJn4vYq9w ($95.55 in chips)
Seat 2: QHvTZcrKe6+maWUfVjP29Q ($100 in chips)
Seat 3: TPZ+m9x+lwoKpv7TMfAUWA ($204.20 in chips)
Seat 4: +uSzP8Jwnw7sKfQ4s66b7w ($51.30 in chips)
Seat 5: OGMLOcTNYZXZU81au7ztUw ($167.15 in chips)
Seat 6: XUk5GQsfNFpHvaToDZ0rZA ($168.20 in chips)
TPZ+m9x+lwoKpv7TMfAUWA: posts small blind $0.50
+uSzP8Jwnw7sKfQ4s66b7w: posts big blind $1
*** HOLE CARDS ***
OGMLOcTNYZXZU81au7ztUw: folds
XUk5GQsfNFpHvaToDZ0rZA: folds
xNKcQzD9+/iHmtJn4vYq9w: folds
QHvTZcrKe6+maWUfVjP29Q: raises $2 to $3
TPZ+m9x+lwoKpv7TMfAUWA: folds
+uSzP8Jwnw7sKfQ4s66b7w: folds
QHvTZcrKe6+maWUfVjP29Q collected $2.50 from pot
QHvTZcrKe6+maWUfVjP29Q: doesn't show hand
*** SUMMARY ***
Total pot $2.50 | Rake $0
Seat 1: xNKcQzD9+/iHmtJn4vYq9w folded before Flop (didn't bet)
Seat 2: QHvTZcrKe6+maWUfVjP29Q (button) collected ($2.50)
Seat 3: TPZ+m9x+lwoKpv7TMfAUWA (small blind) folded before Flop
Seat 4: +uSzP8Jwnw7sKfQ4s66b7w (big blind) folded before Flop
Seat 5: OGMLOcTNYZXZU81au7ztUw folded before Flop (didn't bet)
Seat 6: XUk5GQsfNFpHvaToDZ0rZA folded before Flop (didn't bet)



PokerStars Game #59940037632:  Hold'em No Limit ($0.50/$1.00) - 2009/07/01 0:55:35 ET
Table 'cBDNutyLBKEk9+ptwsKmTw' 6-max Seat #6 is the button
Seat 1: xAU6q2/cwmby2sxmA8VcmA ($120.35 in chips)
Seat 2: 5lY8d6Cnm4HUkt/8FZSj4g ($81.65 in chips)
Seat 3: G5ZSSN6RSON3gkNvk/SmYg ($103.15 in chips)
Seat 4: 3q7F5QtzC30pSrn0nl9i+A ($35.50 in chips)
Seat 5: OGMLOcTNYZXZU81au7ztUw ($158.65 in chips)
Seat 6: NqVlOSH2lp+pp/TK3vvK5g ($34.50 in chips)
xAU6q2/cwmby2sxmA8VcmA: posts small blind $0.50
5lY8d6Cnm4HUkt/8FZSj4g: posts big blind $1
*** HOLE CARDS ***
G5ZSSN6RSON3gkNvk/SmYg: folds
3q7F5QtzC30pSrn0nl9i+A: calls $1
OGMLOcTNYZXZU81au7ztUw: folds
NqVlOSH2lp+pp/TK3vvK5g: calls $1
xAU6q2/cwmby2sxmA8VcmA: folds
5lY8d6Cnm4HUkt/8FZSj4g: checks
*** FLOP *** [6c 4h 2h]
5lY8d6Cnm4HUkt/8FZSj4g: checks
3q7F5QtzC30pSrn0nl9i+A: bets $2
NqVlOSH2lp+pp/TK3vvK5g: calls $2
5lY8d6Cnm4HUkt/8FZSj4g: calls $2
*** TURN *** [6c 4h 2h] [5s]
5lY8d6Cnm4HUkt/8FZSj4g: checks
3q7F5QtzC30pSrn0nl9i+A: checks
NqVlOSH2lp+pp/TK3vvK5g: checks
*** RIVER *** [6c 4h 2h 5s] [9s]
5lY8d6Cnm4HUkt/8FZSj4g: checks
3q7F5QtzC30pSrn0nl9i+A: bets $3
NqVlOSH2lp+pp/TK3vvK5g: raises $3 to $6
5lY8d6Cnm4HUkt/8FZSj4g: folds
3q7F5QtzC30pSrn0nl9i+A: folds
NqVlOSH2lp+pp/TK3vvK5g collected $14.75 from pot
*** SUMMARY ***
Total pot $15.50 | Rake $0.75
Board [6c 4h 2h 5s 9s]
Seat 1: xAU6q2/cwmby2sxmA8VcmA (small blind) folded before Flop
Seat 2: 5lY8d6Cnm4HUkt/8FZSj4g (big blind) folded on the River
Seat 3: G5ZSSN6RSON3gkNvk/SmYg folded before Flop (didn't bet)
Seat 4: 3q7F5QtzC30pSrn0nl9i+A folded on the River
Seat 5: OGMLOcTNYZXZU81au7ztUw folded before Flop (didn't bet)
Seat 6: NqVlOSH2lp+pp/TK3vvK5g (button) collected ($14.75)



PokerStars Game #59940038746:  Hold'em No Limit ($0.50/$1.00) - 2009/07/01 0:55:36 ET
Table 'iSx0wTgVb4o7MyZeOe06ZA' 9-max Seat #1 is the button
Seat 1: RSlQ91LM/HQyM+SR8KWgqw ($52.20 in chips)
Seat 2: myIxN7otsyr846M539YR8Q ($19 in chips)
Seat 3: XQV7mCMbzd2Wh/l74wmbug ($86.65 in chips)
Seat 4: Ogn4JDV3mp4ZDKO49IFzKA ($46.55 in chips)
Seat 5: o1axyw4AjQ8n4ubTwlirQQ ($23.50 in chips)
Seat 6: T5/PXFS/W+LLcIXBo1G/RA ($100.15 in chips)
Seat 7: w4NnqVr/Sfoj65ux/fEUyQ ($71.50 in chips)
Seat 8: gUUvmqdVlmvpal6B8nYrmg ($100 in chips)
Seat 9: DMQXVuViR4IFzRccosBkJw ($79.05 in chips)
myIxN7otsyr846M539YR8Q: posts small blind $0.50
XQV7mCMbzd2Wh/l74wmbug: posts big blind $1
*** HOLE CARDS ***
Ogn4JDV3mp4ZDKO49IFzKA: folds
o1axyw4AjQ8n4ubTwlirQQ: folds
T5/PXFS/W+LLcIXBo1G/RA: calls $1
w4NnqVr/Sfoj65ux/fEUyQ: raises $3 to $4
gUUvmqdVlmvpal6B8nYrmg: folds
DMQXVuViR4IFzRccosBkJw: folds
RSlQ91LM/HQyM+SR8KWgqw: folds
RSlQ91LM/HQyM+SR8KWgqw leaves the table
myIxN7otsyr846M539YR8Q: folds
XQV7mCMbzd2Wh/l74wmbug: calls $3
T5/PXFS/W+LLcIXBo1G/RA: calls $3
*** FLOP *** [5h 7h 9c]
VPF+HjszMvUIpy0CHIwH3A joins the table at seat #1
XQV7mCMbzd2Wh/l74wmbug: checks
T5/PXFS/W+LLcIXBo1G/RA: checks
w4NnqVr/Sfoj65ux/fEUyQ: bets $9
XQV7mCMbzd2Wh/l74wmbug: folds
T5/PXFS/W+LLcIXBo1G/RA: folds
w4NnqVr/Sfoj65ux/fEUyQ collected $11.90 from pot
*** SUMMARY ***
Total pot $12.50 | Rake $0.60
Board [5h 7h 9c]
Seat 1: RSlQ91LM/HQyM+SR8KWgqw (button) folded before Flop (didn't bet)
Seat 2: myIxN7otsyr846M539YR8Q (small blind) folded before Flop
Seat 3: XQV7mCMbzd2Wh/l74wmbug (big blind) folded on the Flop
Seat 4: Ogn4JDV3mp4ZDKO49IFzKA folded before Flop (didn't bet)
Seat 5: o1axyw4AjQ8n4ubTwlirQQ folded before Flop (didn't bet)
Seat 6: T5/PXFS/W+LLcIXBo1G/RA folded on the Flop
Seat 7: w4NnqVr/Sfoj65ux/fEUyQ collected ($11.90)
Seat 8: gUUvmqdVlmvpal6B8nYrmg folded before Flop (didn't bet)
Seat 9: DMQXVuViR4IFzRccosBkJw folded before Flop (didn't bet)



PokerStars Game #59940039124:  Hold'em No Limit ($0.50/$1.00) - 2009/07/01 0:55:37 ET
Table 'JOIm/fogLA7vSG0Vc6ME1A' 2-max Seat #2 is the button
Seat 1: NYi6JFscYNrofSXy4sM+Yw ($139.70 in chips)
Seat 2: F5lNTyZLIX9W2wQZ0plwgg ($112.60 in chips)
F5lNTyZLIX9W2wQZ0plwgg: posts small blind $0.50
NYi6JFscYNrofSXy4sM+Yw: posts big blind $1
*** HOLE CARDS ***
F5lNTyZLIX9W2wQZ0plwgg: raises $3 to $4
NYi6JFscYNrofSXy4sM+Yw: calls $3
*** FLOP *** [Js Jd 5h]
NYi6JFscYNrofSXy4sM+Yw: checks
F5lNTyZLIX9W2wQZ0plwgg: bets $5
NYi6JFscYNrofSXy4sM+Yw: raises $10 to $15
F5lNTyZLIX9W2wQZ0plwgg: calls $10
*** TURN *** [Js Jd 5h] [3c]
NYi6JFscYNrofSXy4sM+Yw: bets $21
F5lNTyZLIX9W2wQZ0plwgg: calls $21
*** RIVER *** [Js Jd 5h 3c] [Qs]
NYi6JFscYNrofSXy4sM+Yw: bets $71
F5lNTyZLIX9W2wQZ0plwgg: folds
NYi6JFscYNrofSXy4sM+Yw collected $79.50 from pot
*** SUMMARY ***
Total pot $80 | Rake $0.50
Board [Js Jd 5h 3c Qs]
Seat 1: NYi6JFscYNrofSXy4sM+Yw (big blind) collected ($79.50)
Seat 2: F5lNTyZLIX9W2wQZ0plwgg (button) (small blind) folded on the River



PokerStars Game #59940039848:  Hold'em No Limit ($0.50/$1.00) - 2009/07/01 0:55:38 ET
Table 'MUPc8FEpe/nR0BKSeReX6Q' 6-max Seat #3 is the button
Seat 1: YsLQ3BAvgQHWXMAv3Wv6Hg ($112.35 in chips)
Seat 2: xAU6q2/cwmby2sxmA8VcmA ($101 in chips)
Seat 3: wx3sQGkVi2x9wJXuWNHPBw ($231.85 in chips)
Seat 4: ZA1bp6g8IwtTxkUE4eCjDQ ($184.80 in chips)
Seat 5: UBZQqpnJZdTYYY1FTb0rLA ($105.05 in chips)
Seat 6: oxnw0GLLpFanjhGkxfRSqA ($57.70 in chips)
ZA1bp6g8IwtTxkUE4eCjDQ: posts small blind $0.50
ZA1bp6g8IwtTxkUE4eCjDQ said, "nh"
UBZQqpnJZdTYYY1FTb0rLA: posts big blind $1
*** HOLE CARDS ***
oxnw0GLLpFanjhGkxfRSqA: folds
YsLQ3BAvgQHWXMAv3Wv6Hg: raises $3 to $4
xAU6q2/cwmby2sxmA8VcmA: folds
wx3sQGkVi2x9wJXuWNHPBw: folds
ZA1bp6g8IwtTxkUE4eCjDQ: calls $3.50
UBZQqpnJZdTYYY1FTb0rLA: folds
*** FLOP *** [4c 6s 6d]
ZA1bp6g8IwtTxkUE4eCjDQ: checks
YsLQ3BAvgQHWXMAv3Wv6Hg: checks
*** TURN *** [4c 6s 6d] [3c]
ZA1bp6g8IwtTxkUE4eCjDQ: bets $8
YsLQ3BAvgQHWXMAv3Wv6Hg: folds
ZA1bp6g8IwtTxkUE4eCjDQ collected $8.55 from pot
YsLQ3BAvgQHWXMAv3Wv6Hg leaves the table
ZA1bp6g8IwtTxkUE4eCjDQ: doesn't show hand
*** SUMMARY ***
Total pot $9 | Rake $0.45
Board [4c 6s 6d 3c]
Seat 1: YsLQ3BAvgQHWXMAv3Wv6Hg folded on the Turn
Seat 2: xAU6q2/cwmby2sxmA8VcmA folded before Flop (didn't bet)
Seat 3: wx3sQGkVi2x9wJXuWNHPBw (button) folded before Flop (didn't bet)
Seat 4: ZA1bp6g8IwtTxkUE4eCjDQ (small blind) collected ($8.55)
Seat 5: UBZQqpnJZdTYYY1FTb0rLA (big blind) folded before Flop
Seat 6: oxnw0GLLpFanjhGkxfRSqA folded before Flop (didn't bet)



PokerStars Game #59940039624:  Hold'em No Limit ($0.50/$1.00) - 2009/07/01 0:55:38 ET
Table '7O9fB8yx1u7sJveJn8w6jA' 6-max Seat #1 is the button
Seat 1: jy52+7FotjH63o5tEEVgKw ($135.85 in chips)
Seat 2: wx3sQGkVi2x9wJXuWNHPBw ($191.50 in chips)
Seat 3: hpxXcmRkXXI9HE5+5/j/0Q ($100 in chips)
Seat 4: XIZSmlGttGgSRaIU42K4Fg ($122.25 in chips)
Seat 5: BCEV3COoKY607AzLWayfRA ($100 in chips)
Seat 6: UBZQqpnJZdTYYY1FTb0rLA ($128.95 in chips)
wx3sQGkVi2x9wJXuWNHPBw: posts small blind $0.50
hpxXcmRkXXI9HE5+5/j/0Q: posts big blind $1
*** HOLE CARDS ***
XIZSmlGttGgSRaIU42K4Fg: folds
BCEV3COoKY607AzLWayfRA: folds
UBZQqpnJZdTYYY1FTb0rLA: raises $2 to $3
jy52+7FotjH63o5tEEVgKw: folds
wx3sQGkVi2x9wJXuWNHPBw: folds
hpxXcmRkXXI9HE5+5/j/0Q: folds
UBZQqpnJZdTYYY1FTb0rLA collected $2.50 from pot
UBZQqpnJZdTYYY1FTb0rLA: doesn't show hand
*** SUMMARY ***
Total pot $2.50 | Rake $0
Seat 1: jy52+7FotjH63o5tEEVgKw (button) folded before Flop (didn't bet)
Seat 2: wx3sQGkVi2x9wJXuWNHPBw (small blind) folded before Flop
Seat 3: hpxXcmRkXXI9HE5+5/j/0Q (big blind) folded before Flop
Seat 4: XIZSmlGttGgSRaIU42K4Fg folded before Flop (didn't bet)
Seat 5: BCEV3COoKY607AzLWayfRA folded before Flop (didn't bet)
Seat 6: UBZQqpnJZdTYYY1FTb0rLA collected ($2.50)



PokerStars Game #59940044132:  Hold'em No Limit ($0.50/$1.00) - 2009/07/01 0:55:45 ET
Table 'LmXQK9xy3awB+qsPzI21Mw' 2-max Seat #1 is the button
Seat 1: NYi6JFscYNrofSXy4sM+Yw ($329.25 in chips)
Seat 2: TME8GvochpQAo8cmJwWmvA ($61.80 in chips)
NYi6JFscYNrofSXy4sM+Yw: posts small blind $0.50
TME8GvochpQAo8cmJwWmvA: posts big blind $1
*** HOLE CARDS ***
NYi6JFscYNrofSXy4sM+Yw: raises $2 to $3
TME8GvochpQAo8cmJwWmvA: raises $7 to $10
NYi6JFscYNrofSXy4sM+Yw: folds
TME8GvochpQAo8cmJwWmvA collected $6 from pot
TME8GvochpQAo8cmJwWmvA: doesn't show hand
*** SUMMARY ***
Total pot $6 | Rake $0
Seat 1: NYi6JFscYNrofSXy4sM+Yw (button) (small blind) folded before Flop
Seat 2: TME8GvochpQAo8cmJwWmvA (big blind) collected ($6)



PokerStars Game #59940044078:  Hold'em No Limit ($0.50/$1.00) - 2009/07/01 0:55:45 ET
Table '6YvsYDPNIDx2v5z3bJnwZQ' 9-max Seat #9 is the button
Seat 1: Ogn4JDV3mp4ZDKO49IFzKA ($18.70 in chips)
Seat 2: x80+i7DJL+81v3quj7KbNg ($20 in chips)
Seat 3: negfosHnGOZXSHpWDRKyBQ ($20 in chips)
Seat 4: kEr5NYB+JIG5+szcYMr6hA ($41.25 in chips)
Seat 5: mBRWbnUl8diyBO1qTJaNzw ($165.20 in chips)
Seat 6: 7RSwrjMohkYrZAhOd1uaZg ($15 in chips)
Seat 7: mae7OMTaJ/MFimNbZegCkg ($55.30 in chips)
Seat 8: PSFxpXgPedVZyHSu2Zhb7Q ($109.30 in chips)
Seat 9: ZgMRSHJ9EOtPeVHmdeV9kQ ($50 in chips)
Ogn4JDV3mp4ZDKO49IFzKA: posts small blind $0.50
x80+i7DJL+81v3quj7KbNg: posts big blind $1
*** HOLE CARDS ***
negfosHnGOZXSHpWDRKyBQ: raises $2 to $3
kEr5NYB+JIG5+szcYMr6hA: calls $3
mBRWbnUl8diyBO1qTJaNzw: folds
7RSwrjMohkYrZAhOd1uaZg: calls $3
mae7OMTaJ/MFimNbZegCkg: calls $3
PSFxpXgPedVZyHSu2Zhb7Q: folds
ZgMRSHJ9EOtPeVHmdeV9kQ: folds
Ogn4JDV3mp4ZDKO49IFzKA: folds
x80+i7DJL+81v3quj7KbNg: calls $2
*** FLOP *** [Qh Kh 9d]
x80+i7DJL+81v3quj7KbNg: checks
negfosHnGOZXSHpWDRKyBQ: checks
kEr5NYB+JIG5+szcYMr6hA: checks
7RSwrjMohkYrZAhOd1uaZg: checks
mae7OMTaJ/MFimNbZegCkg: checks
*** TURN *** [Qh Kh 9d] [3d]
x80+i7DJL+81v3quj7KbNg: bets $17 and is all-in
negfosHnGOZXSHpWDRKyBQ: folds
kEr5NYB+JIG5+szcYMr6hA: folds
7RSwrjMohkYrZAhOd1uaZg: folds
mae7OMTaJ/MFimNbZegCkg: folds
x80+i7DJL+81v3quj7KbNg collected $14.75 from pot
*** SUMMARY ***
Total pot $15.50 | Rake $0.75
Board [Qh Kh 9d 3d]
Seat 1: Ogn4JDV3mp4ZDKO49IFzKA (small blind) folded before Flop
Seat 2: x80+i7DJL+81v3quj7KbNg (big blind) collected ($14.75)
Seat 3: negfosHnGOZXSHpWDRKyBQ folded on the Turn
Seat 4: kEr5NYB+JIG5+szcYMr6hA folded on the Turn
Seat 5: mBRWbnUl8diyBO1qTJaNzw folded before Flop (didn't bet)
Seat 6: 7RSwrjMohkYrZAhOd1uaZg folded on the Turn
Seat 7: mae7OMTaJ/MFimNbZegCkg folded on the Turn
Seat 8: PSFxpXgPedVZyHSu2Zhb7Q folded before Flop (didn't bet)
Seat 9: ZgMRSHJ9EOtPeVHmdeV9kQ (button) folded before Flop (didn't bet)



PokerStars Game #59940044468:  Hold'em No Limit ($0.50/$1.00) - 2009/07/01 0:55:46 ET
Table 'tyUh+jyNvrceIQdKMJjQ2wZFWj23PMihdwrNWv41OG/Qeat #5 is the button
Seat 1: o8A5MUdudVKu+pAwgZOX2w ($179.80 in chips)
Seat 2: XvUbOIg94d25feWeQlOTVg ($153.20 in chips)
Seat 3: TalCiLYHCd+ffkmR3auPvA ($85.90 in chips)
Seat 4: TSuRyAHnUPCFjP7Z0rEE0w ($111.25 in chips)
Seat 5: j7NIOHLZk7V2o9fOioO5ug ($118.30 in chips)
Seat 6: YsLQ3BAvgQHWXMAv3Wv6Hg ($146.15 in chips)
YsLQ3BAvgQHWXMAv3Wv6Hg: posts small blind $0.50
o8A5MUdudVKu+pAwgZOX2w: posts big blind $1
*** HOLE CARDS ***
XvUbOIg94d25feWeQlOTVg: calls $1
TalCiLYHCd+ffkmR3auPvA: folds
TSuRyAHnUPCFjP7Z0rEE0w: folds
j7NIOHLZk7V2o9fOioO5ug: folds
YsLQ3BAvgQHWXMAv3Wv6Hg: folds
o8A5MUdudVKu+pAwgZOX2w: checks
*** FLOP *** [2s 9d Qd]
YsLQ3BAvgQHWXMAv3Wv6Hg leaves the table
o8A5MUdudVKu+pAwgZOX2w: checks
XvUbOIg94d25feWeQlOTVg: checks
*** TURN *** [2s 9d Qd] [6d]
o8A5MUdudVKu+pAwgZOX2w: checks
XvUbOIg94d25feWeQlOTVg: checks
*** RIVER *** [2s 9d Qd 6d] [8d]
o8A5MUdudVKu+pAwgZOX2w: bets $6
XvUbOIg94d25feWeQlOTVg: folds
o8A5MUdudVKu+pAwgZOX2w collected $2.40 from pot
o8A5MUdudVKu+pAwgZOX2w: doesn't show hand
4OO5v3AVduL0tePNx8wk5A joins the table at seat #6
*** SUMMARY ***
Total pot $2.50 | Rake $0.10
Board [2s 9d Qd 6d 8d]
Seat 1: o8A5MUdudVKu+pAwgZOX2w (big blind) collected ($2.40)
Seat 2: XvUbOIg94d25feWeQlOTVg folded on the River
Seat 3: TalCiLYHCd+ffkmR3auPvA folded before Flop (didn't bet)
Seat 4: TSuRyAHnUPCFjP7Z0rEE0w folded before Flop (didn't bet)
Seat 5: j7NIOHLZk7V2o9fOioO5ug (button) folded before Flop (didn't bet)
Seat 6: YsLQ3BAvgQHWXMAv3Wv6Hg (small blind) folded before Flop



PokerStars Game #59940046020:  Hold'em No Limit ($0.50/$1.00) - 2009/07/01 0:55:48 ET
Table 'hugOjcwJvzEwZbK7tyiWuQ' 9-max Seat #6 is the button
Seat 2: r27C1nIV4NS4+qbnrgBQSw ($262.50 in chips)
Seat 3: jDwhY1kCdc6EkAHbT7PJMQ ($102.15 in chips)
Seat 4: UWB3oeddt/GObx2Mix2Anw ($204.25 in chips)
Seat 5: 5BRGWf+R3nt2WS3b5xX+zA ($24.20 in chips)
Seat 6: gUUvmqdVlmvpal6B8nYrmg ($105.90 in chips)
Seat 7: FL3MrLspcF23LYvC4ipBOA ($112.30 in chips)
Seat 8: /zy+DB4S5fUQUSfZWFzYGw ($100 in chips)
Seat 9: W8P9bUKCs43TO1xHm0dL6w ($89.45 in chips)
FL3MrLspcF23LYvC4ipBOA: posts small blind $0.50
/zy+DB4S5fUQUSfZWFzYGw: posts big blind $1
D+W9Me7w6Hcx/WRUSKV0dw: sits out
*** HOLE CARDS ***
W8P9bUKCs43TO1xHm0dL6w: folds
r27C1nIV4NS4+qbnrgBQSw: folds
jDwhY1kCdc6EkAHbT7PJMQ: folds
UWB3oeddt/GObx2Mix2Anw: folds
5BRGWf+R3nt2WS3b5xX+zA: folds
gUUvmqdVlmvpal6B8nYrmg: raises $1 to $2
W8P9bUKCs43TO1xHm0dL6w is sitting out
FL3MrLspcF23LYvC4ipBOA: folds
/zy+DB4S5fUQUSfZWFzYGw: folds
gUUvmqdVlmvpal6B8nYrmg collected $2.50 from pot
*** SUMMARY ***
Total pot $2.50 | Rake $0
Seat 2: r27C1nIV4NS4+qbnrgBQSw folded before Flop (didn't bet)
Seat 3: jDwhY1kCdc6EkAHbT7PJMQ folded before Flop (didn't bet)
Seat 4: UWB3oeddt/GObx2Mix2Anw folded before Flop (didn't bet)
Seat 5: 5BRGWf+R3nt2WS3b5xX+zA folded before Flop (didn't bet)
Seat 6: gUUvmqdVlmvpal6B8nYrmg (button) collected ($2.50)
Seat 7: FL3MrLspcF23LYvC4ipBOA (small blind) folded before Flop
Seat 8: /zy+DB4S5fUQUSfZWFzYGw (big blind) folded before Flop
Seat 9: W8P9bUKCs43TO1xHm0dL6w folded before Flop (didn't bet)



PokerStars Game #59940047104:  Hold'em No Limit ($0.50/$1.00) - 2009/07/01 0:55:50 ET
Table '7Nl0ffnjeK44/vmeexh3MQ' 9-max Seat #2 is the button
Seat 1: s7D3Y+k4Cj4D1cXHv7oj+Q ($94.20 in chips)
Seat 2: OGgaARGdJQT4awWVNQ957w ($100 in chips)
Seat 3: vR4IO10geOgvTW+LAUBv/A ($100 in chips)
Seat 4: bLbSOSmSOnqE0iTcH/5dxA ($113 in chips)
Seat 5: bL+QVeDcuEdzMGAGg2XJHg ($106.75 in chips)
Seat 6: FVs16t7GgfWgQWt4JxsObQ ($26.20 in chips)
Seat 7: 997ViqAtWn1FPjJqcffwcA ($100 in chips)
Seat 9: ouwUBGRKnKK9uhn1G4Lf+A ($197 in chips)
vR4IO10geOgvTW+LAUBv/A: posts small blind $0.50
bLbSOSmSOnqE0iTcH/5dxA: posts big blind $1
D+W9Me7w6Hcx/WRUSKV0dw: sits out
*** HOLE CARDS ***
bL+QVeDcuEdzMGAGg2XJHg: folds
FVs16t7GgfWgQWt4JxsObQ: calls $1
997ViqAtWn1FPjJqcffwcA: folds
ouwUBGRKnKK9uhn1G4Lf+A: folds
s7D3Y+k4Cj4D1cXHv7oj+Q: folds
OGgaARGdJQT4awWVNQ957w: folds
vR4IO10geOgvTW+LAUBv/A: folds
bLbSOSmSOnqE0iTcH/5dxA: raises $4 to $5
FVs16t7GgfWgQWt4JxsObQ: folds
bLbSOSmSOnqE0iTcH/5dxA collected $2.50 from pot
bLbSOSmSOnqE0iTcH/5dxA: doesn't show hand
*** SUMMARY ***
Total pot $2.50 | Rake $0
Seat 1: s7D3Y+k4Cj4D1cXHv7oj+Q folded before Flop (didn't bet)
Seat 2: OGgaARGdJQT4awWVNQ957w (button) folded before Flop (didn't bet)
Seat 3: vR4IO10geOgvTW+LAUBv/A (small blind) folded before Flop
Seat 4: bLbSOSmSOnqE0iTcH/5dxA (big blind) collected ($2.50)
Seat 5: bL+QVeDcuEdzMGAGg2XJHg folded before Flop (didn't bet)
Seat 6: FVs16t7GgfWgQWt4JxsObQ folded before Flop
Seat 7: 997ViqAtWn1FPjJqcffwcA folded before Flop (didn't bet)
Seat 9: ouwUBGRKnKK9uhn1G4Lf+A folded before Flop (didn't bet)



PokerStars Game #59940048452:  Hold'em No Limit ($0.50/$1.00) - 2009/07/01 0:55:52 ET
Table 'VOs36P6NW+QyXeQ1B62kmA' 6-max Seat #1 is the button
Seat 1: AdLVjddOzm+sRNo1Bc3S6Q ($130.80 in chips)
Seat 2: 2UMlbaZ8n8AbRli0Yr0mDw ($19 in chips)
Seat 3: TSuRyAHnUPCFjP7Z0rEE0w ($107.90 in chips)
Seat 4: w02zQzNydODiyV9THKgo9w ($41.50 in chips)
Seat 5: ozrlafxxh1HmYdA0/h+MuA ($44.75 in chips)
2UMlbaZ8n8AbRli0Yr0mDw: posts small blind $0.50
TSuRyAHnUPCFjP7Z0rEE0w: posts big blind $1
*** HOLE CARDS ***
w02zQzNydODiyV9THKgo9w: folds
slVKuQyEz8Qj4E3uLPYNXg joins the table at seat #6
ozrlafxxh1HmYdA0/h+MuA: folds
AdLVjddOzm+sRNo1Bc3S6Q: folds
2UMlbaZ8n8AbRli0Yr0mDw: calls $0.50
TSuRyAHnUPCFjP7Z0rEE0w: checks
*** FLOP *** [9s 8s 9h]
2UMlbaZ8n8AbRli0Yr0mDw: checks
TSuRyAHnUPCFjP7Z0rEE0w: checks
*** TURN *** [9s 8s 9h] [4c]
2UMlbaZ8n8AbRli0Yr0mDw: checks
TSuRyAHnUPCFjP7Z0rEE0w: checks
*** RIVER *** [9s 8s 9h 4c] [4s]
2UMlbaZ8n8AbRli0Yr0mDw: bets $2
TSuRyAHnUPCFjP7Z0rEE0w: folds
2UMlbaZ8n8AbRli0Yr0mDw collected $1.90 from pot
2UMlbaZ8n8AbRli0Yr0mDw: doesn't show hand
*** SUMMARY ***
Total pot $2 | Rake $0.10
Board [9s 8s 9h 4c 4s]
Seat 1: AdLVjddOzm+sRNo1Bc3S6Q (button) folded before Flop (didn't bet)
Seat 2: 2UMlbaZ8n8AbRli0Yr0mDw (small blind) collected ($1.90)
Seat 3: TSuRyAHnUPCFjP7Z0rEE0w (big blind) folded on the River
Seat 4: w02zQzNydODiyV9THKgo9w folded before Flop (didn't bet)
Seat 5: ozrlafxxh1HmYdA0/h+MuA folded before Flop (didn't bet)



PokerStars Game #59940051412:  Hold'em No Limit ($0.50/$1.00) - 2009/07/01 0:55:57 ET
Table '+cA8mcmhaedZ7YcrDdhmeQ' 6-max Seat #1 is the button
Seat 1: lsLuWlcPA3Rh7kJVLzMh0Q ($286 in chips)
Seat 2: RqgF7gRoKgRNW8Zoi1ty4A ($106.45 in chips)
Seat 3: 7H5WkGzGvsv56y1iaqHvRg ($54.85 in chips)
Seat 4: JwCcjZl0bjJzG7hmE0dnTA ($101.50 in chips)
Seat 5: +7hFKAL0b0O/n8G72TclJA ($54.05 in chips)
Seat 6: YfsTQsY/fxb+YqbdclTHuw ($27.45 in chips)
RqgF7gRoKgRNW8Zoi1ty4A: posts small blind $0.50
7H5WkGzGvsv56y1iaqHvRg: posts big blind $1
*** HOLE CARDS ***
JwCcjZl0bjJzG7hmE0dnTA: folds
+7hFKAL0b0O/n8G72TclJA: raises $2 to $3
YfsTQsY/fxb+YqbdclTHuw: folds
lsLuWlcPA3Rh7kJVLzMh0Q: folds
JwCcjZl0bjJzG7hmE0dnTA leaves the table
4OO5v3AVduL0tePNx8wk5A joins the table at seat #4
RqgF7gRoKgRNW8Zoi1ty4A: folds
7H5WkGzGvsv56y1iaqHvRg: calls $2
*** FLOP *** [4h 5s 3c]
7H5WkGzGvsv56y1iaqHvRg: checks
+7hFKAL0b0O/n8G72TclJA: checks
*** TURN *** [4h 5s 3c] [Qc]
7H5WkGzGvsv56y1iaqHvRg: bets $2
+7hFKAL0b0O/n8G72TclJA: raises $4 to $6
7H5WkGzGvsv56y1iaqHvRg: calls $4
*** RIVER *** [4h 5s 3c Qc] [Qh]
7H5WkGzGvsv56y1iaqHvRg: checks
+7hFKAL0b0O/n8G72TclJA: checks
*** SHOW DOWN ***
7H5WkGzGvsv56y1iaqHvRg: shows [Tc Kc] (a pair of Queens)
+7hFKAL0b0O/n8G72TclJA: shows [Jd Jc] (two pair, Queens and Jacks)
+7hFKAL0b0O/n8G72TclJA collected $17.60 from pot
*** SUMMARY ***
Total pot $18.50 | Rake $0.90
Board [4h 5s 3c Qc Qh]
Seat 1: lsLuWlcPA3Rh7kJVLzMh0Q (button) folded before Flop (didn't bet)
Seat 2: RqgF7gRoKgRNW8Zoi1ty4A (small blind) folded before Flop
Seat 3: 7H5WkGzGvsv56y1iaqHvRg (big blind) showed [Tc Kc] and lost with a pair of Queens
Seat 4: JwCcjZl0bjJzG7hmE0dnTA folded before Flop (didn't bet)
Seat 5: +7hFKAL0b0O/n8G72TclJA showed [Jd Jc] and won ($17.60) with two pair, Queens and Jacks
Seat 6: YfsTQsY/fxb+YqbdclTHuw folded before Flop (didn't bet)



PokerStars Game #59940052022:  Hold'em No Limit ($0.50/$1.00) - 2009/07/01 0:55:58 ET
Table 'mmbQQVBTrPdE+wy+s+9VPA' 6-max Seat #5 is the button
Seat 2: +W6OnF033KNM2xH0fGj98Q ($140.60 in chips)
Seat 3: wx3sQGkVi2x9wJXuWNHPBw ($114.15 in chips)
Seat 4: V3iZdcw61nXF3g5hD2RrsQ ($101.50 in chips)
Seat 5: YMJG+F++3Aj6P8dAWda5fw ($99.50 in chips)
Seat 6: U2CWBTv29qdCbj8RNF2sIw ($97.50 in chips)
U2CWBTv29qdCbj8RNF2sIw: posts small blind $0.50
+W6OnF033KNM2xH0fGj98Q: posts big blind $1
*** HOLE CARDS ***
wx3sQGkVi2x9wJXuWNHPBw: folds
V3iZdcw61nXF3g5hD2RrsQ: raises $2 to $3
YMJG+F++3Aj6P8dAWda5fw: folds
U2CWBTv29qdCbj8RNF2sIw: folds
+W6OnF033KNM2xH0fGj98Q: calls $2
*** FLOP *** [9s 6d 3c]
+W6OnF033KNM2xH0fGj98Q: checks
V3iZdcw61nXF3g5hD2RrsQ: bets $4
+W6OnF033KNM2xH0fGj98Q: raises $10 to $14
V3iZdcw61nXF3g5hD2RrsQ: folds
+W6OnF033KNM2xH0fGj98Q collected $13.80 from pot
*** SUMMARY ***
Total pot $14.50 | Rake $0.70
Board [9s 6d 3c]
Seat 2: +W6OnF033KNM2xH0fGj98Q (big blind) collected ($13.80)
Seat 3: wx3sQGkVi2x9wJXuWNHPBw folded before Flop (didn't bet)
Seat 4: V3iZdcw61nXF3g5hD2RrsQ folded on the Flop
Seat 5: YMJG+F++3Aj6P8dAWda5fw (button) folded before Flop (didn't bet)
Seat 6: U2CWBTv29qdCbj8RNF2sIw (small blind) folded before Flop



PokerStars Game #59940052090:  Hold'em No Limit ($0.50/$1.00) - 2009/07/01 0:55:58 ET
Table '8jIjWCPY0NGprquL+xcMFg' 9-max Seat #4 is the button
Seat 1: vR4IO10geOgvTW+LAUBv/A ($136.05 in chips)
Seat 2: laA8va+Yv8WuMqT1zdR91g ($106.05 in chips)
Seat 3: tjhwe1V98x2spSoUQER3HQ ($103 in chips)
Seat 4: Jjc7EHWzs4//xUAjJ0UWoA ($18.50 in chips)
Seat 5: 2YpnxJiexJHyERfbqgwEcw ($86.05 in chips)
Seat 6: GTQkFJtSkbVbnGCktp6e3g ($102.85 in chips)
Seat 7: O3CGPwwUmamrCNHccOilrg ($45.45 in chips)
Seat 9: negfosHnGOZXSHpWDRKyBQ ($23 in chips)
2YpnxJiexJHyERfbqgwEcw: posts small blind $0.50
GTQkFJtSkbVbnGCktp6e3g: posts big blind $1
D+W9Me7w6Hcx/WRUSKV0dw: sits out
*** HOLE CARDS ***
O3CGPwwUmamrCNHccOilrg: folds
negfosHnGOZXSHpWDRKyBQ: folds
vR4IO10geOgvTW+LAUBv/A: folds
laA8va+Yv8WuMqT1zdR91g: folds
tjhwe1V98x2spSoUQER3HQ: raises $3 to $4
Jjc7EHWzs4//xUAjJ0UWoA: folds
2YpnxJiexJHyERfbqgwEcw: folds
GTQkFJtSkbVbnGCktp6e3g: folds
tjhwe1V98x2spSoUQER3HQ collected $2.50 from pot
tjhwe1V98x2spSoUQER3HQ: doesn't show hand
*** SUMMARY ***
Total pot $2.50 | Rake $0
Seat 1: vR4IO10geOgvTW+LAUBv/A folded before Flop (didn't bet)
Seat 2: laA8va+Yv8WuMqT1zdR91g folded before Flop (didn't bet)
Seat 3: tjhwe1V98x2spSoUQER3HQ collected ($2.50)
Seat 4: Jjc7EHWzs4//xUAjJ0UWoA (button) folded before Flop (didn't bet)
Seat 5: 2YpnxJiexJHyERfbqgwEcw (small blind) folded before Flop
Seat 6: GTQkFJtSkbVbnGCktp6e3g (big blind) folded before Flop
Seat 7: O3CGPwwUmamrCNHccOilrg folded before Flop (didn't bet)
Seat 9: negfosHnGOZXSHpWDRKyBQ folded before Flop (didn't bet)



PokerStars Game #59940052900:  Hold'em No Limit ($0.50/$1.00) - 2009/07/01 0:55:59 ET
Table 'LmXQK9xy3awB+qsPzI21Mw' 2-max Seat #2 is the button
Seat 1: NYi6JFscYNrofSXy4sM+Yw ($326.25 in chips)
Seat 2: TME8GvochpQAo8cmJwWmvA ($64.80 in chips)
TME8GvochpQAo8cmJwWmvA: posts small blind $0.50
NYi6JFscYNrofSXy4sM+Yw: posts big blind $1
*** HOLE CARDS ***
TME8GvochpQAo8cmJwWmvA: calls $0.50
NYi6JFscYNrofSXy4sM+Yw: checks
*** FLOP *** [4h Ah 2h]
NYi6JFscYNrofSXy4sM+Yw: bets $2
TME8GvochpQAo8cmJwWmvA: calls $2
*** TURN *** [4h Ah 2h] [Qd]
NYi6JFscYNrofSXy4sM+Yw: checks
TME8GvochpQAo8cmJwWmvA: bets $2
NYi6JFscYNrofSXy4sM+Yw: folds
TME8GvochpQAo8cmJwWmvA collected $5.75 from pot
TME8GvochpQAo8cmJwWmvA: doesn't show hand
*** SUMMARY ***
Total pot $6 | Rake $0.25
Board [4h Ah 2h Qd]
Seat 1: NYi6JFscYNrofSXy4sM+Yw (big blind) folded on the Turn
Seat 2: TME8GvochpQAo8cmJwWmvA (button) (small blind) collected ($5.75)



PokerStars Game #59940052768:  Hold'em No Limit ($0.50/$1.00) - 2009/07/01 0:55:59 ET
Table 'JOIm/fogLA7vSG0Vc6ME1A' 2-max Seat #1 is the button
Seat 1: NYi6JFscYNrofSXy4sM+Yw ($179.20 in chips)
Seat 2: F5lNTyZLIX9W2wQZ0plwgg ($72.60 in chips)
NYi6JFscYNrofSXy4sM+Yw: posts small blind $0.50
F5lNTyZLIX9W2wQZ0plwgg: posts big blind $1
*** HOLE CARDS ***
NYi6JFscYNrofSXy4sM+Yw: raises $1 to $2
F5lNTyZLIX9W2wQZ0plwgg: raises $3 to $5
NYi6JFscYNrofSXy4sM+Yw: calls $3
*** FLOP *** [Jc 8s 3d]
F5lNTyZLIX9W2wQZ0plwgg: bets $4
NYi6JFscYNrofSXy4sM+Yw: calls $4
*** TURN *** [Jc 8s 3d] [Ac]
F5lNTyZLIX9W2wQZ0plwgg: bets $63.60 and is all-in
NYi6JFscYNrofSXy4sM+Yw: folds
F5lNTyZLIX9W2wQZ0plwgg collected $17.50 from pot
F5lNTyZLIX9W2wQZ0plwgg: doesn't show hand
*** SUMMARY ***
Total pot $18 | Rake $0.50
Board [Jc 8s 3d Ac]
Seat 1: NYi6JFscYNrofSXy4sM+Yw (button) (small blind) folded on the Turn
Seat 2: F5lNTyZLIX9W2wQZ0plwgg (big blind) collected ($17.50)



PokerStars Game #59940054556:  Hold'em No Limit ($0.50/$1.00) - 2009/07/01 0:56:02 ET
Table 'tJq9SfN1ywY0r03VBlWlwQ' 9-max Seat #8 is the button
Seat 1: wZsU+w9r7G66x93UuvBf1Q ($342.30 in chips)
Seat 2: RqkO8O/Y3qlc3PIuCAHjVg ($74.40 in chips)
Seat 3: FVs16t7GgfWgQWt4JxsObQ ($33.95 in chips)
Seat 4: bLbSOSmSOnqE0iTcH/5dxA ($110.20 in chips)
Seat 5: Ogn4JDV3mp4ZDKO49IFzKA ($17.25 in chips)
Seat 6: gUUvmqdVlmvpal6B8nYrmg ($120.05 in chips)
Seat 7: qVhRZ0PLZ95XRJHWAjXjOQ ($130.90 in chips)
Seat 8: G4DEhsZFmznGNVpy2SEocA ($22 in chips)
Seat 9: XE5QF1y74bpHog9JxWJMWQ ($100 in chips)
XE5QF1y74bpHog9JxWJMWQ: posts small blind $0.50
wZsU+w9r7G66x93UuvBf1Q: posts big blind $1
*** HOLE CARDS ***
RqkO8O/Y3qlc3PIuCAHjVg: folds
FVs16t7GgfWgQWt4JxsObQ: folds
bLbSOSmSOnqE0iTcH/5dxA: folds
Ogn4JDV3mp4ZDKO49IFzKA: folds
gUUvmqdVlmvpal6B8nYrmg: folds
qVhRZ0PLZ95XRJHWAjXjOQ: calls $1
G4DEhsZFmznGNVpy2SEocA: folds
XE5QF1y74bpHog9JxWJMWQ: raises $4 to $5
wZsU+w9r7G66x93UuvBf1Q: folds
qVhRZ0PLZ95XRJHWAjXjOQ: folds
XE5QF1y74bpHog9JxWJMWQ collected $3 from pot
*** SUMMARY ***
Total pot $3 | Rake $0
Seat 1: wZsU+w9r7G66x93UuvBf1Q (big blind) folded before Flop
Seat 2: RqkO8O/Y3qlc3PIuCAHjVg folded before Flop (didn't bet)
Seat 3: FVs16t7GgfWgQWt4JxsObQ folded before Flop (didn't bet)
Seat 4: bLbSOSmSOnqE0iTcH/5dxA folded before Flop (didn't bet)
Seat 5: Ogn4JDV3mp4ZDKO49IFzKA folded before Flop (didn't bet)
Seat 6: gUUvmqdVlmvpal6B8nYrmg folded before Flop (didn't bet)
Seat 7: qVhRZ0PLZ95XRJHWAjXjOQ folded before Flop
Seat 8: G4DEhsZFmznGNVpy2SEocA (button) folded before Flop (didn't bet)
Seat 9: XE5QF1y74bpHog9JxWJMWQ (small blind) collected ($3)



PokerStars Game #59940055676:  Hold'em No Limit ($0.50/$1.00) - 2009/07/01 0:56:04 ET
Table 'W/wyObTiXZm+Ckkl3YxcSw' 6-max Seat #2 is the button
Seat 1: eUBBn2R56C1IQ6Cs/vitwg ($112.90 in chips)
Seat 2: oDiBRCaF0QVtd3kO6xZIXw ($94.80 in chips)
Seat 5: BdbmJTZZ47quA9vUWwXtlw ($64.85 in chips)
Seat 6: tS9JHB1h+FQ++qu8RwRNgg ($39.80 in chips)
dxyNCn/qxfkGDUIf28Cbng will be allowed to play after the button
BdbmJTZZ47quA9vUWwXtlw: posts small blind $0.50
tS9JHB1h+FQ++qu8RwRNgg: posts big blind $1
*** HOLE CARDS ***
eUBBn2R56C1IQ6Cs/vitwg: raises $2 to $3
oDiBRCaF0QVtd3kO6xZIXw: calls $3
BdbmJTZZ47quA9vUWwXtlw: folds
tS9JHB1h+FQ++qu8RwRNgg: folds
*** FLOP *** [4d 4h Jd]
eUBBn2R56C1IQ6Cs/vitwg: bets $5
oDiBRCaF0QVtd3kO6xZIXw: raises $10 to $15
eUBBn2R56C1IQ6Cs/vitwg: folds
oDiBRCaF0QVtd3kO6xZIXw collected $16.65 from pot
oDiBRCaF0QVtd3kO6xZIXw: doesn't show hand
*** SUMMARY ***
Total pot $17.50 | Rake $0.85
Board [4d 4h Jd]
Seat 1: eUBBn2R56C1IQ6Cs/vitwg folded on the Flop
Seat 2: oDiBRCaF0QVtd3kO6xZIXw (button) collected ($16.65)
Seat 5: BdbmJTZZ47quA9vUWwXtlw (small blind) folded before Flop
Seat 6: tS9JHB1h+FQ++qu8RwRNgg (big blind) folded before Flop



PokerStars Game #59940055894:  Hold'em No Limit ($0.50/$1.00) - 2009/07/01 0:56:04 ET
Table 'tLrtq7gDzxEvckNAI1OS5Q' 6-max Seat #3 is the button
Seat 1: xNKcQzD9+/iHmtJn4vYq9w ($95.55 in chips)
Seat 2: QHvTZcrKe6+maWUfVjP29Q ($101.50 in chips)
Seat 3: TPZ+m9x+lwoKpv7TMfAUWA ($203.70 in chips)
Seat 4: +uSzP8Jwnw7sKfQ4s66b7w ($50.30 in chips)
Seat 5: OGMLOcTNYZXZU81au7ztUw ($167.15 in chips)
Seat 6: XUk5GQsfNFpHvaToDZ0rZA ($168.20 in chips)
+uSzP8Jwnw7sKfQ4s66b7w: posts small blind $0.50
OGMLOcTNYZXZU81au7ztUw: posts big blind $1
*** HOLE CARDS ***
XUk5GQsfNFpHvaToDZ0rZA: folds
xNKcQzD9+/iHmtJn4vYq9w: folds
QHvTZcrKe6+maWUfVjP29Q: folds
TPZ+m9x+lwoKpv7TMfAUWA: raises $2 to $3
+uSzP8Jwnw7sKfQ4s66b7w: folds
OGMLOcTNYZXZU81au7ztUw: folds
TPZ+m9x+lwoKpv7TMfAUWA collected $2.50 from pot
*** SUMMARY ***
Total pot $2.50 | Rake $0
Seat 1: xNKcQzD9+/iHmtJn4vYq9w folded before Flop (didn't bet)
Seat 2: QHvTZcrKe6+maWUfVjP29Q folded before Flop (didn't bet)
Seat 3: TPZ+m9x+lwoKpv7TMfAUWA (button) collected ($2.50)
Seat 4: +uSzP8Jwnw7sKfQ4s66b7w (small blind) folded before Flop
Seat 5: OGMLOcTNYZXZU81au7ztUw (big blind) folded before Flop
Seat 6: XUk5GQsfNFpHvaToDZ0rZA folded before Flop (didn't bet)



PokerStars Game #59940055824:  Hold'em No Limit ($0.50/$1.00) - 2009/07/01 0:56:04 ET
Table 'GPp0HyAuggN8oE0sUWzPpA' 9-max Seat #9 is the button
Seat 1: qJr25HAtvv1w/7IBvjMM3g ($26.50 in chips)
Seat 2: m3U8I35Pn3gxKhoS2nmYIg ($61.20 in chips)
Seat 3: CCCXsirC+bO7ginAuUUVlQ ($62.80 in chips)
Seat 4: mBRWbnUl8diyBO1qTJaNzw ($104.70 in chips)
Seat 5: 0fXz44fzDo5QmhAaJCvFfA ($24.65 in chips)
Seat 6: BK/GtNPkSx0TdUDj82id5A ($10 in chips)
Seat 7: DHdbHyysD15wCAtx+BhUjA ($98.50 in chips)
Seat 9: VPF+HjszMvUIpy0CHIwH3A ($27.50 in chips)
qJr25HAtvv1w/7IBvjMM3g: posts small blind $0.50
m3U8I35Pn3gxKhoS2nmYIg: posts big blind $1
John86sand has timed out
John86sand: is sitting out
*** HOLE CARDS ***
CCCXsirC+bO7ginAuUUVlQ has timed out
CCCXsirC+bO7ginAuUUVlQ: folds
CCCXsirC+bO7ginAuUUVlQ is sitting out
mBRWbnUl8diyBO1qTJaNzw: raises $3 to $4
0fXz44fzDo5QmhAaJCvFfA: folds
BK/GtNPkSx0TdUDj82id5A: folds
DHdbHyysD15wCAtx+BhUjA: folds
VPF+HjszMvUIpy0CHIwH3A: folds
John86sand has returned
qJr25HAtvv1w/7IBvjMM3g: folds
m3U8I35Pn3gxKhoS2nmYIg: calls $3
*** FLOP *** [Ad Th 4s]
m3U8I35Pn3gxKhoS2nmYIg: checks
mBRWbnUl8diyBO1qTJaNzw: bets $6
m3U8I35Pn3gxKhoS2nmYIg: folds
mBRWbnUl8diyBO1qTJaNzw collected $8.10 from pot
*** SUMMARY ***
Total pot $8.50 | Rake $0.40
Board [Ad Th 4s]
Seat 1: qJr25HAtvv1w/7IBvjMM3g (small blind) folded before Flop
Seat 2: m3U8I35Pn3gxKhoS2nmYIg (big blind) folded on the Flop
Seat 3: CCCXsirC+bO7ginAuUUVlQ folded before Flop (didn't bet)
Seat 4: mBRWbnUl8diyBO1qTJaNzw collected ($8.10)
Seat 5: 0fXz44fzDo5QmhAaJCvFfA folded before Flop (didn't bet)
Seat 6: BK/GtNPkSx0TdUDj82id5A folded before Flop (didn't bet)
Seat 7: DHdbHyysD15wCAtx+BhUjA folded before Flop (didn't bet)
Seat 9: VPF+HjszMvUIpy0CHIwH3A (button) folded before Flop (didn't bet)



PokerStars Game #59940056520:  Hold'em No Limit ($0.50/$1.00) - 2009/07/01 0:56:05 ET
Table 'pHrhryH8jPNdQfY62f8v+g' 6-max Seat #5 is the button
Seat 1: OvwYHV65yUbgdBjSmo1+5g ($60 in chips)
Seat 2: RqgF7gRoKgRNW8Zoi1ty4A ($100.75 in chips)
Seat 3: 8oS5O7iD/qnFXFXJrGIgNQ ($159.30 in chips)
Seat 5: r1/R7y0Ortgoz4lccgW8VA ($46.40 in chips)
Seat 6: xAU6q2/cwmby2sxmA8VcmA ($113.80 in chips)
xAU6q2/cwmby2sxmA8VcmA: posts small blind $0.50
OvwYHV65yUbgdBjSmo1+5g: posts big blind $1
*** HOLE CARDS ***
RqgF7gRoKgRNW8Zoi1ty4A: folds
8oS5O7iD/qnFXFXJrGIgNQ: folds
r1/R7y0Ortgoz4lccgW8VA: raises $2 to $3
xAU6q2/cwmby2sxmA8VcmA: folds
OvwYHV65yUbgdBjSmo1+5g: folds
r1/R7y0Ortgoz4lccgW8VA collected $2.50 from pot
*** SUMMARY ***
Total pot $2.50 | Rake $0
Seat 1: OvwYHV65yUbgdBjSmo1+5g (big blind) folded before Flop
Seat 2: RqgF7gRoKgRNW8Zoi1ty4A folded before Flop (didn't bet)
Seat 3: 8oS5O7iD/qnFXFXJrGIgNQ folded before Flop (didn't bet)
Seat 5: r1/R7y0Ortgoz4lccgW8VA (button) collected ($2.50)
Seat 6: xAU6q2/cwmby2sxmA8VcmA (small blind) folded before Flop



PokerStars Game #59940057134:  Hold'em No Limit ($0.50/$1.00) - 2009/07/01 0:56:06 ET
Table 'U9zqzC8f3oTJ2ShXFgSSOA' 6-max Seat #1 is the button
Seat 1: iHo1oDbrEVJ8nEGdaPrICw ($105.40 in chips)
Seat 2: TSuRyAHnUPCFjP7Z0rEE0w ($100 in chips)
Seat 3: yfXek8iJ7O4CFyqXrtGcfg ($14.95 in chips)
Seat 4: 33q95we0Etwgrm6guQGncw ($77.75 in chips)
Seat 5: KfwW5us6tydK81NYTtK1gw ($297.45 in chips)
Seat 6: 4OO5v3AVduL0tePNx8wk5A ($119.20 in chips)
TSuRyAHnUPCFjP7Z0rEE0w: posts small blind $0.50
yfXek8iJ7O4CFyqXrtGcfg: posts big blind $1
*** HOLE CARDS ***
33q95we0Etwgrm6guQGncw: folds
KfwW5us6tydK81NYTtK1gw: folds
4OO5v3AVduL0tePNx8wk5A: folds
iHo1oDbrEVJ8nEGdaPrICw: folds
TSuRyAHnUPCFjP7Z0rEE0w: folds
33q95we0Etwgrm6guQGncw leaves the table
yfXek8iJ7O4CFyqXrtGcfg collected $1 from pot
*** SUMMARY ***
Total pot $1 | Rake $0
Seat 1: iHo1oDbrEVJ8nEGdaPrICw (button) folded before Flop (didn't bet)
Seat 2: TSuRyAHnUPCFjP7Z0rEE0w (small blind) folded before Flop
Seat 3: yfXek8iJ7O4CFyqXrtGcfg (big blind) collected ($1)
Seat 4: 33q95we0Etwgrm6guQGncw folded before Flop (didn't bet)
Seat 5: KfwW5us6tydK81NYTtK1gw folded before Flop (didn't bet)
Seat 6: 4OO5v3AVduL0tePNx8wk5A folded before Flop (didn't bet)



PokerStars Game #59940060368:  Hold'em No Limit ($0.50/$1.00) - 2009/07/01 0:56:11 ET
Table '7O9fB8yx1u7sJveJn8w6jA' 6-max Seat #2 is the button
Seat 1: jy52+7FotjH63o5tEEVgKw ($135.85 in chips)
Seat 2: wx3sQGkVi2x9wJXuWNHPBw ($191 in chips)
Seat 3: hpxXcmRkXXI9HE5+5/j/0Q ($100 in chips)
Seat 4: XIZSmlGttGgSRaIU42K4Fg ($122.25 in chips)
Seat 5: BCEV3COoKY607AzLWayfRA ($100 in chips)
Seat 6: UBZQqpnJZdTYYY1FTb0rLA ($130.45 in chips)
hpxXcmRkXXI9HE5+5/j/0Q: posts small blind $0.50
XIZSmlGttGgSRaIU42K4Fg: posts big blind $1
*** HOLE CARDS ***
BCEV3COoKY607AzLWayfRA: folds
UBZQqpnJZdTYYY1FTb0rLA: folds
jy52+7FotjH63o5tEEVgKw: calls $1
wx3sQGkVi2x9wJXuWNHPBw: folds
hpxXcmRkXXI9HE5+5/j/0Q: folds
XIZSmlGttGgSRaIU42K4Fg: checks
*** FLOP *** [7h 2c Jh]
XIZSmlGttGgSRaIU42K4Fg: checks
jy52+7FotjH63o5tEEVgKw: bets $3
XIZSmlGttGgSRaIU42K4Fg: calls $3
*** TURN *** [7h 2c Jh] [8s]
XIZSmlGttGgSRaIU42K4Fg: checks
jy52+7FotjH63o5tEEVgKw: bets $4
XIZSmlGttGgSRaIU42K4Fg: calls $4
*** RIVER *** [7h 2c Jh 8s] [Kc]
XIZSmlGttGgSRaIU42K4Fg: checks
jy52+7FotjH63o5tEEVgKw: bets $5
XIZSmlGttGgSRaIU42K4Fg: raises $11 to $16
jy52+7FotjH63o5tEEVgKw: calls $11
*** SHOW DOWN ***
XIZSmlGttGgSRaIU42K4Fg: shows [7s 2d] (two pair, Sevens and Deuces)
jy52+7FotjH63o5tEEVgKw: mucks hand
XIZSmlGttGgSRaIU42K4Fg collected $46.15 from pot
*** SUMMARY ***
Total pot $48.50 | Rake $2.35
Board [7h 2c Jh 8s Kc]
Seat 1: jy52+7FotjH63o5tEEVgKw mucked
Seat 2: wx3sQGkVi2x9wJXuWNHPBw (button) folded before Flop (didn't bet)
Seat 3: hpxXcmRkXXI9HE5+5/j/0Q (small blind) folded before Flop
Seat 4: XIZSmlGttGgSRaIU42K4Fg (big blind) showed [7s 2d] and won ($46.15) with two pair, Sevens and Deuces
Seat 5: BCEV3COoKY607AzLWayfRA folded before Flop (didn't bet)
Seat 6: UBZQqpnJZdTYYY1FTb0rLA folded before Flop (didn't bet)



PokerStars Game #59940062328:  Hold'em No Limit ($0.50/$1.00) - 2009/07/01 0:56:14 ET
Table 'vs/5jr6ciwjVQ5+Soc+u2A' 6-max Seat #3 is the button
Seat 1: /P4w1pHg2zHYg/4ubJ0dPw ($60 in chips)
Seat 2: XOIf9W+VAxhZqN+SYoyMKA ($117.35 in chips)
Seat 3: G5ZSSN6RSON3gkNvk/SmYg ($141.85 in chips)
Seat 4: wk6Ohn4GDozoOMHc4eb2rw ($57.15 in chips)
Seat 5: 2DwLxMUbmzvwY7o4/i47Xg ($30.50 in chips)
wk6Ohn4GDozoOMHc4eb2rw: posts small blind $0.50
2DwLxMUbmzvwY7o4/i47Xg: posts big blind $1
*** HOLE CARDS ***
/P4w1pHg2zHYg/4ubJ0dPw: folds
XOIf9W+VAxhZqN+SYoyMKA: folds
G5ZSSN6RSON3gkNvk/SmYg: folds
wk6Ohn4GDozoOMHc4eb2rw: raises $1 to $2
2DwLxMUbmzvwY7o4/i47Xg: calls $1
*** FLOP *** [3d 4d 6s]
wk6Ohn4GDozoOMHc4eb2rw: checks
2DwLxMUbmzvwY7o4/i47Xg: bets $4
wk6Ohn4GDozoOMHc4eb2rw: folds
2DwLxMUbmzvwY7o4/i47Xg collected $3.80 from pot
2DwLxMUbmzvwY7o4/i47Xg: doesn't show hand
*** SUMMARY ***
Total pot $4 | Rake $0.20
Board [3d 4d 6s]
Seat 1: /P4w1pHg2zHYg/4ubJ0dPw folded before Flop (didn't bet)
Seat 2: XOIf9W+VAxhZqN+SYoyMKA folded before Flop (didn't bet)
Seat 3: G5ZSSN6RSON3gkNvk/SmYg (button) folded before Flop (didn't bet)
Seat 4: wk6Ohn4GDozoOMHc4eb2rw (small blind) folded on the Flop
Seat 5: 2DwLxMUbmzvwY7o4/i47Xg (big blind) collected ($3.80)



PokerStars Game #59940062464:  Hold'em No Limit ($0.50/$1.00) - 2009/07/01 0:56:15 ET
Table 'LmXQK9xy3awB+qsPzI21Mw' 2-max Seat #1 is the button
Seat 1: NYi6JFscYNrofSXy4sM+Yw ($323.25 in chips)
Seat 2: TME8GvochpQAo8cmJwWmvA ($67.55 in chips)
NYi6JFscYNrofSXy4sM+Yw: posts small blind $0.50
TME8GvochpQAo8cmJwWmvA: posts big blind $1
*** HOLE CARDS ***
NYi6JFscYNrofSXy4sM+Yw: raises $2 to $3
TME8GvochpQAo8cmJwWmvA: folds
NYi6JFscYNrofSXy4sM+Yw collected $2 from pot
*** SUMMARY ***
Total pot $2 | Rake $0
Seat 1: NYi6JFscYNrofSXy4sM+Yw (button) (small blind) collected ($2)
Seat 2: TME8GvochpQAo8cmJwWmvA (big blind) folded before Flop



PokerStars Game #59940063530:  Hold'em No Limit ($0.50/$1.00) - 2009/07/01 0:56:16 ET
Table 'eU3bWpDDg3Z+9R4m4iVmog' 6-max Seat #4 is the button
Seat 1: TSuRyAHnUPCFjP7Z0rEE0w ($192.65 in chips)
Seat 2: 8CAoOzhmB8n3nRFf3V4BTg ($81.80 in chips)
Seat 4: GDVIsbEJ/DOJsMKE4Asz0A ($88.60 in chips)
Seat 5: AdLVjddOzm+sRNo1Bc3S6Q ($100 in chips)
Seat 6: hpxXcmRkXXI9HE5+5/j/0Q ($120.10 in chips)
AdLVjddOzm+sRNo1Bc3S6Q: posts small blind $0.50
hpxXcmRkXXI9HE5+5/j/0Q: posts big blind $1
*** HOLE CARDS ***
TSuRyAHnUPCFjP7Z0rEE0w: folds
8CAoOzhmB8n3nRFf3V4BTg: folds
GDVIsbEJ/DOJsMKE4Asz0A: folds
AdLVjddOzm+sRNo1Bc3S6Q: folds
rVMOzU7w5FddYPGhD7qN2Q joins the table at seat #3
hpxXcmRkXXI9HE5+5/j/0Q collected $1 from pot
hpxXcmRkXXI9HE5+5/j/0Q: doesn't show hand
*** SUMMARY ***
Total pot $1 | Rake $0
Seat 1: TSuRyAHnUPCFjP7Z0rEE0w folded before Flop (didn't bet)
Seat 2: 8CAoOzhmB8n3nRFf3V4BTg folded before Flop (didn't bet)
Seat 4: GDVIsbEJ/DOJsMKE4Asz0A (button) folded before Flop (didn't bet)
Seat 5: AdLVjddOzm+sRNo1Bc3S6Q (small blind) folded before Flop
Seat 6: hpxXcmRkXXI9HE5+5/j/0Q (big blind) collected ($1)



PokerStars Game #59940065976:  Hold'em No Limit ($0.50/$1.00) - 2009/07/01 0:56:20 ET
Table 'U9zqzC8f3oTJ2ShXFgSSOA' 6-max Seat #2 is the button
Seat 1: iHo1oDbrEVJ8nEGdaPrICw ($105.40 in chips)
Seat 2: TSuRyAHnUPCFjP7Z0rEE0w ($100 in chips)
Seat 3: yfXek8iJ7O4CFyqXrtGcfg ($15.45 in chips)
Seat 5: KfwW5us6tydK81NYTtK1gw ($297.45 in chips)
Seat 6: 4OO5v3AVduL0tePNx8wk5A ($119.20 in chips)
yfXek8iJ7O4CFyqXrtGcfg: posts small blind $0.50
KfwW5us6tydK81NYTtK1gw: posts big blind $1
*** HOLE CARDS ***
4OO5v3AVduL0tePNx8wk5A: folds
iHo1oDbrEVJ8nEGdaPrICw: folds
TSuRyAHnUPCFjP7Z0rEE0w: folds
yfXek8iJ7O4CFyqXrtGcfg: calls $0.50
KfwW5us6tydK81NYTtK1gw: checks
*** FLOP *** [Qh 2s 9s]
yfXek8iJ7O4CFyqXrtGcfg: bets $3
KfwW5us6tydK81NYTtK1gw: folds
yfXek8iJ7O4CFyqXrtGcfg collected $1.90 from pot
*** SUMMARY ***
Total pot $2 | Rake $0.10
Board [Qh 2s 9s]
Seat 1: iHo1oDbrEVJ8nEGdaPrICw folded before Flop (didn't bet)
Seat 2: TSuRyAHnUPCFjP7Z0rEE0w (button) folded before Flop (didn't bet)
Seat 3: yfXek8iJ7O4CFyqXrtGcfg (small blind) collected ($1.90)
Seat 5: KfwW5us6tydK81NYTtK1gw (big blind) folded on the Flop
Seat 6: 4OO5v3AVduL0tePNx8wk5A folded before Flop (didn't bet)



PokerStars Game #59940065922:  Hold'em No Limit ($0.50/$1.00) - 2009/07/01 0:56:20 ET
Table 'cKH9c4x6u79IqCdaKKvXrw' 9-max Seat #4 is the button
Seat 1: Pp/KTcXkfZKKUHkjyaLTdg ($15.50 in chips)
Seat 2: 8S3JMH4TY3whgIlZmMv66w ($70.15 in chips)
Seat 3: 997ViqAtWn1FPjJqcffwcA ($157.10 in chips)
Seat 4: FL3MrLspcF23LYvC4ipBOA ($100 in chips)
Seat 5: Jjc7EHWzs4//xUAjJ0UWoA ($38.50 in chips)
Seat 6: Bsd/K5gAcLanYbGiPirRjw ($207.55 in chips)
Seat 7: 1GkkVBhlJ92guE6K5mS5Ig ($11.80 in chips)
Seat 9: 6XkTu4ahxzHnvjjc1R8YjQ ($43.10 in chips)
Jjc7EHWzs4//xUAjJ0UWoA: posts small blind $0.50
Bsd/K5gAcLanYbGiPirRjw: posts big blind $1
myIxN7otsyr846M539YR8Q: sits out
*** HOLE CARDS ***
1GkkVBhlJ92guE6K5mS5Ig: folds
6XkTu4ahxzHnvjjc1R8YjQ: folds
Pp/KTcXkfZKKUHkjyaLTdg: raises $2.50 to $3.50
8S3JMH4TY3whgIlZmMv66w: folds
997ViqAtWn1FPjJqcffwcA: folds
FL3MrLspcF23LYvC4ipBOA: folds
Jjc7EHWzs4//xUAjJ0UWoA: folds
Bsd/K5gAcLanYbGiPirRjw: folds
Pp/KTcXkfZKKUHkjyaLTdg collected $2.50 from pot
Pp/KTcXkfZKKUHkjyaLTdg: doesn't show hand
*** SUMMARY ***
Total pot $2.50 | Rake $0
Seat 1: Pp/KTcXkfZKKUHkjyaLTdg collected ($2.50)
Seat 2: 8S3JMH4TY3whgIlZmMv66w folded before Flop (didn't bet)
Seat 3: 997ViqAtWn1FPjJqcffwcA folded before Flop (didn't bet)
Seat 4: FL3MrLspcF23LYvC4ipBOA (button) folded before Flop (didn't bet)
Seat 5: Jjc7EHWzs4//xUAjJ0UWoA (small blind) folded before Flop
Seat 6: Bsd/K5gAcLanYbGiPirRjw (big blind) folded before Flop
Seat 7: 1GkkVBhlJ92guE6K5mS5Ig folded before Flop (didn't bet)
Seat 9: 6XkTu4ahxzHnvjjc1R8YjQ folded before Flop (didn't bet)



PokerStars Game #59940066678:  Hold'em No Limit ($0.50/$1.00) - 2009/07/01 0:56:21 ET
Table 'JOIm/fogLA7vSG0Vc6ME1A' 2-max Seat #2 is the button
Seat 1: NYi6JFscYNrofSXy4sM+Yw ($170.20 in chips)
Seat 2: F5lNTyZLIX9W2wQZ0plwgg ($81.10 in chips)
F5lNTyZLIX9W2wQZ0plwgg: posts small blind $0.50
NYi6JFscYNrofSXy4sM+Yw: posts big blind $1
*** HOLE CARDS ***
F5lNTyZLIX9W2wQZ0plwgg: raises $1 to $2
NYi6JFscYNrofSXy4sM+Yw: calls $1
*** FLOP *** [6h 4s Js]
NYi6JFscYNrofSXy4sM+Yw: checks
F5lNTyZLIX9W2wQZ0plwgg: bets $4
NYi6JFscYNrofSXy4sM+Yw: calls $4
*** TURN *** [6h 4s Js] [Qs]
NYi6JFscYNrofSXy4sM+Yw: checks
F5lNTyZLIX9W2wQZ0plwgg: checks
*** RIVER *** [6h 4s Js Qs] [Kd]
NYi6JFscYNrofSXy4sM+Yw: checks
F5lNTyZLIX9W2wQZ0plwgg: checks
*** SHOW DOWN ***
NYi6JFscYNrofSXy4sM+Yw: shows [3h 5d] (high card King)
F5lNTyZLIX9W2wQZ0plwgg: shows [Jd 9c] (a pair of Jacks)
F5lNTyZLIX9W2wQZ0plwgg collected $11.50 from pot
*** SUMMARY ***
Total pot $12 | Rake $0.50
Board [6h 4s Js Qs Kd]
Seat 1: NYi6JFscYNrofSXy4sM+Yw (big blind) showed [3h 5d] and lost with high card King
Seat 2: F5lNTyZLIX9W2wQZ0plwgg (button) (small blind) showed [Jd 9c] and won ($11.50) with a pair of Jacks



PokerStars Game #59940067334:  Hold'em No Limit ($0.50/$1.00) - 2009/07/01 0:56:23 ET
Table 'LmXQK9xy3awB+qsPzI21Mw' 2-max Seat #2 is the button
Seat 1: NYi6JFscYNrofSXy4sM+Yw ($324.25 in chips)
Seat 2: TME8GvochpQAo8cmJwWmvA ($66.55 in chips)
TME8GvochpQAo8cmJwWmvA: posts small blind $0.50
NYi6JFscYNrofSXy4sM+Yw: posts big blind $1
*** HOLE CARDS ***
TME8GvochpQAo8cmJwWmvA: raises $1 to $2
NYi6JFscYNrofSXy4sM+Yw: folds
TME8GvochpQAo8cmJwWmvA collected $2 from pot
TME8GvochpQAo8cmJwWmvA: doesn't show hand
*** SUMMARY ***
Total pot $2 | Rake $0
Seat 1: NYi6JFscYNrofSXy4sM+Yw (big blind) folded before Flop
Seat 2: TME8GvochpQAo8cmJwWmvA (button) (small blind) collected ($2)



PokerStars Game #59940067838:  Hold'em No Limit ($0.50/$1.00) - 2009/07/01 0:56:23 ET
Table '/FUb199IViHMJHi5YWmeuQ' 9-max Seat #8 is the button
Seat 1: TZcz9MEWDA+WydgGruqqbw ($114 in chips)
Seat 2: FL3MrLspcF23LYvC4ipBOA ($175.90 in chips)
Seat 3: qN483QJ1NvHbdIZB7J4ARw ($40.20 in chips)
Seat 4: qheQay5YvP2DMAb3OUSxtw ($143.35 in chips)
Seat 5: kiakSwxX0e64PwYGAPQvLw ($31.25 in chips)
Seat 6: ccFf7Q4z1cTGQmeoYiWEfw ($40.55 in chips)
Seat 7: bLbSOSmSOnqE0iTcH/5dxA ($105.20 in chips)
Seat 8: 997ViqAtWn1FPjJqcffwcA ($103 in chips)
Seat 9: RfLbneGRY8yQUpMgDnJCxA ($64.45 in chips)
RfLbneGRY8yQUpMgDnJCxA: posts small blind $0.50
TZcz9MEWDA+WydgGruqqbw: posts big blind $1
*** HOLE CARDS ***
FL3MrLspcF23LYvC4ipBOA: folds
qN483QJ1NvHbdIZB7J4ARw: calls $1
qheQay5YvP2DMAb3OUSxtw: folds
kiakSwxX0e64PwYGAPQvLw: folds
ccFf7Q4z1cTGQmeoYiWEfw: calls $1
bLbSOSmSOnqE0iTcH/5dxA: folds
997ViqAtWn1FPjJqcffwcA: folds
RfLbneGRY8yQUpMgDnJCxA: folds
TZcz9MEWDA+WydgGruqqbw: checks
*** FLOP *** [8c Th Js]
TZcz9MEWDA+WydgGruqqbw: checks
qN483QJ1NvHbdIZB7J4ARw: bets $3
ccFf7Q4z1cTGQmeoYiWEfw: calls $3
TZcz9MEWDA+WydgGruqqbw: folds
*** TURN *** [8c Th Js] [7h]
qN483QJ1NvHbdIZB7J4ARw: bets $4
ccFf7Q4z1cTGQmeoYiWEfw: calls $4
*** RIVER *** [8c Th Js 7h] [4c]
qN483QJ1NvHbdIZB7J4ARw: bets $8
ccFf7Q4z1cTGQmeoYiWEfw: calls $8
*** SHOW DOWN ***
qN483QJ1NvHbdIZB7J4ARw: shows [As 4h] (a pair of Fours)
ccFf7Q4z1cTGQmeoYiWEfw: shows [Td Qh] (a pair of Tens)
ccFf7Q4z1cTGQmeoYiWEfw collected $31.90 from pot
*** SUMMARY ***
Total pot $33.50 | Rake $1.60
Board [8c Th Js 7h 4c]
Seat 1: TZcz9MEWDA+WydgGruqqbw (big blind) folded on the Flop
Seat 2: FL3MrLspcF23LYvC4ipBOA folded before Flop (didn't bet)
Seat 3: qN483QJ1NvHbdIZB7J4ARw showed [As 4h] and lost with a pair of Fours
Seat 4: qheQay5YvP2DMAb3OUSxtw folded before Flop (didn't bet)
Seat 5: kiakSwxX0e64PwYGAPQvLw folded before Flop (didn't bet)
Seat 6: ccFf7Q4z1cTGQmeoYiWEfw showed [Td Qh] and won ($31.90) with a pair of Tens
Seat 7: bLbSOSmSOnqE0iTcH/5dxA folded before Flop (didn't bet)
Seat 8: 997ViqAtWn1FPjJqcffwcA (button) folded before Flop (didn't bet)
Seat 9: RfLbneGRY8yQUpMgDnJCxA (small blind) folded before Flop



PokerStars Game #59940068348:  Hold'em No Limit ($0.50/$1.00) - 2009/07/01 0:56:24 ET
Table 'hugOjcwJvzEwZbK7tyiWuQ' 9-max Seat #7 is the button
Seat 1: D+W9Me7w6Hcx/WRUSKV0dw ($20 in chips)
Seat 2: r27C1nIV4NS4+qbnrgBQSw ($262.50 in chips)
Seat 3: jDwhY1kCdc6EkAHbT7PJMQ ($102.15 in chips)
Seat 4: UWB3oeddt/GObx2Mix2Anw ($204.25 in chips)
Seat 5: 5BRGWf+R3nt2WS3b5xX+zA ($24.20 in chips)
Seat 6: gUUvmqdVlmvpal6B8nYrmg ($107.40 in chips)
Seat 7: FL3MrLspcF23LYvC4ipBOA ($111.80 in chips)
Seat 8: /zy+DB4S5fUQUSfZWFzYGw ($100 in chips)
/zy+DB4S5fUQUSfZWFzYGw: posts small blind $0.50
D+W9Me7w6Hcx/WRUSKV0dw: posts big blind $1
*** HOLE CARDS ***
r27C1nIV4NS4+qbnrgBQSw: folds
jDwhY1kCdc6EkAHbT7PJMQ: folds
UWB3oeddt/GObx2Mix2Anw: folds
5BRGWf+R3nt2WS3b5xX+zA: folds
gUUvmqdVlmvpal6B8nYrmg: folds
FL3MrLspcF23LYvC4ipBOA: folds
/zy+DB4S5fUQUSfZWFzYGw: raises $2 to $3
D+W9Me7w6Hcx/WRUSKV0dw: folds
/zy+DB4S5fUQUSfZWFzYGw collected $2 from pot
/zy+DB4S5fUQUSfZWFzYGw: doesn't show hand
*** SUMMARY ***
Total pot $2 | Rake $0
Seat 1: D+W9Me7w6Hcx/WRUSKV0dw (big blind) folded before Flop
Seat 2: r27C1nIV4NS4+qbnrgBQSw folded before Flop (didn't bet)
Seat 3: jDwhY1kCdc6EkAHbT7PJMQ folded before Flop (didn't bet)
Seat 4: UWB3oeddt/GObx2Mix2Anw folded before Flop (didn't bet)
Seat 5: 5BRGWf+R3nt2WS3b5xX+zA folded before Flop (didn't bet)
Seat 6: gUUvmqdVlmvpal6B8nYrmg folded before Flop (didn't bet)
Seat 7: FL3MrLspcF23LYvC4ipBOA (button) folded before Flop (didn't bet)
Seat 8: /zy+DB4S5fUQUSfZWFzYGw (small blind) collected ($2)



PokerStars Game #59940068306:  Hold'em No Limit ($0.50/$1.00) - 2009/07/01 0:56:24 ET
Table 'tyUh+jyNvrceIQdKMJjQ2wZFWj23PMihdwrNWv41OG/Qeat #1 is the button
Seat 1: o8A5MUdudVKu+pAwgZOX2w ($181.20 in chips)
Seat 2: XvUbOIg94d25feWeQlOTVg ($152.20 in chips)
Seat 3: TalCiLYHCd+ffkmR3auPvA ($85.90 in chips)
Seat 4: TSuRyAHnUPCFjP7Z0rEE0w ($111.25 in chips)
Seat 5: j7NIOHLZk7V2o9fOioO5ug ($118.30 in chips)
XvUbOIg94d25feWeQlOTVg: posts small blind $0.50
TalCiLYHCd+ffkmR3auPvA: posts big blind $1
4OO5v3AVduL0tePNx8wk5A: sits out
*** HOLE CARDS ***
TSuRyAHnUPCFjP7Z0rEE0w: folds
j7NIOHLZk7V2o9fOioO5ug: folds
o8A5MUdudVKu+pAwgZOX2w: calls $1
XvUbOIg94d25feWeQlOTVg: calls $0.50
TalCiLYHCd+ffkmR3auPvA: checks
*** FLOP *** [Ah 2h Qh]
XvUbOIg94d25feWeQlOTVg: checks
TalCiLYHCd+ffkmR3auPvA: checks
o8A5MUdudVKu+pAwgZOX2w: checks
*** TURN *** [Ah 2h Qh] [As]
XvUbOIg94d25feWeQlOTVg: checks
TalCiLYHCd+ffkmR3auPvA: bets $3
o8A5MUdudVKu+pAwgZOX2w: calls $3
XvUbOIg94d25feWeQlOTVg: folds
*** RIVER *** [Ah 2h Qh As] [Jh]
TalCiLYHCd+ffkmR3auPvA: bets $4
o8A5MUdudVKu+pAwgZOX2w: calls $4
*** SHOW DOWN ***
TalCiLYHCd+ffkmR3auPvA: shows [9h Js] (a flush, Ace high)
o8A5MUdudVKu+pAwgZOX2w: mucks hand
TalCiLYHCd+ffkmR3auPvA collected $16.20 from pot
*** SUMMARY ***
Total pot $17 | Rake $0.80
Board [Ah 2h Qh As Jh]
Seat 1: o8A5MUdudVKu+pAwgZOX2w (button) mucked
Seat 2: XvUbOIg94d25feWeQlOTVg (small blind) folded on the Turn
Seat 3: TalCiLYHCd+ffkmR3auPvA (big blind) showed [9h Js] and won ($16.20) with a flush, Ace high
Seat 4: TSuRyAHnUPCFjP7Z0rEE0w folded before Flop (didn't bet)
Seat 5: j7NIOHLZk7V2o9fOioO5ug folded before Flop (didn't bet)



PokerStars Game #59940069224:  Hold'em No Limit ($0.50/$1.00) - 2009/07/01 0:56:26 ET
Table '7Nl0ffnjeK44/vmeexh3MQ' 9-max Seat #3 is the button
Seat 1: s7D3Y+k4Cj4D1cXHv7oj+Q ($94.20 in chips)
Seat 2: OGgaARGdJQT4awWVNQ957w ($100 in chips)
Seat 3: vR4IO10geOgvTW+LAUBv/A ($100 in chips)
Seat 4: bLbSOSmSOnqE0iTcH/5dxA ($114.50 in chips)
Seat 6: FVs16t7GgfWgQWt4JxsObQ ($25.20 in chips)
Seat 7: 997ViqAtWn1FPjJqcffwcA ($100 in chips)
Seat 9: ouwUBGRKnKK9uhn1G4Lf+A ($197 in chips)
bLbSOSmSOnqE0iTcH/5dxA: posts small blind $0.50
bL+QVeDcuEdzMGAGg2XJHg: is sitting out
FVs16t7GgfWgQWt4JxsObQ: posts big blind $1
D+W9Me7w6Hcx/WRUSKV0dw: sits out
*** HOLE CARDS ***
bL+QVeDcuEdzMGAGg2XJHg leaves the table
997ViqAtWn1FPjJqcffwcA: folds
ouwUBGRKnKK9uhn1G4Lf+A: folds
s7D3Y+k4Cj4D1cXHv7oj+Q: calls $1
OGgaARGdJQT4awWVNQ957w: folds
vR4IO10geOgvTW+LAUBv/A: folds
bLbSOSmSOnqE0iTcH/5dxA: calls $0.50
FVs16t7GgfWgQWt4JxsObQ: raises $2 to $3
s7D3Y+k4Cj4D1cXHv7oj+Q: calls $2
bLbSOSmSOnqE0iTcH/5dxA: folds
*** FLOP *** [8c 7s Qh]
FVs16t7GgfWgQWt4JxsObQ: checks
s7D3Y+k4Cj4D1cXHv7oj+Q: checks
*** TURN *** [8c 7s Qh] [6d]
FVs16t7GgfWgQWt4JxsObQ: checks
s7D3Y+k4Cj4D1cXHv7oj+Q: bets $3
FVs16t7GgfWgQWt4JxsObQ: calls $3
*** RIVER *** [8c 7s Qh 6d] [7h]
FVs16t7GgfWgQWt4JxsObQ: bets $1
s7D3Y+k4Cj4D1cXHv7oj+Q: calls $1
*** SHOW DOWN ***
FVs16t7GgfWgQWt4JxsObQ: shows [2d 2s] (two pair, Sevens and Deuces)
s7D3Y+k4Cj4D1cXHv7oj+Q: mucks hand
FVs16t7GgfWgQWt4JxsObQ collected $14.30 from pot
*** SUMMARY ***
Total pot $15 | Rake $0.70
Board [8c 7s Qh 6d 7h]
Seat 1: s7D3Y+k4Cj4D1cXHv7oj+Q mucked
Seat 2: OGgaARGdJQT4awWVNQ957w folded before Flop (didn't bet)
Seat 3: vR4IO10geOgvTW+LAUBv/A (button) folded before Flop (didn't bet)
Seat 4: bLbSOSmSOnqE0iTcH/5dxA (small blind) folded before Flop
Seat 6: FVs16t7GgfWgQWt4JxsObQ (big blind) showed [2d 2s] and won ($14.30) with two pair, Sevens and Deuces
Seat 7: 997ViqAtWn1FPjJqcffwcA folded before Flop (didn't bet)
Seat 9: ouwUBGRKnKK9uhn1G4Lf+A folded before Flop (didn't bet)



PokerStars Game #59940069742:  Hold'em No Limit ($0.50/$1.00) - 2009/07/01 0:56:27 ET
Table '8jIjWCPY0NGprquL+xcMFg' 9-max Seat #5 is the button
Seat 1: vR4IO10geOgvTW+LAUBv/A ($136.05 in chips)
Seat 2: laA8va+Yv8WuMqT1zdR91g ($106.05 in chips)
Seat 3: tjhwe1V98x2spSoUQER3HQ ($104.50 in chips)
Seat 4: Jjc7EHWzs4//xUAjJ0UWoA ($18.50 in chips)
Seat 5: 2YpnxJiexJHyERfbqgwEcw ($85.55 in chips)
Seat 6: GTQkFJtSkbVbnGCktp6e3g ($101.85 in chips)
Seat 7: O3CGPwwUmamrCNHccOilrg ($45.45 in chips)
Seat 9: negfosHnGOZXSHpWDRKyBQ ($23 in chips)
GTQkFJtSkbVbnGCktp6e3g: posts small blind $0.50
O3CGPwwUmamrCNHccOilrg: posts big blind $1
D+W9Me7w6Hcx/WRUSKV0dw: sits out
*** HOLE CARDS ***
negfosHnGOZXSHpWDRKyBQ: folds
vR4IO10geOgvTW+LAUBv/A: folds
laA8va+Yv8WuMqT1zdR91g: folds
tjhwe1V98x2spSoUQER3HQ: folds
Jjc7EHWzs4//xUAjJ0UWoA: folds
2YpnxJiexJHyERfbqgwEcw: folds
GTQkFJtSkbVbnGCktp6e3g: folds
O3CGPwwUmamrCNHccOilrg collected $1 from pot
O3CGPwwUmamrCNHccOilrg: doesn't show hand
*** SUMMARY ***
Total pot $1 | Rake $0
Seat 1: vR4IO10geOgvTW+LAUBv/A folded before Flop (didn't bet)
Seat 2: laA8va+Yv8WuMqT1zdR91g folded before Flop (didn't bet)
Seat 3: tjhwe1V98x2spSoUQER3HQ folded before Flop (didn't bet)
Seat 4: Jjc7EHWzs4//xUAjJ0UWoA folded before Flop (didn't bet)
Seat 5: 2YpnxJiexJHyERfbqgwEcw (button) folded before Flop (didn't bet)
Seat 6: GTQkFJtSkbVbnGCktp6e3g (small blind) folded before Flop
Seat 7: O3CGPwwUmamrCNHccOilrg (big blind) collected ($1)
Seat 9: negfosHnGOZXSHpWDRKyBQ folded before Flop (didn't bet)



PokerStars Game #59940071720:  Hold'em No Limit ($0.50/$1.00) - 2009/07/01 0:56:30 ET
Table 'MUPc8FEpe/nR0BKSeReX6Q' 6-max Seat #4 is the button
Seat 2: xAU6q2/cwmby2sxmA8VcmA ($101 in chips)
Seat 3: wx3sQGkVi2x9wJXuWNHPBw ($231.85 in chips)
Seat 4: ZA1bp6g8IwtTxkUE4eCjDQ ($189.35 in chips)
Seat 5: UBZQqpnJZdTYYY1FTb0rLA ($104.05 in chips)
Seat 6: oxnw0GLLpFanjhGkxfRSqA ($57.70 in chips)
UBZQqpnJZdTYYY1FTb0rLA: posts small blind $0.50
oxnw0GLLpFanjhGkxfRSqA: posts big blind $1
*** HOLE CARDS ***
xAU6q2/cwmby2sxmA8VcmA: raises $3 to $4
wx3sQGkVi2x9wJXuWNHPBw: folds
ZA1bp6g8IwtTxkUE4eCjDQ: folds
UBZQqpnJZdTYYY1FTb0rLA: folds
oxnw0GLLpFanjhGkxfRSqA: calls $3
*** FLOP *** [4c 3d Qh]
oxnw0GLLpFanjhGkxfRSqA: checks
xAU6q2/cwmby2sxmA8VcmA: checks
*** TURN *** [4c 3d Qh] [Jc]
oxnw0GLLpFanjhGkxfRSqA: checks
xAU6q2/cwmby2sxmA8VcmA: bets $5
oxnw0GLLpFanjhGkxfRSqA: folds
xAU6q2/cwmby2sxmA8VcmA collected $8.10 from pot
xAU6q2/cwmby2sxmA8VcmA: doesn't show hand
*** SUMMARY ***
Total pot $8.50 | Rake $0.40
Board [4c 3d Qh Jc]
Seat 2: xAU6q2/cwmby2sxmA8VcmA collected ($8.10)
Seat 3: wx3sQGkVi2x9wJXuWNHPBw folded before Flop (didn't bet)
Seat 4: ZA1bp6g8IwtTxkUE4eCjDQ (button) folded before Flop (didn't bet)
Seat 5: UBZQqpnJZdTYYY1FTb0rLA (small blind) folded before Flop
Seat 6: oxnw0GLLpFanjhGkxfRSqA (big blind) folded on the Turn



PokerStars Game #59940071568:  Hold'em No Limit ($0.50/$1.00) - 2009/07/01 0:56:30 ET
Table 'LmXQK9xy3awB+qsPzI21Mw' 2-max Seat #1 is the button
Seat 1: NYi6JFscYNrofSXy4sM+Yw ($323.25 in chips)
Seat 2: TME8GvochpQAo8cmJwWmvA ($67.55 in chips)
NYi6JFscYNrofSXy4sM+Yw: posts small blind $0.50
TME8GvochpQAo8cmJwWmvA: posts big blind $1
*** HOLE CARDS ***
NYi6JFscYNrofSXy4sM+Yw: raises $2 to $3
TME8GvochpQAo8cmJwWmvA: raises $5 to $8
NYi6JFscYNrofSXy4sM+Yw: folds
TME8GvochpQAo8cmJwWmvA collected $6 from pot
TME8GvochpQAo8cmJwWmvA: doesn't show hand
*** SUMMARY ***
Total pot $6 | Rake $0
Seat 1: NYi6JFscYNrofSXy4sM+Yw (button) (small blind) folded before Flop
Seat 2: TME8GvochpQAo8cmJwWmvA (big blind) collected ($6)



PokerStars Game #59940072404:  Hold'em No Limit ($0.50/$1.00) - 2009/07/01 0:56:31 ET
Table 'Zka9tv1yilg0MvXWPQrShg' 9-max Seat #7 is the button
Seat 1: TZcz9MEWDA+WydgGruqqbw ($121.90 in chips)
Seat 2: kz9ziSiGUc+857heiKSayw ($17 in chips)
Seat 3: gUUvmqdVlmvpal6B8nYrmg ($106.80 in chips)
Seat 4: stxmTgSicxShtrDxhOOX2g ($68.15 in chips)
Seat 5: /zy+DB4S5fUQUSfZWFzYGw ($123.40 in chips)
Seat 6: rY8wPoax1lS+HUY+I0FZDw ($142.95 in chips)
Seat 7: p1SafS90nb3Uft5LB0NkHw ($20.50 in chips)
Seat 9: 6daxhj43mWj04MOPTOmaYA ($94.50 in chips)
D+W9Me7w6Hcx/WRUSKV0dw will be allowed to play after the button
6daxhj43mWj04MOPTOmaYA: posts small blind $0.50
TZcz9MEWDA+WydgGruqqbw: posts big blind $1
*** HOLE CARDS ***
kz9ziSiGUc+857heiKSayw: folds
gUUvmqdVlmvpal6B8nYrmg: folds
stxmTgSicxShtrDxhOOX2g: raises $1 to $2
/zy+DB4S5fUQUSfZWFzYGw: folds
rY8wPoax1lS+HUY+I0FZDw: folds
p1SafS90nb3Uft5LB0NkHw: folds
6daxhj43mWj04MOPTOmaYA: folds
TZcz9MEWDA+WydgGruqqbw: folds
stxmTgSicxShtrDxhOOX2g collected $2.50 from pot
*** SUMMARY ***
Total pot $2.50 | Rake $0
Seat 1: TZcz9MEWDA+WydgGruqqbw (big blind) folded before Flop
Seat 2: kz9ziSiGUc+857heiKSayw folded before Flop (didn't bet)
Seat 3: gUUvmqdVlmvpal6B8nYrmg folded before Flop (didn't bet)
Seat 4: stxmTgSicxShtrDxhOOX2g collected ($2.50)
Seat 5: /zy+DB4S5fUQUSfZWFzYGw folded before Flop (didn't bet)
Seat 6: rY8wPoax1lS+HUY+I0FZDw folded before Flop (didn't bet)
Seat 7: p1SafS90nb3Uft5LB0NkHw (button) folded before Flop (didn't bet)
Seat 9: 6daxhj43mWj04MOPTOmaYA (small blind) folded before Flop



PokerStars Game #59940074766:  Hold'em No Limit ($0.50/$1.00) - 2009/07/01 0:56:35 ET
Table 'iSx0wTgVb4o7MyZeOe06ZA' 9-max Seat #2 is the button
Seat 2: myIxN7otsyr846M539YR8Q ($18.50 in chips)
Seat 3: XQV7mCMbzd2Wh/l74wmbug ($82.65 in chips)
Seat 5: o1axyw4AjQ8n4ubTwlirQQ ($23.50 in chips)
Seat 6: T5/PXFS/W+LLcIXBo1G/RA ($96.15 in chips)
Seat 7: w4NnqVr/Sfoj65ux/fEUyQ ($79.40 in chips)
Seat 8: gUUvmqdVlmvpal6B8nYrmg ($100 in chips)
Seat 9: DMQXVuViR4IFzRccosBkJw ($79.05 in chips)
XQV7mCMbzd2Wh/l74wmbug: posts small blind $0.50
Ogn4JDV3mp4ZDKO49IFzKA: is sitting out
o1axyw4AjQ8n4ubTwlirQQ: posts big blind $1
Ogn4JDV3mp4ZDKO49IFzKA leaves the table
VPF+HjszMvUIpy0CHIwH3A: sits out
*** HOLE CARDS ***
T5/PXFS/W+LLcIXBo1G/RA: folds
w4NnqVr/Sfoj65ux/fEUyQ: folds
gUUvmqdVlmvpal6B8nYrmg: folds
DMQXVuViR4IFzRccosBkJw: folds
0fXz44fzDo5QmhAaJCvFfA joins the table at seat #4
myIxN7otsyr846M539YR8Q: raises $17.50 to $18.50 and is all-in
XQV7mCMbzd2Wh/l74wmbug: folds
o1axyw4AjQ8n4ubTwlirQQ: folds
myIxN7otsyr846M539YR8Q collected $2.50 from pot
*** SUMMARY ***
Total pot $2.50 | Rake $0
Seat 2: myIxN7otsyr846M539YR8Q (button) collected ($2.50)
Seat 3: XQV7mCMbzd2Wh/l74wmbug (small blind) folded before Flop
Seat 5: o1axyw4AjQ8n4ubTwlirQQ (big blind) folded before Flop
Seat 6: T5/PXFS/W+LLcIXBo1G/RA folded before Flop (didn't bet)
Seat 7: w4NnqVr/Sfoj65ux/fEUyQ folded before Flop (didn't bet)
Seat 8: gUUvmqdVlmvpal6B8nYrmg folded before Flop (didn't bet)
Seat 9: DMQXVuViR4IFzRccosBkJw folded before Flop (didn't bet)



PokerStars Game #59940075498:  Hold'em No Limit ($0.50/$1.00) - 2009/07/01 0:56:36 ET
Table 'fTlPiCj0utgzC/5io+I7ew' 6-max Seat #4 is the button
Seat 1: YMJG+F++3Aj6P8dAWda5fw ($93.50 in chips)
Seat 2: Qy/UBNbD2HaA0Ogxg8Sf3w ($125.85 in chips)
Seat 3: wL5HjWHHOSGc53xWMNKB9Q ($33.60 in chips)
Seat 4: uJVSceLggtsrJya+WtmUEA ($117.75 in chips)
Seat 5: bFrTkDcWGTxyvNul7GVdYg ($308.05 in chips)
Seat 6: /P4w1pHg2zHYg/4ubJ0dPw ($60 in chips)
bFrTkDcWGTxyvNul7GVdYg: posts small blind $0.50
/P4w1pHg2zHYg/4ubJ0dPw: posts big blind $1
wL5HjWHHOSGc53xWMNKB9Q: posts big blind $1
*** HOLE CARDS ***
YMJG+F++3Aj6P8dAWda5fw: folds
Qy/UBNbD2HaA0Ogxg8Sf3w: raises $3 to $4
wL5HjWHHOSGc53xWMNKB9Q: folds
uJVSceLggtsrJya+WtmUEA: folds
bFrTkDcWGTxyvNul7GVdYg: folds
/P4w1pHg2zHYg/4ubJ0dPw: folds
Qy/UBNbD2HaA0Ogxg8Sf3w collected $3.50 from pot
*** SUMMARY ***
Total pot $3.50 | Rake $0
Seat 1: YMJG+F++3Aj6P8dAWda5fw folded before Flop (didn't bet)
Seat 2: Qy/UBNbD2HaA0Ogxg8Sf3w collected ($3.50)
Seat 3: wL5HjWHHOSGc53xWMNKB9Q folded before Flop
Seat 4: uJVSceLggtsrJya+WtmUEA (button) folded before Flop (didn't bet)
Seat 5: bFrTkDcWGTxyvNul7GVdYg (small blind) folded before Flop
Seat 6: /P4w1pHg2zHYg/4ubJ0dPw (big blind) folded before Flop



PokerStars Game #59940075764:  Hold'em No Limit ($0.50/$1.00) - 2009/07/01 0:56:36 ET
Table 'eU3bWpDDg3Z+9R4m4iVmog' 6-max Seat #5 is the button
Seat 1: TSuRyAHnUPCFjP7Z0rEE0w ($192.65 in chips)
Seat 2: 8CAoOzhmB8n3nRFf3V4BTg ($81.80 in chips)
Seat 4: GDVIsbEJ/DOJsMKE4Asz0A ($88.60 in chips)
Seat 5: AdLVjddOzm+sRNo1Bc3S6Q ($100 in chips)
Seat 6: hpxXcmRkXXI9HE5+5/j/0Q ($120.60 in chips)
hpxXcmRkXXI9HE5+5/j/0Q: posts small blind $0.50
TSuRyAHnUPCFjP7Z0rEE0w: posts big blind $1
rVMOzU7w5FddYPGhD7qN2Q: sits out
*** HOLE CARDS ***
8CAoOzhmB8n3nRFf3V4BTg: folds
GDVIsbEJ/DOJsMKE4Asz0A: folds
AdLVjddOzm+sRNo1Bc3S6Q: raises $3 to $4
hpxXcmRkXXI9HE5+5/j/0Q: folds
TSuRyAHnUPCFjP7Z0rEE0w: folds
AdLVjddOzm+sRNo1Bc3S6Q collected $2.50 from pot
AdLVjddOzm+sRNo1Bc3S6Q: doesn't show hand
*** SUMMARY ***
Total pot $2.50 | Rake $0
Seat 1: TSuRyAHnUPCFjP7Z0rEE0w (big blind) folded before Flop
Seat 2: 8CAoOzhmB8n3nRFf3V4BTg folded before Flop (didn't bet)
Seat 4: GDVIsbEJ/DOJsMKE4Asz0A folded before Flop (didn't bet)
Seat 5: AdLVjddOzm+sRNo1Bc3S6Q (button) collected ($2.50)
Seat 6: hpxXcmRkXXI9HE5+5/j/0Q (small blind) folded before Flop



PokerStars Game #59940076270:  Hold'em No Limit ($0.50/$1.00) - 2009/07/01 0:56:37 ET
Table 'JOIm/fogLA7vSG0Vc6ME1A' 2-max Seat #1 is the button
Seat 1: NYi6JFscYNrofSXy4sM+Yw ($164.20 in chips)
Seat 2: F5lNTyZLIX9W2wQZ0plwgg ($86.60 in chips)
NYi6JFscYNrofSXy4sM+Yw: posts small blind $0.50
F5lNTyZLIX9W2wQZ0plwgg: posts big blind $1
*** HOLE CARDS ***
NYi6JFscYNrofSXy4sM+Yw: folds
F5lNTyZLIX9W2wQZ0plwgg collected $1 from pot
F5lNTyZLIX9W2wQZ0plwgg: doesn't show hand
*** SUMMARY ***
Total pot $1 | Rake $0
Seat 1: NYi6JFscYNrofSXy4sM+Yw (button) (small blind) folded before Flop
Seat 2: F5lNTyZLIX9W2wQZ0plwgg (big blind) collected ($1)



PokerStars Game #59940076564:  Hold'em No Limit ($0.50/$1.00) - 2009/07/01 0:56:38 ET
Table 'SQLOQoANiHscJ8AL7zffbw' 9-max Seat #2 is the button
Seat 1: jPTRd6SpCp4xqAy2XQiTOw ($67.10 in chips)
Seat 2: /zy+DB4S5fUQUSfZWFzYGw ($329.50 in chips)
Seat 3: 0eFnow7+D7veCYQ+CG9FFw ($93.85 in chips)
Seat 4: /mfensKw8/iZ1Vrx33S4xg ($21.50 in chips)
Seat 5: L9njYvloJ1NdXjP8edHEAg ($105.60 in chips)
Seat 6: p5UKaxVobvptF0ANhR/q1A ($173 in chips)
Seat 7: bJckevFOcg//s0qyMQI6sQ ($100 in chips)
Seat 8: 2BV+oJIQYr65IO6nEChvbA ($60 in chips)
Seat 9: qJr25HAtvv1w/7IBvjMM3g ($200.90 in chips)
0eFnow7+D7veCYQ+CG9FFw: posts small blind $0.50
/mfensKw8/iZ1Vrx33S4xg: posts big blind $1
*** HOLE CARDS ***
L9njYvloJ1NdXjP8edHEAg: folds
p5UKaxVobvptF0ANhR/q1A: folds
bJckevFOcg//s0qyMQI6sQ: folds
2BV+oJIQYr65IO6nEChvbA: folds
qJr25HAtvv1w/7IBvjMM3g: calls $1
jPTRd6SpCp4xqAy2XQiTOw: folds
/zy+DB4S5fUQUSfZWFzYGw: folds
0eFnow7+D7veCYQ+CG9FFw: folds
/mfensKw8/iZ1Vrx33S4xg: checks
*** FLOP *** [5c Tc Qh]
/mfensKw8/iZ1Vrx33S4xg: checks
qJr25HAtvv1w/7IBvjMM3g: bets $2
/mfensKw8/iZ1Vrx33S4xg: folds
qJr25HAtvv1w/7IBvjMM3g collected $2.40 from pot
*** SUMMARY ***
Total pot $2.50 | Rake $0.10
Board [5c Tc Qh]
Seat 1: jPTRd6SpCp4xqAy2XQiTOw folded before Flop (didn't bet)
Seat 2: /zy+DB4S5fUQUSfZWFzYGw (button) folded before Flop (didn't bet)
Seat 3: 0eFnow7+D7veCYQ+CG9FFw (small blind) folded before Flop
Seat 4: /mfensKw8/iZ1Vrx33S4xg (big blind) folded on the Flop
Seat 5: L9njYvloJ1NdXjP8edHEAg folded before Flop (didn't bet)
Seat 6: p5UKaxVobvptF0ANhR/q1A folded before Flop (didn't bet)
Seat 7: bJckevFOcg//s0qyMQI6sQ folded before Flop (didn't bet)
Seat 8: 2BV+oJIQYr65IO6nEChvbA folded before Flop (didn't bet)
Seat 9: qJr25HAtvv1w/7IBvjMM3g collected ($2.40)



PokerStars Game #59940077554:  Hold'em No Limit ($0.50/$1.00) - 2009/07/01 0:56:39 ET
Table 'LmXQK9xy3awB+qsPzI21Mw' 2-max Seat #2 is the button
Seat 1: NYi6JFscYNrofSXy4sM+Yw ($320.25 in chips)
Seat 2: TME8GvochpQAo8cmJwWmvA ($70.55 in chips)
TME8GvochpQAo8cmJwWmvA: posts small blind $0.50
NYi6JFscYNrofSXy4sM+Yw: posts big blind $1
*** HOLE CARDS ***
TME8GvochpQAo8cmJwWmvA: raises $1 to $2
NYi6JFscYNrofSXy4sM+Yw: calls $1
*** FLOP *** [Tc 4s 6d]
NYi6JFscYNrofSXy4sM+Yw: checks
TME8GvochpQAo8cmJwWmvA: bets $3
NYi6JFscYNrofSXy4sM+Yw: calls $3
*** TURN *** [Tc 4s 6d] [6h]
NYi6JFscYNrofSXy4sM+Yw: checks
TME8GvochpQAo8cmJwWmvA: checks
*** RIVER *** [Tc 4s 6d 6h] [3d]
NYi6JFscYNrofSXy4sM+Yw: bets $6
TME8GvochpQAo8cmJwWmvA: calls $6
*** SHOW DOWN ***
NYi6JFscYNrofSXy4sM+Yw: shows [9d 8d] (a pair of Sixes)
TME8GvochpQAo8cmJwWmvA: shows [7h Ts] (two pair, Tens and Sixes)
TME8GvochpQAo8cmJwWmvA collected $21.50 from pot
*** SUMMARY ***
Total pot $22 | Rake $0.50
Board [Tc 4s 6d 6h 3d]
Seat 1: NYi6JFscYNrofSXy4sM+Yw (big blind) showed [9d 8d] and lost with a pair of Sixes
Seat 2: TME8GvochpQAo8cmJwWmvA (button) (small blind) showed [7h Ts] and won ($21.50) with two pair, Tens and Sixes



PokerStars Game #59940077046:  Hold'em No Limit ($0.50/$1.00) - 2009/07/01 0:56:39 ET
Table '/RZcOwpZpHQ+OwPwjsbnRw' 6-max Seat #5 is the button
Seat 1: Zboa6dColKGHBjLPUakZjw ($34.90 in chips)
Seat 2: +xW7QemQU0Fxs+4TnqBRow ($238.65 in chips)
Seat 3: XnT1yK2DD/5FL+0bwuEhqg ($46.45 in chips)
Seat 4: j7NIOHLZk7V2o9fOioO5ug ($100 in chips)
Seat 5: wx3sQGkVi2x9wJXuWNHPBw ($179.15 in chips)
Seat 6: XOIf9W+VAxhZqN+SYoyMKA ($290.75 in chips)
XOIf9W+VAxhZqN+SYoyMKA: posts small blind $0.50
Zboa6dColKGHBjLPUakZjw: posts big blind $1
*** HOLE CARDS ***
+xW7QemQU0Fxs+4TnqBRow: folds
XnT1yK2DD/5FL+0bwuEhqg: folds
j7NIOHLZk7V2o9fOioO5ug: folds
wx3sQGkVi2x9wJXuWNHPBw: folds
XOIf9W+VAxhZqN+SYoyMKA: raises $2 to $3
Zboa6dColKGHBjLPUakZjw: raises $2 to $5
XOIf9W+VAxhZqN+SYoyMKA: calls $2
*** FLOP *** [8c Ts 6d]
XOIf9W+VAxhZqN+SYoyMKA: checks
Zboa6dColKGHBjLPUakZjw: bets $3
XOIf9W+VAxhZqN+SYoyMKA: raises $10 to $13
Zboa6dColKGHBjLPUakZjw: calls $10
*** TURN *** [8c Ts 6d] [Js]
XOIf9W+VAxhZqN+SYoyMKA: bets $20
Zboa6dColKGHBjLPUakZjw: calls $16.90 and is all-in
*** RIVER *** [8c Ts 6d Js] [Jc]
*** SHOW DOWN ***
XOIf9W+VAxhZqN+SYoyMKA: shows [Th Qs] (two pair, Jacks and Tens)
Zboa6dColKGHBjLPUakZjw: shows [Ad As] (two pair, Aces and Jacks)
Zboa6dColKGHBjLPUakZjw collected $66.80 from pot
*** SUMMARY ***
Total pot $69.80 | Rake $3
Board [8c Ts 6d Js Jc]
Seat 1: Zboa6dColKGHBjLPUakZjw (big blind) showed [Ad As] and won ($66.80) with two pair, Aces and Jacks
Seat 2: +xW7QemQU0Fxs+4TnqBRow folded before Flop (didn't bet)
Seat 3: XnT1yK2DD/5FL+0bwuEhqg folded before Flop (didn't bet)
Seat 4: j7NIOHLZk7V2o9fOioO5ug folded before Flop (didn't bet)
Seat 5: wx3sQGkVi2x9wJXuWNHPBw (button) folded before Flop (didn't bet)
Seat 6: XOIf9W+VAxhZqN+SYoyMKA (small blind) showed [Th Qs] and lost with two pair, Jacks and Tens



PokerStars Game #59940077780:  Hold'em No Limit ($0.50/$1.00) - 2009/07/01 0:56:40 ET
Table 'vs/5jr6ciwjVQ5+Soc+u2A' 6-max Seat #4 is the button
Seat 1: /P4w1pHg2zHYg/4ubJ0dPw ($60 in chips)
Seat 2: XOIf9W+VAxhZqN+SYoyMKA ($117.35 in chips)
Seat 3: G5ZSSN6RSON3gkNvk/SmYg ($141.85 in chips)
Seat 4: wk6Ohn4GDozoOMHc4eb2rw ($55.15 in chips)
Seat 5: 2DwLxMUbmzvwY7o4/i47Xg ($32.30 in chips)
2DwLxMUbmzvwY7o4/i47Xg: posts small blind $0.50
/P4w1pHg2zHYg/4ubJ0dPw: posts big blind $1
*** HOLE CARDS ***
XOIf9W+VAxhZqN+SYoyMKA: folds
G5ZSSN6RSON3gkNvk/SmYg: folds
wk6Ohn4GDozoOMHc4eb2rw: raises $1 to $2
2DwLxMUbmzvwY7o4/i47Xg: folds
/P4w1pHg2zHYg/4ubJ0dPw: folds
wk6Ohn4GDozoOMHc4eb2rw collected $2.50 from pot
wk6Ohn4GDozoOMHc4eb2rw: doesn't show hand
*** SUMMARY ***
Total pot $2.50 | Rake $0
Seat 1: /P4w1pHg2zHYg/4ubJ0dPw (big blind) folded before Flop
Seat 2: XOIf9W+VAxhZqN+SYoyMKA folded before Flop (didn't bet)
Seat 3: G5ZSSN6RSON3gkNvk/SmYg folded before Flop (didn't bet)
Seat 4: wk6Ohn4GDozoOMHc4eb2rw (button) collected ($2.50)
Seat 5: 2DwLxMUbmzvwY7o4/i47Xg (small blind) folded before Flop



PokerStars Game #59940077704:  Hold'em No Limit ($0.50/$1.00) - 2009/07/01 0:56:40 ET
Table 'VOs36P6NW+QyXeQ1B62kmA' 6-max Seat #2 is the button
Seat 1: AdLVjddOzm+sRNo1Bc3S6Q ($130.80 in chips)
Seat 2: 2UMlbaZ8n8AbRli0Yr0mDw ($19.90 in chips)
Seat 3: TSuRyAHnUPCFjP7Z0rEE0w ($106.90 in chips)
Seat 4: w02zQzNydODiyV9THKgo9w ($41.50 in chips)
Seat 5: ozrlafxxh1HmYdA0/h+MuA ($44.75 in chips)
TSuRyAHnUPCFjP7Z0rEE0w: posts small blind $0.50
w02zQzNydODiyV9THKgo9w: posts big blind $1
slVKuQyEz8Qj4E3uLPYNXg: sits out
*** HOLE CARDS ***
ozrlafxxh1HmYdA0/h+MuA: folds
AdLVjddOzm+sRNo1Bc3S6Q: folds
2UMlbaZ8n8AbRli0Yr0mDw: folds
TSuRyAHnUPCFjP7Z0rEE0w: folds
w02zQzNydODiyV9THKgo9w collected $1 from pot
*** SUMMARY ***
Total pot $1 | Rake $0
Seat 1: AdLVjddOzm+sRNo1Bc3S6Q folded before Flop (didn't bet)
Seat 2: 2UMlbaZ8n8AbRli0Yr0mDw (button) folded before Flop (didn't bet)
Seat 3: TSuRyAHnUPCFjP7Z0rEE0w (small blind) folded before Flop
Seat 4: w02zQzNydODiyV9THKgo9w (big blind) collected ($1)
Seat 5: ozrlafxxh1HmYdA0/h+MuA folded before Flop (didn't bet)



PokerStars Game #59940078490:  Hold'em No Limit ($0.50/$1.00) - 2009/07/01 0:56:41 ET
Table 'tLrtq7gDzxEvckNAI1OS5Q' 6-max Seat #4 is the button
Seat 1: xNKcQzD9+/iHmtJn4vYq9w ($95.55 in chips)
Seat 2: QHvTZcrKe6+maWUfVjP29Q ($101.50 in chips)
Seat 3: TPZ+m9x+lwoKpv7TMfAUWA ($205.20 in chips)
Seat 4: +uSzP8Jwnw7sKfQ4s66b7w ($49.80 in chips)
Seat 5: OGMLOcTNYZXZU81au7ztUw ($166.15 in chips)
Seat 6: XUk5GQsfNFpHvaToDZ0rZA ($168.20 in chips)
OGMLOcTNYZXZU81au7ztUw: posts small blind $0.50
XUk5GQsfNFpHvaToDZ0rZA: posts big blind $1
*** HOLE CARDS ***
xNKcQzD9+/iHmtJn4vYq9w: raises $2.50 to $3.50
QHvTZcrKe6+maWUfVjP29Q: folds
TPZ+m9x+lwoKpv7TMfAUWA: calls $3.50
+uSzP8Jwnw7sKfQ4s66b7w: folds
OGMLOcTNYZXZU81au7ztUw: folds
XUk5GQsfNFpHvaToDZ0rZA: folds
*** FLOP *** [As 4h 4s]
xNKcQzD9+/iHmtJn4vYq9w: bets $5
TPZ+m9x+lwoKpv7TMfAUWA: raises $10 to $15
xNKcQzD9+/iHmtJn4vYq9w: calls $10
*** TURN *** [As 4h 4s] [Th]
xNKcQzD9+/iHmtJn4vYq9w: checks
TPZ+m9x+lwoKpv7TMfAUWA: bets $32
xNKcQzD9+/iHmtJn4vYq9w: calls $32
*** RIVER *** [As 4h 4s Th] [Ks]
xNKcQzD9+/iHmtJn4vYq9w: bets $45.05 and is all-in
TPZ+m9x+lwoKpv7TMfAUWA: calls $45.05
*** SHOW DOWN ***
xNKcQzD9+/iHmtJn4vYq9w: shows [8d 8h] (two pair, Eights and Fours)
TPZ+m9x+lwoKpv7TMfAUWA: shows [4c 7c] (three of a kind, Fours)
TPZ+m9x+lwoKpv7TMfAUWA collected $189.60 from pot
*** SUMMARY ***
Total pot $192.60 | Rake $3
Board [As 4h 4s Th Ks]
Seat 1: xNKcQzD9+/iHmtJn4vYq9w showed [8d 8h] and lost with two pair, Eights and Fours
Seat 2: QHvTZcrKe6+maWUfVjP29Q folded before Flop (didn't bet)
Seat 3: TPZ+m9x+lwoKpv7TMfAUWA showed [4c 7c] and won ($189.60) with three of a kind, Fours
Seat 4: +uSzP8Jwnw7sKfQ4s66b7w (button) folded before Flop (didn't bet)
Seat 5: OGMLOcTNYZXZU81au7ztUw (small blind) folded before Flop
Seat 6: XUk5GQsfNFpHvaToDZ0rZA (big blind) folded before Flop



PokerStars Game #59940079824:  Hold'em No Limit ($0.50/$1.00) - 2009/07/01 0:56:43 ET
Table 'JOIm/fogLA7vSG0Vc6ME1A' 2-max Seat #2 is the button
Seat 1: NYi6JFscYNrofSXy4sM+Yw ($163.70 in chips)
Seat 2: F5lNTyZLIX9W2wQZ0plwgg ($87.10 in chips)
F5lNTyZLIX9W2wQZ0plwgg: posts small blind $0.50
NYi6JFscYNrofSXy4sM+Yw: posts big blind $1
*** HOLE CARDS ***
F5lNTyZLIX9W2wQZ0plwgg: raises $3 to $4
NYi6JFscYNrofSXy4sM+Yw: folds
F5lNTyZLIX9W2wQZ0plwgg collected $2 from pot
F5lNTyZLIX9W2wQZ0plwgg: doesn't show hand
*** SUMMARY ***
Total pot $2 | Rake $0
Seat 1: NYi6JFscYNrofSXy4sM+Yw (big blind) folded before Flop
Seat 2: F5lNTyZLIX9W2wQZ0plwgg (button) (small blind) collected ($2)



PokerStars Game #59940082416:  Hold'em No Limit ($0.50/$1.00) - 2009/07/01 0:56:47 ET
Table 'cKH9c4x6u79IqCdaKKvXrw' 9-max Seat #5 is the button
Seat 1: Pp/KTcXkfZKKUHkjyaLTdg ($17 in chips)
Seat 2: 8S3JMH4TY3whgIlZmMv66w ($70.15 in chips)
Seat 3: 997ViqAtWn1FPjJqcffwcA ($157.10 in chips)
Seat 4: FL3MrLspcF23LYvC4ipBOA ($100 in chips)
Seat 5: Jjc7EHWzs4//xUAjJ0UWoA ($38 in chips)
Seat 6: Bsd/K5gAcLanYbGiPirRjw ($206.55 in chips)
Seat 7: 1GkkVBhlJ92guE6K5mS5Ig ($11.80 in chips)
Seat 9: 6XkTu4ahxzHnvjjc1R8YjQ ($43.10 in chips)
Bsd/K5gAcLanYbGiPirRjw: posts small blind $0.50
1GkkVBhlJ92guE6K5mS5Ig: posts big blind $1
myIxN7otsyr846M539YR8Q: sits out
*** HOLE CARDS ***
6XkTu4ahxzHnvjjc1R8YjQ: folds
Pp/KTcXkfZKKUHkjyaLTdg: folds
8S3JMH4TY3whgIlZmMv66w: folds
997ViqAtWn1FPjJqcffwcA: folds
FL3MrLspcF23LYvC4ipBOA: raises $2 to $3
Jjc7EHWzs4//xUAjJ0UWoA: folds
Bsd/K5gAcLanYbGiPirRjw: raises $7 to $10
1GkkVBhlJ92guE6K5mS5Ig: folds
FL3MrLspcF23LYvC4ipBOA: folds
Bsd/K5gAcLanYbGiPirRjw collected $7 from pot
*** SUMMARY ***
Total pot $7 | Rake $0
Seat 1: Pp/KTcXkfZKKUHkjyaLTdg folded before Flop (didn't bet)
Seat 2: 8S3JMH4TY3whgIlZmMv66w folded before Flop (didn't bet)
Seat 3: 997ViqAtWn1FPjJqcffwcA folded before Flop (didn't bet)
Seat 4: FL3MrLspcF23LYvC4ipBOA folded before Flop
Seat 5: Jjc7EHWzs4//xUAjJ0UWoA (button) folded before Flop (didn't bet)
Seat 6: Bsd/K5gAcLanYbGiPirRjw (small blind) collected ($7)
Seat 7: 1GkkVBhlJ92guE6K5mS5Ig (big blind) folded before Flop
Seat 9: 6XkTu4ahxzHnvjjc1R8YjQ folded before Flop (didn't bet)



PokerStars Game #59940082998:  Hold'em No Limit ($0.50/$1.00) - 2009/07/01 0:56:48 ET
Table 'pHrhryH8jPNdQfY62f8v+g' 6-max Seat #6 is the button
Seat 1: OvwYHV65yUbgdBjSmo1+5g ($59 in chips)
Seat 2: RqgF7gRoKgRNW8Zoi1ty4A ($100.75 in chips)
Seat 3: 8oS5O7iD/qnFXFXJrGIgNQ ($159.30 in chips)
Seat 5: r1/R7y0Ortgoz4lccgW8VA ($47.90 in chips)
Seat 6: xAU6q2/cwmby2sxmA8VcmA ($113.30 in chips)
OvwYHV65yUbgdBjSmo1+5g: posts small blind $0.50
RqgF7gRoKgRNW8Zoi1ty4A: posts big blind $1
*** HOLE CARDS ***
DHjG71KHeyQxu3OZ+fFd4w joins the table at seat #4
8oS5O7iD/qnFXFXJrGIgNQ: raises $2 to $3
r1/R7y0Ortgoz4lccgW8VA: calls $3
xAU6q2/cwmby2sxmA8VcmA: folds
OvwYHV65yUbgdBjSmo1+5g: folds
RqgF7gRoKgRNW8Zoi1ty4A: folds
*** FLOP *** [5s Ah 4h]
8oS5O7iD/qnFXFXJrGIgNQ: checks
r1/R7y0Ortgoz4lccgW8VA: bets $3.50
8oS5O7iD/qnFXFXJrGIgNQ: folds
r1/R7y0Ortgoz4lccgW8VA collected $7.15 from pot
*** SUMMARY ***
Total pot $7.50 | Rake $0.35
Board [5s Ah 4h]
Seat 1: OvwYHV65yUbgdBjSmo1+5g (small blind) folded before Flop
Seat 2: RqgF7gRoKgRNW8Zoi1ty4A (big blind) folded before Flop
Seat 3: 8oS5O7iD/qnFXFXJrGIgNQ folded on the Flop
Seat 5: r1/R7y0Ortgoz4lccgW8VA collected ($7.15)
Seat 6: xAU6q2/cwmby2sxmA8VcmA (button) folded before Flop (didn't bet)



PokerStars Game #59940083686:  Hold'em No Limit ($0.50/$1.00) - 2009/07/01 0:56:49 ET
Table 'GxCPo/gd3OSthkYrAxJngg' 6-max Seat #4 is the button
Seat 1: sH8BpAFP+jGFxCgVpD1Lew ($262.65 in chips)
Seat 2: YExX2paeIHrmfIwV1ivM/w ($79.20 in chips)
Seat 3: o6plE+MSW4XFNTeONe16xg ($28.10 in chips)
Seat 4: YMJG+F++3Aj6P8dAWda5fw ($206.10 in chips)
Seat 5: G5ZSSN6RSON3gkNvk/SmYg ($105.75 in chips)
G5ZSSN6RSON3gkNvk/SmYg: posts small blind $0.50
sH8BpAFP+jGFxCgVpD1Lew: posts big blind $1
*** HOLE CARDS ***
YExX2paeIHrmfIwV1ivM/w: folds
o6plE+MSW4XFNTeONe16xg: folds
YMJG+F++3Aj6P8dAWda5fw: folds
G5ZSSN6RSON3gkNvk/SmYg: folds
sH8BpAFP+jGFxCgVpD1Lew collected $1 from pot
*** SUMMARY ***
Total pot $1 | Rake $0
Seat 1: sH8BpAFP+jGFxCgVpD1Lew (big blind) collected ($1)
Seat 2: YExX2paeIHrmfIwV1ivM/w folded before Flop (didn't bet)
Seat 3: o6plE+MSW4XFNTeONe16xg folded before Flop (didn't bet)
Seat 4: YMJG+F++3Aj6P8dAWda5fw (button) folded before Flop (didn't bet)
Seat 5: G5ZSSN6RSON3gkNvk/SmYg (small blind) folded before Flop



PokerStars Game #59940084130:  Hold'em No Limit ($0.50/$1.00) - 2009/07/01 0:56:50 ET
Table '+cA8mcmhaedZ7YcrDdhmeQ' 6-max Seat #2 is the button
Seat 1: lsLuWlcPA3Rh7kJVLzMh0Q ($286 in chips)
Seat 2: RqgF7gRoKgRNW8Zoi1ty4A ($105.95 in chips)
Seat 3: 7H5WkGzGvsv56y1iaqHvRg ($45.85 in chips)
Seat 4: 4OO5v3AVduL0tePNx8wk5A ($100 in chips)
Seat 5: +7hFKAL0b0O/n8G72TclJA ($62.65 in chips)
Seat 6: YfsTQsY/fxb+YqbdclTHuw ($27.45 in chips)
7H5WkGzGvsv56y1iaqHvRg: posts small blind $0.50
4OO5v3AVduL0tePNx8wk5A: posts big blind $1
*** HOLE CARDS ***
+7hFKAL0b0O/n8G72TclJA: folds
YfsTQsY/fxb+YqbdclTHuw: folds
lsLuWlcPA3Rh7kJVLzMh0Q: raises $2 to $3
RqgF7gRoKgRNW8Zoi1ty4A: folds
7H5WkGzGvsv56y1iaqHvRg: calls $2.50
4OO5v3AVduL0tePNx8wk5A: folds
*** FLOP *** [7c 4s As]
7H5WkGzGvsv56y1iaqHvRg: checks
lsLuWlcPA3Rh7kJVLzMh0Q: bets $5
7H5WkGzGvsv56y1iaqHvRg: calls $5
*** TURN *** [7c 4s As] [2s]
7H5WkGzGvsv56y1iaqHvRg: checks
lsLuWlcPA3Rh7kJVLzMh0Q: checks
*** RIVER *** [7c 4s As 2s] [7h]
7H5WkGzGvsv56y1iaqHvRg: bets $7
lsLuWlcPA3Rh7kJVLzMh0Q: calls $7
*** SHOW DOWN ***
7H5WkGzGvsv56y1iaqHvRg: shows [9s 9d] (two pair, Nines and Sevens)
lsLuWlcPA3Rh7kJVLzMh0Q: shows [Js Ah] (two pair, Aces and Sevens)
lsLuWlcPA3Rh7kJVLzMh0Q collected $29.50 from pot
*** SUMMARY ***
Total pot $31 | Rake $1.50
Board [7c 4s As 2s 7h]
Seat 1: lsLuWlcPA3Rh7kJVLzMh0Q showed [Js Ah] and won ($29.50) with two pair, Aces and Sevens
Seat 2: RqgF7gRoKgRNW8Zoi1ty4A (button) folded before Flop (didn't bet)
Seat 3: 7H5WkGzGvsv56y1iaqHvRg (small blind) showed [9s 9d] and lost with two pair, Nines and Sevens
Seat 4: 4OO5v3AVduL0tePNx8wk5A (big blind) folded before Flop
Seat 5: +7hFKAL0b0O/n8G72TclJA folded before Flop (didn't bet)
Seat 6: YfsTQsY/fxb+YqbdclTHuw folded before Flop (didn't bet)



PokerStars Game #59940084514:  Hold'em No Limit ($0.50/$1.00) - 2009/07/01 0:56:51 ET
Table '8jIjWCPY0NGprquL+xcMFg' 9-max Seat #6 is the button
Seat 1: vR4IO10geOgvTW+LAUBv/A ($136.05 in chips)
Seat 2: laA8va+Yv8WuMqT1zdR91g ($106.05 in chips)
Seat 3: tjhwe1V98x2spSoUQER3HQ ($104.50 in chips)
Seat 4: Jjc7EHWzs4//xUAjJ0UWoA ($18.50 in chips)
Seat 5: 2YpnxJiexJHyERfbqgwEcw ($85.55 in chips)
Seat 6: GTQkFJtSkbVbnGCktp6e3g ($101.35 in chips)
Seat 7: O3CGPwwUmamrCNHccOilrg ($45.95 in chips)
Seat 8: D+W9Me7w6Hcx/WRUSKV0dw ($20 in chips)
Seat 9: negfosHnGOZXSHpWDRKyBQ ($23 in chips)
O3CGPwwUmamrCNHccOilrg: posts small blind $0.50
D+W9Me7w6Hcx/WRUSKV0dw: posts big blind $1
*** HOLE CARDS ***
negfosHnGOZXSHpWDRKyBQ: folds
vR4IO10geOgvTW+LAUBv/A: folds
laA8va+Yv8WuMqT1zdR91g: folds
tjhwe1V98x2spSoUQER3HQ: folds
Jjc7EHWzs4//xUAjJ0UWoA: calls $1
2YpnxJiexJHyERfbqgwEcw: folds
GTQkFJtSkbVbnGCktp6e3g: folds
O3CGPwwUmamrCNHccOilrg: folds
D+W9Me7w6Hcx/WRUSKV0dw: checks
*** FLOP *** [6d Ac 2s]
D+W9Me7w6Hcx/WRUSKV0dw: checks
Jjc7EHWzs4//xUAjJ0UWoA: bets $2
D+W9Me7w6Hcx/WRUSKV0dw: folds
Jjc7EHWzs4//xUAjJ0UWoA collected $2.40 from pot
*** SUMMARY ***
Total pot $2.50 | Rake $0.10
Board [6d Ac 2s]
Seat 1: vR4IO10geOgvTW+LAUBv/A folded before Flop (didn't bet)
Seat 2: laA8va+Yv8WuMqT1zdR91g folded before Flop (didn't bet)
Seat 3: tjhwe1V98x2spSoUQER3HQ folded before Flop (didn't bet)
Seat 4: Jjc7EHWzs4//xUAjJ0UWoA collected ($2.40)
Seat 5: 2YpnxJiexJHyERfbqgwEcw folded before Flop (didn't bet)
Seat 6: GTQkFJtSkbVbnGCktp6e3g (button) folded before Flop (didn't bet)
Seat 7: O3CGPwwUmamrCNHccOilrg (small blind) folded before Flop
Seat 8: D+W9Me7w6Hcx/WRUSKV0dw (big blind) folded on the Flop
Seat 9: negfosHnGOZXSHpWDRKyBQ folded before Flop (didn't bet)



PokerStars Game #59940085724:  Hold'em No Limit ($0.50/$1.00) - 2009/07/01 0:56:53 ET
Table 'JOIm/fogLA7vSG0Vc6ME1A' 2-max Seat #1 is the button
Seat 1: NYi6JFscYNrofSXy4sM+Yw ($162.70 in chips)
Seat 2: F5lNTyZLIX9W2wQZ0plwgg ($88.10 in chips)
NYi6JFscYNrofSXy4sM+Yw: posts small blind $0.50
F5lNTyZLIX9W2wQZ0plwgg: posts big blind $1
*** HOLE CARDS ***
NYi6JFscYNrofSXy4sM+Yw: raises $2 to $3
F5lNTyZLIX9W2wQZ0plwgg: calls $2
*** FLOP *** [4h Ks 5s]
F5lNTyZLIX9W2wQZ0plwgg: bets $3
NYi6JFscYNrofSXy4sM+Yw: folds
F5lNTyZLIX9W2wQZ0plwgg collected $5.70 from pot
F5lNTyZLIX9W2wQZ0plwgg: doesn't show hand
*** SUMMARY ***
Total pot $6 | Rake $0.30
Board [4h Ks 5s]
Seat 1: NYi6JFscYNrofSXy4sM+Yw (button) (small blind) folded on the Flop
Seat 2: F5lNTyZLIX9W2wQZ0plwgg (big blind) collected ($5.70)



PokerStars Game #59940086588:  Hold'em No Limit ($0.50/$1.00) - 2009/07/01 0:56:54 ET
Table 'vs/5jr6ciwjVQ5+Soc+u2A' 6-max Seat #5 is the button
Seat 1: /P4w1pHg2zHYg/4ubJ0dPw ($60 in chips)
Seat 2: XOIf9W+VAxhZqN+SYoyMKA ($117.35 in chips)
Seat 3: G5ZSSN6RSON3gkNvk/SmYg ($141.85 in chips)
Seat 4: wk6Ohn4GDozoOMHc4eb2rw ($56.65 in chips)
Seat 5: 2DwLxMUbmzvwY7o4/i47Xg ($31.80 in chips)
/P4w1pHg2zHYg/4ubJ0dPw: posts small blind $0.50
XOIf9W+VAxhZqN+SYoyMKA: posts big blind $1
*** HOLE CARDS ***
G5ZSSN6RSON3gkNvk/SmYg: folds
wk6Ohn4GDozoOMHc4eb2rw: raises $3 to $4
2DwLxMUbmzvwY7o4/i47Xg: raises $6 to $10
/P4w1pHg2zHYg/4ubJ0dPw: folds
XOIf9W+VAxhZqN+SYoyMKA: folds
wk6Ohn4GDozoOMHc4eb2rw: raises $6 to $16
2DwLxMUbmzvwY7o4/i47Xg: raises $6 to $22
wk6Ohn4GDozoOMHc4eb2rw: raises $34.65 to $56.65 and is all-in
2DwLxMUbmzvwY7o4/i47Xg: calls $9.80 and is all-in
*** FLOP *** [Ac 9c 9d]
*** TURN *** [Ac 9c 9d] [7d]
*** RIVER *** [Ac 9c 9d 7d] [Kc]
*** SHOW DOWN ***
wk6Ohn4GDozoOMHc4eb2rw: shows [Kh Kd] (a full house, Kings full of Nines)
2DwLxMUbmzvwY7o4/i47Xg: mucks hand
wk6Ohn4GDozoOMHc4eb2rw collected $63.10 from pot
*** SUMMARY ***
Total pot $65.10 | Rake $2
Board [Ac 9c 9d 7d Kc]
Seat 1: /P4w1pHg2zHYg/4ubJ0dPw (small blind) folded before Flop
Seat 2: XOIf9W+VAxhZqN+SYoyMKA (big blind) folded before Flop
Seat 3: G5ZSSN6RSON3gkNvk/SmYg folded before Flop (didn't bet)
Seat 4: wk6Ohn4GDozoOMHc4eb2rw showed [Kh Kd] and won ($63.10) with a full house, Kings full of Nines
Seat 5: 2DwLxMUbmzvwY7o4/i47Xg (button) mucked



PokerStars Game #59940087180:  Hold'em No Limit ($0.50/$1.00) - 2009/07/01 0:56:55 ET
Table 'hugOjcwJvzEwZbK7tyiWuQ' 9-max Seat #8 is the button
Seat 1: D+W9Me7w6Hcx/WRUSKV0dw ($19 in chips)
Seat 2: r27C1nIV4NS4+qbnrgBQSw ($262.50 in chips)
Seat 3: jDwhY1kCdc6EkAHbT7PJMQ ($102.15 in chips)
Seat 4: UWB3oeddt/GObx2Mix2Anw ($204.25 in chips)
Seat 5: 5BRGWf+R3nt2WS3b5xX+zA ($24.20 in chips)
Seat 6: gUUvmqdVlmvpal6B8nYrmg ($107.40 in chips)
Seat 7: FL3MrLspcF23LYvC4ipBOA ($111.80 in chips)
Seat 8: /zy+DB4S5fUQUSfZWFzYGw ($101 in chips)
D+W9Me7w6Hcx/WRUSKV0dw: posts small blind $0.50
r27C1nIV4NS4+qbnrgBQSw: posts big blind $1
*** HOLE CARDS ***
jDwhY1kCdc6EkAHbT7PJMQ: folds
UWB3oeddt/GObx2Mix2Anw: folds
5BRGWf+R3nt2WS3b5xX+zA: folds
gUUvmqdVlmvpal6B8nYrmg: raises $1 to $2
FL3MrLspcF23LYvC4ipBOA: folds
/zy+DB4S5fUQUSfZWFzYGw: folds
D+W9Me7w6Hcx/WRUSKV0dw: folds
r27C1nIV4NS4+qbnrgBQSw: folds
gUUvmqdVlmvpal6B8nYrmg collected $2.50 from pot
*** SUMMARY ***
Total pot $2.50 | Rake $0
Seat 1: D+W9Me7w6Hcx/WRUSKV0dw (small blind) folded before Flop
Seat 2: r27C1nIV4NS4+qbnrgBQSw (big blind) folded before Flop
Seat 3: jDwhY1kCdc6EkAHbT7PJMQ folded before Flop (didn't bet)
Seat 4: UWB3oeddt/GObx2Mix2Anw folded before Flop (didn't bet)
Seat 5: 5BRGWf+R3nt2WS3b5xX+zA folded before Flop (didn't bet)
Seat 6: gUUvmqdVlmvpal6B8nYrmg collected ($2.50)
Seat 7: FL3MrLspcF23LYvC4ipBOA folded before Flop (didn't bet)
Seat 8: /zy+DB4S5fUQUSfZWFzYGw (button) folded before Flop (didn't bet)



PokerStars Game #59940087642:  Hold'em No Limit ($0.50/$1.00) - 2009/07/01 0:56:56 ET
Table 'rmZfTK+oSebeUPJNbWhdAA' 6-max Seat #3 is the button
Seat 1: xAU6q2/cwmby2sxmA8VcmA ($148 in chips)
Seat 2: z7O9PO/WEcqRouIydFhS9Q ($78.45 in chips)
Seat 3: BCEV3COoKY607AzLWayfRA ($98.50 in chips)
Seat 4: 1/mIuXfgx1ZyVkodrmfQDw ($100 in chips)
Seat 5: 5lY8d6Cnm4HUkt/8FZSj4g ($112.60 in chips)
Seat 6: j7NIOHLZk7V2o9fOioO5ug ($119.80 in chips)
1/mIuXfgx1ZyVkodrmfQDw: posts small blind $0.50
5lY8d6Cnm4HUkt/8FZSj4g: posts big blind $1
*** HOLE CARDS ***
j7NIOHLZk7V2o9fOioO5ug: folds
xAU6q2/cwmby2sxmA8VcmA: folds
z7O9PO/WEcqRouIydFhS9Q: raises $2 to $3
BCEV3COoKY607AzLWayfRA: calls $3
1/mIuXfgx1ZyVkodrmfQDw: raises $11 to $14
5lY8d6Cnm4HUkt/8FZSj4g: folds
z7O9PO/WEcqRouIydFhS9Q: folds
BCEV3COoKY607AzLWayfRA: calls $11
*** FLOP *** [Qh Jc 2c]
1/mIuXfgx1ZyVkodrmfQDw: bets $22
BCEV3COoKY607AzLWayfRA: raises $22 to $44
1/mIuXfgx1ZyVkodrmfQDw: folds
BCEV3COoKY607AzLWayfRA collected $73 from pot
BCEV3COoKY607AzLWayfRA: doesn't show hand
*** SUMMARY ***
Total pot $76 | Rake $3
Board [Qh Jc 2c]
Seat 1: xAU6q2/cwmby2sxmA8VcmA folded before Flop (didn't bet)
Seat 2: z7O9PO/WEcqRouIydFhS9Q folded before Flop
Seat 3: BCEV3COoKY607AzLWayfRA (button) collected ($73)
Seat 4: 1/mIuXfgx1ZyVkodrmfQDw (small blind) folded on the Flop
Seat 5: 5lY8d6Cnm4HUkt/8FZSj4g (big blind) folded before Flop
Seat 6: j7NIOHLZk7V2o9fOioO5ug folded before Flop (didn't bet)



PokerStars Game #59940088756:  Hold'em No Limit ($0.50/$1.00) - 2009/07/01 0:56:57 ET
Table 'LmXQK9xy3awB+qsPzI21Mw' 2-max Seat #1 is the button
Seat 1: NYi6JFscYNrofSXy4sM+Yw ($309.25 in chips)
Seat 2: TME8GvochpQAo8cmJwWmvA ($81.05 in chips)
NYi6JFscYNrofSXy4sM+Yw: posts small blind $0.50
TME8GvochpQAo8cmJwWmvA: posts big blind $1
*** HOLE CARDS ***
NYi6JFscYNrofSXy4sM+Yw: raises $2 to $3
TME8GvochpQAo8cmJwWmvA: calls $2
*** FLOP *** [8s 4c Th]
TME8GvochpQAo8cmJwWmvA: checks
NYi6JFscYNrofSXy4sM+Yw: bets $3
TME8GvochpQAo8cmJwWmvA: calls $3
*** TURN *** [8s 4c Th] [6c]
TME8GvochpQAo8cmJwWmvA: checks
NYi6JFscYNrofSXy4sM+Yw: bets $8.50
TME8GvochpQAo8cmJwWmvA: calls $8.50
*** RIVER *** [8s 4c Th 6c] [7c]
TME8GvochpQAo8cmJwWmvA: checks
NYi6JFscYNrofSXy4sM+Yw: checks
*** SHOW DOWN ***
TME8GvochpQAo8cmJwWmvA: shows [5d 5c] (a straight, Four to Eight)
NYi6JFscYNrofSXy4sM+Yw: mucks hand
TME8GvochpQAo8cmJwWmvA collected $28.50 from pot
*** SUMMARY ***
Total pot $29 | Rake $0.50
Board [8s 4c Th 6c 7c]
Seat 1: NYi6JFscYNrofSXy4sM+Yw (button) (small blind) mucked
Seat 2: TME8GvochpQAo8cmJwWmvA (big blind) showed [5d 5c] and won ($28.50) with a straight, Four to Eight



PokerStars Game #59940089068:  Hold'em No Limit ($0.50/$1.00) - 2009/07/01 0:56:58 ET
Table 'W/wyObTiXZm+Ckkl3YxcSw' 6-max Seat #5 is the button
Seat 1: eUBBn2R56C1IQ6Cs/vitwg ($104.90 in chips)
Seat 2: oDiBRCaF0QVtd3kO6xZIXw ($103.45 in chips)
Seat 3: dxyNCn/qxfkGDUIf28Cbng ($86.90 in chips)
Seat 5: BdbmJTZZ47quA9vUWwXtlw ($64.35 in chips)
Seat 6: tS9JHB1h+FQ++qu8RwRNgg ($38.80 in chips)
tS9JHB1h+FQ++qu8RwRNgg: posts small blind $0.50
eUBBn2R56C1IQ6Cs/vitwg: posts big blind $1
dxyNCn/qxfkGDUIf28Cbng: posts big blind $1
*** HOLE CARDS ***
oDiBRCaF0QVtd3kO6xZIXw: folds
dxyNCn/qxfkGDUIf28Cbng: checks
BdbmJTZZ47quA9vUWwXtlw: folds
tS9JHB1h+FQ++qu8RwRNgg: raises $3 to $4
eUBBn2R56C1IQ6Cs/vitwg: folds
dxyNCn/qxfkGDUIf28Cbng: folds
tS9JHB1h+FQ++qu8RwRNgg collected $3 from pot
tS9JHB1h+FQ++qu8RwRNgg: doesn't show hand
*** SUMMARY ***
Total pot $3 | Rake $0
Seat 1: eUBBn2R56C1IQ6Cs/vitwg (big blind) folded before Flop
Seat 2: oDiBRCaF0QVtd3kO6xZIXw folded before Flop (didn't bet)
Seat 3: dxyNCn/qxfkGDUIf28Cbng folded before Flop
Seat 5: BdbmJTZZ47quA9vUWwXtlw (button) folded before Flop (didn't bet)
Seat 6: tS9JHB1h+FQ++qu8RwRNgg (small blind) collected ($3)



PokerStars Game #59940090902:  Hold'em No Limit ($0.50/$1.00) - 2009/07/01 0:57:01 ET
Table 'U9zqzC8f3oTJ2ShXFgSSOA' 6-max Seat #3 is the button
Seat 1: iHo1oDbrEVJ8nEGdaPrICw ($105.40 in chips)
Seat 2: TSuRyAHnUPCFjP7Z0rEE0w ($100 in chips)
Seat 3: yfXek8iJ7O4CFyqXrtGcfg ($16.35 in chips)
Seat 5: KfwW5us6tydK81NYTtK1gw ($296.45 in chips)
Seat 6: 4OO5v3AVduL0tePNx8wk5A ($119.20 in chips)
KfwW5us6tydK81NYTtK1gw: posts small blind $0.50
4OO5v3AVduL0tePNx8wk5A: posts big blind $1
*** HOLE CARDS ***
iHo1oDbrEVJ8nEGdaPrICw: folds
TSuRyAHnUPCFjP7Z0rEE0w: folds
yfXek8iJ7O4CFyqXrtGcfg: folds
KfwW5us6tydK81NYTtK1gw: raises $1 to $2
4OO5v3AVduL0tePNx8wk5A: folds
KfwW5us6tydK81NYTtK1gw collected $2 from pot
KfwW5us6tydK81NYTtK1gw: doesn't show hand
*** SUMMARY ***
Total pot $2 | Rake $0
Seat 1: iHo1oDbrEVJ8nEGdaPrICw folded before Flop (didn't bet)
Seat 2: TSuRyAHnUPCFjP7Z0rEE0w folded before Flop (didn't bet)
Seat 3: yfXek8iJ7O4CFyqXrtGcfg (button) folded before Flop (didn't bet)
Seat 5: KfwW5us6tydK81NYTtK1gw (small blind) collected ($2)
Seat 6: 4OO5v3AVduL0tePNx8wk5A (big blind) folded before Flop



PokerStars Game #59940091098:  Hold'em No Limit ($0.50/$1.00) - 2009/07/01 0:57:01 ET
Table '6YvsYDPNIDx2v5z3bJnwZQ' 9-max Seat #1 is the button
Seat 1: Ogn4JDV3mp4ZDKO49IFzKA ($18.20 in chips)
Seat 3: negfosHnGOZXSHpWDRKyBQ ($17 in chips)
Seat 4: kEr5NYB+JIG5+szcYMr6hA ($38.25 in chips)
Seat 5: mBRWbnUl8diyBO1qTJaNzw ($165.20 in chips)
Seat 6: 7RSwrjMohkYrZAhOd1uaZg ($12 in chips)
Seat 7: mae7OMTaJ/MFimNbZegCkg ($52.30 in chips)
Seat 8: PSFxpXgPedVZyHSu2Zhb7Q ($109.30 in chips)
Seat 9: ZgMRSHJ9EOtPeVHmdeV9kQ ($50 in chips)
x80+i7DJL+81v3quj7KbNg: is sitting out
x80+i7DJL+81v3quj7KbNg leaves the table
negfosHnGOZXSHpWDRKyBQ: posts small blind $0.50
kEr5NYB+JIG5+szcYMr6hA: posts big blind $1
*** HOLE CARDS ***
mBRWbnUl8diyBO1qTJaNzw: folds
7RSwrjMohkYrZAhOd1uaZg: folds
mae7OMTaJ/MFimNbZegCkg: folds
PSFxpXgPedVZyHSu2Zhb7Q: raises $2 to $3
ZgMRSHJ9EOtPeVHmdeV9kQ: folds
Ogn4JDV3mp4ZDKO49IFzKA: folds
negfosHnGOZXSHpWDRKyBQ: folds
kEr5NYB+JIG5+szcYMr6hA: folds
+hHqYgKILitkxIzFNGvvsA joins the table at seat #2
PSFxpXgPedVZyHSu2Zhb7Q collected $2.50 from pot
*** SUMMARY ***
Total pot $2.50 | Rake $0
Seat 1: Ogn4JDV3mp4ZDKO49IFzKA (button) folded before Flop (didn't bet)
Seat 3: negfosHnGOZXSHpWDRKyBQ (small blind) folded before Flop
Seat 4: kEr5NYB+JIG5+szcYMr6hA (big blind) folded before Flop
Seat 5: mBRWbnUl8diyBO1qTJaNzw folded before Flop (didn't bet)
Seat 6: 7RSwrjMohkYrZAhOd1uaZg folded before Flop (didn't bet)
Seat 7: mae7OMTaJ/MFimNbZegCkg folded before Flop (didn't bet)
Seat 8: PSFxpXgPedVZyHSu2Zhb7Q collected ($2.50)
Seat 9: ZgMRSHJ9EOtPeVHmdeV9kQ folded before Flop (didn't bet)



PokerStars Game #59940090942:  Hold'em No Limit ($0.50/$1.00) - 2009/07/01 0:57:01 ET
Table 'fTlPiCj0utgzC/5io+I7ew' 6-max Seat #5 is the button
Seat 1: YMJG+F++3Aj6P8dAWda5fw ($93.50 in chips)
Seat 2: Qy/UBNbD2HaA0Ogxg8Sf3w ($128.35 in chips)
Seat 3: wL5HjWHHOSGc53xWMNKB9Q ($32.60 in chips)
Seat 4: uJVSceLggtsrJya+WtmUEA ($117.75 in chips)
Seat 5: bFrTkDcWGTxyvNul7GVdYg ($307.55 in chips)
Seat 6: /P4w1pHg2zHYg/4ubJ0dPw ($60 in chips)
/P4w1pHg2zHYg/4ubJ0dPw: posts small blind $0.50
YMJG+F++3Aj6P8dAWda5fw: posts big blind $1
*** HOLE CARDS ***
Qy/UBNbD2HaA0Ogxg8Sf3w: folds
wL5HjWHHOSGc53xWMNKB9Q: folds
uJVSceLggtsrJya+WtmUEA: raises $2 to $3
bFrTkDcWGTxyvNul7GVdYg: folds
/P4w1pHg2zHYg/4ubJ0dPw: folds
YMJG+F++3Aj6P8dAWda5fw: folds
uJVSceLggtsrJya+WtmUEA collected $2.50 from pot
*** SUMMARY ***
Total pot $2.50 | Rake $0
Seat 1: YMJG+F++3Aj6P8dAWda5fw (big blind) folded before Flop
Seat 2: Qy/UBNbD2HaA0Ogxg8Sf3w folded before Flop (didn't bet)
Seat 3: wL5HjWHHOSGc53xWMNKB9Q folded before Flop (didn't bet)
Seat 4: uJVSceLggtsrJya+WtmUEA collected ($2.50)
Seat 5: bFrTkDcWGTxyvNul7GVdYg (button) folded before Flop (didn't bet)
Seat 6: /P4w1pHg2zHYg/4ubJ0dPw (small blind) folded before Flop



PokerStars Game #59940091704:  Hold'em No Limit ($0.50/$1.00) - 2009/07/01 0:57:02 ET
Table 'VOs36P6NW+QyXeQ1B62kmA' 6-max Seat #3 is the button
Seat 1: AdLVjddOzm+sRNo1Bc3S6Q ($130.80 in chips)
Seat 2: 2UMlbaZ8n8AbRli0Yr0mDw ($19.90 in chips)
Seat 3: TSuRyAHnUPCFjP7Z0rEE0w ($106.40 in chips)
Seat 4: w02zQzNydODiyV9THKgo9w ($42 in chips)
Seat 5: ozrlafxxh1HmYdA0/h+MuA ($44.75 in chips)
w02zQzNydODiyV9THKgo9w: posts small blind $0.50
ozrlafxxh1HmYdA0/h+MuA: posts big blind $1
slVKuQyEz8Qj4E3uLPYNXg: sits out
*** HOLE CARDS ***
AdLVjddOzm+sRNo1Bc3S6Q: folds
2UMlbaZ8n8AbRli0Yr0mDw: raises $3 to $4
TSuRyAHnUPCFjP7Z0rEE0w: folds
w02zQzNydODiyV9THKgo9w: folds
ozrlafxxh1HmYdA0/h+MuA: calls $3
*** FLOP *** [3c 6h 7h]
ozrlafxxh1HmYdA0/h+MuA: checks
2UMlbaZ8n8AbRli0Yr0mDw: bets $8
ozrlafxxh1HmYdA0/h+MuA: calls $8
*** TURN *** [3c 6h 7h] [Qd]
ozrlafxxh1HmYdA0/h+MuA: checks
2UMlbaZ8n8AbRli0Yr0mDw: bets $7.90 and is all-in
ozrlafxxh1HmYdA0/h+MuA: calls $7.90
*** RIVER *** [3c 6h 7h Qd] [8h]
*** SHOW DOWN ***
ozrlafxxh1HmYdA0/h+MuA: shows [8d 9h] (a pair of Eights)
2UMlbaZ8n8AbRli0Yr0mDw: shows [Jd Jc] (a pair of Jacks)
2UMlbaZ8n8AbRli0Yr0mDw collected $38.35 from pot
*** SUMMARY ***
Total pot $40.30 | Rake $1.95
Board [3c 6h 7h Qd 8h]
Seat 1: AdLVjddOzm+sRNo1Bc3S6Q folded before Flop (didn't bet)
Seat 2: 2UMlbaZ8n8AbRli0Yr0mDw showed [Jd Jc] and won ($38.35) with a pair of Jacks
Seat 3: TSuRyAHnUPCFjP7Z0rEE0w (button) folded before Flop (didn't bet)
Seat 4: w02zQzNydODiyV9THKgo9w (small blind) folded before Flop
Seat 5: ozrlafxxh1HmYdA0/h+MuA (big blind) showed [8d 9h] and lost with a pair of Eights



PokerStars Game #59940092158:  Hold'em No Limit ($0.50/$1.00) - 2009/07/01 0:57:03 ET
Table 'eU3bWpDDg3Z+9R4m4iVmog' 6-max Seat #6 is the button
Seat 1: TSuRyAHnUPCFjP7Z0rEE0w ($191.65 in chips)
Seat 2: 8CAoOzhmB8n3nRFf3V4BTg ($81.80 in chips)
Seat 4: GDVIsbEJ/DOJsMKE4Asz0A ($88.60 in chips)
Seat 5: AdLVjddOzm+sRNo1Bc3S6Q ($101.50 in chips)
Seat 6: hpxXcmRkXXI9HE5+5/j/0Q ($120.10 in chips)
TSuRyAHnUPCFjP7Z0rEE0w: posts small blind $0.50
8CAoOzhmB8n3nRFf3V4BTg: posts big blind $1
rVMOzU7w5FddYPGhD7qN2Q: sits out
*** HOLE CARDS ***
GDVIsbEJ/DOJsMKE4Asz0A: folds
AdLVjddOzm+sRNo1Bc3S6Q: folds
hpxXcmRkXXI9HE5+5/j/0Q: folds
TSuRyAHnUPCFjP7Z0rEE0w: folds
8CAoOzhmB8n3nRFf3V4BTg collected $1 from pot
*** SUMMARY ***
Total pot $1 | Rake $0
Seat 1: TSuRyAHnUPCFjP7Z0rEE0w (small blind) folded before Flop
Seat 2: 8CAoOzhmB8n3nRFf3V4BTg (big blind) collected ($1)
Seat 4: GDVIsbEJ/DOJsMKE4Asz0A folded before Flop (didn't bet)
Seat 5: AdLVjddOzm+sRNo1Bc3S6Q folded before Flop (didn't bet)
Seat 6: hpxXcmRkXXI9HE5+5/j/0Q (button) folded before Flop (didn't bet)



PokerStars Game #59940092836:  Hold'em No Limit ($0.50/$1.00) - 2009/07/01 0:57:04 ET
Table 'Zka9tv1yilg0MvXWPQrShg' 9-max Seat #9 is the button
Seat 1: TZcz9MEWDA+WydgGruqqbw ($120.90 in chips)
Seat 2: kz9ziSiGUc+857heiKSayw ($17 in chips)
Seat 3: gUUvmqdVlmvpal6B8nYrmg ($106.80 in chips)
Seat 4: stxmTgSicxShtrDxhOOX2g ($69.65 in chips)
Seat 5: /zy+DB4S5fUQUSfZWFzYGw ($123.40 in chips)
Seat 6: rY8wPoax1lS+HUY+I0FZDw ($142.95 in chips)
Seat 7: p1SafS90nb3Uft5LB0NkHw ($20.50 in chips)
Seat 9: 6daxhj43mWj04MOPTOmaYA ($94 in chips)
TZcz9MEWDA+WydgGruqqbw: posts small blind $0.50
kz9ziSiGUc+857heiKSayw: posts big blind $1
D+W9Me7w6Hcx/WRUSKV0dw: sits out
*** HOLE CARDS ***
gUUvmqdVlmvpal6B8nYrmg: raises $1 to $2
stxmTgSicxShtrDxhOOX2g: folds
/zy+DB4S5fUQUSfZWFzYGw: folds
rY8wPoax1lS+HUY+I0FZDw: calls $2
p1SafS90nb3Uft5LB0NkHw: folds
6daxhj43mWj04MOPTOmaYA: folds
TZcz9MEWDA+WydgGruqqbw: folds
kz9ziSiGUc+857heiKSayw: calls $1
*** FLOP *** [8d Jd 4d]
kz9ziSiGUc+857heiKSayw: checks
gUUvmqdVlmvpal6B8nYrmg: checks
rY8wPoax1lS+HUY+I0FZDw: bets $3
kz9ziSiGUc+857heiKSayw: calls $3
gUUvmqdVlmvpal6B8nYrmg: folds
*** TURN *** [8d Jd 4d] [6c]
kz9ziSiGUc+857heiKSayw: bets $12 and is all-in
rY8wPoax1lS+HUY+I0FZDw: calls $12
*** RIVER *** [8d Jd 4d 6c] [Kc]
*** SHOW DOWN ***
kz9ziSiGUc+857heiKSayw: shows [Js 6s] (two pair, Jacks and Sixes)
rY8wPoax1lS+HUY+I0FZDw: shows [9d 6d] (a flush, Jack high)
rY8wPoax1lS+HUY+I0FZDw collected $34.75 from pot
*** SUMMARY ***
Total pot $36.50 | Rake $1.75
Board [8d Jd 4d 6c Kc]
Seat 1: TZcz9MEWDA+WydgGruqqbw (small blind) folded before Flop
Seat 2: kz9ziSiGUc+857heiKSayw (big blind) showed [Js 6s] and lost with two pair, Jacks and Sixes
Seat 3: gUUvmqdVlmvpal6B8nYrmg folded on the Flop
Seat 4: stxmTgSicxShtrDxhOOX2g folded before Flop (didn't bet)
Seat 5: /zy+DB4S5fUQUSfZWFzYGw folded before Flop (didn't bet)
Seat 6: rY8wPoax1lS+HUY+I0FZDw showed [9d 6d] and won ($34.75) with a flush, Jack high
Seat 7: p1SafS90nb3Uft5LB0NkHw folded before Flop (didn't bet)
Seat 9: 6daxhj43mWj04MOPTOmaYA (button) folded before Flop (didn't bet)



PokerStars Game #59940092778:  Hold'em No Limit ($0.50/$1.00) - 2009/07/01 0:57:04 ET
Table 'uNlePsyMIqzM691Xkrlk6Q' 9-max Seat #4 is the button
Seat 1: bLbSOSmSOnqE0iTcH/5dxA ($100 in chips)
Seat 2: +OqpStnt0FqbCfyHAWaLbg ($100.15 in chips)
Seat 3: h7qXkU57Bb8ZuPwMyxR8Ug ($16.15 in chips)
Seat 4: TZcz9MEWDA+WydgGruqqbw ($101.15 in chips)
Seat 5: 3obndzTJ6fECz8+wWhMd1w ($17.50 in chips)
Seat 6: myIxN7otsyr846M539YR8Q ($18.50 in chips)
Seat 7: w6cw9nzN7AvkkHBVVjykoQ ($55.75 in chips)
Seat 8: laA8va+Yv8WuMqT1zdR91g ($101 in chips)
Seat 9: vR4IO10geOgvTW+LAUBv/A ($100 in chips)
3obndzTJ6fECz8+wWhMd1w: posts small blind $0.50
myIxN7otsyr846M539YR8Q: posts big blind $1
*** HOLE CARDS ***
w6cw9nzN7AvkkHBVVjykoQ: folds
laA8va+Yv8WuMqT1zdR91g: folds
vR4IO10geOgvTW+LAUBv/A: raises $2 to $3
bLbSOSmSOnqE0iTcH/5dxA: folds
+OqpStnt0FqbCfyHAWaLbg: folds
h7qXkU57Bb8ZuPwMyxR8Ug: folds
TZcz9MEWDA+WydgGruqqbw: folds
3obndzTJ6fECz8+wWhMd1w: folds
myIxN7otsyr846M539YR8Q: folds
vR4IO10geOgvTW+LAUBv/A collected $2.50 from pot
vR4IO10geOgvTW+LAUBv/A: doesn't show hand
*** SUMMARY ***
Total pot $2.50 | Rake $0
Seat 1: bLbSOSmSOnqE0iTcH/5dxA folded before Flop (didn't bet)
Seat 2: +OqpStnt0FqbCfyHAWaLbg folded before Flop (didn't bet)
Seat 3: h7qXkU57Bb8ZuPwMyxR8Ug folded before Flop (didn't bet)
Seat 4: TZcz9MEWDA+WydgGruqqbw (button) folded before Flop (didn't bet)
Seat 5: 3obndzTJ6fECz8+wWhMd1w (small blind) folded before Flop
Seat 6: myIxN7otsyr846M539YR8Q (big blind) folded before Flop
Seat 7: w6cw9nzN7AvkkHBVVjykoQ folded before Flop (didn't bet)
Seat 8: laA8va+Yv8WuMqT1zdR91g folded before Flop (didn't bet)
Seat 9: vR4IO10geOgvTW+LAUBv/A collected ($2.50)



PokerStars Game #59940093220:  Hold'em No Limit ($0.50/$1.00) - 2009/07/01 0:57:05 ET
Table 'JOIm/fogLA7vSG0Vc6ME1A' 2-max Seat #2 is the button
Seat 1: NYi6JFscYNrofSXy4sM+Yw ($159.70 in chips)
Seat 2: F5lNTyZLIX9W2wQZ0plwgg ($90.80 in chips)
F5lNTyZLIX9W2wQZ0plwgg: posts small blind $0.50
NYi6JFscYNrofSXy4sM+Yw: posts big blind $1
*** HOLE CARDS ***
F5lNTyZLIX9W2wQZ0plwgg: raises $3 to $4
NYi6JFscYNrofSXy4sM+Yw: calls $3
*** FLOP *** [Ac Tc 3c]
NYi6JFscYNrofSXy4sM+Yw: bets $4
F5lNTyZLIX9W2wQZ0plwgg: calls $4
*** TURN *** [Ac Tc 3c] [8s]
NYi6JFscYNrofSXy4sM+Yw: checks
F5lNTyZLIX9W2wQZ0plwgg: checks
*** RIVER *** [Ac Tc 3c 8s] [5s]
NYi6JFscYNrofSXy4sM+Yw: checks
F5lNTyZLIX9W2wQZ0plwgg: checks
*** SHOW DOWN ***
NYi6JFscYNrofSXy4sM+Yw: shows [Jd Ts] (a pair of Tens)
F5lNTyZLIX9W2wQZ0plwgg: shows [2h Ad] (a pair of Aces)
F5lNTyZLIX9W2wQZ0plwgg collected $15.50 from pot
*** SUMMARY ***
Total pot $16 | Rake $0.50
Board [Ac Tc 3c 8s 5s]
Seat 1: NYi6JFscYNrofSXy4sM+Yw (big blind) showed [Jd Ts] and lost with a pair of Tens
Seat 2: F5lNTyZLIX9W2wQZ0plwgg (button) (small blind) showed [2h Ad] and won ($15.50) with a pair of Aces



PokerStars Game #59940094314:  Hold'em No Limit ($0.50/$1.00) - 2009/07/01 0:57:06 ET
Table 'iSx0wTgVb4o7MyZeOe06ZA' 9-max Seat #3 is the button
Seat 2: myIxN7otsyr846M539YR8Q ($20 in chips)
Seat 3: XQV7mCMbzd2Wh/l74wmbug ($82.15 in chips)
Seat 5: o1axyw4AjQ8n4ubTwlirQQ ($22.50 in chips)
Seat 6: T5/PXFS/W+LLcIXBo1G/RA ($96.15 in chips)
Seat 7: w4NnqVr/Sfoj65ux/fEUyQ ($79.40 in chips)
Seat 8: gUUvmqdVlmvpal6B8nYrmg ($100 in chips)
Seat 9: DMQXVuViR4IFzRccosBkJw ($79.05 in chips)
0fXz44fzDo5QmhAaJCvFfA will be allowed to play after the button
o1axyw4AjQ8n4ubTwlirQQ: posts small blind $0.50
T5/PXFS/W+LLcIXBo1G/RA: posts big blind $1
VPF+HjszMvUIpy0CHIwH3A: sits out
*** HOLE CARDS ***
w4NnqVr/Sfoj65ux/fEUyQ: folds
gUUvmqdVlmvpal6B8nYrmg: folds
DMQXVuViR4IFzRccosBkJw: raises $3 to $4
myIxN7otsyr846M539YR8Q: folds
XQV7mCMbzd2Wh/l74wmbug: folds
o1axyw4AjQ8n4ubTwlirQQ: folds
T5/PXFS/W+LLcIXBo1G/RA: calls $3
*** FLOP *** [Jh 3c Jd]
T5/PXFS/W+LLcIXBo1G/RA: checks
DMQXVuViR4IFzRccosBkJw: bets $6
T5/PXFS/W+LLcIXBo1G/RA: raises $9 to $15
DMQXVuViR4IFzRccosBkJw: folds
T5/PXFS/W+LLcIXBo1G/RA collected $19.50 from pot
*** SUMMARY ***
Total pot $20.50 | Rake $1
Board [Jh 3c Jd]
Seat 2: myIxN7otsyr846M539YR8Q folded before Flop (didn't bet)
Seat 3: XQV7mCMbzd2Wh/l74wmbug (button) folded before Flop (didn't bet)
Seat 5: o1axyw4AjQ8n4ubTwlirQQ (small blind) folded before Flop
Seat 6: T5/PXFS/W+LLcIXBo1G/RA (big blind) collected ($19.50)
Seat 7: w4NnqVr/Sfoj65ux/fEUyQ folded before Flop (didn't bet)
Seat 8: gUUvmqdVlmvpal6B8nYrmg folded before Flop (didn't bet)
Seat 9: DMQXVuViR4IFzRccosBkJw folded on the Flop



PokerStars Game #59940097450:  Hold'em No Limit ($0.50/$1.00) - 2009/07/01 0:57:11 ET
Table 'GxCPo/gd3OSthkYrAxJngg' 6-max Seat #5 is the button
Seat 1: sH8BpAFP+jGFxCgVpD1Lew ($263.15 in chips)
Seat 2: YExX2paeIHrmfIwV1ivM/w ($79.20 in chips)
Seat 3: o6plE+MSW4XFNTeONe16xg ($28.10 in chips)
Seat 4: YMJG+F++3Aj6P8dAWda5fw ($206.10 in chips)
Seat 5: G5ZSSN6RSON3gkNvk/SmYg ($105.25 in chips)
sH8BpAFP+jGFxCgVpD1Lew: posts small blind $0.50
YExX2paeIHrmfIwV1ivM/w: posts big blind $1
*** HOLE CARDS ***
o6plE+MSW4XFNTeONe16xg: folds
YMJG+F++3Aj6P8dAWda5fw: raises $2 to $3
G5ZSSN6RSON3gkNvk/SmYg: folds
sH8BpAFP+jGFxCgVpD1Lew: calls $2.50
YExX2paeIHrmfIwV1ivM/w: folds
*** FLOP *** [9d Jh Qs]
sH8BpAFP+jGFxCgVpD1Lew: bets $5
YMJG+F++3Aj6P8dAWda5fw: folds
sH8BpAFP+jGFxCgVpD1Lew collected $6.65 from pot
*** SUMMARY ***
Total pot $7 | Rake $0.35
Board [9d Jh Qs]
Seat 1: sH8BpAFP+jGFxCgVpD1Lew (small blind) collected ($6.65)
Seat 2: YExX2paeIHrmfIwV1ivM/w (big blind) folded before Flop
Seat 3: o6plE+MSW4XFNTeONe16xg folded before Flop (didn't bet)
Seat 4: YMJG+F++3Aj6P8dAWda5fw folded on the Flop
Seat 5: G5ZSSN6RSON3gkNvk/SmYg (button) folded before Flop (didn't bet)



PokerStars Game #59940099524:  Hold'em No Limit ($0.50/$1.00) - 2009/07/01 0:57:15 ET
Table 'MUPc8FEpe/nR0BKSeReX6Q' 6-max Seat #5 is the button
Seat 2: xAU6q2/cwmby2sxmA8VcmA ($105.10 in chips)
Seat 3: wx3sQGkVi2x9wJXuWNHPBw ($231.85 in chips)
Seat 4: ZA1bp6g8IwtTxkUE4eCjDQ ($189.35 in chips)
Seat 5: UBZQqpnJZdTYYY1FTb0rLA ($103.55 in chips)
Seat 6: oxnw0GLLpFanjhGkxfRSqA ($53.70 in chips)
oxnw0GLLpFanjhGkxfRSqA: posts small blind $0.50
xAU6q2/cwmby2sxmA8VcmA: posts big blind $1
*** HOLE CARDS ***
wx3sQGkVi2x9wJXuWNHPBw: folds
ZA1bp6g8IwtTxkUE4eCjDQ: folds
UBZQqpnJZdTYYY1FTb0rLA: folds
oxnw0GLLpFanjhGkxfRSqA: calls $0.50
xAU6q2/cwmby2sxmA8VcmA: checks
*** FLOP *** [Ad 7h Tc]
oxnw0GLLpFanjhGkxfRSqA: bets $1
xAU6q2/cwmby2sxmA8VcmA: raises $3 to $4
oxnw0GLLpFanjhGkxfRSqA: calls $3
*** TURN *** [Ad 7h Tc] [9c]
oxnw0GLLpFanjhGkxfRSqA: checks
xAU6q2/cwmby2sxmA8VcmA: bets $7
oxnw0GLLpFanjhGkxfRSqA: calls $7
*** RIVER *** [Ad 7h Tc 9c] [Th]
oxnw0GLLpFanjhGkxfRSqA: checks
xAU6q2/cwmby2sxmA8VcmA: bets $8
oxnw0GLLpFanjhGkxfRSqA: calls $8
*** SHOW DOWN ***
xAU6q2/cwmby2sxmA8VcmA: shows [Ah 9d] (two pair, Aces and Tens)
oxnw0GLLpFanjhGkxfRSqA: mucks hand
xAU6q2/cwmby2sxmA8VcmA collected $38.10 from pot
*** SUMMARY ***
Total pot $40 | Rake $1.90
Board [Ad 7h Tc 9c Th]
Seat 2: xAU6q2/cwmby2sxmA8VcmA (big blind) showed [Ah 9d] and won ($38.10) with two pair, Aces and Tens
Seat 3: wx3sQGkVi2x9wJXuWNHPBw folded before Flop (didn't bet)
Seat 4: ZA1bp6g8IwtTxkUE4eCjDQ folded before Flop (didn't bet)
Seat 5: UBZQqpnJZdTYYY1FTb0rLA (button) folded before Flop (didn't bet)
Seat 6: oxnw0GLLpFanjhGkxfRSqA (small blind) mucked



PokerStars Game #59940100408:  Hold'em No Limit ($0.50/$1.00) - 2009/07/01 0:57:16 ET
Table 'mmbQQVBTrPdE+wy+s+9VPA' 6-max Seat #6 is the button
Seat 3: wx3sQGkVi2x9wJXuWNHPBw ($114.15 in chips)
Seat 4: V3iZdcw61nXF3g5hD2RrsQ ($100 in chips)
Seat 5: YMJG+F++3Aj6P8dAWda5fw ($99.50 in chips)
Seat 6: U2CWBTv29qdCbj8RNF2sIw ($97 in chips)
zyP4SPoWZnKUfTvIRLCVog joins the table at seat #1
+W6OnF033KNM2xH0fGj98Q: is sitting out
+W6OnF033KNM2xH0fGj98Q leaves the table
wx3sQGkVi2x9wJXuWNHPBw: posts small blind $0.50
V3iZdcw61nXF3g5hD2RrsQ: posts big blind $1
*** HOLE CARDS ***
YMJG+F++3Aj6P8dAWda5fw: folds
U2CWBTv29qdCbj8RNF2sIw: raises $2 to $3
wx3sQGkVi2x9wJXuWNHPBw: folds
V3iZdcw61nXF3g5hD2RrsQ: folds
U2CWBTv29qdCbj8RNF2sIw collected $2.50 from pot
*** SUMMARY ***
Total pot $2.50 | Rake $0
Seat 3: wx3sQGkVi2x9wJXuWNHPBw (small blind) folded before Flop
Seat 4: V3iZdcw61nXF3g5hD2RrsQ (big blind) folded before Flop
Seat 5: YMJG+F++3Aj6P8dAWda5fw folded before Flop (didn't bet)
Seat 6: U2CWBTv29qdCbj8RNF2sIw (button) collected ($2.50)



PokerStars Game #59940100872:  Hold'em No Limit ($0.50/$1.00) - 2009/07/01 0:57:17 ET
Table 'tyUh+jyNvrceIQdKMJjQ2wZFWj23PMihdwrNWv41OG/Qeat #2 is the button
Seat 1: o8A5MUdudVKu+pAwgZOX2w ($173.20 in chips)
Seat 2: XvUbOIg94d25feWeQlOTVg ($151.20 in chips)
Seat 3: TalCiLYHCd+ffkmR3auPvA ($94.10 in chips)
Seat 4: TSuRyAHnUPCFjP7Z0rEE0w ($111.25 in chips)
Seat 5: j7NIOHLZk7V2o9fOioO5ug ($118.30 in chips)
TalCiLYHCd+ffkmR3auPvA: posts small blind $0.50
TSuRyAHnUPCFjP7Z0rEE0w: posts big blind $1
4OO5v3AVduL0tePNx8wk5A: sits out
*** HOLE CARDS ***
j7NIOHLZk7V2o9fOioO5ug: folds
o8A5MUdudVKu+pAwgZOX2w: calls $1
XvUbOIg94d25feWeQlOTVg: calls $1
TalCiLYHCd+ffkmR3auPvA: calls $0.50
TSuRyAHnUPCFjP7Z0rEE0w: checks
*** FLOP *** [4s Ts 9s]
TalCiLYHCd+ffkmR3auPvA: checks
TSuRyAHnUPCFjP7Z0rEE0w: checks
o8A5MUdudVKu+pAwgZOX2w: checks
XvUbOIg94d25feWeQlOTVg: bets $4
TalCiLYHCd+ffkmR3auPvA: folds
TSuRyAHnUPCFjP7Z0rEE0w: folds
o8A5MUdudVKu+pAwgZOX2w: folds
XvUbOIg94d25feWeQlOTVg collected $3.80 from pot
*** SUMMARY ***
Total pot $4 | Rake $0.20
Board [4s Ts 9s]
Seat 1: o8A5MUdudVKu+pAwgZOX2w folded on the Flop
Seat 2: XvUbOIg94d25feWeQlOTVg (button) collected ($3.80)
Seat 3: TalCiLYHCd+ffkmR3auPvA (small blind) folded on the Flop
Seat 4: TSuRyAHnUPCFjP7Z0rEE0w (big blind) folded on the Flop
Seat 5: j7NIOHLZk7V2o9fOioO5ug folded before Flop (didn't bet)



PokerStars Game #59940102464:  Hold'em No Limit ($0.50/$1.00) - 2009/07/01 0:57:19 ET
Table 'tJq9SfN1ywY0r03VBlWlwQ' 9-max Seat #9 is the button
Seat 1: wZsU+w9r7G66x93UuvBf1Q ($341.30 in chips)
Seat 2: RqkO8O/Y3qlc3PIuCAHjVg ($74.40 in chips)
Seat 3: FVs16t7GgfWgQWt4JxsObQ ($33.95 in chips)
Seat 4: bLbSOSmSOnqE0iTcH/5dxA ($110.20 in chips)
Seat 5: Ogn4JDV3mp4ZDKO49IFzKA ($17.25 in chips)
Seat 6: gUUvmqdVlmvpal6B8nYrmg ($120.05 in chips)
Seat 7: qVhRZ0PLZ95XRJHWAjXjOQ ($129.90 in chips)
Seat 8: G4DEhsZFmznGNVpy2SEocA ($22 in chips)
Seat 9: XE5QF1y74bpHog9JxWJMWQ ($102 in chips)
wZsU+w9r7G66x93UuvBf1Q: posts small blind $0.50
RqkO8O/Y3qlc3PIuCAHjVg: posts big blind $1
*** HOLE CARDS ***
FVs16t7GgfWgQWt4JxsObQ: calls $1
bLbSOSmSOnqE0iTcH/5dxA: folds
Ogn4JDV3mp4ZDKO49IFzKA: folds
gUUvmqdVlmvpal6B8nYrmg: raises $3 to $4
qVhRZ0PLZ95XRJHWAjXjOQ: folds
G4DEhsZFmznGNVpy2SEocA: folds
XE5QF1y74bpHog9JxWJMWQ: folds
wZsU+w9r7G66x93UuvBf1Q: folds
RqkO8O/Y3qlc3PIuCAHjVg: folds
FVs16t7GgfWgQWt4JxsObQ: calls $3
*** FLOP *** [Jh 6d 9d]
FVs16t7GgfWgQWt4JxsObQ: checks
gUUvmqdVlmvpal6B8nYrmg: checks
*** TURN *** [Jh 6d 9d] [5d]
FVs16t7GgfWgQWt4JxsObQ: checks
gUUvmqdVlmvpal6B8nYrmg: checks
*** RIVER *** [Jh 6d 9d 5d] [Js]
FVs16t7GgfWgQWt4JxsObQ: bets $3
gUUvmqdVlmvpal6B8nYrmg: folds
FVs16t7GgfWgQWt4JxsObQ collected $9.05 from pot
*** SUMMARY ***
Total pot $9.50 | Rake $0.45
Board [Jh 6d 9d 5d Js]
Seat 1: wZsU+w9r7G66x93UuvBf1Q (small blind) folded before Flop
Seat 2: RqkO8O/Y3qlc3PIuCAHjVg (big blind) folded before Flop
Seat 3: FVs16t7GgfWgQWt4JxsObQ collected ($9.05)
Seat 4: bLbSOSmSOnqE0iTcH/5dxA folded before Flop (didn't bet)
Seat 5: Ogn4JDV3mp4ZDKO49IFzKA folded before Flop (didn't bet)
Seat 6: gUUvmqdVlmvpal6B8nYrmg folded on the River
Seat 7: qVhRZ0PLZ95XRJHWAjXjOQ folded before Flop (didn't bet)
Seat 8: G4DEhsZFmznGNVpy2SEocA folded before Flop (didn't bet)
Seat 9: XE5QF1y74bpHog9JxWJMWQ (button) folded before Flop (didn't bet)



PokerStars Game #59940102124:  Hold'em No Limit ($0.50/$1.00) - 2009/07/01 0:57:19 ET
Table 'eU3bWpDDg3Z+9R4m4iVmog' 6-max Seat #1 is the button
Seat 1: TSuRyAHnUPCFjP7Z0rEE0w ($191.15 in chips)
Seat 2: 8CAoOzhmB8n3nRFf3V4BTg ($82.30 in chips)
Seat 3: rVMOzU7w5FddYPGhD7qN2Q ($48.25 in chips)
Seat 4: GDVIsbEJ/DOJsMKE4Asz0A ($88.60 in chips)
Seat 5: AdLVjddOzm+sRNo1Bc3S6Q ($101.50 in chips)
Seat 6: hpxXcmRkXXI9HE5+5/j/0Q ($120.10 in chips)
8CAoOzhmB8n3nRFf3V4BTg: posts small blind $0.50
rVMOzU7w5FddYPGhD7qN2Q: posts big blind $1
*** HOLE CARDS ***
GDVIsbEJ/DOJsMKE4Asz0A: folds
AdLVjddOzm+sRNo1Bc3S6Q has timed out
AdLVjddOzm+sRNo1Bc3S6Q: folds
AdLVjddOzm+sRNo1Bc3S6Q is sitting out
hpxXcmRkXXI9HE5+5/j/0Q: folds
TSuRyAHnUPCFjP7Z0rEE0w: folds
AdLVjddOzm+sRNo1Bc3S6Q leaves the table
8CAoOzhmB8n3nRFf3V4BTg: calls $0.50
rVMOzU7w5FddYPGhD7qN2Q: checks
*** FLOP *** [Kc Td 3d]
8CAoOzhmB8n3nRFf3V4BTg: checks
rVMOzU7w5FddYPGhD7qN2Q: bets $3
8CAoOzhmB8n3nRFf3V4BTg: folds
rVMOzU7w5FddYPGhD7qN2Q collected $1.90 from pot
*** SUMMARY ***
Total pot $2 | Rake $0.10
Board [Kc Td 3d]
Seat 1: TSuRyAHnUPCFjP7Z0rEE0w (button) folded before Flop (didn't bet)
Seat 2: 8CAoOzhmB8n3nRFf3V4BTg (small blind) folded on the Flop
Seat 3: rVMOzU7w5FddYPGhD7qN2Q (big blind) collected ($1.90)
Seat 4: GDVIsbEJ/DOJsMKE4Asz0A folded before Flop (didn't bet)
Seat 5: AdLVjddOzm+sRNo1Bc3S6Q folded before Flop (didn't bet)
Seat 6: hpxXcmRkXXI9HE5+5/j/0Q folded before Flop (didn't bet)



PokerStars Game #59940102870:  Hold'em No Limit ($0.50/$1.00) - 2009/07/01 0:57:20 ET
Table 'LmXQK9xy3awB+qsPzI21Mw' 2-max Seat #2 is the button
Seat 1: NYi6JFscYNrofSXy4sM+Yw ($294.75 in chips)
Seat 2: TME8GvochpQAo8cmJwWmvA ($95.05 in chips)
TME8GvochpQAo8cmJwWmvA: posts small blind $0.50
NYi6JFscYNrofSXy4sM+Yw: posts big blind $1
*** HOLE CARDS ***
TME8GvochpQAo8cmJwWmvA: folds
NYi6JFscYNrofSXy4sM+Yw collected $1 from pot
*** SUMMARY ***
Total pot $1 | Rake $0
Seat 1: NYi6JFscYNrofSXy4sM+Yw (big blind) collected ($1)
Seat 2: TME8GvochpQAo8cmJwWmvA (button) (small blind) folded before Flop



PokerStars Game #59940104104:  Hold'em No Limit ($0.50/$1.00) - 2009/07/01 0:57:22 ET
Table 'cBDNutyLBKEk9+ptwsKmTw' 6-max Seat #1 is the button
Seat 1: xAU6q2/cwmby2sxmA8VcmA ($119.85 in chips)
Seat 2: 5lY8d6Cnm4HUkt/8FZSj4g ($78.65 in chips)
Seat 3: G5ZSSN6RSON3gkNvk/SmYg ($103.15 in chips)
Seat 4: 3q7F5QtzC30pSrn0nl9i+A ($29.50 in chips)
Seat 5: OGMLOcTNYZXZU81au7ztUw ($158.65 in chips)
Seat 6: NqVlOSH2lp+pp/TK3vvK5g ($43.25 in chips)
5lY8d6Cnm4HUkt/8FZSj4g: posts small blind $0.50
G5ZSSN6RSON3gkNvk/SmYg: posts big blind $1
*** HOLE CARDS ***
3q7F5QtzC30pSrn0nl9i+A: folds
OGMLOcTNYZXZU81au7ztUw has timed out
OGMLOcTNYZXZU81au7ztUw: folds
OGMLOcTNYZXZU81au7ztUw is sitting out
NqVlOSH2lp+pp/TK3vvK5g: folds
OGMLOcTNYZXZU81au7ztUw has returned
xAU6q2/cwmby2sxmA8VcmA: raises $3 to $4
5lY8d6Cnm4HUkt/8FZSj4g: folds
G5ZSSN6RSON3gkNvk/SmYg: folds
xAU6q2/cwmby2sxmA8VcmA collected $2.50 from pot
xAU6q2/cwmby2sxmA8VcmA: doesn't show hand
*** SUMMARY ***
Total pot $2.50 | Rake $0
Seat 1: xAU6q2/cwmby2sxmA8VcmA (button) collected ($2.50)
Seat 2: 5lY8d6Cnm4HUkt/8FZSj4g (small blind) folded before Flop
Seat 3: G5ZSSN6RSON3gkNvk/SmYg (big blind) folded before Flop
Seat 4: 3q7F5QtzC30pSrn0nl9i+A folded before Flop (didn't bet)
Seat 5: OGMLOcTNYZXZU81au7ztUw folded before Flop (didn't bet)
Seat 6: NqVlOSH2lp+pp/TK3vvK5g folded before Flop (didn't bet)



PokerStars Game #59940104242:  Hold'em No Limit ($0.50/$1.00) - 2009/07/01 0:57:22 ET
Table 'W/wyObTiXZm+Ckkl3YxcSw' 6-max Seat #6 is the button
Seat 1: eUBBn2R56C1IQ6Cs/vitwg ($103.90 in chips)
Seat 2: oDiBRCaF0QVtd3kO6xZIXw ($103.45 in chips)
Seat 3: dxyNCn/qxfkGDUIf28Cbng ($85.90 in chips)
Seat 5: BdbmJTZZ47quA9vUWwXtlw ($64.35 in chips)
Seat 6: tS9JHB1h+FQ++qu8RwRNgg ($40.80 in chips)
eUBBn2R56C1IQ6Cs/vitwg: posts small blind $0.50
oDiBRCaF0QVtd3kO6xZIXw: posts big blind $1
*** HOLE CARDS ***
dxyNCn/qxfkGDUIf28Cbng: folds
BdbmJTZZ47quA9vUWwXtlw: raises $2 to $3
tS9JHB1h+FQ++qu8RwRNgg: folds
aYii2DmxlOlbC1wbGRBWvQ joins the table at seat #4
eUBBn2R56C1IQ6Cs/vitwg: folds
oDiBRCaF0QVtd3kO6xZIXw: calls $2
*** FLOP *** [5h 3c Kd]
oDiBRCaF0QVtd3kO6xZIXw: bets $4
BdbmJTZZ47quA9vUWwXtlw: folds
oDiBRCaF0QVtd3kO6xZIXw collected $6.20 from pot
oDiBRCaF0QVtd3kO6xZIXw: doesn't show hand
*** SUMMARY ***
Total pot $6.50 | Rake $0.30
Board [5h 3c Kd]
Seat 1: eUBBn2R56C1IQ6Cs/vitwg (small blind) folded before Flop
Seat 2: oDiBRCaF0QVtd3kO6xZIXw (big blind) collected ($6.20)
Seat 3: dxyNCn/qxfkGDUIf28Cbng folded before Flop (didn't bet)
Seat 5: BdbmJTZZ47quA9vUWwXtlw folded on the Flop
Seat 6: tS9JHB1h+FQ++qu8RwRNgg (button) folded before Flop (didn't bet)



PokerStars Game #59940104488:  Hold'em No Limit ($0.50/$1.00) - 2009/07/01 0:57:23 ET
Table 'hugOjcwJvzEwZbK7tyiWuQ' 9-max Seat #1 is the button
Seat 1: D+W9Me7w6Hcx/WRUSKV0dw ($18.50 in chips)
Seat 2: r27C1nIV4NS4+qbnrgBQSw ($261.50 in chips)
Seat 3: jDwhY1kCdc6EkAHbT7PJMQ ($102.15 in chips)
Seat 4: UWB3oeddt/GObx2Mix2Anw ($204.25 in chips)
Seat 5: 5BRGWf+R3nt2WS3b5xX+zA ($24.20 in chips)
Seat 6: gUUvmqdVlmvpal6B8nYrmg ($108.90 in chips)
Seat 7: FL3MrLspcF23LYvC4ipBOA ($111.80 in chips)
Seat 8: /zy+DB4S5fUQUSfZWFzYGw ($101 in chips)
r27C1nIV4NS4+qbnrgBQSw: posts small blind $0.50
jDwhY1kCdc6EkAHbT7PJMQ: posts big blind $1
*** HOLE CARDS ***
UWB3oeddt/GObx2Mix2Anw: folds
5BRGWf+R3nt2WS3b5xX+zA: folds
gUUvmqdVlmvpal6B8nYrmg: folds
FL3MrLspcF23LYvC4ipBOA: folds
/zy+DB4S5fUQUSfZWFzYGw: folds
D+W9Me7w6Hcx/WRUSKV0dw: raises $1.45 to $2.45
r27C1nIV4NS4+qbnrgBQSw: folds
jDwhY1kCdc6EkAHbT7PJMQ: folds
D+W9Me7w6Hcx/WRUSKV0dw collected $2.50 from pot
*** SUMMARY ***
Total pot $2.50 | Rake $0
Seat 1: D+W9Me7w6Hcx/WRUSKV0dw (button) collected ($2.50)
Seat 2: r27C1nIV4NS4+qbnrgBQSw (small blind) folded before Flop
Seat 3: jDwhY1kCdc6EkAHbT7PJMQ (big blind) folded before Flop
Seat 4: UWB3oeddt/GObx2Mix2Anw folded before Flop (didn't bet)
Seat 5: 5BRGWf+R3nt2WS3b5xX+zA folded before Flop (didn't bet)
Seat 6: gUUvmqdVlmvpal6B8nYrmg folded before Flop (didn't bet)
Seat 7: FL3MrLspcF23LYvC4ipBOA folded before Flop (didn't bet)
Seat 8: /zy+DB4S5fUQUSfZWFzYGw folded before Flop (didn't bet)



PokerStars Game #59940105590:  Hold'em No Limit ($0.50/$1.00) - 2009/07/01 0:57:24 ET
Table 'fTlPiCj0utgzC/5io+I7ew' 6-max Seat #6 is the button
Seat 1: YMJG+F++3Aj6P8dAWda5fw ($92.50 in chips)
Seat 2: Qy/UBNbD2HaA0Ogxg8Sf3w ($128.35 in chips)
Seat 3: wL5HjWHHOSGc53xWMNKB9Q ($32.60 in chips)
Seat 4: uJVSceLggtsrJya+WtmUEA ($119.25 in chips)
Seat 5: bFrTkDcWGTxyvNul7GVdYg ($307.55 in chips)
Seat 6: /P4w1pHg2zHYg/4ubJ0dPw ($60 in chips)
YMJG+F++3Aj6P8dAWda5fw: posts small blind $0.50
Qy/UBNbD2HaA0Ogxg8Sf3w: posts big blind $1
*** HOLE CARDS ***
wL5HjWHHOSGc53xWMNKB9Q: folds
uJVSceLggtsrJya+WtmUEA: folds
bFrTkDcWGTxyvNul7GVdYg: folds
/P4w1pHg2zHYg/4ubJ0dPw: raises $2 to $3
YMJG+F++3Aj6P8dAWda5fw: folds
Qy/UBNbD2HaA0Ogxg8Sf3w: folds
/P4w1pHg2zHYg/4ubJ0dPw collected $2.50 from pot
*** SUMMARY ***
Total pot $2.50 | Rake $0
Seat 1: YMJG+F++3Aj6P8dAWda5fw (small blind) folded before Flop
Seat 2: Qy/UBNbD2HaA0Ogxg8Sf3w (big blind) folded before Flop
Seat 3: wL5HjWHHOSGc53xWMNKB9Q folded before Flop (didn't bet)
Seat 4: uJVSceLggtsrJya+WtmUEA folded before Flop (didn't bet)
Seat 5: bFrTkDcWGTxyvNul7GVdYg folded before Flop (didn't bet)
Seat 6: /P4w1pHg2zHYg/4ubJ0dPw (button) collected ($2.50)



PokerStars Game #59940107496:  Hold'em No Limit ($0.50/$1.00) - 2009/07/01 0:57:27 ET
Table '/RZcOwpZpHQ+OwPwjsbnRw' 6-max Seat #6 is the button
Seat 1: Zboa6dColKGHBjLPUakZjw ($66.80 in chips)
Seat 2: +xW7QemQU0Fxs+4TnqBRow ($238.65 in chips)
Seat 3: XnT1yK2DD/5FL+0bwuEhqg ($46.45 in chips)
Seat 4: j7NIOHLZk7V2o9fOioO5ug ($100 in chips)
Seat 5: wx3sQGkVi2x9wJXuWNHPBw ($179.15 in chips)
Seat 6: XOIf9W+VAxhZqN+SYoyMKA ($255.85 in chips)
Zboa6dColKGHBjLPUakZjw: posts small blind $0.50
+xW7QemQU0Fxs+4TnqBRow: posts big blind $1
*** HOLE CARDS ***
XnT1yK2DD/5FL+0bwuEhqg: folds
j7NIOHLZk7V2o9fOioO5ug: folds
wx3sQGkVi2x9wJXuWNHPBw: folds
XOIf9W+VAxhZqN+SYoyMKA: folds
Zboa6dColKGHBjLPUakZjw: raises $1 to $2
+xW7QemQU0Fxs+4TnqBRow: calls $1
*** FLOP *** [Qh Jd 2c]
Zboa6dColKGHBjLPUakZjw: bets $2
+xW7QemQU0Fxs+4TnqBRow: calls $2
*** TURN *** [Qh Jd 2c] [Jh]
Zboa6dColKGHBjLPUakZjw: bets $3
+xW7QemQU0Fxs+4TnqBRow: calls $3
*** RIVER *** [Qh Jd 2c Jh] [Qd]
Zboa6dColKGHBjLPUakZjw: bets $5
+xW7QemQU0Fxs+4TnqBRow: folds
Zboa6dColKGHBjLPUakZjw collected $13.35 from pot
*** SUMMARY ***
Total pot $14 | Rake $0.65
Board [Qh Jd 2c Jh Qd]
Seat 1: Zboa6dColKGHBjLPUakZjw (small blind) collected ($13.35)
Seat 2: +xW7QemQU0Fxs+4TnqBRow (big blind) folded on the River
Seat 3: XnT1yK2DD/5FL+0bwuEhqg folded before Flop (didn't bet)
Seat 4: j7NIOHLZk7V2o9fOioO5ug folded before Flop (didn't bet)
Seat 5: wx3sQGkVi2x9wJXuWNHPBw folded before Flop (didn't bet)
Seat 6: XOIf9W+VAxhZqN+SYoyMKA (button) folded before Flop (didn't bet)



PokerStars Game #59940107744:  Hold'em No Limit ($0.50/$1.00) - 2009/07/01 0:57:28 ET
Table 'LmXQK9xy3awB+qsPzI21Mw' 2-max Seat #1 is the button
Seat 1: NYi6JFscYNrofSXy4sM+Yw ($295.25 in chips)
Seat 2: TME8GvochpQAo8cmJwWmvA ($94.55 in chips)
NYi6JFscYNrofSXy4sM+Yw: posts small blind $0.50
TME8GvochpQAo8cmJwWmvA: posts big blind $1
*** HOLE CARDS ***
NYi6JFscYNrofSXy4sM+Yw: raises $2 to $3
TME8GvochpQAo8cmJwWmvA: raises $8 to $11
NYi6JFscYNrofSXy4sM+Yw: folds
TME8GvochpQAo8cmJwWmvA collected $6 from pot
TME8GvochpQAo8cmJwWmvA: doesn't show hand
*** SUMMARY ***
Total pot $6 | Rake $0
Seat 1: NYi6JFscYNrofSXy4sM+Yw (button) (small blind) folded before Flop
Seat 2: TME8GvochpQAo8cmJwWmvA (big blind) collected ($6)



PokerStars Game #59940108086:  Hold'em No Limit ($0.50/$1.00) - 2009/07/01 0:57:28 ET
Table 'JOIm/fogLA7vSG0Vc6ME1A' 2-max Seat #1 is the button
Seat 1: NYi6JFscYNrofSXy4sM+Yw ($151.70 in chips)
Seat 2: F5lNTyZLIX9W2wQZ0plwgg ($98.30 in chips)
NYi6JFscYNrofSXy4sM+Yw: posts small blind $0.50
F5lNTyZLIX9W2wQZ0plwgg: posts big blind $1
*** HOLE CARDS ***
NYi6JFscYNrofSXy4sM+Yw: raises $1 to $2
F5lNTyZLIX9W2wQZ0plwgg: calls $1
*** FLOP *** [5h 3c Jd]
F5lNTyZLIX9W2wQZ0plwgg: bets $2
NYi6JFscYNrofSXy4sM+Yw: folds
F5lNTyZLIX9W2wQZ0plwgg collected $3.80 from pot
F5lNTyZLIX9W2wQZ0plwgg: doesn't show hand
*** SUMMARY ***
Total pot $4 | Rake $0.20
Board [5h 3c Jd]
Seat 1: NYi6JFscYNrofSXy4sM+Yw (button) (small blind) folded on the Flop
Seat 2: F5lNTyZLIX9W2wQZ0plwgg (big blind) collected ($3.80)



PokerStars Game #59940108272:  Hold'em No Limit ($0.50/$1.00) - 2009/07/01 0:57:29 ET
Table 'U9zqzC8f3oTJ2ShXFgSSOA' 6-max Seat #5 is the button
Seat 1: iHo1oDbrEVJ8nEGdaPrICw ($105.40 in chips)
Seat 2: TSuRyAHnUPCFjP7Z0rEE0w ($100 in chips)
Seat 3: yfXek8iJ7O4CFyqXrtGcfg ($16.35 in chips)
Seat 5: KfwW5us6tydK81NYTtK1gw ($297.45 in chips)
Seat 6: 4OO5v3AVduL0tePNx8wk5A ($118.20 in chips)
4OO5v3AVduL0tePNx8wk5A: posts small blind $0.50
iHo1oDbrEVJ8nEGdaPrICw: posts big blind $1
*** HOLE CARDS ***
TSuRyAHnUPCFjP7Z0rEE0w: folds
yfXek8iJ7O4CFyqXrtGcfg: folds
KfwW5us6tydK81NYTtK1gw: folds
4OO5v3AVduL0tePNx8wk5A: folds
iHo1oDbrEVJ8nEGdaPrICw collected $1 from pot
iHo1oDbrEVJ8nEGdaPrICw: doesn't show hand
*** SUMMARY ***
Total pot $1 | Rake $0
Seat 1: iHo1oDbrEVJ8nEGdaPrICw (big blind) collected ($1)
Seat 2: TSuRyAHnUPCFjP7Z0rEE0w folded before Flop (didn't bet)
Seat 3: yfXek8iJ7O4CFyqXrtGcfg folded before Flop (didn't bet)
Seat 5: KfwW5us6tydK81NYTtK1gw (button) folded before Flop (didn't bet)
Seat 6: 4OO5v3AVduL0tePNx8wk5A (small blind) folded before Flop



PokerStars Game #59940108828:  Hold'em No Limit ($0.50/$1.00) - 2009/07/01 0:57:30 ET
Table 'cKH9c4x6u79IqCdaKKvXrw' 9-max Seat #6 is the button
Seat 1: Pp/KTcXkfZKKUHkjyaLTdg ($17 in chips)
Seat 2: 8S3JMH4TY3whgIlZmMv66w ($70.15 in chips)
Seat 3: 997ViqAtWn1FPjJqcffwcA ($157.10 in chips)
Seat 4: FL3MrLspcF23LYvC4ipBOA ($100 in chips)
Seat 5: Jjc7EHWzs4//xUAjJ0UWoA ($38 in chips)
Seat 6: Bsd/K5gAcLanYbGiPirRjw ($210.55 in chips)
Seat 7: 1GkkVBhlJ92guE6K5mS5Ig ($10.80 in chips)
Seat 8: myIxN7otsyr846M539YR8Q ($20 in chips)
Seat 9: 6XkTu4ahxzHnvjjc1R8YjQ ($43.10 in chips)
1GkkVBhlJ92guE6K5mS5Ig: posts small blind $0.50
myIxN7otsyr846M539YR8Q: posts big blind $1
*** HOLE CARDS ***
6XkTu4ahxzHnvjjc1R8YjQ: folds
Pp/KTcXkfZKKUHkjyaLTdg: folds
8S3JMH4TY3whgIlZmMv66w: folds
997ViqAtWn1FPjJqcffwcA: folds
FL3MrLspcF23LYvC4ipBOA: raises $2 to $3
Jjc7EHWzs4//xUAjJ0UWoA: calls $3
Bsd/K5gAcLanYbGiPirRjw: folds
1GkkVBhlJ92guE6K5mS5Ig: folds
myIxN7otsyr846M539YR8Q: folds
*** FLOP *** [3h Kh 3d]
FL3MrLspcF23LYvC4ipBOA: checks
Jjc7EHWzs4//xUAjJ0UWoA: bets $4
FL3MrLspcF23LYvC4ipBOA: folds
Jjc7EHWzs4//xUAjJ0UWoA collected $7.15 from pot
*** SUMMARY ***
Total pot $7.50 | Rake $0.35
Board [3h Kh 3d]
Seat 1: Pp/KTcXkfZKKUHkjyaLTdg folded before Flop (didn't bet)
Seat 2: 8S3JMH4TY3whgIlZmMv66w folded before Flop (didn't bet)
Seat 3: 997ViqAtWn1FPjJqcffwcA folded before Flop (didn't bet)
Seat 4: FL3MrLspcF23LYvC4ipBOA folded on the Flop
Seat 5: Jjc7EHWzs4//xUAjJ0UWoA collected ($7.15)
Seat 6: Bsd/K5gAcLanYbGiPirRjw (button) folded before Flop (didn't bet)
Seat 7: 1GkkVBhlJ92guE6K5mS5Ig (small blind) folded before Flop
Seat 8: myIxN7otsyr846M539YR8Q (big blind) folded before Flop
Seat 9: 6XkTu4ahxzHnvjjc1R8YjQ folded before Flop (didn't bet)



PokerStars Game #59940110686:  Hold'em No Limit ($0.50/$1.00) - 2009/07/01 0:57:33 ET
Table '/FUb199IViHMJHi5YWmeuQ' 9-max Seat #9 is the button
Seat 1: TZcz9MEWDA+WydgGruqqbw ($113 in chips)
Seat 2: FL3MrLspcF23LYvC4ipBOA ($175.90 in chips)
Seat 3: qN483QJ1NvHbdIZB7J4ARw ($24.20 in chips)
Seat 4: qheQay5YvP2DMAb3OUSxtw ($143.35 in chips)
Seat 5: kiakSwxX0e64PwYGAPQvLw ($31.25 in chips)
Seat 6: ccFf7Q4z1cTGQmeoYiWEfw ($56.45 in chips)
Seat 7: bLbSOSmSOnqE0iTcH/5dxA ($105.20 in chips)
Seat 8: 997ViqAtWn1FPjJqcffwcA ($103 in chips)
Seat 9: RfLbneGRY8yQUpMgDnJCxA ($63.95 in chips)
TZcz9MEWDA+WydgGruqqbw: posts small blind $0.50
FL3MrLspcF23LYvC4ipBOA: posts big blind $1
*** HOLE CARDS ***
qN483QJ1NvHbdIZB7J4ARw: calls $1
qheQay5YvP2DMAb3OUSxtw: folds
kiakSwxX0e64PwYGAPQvLw: folds
ccFf7Q4z1cTGQmeoYiWEfw: folds
bLbSOSmSOnqE0iTcH/5dxA: raises $4 to $5
997ViqAtWn1FPjJqcffwcA: folds
RfLbneGRY8yQUpMgDnJCxA: folds
TZcz9MEWDA+WydgGruqqbw: raises $11 to $16
FL3MrLspcF23LYvC4ipBOA: folds
qN483QJ1NvHbdIZB7J4ARw: folds
bLbSOSmSOnqE0iTcH/5dxA: folds
TZcz9MEWDA+WydgGruqqbw collected $12 from pot
TZcz9MEWDA+WydgGruqqbw: doesn't show hand
*** SUMMARY ***
Total pot $12 | Rake $0
Seat 1: TZcz9MEWDA+WydgGruqqbw (small blind) collected ($12)
Seat 2: FL3MrLspcF23LYvC4ipBOA (big blind) folded before Flop
Seat 3: qN483QJ1NvHbdIZB7J4ARw folded before Flop
Seat 4: qheQay5YvP2DMAb3OUSxtw folded before Flop (didn't bet)
Seat 5: kiakSwxX0e64PwYGAPQvLw folded before Flop (didn't bet)
Seat 6: ccFf7Q4z1cTGQmeoYiWEfw folded before Flop (didn't bet)
Seat 7: bLbSOSmSOnqE0iTcH/5dxA folded before Flop
Seat 8: 997ViqAtWn1FPjJqcffwcA folded before Flop (didn't bet)
Seat 9: RfLbneGRY8yQUpMgDnJCxA (button) folded before Flop (didn't bet)



PokerStars Game #59940111012:  Hold'em No Limit ($0.50/$1.00) - 2009/07/01 0:57:33 ET
Table '7O9fB8yx1u7sJveJn8w6jA' 6-max Seat #3 is the button
Seat 1: jy52+7FotjH63o5tEEVgKw ($111.85 in chips)
Seat 2: wx3sQGkVi2x9wJXuWNHPBw ($191 in chips)
Seat 3: hpxXcmRkXXI9HE5+5/j/0Q ($100 in chips)
Seat 4: XIZSmlGttGgSRaIU42K4Fg ($144.40 in chips)
Seat 5: BCEV3COoKY607AzLWayfRA ($100 in chips)
Seat 6: UBZQqpnJZdTYYY1FTb0rLA ($130.45 in chips)
XIZSmlGttGgSRaIU42K4Fg: posts small blind $0.50
BCEV3COoKY607AzLWayfRA: posts big blind $1
*** HOLE CARDS ***
UBZQqpnJZdTYYY1FTb0rLA: folds
jy52+7FotjH63o5tEEVgKw: calls $1
wx3sQGkVi2x9wJXuWNHPBw: raises $4 to $5
hpxXcmRkXXI9HE5+5/j/0Q: folds
XIZSmlGttGgSRaIU42K4Fg: folds
BCEV3COoKY607AzLWayfRA: folds
jy52+7FotjH63o5tEEVgKw: calls $4
*** FLOP *** [5h Kh 7c]
jy52+7FotjH63o5tEEVgKw: checks
wx3sQGkVi2x9wJXuWNHPBw: bets $8
jy52+7FotjH63o5tEEVgKw: folds
jy52+7FotjH63o5tEEVgKw is sitting out
wx3sQGkVi2x9wJXuWNHPBw collected $10.95 from pot
*** SUMMARY ***
Total pot $11.50 | Rake $0.55
Board [5h Kh 7c]
Seat 1: jy52+7FotjH63o5tEEVgKw folded on the Flop
Seat 2: wx3sQGkVi2x9wJXuWNHPBw collected ($10.95)
Seat 3: hpxXcmRkXXI9HE5+5/j/0Q (button) folded before Flop (didn't bet)
Seat 4: XIZSmlGttGgSRaIU42K4Fg (small blind) folded before Flop
Seat 5: BCEV3COoKY607AzLWayfRA (big blind) folded before Flop
Seat 6: UBZQqpnJZdTYYY1FTb0rLA folded before Flop (didn't bet)



PokerStars Game #59940111242:  Hold'em No Limit ($0.50/$1.00) - 2009/07/01 0:57:34 ET
Table 'uNlePsyMIqzM691Xkrlk6Q' 9-max Seat #5 is the button
Seat 1: bLbSOSmSOnqE0iTcH/5dxA ($100 in chips)
Seat 2: +OqpStnt0FqbCfyHAWaLbg ($100.15 in chips)
Seat 3: h7qXkU57Bb8ZuPwMyxR8Ug ($16.15 in chips)
Seat 4: TZcz9MEWDA+WydgGruqqbw ($101.15 in chips)
Seat 5: 3obndzTJ6fECz8+wWhMd1w ($17 in chips)
Seat 6: myIxN7otsyr846M539YR8Q ($17.50 in chips)
Seat 7: w6cw9nzN7AvkkHBVVjykoQ ($55.75 in chips)
Seat 8: laA8va+Yv8WuMqT1zdR91g ($101 in chips)
Seat 9: vR4IO10geOgvTW+LAUBv/A ($101.50 in chips)
myIxN7otsyr846M539YR8Q: posts small blind $0.50
w6cw9nzN7AvkkHBVVjykoQ: posts big blind $1
*** HOLE CARDS ***
laA8va+Yv8WuMqT1zdR91g: folds
vR4IO10geOgvTW+LAUBv/A: folds
bLbSOSmSOnqE0iTcH/5dxA: folds
+OqpStnt0FqbCfyHAWaLbg: folds
h7qXkU57Bb8ZuPwMyxR8Ug: folds
TZcz9MEWDA+WydgGruqqbw: raises $2 to $3
3obndzTJ6fECz8+wWhMd1w: folds
myIxN7otsyr846M539YR8Q: raises $14.50 to $17.50 and is all-in
w6cw9nzN7AvkkHBVVjykoQ: folds
TZcz9MEWDA+WydgGruqqbw: folds
myIxN7otsyr846M539YR8Q collected $7 from pot
myIxN7otsyr846M539YR8Q: doesn't show hand
*** SUMMARY ***
Total pot $7 | Rake $0
Seat 1: bLbSOSmSOnqE0iTcH/5dxA folded before Flop (didn't bet)
Seat 2: +OqpStnt0FqbCfyHAWaLbg folded before Flop (didn't bet)
Seat 3: h7qXkU57Bb8ZuPwMyxR8Ug folded before Flop (didn't bet)
Seat 4: TZcz9MEWDA+WydgGruqqbw folded before Flop
Seat 5: 3obndzTJ6fECz8+wWhMd1w (button) folded before Flop (didn't bet)
Seat 6: myIxN7otsyr846M539YR8Q (small blind) collected ($7)
Seat 7: w6cw9nzN7AvkkHBVVjykoQ (big blind) folded before Flop
Seat 8: laA8va+Yv8WuMqT1zdR91g folded before Flop (didn't bet)
Seat 9: vR4IO10geOgvTW+LAUBv/A folded before Flop (didn't bet)



PokerStars Game #59940113992:  Hold'em No Limit ($0.50/$1.00) - 2009/07/01 0:57:38 ET
Table '6YvsYDPNIDx2v5z3bJnwZQ' 9-max Seat #3 is the button
Seat 1: Ogn4JDV3mp4ZDKO49IFzKA ($18.20 in chips)
Seat 2: +hHqYgKILitkxIzFNGvvsA ($35 in chips)
Seat 3: negfosHnGOZXSHpWDRKyBQ ($16.50 in chips)
Seat 4: kEr5NYB+JIG5+szcYMr6hA ($37.25 in chips)
Seat 5: mBRWbnUl8diyBO1qTJaNzw ($165.20 in chips)
Seat 6: 7RSwrjMohkYrZAhOd1uaZg ($12 in chips)
Seat 7: mae7OMTaJ/MFimNbZegCkg ($52.30 in chips)
Seat 8: PSFxpXgPedVZyHSu2Zhb7Q ($110.80 in chips)
Seat 9: ZgMRSHJ9EOtPeVHmdeV9kQ ($50 in chips)
kEr5NYB+JIG5+szcYMr6hA: posts small blind $0.50
mBRWbnUl8diyBO1qTJaNzw: posts big blind $1
+hHqYgKILitkxIzFNGvvsA: posts big blind $1
*** HOLE CARDS ***
7RSwrjMohkYrZAhOd1uaZg: calls $1
mae7OMTaJ/MFimNbZegCkg: folds
PSFxpXgPedVZyHSu2Zhb7Q: calls $1
ZgMRSHJ9EOtPeVHmdeV9kQ: folds
Ogn4JDV3mp4ZDKO49IFzKA: raises $17.20 to $18.20 and is all-in
+hHqYgKILitkxIzFNGvvsA: folds
negfosHnGOZXSHpWDRKyBQ: folds
kEr5NYB+JIG5+szcYMr6hA: folds
mBRWbnUl8diyBO1qTJaNzw: folds
7RSwrjMohkYrZAhOd1uaZg: folds
PSFxpXgPedVZyHSu2Zhb7Q: folds
Ogn4JDV3mp4ZDKO49IFzKA collected $5.50 from pot
*** SUMMARY ***
Total pot $5.50 | Rake $0
Seat 1: Ogn4JDV3mp4ZDKO49IFzKA collected ($5.50)
Seat 2: +hHqYgKILitkxIzFNGvvsA folded before Flop
Seat 3: negfosHnGOZXSHpWDRKyBQ (button) folded before Flop (didn't bet)
Seat 4: kEr5NYB+JIG5+szcYMr6hA (small blind) folded before Flop
Seat 5: mBRWbnUl8diyBO1qTJaNzw (big blind) folded before Flop
Seat 6: 7RSwrjMohkYrZAhOd1uaZg folded before Flop
Seat 7: mae7OMTaJ/MFimNbZegCkg folded before Flop (didn't bet)
Seat 8: PSFxpXgPedVZyHSu2Zhb7Q folded before Flop
Seat 9: ZgMRSHJ9EOtPeVHmdeV9kQ folded before Flop (didn't bet)



PokerStars Game #59940114050:  Hold'em No Limit ($0.50/$1.00) - 2009/07/01 0:57:38 ET
Table 'mmbQQVBTrPdE+wy+s+9VPA' 6-max Seat #3 is the button
Seat 1: zyP4SPoWZnKUfTvIRLCVog ($60 in chips)
Seat 2: cl/QpVR/PLO58lj+C5mGLw ($25 in chips)
Seat 3: wx3sQGkVi2x9wJXuWNHPBw ($113.65 in chips)
Seat 4: V3iZdcw61nXF3g5hD2RrsQ ($100 in chips)
Seat 5: YMJG+F++3Aj6P8dAWda5fw ($99.50 in chips)
Seat 6: U2CWBTv29qdCbj8RNF2sIw ($98.50 in chips)
V3iZdcw61nXF3g5hD2RrsQ: posts small blind $0.50
YMJG+F++3Aj6P8dAWda5fw: posts big blind $1
zyP4SPoWZnKUfTvIRLCVog: posts big blind $1
cl/QpVR/PLO58lj+C5mGLw: posts big blind $1
*** HOLE CARDS ***
U2CWBTv29qdCbj8RNF2sIw: raises $4 to $5
zyP4SPoWZnKUfTvIRLCVog: calls $4
cl/QpVR/PLO58lj+C5mGLw: folds
wx3sQGkVi2x9wJXuWNHPBw: folds
V3iZdcw61nXF3g5hD2RrsQ: folds
YMJG+F++3Aj6P8dAWda5fw: folds
*** FLOP *** [Th 3c 2s]
U2CWBTv29qdCbj8RNF2sIw: bets $7
zyP4SPoWZnKUfTvIRLCVog: folds
U2CWBTv29qdCbj8RNF2sIw collected $11.90 from pot
*** SUMMARY ***
Total pot $12.50 | Rake $0.60
Board [Th 3c 2s]
Seat 1: zyP4SPoWZnKUfTvIRLCVog folded on the Flop
Seat 2: cl/QpVR/PLO58lj+C5mGLw folded before Flop
Seat 3: wx3sQGkVi2x9wJXuWNHPBw (button) folded before Flop (didn't bet)
Seat 4: V3iZdcw61nXF3g5hD2RrsQ (small blind) folded before Flop
Seat 5: YMJG+F++3Aj6P8dAWda5fw (big blind) folded before Flop
Seat 6: U2CWBTv29qdCbj8RNF2sIw collected ($11.90)



PokerStars Game #59940114034:  Hold'em No Limit ($0.50/$1.00) - 2009/07/01 0:57:38 ET
Table 'LmXQK9xy3awB+qsPzI21Mw' 2-max Seat #2 is the button
Seat 1: NYi6JFscYNrofSXy4sM+Yw ($292.25 in chips)
Seat 2: TME8GvochpQAo8cmJwWmvA ($97.55 in chips)
TME8GvochpQAo8cmJwWmvA: posts small blind $0.50
NYi6JFscYNrofSXy4sM+Yw: posts big blind $1
*** HOLE CARDS ***
TME8GvochpQAo8cmJwWmvA: folds
NYi6JFscYNrofSXy4sM+Yw collected $1 from pot
NYi6JFscYNrofSXy4sM+Yw: doesn't show hand
*** SUMMARY ***
Total pot $1 | Rake $0
Seat 1: NYi6JFscYNrofSXy4sM+Yw (big blind) collected ($1)
Seat 2: TME8GvochpQAo8cmJwWmvA (button) (small blind) folded before Flop



PokerStars Game #59940115280:  Hold'em No Limit ($0.50/$1.00) - 2009/07/01 0:57:40 ET
Table 'JOIm/fogLA7vSG0Vc6ME1A' 2-max Seat #2 is the button
Seat 1: NYi6JFscYNrofSXy4sM+Yw ($149.70 in chips)
Seat 2: F5lNTyZLIX9W2wQZ0plwgg ($100.10 in chips)
F5lNTyZLIX9W2wQZ0plwgg: posts small blind $0.50
NYi6JFscYNrofSXy4sM+Yw: posts big blind $1
*** HOLE CARDS ***
F5lNTyZLIX9W2wQZ0plwgg: folds
NYi6JFscYNrofSXy4sM+Yw collected $1 from pot
*** SUMMARY ***
Total pot $1 | Rake $0
Seat 1: NYi6JFscYNrofSXy4sM+Yw (big blind) collected ($1)
Seat 2: F5lNTyZLIX9W2wQZ0plwgg (button) (small blind) folded before Flop



PokerStars Game #59940115010:  Hold'em No Limit ($0.50/$1.00) - 2009/07/01 0:57:40 ET
Table '8jIjWCPY0NGprquL+xcMFg' 9-max Seat #7 is the button
Seat 1: vR4IO10geOgvTW+LAUBv/A ($136.05 in chips)
Seat 2: laA8va+Yv8WuMqT1zdR91g ($106.05 in chips)
Seat 3: tjhwe1V98x2spSoUQER3HQ ($104.50 in chips)
Seat 4: Jjc7EHWzs4//xUAjJ0UWoA ($19.90 in chips)
Seat 5: 2YpnxJiexJHyERfbqgwEcw ($85.55 in chips)
Seat 6: GTQkFJtSkbVbnGCktp6e3g ($101.35 in chips)
Seat 7: O3CGPwwUmamrCNHccOilrg ($45.45 in chips)
Seat 8: D+W9Me7w6Hcx/WRUSKV0dw ($19 in chips)
Seat 9: negfosHnGOZXSHpWDRKyBQ ($23 in chips)
D+W9Me7w6Hcx/WRUSKV0dw: posts small blind $0.50
negfosHnGOZXSHpWDRKyBQ: posts big blind $1
*** HOLE CARDS ***
vR4IO10geOgvTW+LAUBv/A: folds
laA8va+Yv8WuMqT1zdR91g: raises $2 to $3
tjhwe1V98x2spSoUQER3HQ: folds
Jjc7EHWzs4//xUAjJ0UWoA: folds
2YpnxJiexJHyERfbqgwEcw: calls $3
GTQkFJtSkbVbnGCktp6e3g: folds
O3CGPwwUmamrCNHccOilrg: folds
D+W9Me7w6Hcx/WRUSKV0dw: folds
negfosHnGOZXSHpWDRKyBQ: folds
*** FLOP *** [3c Kc Ts]
laA8va+Yv8WuMqT1zdR91g: bets $5.50
2YpnxJiexJHyERfbqgwEcw: folds
laA8va+Yv8WuMqT1zdR91g collected $7.15 from pot
laA8va+Yv8WuMqT1zdR91g: doesn't show hand
*** SUMMARY ***
Total pot $7.50 | Rake $0.35
Board [3c Kc Ts]
Seat 1: vR4IO10geOgvTW+LAUBv/A folded before Flop (didn't bet)
Seat 2: laA8va+Yv8WuMqT1zdR91g collected ($7.15)
Seat 3: tjhwe1V98x2spSoUQER3HQ folded before Flop (didn't bet)
Seat 4: Jjc7EHWzs4//xUAjJ0UWoA folded before Flop (didn't bet)
Seat 5: 2YpnxJiexJHyERfbqgwEcw folded on the Flop
Seat 6: GTQkFJtSkbVbnGCktp6e3g folded before Flop (didn't bet)
Seat 7: O3CGPwwUmamrCNHccOilrg (button) folded before Flop (didn't bet)
Seat 8: D+W9Me7w6Hcx/WRUSKV0dw (small blind) folded before Flop
Seat 9: negfosHnGOZXSHpWDRKyBQ (big blind) folded before Flop



PokerStars Game #59940115648:  Hold'em No Limit ($0.50/$1.00) - 2009/07/01 0:57:41 ET
Table 'SQLOQoANiHscJ8AL7zffbw' 9-max Seat #3 is the button
Seat 1: jPTRd6SpCp4xqAy2XQiTOw ($67.10 in chips)
Seat 2: /zy+DB4S5fUQUSfZWFzYGw ($329.50 in chips)
Seat 3: 0eFnow7+D7veCYQ+CG9FFw ($93.35 in chips)
Seat 4: /mfensKw8/iZ1Vrx33S4xg ($20.50 in chips)
Seat 5: L9njYvloJ1NdXjP8edHEAg ($105.60 in chips)
Seat 6: p5UKaxVobvptF0ANhR/q1A ($173 in chips)
Seat 7: bJckevFOcg//s0qyMQI6sQ ($100 in chips)
Seat 8: 2BV+oJIQYr65IO6nEChvbA ($60 in chips)
Seat 9: qJr25HAtvv1w/7IBvjMM3g ($202.30 in chips)
/mfensKw8/iZ1Vrx33S4xg: posts small blind $0.50
L9njYvloJ1NdXjP8edHEAg: posts big blind $1
*** HOLE CARDS ***
p5UKaxVobvptF0ANhR/q1A: folds
bJckevFOcg//s0qyMQI6sQ: folds
2BV+oJIQYr65IO6nEChvbA: folds
qJr25HAtvv1w/7IBvjMM3g: folds
jPTRd6SpCp4xqAy2XQiTOw: calls $1
/zy+DB4S5fUQUSfZWFzYGw: folds
0eFnow7+D7veCYQ+CG9FFw: folds
/mfensKw8/iZ1Vrx33S4xg: calls $0.50
L9njYvloJ1NdXjP8edHEAg: checks
*** FLOP *** [7c 5h Qc]
/mfensKw8/iZ1Vrx33S4xg: checks
L9njYvloJ1NdXjP8edHEAg: checks
jPTRd6SpCp4xqAy2XQiTOw: checks
*** TURN *** [7c 5h Qc] [Qs]
/mfensKw8/iZ1Vrx33S4xg: checks
L9njYvloJ1NdXjP8edHEAg: checks
jPTRd6SpCp4xqAy2XQiTOw: bets $4
/mfensKw8/iZ1Vrx33S4xg: folds
L9njYvloJ1NdXjP8edHEAg: folds
jPTRd6SpCp4xqAy2XQiTOw collected $2.85 from pot
jPTRd6SpCp4xqAy2XQiTOw: doesn't show hand
*** SUMMARY ***
Total pot $3 | Rake $0.15
Board [7c 5h Qc Qs]
Seat 1: jPTRd6SpCp4xqAy2XQiTOw collected ($2.85)
Seat 2: /zy+DB4S5fUQUSfZWFzYGw folded before Flop (didn't bet)
Seat 3: 0eFnow7+D7veCYQ+CG9FFw (button) folded before Flop (didn't bet)
Seat 4: /mfensKw8/iZ1Vrx33S4xg (small blind) folded on the Turn
Seat 5: L9njYvloJ1NdXjP8edHEAg (big blind) folded on the Turn
Seat 6: p5UKaxVobvptF0ANhR/q1A folded before Flop (didn't bet)
Seat 7: bJckevFOcg//s0qyMQI6sQ folded before Flop (didn't bet)
Seat 8: 2BV+oJIQYr65IO6nEChvbA folded before Flop (didn't bet)
Seat 9: qJr25HAtvv1w/7IBvjMM3g folded before Flop (didn't bet)



PokerStars Game #59940115618:  Hold'em No Limit ($0.50/$1.00) - 2009/07/01 0:57:41 ET
Table 'pHrhryH8jPNdQfY62f8v+g' 6-max Seat #1 is the button
Seat 1: OvwYHV65yUbgdBjSmo1+5g ($58.50 in chips)
Seat 2: RqgF7gRoKgRNW8Zoi1ty4A ($100 in chips)
Seat 3: 8oS5O7iD/qnFXFXJrGIgNQ ($156.30 in chips)
Seat 4: DHjG71KHeyQxu3OZ+fFd4w ($21.20 in chips)
Seat 5: r1/R7y0Ortgoz4lccgW8VA ($52.05 in chips)
Seat 6: xAU6q2/cwmby2sxmA8VcmA ($113.30 in chips)
RqgF7gRoKgRNW8Zoi1ty4A: posts small blind $0.50
8oS5O7iD/qnFXFXJrGIgNQ: posts big blind $1
DHjG71KHeyQxu3OZ+fFd4w: posts big blind $1
*** HOLE CARDS ***
DHjG71KHeyQxu3OZ+fFd4w: raises $4 to $5
r1/R7y0Ortgoz4lccgW8VA: folds
xAU6q2/cwmby2sxmA8VcmA: folds
OvwYHV65yUbgdBjSmo1+5g: folds
RqgF7gRoKgRNW8Zoi1ty4A: folds
8oS5O7iD/qnFXFXJrGIgNQ: folds
DHjG71KHeyQxu3OZ+fFd4w collected $2.50 from pot
DHjG71KHeyQxu3OZ+fFd4w: doesn't show hand
*** SUMMARY ***
Total pot $2.50 | Rake $0
Seat 1: OvwYHV65yUbgdBjSmo1+5g (button) folded before Flop (didn't bet)
Seat 2: RqgF7gRoKgRNW8Zoi1ty4A (small blind) folded before Flop
Seat 3: 8oS5O7iD/qnFXFXJrGIgNQ (big blind) folded before Flop
Seat 4: DHjG71KHeyQxu3OZ+fFd4w collected ($2.50)
Seat 5: r1/R7y0Ortgoz4lccgW8VA folded before Flop (didn't bet)
Seat 6: xAU6q2/cwmby2sxmA8VcmA folded before Flop (didn't bet)



PokerStars Game #59940116608:  Hold'em No Limit ($0.50/$1.00) - 2009/07/01 0:57:42 ET
Table 'tLrtq7gDzxEvckNAI1OS5Q' 6-max Seat #5 is the button
Seat 2: QHvTZcrKe6+maWUfVjP29Q ($101.50 in chips)
Seat 3: TPZ+m9x+lwoKpv7TMfAUWA ($299.25 in chips)
Seat 4: +uSzP8Jwnw7sKfQ4s66b7w ($49.80 in chips)
Seat 5: OGMLOcTNYZXZU81au7ztUw ($165.65 in chips)
Seat 6: XUk5GQsfNFpHvaToDZ0rZA ($167.20 in chips)
XUk5GQsfNFpHvaToDZ0rZA: posts small blind $0.50
xNKcQzD9+/iHmtJn4vYq9w: is sitting out
QHvTZcrKe6+maWUfVjP29Q: posts big blind $1
*** HOLE CARDS ***
TPZ+m9x+lwoKpv7TMfAUWA: raises $2 to $3
+uSzP8Jwnw7sKfQ4s66b7w: folds
xNKcQzD9+/iHmtJn4vYq9w leaves the table
OGMLOcTNYZXZU81au7ztUw: folds
XUk5GQsfNFpHvaToDZ0rZA: folds
QHvTZcrKe6+maWUfVjP29Q: folds
TPZ+m9x+lwoKpv7TMfAUWA collected $2.50 from pot
*** SUMMARY ***
Total pot $2.50 | Rake $0
Seat 2: QHvTZcrKe6+maWUfVjP29Q (big blind) folded before Flop
Seat 3: TPZ+m9x+lwoKpv7TMfAUWA collected ($2.50)
Seat 4: +uSzP8Jwnw7sKfQ4s66b7w folded before Flop (didn't bet)
Seat 5: OGMLOcTNYZXZU81au7ztUw (button) folded before Flop (didn't bet)
Seat 6: XUk5GQsfNFpHvaToDZ0rZA (small blind) folded before Flop



PokerStars Game #59940117720:  Hold'em No Limit ($0.50/$1.00) - 2009/07/01 0:57:44 ET
Table 'U9zqzC8f3oTJ2ShXFgSSOA' 6-max Seat #6 is the button
Seat 1: iHo1oDbrEVJ8nEGdaPrICw ($105.90 in chips)
Seat 2: TSuRyAHnUPCFjP7Z0rEE0w ($100 in chips)
Seat 3: yfXek8iJ7O4CFyqXrtGcfg ($16.35 in chips)
Seat 5: KfwW5us6tydK81NYTtK1gw ($297.45 in chips)
Seat 6: 4OO5v3AVduL0tePNx8wk5A ($117.70 in chips)
iHo1oDbrEVJ8nEGdaPrICw: posts small blind $0.50
TSuRyAHnUPCFjP7Z0rEE0w: posts big blind $1
*** HOLE CARDS ***
yfXek8iJ7O4CFyqXrtGcfg: folds
KfwW5us6tydK81NYTtK1gw: folds
4OO5v3AVduL0tePNx8wk5A: raises $2 to $3
iHo1oDbrEVJ8nEGdaPrICw: folds
TSuRyAHnUPCFjP7Z0rEE0w: folds
4OO5v3AVduL0tePNx8wk5A collected $2.50 from pot
4OO5v3AVduL0tePNx8wk5A is sitting out
4OO5v3AVduL0tePNx8wk5A: doesn't show hand
*** SUMMARY ***
Total pot $2.50 | Rake $0
Seat 1: iHo1oDbrEVJ8nEGdaPrICw (small blind) folded before Flop
Seat 2: TSuRyAHnUPCFjP7Z0rEE0w (big blind) folded before Flop
Seat 3: yfXek8iJ7O4CFyqXrtGcfg folded before Flop (didn't bet)
Seat 5: KfwW5us6tydK81NYTtK1gw folded before Flop (didn't bet)
Seat 6: 4OO5v3AVduL0tePNx8wk5A (button) collected ($2.50)



PokerStars Game #59940117568:  Hold'em No Limit ($0.50/$1.00) - 2009/07/01 0:57:44 ET
Table 'LmXQK9xy3awB+qsPzI21Mw' 2-max Seat #1 is the button
Seat 1: NYi6JFscYNrofSXy4sM+Yw ($292.75 in chips)
Seat 2: TME8GvochpQAo8cmJwWmvA ($97.05 in chips)
NYi6JFscYNrofSXy4sM+Yw: posts small blind $0.50
TME8GvochpQAo8cmJwWmvA: posts big blind $1
*** HOLE CARDS ***
NYi6JFscYNrofSXy4sM+Yw: raises $2 to $3
TME8GvochpQAo8cmJwWmvA: calls $2
*** FLOP *** [5d Jd 9c]
TME8GvochpQAo8cmJwWmvA: checks
NYi6JFscYNrofSXy4sM+Yw: checks
*** TURN *** [5d Jd 9c] [Jc]
TME8GvochpQAo8cmJwWmvA: bets $2
NYi6JFscYNrofSXy4sM+Yw: folds
TME8GvochpQAo8cmJwWmvA collected $5.70 from pot
TME8GvochpQAo8cmJwWmvA: doesn't show hand
*** SUMMARY ***
Total pot $6 | Rake $0.30
Board [5d Jd 9c Jc]
Seat 1: NYi6JFscYNrofSXy4sM+Yw (button) (small blind) folded on the Turn
Seat 2: TME8GvochpQAo8cmJwWmvA (big blind) collected ($5.70)



PokerStars Game #59940117370:  Hold'em No Limit ($0.50/$1.00) - 2009/07/01 0:57:44 ET
Table 'vs/5jr6ciwjVQ5+Soc+u2A' 6-max Seat #1 is the button
Seat 1: /P4w1pHg2zHYg/4ubJ0dPw ($60 in chips)
Seat 2: XOIf9W+VAxhZqN+SYoyMKA ($116.35 in chips)
Seat 3: G5ZSSN6RSON3gkNvk/SmYg ($141.85 in chips)
Seat 4: wk6Ohn4GDozoOMHc4eb2rw ($87.95 in chips)
XOIf9W+VAxhZqN+SYoyMKA: posts small blind $0.50
G5ZSSN6RSON3gkNvk/SmYg: posts big blind $1
*** HOLE CARDS ***
2DwLxMUbmzvwY7o4/i47Xg leaves the table
wk6Ohn4GDozoOMHc4eb2rw: raises $1 to $2
/P4w1pHg2zHYg/4ubJ0dPw: folds
XOIf9W+VAxhZqN+SYoyMKA: folds
G5ZSSN6RSON3gkNvk/SmYg: calls $1
*** FLOP *** [6c Qs 3d]
G5ZSSN6RSON3gkNvk/SmYg: checks
wk6Ohn4GDozoOMHc4eb2rw: checks
*** TURN *** [6c Qs 3d] [2s]
G5ZSSN6RSON3gkNvk/SmYg: checks
wk6Ohn4GDozoOMHc4eb2rw: checks
*** RIVER *** [6c Qs 3d 2s] [4h]
G5ZSSN6RSON3gkNvk/SmYg: checks
wk6Ohn4GDozoOMHc4eb2rw: checks
*** SHOW DOWN ***
G5ZSSN6RSON3gkNvk/SmYg: shows [7s 9h] (high card Queen)
wk6Ohn4GDozoOMHc4eb2rw: shows [Jh Ts] (high card Queen - Jack kicker)
wk6Ohn4GDozoOMHc4eb2rw collected $4.30 from pot
*** SUMMARY ***
Total pot $4.50 | Rake $0.20
Board [6c Qs 3d 2s 4h]
Seat 1: /P4w1pHg2zHYg/4ubJ0dPw (button) folded before Flop (didn't bet)
Seat 2: XOIf9W+VAxhZqN+SYoyMKA (small blind) folded before Flop
Seat 3: G5ZSSN6RSON3gkNvk/SmYg (big blind) showed [7s 9h] and lost with high card Queen
Seat 4: wk6Ohn4GDozoOMHc4eb2rw showed [Jh Ts] and won ($4.30) with high card Queen



PokerStars Game #59940118772:  Hold'em No Limit ($0.50/$1.00) - 2009/07/01 0:57:46 ET
Table 'JOIm/fogLA7vSG0Vc6ME1A' 2-max Seat #1 is the button
Seat 1: NYi6JFscYNrofSXy4sM+Yw ($150.20 in chips)
Seat 2: F5lNTyZLIX9W2wQZ0plwgg ($99.60 in chips)
NYi6JFscYNrofSXy4sM+Yw: posts small blind $0.50
F5lNTyZLIX9W2wQZ0plwgg: posts big blind $1
*** HOLE CARDS ***
NYi6JFscYNrofSXy4sM+Yw: raises $2 to $3
F5lNTyZLIX9W2wQZ0plwgg: raises $2 to $5
NYi6JFscYNrofSXy4sM+Yw: calls $2
*** FLOP *** [6d 3d 9c]
F5lNTyZLIX9W2wQZ0plwgg: bets $8
NYi6JFscYNrofSXy4sM+Yw: folds
F5lNTyZLIX9W2wQZ0plwgg collected $9.50 from pot
F5lNTyZLIX9W2wQZ0plwgg: doesn't show hand
*** SUMMARY ***
Total pot $10 | Rake $0.50
Board [6d 3d 9c]
Seat 1: NYi6JFscYNrofSXy4sM+Yw (button) (small blind) folded on the Flop
Seat 2: F5lNTyZLIX9W2wQZ0plwgg (big blind) collected ($9.50)



PokerStars Game #59940122762:  Hold'em No Limit ($0.50/$1.00) - 2009/07/01 0:57:52 ET
Table 'fTlPiCj0utgzC/5io+I7ew' 6-max Seat #1 is the button
Seat 1: YMJG+F++3Aj6P8dAWda5fw ($92 in chips)
Seat 2: Qy/UBNbD2HaA0Ogxg8Sf3w ($127.35 in chips)
Seat 3: wL5HjWHHOSGc53xWMNKB9Q ($32.60 in chips)
Seat 4: uJVSceLggtsrJya+WtmUEA ($119.25 in chips)
Seat 5: bFrTkDcWGTxyvNul7GVdYg ($307.55 in chips)
Seat 6: /P4w1pHg2zHYg/4ubJ0dPw ($61.50 in chips)
Qy/UBNbD2HaA0Ogxg8Sf3w: posts small blind $0.50
wL5HjWHHOSGc53xWMNKB9Q: posts big blind $1
*** HOLE CARDS ***
uJVSceLggtsrJya+WtmUEA: folds
bFrTkDcWGTxyvNul7GVdYg: folds
/P4w1pHg2zHYg/4ubJ0dPw: folds
YMJG+F++3Aj6P8dAWda5fw: raises $2 to $3
Qy/UBNbD2HaA0Ogxg8Sf3w: folds
wL5HjWHHOSGc53xWMNKB9Q: calls $2
*** FLOP *** [7h 6c 2c]
wL5HjWHHOSGc53xWMNKB9Q: checks
YMJG+F++3Aj6P8dAWda5fw: checks
*** TURN *** [7h 6c 2c] [Jh]
wL5HjWHHOSGc53xWMNKB9Q: checks
YMJG+F++3Aj6P8dAWda5fw: bets $3.50
wL5HjWHHOSGc53xWMNKB9Q: folds
YMJG+F++3Aj6P8dAWda5fw collected $6.20 from pot
*** SUMMARY ***
Total pot $6.50 | Rake $0.30
Board [7h 6c 2c Jh]
Seat 1: YMJG+F++3Aj6P8dAWda5fw (button) collected ($6.20)
Seat 2: Qy/UBNbD2HaA0Ogxg8Sf3w (small blind) folded before Flop
Seat 3: wL5HjWHHOSGc53xWMNKB9Q (big blind) folded on the Turn
Seat 4: uJVSceLggtsrJya+WtmUEA folded before Flop (didn't bet)
Seat 5: bFrTkDcWGTxyvNul7GVdYg folded before Flop (didn't bet)
Seat 6: /P4w1pHg2zHYg/4ubJ0dPw folded before Flop (didn't bet)



PokerStars Game #59940124080:  Hold'em No Limit ($0.50/$1.00) - 2009/07/01 0:57:55 ET
Table 'VOs36P6NW+QyXeQ1B62kmA' 6-max Seat #4 is the button
Seat 1: AdLVjddOzm+sRNo1Bc3S6Q ($130.80 in chips)
Seat 2: 2UMlbaZ8n8AbRli0Yr0mDw ($38.35 in chips)
Seat 3: TSuRyAHnUPCFjP7Z0rEE0w ($106.40 in chips)
Seat 4: w02zQzNydODiyV9THKgo9w ($41.50 in chips)
Seat 5: ozrlafxxh1HmYdA0/h+MuA ($24.85 in chips)
Seat 6: slVKuQyEz8Qj4E3uLPYNXg ($100 in chips)
ozrlafxxh1HmYdA0/h+MuA: posts small blind $0.50
slVKuQyEz8Qj4E3uLPYNXg: posts big blind $1
*** HOLE CARDS ***
AdLVjddOzm+sRNo1Bc3S6Q: folds
AdLVjddOzm+sRNo1Bc3S6Q leaves the table
2UMlbaZ8n8AbRli0Yr0mDw: folds
TSuRyAHnUPCFjP7Z0rEE0w: folds
w02zQzNydODiyV9THKgo9w: calls $1
ozrlafxxh1HmYdA0/h+MuA: calls $0.50
slVKuQyEz8Qj4E3uLPYNXg: checks
*** FLOP *** [Qd Ah Th]
ozrlafxxh1HmYdA0/h+MuA: checks
slVKuQyEz8Qj4E3uLPYNXg: checks
w02zQzNydODiyV9THKgo9w: bets $2
ozrlafxxh1HmYdA0/h+MuA: folds
slVKuQyEz8Qj4E3uLPYNXg: folds
w02zQzNydODiyV9THKgo9w collected $2.85 from pot
*** SUMMARY ***
Total pot $3 | Rake $0.15
Board [Qd Ah Th]
Seat 1: AdLVjddOzm+sRNo1Bc3S6Q folded before Flop (didn't bet)
Seat 2: 2UMlbaZ8n8AbRli0Yr0mDw folded before Flop (didn't bet)
Seat 3: TSuRyAHnUPCFjP7Z0rEE0w folded before Flop (didn't bet)
Seat 4: w02zQzNydODiyV9THKgo9w (button) collected ($2.85)
Seat 5: ozrlafxxh1HmYdA0/h+MuA (small blind) folded on the Flop
Seat 6: slVKuQyEz8Qj4E3uLPYNXg (big blind) folded on the Flop



PokerStars Game #59940124864:  Hold'em No Limit ($0.50/$1.00) - 2009/07/01 0:57:56 ET
Table '7Nl0ffnjeK44/vmeexh3MQ' 9-max Seat #4 is the button
Seat 1: s7D3Y+k4Cj4D1cXHv7oj+Q ($87.20 in chips)
Seat 2: OGgaARGdJQT4awWVNQ957w ($100 in chips)
Seat 3: vR4IO10geOgvTW+LAUBv/A ($100 in chips)
Seat 4: bLbSOSmSOnqE0iTcH/5dxA ($113.50 in chips)
Seat 6: FVs16t7GgfWgQWt4JxsObQ ($32.50 in chips)
Seat 7: 997ViqAtWn1FPjJqcffwcA ($100 in chips)
Seat 9: ouwUBGRKnKK9uhn1G4Lf+A ($197 in chips)
FVs16t7GgfWgQWt4JxsObQ: posts small blind $0.50
997ViqAtWn1FPjJqcffwcA: posts big blind $1
D+W9Me7w6Hcx/WRUSKV0dw: sits out
*** HOLE CARDS ***
ouwUBGRKnKK9uhn1G4Lf+A: folds
s7D3Y+k4Cj4D1cXHv7oj+Q: calls $1
OGgaARGdJQT4awWVNQ957w: folds
vR4IO10geOgvTW+LAUBv/A: calls $1
bLbSOSmSOnqE0iTcH/5dxA: folds
FVs16t7GgfWgQWt4JxsObQ: calls $0.50
997ViqAtWn1FPjJqcffwcA: checks
*** FLOP *** [7d Jc Qd]
FVs16t7GgfWgQWt4JxsObQ: bets $2
997ViqAtWn1FPjJqcffwcA: folds
s7D3Y+k4Cj4D1cXHv7oj+Q: calls $2
vR4IO10geOgvTW+LAUBv/A: folds
*** TURN *** [7d Jc Qd] [Td]
61sfw5QTu62YYIt68OsdrA joins the table at seat #5
FVs16t7GgfWgQWt4JxsObQ: bets $3
s7D3Y+k4Cj4D1cXHv7oj+Q: calls $3
*** RIVER *** [7d Jc Qd Td] [8c]
FVs16t7GgfWgQWt4JxsObQ: bets $2
s7D3Y+k4Cj4D1cXHv7oj+Q: calls $2
*** SHOW DOWN ***
FVs16t7GgfWgQWt4JxsObQ: shows [Qs 4h] (a pair of Queens)
s7D3Y+k4Cj4D1cXHv7oj+Q: shows [7s Ts] (two pair, Tens and Sevens)
s7D3Y+k4Cj4D1cXHv7oj+Q collected $17.15 from pot
*** SUMMARY ***
Total pot $18 | Rake $0.85
Board [7d Jc Qd Td 8c]
Seat 1: s7D3Y+k4Cj4D1cXHv7oj+Q showed [7s Ts] and won ($17.15) with two pair, Tens and Sevens
Seat 2: OGgaARGdJQT4awWVNQ957w folded before Flop (didn't bet)
Seat 3: vR4IO10geOgvTW+LAUBv/A folded on the Flop
Seat 4: bLbSOSmSOnqE0iTcH/5dxA (button) folded before Flop (didn't bet)
Seat 6: FVs16t7GgfWgQWt4JxsObQ (small blind) showed [Qs 4h] and lost with a pair of Queens
Seat 7: 997ViqAtWn1FPjJqcffwcA (big blind) folded on the Flop
Seat 9: ouwUBGRKnKK9uhn1G4Lf+A folded before Flop (didn't bet)



PokerStars Game #59940126914:  Hold'em No Limit ($0.50/$1.00) - 2009/07/01 0:57:59 ET
Table 'LmXQK9xy3awB+qsPzI21Mw' 2-max Seat #2 is the button
Seat 1: NYi6JFscYNrofSXy4sM+Yw ($289.75 in chips)
Seat 2: TME8GvochpQAo8cmJwWmvA ($99.75 in chips)
TME8GvochpQAo8cmJwWmvA: posts small blind $0.50
NYi6JFscYNrofSXy4sM+Yw: posts big blind $1
*** HOLE CARDS ***
TME8GvochpQAo8cmJwWmvA: calls $0.50
NYi6JFscYNrofSXy4sM+Yw: checks
*** FLOP *** [Ac Ts 4d]
NYi6JFscYNrofSXy4sM+Yw: bets $2
TME8GvochpQAo8cmJwWmvA: calls $2
*** TURN *** [Ac Ts 4d] [9h]
NYi6JFscYNrofSXy4sM+Yw: checks
TME8GvochpQAo8cmJwWmvA: checks
*** RIVER *** [Ac Ts 4d 9h] [Qs]
NYi6JFscYNrofSXy4sM+Yw: checks
TME8GvochpQAo8cmJwWmvA: bets $3
NYi6JFscYNrofSXy4sM+Yw: folds
TME8GvochpQAo8cmJwWmvA collected $5.75 from pot
TME8GvochpQAo8cmJwWmvA: doesn't show hand
*** SUMMARY ***
Total pot $6 | Rake $0.25
Board [Ac Ts 4d 9h Qs]
Seat 1: NYi6JFscYNrofSXy4sM+Yw (big blind) folded on the River
Seat 2: TME8GvochpQAo8cmJwWmvA (button) (small blind) collected ($5.75)



PokerStars Game #59940127716:  Hold'em No Limit ($0.50/$1.00) - 2009/07/01 0:58:00 ET
Table 'W/wyObTiXZm+Ckkl3YxcSw' 6-max Seat #1 is the button
Seat 1: eUBBn2R56C1IQ6Cs/vitwg ($103.40 in chips)
Seat 2: oDiBRCaF0QVtd3kO6xZIXw ($106.65 in chips)
Seat 3: dxyNCn/qxfkGDUIf28Cbng ($85.90 in chips)
Seat 5: BdbmJTZZ47quA9vUWwXtlw ($61.35 in chips)
Seat 6: tS9JHB1h+FQ++qu8RwRNgg ($40.80 in chips)
oDiBRCaF0QVtd3kO6xZIXw: posts small blind $0.50
dxyNCn/qxfkGDUIf28Cbng: posts big blind $1
aYii2DmxlOlbC1wbGRBWvQ: sits out
*** HOLE CARDS ***
BdbmJTZZ47quA9vUWwXtlw: folds
tS9JHB1h+FQ++qu8RwRNgg: folds
eUBBn2R56C1IQ6Cs/vitwg: folds
oDiBRCaF0QVtd3kO6xZIXw: folds
dxyNCn/qxfkGDUIf28Cbng collected $1 from pot
*** SUMMARY ***
Total pot $1 | Rake $0
Seat 1: eUBBn2R56C1IQ6Cs/vitwg (button) folded before Flop (didn't bet)
Seat 2: oDiBRCaF0QVtd3kO6xZIXw (small blind) folded before Flop
Seat 3: dxyNCn/qxfkGDUIf28Cbng (big blind) collected ($1)
Seat 5: BdbmJTZZ47quA9vUWwXtlw folded before Flop (didn't bet)
Seat 6: tS9JHB1h+FQ++qu8RwRNgg folded before Flop (didn't bet)



PokerStars Game #59940127704:  Hold'em No Limit ($0.50/$1.00) - 2009/07/01 0:58:00 ET
Table 'hugOjcwJvzEwZbK7tyiWuQ' 9-max Seat #2 is the button
Seat 1: D+W9Me7w6Hcx/WRUSKV0dw ($20 in chips)
Seat 2: r27C1nIV4NS4+qbnrgBQSw ($261 in chips)
Seat 3: jDwhY1kCdc6EkAHbT7PJMQ ($101.15 in chips)
Seat 4: UWB3oeddt/GObx2Mix2Anw ($204.25 in chips)
Seat 5: 5BRGWf+R3nt2WS3b5xX+zA ($24.20 in chips)
Seat 6: gUUvmqdVlmvpal6B8nYrmg ($108.90 in chips)
Seat 7: FL3MrLspcF23LYvC4ipBOA ($111.80 in chips)
Seat 8: /zy+DB4S5fUQUSfZWFzYGw ($101 in chips)
jDwhY1kCdc6EkAHbT7PJMQ: posts small blind $0.50
UWB3oeddt/GObx2Mix2Anw: posts big blind $1
*** HOLE CARDS ***
5BRGWf+R3nt2WS3b5xX+zA: folds
gUUvmqdVlmvpal6B8nYrmg: folds
FL3MrLspcF23LYvC4ipBOA: folds
/zy+DB4S5fUQUSfZWFzYGw: folds
D+W9Me7w6Hcx/WRUSKV0dw: folds
r27C1nIV4NS4+qbnrgBQSw: folds
jDwhY1kCdc6EkAHbT7PJMQ: folds
UWB3oeddt/GObx2Mix2Anw collected $1 from pot
UWB3oeddt/GObx2Mix2Anw: doesn't show hand
*** SUMMARY ***
Total pot $1 | Rake $0
Seat 1: D+W9Me7w6Hcx/WRUSKV0dw folded before Flop (didn't bet)
Seat 2: r27C1nIV4NS4+qbnrgBQSw (button) folded before Flop (didn't bet)
Seat 3: jDwhY1kCdc6EkAHbT7PJMQ (small blind) folded before Flop
Seat 4: UWB3oeddt/GObx2Mix2Anw (big blind) collected ($1)
Seat 5: 5BRGWf+R3nt2WS3b5xX+zA folded before Flop (didn't bet)
Seat 6: gUUvmqdVlmvpal6B8nYrmg folded before Flop (didn't bet)
Seat 7: FL3MrLspcF23LYvC4ipBOA folded before Flop (didn't bet)
Seat 8: /zy+DB4S5fUQUSfZWFzYGw folded before Flop (didn't bet)



PokerStars Game #59940128078:  Hold'em No Limit ($0.50/$1.00) - 2009/07/01 0:58:01 ET
Table 'tLrtq7gDzxEvckNAI1OS5Q' 6-max Seat #6 is the button
Seat 2: QHvTZcrKe6+maWUfVjP29Q ($100.50 in chips)
Seat 3: TPZ+m9x+lwoKpv7TMfAUWA ($300.75 in chips)
Seat 4: +uSzP8Jwnw7sKfQ4s66b7w ($49.80 in chips)
Seat 5: OGMLOcTNYZXZU81au7ztUw ($165.65 in chips)
Seat 6: XUk5GQsfNFpHvaToDZ0rZA ($166.70 in chips)
QHvTZcrKe6+maWUfVjP29Q: posts small blind $0.50
TPZ+m9x+lwoKpv7TMfAUWA: posts big blind $1
*** HOLE CARDS ***
+uSzP8Jwnw7sKfQ4s66b7w: folds
OGMLOcTNYZXZU81au7ztUw: folds
XUk5GQsfNFpHvaToDZ0rZA: folds
QHvTZcrKe6+maWUfVjP29Q: folds
TPZ+m9x+lwoKpv7TMfAUWA collected $1 from pot
*** SUMMARY ***
Total pot $1 | Rake $0
Seat 2: QHvTZcrKe6+maWUfVjP29Q (small blind) folded before Flop
Seat 3: TPZ+m9x+lwoKpv7TMfAUWA (big blind) collected ($1)
Seat 4: +uSzP8Jwnw7sKfQ4s66b7w folded before Flop (didn't bet)
Seat 5: OGMLOcTNYZXZU81au7ztUw folded before Flop (didn't bet)
Seat 6: XUk5GQsfNFpHvaToDZ0rZA (button) folded before Flop (didn't bet)



PokerStars Game #59940127942:  Hold'em No Limit ($0.50/$1.00) - 2009/07/01 0:58:01 ET
Table 'cBDNutyLBKEk9+ptwsKmTw' 6-max Seat #2 is the button
Seat 1: xAU6q2/cwmby2sxmA8VcmA ($121.35 in chips)
Seat 2: 5lY8d6Cnm4HUkt/8FZSj4g ($78.15 in chips)
Seat 3: G5ZSSN6RSON3gkNvk/SmYg ($102.15 in chips)
Seat 4: 3q7F5QtzC30pSrn0nl9i+A ($29.50 in chips)
Seat 5: OGMLOcTNYZXZU81au7ztUw ($158.65 in chips)
Seat 6: NqVlOSH2lp+pp/TK3vvK5g ($43.25 in chips)
G5ZSSN6RSON3gkNvk/SmYg: posts small blind $0.50
3q7F5QtzC30pSrn0nl9i+A: posts big blind $1
*** HOLE CARDS ***
OGMLOcTNYZXZU81au7ztUw: folds
NqVlOSH2lp+pp/TK3vvK5g: raises $1 to $2
xAU6q2/cwmby2sxmA8VcmA: folds
5lY8d6Cnm4HUkt/8FZSj4g: folds
G5ZSSN6RSON3gkNvk/SmYg: folds
3q7F5QtzC30pSrn0nl9i+A: folds
NqVlOSH2lp+pp/TK3vvK5g collected $2.50 from pot
*** SUMMARY ***
Total pot $2.50 | Rake $0
Seat 1: xAU6q2/cwmby2sxmA8VcmA folded before Flop (didn't bet)
Seat 2: 5lY8d6Cnm4HUkt/8FZSj4g (button) folded before Flop (didn't bet)
Seat 3: G5ZSSN6RSON3gkNvk/SmYg (small blind) folded before Flop
Seat 4: 3q7F5QtzC30pSrn0nl9i+A (big blind) folded before Flop
Seat 5: OGMLOcTNYZXZU81au7ztUw folded before Flop (didn't bet)
Seat 6: NqVlOSH2lp+pp/TK3vvK5g collected ($2.50)



PokerStars Game #59940128382:  Hold'em No Limit ($0.50/$1.00) - 2009/07/01 0:58:02 ET
Table 'JOIm/fogLA7vSG0Vc6ME1A' 2-max Seat #2 is the button
Seat 1: NYi6JFscYNrofSXy4sM+Yw ($145.20 in chips)
Seat 2: F5lNTyZLIX9W2wQZ0plwgg ($104.10 in chips)
F5lNTyZLIX9W2wQZ0plwgg: posts small blind $0.50
NYi6JFscYNrofSXy4sM+Yw: posts big blind $1
*** HOLE CARDS ***
F5lNTyZLIX9W2wQZ0plwgg: raises $1 to $2
NYi6JFscYNrofSXy4sM+Yw: calls $1
*** FLOP *** [3d Jc 8h]
NYi6JFscYNrofSXy4sM+Yw: checks
F5lNTyZLIX9W2wQZ0plwgg: checks
*** TURN *** [3d Jc 8h] [6s]
NYi6JFscYNrofSXy4sM+Yw: bets $2.50
F5lNTyZLIX9W2wQZ0plwgg: calls $2.50
*** RIVER *** [3d Jc 8h 6s] [Kd]
NYi6JFscYNrofSXy4sM+Yw: checks
F5lNTyZLIX9W2wQZ0plwgg: checks
*** SHOW DOWN ***
NYi6JFscYNrofSXy4sM+Yw: shows [7h 6h] (a pair of Sixes)
F5lNTyZLIX9W2wQZ0plwgg: shows [4s 6c] (a pair of Sixes)
NYi6JFscYNrofSXy4sM+Yw collected $4.30 from pot
F5lNTyZLIX9W2wQZ0plwgg collected $4.30 from pot
*** SUMMARY ***
Total pot $9 | Rake $0.40
Board [3d Jc 8h 6s Kd]
Seat 1: NYi6JFscYNrofSXy4sM+Yw (big blind) showed [7h 6h] and won ($4.30) with a pair of Sixes
Seat 2: F5lNTyZLIX9W2wQZ0plwgg (button) (small blind) showed [4s 6c] and won ($4.30) with a pair of Sixes



PokerStars Game #59940130202:  Hold'em No Limit ($0.50/$1.00) - 2009/07/01 0:58:04 ET
Table 'Zka9tv1yilg0MvXWPQrShg' 9-max Seat #1 is the button
Seat 1: TZcz9MEWDA+WydgGruqqbw ($120.40 in chips)
Seat 3: gUUvmqdVlmvpal6B8nYrmg ($104.80 in chips)
Seat 4: stxmTgSicxShtrDxhOOX2g ($69.65 in chips)
Seat 5: /zy+DB4S5fUQUSfZWFzYGw ($123.40 in chips)
Seat 6: rY8wPoax1lS+HUY+I0FZDw ($160.70 in chips)
Seat 7: p1SafS90nb3Uft5LB0NkHw ($20.50 in chips)
Seat 9: 6daxhj43mWj04MOPTOmaYA ($94 in chips)
gUUvmqdVlmvpal6B8nYrmg: posts small blind $0.50
stxmTgSicxShtrDxhOOX2g: posts big blind $1
D+W9Me7w6Hcx/WRUSKV0dw: sits out
*** HOLE CARDS ***
kz9ziSiGUc+857heiKSayw has returned
/zy+DB4S5fUQUSfZWFzYGw: folds
rY8wPoax1lS+HUY+I0FZDw: folds
p1SafS90nb3Uft5LB0NkHw: folds
6daxhj43mWj04MOPTOmaYA: folds
TZcz9MEWDA+WydgGruqqbw: raises $2 to $3
gUUvmqdVlmvpal6B8nYrmg: calls $2.50
stxmTgSicxShtrDxhOOX2g: folds
*** FLOP *** [Ks 8d Td]
gUUvmqdVlmvpal6B8nYrmg: checks
TZcz9MEWDA+WydgGruqqbw: checks
*** TURN *** [Ks 8d Td] [Kc]
gUUvmqdVlmvpal6B8nYrmg: bets $3
TZcz9MEWDA+WydgGruqqbw: folds
gUUvmqdVlmvpal6B8nYrmg collected $6.65 from pot
*** SUMMARY ***
Total pot $7 | Rake $0.35
Board [Ks 8d Td Kc]
Seat 1: TZcz9MEWDA+WydgGruqqbw (button) folded on the Turn
Seat 3: gUUvmqdVlmvpal6B8nYrmg (small blind) collected ($6.65)
Seat 4: stxmTgSicxShtrDxhOOX2g (big blind) folded before Flop
Seat 5: /zy+DB4S5fUQUSfZWFzYGw folded before Flop (didn't bet)
Seat 6: rY8wPoax1lS+HUY+I0FZDw folded before Flop (didn't bet)
Seat 7: p1SafS90nb3Uft5LB0NkHw folded before Flop (didn't bet)
Seat 9: 6daxhj43mWj04MOPTOmaYA folded before Flop (didn't bet)



PokerStars Game #59940131686:  Hold'em No Limit ($0.50/$1.00) - 2009/07/01 0:58:07 ET
Table '+cA8mcmhaedZ7YcrDdhmeQ' 6-max Seat #3 is the button
Seat 1: lsLuWlcPA3Rh7kJVLzMh0Q ($300.50 in chips)
Seat 2: RqgF7gRoKgRNW8Zoi1ty4A ($105.95 in chips)
Seat 3: 7H5WkGzGvsv56y1iaqHvRg ($30.85 in chips)
Seat 4: 4OO5v3AVduL0tePNx8wk5A ($100 in chips)
Seat 5: +7hFKAL0b0O/n8G72TclJA ($62.65 in chips)
Seat 6: YfsTQsY/fxb+YqbdclTHuw ($27.45 in chips)
4OO5v3AVduL0tePNx8wk5A: posts small blind $0.50
+7hFKAL0b0O/n8G72TclJA: posts big blind $1
*** HOLE CARDS ***
YfsTQsY/fxb+YqbdclTHuw: calls $1
lsLuWlcPA3Rh7kJVLzMh0Q: folds
RqgF7gRoKgRNW8Zoi1ty4A: folds
7H5WkGzGvsv56y1iaqHvRg: calls $1
4OO5v3AVduL0tePNx8wk5A: folds
+7hFKAL0b0O/n8G72TclJA: raises $1 to $2
YfsTQsY/fxb+YqbdclTHuw: calls $1
7H5WkGzGvsv56y1iaqHvRg: calls $1
*** FLOP *** [3h 7d Jh]
+7hFKAL0b0O/n8G72TclJA: bets $4
YfsTQsY/fxb+YqbdclTHuw: folds
7H5WkGzGvsv56y1iaqHvRg: folds
+7hFKAL0b0O/n8G72TclJA collected $6.20 from pot
*** SUMMARY ***
Total pot $6.50 | Rake $0.30
Board [3h 7d Jh]
Seat 1: lsLuWlcPA3Rh7kJVLzMh0Q folded before Flop (didn't bet)
Seat 2: RqgF7gRoKgRNW8Zoi1ty4A folded before Flop (didn't bet)
Seat 3: 7H5WkGzGvsv56y1iaqHvRg (button) folded on the Flop
Seat 4: 4OO5v3AVduL0tePNx8wk5A (small blind) folded before Flop
Seat 5: +7hFKAL0b0O/n8G72TclJA (big blind) collected ($6.20)
Seat 6: YfsTQsY/fxb+YqbdclTHuw folded on the Flop



PokerStars Game #59940132254:  Hold'em No Limit ($0.50/$1.00) - 2009/07/01 0:58:08 ET
Table 'MUPc8FEpe/nR0BKSeReX6Q' 6-max Seat #6 is the button
Seat 2: xAU6q2/cwmby2sxmA8VcmA ($123.20 in chips)
Seat 3: wx3sQGkVi2x9wJXuWNHPBw ($231.85 in chips)
Seat 4: ZA1bp6g8IwtTxkUE4eCjDQ ($189.35 in chips)
Seat 5: UBZQqpnJZdTYYY1FTb0rLA ($103.55 in chips)
Seat 6: oxnw0GLLpFanjhGkxfRSqA ($33.70 in chips)
xAU6q2/cwmby2sxmA8VcmA: posts small blind $0.50
wx3sQGkVi2x9wJXuWNHPBw: posts big blind $1
*** HOLE CARDS ***
ZA1bp6g8IwtTxkUE4eCjDQ: calls $1
UBZQqpnJZdTYYY1FTb0rLA: folds
oxnw0GLLpFanjhGkxfRSqA: calls $1
xAU6q2/cwmby2sxmA8VcmA: folds
wx3sQGkVi2x9wJXuWNHPBw: checks
*** FLOP *** [Ah 5c Ac]
wx3sQGkVi2x9wJXuWNHPBw: checks
ZA1bp6g8IwtTxkUE4eCjDQ: bets $1
oxnw0GLLpFanjhGkxfRSqA: calls $1
wx3sQGkVi2x9wJXuWNHPBw: folds
*** TURN *** [Ah 5c Ac] [3h]
ZA1bp6g8IwtTxkUE4eCjDQ: checks
oxnw0GLLpFanjhGkxfRSqA: checks
*** RIVER *** [Ah 5c Ac 3h] [Ad]
ZA1bp6g8IwtTxkUE4eCjDQ: checks
oxnw0GLLpFanjhGkxfRSqA: bets $3
ZA1bp6g8IwtTxkUE4eCjDQ: calls $3
*** SHOW DOWN ***
oxnw0GLLpFanjhGkxfRSqA: shows [7c Qc] (three of a kind, Aces)
ZA1bp6g8IwtTxkUE4eCjDQ: shows [Ks Jc] (three of a kind, Aces - King kicker)
ZA1bp6g8IwtTxkUE4eCjDQ collected $10.95 from pot
*** SUMMARY ***
Total pot $11.50 | Rake $0.55
Board [Ah 5c Ac 3h Ad]
Seat 2: xAU6q2/cwmby2sxmA8VcmA (small blind) folded before Flop
Seat 3: wx3sQGkVi2x9wJXuWNHPBw (big blind) folded on the Flop
Seat 4: ZA1bp6g8IwtTxkUE4eCjDQ showed [Ks Jc] and won ($10.95) with three of a kind, Aces
Seat 5: UBZQqpnJZdTYYY1FTb0rLA folded before Flop (didn't bet)
Seat 6: oxnw0GLLpFanjhGkxfRSqA (button) showed [7c Qc] and lost with three of a kind, Aces



PokerStars Game #59940133004:  Hold'em No Limit ($0.50/$1.00) - 2009/07/01 0:58:09 ET
Table 'eU3bWpDDg3Z+9R4m4iVmog' 6-max Seat #2 is the button
Seat 1: TSuRyAHnUPCFjP7Z0rEE0w ($191.15 in chips)
Seat 2: 8CAoOzhmB8n3nRFf3V4BTg ($81.30 in chips)
Seat 3: rVMOzU7w5FddYPGhD7qN2Q ($49.15 in chips)
Seat 4: GDVIsbEJ/DOJsMKE4Asz0A ($88.60 in chips)
Seat 6: hpxXcmRkXXI9HE5+5/j/0Q ($120.10 in chips)
rVMOzU7w5FddYPGhD7qN2Q: posts small blind $0.50
GDVIsbEJ/DOJsMKE4Asz0A: posts big blind $1
*** HOLE CARDS ***
hpxXcmRkXXI9HE5+5/j/0Q: folds
TSuRyAHnUPCFjP7Z0rEE0w: folds
8CAoOzhmB8n3nRFf3V4BTg: folds
rVMOzU7w5FddYPGhD7qN2Q: calls $0.50
GDVIsbEJ/DOJsMKE4Asz0A: checks
*** FLOP *** [7h Td 4c]
rVMOzU7w5FddYPGhD7qN2Q: checks
GDVIsbEJ/DOJsMKE4Asz0A: bets $1
rVMOzU7w5FddYPGhD7qN2Q: folds
GDVIsbEJ/DOJsMKE4Asz0A collected $1.90 from pot
*** SUMMARY ***
Total pot $2 | Rake $0.10
Board [7h Td 4c]
Seat 1: TSuRyAHnUPCFjP7Z0rEE0w folded before Flop (didn't bet)
Seat 2: 8CAoOzhmB8n3nRFf3V4BTg (button) folded before Flop (didn't bet)
Seat 3: rVMOzU7w5FddYPGhD7qN2Q (small blind) folded on the Flop
Seat 4: GDVIsbEJ/DOJsMKE4Asz0A (big blind) collected ($1.90)
Seat 6: hpxXcmRkXXI9HE5+5/j/0Q folded before Flop (didn't bet)



PokerStars Game #59940133168:  Hold'em No Limit ($0.50/$1.00) - 2009/07/01 0:58:09 ET
Table 'GPp0HyAuggN8oE0sUWzPpA' 9-max Seat #1 is the button
Seat 1: qJr25HAtvv1w/7IBvjMM3g ($26 in chips)
Seat 2: m3U8I35Pn3gxKhoS2nmYIg ($57.20 in chips)
Seat 4: mBRWbnUl8diyBO1qTJaNzw ($108.80 in chips)
Seat 5: 0fXz44fzDo5QmhAaJCvFfA ($24.65 in chips)
Seat 6: BK/GtNPkSx0TdUDj82id5A ($10 in chips)
Seat 7: DHdbHyysD15wCAtx+BhUjA ($98.50 in chips)
Seat 9: VPF+HjszMvUIpy0CHIwH3A ($27.50 in chips)
m3U8I35Pn3gxKhoS2nmYIg: posts small blind $0.50
mBRWbnUl8diyBO1qTJaNzw: posts big blind $1
John86sand: sits out
*** HOLE CARDS ***
0fXz44fzDo5QmhAaJCvFfA: folds
BK/GtNPkSx0TdUDj82id5A: folds
DHdbHyysD15wCAtx+BhUjA: folds
VPF+HjszMvUIpy0CHIwH3A: folds
qJr25HAtvv1w/7IBvjMM3g: raises $3 to $4
m3U8I35Pn3gxKhoS2nmYIg: folds
mBRWbnUl8diyBO1qTJaNzw: folds
qJr25HAtvv1w/7IBvjMM3g collected $2.50 from pot
*** SUMMARY ***
Total pot $2.50 | Rake $0
Seat 1: qJr25HAtvv1w/7IBvjMM3g (button) collected ($2.50)
Seat 2: m3U8I35Pn3gxKhoS2nmYIg (small blind) folded before Flop
Seat 4: mBRWbnUl8diyBO1qTJaNzw (big blind) folded before Flop
Seat 5: 0fXz44fzDo5QmhAaJCvFfA folded before Flop (didn't bet)
Seat 6: BK/GtNPkSx0TdUDj82id5A folded before Flop (didn't bet)
Seat 7: DHdbHyysD15wCAtx+BhUjA folded before Flop (didn't bet)
Seat 9: VPF+HjszMvUIpy0CHIwH3A folded before Flop (didn't bet)



PokerStars Game #59940135270:  Hold'em No Limit ($0.50/$1.00) - 2009/07/01 0:58:13 ET
Table 'uNlePsyMIqzM691Xkrlk6Q' 9-max Seat #6 is the button
Seat 1: bLbSOSmSOnqE0iTcH/5dxA ($100 in chips)
Seat 2: +OqpStnt0FqbCfyHAWaLbg ($100.15 in chips)
Seat 3: h7qXkU57Bb8ZuPwMyxR8Ug ($16.15 in chips)
Seat 4: TZcz9MEWDA+WydgGruqqbw ($100 in chips)
Seat 5: 3obndzTJ6fECz8+wWhMd1w ($17 in chips)
Seat 6: myIxN7otsyr846M539YR8Q ($21.50 in chips)
Seat 7: w6cw9nzN7AvkkHBVVjykoQ ($54.75 in chips)
Seat 8: laA8va+Yv8WuMqT1zdR91g ($101 in chips)
Seat 9: vR4IO10geOgvTW+LAUBv/A ($101.50 in chips)
w6cw9nzN7AvkkHBVVjykoQ: posts small blind $0.50
laA8va+Yv8WuMqT1zdR91g: posts big blind $1
*** HOLE CARDS ***
vR4IO10geOgvTW+LAUBv/A: folds
bLbSOSmSOnqE0iTcH/5dxA: folds
+OqpStnt0FqbCfyHAWaLbg: folds
h7qXkU57Bb8ZuPwMyxR8Ug: folds
TZcz9MEWDA+WydgGruqqbw: folds
3obndzTJ6fECz8+wWhMd1w: folds
myIxN7otsyr846M539YR8Q: folds
w6cw9nzN7AvkkHBVVjykoQ: folds
laA8va+Yv8WuMqT1zdR91g collected $1 from pot
laA8va+Yv8WuMqT1zdR91g: doesn't show hand
*** SUMMARY ***
Total pot $1 | Rake $0
Seat 1: bLbSOSmSOnqE0iTcH/5dxA folded before Flop (didn't bet)
Seat 2: +OqpStnt0FqbCfyHAWaLbg folded before Flop (didn't bet)
Seat 3: h7qXkU57Bb8ZuPwMyxR8Ug folded before Flop (didn't bet)
Seat 4: TZcz9MEWDA+WydgGruqqbw folded before Flop (didn't bet)
Seat 5: 3obndzTJ6fECz8+wWhMd1w folded before Flop (didn't bet)
Seat 6: myIxN7otsyr846M539YR8Q (button) folded before Flop (didn't bet)
Seat 7: w6cw9nzN7AvkkHBVVjykoQ (small blind) folded before Flop
Seat 8: laA8va+Yv8WuMqT1zdR91g (big blind) collected ($1)
Seat 9: vR4IO10geOgvTW+LAUBv/A folded before Flop (didn't bet)



PokerStars Game #59940135424:  Hold'em No Limit ($0.50/$1.00) - 2009/07/01 0:58:13 ET
Table '/RZcOwpZpHQ+OwPwjsbnRw' 6-max Seat #1 is the button
Seat 1: Zboa6dColKGHBjLPUakZjw ($73.15 in chips)
Seat 2: +xW7QemQU0Fxs+4TnqBRow ($231.65 in chips)
Seat 3: XnT1yK2DD/5FL+0bwuEhqg ($46.45 in chips)
Seat 4: j7NIOHLZk7V2o9fOioO5ug ($100 in chips)
Seat 5: wx3sQGkVi2x9wJXuWNHPBw ($179.15 in chips)
Seat 6: XOIf9W+VAxhZqN+SYoyMKA ($255.85 in chips)
+xW7QemQU0Fxs+4TnqBRow: posts small blind $0.50
XnT1yK2DD/5FL+0bwuEhqg: posts big blind $1
*** HOLE CARDS ***
j7NIOHLZk7V2o9fOioO5ug: folds
wx3sQGkVi2x9wJXuWNHPBw: folds
XOIf9W+VAxhZqN+SYoyMKA: folds
Zboa6dColKGHBjLPUakZjw: folds
+xW7QemQU0Fxs+4TnqBRow: folds
XnT1yK2DD/5FL+0bwuEhqg collected $1 from pot
XnT1yK2DD/5FL+0bwuEhqg: doesn't show hand
*** SUMMARY ***
Total pot $1 | Rake $0
Seat 1: Zboa6dColKGHBjLPUakZjw (button) folded before Flop (didn't bet)
Seat 2: +xW7QemQU0Fxs+4TnqBRow (small blind) folded before Flop
Seat 3: XnT1yK2DD/5FL+0bwuEhqg (big blind) collected ($1)
Seat 4: j7NIOHLZk7V2o9fOioO5ug folded before Flop (didn't bet)
Seat 5: wx3sQGkVi2x9wJXuWNHPBw folded before Flop (didn't bet)
Seat 6: XOIf9W+VAxhZqN+SYoyMKA folded before Flop (didn't bet)



PokerStars Game #59940136742:  Hold'em No Limit ($0.50/$1.00) - 2009/07/01 0:58:15 ET
Table 'W/wyObTiXZm+Ckkl3YxcSw' 6-max Seat #2 is the button
Seat 1: eUBBn2R56C1IQ6Cs/vitwg ($103.40 in chips)
Seat 2: oDiBRCaF0QVtd3kO6xZIXw ($106.15 in chips)
Seat 3: dxyNCn/qxfkGDUIf28Cbng ($86.40 in chips)
Seat 4: aYii2DmxlOlbC1wbGRBWvQ ($100 in chips)
Seat 5: BdbmJTZZ47quA9vUWwXtlw ($61.35 in chips)
Seat 6: tS9JHB1h+FQ++qu8RwRNgg ($40.80 in chips)
dxyNCn/qxfkGDUIf28Cbng: posts small blind $0.50
aYii2DmxlOlbC1wbGRBWvQ: posts big blind $1
*** HOLE CARDS ***
BdbmJTZZ47quA9vUWwXtlw: folds
tS9JHB1h+FQ++qu8RwRNgg: folds
eUBBn2R56C1IQ6Cs/vitwg: folds
oDiBRCaF0QVtd3kO6xZIXw: raises $2 to $3
dxyNCn/qxfkGDUIf28Cbng: folds
aYii2DmxlOlbC1wbGRBWvQ: calls $2
*** FLOP *** [Jd Ac 3d]
aYii2DmxlOlbC1wbGRBWvQ: checks
oDiBRCaF0QVtd3kO6xZIXw: bets $5
aYii2DmxlOlbC1wbGRBWvQ: folds
aYii2DmxlOlbC1wbGRBWvQ is sitting out
oDiBRCaF0QVtd3kO6xZIXw collected $6.20 from pot
oDiBRCaF0QVtd3kO6xZIXw: doesn't show hand
*** SUMMARY ***
Total pot $6.50 | Rake $0.30
Board [Jd Ac 3d]
Seat 1: eUBBn2R56C1IQ6Cs/vitwg folded before Flop (didn't bet)
Seat 2: oDiBRCaF0QVtd3kO6xZIXw (button) collected ($6.20)
Seat 3: dxyNCn/qxfkGDUIf28Cbng (small blind) folded before Flop
Seat 4: aYii2DmxlOlbC1wbGRBWvQ (big blind) folded on the Flop
Seat 5: BdbmJTZZ47quA9vUWwXtlw folded before Flop (didn't bet)
Seat 6: tS9JHB1h+FQ++qu8RwRNgg folded before Flop (didn't bet)



PokerStars Game #59940136838:  Hold'em No Limit ($0.50/$1.00) - 2009/07/01 0:58:15 ET
Table 'U9zqzC8f3oTJ2ShXFgSSOA' 6-max Seat #1 is the button
Seat 1: iHo1oDbrEVJ8nEGdaPrICw ($105.40 in chips)
Seat 2: TSuRyAHnUPCFjP7Z0rEE0w ($100 in chips)
Seat 3: yfXek8iJ7O4CFyqXrtGcfg ($16.35 in chips)
Seat 5: KfwW5us6tydK81NYTtK1gw ($297.45 in chips)
TSuRyAHnUPCFjP7Z0rEE0w: posts small blind $0.50
yfXek8iJ7O4CFyqXrtGcfg: posts big blind $1
*** HOLE CARDS ***
KfwW5us6tydK81NYTtK1gw: folds
iHo1oDbrEVJ8nEGdaPrICw: folds
4OO5v3AVduL0tePNx8wk5A leaves the table
TSuRyAHnUPCFjP7Z0rEE0w: folds
yfXek8iJ7O4CFyqXrtGcfg collected $1 from pot
*** SUMMARY ***
Total pot $1 | Rake $0
Seat 1: iHo1oDbrEVJ8nEGdaPrICw (button) folded before Flop (didn't bet)
Seat 2: TSuRyAHnUPCFjP7Z0rEE0w (small blind) folded before Flop
Seat 3: yfXek8iJ7O4CFyqXrtGcfg (big blind) collected ($1)
Seat 5: KfwW5us6tydK81NYTtK1gw folded before Flop (didn't bet)



PokerStars Game #59940137462:  Hold'em No Limit ($0.50/$1.00) - 2009/07/01 0:58:16 ET
Table 'tLrtq7gDzxEvckNAI1OS5Q' 6-max Seat #2 is the button
Seat 2: QHvTZcrKe6+maWUfVjP29Q ($100 in chips)
Seat 3: TPZ+m9x+lwoKpv7TMfAUWA ($301.25 in chips)
Seat 4: +uSzP8Jwnw7sKfQ4s66b7w ($49.80 in chips)
Seat 5: OGMLOcTNYZXZU81au7ztUw ($165.65 in chips)
Seat 6: XUk5GQsfNFpHvaToDZ0rZA ($166.70 in chips)
TPZ+m9x+lwoKpv7TMfAUWA: posts small blind $0.50
+uSzP8Jwnw7sKfQ4s66b7w: posts big blind $1
*** HOLE CARDS ***
OGMLOcTNYZXZU81au7ztUw: folds
XUk5GQsfNFpHvaToDZ0rZA: folds
QHvTZcrKe6+maWUfVjP29Q: folds
TPZ+m9x+lwoKpv7TMfAUWA: raises $2 to $3
+uSzP8Jwnw7sKfQ4s66b7w: calls $2
*** FLOP *** [7c Jc 7d]
TPZ+m9x+lwoKpv7TMfAUWA: bets $4
+uSzP8Jwnw7sKfQ4s66b7w: folds
TPZ+m9x+lwoKpv7TMfAUWA collected $5.70 from pot
*** SUMMARY ***
Total pot $6 | Rake $0.30
Board [7c Jc 7d]
Seat 2: QHvTZcrKe6+maWUfVjP29Q (button) folded before Flop (didn't bet)
Seat 3: TPZ+m9x+lwoKpv7TMfAUWA (small blind) collected ($5.70)
Seat 4: +uSzP8Jwnw7sKfQ4s66b7w (big blind) folded on the Flop
Seat 5: OGMLOcTNYZXZU81au7ztUw folded before Flop (didn't bet)
Seat 6: XUk5GQsfNFpHvaToDZ0rZA folded before Flop (didn't bet)



PokerStars Game #59940137544:  Hold'em No Limit ($0.50/$1.00) - 2009/07/01 0:58:16 ET
Table 'tyUh+jyNvrceIQdKMJjQ2wZFWj23PMihdwrNWv41OG/Qeat #3 is the button
Seat 1: o8A5MUdudVKu+pAwgZOX2w ($172.20 in chips)
Seat 2: XvUbOIg94d25feWeQlOTVg ($154 in chips)
Seat 3: TalCiLYHCd+ffkmR3auPvA ($93.10 in chips)
Seat 4: TSuRyAHnUPCFjP7Z0rEE0w ($110.25 in chips)
Seat 5: j7NIOHLZk7V2o9fOioO5ug ($118.30 in chips)
TSuRyAHnUPCFjP7Z0rEE0w: posts small blind $0.50
j7NIOHLZk7V2o9fOioO5ug: posts big blind $1
4OO5v3AVduL0tePNx8wk5A: sits out
*** HOLE CARDS ***
o8A5MUdudVKu+pAwgZOX2w: folds
XvUbOIg94d25feWeQlOTVg: calls $1
TalCiLYHCd+ffkmR3auPvA: calls $1
TSuRyAHnUPCFjP7Z0rEE0w: folds
j7NIOHLZk7V2o9fOioO5ug: checks
*** FLOP *** [9h Ts Ah]
j7NIOHLZk7V2o9fOioO5ug: bets $4
XvUbOIg94d25feWeQlOTVg: folds
TalCiLYHCd+ffkmR3auPvA: folds
j7NIOHLZk7V2o9fOioO5ug collected $3.35 from pot
j7NIOHLZk7V2o9fOioO5ug: doesn't show hand
*** SUMMARY ***
Total pot $3.50 | Rake $0.15
Board [9h Ts Ah]
Seat 1: o8A5MUdudVKu+pAwgZOX2w folded before Flop (didn't bet)
Seat 2: XvUbOIg94d25feWeQlOTVg folded on the Flop
Seat 3: TalCiLYHCd+ffkmR3auPvA (button) folded on the Flop
Seat 4: TSuRyAHnUPCFjP7Z0rEE0w (small blind) folded before Flop
Seat 5: j7NIOHLZk7V2o9fOioO5ug (big blind) collected ($3.35)



PokerStars Game #59940138068:  Hold'em No Limit ($0.50/$1.00) - 2009/07/01 0:58:17 ET
Table 'pHrhryH8jPNdQfY62f8v+g' 6-max Seat #2 is the button
Seat 1: OvwYHV65yUbgdBjSmo1+5g ($58.50 in chips)
Seat 2: RqgF7gRoKgRNW8Zoi1ty4A ($100 in chips)
Seat 3: 8oS5O7iD/qnFXFXJrGIgNQ ($155.30 in chips)
Seat 4: DHjG71KHeyQxu3OZ+fFd4w ($22.70 in chips)
Seat 5: r1/R7y0Ortgoz4lccgW8VA ($52.05 in chips)
Seat 6: xAU6q2/cwmby2sxmA8VcmA ($113.30 in chips)
8oS5O7iD/qnFXFXJrGIgNQ: posts small blind $0.50
DHjG71KHeyQxu3OZ+fFd4w: posts big blind $1
*** HOLE CARDS ***
r1/R7y0Ortgoz4lccgW8VA: calls $1
xAU6q2/cwmby2sxmA8VcmA: raises $3 to $4
OvwYHV65yUbgdBjSmo1+5g: calls $4
RqgF7gRoKgRNW8Zoi1ty4A: calls $4
8oS5O7iD/qnFXFXJrGIgNQ: folds
DHjG71KHeyQxu3OZ+fFd4w: calls $3
r1/R7y0Ortgoz4lccgW8VA: calls $3
*** FLOP *** [Qh 4d Ks]
DHjG71KHeyQxu3OZ+fFd4w: checks
r1/R7y0Ortgoz4lccgW8VA: checks
xAU6q2/cwmby2sxmA8VcmA: checks
OvwYHV65yUbgdBjSmo1+5g: bets $4
RqgF7gRoKgRNW8Zoi1ty4A: raises $8 to $12
DHjG71KHeyQxu3OZ+fFd4w: folds
r1/R7y0Ortgoz4lccgW8VA: folds
xAU6q2/cwmby2sxmA8VcmA: folds
OvwYHV65yUbgdBjSmo1+5g: folds
RqgF7gRoKgRNW8Zoi1ty4A collected $27.15 from pot
*** SUMMARY ***
Total pot $28.50 | Rake $1.35
Board [Qh 4d Ks]
Seat 1: OvwYHV65yUbgdBjSmo1+5g folded on the Flop
Seat 2: RqgF7gRoKgRNW8Zoi1ty4A (button) collected ($27.15)
Seat 3: 8oS5O7iD/qnFXFXJrGIgNQ (small blind) folded before Flop
Seat 4: DHjG71KHeyQxu3OZ+fFd4w (big blind) folded on the Flop
Seat 5: r1/R7y0Ortgoz4lccgW8VA folded on the Flop
Seat 6: xAU6q2/cwmby2sxmA8VcmA folded on the Flop



PokerStars Game #59940138154:  Hold'em No Limit ($0.50/$1.00) - 2009/07/01 0:58:17 ET
Table 'JOIm/fogLA7vSG0Vc6ME1A' 2-max Seat #1 is the button
Seat 1: NYi6JFscYNrofSXy4sM+Yw ($145 in chips)
Seat 2: F5lNTyZLIX9W2wQZ0plwgg ($103.90 in chips)
NYi6JFscYNrofSXy4sM+Yw: posts small blind $0.50
F5lNTyZLIX9W2wQZ0plwgg: posts big blind $1
*** HOLE CARDS ***
NYi6JFscYNrofSXy4sM+Yw: raises $2 to $3
F5lNTyZLIX9W2wQZ0plwgg: calls $2
*** FLOP *** [6d 4s As]
F5lNTyZLIX9W2wQZ0plwgg: bets $1
NYi6JFscYNrofSXy4sM+Yw: raises $6 to $7
F5lNTyZLIX9W2wQZ0plwgg: calls $6
*** TURN *** [6d 4s As] [Kd]
F5lNTyZLIX9W2wQZ0plwgg: bets $3
NYi6JFscYNrofSXy4sM+Yw: raises $12 to $15
F5lNTyZLIX9W2wQZ0plwgg: folds
NYi6JFscYNrofSXy4sM+Yw collected $25.50 from pot
*** SUMMARY ***
Total pot $26 | Rake $0.50
Board [6d 4s As Kd]
Seat 1: NYi6JFscYNrofSXy4sM+Yw (button) (small blind) collected ($25.50)
Seat 2: F5lNTyZLIX9W2wQZ0plwgg (big blind) folded on the Turn



PokerStars Game #59940138466:  Hold'em No Limit ($0.50/$1.00) - 2009/07/01 0:58:18 ET
Table '7O9fB8yx1u7sJveJn8w6jA' 6-max Seat #4 is the button
Seat 2: wx3sQGkVi2x9wJXuWNHPBw ($196.95 in chips)
Seat 3: hpxXcmRkXXI9HE5+5/j/0Q ($100 in chips)
Seat 4: XIZSmlGttGgSRaIU42K4Fg ($143.90 in chips)
Seat 5: BCEV3COoKY607AzLWayfRA ($100 in chips)
Seat 6: UBZQqpnJZdTYYY1FTb0rLA ($130.45 in chips)
BCEV3COoKY607AzLWayfRA: posts small blind $0.50
UBZQqpnJZdTYYY1FTb0rLA: posts big blind $1
*** HOLE CARDS ***
wx3sQGkVi2x9wJXuWNHPBw: folds
hpxXcmRkXXI9HE5+5/j/0Q: folds
XIZSmlGttGgSRaIU42K4Fg: folds
BCEV3COoKY607AzLWayfRA: folds
UBZQqpnJZdTYYY1FTb0rLA collected $1 from pot
UBZQqpnJZdTYYY1FTb0rLA: doesn't show hand
*** SUMMARY ***
Total pot $1 | Rake $0
Seat 2: wx3sQGkVi2x9wJXuWNHPBw folded before Flop (didn't bet)
Seat 3: hpxXcmRkXXI9HE5+5/j/0Q folded before Flop (didn't bet)
Seat 4: XIZSmlGttGgSRaIU42K4Fg (button) folded before Flop (didn't bet)
Seat 5: BCEV3COoKY607AzLWayfRA (small blind) folded before Flop
Seat 6: UBZQqpnJZdTYYY1FTb0rLA (big blind) collected ($1)



PokerStars Game #59940139250:  Hold'em No Limit ($0.50/$1.00) - 2009/07/01 0:58:19 ET
Table 'LmXQK9xy3awB+qsPzI21Mw' 2-max Seat #1 is the button
Seat 1: NYi6JFscYNrofSXy4sM+Yw ($286.75 in chips)
Seat 2: TME8GvochpQAo8cmJwWmvA ($102.50 in chips)
NYi6JFscYNrofSXy4sM+Yw: posts small blind $0.50
TME8GvochpQAo8cmJwWmvA: posts big blind $1
*** HOLE CARDS ***
NYi6JFscYNrofSXy4sM+Yw: raises $2 to $3
TME8GvochpQAo8cmJwWmvA: calls $2
*** FLOP *** [Ks 7s 4c]
TME8GvochpQAo8cmJwWmvA: checks
NYi6JFscYNrofSXy4sM+Yw: bets $3
TME8GvochpQAo8cmJwWmvA: calls $3
*** TURN *** [Ks 7s 4c] [Kc]
TME8GvochpQAo8cmJwWmvA: checks
NYi6JFscYNrofSXy4sM+Yw: checks
*** RIVER *** [Ks 7s 4c Kc] [6s]
TME8GvochpQAo8cmJwWmvA: bets $4
NYi6JFscYNrofSXy4sM+Yw: folds
TME8GvochpQAo8cmJwWmvA collected $11.50 from pot
TME8GvochpQAo8cmJwWmvA: doesn't show hand
*** SUMMARY ***
Total pot $12 | Rake $0.50
Board [Ks 7s 4c Kc 6s]
Seat 1: NYi6JFscYNrofSXy4sM+Yw (button) (small blind) folded on the River
Seat 2: TME8GvochpQAo8cmJwWmvA (big blind) collected ($11.50)



PokerStars Game #59940140012:  Hold'em No Limit ($0.50/$1.00) - 2009/07/01 0:58:20 ET
Table '/FUb199IViHMJHi5YWmeuQ' 9-max Seat #1 is the button
Seat 1: TZcz9MEWDA+WydgGruqqbw ($120 in chips)
Seat 2: FL3MrLspcF23LYvC4ipBOA ($174.90 in chips)
Seat 3: qN483QJ1NvHbdIZB7J4ARw ($23.20 in chips)
Seat 4: qheQay5YvP2DMAb3OUSxtw ($143.35 in chips)
Seat 5: kiakSwxX0e64PwYGAPQvLw ($31.25 in chips)
Seat 6: ccFf7Q4z1cTGQmeoYiWEfw ($56.45 in chips)
Seat 7: bLbSOSmSOnqE0iTcH/5dxA ($100.20 in chips)
Seat 8: 997ViqAtWn1FPjJqcffwcA ($103 in chips)
Seat 9: RfLbneGRY8yQUpMgDnJCxA ($63.95 in chips)
FL3MrLspcF23LYvC4ipBOA: posts small blind $0.50
qN483QJ1NvHbdIZB7J4ARw: posts big blind $1
*** HOLE CARDS ***
qheQay5YvP2DMAb3OUSxtw: folds
kiakSwxX0e64PwYGAPQvLw: folds
ccFf7Q4z1cTGQmeoYiWEfw: folds
bLbSOSmSOnqE0iTcH/5dxA: folds
997ViqAtWn1FPjJqcffwcA: folds
RfLbneGRY8yQUpMgDnJCxA: folds
TZcz9MEWDA+WydgGruqqbw: folds
FL3MrLspcF23LYvC4ipBOA: folds
qN483QJ1NvHbdIZB7J4ARw collected $1 from pot
*** SUMMARY ***
Total pot $1 | Rake $0
Seat 1: TZcz9MEWDA+WydgGruqqbw (button) folded before Flop (didn't bet)
Seat 2: FL3MrLspcF23LYvC4ipBOA (small blind) folded before Flop
Seat 3: qN483QJ1NvHbdIZB7J4ARw (big blind) collected ($1)
Seat 4: qheQay5YvP2DMAb3OUSxtw folded before Flop (didn't bet)
Seat 5: kiakSwxX0e64PwYGAPQvLw folded before Flop (didn't bet)
Seat 6: ccFf7Q4z1cTGQmeoYiWEfw folded before Flop (didn't bet)
Seat 7: bLbSOSmSOnqE0iTcH/5dxA folded before Flop (didn't bet)
Seat 8: 997ViqAtWn1FPjJqcffwcA folded before Flop (didn't bet)
Seat 9: RfLbneGRY8yQUpMgDnJCxA folded before Flop (didn't bet)



PokerStars Game #59940140194:  Hold'em No Limit ($0.50/$1.00) - 2009/07/01 0:58:21 ET
Table 'GxCPo/gd3OSthkYrAxJngg' 6-max Seat #1 is the button
Seat 1: sH8BpAFP+jGFxCgVpD1Lew ($266.80 in chips)
Seat 2: YExX2paeIHrmfIwV1ivM/w ($78.20 in chips)
Seat 3: o6plE+MSW4XFNTeONe16xg ($28.10 in chips)
Seat 4: YMJG+F++3Aj6P8dAWda5fw ($203.10 in chips)
Seat 5: G5ZSSN6RSON3gkNvk/SmYg ($105.25 in chips)
YExX2paeIHrmfIwV1ivM/w: posts small blind $0.50
o6plE+MSW4XFNTeONe16xg: posts big blind $1
*** HOLE CARDS ***
YMJG+F++3Aj6P8dAWda5fw: folds
G5ZSSN6RSON3gkNvk/SmYg: folds
sH8BpAFP+jGFxCgVpD1Lew: raises $2 to $3
YExX2paeIHrmfIwV1ivM/w: folds
o6plE+MSW4XFNTeONe16xg: calls $2
*** FLOP *** [Th 3s 3c]
o6plE+MSW4XFNTeONe16xg: checks
sH8BpAFP+jGFxCgVpD1Lew: checks
*** TURN *** [Th 3s 3c] [8d]
o6plE+MSW4XFNTeONe16xg: checks
sH8BpAFP+jGFxCgVpD1Lew: checks
*** RIVER *** [Th 3s 3c 8d] [Ah]
o6plE+MSW4XFNTeONe16xg: bets $1
sH8BpAFP+jGFxCgVpD1Lew: calls $1
*** SHOW DOWN ***
o6plE+MSW4XFNTeONe16xg: shows [Qh Js] (a pair of Threes)
sH8BpAFP+jGFxCgVpD1Lew: shows [7s Ks] (a pair of Threes - Ace+King kicker)
sH8BpAFP+jGFxCgVpD1Lew collected $8.10 from pot
*** SUMMARY ***
Total pot $8.50 | Rake $0.40
Board [Th 3s 3c 8d Ah]
Seat 1: sH8BpAFP+jGFxCgVpD1Lew (button) showed [7s Ks] and won ($8.10) with a pair of Threes
Seat 2: YExX2paeIHrmfIwV1ivM/w (small blind) folded before Flop
Seat 3: o6plE+MSW4XFNTeONe16xg (big blind) showed [Qh Js] and lost with a pair of Threes
Seat 4: YMJG+F++3Aj6P8dAWda5fw folded before Flop (didn't bet)
Seat 5: G5ZSSN6RSON3gkNvk/SmYg folded before Flop (didn't bet)



PokerStars Game #59940142350:  Hold'em No Limit ($0.50/$1.00) - 2009/07/01 0:58:24 ET
Table '6YvsYDPNIDx2v5z3bJnwZQ' 9-max Seat #4 is the button
Seat 1: Ogn4JDV3mp4ZDKO49IFzKA ($22.70 in chips)
Seat 2: +hHqYgKILitkxIzFNGvvsA ($34 in chips)
Seat 3: negfosHnGOZXSHpWDRKyBQ ($16.50 in chips)
Seat 4: kEr5NYB+JIG5+szcYMr6hA ($36.75 in chips)
Seat 5: mBRWbnUl8diyBO1qTJaNzw ($164.20 in chips)
Seat 6: 7RSwrjMohkYrZAhOd1uaZg ($11 in chips)
Seat 7: mae7OMTaJ/MFimNbZegCkg ($52.30 in chips)
Seat 8: PSFxpXgPedVZyHSu2Zhb7Q ($109.80 in chips)
Seat 9: ZgMRSHJ9EOtPeVHmdeV9kQ ($50 in chips)
mBRWbnUl8diyBO1qTJaNzw: posts small blind $0.50
7RSwrjMohkYrZAhOd1uaZg: posts big blind $1
*** HOLE CARDS ***
mae7OMTaJ/MFimNbZegCkg: folds
PSFxpXgPedVZyHSu2Zhb7Q: folds
ZgMRSHJ9EOtPeVHmdeV9kQ: raises $1 to $2
Ogn4JDV3mp4ZDKO49IFzKA: folds
+hHqYgKILitkxIzFNGvvsA: calls $2
negfosHnGOZXSHpWDRKyBQ: folds
kEr5NYB+JIG5+szcYMr6hA: folds
mBRWbnUl8diyBO1qTJaNzw: calls $1.50
7RSwrjMohkYrZAhOd1uaZg: calls $1
*** FLOP *** [7h Td Jd]
mBRWbnUl8diyBO1qTJaNzw: checks
7RSwrjMohkYrZAhOd1uaZg: checks
ZgMRSHJ9EOtPeVHmdeV9kQ: bets $3
+hHqYgKILitkxIzFNGvvsA: calls $3
mBRWbnUl8diyBO1qTJaNzw: folds
7RSwrjMohkYrZAhOd1uaZg: folds
*** TURN *** [7h Td Jd] [4c]
ZgMRSHJ9EOtPeVHmdeV9kQ: checks
+hHqYgKILitkxIzFNGvvsA: checks
*** RIVER *** [7h Td Jd 4c] [4h]
ZgMRSHJ9EOtPeVHmdeV9kQ: checks
+hHqYgKILitkxIzFNGvvsA: bets $1
ZgMRSHJ9EOtPeVHmdeV9kQ: calls $1
*** SHOW DOWN ***
+hHqYgKILitkxIzFNGvvsA: shows [5h Jh] (two pair, Jacks and Fours)
ZgMRSHJ9EOtPeVHmdeV9kQ: mucks hand
+hHqYgKILitkxIzFNGvvsA collected $15.25 from pot
*** SUMMARY ***
Total pot $16 | Rake $0.75
Board [7h Td Jd 4c 4h]
Seat 1: Ogn4JDV3mp4ZDKO49IFzKA folded before Flop (didn't bet)
Seat 2: +hHqYgKILitkxIzFNGvvsA showed [5h Jh] and won ($15.25) with two pair, Jacks and Fours
Seat 3: negfosHnGOZXSHpWDRKyBQ folded before Flop (didn't bet)
Seat 4: kEr5NYB+JIG5+szcYMr6hA (button) folded before Flop (didn't bet)
Seat 5: mBRWbnUl8diyBO1qTJaNzw (small blind) folded on the Flop
Seat 6: 7RSwrjMohkYrZAhOd1uaZg (big blind) folded on the Flop
Seat 7: mae7OMTaJ/MFimNbZegCkg folded before Flop (didn't bet)
Seat 8: PSFxpXgPedVZyHSu2Zhb7Q folded before Flop (didn't bet)
Seat 9: ZgMRSHJ9EOtPeVHmdeV9kQ mucked



PokerStars Game #59940143538:  Hold'em No Limit ($0.50/$1.00) - 2009/07/01 0:58:26 ET
Table 'VOs36P6NW+QyXeQ1B62kmA' 6-max Seat #5 is the button
Seat 2: 2UMlbaZ8n8AbRli0Yr0mDw ($38.35 in chips)
Seat 3: TSuRyAHnUPCFjP7Z0rEE0w ($106.40 in chips)
Seat 4: w02zQzNydODiyV9THKgo9w ($43.35 in chips)
Seat 5: ozrlafxxh1HmYdA0/h+MuA ($23.85 in chips)
Seat 6: slVKuQyEz8Qj4E3uLPYNXg ($99 in chips)
slVKuQyEz8Qj4E3uLPYNXg: posts small blind $0.50
2UMlbaZ8n8AbRli0Yr0mDw: posts big blind $1
*** HOLE CARDS ***
TSuRyAHnUPCFjP7Z0rEE0w: folds
w02zQzNydODiyV9THKgo9w: folds
Z2fXsGcjl+Eax+RzOgwOmg joins the table at seat #1
ozrlafxxh1HmYdA0/h+MuA: folds
slVKuQyEz8Qj4E3uLPYNXg: folds
2UMlbaZ8n8AbRli0Yr0mDw collected $1 from pot
*** SUMMARY ***
Total pot $1 | Rake $0
Seat 2: 2UMlbaZ8n8AbRli0Yr0mDw (big blind) collected ($1)
Seat 3: TSuRyAHnUPCFjP7Z0rEE0w folded before Flop (didn't bet)
Seat 4: w02zQzNydODiyV9THKgo9w folded before Flop (didn't bet)
Seat 5: ozrlafxxh1HmYdA0/h+MuA (button) folded before Flop (didn't bet)
Seat 6: slVKuQyEz8Qj4E3uLPYNXg (small blind) folded before Flop



PokerStars Game #59940144142:  Hold'em No Limit ($0.50/$1.00) - 2009/07/01 0:58:27 ET
Table '8jIjWCPY0NGprquL+xcMFg' 9-max Seat #8 is the button
Seat 2: laA8va+Yv8WuMqT1zdR91g ($110.20 in chips)
Seat 3: tjhwe1V98x2spSoUQER3HQ ($104.50 in chips)
Seat 4: Jjc7EHWzs4//xUAjJ0UWoA ($19.90 in chips)
Seat 5: 2YpnxJiexJHyERfbqgwEcw ($82.55 in chips)
Seat 6: GTQkFJtSkbVbnGCktp6e3g ($101.35 in chips)
Seat 7: O3CGPwwUmamrCNHccOilrg ($45.45 in chips)
Seat 8: D+W9Me7w6Hcx/WRUSKV0dw ($18.50 in chips)
Seat 9: negfosHnGOZXSHpWDRKyBQ ($22 in chips)
negfosHnGOZXSHpWDRKyBQ: posts small blind $0.50
vR4IO10geOgvTW+LAUBv/A: is sitting out
laA8va+Yv8WuMqT1zdR91g: posts big blind $1
*** HOLE CARDS ***
vR4IO10geOgvTW+LAUBv/A leaves the table
tjhwe1V98x2spSoUQER3HQ: folds
Jjc7EHWzs4//xUAjJ0UWoA: calls $1
2YpnxJiexJHyERfbqgwEcw: raises $3 to $4
GTQkFJtSkbVbnGCktp6e3g: folds
O3CGPwwUmamrCNHccOilrg: calls $4
D+W9Me7w6Hcx/WRUSKV0dw: folds
N7iZ0peZns5o4A6AjN24jQ joins the table at seat #1
negfosHnGOZXSHpWDRKyBQ: raises $18 to $22 and is all-in
laA8va+Yv8WuMqT1zdR91g: folds
Jjc7EHWzs4//xUAjJ0UWoA: folds
2YpnxJiexJHyERfbqgwEcw: calls $18
O3CGPwwUmamrCNHccOilrg: folds
*** FLOP *** [Qd 3c Qc]
*** TURN *** [Qd 3c Qc] [8c]
*** RIVER *** [Qd 3c Qc 8c] [5c]
*** SHOW DOWN ***
negfosHnGOZXSHpWDRKyBQ: shows [Ac 6c] (a flush, Ace high)
2YpnxJiexJHyERfbqgwEcw: mucks hand
negfosHnGOZXSHpWDRKyBQ collected $47.50 from pot
*** SUMMARY ***
Total pot $50 | Rake $2.50
Board [Qd 3c Qc 8c 5c]
Seat 2: laA8va+Yv8WuMqT1zdR91g (big blind) folded before Flop
Seat 3: tjhwe1V98x2spSoUQER3HQ folded before Flop (didn't bet)
Seat 4: Jjc7EHWzs4//xUAjJ0UWoA folded before Flop
Seat 5: 2YpnxJiexJHyERfbqgwEcw mucked
Seat 6: GTQkFJtSkbVbnGCktp6e3g folded before Flop (didn't bet)
Seat 7: O3CGPwwUmamrCNHccOilrg folded before Flop
Seat 8: D+W9Me7w6Hcx/WRUSKV0dw (button) folded before Flop (didn't bet)
Seat 9: negfosHnGOZXSHpWDRKyBQ (small blind) showed [Ac 6c] and won ($47.50) with a flush, Ace high



PokerStars Game #59940143706:  Hold'em No Limit ($0.50/$1.00) - 2009/07/01 0:58:27 ET
Table 'U9zqzC8f3oTJ2ShXFgSSOA' 6-max Seat #2 is the button
Seat 1: iHo1oDbrEVJ8nEGdaPrICw ($105.40 in chips)
Seat 2: TSuRyAHnUPCFjP7Z0rEE0w ($100 in chips)
Seat 3: yfXek8iJ7O4CFyqXrtGcfg ($16.85 in chips)
Seat 5: KfwW5us6tydK81NYTtK1gw ($297.45 in chips)
yfXek8iJ7O4CFyqXrtGcfg: posts small blind $0.50
KfwW5us6tydK81NYTtK1gw: posts big blind $1
*** HOLE CARDS ***
iHo1oDbrEVJ8nEGdaPrICw: folds
TSuRyAHnUPCFjP7Z0rEE0w: folds
yfXek8iJ7O4CFyqXrtGcfg: calls $0.50
KfwW5us6tydK81NYTtK1gw: checks
*** FLOP *** [Qc Js 2c]
yfXek8iJ7O4CFyqXrtGcfg: bets $2
KfwW5us6tydK81NYTtK1gw: folds
yfXek8iJ7O4CFyqXrtGcfg collected $1.90 from pot
*** SUMMARY ***
Total pot $2 | Rake $0.10
Board [Qc Js 2c]
Seat 1: iHo1oDbrEVJ8nEGdaPrICw folded before Flop (didn't bet)
Seat 2: TSuRyAHnUPCFjP7Z0rEE0w (button) folded before Flop (didn't bet)
Seat 3: yfXek8iJ7O4CFyqXrtGcfg (small blind) collected ($1.90)
Seat 5: KfwW5us6tydK81NYTtK1gw (big blind) folded on the Flop



PokerStars Game #59940143840:  Hold'em No Limit ($0.50/$1.00) - 2009/07/01 0:58:27 ET
Table 'rmZfTK+oSebeUPJNbWhdAA' 6-max Seat #4 is the button
Seat 1: xAU6q2/cwmby2sxmA8VcmA ($148 in chips)
Seat 2: z7O9PO/WEcqRouIydFhS9Q ($100 in chips)
Seat 3: BCEV3COoKY607AzLWayfRA ($135.50 in chips)
Seat 4: 1/mIuXfgx1ZyVkodrmfQDw ($100 in chips)
Seat 5: 5lY8d6Cnm4HUkt/8FZSj4g ($111.60 in chips)
Seat 6: j7NIOHLZk7V2o9fOioO5ug ($119.80 in chips)
5lY8d6Cnm4HUkt/8FZSj4g: posts small blind $0.50
j7NIOHLZk7V2o9fOioO5ug: posts big blind $1
*** HOLE CARDS ***
xAU6q2/cwmby2sxmA8VcmA: folds
z7O9PO/WEcqRouIydFhS9Q: folds
BCEV3COoKY607AzLWayfRA: folds
1/mIuXfgx1ZyVkodrmfQDw: folds
5lY8d6Cnm4HUkt/8FZSj4g: calls $0.50
j7NIOHLZk7V2o9fOioO5ug: checks
*** FLOP *** [Qc 5d 6s]
5lY8d6Cnm4HUkt/8FZSj4g: bets $3
j7NIOHLZk7V2o9fOioO5ug: folds
5lY8d6Cnm4HUkt/8FZSj4g collected $1.90 from pot
5lY8d6Cnm4HUkt/8FZSj4g: doesn't show hand
*** SUMMARY ***
Total pot $2 | Rake $0.10
Board [Qc 5d 6s]
Seat 1: xAU6q2/cwmby2sxmA8VcmA folded before Flop (didn't bet)
Seat 2: z7O9PO/WEcqRouIydFhS9Q folded before Flop (didn't bet)
Seat 3: BCEV3COoKY607AzLWayfRA folded before Flop (didn't bet)
Seat 4: 1/mIuXfgx1ZyVkodrmfQDw (button) folded before Flop (didn't bet)
Seat 5: 5lY8d6Cnm4HUkt/8FZSj4g (small blind) collected ($1.90)
Seat 6: j7NIOHLZk7V2o9fOioO5ug (big blind) folded on the Flop



PokerStars Game #59940144466:  Hold'em No Limit ($0.50/$1.00) - 2009/07/01 0:58:28 ET
Table 'mmbQQVBTrPdE+wy+s+9VPA' 6-max Seat #4 is the button
Seat 1: zyP4SPoWZnKUfTvIRLCVog ($55 in chips)
Seat 2: cl/QpVR/PLO58lj+C5mGLw ($24 in chips)
Seat 3: wx3sQGkVi2x9wJXuWNHPBw ($113.65 in chips)
Seat 4: V3iZdcw61nXF3g5hD2RrsQ ($100 in chips)
Seat 5: YMJG+F++3Aj6P8dAWda5fw ($98.50 in chips)
Seat 6: U2CWBTv29qdCbj8RNF2sIw ($105.40 in chips)
YMJG+F++3Aj6P8dAWda5fw: posts small blind $0.50
U2CWBTv29qdCbj8RNF2sIw: posts big blind $1
*** HOLE CARDS ***
zyP4SPoWZnKUfTvIRLCVog: folds
cl/QpVR/PLO58lj+C5mGLw: folds
wx3sQGkVi2x9wJXuWNHPBw: folds
V3iZdcw61nXF3g5hD2RrsQ: folds
YMJG+F++3Aj6P8dAWda5fw: folds
U2CWBTv29qdCbj8RNF2sIw collected $1 from pot
*** SUMMARY ***
Total pot $1 | Rake $0
Seat 1: zyP4SPoWZnKUfTvIRLCVog folded before Flop (didn't bet)
Seat 2: cl/QpVR/PLO58lj+C5mGLw folded before Flop (didn't bet)
Seat 3: wx3sQGkVi2x9wJXuWNHPBw folded before Flop (didn't bet)
Seat 4: V3iZdcw61nXF3g5hD2RrsQ (button) folded before Flop (didn't bet)
Seat 5: YMJG+F++3Aj6P8dAWda5fw (small blind) folded before Flop
Seat 6: U2CWBTv29qdCbj8RNF2sIw (big blind) collected ($1)



PokerStars Game #59940144632:  Hold'em No Limit ($0.50/$1.00) - 2009/07/01 0:58:28 ET
Table 'cKH9c4x6u79IqCdaKKvXrw' 9-max Seat #7 is the button
Seat 1: Pp/KTcXkfZKKUHkjyaLTdg ($17 in chips)
Seat 2: 8S3JMH4TY3whgIlZmMv66w ($70.15 in chips)
Seat 3: 997ViqAtWn1FPjJqcffwcA ($157.10 in chips)
Seat 4: FL3MrLspcF23LYvC4ipBOA ($100 in chips)
Seat 5: Jjc7EHWzs4//xUAjJ0UWoA ($42.15 in chips)
Seat 6: Bsd/K5gAcLanYbGiPirRjw ($210.55 in chips)
Seat 7: 1GkkVBhlJ92guE6K5mS5Ig ($10.30 in chips)
Seat 8: myIxN7otsyr846M539YR8Q ($19 in chips)
Seat 9: 6XkTu4ahxzHnvjjc1R8YjQ ($43.10 in chips)
myIxN7otsyr846M539YR8Q: posts small blind $0.50
6XkTu4ahxzHnvjjc1R8YjQ: posts big blind $1
*** HOLE CARDS ***
Pp/KTcXkfZKKUHkjyaLTdg: folds
8S3JMH4TY3whgIlZmMv66w: calls $1
997ViqAtWn1FPjJqcffwcA: folds
FL3MrLspcF23LYvC4ipBOA: folds
Jjc7EHWzs4//xUAjJ0UWoA: folds
Bsd/K5gAcLanYbGiPirRjw: folds
1GkkVBhlJ92guE6K5mS5Ig: calls $1
myIxN7otsyr846M539YR8Q: folds
6XkTu4ahxzHnvjjc1R8YjQ: checks
*** FLOP *** [Kh 5h 9h]
6XkTu4ahxzHnvjjc1R8YjQ: checks
8S3JMH4TY3whgIlZmMv66w: checks
1GkkVBhlJ92guE6K5mS5Ig: bets $2
6XkTu4ahxzHnvjjc1R8YjQ: folds
8S3JMH4TY3whgIlZmMv66w: folds
1GkkVBhlJ92guE6K5mS5Ig collected $3.35 from pot
*** SUMMARY ***
Total pot $3.50 | Rake $0.15
Board [Kh 5h 9h]
Seat 1: Pp/KTcXkfZKKUHkjyaLTdg folded before Flop (didn't bet)
Seat 2: 8S3JMH4TY3whgIlZmMv66w folded on the Flop
Seat 3: 997ViqAtWn1FPjJqcffwcA folded before Flop (didn't bet)
Seat 4: FL3MrLspcF23LYvC4ipBOA folded before Flop (didn't bet)
Seat 5: Jjc7EHWzs4//xUAjJ0UWoA folded before Flop (didn't bet)
Seat 6: Bsd/K5gAcLanYbGiPirRjw folded before Flop (didn't bet)
Seat 7: 1GkkVBhlJ92guE6K5mS5Ig (button) collected ($3.35)
Seat 8: myIxN7otsyr846M539YR8Q (small blind) folded before Flop
Seat 9: 6XkTu4ahxzHnvjjc1R8YjQ (big blind) folded on the Flop



PokerStars Game #59940145226:  Hold'em No Limit ($0.50/$1.00) - 2009/07/01 0:58:29 ET
Table 'eU3bWpDDg3Z+9R4m4iVmog' 6-max Seat #3 is the button
Seat 1: TSuRyAHnUPCFjP7Z0rEE0w ($191.15 in chips)
Seat 2: 8CAoOzhmB8n3nRFf3V4BTg ($81.30 in chips)
Seat 3: rVMOzU7w5FddYPGhD7qN2Q ($48.15 in chips)
Seat 4: GDVIsbEJ/DOJsMKE4Asz0A ($89.50 in chips)
Seat 6: hpxXcmRkXXI9HE5+5/j/0Q ($120.10 in chips)
GDVIsbEJ/DOJsMKE4Asz0A: posts small blind $0.50
hpxXcmRkXXI9HE5+5/j/0Q: posts big blind $1
*** HOLE CARDS ***
TSuRyAHnUPCFjP7Z0rEE0w: folds
8CAoOzhmB8n3nRFf3V4BTg: raises $3 to $4
rVMOzU7w5FddYPGhD7qN2Q: folds
GDVIsbEJ/DOJsMKE4Asz0A: calls $3.50
hpxXcmRkXXI9HE5+5/j/0Q: folds
*** FLOP *** [6d 8h 3d]
GDVIsbEJ/DOJsMKE4Asz0A: checks
8CAoOzhmB8n3nRFf3V4BTg: bets $6
GDVIsbEJ/DOJsMKE4Asz0A: calls $6
*** TURN *** [6d 8h 3d] [9c]
GDVIsbEJ/DOJsMKE4Asz0A: checks
8CAoOzhmB8n3nRFf3V4BTg: checks
*** RIVER *** [6d 8h 3d 9c] [8s]
GDVIsbEJ/DOJsMKE4Asz0A: bets $11
8CAoOzhmB8n3nRFf3V4BTg: folds
GDVIsbEJ/DOJsMKE4Asz0A collected $20 from pot
GDVIsbEJ/DOJsMKE4Asz0A: doesn't show hand
*** SUMMARY ***
Total pot $21 | Rake $1
Board [6d 8h 3d 9c 8s]
Seat 1: TSuRyAHnUPCFjP7Z0rEE0w folded before Flop (didn't bet)
Seat 2: 8CAoOzhmB8n3nRFf3V4BTg folded on the River
Seat 3: rVMOzU7w5FddYPGhD7qN2Q (button) folded before Flop (didn't bet)
Seat 4: GDVIsbEJ/DOJsMKE4Asz0A (small blind) collected ($20)
Seat 6: hpxXcmRkXXI9HE5+5/j/0Q (big blind) folded before Flop



PokerStars Game #59940146322:  Hold'em No Limit ($0.50/$1.00) - 2009/07/01 0:58:31 ET
Table 'hugOjcwJvzEwZbK7tyiWuQ' 9-max Seat #3 is the button
Seat 1: D+W9Me7w6Hcx/WRUSKV0dw ($20 in chips)
Seat 2: r27C1nIV4NS4+qbnrgBQSw ($261 in chips)
Seat 3: jDwhY1kCdc6EkAHbT7PJMQ ($100.65 in chips)
Seat 4: UWB3oeddt/GObx2Mix2Anw ($204.75 in chips)
Seat 5: 5BRGWf+R3nt2WS3b5xX+zA ($24.20 in chips)
Seat 6: gUUvmqdVlmvpal6B8nYrmg ($108.90 in chips)
Seat 7: FL3MrLspcF23LYvC4ipBOA ($111.80 in chips)
Seat 8: /zy+DB4S5fUQUSfZWFzYGw ($101 in chips)
UWB3oeddt/GObx2Mix2Anw: posts small blind $0.50
5BRGWf+R3nt2WS3b5xX+zA: posts big blind $1
*** HOLE CARDS ***
gUUvmqdVlmvpal6B8nYrmg: folds
FL3MrLspcF23LYvC4ipBOA: folds
/zy+DB4S5fUQUSfZWFzYGw: folds
D+W9Me7w6Hcx/WRUSKV0dw: folds
r27C1nIV4NS4+qbnrgBQSw: folds
jDwhY1kCdc6EkAHbT7PJMQ: raises $3 to $4
UWB3oeddt/GObx2Mix2Anw: folds
5BRGWf+R3nt2WS3b5xX+zA: calls $3
*** FLOP *** [7s Js 5h]
5BRGWf+R3nt2WS3b5xX+zA: checks
jDwhY1kCdc6EkAHbT7PJMQ: bets $5
5BRGWf+R3nt2WS3b5xX+zA: folds
jDwhY1kCdc6EkAHbT7PJMQ collected $8.10 from pot
*** SUMMARY ***
Total pot $8.50 | Rake $0.40
Board [7s Js 5h]
Seat 1: D+W9Me7w6Hcx/WRUSKV0dw folded before Flop (didn't bet)
Seat 2: r27C1nIV4NS4+qbnrgBQSw folded before Flop (didn't bet)
Seat 3: jDwhY1kCdc6EkAHbT7PJMQ (button) collected ($8.10)
Seat 4: UWB3oeddt/GObx2Mix2Anw (small blind) folded before Flop
Seat 5: 5BRGWf+R3nt2WS3b5xX+zA (big blind) folded on the Flop
Seat 6: gUUvmqdVlmvpal6B8nYrmg folded before Flop (didn't bet)
Seat 7: FL3MrLspcF23LYvC4ipBOA folded before Flop (didn't bet)
Seat 8: /zy+DB4S5fUQUSfZWFzYGw folded before Flop (didn't bet)



PokerStars Game #59940146938:  Hold'em No Limit ($0.50/$1.00) - 2009/07/01 0:58:32 ET
Table '/RZcOwpZpHQ+OwPwjsbnRw' 6-max Seat #2 is the button
Seat 1: Zboa6dColKGHBjLPUakZjw ($73.15 in chips)
Seat 2: +xW7QemQU0Fxs+4TnqBRow ($231.15 in chips)
Seat 3: XnT1yK2DD/5FL+0bwuEhqg ($46.95 in chips)
Seat 4: j7NIOHLZk7V2o9fOioO5ug ($100 in chips)
Seat 5: wx3sQGkVi2x9wJXuWNHPBw ($179.15 in chips)
Seat 6: XOIf9W+VAxhZqN+SYoyMKA ($255.85 in chips)
XnT1yK2DD/5FL+0bwuEhqg: posts small blind $0.50
j7NIOHLZk7V2o9fOioO5ug: posts big blind $1
*** HOLE CARDS ***
wx3sQGkVi2x9wJXuWNHPBw: folds
XOIf9W+VAxhZqN+SYoyMKA: folds
Zboa6dColKGHBjLPUakZjw: folds
+xW7QemQU0Fxs+4TnqBRow: folds
XnT1yK2DD/5FL+0bwuEhqg: calls $0.50
j7NIOHLZk7V2o9fOioO5ug: checks
*** FLOP *** [9c 6s 5s]
XnT1yK2DD/5FL+0bwuEhqg: bets $2
j7NIOHLZk7V2o9fOioO5ug: calls $2
*** TURN *** [9c 6s 5s] [Qs]
XnT1yK2DD/5FL+0bwuEhqg: bets $4
j7NIOHLZk7V2o9fOioO5ug: calls $4
*** RIVER *** [9c 6s 5s Qs] [2s]
XnT1yK2DD/5FL+0bwuEhqg: checks
j7NIOHLZk7V2o9fOioO5ug: checks
*** SHOW DOWN ***
XnT1yK2DD/5FL+0bwuEhqg: shows [2h 6h] (two pair, Sixes and Deuces)
j7NIOHLZk7V2o9fOioO5ug: mucks hand
XnT1yK2DD/5FL+0bwuEhqg collected $13.35 from pot
*** SUMMARY ***
Total pot $14 | Rake $0.65
Board [9c 6s 5s Qs 2s]
Seat 1: Zboa6dColKGHBjLPUakZjw folded before Flop (didn't bet)
Seat 2: +xW7QemQU0Fxs+4TnqBRow (button) folded before Flop (didn't bet)
Seat 3: XnT1yK2DD/5FL+0bwuEhqg (small blind) showed [2h 6h] and won ($13.35) with two pair, Sixes and Deuces
Seat 4: j7NIOHLZk7V2o9fOioO5ug (big blind) mucked
Seat 5: wx3sQGkVi2x9wJXuWNHPBw folded before Flop (didn't bet)
Seat 6: XOIf9W+VAxhZqN+SYoyMKA folded before Flop (didn't bet)



PokerStars Game #59940147322:  Hold'em No Limit ($0.50/$1.00) - 2009/07/01 0:58:33 ET
Table 'iSx0wTgVb4o7MyZeOe06ZA' 9-max Seat #5 is the button
Seat 2: myIxN7otsyr846M539YR8Q ($20 in chips)
Seat 3: XQV7mCMbzd2Wh/l74wmbug ($82.15 in chips)
Seat 5: o1axyw4AjQ8n4ubTwlirQQ ($22 in chips)
Seat 6: T5/PXFS/W+LLcIXBo1G/RA ($105.65 in chips)
Seat 7: w4NnqVr/Sfoj65ux/fEUyQ ($79.40 in chips)
Seat 8: gUUvmqdVlmvpal6B8nYrmg ($100 in chips)
Seat 9: DMQXVuViR4IFzRccosBkJw ($69.05 in chips)
T5/PXFS/W+LLcIXBo1G/RA: posts small blind $0.50
w4NnqVr/Sfoj65ux/fEUyQ: posts big blind $1
VPF+HjszMvUIpy0CHIwH3A: sits out
0fXz44fzDo5QmhAaJCvFfA: sits out
*** HOLE CARDS ***
gUUvmqdVlmvpal6B8nYrmg: raises $1 to $2
DMQXVuViR4IFzRccosBkJw: raises $4 to $6
myIxN7otsyr846M539YR8Q: folds
XQV7mCMbzd2Wh/l74wmbug: calls $6
o1axyw4AjQ8n4ubTwlirQQ: folds
T5/PXFS/W+LLcIXBo1G/RA: folds
w4NnqVr/Sfoj65ux/fEUyQ: folds
gUUvmqdVlmvpal6B8nYrmg: folds
*** FLOP *** [4c 9s Ts]
DMQXVuViR4IFzRccosBkJw: bets $5
XQV7mCMbzd2Wh/l74wmbug: raises $10 to $15
DMQXVuViR4IFzRccosBkJw: folds
XQV7mCMbzd2Wh/l74wmbug collected $24.30 from pot
*** SUMMARY ***
Total pot $25.50 | Rake $1.20
Board [4c 9s Ts]
Seat 2: myIxN7otsyr846M539YR8Q folded before Flop (didn't bet)
Seat 3: XQV7mCMbzd2Wh/l74wmbug collected ($24.30)
Seat 5: o1axyw4AjQ8n4ubTwlirQQ (button) folded before Flop (didn't bet)
Seat 6: T5/PXFS/W+LLcIXBo1G/RA (small blind) folded before Flop
Seat 7: w4NnqVr/Sfoj65ux/fEUyQ (big blind) folded before Flop
Seat 8: gUUvmqdVlmvpal6B8nYrmg folded before Flop
Seat 9: DMQXVuViR4IFzRccosBkJw folded on the Flop



PokerStars Game #59940147280:  Hold'em No Limit ($0.50/$1.00) - 2009/07/01 0:58:33 ET
Table '7O9fB8yx1u7sJveJn8w6jA' 6-max Seat #5 is the button
Seat 2: wx3sQGkVi2x9wJXuWNHPBw ($196.95 in chips)
Seat 3: hpxXcmRkXXI9HE5+5/j/0Q ($100 in chips)
Seat 4: XIZSmlGttGgSRaIU42K4Fg ($143.90 in chips)
Seat 5: BCEV3COoKY607AzLWayfRA ($100 in chips)
Seat 6: UBZQqpnJZdTYYY1FTb0rLA ($130.95 in chips)
UBZQqpnJZdTYYY1FTb0rLA: posts small blind $0.50
wx3sQGkVi2x9wJXuWNHPBw: posts big blind $1
*** HOLE CARDS ***
hpxXcmRkXXI9HE5+5/j/0Q: folds
XIZSmlGttGgSRaIU42K4Fg: folds
BCEV3COoKY607AzLWayfRA: raises $3 to $4
UBZQqpnJZdTYYY1FTb0rLA: folds
wx3sQGkVi2x9wJXuWNHPBw: folds
BCEV3COoKY607AzLWayfRA collected $2.50 from pot
BCEV3COoKY607AzLWayfRA: doesn't show hand
*** SUMMARY ***
Total pot $2.50 | Rake $0
Seat 2: wx3sQGkVi2x9wJXuWNHPBw (big blind) folded before Flop
Seat 3: hpxXcmRkXXI9HE5+5/j/0Q folded before Flop (didn't bet)
Seat 4: XIZSmlGttGgSRaIU42K4Fg folded before Flop (didn't bet)
Seat 5: BCEV3COoKY607AzLWayfRA (button) collected ($2.50)
Seat 6: UBZQqpnJZdTYYY1FTb0rLA (small blind) folded before Flop



PokerStars Game #59940150058:  Hold'em No Limit ($0.50/$1.00) - 2009/07/01 0:58:37 ET
Table 'cBDNutyLBKEk9+ptwsKmTw' 6-max Seat #3 is the button
Seat 1: xAU6q2/cwmby2sxmA8VcmA ($121.35 in chips)
Seat 2: 5lY8d6Cnm4HUkt/8FZSj4g ($78.15 in chips)
Seat 3: G5ZSSN6RSON3gkNvk/SmYg ($101.65 in chips)
Seat 4: 3q7F5QtzC30pSrn0nl9i+A ($28.50 in chips)
Seat 5: OGMLOcTNYZXZU81au7ztUw ($158.65 in chips)
Seat 6: NqVlOSH2lp+pp/TK3vvK5g ($44.75 in chips)
3q7F5QtzC30pSrn0nl9i+A: posts small blind $0.50
OGMLOcTNYZXZU81au7ztUw: posts big blind $1
*** HOLE CARDS ***
NqVlOSH2lp+pp/TK3vvK5g: raises $1 to $2
xAU6q2/cwmby2sxmA8VcmA: folds
5lY8d6Cnm4HUkt/8FZSj4g: folds
G5ZSSN6RSON3gkNvk/SmYg: folds
3q7F5QtzC30pSrn0nl9i+A: calls $1.50
OGMLOcTNYZXZU81au7ztUw: folds
*** FLOP *** [Ad 7c 5h]
3q7F5QtzC30pSrn0nl9i+A: bets $1
NqVlOSH2lp+pp/TK3vvK5g: raises $1 to $2
3q7F5QtzC30pSrn0nl9i+A: calls $1
*** TURN *** [Ad 7c 5h] [3d]
3q7F5QtzC30pSrn0nl9i+A: bets $3
NqVlOSH2lp+pp/TK3vvK5g: calls $3
*** RIVER *** [Ad 7c 5h 3d] [6s]
3q7F5QtzC30pSrn0nl9i+A: checks
NqVlOSH2lp+pp/TK3vvK5g: checks
*** SHOW DOWN ***
3q7F5QtzC30pSrn0nl9i+A: shows [3h As] (two pair, Aces and Threes)
NqVlOSH2lp+pp/TK3vvK5g: mucks hand
3q7F5QtzC30pSrn0nl9i+A collected $14.30 from pot
*** SUMMARY ***
Total pot $15 | Rake $0.70
Board [Ad 7c 5h 3d 6s]
Seat 1: xAU6q2/cwmby2sxmA8VcmA folded before Flop (didn't bet)
Seat 2: 5lY8d6Cnm4HUkt/8FZSj4g folded before Flop (didn't bet)
Seat 3: G5ZSSN6RSON3gkNvk/SmYg (button) folded before Flop (didn't bet)
Seat 4: 3q7F5QtzC30pSrn0nl9i+A (small blind) showed [3h As] and won ($14.30) with two pair, Aces and Threes
Seat 5: OGMLOcTNYZXZU81au7ztUw (big blind) folded before Flop
Seat 6: NqVlOSH2lp+pp/TK3vvK5g mucked



PokerStars Game #59940151628:  Hold'em No Limit ($0.50/$1.00) - 2009/07/01 0:58:40 ET
Table '+cA8mcmhaedZ7YcrDdhmeQ' 6-max Seat #4 is the button
Seat 1: lsLuWlcPA3Rh7kJVLzMh0Q ($300.50 in chips)
Seat 2: RqgF7gRoKgRNW8Zoi1ty4A ($105.95 in chips)
Seat 3: 7H5WkGzGvsv56y1iaqHvRg ($28.85 in chips)
Seat 4: 4OO5v3AVduL0tePNx8wk5A ($100 in chips)
Seat 5: +7hFKAL0b0O/n8G72TclJA ($66.85 in chips)
Seat 6: YfsTQsY/fxb+YqbdclTHuw ($25.45 in chips)
+7hFKAL0b0O/n8G72TclJA: posts small blind $0.50
YfsTQsY/fxb+YqbdclTHuw: posts big blind $1
*** HOLE CARDS ***
lsLuWlcPA3Rh7kJVLzMh0Q: folds
RqgF7gRoKgRNW8Zoi1ty4A: folds
7H5WkGzGvsv56y1iaqHvRg: folds
4OO5v3AVduL0tePNx8wk5A: folds
+7hFKAL0b0O/n8G72TclJA: folds
YfsTQsY/fxb+YqbdclTHuw collected $1 from pot
*** SUMMARY ***
Total pot $1 | Rake $0
Seat 1: lsLuWlcPA3Rh7kJVLzMh0Q folded before Flop (didn't bet)
Seat 2: RqgF7gRoKgRNW8Zoi1ty4A folded before Flop (didn't bet)
Seat 3: 7H5WkGzGvsv56y1iaqHvRg folded before Flop (didn't bet)
Seat 4: 4OO5v3AVduL0tePNx8wk5A (button) folded before Flop (didn't bet)
Seat 5: +7hFKAL0b0O/n8G72TclJA (small blind) folded before Flop
Seat 6: YfsTQsY/fxb+YqbdclTHuw (big blind) collected ($1)



PokerStars Game #59940153150:  Hold'em No Limit ($0.50/$1.00) - 2009/07/01 0:58:42 ET
Table 'uNlePsyMIqzM691Xkrlk6Q' 9-max Seat #7 is the button
Seat 1: bLbSOSmSOnqE0iTcH/5dxA ($100 in chips)
Seat 2: +OqpStnt0FqbCfyHAWaLbg ($100.15 in chips)
Seat 3: h7qXkU57Bb8ZuPwMyxR8Ug ($16.15 in chips)
Seat 4: TZcz9MEWDA+WydgGruqqbw ($100 in chips)
Seat 5: 3obndzTJ6fECz8+wWhMd1w ($17 in chips)
Seat 6: myIxN7otsyr846M539YR8Q ($21.50 in chips)
Seat 7: w6cw9nzN7AvkkHBVVjykoQ ($54.25 in chips)
Seat 8: laA8va+Yv8WuMqT1zdR91g ($101.50 in chips)
laA8va+Yv8WuMqT1zdR91g: posts small blind $0.50
vR4IO10geOgvTW+LAUBv/A: is sitting out
bLbSOSmSOnqE0iTcH/5dxA: posts big blind $1
*** HOLE CARDS ***
vR4IO10geOgvTW+LAUBv/A leaves the table
+OqpStnt0FqbCfyHAWaLbg: folds
h7qXkU57Bb8ZuPwMyxR8Ug: calls $1
TZcz9MEWDA+WydgGruqqbw: calls $1
VPF+HjszMvUIpy0CHIwH3A joins the table at seat #9
3obndzTJ6fECz8+wWhMd1w: folds
myIxN7otsyr846M539YR8Q: folds
w6cw9nzN7AvkkHBVVjykoQ: folds
laA8va+Yv8WuMqT1zdR91g: raises $5 to $6
bLbSOSmSOnqE0iTcH/5dxA: folds
h7qXkU57Bb8ZuPwMyxR8Ug: folds
TZcz9MEWDA+WydgGruqqbw: folds
laA8va+Yv8WuMqT1zdR91g collected $4 from pot
laA8va+Yv8WuMqT1zdR91g: doesn't show hand
*** SUMMARY ***
Total pot $4 | Rake $0
Seat 1: bLbSOSmSOnqE0iTcH/5dxA (big blind) folded before Flop
Seat 2: +OqpStnt0FqbCfyHAWaLbg folded before Flop (didn't bet)
Seat 3: h7qXkU57Bb8ZuPwMyxR8Ug folded before Flop
Seat 4: TZcz9MEWDA+WydgGruqqbw folded before Flop
Seat 5: 3obndzTJ6fECz8+wWhMd1w folded before Flop (didn't bet)
Seat 6: myIxN7otsyr846M539YR8Q folded before Flop (didn't bet)
Seat 7: w6cw9nzN7AvkkHBVVjykoQ (button) folded before Flop (didn't bet)
Seat 8: laA8va+Yv8WuMqT1zdR91g (small blind) collected ($4)



PokerStars Game #59940154818:  Hold'em No Limit ($0.50/$1.00) - 2009/07/01 0:58:45 ET
Table 'VOs36P6NW+QyXeQ1B62kmA' 6-max Seat #6 is the button
Seat 2: 2UMlbaZ8n8AbRli0Yr0mDw ($38.85 in chips)
Seat 3: TSuRyAHnUPCFjP7Z0rEE0w ($106.40 in chips)
Seat 4: w02zQzNydODiyV9THKgo9w ($43.35 in chips)
Seat 5: ozrlafxxh1HmYdA0/h+MuA ($23.85 in chips)
Seat 6: slVKuQyEz8Qj4E3uLPYNXg ($98.50 in chips)
Z2fXsGcjl+Eax+RzOgwOmg will be allowed to play after the button
2UMlbaZ8n8AbRli0Yr0mDw: posts small blind $0.50
TSuRyAHnUPCFjP7Z0rEE0w: posts big blind $1
*** HOLE CARDS ***
w02zQzNydODiyV9THKgo9w: folds
ozrlafxxh1HmYdA0/h+MuA: calls $1
slVKuQyEz8Qj4E3uLPYNXg: folds
2UMlbaZ8n8AbRli0Yr0mDw: calls $0.50
TSuRyAHnUPCFjP7Z0rEE0w: checks
*** FLOP *** [Ts 4h Kc]
2UMlbaZ8n8AbRli0Yr0mDw: bets $3
TSuRyAHnUPCFjP7Z0rEE0w: folds
ozrlafxxh1HmYdA0/h+MuA: calls $3
*** TURN *** [Ts 4h Kc] [Ad]
2UMlbaZ8n8AbRli0Yr0mDw: bets $3
ozrlafxxh1HmYdA0/h+MuA: calls $3
*** RIVER *** [Ts 4h Kc Ad] [8d]
2UMlbaZ8n8AbRli0Yr0mDw: bets $3
ozrlafxxh1HmYdA0/h+MuA: raises $13 to $16
2UMlbaZ8n8AbRli0Yr0mDw: folds
ozrlafxxh1HmYdA0/h+MuA collected $20 from pot
*** SUMMARY ***
Total pot $21 | Rake $1
Board [Ts 4h Kc Ad 8d]
Seat 2: 2UMlbaZ8n8AbRli0Yr0mDw (small blind) folded on the River
Seat 3: TSuRyAHnUPCFjP7Z0rEE0w (big blind) folded on the Flop
Seat 4: w02zQzNydODiyV9THKgo9w folded before Flop (didn't bet)
Seat 5: ozrlafxxh1HmYdA0/h+MuA collected ($20)
Seat 6: slVKuQyEz8Qj4E3uLPYNXg (button) folded before Flop (didn't bet)



PokerStars Game #59940155334:  Hold'em No Limit ($0.50/$1.00) - 2009/07/01 0:58:45 ET
Table 'vs/5jr6ciwjVQ5+Soc+u2A' 6-max Seat #2 is the button
Seat 1: /P4w1pHg2zHYg/4ubJ0dPw ($60 in chips)
Seat 2: XOIf9W+VAxhZqN+SYoyMKA ($115.85 in chips)
Seat 3: G5ZSSN6RSON3gkNvk/SmYg ($139.85 in chips)
Seat 4: wk6Ohn4GDozoOMHc4eb2rw ($90.25 in chips)
G5ZSSN6RSON3gkNvk/SmYg: posts small blind $0.50
wk6Ohn4GDozoOMHc4eb2rw: posts big blind $1
*** HOLE CARDS ***
/P4w1pHg2zHYg/4ubJ0dPw: folds
XOIf9W+VAxhZqN+SYoyMKA: folds
G5ZSSN6RSON3gkNvk/SmYg: folds
wk6Ohn4GDozoOMHc4eb2rw collected $1 from pot
wk6Ohn4GDozoOMHc4eb2rw: doesn't show hand
*** SUMMARY ***
Total pot $1 | Rake $0
Seat 1: /P4w1pHg2zHYg/4ubJ0dPw folded before Flop (didn't bet)
Seat 2: XOIf9W+VAxhZqN+SYoyMKA (button) folded before Flop (didn't bet)
Seat 3: G5ZSSN6RSON3gkNvk/SmYg (small blind) folded before Flop
Seat 4: wk6Ohn4GDozoOMHc4eb2rw (big blind) collected ($1)



PokerStars Game #59940155028:  Hold'em No Limit ($0.50/$1.00) - 2009/07/01 0:58:45 ET
Table '/FUb199IViHMJHi5YWmeuQ' 9-max Seat #2 is the button
Seat 1: TZcz9MEWDA+WydgGruqqbw ($120 in chips)
Seat 2: FL3MrLspcF23LYvC4ipBOA ($174.40 in chips)
Seat 3: qN483QJ1NvHbdIZB7J4ARw ($23.70 in chips)
Seat 4: qheQay5YvP2DMAb3OUSxtw ($143.35 in chips)
Seat 5: kiakSwxX0e64PwYGAPQvLw ($31.25 in chips)
Seat 6: ccFf7Q4z1cTGQmeoYiWEfw ($56.45 in chips)
Seat 7: bLbSOSmSOnqE0iTcH/5dxA ($100.20 in chips)
Seat 8: 997ViqAtWn1FPjJqcffwcA ($103 in chips)
Seat 9: RfLbneGRY8yQUpMgDnJCxA ($63.95 in chips)
qN483QJ1NvHbdIZB7J4ARw: posts small blind $0.50
qheQay5YvP2DMAb3OUSxtw: posts big blind $1
*** HOLE CARDS ***
kiakSwxX0e64PwYGAPQvLw: folds
ccFf7Q4z1cTGQmeoYiWEfw: folds
bLbSOSmSOnqE0iTcH/5dxA: folds
997ViqAtWn1FPjJqcffwcA: folds
RfLbneGRY8yQUpMgDnJCxA: folds
TZcz9MEWDA+WydgGruqqbw: folds
FL3MrLspcF23LYvC4ipBOA: raises $2 to $3
qN483QJ1NvHbdIZB7J4ARw: calls $2.50
qheQay5YvP2DMAb3OUSxtw: folds
*** FLOP *** [Jc 3s 3d]
qN483QJ1NvHbdIZB7J4ARw: checks
FL3MrLspcF23LYvC4ipBOA: bets $4
qN483QJ1NvHbdIZB7J4ARw: folds
FL3MrLspcF23LYvC4ipBOA collected $6.65 from pot
FL3MrLspcF23LYvC4ipBOA: doesn't show hand
*** SUMMARY ***
Total pot $7 | Rake $0.35
Board [Jc 3s 3d]
Seat 1: TZcz9MEWDA+WydgGruqqbw folded before Flop (didn't bet)
Seat 2: FL3MrLspcF23LYvC4ipBOA (button) collected ($6.65)
Seat 3: qN483QJ1NvHbdIZB7J4ARw (small blind) folded on the Flop
Seat 4: qheQay5YvP2DMAb3OUSxtw (big blind) folded before Flop
Seat 5: kiakSwxX0e64PwYGAPQvLw folded before Flop (didn't bet)
Seat 6: ccFf7Q4z1cTGQmeoYiWEfw folded before Flop (didn't bet)
Seat 7: bLbSOSmSOnqE0iTcH/5dxA folded before Flop (didn't bet)
Seat 8: 997ViqAtWn1FPjJqcffwcA folded before Flop (didn't bet)
Seat 9: RfLbneGRY8yQUpMgDnJCxA folded before Flop (didn't bet)



PokerStars Game #59940155962:  Hold'em No Limit ($0.50/$1.00) - 2009/07/01 0:58:46 ET
Table 'fTlPiCj0utgzC/5io+I7ew' 6-max Seat #2 is the button
Seat 1: YMJG+F++3Aj6P8dAWda5fw ($100 in chips)
Seat 2: Qy/UBNbD2HaA0Ogxg8Sf3w ($126.85 in chips)
Seat 3: wL5HjWHHOSGc53xWMNKB9Q ($29.60 in chips)
Seat 4: uJVSceLggtsrJya+WtmUEA ($119.25 in chips)
Seat 5: bFrTkDcWGTxyvNul7GVdYg ($307.55 in chips)
Seat 6: /P4w1pHg2zHYg/4ubJ0dPw ($61.50 in chips)
wL5HjWHHOSGc53xWMNKB9Q: posts small blind $0.50
uJVSceLggtsrJya+WtmUEA: posts big blind $1
*** HOLE CARDS ***
bFrTkDcWGTxyvNul7GVdYg: folds
/P4w1pHg2zHYg/4ubJ0dPw: folds
YMJG+F++3Aj6P8dAWda5fw: folds
Qy/UBNbD2HaA0Ogxg8Sf3w: folds
wL5HjWHHOSGc53xWMNKB9Q: folds
uJVSceLggtsrJya+WtmUEA collected $1 from pot
*** SUMMARY ***
Total pot $1 | Rake $0
Seat 1: YMJG+F++3Aj6P8dAWda5fw folded before Flop (didn't bet)
Seat 2: Qy/UBNbD2HaA0Ogxg8Sf3w (button) folded before Flop (didn't bet)
Seat 3: wL5HjWHHOSGc53xWMNKB9Q (small blind) folded before Flop
Seat 4: uJVSceLggtsrJya+WtmUEA (big blind) collected ($1)
Seat 5: bFrTkDcWGTxyvNul7GVdYg folded before Flop (didn't bet)
Seat 6: /P4w1pHg2zHYg/4ubJ0dPw folded before Flop (didn't bet)



PokerStars Game #59940155930:  Hold'em No Limit ($0.50/$1.00) - 2009/07/01 0:58:46 ET
Table 'LmXQK9xy3awB+qsPzI21Mw' 2-max Seat #2 is the button
Seat 1: NYi6JFscYNrofSXy4sM+Yw ($280.75 in chips)
Seat 2: TME8GvochpQAo8cmJwWmvA ($108 in chips)
TME8GvochpQAo8cmJwWmvA: posts small blind $0.50
NYi6JFscYNrofSXy4sM+Yw: posts big blind $1
*** HOLE CARDS ***
TME8GvochpQAo8cmJwWmvA: raises $1 to $2
NYi6JFscYNrofSXy4sM+Yw: calls $1
*** FLOP *** [4h 4s 3s]
NYi6JFscYNrofSXy4sM+Yw: checks
TME8GvochpQAo8cmJwWmvA: bets $1
NYi6JFscYNrofSXy4sM+Yw: folds
TME8GvochpQAo8cmJwWmvA collected $3.80 from pot
TME8GvochpQAo8cmJwWmvA: doesn't show hand
*** SUMMARY ***
Total pot $4 | Rake $0.20
Board [4h 4s 3s]
Seat 1: NYi6JFscYNrofSXy4sM+Yw (big blind) folded on the Flop
Seat 2: TME8GvochpQAo8cmJwWmvA (button) (small blind) collected ($3.80)



PokerStars Game #59940157582:  Hold'em No Limit ($0.50/$1.00) - 2009/07/01 0:58:49 ET
Table 'tyUh+jyNvrceIQdKMJjQ2wZFWj23PMihdwrNWv41OG/Qeat #4 is the button
Seat 1: o8A5MUdudVKu+pAwgZOX2w ($172.20 in chips)
Seat 2: XvUbOIg94d25feWeQlOTVg ($153 in chips)
Seat 3: TalCiLYHCd+ffkmR3auPvA ($92.10 in chips)
Seat 4: TSuRyAHnUPCFjP7Z0rEE0w ($109.75 in chips)
Seat 5: j7NIOHLZk7V2o9fOioO5ug ($120.65 in chips)
Seat 6: 4OO5v3AVduL0tePNx8wk5A ($100 in chips)
j7NIOHLZk7V2o9fOioO5ug: posts small blind $0.50
4OO5v3AVduL0tePNx8wk5A: posts big blind $1
*** HOLE CARDS ***
o8A5MUdudVKu+pAwgZOX2w: calls $1
XvUbOIg94d25feWeQlOTVg: folds
TalCiLYHCd+ffkmR3auPvA: folds
TSuRyAHnUPCFjP7Z0rEE0w: folds
j7NIOHLZk7V2o9fOioO5ug: calls $0.50
4OO5v3AVduL0tePNx8wk5A: checks
*** FLOP *** [Th 2d As]
j7NIOHLZk7V2o9fOioO5ug: checks
4OO5v3AVduL0tePNx8wk5A: checks
o8A5MUdudVKu+pAwgZOX2w: bets $3
j7NIOHLZk7V2o9fOioO5ug: calls $3
4OO5v3AVduL0tePNx8wk5A: folds
*** TURN *** [Th 2d As] [Kd]
j7NIOHLZk7V2o9fOioO5ug: checks
o8A5MUdudVKu+pAwgZOX2w: bets $5
j7NIOHLZk7V2o9fOioO5ug: calls $5
*** RIVER *** [Th 2d As Kd] [8c]
j7NIOHLZk7V2o9fOioO5ug: checks
o8A5MUdudVKu+pAwgZOX2w: checks
*** SHOW DOWN ***
j7NIOHLZk7V2o9fOioO5ug: shows [Qd Ts] (a pair of Tens)
o8A5MUdudVKu+pAwgZOX2w: shows [6h Ad] (a pair of Aces)
o8A5MUdudVKu+pAwgZOX2w collected $18.10 from pot
*** SUMMARY ***
Total pot $19 | Rake $0.90
Board [Th 2d As Kd 8c]
Seat 1: o8A5MUdudVKu+pAwgZOX2w showed [6h Ad] and won ($18.10) with a pair of Aces
Seat 2: XvUbOIg94d25feWeQlOTVg folded before Flop (didn't bet)
Seat 3: TalCiLYHCd+ffkmR3auPvA folded before Flop (didn't bet)
Seat 4: TSuRyAHnUPCFjP7Z0rEE0w (button) folded before Flop (didn't bet)
Seat 5: j7NIOHLZk7V2o9fOioO5ug (small blind) showed [Qd Ts] and lost with a pair of Tens
Seat 6: 4OO5v3AVduL0tePNx8wk5A (big blind) folded on the Flop



PokerStars Game #59940157640:  Hold'em No Limit ($0.50/$1.00) - 2009/07/01 0:58:49 ET
Table 'tLrtq7gDzxEvckNAI1OS5Q' 6-max Seat #3 is the button
Seat 2: QHvTZcrKe6+maWUfVjP29Q ($100 in chips)
Seat 3: TPZ+m9x+lwoKpv7TMfAUWA ($303.95 in chips)
Seat 4: +uSzP8Jwnw7sKfQ4s66b7w ($46.80 in chips)
Seat 5: OGMLOcTNYZXZU81au7ztUw ($165.65 in chips)
Seat 6: XUk5GQsfNFpHvaToDZ0rZA ($166.70 in chips)
+uSzP8Jwnw7sKfQ4s66b7w: posts small blind $0.50
OGMLOcTNYZXZU81au7ztUw: posts big blind $1
*** HOLE CARDS ***
XUk5GQsfNFpHvaToDZ0rZA: calls $1
QHvTZcrKe6+maWUfVjP29Q: folds
TPZ+m9x+lwoKpv7TMfAUWA: folds
+uSzP8Jwnw7sKfQ4s66b7w: folds
OGMLOcTNYZXZU81au7ztUw: raises $2 to $3
XUk5GQsfNFpHvaToDZ0rZA: calls $2
*** FLOP *** [2d 8h 9s]
OGMLOcTNYZXZU81au7ztUw: checks
XUk5GQsfNFpHvaToDZ0rZA: bets $4
OGMLOcTNYZXZU81au7ztUw: folds
XUk5GQsfNFpHvaToDZ0rZA collected $6.20 from pot
XUk5GQsfNFpHvaToDZ0rZA: doesn't show hand
*** SUMMARY ***
Total pot $6.50 | Rake $0.30
Board [2d 8h 9s]
Seat 2: QHvTZcrKe6+maWUfVjP29Q folded before Flop (didn't bet)
Seat 3: TPZ+m9x+lwoKpv7TMfAUWA (button) folded before Flop (didn't bet)
Seat 4: +uSzP8Jwnw7sKfQ4s66b7w (small blind) folded before Flop
Seat 5: OGMLOcTNYZXZU81au7ztUw (big blind) folded on the Flop
Seat 6: XUk5GQsfNFpHvaToDZ0rZA collected ($6.20)



PokerStars Game #59940158696:  Hold'em No Limit ($0.50/$1.00) - 2009/07/01 0:58:51 ET
Table 'GPp0HyAuggN8oE0sUWzPpA' 9-max Seat #2 is the button
Seat 1: qJr25HAtvv1w/7IBvjMM3g ($27.50 in chips)
Seat 2: m3U8I35Pn3gxKhoS2nmYIg ($56.70 in chips)
Seat 4: mBRWbnUl8diyBO1qTJaNzw ($107.80 in chips)
Seat 5: 0fXz44fzDo5QmhAaJCvFfA ($24.65 in chips)
Seat 6: BK/GtNPkSx0TdUDj82id5A ($10 in chips)
Seat 7: DHdbHyysD15wCAtx+BhUjA ($98.50 in chips)
Seat 9: VPF+HjszMvUIpy0CHIwH3A ($27.50 in chips)
mBRWbnUl8diyBO1qTJaNzw: posts small blind $0.50
0fXz44fzDo5QmhAaJCvFfA: posts big blind $1
John86sand: sits out
*** HOLE CARDS ***
BK/GtNPkSx0TdUDj82id5A: calls $1
DHdbHyysD15wCAtx+BhUjA: raises $3 to $4
VPF+HjszMvUIpy0CHIwH3A: folds
qJr25HAtvv1w/7IBvjMM3g: folds
m3U8I35Pn3gxKhoS2nmYIg: folds
mBRWbnUl8diyBO1qTJaNzw: folds
0fXz44fzDo5QmhAaJCvFfA: calls $3
BK/GtNPkSx0TdUDj82id5A: calls $3
*** FLOP *** [Qh 5d 4c]
0fXz44fzDo5QmhAaJCvFfA: checks
CCCXsirC+bO7ginAuUUVlQ has returned
BK/GtNPkSx0TdUDj82id5A: bets $6 and is all-in
DHdbHyysD15wCAtx+BhUjA: folds
0fXz44fzDo5QmhAaJCvFfA: calls $6
*** TURN *** [Qh 5d 4c] [Qd]
*** RIVER *** [Qh 5d 4c Qd] [Ah]
*** SHOW DOWN ***
0fXz44fzDo5QmhAaJCvFfA: shows [8h 7h] (a pair of Queens)
BK/GtNPkSx0TdUDj82id5A: shows [9d 9c] (two pair, Queens and Nines)
BK/GtNPkSx0TdUDj82id5A collected $23.35 from pot
*** SUMMARY ***
Total pot $24.50 | Rake $1.15
Board [Qh 5d 4c Qd Ah]
Seat 1: qJr25HAtvv1w/7IBvjMM3g folded before Flop (didn't bet)
Seat 2: m3U8I35Pn3gxKhoS2nmYIg (button) folded before Flop (didn't bet)
Seat 4: mBRWbnUl8diyBO1qTJaNzw (small blind) folded before Flop
Seat 5: 0fXz44fzDo5QmhAaJCvFfA (big blind) showed [8h 7h] and lost with a pair of Queens
Seat 6: BK/GtNPkSx0TdUDj82id5A showed [9d 9c] and won ($23.35) with two pair, Queens and Nines
Seat 7: DHdbHyysD15wCAtx+BhUjA folded on the Flop
Seat 9: VPF+HjszMvUIpy0CHIwH3A folded before Flop (didn't bet)



PokerStars Game #59940161290:  Hold'em No Limit ($0.50/$1.00) - 2009/07/01 0:58:55 ET
Table 'Zka9tv1yilg0MvXWPQrShg' 9-max Seat #3 is the button
Seat 1: TZcz9MEWDA+WydgGruqqbw ($117.40 in chips)
Seat 2: kz9ziSiGUc+857heiKSayw ($20 in chips)
Seat 3: gUUvmqdVlmvpal6B8nYrmg ($108.45 in chips)
Seat 4: stxmTgSicxShtrDxhOOX2g ($68.65 in chips)
Seat 5: /zy+DB4S5fUQUSfZWFzYGw ($123.40 in chips)
Seat 6: rY8wPoax1lS+HUY+I0FZDw ($160.70 in chips)
Seat 7: p1SafS90nb3Uft5LB0NkHw ($20.50 in chips)
Seat 9: 6daxhj43mWj04MOPTOmaYA ($94 in chips)
stxmTgSicxShtrDxhOOX2g: posts small blind $0.50
/zy+DB4S5fUQUSfZWFzYGw: posts big blind $1
D+W9Me7w6Hcx/WRUSKV0dw: sits out
kz9ziSiGUc+857heiKSayw: posts small blind $0.50
*** HOLE CARDS ***
rY8wPoax1lS+HUY+I0FZDw: folds
p1SafS90nb3Uft5LB0NkHw: folds
6daxhj43mWj04MOPTOmaYA: folds
TZcz9MEWDA+WydgGruqqbw: folds
kz9ziSiGUc+857heiKSayw: folds
gUUvmqdVlmvpal6B8nYrmg: raises $1 to $2
stxmTgSicxShtrDxhOOX2g: folds
/zy+DB4S5fUQUSfZWFzYGw: calls $1
*** FLOP *** [Qh 6h Jh]
/zy+DB4S5fUQUSfZWFzYGw: checks
gUUvmqdVlmvpal6B8nYrmg: checks
*** TURN *** [Qh 6h Jh] [3s]
/zy+DB4S5fUQUSfZWFzYGw: bets $3
gUUvmqdVlmvpal6B8nYrmg: folds
/zy+DB4S5fUQUSfZWFzYGw collected $4.75 from pot
*** SUMMARY ***
Total pot $5 | Rake $0.25
Board [Qh 6h Jh 3s]
Seat 1: TZcz9MEWDA+WydgGruqqbw folded before Flop (didn't bet)
Seat 2: kz9ziSiGUc+857heiKSayw folded before Flop
Seat 3: gUUvmqdVlmvpal6B8nYrmg (button) folded on the Turn
Seat 4: stxmTgSicxShtrDxhOOX2g (small blind) folded before Flop
Seat 5: /zy+DB4S5fUQUSfZWFzYGw (big blind) collected ($4.75)
Seat 6: rY8wPoax1lS+HUY+I0FZDw folded before Flop (didn't bet)
Seat 7: p1SafS90nb3Uft5LB0NkHw folded before Flop (didn't bet)
Seat 9: 6daxhj43mWj04MOPTOmaYA folded before Flop (didn't bet)



PokerStars Game #59940161922:  Hold'em No Limit ($0.50/$1.00) - 2009/07/01 0:58:56 ET
Table 'W/wyObTiXZm+Ckkl3YxcSw' 6-max Seat #3 is the button
Seat 1: eUBBn2R56C1IQ6Cs/vitwg ($103.40 in chips)
Seat 2: oDiBRCaF0QVtd3kO6xZIXw ($109.35 in chips)
Seat 3: dxyNCn/qxfkGDUIf28Cbng ($85.90 in chips)
Seat 5: BdbmJTZZ47quA9vUWwXtlw ($61.35 in chips)
Seat 6: tS9JHB1h+FQ++qu8RwRNgg ($40.80 in chips)
BdbmJTZZ47quA9vUWwXtlw: posts small blind $0.50
tS9JHB1h+FQ++qu8RwRNgg: posts big blind $1
*** HOLE CARDS ***
eUBBn2R56C1IQ6Cs/vitwg: raises $3 to $4
oDiBRCaF0QVtd3kO6xZIXw: folds
dxyNCn/qxfkGDUIf28Cbng: folds
BdbmJTZZ47quA9vUWwXtlw: folds
tS9JHB1h+FQ++qu8RwRNgg: calls $3
*** FLOP *** [2h Qh 6c]
tS9JHB1h+FQ++qu8RwRNgg: checks
eUBBn2R56C1IQ6Cs/vitwg: bets $6
tS9JHB1h+FQ++qu8RwRNgg: raises $15 to $21
eUBBn2R56C1IQ6Cs/vitwg: raises $41 to $62
tS9JHB1h+FQ++qu8RwRNgg: calls $15.80 and is all-in
*** TURN *** [2h Qh 6c] [3d]
*** RIVER *** [2h Qh 6c 3d] [4c]
*** SHOW DOWN ***
tS9JHB1h+FQ++qu8RwRNgg: shows [Qd Jd] (a pair of Queens)
eUBBn2R56C1IQ6Cs/vitwg: shows [Kd Kc] (a pair of Kings)
eUBBn2R56C1IQ6Cs/vitwg collected $80.10 from pot
*** SUMMARY ***
Total pot $82.10 | Rake $2
Board [2h Qh 6c 3d 4c]
Seat 1: eUBBn2R56C1IQ6Cs/vitwg showed [Kd Kc] and won ($80.10) with a pair of Kings
Seat 2: oDiBRCaF0QVtd3kO6xZIXw folded before Flop (didn't bet)
Seat 3: dxyNCn/qxfkGDUIf28Cbng (button) folded before Flop (didn't bet)
Seat 5: BdbmJTZZ47quA9vUWwXtlw (small blind) folded before Flop
Seat 6: tS9JHB1h+FQ++qu8RwRNgg (big blind) showed [Qd Jd] and lost with a pair of Queens



PokerStars Game #59940161662:  Hold'em No Limit ($0.50/$1.00) - 2009/07/01 0:58:56 ET
Table 'vs/5jr6ciwjVQ5+Soc+u2A' 6-max Seat #3 is the button
Seat 1: /P4w1pHg2zHYg/4ubJ0dPw ($60 in chips)
Seat 2: XOIf9W+VAxhZqN+SYoyMKA ($115.85 in chips)
Seat 3: G5ZSSN6RSON3gkNvk/SmYg ($139.35 in chips)
Seat 4: wk6Ohn4GDozoOMHc4eb2rw ($90.75 in chips)
wk6Ohn4GDozoOMHc4eb2rw: posts small blind $0.50
/P4w1pHg2zHYg/4ubJ0dPw: posts big blind $1
*** HOLE CARDS ***
XOIf9W+VAxhZqN+SYoyMKA: folds
G5ZSSN6RSON3gkNvk/SmYg: folds
wk6Ohn4GDozoOMHc4eb2rw: calls $0.50
/P4w1pHg2zHYg/4ubJ0dPw: checks
*** FLOP *** [Ah 6d 9c]
wk6Ohn4GDozoOMHc4eb2rw: bets $1
/P4w1pHg2zHYg/4ubJ0dPw: folds
wk6Ohn4GDozoOMHc4eb2rw collected $1.90 from pot
wk6Ohn4GDozoOMHc4eb2rw: doesn't show hand
*** SUMMARY ***
Total pot $2 | Rake $0.10
Board [Ah 6d 9c]
Seat 1: /P4w1pHg2zHYg/4ubJ0dPw (big blind) folded on the Flop
Seat 2: XOIf9W+VAxhZqN+SYoyMKA folded before Flop (didn't bet)
Seat 3: G5ZSSN6RSON3gkNvk/SmYg (button) folded before Flop (didn't bet)
Seat 4: wk6Ohn4GDozoOMHc4eb2rw (small blind) collected ($1.90)



PokerStars Game #59940162494:  Hold'em No Limit ($0.50/$1.00) - 2009/07/01 0:58:57 ET
Table 'rmZfTK+oSebeUPJNbWhdAA' 6-max Seat #5 is the button
Seat 1: xAU6q2/cwmby2sxmA8VcmA ($148 in chips)
Seat 2: z7O9PO/WEcqRouIydFhS9Q ($100 in chips)
Seat 3: BCEV3COoKY607AzLWayfRA ($135.50 in chips)
Seat 4: 1/mIuXfgx1ZyVkodrmfQDw ($100 in chips)
Seat 5: 5lY8d6Cnm4HUkt/8FZSj4g ($112.50 in chips)
Seat 6: j7NIOHLZk7V2o9fOioO5ug ($118.80 in chips)
j7NIOHLZk7V2o9fOioO5ug: posts small blind $0.50
xAU6q2/cwmby2sxmA8VcmA: posts big blind $1
*** HOLE CARDS ***
z7O9PO/WEcqRouIydFhS9Q: raises $2 to $3
BCEV3COoKY607AzLWayfRA: folds
1/mIuXfgx1ZyVkodrmfQDw: folds
5lY8d6Cnm4HUkt/8FZSj4g: folds
j7NIOHLZk7V2o9fOioO5ug: folds
xAU6q2/cwmby2sxmA8VcmA: folds
z7O9PO/WEcqRouIydFhS9Q collected $2.50 from pot
*** SUMMARY ***
Total pot $2.50 | Rake $0
Seat 1: xAU6q2/cwmby2sxmA8VcmA (big blind) folded before Flop
Seat 2: z7O9PO/WEcqRouIydFhS9Q collected ($2.50)
Seat 3: BCEV3COoKY607AzLWayfRA folded before Flop (didn't bet)
Seat 4: 1/mIuXfgx1ZyVkodrmfQDw folded before Flop (didn't bet)
Seat 5: 5lY8d6Cnm4HUkt/8FZSj4g (button) folded before Flop (didn't bet)
Seat 6: j7NIOHLZk7V2o9fOioO5ug (small blind) folded before Flop



PokerStars Game #59940163936:  Hold'em No Limit ($0.50/$1.00) - 2009/07/01 0:59:00 ET
Table '7O9fB8yx1u7sJveJn8w6jA' 6-max Seat #6 is the button
Seat 2: wx3sQGkVi2x9wJXuWNHPBw ($195.95 in chips)
Seat 3: hpxXcmRkXXI9HE5+5/j/0Q ($100 in chips)
Seat 4: XIZSmlGttGgSRaIU42K4Fg ($143.90 in chips)
Seat 5: BCEV3COoKY607AzLWayfRA ($101.50 in chips)
Seat 6: UBZQqpnJZdTYYY1FTb0rLA ($130.45 in chips)
wx3sQGkVi2x9wJXuWNHPBw: posts small blind $0.50
hpxXcmRkXXI9HE5+5/j/0Q: posts big blind $1
*** HOLE CARDS ***
XIZSmlGttGgSRaIU42K4Fg: calls $1
BCEV3COoKY607AzLWayfRA: raises $4 to $5
UBZQqpnJZdTYYY1FTb0rLA: raises $10 to $15
wx3sQGkVi2x9wJXuWNHPBw: folds
hpxXcmRkXXI9HE5+5/j/0Q: folds
XIZSmlGttGgSRaIU42K4Fg: folds
BCEV3COoKY607AzLWayfRA: folds
UBZQqpnJZdTYYY1FTb0rLA collected $12.50 from pot
UBZQqpnJZdTYYY1FTb0rLA: doesn't show hand
*** SUMMARY ***
Total pot $12.50 | Rake $0
Seat 2: wx3sQGkVi2x9wJXuWNHPBw (small blind) folded before Flop
Seat 3: hpxXcmRkXXI9HE5+5/j/0Q (big blind) folded before Flop
Seat 4: XIZSmlGttGgSRaIU42K4Fg folded before Flop
Seat 5: BCEV3COoKY607AzLWayfRA folded before Flop
Seat 6: UBZQqpnJZdTYYY1FTb0rLA (button) collected ($12.50)



PokerStars Game #59940164998:  Hold'em No Limit ($0.50/$1.00) - 2009/07/01 0:59:01 ET
Table 'tJq9SfN1ywY0r03VBlWlwQ' 9-max Seat #1 is the button
Seat 1: wZsU+w9r7G66x93UuvBf1Q ($340.80 in chips)
Seat 2: RqkO8O/Y3qlc3PIuCAHjVg ($73.40 in chips)
Seat 3: FVs16t7GgfWgQWt4JxsObQ ($39 in chips)
Seat 4: bLbSOSmSOnqE0iTcH/5dxA ($110.20 in chips)
Seat 5: Ogn4JDV3mp4ZDKO49IFzKA ($17.25 in chips)
Seat 6: gUUvmqdVlmvpal6B8nYrmg ($116.05 in chips)
Seat 7: qVhRZ0PLZ95XRJHWAjXjOQ ($129.90 in chips)
Seat 8: G4DEhsZFmznGNVpy2SEocA ($22 in chips)
Seat 9: XE5QF1y74bpHog9JxWJMWQ ($102 in chips)
RqkO8O/Y3qlc3PIuCAHjVg: posts small blind $0.50
FVs16t7GgfWgQWt4JxsObQ: posts big blind $1
*** HOLE CARDS ***
bLbSOSmSOnqE0iTcH/5dxA: folds
Ogn4JDV3mp4ZDKO49IFzKA: folds
gUUvmqdVlmvpal6B8nYrmg: folds
qVhRZ0PLZ95XRJHWAjXjOQ: folds
G4DEhsZFmznGNVpy2SEocA: folds
XE5QF1y74bpHog9JxWJMWQ: folds
wZsU+w9r7G66x93UuvBf1Q: folds
RqkO8O/Y3qlc3PIuCAHjVg: raises $1 to $2
FVs16t7GgfWgQWt4JxsObQ: calls $1
*** FLOP *** [3h Ad Kd]
RqkO8O/Y3qlc3PIuCAHjVg: bets $3
FVs16t7GgfWgQWt4JxsObQ: folds
RqkO8O/Y3qlc3PIuCAHjVg collected $3.80 from pot
*** SUMMARY ***
Total pot $4 | Rake $0.20
Board [3h Ad Kd]
Seat 1: wZsU+w9r7G66x93UuvBf1Q (button) folded before Flop (didn't bet)
Seat 2: RqkO8O/Y3qlc3PIuCAHjVg (small blind) collected ($3.80)
Seat 3: FVs16t7GgfWgQWt4JxsObQ (big blind) folded on the Flop
Seat 4: bLbSOSmSOnqE0iTcH/5dxA folded before Flop (didn't bet)
Seat 5: Ogn4JDV3mp4ZDKO49IFzKA folded before Flop (didn't bet)
Seat 6: gUUvmqdVlmvpal6B8nYrmg folded before Flop (didn't bet)
Seat 7: qVhRZ0PLZ95XRJHWAjXjOQ folded before Flop (didn't bet)
Seat 8: G4DEhsZFmznGNVpy2SEocA folded before Flop (didn't bet)
Seat 9: XE5QF1y74bpHog9JxWJMWQ folded before Flop (didn't bet)



PokerStars Game #59940165580:  Hold'em No Limit ($0.50/$1.00) - 2009/07/01 0:59:02 ET
Table '+cA8mcmhaedZ7YcrDdhmeQ' 6-max Seat #5 is the button
Seat 1: lsLuWlcPA3Rh7kJVLzMh0Q ($300.50 in chips)
Seat 2: RqgF7gRoKgRNW8Zoi1ty4A ($105.95 in chips)
Seat 3: 7H5WkGzGvsv56y1iaqHvRg ($28.85 in chips)
Seat 4: 4OO5v3AVduL0tePNx8wk5A ($100 in chips)
Seat 5: +7hFKAL0b0O/n8G72TclJA ($66.35 in chips)
Seat 6: YfsTQsY/fxb+YqbdclTHuw ($25.95 in chips)
YfsTQsY/fxb+YqbdclTHuw: posts small blind $0.50
lsLuWlcPA3Rh7kJVLzMh0Q: posts big blind $1
*** HOLE CARDS ***
RqgF7gRoKgRNW8Zoi1ty4A: folds
7H5WkGzGvsv56y1iaqHvRg: calls $1
4OO5v3AVduL0tePNx8wk5A: raises $4 to $5
+7hFKAL0b0O/n8G72TclJA: folds
YfsTQsY/fxb+YqbdclTHuw: folds
lsLuWlcPA3Rh7kJVLzMh0Q: folds
7H5WkGzGvsv56y1iaqHvRg: folds
4OO5v3AVduL0tePNx8wk5A collected $3.50 from pot
*** SUMMARY ***
Total pot $3.50 | Rake $0
Seat 1: lsLuWlcPA3Rh7kJVLzMh0Q (big blind) folded before Flop
Seat 2: RqgF7gRoKgRNW8Zoi1ty4A folded before Flop (didn't bet)
Seat 3: 7H5WkGzGvsv56y1iaqHvRg folded before Flop
Seat 4: 4OO5v3AVduL0tePNx8wk5A collected ($3.50)
Seat 5: +7hFKAL0b0O/n8G72TclJA (button) folded before Flop (didn't bet)
Seat 6: YfsTQsY/fxb+YqbdclTHuw (small blind) folded before Flop



PokerStars Game #59940165828:  Hold'em No Limit ($0.50/$1.00) - 2009/07/01 0:59:03 ET
Table 'LmXQK9xy3awB+qsPzI21Mw' 2-max Seat #1 is the button
Seat 1: NYi6JFscYNrofSXy4sM+Yw ($278.75 in chips)
Seat 2: TME8GvochpQAo8cmJwWmvA ($109.80 in chips)
NYi6JFscYNrofSXy4sM+Yw: posts small blind $0.50
TME8GvochpQAo8cmJwWmvA: posts big blind $1
*** HOLE CARDS ***
NYi6JFscYNrofSXy4sM+Yw: raises $2 to $3
TME8GvochpQAo8cmJwWmvA: calls $2
*** FLOP *** [Jc 8c 8d]
TME8GvochpQAo8cmJwWmvA: checks
NYi6JFscYNrofSXy4sM+Yw: bets $3
TME8GvochpQAo8cmJwWmvA: calls $3
*** TURN *** [Jc 8c 8d] [2d]
TME8GvochpQAo8cmJwWmvA: checks
NYi6JFscYNrofSXy4sM+Yw: bets $5
TME8GvochpQAo8cmJwWmvA: calls $5
*** RIVER *** [Jc 8c 8d 2d] [9d]
TME8GvochpQAo8cmJwWmvA: checks
NYi6JFscYNrofSXy4sM+Yw: checks
*** SHOW DOWN ***
TME8GvochpQAo8cmJwWmvA: shows [Ah 8s] (three of a kind, Eights)
NYi6JFscYNrofSXy4sM+Yw: mucks hand
TME8GvochpQAo8cmJwWmvA collected $21.50 from pot
*** SUMMARY ***
Total pot $22 | Rake $0.50
Board [Jc 8c 8d 2d 9d]
Seat 1: NYi6JFscYNrofSXy4sM+Yw (button) (small blind) mucked
Seat 2: TME8GvochpQAo8cmJwWmvA (big blind) showed [Ah 8s] and won ($21.50) with three of a kind, Eights



PokerStars Game #59940166064:  Hold'em No Limit ($0.50/$1.00) - 2009/07/01 0:59:03 ET
Table 'U9zqzC8f3oTJ2ShXFgSSOA' 6-max Seat #3 is the button
Seat 1: iHo1oDbrEVJ8nEGdaPrICw ($105.40 in chips)
Seat 2: TSuRyAHnUPCFjP7Z0rEE0w ($100 in chips)
Seat 3: yfXek8iJ7O4CFyqXrtGcfg ($17.75 in chips)
Seat 5: KfwW5us6tydK81NYTtK1gw ($296.45 in chips)
KfwW5us6tydK81NYTtK1gw: posts small blind $0.50
iHo1oDbrEVJ8nEGdaPrICw: posts big blind $1
*** HOLE CARDS ***
TSuRyAHnUPCFjP7Z0rEE0w: folds
yfXek8iJ7O4CFyqXrtGcfg: raises $2 to $3
KfwW5us6tydK81NYTtK1gw: calls $2.50
iHo1oDbrEVJ8nEGdaPrICw: folds
*** FLOP *** [8d 6s 5c]
iHo1oDbrEVJ8nEGdaPrICw is sitting out
KfwW5us6tydK81NYTtK1gw: checks
yfXek8iJ7O4CFyqXrtGcfg: bets $3
KfwW5us6tydK81NYTtK1gw: calls $3
*** TURN *** [8d 6s 5c] [Jd]
KfwW5us6tydK81NYTtK1gw: checks
yfXek8iJ7O4CFyqXrtGcfg: bets $4
KfwW5us6tydK81NYTtK1gw: raises $20 to $24
yfXek8iJ7O4CFyqXrtGcfg: calls $7.75 and is all-in
*** RIVER *** [8d 6s 5c Jd] [As]
*** SHOW DOWN ***
KfwW5us6tydK81NYTtK1gw: shows [7d 9d] (a straight, Five to Nine)
yfXek8iJ7O4CFyqXrtGcfg: mucks hand
KfwW5us6tydK81NYTtK1gw collected $34.75 from pot
*** SUMMARY ***
Total pot $36.50 | Rake $1.75
Board [8d 6s 5c Jd As]
Seat 1: iHo1oDbrEVJ8nEGdaPrICw (big blind) folded before Flop
Seat 2: TSuRyAHnUPCFjP7Z0rEE0w folded before Flop (didn't bet)
Seat 3: yfXek8iJ7O4CFyqXrtGcfg (button) mucked
Seat 5: KfwW5us6tydK81NYTtK1gw (small blind) showed [7d 9d] and won ($34.75) with a straight, Five to Nine



PokerStars Game #59940167154:  Hold'em No Limit ($0.50/$1.00) - 2009/07/01 0:59:05 ET
Table 'mmbQQVBTrPdE+wy+s+9VPA' 6-max Seat #5 is the button
Seat 1: zyP4SPoWZnKUfTvIRLCVog ($55 in chips)
Seat 2: cl/QpVR/PLO58lj+C5mGLw ($24 in chips)
Seat 3: wx3sQGkVi2x9wJXuWNHPBw ($113.65 in chips)
Seat 4: V3iZdcw61nXF3g5hD2RrsQ ($100 in chips)
Seat 5: YMJG+F++3Aj6P8dAWda5fw ($98 in chips)
Seat 6: U2CWBTv29qdCbj8RNF2sIw ($105.90 in chips)
U2CWBTv29qdCbj8RNF2sIw: posts small blind $0.50
zyP4SPoWZnKUfTvIRLCVog: posts big blind $1
*** HOLE CARDS ***
cl/QpVR/PLO58lj+C5mGLw: calls $1
wx3sQGkVi2x9wJXuWNHPBw: folds
V3iZdcw61nXF3g5hD2RrsQ: folds
YMJG+F++3Aj6P8dAWda5fw: folds
U2CWBTv29qdCbj8RNF2sIw: raises $3 to $4
zyP4SPoWZnKUfTvIRLCVog: folds
cl/QpVR/PLO58lj+C5mGLw: calls $3
*** FLOP *** [Ah 6d 4s]
U2CWBTv29qdCbj8RNF2sIw: bets $5
cl/QpVR/PLO58lj+C5mGLw: folds
U2CWBTv29qdCbj8RNF2sIw collected $8.55 from pot
*** SUMMARY ***
Total pot $9 | Rake $0.45
Board [Ah 6d 4s]
Seat 1: zyP4SPoWZnKUfTvIRLCVog (big blind) folded before Flop
Seat 2: cl/QpVR/PLO58lj+C5mGLw folded on the Flop
Seat 3: wx3sQGkVi2x9wJXuWNHPBw folded before Flop (didn't bet)
Seat 4: V3iZdcw61nXF3g5hD2RrsQ folded before Flop (didn't bet)
Seat 5: YMJG+F++3Aj6P8dAWda5fw (button) folded before Flop (didn't bet)
Seat 6: U2CWBTv29qdCbj8RNF2sIw (small blind) collected ($8.55)



PokerStars Game #59940167356:  Hold'em No Limit ($0.50/$1.00) - 2009/07/01 0:59:05 ET
Table '7Nl0ffnjeK44/vmeexh3MQ' 9-max Seat #6 is the button
Seat 1: s7D3Y+k4Cj4D1cXHv7oj+Q ($96.35 in chips)
Seat 2: OGgaARGdJQT4awWVNQ957w ($100 in chips)
Seat 3: vR4IO10geOgvTW+LAUBv/A ($100 in chips)
Seat 4: bLbSOSmSOnqE0iTcH/5dxA ($113.50 in chips)
Seat 6: FVs16t7GgfWgQWt4JxsObQ ($24.50 in chips)
Seat 7: 997ViqAtWn1FPjJqcffwcA ($100 in chips)
Seat 8: D+W9Me7w6Hcx/WRUSKV0dw ($20 in chips)
Seat 9: ouwUBGRKnKK9uhn1G4Lf+A ($197 in chips)
997ViqAtWn1FPjJqcffwcA: posts small blind $0.50
D+W9Me7w6Hcx/WRUSKV0dw: posts big blind $1
61sfw5QTu62YYIt68OsdrA: sits out
*** HOLE CARDS ***
ouwUBGRKnKK9uhn1G4Lf+A: folds
s7D3Y+k4Cj4D1cXHv7oj+Q: folds
OGgaARGdJQT4awWVNQ957w: folds
vR4IO10geOgvTW+LAUBv/A: folds
bLbSOSmSOnqE0iTcH/5dxA: folds
FVs16t7GgfWgQWt4JxsObQ: calls $1
997ViqAtWn1FPjJqcffwcA: calls $0.50
D+W9Me7w6Hcx/WRUSKV0dw: raises $3.60 to $4.60
FVs16t7GgfWgQWt4JxsObQ: calls $3.60
997ViqAtWn1FPjJqcffwcA: folds
*** FLOP *** [Js 8h Qc]
D+W9Me7w6Hcx/WRUSKV0dw: checks
FVs16t7GgfWgQWt4JxsObQ: checks
*** TURN *** [Js 8h Qc] [7c]
D+W9Me7w6Hcx/WRUSKV0dw: checks
FVs16t7GgfWgQWt4JxsObQ: checks
*** RIVER *** [Js 8h Qc 7c] [Kc]
D+W9Me7w6Hcx/WRUSKV0dw: checks
FVs16t7GgfWgQWt4JxsObQ: checks
*** SHOW DOWN ***
D+W9Me7w6Hcx/WRUSKV0dw: shows [5d As] (high card Ace)
FVs16t7GgfWgQWt4JxsObQ: shows [3c Ah] (high card Ace)
D+W9Me7w6Hcx/WRUSKV0dw collected $4.85 from pot
FVs16t7GgfWgQWt4JxsObQ collected $4.85 from pot
*** SUMMARY ***
Total pot $10.20 | Rake $0.50
Board [Js 8h Qc 7c Kc]
Seat 1: s7D3Y+k4Cj4D1cXHv7oj+Q folded before Flop (didn't bet)
Seat 2: OGgaARGdJQT4awWVNQ957w folded before Flop (didn't bet)
Seat 3: vR4IO10geOgvTW+LAUBv/A folded before Flop (didn't bet)
Seat 4: bLbSOSmSOnqE0iTcH/5dxA folded before Flop (didn't bet)
Seat 6: FVs16t7GgfWgQWt4JxsObQ (button) showed [3c Ah] and won ($4.85) with high card Ace
Seat 7: 997ViqAtWn1FPjJqcffwcA (small blind) folded before Flop
Seat 8: D+W9Me7w6Hcx/WRUSKV0dw (big blind) showed [5d As] and won ($4.85) with high card Ace
Seat 9: ouwUBGRKnKK9uhn1G4Lf+A folded before Flop (didn't bet)



PokerStars Game #59940168354:  Hold'em No Limit ($0.50/$1.00) - 2009/07/01 0:59:07 ET
Table 'MUPc8FEpe/nR0BKSeReX6Q' 6-max Seat #2 is the button
Seat 2: xAU6q2/cwmby2sxmA8VcmA ($122.70 in chips)
Seat 3: wx3sQGkVi2x9wJXuWNHPBw ($230.85 in chips)
Seat 4: ZA1bp6g8IwtTxkUE4eCjDQ ($195.30 in chips)
Seat 5: UBZQqpnJZdTYYY1FTb0rLA ($103.55 in chips)
Seat 6: oxnw0GLLpFanjhGkxfRSqA ($28.70 in chips)
wx3sQGkVi2x9wJXuWNHPBw: posts small blind $0.50
ZA1bp6g8IwtTxkUE4eCjDQ: posts big blind $1
*** HOLE CARDS ***
UBZQqpnJZdTYYY1FTb0rLA: folds
oxnw0GLLpFanjhGkxfRSqA: folds
xAU6q2/cwmby2sxmA8VcmA: folds
wx3sQGkVi2x9wJXuWNHPBw: folds
ZA1bp6g8IwtTxkUE4eCjDQ collected $1 from pot
ZA1bp6g8IwtTxkUE4eCjDQ: doesn't show hand
*** SUMMARY ***
Total pot $1 | Rake $0
Seat 2: xAU6q2/cwmby2sxmA8VcmA (button) folded before Flop (didn't bet)
Seat 3: wx3sQGkVi2x9wJXuWNHPBw (small blind) folded before Flop
Seat 4: ZA1bp6g8IwtTxkUE4eCjDQ (big blind) collected ($1)
Seat 5: UBZQqpnJZdTYYY1FTb0rLA folded before Flop (didn't bet)
Seat 6: oxnw0GLLpFanjhGkxfRSqA folded before Flop (didn't bet)



PokerStars Game #59940168268:  Hold'em No Limit ($0.50/$1.00) - 2009/07/01 0:59:07 ET
Table 'fTlPiCj0utgzC/5io+I7ew' 6-max Seat #3 is the button
Seat 1: YMJG+F++3Aj6P8dAWda5fw ($100 in chips)
Seat 2: Qy/UBNbD2HaA0Ogxg8Sf3w ($126.85 in chips)
Seat 3: wL5HjWHHOSGc53xWMNKB9Q ($29.10 in chips)
Seat 4: uJVSceLggtsrJya+WtmUEA ($119.75 in chips)
Seat 5: bFrTkDcWGTxyvNul7GVdYg ($307.55 in chips)
Seat 6: /P4w1pHg2zHYg/4ubJ0dPw ($61.50 in chips)
uJVSceLggtsrJya+WtmUEA: posts small blind $0.50
bFrTkDcWGTxyvNul7GVdYg: posts big blind $1
*** HOLE CARDS ***
/P4w1pHg2zHYg/4ubJ0dPw: folds
YMJG+F++3Aj6P8dAWda5fw: folds
Qy/UBNbD2HaA0Ogxg8Sf3w: folds
wL5HjWHHOSGc53xWMNKB9Q: folds
uJVSceLggtsrJya+WtmUEA: raises $2 to $3
bFrTkDcWGTxyvNul7GVdYg: folds
uJVSceLggtsrJya+WtmUEA collected $2 from pot
*** SUMMARY ***
Total pot $2 | Rake $0
Seat 1: YMJG+F++3Aj6P8dAWda5fw folded before Flop (didn't bet)
Seat 2: Qy/UBNbD2HaA0Ogxg8Sf3w folded before Flop (didn't bet)
Seat 3: wL5HjWHHOSGc53xWMNKB9Q (button) folded before Flop (didn't bet)
Seat 4: uJVSceLggtsrJya+WtmUEA (small blind) collected ($2)
Seat 5: bFrTkDcWGTxyvNul7GVdYg (big blind) folded before Flop
Seat 6: /P4w1pHg2zHYg/4ubJ0dPw folded before Flop (didn't bet)



PokerStars Game #59940172576:  Hold'em No Limit ($0.50/$1.00) - 2009/07/01 0:59:14 ET
Table 'rmZfTK+oSebeUPJNbWhdAA' 6-max Seat #6 is the button
Seat 1: xAU6q2/cwmby2sxmA8VcmA ($147 in chips)
Seat 2: z7O9PO/WEcqRouIydFhS9Q ($101.50 in chips)
Seat 3: BCEV3COoKY607AzLWayfRA ($135.50 in chips)
Seat 4: 1/mIuXfgx1ZyVkodrmfQDw ($100 in chips)
Seat 5: 5lY8d6Cnm4HUkt/8FZSj4g ($112.50 in chips)
Seat 6: j7NIOHLZk7V2o9fOioO5ug ($118.30 in chips)
xAU6q2/cwmby2sxmA8VcmA: posts small blind $0.50
z7O9PO/WEcqRouIydFhS9Q: posts big blind $1
*** HOLE CARDS ***
BCEV3COoKY607AzLWayfRA: folds
1/mIuXfgx1ZyVkodrmfQDw: folds
5lY8d6Cnm4HUkt/8FZSj4g: folds
j7NIOHLZk7V2o9fOioO5ug: folds
xAU6q2/cwmby2sxmA8VcmA: folds
z7O9PO/WEcqRouIydFhS9Q collected $1 from pot
*** SUMMARY ***
Total pot $1 | Rake $0
Seat 1: xAU6q2/cwmby2sxmA8VcmA (small blind) folded before Flop
Seat 2: z7O9PO/WEcqRouIydFhS9Q (big blind) collected ($1)
Seat 3: BCEV3COoKY607AzLWayfRA folded before Flop (didn't bet)
Seat 4: 1/mIuXfgx1ZyVkodrmfQDw folded before Flop (didn't bet)
Seat 5: 5lY8d6Cnm4HUkt/8FZSj4g folded before Flop (didn't bet)
Seat 6: j7NIOHLZk7V2o9fOioO5ug (button) folded before Flop (didn't bet)



PokerStars Game #59940174876:  Hold'em No Limit ($0.50/$1.00) - 2009/07/01 0:59:18 ET
Table 'SQLOQoANiHscJ8AL7zffbw' 9-max Seat #4 is the button
Seat 1: jPTRd6SpCp4xqAy2XQiTOw ($68.95 in chips)
Seat 2: /zy+DB4S5fUQUSfZWFzYGw ($329.50 in chips)
Seat 3: 0eFnow7+D7veCYQ+CG9FFw ($93.35 in chips)
Seat 4: /mfensKw8/iZ1Vrx33S4xg ($20 in chips)
Seat 5: L9njYvloJ1NdXjP8edHEAg ($104.60 in chips)
Seat 6: p5UKaxVobvptF0ANhR/q1A ($173 in chips)
Seat 7: bJckevFOcg//s0qyMQI6sQ ($100 in chips)
Seat 8: 2BV+oJIQYr65IO6nEChvbA ($60 in chips)
Seat 9: qJr25HAtvv1w/7IBvjMM3g ($202.30 in chips)
L9njYvloJ1NdXjP8edHEAg: posts small blind $0.50
p5UKaxVobvptF0ANhR/q1A: posts big blind $1
*** HOLE CARDS ***
bJckevFOcg//s0qyMQI6sQ: folds
2BV+oJIQYr65IO6nEChvbA: folds
qJr25HAtvv1w/7IBvjMM3g: calls $1
jPTRd6SpCp4xqAy2XQiTOw: folds
/zy+DB4S5fUQUSfZWFzYGw: folds
0eFnow7+D7veCYQ+CG9FFw: folds
/mfensKw8/iZ1Vrx33S4xg: folds
L9njYvloJ1NdXjP8edHEAg: folds
p5UKaxVobvptF0ANhR/q1A: checks
*** FLOP *** [Ts 7h 6d]
p5UKaxVobvptF0ANhR/q1A: checks
qJr25HAtvv1w/7IBvjMM3g: bets $2
p5UKaxVobvptF0ANhR/q1A: folds
qJr25HAtvv1w/7IBvjMM3g collected $2.40 from pot
*** SUMMARY ***
Total pot $2.50 | Rake $0.10
Board [Ts 7h 6d]
Seat 1: jPTRd6SpCp4xqAy2XQiTOw folded before Flop (didn't bet)
Seat 2: /zy+DB4S5fUQUSfZWFzYGw folded before Flop (didn't bet)
Seat 3: 0eFnow7+D7veCYQ+CG9FFw folded before Flop (didn't bet)
Seat 4: /mfensKw8/iZ1Vrx33S4xg (button) folded before Flop (didn't bet)
Seat 5: L9njYvloJ1NdXjP8edHEAg (small blind) folded before Flop
Seat 6: p5UKaxVobvptF0ANhR/q1A (big blind) folded on the Flop
Seat 7: bJckevFOcg//s0qyMQI6sQ folded before Flop (didn't bet)
Seat 8: 2BV+oJIQYr65IO6nEChvbA folded before Flop (didn't bet)
Seat 9: qJr25HAtvv1w/7IBvjMM3g collected ($2.40)



PokerStars Game #59940176308:  Hold'em No Limit ($0.50/$1.00) - 2009/07/01 0:59:20 ET
Table 'vs/5jr6ciwjVQ5+Soc+u2A' 6-max Seat #4 is the button
Seat 1: /P4w1pHg2zHYg/4ubJ0dPw ($60 in chips)
Seat 2: XOIf9W+VAxhZqN+SYoyMKA ($115.85 in chips)
Seat 3: G5ZSSN6RSON3gkNvk/SmYg ($139.35 in chips)
Seat 4: wk6Ohn4GDozoOMHc4eb2rw ($91.65 in chips)
/P4w1pHg2zHYg/4ubJ0dPw: posts small blind $0.50
XOIf9W+VAxhZqN+SYoyMKA: posts big blind $1
*** HOLE CARDS ***
G5ZSSN6RSON3gkNvk/SmYg: folds
wk6Ohn4GDozoOMHc4eb2rw: raises $1 to $2
/P4w1pHg2zHYg/4ubJ0dPw: folds
XOIf9W+VAxhZqN+SYoyMKA: calls $1
*** FLOP *** [6c 9c Qh]
XOIf9W+VAxhZqN+SYoyMKA: checks
wk6Ohn4GDozoOMHc4eb2rw: checks
*** TURN *** [6c 9c Qh] [2d]
+Nt3OPk3XR9SKjZgm2CexQ joins the table at seat #5
XOIf9W+VAxhZqN+SYoyMKA: bets $3
wk6Ohn4GDozoOMHc4eb2rw: folds
XOIf9W+VAxhZqN+SYoyMKA collected $4.30 from pot
XOIf9W+VAxhZqN+SYoyMKA: doesn't show hand
*** SUMMARY ***
Total pot $4.50 | Rake $0.20
Board [6c 9c Qh 2d]
Seat 1: /P4w1pHg2zHYg/4ubJ0dPw (small blind) folded before Flop
Seat 2: XOIf9W+VAxhZqN+SYoyMKA (big blind) collected ($4.30)
Seat 3: G5ZSSN6RSON3gkNvk/SmYg folded before Flop (didn't bet)
Seat 4: wk6Ohn4GDozoOMHc4eb2rw (button) folded on the Turn



PokerStars Game #59940176654:  Hold'em No Limit ($0.50/$1.00) - 2009/07/01 0:59:21 ET
Table '/RZcOwpZpHQ+OwPwjsbnRw' 6-max Seat #3 is the button
Seat 1: Zboa6dColKGHBjLPUakZjw ($73.15 in chips)
Seat 2: +xW7QemQU0Fxs+4TnqBRow ($231.15 in chips)
Seat 3: XnT1yK2DD/5FL+0bwuEhqg ($53.30 in chips)
Seat 4: j7NIOHLZk7V2o9fOioO5ug ($100 in chips)
Seat 5: wx3sQGkVi2x9wJXuWNHPBw ($179.15 in chips)
Seat 6: XOIf9W+VAxhZqN+SYoyMKA ($255.85 in chips)
j7NIOHLZk7V2o9fOioO5ug: posts small blind $0.50
wx3sQGkVi2x9wJXuWNHPBw: posts big blind $1
*** HOLE CARDS ***
XOIf9W+VAxhZqN+SYoyMKA: folds
Zboa6dColKGHBjLPUakZjw: raises $1 to $2
XOIf9W+VAxhZqN+SYoyMKA leaves the table
+xW7QemQU0Fxs+4TnqBRow: folds
XnT1yK2DD/5FL+0bwuEhqg: folds
j7NIOHLZk7V2o9fOioO5ug: folds
wx3sQGkVi2x9wJXuWNHPBw: folds
Zboa6dColKGHBjLPUakZjw collected $2.50 from pot
*** SUMMARY ***
Total pot $2.50 | Rake $0
Seat 1: Zboa6dColKGHBjLPUakZjw collected ($2.50)
Seat 2: +xW7QemQU0Fxs+4TnqBRow folded before Flop (didn't bet)
Seat 3: XnT1yK2DD/5FL+0bwuEhqg (button) folded before Flop (didn't bet)
Seat 4: j7NIOHLZk7V2o9fOioO5ug (small blind) folded before Flop
Seat 5: wx3sQGkVi2x9wJXuWNHPBw (big blind) folded before Flop
Seat 6: XOIf9W+VAxhZqN+SYoyMKA folded before Flop (didn't bet)



PokerStars Game #59940178472:  Hold'em No Limit ($0.50/$1.00) - 2009/07/01 0:59:24 ET
Table 'cKH9c4x6u79IqCdaKKvXrw' 9-max Seat #8 is the button
Seat 1: Pp/KTcXkfZKKUHkjyaLTdg ($17 in chips)
Seat 2: 8S3JMH4TY3whgIlZmMv66w ($69.15 in chips)
Seat 3: 997ViqAtWn1FPjJqcffwcA ($157.10 in chips)
Seat 4: FL3MrLspcF23LYvC4ipBOA ($100 in chips)
Seat 5: Jjc7EHWzs4//xUAjJ0UWoA ($42.15 in chips)
Seat 6: Bsd/K5gAcLanYbGiPirRjw ($210.55 in chips)
Seat 7: 1GkkVBhlJ92guE6K5mS5Ig ($12.65 in chips)
Seat 8: myIxN7otsyr846M539YR8Q ($18.50 in chips)
Seat 9: 6XkTu4ahxzHnvjjc1R8YjQ ($42.10 in chips)
6XkTu4ahxzHnvjjc1R8YjQ: posts small blind $0.50
Pp/KTcXkfZKKUHkjyaLTdg: posts big blind $1
*** HOLE CARDS ***
8S3JMH4TY3whgIlZmMv66w: folds
997ViqAtWn1FPjJqcffwcA: folds
FL3MrLspcF23LYvC4ipBOA: folds
Jjc7EHWzs4//xUAjJ0UWoA: folds
Bsd/K5gAcLanYbGiPirRjw: folds
1GkkVBhlJ92guE6K5mS5Ig: folds
myIxN7otsyr846M539YR8Q: folds
6XkTu4ahxzHnvjjc1R8YjQ: folds
Pp/KTcXkfZKKUHkjyaLTdg collected $1 from pot
Pp/KTcXkfZKKUHkjyaLTdg: doesn't show hand
*** SUMMARY ***
Total pot $1 | Rake $0
Seat 1: Pp/KTcXkfZKKUHkjyaLTdg (big blind) collected ($1)
Seat 2: 8S3JMH4TY3whgIlZmMv66w folded before Flop (didn't bet)
Seat 3: 997ViqAtWn1FPjJqcffwcA folded before Flop (didn't bet)
Seat 4: FL3MrLspcF23LYvC4ipBOA folded before Flop (didn't bet)
Seat 5: Jjc7EHWzs4//xUAjJ0UWoA folded before Flop (didn't bet)
Seat 6: Bsd/K5gAcLanYbGiPirRjw folded before Flop (didn't bet)
Seat 7: 1GkkVBhlJ92guE6K5mS5Ig folded before Flop (didn't bet)
Seat 8: myIxN7otsyr846M539YR8Q (button) folded before Flop (didn't bet)
Seat 9: 6XkTu4ahxzHnvjjc1R8YjQ (small blind) folded before Flop



PokerStars Game #59940178754:  Hold'em No Limit ($0.50/$1.00) - 2009/07/01 0:59:24 ET
Table '/FUb199IViHMJHi5YWmeuQ' 9-max Seat #3 is the button
Seat 1: TZcz9MEWDA+WydgGruqqbw ($120 in chips)
Seat 2: FL3MrLspcF23LYvC4ipBOA ($178.05 in chips)
Seat 3: qN483QJ1NvHbdIZB7J4ARw ($20.70 in chips)
Seat 4: qheQay5YvP2DMAb3OUSxtw ($142.35 in chips)
Seat 6: ccFf7Q4z1cTGQmeoYiWEfw ($56.45 in chips)
Seat 7: bLbSOSmSOnqE0iTcH/5dxA ($100.20 in chips)
Seat 8: 997ViqAtWn1FPjJqcffwcA ($103 in chips)
Seat 9: RfLbneGRY8yQUpMgDnJCxA ($63.95 in chips)
qheQay5YvP2DMAb3OUSxtw: posts small blind $0.50
kiakSwxX0e64PwYGAPQvLw: is sitting out
ccFf7Q4z1cTGQmeoYiWEfw: posts big blind $1
*** HOLE CARDS ***
kiakSwxX0e64PwYGAPQvLw leaves the table
bLbSOSmSOnqE0iTcH/5dxA: calls $1
997ViqAtWn1FPjJqcffwcA: folds
RfLbneGRY8yQUpMgDnJCxA: folds
TZcz9MEWDA+WydgGruqqbw: folds
FL3MrLspcF23LYvC4ipBOA: folds
qN483QJ1NvHbdIZB7J4ARw: folds
vincentt85 joins the table at seat #5
qheQay5YvP2DMAb3OUSxtw: raises $4 to $5
ccFf7Q4z1cTGQmeoYiWEfw: calls $4
bLbSOSmSOnqE0iTcH/5dxA: folds
*** FLOP *** [3s 8d Tc]
qheQay5YvP2DMAb3OUSxtw: bets $7
ccFf7Q4z1cTGQmeoYiWEfw: folds
qheQay5YvP2DMAb3OUSxtw collected $10.45 from pot
qheQay5YvP2DMAb3OUSxtw: doesn't show hand
*** SUMMARY ***
Total pot $11 | Rake $0.55
Board [3s 8d Tc]
Seat 1: TZcz9MEWDA+WydgGruqqbw folded before Flop (didn't bet)
Seat 2: FL3MrLspcF23LYvC4ipBOA folded before Flop (didn't bet)
Seat 3: qN483QJ1NvHbdIZB7J4ARw (button) folded before Flop (didn't bet)
Seat 4: qheQay5YvP2DMAb3OUSxtw (small blind) collected ($10.45)
Seat 6: ccFf7Q4z1cTGQmeoYiWEfw (big blind) folded on the Flop
Seat 7: bLbSOSmSOnqE0iTcH/5dxA folded before Flop
Seat 8: 997ViqAtWn1FPjJqcffwcA folded before Flop (didn't bet)
Seat 9: RfLbneGRY8yQUpMgDnJCxA folded before Flop (didn't bet)



PokerStars Game #59940181114:  Hold'em No Limit ($0.50/$1.00) - 2009/07/01 0:59:28 ET
Table 'LmXQK9xy3awB+qsPzI21Mw' 2-max Seat #2 is the button
Seat 1: NYi6JFscYNrofSXy4sM+Yw ($267.75 in chips)
Seat 2: TME8GvochpQAo8cmJwWmvA ($120.30 in chips)
TME8GvochpQAo8cmJwWmvA: posts small blind $0.50
NYi6JFscYNrofSXy4sM+Yw: posts big blind $1
*** HOLE CARDS ***
TME8GvochpQAo8cmJwWmvA: raises $1 to $2
NYi6JFscYNrofSXy4sM+Yw: calls $1
*** FLOP *** [Qh 3c 2c]
NYi6JFscYNrofSXy4sM+Yw: bets $2.50
TME8GvochpQAo8cmJwWmvA: folds
NYi6JFscYNrofSXy4sM+Yw collected $3.80 from pot
*** SUMMARY ***
Total pot $4 | Rake $0.20
Board [Qh 3c 2c]
Seat 1: NYi6JFscYNrofSXy4sM+Yw (big blind) collected ($3.80)
Seat 2: TME8GvochpQAo8cmJwWmvA (button) (small blind) folded on the Flop



PokerStars Game #59940181880:  Hold'em No Limit ($0.50/$1.00) - 2009/07/01 0:59:29 ET
Table 'fTlPiCj0utgzC/5io+I7ew' 6-max Seat #4 is the button
Seat 1: YMJG+F++3Aj6P8dAWda5fw ($100 in chips)
Seat 2: Qy/UBNbD2HaA0Ogxg8Sf3w ($126.85 in chips)
Seat 3: wL5HjWHHOSGc53xWMNKB9Q ($29.10 in chips)
Seat 4: uJVSceLggtsrJya+WtmUEA ($120.75 in chips)
Seat 5: bFrTkDcWGTxyvNul7GVdYg ($306.55 in chips)
Seat 6: /P4w1pHg2zHYg/4ubJ0dPw ($61.50 in chips)
bFrTkDcWGTxyvNul7GVdYg: posts small blind $0.50
/P4w1pHg2zHYg/4ubJ0dPw: posts big blind $1
*** HOLE CARDS ***
YMJG+F++3Aj6P8dAWda5fw: folds
Qy/UBNbD2HaA0Ogxg8Sf3w: folds
wL5HjWHHOSGc53xWMNKB9Q: raises $2 to $3
uJVSceLggtsrJya+WtmUEA: folds
bFrTkDcWGTxyvNul7GVdYg: folds
/P4w1pHg2zHYg/4ubJ0dPw: folds
wL5HjWHHOSGc53xWMNKB9Q collected $2.50 from pot
*** SUMMARY ***
Total pot $2.50 | Rake $0
Seat 1: YMJG+F++3Aj6P8dAWda5fw folded before Flop (didn't bet)
Seat 2: Qy/UBNbD2HaA0Ogxg8Sf3w folded before Flop (didn't bet)
Seat 3: wL5HjWHHOSGc53xWMNKB9Q collected ($2.50)
Seat 4: uJVSceLggtsrJya+WtmUEA (button) folded before Flop (didn't bet)
Seat 5: bFrTkDcWGTxyvNul7GVdYg (small blind) folded before Flop
Seat 6: /P4w1pHg2zHYg/4ubJ0dPw (big blind) folded before Flop



PokerStars Game #59940181470:  Hold'em No Limit ($0.50/$1.00) - 2009/07/01 0:59:29 ET
Table 'tLrtq7gDzxEvckNAI1OS5Q' 6-max Seat #4 is the button
Seat 2: QHvTZcrKe6+maWUfVjP29Q ($100 in chips)
Seat 3: TPZ+m9x+lwoKpv7TMfAUWA ($303.95 in chips)
Seat 4: +uSzP8Jwnw7sKfQ4s66b7w ($46.30 in chips)
Seat 5: OGMLOcTNYZXZU81au7ztUw ($162.65 in chips)
Seat 6: XUk5GQsfNFpHvaToDZ0rZA ($169.90 in chips)
OGMLOcTNYZXZU81au7ztUw: posts small blind $0.50
XUk5GQsfNFpHvaToDZ0rZA: posts big blind $1
*** HOLE CARDS ***
QHvTZcrKe6+maWUfVjP29Q: folds
yestrum2586 joins the table at seat #1
TPZ+m9x+lwoKpv7TMfAUWA: raises $2 to $3
+uSzP8Jwnw7sKfQ4s66b7w: folds
OGMLOcTNYZXZU81au7ztUw: raises $6 to $9
XUk5GQsfNFpHvaToDZ0rZA: folds
yestrum2586 leaves the table
TPZ+m9x+lwoKpv7TMfAUWA: folds
OGMLOcTNYZXZU81au7ztUw collected $7 from pot
OGMLOcTNYZXZU81au7ztUw: doesn't show hand
*** SUMMARY ***
Total pot $7 | Rake $0
Seat 2: QHvTZcrKe6+maWUfVjP29Q folded before Flop (didn't bet)
Seat 3: TPZ+m9x+lwoKpv7TMfAUWA folded before Flop
Seat 4: +uSzP8Jwnw7sKfQ4s66b7w (button) folded before Flop (didn't bet)
Seat 5: OGMLOcTNYZXZU81au7ztUw (small blind) collected ($7)
Seat 6: XUk5GQsfNFpHvaToDZ0rZA (big blind) folded before Flop



PokerStars Game #59940182668:  Hold'em No Limit ($0.50/$1.00) - 2009/07/01 0:59:31 ET
Table '+cA8mcmhaedZ7YcrDdhmeQ' 6-max Seat #6 is the button
Seat 1: lsLuWlcPA3Rh7kJVLzMh0Q ($299.50 in chips)
Seat 2: RqgF7gRoKgRNW8Zoi1ty4A ($105.95 in chips)
Seat 3: 7H5WkGzGvsv56y1iaqHvRg ($27.85 in chips)
Seat 4: 4OO5v3AVduL0tePNx8wk5A ($102.50 in chips)
Seat 5: +7hFKAL0b0O/n8G72TclJA ($66.35 in chips)
Seat 6: YfsTQsY/fxb+YqbdclTHuw ($25.45 in chips)
lsLuWlcPA3Rh7kJVLzMh0Q: posts small blind $0.50
RqgF7gRoKgRNW8Zoi1ty4A: posts big blind $1
*** HOLE CARDS ***
7H5WkGzGvsv56y1iaqHvRg: calls $1
4OO5v3AVduL0tePNx8wk5A: folds
+7hFKAL0b0O/n8G72TclJA: folds
YfsTQsY/fxb+YqbdclTHuw: folds
lsLuWlcPA3Rh7kJVLzMh0Q: calls $0.50
RqgF7gRoKgRNW8Zoi1ty4A: checks
*** FLOP *** [2h 5c As]
lsLuWlcPA3Rh7kJVLzMh0Q: bets $2
RqgF7gRoKgRNW8Zoi1ty4A: calls $2
7H5WkGzGvsv56y1iaqHvRg: calls $2
*** TURN *** [2h 5c As] [Ah]
lsLuWlcPA3Rh7kJVLzMh0Q: checks
RqgF7gRoKgRNW8Zoi1ty4A: bets $6
7H5WkGzGvsv56y1iaqHvRg: folds
lsLuWlcPA3Rh7kJVLzMh0Q: folds
RqgF7gRoKgRNW8Zoi1ty4A collected $8.60 from pot
*** SUMMARY ***
Total pot $9 | Rake $0.40
Board [2h 5c As Ah]
Seat 1: lsLuWlcPA3Rh7kJVLzMh0Q (small blind) folded on the Turn
Seat 2: RqgF7gRoKgRNW8Zoi1ty4A (big blind) collected ($8.60)
Seat 3: 7H5WkGzGvsv56y1iaqHvRg folded on the Turn
Seat 4: 4OO5v3AVduL0tePNx8wk5A folded before Flop (didn't bet)
Seat 5: +7hFKAL0b0O/n8G72TclJA folded before Flop (didn't bet)
Seat 6: YfsTQsY/fxb+YqbdclTHuw (button) folded before Flop (didn't bet)



PokerStars Game #59940182666:  Hold'em No Limit ($0.50/$1.00) - 2009/07/01 0:59:31 ET
Table 'kS0cTQAEi+fdUlJP2gQYvw' 9-max Seat #6 is the button
Seat 1: c/9X4zftzphFxYtxp5kp9w ($68.85 in chips)
Seat 2: D+W9Me7w6Hcx/WRUSKV0dw ($20 in chips)
Seat 3: 2BV+oJIQYr65IO6nEChvbA ($60 in chips)
Seat 4: TZcz9MEWDA+WydgGruqqbw ($100.10 in chips)
Seat 5: 997ViqAtWn1FPjJqcffwcA ($104.15 in chips)
Seat 6: yAbu2QsRPVcjPbqlf/jDxw ($127.65 in chips)
Seat 7: Ffa7Nj4X5fddtROP01hfQg ($126.50 in chips)
Seat 8: QYMfy2FoN6/Qe1LWYuI7fw ($20.50 in chips)
Seat 9: OGgaARGdJQT4awWVNQ957w ($103.50 in chips)
Ffa7Nj4X5fddtROP01hfQg: posts small blind $0.50
QYMfy2FoN6/Qe1LWYuI7fw: posts big blind $1
*** HOLE CARDS ***
OGgaARGdJQT4awWVNQ957w: folds
Ffa7Nj4X5fddtROP01hfQg said, "i had less than $10 an hour ago"
c/9X4zftzphFxYtxp5kp9w: calls $1
D+W9Me7w6Hcx/WRUSKV0dw: folds
2BV+oJIQYr65IO6nEChvbA: calls $1
TZcz9MEWDA+WydgGruqqbw: folds
997ViqAtWn1FPjJqcffwcA: folds
Ffa7Nj4X5fddtROP01hfQg said, "50"
yAbu2QsRPVcjPbqlf/jDxw: folds
Ffa7Nj4X5fddtROP01hfQg: calls $0.50
QYMfy2FoN6/Qe1LWYuI7fw: checks
*** FLOP *** [Ks 7d Kh]
Ffa7Nj4X5fddtROP01hfQg: checks
QYMfy2FoN6/Qe1LWYuI7fw: checks
c/9X4zftzphFxYtxp5kp9w: checks
2BV+oJIQYr65IO6nEChvbA: checks
*** TURN *** [Ks 7d Kh] [6h]
Ffa7Nj4X5fddtROP01hfQg: bets $2
Ffa7Nj4X5fddtROP01hfQg said, "i just stopped playing like a dumba$$"
QYMfy2FoN6/Qe1LWYuI7fw: folds
Ffa7Nj4X5fddtROP01hfQg said, "and caught some cards"
c/9X4zftzphFxYtxp5kp9w: calls $2
Ffa7Nj4X5fddtROP01hfQg said, "lol"
2BV+oJIQYr65IO6nEChvbA: folds
*** RIVER *** [Ks 7d Kh 6h] [Qd]
Ffa7Nj4X5fddtROP01hfQg: checks
c/9X4zftzphFxYtxp5kp9w: checks
*** SHOW DOWN ***
Ffa7Nj4X5fddtROP01hfQg: shows [9d 8c] (a pair of Kings)
c/9X4zftzphFxYtxp5kp9w: mucks hand
Ffa7Nj4X5fddtROP01hfQg collected $7.65 from pot
*** SUMMARY ***
Total pot $8 | Rake $0.35
Board [Ks 7d Kh 6h Qd]
Seat 1: c/9X4zftzphFxYtxp5kp9w mucked
Seat 2: D+W9Me7w6Hcx/WRUSKV0dw folded before Flop (didn't bet)
Seat 3: 2BV+oJIQYr65IO6nEChvbA folded on the Turn
Seat 4: TZcz9MEWDA+WydgGruqqbw folded before Flop (didn't bet)
Seat 5: 997ViqAtWn1FPjJqcffwcA folded before Flop (didn't bet)
Seat 6: yAbu2QsRPVcjPbqlf/jDxw (button) folded before Flop (didn't bet)
Seat 7: Ffa7Nj4X5fddtROP01hfQg (small blind) showed [9d 8c] and won ($7.65) with a pair of Kings
Seat 8: QYMfy2FoN6/Qe1LWYuI7fw (big blind) folded on the Turn
Seat 9: OGgaARGdJQT4awWVNQ957w folded before Flop (didn't bet)



PokerStars Game #59940185170:  Hold'em No Limit ($0.50/$1.00) - 2009/07/01 0:59:35 ET
Table 'hugOjcwJvzEwZbK7tyiWuQ' 9-max Seat #4 is the button
Seat 1: D+W9Me7w6Hcx/WRUSKV0dw ($20 in chips)
Seat 2: r27C1nIV4NS4+qbnrgBQSw ($261 in chips)
Seat 3: jDwhY1kCdc6EkAHbT7PJMQ ($104.75 in chips)
Seat 4: UWB3oeddt/GObx2Mix2Anw ($204.25 in chips)
Seat 5: 5BRGWf+R3nt2WS3b5xX+zA ($20.20 in chips)
Seat 6: gUUvmqdVlmvpal6B8nYrmg ($108.90 in chips)
Seat 7: FL3MrLspcF23LYvC4ipBOA ($111.80 in chips)
Seat 8: /zy+DB4S5fUQUSfZWFzYGw ($101 in chips)
5BRGWf+R3nt2WS3b5xX+zA: posts small blind $0.50
gUUvmqdVlmvpal6B8nYrmg: posts big blind $1
*** HOLE CARDS ***
FL3MrLspcF23LYvC4ipBOA: folds
/zy+DB4S5fUQUSfZWFzYGw: folds
D+W9Me7w6Hcx/WRUSKV0dw: raises $1.45 to $2.45
r27C1nIV4NS4+qbnrgBQSw: folds
jDwhY1kCdc6EkAHbT7PJMQ: folds
UWB3oeddt/GObx2Mix2Anw: calls $2.45
5BRGWf+R3nt2WS3b5xX+zA: calls $1.95
gUUvmqdVlmvpal6B8nYrmg: folds
*** FLOP *** [6h 2s 7c]
5BRGWf+R3nt2WS3b5xX+zA: bets $4
D+W9Me7w6Hcx/WRUSKV0dw: calls $4
UWB3oeddt/GObx2Mix2Anw: calls $4
*** TURN *** [6h 2s 7c] [7s]
5BRGWf+R3nt2WS3b5xX+zA: checks
D+W9Me7w6Hcx/WRUSKV0dw: checks
UWB3oeddt/GObx2Mix2Anw: checks
*** RIVER *** [6h 2s 7c 7s] [Ah]
5BRGWf+R3nt2WS3b5xX+zA: checks
D+W9Me7w6Hcx/WRUSKV0dw: bets $13.55 and is all-in
UWB3oeddt/GObx2Mix2Anw: folds
5BRGWf+R3nt2WS3b5xX+zA: folds
D+W9Me7w6Hcx/WRUSKV0dw collected $19.40 from pot
*** SUMMARY ***
Total pot $20.35 | Rake $0.95
Board [6h 2s 7c 7s Ah]
Seat 1: D+W9Me7w6Hcx/WRUSKV0dw collected ($19.40)
Seat 2: r27C1nIV4NS4+qbnrgBQSw folded before Flop (didn't bet)
Seat 3: jDwhY1kCdc6EkAHbT7PJMQ folded before Flop (didn't bet)
Seat 4: UWB3oeddt/GObx2Mix2Anw (button) folded on the River
Seat 5: 5BRGWf+R3nt2WS3b5xX+zA (small blind) folded on the River
Seat 6: gUUvmqdVlmvpal6B8nYrmg (big blind) folded before Flop
Seat 7: FL3MrLspcF23LYvC4ipBOA folded before Flop (didn't bet)
Seat 8: /zy+DB4S5fUQUSfZWFzYGw folded before Flop (didn't bet)



PokerStars Game #59940186176:  Hold'em No Limit ($0.50/$1.00) - 2009/07/01 0:59:36 ET
Table 'MUPc8FEpe/nR0BKSeReX6Q' 6-max Seat #3 is the button
Seat 2: xAU6q2/cwmby2sxmA8VcmA ($122.70 in chips)
Seat 3: wx3sQGkVi2x9wJXuWNHPBw ($230.35 in chips)
Seat 4: ZA1bp6g8IwtTxkUE4eCjDQ ($195.80 in chips)
Seat 5: UBZQqpnJZdTYYY1FTb0rLA ($103.55 in chips)
Seat 6: oxnw0GLLpFanjhGkxfRSqA ($28.70 in chips)
ZA1bp6g8IwtTxkUE4eCjDQ: posts small blind $0.50
UBZQqpnJZdTYYY1FTb0rLA: posts big blind $1
*** HOLE CARDS ***
oxnw0GLLpFanjhGkxfRSqA: folds
xAU6q2/cwmby2sxmA8VcmA: folds
wx3sQGkVi2x9wJXuWNHPBw: folds
ZA1bp6g8IwtTxkUE4eCjDQ: raises $1 to $2
UBZQqpnJZdTYYY1FTb0rLA: folds
ZA1bp6g8IwtTxkUE4eCjDQ collected $2 from pot
ZA1bp6g8IwtTxkUE4eCjDQ: doesn't show hand
*** SUMMARY ***
Total pot $2 | Rake $0
Seat 2: xAU6q2/cwmby2sxmA8VcmA folded before Flop (didn't bet)
Seat 3: wx3sQGkVi2x9wJXuWNHPBw (button) folded before Flop (didn't bet)
Seat 4: ZA1bp6g8IwtTxkUE4eCjDQ (small blind) collected ($2)
Seat 5: UBZQqpnJZdTYYY1FTb0rLA (big blind) folded before Flop
Seat 6: oxnw0GLLpFanjhGkxfRSqA folded before Flop (didn't bet)



PokerStars Game #59940185988:  Hold'em No Limit ($0.50/$1.00) - 2009/07/01 0:59:36 ET
Table 'JTT1XWaDZHSaMZQK7cR5uw' 2-max Seat #2 is the button
Seat 1: OLplZF6FEnLflv81Hz+Fxg ($110.55 in chips)
Seat 2: BcqgegiOUxmBD3F3umsljg ($100.85 in chips)
BcqgegiOUxmBD3F3umsljg: posts small blind $0.50
OLplZF6FEnLflv81Hz+Fxg: posts big blind $1
*** HOLE CARDS ***
BcqgegiOUxmBD3F3umsljg: raises $1 to $2
OLplZF6FEnLflv81Hz+Fxg: raises $6 to $8
BcqgegiOUxmBD3F3umsljg: folds
OLplZF6FEnLflv81Hz+Fxg collected $4 from pot
*** SUMMARY ***
Total pot $4 | Rake $0
Seat 1: OLplZF6FEnLflv81Hz+Fxg (big blind) collected ($4)
Seat 2: BcqgegiOUxmBD3F3umsljg (button) (small blind) folded before Flop



PokerStars Game #59940186424:  Hold'em No Limit ($0.50/$1.00) - 2009/07/01 0:59:37 ET
Table 'rmZfTK+oSebeUPJNbWhdAA' 6-max Seat #1 is the button
Seat 1: xAU6q2/cwmby2sxmA8VcmA ($146.50 in chips)
Seat 2: z7O9PO/WEcqRouIydFhS9Q ($102 in chips)
Seat 3: BCEV3COoKY607AzLWayfRA ($135.50 in chips)
Seat 4: 1/mIuXfgx1ZyVkodrmfQDw ($100 in chips)
Seat 5: 5lY8d6Cnm4HUkt/8FZSj4g ($112.50 in chips)
Seat 6: j7NIOHLZk7V2o9fOioO5ug ($118.30 in chips)
z7O9PO/WEcqRouIydFhS9Q: posts small blind $0.50
BCEV3COoKY607AzLWayfRA: posts big blind $1
*** HOLE CARDS ***
1/mIuXfgx1ZyVkodrmfQDw: folds
5lY8d6Cnm4HUkt/8FZSj4g: calls $1
j7NIOHLZk7V2o9fOioO5ug: folds
xAU6q2/cwmby2sxmA8VcmA: folds
z7O9PO/WEcqRouIydFhS9Q: calls $0.50
BCEV3COoKY607AzLWayfRA: checks
*** FLOP *** [9h 5s 2h]
z7O9PO/WEcqRouIydFhS9Q: checks
BCEV3COoKY607AzLWayfRA: checks
5lY8d6Cnm4HUkt/8FZSj4g: bets $3
z7O9PO/WEcqRouIydFhS9Q: calls $3
BCEV3COoKY607AzLWayfRA: folds
*** TURN *** [9h 5s 2h] [8h]
z7O9PO/WEcqRouIydFhS9Q: checks
5lY8d6Cnm4HUkt/8FZSj4g: bets $7
z7O9PO/WEcqRouIydFhS9Q: calls $7
*** RIVER *** [9h 5s 2h 8h] [Js]
z7O9PO/WEcqRouIydFhS9Q: bets $9
5lY8d6Cnm4HUkt/8FZSj4g: calls $9
*** SHOW DOWN ***
z7O9PO/WEcqRouIydFhS9Q: shows [Qh Th] (a flush, Queen high)
5lY8d6Cnm4HUkt/8FZSj4g: mucks hand
z7O9PO/WEcqRouIydFhS9Q collected $39.05 from pot
*** SUMMARY ***
Total pot $41 | Rake $1.95
Board [9h 5s 2h 8h Js]
Seat 1: xAU6q2/cwmby2sxmA8VcmA (button) folded before Flop (didn't bet)
Seat 2: z7O9PO/WEcqRouIydFhS9Q (small blind) showed [Qh Th] and won ($39.05) with a flush, Queen high
Seat 3: BCEV3COoKY607AzLWayfRA (big blind) folded on the Flop
Seat 4: 1/mIuXfgx1ZyVkodrmfQDw folded before Flop (didn't bet)
Seat 5: 5lY8d6Cnm4HUkt/8FZSj4g mucked
Seat 6: j7NIOHLZk7V2o9fOioO5ug folded before Flop (didn't bet)



PokerStars Game #59940187396:  Hold'em No Limit ($0.50/$1.00) - 2009/07/01 0:59:38 ET
Table 'LmXQK9xy3awB+qsPzI21Mw' 2-max Seat #1 is the button
Seat 1: NYi6JFscYNrofSXy4sM+Yw ($269.55 in chips)
Seat 2: TME8GvochpQAo8cmJwWmvA ($118.30 in chips)
NYi6JFscYNrofSXy4sM+Yw: posts small blind $0.50
TME8GvochpQAo8cmJwWmvA: posts big blind $1
*** HOLE CARDS ***
NYi6JFscYNrofSXy4sM+Yw: raises $2 to $3
TME8GvochpQAo8cmJwWmvA: folds
NYi6JFscYNrofSXy4sM+Yw collected $2 from pot
NYi6JFscYNrofSXy4sM+Yw: doesn't show hand
*** SUMMARY ***
Total pot $2 | Rake $0
Seat 1: NYi6JFscYNrofSXy4sM+Yw (button) (small blind) collected ($2)
Seat 2: TME8GvochpQAo8cmJwWmvA (big blind) folded before Flop



PokerStars Game #59940187352:  Hold'em No Limit ($0.50/$1.00) - 2009/07/01 0:59:38 ET
Table '/RZcOwpZpHQ+OwPwjsbnRw' 6-max Seat #4 is the button
Seat 1: Zboa6dColKGHBjLPUakZjw ($74.65 in chips)
Seat 2: +xW7QemQU0Fxs+4TnqBRow ($231.15 in chips)
Seat 3: XnT1yK2DD/5FL+0bwuEhqg ($53.30 in chips)
Seat 4: j7NIOHLZk7V2o9fOioO5ug ($100 in chips)
Seat 5: wx3sQGkVi2x9wJXuWNHPBw ($178.15 in chips)
wx3sQGkVi2x9wJXuWNHPBw: posts small blind $0.50
Zboa6dColKGHBjLPUakZjw: posts big blind $1
*** HOLE CARDS ***
+xW7QemQU0Fxs+4TnqBRow: folds
XnT1yK2DD/5FL+0bwuEhqg: folds
j7NIOHLZk7V2o9fOioO5ug: raises $2 to $3
wx3sQGkVi2x9wJXuWNHPBw: folds
Zboa6dColKGHBjLPUakZjw: calls $2
*** FLOP *** [9d 6d 5d]
Zboa6dColKGHBjLPUakZjw: checks
j7NIOHLZk7V2o9fOioO5ug: bets $5
Zboa6dColKGHBjLPUakZjw: folds
j7NIOHLZk7V2o9fOioO5ug collected $6.20 from pot
j7NIOHLZk7V2o9fOioO5ug: doesn't show hand
*** SUMMARY ***
Total pot $6.50 | Rake $0.30
Board [9d 6d 5d]
Seat 1: Zboa6dColKGHBjLPUakZjw (big blind) folded on the Flop
Seat 2: +xW7QemQU0Fxs+4TnqBRow folded before Flop (didn't bet)
Seat 3: XnT1yK2DD/5FL+0bwuEhqg folded before Flop (didn't bet)
Seat 4: j7NIOHLZk7V2o9fOioO5ug (button) collected ($6.20)
Seat 5: wx3sQGkVi2x9wJXuWNHPBw (small blind) folded before Flop



PokerStars Game #59940187312:  Hold'em No Limit ($0.50/$1.00) - 2009/07/01 0:59:38 ET
Table 'eU3bWpDDg3Z+9R4m4iVmog' 6-max Seat #4 is the button
Seat 1: TSuRyAHnUPCFjP7Z0rEE0w ($191.15 in chips)
Seat 2: 8CAoOzhmB8n3nRFf3V4BTg ($71.30 in chips)
Seat 3: rVMOzU7w5FddYPGhD7qN2Q ($48.15 in chips)
Seat 4: GDVIsbEJ/DOJsMKE4Asz0A ($99.50 in chips)
Seat 6: hpxXcmRkXXI9HE5+5/j/0Q ($119.10 in chips)
hpxXcmRkXXI9HE5+5/j/0Q: posts small blind $0.50
TSuRyAHnUPCFjP7Z0rEE0w: posts big blind $1
*** HOLE CARDS ***
8CAoOzhmB8n3nRFf3V4BTg: raises $2 to $3
rVMOzU7w5FddYPGhD7qN2Q: folds
GDVIsbEJ/DOJsMKE4Asz0A: folds
hpxXcmRkXXI9HE5+5/j/0Q: raises $9 to $12
TSuRyAHnUPCFjP7Z0rEE0w: folds
8CAoOzhmB8n3nRFf3V4BTg: calls $9
*** FLOP *** [Jd Qd 6d]
hpxXcmRkXXI9HE5+5/j/0Q: bets $17
8CAoOzhmB8n3nRFf3V4BTg: folds
hpxXcmRkXXI9HE5+5/j/0Q collected $23.75 from pot
hpxXcmRkXXI9HE5+5/j/0Q: doesn't show hand
*** SUMMARY ***
Total pot $25 | Rake $1.25
Board [Jd Qd 6d]
Seat 1: TSuRyAHnUPCFjP7Z0rEE0w (big blind) folded before Flop
Seat 2: 8CAoOzhmB8n3nRFf3V4BTg folded on the Flop
Seat 3: rVMOzU7w5FddYPGhD7qN2Q folded before Flop (didn't bet)
Seat 4: GDVIsbEJ/DOJsMKE4Asz0A (button) folded before Flop (didn't bet)
Seat 6: hpxXcmRkXXI9HE5+5/j/0Q (small blind) collected ($23.75)



PokerStars Game #59940187124:  Hold'em No Limit ($0.50/$1.00) - 2009/07/01 0:59:38 ET
Table '8jIjWCPY0NGprquL+xcMFg' 9-max Seat #9 is the button
Seat 2: laA8va+Yv8WuMqT1zdR91g ($109.20 in chips)
Seat 3: tjhwe1V98x2spSoUQER3HQ ($104.50 in chips)
Seat 4: Jjc7EHWzs4//xUAjJ0UWoA ($18.90 in chips)
Seat 5: 2YpnxJiexJHyERfbqgwEcw ($60.55 in chips)
Seat 6: GTQkFJtSkbVbnGCktp6e3g ($101.35 in chips)
Seat 7: O3CGPwwUmamrCNHccOilrg ($41.45 in chips)
Seat 8: D+W9Me7w6Hcx/WRUSKV0dw ($18.50 in chips)
Seat 9: negfosHnGOZXSHpWDRKyBQ ($47.50 in chips)
N7iZ0peZns5o4A6AjN24jQ will be allowed to play after the button
laA8va+Yv8WuMqT1zdR91g: posts small blind $0.50
tjhwe1V98x2spSoUQER3HQ: posts big blind $1
*** HOLE CARDS ***
Jjc7EHWzs4//xUAjJ0UWoA: folds
2YpnxJiexJHyERfbqgwEcw: raises $2 to $3
GTQkFJtSkbVbnGCktp6e3g: folds
O3CGPwwUmamrCNHccOilrg: folds
D+W9Me7w6Hcx/WRUSKV0dw: folds
negfosHnGOZXSHpWDRKyBQ: calls $3
laA8va+Yv8WuMqT1zdR91g: folds
tjhwe1V98x2spSoUQER3HQ: folds
*** FLOP *** [5d 3h 8c]
2YpnxJiexJHyERfbqgwEcw: checks
negfosHnGOZXSHpWDRKyBQ: checks
*** TURN *** [5d 3h 8c] [Th]
2YpnxJiexJHyERfbqgwEcw: checks
negfosHnGOZXSHpWDRKyBQ: bets $5
2YpnxJiexJHyERfbqgwEcw: calls $5
*** RIVER *** [5d 3h 8c Th] [3s]
2YpnxJiexJHyERfbqgwEcw: checks
negfosHnGOZXSHpWDRKyBQ: bets $11
2YpnxJiexJHyERfbqgwEcw: folds
negfosHnGOZXSHpWDRKyBQ collected $16.65 from pot
negfosHnGOZXSHpWDRKyBQ: doesn't show hand
*** SUMMARY ***
Total pot $17.50 | Rake $0.85
Board [5d 3h 8c Th 3s]
Seat 2: laA8va+Yv8WuMqT1zdR91g (small blind) folded before Flop
Seat 3: tjhwe1V98x2spSoUQER3HQ (big blind) folded before Flop
Seat 4: Jjc7EHWzs4//xUAjJ0UWoA folded before Flop (didn't bet)
Seat 5: 2YpnxJiexJHyERfbqgwEcw folded on the River
Seat 6: GTQkFJtSkbVbnGCktp6e3g folded before Flop (didn't bet)
Seat 7: O3CGPwwUmamrCNHccOilrg folded before Flop (didn't bet)
Seat 8: D+W9Me7w6Hcx/WRUSKV0dw folded before Flop (didn't bet)
Seat 9: negfosHnGOZXSHpWDRKyBQ (button) collected ($16.65)



PokerStars Game #59940188132:  Hold'em No Limit ($0.50/$1.00) - 2009/07/01 0:59:40 ET
Table 'uNlePsyMIqzM691Xkrlk6Q' 9-max Seat #8 is the button
Seat 1: bLbSOSmSOnqE0iTcH/5dxA ($100 in chips)
Seat 2: +OqpStnt0FqbCfyHAWaLbg ($100.15 in chips)
Seat 3: h7qXkU57Bb8ZuPwMyxR8Ug ($15.15 in chips)
Seat 4: TZcz9MEWDA+WydgGruqqbw ($100 in chips)
Seat 5: 3obndzTJ6fECz8+wWhMd1w ($17 in chips)
Seat 6: myIxN7otsyr846M539YR8Q ($21.50 in chips)
Seat 7: w6cw9nzN7AvkkHBVVjykoQ ($54.25 in chips)
Seat 8: laA8va+Yv8WuMqT1zdR91g ($104.50 in chips)
VPF+HjszMvUIpy0CHIwH3A will be allowed to play after the button
bLbSOSmSOnqE0iTcH/5dxA: posts small blind $0.50
+OqpStnt0FqbCfyHAWaLbg: posts big blind $1
*** HOLE CARDS ***
h7qXkU57Bb8ZuPwMyxR8Ug: folds
TZcz9MEWDA+WydgGruqqbw: folds
3obndzTJ6fECz8+wWhMd1w: folds
myIxN7otsyr846M539YR8Q: folds
w6cw9nzN7AvkkHBVVjykoQ: folds
laA8va+Yv8WuMqT1zdR91g: raises $2 to $3
bLbSOSmSOnqE0iTcH/5dxA: folds
+OqpStnt0FqbCfyHAWaLbg: calls $2
*** FLOP *** [As Ts Ac]
+OqpStnt0FqbCfyHAWaLbg: checks
laA8va+Yv8WuMqT1zdR91g: bets $5
+OqpStnt0FqbCfyHAWaLbg: folds
laA8va+Yv8WuMqT1zdR91g collected $6.20 from pot
laA8va+Yv8WuMqT1zdR91g: doesn't show hand
*** SUMMARY ***
Total pot $6.50 | Rake $0.30
Board [As Ts Ac]
Seat 1: bLbSOSmSOnqE0iTcH/5dxA (small blind) folded before Flop
Seat 2: +OqpStnt0FqbCfyHAWaLbg (big blind) folded on the Flop
Seat 3: h7qXkU57Bb8ZuPwMyxR8Ug folded before Flop (didn't bet)
Seat 4: TZcz9MEWDA+WydgGruqqbw folded before Flop (didn't bet)
Seat 5: 3obndzTJ6fECz8+wWhMd1w folded before Flop (didn't bet)
Seat 6: myIxN7otsyr846M539YR8Q folded before Flop (didn't bet)
Seat 7: w6cw9nzN7AvkkHBVVjykoQ folded before Flop (didn't bet)
Seat 8: laA8va+Yv8WuMqT1zdR91g (button) collected ($6.20)



PokerStars Game #59940188160:  Hold'em No Limit ($0.50/$1.00) - 2009/07/01 0:59:40 ET
Table 'cKH9c4x6u79IqCdaKKvXrw' 9-max Seat #9 is the button
Seat 1: Pp/KTcXkfZKKUHkjyaLTdg ($17.50 in chips)
Seat 2: 8S3JMH4TY3whgIlZmMv66w ($69.15 in chips)
Seat 3: 997ViqAtWn1FPjJqcffwcA ($157.10 in chips)
Seat 4: FL3MrLspcF23LYvC4ipBOA ($100 in chips)
Seat 5: Jjc7EHWzs4//xUAjJ0UWoA ($42.15 in chips)
Seat 6: Bsd/K5gAcLanYbGiPirRjw ($210.55 in chips)
Seat 7: 1GkkVBhlJ92guE6K5mS5Ig ($12.65 in chips)
Seat 8: myIxN7otsyr846M539YR8Q ($18.50 in chips)
Seat 9: 6XkTu4ahxzHnvjjc1R8YjQ ($41.60 in chips)
Pp/KTcXkfZKKUHkjyaLTdg: posts small blind $0.50
8S3JMH4TY3whgIlZmMv66w: posts big blind $1
*** HOLE CARDS ***
997ViqAtWn1FPjJqcffwcA: folds
FL3MrLspcF23LYvC4ipBOA: folds
Jjc7EHWzs4//xUAjJ0UWoA: folds
Bsd/K5gAcLanYbGiPirRjw: folds
1GkkVBhlJ92guE6K5mS5Ig: raises $2 to $3
myIxN7otsyr846M539YR8Q: folds
6XkTu4ahxzHnvjjc1R8YjQ: folds
Pp/KTcXkfZKKUHkjyaLTdg: folds
8S3JMH4TY3whgIlZmMv66w: folds
1GkkVBhlJ92guE6K5mS5Ig collected $2.50 from pot
*** SUMMARY ***
Total pot $2.50 | Rake $0
Seat 1: Pp/KTcXkfZKKUHkjyaLTdg (small blind) folded before Flop
Seat 2: 8S3JMH4TY3whgIlZmMv66w (big blind) folded before Flop
Seat 3: 997ViqAtWn1FPjJqcffwcA folded before Flop (didn't bet)
Seat 4: FL3MrLspcF23LYvC4ipBOA folded before Flop (didn't bet)
Seat 5: Jjc7EHWzs4//xUAjJ0UWoA folded before Flop (didn't bet)
Seat 6: Bsd/K5gAcLanYbGiPirRjw folded before Flop (didn't bet)
Seat 7: 1GkkVBhlJ92guE6K5mS5Ig collected ($2.50)
Seat 8: myIxN7otsyr846M539YR8Q folded before Flop (didn't bet)
Seat 9: 6XkTu4ahxzHnvjjc1R8YjQ (button) folded before Flop (didn't bet)



PokerStars Game #59940189640:  Hold'em No Limit ($0.50/$1.00) - 2009/07/01 0:59:42 ET
Table 'iSx0wTgVb4o7MyZeOe06ZA' 9-max Seat #6 is the button
Seat 2: myIxN7otsyr846M539YR8Q ($20 in chips)
Seat 3: XQV7mCMbzd2Wh/l74wmbug ($95.45 in chips)
Seat 5: o1axyw4AjQ8n4ubTwlirQQ ($22 in chips)
Seat 6: T5/PXFS/W+LLcIXBo1G/RA ($105.15 in chips)
Seat 7: w4NnqVr/Sfoj65ux/fEUyQ ($78.40 in chips)
Seat 8: gUUvmqdVlmvpal6B8nYrmg ($100 in chips)
Seat 9: DMQXVuViR4IFzRccosBkJw ($58.05 in chips)
w4NnqVr/Sfoj65ux/fEUyQ: posts small blind $0.50
gUUvmqdVlmvpal6B8nYrmg: posts big blind $1
VPF+HjszMvUIpy0CHIwH3A: sits out
0fXz44fzDo5QmhAaJCvFfA: sits out
*** HOLE CARDS ***
DMQXVuViR4IFzRccosBkJw: calls $1
myIxN7otsyr846M539YR8Q: folds
XQV7mCMbzd2Wh/l74wmbug: calls $1
o1axyw4AjQ8n4ubTwlirQQ: folds
T5/PXFS/W+LLcIXBo1G/RA: folds
w4NnqVr/Sfoj65ux/fEUyQ: folds
gUUvmqdVlmvpal6B8nYrmg: checks
*** FLOP *** [2c Kd 6s]
gUUvmqdVlmvpal6B8nYrmg: checks
DMQXVuViR4IFzRccosBkJw: checks
XQV7mCMbzd2Wh/l74wmbug: bets $2
gUUvmqdVlmvpal6B8nYrmg: folds
DMQXVuViR4IFzRccosBkJw: folds
XQV7mCMbzd2Wh/l74wmbug collected $3.35 from pot
*** SUMMARY ***
Total pot $3.50 | Rake $0.15
Board [2c Kd 6s]
Seat 2: myIxN7otsyr846M539YR8Q folded before Flop (didn't bet)
Seat 3: XQV7mCMbzd2Wh/l74wmbug collected ($3.35)
Seat 5: o1axyw4AjQ8n4ubTwlirQQ folded before Flop (didn't bet)
Seat 6: T5/PXFS/W+LLcIXBo1G/RA (button) folded before Flop (didn't bet)
Seat 7: w4NnqVr/Sfoj65ux/fEUyQ (small blind) folded before Flop
Seat 8: gUUvmqdVlmvpal6B8nYrmg (big blind) folded on the Flop
Seat 9: DMQXVuViR4IFzRccosBkJw folded on the Flop



PokerStars Game #59940191420:  Hold'em No Limit ($0.50/$1.00) - 2009/07/01 0:59:45 ET
Table 'tJq9SfN1ywY0r03VBlWlwQ' 9-max Seat #2 is the button
Seat 1: wZsU+w9r7G66x93UuvBf1Q ($340.80 in chips)
Seat 2: RqkO8O/Y3qlc3PIuCAHjVg ($75.20 in chips)
Seat 3: FVs16t7GgfWgQWt4JxsObQ ($37 in chips)
Seat 4: bLbSOSmSOnqE0iTcH/5dxA ($110.20 in chips)
Seat 5: Ogn4JDV3mp4ZDKO49IFzKA ($17.25 in chips)
Seat 6: gUUvmqdVlmvpal6B8nYrmg ($116.05 in chips)
Seat 7: qVhRZ0PLZ95XRJHWAjXjOQ ($129.90 in chips)
Seat 8: G4DEhsZFmznGNVpy2SEocA ($22 in chips)
Seat 9: XE5QF1y74bpHog9JxWJMWQ ($102 in chips)
FVs16t7GgfWgQWt4JxsObQ: posts small blind $0.50
bLbSOSmSOnqE0iTcH/5dxA: posts big blind $1
*** HOLE CARDS ***
Ogn4JDV3mp4ZDKO49IFzKA: folds
gUUvmqdVlmvpal6B8nYrmg: folds
qVhRZ0PLZ95XRJHWAjXjOQ: folds
G4DEhsZFmznGNVpy2SEocA: folds
XE5QF1y74bpHog9JxWJMWQ: folds
wZsU+w9r7G66x93UuvBf1Q: folds
RqkO8O/Y3qlc3PIuCAHjVg: folds
FVs16t7GgfWgQWt4JxsObQ: calls $0.50
bLbSOSmSOnqE0iTcH/5dxA: checks
*** FLOP *** [2h Qc 3d]
FVs16t7GgfWgQWt4JxsObQ: checks
bLbSOSmSOnqE0iTcH/5dxA: checks
*** TURN *** [2h Qc 3d] [Qd]
FVs16t7GgfWgQWt4JxsObQ: checks
bLbSOSmSOnqE0iTcH/5dxA: checks
*** RIVER *** [2h Qc 3d Qd] [7d]
FVs16t7GgfWgQWt4JxsObQ: checks
bLbSOSmSOnqE0iTcH/5dxA: checks
*** SHOW DOWN ***
FVs16t7GgfWgQWt4JxsObQ: shows [7s Jc] (two pair, Queens and Sevens)
bLbSOSmSOnqE0iTcH/5dxA: mucks hand
FVs16t7GgfWgQWt4JxsObQ collected $1.90 from pot
*** SUMMARY ***
Total pot $2 | Rake $0.10
Board [2h Qc 3d Qd 7d]
Seat 1: wZsU+w9r7G66x93UuvBf1Q folded before Flop (didn't bet)
Seat 2: RqkO8O/Y3qlc3PIuCAHjVg (button) folded before Flop (didn't bet)
Seat 3: FVs16t7GgfWgQWt4JxsObQ (small blind) showed [7s Jc] and won ($1.90) with two pair, Queens and Sevens
Seat 4: bLbSOSmSOnqE0iTcH/5dxA (big blind) mucked
Seat 5: Ogn4JDV3mp4ZDKO49IFzKA folded before Flop (didn't bet)
Seat 6: gUUvmqdVlmvpal6B8nYrmg folded before Flop (didn't bet)
Seat 7: qVhRZ0PLZ95XRJHWAjXjOQ folded before Flop (didn't bet)
Seat 8: G4DEhsZFmznGNVpy2SEocA folded before Flop (didn't bet)
Seat 9: XE5QF1y74bpHog9JxWJMWQ folded before Flop (didn't bet)



PokerStars Game #59940191566:  Hold'em No Limit ($0.50/$1.00) - 2009/07/01 0:59:45 ET
Table 'LmXQK9xy3awB+qsPzI21Mw' 2-max Seat #2 is the button
Seat 1: NYi6JFscYNrofSXy4sM+Yw ($270.55 in chips)
Seat 2: TME8GvochpQAo8cmJwWmvA ($117.30 in chips)
TME8GvochpQAo8cmJwWmvA: posts small blind $0.50
NYi6JFscYNrofSXy4sM+Yw: posts big blind $1
*** HOLE CARDS ***
TME8GvochpQAo8cmJwWmvA: raises $1 to $2
NYi6JFscYNrofSXy4sM+Yw: folds
TME8GvochpQAo8cmJwWmvA collected $2 from pot
*** SUMMARY ***
Total pot $2 | Rake $0
Seat 1: NYi6JFscYNrofSXy4sM+Yw (big blind) folded before Flop
Seat 2: TME8GvochpQAo8cmJwWmvA (button) (small blind) collected ($2)



PokerStars Game #59940192612:  Hold'em No Limit ($0.50/$1.00) - 2009/07/01 0:59:47 ET
Table 'cBDNutyLBKEk9+ptwsKmTw' 6-max Seat #4 is the button
Seat 1: xAU6q2/cwmby2sxmA8VcmA ($121.35 in chips)
Seat 2: 5lY8d6Cnm4HUkt/8FZSj4g ($78.15 in chips)
Seat 3: G5ZSSN6RSON3gkNvk/SmYg ($101.65 in chips)
Seat 4: 3q7F5QtzC30pSrn0nl9i+A ($35.80 in chips)
Seat 5: OGMLOcTNYZXZU81au7ztUw ($157.65 in chips)
Seat 6: NqVlOSH2lp+pp/TK3vvK5g ($37.75 in chips)
OGMLOcTNYZXZU81au7ztUw: posts small blind $0.50
NqVlOSH2lp+pp/TK3vvK5g: posts big blind $1
*** HOLE CARDS ***
xAU6q2/cwmby2sxmA8VcmA: folds
5lY8d6Cnm4HUkt/8FZSj4g: folds
G5ZSSN6RSON3gkNvk/SmYg: folds
3q7F5QtzC30pSrn0nl9i+A: calls $1
OGMLOcTNYZXZU81au7ztUw: folds
NqVlOSH2lp+pp/TK3vvK5g: checks
*** FLOP *** [6s Kh 3s]
NqVlOSH2lp+pp/TK3vvK5g: checks
3q7F5QtzC30pSrn0nl9i+A: checks
*** TURN *** [6s Kh 3s] [4c]
NqVlOSH2lp+pp/TK3vvK5g: checks
3q7F5QtzC30pSrn0nl9i+A: checks
*** RIVER *** [6s Kh 3s 4c] [5s]
NqVlOSH2lp+pp/TK3vvK5g: bets $1
3q7F5QtzC30pSrn0nl9i+A: calls $1
*** SHOW DOWN ***
NqVlOSH2lp+pp/TK3vvK5g: shows [5d Qh] (a pair of Fives)
3q7F5QtzC30pSrn0nl9i+A: mucks hand
NqVlOSH2lp+pp/TK3vvK5g collected $4.30 from pot
*** SUMMARY ***
Total pot $4.50 | Rake $0.20
Board [6s Kh 3s 4c 5s]
Seat 1: xAU6q2/cwmby2sxmA8VcmA folded before Flop (didn't bet)
Seat 2: 5lY8d6Cnm4HUkt/8FZSj4g folded before Flop (didn't bet)
Seat 3: G5ZSSN6RSON3gkNvk/SmYg folded before Flop (didn't bet)
Seat 4: 3q7F5QtzC30pSrn0nl9i+A (button) mucked
Seat 5: OGMLOcTNYZXZU81au7ztUw (small blind) folded before Flop
Seat 6: NqVlOSH2lp+pp/TK3vvK5g (big blind) showed [5d Qh] and won ($4.30) with a pair of Fives



PokerStars Game #59940194634:  Hold'em No Limit ($0.50/$1.00) - 2009/07/01 0:59:50 ET
Table 'vs/5jr6ciwjVQ5+Soc+u2A' 6-max Seat #1 is the button
Seat 1: /P4w1pHg2zHYg/4ubJ0dPw ($60 in chips)
Seat 2: XOIf9W+VAxhZqN+SYoyMKA ($118.15 in chips)
Seat 3: G5ZSSN6RSON3gkNvk/SmYg ($139.35 in chips)
Seat 4: wk6Ohn4GDozoOMHc4eb2rw ($89.65 in chips)
XOIf9W+VAxhZqN+SYoyMKA: posts small blind $0.50
G5ZSSN6RSON3gkNvk/SmYg: posts big blind $1
+Nt3OPk3XR9SKjZgm2CexQ: sits out
*** HOLE CARDS ***
wk6Ohn4GDozoOMHc4eb2rw: raises $2 to $3
/P4w1pHg2zHYg/4ubJ0dPw: folds
XOIf9W+VAxhZqN+SYoyMKA: folds
G5ZSSN6RSON3gkNvk/SmYg: folds
wk6Ohn4GDozoOMHc4eb2rw collected $2.50 from pot
wk6Ohn4GDozoOMHc4eb2rw: doesn't show hand
*** SUMMARY ***
Total pot $2.50 | Rake $0
Seat 1: /P4w1pHg2zHYg/4ubJ0dPw (button) folded before Flop (didn't bet)
Seat 2: XOIf9W+VAxhZqN+SYoyMKA (small blind) folded before Flop
Seat 3: G5ZSSN6RSON3gkNvk/SmYg (big blind) folded before Flop
Seat 4: wk6Ohn4GDozoOMHc4eb2rw collected ($2.50)



PokerStars Game #59940194452:  Hold'em No Limit ($0.50/$1.00) - 2009/07/01 0:59:50 ET
Table 'W/wyObTiXZm+Ckkl3YxcSw' 6-max Seat #5 is the button
Seat 1: eUBBn2R56C1IQ6Cs/vitwg ($142.70 in chips)
Seat 2: oDiBRCaF0QVtd3kO6xZIXw ($109.35 in chips)
Seat 3: dxyNCn/qxfkGDUIf28Cbng ($85.90 in chips)
Seat 5: BdbmJTZZ47quA9vUWwXtlw ($60.85 in chips)
eUBBn2R56C1IQ6Cs/vitwg: posts small blind $0.50
oDiBRCaF0QVtd3kO6xZIXw: posts big blind $1
*** HOLE CARDS ***
dxyNCn/qxfkGDUIf28Cbng: raises $2 to $3
tS9JHB1h+FQ++qu8RwRNgg leaves the table
BdbmJTZZ47quA9vUWwXtlw: folds
eUBBn2R56C1IQ6Cs/vitwg: folds
oDiBRCaF0QVtd3kO6xZIXw: folds
dxyNCn/qxfkGDUIf28Cbng collected $2.50 from pot
OGMLOcTNYZXZU81au7ztUw joins the table at seat #6
*** SUMMARY ***
Total pot $2.50 | Rake $0
Seat 1: eUBBn2R56C1IQ6Cs/vitwg (small blind) folded before Flop
Seat 2: oDiBRCaF0QVtd3kO6xZIXw (big blind) folded before Flop
Seat 3: dxyNCn/qxfkGDUIf28Cbng collected ($2.50)
Seat 5: BdbmJTZZ47quA9vUWwXtlw (button) folded before Flop (didn't bet)



PokerStars Game #59940194298:  Hold'em No Limit ($0.50/$1.00) - 2009/07/01 0:59:50 ET
Table 'GPp0HyAuggN8oE0sUWzPpA' 9-max Seat #4 is the button
Seat 1: qJr25HAtvv1w/7IBvjMM3g ($27.50 in chips)
Seat 2: m3U8I35Pn3gxKhoS2nmYIg ($56.70 in chips)
Seat 3: CCCXsirC+bO7ginAuUUVlQ ($62.80 in chips)
Seat 4: mBRWbnUl8diyBO1qTJaNzw ($107.30 in chips)
Seat 5: 0fXz44fzDo5QmhAaJCvFfA ($14.65 in chips)
Seat 6: BK/GtNPkSx0TdUDj82id5A ($23.35 in chips)
Seat 7: DHdbHyysD15wCAtx+BhUjA ($94.50 in chips)
Seat 9: VPF+HjszMvUIpy0CHIwH3A ($27.50 in chips)
0fXz44fzDo5QmhAaJCvFfA: posts small blind $0.50
BK/GtNPkSx0TdUDj82id5A: posts big blind $1
John86sand: sits out
CCCXsirC+bO7ginAuUUVlQ: posts small & big blinds $1.50
*** HOLE CARDS ***
DHdbHyysD15wCAtx+BhUjA: folds
VPF+HjszMvUIpy0CHIwH3A: folds
qJr25HAtvv1w/7IBvjMM3g: folds
m3U8I35Pn3gxKhoS2nmYIg: raises $1 to $2
CCCXsirC+bO7ginAuUUVlQ: calls $1
mBRWbnUl8diyBO1qTJaNzw: folds
0fXz44fzDo5QmhAaJCvFfA: folds
BK/GtNPkSx0TdUDj82id5A: calls $1
*** FLOP *** [2h Ks 7s]
BK/GtNPkSx0TdUDj82id5A: checks
m3U8I35Pn3gxKhoS2nmYIg: checks
CCCXsirC+bO7ginAuUUVlQ: bets $3
BK/GtNPkSx0TdUDj82id5A: calls $3
m3U8I35Pn3gxKhoS2nmYIg: folds
*** TURN *** [2h Ks 7s] [Kc]
BK/GtNPkSx0TdUDj82id5A: checks
CCCXsirC+bO7ginAuUUVlQ: checks
*** RIVER *** [2h Ks 7s Kc] [9c]
BK/GtNPkSx0TdUDj82id5A: checks
CCCXsirC+bO7ginAuUUVlQ: checks
*** SHOW DOWN ***
BK/GtNPkSx0TdUDj82id5A: shows [4s As] (a pair of Kings)
CCCXsirC+bO7ginAuUUVlQ: shows [Ac 2c] (two pair, Kings and Deuces)
CCCXsirC+bO7ginAuUUVlQ collected $12.40 from pot
*** SUMMARY ***
Total pot $13 | Rake $0.60
Board [2h Ks 7s Kc 9c]
Seat 1: qJr25HAtvv1w/7IBvjMM3g folded before Flop (didn't bet)
Seat 2: m3U8I35Pn3gxKhoS2nmYIg folded on the Flop
Seat 3: CCCXsirC+bO7ginAuUUVlQ showed [Ac 2c] and won ($12.40) with two pair, Kings and Deuces
Seat 4: mBRWbnUl8diyBO1qTJaNzw (button) folded before Flop (didn't bet)
Seat 5: 0fXz44fzDo5QmhAaJCvFfA (small blind) folded before Flop
Seat 6: BK/GtNPkSx0TdUDj82id5A (big blind) showed [4s As] and lost with a pair of Kings
Seat 7: DHdbHyysD15wCAtx+BhUjA folded before Flop (didn't bet)
Seat 9: VPF+HjszMvUIpy0CHIwH3A folded before Flop (didn't bet)



PokerStars Game #59940194314:  Hold'em No Limit ($0.50/$1.00) - 2009/07/01 0:59:50 ET
Table 'QSIig7BLMc9wY/rgBechzw' 6-max Seat #3 is the button
Seat 2: mLOIkH/qmRa+mVujQIhBRg ($41.55 in chips)
Seat 3: Z3y97GMLCsoTZ9j7f6qctg ($35.80 in chips)
Seat 4: +uSzP8Jwnw7sKfQ4s66b7w ($62.50 in chips)
Seat 5: PVmmeYpn4gqkqYUool6BOA ($19.90 in chips)
Seat 6: PxqfkAMdAWtkgbT+q2gciA ($32.80 in chips)
+uSzP8Jwnw7sKfQ4s66b7w: posts small blind $0.50
PVmmeYpn4gqkqYUool6BOA: posts big blind $1
Z2fXsGcjl+Eax+RzOgwOmg: sits out
*** HOLE CARDS ***
PxqfkAMdAWtkgbT+q2gciA: folds
mLOIkH/qmRa+mVujQIhBRg: calls $1
Z3y97GMLCsoTZ9j7f6qctg: folds
+uSzP8Jwnw7sKfQ4s66b7w: folds
PVmmeYpn4gqkqYUool6BOA: checks
*** FLOP *** [Qd 5d Js]
PVmmeYpn4gqkqYUool6BOA: checks
mLOIkH/qmRa+mVujQIhBRg: bets $2
PVmmeYpn4gqkqYUool6BOA: folds
mLOIkH/qmRa+mVujQIhBRg collected $2.40 from pot
*** SUMMARY ***
Total pot $2.50 | Rake $0.10
Board [Qd 5d Js]
Seat 2: mLOIkH/qmRa+mVujQIhBRg collected ($2.40)
Seat 3: Z3y97GMLCsoTZ9j7f6qctg (button) folded before Flop (didn't bet)
Seat 4: +uSzP8Jwnw7sKfQ4s66b7w (small blind) folded before Flop
Seat 5: PVmmeYpn4gqkqYUool6BOA (big blind) folded on the Flop
Seat 6: PxqfkAMdAWtkgbT+q2gciA folded before Flop (didn't bet)



PokerStars Game #59940195672:  Hold'em No Limit ($0.50/$1.00) - 2009/07/01 0:59:52 ET
Table 'LmXQK9xy3awB+qsPzI21Mw' 2-max Seat #1 is the button
Seat 1: NYi6JFscYNrofSXy4sM+Yw ($269.55 in chips)
Seat 2: TME8GvochpQAo8cmJwWmvA ($118.30 in chips)
NYi6JFscYNrofSXy4sM+Yw: posts small blind $0.50
TME8GvochpQAo8cmJwWmvA: posts big blind $1
*** HOLE CARDS ***
NYi6JFscYNrofSXy4sM+Yw: folds
TME8GvochpQAo8cmJwWmvA collected $1 from pot
*** SUMMARY ***
Total pot $1 | Rake $0
Seat 1: NYi6JFscYNrofSXy4sM+Yw (button) (small blind) folded before Flop
Seat 2: TME8GvochpQAo8cmJwWmvA (big blind) collected ($1)



PokerStars Game #59940196798:  Hold'em No Limit ($0.50/$1.00) - 2009/07/01 0:59:54 ET
Table 'fTlPiCj0utgzC/5io+I7ew' 6-max Seat #5 is the button
Seat 1: YMJG+F++3Aj6P8dAWda5fw ($100 in chips)
Seat 2: Qy/UBNbD2HaA0Ogxg8Sf3w ($126.85 in chips)
Seat 3: wL5HjWHHOSGc53xWMNKB9Q ($30.60 in chips)
Seat 4: uJVSceLggtsrJya+WtmUEA ($120.75 in chips)
Seat 5: bFrTkDcWGTxyvNul7GVdYg ($306.05 in chips)
Seat 6: /P4w1pHg2zHYg/4ubJ0dPw ($60.50 in chips)
/P4w1pHg2zHYg/4ubJ0dPw: posts small blind $0.50
YMJG+F++3Aj6P8dAWda5fw: posts big blind $1
*** HOLE CARDS ***
Qy/UBNbD2HaA0Ogxg8Sf3w: folds
wL5HjWHHOSGc53xWMNKB9Q: calls $1
uJVSceLggtsrJya+WtmUEA: folds
bFrTkDcWGTxyvNul7GVdYg: raises $3.50 to $4.50
/P4w1pHg2zHYg/4ubJ0dPw: folds
YMJG+F++3Aj6P8dAWda5fw: folds
wL5HjWHHOSGc53xWMNKB9Q: folds
bFrTkDcWGTxyvNul7GVdYg collected $3.50 from pot
*** SUMMARY ***
Total pot $3.50 | Rake $0
Seat 1: YMJG+F++3Aj6P8dAWda5fw (big blind) folded before Flop
Seat 2: Qy/UBNbD2HaA0Ogxg8Sf3w folded before Flop (didn't bet)
Seat 3: wL5HjWHHOSGc53xWMNKB9Q folded before Flop
Seat 4: uJVSceLggtsrJya+WtmUEA folded before Flop (didn't bet)
Seat 5: bFrTkDcWGTxyvNul7GVdYg (button) collected ($3.50)
Seat 6: /P4w1pHg2zHYg/4ubJ0dPw (small blind) folded before Flop



PokerStars Game #59940197186:  Hold'em No Limit ($0.50/$1.00) - 2009/07/01 0:59:54 ET
Table 'Zka9tv1yilg0MvXWPQrShg' 9-max Seat #4 is the button
Seat 1: TZcz9MEWDA+WydgGruqqbw ($117.40 in chips)
Seat 2: kz9ziSiGUc+857heiKSayw ($19.50 in chips)
Seat 3: gUUvmqdVlmvpal6B8nYrmg ($106.45 in chips)
Seat 4: stxmTgSicxShtrDxhOOX2g ($68.15 in chips)
Seat 5: /zy+DB4S5fUQUSfZWFzYGw ($126.15 in chips)
Seat 6: rY8wPoax1lS+HUY+I0FZDw ($160.70 in chips)
Seat 7: p1SafS90nb3Uft5LB0NkHw ($20.50 in chips)
Seat 9: 6daxhj43mWj04MOPTOmaYA ($94 in chips)
/zy+DB4S5fUQUSfZWFzYGw: posts small blind $0.50
rY8wPoax1lS+HUY+I0FZDw: posts big blind $1
D+W9Me7w6Hcx/WRUSKV0dw: sits out
*** HOLE CARDS ***
p1SafS90nb3Uft5LB0NkHw: folds
6daxhj43mWj04MOPTOmaYA: folds
TZcz9MEWDA+WydgGruqqbw: folds
kz9ziSiGUc+857heiKSayw: folds
gUUvmqdVlmvpal6B8nYrmg: folds
stxmTgSicxShtrDxhOOX2g: calls $1
/zy+DB4S5fUQUSfZWFzYGw: raises $4 to $5
rY8wPoax1lS+HUY+I0FZDw: folds
stxmTgSicxShtrDxhOOX2g: calls $4
*** FLOP *** [4h 8d 4d]
/zy+DB4S5fUQUSfZWFzYGw: bets $7
stxmTgSicxShtrDxhOOX2g: folds
/zy+DB4S5fUQUSfZWFzYGw collected $10.45 from pot
*** SUMMARY ***
Total pot $11 | Rake $0.55
Board [4h 8d 4d]
Seat 1: TZcz9MEWDA+WydgGruqqbw folded before Flop (didn't bet)
Seat 2: kz9ziSiGUc+857heiKSayw folded before Flop (didn't bet)
Seat 3: gUUvmqdVlmvpal6B8nYrmg folded before Flop (didn't bet)
Seat 4: stxmTgSicxShtrDxhOOX2g (button) folded on the Flop
Seat 5: /zy+DB4S5fUQUSfZWFzYGw (small blind) collected ($10.45)
Seat 6: rY8wPoax1lS+HUY+I0FZDw (big blind) folded before Flop
Seat 7: p1SafS90nb3Uft5LB0NkHw folded before Flop (didn't bet)
Seat 9: 6daxhj43mWj04MOPTOmaYA folded before Flop (didn't bet)



PokerStars Game #59940197526:  Hold'em No Limit ($0.50/$1.00) - 2009/07/01 0:59:55 ET
Table 'JTT1XWaDZHSaMZQK7cR5uw' 2-max Seat #1 is the button
Seat 1: OLplZF6FEnLflv81Hz+Fxg ($112.55 in chips)
Seat 2: BcqgegiOUxmBD3F3umsljg ($98.85 in chips)
OLplZF6FEnLflv81Hz+Fxg: posts small blind $0.50
BcqgegiOUxmBD3F3umsljg: posts big blind $1
*** HOLE CARDS ***
OLplZF6FEnLflv81Hz+Fxg: raises $2 to $3
BcqgegiOUxmBD3F3umsljg: calls $2
*** FLOP *** [Kh Kd 7h]
BcqgegiOUxmBD3F3umsljg: checks
OLplZF6FEnLflv81Hz+Fxg: checks
*** TURN *** [Kh Kd 7h] [5c]
BcqgegiOUxmBD3F3umsljg: bets $2
OLplZF6FEnLflv81Hz+Fxg: raises $5 to $7
BcqgegiOUxmBD3F3umsljg: folds
OLplZF6FEnLflv81Hz+Fxg collected $9.55 from pot
OLplZF6FEnLflv81Hz+Fxg: doesn't show hand
*** SUMMARY ***
Total pot $10 | Rake $0.45
Board [Kh Kd 7h 5c]
Seat 1: OLplZF6FEnLflv81Hz+Fxg (button) (small blind) collected ($9.55)
Seat 2: BcqgegiOUxmBD3F3umsljg (big blind) folded on the Turn



PokerStars Game #59940198086:  Hold'em No Limit ($0.50/$1.00) - 2009/07/01 0:59:56 ET
Table 'pHrhryH8jPNdQfY62f8v+g' 6-max Seat #3 is the button
Seat 1: OvwYHV65yUbgdBjSmo1+5g ($50.50 in chips)
Seat 2: RqgF7gRoKgRNW8Zoi1ty4A ($119.15 in chips)
Seat 3: 8oS5O7iD/qnFXFXJrGIgNQ ($154.80 in chips)
Seat 4: DHjG71KHeyQxu3OZ+fFd4w ($18.70 in chips)
Seat 5: r1/R7y0Ortgoz4lccgW8VA ($48.05 in chips)
Seat 6: xAU6q2/cwmby2sxmA8VcmA ($109.30 in chips)
DHjG71KHeyQxu3OZ+fFd4w: posts small blind $0.50
r1/R7y0Ortgoz4lccgW8VA: posts big blind $1
*** HOLE CARDS ***
xAU6q2/cwmby2sxmA8VcmA: folds
OvwYHV65yUbgdBjSmo1+5g: folds
RqgF7gRoKgRNW8Zoi1ty4A: raises $2 to $3
8oS5O7iD/qnFXFXJrGIgNQ: calls $3
DHjG71KHeyQxu3OZ+fFd4w: raises $15.70 to $18.70 and is all-in
r1/R7y0Ortgoz4lccgW8VA: folds
RqgF7gRoKgRNW8Zoi1ty4A: raises $100.45 to $119.15 and is all-in
8oS5O7iD/qnFXFXJrGIgNQ: folds
*** FLOP *** [8c Ac 3d]
*** TURN *** [8c Ac 3d] [6h]
*** RIVER *** [8c Ac 3d 6h] [8s]
*** SHOW DOWN ***
DHjG71KHeyQxu3OZ+fFd4w: shows [As 4c] (two pair, Aces and Eights)
RqgF7gRoKgRNW8Zoi1ty4A: mucks hand
DHjG71KHeyQxu3OZ+fFd4w collected $39.35 from pot
*** SUMMARY ***
Total pot $41.40 | Rake $2.05
Board [8c Ac 3d 6h 8s]
Seat 1: OvwYHV65yUbgdBjSmo1+5g folded before Flop (didn't bet)
Seat 2: RqgF7gRoKgRNW8Zoi1ty4A mucked
Seat 3: 8oS5O7iD/qnFXFXJrGIgNQ (button) folded before Flop
Seat 4: DHjG71KHeyQxu3OZ+fFd4w (small blind) showed [As 4c] and won ($39.35) with two pair, Aces and Eights
Seat 5: r1/R7y0Ortgoz4lccgW8VA (big blind) folded before Flop
Seat 6: xAU6q2/cwmby2sxmA8VcmA folded before Flop (didn't bet)



PokerStars Game #59940199792:  Hold'em No Limit ($0.50/$1.00) - 2009/07/01 0:59:59 ET
Table 'LmXQK9xy3awB+qsPzI21Mw' 2-max Seat #2 is the button
Seat 1: NYi6JFscYNrofSXy4sM+Yw ($269.05 in chips)
Seat 2: TME8GvochpQAo8cmJwWmvA ($118.80 in chips)
TME8GvochpQAo8cmJwWmvA: posts small blind $0.50
NYi6JFscYNrofSXy4sM+Yw: posts big blind $1
*** HOLE CARDS ***
TME8GvochpQAo8cmJwWmvA: calls $0.50
NYi6JFscYNrofSXy4sM+Yw: checks
*** FLOP *** [Ts Qc 4s]
NYi6JFscYNrofSXy4sM+Yw: checks
TME8GvochpQAo8cmJwWmvA: bets $2
NYi6JFscYNrofSXy4sM+Yw: folds
TME8GvochpQAo8cmJwWmvA collected $1.90 from pot
TME8GvochpQAo8cmJwWmvA: doesn't show hand
*** SUMMARY ***
Total pot $2 | Rake $0.10
Board [Ts Qc 4s]
Seat 1: NYi6JFscYNrofSXy4sM+Yw (big blind) folded on the Flop
Seat 2: TME8GvochpQAo8cmJwWmvA (button) (small blind) collected ($1.90)



PokerStars Game #59940202326:  Hold'em No Limit ($0.50/$1.00) - 2009/07/01 1:00:02 ET
Table '6YvsYDPNIDx2v5z3bJnwZQ' 9-max Seat #5 is the button
Seat 1: Ogn4JDV3mp4ZDKO49IFzKA ($22.70 in chips)
Seat 2: +hHqYgKILitkxIzFNGvvsA ($43.25 in chips)
Seat 3: negfosHnGOZXSHpWDRKyBQ ($16.50 in chips)
Seat 4: kEr5NYB+JIG5+szcYMr6hA ($36.75 in chips)
Seat 5: mBRWbnUl8diyBO1qTJaNzw ($162.20 in chips)
Seat 6: 7RSwrjMohkYrZAhOd1uaZg ($9 in chips)
Seat 7: mae7OMTaJ/MFimNbZegCkg ($52.30 in chips)
Seat 8: PSFxpXgPedVZyHSu2Zhb7Q ($109.80 in chips)
Seat 9: ZgMRSHJ9EOtPeVHmdeV9kQ ($44 in chips)
7RSwrjMohkYrZAhOd1uaZg: posts small blind $0.50
mae7OMTaJ/MFimNbZegCkg: posts big blind $1
*** HOLE CARDS ***
PSFxpXgPedVZyHSu2Zhb7Q: calls $1
ZgMRSHJ9EOtPeVHmdeV9kQ: calls $1
Ogn4JDV3mp4ZDKO49IFzKA: folds
+hHqYgKILitkxIzFNGvvsA: calls $1
negfosHnGOZXSHpWDRKyBQ: folds
kEr5NYB+JIG5+szcYMr6hA: calls $1
mBRWbnUl8diyBO1qTJaNzw: folds
7RSwrjMohkYrZAhOd1uaZg: calls $0.50
mae7OMTaJ/MFimNbZegCkg: checks
*** FLOP *** [8h 6h 2c]
7RSwrjMohkYrZAhOd1uaZg: checks
mae7OMTaJ/MFimNbZegCkg: checks
PSFxpXgPedVZyHSu2Zhb7Q: checks
ZgMRSHJ9EOtPeVHmdeV9kQ: bets $2
+hHqYgKILitkxIzFNGvvsA: calls $2
kEr5NYB+JIG5+szcYMr6hA: calls $2
7RSwrjMohkYrZAhOd1uaZg: calls $2
mae7OMTaJ/MFimNbZegCkg: folds
PSFxpXgPedVZyHSu2Zhb7Q: folds
*** TURN *** [8h 6h 2c] [8d]
7RSwrjMohkYrZAhOd1uaZg: checks
ZgMRSHJ9EOtPeVHmdeV9kQ: bets $2
+hHqYgKILitkxIzFNGvvsA: calls $2
kEr5NYB+JIG5+szcYMr6hA: raises $8 to $10
7RSwrjMohkYrZAhOd1uaZg: folds
ZgMRSHJ9EOtPeVHmdeV9kQ: folds
+hHqYgKILitkxIzFNGvvsA: folds
ZgMRSHJ9EOtPeVHmdeV9kQ leaves the table
kEr5NYB+JIG5+szcYMr6hA collected $19.05 from pot
*** SUMMARY ***
Total pot $20 | Rake $0.95
Board [8h 6h 2c 8d]
Seat 1: Ogn4JDV3mp4ZDKO49IFzKA folded before Flop (didn't bet)
Seat 2: +hHqYgKILitkxIzFNGvvsA folded on the Turn
Seat 3: negfosHnGOZXSHpWDRKyBQ folded before Flop (didn't bet)
Seat 4: kEr5NYB+JIG5+szcYMr6hA collected ($19.05)
Seat 5: mBRWbnUl8diyBO1qTJaNzw (button) folded before Flop (didn't bet)
Seat 6: 7RSwrjMohkYrZAhOd1uaZg (small blind) folded on the Turn
Seat 7: mae7OMTaJ/MFimNbZegCkg (big blind) folded on the Flop
Seat 8: PSFxpXgPedVZyHSu2Zhb7Q folded on the Flop
Seat 9: ZgMRSHJ9EOtPeVHmdeV9kQ folded on the Turn



PokerStars Game #59940202930:  Hold'em No Limit ($0.50/$1.00) - 2009/07/01 1:00:03 ET
Table 'vs/5jr6ciwjVQ5+Soc+u2A' 6-max Seat #2 is the button
Seat 1: /P4w1pHg2zHYg/4ubJ0dPw ($60 in chips)
Seat 2: XOIf9W+VAxhZqN+SYoyMKA ($117.65 in chips)
Seat 3: G5ZSSN6RSON3gkNvk/SmYg ($138.35 in chips)
Seat 4: wk6Ohn4GDozoOMHc4eb2rw ($91.15 in chips)
G5ZSSN6RSON3gkNvk/SmYg: posts small blind $0.50
wk6Ohn4GDozoOMHc4eb2rw: posts big blind $1
+Nt3OPk3XR9SKjZgm2CexQ: sits out
*** HOLE CARDS ***
/P4w1pHg2zHYg/4ubJ0dPw: folds
XOIf9W+VAxhZqN+SYoyMKA: folds
G5ZSSN6RSON3gkNvk/SmYg: raises $2 to $3
wk6Ohn4GDozoOMHc4eb2rw: folds
G5ZSSN6RSON3gkNvk/SmYg collected $2 from pot
G5ZSSN6RSON3gkNvk/SmYg: doesn't show hand
*** SUMMARY ***
Total pot $2 | Rake $0
Seat 1: /P4w1pHg2zHYg/4ubJ0dPw folded before Flop (didn't bet)
Seat 2: XOIf9W+VAxhZqN+SYoyMKA (button) folded before Flop (didn't bet)
Seat 3: G5ZSSN6RSON3gkNvk/SmYg (small blind) collected ($2)
Seat 4: wk6Ohn4GDozoOMHc4eb2rw (big blind) folded before Flop



PokerStars Game #59940202728:  Hold'em No Limit ($0.50/$1.00) - 2009/07/01 1:00:03 ET
Table 'MUPc8FEpe/nR0BKSeReX6Q' 6-max Seat #4 is the button
Seat 2: xAU6q2/cwmby2sxmA8VcmA ($122.70 in chips)
Seat 3: wx3sQGkVi2x9wJXuWNHPBw ($230.35 in chips)
Seat 4: ZA1bp6g8IwtTxkUE4eCjDQ ($196.80 in chips)
Seat 5: UBZQqpnJZdTYYY1FTb0rLA ($102.55 in chips)
Seat 6: oxnw0GLLpFanjhGkxfRSqA ($28.70 in chips)
UBZQqpnJZdTYYY1FTb0rLA: posts small blind $0.50
oxnw0GLLpFanjhGkxfRSqA: posts big blind $1
*** HOLE CARDS ***
xAU6q2/cwmby2sxmA8VcmA: folds
qhkK6+yCciTRd+rCFEbnEQ joins the table at seat #1
wx3sQGkVi2x9wJXuWNHPBw: raises $3 to $4
ZA1bp6g8IwtTxkUE4eCjDQ: folds
UBZQqpnJZdTYYY1FTb0rLA: folds
oxnw0GLLpFanjhGkxfRSqA: folds
wx3sQGkVi2x9wJXuWNHPBw collected $2.50 from pot
*** SUMMARY ***
Total pot $2.50 | Rake $0
Seat 2: xAU6q2/cwmby2sxmA8VcmA folded before Flop (didn't bet)
Seat 3: wx3sQGkVi2x9wJXuWNHPBw collected ($2.50)
Seat 4: ZA1bp6g8IwtTxkUE4eCjDQ (button) folded before Flop (didn't bet)
Seat 5: UBZQqpnJZdTYYY1FTb0rLA (small blind) folded before Flop
Seat 6: oxnw0GLLpFanjhGkxfRSqA (big blind) folded before Flop



PokerStars Game #59940204908:  Hold'em No Limit ($0.50/$1.00) - 2009/07/01 1:00:06 ET
Table 'tLrtq7gDzxEvckNAI1OS5Q' 6-max Seat #5 is the button
Seat 3: TPZ+m9x+lwoKpv7TMfAUWA ($300.95 in chips)
Seat 4: +uSzP8Jwnw7sKfQ4s66b7w ($46.30 in chips)
Seat 5: OGMLOcTNYZXZU81au7ztUw ($166.65 in chips)
Seat 6: XUk5GQsfNFpHvaToDZ0rZA ($168.90 in chips)
XUk5GQsfNFpHvaToDZ0rZA: posts small blind $0.50
QHvTZcrKe6+maWUfVjP29Q: is sitting out
TPZ+m9x+lwoKpv7TMfAUWA: posts big blind $1
*** HOLE CARDS ***
QHvTZcrKe6+maWUfVjP29Q leaves the table
+uSzP8Jwnw7sKfQ4s66b7w: folds
OGMLOcTNYZXZU81au7ztUw: folds
XUk5GQsfNFpHvaToDZ0rZA: folds
TPZ+m9x+lwoKpv7TMfAUWA collected $1 from pot
*** SUMMARY ***
Total pot $1 | Rake $0
Seat 3: TPZ+m9x+lwoKpv7TMfAUWA (big blind) collected ($1)
Seat 4: +uSzP8Jwnw7sKfQ4s66b7w folded before Flop (didn't bet)
Seat 5: OGMLOcTNYZXZU81au7ztUw (button) folded before Flop (didn't bet)
Seat 6: XUk5GQsfNFpHvaToDZ0rZA (small blind) folded before Flop



PokerStars Game #59940205238:  Hold'em No Limit ($0.50/$1.00) - 2009/07/01 1:00:07 ET
Table 'W/wyObTiXZm+Ckkl3YxcSw' 6-max Seat #1 is the button
Seat 1: eUBBn2R56C1IQ6Cs/vitwg ($142.20 in chips)
Seat 2: oDiBRCaF0QVtd3kO6xZIXw ($108.35 in chips)
Seat 3: dxyNCn/qxfkGDUIf28Cbng ($87.40 in chips)
Seat 5: BdbmJTZZ47quA9vUWwXtlw ($60.85 in chips)
oDiBRCaF0QVtd3kO6xZIXw: posts small blind $0.50
dxyNCn/qxfkGDUIf28Cbng: posts big blind $1
OGMLOcTNYZXZU81au7ztUw: sits out
*** HOLE CARDS ***
aYii2DmxlOlbC1wbGRBWvQ has returned
BdbmJTZZ47quA9vUWwXtlw: folds
eUBBn2R56C1IQ6Cs/vitwg: raises $2 to $3
oDiBRCaF0QVtd3kO6xZIXw: folds
dxyNCn/qxfkGDUIf28Cbng: calls $2
*** FLOP *** [6c 8s 7s]
dxyNCn/qxfkGDUIf28Cbng: checks
eUBBn2R56C1IQ6Cs/vitwg: checks
*** TURN *** [6c 8s 7s] [Kh]
dxyNCn/qxfkGDUIf28Cbng: checks
eUBBn2R56C1IQ6Cs/vitwg: bets $5
dxyNCn/qxfkGDUIf28Cbng: folds
eUBBn2R56C1IQ6Cs/vitwg collected $6.20 from pot
*** SUMMARY ***
Total pot $6.50 | Rake $0.30
Board [6c 8s 7s Kh]
Seat 1: eUBBn2R56C1IQ6Cs/vitwg (button) collected ($6.20)
Seat 2: oDiBRCaF0QVtd3kO6xZIXw (small blind) folded before Flop
Seat 3: dxyNCn/qxfkGDUIf28Cbng (big blind) folded on the Turn
Seat 5: BdbmJTZZ47quA9vUWwXtlw folded before Flop (didn't bet)



PokerStars Game #59940206720:  Hold'em No Limit ($0.50/$1.00) - 2009/07/01 1:00:09 ET
Table 'LmXQK9xy3awB+qsPzI21Mw' 2-max Seat #1 is the button
Seat 1: NYi6JFscYNrofSXy4sM+Yw ($268.05 in chips)
Seat 2: TME8GvochpQAo8cmJwWmvA ($119.70 in chips)
NYi6JFscYNrofSXy4sM+Yw: posts small blind $0.50
TME8GvochpQAo8cmJwWmvA: posts big blind $1
*** HOLE CARDS ***
NYi6JFscYNrofSXy4sM+Yw: raises $2 to $3
TME8GvochpQAo8cmJwWmvA: folds
NYi6JFscYNrofSXy4sM+Yw collected $2 from pot
*** SUMMARY ***
Total pot $2 | Rake $0
Seat 1: NYi6JFscYNrofSXy4sM+Yw (button) (small blind) collected ($2)
Seat 2: TME8GvochpQAo8cmJwWmvA (big blind) folded before Flop



PokerStars Game #59940206334:  Hold'em No Limit ($0.50/$1.00) - 2009/07/01 1:00:09 ET
Table 'eU3bWpDDg3Z+9R4m4iVmog' 6-max Seat #6 is the button
Seat 1: TSuRyAHnUPCFjP7Z0rEE0w ($190.15 in chips)
Seat 2: 8CAoOzhmB8n3nRFf3V4BTg ($59.30 in chips)
Seat 3: rVMOzU7w5FddYPGhD7qN2Q ($48.15 in chips)
Seat 4: GDVIsbEJ/DOJsMKE4Asz0A ($99.50 in chips)
Seat 6: hpxXcmRkXXI9HE5+5/j/0Q ($130.85 in chips)
TSuRyAHnUPCFjP7Z0rEE0w: posts small blind $0.50
8CAoOzhmB8n3nRFf3V4BTg: posts big blind $1
*** HOLE CARDS ***
rVMOzU7w5FddYPGhD7qN2Q: folds
GDVIsbEJ/DOJsMKE4Asz0A: folds
hpxXcmRkXXI9HE5+5/j/0Q: folds
TSuRyAHnUPCFjP7Z0rEE0w: folds
8CAoOzhmB8n3nRFf3V4BTg collected $1 from pot
*** SUMMARY ***
Total pot $1 | Rake $0
Seat 1: TSuRyAHnUPCFjP7Z0rEE0w (small blind) folded before Flop
Seat 2: 8CAoOzhmB8n3nRFf3V4BTg (big blind) collected ($1)
Seat 3: rVMOzU7w5FddYPGhD7qN2Q folded before Flop (didn't bet)
Seat 4: GDVIsbEJ/DOJsMKE4Asz0A folded before Flop (didn't bet)
Seat 6: hpxXcmRkXXI9HE5+5/j/0Q (button) folded before Flop (didn't bet)



PokerStars Game #59940208440:  Hold'em No Limit ($0.50/$1.00) - 2009/07/01 1:00:12 ET
Table 'VOs36P6NW+QyXeQ1B62kmA' 6-max Seat #2 is the button
Seat 2: 2UMlbaZ8n8AbRli0Yr0mDw ($28.85 in chips)
Seat 3: TSuRyAHnUPCFjP7Z0rEE0w ($105.40 in chips)
Seat 4: w02zQzNydODiyV9THKgo9w ($43.35 in chips)
Seat 5: ozrlafxxh1HmYdA0/h+MuA ($33.85 in chips)
Seat 6: slVKuQyEz8Qj4E3uLPYNXg ($98.50 in chips)
TSuRyAHnUPCFjP7Z0rEE0w: posts small blind $0.50
w02zQzNydODiyV9THKgo9w: posts big blind $1
Z2fXsGcjl+Eax+RzOgwOmg: sits out
*** HOLE CARDS ***
ozrlafxxh1HmYdA0/h+MuA: folds
slVKuQyEz8Qj4E3uLPYNXg: folds
2UMlbaZ8n8AbRli0Yr0mDw: folds
TSuRyAHnUPCFjP7Z0rEE0w: folds
w02zQzNydODiyV9THKgo9w collected $1 from pot
*** SUMMARY ***
Total pot $1 | Rake $0
Seat 2: 2UMlbaZ8n8AbRli0Yr0mDw (button) folded before Flop (didn't bet)
Seat 3: TSuRyAHnUPCFjP7Z0rEE0w (small blind) folded before Flop
Seat 4: w02zQzNydODiyV9THKgo9w (big blind) collected ($1)
Seat 5: ozrlafxxh1HmYdA0/h+MuA folded before Flop (didn't bet)
Seat 6: slVKuQyEz8Qj4E3uLPYNXg folded before Flop (didn't bet)



PokerStars Game #59940209560:  Hold'em No Limit ($0.50/$1.00) - 2009/07/01 1:00:14 ET
Table '7O9fB8yx1u7sJveJn8w6jA' 6-max Seat #2 is the button
Seat 2: wx3sQGkVi2x9wJXuWNHPBw ($195.45 in chips)
Seat 3: hpxXcmRkXXI9HE5+5/j/0Q ($100 in chips)
Seat 4: XIZSmlGttGgSRaIU42K4Fg ($142.90 in chips)
Seat 5: BCEV3COoKY607AzLWayfRA ($100 in chips)
Seat 6: UBZQqpnJZdTYYY1FTb0rLA ($137.95 in chips)
hpxXcmRkXXI9HE5+5/j/0Q: posts small blind $0.50
XIZSmlGttGgSRaIU42K4Fg: posts big blind $1
*** HOLE CARDS ***
BCEV3COoKY607AzLWayfRA: folds
UBZQqpnJZdTYYY1FTb0rLA: folds
wx3sQGkVi2x9wJXuWNHPBw: folds
hpxXcmRkXXI9HE5+5/j/0Q: folds
XIZSmlGttGgSRaIU42K4Fg collected $1 from pot
*** SUMMARY ***
Total pot $1 | Rake $0
Seat 2: wx3sQGkVi2x9wJXuWNHPBw (button) folded before Flop (didn't bet)
Seat 3: hpxXcmRkXXI9HE5+5/j/0Q (small blind) folded before Flop
Seat 4: XIZSmlGttGgSRaIU42K4Fg (big blind) collected ($1)
Seat 5: BCEV3COoKY607AzLWayfRA folded before Flop (didn't bet)
Seat 6: UBZQqpnJZdTYYY1FTb0rLA folded before Flop (didn't bet)



PokerStars Game #59940209714:  Hold'em No Limit ($0.50/$1.00) - 2009/07/01 1:00:14 ET
Table 'JTT1XWaDZHSaMZQK7cR5uw' 2-max Seat #2 is the button
Seat 1: OLplZF6FEnLflv81Hz+Fxg ($117.10 in chips)
Seat 2: BcqgegiOUxmBD3F3umsljg ($93.85 in chips)
BcqgegiOUxmBD3F3umsljg: posts small blind $0.50
OLplZF6FEnLflv81Hz+Fxg: posts big blind $1
*** HOLE CARDS ***
BcqgegiOUxmBD3F3umsljg: calls $0.50
OLplZF6FEnLflv81Hz+Fxg: checks
*** FLOP *** [3c Ad Js]
OLplZF6FEnLflv81Hz+Fxg: checks
BcqgegiOUxmBD3F3umsljg: checks
*** TURN *** [3c Ad Js] [Jh]
OLplZF6FEnLflv81Hz+Fxg: bets $2
BcqgegiOUxmBD3F3umsljg: folds
OLplZF6FEnLflv81Hz+Fxg collected $1.90 from pot
*** SUMMARY ***
Total pot $2 | Rake $0.10
Board [3c Ad Js Jh]
Seat 1: OLplZF6FEnLflv81Hz+Fxg (big blind) collected ($1.90)
Seat 2: BcqgegiOUxmBD3F3umsljg (button) (small blind) folded on the Turn



PokerStars Game #59940209592:  Hold'em No Limit ($0.50/$1.00) - 2009/07/01 1:00:14 ET
Table 'mmbQQVBTrPdE+wy+s+9VPA' 6-max Seat #6 is the button
Seat 1: zyP4SPoWZnKUfTvIRLCVog ($54 in chips)
Seat 2: cl/QpVR/PLO58lj+C5mGLw ($20 in chips)
Seat 3: wx3sQGkVi2x9wJXuWNHPBw ($113.65 in chips)
Seat 4: V3iZdcw61nXF3g5hD2RrsQ ($100 in chips)
Seat 5: YMJG+F++3Aj6P8dAWda5fw ($100 in chips)
Seat 6: U2CWBTv29qdCbj8RNF2sIw ($110.45 in chips)
zyP4SPoWZnKUfTvIRLCVog: posts small blind $0.50
cl/QpVR/PLO58lj+C5mGLw: posts big blind $1
*** HOLE CARDS ***
wx3sQGkVi2x9wJXuWNHPBw: folds
V3iZdcw61nXF3g5hD2RrsQ: folds
YMJG+F++3Aj6P8dAWda5fw: folds
U2CWBTv29qdCbj8RNF2sIw: raises $2 to $3
zyP4SPoWZnKUfTvIRLCVog: folds
cl/QpVR/PLO58lj+C5mGLw: calls $2
*** FLOP *** [5c 3h 6s]
cl/QpVR/PLO58lj+C5mGLw: checks
U2CWBTv29qdCbj8RNF2sIw: checks
*** TURN *** [5c 3h 6s] [Qh]
cl/QpVR/PLO58lj+C5mGLw: bets $3
U2CWBTv29qdCbj8RNF2sIw: folds
cl/QpVR/PLO58lj+C5mGLw collected $6.20 from pot
*** SUMMARY ***
Total pot $6.50 | Rake $0.30
Board [5c 3h 6s Qh]
Seat 1: zyP4SPoWZnKUfTvIRLCVog (small blind) folded before Flop
Seat 2: cl/QpVR/PLO58lj+C5mGLw (big blind) collected ($6.20)
Seat 3: wx3sQGkVi2x9wJXuWNHPBw folded before Flop (didn't bet)
Seat 4: V3iZdcw61nXF3g5hD2RrsQ folded before Flop (didn't bet)
Seat 5: YMJG+F++3Aj6P8dAWda5fw folded before Flop (didn't bet)
Seat 6: U2CWBTv29qdCbj8RNF2sIw (button) folded on the Turn



PokerStars Game #59940209944:  Hold'em No Limit ($0.50/$1.00) - 2009/07/01 1:00:15 ET
Table 'QSIig7BLMc9wY/rgBechzw' 6-max Seat #4 is the button
Seat 2: mLOIkH/qmRa+mVujQIhBRg ($42.95 in chips)
Seat 3: Z3y97GMLCsoTZ9j7f6qctg ($35.80 in chips)
Seat 4: +uSzP8Jwnw7sKfQ4s66b7w ($62 in chips)
Seat 5: PVmmeYpn4gqkqYUool6BOA ($18.90 in chips)
Seat 6: PxqfkAMdAWtkgbT+q2gciA ($32.80 in chips)
PVmmeYpn4gqkqYUool6BOA: posts small blind $0.50
PxqfkAMdAWtkgbT+q2gciA: posts big blind $1
Z2fXsGcjl+Eax+RzOgwOmg: sits out
*** HOLE CARDS ***
mLOIkH/qmRa+mVujQIhBRg: folds
Z3y97GMLCsoTZ9j7f6qctg: folds
+uSzP8Jwnw7sKfQ4s66b7w: folds
PVmmeYpn4gqkqYUool6BOA: calls $0.50
PxqfkAMdAWtkgbT+q2gciA: checks
*** FLOP *** [Js As 8s]
PVmmeYpn4gqkqYUool6BOA: checks
PxqfkAMdAWtkgbT+q2gciA: checks
*** TURN *** [Js As 8s] [4d]
PVmmeYpn4gqkqYUool6BOA: checks
PxqfkAMdAWtkgbT+q2gciA: bets $2
PVmmeYpn4gqkqYUool6BOA: folds
PxqfkAMdAWtkgbT+q2gciA collected $1.90 from pot
*** SUMMARY ***
Total pot $2 | Rake $0.10
Board [Js As 8s 4d]
Seat 2: mLOIkH/qmRa+mVujQIhBRg folded before Flop (didn't bet)
Seat 3: Z3y97GMLCsoTZ9j7f6qctg folded before Flop (didn't bet)
Seat 4: +uSzP8Jwnw7sKfQ4s66b7w (button) folded before Flop (didn't bet)
Seat 5: PVmmeYpn4gqkqYUool6BOA (small blind) folded on the Turn
Seat 6: PxqfkAMdAWtkgbT+q2gciA (big blind) collected ($1.90)



PokerStars Game #59940210918:  Hold'em No Limit ($0.50/$1.00) - 2009/07/01 1:00:16 ET
Table 'vs/5jr6ciwjVQ5+Soc+u2A' 6-max Seat #3 is the button
Seat 1: /P4w1pHg2zHYg/4ubJ0dPw ($60 in chips)
Seat 2: XOIf9W+VAxhZqN+SYoyMKA ($117.65 in chips)
Seat 3: G5ZSSN6RSON3gkNvk/SmYg ($139.35 in chips)
Seat 4: wk6Ohn4GDozoOMHc4eb2rw ($90.15 in chips)
Seat 5: +Nt3OPk3XR9SKjZgm2CexQ ($100 in chips)
wk6Ohn4GDozoOMHc4eb2rw: posts small blind $0.50
+Nt3OPk3XR9SKjZgm2CexQ: posts big blind $1
*** HOLE CARDS ***
/P4w1pHg2zHYg/4ubJ0dPw: folds
XOIf9W+VAxhZqN+SYoyMKA: folds
G5ZSSN6RSON3gkNvk/SmYg: folds
wk6Ohn4GDozoOMHc4eb2rw: calls $0.50
+Nt3OPk3XR9SKjZgm2CexQ: raises $2 to $3
wk6Ohn4GDozoOMHc4eb2rw: folds
+Nt3OPk3XR9SKjZgm2CexQ collected $2 from pot
+Nt3OPk3XR9SKjZgm2CexQ: doesn't show hand
*** SUMMARY ***
Total pot $2 | Rake $0
Seat 1: /P4w1pHg2zHYg/4ubJ0dPw folded before Flop (didn't bet)
Seat 2: XOIf9W+VAxhZqN+SYoyMKA folded before Flop (didn't bet)
Seat 3: G5ZSSN6RSON3gkNvk/SmYg (button) folded before Flop (didn't bet)
Seat 4: wk6Ohn4GDozoOMHc4eb2rw (small blind) folded before Flop
Seat 5: +Nt3OPk3XR9SKjZgm2CexQ (big blind) collected ($2)



PokerStars Game #59940210540:  Hold'em No Limit ($0.50/$1.00) - 2009/07/01 1:00:16 ET
Table '7Nl0ffnjeK44/vmeexh3MQ' 9-max Seat #7 is the button
Seat 1: s7D3Y+k4Cj4D1cXHv7oj+Q ($96.35 in chips)
Seat 2: OGgaARGdJQT4awWVNQ957w ($100 in chips)
Seat 3: vR4IO10geOgvTW+LAUBv/A ($100 in chips)
Seat 4: bLbSOSmSOnqE0iTcH/5dxA ($113.50 in chips)
Seat 6: FVs16t7GgfWgQWt4JxsObQ ($24.75 in chips)
Seat 7: 997ViqAtWn1FPjJqcffwcA ($100 in chips)
Seat 8: D+W9Me7w6Hcx/WRUSKV0dw ($20.25 in chips)
Seat 9: ouwUBGRKnKK9uhn1G4Lf+A ($197 in chips)
D+W9Me7w6Hcx/WRUSKV0dw: posts small blind $0.50
ouwUBGRKnKK9uhn1G4Lf+A: posts big blind $1
61sfw5QTu62YYIt68OsdrA: sits out
*** HOLE CARDS ***
s7D3Y+k4Cj4D1cXHv7oj+Q: folds
OGgaARGdJQT4awWVNQ957w: raises $3 to $4
vR4IO10geOgvTW+LAUBv/A: folds
bLbSOSmSOnqE0iTcH/5dxA: folds
FVs16t7GgfWgQWt4JxsObQ: folds
997ViqAtWn1FPjJqcffwcA: folds
D+W9Me7w6Hcx/WRUSKV0dw: folds
ouwUBGRKnKK9uhn1G4Lf+A: folds
OGgaARGdJQT4awWVNQ957w collected $2.50 from pot
OGgaARGdJQT4awWVNQ957w: doesn't show hand
*** SUMMARY ***
Total pot $2.50 | Rake $0
Seat 1: s7D3Y+k4Cj4D1cXHv7oj+Q folded before Flop (didn't bet)
Seat 2: OGgaARGdJQT4awWVNQ957w collected ($2.50)
Seat 3: vR4IO10geOgvTW+LAUBv/A folded before Flop (didn't bet)
Seat 4: bLbSOSmSOnqE0iTcH/5dxA folded before Flop (didn't bet)
Seat 6: FVs16t7GgfWgQWt4JxsObQ folded before Flop (didn't bet)
Seat 7: 997ViqAtWn1FPjJqcffwcA (button) folded before Flop (didn't bet)
Seat 8: D+W9Me7w6Hcx/WRUSKV0dw (small blind) folded before Flop
Seat 9: ouwUBGRKnKK9uhn1G4Lf+A (big blind) folded before Flop



PokerStars Game #59940211340:  Hold'em No Limit ($0.50/$1.00) - 2009/07/01 1:00:17 ET
Table 'SQLOQoANiHscJ8AL7zffbw' 9-max Seat #5 is the button
Seat 1: jPTRd6SpCp4xqAy2XQiTOw ($68.95 in chips)
Seat 2: /zy+DB4S5fUQUSfZWFzYGw ($329.50 in chips)
Seat 3: 0eFnow7+D7veCYQ+CG9FFw ($93.35 in chips)
Seat 4: /mfensKw8/iZ1Vrx33S4xg ($20 in chips)
Seat 5: L9njYvloJ1NdXjP8edHEAg ($104.10 in chips)
Seat 6: p5UKaxVobvptF0ANhR/q1A ($172 in chips)
Seat 7: bJckevFOcg//s0qyMQI6sQ ($100 in chips)
Seat 8: 2BV+oJIQYr65IO6nEChvbA ($60 in chips)
Seat 9: qJr25HAtvv1w/7IBvjMM3g ($203.70 in chips)
p5UKaxVobvptF0ANhR/q1A: posts small blind $0.50
bJckevFOcg//s0qyMQI6sQ: posts big blind $1
*** HOLE CARDS ***
2BV+oJIQYr65IO6nEChvbA: raises $1 to $2
qJr25HAtvv1w/7IBvjMM3g: folds
jPTRd6SpCp4xqAy2XQiTOw: folds
/zy+DB4S5fUQUSfZWFzYGw: folds
0eFnow7+D7veCYQ+CG9FFw: folds
/mfensKw8/iZ1Vrx33S4xg: folds
L9njYvloJ1NdXjP8edHEAg: folds
p5UKaxVobvptF0ANhR/q1A: folds
bJckevFOcg//s0qyMQI6sQ: calls $1
*** FLOP *** [Kc Ts 6d]
bJckevFOcg//s0qyMQI6sQ: checks
p5UKaxVobvptF0ANhR/q1A leaves the table
2BV+oJIQYr65IO6nEChvbA: bets $2.50
bJckevFOcg//s0qyMQI6sQ: raises $5.50 to $8
2BV+oJIQYr65IO6nEChvbA: folds
bJckevFOcg//s0qyMQI6sQ collected $9.05 from pot
*** SUMMARY ***
Total pot $9.50 | Rake $0.45
Board [Kc Ts 6d]
Seat 1: jPTRd6SpCp4xqAy2XQiTOw folded before Flop (didn't bet)
Seat 2: /zy+DB4S5fUQUSfZWFzYGw folded before Flop (didn't bet)
Seat 3: 0eFnow7+D7veCYQ+CG9FFw folded before Flop (didn't bet)
Seat 4: /mfensKw8/iZ1Vrx33S4xg folded before Flop (didn't bet)
Seat 5: L9njYvloJ1NdXjP8edHEAg (button) folded before Flop (didn't bet)
Seat 6: p5UKaxVobvptF0ANhR/q1A (small blind) folded before Flop
Seat 7: bJckevFOcg//s0qyMQI6sQ (big blind) collected ($9.05)
Seat 8: 2BV+oJIQYr65IO6nEChvbA folded on the Flop
Seat 9: qJr25HAtvv1w/7IBvjMM3g folded before Flop (didn't bet)



PokerStars Game #59940211758:  Hold'em No Limit ($0.50/$1.00) - 2009/07/01 1:00:18 ET
Table '/FUb199IViHMJHi5YWmeuQ' 9-max Seat #4 is the button
Seat 1: TZcz9MEWDA+WydgGruqqbw ($120 in chips)
Seat 2: FL3MrLspcF23LYvC4ipBOA ($178.05 in chips)
Seat 3: qN483QJ1NvHbdIZB7J4ARw ($20.70 in chips)
Seat 4: qheQay5YvP2DMAb3OUSxtw ($147.80 in chips)
Seat 6: ccFf7Q4z1cTGQmeoYiWEfw ($51.45 in chips)
Seat 7: bLbSOSmSOnqE0iTcH/5dxA ($100 in chips)
Seat 8: 997ViqAtWn1FPjJqcffwcA ($103 in chips)
Seat 9: RfLbneGRY8yQUpMgDnJCxA ($63.95 in chips)
vincentt85 will be allowed to play after the button
ccFf7Q4z1cTGQmeoYiWEfw: posts small blind $0.50
bLbSOSmSOnqE0iTcH/5dxA: posts big blind $1
*** HOLE CARDS ***
997ViqAtWn1FPjJqcffwcA: folds
RfLbneGRY8yQUpMgDnJCxA: folds
TZcz9MEWDA+WydgGruqqbw: folds
FL3MrLspcF23LYvC4ipBOA: folds
qN483QJ1NvHbdIZB7J4ARw: calls $1
qheQay5YvP2DMAb3OUSxtw: folds
ccFf7Q4z1cTGQmeoYiWEfw: calls $0.50
bLbSOSmSOnqE0iTcH/5dxA: checks
*** FLOP *** [Qd 7c 3h]
ccFf7Q4z1cTGQmeoYiWEfw: checks
bLbSOSmSOnqE0iTcH/5dxA: checks
qN483QJ1NvHbdIZB7J4ARw: checks
*** TURN *** [Qd 7c 3h] [8s]
ccFf7Q4z1cTGQmeoYiWEfw: bets $3
bLbSOSmSOnqE0iTcH/5dxA: folds
qN483QJ1NvHbdIZB7J4ARw: folds
ccFf7Q4z1cTGQmeoYiWEfw collected $2.85 from pot
ccFf7Q4z1cTGQmeoYiWEfw: doesn't show hand
*** SUMMARY ***
Total pot $3 | Rake $0.15
Board [Qd 7c 3h 8s]
Seat 1: TZcz9MEWDA+WydgGruqqbw folded before Flop (didn't bet)
Seat 2: FL3MrLspcF23LYvC4ipBOA folded before Flop (didn't bet)
Seat 3: qN483QJ1NvHbdIZB7J4ARw folded on the Turn
Seat 4: qheQay5YvP2DMAb3OUSxtw (button) folded before Flop (didn't bet)
Seat 6: ccFf7Q4z1cTGQmeoYiWEfw (small blind) collected ($2.85)
Seat 7: bLbSOSmSOnqE0iTcH/5dxA (big blind) folded on the Turn
Seat 8: 997ViqAtWn1FPjJqcffwcA folded before Flop (didn't bet)
Seat 9: RfLbneGRY8yQUpMgDnJCxA folded before Flop (didn't bet)



PokerStars Game #59940212308:  Hold'em No Limit ($0.50/$1.00) - 2009/07/01 1:00:19 ET
Table 'cKH9c4x6u79IqCdaKKvXrw' 9-max Seat #1 is the button
Seat 1: Pp/KTcXkfZKKUHkjyaLTdg ($17 in chips)
Seat 2: 8S3JMH4TY3whgIlZmMv66w ($68.15 in chips)
Seat 3: 997ViqAtWn1FPjJqcffwcA ($157.10 in chips)
Seat 4: FL3MrLspcF23LYvC4ipBOA ($100 in chips)
Seat 5: Jjc7EHWzs4//xUAjJ0UWoA ($42.15 in chips)
Seat 6: Bsd/K5gAcLanYbGiPirRjw ($210.55 in chips)
Seat 7: 1GkkVBhlJ92guE6K5mS5Ig ($14.15 in chips)
Seat 8: myIxN7otsyr846M539YR8Q ($18.50 in chips)
Seat 9: 6XkTu4ahxzHnvjjc1R8YjQ ($41.60 in chips)
8S3JMH4TY3whgIlZmMv66w: posts small blind $0.50
997ViqAtWn1FPjJqcffwcA: posts big blind $1
*** HOLE CARDS ***
FL3MrLspcF23LYvC4ipBOA: folds
Jjc7EHWzs4//xUAjJ0UWoA: folds
Bsd/K5gAcLanYbGiPirRjw: folds
1GkkVBhlJ92guE6K5mS5Ig: folds
myIxN7otsyr846M539YR8Q: folds
6XkTu4ahxzHnvjjc1R8YjQ: folds
Pp/KTcXkfZKKUHkjyaLTdg: folds
8S3JMH4TY3whgIlZmMv66w: folds
997ViqAtWn1FPjJqcffwcA collected $1 from pot
997ViqAtWn1FPjJqcffwcA: doesn't show hand
*** SUMMARY ***
Total pot $1 | Rake $0
Seat 1: Pp/KTcXkfZKKUHkjyaLTdg (button) folded before Flop (didn't bet)
Seat 2: 8S3JMH4TY3whgIlZmMv66w (small blind) folded before Flop
Seat 3: 997ViqAtWn1FPjJqcffwcA (big blind) collected ($1)
Seat 4: FL3MrLspcF23LYvC4ipBOA folded before Flop (didn't bet)
Seat 5: Jjc7EHWzs4//xUAjJ0UWoA folded before Flop (didn't bet)
Seat 6: Bsd/K5gAcLanYbGiPirRjw folded before Flop (didn't bet)
Seat 7: 1GkkVBhlJ92guE6K5mS5Ig folded before Flop (didn't bet)
Seat 8: myIxN7otsyr846M539YR8Q folded before Flop (didn't bet)
Seat 9: 6XkTu4ahxzHnvjjc1R8YjQ folded before Flop (didn't bet)



PokerStars Game #59940212826:  Hold'em No Limit ($0.50/$1.00) - 2009/07/01 1:00:19 ET
Table 'LmXQK9xy3awB+qsPzI21Mw' 2-max Seat #2 is the button
Seat 1: NYi6JFscYNrofSXy4sM+Yw ($269.05 in chips)
Seat 2: TME8GvochpQAo8cmJwWmvA ($118.70 in chips)
TME8GvochpQAo8cmJwWmvA: posts small blind $0.50
NYi6JFscYNrofSXy4sM+Yw: posts big blind $1
*** HOLE CARDS ***
TME8GvochpQAo8cmJwWmvA: calls $0.50
NYi6JFscYNrofSXy4sM+Yw: raises $3 to $4
TME8GvochpQAo8cmJwWmvA: calls $3
*** FLOP *** [7h 6h 6s]
NYi6JFscYNrofSXy4sM+Yw: bets $5
TME8GvochpQAo8cmJwWmvA: calls $5
*** TURN *** [7h 6h 6s] [3d]
NYi6JFscYNrofSXy4sM+Yw: checks
TME8GvochpQAo8cmJwWmvA: bets $5
NYi6JFscYNrofSXy4sM+Yw: folds
TME8GvochpQAo8cmJwWmvA collected $17.50 from pot
TME8GvochpQAo8cmJwWmvA: doesn't show hand
*** SUMMARY ***
Total pot $18 | Rake $0.50
Board [7h 6h 6s 3d]
Seat 1: NYi6JFscYNrofSXy4sM+Yw (big blind) folded on the Turn
Seat 2: TME8GvochpQAo8cmJwWmvA (button) (small blind) collected ($17.50)



PokerStars Game #59940214628:  Hold'em No Limit ($0.50/$1.00) - 2009/07/01 1:00:22 ET
Table '/RZcOwpZpHQ+OwPwjsbnRw' 6-max Seat #5 is the button
Seat 1: Zboa6dColKGHBjLPUakZjw ($71.65 in chips)
Seat 2: +xW7QemQU0Fxs+4TnqBRow ($231.15 in chips)
Seat 3: XnT1yK2DD/5FL+0bwuEhqg ($53.30 in chips)
Seat 4: j7NIOHLZk7V2o9fOioO5ug ($103.20 in chips)
Seat 5: wx3sQGkVi2x9wJXuWNHPBw ($177.65 in chips)
Zboa6dColKGHBjLPUakZjw: posts small blind $0.50
+xW7QemQU0Fxs+4TnqBRow: posts big blind $1
*** HOLE CARDS ***
XnT1yK2DD/5FL+0bwuEhqg: folds
j7NIOHLZk7V2o9fOioO5ug: folds
wx3sQGkVi2x9wJXuWNHPBw: folds
2d/PU00mMdO9azAaXqcSbw joins the table at seat #6
Zboa6dColKGHBjLPUakZjw: raises $1 to $2
+xW7QemQU0Fxs+4TnqBRow: folds
Zboa6dColKGHBjLPUakZjw collected $2 from pot
*** SUMMARY ***
Total pot $2 | Rake $0
Seat 1: Zboa6dColKGHBjLPUakZjw (small blind) collected ($2)
Seat 2: +xW7QemQU0Fxs+4TnqBRow (big blind) folded before Flop
Seat 3: XnT1yK2DD/5FL+0bwuEhqg folded before Flop (didn't bet)
Seat 4: j7NIOHLZk7V2o9fOioO5ug folded before Flop (didn't bet)
Seat 5: wx3sQGkVi2x9wJXuWNHPBw (button) folded before Flop (didn't bet)



PokerStars Game #59940214432:  Hold'em No Limit ($0.50/$1.00) - 2009/07/01 1:00:22 ET
Table 'GxCPo/gd3OSthkYrAxJngg' 6-max Seat #2 is the button
Seat 1: sH8BpAFP+jGFxCgVpD1Lew ($270.90 in chips)
Seat 2: YExX2paeIHrmfIwV1ivM/w ($77.70 in chips)
Seat 3: o6plE+MSW4XFNTeONe16xg ($24.10 in chips)
Seat 4: YMJG+F++3Aj6P8dAWda5fw ($203.10 in chips)
Seat 5: G5ZSSN6RSON3gkNvk/SmYg ($105.25 in chips)
o6plE+MSW4XFNTeONe16xg: posts small blind $0.50
YMJG+F++3Aj6P8dAWda5fw: posts big blind $1
*** HOLE CARDS ***
G5ZSSN6RSON3gkNvk/SmYg: folds
sH8BpAFP+jGFxCgVpD1Lew: raises $2 to $3
YExX2paeIHrmfIwV1ivM/w: folds
o6plE+MSW4XFNTeONe16xg: folds
YMJG+F++3Aj6P8dAWda5fw: folds
sH8BpAFP+jGFxCgVpD1Lew collected $2.50 from pot
*** SUMMARY ***
Total pot $2.50 | Rake $0
Seat 1: sH8BpAFP+jGFxCgVpD1Lew collected ($2.50)
Seat 2: YExX2paeIHrmfIwV1ivM/w (button) folded before Flop (didn't bet)
Seat 3: o6plE+MSW4XFNTeONe16xg (small blind) folded before Flop
Seat 4: YMJG+F++3Aj6P8dAWda5fw (big blind) folded before Flop
Seat 5: G5ZSSN6RSON3gkNvk/SmYg folded before Flop (didn't bet)



PokerStars Game #59940215656:  Hold'em No Limit ($0.50/$1.00) - 2009/07/01 1:00:24 ET
Table 'O96CPOtvMBWP6kzuYDfdFA' 6-max Seat #5 is the button
Seat 1: 6alLXQIITA2EZ/lBeym8Dw ($121.05 in chips)
Seat 2: yynBOXUjw28V5kz84sxX4g ($12.90 in chips)
Seat 3: V89DGjxE171oPREEbAXiyg ($79.25 in chips)
Seat 4: /P4w1pHg2zHYg/4ubJ0dPw ($60 in chips)
Seat 5: G5ZSSN6RSON3gkNvk/SmYg ($100 in chips)
Seat 6: GYei5jXGWexiJYbAT2fELg ($26.85 in chips)
GYei5jXGWexiJYbAT2fELg: posts small blind $0.50
6alLXQIITA2EZ/lBeym8Dw: posts big blind $1
*** HOLE CARDS ***
yynBOXUjw28V5kz84sxX4g: folds
V89DGjxE171oPREEbAXiyg: raises $4 to $5
/P4w1pHg2zHYg/4ubJ0dPw: folds
G5ZSSN6RSON3gkNvk/SmYg: folds
GYei5jXGWexiJYbAT2fELg: folds
6alLXQIITA2EZ/lBeym8Dw: folds
V89DGjxE171oPREEbAXiyg collected $2.50 from pot
V89DGjxE171oPREEbAXiyg: doesn't show hand
*** SUMMARY ***
Total pot $2.50 | Rake $0
Seat 1: 6alLXQIITA2EZ/lBeym8Dw (big blind) folded before Flop
Seat 2: yynBOXUjw28V5kz84sxX4g folded before Flop (didn't bet)
Seat 3: V89DGjxE171oPREEbAXiyg collected ($2.50)
Seat 4: /P4w1pHg2zHYg/4ubJ0dPw folded before Flop (didn't bet)
Seat 5: G5ZSSN6RSON3gkNvk/SmYg (button) folded before Flop (didn't bet)
Seat 6: GYei5jXGWexiJYbAT2fELg (small blind) folded before Flop



PokerStars Game #59940216094:  Hold'em No Limit ($0.50/$1.00) - 2009/07/01 1:00:25 ET
Table 'fTlPiCj0utgzC/5io+I7ew' 6-max Seat #6 is the button
Seat 1: YMJG+F++3Aj6P8dAWda5fw ($99 in chips)
Seat 2: Qy/UBNbD2HaA0Ogxg8Sf3w ($126.85 in chips)
Seat 3: wL5HjWHHOSGc53xWMNKB9Q ($29.60 in chips)
Seat 4: uJVSceLggtsrJya+WtmUEA ($120.75 in chips)
Seat 5: bFrTkDcWGTxyvNul7GVdYg ($308.55 in chips)
Seat 6: /P4w1pHg2zHYg/4ubJ0dPw ($60 in chips)
YMJG+F++3Aj6P8dAWda5fw: posts small blind $0.50
Qy/UBNbD2HaA0Ogxg8Sf3w: posts big blind $1
*** HOLE CARDS ***
wL5HjWHHOSGc53xWMNKB9Q: calls $1
uJVSceLggtsrJya+WtmUEA: raises $3 to $4
bFrTkDcWGTxyvNul7GVdYg: calls $4
/P4w1pHg2zHYg/4ubJ0dPw: folds
YMJG+F++3Aj6P8dAWda5fw: folds
Qy/UBNbD2HaA0Ogxg8Sf3w: folds
wL5HjWHHOSGc53xWMNKB9Q: calls $3
*** FLOP *** [9c 5s 6s]
wL5HjWHHOSGc53xWMNKB9Q: checks
uJVSceLggtsrJya+WtmUEA: bets $8
bFrTkDcWGTxyvNul7GVdYg: raises $8 to $16
wL5HjWHHOSGc53xWMNKB9Q: folds
uJVSceLggtsrJya+WtmUEA: raises $100.75 to $116.75 and is all-in
bFrTkDcWGTxyvNul7GVdYg: folds
uJVSceLggtsrJya+WtmUEA collected $43.30 from pot
*** SUMMARY ***
Total pot $45.50 | Rake $2.20
Board [9c 5s 6s]
Seat 1: YMJG+F++3Aj6P8dAWda5fw (small blind) folded before Flop
Seat 2: Qy/UBNbD2HaA0Ogxg8Sf3w (big blind) folded before Flop
Seat 3: wL5HjWHHOSGc53xWMNKB9Q folded on the Flop
Seat 4: uJVSceLggtsrJya+WtmUEA collected ($43.30)
Seat 5: bFrTkDcWGTxyvNul7GVdYg folded on the Flop
Seat 6: /P4w1pHg2zHYg/4ubJ0dPw (button) folded before Flop (didn't bet)



PokerStars Game #59940216012:  Hold'em No Limit ($0.50/$1.00) - 2009/07/01 1:00:25 ET
Table '+cA8mcmhaedZ7YcrDdhmeQ' 6-max Seat #1 is the button
Seat 1: lsLuWlcPA3Rh7kJVLzMh0Q ($296.50 in chips)
Seat 2: RqgF7gRoKgRNW8Zoi1ty4A ($111.55 in chips)
Seat 3: 7H5WkGzGvsv56y1iaqHvRg ($24.85 in chips)
Seat 4: 4OO5v3AVduL0tePNx8wk5A ($102.50 in chips)
Seat 5: +7hFKAL0b0O/n8G72TclJA ($66.35 in chips)
Seat 6: YfsTQsY/fxb+YqbdclTHuw ($25.45 in chips)
RqgF7gRoKgRNW8Zoi1ty4A: posts small blind $0.50
7H5WkGzGvsv56y1iaqHvRg: posts big blind $1
*** HOLE CARDS ***
4OO5v3AVduL0tePNx8wk5A: folds
+7hFKAL0b0O/n8G72TclJA: folds
YfsTQsY/fxb+YqbdclTHuw: calls $1
lsLuWlcPA3Rh7kJVLzMh0Q: folds
RqgF7gRoKgRNW8Zoi1ty4A: calls $0.50
7H5WkGzGvsv56y1iaqHvRg: checks
*** FLOP *** [Kd 6h 4d]
RqgF7gRoKgRNW8Zoi1ty4A: checks
7H5WkGzGvsv56y1iaqHvRg: checks
YfsTQsY/fxb+YqbdclTHuw: checks
*** TURN *** [Kd 6h 4d] [Jc]
RqgF7gRoKgRNW8Zoi1ty4A: checks
7H5WkGzGvsv56y1iaqHvRg: checks
YfsTQsY/fxb+YqbdclTHuw: checks
*** RIVER *** [Kd 6h 4d Jc] [Th]
RqgF7gRoKgRNW8Zoi1ty4A: checks
7H5WkGzGvsv56y1iaqHvRg: checks
YfsTQsY/fxb+YqbdclTHuw: checks
*** SHOW DOWN ***
RqgF7gRoKgRNW8Zoi1ty4A: shows [2d 2c] (a pair of Deuces)
7H5WkGzGvsv56y1iaqHvRg: shows [4c Qh] (a pair of Fours)
YfsTQsY/fxb+YqbdclTHuw: mucks hand
7H5WkGzGvsv56y1iaqHvRg collected $2.85 from pot
*** SUMMARY ***
Total pot $3 | Rake $0.15
Board [Kd 6h 4d Jc Th]
Seat 1: lsLuWlcPA3Rh7kJVLzMh0Q (button) folded before Flop (didn't bet)
Seat 2: RqgF7gRoKgRNW8Zoi1ty4A (small blind) showed [2d 2c] and lost with a pair of Deuces
Seat 3: 7H5WkGzGvsv56y1iaqHvRg (big blind) showed [4c Qh] and won ($2.85) with a pair of Fours
Seat 4: 4OO5v3AVduL0tePNx8wk5A folded before Flop (didn't bet)
Seat 5: +7hFKAL0b0O/n8G72TclJA folded before Flop (didn't bet)
Seat 6: YfsTQsY/fxb+YqbdclTHuw mucked



PokerStars Game #59940216272:  Hold'em No Limit ($0.50/$1.00) - 2009/07/01 1:00:25 ET
Table 'eU3bWpDDg3Z+9R4m4iVmog' 6-max Seat #1 is the button
Seat 1: TSuRyAHnUPCFjP7Z0rEE0w ($189.65 in chips)
Seat 2: 8CAoOzhmB8n3nRFf3V4BTg ($59.80 in chips)
Seat 3: rVMOzU7w5FddYPGhD7qN2Q ($48.15 in chips)
Seat 4: GDVIsbEJ/DOJsMKE4Asz0A ($99.50 in chips)
Seat 6: hpxXcmRkXXI9HE5+5/j/0Q ($130.85 in chips)
8CAoOzhmB8n3nRFf3V4BTg: posts small blind $0.50
rVMOzU7w5FddYPGhD7qN2Q: posts big blind $1
*** HOLE CARDS ***
GDVIsbEJ/DOJsMKE4Asz0A: folds
hpxXcmRkXXI9HE5+5/j/0Q: folds
TSuRyAHnUPCFjP7Z0rEE0w: folds
8CAoOzhmB8n3nRFf3V4BTg: folds
rVMOzU7w5FddYPGhD7qN2Q collected $1 from pot
*** SUMMARY ***
Total pot $1 | Rake $0
Seat 1: TSuRyAHnUPCFjP7Z0rEE0w (button) folded before Flop (didn't bet)
Seat 2: 8CAoOzhmB8n3nRFf3V4BTg (small blind) folded before Flop
Seat 3: rVMOzU7w5FddYPGhD7qN2Q (big blind) collected ($1)
Seat 4: GDVIsbEJ/DOJsMKE4Asz0A folded before Flop (didn't bet)
Seat 6: hpxXcmRkXXI9HE5+5/j/0Q folded before Flop (didn't bet)



PokerStars Game #59940218912:  Hold'em No Limit ($0.50/$1.00) - 2009/07/01 1:00:29 ET
Table 'tLrtq7gDzxEvckNAI1OS5Q' 6-max Seat #6 is the button
Seat 3: TPZ+m9x+lwoKpv7TMfAUWA ($301.45 in chips)
Seat 4: +uSzP8Jwnw7sKfQ4s66b7w ($46.30 in chips)
Seat 5: OGMLOcTNYZXZU81au7ztUw ($166.65 in chips)
Seat 6: XUk5GQsfNFpHvaToDZ0rZA ($168.40 in chips)
TPZ+m9x+lwoKpv7TMfAUWA: posts small blind $0.50
+uSzP8Jwnw7sKfQ4s66b7w: posts big blind $1
*** HOLE CARDS ***
OGMLOcTNYZXZU81au7ztUw: folds
XUk5GQsfNFpHvaToDZ0rZA: folds
TPZ+m9x+lwoKpv7TMfAUWA: folds
+uSzP8Jwnw7sKfQ4s66b7w collected $1 from pot
*** SUMMARY ***
Total pot $1 | Rake $0
Seat 3: TPZ+m9x+lwoKpv7TMfAUWA (small blind) folded before Flop
Seat 4: +uSzP8Jwnw7sKfQ4s66b7w (big blind) collected ($1)
Seat 5: OGMLOcTNYZXZU81au7ztUw folded before Flop (didn't bet)
Seat 6: XUk5GQsfNFpHvaToDZ0rZA (button) folded before Flop (didn't bet)



PokerStars Game #59940219366:  Hold'em No Limit ($0.50/$1.00) - 2009/07/01 1:00:30 ET
Table 'MUPc8FEpe/nR0BKSeReX6Q' 6-max Seat #5 is the button
Seat 1: qhkK6+yCciTRd+rCFEbnEQ ($40 in chips)
Seat 2: xAU6q2/cwmby2sxmA8VcmA ($122.70 in chips)
Seat 3: wx3sQGkVi2x9wJXuWNHPBw ($231.85 in chips)
Seat 4: ZA1bp6g8IwtTxkUE4eCjDQ ($196.80 in chips)
Seat 5: UBZQqpnJZdTYYY1FTb0rLA ($102.05 in chips)
Seat 6: oxnw0GLLpFanjhGkxfRSqA ($27.70 in chips)
oxnw0GLLpFanjhGkxfRSqA: posts small blind $0.50
qhkK6+yCciTRd+rCFEbnEQ: posts big blind $1
*** HOLE CARDS ***
xAU6q2/cwmby2sxmA8VcmA: folds
wx3sQGkVi2x9wJXuWNHPBw: raises $3 to $4
ZA1bp6g8IwtTxkUE4eCjDQ: folds
UBZQqpnJZdTYYY1FTb0rLA: folds
oxnw0GLLpFanjhGkxfRSqA: calls $3.50
qhkK6+yCciTRd+rCFEbnEQ: folds
*** FLOP *** [4c Tc 7c]
oxnw0GLLpFanjhGkxfRSqA: checks
wx3sQGkVi2x9wJXuWNHPBw: bets $6
oxnw0GLLpFanjhGkxfRSqA: folds
wx3sQGkVi2x9wJXuWNHPBw collected $8.55 from pot
*** SUMMARY ***
Total pot $9 | Rake $0.45
Board [4c Tc 7c]
Seat 1: qhkK6+yCciTRd+rCFEbnEQ (big blind) folded before Flop
Seat 2: xAU6q2/cwmby2sxmA8VcmA folded before Flop (didn't bet)
Seat 3: wx3sQGkVi2x9wJXuWNHPBw collected ($8.55)
Seat 4: ZA1bp6g8IwtTxkUE4eCjDQ folded before Flop (didn't bet)
Seat 5: UBZQqpnJZdTYYY1FTb0rLA (button) folded before Flop (didn't bet)
Seat 6: oxnw0GLLpFanjhGkxfRSqA (small blind) folded on the Flop



PokerStars Game #59940219232:  Hold'em No Limit ($0.50/$1.00) - 2009/07/01 1:00:30 ET
Table 'JTT1XWaDZHSaMZQK7cR5uw' 2-max Seat #1 is the button
Seat 1: OLplZF6FEnLflv81Hz+Fxg ($118 in chips)
Seat 2: BcqgegiOUxmBD3F3umsljg ($92.85 in chips)
OLplZF6FEnLflv81Hz+Fxg: posts small blind $0.50
BcqgegiOUxmBD3F3umsljg: posts big blind $1
*** HOLE CARDS ***
OLplZF6FEnLflv81Hz+Fxg: folds
BcqgegiOUxmBD3F3umsljg collected $1 from pot
BcqgegiOUxmBD3F3umsljg: doesn't show hand
*** SUMMARY ***
Total pot $1 | Rake $0
Seat 1: OLplZF6FEnLflv81Hz+Fxg (button) (small blind) folded before Flop
Seat 2: BcqgegiOUxmBD3F3umsljg (big blind) collected ($1)



PokerStars Game #59940219754:  Hold'em No Limit ($0.50/$1.00) - 2009/07/01 1:00:31 ET
Table 'cBDNutyLBKEk9+ptwsKmTw' 6-max Seat #5 is the button
Seat 1: xAU6q2/cwmby2sxmA8VcmA ($121.35 in chips)
Seat 2: 5lY8d6Cnm4HUkt/8FZSj4g ($78.15 in chips)
Seat 3: G5ZSSN6RSON3gkNvk/SmYg ($101.65 in chips)
Seat 4: 3q7F5QtzC30pSrn0nl9i+A ($33.80 in chips)
Seat 5: OGMLOcTNYZXZU81au7ztUw ($157.15 in chips)
Seat 6: NqVlOSH2lp+pp/TK3vvK5g ($40.05 in chips)
NqVlOSH2lp+pp/TK3vvK5g: posts small blind $0.50
xAU6q2/cwmby2sxmA8VcmA: posts big blind $1
*** HOLE CARDS ***
5lY8d6Cnm4HUkt/8FZSj4g: calls $1
G5ZSSN6RSON3gkNvk/SmYg: folds
3q7F5QtzC30pSrn0nl9i+A: folds
OGMLOcTNYZXZU81au7ztUw: folds
NqVlOSH2lp+pp/TK3vvK5g: raises $1 to $2
xAU6q2/cwmby2sxmA8VcmA: raises $9 to $11
5lY8d6Cnm4HUkt/8FZSj4g: calls $10
NqVlOSH2lp+pp/TK3vvK5g: calls $9
*** FLOP *** [5h Qh 8s]
NqVlOSH2lp+pp/TK3vvK5g: checks
xAU6q2/cwmby2sxmA8VcmA: checks
5lY8d6Cnm4HUkt/8FZSj4g: bets $24
NqVlOSH2lp+pp/TK3vvK5g: calls $24
xAU6q2/cwmby2sxmA8VcmA: folds
*** TURN *** [5h Qh 8s] [9s]
NqVlOSH2lp+pp/TK3vvK5g: bets $5.05 and is all-in
5lY8d6Cnm4HUkt/8FZSj4g: calls $5.05
*** RIVER *** [5h Qh 8s 9s] [3h]
*** SHOW DOWN ***
NqVlOSH2lp+pp/TK3vvK5g: shows [9h Ah] (a flush, Ace high)
5lY8d6Cnm4HUkt/8FZSj4g: mucks hand
NqVlOSH2lp+pp/TK3vvK5g collected $88.10 from pot
*** SUMMARY ***
Total pot $91.10 | Rake $3
Board [5h Qh 8s 9s 3h]
Seat 1: xAU6q2/cwmby2sxmA8VcmA (big blind) folded on the Flop
Seat 2: 5lY8d6Cnm4HUkt/8FZSj4g mucked
Seat 3: G5ZSSN6RSON3gkNvk/SmYg folded before Flop (didn't bet)
Seat 4: 3q7F5QtzC30pSrn0nl9i+A folded before Flop (didn't bet)
Seat 5: OGMLOcTNYZXZU81au7ztUw (button) folded before Flop (didn't bet)
Seat 6: NqVlOSH2lp+pp/TK3vvK5g (small blind) showed [9h Ah] and won ($88.10) with a flush, Ace high



PokerStars Game #59940220006:  Hold'em No Limit ($0.50/$1.00) - 2009/07/01 1:00:31 ET
Table 'vs/5jr6ciwjVQ5+Soc+u2A' 6-max Seat #4 is the button
Seat 1: /P4w1pHg2zHYg/4ubJ0dPw ($60 in chips)
Seat 2: XOIf9W+VAxhZqN+SYoyMKA ($117.65 in chips)
Seat 3: G5ZSSN6RSON3gkNvk/SmYg ($139.35 in chips)
Seat 4: wk6Ohn4GDozoOMHc4eb2rw ($89.15 in chips)
Seat 5: +Nt3OPk3XR9SKjZgm2CexQ ($101 in chips)
+Nt3OPk3XR9SKjZgm2CexQ: posts small blind $0.50
/P4w1pHg2zHYg/4ubJ0dPw: posts big blind $1
*** HOLE CARDS ***
XOIf9W+VAxhZqN+SYoyMKA: raises $2 to $3
G5ZSSN6RSON3gkNvk/SmYg: folds
wk6Ohn4GDozoOMHc4eb2rw: folds
+Nt3OPk3XR9SKjZgm2CexQ: folds
/P4w1pHg2zHYg/4ubJ0dPw: folds
XOIf9W+VAxhZqN+SYoyMKA collected $2.50 from pot
XOIf9W+VAxhZqN+SYoyMKA: doesn't show hand
*** SUMMARY ***
Total pot $2.50 | Rake $0
Seat 1: /P4w1pHg2zHYg/4ubJ0dPw (big blind) folded before Flop
Seat 2: XOIf9W+VAxhZqN+SYoyMKA collected ($2.50)
Seat 3: G5ZSSN6RSON3gkNvk/SmYg folded before Flop (didn't bet)
Seat 4: wk6Ohn4GDozoOMHc4eb2rw (button) folded before Flop (didn't bet)
Seat 5: +Nt3OPk3XR9SKjZgm2CexQ (small blind) folded before Flop



PokerStars Game #59940220166:  Hold'em No Limit ($0.50/$1.00) - 2009/07/01 1:00:32 ET
Table 'uNlePsyMIqzM691Xkrlk6Q' 9-max Seat #1 is the button
Seat 1: bLbSOSmSOnqE0iTcH/5dxA ($100 in chips)
Seat 2: +OqpStnt0FqbCfyHAWaLbg ($97.15 in chips)
Seat 3: h7qXkU57Bb8ZuPwMyxR8Ug ($15.15 in chips)
Seat 4: TZcz9MEWDA+WydgGruqqbw ($100 in chips)
Seat 5: 3obndzTJ6fECz8+wWhMd1w ($17 in chips)
Seat 6: myIxN7otsyr846M539YR8Q ($21.50 in chips)
Seat 7: w6cw9nzN7AvkkHBVVjykoQ ($54.25 in chips)
Seat 8: laA8va+Yv8WuMqT1zdR91g ($107.70 in chips)
+OqpStnt0FqbCfyHAWaLbg: posts small blind $0.50
h7qXkU57Bb8ZuPwMyxR8Ug: posts big blind $1
VPF+HjszMvUIpy0CHIwH3A: sits out
*** HOLE CARDS ***
TZcz9MEWDA+WydgGruqqbw: folds
3obndzTJ6fECz8+wWhMd1w: folds
myIxN7otsyr846M539YR8Q: folds
w6cw9nzN7AvkkHBVVjykoQ: folds
laA8va+Yv8WuMqT1zdR91g: raises $2 to $3
bLbSOSmSOnqE0iTcH/5dxA: folds
+OqpStnt0FqbCfyHAWaLbg: folds
h7qXkU57Bb8ZuPwMyxR8Ug: folds
laA8va+Yv8WuMqT1zdR91g collected $2.50 from pot
laA8va+Yv8WuMqT1zdR91g: doesn't show hand
*** SUMMARY ***
Total pot $2.50 | Rake $0
Seat 1: bLbSOSmSOnqE0iTcH/5dxA (button) folded before Flop (didn't bet)
Seat 2: +OqpStnt0FqbCfyHAWaLbg (small blind) folded before Flop
Seat 3: h7qXkU57Bb8ZuPwMyxR8Ug (big blind) folded before Flop
Seat 4: TZcz9MEWDA+WydgGruqqbw folded before Flop (didn't bet)
Seat 5: 3obndzTJ6fECz8+wWhMd1w folded before Flop (didn't bet)
Seat 6: myIxN7otsyr846M539YR8Q folded before Flop (didn't bet)
Seat 7: w6cw9nzN7AvkkHBVVjykoQ folded before Flop (didn't bet)
Seat 8: laA8va+Yv8WuMqT1zdR91g collected ($2.50)



PokerStars Game #59940220842:  Hold'em No Limit ($0.50/$1.00) - 2009/07/01 1:00:33 ET
Table 'iSx0wTgVb4o7MyZeOe06ZA' 9-max Seat #7 is the button
Seat 2: myIxN7otsyr846M539YR8Q ($20 in chips)
Seat 3: XQV7mCMbzd2Wh/l74wmbug ($97.80 in chips)
Seat 5: o1axyw4AjQ8n4ubTwlirQQ ($22 in chips)
Seat 6: T5/PXFS/W+LLcIXBo1G/RA ($105.15 in chips)
Seat 7: w4NnqVr/Sfoj65ux/fEUyQ ($77.90 in chips)
Seat 8: gUUvmqdVlmvpal6B8nYrmg ($100 in chips)
Seat 9: DMQXVuViR4IFzRccosBkJw ($57.05 in chips)
gUUvmqdVlmvpal6B8nYrmg: posts small blind $0.50
DMQXVuViR4IFzRccosBkJw: posts big blind $1
VPF+HjszMvUIpy0CHIwH3A: sits out
0fXz44fzDo5QmhAaJCvFfA: sits out
*** HOLE CARDS ***
myIxN7otsyr846M539YR8Q: folds
XQV7mCMbzd2Wh/l74wmbug: calls $1
o1axyw4AjQ8n4ubTwlirQQ: folds
T5/PXFS/W+LLcIXBo1G/RA: folds
w4NnqVr/Sfoj65ux/fEUyQ: folds
gUUvmqdVlmvpal6B8nYrmg: folds
DMQXVuViR4IFzRccosBkJw: checks
*** FLOP *** [3d As 5d]
DMQXVuViR4IFzRccosBkJw: checks
XQV7mCMbzd2Wh/l74wmbug: bets $2
DMQXVuViR4IFzRccosBkJw: folds
XQV7mCMbzd2Wh/l74wmbug collected $2.40 from pot
XQV7mCMbzd2Wh/l74wmbug: doesn't show hand
*** SUMMARY ***
Total pot $2.50 | Rake $0.10
Board [3d As 5d]
Seat 2: myIxN7otsyr846M539YR8Q folded before Flop (didn't bet)
Seat 3: XQV7mCMbzd2Wh/l74wmbug collected ($2.40)
Seat 5: o1axyw4AjQ8n4ubTwlirQQ folded before Flop (didn't bet)
Seat 6: T5/PXFS/W+LLcIXBo1G/RA folded before Flop (didn't bet)
Seat 7: w4NnqVr/Sfoj65ux/fEUyQ (button) folded before Flop (didn't bet)
Seat 8: gUUvmqdVlmvpal6B8nYrmg (small blind) folded before Flop
Seat 9: DMQXVuViR4IFzRccosBkJw (big blind) folded on the Flop



PokerStars Game #59940221396:  Hold'em No Limit ($0.50/$1.00) - 2009/07/01 1:00:34 ET
Table 'AZ7X3LyLmCidg6l0vIxAvg' 2-max Seat #2 is the button
Seat 1: 9mAoSP3o/mikSZOW2LEEAw ($43.30 in chips)
Seat 2: n650kDobXJAFMDLOn/dqSw ($118.10 in chips)
n650kDobXJAFMDLOn/dqSw: posts small blind $0.50
9mAoSP3o/mikSZOW2LEEAw: posts big blind $1
*** HOLE CARDS ***
n650kDobXJAFMDLOn/dqSw: raises $2 to $3
9mAoSP3o/mikSZOW2LEEAw: calls $2
*** FLOP *** [Qh Kc Qs]
9mAoSP3o/mikSZOW2LEEAw: bets $1
n650kDobXJAFMDLOn/dqSw: calls $1
*** TURN *** [Qh Kc Qs] [6s]
9mAoSP3o/mikSZOW2LEEAw: bets $3
n650kDobXJAFMDLOn/dqSw: folds
9mAoSP3o/mikSZOW2LEEAw collected $7.65 from pot
9mAoSP3o/mikSZOW2LEEAw: shows [Ts Qc] (three of a kind, Queens)
*** SUMMARY ***
Total pot $8 | Rake $0.35
Board [Qh Kc Qs 6s]
Seat 1: 9mAoSP3o/mikSZOW2LEEAw (big blind) collected ($7.65)
Seat 2: n650kDobXJAFMDLOn/dqSw (button) (small blind) folded on the Turn



PokerStars Game #59940221808:  Hold'em No Limit ($0.50/$1.00) - 2009/07/01 1:00:34 ET
Table 'VOs36P6NW+QyXeQ1B62kmA' 6-max Seat #3 is the button
Seat 2: 2UMlbaZ8n8AbRli0Yr0mDw ($28.85 in chips)
Seat 3: TSuRyAHnUPCFjP7Z0rEE0w ($104.90 in chips)
Seat 4: w02zQzNydODiyV9THKgo9w ($43.85 in chips)
Seat 5: ozrlafxxh1HmYdA0/h+MuA ($33.85 in chips)
Seat 6: slVKuQyEz8Qj4E3uLPYNXg ($98.50 in chips)
w02zQzNydODiyV9THKgo9w: posts small blind $0.50
ozrlafxxh1HmYdA0/h+MuA: posts big blind $1
Z2fXsGcjl+Eax+RzOgwOmg: sits out
*** HOLE CARDS ***
slVKuQyEz8Qj4E3uLPYNXg has timed out
slVKuQyEz8Qj4E3uLPYNXg: folds
slVKuQyEz8Qj4E3uLPYNXg is sitting out
2UMlbaZ8n8AbRli0Yr0mDw: folds
TSuRyAHnUPCFjP7Z0rEE0w: raises $3 to $4
slVKuQyEz8Qj4E3uLPYNXg has returned
w02zQzNydODiyV9THKgo9w: folds
ozrlafxxh1HmYdA0/h+MuA: folds
TSuRyAHnUPCFjP7Z0rEE0w collected $2.50 from pot
TSuRyAHnUPCFjP7Z0rEE0w: doesn't show hand
*** SUMMARY ***
Total pot $2.50 | Rake $0
Seat 2: 2UMlbaZ8n8AbRli0Yr0mDw folded before Flop (didn't bet)
Seat 3: TSuRyAHnUPCFjP7Z0rEE0w (button) collected ($2.50)
Seat 4: w02zQzNydODiyV9THKgo9w (small blind) folded before Flop
Seat 5: ozrlafxxh1HmYdA0/h+MuA (big blind) folded before Flop
Seat 6: slVKuQyEz8Qj4E3uLPYNXg folded before Flop (didn't bet)



PokerStars Game #59940223092:  Hold'em No Limit ($0.50/$1.00) - 2009/07/01 1:00:36 ET
Table 'JTT1XWaDZHSaMZQK7cR5uw' 2-max Seat #2 is the button
Seat 1: OLplZF6FEnLflv81Hz+Fxg ($117.50 in chips)
Seat 2: BcqgegiOUxmBD3F3umsljg ($93.35 in chips)
BcqgegiOUxmBD3F3umsljg: posts small blind $0.50
OLplZF6FEnLflv81Hz+Fxg: posts big blind $1
*** HOLE CARDS ***
BcqgegiOUxmBD3F3umsljg: raises $1 to $2
OLplZF6FEnLflv81Hz+Fxg: folds
BcqgegiOUxmBD3F3umsljg collected $2 from pot
*** SUMMARY ***
Total pot $2 | Rake $0
Seat 1: OLplZF6FEnLflv81Hz+Fxg (big blind) folded before Flop
Seat 2: BcqgegiOUxmBD3F3umsljg (button) (small blind) collected ($2)



PokerStars Game #59940223596:  Hold'em No Limit ($0.50/$1.00) - 2009/07/01 1:00:37 ET
Table '8jIjWCPY0NGprquL+xcMFg' 9-max Seat #2 is the button
Seat 1: N7iZ0peZns5o4A6AjN24jQ ($46.60 in chips)
Seat 2: laA8va+Yv8WuMqT1zdR91g ($108.70 in chips)
Seat 3: tjhwe1V98x2spSoUQER3HQ ($103.50 in chips)
Seat 4: Jjc7EHWzs4//xUAjJ0UWoA ($18.90 in chips)
Seat 5: 2YpnxJiexJHyERfbqgwEcw ($52.55 in chips)
Seat 6: GTQkFJtSkbVbnGCktp6e3g ($101.35 in chips)
Seat 7: O3CGPwwUmamrCNHccOilrg ($41.45 in chips)
Seat 8: D+W9Me7w6Hcx/WRUSKV0dw ($18.50 in chips)
Seat 9: negfosHnGOZXSHpWDRKyBQ ($56.15 in chips)
tjhwe1V98x2spSoUQER3HQ: posts small blind $0.50
Jjc7EHWzs4//xUAjJ0UWoA: posts big blind $1
N7iZ0peZns5o4A6AjN24jQ: posts big blind $1
*** HOLE CARDS ***
2YpnxJiexJHyERfbqgwEcw: raises $3 to $4
GTQkFJtSkbVbnGCktp6e3g: folds
O3CGPwwUmamrCNHccOilrg: folds
D+W9Me7w6Hcx/WRUSKV0dw: folds
negfosHnGOZXSHpWDRKyBQ: folds
N7iZ0peZns5o4A6AjN24jQ: folds
laA8va+Yv8WuMqT1zdR91g: folds
tjhwe1V98x2spSoUQER3HQ: folds
Jjc7EHWzs4//xUAjJ0UWoA: folds
2YpnxJiexJHyERfbqgwEcw collected $3.50 from pot
2YpnxJiexJHyERfbqgwEcw: doesn't show hand
*** SUMMARY ***
Total pot $3.50 | Rake $0
Seat 1: N7iZ0peZns5o4A6AjN24jQ folded before Flop
Seat 2: laA8va+Yv8WuMqT1zdR91g (button) folded before Flop (didn't bet)
Seat 3: tjhwe1V98x2spSoUQER3HQ (small blind) folded before Flop
Seat 4: Jjc7EHWzs4//xUAjJ0UWoA (big blind) folded before Flop
Seat 5: 2YpnxJiexJHyERfbqgwEcw collected ($3.50)
Seat 6: GTQkFJtSkbVbnGCktp6e3g folded before Flop (didn't bet)
Seat 7: O3CGPwwUmamrCNHccOilrg folded before Flop (didn't bet)
Seat 8: D+W9Me7w6Hcx/WRUSKV0dw folded before Flop (didn't bet)
Seat 9: negfosHnGOZXSHpWDRKyBQ folded before Flop (didn't bet)



PokerStars Game #59940224004:  Hold'em No Limit ($0.50/$1.00) - 2009/07/01 1:00:38 ET
Table 'eU3bWpDDg3Z+9R4m4iVmog' 6-max Seat #2 is the button
Seat 1: TSuRyAHnUPCFjP7Z0rEE0w ($189.65 in chips)
Seat 2: 8CAoOzhmB8n3nRFf3V4BTg ($59.30 in chips)
Seat 3: rVMOzU7w5FddYPGhD7qN2Q ($48.65 in chips)
Seat 4: GDVIsbEJ/DOJsMKE4Asz0A ($99.50 in chips)
Seat 6: hpxXcmRkXXI9HE5+5/j/0Q ($130.85 in chips)
rVMOzU7w5FddYPGhD7qN2Q: posts small blind $0.50
GDVIsbEJ/DOJsMKE4Asz0A: posts big blind $1
*** HOLE CARDS ***
hpxXcmRkXXI9HE5+5/j/0Q: folds
TSuRyAHnUPCFjP7Z0rEE0w: folds
8CAoOzhmB8n3nRFf3V4BTg: folds
rVMOzU7w5FddYPGhD7qN2Q: folds
GDVIsbEJ/DOJsMKE4Asz0A collected $1 from pot
*** SUMMARY ***
Total pot $1 | Rake $0
Seat 1: TSuRyAHnUPCFjP7Z0rEE0w folded before Flop (didn't bet)
Seat 2: 8CAoOzhmB8n3nRFf3V4BTg (button) folded before Flop (didn't bet)
Seat 3: rVMOzU7w5FddYPGhD7qN2Q (small blind) folded before Flop
Seat 4: GDVIsbEJ/DOJsMKE4Asz0A (big blind) collected ($1)
Seat 6: hpxXcmRkXXI9HE5+5/j/0Q folded before Flop (didn't bet)



PokerStars Game #59940225418:  Hold'em No Limit ($0.50/$1.00) - 2009/07/01 1:00:40 ET
Table 'W/wyObTiXZm+Ckkl3YxcSw' 6-max Seat #2 is the button
Seat 1: eUBBn2R56C1IQ6Cs/vitwg ($145.40 in chips)
Seat 2: oDiBRCaF0QVtd3kO6xZIXw ($107.85 in chips)
Seat 3: dxyNCn/qxfkGDUIf28Cbng ($84.40 in chips)
Seat 4: aYii2DmxlOlbC1wbGRBWvQ ($97 in chips)
Seat 5: BdbmJTZZ47quA9vUWwXtlw ($60.85 in chips)
dxyNCn/qxfkGDUIf28Cbng: posts small blind $0.50
aYii2DmxlOlbC1wbGRBWvQ: posts big blind $1
OGMLOcTNYZXZU81au7ztUw: sits out
*** HOLE CARDS ***
BdbmJTZZ47quA9vUWwXtlw: folds
eUBBn2R56C1IQ6Cs/vitwg: raises $2 to $3
oDiBRCaF0QVtd3kO6xZIXw: folds
dxyNCn/qxfkGDUIf28Cbng: folds
aYii2DmxlOlbC1wbGRBWvQ: raises $4 to $7
eUBBn2R56C1IQ6Cs/vitwg: calls $4
*** FLOP *** [9s Js Jd]
aYii2DmxlOlbC1wbGRBWvQ: bets $7
eUBBn2R56C1IQ6Cs/vitwg: folds
aYii2DmxlOlbC1wbGRBWvQ collected $13.80 from pot
*** SUMMARY ***
Total pot $14.50 | Rake $0.70
Board [9s Js Jd]
Seat 1: eUBBn2R56C1IQ6Cs/vitwg folded on the Flop
Seat 2: oDiBRCaF0QVtd3kO6xZIXw (button) folded before Flop (didn't bet)
Seat 3: dxyNCn/qxfkGDUIf28Cbng (small blind) folded before Flop
Seat 4: aYii2DmxlOlbC1wbGRBWvQ (big blind) collected ($13.80)
Seat 5: BdbmJTZZ47quA9vUWwXtlw folded before Flop (didn't bet)



PokerStars Game #59940225240:  Hold'em No Limit ($0.50/$1.00) - 2009/07/01 1:00:40 ET
Table 'Zka9tv1yilg0MvXWPQrShg' 9-max Seat #5 is the button
Seat 1: TZcz9MEWDA+WydgGruqqbw ($117.40 in chips)
Seat 2: kz9ziSiGUc+857heiKSayw ($19.50 in chips)
Seat 3: gUUvmqdVlmvpal6B8nYrmg ($106.45 in chips)
Seat 4: stxmTgSicxShtrDxhOOX2g ($63.15 in chips)
Seat 5: /zy+DB4S5fUQUSfZWFzYGw ($131.60 in chips)
Seat 6: rY8wPoax1lS+HUY+I0FZDw ($159.70 in chips)
Seat 7: p1SafS90nb3Uft5LB0NkHw ($20.50 in chips)
Seat 9: 6daxhj43mWj04MOPTOmaYA ($94 in chips)
rY8wPoax1lS+HUY+I0FZDw: posts small blind $0.50
p1SafS90nb3Uft5LB0NkHw: posts big blind $1
D+W9Me7w6Hcx/WRUSKV0dw: sits out
*** HOLE CARDS ***
6daxhj43mWj04MOPTOmaYA: raises $2 to $3
TZcz9MEWDA+WydgGruqqbw: folds
kz9ziSiGUc+857heiKSayw: folds
gUUvmqdVlmvpal6B8nYrmg: folds
stxmTgSicxShtrDxhOOX2g: folds
/zy+DB4S5fUQUSfZWFzYGw: calls $3
rY8wPoax1lS+HUY+I0FZDw: folds
p1SafS90nb3Uft5LB0NkHw: folds
*** FLOP *** [5s 9d Kh]
6daxhj43mWj04MOPTOmaYA: bets $5
/zy+DB4S5fUQUSfZWFzYGw: calls $5
*** TURN *** [5s 9d Kh] [Ad]
6daxhj43mWj04MOPTOmaYA: bets $8
/zy+DB4S5fUQUSfZWFzYGw: calls $8
*** RIVER *** [5s 9d Kh Ad] [6s]
6daxhj43mWj04MOPTOmaYA: bets $11
/zy+DB4S5fUQUSfZWFzYGw: folds
6daxhj43mWj04MOPTOmaYA collected $31.90 from pot
*** SUMMARY ***
Total pot $33.50 | Rake $1.60
Board [5s 9d Kh Ad 6s]
Seat 1: TZcz9MEWDA+WydgGruqqbw folded before Flop (didn't bet)
Seat 2: kz9ziSiGUc+857heiKSayw folded before Flop (didn't bet)
Seat 3: gUUvmqdVlmvpal6B8nYrmg folded before Flop (didn't bet)
Seat 4: stxmTgSicxShtrDxhOOX2g folded before Flop (didn't bet)
Seat 5: /zy+DB4S5fUQUSfZWFzYGw (button) folded on the River
Seat 6: rY8wPoax1lS+HUY+I0FZDw (small blind) folded before Flop
Seat 7: p1SafS90nb3Uft5LB0NkHw (big blind) folded before Flop
Seat 9: 6daxhj43mWj04MOPTOmaYA collected ($31.90)



PokerStars Game #59940226456:  Hold'em No Limit ($0.50/$1.00) - 2009/07/01 1:00:42 ET
Table 'cKH9c4x6u79IqCdaKKvXrw' 9-max Seat #2 is the button
Seat 1: Pp/KTcXkfZKKUHkjyaLTdg ($17 in chips)
Seat 2: 8S3JMH4TY3whgIlZmMv66w ($67.65 in chips)
Seat 3: 997ViqAtWn1FPjJqcffwcA ($157.60 in chips)
Seat 4: FL3MrLspcF23LYvC4ipBOA ($100 in chips)
Seat 5: Jjc7EHWzs4//xUAjJ0UWoA ($42.15 in chips)
Seat 6: Bsd/K5gAcLanYbGiPirRjw ($210.55 in chips)
Seat 7: 1GkkVBhlJ92guE6K5mS5Ig ($14.15 in chips)
Seat 8: myIxN7otsyr846M539YR8Q ($18.50 in chips)
Seat 9: 6XkTu4ahxzHnvjjc1R8YjQ ($41.60 in chips)
997ViqAtWn1FPjJqcffwcA: posts small blind $0.50
FL3MrLspcF23LYvC4ipBOA: posts big blind $1
*** HOLE CARDS ***
Jjc7EHWzs4//xUAjJ0UWoA: folds
Bsd/K5gAcLanYbGiPirRjw: folds
1GkkVBhlJ92guE6K5mS5Ig: calls $1
myIxN7otsyr846M539YR8Q: folds
6XkTu4ahxzHnvjjc1R8YjQ: folds
Pp/KTcXkfZKKUHkjyaLTdg: folds
8S3JMH4TY3whgIlZmMv66w: folds
997ViqAtWn1FPjJqcffwcA: folds
FL3MrLspcF23LYvC4ipBOA: checks
*** FLOP *** [Ah 4h 2c]
FL3MrLspcF23LYvC4ipBOA: checks
1GkkVBhlJ92guE6K5mS5Ig: bets $2
FL3MrLspcF23LYvC4ipBOA: folds
1GkkVBhlJ92guE6K5mS5Ig collected $2.40 from pot
*** SUMMARY ***
Total pot $2.50 | Rake $0.10
Board [Ah 4h 2c]
Seat 1: Pp/KTcXkfZKKUHkjyaLTdg folded before Flop (didn't bet)
Seat 2: 8S3JMH4TY3whgIlZmMv66w (button) folded before Flop (didn't bet)
Seat 3: 997ViqAtWn1FPjJqcffwcA (small blind) folded before Flop
Seat 4: FL3MrLspcF23LYvC4ipBOA (big blind) folded on the Flop
Seat 5: Jjc7EHWzs4//xUAjJ0UWoA folded before Flop (didn't bet)
Seat 6: Bsd/K5gAcLanYbGiPirRjw folded before Flop (didn't bet)
Seat 7: 1GkkVBhlJ92guE6K5mS5Ig collected ($2.40)
Seat 8: myIxN7otsyr846M539YR8Q folded before Flop (didn't bet)
Seat 9: 6XkTu4ahxzHnvjjc1R8YjQ folded before Flop (didn't bet)



PokerStars Game #59940226360:  Hold'em No Limit ($0.50/$1.00) - 2009/07/01 1:00:42 ET
Table 'LmXQK9xy3awB+qsPzI21Mw' 2-max Seat #1 is the button
Seat 1: NYi6JFscYNrofSXy4sM+Yw ($260.05 in chips)
Seat 2: TME8GvochpQAo8cmJwWmvA ($127.20 in chips)
NYi6JFscYNrofSXy4sM+Yw: posts small blind $0.50
TME8GvochpQAo8cmJwWmvA: posts big blind $1
*** HOLE CARDS ***
NYi6JFscYNrofSXy4sM+Yw: raises $2 to $3
TME8GvochpQAo8cmJwWmvA: folds
NYi6JFscYNrofSXy4sM+Yw collected $2 from pot
*** SUMMARY ***
Total pot $2 | Rake $0
Seat 1: NYi6JFscYNrofSXy4sM+Yw (button) (small blind) collected ($2)
Seat 2: TME8GvochpQAo8cmJwWmvA (big blind) folded before Flop



PokerStars Game #59940227018:  Hold'em No Limit ($0.50/$1.00) - 2009/07/01 1:00:43 ET
Table 'pHrhryH8jPNdQfY62f8v+g' 6-max Seat #4 is the button
Seat 1: OvwYHV65yUbgdBjSmo1+5g ($50.50 in chips)
Seat 2: RqgF7gRoKgRNW8Zoi1ty4A ($100.45 in chips)
Seat 3: 8oS5O7iD/qnFXFXJrGIgNQ ($151.80 in chips)
Seat 4: DHjG71KHeyQxu3OZ+fFd4w ($39.35 in chips)
Seat 5: r1/R7y0Ortgoz4lccgW8VA ($47.05 in chips)
Seat 6: xAU6q2/cwmby2sxmA8VcmA ($109.30 in chips)
r1/R7y0Ortgoz4lccgW8VA: posts small blind $0.50
xAU6q2/cwmby2sxmA8VcmA: posts big blind $1
*** HOLE CARDS ***
OvwYHV65yUbgdBjSmo1+5g: calls $1
RqgF7gRoKgRNW8Zoi1ty4A: folds
8oS5O7iD/qnFXFXJrGIgNQ: folds
DHjG71KHeyQxu3OZ+fFd4w: folds
r1/R7y0Ortgoz4lccgW8VA: folds
xAU6q2/cwmby2sxmA8VcmA: checks
*** FLOP *** [6s 9c 7s]
xAU6q2/cwmby2sxmA8VcmA: checks
OvwYHV65yUbgdBjSmo1+5g: bets $2
xAU6q2/cwmby2sxmA8VcmA: calls $2
*** TURN *** [6s 9c 7s] [Qs]
xAU6q2/cwmby2sxmA8VcmA: checks
OvwYHV65yUbgdBjSmo1+5g: bets $2
xAU6q2/cwmby2sxmA8VcmA: calls $2
*** RIVER *** [6s 9c 7s Qs] [As]
xAU6q2/cwmby2sxmA8VcmA: checks
OvwYHV65yUbgdBjSmo1+5g: bets $5
xAU6q2/cwmby2sxmA8VcmA: folds
OvwYHV65yUbgdBjSmo1+5g collected $10 from pot
*** SUMMARY ***
Total pot $10.50 | Rake $0.50
Board [6s 9c 7s Qs As]
Seat 1: OvwYHV65yUbgdBjSmo1+5g collected ($10)
Seat 2: RqgF7gRoKgRNW8Zoi1ty4A folded before Flop (didn't bet)
Seat 3: 8oS5O7iD/qnFXFXJrGIgNQ folded before Flop (didn't bet)
Seat 4: DHjG71KHeyQxu3OZ+fFd4w (button) folded before Flop (didn't bet)
Seat 5: r1/R7y0Ortgoz4lccgW8VA (small blind) folded before Flop
Seat 6: xAU6q2/cwmby2sxmA8VcmA (big blind) folded on the River



PokerStars Game #59940227306:  Hold'em No Limit ($0.50/$1.00) - 2009/07/01 1:00:43 ET
Table 'tLrtq7gDzxEvckNAI1OS5Q' 6-max Seat #3 is the button
Seat 3: TPZ+m9x+lwoKpv7TMfAUWA ($300.95 in chips)
Seat 4: +uSzP8Jwnw7sKfQ4s66b7w ($46.80 in chips)
Seat 5: OGMLOcTNYZXZU81au7ztUw ($166.65 in chips)
Seat 6: XUk5GQsfNFpHvaToDZ0rZA ($168.40 in chips)
+uSzP8Jwnw7sKfQ4s66b7w: posts small blind $0.50
OGMLOcTNYZXZU81au7ztUw: posts big blind $1
*** HOLE CARDS ***
XUk5GQsfNFpHvaToDZ0rZA: folds
TPZ+m9x+lwoKpv7TMfAUWA: raises $2 to $3
+uSzP8Jwnw7sKfQ4s66b7w: calls $2.50
OGMLOcTNYZXZU81au7ztUw: folds
*** FLOP *** [Kd 2h Qc]
+uSzP8Jwnw7sKfQ4s66b7w: checks
TPZ+m9x+lwoKpv7TMfAUWA: bets $5
+uSzP8Jwnw7sKfQ4s66b7w: folds
TPZ+m9x+lwoKpv7TMfAUWA collected $6.65 from pot
*** SUMMARY ***
Total pot $7 | Rake $0.35
Board [Kd 2h Qc]
Seat 3: TPZ+m9x+lwoKpv7TMfAUWA (button) collected ($6.65)
Seat 4: +uSzP8Jwnw7sKfQ4s66b7w (small blind) folded on the Flop
Seat 5: OGMLOcTNYZXZU81au7ztUw (big blind) folded before Flop
Seat 6: XUk5GQsfNFpHvaToDZ0rZA folded before Flop (didn't bet)



PokerStars Game #59940227808:  Hold'em No Limit ($0.50/$1.00) - 2009/07/01 1:00:45 ET
Table 'JTT1XWaDZHSaMZQK7cR5uw' 2-max Seat #1 is the button
Seat 1: OLplZF6FEnLflv81Hz+Fxg ($116.50 in chips)
Seat 2: BcqgegiOUxmBD3F3umsljg ($94.35 in chips)
OLplZF6FEnLflv81Hz+Fxg: posts small blind $0.50
BcqgegiOUxmBD3F3umsljg: posts big blind $1
*** HOLE CARDS ***
OLplZF6FEnLflv81Hz+Fxg: folds
BcqgegiOUxmBD3F3umsljg collected $1 from pot
*** SUMMARY ***
Total pot $1 | Rake $0
Seat 1: OLplZF6FEnLflv81Hz+Fxg (button) (small blind) folded before Flop
Seat 2: BcqgegiOUxmBD3F3umsljg (big blind) collected ($1)



PokerStars Game #59940229054:  Hold'em No Limit ($0.50/$1.00) - 2009/07/01 1:00:46 ET
Table '7O9fB8yx1u7sJveJn8w6jA' 6-max Seat #3 is the button
Seat 2: wx3sQGkVi2x9wJXuWNHPBw ($195.45 in chips)
Seat 3: hpxXcmRkXXI9HE5+5/j/0Q ($100 in chips)
Seat 4: XIZSmlGttGgSRaIU42K4Fg ($143.40 in chips)
Seat 5: BCEV3COoKY607AzLWayfRA ($100 in chips)
Seat 6: UBZQqpnJZdTYYY1FTb0rLA ($137.95 in chips)
XIZSmlGttGgSRaIU42K4Fg: posts small blind $0.50
BCEV3COoKY607AzLWayfRA: posts big blind $1
*** HOLE CARDS ***
UBZQqpnJZdTYYY1FTb0rLA: folds
wx3sQGkVi2x9wJXuWNHPBw: folds
hpxXcmRkXXI9HE5+5/j/0Q: raises $3 to $4
XIZSmlGttGgSRaIU42K4Fg: folds
BCEV3COoKY607AzLWayfRA: folds
hpxXcmRkXXI9HE5+5/j/0Q collected $2.50 from pot
hpxXcmRkXXI9HE5+5/j/0Q: doesn't show hand
*** SUMMARY ***
Total pot $2.50 | Rake $0
Seat 2: wx3sQGkVi2x9wJXuWNHPBw folded before Flop (didn't bet)
Seat 3: hpxXcmRkXXI9HE5+5/j/0Q (button) collected ($2.50)
Seat 4: XIZSmlGttGgSRaIU42K4Fg (small blind) folded before Flop
Seat 5: BCEV3COoKY607AzLWayfRA (big blind) folded before Flop
Seat 6: UBZQqpnJZdTYYY1FTb0rLA folded before Flop (didn't bet)



PokerStars Game #59940230312:  Hold'em No Limit ($0.50/$1.00) - 2009/07/01 1:00:49 ET
Table 'rmZfTK+oSebeUPJNbWhdAA' 6-max Seat #2 is the button
Seat 1: xAU6q2/cwmby2sxmA8VcmA ($146.50 in chips)
Seat 2: z7O9PO/WEcqRouIydFhS9Q ($121.05 in chips)
Seat 3: BCEV3COoKY607AzLWayfRA ($134.50 in chips)
Seat 4: 1/mIuXfgx1ZyVkodrmfQDw ($100 in chips)
Seat 5: 5lY8d6Cnm4HUkt/8FZSj4g ($92.50 in chips)
Seat 6: j7NIOHLZk7V2o9fOioO5ug ($118.30 in chips)
BCEV3COoKY607AzLWayfRA: posts small blind $0.50
1/mIuXfgx1ZyVkodrmfQDw: posts big blind $1
*** HOLE CARDS ***
5lY8d6Cnm4HUkt/8FZSj4g: calls $1
j7NIOHLZk7V2o9fOioO5ug: folds
xAU6q2/cwmby2sxmA8VcmA: folds
z7O9PO/WEcqRouIydFhS9Q: folds
BCEV3COoKY607AzLWayfRA: folds
1/mIuXfgx1ZyVkodrmfQDw: checks
*** FLOP *** [8d 4h 5d]
1/mIuXfgx1ZyVkodrmfQDw: checks
5lY8d6Cnm4HUkt/8FZSj4g: bets $7
1/mIuXfgx1ZyVkodrmfQDw: folds
5lY8d6Cnm4HUkt/8FZSj4g collected $2.40 from pot
*** SUMMARY ***
Total pot $2.50 | Rake $0.10
Board [8d 4h 5d]
Seat 1: xAU6q2/cwmby2sxmA8VcmA folded before Flop (didn't bet)
Seat 2: z7O9PO/WEcqRouIydFhS9Q (button) folded before Flop (didn't bet)
Seat 3: BCEV3COoKY607AzLWayfRA (small blind) folded before Flop
Seat 4: 1/mIuXfgx1ZyVkodrmfQDw (big blind) folded on the Flop
Seat 5: 5lY8d6Cnm4HUkt/8FZSj4g collected ($2.40)
Seat 6: j7NIOHLZk7V2o9fOioO5ug folded before Flop (didn't bet)



PokerStars Game #59940230478:  Hold'em No Limit ($0.50/$1.00) - 2009/07/01 1:00:49 ET
Table 'tyUh+jyNvrceIQdKMJjQ2wZFWj23PMihdwrNWv41OG/Qeat #5 is the button
Seat 1: o8A5MUdudVKu+pAwgZOX2w ($181.30 in chips)
Seat 2: XvUbOIg94d25feWeQlOTVg ($153 in chips)
Seat 3: TalCiLYHCd+ffkmR3auPvA ($92.10 in chips)
Seat 4: TSuRyAHnUPCFjP7Z0rEE0w ($109.75 in chips)
Seat 5: j7NIOHLZk7V2o9fOioO5ug ($111.65 in chips)
Seat 6: 4OO5v3AVduL0tePNx8wk5A ($100 in chips)
4OO5v3AVduL0tePNx8wk5A: posts small blind $0.50
o8A5MUdudVKu+pAwgZOX2w: posts big blind $1
*** HOLE CARDS ***
XvUbOIg94d25feWeQlOTVg: folds
TalCiLYHCd+ffkmR3auPvA: folds
TSuRyAHnUPCFjP7Z0rEE0w: folds
j7NIOHLZk7V2o9fOioO5ug: folds
4OO5v3AVduL0tePNx8wk5A: folds
o8A5MUdudVKu+pAwgZOX2w collected $1 from pot
o8A5MUdudVKu+pAwgZOX2w: doesn't show hand
*** SUMMARY ***
Total pot $1 | Rake $0
Seat 1: o8A5MUdudVKu+pAwgZOX2w (big blind) collected ($1)
Seat 2: XvUbOIg94d25feWeQlOTVg folded before Flop (didn't bet)
Seat 3: TalCiLYHCd+ffkmR3auPvA folded before Flop (didn't bet)
Seat 4: TSuRyAHnUPCFjP7Z0rEE0w folded before Flop (didn't bet)
Seat 5: j7NIOHLZk7V2o9fOioO5ug (button) folded before Flop (didn't bet)
Seat 6: 4OO5v3AVduL0tePNx8wk5A (small blind) folded before Flop



PokerStars Game #59940231790:  Hold'em No Limit ($0.50/$1.00) - 2009/07/01 1:00:51 ET
Table 'QSIig7BLMc9wY/rgBechzw' 6-max Seat #5 is the button
Seat 1: Z2fXsGcjl+Eax+RzOgwOmg ($100 in chips)
Seat 2: mLOIkH/qmRa+mVujQIhBRg ($42.95 in chips)
Seat 3: Z3y97GMLCsoTZ9j7f6qctg ($35.80 in chips)
Seat 4: +uSzP8Jwnw7sKfQ4s66b7w ($62 in chips)
Seat 5: PVmmeYpn4gqkqYUool6BOA ($17.90 in chips)
Seat 6: PxqfkAMdAWtkgbT+q2gciA ($33.70 in chips)
PxqfkAMdAWtkgbT+q2gciA: posts small blind $0.50
Z2fXsGcjl+Eax+RzOgwOmg: posts big blind $1
*** HOLE CARDS ***
mLOIkH/qmRa+mVujQIhBRg: calls $1
Z3y97GMLCsoTZ9j7f6qctg: calls $1
+uSzP8Jwnw7sKfQ4s66b7w: raises $4 to $5
PVmmeYpn4gqkqYUool6BOA: folds
PxqfkAMdAWtkgbT+q2gciA: folds
Z2fXsGcjl+Eax+RzOgwOmg: folds
mLOIkH/qmRa+mVujQIhBRg: calls $4
Z3y97GMLCsoTZ9j7f6qctg: calls $4
*** FLOP *** [9s 5c Tc]
mLOIkH/qmRa+mVujQIhBRg: checks
Z3y97GMLCsoTZ9j7f6qctg: checks
+uSzP8Jwnw7sKfQ4s66b7w: bets $14
mLOIkH/qmRa+mVujQIhBRg: folds
Z3y97GMLCsoTZ9j7f6qctg: folds
+uSzP8Jwnw7sKfQ4s66b7w collected $15.70 from pot
*** SUMMARY ***
Total pot $16.50 | Rake $0.80
Board [9s 5c Tc]
Seat 1: Z2fXsGcjl+Eax+RzOgwOmg (big blind) folded before Flop
Seat 2: mLOIkH/qmRa+mVujQIhBRg folded on the Flop
Seat 3: Z3y97GMLCsoTZ9j7f6qctg folded on the Flop
Seat 4: +uSzP8Jwnw7sKfQ4s66b7w collected ($15.70)
Seat 5: PVmmeYpn4gqkqYUool6BOA (button) folded before Flop (didn't bet)
Seat 6: PxqfkAMdAWtkgbT+q2gciA (small blind) folded before Flop



PokerStars Game #59940231740:  Hold'em No Limit ($0.50/$1.00) - 2009/07/01 1:00:51 ET
Table 'JTT1XWaDZHSaMZQK7cR5uw' 2-max Seat #2 is the button
Seat 1: OLplZF6FEnLflv81Hz+Fxg ($116 in chips)
Seat 2: BcqgegiOUxmBD3F3umsljg ($94.85 in chips)
BcqgegiOUxmBD3F3umsljg: posts small blind $0.50
OLplZF6FEnLflv81Hz+Fxg: posts big blind $1
*** HOLE CARDS ***
BcqgegiOUxmBD3F3umsljg: raises $1 to $2
OLplZF6FEnLflv81Hz+Fxg: raises $6 to $8
BcqgegiOUxmBD3F3umsljg: folds
OLplZF6FEnLflv81Hz+Fxg collected $4 from pot
*** SUMMARY ***
Total pot $4 | Rake $0
Seat 1: OLplZF6FEnLflv81Hz+Fxg (big blind) collected ($4)
Seat 2: BcqgegiOUxmBD3F3umsljg (button) (small blind) folded before Flop



PokerStars Game #59940232482:  Hold'em No Limit ($0.50/$1.00) - 2009/07/01 1:00:52 ET
Table 'vs/5jr6ciwjVQ5+Soc+u2A' 6-max Seat #5 is the button
Seat 1: /P4w1pHg2zHYg/4ubJ0dPw ($60 in chips)
Seat 3: G5ZSSN6RSON3gkNvk/SmYg ($139.35 in chips)
Seat 4: wk6Ohn4GDozoOMHc4eb2rw ($89.15 in chips)
Seat 5: +Nt3OPk3XR9SKjZgm2CexQ ($100.50 in chips)
/P4w1pHg2zHYg/4ubJ0dPw: posts small blind $0.50
XOIf9W+VAxhZqN+SYoyMKA: is sitting out
G5ZSSN6RSON3gkNvk/SmYg: posts big blind $1
*** HOLE CARDS ***
wk6Ohn4GDozoOMHc4eb2rw: folds
XOIf9W+VAxhZqN+SYoyMKA leaves the table
+Nt3OPk3XR9SKjZgm2CexQ: raises $1.30 to $2.30
/P4w1pHg2zHYg/4ubJ0dPw: raises $5.70 to $8
G5ZSSN6RSON3gkNvk/SmYg: folds
+Nt3OPk3XR9SKjZgm2CexQ: folds
TighterRock joins the table at seat #2
/P4w1pHg2zHYg/4ubJ0dPw collected $5.60 from pot
/P4w1pHg2zHYg/4ubJ0dPw: doesn't show hand
*** SUMMARY ***
Total pot $5.60 | Rake $0
Seat 1: /P4w1pHg2zHYg/4ubJ0dPw (small blind) collected ($5.60)
Seat 3: G5ZSSN6RSON3gkNvk/SmYg (big blind) folded before Flop
Seat 4: wk6Ohn4GDozoOMHc4eb2rw folded before Flop (didn't bet)
Seat 5: +Nt3OPk3XR9SKjZgm2CexQ (button) folded before Flop



PokerStars Game #59940233014:  Hold'em No Limit ($0.50/$1.00) - 2009/07/01 1:00:53 ET
Table 'eU3bWpDDg3Z+9R4m4iVmog' 6-max Seat #3 is the button
Seat 1: TSuRyAHnUPCFjP7Z0rEE0w ($189.65 in chips)
Seat 2: 8CAoOzhmB8n3nRFf3V4BTg ($59.30 in chips)
Seat 3: rVMOzU7w5FddYPGhD7qN2Q ($48.15 in chips)
Seat 4: GDVIsbEJ/DOJsMKE4Asz0A ($100 in chips)
Seat 6: hpxXcmRkXXI9HE5+5/j/0Q ($130.85 in chips)
GDVIsbEJ/DOJsMKE4Asz0A: posts small blind $0.50
hpxXcmRkXXI9HE5+5/j/0Q: posts big blind $1
*** HOLE CARDS ***
TSuRyAHnUPCFjP7Z0rEE0w: folds
8CAoOzhmB8n3nRFf3V4BTg: folds
rVMOzU7w5FddYPGhD7qN2Q: folds
GDVIsbEJ/DOJsMKE4Asz0A: calls $0.50
hpxXcmRkXXI9HE5+5/j/0Q: checks
*** FLOP *** [9s Kd 6d]
GDVIsbEJ/DOJsMKE4Asz0A: checks
hpxXcmRkXXI9HE5+5/j/0Q: checks
*** TURN *** [9s Kd 6d] [3h]
GDVIsbEJ/DOJsMKE4Asz0A: checks
hpxXcmRkXXI9HE5+5/j/0Q: checks
*** RIVER *** [9s Kd 6d 3h] [Js]
GDVIsbEJ/DOJsMKE4Asz0A: checks
hpxXcmRkXXI9HE5+5/j/0Q: checks
*** SHOW DOWN ***
GDVIsbEJ/DOJsMKE4Asz0A: shows [4s 7s] (high card King)
hpxXcmRkXXI9HE5+5/j/0Q: shows [Ac 8s] (high card Ace)
hpxXcmRkXXI9HE5+5/j/0Q collected $1.90 from pot
*** SUMMARY ***
Total pot $2 | Rake $0.10
Board [9s Kd 6d 3h Js]
Seat 1: TSuRyAHnUPCFjP7Z0rEE0w folded before Flop (didn't bet)
Seat 2: 8CAoOzhmB8n3nRFf3V4BTg folded before Flop (didn't bet)
Seat 3: rVMOzU7w5FddYPGhD7qN2Q (button) folded before Flop (didn't bet)
Seat 4: GDVIsbEJ/DOJsMKE4Asz0A (small blind) showed [4s 7s] and lost with high card King
Seat 6: hpxXcmRkXXI9HE5+5/j/0Q (big blind) showed [Ac 8s] and won ($1.90) with high card Ace



PokerStars Game #59940234170:  Hold'em No Limit ($0.50/$1.00) - 2009/07/01 1:00:55 ET
Table 'LmXQK9xy3awB+qsPzI21Mw' 2-max Seat #2 is the button
Seat 1: NYi6JFscYNrofSXy4sM+Yw ($261.05 in chips)
Seat 2: TME8GvochpQAo8cmJwWmvA ($126.20 in chips)
TME8GvochpQAo8cmJwWmvA: posts small blind $0.50
NYi6JFscYNrofSXy4sM+Yw: posts big blind $1
*** HOLE CARDS ***
TME8GvochpQAo8cmJwWmvA: calls $0.50
NYi6JFscYNrofSXy4sM+Yw: raises $3 to $4
TME8GvochpQAo8cmJwWmvA: calls $3
*** FLOP *** [6h 6d 9d]
NYi6JFscYNrofSXy4sM+Yw: bets $4
TME8GvochpQAo8cmJwWmvA: calls $4
*** TURN *** [6h 6d 9d] [9c]
NYi6JFscYNrofSXy4sM+Yw: checks
TME8GvochpQAo8cmJwWmvA: bets $6
NYi6JFscYNrofSXy4sM+Yw: folds
TME8GvochpQAo8cmJwWmvA collected $15.50 from pot
TME8GvochpQAo8cmJwWmvA: doesn't show hand
*** SUMMARY ***
Total pot $16 | Rake $0.50
Board [6h 6d 9d 9c]
Seat 1: NYi6JFscYNrofSXy4sM+Yw (big blind) folded on the Turn
Seat 2: TME8GvochpQAo8cmJwWmvA (button) (small blind) collected ($15.50)



PokerStars Game #59940234798:  Hold'em No Limit ($0.50/$1.00) - 2009/07/01 1:00:56 ET
Table 'mmbQQVBTrPdE+wy+s+9VPA' 6-max Seat #1 is the button
Seat 1: zyP4SPoWZnKUfTvIRLCVog ($53.50 in chips)
Seat 2: cl/QpVR/PLO58lj+C5mGLw ($23.20 in chips)
Seat 3: wx3sQGkVi2x9wJXuWNHPBw ($113.65 in chips)
Seat 4: V3iZdcw61nXF3g5hD2RrsQ ($100 in chips)
Seat 5: YMJG+F++3Aj6P8dAWda5fw ($100 in chips)
Seat 6: U2CWBTv29qdCbj8RNF2sIw ($107.45 in chips)
cl/QpVR/PLO58lj+C5mGLw: posts small blind $0.50
wx3sQGkVi2x9wJXuWNHPBw: posts big blind $1
*** HOLE CARDS ***
V3iZdcw61nXF3g5hD2RrsQ: folds
YMJG+F++3Aj6P8dAWda5fw: folds
U2CWBTv29qdCbj8RNF2sIw: raises $2 to $3
zyP4SPoWZnKUfTvIRLCVog: folds
cl/QpVR/PLO58lj+C5mGLw: folds
wx3sQGkVi2x9wJXuWNHPBw: folds
U2CWBTv29qdCbj8RNF2sIw collected $2.50 from pot
*** SUMMARY ***
Total pot $2.50 | Rake $0
Seat 1: zyP4SPoWZnKUfTvIRLCVog (button) folded before Flop (didn't bet)
Seat 2: cl/QpVR/PLO58lj+C5mGLw (small blind) folded before Flop
Seat 3: wx3sQGkVi2x9wJXuWNHPBw (big blind) folded before Flop
Seat 4: V3iZdcw61nXF3g5hD2RrsQ folded before Flop (didn't bet)
Seat 5: YMJG+F++3Aj6P8dAWda5fw folded before Flop (didn't bet)
Seat 6: U2CWBTv29qdCbj8RNF2sIw collected ($2.50)



PokerStars Game #59940235892:  Hold'em No Limit ($0.50/$1.00) - 2009/07/01 1:00:57 ET
Table 'hugOjcwJvzEwZbK7tyiWuQ' 9-max Seat #5 is the button
Seat 1: D+W9Me7w6Hcx/WRUSKV0dw ($32.95 in chips)
Seat 2: r27C1nIV4NS4+qbnrgBQSw ($261 in chips)
Seat 3: jDwhY1kCdc6EkAHbT7PJMQ ($104.75 in chips)
Seat 4: UWB3oeddt/GObx2Mix2Anw ($197.80 in chips)
Seat 5: 5BRGWf+R3nt2WS3b5xX+zA ($13.75 in chips)
Seat 6: gUUvmqdVlmvpal6B8nYrmg ($107.90 in chips)
Seat 7: FL3MrLspcF23LYvC4ipBOA ($111.80 in chips)
Seat 8: /zy+DB4S5fUQUSfZWFzYGw ($101 in chips)
gUUvmqdVlmvpal6B8nYrmg: posts small blind $0.50
FL3MrLspcF23LYvC4ipBOA: posts big blind $1
*** HOLE CARDS ***
/zy+DB4S5fUQUSfZWFzYGw: folds
D+W9Me7w6Hcx/WRUSKV0dw: folds
r27C1nIV4NS4+qbnrgBQSw: raises $3 to $4
jDwhY1kCdc6EkAHbT7PJMQ: folds
UWB3oeddt/GObx2Mix2Anw: calls $4
5BRGWf+R3nt2WS3b5xX+zA: folds
gUUvmqdVlmvpal6B8nYrmg: folds
FL3MrLspcF23LYvC4ipBOA: folds
*** FLOP *** [Th 3c Qd]
r27C1nIV4NS4+qbnrgBQSw: bets $7
UWB3oeddt/GObx2Mix2Anw: calls $7
*** TURN *** [Th 3c Qd] [8h]
r27C1nIV4NS4+qbnrgBQSw: checks
UWB3oeddt/GObx2Mix2Anw: checks
*** RIVER *** [Th 3c Qd 8h] [5d]
r27C1nIV4NS4+qbnrgBQSw: bets $12
UWB3oeddt/GObx2Mix2Anw: calls $12
W8P9bUKCs43TO1xHm0dL6w has returned
*** SHOW DOWN ***
r27C1nIV4NS4+qbnrgBQSw: shows [Jc Jh] (a pair of Jacks)
UWB3oeddt/GObx2Mix2Anw: mucks hand
r27C1nIV4NS4+qbnrgBQSw collected $45.20 from pot
*** SUMMARY ***
Total pot $47.50 | Rake $2.30
Board [Th 3c Qd 8h 5d]
Seat 1: D+W9Me7w6Hcx/WRUSKV0dw folded before Flop (didn't bet)
Seat 2: r27C1nIV4NS4+qbnrgBQSw showed [Jc Jh] and won ($45.20) with a pair of Jacks
Seat 3: jDwhY1kCdc6EkAHbT7PJMQ folded before Flop (didn't bet)
Seat 4: UWB3oeddt/GObx2Mix2Anw mucked
Seat 5: 5BRGWf+R3nt2WS3b5xX+zA (button) folded before Flop (didn't bet)
Seat 6: gUUvmqdVlmvpal6B8nYrmg (small blind) folded before Flop
Seat 7: FL3MrLspcF23LYvC4ipBOA (big blind) folded before Flop
Seat 8: /zy+DB4S5fUQUSfZWFzYGw folded before Flop (didn't bet)



PokerStars Game #59940237352:  Hold'em No Limit ($0.50/$1.00) - 2009/07/01 1:01:00 ET
Table 'O96CPOtvMBWP6kzuYDfdFA' 6-max Seat #6 is the button
Seat 1: 6alLXQIITA2EZ/lBeym8Dw ($120.05 in chips)
Seat 2: yynBOXUjw28V5kz84sxX4g ($12.90 in chips)
Seat 3: V89DGjxE171oPREEbAXiyg ($80.75 in chips)
Seat 4: /P4w1pHg2zHYg/4ubJ0dPw ($60 in chips)
Seat 5: G5ZSSN6RSON3gkNvk/SmYg ($100 in chips)
Seat 6: GYei5jXGWexiJYbAT2fELg ($26.35 in chips)
6alLXQIITA2EZ/lBeym8Dw: posts small blind $0.50
yynBOXUjw28V5kz84sxX4g: posts big blind $1
*** HOLE CARDS ***
V89DGjxE171oPREEbAXiyg: calls $1
/P4w1pHg2zHYg/4ubJ0dPw: folds
G5ZSSN6RSON3gkNvk/SmYg: folds
GYei5jXGWexiJYbAT2fELg: calls $1
6alLXQIITA2EZ/lBeym8Dw: folds
yynBOXUjw28V5kz84sxX4g: checks
*** FLOP *** [Qc 8h 6c]
yynBOXUjw28V5kz84sxX4g: checks
V89DGjxE171oPREEbAXiyg: bets $5
GYei5jXGWexiJYbAT2fELg: folds
yynBOXUjw28V5kz84sxX4g: folds
V89DGjxE171oPREEbAXiyg collected $3.35 from pot
*** SUMMARY ***
Total pot $3.50 | Rake $0.15
Board [Qc 8h 6c]
Seat 1: 6alLXQIITA2EZ/lBeym8Dw (small blind) folded before Flop
Seat 2: yynBOXUjw28V5kz84sxX4g (big blind) folded on the Flop
Seat 3: V89DGjxE171oPREEbAXiyg collected ($3.35)
Seat 4: /P4w1pHg2zHYg/4ubJ0dPw folded before Flop (didn't bet)
Seat 5: G5ZSSN6RSON3gkNvk/SmYg folded before Flop (didn't bet)
Seat 6: GYei5jXGWexiJYbAT2fELg (button) folded on the Flop



PokerStars Game #59940238456:  Hold'em No Limit ($0.50/$1.00) - 2009/07/01 1:01:02 ET
Table 'JTT1XWaDZHSaMZQK7cR5uw' 2-max Seat #1 is the button
Seat 1: OLplZF6FEnLflv81Hz+Fxg ($118 in chips)
Seat 2: BcqgegiOUxmBD3F3umsljg ($92.85 in chips)
OLplZF6FEnLflv81Hz+Fxg: posts small blind $0.50
BcqgegiOUxmBD3F3umsljg: posts big blind $1
*** HOLE CARDS ***
OLplZF6FEnLflv81Hz+Fxg: folds
BcqgegiOUxmBD3F3umsljg collected $1 from pot
BcqgegiOUxmBD3F3umsljg: doesn't show hand
*** SUMMARY ***
Total pot $1 | Rake $0
Seat 1: OLplZF6FEnLflv81Hz+Fxg (button) (small blind) folded before Flop
Seat 2: BcqgegiOUxmBD3F3umsljg (big blind) collected ($1)



PokerStars Game #59940238988:  Hold'em No Limit ($0.50/$1.00) - 2009/07/01 1:01:03 ET
Table '/RZcOwpZpHQ+OwPwjsbnRw' 6-max Seat #1 is the button
Seat 1: Zboa6dColKGHBjLPUakZjw ($72.65 in chips)
Seat 2: +xW7QemQU0Fxs+4TnqBRow ($230.15 in chips)
Seat 3: XnT1yK2DD/5FL+0bwuEhqg ($53.30 in chips)
Seat 4: j7NIOHLZk7V2o9fOioO5ug ($103.20 in chips)
Seat 5: wx3sQGkVi2x9wJXuWNHPBw ($177.65 in chips)
Seat 6: 2d/PU00mMdO9azAaXqcSbw ($26 in chips)
+xW7QemQU0Fxs+4TnqBRow: posts small blind $0.50
XnT1yK2DD/5FL+0bwuEhqg: posts big blind $1
2d/PU00mMdO9azAaXqcSbw: posts big blind $1
*** HOLE CARDS ***
j7NIOHLZk7V2o9fOioO5ug: folds
wx3sQGkVi2x9wJXuWNHPBw: folds
2d/PU00mMdO9azAaXqcSbw: checks
Zboa6dColKGHBjLPUakZjw: raises $1 to $2
+xW7QemQU0Fxs+4TnqBRow: calls $1.50
XnT1yK2DD/5FL+0bwuEhqg: calls $1
2d/PU00mMdO9azAaXqcSbw: calls $1
*** FLOP *** [Qd 5s 2s]
+xW7QemQU0Fxs+4TnqBRow: checks
XnT1yK2DD/5FL+0bwuEhqg: checks
2d/PU00mMdO9azAaXqcSbw: checks
Zboa6dColKGHBjLPUakZjw: bets $3
+xW7QemQU0Fxs+4TnqBRow: calls $3
XnT1yK2DD/5FL+0bwuEhqg: calls $3
2d/PU00mMdO9azAaXqcSbw: calls $3
*** TURN *** [Qd 5s 2s] [Ah]
+xW7QemQU0Fxs+4TnqBRow: checks
XnT1yK2DD/5FL+0bwuEhqg: checks
2d/PU00mMdO9azAaXqcSbw: checks
Zboa6dColKGHBjLPUakZjw: bets $5
+xW7QemQU0Fxs+4TnqBRow: folds
XnT1yK2DD/5FL+0bwuEhqg: folds
2d/PU00mMdO9azAaXqcSbw: calls $5
*** RIVER *** [Qd 5s 2s Ah] [Kd]
2d/PU00mMdO9azAaXqcSbw: checks
Zboa6dColKGHBjLPUakZjw: bets $10
2d/PU00mMdO9azAaXqcSbw: calls $10
*** SHOW DOWN ***
Zboa6dColKGHBjLPUakZjw: shows [9h As] (a pair of Aces)
2d/PU00mMdO9azAaXqcSbw: mucks hand
Zboa6dColKGHBjLPUakZjw collected $47.60 from pot
*** SUMMARY ***
Total pot $50 | Rake $2.40
Board [Qd 5s 2s Ah Kd]
Seat 1: Zboa6dColKGHBjLPUakZjw (button) showed [9h As] and won ($47.60) with a pair of Aces
Seat 2: +xW7QemQU0Fxs+4TnqBRow (small blind) folded on the Turn
Seat 3: XnT1yK2DD/5FL+0bwuEhqg (big blind) folded on the Turn
Seat 4: j7NIOHLZk7V2o9fOioO5ug folded before Flop (didn't bet)
Seat 5: wx3sQGkVi2x9wJXuWNHPBw folded before Flop (didn't bet)
Seat 6: 2d/PU00mMdO9azAaXqcSbw mucked



PokerStars Game #59940239056:  Hold'em No Limit ($0.50/$1.00) - 2009/07/01 1:01:03 ET
Table '7Nl0ffnjeK44/vmeexh3MQ' 9-max Seat #8 is the button
Seat 1: s7D3Y+k4Cj4D1cXHv7oj+Q ($96.35 in chips)
Seat 2: OGgaARGdJQT4awWVNQ957w ($101.50 in chips)
Seat 3: vR4IO10geOgvTW+LAUBv/A ($100 in chips)
Seat 4: bLbSOSmSOnqE0iTcH/5dxA ($113.50 in chips)
Seat 6: FVs16t7GgfWgQWt4JxsObQ ($24.75 in chips)
Seat 7: 997ViqAtWn1FPjJqcffwcA ($100 in chips)
Seat 8: D+W9Me7w6Hcx/WRUSKV0dw ($19.75 in chips)
Seat 9: ouwUBGRKnKK9uhn1G4Lf+A ($196 in chips)
ouwUBGRKnKK9uhn1G4Lf+A: posts small blind $0.50
s7D3Y+k4Cj4D1cXHv7oj+Q: posts big blind $1
61sfw5QTu62YYIt68OsdrA: sits out
*** HOLE CARDS ***
OGgaARGdJQT4awWVNQ957w: folds
vR4IO10geOgvTW+LAUBv/A: folds
bLbSOSmSOnqE0iTcH/5dxA: raises $3 to $4
FVs16t7GgfWgQWt4JxsObQ: raises $3 to $7
997ViqAtWn1FPjJqcffwcA: folds
D+W9Me7w6Hcx/WRUSKV0dw: folds
ouwUBGRKnKK9uhn1G4Lf+A: folds
s7D3Y+k4Cj4D1cXHv7oj+Q: folds
bLbSOSmSOnqE0iTcH/5dxA: raises $106.50 to $113.50 and is all-in
FVs16t7GgfWgQWt4JxsObQ: calls $17.75 and is all-in
*** FLOP *** [Tc Kd Qc]
*** TURN *** [Tc Kd Qc] [9d]
*** RIVER *** [Tc Kd Qc 9d] [Ac]
*** SHOW DOWN ***
bLbSOSmSOnqE0iTcH/5dxA: shows [Qd Ad] (two pair, Aces and Queens)
FVs16t7GgfWgQWt4JxsObQ: shows [Jh Jd] (a straight, Ten to Ace)
FVs16t7GgfWgQWt4JxsObQ collected $48.45 from pot
*** SUMMARY ***
Total pot $51 | Rake $2.55
Board [Tc Kd Qc 9d Ac]
Seat 1: s7D3Y+k4Cj4D1cXHv7oj+Q (big blind) folded before Flop
Seat 2: OGgaARGdJQT4awWVNQ957w folded before Flop (didn't bet)
Seat 3: vR4IO10geOgvTW+LAUBv/A folded before Flop (didn't bet)
Seat 4: bLbSOSmSOnqE0iTcH/5dxA showed [Qd Ad] and lost with two pair, Aces and Queens
Seat 6: FVs16t7GgfWgQWt4JxsObQ showed [Jh Jd] and won ($48.45) with a straight, Ten to Ace
Seat 7: 997ViqAtWn1FPjJqcffwcA folded before Flop (didn't bet)
Seat 8: D+W9Me7w6Hcx/WRUSKV0dw (button) folded before Flop (didn't bet)
Seat 9: ouwUBGRKnKK9uhn1G4Lf+A (small blind) folded before Flop



PokerStars Game #59940240584:  Hold'em No Limit ($0.50/$1.00) - 2009/07/01 1:01:05 ET
Table 'GPp0HyAuggN8oE0sUWzPpA' 9-max Seat #5 is the button
Seat 1: qJr25HAtvv1w/7IBvjMM3g ($27.50 in chips)
Seat 2: m3U8I35Pn3gxKhoS2nmYIg ($54.70 in chips)
Seat 3: CCCXsirC+bO7ginAuUUVlQ ($69.70 in chips)
Seat 4: mBRWbnUl8diyBO1qTJaNzw ($107.30 in chips)
Seat 5: 0fXz44fzDo5QmhAaJCvFfA ($14.15 in chips)
Seat 6: BK/GtNPkSx0TdUDj82id5A ($18.35 in chips)
Seat 7: DHdbHyysD15wCAtx+BhUjA ($94.50 in chips)
Seat 9: VPF+HjszMvUIpy0CHIwH3A ($27.50 in chips)
BK/GtNPkSx0TdUDj82id5A: posts small blind $0.50
DHdbHyysD15wCAtx+BhUjA: posts big blind $1
John86sand: sits out
*** HOLE CARDS ***
VPF+HjszMvUIpy0CHIwH3A: folds
qJr25HAtvv1w/7IBvjMM3g: calls $1
m3U8I35Pn3gxKhoS2nmYIg: folds
CCCXsirC+bO7ginAuUUVlQ: raises $2 to $3
mBRWbnUl8diyBO1qTJaNzw: folds
0fXz44fzDo5QmhAaJCvFfA: folds
BK/GtNPkSx0TdUDj82id5A: folds
DHdbHyysD15wCAtx+BhUjA: folds
qJr25HAtvv1w/7IBvjMM3g: calls $2
*** FLOP *** [8d Kd 7d]
qJr25HAtvv1w/7IBvjMM3g: checks
CCCXsirC+bO7ginAuUUVlQ: bets $5
qJr25HAtvv1w/7IBvjMM3g: calls $5
*** TURN *** [8d Kd 7d] [Ac]
qJr25HAtvv1w/7IBvjMM3g: checks
CCCXsirC+bO7ginAuUUVlQ: bets $10
qJr25HAtvv1w/7IBvjMM3g: raises $9.50 to $19.50 and is all-in
CCCXsirC+bO7ginAuUUVlQ: folds
qJr25HAtvv1w/7IBvjMM3g collected $35.70 from pot
*** SUMMARY ***
Total pot $37.50 | Rake $1.80
Board [8d Kd 7d Ac]
Seat 1: qJr25HAtvv1w/7IBvjMM3g collected ($35.70)
Seat 2: m3U8I35Pn3gxKhoS2nmYIg folded before Flop (didn't bet)
Seat 3: CCCXsirC+bO7ginAuUUVlQ folded on the Turn
Seat 4: mBRWbnUl8diyBO1qTJaNzw folded before Flop (didn't bet)
Seat 5: 0fXz44fzDo5QmhAaJCvFfA (button) folded before Flop (didn't bet)
Seat 6: BK/GtNPkSx0TdUDj82id5A (small blind) folded before Flop
Seat 7: DHdbHyysD15wCAtx+BhUjA (big blind) folded before Flop
Seat 9: VPF+HjszMvUIpy0CHIwH3A folded before Flop (didn't bet)



PokerStars Game #59940240546:  Hold'em No Limit ($0.50/$1.00) - 2009/07/01 1:01:05 ET
Table 'tJq9SfN1ywY0r03VBlWlwQ' 9-max Seat #3 is the button
Seat 1: wZsU+w9r7G66x93UuvBf1Q ($340.80 in chips)
Seat 2: RqkO8O/Y3qlc3PIuCAHjVg ($75.20 in chips)
Seat 3: FVs16t7GgfWgQWt4JxsObQ ($37.90 in chips)
Seat 4: bLbSOSmSOnqE0iTcH/5dxA ($109.20 in chips)
Seat 6: gUUvmqdVlmvpal6B8nYrmg ($116.05 in chips)
Seat 7: qVhRZ0PLZ95XRJHWAjXjOQ ($129.90 in chips)
Seat 8: G4DEhsZFmznGNVpy2SEocA ($22 in chips)
Seat 9: XE5QF1y74bpHog9JxWJMWQ ($102 in chips)
bLbSOSmSOnqE0iTcH/5dxA: posts small blind $0.50
Ogn4JDV3mp4ZDKO49IFzKA: is sitting out
gUUvmqdVlmvpal6B8nYrmg: posts big blind $1
*** HOLE CARDS ***
Ogn4JDV3mp4ZDKO49IFzKA leaves the table
qVhRZ0PLZ95XRJHWAjXjOQ: calls $1
G4DEhsZFmznGNVpy2SEocA: folds
XE5QF1y74bpHog9JxWJMWQ: folds
wZsU+w9r7G66x93UuvBf1Q: folds
RqkO8O/Y3qlc3PIuCAHjVg: folds
FVs16t7GgfWgQWt4JxsObQ: calls $1
bLbSOSmSOnqE0iTcH/5dxA: folds
gUUvmqdVlmvpal6B8nYrmg: checks
*** FLOP *** [3s Ac Ah]
gUUvmqdVlmvpal6B8nYrmg: checks
qVhRZ0PLZ95XRJHWAjXjOQ: bets $2
FVs16t7GgfWgQWt4JxsObQ: folds
gUUvmqdVlmvpal6B8nYrmg: folds
Sylvester74 joins the table at seat #5
qVhRZ0PLZ95XRJHWAjXjOQ collected $3.35 from pot
*** SUMMARY ***
Total pot $3.50 | Rake $0.15
Board [3s Ac Ah]
Seat 1: wZsU+w9r7G66x93UuvBf1Q folded before Flop (didn't bet)
Seat 2: RqkO8O/Y3qlc3PIuCAHjVg folded before Flop (didn't bet)
Seat 3: FVs16t7GgfWgQWt4JxsObQ (button) folded on the Flop
Seat 4: bLbSOSmSOnqE0iTcH/5dxA (small blind) folded before Flop
Seat 6: gUUvmqdVlmvpal6B8nYrmg (big blind) folded on the Flop
Seat 7: qVhRZ0PLZ95XRJHWAjXjOQ collected ($3.35)
Seat 8: G4DEhsZFmznGNVpy2SEocA folded before Flop (didn't bet)
Seat 9: XE5QF1y74bpHog9JxWJMWQ folded before Flop (didn't bet)



PokerStars Game #59940240508:  Hold'em No Limit ($0.50/$1.00) - 2009/07/01 1:01:05 ET
Table 'VOs36P6NW+QyXeQ1B62kmA' 6-max Seat #4 is the button
Seat 2: 2UMlbaZ8n8AbRli0Yr0mDw ($28.85 in chips)
Seat 3: TSuRyAHnUPCFjP7Z0rEE0w ($106.40 in chips)
Seat 4: w02zQzNydODiyV9THKgo9w ($43.35 in chips)
Seat 5: ozrlafxxh1HmYdA0/h+MuA ($32.85 in chips)
Seat 6: slVKuQyEz8Qj4E3uLPYNXg ($98.50 in chips)
ozrlafxxh1HmYdA0/h+MuA: posts small blind $0.50
slVKuQyEz8Qj4E3uLPYNXg: posts big blind $1
Z2fXsGcjl+Eax+RzOgwOmg: sits out
*** HOLE CARDS ***
2UMlbaZ8n8AbRli0Yr0mDw has timed out
2UMlbaZ8n8AbRli0Yr0mDw: folds
2UMlbaZ8n8AbRli0Yr0mDw is sitting out
TSuRyAHnUPCFjP7Z0rEE0w: folds
w02zQzNydODiyV9THKgo9w: calls $1
ozrlafxxh1HmYdA0/h+MuA: calls $0.50
slVKuQyEz8Qj4E3uLPYNXg: checks
*** FLOP *** [3h 2c 9s]
2UMlbaZ8n8AbRli0Yr0mDw has returned
ozrlafxxh1HmYdA0/h+MuA: checks
slVKuQyEz8Qj4E3uLPYNXg: checks
w02zQzNydODiyV9THKgo9w: checks
*** TURN *** [3h 2c 9s] [6c]
ozrlafxxh1HmYdA0/h+MuA: checks
slVKuQyEz8Qj4E3uLPYNXg: checks
w02zQzNydODiyV9THKgo9w: checks
*** RIVER *** [3h 2c 9s 6c] [6d]
ozrlafxxh1HmYdA0/h+MuA: checks
slVKuQyEz8Qj4E3uLPYNXg: checks
w02zQzNydODiyV9THKgo9w: checks
*** SHOW DOWN ***
ozrlafxxh1HmYdA0/h+MuA: shows [Qc 8c] (a pair of Sixes)
slVKuQyEz8Qj4E3uLPYNXg: mucks hand
w02zQzNydODiyV9THKgo9w: shows [Th Kd] (a pair of Sixes - King kicker)
w02zQzNydODiyV9THKgo9w collected $2.85 from pot
*** SUMMARY ***
Total pot $3 | Rake $0.15
Board [3h 2c 9s 6c 6d]
Seat 2: 2UMlbaZ8n8AbRli0Yr0mDw folded before Flop (didn't bet)
Seat 3: TSuRyAHnUPCFjP7Z0rEE0w folded before Flop (didn't bet)
Seat 4: w02zQzNydODiyV9THKgo9w (button) showed [Th Kd] and won ($2.85) with a pair of Sixes
Seat 5: ozrlafxxh1HmYdA0/h+MuA (small blind) showed [Qc 8c] and lost with a pair of Sixes
Seat 6: slVKuQyEz8Qj4E3uLPYNXg (big blind) mucked



PokerStars Game #59940241622:  Hold'em No Limit ($0.50/$1.00) - 2009/07/01 1:01:07 ET
Table '+cA8mcmhaedZ7YcrDdhmeQ' 6-max Seat #2 is the button
Seat 1: lsLuWlcPA3Rh7kJVLzMh0Q ($296.50 in chips)
Seat 2: RqgF7gRoKgRNW8Zoi1ty4A ($110.55 in chips)
Seat 3: 7H5WkGzGvsv56y1iaqHvRg ($26.70 in chips)
Seat 4: 4OO5v3AVduL0tePNx8wk5A ($102.50 in chips)
Seat 5: +7hFKAL0b0O/n8G72TclJA ($66.35 in chips)
Seat 6: YfsTQsY/fxb+YqbdclTHuw ($24.45 in chips)
7H5WkGzGvsv56y1iaqHvRg: posts small blind $0.50
4OO5v3AVduL0tePNx8wk5A: posts big blind $1
*** HOLE CARDS ***
+7hFKAL0b0O/n8G72TclJA: folds
YfsTQsY/fxb+YqbdclTHuw: calls $1
lsLuWlcPA3Rh7kJVLzMh0Q: raises $4 to $5
RqgF7gRoKgRNW8Zoi1ty4A: folds
7H5WkGzGvsv56y1iaqHvRg: folds
4OO5v3AVduL0tePNx8wk5A: folds
YfsTQsY/fxb+YqbdclTHuw: calls $4
*** FLOP *** [3c 6h 8c]
YfsTQsY/fxb+YqbdclTHuw: checks
lsLuWlcPA3Rh7kJVLzMh0Q: checks
*** TURN *** [3c 6h 8c] [Ad]
YfsTQsY/fxb+YqbdclTHuw: checks
lsLuWlcPA3Rh7kJVLzMh0Q: bets $6
YfsTQsY/fxb+YqbdclTHuw: folds
lsLuWlcPA3Rh7kJVLzMh0Q collected $10.95 from pot
*** SUMMARY ***
Total pot $11.50 | Rake $0.55
Board [3c 6h 8c Ad]
Seat 1: lsLuWlcPA3Rh7kJVLzMh0Q collected ($10.95)
Seat 2: RqgF7gRoKgRNW8Zoi1ty4A (button) folded before Flop (didn't bet)
Seat 3: 7H5WkGzGvsv56y1iaqHvRg (small blind) folded before Flop
Seat 4: 4OO5v3AVduL0tePNx8wk5A (big blind) folded before Flop
Seat 5: +7hFKAL0b0O/n8G72TclJA folded before Flop (didn't bet)
Seat 6: YfsTQsY/fxb+YqbdclTHuw folded on the Turn



PokerStars Game #59940242226:  Hold'em No Limit ($0.50/$1.00) - 2009/07/01 1:01:08 ET
Table 'JTT1XWaDZHSaMZQK7cR5uw' 2-max Seat #2 is the button
Seat 1: OLplZF6FEnLflv81Hz+Fxg ($117.50 in chips)
Seat 2: BcqgegiOUxmBD3F3umsljg ($93.35 in chips)
BcqgegiOUxmBD3F3umsljg: posts small blind $0.50
OLplZF6FEnLflv81Hz+Fxg: posts big blind $1
*** HOLE CARDS ***
BcqgegiOUxmBD3F3umsljg: raises $1 to $2
OLplZF6FEnLflv81Hz+Fxg: calls $1
*** FLOP *** [Ac 7d Td]
OLplZF6FEnLflv81Hz+Fxg: bets $3
BcqgegiOUxmBD3F3umsljg: calls $3
*** TURN *** [Ac 7d Td] [8h]
OLplZF6FEnLflv81Hz+Fxg: checks
BcqgegiOUxmBD3F3umsljg: checks
*** RIVER *** [Ac 7d Td 8h] [Ad]
OLplZF6FEnLflv81Hz+Fxg: bets $6
BcqgegiOUxmBD3F3umsljg: folds
OLplZF6FEnLflv81Hz+Fxg collected $9.55 from pot
*** SUMMARY ***
Total pot $10 | Rake $0.45
Board [Ac 7d Td 8h Ad]
Seat 1: OLplZF6FEnLflv81Hz+Fxg (big blind) collected ($9.55)
Seat 2: BcqgegiOUxmBD3F3umsljg (button) (small blind) folded on the River



PokerStars Game #59940242086:  Hold'em No Limit ($0.50/$1.00) - 2009/07/01 1:01:08 ET
Table 'uNlePsyMIqzM691Xkrlk6Q' 9-max Seat #2 is the button
Seat 1: bLbSOSmSOnqE0iTcH/5dxA ($100 in chips)
Seat 2: +OqpStnt0FqbCfyHAWaLbg ($96.65 in chips)
Seat 3: h7qXkU57Bb8ZuPwMyxR8Ug ($14.15 in chips)
Seat 5: 3obndzTJ6fECz8+wWhMd1w ($17 in chips)
Seat 6: myIxN7otsyr846M539YR8Q ($21.50 in chips)
Seat 7: w6cw9nzN7AvkkHBVVjykoQ ($54.25 in chips)
Seat 8: laA8va+Yv8WuMqT1zdR91g ($109.20 in chips)
h7qXkU57Bb8ZuPwMyxR8Ug: posts small blind $0.50
TZcz9MEWDA+WydgGruqqbw: is sitting out
3obndzTJ6fECz8+wWhMd1w: posts big blind $1
VPF+HjszMvUIpy0CHIwH3A: sits out
*** HOLE CARDS ***
TZcz9MEWDA+WydgGruqqbw leaves the table
myIxN7otsyr846M539YR8Q: folds
w6cw9nzN7AvkkHBVVjykoQ: raises $3 to $4
D+W9Me7w6Hcx/WRUSKV0dw joins the table at seat #4
laA8va+Yv8WuMqT1zdR91g: folds
bLbSOSmSOnqE0iTcH/5dxA: folds
+OqpStnt0FqbCfyHAWaLbg: folds
h7qXkU57Bb8ZuPwMyxR8Ug: folds
3obndzTJ6fECz8+wWhMd1w: folds
w6cw9nzN7AvkkHBVVjykoQ collected $2.50 from pot
*** SUMMARY ***
Total pot $2.50 | Rake $0
Seat 1: bLbSOSmSOnqE0iTcH/5dxA folded before Flop (didn't bet)
Seat 2: +OqpStnt0FqbCfyHAWaLbg (button) folded before Flop (didn't bet)
Seat 3: h7qXkU57Bb8ZuPwMyxR8Ug (small blind) folded before Flop
Seat 5: 3obndzTJ6fECz8+wWhMd1w (big blind) folded before Flop
Seat 6: myIxN7otsyr846M539YR8Q folded before Flop (didn't bet)
Seat 7: w6cw9nzN7AvkkHBVVjykoQ collected ($2.50)
Seat 8: laA8va+Yv8WuMqT1zdR91g folded before Flop (didn't bet)



PokerStars Game #59940242968:  Hold'em No Limit ($0.50/$1.00) - 2009/07/01 1:01:09 ET
Table 'GxCPo/gd3OSthkYrAxJngg' 6-max Seat #3 is the button
Seat 1: sH8BpAFP+jGFxCgVpD1Lew ($272.40 in chips)
Seat 2: YExX2paeIHrmfIwV1ivM/w ($77.70 in chips)
Seat 3: o6plE+MSW4XFNTeONe16xg ($23.60 in chips)
Seat 4: YMJG+F++3Aj6P8dAWda5fw ($202.10 in chips)
Seat 5: G5ZSSN6RSON3gkNvk/SmYg ($105.25 in chips)
YMJG+F++3Aj6P8dAWda5fw: posts small blind $0.50
G5ZSSN6RSON3gkNvk/SmYg: posts big blind $1
*** HOLE CARDS ***
sH8BpAFP+jGFxCgVpD1Lew: folds
YExX2paeIHrmfIwV1ivM/w: folds
o6plE+MSW4XFNTeONe16xg: folds
YMJG+F++3Aj6P8dAWda5fw: raises $2 to $3
G5ZSSN6RSON3gkNvk/SmYg: folds
YMJG+F++3Aj6P8dAWda5fw collected $2 from pot
*** SUMMARY ***
Total pot $2 | Rake $0
Seat 1: sH8BpAFP+jGFxCgVpD1Lew folded before Flop (didn't bet)
Seat 2: YExX2paeIHrmfIwV1ivM/w folded before Flop (didn't bet)
Seat 3: o6plE+MSW4XFNTeONe16xg (button) folded before Flop (didn't bet)
Seat 4: YMJG+F++3Aj6P8dAWda5fw (small blind) collected ($2)
Seat 5: G5ZSSN6RSON3gkNvk/SmYg (big blind) folded before Flop



PokerStars Game #59940243794:  Hold'em No Limit ($0.50/$1.00) - 2009/07/01 1:01:10 ET
Table 'MUPc8FEpe/nR0BKSeReX6Q' 6-max Seat #6 is the button
Seat 1: qhkK6+yCciTRd+rCFEbnEQ ($39 in chips)
Seat 2: xAU6q2/cwmby2sxmA8VcmA ($122.70 in chips)
Seat 3: wx3sQGkVi2x9wJXuWNHPBw ($236.40 in chips)
Seat 4: ZA1bp6g8IwtTxkUE4eCjDQ ($196.80 in chips)
Seat 5: UBZQqpnJZdTYYY1FTb0rLA ($102.05 in chips)
Seat 6: oxnw0GLLpFanjhGkxfRSqA ($23.70 in chips)
qhkK6+yCciTRd+rCFEbnEQ: posts small blind $0.50
xAU6q2/cwmby2sxmA8VcmA: posts big blind $1
*** HOLE CARDS ***
wx3sQGkVi2x9wJXuWNHPBw: folds
ZA1bp6g8IwtTxkUE4eCjDQ: folds
UBZQqpnJZdTYYY1FTb0rLA: folds
oxnw0GLLpFanjhGkxfRSqA: folds
qhkK6+yCciTRd+rCFEbnEQ: raises $2 to $3
xAU6q2/cwmby2sxmA8VcmA: folds
qhkK6+yCciTRd+rCFEbnEQ collected $2 from pot
qhkK6+yCciTRd+rCFEbnEQ: doesn't show hand
*** SUMMARY ***
Total pot $2 | Rake $0
Seat 1: qhkK6+yCciTRd+rCFEbnEQ (small blind) collected ($2)
Seat 2: xAU6q2/cwmby2sxmA8VcmA (big blind) folded before Flop
Seat 3: wx3sQGkVi2x9wJXuWNHPBw folded before Flop (didn't bet)
Seat 4: ZA1bp6g8IwtTxkUE4eCjDQ folded before Flop (didn't bet)
Seat 5: UBZQqpnJZdTYYY1FTb0rLA folded before Flop (didn't bet)
Seat 6: oxnw0GLLpFanjhGkxfRSqA (button) folded before Flop (didn't bet)



PokerStars Game #59940245744:  Hold'em No Limit ($0.50/$1.00) - 2009/07/01 1:01:14 ET
Table '8jIjWCPY0NGprquL+xcMFg' 9-max Seat #3 is the button
Seat 1: N7iZ0peZns5o4A6AjN24jQ ($45.60 in chips)
Seat 2: laA8va+Yv8WuMqT1zdR91g ($108.70 in chips)
Seat 3: tjhwe1V98x2spSoUQER3HQ ($103 in chips)
Seat 4: Jjc7EHWzs4//xUAjJ0UWoA ($17.90 in chips)
Seat 5: 2YpnxJiexJHyERfbqgwEcw ($55.05 in chips)
Seat 6: GTQkFJtSkbVbnGCktp6e3g ($101.35 in chips)
Seat 7: O3CGPwwUmamrCNHccOilrg ($41.45 in chips)
Seat 8: D+W9Me7w6Hcx/WRUSKV0dw ($18.50 in chips)
Seat 9: negfosHnGOZXSHpWDRKyBQ ($56.15 in chips)
Jjc7EHWzs4//xUAjJ0UWoA: posts small blind $0.50
2YpnxJiexJHyERfbqgwEcw: posts big blind $1
*** HOLE CARDS ***
GTQkFJtSkbVbnGCktp6e3g: folds
O3CGPwwUmamrCNHccOilrg: folds
D+W9Me7w6Hcx/WRUSKV0dw: folds
negfosHnGOZXSHpWDRKyBQ: raises $2 to $3
N7iZ0peZns5o4A6AjN24jQ: folds
laA8va+Yv8WuMqT1zdR91g: folds
tjhwe1V98x2spSoUQER3HQ: folds
Jjc7EHWzs4//xUAjJ0UWoA: folds
2YpnxJiexJHyERfbqgwEcw: folds
negfosHnGOZXSHpWDRKyBQ collected $2.50 from pot
negfosHnGOZXSHpWDRKyBQ: doesn't show hand
*** SUMMARY ***
Total pot $2.50 | Rake $0
Seat 1: N7iZ0peZns5o4A6AjN24jQ folded before Flop (didn't bet)
Seat 2: laA8va+Yv8WuMqT1zdR91g folded before Flop (didn't bet)
Seat 3: tjhwe1V98x2spSoUQER3HQ (button) folded before Flop (didn't bet)
Seat 4: Jjc7EHWzs4//xUAjJ0UWoA (small blind) folded before Flop
Seat 5: 2YpnxJiexJHyERfbqgwEcw (big blind) folded before Flop
Seat 6: GTQkFJtSkbVbnGCktp6e3g folded before Flop (didn't bet)
Seat 7: O3CGPwwUmamrCNHccOilrg folded before Flop (didn't bet)
Seat 8: D+W9Me7w6Hcx/WRUSKV0dw folded before Flop (didn't bet)
Seat 9: negfosHnGOZXSHpWDRKyBQ collected ($2.50)



PokerStars Game #59940246934:  Hold'em No Limit ($0.50/$1.00) - 2009/07/01 1:01:16 ET
Table 'mmbQQVBTrPdE+wy+s+9VPA' 6-max Seat #2 is the button
Seat 1: zyP4SPoWZnKUfTvIRLCVog ($53.50 in chips)
Seat 2: cl/QpVR/PLO58lj+C5mGLw ($22.70 in chips)
Seat 3: wx3sQGkVi2x9wJXuWNHPBw ($112.65 in chips)
Seat 4: V3iZdcw61nXF3g5hD2RrsQ ($100 in chips)
Seat 5: YMJG+F++3Aj6P8dAWda5fw ($100 in chips)
Seat 6: U2CWBTv29qdCbj8RNF2sIw ($108.95 in chips)
wx3sQGkVi2x9wJXuWNHPBw: posts small blind $0.50
V3iZdcw61nXF3g5hD2RrsQ: posts big blind $1
*** HOLE CARDS ***
YMJG+F++3Aj6P8dAWda5fw: folds
U2CWBTv29qdCbj8RNF2sIw: folds
zyP4SPoWZnKUfTvIRLCVog: folds
cl/QpVR/PLO58lj+C5mGLw: calls $1
wx3sQGkVi2x9wJXuWNHPBw: calls $0.50
V3iZdcw61nXF3g5hD2RrsQ: checks
*** FLOP *** [Kh 2d 2c]
wx3sQGkVi2x9wJXuWNHPBw: checks
V3iZdcw61nXF3g5hD2RrsQ: checks
cl/QpVR/PLO58lj+C5mGLw: bets $2
wx3sQGkVi2x9wJXuWNHPBw: folds
V3iZdcw61nXF3g5hD2RrsQ: calls $2
*** TURN *** [Kh 2d 2c] [4c]
V3iZdcw61nXF3g5hD2RrsQ: checks
cl/QpVR/PLO58lj+C5mGLw: bets $3
V3iZdcw61nXF3g5hD2RrsQ: calls $3
*** RIVER *** [Kh 2d 2c 4c] [5s]
V3iZdcw61nXF3g5hD2RrsQ: checks
cl/QpVR/PLO58lj+C5mGLw: bets $6
V3iZdcw61nXF3g5hD2RrsQ: calls $6
*** SHOW DOWN ***
cl/QpVR/PLO58lj+C5mGLw: shows [Qd Jc] (a pair of Deuces)
V3iZdcw61nXF3g5hD2RrsQ: shows [7h Kd] (two pair, Kings and Deuces)
V3iZdcw61nXF3g5hD2RrsQ collected $23.80 from pot
*** SUMMARY ***
Total pot $25 | Rake $1.20
Board [Kh 2d 2c 4c 5s]
Seat 1: zyP4SPoWZnKUfTvIRLCVog folded before Flop (didn't bet)
Seat 2: cl/QpVR/PLO58lj+C5mGLw (button) showed [Qd Jc] and lost with a pair of Deuces
Seat 3: wx3sQGkVi2x9wJXuWNHPBw (small blind) folded on the Flop
Seat 4: V3iZdcw61nXF3g5hD2RrsQ (big blind) showed [7h Kd] and won ($23.80) with two pair, Kings and Deuces
Seat 5: YMJG+F++3Aj6P8dAWda5fw folded before Flop (didn't bet)
Seat 6: U2CWBTv29qdCbj8RNF2sIw folded before Flop (didn't bet)



PokerStars Game #59940248092:  Hold'em No Limit ($0.50/$1.00) - 2009/07/01 1:01:18 ET
Table '7O9fB8yx1u7sJveJn8w6jA' 6-max Seat #4 is the button
Seat 2: wx3sQGkVi2x9wJXuWNHPBw ($195.45 in chips)
Seat 3: hpxXcmRkXXI9HE5+5/j/0Q ($101.50 in chips)
Seat 4: XIZSmlGttGgSRaIU42K4Fg ($142.90 in chips)
Seat 5: BCEV3COoKY607AzLWayfRA ($100 in chips)
Seat 6: UBZQqpnJZdTYYY1FTb0rLA ($137.95 in chips)
BCEV3COoKY607AzLWayfRA: posts small blind $0.50
UBZQqpnJZdTYYY1FTb0rLA: posts big blind $1
*** HOLE CARDS ***
wx3sQGkVi2x9wJXuWNHPBw: folds
jy52+7FotjH63o5tEEVgKw has returned
hpxXcmRkXXI9HE5+5/j/0Q: folds
XIZSmlGttGgSRaIU42K4Fg: calls $1
BCEV3COoKY607AzLWayfRA: calls $0.50
UBZQqpnJZdTYYY1FTb0rLA: checks
*** FLOP *** [Ah 9d 9c]
BCEV3COoKY607AzLWayfRA: bets $2
UBZQqpnJZdTYYY1FTb0rLA: folds
XIZSmlGttGgSRaIU42K4Fg: calls $2
*** TURN *** [Ah 9d 9c] [4h]
BCEV3COoKY607AzLWayfRA: checks
XIZSmlGttGgSRaIU42K4Fg: checks
*** RIVER *** [Ah 9d 9c 4h] [Qc]
BCEV3COoKY607AzLWayfRA: checks
XIZSmlGttGgSRaIU42K4Fg: checks
*** SHOW DOWN ***
BCEV3COoKY607AzLWayfRA: shows [4c As] (two pair, Aces and Nines)
XIZSmlGttGgSRaIU42K4Fg: mucks hand
BCEV3COoKY607AzLWayfRA collected $6.70 from pot
*** SUMMARY ***
Total pot $7 | Rake $0.30
Board [Ah 9d 9c 4h Qc]
Seat 2: wx3sQGkVi2x9wJXuWNHPBw folded before Flop (didn't bet)
Seat 3: hpxXcmRkXXI9HE5+5/j/0Q folded before Flop (didn't bet)
Seat 4: XIZSmlGttGgSRaIU42K4Fg (button) mucked
Seat 5: BCEV3COoKY607AzLWayfRA (small blind) showed [4c As] and won ($6.70) with two pair, Aces and Nines
Seat 6: UBZQqpnJZdTYYY1FTb0rLA (big blind) folded on the Flop



PokerStars Game #59940249216:  Hold'em No Limit ($0.50/$1.00) - 2009/07/01 1:01:19 ET
Table 'tyUh+jyNvrceIQdKMJjQ2wZFWj23PMihdwrNWv41OG/Qeat #6 is the button
Seat 1: o8A5MUdudVKu+pAwgZOX2w ($181.80 in chips)
Seat 2: XvUbOIg94d25feWeQlOTVg ($153 in chips)
Seat 3: TalCiLYHCd+ffkmR3auPvA ($92.10 in chips)
Seat 4: TSuRyAHnUPCFjP7Z0rEE0w ($109.75 in chips)
Seat 5: j7NIOHLZk7V2o9fOioO5ug ($111.65 in chips)
Seat 6: 4OO5v3AVduL0tePNx8wk5A ($100 in chips)
o8A5MUdudVKu+pAwgZOX2w: posts small blind $0.50
XvUbOIg94d25feWeQlOTVg: posts big blind $1
*** HOLE CARDS ***
TalCiLYHCd+ffkmR3auPvA: calls $1
TSuRyAHnUPCFjP7Z0rEE0w: raises $3 to $4
j7NIOHLZk7V2o9fOioO5ug: folds
4OO5v3AVduL0tePNx8wk5A: folds
o8A5MUdudVKu+pAwgZOX2w: calls $3.50
XvUbOIg94d25feWeQlOTVg: folds
TalCiLYHCd+ffkmR3auPvA: calls $3
*** FLOP *** [Ts 5s 8h]
o8A5MUdudVKu+pAwgZOX2w: bets $6
TalCiLYHCd+ffkmR3auPvA: folds
TSuRyAHnUPCFjP7Z0rEE0w: raises $14.50 to $20.50
o8A5MUdudVKu+pAwgZOX2w: calls $14.50
*** TURN *** [Ts 5s 8h] [7h]
o8A5MUdudVKu+pAwgZOX2w: checks
TSuRyAHnUPCFjP7Z0rEE0w: bets $40
o8A5MUdudVKu+pAwgZOX2w: raises $46 to $86
TSuRyAHnUPCFjP7Z0rEE0w: calls $45.25 and is all-in
*** RIVER *** [Ts 5s 8h 7h] [Ad]
*** SHOW DOWN ***
o8A5MUdudVKu+pAwgZOX2w: shows [Ah 8d] (two pair, Aces and Eights)
TSuRyAHnUPCFjP7Z0rEE0w: shows [Jd 9d] (a straight, Seven to Jack)
TSuRyAHnUPCFjP7Z0rEE0w collected $221.50 from pot
*** SUMMARY ***
Total pot $224.50 | Rake $3
Board [Ts 5s 8h 7h Ad]
Seat 1: o8A5MUdudVKu+pAwgZOX2w (small blind) showed [Ah 8d] and lost with two pair, Aces and Eights
Seat 2: XvUbOIg94d25feWeQlOTVg (big blind) folded before Flop
Seat 3: TalCiLYHCd+ffkmR3auPvA folded on the Flop
Seat 4: TSuRyAHnUPCFjP7Z0rEE0w showed [Jd 9d] and won ($221.50) with a straight, Seven to Jack
Seat 5: j7NIOHLZk7V2o9fOioO5ug folded before Flop (didn't bet)
Seat 6: 4OO5v3AVduL0tePNx8wk5A (button) folded before Flop (didn't bet)



PokerStars Game #59940249810:  Hold'em No Limit ($0.50/$1.00) - 2009/07/01 1:01:20 ET
Table 'fTlPiCj0utgzC/5io+I7ew' 6-max Seat #1 is the button
Seat 1: YMJG+F++3Aj6P8dAWda5fw ($98.50 in chips)
Seat 2: Qy/UBNbD2HaA0Ogxg8Sf3w ($125.85 in chips)
Seat 3: wL5HjWHHOSGc53xWMNKB9Q ($25.60 in chips)
Seat 4: uJVSceLggtsrJya+WtmUEA ($144.05 in chips)
Seat 5: bFrTkDcWGTxyvNul7GVdYg ($288.55 in chips)
Seat 6: /P4w1pHg2zHYg/4ubJ0dPw ($60 in chips)
Qy/UBNbD2HaA0Ogxg8Sf3w: posts small blind $0.50
wL5HjWHHOSGc53xWMNKB9Q: posts big blind $1
*** HOLE CARDS ***
uJVSceLggtsrJya+WtmUEA: raises $2 to $3
bFrTkDcWGTxyvNul7GVdYg: raises $8.50 to $11.50
/P4w1pHg2zHYg/4ubJ0dPw: folds
YMJG+F++3Aj6P8dAWda5fw: folds
Qy/UBNbD2HaA0Ogxg8Sf3w: folds
wL5HjWHHOSGc53xWMNKB9Q: folds
uJVSceLggtsrJya+WtmUEA: calls $8.50
*** FLOP *** [8c Ad Jd]
uJVSceLggtsrJya+WtmUEA: checks
bFrTkDcWGTxyvNul7GVdYg: bets $14
uJVSceLggtsrJya+WtmUEA: raises $21 to $35
bFrTkDcWGTxyvNul7GVdYg: folds
uJVSceLggtsrJya+WtmUEA collected $49.95 from pot
*** SUMMARY ***
Total pot $52.50 | Rake $2.55
Board [8c Ad Jd]
Seat 1: YMJG+F++3Aj6P8dAWda5fw (button) folded before Flop (didn't bet)
Seat 2: Qy/UBNbD2HaA0Ogxg8Sf3w (small blind) folded before Flop
Seat 3: wL5HjWHHOSGc53xWMNKB9Q (big blind) folded before Flop
Seat 4: uJVSceLggtsrJya+WtmUEA collected ($49.95)
Seat 5: bFrTkDcWGTxyvNul7GVdYg folded on the Flop
Seat 6: /P4w1pHg2zHYg/4ubJ0dPw folded before Flop (didn't bet)



PokerStars Game #59940249442:  Hold'em No Limit ($0.50/$1.00) - 2009/07/01 1:01:20 ET
Table 'vs/5jr6ciwjVQ5+Soc+u2A' 6-max Seat #1 is the button
Seat 1: /P4w1pHg2zHYg/4ubJ0dPw ($63.30 in chips)
Seat 3: G5ZSSN6RSON3gkNvk/SmYg ($138.35 in chips)
Seat 4: wk6Ohn4GDozoOMHc4eb2rw ($89.15 in chips)
Seat 5: +Nt3OPk3XR9SKjZgm2CexQ ($100 in chips)
TighterRock will be allowed to play after the button
G5ZSSN6RSON3gkNvk/SmYg: posts small blind $0.50
wk6Ohn4GDozoOMHc4eb2rw: posts big blind $1
*** HOLE CARDS ***
+Nt3OPk3XR9SKjZgm2CexQ: folds
/P4w1pHg2zHYg/4ubJ0dPw: folds
G5ZSSN6RSON3gkNvk/SmYg: folds
wk6Ohn4GDozoOMHc4eb2rw collected $1 from pot
wk6Ohn4GDozoOMHc4eb2rw: doesn't show hand
*** SUMMARY ***
Total pot $1 | Rake $0
Seat 1: /P4w1pHg2zHYg/4ubJ0dPw (button) folded before Flop (didn't bet)
Seat 3: G5ZSSN6RSON3gkNvk/SmYg (small blind) folded before Flop
Seat 4: wk6Ohn4GDozoOMHc4eb2rw (big blind) collected ($1)
Seat 5: +Nt3OPk3XR9SKjZgm2CexQ folded before Flop (didn't bet)



PokerStars Game #59940249686:  Hold'em No Limit ($0.50/$1.00) - 2009/07/01 1:01:20 ET
Table 'SQLOQoANiHscJ8AL7zffbw' 9-max Seat #7 is the button
Seat 1: jPTRd6SpCp4xqAy2XQiTOw ($68.95 in chips)
Seat 2: /zy+DB4S5fUQUSfZWFzYGw ($329.50 in chips)
Seat 3: 0eFnow7+D7veCYQ+CG9FFw ($93.35 in chips)
Seat 4: /mfensKw8/iZ1Vrx33S4xg ($20 in chips)
Seat 5: L9njYvloJ1NdXjP8edHEAg ($104.10 in chips)
Seat 7: bJckevFOcg//s0qyMQI6sQ ($104.55 in chips)
Seat 8: 2BV+oJIQYr65IO6nEChvbA ($60 in chips)
Seat 9: qJr25HAtvv1w/7IBvjMM3g ($203.70 in chips)
2BV+oJIQYr65IO6nEChvbA: posts small blind $0.50
qJr25HAtvv1w/7IBvjMM3g: posts big blind $1
*** HOLE CARDS ***
jPTRd6SpCp4xqAy2XQiTOw: folds
/zy+DB4S5fUQUSfZWFzYGw: folds
vincentt85 joins the table at seat #6
0eFnow7+D7veCYQ+CG9FFw: folds
/mfensKw8/iZ1Vrx33S4xg: folds
L9njYvloJ1NdXjP8edHEAg: folds
bJckevFOcg//s0qyMQI6sQ: folds
2BV+oJIQYr65IO6nEChvbA: folds
qJr25HAtvv1w/7IBvjMM3g collected $1 from pot
*** SUMMARY ***
Total pot $1 | Rake $0
Seat 1: jPTRd6SpCp4xqAy2XQiTOw folded before Flop (didn't bet)
Seat 2: /zy+DB4S5fUQUSfZWFzYGw folded before Flop (didn't bet)
Seat 3: 0eFnow7+D7veCYQ+CG9FFw folded before Flop (didn't bet)
Seat 4: /mfensKw8/iZ1Vrx33S4xg folded before Flop (didn't bet)
Seat 5: L9njYvloJ1NdXjP8edHEAg folded before Flop (didn't bet)
Seat 7: bJckevFOcg//s0qyMQI6sQ (button) folded before Flop (didn't bet)
Seat 8: 2BV+oJIQYr65IO6nEChvbA (small blind) folded before Flop
Seat 9: qJr25HAtvv1w/7IBvjMM3g (big blind) collected ($1)



PokerStars Game #59940250674:  Hold'em No Limit ($0.50/$1.00) - 2009/07/01 1:01:22 ET
Table 'iSx0wTgVb4o7MyZeOe06ZA' 9-max Seat #8 is the button
Seat 1: VPF+HjszMvUIpy0CHIwH3A ($20 in chips)
Seat 2: myIxN7otsyr846M539YR8Q ($20 in chips)
Seat 3: XQV7mCMbzd2Wh/l74wmbug ($99.20 in chips)
Seat 5: o1axyw4AjQ8n4ubTwlirQQ ($22 in chips)
Seat 6: T5/PXFS/W+LLcIXBo1G/RA ($105.15 in chips)
Seat 7: w4NnqVr/Sfoj65ux/fEUyQ ($77.90 in chips)
Seat 8: gUUvmqdVlmvpal6B8nYrmg ($100 in chips)
Seat 9: DMQXVuViR4IFzRccosBkJw ($56.05 in chips)
DMQXVuViR4IFzRccosBkJw: posts small blind $0.50
VPF+HjszMvUIpy0CHIwH3A: posts big blind $1
0fXz44fzDo5QmhAaJCvFfA: sits out
*** HOLE CARDS ***
myIxN7otsyr846M539YR8Q: folds
XQV7mCMbzd2Wh/l74wmbug: folds
o1axyw4AjQ8n4ubTwlirQQ: folds
T5/PXFS/W+LLcIXBo1G/RA: calls $1
w4NnqVr/Sfoj65ux/fEUyQ: folds
gUUvmqdVlmvpal6B8nYrmg: folds
DMQXVuViR4IFzRccosBkJw: raises $3 to $4
VPF+HjszMvUIpy0CHIwH3A: folds
T5/PXFS/W+LLcIXBo1G/RA: calls $3
*** FLOP *** [4c 3h 5s]
DMQXVuViR4IFzRccosBkJw: bets $7
T5/PXFS/W+LLcIXBo1G/RA: calls $7
*** TURN *** [4c 3h 5s] [Jh]
DMQXVuViR4IFzRccosBkJw: bets $15
T5/PXFS/W+LLcIXBo1G/RA: raises $35 to $50
DMQXVuViR4IFzRccosBkJw: calls $30.05 and is all-in
*** RIVER *** [4c 3h 5s Jh] [2h]
*** SHOW DOWN ***
DMQXVuViR4IFzRccosBkJw: shows [Tc Ts] (a pair of Tens)
T5/PXFS/W+LLcIXBo1G/RA: shows [2s As] (a straight, Ace to Five)
T5/PXFS/W+LLcIXBo1G/RA collected $110.10 from pot
*** SUMMARY ***
Total pot $113.10 | Rake $3
Board [4c 3h 5s Jh 2h]
Seat 1: VPF+HjszMvUIpy0CHIwH3A (big blind) folded before Flop
Seat 2: myIxN7otsyr846M539YR8Q folded before Flop (didn't bet)
Seat 3: XQV7mCMbzd2Wh/l74wmbug folded before Flop (didn't bet)
Seat 5: o1axyw4AjQ8n4ubTwlirQQ folded before Flop (didn't bet)
Seat 6: T5/PXFS/W+LLcIXBo1G/RA showed [2s As] and won ($110.10) with a straight, Ace to Five
Seat 7: w4NnqVr/Sfoj65ux/fEUyQ folded before Flop (didn't bet)
Seat 8: gUUvmqdVlmvpal6B8nYrmg (button) folded before Flop (didn't bet)
Seat 9: DMQXVuViR4IFzRccosBkJw (small blind) showed [Tc Ts] and lost with a pair of Tens



PokerStars Game #59940251608:  Hold'em No Limit ($0.50/$1.00) - 2009/07/01 1:01:23 ET
Table 'tLrtq7gDzxEvckNAI1OS5Q' 6-max Seat #4 is the button
Seat 3: TPZ+m9x+lwoKpv7TMfAUWA ($304.60 in chips)
Seat 4: +uSzP8Jwnw7sKfQ4s66b7w ($43.80 in chips)
Seat 5: OGMLOcTNYZXZU81au7ztUw ($165.65 in chips)
Seat 6: XUk5GQsfNFpHvaToDZ0rZA ($168.40 in chips)
OGMLOcTNYZXZU81au7ztUw: posts small blind $0.50
XUk5GQsfNFpHvaToDZ0rZA: posts big blind $1
*** HOLE CARDS ***
TPZ+m9x+lwoKpv7TMfAUWA: folds
+uSzP8Jwnw7sKfQ4s66b7w: folds
OGMLOcTNYZXZU81au7ztUw: folds
XUk5GQsfNFpHvaToDZ0rZA collected $1 from pot
XUk5GQsfNFpHvaToDZ0rZA: doesn't show hand
*** SUMMARY ***
Total pot $1 | Rake $0
Seat 3: TPZ+m9x+lwoKpv7TMfAUWA folded before Flop (didn't bet)
Seat 4: +uSzP8Jwnw7sKfQ4s66b7w (button) folded before Flop (didn't bet)
Seat 5: OGMLOcTNYZXZU81au7ztUw (small blind) folded before Flop
Seat 6: XUk5GQsfNFpHvaToDZ0rZA (big blind) collected ($1)



PokerStars Game #59940253726:  Hold'em No Limit ($0.50/$1.00) - 2009/07/01 1:01:27 ET
Table 'LmXQK9xy3awB+qsPzI21Mw' 2-max Seat #1 is the button
Seat 1: NYi6JFscYNrofSXy4sM+Yw ($253.05 in chips)
Seat 2: TME8GvochpQAo8cmJwWmvA ($133.70 in chips)
NYi6JFscYNrofSXy4sM+Yw: posts small blind $0.50
TME8GvochpQAo8cmJwWmvA: posts big blind $1
*** HOLE CARDS ***
NYi6JFscYNrofSXy4sM+Yw: raises $2 to $3
TME8GvochpQAo8cmJwWmvA: folds
NYi6JFscYNrofSXy4sM+Yw collected $2 from pot
*** SUMMARY ***
Total pot $2 | Rake $0
Seat 1: NYi6JFscYNrofSXy4sM+Yw (button) (small blind) collected ($2)
Seat 2: TME8GvochpQAo8cmJwWmvA (big blind) folded before Flop



PokerStars Game #59940256392:  Hold'em No Limit ($0.50/$1.00) - 2009/07/01 1:01:31 ET
Table 'JTT1XWaDZHSaMZQK7cR5uw' 2-max Seat #1 is the button
Seat 1: OLplZF6FEnLflv81Hz+Fxg ($122.05 in chips)
Seat 2: BcqgegiOUxmBD3F3umsljg ($88.35 in chips)
OLplZF6FEnLflv81Hz+Fxg: posts small blind $0.50
BcqgegiOUxmBD3F3umsljg: posts big blind $1
*** HOLE CARDS ***
OLplZF6FEnLflv81Hz+Fxg: folds
BcqgegiOUxmBD3F3umsljg collected $1 from pot
*** SUMMARY ***
Total pot $1 | Rake $0
Seat 1: OLplZF6FEnLflv81Hz+Fxg (button) (small blind) folded before Flop
Seat 2: BcqgegiOUxmBD3F3umsljg (big blind) collected ($1)



PokerStars Game #59940257358:  Hold'em No Limit ($0.50/$1.00) - 2009/07/01 1:01:33 ET
Table 'tLrtq7gDzxEvckNAI1OS5Q' 6-max Seat #5 is the button
Seat 3: TPZ+m9x+lwoKpv7TMfAUWA ($304.60 in chips)
Seat 4: +uSzP8Jwnw7sKfQ4s66b7w ($43.80 in chips)
Seat 5: OGMLOcTNYZXZU81au7ztUw ($165.15 in chips)
Seat 6: XUk5GQsfNFpHvaToDZ0rZA ($168.90 in chips)
XUk5GQsfNFpHvaToDZ0rZA: posts small blind $0.50
TPZ+m9x+lwoKpv7TMfAUWA: posts big blind $1
*** HOLE CARDS ***
+uSzP8Jwnw7sKfQ4s66b7w: folds
OGMLOcTNYZXZU81au7ztUw: raises $2 to $3
XUk5GQsfNFpHvaToDZ0rZA: folds
TPZ+m9x+lwoKpv7TMfAUWA: calls $2
*** FLOP *** [3h 3d 6h]
TPZ+m9x+lwoKpv7TMfAUWA: checks
OGMLOcTNYZXZU81au7ztUw: bets $4
TPZ+m9x+lwoKpv7TMfAUWA: folds
OGMLOcTNYZXZU81au7ztUw collected $6.20 from pot
OGMLOcTNYZXZU81au7ztUw: doesn't show hand
*** SUMMARY ***
Total pot $6.50 | Rake $0.30
Board [3h 3d 6h]
Seat 3: TPZ+m9x+lwoKpv7TMfAUWA (big blind) folded on the Flop
Seat 4: +uSzP8Jwnw7sKfQ4s66b7w folded before Flop (didn't bet)
Seat 5: OGMLOcTNYZXZU81au7ztUw (button) collected ($6.20)
Seat 6: XUk5GQsfNFpHvaToDZ0rZA (small blind) folded before Flop



PokerStars Game #59940258076:  Hold'em No Limit ($0.50/$1.00) - 2009/07/01 1:01:34 ET
Table 'cKH9c4x6u79IqCdaKKvXrw' 9-max Seat #3 is the button
Seat 1: Pp/KTcXkfZKKUHkjyaLTdg ($17 in chips)
Seat 2: 8S3JMH4TY3whgIlZmMv66w ($67.65 in chips)
Seat 3: 997ViqAtWn1FPjJqcffwcA ($157.10 in chips)
Seat 4: FL3MrLspcF23LYvC4ipBOA ($100 in chips)
Seat 5: Jjc7EHWzs4//xUAjJ0UWoA ($42.15 in chips)
Seat 6: Bsd/K5gAcLanYbGiPirRjw ($210.55 in chips)
Seat 7: 1GkkVBhlJ92guE6K5mS5Ig ($15.55 in chips)
Seat 8: myIxN7otsyr846M539YR8Q ($18.50 in chips)
Seat 9: 6XkTu4ahxzHnvjjc1R8YjQ ($41.60 in chips)
FL3MrLspcF23LYvC4ipBOA: posts small blind $0.50
Jjc7EHWzs4//xUAjJ0UWoA: posts big blind $1
*** HOLE CARDS ***
Bsd/K5gAcLanYbGiPirRjw: folds
1GkkVBhlJ92guE6K5mS5Ig: folds
myIxN7otsyr846M539YR8Q: folds
6XkTu4ahxzHnvjjc1R8YjQ: folds
Pp/KTcXkfZKKUHkjyaLTdg: raises $2.50 to $3.50
8S3JMH4TY3whgIlZmMv66w: folds
997ViqAtWn1FPjJqcffwcA: folds
FL3MrLspcF23LYvC4ipBOA: folds
Jjc7EHWzs4//xUAjJ0UWoA: folds
Pp/KTcXkfZKKUHkjyaLTdg collected $2.50 from pot
Pp/KTcXkfZKKUHkjyaLTdg: doesn't show hand
*** SUMMARY ***
Total pot $2.50 | Rake $0
Seat 1: Pp/KTcXkfZKKUHkjyaLTdg collected ($2.50)
Seat 2: 8S3JMH4TY3whgIlZmMv66w folded before Flop (didn't bet)
Seat 3: 997ViqAtWn1FPjJqcffwcA (button) folded before Flop (didn't bet)
Seat 4: FL3MrLspcF23LYvC4ipBOA (small blind) folded before Flop
Seat 5: Jjc7EHWzs4//xUAjJ0UWoA (big blind) folded before Flop
Seat 6: Bsd/K5gAcLanYbGiPirRjw folded before Flop (didn't bet)
Seat 7: 1GkkVBhlJ92guE6K5mS5Ig folded before Flop (didn't bet)
Seat 8: myIxN7otsyr846M539YR8Q folded before Flop (didn't bet)
Seat 9: 6XkTu4ahxzHnvjjc1R8YjQ folded before Flop (didn't bet)



PokerStars Game #59940258478:  Hold'em No Limit ($0.50/$1.00) - 2009/07/01 1:01:35 ET
Table 'vs/5jr6ciwjVQ5+Soc+u2A' 6-max Seat #3 is the button
Seat 1: /P4w1pHg2zHYg/4ubJ0dPw ($63.30 in chips)
Seat 3: G5ZSSN6RSON3gkNvk/SmYg ($137.85 in chips)
Seat 4: wk6Ohn4GDozoOMHc4eb2rw ($89.65 in chips)
Seat 5: +Nt3OPk3XR9SKjZgm2CexQ ($100 in chips)
wk6Ohn4GDozoOMHc4eb2rw: posts small blind $0.50
+Nt3OPk3XR9SKjZgm2CexQ: posts big blind $1
TighterRock: sits out
*** HOLE CARDS ***
/P4w1pHg2zHYg/4ubJ0dPw: folds
G5ZSSN6RSON3gkNvk/SmYg: folds
wk6Ohn4GDozoOMHc4eb2rw: raises $1 to $2
+Nt3OPk3XR9SKjZgm2CexQ: calls $1
*** FLOP *** [5s 3h 2h]
wk6Ohn4GDozoOMHc4eb2rw: checks
+Nt3OPk3XR9SKjZgm2CexQ: bets $3
wk6Ohn4GDozoOMHc4eb2rw: folds
+Nt3OPk3XR9SKjZgm2CexQ collected $3.80 from pot
+Nt3OPk3XR9SKjZgm2CexQ: doesn't show hand
*** SUMMARY ***
Total pot $4 | Rake $0.20
Board [5s 3h 2h]
Seat 1: /P4w1pHg2zHYg/4ubJ0dPw folded before Flop (didn't bet)
Seat 3: G5ZSSN6RSON3gkNvk/SmYg (button) folded before Flop (didn't bet)
Seat 4: wk6Ohn4GDozoOMHc4eb2rw (small blind) folded on the Flop
Seat 5: +Nt3OPk3XR9SKjZgm2CexQ (big blind) collected ($3.80)



PokerStars Game #59940260144:  Hold'em No Limit ($0.50/$1.00) - 2009/07/01 1:01:38 ET
Table 'JTT1XWaDZHSaMZQK7cR5uw' 2-max Seat #2 is the button
Seat 1: OLplZF6FEnLflv81Hz+Fxg ($121.55 in chips)
Seat 2: BcqgegiOUxmBD3F3umsljg ($88.85 in chips)
BcqgegiOUxmBD3F3umsljg: posts small blind $0.50
OLplZF6FEnLflv81Hz+Fxg: posts big blind $1
*** HOLE CARDS ***
BcqgegiOUxmBD3F3umsljg: raises $1 to $2
OLplZF6FEnLflv81Hz+Fxg: folds
BcqgegiOUxmBD3F3umsljg collected $2 from pot
*** SUMMARY ***
Total pot $2 | Rake $0
Seat 1: OLplZF6FEnLflv81Hz+Fxg (big blind) folded before Flop
Seat 2: BcqgegiOUxmBD3F3umsljg (button) (small blind) collected ($2)



PokerStars Game #59940262054:  Hold'em No Limit ($0.50/$1.00) - 2009/07/01 1:01:41 ET
Table 'rmZfTK+oSebeUPJNbWhdAA' 6-max Seat #3 is the button
Seat 1: xAU6q2/cwmby2sxmA8VcmA ($146.50 in chips)
Seat 2: z7O9PO/WEcqRouIydFhS9Q ($121.05 in chips)
Seat 3: BCEV3COoKY607AzLWayfRA ($134 in chips)
Seat 4: 1/mIuXfgx1ZyVkodrmfQDw ($100 in chips)
Seat 5: 5lY8d6Cnm4HUkt/8FZSj4g ($93.90 in chips)
Seat 6: j7NIOHLZk7V2o9fOioO5ug ($118.30 in chips)
1/mIuXfgx1ZyVkodrmfQDw: posts small blind $0.50
5lY8d6Cnm4HUkt/8FZSj4g: posts big blind $1
*** HOLE CARDS ***
j7NIOHLZk7V2o9fOioO5ug: folds
xAU6q2/cwmby2sxmA8VcmA: folds
z7O9PO/WEcqRouIydFhS9Q: folds
BCEV3COoKY607AzLWayfRA: folds
1/mIuXfgx1ZyVkodrmfQDw: raises $2 to $3
5lY8d6Cnm4HUkt/8FZSj4g: calls $2
*** FLOP *** [3c Qc Qh]
1/mIuXfgx1ZyVkodrmfQDw: bets $4
5lY8d6Cnm4HUkt/8FZSj4g: folds
1/mIuXfgx1ZyVkodrmfQDw collected $5.70 from pot
1/mIuXfgx1ZyVkodrmfQDw: doesn't show hand
*** SUMMARY ***
Total pot $6 | Rake $0.30
Board [3c Qc Qh]
Seat 1: xAU6q2/cwmby2sxmA8VcmA folded before Flop (didn't bet)
Seat 2: z7O9PO/WEcqRouIydFhS9Q folded before Flop (didn't bet)
Seat 3: BCEV3COoKY607AzLWayfRA (button) folded before Flop (didn't bet)
Seat 4: 1/mIuXfgx1ZyVkodrmfQDw (small blind) collected ($5.70)
Seat 5: 5lY8d6Cnm4HUkt/8FZSj4g (big blind) folded on the Flop
Seat 6: j7NIOHLZk7V2o9fOioO5ug folded before Flop (didn't bet)



PokerStars Game #59940262334:  Hold'em No Limit ($0.50/$1.00) - 2009/07/01 1:01:41 ET
Table 'W/wyObTiXZm+Ckkl3YxcSw' 6-max Seat #3 is the button
Seat 1: eUBBn2R56C1IQ6Cs/vitwg ($138.40 in chips)
Seat 2: oDiBRCaF0QVtd3kO6xZIXw ($107.85 in chips)
Seat 3: dxyNCn/qxfkGDUIf28Cbng ($83.90 in chips)
Seat 4: aYii2DmxlOlbC1wbGRBWvQ ($103.80 in chips)
Seat 5: BdbmJTZZ47quA9vUWwXtlw ($60.85 in chips)
aYii2DmxlOlbC1wbGRBWvQ: posts small blind $0.50
BdbmJTZZ47quA9vUWwXtlw: posts big blind $1
OGMLOcTNYZXZU81au7ztUw: sits out
*** HOLE CARDS ***
eUBBn2R56C1IQ6Cs/vitwg: raises $3 to $4
oDiBRCaF0QVtd3kO6xZIXw: folds
dxyNCn/qxfkGDUIf28Cbng: folds
aYii2DmxlOlbC1wbGRBWvQ: calls $3.50
BdbmJTZZ47quA9vUWwXtlw: calls $3
*** FLOP *** [Td 7d 3c]
aYii2DmxlOlbC1wbGRBWvQ: checks
BdbmJTZZ47quA9vUWwXtlw: bets $4
eUBBn2R56C1IQ6Cs/vitwg: raises $11 to $15
aYii2DmxlOlbC1wbGRBWvQ: folds
BdbmJTZZ47quA9vUWwXtlw: calls $11
*** TURN *** [Td 7d 3c] [2d]
BdbmJTZZ47quA9vUWwXtlw: checks
eUBBn2R56C1IQ6Cs/vitwg: bets $19
BdbmJTZZ47quA9vUWwXtlw: raises $22.85 to $41.85 and is all-in
eUBBn2R56C1IQ6Cs/vitwg: calls $22.85
*** RIVER *** [Td 7d 3c 2d] [7c]
*** SHOW DOWN ***
BdbmJTZZ47quA9vUWwXtlw: shows [9h Th] (two pair, Tens and Sevens)
eUBBn2R56C1IQ6Cs/vitwg: shows [Ac Ad] (two pair, Aces and Sevens)
eUBBn2R56C1IQ6Cs/vitwg collected $123.70 from pot
*** SUMMARY ***
Total pot $125.70 | Rake $2
Board [Td 7d 3c 2d 7c]
Seat 1: eUBBn2R56C1IQ6Cs/vitwg showed [Ac Ad] and won ($123.70) with two pair, Aces and Sevens
Seat 2: oDiBRCaF0QVtd3kO6xZIXw folded before Flop (didn't bet)
Seat 3: dxyNCn/qxfkGDUIf28Cbng (button) folded before Flop (didn't bet)
Seat 4: aYii2DmxlOlbC1wbGRBWvQ (small blind) folded on the Flop
Seat 5: BdbmJTZZ47quA9vUWwXtlw (big blind) showed [9h Th] and lost with two pair, Tens and Sevens



PokerStars Game #59940261970:  Hold'em No Limit ($0.50/$1.00) - 2009/07/01 1:01:41 ET
Table 'eU3bWpDDg3Z+9R4m4iVmog' 6-max Seat #4 is the button
Seat 1: TSuRyAHnUPCFjP7Z0rEE0w ($189.65 in chips)
Seat 2: 8CAoOzhmB8n3nRFf3V4BTg ($59.30 in chips)
Seat 3: rVMOzU7w5FddYPGhD7qN2Q ($48.15 in chips)
Seat 4: GDVIsbEJ/DOJsMKE4Asz0A ($99 in chips)
Seat 6: hpxXcmRkXXI9HE5+5/j/0Q ($131.75 in chips)
hpxXcmRkXXI9HE5+5/j/0Q: posts small blind $0.50
TSuRyAHnUPCFjP7Z0rEE0w: posts big blind $1
*** HOLE CARDS ***
8CAoOzhmB8n3nRFf3V4BTg: folds
rVMOzU7w5FddYPGhD7qN2Q: folds
GDVIsbEJ/DOJsMKE4Asz0A: folds
hpxXcmRkXXI9HE5+5/j/0Q: folds
TSuRyAHnUPCFjP7Z0rEE0w collected $1 from pot
TSuRyAHnUPCFjP7Z0rEE0w: doesn't show hand
*** SUMMARY ***
Total pot $1 | Rake $0
Seat 1: TSuRyAHnUPCFjP7Z0rEE0w (big blind) collected ($1)
Seat 2: 8CAoOzhmB8n3nRFf3V4BTg folded before Flop (didn't bet)
Seat 3: rVMOzU7w5FddYPGhD7qN2Q folded before Flop (didn't bet)
Seat 4: GDVIsbEJ/DOJsMKE4Asz0A (button) folded before Flop (didn't bet)
Seat 6: hpxXcmRkXXI9HE5+5/j/0Q (small blind) folded before Flop



PokerStars Game #59940262864:  Hold'em No Limit ($0.50/$1.00) - 2009/07/01 1:01:42 ET
Table 'GxCPo/gd3OSthkYrAxJngg' 6-max Seat #4 is the button
Seat 1: sH8BpAFP+jGFxCgVpD1Lew ($272.40 in chips)
Seat 2: YExX2paeIHrmfIwV1ivM/w ($77.70 in chips)
Seat 3: o6plE+MSW4XFNTeONe16xg ($23.60 in chips)
Seat 4: YMJG+F++3Aj6P8dAWda5fw ($203.10 in chips)
Seat 5: G5ZSSN6RSON3gkNvk/SmYg ($104.25 in chips)
G5ZSSN6RSON3gkNvk/SmYg: posts small blind $0.50
sH8BpAFP+jGFxCgVpD1Lew: posts big blind $1
*** HOLE CARDS ***
YExX2paeIHrmfIwV1ivM/w: calls $1
o6plE+MSW4XFNTeONe16xg: folds
YMJG+F++3Aj6P8dAWda5fw: folds
G5ZSSN6RSON3gkNvk/SmYg: folds
sH8BpAFP+jGFxCgVpD1Lew: checks
*** FLOP *** [Qc 7d Js]
sH8BpAFP+jGFxCgVpD1Lew: checks
YExX2paeIHrmfIwV1ivM/w: bets $2
sH8BpAFP+jGFxCgVpD1Lew: folds
YExX2paeIHrmfIwV1ivM/w collected $2.40 from pot
*** SUMMARY ***
Total pot $2.50 | Rake $0.10
Board [Qc 7d Js]
Seat 1: sH8BpAFP+jGFxCgVpD1Lew (big blind) folded on the Flop
Seat 2: YExX2paeIHrmfIwV1ivM/w collected ($2.40)
Seat 3: o6plE+MSW4XFNTeONe16xg folded before Flop (didn't bet)
Seat 4: YMJG+F++3Aj6P8dAWda5fw (button) folded before Flop (didn't bet)
Seat 5: G5ZSSN6RSON3gkNvk/SmYg (small blind) folded before Flop



PokerStars Game #59940262690:  Hold'em No Limit ($0.50/$1.00) - 2009/07/01 1:01:42 ET
Table '/FUb199IViHMJHi5YWmeuQ' 9-max Seat #6 is the button
Seat 1: TZcz9MEWDA+WydgGruqqbw ($120 in chips)
Seat 2: FL3MrLspcF23LYvC4ipBOA ($178.05 in chips)
Seat 3: qN483QJ1NvHbdIZB7J4ARw ($19.70 in chips)
Seat 4: qheQay5YvP2DMAb3OUSxtw ($147.80 in chips)
Seat 6: ccFf7Q4z1cTGQmeoYiWEfw ($53.30 in chips)
Seat 7: bLbSOSmSOnqE0iTcH/5dxA ($100 in chips)
Seat 8: 997ViqAtWn1FPjJqcffwcA ($103 in chips)
Seat 9: RfLbneGRY8yQUpMgDnJCxA ($63.95 in chips)
bLbSOSmSOnqE0iTcH/5dxA: posts small blind $0.50
997ViqAtWn1FPjJqcffwcA: posts big blind $1
vincentt85: sits out
*** HOLE CARDS ***
RfLbneGRY8yQUpMgDnJCxA: raises $2 to $3
TZcz9MEWDA+WydgGruqqbw: folds
FL3MrLspcF23LYvC4ipBOA: folds
qN483QJ1NvHbdIZB7J4ARw: calls $3
qheQay5YvP2DMAb3OUSxtw: folds
ccFf7Q4z1cTGQmeoYiWEfw: folds
bLbSOSmSOnqE0iTcH/5dxA: folds
997ViqAtWn1FPjJqcffwcA: folds
*** FLOP *** [4h Kh Td]
RfLbneGRY8yQUpMgDnJCxA: bets $1
qN483QJ1NvHbdIZB7J4ARw: calls $1
*** TURN *** [4h Kh Td] [8c]
RfLbneGRY8yQUpMgDnJCxA: bets $2
qN483QJ1NvHbdIZB7J4ARw: calls $2
*** RIVER *** [4h Kh Td 8c] [Ts]
RfLbneGRY8yQUpMgDnJCxA: bets $4
qN483QJ1NvHbdIZB7J4ARw: folds
RfLbneGRY8yQUpMgDnJCxA collected $12.85 from pot
RfLbneGRY8yQUpMgDnJCxA: doesn't show hand
*** SUMMARY ***
Total pot $13.50 | Rake $0.65
Board [4h Kh Td 8c Ts]
Seat 1: TZcz9MEWDA+WydgGruqqbw folded before Flop (didn't bet)
Seat 2: FL3MrLspcF23LYvC4ipBOA folded before Flop (didn't bet)
Seat 3: qN483QJ1NvHbdIZB7J4ARw folded on the River
Seat 4: qheQay5YvP2DMAb3OUSxtw folded before Flop (didn't bet)
Seat 6: ccFf7Q4z1cTGQmeoYiWEfw (button) folded before Flop (didn't bet)
Seat 7: bLbSOSmSOnqE0iTcH/5dxA (small blind) folded before Flop
Seat 8: 997ViqAtWn1FPjJqcffwcA (big blind) folded before Flop
Seat 9: RfLbneGRY8yQUpMgDnJCxA collected ($12.85)



PokerStars Game #59940262520:  Hold'em No Limit ($0.50/$1.00) - 2009/07/01 1:01:42 ET
Table 'kS0cTQAEi+fdUlJP2gQYvw' 9-max Seat #7 is the button
Seat 1: c/9X4zftzphFxYtxp5kp9w ($65.85 in chips)
Seat 2: D+W9Me7w6Hcx/WRUSKV0dw ($20 in chips)
Seat 3: 2BV+oJIQYr65IO6nEChvbA ($60 in chips)
Seat 4: TZcz9MEWDA+WydgGruqqbw ($100.10 in chips)
Seat 5: 997ViqAtWn1FPjJqcffwcA ($104.15 in chips)
Seat 6: yAbu2QsRPVcjPbqlf/jDxw ($127.65 in chips)
Seat 7: Ffa7Nj4X5fddtROP01hfQg ($131.15 in chips)
Seat 8: QYMfy2FoN6/Qe1LWYuI7fw ($19.50 in chips)
Seat 9: OGgaARGdJQT4awWVNQ957w ($103.50 in chips)
QYMfy2FoN6/Qe1LWYuI7fw: posts small blind $0.50
OGgaARGdJQT4awWVNQ957w: posts big blind $1
*** HOLE CARDS ***
Ffa7Nj4X5fddtROP01hfQg said, "dude!"
c/9X4zftzphFxYtxp5kp9w said, "didn't wanna bluff it"
c/9X4zftzphFxYtxp5kp9w: folds
D+W9Me7w6Hcx/WRUSKV0dw: folds
2BV+oJIQYr65IO6nEChvbA: folds
TZcz9MEWDA+WydgGruqqbw: folds
c/9X4zftzphFxYtxp5kp9w said, "almost did"
997ViqAtWn1FPjJqcffwcA: folds
yAbu2QsRPVcjPbqlf/jDxw: folds
Ffa7Nj4X5fddtROP01hfQg: folds
QYMfy2FoN6/Qe1LWYuI7fw: raises $2 to $3
OGgaARGdJQT4awWVNQ957w: folds
QYMfy2FoN6/Qe1LWYuI7fw collected $2 from pot
*** SUMMARY ***
Total pot $2 | Rake $0
Seat 1: c/9X4zftzphFxYtxp5kp9w folded before Flop (didn't bet)
Seat 2: D+W9Me7w6Hcx/WRUSKV0dw folded before Flop (didn't bet)
Seat 3: 2BV+oJIQYr65IO6nEChvbA folded before Flop (didn't bet)
Seat 4: TZcz9MEWDA+WydgGruqqbw folded before Flop (didn't bet)
Seat 5: 997ViqAtWn1FPjJqcffwcA folded before Flop (didn't bet)
Seat 6: yAbu2QsRPVcjPbqlf/jDxw folded before Flop (didn't bet)
Seat 7: Ffa7Nj4X5fddtROP01hfQg (button) folded before Flop (didn't bet)
Seat 8: QYMfy2FoN6/Qe1LWYuI7fw (small blind) collected ($2)
Seat 9: OGgaARGdJQT4awWVNQ957w (big blind) folded before Flop



