PokerStars Game #59940262882:  Hold'em No Limit ($0.50/$1.00) - 2009/07/01 1:01:42 ET
Table 'Zka9tv1yilg0MvXWPQrShg' 9-max Seat #6 is the button
Seat 1: TZcz9MEWDA+WydgGruqqbw ($117.40 in chips)
Seat 2: kz9ziSiGUc+857heiKSayw ($19.50 in chips)
Seat 3: gUUvmqdVlmvpal6B8nYrmg ($106.45 in chips)
Seat 4: stxmTgSicxShtrDxhOOX2g ($63.15 in chips)
Seat 5: /zy+DB4S5fUQUSfZWFzYGw ($115.60 in chips)
Seat 6: rY8wPoax1lS+HUY+I0FZDw ($159.20 in chips)
Seat 7: p1SafS90nb3Uft5LB0NkHw ($19.50 in chips)
Seat 8: D+W9Me7w6Hcx/WRUSKV0dw ($20 in chips)
Seat 9: 6daxhj43mWj04MOPTOmaYA ($109.90 in chips)
p1SafS90nb3Uft5LB0NkHw: posts small blind $0.50
D+W9Me7w6Hcx/WRUSKV0dw: posts big blind $1
*** HOLE CARDS ***
6daxhj43mWj04MOPTOmaYA: folds
TZcz9MEWDA+WydgGruqqbw: folds
kz9ziSiGUc+857heiKSayw: folds
gUUvmqdVlmvpal6B8nYrmg: raises $1 to $2
stxmTgSicxShtrDxhOOX2g: folds
/zy+DB4S5fUQUSfZWFzYGw: folds
rY8wPoax1lS+HUY+I0FZDw: folds
p1SafS90nb3Uft5LB0NkHw: folds
D+W9Me7w6Hcx/WRUSKV0dw: folds
gUUvmqdVlmvpal6B8nYrmg collected $2.50 from pot
*** SUMMARY ***
Total pot $2.50 | Rake $0
Seat 1: TZcz9MEWDA+WydgGruqqbw folded before Flop (didn't bet)
Seat 2: kz9ziSiGUc+857heiKSayw folded before Flop (didn't bet)
Seat 3: gUUvmqdVlmvpal6B8nYrmg collected ($2.50)
Seat 4: stxmTgSicxShtrDxhOOX2g folded before Flop (didn't bet)
Seat 5: /zy+DB4S5fUQUSfZWFzYGw folded before Flop (didn't bet)
Seat 6: rY8wPoax1lS+HUY+I0FZDw (button) folded before Flop (didn't bet)
Seat 7: p1SafS90nb3Uft5LB0NkHw (small blind) folded before Flop
Seat 8: D+W9Me7w6Hcx/WRUSKV0dw (big blind) folded before Flop
Seat 9: 6daxhj43mWj04MOPTOmaYA folded before Flop (didn't bet)



PokerStars Game #59940263326:  Hold'em No Limit ($0.50/$1.00) - 2009/07/01 1:01:43 ET
Table 'O96CPOtvMBWP6kzuYDfdFA' 6-max Seat #1 is the button
Seat 1: 6alLXQIITA2EZ/lBeym8Dw ($119.55 in chips)
Seat 2: yynBOXUjw28V5kz84sxX4g ($11.90 in chips)
Seat 3: V89DGjxE171oPREEbAXiyg ($83.10 in chips)
Seat 4: /P4w1pHg2zHYg/4ubJ0dPw ($60 in chips)
Seat 5: G5ZSSN6RSON3gkNvk/SmYg ($100 in chips)
Seat 6: GYei5jXGWexiJYbAT2fELg ($25.35 in chips)
yynBOXUjw28V5kz84sxX4g: posts small blind $0.50
V89DGjxE171oPREEbAXiyg: posts big blind $1
*** HOLE CARDS ***
/P4w1pHg2zHYg/4ubJ0dPw: folds
G5ZSSN6RSON3gkNvk/SmYg: folds
GYei5jXGWexiJYbAT2fELg: folds
6alLXQIITA2EZ/lBeym8Dw: folds
yynBOXUjw28V5kz84sxX4g: folds
V89DGjxE171oPREEbAXiyg collected $1 from pot
*** SUMMARY ***
Total pot $1 | Rake $0
Seat 1: 6alLXQIITA2EZ/lBeym8Dw (button) folded before Flop (didn't bet)
Seat 2: yynBOXUjw28V5kz84sxX4g (small blind) folded before Flop
Seat 3: V89DGjxE171oPREEbAXiyg (big blind) collected ($1)
Seat 4: /P4w1pHg2zHYg/4ubJ0dPw folded before Flop (didn't bet)
Seat 5: G5ZSSN6RSON3gkNvk/SmYg folded before Flop (didn't bet)
Seat 6: GYei5jXGWexiJYbAT2fELg folded before Flop (didn't bet)



PokerStars Game #59940264260:  Hold'em No Limit ($0.50/$1.00) - 2009/07/01 1:01:44 ET
Table '6YvsYDPNIDx2v5z3bJnwZQ' 9-max Seat #6 is the button
Seat 1: Ogn4JDV3mp4ZDKO49IFzKA ($22.70 in chips)
Seat 2: +hHqYgKILitkxIzFNGvvsA ($38.25 in chips)
Seat 3: negfosHnGOZXSHpWDRKyBQ ($16.50 in chips)
Seat 4: kEr5NYB+JIG5+szcYMr6hA ($50.80 in chips)
Seat 5: mBRWbnUl8diyBO1qTJaNzw ($162.20 in chips)
Seat 6: 7RSwrjMohkYrZAhOd1uaZg ($6 in chips)
Seat 7: mae7OMTaJ/MFimNbZegCkg ($51.30 in chips)
Seat 8: PSFxpXgPedVZyHSu2Zhb7Q ($108.80 in chips)
mae7OMTaJ/MFimNbZegCkg: posts small blind $0.50
PSFxpXgPedVZyHSu2Zhb7Q: posts big blind $1
*** HOLE CARDS ***
Ogn4JDV3mp4ZDKO49IFzKA: folds
+hHqYgKILitkxIzFNGvvsA: calls $1
negfosHnGOZXSHpWDRKyBQ: folds
kEr5NYB+JIG5+szcYMr6hA: calls $1
mBRWbnUl8diyBO1qTJaNzw: folds
7RSwrjMohkYrZAhOd1uaZg: folds
mae7OMTaJ/MFimNbZegCkg: calls $0.50
PSFxpXgPedVZyHSu2Zhb7Q: raises $2 to $3
+hHqYgKILitkxIzFNGvvsA: calls $2
kEr5NYB+JIG5+szcYMr6hA: calls $2
mae7OMTaJ/MFimNbZegCkg: calls $2
*** FLOP *** [Jh 5d Ad]
mae7OMTaJ/MFimNbZegCkg: checks
PSFxpXgPedVZyHSu2Zhb7Q: checks
+hHqYgKILitkxIzFNGvvsA: checks
kEr5NYB+JIG5+szcYMr6hA: checks
*** TURN *** [Jh 5d Ad] [9h]
mae7OMTaJ/MFimNbZegCkg: checks
PSFxpXgPedVZyHSu2Zhb7Q: checks
+hHqYgKILitkxIzFNGvvsA: checks
kEr5NYB+JIG5+szcYMr6hA: checks
*** RIVER *** [Jh 5d Ad 9h] [5s]
mae7OMTaJ/MFimNbZegCkg: checks
PSFxpXgPedVZyHSu2Zhb7Q: checks
+hHqYgKILitkxIzFNGvvsA: checks
kEr5NYB+JIG5+szcYMr6hA: checks
*** SHOW DOWN ***
mae7OMTaJ/MFimNbZegCkg: shows [3c 3s] (two pair, Fives and Threes)
PSFxpXgPedVZyHSu2Zhb7Q: shows [Th Tc] (two pair, Tens and Fives)
+hHqYgKILitkxIzFNGvvsA: mucks hand
kEr5NYB+JIG5+szcYMr6hA: mucks hand
PSFxpXgPedVZyHSu2Zhb7Q collected $11.40 from pot
*** SUMMARY ***
Total pot $12 | Rake $0.60
Board [Jh 5d Ad 9h 5s]
Seat 1: Ogn4JDV3mp4ZDKO49IFzKA folded before Flop (didn't bet)
Seat 2: +hHqYgKILitkxIzFNGvvsA mucked
Seat 3: negfosHnGOZXSHpWDRKyBQ folded before Flop (didn't bet)
Seat 4: kEr5NYB+JIG5+szcYMr6hA mucked
Seat 5: mBRWbnUl8diyBO1qTJaNzw folded before Flop (didn't bet)
Seat 6: 7RSwrjMohkYrZAhOd1uaZg (button) folded before Flop (didn't bet)
Seat 7: mae7OMTaJ/MFimNbZegCkg (small blind) showed [3c 3s] and lost with two pair, Fives and Threes
Seat 8: PSFxpXgPedVZyHSu2Zhb7Q (big blind) showed [Th Tc] and won ($11.40) with two pair, Tens and Fives



PokerStars Game #59940265378:  Hold'em No Limit ($0.50/$1.00) - 2009/07/01 1:01:46 ET
Table '+cA8mcmhaedZ7YcrDdhmeQ' 6-max Seat #3 is the button
Seat 1: lsLuWlcPA3Rh7kJVLzMh0Q ($302.45 in chips)
Seat 2: RqgF7gRoKgRNW8Zoi1ty4A ($110.55 in chips)
Seat 3: 7H5WkGzGvsv56y1iaqHvRg ($26.20 in chips)
Seat 4: 4OO5v3AVduL0tePNx8wk5A ($101.50 in chips)
Seat 5: +7hFKAL0b0O/n8G72TclJA ($66.35 in chips)
Seat 6: YfsTQsY/fxb+YqbdclTHuw ($19.45 in chips)
4OO5v3AVduL0tePNx8wk5A: posts small blind $0.50
+7hFKAL0b0O/n8G72TclJA: posts big blind $1
*** HOLE CARDS ***
YfsTQsY/fxb+YqbdclTHuw: calls $1
lsLuWlcPA3Rh7kJVLzMh0Q: folds
RqgF7gRoKgRNW8Zoi1ty4A: folds
7H5WkGzGvsv56y1iaqHvRg: raises $2 to $3
4OO5v3AVduL0tePNx8wk5A: folds
+7hFKAL0b0O/n8G72TclJA: folds
YfsTQsY/fxb+YqbdclTHuw: calls $2
*** FLOP *** [5h 2c Td]
YfsTQsY/fxb+YqbdclTHuw: bets $16.45 and is all-in
7H5WkGzGvsv56y1iaqHvRg: folds
YfsTQsY/fxb+YqbdclTHuw collected $7.15 from pot
*** SUMMARY ***
Total pot $7.50 | Rake $0.35
Board [5h 2c Td]
Seat 1: lsLuWlcPA3Rh7kJVLzMh0Q folded before Flop (didn't bet)
Seat 2: RqgF7gRoKgRNW8Zoi1ty4A folded before Flop (didn't bet)
Seat 3: 7H5WkGzGvsv56y1iaqHvRg (button) folded on the Flop
Seat 4: 4OO5v3AVduL0tePNx8wk5A (small blind) folded before Flop
Seat 5: +7hFKAL0b0O/n8G72TclJA (big blind) folded before Flop
Seat 6: YfsTQsY/fxb+YqbdclTHuw collected ($7.15)



PokerStars Game #59940265444:  Hold'em No Limit ($0.50/$1.00) - 2009/07/01 1:01:46 ET
Table 'MUPc8FEpe/nR0BKSeReX6Q' 6-max Seat #1 is the button
Seat 1: qhkK6+yCciTRd+rCFEbnEQ ($40 in chips)
Seat 2: xAU6q2/cwmby2sxmA8VcmA ($121.70 in chips)
Seat 3: wx3sQGkVi2x9wJXuWNHPBw ($236.40 in chips)
Seat 4: ZA1bp6g8IwtTxkUE4eCjDQ ($196.80 in chips)
Seat 5: UBZQqpnJZdTYYY1FTb0rLA ($102.05 in chips)
Seat 6: oxnw0GLLpFanjhGkxfRSqA ($23.70 in chips)
xAU6q2/cwmby2sxmA8VcmA: posts small blind $0.50
wx3sQGkVi2x9wJXuWNHPBw: posts big blind $1
*** HOLE CARDS ***
ZA1bp6g8IwtTxkUE4eCjDQ: folds
UBZQqpnJZdTYYY1FTb0rLA: folds
oxnw0GLLpFanjhGkxfRSqA: folds
qhkK6+yCciTRd+rCFEbnEQ: folds
xAU6q2/cwmby2sxmA8VcmA: folds
wx3sQGkVi2x9wJXuWNHPBw collected $1 from pot
*** SUMMARY ***
Total pot $1 | Rake $0
Seat 1: qhkK6+yCciTRd+rCFEbnEQ (button) folded before Flop (didn't bet)
Seat 2: xAU6q2/cwmby2sxmA8VcmA (small blind) folded before Flop
Seat 3: wx3sQGkVi2x9wJXuWNHPBw (big blind) collected ($1)
Seat 4: ZA1bp6g8IwtTxkUE4eCjDQ folded before Flop (didn't bet)
Seat 5: UBZQqpnJZdTYYY1FTb0rLA folded before Flop (didn't bet)
Seat 6: oxnw0GLLpFanjhGkxfRSqA folded before Flop (didn't bet)



PokerStars Game #59940265204:  Hold'em No Limit ($0.50/$1.00) - 2009/07/01 1:01:46 ET
Table 'LmXQK9xy3awB+qsPzI21Mw' 2-max Seat #2 is the button
Seat 1: NYi6JFscYNrofSXy4sM+Yw ($254.05 in chips)
Seat 2: TME8GvochpQAo8cmJwWmvA ($132.70 in chips)
TME8GvochpQAo8cmJwWmvA: posts small blind $0.50
NYi6JFscYNrofSXy4sM+Yw: posts big blind $1
*** HOLE CARDS ***
TME8GvochpQAo8cmJwWmvA: raises $1 to $2
NYi6JFscYNrofSXy4sM+Yw: folds
TME8GvochpQAo8cmJwWmvA collected $2 from pot
TME8GvochpQAo8cmJwWmvA: doesn't show hand
*** SUMMARY ***
Total pot $2 | Rake $0
Seat 1: NYi6JFscYNrofSXy4sM+Yw (big blind) folded before Flop
Seat 2: TME8GvochpQAo8cmJwWmvA (button) (small blind) collected ($2)



PokerStars Game #59940266708:  Hold'em No Limit ($0.50/$1.00) - 2009/07/01 1:01:48 ET
Table 'JTT1XWaDZHSaMZQK7cR5uw' 2-max Seat #1 is the button
Seat 1: OLplZF6FEnLflv81Hz+Fxg ($120.55 in chips)
Seat 2: BcqgegiOUxmBD3F3umsljg ($89.85 in chips)
OLplZF6FEnLflv81Hz+Fxg: posts small blind $0.50
BcqgegiOUxmBD3F3umsljg: posts big blind $1
*** HOLE CARDS ***
OLplZF6FEnLflv81Hz+Fxg: folds
BcqgegiOUxmBD3F3umsljg collected $1 from pot
*** SUMMARY ***
Total pot $1 | Rake $0
Seat 1: OLplZF6FEnLflv81Hz+Fxg (button) (small blind) folded before Flop
Seat 2: BcqgegiOUxmBD3F3umsljg (big blind) collected ($1)



PokerStars Game #59940267348:  Hold'em No Limit ($0.50/$1.00) - 2009/07/01 1:01:50 ET
Table 'cBDNutyLBKEk9+ptwsKmTw' 6-max Seat #6 is the button
Seat 1: xAU6q2/cwmby2sxmA8VcmA ($110.35 in chips)
Seat 2: 5lY8d6Cnm4HUkt/8FZSj4g ($38.10 in chips)
Seat 3: G5ZSSN6RSON3gkNvk/SmYg ($101.65 in chips)
Seat 4: 3q7F5QtzC30pSrn0nl9i+A ($33.80 in chips)
Seat 5: OGMLOcTNYZXZU81au7ztUw ($157.15 in chips)
Seat 6: NqVlOSH2lp+pp/TK3vvK5g ($88.10 in chips)
xAU6q2/cwmby2sxmA8VcmA: posts small blind $0.50
5lY8d6Cnm4HUkt/8FZSj4g: posts big blind $1
*** HOLE CARDS ***
G5ZSSN6RSON3gkNvk/SmYg: folds
3q7F5QtzC30pSrn0nl9i+A: calls $1
OGMLOcTNYZXZU81au7ztUw: raises $3 to $4
NqVlOSH2lp+pp/TK3vvK5g: folds
xAU6q2/cwmby2sxmA8VcmA: folds
5lY8d6Cnm4HUkt/8FZSj4g: calls $3
3q7F5QtzC30pSrn0nl9i+A: calls $3
*** FLOP *** [Jh 9h 6h]
5lY8d6Cnm4HUkt/8FZSj4g: checks
3q7F5QtzC30pSrn0nl9i+A: checks
OGMLOcTNYZXZU81au7ztUw: bets $10
5lY8d6Cnm4HUkt/8FZSj4g: folds
3q7F5QtzC30pSrn0nl9i+A: folds
OGMLOcTNYZXZU81au7ztUw collected $11.90 from pot
OGMLOcTNYZXZU81au7ztUw: doesn't show hand
*** SUMMARY ***
Total pot $12.50 | Rake $0.60
Board [Jh 9h 6h]
Seat 1: xAU6q2/cwmby2sxmA8VcmA (small blind) folded before Flop
Seat 2: 5lY8d6Cnm4HUkt/8FZSj4g (big blind) folded on the Flop
Seat 3: G5ZSSN6RSON3gkNvk/SmYg folded before Flop (didn't bet)
Seat 4: 3q7F5QtzC30pSrn0nl9i+A folded on the Flop
Seat 5: OGMLOcTNYZXZU81au7ztUw collected ($11.90)
Seat 6: NqVlOSH2lp+pp/TK3vvK5g (button) folded before Flop (didn't bet)



PokerStars Game #59940267512:  Hold'em No Limit ($0.50/$1.00) - 2009/07/01 1:01:50 ET
Table 'SQLOQoANiHscJ8AL7zffbw' 9-max Seat #8 is the button
Seat 1: jPTRd6SpCp4xqAy2XQiTOw ($68.95 in chips)
Seat 2: /zy+DB4S5fUQUSfZWFzYGw ($329.50 in chips)
Seat 3: 0eFnow7+D7veCYQ+CG9FFw ($93.35 in chips)
Seat 4: /mfensKw8/iZ1Vrx33S4xg ($20 in chips)
Seat 5: L9njYvloJ1NdXjP8edHEAg ($104.10 in chips)
Seat 7: bJckevFOcg//s0qyMQI6sQ ($104.55 in chips)
Seat 8: 2BV+oJIQYr65IO6nEChvbA ($60 in chips)
Seat 9: qJr25HAtvv1w/7IBvjMM3g ($204.20 in chips)
qJr25HAtvv1w/7IBvjMM3g: posts small blind $0.50
jPTRd6SpCp4xqAy2XQiTOw: posts big blind $1
H+DVy3Ei8L1UKS2tVOtJcw: sits out
*** HOLE CARDS ***
/zy+DB4S5fUQUSfZWFzYGw: folds
0eFnow7+D7veCYQ+CG9FFw: folds
/mfensKw8/iZ1Vrx33S4xg: folds
L9njYvloJ1NdXjP8edHEAg: folds
bJckevFOcg//s0qyMQI6sQ: folds
2BV+oJIQYr65IO6nEChvbA: folds
qJr25HAtvv1w/7IBvjMM3g: calls $0.50
jPTRd6SpCp4xqAy2XQiTOw: checks
*** FLOP *** [6s Kd Kc]
qJr25HAtvv1w/7IBvjMM3g: checks
jPTRd6SpCp4xqAy2XQiTOw: checks
*** TURN *** [6s Kd Kc] [6h]
qJr25HAtvv1w/7IBvjMM3g: checks
jPTRd6SpCp4xqAy2XQiTOw: checks
*** RIVER *** [6s Kd Kc 6h] [Ks]
qJr25HAtvv1w/7IBvjMM3g: checks
jPTRd6SpCp4xqAy2XQiTOw: checks
*** SHOW DOWN ***
qJr25HAtvv1w/7IBvjMM3g: shows [Td 3d] (a full house, Kings full of Sixes)
jPTRd6SpCp4xqAy2XQiTOw: shows [2s 3h] (a full house, Kings full of Sixes)
qJr25HAtvv1w/7IBvjMM3g collected $0.95 from pot
jPTRd6SpCp4xqAy2XQiTOw collected $0.95 from pot
*** SUMMARY ***
Total pot $2 | Rake $0.10
Board [6s Kd Kc 6h Ks]
Seat 1: jPTRd6SpCp4xqAy2XQiTOw (big blind) showed [2s 3h] and won ($0.95) with a full house, Kings full of Sixes
Seat 2: /zy+DB4S5fUQUSfZWFzYGw folded before Flop (didn't bet)
Seat 3: 0eFnow7+D7veCYQ+CG9FFw folded before Flop (didn't bet)
Seat 4: /mfensKw8/iZ1Vrx33S4xg folded before Flop (didn't bet)
Seat 5: L9njYvloJ1NdXjP8edHEAg folded before Flop (didn't bet)
Seat 7: bJckevFOcg//s0qyMQI6sQ folded before Flop (didn't bet)
Seat 8: 2BV+oJIQYr65IO6nEChvbA (button) folded before Flop (didn't bet)
Seat 9: qJr25HAtvv1w/7IBvjMM3g (small blind) showed [Td 3d] and won ($0.95) with a full house, Kings full of Sixes



PokerStars Game #59940268218:  Hold'em No Limit ($0.50/$1.00) - 2009/07/01 1:01:51 ET
Table '8jIjWCPY0NGprquL+xcMFg' 9-max Seat #4 is the button
Seat 1: N7iZ0peZns5o4A6AjN24jQ ($45.60 in chips)
Seat 2: laA8va+Yv8WuMqT1zdR91g ($108.70 in chips)
Seat 3: tjhwe1V98x2spSoUQER3HQ ($103 in chips)
Seat 4: Jjc7EHWzs4//xUAjJ0UWoA ($17.40 in chips)
Seat 5: 2YpnxJiexJHyERfbqgwEcw ($54.05 in chips)
Seat 6: GTQkFJtSkbVbnGCktp6e3g ($101.35 in chips)
Seat 7: O3CGPwwUmamrCNHccOilrg ($41.45 in chips)
Seat 8: D+W9Me7w6Hcx/WRUSKV0dw ($18.50 in chips)
Seat 9: negfosHnGOZXSHpWDRKyBQ ($57.65 in chips)
2YpnxJiexJHyERfbqgwEcw: posts small blind $0.50
GTQkFJtSkbVbnGCktp6e3g: posts big blind $1
*** HOLE CARDS ***
O3CGPwwUmamrCNHccOilrg: folds
D+W9Me7w6Hcx/WRUSKV0dw: folds
negfosHnGOZXSHpWDRKyBQ: folds
N7iZ0peZns5o4A6AjN24jQ: folds
laA8va+Yv8WuMqT1zdR91g: folds
tjhwe1V98x2spSoUQER3HQ: folds
Jjc7EHWzs4//xUAjJ0UWoA: raises $2 to $3
2YpnxJiexJHyERfbqgwEcw: folds
GTQkFJtSkbVbnGCktp6e3g: folds
Jjc7EHWzs4//xUAjJ0UWoA collected $2.50 from pot
*** SUMMARY ***
Total pot $2.50 | Rake $0
Seat 1: N7iZ0peZns5o4A6AjN24jQ folded before Flop (didn't bet)
Seat 2: laA8va+Yv8WuMqT1zdR91g folded before Flop (didn't bet)
Seat 3: tjhwe1V98x2spSoUQER3HQ folded before Flop (didn't bet)
Seat 4: Jjc7EHWzs4//xUAjJ0UWoA (button) collected ($2.50)
Seat 5: 2YpnxJiexJHyERfbqgwEcw (small blind) folded before Flop
Seat 6: GTQkFJtSkbVbnGCktp6e3g (big blind) folded before Flop
Seat 7: O3CGPwwUmamrCNHccOilrg folded before Flop (didn't bet)
Seat 8: D+W9Me7w6Hcx/WRUSKV0dw folded before Flop (didn't bet)
Seat 9: negfosHnGOZXSHpWDRKyBQ folded before Flop (didn't bet)



PokerStars Game #59940269784:  Hold'em No Limit ($0.50/$1.00) - 2009/07/01 1:01:54 ET
Table 'LmXQK9xy3awB+qsPzI21Mw' 2-max Seat #1 is the button
Seat 1: NYi6JFscYNrofSXy4sM+Yw ($253.05 in chips)
Seat 2: TME8GvochpQAo8cmJwWmvA ($133.70 in chips)
NYi6JFscYNrofSXy4sM+Yw: posts small blind $0.50
TME8GvochpQAo8cmJwWmvA: posts big blind $1
*** HOLE CARDS ***
NYi6JFscYNrofSXy4sM+Yw: raises $1 to $2
TME8GvochpQAo8cmJwWmvA: calls $1
*** FLOP *** [Ad Td 4h]
TME8GvochpQAo8cmJwWmvA: checks
NYi6JFscYNrofSXy4sM+Yw: bets $3
TME8GvochpQAo8cmJwWmvA: calls $3
*** TURN *** [Ad Td 4h] [7h]
TME8GvochpQAo8cmJwWmvA: checks
NYi6JFscYNrofSXy4sM+Yw: bets $7
TME8GvochpQAo8cmJwWmvA: calls $7
*** RIVER *** [Ad Td 4h 7h] [Qh]
TME8GvochpQAo8cmJwWmvA: checks
NYi6JFscYNrofSXy4sM+Yw: checks
*** SHOW DOWN ***
TME8GvochpQAo8cmJwWmvA: shows [9s Ts] (a pair of Tens)
NYi6JFscYNrofSXy4sM+Yw: shows [2d Qd] (a pair of Queens)
NYi6JFscYNrofSXy4sM+Yw collected $23.50 from pot
*** SUMMARY ***
Total pot $24 | Rake $0.50
Board [Ad Td 4h 7h Qh]
Seat 1: NYi6JFscYNrofSXy4sM+Yw (button) (small blind) showed [2d Qd] and won ($23.50) with a pair of Queens
Seat 2: TME8GvochpQAo8cmJwWmvA (big blind) showed [9s Ts] and lost with a pair of Tens



PokerStars Game #59940270674:  Hold'em No Limit ($0.50/$1.00) - 2009/07/01 1:01:55 ET
Table 'JTT1XWaDZHSaMZQK7cR5uw' 2-max Seat #2 is the button
Seat 1: OLplZF6FEnLflv81Hz+Fxg ($120.05 in chips)
Seat 2: BcqgegiOUxmBD3F3umsljg ($90.35 in chips)
BcqgegiOUxmBD3F3umsljg: posts small blind $0.50
OLplZF6FEnLflv81Hz+Fxg: posts big blind $1
*** HOLE CARDS ***
BcqgegiOUxmBD3F3umsljg: calls $0.50
OLplZF6FEnLflv81Hz+Fxg: checks
*** FLOP *** [7d Tc Kh]
OLplZF6FEnLflv81Hz+Fxg: checks
BcqgegiOUxmBD3F3umsljg: checks
*** TURN *** [7d Tc Kh] [Td]
OLplZF6FEnLflv81Hz+Fxg: checks
BcqgegiOUxmBD3F3umsljg: bets $2
OLplZF6FEnLflv81Hz+Fxg: folds
BcqgegiOUxmBD3F3umsljg collected $1.90 from pot
*** SUMMARY ***
Total pot $2 | Rake $0.10
Board [7d Tc Kh Td]
Seat 1: OLplZF6FEnLflv81Hz+Fxg (big blind) folded on the Turn
Seat 2: BcqgegiOUxmBD3F3umsljg (button) (small blind) collected ($1.90)



PokerStars Game #59940271436:  Hold'em No Limit ($0.50/$1.00) - 2009/07/01 1:01:56 ET
Table 'cKH9c4x6u79IqCdaKKvXrw' 9-max Seat #4 is the button
Seat 1: Pp/KTcXkfZKKUHkjyaLTdg ($18.50 in chips)
Seat 2: 8S3JMH4TY3whgIlZmMv66w ($67.65 in chips)
Seat 3: 997ViqAtWn1FPjJqcffwcA ($157.10 in chips)
Seat 4: FL3MrLspcF23LYvC4ipBOA ($100 in chips)
Seat 5: Jjc7EHWzs4//xUAjJ0UWoA ($41.15 in chips)
Seat 6: Bsd/K5gAcLanYbGiPirRjw ($210.55 in chips)
Seat 7: 1GkkVBhlJ92guE6K5mS5Ig ($15.55 in chips)
Seat 8: myIxN7otsyr846M539YR8Q ($18.50 in chips)
Seat 9: 6XkTu4ahxzHnvjjc1R8YjQ ($41.60 in chips)
Jjc7EHWzs4//xUAjJ0UWoA: posts small blind $0.50
Bsd/K5gAcLanYbGiPirRjw: posts big blind $1
*** HOLE CARDS ***
1GkkVBhlJ92guE6K5mS5Ig: folds
myIxN7otsyr846M539YR8Q: folds
6XkTu4ahxzHnvjjc1R8YjQ: folds
Pp/KTcXkfZKKUHkjyaLTdg: raises $2.50 to $3.50
8S3JMH4TY3whgIlZmMv66w: folds
997ViqAtWn1FPjJqcffwcA: folds
FL3MrLspcF23LYvC4ipBOA: folds
Jjc7EHWzs4//xUAjJ0UWoA: folds
Bsd/K5gAcLanYbGiPirRjw: folds
Pp/KTcXkfZKKUHkjyaLTdg collected $2.50 from pot
Pp/KTcXkfZKKUHkjyaLTdg: doesn't show hand
*** SUMMARY ***
Total pot $2.50 | Rake $0
Seat 1: Pp/KTcXkfZKKUHkjyaLTdg collected ($2.50)
Seat 2: 8S3JMH4TY3whgIlZmMv66w folded before Flop (didn't bet)
Seat 3: 997ViqAtWn1FPjJqcffwcA folded before Flop (didn't bet)
Seat 4: FL3MrLspcF23LYvC4ipBOA (button) folded before Flop (didn't bet)
Seat 5: Jjc7EHWzs4//xUAjJ0UWoA (small blind) folded before Flop
Seat 6: Bsd/K5gAcLanYbGiPirRjw (big blind) folded before Flop
Seat 7: 1GkkVBhlJ92guE6K5mS5Ig folded before Flop (didn't bet)
Seat 8: myIxN7otsyr846M539YR8Q folded before Flop (didn't bet)
Seat 9: 6XkTu4ahxzHnvjjc1R8YjQ folded before Flop (didn't bet)



PokerStars Game #59940271750:  Hold'em No Limit ($0.50/$1.00) - 2009/07/01 1:01:57 ET
Table 'eU3bWpDDg3Z+9R4m4iVmog' 6-max Seat #6 is the button
Seat 1: TSuRyAHnUPCFjP7Z0rEE0w ($190.15 in chips)
Seat 2: 8CAoOzhmB8n3nRFf3V4BTg ($59.30 in chips)
Seat 3: rVMOzU7w5FddYPGhD7qN2Q ($48.15 in chips)
Seat 4: GDVIsbEJ/DOJsMKE4Asz0A ($99 in chips)
Seat 6: hpxXcmRkXXI9HE5+5/j/0Q ($131.25 in chips)
TSuRyAHnUPCFjP7Z0rEE0w: posts small blind $0.50
8CAoOzhmB8n3nRFf3V4BTg: posts big blind $1
*** HOLE CARDS ***
rVMOzU7w5FddYPGhD7qN2Q: folds
GDVIsbEJ/DOJsMKE4Asz0A: folds
hpxXcmRkXXI9HE5+5/j/0Q: folds
TSuRyAHnUPCFjP7Z0rEE0w: folds
8CAoOzhmB8n3nRFf3V4BTg collected $1 from pot
*** SUMMARY ***
Total pot $1 | Rake $0
Seat 1: TSuRyAHnUPCFjP7Z0rEE0w (small blind) folded before Flop
Seat 2: 8CAoOzhmB8n3nRFf3V4BTg (big blind) collected ($1)
Seat 3: rVMOzU7w5FddYPGhD7qN2Q folded before Flop (didn't bet)
Seat 4: GDVIsbEJ/DOJsMKE4Asz0A folded before Flop (didn't bet)
Seat 6: hpxXcmRkXXI9HE5+5/j/0Q (button) folded before Flop (didn't bet)



PokerStars Game #59940272992:  Hold'em No Limit ($0.50/$1.00) - 2009/07/01 1:01:59 ET
Table 'QSIig7BLMc9wY/rgBechzw' 6-max Seat #6 is the button
Seat 1: Z2fXsGcjl+Eax+RzOgwOmg ($100 in chips)
Seat 2: mLOIkH/qmRa+mVujQIhBRg ($37.95 in chips)
Seat 3: Z3y97GMLCsoTZ9j7f6qctg ($30.80 in chips)
Seat 4: +uSzP8Jwnw7sKfQ4s66b7w ($72.70 in chips)
Seat 5: PVmmeYpn4gqkqYUool6BOA ($17.90 in chips)
Seat 6: PxqfkAMdAWtkgbT+q2gciA ($33.20 in chips)
Z2fXsGcjl+Eax+RzOgwOmg: posts small blind $0.50
mLOIkH/qmRa+mVujQIhBRg: posts big blind $1
*** HOLE CARDS ***
Z3y97GMLCsoTZ9j7f6qctg: folds
+uSzP8Jwnw7sKfQ4s66b7w: raises $2 to $3
PVmmeYpn4gqkqYUool6BOA: folds
PxqfkAMdAWtkgbT+q2gciA: folds
Z2fXsGcjl+Eax+RzOgwOmg: folds
mLOIkH/qmRa+mVujQIhBRg: calls $2
*** FLOP *** [2d Td 4s]
mLOIkH/qmRa+mVujQIhBRg: checks
+uSzP8Jwnw7sKfQ4s66b7w: checks
*** TURN *** [2d Td 4s] [9h]
mLOIkH/qmRa+mVujQIhBRg: bets $3
+uSzP8Jwnw7sKfQ4s66b7w: folds
mLOIkH/qmRa+mVujQIhBRg collected $6.20 from pot
*** SUMMARY ***
Total pot $6.50 | Rake $0.30
Board [2d Td 4s 9h]
Seat 1: Z2fXsGcjl+Eax+RzOgwOmg (small blind) folded before Flop
Seat 2: mLOIkH/qmRa+mVujQIhBRg (big blind) collected ($6.20)
Seat 3: Z3y97GMLCsoTZ9j7f6qctg folded before Flop (didn't bet)
Seat 4: +uSzP8Jwnw7sKfQ4s66b7w folded on the Turn
Seat 5: PVmmeYpn4gqkqYUool6BOA folded before Flop (didn't bet)
Seat 6: PxqfkAMdAWtkgbT+q2gciA (button) folded before Flop (didn't bet)



PokerStars Game #59940274642:  Hold'em No Limit ($0.50/$1.00) - 2009/07/01 1:02:01 ET
Table '7Nl0ffnjeK44/vmeexh3MQ' 9-max Seat #9 is the button
Seat 1: s7D3Y+k4Cj4D1cXHv7oj+Q ($95.35 in chips)
Seat 2: OGgaARGdJQT4awWVNQ957w ($101.50 in chips)
Seat 3: vR4IO10geOgvTW+LAUBv/A ($100 in chips)
Seat 4: bLbSOSmSOnqE0iTcH/5dxA ($100 in chips)
Seat 6: FVs16t7GgfWgQWt4JxsObQ ($48.45 in chips)
Seat 7: 997ViqAtWn1FPjJqcffwcA ($100 in chips)
Seat 8: D+W9Me7w6Hcx/WRUSKV0dw ($19.75 in chips)
Seat 9: ouwUBGRKnKK9uhn1G4Lf+A ($195.50 in chips)
s7D3Y+k4Cj4D1cXHv7oj+Q: posts small blind $0.50
OGgaARGdJQT4awWVNQ957w: posts big blind $1
61sfw5QTu62YYIt68OsdrA: sits out
*** HOLE CARDS ***
vR4IO10geOgvTW+LAUBv/A: folds
bLbSOSmSOnqE0iTcH/5dxA: calls $1
FVs16t7GgfWgQWt4JxsObQ: calls $1
997ViqAtWn1FPjJqcffwcA: folds
D+W9Me7w6Hcx/WRUSKV0dw: folds
ouwUBGRKnKK9uhn1G4Lf+A: folds
s7D3Y+k4Cj4D1cXHv7oj+Q: folds
OGgaARGdJQT4awWVNQ957w: checks
*** FLOP *** [Qs Js Ks]
OGgaARGdJQT4awWVNQ957w: checks
bLbSOSmSOnqE0iTcH/5dxA: checks
FVs16t7GgfWgQWt4JxsObQ: bets $2
OGgaARGdJQT4awWVNQ957w: folds
bLbSOSmSOnqE0iTcH/5dxA: folds
FVs16t7GgfWgQWt4JxsObQ collected $3.35 from pot
*** SUMMARY ***
Total pot $3.50 | Rake $0.15
Board [Qs Js Ks]
Seat 1: s7D3Y+k4Cj4D1cXHv7oj+Q (small blind) folded before Flop
Seat 2: OGgaARGdJQT4awWVNQ957w (big blind) folded on the Flop
Seat 3: vR4IO10geOgvTW+LAUBv/A folded before Flop (didn't bet)
Seat 4: bLbSOSmSOnqE0iTcH/5dxA folded on the Flop
Seat 6: FVs16t7GgfWgQWt4JxsObQ collected ($3.35)
Seat 7: 997ViqAtWn1FPjJqcffwcA folded before Flop (didn't bet)
Seat 8: D+W9Me7w6Hcx/WRUSKV0dw folded before Flop (didn't bet)
Seat 9: ouwUBGRKnKK9uhn1G4Lf+A (button) folded before Flop (didn't bet)



PokerStars Game #59940274896:  Hold'em No Limit ($0.50/$1.00) - 2009/07/01 1:02:02 ET
Table 'O96CPOtvMBWP6kzuYDfdFA' 6-max Seat #2 is the button
Seat 1: 6alLXQIITA2EZ/lBeym8Dw ($119.55 in chips)
Seat 2: yynBOXUjw28V5kz84sxX4g ($11.40 in chips)
Seat 3: V89DGjxE171oPREEbAXiyg ($83.60 in chips)
Seat 4: /P4w1pHg2zHYg/4ubJ0dPw ($60 in chips)
Seat 5: G5ZSSN6RSON3gkNvk/SmYg ($100 in chips)
Seat 6: GYei5jXGWexiJYbAT2fELg ($25.35 in chips)
V89DGjxE171oPREEbAXiyg: posts small blind $0.50
/P4w1pHg2zHYg/4ubJ0dPw: posts big blind $1
*** HOLE CARDS ***
G5ZSSN6RSON3gkNvk/SmYg: folds
GYei5jXGWexiJYbAT2fELg: calls $1
6alLXQIITA2EZ/lBeym8Dw: folds
yynBOXUjw28V5kz84sxX4g: folds
V89DGjxE171oPREEbAXiyg: folds
/P4w1pHg2zHYg/4ubJ0dPw: checks
*** FLOP *** [Jd 2d 9d]
/P4w1pHg2zHYg/4ubJ0dPw: bets $2.50
GYei5jXGWexiJYbAT2fELg: folds
/P4w1pHg2zHYg/4ubJ0dPw collected $2.40 from pot
*** SUMMARY ***
Total pot $2.50 | Rake $0.10
Board [Jd 2d 9d]
Seat 1: 6alLXQIITA2EZ/lBeym8Dw folded before Flop (didn't bet)
Seat 2: yynBOXUjw28V5kz84sxX4g (button) folded before Flop (didn't bet)
Seat 3: V89DGjxE171oPREEbAXiyg (small blind) folded before Flop
Seat 4: /P4w1pHg2zHYg/4ubJ0dPw (big blind) collected ($2.40)
Seat 5: G5ZSSN6RSON3gkNvk/SmYg folded before Flop (didn't bet)
Seat 6: GYei5jXGWexiJYbAT2fELg folded on the Flop



PokerStars Game #59940275554:  Hold'em No Limit ($0.50/$1.00) - 2009/07/01 1:02:03 ET
Table 'pHrhryH8jPNdQfY62f8v+g' 6-max Seat #5 is the button
Seat 1: OvwYHV65yUbgdBjSmo1+5g ($55.50 in chips)
Seat 2: RqgF7gRoKgRNW8Zoi1ty4A ($100.45 in chips)
Seat 3: 8oS5O7iD/qnFXFXJrGIgNQ ($151.80 in chips)
Seat 4: DHjG71KHeyQxu3OZ+fFd4w ($39.35 in chips)
Seat 5: r1/R7y0Ortgoz4lccgW8VA ($46.55 in chips)
Seat 6: xAU6q2/cwmby2sxmA8VcmA ($104.30 in chips)
xAU6q2/cwmby2sxmA8VcmA: posts small blind $0.50
OvwYHV65yUbgdBjSmo1+5g: posts big blind $1
*** HOLE CARDS ***
RqgF7gRoKgRNW8Zoi1ty4A: raises $3 to $4
8oS5O7iD/qnFXFXJrGIgNQ: folds
DHjG71KHeyQxu3OZ+fFd4w: raises $35.35 to $39.35 and is all-in
r1/R7y0Ortgoz4lccgW8VA: folds
xAU6q2/cwmby2sxmA8VcmA: folds
OvwYHV65yUbgdBjSmo1+5g: folds
RqgF7gRoKgRNW8Zoi1ty4A: calls $35.35
*** FLOP *** [3c Jc 9h]
*** TURN *** [3c Jc 9h] [2h]
*** RIVER *** [3c Jc 9h 2h] [6h]
*** SHOW DOWN ***
RqgF7gRoKgRNW8Zoi1ty4A: shows [Ah Kd] (high card Ace)
DHjG71KHeyQxu3OZ+fFd4w: mucks hand
RqgF7gRoKgRNW8Zoi1ty4A collected $77.20 from pot
*** SUMMARY ***
Total pot $80.20 | Rake $3
Board [3c Jc 9h 2h 6h]
Seat 1: OvwYHV65yUbgdBjSmo1+5g (big blind) folded before Flop
Seat 2: RqgF7gRoKgRNW8Zoi1ty4A showed [Ah Kd] and won ($77.20) with high card Ace
Seat 3: 8oS5O7iD/qnFXFXJrGIgNQ folded before Flop (didn't bet)
Seat 4: DHjG71KHeyQxu3OZ+fFd4w mucked
Seat 5: r1/R7y0Ortgoz4lccgW8VA (button) folded before Flop (didn't bet)
Seat 6: xAU6q2/cwmby2sxmA8VcmA (small blind) folded before Flop



PokerStars Game #59940275392:  Hold'em No Limit ($0.50/$1.00) - 2009/07/01 1:02:03 ET
Table 'tLrtq7gDzxEvckNAI1OS5Q' 6-max Seat #6 is the button
Seat 3: TPZ+m9x+lwoKpv7TMfAUWA ($301.60 in chips)
Seat 4: +uSzP8Jwnw7sKfQ4s66b7w ($43.80 in chips)
Seat 5: OGMLOcTNYZXZU81au7ztUw ($168.35 in chips)
Seat 6: XUk5GQsfNFpHvaToDZ0rZA ($168.40 in chips)
TPZ+m9x+lwoKpv7TMfAUWA: posts small blind $0.50
+uSzP8Jwnw7sKfQ4s66b7w: posts big blind $1
*** HOLE CARDS ***
OGMLOcTNYZXZU81au7ztUw: folds
XUk5GQsfNFpHvaToDZ0rZA: folds
TPZ+m9x+lwoKpv7TMfAUWA: folds
+uSzP8Jwnw7sKfQ4s66b7w collected $1 from pot
*** SUMMARY ***
Total pot $1 | Rake $0
Seat 3: TPZ+m9x+lwoKpv7TMfAUWA (small blind) folded before Flop
Seat 4: +uSzP8Jwnw7sKfQ4s66b7w (big blind) collected ($1)
Seat 5: OGMLOcTNYZXZU81au7ztUw folded before Flop (didn't bet)
Seat 6: XUk5GQsfNFpHvaToDZ0rZA (button) folded before Flop (didn't bet)



PokerStars Game #59940276182:  Hold'em No Limit ($0.50/$1.00) - 2009/07/01 1:02:04 ET
Table 'MUPc8FEpe/nR0BKSeReX6Q' 6-max Seat #2 is the button
Seat 1: qhkK6+yCciTRd+rCFEbnEQ ($40 in chips)
Seat 2: xAU6q2/cwmby2sxmA8VcmA ($121.20 in chips)
Seat 3: wx3sQGkVi2x9wJXuWNHPBw ($236.90 in chips)
Seat 4: ZA1bp6g8IwtTxkUE4eCjDQ ($196.80 in chips)
Seat 5: UBZQqpnJZdTYYY1FTb0rLA ($102.05 in chips)
Seat 6: oxnw0GLLpFanjhGkxfRSqA ($23.70 in chips)
wx3sQGkVi2x9wJXuWNHPBw: posts small blind $0.50
ZA1bp6g8IwtTxkUE4eCjDQ: posts big blind $1
*** HOLE CARDS ***
UBZQqpnJZdTYYY1FTb0rLA: folds
oxnw0GLLpFanjhGkxfRSqA: folds
qhkK6+yCciTRd+rCFEbnEQ: folds
xAU6q2/cwmby2sxmA8VcmA: raises $3 to $4
wx3sQGkVi2x9wJXuWNHPBw: folds
ZA1bp6g8IwtTxkUE4eCjDQ: folds
xAU6q2/cwmby2sxmA8VcmA collected $2.50 from pot
xAU6q2/cwmby2sxmA8VcmA: doesn't show hand
*** SUMMARY ***
Total pot $2.50 | Rake $0
Seat 1: qhkK6+yCciTRd+rCFEbnEQ folded before Flop (didn't bet)
Seat 2: xAU6q2/cwmby2sxmA8VcmA (button) collected ($2.50)
Seat 3: wx3sQGkVi2x9wJXuWNHPBw (small blind) folded before Flop
Seat 4: ZA1bp6g8IwtTxkUE4eCjDQ (big blind) folded before Flop
Seat 5: UBZQqpnJZdTYYY1FTb0rLA folded before Flop (didn't bet)
Seat 6: oxnw0GLLpFanjhGkxfRSqA folded before Flop (didn't bet)



PokerStars Game #59940277160:  Hold'em No Limit ($0.50/$1.00) - 2009/07/01 1:02:06 ET
Table 'GPp0HyAuggN8oE0sUWzPpA' 9-max Seat #6 is the button
Seat 1: qJr25HAtvv1w/7IBvjMM3g ($45.20 in chips)
Seat 2: m3U8I35Pn3gxKhoS2nmYIg ($54.70 in chips)
Seat 3: CCCXsirC+bO7ginAuUUVlQ ($51.70 in chips)
Seat 4: mBRWbnUl8diyBO1qTJaNzw ($107.30 in chips)
Seat 5: 0fXz44fzDo5QmhAaJCvFfA ($14.15 in chips)
Seat 6: BK/GtNPkSx0TdUDj82id5A ($17.85 in chips)
Seat 7: DHdbHyysD15wCAtx+BhUjA ($93.50 in chips)
Seat 8: 6DBvLniKMJADk/t5l29oMA ($26.65 in chips)
Seat 9: VPF+HjszMvUIpy0CHIwH3A ($27.50 in chips)
DHdbHyysD15wCAtx+BhUjA: posts small blind $0.50
6DBvLniKMJADk/t5l29oMA: posts big blind $1
*** HOLE CARDS ***
VPF+HjszMvUIpy0CHIwH3A: folds
qJr25HAtvv1w/7IBvjMM3g: calls $1
m3U8I35Pn3gxKhoS2nmYIg: folds
CCCXsirC+bO7ginAuUUVlQ: calls $1
mBRWbnUl8diyBO1qTJaNzw: folds
0fXz44fzDo5QmhAaJCvFfA: folds
BK/GtNPkSx0TdUDj82id5A: folds
DHdbHyysD15wCAtx+BhUjA: calls $0.50
6DBvLniKMJADk/t5l29oMA: checks
*** FLOP *** [8d Kc 6d]
DHdbHyysD15wCAtx+BhUjA: checks
6DBvLniKMJADk/t5l29oMA: checks
qJr25HAtvv1w/7IBvjMM3g: checks
CCCXsirC+bO7ginAuUUVlQ: bets $2
DHdbHyysD15wCAtx+BhUjA: folds
6DBvLniKMJADk/t5l29oMA: folds
qJr25HAtvv1w/7IBvjMM3g: folds
CCCXsirC+bO7ginAuUUVlQ collected $3.80 from pot
CCCXsirC+bO7ginAuUUVlQ: doesn't show hand
*** SUMMARY ***
Total pot $4 | Rake $0.20
Board [8d Kc 6d]
Seat 1: qJr25HAtvv1w/7IBvjMM3g folded on the Flop
Seat 2: m3U8I35Pn3gxKhoS2nmYIg folded before Flop (didn't bet)
Seat 3: CCCXsirC+bO7ginAuUUVlQ collected ($3.80)
Seat 4: mBRWbnUl8diyBO1qTJaNzw folded before Flop (didn't bet)
Seat 5: 0fXz44fzDo5QmhAaJCvFfA folded before Flop (didn't bet)
Seat 6: BK/GtNPkSx0TdUDj82id5A (button) folded before Flop (didn't bet)
Seat 7: DHdbHyysD15wCAtx+BhUjA (small blind) folded on the Flop
Seat 8: 6DBvLniKMJADk/t5l29oMA (big blind) folded on the Flop
Seat 9: VPF+HjszMvUIpy0CHIwH3A folded before Flop (didn't bet)



PokerStars Game #59940277564:  Hold'em No Limit ($0.50/$1.00) - 2009/07/01 1:02:07 ET
Table 'vs/5jr6ciwjVQ5+Soc+u2A' 6-max Seat #4 is the button
Seat 1: /P4w1pHg2zHYg/4ubJ0dPw ($63.30 in chips)
Seat 3: G5ZSSN6RSON3gkNvk/SmYg ($137.85 in chips)
Seat 4: wk6Ohn4GDozoOMHc4eb2rw ($87.65 in chips)
Seat 5: +Nt3OPk3XR9SKjZgm2CexQ ($101.80 in chips)
+Nt3OPk3XR9SKjZgm2CexQ: posts small blind $0.50
/P4w1pHg2zHYg/4ubJ0dPw: posts big blind $1
lXX4W7m3u++JiSOZ46yVMQ: sits out
*** HOLE CARDS ***
G5ZSSN6RSON3gkNvk/SmYg: folds
wk6Ohn4GDozoOMHc4eb2rw: raises $3 to $4
+Nt3OPk3XR9SKjZgm2CexQ: folds
/P4w1pHg2zHYg/4ubJ0dPw: folds
wk6Ohn4GDozoOMHc4eb2rw collected $2.50 from pot
wk6Ohn4GDozoOMHc4eb2rw: doesn't show hand
*** SUMMARY ***
Total pot $2.50 | Rake $0
Seat 1: /P4w1pHg2zHYg/4ubJ0dPw (big blind) folded before Flop
Seat 3: G5ZSSN6RSON3gkNvk/SmYg folded before Flop (didn't bet)
Seat 4: wk6Ohn4GDozoOMHc4eb2rw (button) collected ($2.50)
Seat 5: +Nt3OPk3XR9SKjZgm2CexQ (small blind) folded before Flop



PokerStars Game #59940277932:  Hold'em No Limit ($0.50/$1.00) - 2009/07/01 1:02:07 ET
Table 'fTlPiCj0utgzC/5io+I7ew' 6-max Seat #2 is the button
Seat 1: YMJG+F++3Aj6P8dAWda5fw ($98.50 in chips)
Seat 2: Qy/UBNbD2HaA0Ogxg8Sf3w ($125.35 in chips)
Seat 3: wL5HjWHHOSGc53xWMNKB9Q ($24.60 in chips)
Seat 4: uJVSceLggtsrJya+WtmUEA ($168.50 in chips)
Seat 5: bFrTkDcWGTxyvNul7GVdYg ($263.05 in chips)
Seat 6: /P4w1pHg2zHYg/4ubJ0dPw ($60 in chips)
wL5HjWHHOSGc53xWMNKB9Q: posts small blind $0.50
uJVSceLggtsrJya+WtmUEA: posts big blind $1
*** HOLE CARDS ***
bFrTkDcWGTxyvNul7GVdYg: folds
/P4w1pHg2zHYg/4ubJ0dPw: raises $2.50 to $3.50
YMJG+F++3Aj6P8dAWda5fw: raises $6.50 to $10
Qy/UBNbD2HaA0Ogxg8Sf3w: folds
wL5HjWHHOSGc53xWMNKB9Q: folds
uJVSceLggtsrJya+WtmUEA: folds
bFrTkDcWGTxyvNul7GVdYg leaves the table
/P4w1pHg2zHYg/4ubJ0dPw: folds
YMJG+F++3Aj6P8dAWda5fw collected $8.50 from pot
*** SUMMARY ***
Total pot $8.50 | Rake $0
Seat 1: YMJG+F++3Aj6P8dAWda5fw collected ($8.50)
Seat 2: Qy/UBNbD2HaA0Ogxg8Sf3w (button) folded before Flop (didn't bet)
Seat 3: wL5HjWHHOSGc53xWMNKB9Q (small blind) folded before Flop
Seat 4: uJVSceLggtsrJya+WtmUEA (big blind) folded before Flop
Seat 5: bFrTkDcWGTxyvNul7GVdYg folded before Flop (didn't bet)
Seat 6: /P4w1pHg2zHYg/4ubJ0dPw folded before Flop



PokerStars Game #59940282210:  Hold'em No Limit ($0.50/$1.00) - 2009/07/01 1:02:14 ET
Table 'LmXQK9xy3awB+qsPzI21Mw' 2-max Seat #2 is the button
Seat 1: NYi6JFscYNrofSXy4sM+Yw ($264.55 in chips)
Seat 2: TME8GvochpQAo8cmJwWmvA ($121.70 in chips)
TME8GvochpQAo8cmJwWmvA: posts small blind $0.50
NYi6JFscYNrofSXy4sM+Yw: posts big blind $1
*** HOLE CARDS ***
TME8GvochpQAo8cmJwWmvA: folds
NYi6JFscYNrofSXy4sM+Yw collected $1 from pot
*** SUMMARY ***
Total pot $1 | Rake $0
Seat 1: NYi6JFscYNrofSXy4sM+Yw (big blind) collected ($1)
Seat 2: TME8GvochpQAo8cmJwWmvA (button) (small blind) folded before Flop



PokerStars Game #59940281802:  Hold'em No Limit ($0.50/$1.00) - 2009/07/01 1:02:14 ET
Table 'tLrtq7gDzxEvckNAI1OS5Q' 6-max Seat #3 is the button
Seat 3: TPZ+m9x+lwoKpv7TMfAUWA ($301.10 in chips)
Seat 4: +uSzP8Jwnw7sKfQ4s66b7w ($44.30 in chips)
Seat 5: OGMLOcTNYZXZU81au7ztUw ($168.35 in chips)
Seat 6: XUk5GQsfNFpHvaToDZ0rZA ($168.40 in chips)
+uSzP8Jwnw7sKfQ4s66b7w: posts small blind $0.50
OGMLOcTNYZXZU81au7ztUw: posts big blind $1
*** HOLE CARDS ***
XUk5GQsfNFpHvaToDZ0rZA: folds
TPZ+m9x+lwoKpv7TMfAUWA: raises $2 to $3
+uSzP8Jwnw7sKfQ4s66b7w: folds
OGMLOcTNYZXZU81au7ztUw: folds
TPZ+m9x+lwoKpv7TMfAUWA collected $2.50 from pot
*** SUMMARY ***
Total pot $2.50 | Rake $0
Seat 3: TPZ+m9x+lwoKpv7TMfAUWA (button) collected ($2.50)
Seat 4: +uSzP8Jwnw7sKfQ4s66b7w (small blind) folded before Flop
Seat 5: OGMLOcTNYZXZU81au7ztUw (big blind) folded before Flop
Seat 6: XUk5GQsfNFpHvaToDZ0rZA folded before Flop (didn't bet)



PokerStars Game #59940281826:  Hold'em No Limit ($0.50/$1.00) - 2009/07/01 1:02:14 ET
Table 'tJq9SfN1ywY0r03VBlWlwQ' 9-max Seat #4 is the button
Seat 1: wZsU+w9r7G66x93UuvBf1Q ($340.80 in chips)
Seat 2: RqkO8O/Y3qlc3PIuCAHjVg ($75.20 in chips)
Seat 3: FVs16t7GgfWgQWt4JxsObQ ($36.90 in chips)
Seat 4: bLbSOSmSOnqE0iTcH/5dxA ($108.70 in chips)
Seat 6: gUUvmqdVlmvpal6B8nYrmg ($115.05 in chips)
Seat 8: G4DEhsZFmznGNVpy2SEocA ($22 in chips)
Seat 9: XE5QF1y74bpHog9JxWJMWQ ($102 in chips)
h5ipsNTMyolp7xn/NAvWkA will be allowed to play after the button
gUUvmqdVlmvpal6B8nYrmg: posts small blind $0.50
rodents: is sitting out
G4DEhsZFmznGNVpy2SEocA: posts big blind $1
*** HOLE CARDS ***
rodents leaves the table
XE5QF1y74bpHog9JxWJMWQ: folds
wZsU+w9r7G66x93UuvBf1Q: folds
RqkO8O/Y3qlc3PIuCAHjVg: calls $1
FVs16t7GgfWgQWt4JxsObQ: calls $1
bLbSOSmSOnqE0iTcH/5dxA has timed out
bLbSOSmSOnqE0iTcH/5dxA: folds
bLbSOSmSOnqE0iTcH/5dxA is sitting out
bLbSOSmSOnqE0iTcH/5dxA has returned
gUUvmqdVlmvpal6B8nYrmg: calls $0.50
G4DEhsZFmznGNVpy2SEocA: checks
*** FLOP *** [2d Kh 6s]
gUUvmqdVlmvpal6B8nYrmg: checks
G4DEhsZFmznGNVpy2SEocA: checks
RqkO8O/Y3qlc3PIuCAHjVg: checks
FVs16t7GgfWgQWt4JxsObQ: checks
*** TURN *** [2d Kh 6s] [4h]
gUUvmqdVlmvpal6B8nYrmg: checks
G4DEhsZFmznGNVpy2SEocA: bets $3
RqkO8O/Y3qlc3PIuCAHjVg: calls $3
FVs16t7GgfWgQWt4JxsObQ: calls $3
gUUvmqdVlmvpal6B8nYrmg: folds
*** RIVER *** [2d Kh 6s 4h] [5d]
G4DEhsZFmznGNVpy2SEocA: checks
RqkO8O/Y3qlc3PIuCAHjVg: checks
FVs16t7GgfWgQWt4JxsObQ: checks
*** SHOW DOWN ***
G4DEhsZFmznGNVpy2SEocA: shows [Th 6h] (a pair of Sixes)
RqkO8O/Y3qlc3PIuCAHjVg: mucks hand
FVs16t7GgfWgQWt4JxsObQ: mucks hand
G4DEhsZFmznGNVpy2SEocA collected $12.40 from pot
*** SUMMARY ***
Total pot $13 | Rake $0.60
Board [2d Kh 6s 4h 5d]
Seat 1: wZsU+w9r7G66x93UuvBf1Q folded before Flop (didn't bet)
Seat 2: RqkO8O/Y3qlc3PIuCAHjVg mucked
Seat 3: FVs16t7GgfWgQWt4JxsObQ mucked
Seat 4: bLbSOSmSOnqE0iTcH/5dxA (button) folded before Flop (didn't bet)
Seat 6: gUUvmqdVlmvpal6B8nYrmg (small blind) folded on the Turn
Seat 8: G4DEhsZFmznGNVpy2SEocA (big blind) showed [Th 6h] and won ($12.40) with a pair of Sixes
Seat 9: XE5QF1y74bpHog9JxWJMWQ folded before Flop (didn't bet)



PokerStars Game #59940282276:  Hold'em No Limit ($0.50/$1.00) - 2009/07/01 1:02:15 ET
Table 'hugOjcwJvzEwZbK7tyiWuQ' 9-max Seat #6 is the button
Seat 1: D+W9Me7w6Hcx/WRUSKV0dw ($32.95 in chips)
Seat 2: r27C1nIV4NS4+qbnrgBQSw ($283.20 in chips)
Seat 3: jDwhY1kCdc6EkAHbT7PJMQ ($104.75 in chips)
Seat 4: UWB3oeddt/GObx2Mix2Anw ($174.80 in chips)
Seat 5: 5BRGWf+R3nt2WS3b5xX+zA ($13.75 in chips)
Seat 6: gUUvmqdVlmvpal6B8nYrmg ($107.40 in chips)
Seat 7: FL3MrLspcF23LYvC4ipBOA ($110.80 in chips)
Seat 8: /zy+DB4S5fUQUSfZWFzYGw ($101 in chips)
FL3MrLspcF23LYvC4ipBOA: posts small blind $0.50
/zy+DB4S5fUQUSfZWFzYGw: posts big blind $1
W8P9bUKCs43TO1xHm0dL6w: sits out
*** HOLE CARDS ***
D+W9Me7w6Hcx/WRUSKV0dw: folds
r27C1nIV4NS4+qbnrgBQSw: folds
jDwhY1kCdc6EkAHbT7PJMQ: folds
UWB3oeddt/GObx2Mix2Anw: folds
5BRGWf+R3nt2WS3b5xX+zA: raises $2 to $3
gUUvmqdVlmvpal6B8nYrmg: folds
FL3MrLspcF23LYvC4ipBOA: folds
/zy+DB4S5fUQUSfZWFzYGw: folds
5BRGWf+R3nt2WS3b5xX+zA collected $2.50 from pot
*** SUMMARY ***
Total pot $2.50 | Rake $0
Seat 1: D+W9Me7w6Hcx/WRUSKV0dw folded before Flop (didn't bet)
Seat 2: r27C1nIV4NS4+qbnrgBQSw folded before Flop (didn't bet)
Seat 3: jDwhY1kCdc6EkAHbT7PJMQ folded before Flop (didn't bet)
Seat 4: UWB3oeddt/GObx2Mix2Anw folded before Flop (didn't bet)
Seat 5: 5BRGWf+R3nt2WS3b5xX+zA collected ($2.50)
Seat 6: gUUvmqdVlmvpal6B8nYrmg (button) folded before Flop (didn't bet)
Seat 7: FL3MrLspcF23LYvC4ipBOA (small blind) folded before Flop
Seat 8: /zy+DB4S5fUQUSfZWFzYGw (big blind) folded before Flop



PokerStars Game #59940283404:  Hold'em No Limit ($0.50/$1.00) - 2009/07/01 1:02:16 ET
Table 'eU3bWpDDg3Z+9R4m4iVmog' 6-max Seat #1 is the button
Seat 1: TSuRyAHnUPCFjP7Z0rEE0w ($189.65 in chips)
Seat 2: 8CAoOzhmB8n3nRFf3V4BTg ($59.80 in chips)
Seat 3: rVMOzU7w5FddYPGhD7qN2Q ($48.15 in chips)
Seat 4: GDVIsbEJ/DOJsMKE4Asz0A ($99 in chips)
Seat 6: hpxXcmRkXXI9HE5+5/j/0Q ($131.25 in chips)
8CAoOzhmB8n3nRFf3V4BTg: posts small blind $0.50
rVMOzU7w5FddYPGhD7qN2Q: posts big blind $1
*** HOLE CARDS ***
GDVIsbEJ/DOJsMKE4Asz0A: raises $2 to $3
hpxXcmRkXXI9HE5+5/j/0Q: calls $3
TSuRyAHnUPCFjP7Z0rEE0w: folds
8CAoOzhmB8n3nRFf3V4BTg: folds
rVMOzU7w5FddYPGhD7qN2Q: folds
*** FLOP *** [7h Qs Kh]
GDVIsbEJ/DOJsMKE4Asz0A: bets $3
hpxXcmRkXXI9HE5+5/j/0Q: folds
GDVIsbEJ/DOJsMKE4Asz0A collected $7.15 from pot
GDVIsbEJ/DOJsMKE4Asz0A: doesn't show hand
*** SUMMARY ***
Total pot $7.50 | Rake $0.35
Board [7h Qs Kh]
Seat 1: TSuRyAHnUPCFjP7Z0rEE0w (button) folded before Flop (didn't bet)
Seat 2: 8CAoOzhmB8n3nRFf3V4BTg (small blind) folded before Flop
Seat 3: rVMOzU7w5FddYPGhD7qN2Q (big blind) folded before Flop
Seat 4: GDVIsbEJ/DOJsMKE4Asz0A collected ($7.15)
Seat 6: hpxXcmRkXXI9HE5+5/j/0Q folded on the Flop



PokerStars Game #59940283010:  Hold'em No Limit ($0.50/$1.00) - 2009/07/01 1:02:16 ET
Table 'kS0cTQAEi+fdUlJP2gQYvw' 9-max Seat #8 is the button
Seat 1: c/9X4zftzphFxYtxp5kp9w ($65.85 in chips)
Seat 2: D+W9Me7w6Hcx/WRUSKV0dw ($20 in chips)
Seat 3: 2BV+oJIQYr65IO6nEChvbA ($60 in chips)
Seat 4: TZcz9MEWDA+WydgGruqqbw ($100.10 in chips)
Seat 5: 997ViqAtWn1FPjJqcffwcA ($104.15 in chips)
Seat 6: yAbu2QsRPVcjPbqlf/jDxw ($127.65 in chips)
Seat 7: Ffa7Nj4X5fddtROP01hfQg ($131.15 in chips)
Seat 8: QYMfy2FoN6/Qe1LWYuI7fw ($20.50 in chips)
Seat 9: OGgaARGdJQT4awWVNQ957w ($102.50 in chips)
OGgaARGdJQT4awWVNQ957w: posts small blind $0.50
c/9X4zftzphFxYtxp5kp9w: posts big blind $1
*** HOLE CARDS ***
D+W9Me7w6Hcx/WRUSKV0dw: folds
2BV+oJIQYr65IO6nEChvbA: folds
TZcz9MEWDA+WydgGruqqbw: folds
997ViqAtWn1FPjJqcffwcA: folds
yAbu2QsRPVcjPbqlf/jDxw: folds
Ffa7Nj4X5fddtROP01hfQg: calls $1
QYMfy2FoN6/Qe1LWYuI7fw: folds
OGgaARGdJQT4awWVNQ957w: folds
c/9X4zftzphFxYtxp5kp9w: checks
*** FLOP *** [4s Jd 7c]
c/9X4zftzphFxYtxp5kp9w: checks
Ffa7Nj4X5fddtROP01hfQg: checks
*** TURN *** [4s Jd 7c] [Tc]
c/9X4zftzphFxYtxp5kp9w: checks
Ffa7Nj4X5fddtROP01hfQg: bets $2
c/9X4zftzphFxYtxp5kp9w: folds
Ffa7Nj4X5fddtROP01hfQg collected $2.40 from pot
*** SUMMARY ***
Total pot $2.50 | Rake $0.10
Board [4s Jd 7c Tc]
Seat 1: c/9X4zftzphFxYtxp5kp9w (big blind) folded on the Turn
Seat 2: D+W9Me7w6Hcx/WRUSKV0dw folded before Flop (didn't bet)
Seat 3: 2BV+oJIQYr65IO6nEChvbA folded before Flop (didn't bet)
Seat 4: TZcz9MEWDA+WydgGruqqbw folded before Flop (didn't bet)
Seat 5: 997ViqAtWn1FPjJqcffwcA folded before Flop (didn't bet)
Seat 6: yAbu2QsRPVcjPbqlf/jDxw folded before Flop (didn't bet)
Seat 7: Ffa7Nj4X5fddtROP01hfQg collected ($2.40)
Seat 8: QYMfy2FoN6/Qe1LWYuI7fw (button) folded before Flop (didn't bet)
Seat 9: OGgaARGdJQT4awWVNQ957w (small blind) folded before Flop



PokerStars Game #59940284066:  Hold'em No Limit ($0.50/$1.00) - 2009/07/01 1:02:18 ET
Table 'JTT1XWaDZHSaMZQK7cR5uw' 2-max Seat #1 is the button
Seat 1: OLplZF6FEnLflv81Hz+Fxg ($119.05 in chips)
Seat 2: BcqgegiOUxmBD3F3umsljg ($91.25 in chips)
OLplZF6FEnLflv81Hz+Fxg: posts small blind $0.50
BcqgegiOUxmBD3F3umsljg: posts big blind $1
*** HOLE CARDS ***
OLplZF6FEnLflv81Hz+Fxg: raises $2 to $3
BcqgegiOUxmBD3F3umsljg: raises $2 to $5
OLplZF6FEnLflv81Hz+Fxg: calls $2
*** FLOP *** [7s Js 3s]
BcqgegiOUxmBD3F3umsljg: checks
OLplZF6FEnLflv81Hz+Fxg: checks
*** TURN *** [7s Js 3s] [2s]
BcqgegiOUxmBD3F3umsljg: bets $5
OLplZF6FEnLflv81Hz+Fxg: raises $11 to $16
BcqgegiOUxmBD3F3umsljg: folds
OLplZF6FEnLflv81Hz+Fxg collected $19.50 from pot
OLplZF6FEnLflv81Hz+Fxg: doesn't show hand
*** SUMMARY ***
Total pot $20 | Rake $0.50
Board [7s Js 3s 2s]
Seat 1: OLplZF6FEnLflv81Hz+Fxg (button) (small blind) collected ($19.50)
Seat 2: BcqgegiOUxmBD3F3umsljg (big blind) folded on the Turn



PokerStars Game #59940284874:  Hold'em No Limit ($0.50/$1.00) - 2009/07/01 1:02:19 ET
Table 'vs/5jr6ciwjVQ5+Soc+u2A' 6-max Seat #5 is the button
Seat 1: /P4w1pHg2zHYg/4ubJ0dPw ($62.30 in chips)
Seat 2: lXX4W7m3u++JiSOZ46yVMQ ($100 in chips)
Seat 3: G5ZSSN6RSON3gkNvk/SmYg ($137.85 in chips)
Seat 4: wk6Ohn4GDozoOMHc4eb2rw ($89.15 in chips)
Seat 5: +Nt3OPk3XR9SKjZgm2CexQ ($101.30 in chips)
/P4w1pHg2zHYg/4ubJ0dPw: posts small blind $0.50
lXX4W7m3u++JiSOZ46yVMQ: posts big blind $1
*** HOLE CARDS ***
G5ZSSN6RSON3gkNvk/SmYg: raises $3 to $4
wk6Ohn4GDozoOMHc4eb2rw: folds
+Nt3OPk3XR9SKjZgm2CexQ: folds
/P4w1pHg2zHYg/4ubJ0dPw: folds
lXX4W7m3u++JiSOZ46yVMQ: folds
G5ZSSN6RSON3gkNvk/SmYg collected $2.50 from pot
G5ZSSN6RSON3gkNvk/SmYg: doesn't show hand
*** SUMMARY ***
Total pot $2.50 | Rake $0
Seat 1: /P4w1pHg2zHYg/4ubJ0dPw (small blind) folded before Flop
Seat 2: lXX4W7m3u++JiSOZ46yVMQ (big blind) folded before Flop
Seat 3: G5ZSSN6RSON3gkNvk/SmYg collected ($2.50)
Seat 4: wk6Ohn4GDozoOMHc4eb2rw folded before Flop (didn't bet)
Seat 5: +Nt3OPk3XR9SKjZgm2CexQ (button) folded before Flop (didn't bet)



PokerStars Game #59940285390:  Hold'em No Limit ($0.50/$1.00) - 2009/07/01 1:02:20 ET
Table 'LmXQK9xy3awB+qsPzI21Mw' 2-max Seat #1 is the button
Seat 1: NYi6JFscYNrofSXy4sM+Yw ($265.05 in chips)
Seat 2: TME8GvochpQAo8cmJwWmvA ($121.20 in chips)
NYi6JFscYNrofSXy4sM+Yw: posts small blind $0.50
TME8GvochpQAo8cmJwWmvA: posts big blind $1
*** HOLE CARDS ***
NYi6JFscYNrofSXy4sM+Yw: raises $2 to $3
TME8GvochpQAo8cmJwWmvA: folds
NYi6JFscYNrofSXy4sM+Yw collected $2 from pot
*** SUMMARY ***
Total pot $2 | Rake $0
Seat 1: NYi6JFscYNrofSXy4sM+Yw (button) (small blind) collected ($2)
Seat 2: TME8GvochpQAo8cmJwWmvA (big blind) folded before Flop



PokerStars Game #59940285128:  Hold'em No Limit ($0.50/$1.00) - 2009/07/01 1:02:20 ET
Table 'MUPc8FEpe/nR0BKSeReX6Q' 6-max Seat #3 is the button
Seat 1: qhkK6+yCciTRd+rCFEbnEQ ($40 in chips)
Seat 2: xAU6q2/cwmby2sxmA8VcmA ($122.70 in chips)
Seat 3: wx3sQGkVi2x9wJXuWNHPBw ($236.40 in chips)
Seat 4: ZA1bp6g8IwtTxkUE4eCjDQ ($195.80 in chips)
Seat 5: UBZQqpnJZdTYYY1FTb0rLA ($102.05 in chips)
Seat 6: oxnw0GLLpFanjhGkxfRSqA ($23.70 in chips)
ZA1bp6g8IwtTxkUE4eCjDQ: posts small blind $0.50
UBZQqpnJZdTYYY1FTb0rLA: posts big blind $1
*** HOLE CARDS ***
oxnw0GLLpFanjhGkxfRSqA: folds
qhkK6+yCciTRd+rCFEbnEQ: raises $2 to $3
xAU6q2/cwmby2sxmA8VcmA: folds
wx3sQGkVi2x9wJXuWNHPBw: folds
ZA1bp6g8IwtTxkUE4eCjDQ: folds
UBZQqpnJZdTYYY1FTb0rLA: calls $2
*** FLOP *** [6d 2c Jc]
UBZQqpnJZdTYYY1FTb0rLA: checks
qhkK6+yCciTRd+rCFEbnEQ: bets $3
UBZQqpnJZdTYYY1FTb0rLA: folds
qhkK6+yCciTRd+rCFEbnEQ collected $6.20 from pot
qhkK6+yCciTRd+rCFEbnEQ: doesn't show hand
*** SUMMARY ***
Total pot $6.50 | Rake $0.30
Board [6d 2c Jc]
Seat 1: qhkK6+yCciTRd+rCFEbnEQ collected ($6.20)
Seat 2: xAU6q2/cwmby2sxmA8VcmA folded before Flop (didn't bet)
Seat 3: wx3sQGkVi2x9wJXuWNHPBw (button) folded before Flop (didn't bet)
Seat 4: ZA1bp6g8IwtTxkUE4eCjDQ (small blind) folded before Flop
Seat 5: UBZQqpnJZdTYYY1FTb0rLA (big blind) folded on the Flop
Seat 6: oxnw0GLLpFanjhGkxfRSqA folded before Flop (didn't bet)



PokerStars Game #59940286262:  Hold'em No Limit ($0.50/$1.00) - 2009/07/01 1:02:21 ET
Table 'rmZfTK+oSebeUPJNbWhdAA' 6-max Seat #4 is the button
Seat 1: xAU6q2/cwmby2sxmA8VcmA ($146.50 in chips)
Seat 2: z7O9PO/WEcqRouIydFhS9Q ($121.05 in chips)
Seat 3: BCEV3COoKY607AzLWayfRA ($134 in chips)
Seat 4: 1/mIuXfgx1ZyVkodrmfQDw ($102.70 in chips)
Seat 5: 5lY8d6Cnm4HUkt/8FZSj4g ($90.90 in chips)
5lY8d6Cnm4HUkt/8FZSj4g: posts small blind $0.50
j7NIOHLZk7V2o9fOioO5ug has timed out
j7NIOHLZk7V2o9fOioO5ug: is sitting out
xAU6q2/cwmby2sxmA8VcmA: posts big blind $1
*** HOLE CARDS ***
z7O9PO/WEcqRouIydFhS9Q: folds
BCEV3COoKY607AzLWayfRA: folds
1/mIuXfgx1ZyVkodrmfQDw: folds
5lY8d6Cnm4HUkt/8FZSj4g: calls $0.50
xAU6q2/cwmby2sxmA8VcmA: raises $4 to $5
5lY8d6Cnm4HUkt/8FZSj4g: folds
xAU6q2/cwmby2sxmA8VcmA collected $2 from pot
xAU6q2/cwmby2sxmA8VcmA: doesn't show hand
*** SUMMARY ***
Total pot $2 | Rake $0
Seat 1: xAU6q2/cwmby2sxmA8VcmA (big blind) collected ($2)
Seat 2: z7O9PO/WEcqRouIydFhS9Q folded before Flop (didn't bet)
Seat 3: BCEV3COoKY607AzLWayfRA folded before Flop (didn't bet)
Seat 4: 1/mIuXfgx1ZyVkodrmfQDw (button) folded before Flop (didn't bet)
Seat 5: 5lY8d6Cnm4HUkt/8FZSj4g (small blind) folded before Flop



PokerStars Game #59940288868:  Hold'em No Limit ($0.50/$1.00) - 2009/07/01 1:02:26 ET
Table '+cA8mcmhaedZ7YcrDdhmeQ' 6-max Seat #4 is the button
Seat 1: lsLuWlcPA3Rh7kJVLzMh0Q ($302.45 in chips)
Seat 2: RqgF7gRoKgRNW8Zoi1ty4A ($110.55 in chips)
Seat 3: 7H5WkGzGvsv56y1iaqHvRg ($23.20 in chips)
Seat 4: 4OO5v3AVduL0tePNx8wk5A ($101 in chips)
Seat 5: +7hFKAL0b0O/n8G72TclJA ($65.35 in chips)
Seat 6: YfsTQsY/fxb+YqbdclTHuw ($23.60 in chips)
+7hFKAL0b0O/n8G72TclJA: posts small blind $0.50
YfsTQsY/fxb+YqbdclTHuw: posts big blind $1
*** HOLE CARDS ***
lsLuWlcPA3Rh7kJVLzMh0Q: folds
RqgF7gRoKgRNW8Zoi1ty4A: folds
7H5WkGzGvsv56y1iaqHvRg: calls $1
4OO5v3AVduL0tePNx8wk5A: folds
+7hFKAL0b0O/n8G72TclJA: calls $0.50
YfsTQsY/fxb+YqbdclTHuw: raises $4 to $5
7H5WkGzGvsv56y1iaqHvRg: folds
+7hFKAL0b0O/n8G72TclJA: folds
YfsTQsY/fxb+YqbdclTHuw collected $3 from pot
*** SUMMARY ***
Total pot $3 | Rake $0
Seat 1: lsLuWlcPA3Rh7kJVLzMh0Q folded before Flop (didn't bet)
Seat 2: RqgF7gRoKgRNW8Zoi1ty4A folded before Flop (didn't bet)
Seat 3: 7H5WkGzGvsv56y1iaqHvRg folded before Flop
Seat 4: 4OO5v3AVduL0tePNx8wk5A (button) folded before Flop (didn't bet)
Seat 5: +7hFKAL0b0O/n8G72TclJA (small blind) folded before Flop
Seat 6: YfsTQsY/fxb+YqbdclTHuw (big blind) collected ($3)



PokerStars Game #59940289180:  Hold'em No Limit ($0.50/$1.00) - 2009/07/01 1:02:26 ET
Table 'LmXQK9xy3awB+qsPzI21Mw' 2-max Seat #2 is the button
Seat 1: NYi6JFscYNrofSXy4sM+Yw ($266.05 in chips)
Seat 2: TME8GvochpQAo8cmJwWmvA ($120.20 in chips)
TME8GvochpQAo8cmJwWmvA: posts small blind $0.50
NYi6JFscYNrofSXy4sM+Yw: posts big blind $1
*** HOLE CARDS ***
TME8GvochpQAo8cmJwWmvA: folds
NYi6JFscYNrofSXy4sM+Yw collected $1 from pot
*** SUMMARY ***
Total pot $1 | Rake $0
Seat 1: NYi6JFscYNrofSXy4sM+Yw (big blind) collected ($1)
Seat 2: TME8GvochpQAo8cmJwWmvA (button) (small blind) folded before Flop



PokerStars Game #59940289278:  Hold'em No Limit ($0.50/$1.00) - 2009/07/01 1:02:27 ET
Table 'VOs36P6NW+QyXeQ1B62kmA' 6-max Seat #5 is the button
Seat 1: Z2fXsGcjl+Eax+RzOgwOmg ($100 in chips)
Seat 2: 2UMlbaZ8n8AbRli0Yr0mDw ($28.85 in chips)
Seat 3: TSuRyAHnUPCFjP7Z0rEE0w ($106.40 in chips)
Seat 4: w02zQzNydODiyV9THKgo9w ($45.20 in chips)
Seat 5: ozrlafxxh1HmYdA0/h+MuA ($31.85 in chips)
Seat 6: slVKuQyEz8Qj4E3uLPYNXg ($97.50 in chips)
slVKuQyEz8Qj4E3uLPYNXg: posts small blind $0.50
Z2fXsGcjl+Eax+RzOgwOmg: posts big blind $1
*** HOLE CARDS ***
2UMlbaZ8n8AbRli0Yr0mDw: calls $1
TSuRyAHnUPCFjP7Z0rEE0w: folds
w02zQzNydODiyV9THKgo9w: calls $1
ozrlafxxh1HmYdA0/h+MuA: folds
slVKuQyEz8Qj4E3uLPYNXg: folds
Z2fXsGcjl+Eax+RzOgwOmg: checks
*** FLOP *** [5h 3c 2d]
Z2fXsGcjl+Eax+RzOgwOmg: checks
2UMlbaZ8n8AbRli0Yr0mDw: bets $2
w02zQzNydODiyV9THKgo9w: folds
Z2fXsGcjl+Eax+RzOgwOmg: folds
2UMlbaZ8n8AbRli0Yr0mDw collected $3.35 from pot
2UMlbaZ8n8AbRli0Yr0mDw: doesn't show hand
*** SUMMARY ***
Total pot $3.50 | Rake $0.15
Board [5h 3c 2d]
Seat 1: Z2fXsGcjl+Eax+RzOgwOmg (big blind) folded on the Flop
Seat 2: 2UMlbaZ8n8AbRli0Yr0mDw collected ($3.35)
Seat 3: TSuRyAHnUPCFjP7Z0rEE0w folded before Flop (didn't bet)
Seat 4: w02zQzNydODiyV9THKgo9w folded on the Flop
Seat 5: ozrlafxxh1HmYdA0/h+MuA (button) folded before Flop (didn't bet)
Seat 6: slVKuQyEz8Qj4E3uLPYNXg (small blind) folded before Flop



PokerStars Game #59940290166:  Hold'em No Limit ($0.50/$1.00) - 2009/07/01 1:02:28 ET
Table '8jIjWCPY0NGprquL+xcMFg' 9-max Seat #5 is the button
Seat 1: N7iZ0peZns5o4A6AjN24jQ ($45.60 in chips)
Seat 2: laA8va+Yv8WuMqT1zdR91g ($108.70 in chips)
Seat 3: tjhwe1V98x2spSoUQER3HQ ($103 in chips)
Seat 4: Jjc7EHWzs4//xUAjJ0UWoA ($18.90 in chips)
Seat 5: 2YpnxJiexJHyERfbqgwEcw ($53.55 in chips)
Seat 6: GTQkFJtSkbVbnGCktp6e3g ($100.35 in chips)
Seat 7: O3CGPwwUmamrCNHccOilrg ($41.45 in chips)
Seat 8: D+W9Me7w6Hcx/WRUSKV0dw ($18.50 in chips)
Seat 9: negfosHnGOZXSHpWDRKyBQ ($57.65 in chips)
GTQkFJtSkbVbnGCktp6e3g: posts small blind $0.50
O3CGPwwUmamrCNHccOilrg: posts big blind $1
*** HOLE CARDS ***
D+W9Me7w6Hcx/WRUSKV0dw: folds
negfosHnGOZXSHpWDRKyBQ: folds
N7iZ0peZns5o4A6AjN24jQ: calls $1
laA8va+Yv8WuMqT1zdR91g: folds
tjhwe1V98x2spSoUQER3HQ: raises $4 to $5
Jjc7EHWzs4//xUAjJ0UWoA: folds
2YpnxJiexJHyERfbqgwEcw: folds
GTQkFJtSkbVbnGCktp6e3g: folds
O3CGPwwUmamrCNHccOilrg: calls $4
N7iZ0peZns5o4A6AjN24jQ: folds
*** FLOP *** [8s 3c 2s]
O3CGPwwUmamrCNHccOilrg: checks
tjhwe1V98x2spSoUQER3HQ: bets $7
O3CGPwwUmamrCNHccOilrg: folds
tjhwe1V98x2spSoUQER3HQ collected $10.95 from pot
tjhwe1V98x2spSoUQER3HQ: doesn't show hand
*** SUMMARY ***
Total pot $11.50 | Rake $0.55
Board [8s 3c 2s]
Seat 1: N7iZ0peZns5o4A6AjN24jQ folded before Flop
Seat 2: laA8va+Yv8WuMqT1zdR91g folded before Flop (didn't bet)
Seat 3: tjhwe1V98x2spSoUQER3HQ collected ($10.95)
Seat 4: Jjc7EHWzs4//xUAjJ0UWoA folded before Flop (didn't bet)
Seat 5: 2YpnxJiexJHyERfbqgwEcw (button) folded before Flop (didn't bet)
Seat 6: GTQkFJtSkbVbnGCktp6e3g (small blind) folded before Flop
Seat 7: O3CGPwwUmamrCNHccOilrg (big blind) folded on the Flop
Seat 8: D+W9Me7w6Hcx/WRUSKV0dw folded before Flop (didn't bet)
Seat 9: negfosHnGOZXSHpWDRKyBQ folded before Flop (didn't bet)



PokerStars Game #59940290506:  Hold'em No Limit ($0.50/$1.00) - 2009/07/01 1:02:29 ET
Table '/FUb199IViHMJHi5YWmeuQ' 9-max Seat #7 is the button
Seat 1: TZcz9MEWDA+WydgGruqqbw ($120 in chips)
Seat 2: FL3MrLspcF23LYvC4ipBOA ($178.05 in chips)
Seat 3: qN483QJ1NvHbdIZB7J4ARw ($13.70 in chips)
Seat 4: qheQay5YvP2DMAb3OUSxtw ($147.80 in chips)
Seat 6: ccFf7Q4z1cTGQmeoYiWEfw ($53.30 in chips)
Seat 7: bLbSOSmSOnqE0iTcH/5dxA ($100 in chips)
Seat 8: 997ViqAtWn1FPjJqcffwcA ($102 in chips)
Seat 9: RfLbneGRY8yQUpMgDnJCxA ($70.80 in chips)
997ViqAtWn1FPjJqcffwcA: posts small blind $0.50
RfLbneGRY8yQUpMgDnJCxA: posts big blind $1
H+DVy3Ei8L1UKS2tVOtJcw: sits out
*** HOLE CARDS ***
TZcz9MEWDA+WydgGruqqbw: folds
FL3MrLspcF23LYvC4ipBOA: folds
qN483QJ1NvHbdIZB7J4ARw: folds
qN483QJ1NvHbdIZB7J4ARw leaves the table
qheQay5YvP2DMAb3OUSxtw: raises $2 to $3
ccFf7Q4z1cTGQmeoYiWEfw: folds
DOLzOcBTZYcph5jEfKFWuQ joins the table at seat #3
DOLzOcBTZYcph5jEfKFWuQ leaves the table
bLbSOSmSOnqE0iTcH/5dxA has timed out
bLbSOSmSOnqE0iTcH/5dxA: folds
bLbSOSmSOnqE0iTcH/5dxA is sitting out
997ViqAtWn1FPjJqcffwcA: raises $8 to $11
RfLbneGRY8yQUpMgDnJCxA: folds
qheQay5YvP2DMAb3OUSxtw: folds
997ViqAtWn1FPjJqcffwcA collected $7 from pot
*** SUMMARY ***
Total pot $7 | Rake $0
Seat 1: TZcz9MEWDA+WydgGruqqbw folded before Flop (didn't bet)
Seat 2: FL3MrLspcF23LYvC4ipBOA folded before Flop (didn't bet)
Seat 3: qN483QJ1NvHbdIZB7J4ARw folded before Flop (didn't bet)
Seat 4: qheQay5YvP2DMAb3OUSxtw folded before Flop
Seat 6: ccFf7Q4z1cTGQmeoYiWEfw folded before Flop (didn't bet)
Seat 7: bLbSOSmSOnqE0iTcH/5dxA (button) folded before Flop (didn't bet)
Seat 8: 997ViqAtWn1FPjJqcffwcA (small blind) collected ($7)
Seat 9: RfLbneGRY8yQUpMgDnJCxA (big blind) folded before Flop



PokerStars Game #59940291840:  Hold'em No Limit ($0.50/$1.00) - 2009/07/01 1:02:31 ET
Table 'cKH9c4x6u79IqCdaKKvXrw' 9-max Seat #5 is the button
Seat 1: Pp/KTcXkfZKKUHkjyaLTdg ($20 in chips)
Seat 2: 8S3JMH4TY3whgIlZmMv66w ($67.65 in chips)
Seat 3: 997ViqAtWn1FPjJqcffwcA ($157.10 in chips)
Seat 4: FL3MrLspcF23LYvC4ipBOA ($100 in chips)
Seat 5: Jjc7EHWzs4//xUAjJ0UWoA ($40.65 in chips)
Seat 6: Bsd/K5gAcLanYbGiPirRjw ($209.55 in chips)
Seat 7: 1GkkVBhlJ92guE6K5mS5Ig ($15.55 in chips)
Seat 8: myIxN7otsyr846M539YR8Q ($18.50 in chips)
Seat 9: 6XkTu4ahxzHnvjjc1R8YjQ ($41.60 in chips)
Bsd/K5gAcLanYbGiPirRjw: posts small blind $0.50
1GkkVBhlJ92guE6K5mS5Ig: posts big blind $1
*** HOLE CARDS ***
myIxN7otsyr846M539YR8Q: folds
6XkTu4ahxzHnvjjc1R8YjQ: folds
Pp/KTcXkfZKKUHkjyaLTdg: folds
8S3JMH4TY3whgIlZmMv66w: folds
997ViqAtWn1FPjJqcffwcA: folds
FL3MrLspcF23LYvC4ipBOA: folds
Jjc7EHWzs4//xUAjJ0UWoA: folds
Bsd/K5gAcLanYbGiPirRjw: raises $2 to $3
1GkkVBhlJ92guE6K5mS5Ig: calls $2
*** FLOP *** [8h 9s 2c]
Bsd/K5gAcLanYbGiPirRjw: checks
1GkkVBhlJ92guE6K5mS5Ig: checks
*** TURN *** [8h 9s 2c] [Kd]
Bsd/K5gAcLanYbGiPirRjw: checks
1GkkVBhlJ92guE6K5mS5Ig: checks
*** RIVER *** [8h 9s 2c Kd] [3s]
Bsd/K5gAcLanYbGiPirRjw: checks
1GkkVBhlJ92guE6K5mS5Ig: checks
*** SHOW DOWN ***
Bsd/K5gAcLanYbGiPirRjw: shows [Ac 5h] (high card Ace)
1GkkVBhlJ92guE6K5mS5Ig: shows [4d 8d] (a pair of Eights)
1GkkVBhlJ92guE6K5mS5Ig collected $5.70 from pot
*** SUMMARY ***
Total pot $6 | Rake $0.30
Board [8h 9s 2c Kd 3s]
Seat 1: Pp/KTcXkfZKKUHkjyaLTdg folded before Flop (didn't bet)
Seat 2: 8S3JMH4TY3whgIlZmMv66w folded before Flop (didn't bet)
Seat 3: 997ViqAtWn1FPjJqcffwcA folded before Flop (didn't bet)
Seat 4: FL3MrLspcF23LYvC4ipBOA folded before Flop (didn't bet)
Seat 5: Jjc7EHWzs4//xUAjJ0UWoA (button) folded before Flop (didn't bet)
Seat 6: Bsd/K5gAcLanYbGiPirRjw (small blind) showed [Ac 5h] and lost with high card Ace
Seat 7: 1GkkVBhlJ92guE6K5mS5Ig (big blind) showed [4d 8d] and won ($5.70) with a pair of Eights
Seat 8: myIxN7otsyr846M539YR8Q folded before Flop (didn't bet)
Seat 9: 6XkTu4ahxzHnvjjc1R8YjQ folded before Flop (didn't bet)



PokerStars Game #59940291992:  Hold'em No Limit ($0.50/$1.00) - 2009/07/01 1:02:31 ET
Table 'O96CPOtvMBWP6kzuYDfdFA' 6-max Seat #3 is the button
Seat 1: 6alLXQIITA2EZ/lBeym8Dw ($119.55 in chips)
Seat 2: yynBOXUjw28V5kz84sxX4g ($11.40 in chips)
Seat 3: V89DGjxE171oPREEbAXiyg ($83.10 in chips)
Seat 4: /P4w1pHg2zHYg/4ubJ0dPw ($61.40 in chips)
Seat 5: G5ZSSN6RSON3gkNvk/SmYg ($100 in chips)
Seat 6: GYei5jXGWexiJYbAT2fELg ($24.35 in chips)
/P4w1pHg2zHYg/4ubJ0dPw: posts small blind $0.50
G5ZSSN6RSON3gkNvk/SmYg: posts big blind $1
*** HOLE CARDS ***
GYei5jXGWexiJYbAT2fELg: folds
6alLXQIITA2EZ/lBeym8Dw: raises $2 to $3
yynBOXUjw28V5kz84sxX4g: raises $8.40 to $11.40 and is all-in
V89DGjxE171oPREEbAXiyg: calls $11.40
/P4w1pHg2zHYg/4ubJ0dPw: folds
G5ZSSN6RSON3gkNvk/SmYg: folds
6alLXQIITA2EZ/lBeym8Dw: raises $28.60 to $40
V89DGjxE171oPREEbAXiyg: raises $28.60 to $68.60
6alLXQIITA2EZ/lBeym8Dw: raises $31.40 to $100
V89DGjxE171oPREEbAXiyg: calls $14.50 and is all-in
*** FLOP *** [Ts 5s Jh]
*** TURN *** [Ts 5s Jh] [Ks]
*** RIVER *** [Ts 5s Jh Ks] [7h]
*** SHOW DOWN ***
6alLXQIITA2EZ/lBeym8Dw: shows [Ad Kh] (a pair of Kings)
V89DGjxE171oPREEbAXiyg: shows [Ac Kc] (a pair of Kings)
6alLXQIITA2EZ/lBeym8Dw collected $71.10 from side pot
V89DGjxE171oPREEbAXiyg collected $71.05 from side pot
yynBOXUjw28V5kz84sxX4g: mucks hand
6alLXQIITA2EZ/lBeym8Dw collected $17 from main pot
V89DGjxE171oPREEbAXiyg collected $16.95 from main pot
*** SUMMARY ***
Total pot $179.10 Main pot $33.95. Side pot $142.15. | Rake $3
Board [Ts 5s Jh Ks 7h]
Seat 1: 6alLXQIITA2EZ/lBeym8Dw showed [Ad Kh] and won ($88.10) with a pair of Kings
Seat 2: yynBOXUjw28V5kz84sxX4g mucked
Seat 3: V89DGjxE171oPREEbAXiyg (button) showed [Ac Kc] and won ($88) with a pair of Kings
Seat 4: /P4w1pHg2zHYg/4ubJ0dPw (small blind) folded before Flop
Seat 5: G5ZSSN6RSON3gkNvk/SmYg (big blind) folded before Flop
Seat 6: GYei5jXGWexiJYbAT2fELg folded before Flop (didn't bet)



PokerStars Game #59940292334:  Hold'em No Limit ($0.50/$1.00) - 2009/07/01 1:02:32 ET
Table 'LmXQK9xy3awB+qsPzI21Mw' 2-max Seat #1 is the button
Seat 1: NYi6JFscYNrofSXy4sM+Yw ($266.55 in chips)
Seat 2: TME8GvochpQAo8cmJwWmvA ($119.70 in chips)
NYi6JFscYNrofSXy4sM+Yw: posts small blind $0.50
TME8GvochpQAo8cmJwWmvA: posts big blind $1
*** HOLE CARDS ***
NYi6JFscYNrofSXy4sM+Yw: raises $2 to $3
TME8GvochpQAo8cmJwWmvA: raises $4 to $7
NYi6JFscYNrofSXy4sM+Yw: folds
TME8GvochpQAo8cmJwWmvA collected $6 from pot
TME8GvochpQAo8cmJwWmvA: doesn't show hand
*** SUMMARY ***
Total pot $6 | Rake $0
Seat 1: NYi6JFscYNrofSXy4sM+Yw (button) (small blind) folded before Flop
Seat 2: TME8GvochpQAo8cmJwWmvA (big blind) collected ($6)



PokerStars Game #59940293298:  Hold'em No Limit ($0.50/$1.00) - 2009/07/01 1:02:33 ET
Table 'W/wyObTiXZm+Ckkl3YxcSw' 6-max Seat #4 is the button
Seat 1: eUBBn2R56C1IQ6Cs/vitwg ($201.25 in chips)
Seat 2: oDiBRCaF0QVtd3kO6xZIXw ($107.85 in chips)
Seat 3: dxyNCn/qxfkGDUIf28Cbng ($83.90 in chips)
Seat 4: aYii2DmxlOlbC1wbGRBWvQ ($99.80 in chips)
OGMLOcTNYZXZU81au7ztUw will be allowed to play after the button
eUBBn2R56C1IQ6Cs/vitwg: posts small blind $0.50
oDiBRCaF0QVtd3kO6xZIXw: posts big blind $1
*** HOLE CARDS ***
dxyNCn/qxfkGDUIf28Cbng: folds
aYii2DmxlOlbC1wbGRBWvQ: folds
eUBBn2R56C1IQ6Cs/vitwg: raises $2 to $3
xPeM3 leaves the table
oDiBRCaF0QVtd3kO6xZIXw: calls $2
*** FLOP *** [Ks 4s 5c]
eUBBn2R56C1IQ6Cs/vitwg: bets $4
oDiBRCaF0QVtd3kO6xZIXw: raises $8 to $12
eUBBn2R56C1IQ6Cs/vitwg: folds
oDiBRCaF0QVtd3kO6xZIXw collected $13.35 from pot
oDiBRCaF0QVtd3kO6xZIXw: doesn't show hand
*** SUMMARY ***
Total pot $14 | Rake $0.65
Board [Ks 4s 5c]
Seat 1: eUBBn2R56C1IQ6Cs/vitwg (small blind) folded on the Flop
Seat 2: oDiBRCaF0QVtd3kO6xZIXw (big blind) collected ($13.35)
Seat 3: dxyNCn/qxfkGDUIf28Cbng folded before Flop (didn't bet)
Seat 4: aYii2DmxlOlbC1wbGRBWvQ (button) folded before Flop (didn't bet)



PokerStars Game #59940293134:  Hold'em No Limit ($0.50/$1.00) - 2009/07/01 1:02:33 ET
Table 'vs/5jr6ciwjVQ5+Soc+u2A' 6-max Seat #1 is the button
Seat 1: /P4w1pHg2zHYg/4ubJ0dPw ($61.80 in chips)
Seat 2: lXX4W7m3u++JiSOZ46yVMQ ($99 in chips)
Seat 3: G5ZSSN6RSON3gkNvk/SmYg ($139.35 in chips)
Seat 4: wk6Ohn4GDozoOMHc4eb2rw ($89.15 in chips)
Seat 5: +Nt3OPk3XR9SKjZgm2CexQ ($101.30 in chips)
lXX4W7m3u++JiSOZ46yVMQ: posts small blind $0.50
G5ZSSN6RSON3gkNvk/SmYg: posts big blind $1
*** HOLE CARDS ***
wk6Ohn4GDozoOMHc4eb2rw: folds
+Nt3OPk3XR9SKjZgm2CexQ: raises $2 to $3
/P4w1pHg2zHYg/4ubJ0dPw: folds
lXX4W7m3u++JiSOZ46yVMQ: folds
G5ZSSN6RSON3gkNvk/SmYg: folds
+Nt3OPk3XR9SKjZgm2CexQ collected $2.50 from pot
+Nt3OPk3XR9SKjZgm2CexQ: doesn't show hand
*** SUMMARY ***
Total pot $2.50 | Rake $0
Seat 1: /P4w1pHg2zHYg/4ubJ0dPw (button) folded before Flop (didn't bet)
Seat 2: lXX4W7m3u++JiSOZ46yVMQ (small blind) folded before Flop
Seat 3: G5ZSSN6RSON3gkNvk/SmYg (big blind) folded before Flop
Seat 4: wk6Ohn4GDozoOMHc4eb2rw folded before Flop (didn't bet)
Seat 5: +Nt3OPk3XR9SKjZgm2CexQ collected ($2.50)



PokerStars Game #59940293424:  Hold'em No Limit ($0.50/$1.00) - 2009/07/01 1:02:34 ET
Table 'tyUh+jyNvrceIQdKMJjQ2wZFWj23PMihdwrNWv41OG/Qeat #1 is the button
Seat 1: o8A5MUdudVKu+pAwgZOX2w ($72.05 in chips)
Seat 2: XvUbOIg94d25feWeQlOTVg ($152 in chips)
Seat 3: TalCiLYHCd+ffkmR3auPvA ($88.10 in chips)
Seat 4: TSuRyAHnUPCFjP7Z0rEE0w ($221.50 in chips)
Seat 5: j7NIOHLZk7V2o9fOioO5ug ($111.65 in chips)
Seat 6: 4OO5v3AVduL0tePNx8wk5A ($100 in chips)
XvUbOIg94d25feWeQlOTVg: posts small blind $0.50
TalCiLYHCd+ffkmR3auPvA: posts big blind $1
*** HOLE CARDS ***
TSuRyAHnUPCFjP7Z0rEE0w: raises $3 to $4
j7NIOHLZk7V2o9fOioO5ug has timed out
j7NIOHLZk7V2o9fOioO5ug: folds
j7NIOHLZk7V2o9fOioO5ug is sitting out
4OO5v3AVduL0tePNx8wk5A: folds
o8A5MUdudVKu+pAwgZOX2w: calls $4
XvUbOIg94d25feWeQlOTVg: calls $3.50
TalCiLYHCd+ffkmR3auPvA: calls $3
*** FLOP *** [Ah 7h 5d]
XvUbOIg94d25feWeQlOTVg: checks
TalCiLYHCd+ffkmR3auPvA: checks
TSuRyAHnUPCFjP7Z0rEE0w: bets $9.50
j7NIOHLZk7V2o9fOioO5ug has returned
o8A5MUdudVKu+pAwgZOX2w: calls $9.50
XvUbOIg94d25feWeQlOTVg: folds
TalCiLYHCd+ffkmR3auPvA: folds
*** TURN *** [Ah 7h 5d] [9h]
TSuRyAHnUPCFjP7Z0rEE0w: checks
o8A5MUdudVKu+pAwgZOX2w: checks
*** RIVER *** [Ah 7h 5d 9h] [5s]
TSuRyAHnUPCFjP7Z0rEE0w: checks
o8A5MUdudVKu+pAwgZOX2w: bets $25
TSuRyAHnUPCFjP7Z0rEE0w: calls $25
*** SHOW DOWN ***
o8A5MUdudVKu+pAwgZOX2w: shows [5h Qh] (a flush, Ace high)
TSuRyAHnUPCFjP7Z0rEE0w: mucks hand
o8A5MUdudVKu+pAwgZOX2w collected $82 from pot
*** SUMMARY ***
Total pot $85 | Rake $3
Board [Ah 7h 5d 9h 5s]
Seat 1: o8A5MUdudVKu+pAwgZOX2w (button) showed [5h Qh] and won ($82) with a flush, Ace high
Seat 2: XvUbOIg94d25feWeQlOTVg (small blind) folded on the Flop
Seat 3: TalCiLYHCd+ffkmR3auPvA (big blind) folded on the Flop
Seat 4: TSuRyAHnUPCFjP7Z0rEE0w mucked
Seat 5: j7NIOHLZk7V2o9fOioO5ug folded before Flop (didn't bet)
Seat 6: 4OO5v3AVduL0tePNx8wk5A folded before Flop (didn't bet)



PokerStars Game #59940294920:  Hold'em No Limit ($0.50/$1.00) - 2009/07/01 1:02:36 ET
Table 'iSx0wTgVb4o7MyZeOe06ZA' 9-max Seat #1 is the button
Seat 1: VPF+HjszMvUIpy0CHIwH3A ($19 in chips)
Seat 2: myIxN7otsyr846M539YR8Q ($20 in chips)
Seat 4: 0fXz44fzDo5QmhAaJCvFfA ($20 in chips)
Seat 5: o1axyw4AjQ8n4ubTwlirQQ ($22 in chips)
Seat 6: T5/PXFS/W+LLcIXBo1G/RA ($159.20 in chips)
Seat 7: w4NnqVr/Sfoj65ux/fEUyQ ($77.90 in chips)
Seat 8: gUUvmqdVlmvpal6B8nYrmg ($100 in chips)
myIxN7otsyr846M539YR8Q: posts small blind $0.50
IsaacMark: is sitting out
IsaacMark leaves the table
hkim201 has returned
0fXz44fzDo5QmhAaJCvFfA: posts big blind $1
*** HOLE CARDS ***
/inIs/z/PcX+TniIFpaxpg joins the table at seat #3
hkim201 leaves the table
o1axyw4AjQ8n4ubTwlirQQ: folds
T5/PXFS/W+LLcIXBo1G/RA: folds
w4NnqVr/Sfoj65ux/fEUyQ: folds
DOLzOcBTZYcph5jEfKFWuQ joins the table at seat #9
gUUvmqdVlmvpal6B8nYrmg: raises $1 to $2
VPF+HjszMvUIpy0CHIwH3A: folds
DOLzOcBTZYcph5jEfKFWuQ leaves the table
myIxN7otsyr846M539YR8Q: folds
0fXz44fzDo5QmhAaJCvFfA: calls $1
*** FLOP *** [8d 6s 7s]
0fXz44fzDo5QmhAaJCvFfA: checks
gUUvmqdVlmvpal6B8nYrmg: bets $1
0fXz44fzDo5QmhAaJCvFfA: folds
gUUvmqdVlmvpal6B8nYrmg collected $4.30 from pot
*** SUMMARY ***
Total pot $4.50 | Rake $0.20
Board [8d 6s 7s]
Seat 1: VPF+HjszMvUIpy0CHIwH3A (button) folded before Flop (didn't bet)
Seat 2: myIxN7otsyr846M539YR8Q (small blind) folded before Flop
Seat 4: 0fXz44fzDo5QmhAaJCvFfA (big blind) folded on the Flop
Seat 5: o1axyw4AjQ8n4ubTwlirQQ folded before Flop (didn't bet)
Seat 6: T5/PXFS/W+LLcIXBo1G/RA folded before Flop (didn't bet)
Seat 7: w4NnqVr/Sfoj65ux/fEUyQ folded before Flop (didn't bet)
Seat 8: gUUvmqdVlmvpal6B8nYrmg collected ($4.30)



PokerStars Game #59940295210:  Hold'em No Limit ($0.50/$1.00) - 2009/07/01 1:02:37 ET
Table '/RZcOwpZpHQ+OwPwjsbnRw' 6-max Seat #2 is the button
Seat 1: Zboa6dColKGHBjLPUakZjw ($100.25 in chips)
Seat 2: +xW7QemQU0Fxs+4TnqBRow ($225.15 in chips)
Seat 3: XnT1yK2DD/5FL+0bwuEhqg ($48.30 in chips)
Seat 5: wx3sQGkVi2x9wJXuWNHPBw ($177.65 in chips)
Seat 6: 2d/PU00mMdO9azAaXqcSbw ($6 in chips)
XnT1yK2DD/5FL+0bwuEhqg: posts small blind $0.50
j7NIOHLZk7V2o9fOioO5ug has timed out
j7NIOHLZk7V2o9fOioO5ug: is sitting out
wx3sQGkVi2x9wJXuWNHPBw: posts big blind $1
*** HOLE CARDS ***
2d/PU00mMdO9azAaXqcSbw: raises $5 to $6 and is all-in
Zboa6dColKGHBjLPUakZjw: folds
Zboa6dColKGHBjLPUakZjw leaves the table
+xW7QemQU0Fxs+4TnqBRow: folds
XnT1yK2DD/5FL+0bwuEhqg: calls $5.50
wx3sQGkVi2x9wJXuWNHPBw: folds
*** FLOP *** [7h 9s 7c]
*** TURN *** [7h 9s 7c] [Kc]
*** RIVER *** [7h 9s 7c Kc] [2s]
j7NIOHLZk7V2o9fOioO5ug has returned
*** SHOW DOWN ***
XnT1yK2DD/5FL+0bwuEhqg: shows [Qs Ah] (a pair of Sevens)
2d/PU00mMdO9azAaXqcSbw: shows [3d 3h] (two pair, Sevens and Threes)
2d/PU00mMdO9azAaXqcSbw collected $12.35 from pot
*** SUMMARY ***
Total pot $13 | Rake $0.65
Board [7h 9s 7c Kc 2s]
Seat 1: Zboa6dColKGHBjLPUakZjw folded before Flop (didn't bet)
Seat 2: +xW7QemQU0Fxs+4TnqBRow (button) folded before Flop (didn't bet)
Seat 3: XnT1yK2DD/5FL+0bwuEhqg (small blind) showed [Qs Ah] and lost with a pair of Sevens
Seat 5: wx3sQGkVi2x9wJXuWNHPBw (big blind) folded before Flop
Seat 6: 2d/PU00mMdO9azAaXqcSbw showed [3d 3h] and won ($12.35) with two pair, Sevens and Threes



PokerStars Game #59940296268:  Hold'em No Limit ($0.50/$1.00) - 2009/07/01 1:02:38 ET
Table 'eU3bWpDDg3Z+9R4m4iVmog' 6-max Seat #2 is the button
Seat 1: TSuRyAHnUPCFjP7Z0rEE0w ($189.65 in chips)
Seat 2: 8CAoOzhmB8n3nRFf3V4BTg ($59.30 in chips)
Seat 3: rVMOzU7w5FddYPGhD7qN2Q ($47.15 in chips)
Seat 4: GDVIsbEJ/DOJsMKE4Asz0A ($103.15 in chips)
Seat 6: hpxXcmRkXXI9HE5+5/j/0Q ($128.25 in chips)
rVMOzU7w5FddYPGhD7qN2Q: posts small blind $0.50
GDVIsbEJ/DOJsMKE4Asz0A: posts big blind $1
*** HOLE CARDS ***
hpxXcmRkXXI9HE5+5/j/0Q: folds
TSuRyAHnUPCFjP7Z0rEE0w: folds
8CAoOzhmB8n3nRFf3V4BTg: folds
rVMOzU7w5FddYPGhD7qN2Q: calls $0.50
GDVIsbEJ/DOJsMKE4Asz0A: checks
*** FLOP *** [7s Tc 2h]
rVMOzU7w5FddYPGhD7qN2Q: checks
GDVIsbEJ/DOJsMKE4Asz0A: checks
*** TURN *** [7s Tc 2h] [6d]
rVMOzU7w5FddYPGhD7qN2Q: checks
GDVIsbEJ/DOJsMKE4Asz0A: bets $2
rVMOzU7w5FddYPGhD7qN2Q: calls $2
*** RIVER *** [7s Tc 2h 6d] [4d]
rVMOzU7w5FddYPGhD7qN2Q: checks
GDVIsbEJ/DOJsMKE4Asz0A: bets $4
rVMOzU7w5FddYPGhD7qN2Q: calls $4
*** SHOW DOWN ***
GDVIsbEJ/DOJsMKE4Asz0A: shows [9d 8s] (a straight, Six to Ten)
rVMOzU7w5FddYPGhD7qN2Q: mucks hand
GDVIsbEJ/DOJsMKE4Asz0A collected $13.35 from pot
*** SUMMARY ***
Total pot $14 | Rake $0.65
Board [7s Tc 2h 6d 4d]
Seat 1: TSuRyAHnUPCFjP7Z0rEE0w folded before Flop (didn't bet)
Seat 2: 8CAoOzhmB8n3nRFf3V4BTg (button) folded before Flop (didn't bet)
Seat 3: rVMOzU7w5FddYPGhD7qN2Q (small blind) mucked
Seat 4: GDVIsbEJ/DOJsMKE4Asz0A (big blind) showed [9d 8s] and won ($13.35) with a straight, Six to Ten
Seat 6: hpxXcmRkXXI9HE5+5/j/0Q folded before Flop (didn't bet)



PokerStars Game #59940296422:  Hold'em No Limit ($0.50/$1.00) - 2009/07/01 1:02:39 ET
Table 'Zka9tv1yilg0MvXWPQrShg' 9-max Seat #7 is the button
Seat 1: TZcz9MEWDA+WydgGruqqbw ($117.40 in chips)
Seat 2: kz9ziSiGUc+857heiKSayw ($19.50 in chips)
Seat 3: gUUvmqdVlmvpal6B8nYrmg ($107.95 in chips)
Seat 4: stxmTgSicxShtrDxhOOX2g ($63.15 in chips)
Seat 5: /zy+DB4S5fUQUSfZWFzYGw ($115.60 in chips)
Seat 6: rY8wPoax1lS+HUY+I0FZDw ($159.20 in chips)
Seat 7: p1SafS90nb3Uft5LB0NkHw ($19 in chips)
Seat 8: D+W9Me7w6Hcx/WRUSKV0dw ($19 in chips)
Seat 9: 6daxhj43mWj04MOPTOmaYA ($109.90 in chips)
D+W9Me7w6Hcx/WRUSKV0dw: posts small blind $0.50
6daxhj43mWj04MOPTOmaYA: posts big blind $1
*** HOLE CARDS ***
TZcz9MEWDA+WydgGruqqbw: folds
kz9ziSiGUc+857heiKSayw: raises $2 to $3
gUUvmqdVlmvpal6B8nYrmg: folds
stxmTgSicxShtrDxhOOX2g: folds
/zy+DB4S5fUQUSfZWFzYGw: folds
rY8wPoax1lS+HUY+I0FZDw: folds
p1SafS90nb3Uft5LB0NkHw: folds
D+W9Me7w6Hcx/WRUSKV0dw: folds
6daxhj43mWj04MOPTOmaYA: calls $2
*** FLOP *** [Ts Js 6h]
6daxhj43mWj04MOPTOmaYA: checks
kz9ziSiGUc+857heiKSayw: bets $4
6daxhj43mWj04MOPTOmaYA: folds
kz9ziSiGUc+857heiKSayw collected $6.20 from pot
*** SUMMARY ***
Total pot $6.50 | Rake $0.30
Board [Ts Js 6h]
Seat 1: TZcz9MEWDA+WydgGruqqbw folded before Flop (didn't bet)
Seat 2: kz9ziSiGUc+857heiKSayw collected ($6.20)
Seat 3: gUUvmqdVlmvpal6B8nYrmg folded before Flop (didn't bet)
Seat 4: stxmTgSicxShtrDxhOOX2g folded before Flop (didn't bet)
Seat 5: /zy+DB4S5fUQUSfZWFzYGw folded before Flop (didn't bet)
Seat 6: rY8wPoax1lS+HUY+I0FZDw folded before Flop (didn't bet)
Seat 7: p1SafS90nb3Uft5LB0NkHw (button) folded before Flop (didn't bet)
Seat 8: D+W9Me7w6Hcx/WRUSKV0dw (small blind) folded before Flop
Seat 9: 6daxhj43mWj04MOPTOmaYA (big blind) folded on the Flop



PokerStars Game #59940297482:  Hold'em No Limit ($0.50/$1.00) - 2009/07/01 1:02:40 ET
Table 'fTlPiCj0utgzC/5io+I7ew' 6-max Seat #3 is the button
Seat 1: YMJG+F++3Aj6P8dAWda5fw ($103.50 in chips)
Seat 2: Qy/UBNbD2HaA0Ogxg8Sf3w ($125.35 in chips)
Seat 3: wL5HjWHHOSGc53xWMNKB9Q ($24.10 in chips)
Seat 4: uJVSceLggtsrJya+WtmUEA ($167.50 in chips)
Seat 6: /P4w1pHg2zHYg/4ubJ0dPw ($60 in chips)
uJVSceLggtsrJya+WtmUEA: posts small blind $0.50
/P4w1pHg2zHYg/4ubJ0dPw: posts big blind $1
*** HOLE CARDS ***
YMJG+F++3Aj6P8dAWda5fw: folds
Qy/UBNbD2HaA0Ogxg8Sf3w: folds
wL5HjWHHOSGc53xWMNKB9Q: raises $2 to $3
uJVSceLggtsrJya+WtmUEA: folds
/P4w1pHg2zHYg/4ubJ0dPw: folds
wL5HjWHHOSGc53xWMNKB9Q collected $2.50 from pot
*** SUMMARY ***
Total pot $2.50 | Rake $0
Seat 1: YMJG+F++3Aj6P8dAWda5fw folded before Flop (didn't bet)
Seat 2: Qy/UBNbD2HaA0Ogxg8Sf3w folded before Flop (didn't bet)
Seat 3: wL5HjWHHOSGc53xWMNKB9Q (button) collected ($2.50)
Seat 4: uJVSceLggtsrJya+WtmUEA (small blind) folded before Flop
Seat 6: /P4w1pHg2zHYg/4ubJ0dPw (big blind) folded before Flop



PokerStars Game #59940297754:  Hold'em No Limit ($0.50/$1.00) - 2009/07/01 1:02:41 ET
Table 'GxCPo/gd3OSthkYrAxJngg' 6-max Seat #5 is the button
Seat 1: sH8BpAFP+jGFxCgVpD1Lew ($271.40 in chips)
Seat 2: YExX2paeIHrmfIwV1ivM/w ($79.10 in chips)
Seat 3: o6plE+MSW4XFNTeONe16xg ($23.60 in chips)
Seat 4: YMJG+F++3Aj6P8dAWda5fw ($203.10 in chips)
Seat 5: G5ZSSN6RSON3gkNvk/SmYg ($103.75 in chips)
sH8BpAFP+jGFxCgVpD1Lew: posts small blind $0.50
YExX2paeIHrmfIwV1ivM/w: posts big blind $1
*** HOLE CARDS ***
o6plE+MSW4XFNTeONe16xg: folds
YMJG+F++3Aj6P8dAWda5fw: raises $2 to $3
G5ZSSN6RSON3gkNvk/SmYg: folds
sH8BpAFP+jGFxCgVpD1Lew: calls $2.50
YExX2paeIHrmfIwV1ivM/w: folds
*** FLOP *** [Qd Jh Kh]
sH8BpAFP+jGFxCgVpD1Lew: checks
YMJG+F++3Aj6P8dAWda5fw: checks
*** TURN *** [Qd Jh Kh] [3h]
sH8BpAFP+jGFxCgVpD1Lew: checks
YMJG+F++3Aj6P8dAWda5fw: checks
*** RIVER *** [Qd Jh Kh 3h] [2s]
sH8BpAFP+jGFxCgVpD1Lew: checks
YMJG+F++3Aj6P8dAWda5fw: checks
*** SHOW DOWN ***
sH8BpAFP+jGFxCgVpD1Lew: shows [6d 4d] (high card King)
YMJG+F++3Aj6P8dAWda5fw: shows [9s 9h] (a pair of Nines)
YMJG+F++3Aj6P8dAWda5fw collected $6.65 from pot
*** SUMMARY ***
Total pot $7 | Rake $0.35
Board [Qd Jh Kh 3h 2s]
Seat 1: sH8BpAFP+jGFxCgVpD1Lew (small blind) showed [6d 4d] and lost with high card King
Seat 2: YExX2paeIHrmfIwV1ivM/w (big blind) folded before Flop
Seat 3: o6plE+MSW4XFNTeONe16xg folded before Flop (didn't bet)
Seat 4: YMJG+F++3Aj6P8dAWda5fw showed [9s 9h] and won ($6.65) with a pair of Nines
Seat 5: G5ZSSN6RSON3gkNvk/SmYg (button) folded before Flop (didn't bet)



PokerStars Game #59940298042:  Hold'em No Limit ($0.50/$1.00) - 2009/07/01 1:02:41 ET
Table 'SQLOQoANiHscJ8AL7zffbw' 9-max Seat #9 is the button
Seat 1: jPTRd6SpCp4xqAy2XQiTOw ($68.90 in chips)
Seat 2: /zy+DB4S5fUQUSfZWFzYGw ($329.50 in chips)
Seat 3: 0eFnow7+D7veCYQ+CG9FFw ($93.35 in chips)
Seat 4: /mfensKw8/iZ1Vrx33S4xg ($20 in chips)
Seat 5: L9njYvloJ1NdXjP8edHEAg ($104.10 in chips)
Seat 7: bJckevFOcg//s0qyMQI6sQ ($104.55 in chips)
Seat 8: 2BV+oJIQYr65IO6nEChvbA ($60 in chips)
Seat 9: qJr25HAtvv1w/7IBvjMM3g ($204.15 in chips)
jPTRd6SpCp4xqAy2XQiTOw: posts small blind $0.50
/zy+DB4S5fUQUSfZWFzYGw: posts big blind $1
H+DVy3Ei8L1UKS2tVOtJcw: sits out
*** HOLE CARDS ***
0eFnow7+D7veCYQ+CG9FFw: folds
/mfensKw8/iZ1Vrx33S4xg: folds
L9njYvloJ1NdXjP8edHEAg: folds
bJckevFOcg//s0qyMQI6sQ: folds
2BV+oJIQYr65IO6nEChvbA: folds
qJr25HAtvv1w/7IBvjMM3g: folds
jPTRd6SpCp4xqAy2XQiTOw: calls $0.50
/zy+DB4S5fUQUSfZWFzYGw: checks
*** FLOP *** [Ac 4d Tc]
jPTRd6SpCp4xqAy2XQiTOw: checks
/zy+DB4S5fUQUSfZWFzYGw: checks
*** TURN *** [Ac 4d Tc] [Ks]
jPTRd6SpCp4xqAy2XQiTOw: checks
/zy+DB4S5fUQUSfZWFzYGw: checks
*** RIVER *** [Ac 4d Tc Ks] [Qd]
jPTRd6SpCp4xqAy2XQiTOw: checks
/zy+DB4S5fUQUSfZWFzYGw: bets $2
jPTRd6SpCp4xqAy2XQiTOw: folds
/zy+DB4S5fUQUSfZWFzYGw collected $1.90 from pot
*** SUMMARY ***
Total pot $2 | Rake $0.10
Board [Ac 4d Tc Ks Qd]
Seat 1: jPTRd6SpCp4xqAy2XQiTOw (small blind) folded on the River
Seat 2: /zy+DB4S5fUQUSfZWFzYGw (big blind) collected ($1.90)
Seat 3: 0eFnow7+D7veCYQ+CG9FFw folded before Flop (didn't bet)
Seat 4: /mfensKw8/iZ1Vrx33S4xg folded before Flop (didn't bet)
Seat 5: L9njYvloJ1NdXjP8edHEAg folded before Flop (didn't bet)
Seat 7: bJckevFOcg//s0qyMQI6sQ folded before Flop (didn't bet)
Seat 8: 2BV+oJIQYr65IO6nEChvbA folded before Flop (didn't bet)
Seat 9: qJr25HAtvv1w/7IBvjMM3g (button) folded before Flop (didn't bet)



PokerStars Game #59940298330:  Hold'em No Limit ($0.50/$1.00) - 2009/07/01 1:02:42 ET
Table 'cBDNutyLBKEk9+ptwsKmTw' 6-max Seat #1 is the button
Seat 1: xAU6q2/cwmby2sxmA8VcmA ($109.85 in chips)
Seat 2: 5lY8d6Cnm4HUkt/8FZSj4g ($34.10 in chips)
Seat 3: G5ZSSN6RSON3gkNvk/SmYg ($101.65 in chips)
Seat 4: 3q7F5QtzC30pSrn0nl9i+A ($29.80 in chips)
Seat 5: OGMLOcTNYZXZU81au7ztUw ($165.05 in chips)
Seat 6: NqVlOSH2lp+pp/TK3vvK5g ($88.10 in chips)
5lY8d6Cnm4HUkt/8FZSj4g: posts small blind $0.50
G5ZSSN6RSON3gkNvk/SmYg: posts big blind $1
*** HOLE CARDS ***
3q7F5QtzC30pSrn0nl9i+A: calls $1
OGMLOcTNYZXZU81au7ztUw: folds
NqVlOSH2lp+pp/TK3vvK5g: calls $1
xAU6q2/cwmby2sxmA8VcmA: folds
5lY8d6Cnm4HUkt/8FZSj4g: calls $0.50
G5ZSSN6RSON3gkNvk/SmYg: checks
*** FLOP *** [6h Jd 5d]
5lY8d6Cnm4HUkt/8FZSj4g: checks
G5ZSSN6RSON3gkNvk/SmYg: checks
3q7F5QtzC30pSrn0nl9i+A: checks
NqVlOSH2lp+pp/TK3vvK5g: bets $3
5lY8d6Cnm4HUkt/8FZSj4g: folds
G5ZSSN6RSON3gkNvk/SmYg: folds
3q7F5QtzC30pSrn0nl9i+A: folds
NqVlOSH2lp+pp/TK3vvK5g collected $3.80 from pot
*** SUMMARY ***
Total pot $4 | Rake $0.20
Board [6h Jd 5d]
Seat 1: xAU6q2/cwmby2sxmA8VcmA (button) folded before Flop (didn't bet)
Seat 2: 5lY8d6Cnm4HUkt/8FZSj4g (small blind) folded on the Flop
Seat 3: G5ZSSN6RSON3gkNvk/SmYg (big blind) folded on the Flop
Seat 4: 3q7F5QtzC30pSrn0nl9i+A folded on the Flop
Seat 5: OGMLOcTNYZXZU81au7ztUw folded before Flop (didn't bet)
Seat 6: NqVlOSH2lp+pp/TK3vvK5g collected ($3.80)



PokerStars Game #59940299304:  Hold'em No Limit ($0.50/$1.00) - 2009/07/01 1:02:43 ET
Table 'QSIig7BLMc9wY/rgBechzw' 6-max Seat #1 is the button
Seat 1: Z2fXsGcjl+Eax+RzOgwOmg ($100 in chips)
Seat 2: mLOIkH/qmRa+mVujQIhBRg ($41.15 in chips)
Seat 3: Z3y97GMLCsoTZ9j7f6qctg ($30.80 in chips)
Seat 4: +uSzP8Jwnw7sKfQ4s66b7w ($69.70 in chips)
Seat 5: PVmmeYpn4gqkqYUool6BOA ($17.90 in chips)
Seat 6: PxqfkAMdAWtkgbT+q2gciA ($33.20 in chips)
mLOIkH/qmRa+mVujQIhBRg: posts small blind $0.50
Z3y97GMLCsoTZ9j7f6qctg: posts big blind $1
*** HOLE CARDS ***
+uSzP8Jwnw7sKfQ4s66b7w: folds
PVmmeYpn4gqkqYUool6BOA: calls $1
PxqfkAMdAWtkgbT+q2gciA: raises $2 to $3
Z2fXsGcjl+Eax+RzOgwOmg: folds
mLOIkH/qmRa+mVujQIhBRg: folds
Z3y97GMLCsoTZ9j7f6qctg: folds
PVmmeYpn4gqkqYUool6BOA: folds
PxqfkAMdAWtkgbT+q2gciA collected $3.50 from pot
*** SUMMARY ***
Total pot $3.50 | Rake $0
Seat 1: Z2fXsGcjl+Eax+RzOgwOmg (button) folded before Flop (didn't bet)
Seat 2: mLOIkH/qmRa+mVujQIhBRg (small blind) folded before Flop
Seat 3: Z3y97GMLCsoTZ9j7f6qctg (big blind) folded before Flop
Seat 4: +uSzP8Jwnw7sKfQ4s66b7w folded before Flop (didn't bet)
Seat 5: PVmmeYpn4gqkqYUool6BOA folded before Flop
Seat 6: PxqfkAMdAWtkgbT+q2gciA collected ($3.50)



PokerStars Game #59940298898:  Hold'em No Limit ($0.50/$1.00) - 2009/07/01 1:02:43 ET
Table 'LmXQK9xy3awB+qsPzI21Mw' 2-max Seat #2 is the button
Seat 1: NYi6JFscYNrofSXy4sM+Yw ($263.55 in chips)
Seat 2: TME8GvochpQAo8cmJwWmvA ($122.70 in chips)
TME8GvochpQAo8cmJwWmvA: posts small blind $0.50
NYi6JFscYNrofSXy4sM+Yw: posts big blind $1
*** HOLE CARDS ***
TME8GvochpQAo8cmJwWmvA: folds
NYi6JFscYNrofSXy4sM+Yw collected $1 from pot
*** SUMMARY ***
Total pot $1 | Rake $0
Seat 1: NYi6JFscYNrofSXy4sM+Yw (big blind) collected ($1)
Seat 2: TME8GvochpQAo8cmJwWmvA (button) (small blind) folded before Flop



PokerStars Game #59940298900:  Hold'em No Limit ($0.50/$1.00) - 2009/07/01 1:02:43 ET
Table 'tLrtq7gDzxEvckNAI1OS5Q' 6-max Seat #4 is the button
Seat 3: TPZ+m9x+lwoKpv7TMfAUWA ($302.60 in chips)
Seat 4: +uSzP8Jwnw7sKfQ4s66b7w ($43.80 in chips)
Seat 5: OGMLOcTNYZXZU81au7ztUw ($167.35 in chips)
Seat 6: XUk5GQsfNFpHvaToDZ0rZA ($168.40 in chips)
OGMLOcTNYZXZU81au7ztUw: posts small blind $0.50
XUk5GQsfNFpHvaToDZ0rZA: posts big blind $1
*** HOLE CARDS ***
TPZ+m9x+lwoKpv7TMfAUWA: folds
+uSzP8Jwnw7sKfQ4s66b7w: folds
OGMLOcTNYZXZU81au7ztUw: folds
XUk5GQsfNFpHvaToDZ0rZA collected $1 from pot
XUk5GQsfNFpHvaToDZ0rZA: doesn't show hand
*** SUMMARY ***
Total pot $1 | Rake $0
Seat 3: TPZ+m9x+lwoKpv7TMfAUWA folded before Flop (didn't bet)
Seat 4: +uSzP8Jwnw7sKfQ4s66b7w (button) folded before Flop (didn't bet)
Seat 5: OGMLOcTNYZXZU81au7ztUw (small blind) folded before Flop
Seat 6: XUk5GQsfNFpHvaToDZ0rZA (big blind) collected ($1)



PokerStars Game #59940299858:  Hold'em No Limit ($0.50/$1.00) - 2009/07/01 1:02:44 ET
Table 'JTT1XWaDZHSaMZQK7cR5uw' 2-max Seat #2 is the button
Seat 1: OLplZF6FEnLflv81Hz+Fxg ($128.55 in chips)
Seat 2: BcqgegiOUxmBD3F3umsljg ($81.25 in chips)
BcqgegiOUxmBD3F3umsljg: posts small blind $0.50
OLplZF6FEnLflv81Hz+Fxg: posts big blind $1
*** HOLE CARDS ***
BcqgegiOUxmBD3F3umsljg: raises $1 to $2
OLplZF6FEnLflv81Hz+Fxg: raises $5 to $7
BcqgegiOUxmBD3F3umsljg: folds
OLplZF6FEnLflv81Hz+Fxg collected $4 from pot
*** SUMMARY ***
Total pot $4 | Rake $0
Seat 1: OLplZF6FEnLflv81Hz+Fxg (big blind) collected ($4)
Seat 2: BcqgegiOUxmBD3F3umsljg (button) (small blind) folded before Flop



PokerStars Game #59940300690:  Hold'em No Limit ($0.50/$1.00) - 2009/07/01 1:02:46 ET
Table '7O9fB8yx1u7sJveJn8w6jA' 6-max Seat #5 is the button
Seat 1: jy52+7FotjH63o5tEEVgKw ($106.85 in chips)
Seat 2: wx3sQGkVi2x9wJXuWNHPBw ($195.45 in chips)
Seat 3: hpxXcmRkXXI9HE5+5/j/0Q ($101.50 in chips)
Seat 4: XIZSmlGttGgSRaIU42K4Fg ($139.90 in chips)
Seat 5: BCEV3COoKY607AzLWayfRA ($103.70 in chips)
Seat 6: UBZQqpnJZdTYYY1FTb0rLA ($136.95 in chips)
UBZQqpnJZdTYYY1FTb0rLA: posts small blind $0.50
jy52+7FotjH63o5tEEVgKw: posts big blind $1
*** HOLE CARDS ***
wx3sQGkVi2x9wJXuWNHPBw has timed out
wx3sQGkVi2x9wJXuWNHPBw: folds
wx3sQGkVi2x9wJXuWNHPBw is sitting out
hpxXcmRkXXI9HE5+5/j/0Q: folds
wx3sQGkVi2x9wJXuWNHPBw has returned
XIZSmlGttGgSRaIU42K4Fg: folds
BCEV3COoKY607AzLWayfRA: raises $3 to $4
UBZQqpnJZdTYYY1FTb0rLA: folds
jy52+7FotjH63o5tEEVgKw: calls $3
*** FLOP *** [7c 6h Ad]
jy52+7FotjH63o5tEEVgKw: checks
BCEV3COoKY607AzLWayfRA: checks
*** TURN *** [7c 6h Ad] [Qh]
jy52+7FotjH63o5tEEVgKw: checks
BCEV3COoKY607AzLWayfRA: bets $7
jy52+7FotjH63o5tEEVgKw: folds
jy52+7FotjH63o5tEEVgKw is sitting out
BCEV3COoKY607AzLWayfRA collected $8.10 from pot
BCEV3COoKY607AzLWayfRA: doesn't show hand
*** SUMMARY ***
Total pot $8.50 | Rake $0.40
Board [7c 6h Ad Qh]
Seat 1: jy52+7FotjH63o5tEEVgKw (big blind) folded on the Turn
Seat 2: wx3sQGkVi2x9wJXuWNHPBw folded before Flop (didn't bet)
Seat 3: hpxXcmRkXXI9HE5+5/j/0Q folded before Flop (didn't bet)
Seat 4: XIZSmlGttGgSRaIU42K4Fg folded before Flop (didn't bet)
Seat 5: BCEV3COoKY607AzLWayfRA (button) collected ($8.10)
Seat 6: UBZQqpnJZdTYYY1FTb0rLA (small blind) folded before Flop



PokerStars Game #59940301136:  Hold'em No Limit ($0.50/$1.00) - 2009/07/01 1:02:46 ET
Table 'hugOjcwJvzEwZbK7tyiWuQ' 9-max Seat #7 is the button
Seat 1: D+W9Me7w6Hcx/WRUSKV0dw ($32.95 in chips)
Seat 2: r27C1nIV4NS4+qbnrgBQSw ($283.20 in chips)
Seat 3: jDwhY1kCdc6EkAHbT7PJMQ ($104.75 in chips)
Seat 4: UWB3oeddt/GObx2Mix2Anw ($174.80 in chips)
Seat 5: 5BRGWf+R3nt2WS3b5xX+zA ($15.25 in chips)
Seat 6: gUUvmqdVlmvpal6B8nYrmg ($107.40 in chips)
Seat 7: FL3MrLspcF23LYvC4ipBOA ($110.30 in chips)
Seat 8: /zy+DB4S5fUQUSfZWFzYGw ($100 in chips)
Seat 9: W8P9bUKCs43TO1xHm0dL6w ($89.45 in chips)
/zy+DB4S5fUQUSfZWFzYGw: posts small blind $0.50
W8P9bUKCs43TO1xHm0dL6w: posts big blind $1
*** HOLE CARDS ***
D+W9Me7w6Hcx/WRUSKV0dw: folds
r27C1nIV4NS4+qbnrgBQSw: folds
jDwhY1kCdc6EkAHbT7PJMQ: folds
UWB3oeddt/GObx2Mix2Anw: folds
5BRGWf+R3nt2WS3b5xX+zA: raises $2 to $3
gUUvmqdVlmvpal6B8nYrmg: folds
FL3MrLspcF23LYvC4ipBOA: folds
/zy+DB4S5fUQUSfZWFzYGw: folds
W8P9bUKCs43TO1xHm0dL6w: folds
5BRGWf+R3nt2WS3b5xX+zA collected $2.50 from pot
*** SUMMARY ***
Total pot $2.50 | Rake $0
Seat 1: D+W9Me7w6Hcx/WRUSKV0dw folded before Flop (didn't bet)
Seat 2: r27C1nIV4NS4+qbnrgBQSw folded before Flop (didn't bet)
Seat 3: jDwhY1kCdc6EkAHbT7PJMQ folded before Flop (didn't bet)
Seat 4: UWB3oeddt/GObx2Mix2Anw folded before Flop (didn't bet)
Seat 5: 5BRGWf+R3nt2WS3b5xX+zA collected ($2.50)
Seat 6: gUUvmqdVlmvpal6B8nYrmg folded before Flop (didn't bet)
Seat 7: FL3MrLspcF23LYvC4ipBOA (button) folded before Flop (didn't bet)
Seat 8: /zy+DB4S5fUQUSfZWFzYGw (small blind) folded before Flop
Seat 9: W8P9bUKCs43TO1xHm0dL6w (big blind) folded before Flop



PokerStars Game #59940301552:  Hold'em No Limit ($0.50/$1.00) - 2009/07/01 1:02:47 ET
Table 'vs/5jr6ciwjVQ5+Soc+u2A' 6-max Seat #2 is the button
Seat 1: /P4w1pHg2zHYg/4ubJ0dPw ($61.80 in chips)
Seat 2: lXX4W7m3u++JiSOZ46yVMQ ($98.50 in chips)
Seat 3: G5ZSSN6RSON3gkNvk/SmYg ($138.35 in chips)
Seat 4: wk6Ohn4GDozoOMHc4eb2rw ($89.15 in chips)
Seat 5: +Nt3OPk3XR9SKjZgm2CexQ ($102.80 in chips)
G5ZSSN6RSON3gkNvk/SmYg: posts small blind $0.50
wk6Ohn4GDozoOMHc4eb2rw: posts big blind $1
*** HOLE CARDS ***
+Nt3OPk3XR9SKjZgm2CexQ: folds
/P4w1pHg2zHYg/4ubJ0dPw: folds
lXX4W7m3u++JiSOZ46yVMQ: folds
G5ZSSN6RSON3gkNvk/SmYg: folds
wk6Ohn4GDozoOMHc4eb2rw collected $1 from pot
wk6Ohn4GDozoOMHc4eb2rw: doesn't show hand
*** SUMMARY ***
Total pot $1 | Rake $0
Seat 1: /P4w1pHg2zHYg/4ubJ0dPw folded before Flop (didn't bet)
Seat 2: lXX4W7m3u++JiSOZ46yVMQ (button) folded before Flop (didn't bet)
Seat 3: G5ZSSN6RSON3gkNvk/SmYg (small blind) folded before Flop
Seat 4: wk6Ohn4GDozoOMHc4eb2rw (big blind) collected ($1)
Seat 5: +Nt3OPk3XR9SKjZgm2CexQ folded before Flop (didn't bet)



PokerStars Game #59940302034:  Hold'em No Limit ($0.50/$1.00) - 2009/07/01 1:02:48 ET
Table 'pHrhryH8jPNdQfY62f8v+g' 6-max Seat #6 is the button
Seat 1: OvwYHV65yUbgdBjSmo1+5g ($54.50 in chips)
Seat 2: RqgF7gRoKgRNW8Zoi1ty4A ($138.30 in chips)
Seat 3: 8oS5O7iD/qnFXFXJrGIgNQ ($151.80 in chips)
Seat 5: r1/R7y0Ortgoz4lccgW8VA ($46.55 in chips)
Seat 6: xAU6q2/cwmby2sxmA8VcmA ($103.80 in chips)
OvwYHV65yUbgdBjSmo1+5g: posts small blind $0.50
RqgF7gRoKgRNW8Zoi1ty4A: posts big blind $1
*** HOLE CARDS ***
8oS5O7iD/qnFXFXJrGIgNQ: folds
r1/R7y0Ortgoz4lccgW8VA: raises $2 to $3
xAU6q2/cwmby2sxmA8VcmA: folds
OvwYHV65yUbgdBjSmo1+5g: folds
RqgF7gRoKgRNW8Zoi1ty4A: folds
r1/R7y0Ortgoz4lccgW8VA collected $2.50 from pot
*** SUMMARY ***
Total pot $2.50 | Rake $0
Seat 1: OvwYHV65yUbgdBjSmo1+5g (small blind) folded before Flop
Seat 2: RqgF7gRoKgRNW8Zoi1ty4A (big blind) folded before Flop
Seat 3: 8oS5O7iD/qnFXFXJrGIgNQ folded before Flop (didn't bet)
Seat 5: r1/R7y0Ortgoz4lccgW8VA collected ($2.50)
Seat 6: xAU6q2/cwmby2sxmA8VcmA (button) folded before Flop (didn't bet)



PokerStars Game #59940302314:  Hold'em No Limit ($0.50/$1.00) - 2009/07/01 1:02:49 ET
Table 'CASNP0uy1C+jGLml/I4PtA' 9-max Seat #3 is the button
Seat 1: tkdBeXTJlFsZdioidNqLow ($60 in chips)
Seat 2: tjhwe1V98x2spSoUQER3HQ ($107.10 in chips)
Seat 3: bJckevFOcg//s0qyMQI6sQ ($102.40 in chips)
Seat 4: B/G0GJacqZ8K59/ZVdq4kQ ($49.15 in chips)
Seat 5: Jjc7EHWzs4//xUAjJ0UWoA ($20 in chips)
Seat 6: 0eFnow7+D7veCYQ+CG9FFw ($106.25 in chips)
Seat 7: RpMNxqeYPSeOh0tflU772w ($157.05 in chips)
Seat 8: L9njYvloJ1NdXjP8edHEAg ($100 in chips)
Seat 9: Pp/KTcXkfZKKUHkjyaLTdg ($20 in chips)
B/G0GJacqZ8K59/ZVdq4kQ: posts small blind $0.50
Jjc7EHWzs4//xUAjJ0UWoA: posts big blind $1
*** HOLE CARDS ***
0eFnow7+D7veCYQ+CG9FFw: folds
0eFnow7+D7veCYQ+CG9FFw leaves the table
RpMNxqeYPSeOh0tflU772w: folds
FJEywSpo5JbRKByzmweboA joins the table at seat #6
L9njYvloJ1NdXjP8edHEAg: folds
Pp/KTcXkfZKKUHkjyaLTdg: folds
tkdBeXTJlFsZdioidNqLow: folds
tjhwe1V98x2spSoUQER3HQ: folds
bJckevFOcg//s0qyMQI6sQ: folds
B/G0GJacqZ8K59/ZVdq4kQ: calls $0.50
Jjc7EHWzs4//xUAjJ0UWoA: checks
*** FLOP *** [3h 4h 8s]
B/G0GJacqZ8K59/ZVdq4kQ: bets $4
Jjc7EHWzs4//xUAjJ0UWoA: calls $4
*** TURN *** [3h 4h 8s] [4s]
B/G0GJacqZ8K59/ZVdq4kQ: bets $6
Jjc7EHWzs4//xUAjJ0UWoA: folds
B/G0GJacqZ8K59/ZVdq4kQ collected $9.55 from pot
B/G0GJacqZ8K59/ZVdq4kQ: doesn't show hand
*** SUMMARY ***
Total pot $10 | Rake $0.45
Board [3h 4h 8s 4s]
Seat 1: tkdBeXTJlFsZdioidNqLow folded before Flop (didn't bet)
Seat 2: tjhwe1V98x2spSoUQER3HQ folded before Flop (didn't bet)
Seat 3: bJckevFOcg//s0qyMQI6sQ (button) folded before Flop (didn't bet)
Seat 4: B/G0GJacqZ8K59/ZVdq4kQ (small blind) collected ($9.55)
Seat 5: Jjc7EHWzs4//xUAjJ0UWoA (big blind) folded on the Turn
Seat 6: 0eFnow7+D7veCYQ+CG9FFw folded before Flop (didn't bet)
Seat 7: RpMNxqeYPSeOh0tflU772w folded before Flop (didn't bet)
Seat 8: L9njYvloJ1NdXjP8edHEAg folded before Flop (didn't bet)
Seat 9: Pp/KTcXkfZKKUHkjyaLTdg folded before Flop (didn't bet)



PokerStars Game #59940305326:  Hold'em No Limit ($0.50/$1.00) - 2009/07/01 1:02:53 ET
Table 'VOs36P6NW+QyXeQ1B62kmA' 6-max Seat #6 is the button
Seat 1: Z2fXsGcjl+Eax+RzOgwOmg ($100 in chips)
Seat 2: 2UMlbaZ8n8AbRli0Yr0mDw ($31.20 in chips)
Seat 3: TSuRyAHnUPCFjP7Z0rEE0w ($106.40 in chips)
Seat 4: w02zQzNydODiyV9THKgo9w ($44.20 in chips)
Seat 5: ozrlafxxh1HmYdA0/h+MuA ($31.85 in chips)
Seat 6: slVKuQyEz8Qj4E3uLPYNXg ($97 in chips)
Z2fXsGcjl+Eax+RzOgwOmg: posts small blind $0.50
2UMlbaZ8n8AbRli0Yr0mDw: posts big blind $1
*** HOLE CARDS ***
TSuRyAHnUPCFjP7Z0rEE0w: folds
w02zQzNydODiyV9THKgo9w: folds
ozrlafxxh1HmYdA0/h+MuA: calls $1
slVKuQyEz8Qj4E3uLPYNXg: calls $1
Z2fXsGcjl+Eax+RzOgwOmg: folds
2UMlbaZ8n8AbRli0Yr0mDw: checks
*** FLOP *** [Tc 4s 5c]
2UMlbaZ8n8AbRli0Yr0mDw: checks
ozrlafxxh1HmYdA0/h+MuA: checks
slVKuQyEz8Qj4E3uLPYNXg: checks
*** TURN *** [Tc 4s 5c] [Qs]
2UMlbaZ8n8AbRli0Yr0mDw: bets $3
ozrlafxxh1HmYdA0/h+MuA: calls $3
slVKuQyEz8Qj4E3uLPYNXg: calls $3
*** RIVER *** [Tc 4s 5c Qs] [Jh]
2UMlbaZ8n8AbRli0Yr0mDw: checks
ozrlafxxh1HmYdA0/h+MuA: bets $7
slVKuQyEz8Qj4E3uLPYNXg: calls $7
2UMlbaZ8n8AbRli0Yr0mDw: folds
*** SHOW DOWN ***
ozrlafxxh1HmYdA0/h+MuA: shows [Qh 4h] (two pair, Queens and Fours)
slVKuQyEz8Qj4E3uLPYNXg: mucks hand
ozrlafxxh1HmYdA0/h+MuA collected $25.25 from pot
*** SUMMARY ***
Total pot $26.50 | Rake $1.25
Board [Tc 4s 5c Qs Jh]
Seat 1: Z2fXsGcjl+Eax+RzOgwOmg (small blind) folded before Flop
Seat 2: 2UMlbaZ8n8AbRli0Yr0mDw (big blind) folded on the River
Seat 3: TSuRyAHnUPCFjP7Z0rEE0w folded before Flop (didn't bet)
Seat 4: w02zQzNydODiyV9THKgo9w folded before Flop (didn't bet)
Seat 5: ozrlafxxh1HmYdA0/h+MuA showed [Qh 4h] and won ($25.25) with two pair, Queens and Fours
Seat 6: slVKuQyEz8Qj4E3uLPYNXg (button) mucked



PokerStars Game #59940306094:  Hold'em No Limit ($0.50/$1.00) - 2009/07/01 1:02:55 ET
Table 'JTT1XWaDZHSaMZQK7cR5uw' 2-max Seat #1 is the button
Seat 1: OLplZF6FEnLflv81Hz+Fxg ($130.55 in chips)
Seat 2: BcqgegiOUxmBD3F3umsljg ($79.25 in chips)
OLplZF6FEnLflv81Hz+Fxg: posts small blind $0.50
BcqgegiOUxmBD3F3umsljg: posts big blind $1
*** HOLE CARDS ***
OLplZF6FEnLflv81Hz+Fxg: folds
BcqgegiOUxmBD3F3umsljg collected $1 from pot
*** SUMMARY ***
Total pot $1 | Rake $0
Seat 1: OLplZF6FEnLflv81Hz+Fxg (button) (small blind) folded before Flop
Seat 2: BcqgegiOUxmBD3F3umsljg (big blind) collected ($1)



PokerStars Game #59940307870:  Hold'em No Limit ($0.50/$1.00) - 2009/07/01 1:02:58 ET
Table 'tLrtq7gDzxEvckNAI1OS5Q' 6-max Seat #5 is the button
Seat 3: TPZ+m9x+lwoKpv7TMfAUWA ($302.60 in chips)
Seat 4: +uSzP8Jwnw7sKfQ4s66b7w ($43.80 in chips)
Seat 5: OGMLOcTNYZXZU81au7ztUw ($166.85 in chips)
Seat 6: XUk5GQsfNFpHvaToDZ0rZA ($168.90 in chips)
XUk5GQsfNFpHvaToDZ0rZA: posts small blind $0.50
TPZ+m9x+lwoKpv7TMfAUWA: posts big blind $1
*** HOLE CARDS ***
+uSzP8Jwnw7sKfQ4s66b7w: folds
+uSzP8Jwnw7sKfQ4s66b7w leaves the table
OGMLOcTNYZXZU81au7ztUw: raises $2 to $3
XUk5GQsfNFpHvaToDZ0rZA: folds
TPZ+m9x+lwoKpv7TMfAUWA: calls $2
*** FLOP *** [5s 3s 2s]
TPZ+m9x+lwoKpv7TMfAUWA: checks
OGMLOcTNYZXZU81au7ztUw: bets $5
TPZ+m9x+lwoKpv7TMfAUWA: folds
OGMLOcTNYZXZU81au7ztUw collected $6.20 from pot
OGMLOcTNYZXZU81au7ztUw: doesn't show hand
*** SUMMARY ***
Total pot $6.50 | Rake $0.30
Board [5s 3s 2s]
Seat 3: TPZ+m9x+lwoKpv7TMfAUWA (big blind) folded on the Flop
Seat 4: +uSzP8Jwnw7sKfQ4s66b7w folded before Flop (didn't bet)
Seat 5: OGMLOcTNYZXZU81au7ztUw (button) collected ($6.20)
Seat 6: XUk5GQsfNFpHvaToDZ0rZA (small blind) folded before Flop



PokerStars Game #59940308588:  Hold'em No Limit ($0.50/$1.00) - 2009/07/01 1:02:59 ET
Table 'MUPc8FEpe/nR0BKSeReX6Q' 6-max Seat #4 is the button
Seat 1: qhkK6+yCciTRd+rCFEbnEQ ($43.20 in chips)
Seat 2: xAU6q2/cwmby2sxmA8VcmA ($122.70 in chips)
Seat 3: wx3sQGkVi2x9wJXuWNHPBw ($236.40 in chips)
Seat 4: ZA1bp6g8IwtTxkUE4eCjDQ ($195.30 in chips)
Seat 5: UBZQqpnJZdTYYY1FTb0rLA ($100 in chips)
Seat 6: oxnw0GLLpFanjhGkxfRSqA ($23.70 in chips)
UBZQqpnJZdTYYY1FTb0rLA: posts small blind $0.50
oxnw0GLLpFanjhGkxfRSqA: posts big blind $1
*** HOLE CARDS ***
qhkK6+yCciTRd+rCFEbnEQ: folds
xAU6q2/cwmby2sxmA8VcmA: folds
wx3sQGkVi2x9wJXuWNHPBw: folds
ZA1bp6g8IwtTxkUE4eCjDQ: folds
UBZQqpnJZdTYYY1FTb0rLA: folds
oxnw0GLLpFanjhGkxfRSqA collected $1 from pot
*** SUMMARY ***
Total pot $1 | Rake $0
Seat 1: qhkK6+yCciTRd+rCFEbnEQ folded before Flop (didn't bet)
Seat 2: xAU6q2/cwmby2sxmA8VcmA folded before Flop (didn't bet)
Seat 3: wx3sQGkVi2x9wJXuWNHPBw folded before Flop (didn't bet)
Seat 4: ZA1bp6g8IwtTxkUE4eCjDQ (button) folded before Flop (didn't bet)
Seat 5: UBZQqpnJZdTYYY1FTb0rLA (small blind) folded before Flop
Seat 6: oxnw0GLLpFanjhGkxfRSqA (big blind) collected ($1)



PokerStars Game #59940308610:  Hold'em No Limit ($0.50/$1.00) - 2009/07/01 1:02:59 ET
Table 'rmZfTK+oSebeUPJNbWhdAA' 6-max Seat #5 is the button
Seat 1: xAU6q2/cwmby2sxmA8VcmA ($147.50 in chips)
Seat 2: z7O9PO/WEcqRouIydFhS9Q ($121.05 in chips)
Seat 3: BCEV3COoKY607AzLWayfRA ($134 in chips)
Seat 4: 1/mIuXfgx1ZyVkodrmfQDw ($102.70 in chips)
Seat 5: 5lY8d6Cnm4HUkt/8FZSj4g ($89.90 in chips)
xAU6q2/cwmby2sxmA8VcmA: posts small blind $0.50
z7O9PO/WEcqRouIydFhS9Q: posts big blind $1
*** HOLE CARDS ***
BCEV3COoKY607AzLWayfRA: folds
1/mIuXfgx1ZyVkodrmfQDw: folds
5lY8d6Cnm4HUkt/8FZSj4g: folds
xAU6q2/cwmby2sxmA8VcmA: folds
z7O9PO/WEcqRouIydFhS9Q collected $1 from pot
*** SUMMARY ***
Total pot $1 | Rake $0
Seat 1: xAU6q2/cwmby2sxmA8VcmA (small blind) folded before Flop
Seat 2: z7O9PO/WEcqRouIydFhS9Q (big blind) collected ($1)
Seat 3: BCEV3COoKY607AzLWayfRA folded before Flop (didn't bet)
Seat 4: 1/mIuXfgx1ZyVkodrmfQDw folded before Flop (didn't bet)
Seat 5: 5lY8d6Cnm4HUkt/8FZSj4g (button) folded before Flop (didn't bet)



PokerStars Game #59940309752:  Hold'em No Limit ($0.50/$1.00) - 2009/07/01 1:03:01 ET
Table 'vs/5jr6ciwjVQ5+Soc+u2A' 6-max Seat #3 is the button
Seat 1: /P4w1pHg2zHYg/4ubJ0dPw ($61.80 in chips)
Seat 2: lXX4W7m3u++JiSOZ46yVMQ ($98.50 in chips)
Seat 3: G5ZSSN6RSON3gkNvk/SmYg ($137.85 in chips)
Seat 4: wk6Ohn4GDozoOMHc4eb2rw ($89.65 in chips)
Seat 5: +Nt3OPk3XR9SKjZgm2CexQ ($102.80 in chips)
wk6Ohn4GDozoOMHc4eb2rw: posts small blind $0.50
+Nt3OPk3XR9SKjZgm2CexQ: posts big blind $1
*** HOLE CARDS ***
/P4w1pHg2zHYg/4ubJ0dPw: folds
lXX4W7m3u++JiSOZ46yVMQ: folds
G5ZSSN6RSON3gkNvk/SmYg: folds
wk6Ohn4GDozoOMHc4eb2rw: calls $0.50
+Nt3OPk3XR9SKjZgm2CexQ: raises $2 to $3
wk6Ohn4GDozoOMHc4eb2rw: folds
+Nt3OPk3XR9SKjZgm2CexQ collected $2 from pot
+Nt3OPk3XR9SKjZgm2CexQ: doesn't show hand
*** SUMMARY ***
Total pot $2 | Rake $0
Seat 1: /P4w1pHg2zHYg/4ubJ0dPw folded before Flop (didn't bet)
Seat 2: lXX4W7m3u++JiSOZ46yVMQ folded before Flop (didn't bet)
Seat 3: G5ZSSN6RSON3gkNvk/SmYg (button) folded before Flop (didn't bet)
Seat 4: wk6Ohn4GDozoOMHc4eb2rw (small blind) folded before Flop
Seat 5: +Nt3OPk3XR9SKjZgm2CexQ (big blind) collected ($2)



PokerStars Game #59940309900:  Hold'em No Limit ($0.50/$1.00) - 2009/07/01 1:03:01 ET
Table 'mmbQQVBTrPdE+wy+s+9VPA' 6-max Seat #3 is the button
Seat 1: zyP4SPoWZnKUfTvIRLCVog ($53.50 in chips)
Seat 2: cl/QpVR/PLO58lj+C5mGLw ($10.70 in chips)
Seat 3: wx3sQGkVi2x9wJXuWNHPBw ($111.65 in chips)
Seat 4: V3iZdcw61nXF3g5hD2RrsQ ($111.80 in chips)
Seat 5: YMJG+F++3Aj6P8dAWda5fw ($100 in chips)
Seat 6: U2CWBTv29qdCbj8RNF2sIw ($108.95 in chips)
V3iZdcw61nXF3g5hD2RrsQ: posts small blind $0.50
YMJG+F++3Aj6P8dAWda5fw: posts big blind $1
*** HOLE CARDS ***
U2CWBTv29qdCbj8RNF2sIw: folds
zyP4SPoWZnKUfTvIRLCVog: calls $1
cl/QpVR/PLO58lj+C5mGLw: raises $2 to $3
wx3sQGkVi2x9wJXuWNHPBw: folds
V3iZdcw61nXF3g5hD2RrsQ: folds
YMJG+F++3Aj6P8dAWda5fw: folds
zyP4SPoWZnKUfTvIRLCVog: calls $2
*** FLOP *** [8h 9h 6s]
zyP4SPoWZnKUfTvIRLCVog: checks
cl/QpVR/PLO58lj+C5mGLw: bets $7.70 and is all-in
zyP4SPoWZnKUfTvIRLCVog: calls $7.70
*** TURN *** [8h 9h 6s] [7s]
*** RIVER *** [8h 9h 6s 7s] [Ts]
*** SHOW DOWN ***
zyP4SPoWZnKUfTvIRLCVog: shows [Kh Qd] (a straight, Six to Ten)
cl/QpVR/PLO58lj+C5mGLw: shows [Td Th] (a straight, Six to Ten)
zyP4SPoWZnKUfTvIRLCVog collected $10.90 from pot
cl/QpVR/PLO58lj+C5mGLw collected $10.90 from pot
*** SUMMARY ***
Total pot $22.90 | Rake $1.10
Board [8h 9h 6s 7s Ts]
Seat 1: zyP4SPoWZnKUfTvIRLCVog showed [Kh Qd] and won ($10.90) with a straight, Six to Ten
Seat 2: cl/QpVR/PLO58lj+C5mGLw showed [Td Th] and won ($10.90) with a straight, Six to Ten
Seat 3: wx3sQGkVi2x9wJXuWNHPBw (button) folded before Flop (didn't bet)
Seat 4: V3iZdcw61nXF3g5hD2RrsQ (small blind) folded before Flop
Seat 5: YMJG+F++3Aj6P8dAWda5fw (big blind) folded before Flop
Seat 6: U2CWBTv29qdCbj8RNF2sIw folded before Flop (didn't bet)



PokerStars Game #59940309906:  Hold'em No Limit ($0.50/$1.00) - 2009/07/01 1:03:01 ET
Table 'QSIig7BLMc9wY/rgBechzw' 6-max Seat #2 is the button
Seat 1: Z2fXsGcjl+Eax+RzOgwOmg ($100 in chips)
Seat 2: mLOIkH/qmRa+mVujQIhBRg ($40.65 in chips)
Seat 3: Z3y97GMLCsoTZ9j7f6qctg ($29.80 in chips)
Seat 4: +uSzP8Jwnw7sKfQ4s66b7w ($69.70 in chips)
Seat 5: PVmmeYpn4gqkqYUool6BOA ($16.90 in chips)
Seat 6: PxqfkAMdAWtkgbT+q2gciA ($35.70 in chips)
Z3y97GMLCsoTZ9j7f6qctg: posts small blind $0.50
+uSzP8Jwnw7sKfQ4s66b7w: posts big blind $1
*** HOLE CARDS ***
PVmmeYpn4gqkqYUool6BOA: folds
PxqfkAMdAWtkgbT+q2gciA: folds
Z2fXsGcjl+Eax+RzOgwOmg: folds
mLOIkH/qmRa+mVujQIhBRg: folds
Z3y97GMLCsoTZ9j7f6qctg: calls $0.50
+uSzP8Jwnw7sKfQ4s66b7w: checks
*** FLOP *** [Js 4h Kd]
Z3y97GMLCsoTZ9j7f6qctg: checks
+uSzP8Jwnw7sKfQ4s66b7w: bets $2
Z3y97GMLCsoTZ9j7f6qctg: folds
+uSzP8Jwnw7sKfQ4s66b7w collected $1.90 from pot
*** SUMMARY ***
Total pot $2 | Rake $0.10
Board [Js 4h Kd]
Seat 1: Z2fXsGcjl+Eax+RzOgwOmg folded before Flop (didn't bet)
Seat 2: mLOIkH/qmRa+mVujQIhBRg (button) folded before Flop (didn't bet)
Seat 3: Z3y97GMLCsoTZ9j7f6qctg (small blind) folded on the Flop
Seat 4: +uSzP8Jwnw7sKfQ4s66b7w (big blind) collected ($1.90)
Seat 5: PVmmeYpn4gqkqYUool6BOA folded before Flop (didn't bet)
Seat 6: PxqfkAMdAWtkgbT+q2gciA folded before Flop (didn't bet)



PokerStars Game #59940310216:  Hold'em No Limit ($0.50/$1.00) - 2009/07/01 1:03:02 ET
Table 'JTT1XWaDZHSaMZQK7cR5uw' 2-max Seat #2 is the button
Seat 1: OLplZF6FEnLflv81Hz+Fxg ($130.05 in chips)
Seat 2: BcqgegiOUxmBD3F3umsljg ($79.75 in chips)
BcqgegiOUxmBD3F3umsljg: posts small blind $0.50
OLplZF6FEnLflv81Hz+Fxg: posts big blind $1
*** HOLE CARDS ***
BcqgegiOUxmBD3F3umsljg: raises $1 to $2
OLplZF6FEnLflv81Hz+Fxg: raises $5 to $7
BcqgegiOUxmBD3F3umsljg: folds
OLplZF6FEnLflv81Hz+Fxg collected $4 from pot
OLplZF6FEnLflv81Hz+Fxg: doesn't show hand
*** SUMMARY ***
Total pot $4 | Rake $0
Seat 1: OLplZF6FEnLflv81Hz+Fxg (big blind) collected ($4)
Seat 2: BcqgegiOUxmBD3F3umsljg (button) (small blind) folded before Flop



PokerStars Game #59940310190:  Hold'em No Limit ($0.50/$1.00) - 2009/07/01 1:03:02 ET
Table 'fTlPiCj0utgzC/5io+I7ew' 6-max Seat #4 is the button
Seat 1: YMJG+F++3Aj6P8dAWda5fw ($103.50 in chips)
Seat 2: Qy/UBNbD2HaA0Ogxg8Sf3w ($125.35 in chips)
Seat 3: wL5HjWHHOSGc53xWMNKB9Q ($25.60 in chips)
Seat 4: uJVSceLggtsrJya+WtmUEA ($167 in chips)
Seat 6: /P4w1pHg2zHYg/4ubJ0dPw ($60 in chips)
/P4w1pHg2zHYg/4ubJ0dPw: posts small blind $0.50
YMJG+F++3Aj6P8dAWda5fw: posts big blind $1
*** HOLE CARDS ***
Qy/UBNbD2HaA0Ogxg8Sf3w: folds
wL5HjWHHOSGc53xWMNKB9Q: folds
GC5g2ryXV7e4TTqmaxUofw joins the table at seat #5
uJVSceLggtsrJya+WtmUEA: raises $2 to $3
/P4w1pHg2zHYg/4ubJ0dPw: raises $6 to $9
YMJG+F++3Aj6P8dAWda5fw: folds
uJVSceLggtsrJya+WtmUEA: calls $6
*** FLOP *** [2h 8s 8h]
/P4w1pHg2zHYg/4ubJ0dPw: bets $14
uJVSceLggtsrJya+WtmUEA: folds
/P4w1pHg2zHYg/4ubJ0dPw collected $18.05 from pot
*** SUMMARY ***
Total pot $19 | Rake $0.95
Board [2h 8s 8h]
Seat 1: YMJG+F++3Aj6P8dAWda5fw (big blind) folded before Flop
Seat 2: Qy/UBNbD2HaA0Ogxg8Sf3w folded before Flop (didn't bet)
Seat 3: wL5HjWHHOSGc53xWMNKB9Q folded before Flop (didn't bet)
Seat 4: uJVSceLggtsrJya+WtmUEA (button) folded on the Flop
Seat 6: /P4w1pHg2zHYg/4ubJ0dPw (small blind) collected ($18.05)



PokerStars Game #59940314054:  Hold'em No Limit ($0.50/$1.00) - 2009/07/01 1:03:08 ET
Table 'GPp0HyAuggN8oE0sUWzPpA' 9-max Seat #7 is the button
Seat 1: qJr25HAtvv1w/7IBvjMM3g ($44.20 in chips)
Seat 2: m3U8I35Pn3gxKhoS2nmYIg ($54.70 in chips)
Seat 3: CCCXsirC+bO7ginAuUUVlQ ($54.50 in chips)
Seat 4: mBRWbnUl8diyBO1qTJaNzw ($107.30 in chips)
Seat 5: 0fXz44fzDo5QmhAaJCvFfA ($14.15 in chips)
Seat 6: BK/GtNPkSx0TdUDj82id5A ($17.85 in chips)
Seat 7: DHdbHyysD15wCAtx+BhUjA ($92.50 in chips)
Seat 8: 6DBvLniKMJADk/t5l29oMA ($25.65 in chips)
6DBvLniKMJADk/t5l29oMA: posts small blind $0.50
VPF+HjszMvUIpy0CHIwH3A: is sitting out
qJr25HAtvv1w/7IBvjMM3g: posts big blind $1
*** HOLE CARDS ***
VPF+HjszMvUIpy0CHIwH3A leaves the table
m3U8I35Pn3gxKhoS2nmYIg: folds
CCCXsirC+bO7ginAuUUVlQ: raises $2 to $3
mBRWbnUl8diyBO1qTJaNzw: folds
0fXz44fzDo5QmhAaJCvFfA: folds
BK/GtNPkSx0TdUDj82id5A: folds
DHdbHyysD15wCAtx+BhUjA: folds
6DBvLniKMJADk/t5l29oMA: folds
qJr25HAtvv1w/7IBvjMM3g: folds
CCCXsirC+bO7ginAuUUVlQ collected $2.50 from pot
*** SUMMARY ***
Total pot $2.50 | Rake $0
Seat 1: qJr25HAtvv1w/7IBvjMM3g (big blind) folded before Flop
Seat 2: m3U8I35Pn3gxKhoS2nmYIg folded before Flop (didn't bet)
Seat 3: CCCXsirC+bO7ginAuUUVlQ collected ($2.50)
Seat 4: mBRWbnUl8diyBO1qTJaNzw folded before Flop (didn't bet)
Seat 5: 0fXz44fzDo5QmhAaJCvFfA folded before Flop (didn't bet)
Seat 6: BK/GtNPkSx0TdUDj82id5A folded before Flop (didn't bet)
Seat 7: DHdbHyysD15wCAtx+BhUjA (button) folded before Flop (didn't bet)
Seat 8: 6DBvLniKMJADk/t5l29oMA (small blind) folded before Flop



PokerStars Game #59940314496:  Hold'em No Limit ($0.50/$1.00) - 2009/07/01 1:03:09 ET
Table 'W/wyObTiXZm+Ckkl3YxcSw' 6-max Seat #1 is the button
Seat 1: eUBBn2R56C1IQ6Cs/vitwg ($194.25 in chips)
Seat 2: oDiBRCaF0QVtd3kO6xZIXw ($114.20 in chips)
Seat 3: dxyNCn/qxfkGDUIf28Cbng ($83.90 in chips)
Seat 4: aYii2DmxlOlbC1wbGRBWvQ ($99.80 in chips)
oDiBRCaF0QVtd3kO6xZIXw: posts small blind $0.50
dxyNCn/qxfkGDUIf28Cbng: posts big blind $1
OGMLOcTNYZXZU81au7ztUw: sits out
*** HOLE CARDS ***
aYii2DmxlOlbC1wbGRBWvQ: raises $2 to $3
eUBBn2R56C1IQ6Cs/vitwg: folds
oDiBRCaF0QVtd3kO6xZIXw: calls $2.50
dxyNCn/qxfkGDUIf28Cbng: folds
*** FLOP *** [8d 3d 5d]
oDiBRCaF0QVtd3kO6xZIXw: bets $6
aYii2DmxlOlbC1wbGRBWvQ: folds
oDiBRCaF0QVtd3kO6xZIXw collected $6.65 from pot
oDiBRCaF0QVtd3kO6xZIXw: doesn't show hand
*** SUMMARY ***
Total pot $7 | Rake $0.35
Board [8d 3d 5d]
Seat 1: eUBBn2R56C1IQ6Cs/vitwg (button) folded before Flop (didn't bet)
Seat 2: oDiBRCaF0QVtd3kO6xZIXw (small blind) collected ($6.65)
Seat 3: dxyNCn/qxfkGDUIf28Cbng (big blind) folded before Flop
Seat 4: aYii2DmxlOlbC1wbGRBWvQ folded on the Flop



PokerStars Game #59940315392:  Hold'em No Limit ($0.50/$1.00) - 2009/07/01 1:03:11 ET
Table '+cA8mcmhaedZ7YcrDdhmeQ' 6-max Seat #5 is the button
Seat 1: lsLuWlcPA3Rh7kJVLzMh0Q ($302.45 in chips)
Seat 2: RqgF7gRoKgRNW8Zoi1ty4A ($110.55 in chips)
Seat 3: 7H5WkGzGvsv56y1iaqHvRg ($22.20 in chips)
Seat 4: 4OO5v3AVduL0tePNx8wk5A ($101 in chips)
Seat 5: +7hFKAL0b0O/n8G72TclJA ($64.35 in chips)
Seat 6: YfsTQsY/fxb+YqbdclTHuw ($25.60 in chips)
YfsTQsY/fxb+YqbdclTHuw: posts small blind $0.50
lsLuWlcPA3Rh7kJVLzMh0Q: posts big blind $1
*** HOLE CARDS ***
RqgF7gRoKgRNW8Zoi1ty4A: raises $3 to $4
7H5WkGzGvsv56y1iaqHvRg: folds
4OO5v3AVduL0tePNx8wk5A: folds
+7hFKAL0b0O/n8G72TclJA: folds
YfsTQsY/fxb+YqbdclTHuw: calls $3.50
lsLuWlcPA3Rh7kJVLzMh0Q: folds
*** FLOP *** [7h Qd Qh]
YfsTQsY/fxb+YqbdclTHuw: checks
RqgF7gRoKgRNW8Zoi1ty4A: bets $5
YfsTQsY/fxb+YqbdclTHuw: folds
RqgF7gRoKgRNW8Zoi1ty4A collected $8.55 from pot
*** SUMMARY ***
Total pot $9 | Rake $0.45
Board [7h Qd Qh]
Seat 1: lsLuWlcPA3Rh7kJVLzMh0Q (big blind) folded before Flop
Seat 2: RqgF7gRoKgRNW8Zoi1ty4A collected ($8.55)
Seat 3: 7H5WkGzGvsv56y1iaqHvRg folded before Flop (didn't bet)
Seat 4: 4OO5v3AVduL0tePNx8wk5A folded before Flop (didn't bet)
Seat 5: +7hFKAL0b0O/n8G72TclJA (button) folded before Flop (didn't bet)
Seat 6: YfsTQsY/fxb+YqbdclTHuw (small blind) folded on the Flop



PokerStars Game #59940316010:  Hold'em No Limit ($0.50/$1.00) - 2009/07/01 1:03:12 ET
Table '8jIjWCPY0NGprquL+xcMFg' 9-max Seat #6 is the button
Seat 1: N7iZ0peZns5o4A6AjN24jQ ($44.60 in chips)
Seat 2: laA8va+Yv8WuMqT1zdR91g ($108.70 in chips)
Seat 3: tjhwe1V98x2spSoUQER3HQ ($108.95 in chips)
Seat 4: Jjc7EHWzs4//xUAjJ0UWoA ($18.90 in chips)
Seat 5: 2YpnxJiexJHyERfbqgwEcw ($53.55 in chips)
Seat 6: GTQkFJtSkbVbnGCktp6e3g ($100 in chips)
Seat 7: O3CGPwwUmamrCNHccOilrg ($36.45 in chips)
Seat 8: D+W9Me7w6Hcx/WRUSKV0dw ($18.50 in chips)
Seat 9: negfosHnGOZXSHpWDRKyBQ ($57.65 in chips)
O3CGPwwUmamrCNHccOilrg: posts small blind $0.50
D+W9Me7w6Hcx/WRUSKV0dw: posts big blind $1
*** HOLE CARDS ***
negfosHnGOZXSHpWDRKyBQ: folds
N7iZ0peZns5o4A6AjN24jQ: calls $1
laA8va+Yv8WuMqT1zdR91g: folds
tjhwe1V98x2spSoUQER3HQ: folds
Jjc7EHWzs4//xUAjJ0UWoA: folds
2YpnxJiexJHyERfbqgwEcw: folds
GTQkFJtSkbVbnGCktp6e3g: folds
O3CGPwwUmamrCNHccOilrg: calls $0.50
D+W9Me7w6Hcx/WRUSKV0dw: checks
*** FLOP *** [2c 8d Ac]
O3CGPwwUmamrCNHccOilrg: checks
D+W9Me7w6Hcx/WRUSKV0dw: checks
N7iZ0peZns5o4A6AjN24jQ: checks
*** TURN *** [2c 8d Ac] [4c]
O3CGPwwUmamrCNHccOilrg: checks
D+W9Me7w6Hcx/WRUSKV0dw: checks
N7iZ0peZns5o4A6AjN24jQ: checks
*** RIVER *** [2c 8d Ac 4c] [2h]
O3CGPwwUmamrCNHccOilrg: checks
D+W9Me7w6Hcx/WRUSKV0dw: checks
N7iZ0peZns5o4A6AjN24jQ: bets $1
O3CGPwwUmamrCNHccOilrg: calls $1
D+W9Me7w6Hcx/WRUSKV0dw: folds
*** SHOW DOWN ***
N7iZ0peZns5o4A6AjN24jQ: shows [8h 9c] (two pair, Eights and Deuces)
O3CGPwwUmamrCNHccOilrg: mucks hand
N7iZ0peZns5o4A6AjN24jQ collected $4.80 from pot
*** SUMMARY ***
Total pot $5 | Rake $0.20
Board [2c 8d Ac 4c 2h]
Seat 1: N7iZ0peZns5o4A6AjN24jQ showed [8h 9c] and won ($4.80) with two pair, Eights and Deuces
Seat 2: laA8va+Yv8WuMqT1zdR91g folded before Flop (didn't bet)
Seat 3: tjhwe1V98x2spSoUQER3HQ folded before Flop (didn't bet)
Seat 4: Jjc7EHWzs4//xUAjJ0UWoA folded before Flop (didn't bet)
Seat 5: 2YpnxJiexJHyERfbqgwEcw folded before Flop (didn't bet)
Seat 6: GTQkFJtSkbVbnGCktp6e3g (button) folded before Flop (didn't bet)
Seat 7: O3CGPwwUmamrCNHccOilrg (small blind) mucked
Seat 8: D+W9Me7w6Hcx/WRUSKV0dw (big blind) folded on the River
Seat 9: negfosHnGOZXSHpWDRKyBQ folded before Flop (didn't bet)



PokerStars Game #59940316578:  Hold'em No Limit ($0.50/$1.00) - 2009/07/01 1:03:13 ET
Table 'JTT1XWaDZHSaMZQK7cR5uw' 2-max Seat #1 is the button
Seat 1: OLplZF6FEnLflv81Hz+Fxg ($132.05 in chips)
Seat 2: BcqgegiOUxmBD3F3umsljg ($77.75 in chips)
OLplZF6FEnLflv81Hz+Fxg: posts small blind $0.50
BcqgegiOUxmBD3F3umsljg: posts big blind $1
*** HOLE CARDS ***
OLplZF6FEnLflv81Hz+Fxg: folds
BcqgegiOUxmBD3F3umsljg collected $1 from pot
*** SUMMARY ***
Total pot $1 | Rake $0
Seat 1: OLplZF6FEnLflv81Hz+Fxg (button) (small blind) folded before Flop
Seat 2: BcqgegiOUxmBD3F3umsljg (big blind) collected ($1)



PokerStars Game #59940317402:  Hold'em No Limit ($0.50/$1.00) - 2009/07/01 1:03:14 ET
Table 'rmZfTK+oSebeUPJNbWhdAA' 6-max Seat #1 is the button
Seat 1: xAU6q2/cwmby2sxmA8VcmA ($147 in chips)
Seat 2: z7O9PO/WEcqRouIydFhS9Q ($121.55 in chips)
Seat 3: BCEV3COoKY607AzLWayfRA ($134 in chips)
Seat 4: 1/mIuXfgx1ZyVkodrmfQDw ($102.70 in chips)
Seat 5: 5lY8d6Cnm4HUkt/8FZSj4g ($89.90 in chips)
z7O9PO/WEcqRouIydFhS9Q: posts small blind $0.50
BCEV3COoKY607AzLWayfRA: posts big blind $1
*** HOLE CARDS ***
1/mIuXfgx1ZyVkodrmfQDw: folds
j7NIOHLZk7V2o9fOioO5ug has returned
5lY8d6Cnm4HUkt/8FZSj4g: folds
xAU6q2/cwmby2sxmA8VcmA: raises $3 to $4
z7O9PO/WEcqRouIydFhS9Q: folds
BCEV3COoKY607AzLWayfRA: folds
xAU6q2/cwmby2sxmA8VcmA collected $2.50 from pot
xAU6q2/cwmby2sxmA8VcmA: doesn't show hand
*** SUMMARY ***
Total pot $2.50 | Rake $0
Seat 1: xAU6q2/cwmby2sxmA8VcmA (button) collected ($2.50)
Seat 2: z7O9PO/WEcqRouIydFhS9Q (small blind) folded before Flop
Seat 3: BCEV3COoKY607AzLWayfRA (big blind) folded before Flop
Seat 4: 1/mIuXfgx1ZyVkodrmfQDw folded before Flop (didn't bet)
Seat 5: 5lY8d6Cnm4HUkt/8FZSj4g folded before Flop (didn't bet)



PokerStars Game #59940318244:  Hold'em No Limit ($0.50/$1.00) - 2009/07/01 1:03:15 ET
Table 'eU3bWpDDg3Z+9R4m4iVmog' 6-max Seat #3 is the button
Seat 1: TSuRyAHnUPCFjP7Z0rEE0w ($189.65 in chips)
Seat 2: 8CAoOzhmB8n3nRFf3V4BTg ($59.30 in chips)
Seat 3: rVMOzU7w5FddYPGhD7qN2Q ($40.15 in chips)
Seat 4: GDVIsbEJ/DOJsMKE4Asz0A ($109.50 in chips)
Seat 6: hpxXcmRkXXI9HE5+5/j/0Q ($128.25 in chips)
GDVIsbEJ/DOJsMKE4Asz0A: posts small blind $0.50
hpxXcmRkXXI9HE5+5/j/0Q: posts big blind $1
*** HOLE CARDS ***
TSuRyAHnUPCFjP7Z0rEE0w: raises $3 to $4
8CAoOzhmB8n3nRFf3V4BTg: calls $4
rVMOzU7w5FddYPGhD7qN2Q: folds
GDVIsbEJ/DOJsMKE4Asz0A: calls $3.50
hpxXcmRkXXI9HE5+5/j/0Q: folds
*** FLOP *** [Kd 8c 2s]
GDVIsbEJ/DOJsMKE4Asz0A: checks
TSuRyAHnUPCFjP7Z0rEE0w: bets $7
8CAoOzhmB8n3nRFf3V4BTg: folds
GDVIsbEJ/DOJsMKE4Asz0A: raises $8 to $15
TSuRyAHnUPCFjP7Z0rEE0w: folds
GDVIsbEJ/DOJsMKE4Asz0A collected $25.70 from pot
GDVIsbEJ/DOJsMKE4Asz0A: doesn't show hand
*** SUMMARY ***
Total pot $27 | Rake $1.30
Board [Kd 8c 2s]
Seat 1: TSuRyAHnUPCFjP7Z0rEE0w folded on the Flop
Seat 2: 8CAoOzhmB8n3nRFf3V4BTg folded on the Flop
Seat 3: rVMOzU7w5FddYPGhD7qN2Q (button) folded before Flop (didn't bet)
Seat 4: GDVIsbEJ/DOJsMKE4Asz0A (small blind) collected ($25.70)
Seat 6: hpxXcmRkXXI9HE5+5/j/0Q (big blind) folded before Flop



PokerStars Game #59940318218:  Hold'em No Limit ($0.50/$1.00) - 2009/07/01 1:03:15 ET
Table 'cKH9c4x6u79IqCdaKKvXrw' 9-max Seat #6 is the button
Seat 1: Pp/KTcXkfZKKUHkjyaLTdg ($20 in chips)
Seat 2: 8S3JMH4TY3whgIlZmMv66w ($67.65 in chips)
Seat 3: 997ViqAtWn1FPjJqcffwcA ($157.10 in chips)
Seat 4: FL3MrLspcF23LYvC4ipBOA ($100 in chips)
Seat 5: Jjc7EHWzs4//xUAjJ0UWoA ($40.65 in chips)
Seat 6: Bsd/K5gAcLanYbGiPirRjw ($206.55 in chips)
Seat 7: 1GkkVBhlJ92guE6K5mS5Ig ($18.25 in chips)
Seat 8: myIxN7otsyr846M539YR8Q ($18.50 in chips)
Seat 9: 6XkTu4ahxzHnvjjc1R8YjQ ($41.60 in chips)
1GkkVBhlJ92guE6K5mS5Ig: posts small blind $0.50
myIxN7otsyr846M539YR8Q: posts big blind $1
*** HOLE CARDS ***
6XkTu4ahxzHnvjjc1R8YjQ: raises $2 to $3
Pp/KTcXkfZKKUHkjyaLTdg: folds
8S3JMH4TY3whgIlZmMv66w: folds
997ViqAtWn1FPjJqcffwcA: folds
FL3MrLspcF23LYvC4ipBOA: folds
Jjc7EHWzs4//xUAjJ0UWoA: folds
Bsd/K5gAcLanYbGiPirRjw: folds
1GkkVBhlJ92guE6K5mS5Ig: folds
myIxN7otsyr846M539YR8Q: folds
6XkTu4ahxzHnvjjc1R8YjQ collected $2.50 from pot
*** SUMMARY ***
Total pot $2.50 | Rake $0
Seat 1: Pp/KTcXkfZKKUHkjyaLTdg folded before Flop (didn't bet)
Seat 2: 8S3JMH4TY3whgIlZmMv66w folded before Flop (didn't bet)
Seat 3: 997ViqAtWn1FPjJqcffwcA folded before Flop (didn't bet)
Seat 4: FL3MrLspcF23LYvC4ipBOA folded before Flop (didn't bet)
Seat 5: Jjc7EHWzs4//xUAjJ0UWoA folded before Flop (didn't bet)
Seat 6: Bsd/K5gAcLanYbGiPirRjw (button) folded before Flop (didn't bet)
Seat 7: 1GkkVBhlJ92guE6K5mS5Ig (small blind) folded before Flop
Seat 8: myIxN7otsyr846M539YR8Q (big blind) folded before Flop
Seat 9: 6XkTu4ahxzHnvjjc1R8YjQ collected ($2.50)



PokerStars Game #59940318362:  Hold'em No Limit ($0.50/$1.00) - 2009/07/01 1:03:16 ET
Table 'pHrhryH8jPNdQfY62f8v+g' 6-max Seat #1 is the button
Seat 1: OvwYHV65yUbgdBjSmo1+5g ($54 in chips)
Seat 2: RqgF7gRoKgRNW8Zoi1ty4A ($137.30 in chips)
Seat 3: 8oS5O7iD/qnFXFXJrGIgNQ ($151.80 in chips)
Seat 5: r1/R7y0Ortgoz4lccgW8VA ($48.05 in chips)
Seat 6: xAU6q2/cwmby2sxmA8VcmA ($103.80 in chips)
RqgF7gRoKgRNW8Zoi1ty4A: posts small blind $0.50
8oS5O7iD/qnFXFXJrGIgNQ: posts big blind $1
*** HOLE CARDS ***
r1/R7y0Ortgoz4lccgW8VA: folds
xAU6q2/cwmby2sxmA8VcmA: folds
OvwYHV65yUbgdBjSmo1+5g: folds
RqgF7gRoKgRNW8Zoi1ty4A: folds
8oS5O7iD/qnFXFXJrGIgNQ collected $1 from pot
*** SUMMARY ***
Total pot $1 | Rake $0
Seat 1: OvwYHV65yUbgdBjSmo1+5g (button) folded before Flop (didn't bet)
Seat 2: RqgF7gRoKgRNW8Zoi1ty4A (small blind) folded before Flop
Seat 3: 8oS5O7iD/qnFXFXJrGIgNQ (big blind) collected ($1)
Seat 5: r1/R7y0Ortgoz4lccgW8VA folded before Flop (didn't bet)
Seat 6: xAU6q2/cwmby2sxmA8VcmA folded before Flop (didn't bet)



PokerStars Game #59940319176:  Hold'em No Limit ($0.50/$1.00) - 2009/07/01 1:03:17 ET
Table 'iSx0wTgVb4o7MyZeOe06ZA' 9-max Seat #2 is the button
Seat 1: VPF+HjszMvUIpy0CHIwH3A ($19 in chips)
Seat 2: myIxN7otsyr846M539YR8Q ($19.50 in chips)
Seat 4: 0fXz44fzDo5QmhAaJCvFfA ($18 in chips)
Seat 5: o1axyw4AjQ8n4ubTwlirQQ ($22 in chips)
Seat 6: T5/PXFS/W+LLcIXBo1G/RA ($159.20 in chips)
Seat 7: w4NnqVr/Sfoj65ux/fEUyQ ($77.90 in chips)
Seat 8: gUUvmqdVlmvpal6B8nYrmg ($102.30 in chips)
/inIs/z/PcX+TniIFpaxpg will be allowed to play after the button
0fXz44fzDo5QmhAaJCvFfA: posts small blind $0.50
o1axyw4AjQ8n4ubTwlirQQ: posts big blind $1
mQADhUTC1xGjAJkD7PEg6A: sits out
*** HOLE CARDS ***
T5/PXFS/W+LLcIXBo1G/RA: calls $1
w4NnqVr/Sfoj65ux/fEUyQ: folds
gUUvmqdVlmvpal6B8nYrmg: folds
VPF+HjszMvUIpy0CHIwH3A: folds
myIxN7otsyr846M539YR8Q: raises $18.50 to $19.50 and is all-in
0fXz44fzDo5QmhAaJCvFfA: folds
o1axyw4AjQ8n4ubTwlirQQ: folds
T5/PXFS/W+LLcIXBo1G/RA: calls $18.50
*** FLOP *** [8c 5s 8s]
*** TURN *** [8c 5s 8s] [9s]
*** RIVER *** [8c 5s 8s 9s] [Jd]
*** SHOW DOWN ***
T5/PXFS/W+LLcIXBo1G/RA: shows [Kd Qc] (a pair of Eights)
myIxN7otsyr846M539YR8Q: shows [Th Ac] (a pair of Eights - Ace kicker)
myIxN7otsyr846M539YR8Q collected $38.50 from pot
*** SUMMARY ***
Total pot $40.50 | Rake $2
Board [8c 5s 8s 9s Jd]
Seat 1: VPF+HjszMvUIpy0CHIwH3A folded before Flop (didn't bet)
Seat 2: myIxN7otsyr846M539YR8Q (button) showed [Th Ac] and won ($38.50) with a pair of Eights
Seat 4: 0fXz44fzDo5QmhAaJCvFfA (small blind) folded before Flop
Seat 5: o1axyw4AjQ8n4ubTwlirQQ (big blind) folded before Flop
Seat 6: T5/PXFS/W+LLcIXBo1G/RA showed [Kd Qc] and lost with a pair of Eights
Seat 7: w4NnqVr/Sfoj65ux/fEUyQ folded before Flop (didn't bet)
Seat 8: gUUvmqdVlmvpal6B8nYrmg folded before Flop (didn't bet)



PokerStars Game #59940319930:  Hold'em No Limit ($0.50/$1.00) - 2009/07/01 1:03:18 ET
Table 'JTT1XWaDZHSaMZQK7cR5uw' 2-max Seat #2 is the button
Seat 1: OLplZF6FEnLflv81Hz+Fxg ($131.55 in chips)
Seat 2: BcqgegiOUxmBD3F3umsljg ($78.25 in chips)
BcqgegiOUxmBD3F3umsljg: posts small blind $0.50
OLplZF6FEnLflv81Hz+Fxg: posts big blind $1
*** HOLE CARDS ***
BcqgegiOUxmBD3F3umsljg: folds
OLplZF6FEnLflv81Hz+Fxg collected $1 from pot
*** SUMMARY ***
Total pot $1 | Rake $0
Seat 1: OLplZF6FEnLflv81Hz+Fxg (big blind) collected ($1)
Seat 2: BcqgegiOUxmBD3F3umsljg (button) (small blind) folded before Flop



PokerStars Game #59940320576:  Hold'em No Limit ($0.50/$1.00) - 2009/07/01 1:03:19 ET
Table 'hugOjcwJvzEwZbK7tyiWuQ' 9-max Seat #8 is the button
Seat 2: r27C1nIV4NS4+qbnrgBQSw ($283.20 in chips)
Seat 3: jDwhY1kCdc6EkAHbT7PJMQ ($104.75 in chips)
Seat 4: UWB3oeddt/GObx2Mix2Anw ($174.80 in chips)
Seat 5: 5BRGWf+R3nt2WS3b5xX+zA ($16.75 in chips)
Seat 6: gUUvmqdVlmvpal6B8nYrmg ($107.40 in chips)
Seat 7: FL3MrLspcF23LYvC4ipBOA ($110.30 in chips)
Seat 8: /zy+DB4S5fUQUSfZWFzYGw ($100 in chips)
Seat 9: W8P9bUKCs43TO1xHm0dL6w ($88.45 in chips)
W8P9bUKCs43TO1xHm0dL6w: posts small blind $0.50
D+W9Me7w6Hcx/WRUSKV0dw: is sitting out
r27C1nIV4NS4+qbnrgBQSw: posts big blind $1
*** HOLE CARDS ***
D+W9Me7w6Hcx/WRUSKV0dw leaves the table
jDwhY1kCdc6EkAHbT7PJMQ: raises $3 to $4
UWB3oeddt/GObx2Mix2Anw: folds
5BRGWf+R3nt2WS3b5xX+zA: folds
gUUvmqdVlmvpal6B8nYrmg: folds
FL3MrLspcF23LYvC4ipBOA: folds
/zy+DB4S5fUQUSfZWFzYGw: folds
W8P9bUKCs43TO1xHm0dL6w: folds
r27C1nIV4NS4+qbnrgBQSw: folds
jDwhY1kCdc6EkAHbT7PJMQ collected $2.50 from pot
*** SUMMARY ***
Total pot $2.50 | Rake $0
Seat 2: r27C1nIV4NS4+qbnrgBQSw (big blind) folded before Flop
Seat 3: jDwhY1kCdc6EkAHbT7PJMQ collected ($2.50)
Seat 4: UWB3oeddt/GObx2Mix2Anw folded before Flop (didn't bet)
Seat 5: 5BRGWf+R3nt2WS3b5xX+zA folded before Flop (didn't bet)
Seat 6: gUUvmqdVlmvpal6B8nYrmg folded before Flop (didn't bet)
Seat 7: FL3MrLspcF23LYvC4ipBOA folded before Flop (didn't bet)
Seat 8: /zy+DB4S5fUQUSfZWFzYGw (button) folded before Flop (didn't bet)
Seat 9: W8P9bUKCs43TO1xHm0dL6w (small blind) folded before Flop



PokerStars Game #59940321650:  Hold'em No Limit ($0.50/$1.00) - 2009/07/01 1:03:21 ET
Table 'vs/5jr6ciwjVQ5+Soc+u2A' 6-max Seat #4 is the button
Seat 1: /P4w1pHg2zHYg/4ubJ0dPw ($61.80 in chips)
Seat 2: lXX4W7m3u++JiSOZ46yVMQ ($98.50 in chips)
Seat 3: G5ZSSN6RSON3gkNvk/SmYg ($137.85 in chips)
Seat 4: wk6Ohn4GDozoOMHc4eb2rw ($88.65 in chips)
Seat 5: +Nt3OPk3XR9SKjZgm2CexQ ($103.80 in chips)
+Nt3OPk3XR9SKjZgm2CexQ: posts small blind $0.50
/P4w1pHg2zHYg/4ubJ0dPw: posts big blind $1
*** HOLE CARDS ***
lXX4W7m3u++JiSOZ46yVMQ: raises $2 to $3
G5ZSSN6RSON3gkNvk/SmYg: folds
wk6Ohn4GDozoOMHc4eb2rw: folds
+Nt3OPk3XR9SKjZgm2CexQ: folds
/P4w1pHg2zHYg/4ubJ0dPw: folds
lXX4W7m3u++JiSOZ46yVMQ collected $2.50 from pot
*** SUMMARY ***
Total pot $2.50 | Rake $0
Seat 1: /P4w1pHg2zHYg/4ubJ0dPw (big blind) folded before Flop
Seat 2: lXX4W7m3u++JiSOZ46yVMQ collected ($2.50)
Seat 3: G5ZSSN6RSON3gkNvk/SmYg folded before Flop (didn't bet)
Seat 4: wk6Ohn4GDozoOMHc4eb2rw (button) folded before Flop (didn't bet)
Seat 5: +Nt3OPk3XR9SKjZgm2CexQ (small blind) folded before Flop



PokerStars Game #59940321342:  Hold'em No Limit ($0.50/$1.00) - 2009/07/01 1:03:21 ET
Table 'QSIig7BLMc9wY/rgBechzw' 6-max Seat #3 is the button
Seat 1: Z2fXsGcjl+Eax+RzOgwOmg ($100 in chips)
Seat 2: mLOIkH/qmRa+mVujQIhBRg ($40.65 in chips)
Seat 3: Z3y97GMLCsoTZ9j7f6qctg ($28.80 in chips)
Seat 4: +uSzP8Jwnw7sKfQ4s66b7w ($70.60 in chips)
Seat 5: PVmmeYpn4gqkqYUool6BOA ($16.90 in chips)
Seat 6: PxqfkAMdAWtkgbT+q2gciA ($35.70 in chips)
+uSzP8Jwnw7sKfQ4s66b7w: posts small blind $0.50
PVmmeYpn4gqkqYUool6BOA: posts big blind $1
*** HOLE CARDS ***
PxqfkAMdAWtkgbT+q2gciA: raises $2 to $3
Z2fXsGcjl+Eax+RzOgwOmg: folds
mLOIkH/qmRa+mVujQIhBRg: folds
Z3y97GMLCsoTZ9j7f6qctg: folds
+uSzP8Jwnw7sKfQ4s66b7w: folds
Z3y97GMLCsoTZ9j7f6qctg leaves the table
PVmmeYpn4gqkqYUool6BOA: folds
PxqfkAMdAWtkgbT+q2gciA collected $2.50 from pot
*** SUMMARY ***
Total pot $2.50 | Rake $0
Seat 1: Z2fXsGcjl+Eax+RzOgwOmg folded before Flop (didn't bet)
Seat 2: mLOIkH/qmRa+mVujQIhBRg folded before Flop (didn't bet)
Seat 3: Z3y97GMLCsoTZ9j7f6qctg (button) folded before Flop (didn't bet)
Seat 4: +uSzP8Jwnw7sKfQ4s66b7w (small blind) folded before Flop
Seat 5: PVmmeYpn4gqkqYUool6BOA (big blind) folded before Flop
Seat 6: PxqfkAMdAWtkgbT+q2gciA collected ($2.50)



PokerStars Game #59940322184:  Hold'em No Limit ($0.50/$1.00) - 2009/07/01 1:03:22 ET
Table 'kS0cTQAEi+fdUlJP2gQYvw' 9-max Seat #9 is the button
Seat 1: c/9X4zftzphFxYtxp5kp9w ($64.85 in chips)
Seat 2: D+W9Me7w6Hcx/WRUSKV0dw ($20 in chips)
Seat 3: 2BV+oJIQYr65IO6nEChvbA ($60 in chips)
Seat 4: TZcz9MEWDA+WydgGruqqbw ($100.10 in chips)
Seat 5: 997ViqAtWn1FPjJqcffwcA ($104.15 in chips)
Seat 6: yAbu2QsRPVcjPbqlf/jDxw ($127.65 in chips)
Seat 7: Ffa7Nj4X5fddtROP01hfQg ($132.55 in chips)
Seat 8: QYMfy2FoN6/Qe1LWYuI7fw ($20.50 in chips)
Seat 9: OGgaARGdJQT4awWVNQ957w ($102 in chips)
c/9X4zftzphFxYtxp5kp9w: posts small blind $0.50
D+W9Me7w6Hcx/WRUSKV0dw: posts big blind $1
*** HOLE CARDS ***
2BV+oJIQYr65IO6nEChvbA: folds
TZcz9MEWDA+WydgGruqqbw: folds
997ViqAtWn1FPjJqcffwcA: folds
yAbu2QsRPVcjPbqlf/jDxw: folds
Ffa7Nj4X5fddtROP01hfQg: calls $1
QYMfy2FoN6/Qe1LWYuI7fw: folds
OGgaARGdJQT4awWVNQ957w: folds
c/9X4zftzphFxYtxp5kp9w: folds
D+W9Me7w6Hcx/WRUSKV0dw: checks
*** FLOP *** [2s 8d 3d]
D+W9Me7w6Hcx/WRUSKV0dw: bets $1.80
Ffa7Nj4X5fddtROP01hfQg: folds
D+W9Me7w6Hcx/WRUSKV0dw collected $2.40 from pot
D+W9Me7w6Hcx/WRUSKV0dw: doesn't show hand
*** SUMMARY ***
Total pot $2.50 | Rake $0.10
Board [2s 8d 3d]
Seat 1: c/9X4zftzphFxYtxp5kp9w (small blind) folded before Flop
Seat 2: D+W9Me7w6Hcx/WRUSKV0dw (big blind) collected ($2.40)
Seat 3: 2BV+oJIQYr65IO6nEChvbA folded before Flop (didn't bet)
Seat 4: TZcz9MEWDA+WydgGruqqbw folded before Flop (didn't bet)
Seat 5: 997ViqAtWn1FPjJqcffwcA folded before Flop (didn't bet)
Seat 6: yAbu2QsRPVcjPbqlf/jDxw folded before Flop (didn't bet)
Seat 7: Ffa7Nj4X5fddtROP01hfQg folded on the Flop
Seat 8: QYMfy2FoN6/Qe1LWYuI7fw folded before Flop (didn't bet)
Seat 9: OGgaARGdJQT4awWVNQ957w (button) folded before Flop (didn't bet)



PokerStars Game #59940324026:  Hold'em No Limit ($0.50/$1.00) - 2009/07/01 1:03:25 ET
Table 'JTT1XWaDZHSaMZQK7cR5uw' 2-max Seat #1 is the button
Seat 1: OLplZF6FEnLflv81Hz+Fxg ($132.05 in chips)
Seat 2: BcqgegiOUxmBD3F3umsljg ($77.75 in chips)
OLplZF6FEnLflv81Hz+Fxg: posts small blind $0.50
BcqgegiOUxmBD3F3umsljg: posts big blind $1
*** HOLE CARDS ***
OLplZF6FEnLflv81Hz+Fxg: raises $2 to $3
BcqgegiOUxmBD3F3umsljg: calls $2
*** FLOP *** [4d 9h 2h]
BcqgegiOUxmBD3F3umsljg: checks
OLplZF6FEnLflv81Hz+Fxg: checks
*** TURN *** [4d 9h 2h] [7h]
BcqgegiOUxmBD3F3umsljg: checks
OLplZF6FEnLflv81Hz+Fxg: bets $4
BcqgegiOUxmBD3F3umsljg: folds
OLplZF6FEnLflv81Hz+Fxg collected $5.70 from pot
*** SUMMARY ***
Total pot $6 | Rake $0.30
Board [4d 9h 2h 7h]
Seat 1: OLplZF6FEnLflv81Hz+Fxg (button) (small blind) collected ($5.70)
Seat 2: BcqgegiOUxmBD3F3umsljg (big blind) folded on the Turn



PokerStars Game #59940324184:  Hold'em No Limit ($0.50/$1.00) - 2009/07/01 1:03:25 ET
Table '6YvsYDPNIDx2v5z3bJnwZQ' 9-max Seat #7 is the button
Seat 1: Ogn4JDV3mp4ZDKO49IFzKA ($22.70 in chips)
Seat 2: +hHqYgKILitkxIzFNGvvsA ($35.25 in chips)
Seat 3: negfosHnGOZXSHpWDRKyBQ ($16.50 in chips)
Seat 4: kEr5NYB+JIG5+szcYMr6hA ($47.80 in chips)
Seat 5: mBRWbnUl8diyBO1qTJaNzw ($162.20 in chips)
Seat 6: 7RSwrjMohkYrZAhOd1uaZg ($6 in chips)
Seat 7: mae7OMTaJ/MFimNbZegCkg ($48.30 in chips)
Seat 8: PSFxpXgPedVZyHSu2Zhb7Q ($117.20 in chips)
PSFxpXgPedVZyHSu2Zhb7Q: posts small blind $0.50
Ogn4JDV3mp4ZDKO49IFzKA: posts big blind $1
*** HOLE CARDS ***
+hHqYgKILitkxIzFNGvvsA: calls $1
negfosHnGOZXSHpWDRKyBQ: folds
kEr5NYB+JIG5+szcYMr6hA: calls $1
mBRWbnUl8diyBO1qTJaNzw: folds
7RSwrjMohkYrZAhOd1uaZg: calls $1
mae7OMTaJ/MFimNbZegCkg: folds
PSFxpXgPedVZyHSu2Zhb7Q: calls $0.50
Ogn4JDV3mp4ZDKO49IFzKA: checks
*** FLOP *** [Kc Jc 5c]
PSFxpXgPedVZyHSu2Zhb7Q: checks
Ogn4JDV3mp4ZDKO49IFzKA: checks
+hHqYgKILitkxIzFNGvvsA: checks
kEr5NYB+JIG5+szcYMr6hA: checks
7RSwrjMohkYrZAhOd1uaZg: checks
*** TURN *** [Kc Jc 5c] [5h]
PSFxpXgPedVZyHSu2Zhb7Q: bets $2
Ogn4JDV3mp4ZDKO49IFzKA: raises $19.70 to $21.70 and is all-in
+hHqYgKILitkxIzFNGvvsA: folds
kEr5NYB+JIG5+szcYMr6hA: folds
7RSwrjMohkYrZAhOd1uaZg: calls $5 and is all-in
PSFxpXgPedVZyHSu2Zhb7Q: folds
*** RIVER *** [Kc Jc 5c 5h] [Kh]
*** SHOW DOWN ***
Ogn4JDV3mp4ZDKO49IFzKA: shows [4c 6c] (a flush, King high)
7RSwrjMohkYrZAhOd1uaZg: shows [3c Qc] (a flush, King high - Queen higher)
7RSwrjMohkYrZAhOd1uaZg collected $16.20 from pot
*** SUMMARY ***
Total pot $17 | Rake $0.80
Board [Kc Jc 5c 5h Kh]
Seat 1: Ogn4JDV3mp4ZDKO49IFzKA (big blind) showed [4c 6c] and lost with a flush, King high
Seat 2: +hHqYgKILitkxIzFNGvvsA folded on the Turn
Seat 3: negfosHnGOZXSHpWDRKyBQ folded before Flop (didn't bet)
Seat 4: kEr5NYB+JIG5+szcYMr6hA folded on the Turn
Seat 5: mBRWbnUl8diyBO1qTJaNzw folded before Flop (didn't bet)
Seat 6: 7RSwrjMohkYrZAhOd1uaZg showed [3c Qc] and won ($16.20) with a flush, King high
Seat 7: mae7OMTaJ/MFimNbZegCkg (button) folded before Flop (didn't bet)
Seat 8: PSFxpXgPedVZyHSu2Zhb7Q (small blind) folded on the Turn



PokerStars Game #59940327528:  Hold'em No Limit ($0.50/$1.00) - 2009/07/01 1:03:31 ET
Table '/RZcOwpZpHQ+OwPwjsbnRw' 6-max Seat #3 is the button
Seat 2: +xW7QemQU0Fxs+4TnqBRow ($225.15 in chips)
Seat 3: XnT1yK2DD/5FL+0bwuEhqg ($42.30 in chips)
Seat 5: wx3sQGkVi2x9wJXuWNHPBw ($176.65 in chips)
Seat 6: 2d/PU00mMdO9azAaXqcSbw ($12.35 in chips)
j7NIOHLZk7V2o9fOioO5ug will be allowed to play after the button
wx3sQGkVi2x9wJXuWNHPBw: posts small blind $0.50
2d/PU00mMdO9azAaXqcSbw: posts big blind $1
*** HOLE CARDS ***
+xW7QemQU0Fxs+4TnqBRow: folds
XnT1yK2DD/5FL+0bwuEhqg: folds
wx3sQGkVi2x9wJXuWNHPBw: folds
2d/PU00mMdO9azAaXqcSbw collected $1 from pot
2d/PU00mMdO9azAaXqcSbw: doesn't show hand
*** SUMMARY ***
Total pot $1 | Rake $0
Seat 2: +xW7QemQU0Fxs+4TnqBRow folded before Flop (didn't bet)
Seat 3: XnT1yK2DD/5FL+0bwuEhqg (button) folded before Flop (didn't bet)
Seat 5: wx3sQGkVi2x9wJXuWNHPBw (small blind) folded before Flop
Seat 6: 2d/PU00mMdO9azAaXqcSbw (big blind) collected ($1)



PokerStars Game #59940329038:  Hold'em No Limit ($0.50/$1.00) - 2009/07/01 1:03:33 ET
Table '7Nl0ffnjeK44/vmeexh3MQ' 9-max Seat #1 is the button
Seat 1: s7D3Y+k4Cj4D1cXHv7oj+Q ($94.85 in chips)
Seat 2: OGgaARGdJQT4awWVNQ957w ($100.50 in chips)
Seat 4: bLbSOSmSOnqE0iTcH/5dxA ($100 in chips)
Seat 6: FVs16t7GgfWgQWt4JxsObQ ($50.80 in chips)
Seat 7: 997ViqAtWn1FPjJqcffwcA ($100 in chips)
Seat 8: D+W9Me7w6Hcx/WRUSKV0dw ($19.75 in chips)
Seat 9: ouwUBGRKnKK9uhn1G4Lf+A ($195.50 in chips)
OGgaARGdJQT4awWVNQ957w: posts small blind $0.50
vR4IO10geOgvTW+LAUBv/A: is sitting out
bLbSOSmSOnqE0iTcH/5dxA: posts big blind $1
61sfw5QTu62YYIt68OsdrA: sits out
*** HOLE CARDS ***
FVs16t7GgfWgQWt4JxsObQ: calls $1
997ViqAtWn1FPjJqcffwcA: folds
D+W9Me7w6Hcx/WRUSKV0dw: folds
ouwUBGRKnKK9uhn1G4Lf+A: folds
s7D3Y+k4Cj4D1cXHv7oj+Q: calls $1
vR4IO10geOgvTW+LAUBv/A leaves the table
OGgaARGdJQT4awWVNQ957w: folds
bLbSOSmSOnqE0iTcH/5dxA: checks
*** FLOP *** [5c 2h Ts]
bLbSOSmSOnqE0iTcH/5dxA: checks
FVs16t7GgfWgQWt4JxsObQ: checks
s7D3Y+k4Cj4D1cXHv7oj+Q: checks
*** TURN *** [5c 2h Ts] [6h]
bLbSOSmSOnqE0iTcH/5dxA: checks
FVs16t7GgfWgQWt4JxsObQ: bets $2
s7D3Y+k4Cj4D1cXHv7oj+Q: folds
JMmUYT5pIKCKh2pGjCB/4w joins the table at seat #3
bLbSOSmSOnqE0iTcH/5dxA: folds
FVs16t7GgfWgQWt4JxsObQ collected $3.35 from pot
*** SUMMARY ***
Total pot $3.50 | Rake $0.15
Board [5c 2h Ts 6h]
Seat 1: s7D3Y+k4Cj4D1cXHv7oj+Q (button) folded on the Turn
Seat 2: OGgaARGdJQT4awWVNQ957w (small blind) folded before Flop
Seat 4: bLbSOSmSOnqE0iTcH/5dxA (big blind) folded on the Turn
Seat 6: FVs16t7GgfWgQWt4JxsObQ collected ($3.35)
Seat 7: 997ViqAtWn1FPjJqcffwcA folded before Flop (didn't bet)
Seat 8: D+W9Me7w6Hcx/WRUSKV0dw folded before Flop (didn't bet)
Seat 9: ouwUBGRKnKK9uhn1G4Lf+A folded before Flop (didn't bet)



PokerStars Game #59940328930:  Hold'em No Limit ($0.50/$1.00) - 2009/07/01 1:03:33 ET
Table 'fTlPiCj0utgzC/5io+I7ew' 6-max Seat #6 is the button
Seat 1: YMJG+F++3Aj6P8dAWda5fw ($102.50 in chips)
Seat 2: Qy/UBNbD2HaA0Ogxg8Sf3w ($125.35 in chips)
Seat 3: wL5HjWHHOSGc53xWMNKB9Q ($25.60 in chips)
Seat 4: uJVSceLggtsrJya+WtmUEA ($158 in chips)
Seat 5: GC5g2ryXV7e4TTqmaxUofw ($54.20 in chips)
Seat 6: /P4w1pHg2zHYg/4ubJ0dPw ($69.05 in chips)
YMJG+F++3Aj6P8dAWda5fw: posts small blind $0.50
Qy/UBNbD2HaA0Ogxg8Sf3w: posts big blind $1
GC5g2ryXV7e4TTqmaxUofw: posts big blind $1
*** HOLE CARDS ***
wL5HjWHHOSGc53xWMNKB9Q: folds
uJVSceLggtsrJya+WtmUEA: folds
GC5g2ryXV7e4TTqmaxUofw: checks
/P4w1pHg2zHYg/4ubJ0dPw: folds
YMJG+F++3Aj6P8dAWda5fw: calls $0.50
Qy/UBNbD2HaA0Ogxg8Sf3w: checks
*** FLOP *** [7s Jh 2d]
YMJG+F++3Aj6P8dAWda5fw: bets $1
Qy/UBNbD2HaA0Ogxg8Sf3w: folds
GC5g2ryXV7e4TTqmaxUofw: folds
YMJG+F++3Aj6P8dAWda5fw collected $2.85 from pot
*** SUMMARY ***
Total pot $3 | Rake $0.15
Board [7s Jh 2d]
Seat 1: YMJG+F++3Aj6P8dAWda5fw (small blind) collected ($2.85)
Seat 2: Qy/UBNbD2HaA0Ogxg8Sf3w (big blind) folded on the Flop
Seat 3: wL5HjWHHOSGc53xWMNKB9Q folded before Flop (didn't bet)
Seat 4: uJVSceLggtsrJya+WtmUEA folded before Flop (didn't bet)
Seat 5: GC5g2ryXV7e4TTqmaxUofw folded on the Flop
Seat 6: /P4w1pHg2zHYg/4ubJ0dPw (button) folded before Flop (didn't bet)



PokerStars Game #59940328882:  Hold'em No Limit ($0.50/$1.00) - 2009/07/01 1:03:33 ET
Table 'pHrhryH8jPNdQfY62f8v+g' 6-max Seat #2 is the button
Seat 1: OvwYHV65yUbgdBjSmo1+5g ($54 in chips)
Seat 2: RqgF7gRoKgRNW8Zoi1ty4A ($136.80 in chips)
Seat 3: 8oS5O7iD/qnFXFXJrGIgNQ ($152.30 in chips)
Seat 5: r1/R7y0Ortgoz4lccgW8VA ($48.05 in chips)
Seat 6: xAU6q2/cwmby2sxmA8VcmA ($103.80 in chips)
8oS5O7iD/qnFXFXJrGIgNQ: posts small blind $0.50
r1/R7y0Ortgoz4lccgW8VA: posts big blind $1
*** HOLE CARDS ***
xAU6q2/cwmby2sxmA8VcmA: folds
OvwYHV65yUbgdBjSmo1+5g: calls $1
RqgF7gRoKgRNW8Zoi1ty4A: folds
8oS5O7iD/qnFXFXJrGIgNQ: folds
r1/R7y0Ortgoz4lccgW8VA: checks
*** FLOP *** [7h 8c Tc]
r1/R7y0Ortgoz4lccgW8VA: checks
OvwYHV65yUbgdBjSmo1+5g: bets $2
r1/R7y0Ortgoz4lccgW8VA: calls $2
*** TURN *** [7h 8c Tc] [Kc]
r1/R7y0Ortgoz4lccgW8VA: checks
OvwYHV65yUbgdBjSmo1+5g: bets $4
r1/R7y0Ortgoz4lccgW8VA: folds
OvwYHV65yUbgdBjSmo1+5g collected $6.20 from pot
*** SUMMARY ***
Total pot $6.50 | Rake $0.30
Board [7h 8c Tc Kc]
Seat 1: OvwYHV65yUbgdBjSmo1+5g collected ($6.20)
Seat 2: RqgF7gRoKgRNW8Zoi1ty4A (button) folded before Flop (didn't bet)
Seat 3: 8oS5O7iD/qnFXFXJrGIgNQ (small blind) folded before Flop
Seat 5: r1/R7y0Ortgoz4lccgW8VA (big blind) folded on the Turn
Seat 6: xAU6q2/cwmby2sxmA8VcmA folded before Flop (didn't bet)



PokerStars Game #59940328650:  Hold'em No Limit ($0.50/$1.00) - 2009/07/01 1:03:33 ET
Table 'rmZfTK+oSebeUPJNbWhdAA' 6-max Seat #2 is the button
Seat 1: xAU6q2/cwmby2sxmA8VcmA ($148.50 in chips)
Seat 2: z7O9PO/WEcqRouIydFhS9Q ($121.05 in chips)
Seat 3: BCEV3COoKY607AzLWayfRA ($133 in chips)
Seat 4: 1/mIuXfgx1ZyVkodrmfQDw ($102.70 in chips)
Seat 5: 5lY8d6Cnm4HUkt/8FZSj4g ($89.90 in chips)
BCEV3COoKY607AzLWayfRA: posts small blind $0.50
1/mIuXfgx1ZyVkodrmfQDw: posts big blind $1
j7NIOHLZk7V2o9fOioO5ug: sits out
*** HOLE CARDS ***
5lY8d6Cnm4HUkt/8FZSj4g: folds
xAU6q2/cwmby2sxmA8VcmA: folds
z7O9PO/WEcqRouIydFhS9Q: folds
BCEV3COoKY607AzLWayfRA: folds
1/mIuXfgx1ZyVkodrmfQDw collected $1 from pot
1/mIuXfgx1ZyVkodrmfQDw: doesn't show hand
*** SUMMARY ***
Total pot $1 | Rake $0
Seat 1: xAU6q2/cwmby2sxmA8VcmA folded before Flop (didn't bet)
Seat 2: z7O9PO/WEcqRouIydFhS9Q (button) folded before Flop (didn't bet)
Seat 3: BCEV3COoKY607AzLWayfRA (small blind) folded before Flop
Seat 4: 1/mIuXfgx1ZyVkodrmfQDw (big blind) collected ($1)
Seat 5: 5lY8d6Cnm4HUkt/8FZSj4g folded before Flop (didn't bet)



PokerStars Game #59940330396:  Hold'em No Limit ($0.50/$1.00) - 2009/07/01 1:03:36 ET
Table 'O96CPOtvMBWP6kzuYDfdFA' 6-max Seat #4 is the button
Seat 1: 6alLXQIITA2EZ/lBeym8Dw ($124.55 in chips)
Seat 3: V89DGjxE171oPREEbAXiyg ($88 in chips)
Seat 4: /P4w1pHg2zHYg/4ubJ0dPw ($60.90 in chips)
Seat 5: G5ZSSN6RSON3gkNvk/SmYg ($100 in chips)
Seat 6: GYei5jXGWexiJYbAT2fELg ($24.35 in chips)
G5ZSSN6RSON3gkNvk/SmYg: posts small blind $0.50
GYei5jXGWexiJYbAT2fELg: posts big blind $1
*** HOLE CARDS ***
6alLXQIITA2EZ/lBeym8Dw: folds
V89DGjxE171oPREEbAXiyg: folds
/P4w1pHg2zHYg/4ubJ0dPw: folds
G5ZSSN6RSON3gkNvk/SmYg: folds
V89DGjxE171oPREEbAXiyg said, "nh"
GYei5jXGWexiJYbAT2fELg collected $1 from pot
*** SUMMARY ***
Total pot $1 | Rake $0
Seat 1: 6alLXQIITA2EZ/lBeym8Dw folded before Flop (didn't bet)
Seat 3: V89DGjxE171oPREEbAXiyg folded before Flop (didn't bet)
Seat 4: /P4w1pHg2zHYg/4ubJ0dPw (button) folded before Flop (didn't bet)
Seat 5: G5ZSSN6RSON3gkNvk/SmYg (small blind) folded before Flop
Seat 6: GYei5jXGWexiJYbAT2fELg (big blind) collected ($1)



PokerStars Game #59940331346:  Hold'em No Limit ($0.50/$1.00) - 2009/07/01 1:03:37 ET
Table 'QSIig7BLMc9wY/rgBechzw' 6-max Seat #4 is the button
Seat 1: Z2fXsGcjl+Eax+RzOgwOmg ($100 in chips)
Seat 2: mLOIkH/qmRa+mVujQIhBRg ($40.65 in chips)
Seat 4: +uSzP8Jwnw7sKfQ4s66b7w ($70.10 in chips)
Seat 5: PVmmeYpn4gqkqYUool6BOA ($15.90 in chips)
Seat 6: PxqfkAMdAWtkgbT+q2gciA ($37.20 in chips)
PVmmeYpn4gqkqYUool6BOA: posts small blind $0.50
PxqfkAMdAWtkgbT+q2gciA: posts big blind $1
*** HOLE CARDS ***
Z2fXsGcjl+Eax+RzOgwOmg: folds
+xW7QemQU0Fxs+4TnqBRow joins the table at seat #3
mLOIkH/qmRa+mVujQIhBRg: folds
+uSzP8Jwnw7sKfQ4s66b7w: raises $2 to $3
PVmmeYpn4gqkqYUool6BOA: folds
PxqfkAMdAWtkgbT+q2gciA: calls $2
*** FLOP *** [5h 7c Jc]
PxqfkAMdAWtkgbT+q2gciA: checks
+uSzP8Jwnw7sKfQ4s66b7w: checks
*** TURN *** [5h 7c Jc] [2c]
PxqfkAMdAWtkgbT+q2gciA: bets $2
+uSzP8Jwnw7sKfQ4s66b7w: raises $6 to $8
PxqfkAMdAWtkgbT+q2gciA: folds
+uSzP8Jwnw7sKfQ4s66b7w collected $10 from pot
*** SUMMARY ***
Total pot $10.50 | Rake $0.50
Board [5h 7c Jc 2c]
Seat 1: Z2fXsGcjl+Eax+RzOgwOmg folded before Flop (didn't bet)
Seat 2: mLOIkH/qmRa+mVujQIhBRg folded before Flop (didn't bet)
Seat 4: +uSzP8Jwnw7sKfQ4s66b7w (button) collected ($10)
Seat 5: PVmmeYpn4gqkqYUool6BOA (small blind) folded before Flop
Seat 6: PxqfkAMdAWtkgbT+q2gciA (big blind) folded on the Turn



PokerStars Game #59940331128:  Hold'em No Limit ($0.50/$1.00) - 2009/07/01 1:03:37 ET
Table 'MUPc8FEpe/nR0BKSeReX6Q' 6-max Seat #5 is the button
Seat 1: qhkK6+yCciTRd+rCFEbnEQ ($43.20 in chips)
Seat 2: xAU6q2/cwmby2sxmA8VcmA ($122.70 in chips)
Seat 3: wx3sQGkVi2x9wJXuWNHPBw ($236.40 in chips)
Seat 4: ZA1bp6g8IwtTxkUE4eCjDQ ($195.30 in chips)
Seat 5: UBZQqpnJZdTYYY1FTb0rLA ($100 in chips)
Seat 6: oxnw0GLLpFanjhGkxfRSqA ($24.20 in chips)
oxnw0GLLpFanjhGkxfRSqA: posts small blind $0.50
qhkK6+yCciTRd+rCFEbnEQ: posts big blind $1
*** HOLE CARDS ***
xAU6q2/cwmby2sxmA8VcmA: folds
wx3sQGkVi2x9wJXuWNHPBw: folds
ZA1bp6g8IwtTxkUE4eCjDQ: calls $1
UBZQqpnJZdTYYY1FTb0rLA: folds
oxnw0GLLpFanjhGkxfRSqA: calls $0.50
qhkK6+yCciTRd+rCFEbnEQ: checks
*** FLOP *** [Kd 2s 7s]
oxnw0GLLpFanjhGkxfRSqA: checks
qhkK6+yCciTRd+rCFEbnEQ: checks
ZA1bp6g8IwtTxkUE4eCjDQ: bets $3
oxnw0GLLpFanjhGkxfRSqA: folds
qhkK6+yCciTRd+rCFEbnEQ: folds
ZA1bp6g8IwtTxkUE4eCjDQ collected $2.85 from pot
*** SUMMARY ***
Total pot $3 | Rake $0.15
Board [Kd 2s 7s]
Seat 1: qhkK6+yCciTRd+rCFEbnEQ (big blind) folded on the Flop
Seat 2: xAU6q2/cwmby2sxmA8VcmA folded before Flop (didn't bet)
Seat 3: wx3sQGkVi2x9wJXuWNHPBw folded before Flop (didn't bet)
Seat 4: ZA1bp6g8IwtTxkUE4eCjDQ collected ($2.85)
Seat 5: UBZQqpnJZdTYYY1FTb0rLA (button) folded before Flop (didn't bet)
Seat 6: oxnw0GLLpFanjhGkxfRSqA (small blind) folded on the Flop



PokerStars Game #59940334350:  Hold'em No Limit ($0.50/$1.00) - 2009/07/01 1:03:42 ET
Table 'Zka9tv1yilg0MvXWPQrShg' 9-max Seat #8 is the button
Seat 2: kz9ziSiGUc+857heiKSayw ($22.70 in chips)
Seat 3: gUUvmqdVlmvpal6B8nYrmg ($107.95 in chips)
Seat 4: stxmTgSicxShtrDxhOOX2g ($63.15 in chips)
Seat 5: /zy+DB4S5fUQUSfZWFzYGw ($115.60 in chips)
Seat 6: rY8wPoax1lS+HUY+I0FZDw ($159.20 in chips)
Seat 7: p1SafS90nb3Uft5LB0NkHw ($19 in chips)
Seat 8: D+W9Me7w6Hcx/WRUSKV0dw ($18.50 in chips)
Seat 9: 6daxhj43mWj04MOPTOmaYA ($106.90 in chips)
6daxhj43mWj04MOPTOmaYA: posts small blind $0.50
TZcz9MEWDA+WydgGruqqbw: is sitting out
TZcz9MEWDA+WydgGruqqbw leaves the table
kz9ziSiGUc+857heiKSayw: posts big blind $1
*** HOLE CARDS ***
gUUvmqdVlmvpal6B8nYrmg: folds
stxmTgSicxShtrDxhOOX2g: folds
/zy+DB4S5fUQUSfZWFzYGw: folds
rY8wPoax1lS+HUY+I0FZDw: calls $1
p1SafS90nb3Uft5LB0NkHw: folds
D+W9Me7w6Hcx/WRUSKV0dw: folds
6daxhj43mWj04MOPTOmaYA: folds
kz9ziSiGUc+857heiKSayw: checks
*** FLOP *** [Qc 4d Kh]
kz9ziSiGUc+857heiKSayw: checks
rY8wPoax1lS+HUY+I0FZDw: bets $3
kz9ziSiGUc+857heiKSayw: folds
rY8wPoax1lS+HUY+I0FZDw collected $2.40 from pot
*** SUMMARY ***
Total pot $2.50 | Rake $0.10
Board [Qc 4d Kh]
Seat 2: kz9ziSiGUc+857heiKSayw (big blind) folded on the Flop
Seat 3: gUUvmqdVlmvpal6B8nYrmg folded before Flop (didn't bet)
Seat 4: stxmTgSicxShtrDxhOOX2g folded before Flop (didn't bet)
Seat 5: /zy+DB4S5fUQUSfZWFzYGw folded before Flop (didn't bet)
Seat 6: rY8wPoax1lS+HUY+I0FZDw collected ($2.40)
Seat 7: p1SafS90nb3Uft5LB0NkHw folded before Flop (didn't bet)
Seat 8: D+W9Me7w6Hcx/WRUSKV0dw (button) folded before Flop (didn't bet)
Seat 9: 6daxhj43mWj04MOPTOmaYA (small blind) folded before Flop



PokerStars Game #59940334478:  Hold'em No Limit ($0.50/$1.00) - 2009/07/01 1:03:43 ET
Table 'vs/5jr6ciwjVQ5+Soc+u2A' 6-max Seat #5 is the button
Seat 1: /P4w1pHg2zHYg/4ubJ0dPw ($60.80 in chips)
Seat 2: lXX4W7m3u++JiSOZ46yVMQ ($100 in chips)
Seat 3: G5ZSSN6RSON3gkNvk/SmYg ($137.85 in chips)
Seat 4: wk6Ohn4GDozoOMHc4eb2rw ($88.65 in chips)
Seat 5: +Nt3OPk3XR9SKjZgm2CexQ ($103.30 in chips)
/P4w1pHg2zHYg/4ubJ0dPw: posts small blind $0.50
lXX4W7m3u++JiSOZ46yVMQ: posts big blind $1
*** HOLE CARDS ***
G5ZSSN6RSON3gkNvk/SmYg: folds
wk6Ohn4GDozoOMHc4eb2rw: raises $2 to $3
+Nt3OPk3XR9SKjZgm2CexQ: calls $3
/P4w1pHg2zHYg/4ubJ0dPw: folds
lXX4W7m3u++JiSOZ46yVMQ: folds
*** FLOP *** [3h 5c 8s]
wk6Ohn4GDozoOMHc4eb2rw: checks
+Nt3OPk3XR9SKjZgm2CexQ: bets $5
wk6Ohn4GDozoOMHc4eb2rw: folds
+Nt3OPk3XR9SKjZgm2CexQ collected $7.15 from pot
+Nt3OPk3XR9SKjZgm2CexQ: doesn't show hand
*** SUMMARY ***
Total pot $7.50 | Rake $0.35
Board [3h 5c 8s]
Seat 1: /P4w1pHg2zHYg/4ubJ0dPw (small blind) folded before Flop
Seat 2: lXX4W7m3u++JiSOZ46yVMQ (big blind) folded before Flop
Seat 3: G5ZSSN6RSON3gkNvk/SmYg folded before Flop (didn't bet)
Seat 4: wk6Ohn4GDozoOMHc4eb2rw folded on the Flop
Seat 5: +Nt3OPk3XR9SKjZgm2CexQ (button) collected ($7.15)



PokerStars Game #59940336124:  Hold'em No Limit ($0.50/$1.00) - 2009/07/01 1:03:45 ET
Table 'GPp0HyAuggN8oE0sUWzPpA' 9-max Seat #8 is the button
Seat 1: qJr25HAtvv1w/7IBvjMM3g ($43.20 in chips)
Seat 2: m3U8I35Pn3gxKhoS2nmYIg ($54.70 in chips)
Seat 3: CCCXsirC+bO7ginAuUUVlQ ($56 in chips)
Seat 4: mBRWbnUl8diyBO1qTJaNzw ($107.30 in chips)
Seat 5: 0fXz44fzDo5QmhAaJCvFfA ($14.15 in chips)
Seat 6: BK/GtNPkSx0TdUDj82id5A ($17.85 in chips)
Seat 7: DHdbHyysD15wCAtx+BhUjA ($92.50 in chips)
Seat 8: 6DBvLniKMJADk/t5l29oMA ($25.15 in chips)
qJr25HAtvv1w/7IBvjMM3g: posts small blind $0.50
m3U8I35Pn3gxKhoS2nmYIg: posts big blind $1
*** HOLE CARDS ***
CCCXsirC+bO7ginAuUUVlQ: calls $1
mBRWbnUl8diyBO1qTJaNzw: folds
0fXz44fzDo5QmhAaJCvFfA: raises $3 to $4
BK/GtNPkSx0TdUDj82id5A: folds
DHdbHyysD15wCAtx+BhUjA: folds
6DBvLniKMJADk/t5l29oMA: folds
qJr25HAtvv1w/7IBvjMM3g: folds
m3U8I35Pn3gxKhoS2nmYIg: calls $3
dzoSjPZmtjGuK83119030A joins the table at seat #9
CCCXsirC+bO7ginAuUUVlQ: calls $3
*** FLOP *** [4d 7s 8h]
m3U8I35Pn3gxKhoS2nmYIg: checks
CCCXsirC+bO7ginAuUUVlQ: checks
0fXz44fzDo5QmhAaJCvFfA: checks
*** TURN *** [4d 7s 8h] [As]
m3U8I35Pn3gxKhoS2nmYIg: bets $5
CCCXsirC+bO7ginAuUUVlQ: folds
0fXz44fzDo5QmhAaJCvFfA: raises $5.15 to $10.15 and is all-in
m3U8I35Pn3gxKhoS2nmYIg: calls $5.15
*** RIVER *** [4d 7s 8h As] [6h]
*** SHOW DOWN ***
m3U8I35Pn3gxKhoS2nmYIg: shows [Ah 9s] (a pair of Aces)
0fXz44fzDo5QmhAaJCvFfA: shows [Ks Ad] (a pair of Aces - King kicker)
0fXz44fzDo5QmhAaJCvFfA collected $31.20 from pot
*** SUMMARY ***
Total pot $32.80 | Rake $1.60
Board [4d 7s 8h As 6h]
Seat 1: qJr25HAtvv1w/7IBvjMM3g (small blind) folded before Flop
Seat 2: m3U8I35Pn3gxKhoS2nmYIg (big blind) showed [Ah 9s] and lost with a pair of Aces
Seat 3: CCCXsirC+bO7ginAuUUVlQ folded on the Turn
Seat 4: mBRWbnUl8diyBO1qTJaNzw folded before Flop (didn't bet)
Seat 5: 0fXz44fzDo5QmhAaJCvFfA showed [Ks Ad] and won ($31.20) with a pair of Aces
Seat 6: BK/GtNPkSx0TdUDj82id5A folded before Flop (didn't bet)
Seat 7: DHdbHyysD15wCAtx+BhUjA folded before Flop (didn't bet)
Seat 8: 6DBvLniKMJADk/t5l29oMA (button) folded before Flop (didn't bet)



PokerStars Game #59940335976:  Hold'em No Limit ($0.50/$1.00) - 2009/07/01 1:03:45 ET
Table 'JTT1XWaDZHSaMZQK7cR5uw' 2-max Seat #2 is the button
Seat 1: OLplZF6FEnLflv81Hz+Fxg ($134.75 in chips)
Seat 2: BcqgegiOUxmBD3F3umsljg ($74.75 in chips)
BcqgegiOUxmBD3F3umsljg: posts small blind $0.50
OLplZF6FEnLflv81Hz+Fxg: posts big blind $1
*** HOLE CARDS ***
BcqgegiOUxmBD3F3umsljg: raises $1 to $2
OLplZF6FEnLflv81Hz+Fxg: folds
BcqgegiOUxmBD3F3umsljg collected $2 from pot
*** SUMMARY ***
Total pot $2 | Rake $0
Seat 1: OLplZF6FEnLflv81Hz+Fxg (big blind) folded before Flop
Seat 2: BcqgegiOUxmBD3F3umsljg (button) (small blind) collected ($2)



PokerStars Game #59940337638:  Hold'em No Limit ($0.50/$1.00) - 2009/07/01 1:03:48 ET
Table '+cA8mcmhaedZ7YcrDdhmeQ' 6-max Seat #6 is the button
Seat 1: lsLuWlcPA3Rh7kJVLzMh0Q ($301.45 in chips)
Seat 2: RqgF7gRoKgRNW8Zoi1ty4A ($115.10 in chips)
Seat 3: 7H5WkGzGvsv56y1iaqHvRg ($22.20 in chips)
Seat 4: 4OO5v3AVduL0tePNx8wk5A ($101 in chips)
Seat 5: +7hFKAL0b0O/n8G72TclJA ($64.35 in chips)
Seat 6: YfsTQsY/fxb+YqbdclTHuw ($21.60 in chips)
lsLuWlcPA3Rh7kJVLzMh0Q: posts small blind $0.50
RqgF7gRoKgRNW8Zoi1ty4A: posts big blind $1
*** HOLE CARDS ***
7H5WkGzGvsv56y1iaqHvRg: folds
4OO5v3AVduL0tePNx8wk5A: raises $2 to $3
+7hFKAL0b0O/n8G72TclJA: folds
YfsTQsY/fxb+YqbdclTHuw: calls $3
lsLuWlcPA3Rh7kJVLzMh0Q: folds
RqgF7gRoKgRNW8Zoi1ty4A: raises $12 to $15
4OO5v3AVduL0tePNx8wk5A: folds
YfsTQsY/fxb+YqbdclTHuw: folds
RqgF7gRoKgRNW8Zoi1ty4A collected $9.50 from pot
*** SUMMARY ***
Total pot $9.50 | Rake $0
Seat 1: lsLuWlcPA3Rh7kJVLzMh0Q (small blind) folded before Flop
Seat 2: RqgF7gRoKgRNW8Zoi1ty4A (big blind) collected ($9.50)
Seat 3: 7H5WkGzGvsv56y1iaqHvRg folded before Flop (didn't bet)
Seat 4: 4OO5v3AVduL0tePNx8wk5A folded before Flop
Seat 5: +7hFKAL0b0O/n8G72TclJA folded before Flop (didn't bet)
Seat 6: YfsTQsY/fxb+YqbdclTHuw (button) folded before Flop



PokerStars Game #59940337606:  Hold'em No Limit ($0.50/$1.00) - 2009/07/01 1:03:48 ET
Table 'SQLOQoANiHscJ8AL7zffbw' 9-max Seat #1 is the button
Seat 1: jPTRd6SpCp4xqAy2XQiTOw ($67.90 in chips)
Seat 2: /zy+DB4S5fUQUSfZWFzYGw ($330.40 in chips)
Seat 3: 0eFnow7+D7veCYQ+CG9FFw ($93.35 in chips)
Seat 4: /mfensKw8/iZ1Vrx33S4xg ($20 in chips)
Seat 5: L9njYvloJ1NdXjP8edHEAg ($104.10 in chips)
Seat 7: bJckevFOcg//s0qyMQI6sQ ($104.55 in chips)
Seat 8: 2BV+oJIQYr65IO6nEChvbA ($60 in chips)
Seat 9: qJr25HAtvv1w/7IBvjMM3g ($204.15 in chips)
/zy+DB4S5fUQUSfZWFzYGw: posts small blind $0.50
0eFnow7+D7veCYQ+CG9FFw: posts big blind $1
H+DVy3Ei8L1UKS2tVOtJcw: sits out
*** HOLE CARDS ***
/mfensKw8/iZ1Vrx33S4xg: folds
jPTRd6SpCp4xqAy2XQiTOw said, "guess we all gonna play the long game"
L9njYvloJ1NdXjP8edHEAg: raises $3 to $4
bJckevFOcg//s0qyMQI6sQ: folds
2BV+oJIQYr65IO6nEChvbA: folds
qJr25HAtvv1w/7IBvjMM3g: calls $4
jPTRd6SpCp4xqAy2XQiTOw has timed out
jPTRd6SpCp4xqAy2XQiTOw: folds
jPTRd6SpCp4xqAy2XQiTOw is sitting out
/zy+DB4S5fUQUSfZWFzYGw: folds
0eFnow7+D7veCYQ+CG9FFw: folds
*** FLOP *** [7s 5s 8c]
jPTRd6SpCp4xqAy2XQiTOw has returned
L9njYvloJ1NdXjP8edHEAg: bets $8
qJr25HAtvv1w/7IBvjMM3g: folds
L9njYvloJ1NdXjP8edHEAg collected $9.05 from pot
*** SUMMARY ***
Total pot $9.50 | Rake $0.45
Board [7s 5s 8c]
Seat 1: jPTRd6SpCp4xqAy2XQiTOw (button) folded before Flop (didn't bet)
Seat 2: /zy+DB4S5fUQUSfZWFzYGw (small blind) folded before Flop
Seat 3: 0eFnow7+D7veCYQ+CG9FFw (big blind) folded before Flop
Seat 4: /mfensKw8/iZ1Vrx33S4xg folded before Flop (didn't bet)
Seat 5: L9njYvloJ1NdXjP8edHEAg collected ($9.05)
Seat 7: bJckevFOcg//s0qyMQI6sQ folded before Flop (didn't bet)
Seat 8: 2BV+oJIQYr65IO6nEChvbA folded before Flop (didn't bet)
Seat 9: qJr25HAtvv1w/7IBvjMM3g folded on the Flop



PokerStars Game #59940338722:  Hold'em No Limit ($0.50/$1.00) - 2009/07/01 1:03:50 ET
Table 'hugOjcwJvzEwZbK7tyiWuQ' 9-max Seat #9 is the button
Seat 2: r27C1nIV4NS4+qbnrgBQSw ($282.20 in chips)
Seat 3: jDwhY1kCdc6EkAHbT7PJMQ ($106.25 in chips)
Seat 4: UWB3oeddt/GObx2Mix2Anw ($174.80 in chips)
Seat 5: 5BRGWf+R3nt2WS3b5xX+zA ($16.75 in chips)
Seat 6: gUUvmqdVlmvpal6B8nYrmg ($107.40 in chips)
Seat 7: FL3MrLspcF23LYvC4ipBOA ($110.30 in chips)
Seat 8: /zy+DB4S5fUQUSfZWFzYGw ($100 in chips)
Seat 9: W8P9bUKCs43TO1xHm0dL6w ($87.95 in chips)
r27C1nIV4NS4+qbnrgBQSw: posts small blind $0.50
jDwhY1kCdc6EkAHbT7PJMQ: posts big blind $1
*** HOLE CARDS ***
UWB3oeddt/GObx2Mix2Anw: folds
5BRGWf+R3nt2WS3b5xX+zA: folds
gUUvmqdVlmvpal6B8nYrmg: folds
FL3MrLspcF23LYvC4ipBOA: folds
/zy+DB4S5fUQUSfZWFzYGw: folds
W8P9bUKCs43TO1xHm0dL6w: raises $1 to $2
r27C1nIV4NS4+qbnrgBQSw: folds
jDwhY1kCdc6EkAHbT7PJMQ: folds
W8P9bUKCs43TO1xHm0dL6w collected $2.50 from pot
*** SUMMARY ***
Total pot $2.50 | Rake $0
Seat 2: r27C1nIV4NS4+qbnrgBQSw (small blind) folded before Flop
Seat 3: jDwhY1kCdc6EkAHbT7PJMQ (big blind) folded before Flop
Seat 4: UWB3oeddt/GObx2Mix2Anw folded before Flop (didn't bet)
Seat 5: 5BRGWf+R3nt2WS3b5xX+zA folded before Flop (didn't bet)
Seat 6: gUUvmqdVlmvpal6B8nYrmg folded before Flop (didn't bet)
Seat 7: FL3MrLspcF23LYvC4ipBOA folded before Flop (didn't bet)
Seat 8: /zy+DB4S5fUQUSfZWFzYGw folded before Flop (didn't bet)
Seat 9: W8P9bUKCs43TO1xHm0dL6w (button) collected ($2.50)



PokerStars Game #59940338932:  Hold'em No Limit ($0.50/$1.00) - 2009/07/01 1:03:50 ET
Table 'eU3bWpDDg3Z+9R4m4iVmog' 6-max Seat #4 is the button
Seat 1: TSuRyAHnUPCFjP7Z0rEE0w ($178.65 in chips)
Seat 2: 8CAoOzhmB8n3nRFf3V4BTg ($55.30 in chips)
Seat 3: rVMOzU7w5FddYPGhD7qN2Q ($40.15 in chips)
Seat 4: GDVIsbEJ/DOJsMKE4Asz0A ($124.20 in chips)
Seat 6: hpxXcmRkXXI9HE5+5/j/0Q ($127.25 in chips)
hpxXcmRkXXI9HE5+5/j/0Q: posts small blind $0.50
TSuRyAHnUPCFjP7Z0rEE0w: posts big blind $1
*** HOLE CARDS ***
8CAoOzhmB8n3nRFf3V4BTg: raises $2 to $3
rVMOzU7w5FddYPGhD7qN2Q: folds
GDVIsbEJ/DOJsMKE4Asz0A: calls $3
hpxXcmRkXXI9HE5+5/j/0Q: folds
TSuRyAHnUPCFjP7Z0rEE0w: folds
*** FLOP *** [5h 9h Jd]
8CAoOzhmB8n3nRFf3V4BTg: bets $4
GDVIsbEJ/DOJsMKE4Asz0A: folds
8CAoOzhmB8n3nRFf3V4BTg collected $7.15 from pot
*** SUMMARY ***
Total pot $7.50 | Rake $0.35
Board [5h 9h Jd]
Seat 1: TSuRyAHnUPCFjP7Z0rEE0w (big blind) folded before Flop
Seat 2: 8CAoOzhmB8n3nRFf3V4BTg collected ($7.15)
Seat 3: rVMOzU7w5FddYPGhD7qN2Q folded before Flop (didn't bet)
Seat 4: GDVIsbEJ/DOJsMKE4Asz0A (button) folded on the Flop
Seat 6: hpxXcmRkXXI9HE5+5/j/0Q (small blind) folded before Flop



PokerStars Game #59940338580:  Hold'em No Limit ($0.50/$1.00) - 2009/07/01 1:03:50 ET
Table 'VOs36P6NW+QyXeQ1B62kmA' 6-max Seat #1 is the button
Seat 1: Z2fXsGcjl+Eax+RzOgwOmg ($100 in chips)
Seat 2: 2UMlbaZ8n8AbRli0Yr0mDw ($27.20 in chips)
Seat 3: TSuRyAHnUPCFjP7Z0rEE0w ($106.40 in chips)
Seat 4: w02zQzNydODiyV9THKgo9w ($44.20 in chips)
Seat 5: ozrlafxxh1HmYdA0/h+MuA ($46.10 in chips)
Seat 6: slVKuQyEz8Qj4E3uLPYNXg ($86 in chips)
2UMlbaZ8n8AbRli0Yr0mDw: posts small blind $0.50
TSuRyAHnUPCFjP7Z0rEE0w: posts big blind $1
*** HOLE CARDS ***
w02zQzNydODiyV9THKgo9w: folds
ozrlafxxh1HmYdA0/h+MuA: folds
slVKuQyEz8Qj4E3uLPYNXg: folds
Z2fXsGcjl+Eax+RzOgwOmg: raises $2 to $3
2UMlbaZ8n8AbRli0Yr0mDw: calls $2.50
TSuRyAHnUPCFjP7Z0rEE0w: folds
*** FLOP *** [6h 9s 2d]
2UMlbaZ8n8AbRli0Yr0mDw: bets $4
Z2fXsGcjl+Eax+RzOgwOmg: calls $4
*** TURN *** [6h 9s 2d] [Qs]
2UMlbaZ8n8AbRli0Yr0mDw: bets $5
Z2fXsGcjl+Eax+RzOgwOmg: calls $5
*** RIVER *** [6h 9s 2d Qs] [Th]
2UMlbaZ8n8AbRli0Yr0mDw: checks
Z2fXsGcjl+Eax+RzOgwOmg: checks
*** SHOW DOWN ***
2UMlbaZ8n8AbRli0Yr0mDw: shows [4c Qh] (a pair of Queens)
Z2fXsGcjl+Eax+RzOgwOmg: mucks hand
2UMlbaZ8n8AbRli0Yr0mDw collected $23.80 from pot
*** SUMMARY ***
Total pot $25 | Rake $1.20
Board [6h 9s 2d Qs Th]
Seat 1: Z2fXsGcjl+Eax+RzOgwOmg (button) mucked
Seat 2: 2UMlbaZ8n8AbRli0Yr0mDw (small blind) showed [4c Qh] and won ($23.80) with a pair of Queens
Seat 3: TSuRyAHnUPCFjP7Z0rEE0w (big blind) folded before Flop
Seat 4: w02zQzNydODiyV9THKgo9w folded before Flop (didn't bet)
Seat 5: ozrlafxxh1HmYdA0/h+MuA folded before Flop (didn't bet)
Seat 6: slVKuQyEz8Qj4E3uLPYNXg folded before Flop (didn't bet)



PokerStars Game #59940339238:  Hold'em No Limit ($0.50/$1.00) - 2009/07/01 1:03:51 ET
Table 'cKH9c4x6u79IqCdaKKvXrw' 9-max Seat #7 is the button
Seat 1: Pp/KTcXkfZKKUHkjyaLTdg ($20 in chips)
Seat 2: 8S3JMH4TY3whgIlZmMv66w ($67.65 in chips)
Seat 3: 997ViqAtWn1FPjJqcffwcA ($157.10 in chips)
Seat 4: FL3MrLspcF23LYvC4ipBOA ($100 in chips)
Seat 5: Jjc7EHWzs4//xUAjJ0UWoA ($40.65 in chips)
Seat 6: Bsd/K5gAcLanYbGiPirRjw ($206.55 in chips)
Seat 7: 1GkkVBhlJ92guE6K5mS5Ig ($17.75 in chips)
Seat 8: myIxN7otsyr846M539YR8Q ($17.50 in chips)
Seat 9: 6XkTu4ahxzHnvjjc1R8YjQ ($43.10 in chips)
myIxN7otsyr846M539YR8Q: posts small blind $0.50
6XkTu4ahxzHnvjjc1R8YjQ: posts big blind $1
*** HOLE CARDS ***
Pp/KTcXkfZKKUHkjyaLTdg: folds
8S3JMH4TY3whgIlZmMv66w: raises $2 to $3
997ViqAtWn1FPjJqcffwcA: folds
FL3MrLspcF23LYvC4ipBOA: folds
Jjc7EHWzs4//xUAjJ0UWoA: folds
Bsd/K5gAcLanYbGiPirRjw: folds
1GkkVBhlJ92guE6K5mS5Ig: folds
myIxN7otsyr846M539YR8Q: folds
6XkTu4ahxzHnvjjc1R8YjQ: folds
8S3JMH4TY3whgIlZmMv66w collected $2.50 from pot
*** SUMMARY ***
Total pot $2.50 | Rake $0
Seat 1: Pp/KTcXkfZKKUHkjyaLTdg folded before Flop (didn't bet)
Seat 2: 8S3JMH4TY3whgIlZmMv66w collected ($2.50)
Seat 3: 997ViqAtWn1FPjJqcffwcA folded before Flop (didn't bet)
Seat 4: FL3MrLspcF23LYvC4ipBOA folded before Flop (didn't bet)
Seat 5: Jjc7EHWzs4//xUAjJ0UWoA folded before Flop (didn't bet)
Seat 6: Bsd/K5gAcLanYbGiPirRjw folded before Flop (didn't bet)
Seat 7: 1GkkVBhlJ92guE6K5mS5Ig (button) folded before Flop (didn't bet)
Seat 8: myIxN7otsyr846M539YR8Q (small blind) folded before Flop
Seat 9: 6XkTu4ahxzHnvjjc1R8YjQ (big blind) folded before Flop



PokerStars Game #59940339480:  Hold'em No Limit ($0.50/$1.00) - 2009/07/01 1:03:51 ET
Table 'O96CPOtvMBWP6kzuYDfdFA' 6-max Seat #5 is the button
Seat 1: 6alLXQIITA2EZ/lBeym8Dw ($124.55 in chips)
Seat 3: V89DGjxE171oPREEbAXiyg ($88 in chips)
Seat 4: /P4w1pHg2zHYg/4ubJ0dPw ($60.90 in chips)
Seat 5: G5ZSSN6RSON3gkNvk/SmYg ($100 in chips)
Seat 6: GYei5jXGWexiJYbAT2fELg ($24.85 in chips)
GYei5jXGWexiJYbAT2fELg: posts small blind $0.50
6alLXQIITA2EZ/lBeym8Dw: posts big blind $1
*** HOLE CARDS ***
V89DGjxE171oPREEbAXiyg: folds
/P4w1pHg2zHYg/4ubJ0dPw: folds
G5ZSSN6RSON3gkNvk/SmYg: folds
GYei5jXGWexiJYbAT2fELg: folds
6alLXQIITA2EZ/lBeym8Dw said, "u2"
6alLXQIITA2EZ/lBeym8Dw collected $1 from pot
*** SUMMARY ***
Total pot $1 | Rake $0
Seat 1: 6alLXQIITA2EZ/lBeym8Dw (big blind) collected ($1)
Seat 3: V89DGjxE171oPREEbAXiyg folded before Flop (didn't bet)
Seat 4: /P4w1pHg2zHYg/4ubJ0dPw folded before Flop (didn't bet)
Seat 5: G5ZSSN6RSON3gkNvk/SmYg (button) folded before Flop (didn't bet)
Seat 6: GYei5jXGWexiJYbAT2fELg (small blind) folded before Flop



PokerStars Game #59940340104:  Hold'em No Limit ($0.50/$1.00) - 2009/07/01 1:03:52 ET
Table 'JTT1XWaDZHSaMZQK7cR5uw' 2-max Seat #1 is the button
Seat 1: OLplZF6FEnLflv81Hz+Fxg ($133.75 in chips)
Seat 2: BcqgegiOUxmBD3F3umsljg ($75.75 in chips)
OLplZF6FEnLflv81Hz+Fxg: posts small blind $0.50
BcqgegiOUxmBD3F3umsljg: posts big blind $1
*** HOLE CARDS ***
OLplZF6FEnLflv81Hz+Fxg: folds
BcqgegiOUxmBD3F3umsljg collected $1 from pot
*** SUMMARY ***
Total pot $1 | Rake $0
Seat 1: OLplZF6FEnLflv81Hz+Fxg (button) (small blind) folded before Flop
Seat 2: BcqgegiOUxmBD3F3umsljg (big blind) collected ($1)



PokerStars Game #59940340774:  Hold'em No Limit ($0.50/$1.00) - 2009/07/01 1:03:53 ET
Table 'W/wyObTiXZm+Ckkl3YxcSw' 6-max Seat #2 is the button
Seat 1: eUBBn2R56C1IQ6Cs/vitwg ($194.25 in chips)
Seat 2: oDiBRCaF0QVtd3kO6xZIXw ($117.85 in chips)
Seat 3: dxyNCn/qxfkGDUIf28Cbng ($82.90 in chips)
Seat 4: aYii2DmxlOlbC1wbGRBWvQ ($96.80 in chips)
dxyNCn/qxfkGDUIf28Cbng: posts small blind $0.50
aYii2DmxlOlbC1wbGRBWvQ: posts big blind $1
OGMLOcTNYZXZU81au7ztUw: sits out
*** HOLE CARDS ***
eUBBn2R56C1IQ6Cs/vitwg: raises $2 to $3
oDiBRCaF0QVtd3kO6xZIXw: folds
dxyNCn/qxfkGDUIf28Cbng: folds
aYii2DmxlOlbC1wbGRBWvQ: raises $3 to $6
MFptnnT6AnJakWBooTkmeg joins the table at seat #5
eUBBn2R56C1IQ6Cs/vitwg: calls $3
*** FLOP *** [5s 7c Td]
aYii2DmxlOlbC1wbGRBWvQ: bets $18
eUBBn2R56C1IQ6Cs/vitwg: folds
aYii2DmxlOlbC1wbGRBWvQ collected $11.90 from pot
*** SUMMARY ***
Total pot $12.50 | Rake $0.60
Board [5s 7c Td]
Seat 1: eUBBn2R56C1IQ6Cs/vitwg folded on the Flop
Seat 2: oDiBRCaF0QVtd3kO6xZIXw (button) folded before Flop (didn't bet)
Seat 3: dxyNCn/qxfkGDUIf28Cbng (small blind) folded before Flop
Seat 4: aYii2DmxlOlbC1wbGRBWvQ (big blind) collected ($11.90)



PokerStars Game #59940342366:  Hold'em No Limit ($0.50/$1.00) - 2009/07/01 1:03:56 ET
Table 'cBDNutyLBKEk9+ptwsKmTw' 6-max Seat #2 is the button
Seat 1: xAU6q2/cwmby2sxmA8VcmA ($109.85 in chips)
Seat 2: 5lY8d6Cnm4HUkt/8FZSj4g ($33.10 in chips)
Seat 3: G5ZSSN6RSON3gkNvk/SmYg ($100.65 in chips)
Seat 4: 3q7F5QtzC30pSrn0nl9i+A ($28.80 in chips)
Seat 5: OGMLOcTNYZXZU81au7ztUw ($165.05 in chips)
Seat 6: NqVlOSH2lp+pp/TK3vvK5g ($90.90 in chips)
G5ZSSN6RSON3gkNvk/SmYg: posts small blind $0.50
3q7F5QtzC30pSrn0nl9i+A: posts big blind $1
*** HOLE CARDS ***
OGMLOcTNYZXZU81au7ztUw: folds
NqVlOSH2lp+pp/TK3vvK5g: folds
xAU6q2/cwmby2sxmA8VcmA: folds
5lY8d6Cnm4HUkt/8FZSj4g: calls $1
G5ZSSN6RSON3gkNvk/SmYg: folds
3q7F5QtzC30pSrn0nl9i+A: checks
*** FLOP *** [9c 3c 3d]
3q7F5QtzC30pSrn0nl9i+A: checks
5lY8d6Cnm4HUkt/8FZSj4g: bets $5
3q7F5QtzC30pSrn0nl9i+A: folds
5lY8d6Cnm4HUkt/8FZSj4g collected $2.40 from pot
*** SUMMARY ***
Total pot $2.50 | Rake $0.10
Board [9c 3c 3d]
Seat 1: xAU6q2/cwmby2sxmA8VcmA folded before Flop (didn't bet)
Seat 2: 5lY8d6Cnm4HUkt/8FZSj4g (button) collected ($2.40)
Seat 3: G5ZSSN6RSON3gkNvk/SmYg (small blind) folded before Flop
Seat 4: 3q7F5QtzC30pSrn0nl9i+A (big blind) folded on the Flop
Seat 5: OGMLOcTNYZXZU81au7ztUw folded before Flop (didn't bet)
Seat 6: NqVlOSH2lp+pp/TK3vvK5g folded before Flop (didn't bet)



PokerStars Game #59940342208:  Hold'em No Limit ($0.50/$1.00) - 2009/07/01 1:03:56 ET
Table 'rmZfTK+oSebeUPJNbWhdAA' 6-max Seat #3 is the button
Seat 1: xAU6q2/cwmby2sxmA8VcmA ($148.50 in chips)
Seat 2: z7O9PO/WEcqRouIydFhS9Q ($121.05 in chips)
Seat 3: BCEV3COoKY607AzLWayfRA ($132.50 in chips)
Seat 4: 1/mIuXfgx1ZyVkodrmfQDw ($103.20 in chips)
Seat 5: 5lY8d6Cnm4HUkt/8FZSj4g ($89.90 in chips)
1/mIuXfgx1ZyVkodrmfQDw: posts small blind $0.50
5lY8d6Cnm4HUkt/8FZSj4g: posts big blind $1
j7NIOHLZk7V2o9fOioO5ug: sits out
*** HOLE CARDS ***
xAU6q2/cwmby2sxmA8VcmA: folds
z7O9PO/WEcqRouIydFhS9Q: raises $2 to $3
BCEV3COoKY607AzLWayfRA: folds
1/mIuXfgx1ZyVkodrmfQDw: folds
5lY8d6Cnm4HUkt/8FZSj4g: calls $2
*** FLOP *** [Kh Ac Qh]
5lY8d6Cnm4HUkt/8FZSj4g: checks
z7O9PO/WEcqRouIydFhS9Q: bets $4
5lY8d6Cnm4HUkt/8FZSj4g: calls $4
*** TURN *** [Kh Ac Qh] [4c]
5lY8d6Cnm4HUkt/8FZSj4g: checks
z7O9PO/WEcqRouIydFhS9Q: bets $10
5lY8d6Cnm4HUkt/8FZSj4g: calls $10
*** RIVER *** [Kh Ac Qh 4c] [Qs]
5lY8d6Cnm4HUkt/8FZSj4g: checks
z7O9PO/WEcqRouIydFhS9Q: bets $14
5lY8d6Cnm4HUkt/8FZSj4g: folds
z7O9PO/WEcqRouIydFhS9Q collected $32.85 from pot
z7O9PO/WEcqRouIydFhS9Q: doesn't show hand
*** SUMMARY ***
Total pot $34.50 | Rake $1.65
Board [Kh Ac Qh 4c Qs]
Seat 1: xAU6q2/cwmby2sxmA8VcmA folded before Flop (didn't bet)
Seat 2: z7O9PO/WEcqRouIydFhS9Q collected ($32.85)
Seat 3: BCEV3COoKY607AzLWayfRA (button) folded before Flop (didn't bet)
Seat 4: 1/mIuXfgx1ZyVkodrmfQDw (small blind) folded before Flop
Seat 5: 5lY8d6Cnm4HUkt/8FZSj4g (big blind) folded on the River



PokerStars Game #59940344174:  Hold'em No Limit ($0.50/$1.00) - 2009/07/01 1:03:59 ET
Table 'JTT1XWaDZHSaMZQK7cR5uw' 2-max Seat #2 is the button
Seat 1: OLplZF6FEnLflv81Hz+Fxg ($133.25 in chips)
Seat 2: BcqgegiOUxmBD3F3umsljg ($76.25 in chips)
BcqgegiOUxmBD3F3umsljg: posts small blind $0.50
OLplZF6FEnLflv81Hz+Fxg: posts big blind $1
*** HOLE CARDS ***
BcqgegiOUxmBD3F3umsljg: raises $2 to $3
OLplZF6FEnLflv81Hz+Fxg: folds
BcqgegiOUxmBD3F3umsljg collected $2 from pot
*** SUMMARY ***
Total pot $2 | Rake $0
Seat 1: OLplZF6FEnLflv81Hz+Fxg (big blind) folded before Flop
Seat 2: BcqgegiOUxmBD3F3umsljg (button) (small blind) collected ($2)



PokerStars Game #59940345182:  Hold'em No Limit ($0.50/$1.00) - 2009/07/01 1:04:01 ET
Table 'mmbQQVBTrPdE+wy+s+9VPA' 6-max Seat #4 is the button
Seat 1: zyP4SPoWZnKUfTvIRLCVog ($53.70 in chips)
Seat 2: cl/QpVR/PLO58lj+C5mGLw ($10.90 in chips)
Seat 3: wx3sQGkVi2x9wJXuWNHPBw ($111.65 in chips)
Seat 4: V3iZdcw61nXF3g5hD2RrsQ ($111.30 in chips)
Seat 5: YMJG+F++3Aj6P8dAWda5fw ($99 in chips)
Seat 6: U2CWBTv29qdCbj8RNF2sIw ($108.95 in chips)
YMJG+F++3Aj6P8dAWda5fw: posts small blind $0.50
U2CWBTv29qdCbj8RNF2sIw: posts big blind $1
*** HOLE CARDS ***
zyP4SPoWZnKUfTvIRLCVog: calls $1
cl/QpVR/PLO58lj+C5mGLw: folds
wx3sQGkVi2x9wJXuWNHPBw: folds
V3iZdcw61nXF3g5hD2RrsQ: folds
YMJG+F++3Aj6P8dAWda5fw: calls $0.50
U2CWBTv29qdCbj8RNF2sIw: checks
*** FLOP *** [5h 6h Ah]
YMJG+F++3Aj6P8dAWda5fw: checks
U2CWBTv29qdCbj8RNF2sIw: checks
zyP4SPoWZnKUfTvIRLCVog: bets $4
YMJG+F++3Aj6P8dAWda5fw: folds
U2CWBTv29qdCbj8RNF2sIw: folds
zyP4SPoWZnKUfTvIRLCVog collected $2.85 from pot
*** SUMMARY ***
Total pot $3 | Rake $0.15
Board [5h 6h Ah]
Seat 1: zyP4SPoWZnKUfTvIRLCVog collected ($2.85)
Seat 2: cl/QpVR/PLO58lj+C5mGLw folded before Flop (didn't bet)
Seat 3: wx3sQGkVi2x9wJXuWNHPBw folded before Flop (didn't bet)
Seat 4: V3iZdcw61nXF3g5hD2RrsQ (button) folded before Flop (didn't bet)
Seat 5: YMJG+F++3Aj6P8dAWda5fw (small blind) folded on the Flop
Seat 6: U2CWBTv29qdCbj8RNF2sIw (big blind) folded on the Flop



PokerStars Game #59940345226:  Hold'em No Limit ($0.50/$1.00) - 2009/07/01 1:04:01 ET
Table 'tyUh+jyNvrceIQdKMJjQ2wZFWj23PMihdwrNWv41OG/Qeat #2 is the button
Seat 1: o8A5MUdudVKu+pAwgZOX2w ($115.55 in chips)
Seat 2: XvUbOIg94d25feWeQlOTVg ($148 in chips)
Seat 3: TalCiLYHCd+ffkmR3auPvA ($84.10 in chips)
Seat 4: TSuRyAHnUPCFjP7Z0rEE0w ($183 in chips)
Seat 5: j7NIOHLZk7V2o9fOioO5ug ($111.65 in chips)
Seat 6: 4OO5v3AVduL0tePNx8wk5A ($100 in chips)
TalCiLYHCd+ffkmR3auPvA: posts small blind $0.50
TSuRyAHnUPCFjP7Z0rEE0w: posts big blind $1
*** HOLE CARDS ***
j7NIOHLZk7V2o9fOioO5ug: folds
4OO5v3AVduL0tePNx8wk5A: folds
o8A5MUdudVKu+pAwgZOX2w: calls $1
XvUbOIg94d25feWeQlOTVg: calls $1
TalCiLYHCd+ffkmR3auPvA: folds
TSuRyAHnUPCFjP7Z0rEE0w: checks
*** FLOP *** [7s 6d Kd]
TSuRyAHnUPCFjP7Z0rEE0w: checks
o8A5MUdudVKu+pAwgZOX2w: bets $3
XvUbOIg94d25feWeQlOTVg: folds
TSuRyAHnUPCFjP7Z0rEE0w: folds
o8A5MUdudVKu+pAwgZOX2w collected $3.35 from pot
o8A5MUdudVKu+pAwgZOX2w: doesn't show hand
*** SUMMARY ***
Total pot $3.50 | Rake $0.15
Board [7s 6d Kd]
Seat 1: o8A5MUdudVKu+pAwgZOX2w collected ($3.35)
Seat 2: XvUbOIg94d25feWeQlOTVg (button) folded on the Flop
Seat 3: TalCiLYHCd+ffkmR3auPvA (small blind) folded before Flop
Seat 4: TSuRyAHnUPCFjP7Z0rEE0w (big blind) folded on the Flop
Seat 5: j7NIOHLZk7V2o9fOioO5ug folded before Flop (didn't bet)
Seat 6: 4OO5v3AVduL0tePNx8wk5A folded before Flop (didn't bet)



PokerStars Game #59940346562:  Hold'em No Limit ($0.50/$1.00) - 2009/07/01 1:04:03 ET
Table 'iSx0wTgVb4o7MyZeOe06ZA' 9-max Seat #4 is the button
Seat 1: VPF+HjszMvUIpy0CHIwH3A ($19 in chips)
Seat 2: myIxN7otsyr846M539YR8Q ($38.50 in chips)
Seat 4: 0fXz44fzDo5QmhAaJCvFfA ($17.50 in chips)
Seat 5: o1axyw4AjQ8n4ubTwlirQQ ($21 in chips)
Seat 6: T5/PXFS/W+LLcIXBo1G/RA ($139.70 in chips)
Seat 7: w4NnqVr/Sfoj65ux/fEUyQ ($77.90 in chips)
Seat 8: gUUvmqdVlmvpal6B8nYrmg ($102.30 in chips)
o1axyw4AjQ8n4ubTwlirQQ: posts small blind $0.50
T5/PXFS/W+LLcIXBo1G/RA: posts big blind $1
mQADhUTC1xGjAJkD7PEg6A: sits out
/inIs/z/PcX+TniIFpaxpg: sits out
*** HOLE CARDS ***
w4NnqVr/Sfoj65ux/fEUyQ is disconnected
w4NnqVr/Sfoj65ux/fEUyQ has timed out while disconnected
w4NnqVr/Sfoj65ux/fEUyQ: folds
w4NnqVr/Sfoj65ux/fEUyQ is sitting out
gUUvmqdVlmvpal6B8nYrmg: folds
VPF+HjszMvUIpy0CHIwH3A: folds
myIxN7otsyr846M539YR8Q: folds
0fXz44fzDo5QmhAaJCvFfA: folds
o1axyw4AjQ8n4ubTwlirQQ: calls $0.50
T5/PXFS/W+LLcIXBo1G/RA: checks
*** FLOP *** [6d 5h Kc]
o1axyw4AjQ8n4ubTwlirQQ: checks
T5/PXFS/W+LLcIXBo1G/RA: checks
*** TURN *** [6d 5h Kc] [Kh]
o1axyw4AjQ8n4ubTwlirQQ: checks
T5/PXFS/W+LLcIXBo1G/RA: checks
*** RIVER *** [6d 5h Kc Kh] [Td]
o1axyw4AjQ8n4ubTwlirQQ: checks
w4NnqVr/Sfoj65ux/fEUyQ is connected
T5/PXFS/W+LLcIXBo1G/RA: checks
*** SHOW DOWN ***
o1axyw4AjQ8n4ubTwlirQQ: shows [6c 8c] (two pair, Kings and Sixes)
T5/PXFS/W+LLcIXBo1G/RA: mucks hand
o1axyw4AjQ8n4ubTwlirQQ collected $1.90 from pot
*** SUMMARY ***
Total pot $2 | Rake $0.10
Board [6d 5h Kc Kh Td]
Seat 1: VPF+HjszMvUIpy0CHIwH3A folded before Flop (didn't bet)
Seat 2: myIxN7otsyr846M539YR8Q folded before Flop (didn't bet)
Seat 4: 0fXz44fzDo5QmhAaJCvFfA (button) folded before Flop (didn't bet)
Seat 5: o1axyw4AjQ8n4ubTwlirQQ (small blind) showed [6c 8c] and won ($1.90) with two pair, Kings and Sixes
Seat 6: T5/PXFS/W+LLcIXBo1G/RA (big blind) mucked
Seat 7: w4NnqVr/Sfoj65ux/fEUyQ folded before Flop (didn't bet)
Seat 8: gUUvmqdVlmvpal6B8nYrmg folded before Flop (didn't bet)



PokerStars Game #59940347096:  Hold'em No Limit ($0.50/$1.00) - 2009/07/01 1:04:04 ET
Table 'CASNP0uy1C+jGLml/I4PtA' 9-max Seat #4 is the button
Seat 1: tkdBeXTJlFsZdioidNqLow ($60 in chips)
Seat 2: tjhwe1V98x2spSoUQER3HQ ($107.10 in chips)
Seat 3: bJckevFOcg//s0qyMQI6sQ ($102.40 in chips)
Seat 4: B/G0GJacqZ8K59/ZVdq4kQ ($53.70 in chips)
Seat 5: Jjc7EHWzs4//xUAjJ0UWoA ($15 in chips)
Seat 6: FJEywSpo5JbRKByzmweboA ($100 in chips)
Seat 7: RpMNxqeYPSeOh0tflU772w ($157.05 in chips)
Seat 8: L9njYvloJ1NdXjP8edHEAg ($100 in chips)
Seat 9: Pp/KTcXkfZKKUHkjyaLTdg ($20 in chips)
Jjc7EHWzs4//xUAjJ0UWoA: posts small blind $0.50
FJEywSpo5JbRKByzmweboA: posts big blind $1
*** HOLE CARDS ***
RpMNxqeYPSeOh0tflU772w: folds
L9njYvloJ1NdXjP8edHEAg: folds
Pp/KTcXkfZKKUHkjyaLTdg: folds
tkdBeXTJlFsZdioidNqLow: folds
tjhwe1V98x2spSoUQER3HQ is disconnected
tjhwe1V98x2spSoUQER3HQ has timed out while disconnected
tjhwe1V98x2spSoUQER3HQ: folds
tjhwe1V98x2spSoUQER3HQ is sitting out
bJckevFOcg//s0qyMQI6sQ: folds
B/G0GJacqZ8K59/ZVdq4kQ: folds
Jjc7EHWzs4//xUAjJ0UWoA: folds
FJEywSpo5JbRKByzmweboA collected $1 from pot
*** SUMMARY ***
Total pot $1 | Rake $0
Seat 1: tkdBeXTJlFsZdioidNqLow folded before Flop (didn't bet)
Seat 2: tjhwe1V98x2spSoUQER3HQ folded before Flop (didn't bet)
Seat 3: bJckevFOcg//s0qyMQI6sQ folded before Flop (didn't bet)
Seat 4: B/G0GJacqZ8K59/ZVdq4kQ (button) folded before Flop (didn't bet)
Seat 5: Jjc7EHWzs4//xUAjJ0UWoA (small blind) folded before Flop
Seat 6: FJEywSpo5JbRKByzmweboA (big blind) collected ($1)
Seat 7: RpMNxqeYPSeOh0tflU772w folded before Flop (didn't bet)
Seat 8: L9njYvloJ1NdXjP8edHEAg folded before Flop (didn't bet)
Seat 9: Pp/KTcXkfZKKUHkjyaLTdg folded before Flop (didn't bet)



PokerStars Game #59940347568:  Hold'em No Limit ($0.50/$1.00) - 2009/07/01 1:04:05 ET
Table 'tJq9SfN1ywY0r03VBlWlwQ' 9-max Seat #6 is the button
Seat 1: wZsU+w9r7G66x93UuvBf1Q ($340.80 in chips)
Seat 2: RqkO8O/Y3qlc3PIuCAHjVg ($71.20 in chips)
Seat 3: FVs16t7GgfWgQWt4JxsObQ ($32.90 in chips)
Seat 4: bLbSOSmSOnqE0iTcH/5dxA ($108.70 in chips)
Seat 5: h5ipsNTMyolp7xn/NAvWkA ($75 in chips)
Seat 6: gUUvmqdVlmvpal6B8nYrmg ($114.05 in chips)
Seat 8: G4DEhsZFmznGNVpy2SEocA ($30.40 in chips)
Seat 9: XE5QF1y74bpHog9JxWJMWQ ($102 in chips)
G4DEhsZFmznGNVpy2SEocA: posts small blind $0.50
XE5QF1y74bpHog9JxWJMWQ: posts big blind $1
h5ipsNTMyolp7xn/NAvWkA: posts big blind $1
*** HOLE CARDS ***
wZsU+w9r7G66x93UuvBf1Q: folds
RqkO8O/Y3qlc3PIuCAHjVg: folds
FVs16t7GgfWgQWt4JxsObQ: calls $1
bLbSOSmSOnqE0iTcH/5dxA: raises $5 to $6
RqkO8O/Y3qlc3PIuCAHjVg leaves the table
h5ipsNTMyolp7xn/NAvWkA: folds
gUUvmqdVlmvpal6B8nYrmg: folds
G4DEhsZFmznGNVpy2SEocA: folds
XE5QF1y74bpHog9JxWJMWQ: folds
FVs16t7GgfWgQWt4JxsObQ: folds
bLbSOSmSOnqE0iTcH/5dxA collected $4.50 from pot
*** SUMMARY ***
Total pot $4.50 | Rake $0
Seat 1: wZsU+w9r7G66x93UuvBf1Q folded before Flop (didn't bet)
Seat 2: RqkO8O/Y3qlc3PIuCAHjVg folded before Flop (didn't bet)
Seat 3: FVs16t7GgfWgQWt4JxsObQ folded before Flop
Seat 4: bLbSOSmSOnqE0iTcH/5dxA collected ($4.50)
Seat 5: h5ipsNTMyolp7xn/NAvWkA folded before Flop
Seat 6: gUUvmqdVlmvpal6B8nYrmg (button) folded before Flop (didn't bet)
Seat 8: G4DEhsZFmznGNVpy2SEocA (small blind) folded before Flop
Seat 9: XE5QF1y74bpHog9JxWJMWQ (big blind) folded before Flop



PokerStars Game #59940348170:  Hold'em No Limit ($0.50/$1.00) - 2009/07/01 1:04:06 ET
Table 'O96CPOtvMBWP6kzuYDfdFA' 6-max Seat #6 is the button
Seat 1: 6alLXQIITA2EZ/lBeym8Dw ($125.05 in chips)
Seat 3: V89DGjxE171oPREEbAXiyg ($88 in chips)
Seat 4: /P4w1pHg2zHYg/4ubJ0dPw ($60.90 in chips)
Seat 5: G5ZSSN6RSON3gkNvk/SmYg ($100 in chips)
Seat 6: GYei5jXGWexiJYbAT2fELg ($24.35 in chips)
6alLXQIITA2EZ/lBeym8Dw: posts small blind $0.50
V89DGjxE171oPREEbAXiyg: posts big blind $1
*** HOLE CARDS ***
/P4w1pHg2zHYg/4ubJ0dPw: folds
yynBOXUjw28V5kz84sxX4g leaves the table
G5ZSSN6RSON3gkNvk/SmYg: raises $2 to $3
GYei5jXGWexiJYbAT2fELg: calls $3
6alLXQIITA2EZ/lBeym8Dw: folds
V89DGjxE171oPREEbAXiyg: folds
*** FLOP *** [Js 7c Tc]
G5ZSSN6RSON3gkNvk/SmYg: checks
GYei5jXGWexiJYbAT2fELg: bets $4
G5ZSSN6RSON3gkNvk/SmYg: folds
GYei5jXGWexiJYbAT2fELg collected $7.15 from pot
*** SUMMARY ***
Total pot $7.50 | Rake $0.35
Board [Js 7c Tc]
Seat 1: 6alLXQIITA2EZ/lBeym8Dw (small blind) folded before Flop
Seat 3: V89DGjxE171oPREEbAXiyg (big blind) folded before Flop
Seat 4: /P4w1pHg2zHYg/4ubJ0dPw folded before Flop (didn't bet)
Seat 5: G5ZSSN6RSON3gkNvk/SmYg folded on the Flop
Seat 6: GYei5jXGWexiJYbAT2fELg (button) collected ($7.15)



PokerStars Game #59940348920:  Hold'em No Limit ($0.50/$1.00) - 2009/07/01 1:04:07 ET
Table 'JTT1XWaDZHSaMZQK7cR5uw' 2-max Seat #1 is the button
Seat 1: OLplZF6FEnLflv81Hz+Fxg ($132.25 in chips)
Seat 2: BcqgegiOUxmBD3F3umsljg ($77.25 in chips)
OLplZF6FEnLflv81Hz+Fxg: posts small blind $0.50
BcqgegiOUxmBD3F3umsljg: posts big blind $1
*** HOLE CARDS ***
OLplZF6FEnLflv81Hz+Fxg: folds
BcqgegiOUxmBD3F3umsljg collected $1 from pot
*** SUMMARY ***
Total pot $1 | Rake $0
Seat 1: OLplZF6FEnLflv81Hz+Fxg (button) (small blind) folded before Flop
Seat 2: BcqgegiOUxmBD3F3umsljg (big blind) collected ($1)



PokerStars Game #59940351512:  Hold'em No Limit ($0.50/$1.00) - 2009/07/01 1:04:11 ET
Table 'GxCPo/gd3OSthkYrAxJngg' 6-max Seat #1 is the button
Seat 1: sH8BpAFP+jGFxCgVpD1Lew ($268.40 in chips)
Seat 2: YExX2paeIHrmfIwV1ivM/w ($78.10 in chips)
Seat 3: o6plE+MSW4XFNTeONe16xg ($23.60 in chips)
Seat 4: YMJG+F++3Aj6P8dAWda5fw ($206.75 in chips)
Seat 5: G5ZSSN6RSON3gkNvk/SmYg ($103.75 in chips)
YExX2paeIHrmfIwV1ivM/w: posts small blind $0.50
o6plE+MSW4XFNTeONe16xg: posts big blind $1
*** HOLE CARDS ***
YMJG+F++3Aj6P8dAWda5fw: raises $2 to $3
G5ZSSN6RSON3gkNvk/SmYg: calls $3
sH8BpAFP+jGFxCgVpD1Lew: folds
YExX2paeIHrmfIwV1ivM/w: calls $2.50
o6plE+MSW4XFNTeONe16xg: calls $2
*** FLOP *** [Jh Kh 8s]
YExX2paeIHrmfIwV1ivM/w: checks
o6plE+MSW4XFNTeONe16xg: checks
YMJG+F++3Aj6P8dAWda5fw: checks
G5ZSSN6RSON3gkNvk/SmYg: checks
*** TURN *** [Jh Kh 8s] [Ah]
4d1rWhpu8DzLmzMbR3QKyA joins the table at seat #6
4d1rWhpu8DzLmzMbR3QKyA is sitting out
YExX2paeIHrmfIwV1ivM/w: checks
o6plE+MSW4XFNTeONe16xg: checks
YMJG+F++3Aj6P8dAWda5fw: checks
G5ZSSN6RSON3gkNvk/SmYg: bets $6
YExX2paeIHrmfIwV1ivM/w: calls $6
o6plE+MSW4XFNTeONe16xg: folds
YMJG+F++3Aj6P8dAWda5fw: folds
*** RIVER *** [Jh Kh 8s Ah] [6c]
YExX2paeIHrmfIwV1ivM/w: checks
G5ZSSN6RSON3gkNvk/SmYg: checks
*** SHOW DOWN ***
YExX2paeIHrmfIwV1ivM/w: shows [As 5s] (a pair of Aces)
G5ZSSN6RSON3gkNvk/SmYg: shows [Ad Qd] (a pair of Aces - King+Queen kicker)
G5ZSSN6RSON3gkNvk/SmYg collected $22.85 from pot
*** SUMMARY ***
Total pot $24 | Rake $1.15
Board [Jh Kh 8s Ah 6c]
Seat 1: sH8BpAFP+jGFxCgVpD1Lew (button) folded before Flop (didn't bet)
Seat 2: YExX2paeIHrmfIwV1ivM/w (small blind) showed [As 5s] and lost with a pair of Aces
Seat 3: o6plE+MSW4XFNTeONe16xg (big blind) folded on the Turn
Seat 4: YMJG+F++3Aj6P8dAWda5fw folded on the Turn
Seat 5: G5ZSSN6RSON3gkNvk/SmYg showed [Ad Qd] and won ($22.85) with a pair of Aces



PokerStars Game #59940352512:  Hold'em No Limit ($0.50/$1.00) - 2009/07/01 1:04:13 ET
Table 'fTlPiCj0utgzC/5io+I7ew' 6-max Seat #1 is the button
Seat 1: YMJG+F++3Aj6P8dAWda5fw ($104.35 in chips)
Seat 2: Qy/UBNbD2HaA0Ogxg8Sf3w ($124.35 in chips)
Seat 3: wL5HjWHHOSGc53xWMNKB9Q ($25.60 in chips)
Seat 4: uJVSceLggtsrJya+WtmUEA ($158 in chips)
Seat 5: GC5g2ryXV7e4TTqmaxUofw ($53.20 in chips)
Seat 6: /P4w1pHg2zHYg/4ubJ0dPw ($69.05 in chips)
Qy/UBNbD2HaA0Ogxg8Sf3w: posts small blind $0.50
wL5HjWHHOSGc53xWMNKB9Q: posts big blind $1
*** HOLE CARDS ***
uJVSceLggtsrJya+WtmUEA: folds
GC5g2ryXV7e4TTqmaxUofw: folds
/P4w1pHg2zHYg/4ubJ0dPw: folds
YMJG+F++3Aj6P8dAWda5fw: folds
Qy/UBNbD2HaA0Ogxg8Sf3w: folds
wL5HjWHHOSGc53xWMNKB9Q collected $1 from pot
*** SUMMARY ***
Total pot $1 | Rake $0
Seat 1: YMJG+F++3Aj6P8dAWda5fw (button) folded before Flop (didn't bet)
Seat 2: Qy/UBNbD2HaA0Ogxg8Sf3w (small blind) folded before Flop
Seat 3: wL5HjWHHOSGc53xWMNKB9Q (big blind) collected ($1)
Seat 4: uJVSceLggtsrJya+WtmUEA folded before Flop (didn't bet)
Seat 5: GC5g2ryXV7e4TTqmaxUofw folded before Flop (didn't bet)
Seat 6: /P4w1pHg2zHYg/4ubJ0dPw folded before Flop (didn't bet)



PokerStars Game #59940353070:  Hold'em No Limit ($0.50/$1.00) - 2009/07/01 1:04:14 ET
Table 'JTT1XWaDZHSaMZQK7cR5uw' 2-max Seat #2 is the button
Seat 1: OLplZF6FEnLflv81Hz+Fxg ($131.75 in chips)
Seat 2: BcqgegiOUxmBD3F3umsljg ($77.75 in chips)
BcqgegiOUxmBD3F3umsljg: posts small blind $0.50
OLplZF6FEnLflv81Hz+Fxg: posts big blind $1
*** HOLE CARDS ***
BcqgegiOUxmBD3F3umsljg: raises $1 to $2
OLplZF6FEnLflv81Hz+Fxg: calls $1
*** FLOP *** [Qd 9d 8h]
OLplZF6FEnLflv81Hz+Fxg: checks
BcqgegiOUxmBD3F3umsljg: checks
*** TURN *** [Qd 9d 8h] [4s]
OLplZF6FEnLflv81Hz+Fxg: checks
BcqgegiOUxmBD3F3umsljg: checks
*** RIVER *** [Qd 9d 8h 4s] [9c]
OLplZF6FEnLflv81Hz+Fxg: checks
BcqgegiOUxmBD3F3umsljg: checks
*** SHOW DOWN ***
OLplZF6FEnLflv81Hz+Fxg: shows [2s 7s] (a pair of Nines)
BcqgegiOUxmBD3F3umsljg: shows [6d Ks] (a pair of Nines - King kicker)
BcqgegiOUxmBD3F3umsljg collected $3.80 from pot
*** SUMMARY ***
Total pot $4 | Rake $0.20
Board [Qd 9d 8h 4s 9c]
Seat 1: OLplZF6FEnLflv81Hz+Fxg (big blind) showed [2s 7s] and lost with a pair of Nines
Seat 2: BcqgegiOUxmBD3F3umsljg (button) (small blind) showed [6d Ks] and won ($3.80) with a pair of Nines



PokerStars Game #59940353634:  Hold'em No Limit ($0.50/$1.00) - 2009/07/01 1:04:15 ET
Table 'pHrhryH8jPNdQfY62f8v+g' 6-max Seat #3 is the button
Seat 1: OvwYHV65yUbgdBjSmo1+5g ($57.20 in chips)
Seat 2: RqgF7gRoKgRNW8Zoi1ty4A ($136.80 in chips)
Seat 3: 8oS5O7iD/qnFXFXJrGIgNQ ($151.80 in chips)
Seat 5: r1/R7y0Ortgoz4lccgW8VA ($45.05 in chips)
Seat 6: xAU6q2/cwmby2sxmA8VcmA ($103.80 in chips)
r1/R7y0Ortgoz4lccgW8VA: posts small blind $0.50
xAU6q2/cwmby2sxmA8VcmA: posts big blind $1
*** HOLE CARDS ***
OvwYHV65yUbgdBjSmo1+5g: calls $1
RqgF7gRoKgRNW8Zoi1ty4A: raises $4 to $5
8oS5O7iD/qnFXFXJrGIgNQ: folds
r1/R7y0Ortgoz4lccgW8VA: folds
xAU6q2/cwmby2sxmA8VcmA: folds
1f3beyIML24UqEMTbWy93g joins the table at seat #4
OvwYHV65yUbgdBjSmo1+5g: folds
RqgF7gRoKgRNW8Zoi1ty4A collected $3.50 from pot
*** SUMMARY ***
Total pot $3.50 | Rake $0
Seat 1: OvwYHV65yUbgdBjSmo1+5g folded before Flop
Seat 2: RqgF7gRoKgRNW8Zoi1ty4A collected ($3.50)
Seat 3: 8oS5O7iD/qnFXFXJrGIgNQ (button) folded before Flop (didn't bet)
Seat 5: r1/R7y0Ortgoz4lccgW8VA (small blind) folded before Flop
Seat 6: xAU6q2/cwmby2sxmA8VcmA (big blind) folded before Flop



PokerStars Game #59940354110:  Hold'em No Limit ($0.50/$1.00) - 2009/07/01 1:04:16 ET
Table 'vs/5jr6ciwjVQ5+Soc+u2A' 6-max Seat #1 is the button
Seat 1: /P4w1pHg2zHYg/4ubJ0dPw ($60.30 in chips)
Seat 2: lXX4W7m3u++JiSOZ46yVMQ ($99 in chips)
Seat 3: G5ZSSN6RSON3gkNvk/SmYg ($137.85 in chips)
Seat 4: wk6Ohn4GDozoOMHc4eb2rw ($85.65 in chips)
Seat 5: +Nt3OPk3XR9SKjZgm2CexQ ($107.45 in chips)
lXX4W7m3u++JiSOZ46yVMQ: posts small blind $0.50
G5ZSSN6RSON3gkNvk/SmYg: posts big blind $1
*** HOLE CARDS ***
wk6Ohn4GDozoOMHc4eb2rw: folds
+Nt3OPk3XR9SKjZgm2CexQ: folds
/P4w1pHg2zHYg/4ubJ0dPw: folds
lXX4W7m3u++JiSOZ46yVMQ: calls $0.50
G5ZSSN6RSON3gkNvk/SmYg: checks
*** FLOP *** [Qh 8s 9h]
lXX4W7m3u++JiSOZ46yVMQ: checks
G5ZSSN6RSON3gkNvk/SmYg: bets $2
lXX4W7m3u++JiSOZ46yVMQ: raises $5 to $7
G5ZSSN6RSON3gkNvk/SmYg: calls $5
*** TURN *** [Qh 8s 9h] [Jc]
lXX4W7m3u++JiSOZ46yVMQ: checks
G5ZSSN6RSON3gkNvk/SmYg: checks
*** RIVER *** [Qh 8s 9h Jc] [Ah]
lXX4W7m3u++JiSOZ46yVMQ: bets $5
G5ZSSN6RSON3gkNvk/SmYg: raises $10 to $15
lXX4W7m3u++JiSOZ46yVMQ: calls $10
*** SHOW DOWN ***
G5ZSSN6RSON3gkNvk/SmYg: shows [7h 2h] (a flush, Ace high)
lXX4W7m3u++JiSOZ46yVMQ: mucks hand
G5ZSSN6RSON3gkNvk/SmYg collected $44 from pot
*** SUMMARY ***
Total pot $46 | Rake $2
Board [Qh 8s 9h Jc Ah]
Seat 1: /P4w1pHg2zHYg/4ubJ0dPw (button) folded before Flop (didn't bet)
Seat 2: lXX4W7m3u++JiSOZ46yVMQ (small blind) mucked
Seat 3: G5ZSSN6RSON3gkNvk/SmYg (big blind) showed [7h 2h] and won ($44) with a flush, Ace high
Seat 4: wk6Ohn4GDozoOMHc4eb2rw folded before Flop (didn't bet)
Seat 5: +Nt3OPk3XR9SKjZgm2CexQ folded before Flop (didn't bet)



PokerStars Game #59940354118:  Hold'em No Limit ($0.50/$1.00) - 2009/07/01 1:04:16 ET
Table 'QSIig7BLMc9wY/rgBechzw' 6-max Seat #5 is the button
Seat 1: Z2fXsGcjl+Eax+RzOgwOmg ($100 in chips)
Seat 2: mLOIkH/qmRa+mVujQIhBRg ($40.65 in chips)
Seat 4: +uSzP8Jwnw7sKfQ4s66b7w ($75.10 in chips)
Seat 5: PVmmeYpn4gqkqYUool6BOA ($15.40 in chips)
Seat 6: PxqfkAMdAWtkgbT+q2gciA ($32.20 in chips)
PxqfkAMdAWtkgbT+q2gciA: posts small blind $0.50
Z2fXsGcjl+Eax+RzOgwOmg: posts big blind $1
+xW7QemQU0Fxs+4TnqBRow: sits out
*** HOLE CARDS ***
mLOIkH/qmRa+mVujQIhBRg: folds
+uSzP8Jwnw7sKfQ4s66b7w: raises $2 to $3
PVmmeYpn4gqkqYUool6BOA: raises $2 to $5
PxqfkAMdAWtkgbT+q2gciA: folds
Z2fXsGcjl+Eax+RzOgwOmg: folds
+uSzP8Jwnw7sKfQ4s66b7w: calls $2
*** FLOP *** [Kh 8s Jh]
+uSzP8Jwnw7sKfQ4s66b7w: checks
PVmmeYpn4gqkqYUool6BOA: bets $10.40 and is all-in
+uSzP8Jwnw7sKfQ4s66b7w: calls $10.40
*** TURN *** [Kh 8s Jh] [Js]
*** RIVER *** [Kh 8s Jh Js] [Ad]
*** SHOW DOWN ***
+uSzP8Jwnw7sKfQ4s66b7w: shows [Jc Qh] (three of a kind, Jacks)
PVmmeYpn4gqkqYUool6BOA: mucks hand
+uSzP8Jwnw7sKfQ4s66b7w collected $30.75 from pot
*** SUMMARY ***
Total pot $32.30 | Rake $1.55
Board [Kh 8s Jh Js Ad]
Seat 1: Z2fXsGcjl+Eax+RzOgwOmg (big blind) folded before Flop
Seat 2: mLOIkH/qmRa+mVujQIhBRg folded before Flop (didn't bet)
Seat 4: +uSzP8Jwnw7sKfQ4s66b7w showed [Jc Qh] and won ($30.75) with three of a kind, Jacks
Seat 5: PVmmeYpn4gqkqYUool6BOA (button) mucked
Seat 6: PxqfkAMdAWtkgbT+q2gciA (small blind) folded before Flop



PokerStars Game #59940354216:  Hold'em No Limit ($0.50/$1.00) - 2009/07/01 1:04:16 ET
Table 'cKH9c4x6u79IqCdaKKvXrw' 9-max Seat #8 is the button
Seat 1: Pp/KTcXkfZKKUHkjyaLTdg ($20 in chips)
Seat 2: 8S3JMH4TY3whgIlZmMv66w ($69.15 in chips)
Seat 3: 997ViqAtWn1FPjJqcffwcA ($157.10 in chips)
Seat 4: FL3MrLspcF23LYvC4ipBOA ($100 in chips)
Seat 5: Jjc7EHWzs4//xUAjJ0UWoA ($40.65 in chips)
Seat 6: Bsd/K5gAcLanYbGiPirRjw ($206.55 in chips)
Seat 7: 1GkkVBhlJ92guE6K5mS5Ig ($17.75 in chips)
Seat 8: myIxN7otsyr846M539YR8Q ($17 in chips)
Seat 9: 6XkTu4ahxzHnvjjc1R8YjQ ($42.10 in chips)
6XkTu4ahxzHnvjjc1R8YjQ: posts small blind $0.50
Pp/KTcXkfZKKUHkjyaLTdg: posts big blind $1
*** HOLE CARDS ***
8S3JMH4TY3whgIlZmMv66w: calls $1
997ViqAtWn1FPjJqcffwcA: folds
FL3MrLspcF23LYvC4ipBOA: folds
Jjc7EHWzs4//xUAjJ0UWoA: folds
Bsd/K5gAcLanYbGiPirRjw: raises $3 to $4
1GkkVBhlJ92guE6K5mS5Ig: folds
myIxN7otsyr846M539YR8Q: folds
6XkTu4ahxzHnvjjc1R8YjQ: folds
Pp/KTcXkfZKKUHkjyaLTdg: folds
8S3JMH4TY3whgIlZmMv66w: calls $3
*** FLOP *** [Th Ac 2c]
8S3JMH4TY3whgIlZmMv66w: bets $4
Bsd/K5gAcLanYbGiPirRjw: folds
8S3JMH4TY3whgIlZmMv66w collected $9.05 from pot
8S3JMH4TY3whgIlZmMv66w: doesn't show hand
*** SUMMARY ***
Total pot $9.50 | Rake $0.45
Board [Th Ac 2c]
Seat 1: Pp/KTcXkfZKKUHkjyaLTdg (big blind) folded before Flop
Seat 2: 8S3JMH4TY3whgIlZmMv66w collected ($9.05)
Seat 3: 997ViqAtWn1FPjJqcffwcA folded before Flop (didn't bet)
Seat 4: FL3MrLspcF23LYvC4ipBOA folded before Flop (didn't bet)
Seat 5: Jjc7EHWzs4//xUAjJ0UWoA folded before Flop (didn't bet)
Seat 6: Bsd/K5gAcLanYbGiPirRjw folded on the Flop
Seat 7: 1GkkVBhlJ92guE6K5mS5Ig folded before Flop (didn't bet)
Seat 8: myIxN7otsyr846M539YR8Q (button) folded before Flop (didn't bet)
Seat 9: 6XkTu4ahxzHnvjjc1R8YjQ (small blind) folded before Flop



PokerStars Game #59940356688:  Hold'em No Limit ($0.50/$1.00) - 2009/07/01 1:04:20 ET
Table 'MUPc8FEpe/nR0BKSeReX6Q' 6-max Seat #6 is the button
Seat 1: qhkK6+yCciTRd+rCFEbnEQ ($42.20 in chips)
Seat 2: xAU6q2/cwmby2sxmA8VcmA ($122.70 in chips)
Seat 3: wx3sQGkVi2x9wJXuWNHPBw ($236.40 in chips)
Seat 4: ZA1bp6g8IwtTxkUE4eCjDQ ($197.15 in chips)
Seat 5: UBZQqpnJZdTYYY1FTb0rLA ($100 in chips)
Seat 6: oxnw0GLLpFanjhGkxfRSqA ($23.20 in chips)
qhkK6+yCciTRd+rCFEbnEQ: posts small blind $0.50
xAU6q2/cwmby2sxmA8VcmA: posts big blind $1
*** HOLE CARDS ***
wx3sQGkVi2x9wJXuWNHPBw: raises $3 to $4
ZA1bp6g8IwtTxkUE4eCjDQ: calls $4
UBZQqpnJZdTYYY1FTb0rLA: folds
oxnw0GLLpFanjhGkxfRSqA: folds
qhkK6+yCciTRd+rCFEbnEQ: folds
xAU6q2/cwmby2sxmA8VcmA: folds
*** FLOP *** [Ac 7c 5h]
wx3sQGkVi2x9wJXuWNHPBw: bets $6.50
ZA1bp6g8IwtTxkUE4eCjDQ: calls $6.50
*** TURN *** [Ac 7c 5h] [8s]
wx3sQGkVi2x9wJXuWNHPBw: bets $14
ZA1bp6g8IwtTxkUE4eCjDQ: calls $14
*** RIVER *** [Ac 7c 5h 8s] [5s]
wx3sQGkVi2x9wJXuWNHPBw: checks
ZA1bp6g8IwtTxkUE4eCjDQ: checks
*** SHOW DOWN ***
wx3sQGkVi2x9wJXuWNHPBw: shows [Ad Jc] (two pair, Aces and Fives)
ZA1bp6g8IwtTxkUE4eCjDQ: shows [Ah Jd] (two pair, Aces and Fives)
wx3sQGkVi2x9wJXuWNHPBw collected $24.05 from pot
ZA1bp6g8IwtTxkUE4eCjDQ collected $24 from pot
*** SUMMARY ***
Total pot $50.50 | Rake $2.45
Board [Ac 7c 5h 8s 5s]
Seat 1: qhkK6+yCciTRd+rCFEbnEQ (small blind) folded before Flop
Seat 2: xAU6q2/cwmby2sxmA8VcmA (big blind) folded before Flop
Seat 3: wx3sQGkVi2x9wJXuWNHPBw showed [Ad Jc] and won ($24.05) with two pair, Aces and Fives
Seat 4: ZA1bp6g8IwtTxkUE4eCjDQ showed [Ah Jd] and won ($24) with two pair, Aces and Fives
Seat 5: UBZQqpnJZdTYYY1FTb0rLA folded before Flop (didn't bet)
Seat 6: oxnw0GLLpFanjhGkxfRSqA (button) folded before Flop (didn't bet)



PokerStars Game #59940356406:  Hold'em No Limit ($0.50/$1.00) - 2009/07/01 1:04:20 ET
Table 'eU3bWpDDg3Z+9R4m4iVmog' 6-max Seat #6 is the button
Seat 1: TSuRyAHnUPCFjP7Z0rEE0w ($177.65 in chips)
Seat 2: 8CAoOzhmB8n3nRFf3V4BTg ($59.45 in chips)
Seat 3: rVMOzU7w5FddYPGhD7qN2Q ($40.15 in chips)
Seat 4: GDVIsbEJ/DOJsMKE4Asz0A ($121.20 in chips)
Seat 6: hpxXcmRkXXI9HE5+5/j/0Q ($126.75 in chips)
TSuRyAHnUPCFjP7Z0rEE0w: posts small blind $0.50
8CAoOzhmB8n3nRFf3V4BTg: posts big blind $1
*** HOLE CARDS ***
rVMOzU7w5FddYPGhD7qN2Q: folds
GDVIsbEJ/DOJsMKE4Asz0A: raises $2 to $3
hpxXcmRkXXI9HE5+5/j/0Q: calls $3
TSuRyAHnUPCFjP7Z0rEE0w: folds
8CAoOzhmB8n3nRFf3V4BTg: calls $2
*** FLOP *** [3s 2d 7d]
8CAoOzhmB8n3nRFf3V4BTg: checks
GDVIsbEJ/DOJsMKE4Asz0A: checks
hpxXcmRkXXI9HE5+5/j/0Q: checks
*** TURN *** [3s 2d 7d] [8s]
8CAoOzhmB8n3nRFf3V4BTg: bets $6
GDVIsbEJ/DOJsMKE4Asz0A: folds
hpxXcmRkXXI9HE5+5/j/0Q: calls $6
*** RIVER *** [3s 2d 7d 8s] [9h]
8CAoOzhmB8n3nRFf3V4BTg: bets $15
hpxXcmRkXXI9HE5+5/j/0Q: folds
8CAoOzhmB8n3nRFf3V4BTg collected $20.45 from pot
*** SUMMARY ***
Total pot $21.50 | Rake $1.05
Board [3s 2d 7d 8s 9h]
Seat 1: TSuRyAHnUPCFjP7Z0rEE0w (small blind) folded before Flop
Seat 2: 8CAoOzhmB8n3nRFf3V4BTg (big blind) collected ($20.45)
Seat 3: rVMOzU7w5FddYPGhD7qN2Q folded before Flop (didn't bet)
Seat 4: GDVIsbEJ/DOJsMKE4Asz0A folded on the Turn
Seat 6: hpxXcmRkXXI9HE5+5/j/0Q (button) folded on the River



PokerStars Game #59940357580:  Hold'em No Limit ($0.50/$1.00) - 2009/07/01 1:04:21 ET
Table '7O9fB8yx1u7sJveJn8w6jA' 6-max Seat #6 is the button
Seat 2: wx3sQGkVi2x9wJXuWNHPBw ($195.45 in chips)
Seat 3: hpxXcmRkXXI9HE5+5/j/0Q ($101.50 in chips)
Seat 4: XIZSmlGttGgSRaIU42K4Fg ($139.90 in chips)
Seat 5: BCEV3COoKY607AzLWayfRA ($107.80 in chips)
Seat 6: UBZQqpnJZdTYYY1FTb0rLA ($136.45 in chips)
wx3sQGkVi2x9wJXuWNHPBw: posts small blind $0.50
hpxXcmRkXXI9HE5+5/j/0Q: posts big blind $1
*** HOLE CARDS ***
XIZSmlGttGgSRaIU42K4Fg: folds
BCEV3COoKY607AzLWayfRA: folds
UBZQqpnJZdTYYY1FTb0rLA: raises $2 to $3
wx3sQGkVi2x9wJXuWNHPBw: folds
hpxXcmRkXXI9HE5+5/j/0Q: calls $2
*** FLOP *** [Td 6d 2s]
hpxXcmRkXXI9HE5+5/j/0Q: bets $5
UBZQqpnJZdTYYY1FTb0rLA: folds
hpxXcmRkXXI9HE5+5/j/0Q collected $6.20 from pot
hpxXcmRkXXI9HE5+5/j/0Q: doesn't show hand
*** SUMMARY ***
Total pot $6.50 | Rake $0.30
Board [Td 6d 2s]
Seat 2: wx3sQGkVi2x9wJXuWNHPBw (small blind) folded before Flop
Seat 3: hpxXcmRkXXI9HE5+5/j/0Q (big blind) collected ($6.20)
Seat 4: XIZSmlGttGgSRaIU42K4Fg folded before Flop (didn't bet)
Seat 5: BCEV3COoKY607AzLWayfRA folded before Flop (didn't bet)
Seat 6: UBZQqpnJZdTYYY1FTb0rLA (button) folded on the Flop



PokerStars Game #59940359108:  Hold'em No Limit ($0.50/$1.00) - 2009/07/01 1:04:24 ET
Table 'kS0cTQAEi+fdUlJP2gQYvw' 9-max Seat #1 is the button
Seat 1: c/9X4zftzphFxYtxp5kp9w ($64.35 in chips)
Seat 2: D+W9Me7w6Hcx/WRUSKV0dw ($21.40 in chips)
Seat 3: 2BV+oJIQYr65IO6nEChvbA ($60 in chips)
Seat 4: TZcz9MEWDA+WydgGruqqbw ($100.10 in chips)
Seat 5: 997ViqAtWn1FPjJqcffwcA ($104.15 in chips)
Seat 6: yAbu2QsRPVcjPbqlf/jDxw ($127.65 in chips)
Seat 7: Ffa7Nj4X5fddtROP01hfQg ($131.55 in chips)
Seat 8: QYMfy2FoN6/Qe1LWYuI7fw ($20.50 in chips)
Seat 9: OGgaARGdJQT4awWVNQ957w ($102 in chips)
D+W9Me7w6Hcx/WRUSKV0dw: posts small blind $0.50
2BV+oJIQYr65IO6nEChvbA: posts big blind $1
*** HOLE CARDS ***
TZcz9MEWDA+WydgGruqqbw: folds
997ViqAtWn1FPjJqcffwcA: folds
yAbu2QsRPVcjPbqlf/jDxw: folds
Ffa7Nj4X5fddtROP01hfQg: raises $2 to $3
QYMfy2FoN6/Qe1LWYuI7fw: calls $3
OGgaARGdJQT4awWVNQ957w: folds
c/9X4zftzphFxYtxp5kp9w: folds
D+W9Me7w6Hcx/WRUSKV0dw: folds
2BV+oJIQYr65IO6nEChvbA: folds
*** FLOP *** [2d 5h 5d]
Ffa7Nj4X5fddtROP01hfQg: bets $2
QYMfy2FoN6/Qe1LWYuI7fw: raises $5 to $7
Ffa7Nj4X5fddtROP01hfQg: folds
QYMfy2FoN6/Qe1LWYuI7fw collected $10.95 from pot
*** SUMMARY ***
Total pot $11.50 | Rake $0.55
Board [2d 5h 5d]
Seat 1: c/9X4zftzphFxYtxp5kp9w (button) folded before Flop (didn't bet)
Seat 2: D+W9Me7w6Hcx/WRUSKV0dw (small blind) folded before Flop
Seat 3: 2BV+oJIQYr65IO6nEChvbA (big blind) folded before Flop
Seat 4: TZcz9MEWDA+WydgGruqqbw folded before Flop (didn't bet)
Seat 5: 997ViqAtWn1FPjJqcffwcA folded before Flop (didn't bet)
Seat 6: yAbu2QsRPVcjPbqlf/jDxw folded before Flop (didn't bet)
Seat 7: Ffa7Nj4X5fddtROP01hfQg folded on the Flop
Seat 8: QYMfy2FoN6/Qe1LWYuI7fw collected ($10.95)
Seat 9: OGgaARGdJQT4awWVNQ957w folded before Flop (didn't bet)



PokerStars Game #59940361002:  Hold'em No Limit ($0.50/$1.00) - 2009/07/01 1:04:27 ET
Table '8jIjWCPY0NGprquL+xcMFg' 9-max Seat #7 is the button
Seat 1: N7iZ0peZns5o4A6AjN24jQ ($47.40 in chips)
Seat 2: laA8va+Yv8WuMqT1zdR91g ($108.70 in chips)
Seat 3: tjhwe1V98x2spSoUQER3HQ ($108.95 in chips)
Seat 4: Jjc7EHWzs4//xUAjJ0UWoA ($18.90 in chips)
Seat 5: 2YpnxJiexJHyERfbqgwEcw ($53.55 in chips)
Seat 6: GTQkFJtSkbVbnGCktp6e3g ($100 in chips)
Seat 7: O3CGPwwUmamrCNHccOilrg ($34.45 in chips)
Seat 8: D+W9Me7w6Hcx/WRUSKV0dw ($17.50 in chips)
D+W9Me7w6Hcx/WRUSKV0dw: posts small blind $0.50
negfosHnGOZXSHpWDRKyBQ: is sitting out
N7iZ0peZns5o4A6AjN24jQ: posts big blind $1
*** HOLE CARDS ***
negfosHnGOZXSHpWDRKyBQ leaves the table
laA8va+Yv8WuMqT1zdR91g: folds
tjhwe1V98x2spSoUQER3HQ has timed out while being disconnected
tjhwe1V98x2spSoUQER3HQ: folds
tjhwe1V98x2spSoUQER3HQ is sitting out
Jjc7EHWzs4//xUAjJ0UWoA: calls $1
2YpnxJiexJHyERfbqgwEcw: folds
tjhwe1V98x2spSoUQER3HQ is disconnected
GTQkFJtSkbVbnGCktp6e3g: folds
O3CGPwwUmamrCNHccOilrg: folds
D+W9Me7w6Hcx/WRUSKV0dw: folds
N7iZ0peZns5o4A6AjN24jQ: checks
*** FLOP *** [7h Ts 4d]
N7iZ0peZns5o4A6AjN24jQ: checks
Jjc7EHWzs4//xUAjJ0UWoA: bets $2
N7iZ0peZns5o4A6AjN24jQ: calls $2
*** TURN *** [7h Ts 4d] [2s]
N7iZ0peZns5o4A6AjN24jQ: checks
Jjc7EHWzs4//xUAjJ0UWoA: checks
*** RIVER *** [7h Ts 4d 2s] [3c]
N7iZ0peZns5o4A6AjN24jQ: checks
Jjc7EHWzs4//xUAjJ0UWoA: checks
*** SHOW DOWN ***
N7iZ0peZns5o4A6AjN24jQ: shows [Jd 8d] (high card Jack)
Jjc7EHWzs4//xUAjJ0UWoA: shows [6h 3h] (a pair of Threes)
Jjc7EHWzs4//xUAjJ0UWoA collected $6.20 from pot
*** SUMMARY ***
Total pot $6.50 | Rake $0.30
Board [7h Ts 4d 2s 3c]
Seat 1: N7iZ0peZns5o4A6AjN24jQ (big blind) showed [Jd 8d] and lost with high card Jack
Seat 2: laA8va+Yv8WuMqT1zdR91g folded before Flop (didn't bet)
Seat 3: tjhwe1V98x2spSoUQER3HQ folded before Flop (didn't bet)
Seat 4: Jjc7EHWzs4//xUAjJ0UWoA showed [6h 3h] and won ($6.20) with a pair of Threes
Seat 5: 2YpnxJiexJHyERfbqgwEcw folded before Flop (didn't bet)
Seat 6: GTQkFJtSkbVbnGCktp6e3g folded before Flop (didn't bet)
Seat 7: O3CGPwwUmamrCNHccOilrg (button) folded before Flop (didn't bet)
Seat 8: D+W9Me7w6Hcx/WRUSKV0dw (small blind) folded before Flop



PokerStars Game #59940362014:  Hold'em No Limit ($0.50/$1.00) - 2009/07/01 1:04:29 ET
Table 'cBDNutyLBKEk9+ptwsKmTw' 6-max Seat #3 is the button
Seat 1: xAU6q2/cwmby2sxmA8VcmA ($109.85 in chips)
Seat 2: 5lY8d6Cnm4HUkt/8FZSj4g ($34.50 in chips)
Seat 3: G5ZSSN6RSON3gkNvk/SmYg ($100.15 in chips)
Seat 4: 3q7F5QtzC30pSrn0nl9i+A ($27.80 in chips)
Seat 5: OGMLOcTNYZXZU81au7ztUw ($165.05 in chips)
Seat 6: NqVlOSH2lp+pp/TK3vvK5g ($90.90 in chips)
3q7F5QtzC30pSrn0nl9i+A: posts small blind $0.50
OGMLOcTNYZXZU81au7ztUw: posts big blind $1
*** HOLE CARDS ***
NqVlOSH2lp+pp/TK3vvK5g: calls $1
xAU6q2/cwmby2sxmA8VcmA: folds
5lY8d6Cnm4HUkt/8FZSj4g: calls $1
G5ZSSN6RSON3gkNvk/SmYg: folds
3q7F5QtzC30pSrn0nl9i+A: calls $0.50
OGMLOcTNYZXZU81au7ztUw: checks
*** FLOP *** [Qd Kh 4h]
3q7F5QtzC30pSrn0nl9i+A: checks
OGMLOcTNYZXZU81au7ztUw: checks
NqVlOSH2lp+pp/TK3vvK5g: bets $1
5lY8d6Cnm4HUkt/8FZSj4g: folds
3q7F5QtzC30pSrn0nl9i+A: folds
OGMLOcTNYZXZU81au7ztUw: calls $1
*** TURN *** [Qd Kh 4h] [Ad]
OGMLOcTNYZXZU81au7ztUw: checks
NqVlOSH2lp+pp/TK3vvK5g: bets $3
OGMLOcTNYZXZU81au7ztUw: folds
NqVlOSH2lp+pp/TK3vvK5g collected $5.75 from pot
*** SUMMARY ***
Total pot $6 | Rake $0.25
Board [Qd Kh 4h Ad]
Seat 1: xAU6q2/cwmby2sxmA8VcmA folded before Flop (didn't bet)
Seat 2: 5lY8d6Cnm4HUkt/8FZSj4g folded on the Flop
Seat 3: G5ZSSN6RSON3gkNvk/SmYg (button) folded before Flop (didn't bet)
Seat 4: 3q7F5QtzC30pSrn0nl9i+A (small blind) folded on the Flop
Seat 5: OGMLOcTNYZXZU81au7ztUw (big blind) folded on the Turn
Seat 6: NqVlOSH2lp+pp/TK3vvK5g collected ($5.75)



PokerStars Game #59940363616:  Hold'em No Limit ($0.50/$1.00) - 2009/07/01 1:04:32 ET
Table 'hugOjcwJvzEwZbK7tyiWuQ' 9-max Seat #2 is the button
Seat 2: r27C1nIV4NS4+qbnrgBQSw ($281.70 in chips)
Seat 3: jDwhY1kCdc6EkAHbT7PJMQ ($105.25 in chips)
Seat 4: UWB3oeddt/GObx2Mix2Anw ($174.80 in chips)
Seat 5: 5BRGWf+R3nt2WS3b5xX+zA ($16.75 in chips)
Seat 6: gUUvmqdVlmvpal6B8nYrmg ($107.40 in chips)
Seat 7: FL3MrLspcF23LYvC4ipBOA ($110.30 in chips)
Seat 8: /zy+DB4S5fUQUSfZWFzYGw ($100 in chips)
Seat 9: W8P9bUKCs43TO1xHm0dL6w ($89.45 in chips)
jDwhY1kCdc6EkAHbT7PJMQ: posts small blind $0.50
UWB3oeddt/GObx2Mix2Anw: posts big blind $1
*** HOLE CARDS ***
5BRGWf+R3nt2WS3b5xX+zA: folds
gUUvmqdVlmvpal6B8nYrmg: folds
FL3MrLspcF23LYvC4ipBOA: folds
/zy+DB4S5fUQUSfZWFzYGw: folds
W8P9bUKCs43TO1xHm0dL6w: folds
r27C1nIV4NS4+qbnrgBQSw: raises $2 to $3
jDwhY1kCdc6EkAHbT7PJMQ: folds
UWB3oeddt/GObx2Mix2Anw: folds
r27C1nIV4NS4+qbnrgBQSw collected $2.50 from pot
*** SUMMARY ***
Total pot $2.50 | Rake $0
Seat 2: r27C1nIV4NS4+qbnrgBQSw (button) collected ($2.50)
Seat 3: jDwhY1kCdc6EkAHbT7PJMQ (small blind) folded before Flop
Seat 4: UWB3oeddt/GObx2Mix2Anw (big blind) folded before Flop
Seat 5: 5BRGWf+R3nt2WS3b5xX+zA folded before Flop (didn't bet)
Seat 6: gUUvmqdVlmvpal6B8nYrmg folded before Flop (didn't bet)
Seat 7: FL3MrLspcF23LYvC4ipBOA folded before Flop (didn't bet)
Seat 8: /zy+DB4S5fUQUSfZWFzYGw folded before Flop (didn't bet)
Seat 9: W8P9bUKCs43TO1xHm0dL6w folded before Flop (didn't bet)



PokerStars Game #59940364760:  Hold'em No Limit ($0.50/$1.00) - 2009/07/01 1:04:34 ET
Table 'W/wyObTiXZm+Ckkl3YxcSw' 6-max Seat #3 is the button
Seat 1: eUBBn2R56C1IQ6Cs/vitwg ($188.25 in chips)
Seat 2: oDiBRCaF0QVtd3kO6xZIXw ($117.85 in chips)
Seat 3: dxyNCn/qxfkGDUIf28Cbng ($82.40 in chips)
Seat 4: aYii2DmxlOlbC1wbGRBWvQ ($102.70 in chips)
Seat 5: MFptnnT6AnJakWBooTkmeg ($23.40 in chips)
aYii2DmxlOlbC1wbGRBWvQ: posts small blind $0.50
MFptnnT6AnJakWBooTkmeg: posts big blind $1
OGMLOcTNYZXZU81au7ztUw: sits out
*** HOLE CARDS ***
eUBBn2R56C1IQ6Cs/vitwg: folds
oDiBRCaF0QVtd3kO6xZIXw: folds
dxyNCn/qxfkGDUIf28Cbng: calls $1
aYii2DmxlOlbC1wbGRBWvQ: calls $0.50
MFptnnT6AnJakWBooTkmeg: checks
*** FLOP *** [Jh Qd Tc]
aYii2DmxlOlbC1wbGRBWvQ: checks
MFptnnT6AnJakWBooTkmeg: bets $2
dxyNCn/qxfkGDUIf28Cbng: folds
aYii2DmxlOlbC1wbGRBWvQ: folds
MFptnnT6AnJakWBooTkmeg collected $2.85 from pot
MFptnnT6AnJakWBooTkmeg: doesn't show hand
*** SUMMARY ***
Total pot $3 | Rake $0.15
Board [Jh Qd Tc]
Seat 1: eUBBn2R56C1IQ6Cs/vitwg folded before Flop (didn't bet)
Seat 2: oDiBRCaF0QVtd3kO6xZIXw folded before Flop (didn't bet)
Seat 3: dxyNCn/qxfkGDUIf28Cbng (button) folded on the Flop
Seat 4: aYii2DmxlOlbC1wbGRBWvQ (small blind) folded on the Flop
Seat 5: MFptnnT6AnJakWBooTkmeg (big blind) collected ($2.85)



PokerStars Game #59940365596:  Hold'em No Limit ($0.50/$1.00) - 2009/07/01 1:04:35 ET
Table 'tyUh+jyNvrceIQdKMJjQ2wZFWj23PMihdwrNWv41OG/Qeat #3 is the button
Seat 1: o8A5MUdudVKu+pAwgZOX2w ($117.90 in chips)
Seat 2: XvUbOIg94d25feWeQlOTVg ($147 in chips)
Seat 3: TalCiLYHCd+ffkmR3auPvA ($83.60 in chips)
Seat 4: TSuRyAHnUPCFjP7Z0rEE0w ($182 in chips)
Seat 5: j7NIOHLZk7V2o9fOioO5ug ($111.65 in chips)
Seat 6: 4OO5v3AVduL0tePNx8wk5A ($100 in chips)
TSuRyAHnUPCFjP7Z0rEE0w: posts small blind $0.50
j7NIOHLZk7V2o9fOioO5ug: posts big blind $1
*** HOLE CARDS ***
4OO5v3AVduL0tePNx8wk5A: folds
o8A5MUdudVKu+pAwgZOX2w: calls $1
XvUbOIg94d25feWeQlOTVg: folds
TalCiLYHCd+ffkmR3auPvA: folds
TSuRyAHnUPCFjP7Z0rEE0w: folds
j7NIOHLZk7V2o9fOioO5ug: checks
*** FLOP *** [7s 7c 3h]
j7NIOHLZk7V2o9fOioO5ug: checks
o8A5MUdudVKu+pAwgZOX2w: checks
*** TURN *** [7s 7c 3h] [Tc]
j7NIOHLZk7V2o9fOioO5ug: bets $3
o8A5MUdudVKu+pAwgZOX2w: calls $3
*** RIVER *** [7s 7c 3h Tc] [9d]
j7NIOHLZk7V2o9fOioO5ug: bets $7
o8A5MUdudVKu+pAwgZOX2w: calls $7
*** SHOW DOWN ***
j7NIOHLZk7V2o9fOioO5ug: shows [Td 9h] (two pair, Tens and Nines)
o8A5MUdudVKu+pAwgZOX2w: mucks hand
j7NIOHLZk7V2o9fOioO5ug collected $21.40 from pot
*** SUMMARY ***
Total pot $22.50 | Rake $1.10
Board [7s 7c 3h Tc 9d]
Seat 1: o8A5MUdudVKu+pAwgZOX2w mucked
Seat 2: XvUbOIg94d25feWeQlOTVg folded before Flop (didn't bet)
Seat 3: TalCiLYHCd+ffkmR3auPvA (button) folded before Flop (didn't bet)
Seat 4: TSuRyAHnUPCFjP7Z0rEE0w (small blind) folded before Flop
Seat 5: j7NIOHLZk7V2o9fOioO5ug (big blind) showed [Td 9h] and won ($21.40) with two pair, Tens and Nines
Seat 6: 4OO5v3AVduL0tePNx8wk5A folded before Flop (didn't bet)



PokerStars Game #59940365334:  Hold'em No Limit ($0.50/$1.00) - 2009/07/01 1:04:35 ET
Table 'JTT1XWaDZHSaMZQK7cR5uw' 2-max Seat #1 is the button
Seat 1: OLplZF6FEnLflv81Hz+Fxg ($129.75 in chips)
Seat 2: BcqgegiOUxmBD3F3umsljg ($79.55 in chips)
OLplZF6FEnLflv81Hz+Fxg: posts small blind $0.50
BcqgegiOUxmBD3F3umsljg: posts big blind $1
*** HOLE CARDS ***
OLplZF6FEnLflv81Hz+Fxg: folds
BcqgegiOUxmBD3F3umsljg collected $1 from pot
*** SUMMARY ***
Total pot $1 | Rake $0
Seat 1: OLplZF6FEnLflv81Hz+Fxg (button) (small blind) folded before Flop
Seat 2: BcqgegiOUxmBD3F3umsljg (big blind) collected ($1)



PokerStars Game #59940367630:  Hold'em No Limit ($0.50/$1.00) - 2009/07/01 1:04:38 ET
Table 'fTlPiCj0utgzC/5io+I7ew' 6-max Seat #2 is the button
Seat 1: YMJG+F++3Aj6P8dAWda5fw ($104.35 in chips)
Seat 2: Qy/UBNbD2HaA0Ogxg8Sf3w ($123.85 in chips)
Seat 3: wL5HjWHHOSGc53xWMNKB9Q ($26.10 in chips)
Seat 4: uJVSceLggtsrJya+WtmUEA ($158 in chips)
Seat 5: GC5g2ryXV7e4TTqmaxUofw ($53.20 in chips)
Seat 6: /P4w1pHg2zHYg/4ubJ0dPw ($69.05 in chips)
wL5HjWHHOSGc53xWMNKB9Q: posts small blind $0.50
uJVSceLggtsrJya+WtmUEA: posts big blind $1
*** HOLE CARDS ***
GC5g2ryXV7e4TTqmaxUofw: folds
/P4w1pHg2zHYg/4ubJ0dPw: folds
YMJG+F++3Aj6P8dAWda5fw: folds
Qy/UBNbD2HaA0Ogxg8Sf3w: folds
wL5HjWHHOSGc53xWMNKB9Q: calls $0.50
uJVSceLggtsrJya+WtmUEA: checks
*** FLOP *** [8c 3d 9h]
wL5HjWHHOSGc53xWMNKB9Q: checks
uJVSceLggtsrJya+WtmUEA: bets $2
wL5HjWHHOSGc53xWMNKB9Q: raises $23.10 to $25.10 and is all-in
uJVSceLggtsrJya+WtmUEA: calls $23.10
*** TURN *** [8c 3d 9h] [7s]
*** RIVER *** [8c 3d 9h 7s] [2h]
*** SHOW DOWN ***
wL5HjWHHOSGc53xWMNKB9Q: shows [As Ah] (a pair of Aces)
uJVSceLggtsrJya+WtmUEA: shows [3s 9c] (two pair, Nines and Threes)
uJVSceLggtsrJya+WtmUEA collected $49.60 from pot
*** SUMMARY ***
Total pot $52.20 | Rake $2.60
Board [8c 3d 9h 7s 2h]
Seat 1: YMJG+F++3Aj6P8dAWda5fw folded before Flop (didn't bet)
Seat 2: Qy/UBNbD2HaA0Ogxg8Sf3w (button) folded before Flop (didn't bet)
Seat 3: wL5HjWHHOSGc53xWMNKB9Q (small blind) showed [As Ah] and lost with a pair of Aces
Seat 4: uJVSceLggtsrJya+WtmUEA (big blind) showed [3s 9c] and won ($49.60) with two pair, Nines and Threes
Seat 5: GC5g2ryXV7e4TTqmaxUofw folded before Flop (didn't bet)
Seat 6: /P4w1pHg2zHYg/4ubJ0dPw folded before Flop (didn't bet)



PokerStars Game #59940368472:  Hold'em No Limit ($0.50/$1.00) - 2009/07/01 1:04:40 ET
Table '+cA8mcmhaedZ7YcrDdhmeQ' 6-max Seat #1 is the button
Seat 1: lsLuWlcPA3Rh7kJVLzMh0Q ($300.95 in chips)
Seat 2: RqgF7gRoKgRNW8Zoi1ty4A ($121.60 in chips)
Seat 3: 7H5WkGzGvsv56y1iaqHvRg ($22.20 in chips)
Seat 4: 4OO5v3AVduL0tePNx8wk5A ($100 in chips)
Seat 5: +7hFKAL0b0O/n8G72TclJA ($64.35 in chips)
Seat 6: YfsTQsY/fxb+YqbdclTHuw ($18.60 in chips)
RqgF7gRoKgRNW8Zoi1ty4A: posts small blind $0.50
7H5WkGzGvsv56y1iaqHvRg: posts big blind $1
*** HOLE CARDS ***
4OO5v3AVduL0tePNx8wk5A: raises $3 to $4
+7hFKAL0b0O/n8G72TclJA: raises $5 to $9
YfsTQsY/fxb+YqbdclTHuw: folds
lsLuWlcPA3Rh7kJVLzMh0Q: folds
RqgF7gRoKgRNW8Zoi1ty4A: folds
7H5WkGzGvsv56y1iaqHvRg: folds
4OO5v3AVduL0tePNx8wk5A: folds
+7hFKAL0b0O/n8G72TclJA collected $9.50 from pot
*** SUMMARY ***
Total pot $9.50 | Rake $0
Seat 1: lsLuWlcPA3Rh7kJVLzMh0Q (button) folded before Flop (didn't bet)
Seat 2: RqgF7gRoKgRNW8Zoi1ty4A (small blind) folded before Flop
Seat 3: 7H5WkGzGvsv56y1iaqHvRg (big blind) folded before Flop
Seat 4: 4OO5v3AVduL0tePNx8wk5A folded before Flop
Seat 5: +7hFKAL0b0O/n8G72TclJA collected ($9.50)
Seat 6: YfsTQsY/fxb+YqbdclTHuw folded before Flop (didn't bet)



PokerStars Game #59940369166:  Hold'em No Limit ($0.50/$1.00) - 2009/07/01 1:04:41 ET
Table 'JTT1XWaDZHSaMZQK7cR5uw' 2-max Seat #2 is the button
Seat 1: OLplZF6FEnLflv81Hz+Fxg ($129.25 in chips)
Seat 2: BcqgegiOUxmBD3F3umsljg ($80.05 in chips)
BcqgegiOUxmBD3F3umsljg: posts small blind $0.50
OLplZF6FEnLflv81Hz+Fxg: posts big blind $1
*** HOLE CARDS ***
BcqgegiOUxmBD3F3umsljg: raises $1 to $2
OLplZF6FEnLflv81Hz+Fxg: raises $5 to $7
BcqgegiOUxmBD3F3umsljg: folds
OLplZF6FEnLflv81Hz+Fxg collected $4 from pot
*** SUMMARY ***
Total pot $4 | Rake $0
Seat 1: OLplZF6FEnLflv81Hz+Fxg (big blind) collected ($4)
Seat 2: BcqgegiOUxmBD3F3umsljg (button) (small blind) folded before Flop



PokerStars Game #59940369584:  Hold'em No Limit ($0.50/$1.00) - 2009/07/01 1:04:42 ET
Table 'O96CPOtvMBWP6kzuYDfdFA' 6-max Seat #1 is the button
Seat 1: 6alLXQIITA2EZ/lBeym8Dw ($124.55 in chips)
Seat 3: V89DGjxE171oPREEbAXiyg ($87 in chips)
Seat 4: /P4w1pHg2zHYg/4ubJ0dPw ($60.90 in chips)
Seat 5: G5ZSSN6RSON3gkNvk/SmYg ($100 in chips)
Seat 6: GYei5jXGWexiJYbAT2fELg ($28.50 in chips)
V89DGjxE171oPREEbAXiyg: posts small blind $0.50
/P4w1pHg2zHYg/4ubJ0dPw: posts big blind $1
*** HOLE CARDS ***
G5ZSSN6RSON3gkNvk/SmYg: folds
GYei5jXGWexiJYbAT2fELg: folds
6alLXQIITA2EZ/lBeym8Dw: raises $2 to $3
V89DGjxE171oPREEbAXiyg: folds
/P4w1pHg2zHYg/4ubJ0dPw: folds
4d1rWhpu8DzLmzMbR3QKyA joins the table at seat #2
4d1rWhpu8DzLmzMbR3QKyA is sitting out
6alLXQIITA2EZ/lBeym8Dw collected $2.50 from pot
6alLXQIITA2EZ/lBeym8Dw: doesn't show hand
*** SUMMARY ***
Total pot $2.50 | Rake $0
Seat 1: 6alLXQIITA2EZ/lBeym8Dw (button) collected ($2.50)
Seat 3: V89DGjxE171oPREEbAXiyg (small blind) folded before Flop
Seat 4: /P4w1pHg2zHYg/4ubJ0dPw (big blind) folded before Flop
Seat 5: G5ZSSN6RSON3gkNvk/SmYg folded before Flop (didn't bet)
Seat 6: GYei5jXGWexiJYbAT2fELg folded before Flop (didn't bet)



PokerStars Game #59940372020:  Hold'em No Limit ($0.50/$1.00) - 2009/07/01 1:04:46 ET
Table 'Zka9tv1yilg0MvXWPQrShg' 9-max Seat #9 is the button
Seat 2: kz9ziSiGUc+857heiKSayw ($21.70 in chips)
Seat 3: gUUvmqdVlmvpal6B8nYrmg ($107.95 in chips)
Seat 4: stxmTgSicxShtrDxhOOX2g ($63.15 in chips)
Seat 5: /zy+DB4S5fUQUSfZWFzYGw ($115.60 in chips)
Seat 6: rY8wPoax1lS+HUY+I0FZDw ($160.60 in chips)
Seat 7: p1SafS90nb3Uft5LB0NkHw ($19 in chips)
Seat 8: D+W9Me7w6Hcx/WRUSKV0dw ($18.50 in chips)
Seat 9: 6daxhj43mWj04MOPTOmaYA ($106.40 in chips)
kz9ziSiGUc+857heiKSayw: posts small blind $0.50
gUUvmqdVlmvpal6B8nYrmg: posts big blind $1
*** HOLE CARDS ***
stxmTgSicxShtrDxhOOX2g has timed out
stxmTgSicxShtrDxhOOX2g: folds
stxmTgSicxShtrDxhOOX2g is sitting out
/zy+DB4S5fUQUSfZWFzYGw: raises $2 to $3
rY8wPoax1lS+HUY+I0FZDw: folds
p1SafS90nb3Uft5LB0NkHw: raises $6 to $9
D+W9Me7w6Hcx/WRUSKV0dw: folds
6daxhj43mWj04MOPTOmaYA: folds
kz9ziSiGUc+857heiKSayw: folds
gUUvmqdVlmvpal6B8nYrmg: folds
/zy+DB4S5fUQUSfZWFzYGw: folds
p1SafS90nb3Uft5LB0NkHw collected $7.50 from pot
*** SUMMARY ***
Total pot $7.50 | Rake $0
Seat 2: kz9ziSiGUc+857heiKSayw (small blind) folded before Flop
Seat 3: gUUvmqdVlmvpal6B8nYrmg (big blind) folded before Flop
Seat 4: stxmTgSicxShtrDxhOOX2g folded before Flop (didn't bet)
Seat 5: /zy+DB4S5fUQUSfZWFzYGw folded before Flop
Seat 6: rY8wPoax1lS+HUY+I0FZDw folded before Flop (didn't bet)
Seat 7: p1SafS90nb3Uft5LB0NkHw collected ($7.50)
Seat 8: D+W9Me7w6Hcx/WRUSKV0dw folded before Flop (didn't bet)
Seat 9: 6daxhj43mWj04MOPTOmaYA (button) folded before Flop (didn't bet)



PokerStars Game #59940372900:  Hold'em No Limit ($0.50/$1.00) - 2009/07/01 1:04:47 ET
Table '3T4owEKJKyGTMePwrv50FQ' 9-max Seat #9 is the button
Seat 1: OGgaARGdJQT4awWVNQ957w ($101.60 in chips)
Seat 2: t+Id2O6herCLgwnC4m49PA ($40.10 in chips)
Seat 3: DOLzOcBTZYcph5jEfKFWuQ ($107 in chips)
Seat 4: O5Go3jrzbQWxRB6ESK+Ptg ($39.60 in chips)
Seat 5: eI48VADSCFoNZBx4T9qs2w ($30.45 in chips)
Seat 6: laA8va+Yv8WuMqT1zdR91g ($100 in chips)
Seat 7: 1862487932 ($100 in chips)
Seat 9: 61sfw5QTu62YYIt68OsdrA ($58.30 in chips)
OGgaARGdJQT4awWVNQ957w: posts small blind $0.50
t+Id2O6herCLgwnC4m49PA: posts big blind $1
ucTB8uAUcQnKGsA70OSjNA: sits out
*** HOLE CARDS ***
DOLzOcBTZYcph5jEfKFWuQ: folds
O5Go3jrzbQWxRB6ESK+Ptg: folds
eI48VADSCFoNZBx4T9qs2w: raises $2 to $3
laA8va+Yv8WuMqT1zdR91g: folds
1862487932: folds
61sfw5QTu62YYIt68OsdrA: folds
OGgaARGdJQT4awWVNQ957w: folds
t+Id2O6herCLgwnC4m49PA: folds
eI48VADSCFoNZBx4T9qs2w collected $2.50 from pot
*** SUMMARY ***
Total pot $2.50 | Rake $0
Seat 1: OGgaARGdJQT4awWVNQ957w (small blind) folded before Flop
Seat 2: t+Id2O6herCLgwnC4m49PA (big blind) folded before Flop
Seat 3: DOLzOcBTZYcph5jEfKFWuQ folded before Flop (didn't bet)
Seat 4: O5Go3jrzbQWxRB6ESK+Ptg folded before Flop (didn't bet)
Seat 5: eI48VADSCFoNZBx4T9qs2w collected ($2.50)
Seat 6: laA8va+Yv8WuMqT1zdR91g folded before Flop (didn't bet)
Seat 7: 1862487932 folded before Flop (didn't bet)
Seat 9: 61sfw5QTu62YYIt68OsdrA (button) folded before Flop (didn't bet)



PokerStars Game #59940372718:  Hold'em No Limit ($0.50/$1.00) - 2009/07/01 1:04:47 ET
Table 'mmbQQVBTrPdE+wy+s+9VPA' 6-max Seat #5 is the button
Seat 1: zyP4SPoWZnKUfTvIRLCVog ($55.55 in chips)
Seat 2: cl/QpVR/PLO58lj+C5mGLw ($10.90 in chips)
Seat 3: wx3sQGkVi2x9wJXuWNHPBw ($111.65 in chips)
Seat 4: V3iZdcw61nXF3g5hD2RrsQ ($111.30 in chips)
Seat 5: YMJG+F++3Aj6P8dAWda5fw ($98 in chips)
Seat 6: U2CWBTv29qdCbj8RNF2sIw ($107.95 in chips)
U2CWBTv29qdCbj8RNF2sIw: posts small blind $0.50
zyP4SPoWZnKUfTvIRLCVog: posts big blind $1
*** HOLE CARDS ***
cl/QpVR/PLO58lj+C5mGLw: calls $1
wx3sQGkVi2x9wJXuWNHPBw: folds
V3iZdcw61nXF3g5hD2RrsQ: folds
YMJG+F++3Aj6P8dAWda5fw: folds
U2CWBTv29qdCbj8RNF2sIw: calls $0.50
zyP4SPoWZnKUfTvIRLCVog: checks
*** FLOP *** [6h 3h 9c]
U2CWBTv29qdCbj8RNF2sIw: bets $2
zyP4SPoWZnKUfTvIRLCVog: calls $2
cl/QpVR/PLO58lj+C5mGLw: folds
*** TURN *** [6h 3h 9c] [Kd]
U2CWBTv29qdCbj8RNF2sIw: bets $5
zyP4SPoWZnKUfTvIRLCVog: calls $5
*** RIVER *** [6h 3h 9c Kd] [Ts]
U2CWBTv29qdCbj8RNF2sIw: bets $12
zyP4SPoWZnKUfTvIRLCVog: calls $12
*** SHOW DOWN ***
U2CWBTv29qdCbj8RNF2sIw: shows [6c 5d] (a pair of Sixes)
zyP4SPoWZnKUfTvIRLCVog: shows [5s 9d] (a pair of Nines)
zyP4SPoWZnKUfTvIRLCVog collected $39 from pot
*** SUMMARY ***
Total pot $41 | Rake $2
Board [6h 3h 9c Kd Ts]
Seat 1: zyP4SPoWZnKUfTvIRLCVog (big blind) showed [5s 9d] and won ($39) with a pair of Nines
Seat 2: cl/QpVR/PLO58lj+C5mGLw folded on the Flop
Seat 3: wx3sQGkVi2x9wJXuWNHPBw folded before Flop (didn't bet)
Seat 4: V3iZdcw61nXF3g5hD2RrsQ folded before Flop (didn't bet)
Seat 5: YMJG+F++3Aj6P8dAWda5fw (button) folded before Flop (didn't bet)
Seat 6: U2CWBTv29qdCbj8RNF2sIw (small blind) showed [6c 5d] and lost with a pair of Sixes



PokerStars Game #59940374570:  Hold'em No Limit ($0.50/$1.00) - 2009/07/01 1:04:50 ET
Table 'GPp0HyAuggN8oE0sUWzPpA' 9-max Seat #1 is the button
Seat 1: qJr25HAtvv1w/7IBvjMM3g ($42.70 in chips)
Seat 2: m3U8I35Pn3gxKhoS2nmYIg ($40.55 in chips)
Seat 3: CCCXsirC+bO7ginAuUUVlQ ($52 in chips)
Seat 4: mBRWbnUl8diyBO1qTJaNzw ($107.30 in chips)
Seat 5: 0fXz44fzDo5QmhAaJCvFfA ($31.20 in chips)
Seat 6: BK/GtNPkSx0TdUDj82id5A ($17.85 in chips)
Seat 7: DHdbHyysD15wCAtx+BhUjA ($92.50 in chips)
Seat 8: 6DBvLniKMJADk/t5l29oMA ($25.15 in chips)
Seat 9: dzoSjPZmtjGuK83119030A ($30 in chips)
m3U8I35Pn3gxKhoS2nmYIg: posts small blind $0.50
CCCXsirC+bO7ginAuUUVlQ: posts big blind $1
dzoSjPZmtjGuK83119030A: posts big blind $1
*** HOLE CARDS ***
mBRWbnUl8diyBO1qTJaNzw: folds
0fXz44fzDo5QmhAaJCvFfA: folds
BK/GtNPkSx0TdUDj82id5A: folds
DHdbHyysD15wCAtx+BhUjA: raises $2 to $3
6DBvLniKMJADk/t5l29oMA: folds
dzoSjPZmtjGuK83119030A: folds
qJr25HAtvv1w/7IBvjMM3g: folds
m3U8I35Pn3gxKhoS2nmYIg: folds
CCCXsirC+bO7ginAuUUVlQ: folds
DHdbHyysD15wCAtx+BhUjA collected $3.50 from pot
*** SUMMARY ***
Total pot $3.50 | Rake $0
Seat 1: qJr25HAtvv1w/7IBvjMM3g (button) folded before Flop (didn't bet)
Seat 2: m3U8I35Pn3gxKhoS2nmYIg (small blind) folded before Flop
Seat 3: CCCXsirC+bO7ginAuUUVlQ (big blind) folded before Flop
Seat 4: mBRWbnUl8diyBO1qTJaNzw folded before Flop (didn't bet)
Seat 5: 0fXz44fzDo5QmhAaJCvFfA folded before Flop (didn't bet)
Seat 6: BK/GtNPkSx0TdUDj82id5A folded before Flop (didn't bet)
Seat 7: DHdbHyysD15wCAtx+BhUjA collected ($3.50)
Seat 8: 6DBvLniKMJADk/t5l29oMA folded before Flop (didn't bet)
Seat 9: dzoSjPZmtjGuK83119030A folded before Flop



PokerStars Game #59940375116:  Hold'em No Limit ($0.50/$1.00) - 2009/07/01 1:04:51 ET
Table 'tJq9SfN1ywY0r03VBlWlwQ' 9-max Seat #8 is the button
Seat 1: wZsU+w9r7G66x93UuvBf1Q ($340.80 in chips)
Seat 3: FVs16t7GgfWgQWt4JxsObQ ($31.90 in chips)
Seat 4: bLbSOSmSOnqE0iTcH/5dxA ($112.20 in chips)
Seat 5: h5ipsNTMyolp7xn/NAvWkA ($74 in chips)
Seat 6: gUUvmqdVlmvpal6B8nYrmg ($114.05 in chips)
Seat 8: G4DEhsZFmznGNVpy2SEocA ($29.90 in chips)
Seat 9: XE5QF1y74bpHog9JxWJMWQ ($101 in chips)
XE5QF1y74bpHog9JxWJMWQ: posts small blind $0.50
wZsU+w9r7G66x93UuvBf1Q: posts big blind $1
*** HOLE CARDS ***
FVs16t7GgfWgQWt4JxsObQ: calls $1
bLbSOSmSOnqE0iTcH/5dxA: folds
h5ipsNTMyolp7xn/NAvWkA: calls $1
gUUvmqdVlmvpal6B8nYrmg: raises $4 to $5
G4DEhsZFmznGNVpy2SEocA: folds
XE5QF1y74bpHog9JxWJMWQ: folds
wZsU+w9r7G66x93UuvBf1Q: folds
FVs16t7GgfWgQWt4JxsObQ: calls $4
h5ipsNTMyolp7xn/NAvWkA: folds
*** FLOP *** [Js 9s Ts]
FVs16t7GgfWgQWt4JxsObQ: checks
gUUvmqdVlmvpal6B8nYrmg: bets $6
FVs16t7GgfWgQWt4JxsObQ: calls $6
*** TURN *** [Js 9s Ts] [2c]
FVs16t7GgfWgQWt4JxsObQ: bets $2
gUUvmqdVlmvpal6B8nYrmg: raises $14 to $16
FVs16t7GgfWgQWt4JxsObQ: folds
gUUvmqdVlmvpal6B8nYrmg collected $27.15 from pot
*** SUMMARY ***
Total pot $28.50 | Rake $1.35
Board [Js 9s Ts 2c]
Seat 1: wZsU+w9r7G66x93UuvBf1Q (big blind) folded before Flop
Seat 3: FVs16t7GgfWgQWt4JxsObQ folded on the Turn
Seat 4: bLbSOSmSOnqE0iTcH/5dxA folded before Flop (didn't bet)
Seat 5: h5ipsNTMyolp7xn/NAvWkA folded before Flop
Seat 6: gUUvmqdVlmvpal6B8nYrmg collected ($27.15)
Seat 8: G4DEhsZFmznGNVpy2SEocA (button) folded before Flop (didn't bet)
Seat 9: XE5QF1y74bpHog9JxWJMWQ (small blind) folded before Flop



PokerStars Game #59940375778:  Hold'em No Limit ($0.50/$1.00) - 2009/07/01 1:04:52 ET
Table 'JTT1XWaDZHSaMZQK7cR5uw' 2-max Seat #1 is the button
Seat 1: OLplZF6FEnLflv81Hz+Fxg ($131.25 in chips)
Seat 2: BcqgegiOUxmBD3F3umsljg ($78.05 in chips)
OLplZF6FEnLflv81Hz+Fxg: posts small blind $0.50
BcqgegiOUxmBD3F3umsljg: posts big blind $1
*** HOLE CARDS ***
OLplZF6FEnLflv81Hz+Fxg: raises $2 to $3
BcqgegiOUxmBD3F3umsljg: folds
OLplZF6FEnLflv81Hz+Fxg collected $2 from pot
*** SUMMARY ***
Total pot $2 | Rake $0
Seat 1: OLplZF6FEnLflv81Hz+Fxg (button) (small blind) collected ($2)
Seat 2: BcqgegiOUxmBD3F3umsljg (big blind) folded before Flop



PokerStars Game #59940375546:  Hold'em No Limit ($0.50/$1.00) - 2009/07/01 1:04:52 ET
Table '7Nl0ffnjeK44/vmeexh3MQ' 9-max Seat #2 is the button
Seat 1: s7D3Y+k4Cj4D1cXHv7oj+Q ($93.85 in chips)
Seat 2: OGgaARGdJQT4awWVNQ957w ($100 in chips)
Seat 4: bLbSOSmSOnqE0iTcH/5dxA ($100 in chips)
Seat 5: 61sfw5QTu62YYIt68OsdrA ($60 in chips)
Seat 6: FVs16t7GgfWgQWt4JxsObQ ($53.15 in chips)
Seat 7: 997ViqAtWn1FPjJqcffwcA ($100 in chips)
Seat 8: D+W9Me7w6Hcx/WRUSKV0dw ($19.75 in chips)
Seat 9: ouwUBGRKnKK9uhn1G4Lf+A ($195.50 in chips)
JMmUYT5pIKCKh2pGjCB/4w will be allowed to play after the button
bLbSOSmSOnqE0iTcH/5dxA: posts small blind $0.50
61sfw5QTu62YYIt68OsdrA: posts big blind $1
*** HOLE CARDS ***
FVs16t7GgfWgQWt4JxsObQ: calls $1
997ViqAtWn1FPjJqcffwcA: folds
D+W9Me7w6Hcx/WRUSKV0dw: folds
ouwUBGRKnKK9uhn1G4Lf+A: folds
s7D3Y+k4Cj4D1cXHv7oj+Q: folds
OGgaARGdJQT4awWVNQ957w: folds
bLbSOSmSOnqE0iTcH/5dxA: folds
61sfw5QTu62YYIt68OsdrA: raises $2 to $3
FVs16t7GgfWgQWt4JxsObQ: calls $2
*** FLOP *** [9c 2d 5d]
61sfw5QTu62YYIt68OsdrA: bets $3
FVs16t7GgfWgQWt4JxsObQ: calls $3
*** TURN *** [9c 2d 5d] [3h]
61sfw5QTu62YYIt68OsdrA: bets $5
FVs16t7GgfWgQWt4JxsObQ: folds
61sfw5QTu62YYIt68OsdrA collected $11.90 from pot
61sfw5QTu62YYIt68OsdrA: doesn't show hand
*** SUMMARY ***
Total pot $12.50 | Rake $0.60
Board [9c 2d 5d 3h]
Seat 1: s7D3Y+k4Cj4D1cXHv7oj+Q folded before Flop (didn't bet)
Seat 2: OGgaARGdJQT4awWVNQ957w (button) folded before Flop (didn't bet)
Seat 4: bLbSOSmSOnqE0iTcH/5dxA (small blind) folded before Flop
Seat 5: 61sfw5QTu62YYIt68OsdrA (big blind) collected ($11.90)
Seat 6: FVs16t7GgfWgQWt4JxsObQ folded on the Turn
Seat 7: 997ViqAtWn1FPjJqcffwcA folded before Flop (didn't bet)
Seat 8: D+W9Me7w6Hcx/WRUSKV0dw folded before Flop (didn't bet)
Seat 9: ouwUBGRKnKK9uhn1G4Lf+A folded before Flop (didn't bet)



PokerStars Game #59940376324:  Hold'em No Limit ($0.50/$1.00) - 2009/07/01 1:04:53 ET
Table 'VOs36P6NW+QyXeQ1B62kmA' 6-max Seat #2 is the button
Seat 1: Z2fXsGcjl+Eax+RzOgwOmg ($100 in chips)
Seat 2: 2UMlbaZ8n8AbRli0Yr0mDw ($39 in chips)
Seat 3: TSuRyAHnUPCFjP7Z0rEE0w ($105.40 in chips)
Seat 4: w02zQzNydODiyV9THKgo9w ($44.20 in chips)
Seat 5: ozrlafxxh1HmYdA0/h+MuA ($46.10 in chips)
Seat 6: slVKuQyEz8Qj4E3uLPYNXg ($100 in chips)
TSuRyAHnUPCFjP7Z0rEE0w: posts small blind $0.50
w02zQzNydODiyV9THKgo9w: posts big blind $1
*** HOLE CARDS ***
ozrlafxxh1HmYdA0/h+MuA: calls $1
slVKuQyEz8Qj4E3uLPYNXg: folds
Z2fXsGcjl+Eax+RzOgwOmg: folds
2UMlbaZ8n8AbRli0Yr0mDw: folds
TSuRyAHnUPCFjP7Z0rEE0w: folds
w02zQzNydODiyV9THKgo9w: checks
*** FLOP *** [8h 9c 7h]
w02zQzNydODiyV9THKgo9w: checks
ozrlafxxh1HmYdA0/h+MuA: checks
*** TURN *** [8h 9c 7h] [7c]
w02zQzNydODiyV9THKgo9w: checks
ozrlafxxh1HmYdA0/h+MuA: bets $1
w02zQzNydODiyV9THKgo9w: calls $1
*** RIVER *** [8h 9c 7h 7c] [7s]
w02zQzNydODiyV9THKgo9w: checks
ozrlafxxh1HmYdA0/h+MuA: bets $3
w02zQzNydODiyV9THKgo9w: folds
ozrlafxxh1HmYdA0/h+MuA collected $4.30 from pot
*** SUMMARY ***
Total pot $4.50 | Rake $0.20
Board [8h 9c 7h 7c 7s]
Seat 1: Z2fXsGcjl+Eax+RzOgwOmg folded before Flop (didn't bet)
Seat 2: 2UMlbaZ8n8AbRli0Yr0mDw (button) folded before Flop (didn't bet)
Seat 3: TSuRyAHnUPCFjP7Z0rEE0w (small blind) folded before Flop
Seat 4: w02zQzNydODiyV9THKgo9w (big blind) folded on the River
Seat 5: ozrlafxxh1HmYdA0/h+MuA collected ($4.30)
Seat 6: slVKuQyEz8Qj4E3uLPYNXg folded before Flop (didn't bet)



PokerStars Game #59940379206:  Hold'em No Limit ($0.50/$1.00) - 2009/07/01 1:04:58 ET
Table 'rmZfTK+oSebeUPJNbWhdAA' 6-max Seat #4 is the button
Seat 1: xAU6q2/cwmby2sxmA8VcmA ($148.50 in chips)
Seat 2: z7O9PO/WEcqRouIydFhS9Q ($136.90 in chips)
Seat 3: BCEV3COoKY607AzLWayfRA ($132.50 in chips)
Seat 4: 1/mIuXfgx1ZyVkodrmfQDw ($102.70 in chips)
Seat 5: 5lY8d6Cnm4HUkt/8FZSj4g ($72.90 in chips)
Seat 6: j7NIOHLZk7V2o9fOioO5ug ($118.30 in chips)
5lY8d6Cnm4HUkt/8FZSj4g: posts small blind $0.50
j7NIOHLZk7V2o9fOioO5ug: posts big blind $1
*** HOLE CARDS ***
xAU6q2/cwmby2sxmA8VcmA: folds
z7O9PO/WEcqRouIydFhS9Q: folds
BCEV3COoKY607AzLWayfRA: folds
1/mIuXfgx1ZyVkodrmfQDw: folds
5lY8d6Cnm4HUkt/8FZSj4g: calls $0.50
j7NIOHLZk7V2o9fOioO5ug: raises $4 to $5
5lY8d6Cnm4HUkt/8FZSj4g: calls $4
*** FLOP *** [8h 3h 5h]
5lY8d6Cnm4HUkt/8FZSj4g: checks
j7NIOHLZk7V2o9fOioO5ug: checks
*** TURN *** [8h 3h 5h] [4c]
5lY8d6Cnm4HUkt/8FZSj4g: bets $23
j7NIOHLZk7V2o9fOioO5ug: folds
5lY8d6Cnm4HUkt/8FZSj4g collected $9.50 from pot
5lY8d6Cnm4HUkt/8FZSj4g: doesn't show hand
*** SUMMARY ***
Total pot $10 | Rake $0.50
Board [8h 3h 5h 4c]
Seat 1: xAU6q2/cwmby2sxmA8VcmA folded before Flop (didn't bet)
Seat 2: z7O9PO/WEcqRouIydFhS9Q folded before Flop (didn't bet)
Seat 3: BCEV3COoKY607AzLWayfRA folded before Flop (didn't bet)
Seat 4: 1/mIuXfgx1ZyVkodrmfQDw (button) folded before Flop (didn't bet)
Seat 5: 5lY8d6Cnm4HUkt/8FZSj4g (small blind) collected ($9.50)
Seat 6: j7NIOHLZk7V2o9fOioO5ug (big blind) folded on the Turn



PokerStars Game #59940379958:  Hold'em No Limit ($0.50/$1.00) - 2009/07/01 1:04:59 ET
Table 'pHrhryH8jPNdQfY62f8v+g' 6-max Seat #5 is the button
Seat 2: RqgF7gRoKgRNW8Zoi1ty4A ($139.30 in chips)
Seat 3: 8oS5O7iD/qnFXFXJrGIgNQ ($151.80 in chips)
Seat 5: r1/R7y0Ortgoz4lccgW8VA ($44.55 in chips)
Seat 6: xAU6q2/cwmby2sxmA8VcmA ($102.80 in chips)
xAU6q2/cwmby2sxmA8VcmA: posts small blind $0.50
OvwYHV65yUbgdBjSmo1+5g: is sitting out
OvwYHV65yUbgdBjSmo1+5g leaves the table
RqgF7gRoKgRNW8Zoi1ty4A: posts big blind $1
1f3beyIML24UqEMTbWy93g: sits out
*** HOLE CARDS ***
8oS5O7iD/qnFXFXJrGIgNQ: raises $2.50 to $3.50
r1/R7y0Ortgoz4lccgW8VA: calls $3.50
4d1rWhpu8DzLmzMbR3QKyA joins the table at seat #1
4d1rWhpu8DzLmzMbR3QKyA is sitting out
xAU6q2/cwmby2sxmA8VcmA: calls $3
RqgF7gRoKgRNW8Zoi1ty4A: folds
*** FLOP *** [Kd 5h Kc]
xAU6q2/cwmby2sxmA8VcmA: checks
8oS5O7iD/qnFXFXJrGIgNQ: bets $7
r1/R7y0Ortgoz4lccgW8VA: folds
xAU6q2/cwmby2sxmA8VcmA: raises $14 to $21
8oS5O7iD/qnFXFXJrGIgNQ: calls $14
*** TURN *** [Kd 5h Kc] [Jc]
xAU6q2/cwmby2sxmA8VcmA: bets $34
8oS5O7iD/qnFXFXJrGIgNQ: calls $34
*** RIVER *** [Kd 5h Kc Jc] [8c]
xAU6q2/cwmby2sxmA8VcmA: bets $44.30 and is all-in
8oS5O7iD/qnFXFXJrGIgNQ: calls $44.30
*** SHOW DOWN ***
xAU6q2/cwmby2sxmA8VcmA: shows [5s 5d] (a full house, Fives full of Kings)
8oS5O7iD/qnFXFXJrGIgNQ: mucks hand
xAU6q2/cwmby2sxmA8VcmA collected $208.10 from pot
*** SUMMARY ***
Total pot $210.10 | Rake $2
Board [Kd 5h Kc Jc 8c]
Seat 2: RqgF7gRoKgRNW8Zoi1ty4A (big blind) folded before Flop
Seat 3: 8oS5O7iD/qnFXFXJrGIgNQ mucked
Seat 5: r1/R7y0Ortgoz4lccgW8VA (button) folded on the Flop
Seat 6: xAU6q2/cwmby2sxmA8VcmA (small blind) showed [5s 5d] and won ($208.10) with a full house, Fives full of Kings



PokerStars Game #59940380484:  Hold'em No Limit ($0.50/$1.00) - 2009/07/01 1:05:00 ET
Table 'JTT1XWaDZHSaMZQK7cR5uw' 2-max Seat #2 is the button
Seat 1: OLplZF6FEnLflv81Hz+Fxg ($132.25 in chips)
Seat 2: BcqgegiOUxmBD3F3umsljg ($77.05 in chips)
BcqgegiOUxmBD3F3umsljg: posts small blind $0.50
OLplZF6FEnLflv81Hz+Fxg: posts big blind $1
*** HOLE CARDS ***
BcqgegiOUxmBD3F3umsljg: raises $2 to $3
OLplZF6FEnLflv81Hz+Fxg: folds
BcqgegiOUxmBD3F3umsljg collected $2 from pot
*** SUMMARY ***
Total pot $2 | Rake $0
Seat 1: OLplZF6FEnLflv81Hz+Fxg (big blind) folded before Flop
Seat 2: BcqgegiOUxmBD3F3umsljg (button) (small blind) collected ($2)



PokerStars Game #59940381000:  Hold'em No Limit ($0.50/$1.00) - 2009/07/01 1:05:01 ET
Table 'W/wyObTiXZm+Ckkl3YxcSw' 6-max Seat #4 is the button
Seat 1: eUBBn2R56C1IQ6Cs/vitwg ($188.25 in chips)
Seat 2: oDiBRCaF0QVtd3kO6xZIXw ($117.85 in chips)
Seat 3: dxyNCn/qxfkGDUIf28Cbng ($81.40 in chips)
Seat 4: aYii2DmxlOlbC1wbGRBWvQ ($101.70 in chips)
Seat 5: MFptnnT6AnJakWBooTkmeg ($25.25 in chips)
Seat 6: OGMLOcTNYZXZU81au7ztUw ($100 in chips)
MFptnnT6AnJakWBooTkmeg: posts small blind $0.50
OGMLOcTNYZXZU81au7ztUw: posts big blind $1
*** HOLE CARDS ***
eUBBn2R56C1IQ6Cs/vitwg: folds
oDiBRCaF0QVtd3kO6xZIXw: folds
dxyNCn/qxfkGDUIf28Cbng: folds
aYii2DmxlOlbC1wbGRBWvQ: folds
MFptnnT6AnJakWBooTkmeg: calls $0.50
OGMLOcTNYZXZU81au7ztUw: raises $2 to $3
MFptnnT6AnJakWBooTkmeg: folds
OGMLOcTNYZXZU81au7ztUw collected $2 from pot
OGMLOcTNYZXZU81au7ztUw: doesn't show hand
*** SUMMARY ***
Total pot $2 | Rake $0
Seat 1: eUBBn2R56C1IQ6Cs/vitwg folded before Flop (didn't bet)
Seat 2: oDiBRCaF0QVtd3kO6xZIXw folded before Flop (didn't bet)
Seat 3: dxyNCn/qxfkGDUIf28Cbng folded before Flop (didn't bet)
Seat 4: aYii2DmxlOlbC1wbGRBWvQ (button) folded before Flop (didn't bet)
Seat 5: MFptnnT6AnJakWBooTkmeg (small blind) folded before Flop
Seat 6: OGMLOcTNYZXZU81au7ztUw (big blind) collected ($2)



PokerStars Game #59940384630:  Hold'em No Limit ($0.50/$1.00) - 2009/07/01 1:05:07 ET
Table '+cA8mcmhaedZ7YcrDdhmeQ' 6-max Seat #2 is the button
Seat 1: lsLuWlcPA3Rh7kJVLzMh0Q ($300.95 in chips)
Seat 2: RqgF7gRoKgRNW8Zoi1ty4A ($121.10 in chips)
Seat 3: 7H5WkGzGvsv56y1iaqHvRg ($21.20 in chips)
Seat 4: 4OO5v3AVduL0tePNx8wk5A ($100 in chips)
Seat 5: +7hFKAL0b0O/n8G72TclJA ($69.85 in chips)
Seat 6: YfsTQsY/fxb+YqbdclTHuw ($18.60 in chips)
7H5WkGzGvsv56y1iaqHvRg: posts small blind $0.50
4OO5v3AVduL0tePNx8wk5A: posts big blind $1
*** HOLE CARDS ***
+7hFKAL0b0O/n8G72TclJA: folds
YfsTQsY/fxb+YqbdclTHuw: folds
lsLuWlcPA3Rh7kJVLzMh0Q: folds
RqgF7gRoKgRNW8Zoi1ty4A: folds
7H5WkGzGvsv56y1iaqHvRg: calls $0.50
4OO5v3AVduL0tePNx8wk5A: checks
*** FLOP *** [Tc Ac Ah]
7H5WkGzGvsv56y1iaqHvRg: checks
4OO5v3AVduL0tePNx8wk5A: checks
*** TURN *** [Tc Ac Ah] [6s]
7H5WkGzGvsv56y1iaqHvRg: checks
4OO5v3AVduL0tePNx8wk5A: bets $1.50
7H5WkGzGvsv56y1iaqHvRg: folds
4OO5v3AVduL0tePNx8wk5A collected $1.90 from pot
*** SUMMARY ***
Total pot $2 | Rake $0.10
Board [Tc Ac Ah 6s]
Seat 1: lsLuWlcPA3Rh7kJVLzMh0Q folded before Flop (didn't bet)
Seat 2: RqgF7gRoKgRNW8Zoi1ty4A (button) folded before Flop (didn't bet)
Seat 3: 7H5WkGzGvsv56y1iaqHvRg (small blind) folded on the Turn
Seat 4: 4OO5v3AVduL0tePNx8wk5A (big blind) collected ($1.90)
Seat 5: +7hFKAL0b0O/n8G72TclJA folded before Flop (didn't bet)
Seat 6: YfsTQsY/fxb+YqbdclTHuw folded before Flop (didn't bet)



PokerStars Game #59940384848:  Hold'em No Limit ($0.50/$1.00) - 2009/07/01 1:05:07 ET
Table 'QSIig7BLMc9wY/rgBechzw' 6-max Seat #6 is the button
Seat 1: Z2fXsGcjl+Eax+RzOgwOmg ($100 in chips)
Seat 2: mLOIkH/qmRa+mVujQIhBRg ($40.65 in chips)
Seat 4: +uSzP8Jwnw7sKfQ4s66b7w ($90.45 in chips)
Seat 6: PxqfkAMdAWtkgbT+q2gciA ($31.70 in chips)
Z2fXsGcjl+Eax+RzOgwOmg: posts small blind $0.50
mLOIkH/qmRa+mVujQIhBRg: posts big blind $1
+xW7QemQU0Fxs+4TnqBRow: sits out
*** HOLE CARDS ***
+uSzP8Jwnw7sKfQ4s66b7w: raises $2 to $3
PVmmeYpn4gqkqYUool6BOA leaves the table
PxqfkAMdAWtkgbT+q2gciA: calls $3
Z2fXsGcjl+Eax+RzOgwOmg: raises $12 to $15
mLOIkH/qmRa+mVujQIhBRg: folds
+uSzP8Jwnw7sKfQ4s66b7w: folds
PxqfkAMdAWtkgbT+q2gciA: folds
Z2fXsGcjl+Eax+RzOgwOmg collected $10 from pot
Z2fXsGcjl+Eax+RzOgwOmg: doesn't show hand
*** SUMMARY ***
Total pot $10 | Rake $0
Seat 1: Z2fXsGcjl+Eax+RzOgwOmg (small blind) collected ($10)
Seat 2: mLOIkH/qmRa+mVujQIhBRg (big blind) folded before Flop
Seat 4: +uSzP8Jwnw7sKfQ4s66b7w folded before Flop
Seat 6: PxqfkAMdAWtkgbT+q2gciA (button) folded before Flop



PokerStars Game #59940385510:  Hold'em No Limit ($0.50/$1.00) - 2009/07/01 1:05:08 ET
Table 'JTT1XWaDZHSaMZQK7cR5uw' 2-max Seat #1 is the button
Seat 1: OLplZF6FEnLflv81Hz+Fxg ($131.25 in chips)
Seat 2: BcqgegiOUxmBD3F3umsljg ($78.05 in chips)
OLplZF6FEnLflv81Hz+Fxg: posts small blind $0.50
BcqgegiOUxmBD3F3umsljg: posts big blind $1
*** HOLE CARDS ***
OLplZF6FEnLflv81Hz+Fxg: raises $2 to $3
BcqgegiOUxmBD3F3umsljg: calls $2
*** FLOP *** [Qd 4c Ah]
BcqgegiOUxmBD3F3umsljg: checks
OLplZF6FEnLflv81Hz+Fxg: checks
*** TURN *** [Qd 4c Ah] [Ks]
BcqgegiOUxmBD3F3umsljg: bets $4
OLplZF6FEnLflv81Hz+Fxg: folds
BcqgegiOUxmBD3F3umsljg collected $5.70 from pot
*** SUMMARY ***
Total pot $6 | Rake $0.30
Board [Qd 4c Ah Ks]
Seat 1: OLplZF6FEnLflv81Hz+Fxg (button) (small blind) folded on the Turn
Seat 2: BcqgegiOUxmBD3F3umsljg (big blind) collected ($5.70)



PokerStars Game #59940385094:  Hold'em No Limit ($0.50/$1.00) - 2009/07/01 1:05:08 ET
Table 'O96CPOtvMBWP6kzuYDfdFA' 6-max Seat #3 is the button
Seat 1: 6alLXQIITA2EZ/lBeym8Dw ($126.05 in chips)
Seat 3: V89DGjxE171oPREEbAXiyg ($86.50 in chips)
Seat 4: /P4w1pHg2zHYg/4ubJ0dPw ($60 in chips)
Seat 5: G5ZSSN6RSON3gkNvk/SmYg ($100 in chips)
Seat 6: GYei5jXGWexiJYbAT2fELg ($28.50 in chips)
/P4w1pHg2zHYg/4ubJ0dPw: posts small blind $0.50
G5ZSSN6RSON3gkNvk/SmYg: posts big blind $1
*** HOLE CARDS ***
GYei5jXGWexiJYbAT2fELg: calls $1
6alLXQIITA2EZ/lBeym8Dw: folds
V89DGjxE171oPREEbAXiyg: folds
/P4w1pHg2zHYg/4ubJ0dPw: raises $3 to $4
G5ZSSN6RSON3gkNvk/SmYg: folds
GYei5jXGWexiJYbAT2fELg: calls $3
*** FLOP *** [9d 9h 5c]
/P4w1pHg2zHYg/4ubJ0dPw: bets $5
GYei5jXGWexiJYbAT2fELg: folds
/P4w1pHg2zHYg/4ubJ0dPw collected $8.55 from pot
/P4w1pHg2zHYg/4ubJ0dPw: doesn't show hand
*** SUMMARY ***
Total pot $9 | Rake $0.45
Board [9d 9h 5c]
Seat 1: 6alLXQIITA2EZ/lBeym8Dw folded before Flop (didn't bet)
Seat 3: V89DGjxE171oPREEbAXiyg (button) folded before Flop (didn't bet)
Seat 4: /P4w1pHg2zHYg/4ubJ0dPw (small blind) collected ($8.55)
Seat 5: G5ZSSN6RSON3gkNvk/SmYg (big blind) folded before Flop
Seat 6: GYei5jXGWexiJYbAT2fELg folded on the Flop



PokerStars Game #59940385848:  Hold'em No Limit ($0.50/$1.00) - 2009/07/01 1:05:09 ET
Table '6YvsYDPNIDx2v5z3bJnwZQ' 9-max Seat #8 is the button
Seat 1: Ogn4JDV3mp4ZDKO49IFzKA ($16.70 in chips)
Seat 2: +hHqYgKILitkxIzFNGvvsA ($34.25 in chips)
Seat 3: negfosHnGOZXSHpWDRKyBQ ($16.50 in chips)
Seat 4: kEr5NYB+JIG5+szcYMr6hA ($46.80 in chips)
Seat 5: mBRWbnUl8diyBO1qTJaNzw ($162.20 in chips)
Seat 6: 7RSwrjMohkYrZAhOd1uaZg ($16.20 in chips)
Seat 7: mae7OMTaJ/MFimNbZegCkg ($48.30 in chips)
Seat 8: PSFxpXgPedVZyHSu2Zhb7Q ($114.20 in chips)
VPF+HjszMvUIpy0CHIwH3A joins the table at seat #9
Ogn4JDV3mp4ZDKO49IFzKA: posts small blind $0.50
+hHqYgKILitkxIzFNGvvsA: posts big blind $1
*** HOLE CARDS ***
negfosHnGOZXSHpWDRKyBQ: folds
kEr5NYB+JIG5+szcYMr6hA: calls $1
mBRWbnUl8diyBO1qTJaNzw: folds
7RSwrjMohkYrZAhOd1uaZg: folds
mae7OMTaJ/MFimNbZegCkg: folds
PSFxpXgPedVZyHSu2Zhb7Q: folds
Ogn4JDV3mp4ZDKO49IFzKA: raises $15.70 to $16.70 and is all-in
+hHqYgKILitkxIzFNGvvsA: folds
kEr5NYB+JIG5+szcYMr6hA: folds
Ogn4JDV3mp4ZDKO49IFzKA collected $3 from pot
*** SUMMARY ***
Total pot $3 | Rake $0
Seat 1: Ogn4JDV3mp4ZDKO49IFzKA (small blind) collected ($3)
Seat 2: +hHqYgKILitkxIzFNGvvsA (big blind) folded before Flop
Seat 3: negfosHnGOZXSHpWDRKyBQ folded before Flop (didn't bet)
Seat 4: kEr5NYB+JIG5+szcYMr6hA folded before Flop
Seat 5: mBRWbnUl8diyBO1qTJaNzw folded before Flop (didn't bet)
Seat 6: 7RSwrjMohkYrZAhOd1uaZg folded before Flop (didn't bet)
Seat 7: mae7OMTaJ/MFimNbZegCkg folded before Flop (didn't bet)
Seat 8: PSFxpXgPedVZyHSu2Zhb7Q (button) folded before Flop (didn't bet)



PokerStars Game #59940386502:  Hold'em No Limit ($0.50/$1.00) - 2009/07/01 1:05:10 ET
Table 'eU3bWpDDg3Z+9R4m4iVmog' 6-max Seat #1 is the button
Seat 1: TSuRyAHnUPCFjP7Z0rEE0w ($177.15 in chips)
Seat 2: 8CAoOzhmB8n3nRFf3V4BTg ($70.90 in chips)
Seat 3: rVMOzU7w5FddYPGhD7qN2Q ($40.15 in chips)
Seat 4: GDVIsbEJ/DOJsMKE4Asz0A ($118.20 in chips)
Seat 6: hpxXcmRkXXI9HE5+5/j/0Q ($117.75 in chips)
8CAoOzhmB8n3nRFf3V4BTg: posts small blind $0.50
rVMOzU7w5FddYPGhD7qN2Q: posts big blind $1
*** HOLE CARDS ***
GDVIsbEJ/DOJsMKE4Asz0A: folds
hpxXcmRkXXI9HE5+5/j/0Q: folds
TSuRyAHnUPCFjP7Z0rEE0w: folds
8CAoOzhmB8n3nRFf3V4BTg: calls $0.50
rVMOzU7w5FddYPGhD7qN2Q: checks
*** FLOP *** [8h 8d 3s]
8CAoOzhmB8n3nRFf3V4BTg: checks
rVMOzU7w5FddYPGhD7qN2Q: checks
*** TURN *** [8h 8d 3s] [7d]
8CAoOzhmB8n3nRFf3V4BTg: checks
rVMOzU7w5FddYPGhD7qN2Q: checks
*** RIVER *** [8h 8d 3s 7d] [2s]
8CAoOzhmB8n3nRFf3V4BTg: checks
rVMOzU7w5FddYPGhD7qN2Q: checks
*** SHOW DOWN ***
8CAoOzhmB8n3nRFf3V4BTg: shows [4h Th] (a pair of Eights)
rVMOzU7w5FddYPGhD7qN2Q: shows [Qh 5d] (a pair of Eights - Queen kicker)
rVMOzU7w5FddYPGhD7qN2Q collected $1.90 from pot
*** SUMMARY ***
Total pot $2 | Rake $0.10
Board [8h 8d 3s 7d 2s]
Seat 1: TSuRyAHnUPCFjP7Z0rEE0w (button) folded before Flop (didn't bet)
Seat 2: 8CAoOzhmB8n3nRFf3V4BTg (small blind) showed [4h Th] and lost with a pair of Eights
Seat 3: rVMOzU7w5FddYPGhD7qN2Q (big blind) showed [Qh 5d] and won ($1.90) with a pair of Eights
Seat 4: GDVIsbEJ/DOJsMKE4Asz0A folded before Flop (didn't bet)
Seat 6: hpxXcmRkXXI9HE5+5/j/0Q folded before Flop (didn't bet)



PokerStars Game #59940386668:  Hold'em No Limit ($0.50/$1.00) - 2009/07/01 1:05:10 ET
Table 'tyUh+jyNvrceIQdKMJjQ2wZFWj23PMihdwrNWv41OG/Qeat #4 is the button
Seat 1: o8A5MUdudVKu+pAwgZOX2w ($106.90 in chips)
Seat 2: XvUbOIg94d25feWeQlOTVg ($147 in chips)
Seat 3: TalCiLYHCd+ffkmR3auPvA ($83.60 in chips)
Seat 4: TSuRyAHnUPCFjP7Z0rEE0w ($181.50 in chips)
Seat 5: j7NIOHLZk7V2o9fOioO5ug ($122.05 in chips)
Seat 6: 4OO5v3AVduL0tePNx8wk5A ($100 in chips)
j7NIOHLZk7V2o9fOioO5ug: posts small blind $0.50
4OO5v3AVduL0tePNx8wk5A: posts big blind $1
*** HOLE CARDS ***
o8A5MUdudVKu+pAwgZOX2w: calls $1
XvUbOIg94d25feWeQlOTVg has timed out
XvUbOIg94d25feWeQlOTVg: folds
XvUbOIg94d25feWeQlOTVg is sitting out
TalCiLYHCd+ffkmR3auPvA: folds
TSuRyAHnUPCFjP7Z0rEE0w: folds
j7NIOHLZk7V2o9fOioO5ug: folds
4OO5v3AVduL0tePNx8wk5A: checks
*** FLOP *** [As Jd Th]
4OO5v3AVduL0tePNx8wk5A: checks
o8A5MUdudVKu+pAwgZOX2w: bets $5
XvUbOIg94d25feWeQlOTVg leaves the table
4OO5v3AVduL0tePNx8wk5A: folds
o8A5MUdudVKu+pAwgZOX2w collected $2.40 from pot
o8A5MUdudVKu+pAwgZOX2w: doesn't show hand
*** SUMMARY ***
Total pot $2.50 | Rake $0.10
Board [As Jd Th]
Seat 1: o8A5MUdudVKu+pAwgZOX2w collected ($2.40)
Seat 2: XvUbOIg94d25feWeQlOTVg folded before Flop (didn't bet)
Seat 3: TalCiLYHCd+ffkmR3auPvA folded before Flop (didn't bet)
Seat 4: TSuRyAHnUPCFjP7Z0rEE0w (button) folded before Flop (didn't bet)
Seat 5: j7NIOHLZk7V2o9fOioO5ug (small blind) folded before Flop
Seat 6: 4OO5v3AVduL0tePNx8wk5A (big blind) folded on the Flop



PokerStars Game #59940387292:  Hold'em No Limit ($0.50/$1.00) - 2009/07/01 1:05:11 ET
Table 'MUPc8FEpe/nR0BKSeReX6Q' 6-max Seat #1 is the button
Seat 1: qhkK6+yCciTRd+rCFEbnEQ ($41.70 in chips)
Seat 2: xAU6q2/cwmby2sxmA8VcmA ($121.70 in chips)
Seat 3: wx3sQGkVi2x9wJXuWNHPBw ($235.95 in chips)
Seat 4: ZA1bp6g8IwtTxkUE4eCjDQ ($196.65 in chips)
Seat 5: UBZQqpnJZdTYYY1FTb0rLA ($100 in chips)
Seat 6: oxnw0GLLpFanjhGkxfRSqA ($23.20 in chips)
xAU6q2/cwmby2sxmA8VcmA: posts small blind $0.50
wx3sQGkVi2x9wJXuWNHPBw: posts big blind $1
*** HOLE CARDS ***
ZA1bp6g8IwtTxkUE4eCjDQ: folds
UBZQqpnJZdTYYY1FTb0rLA: folds
oxnw0GLLpFanjhGkxfRSqA: folds
qhkK6+yCciTRd+rCFEbnEQ: folds
xAU6q2/cwmby2sxmA8VcmA: folds
wx3sQGkVi2x9wJXuWNHPBw collected $1 from pot
*** SUMMARY ***
Total pot $1 | Rake $0
Seat 1: qhkK6+yCciTRd+rCFEbnEQ (button) folded before Flop (didn't bet)
Seat 2: xAU6q2/cwmby2sxmA8VcmA (small blind) folded before Flop
Seat 3: wx3sQGkVi2x9wJXuWNHPBw (big blind) collected ($1)
Seat 4: ZA1bp6g8IwtTxkUE4eCjDQ folded before Flop (didn't bet)
Seat 5: UBZQqpnJZdTYYY1FTb0rLA folded before Flop (didn't bet)
Seat 6: oxnw0GLLpFanjhGkxfRSqA folded before Flop (didn't bet)



PokerStars Game #59940388722:  Hold'em No Limit ($0.50/$1.00) - 2009/07/01 1:05:14 ET
Table 'hugOjcwJvzEwZbK7tyiWuQ' 9-max Seat #3 is the button
Seat 2: r27C1nIV4NS4+qbnrgBQSw ($283.20 in chips)
Seat 3: jDwhY1kCdc6EkAHbT7PJMQ ($104.75 in chips)
Seat 4: UWB3oeddt/GObx2Mix2Anw ($173.80 in chips)
Seat 5: 5BRGWf+R3nt2WS3b5xX+zA ($16.75 in chips)
Seat 6: gUUvmqdVlmvpal6B8nYrmg ($107.40 in chips)
Seat 7: FL3MrLspcF23LYvC4ipBOA ($110.30 in chips)
Seat 8: /zy+DB4S5fUQUSfZWFzYGw ($100 in chips)
Seat 9: W8P9bUKCs43TO1xHm0dL6w ($89.45 in chips)
UWB3oeddt/GObx2Mix2Anw: posts small blind $0.50
5BRGWf+R3nt2WS3b5xX+zA: posts big blind $1
*** HOLE CARDS ***
gUUvmqdVlmvpal6B8nYrmg: folds
FL3MrLspcF23LYvC4ipBOA: folds
/zy+DB4S5fUQUSfZWFzYGw: folds
W8P9bUKCs43TO1xHm0dL6w: folds
r27C1nIV4NS4+qbnrgBQSw: folds
jDwhY1kCdc6EkAHbT7PJMQ: folds
UWB3oeddt/GObx2Mix2Anw: folds
5BRGWf+R3nt2WS3b5xX+zA collected $1 from pot
*** SUMMARY ***
Total pot $1 | Rake $0
Seat 2: r27C1nIV4NS4+qbnrgBQSw folded before Flop (didn't bet)
Seat 3: jDwhY1kCdc6EkAHbT7PJMQ (button) folded before Flop (didn't bet)
Seat 4: UWB3oeddt/GObx2Mix2Anw (small blind) folded before Flop
Seat 5: 5BRGWf+R3nt2WS3b5xX+zA (big blind) collected ($1)
Seat 6: gUUvmqdVlmvpal6B8nYrmg folded before Flop (didn't bet)
Seat 7: FL3MrLspcF23LYvC4ipBOA folded before Flop (didn't bet)
Seat 8: /zy+DB4S5fUQUSfZWFzYGw folded before Flop (didn't bet)
Seat 9: W8P9bUKCs43TO1xHm0dL6w folded before Flop (didn't bet)



PokerStars Game #59940390374:  Hold'em No Limit ($0.50/$1.00) - 2009/07/01 1:05:17 ET
Table '7O9fB8yx1u7sJveJn8w6jA' 6-max Seat #2 is the button
Seat 2: wx3sQGkVi2x9wJXuWNHPBw ($194.95 in chips)
Seat 3: hpxXcmRkXXI9HE5+5/j/0Q ($104.70 in chips)
Seat 4: XIZSmlGttGgSRaIU42K4Fg ($139.90 in chips)
Seat 5: BCEV3COoKY607AzLWayfRA ($107.80 in chips)
Seat 6: UBZQqpnJZdTYYY1FTb0rLA ($133.45 in chips)
hpxXcmRkXXI9HE5+5/j/0Q: posts small blind $0.50
XIZSmlGttGgSRaIU42K4Fg: posts big blind $1
*** HOLE CARDS ***
BCEV3COoKY607AzLWayfRA: folds
UBZQqpnJZdTYYY1FTb0rLA: folds
wx3sQGkVi2x9wJXuWNHPBw: raises $2 to $3
hpxXcmRkXXI9HE5+5/j/0Q: folds
XIZSmlGttGgSRaIU42K4Fg: calls $2
*** FLOP *** [4s Kh 3c]
XIZSmlGttGgSRaIU42K4Fg: checks
wx3sQGkVi2x9wJXuWNHPBw: checks
*** TURN *** [4s Kh 3c] [8h]
XIZSmlGttGgSRaIU42K4Fg: checks
wx3sQGkVi2x9wJXuWNHPBw: bets $4
XIZSmlGttGgSRaIU42K4Fg: calls $4
*** RIVER *** [4s Kh 3c 8h] [6d]
XIZSmlGttGgSRaIU42K4Fg: bets $12
wx3sQGkVi2x9wJXuWNHPBw: folds
XIZSmlGttGgSRaIU42K4Fg collected $13.80 from pot
*** SUMMARY ***
Total pot $14.50 | Rake $0.70
Board [4s Kh 3c 8h 6d]
Seat 2: wx3sQGkVi2x9wJXuWNHPBw (button) folded on the River
Seat 3: hpxXcmRkXXI9HE5+5/j/0Q (small blind) folded before Flop
Seat 4: XIZSmlGttGgSRaIU42K4Fg (big blind) collected ($13.80)
Seat 5: BCEV3COoKY607AzLWayfRA folded before Flop (didn't bet)
Seat 6: UBZQqpnJZdTYYY1FTb0rLA folded before Flop (didn't bet)



PokerStars Game #59940390858:  Hold'em No Limit ($0.50/$1.00) - 2009/07/01 1:05:18 ET
Table 'hdVBCnDy5t2X9dZo0AvD9w' 9-max Seat #2 is the button
Seat 1: sa/cZBFh73L9TapFXpn3BA ($50.35 in chips)
Seat 2: Ogn4JDV3mp4ZDKO49IFzKA ($18.50 in chips)
Seat 3: 1862487932 ($100 in chips)
Seat 4: YvSugbFKWSuAYx9iokQwUQ ($73.50 in chips)
Seat 6: bJckevFOcg//s0qyMQI6sQ ($101.50 in chips)
Seat 7: KqC3XiX79XzqwhoOYPVb4w ($168.55 in chips)
Seat 8: gUUvmqdVlmvpal6B8nYrmg ($147.90 in chips)
Seat 9: AMkLbywdoc0K30BTzaIfTQ ($190.90 in chips)
1862487932: posts small blind $0.50
YvSugbFKWSuAYx9iokQwUQ: posts big blind $1
H+DVy3Ei8L1UKS2tVOtJcw: sits out
*** HOLE CARDS ***
bJckevFOcg//s0qyMQI6sQ: folds
KqC3XiX79XzqwhoOYPVb4w: folds
gUUvmqdVlmvpal6B8nYrmg: raises $2 to $3
AMkLbywdoc0K30BTzaIfTQ: calls $3
sa/cZBFh73L9TapFXpn3BA: calls $3
Ogn4JDV3mp4ZDKO49IFzKA: folds
1862487932: folds
YvSugbFKWSuAYx9iokQwUQ: calls $2
*** FLOP *** [6s 6h 7c]
YvSugbFKWSuAYx9iokQwUQ: checks
gUUvmqdVlmvpal6B8nYrmg: checks
AMkLbywdoc0K30BTzaIfTQ: checks
sa/cZBFh73L9TapFXpn3BA: bets $5
YvSugbFKWSuAYx9iokQwUQ: folds
gUUvmqdVlmvpal6B8nYrmg: folds
AMkLbywdoc0K30BTzaIfTQ: folds
sa/cZBFh73L9TapFXpn3BA collected $11.90 from pot
*** SUMMARY ***
Total pot $12.50 | Rake $0.60
Board [6s 6h 7c]
Seat 1: sa/cZBFh73L9TapFXpn3BA collected ($11.90)
Seat 2: Ogn4JDV3mp4ZDKO49IFzKA (button) folded before Flop (didn't bet)
Seat 3: 1862487932 (small blind) folded before Flop
Seat 4: YvSugbFKWSuAYx9iokQwUQ (big blind) folded on the Flop
Seat 6: bJckevFOcg//s0qyMQI6sQ folded before Flop (didn't bet)
Seat 7: KqC3XiX79XzqwhoOYPVb4w folded before Flop (didn't bet)
Seat 8: gUUvmqdVlmvpal6B8nYrmg folded on the Flop
Seat 9: AMkLbywdoc0K30BTzaIfTQ folded on the Flop



PokerStars Game #59940391456:  Hold'em No Limit ($0.50/$1.00) - 2009/07/01 1:05:19 ET
Table 'cKH9c4x6u79IqCdaKKvXrw' 9-max Seat #9 is the button
Seat 1: Pp/KTcXkfZKKUHkjyaLTdg ($19 in chips)
Seat 2: 8S3JMH4TY3whgIlZmMv66w ($74.20 in chips)
Seat 3: 997ViqAtWn1FPjJqcffwcA ($157.10 in chips)
Seat 4: FL3MrLspcF23LYvC4ipBOA ($100 in chips)
Seat 5: Jjc7EHWzs4//xUAjJ0UWoA ($40.65 in chips)
Seat 6: Bsd/K5gAcLanYbGiPirRjw ($202.55 in chips)
Seat 7: 1GkkVBhlJ92guE6K5mS5Ig ($17.75 in chips)
Seat 8: myIxN7otsyr846M539YR8Q ($17 in chips)
Seat 9: 6XkTu4ahxzHnvjjc1R8YjQ ($41.60 in chips)
Pp/KTcXkfZKKUHkjyaLTdg: posts small blind $0.50
8S3JMH4TY3whgIlZmMv66w: posts big blind $1
*** HOLE CARDS ***
997ViqAtWn1FPjJqcffwcA: folds
FL3MrLspcF23LYvC4ipBOA: folds
Jjc7EHWzs4//xUAjJ0UWoA: folds
Bsd/K5gAcLanYbGiPirRjw: folds
1GkkVBhlJ92guE6K5mS5Ig: folds
myIxN7otsyr846M539YR8Q: folds
6XkTu4ahxzHnvjjc1R8YjQ: folds
Pp/KTcXkfZKKUHkjyaLTdg: folds
8S3JMH4TY3whgIlZmMv66w collected $1 from pot
*** SUMMARY ***
Total pot $1 | Rake $0
Seat 1: Pp/KTcXkfZKKUHkjyaLTdg (small blind) folded before Flop
Seat 2: 8S3JMH4TY3whgIlZmMv66w (big blind) collected ($1)
Seat 3: 997ViqAtWn1FPjJqcffwcA folded before Flop (didn't bet)
Seat 4: FL3MrLspcF23LYvC4ipBOA folded before Flop (didn't bet)
Seat 5: Jjc7EHWzs4//xUAjJ0UWoA folded before Flop (didn't bet)
Seat 6: Bsd/K5gAcLanYbGiPirRjw folded before Flop (didn't bet)
Seat 7: 1GkkVBhlJ92guE6K5mS5Ig folded before Flop (didn't bet)
Seat 8: myIxN7otsyr846M539YR8Q folded before Flop (didn't bet)
Seat 9: 6XkTu4ahxzHnvjjc1R8YjQ (button) folded before Flop (didn't bet)



PokerStars Game #59940392566:  Hold'em No Limit ($0.50/$1.00) - 2009/07/01 1:05:21 ET
Table '3T4owEKJKyGTMePwrv50FQ' 9-max Seat #1 is the button
Seat 1: OGgaARGdJQT4awWVNQ957w ($101.10 in chips)
Seat 2: t+Id2O6herCLgwnC4m49PA ($39.10 in chips)
Seat 3: DOLzOcBTZYcph5jEfKFWuQ ($107 in chips)
Seat 4: O5Go3jrzbQWxRB6ESK+Ptg ($39.60 in chips)
Seat 5: eI48VADSCFoNZBx4T9qs2w ($31.95 in chips)
Seat 6: laA8va+Yv8WuMqT1zdR91g ($100 in chips)
Seat 7: 1862487932 ($100 in chips)
Seat 9: 61sfw5QTu62YYIt68OsdrA ($58.30 in chips)
t+Id2O6herCLgwnC4m49PA: posts small blind $0.50
DOLzOcBTZYcph5jEfKFWuQ: posts big blind $1
ucTB8uAUcQnKGsA70OSjNA: sits out
*** HOLE CARDS ***
O5Go3jrzbQWxRB6ESK+Ptg: calls $1
eI48VADSCFoNZBx4T9qs2w: folds
laA8va+Yv8WuMqT1zdR91g: folds
1862487932: folds
61sfw5QTu62YYIt68OsdrA: raises $2 to $3
OGgaARGdJQT4awWVNQ957w: folds
t+Id2O6herCLgwnC4m49PA: folds
DOLzOcBTZYcph5jEfKFWuQ: folds
O5Go3jrzbQWxRB6ESK+Ptg: calls $2
*** FLOP *** [4d 9d 4s]
O5Go3jrzbQWxRB6ESK+Ptg: checks
61sfw5QTu62YYIt68OsdrA: checks
*** TURN *** [4d 9d 4s] [5c]
O5Go3jrzbQWxRB6ESK+Ptg: checks
61sfw5QTu62YYIt68OsdrA: checks
*** RIVER *** [4d 9d 4s 5c] [Jc]
O5Go3jrzbQWxRB6ESK+Ptg: bets $5
61sfw5QTu62YYIt68OsdrA: calls $5
*** SHOW DOWN ***
O5Go3jrzbQWxRB6ESK+Ptg: shows [Jd Kc] (two pair, Jacks and Fours)
61sfw5QTu62YYIt68OsdrA: shows [Jh As] (two pair, Jacks and Fours - Ace kicker)
61sfw5QTu62YYIt68OsdrA collected $16.65 from pot
*** SUMMARY ***
Total pot $17.50 | Rake $0.85
Board [4d 9d 4s 5c Jc]
Seat 1: OGgaARGdJQT4awWVNQ957w (button) folded before Flop (didn't bet)
Seat 2: t+Id2O6herCLgwnC4m49PA (small blind) folded before Flop
Seat 3: DOLzOcBTZYcph5jEfKFWuQ (big blind) folded before Flop
Seat 4: O5Go3jrzbQWxRB6ESK+Ptg showed [Jd Kc] and lost with two pair, Jacks and Fours
Seat 5: eI48VADSCFoNZBx4T9qs2w folded before Flop (didn't bet)
Seat 6: laA8va+Yv8WuMqT1zdR91g folded before Flop (didn't bet)
Seat 7: 1862487932 folded before Flop (didn't bet)
Seat 9: 61sfw5QTu62YYIt68OsdrA showed [Jh As] and won ($16.65) with two pair, Jacks and Fours



PokerStars Game #59940395050:  Hold'em No Limit ($0.50/$1.00) - 2009/07/01 1:05:25 ET
Table 'GPp0HyAuggN8oE0sUWzPpA' 9-max Seat #2 is the button
Seat 1: qJr25HAtvv1w/7IBvjMM3g ($42.70 in chips)
Seat 2: m3U8I35Pn3gxKhoS2nmYIg ($40.05 in chips)
Seat 3: CCCXsirC+bO7ginAuUUVlQ ($51 in chips)
Seat 4: mBRWbnUl8diyBO1qTJaNzw ($107.30 in chips)
Seat 5: 0fXz44fzDo5QmhAaJCvFfA ($31.20 in chips)
Seat 6: BK/GtNPkSx0TdUDj82id5A ($17.85 in chips)
Seat 7: DHdbHyysD15wCAtx+BhUjA ($95 in chips)
Seat 8: 6DBvLniKMJADk/t5l29oMA ($25.15 in chips)
Seat 9: dzoSjPZmtjGuK83119030A ($29 in chips)
CCCXsirC+bO7ginAuUUVlQ: posts small blind $0.50
mBRWbnUl8diyBO1qTJaNzw: posts big blind $1
*** HOLE CARDS ***
0fXz44fzDo5QmhAaJCvFfA: folds
BK/GtNPkSx0TdUDj82id5A: folds
DHdbHyysD15wCAtx+BhUjA: folds
6DBvLniKMJADk/t5l29oMA: folds
dzoSjPZmtjGuK83119030A: folds
qJr25HAtvv1w/7IBvjMM3g: folds
m3U8I35Pn3gxKhoS2nmYIg: folds
CCCXsirC+bO7ginAuUUVlQ: calls $0.50
mBRWbnUl8diyBO1qTJaNzw: checks
*** FLOP *** [8s 6c 9d]
CCCXsirC+bO7ginAuUUVlQ: bets $1
mBRWbnUl8diyBO1qTJaNzw: raises $4 to $5
CCCXsirC+bO7ginAuUUVlQ: folds
mBRWbnUl8diyBO1qTJaNzw collected $3.85 from pot
*** SUMMARY ***
Total pot $4 | Rake $0.15
Board [8s 6c 9d]
Seat 1: qJr25HAtvv1w/7IBvjMM3g folded before Flop (didn't bet)
Seat 2: m3U8I35Pn3gxKhoS2nmYIg (button) folded before Flop (didn't bet)
Seat 3: CCCXsirC+bO7ginAuUUVlQ (small blind) folded on the Flop
Seat 4: mBRWbnUl8diyBO1qTJaNzw (big blind) collected ($3.85)
Seat 5: 0fXz44fzDo5QmhAaJCvFfA folded before Flop (didn't bet)
Seat 6: BK/GtNPkSx0TdUDj82id5A folded before Flop (didn't bet)
Seat 7: DHdbHyysD15wCAtx+BhUjA folded before Flop (didn't bet)
Seat 8: 6DBvLniKMJADk/t5l29oMA folded before Flop (didn't bet)
Seat 9: dzoSjPZmtjGuK83119030A folded before Flop (didn't bet)



PokerStars Game #59940395328:  Hold'em No Limit ($0.50/$1.00) - 2009/07/01 1:05:25 ET
Table 'W/wyObTiXZm+Ckkl3YxcSw' 6-max Seat #5 is the button
Seat 1: eUBBn2R56C1IQ6Cs/vitwg ($188.25 in chips)
Seat 2: oDiBRCaF0QVtd3kO6xZIXw ($117.85 in chips)
Seat 3: dxyNCn/qxfkGDUIf28Cbng ($81.40 in chips)
Seat 4: aYii2DmxlOlbC1wbGRBWvQ ($101.70 in chips)
Seat 5: MFptnnT6AnJakWBooTkmeg ($24.25 in chips)
Seat 6: OGMLOcTNYZXZU81au7ztUw ($101 in chips)
OGMLOcTNYZXZU81au7ztUw: posts small blind $0.50
eUBBn2R56C1IQ6Cs/vitwg: posts big blind $1
*** HOLE CARDS ***
oDiBRCaF0QVtd3kO6xZIXw: folds
dxyNCn/qxfkGDUIf28Cbng: folds
aYii2DmxlOlbC1wbGRBWvQ: folds
MFptnnT6AnJakWBooTkmeg: calls $1
OGMLOcTNYZXZU81au7ztUw: folds
eUBBn2R56C1IQ6Cs/vitwg: checks
*** FLOP *** [8d Ts 4d]
eUBBn2R56C1IQ6Cs/vitwg: checks
MFptnnT6AnJakWBooTkmeg: bets $2.75
eUBBn2R56C1IQ6Cs/vitwg: folds
MFptnnT6AnJakWBooTkmeg collected $2.40 from pot
MFptnnT6AnJakWBooTkmeg: doesn't show hand
*** SUMMARY ***
Total pot $2.50 | Rake $0.10
Board [8d Ts 4d]
Seat 1: eUBBn2R56C1IQ6Cs/vitwg (big blind) folded on the Flop
Seat 2: oDiBRCaF0QVtd3kO6xZIXw folded before Flop (didn't bet)
Seat 3: dxyNCn/qxfkGDUIf28Cbng folded before Flop (didn't bet)
Seat 4: aYii2DmxlOlbC1wbGRBWvQ folded before Flop (didn't bet)
Seat 5: MFptnnT6AnJakWBooTkmeg (button) collected ($2.40)
Seat 6: OGMLOcTNYZXZU81au7ztUw (small blind) folded before Flop



PokerStars Game #59940395918:  Hold'em No Limit ($0.50/$1.00) - 2009/07/01 1:05:26 ET
Table 'CASNP0uy1C+jGLml/I4PtA' 9-max Seat #5 is the button
Seat 1: tkdBeXTJlFsZdioidNqLow ($60 in chips)
Seat 3: bJckevFOcg//s0qyMQI6sQ ($102.40 in chips)
Seat 4: B/G0GJacqZ8K59/ZVdq4kQ ($53.70 in chips)
Seat 5: Jjc7EHWzs4//xUAjJ0UWoA ($14.50 in chips)
Seat 6: FJEywSpo5JbRKByzmweboA ($100.50 in chips)
Seat 8: L9njYvloJ1NdXjP8edHEAg ($100 in chips)
Seat 9: Pp/KTcXkfZKKUHkjyaLTdg ($20 in chips)
FJEywSpo5JbRKByzmweboA: posts small blind $0.50
RpMNxqeYPSeOh0tflU772w: is sitting out
L9njYvloJ1NdXjP8edHEAg: posts big blind $1
*** HOLE CARDS ***
Pp/KTcXkfZKKUHkjyaLTdg: folds
tkdBeXTJlFsZdioidNqLow: folds
bJckevFOcg//s0qyMQI6sQ: folds
B/G0GJacqZ8K59/ZVdq4kQ: folds
Jjc7EHWzs4//xUAjJ0UWoA: folds
FJEywSpo5JbRKByzmweboA: folds
L9njYvloJ1NdXjP8edHEAg collected $1 from pot
*** SUMMARY ***
Total pot $1 | Rake $0
Seat 1: tkdBeXTJlFsZdioidNqLow folded before Flop (didn't bet)
Seat 3: bJckevFOcg//s0qyMQI6sQ folded before Flop (didn't bet)
Seat 4: B/G0GJacqZ8K59/ZVdq4kQ folded before Flop (didn't bet)
Seat 5: Jjc7EHWzs4//xUAjJ0UWoA (button) folded before Flop (didn't bet)
Seat 6: FJEywSpo5JbRKByzmweboA (small blind) folded before Flop
Seat 8: L9njYvloJ1NdXjP8edHEAg (big blind) collected ($1)
Seat 9: Pp/KTcXkfZKKUHkjyaLTdg folded before Flop (didn't bet)



PokerStars Game #59940396380:  Hold'em No Limit ($0.50/$1.00) - 2009/07/01 1:05:27 ET
Table 'MUPc8FEpe/nR0BKSeReX6Q' 6-max Seat #2 is the button
Seat 1: qhkK6+yCciTRd+rCFEbnEQ ($41.70 in chips)
Seat 2: xAU6q2/cwmby2sxmA8VcmA ($121.20 in chips)
Seat 3: wx3sQGkVi2x9wJXuWNHPBw ($236.45 in chips)
Seat 4: ZA1bp6g8IwtTxkUE4eCjDQ ($196.65 in chips)
Seat 5: UBZQqpnJZdTYYY1FTb0rLA ($100 in chips)
Seat 6: oxnw0GLLpFanjhGkxfRSqA ($23.20 in chips)
wx3sQGkVi2x9wJXuWNHPBw: posts small blind $0.50
ZA1bp6g8IwtTxkUE4eCjDQ: posts big blind $1
*** HOLE CARDS ***
UBZQqpnJZdTYYY1FTb0rLA: folds
oxnw0GLLpFanjhGkxfRSqA: calls $1
qhkK6+yCciTRd+rCFEbnEQ: folds
xAU6q2/cwmby2sxmA8VcmA: raises $4 to $5
wx3sQGkVi2x9wJXuWNHPBw: folds
ZA1bp6g8IwtTxkUE4eCjDQ: folds
oxnw0GLLpFanjhGkxfRSqA: calls $4
*** FLOP *** [4c Ts 4h]
oxnw0GLLpFanjhGkxfRSqA: checks
xAU6q2/cwmby2sxmA8VcmA: checks
*** TURN *** [4c Ts 4h] [As]
oxnw0GLLpFanjhGkxfRSqA: checks
xAU6q2/cwmby2sxmA8VcmA: checks
*** RIVER *** [4c Ts 4h As] [2s]
oxnw0GLLpFanjhGkxfRSqA: checks
xAU6q2/cwmby2sxmA8VcmA: checks
*** SHOW DOWN ***
oxnw0GLLpFanjhGkxfRSqA: shows [3s 3d] (two pair, Fours and Threes)
xAU6q2/cwmby2sxmA8VcmA: mucks hand
oxnw0GLLpFanjhGkxfRSqA collected $10.95 from pot
*** SUMMARY ***
Total pot $11.50 | Rake $0.55
Board [4c Ts 4h As 2s]
Seat 1: qhkK6+yCciTRd+rCFEbnEQ folded before Flop (didn't bet)
Seat 2: xAU6q2/cwmby2sxmA8VcmA (button) mucked
Seat 3: wx3sQGkVi2x9wJXuWNHPBw (small blind) folded before Flop
Seat 4: ZA1bp6g8IwtTxkUE4eCjDQ (big blind) folded before Flop
Seat 5: UBZQqpnJZdTYYY1FTb0rLA folded before Flop (didn't bet)
Seat 6: oxnw0GLLpFanjhGkxfRSqA showed [3s 3d] and won ($10.95) with two pair, Fours and Threes



PokerStars Game #59940396542:  Hold'em No Limit ($0.50/$1.00) - 2009/07/01 1:05:27 ET
Table 'JTT1XWaDZHSaMZQK7cR5uw' 2-max Seat #2 is the button
Seat 1: OLplZF6FEnLflv81Hz+Fxg ($128.25 in chips)
Seat 2: BcqgegiOUxmBD3F3umsljg ($80.75 in chips)
BcqgegiOUxmBD3F3umsljg: posts small blind $0.50
OLplZF6FEnLflv81Hz+Fxg: posts big blind $1
*** HOLE CARDS ***
BcqgegiOUxmBD3F3umsljg: raises $1 to $2
OLplZF6FEnLflv81Hz+Fxg: folds
BcqgegiOUxmBD3F3umsljg collected $2 from pot
*** SUMMARY ***
Total pot $2 | Rake $0
Seat 1: OLplZF6FEnLflv81Hz+Fxg (big blind) folded before Flop
Seat 2: BcqgegiOUxmBD3F3umsljg (button) (small blind) collected ($2)



PokerStars Game #59940397816:  Hold'em No Limit ($0.50/$1.00) - 2009/07/01 1:05:29 ET
Table 'N2bNCDHL96aCQDvZIh+yQQ' 6-max Seat #4 is the button
Seat 2: TIB5eSBJLz62w6yz2+yeKw ($90.50 in chips)
Seat 3: Qy/UBNbD2HaA0Ogxg8Sf3w ($235.20 in chips)
Seat 4: uCqEjnxh2/vFBjKYkfTOkw ($196.55 in chips)
Seat 5: 8OEJHwpMpZZfyaTpXEDFfw ($30.25 in chips)
Seat 6: TSuRyAHnUPCFjP7Z0rEE0w ($100 in chips)
8OEJHwpMpZZfyaTpXEDFfw: posts small blind $0.50
TSuRyAHnUPCFjP7Z0rEE0w: posts big blind $1
*** HOLE CARDS ***
TIB5eSBJLz62w6yz2+yeKw: folds
Qy/UBNbD2HaA0Ogxg8Sf3w: folds
uCqEjnxh2/vFBjKYkfTOkw: folds
8OEJHwpMpZZfyaTpXEDFfw: calls $0.50
TSuRyAHnUPCFjP7Z0rEE0w: checks
*** FLOP *** [Qh 6s Qc]
8OEJHwpMpZZfyaTpXEDFfw: checks
TSuRyAHnUPCFjP7Z0rEE0w: checks
*** TURN *** [Qh 6s Qc] [Ac]
8OEJHwpMpZZfyaTpXEDFfw: checks
TSuRyAHnUPCFjP7Z0rEE0w: bets $1.50
8OEJHwpMpZZfyaTpXEDFfw: calls $1.50
*** RIVER *** [Qh 6s Qc Ac] [7s]
8OEJHwpMpZZfyaTpXEDFfw: checks
TSuRyAHnUPCFjP7Z0rEE0w: checks
*** SHOW DOWN ***
8OEJHwpMpZZfyaTpXEDFfw: shows [8c 7c] (two pair, Queens and Sevens)
TSuRyAHnUPCFjP7Z0rEE0w: shows [2s Ah] (two pair, Aces and Queens)
TSuRyAHnUPCFjP7Z0rEE0w collected $4.80 from pot
*** SUMMARY ***
Total pot $5 | Rake $0.20
Board [Qh 6s Qc Ac 7s]
Seat 2: TIB5eSBJLz62w6yz2+yeKw folded before Flop (didn't bet)
Seat 3: Qy/UBNbD2HaA0Ogxg8Sf3w folded before Flop (didn't bet)
Seat 4: uCqEjnxh2/vFBjKYkfTOkw (button) folded before Flop (didn't bet)
Seat 5: 8OEJHwpMpZZfyaTpXEDFfw (small blind) showed [8c 7c] and lost with two pair, Queens and Sevens
Seat 6: TSuRyAHnUPCFjP7Z0rEE0w (big blind) showed [2s Ah] and won ($4.80) with two pair, Aces and Queens



PokerStars Game #59940398166:  Hold'em No Limit ($0.50/$1.00) - 2009/07/01 1:05:30 ET
Table 'vs/5jr6ciwjVQ5+Soc+u2A' 6-max Seat #2 is the button
Seat 1: /P4w1pHg2zHYg/4ubJ0dPw ($60.30 in chips)
Seat 2: lXX4W7m3u++JiSOZ46yVMQ ($76 in chips)
Seat 3: G5ZSSN6RSON3gkNvk/SmYg ($158.85 in chips)
Seat 4: wk6Ohn4GDozoOMHc4eb2rw ($85.65 in chips)
Seat 5: +Nt3OPk3XR9SKjZgm2CexQ ($107.45 in chips)
G5ZSSN6RSON3gkNvk/SmYg: posts small blind $0.50
wk6Ohn4GDozoOMHc4eb2rw: posts big blind $1
*** HOLE CARDS ***
+Nt3OPk3XR9SKjZgm2CexQ: folds
Z2fXsGcjl+Eax+RzOgwOmg joins the table at seat #6
/P4w1pHg2zHYg/4ubJ0dPw: folds
lXX4W7m3u++JiSOZ46yVMQ: raises $2 to $3
G5ZSSN6RSON3gkNvk/SmYg: folds
wk6Ohn4GDozoOMHc4eb2rw: calls $2
*** FLOP *** [9h 3c 4s]
wk6Ohn4GDozoOMHc4eb2rw: checks
lXX4W7m3u++JiSOZ46yVMQ: checks
*** TURN *** [9h 3c 4s] [8c]
wk6Ohn4GDozoOMHc4eb2rw: checks
lXX4W7m3u++JiSOZ46yVMQ: checks
*** RIVER *** [9h 3c 4s 8c] [Js]
wk6Ohn4GDozoOMHc4eb2rw: checks
lXX4W7m3u++JiSOZ46yVMQ: bets $3
wk6Ohn4GDozoOMHc4eb2rw: folds
lXX4W7m3u++JiSOZ46yVMQ collected $6.20 from pot
*** SUMMARY ***
Total pot $6.50 | Rake $0.30
Board [9h 3c 4s 8c Js]
Seat 1: /P4w1pHg2zHYg/4ubJ0dPw folded before Flop (didn't bet)
Seat 2: lXX4W7m3u++JiSOZ46yVMQ (button) collected ($6.20)
Seat 3: G5ZSSN6RSON3gkNvk/SmYg (small blind) folded before Flop
Seat 4: wk6Ohn4GDozoOMHc4eb2rw (big blind) folded on the River
Seat 5: +Nt3OPk3XR9SKjZgm2CexQ folded before Flop (didn't bet)



PokerStars Game #59940398096:  Hold'em No Limit ($0.50/$1.00) - 2009/07/01 1:05:30 ET
Table 'QSIig7BLMc9wY/rgBechzw' 6-max Seat #1 is the button
Seat 1: Z2fXsGcjl+Eax+RzOgwOmg ($107 in chips)
Seat 2: mLOIkH/qmRa+mVujQIhBRg ($39.65 in chips)
Seat 3: +xW7QemQU0Fxs+4TnqBRow ($100 in chips)
Seat 4: +uSzP8Jwnw7sKfQ4s66b7w ($87.45 in chips)
Seat 6: PxqfkAMdAWtkgbT+q2gciA ($28.70 in chips)
mLOIkH/qmRa+mVujQIhBRg: posts small blind $0.50
+xW7QemQU0Fxs+4TnqBRow: posts big blind $1
*** HOLE CARDS ***
+uSzP8Jwnw7sKfQ4s66b7w: folds
PxqfkAMdAWtkgbT+q2gciA: folds
Z2fXsGcjl+Eax+RzOgwOmg: folds
mLOIkH/qmRa+mVujQIhBRg: calls $0.50
+xW7QemQU0Fxs+4TnqBRow: checks
*** FLOP *** [As 4h 8d]
mLOIkH/qmRa+mVujQIhBRg: bets $2
lsLuWlcPA3Rh7kJVLzMh0Q joins the table at seat #5
+xW7QemQU0Fxs+4TnqBRow: calls $2
*** TURN *** [As 4h 8d] [Kh]
mLOIkH/qmRa+mVujQIhBRg: bets $4
+xW7QemQU0Fxs+4TnqBRow: folds
mLOIkH/qmRa+mVujQIhBRg collected $5.75 from pot
*** SUMMARY ***
Total pot $6 | Rake $0.25
Board [As 4h 8d Kh]
Seat 1: Z2fXsGcjl+Eax+RzOgwOmg (button) folded before Flop (didn't bet)
Seat 2: mLOIkH/qmRa+mVujQIhBRg (small blind) collected ($5.75)
Seat 3: +xW7QemQU0Fxs+4TnqBRow (big blind) folded on the Turn
Seat 4: +uSzP8Jwnw7sKfQ4s66b7w folded before Flop (didn't bet)
Seat 6: PxqfkAMdAWtkgbT+q2gciA folded before Flop (didn't bet)



PokerStars Game #59940398782:  Hold'em No Limit ($0.50/$1.00) - 2009/07/01 1:05:31 ET
Table 'VOs36P6NW+QyXeQ1B62kmA' 6-max Seat #3 is the button
Seat 1: Z2fXsGcjl+Eax+RzOgwOmg ($100 in chips)
Seat 2: 2UMlbaZ8n8AbRli0Yr0mDw ($39 in chips)
Seat 3: TSuRyAHnUPCFjP7Z0rEE0w ($104.90 in chips)
Seat 4: w02zQzNydODiyV9THKgo9w ($42.20 in chips)
Seat 5: ozrlafxxh1HmYdA0/h+MuA ($48.40 in chips)
Seat 6: slVKuQyEz8Qj4E3uLPYNXg ($100 in chips)
w02zQzNydODiyV9THKgo9w: posts small blind $0.50
ozrlafxxh1HmYdA0/h+MuA: posts big blind $1
*** HOLE CARDS ***
slVKuQyEz8Qj4E3uLPYNXg: folds
Z2fXsGcjl+Eax+RzOgwOmg: folds
2UMlbaZ8n8AbRli0Yr0mDw: calls $1
TSuRyAHnUPCFjP7Z0rEE0w: raises $3 to $4
w02zQzNydODiyV9THKgo9w: folds
ozrlafxxh1HmYdA0/h+MuA: folds
2UMlbaZ8n8AbRli0Yr0mDw: folds
TSuRyAHnUPCFjP7Z0rEE0w collected $3.50 from pot
TSuRyAHnUPCFjP7Z0rEE0w: doesn't show hand
*** SUMMARY ***
Total pot $3.50 | Rake $0
Seat 1: Z2fXsGcjl+Eax+RzOgwOmg folded before Flop (didn't bet)
Seat 2: 2UMlbaZ8n8AbRli0Yr0mDw folded before Flop
Seat 3: TSuRyAHnUPCFjP7Z0rEE0w (button) collected ($3.50)
Seat 4: w02zQzNydODiyV9THKgo9w (small blind) folded before Flop
Seat 5: ozrlafxxh1HmYdA0/h+MuA (big blind) folded before Flop
Seat 6: slVKuQyEz8Qj4E3uLPYNXg folded before Flop (didn't bet)



PokerStars Game #59940399714:  Hold'em No Limit ($0.50/$1.00) - 2009/07/01 1:05:33 ET
Table 'cBDNutyLBKEk9+ptwsKmTw' 6-max Seat #4 is the button
Seat 1: xAU6q2/cwmby2sxmA8VcmA ($109.85 in chips)
Seat 2: 5lY8d6Cnm4HUkt/8FZSj4g ($33.50 in chips)
Seat 3: G5ZSSN6RSON3gkNvk/SmYg ($100.15 in chips)
Seat 4: 3q7F5QtzC30pSrn0nl9i+A ($26.80 in chips)
Seat 5: OGMLOcTNYZXZU81au7ztUw ($163.05 in chips)
Seat 6: NqVlOSH2lp+pp/TK3vvK5g ($94.65 in chips)
OGMLOcTNYZXZU81au7ztUw: posts small blind $0.50
NqVlOSH2lp+pp/TK3vvK5g: posts big blind $1
*** HOLE CARDS ***
xAU6q2/cwmby2sxmA8VcmA: folds
5lY8d6Cnm4HUkt/8FZSj4g: folds
G5ZSSN6RSON3gkNvk/SmYg: folds
3q7F5QtzC30pSrn0nl9i+A: folds
OGMLOcTNYZXZU81au7ztUw: raises $2 to $3
NqVlOSH2lp+pp/TK3vvK5g: calls $2
*** FLOP *** [9d 5d 2s]
OGMLOcTNYZXZU81au7ztUw: bets $4
NqVlOSH2lp+pp/TK3vvK5g: calls $4
*** TURN *** [9d 5d 2s] [Jd]
OGMLOcTNYZXZU81au7ztUw: bets $11
NqVlOSH2lp+pp/TK3vvK5g: folds
OGMLOcTNYZXZU81au7ztUw collected $13.35 from pot
OGMLOcTNYZXZU81au7ztUw: doesn't show hand
*** SUMMARY ***
Total pot $14 | Rake $0.65
Board [9d 5d 2s Jd]
Seat 1: xAU6q2/cwmby2sxmA8VcmA folded before Flop (didn't bet)
Seat 2: 5lY8d6Cnm4HUkt/8FZSj4g folded before Flop (didn't bet)
Seat 3: G5ZSSN6RSON3gkNvk/SmYg folded before Flop (didn't bet)
Seat 4: 3q7F5QtzC30pSrn0nl9i+A (button) folded before Flop (didn't bet)
Seat 5: OGMLOcTNYZXZU81au7ztUw (small blind) collected ($13.35)
Seat 6: NqVlOSH2lp+pp/TK3vvK5g (big blind) folded on the Turn



PokerStars Game #59940399744:  Hold'em No Limit ($0.50/$1.00) - 2009/07/01 1:05:33 ET
Table '8jIjWCPY0NGprquL+xcMFg' 9-max Seat #8 is the button
Seat 1: N7iZ0peZns5o4A6AjN24jQ ($44.40 in chips)
Seat 2: laA8va+Yv8WuMqT1zdR91g ($108.70 in chips)
Seat 4: Jjc7EHWzs4//xUAjJ0UWoA ($22.10 in chips)
Seat 5: 2YpnxJiexJHyERfbqgwEcw ($53.55 in chips)
Seat 6: GTQkFJtSkbVbnGCktp6e3g ($100 in chips)
Seat 7: O3CGPwwUmamrCNHccOilrg ($34.45 in chips)
Seat 8: D+W9Me7w6Hcx/WRUSKV0dw ($17 in chips)
N7iZ0peZns5o4A6AjN24jQ: posts small blind $0.50
laA8va+Yv8WuMqT1zdR91g: posts big blind $1
*** HOLE CARDS ***
Jjc7EHWzs4//xUAjJ0UWoA: calls $1
2YpnxJiexJHyERfbqgwEcw: folds
GTQkFJtSkbVbnGCktp6e3g: folds
O3CGPwwUmamrCNHccOilrg: raises $2 to $3
D+W9Me7w6Hcx/WRUSKV0dw: folds
N7iZ0peZns5o4A6AjN24jQ: folds
laA8va+Yv8WuMqT1zdR91g: folds
Jjc7EHWzs4//xUAjJ0UWoA: calls $2
*** FLOP *** [6h Jd Td]
Jjc7EHWzs4//xUAjJ0UWoA: checks
O3CGPwwUmamrCNHccOilrg: bets $5
Jjc7EHWzs4//xUAjJ0UWoA: folds
O3CGPwwUmamrCNHccOilrg collected $7.15 from pot
O3CGPwwUmamrCNHccOilrg: doesn't show hand
*** SUMMARY ***
Total pot $7.50 | Rake $0.35
Board [6h Jd Td]
Seat 1: N7iZ0peZns5o4A6AjN24jQ (small blind) folded before Flop
Seat 2: laA8va+Yv8WuMqT1zdR91g (big blind) folded before Flop
Seat 4: Jjc7EHWzs4//xUAjJ0UWoA folded on the Flop
Seat 5: 2YpnxJiexJHyERfbqgwEcw folded before Flop (didn't bet)
Seat 6: GTQkFJtSkbVbnGCktp6e3g folded before Flop (didn't bet)
Seat 7: O3CGPwwUmamrCNHccOilrg collected ($7.15)
Seat 8: D+W9Me7w6Hcx/WRUSKV0dw (button) folded before Flop (didn't bet)



PokerStars Game #59940400238:  Hold'em No Limit ($0.50/$1.00) - 2009/07/01 1:05:34 ET
Table 'kS0cTQAEi+fdUlJP2gQYvw' 9-max Seat #2 is the button
Seat 1: c/9X4zftzphFxYtxp5kp9w ($64.35 in chips)
Seat 2: D+W9Me7w6Hcx/WRUSKV0dw ($20.90 in chips)
Seat 3: 2BV+oJIQYr65IO6nEChvbA ($60 in chips)
Seat 5: 997ViqAtWn1FPjJqcffwcA ($104.15 in chips)
Seat 6: yAbu2QsRPVcjPbqlf/jDxw ($127.65 in chips)
Seat 7: Ffa7Nj4X5fddtROP01hfQg ($126.55 in chips)
Seat 8: QYMfy2FoN6/Qe1LWYuI7fw ($26.45 in chips)
Seat 9: OGgaARGdJQT4awWVNQ957w ($102 in chips)
2BV+oJIQYr65IO6nEChvbA: posts small blind $0.50
TZcz9MEWDA+WydgGruqqbw: is sitting out
997ViqAtWn1FPjJqcffwcA: posts big blind $1
*** HOLE CARDS ***
TZcz9MEWDA+WydgGruqqbw leaves the table
yAbu2QsRPVcjPbqlf/jDxw: folds
Ffa7Nj4X5fddtROP01hfQg said, "every time i try to steal blinds"
Ffa7Nj4X5fddtROP01hfQg: folds
QYMfy2FoN6/Qe1LWYuI7fw: folds
OGgaARGdJQT4awWVNQ957w: folds
c/9X4zftzphFxYtxp5kp9w: folds
D+W9Me7w6Hcx/WRUSKV0dw: raises $1.45 to $2.45
2BV+oJIQYr65IO6nEChvbA: folds
997ViqAtWn1FPjJqcffwcA: folds
D+W9Me7w6Hcx/WRUSKV0dw collected $2.50 from pot
D+W9Me7w6Hcx/WRUSKV0dw: doesn't show hand
*** SUMMARY ***
Total pot $2.50 | Rake $0
Seat 1: c/9X4zftzphFxYtxp5kp9w folded before Flop (didn't bet)
Seat 2: D+W9Me7w6Hcx/WRUSKV0dw (button) collected ($2.50)
Seat 3: 2BV+oJIQYr65IO6nEChvbA (small blind) folded before Flop
Seat 5: 997ViqAtWn1FPjJqcffwcA (big blind) folded before Flop
Seat 6: yAbu2QsRPVcjPbqlf/jDxw folded before Flop (didn't bet)
Seat 7: Ffa7Nj4X5fddtROP01hfQg folded before Flop (didn't bet)
Seat 8: QYMfy2FoN6/Qe1LWYuI7fw folded before Flop (didn't bet)
Seat 9: OGgaARGdJQT4awWVNQ957w folded before Flop (didn't bet)



PokerStars Game #59940401314:  Hold'em No Limit ($0.50/$1.00) - 2009/07/01 1:05:35 ET
Table 'JTT1XWaDZHSaMZQK7cR5uw' 2-max Seat #1 is the button
Seat 1: OLplZF6FEnLflv81Hz+Fxg ($127.25 in chips)
Seat 2: BcqgegiOUxmBD3F3umsljg ($81.75 in chips)
OLplZF6FEnLflv81Hz+Fxg: posts small blind $0.50
BcqgegiOUxmBD3F3umsljg: posts big blind $1
*** HOLE CARDS ***
OLplZF6FEnLflv81Hz+Fxg: raises $2 to $3
BcqgegiOUxmBD3F3umsljg: calls $2
*** FLOP *** [Qd Ad 8d]
BcqgegiOUxmBD3F3umsljg: checks
OLplZF6FEnLflv81Hz+Fxg: bets $4
BcqgegiOUxmBD3F3umsljg: folds
OLplZF6FEnLflv81Hz+Fxg collected $5.70 from pot
*** SUMMARY ***
Total pot $6 | Rake $0.30
Board [Qd Ad 8d]
Seat 1: OLplZF6FEnLflv81Hz+Fxg (button) (small blind) collected ($5.70)
Seat 2: BcqgegiOUxmBD3F3umsljg (big blind) folded on the Flop



PokerStars Game #59940403226:  Hold'em No Limit ($0.50/$1.00) - 2009/07/01 1:05:39 ET
Table 'hugOjcwJvzEwZbK7tyiWuQ' 9-max Seat #4 is the button
Seat 2: r27C1nIV4NS4+qbnrgBQSw ($283.20 in chips)
Seat 3: jDwhY1kCdc6EkAHbT7PJMQ ($104.75 in chips)
Seat 4: UWB3oeddt/GObx2Mix2Anw ($173.30 in chips)
Seat 5: 5BRGWf+R3nt2WS3b5xX+zA ($17.25 in chips)
Seat 6: gUUvmqdVlmvpal6B8nYrmg ($107.40 in chips)
Seat 7: FL3MrLspcF23LYvC4ipBOA ($110.30 in chips)
Seat 8: /zy+DB4S5fUQUSfZWFzYGw ($100 in chips)
Seat 9: W8P9bUKCs43TO1xHm0dL6w ($89.45 in chips)
5BRGWf+R3nt2WS3b5xX+zA: posts small blind $0.50
gUUvmqdVlmvpal6B8nYrmg: posts big blind $1
*** HOLE CARDS ***
FL3MrLspcF23LYvC4ipBOA: folds
/zy+DB4S5fUQUSfZWFzYGw: folds
W8P9bUKCs43TO1xHm0dL6w: folds
r27C1nIV4NS4+qbnrgBQSw: folds
jDwhY1kCdc6EkAHbT7PJMQ: folds
UWB3oeddt/GObx2Mix2Anw: raises $2 to $3
5BRGWf+R3nt2WS3b5xX+zA: folds
gUUvmqdVlmvpal6B8nYrmg: folds
UWB3oeddt/GObx2Mix2Anw collected $2.50 from pot
*** SUMMARY ***
Total pot $2.50 | Rake $0
Seat 2: r27C1nIV4NS4+qbnrgBQSw folded before Flop (didn't bet)
Seat 3: jDwhY1kCdc6EkAHbT7PJMQ folded before Flop (didn't bet)
Seat 4: UWB3oeddt/GObx2Mix2Anw (button) collected ($2.50)
Seat 5: 5BRGWf+R3nt2WS3b5xX+zA (small blind) folded before Flop
Seat 6: gUUvmqdVlmvpal6B8nYrmg (big blind) folded before Flop
Seat 7: FL3MrLspcF23LYvC4ipBOA folded before Flop (didn't bet)
Seat 8: /zy+DB4S5fUQUSfZWFzYGw folded before Flop (didn't bet)
Seat 9: W8P9bUKCs43TO1xHm0dL6w folded before Flop (didn't bet)



PokerStars Game #59940403098:  Hold'em No Limit ($0.50/$1.00) - 2009/07/01 1:05:39 ET
Table 'fTlPiCj0utgzC/5io+I7ew' 6-max Seat #4 is the button
Seat 1: YMJG+F++3Aj6P8dAWda5fw ($104.35 in chips)
Seat 2: Qy/UBNbD2HaA0Ogxg8Sf3w ($123.85 in chips)
Seat 4: uJVSceLggtsrJya+WtmUEA ($181.50 in chips)
Seat 5: GC5g2ryXV7e4TTqmaxUofw ($53.20 in chips)
Seat 6: /P4w1pHg2zHYg/4ubJ0dPw ($69.05 in chips)
GC5g2ryXV7e4TTqmaxUofw: posts small blind $0.50
/P4w1pHg2zHYg/4ubJ0dPw: posts big blind $1
*** HOLE CARDS ***
wL5HjWHHOSGc53xWMNKB9Q leaves the table
YMJG+F++3Aj6P8dAWda5fw: folds
Qy/UBNbD2HaA0Ogxg8Sf3w: raises $2 to $3
uJVSceLggtsrJya+WtmUEA: calls $3
GC5g2ryXV7e4TTqmaxUofw: folds
/P4w1pHg2zHYg/4ubJ0dPw: folds
*** FLOP *** [7s Kc 9s]
Qy/UBNbD2HaA0Ogxg8Sf3w: checks
uJVSceLggtsrJya+WtmUEA: bets $4
Z2fXsGcjl+Eax+RzOgwOmg joins the table at seat #3
Qy/UBNbD2HaA0Ogxg8Sf3w: folds
uJVSceLggtsrJya+WtmUEA collected $7.15 from pot
*** SUMMARY ***
Total pot $7.50 | Rake $0.35
Board [7s Kc 9s]
Seat 1: YMJG+F++3Aj6P8dAWda5fw folded before Flop (didn't bet)
Seat 2: Qy/UBNbD2HaA0Ogxg8Sf3w folded on the Flop
Seat 4: uJVSceLggtsrJya+WtmUEA (button) collected ($7.15)
Seat 5: GC5g2ryXV7e4TTqmaxUofw (small blind) folded before Flop
Seat 6: /P4w1pHg2zHYg/4ubJ0dPw (big blind) folded before Flop



PokerStars Game #59940404834:  Hold'em No Limit ($0.50/$1.00) - 2009/07/01 1:05:41 ET
Table 'eU3bWpDDg3Z+9R4m4iVmog' 6-max Seat #2 is the button
Seat 1: TSuRyAHnUPCFjP7Z0rEE0w ($177.15 in chips)
Seat 2: 8CAoOzhmB8n3nRFf3V4BTg ($69.90 in chips)
Seat 3: rVMOzU7w5FddYPGhD7qN2Q ($41.05 in chips)
Seat 4: GDVIsbEJ/DOJsMKE4Asz0A ($118.20 in chips)
Seat 6: hpxXcmRkXXI9HE5+5/j/0Q ($117.75 in chips)
rVMOzU7w5FddYPGhD7qN2Q: posts small blind $0.50
GDVIsbEJ/DOJsMKE4Asz0A: posts big blind $1
*** HOLE CARDS ***
hpxXcmRkXXI9HE5+5/j/0Q: folds
TSuRyAHnUPCFjP7Z0rEE0w: folds
8CAoOzhmB8n3nRFf3V4BTg: raises $2 to $3
rVMOzU7w5FddYPGhD7qN2Q: folds
GDVIsbEJ/DOJsMKE4Asz0A: folds
8CAoOzhmB8n3nRFf3V4BTg collected $2.50 from pot
*** SUMMARY ***
Total pot $2.50 | Rake $0
Seat 1: TSuRyAHnUPCFjP7Z0rEE0w folded before Flop (didn't bet)
Seat 2: 8CAoOzhmB8n3nRFf3V4BTg (button) collected ($2.50)
Seat 3: rVMOzU7w5FddYPGhD7qN2Q (small blind) folded before Flop
Seat 4: GDVIsbEJ/DOJsMKE4Asz0A (big blind) folded before Flop
Seat 6: hpxXcmRkXXI9HE5+5/j/0Q folded before Flop (didn't bet)



PokerStars Game #59940405200:  Hold'em No Limit ($0.50/$1.00) - 2009/07/01 1:05:42 ET
Table 'rmZfTK+oSebeUPJNbWhdAA' 6-max Seat #5 is the button
Seat 1: xAU6q2/cwmby2sxmA8VcmA ($148.50 in chips)
Seat 2: z7O9PO/WEcqRouIydFhS9Q ($136.90 in chips)
Seat 3: BCEV3COoKY607AzLWayfRA ($132.50 in chips)
Seat 4: 1/mIuXfgx1ZyVkodrmfQDw ($102.70 in chips)
Seat 5: 5lY8d6Cnm4HUkt/8FZSj4g ($77.40 in chips)
Seat 6: j7NIOHLZk7V2o9fOioO5ug ($113.30 in chips)
j7NIOHLZk7V2o9fOioO5ug: posts small blind $0.50
xAU6q2/cwmby2sxmA8VcmA: posts big blind $1
*** HOLE CARDS ***
z7O9PO/WEcqRouIydFhS9Q: folds
BCEV3COoKY607AzLWayfRA: folds
1/mIuXfgx1ZyVkodrmfQDw: raises $2 to $3
5lY8d6Cnm4HUkt/8FZSj4g: calls $3
j7NIOHLZk7V2o9fOioO5ug: calls $2.50
xAU6q2/cwmby2sxmA8VcmA: folds
*** FLOP *** [Td 6d 2s]
j7NIOHLZk7V2o9fOioO5ug: bets $7
1/mIuXfgx1ZyVkodrmfQDw: folds
5lY8d6Cnm4HUkt/8FZSj4g: calls $7
*** TURN *** [Td 6d 2s] [9d]
j7NIOHLZk7V2o9fOioO5ug: checks
5lY8d6Cnm4HUkt/8FZSj4g: bets $12
j7NIOHLZk7V2o9fOioO5ug: folds
5lY8d6Cnm4HUkt/8FZSj4g collected $22.85 from pot
5lY8d6Cnm4HUkt/8FZSj4g: doesn't show hand
*** SUMMARY ***
Total pot $24 | Rake $1.15
Board [Td 6d 2s 9d]
Seat 1: xAU6q2/cwmby2sxmA8VcmA (big blind) folded before Flop
Seat 2: z7O9PO/WEcqRouIydFhS9Q folded before Flop (didn't bet)
Seat 3: BCEV3COoKY607AzLWayfRA folded before Flop (didn't bet)
Seat 4: 1/mIuXfgx1ZyVkodrmfQDw folded on the Flop
Seat 5: 5lY8d6Cnm4HUkt/8FZSj4g (button) collected ($22.85)
Seat 6: j7NIOHLZk7V2o9fOioO5ug (small blind) folded on the Turn



PokerStars Game #59940407598:  Hold'em No Limit ($0.50/$1.00) - 2009/07/01 1:05:46 ET
Table 'SQLOQoANiHscJ8AL7zffbw' 9-max Seat #2 is the button
Seat 1: jPTRd6SpCp4xqAy2XQiTOw ($67.90 in chips)
Seat 2: /zy+DB4S5fUQUSfZWFzYGw ($329.90 in chips)
Seat 3: 0eFnow7+D7veCYQ+CG9FFw ($92.35 in chips)
Seat 4: /mfensKw8/iZ1Vrx33S4xg ($20 in chips)
Seat 5: L9njYvloJ1NdXjP8edHEAg ($109.15 in chips)
Seat 7: bJckevFOcg//s0qyMQI6sQ ($104.55 in chips)
Seat 8: 2BV+oJIQYr65IO6nEChvbA ($60 in chips)
Seat 9: qJr25HAtvv1w/7IBvjMM3g ($200.15 in chips)
0eFnow7+D7veCYQ+CG9FFw: posts small blind $0.50
/mfensKw8/iZ1Vrx33S4xg: posts big blind $1
H+DVy3Ei8L1UKS2tVOtJcw: sits out
*** HOLE CARDS ***
L9njYvloJ1NdXjP8edHEAg: folds
bJckevFOcg//s0qyMQI6sQ: folds
2BV+oJIQYr65IO6nEChvbA: folds
qJr25HAtvv1w/7IBvjMM3g: folds
jPTRd6SpCp4xqAy2XQiTOw has timed out
jPTRd6SpCp4xqAy2XQiTOw: folds
jPTRd6SpCp4xqAy2XQiTOw is sitting out
jPTRd6SpCp4xqAy2XQiTOw has returned
/zy+DB4S5fUQUSfZWFzYGw: folds
0eFnow7+D7veCYQ+CG9FFw: folds
/mfensKw8/iZ1Vrx33S4xg collected $1 from pot
*** SUMMARY ***
Total pot $1 | Rake $0
Seat 1: jPTRd6SpCp4xqAy2XQiTOw folded before Flop (didn't bet)
Seat 2: /zy+DB4S5fUQUSfZWFzYGw (button) folded before Flop (didn't bet)
Seat 3: 0eFnow7+D7veCYQ+CG9FFw (small blind) folded before Flop
Seat 4: /mfensKw8/iZ1Vrx33S4xg (big blind) collected ($1)
Seat 5: L9njYvloJ1NdXjP8edHEAg folded before Flop (didn't bet)
Seat 7: bJckevFOcg//s0qyMQI6sQ folded before Flop (didn't bet)
Seat 8: 2BV+oJIQYr65IO6nEChvbA folded before Flop (didn't bet)
Seat 9: qJr25HAtvv1w/7IBvjMM3g folded before Flop (didn't bet)



PokerStars Game #59940408270:  Hold'em No Limit ($0.50/$1.00) - 2009/07/01 1:05:47 ET
Table 'cKH9c4x6u79IqCdaKKvXrw' 9-max Seat #1 is the button
Seat 1: Pp/KTcXkfZKKUHkjyaLTdg ($18.50 in chips)
Seat 2: 8S3JMH4TY3whgIlZmMv66w ($74.70 in chips)
Seat 3: 997ViqAtWn1FPjJqcffwcA ($157.10 in chips)
Seat 4: FL3MrLspcF23LYvC4ipBOA ($100 in chips)
Seat 5: Jjc7EHWzs4//xUAjJ0UWoA ($40.65 in chips)
Seat 6: Bsd/K5gAcLanYbGiPirRjw ($202.55 in chips)
Seat 7: 1GkkVBhlJ92guE6K5mS5Ig ($17.75 in chips)
Seat 8: myIxN7otsyr846M539YR8Q ($17 in chips)
Seat 9: 6XkTu4ahxzHnvjjc1R8YjQ ($41.60 in chips)
8S3JMH4TY3whgIlZmMv66w: posts small blind $0.50
997ViqAtWn1FPjJqcffwcA: posts big blind $1
*** HOLE CARDS ***
FL3MrLspcF23LYvC4ipBOA: folds
Jjc7EHWzs4//xUAjJ0UWoA: folds
Bsd/K5gAcLanYbGiPirRjw: folds
1GkkVBhlJ92guE6K5mS5Ig: calls $1
myIxN7otsyr846M539YR8Q: folds
6XkTu4ahxzHnvjjc1R8YjQ: folds
Pp/KTcXkfZKKUHkjyaLTdg: folds
8S3JMH4TY3whgIlZmMv66w: calls $0.50
997ViqAtWn1FPjJqcffwcA: checks
*** FLOP *** [8s Tc 3c]
8S3JMH4TY3whgIlZmMv66w: bets $2
997ViqAtWn1FPjJqcffwcA: folds
1GkkVBhlJ92guE6K5mS5Ig: folds
8S3JMH4TY3whgIlZmMv66w collected $2.85 from pot
*** SUMMARY ***
Total pot $3 | Rake $0.15
Board [8s Tc 3c]
Seat 1: Pp/KTcXkfZKKUHkjyaLTdg (button) folded before Flop (didn't bet)
Seat 2: 8S3JMH4TY3whgIlZmMv66w (small blind) collected ($2.85)
Seat 3: 997ViqAtWn1FPjJqcffwcA (big blind) folded on the Flop
Seat 4: FL3MrLspcF23LYvC4ipBOA folded before Flop (didn't bet)
Seat 5: Jjc7EHWzs4//xUAjJ0UWoA folded before Flop (didn't bet)
Seat 6: Bsd/K5gAcLanYbGiPirRjw folded before Flop (didn't bet)
Seat 7: 1GkkVBhlJ92guE6K5mS5Ig folded on the Flop
Seat 8: myIxN7otsyr846M539YR8Q folded before Flop (didn't bet)
Seat 9: 6XkTu4ahxzHnvjjc1R8YjQ folded before Flop (didn't bet)



PokerStars Game #59940408520:  Hold'em No Limit ($0.50/$1.00) - 2009/07/01 1:05:48 ET
Table 'O96CPOtvMBWP6kzuYDfdFA' 6-max Seat #4 is the button
Seat 1: 6alLXQIITA2EZ/lBeym8Dw ($126.05 in chips)
Seat 3: V89DGjxE171oPREEbAXiyg ($86.50 in chips)
Seat 4: /P4w1pHg2zHYg/4ubJ0dPw ($64.55 in chips)
Seat 5: G5ZSSN6RSON3gkNvk/SmYg ($100 in chips)
Seat 6: GYei5jXGWexiJYbAT2fELg ($24.50 in chips)
G5ZSSN6RSON3gkNvk/SmYg: posts small blind $0.50
GYei5jXGWexiJYbAT2fELg: posts big blind $1
*** HOLE CARDS ***
6alLXQIITA2EZ/lBeym8Dw: folds
V89DGjxE171oPREEbAXiyg: raises $3 to $4
/P4w1pHg2zHYg/4ubJ0dPw: folds
G5ZSSN6RSON3gkNvk/SmYg: folds
GYei5jXGWexiJYbAT2fELg: calls $3
*** FLOP *** [5s 9s 6c]
GYei5jXGWexiJYbAT2fELg: checks
V89DGjxE171oPREEbAXiyg: bets $8
GYei5jXGWexiJYbAT2fELg: folds
V89DGjxE171oPREEbAXiyg collected $8.10 from pot
*** SUMMARY ***
Total pot $8.50 | Rake $0.40
Board [5s 9s 6c]
Seat 1: 6alLXQIITA2EZ/lBeym8Dw folded before Flop (didn't bet)
Seat 3: V89DGjxE171oPREEbAXiyg collected ($8.10)
Seat 4: /P4w1pHg2zHYg/4ubJ0dPw (button) folded before Flop (didn't bet)
Seat 5: G5ZSSN6RSON3gkNvk/SmYg (small blind) folded before Flop
Seat 6: GYei5jXGWexiJYbAT2fELg (big blind) folded on the Flop



PokerStars Game #59940409490:  Hold'em No Limit ($0.50/$1.00) - 2009/07/01 1:05:49 ET
Table 'GxCPo/gd3OSthkYrAxJngg' 6-max Seat #2 is the button
Seat 1: sH8BpAFP+jGFxCgVpD1Lew ($268.40 in chips)
Seat 2: YExX2paeIHrmfIwV1ivM/w ($69.10 in chips)
Seat 3: o6plE+MSW4XFNTeONe16xg ($20.60 in chips)
Seat 4: YMJG+F++3Aj6P8dAWda5fw ($203.75 in chips)
Seat 5: G5ZSSN6RSON3gkNvk/SmYg ($117.60 in chips)
o6plE+MSW4XFNTeONe16xg: posts small blind $0.50
YMJG+F++3Aj6P8dAWda5fw: posts big blind $1
*** HOLE CARDS ***
G5ZSSN6RSON3gkNvk/SmYg: folds
sH8BpAFP+jGFxCgVpD1Lew: folds
YExX2paeIHrmfIwV1ivM/w: raises $2 to $3
o6plE+MSW4XFNTeONe16xg: folds
YMJG+F++3Aj6P8dAWda5fw: folds
YExX2paeIHrmfIwV1ivM/w collected $2.50 from pot
*** SUMMARY ***
Total pot $2.50 | Rake $0
Seat 1: sH8BpAFP+jGFxCgVpD1Lew folded before Flop (didn't bet)
Seat 2: YExX2paeIHrmfIwV1ivM/w (button) collected ($2.50)
Seat 3: o6plE+MSW4XFNTeONe16xg (small blind) folded before Flop
Seat 4: YMJG+F++3Aj6P8dAWda5fw (big blind) folded before Flop
Seat 5: G5ZSSN6RSON3gkNvk/SmYg folded before Flop (didn't bet)



PokerStars Game #59940409738:  Hold'em No Limit ($0.50/$1.00) - 2009/07/01 1:05:50 ET
Table 'tyUh+jyNvrceIQdKMJjQ2wZFWj23PMihdwrNWv41OG/Qeat #5 is the button
Seat 1: o8A5MUdudVKu+pAwgZOX2w ($108.30 in chips)
Seat 3: TalCiLYHCd+ffkmR3auPvA ($83.60 in chips)
Seat 4: TSuRyAHnUPCFjP7Z0rEE0w ($181.50 in chips)
Seat 5: j7NIOHLZk7V2o9fOioO5ug ($121.55 in chips)
Seat 6: 4OO5v3AVduL0tePNx8wk5A ($100 in chips)
4OO5v3AVduL0tePNx8wk5A: posts small blind $0.50
o8A5MUdudVKu+pAwgZOX2w: posts big blind $1
*** HOLE CARDS ***
5uy3EN+iIYkgwbWZFTUBAQ joins the table at seat #2
TalCiLYHCd+ffkmR3auPvA: raises $2 to $3
TSuRyAHnUPCFjP7Z0rEE0w: folds
j7NIOHLZk7V2o9fOioO5ug: folds
4OO5v3AVduL0tePNx8wk5A: folds
o8A5MUdudVKu+pAwgZOX2w: calls $2
*** FLOP *** [8s 7c 4c]
o8A5MUdudVKu+pAwgZOX2w: checks
TalCiLYHCd+ffkmR3auPvA: bets $6
o8A5MUdudVKu+pAwgZOX2w: calls $6
*** TURN *** [8s 7c 4c] [Ac]
o8A5MUdudVKu+pAwgZOX2w: bets $18
TalCiLYHCd+ffkmR3auPvA: folds
o8A5MUdudVKu+pAwgZOX2w collected $17.60 from pot
o8A5MUdudVKu+pAwgZOX2w: doesn't show hand
*** SUMMARY ***
Total pot $18.50 | Rake $0.90
Board [8s 7c 4c Ac]
Seat 1: o8A5MUdudVKu+pAwgZOX2w (big blind) collected ($17.60)
Seat 3: TalCiLYHCd+ffkmR3auPvA folded on the Turn
Seat 4: TSuRyAHnUPCFjP7Z0rEE0w folded before Flop (didn't bet)
Seat 5: j7NIOHLZk7V2o9fOioO5ug (button) folded before Flop (didn't bet)
Seat 6: 4OO5v3AVduL0tePNx8wk5A (small blind) folded before Flop



PokerStars Game #59940410268:  Hold'em No Limit ($0.50/$1.00) - 2009/07/01 1:05:51 ET
Table 'JTT1XWaDZHSaMZQK7cR5uw' 2-max Seat #2 is the button
Seat 1: OLplZF6FEnLflv81Hz+Fxg ($129.95 in chips)
Seat 2: BcqgegiOUxmBD3F3umsljg ($78.75 in chips)
BcqgegiOUxmBD3F3umsljg: posts small blind $0.50
OLplZF6FEnLflv81Hz+Fxg: posts big blind $1
*** HOLE CARDS ***
BcqgegiOUxmBD3F3umsljg: raises $2 to $3
OLplZF6FEnLflv81Hz+Fxg: calls $2
*** FLOP *** [Jh 8c Js]
OLplZF6FEnLflv81Hz+Fxg: checks
BcqgegiOUxmBD3F3umsljg: bets $3
OLplZF6FEnLflv81Hz+Fxg: raises $3 to $6
BcqgegiOUxmBD3F3umsljg: calls $3
*** TURN *** [Jh 8c Js] [Kh]
OLplZF6FEnLflv81Hz+Fxg: bets $13
BcqgegiOUxmBD3F3umsljg: folds
OLplZF6FEnLflv81Hz+Fxg collected $17.50 from pot
*** SUMMARY ***
Total pot $18 | Rake $0.50
Board [Jh 8c Js Kh]
Seat 1: OLplZF6FEnLflv81Hz+Fxg (big blind) collected ($17.50)
Seat 2: BcqgegiOUxmBD3F3umsljg (button) (small blind) folded on the Turn



PokerStars Game #59940411770:  Hold'em No Limit ($0.50/$1.00) - 2009/07/01 1:05:53 ET
Table '+cA8mcmhaedZ7YcrDdhmeQ' 6-max Seat #3 is the button
Seat 1: lsLuWlcPA3Rh7kJVLzMh0Q ($300.95 in chips)
Seat 2: RqgF7gRoKgRNW8Zoi1ty4A ($121.10 in chips)
Seat 3: 7H5WkGzGvsv56y1iaqHvRg ($20.20 in chips)
Seat 4: 4OO5v3AVduL0tePNx8wk5A ($100.90 in chips)
Seat 5: +7hFKAL0b0O/n8G72TclJA ($69.85 in chips)
Seat 6: YfsTQsY/fxb+YqbdclTHuw ($18.60 in chips)
4OO5v3AVduL0tePNx8wk5A: posts small blind $0.50
+7hFKAL0b0O/n8G72TclJA: posts big blind $1
*** HOLE CARDS ***
YfsTQsY/fxb+YqbdclTHuw: folds
lsLuWlcPA3Rh7kJVLzMh0Q: folds
RqgF7gRoKgRNW8Zoi1ty4A: folds
7H5WkGzGvsv56y1iaqHvRg: folds
4OO5v3AVduL0tePNx8wk5A: raises $2 to $3
+7hFKAL0b0O/n8G72TclJA: calls $2
*** FLOP *** [7h 9s 5h]
4OO5v3AVduL0tePNx8wk5A: bets $5
+7hFKAL0b0O/n8G72TclJA: calls $5
*** TURN *** [7h 9s 5h] [Ac]
4OO5v3AVduL0tePNx8wk5A: bets $12
+7hFKAL0b0O/n8G72TclJA: raises $18 to $30
4OO5v3AVduL0tePNx8wk5A: raises $62.90 to $92.90 and is all-in
+7hFKAL0b0O/n8G72TclJA: calls $31.85 and is all-in
*** RIVER *** [7h 9s 5h Ac] [3h]
*** SHOW DOWN ***
4OO5v3AVduL0tePNx8wk5A: shows [Kd Kh] (a pair of Kings)
+7hFKAL0b0O/n8G72TclJA: shows [7d Ad] (two pair, Aces and Sevens)
+7hFKAL0b0O/n8G72TclJA collected $136.70 from pot
*** SUMMARY ***
Total pot $139.70 | Rake $3
Board [7h 9s 5h Ac 3h]
Seat 1: lsLuWlcPA3Rh7kJVLzMh0Q folded before Flop (didn't bet)
Seat 2: RqgF7gRoKgRNW8Zoi1ty4A folded before Flop (didn't bet)
Seat 3: 7H5WkGzGvsv56y1iaqHvRg (button) folded before Flop (didn't bet)
Seat 4: 4OO5v3AVduL0tePNx8wk5A (small blind) showed [Kd Kh] and lost with a pair of Kings
Seat 5: +7hFKAL0b0O/n8G72TclJA (big blind) showed [7d Ad] and won ($136.70) with two pair, Aces and Sevens
Seat 6: YfsTQsY/fxb+YqbdclTHuw folded before Flop (didn't bet)



PokerStars Game #59940414696:  Hold'em No Limit ($0.50/$1.00) - 2009/07/01 1:05:58 ET
Table 'VOs36P6NW+QyXeQ1B62kmA' 6-max Seat #4 is the button
Seat 1: Z2fXsGcjl+Eax+RzOgwOmg ($100 in chips)
Seat 2: 2UMlbaZ8n8AbRli0Yr0mDw ($38 in chips)
Seat 3: TSuRyAHnUPCFjP7Z0rEE0w ($107.40 in chips)
Seat 4: w02zQzNydODiyV9THKgo9w ($41.70 in chips)
Seat 5: ozrlafxxh1HmYdA0/h+MuA ($47.40 in chips)
Seat 6: slVKuQyEz8Qj4E3uLPYNXg ($100 in chips)
ozrlafxxh1HmYdA0/h+MuA: posts small blind $0.50
slVKuQyEz8Qj4E3uLPYNXg: posts big blind $1
*** HOLE CARDS ***
Z2fXsGcjl+Eax+RzOgwOmg has timed out
Z2fXsGcjl+Eax+RzOgwOmg: folds
Z2fXsGcjl+Eax+RzOgwOmg is sitting out
2UMlbaZ8n8AbRli0Yr0mDw: calls $1
Z2fXsGcjl+Eax+RzOgwOmg has returned
TSuRyAHnUPCFjP7Z0rEE0w: folds
w02zQzNydODiyV9THKgo9w: calls $1
ozrlafxxh1HmYdA0/h+MuA: calls $0.50
slVKuQyEz8Qj4E3uLPYNXg: checks
*** FLOP *** [Ks Js 6h]
ozrlafxxh1HmYdA0/h+MuA: checks
slVKuQyEz8Qj4E3uLPYNXg: checks
2UMlbaZ8n8AbRli0Yr0mDw: bets $3
w02zQzNydODiyV9THKgo9w: folds
TSuRyAHnUPCFjP7Z0rEE0w is sitting out
ozrlafxxh1HmYdA0/h+MuA: folds
slVKuQyEz8Qj4E3uLPYNXg: folds
2UMlbaZ8n8AbRli0Yr0mDw collected $3.80 from pot
2UMlbaZ8n8AbRli0Yr0mDw: doesn't show hand
*** SUMMARY ***
Total pot $4 | Rake $0.20
Board [Ks Js 6h]
Seat 1: Z2fXsGcjl+Eax+RzOgwOmg folded before Flop (didn't bet)
Seat 2: 2UMlbaZ8n8AbRli0Yr0mDw collected ($3.80)
Seat 3: TSuRyAHnUPCFjP7Z0rEE0w folded before Flop (didn't bet)
Seat 4: w02zQzNydODiyV9THKgo9w (button) folded on the Flop
Seat 5: ozrlafxxh1HmYdA0/h+MuA (small blind) folded on the Flop
Seat 6: slVKuQyEz8Qj4E3uLPYNXg (big blind) folded on the Flop



PokerStars Game #59940416498:  Hold'em No Limit ($0.50/$1.00) - 2009/07/01 1:06:01 ET
Table 'eU3bWpDDg3Z+9R4m4iVmog' 6-max Seat #3 is the button
Seat 1: TSuRyAHnUPCFjP7Z0rEE0w ($177.15 in chips)
Seat 2: 8CAoOzhmB8n3nRFf3V4BTg ($71.40 in chips)
Seat 3: rVMOzU7w5FddYPGhD7qN2Q ($40.55 in chips)
Seat 4: GDVIsbEJ/DOJsMKE4Asz0A ($117.20 in chips)
Seat 6: hpxXcmRkXXI9HE5+5/j/0Q ($117.75 in chips)
GDVIsbEJ/DOJsMKE4Asz0A: posts small blind $0.50
hpxXcmRkXXI9HE5+5/j/0Q: posts big blind $1
*** HOLE CARDS ***
TSuRyAHnUPCFjP7Z0rEE0w: folds
TSuRyAHnUPCFjP7Z0rEE0w leaves the table
8CAoOzhmB8n3nRFf3V4BTg: folds
rVMOzU7w5FddYPGhD7qN2Q: folds
GDVIsbEJ/DOJsMKE4Asz0A: calls $0.50
hpxXcmRkXXI9HE5+5/j/0Q: checks
*** FLOP *** [Kd 4h Ad]
GDVIsbEJ/DOJsMKE4Asz0A: checks
hpxXcmRkXXI9HE5+5/j/0Q: bets $2
GDVIsbEJ/DOJsMKE4Asz0A: calls $2
*** TURN *** [Kd 4h Ad] [Qh]
GDVIsbEJ/DOJsMKE4Asz0A: checks
hpxXcmRkXXI9HE5+5/j/0Q: checks
*** RIVER *** [Kd 4h Ad Qh] [6h]
GDVIsbEJ/DOJsMKE4Asz0A: checks
hpxXcmRkXXI9HE5+5/j/0Q: checks
*** SHOW DOWN ***
GDVIsbEJ/DOJsMKE4Asz0A: shows [Jd 8d] (high card Ace)
hpxXcmRkXXI9HE5+5/j/0Q: shows [As 3s] (a pair of Aces)
hpxXcmRkXXI9HE5+5/j/0Q collected $5.75 from pot
*** SUMMARY ***
Total pot $6 | Rake $0.25
Board [Kd 4h Ad Qh 6h]
Seat 1: TSuRyAHnUPCFjP7Z0rEE0w folded before Flop (didn't bet)
Seat 2: 8CAoOzhmB8n3nRFf3V4BTg folded before Flop (didn't bet)
Seat 3: rVMOzU7w5FddYPGhD7qN2Q (button) folded before Flop (didn't bet)
Seat 4: GDVIsbEJ/DOJsMKE4Asz0A (small blind) showed [Jd 8d] and lost with high card Ace
Seat 6: hpxXcmRkXXI9HE5+5/j/0Q (big blind) showed [As 3s] and won ($5.75) with a pair of Aces



PokerStars Game #59940416700:  Hold'em No Limit ($0.50/$1.00) - 2009/07/01 1:06:02 ET
Table '6YvsYDPNIDx2v5z3bJnwZQ' 9-max Seat #1 is the button
Seat 1: Ogn4JDV3mp4ZDKO49IFzKA ($18.70 in chips)
Seat 2: +hHqYgKILitkxIzFNGvvsA ($33.25 in chips)
Seat 4: kEr5NYB+JIG5+szcYMr6hA ($45.80 in chips)
Seat 5: mBRWbnUl8diyBO1qTJaNzw ($162.20 in chips)
Seat 6: 7RSwrjMohkYrZAhOd1uaZg ($16.20 in chips)
Seat 7: mae7OMTaJ/MFimNbZegCkg ($48.30 in chips)
Seat 8: PSFxpXgPedVZyHSu2Zhb7Q ($114.20 in chips)
+hHqYgKILitkxIzFNGvvsA: posts small blind $0.50
negfosHnGOZXSHpWDRKyBQ: is sitting out
kEr5NYB+JIG5+szcYMr6hA: posts big blind $1
VPF+HjszMvUIpy0CHIwH3A: sits out
*** HOLE CARDS ***
negfosHnGOZXSHpWDRKyBQ leaves the table
mBRWbnUl8diyBO1qTJaNzw: folds
7RSwrjMohkYrZAhOd1uaZg: calls $1
mae7OMTaJ/MFimNbZegCkg: folds
PSFxpXgPedVZyHSu2Zhb7Q: folds
Ogn4JDV3mp4ZDKO49IFzKA: raises $17.70 to $18.70 and is all-in
+hHqYgKILitkxIzFNGvvsA: folds
kEr5NYB+JIG5+szcYMr6hA: folds
7RSwrjMohkYrZAhOd1uaZg: folds
Ogn4JDV3mp4ZDKO49IFzKA collected $3.50 from pot
*** SUMMARY ***
Total pot $3.50 | Rake $0
Seat 1: Ogn4JDV3mp4ZDKO49IFzKA (button) collected ($3.50)
Seat 2: +hHqYgKILitkxIzFNGvvsA (small blind) folded before Flop
Seat 4: kEr5NYB+JIG5+szcYMr6hA (big blind) folded before Flop
Seat 5: mBRWbnUl8diyBO1qTJaNzw folded before Flop (didn't bet)
Seat 6: 7RSwrjMohkYrZAhOd1uaZg folded before Flop
Seat 7: mae7OMTaJ/MFimNbZegCkg folded before Flop (didn't bet)
Seat 8: PSFxpXgPedVZyHSu2Zhb7Q folded before Flop (didn't bet)



PokerStars Game #59940417716:  Hold'em No Limit ($0.50/$1.00) - 2009/07/01 1:06:03 ET
Table 'N2bNCDHL96aCQDvZIh+yQQ' 6-max Seat #5 is the button
Seat 2: TIB5eSBJLz62w6yz2+yeKw ($90.50 in chips)
Seat 3: Qy/UBNbD2HaA0Ogxg8Sf3w ($235.20 in chips)
Seat 4: uCqEjnxh2/vFBjKYkfTOkw ($196.55 in chips)
Seat 5: 8OEJHwpMpZZfyaTpXEDFfw ($27.75 in chips)
Seat 6: TSuRyAHnUPCFjP7Z0rEE0w ($102.30 in chips)
TSuRyAHnUPCFjP7Z0rEE0w: posts small blind $0.50
TIB5eSBJLz62w6yz2+yeKw: posts big blind $1
*** HOLE CARDS ***
Qy/UBNbD2HaA0Ogxg8Sf3w: folds
uCqEjnxh2/vFBjKYkfTOkw: folds
8OEJHwpMpZZfyaTpXEDFfw: calls $1
TSuRyAHnUPCFjP7Z0rEE0w: folds
TIB5eSBJLz62w6yz2+yeKw: checks
*** FLOP *** [4h 9h 5s]
TIB5eSBJLz62w6yz2+yeKw: checks
8OEJHwpMpZZfyaTpXEDFfw: checks
*** TURN *** [4h 9h 5s] [3h]
TIB5eSBJLz62w6yz2+yeKw: checks
8OEJHwpMpZZfyaTpXEDFfw: bets $6
TIB5eSBJLz62w6yz2+yeKw: folds
8OEJHwpMpZZfyaTpXEDFfw collected $2.40 from pot
*** SUMMARY ***
Total pot $2.50 | Rake $0.10
Board [4h 9h 5s 3h]
Seat 2: TIB5eSBJLz62w6yz2+yeKw (big blind) folded on the Turn
Seat 3: Qy/UBNbD2HaA0Ogxg8Sf3w folded before Flop (didn't bet)
Seat 4: uCqEjnxh2/vFBjKYkfTOkw folded before Flop (didn't bet)
Seat 5: 8OEJHwpMpZZfyaTpXEDFfw (button) collected ($2.40)
Seat 6: TSuRyAHnUPCFjP7Z0rEE0w (small blind) folded before Flop



PokerStars Game #59940417842:  Hold'em No Limit ($0.50/$1.00) - 2009/07/01 1:06:04 ET
Table 'mmbQQVBTrPdE+wy+s+9VPA' 6-max Seat #6 is the button
Seat 1: zyP4SPoWZnKUfTvIRLCVog ($74.55 in chips)
Seat 2: cl/QpVR/PLO58lj+C5mGLw ($9.90 in chips)
Seat 3: wx3sQGkVi2x9wJXuWNHPBw ($111.65 in chips)
Seat 4: V3iZdcw61nXF3g5hD2RrsQ ($111.30 in chips)
Seat 5: YMJG+F++3Aj6P8dAWda5fw ($100 in chips)
Seat 6: U2CWBTv29qdCbj8RNF2sIw ($87.95 in chips)
zyP4SPoWZnKUfTvIRLCVog: posts small blind $0.50
cl/QpVR/PLO58lj+C5mGLw: posts big blind $1
*** HOLE CARDS ***
wx3sQGkVi2x9wJXuWNHPBw: folds
V3iZdcw61nXF3g5hD2RrsQ: raises $2 to $3
YMJG+F++3Aj6P8dAWda5fw: folds
U2CWBTv29qdCbj8RNF2sIw: folds
zyP4SPoWZnKUfTvIRLCVog: folds
cl/QpVR/PLO58lj+C5mGLw: calls $2
*** FLOP *** [7c 3d Qh]
cl/QpVR/PLO58lj+C5mGLw: checks
V3iZdcw61nXF3g5hD2RrsQ: bets $7
cl/QpVR/PLO58lj+C5mGLw: calls $6.90 and is all-in
*** TURN *** [7c 3d Qh] [Ad]
*** RIVER *** [7c 3d Qh Ad] [Kc]
*** SHOW DOWN ***
cl/QpVR/PLO58lj+C5mGLw: shows [Ah 3c] (two pair, Aces and Threes)
V3iZdcw61nXF3g5hD2RrsQ: shows [7s As] (two pair, Aces and Sevens)
V3iZdcw61nXF3g5hD2RrsQ collected $19.30 from pot
*** SUMMARY ***
Total pot $20.30 | Rake $1
Board [7c 3d Qh Ad Kc]
Seat 1: zyP4SPoWZnKUfTvIRLCVog (small blind) folded before Flop
Seat 2: cl/QpVR/PLO58lj+C5mGLw (big blind) showed [Ah 3c] and lost with two pair, Aces and Threes
Seat 3: wx3sQGkVi2x9wJXuWNHPBw folded before Flop (didn't bet)
Seat 4: V3iZdcw61nXF3g5hD2RrsQ showed [7s As] and won ($19.30) with two pair, Aces and Sevens
Seat 5: YMJG+F++3Aj6P8dAWda5fw folded before Flop (didn't bet)
Seat 6: U2CWBTv29qdCbj8RNF2sIw (button) folded before Flop (didn't bet)



PokerStars Game #59940418216:  Hold'em No Limit ($0.50/$1.00) - 2009/07/01 1:06:04 ET
Table 'W/wyObTiXZm+Ckkl3YxcSw' 6-max Seat #6 is the button
Seat 1: eUBBn2R56C1IQ6Cs/vitwg ($187.25 in chips)
Seat 2: oDiBRCaF0QVtd3kO6xZIXw ($117.85 in chips)
Seat 3: dxyNCn/qxfkGDUIf28Cbng ($81.40 in chips)
Seat 4: aYii2DmxlOlbC1wbGRBWvQ ($101.70 in chips)
Seat 5: MFptnnT6AnJakWBooTkmeg ($25.65 in chips)
Seat 6: OGMLOcTNYZXZU81au7ztUw ($100.50 in chips)
eUBBn2R56C1IQ6Cs/vitwg: posts small blind $0.50
oDiBRCaF0QVtd3kO6xZIXw: posts big blind $1
*** HOLE CARDS ***
dxyNCn/qxfkGDUIf28Cbng: folds
aYii2DmxlOlbC1wbGRBWvQ: folds
MFptnnT6AnJakWBooTkmeg: folds
OGMLOcTNYZXZU81au7ztUw: raises $2 to $3
eUBBn2R56C1IQ6Cs/vitwg: folds
oDiBRCaF0QVtd3kO6xZIXw: folds
OGMLOcTNYZXZU81au7ztUw collected $2.50 from pot
OGMLOcTNYZXZU81au7ztUw: doesn't show hand
*** SUMMARY ***
Total pot $2.50 | Rake $0
Seat 1: eUBBn2R56C1IQ6Cs/vitwg (small blind) folded before Flop
Seat 2: oDiBRCaF0QVtd3kO6xZIXw (big blind) folded before Flop
Seat 3: dxyNCn/qxfkGDUIf28Cbng folded before Flop (didn't bet)
Seat 4: aYii2DmxlOlbC1wbGRBWvQ folded before Flop (didn't bet)
Seat 5: MFptnnT6AnJakWBooTkmeg folded before Flop (didn't bet)
Seat 6: OGMLOcTNYZXZU81au7ztUw (button) collected ($2.50)



PokerStars Game #59940418946:  Hold'em No Limit ($0.50/$1.00) - 2009/07/01 1:06:05 ET
Table 'CASNP0uy1C+jGLml/I4PtA' 9-max Seat #6 is the button
Seat 1: tkdBeXTJlFsZdioidNqLow ($60 in chips)
Seat 3: bJckevFOcg//s0qyMQI6sQ ($102.40 in chips)
Seat 4: B/G0GJacqZ8K59/ZVdq4kQ ($53.70 in chips)
Seat 5: Jjc7EHWzs4//xUAjJ0UWoA ($14.50 in chips)
Seat 6: FJEywSpo5JbRKByzmweboA ($100 in chips)
Seat 8: L9njYvloJ1NdXjP8edHEAg ($100.50 in chips)
Seat 9: Pp/KTcXkfZKKUHkjyaLTdg ($20 in chips)
L9njYvloJ1NdXjP8edHEAg: posts small blind $0.50
Pp/KTcXkfZKKUHkjyaLTdg: posts big blind $1
*** HOLE CARDS ***
tkdBeXTJlFsZdioidNqLow: folds
bJckevFOcg//s0qyMQI6sQ: folds
B/G0GJacqZ8K59/ZVdq4kQ: folds
Jjc7EHWzs4//xUAjJ0UWoA: folds
FJEywSpo5JbRKByzmweboA: folds
L9njYvloJ1NdXjP8edHEAg: folds
Pp/KTcXkfZKKUHkjyaLTdg collected $1 from pot
*** SUMMARY ***
Total pot $1 | Rake $0
Seat 1: tkdBeXTJlFsZdioidNqLow folded before Flop (didn't bet)
Seat 3: bJckevFOcg//s0qyMQI6sQ folded before Flop (didn't bet)
Seat 4: B/G0GJacqZ8K59/ZVdq4kQ folded before Flop (didn't bet)
Seat 5: Jjc7EHWzs4//xUAjJ0UWoA folded before Flop (didn't bet)
Seat 6: FJEywSpo5JbRKByzmweboA (button) folded before Flop (didn't bet)
Seat 8: L9njYvloJ1NdXjP8edHEAg (small blind) folded before Flop
Seat 9: Pp/KTcXkfZKKUHkjyaLTdg (big blind) collected ($1)



PokerStars Game #59940418710:  Hold'em No Limit ($0.50/$1.00) - 2009/07/01 1:06:05 ET
Table 'Zka9tv1yilg0MvXWPQrShg' 9-max Seat #2 is the button
Seat 2: kz9ziSiGUc+857heiKSayw ($21.20 in chips)
Seat 3: gUUvmqdVlmvpal6B8nYrmg ($106.95 in chips)
Seat 5: /zy+DB4S5fUQUSfZWFzYGw ($112.60 in chips)
Seat 6: rY8wPoax1lS+HUY+I0FZDw ($160.60 in chips)
Seat 7: p1SafS90nb3Uft5LB0NkHw ($23.50 in chips)
Seat 8: D+W9Me7w6Hcx/WRUSKV0dw ($18.50 in chips)
Seat 9: 6daxhj43mWj04MOPTOmaYA ($106.40 in chips)
gUUvmqdVlmvpal6B8nYrmg: posts small blind $0.50
/zy+DB4S5fUQUSfZWFzYGw: posts big blind $1
*** HOLE CARDS ***
rY8wPoax1lS+HUY+I0FZDw: folds
p1SafS90nb3Uft5LB0NkHw: raises $3 to $4
D+W9Me7w6Hcx/WRUSKV0dw: folds
6daxhj43mWj04MOPTOmaYA: folds
kz9ziSiGUc+857heiKSayw: folds
gUUvmqdVlmvpal6B8nYrmg: folds
/zy+DB4S5fUQUSfZWFzYGw: folds
p1SafS90nb3Uft5LB0NkHw collected $2.50 from pot
*** SUMMARY ***
Total pot $2.50 | Rake $0
Seat 2: kz9ziSiGUc+857heiKSayw (button) folded before Flop (didn't bet)
Seat 3: gUUvmqdVlmvpal6B8nYrmg (small blind) folded before Flop
Seat 5: /zy+DB4S5fUQUSfZWFzYGw (big blind) folded before Flop
Seat 6: rY8wPoax1lS+HUY+I0FZDw folded before Flop (didn't bet)
Seat 7: p1SafS90nb3Uft5LB0NkHw collected ($2.50)
Seat 8: D+W9Me7w6Hcx/WRUSKV0dw folded before Flop (didn't bet)
Seat 9: 6daxhj43mWj04MOPTOmaYA folded before Flop (didn't bet)



PokerStars Game #59940419394:  Hold'em No Limit ($0.50/$1.00) - 2009/07/01 1:06:06 ET
Table '7Nl0ffnjeK44/vmeexh3MQ' 9-max Seat #4 is the button
Seat 1: s7D3Y+k4Cj4D1cXHv7oj+Q ($93.85 in chips)
Seat 2: OGgaARGdJQT4awWVNQ957w ($100 in chips)
Seat 3: JMmUYT5pIKCKh2pGjCB/4w ($40 in chips)
Seat 4: bLbSOSmSOnqE0iTcH/5dxA ($100 in chips)
Seat 5: 61sfw5QTu62YYIt68OsdrA ($65.90 in chips)
Seat 6: FVs16t7GgfWgQWt4JxsObQ ($47.15 in chips)
Seat 7: 997ViqAtWn1FPjJqcffwcA ($100 in chips)
Seat 8: D+W9Me7w6Hcx/WRUSKV0dw ($19.75 in chips)
Seat 9: ouwUBGRKnKK9uhn1G4Lf+A ($195.50 in chips)
61sfw5QTu62YYIt68OsdrA: posts small blind $0.50
FVs16t7GgfWgQWt4JxsObQ: posts big blind $1
JMmUYT5pIKCKh2pGjCB/4w: posts big blind $1
*** HOLE CARDS ***
997ViqAtWn1FPjJqcffwcA: folds
D+W9Me7w6Hcx/WRUSKV0dw: folds
ouwUBGRKnKK9uhn1G4Lf+A: folds
s7D3Y+k4Cj4D1cXHv7oj+Q: folds
OGgaARGdJQT4awWVNQ957w: folds
JMmUYT5pIKCKh2pGjCB/4w: checks
bLbSOSmSOnqE0iTcH/5dxA: folds
61sfw5QTu62YYIt68OsdrA: calls $0.50
FVs16t7GgfWgQWt4JxsObQ: checks
*** FLOP *** [3c 8h 3s]
61sfw5QTu62YYIt68OsdrA: checks
FVs16t7GgfWgQWt4JxsObQ: checks
JMmUYT5pIKCKh2pGjCB/4w: bets $1
61sfw5QTu62YYIt68OsdrA: folds
FVs16t7GgfWgQWt4JxsObQ: calls $1
*** TURN *** [3c 8h 3s] [Kh]
FVs16t7GgfWgQWt4JxsObQ: bets $1
JMmUYT5pIKCKh2pGjCB/4w: calls $1
*** RIVER *** [3c 8h 3s Kh] [Ac]
FVs16t7GgfWgQWt4JxsObQ: bets $3
JMmUYT5pIKCKh2pGjCB/4w: folds
FVs16t7GgfWgQWt4JxsObQ collected $6.70 from pot
*** SUMMARY ***
Total pot $7 | Rake $0.30
Board [3c 8h 3s Kh Ac]
Seat 1: s7D3Y+k4Cj4D1cXHv7oj+Q folded before Flop (didn't bet)
Seat 2: OGgaARGdJQT4awWVNQ957w folded before Flop (didn't bet)
Seat 3: JMmUYT5pIKCKh2pGjCB/4w folded on the River
Seat 4: bLbSOSmSOnqE0iTcH/5dxA (button) folded before Flop (didn't bet)
Seat 5: 61sfw5QTu62YYIt68OsdrA (small blind) folded on the Flop
Seat 6: FVs16t7GgfWgQWt4JxsObQ (big blind) collected ($6.70)
Seat 7: 997ViqAtWn1FPjJqcffwcA folded before Flop (didn't bet)
Seat 8: D+W9Me7w6Hcx/WRUSKV0dw folded before Flop (didn't bet)
Seat 9: ouwUBGRKnKK9uhn1G4Lf+A folded before Flop (didn't bet)



PokerStars Game #59940422024:  Hold'em No Limit ($0.50/$1.00) - 2009/07/01 1:06:11 ET
Table '8jIjWCPY0NGprquL+xcMFg' 9-max Seat #1 is the button
Seat 1: N7iZ0peZns5o4A6AjN24jQ ($43.90 in chips)
Seat 2: laA8va+Yv8WuMqT1zdR91g ($107.70 in chips)
Seat 4: Jjc7EHWzs4//xUAjJ0UWoA ($19.10 in chips)
Seat 5: 2YpnxJiexJHyERfbqgwEcw ($53.55 in chips)
Seat 6: GTQkFJtSkbVbnGCktp6e3g ($100 in chips)
Seat 7: O3CGPwwUmamrCNHccOilrg ($38.60 in chips)
Seat 8: D+W9Me7w6Hcx/WRUSKV0dw ($17 in chips)
laA8va+Yv8WuMqT1zdR91g: posts small blind $0.50
Jjc7EHWzs4//xUAjJ0UWoA: posts big blind $1
*** HOLE CARDS ***
2YpnxJiexJHyERfbqgwEcw: folds
GTQkFJtSkbVbnGCktp6e3g: folds
O3CGPwwUmamrCNHccOilrg: raises $3 to $4
D+W9Me7w6Hcx/WRUSKV0dw: folds
N7iZ0peZns5o4A6AjN24jQ: folds
2YpnxJiexJHyERfbqgwEcw leaves the table
laA8va+Yv8WuMqT1zdR91g: folds
Jjc7EHWzs4//xUAjJ0UWoA: folds
O3CGPwwUmamrCNHccOilrg collected $2.50 from pot
O3CGPwwUmamrCNHccOilrg: doesn't show hand
*** SUMMARY ***
Total pot $2.50 | Rake $0
Seat 1: N7iZ0peZns5o4A6AjN24jQ (button) folded before Flop (didn't bet)
Seat 2: laA8va+Yv8WuMqT1zdR91g (small blind) folded before Flop
Seat 4: Jjc7EHWzs4//xUAjJ0UWoA (big blind) folded before Flop
Seat 5: 2YpnxJiexJHyERfbqgwEcw folded before Flop (didn't bet)
Seat 6: GTQkFJtSkbVbnGCktp6e3g folded before Flop (didn't bet)
Seat 7: O3CGPwwUmamrCNHccOilrg collected ($2.50)
Seat 8: D+W9Me7w6Hcx/WRUSKV0dw folded before Flop (didn't bet)



PokerStars Game #59940422898:  Hold'em No Limit ($0.50/$1.00) - 2009/07/01 1:06:12 ET
Table 'cBDNutyLBKEk9+ptwsKmTw' 6-max Seat #5 is the button
Seat 1: xAU6q2/cwmby2sxmA8VcmA ($109.85 in chips)
Seat 2: 5lY8d6Cnm4HUkt/8FZSj4g ($33.50 in chips)
Seat 3: G5ZSSN6RSON3gkNvk/SmYg ($100.15 in chips)
Seat 4: 3q7F5QtzC30pSrn0nl9i+A ($26.80 in chips)
Seat 5: OGMLOcTNYZXZU81au7ztUw ($169.40 in chips)
Seat 6: NqVlOSH2lp+pp/TK3vvK5g ($87.65 in chips)
NqVlOSH2lp+pp/TK3vvK5g: posts small blind $0.50
xAU6q2/cwmby2sxmA8VcmA: posts big blind $1
*** HOLE CARDS ***
5lY8d6Cnm4HUkt/8FZSj4g: folds
G5ZSSN6RSON3gkNvk/SmYg: folds
3q7F5QtzC30pSrn0nl9i+A: calls $1
OGMLOcTNYZXZU81au7ztUw: raises $3 to $4
NqVlOSH2lp+pp/TK3vvK5g: folds
xAU6q2/cwmby2sxmA8VcmA: calls $3
3q7F5QtzC30pSrn0nl9i+A: calls $3
*** FLOP *** [5c 4s 2h]
xAU6q2/cwmby2sxmA8VcmA: checks
3q7F5QtzC30pSrn0nl9i+A: bets $3
OGMLOcTNYZXZU81au7ztUw: folds
xAU6q2/cwmby2sxmA8VcmA: raises $19 to $22
3q7F5QtzC30pSrn0nl9i+A: folds
xAU6q2/cwmby2sxmA8VcmA collected $17.65 from pot
xAU6q2/cwmby2sxmA8VcmA: doesn't show hand
*** SUMMARY ***
Total pot $18.50 | Rake $0.85
Board [5c 4s 2h]
Seat 1: xAU6q2/cwmby2sxmA8VcmA (big blind) collected ($17.65)
Seat 2: 5lY8d6Cnm4HUkt/8FZSj4g folded before Flop (didn't bet)
Seat 3: G5ZSSN6RSON3gkNvk/SmYg folded before Flop (didn't bet)
Seat 4: 3q7F5QtzC30pSrn0nl9i+A folded on the Flop
Seat 5: OGMLOcTNYZXZU81au7ztUw (button) folded on the Flop
Seat 6: NqVlOSH2lp+pp/TK3vvK5g (small blind) folded before Flop



PokerStars Game #59940422794:  Hold'em No Limit ($0.50/$1.00) - 2009/07/01 1:06:12 ET
Table 'JTT1XWaDZHSaMZQK7cR5uw' 2-max Seat #1 is the button
Seat 1: OLplZF6FEnLflv81Hz+Fxg ($138.45 in chips)
Seat 2: BcqgegiOUxmBD3F3umsljg ($69.75 in chips)
OLplZF6FEnLflv81Hz+Fxg: posts small blind $0.50
BcqgegiOUxmBD3F3umsljg: posts big blind $1
*** HOLE CARDS ***
OLplZF6FEnLflv81Hz+Fxg: raises $2 to $3
BcqgegiOUxmBD3F3umsljg: folds
OLplZF6FEnLflv81Hz+Fxg collected $2 from pot
*** SUMMARY ***
Total pot $2 | Rake $0
Seat 1: OLplZF6FEnLflv81Hz+Fxg (button) (small blind) collected ($2)
Seat 2: BcqgegiOUxmBD3F3umsljg (big blind) folded before Flop



PokerStars Game #59940424278:  Hold'em No Limit ($0.50/$1.00) - 2009/07/01 1:06:14 ET
Table 'QSIig7BLMc9wY/rgBechzw' 6-max Seat #2 is the button
Seat 1: Z2fXsGcjl+Eax+RzOgwOmg ($107 in chips)
Seat 2: mLOIkH/qmRa+mVujQIhBRg ($42.40 in chips)
Seat 3: +xW7QemQU0Fxs+4TnqBRow ($100 in chips)
Seat 4: +uSzP8Jwnw7sKfQ4s66b7w ($87.45 in chips)
Seat 6: PxqfkAMdAWtkgbT+q2gciA ($28.70 in chips)
+xW7QemQU0Fxs+4TnqBRow: posts small blind $0.50
+uSzP8Jwnw7sKfQ4s66b7w: posts big blind $1
lsLuWlcPA3Rh7kJVLzMh0Q: sits out
*** HOLE CARDS ***
PxqfkAMdAWtkgbT+q2gciA: calls $1
Z2fXsGcjl+Eax+RzOgwOmg has timed out
Z2fXsGcjl+Eax+RzOgwOmg: folds
Z2fXsGcjl+Eax+RzOgwOmg is sitting out
mLOIkH/qmRa+mVujQIhBRg: calls $1
+xW7QemQU0Fxs+4TnqBRow: raises $5 to $6
Z2fXsGcjl+Eax+RzOgwOmg has returned
+uSzP8Jwnw7sKfQ4s66b7w: folds
PxqfkAMdAWtkgbT+q2gciA: calls $5
mLOIkH/qmRa+mVujQIhBRg: calls $5
*** FLOP *** [9s Jd 3c]
+xW7QemQU0Fxs+4TnqBRow: checks
PxqfkAMdAWtkgbT+q2gciA: checks
mLOIkH/qmRa+mVujQIhBRg: checks
*** TURN *** [9s Jd 3c] [Js]
+xW7QemQU0Fxs+4TnqBRow: checks
PxqfkAMdAWtkgbT+q2gciA: bets $8
mLOIkH/qmRa+mVujQIhBRg: folds
+xW7QemQU0Fxs+4TnqBRow: folds
PxqfkAMdAWtkgbT+q2gciA collected $18.05 from pot
*** SUMMARY ***
Total pot $19 | Rake $0.95
Board [9s Jd 3c Js]
Seat 1: Z2fXsGcjl+Eax+RzOgwOmg folded before Flop (didn't bet)
Seat 2: mLOIkH/qmRa+mVujQIhBRg (button) folded on the Turn
Seat 3: +xW7QemQU0Fxs+4TnqBRow (small blind) folded on the Turn
Seat 4: +uSzP8Jwnw7sKfQ4s66b7w (big blind) folded before Flop
Seat 6: PxqfkAMdAWtkgbT+q2gciA collected ($18.05)



PokerStars Game #59940426368:  Hold'em No Limit ($0.50/$1.00) - 2009/07/01 1:06:18 ET
Table 'kS0cTQAEi+fdUlJP2gQYvw' 9-max Seat #3 is the button
Seat 1: c/9X4zftzphFxYtxp5kp9w ($64.35 in chips)
Seat 2: D+W9Me7w6Hcx/WRUSKV0dw ($22.40 in chips)
Seat 3: 2BV+oJIQYr65IO6nEChvbA ($60 in chips)
Seat 5: 997ViqAtWn1FPjJqcffwcA ($103.15 in chips)
Seat 6: yAbu2QsRPVcjPbqlf/jDxw ($127.65 in chips)
Seat 7: Ffa7Nj4X5fddtROP01hfQg ($126.55 in chips)
Seat 8: QYMfy2FoN6/Qe1LWYuI7fw ($26.45 in chips)
Seat 9: OGgaARGdJQT4awWVNQ957w ($102 in chips)
997ViqAtWn1FPjJqcffwcA: posts small blind $0.50
yAbu2QsRPVcjPbqlf/jDxw: posts big blind $1
*** HOLE CARDS ***
Ffa7Nj4X5fddtROP01hfQg: raises $1 to $2
QYMfy2FoN6/Qe1LWYuI7fw: folds
OGgaARGdJQT4awWVNQ957w: folds
c/9X4zftzphFxYtxp5kp9w: folds
D+W9Me7w6Hcx/WRUSKV0dw: folds
2BV+oJIQYr65IO6nEChvbA: folds
997ViqAtWn1FPjJqcffwcA: folds
yAbu2QsRPVcjPbqlf/jDxw: calls $1
*** FLOP *** [4c 7c Jh]
yAbu2QsRPVcjPbqlf/jDxw: checks
Ffa7Nj4X5fddtROP01hfQg: bets $3
yAbu2QsRPVcjPbqlf/jDxw: folds
Ffa7Nj4X5fddtROP01hfQg collected $4.30 from pot
*** SUMMARY ***
Total pot $4.50 | Rake $0.20
Board [4c 7c Jh]
Seat 1: c/9X4zftzphFxYtxp5kp9w folded before Flop (didn't bet)
Seat 2: D+W9Me7w6Hcx/WRUSKV0dw folded before Flop (didn't bet)
Seat 3: 2BV+oJIQYr65IO6nEChvbA (button) folded before Flop (didn't bet)
Seat 5: 997ViqAtWn1FPjJqcffwcA (small blind) folded before Flop
Seat 6: yAbu2QsRPVcjPbqlf/jDxw (big blind) folded on the Flop
Seat 7: Ffa7Nj4X5fddtROP01hfQg collected ($4.30)
Seat 8: QYMfy2FoN6/Qe1LWYuI7fw folded before Flop (didn't bet)
Seat 9: OGgaARGdJQT4awWVNQ957w folded before Flop (didn't bet)



PokerStars Game #59940426232:  Hold'em No Limit ($0.50/$1.00) - 2009/07/01 1:06:18 ET
Table 'pHrhryH8jPNdQfY62f8v+g' 6-max Seat #6 is the button
Seat 2: RqgF7gRoKgRNW8Zoi1ty4A ($138.30 in chips)
Seat 3: 8oS5O7iD/qnFXFXJrGIgNQ ($100 in chips)
Seat 5: r1/R7y0Ortgoz4lccgW8VA ($41.05 in chips)
Seat 6: xAU6q2/cwmby2sxmA8VcmA ($208.10 in chips)
RqgF7gRoKgRNW8Zoi1ty4A: posts small blind $0.50
8oS5O7iD/qnFXFXJrGIgNQ: posts big blind $1
1f3beyIML24UqEMTbWy93g: sits out
*** HOLE CARDS ***
r1/R7y0Ortgoz4lccgW8VA: folds
xAU6q2/cwmby2sxmA8VcmA: folds
RqgF7gRoKgRNW8Zoi1ty4A: raises $2 to $3
8oS5O7iD/qnFXFXJrGIgNQ: calls $2
*** FLOP *** [5c Js 5s]
RqgF7gRoKgRNW8Zoi1ty4A: bets $4
8oS5O7iD/qnFXFXJrGIgNQ: folds
4d1rWhpu8DzLmzMbR3QKyA has returned
RqgF7gRoKgRNW8Zoi1ty4A collected $5.70 from pot
*** SUMMARY ***
Total pot $6 | Rake $0.30
Board [5c Js 5s]
Seat 2: RqgF7gRoKgRNW8Zoi1ty4A (small blind) collected ($5.70)
Seat 3: 8oS5O7iD/qnFXFXJrGIgNQ (big blind) folded on the Flop
Seat 5: r1/R7y0Ortgoz4lccgW8VA folded before Flop (didn't bet)
Seat 6: xAU6q2/cwmby2sxmA8VcmA (button) folded before Flop (didn't bet)



PokerStars Game #59940427798:  Hold'em No Limit ($0.50/$1.00) - 2009/07/01 1:06:21 ET
Table 'JTT1XWaDZHSaMZQK7cR5uw' 2-max Seat #2 is the button
Seat 1: OLplZF6FEnLflv81Hz+Fxg ($139.45 in chips)
Seat 2: BcqgegiOUxmBD3F3umsljg ($68.75 in chips)
BcqgegiOUxmBD3F3umsljg: posts small blind $0.50
OLplZF6FEnLflv81Hz+Fxg: posts big blind $1
*** HOLE CARDS ***
BcqgegiOUxmBD3F3umsljg: raises $1 to $2
OLplZF6FEnLflv81Hz+Fxg: raises $5 to $7
BcqgegiOUxmBD3F3umsljg: calls $5
*** FLOP *** [8h Qs Ad]
OLplZF6FEnLflv81Hz+Fxg: checks
BcqgegiOUxmBD3F3umsljg: bets $5
OLplZF6FEnLflv81Hz+Fxg: calls $5
*** TURN *** [8h Qs Ad] [As]
OLplZF6FEnLflv81Hz+Fxg: checks
BcqgegiOUxmBD3F3umsljg: bets $10
OLplZF6FEnLflv81Hz+Fxg: folds
BcqgegiOUxmBD3F3umsljg collected $23.50 from pot
*** SUMMARY ***
Total pot $24 | Rake $0.50
Board [8h Qs Ad As]
Seat 1: OLplZF6FEnLflv81Hz+Fxg (big blind) folded on the Turn
Seat 2: BcqgegiOUxmBD3F3umsljg (button) (small blind) collected ($23.50)



PokerStars Game #59940428562:  Hold'em No Limit ($0.50/$1.00) - 2009/07/01 1:06:22 ET
Table 'GPp0HyAuggN8oE0sUWzPpA' 9-max Seat #3 is the button
Seat 1: qJr25HAtvv1w/7IBvjMM3g ($42.70 in chips)
Seat 2: m3U8I35Pn3gxKhoS2nmYIg ($40.05 in chips)
Seat 3: CCCXsirC+bO7ginAuUUVlQ ($49 in chips)
Seat 4: mBRWbnUl8diyBO1qTJaNzw ($109.15 in chips)
Seat 6: BK/GtNPkSx0TdUDj82id5A ($17.85 in chips)
Seat 7: DHdbHyysD15wCAtx+BhUjA ($95 in chips)
Seat 8: 6DBvLniKMJADk/t5l29oMA ($25.15 in chips)
Seat 9: dzoSjPZmtjGuK83119030A ($29 in chips)
mBRWbnUl8diyBO1qTJaNzw: posts small blind $0.50
0fXz44fzDo5QmhAaJCvFfA: is sitting out
0fXz44fzDo5QmhAaJCvFfA leaves the table
BK/GtNPkSx0TdUDj82id5A: posts big blind $1
*** HOLE CARDS ***
DHdbHyysD15wCAtx+BhUjA: folds
6DBvLniKMJADk/t5l29oMA: folds
dzoSjPZmtjGuK83119030A: calls $1
qJr25HAtvv1w/7IBvjMM3g: folds
m3U8I35Pn3gxKhoS2nmYIg: calls $1
CCCXsirC+bO7ginAuUUVlQ: calls $1
mBRWbnUl8diyBO1qTJaNzw: folds
BK/GtNPkSx0TdUDj82id5A: checks
*** FLOP *** [Tc 5d 8s]
BK/GtNPkSx0TdUDj82id5A: checks
dzoSjPZmtjGuK83119030A: bets $1
m3U8I35Pn3gxKhoS2nmYIg: calls $1
CCCXsirC+bO7ginAuUUVlQ: calls $1
BK/GtNPkSx0TdUDj82id5A: folds
*** TURN *** [Tc 5d 8s] [3d]
bLbSOSmSOnqE0iTcH/5dxA joins the table at seat #5
dzoSjPZmtjGuK83119030A: checks
m3U8I35Pn3gxKhoS2nmYIg: checks
CCCXsirC+bO7ginAuUUVlQ: checks
*** RIVER *** [Tc 5d 8s 3d] [Jd]
dzoSjPZmtjGuK83119030A: checks
m3U8I35Pn3gxKhoS2nmYIg: checks
CCCXsirC+bO7ginAuUUVlQ: checks
*** SHOW DOWN ***
dzoSjPZmtjGuK83119030A: shows [Kc 5c] (a pair of Fives)
m3U8I35Pn3gxKhoS2nmYIg: shows [5s 6s] (a pair of Fives - lower kicker)
CCCXsirC+bO7ginAuUUVlQ: mucks hand
dzoSjPZmtjGuK83119030A collected $7.15 from pot
*** SUMMARY ***
Total pot $7.50 | Rake $0.35
Board [Tc 5d 8s 3d Jd]
Seat 1: qJr25HAtvv1w/7IBvjMM3g folded before Flop (didn't bet)
Seat 2: m3U8I35Pn3gxKhoS2nmYIg showed [5s 6s] and lost with a pair of Fives
Seat 3: CCCXsirC+bO7ginAuUUVlQ (button) mucked
Seat 4: mBRWbnUl8diyBO1qTJaNzw (small blind) folded before Flop
Seat 6: BK/GtNPkSx0TdUDj82id5A (big blind) folded on the Flop
Seat 7: DHdbHyysD15wCAtx+BhUjA folded before Flop (didn't bet)
Seat 8: 6DBvLniKMJADk/t5l29oMA folded before Flop (didn't bet)
Seat 9: dzoSjPZmtjGuK83119030A showed [Kc 5c] and won ($7.15) with a pair of Fives



PokerStars Game #59940430110:  Hold'em No Limit ($0.50/$1.00) - 2009/07/01 1:06:24 ET
Table 'GxCPo/gd3OSthkYrAxJngg' 6-max Seat #3 is the button
Seat 1: sH8BpAFP+jGFxCgVpD1Lew ($268.40 in chips)
Seat 2: YExX2paeIHrmfIwV1ivM/w ($70.60 in chips)
Seat 3: o6plE+MSW4XFNTeONe16xg ($20.10 in chips)
Seat 4: YMJG+F++3Aj6P8dAWda5fw ($202.75 in chips)
Seat 5: G5ZSSN6RSON3gkNvk/SmYg ($117.60 in chips)
YMJG+F++3Aj6P8dAWda5fw: posts small blind $0.50
G5ZSSN6RSON3gkNvk/SmYg: posts big blind $1
*** HOLE CARDS ***
sH8BpAFP+jGFxCgVpD1Lew: folds
YExX2paeIHrmfIwV1ivM/w: folds
o6plE+MSW4XFNTeONe16xg: raises $2 to $3
YMJG+F++3Aj6P8dAWda5fw: folds
G5ZSSN6RSON3gkNvk/SmYg: folds
4d1rWhpu8DzLmzMbR3QKyA has returned
o6plE+MSW4XFNTeONe16xg collected $2.50 from pot
*** SUMMARY ***
Total pot $2.50 | Rake $0
Seat 1: sH8BpAFP+jGFxCgVpD1Lew folded before Flop (didn't bet)
Seat 2: YExX2paeIHrmfIwV1ivM/w folded before Flop (didn't bet)
Seat 3: o6plE+MSW4XFNTeONe16xg (button) collected ($2.50)
Seat 4: YMJG+F++3Aj6P8dAWda5fw (small blind) folded before Flop
Seat 5: G5ZSSN6RSON3gkNvk/SmYg (big blind) folded before Flop



PokerStars Game #59940430644:  Hold'em No Limit ($0.50/$1.00) - 2009/07/01 1:06:25 ET
Table 'fTlPiCj0utgzC/5io+I7ew' 6-max Seat #5 is the button
Seat 1: YMJG+F++3Aj6P8dAWda5fw ($104.35 in chips)
Seat 2: Qy/UBNbD2HaA0Ogxg8Sf3w ($120.85 in chips)
Seat 4: uJVSceLggtsrJya+WtmUEA ($185.65 in chips)
Seat 5: GC5g2ryXV7e4TTqmaxUofw ($52.70 in chips)
Seat 6: /P4w1pHg2zHYg/4ubJ0dPw ($68.05 in chips)
/P4w1pHg2zHYg/4ubJ0dPw: posts small blind $0.50
YMJG+F++3Aj6P8dAWda5fw: posts big blind $1
Z2fXsGcjl+Eax+RzOgwOmg: sits out
*** HOLE CARDS ***
Qy/UBNbD2HaA0Ogxg8Sf3w: raises $2.50 to $3.50
uJVSceLggtsrJya+WtmUEA: folds
GC5g2ryXV7e4TTqmaxUofw: folds
/P4w1pHg2zHYg/4ubJ0dPw: folds
YMJG+F++3Aj6P8dAWda5fw: folds
Qy/UBNbD2HaA0Ogxg8Sf3w collected $2.50 from pot
*** SUMMARY ***
Total pot $2.50 | Rake $0
Seat 1: YMJG+F++3Aj6P8dAWda5fw (big blind) folded before Flop
Seat 2: Qy/UBNbD2HaA0Ogxg8Sf3w collected ($2.50)
Seat 4: uJVSceLggtsrJya+WtmUEA folded before Flop (didn't bet)
Seat 5: GC5g2ryXV7e4TTqmaxUofw (button) folded before Flop (didn't bet)
Seat 6: /P4w1pHg2zHYg/4ubJ0dPw (small blind) folded before Flop



PokerStars Game #59940430860:  Hold'em No Limit ($0.50/$1.00) - 2009/07/01 1:06:26 ET
Table 'W/wyObTiXZm+Ckkl3YxcSw' 6-max Seat #1 is the button
Seat 1: eUBBn2R56C1IQ6Cs/vitwg ($186.75 in chips)
Seat 2: oDiBRCaF0QVtd3kO6xZIXw ($116.85 in chips)
Seat 3: dxyNCn/qxfkGDUIf28Cbng ($81.40 in chips)
Seat 4: aYii2DmxlOlbC1wbGRBWvQ ($101.70 in chips)
Seat 5: MFptnnT6AnJakWBooTkmeg ($25.65 in chips)
Seat 6: OGMLOcTNYZXZU81au7ztUw ($102 in chips)
oDiBRCaF0QVtd3kO6xZIXw: posts small blind $0.50
dxyNCn/qxfkGDUIf28Cbng: posts big blind $1
*** HOLE CARDS ***
aYii2DmxlOlbC1wbGRBWvQ: folds
MFptnnT6AnJakWBooTkmeg: folds
OGMLOcTNYZXZU81au7ztUw: raises $2 to $3
eUBBn2R56C1IQ6Cs/vitwg: calls $3
oDiBRCaF0QVtd3kO6xZIXw: raises $10 to $13
dxyNCn/qxfkGDUIf28Cbng: folds
OGMLOcTNYZXZU81au7ztUw: calls $10
eUBBn2R56C1IQ6Cs/vitwg: folds
*** FLOP *** [2h 6s Qd]
oDiBRCaF0QVtd3kO6xZIXw: bets $19
OGMLOcTNYZXZU81au7ztUw: folds
oDiBRCaF0QVtd3kO6xZIXw collected $28.50 from pot
oDiBRCaF0QVtd3kO6xZIXw: doesn't show hand
*** SUMMARY ***
Total pot $30 | Rake $1.50
Board [2h 6s Qd]
Seat 1: eUBBn2R56C1IQ6Cs/vitwg (button) folded before Flop
Seat 2: oDiBRCaF0QVtd3kO6xZIXw (small blind) collected ($28.50)
Seat 3: dxyNCn/qxfkGDUIf28Cbng (big blind) folded before Flop
Seat 4: aYii2DmxlOlbC1wbGRBWvQ folded before Flop (didn't bet)
Seat 5: MFptnnT6AnJakWBooTkmeg folded before Flop (didn't bet)
Seat 6: OGMLOcTNYZXZU81au7ztUw folded on the Flop



PokerStars Game #59940433584:  Hold'em No Limit ($0.50/$1.00) - 2009/07/01 1:06:30 ET
Table 'tyUh+jyNvrceIQdKMJjQ2wZFWj23PMihdwrNWv41OG/Qeat #6 is the button
Seat 1: o8A5MUdudVKu+pAwgZOX2w ($116.90 in chips)
Seat 2: 5uy3EN+iIYkgwbWZFTUBAQ ($100 in chips)
Seat 3: TalCiLYHCd+ffkmR3auPvA ($74.60 in chips)
Seat 4: TSuRyAHnUPCFjP7Z0rEE0w ($181.50 in chips)
Seat 5: j7NIOHLZk7V2o9fOioO5ug ($121.55 in chips)
Seat 6: 4OO5v3AVduL0tePNx8wk5A ($100 in chips)
o8A5MUdudVKu+pAwgZOX2w: posts small blind $0.50
5uy3EN+iIYkgwbWZFTUBAQ: posts big blind $1
*** HOLE CARDS ***
TalCiLYHCd+ffkmR3auPvA: folds
TSuRyAHnUPCFjP7Z0rEE0w: folds
TSuRyAHnUPCFjP7Z0rEE0w is sitting out
j7NIOHLZk7V2o9fOioO5ug: raises $2 to $3
4OO5v3AVduL0tePNx8wk5A: folds
o8A5MUdudVKu+pAwgZOX2w: calls $2.50
5uy3EN+iIYkgwbWZFTUBAQ: folds
*** FLOP *** [9c Kd Ac]
o8A5MUdudVKu+pAwgZOX2w: checks
j7NIOHLZk7V2o9fOioO5ug: bets $5
o8A5MUdudVKu+pAwgZOX2w: folds
j7NIOHLZk7V2o9fOioO5ug collected $6.65 from pot
j7NIOHLZk7V2o9fOioO5ug: doesn't show hand
*** SUMMARY ***
Total pot $7 | Rake $0.35
Board [9c Kd Ac]
Seat 1: o8A5MUdudVKu+pAwgZOX2w (small blind) folded on the Flop
Seat 2: 5uy3EN+iIYkgwbWZFTUBAQ (big blind) folded before Flop
Seat 3: TalCiLYHCd+ffkmR3auPvA folded before Flop (didn't bet)
Seat 4: TSuRyAHnUPCFjP7Z0rEE0w folded before Flop (didn't bet)
Seat 5: j7NIOHLZk7V2o9fOioO5ug collected ($6.65)
Seat 6: 4OO5v3AVduL0tePNx8wk5A (button) folded before Flop (didn't bet)



PokerStars Game #59940436500:  Hold'em No Limit ($0.50/$1.00) - 2009/07/01 1:06:35 ET
Table 'rmZfTK+oSebeUPJNbWhdAA' 6-max Seat #6 is the button
Seat 1: xAU6q2/cwmby2sxmA8VcmA ($147.50 in chips)
Seat 2: z7O9PO/WEcqRouIydFhS9Q ($136.90 in chips)
Seat 3: BCEV3COoKY607AzLWayfRA ($132.50 in chips)
Seat 4: 1/mIuXfgx1ZyVkodrmfQDw ($100 in chips)
Seat 5: 5lY8d6Cnm4HUkt/8FZSj4g ($90.25 in chips)
Seat 6: j7NIOHLZk7V2o9fOioO5ug ($103.30 in chips)
xAU6q2/cwmby2sxmA8VcmA: posts small blind $0.50
z7O9PO/WEcqRouIydFhS9Q: posts big blind $1
*** HOLE CARDS ***
BCEV3COoKY607AzLWayfRA: raises $3 to $4
1/mIuXfgx1ZyVkodrmfQDw: folds
5lY8d6Cnm4HUkt/8FZSj4g: folds
j7NIOHLZk7V2o9fOioO5ug: folds
xAU6q2/cwmby2sxmA8VcmA: folds
z7O9PO/WEcqRouIydFhS9Q: folds
BCEV3COoKY607AzLWayfRA collected $2.50 from pot
BCEV3COoKY607AzLWayfRA: doesn't show hand
*** SUMMARY ***
Total pot $2.50 | Rake $0
Seat 1: xAU6q2/cwmby2sxmA8VcmA (small blind) folded before Flop
Seat 2: z7O9PO/WEcqRouIydFhS9Q (big blind) folded before Flop
Seat 3: BCEV3COoKY607AzLWayfRA collected ($2.50)
Seat 4: 1/mIuXfgx1ZyVkodrmfQDw folded before Flop (didn't bet)
Seat 5: 5lY8d6Cnm4HUkt/8FZSj4g folded before Flop (didn't bet)
Seat 6: j7NIOHLZk7V2o9fOioO5ug (button) folded before Flop (didn't bet)



PokerStars Game #59940436356:  Hold'em No Limit ($0.50/$1.00) - 2009/07/01 1:06:35 ET
Table 'O96CPOtvMBWP6kzuYDfdFA' 6-max Seat #5 is the button
Seat 1: 6alLXQIITA2EZ/lBeym8Dw ($126.05 in chips)
Seat 3: V89DGjxE171oPREEbAXiyg ($90.60 in chips)
Seat 4: /P4w1pHg2zHYg/4ubJ0dPw ($64.55 in chips)
Seat 5: G5ZSSN6RSON3gkNvk/SmYg ($100 in chips)
Seat 6: GYei5jXGWexiJYbAT2fELg ($20.50 in chips)
GYei5jXGWexiJYbAT2fELg: posts small blind $0.50
6alLXQIITA2EZ/lBeym8Dw: posts big blind $1
*** HOLE CARDS ***
V89DGjxE171oPREEbAXiyg: folds
/P4w1pHg2zHYg/4ubJ0dPw: folds
V89DGjxE171oPREEbAXiyg is sitting out
G5ZSSN6RSON3gkNvk/SmYg: folds
GYei5jXGWexiJYbAT2fELg: folds
6alLXQIITA2EZ/lBeym8Dw collected $1 from pot
*** SUMMARY ***
Total pot $1 | Rake $0
Seat 1: 6alLXQIITA2EZ/lBeym8Dw (big blind) collected ($1)
Seat 3: V89DGjxE171oPREEbAXiyg folded before Flop (didn't bet)
Seat 4: /P4w1pHg2zHYg/4ubJ0dPw folded before Flop (didn't bet)
Seat 5: G5ZSSN6RSON3gkNvk/SmYg (button) folded before Flop (didn't bet)
Seat 6: GYei5jXGWexiJYbAT2fELg (small blind) folded before Flop



PokerStars Game #59940436910:  Hold'em No Limit ($0.50/$1.00) - 2009/07/01 1:06:36 ET
Table 'N2bNCDHL96aCQDvZIh+yQQ' 6-max Seat #6 is the button
Seat 2: TIB5eSBJLz62w6yz2+yeKw ($89.50 in chips)
Seat 3: Qy/UBNbD2HaA0Ogxg8Sf3w ($235.20 in chips)
Seat 4: uCqEjnxh2/vFBjKYkfTOkw ($196.55 in chips)
Seat 5: 8OEJHwpMpZZfyaTpXEDFfw ($29.15 in chips)
Seat 6: TSuRyAHnUPCFjP7Z0rEE0w ($101.80 in chips)
TIB5eSBJLz62w6yz2+yeKw: posts small blind $0.50
Qy/UBNbD2HaA0Ogxg8Sf3w: posts big blind $1
*** HOLE CARDS ***
uCqEjnxh2/vFBjKYkfTOkw: folds
8OEJHwpMpZZfyaTpXEDFfw: calls $1
TSuRyAHnUPCFjP7Z0rEE0w has timed out
TSuRyAHnUPCFjP7Z0rEE0w: folds
TSuRyAHnUPCFjP7Z0rEE0w is sitting out
TIB5eSBJLz62w6yz2+yeKw: folds
Qy/UBNbD2HaA0Ogxg8Sf3w: checks
*** FLOP *** [8h Tc 6s]
Qy/UBNbD2HaA0Ogxg8Sf3w: checks
8OEJHwpMpZZfyaTpXEDFfw: checks
*** TURN *** [8h Tc 6s] [Js]
Qy/UBNbD2HaA0Ogxg8Sf3w: bets $1
8OEJHwpMpZZfyaTpXEDFfw: calls $1
*** RIVER *** [8h Tc 6s Js] [8c]
Qy/UBNbD2HaA0Ogxg8Sf3w: checks
8OEJHwpMpZZfyaTpXEDFfw: checks
*** SHOW DOWN ***
Qy/UBNbD2HaA0Ogxg8Sf3w: shows [Th As] (two pair, Tens and Eights)
8OEJHwpMpZZfyaTpXEDFfw: mucks hand
Qy/UBNbD2HaA0Ogxg8Sf3w collected $4.30 from pot
*** SUMMARY ***
Total pot $4.50 | Rake $0.20
Board [8h Tc 6s Js 8c]
Seat 2: TIB5eSBJLz62w6yz2+yeKw (small blind) folded before Flop
Seat 3: Qy/UBNbD2HaA0Ogxg8Sf3w (big blind) showed [Th As] and won ($4.30) with two pair, Tens and Eights
Seat 4: uCqEjnxh2/vFBjKYkfTOkw folded before Flop (didn't bet)
Seat 5: 8OEJHwpMpZZfyaTpXEDFfw mucked
Seat 6: TSuRyAHnUPCFjP7Z0rEE0w (button) folded before Flop (didn't bet)



PokerStars Game #59940437318:  Hold'em No Limit ($0.50/$1.00) - 2009/07/01 1:06:36 ET
Table 'hugOjcwJvzEwZbK7tyiWuQ' 9-max Seat #5 is the button
Seat 2: r27C1nIV4NS4+qbnrgBQSw ($283.20 in chips)
Seat 3: jDwhY1kCdc6EkAHbT7PJMQ ($104.75 in chips)
Seat 4: UWB3oeddt/GObx2Mix2Anw ($174.80 in chips)
Seat 5: 5BRGWf+R3nt2WS3b5xX+zA ($16.75 in chips)
Seat 6: gUUvmqdVlmvpal6B8nYrmg ($106.40 in chips)
Seat 7: FL3MrLspcF23LYvC4ipBOA ($110.30 in chips)
Seat 8: /zy+DB4S5fUQUSfZWFzYGw ($100 in chips)
Seat 9: W8P9bUKCs43TO1xHm0dL6w ($89.45 in chips)
gUUvmqdVlmvpal6B8nYrmg: posts small blind $0.50
FL3MrLspcF23LYvC4ipBOA: posts big blind $1
*** HOLE CARDS ***
/zy+DB4S5fUQUSfZWFzYGw: folds
W8P9bUKCs43TO1xHm0dL6w: folds
r27C1nIV4NS4+qbnrgBQSw: folds
jDwhY1kCdc6EkAHbT7PJMQ: folds
UWB3oeddt/GObx2Mix2Anw: raises $2 to $3
5BRGWf+R3nt2WS3b5xX+zA: folds
gUUvmqdVlmvpal6B8nYrmg: folds
FL3MrLspcF23LYvC4ipBOA: calls $2
*** FLOP *** [Ad 7h Ah]
FL3MrLspcF23LYvC4ipBOA: checks
UWB3oeddt/GObx2Mix2Anw: checks
*** TURN *** [Ad 7h Ah] [3s]
FL3MrLspcF23LYvC4ipBOA: checks
UWB3oeddt/GObx2Mix2Anw: bets $3
FL3MrLspcF23LYvC4ipBOA: folds
UWB3oeddt/GObx2Mix2Anw collected $6.20 from pot
UWB3oeddt/GObx2Mix2Anw: doesn't show hand
*** SUMMARY ***
Total pot $6.50 | Rake $0.30
Board [Ad 7h Ah 3s]
Seat 2: r27C1nIV4NS4+qbnrgBQSw folded before Flop (didn't bet)
Seat 3: jDwhY1kCdc6EkAHbT7PJMQ folded before Flop (didn't bet)
Seat 4: UWB3oeddt/GObx2Mix2Anw collected ($6.20)
Seat 5: 5BRGWf+R3nt2WS3b5xX+zA (button) folded before Flop (didn't bet)
Seat 6: gUUvmqdVlmvpal6B8nYrmg (small blind) folded before Flop
Seat 7: FL3MrLspcF23LYvC4ipBOA (big blind) folded on the Turn
Seat 8: /zy+DB4S5fUQUSfZWFzYGw folded before Flop (didn't bet)
Seat 9: W8P9bUKCs43TO1xHm0dL6w folded before Flop (didn't bet)



PokerStars Game #59940436986:  Hold'em No Limit ($0.50/$1.00) - 2009/07/01 1:06:36 ET
Table '3T4owEKJKyGTMePwrv50FQ' 9-max Seat #2 is the button
Seat 1: OGgaARGdJQT4awWVNQ957w ($101.10 in chips)
Seat 2: t+Id2O6herCLgwnC4m49PA ($38.60 in chips)
Seat 3: DOLzOcBTZYcph5jEfKFWuQ ($106 in chips)
Seat 4: O5Go3jrzbQWxRB6ESK+Ptg ($31.60 in chips)
Seat 5: eI48VADSCFoNZBx4T9qs2w ($31.95 in chips)
Seat 6: laA8va+Yv8WuMqT1zdR91g ($100 in chips)
Seat 7: 1862487932 ($100 in chips)
Seat 9: 61sfw5QTu62YYIt68OsdrA ($66.95 in chips)
DOLzOcBTZYcph5jEfKFWuQ: posts small blind $0.50
O5Go3jrzbQWxRB6ESK+Ptg: posts big blind $1
ucTB8uAUcQnKGsA70OSjNA: sits out
*** HOLE CARDS ***
eI48VADSCFoNZBx4T9qs2w: folds
laA8va+Yv8WuMqT1zdR91g: folds
1862487932: raises $2.50 to $3.50
61sfw5QTu62YYIt68OsdrA: folds
OGgaARGdJQT4awWVNQ957w: folds
t+Id2O6herCLgwnC4m49PA: folds
DOLzOcBTZYcph5jEfKFWuQ: folds
O5Go3jrzbQWxRB6ESK+Ptg: folds
1862487932 collected $2.50 from pot
1862487932: doesn't show hand
*** SUMMARY ***
Total pot $2.50 | Rake $0
Seat 1: OGgaARGdJQT4awWVNQ957w folded before Flop (didn't bet)
Seat 2: t+Id2O6herCLgwnC4m49PA (button) folded before Flop (didn't bet)
Seat 3: DOLzOcBTZYcph5jEfKFWuQ (small blind) folded before Flop
Seat 4: O5Go3jrzbQWxRB6ESK+Ptg (big blind) folded before Flop
Seat 5: eI48VADSCFoNZBx4T9qs2w folded before Flop (didn't bet)
Seat 6: laA8va+Yv8WuMqT1zdR91g folded before Flop (didn't bet)
Seat 7: 1862487932 collected ($2.50)
Seat 9: 61sfw5QTu62YYIt68OsdrA folded before Flop (didn't bet)



PokerStars Game #59940436924:  Hold'em No Limit ($0.50/$1.00) - 2009/07/01 1:06:36 ET
Table '6YvsYDPNIDx2v5z3bJnwZQ' 9-max Seat #2 is the button
Seat 1: Ogn4JDV3mp4ZDKO49IFzKA ($21.20 in chips)
Seat 2: +hHqYgKILitkxIzFNGvvsA ($32.75 in chips)
Seat 4: kEr5NYB+JIG5+szcYMr6hA ($44.80 in chips)
Seat 5: mBRWbnUl8diyBO1qTJaNzw ($162.20 in chips)
Seat 6: 7RSwrjMohkYrZAhOd1uaZg ($15.20 in chips)
Seat 7: mae7OMTaJ/MFimNbZegCkg ($48.30 in chips)
Seat 8: PSFxpXgPedVZyHSu2Zhb7Q ($114.20 in chips)
kEr5NYB+JIG5+szcYMr6hA: posts small blind $0.50
mBRWbnUl8diyBO1qTJaNzw: posts big blind $1
*** HOLE CARDS ***
7RSwrjMohkYrZAhOd1uaZg: calls $1
VPF+HjszMvUIpy0CHIwH3A leaves the table
mae7OMTaJ/MFimNbZegCkg: calls $1
PSFxpXgPedVZyHSu2Zhb7Q: calls $1
Ogn4JDV3mp4ZDKO49IFzKA: folds
+hHqYgKILitkxIzFNGvvsA: calls $1
kEr5NYB+JIG5+szcYMr6hA: calls $0.50
mBRWbnUl8diyBO1qTJaNzw: checks
*** FLOP *** [Ks 3d 5c]
kEr5NYB+JIG5+szcYMr6hA: checks
yZYrOeNDxQxkzpbgKX1bng joins the table at seat #9
mBRWbnUl8diyBO1qTJaNzw: checks
7RSwrjMohkYrZAhOd1uaZg: checks
mae7OMTaJ/MFimNbZegCkg: checks
PSFxpXgPedVZyHSu2Zhb7Q: checks
+hHqYgKILitkxIzFNGvvsA: checks
*** TURN *** [Ks 3d 5c] [Qh]
kEr5NYB+JIG5+szcYMr6hA: checks
mBRWbnUl8diyBO1qTJaNzw: checks
7RSwrjMohkYrZAhOd1uaZg: checks
mae7OMTaJ/MFimNbZegCkg: checks
PSFxpXgPedVZyHSu2Zhb7Q: bets $3
+hHqYgKILitkxIzFNGvvsA: folds
kEr5NYB+JIG5+szcYMr6hA: folds
K6OJDis3KfxSm/PKlkATUA joins the table at seat #3
mBRWbnUl8diyBO1qTJaNzw: folds
7RSwrjMohkYrZAhOd1uaZg: calls $3
mae7OMTaJ/MFimNbZegCkg: folds
*** RIVER *** [Ks 3d 5c Qh] [Jd]
7RSwrjMohkYrZAhOd1uaZg: checks
PSFxpXgPedVZyHSu2Zhb7Q: checks
*** SHOW DOWN ***
7RSwrjMohkYrZAhOd1uaZg: shows [Ts Jh] (a pair of Jacks)
PSFxpXgPedVZyHSu2Zhb7Q: shows [Qd 9d] (a pair of Queens)
PSFxpXgPedVZyHSu2Zhb7Q collected $11.45 from pot
*** SUMMARY ***
Total pot $12 | Rake $0.55
Board [Ks 3d 5c Qh Jd]
Seat 1: Ogn4JDV3mp4ZDKO49IFzKA folded before Flop (didn't bet)
Seat 2: +hHqYgKILitkxIzFNGvvsA (button) folded on the Turn
Seat 4: kEr5NYB+JIG5+szcYMr6hA (small blind) folded on the Turn
Seat 5: mBRWbnUl8diyBO1qTJaNzw (big blind) folded on the Turn
Seat 6: 7RSwrjMohkYrZAhOd1uaZg showed [Ts Jh] and lost with a pair of Jacks
Seat 7: mae7OMTaJ/MFimNbZegCkg folded on the Turn
Seat 8: PSFxpXgPedVZyHSu2Zhb7Q showed [Qd 9d] and won ($11.45) with a pair of Queens



PokerStars Game #59940436952:  Hold'em No Limit ($0.50/$1.00) - 2009/07/01 1:06:36 ET
Table 'tJq9SfN1ywY0r03VBlWlwQ' 9-max Seat #9 is the button
Seat 1: wZsU+w9r7G66x93UuvBf1Q ($339.80 in chips)
Seat 3: FVs16t7GgfWgQWt4JxsObQ ($18.90 in chips)
Seat 4: bLbSOSmSOnqE0iTcH/5dxA ($112.20 in chips)
Seat 5: h5ipsNTMyolp7xn/NAvWkA ($73 in chips)
Seat 6: gUUvmqdVlmvpal6B8nYrmg ($128.20 in chips)
Seat 8: G4DEhsZFmznGNVpy2SEocA ($29.90 in chips)
Seat 9: XE5QF1y74bpHog9JxWJMWQ ($100.50 in chips)
wZsU+w9r7G66x93UuvBf1Q: posts small blind $0.50
FVs16t7GgfWgQWt4JxsObQ: posts big blind $1
*** HOLE CARDS ***
bLbSOSmSOnqE0iTcH/5dxA: folds
h5ipsNTMyolp7xn/NAvWkA: folds
gUUvmqdVlmvpal6B8nYrmg: raises $1 to $2
G4DEhsZFmznGNVpy2SEocA: folds
XE5QF1y74bpHog9JxWJMWQ: folds
wZsU+w9r7G66x93UuvBf1Q: folds
FVs16t7GgfWgQWt4JxsObQ: calls $1
*** FLOP *** [As Kh Td]
FVs16t7GgfWgQWt4JxsObQ: checks
gUUvmqdVlmvpal6B8nYrmg: bets $2
FVs16t7GgfWgQWt4JxsObQ: calls $2
*** TURN *** [As Kh Td] [Ts]
FVs16t7GgfWgQWt4JxsObQ: checks
gUUvmqdVlmvpal6B8nYrmg: bets $4
FVs16t7GgfWgQWt4JxsObQ: calls $4
*** RIVER *** [As Kh Td Ts] [Qc]
FVs16t7GgfWgQWt4JxsObQ: checks
gUUvmqdVlmvpal6B8nYrmg: checks
*** SHOW DOWN ***
FVs16t7GgfWgQWt4JxsObQ: shows [Tc 4c] (three of a kind, Tens)
gUUvmqdVlmvpal6B8nYrmg: mucks hand
FVs16t7GgfWgQWt4JxsObQ collected $15.70 from pot
*** SUMMARY ***
Total pot $16.50 | Rake $0.80
Board [As Kh Td Ts Qc]
Seat 1: wZsU+w9r7G66x93UuvBf1Q (small blind) folded before Flop
Seat 3: FVs16t7GgfWgQWt4JxsObQ (big blind) showed [Tc 4c] and won ($15.70) with three of a kind, Tens
Seat 4: bLbSOSmSOnqE0iTcH/5dxA folded before Flop (didn't bet)
Seat 5: h5ipsNTMyolp7xn/NAvWkA folded before Flop (didn't bet)
Seat 6: gUUvmqdVlmvpal6B8nYrmg mucked
Seat 8: G4DEhsZFmznGNVpy2SEocA folded before Flop (didn't bet)
Seat 9: XE5QF1y74bpHog9JxWJMWQ (button) folded before Flop (didn't bet)



PokerStars Game #59940437214:  Hold'em No Limit ($0.50/$1.00) - 2009/07/01 1:06:36 ET
Table 'cKH9c4x6u79IqCdaKKvXrw' 9-max Seat #2 is the button
Seat 1: Pp/KTcXkfZKKUHkjyaLTdg ($18.50 in chips)
Seat 2: 8S3JMH4TY3whgIlZmMv66w ($76.55 in chips)
Seat 3: 997ViqAtWn1FPjJqcffwcA ($156.10 in chips)
Seat 4: FL3MrLspcF23LYvC4ipBOA ($100 in chips)
Seat 5: Jjc7EHWzs4//xUAjJ0UWoA ($40.65 in chips)
Seat 6: Bsd/K5gAcLanYbGiPirRjw ($202.55 in chips)
Seat 7: 1GkkVBhlJ92guE6K5mS5Ig ($16.75 in chips)
Seat 8: myIxN7otsyr846M539YR8Q ($17 in chips)
Seat 9: 6XkTu4ahxzHnvjjc1R8YjQ ($41.60 in chips)
997ViqAtWn1FPjJqcffwcA: posts small blind $0.50
FL3MrLspcF23LYvC4ipBOA: posts big blind $1
*** HOLE CARDS ***
Jjc7EHWzs4//xUAjJ0UWoA: calls $1
Bsd/K5gAcLanYbGiPirRjw: folds
1GkkVBhlJ92guE6K5mS5Ig: folds
myIxN7otsyr846M539YR8Q: folds
6XkTu4ahxzHnvjjc1R8YjQ: folds
Pp/KTcXkfZKKUHkjyaLTdg: folds
8S3JMH4TY3whgIlZmMv66w: folds
997ViqAtWn1FPjJqcffwcA: folds
FL3MrLspcF23LYvC4ipBOA: checks
*** FLOP *** [4s Qd 9d]
FL3MrLspcF23LYvC4ipBOA: checks
Jjc7EHWzs4//xUAjJ0UWoA: bets $2
FL3MrLspcF23LYvC4ipBOA: folds
Jjc7EHWzs4//xUAjJ0UWoA collected $2.40 from pot
*** SUMMARY ***
Total pot $2.50 | Rake $0.10
Board [4s Qd 9d]
Seat 1: Pp/KTcXkfZKKUHkjyaLTdg folded before Flop (didn't bet)
Seat 2: 8S3JMH4TY3whgIlZmMv66w (button) folded before Flop (didn't bet)
Seat 3: 997ViqAtWn1FPjJqcffwcA (small blind) folded before Flop
Seat 4: FL3MrLspcF23LYvC4ipBOA (big blind) folded on the Flop
Seat 5: Jjc7EHWzs4//xUAjJ0UWoA collected ($2.40)
Seat 6: Bsd/K5gAcLanYbGiPirRjw folded before Flop (didn't bet)
Seat 7: 1GkkVBhlJ92guE6K5mS5Ig folded before Flop (didn't bet)
Seat 8: myIxN7otsyr846M539YR8Q folded before Flop (didn't bet)
Seat 9: 6XkTu4ahxzHnvjjc1R8YjQ folded before Flop (didn't bet)



PokerStars Game #59940438258:  Hold'em No Limit ($0.50/$1.00) - 2009/07/01 1:06:38 ET
Table 'vs/5jr6ciwjVQ5+Soc+u2A' 6-max Seat #3 is the button
Seat 1: /P4w1pHg2zHYg/4ubJ0dPw ($60.30 in chips)
Seat 2: lXX4W7m3u++JiSOZ46yVMQ ($100 in chips)
Seat 3: G5ZSSN6RSON3gkNvk/SmYg ($158.35 in chips)
Seat 4: wk6Ohn4GDozoOMHc4eb2rw ($82.65 in chips)
Seat 5: +Nt3OPk3XR9SKjZgm2CexQ ($107.45 in chips)
wk6Ohn4GDozoOMHc4eb2rw: posts small blind $0.50
+Nt3OPk3XR9SKjZgm2CexQ: posts big blind $1
Z2fXsGcjl+Eax+RzOgwOmg: sits out
*** HOLE CARDS ***
/P4w1pHg2zHYg/4ubJ0dPw: raises $2.50 to $3.50
lXX4W7m3u++JiSOZ46yVMQ: folds
G5ZSSN6RSON3gkNvk/SmYg: folds
wk6Ohn4GDozoOMHc4eb2rw: folds
+Nt3OPk3XR9SKjZgm2CexQ: folds
/P4w1pHg2zHYg/4ubJ0dPw collected $2.50 from pot
/P4w1pHg2zHYg/4ubJ0dPw: doesn't show hand
*** SUMMARY ***
Total pot $2.50 | Rake $0
Seat 1: /P4w1pHg2zHYg/4ubJ0dPw collected ($2.50)
Seat 2: lXX4W7m3u++JiSOZ46yVMQ folded before Flop (didn't bet)
Seat 3: G5ZSSN6RSON3gkNvk/SmYg (button) folded before Flop (didn't bet)
Seat 4: wk6Ohn4GDozoOMHc4eb2rw (small blind) folded before Flop
Seat 5: +Nt3OPk3XR9SKjZgm2CexQ (big blind) folded before Flop



PokerStars Game #59940441144:  Hold'em No Limit ($0.50/$1.00) - 2009/07/01 1:06:43 ET
Table '7O9fB8yx1u7sJveJn8w6jA' 6-max Seat #3 is the button
Seat 2: wx3sQGkVi2x9wJXuWNHPBw ($187.95 in chips)
Seat 3: hpxXcmRkXXI9HE5+5/j/0Q ($104.20 in chips)
Seat 4: XIZSmlGttGgSRaIU42K4Fg ($146.70 in chips)
Seat 5: BCEV3COoKY607AzLWayfRA ($107.80 in chips)
Seat 6: UBZQqpnJZdTYYY1FTb0rLA ($133.45 in chips)
XIZSmlGttGgSRaIU42K4Fg: posts small blind $0.50
BCEV3COoKY607AzLWayfRA: posts big blind $1
*** HOLE CARDS ***
jy52+7FotjH63o5tEEVgKw has returned
UBZQqpnJZdTYYY1FTb0rLA: folds
wx3sQGkVi2x9wJXuWNHPBw: folds
hpxXcmRkXXI9HE5+5/j/0Q: folds
XIZSmlGttGgSRaIU42K4Fg: folds
BCEV3COoKY607AzLWayfRA collected $1 from pot
BCEV3COoKY607AzLWayfRA: doesn't show hand
*** SUMMARY ***
Total pot $1 | Rake $0
Seat 2: wx3sQGkVi2x9wJXuWNHPBw folded before Flop (didn't bet)
Seat 3: hpxXcmRkXXI9HE5+5/j/0Q (button) folded before Flop (didn't bet)
Seat 4: XIZSmlGttGgSRaIU42K4Fg (small blind) folded before Flop
Seat 5: BCEV3COoKY607AzLWayfRA (big blind) collected ($1)
Seat 6: UBZQqpnJZdTYYY1FTb0rLA folded before Flop (didn't bet)



PokerStars Game #59940441898:  Hold'em No Limit ($0.50/$1.00) - 2009/07/01 1:06:44 ET
Table 'VOs36P6NW+QyXeQ1B62kmA' 6-max Seat #5 is the button
Seat 1: Z2fXsGcjl+Eax+RzOgwOmg ($100 in chips)
Seat 2: 2UMlbaZ8n8AbRli0Yr0mDw ($40.80 in chips)
Seat 4: w02zQzNydODiyV9THKgo9w ($40.70 in chips)
Seat 5: ozrlafxxh1HmYdA0/h+MuA ($46.40 in chips)
Seat 6: slVKuQyEz8Qj4E3uLPYNXg ($99 in chips)
slVKuQyEz8Qj4E3uLPYNXg: posts small blind $0.50
Z2fXsGcjl+Eax+RzOgwOmg: posts big blind $1
*** HOLE CARDS ***
2UMlbaZ8n8AbRli0Yr0mDw: raises $1 to $2
w02zQzNydODiyV9THKgo9w: folds
ozrlafxxh1HmYdA0/h+MuA: folds
slVKuQyEz8Qj4E3uLPYNXg: folds
Z2fXsGcjl+Eax+RzOgwOmg: calls $1
*** FLOP *** [5s 6d As]
Z2fXsGcjl+Eax+RzOgwOmg: checks
2UMlbaZ8n8AbRli0Yr0mDw: bets $4
Z2fXsGcjl+Eax+RzOgwOmg: folds
2UMlbaZ8n8AbRli0Yr0mDw collected $4.30 from pot
2UMlbaZ8n8AbRli0Yr0mDw: doesn't show hand
*** SUMMARY ***
Total pot $4.50 | Rake $0.20
Board [5s 6d As]
Seat 1: Z2fXsGcjl+Eax+RzOgwOmg (big blind) folded on the Flop
Seat 2: 2UMlbaZ8n8AbRli0Yr0mDw collected ($4.30)
Seat 4: w02zQzNydODiyV9THKgo9w folded before Flop (didn't bet)
Seat 5: ozrlafxxh1HmYdA0/h+MuA (button) folded before Flop (didn't bet)
Seat 6: slVKuQyEz8Qj4E3uLPYNXg (small blind) folded before Flop



PokerStars Game #59940442638:  Hold'em No Limit ($0.50/$1.00) - 2009/07/01 1:06:45 ET
Table 'eU3bWpDDg3Z+9R4m4iVmog' 6-max Seat #4 is the button
Seat 2: 8CAoOzhmB8n3nRFf3V4BTg ($71.40 in chips)
Seat 3: rVMOzU7w5FddYPGhD7qN2Q ($40.55 in chips)
Seat 4: GDVIsbEJ/DOJsMKE4Asz0A ($114.20 in chips)
Seat 6: hpxXcmRkXXI9HE5+5/j/0Q ($120.50 in chips)
hpxXcmRkXXI9HE5+5/j/0Q: posts small blind $0.50
8CAoOzhmB8n3nRFf3V4BTg: posts big blind $1
*** HOLE CARDS ***
rVMOzU7w5FddYPGhD7qN2Q: folds
GDVIsbEJ/DOJsMKE4Asz0A: raises $2 to $3
hpxXcmRkXXI9HE5+5/j/0Q: folds
8CAoOzhmB8n3nRFf3V4BTg: raises $5 to $8
GDVIsbEJ/DOJsMKE4Asz0A: calls $5
*** FLOP *** [2d 7d 2c]
8CAoOzhmB8n3nRFf3V4BTg: bets $11
GDVIsbEJ/DOJsMKE4Asz0A: calls $11
*** TURN *** [2d 7d 2c] [5c]
8CAoOzhmB8n3nRFf3V4BTg: bets $52.40 and is all-in
GDVIsbEJ/DOJsMKE4Asz0A: folds
8CAoOzhmB8n3nRFf3V4BTg collected $36.65 from pot
8CAoOzhmB8n3nRFf3V4BTg: doesn't show hand
*** SUMMARY ***
Total pot $38.50 | Rake $1.85
Board [2d 7d 2c 5c]
Seat 2: 8CAoOzhmB8n3nRFf3V4BTg (big blind) collected ($36.65)
Seat 3: rVMOzU7w5FddYPGhD7qN2Q folded before Flop (didn't bet)
Seat 4: GDVIsbEJ/DOJsMKE4Asz0A (button) folded on the Turn
Seat 6: hpxXcmRkXXI9HE5+5/j/0Q (small blind) folded before Flop



PokerStars Game #59940444762:  Hold'em No Limit ($0.50/$1.00) - 2009/07/01 1:06:49 ET
Table '+cA8mcmhaedZ7YcrDdhmeQ' 6-max Seat #4 is the button
Seat 1: lsLuWlcPA3Rh7kJVLzMh0Q ($300.95 in chips)
Seat 2: RqgF7gRoKgRNW8Zoi1ty4A ($121.10 in chips)
Seat 3: 7H5WkGzGvsv56y1iaqHvRg ($20.20 in chips)
Seat 4: 4OO5v3AVduL0tePNx8wk5A ($100 in chips)
Seat 5: +7hFKAL0b0O/n8G72TclJA ($136.70 in chips)
Seat 6: YfsTQsY/fxb+YqbdclTHuw ($18.60 in chips)
+7hFKAL0b0O/n8G72TclJA: posts small blind $0.50
YfsTQsY/fxb+YqbdclTHuw: posts big blind $1
*** HOLE CARDS ***
lsLuWlcPA3Rh7kJVLzMh0Q: folds
RqgF7gRoKgRNW8Zoi1ty4A: raises $3 to $4
7H5WkGzGvsv56y1iaqHvRg: calls $4
4OO5v3AVduL0tePNx8wk5A: folds
+7hFKAL0b0O/n8G72TclJA: folds
YfsTQsY/fxb+YqbdclTHuw: folds
*** FLOP *** [6h 7s 2h]
RqgF7gRoKgRNW8Zoi1ty4A: bets $5
7H5WkGzGvsv56y1iaqHvRg: raises $11.20 to $16.20 and is all-in
RqgF7gRoKgRNW8Zoi1ty4A: calls $11.20
*** TURN *** [6h 7s 2h] [6c]
*** RIVER *** [6h 7s 2h 6c] [Qc]
*** SHOW DOWN ***
RqgF7gRoKgRNW8Zoi1ty4A: shows [Kc Ks] (two pair, Kings and Sixes)
7H5WkGzGvsv56y1iaqHvRg: mucks hand
RqgF7gRoKgRNW8Zoi1ty4A collected $39.85 from pot
*** SUMMARY ***
Total pot $41.90 | Rake $2.05
Board [6h 7s 2h 6c Qc]
Seat 1: lsLuWlcPA3Rh7kJVLzMh0Q folded before Flop (didn't bet)
Seat 2: RqgF7gRoKgRNW8Zoi1ty4A showed [Kc Ks] and won ($39.85) with two pair, Kings and Sixes
Seat 3: 7H5WkGzGvsv56y1iaqHvRg mucked
Seat 4: 4OO5v3AVduL0tePNx8wk5A (button) folded before Flop (didn't bet)
Seat 5: +7hFKAL0b0O/n8G72TclJA (small blind) folded before Flop
Seat 6: YfsTQsY/fxb+YqbdclTHuw (big blind) folded before Flop



PokerStars Game #59940444906:  Hold'em No Limit ($0.50/$1.00) - 2009/07/01 1:06:49 ET
Table 'MUPc8FEpe/nR0BKSeReX6Q' 6-max Seat #3 is the button
Seat 1: qhkK6+yCciTRd+rCFEbnEQ ($41.70 in chips)
Seat 2: xAU6q2/cwmby2sxmA8VcmA ($116.20 in chips)
Seat 3: wx3sQGkVi2x9wJXuWNHPBw ($235.95 in chips)
Seat 4: ZA1bp6g8IwtTxkUE4eCjDQ ($195.65 in chips)
Seat 5: UBZQqpnJZdTYYY1FTb0rLA ($100 in chips)
Seat 6: oxnw0GLLpFanjhGkxfRSqA ($29.15 in chips)
ZA1bp6g8IwtTxkUE4eCjDQ: posts small blind $0.50
UBZQqpnJZdTYYY1FTb0rLA: posts big blind $1
*** HOLE CARDS ***
oxnw0GLLpFanjhGkxfRSqA: folds
qhkK6+yCciTRd+rCFEbnEQ: folds
xAU6q2/cwmby2sxmA8VcmA: folds
wx3sQGkVi2x9wJXuWNHPBw has timed out
wx3sQGkVi2x9wJXuWNHPBw: folds
wx3sQGkVi2x9wJXuWNHPBw is sitting out
ZA1bp6g8IwtTxkUE4eCjDQ: folds
oxnw0GLLpFanjhGkxfRSqA said, "this is the donkey table"
UBZQqpnJZdTYYY1FTb0rLA collected $1 from pot
UBZQqpnJZdTYYY1FTb0rLA: doesn't show hand
*** SUMMARY ***
Total pot $1 | Rake $0
Seat 1: qhkK6+yCciTRd+rCFEbnEQ folded before Flop (didn't bet)
Seat 2: xAU6q2/cwmby2sxmA8VcmA folded before Flop (didn't bet)
Seat 3: wx3sQGkVi2x9wJXuWNHPBw (button) folded before Flop (didn't bet)
Seat 4: ZA1bp6g8IwtTxkUE4eCjDQ (small blind) folded before Flop
Seat 5: UBZQqpnJZdTYYY1FTb0rLA (big blind) collected ($1)
Seat 6: oxnw0GLLpFanjhGkxfRSqA folded before Flop (didn't bet)



PokerStars Game #59940444472:  Hold'em No Limit ($0.50/$1.00) - 2009/07/01 1:06:49 ET
Table 'JTT1XWaDZHSaMZQK7cR5uw' 2-max Seat #1 is the button
Seat 1: OLplZF6FEnLflv81Hz+Fxg ($127.45 in chips)
Seat 2: BcqgegiOUxmBD3F3umsljg ($80.25 in chips)
OLplZF6FEnLflv81Hz+Fxg: posts small blind $0.50
BcqgegiOUxmBD3F3umsljg: posts big blind $1
*** HOLE CARDS ***
OLplZF6FEnLflv81Hz+Fxg: raises $2 to $3
BcqgegiOUxmBD3F3umsljg: calls $2
*** FLOP *** [Td 6s 4h]
BcqgegiOUxmBD3F3umsljg: bets $3
OLplZF6FEnLflv81Hz+Fxg: calls $3
*** TURN *** [Td 6s 4h] [Tc]
BcqgegiOUxmBD3F3umsljg: checks
OLplZF6FEnLflv81Hz+Fxg: checks
*** RIVER *** [Td 6s 4h Tc] [Ad]
BcqgegiOUxmBD3F3umsljg: checks
OLplZF6FEnLflv81Hz+Fxg: checks
*** SHOW DOWN ***
BcqgegiOUxmBD3F3umsljg: shows [6h Kc] (two pair, Tens and Sixes)
OLplZF6FEnLflv81Hz+Fxg: mucks hand
BcqgegiOUxmBD3F3umsljg collected $11.50 from pot
*** SUMMARY ***
Total pot $12 | Rake $0.50
Board [Td 6s 4h Tc Ad]
Seat 1: OLplZF6FEnLflv81Hz+Fxg (button) (small blind) mucked
Seat 2: BcqgegiOUxmBD3F3umsljg (big blind) showed [6h Kc] and won ($11.50) with two pair, Tens and Sixes



PokerStars Game #59940445470:  Hold'em No Limit ($0.50/$1.00) - 2009/07/01 1:06:50 ET
Table 'vs/5jr6ciwjVQ5+Soc+u2A' 6-max Seat #4 is the button
Seat 1: /P4w1pHg2zHYg/4ubJ0dPw ($61.80 in chips)
Seat 2: lXX4W7m3u++JiSOZ46yVMQ ($100 in chips)
Seat 3: G5ZSSN6RSON3gkNvk/SmYg ($158.35 in chips)
Seat 4: wk6Ohn4GDozoOMHc4eb2rw ($82.15 in chips)
Seat 5: +Nt3OPk3XR9SKjZgm2CexQ ($106.45 in chips)
Seat 6: Z2fXsGcjl+Eax+RzOgwOmg ($100 in chips)
+Nt3OPk3XR9SKjZgm2CexQ: posts small blind $0.50
Z2fXsGcjl+Eax+RzOgwOmg: posts big blind $1
*** HOLE CARDS ***
/P4w1pHg2zHYg/4ubJ0dPw: folds
lXX4W7m3u++JiSOZ46yVMQ: raises $2 to $3
G5ZSSN6RSON3gkNvk/SmYg: calls $3
wk6Ohn4GDozoOMHc4eb2rw: calls $3
+Nt3OPk3XR9SKjZgm2CexQ: folds
Z2fXsGcjl+Eax+RzOgwOmg: folds
*** FLOP *** [Jc 5s 4s]
lXX4W7m3u++JiSOZ46yVMQ: bets $7
G5ZSSN6RSON3gkNvk/SmYg: folds
wk6Ohn4GDozoOMHc4eb2rw: folds
lXX4W7m3u++JiSOZ46yVMQ collected $10 from pot
*** SUMMARY ***
Total pot $10.50 | Rake $0.50
Board [Jc 5s 4s]
Seat 1: /P4w1pHg2zHYg/4ubJ0dPw folded before Flop (didn't bet)
Seat 2: lXX4W7m3u++JiSOZ46yVMQ collected ($10)
Seat 3: G5ZSSN6RSON3gkNvk/SmYg folded on the Flop
Seat 4: wk6Ohn4GDozoOMHc4eb2rw (button) folded on the Flop
Seat 5: +Nt3OPk3XR9SKjZgm2CexQ (small blind) folded before Flop
Seat 6: Z2fXsGcjl+Eax+RzOgwOmg (big blind) folded before Flop



PokerStars Game #59940448358:  Hold'em No Limit ($0.50/$1.00) - 2009/07/01 1:06:55 ET
Table 'O96CPOtvMBWP6kzuYDfdFA' 6-max Seat #6 is the button
Seat 1: 6alLXQIITA2EZ/lBeym8Dw ($126.55 in chips)
Seat 4: /P4w1pHg2zHYg/4ubJ0dPw ($64.55 in chips)
Seat 5: G5ZSSN6RSON3gkNvk/SmYg ($100 in chips)
Seat 6: GYei5jXGWexiJYbAT2fELg ($20 in chips)
6alLXQIITA2EZ/lBeym8Dw: posts small blind $0.50
/P4w1pHg2zHYg/4ubJ0dPw: posts big blind $1
*** HOLE CARDS ***
G5ZSSN6RSON3gkNvk/SmYg: folds
GYei5jXGWexiJYbAT2fELg: folds
4d1rWhpu8DzLmzMbR3QKyA has returned
6alLXQIITA2EZ/lBeym8Dw: folds
/P4w1pHg2zHYg/4ubJ0dPw collected $1 from pot
*** SUMMARY ***
Total pot $1 | Rake $0
Seat 1: 6alLXQIITA2EZ/lBeym8Dw (small blind) folded before Flop
Seat 4: /P4w1pHg2zHYg/4ubJ0dPw (big blind) collected ($1)
Seat 5: G5ZSSN6RSON3gkNvk/SmYg folded before Flop (didn't bet)
Seat 6: GYei5jXGWexiJYbAT2fELg (button) folded before Flop (didn't bet)



PokerStars Game #59940448734:  Hold'em No Limit ($0.50/$1.00) - 2009/07/01 1:06:56 ET
Table 'CASNP0uy1C+jGLml/I4PtA' 9-max Seat #8 is the button
Seat 1: tkdBeXTJlFsZdioidNqLow ($60 in chips)
Seat 3: bJckevFOcg//s0qyMQI6sQ ($102.40 in chips)
Seat 4: B/G0GJacqZ8K59/ZVdq4kQ ($53.70 in chips)
Seat 5: Jjc7EHWzs4//xUAjJ0UWoA ($14.50 in chips)
Seat 6: FJEywSpo5JbRKByzmweboA ($100 in chips)
Seat 8: L9njYvloJ1NdXjP8edHEAg ($100 in chips)
Seat 9: Pp/KTcXkfZKKUHkjyaLTdg ($20.50 in chips)
Pp/KTcXkfZKKUHkjyaLTdg: posts small blind $0.50
tkdBeXTJlFsZdioidNqLow: posts big blind $1
*** HOLE CARDS ***
bJckevFOcg//s0qyMQI6sQ: folds
B/G0GJacqZ8K59/ZVdq4kQ: folds
Jjc7EHWzs4//xUAjJ0UWoA: folds
FJEywSpo5JbRKByzmweboA: folds
L9njYvloJ1NdXjP8edHEAg: folds
Pp/KTcXkfZKKUHkjyaLTdg: folds
tkdBeXTJlFsZdioidNqLow collected $1 from pot
*** SUMMARY ***
Total pot $1 | Rake $0
Seat 1: tkdBeXTJlFsZdioidNqLow (big blind) collected ($1)
Seat 3: bJckevFOcg//s0qyMQI6sQ folded before Flop (didn't bet)
Seat 4: B/G0GJacqZ8K59/ZVdq4kQ folded before Flop (didn't bet)
Seat 5: Jjc7EHWzs4//xUAjJ0UWoA folded before Flop (didn't bet)
Seat 6: FJEywSpo5JbRKByzmweboA folded before Flop (didn't bet)
Seat 8: L9njYvloJ1NdXjP8edHEAg (button) folded before Flop (didn't bet)
Seat 9: Pp/KTcXkfZKKUHkjyaLTdg (small blind) folded before Flop



PokerStars Game #59940450470:  Hold'em No Limit ($0.50/$1.00) - 2009/07/01 1:06:59 ET
Table 'hdVBCnDy5t2X9dZo0AvD9w' 9-max Seat #3 is the button
Seat 1: sa/cZBFh73L9TapFXpn3BA ($59.25 in chips)
Seat 2: Ogn4JDV3mp4ZDKO49IFzKA ($18.50 in chips)
Seat 3: 1862487932 ($100 in chips)
Seat 4: YvSugbFKWSuAYx9iokQwUQ ($70.50 in chips)
Seat 5: H+DVy3Ei8L1UKS2tVOtJcw ($100 in chips)
Seat 6: bJckevFOcg//s0qyMQI6sQ ($101.50 in chips)
Seat 7: KqC3XiX79XzqwhoOYPVb4w ($168.55 in chips)
Seat 8: gUUvmqdVlmvpal6B8nYrmg ($144.90 in chips)
Seat 9: AMkLbywdoc0K30BTzaIfTQ ($187.90 in chips)
YvSugbFKWSuAYx9iokQwUQ: posts small blind $0.50
H+DVy3Ei8L1UKS2tVOtJcw: posts big blind $1
*** HOLE CARDS ***
bJckevFOcg//s0qyMQI6sQ: folds
KqC3XiX79XzqwhoOYPVb4w: calls $1
gUUvmqdVlmvpal6B8nYrmg: calls $1
AMkLbywdoc0K30BTzaIfTQ: folds
sa/cZBFh73L9TapFXpn3BA: raises $3 to $4
Ogn4JDV3mp4ZDKO49IFzKA: folds
1862487932: folds
YvSugbFKWSuAYx9iokQwUQ: folds
H+DVy3Ei8L1UKS2tVOtJcw: folds
KqC3XiX79XzqwhoOYPVb4w: calls $3
gUUvmqdVlmvpal6B8nYrmg: calls $3
*** FLOP *** [Td 4s 8d]
KqC3XiX79XzqwhoOYPVb4w: checks
gUUvmqdVlmvpal6B8nYrmg: checks
sa/cZBFh73L9TapFXpn3BA: bets $5
KqC3XiX79XzqwhoOYPVb4w: folds
gUUvmqdVlmvpal6B8nYrmg: folds
sa/cZBFh73L9TapFXpn3BA collected $12.85 from pot
*** SUMMARY ***
Total pot $13.50 | Rake $0.65
Board [Td 4s 8d]
Seat 1: sa/cZBFh73L9TapFXpn3BA collected ($12.85)
Seat 2: Ogn4JDV3mp4ZDKO49IFzKA folded before Flop (didn't bet)
Seat 3: 1862487932 (button) folded before Flop (didn't bet)
Seat 4: YvSugbFKWSuAYx9iokQwUQ (small blind) folded before Flop
Seat 5: H+DVy3Ei8L1UKS2tVOtJcw (big blind) folded before Flop
Seat 6: bJckevFOcg//s0qyMQI6sQ folded before Flop (didn't bet)
Seat 7: KqC3XiX79XzqwhoOYPVb4w folded on the Flop
Seat 8: gUUvmqdVlmvpal6B8nYrmg folded on the Flop
Seat 9: AMkLbywdoc0K30BTzaIfTQ folded before Flop (didn't bet)



PokerStars Game #59940451384:  Hold'em No Limit ($0.50/$1.00) - 2009/07/01 1:07:00 ET
Table 'fTlPiCj0utgzC/5io+I7ew' 6-max Seat #6 is the button
Seat 1: YMJG+F++3Aj6P8dAWda5fw ($103.35 in chips)
Seat 2: Qy/UBNbD2HaA0Ogxg8Sf3w ($122.35 in chips)
Seat 4: uJVSceLggtsrJya+WtmUEA ($185.65 in chips)
Seat 5: GC5g2ryXV7e4TTqmaxUofw ($52.70 in chips)
Seat 6: /P4w1pHg2zHYg/4ubJ0dPw ($67.55 in chips)
YMJG+F++3Aj6P8dAWda5fw: posts small blind $0.50
Qy/UBNbD2HaA0Ogxg8Sf3w: posts big blind $1
Z2fXsGcjl+Eax+RzOgwOmg: sits out
*** HOLE CARDS ***
uJVSceLggtsrJya+WtmUEA: raises $2 to $3
GC5g2ryXV7e4TTqmaxUofw: folds
/P4w1pHg2zHYg/4ubJ0dPw: folds
YMJG+F++3Aj6P8dAWda5fw: folds
Qy/UBNbD2HaA0Ogxg8Sf3w: folds
uJVSceLggtsrJya+WtmUEA collected $2.50 from pot
*** SUMMARY ***
Total pot $2.50 | Rake $0
Seat 1: YMJG+F++3Aj6P8dAWda5fw (small blind) folded before Flop
Seat 2: Qy/UBNbD2HaA0Ogxg8Sf3w (big blind) folded before Flop
Seat 4: uJVSceLggtsrJya+WtmUEA collected ($2.50)
Seat 5: GC5g2ryXV7e4TTqmaxUofw folded before Flop (didn't bet)
Seat 6: /P4w1pHg2zHYg/4ubJ0dPw (button) folded before Flop (didn't bet)



PokerStars Game #59940453530:  Hold'em No Limit ($0.50/$1.00) - 2009/07/01 1:07:04 ET
Table 'tyUh+jyNvrceIQdKMJjQ2wZFWj23PMihdwrNWv41OG/Qeat #1 is the button
Seat 1: o8A5MUdudVKu+pAwgZOX2w ($113.90 in chips)
Seat 2: 5uy3EN+iIYkgwbWZFTUBAQ ($100 in chips)
Seat 3: TalCiLYHCd+ffkmR3auPvA ($74.60 in chips)
Seat 5: j7NIOHLZk7V2o9fOioO5ug ($125.20 in chips)
Seat 6: 4OO5v3AVduL0tePNx8wk5A ($100 in chips)
5uy3EN+iIYkgwbWZFTUBAQ: posts small blind $0.50
TalCiLYHCd+ffkmR3auPvA: posts big blind $1
*** HOLE CARDS ***
j7NIOHLZk7V2o9fOioO5ug: raises $2 to $3
4OO5v3AVduL0tePNx8wk5A: folds
o8A5MUdudVKu+pAwgZOX2w: folds
5uy3EN+iIYkgwbWZFTUBAQ: folds
TalCiLYHCd+ffkmR3auPvA: calls $2
*** FLOP *** [Kd 2d 6h]
TalCiLYHCd+ffkmR3auPvA: checks
j7NIOHLZk7V2o9fOioO5ug: bets $5
TalCiLYHCd+ffkmR3auPvA: folds
j7NIOHLZk7V2o9fOioO5ug collected $6.20 from pot
j7NIOHLZk7V2o9fOioO5ug: doesn't show hand
*** SUMMARY ***
Total pot $6.50 | Rake $0.30
Board [Kd 2d 6h]
Seat 1: o8A5MUdudVKu+pAwgZOX2w (button) folded before Flop (didn't bet)
Seat 2: 5uy3EN+iIYkgwbWZFTUBAQ (small blind) folded before Flop
Seat 3: TalCiLYHCd+ffkmR3auPvA (big blind) folded on the Flop
Seat 5: j7NIOHLZk7V2o9fOioO5ug collected ($6.20)
Seat 6: 4OO5v3AVduL0tePNx8wk5A folded before Flop (didn't bet)



PokerStars Game #59940454056:  Hold'em No Limit ($0.50/$1.00) - 2009/07/01 1:07:05 ET
Table 'SQLOQoANiHscJ8AL7zffbw' 9-max Seat #3 is the button
Seat 1: jPTRd6SpCp4xqAy2XQiTOw ($67.90 in chips)
Seat 2: /zy+DB4S5fUQUSfZWFzYGw ($329.90 in chips)
Seat 3: 0eFnow7+D7veCYQ+CG9FFw ($91.85 in chips)
Seat 4: /mfensKw8/iZ1Vrx33S4xg ($20.50 in chips)
Seat 5: L9njYvloJ1NdXjP8edHEAg ($109.15 in chips)
Seat 7: bJckevFOcg//s0qyMQI6sQ ($104.55 in chips)
Seat 8: 2BV+oJIQYr65IO6nEChvbA ($60 in chips)
Seat 9: qJr25HAtvv1w/7IBvjMM3g ($200.15 in chips)
/mfensKw8/iZ1Vrx33S4xg: posts small blind $0.50
L9njYvloJ1NdXjP8edHEAg: posts big blind $1
H+DVy3Ei8L1UKS2tVOtJcw: sits out
*** HOLE CARDS ***
bJckevFOcg//s0qyMQI6sQ: folds
2BV+oJIQYr65IO6nEChvbA: folds
qJr25HAtvv1w/7IBvjMM3g: folds
/mfensKw8/iZ1Vrx33S4xg said, "we have jerks here"
jPTRd6SpCp4xqAy2XQiTOw has timed out
jPTRd6SpCp4xqAy2XQiTOw: folds
jPTRd6SpCp4xqAy2XQiTOw is sitting out
/zy+DB4S5fUQUSfZWFzYGw: folds
0eFnow7+D7veCYQ+CG9FFw: raises $2 to $3
/mfensKw8/iZ1Vrx33S4xg: calls $2.50
jPTRd6SpCp4xqAy2XQiTOw has returned
jPTRd6SpCp4xqAy2XQiTOw said, "just wanna take my time like maker and KetK"
L9njYvloJ1NdXjP8edHEAg: folds
*** FLOP *** [7h 9d 9c]
/mfensKw8/iZ1Vrx33S4xg: checks
0eFnow7+D7veCYQ+CG9FFw: checks
*** TURN *** [7h 9d 9c] [Qh]
jPTRd6SpCp4xqAy2XQiTOw said, "takes maker 15 sec to post her blind"
/mfensKw8/iZ1Vrx33S4xg said, "k please be faster"
/mfensKw8/iZ1Vrx33S4xg: checks
0eFnow7+D7veCYQ+CG9FFw: bets $4
/mfensKw8/iZ1Vrx33S4xg: folds
0eFnow7+D7veCYQ+CG9FFw collected $6.65 from pot
*** SUMMARY ***
Total pot $7 | Rake $0.35
Board [7h 9d 9c Qh]
Seat 1: jPTRd6SpCp4xqAy2XQiTOw folded before Flop (didn't bet)
Seat 2: /zy+DB4S5fUQUSfZWFzYGw folded before Flop (didn't bet)
Seat 3: 0eFnow7+D7veCYQ+CG9FFw (button) collected ($6.65)
Seat 4: /mfensKw8/iZ1Vrx33S4xg (small blind) folded on the Turn
Seat 5: L9njYvloJ1NdXjP8edHEAg (big blind) folded before Flop
Seat 7: bJckevFOcg//s0qyMQI6sQ folded before Flop (didn't bet)
Seat 8: 2BV+oJIQYr65IO6nEChvbA folded before Flop (didn't bet)
Seat 9: qJr25HAtvv1w/7IBvjMM3g folded before Flop (didn't bet)



PokerStars Game #59940454286:  Hold'em No Limit ($0.50/$1.00) - 2009/07/01 1:07:05 ET
Table 'Zka9tv1yilg0MvXWPQrShg' 9-max Seat #3 is the button
Seat 2: kz9ziSiGUc+857heiKSayw ($21.20 in chips)
Seat 3: gUUvmqdVlmvpal6B8nYrmg ($106.45 in chips)
Seat 5: /zy+DB4S5fUQUSfZWFzYGw ($111.60 in chips)
Seat 6: rY8wPoax1lS+HUY+I0FZDw ($160.60 in chips)
Seat 7: p1SafS90nb3Uft5LB0NkHw ($25 in chips)
Seat 8: D+W9Me7w6Hcx/WRUSKV0dw ($18.50 in chips)
Seat 9: 6daxhj43mWj04MOPTOmaYA ($106.40 in chips)
/zy+DB4S5fUQUSfZWFzYGw: posts small blind $0.50
rY8wPoax1lS+HUY+I0FZDw: posts big blind $1
*** HOLE CARDS ***
p1SafS90nb3Uft5LB0NkHw: folds
D+W9Me7w6Hcx/WRUSKV0dw: folds
p1SafS90nb3Uft5LB0NkHw leaves the table
6daxhj43mWj04MOPTOmaYA: folds
kz9ziSiGUc+857heiKSayw: folds
gUUvmqdVlmvpal6B8nYrmg: raises $2 to $3
/zy+DB4S5fUQUSfZWFzYGw: folds
rY8wPoax1lS+HUY+I0FZDw: calls $2
*** FLOP *** [3h 3s Kc]
rY8wPoax1lS+HUY+I0FZDw: checks
gUUvmqdVlmvpal6B8nYrmg: bets $4
rY8wPoax1lS+HUY+I0FZDw: calls $4
*** TURN *** [3h 3s Kc] [7c]
rY8wPoax1lS+HUY+I0FZDw: checks
gUUvmqdVlmvpal6B8nYrmg: checks
*** RIVER *** [3h 3s Kc 7c] [Ah]
rY8wPoax1lS+HUY+I0FZDw: checks
gUUvmqdVlmvpal6B8nYrmg: checks
*** SHOW DOWN ***
rY8wPoax1lS+HUY+I0FZDw: shows [Kd Qd] (two pair, Kings and Threes)
gUUvmqdVlmvpal6B8nYrmg: mucks hand
rY8wPoax1lS+HUY+I0FZDw collected $13.80 from pot
*** SUMMARY ***
Total pot $14.50 | Rake $0.70
Board [3h 3s Kc 7c Ah]
Seat 2: kz9ziSiGUc+857heiKSayw folded before Flop (didn't bet)
Seat 3: gUUvmqdVlmvpal6B8nYrmg (button) mucked
Seat 5: /zy+DB4S5fUQUSfZWFzYGw (small blind) folded before Flop
Seat 6: rY8wPoax1lS+HUY+I0FZDw (big blind) showed [Kd Qd] and won ($13.80) with two pair, Kings and Threes
Seat 7: p1SafS90nb3Uft5LB0NkHw folded before Flop (didn't bet)
Seat 8: D+W9Me7w6Hcx/WRUSKV0dw folded before Flop (didn't bet)
Seat 9: 6daxhj43mWj04MOPTOmaYA folded before Flop (didn't bet)



PokerStars Game #59940454566:  Hold'em No Limit ($0.50/$1.00) - 2009/07/01 1:07:06 ET
Table '7O9fB8yx1u7sJveJn8w6jA' 6-max Seat #4 is the button
Seat 1: jy52+7FotjH63o5tEEVgKw ($102.85 in chips)
Seat 2: wx3sQGkVi2x9wJXuWNHPBw ($187.95 in chips)
Seat 3: hpxXcmRkXXI9HE5+5/j/0Q ($104.20 in chips)
Seat 4: XIZSmlGttGgSRaIU42K4Fg ($146.20 in chips)
Seat 5: BCEV3COoKY607AzLWayfRA ($108.30 in chips)
BCEV3COoKY607AzLWayfRA: posts small blind $0.50
UBZQqpnJZdTYYY1FTb0rLA: is sitting out
jy52+7FotjH63o5tEEVgKw: posts big blind $1
*** HOLE CARDS ***
wx3sQGkVi2x9wJXuWNHPBw: folds
hpxXcmRkXXI9HE5+5/j/0Q: folds
UBZQqpnJZdTYYY1FTb0rLA leaves the table
XIZSmlGttGgSRaIU42K4Fg: calls $1
BCEV3COoKY607AzLWayfRA: folds
jy52+7FotjH63o5tEEVgKw: checks
*** FLOP *** [4c 8d 5s]
jy52+7FotjH63o5tEEVgKw: checks
XIZSmlGttGgSRaIU42K4Fg: bets $2
jy52+7FotjH63o5tEEVgKw: calls $2
*** TURN *** [4c 8d 5s] [Ac]
jy52+7FotjH63o5tEEVgKw: checks
XIZSmlGttGgSRaIU42K4Fg: bets $4
jy52+7FotjH63o5tEEVgKw: folds
XIZSmlGttGgSRaIU42K4Fg collected $6.20 from pot
*** SUMMARY ***
Total pot $6.50 | Rake $0.30
Board [4c 8d 5s Ac]
Seat 1: jy52+7FotjH63o5tEEVgKw (big blind) folded on the Turn
Seat 2: wx3sQGkVi2x9wJXuWNHPBw folded before Flop (didn't bet)
Seat 3: hpxXcmRkXXI9HE5+5/j/0Q folded before Flop (didn't bet)
Seat 4: XIZSmlGttGgSRaIU42K4Fg (button) collected ($6.20)
Seat 5: BCEV3COoKY607AzLWayfRA (small blind) folded before Flop



PokerStars Game #59940456488:  Hold'em No Limit ($0.50/$1.00) - 2009/07/01 1:07:09 ET
Table 'GxCPo/gd3OSthkYrAxJngg' 6-max Seat #4 is the button
Seat 1: sH8BpAFP+jGFxCgVpD1Lew ($268.40 in chips)
Seat 2: YExX2paeIHrmfIwV1ivM/w ($70.60 in chips)
Seat 3: o6plE+MSW4XFNTeONe16xg ($21.60 in chips)
Seat 4: YMJG+F++3Aj6P8dAWda5fw ($202.25 in chips)
Seat 5: G5ZSSN6RSON3gkNvk/SmYg ($116.60 in chips)
Seat 6: 4d1rWhpu8DzLmzMbR3QKyA ($100 in chips)
G5ZSSN6RSON3gkNvk/SmYg: posts small blind $0.50
4d1rWhpu8DzLmzMbR3QKyA: posts big blind $1
*** HOLE CARDS ***
sH8BpAFP+jGFxCgVpD1Lew: folds
YExX2paeIHrmfIwV1ivM/w: folds
o6plE+MSW4XFNTeONe16xg: calls $1
YMJG+F++3Aj6P8dAWda5fw: folds
G5ZSSN6RSON3gkNvk/SmYg: folds
4d1rWhpu8DzLmzMbR3QKyA: checks
*** FLOP *** [2c 8c 4s]
4d1rWhpu8DzLmzMbR3QKyA: bets $2
o6plE+MSW4XFNTeONe16xg: calls $2
*** TURN *** [2c 8c 4s] [Qd]
4d1rWhpu8DzLmzMbR3QKyA: bets $5
o6plE+MSW4XFNTeONe16xg: folds
4d1rWhpu8DzLmzMbR3QKyA collected $6.20 from pot
4d1rWhpu8DzLmzMbR3QKyA: doesn't show hand
*** SUMMARY ***
Total pot $6.50 | Rake $0.30
Board [2c 8c 4s Qd]
Seat 1: sH8BpAFP+jGFxCgVpD1Lew folded before Flop (didn't bet)
Seat 2: YExX2paeIHrmfIwV1ivM/w folded before Flop (didn't bet)
Seat 3: o6plE+MSW4XFNTeONe16xg folded on the Turn
Seat 4: YMJG+F++3Aj6P8dAWda5fw (button) folded before Flop (didn't bet)
Seat 5: G5ZSSN6RSON3gkNvk/SmYg (small blind) folded before Flop
Seat 6: 4d1rWhpu8DzLmzMbR3QKyA (big blind) collected ($6.20)



PokerStars Game #59940457034:  Hold'em No Limit ($0.50/$1.00) - 2009/07/01 1:07:10 ET
Table 'pHrhryH8jPNdQfY62f8v+g' 6-max Seat #2 is the button
Seat 2: RqgF7gRoKgRNW8Zoi1ty4A ($141 in chips)
Seat 3: 8oS5O7iD/qnFXFXJrGIgNQ ($100 in chips)
Seat 4: 1f3beyIML24UqEMTbWy93g ($50 in chips)
Seat 5: r1/R7y0Ortgoz4lccgW8VA ($41.05 in chips)
Seat 6: xAU6q2/cwmby2sxmA8VcmA ($208.10 in chips)
8oS5O7iD/qnFXFXJrGIgNQ: posts small blind $0.50
1f3beyIML24UqEMTbWy93g: posts big blind $1
4d1rWhpu8DzLmzMbR3QKyA: sits out
*** HOLE CARDS ***
r1/R7y0Ortgoz4lccgW8VA: folds
xAU6q2/cwmby2sxmA8VcmA: folds
RqgF7gRoKgRNW8Zoi1ty4A: folds
8oS5O7iD/qnFXFXJrGIgNQ: calls $0.50
1f3beyIML24UqEMTbWy93g: raises $2 to $3
8oS5O7iD/qnFXFXJrGIgNQ: calls $2
*** FLOP *** [Qh 6s 8c]
8oS5O7iD/qnFXFXJrGIgNQ: checks
1f3beyIML24UqEMTbWy93g: bets $4
8oS5O7iD/qnFXFXJrGIgNQ: folds
1f3beyIML24UqEMTbWy93g collected $5.70 from pot
*** SUMMARY ***
Total pot $6 | Rake $0.30
Board [Qh 6s 8c]
Seat 2: RqgF7gRoKgRNW8Zoi1ty4A (button) folded before Flop (didn't bet)
Seat 3: 8oS5O7iD/qnFXFXJrGIgNQ (small blind) folded on the Flop
Seat 4: 1f3beyIML24UqEMTbWy93g (big blind) collected ($5.70)
Seat 5: r1/R7y0Ortgoz4lccgW8VA folded before Flop (didn't bet)
Seat 6: xAU6q2/cwmby2sxmA8VcmA folded before Flop (didn't bet)



PokerStars Game #59940457756:  Hold'em No Limit ($0.50/$1.00) - 2009/07/01 1:07:11 ET
Table 'O96CPOtvMBWP6kzuYDfdFA' 6-max Seat #1 is the button
Seat 1: 6alLXQIITA2EZ/lBeym8Dw ($126.05 in chips)
Seat 4: /P4w1pHg2zHYg/4ubJ0dPw ($65.05 in chips)
Seat 5: G5ZSSN6RSON3gkNvk/SmYg ($100 in chips)
Seat 6: GYei5jXGWexiJYbAT2fELg ($20 in chips)
4d1rWhpu8DzLmzMbR3QKyA will be allowed to play after the button
/P4w1pHg2zHYg/4ubJ0dPw: posts small blind $0.50
G5ZSSN6RSON3gkNvk/SmYg: posts big blind $1
*** HOLE CARDS ***
GYei5jXGWexiJYbAT2fELg: folds
6alLXQIITA2EZ/lBeym8Dw: folds
/P4w1pHg2zHYg/4ubJ0dPw: raises $2 to $3
G5ZSSN6RSON3gkNvk/SmYg: calls $2
*** FLOP *** [Ac 6s Td]
/P4w1pHg2zHYg/4ubJ0dPw: checks
G5ZSSN6RSON3gkNvk/SmYg: checks
*** TURN *** [Ac 6s Td] [3d]
/P4w1pHg2zHYg/4ubJ0dPw: checks
G5ZSSN6RSON3gkNvk/SmYg: bets $4
/P4w1pHg2zHYg/4ubJ0dPw: folds
G5ZSSN6RSON3gkNvk/SmYg collected $5.70 from pot
*** SUMMARY ***
Total pot $6 | Rake $0.30
Board [Ac 6s Td 3d]
Seat 1: 6alLXQIITA2EZ/lBeym8Dw (button) folded before Flop (didn't bet)
Seat 4: /P4w1pHg2zHYg/4ubJ0dPw (small blind) folded on the Turn
Seat 5: G5ZSSN6RSON3gkNvk/SmYg (big blind) collected ($5.70)
Seat 6: GYei5jXGWexiJYbAT2fELg folded before Flop (didn't bet)



PokerStars Game #59940457380:  Hold'em No Limit ($0.50/$1.00) - 2009/07/01 1:07:11 ET
Table '7Nl0ffnjeK44/vmeexh3MQ' 9-max Seat #5 is the button
Seat 1: s7D3Y+k4Cj4D1cXHv7oj+Q ($93.85 in chips)
Seat 2: OGgaARGdJQT4awWVNQ957w ($100 in chips)
Seat 3: JMmUYT5pIKCKh2pGjCB/4w ($37 in chips)
Seat 4: bLbSOSmSOnqE0iTcH/5dxA ($100 in chips)
Seat 5: 61sfw5QTu62YYIt68OsdrA ($64.90 in chips)
Seat 6: FVs16t7GgfWgQWt4JxsObQ ($50.85 in chips)
Seat 7: 997ViqAtWn1FPjJqcffwcA ($100 in chips)
Seat 8: D+W9Me7w6Hcx/WRUSKV0dw ($19.75 in chips)
Seat 9: ouwUBGRKnKK9uhn1G4Lf+A ($195.50 in chips)
FVs16t7GgfWgQWt4JxsObQ: posts small blind $0.50
997ViqAtWn1FPjJqcffwcA: posts big blind $1
*** HOLE CARDS ***
D+W9Me7w6Hcx/WRUSKV0dw: folds
ouwUBGRKnKK9uhn1G4Lf+A: folds
s7D3Y+k4Cj4D1cXHv7oj+Q: raises $2 to $3
OGgaARGdJQT4awWVNQ957w: folds
JMmUYT5pIKCKh2pGjCB/4w: folds
bLbSOSmSOnqE0iTcH/5dxA: calls $3
61sfw5QTu62YYIt68OsdrA: folds
FVs16t7GgfWgQWt4JxsObQ: folds
997ViqAtWn1FPjJqcffwcA: folds
*** FLOP *** [Jh Kd 4c]
s7D3Y+k4Cj4D1cXHv7oj+Q: checks
bLbSOSmSOnqE0iTcH/5dxA: bets $5
s7D3Y+k4Cj4D1cXHv7oj+Q: folds
bLbSOSmSOnqE0iTcH/5dxA collected $7.15 from pot
bLbSOSmSOnqE0iTcH/5dxA: doesn't show hand
*** SUMMARY ***
Total pot $7.50 | Rake $0.35
Board [Jh Kd 4c]
Seat 1: s7D3Y+k4Cj4D1cXHv7oj+Q folded on the Flop
Seat 2: OGgaARGdJQT4awWVNQ957w folded before Flop (didn't bet)
Seat 3: JMmUYT5pIKCKh2pGjCB/4w folded before Flop (didn't bet)
Seat 4: bLbSOSmSOnqE0iTcH/5dxA collected ($7.15)
Seat 5: 61sfw5QTu62YYIt68OsdrA (button) folded before Flop (didn't bet)
Seat 6: FVs16t7GgfWgQWt4JxsObQ (small blind) folded before Flop
Seat 7: 997ViqAtWn1FPjJqcffwcA (big blind) folded before Flop
Seat 8: D+W9Me7w6Hcx/WRUSKV0dw folded before Flop (didn't bet)
Seat 9: ouwUBGRKnKK9uhn1G4Lf+A folded before Flop (didn't bet)



PokerStars Game #59940457952:  Hold'em No Limit ($0.50/$1.00) - 2009/07/01 1:07:12 ET
Table 'JTT1XWaDZHSaMZQK7cR5uw' 2-max Seat #2 is the button
Seat 1: OLplZF6FEnLflv81Hz+Fxg ($121.45 in chips)
Seat 2: BcqgegiOUxmBD3F3umsljg ($85.75 in chips)
BcqgegiOUxmBD3F3umsljg: posts small blind $0.50
OLplZF6FEnLflv81Hz+Fxg: posts big blind $1
*** HOLE CARDS ***
BcqgegiOUxmBD3F3umsljg: raises $2 to $3
OLplZF6FEnLflv81Hz+Fxg: folds
BcqgegiOUxmBD3F3umsljg collected $2 from pot
*** SUMMARY ***
Total pot $2 | Rake $0
Seat 1: OLplZF6FEnLflv81Hz+Fxg (big blind) folded before Flop
Seat 2: BcqgegiOUxmBD3F3umsljg (button) (small blind) collected ($2)



PokerStars Game #59940458580:  Hold'em No Limit ($0.50/$1.00) - 2009/07/01 1:07:13 ET
Table 'kS0cTQAEi+fdUlJP2gQYvw' 9-max Seat #5 is the button
Seat 1: c/9X4zftzphFxYtxp5kp9w ($64.35 in chips)
Seat 2: D+W9Me7w6Hcx/WRUSKV0dw ($22.40 in chips)
Seat 3: 2BV+oJIQYr65IO6nEChvbA ($60 in chips)
Seat 5: 997ViqAtWn1FPjJqcffwcA ($102.65 in chips)
Seat 6: yAbu2QsRPVcjPbqlf/jDxw ($125.65 in chips)
Seat 7: Ffa7Nj4X5fddtROP01hfQg ($128.85 in chips)
Seat 8: QYMfy2FoN6/Qe1LWYuI7fw ($26.45 in chips)
Seat 9: OGgaARGdJQT4awWVNQ957w ($102 in chips)
yAbu2QsRPVcjPbqlf/jDxw: posts small blind $0.50
Ffa7Nj4X5fddtROP01hfQg: posts big blind $1
*** HOLE CARDS ***
QYMfy2FoN6/Qe1LWYuI7fw: folds
OGgaARGdJQT4awWVNQ957w: folds
c/9X4zftzphFxYtxp5kp9w: folds
D+W9Me7w6Hcx/WRUSKV0dw: folds
2BV+oJIQYr65IO6nEChvbA: folds
997ViqAtWn1FPjJqcffwcA: folds
yAbu2QsRPVcjPbqlf/jDxw: folds
Ffa7Nj4X5fddtROP01hfQg collected $1 from pot
*** SUMMARY ***
Total pot $1 | Rake $0
Seat 1: c/9X4zftzphFxYtxp5kp9w folded before Flop (didn't bet)
Seat 2: D+W9Me7w6Hcx/WRUSKV0dw folded before Flop (didn't bet)
Seat 3: 2BV+oJIQYr65IO6nEChvbA folded before Flop (didn't bet)
Seat 5: 997ViqAtWn1FPjJqcffwcA (button) folded before Flop (didn't bet)
Seat 6: yAbu2QsRPVcjPbqlf/jDxw (small blind) folded before Flop
Seat 7: Ffa7Nj4X5fddtROP01hfQg (big blind) collected ($1)
Seat 8: QYMfy2FoN6/Qe1LWYuI7fw folded before Flop (didn't bet)
Seat 9: OGgaARGdJQT4awWVNQ957w folded before Flop (didn't bet)



PokerStars Game #59940461654:  Hold'em No Limit ($0.50/$1.00) - 2009/07/01 1:07:18 ET
Table 'QSIig7BLMc9wY/rgBechzw' 6-max Seat #3 is the button
Seat 1: Z2fXsGcjl+Eax+RzOgwOmg ($107 in chips)
Seat 2: mLOIkH/qmRa+mVujQIhBRg ($36.40 in chips)
Seat 3: +xW7QemQU0Fxs+4TnqBRow ($100 in chips)
Seat 4: +uSzP8Jwnw7sKfQ4s66b7w ($86.45 in chips)
Seat 5: lsLuWlcPA3Rh7kJVLzMh0Q ($100 in chips)
Seat 6: PxqfkAMdAWtkgbT+q2gciA ($40.75 in chips)
+uSzP8Jwnw7sKfQ4s66b7w: posts small blind $0.50
lsLuWlcPA3Rh7kJVLzMh0Q: posts big blind $1
*** HOLE CARDS ***
PxqfkAMdAWtkgbT+q2gciA: folds
Z2fXsGcjl+Eax+RzOgwOmg: folds
mLOIkH/qmRa+mVujQIhBRg: calls $1
+xW7QemQU0Fxs+4TnqBRow: folds
+uSzP8Jwnw7sKfQ4s66b7w: calls $0.50
lsLuWlcPA3Rh7kJVLzMh0Q: checks
*** FLOP *** [Jd 5h Kd]
+uSzP8Jwnw7sKfQ4s66b7w: checks
lsLuWlcPA3Rh7kJVLzMh0Q: checks
mLOIkH/qmRa+mVujQIhBRg: bets $2
+uSzP8Jwnw7sKfQ4s66b7w: calls $2
lsLuWlcPA3Rh7kJVLzMh0Q: folds
*** TURN *** [Jd 5h Kd] [9d]
+uSzP8Jwnw7sKfQ4s66b7w: checks
mLOIkH/qmRa+mVujQIhBRg: checks
*** RIVER *** [Jd 5h Kd 9d] [Jh]
+uSzP8Jwnw7sKfQ4s66b7w: checks
mLOIkH/qmRa+mVujQIhBRg: checks
*** SHOW DOWN ***
+uSzP8Jwnw7sKfQ4s66b7w: shows [As Td] (a pair of Jacks)
mLOIkH/qmRa+mVujQIhBRg: shows [5d 7h] (two pair, Jacks and Fives)
mLOIkH/qmRa+mVujQIhBRg collected $6.70 from pot
*** SUMMARY ***
Total pot $7 | Rake $0.30
Board [Jd 5h Kd 9d Jh]
Seat 1: Z2fXsGcjl+Eax+RzOgwOmg folded before Flop (didn't bet)
Seat 2: mLOIkH/qmRa+mVujQIhBRg showed [5d 7h] and won ($6.70) with two pair, Jacks and Fives
Seat 3: +xW7QemQU0Fxs+4TnqBRow (button) folded before Flop (didn't bet)
Seat 4: +uSzP8Jwnw7sKfQ4s66b7w (small blind) showed [As Td] and lost with a pair of Jacks
Seat 5: lsLuWlcPA3Rh7kJVLzMh0Q (big blind) folded on the Flop
Seat 6: PxqfkAMdAWtkgbT+q2gciA folded before Flop (didn't bet)



PokerStars Game #59940461606:  Hold'em No Limit ($0.50/$1.00) - 2009/07/01 1:07:18 ET
Table 'CASNP0uy1C+jGLml/I4PtA' 9-max Seat #9 is the button
Seat 1: tkdBeXTJlFsZdioidNqLow ($60.50 in chips)
Seat 3: bJckevFOcg//s0qyMQI6sQ ($102.40 in chips)
Seat 4: B/G0GJacqZ8K59/ZVdq4kQ ($53.70 in chips)
Seat 5: Jjc7EHWzs4//xUAjJ0UWoA ($14.50 in chips)
Seat 6: FJEywSpo5JbRKByzmweboA ($100 in chips)
Seat 8: L9njYvloJ1NdXjP8edHEAg ($100 in chips)
Seat 9: Pp/KTcXkfZKKUHkjyaLTdg ($20 in chips)
tkdBeXTJlFsZdioidNqLow: posts small blind $0.50
bJckevFOcg//s0qyMQI6sQ: posts big blind $1
*** HOLE CARDS ***
B/G0GJacqZ8K59/ZVdq4kQ: folds
Jjc7EHWzs4//xUAjJ0UWoA: folds
FJEywSpo5JbRKByzmweboA: raises $2.50 to $3.50
RpMNxqeYPSeOh0tflU772w leaves the table
L9njYvloJ1NdXjP8edHEAg: folds
Pp/KTcXkfZKKUHkjyaLTdg: folds
tkdBeXTJlFsZdioidNqLow: folds
bJckevFOcg//s0qyMQI6sQ: folds
FJEywSpo5JbRKByzmweboA collected $2.50 from pot
FJEywSpo5JbRKByzmweboA: doesn't show hand
*** SUMMARY ***
Total pot $2.50 | Rake $0
Seat 1: tkdBeXTJlFsZdioidNqLow (small blind) folded before Flop
Seat 3: bJckevFOcg//s0qyMQI6sQ (big blind) folded before Flop
Seat 4: B/G0GJacqZ8K59/ZVdq4kQ folded before Flop (didn't bet)
Seat 5: Jjc7EHWzs4//xUAjJ0UWoA folded before Flop (didn't bet)
Seat 6: FJEywSpo5JbRKByzmweboA collected ($2.50)
Seat 8: L9njYvloJ1NdXjP8edHEAg folded before Flop (didn't bet)
Seat 9: Pp/KTcXkfZKKUHkjyaLTdg (button) folded before Flop (didn't bet)



PokerStars Game #59940462014:  Hold'em No Limit ($0.50/$1.00) - 2009/07/01 1:07:19 ET
Table '3T4owEKJKyGTMePwrv50FQ' 9-max Seat #3 is the button
Seat 1: OGgaARGdJQT4awWVNQ957w ($101.10 in chips)
Seat 2: t+Id2O6herCLgwnC4m49PA ($38.60 in chips)
Seat 3: DOLzOcBTZYcph5jEfKFWuQ ($105.50 in chips)
Seat 4: O5Go3jrzbQWxRB6ESK+Ptg ($30.60 in chips)
Seat 5: eI48VADSCFoNZBx4T9qs2w ($31.95 in chips)
Seat 6: laA8va+Yv8WuMqT1zdR91g ($100 in chips)
Seat 7: 1862487932 ($101.50 in chips)
Seat 9: 61sfw5QTu62YYIt68OsdrA ($66.95 in chips)
O5Go3jrzbQWxRB6ESK+Ptg: posts small blind $0.50
eI48VADSCFoNZBx4T9qs2w: posts big blind $1
ucTB8uAUcQnKGsA70OSjNA: sits out
*** HOLE CARDS ***
laA8va+Yv8WuMqT1zdR91g: folds
1862487932: raises $2.50 to $3.50
61sfw5QTu62YYIt68OsdrA: folds
OGgaARGdJQT4awWVNQ957w: folds
t+Id2O6herCLgwnC4m49PA: folds
DOLzOcBTZYcph5jEfKFWuQ: folds
O5Go3jrzbQWxRB6ESK+Ptg: folds
eI48VADSCFoNZBx4T9qs2w: folds
1862487932 collected $2.50 from pot
1862487932: doesn't show hand
*** SUMMARY ***
Total pot $2.50 | Rake $0
Seat 1: OGgaARGdJQT4awWVNQ957w folded before Flop (didn't bet)
Seat 2: t+Id2O6herCLgwnC4m49PA folded before Flop (didn't bet)
Seat 3: DOLzOcBTZYcph5jEfKFWuQ (button) folded before Flop (didn't bet)
Seat 4: O5Go3jrzbQWxRB6ESK+Ptg (small blind) folded before Flop
Seat 5: eI48VADSCFoNZBx4T9qs2w (big blind) folded before Flop
Seat 6: laA8va+Yv8WuMqT1zdR91g folded before Flop (didn't bet)
Seat 7: 1862487932 collected ($2.50)
Seat 9: 61sfw5QTu62YYIt68OsdrA folded before Flop (didn't bet)



PokerStars Game #59940463078:  Hold'em No Limit ($0.50/$1.00) - 2009/07/01 1:07:20 ET
Table 'rmZfTK+oSebeUPJNbWhdAA' 6-max Seat #1 is the button
Seat 1: xAU6q2/cwmby2sxmA8VcmA ($147 in chips)
Seat 2: z7O9PO/WEcqRouIydFhS9Q ($135.90 in chips)
Seat 3: BCEV3COoKY607AzLWayfRA ($134 in chips)
Seat 4: 1/mIuXfgx1ZyVkodrmfQDw ($100 in chips)
Seat 5: 5lY8d6Cnm4HUkt/8FZSj4g ($90.25 in chips)
Seat 6: j7NIOHLZk7V2o9fOioO5ug ($103.30 in chips)
z7O9PO/WEcqRouIydFhS9Q: posts small blind $0.50
BCEV3COoKY607AzLWayfRA: posts big blind $1
*** HOLE CARDS ***
1/mIuXfgx1ZyVkodrmfQDw: folds
5lY8d6Cnm4HUkt/8FZSj4g: folds
j7NIOHLZk7V2o9fOioO5ug: raises $2 to $3
xAU6q2/cwmby2sxmA8VcmA: folds
z7O9PO/WEcqRouIydFhS9Q: folds
BCEV3COoKY607AzLWayfRA: folds
j7NIOHLZk7V2o9fOioO5ug collected $2.50 from pot
j7NIOHLZk7V2o9fOioO5ug: doesn't show hand
*** SUMMARY ***
Total pot $2.50 | Rake $0
Seat 1: xAU6q2/cwmby2sxmA8VcmA (button) folded before Flop (didn't bet)
Seat 2: z7O9PO/WEcqRouIydFhS9Q (small blind) folded before Flop
Seat 3: BCEV3COoKY607AzLWayfRA (big blind) folded before Flop
Seat 4: 1/mIuXfgx1ZyVkodrmfQDw folded before Flop (didn't bet)
Seat 5: 5lY8d6Cnm4HUkt/8FZSj4g folded before Flop (didn't bet)
Seat 6: j7NIOHLZk7V2o9fOioO5ug collected ($2.50)



PokerStars Game #59940462820:  Hold'em No Limit ($0.50/$1.00) - 2009/07/01 1:07:20 ET
Table 'JTT1XWaDZHSaMZQK7cR5uw' 2-max Seat #1 is the button
Seat 1: OLplZF6FEnLflv81Hz+Fxg ($120.45 in chips)
Seat 2: BcqgegiOUxmBD3F3umsljg ($86.75 in chips)
OLplZF6FEnLflv81Hz+Fxg: posts small blind $0.50
BcqgegiOUxmBD3F3umsljg: posts big blind $1
*** HOLE CARDS ***
OLplZF6FEnLflv81Hz+Fxg: folds
BcqgegiOUxmBD3F3umsljg collected $1 from pot
*** SUMMARY ***
Total pot $1 | Rake $0
Seat 1: OLplZF6FEnLflv81Hz+Fxg (button) (small blind) folded before Flop
Seat 2: BcqgegiOUxmBD3F3umsljg (big blind) collected ($1)



PokerStars Game #59940463518:  Hold'em No Limit ($0.50/$1.00) - 2009/07/01 1:07:21 ET
Table 'MUPc8FEpe/nR0BKSeReX6Q' 6-max Seat #4 is the button
Seat 1: qhkK6+yCciTRd+rCFEbnEQ ($41.70 in chips)
Seat 2: xAU6q2/cwmby2sxmA8VcmA ($116.20 in chips)
Seat 4: ZA1bp6g8IwtTxkUE4eCjDQ ($195.15 in chips)
Seat 5: UBZQqpnJZdTYYY1FTb0rLA ($100.50 in chips)
Seat 6: oxnw0GLLpFanjhGkxfRSqA ($29.15 in chips)
UBZQqpnJZdTYYY1FTb0rLA: posts small blind $0.50
oxnw0GLLpFanjhGkxfRSqA: posts big blind $1
*** HOLE CARDS ***
qhkK6+yCciTRd+rCFEbnEQ: folds
wx3sQGkVi2x9wJXuWNHPBw has returned
xAU6q2/cwmby2sxmA8VcmA: folds
ZA1bp6g8IwtTxkUE4eCjDQ: folds
UBZQqpnJZdTYYY1FTb0rLA: folds
oxnw0GLLpFanjhGkxfRSqA collected $1 from pot
*** SUMMARY ***
Total pot $1 | Rake $0
Seat 1: qhkK6+yCciTRd+rCFEbnEQ folded before Flop (didn't bet)
Seat 2: xAU6q2/cwmby2sxmA8VcmA folded before Flop (didn't bet)
Seat 4: ZA1bp6g8IwtTxkUE4eCjDQ (button) folded before Flop (didn't bet)
Seat 5: UBZQqpnJZdTYYY1FTb0rLA (small blind) folded before Flop
Seat 6: oxnw0GLLpFanjhGkxfRSqA (big blind) collected ($1)



PokerStars Game #59940464254:  Hold'em No Limit ($0.50/$1.00) - 2009/07/01 1:07:22 ET
Table 'VOs36P6NW+QyXeQ1B62kmA' 6-max Seat #6 is the button
Seat 1: Z2fXsGcjl+Eax+RzOgwOmg ($100 in chips)
Seat 2: 2UMlbaZ8n8AbRli0Yr0mDw ($43.10 in chips)
Seat 4: w02zQzNydODiyV9THKgo9w ($40.70 in chips)
Seat 5: ozrlafxxh1HmYdA0/h+MuA ($46.40 in chips)
Seat 6: slVKuQyEz8Qj4E3uLPYNXg ($98.50 in chips)
Z2fXsGcjl+Eax+RzOgwOmg: posts small blind $0.50
2UMlbaZ8n8AbRli0Yr0mDw: posts big blind $1
*** HOLE CARDS ***
w02zQzNydODiyV9THKgo9w: calls $1
ozrlafxxh1HmYdA0/h+MuA: calls $1
slVKuQyEz8Qj4E3uLPYNXg: folds
Z2fXsGcjl+Eax+RzOgwOmg: folds
2UMlbaZ8n8AbRli0Yr0mDw: checks
*** FLOP *** [7d Js 2s]
2UMlbaZ8n8AbRli0Yr0mDw: checks
w02zQzNydODiyV9THKgo9w: checks
ozrlafxxh1HmYdA0/h+MuA: checks
*** TURN *** [7d Js 2s] [Jc]
2UMlbaZ8n8AbRli0Yr0mDw: checks
w02zQzNydODiyV9THKgo9w: bets $3
ozrlafxxh1HmYdA0/h+MuA: folds
2UMlbaZ8n8AbRli0Yr0mDw: folds
w02zQzNydODiyV9THKgo9w collected $3.35 from pot
w02zQzNydODiyV9THKgo9w: doesn't show hand
*** SUMMARY ***
Total pot $3.50 | Rake $0.15
Board [7d Js 2s Jc]
Seat 1: Z2fXsGcjl+Eax+RzOgwOmg (small blind) folded before Flop
Seat 2: 2UMlbaZ8n8AbRli0Yr0mDw (big blind) folded on the Turn
Seat 4: w02zQzNydODiyV9THKgo9w collected ($3.35)
Seat 5: ozrlafxxh1HmYdA0/h+MuA folded on the Turn
Seat 6: slVKuQyEz8Qj4E3uLPYNXg (button) folded before Flop (didn't bet)



PokerStars Game #59940465370:  Hold'em No Limit ($0.50/$1.00) - 2009/07/01 1:07:24 ET
Table 'cKH9c4x6u79IqCdaKKvXrw' 9-max Seat #3 is the button
Seat 1: Pp/KTcXkfZKKUHkjyaLTdg ($18.50 in chips)
Seat 2: 8S3JMH4TY3whgIlZmMv66w ($76.55 in chips)
Seat 3: 997ViqAtWn1FPjJqcffwcA ($155.60 in chips)
Seat 4: FL3MrLspcF23LYvC4ipBOA ($100 in chips)
Seat 5: Jjc7EHWzs4//xUAjJ0UWoA ($42.05 in chips)
Seat 6: Bsd/K5gAcLanYbGiPirRjw ($202.55 in chips)
Seat 7: 1GkkVBhlJ92guE6K5mS5Ig ($16.75 in chips)
Seat 8: myIxN7otsyr846M539YR8Q ($17 in chips)
Seat 9: 6XkTu4ahxzHnvjjc1R8YjQ ($41.60 in chips)
FL3MrLspcF23LYvC4ipBOA: posts small blind $0.50
Jjc7EHWzs4//xUAjJ0UWoA: posts big blind $1
*** HOLE CARDS ***
Bsd/K5gAcLanYbGiPirRjw: folds
1GkkVBhlJ92guE6K5mS5Ig: calls $1
myIxN7otsyr846M539YR8Q: folds
6XkTu4ahxzHnvjjc1R8YjQ: folds
Pp/KTcXkfZKKUHkjyaLTdg: folds
8S3JMH4TY3whgIlZmMv66w: calls $1
997ViqAtWn1FPjJqcffwcA: folds
FL3MrLspcF23LYvC4ipBOA: folds
Jjc7EHWzs4//xUAjJ0UWoA: checks
*** FLOP *** [Qs Kc 5h]
Jjc7EHWzs4//xUAjJ0UWoA: checks
1GkkVBhlJ92guE6K5mS5Ig: bets $3
8S3JMH4TY3whgIlZmMv66w: folds
Jjc7EHWzs4//xUAjJ0UWoA: folds
1GkkVBhlJ92guE6K5mS5Ig collected $3.35 from pot
*** SUMMARY ***
Total pot $3.50 | Rake $0.15
Board [Qs Kc 5h]
Seat 1: Pp/KTcXkfZKKUHkjyaLTdg folded before Flop (didn't bet)
Seat 2: 8S3JMH4TY3whgIlZmMv66w folded on the Flop
Seat 3: 997ViqAtWn1FPjJqcffwcA (button) folded before Flop (didn't bet)
Seat 4: FL3MrLspcF23LYvC4ipBOA (small blind) folded before Flop
Seat 5: Jjc7EHWzs4//xUAjJ0UWoA (big blind) folded on the Flop
Seat 6: Bsd/K5gAcLanYbGiPirRjw folded before Flop (didn't bet)
Seat 7: 1GkkVBhlJ92guE6K5mS5Ig collected ($3.35)
Seat 8: myIxN7otsyr846M539YR8Q folded before Flop (didn't bet)
Seat 9: 6XkTu4ahxzHnvjjc1R8YjQ folded before Flop (didn't bet)



PokerStars Game #59940465794:  Hold'em No Limit ($0.50/$1.00) - 2009/07/01 1:07:25 ET
Table 'cBDNutyLBKEk9+ptwsKmTw' 6-max Seat #6 is the button
Seat 1: xAU6q2/cwmby2sxmA8VcmA ($120.50 in chips)
Seat 2: 5lY8d6Cnm4HUkt/8FZSj4g ($33.50 in chips)
Seat 3: G5ZSSN6RSON3gkNvk/SmYg ($100.15 in chips)
Seat 4: 3q7F5QtzC30pSrn0nl9i+A ($19.80 in chips)
Seat 5: OGMLOcTNYZXZU81au7ztUw ($165.40 in chips)
Seat 6: NqVlOSH2lp+pp/TK3vvK5g ($87.15 in chips)
xAU6q2/cwmby2sxmA8VcmA: posts small blind $0.50
5lY8d6Cnm4HUkt/8FZSj4g: posts big blind $1
*** HOLE CARDS ***
G5ZSSN6RSON3gkNvk/SmYg: raises $3 to $4
3q7F5QtzC30pSrn0nl9i+A: folds
OGMLOcTNYZXZU81au7ztUw: folds
NqVlOSH2lp+pp/TK3vvK5g: folds
xAU6q2/cwmby2sxmA8VcmA: folds
5lY8d6Cnm4HUkt/8FZSj4g: raises $29.50 to $33.50 and is all-in
G5ZSSN6RSON3gkNvk/SmYg: folds
5lY8d6Cnm4HUkt/8FZSj4g collected $8.50 from pot
5lY8d6Cnm4HUkt/8FZSj4g: shows [4s Js] (high card Jack)
*** SUMMARY ***
Total pot $8.50 | Rake $0
Seat 1: xAU6q2/cwmby2sxmA8VcmA (small blind) folded before Flop
Seat 2: 5lY8d6Cnm4HUkt/8FZSj4g (big blind) collected ($8.50)
Seat 3: G5ZSSN6RSON3gkNvk/SmYg folded before Flop
Seat 4: 3q7F5QtzC30pSrn0nl9i+A folded before Flop (didn't bet)
Seat 5: OGMLOcTNYZXZU81au7ztUw folded before Flop (didn't bet)
Seat 6: NqVlOSH2lp+pp/TK3vvK5g (button) folded before Flop (didn't bet)



PokerStars Game #59940466598:  Hold'em No Limit ($0.50/$1.00) - 2009/07/01 1:07:26 ET
Table 'W/wyObTiXZm+Ckkl3YxcSw' 6-max Seat #2 is the button
Seat 1: eUBBn2R56C1IQ6Cs/vitwg ($183.75 in chips)
Seat 2: oDiBRCaF0QVtd3kO6xZIXw ($132.35 in chips)
Seat 3: dxyNCn/qxfkGDUIf28Cbng ($80.40 in chips)
Seat 4: aYii2DmxlOlbC1wbGRBWvQ ($101.70 in chips)
Seat 5: MFptnnT6AnJakWBooTkmeg ($25.65 in chips)
Seat 6: OGMLOcTNYZXZU81au7ztUw ($100 in chips)
dxyNCn/qxfkGDUIf28Cbng: posts small blind $0.50
aYii2DmxlOlbC1wbGRBWvQ: posts big blind $1
*** HOLE CARDS ***
MFptnnT6AnJakWBooTkmeg: folds
OGMLOcTNYZXZU81au7ztUw: folds
eUBBn2R56C1IQ6Cs/vitwg: raises $2 to $3
oDiBRCaF0QVtd3kO6xZIXw: folds
dxyNCn/qxfkGDUIf28Cbng: calls $2.50
aYii2DmxlOlbC1wbGRBWvQ: calls $2
*** FLOP *** [2d 4h 5h]
dxyNCn/qxfkGDUIf28Cbng: checks
aYii2DmxlOlbC1wbGRBWvQ: bets $5
eUBBn2R56C1IQ6Cs/vitwg: folds
dxyNCn/qxfkGDUIf28Cbng: folds
aYii2DmxlOlbC1wbGRBWvQ collected $8.55 from pot
*** SUMMARY ***
Total pot $9 | Rake $0.45
Board [2d 4h 5h]
Seat 1: eUBBn2R56C1IQ6Cs/vitwg folded on the Flop
Seat 2: oDiBRCaF0QVtd3kO6xZIXw (button) folded before Flop (didn't bet)
Seat 3: dxyNCn/qxfkGDUIf28Cbng (small blind) folded on the Flop
Seat 4: aYii2DmxlOlbC1wbGRBWvQ (big blind) collected ($8.55)
Seat 5: MFptnnT6AnJakWBooTkmeg folded before Flop (didn't bet)
Seat 6: OGMLOcTNYZXZU81au7ztUw folded before Flop (didn't bet)



PokerStars Game #59940466520:  Hold'em No Limit ($0.50/$1.00) - 2009/07/01 1:07:26 ET
Table 'JTT1XWaDZHSaMZQK7cR5uw' 2-max Seat #2 is the button
Seat 1: OLplZF6FEnLflv81Hz+Fxg ($119.95 in chips)
Seat 2: BcqgegiOUxmBD3F3umsljg ($87.25 in chips)
BcqgegiOUxmBD3F3umsljg: posts small blind $0.50
OLplZF6FEnLflv81Hz+Fxg: posts big blind $1
*** HOLE CARDS ***
BcqgegiOUxmBD3F3umsljg: calls $0.50
OLplZF6FEnLflv81Hz+Fxg: checks
*** FLOP *** [Kh 5s 9h]
OLplZF6FEnLflv81Hz+Fxg: checks
BcqgegiOUxmBD3F3umsljg: checks
*** TURN *** [Kh 5s 9h] [Ac]
OLplZF6FEnLflv81Hz+Fxg: checks
BcqgegiOUxmBD3F3umsljg: bets $3
OLplZF6FEnLflv81Hz+Fxg: folds
BcqgegiOUxmBD3F3umsljg collected $1.90 from pot
*** SUMMARY ***
Total pot $2 | Rake $0.10
Board [Kh 5s 9h Ac]
Seat 1: OLplZF6FEnLflv81Hz+Fxg (big blind) folded on the Turn
Seat 2: BcqgegiOUxmBD3F3umsljg (button) (small blind) collected ($1.90)



PokerStars Game #59940467084:  Hold'em No Limit ($0.50/$1.00) - 2009/07/01 1:07:27 ET
Table 'eU3bWpDDg3Z+9R4m4iVmog' 6-max Seat #6 is the button
Seat 2: 8CAoOzhmB8n3nRFf3V4BTg ($89.05 in chips)
Seat 3: rVMOzU7w5FddYPGhD7qN2Q ($40.55 in chips)
Seat 4: GDVIsbEJ/DOJsMKE4Asz0A ($95.20 in chips)
Seat 6: hpxXcmRkXXI9HE5+5/j/0Q ($120 in chips)
8CAoOzhmB8n3nRFf3V4BTg: posts small blind $0.50
rVMOzU7w5FddYPGhD7qN2Q: posts big blind $1
*** HOLE CARDS ***
GDVIsbEJ/DOJsMKE4Asz0A said, "9s"
GDVIsbEJ/DOJsMKE4Asz0A: folds
hpxXcmRkXXI9HE5+5/j/0Q: folds
8CAoOzhmB8n3nRFf3V4BTg said, "KK"
8CAoOzhmB8n3nRFf3V4BTg: calls $0.50
rVMOzU7w5FddYPGhD7qN2Q: checks
*** FLOP *** [Qc Ks 4c]
8CAoOzhmB8n3nRFf3V4BTg: checks
rVMOzU7w5FddYPGhD7qN2Q: checks
*** TURN *** [Qc Ks 4c] [3d]
8CAoOzhmB8n3nRFf3V4BTg: bets $1
rVMOzU7w5FddYPGhD7qN2Q: folds
8CAoOzhmB8n3nRFf3V4BTg collected $1.90 from pot
*** SUMMARY ***
Total pot $2 | Rake $0.10
Board [Qc Ks 4c 3d]
Seat 2: 8CAoOzhmB8n3nRFf3V4BTg (small blind) collected ($1.90)
Seat 3: rVMOzU7w5FddYPGhD7qN2Q (big blind) folded on the Turn
Seat 4: GDVIsbEJ/DOJsMKE4Asz0A folded before Flop (didn't bet)
Seat 6: hpxXcmRkXXI9HE5+5/j/0Q (button) folded before Flop (didn't bet)



PokerStars Game #59940469364:  Hold'em No Limit ($0.50/$1.00) - 2009/07/01 1:07:31 ET
Table 'mmbQQVBTrPdE+wy+s+9VPA' 6-max Seat #1 is the button
Seat 1: zyP4SPoWZnKUfTvIRLCVog ($74.05 in chips)
Seat 3: wx3sQGkVi2x9wJXuWNHPBw ($111.65 in chips)
Seat 4: V3iZdcw61nXF3g5hD2RrsQ ($120.70 in chips)
Seat 5: YMJG+F++3Aj6P8dAWda5fw ($100 in chips)
Seat 6: U2CWBTv29qdCbj8RNF2sIw ($100 in chips)
wx3sQGkVi2x9wJXuWNHPBw: posts small blind $0.50
V3iZdcw61nXF3g5hD2RrsQ: posts big blind $1
*** HOLE CARDS ***
YMJG+F++3Aj6P8dAWda5fw: folds
U2CWBTv29qdCbj8RNF2sIw: folds
cl/QpVR/PLO58lj+C5mGLw leaves the table
zyP4SPoWZnKUfTvIRLCVog: raises $3 to $4
wx3sQGkVi2x9wJXuWNHPBw: folds
V3iZdcw61nXF3g5hD2RrsQ: folds
zyP4SPoWZnKUfTvIRLCVog collected $2.50 from pot
*** SUMMARY ***
Total pot $2.50 | Rake $0
Seat 1: zyP4SPoWZnKUfTvIRLCVog (button) collected ($2.50)
Seat 3: wx3sQGkVi2x9wJXuWNHPBw (small blind) folded before Flop
Seat 4: V3iZdcw61nXF3g5hD2RrsQ (big blind) folded before Flop
Seat 5: YMJG+F++3Aj6P8dAWda5fw folded before Flop (didn't bet)
Seat 6: U2CWBTv29qdCbj8RNF2sIw folded before Flop (didn't bet)



PokerStars Game #59940469158:  Hold'em No Limit ($0.50/$1.00) - 2009/07/01 1:07:31 ET
Table 'tyUh+jyNvrceIQdKMJjQ2wZFWj23PMihdwrNWv41OG/Qeat #2 is the button
Seat 1: o8A5MUdudVKu+pAwgZOX2w ($113.90 in chips)
Seat 2: 5uy3EN+iIYkgwbWZFTUBAQ ($100 in chips)
Seat 3: TalCiLYHCd+ffkmR3auPvA ($71.60 in chips)
Seat 5: j7NIOHLZk7V2o9fOioO5ug ($128.40 in chips)
Seat 6: 4OO5v3AVduL0tePNx8wk5A ($100 in chips)
TalCiLYHCd+ffkmR3auPvA: posts small blind $0.50
j7NIOHLZk7V2o9fOioO5ug: posts big blind $1
*** HOLE CARDS ***
4OO5v3AVduL0tePNx8wk5A: folds
o8A5MUdudVKu+pAwgZOX2w: folds
5uy3EN+iIYkgwbWZFTUBAQ: folds
TalCiLYHCd+ffkmR3auPvA: raises $3 to $4
j7NIOHLZk7V2o9fOioO5ug: folds
TalCiLYHCd+ffkmR3auPvA collected $2 from pot
TalCiLYHCd+ffkmR3auPvA: doesn't show hand
*** SUMMARY ***
Total pot $2 | Rake $0
Seat 1: o8A5MUdudVKu+pAwgZOX2w folded before Flop (didn't bet)
Seat 2: 5uy3EN+iIYkgwbWZFTUBAQ (button) folded before Flop (didn't bet)
Seat 3: TalCiLYHCd+ffkmR3auPvA (small blind) collected ($2)
Seat 5: j7NIOHLZk7V2o9fOioO5ug (big blind) folded before Flop
Seat 6: 4OO5v3AVduL0tePNx8wk5A folded before Flop (didn't bet)



PokerStars Game #59940469924:  Hold'em No Limit ($0.50/$1.00) - 2009/07/01 1:07:32 ET
Table '+cA8mcmhaedZ7YcrDdhmeQ' 6-max Seat #5 is the button
Seat 1: lsLuWlcPA3Rh7kJVLzMh0Q ($300.95 in chips)
Seat 2: RqgF7gRoKgRNW8Zoi1ty4A ($140.75 in chips)
Seat 4: 4OO5v3AVduL0tePNx8wk5A ($100 in chips)
Seat 5: +7hFKAL0b0O/n8G72TclJA ($136.20 in chips)
Seat 6: YfsTQsY/fxb+YqbdclTHuw ($17.60 in chips)
YfsTQsY/fxb+YqbdclTHuw: posts small blind $0.50
lsLuWlcPA3Rh7kJVLzMh0Q: posts big blind $1
*** HOLE CARDS ***
RqgF7gRoKgRNW8Zoi1ty4A: raises $3 to $4
DAIgyIWbYvAkL6PbAI27pg joins the table at seat #3
4OO5v3AVduL0tePNx8wk5A: calls $4
+7hFKAL0b0O/n8G72TclJA: folds
YfsTQsY/fxb+YqbdclTHuw: folds
lsLuWlcPA3Rh7kJVLzMh0Q: folds
*** FLOP *** [5s 6c 6h]
RqgF7gRoKgRNW8Zoi1ty4A: bets $5
4OO5v3AVduL0tePNx8wk5A: raises $12.50 to $17.50
RqgF7gRoKgRNW8Zoi1ty4A: folds
4OO5v3AVduL0tePNx8wk5A collected $18.55 from pot
*** SUMMARY ***
Total pot $19.50 | Rake $0.95
Board [5s 6c 6h]
Seat 1: lsLuWlcPA3Rh7kJVLzMh0Q (big blind) folded before Flop
Seat 2: RqgF7gRoKgRNW8Zoi1ty4A folded on the Flop
Seat 4: 4OO5v3AVduL0tePNx8wk5A collected ($18.55)
Seat 5: +7hFKAL0b0O/n8G72TclJA (button) folded before Flop (didn't bet)
Seat 6: YfsTQsY/fxb+YqbdclTHuw (small blind) folded before Flop



PokerStars Game #59940472866:  Hold'em No Limit ($0.50/$1.00) - 2009/07/01 1:07:37 ET
Table 'kS0cTQAEi+fdUlJP2gQYvw' 9-max Seat #6 is the button
Seat 1: c/9X4zftzphFxYtxp5kp9w ($64.35 in chips)
Seat 2: D+W9Me7w6Hcx/WRUSKV0dw ($22.40 in chips)
Seat 3: 2BV+oJIQYr65IO6nEChvbA ($60 in chips)
Seat 5: 997ViqAtWn1FPjJqcffwcA ($102.65 in chips)
Seat 6: yAbu2QsRPVcjPbqlf/jDxw ($125.15 in chips)
Seat 7: Ffa7Nj4X5fddtROP01hfQg ($129.35 in chips)
Seat 8: QYMfy2FoN6/Qe1LWYuI7fw ($26.45 in chips)
Seat 9: OGgaARGdJQT4awWVNQ957w ($102 in chips)
Ffa7Nj4X5fddtROP01hfQg: posts small blind $0.50
QYMfy2FoN6/Qe1LWYuI7fw: posts big blind $1
*** HOLE CARDS ***
OGgaARGdJQT4awWVNQ957w: folds
c/9X4zftzphFxYtxp5kp9w: folds
D+W9Me7w6Hcx/WRUSKV0dw: folds
2BV+oJIQYr65IO6nEChvbA: folds
997ViqAtWn1FPjJqcffwcA: folds
yAbu2QsRPVcjPbqlf/jDxw: folds
Ffa7Nj4X5fddtROP01hfQg: calls $0.50
QYMfy2FoN6/Qe1LWYuI7fw: raises $2 to $3
Ffa7Nj4X5fddtROP01hfQg: calls $2
*** FLOP *** [6d 4d Th]
Ffa7Nj4X5fddtROP01hfQg: bets $4
QYMfy2FoN6/Qe1LWYuI7fw: raises $8 to $12
Ffa7Nj4X5fddtROP01hfQg: calls $8
*** TURN *** [6d 4d Th] [9c]
Ffa7Nj4X5fddtROP01hfQg: bets $3
QYMfy2FoN6/Qe1LWYuI7fw: calls $3
*** RIVER *** [6d 4d Th 9c] [7s]
Ffa7Nj4X5fddtROP01hfQg: bets $2
QYMfy2FoN6/Qe1LWYuI7fw: raises $6.45 to $8.45 and is all-in
Ffa7Nj4X5fddtROP01hfQg: calls $6.45
*** SHOW DOWN ***
QYMfy2FoN6/Qe1LWYuI7fw: shows [Ad 2d] (high card Ace)
Ffa7Nj4X5fddtROP01hfQg: shows [Ts Jh] (a pair of Tens)
Ffa7Nj4X5fddtROP01hfQg collected $50.35 from pot
*** SUMMARY ***
Total pot $52.90 | Rake $2.55
Board [6d 4d Th 9c 7s]
Seat 1: c/9X4zftzphFxYtxp5kp9w folded before Flop (didn't bet)
Seat 2: D+W9Me7w6Hcx/WRUSKV0dw folded before Flop (didn't bet)
Seat 3: 2BV+oJIQYr65IO6nEChvbA folded before Flop (didn't bet)
Seat 5: 997ViqAtWn1FPjJqcffwcA folded before Flop (didn't bet)
Seat 6: yAbu2QsRPVcjPbqlf/jDxw (button) folded before Flop (didn't bet)
Seat 7: Ffa7Nj4X5fddtROP01hfQg (small blind) showed [Ts Jh] and won ($50.35) with a pair of Tens
Seat 8: QYMfy2FoN6/Qe1LWYuI7fw (big blind) showed [Ad 2d] and lost with high card Ace
Seat 9: OGgaARGdJQT4awWVNQ957w folded before Flop (didn't bet)



PokerStars Game #59940474012:  Hold'em No Limit ($0.50/$1.00) - 2009/07/01 1:07:39 ET
Table '7O9fB8yx1u7sJveJn8w6jA' 6-max Seat #5 is the button
Seat 1: jy52+7FotjH63o5tEEVgKw ($99.85 in chips)
Seat 2: wx3sQGkVi2x9wJXuWNHPBw ($187.95 in chips)
Seat 3: hpxXcmRkXXI9HE5+5/j/0Q ($104.20 in chips)
Seat 4: XIZSmlGttGgSRaIU42K4Fg ($149.40 in chips)
Seat 5: BCEV3COoKY607AzLWayfRA ($107.80 in chips)
jy52+7FotjH63o5tEEVgKw: posts small blind $0.50
wx3sQGkVi2x9wJXuWNHPBw: posts big blind $1
*** HOLE CARDS ***
hpxXcmRkXXI9HE5+5/j/0Q: folds
XIZSmlGttGgSRaIU42K4Fg: folds
XIZSmlGttGgSRaIU42K4Fg leaves the table
BCEV3COoKY607AzLWayfRA: raises $2 to $3
jy52+7FotjH63o5tEEVgKw: calls $2.50
wx3sQGkVi2x9wJXuWNHPBw: folds
*** FLOP *** [7s Qs Ts]
jy52+7FotjH63o5tEEVgKw: checks
BCEV3COoKY607AzLWayfRA: checks
*** TURN *** [7s Qs Ts] [2d]
jy52+7FotjH63o5tEEVgKw: checks
BCEV3COoKY607AzLWayfRA: bets $5
jy52+7FotjH63o5tEEVgKw: calls $5
*** RIVER *** [7s Qs Ts 2d] [5h]
jy52+7FotjH63o5tEEVgKw: checks
BCEV3COoKY607AzLWayfRA: bets $14
jy52+7FotjH63o5tEEVgKw: folds
BCEV3COoKY607AzLWayfRA collected $16.20 from pot
BCEV3COoKY607AzLWayfRA: doesn't show hand
*** SUMMARY ***
Total pot $17 | Rake $0.80
Board [7s Qs Ts 2d 5h]
Seat 1: jy52+7FotjH63o5tEEVgKw (small blind) folded on the River
Seat 2: wx3sQGkVi2x9wJXuWNHPBw (big blind) folded before Flop
Seat 3: hpxXcmRkXXI9HE5+5/j/0Q folded before Flop (didn't bet)
Seat 4: XIZSmlGttGgSRaIU42K4Fg folded before Flop (didn't bet)
Seat 5: BCEV3COoKY607AzLWayfRA (button) collected ($16.20)



PokerStars Game #59940474438:  Hold'em No Limit ($0.50/$1.00) - 2009/07/01 1:07:40 ET
Table 'vs/5jr6ciwjVQ5+Soc+u2A' 6-max Seat #5 is the button
Seat 1: /P4w1pHg2zHYg/4ubJ0dPw ($61.80 in chips)
Seat 2: lXX4W7m3u++JiSOZ46yVMQ ($107 in chips)
Seat 3: G5ZSSN6RSON3gkNvk/SmYg ($155.35 in chips)
Seat 4: wk6Ohn4GDozoOMHc4eb2rw ($79.15 in chips)
Seat 5: +Nt3OPk3XR9SKjZgm2CexQ ($105.95 in chips)
Seat 6: Z2fXsGcjl+Eax+RzOgwOmg ($100 in chips)
Z2fXsGcjl+Eax+RzOgwOmg: posts small blind $0.50
/P4w1pHg2zHYg/4ubJ0dPw: posts big blind $1
*** HOLE CARDS ***
lXX4W7m3u++JiSOZ46yVMQ: folds
G5ZSSN6RSON3gkNvk/SmYg: folds
wk6Ohn4GDozoOMHc4eb2rw: folds
+Nt3OPk3XR9SKjZgm2CexQ: raises $1.30 to $2.30
Z2fXsGcjl+Eax+RzOgwOmg: folds
/P4w1pHg2zHYg/4ubJ0dPw: folds
+Nt3OPk3XR9SKjZgm2CexQ collected $2.50 from pot
+Nt3OPk3XR9SKjZgm2CexQ: doesn't show hand
*** SUMMARY ***
Total pot $2.50 | Rake $0
Seat 1: /P4w1pHg2zHYg/4ubJ0dPw (big blind) folded before Flop
Seat 2: lXX4W7m3u++JiSOZ46yVMQ folded before Flop (didn't bet)
Seat 3: G5ZSSN6RSON3gkNvk/SmYg folded before Flop (didn't bet)
Seat 4: wk6Ohn4GDozoOMHc4eb2rw folded before Flop (didn't bet)
Seat 5: +Nt3OPk3XR9SKjZgm2CexQ (button) collected ($2.50)
Seat 6: Z2fXsGcjl+Eax+RzOgwOmg (small blind) folded before Flop



PokerStars Game #59940474940:  Hold'em No Limit ($0.50/$1.00) - 2009/07/01 1:07:41 ET
Table 'MUPc8FEpe/nR0BKSeReX6Q' 6-max Seat #5 is the button
Seat 1: qhkK6+yCciTRd+rCFEbnEQ ($41.70 in chips)
Seat 2: xAU6q2/cwmby2sxmA8VcmA ($116.20 in chips)
Seat 3: wx3sQGkVi2x9wJXuWNHPBw ($235.95 in chips)
Seat 4: ZA1bp6g8IwtTxkUE4eCjDQ ($195.15 in chips)
Seat 5: UBZQqpnJZdTYYY1FTb0rLA ($100 in chips)
Seat 6: oxnw0GLLpFanjhGkxfRSqA ($29.65 in chips)
oxnw0GLLpFanjhGkxfRSqA: posts small blind $0.50
qhkK6+yCciTRd+rCFEbnEQ: posts big blind $1
*** HOLE CARDS ***
xAU6q2/cwmby2sxmA8VcmA: folds
wx3sQGkVi2x9wJXuWNHPBw: folds
ZA1bp6g8IwtTxkUE4eCjDQ: folds
UBZQqpnJZdTYYY1FTb0rLA: folds
oxnw0GLLpFanjhGkxfRSqA: calls $0.50
qhkK6+yCciTRd+rCFEbnEQ: raises $3 to $4
oxnw0GLLpFanjhGkxfRSqA: folds
qhkK6+yCciTRd+rCFEbnEQ collected $2 from pot
qhkK6+yCciTRd+rCFEbnEQ: doesn't show hand
*** SUMMARY ***
Total pot $2 | Rake $0
Seat 1: qhkK6+yCciTRd+rCFEbnEQ (big blind) collected ($2)
Seat 2: xAU6q2/cwmby2sxmA8VcmA folded before Flop (didn't bet)
Seat 3: wx3sQGkVi2x9wJXuWNHPBw folded before Flop (didn't bet)
Seat 4: ZA1bp6g8IwtTxkUE4eCjDQ folded before Flop (didn't bet)
Seat 5: UBZQqpnJZdTYYY1FTb0rLA (button) folded before Flop (didn't bet)
Seat 6: oxnw0GLLpFanjhGkxfRSqA (small blind) folded before Flop



PokerStars Game #59940475688:  Hold'em No Limit ($0.50/$1.00) - 2009/07/01 1:07:42 ET
Table 'fTlPiCj0utgzC/5io+I7ew' 6-max Seat #1 is the button
Seat 1: YMJG+F++3Aj6P8dAWda5fw ($102.85 in chips)
Seat 2: Qy/UBNbD2HaA0Ogxg8Sf3w ($121.35 in chips)
Seat 3: Z2fXsGcjl+Eax+RzOgwOmg ($100 in chips)
Seat 4: uJVSceLggtsrJya+WtmUEA ($187.15 in chips)
Seat 5: GC5g2ryXV7e4TTqmaxUofw ($52.70 in chips)
Seat 6: /P4w1pHg2zHYg/4ubJ0dPw ($67.55 in chips)
Qy/UBNbD2HaA0Ogxg8Sf3w: posts small blind $0.50
Z2fXsGcjl+Eax+RzOgwOmg: posts big blind $1
*** HOLE CARDS ***
uJVSceLggtsrJya+WtmUEA: folds
GC5g2ryXV7e4TTqmaxUofw: raises $1 to $2
/P4w1pHg2zHYg/4ubJ0dPw: folds
YMJG+F++3Aj6P8dAWda5fw: folds
Qy/UBNbD2HaA0Ogxg8Sf3w: raises $5 to $7
Z2fXsGcjl+Eax+RzOgwOmg: folds
GC5g2ryXV7e4TTqmaxUofw: calls $5
*** FLOP *** [Jc 9c Jd]
Qy/UBNbD2HaA0Ogxg8Sf3w: bets $14
GC5g2ryXV7e4TTqmaxUofw: folds
GC5g2ryXV7e4TTqmaxUofw leaves the table
Qy/UBNbD2HaA0Ogxg8Sf3w collected $14.25 from pot
*** SUMMARY ***
Total pot $15 | Rake $0.75
Board [Jc 9c Jd]
Seat 1: YMJG+F++3Aj6P8dAWda5fw (button) folded before Flop (didn't bet)
Seat 2: Qy/UBNbD2HaA0Ogxg8Sf3w (small blind) collected ($14.25)
Seat 3: Z2fXsGcjl+Eax+RzOgwOmg (big blind) folded before Flop
Seat 4: uJVSceLggtsrJya+WtmUEA folded before Flop (didn't bet)
Seat 5: GC5g2ryXV7e4TTqmaxUofw folded on the Flop
Seat 6: /P4w1pHg2zHYg/4ubJ0dPw folded before Flop (didn't bet)



PokerStars Game #59940477350:  Hold'em No Limit ($0.50/$1.00) - 2009/07/01 1:07:45 ET
Table 'hugOjcwJvzEwZbK7tyiWuQ' 9-max Seat #6 is the button
Seat 2: r27C1nIV4NS4+qbnrgBQSw ($283.20 in chips)
Seat 3: jDwhY1kCdc6EkAHbT7PJMQ ($104.75 in chips)
Seat 4: UWB3oeddt/GObx2Mix2Anw ($178 in chips)
Seat 5: 5BRGWf+R3nt2WS3b5xX+zA ($16.75 in chips)
Seat 6: gUUvmqdVlmvpal6B8nYrmg ($105.90 in chips)
Seat 7: FL3MrLspcF23LYvC4ipBOA ($107.30 in chips)
Seat 8: /zy+DB4S5fUQUSfZWFzYGw ($100 in chips)
Seat 9: W8P9bUKCs43TO1xHm0dL6w ($89.45 in chips)
FL3MrLspcF23LYvC4ipBOA: posts small blind $0.50
/zy+DB4S5fUQUSfZWFzYGw: posts big blind $1
*** HOLE CARDS ***
W8P9bUKCs43TO1xHm0dL6w: raises $1 to $2
r27C1nIV4NS4+qbnrgBQSw: folds
jDwhY1kCdc6EkAHbT7PJMQ: folds
UWB3oeddt/GObx2Mix2Anw: folds
5BRGWf+R3nt2WS3b5xX+zA: folds
gUUvmqdVlmvpal6B8nYrmg: folds
FL3MrLspcF23LYvC4ipBOA: folds
/zy+DB4S5fUQUSfZWFzYGw: folds
W8P9bUKCs43TO1xHm0dL6w collected $2.50 from pot
*** SUMMARY ***
Total pot $2.50 | Rake $0
Seat 2: r27C1nIV4NS4+qbnrgBQSw folded before Flop (didn't bet)
Seat 3: jDwhY1kCdc6EkAHbT7PJMQ folded before Flop (didn't bet)
Seat 4: UWB3oeddt/GObx2Mix2Anw folded before Flop (didn't bet)
Seat 5: 5BRGWf+R3nt2WS3b5xX+zA folded before Flop (didn't bet)
Seat 6: gUUvmqdVlmvpal6B8nYrmg (button) folded before Flop (didn't bet)
Seat 7: FL3MrLspcF23LYvC4ipBOA (small blind) folded before Flop
Seat 8: /zy+DB4S5fUQUSfZWFzYGw (big blind) folded before Flop
Seat 9: W8P9bUKCs43TO1xHm0dL6w collected ($2.50)



PokerStars Game #59940477660:  Hold'em No Limit ($0.50/$1.00) - 2009/07/01 1:07:45 ET
Table 'GPp0HyAuggN8oE0sUWzPpA' 9-max Seat #4 is the button
Seat 1: qJr25HAtvv1w/7IBvjMM3g ($42.70 in chips)
Seat 2: m3U8I35Pn3gxKhoS2nmYIg ($38.05 in chips)
Seat 3: CCCXsirC+bO7ginAuUUVlQ ($47 in chips)
Seat 4: mBRWbnUl8diyBO1qTJaNzw ($108.65 in chips)
Seat 6: BK/GtNPkSx0TdUDj82id5A ($16.85 in chips)
Seat 7: DHdbHyysD15wCAtx+BhUjA ($95 in chips)
Seat 8: 6DBvLniKMJADk/t5l29oMA ($25.15 in chips)
Seat 9: dzoSjPZmtjGuK83119030A ($34.15 in chips)
bLbSOSmSOnqE0iTcH/5dxA will be allowed to play after the button
BK/GtNPkSx0TdUDj82id5A: posts small blind $0.50
DHdbHyysD15wCAtx+BhUjA: posts big blind $1
*** HOLE CARDS ***
6DBvLniKMJADk/t5l29oMA: folds
dzoSjPZmtjGuK83119030A: folds
qJr25HAtvv1w/7IBvjMM3g: folds
m3U8I35Pn3gxKhoS2nmYIg: folds
CCCXsirC+bO7ginAuUUVlQ: calls $1
mBRWbnUl8diyBO1qTJaNzw: calls $1
BK/GtNPkSx0TdUDj82id5A: folds
DHdbHyysD15wCAtx+BhUjA: checks
*** FLOP *** [Jc 7c Qc]
DHdbHyysD15wCAtx+BhUjA: checks
CCCXsirC+bO7ginAuUUVlQ: bets $3
mBRWbnUl8diyBO1qTJaNzw: folds
DHdbHyysD15wCAtx+BhUjA: folds
CCCXsirC+bO7ginAuUUVlQ collected $3.35 from pot
*** SUMMARY ***
Total pot $3.50 | Rake $0.15
Board [Jc 7c Qc]
Seat 1: qJr25HAtvv1w/7IBvjMM3g folded before Flop (didn't bet)
Seat 2: m3U8I35Pn3gxKhoS2nmYIg folded before Flop (didn't bet)
Seat 3: CCCXsirC+bO7ginAuUUVlQ collected ($3.35)
Seat 4: mBRWbnUl8diyBO1qTJaNzw (button) folded on the Flop
Seat 6: BK/GtNPkSx0TdUDj82id5A (small blind) folded before Flop
Seat 7: DHdbHyysD15wCAtx+BhUjA (big blind) folded on the Flop
Seat 8: 6DBvLniKMJADk/t5l29oMA folded before Flop (didn't bet)
Seat 9: dzoSjPZmtjGuK83119030A folded before Flop (didn't bet)



PokerStars Game #59940478150:  Hold'em No Limit ($0.50/$1.00) - 2009/07/01 1:07:46 ET
Table 'JTT1XWaDZHSaMZQK7cR5uw' 2-max Seat #1 is the button
Seat 1: OLplZF6FEnLflv81Hz+Fxg ($118.95 in chips)
Seat 2: BcqgegiOUxmBD3F3umsljg ($88.15 in chips)
OLplZF6FEnLflv81Hz+Fxg: posts small blind $0.50
BcqgegiOUxmBD3F3umsljg: posts big blind $1
*** HOLE CARDS ***
OLplZF6FEnLflv81Hz+Fxg: raises $2 to $3
BcqgegiOUxmBD3F3umsljg: calls $2
*** FLOP *** [6s 2s Kh]
BcqgegiOUxmBD3F3umsljg: bets $3
OLplZF6FEnLflv81Hz+Fxg: raises $5 to $8
BcqgegiOUxmBD3F3umsljg: folds
OLplZF6FEnLflv81Hz+Fxg collected $11.50 from pot
*** SUMMARY ***
Total pot $12 | Rake $0.50
Board [6s 2s Kh]
Seat 1: OLplZF6FEnLflv81Hz+Fxg (button) (small blind) collected ($11.50)
Seat 2: BcqgegiOUxmBD3F3umsljg (big blind) folded on the Flop



PokerStars Game #59940479392:  Hold'em No Limit ($0.50/$1.00) - 2009/07/01 1:07:48 ET
Table 'eU3bWpDDg3Z+9R4m4iVmog' 6-max Seat #2 is the button
Seat 2: 8CAoOzhmB8n3nRFf3V4BTg ($89.95 in chips)
Seat 3: rVMOzU7w5FddYPGhD7qN2Q ($39.55 in chips)
Seat 4: GDVIsbEJ/DOJsMKE4Asz0A ($95.20 in chips)
Seat 6: hpxXcmRkXXI9HE5+5/j/0Q ($120 in chips)
rVMOzU7w5FddYPGhD7qN2Q: posts small blind $0.50
GDVIsbEJ/DOJsMKE4Asz0A: posts big blind $1
*** HOLE CARDS ***
8CAoOzhmB8n3nRFf3V4BTg said, "i was scared of flush draw.."
hpxXcmRkXXI9HE5+5/j/0Q: folds
8CAoOzhmB8n3nRFf3V4BTg said, "bad bet"
8CAoOzhmB8n3nRFf3V4BTg: folds
rVMOzU7w5FddYPGhD7qN2Q: calls $0.50
GDVIsbEJ/DOJsMKE4Asz0A: checks
*** FLOP *** [Qs 7c 6d]
rVMOzU7w5FddYPGhD7qN2Q: bets $1
GDVIsbEJ/DOJsMKE4Asz0A: calls $1
*** TURN *** [Qs 7c 6d] [6h]
rVMOzU7w5FddYPGhD7qN2Q: bets $2
GDVIsbEJ/DOJsMKE4Asz0A: calls $2
*** RIVER *** [Qs 7c 6d 6h] [2d]
rVMOzU7w5FddYPGhD7qN2Q: bets $5
GDVIsbEJ/DOJsMKE4Asz0A: calls $5
*** SHOW DOWN ***
rVMOzU7w5FddYPGhD7qN2Q: shows [3h Qh] (two pair, Queens and Sixes)
GDVIsbEJ/DOJsMKE4Asz0A: shows [Qc 5c] (two pair, Queens and Sixes)
rVMOzU7w5FddYPGhD7qN2Q collected $8.60 from pot
GDVIsbEJ/DOJsMKE4Asz0A collected $8.55 from pot
*** SUMMARY ***
Total pot $18 | Rake $0.85
Board [Qs 7c 6d 6h 2d]
Seat 2: 8CAoOzhmB8n3nRFf3V4BTg (button) folded before Flop (didn't bet)
Seat 3: rVMOzU7w5FddYPGhD7qN2Q (small blind) showed [3h Qh] and won ($8.60) with two pair, Queens and Sixes
Seat 4: GDVIsbEJ/DOJsMKE4Asz0A (big blind) showed [Qc 5c] and won ($8.55) with two pair, Queens and Sixes
Seat 6: hpxXcmRkXXI9HE5+5/j/0Q folded before Flop (didn't bet)



PokerStars Game #59940481846:  Hold'em No Limit ($0.50/$1.00) - 2009/07/01 1:07:53 ET
Table 'N2bNCDHL96aCQDvZIh+yQQ' 6-max Seat #2 is the button
Seat 2: TIB5eSBJLz62w6yz2+yeKw ($89 in chips)
Seat 3: Qy/UBNbD2HaA0Ogxg8Sf3w ($237.50 in chips)
Seat 4: uCqEjnxh2/vFBjKYkfTOkw ($196.55 in chips)
Seat 5: 8OEJHwpMpZZfyaTpXEDFfw ($27.15 in chips)
Qy/UBNbD2HaA0Ogxg8Sf3w: posts small blind $0.50
uCqEjnxh2/vFBjKYkfTOkw: posts big blind $1
*** HOLE CARDS ***
8OEJHwpMpZZfyaTpXEDFfw: folds
TIB5eSBJLz62w6yz2+yeKw: folds
Qy/UBNbD2HaA0Ogxg8Sf3w: folds
uCqEjnxh2/vFBjKYkfTOkw collected $1 from pot
uCqEjnxh2/vFBjKYkfTOkw: doesn't show hand
*** SUMMARY ***
Total pot $1 | Rake $0
Seat 2: TIB5eSBJLz62w6yz2+yeKw (button) folded before Flop (didn't bet)
Seat 3: Qy/UBNbD2HaA0Ogxg8Sf3w (small blind) folded before Flop
Seat 4: uCqEjnxh2/vFBjKYkfTOkw (big blind) collected ($1)
Seat 5: 8OEJHwpMpZZfyaTpXEDFfw folded before Flop (didn't bet)



PokerStars Game #59940481830:  Hold'em No Limit ($0.50/$1.00) - 2009/07/01 1:07:53 ET
Table 'mmbQQVBTrPdE+wy+s+9VPA' 6-max Seat #3 is the button
Seat 1: zyP4SPoWZnKUfTvIRLCVog ($75.55 in chips)
Seat 3: wx3sQGkVi2x9wJXuWNHPBw ($111.15 in chips)
Seat 4: V3iZdcw61nXF3g5hD2RrsQ ($119.70 in chips)
Seat 5: YMJG+F++3Aj6P8dAWda5fw ($100 in chips)
Seat 6: U2CWBTv29qdCbj8RNF2sIw ($100 in chips)
V3iZdcw61nXF3g5hD2RrsQ: posts small blind $0.50
YMJG+F++3Aj6P8dAWda5fw: posts big blind $1
*** HOLE CARDS ***
U2CWBTv29qdCbj8RNF2sIw: folds
zyP4SPoWZnKUfTvIRLCVog: calls $1
wx3sQGkVi2x9wJXuWNHPBw: folds
V3iZdcw61nXF3g5hD2RrsQ: folds
YMJG+F++3Aj6P8dAWda5fw: checks
*** FLOP *** [5h 4c 3c]
YMJG+F++3Aj6P8dAWda5fw: bets $1
zyP4SPoWZnKUfTvIRLCVog: calls $1
*** TURN *** [5h 4c 3c] [Jc]
YMJG+F++3Aj6P8dAWda5fw: bets $2
zyP4SPoWZnKUfTvIRLCVog: calls $2
*** RIVER *** [5h 4c 3c Jc] [Th]
YMJG+F++3Aj6P8dAWda5fw: bets $4
XK4Qsl+DA8gAJyg85/zBIw joins the table at seat #2
zyP4SPoWZnKUfTvIRLCVog: folds
YMJG+F++3Aj6P8dAWda5fw collected $8.10 from pot
*** SUMMARY ***
Total pot $8.50 | Rake $0.40
Board [5h 4c 3c Jc Th]
Seat 1: zyP4SPoWZnKUfTvIRLCVog folded on the River
Seat 3: wx3sQGkVi2x9wJXuWNHPBw (button) folded before Flop (didn't bet)
Seat 4: V3iZdcw61nXF3g5hD2RrsQ (small blind) folded before Flop
Seat 5: YMJG+F++3Aj6P8dAWda5fw (big blind) collected ($8.10)
Seat 6: U2CWBTv29qdCbj8RNF2sIw folded before Flop (didn't bet)



PokerStars Game #59940485902:  Hold'em No Limit ($0.50/$1.00) - 2009/07/01 1:07:59 ET
Table 'O96CPOtvMBWP6kzuYDfdFA' 6-max Seat #4 is the button
Seat 1: 6alLXQIITA2EZ/lBeym8Dw ($126.05 in chips)
Seat 4: /P4w1pHg2zHYg/4ubJ0dPw ($62.05 in chips)
Seat 5: G5ZSSN6RSON3gkNvk/SmYg ($102.70 in chips)
Seat 6: GYei5jXGWexiJYbAT2fELg ($20 in chips)
G5ZSSN6RSON3gkNvk/SmYg: posts small blind $0.50
GYei5jXGWexiJYbAT2fELg: posts big blind $1
4d1rWhpu8DzLmzMbR3QKyA: sits out
*** HOLE CARDS ***
6alLXQIITA2EZ/lBeym8Dw: folds
/P4w1pHg2zHYg/4ubJ0dPw: folds
G5ZSSN6RSON3gkNvk/SmYg: raises $2 to $3
GYei5jXGWexiJYbAT2fELg: calls $2
*** FLOP *** [3c 4c 9s]
G5ZSSN6RSON3gkNvk/SmYg: bets $4
GYei5jXGWexiJYbAT2fELg: calls $4
*** TURN *** [3c 4c 9s] [5d]
G5ZSSN6RSON3gkNvk/SmYg: bets $14
GYei5jXGWexiJYbAT2fELg: calls $13 and is all-in
*** RIVER *** [3c 4c 9s 5d] [7d]
*** SHOW DOWN ***
G5ZSSN6RSON3gkNvk/SmYg: shows [3h As] (a pair of Threes)
GYei5jXGWexiJYbAT2fELg: shows [8s 6c] (a straight, Five to Nine)
GYei5jXGWexiJYbAT2fELg collected $38.05 from pot
*** SUMMARY ***
Total pot $40 | Rake $1.95
Board [3c 4c 9s 5d 7d]
Seat 1: 6alLXQIITA2EZ/lBeym8Dw folded before Flop (didn't bet)
Seat 4: /P4w1pHg2zHYg/4ubJ0dPw (button) folded before Flop (didn't bet)
Seat 5: G5ZSSN6RSON3gkNvk/SmYg (small blind) showed [3h As] and lost with a pair of Threes
Seat 6: GYei5jXGWexiJYbAT2fELg (big blind) showed [8s 6c] and won ($38.05) with a straight, Five to Nine



PokerStars Game #59940485522:  Hold'em No Limit ($0.50/$1.00) - 2009/07/01 1:07:59 ET
Table 'rmZfTK+oSebeUPJNbWhdAA' 6-max Seat #2 is the button
Seat 1: xAU6q2/cwmby2sxmA8VcmA ($147 in chips)
Seat 2: z7O9PO/WEcqRouIydFhS9Q ($135.40 in chips)
Seat 3: BCEV3COoKY607AzLWayfRA ($133 in chips)
Seat 4: 1/mIuXfgx1ZyVkodrmfQDw ($100 in chips)
Seat 5: 5lY8d6Cnm4HUkt/8FZSj4g ($90.25 in chips)
Seat 6: j7NIOHLZk7V2o9fOioO5ug ($104.80 in chips)
BCEV3COoKY607AzLWayfRA: posts small blind $0.50
1/mIuXfgx1ZyVkodrmfQDw: posts big blind $1
*** HOLE CARDS ***
5lY8d6Cnm4HUkt/8FZSj4g: folds
j7NIOHLZk7V2o9fOioO5ug: folds
xAU6q2/cwmby2sxmA8VcmA: raises $3 to $4
z7O9PO/WEcqRouIydFhS9Q: folds
BCEV3COoKY607AzLWayfRA: folds
1/mIuXfgx1ZyVkodrmfQDw: folds
xAU6q2/cwmby2sxmA8VcmA collected $2.50 from pot
xAU6q2/cwmby2sxmA8VcmA: doesn't show hand
*** SUMMARY ***
Total pot $2.50 | Rake $0
Seat 1: xAU6q2/cwmby2sxmA8VcmA collected ($2.50)
Seat 2: z7O9PO/WEcqRouIydFhS9Q (button) folded before Flop (didn't bet)
Seat 3: BCEV3COoKY607AzLWayfRA (small blind) folded before Flop
Seat 4: 1/mIuXfgx1ZyVkodrmfQDw (big blind) folded before Flop
Seat 5: 5lY8d6Cnm4HUkt/8FZSj4g folded before Flop (didn't bet)
Seat 6: j7NIOHLZk7V2o9fOioO5ug folded before Flop (didn't bet)



PokerStars Game #59940485672:  Hold'em No Limit ($0.50/$1.00) - 2009/07/01 1:07:59 ET
Table 'cBDNutyLBKEk9+ptwsKmTw' 6-max Seat #1 is the button
Seat 1: xAU6q2/cwmby2sxmA8VcmA ($120 in chips)
Seat 2: 5lY8d6Cnm4HUkt/8FZSj4g ($38 in chips)
Seat 3: G5ZSSN6RSON3gkNvk/SmYg ($100 in chips)
Seat 4: 3q7F5QtzC30pSrn0nl9i+A ($19.80 in chips)
Seat 5: OGMLOcTNYZXZU81au7ztUw ($165.40 in chips)
Seat 6: NqVlOSH2lp+pp/TK3vvK5g ($87.15 in chips)
5lY8d6Cnm4HUkt/8FZSj4g: posts small blind $0.50
G5ZSSN6RSON3gkNvk/SmYg: posts big blind $1
*** HOLE CARDS ***
3q7F5QtzC30pSrn0nl9i+A: calls $1
OGMLOcTNYZXZU81au7ztUw: folds
NqVlOSH2lp+pp/TK3vvK5g: folds
xAU6q2/cwmby2sxmA8VcmA: folds
5lY8d6Cnm4HUkt/8FZSj4g: calls $0.50
G5ZSSN6RSON3gkNvk/SmYg: checks
*** FLOP *** [3d Jd Kh]
5lY8d6Cnm4HUkt/8FZSj4g: bets $4
G5ZSSN6RSON3gkNvk/SmYg: folds
3q7F5QtzC30pSrn0nl9i+A: raises $4 to $8
5lY8d6Cnm4HUkt/8FZSj4g: folds
3q7F5QtzC30pSrn0nl9i+A collected $10.50 from pot
*** SUMMARY ***
Total pot $11 | Rake $0.50
Board [3d Jd Kh]
Seat 1: xAU6q2/cwmby2sxmA8VcmA (button) folded before Flop (didn't bet)
Seat 2: 5lY8d6Cnm4HUkt/8FZSj4g (small blind) folded on the Flop
Seat 3: G5ZSSN6RSON3gkNvk/SmYg (big blind) folded on the Flop
Seat 4: 3q7F5QtzC30pSrn0nl9i+A collected ($10.50)
Seat 5: OGMLOcTNYZXZU81au7ztUw folded before Flop (didn't bet)
Seat 6: NqVlOSH2lp+pp/TK3vvK5g folded before Flop (didn't bet)



PokerStars Game #59940486844:  Hold'em No Limit ($0.50/$1.00) - 2009/07/01 1:08:01 ET
Table '3T4owEKJKyGTMePwrv50FQ' 9-max Seat #4 is the button
Seat 1: OGgaARGdJQT4awWVNQ957w ($101.10 in chips)
Seat 2: t+Id2O6herCLgwnC4m49PA ($38.60 in chips)
Seat 3: DOLzOcBTZYcph5jEfKFWuQ ($105.50 in chips)
Seat 4: O5Go3jrzbQWxRB6ESK+Ptg ($30.10 in chips)
Seat 5: eI48VADSCFoNZBx4T9qs2w ($30.95 in chips)
Seat 6: laA8va+Yv8WuMqT1zdR91g ($100 in chips)
Seat 7: 1862487932 ($103 in chips)
Seat 9: 61sfw5QTu62YYIt68OsdrA ($66.95 in chips)
eI48VADSCFoNZBx4T9qs2w: posts small blind $0.50
laA8va+Yv8WuMqT1zdR91g: posts big blind $1
ucTB8uAUcQnKGsA70OSjNA: sits out
*** HOLE CARDS ***
1862487932: folds
61sfw5QTu62YYIt68OsdrA: folds
OGgaARGdJQT4awWVNQ957w: folds
t+Id2O6herCLgwnC4m49PA: folds
DOLzOcBTZYcph5jEfKFWuQ: folds
O5Go3jrzbQWxRB6ESK+Ptg: folds
eI48VADSCFoNZBx4T9qs2w: calls $0.50
laA8va+Yv8WuMqT1zdR91g: checks
*** FLOP *** [Th Jd 2s]
eI48VADSCFoNZBx4T9qs2w: bets $1
laA8va+Yv8WuMqT1zdR91g: folds
eI48VADSCFoNZBx4T9qs2w collected $1.90 from pot
*** SUMMARY ***
Total pot $2 | Rake $0.10
Board [Th Jd 2s]
Seat 1: OGgaARGdJQT4awWVNQ957w folded before Flop (didn't bet)
Seat 2: t+Id2O6herCLgwnC4m49PA folded before Flop (didn't bet)
Seat 3: DOLzOcBTZYcph5jEfKFWuQ folded before Flop (didn't bet)
Seat 4: O5Go3jrzbQWxRB6ESK+Ptg (button) folded before Flop (didn't bet)
Seat 5: eI48VADSCFoNZBx4T9qs2w (small blind) collected ($1.90)
Seat 6: laA8va+Yv8WuMqT1zdR91g (big blind) folded on the Flop
Seat 7: 1862487932 folded before Flop (didn't bet)
Seat 9: 61sfw5QTu62YYIt68OsdrA folded before Flop (didn't bet)



PokerStars Game #59940487648:  Hold'em No Limit ($0.50/$1.00) - 2009/07/01 1:08:03 ET
Table 'N2bNCDHL96aCQDvZIh+yQQ' 6-max Seat #3 is the button
Seat 2: TIB5eSBJLz62w6yz2+yeKw ($89 in chips)
Seat 3: Qy/UBNbD2HaA0Ogxg8Sf3w ($237 in chips)
Seat 4: uCqEjnxh2/vFBjKYkfTOkw ($197.05 in chips)
Seat 5: 8OEJHwpMpZZfyaTpXEDFfw ($27.15 in chips)
uCqEjnxh2/vFBjKYkfTOkw: posts small blind $0.50
8OEJHwpMpZZfyaTpXEDFfw: posts big blind $1
*** HOLE CARDS ***
TIB5eSBJLz62w6yz2+yeKw: folds
Qy/UBNbD2HaA0Ogxg8Sf3w: folds
uCqEjnxh2/vFBjKYkfTOkw: calls $0.50
8OEJHwpMpZZfyaTpXEDFfw: checks
*** FLOP *** [9h Ts 5d]
uCqEjnxh2/vFBjKYkfTOkw: checks
8OEJHwpMpZZfyaTpXEDFfw: checks
*** TURN *** [9h Ts 5d] [Ad]
uCqEjnxh2/vFBjKYkfTOkw: checks
8OEJHwpMpZZfyaTpXEDFfw: checks
*** RIVER *** [9h Ts 5d Ad] [4s]
uCqEjnxh2/vFBjKYkfTOkw: checks
8OEJHwpMpZZfyaTpXEDFfw: checks
*** SHOW DOWN ***
uCqEjnxh2/vFBjKYkfTOkw: shows [8s Jh] (high card Ace)
8OEJHwpMpZZfyaTpXEDFfw: mucks hand
uCqEjnxh2/vFBjKYkfTOkw collected $1.90 from pot
*** SUMMARY ***
Total pot $2 | Rake $0.10
Board [9h Ts 5d Ad 4s]
Seat 2: TIB5eSBJLz62w6yz2+yeKw folded before Flop (didn't bet)
Seat 3: Qy/UBNbD2HaA0Ogxg8Sf3w (button) folded before Flop (didn't bet)
Seat 4: uCqEjnxh2/vFBjKYkfTOkw (small blind) showed [8s Jh] and won ($1.90) with high card Ace
Seat 5: 8OEJHwpMpZZfyaTpXEDFfw (big blind) mucked



PokerStars Game #59940488118:  Hold'em No Limit ($0.50/$1.00) - 2009/07/01 1:08:03 ET
Table '7Nl0ffnjeK44/vmeexh3MQ' 9-max Seat #6 is the button
Seat 1: s7D3Y+k4Cj4D1cXHv7oj+Q ($90.85 in chips)
Seat 2: OGgaARGdJQT4awWVNQ957w ($100 in chips)
Seat 3: JMmUYT5pIKCKh2pGjCB/4w ($37 in chips)
Seat 4: bLbSOSmSOnqE0iTcH/5dxA ($104.15 in chips)
Seat 5: 61sfw5QTu62YYIt68OsdrA ($64.90 in chips)
Seat 6: FVs16t7GgfWgQWt4JxsObQ ($50.35 in chips)
Seat 7: 997ViqAtWn1FPjJqcffwcA ($100 in chips)
Seat 8: D+W9Me7w6Hcx/WRUSKV0dw ($19.75 in chips)
Seat 9: ouwUBGRKnKK9uhn1G4Lf+A ($195.50 in chips)
997ViqAtWn1FPjJqcffwcA: posts small blind $0.50
D+W9Me7w6Hcx/WRUSKV0dw: posts big blind $1
*** HOLE CARDS ***
ouwUBGRKnKK9uhn1G4Lf+A: folds
s7D3Y+k4Cj4D1cXHv7oj+Q: folds
OGgaARGdJQT4awWVNQ957w: folds
JMmUYT5pIKCKh2pGjCB/4w: folds
bLbSOSmSOnqE0iTcH/5dxA: folds
61sfw5QTu62YYIt68OsdrA: raises $2 to $3
FVs16t7GgfWgQWt4JxsObQ: calls $3
997ViqAtWn1FPjJqcffwcA: folds
D+W9Me7w6Hcx/WRUSKV0dw: folds
*** FLOP *** [5s Ks Qd]
61sfw5QTu62YYIt68OsdrA: bets $6
FVs16t7GgfWgQWt4JxsObQ: calls $6
*** TURN *** [5s Ks Qd] [Qs]
61sfw5QTu62YYIt68OsdrA: checks
FVs16t7GgfWgQWt4JxsObQ: bets $5
61sfw5QTu62YYIt68OsdrA: calls $5
*** RIVER *** [5s Ks Qd Qs] [Kc]
61sfw5QTu62YYIt68OsdrA: checks
FVs16t7GgfWgQWt4JxsObQ: checks
*** SHOW DOWN ***
61sfw5QTu62YYIt68OsdrA: shows [Ah As] (two pair, Aces and Kings)
FVs16t7GgfWgQWt4JxsObQ: mucks hand
61sfw5QTu62YYIt68OsdrA collected $28.10 from pot
*** SUMMARY ***
Total pot $29.50 | Rake $1.40
Board [5s Ks Qd Qs Kc]
Seat 1: s7D3Y+k4Cj4D1cXHv7oj+Q folded before Flop (didn't bet)
Seat 2: OGgaARGdJQT4awWVNQ957w folded before Flop (didn't bet)
Seat 3: JMmUYT5pIKCKh2pGjCB/4w folded before Flop (didn't bet)
Seat 4: bLbSOSmSOnqE0iTcH/5dxA folded before Flop (didn't bet)
Seat 5: 61sfw5QTu62YYIt68OsdrA showed [Ah As] and won ($28.10) with two pair, Aces and Kings
Seat 6: FVs16t7GgfWgQWt4JxsObQ (button) mucked
Seat 7: 997ViqAtWn1FPjJqcffwcA (small blind) folded before Flop
Seat 8: D+W9Me7w6Hcx/WRUSKV0dw (big blind) folded before Flop
Seat 9: ouwUBGRKnKK9uhn1G4Lf+A folded before Flop (didn't bet)



PokerStars Game #59940488318:  Hold'em No Limit ($0.50/$1.00) - 2009/07/01 1:08:04 ET
Table 'vs/5jr6ciwjVQ5+Soc+u2A' 6-max Seat #6 is the button
Seat 1: /P4w1pHg2zHYg/4ubJ0dPw ($60.80 in chips)
Seat 2: lXX4W7m3u++JiSOZ46yVMQ ($107 in chips)
Seat 3: G5ZSSN6RSON3gkNvk/SmYg ($155.35 in chips)
Seat 4: wk6Ohn4GDozoOMHc4eb2rw ($79.15 in chips)
Seat 5: +Nt3OPk3XR9SKjZgm2CexQ ($107.45 in chips)
Seat 6: Z2fXsGcjl+Eax+RzOgwOmg ($100 in chips)
/P4w1pHg2zHYg/4ubJ0dPw: posts small blind $0.50
lXX4W7m3u++JiSOZ46yVMQ: posts big blind $1
*** HOLE CARDS ***
G5ZSSN6RSON3gkNvk/SmYg: folds
wk6Ohn4GDozoOMHc4eb2rw: folds
+Nt3OPk3XR9SKjZgm2CexQ: folds
Z2fXsGcjl+Eax+RzOgwOmg: raises $2 to $3
/P4w1pHg2zHYg/4ubJ0dPw: folds
lXX4W7m3u++JiSOZ46yVMQ: calls $2
*** FLOP *** [2c 7s Tc]
lXX4W7m3u++JiSOZ46yVMQ: checks
Z2fXsGcjl+Eax+RzOgwOmg: bets $5
lXX4W7m3u++JiSOZ46yVMQ: calls $5
*** TURN *** [2c 7s Tc] [3c]
lXX4W7m3u++JiSOZ46yVMQ: bets $10
Z2fXsGcjl+Eax+RzOgwOmg: folds
lXX4W7m3u++JiSOZ46yVMQ collected $15.70 from pot
*** SUMMARY ***
Total pot $16.50 | Rake $0.80
Board [2c 7s Tc 3c]
Seat 1: /P4w1pHg2zHYg/4ubJ0dPw (small blind) folded before Flop
Seat 2: lXX4W7m3u++JiSOZ46yVMQ (big blind) collected ($15.70)
Seat 3: G5ZSSN6RSON3gkNvk/SmYg folded before Flop (didn't bet)
Seat 4: wk6Ohn4GDozoOMHc4eb2rw folded before Flop (didn't bet)
Seat 5: +Nt3OPk3XR9SKjZgm2CexQ folded before Flop (didn't bet)
Seat 6: Z2fXsGcjl+Eax+RzOgwOmg (button) folded on the Turn



PokerStars Game #59940489542:  Hold'em No Limit ($0.50/$1.00) - 2009/07/01 1:08:06 ET
Table 'MUPc8FEpe/nR0BKSeReX6Q' 6-max Seat #6 is the button
Seat 1: qhkK6+yCciTRd+rCFEbnEQ ($42.70 in chips)
Seat 2: xAU6q2/cwmby2sxmA8VcmA ($116.20 in chips)
Seat 3: wx3sQGkVi2x9wJXuWNHPBw ($235.95 in chips)
Seat 4: ZA1bp6g8IwtTxkUE4eCjDQ ($195.15 in chips)
Seat 5: UBZQqpnJZdTYYY1FTb0rLA ($100 in chips)
Seat 6: oxnw0GLLpFanjhGkxfRSqA ($28.65 in chips)
qhkK6+yCciTRd+rCFEbnEQ: posts small blind $0.50
xAU6q2/cwmby2sxmA8VcmA: posts big blind $1
*** HOLE CARDS ***
wx3sQGkVi2x9wJXuWNHPBw: folds
ZA1bp6g8IwtTxkUE4eCjDQ: folds
UBZQqpnJZdTYYY1FTb0rLA: folds
oxnw0GLLpFanjhGkxfRSqA: calls $1
qhkK6+yCciTRd+rCFEbnEQ: calls $0.50
xAU6q2/cwmby2sxmA8VcmA: checks
*** FLOP *** [8s 2c 8d]
qhkK6+yCciTRd+rCFEbnEQ: checks
xAU6q2/cwmby2sxmA8VcmA: checks
oxnw0GLLpFanjhGkxfRSqA: bets $2
qhkK6+yCciTRd+rCFEbnEQ: folds
xAU6q2/cwmby2sxmA8VcmA: folds
oxnw0GLLpFanjhGkxfRSqA collected $2.85 from pot
*** SUMMARY ***
Total pot $3 | Rake $0.15
Board [8s 2c 8d]
Seat 1: qhkK6+yCciTRd+rCFEbnEQ (small blind) folded on the Flop
Seat 2: xAU6q2/cwmby2sxmA8VcmA (big blind) folded on the Flop
Seat 3: wx3sQGkVi2x9wJXuWNHPBw folded before Flop (didn't bet)
Seat 4: ZA1bp6g8IwtTxkUE4eCjDQ folded before Flop (didn't bet)
Seat 5: UBZQqpnJZdTYYY1FTb0rLA folded before Flop (didn't bet)
Seat 6: oxnw0GLLpFanjhGkxfRSqA (button) collected ($2.85)



PokerStars Game #59940489796:  Hold'em No Limit ($0.50/$1.00) - 2009/07/01 1:08:06 ET
Table 'VOs36P6NW+QyXeQ1B62kmA' 6-max Seat #1 is the button
Seat 1: Z2fXsGcjl+Eax+RzOgwOmg ($100 in chips)
Seat 2: 2UMlbaZ8n8AbRli0Yr0mDw ($42.10 in chips)
Seat 4: w02zQzNydODiyV9THKgo9w ($43.05 in chips)
Seat 5: ozrlafxxh1HmYdA0/h+MuA ($45.40 in chips)
Seat 6: slVKuQyEz8Qj4E3uLPYNXg ($98.50 in chips)
2UMlbaZ8n8AbRli0Yr0mDw: posts small blind $0.50
w02zQzNydODiyV9THKgo9w: posts big blind $1
*** HOLE CARDS ***
ozrlafxxh1HmYdA0/h+MuA: calls $1
slVKuQyEz8Qj4E3uLPYNXg: folds
Z2fXsGcjl+Eax+RzOgwOmg: folds
2UMlbaZ8n8AbRli0Yr0mDw: raises $3 to $4
w02zQzNydODiyV9THKgo9w: folds
ozrlafxxh1HmYdA0/h+MuA: folds
2UMlbaZ8n8AbRli0Yr0mDw collected $3 from pot
2UMlbaZ8n8AbRli0Yr0mDw: doesn't show hand
*** SUMMARY ***
Total pot $3 | Rake $0
Seat 1: Z2fXsGcjl+Eax+RzOgwOmg (button) folded before Flop (didn't bet)
Seat 2: 2UMlbaZ8n8AbRli0Yr0mDw (small blind) collected ($3)
Seat 4: w02zQzNydODiyV9THKgo9w (big blind) folded before Flop
Seat 5: ozrlafxxh1HmYdA0/h+MuA folded before Flop
Seat 6: slVKuQyEz8Qj4E3uLPYNXg folded before Flop (didn't bet)



PokerStars Game #59940490762:  Hold'em No Limit ($0.50/$1.00) - 2009/07/01 1:08:08 ET
Table 'JTT1XWaDZHSaMZQK7cR5uw' 2-max Seat #2 is the button
Seat 1: OLplZF6FEnLflv81Hz+Fxg ($124.45 in chips)
Seat 2: BcqgegiOUxmBD3F3umsljg ($82.15 in chips)
BcqgegiOUxmBD3F3umsljg: posts small blind $0.50
OLplZF6FEnLflv81Hz+Fxg: posts big blind $1
*** HOLE CARDS ***
BcqgegiOUxmBD3F3umsljg: raises $2 to $3
OLplZF6FEnLflv81Hz+Fxg: folds
BcqgegiOUxmBD3F3umsljg collected $2 from pot
BcqgegiOUxmBD3F3umsljg: doesn't show hand
*** SUMMARY ***
Total pot $2 | Rake $0
Seat 1: OLplZF6FEnLflv81Hz+Fxg (big blind) folded before Flop
Seat 2: BcqgegiOUxmBD3F3umsljg (button) (small blind) collected ($2)



PokerStars Game #59940491650:  Hold'em No Limit ($0.50/$1.00) - 2009/07/01 1:08:09 ET
Table 'tyUh+jyNvrceIQdKMJjQ2wZFWj23PMihdwrNWv41OG/Qeat #3 is the button
Seat 1: o8A5MUdudVKu+pAwgZOX2w ($113.90 in chips)
Seat 2: 5uy3EN+iIYkgwbWZFTUBAQ ($100 in chips)
Seat 3: TalCiLYHCd+ffkmR3auPvA ($72.60 in chips)
Seat 5: j7NIOHLZk7V2o9fOioO5ug ($127.40 in chips)
Seat 6: 4OO5v3AVduL0tePNx8wk5A ($100 in chips)
j7NIOHLZk7V2o9fOioO5ug: posts small blind $0.50
4OO5v3AVduL0tePNx8wk5A: posts big blind $1
*** HOLE CARDS ***
o8A5MUdudVKu+pAwgZOX2w: folds
5uy3EN+iIYkgwbWZFTUBAQ: folds
TalCiLYHCd+ffkmR3auPvA: calls $1
j7NIOHLZk7V2o9fOioO5ug: raises $4 to $5
4OO5v3AVduL0tePNx8wk5A: folds
TalCiLYHCd+ffkmR3auPvA: calls $4
*** FLOP *** [Kh Ah Ts]
TSuRyAHnUPCFjP7Z0rEE0w leaves the table
j7NIOHLZk7V2o9fOioO5ug: bets $7
TalCiLYHCd+ffkmR3auPvA: raises $8 to $15
j7NIOHLZk7V2o9fOioO5ug: calls $8
*** TURN *** [Kh Ah Ts] [Qs]
j7NIOHLZk7V2o9fOioO5ug: checks
TalCiLYHCd+ffkmR3auPvA: bets $18
j7NIOHLZk7V2o9fOioO5ug: raises $32 to $50
TalCiLYHCd+ffkmR3auPvA: raises $2.60 to $52.60 and is all-in
j7NIOHLZk7V2o9fOioO5ug: calls $2.60
*** RIVER *** [Kh Ah Ts Qs] [5c]
*** SHOW DOWN ***
j7NIOHLZk7V2o9fOioO5ug: shows [As 6s] (a pair of Aces)
TalCiLYHCd+ffkmR3auPvA: shows [Td Ac] (two pair, Aces and Tens)
TalCiLYHCd+ffkmR3auPvA collected $144.20 from pot
*** SUMMARY ***
Total pot $146.20 | Rake $2
Board [Kh Ah Ts Qs 5c]
Seat 1: o8A5MUdudVKu+pAwgZOX2w folded before Flop (didn't bet)
Seat 2: 5uy3EN+iIYkgwbWZFTUBAQ folded before Flop (didn't bet)
Seat 3: TalCiLYHCd+ffkmR3auPvA (button) showed [Td Ac] and won ($144.20) with two pair, Aces and Tens
Seat 5: j7NIOHLZk7V2o9fOioO5ug (small blind) showed [As 6s] and lost with a pair of Aces
Seat 6: 4OO5v3AVduL0tePNx8wk5A (big blind) folded before Flop



PokerStars Game #59940492654:  Hold'em No Limit ($0.50/$1.00) - 2009/07/01 1:08:11 ET
Table 'W/wyObTiXZm+Ckkl3YxcSw' 6-max Seat #3 is the button
Seat 1: eUBBn2R56C1IQ6Cs/vitwg ($180.75 in chips)
Seat 2: oDiBRCaF0QVtd3kO6xZIXw ($132.35 in chips)
Seat 3: dxyNCn/qxfkGDUIf28Cbng ($77.40 in chips)
Seat 4: aYii2DmxlOlbC1wbGRBWvQ ($107.25 in chips)
Seat 5: MFptnnT6AnJakWBooTkmeg ($25.65 in chips)
Seat 6: OGMLOcTNYZXZU81au7ztUw ($100 in chips)
aYii2DmxlOlbC1wbGRBWvQ: posts small blind $0.50
MFptnnT6AnJakWBooTkmeg: posts big blind $1
*** HOLE CARDS ***
OGMLOcTNYZXZU81au7ztUw: folds
eUBBn2R56C1IQ6Cs/vitwg: folds
oDiBRCaF0QVtd3kO6xZIXw: calls $1
dxyNCn/qxfkGDUIf28Cbng: calls $1
aYii2DmxlOlbC1wbGRBWvQ: folds
MFptnnT6AnJakWBooTkmeg: checks
*** FLOP *** [5s 6s Qc]
MFptnnT6AnJakWBooTkmeg: checks
oDiBRCaF0QVtd3kO6xZIXw: bets $3
dxyNCn/qxfkGDUIf28Cbng: calls $3
MFptnnT6AnJakWBooTkmeg: folds
*** TURN *** [5s 6s Qc] [7d]
oDiBRCaF0QVtd3kO6xZIXw: bets $6
dxyNCn/qxfkGDUIf28Cbng: calls $6
*** RIVER *** [5s 6s Qc 7d] [8c]
oDiBRCaF0QVtd3kO6xZIXw: bets $10
dxyNCn/qxfkGDUIf28Cbng: calls $10
*** SHOW DOWN ***
oDiBRCaF0QVtd3kO6xZIXw: shows [8h 8s] (three of a kind, Eights)
dxyNCn/qxfkGDUIf28Cbng: mucks hand
oDiBRCaF0QVtd3kO6xZIXw collected $39.50 from pot
*** SUMMARY ***
Total pot $41.50 | Rake $2
Board [5s 6s Qc 7d 8c]
Seat 1: eUBBn2R56C1IQ6Cs/vitwg folded before Flop (didn't bet)
Seat 2: oDiBRCaF0QVtd3kO6xZIXw showed [8h 8s] and won ($39.50) with three of a kind, Eights
Seat 3: dxyNCn/qxfkGDUIf28Cbng (button) mucked
Seat 4: aYii2DmxlOlbC1wbGRBWvQ (small blind) folded before Flop
Seat 5: MFptnnT6AnJakWBooTkmeg (big blind) folded on the Flop
Seat 6: OGMLOcTNYZXZU81au7ztUw folded before Flop (didn't bet)



PokerStars Game #59940493538:  Hold'em No Limit ($0.50/$1.00) - 2009/07/01 1:08:12 ET
Table 'QSIig7BLMc9wY/rgBechzw' 6-max Seat #4 is the button
Seat 1: Z2fXsGcjl+Eax+RzOgwOmg ($107 in chips)
Seat 2: mLOIkH/qmRa+mVujQIhBRg ($40.10 in chips)
Seat 3: +xW7QemQU0Fxs+4TnqBRow ($100 in chips)
Seat 4: +uSzP8Jwnw7sKfQ4s66b7w ($83.45 in chips)
Seat 5: lsLuWlcPA3Rh7kJVLzMh0Q ($100 in chips)
Seat 6: PxqfkAMdAWtkgbT+q2gciA ($40.75 in chips)
lsLuWlcPA3Rh7kJVLzMh0Q: posts small blind $0.50
PxqfkAMdAWtkgbT+q2gciA: posts big blind $1
*** HOLE CARDS ***
Z2fXsGcjl+Eax+RzOgwOmg: folds
mLOIkH/qmRa+mVujQIhBRg: folds
+xW7QemQU0Fxs+4TnqBRow: folds
+uSzP8Jwnw7sKfQ4s66b7w: folds
lsLuWlcPA3Rh7kJVLzMh0Q: raises $2 to $3
PxqfkAMdAWtkgbT+q2gciA: folds
lsLuWlcPA3Rh7kJVLzMh0Q collected $2 from pot
lsLuWlcPA3Rh7kJVLzMh0Q: doesn't show hand
*** SUMMARY ***
Total pot $2 | Rake $0
Seat 1: Z2fXsGcjl+Eax+RzOgwOmg folded before Flop (didn't bet)
Seat 2: mLOIkH/qmRa+mVujQIhBRg folded before Flop (didn't bet)
Seat 3: +xW7QemQU0Fxs+4TnqBRow folded before Flop (didn't bet)
Seat 4: +uSzP8Jwnw7sKfQ4s66b7w (button) folded before Flop (didn't bet)
Seat 5: lsLuWlcPA3Rh7kJVLzMh0Q (small blind) collected ($2)
Seat 6: PxqfkAMdAWtkgbT+q2gciA (big blind) folded before Flop



PokerStars Game #59940493382:  Hold'em No Limit ($0.50/$1.00) - 2009/07/01 1:08:12 ET
Table 'cKH9c4x6u79IqCdaKKvXrw' 9-max Seat #4 is the button
Seat 1: Pp/KTcXkfZKKUHkjyaLTdg ($18.50 in chips)
Seat 2: 8S3JMH4TY3whgIlZmMv66w ($75.55 in chips)
Seat 3: 997ViqAtWn1FPjJqcffwcA ($155.60 in chips)
Seat 4: FL3MrLspcF23LYvC4ipBOA ($100 in chips)
Seat 5: Jjc7EHWzs4//xUAjJ0UWoA ($41.05 in chips)
Seat 6: Bsd/K5gAcLanYbGiPirRjw ($202.55 in chips)
Seat 7: 1GkkVBhlJ92guE6K5mS5Ig ($19.10 in chips)
Seat 8: myIxN7otsyr846M539YR8Q ($17 in chips)
Seat 9: 6XkTu4ahxzHnvjjc1R8YjQ ($41.60 in chips)
Jjc7EHWzs4//xUAjJ0UWoA: posts small blind $0.50
Bsd/K5gAcLanYbGiPirRjw: posts big blind $1
*** HOLE CARDS ***
1GkkVBhlJ92guE6K5mS5Ig: calls $1
myIxN7otsyr846M539YR8Q: folds
6XkTu4ahxzHnvjjc1R8YjQ: folds
Pp/KTcXkfZKKUHkjyaLTdg: folds
8S3JMH4TY3whgIlZmMv66w: folds
997ViqAtWn1FPjJqcffwcA: folds
FL3MrLspcF23LYvC4ipBOA: folds
Jjc7EHWzs4//xUAjJ0UWoA: calls $0.50
Bsd/K5gAcLanYbGiPirRjw: checks
*** FLOP *** [Qh 9h Jd]
Jjc7EHWzs4//xUAjJ0UWoA: checks
Bsd/K5gAcLanYbGiPirRjw: checks
1GkkVBhlJ92guE6K5mS5Ig: checks
*** TURN *** [Qh 9h Jd] [7s]
Jjc7EHWzs4//xUAjJ0UWoA: checks
Bsd/K5gAcLanYbGiPirRjw: checks
1GkkVBhlJ92guE6K5mS5Ig: checks
*** RIVER *** [Qh 9h Jd 7s] [5s]
Jjc7EHWzs4//xUAjJ0UWoA: checks
Bsd/K5gAcLanYbGiPirRjw: checks
1GkkVBhlJ92guE6K5mS5Ig: checks
*** SHOW DOWN ***
Jjc7EHWzs4//xUAjJ0UWoA: shows [9s 8s] (a pair of Nines)
Bsd/K5gAcLanYbGiPirRjw: mucks hand
1GkkVBhlJ92guE6K5mS5Ig: mucks hand
Jjc7EHWzs4//xUAjJ0UWoA collected $2.85 from pot
*** SUMMARY ***
Total pot $3 | Rake $0.15
Board [Qh 9h Jd 7s 5s]
Seat 1: Pp/KTcXkfZKKUHkjyaLTdg folded before Flop (didn't bet)
Seat 2: 8S3JMH4TY3whgIlZmMv66w folded before Flop (didn't bet)
Seat 3: 997ViqAtWn1FPjJqcffwcA folded before Flop (didn't bet)
Seat 4: FL3MrLspcF23LYvC4ipBOA (button) folded before Flop (didn't bet)
Seat 5: Jjc7EHWzs4//xUAjJ0UWoA (small blind) showed [9s 8s] and won ($2.85) with a pair of Nines
Seat 6: Bsd/K5gAcLanYbGiPirRjw (big blind) mucked
Seat 7: 1GkkVBhlJ92guE6K5mS5Ig mucked
Seat 8: myIxN7otsyr846M539YR8Q folded before Flop (didn't bet)
Seat 9: 6XkTu4ahxzHnvjjc1R8YjQ folded before Flop (didn't bet)



PokerStars Game #59940496158:  Hold'em No Limit ($0.50/$1.00) - 2009/07/01 1:08:17 ET
Table 'JTT1XWaDZHSaMZQK7cR5uw' 2-max Seat #1 is the button
Seat 1: OLplZF6FEnLflv81Hz+Fxg ($123.45 in chips)
Seat 2: BcqgegiOUxmBD3F3umsljg ($83.15 in chips)
OLplZF6FEnLflv81Hz+Fxg: posts small blind $0.50
BcqgegiOUxmBD3F3umsljg: posts big blind $1
*** HOLE CARDS ***
OLplZF6FEnLflv81Hz+Fxg: raises $2 to $3
BcqgegiOUxmBD3F3umsljg: folds
OLplZF6FEnLflv81Hz+Fxg collected $2 from pot
*** SUMMARY ***
Total pot $2 | Rake $0
Seat 1: OLplZF6FEnLflv81Hz+Fxg (button) (small blind) collected ($2)
Seat 2: BcqgegiOUxmBD3F3umsljg (big blind) folded before Flop



PokerStars Game #59940496492:  Hold'em No Limit ($0.50/$1.00) - 2009/07/01 1:08:17 ET
Table 'hugOjcwJvzEwZbK7tyiWuQ' 9-max Seat #7 is the button
Seat 2: r27C1nIV4NS4+qbnrgBQSw ($283.20 in chips)
Seat 3: jDwhY1kCdc6EkAHbT7PJMQ ($104.75 in chips)
Seat 4: UWB3oeddt/GObx2Mix2Anw ($178 in chips)
Seat 5: 5BRGWf+R3nt2WS3b5xX+zA ($16.75 in chips)
Seat 6: gUUvmqdVlmvpal6B8nYrmg ($105.90 in chips)
Seat 7: FL3MrLspcF23LYvC4ipBOA ($106.80 in chips)
Seat 8: /zy+DB4S5fUQUSfZWFzYGw ($100 in chips)
Seat 9: W8P9bUKCs43TO1xHm0dL6w ($90.95 in chips)
/zy+DB4S5fUQUSfZWFzYGw: posts small blind $0.50
W8P9bUKCs43TO1xHm0dL6w: posts big blind $1
*** HOLE CARDS ***
r27C1nIV4NS4+qbnrgBQSw: folds
jDwhY1kCdc6EkAHbT7PJMQ: folds
UWB3oeddt/GObx2Mix2Anw: folds
5BRGWf+R3nt2WS3b5xX+zA: folds
gUUvmqdVlmvpal6B8nYrmg: raises $1 to $2
FL3MrLspcF23LYvC4ipBOA: raises $7 to $9
/zy+DB4S5fUQUSfZWFzYGw: folds
W8P9bUKCs43TO1xHm0dL6w: folds
gUUvmqdVlmvpal6B8nYrmg: folds
FL3MrLspcF23LYvC4ipBOA collected $5.50 from pot
*** SUMMARY ***
Total pot $5.50 | Rake $0
Seat 2: r27C1nIV4NS4+qbnrgBQSw folded before Flop (didn't bet)
Seat 3: jDwhY1kCdc6EkAHbT7PJMQ folded before Flop (didn't bet)
Seat 4: UWB3oeddt/GObx2Mix2Anw folded before Flop (didn't bet)
Seat 5: 5BRGWf+R3nt2WS3b5xX+zA folded before Flop (didn't bet)
Seat 6: gUUvmqdVlmvpal6B8nYrmg folded before Flop
Seat 7: FL3MrLspcF23LYvC4ipBOA (button) collected ($5.50)
Seat 8: /zy+DB4S5fUQUSfZWFzYGw (small blind) folded before Flop
Seat 9: W8P9bUKCs43TO1xHm0dL6w (big blind) folded before Flop



PokerStars Game #59940498596:  Hold'em No Limit ($0.50/$1.00) - 2009/07/01 1:08:21 ET
Table 'tJq9SfN1ywY0r03VBlWlwQ' 9-max Seat #1 is the button
Seat 1: wZsU+w9r7G66x93UuvBf1Q ($339.30 in chips)
Seat 3: FVs16t7GgfWgQWt4JxsObQ ($26.60 in chips)
Seat 4: bLbSOSmSOnqE0iTcH/5dxA ($112.20 in chips)
Seat 5: h5ipsNTMyolp7xn/NAvWkA ($73 in chips)
Seat 6: gUUvmqdVlmvpal6B8nYrmg ($120.20 in chips)
Seat 8: G4DEhsZFmznGNVpy2SEocA ($29.90 in chips)
Seat 9: XE5QF1y74bpHog9JxWJMWQ ($100.50 in chips)
FVs16t7GgfWgQWt4JxsObQ: posts small blind $0.50
bLbSOSmSOnqE0iTcH/5dxA: posts big blind $1
*** HOLE CARDS ***
h5ipsNTMyolp7xn/NAvWkA: raises $2 to $3
gUUvmqdVlmvpal6B8nYrmg: folds
G4DEhsZFmznGNVpy2SEocA: folds
XE5QF1y74bpHog9JxWJMWQ: folds
wZsU+w9r7G66x93UuvBf1Q: folds
FVs16t7GgfWgQWt4JxsObQ: folds
bLbSOSmSOnqE0iTcH/5dxA: folds
h5ipsNTMyolp7xn/NAvWkA collected $2.50 from pot
*** SUMMARY ***
Total pot $2.50 | Rake $0
Seat 1: wZsU+w9r7G66x93UuvBf1Q (button) folded before Flop (didn't bet)
Seat 3: FVs16t7GgfWgQWt4JxsObQ (small blind) folded before Flop
Seat 4: bLbSOSmSOnqE0iTcH/5dxA (big blind) folded before Flop
Seat 5: h5ipsNTMyolp7xn/NAvWkA collected ($2.50)
Seat 6: gUUvmqdVlmvpal6B8nYrmg folded before Flop (didn't bet)
Seat 8: G4DEhsZFmznGNVpy2SEocA folded before Flop (didn't bet)
Seat 9: XE5QF1y74bpHog9JxWJMWQ folded before Flop (didn't bet)



PokerStars Game #59940499008:  Hold'em No Limit ($0.50/$1.00) - 2009/07/01 1:08:22 ET
Table 'eU3bWpDDg3Z+9R4m4iVmog' 6-max Seat #3 is the button
Seat 2: 8CAoOzhmB8n3nRFf3V4BTg ($89.95 in chips)
Seat 3: rVMOzU7w5FddYPGhD7qN2Q ($39.15 in chips)
Seat 4: GDVIsbEJ/DOJsMKE4Asz0A ($94.75 in chips)
Seat 6: hpxXcmRkXXI9HE5+5/j/0Q ($120 in chips)
GDVIsbEJ/DOJsMKE4Asz0A: posts small blind $0.50
hpxXcmRkXXI9HE5+5/j/0Q: posts big blind $1
*** HOLE CARDS ***
8CAoOzhmB8n3nRFf3V4BTg: folds
rVMOzU7w5FddYPGhD7qN2Q: calls $1
GDVIsbEJ/DOJsMKE4Asz0A: calls $0.50
hpxXcmRkXXI9HE5+5/j/0Q: checks
*** FLOP *** [4h 3s As]
GDVIsbEJ/DOJsMKE4Asz0A: checks
hpxXcmRkXXI9HE5+5/j/0Q: checks
rVMOzU7w5FddYPGhD7qN2Q: checks
*** TURN *** [4h 3s As] [Ks]
GDVIsbEJ/DOJsMKE4Asz0A: checks
hpxXcmRkXXI9HE5+5/j/0Q: checks
rVMOzU7w5FddYPGhD7qN2Q: checks
*** RIVER *** [4h 3s As Ks] [3h]
GDVIsbEJ/DOJsMKE4Asz0A: checks
hpxXcmRkXXI9HE5+5/j/0Q: checks
rVMOzU7w5FddYPGhD7qN2Q: checks
*** SHOW DOWN ***
GDVIsbEJ/DOJsMKE4Asz0A: shows [2c Jh] (a pair of Threes)
hpxXcmRkXXI9HE5+5/j/0Q: shows [2d 3d] (three of a kind, Threes)
rVMOzU7w5FddYPGhD7qN2Q: mucks hand
hpxXcmRkXXI9HE5+5/j/0Q collected $2.85 from pot
*** SUMMARY ***
Total pot $3 | Rake $0.15
Board [4h 3s As Ks 3h]
Seat 2: 8CAoOzhmB8n3nRFf3V4BTg folded before Flop (didn't bet)
Seat 3: rVMOzU7w5FddYPGhD7qN2Q (button) mucked
Seat 4: GDVIsbEJ/DOJsMKE4Asz0A (small blind) showed [2c Jh] and lost with a pair of Threes
Seat 6: hpxXcmRkXXI9HE5+5/j/0Q (big blind) showed [2d 3d] and won ($2.85) with three of a kind, Threes



PokerStars Game #59940499602:  Hold'em No Limit ($0.50/$1.00) - 2009/07/01 1:08:23 ET
Table 'CASNP0uy1C+jGLml/I4PtA' 9-max Seat #1 is the button
Seat 1: tkdBeXTJlFsZdioidNqLow ($60 in chips)
Seat 3: bJckevFOcg//s0qyMQI6sQ ($101.40 in chips)
Seat 4: B/G0GJacqZ8K59/ZVdq4kQ ($53.70 in chips)
Seat 5: Jjc7EHWzs4//xUAjJ0UWoA ($14.50 in chips)
Seat 6: FJEywSpo5JbRKByzmweboA ($101.50 in chips)
Seat 8: L9njYvloJ1NdXjP8edHEAg ($100 in chips)
Seat 9: Pp/KTcXkfZKKUHkjyaLTdg ($20 in chips)
bJckevFOcg//s0qyMQI6sQ: posts small blind $0.50
B/G0GJacqZ8K59/ZVdq4kQ: posts big blind $1
*** HOLE CARDS ***
Jjc7EHWzs4//xUAjJ0UWoA: folds
FJEywSpo5JbRKByzmweboA: folds
L9njYvloJ1NdXjP8edHEAg: folds
Pp/KTcXkfZKKUHkjyaLTdg: folds
tkdBeXTJlFsZdioidNqLow: folds
bJckevFOcg//s0qyMQI6sQ: folds
B/G0GJacqZ8K59/ZVdq4kQ collected $1 from pot
*** SUMMARY ***
Total pot $1 | Rake $0
Seat 1: tkdBeXTJlFsZdioidNqLow (button) folded before Flop (didn't bet)
Seat 3: bJckevFOcg//s0qyMQI6sQ (small blind) folded before Flop
Seat 4: B/G0GJacqZ8K59/ZVdq4kQ (big blind) collected ($1)
Seat 5: Jjc7EHWzs4//xUAjJ0UWoA folded before Flop (didn't bet)
Seat 6: FJEywSpo5JbRKByzmweboA folded before Flop (didn't bet)
Seat 8: L9njYvloJ1NdXjP8edHEAg folded before Flop (didn't bet)
Seat 9: Pp/KTcXkfZKKUHkjyaLTdg folded before Flop (didn't bet)



PokerStars Game #59940500998:  Hold'em No Limit ($0.50/$1.00) - 2009/07/01 1:08:25 ET
Table 'JTT1XWaDZHSaMZQK7cR5uw' 2-max Seat #2 is the button
Seat 1: OLplZF6FEnLflv81Hz+Fxg ($124.45 in chips)
Seat 2: BcqgegiOUxmBD3F3umsljg ($82.15 in chips)
BcqgegiOUxmBD3F3umsljg: posts small blind $0.50
OLplZF6FEnLflv81Hz+Fxg: posts big blind $1
*** HOLE CARDS ***
BcqgegiOUxmBD3F3umsljg: raises $2 to $3
OLplZF6FEnLflv81Hz+Fxg: folds
BcqgegiOUxmBD3F3umsljg collected $2 from pot
*** SUMMARY ***
Total pot $2 | Rake $0
Seat 1: OLplZF6FEnLflv81Hz+Fxg (big blind) folded before Flop
Seat 2: BcqgegiOUxmBD3F3umsljg (button) (small blind) collected ($2)



PokerStars Game #59940501288:  Hold'em No Limit ($0.50/$1.00) - 2009/07/01 1:08:26 ET
Table 'VOs36P6NW+QyXeQ1B62kmA' 6-max Seat #2 is the button
Seat 1: Z2fXsGcjl+Eax+RzOgwOmg ($100 in chips)
Seat 2: 2UMlbaZ8n8AbRli0Yr0mDw ($44.10 in chips)
Seat 4: w02zQzNydODiyV9THKgo9w ($42.05 in chips)
Seat 5: ozrlafxxh1HmYdA0/h+MuA ($44.40 in chips)
Seat 6: slVKuQyEz8Qj4E3uLPYNXg ($98.50 in chips)
w02zQzNydODiyV9THKgo9w: posts small blind $0.50
ozrlafxxh1HmYdA0/h+MuA: posts big blind $1
*** HOLE CARDS ***
slVKuQyEz8Qj4E3uLPYNXg: folds
Z2fXsGcjl+Eax+RzOgwOmg: folds
2UMlbaZ8n8AbRli0Yr0mDw: raises $2 to $3
w02zQzNydODiyV9THKgo9w: calls $2.50
ozrlafxxh1HmYdA0/h+MuA: calls $2
*** FLOP *** [5h 3s 7c]
TSuRyAHnUPCFjP7Z0rEE0w leaves the table
w02zQzNydODiyV9THKgo9w: bets $6
FyNUCpzHVyQu/qX8pqNQFA joins the table at seat #3
ozrlafxxh1HmYdA0/h+MuA: folds
2UMlbaZ8n8AbRli0Yr0mDw: folds
w02zQzNydODiyV9THKgo9w collected $8.55 from pot
*** SUMMARY ***
Total pot $9 | Rake $0.45
Board [5h 3s 7c]
Seat 1: Z2fXsGcjl+Eax+RzOgwOmg folded before Flop (didn't bet)
Seat 2: 2UMlbaZ8n8AbRli0Yr0mDw (button) folded on the Flop
Seat 4: w02zQzNydODiyV9THKgo9w (small blind) collected ($8.55)
Seat 5: ozrlafxxh1HmYdA0/h+MuA (big blind) folded on the Flop
Seat 6: slVKuQyEz8Qj4E3uLPYNXg folded before Flop (didn't bet)



PokerStars Game #59940501974:  Hold'em No Limit ($0.50/$1.00) - 2009/07/01 1:08:27 ET
Table '+cA8mcmhaedZ7YcrDdhmeQ' 6-max Seat #6 is the button
Seat 1: lsLuWlcPA3Rh7kJVLzMh0Q ($299.95 in chips)
Seat 2: RqgF7gRoKgRNW8Zoi1ty4A ($131.75 in chips)
Seat 4: 4OO5v3AVduL0tePNx8wk5A ($109.55 in chips)
Seat 5: +7hFKAL0b0O/n8G72TclJA ($136.20 in chips)
Seat 6: YfsTQsY/fxb+YqbdclTHuw ($17.10 in chips)
lsLuWlcPA3Rh7kJVLzMh0Q: posts small blind $0.50
RqgF7gRoKgRNW8Zoi1ty4A: posts big blind $1
DAIgyIWbYvAkL6PbAI27pg: sits out
*** HOLE CARDS ***
4OO5v3AVduL0tePNx8wk5A: folds
+7hFKAL0b0O/n8G72TclJA: folds
YfsTQsY/fxb+YqbdclTHuw: folds
lsLuWlcPA3Rh7kJVLzMh0Q: raises $2 to $3
RqgF7gRoKgRNW8Zoi1ty4A: folds
lsLuWlcPA3Rh7kJVLzMh0Q collected $2 from pot
*** SUMMARY ***
Total pot $2 | Rake $0
Seat 1: lsLuWlcPA3Rh7kJVLzMh0Q (small blind) collected ($2)
Seat 2: RqgF7gRoKgRNW8Zoi1ty4A (big blind) folded before Flop
Seat 4: 4OO5v3AVduL0tePNx8wk5A folded before Flop (didn't bet)
Seat 5: +7hFKAL0b0O/n8G72TclJA folded before Flop (didn't bet)
Seat 6: YfsTQsY/fxb+YqbdclTHuw (button) folded before Flop (didn't bet)



PokerStars Game #59940502104:  Hold'em No Limit ($0.50/$1.00) - 2009/07/01 1:08:27 ET
Table 'rmZfTK+oSebeUPJNbWhdAA' 6-max Seat #3 is the button
Seat 1: xAU6q2/cwmby2sxmA8VcmA ($148.50 in chips)
Seat 2: z7O9PO/WEcqRouIydFhS9Q ($135.40 in chips)
Seat 3: BCEV3COoKY607AzLWayfRA ($132.50 in chips)
Seat 4: 1/mIuXfgx1ZyVkodrmfQDw ($100 in chips)
Seat 5: 5lY8d6Cnm4HUkt/8FZSj4g ($90.25 in chips)
Seat 6: j7NIOHLZk7V2o9fOioO5ug ($104.80 in chips)
1/mIuXfgx1ZyVkodrmfQDw: posts small blind $0.50
5lY8d6Cnm4HUkt/8FZSj4g: posts big blind $1
*** HOLE CARDS ***
j7NIOHLZk7V2o9fOioO5ug: folds
xAU6q2/cwmby2sxmA8VcmA: folds
z7O9PO/WEcqRouIydFhS9Q: folds
BCEV3COoKY607AzLWayfRA: folds
1/mIuXfgx1ZyVkodrmfQDw: raises $2 to $3
5lY8d6Cnm4HUkt/8FZSj4g: calls $2
*** FLOP *** [Ac 6d 7c]
1/mIuXfgx1ZyVkodrmfQDw: checks
5lY8d6Cnm4HUkt/8FZSj4g: bets $3
1/mIuXfgx1ZyVkodrmfQDw: folds
5lY8d6Cnm4HUkt/8FZSj4g collected $5.70 from pot
5lY8d6Cnm4HUkt/8FZSj4g: doesn't show hand
*** SUMMARY ***
Total pot $6 | Rake $0.30
Board [Ac 6d 7c]
Seat 1: xAU6q2/cwmby2sxmA8VcmA folded before Flop (didn't bet)
Seat 2: z7O9PO/WEcqRouIydFhS9Q folded before Flop (didn't bet)
Seat 3: BCEV3COoKY607AzLWayfRA (button) folded before Flop (didn't bet)
Seat 4: 1/mIuXfgx1ZyVkodrmfQDw (small blind) folded on the Flop
Seat 5: 5lY8d6Cnm4HUkt/8FZSj4g (big blind) collected ($5.70)
Seat 6: j7NIOHLZk7V2o9fOioO5ug folded before Flop (didn't bet)



PokerStars Game #59940501960:  Hold'em No Limit ($0.50/$1.00) - 2009/07/01 1:08:27 ET
Table 'GxCPo/gd3OSthkYrAxJngg' 6-max Seat #5 is the button
Seat 1: sH8BpAFP+jGFxCgVpD1Lew ($268.40 in chips)
Seat 2: YExX2paeIHrmfIwV1ivM/w ($70.60 in chips)
Seat 3: o6plE+MSW4XFNTeONe16xg ($18.60 in chips)
Seat 4: YMJG+F++3Aj6P8dAWda5fw ($202.25 in chips)
Seat 5: G5ZSSN6RSON3gkNvk/SmYg ($116.10 in chips)
Seat 6: 4d1rWhpu8DzLmzMbR3QKyA ($103.20 in chips)
4d1rWhpu8DzLmzMbR3QKyA: posts small blind $0.50
sH8BpAFP+jGFxCgVpD1Lew: posts big blind $1
*** HOLE CARDS ***
YExX2paeIHrmfIwV1ivM/w: folds
o6plE+MSW4XFNTeONe16xg: calls $1
YExX2paeIHrmfIwV1ivM/w is sitting out
YMJG+F++3Aj6P8dAWda5fw: folds
G5ZSSN6RSON3gkNvk/SmYg: folds
4d1rWhpu8DzLmzMbR3QKyA: folds
sH8BpAFP+jGFxCgVpD1Lew: checks
*** FLOP *** [7h Ah 2h]
sH8BpAFP+jGFxCgVpD1Lew: checks
o6plE+MSW4XFNTeONe16xg: checks
*** TURN *** [7h Ah 2h] [7s]
sH8BpAFP+jGFxCgVpD1Lew: checks
o6plE+MSW4XFNTeONe16xg: bets $1
sH8BpAFP+jGFxCgVpD1Lew: folds
o6plE+MSW4XFNTeONe16xg collected $2.40 from pot
*** SUMMARY ***
Total pot $2.50 | Rake $0.10
Board [7h Ah 2h 7s]
Seat 1: sH8BpAFP+jGFxCgVpD1Lew (big blind) folded on the Turn
Seat 2: YExX2paeIHrmfIwV1ivM/w folded before Flop (didn't bet)
Seat 3: o6plE+MSW4XFNTeONe16xg collected ($2.40)
Seat 4: YMJG+F++3Aj6P8dAWda5fw folded before Flop (didn't bet)
Seat 5: G5ZSSN6RSON3gkNvk/SmYg (button) folded before Flop (didn't bet)
Seat 6: 4d1rWhpu8DzLmzMbR3QKyA (small blind) folded before Flop



PokerStars Game #59940503290:  Hold'em No Limit ($0.50/$1.00) - 2009/07/01 1:08:29 ET
Table '6YvsYDPNIDx2v5z3bJnwZQ' 9-max Seat #4 is the button
Seat 1: Ogn4JDV3mp4ZDKO49IFzKA ($21.20 in chips)
Seat 2: +hHqYgKILitkxIzFNGvvsA ($31.75 in chips)
Seat 4: kEr5NYB+JIG5+szcYMr6hA ($43.80 in chips)
Seat 5: mBRWbnUl8diyBO1qTJaNzw ($161.20 in chips)
Seat 6: 7RSwrjMohkYrZAhOd1uaZg ($11.20 in chips)
Seat 7: mae7OMTaJ/MFimNbZegCkg ($47.30 in chips)
Seat 8: PSFxpXgPedVZyHSu2Zhb7Q ($121.65 in chips)
Seat 9: yZYrOeNDxQxkzpbgKX1bng ($29 in chips)
mBRWbnUl8diyBO1qTJaNzw: posts small blind $0.50
7RSwrjMohkYrZAhOd1uaZg: posts big blind $1
yZYrOeNDxQxkzpbgKX1bng: posts big blind $1
K6OJDis3KfxSm/PKlkATUA: sits out
*** HOLE CARDS ***
mae7OMTaJ/MFimNbZegCkg: folds
PSFxpXgPedVZyHSu2Zhb7Q: folds
yZYrOeNDxQxkzpbgKX1bng: checks
Ogn4JDV3mp4ZDKO49IFzKA: folds
+hHqYgKILitkxIzFNGvvsA: calls $1
kEr5NYB+JIG5+szcYMr6hA: folds
mBRWbnUl8diyBO1qTJaNzw: folds
7RSwrjMohkYrZAhOd1uaZg: checks
*** FLOP *** [3h 9c 9d]
7RSwrjMohkYrZAhOd1uaZg: bets $1
yZYrOeNDxQxkzpbgKX1bng: folds
+hHqYgKILitkxIzFNGvvsA: folds
7RSwrjMohkYrZAhOd1uaZg collected $3.35 from pot
*** SUMMARY ***
Total pot $3.50 | Rake $0.15
Board [3h 9c 9d]
Seat 1: Ogn4JDV3mp4ZDKO49IFzKA folded before Flop (didn't bet)
Seat 2: +hHqYgKILitkxIzFNGvvsA folded on the Flop
Seat 4: kEr5NYB+JIG5+szcYMr6hA (button) folded before Flop (didn't bet)
Seat 5: mBRWbnUl8diyBO1qTJaNzw (small blind) folded before Flop
Seat 6: 7RSwrjMohkYrZAhOd1uaZg (big blind) collected ($3.35)
Seat 7: mae7OMTaJ/MFimNbZegCkg folded before Flop (didn't bet)
Seat 8: PSFxpXgPedVZyHSu2Zhb7Q folded before Flop (didn't bet)
Seat 9: yZYrOeNDxQxkzpbgKX1bng folded on the Flop



PokerStars Game #59940504416:  Hold'em No Limit ($0.50/$1.00) - 2009/07/01 1:08:31 ET
Table 'QSIig7BLMc9wY/rgBechzw' 6-max Seat #5 is the button
Seat 1: Z2fXsGcjl+Eax+RzOgwOmg ($107 in chips)
Seat 2: mLOIkH/qmRa+mVujQIhBRg ($40.10 in chips)
Seat 3: +xW7QemQU0Fxs+4TnqBRow ($100 in chips)
Seat 4: +uSzP8Jwnw7sKfQ4s66b7w ($83.45 in chips)
Seat 5: lsLuWlcPA3Rh7kJVLzMh0Q ($101 in chips)
Seat 6: PxqfkAMdAWtkgbT+q2gciA ($39.75 in chips)
PxqfkAMdAWtkgbT+q2gciA: posts small blind $0.50
Z2fXsGcjl+Eax+RzOgwOmg: posts big blind $1
*** HOLE CARDS ***
mLOIkH/qmRa+mVujQIhBRg: folds
+xW7QemQU0Fxs+4TnqBRow: folds
+uSzP8Jwnw7sKfQ4s66b7w: raises $2 to $3
lsLuWlcPA3Rh7kJVLzMh0Q: folds
PxqfkAMdAWtkgbT+q2gciA: calls $2.50
Z2fXsGcjl+Eax+RzOgwOmg: raises $11 to $14
+uSzP8Jwnw7sKfQ4s66b7w: folds
PxqfkAMdAWtkgbT+q2gciA: folds
Z2fXsGcjl+Eax+RzOgwOmg collected $9 from pot
Z2fXsGcjl+Eax+RzOgwOmg: doesn't show hand
*** SUMMARY ***
Total pot $9 | Rake $0
Seat 1: Z2fXsGcjl+Eax+RzOgwOmg (big blind) collected ($9)
Seat 2: mLOIkH/qmRa+mVujQIhBRg folded before Flop (didn't bet)
Seat 3: +xW7QemQU0Fxs+4TnqBRow folded before Flop (didn't bet)
Seat 4: +uSzP8Jwnw7sKfQ4s66b7w folded before Flop
Seat 5: lsLuWlcPA3Rh7kJVLzMh0Q (button) folded before Flop (didn't bet)
Seat 6: PxqfkAMdAWtkgbT+q2gciA (small blind) folded before Flop



PokerStars Game #59940504214:  Hold'em No Limit ($0.50/$1.00) - 2009/07/01 1:08:31 ET
Table 'N2bNCDHL96aCQDvZIh+yQQ' 6-max Seat #4 is the button
Seat 2: TIB5eSBJLz62w6yz2+yeKw ($89 in chips)
Seat 3: Qy/UBNbD2HaA0Ogxg8Sf3w ($237 in chips)
Seat 4: uCqEjnxh2/vFBjKYkfTOkw ($197.95 in chips)
Seat 5: 8OEJHwpMpZZfyaTpXEDFfw ($26.15 in chips)
8OEJHwpMpZZfyaTpXEDFfw: posts small blind $0.50
TIB5eSBJLz62w6yz2+yeKw: posts big blind $1
*** HOLE CARDS ***
Qy/UBNbD2HaA0Ogxg8Sf3w: folds
TSuRyAHnUPCFjP7Z0rEE0w leaves the table
uCqEjnxh2/vFBjKYkfTOkw: folds
8OEJHwpMpZZfyaTpXEDFfw: calls $0.50
TIB5eSBJLz62w6yz2+yeKw: checks
*** FLOP *** [5d 5s Js]
8OEJHwpMpZZfyaTpXEDFfw: checks
TIB5eSBJLz62w6yz2+yeKw: checks
*** TURN *** [5d 5s Js] [7s]
8OEJHwpMpZZfyaTpXEDFfw: checks
TIB5eSBJLz62w6yz2+yeKw: checks
*** RIVER *** [5d 5s Js 7s] [Ks]
8OEJHwpMpZZfyaTpXEDFfw: bets $4
TIB5eSBJLz62w6yz2+yeKw: folds
8OEJHwpMpZZfyaTpXEDFfw collected $1.90 from pot
*** SUMMARY ***
Total pot $2 | Rake $0.10
Board [5d 5s Js 7s Ks]
Seat 2: TIB5eSBJLz62w6yz2+yeKw (big blind) folded on the River
Seat 3: Qy/UBNbD2HaA0Ogxg8Sf3w folded before Flop (didn't bet)
Seat 4: uCqEjnxh2/vFBjKYkfTOkw (button) folded before Flop (didn't bet)
Seat 5: 8OEJHwpMpZZfyaTpXEDFfw (small blind) collected ($1.90)



PokerStars Game #59940505526:  Hold'em No Limit ($0.50/$1.00) - 2009/07/01 1:08:33 ET
Table 'fZjVbKj9D8yOB+Rj7NaP/A' 9-max Seat #7 is the button
Seat 1: Oh57946S8OPACStkrhQm7g ($67 in chips)
Seat 2: PTAFYDIUSsG+SArbxNl+Aw ($113.50 in chips)
Seat 3: yAbu2QsRPVcjPbqlf/jDxw ($104 in chips)
Seat 5: PkGfq5xrSlNsujKaG/HF4Q ($101.50 in chips)
Seat 6: OvwYHV65yUbgdBjSmo1+5g ($29.90 in chips)
Seat 7: SyS20PAm3RpT6uLBsGkwOA ($113.25 in chips)
Seat 9: qheQay5YvP2DMAb3OUSxtw ($99 in chips)
qheQay5YvP2DMAb3OUSxtw: posts small blind $0.50
Oh57946S8OPACStkrhQm7g: posts big blind $1
997ViqAtWn1FPjJqcffwcA: sits out
*** HOLE CARDS ***
PTAFYDIUSsG+SArbxNl+Aw: folds
yAbu2QsRPVcjPbqlf/jDxw: folds
PkGfq5xrSlNsujKaG/HF4Q: folds
OvwYHV65yUbgdBjSmo1+5g: raises $2 to $3
SyS20PAm3RpT6uLBsGkwOA: folds
qheQay5YvP2DMAb3OUSxtw: folds
Oh57946S8OPACStkrhQm7g: calls $2
*** FLOP *** [6h 6s Ad]
Oh57946S8OPACStkrhQm7g: checks
OvwYHV65yUbgdBjSmo1+5g: bets $3
Oh57946S8OPACStkrhQm7g: folds
OvwYHV65yUbgdBjSmo1+5g collected $6.20 from pot
*** SUMMARY ***
Total pot $6.50 | Rake $0.30
Board [6h 6s Ad]
Seat 1: Oh57946S8OPACStkrhQm7g (big blind) folded on the Flop
Seat 2: PTAFYDIUSsG+SArbxNl+Aw folded before Flop (didn't bet)
Seat 3: yAbu2QsRPVcjPbqlf/jDxw folded before Flop (didn't bet)
Seat 5: PkGfq5xrSlNsujKaG/HF4Q folded before Flop (didn't bet)
Seat 6: OvwYHV65yUbgdBjSmo1+5g collected ($6.20)
Seat 7: SyS20PAm3RpT6uLBsGkwOA (button) folded before Flop (didn't bet)
Seat 9: qheQay5YvP2DMAb3OUSxtw (small blind) folded before Flop



PokerStars Game #59940506822:  Hold'em No Limit ($0.50/$1.00) - 2009/07/01 1:08:35 ET
Table 'cBDNutyLBKEk9+ptwsKmTw' 6-max Seat #2 is the button
Seat 1: xAU6q2/cwmby2sxmA8VcmA ($120 in chips)
Seat 2: 5lY8d6Cnm4HUkt/8FZSj4g ($33 in chips)
Seat 3: G5ZSSN6RSON3gkNvk/SmYg ($100 in chips)
Seat 4: 3q7F5QtzC30pSrn0nl9i+A ($25.30 in chips)
Seat 5: OGMLOcTNYZXZU81au7ztUw ($165.40 in chips)
Seat 6: NqVlOSH2lp+pp/TK3vvK5g ($87.15 in chips)
G5ZSSN6RSON3gkNvk/SmYg: posts small blind $0.50
3q7F5QtzC30pSrn0nl9i+A: posts big blind $1
*** HOLE CARDS ***
OGMLOcTNYZXZU81au7ztUw: folds
NqVlOSH2lp+pp/TK3vvK5g: calls $1
xAU6q2/cwmby2sxmA8VcmA: raises $4 to $5
5lY8d6Cnm4HUkt/8FZSj4g: folds
G5ZSSN6RSON3gkNvk/SmYg: folds
3q7F5QtzC30pSrn0nl9i+A: folds
NqVlOSH2lp+pp/TK3vvK5g: calls $4
*** FLOP *** [Kd Th Ts]
NqVlOSH2lp+pp/TK3vvK5g: bets $1
xAU6q2/cwmby2sxmA8VcmA: raises $11 to $12
NqVlOSH2lp+pp/TK3vvK5g: folds
xAU6q2/cwmby2sxmA8VcmA collected $12.90 from pot
xAU6q2/cwmby2sxmA8VcmA: doesn't show hand
*** SUMMARY ***
Total pot $13.50 | Rake $0.60
Board [Kd Th Ts]
Seat 1: xAU6q2/cwmby2sxmA8VcmA collected ($12.90)
Seat 2: 5lY8d6Cnm4HUkt/8FZSj4g (button) folded before Flop (didn't bet)
Seat 3: G5ZSSN6RSON3gkNvk/SmYg (small blind) folded before Flop
Seat 4: 3q7F5QtzC30pSrn0nl9i+A (big blind) folded before Flop
Seat 5: OGMLOcTNYZXZU81au7ztUw folded before Flop (didn't bet)
Seat 6: NqVlOSH2lp+pp/TK3vvK5g folded on the Flop



PokerStars Game #59940506456:  Hold'em No Limit ($0.50/$1.00) - 2009/07/01 1:08:35 ET
Table 'JTT1XWaDZHSaMZQK7cR5uw' 2-max Seat #1 is the button
Seat 1: OLplZF6FEnLflv81Hz+Fxg ($123.45 in chips)
Seat 2: BcqgegiOUxmBD3F3umsljg ($83.15 in chips)
OLplZF6FEnLflv81Hz+Fxg: posts small blind $0.50
BcqgegiOUxmBD3F3umsljg: posts big blind $1
*** HOLE CARDS ***
OLplZF6FEnLflv81Hz+Fxg: raises $2 to $3
BcqgegiOUxmBD3F3umsljg: raises $2 to $5
OLplZF6FEnLflv81Hz+Fxg: calls $2
*** FLOP *** [Jh Qd 2c]
BcqgegiOUxmBD3F3umsljg: bets $3
OLplZF6FEnLflv81Hz+Fxg: raises $6 to $9
BcqgegiOUxmBD3F3umsljg: folds
OLplZF6FEnLflv81Hz+Fxg collected $15.50 from pot
*** SUMMARY ***
Total pot $16 | Rake $0.50
Board [Jh Qd 2c]
Seat 1: OLplZF6FEnLflv81Hz+Fxg (button) (small blind) collected ($15.50)
Seat 2: BcqgegiOUxmBD3F3umsljg (big blind) folded on the Flop



PokerStars Game #59940506760:  Hold'em No Limit ($0.50/$1.00) - 2009/07/01 1:08:35 ET
Table 'fTlPiCj0utgzC/5io+I7ew' 6-max Seat #2 is the button
Seat 1: YMJG+F++3Aj6P8dAWda5fw ($102.85 in chips)
Seat 2: Qy/UBNbD2HaA0Ogxg8Sf3w ($128.60 in chips)
Seat 3: Z2fXsGcjl+Eax+RzOgwOmg ($100 in chips)
Seat 4: uJVSceLggtsrJya+WtmUEA ($187.15 in chips)
Seat 6: /P4w1pHg2zHYg/4ubJ0dPw ($67.55 in chips)
Z2fXsGcjl+Eax+RzOgwOmg: posts small blind $0.50
uJVSceLggtsrJya+WtmUEA: posts big blind $1
*** HOLE CARDS ***
/P4w1pHg2zHYg/4ubJ0dPw: folds
YMJG+F++3Aj6P8dAWda5fw: folds
Qy/UBNbD2HaA0Ogxg8Sf3w: folds
Z2fXsGcjl+Eax+RzOgwOmg: raises $2 to $3
uJVSceLggtsrJya+WtmUEA: folds
Z2fXsGcjl+Eax+RzOgwOmg collected $2 from pot
*** SUMMARY ***
Total pot $2 | Rake $0
Seat 1: YMJG+F++3Aj6P8dAWda5fw folded before Flop (didn't bet)
Seat 2: Qy/UBNbD2HaA0Ogxg8Sf3w (button) folded before Flop (didn't bet)
Seat 3: Z2fXsGcjl+Eax+RzOgwOmg (small blind) collected ($2)
Seat 4: uJVSceLggtsrJya+WtmUEA (big blind) folded before Flop
Seat 6: /P4w1pHg2zHYg/4ubJ0dPw folded before Flop (didn't bet)



PokerStars Game #59940507298:  Hold'em No Limit ($0.50/$1.00) - 2009/07/01 1:08:36 ET
Table 'pHrhryH8jPNdQfY62f8v+g' 6-max Seat #3 is the button
Seat 2: RqgF7gRoKgRNW8Zoi1ty4A ($141 in chips)
Seat 3: 8oS5O7iD/qnFXFXJrGIgNQ ($100 in chips)
Seat 4: 1f3beyIML24UqEMTbWy93g ($52.70 in chips)
Seat 5: r1/R7y0Ortgoz4lccgW8VA ($41.05 in chips)
Seat 6: xAU6q2/cwmby2sxmA8VcmA ($208.10 in chips)
1f3beyIML24UqEMTbWy93g: posts small blind $0.50
r1/R7y0Ortgoz4lccgW8VA: posts big blind $1
4d1rWhpu8DzLmzMbR3QKyA: sits out
*** HOLE CARDS ***
xAU6q2/cwmby2sxmA8VcmA: folds
RqgF7gRoKgRNW8Zoi1ty4A: folds
8oS5O7iD/qnFXFXJrGIgNQ: folds
1f3beyIML24UqEMTbWy93g: raises $2 to $3
r1/R7y0Ortgoz4lccgW8VA: calls $2
*** FLOP *** [Qs Td Js]
1f3beyIML24UqEMTbWy93g: bets $3
r1/R7y0Ortgoz4lccgW8VA: calls $3
*** TURN *** [Qs Td Js] [Ah]
1f3beyIML24UqEMTbWy93g: checks
r1/R7y0Ortgoz4lccgW8VA: checks
*** RIVER *** [Qs Td Js Ah] [2h]
1f3beyIML24UqEMTbWy93g: checks
r1/R7y0Ortgoz4lccgW8VA: checks
*** SHOW DOWN ***
1f3beyIML24UqEMTbWy93g: shows [Tc Ts] (three of a kind, Tens)
r1/R7y0Ortgoz4lccgW8VA: mucks hand
1f3beyIML24UqEMTbWy93g collected $11.45 from pot
*** SUMMARY ***
Total pot $12 | Rake $0.55
Board [Qs Td Js Ah 2h]
Seat 2: RqgF7gRoKgRNW8Zoi1ty4A folded before Flop (didn't bet)
Seat 3: 8oS5O7iD/qnFXFXJrGIgNQ (button) folded before Flop (didn't bet)
Seat 4: 1f3beyIML24UqEMTbWy93g (small blind) showed [Tc Ts] and won ($11.45) with three of a kind, Tens
Seat 5: r1/R7y0Ortgoz4lccgW8VA (big blind) mucked
Seat 6: xAU6q2/cwmby2sxmA8VcmA folded before Flop (didn't bet)



PokerStars Game #59940508540:  Hold'em No Limit ($0.50/$1.00) - 2009/07/01 1:08:38 ET
Table 'GPp0HyAuggN8oE0sUWzPpA' 9-max Seat #6 is the button
Seat 1: qJr25HAtvv1w/7IBvjMM3g ($42.70 in chips)
Seat 2: m3U8I35Pn3gxKhoS2nmYIg ($38.05 in chips)
Seat 3: CCCXsirC+bO7ginAuUUVlQ ($49.35 in chips)
Seat 4: mBRWbnUl8diyBO1qTJaNzw ($107.65 in chips)
Seat 6: BK/GtNPkSx0TdUDj82id5A ($16.35 in chips)
Seat 7: DHdbHyysD15wCAtx+BhUjA ($94 in chips)
Seat 8: 6DBvLniKMJADk/t5l29oMA ($25.15 in chips)
Seat 9: dzoSjPZmtjGuK83119030A ($34.15 in chips)
DHdbHyysD15wCAtx+BhUjA: posts small blind $0.50
6DBvLniKMJADk/t5l29oMA: posts big blind $1
bLbSOSmSOnqE0iTcH/5dxA: sits out
*** HOLE CARDS ***
dzoSjPZmtjGuK83119030A: folds
qJr25HAtvv1w/7IBvjMM3g: folds
m3U8I35Pn3gxKhoS2nmYIg: raises $2 to $3
CCCXsirC+bO7ginAuUUVlQ: folds
mBRWbnUl8diyBO1qTJaNzw: folds
BK/GtNPkSx0TdUDj82id5A: folds
DHdbHyysD15wCAtx+BhUjA: folds
6DBvLniKMJADk/t5l29oMA: folds
m3U8I35Pn3gxKhoS2nmYIg collected $2.50 from pot
*** SUMMARY ***
Total pot $2.50 | Rake $0
Seat 1: qJr25HAtvv1w/7IBvjMM3g folded before Flop (didn't bet)
Seat 2: m3U8I35Pn3gxKhoS2nmYIg collected ($2.50)
Seat 3: CCCXsirC+bO7ginAuUUVlQ folded before Flop (didn't bet)
Seat 4: mBRWbnUl8diyBO1qTJaNzw folded before Flop (didn't bet)
Seat 6: BK/GtNPkSx0TdUDj82id5A (button) folded before Flop (didn't bet)
Seat 7: DHdbHyysD15wCAtx+BhUjA (small blind) folded before Flop
Seat 8: 6DBvLniKMJADk/t5l29oMA (big blind) folded before Flop
Seat 9: dzoSjPZmtjGuK83119030A folded before Flop (didn't bet)



PokerStars Game #59940510272:  Hold'em No Limit ($0.50/$1.00) - 2009/07/01 1:08:41 ET
Table '3T4owEKJKyGTMePwrv50FQ' 9-max Seat #5 is the button
Seat 1: OGgaARGdJQT4awWVNQ957w ($101.10 in chips)
Seat 2: t+Id2O6herCLgwnC4m49PA ($38.60 in chips)
Seat 3: DOLzOcBTZYcph5jEfKFWuQ ($105.50 in chips)
Seat 4: O5Go3jrzbQWxRB6ESK+Ptg ($30.10 in chips)
Seat 5: eI48VADSCFoNZBx4T9qs2w ($31.85 in chips)
Seat 6: laA8va+Yv8WuMqT1zdR91g ($100 in chips)
Seat 7: 1862487932 ($103 in chips)
Seat 9: 61sfw5QTu62YYIt68OsdrA ($66.95 in chips)
laA8va+Yv8WuMqT1zdR91g: posts small blind $0.50
1862487932: posts big blind $1
ucTB8uAUcQnKGsA70OSjNA: sits out
*** HOLE CARDS ***
61sfw5QTu62YYIt68OsdrA: folds
OGgaARGdJQT4awWVNQ957w: folds
t+Id2O6herCLgwnC4m49PA: folds
DOLzOcBTZYcph5jEfKFWuQ: folds
O5Go3jrzbQWxRB6ESK+Ptg: folds
eI48VADSCFoNZBx4T9qs2w: folds
laA8va+Yv8WuMqT1zdR91g: folds
1862487932 collected $1 from pot
1862487932: doesn't show hand
*** SUMMARY ***
Total pot $1 | Rake $0
Seat 1: OGgaARGdJQT4awWVNQ957w folded before Flop (didn't bet)
Seat 2: t+Id2O6herCLgwnC4m49PA folded before Flop (didn't bet)
Seat 3: DOLzOcBTZYcph5jEfKFWuQ folded before Flop (didn't bet)
Seat 4: O5Go3jrzbQWxRB6ESK+Ptg folded before Flop (didn't bet)
Seat 5: eI48VADSCFoNZBx4T9qs2w (button) folded before Flop (didn't bet)
Seat 6: laA8va+Yv8WuMqT1zdR91g (small blind) folded before Flop
Seat 7: 1862487932 (big blind) collected ($1)
Seat 9: 61sfw5QTu62YYIt68OsdrA folded before Flop (didn't bet)



PokerStars Game #59940512016:  Hold'em No Limit ($0.50/$1.00) - 2009/07/01 1:08:44 ET
Table 'hdVBCnDy5t2X9dZo0AvD9w' 9-max Seat #4 is the button
Seat 1: sa/cZBFh73L9TapFXpn3BA ($68.10 in chips)
Seat 2: Ogn4JDV3mp4ZDKO49IFzKA ($18.50 in chips)
Seat 3: 1862487932 ($100 in chips)
Seat 4: YvSugbFKWSuAYx9iokQwUQ ($70 in chips)
Seat 5: H+DVy3Ei8L1UKS2tVOtJcw ($100 in chips)
Seat 6: bJckevFOcg//s0qyMQI6sQ ($101.50 in chips)
Seat 7: KqC3XiX79XzqwhoOYPVb4w ($164.55 in chips)
Seat 8: gUUvmqdVlmvpal6B8nYrmg ($140.90 in chips)
Seat 9: AMkLbywdoc0K30BTzaIfTQ ($187.90 in chips)
H+DVy3Ei8L1UKS2tVOtJcw: posts small blind $0.50
bJckevFOcg//s0qyMQI6sQ: posts big blind $1
*** HOLE CARDS ***
KqC3XiX79XzqwhoOYPVb4w: folds
gUUvmqdVlmvpal6B8nYrmg: folds
AMkLbywdoc0K30BTzaIfTQ: folds
sa/cZBFh73L9TapFXpn3BA: raises $1 to $2
Ogn4JDV3mp4ZDKO49IFzKA: raises $16.50 to $18.50 and is all-in
1862487932: folds
YvSugbFKWSuAYx9iokQwUQ: folds
H+DVy3Ei8L1UKS2tVOtJcw: folds
bJckevFOcg//s0qyMQI6sQ: folds
sa/cZBFh73L9TapFXpn3BA: folds
Ogn4JDV3mp4ZDKO49IFzKA collected $5.50 from pot
*** SUMMARY ***
Total pot $5.50 | Rake $0
Seat 1: sa/cZBFh73L9TapFXpn3BA folded before Flop
Seat 2: Ogn4JDV3mp4ZDKO49IFzKA collected ($5.50)
Seat 3: 1862487932 folded before Flop (didn't bet)
Seat 4: YvSugbFKWSuAYx9iokQwUQ (button) folded before Flop (didn't bet)
Seat 5: H+DVy3Ei8L1UKS2tVOtJcw (small blind) folded before Flop
Seat 6: bJckevFOcg//s0qyMQI6sQ (big blind) folded before Flop
Seat 7: KqC3XiX79XzqwhoOYPVb4w folded before Flop (didn't bet)
Seat 8: gUUvmqdVlmvpal6B8nYrmg folded before Flop (didn't bet)
Seat 9: AMkLbywdoc0K30BTzaIfTQ folded before Flop (didn't bet)



PokerStars Game #59940513862:  Hold'em No Limit ($0.50/$1.00) - 2009/07/01 1:08:47 ET
Table 'O96CPOtvMBWP6kzuYDfdFA' 6-max Seat #5 is the button
Seat 1: 6alLXQIITA2EZ/lBeym8Dw ($126.05 in chips)
Seat 4: /P4w1pHg2zHYg/4ubJ0dPw ($62.05 in chips)
Seat 5: G5ZSSN6RSON3gkNvk/SmYg ($100 in chips)
Seat 6: GYei5jXGWexiJYbAT2fELg ($38.05 in chips)
GYei5jXGWexiJYbAT2fELg: posts small blind $0.50
6alLXQIITA2EZ/lBeym8Dw: posts big blind $1
4d1rWhpu8DzLmzMbR3QKyA: sits out
*** HOLE CARDS ***
/P4w1pHg2zHYg/4ubJ0dPw: folds
G5ZSSN6RSON3gkNvk/SmYg: folds
GYei5jXGWexiJYbAT2fELg: raises $2 to $3
6alLXQIITA2EZ/lBeym8Dw: calls $2
*** FLOP *** [5h 3h Qs]
GYei5jXGWexiJYbAT2fELg: checks
6alLXQIITA2EZ/lBeym8Dw: bets $3
GYei5jXGWexiJYbAT2fELg: calls $3
*** TURN *** [5h 3h Qs] [5s]
GYei5jXGWexiJYbAT2fELg: checks
6alLXQIITA2EZ/lBeym8Dw: checks
*** RIVER *** [5h 3h Qs 5s] [4d]
GYei5jXGWexiJYbAT2fELg: checks
6alLXQIITA2EZ/lBeym8Dw: checks
*** SHOW DOWN ***
GYei5jXGWexiJYbAT2fELg: shows [As Kd] (a pair of Fives)
6alLXQIITA2EZ/lBeym8Dw: mucks hand
GYei5jXGWexiJYbAT2fELg collected $11.45 from pot
*** SUMMARY ***
Total pot $12 | Rake $0.55
Board [5h 3h Qs 5s 4d]
Seat 1: 6alLXQIITA2EZ/lBeym8Dw (big blind) mucked
Seat 4: /P4w1pHg2zHYg/4ubJ0dPw folded before Flop (didn't bet)
Seat 5: G5ZSSN6RSON3gkNvk/SmYg (button) folded before Flop (didn't bet)
Seat 6: GYei5jXGWexiJYbAT2fELg (small blind) showed [As Kd] and won ($11.45) with a pair of Fives



PokerStars Game #59940513506:  Hold'em No Limit ($0.50/$1.00) - 2009/07/01 1:08:47 ET
Table 'vs/5jr6ciwjVQ5+Soc+u2A' 6-max Seat #1 is the button
Seat 1: /P4w1pHg2zHYg/4ubJ0dPw ($60.30 in chips)
Seat 2: lXX4W7m3u++JiSOZ46yVMQ ($114.70 in chips)
Seat 3: G5ZSSN6RSON3gkNvk/SmYg ($155.35 in chips)
Seat 4: wk6Ohn4GDozoOMHc4eb2rw ($79.15 in chips)
Seat 5: +Nt3OPk3XR9SKjZgm2CexQ ($107.45 in chips)
Seat 6: Z2fXsGcjl+Eax+RzOgwOmg ($100 in chips)
lXX4W7m3u++JiSOZ46yVMQ: posts small blind $0.50
G5ZSSN6RSON3gkNvk/SmYg: posts big blind $1
*** HOLE CARDS ***
wk6Ohn4GDozoOMHc4eb2rw: folds
+Nt3OPk3XR9SKjZgm2CexQ: raises $2 to $3
Z2fXsGcjl+Eax+RzOgwOmg: folds
/P4w1pHg2zHYg/4ubJ0dPw: folds
lXX4W7m3u++JiSOZ46yVMQ: folds
G5ZSSN6RSON3gkNvk/SmYg: folds
+Nt3OPk3XR9SKjZgm2CexQ collected $2.50 from pot
+Nt3OPk3XR9SKjZgm2CexQ: doesn't show hand
*** SUMMARY ***
Total pot $2.50 | Rake $0
Seat 1: /P4w1pHg2zHYg/4ubJ0dPw (button) folded before Flop (didn't bet)
Seat 2: lXX4W7m3u++JiSOZ46yVMQ (small blind) folded before Flop
Seat 3: G5ZSSN6RSON3gkNvk/SmYg (big blind) folded before Flop
Seat 4: wk6Ohn4GDozoOMHc4eb2rw folded before Flop (didn't bet)
Seat 5: +Nt3OPk3XR9SKjZgm2CexQ collected ($2.50)
Seat 6: Z2fXsGcjl+Eax+RzOgwOmg folded before Flop (didn't bet)



PokerStars Game #59940514340:  Hold'em No Limit ($0.50/$1.00) - 2009/07/01 1:08:48 ET
Table 'MUPc8FEpe/nR0BKSeReX6Q' 6-max Seat #1 is the button
Seat 1: qhkK6+yCciTRd+rCFEbnEQ ($41.70 in chips)
Seat 2: xAU6q2/cwmby2sxmA8VcmA ($115.20 in chips)
Seat 3: wx3sQGkVi2x9wJXuWNHPBw ($235.95 in chips)
Seat 4: ZA1bp6g8IwtTxkUE4eCjDQ ($195.15 in chips)
Seat 5: UBZQqpnJZdTYYY1FTb0rLA ($100 in chips)
Seat 6: oxnw0GLLpFanjhGkxfRSqA ($30.50 in chips)
xAU6q2/cwmby2sxmA8VcmA: posts small blind $0.50
wx3sQGkVi2x9wJXuWNHPBw: posts big blind $1
*** HOLE CARDS ***
ZA1bp6g8IwtTxkUE4eCjDQ: folds
UBZQqpnJZdTYYY1FTb0rLA: folds
oxnw0GLLpFanjhGkxfRSqA: raises $4 to $5
qhkK6+yCciTRd+rCFEbnEQ: folds
xAU6q2/cwmby2sxmA8VcmA: folds
wx3sQGkVi2x9wJXuWNHPBw: calls $4
*** FLOP *** [3d Js 7s]
wx3sQGkVi2x9wJXuWNHPBw: checks
oxnw0GLLpFanjhGkxfRSqA: bets $12
wx3sQGkVi2x9wJXuWNHPBw: raises $14 to $26
oxnw0GLLpFanjhGkxfRSqA: calls $13.50 and is all-in
*** TURN *** [3d Js 7s] [5c]
*** RIVER *** [3d Js 7s 5c] [2c]
*** SHOW DOWN ***
wx3sQGkVi2x9wJXuWNHPBw: shows [As Jd] (a pair of Jacks)
oxnw0GLLpFanjhGkxfRSqA: shows [Ks Kc] (a pair of Kings)
oxnw0GLLpFanjhGkxfRSqA collected $58.50 from pot
*** SUMMARY ***
Total pot $61.50 | Rake $3
Board [3d Js 7s 5c 2c]
Seat 1: qhkK6+yCciTRd+rCFEbnEQ (button) folded before Flop (didn't bet)
Seat 2: xAU6q2/cwmby2sxmA8VcmA (small blind) folded before Flop
Seat 3: wx3sQGkVi2x9wJXuWNHPBw (big blind) showed [As Jd] and lost with a pair of Jacks
Seat 4: ZA1bp6g8IwtTxkUE4eCjDQ folded before Flop (didn't bet)
Seat 5: UBZQqpnJZdTYYY1FTb0rLA folded before Flop (didn't bet)
Seat 6: oxnw0GLLpFanjhGkxfRSqA showed [Ks Kc] and won ($58.50) with a pair of Kings



PokerStars Game #59940514716:  Hold'em No Limit ($0.50/$1.00) - 2009/07/01 1:08:49 ET
Table '7O9fB8yx1u7sJveJn8w6jA' 6-max Seat #1 is the button
Seat 1: jy52+7FotjH63o5tEEVgKw ($91.85 in chips)
Seat 2: wx3sQGkVi2x9wJXuWNHPBw ($186.95 in chips)
Seat 3: hpxXcmRkXXI9HE5+5/j/0Q ($104.20 in chips)
Seat 5: BCEV3COoKY607AzLWayfRA ($116 in chips)
wx3sQGkVi2x9wJXuWNHPBw: posts small blind $0.50
hpxXcmRkXXI9HE5+5/j/0Q: posts big blind $1
*** HOLE CARDS ***
b2a+5TkFf4xJN/Ihhma58Q joins the table at seat #4
BCEV3COoKY607AzLWayfRA: raises $3 to $4
jy52+7FotjH63o5tEEVgKw: calls $4
wx3sQGkVi2x9wJXuWNHPBw: folds
hpxXcmRkXXI9HE5+5/j/0Q: folds
*** FLOP *** [7c 7h Ts]
BCEV3COoKY607AzLWayfRA: checks
jy52+7FotjH63o5tEEVgKw: checks
*** TURN *** [7c 7h Ts] [9s]
BCEV3COoKY607AzLWayfRA: bets $6
jy52+7FotjH63o5tEEVgKw: folds
BCEV3COoKY607AzLWayfRA collected $9.05 from pot
BCEV3COoKY607AzLWayfRA: doesn't show hand
*** SUMMARY ***
Total pot $9.50 | Rake $0.45
Board [7c 7h Ts 9s]
Seat 1: jy52+7FotjH63o5tEEVgKw (button) folded on the Turn
Seat 2: wx3sQGkVi2x9wJXuWNHPBw (small blind) folded before Flop
Seat 3: hpxXcmRkXXI9HE5+5/j/0Q (big blind) folded before Flop
Seat 5: BCEV3COoKY607AzLWayfRA collected ($9.05)



PokerStars Game #59940517118:  Hold'em No Limit ($0.50/$1.00) - 2009/07/01 1:08:53 ET
Table 'eU3bWpDDg3Z+9R4m4iVmog' 6-max Seat #4 is the button
Seat 2: 8CAoOzhmB8n3nRFf3V4BTg ($89.95 in chips)
Seat 3: rVMOzU7w5FddYPGhD7qN2Q ($38.15 in chips)
Seat 4: GDVIsbEJ/DOJsMKE4Asz0A ($93.75 in chips)
Seat 6: hpxXcmRkXXI9HE5+5/j/0Q ($121.85 in chips)
hpxXcmRkXXI9HE5+5/j/0Q: posts small blind $0.50
8CAoOzhmB8n3nRFf3V4BTg: posts big blind $1
*** HOLE CARDS ***
rVMOzU7w5FddYPGhD7qN2Q: folds
GDVIsbEJ/DOJsMKE4Asz0A: folds
hpxXcmRkXXI9HE5+5/j/0Q: raises $3 to $4
8CAoOzhmB8n3nRFf3V4BTg: folds
hpxXcmRkXXI9HE5+5/j/0Q collected $2 from pot
hpxXcmRkXXI9HE5+5/j/0Q: doesn't show hand
*** SUMMARY ***
Total pot $2 | Rake $0
Seat 2: 8CAoOzhmB8n3nRFf3V4BTg (big blind) folded before Flop
Seat 3: rVMOzU7w5FddYPGhD7qN2Q folded before Flop (didn't bet)
Seat 4: GDVIsbEJ/DOJsMKE4Asz0A (button) folded before Flop (didn't bet)
Seat 6: hpxXcmRkXXI9HE5+5/j/0Q (small blind) collected ($2)



PokerStars Game #59940518172:  Hold'em No Limit ($0.50/$1.00) - 2009/07/01 1:08:54 ET
Table '+cA8mcmhaedZ7YcrDdhmeQ' 6-max Seat #1 is the button
Seat 1: lsLuWlcPA3Rh7kJVLzMh0Q ($300.95 in chips)
Seat 2: RqgF7gRoKgRNW8Zoi1ty4A ($130.75 in chips)
Seat 3: DAIgyIWbYvAkL6PbAI27pg ($20 in chips)
Seat 4: 4OO5v3AVduL0tePNx8wk5A ($109.55 in chips)
Seat 5: +7hFKAL0b0O/n8G72TclJA ($136.20 in chips)
Seat 6: YfsTQsY/fxb+YqbdclTHuw ($17.10 in chips)
RqgF7gRoKgRNW8Zoi1ty4A: posts small blind $0.50
DAIgyIWbYvAkL6PbAI27pg: posts big blind $1
*** HOLE CARDS ***
4OO5v3AVduL0tePNx8wk5A: folds
+7hFKAL0b0O/n8G72TclJA: folds
YfsTQsY/fxb+YqbdclTHuw: folds
lsLuWlcPA3Rh7kJVLzMh0Q: raises $2 to $3
RqgF7gRoKgRNW8Zoi1ty4A: folds
DAIgyIWbYvAkL6PbAI27pg: folds
lsLuWlcPA3Rh7kJVLzMh0Q collected $2.50 from pot
*** SUMMARY ***
Total pot $2.50 | Rake $0
Seat 1: lsLuWlcPA3Rh7kJVLzMh0Q (button) collected ($2.50)
Seat 2: RqgF7gRoKgRNW8Zoi1ty4A (small blind) folded before Flop
Seat 3: DAIgyIWbYvAkL6PbAI27pg (big blind) folded before Flop
Seat 4: 4OO5v3AVduL0tePNx8wk5A folded before Flop (didn't bet)
Seat 5: +7hFKAL0b0O/n8G72TclJA folded before Flop (didn't bet)
Seat 6: YfsTQsY/fxb+YqbdclTHuw folded before Flop (didn't bet)



PokerStars Game #59940518520:  Hold'em No Limit ($0.50/$1.00) - 2009/07/01 1:08:55 ET
Table 'QSIig7BLMc9wY/rgBechzw' 6-max Seat #6 is the button
Seat 1: Z2fXsGcjl+Eax+RzOgwOmg ($113 in chips)
Seat 2: mLOIkH/qmRa+mVujQIhBRg ($40.10 in chips)
Seat 3: +xW7QemQU0Fxs+4TnqBRow ($100 in chips)
Seat 4: +uSzP8Jwnw7sKfQ4s66b7w ($80.45 in chips)
Seat 5: lsLuWlcPA3Rh7kJVLzMh0Q ($101 in chips)
Seat 6: PxqfkAMdAWtkgbT+q2gciA ($36.75 in chips)
Z2fXsGcjl+Eax+RzOgwOmg: posts small blind $0.50
mLOIkH/qmRa+mVujQIhBRg: posts big blind $1
*** HOLE CARDS ***
+xW7QemQU0Fxs+4TnqBRow: folds
+uSzP8Jwnw7sKfQ4s66b7w: folds
lsLuWlcPA3Rh7kJVLzMh0Q: folds
PxqfkAMdAWtkgbT+q2gciA: folds
Z2fXsGcjl+Eax+RzOgwOmg: folds
mLOIkH/qmRa+mVujQIhBRg collected $1 from pot
*** SUMMARY ***
Total pot $1 | Rake $0
Seat 1: Z2fXsGcjl+Eax+RzOgwOmg (small blind) folded before Flop
Seat 2: mLOIkH/qmRa+mVujQIhBRg (big blind) collected ($1)
Seat 3: +xW7QemQU0Fxs+4TnqBRow folded before Flop (didn't bet)
Seat 4: +uSzP8Jwnw7sKfQ4s66b7w folded before Flop (didn't bet)
Seat 5: lsLuWlcPA3Rh7kJVLzMh0Q folded before Flop (didn't bet)
Seat 6: PxqfkAMdAWtkgbT+q2gciA (button) folded before Flop (didn't bet)



PokerStars Game #59940518586:  Hold'em No Limit ($0.50/$1.00) - 2009/07/01 1:08:55 ET
Table 'CASNP0uy1C+jGLml/I4PtA' 9-max Seat #3 is the button
Seat 1: tkdBeXTJlFsZdioidNqLow ($60 in chips)
Seat 3: bJckevFOcg//s0qyMQI6sQ ($100.90 in chips)
Seat 4: B/G0GJacqZ8K59/ZVdq4kQ ($54.20 in chips)
Seat 5: Jjc7EHWzs4//xUAjJ0UWoA ($14.50 in chips)
Seat 6: FJEywSpo5JbRKByzmweboA ($101.50 in chips)
Seat 8: L9njYvloJ1NdXjP8edHEAg ($100 in chips)
Seat 9: Pp/KTcXkfZKKUHkjyaLTdg ($20 in chips)
B/G0GJacqZ8K59/ZVdq4kQ: posts small blind $0.50
Jjc7EHWzs4//xUAjJ0UWoA: posts big blind $1
*** HOLE CARDS ***
FJEywSpo5JbRKByzmweboA: folds
S3Ex8K7v6xm5jqjRM7Fl3w joins the table at seat #7
L9njYvloJ1NdXjP8edHEAg: folds
Pp/KTcXkfZKKUHkjyaLTdg: folds
tkdBeXTJlFsZdioidNqLow: folds
bJckevFOcg//s0qyMQI6sQ: folds
B/G0GJacqZ8K59/ZVdq4kQ: calls $0.50
Jjc7EHWzs4//xUAjJ0UWoA: checks
*** FLOP *** [2h Kc Qc]
B/G0GJacqZ8K59/ZVdq4kQ: bets $2
Jjc7EHWzs4//xUAjJ0UWoA: folds
B/G0GJacqZ8K59/ZVdq4kQ collected $1.90 from pot
B/G0GJacqZ8K59/ZVdq4kQ: doesn't show hand
*** SUMMARY ***
Total pot $2 | Rake $0.10
Board [2h Kc Qc]
Seat 1: tkdBeXTJlFsZdioidNqLow folded before Flop (didn't bet)
Seat 3: bJckevFOcg//s0qyMQI6sQ (button) folded before Flop (didn't bet)
Seat 4: B/G0GJacqZ8K59/ZVdq4kQ (small blind) collected ($1.90)
Seat 5: Jjc7EHWzs4//xUAjJ0UWoA (big blind) folded on the Flop
Seat 6: FJEywSpo5JbRKByzmweboA folded before Flop (didn't bet)
Seat 8: L9njYvloJ1NdXjP8edHEAg folded before Flop (didn't bet)
Seat 9: Pp/KTcXkfZKKUHkjyaLTdg folded before Flop (didn't bet)



PokerStars Game #59940519380:  Hold'em No Limit ($0.50/$1.00) - 2009/07/01 1:08:56 ET
Table 'VOs36P6NW+QyXeQ1B62kmA' 6-max Seat #4 is the button
Seat 1: Z2fXsGcjl+Eax+RzOgwOmg ($100 in chips)
Seat 2: 2UMlbaZ8n8AbRli0Yr0mDw ($41.10 in chips)
Seat 4: w02zQzNydODiyV9THKgo9w ($47.60 in chips)
Seat 5: ozrlafxxh1HmYdA0/h+MuA ($41.40 in chips)
Seat 6: slVKuQyEz8Qj4E3uLPYNXg ($98.50 in chips)
ozrlafxxh1HmYdA0/h+MuA: posts small blind $0.50
slVKuQyEz8Qj4E3uLPYNXg: posts big blind $1
FyNUCpzHVyQu/qX8pqNQFA: sits out
*** HOLE CARDS ***
Z2fXsGcjl+Eax+RzOgwOmg: raises $3 to $4
2UMlbaZ8n8AbRli0Yr0mDw: folds
w02zQzNydODiyV9THKgo9w: folds
ozrlafxxh1HmYdA0/h+MuA: folds
slVKuQyEz8Qj4E3uLPYNXg: folds
Z2fXsGcjl+Eax+RzOgwOmg collected $2.50 from pot
Z2fXsGcjl+Eax+RzOgwOmg: doesn't show hand
*** SUMMARY ***
Total pot $2.50 | Rake $0
Seat 1: Z2fXsGcjl+Eax+RzOgwOmg collected ($2.50)
Seat 2: 2UMlbaZ8n8AbRli0Yr0mDw folded before Flop (didn't bet)
Seat 4: w02zQzNydODiyV9THKgo9w (button) folded before Flop (didn't bet)
Seat 5: ozrlafxxh1HmYdA0/h+MuA (small blind) folded before Flop
Seat 6: slVKuQyEz8Qj4E3uLPYNXg (big blind) folded before Flop



PokerStars Game #59940521352:  Hold'em No Limit ($0.50/$1.00) - 2009/07/01 1:09:00 ET
Table 'kS0cTQAEi+fdUlJP2gQYvw' 9-max Seat #7 is the button
Seat 1: c/9X4zftzphFxYtxp5kp9w ($64.35 in chips)
Seat 2: D+W9Me7w6Hcx/WRUSKV0dw ($22.40 in chips)
Seat 3: 2BV+oJIQYr65IO6nEChvbA ($60 in chips)
Seat 5: 997ViqAtWn1FPjJqcffwcA ($102.65 in chips)
Seat 6: yAbu2QsRPVcjPbqlf/jDxw ($125.15 in chips)
Seat 7: Ffa7Nj4X5fddtROP01hfQg ($153.25 in chips)
Seat 9: OGgaARGdJQT4awWVNQ957w ($102 in chips)
OGgaARGdJQT4awWVNQ957w: posts small blind $0.50
c/9X4zftzphFxYtxp5kp9w: posts big blind $1
*** HOLE CARDS ***
D+W9Me7w6Hcx/WRUSKV0dw: folds
QYMfy2FoN6/Qe1LWYuI7fw leaves the table
2BV+oJIQYr65IO6nEChvbA: folds
997ViqAtWn1FPjJqcffwcA: folds
yAbu2QsRPVcjPbqlf/jDxw: raises $3 to $4
Ffa7Nj4X5fddtROP01hfQg: folds
OGgaARGdJQT4awWVNQ957w: folds
c/9X4zftzphFxYtxp5kp9w: folds
yAbu2QsRPVcjPbqlf/jDxw collected $2.50 from pot
yAbu2QsRPVcjPbqlf/jDxw: doesn't show hand
*** SUMMARY ***
Total pot $2.50 | Rake $0
Seat 1: c/9X4zftzphFxYtxp5kp9w (big blind) folded before Flop
Seat 2: D+W9Me7w6Hcx/WRUSKV0dw folded before Flop (didn't bet)
Seat 3: 2BV+oJIQYr65IO6nEChvbA folded before Flop (didn't bet)
Seat 5: 997ViqAtWn1FPjJqcffwcA folded before Flop (didn't bet)
Seat 6: yAbu2QsRPVcjPbqlf/jDxw collected ($2.50)
Seat 7: Ffa7Nj4X5fddtROP01hfQg (button) folded before Flop (didn't bet)
Seat 9: OGgaARGdJQT4awWVNQ957w (small blind) folded before Flop



PokerStars Game #59940522630:  Hold'em No Limit ($0.50/$1.00) - 2009/07/01 1:09:01 ET
Table 'N2bNCDHL96aCQDvZIh+yQQ' 6-max Seat #5 is the button
Seat 2: TIB5eSBJLz62w6yz2+yeKw ($88 in chips)
Seat 3: Qy/UBNbD2HaA0Ogxg8Sf3w ($237 in chips)
Seat 4: uCqEjnxh2/vFBjKYkfTOkw ($197.95 in chips)
Seat 5: 8OEJHwpMpZZfyaTpXEDFfw ($27.05 in chips)
TIB5eSBJLz62w6yz2+yeKw: posts small blind $0.50
Qy/UBNbD2HaA0Ogxg8Sf3w: posts big blind $1
*** HOLE CARDS ***
uCqEjnxh2/vFBjKYkfTOkw: folds
8OEJHwpMpZZfyaTpXEDFfw: calls $1
TIB5eSBJLz62w6yz2+yeKw: raises $3 to $4
Qy/UBNbD2HaA0Ogxg8Sf3w: folds
8OEJHwpMpZZfyaTpXEDFfw: calls $3
*** FLOP *** [2h Td Ks]
TIB5eSBJLz62w6yz2+yeKw: checks
8OEJHwpMpZZfyaTpXEDFfw: bets $6
TIB5eSBJLz62w6yz2+yeKw: calls $6
*** TURN *** [2h Td Ks] [2c]
TIB5eSBJLz62w6yz2+yeKw: checks
8OEJHwpMpZZfyaTpXEDFfw: bets $7
TIB5eSBJLz62w6yz2+yeKw: calls $7
*** RIVER *** [2h Td Ks 2c] [Js]
TIB5eSBJLz62w6yz2+yeKw: checks
8OEJHwpMpZZfyaTpXEDFfw: checks
*** SHOW DOWN ***
TIB5eSBJLz62w6yz2+yeKw: shows [Kh Kc] (a full house, Kings full of Deuces)
8OEJHwpMpZZfyaTpXEDFfw: mucks hand
TIB5eSBJLz62w6yz2+yeKw collected $33.30 from pot
*** SUMMARY ***
Total pot $35 | Rake $1.70
Board [2h Td Ks 2c Js]
Seat 2: TIB5eSBJLz62w6yz2+yeKw (small blind) showed [Kh Kc] and won ($33.30) with a full house, Kings full of Deuces
Seat 3: Qy/UBNbD2HaA0Ogxg8Sf3w (big blind) folded before Flop
Seat 4: uCqEjnxh2/vFBjKYkfTOkw folded before Flop (didn't bet)
Seat 5: 8OEJHwpMpZZfyaTpXEDFfw (button) mucked



PokerStars Game #59940522774:  Hold'em No Limit ($0.50/$1.00) - 2009/07/01 1:09:01 ET
Table 'SQLOQoANiHscJ8AL7zffbw' 9-max Seat #4 is the button
Seat 1: jPTRd6SpCp4xqAy2XQiTOw ($67.90 in chips)
Seat 2: /zy+DB4S5fUQUSfZWFzYGw ($329.90 in chips)
Seat 3: 0eFnow7+D7veCYQ+CG9FFw ($95.50 in chips)
Seat 4: /mfensKw8/iZ1Vrx33S4xg ($20 in chips)
Seat 5: L9njYvloJ1NdXjP8edHEAg ($108.15 in chips)
Seat 6: H+DVy3Ei8L1UKS2tVOtJcw ($100 in chips)
Seat 7: bJckevFOcg//s0qyMQI6sQ ($104.55 in chips)
Seat 8: 2BV+oJIQYr65IO6nEChvbA ($60 in chips)
Seat 9: qJr25HAtvv1w/7IBvjMM3g ($200.15 in chips)
jPTRd6SpCp4xqAy2XQiTOw said, "post the blind"
jPTRd6SpCp4xqAy2XQiTOw said, "see what i mean"
/mfensKw8/iZ1Vrx33S4xg said, "lol"
L9njYvloJ1NdXjP8edHEAg: posts small blind $0.50
H+DVy3Ei8L1UKS2tVOtJcw: posts big blind $1
*** HOLE CARDS ***
bJckevFOcg//s0qyMQI6sQ: folds
2BV+oJIQYr65IO6nEChvbA: folds
qJr25HAtvv1w/7IBvjMM3g: folds
jPTRd6SpCp4xqAy2XQiTOw said, "gonna be a long nioght"
jPTRd6SpCp4xqAy2XQiTOw has timed out
jPTRd6SpCp4xqAy2XQiTOw: folds
jPTRd6SpCp4xqAy2XQiTOw is sitting out
jPTRd6SpCp4xqAy2XQiTOw has returned
/zy+DB4S5fUQUSfZWFzYGw: folds
0eFnow7+D7veCYQ+CG9FFw: folds
/mfensKw8/iZ1Vrx33S4xg: raises $2 to $3
jPTRd6SpCp4xqAy2XQiTOw said, "gonna use my time next hand"
L9njYvloJ1NdXjP8edHEAg: folds
H+DVy3Ei8L1UKS2tVOtJcw: folds
/mfensKw8/iZ1Vrx33S4xg collected $2.50 from pot
*** SUMMARY ***
Total pot $2.50 | Rake $0
Seat 1: jPTRd6SpCp4xqAy2XQiTOw folded before Flop (didn't bet)
Seat 2: /zy+DB4S5fUQUSfZWFzYGw folded before Flop (didn't bet)
Seat 3: 0eFnow7+D7veCYQ+CG9FFw folded before Flop (didn't bet)
Seat 4: /mfensKw8/iZ1Vrx33S4xg (button) collected ($2.50)
Seat 5: L9njYvloJ1NdXjP8edHEAg (small blind) folded before Flop
Seat 6: H+DVy3Ei8L1UKS2tVOtJcw (big blind) folded before Flop
Seat 7: bJckevFOcg//s0qyMQI6sQ folded before Flop (didn't bet)
Seat 8: 2BV+oJIQYr65IO6nEChvbA folded before Flop (didn't bet)
Seat 9: qJr25HAtvv1w/7IBvjMM3g folded before Flop (didn't bet)



PokerStars Game #59940524170:  Hold'em No Limit ($0.50/$1.00) - 2009/07/01 1:09:04 ET
Table 'vs/5jr6ciwjVQ5+Soc+u2A' 6-max Seat #2 is the button
Seat 1: /P4w1pHg2zHYg/4ubJ0dPw ($60.30 in chips)
Seat 2: lXX4W7m3u++JiSOZ46yVMQ ($114.20 in chips)
Seat 3: G5ZSSN6RSON3gkNvk/SmYg ($154.35 in chips)
Seat 4: wk6Ohn4GDozoOMHc4eb2rw ($79.15 in chips)
Seat 5: +Nt3OPk3XR9SKjZgm2CexQ ($108.95 in chips)
Seat 6: Z2fXsGcjl+Eax+RzOgwOmg ($100 in chips)
G5ZSSN6RSON3gkNvk/SmYg: posts small blind $0.50
wk6Ohn4GDozoOMHc4eb2rw: posts big blind $1
*** HOLE CARDS ***
+Nt3OPk3XR9SKjZgm2CexQ: folds
Z2fXsGcjl+Eax+RzOgwOmg: folds
/P4w1pHg2zHYg/4ubJ0dPw: raises $2.50 to $3.50
lXX4W7m3u++JiSOZ46yVMQ: folds
G5ZSSN6RSON3gkNvk/SmYg: calls $3
wk6Ohn4GDozoOMHc4eb2rw: calls $2.50
*** FLOP *** [6s 4s 3s]
G5ZSSN6RSON3gkNvk/SmYg: checks
wk6Ohn4GDozoOMHc4eb2rw: checks
/P4w1pHg2zHYg/4ubJ0dPw: bets $7.50
G5ZSSN6RSON3gkNvk/SmYg: calls $7.50
wk6Ohn4GDozoOMHc4eb2rw: folds
*** TURN *** [6s 4s 3s] [Tc]
G5ZSSN6RSON3gkNvk/SmYg: checks
/P4w1pHg2zHYg/4ubJ0dPw: bets $18
G5ZSSN6RSON3gkNvk/SmYg: calls $18
*** RIVER *** [6s 4s 3s Tc] [As]
G5ZSSN6RSON3gkNvk/SmYg: checks
/P4w1pHg2zHYg/4ubJ0dPw: checks
*** SHOW DOWN ***
G5ZSSN6RSON3gkNvk/SmYg: shows [9d 9s] (a flush, Ace high)
/P4w1pHg2zHYg/4ubJ0dPw: shows [Td Ts] (a flush, Ace high - Ten higher)
/P4w1pHg2zHYg/4ubJ0dPw collected $58.50 from pot
*** SUMMARY ***
Total pot $61.50 | Rake $3
Board [6s 4s 3s Tc As]
Seat 1: /P4w1pHg2zHYg/4ubJ0dPw showed [Td Ts] and won ($58.50) with a flush, Ace high
Seat 2: lXX4W7m3u++JiSOZ46yVMQ (button) folded before Flop (didn't bet)
Seat 3: G5ZSSN6RSON3gkNvk/SmYg (small blind) showed [9d 9s] and lost with a flush, Ace high
Seat 4: wk6Ohn4GDozoOMHc4eb2rw (big blind) folded on the Flop
Seat 5: +Nt3OPk3XR9SKjZgm2CexQ folded before Flop (didn't bet)
Seat 6: Z2fXsGcjl+Eax+RzOgwOmg folded before Flop (didn't bet)



PokerStars Game #59940524908:  Hold'em No Limit ($0.50/$1.00) - 2009/07/01 1:09:05 ET
Table 'eU3bWpDDg3Z+9R4m4iVmog' 6-max Seat #6 is the button
Seat 2: 8CAoOzhmB8n3nRFf3V4BTg ($88.95 in chips)
Seat 3: rVMOzU7w5FddYPGhD7qN2Q ($38.15 in chips)
Seat 4: GDVIsbEJ/DOJsMKE4Asz0A ($93.75 in chips)
Seat 6: hpxXcmRkXXI9HE5+5/j/0Q ($122.85 in chips)
8CAoOzhmB8n3nRFf3V4BTg: posts small blind $0.50
rVMOzU7w5FddYPGhD7qN2Q: posts big blind $1
*** HOLE CARDS ***
GDVIsbEJ/DOJsMKE4Asz0A: folds
hpxXcmRkXXI9HE5+5/j/0Q: folds
8CAoOzhmB8n3nRFf3V4BTg: raises $2 to $3
rVMOzU7w5FddYPGhD7qN2Q: folds
8CAoOzhmB8n3nRFf3V4BTg collected $2 from pot
*** SUMMARY ***
Total pot $2 | Rake $0
Seat 2: 8CAoOzhmB8n3nRFf3V4BTg (small blind) collected ($2)
Seat 3: rVMOzU7w5FddYPGhD7qN2Q (big blind) folded before Flop
Seat 4: GDVIsbEJ/DOJsMKE4Asz0A folded before Flop (didn't bet)
Seat 6: hpxXcmRkXXI9HE5+5/j/0Q (button) folded before Flop (didn't bet)



PokerStars Game #59940525272:  Hold'em No Limit ($0.50/$1.00) - 2009/07/01 1:09:06 ET
Table 'fTlPiCj0utgzC/5io+I7ew' 6-max Seat #3 is the button
Seat 1: YMJG+F++3Aj6P8dAWda5fw ($102.85 in chips)
Seat 2: Qy/UBNbD2HaA0Ogxg8Sf3w ($128.60 in chips)
Seat 3: Z2fXsGcjl+Eax+RzOgwOmg ($101 in chips)
Seat 4: uJVSceLggtsrJya+WtmUEA ($186.15 in chips)
Seat 6: /P4w1pHg2zHYg/4ubJ0dPw ($67.55 in chips)
uJVSceLggtsrJya+WtmUEA: posts small blind $0.50
/P4w1pHg2zHYg/4ubJ0dPw: posts big blind $1
*** HOLE CARDS ***
YMJG+F++3Aj6P8dAWda5fw: folds
Qy/UBNbD2HaA0Ogxg8Sf3w: folds
Z2fXsGcjl+Eax+RzOgwOmg: raises $2 to $3
uJVSceLggtsrJya+WtmUEA: folds
/P4w1pHg2zHYg/4ubJ0dPw: folds
Z2fXsGcjl+Eax+RzOgwOmg collected $2.50 from pot
*** SUMMARY ***
Total pot $2.50 | Rake $0
Seat 1: YMJG+F++3Aj6P8dAWda5fw folded before Flop (didn't bet)
Seat 2: Qy/UBNbD2HaA0Ogxg8Sf3w folded before Flop (didn't bet)
Seat 3: Z2fXsGcjl+Eax+RzOgwOmg (button) collected ($2.50)
Seat 4: uJVSceLggtsrJya+WtmUEA (small blind) folded before Flop
Seat 6: /P4w1pHg2zHYg/4ubJ0dPw (big blind) folded before Flop



PokerStars Game #59940525400:  Hold'em No Limit ($0.50/$1.00) - 2009/07/01 1:09:06 ET
Table 'mmbQQVBTrPdE+wy+s+9VPA' 6-max Seat #4 is the button
Seat 1: zyP4SPoWZnKUfTvIRLCVog ($71.55 in chips)
Seat 3: wx3sQGkVi2x9wJXuWNHPBw ($111.15 in chips)
Seat 4: V3iZdcw61nXF3g5hD2RrsQ ($119.20 in chips)
Seat 5: YMJG+F++3Aj6P8dAWda5fw ($104.10 in chips)
Seat 6: U2CWBTv29qdCbj8RNF2sIw ($100 in chips)
YMJG+F++3Aj6P8dAWda5fw: posts small blind $0.50
U2CWBTv29qdCbj8RNF2sIw: posts big blind $1
XK4Qsl+DA8gAJyg85/zBIw: sits out
*** HOLE CARDS ***
zyP4SPoWZnKUfTvIRLCVog: folds
wx3sQGkVi2x9wJXuWNHPBw: folds
V3iZdcw61nXF3g5hD2RrsQ: raises $2 to $3
YMJG+F++3Aj6P8dAWda5fw: folds
U2CWBTv29qdCbj8RNF2sIw: calls $2
*** FLOP *** [3h Js Tc]
U2CWBTv29qdCbj8RNF2sIw: checks
V3iZdcw61nXF3g5hD2RrsQ: bets $4
U2CWBTv29qdCbj8RNF2sIw: folds
V3iZdcw61nXF3g5hD2RrsQ collected $6.20 from pot
V3iZdcw61nXF3g5hD2RrsQ: doesn't show hand
*** SUMMARY ***
Total pot $6.50 | Rake $0.30
Board [3h Js Tc]
Seat 1: zyP4SPoWZnKUfTvIRLCVog folded before Flop (didn't bet)
Seat 3: wx3sQGkVi2x9wJXuWNHPBw folded before Flop (didn't bet)
Seat 4: V3iZdcw61nXF3g5hD2RrsQ (button) collected ($6.20)
Seat 5: YMJG+F++3Aj6P8dAWda5fw (small blind) folded before Flop
Seat 6: U2CWBTv29qdCbj8RNF2sIw (big blind) folded on the Flop



PokerStars Game #59940525468:  Hold'em No Limit ($0.50/$1.00) - 2009/07/01 1:09:06 ET
Table 'hugOjcwJvzEwZbK7tyiWuQ' 9-max Seat #8 is the button
Seat 2: r27C1nIV4NS4+qbnrgBQSw ($283.20 in chips)
Seat 3: jDwhY1kCdc6EkAHbT7PJMQ ($104.75 in chips)
Seat 4: UWB3oeddt/GObx2Mix2Anw ($178 in chips)
Seat 5: 5BRGWf+R3nt2WS3b5xX+zA ($16.75 in chips)
Seat 6: gUUvmqdVlmvpal6B8nYrmg ($103.90 in chips)
Seat 7: FL3MrLspcF23LYvC4ipBOA ($110.30 in chips)
Seat 8: /zy+DB4S5fUQUSfZWFzYGw ($100 in chips)
Seat 9: W8P9bUKCs43TO1xHm0dL6w ($89.95 in chips)
W8P9bUKCs43TO1xHm0dL6w: posts small blind $0.50
r27C1nIV4NS4+qbnrgBQSw: posts big blind $1
*** HOLE CARDS ***
jDwhY1kCdc6EkAHbT7PJMQ: folds
UWB3oeddt/GObx2Mix2Anw: raises $2 to $3
5BRGWf+R3nt2WS3b5xX+zA: folds
gUUvmqdVlmvpal6B8nYrmg: folds
FL3MrLspcF23LYvC4ipBOA: folds
S3Ex8K7v6xm5jqjRM7Fl3w joins the table at seat #1
/zy+DB4S5fUQUSfZWFzYGw: raises $6 to $9
W8P9bUKCs43TO1xHm0dL6w: folds
r27C1nIV4NS4+qbnrgBQSw: folds
UWB3oeddt/GObx2Mix2Anw: calls $6
*** FLOP *** [Ks 8d 3d]
UWB3oeddt/GObx2Mix2Anw: checks
/zy+DB4S5fUQUSfZWFzYGw: bets $12
UWB3oeddt/GObx2Mix2Anw: folds
/zy+DB4S5fUQUSfZWFzYGw collected $18.55 from pot
*** SUMMARY ***
Total pot $19.50 | Rake $0.95
Board [Ks 8d 3d]
Seat 2: r27C1nIV4NS4+qbnrgBQSw (big blind) folded before Flop
Seat 3: jDwhY1kCdc6EkAHbT7PJMQ folded before Flop (didn't bet)
Seat 4: UWB3oeddt/GObx2Mix2Anw folded on the Flop
Seat 5: 5BRGWf+R3nt2WS3b5xX+zA folded before Flop (didn't bet)
Seat 6: gUUvmqdVlmvpal6B8nYrmg folded before Flop (didn't bet)
Seat 7: FL3MrLspcF23LYvC4ipBOA folded before Flop (didn't bet)
Seat 8: /zy+DB4S5fUQUSfZWFzYGw (button) collected ($18.55)
Seat 9: W8P9bUKCs43TO1xHm0dL6w (small blind) folded before Flop



PokerStars Game #59940526378:  Hold'em No Limit ($0.50/$1.00) - 2009/07/01 1:09:08 ET
Table 'rmZfTK+oSebeUPJNbWhdAA' 6-max Seat #4 is the button
Seat 1: xAU6q2/cwmby2sxmA8VcmA ($148.50 in chips)
Seat 2: z7O9PO/WEcqRouIydFhS9Q ($135.40 in chips)
Seat 3: BCEV3COoKY607AzLWayfRA ($132.50 in chips)
Seat 4: 1/mIuXfgx1ZyVkodrmfQDw ($100 in chips)
Seat 5: 5lY8d6Cnm4HUkt/8FZSj4g ($92.95 in chips)
Seat 6: j7NIOHLZk7V2o9fOioO5ug ($104.80 in chips)
5lY8d6Cnm4HUkt/8FZSj4g: posts small blind $0.50
j7NIOHLZk7V2o9fOioO5ug: posts big blind $1
*** HOLE CARDS ***
xAU6q2/cwmby2sxmA8VcmA: folds
z7O9PO/WEcqRouIydFhS9Q: folds
BCEV3COoKY607AzLWayfRA: folds
1/mIuXfgx1ZyVkodrmfQDw: folds
5lY8d6Cnm4HUkt/8FZSj4g: calls $0.50
j7NIOHLZk7V2o9fOioO5ug: raises $4 to $5
5lY8d6Cnm4HUkt/8FZSj4g: calls $4
*** FLOP *** [6h Ad 3h]
5lY8d6Cnm4HUkt/8FZSj4g: checks
j7NIOHLZk7V2o9fOioO5ug: bets $7
5lY8d6Cnm4HUkt/8FZSj4g: calls $7
*** TURN *** [6h Ad 3h] [6s]
5lY8d6Cnm4HUkt/8FZSj4g: checks
j7NIOHLZk7V2o9fOioO5ug: bets $17
5lY8d6Cnm4HUkt/8FZSj4g: calls $17
*** RIVER *** [6h Ad 3h 6s] [7s]
5lY8d6Cnm4HUkt/8FZSj4g: checks
j7NIOHLZk7V2o9fOioO5ug: bets $23
5lY8d6Cnm4HUkt/8FZSj4g: folds
j7NIOHLZk7V2o9fOioO5ug collected $55.20 from pot
j7NIOHLZk7V2o9fOioO5ug: doesn't show hand
*** SUMMARY ***
Total pot $58 | Rake $2.80
Board [6h Ad 3h 6s 7s]
Seat 1: xAU6q2/cwmby2sxmA8VcmA folded before Flop (didn't bet)
Seat 2: z7O9PO/WEcqRouIydFhS9Q folded before Flop (didn't bet)
Seat 3: BCEV3COoKY607AzLWayfRA folded before Flop (didn't bet)
Seat 4: 1/mIuXfgx1ZyVkodrmfQDw (button) folded before Flop (didn't bet)
Seat 5: 5lY8d6Cnm4HUkt/8FZSj4g (small blind) folded on the River
Seat 6: j7NIOHLZk7V2o9fOioO5ug (big blind) collected ($55.20)



PokerStars Game #59940527304:  Hold'em No Limit ($0.50/$1.00) - 2009/07/01 1:09:09 ET
Table 'QSIig7BLMc9wY/rgBechzw' 6-max Seat #1 is the button
Seat 1: Z2fXsGcjl+Eax+RzOgwOmg ($112.50 in chips)
Seat 2: mLOIkH/qmRa+mVujQIhBRg ($40.60 in chips)
Seat 3: +xW7QemQU0Fxs+4TnqBRow ($100 in chips)
Seat 4: +uSzP8Jwnw7sKfQ4s66b7w ($80.45 in chips)
Seat 5: lsLuWlcPA3Rh7kJVLzMh0Q ($101 in chips)
Seat 6: PxqfkAMdAWtkgbT+q2gciA ($36.75 in chips)
mLOIkH/qmRa+mVujQIhBRg: posts small blind $0.50
+xW7QemQU0Fxs+4TnqBRow: posts big blind $1
*** HOLE CARDS ***
+uSzP8Jwnw7sKfQ4s66b7w: folds
lsLuWlcPA3Rh7kJVLzMh0Q: folds
PxqfkAMdAWtkgbT+q2gciA: calls $1
Z2fXsGcjl+Eax+RzOgwOmg: raises $4 to $5
mLOIkH/qmRa+mVujQIhBRg: folds
+xW7QemQU0Fxs+4TnqBRow: folds
PxqfkAMdAWtkgbT+q2gciA: folds
Z2fXsGcjl+Eax+RzOgwOmg collected $3.50 from pot
Z2fXsGcjl+Eax+RzOgwOmg: doesn't show hand
*** SUMMARY ***
Total pot $3.50 | Rake $0
Seat 1: Z2fXsGcjl+Eax+RzOgwOmg (button) collected ($3.50)
Seat 2: mLOIkH/qmRa+mVujQIhBRg (small blind) folded before Flop
Seat 3: +xW7QemQU0Fxs+4TnqBRow (big blind) folded before Flop
Seat 4: +uSzP8Jwnw7sKfQ4s66b7w folded before Flop (didn't bet)
Seat 5: lsLuWlcPA3Rh7kJVLzMh0Q folded before Flop (didn't bet)
Seat 6: PxqfkAMdAWtkgbT+q2gciA folded before Flop



PokerStars Game #59940528746:  Hold'em No Limit ($0.50/$1.00) - 2009/07/01 1:09:12 ET
Table 'W/wyObTiXZm+Ckkl3YxcSw' 6-max Seat #4 is the button
Seat 1: eUBBn2R56C1IQ6Cs/vitwg ($180.75 in chips)
Seat 2: oDiBRCaF0QVtd3kO6xZIXw ($151.85 in chips)
Seat 3: dxyNCn/qxfkGDUIf28Cbng ($57.40 in chips)
Seat 4: aYii2DmxlOlbC1wbGRBWvQ ($106.75 in chips)
Seat 5: MFptnnT6AnJakWBooTkmeg ($24.65 in chips)
Seat 6: OGMLOcTNYZXZU81au7ztUw ($100 in chips)
MFptnnT6AnJakWBooTkmeg: posts small blind $0.50
OGMLOcTNYZXZU81au7ztUw: posts big blind $1
*** HOLE CARDS ***
eUBBn2R56C1IQ6Cs/vitwg: folds
oDiBRCaF0QVtd3kO6xZIXw: folds
dxyNCn/qxfkGDUIf28Cbng: folds
aYii2DmxlOlbC1wbGRBWvQ: calls $1
MFptnnT6AnJakWBooTkmeg: calls $0.50
OGMLOcTNYZXZU81au7ztUw: checks
*** FLOP *** [5s 9c 9s]
MFptnnT6AnJakWBooTkmeg: checks
OGMLOcTNYZXZU81au7ztUw: checks
aYii2DmxlOlbC1wbGRBWvQ: checks
*** TURN *** [5s 9c 9s] [Jc]
MFptnnT6AnJakWBooTkmeg: checks
OGMLOcTNYZXZU81au7ztUw: checks
aYii2DmxlOlbC1wbGRBWvQ: bets $2
MFptnnT6AnJakWBooTkmeg: folds
OGMLOcTNYZXZU81au7ztUw: folds
aYii2DmxlOlbC1wbGRBWvQ collected $2.85 from pot
*** SUMMARY ***
Total pot $3 | Rake $0.15
Board [5s 9c 9s Jc]
Seat 1: eUBBn2R56C1IQ6Cs/vitwg folded before Flop (didn't bet)
Seat 2: oDiBRCaF0QVtd3kO6xZIXw folded before Flop (didn't bet)
Seat 3: dxyNCn/qxfkGDUIf28Cbng folded before Flop (didn't bet)
Seat 4: aYii2DmxlOlbC1wbGRBWvQ (button) collected ($2.85)
Seat 5: MFptnnT6AnJakWBooTkmeg (small blind) folded on the Turn
Seat 6: OGMLOcTNYZXZU81au7ztUw (big blind) folded on the Turn



PokerStars Game #59940529484:  Hold'em No Limit ($0.50/$1.00) - 2009/07/01 1:09:13 ET
Table 'tyUh+jyNvrceIQdKMJjQ2wZFWj23PMihdwrNWv41OG/Qeat #5 is the button
Seat 1: o8A5MUdudVKu+pAwgZOX2w ($113.90 in chips)
Seat 2: 5uy3EN+iIYkgwbWZFTUBAQ ($100 in chips)
Seat 3: TalCiLYHCd+ffkmR3auPvA ($144.20 in chips)
Seat 5: j7NIOHLZk7V2o9fOioO5ug ($100 in chips)
Seat 6: 4OO5v3AVduL0tePNx8wk5A ($100 in chips)
4OO5v3AVduL0tePNx8wk5A: posts small blind $0.50
o8A5MUdudVKu+pAwgZOX2w: posts big blind $1
*** HOLE CARDS ***
5uy3EN+iIYkgwbWZFTUBAQ: folds
TalCiLYHCd+ffkmR3auPvA: raises $3 to $4
j7NIOHLZk7V2o9fOioO5ug: folds
4OO5v3AVduL0tePNx8wk5A: folds
o8A5MUdudVKu+pAwgZOX2w: calls $3
*** FLOP *** [7s Jh 2h]
hpxXcmRkXXI9HE5+5/j/0Q joins the table at seat #4
o8A5MUdudVKu+pAwgZOX2w: checks
TalCiLYHCd+ffkmR3auPvA: bets $6
o8A5MUdudVKu+pAwgZOX2w: folds
TalCiLYHCd+ffkmR3auPvA collected $8.10 from pot
TalCiLYHCd+ffkmR3auPvA: doesn't show hand
*** SUMMARY ***
Total pot $8.50 | Rake $0.40
Board [7s Jh 2h]
Seat 1: o8A5MUdudVKu+pAwgZOX2w (big blind) folded on the Flop
Seat 2: 5uy3EN+iIYkgwbWZFTUBAQ folded before Flop (didn't bet)
Seat 3: TalCiLYHCd+ffkmR3auPvA collected ($8.10)
Seat 5: j7NIOHLZk7V2o9fOioO5ug (button) folded before Flop (didn't bet)
Seat 6: 4OO5v3AVduL0tePNx8wk5A (small blind) folded before Flop



PokerStars Game #59940530138:  Hold'em No Limit ($0.50/$1.00) - 2009/07/01 1:09:14 ET
Table '6YvsYDPNIDx2v5z3bJnwZQ' 9-max Seat #5 is the button
Seat 1: Ogn4JDV3mp4ZDKO49IFzKA ($21.20 in chips)
Seat 2: +hHqYgKILitkxIzFNGvvsA ($30.75 in chips)
Seat 4: kEr5NYB+JIG5+szcYMr6hA ($43.80 in chips)
Seat 5: mBRWbnUl8diyBO1qTJaNzw ($160.70 in chips)
Seat 6: 7RSwrjMohkYrZAhOd1uaZg ($13.55 in chips)
Seat 7: mae7OMTaJ/MFimNbZegCkg ($47.30 in chips)
Seat 8: PSFxpXgPedVZyHSu2Zhb7Q ($121.65 in chips)
Seat 9: yZYrOeNDxQxkzpbgKX1bng ($28 in chips)
7RSwrjMohkYrZAhOd1uaZg: posts small blind $0.50
mae7OMTaJ/MFimNbZegCkg: posts big blind $1
K6OJDis3KfxSm/PKlkATUA: sits out
*** HOLE CARDS ***
PSFxpXgPedVZyHSu2Zhb7Q: calls $1
yZYrOeNDxQxkzpbgKX1bng: folds
Ogn4JDV3mp4ZDKO49IFzKA: folds
+hHqYgKILitkxIzFNGvvsA: calls $1
kEr5NYB+JIG5+szcYMr6hA: folds
mBRWbnUl8diyBO1qTJaNzw: folds
7RSwrjMohkYrZAhOd1uaZg: calls $0.50
mae7OMTaJ/MFimNbZegCkg: checks
*** FLOP *** [5c Jc 2h]
7RSwrjMohkYrZAhOd1uaZg: checks
mae7OMTaJ/MFimNbZegCkg: checks
PSFxpXgPedVZyHSu2Zhb7Q: bets $2
+hHqYgKILitkxIzFNGvvsA: folds
7RSwrjMohkYrZAhOd1uaZg: folds
mae7OMTaJ/MFimNbZegCkg: folds
PSFxpXgPedVZyHSu2Zhb7Q collected $3.80 from pot
*** SUMMARY ***
Total pot $4 | Rake $0.20
Board [5c Jc 2h]
Seat 1: Ogn4JDV3mp4ZDKO49IFzKA folded before Flop (didn't bet)
Seat 2: +hHqYgKILitkxIzFNGvvsA folded on the Flop
Seat 4: kEr5NYB+JIG5+szcYMr6hA folded before Flop (didn't bet)
Seat 5: mBRWbnUl8diyBO1qTJaNzw (button) folded before Flop (didn't bet)
Seat 6: 7RSwrjMohkYrZAhOd1uaZg (small blind) folded on the Flop
Seat 7: mae7OMTaJ/MFimNbZegCkg (big blind) folded on the Flop
Seat 8: PSFxpXgPedVZyHSu2Zhb7Q collected ($3.80)
Seat 9: yZYrOeNDxQxkzpbgKX1bng folded before Flop (didn't bet)



PokerStars Game #59940531092:  Hold'em No Limit ($0.50/$1.00) - 2009/07/01 1:09:16 ET
Table 'fZjVbKj9D8yOB+Rj7NaP/A' 9-max Seat #9 is the button
Seat 1: Oh57946S8OPACStkrhQm7g ($64 in chips)
Seat 2: PTAFYDIUSsG+SArbxNl+Aw ($113.50 in chips)
Seat 3: yAbu2QsRPVcjPbqlf/jDxw ($104 in chips)
Seat 5: PkGfq5xrSlNsujKaG/HF4Q ($101.50 in chips)
Seat 6: OvwYHV65yUbgdBjSmo1+5g ($33.10 in chips)
Seat 7: SyS20PAm3RpT6uLBsGkwOA ($113.25 in chips)
Seat 9: qheQay5YvP2DMAb3OUSxtw ($99 in chips)
Oh57946S8OPACStkrhQm7g: posts small blind $0.50
PTAFYDIUSsG+SArbxNl+Aw: posts big blind $1
997ViqAtWn1FPjJqcffwcA: sits out
*** HOLE CARDS ***
yAbu2QsRPVcjPbqlf/jDxw: folds
PkGfq5xrSlNsujKaG/HF4Q: raises $3 to $4
OvwYHV65yUbgdBjSmo1+5g: folds
SyS20PAm3RpT6uLBsGkwOA: folds
zDOE5r14tWqCf6xhuSHK6g joins the table at seat #8
qheQay5YvP2DMAb3OUSxtw: folds
Oh57946S8OPACStkrhQm7g: raises $7 to $11
PTAFYDIUSsG+SArbxNl+Aw: folds
PkGfq5xrSlNsujKaG/HF4Q: raises $22 to $33
Oh57946S8OPACStkrhQm7g: raises $31 to $64 and is all-in
PkGfq5xrSlNsujKaG/HF4Q: calls $31
*** FLOP *** [Kh 5d Jh]
*** TURN *** [Kh 5d Jh] [8h]
*** RIVER *** [Kh 5d Jh 8h] [4d]
*** SHOW DOWN ***
Oh57946S8OPACStkrhQm7g: shows [Ah Ks] (a pair of Kings)
PkGfq5xrSlNsujKaG/HF4Q: mucks hand
Oh57946S8OPACStkrhQm7g collected $126 from pot
*** SUMMARY ***
Total pot $129 | Rake $3
Board [Kh 5d Jh 8h 4d]
Seat 1: Oh57946S8OPACStkrhQm7g (small blind) showed [Ah Ks] and won ($126) with a pair of Kings
Seat 2: PTAFYDIUSsG+SArbxNl+Aw (big blind) folded before Flop
Seat 3: yAbu2QsRPVcjPbqlf/jDxw folded before Flop (didn't bet)
Seat 5: PkGfq5xrSlNsujKaG/HF4Q mucked
Seat 6: OvwYHV65yUbgdBjSmo1+5g folded before Flop (didn't bet)
Seat 7: SyS20PAm3RpT6uLBsGkwOA folded before Flop (didn't bet)
Seat 9: qheQay5YvP2DMAb3OUSxtw (button) folded before Flop (didn't bet)



PokerStars Game #59940531976:  Hold'em No Limit ($0.50/$1.00) - 2009/07/01 1:09:17 ET
Table 'eU3bWpDDg3Z+9R4m4iVmog' 6-max Seat #2 is the button
Seat 2: 8CAoOzhmB8n3nRFf3V4BTg ($89.95 in chips)
Seat 3: rVMOzU7w5FddYPGhD7qN2Q ($37.15 in chips)
Seat 4: GDVIsbEJ/DOJsMKE4Asz0A ($93.75 in chips)
Seat 6: hpxXcmRkXXI9HE5+5/j/0Q ($122.85 in chips)
rVMOzU7w5FddYPGhD7qN2Q: posts small blind $0.50
GDVIsbEJ/DOJsMKE4Asz0A: posts big blind $1
*** HOLE CARDS ***
hpxXcmRkXXI9HE5+5/j/0Q: folds
hpxXcmRkXXI9HE5+5/j/0Q leaves the table
8CAoOzhmB8n3nRFf3V4BTg: calls $1
rVMOzU7w5FddYPGhD7qN2Q: calls $0.50
GDVIsbEJ/DOJsMKE4Asz0A: checks
*** FLOP *** [3c 7h 6h]
rVMOzU7w5FddYPGhD7qN2Q: checks
GDVIsbEJ/DOJsMKE4Asz0A: checks
8CAoOzhmB8n3nRFf3V4BTg: bets $1
rVMOzU7w5FddYPGhD7qN2Q: folds
GDVIsbEJ/DOJsMKE4Asz0A: folds
8CAoOzhmB8n3nRFf3V4BTg collected $2.85 from pot
8CAoOzhmB8n3nRFf3V4BTg: doesn't show hand
*** SUMMARY ***
Total pot $3 | Rake $0.15
Board [3c 7h 6h]
Seat 2: 8CAoOzhmB8n3nRFf3V4BTg (button) collected ($2.85)
Seat 3: rVMOzU7w5FddYPGhD7qN2Q (small blind) folded on the Flop
Seat 4: GDVIsbEJ/DOJsMKE4Asz0A (big blind) folded on the Flop
Seat 6: hpxXcmRkXXI9HE5+5/j/0Q folded before Flop (didn't bet)



PokerStars Game #59940531916:  Hold'em No Limit ($0.50/$1.00) - 2009/07/01 1:09:17 ET
Table 'cKH9c4x6u79IqCdaKKvXrw' 9-max Seat #5 is the button
Seat 1: Pp/KTcXkfZKKUHkjyaLTdg ($18.50 in chips)
Seat 2: 8S3JMH4TY3whgIlZmMv66w ($75.55 in chips)
Seat 3: 997ViqAtWn1FPjJqcffwcA ($155.60 in chips)
Seat 4: FL3MrLspcF23LYvC4ipBOA ($100 in chips)
Seat 5: Jjc7EHWzs4//xUAjJ0UWoA ($42.90 in chips)
Seat 6: Bsd/K5gAcLanYbGiPirRjw ($201.55 in chips)
Seat 7: 1GkkVBhlJ92guE6K5mS5Ig ($18.10 in chips)
Seat 8: myIxN7otsyr846M539YR8Q ($17 in chips)
Seat 9: 6XkTu4ahxzHnvjjc1R8YjQ ($41.60 in chips)
Bsd/K5gAcLanYbGiPirRjw: posts small blind $0.50
1GkkVBhlJ92guE6K5mS5Ig: posts big blind $1
*** HOLE CARDS ***
myIxN7otsyr846M539YR8Q: folds
6XkTu4ahxzHnvjjc1R8YjQ: folds
Pp/KTcXkfZKKUHkjyaLTdg: folds
8S3JMH4TY3whgIlZmMv66w: folds
997ViqAtWn1FPjJqcffwcA: folds
FL3MrLspcF23LYvC4ipBOA has timed out
FL3MrLspcF23LYvC4ipBOA: folds
FL3MrLspcF23LYvC4ipBOA is sitting out
Jjc7EHWzs4//xUAjJ0UWoA: raises $2 to $3
Bsd/K5gAcLanYbGiPirRjw: folds
1GkkVBhlJ92guE6K5mS5Ig: folds
Jjc7EHWzs4//xUAjJ0UWoA collected $2.50 from pot
*** SUMMARY ***
Total pot $2.50 | Rake $0
Seat 1: Pp/KTcXkfZKKUHkjyaLTdg folded before Flop (didn't bet)
Seat 2: 8S3JMH4TY3whgIlZmMv66w folded before Flop (didn't bet)
Seat 3: 997ViqAtWn1FPjJqcffwcA folded before Flop (didn't bet)
Seat 4: FL3MrLspcF23LYvC4ipBOA folded before Flop (didn't bet)
Seat 5: Jjc7EHWzs4//xUAjJ0UWoA (button) collected ($2.50)
Seat 6: Bsd/K5gAcLanYbGiPirRjw (small blind) folded before Flop
Seat 7: 1GkkVBhlJ92guE6K5mS5Ig (big blind) folded before Flop
Seat 8: myIxN7otsyr846M539YR8Q folded before Flop (didn't bet)
Seat 9: 6XkTu4ahxzHnvjjc1R8YjQ folded before Flop (didn't bet)



PokerStars Game #59940532154:  Hold'em No Limit ($0.50/$1.00) - 2009/07/01 1:09:18 ET
Table 'GPp0HyAuggN8oE0sUWzPpA' 9-max Seat #7 is the button
Seat 1: qJr25HAtvv1w/7IBvjMM3g ($42.70 in chips)
Seat 2: m3U8I35Pn3gxKhoS2nmYIg ($39.55 in chips)
Seat 3: CCCXsirC+bO7ginAuUUVlQ ($49.35 in chips)
Seat 4: mBRWbnUl8diyBO1qTJaNzw ($107.65 in chips)
Seat 6: BK/GtNPkSx0TdUDj82id5A ($16.35 in chips)
Seat 7: DHdbHyysD15wCAtx+BhUjA ($93.50 in chips)
Seat 8: 6DBvLniKMJADk/t5l29oMA ($24.15 in chips)
Seat 9: dzoSjPZmtjGuK83119030A ($34.15 in chips)
6DBvLniKMJADk/t5l29oMA: posts small blind $0.50
dzoSjPZmtjGuK83119030A: posts big blind $1
bLbSOSmSOnqE0iTcH/5dxA: sits out
*** HOLE CARDS ***
qJr25HAtvv1w/7IBvjMM3g: folds
m3U8I35Pn3gxKhoS2nmYIg: folds
CCCXsirC+bO7ginAuUUVlQ: folds
mBRWbnUl8diyBO1qTJaNzw: folds
BK/GtNPkSx0TdUDj82id5A: folds
DHdbHyysD15wCAtx+BhUjA: folds
6DBvLniKMJADk/t5l29oMA: folds
dzoSjPZmtjGuK83119030A collected $1 from pot
*** SUMMARY ***
Total pot $1 | Rake $0
Seat 1: qJr25HAtvv1w/7IBvjMM3g folded before Flop (didn't bet)
Seat 2: m3U8I35Pn3gxKhoS2nmYIg folded before Flop (didn't bet)
Seat 3: CCCXsirC+bO7ginAuUUVlQ folded before Flop (didn't bet)
Seat 4: mBRWbnUl8diyBO1qTJaNzw folded before Flop (didn't bet)
Seat 6: BK/GtNPkSx0TdUDj82id5A folded before Flop (didn't bet)
Seat 7: DHdbHyysD15wCAtx+BhUjA (button) folded before Flop (didn't bet)
Seat 8: 6DBvLniKMJADk/t5l29oMA (small blind) folded before Flop
Seat 9: dzoSjPZmtjGuK83119030A (big blind) collected ($1)



PokerStars Game #59940533662:  Hold'em No Limit ($0.50/$1.00) - 2009/07/01 1:09:20 ET
Table '3T4owEKJKyGTMePwrv50FQ' 9-max Seat #6 is the button
Seat 1: OGgaARGdJQT4awWVNQ957w ($101.10 in chips)
Seat 2: t+Id2O6herCLgwnC4m49PA ($38.60 in chips)
Seat 3: DOLzOcBTZYcph5jEfKFWuQ ($105.50 in chips)
Seat 4: O5Go3jrzbQWxRB6ESK+Ptg ($30.10 in chips)
Seat 5: eI48VADSCFoNZBx4T9qs2w ($31.85 in chips)
Seat 6: laA8va+Yv8WuMqT1zdR91g ($100 in chips)
Seat 7: 1862487932 ($103.50 in chips)
Seat 8: ucTB8uAUcQnKGsA70OSjNA ($20 in chips)
Seat 9: 61sfw5QTu62YYIt68OsdrA ($66.95 in chips)
1862487932: posts small blind $0.50
ucTB8uAUcQnKGsA70OSjNA: posts big blind $1
*** HOLE CARDS ***
61sfw5QTu62YYIt68OsdrA: folds
OGgaARGdJQT4awWVNQ957w: folds
t+Id2O6herCLgwnC4m49PA: folds
DOLzOcBTZYcph5jEfKFWuQ: folds
O5Go3jrzbQWxRB6ESK+Ptg: folds
eI48VADSCFoNZBx4T9qs2w: folds
laA8va+Yv8WuMqT1zdR91g: folds
1862487932: raises $2.50 to $3.50
ucTB8uAUcQnKGsA70OSjNA: folds
1862487932 collected $2 from pot
1862487932: doesn't show hand
*** SUMMARY ***
Total pot $2 | Rake $0
Seat 1: OGgaARGdJQT4awWVNQ957w folded before Flop (didn't bet)
Seat 2: t+Id2O6herCLgwnC4m49PA folded before Flop (didn't bet)
Seat 3: DOLzOcBTZYcph5jEfKFWuQ folded before Flop (didn't bet)
Seat 4: O5Go3jrzbQWxRB6ESK+Ptg folded before Flop (didn't bet)
Seat 5: eI48VADSCFoNZBx4T9qs2w folded before Flop (didn't bet)
Seat 6: laA8va+Yv8WuMqT1zdR91g (button) folded before Flop (didn't bet)
Seat 7: 1862487932 (small blind) collected ($2)
Seat 8: ucTB8uAUcQnKGsA70OSjNA (big blind) folded before Flop
Seat 9: 61sfw5QTu62YYIt68OsdrA folded before Flop (didn't bet)



PokerStars Game #59940534088:  Hold'em No Limit ($0.50/$1.00) - 2009/07/01 1:09:21 ET
Table 'tJq9SfN1ywY0r03VBlWlwQ' 9-max Seat #3 is the button
Seat 1: wZsU+w9r7G66x93UuvBf1Q ($339.30 in chips)
Seat 3: FVs16t7GgfWgQWt4JxsObQ ($26.10 in chips)
Seat 4: bLbSOSmSOnqE0iTcH/5dxA ($111.20 in chips)
Seat 5: h5ipsNTMyolp7xn/NAvWkA ($74.50 in chips)
Seat 6: gUUvmqdVlmvpal6B8nYrmg ($120.20 in chips)
Seat 8: G4DEhsZFmznGNVpy2SEocA ($29.90 in chips)
Seat 9: XE5QF1y74bpHog9JxWJMWQ ($100.50 in chips)
bLbSOSmSOnqE0iTcH/5dxA: posts small blind $0.50
h5ipsNTMyolp7xn/NAvWkA: posts big blind $1
*** HOLE CARDS ***
gUUvmqdVlmvpal6B8nYrmg: folds
G4DEhsZFmznGNVpy2SEocA: folds
XE5QF1y74bpHog9JxWJMWQ: folds
wZsU+w9r7G66x93UuvBf1Q: raises $3 to $4
FVs16t7GgfWgQWt4JxsObQ: folds
bLbSOSmSOnqE0iTcH/5dxA: folds
h5ipsNTMyolp7xn/NAvWkA: raises $6 to $10
wZsU+w9r7G66x93UuvBf1Q: folds
h5ipsNTMyolp7xn/NAvWkA collected $8.50 from pot
*** SUMMARY ***
Total pot $8.50 | Rake $0
Seat 1: wZsU+w9r7G66x93UuvBf1Q folded before Flop
Seat 3: FVs16t7GgfWgQWt4JxsObQ (button) folded before Flop (didn't bet)
Seat 4: bLbSOSmSOnqE0iTcH/5dxA (small blind) folded before Flop
Seat 5: h5ipsNTMyolp7xn/NAvWkA (big blind) collected ($8.50)
Seat 6: gUUvmqdVlmvpal6B8nYrmg folded before Flop (didn't bet)
Seat 8: G4DEhsZFmznGNVpy2SEocA folded before Flop (didn't bet)
Seat 9: XE5QF1y74bpHog9JxWJMWQ folded before Flop (didn't bet)



PokerStars Game #59940534242:  Hold'em No Limit ($0.50/$1.00) - 2009/07/01 1:09:21 ET
Table 'JTT1XWaDZHSaMZQK7cR5uw' 2-max Seat #2 is the button
Seat 1: OLplZF6FEnLflv81Hz+Fxg ($130.95 in chips)
Seat 2: BcqgegiOUxmBD3F3umsljg ($75.15 in chips)
BcqgegiOUxmBD3F3umsljg: posts small blind $0.50
OLplZF6FEnLflv81Hz+Fxg: posts big blind $1
*** HOLE CARDS ***
BcqgegiOUxmBD3F3umsljg: raises $1 to $2
OLplZF6FEnLflv81Hz+Fxg: calls $1
*** FLOP *** [9h 9d Ts]
OLplZF6FEnLflv81Hz+Fxg said, "do you ever make a raise with a real hand?"
OLplZF6FEnLflv81Hz+Fxg: checks
BcqgegiOUxmBD3F3umsljg: checks
*** TURN *** [9h 9d Ts] [9s]
OLplZF6FEnLflv81Hz+Fxg: checks
BcqgegiOUxmBD3F3umsljg: bets $4
OLplZF6FEnLflv81Hz+Fxg: folds
BcqgegiOUxmBD3F3umsljg collected $3.80 from pot
*** SUMMARY ***
Total pot $4 | Rake $0.20
Board [9h 9d Ts 9s]
Seat 1: OLplZF6FEnLflv81Hz+Fxg (big blind) folded on the Turn
Seat 2: BcqgegiOUxmBD3F3umsljg (button) (small blind) collected ($3.80)



PokerStars Game #59940534542:  Hold'em No Limit ($0.50/$1.00) - 2009/07/01 1:09:22 ET
Table 'VOs36P6NW+QyXeQ1B62kmA' 6-max Seat #5 is the button
Seat 1: Z2fXsGcjl+Eax+RzOgwOmg ($101.50 in chips)
Seat 2: 2UMlbaZ8n8AbRli0Yr0mDw ($41.10 in chips)
Seat 4: w02zQzNydODiyV9THKgo9w ($47.60 in chips)
Seat 5: ozrlafxxh1HmYdA0/h+MuA ($40.90 in chips)
Seat 6: slVKuQyEz8Qj4E3uLPYNXg ($100 in chips)
slVKuQyEz8Qj4E3uLPYNXg: posts small blind $0.50
Z2fXsGcjl+Eax+RzOgwOmg: posts big blind $1
FyNUCpzHVyQu/qX8pqNQFA: sits out
*** HOLE CARDS ***
2UMlbaZ8n8AbRli0Yr0mDw: calls $1
w02zQzNydODiyV9THKgo9w: folds
ozrlafxxh1HmYdA0/h+MuA: raises $1 to $2
slVKuQyEz8Qj4E3uLPYNXg: calls $1.50
Z2fXsGcjl+Eax+RzOgwOmg: folds
2UMlbaZ8n8AbRli0Yr0mDw: calls $1
*** FLOP *** [6s 7d 8d]
slVKuQyEz8Qj4E3uLPYNXg: checks
2UMlbaZ8n8AbRli0Yr0mDw: bets $3
ozrlafxxh1HmYdA0/h+MuA: calls $3
slVKuQyEz8Qj4E3uLPYNXg: calls $3
*** TURN *** [6s 7d 8d] [5c]
slVKuQyEz8Qj4E3uLPYNXg: checks
2UMlbaZ8n8AbRli0Yr0mDw: checks
ozrlafxxh1HmYdA0/h+MuA: bets $5
slVKuQyEz8Qj4E3uLPYNXg: calls $5
2UMlbaZ8n8AbRli0Yr0mDw: folds
*** RIVER *** [6s 7d 8d 5c] [4c]
slVKuQyEz8Qj4E3uLPYNXg: bets $10
ozrlafxxh1HmYdA0/h+MuA: calls $10
*** SHOW DOWN ***
slVKuQyEz8Qj4E3uLPYNXg: shows [Jc Th] (a straight, Four to Eight)
ozrlafxxh1HmYdA0/h+MuA: shows [As Ks] (a straight, Four to Eight)
slVKuQyEz8Qj4E3uLPYNXg collected $22 from pot
ozrlafxxh1HmYdA0/h+MuA collected $22 from pot
*** SUMMARY ***
Total pot $46 | Rake $2
Board [6s 7d 8d 5c 4c]
Seat 1: Z2fXsGcjl+Eax+RzOgwOmg (big blind) folded before Flop
Seat 2: 2UMlbaZ8n8AbRli0Yr0mDw folded on the Turn
Seat 4: w02zQzNydODiyV9THKgo9w folded before Flop (didn't bet)
Seat 5: ozrlafxxh1HmYdA0/h+MuA (button) showed [As Ks] and won ($22) with a straight, Four to Eight
Seat 6: slVKuQyEz8Qj4E3uLPYNXg (small blind) showed [Jc Th] and won ($22) with a straight, Four to Eight



PokerStars Game #59940537150:  Hold'em No Limit ($0.50/$1.00) - 2009/07/01 1:09:26 ET
Table 'MUPc8FEpe/nR0BKSeReX6Q' 6-max Seat #2 is the button
Seat 1: qhkK6+yCciTRd+rCFEbnEQ ($41.70 in chips)
Seat 2: xAU6q2/cwmby2sxmA8VcmA ($114.70 in chips)
Seat 3: wx3sQGkVi2x9wJXuWNHPBw ($205.45 in chips)
Seat 4: ZA1bp6g8IwtTxkUE4eCjDQ ($195.15 in chips)
Seat 5: UBZQqpnJZdTYYY1FTb0rLA ($100 in chips)
Seat 6: oxnw0GLLpFanjhGkxfRSqA ($58.50 in chips)
wx3sQGkVi2x9wJXuWNHPBw: posts small blind $0.50
ZA1bp6g8IwtTxkUE4eCjDQ: posts big blind $1
*** HOLE CARDS ***
UBZQqpnJZdTYYY1FTb0rLA: folds
oxnw0GLLpFanjhGkxfRSqA: calls $1
qhkK6+yCciTRd+rCFEbnEQ: folds
xAU6q2/cwmby2sxmA8VcmA: folds
wx3sQGkVi2x9wJXuWNHPBw: calls $0.50
ZA1bp6g8IwtTxkUE4eCjDQ: checks
*** FLOP *** [8c 6d Qs]
wx3sQGkVi2x9wJXuWNHPBw: checks
ZA1bp6g8IwtTxkUE4eCjDQ: bets $1
oxnw0GLLpFanjhGkxfRSqA: calls $1
wx3sQGkVi2x9wJXuWNHPBw: calls $1
*** TURN *** [8c 6d Qs] [9h]
wx3sQGkVi2x9wJXuWNHPBw: checks
ZA1bp6g8IwtTxkUE4eCjDQ: bets $1
oxnw0GLLpFanjhGkxfRSqA: calls $1
wx3sQGkVi2x9wJXuWNHPBw: raises $5.50 to $6.50
ZA1bp6g8IwtTxkUE4eCjDQ: calls $5.50
oxnw0GLLpFanjhGkxfRSqA: folds
*** RIVER *** [8c 6d Qs 9h] [9c]
wx3sQGkVi2x9wJXuWNHPBw: bets $12.50
ZA1bp6g8IwtTxkUE4eCjDQ: folds
wx3sQGkVi2x9wJXuWNHPBw collected $19.05 from pot
*** SUMMARY ***
Total pot $20 | Rake $0.95
Board [8c 6d Qs 9h 9c]
Seat 1: qhkK6+yCciTRd+rCFEbnEQ folded before Flop (didn't bet)
Seat 2: xAU6q2/cwmby2sxmA8VcmA (button) folded before Flop (didn't bet)
Seat 3: wx3sQGkVi2x9wJXuWNHPBw (small blind) collected ($19.05)
Seat 4: ZA1bp6g8IwtTxkUE4eCjDQ (big blind) folded on the River
Seat 5: UBZQqpnJZdTYYY1FTb0rLA folded before Flop (didn't bet)
Seat 6: oxnw0GLLpFanjhGkxfRSqA folded on the Turn



PokerStars Game #59940537474:  Hold'em No Limit ($0.50/$1.00) - 2009/07/01 1:09:27 ET
Table '7Nl0ffnjeK44/vmeexh3MQ' 9-max Seat #7 is the button
Seat 1: s7D3Y+k4Cj4D1cXHv7oj+Q ($90.85 in chips)
Seat 2: OGgaARGdJQT4awWVNQ957w ($100 in chips)
Seat 3: JMmUYT5pIKCKh2pGjCB/4w ($37 in chips)
Seat 4: bLbSOSmSOnqE0iTcH/5dxA ($104.15 in chips)
Seat 5: 61sfw5QTu62YYIt68OsdrA ($79 in chips)
Seat 6: FVs16t7GgfWgQWt4JxsObQ ($36.35 in chips)
Seat 7: 997ViqAtWn1FPjJqcffwcA ($100 in chips)
Seat 8: D+W9Me7w6Hcx/WRUSKV0dw ($18.75 in chips)
Seat 9: ouwUBGRKnKK9uhn1G4Lf+A ($195.50 in chips)
D+W9Me7w6Hcx/WRUSKV0dw: posts small blind $0.50
ouwUBGRKnKK9uhn1G4Lf+A: posts big blind $1
*** HOLE CARDS ***
s7D3Y+k4Cj4D1cXHv7oj+Q: folds
s7D3Y+k4Cj4D1cXHv7oj+Q is sitting out
OGgaARGdJQT4awWVNQ957w: folds
s7D3Y+k4Cj4D1cXHv7oj+Q leaves the table
JMmUYT5pIKCKh2pGjCB/4w: calls $1
V138SURkdX8LdVBPKdJJag joins the table at seat #1
bLbSOSmSOnqE0iTcH/5dxA: folds
61sfw5QTu62YYIt68OsdrA: folds
FVs16t7GgfWgQWt4JxsObQ: calls $1
997ViqAtWn1FPjJqcffwcA: folds
D+W9Me7w6Hcx/WRUSKV0dw: folds
ouwUBGRKnKK9uhn1G4Lf+A: checks
*** FLOP *** [Qc Jh 4h]
ouwUBGRKnKK9uhn1G4Lf+A: checks
JMmUYT5pIKCKh2pGjCB/4w: bets $2
FVs16t7GgfWgQWt4JxsObQ: calls $2
ouwUBGRKnKK9uhn1G4Lf+A: folds
*** TURN *** [Qc Jh 4h] [Ac]
JMmUYT5pIKCKh2pGjCB/4w: bets $2
FVs16t7GgfWgQWt4JxsObQ: calls $2
*** RIVER *** [Qc Jh 4h Ac] [4c]
JMmUYT5pIKCKh2pGjCB/4w: bets $3
FVs16t7GgfWgQWt4JxsObQ: folds
JMmUYT5pIKCKh2pGjCB/4w collected $10.95 from pot
JMmUYT5pIKCKh2pGjCB/4w: doesn't show hand
*** SUMMARY ***
Total pot $11.50 | Rake $0.55
Board [Qc Jh 4h Ac 4c]
Seat 1: s7D3Y+k4Cj4D1cXHv7oj+Q folded before Flop (didn't bet)
Seat 2: OGgaARGdJQT4awWVNQ957w folded before Flop (didn't bet)
Seat 3: JMmUYT5pIKCKh2pGjCB/4w collected ($10.95)
Seat 4: bLbSOSmSOnqE0iTcH/5dxA folded before Flop (didn't bet)
Seat 5: 61sfw5QTu62YYIt68OsdrA folded before Flop (didn't bet)
Seat 6: FVs16t7GgfWgQWt4JxsObQ folded on the River
Seat 7: 997ViqAtWn1FPjJqcffwcA (button) folded before Flop (didn't bet)
Seat 8: D+W9Me7w6Hcx/WRUSKV0dw (small blind) folded before Flop
Seat 9: ouwUBGRKnKK9uhn1G4Lf+A (big blind) folded on the Flop



PokerStars Game #59940539780:  Hold'em No Limit ($0.50/$1.00) - 2009/07/01 1:09:31 ET
Table 'kS0cTQAEi+fdUlJP2gQYvw' 9-max Seat #9 is the button
Seat 1: c/9X4zftzphFxYtxp5kp9w ($63.35 in chips)
Seat 2: D+W9Me7w6Hcx/WRUSKV0dw ($22.40 in chips)
Seat 3: 2BV+oJIQYr65IO6nEChvbA ($60 in chips)
Seat 5: 997ViqAtWn1FPjJqcffwcA ($102.65 in chips)
Seat 6: yAbu2QsRPVcjPbqlf/jDxw ($126.65 in chips)
Seat 7: Ffa7Nj4X5fddtROP01hfQg ($153.25 in chips)
Seat 9: OGgaARGdJQT4awWVNQ957w ($101.50 in chips)
c/9X4zftzphFxYtxp5kp9w: posts small blind $0.50
D+W9Me7w6Hcx/WRUSKV0dw: posts big blind $1
*** HOLE CARDS ***
2BV+oJIQYr65IO6nEChvbA: folds
997ViqAtWn1FPjJqcffwcA: folds
yAbu2QsRPVcjPbqlf/jDxw: raises $3 to $4
Ffa7Nj4X5fddtROP01hfQg: folds
OGgaARGdJQT4awWVNQ957w: folds
c/9X4zftzphFxYtxp5kp9w: folds
D+W9Me7w6Hcx/WRUSKV0dw: folds
yAbu2QsRPVcjPbqlf/jDxw collected $2.50 from pot
yAbu2QsRPVcjPbqlf/jDxw: doesn't show hand
*** SUMMARY ***
Total pot $2.50 | Rake $0
Seat 1: c/9X4zftzphFxYtxp5kp9w (small blind) folded before Flop
Seat 2: D+W9Me7w6Hcx/WRUSKV0dw (big blind) folded before Flop
Seat 3: 2BV+oJIQYr65IO6nEChvbA folded before Flop (didn't bet)
Seat 5: 997ViqAtWn1FPjJqcffwcA folded before Flop (didn't bet)
Seat 6: yAbu2QsRPVcjPbqlf/jDxw collected ($2.50)
Seat 7: Ffa7Nj4X5fddtROP01hfQg folded before Flop (didn't bet)
Seat 9: OGgaARGdJQT4awWVNQ957w (button) folded before Flop (didn't bet)



PokerStars Game #59940540118:  Hold'em No Limit ($0.50/$1.00) - 2009/07/01 1:09:31 ET
Table 'QSIig7BLMc9wY/rgBechzw' 6-max Seat #2 is the button
Seat 1: Z2fXsGcjl+Eax+RzOgwOmg ($115 in chips)
Seat 2: mLOIkH/qmRa+mVujQIhBRg ($40.10 in chips)
Seat 3: +xW7QemQU0Fxs+4TnqBRow ($100 in chips)
Seat 4: +uSzP8Jwnw7sKfQ4s66b7w ($80.45 in chips)
Seat 5: lsLuWlcPA3Rh7kJVLzMh0Q ($101 in chips)
Seat 6: PxqfkAMdAWtkgbT+q2gciA ($35.75 in chips)
+xW7QemQU0Fxs+4TnqBRow: posts small blind $0.50
+uSzP8Jwnw7sKfQ4s66b7w: posts big blind $1
*** HOLE CARDS ***
lsLuWlcPA3Rh7kJVLzMh0Q: folds
PxqfkAMdAWtkgbT+q2gciA: folds
Z2fXsGcjl+Eax+RzOgwOmg: folds
mLOIkH/qmRa+mVujQIhBRg: raises $1 to $2
+xW7QemQU0Fxs+4TnqBRow: folds
+uSzP8Jwnw7sKfQ4s66b7w: folds
mLOIkH/qmRa+mVujQIhBRg collected $2.50 from pot
*** SUMMARY ***
Total pot $2.50 | Rake $0
Seat 1: Z2fXsGcjl+Eax+RzOgwOmg folded before Flop (didn't bet)
Seat 2: mLOIkH/qmRa+mVujQIhBRg (button) collected ($2.50)
Seat 3: +xW7QemQU0Fxs+4TnqBRow (small blind) folded before Flop
Seat 4: +uSzP8Jwnw7sKfQ4s66b7w (big blind) folded before Flop
Seat 5: lsLuWlcPA3Rh7kJVLzMh0Q folded before Flop (didn't bet)
Seat 6: PxqfkAMdAWtkgbT+q2gciA folded before Flop (didn't bet)



PokerStars Game #59940539806:  Hold'em No Limit ($0.50/$1.00) - 2009/07/01 1:09:31 ET
Table 'cBDNutyLBKEk9+ptwsKmTw' 6-max Seat #3 is the button
Seat 1: xAU6q2/cwmby2sxmA8VcmA ($126.90 in chips)
Seat 2: 5lY8d6Cnm4HUkt/8FZSj4g ($33 in chips)
Seat 3: G5ZSSN6RSON3gkNvk/SmYg ($100 in chips)
Seat 4: 3q7F5QtzC30pSrn0nl9i+A ($24.30 in chips)
Seat 6: NqVlOSH2lp+pp/TK3vvK5g ($81.15 in chips)
3q7F5QtzC30pSrn0nl9i+A: posts small blind $0.50
OGMLOcTNYZXZU81au7ztUw: is sitting out
NqVlOSH2lp+pp/TK3vvK5g: posts big blind $1
*** HOLE CARDS ***
xAU6q2/cwmby2sxmA8VcmA: folds
OGMLOcTNYZXZU81au7ztUw leaves the table
hpxXcmRkXXI9HE5+5/j/0Q joins the table at seat #5
5lY8d6Cnm4HUkt/8FZSj4g: calls $1
G5ZSSN6RSON3gkNvk/SmYg: folds
3q7F5QtzC30pSrn0nl9i+A: raises $1 to $2
NqVlOSH2lp+pp/TK3vvK5g: calls $1
5lY8d6Cnm4HUkt/8FZSj4g: calls $1
*** FLOP *** [7h Jd 9d]
3q7F5QtzC30pSrn0nl9i+A: bets $4
NqVlOSH2lp+pp/TK3vvK5g: folds
5lY8d6Cnm4HUkt/8FZSj4g: calls $4
*** TURN *** [7h Jd 9d] [4c]
3q7F5QtzC30pSrn0nl9i+A: bets $18.30 and is all-in
5lY8d6Cnm4HUkt/8FZSj4g: calls $18.30
*** RIVER *** [7h Jd 9d 4c] [As]
*** SHOW DOWN ***
3q7F5QtzC30pSrn0nl9i+A: shows [Kc Kd] (a pair of Kings)
5lY8d6Cnm4HUkt/8FZSj4g: mucks hand
3q7F5QtzC30pSrn0nl9i+A collected $48.60 from pot
*** SUMMARY ***
Total pot $50.60 | Rake $2
Board [7h Jd 9d 4c As]
Seat 1: xAU6q2/cwmby2sxmA8VcmA folded before Flop (didn't bet)
Seat 2: 5lY8d6Cnm4HUkt/8FZSj4g mucked
Seat 3: G5ZSSN6RSON3gkNvk/SmYg (button) folded before Flop (didn't bet)
Seat 4: 3q7F5QtzC30pSrn0nl9i+A (small blind) showed [Kc Kd] and won ($48.60) with a pair of Kings
Seat 6: NqVlOSH2lp+pp/TK3vvK5g (big blind) folded on the Flop



PokerStars Game #59940541886:  Hold'em No Limit ($0.50/$1.00) - 2009/07/01 1:09:34 ET
Table 'fTlPiCj0utgzC/5io+I7ew' 6-max Seat #4 is the button
Seat 1: YMJG+F++3Aj6P8dAWda5fw ($102.85 in chips)
Seat 2: Qy/UBNbD2HaA0Ogxg8Sf3w ($128.60 in chips)
Seat 3: Z2fXsGcjl+Eax+RzOgwOmg ($102.50 in chips)
Seat 4: uJVSceLggtsrJya+WtmUEA ($185.65 in chips)
Seat 6: /P4w1pHg2zHYg/4ubJ0dPw ($66.55 in chips)
/P4w1pHg2zHYg/4ubJ0dPw: posts small blind $0.50
YMJG+F++3Aj6P8dAWda5fw: posts big blind $1
*** HOLE CARDS ***
Qy/UBNbD2HaA0Ogxg8Sf3w: folds
Z2fXsGcjl+Eax+RzOgwOmg: folds
uJVSceLggtsrJya+WtmUEA: folds
/P4w1pHg2zHYg/4ubJ0dPw: raises $2 to $3
YMJG+F++3Aj6P8dAWda5fw: folds
/P4w1pHg2zHYg/4ubJ0dPw collected $2 from pot
*** SUMMARY ***
Total pot $2 | Rake $0
Seat 1: YMJG+F++3Aj6P8dAWda5fw (big blind) folded before Flop
Seat 2: Qy/UBNbD2HaA0Ogxg8Sf3w folded before Flop (didn't bet)
Seat 3: Z2fXsGcjl+Eax+RzOgwOmg folded before Flop (didn't bet)
Seat 4: uJVSceLggtsrJya+WtmUEA (button) folded before Flop (didn't bet)
Seat 6: /P4w1pHg2zHYg/4ubJ0dPw (small blind) collected ($2)



PokerStars Game #59940542940:  Hold'em No Limit ($0.50/$1.00) - 2009/07/01 1:09:36 ET
Table '7O9fB8yx1u7sJveJn8w6jA' 6-max Seat #2 is the button
Seat 1: jy52+7FotjH63o5tEEVgKw ($87.85 in chips)
Seat 2: wx3sQGkVi2x9wJXuWNHPBw ($186.45 in chips)
Seat 3: hpxXcmRkXXI9HE5+5/j/0Q ($103.20 in chips)
Seat 4: b2a+5TkFf4xJN/Ihhma58Q ($40 in chips)
Seat 5: BCEV3COoKY607AzLWayfRA ($121.05 in chips)
hpxXcmRkXXI9HE5+5/j/0Q: posts small blind $0.50
b2a+5TkFf4xJN/Ihhma58Q: posts big blind $1
*** HOLE CARDS ***
BCEV3COoKY607AzLWayfRA: folds
p1Ga2i1TuXUvRn+Rf/0FMw joins the table at seat #6
jy52+7FotjH63o5tEEVgKw: calls $1
wx3sQGkVi2x9wJXuWNHPBw has timed out
wx3sQGkVi2x9wJXuWNHPBw: folds
wx3sQGkVi2x9wJXuWNHPBw is sitting out
wx3sQGkVi2x9wJXuWNHPBw has returned
hpxXcmRkXXI9HE5+5/j/0Q: folds
b2a+5TkFf4xJN/Ihhma58Q: raises $1 to $2
jy52+7FotjH63o5tEEVgKw: calls $1
*** FLOP *** [4c 6d 2h]
b2a+5TkFf4xJN/Ihhma58Q: checks
jy52+7FotjH63o5tEEVgKw: checks
*** TURN *** [4c 6d 2h] [7s]
b2a+5TkFf4xJN/Ihhma58Q: bets $3
jy52+7FotjH63o5tEEVgKw: folds
b2a+5TkFf4xJN/Ihhma58Q collected $4.30 from pot
*** SUMMARY ***
Total pot $4.50 | Rake $0.20
Board [4c 6d 2h 7s]
Seat 1: jy52+7FotjH63o5tEEVgKw folded on the Turn
Seat 2: wx3sQGkVi2x9wJXuWNHPBw (button) folded before Flop (didn't bet)
Seat 3: hpxXcmRkXXI9HE5+5/j/0Q (small blind) folded before Flop
Seat 4: b2a+5TkFf4xJN/Ihhma58Q (big blind) collected ($4.30)
Seat 5: BCEV3COoKY607AzLWayfRA folded before Flop (didn't bet)



PokerStars Game #59940544188:  Hold'em No Limit ($0.50/$1.00) - 2009/07/01 1:09:38 ET
Table 'pHrhryH8jPNdQfY62f8v+g' 6-max Seat #4 is the button
Seat 2: RqgF7gRoKgRNW8Zoi1ty4A ($141 in chips)
Seat 3: 8oS5O7iD/qnFXFXJrGIgNQ ($100 in chips)
Seat 4: 1f3beyIML24UqEMTbWy93g ($58.15 in chips)
Seat 5: r1/R7y0Ortgoz4lccgW8VA ($35.05 in chips)
Seat 6: xAU6q2/cwmby2sxmA8VcmA ($208.10 in chips)
r1/R7y0Ortgoz4lccgW8VA: posts small blind $0.50
xAU6q2/cwmby2sxmA8VcmA: posts big blind $1
4d1rWhpu8DzLmzMbR3QKyA: sits out
*** HOLE CARDS ***
RqgF7gRoKgRNW8Zoi1ty4A: folds
8oS5O7iD/qnFXFXJrGIgNQ: raises $2.50 to $3.50
1f3beyIML24UqEMTbWy93g: folds
r1/R7y0Ortgoz4lccgW8VA: calls $3
xAU6q2/cwmby2sxmA8VcmA: folds
*** FLOP *** [5d 5c 6h]
r1/R7y0Ortgoz4lccgW8VA: checks
8oS5O7iD/qnFXFXJrGIgNQ: checks
*** TURN *** [5d 5c 6h] [Ad]
r1/R7y0Ortgoz4lccgW8VA: bets $5
8oS5O7iD/qnFXFXJrGIgNQ: folds
r1/R7y0Ortgoz4lccgW8VA collected $7.60 from pot
*** SUMMARY ***
Total pot $8 | Rake $0.40
Board [5d 5c 6h Ad]
Seat 2: RqgF7gRoKgRNW8Zoi1ty4A folded before Flop (didn't bet)
Seat 3: 8oS5O7iD/qnFXFXJrGIgNQ folded on the Turn
Seat 4: 1f3beyIML24UqEMTbWy93g (button) folded before Flop (didn't bet)
Seat 5: r1/R7y0Ortgoz4lccgW8VA (small blind) collected ($7.60)
Seat 6: xAU6q2/cwmby2sxmA8VcmA (big blind) folded before Flop



PokerStars Game #59940544242:  Hold'em No Limit ($0.50/$1.00) - 2009/07/01 1:09:38 ET
Table 'tyUh+jyNvrceIQdKMJjQ2wZFWj23PMihdwrNWv41OG/Qeat #6 is the button
Seat 1: o8A5MUdudVKu+pAwgZOX2w ($109.90 in chips)
Seat 2: 5uy3EN+iIYkgwbWZFTUBAQ ($100 in chips)
Seat 3: TalCiLYHCd+ffkmR3auPvA ($148.30 in chips)
Seat 5: j7NIOHLZk7V2o9fOioO5ug ($100 in chips)
Seat 6: 4OO5v3AVduL0tePNx8wk5A ($100 in chips)
o8A5MUdudVKu+pAwgZOX2w: posts small blind $0.50
5uy3EN+iIYkgwbWZFTUBAQ: posts big blind $1
hpxXcmRkXXI9HE5+5/j/0Q: sits out
*** HOLE CARDS ***
TalCiLYHCd+ffkmR3auPvA: folds
j7NIOHLZk7V2o9fOioO5ug: folds
4OO5v3AVduL0tePNx8wk5A: raises $2 to $3
o8A5MUdudVKu+pAwgZOX2w: calls $2.50
5uy3EN+iIYkgwbWZFTUBAQ: folds
*** FLOP *** [Ah 9h Jd]
o8A5MUdudVKu+pAwgZOX2w: checks
4OO5v3AVduL0tePNx8wk5A: checks
*** TURN *** [Ah 9h Jd] [Tc]
o8A5MUdudVKu+pAwgZOX2w: bets $6
4OO5v3AVduL0tePNx8wk5A: folds
o8A5MUdudVKu+pAwgZOX2w collected $6.65 from pot
o8A5MUdudVKu+pAwgZOX2w: doesn't show hand
*** SUMMARY ***
Total pot $7 | Rake $0.35
Board [Ah 9h Jd Tc]
Seat 1: o8A5MUdudVKu+pAwgZOX2w (small blind) collected ($6.65)
Seat 2: 5uy3EN+iIYkgwbWZFTUBAQ (big blind) folded before Flop
Seat 3: TalCiLYHCd+ffkmR3auPvA folded before Flop (didn't bet)
Seat 5: j7NIOHLZk7V2o9fOioO5ug folded before Flop (didn't bet)
Seat 6: 4OO5v3AVduL0tePNx8wk5A (button) folded on the Turn



PokerStars Game #59940544696:  Hold'em No Limit ($0.50/$1.00) - 2009/07/01 1:09:39 ET
Table 'GPp0HyAuggN8oE0sUWzPpA' 9-max Seat #8 is the button
Seat 1: qJr25HAtvv1w/7IBvjMM3g ($42.70 in chips)
Seat 2: m3U8I35Pn3gxKhoS2nmYIg ($39.55 in chips)
Seat 3: CCCXsirC+bO7ginAuUUVlQ ($49.35 in chips)
Seat 4: mBRWbnUl8diyBO1qTJaNzw ($107.65 in chips)
Seat 6: BK/GtNPkSx0TdUDj82id5A ($16.35 in chips)
Seat 7: DHdbHyysD15wCAtx+BhUjA ($93.50 in chips)
Seat 8: 6DBvLniKMJADk/t5l29oMA ($23.65 in chips)
Seat 9: dzoSjPZmtjGuK83119030A ($34.65 in chips)
dzoSjPZmtjGuK83119030A: posts small blind $0.50
qJr25HAtvv1w/7IBvjMM3g: posts big blind $1
bLbSOSmSOnqE0iTcH/5dxA: sits out
*** HOLE CARDS ***
m3U8I35Pn3gxKhoS2nmYIg: folds
CCCXsirC+bO7ginAuUUVlQ: folds
mBRWbnUl8diyBO1qTJaNzw: raises $3 to $4
BK/GtNPkSx0TdUDj82id5A: folds
DHdbHyysD15wCAtx+BhUjA: folds
6DBvLniKMJADk/t5l29oMA: folds
dzoSjPZmtjGuK83119030A: folds
6DBvLniKMJADk/t5l29oMA leaves the table
qJr25HAtvv1w/7IBvjMM3g: raises $8 to $12
mBRWbnUl8diyBO1qTJaNzw: folds
qJr25HAtvv1w/7IBvjMM3g collected $8.50 from pot
*** SUMMARY ***
Total pot $8.50 | Rake $0
Seat 1: qJr25HAtvv1w/7IBvjMM3g (big blind) collected ($8.50)
Seat 2: m3U8I35Pn3gxKhoS2nmYIg folded before Flop (didn't bet)
Seat 3: CCCXsirC+bO7ginAuUUVlQ folded before Flop (didn't bet)
Seat 4: mBRWbnUl8diyBO1qTJaNzw folded before Flop
Seat 6: BK/GtNPkSx0TdUDj82id5A folded before Flop (didn't bet)
Seat 7: DHdbHyysD15wCAtx+BhUjA folded before Flop (didn't bet)
Seat 8: 6DBvLniKMJADk/t5l29oMA (button) folded before Flop (didn't bet)
Seat 9: dzoSjPZmtjGuK83119030A (small blind) folded before Flop



PokerStars Game #59940545856:  Hold'em No Limit ($0.50/$1.00) - 2009/07/01 1:09:41 ET
Table 'hdVBCnDy5t2X9dZo0AvD9w' 9-max Seat #5 is the button
Seat 1: sa/cZBFh73L9TapFXpn3BA ($66.10 in chips)
Seat 2: Ogn4JDV3mp4ZDKO49IFzKA ($22 in chips)
Seat 3: 1862487932 ($100 in chips)
Seat 4: YvSugbFKWSuAYx9iokQwUQ ($70 in chips)
Seat 5: H+DVy3Ei8L1UKS2tVOtJcw ($100 in chips)
Seat 6: bJckevFOcg//s0qyMQI6sQ ($100.50 in chips)
Seat 7: KqC3XiX79XzqwhoOYPVb4w ($164.55 in chips)
Seat 8: gUUvmqdVlmvpal6B8nYrmg ($140.90 in chips)
Seat 9: AMkLbywdoc0K30BTzaIfTQ ($187.90 in chips)
bJckevFOcg//s0qyMQI6sQ: posts small blind $0.50
KqC3XiX79XzqwhoOYPVb4w: posts big blind $1
*** HOLE CARDS ***
gUUvmqdVlmvpal6B8nYrmg: folds
AMkLbywdoc0K30BTzaIfTQ: folds
sa/cZBFh73L9TapFXpn3BA: raises $1 to $2
Ogn4JDV3mp4ZDKO49IFzKA: folds
1862487932: folds
YvSugbFKWSuAYx9iokQwUQ: folds
H+DVy3Ei8L1UKS2tVOtJcw: folds
bJckevFOcg//s0qyMQI6sQ: folds
KqC3XiX79XzqwhoOYPVb4w: folds
sa/cZBFh73L9TapFXpn3BA collected $2.50 from pot
*** SUMMARY ***
Total pot $2.50 | Rake $0
Seat 1: sa/cZBFh73L9TapFXpn3BA collected ($2.50)
Seat 2: Ogn4JDV3mp4ZDKO49IFzKA folded before Flop (didn't bet)
Seat 3: 1862487932 folded before Flop (didn't bet)
Seat 4: YvSugbFKWSuAYx9iokQwUQ folded before Flop (didn't bet)
Seat 5: H+DVy3Ei8L1UKS2tVOtJcw (button) folded before Flop (didn't bet)
Seat 6: bJckevFOcg//s0qyMQI6sQ (small blind) folded before Flop
Seat 7: KqC3XiX79XzqwhoOYPVb4w (big blind) folded before Flop
Seat 8: gUUvmqdVlmvpal6B8nYrmg folded before Flop (didn't bet)
Seat 9: AMkLbywdoc0K30BTzaIfTQ folded before Flop (didn't bet)



PokerStars Game #59940547132:  Hold'em No Limit ($0.50/$1.00) - 2009/07/01 1:09:43 ET
Table '+cA8mcmhaedZ7YcrDdhmeQ' 6-max Seat #2 is the button
Seat 1: lsLuWlcPA3Rh7kJVLzMh0Q ($302.45 in chips)
Seat 2: RqgF7gRoKgRNW8Zoi1ty4A ($130.25 in chips)
Seat 3: DAIgyIWbYvAkL6PbAI27pg ($19 in chips)
Seat 4: 4OO5v3AVduL0tePNx8wk5A ($109.55 in chips)
Seat 5: +7hFKAL0b0O/n8G72TclJA ($136.20 in chips)
Seat 6: YfsTQsY/fxb+YqbdclTHuw ($17.10 in chips)
DAIgyIWbYvAkL6PbAI27pg: posts small blind $0.50
4OO5v3AVduL0tePNx8wk5A: posts big blind $1
*** HOLE CARDS ***
+7hFKAL0b0O/n8G72TclJA: folds
YfsTQsY/fxb+YqbdclTHuw: folds
lsLuWlcPA3Rh7kJVLzMh0Q: raises $2 to $3
RqgF7gRoKgRNW8Zoi1ty4A: folds
DAIgyIWbYvAkL6PbAI27pg: folds
4OO5v3AVduL0tePNx8wk5A: folds
lsLuWlcPA3Rh7kJVLzMh0Q collected $2.50 from pot
*** SUMMARY ***
Total pot $2.50 | Rake $0
Seat 1: lsLuWlcPA3Rh7kJVLzMh0Q collected ($2.50)
Seat 2: RqgF7gRoKgRNW8Zoi1ty4A (button) folded before Flop (didn't bet)
Seat 3: DAIgyIWbYvAkL6PbAI27pg (small blind) folded before Flop
Seat 4: 4OO5v3AVduL0tePNx8wk5A (big blind) folded before Flop
Seat 5: +7hFKAL0b0O/n8G72TclJA folded before Flop (didn't bet)
Seat 6: YfsTQsY/fxb+YqbdclTHuw folded before Flop (didn't bet)



PokerStars Game #59940548232:  Hold'em No Limit ($0.50/$1.00) - 2009/07/01 1:09:45 ET
Table 'QSIig7BLMc9wY/rgBechzw' 6-max Seat #3 is the button
Seat 1: Z2fXsGcjl+Eax+RzOgwOmg ($115 in chips)
Seat 2: mLOIkH/qmRa+mVujQIhBRg ($41.60 in chips)
Seat 3: +xW7QemQU0Fxs+4TnqBRow ($100 in chips)
Seat 4: +uSzP8Jwnw7sKfQ4s66b7w ($79.45 in chips)
Seat 5: lsLuWlcPA3Rh7kJVLzMh0Q ($101 in chips)
Seat 6: PxqfkAMdAWtkgbT+q2gciA ($35.75 in chips)
+uSzP8Jwnw7sKfQ4s66b7w: posts small blind $0.50
lsLuWlcPA3Rh7kJVLzMh0Q: posts big blind $1
*** HOLE CARDS ***
PxqfkAMdAWtkgbT+q2gciA: folds
Z2fXsGcjl+Eax+RzOgwOmg: folds
mLOIkH/qmRa+mVujQIhBRg: calls $1
+xW7QemQU0Fxs+4TnqBRow: folds
+uSzP8Jwnw7sKfQ4s66b7w: calls $0.50
lsLuWlcPA3Rh7kJVLzMh0Q: checks
*** FLOP *** [3d 7h 8d]
+uSzP8Jwnw7sKfQ4s66b7w: checks
lsLuWlcPA3Rh7kJVLzMh0Q: checks
mLOIkH/qmRa+mVujQIhBRg: checks
*** TURN *** [3d 7h 8d] [5d]
+uSzP8Jwnw7sKfQ4s66b7w: checks
lsLuWlcPA3Rh7kJVLzMh0Q: checks
mLOIkH/qmRa+mVujQIhBRg: checks
*** RIVER *** [3d 7h 8d 5d] [9d]
+uSzP8Jwnw7sKfQ4s66b7w: checks
lsLuWlcPA3Rh7kJVLzMh0Q: bets $1
mLOIkH/qmRa+mVujQIhBRg: folds
+uSzP8Jwnw7sKfQ4s66b7w: folds
lsLuWlcPA3Rh7kJVLzMh0Q collected $2.85 from pot
lsLuWlcPA3Rh7kJVLzMh0Q: doesn't show hand
*** SUMMARY ***
Total pot $3 | Rake $0.15
Board [3d 7h 8d 5d 9d]
Seat 1: Z2fXsGcjl+Eax+RzOgwOmg folded before Flop (didn't bet)
Seat 2: mLOIkH/qmRa+mVujQIhBRg folded on the River
Seat 3: +xW7QemQU0Fxs+4TnqBRow (button) folded before Flop (didn't bet)
Seat 4: +uSzP8Jwnw7sKfQ4s66b7w (small blind) folded on the River
Seat 5: lsLuWlcPA3Rh7kJVLzMh0Q (big blind) collected ($2.85)
Seat 6: PxqfkAMdAWtkgbT+q2gciA folded before Flop (didn't bet)



PokerStars Game #59940550970:  Hold'em No Limit ($0.50/$1.00) - 2009/07/01 1:09:50 ET
Table 'N2bNCDHL96aCQDvZIh+yQQ' 6-max Seat #2 is the button
Seat 2: TIB5eSBJLz62w6yz2+yeKw ($104.30 in chips)
Seat 3: Qy/UBNbD2HaA0Ogxg8Sf3w ($236 in chips)
Seat 4: uCqEjnxh2/vFBjKYkfTOkw ($197.95 in chips)
Seat 5: 8OEJHwpMpZZfyaTpXEDFfw ($10.05 in chips)
Qy/UBNbD2HaA0Ogxg8Sf3w: posts small blind $0.50
uCqEjnxh2/vFBjKYkfTOkw: posts big blind $1
*** HOLE CARDS ***
8OEJHwpMpZZfyaTpXEDFfw: calls $1
TIB5eSBJLz62w6yz2+yeKw: folds
Qy/UBNbD2HaA0Ogxg8Sf3w: folds
uCqEjnxh2/vFBjKYkfTOkw: checks
*** FLOP *** [7c 5s Ks]
uCqEjnxh2/vFBjKYkfTOkw: checks
8OEJHwpMpZZfyaTpXEDFfw: checks
*** TURN *** [7c 5s Ks] [Td]
uCqEjnxh2/vFBjKYkfTOkw: checks
8OEJHwpMpZZfyaTpXEDFfw: checks
*** RIVER *** [7c 5s Ks Td] [3s]
uCqEjnxh2/vFBjKYkfTOkw: checks
8OEJHwpMpZZfyaTpXEDFfw: checks
*** SHOW DOWN ***
uCqEjnxh2/vFBjKYkfTOkw: shows [3c 4c] (a pair of Threes)
8OEJHwpMpZZfyaTpXEDFfw: shows [Tc Ah] (a pair of Tens)
8OEJHwpMpZZfyaTpXEDFfw collected $2.40 from pot
*** SUMMARY ***
Total pot $2.50 | Rake $0.10
Board [7c 5s Ks Td 3s]
Seat 2: TIB5eSBJLz62w6yz2+yeKw (button) folded before Flop (didn't bet)
Seat 3: Qy/UBNbD2HaA0Ogxg8Sf3w (small blind) folded before Flop
Seat 4: uCqEjnxh2/vFBjKYkfTOkw (big blind) showed [3c 4c] and lost with a pair of Threes
Seat 5: 8OEJHwpMpZZfyaTpXEDFfw showed [Tc Ah] and won ($2.40) with a pair of Tens



PokerStars Game #59940550928:  Hold'em No Limit ($0.50/$1.00) - 2009/07/01 1:09:50 ET
Table 'GxCPo/gd3OSthkYrAxJngg' 6-max Seat #6 is the button
Seat 1: sH8BpAFP+jGFxCgVpD1Lew ($267.40 in chips)
Seat 3: o6plE+MSW4XFNTeONe16xg ($20 in chips)
Seat 4: YMJG+F++3Aj6P8dAWda5fw ($202.25 in chips)
Seat 5: G5ZSSN6RSON3gkNvk/SmYg ($116.10 in chips)
Seat 6: 4d1rWhpu8DzLmzMbR3QKyA ($102.70 in chips)
sH8BpAFP+jGFxCgVpD1Lew: posts small blind $0.50
o6plE+MSW4XFNTeONe16xg: posts big blind $1
*** HOLE CARDS ***
YMJG+F++3Aj6P8dAWda5fw: folds
G5ZSSN6RSON3gkNvk/SmYg: folds
4d1rWhpu8DzLmzMbR3QKyA: raises $2 to $3
sH8BpAFP+jGFxCgVpD1Lew: folds
o6plE+MSW4XFNTeONe16xg: folds
4d1rWhpu8DzLmzMbR3QKyA collected $2.50 from pot
*** SUMMARY ***
Total pot $2.50 | Rake $0
Seat 1: sH8BpAFP+jGFxCgVpD1Lew (small blind) folded before Flop
Seat 3: o6plE+MSW4XFNTeONe16xg (big blind) folded before Flop
Seat 4: YMJG+F++3Aj6P8dAWda5fw folded before Flop (didn't bet)
Seat 5: G5ZSSN6RSON3gkNvk/SmYg folded before Flop (didn't bet)
Seat 6: 4d1rWhpu8DzLmzMbR3QKyA (button) collected ($2.50)



PokerStars Game #59940551786:  Hold'em No Limit ($0.50/$1.00) - 2009/07/01 1:09:51 ET
Table 'JTT1XWaDZHSaMZQK7cR5uw' 2-max Seat #1 is the button
Seat 1: OLplZF6FEnLflv81Hz+Fxg ($128.95 in chips)
Seat 2: BcqgegiOUxmBD3F3umsljg ($76.95 in chips)
OLplZF6FEnLflv81Hz+Fxg: posts small blind $0.50
BcqgegiOUxmBD3F3umsljg: posts big blind $1
*** HOLE CARDS ***
OLplZF6FEnLflv81Hz+Fxg: raises $2 to $3
BcqgegiOUxmBD3F3umsljg: folds
OLplZF6FEnLflv81Hz+Fxg collected $2 from pot
*** SUMMARY ***
Total pot $2 | Rake $0
Seat 1: OLplZF6FEnLflv81Hz+Fxg (button) (small blind) collected ($2)
Seat 2: BcqgegiOUxmBD3F3umsljg (big blind) folded before Flop



PokerStars Game #59940554182:  Hold'em No Limit ($0.50/$1.00) - 2009/07/01 1:09:55 ET
Table 'O96CPOtvMBWP6kzuYDfdFA' 6-max Seat #6 is the button
Seat 1: 6alLXQIITA2EZ/lBeym8Dw ($120.05 in chips)
Seat 2: 4d1rWhpu8DzLmzMbR3QKyA ($100 in chips)
Seat 4: /P4w1pHg2zHYg/4ubJ0dPw ($62.05 in chips)
Seat 5: G5ZSSN6RSON3gkNvk/SmYg ($100 in chips)
Seat 6: GYei5jXGWexiJYbAT2fELg ($43.50 in chips)
6alLXQIITA2EZ/lBeym8Dw: posts small blind $0.50
4d1rWhpu8DzLmzMbR3QKyA: posts big blind $1
*** HOLE CARDS ***
/P4w1pHg2zHYg/4ubJ0dPw: folds
G5ZSSN6RSON3gkNvk/SmYg: folds
GYei5jXGWexiJYbAT2fELg: calls $1
6alLXQIITA2EZ/lBeym8Dw: folds
4d1rWhpu8DzLmzMbR3QKyA: checks
*** FLOP *** [Ad Jd 9h]
4d1rWhpu8DzLmzMbR3QKyA: checks
GYei5jXGWexiJYbAT2fELg: checks
*** TURN *** [Ad Jd 9h] [Td]
4d1rWhpu8DzLmzMbR3QKyA: checks
GYei5jXGWexiJYbAT2fELg: bets $2
4d1rWhpu8DzLmzMbR3QKyA: folds
GYei5jXGWexiJYbAT2fELg collected $2.40 from pot
*** SUMMARY ***
Total pot $2.50 | Rake $0.10
Board [Ad Jd 9h Td]
Seat 1: 6alLXQIITA2EZ/lBeym8Dw (small blind) folded before Flop
Seat 2: 4d1rWhpu8DzLmzMbR3QKyA (big blind) folded on the Turn
Seat 4: /P4w1pHg2zHYg/4ubJ0dPw folded before Flop (didn't bet)
Seat 5: G5ZSSN6RSON3gkNvk/SmYg folded before Flop (didn't bet)
Seat 6: GYei5jXGWexiJYbAT2fELg (button) collected ($2.40)



PokerStars Game #59940555544:  Hold'em No Limit ($0.50/$1.00) - 2009/07/01 1:09:57 ET
Table 'mmbQQVBTrPdE+wy+s+9VPA' 6-max Seat #5 is the button
Seat 1: zyP4SPoWZnKUfTvIRLCVog ($71.55 in chips)
Seat 3: wx3sQGkVi2x9wJXuWNHPBw ($111.15 in chips)
Seat 4: V3iZdcw61nXF3g5hD2RrsQ ($122.40 in chips)
Seat 5: YMJG+F++3Aj6P8dAWda5fw ($103.60 in chips)
Seat 6: U2CWBTv29qdCbj8RNF2sIw ($97 in chips)
U2CWBTv29qdCbj8RNF2sIw: posts small blind $0.50
zyP4SPoWZnKUfTvIRLCVog: posts big blind $1
XK4Qsl+DA8gAJyg85/zBIw: sits out
*** HOLE CARDS ***
wx3sQGkVi2x9wJXuWNHPBw: folds
V3iZdcw61nXF3g5hD2RrsQ: raises $2 to $3
YMJG+F++3Aj6P8dAWda5fw: folds
U2CWBTv29qdCbj8RNF2sIw: raises $7 to $10
zyP4SPoWZnKUfTvIRLCVog: folds
V3iZdcw61nXF3g5hD2RrsQ: calls $7
*** FLOP *** [3h 4c 2d]
U2CWBTv29qdCbj8RNF2sIw: bets $13
V3iZdcw61nXF3g5hD2RrsQ: folds
U2CWBTv29qdCbj8RNF2sIw collected $19.95 from pot
*** SUMMARY ***
Total pot $21 | Rake $1.05
Board [3h 4c 2d]
Seat 1: zyP4SPoWZnKUfTvIRLCVog (big blind) folded before Flop
Seat 3: wx3sQGkVi2x9wJXuWNHPBw folded before Flop (didn't bet)
Seat 4: V3iZdcw61nXF3g5hD2RrsQ folded on the Flop
Seat 5: YMJG+F++3Aj6P8dAWda5fw (button) folded before Flop (didn't bet)
Seat 6: U2CWBTv29qdCbj8RNF2sIw (small blind) collected ($19.95)



PokerStars Game #59940555230:  Hold'em No Limit ($0.50/$1.00) - 2009/07/01 1:09:57 ET
Table 'hugOjcwJvzEwZbK7tyiWuQ' 9-max Seat #9 is the button
Seat 2: r27C1nIV4NS4+qbnrgBQSw ($282.20 in chips)
Seat 4: UWB3oeddt/GObx2Mix2Anw ($169 in chips)
Seat 5: 5BRGWf+R3nt2WS3b5xX+zA ($16.75 in chips)
Seat 6: gUUvmqdVlmvpal6B8nYrmg ($103.90 in chips)
Seat 7: FL3MrLspcF23LYvC4ipBOA ($110.30 in chips)
Seat 8: /zy+DB4S5fUQUSfZWFzYGw ($109.55 in chips)
Seat 9: W8P9bUKCs43TO1xHm0dL6w ($89.45 in chips)
S3Ex8K7v6xm5jqjRM7Fl3w will be allowed to play after the button
r27C1nIV4NS4+qbnrgBQSw: posts small blind $0.50
jDwhY1kCdc6EkAHbT7PJMQ: is sitting out
UWB3oeddt/GObx2Mix2Anw: posts big blind $1
*** HOLE CARDS ***
5BRGWf+R3nt2WS3b5xX+zA: folds
gUUvmqdVlmvpal6B8nYrmg: folds
FL3MrLspcF23LYvC4ipBOA: folds
/zy+DB4S5fUQUSfZWFzYGw: raises $2 to $3
W8P9bUKCs43TO1xHm0dL6w: folds
r27C1nIV4NS4+qbnrgBQSw: folds
UWB3oeddt/GObx2Mix2Anw: folds
jDwhY1kCdc6EkAHbT7PJMQ leaves the table
/zy+DB4S5fUQUSfZWFzYGw collected $2.50 from pot
*** SUMMARY ***
Total pot $2.50 | Rake $0
Seat 2: r27C1nIV4NS4+qbnrgBQSw (small blind) folded before Flop
Seat 4: UWB3oeddt/GObx2Mix2Anw (big blind) folded before Flop
Seat 5: 5BRGWf+R3nt2WS3b5xX+zA folded before Flop (didn't bet)
Seat 6: gUUvmqdVlmvpal6B8nYrmg folded before Flop (didn't bet)
Seat 7: FL3MrLspcF23LYvC4ipBOA folded before Flop (didn't bet)
Seat 8: /zy+DB4S5fUQUSfZWFzYGw collected ($2.50)
Seat 9: W8P9bUKCs43TO1xHm0dL6w (button) folded before Flop (didn't bet)



PokerStars Game #59940555716:  Hold'em No Limit ($0.50/$1.00) - 2009/07/01 1:09:58 ET
Table 'kS0cTQAEi+fdUlJP2gQYvw' 9-max Seat #1 is the button
Seat 1: c/9X4zftzphFxYtxp5kp9w ($62.85 in chips)
Seat 2: D+W9Me7w6Hcx/WRUSKV0dw ($21.40 in chips)
Seat 3: 2BV+oJIQYr65IO6nEChvbA ($60 in chips)
Seat 5: 997ViqAtWn1FPjJqcffwcA ($102.65 in chips)
Seat 6: yAbu2QsRPVcjPbqlf/jDxw ($128.15 in chips)
Seat 7: Ffa7Nj4X5fddtROP01hfQg ($153.25 in chips)
Seat 9: OGgaARGdJQT4awWVNQ957w ($101.50 in chips)
D+W9Me7w6Hcx/WRUSKV0dw: posts small blind $0.50
2BV+oJIQYr65IO6nEChvbA: posts big blind $1
*** HOLE CARDS ***
997ViqAtWn1FPjJqcffwcA: folds
yAbu2QsRPVcjPbqlf/jDxw: raises $3 to $4
Ffa7Nj4X5fddtROP01hfQg: folds
OGgaARGdJQT4awWVNQ957w: folds
c/9X4zftzphFxYtxp5kp9w: folds
D+W9Me7w6Hcx/WRUSKV0dw: folds
2BV+oJIQYr65IO6nEChvbA: folds
yAbu2QsRPVcjPbqlf/jDxw collected $2.50 from pot
yAbu2QsRPVcjPbqlf/jDxw: doesn't show hand
*** SUMMARY ***
Total pot $2.50 | Rake $0
Seat 1: c/9X4zftzphFxYtxp5kp9w (button) folded before Flop (didn't bet)
Seat 2: D+W9Me7w6Hcx/WRUSKV0dw (small blind) folded before Flop
Seat 3: 2BV+oJIQYr65IO6nEChvbA (big blind) folded before Flop
Seat 5: 997ViqAtWn1FPjJqcffwcA folded before Flop (didn't bet)
Seat 6: yAbu2QsRPVcjPbqlf/jDxw collected ($2.50)
Seat 7: Ffa7Nj4X5fddtROP01hfQg folded before Flop (didn't bet)
Seat 9: OGgaARGdJQT4awWVNQ957w folded before Flop (didn't bet)



PokerStars Game #59940557514:  Hold'em No Limit ($0.50/$1.00) - 2009/07/01 1:10:01 ET
Table 'JTT1XWaDZHSaMZQK7cR5uw' 2-max Seat #2 is the button
Seat 1: OLplZF6FEnLflv81Hz+Fxg ($129.95 in chips)
Seat 2: BcqgegiOUxmBD3F3umsljg ($75.95 in chips)
BcqgegiOUxmBD3F3umsljg: posts small blind $0.50
OLplZF6FEnLflv81Hz+Fxg: posts big blind $1
*** HOLE CARDS ***
BcqgegiOUxmBD3F3umsljg: calls $0.50
OLplZF6FEnLflv81Hz+Fxg: raises $4 to $5
BcqgegiOUxmBD3F3umsljg: folds
OLplZF6FEnLflv81Hz+Fxg collected $2 from pot
*** SUMMARY ***
Total pot $2 | Rake $0
Seat 1: OLplZF6FEnLflv81Hz+Fxg (big blind) collected ($2)
Seat 2: BcqgegiOUxmBD3F3umsljg (button) (small blind) folded before Flop



PokerStars Game #59940557542:  Hold'em No Limit ($0.50/$1.00) - 2009/07/01 1:10:01 ET
Table 'cKH9c4x6u79IqCdaKKvXrw' 9-max Seat #6 is the button
Seat 1: Pp/KTcXkfZKKUHkjyaLTdg ($18.50 in chips)
Seat 2: 8S3JMH4TY3whgIlZmMv66w ($75.55 in chips)
Seat 3: 997ViqAtWn1FPjJqcffwcA ($155.60 in chips)
Seat 5: Jjc7EHWzs4//xUAjJ0UWoA ($44.40 in chips)
Seat 6: Bsd/K5gAcLanYbGiPirRjw ($201.05 in chips)
Seat 7: 1GkkVBhlJ92guE6K5mS5Ig ($17.10 in chips)
Seat 8: myIxN7otsyr846M539YR8Q ($17 in chips)
Seat 9: 6XkTu4ahxzHnvjjc1R8YjQ ($41.60 in chips)
1GkkVBhlJ92guE6K5mS5Ig: posts small blind $0.50
myIxN7otsyr846M539YR8Q: posts big blind $1
*** HOLE CARDS ***
6XkTu4ahxzHnvjjc1R8YjQ: folds
FL3MrLspcF23LYvC4ipBOA has returned
Pp/KTcXkfZKKUHkjyaLTdg: raises $2.50 to $3.50
8S3JMH4TY3whgIlZmMv66w: folds
997ViqAtWn1FPjJqcffwcA: folds
Jjc7EHWzs4//xUAjJ0UWoA: folds
Bsd/K5gAcLanYbGiPirRjw: folds
1GkkVBhlJ92guE6K5mS5Ig: folds
myIxN7otsyr846M539YR8Q: folds
Pp/KTcXkfZKKUHkjyaLTdg collected $2.50 from pot
Pp/KTcXkfZKKUHkjyaLTdg: doesn't show hand
*** SUMMARY ***
Total pot $2.50 | Rake $0
Seat 1: Pp/KTcXkfZKKUHkjyaLTdg collected ($2.50)
Seat 2: 8S3JMH4TY3whgIlZmMv66w folded before Flop (didn't bet)
Seat 3: 997ViqAtWn1FPjJqcffwcA folded before Flop (didn't bet)
Seat 5: Jjc7EHWzs4//xUAjJ0UWoA folded before Flop (didn't bet)
Seat 6: Bsd/K5gAcLanYbGiPirRjw (button) folded before Flop (didn't bet)
Seat 7: 1GkkVBhlJ92guE6K5mS5Ig (small blind) folded before Flop
Seat 8: myIxN7otsyr846M539YR8Q (big blind) folded before Flop
Seat 9: 6XkTu4ahxzHnvjjc1R8YjQ folded before Flop (didn't bet)



PokerStars Game #59940560168:  Hold'em No Limit ($0.50/$1.00) - 2009/07/01 1:10:05 ET
Table 'tJq9SfN1ywY0r03VBlWlwQ' 9-max Seat #4 is the button
Seat 1: wZsU+w9r7G66x93UuvBf1Q ($335.30 in chips)
Seat 3: FVs16t7GgfWgQWt4JxsObQ ($26.10 in chips)
Seat 4: bLbSOSmSOnqE0iTcH/5dxA ($110.70 in chips)
Seat 5: h5ipsNTMyolp7xn/NAvWkA ($79 in chips)
Seat 6: gUUvmqdVlmvpal6B8nYrmg ($120.20 in chips)
Seat 8: G4DEhsZFmznGNVpy2SEocA ($29.90 in chips)
Seat 9: XE5QF1y74bpHog9JxWJMWQ ($100.50 in chips)
h5ipsNTMyolp7xn/NAvWkA: posts small blind $0.50
gUUvmqdVlmvpal6B8nYrmg: posts big blind $1
*** HOLE CARDS ***
G4DEhsZFmznGNVpy2SEocA: folds
XE5QF1y74bpHog9JxWJMWQ: folds
wZsU+w9r7G66x93UuvBf1Q: folds
FVs16t7GgfWgQWt4JxsObQ: calls $1
bLbSOSmSOnqE0iTcH/5dxA: folds
h5ipsNTMyolp7xn/NAvWkA: raises $2 to $3
gUUvmqdVlmvpal6B8nYrmg: calls $2
FVs16t7GgfWgQWt4JxsObQ: calls $2
*** FLOP *** [Th 6c 3c]
h5ipsNTMyolp7xn/NAvWkA: bets $4
gUUvmqdVlmvpal6B8nYrmg: folds
FVs16t7GgfWgQWt4JxsObQ: calls $4
*** TURN *** [Th 6c 3c] [5s]
h5ipsNTMyolp7xn/NAvWkA: bets $5
FVs16t7GgfWgQWt4JxsObQ: calls $5
*** RIVER *** [Th 6c 3c 5s] [6d]
h5ipsNTMyolp7xn/NAvWkA: bets $8
FVs16t7GgfWgQWt4JxsObQ: folds
h5ipsNTMyolp7xn/NAvWkA collected $25.70 from pot
*** SUMMARY ***
Total pot $27 | Rake $1.30
Board [Th 6c 3c 5s 6d]
Seat 1: wZsU+w9r7G66x93UuvBf1Q folded before Flop (didn't bet)
Seat 3: FVs16t7GgfWgQWt4JxsObQ folded on the River
Seat 4: bLbSOSmSOnqE0iTcH/5dxA (button) folded before Flop (didn't bet)
Seat 5: h5ipsNTMyolp7xn/NAvWkA (small blind) collected ($25.70)
Seat 6: gUUvmqdVlmvpal6B8nYrmg (big blind) folded on the Flop
Seat 8: G4DEhsZFmznGNVpy2SEocA folded before Flop (didn't bet)
Seat 9: XE5QF1y74bpHog9JxWJMWQ folded before Flop (didn't bet)



PokerStars Game #59940561100:  Hold'em No Limit ($0.50/$1.00) - 2009/07/01 1:10:07 ET
Table 'CASNP0uy1C+jGLml/I4PtA' 9-max Seat #4 is the button
Seat 1: tkdBeXTJlFsZdioidNqLow ($60 in chips)
Seat 3: bJckevFOcg//s0qyMQI6sQ ($100.90 in chips)
Seat 4: B/G0GJacqZ8K59/ZVdq4kQ ($55.10 in chips)
Seat 5: Jjc7EHWzs4//xUAjJ0UWoA ($13.50 in chips)
Seat 6: FJEywSpo5JbRKByzmweboA ($101.50 in chips)
Seat 8: L9njYvloJ1NdXjP8edHEAg ($100 in chips)
Seat 9: Pp/KTcXkfZKKUHkjyaLTdg ($20 in chips)
Jjc7EHWzs4//xUAjJ0UWoA: posts small blind $0.50
FJEywSpo5JbRKByzmweboA: posts big blind $1
S3Ex8K7v6xm5jqjRM7Fl3w: sits out
*** HOLE CARDS ***
L9njYvloJ1NdXjP8edHEAg: folds
Pp/KTcXkfZKKUHkjyaLTdg: raises $2.50 to $3.50
tkdBeXTJlFsZdioidNqLow: folds
bJckevFOcg//s0qyMQI6sQ: folds
B/G0GJacqZ8K59/ZVdq4kQ: folds
Jjc7EHWzs4//xUAjJ0UWoA: folds
FJEywSpo5JbRKByzmweboA: folds
Pp/KTcXkfZKKUHkjyaLTdg collected $2.50 from pot
*** SUMMARY ***
Total pot $2.50 | Rake $0
Seat 1: tkdBeXTJlFsZdioidNqLow folded before Flop (didn't bet)
Seat 3: bJckevFOcg//s0qyMQI6sQ folded before Flop (didn't bet)
Seat 4: B/G0GJacqZ8K59/ZVdq4kQ (button) folded before Flop (didn't bet)
Seat 5: Jjc7EHWzs4//xUAjJ0UWoA (small blind) folded before Flop
Seat 6: FJEywSpo5JbRKByzmweboA (big blind) folded before Flop
Seat 8: L9njYvloJ1NdXjP8edHEAg folded before Flop (didn't bet)
Seat 9: Pp/KTcXkfZKKUHkjyaLTdg collected ($2.50)



PokerStars Game #59940561436:  Hold'em No Limit ($0.50/$1.00) - 2009/07/01 1:10:08 ET
Table '+cA8mcmhaedZ7YcrDdhmeQ' 6-max Seat #3 is the button
Seat 1: lsLuWlcPA3Rh7kJVLzMh0Q ($303.95 in chips)
Seat 2: RqgF7gRoKgRNW8Zoi1ty4A ($130.25 in chips)
Seat 3: DAIgyIWbYvAkL6PbAI27pg ($18.50 in chips)
Seat 4: 4OO5v3AVduL0tePNx8wk5A ($108.55 in chips)
Seat 5: +7hFKAL0b0O/n8G72TclJA ($136.20 in chips)
Seat 6: YfsTQsY/fxb+YqbdclTHuw ($17.10 in chips)
4OO5v3AVduL0tePNx8wk5A: posts small blind $0.50
+7hFKAL0b0O/n8G72TclJA: posts big blind $1
*** HOLE CARDS ***
YfsTQsY/fxb+YqbdclTHuw: folds
lsLuWlcPA3Rh7kJVLzMh0Q: folds
RqgF7gRoKgRNW8Zoi1ty4A: folds
DAIgyIWbYvAkL6PbAI27pg: folds
4OO5v3AVduL0tePNx8wk5A: raises $2 to $3
+7hFKAL0b0O/n8G72TclJA: folds
4OO5v3AVduL0tePNx8wk5A collected $2 from pot
*** SUMMARY ***
Total pot $2 | Rake $0
Seat 1: lsLuWlcPA3Rh7kJVLzMh0Q folded before Flop (didn't bet)
Seat 2: RqgF7gRoKgRNW8Zoi1ty4A folded before Flop (didn't bet)
Seat 3: DAIgyIWbYvAkL6PbAI27pg (button) folded before Flop (didn't bet)
Seat 4: 4OO5v3AVduL0tePNx8wk5A (small blind) collected ($2)
Seat 5: +7hFKAL0b0O/n8G72TclJA (big blind) folded before Flop
Seat 6: YfsTQsY/fxb+YqbdclTHuw folded before Flop (didn't bet)



PokerStars Game #59940561926:  Hold'em No Limit ($0.50/$1.00) - 2009/07/01 1:10:09 ET
Table 'VOs36P6NW+QyXeQ1B62kmA' 6-max Seat #6 is the button
Seat 1: Z2fXsGcjl+Eax+RzOgwOmg ($100.50 in chips)
Seat 2: 2UMlbaZ8n8AbRli0Yr0mDw ($36.10 in chips)
Seat 4: w02zQzNydODiyV9THKgo9w ($47.60 in chips)
Seat 5: ozrlafxxh1HmYdA0/h+MuA ($42.90 in chips)
Seat 6: slVKuQyEz8Qj4E3uLPYNXg ($102 in chips)
Z2fXsGcjl+Eax+RzOgwOmg: posts small blind $0.50
2UMlbaZ8n8AbRli0Yr0mDw: posts big blind $1
FyNUCpzHVyQu/qX8pqNQFA: sits out
*** HOLE CARDS ***
w02zQzNydODiyV9THKgo9w: folds
ozrlafxxh1HmYdA0/h+MuA: folds
slVKuQyEz8Qj4E3uLPYNXg: raises $2 to $3
Z2fXsGcjl+Eax+RzOgwOmg: folds
2UMlbaZ8n8AbRli0Yr0mDw: calls $2
*** FLOP *** [8s 3c Jh]
2UMlbaZ8n8AbRli0Yr0mDw: checks
slVKuQyEz8Qj4E3uLPYNXg: bets $4
2UMlbaZ8n8AbRli0Yr0mDw: calls $4
*** TURN *** [8s 3c Jh] [2h]
2UMlbaZ8n8AbRli0Yr0mDw: checks
slVKuQyEz8Qj4E3uLPYNXg: bets $13
2UMlbaZ8n8AbRli0Yr0mDw has timed out
2UMlbaZ8n8AbRli0Yr0mDw: folds
2UMlbaZ8n8AbRli0Yr0mDw is sitting out
2UMlbaZ8n8AbRli0Yr0mDw has returned
slVKuQyEz8Qj4E3uLPYNXg collected $13.80 from pot
slVKuQyEz8Qj4E3uLPYNXg: doesn't show hand
*** SUMMARY ***
Total pot $14.50 | Rake $0.70
Board [8s 3c Jh 2h]
Seat 1: Z2fXsGcjl+Eax+RzOgwOmg (small blind) folded before Flop
Seat 2: 2UMlbaZ8n8AbRli0Yr0mDw (big blind) folded on the Turn
Seat 4: w02zQzNydODiyV9THKgo9w folded before Flop (didn't bet)
Seat 5: ozrlafxxh1HmYdA0/h+MuA folded before Flop (didn't bet)
Seat 6: slVKuQyEz8Qj4E3uLPYNXg (button) collected ($13.80)



PokerStars Game #59940563884:  Hold'em No Limit ($0.50/$1.00) - 2009/07/01 1:10:12 ET
Table 'JTT1XWaDZHSaMZQK7cR5uw' 2-max Seat #1 is the button
Seat 1: OLplZF6FEnLflv81Hz+Fxg ($130.95 in chips)
Seat 2: BcqgegiOUxmBD3F3umsljg ($74.95 in chips)
OLplZF6FEnLflv81Hz+Fxg: posts small blind $0.50
BcqgegiOUxmBD3F3umsljg: posts big blind $1
*** HOLE CARDS ***
OLplZF6FEnLflv81Hz+Fxg: raises $2 to $3
BcqgegiOUxmBD3F3umsljg: calls $2
*** FLOP *** [Qc Ah Jc]
BcqgegiOUxmBD3F3umsljg: bets $3
OLplZF6FEnLflv81Hz+Fxg: calls $3
*** TURN *** [Qc Ah Jc] [2d]
BcqgegiOUxmBD3F3umsljg: bets $3
OLplZF6FEnLflv81Hz+Fxg: calls $3
*** RIVER *** [Qc Ah Jc 2d] [Qd]
BcqgegiOUxmBD3F3umsljg: checks
OLplZF6FEnLflv81Hz+Fxg: bets $14
BcqgegiOUxmBD3F3umsljg: calls $14
*** SHOW DOWN ***
OLplZF6FEnLflv81Hz+Fxg: shows [4s Qs] (three of a kind, Queens)
BcqgegiOUxmBD3F3umsljg: mucks hand
OLplZF6FEnLflv81Hz+Fxg collected $45.50 from pot
*** SUMMARY ***
Total pot $46 | Rake $0.50
Board [Qc Ah Jc 2d Qd]
Seat 1: OLplZF6FEnLflv81Hz+Fxg (button) (small blind) showed [4s Qs] and won ($45.50) with three of a kind, Queens
Seat 2: BcqgegiOUxmBD3F3umsljg (big blind) mucked



PokerStars Game #59940563952:  Hold'em No Limit ($0.50/$1.00) - 2009/07/01 1:10:12 ET
Table 'N2bNCDHL96aCQDvZIh+yQQ' 6-max Seat #3 is the button
Seat 2: TIB5eSBJLz62w6yz2+yeKw ($104.30 in chips)
Seat 3: Qy/UBNbD2HaA0Ogxg8Sf3w ($235.50 in chips)
Seat 4: uCqEjnxh2/vFBjKYkfTOkw ($196.95 in chips)
Seat 5: 8OEJHwpMpZZfyaTpXEDFfw ($11.45 in chips)
uCqEjnxh2/vFBjKYkfTOkw: posts small blind $0.50
8OEJHwpMpZZfyaTpXEDFfw: posts big blind $1
*** HOLE CARDS ***
TIB5eSBJLz62w6yz2+yeKw: folds
Qy/UBNbD2HaA0Ogxg8Sf3w: folds
uCqEjnxh2/vFBjKYkfTOkw: calls $0.50
8OEJHwpMpZZfyaTpXEDFfw: checks
*** FLOP *** [4c 6c 3h]
uCqEjnxh2/vFBjKYkfTOkw: checks
8OEJHwpMpZZfyaTpXEDFfw: bets $4
uCqEjnxh2/vFBjKYkfTOkw: calls $4
*** TURN *** [4c 6c 3h] [As]
UU/mxjS3TL57GLD6iS6FPw joins the table at seat #6
uCqEjnxh2/vFBjKYkfTOkw: checks
8OEJHwpMpZZfyaTpXEDFfw: checks
*** RIVER *** [4c 6c 3h As] [Tc]
uCqEjnxh2/vFBjKYkfTOkw: bets $7
8OEJHwpMpZZfyaTpXEDFfw: folds
uCqEjnxh2/vFBjKYkfTOkw collected $9.55 from pot
uCqEjnxh2/vFBjKYkfTOkw: doesn't show hand
*** SUMMARY ***
Total pot $10 | Rake $0.45
Board [4c 6c 3h As Tc]
Seat 2: TIB5eSBJLz62w6yz2+yeKw folded before Flop (didn't bet)
Seat 3: Qy/UBNbD2HaA0Ogxg8Sf3w (button) folded before Flop (didn't bet)
Seat 4: uCqEjnxh2/vFBjKYkfTOkw (small blind) collected ($9.55)
Seat 5: 8OEJHwpMpZZfyaTpXEDFfw (big blind) folded on the River



PokerStars Game #59940566054:  Hold'em No Limit ($0.50/$1.00) - 2009/07/01 1:10:15 ET
Table 'fZjVbKj9D8yOB+Rj7NaP/A' 9-max Seat #1 is the button
Seat 1: Oh57946S8OPACStkrhQm7g ($126 in chips)
Seat 2: PTAFYDIUSsG+SArbxNl+Aw ($112.50 in chips)
Seat 3: yAbu2QsRPVcjPbqlf/jDxw ($104 in chips)
Seat 5: PkGfq5xrSlNsujKaG/HF4Q ($100 in chips)
Seat 6: OvwYHV65yUbgdBjSmo1+5g ($33.10 in chips)
Seat 7: SyS20PAm3RpT6uLBsGkwOA ($113.25 in chips)
Seat 9: qheQay5YvP2DMAb3OUSxtw ($99 in chips)
PTAFYDIUSsG+SArbxNl+Aw: posts small blind $0.50
yAbu2QsRPVcjPbqlf/jDxw: posts big blind $1
997ViqAtWn1FPjJqcffwcA: sits out
zDOE5r14tWqCf6xhuSHK6g: sits out
*** HOLE CARDS ***
PkGfq5xrSlNsujKaG/HF4Q: folds
OvwYHV65yUbgdBjSmo1+5g: calls $1
SyS20PAm3RpT6uLBsGkwOA: folds
qheQay5YvP2DMAb3OUSxtw: folds
Oh57946S8OPACStkrhQm7g: folds
PTAFYDIUSsG+SArbxNl+Aw: folds
Oh57946S8OPACStkrhQm7g leaves the table
yAbu2QsRPVcjPbqlf/jDxw: checks
*** FLOP *** [7s 2h Jd]
yAbu2QsRPVcjPbqlf/jDxw: checks
Oh57946S8OPACStkrhQm7g joins the table at seat #1
OvwYHV65yUbgdBjSmo1+5g: bets $3
yAbu2QsRPVcjPbqlf/jDxw: folds
OvwYHV65yUbgdBjSmo1+5g collected $2.40 from pot
*** SUMMARY ***
Total pot $2.50 | Rake $0.10
Board [7s 2h Jd]
Seat 1: Oh57946S8OPACStkrhQm7g (button) folded before Flop (didn't bet)
Seat 2: PTAFYDIUSsG+SArbxNl+Aw (small blind) folded before Flop
Seat 3: yAbu2QsRPVcjPbqlf/jDxw (big blind) folded on the Flop
Seat 5: PkGfq5xrSlNsujKaG/HF4Q folded before Flop (didn't bet)
Seat 6: OvwYHV65yUbgdBjSmo1+5g collected ($2.40)
Seat 7: SyS20PAm3RpT6uLBsGkwOA folded before Flop (didn't bet)
Seat 9: qheQay5YvP2DMAb3OUSxtw folded before Flop (didn't bet)



PokerStars Game #59940566064:  Hold'em No Limit ($0.50/$1.00) - 2009/07/01 1:10:15 ET
Table 'hdVBCnDy5t2X9dZo0AvD9w' 9-max Seat #6 is the button
Seat 1: sa/cZBFh73L9TapFXpn3BA ($67.60 in chips)
Seat 2: Ogn4JDV3mp4ZDKO49IFzKA ($22 in chips)
Seat 3: 1862487932 ($100 in chips)
Seat 4: YvSugbFKWSuAYx9iokQwUQ ($70 in chips)
Seat 5: H+DVy3Ei8L1UKS2tVOtJcw ($100 in chips)
Seat 6: bJckevFOcg//s0qyMQI6sQ ($100 in chips)
Seat 7: KqC3XiX79XzqwhoOYPVb4w ($163.55 in chips)
Seat 8: gUUvmqdVlmvpal6B8nYrmg ($140.90 in chips)
Seat 9: AMkLbywdoc0K30BTzaIfTQ ($187.90 in chips)
KqC3XiX79XzqwhoOYPVb4w: posts small blind $0.50
gUUvmqdVlmvpal6B8nYrmg: posts big blind $1
*** HOLE CARDS ***
AMkLbywdoc0K30BTzaIfTQ: folds
sa/cZBFh73L9TapFXpn3BA: raises $1 to $2
Ogn4JDV3mp4ZDKO49IFzKA: folds
1862487932: folds
YvSugbFKWSuAYx9iokQwUQ: folds
H+DVy3Ei8L1UKS2tVOtJcw: calls $2
bJckevFOcg//s0qyMQI6sQ: folds
KqC3XiX79XzqwhoOYPVb4w: folds
gUUvmqdVlmvpal6B8nYrmg: folds
*** FLOP *** [5d 8d 2h]
sa/cZBFh73L9TapFXpn3BA: bets $2
H+DVy3Ei8L1UKS2tVOtJcw: folds
sa/cZBFh73L9TapFXpn3BA collected $5.25 from pot
*** SUMMARY ***
Total pot $5.50 | Rake $0.25
Board [5d 8d 2h]
Seat 1: sa/cZBFh73L9TapFXpn3BA collected ($5.25)
Seat 2: Ogn4JDV3mp4ZDKO49IFzKA folded before Flop (didn't bet)
Seat 3: 1862487932 folded before Flop (didn't bet)
Seat 4: YvSugbFKWSuAYx9iokQwUQ folded before Flop (didn't bet)
Seat 5: H+DVy3Ei8L1UKS2tVOtJcw folded on the Flop
Seat 6: bJckevFOcg//s0qyMQI6sQ (button) folded before Flop (didn't bet)
Seat 7: KqC3XiX79XzqwhoOYPVb4w (small blind) folded before Flop
Seat 8: gUUvmqdVlmvpal6B8nYrmg (big blind) folded before Flop
Seat 9: AMkLbywdoc0K30BTzaIfTQ folded before Flop (didn't bet)



PokerStars Game #59940565824:  Hold'em No Limit ($0.50/$1.00) - 2009/07/01 1:10:15 ET
Table 'GxCPo/gd3OSthkYrAxJngg' 6-max Seat #1 is the button
Seat 1: sH8BpAFP+jGFxCgVpD1Lew ($266.90 in chips)
Seat 3: o6plE+MSW4XFNTeONe16xg ($19 in chips)
Seat 4: YMJG+F++3Aj6P8dAWda5fw ($202.25 in chips)
Seat 5: G5ZSSN6RSON3gkNvk/SmYg ($116.10 in chips)
Seat 6: 4d1rWhpu8DzLmzMbR3QKyA ($104.20 in chips)
o6plE+MSW4XFNTeONe16xg: posts small blind $0.50
YMJG+F++3Aj6P8dAWda5fw: posts big blind $1
*** HOLE CARDS ***
G5ZSSN6RSON3gkNvk/SmYg: folds
4d1rWhpu8DzLmzMbR3QKyA: raises $2 to $3
sH8BpAFP+jGFxCgVpD1Lew: folds
o6plE+MSW4XFNTeONe16xg: raises $2 to $5
YMJG+F++3Aj6P8dAWda5fw: calls $4
4d1rWhpu8DzLmzMbR3QKyA: calls $2
*** FLOP *** [Qh 9c Jd]
o6plE+MSW4XFNTeONe16xg: checks
YMJG+F++3Aj6P8dAWda5fw: checks
4d1rWhpu8DzLmzMbR3QKyA: checks
*** TURN *** [Qh 9c Jd] [3d]
o6plE+MSW4XFNTeONe16xg: checks
YMJG+F++3Aj6P8dAWda5fw: checks
4d1rWhpu8DzLmzMbR3QKyA: checks
*** RIVER *** [Qh 9c Jd 3d] [4c]
o6plE+MSW4XFNTeONe16xg: bets $4
YMJG+F++3Aj6P8dAWda5fw: folds
4d1rWhpu8DzLmzMbR3QKyA: folds
o6plE+MSW4XFNTeONe16xg collected $14.25 from pot
*** SUMMARY ***
Total pot $15 | Rake $0.75
Board [Qh 9c Jd 3d 4c]
Seat 1: sH8BpAFP+jGFxCgVpD1Lew (button) folded before Flop (didn't bet)
Seat 3: o6plE+MSW4XFNTeONe16xg (small blind) collected ($14.25)
Seat 4: YMJG+F++3Aj6P8dAWda5fw (big blind) folded on the River
Seat 5: G5ZSSN6RSON3gkNvk/SmYg folded before Flop (didn't bet)
Seat 6: 4d1rWhpu8DzLmzMbR3QKyA folded on the River



PokerStars Game #59940569024:  Hold'em No Limit ($0.50/$1.00) - 2009/07/01 1:10:20 ET
Table 'fTlPiCj0utgzC/5io+I7ew' 6-max Seat #6 is the button
Seat 1: YMJG+F++3Aj6P8dAWda5fw ($101.85 in chips)
Seat 3: Z2fXsGcjl+Eax+RzOgwOmg ($102.50 in chips)
Seat 4: uJVSceLggtsrJya+WtmUEA ($185.65 in chips)
Seat 6: /P4w1pHg2zHYg/4ubJ0dPw ($67.55 in chips)
YMJG+F++3Aj6P8dAWda5fw: posts small blind $0.50
Qy/UBNbD2HaA0Ogxg8Sf3w: is sitting out
Z2fXsGcjl+Eax+RzOgwOmg: posts big blind $1
*** HOLE CARDS ***
uJVSceLggtsrJya+WtmUEA: folds
/P4w1pHg2zHYg/4ubJ0dPw: raises $2 to $3
XUk5GQsfNFpHvaToDZ0rZA joins the table at seat #5
YMJG+F++3Aj6P8dAWda5fw: folds
Z2fXsGcjl+Eax+RzOgwOmg: folds
/P4w1pHg2zHYg/4ubJ0dPw collected $2.50 from pot
*** SUMMARY ***
Total pot $2.50 | Rake $0
Seat 1: YMJG+F++3Aj6P8dAWda5fw (small blind) folded before Flop
Seat 3: Z2fXsGcjl+Eax+RzOgwOmg (big blind) folded before Flop
Seat 4: uJVSceLggtsrJya+WtmUEA folded before Flop (didn't bet)
Seat 6: /P4w1pHg2zHYg/4ubJ0dPw (button) collected ($2.50)



PokerStars Game #59940568916:  Hold'em No Limit ($0.50/$1.00) - 2009/07/01 1:10:20 ET
Table '3T4owEKJKyGTMePwrv50FQ' 9-max Seat #7 is the button
Seat 1: OGgaARGdJQT4awWVNQ957w ($101.10 in chips)
Seat 2: t+Id2O6herCLgwnC4m49PA ($38.60 in chips)
Seat 3: DOLzOcBTZYcph5jEfKFWuQ ($105.50 in chips)
Seat 4: O5Go3jrzbQWxRB6ESK+Ptg ($30.10 in chips)
Seat 5: eI48VADSCFoNZBx4T9qs2w ($31.85 in chips)
Seat 6: laA8va+Yv8WuMqT1zdR91g ($100 in chips)
Seat 7: 1862487932 ($104.50 in chips)
Seat 8: ucTB8uAUcQnKGsA70OSjNA ($19 in chips)
Seat 9: 61sfw5QTu62YYIt68OsdrA ($66.95 in chips)
ucTB8uAUcQnKGsA70OSjNA: posts small blind $0.50
61sfw5QTu62YYIt68OsdrA: posts big blind $1
*** HOLE CARDS ***
OGgaARGdJQT4awWVNQ957w: folds
t+Id2O6herCLgwnC4m49PA: calls $1
DOLzOcBTZYcph5jEfKFWuQ: folds
O5Go3jrzbQWxRB6ESK+Ptg: folds
eI48VADSCFoNZBx4T9qs2w: folds
laA8va+Yv8WuMqT1zdR91g: folds
1862487932: folds
ucTB8uAUcQnKGsA70OSjNA: folds
61sfw5QTu62YYIt68OsdrA: checks
*** FLOP *** [7s 8d Tc]
61sfw5QTu62YYIt68OsdrA: checks
t+Id2O6herCLgwnC4m49PA: bets $2
61sfw5QTu62YYIt68OsdrA: calls $2
*** TURN *** [7s 8d Tc] [3c]
61sfw5QTu62YYIt68OsdrA: checks
t+Id2O6herCLgwnC4m49PA: bets $5
61sfw5QTu62YYIt68OsdrA: folds
t+Id2O6herCLgwnC4m49PA collected $6.20 from pot
*** SUMMARY ***
Total pot $6.50 | Rake $0.30
Board [7s 8d Tc 3c]
Seat 1: OGgaARGdJQT4awWVNQ957w folded before Flop (didn't bet)
Seat 2: t+Id2O6herCLgwnC4m49PA collected ($6.20)
Seat 3: DOLzOcBTZYcph5jEfKFWuQ folded before Flop (didn't bet)
Seat 4: O5Go3jrzbQWxRB6ESK+Ptg folded before Flop (didn't bet)
Seat 5: eI48VADSCFoNZBx4T9qs2w folded before Flop (didn't bet)
Seat 6: laA8va+Yv8WuMqT1zdR91g folded before Flop (didn't bet)
Seat 7: 1862487932 (button) folded before Flop (didn't bet)
Seat 8: ucTB8uAUcQnKGsA70OSjNA (small blind) folded before Flop
Seat 9: 61sfw5QTu62YYIt68OsdrA (big blind) folded on the Turn



PokerStars Game #59940569384:  Hold'em No Limit ($0.50/$1.00) - 2009/07/01 1:10:21 ET
Table 'tyUh+jyNvrceIQdKMJjQ2wZFWj23PMihdwrNWv41OG/Qeat #1 is the button
Seat 1: o8A5MUdudVKu+pAwgZOX2w ($113.55 in chips)
Seat 2: 5uy3EN+iIYkgwbWZFTUBAQ ($100 in chips)
Seat 3: TalCiLYHCd+ffkmR3auPvA ($148.30 in chips)
Seat 5: j7NIOHLZk7V2o9fOioO5ug ($100 in chips)
Seat 6: 4OO5v3AVduL0tePNx8wk5A ($100 in chips)
5uy3EN+iIYkgwbWZFTUBAQ: posts small blind $0.50
TalCiLYHCd+ffkmR3auPvA: posts big blind $1
hpxXcmRkXXI9HE5+5/j/0Q: sits out
*** HOLE CARDS ***
j7NIOHLZk7V2o9fOioO5ug: folds
4OO5v3AVduL0tePNx8wk5A: folds
o8A5MUdudVKu+pAwgZOX2w: calls $1
5uy3EN+iIYkgwbWZFTUBAQ: folds
TalCiLYHCd+ffkmR3auPvA: checks
*** FLOP *** [Th Ad 5d]
TalCiLYHCd+ffkmR3auPvA: checks
o8A5MUdudVKu+pAwgZOX2w: bets $3
TalCiLYHCd+ffkmR3auPvA: folds
o8A5MUdudVKu+pAwgZOX2w collected $2.40 from pot
o8A5MUdudVKu+pAwgZOX2w: doesn't show hand
*** SUMMARY ***
Total pot $2.50 | Rake $0.10
Board [Th Ad 5d]
Seat 1: o8A5MUdudVKu+pAwgZOX2w (button) collected ($2.40)
Seat 2: 5uy3EN+iIYkgwbWZFTUBAQ (small blind) folded before Flop
Seat 3: TalCiLYHCd+ffkmR3auPvA (big blind) folded on the Flop
Seat 5: j7NIOHLZk7V2o9fOioO5ug folded before Flop (didn't bet)
Seat 6: 4OO5v3AVduL0tePNx8wk5A folded before Flop (didn't bet)



PokerStars Game #59940569894:  Hold'em No Limit ($0.50/$1.00) - 2009/07/01 1:10:22 ET
Table 'kS0cTQAEi+fdUlJP2gQYvw' 9-max Seat #2 is the button
Seat 1: c/9X4zftzphFxYtxp5kp9w ($62.85 in chips)
Seat 2: D+W9Me7w6Hcx/WRUSKV0dw ($20.90 in chips)
Seat 3: 2BV+oJIQYr65IO6nEChvbA ($60 in chips)
Seat 5: 997ViqAtWn1FPjJqcffwcA ($102.65 in chips)
Seat 6: yAbu2QsRPVcjPbqlf/jDxw ($129.65 in chips)
Seat 7: Ffa7Nj4X5fddtROP01hfQg ($153.25 in chips)
Seat 9: OGgaARGdJQT4awWVNQ957w ($101.50 in chips)
2BV+oJIQYr65IO6nEChvbA: posts small blind $0.50
997ViqAtWn1FPjJqcffwcA: posts big blind $1
*** HOLE CARDS ***
yAbu2QsRPVcjPbqlf/jDxw: folds
Ffa7Nj4X5fddtROP01hfQg: folds
OGgaARGdJQT4awWVNQ957w: folds
c/9X4zftzphFxYtxp5kp9w: raises $3 to $4
D+W9Me7w6Hcx/WRUSKV0dw: folds
2BV+oJIQYr65IO6nEChvbA: folds
997ViqAtWn1FPjJqcffwcA: folds
c/9X4zftzphFxYtxp5kp9w collected $2.50 from pot
*** SUMMARY ***
Total pot $2.50 | Rake $0
Seat 1: c/9X4zftzphFxYtxp5kp9w collected ($2.50)
Seat 2: D+W9Me7w6Hcx/WRUSKV0dw (button) folded before Flop (didn't bet)
Seat 3: 2BV+oJIQYr65IO6nEChvbA (small blind) folded before Flop
Seat 5: 997ViqAtWn1FPjJqcffwcA (big blind) folded before Flop
Seat 6: yAbu2QsRPVcjPbqlf/jDxw folded before Flop (didn't bet)
Seat 7: Ffa7Nj4X5fddtROP01hfQg folded before Flop (didn't bet)
Seat 9: OGgaARGdJQT4awWVNQ957w folded before Flop (didn't bet)



PokerStars Game #59940570322:  Hold'em No Limit ($0.50/$1.00) - 2009/07/01 1:10:23 ET
Table 'cKH9c4x6u79IqCdaKKvXrw' 9-max Seat #7 is the button
Seat 1: Pp/KTcXkfZKKUHkjyaLTdg ($20 in chips)
Seat 2: 8S3JMH4TY3whgIlZmMv66w ($75.55 in chips)
Seat 3: 997ViqAtWn1FPjJqcffwcA ($155.60 in chips)
Seat 4: FL3MrLspcF23LYvC4ipBOA ($100 in chips)
Seat 5: Jjc7EHWzs4//xUAjJ0UWoA ($44.40 in chips)
Seat 6: Bsd/K5gAcLanYbGiPirRjw ($201.05 in chips)
Seat 7: 1GkkVBhlJ92guE6K5mS5Ig ($16.60 in chips)
Seat 8: myIxN7otsyr846M539YR8Q ($16 in chips)
Seat 9: 6XkTu4ahxzHnvjjc1R8YjQ ($41.60 in chips)
myIxN7otsyr846M539YR8Q: posts small blind $0.50
6XkTu4ahxzHnvjjc1R8YjQ: posts big blind $1
*** HOLE CARDS ***
Pp/KTcXkfZKKUHkjyaLTdg: folds
8S3JMH4TY3whgIlZmMv66w: raises $2 to $3
997ViqAtWn1FPjJqcffwcA: folds
FL3MrLspcF23LYvC4ipBOA: folds
Jjc7EHWzs4//xUAjJ0UWoA: folds
Bsd/K5gAcLanYbGiPirRjw: folds
1GkkVBhlJ92guE6K5mS5Ig: folds
myIxN7otsyr846M539YR8Q: raises $13 to $16 and is all-in
6XkTu4ahxzHnvjjc1R8YjQ: folds
8S3JMH4TY3whgIlZmMv66w: calls $13
*** FLOP *** [7s 7c 2d]
*** TURN *** [7s 7c 2d] [Jd]
*** RIVER *** [7s 7c 2d Jd] [6c]
*** SHOW DOWN ***
myIxN7otsyr846M539YR8Q: shows [Qc Ah] (a pair of Sevens)
8S3JMH4TY3whgIlZmMv66w: mucks hand
myIxN7otsyr846M539YR8Q collected $31.35 from pot
*** SUMMARY ***
Total pot $33 | Rake $1.65
Board [7s 7c 2d Jd 6c]
Seat 1: Pp/KTcXkfZKKUHkjyaLTdg folded before Flop (didn't bet)
Seat 2: 8S3JMH4TY3whgIlZmMv66w mucked
Seat 3: 997ViqAtWn1FPjJqcffwcA folded before Flop (didn't bet)
Seat 4: FL3MrLspcF23LYvC4ipBOA folded before Flop (didn't bet)
Seat 5: Jjc7EHWzs4//xUAjJ0UWoA folded before Flop (didn't bet)
Seat 6: Bsd/K5gAcLanYbGiPirRjw folded before Flop (didn't bet)
Seat 7: 1GkkVBhlJ92guE6K5mS5Ig (button) folded before Flop (didn't bet)
Seat 8: myIxN7otsyr846M539YR8Q (small blind) showed [Qc Ah] and won ($31.35) with a pair of Sevens
Seat 9: 6XkTu4ahxzHnvjjc1R8YjQ (big blind) folded before Flop



PokerStars Game #59940570420:  Hold'em No Limit ($0.50/$1.00) - 2009/07/01 1:10:23 ET
Table 'rmZfTK+oSebeUPJNbWhdAA' 6-max Seat #5 is the button
Seat 1: xAU6q2/cwmby2sxmA8VcmA ($148.50 in chips)
Seat 2: z7O9PO/WEcqRouIydFhS9Q ($135.40 in chips)
Seat 3: BCEV3COoKY607AzLWayfRA ($132.50 in chips)
Seat 4: 1/mIuXfgx1ZyVkodrmfQDw ($100 in chips)
Seat 5: 5lY8d6Cnm4HUkt/8FZSj4g ($63.95 in chips)
Seat 6: j7NIOHLZk7V2o9fOioO5ug ($131 in chips)
j7NIOHLZk7V2o9fOioO5ug: posts small blind $0.50
xAU6q2/cwmby2sxmA8VcmA: posts big blind $1
*** HOLE CARDS ***
z7O9PO/WEcqRouIydFhS9Q: raises $2 to $3
BCEV3COoKY607AzLWayfRA: raises $8 to $11
1/mIuXfgx1ZyVkodrmfQDw: folds
5lY8d6Cnm4HUkt/8FZSj4g: calls $11
j7NIOHLZk7V2o9fOioO5ug: folds
xAU6q2/cwmby2sxmA8VcmA: folds
z7O9PO/WEcqRouIydFhS9Q: calls $8
*** FLOP *** [Th 2s 6d]
z7O9PO/WEcqRouIydFhS9Q: checks
BCEV3COoKY607AzLWayfRA: bets $16
5lY8d6Cnm4HUkt/8FZSj4g: folds
z7O9PO/WEcqRouIydFhS9Q: folds
BCEV3COoKY607AzLWayfRA collected $32.80 from pot
BCEV3COoKY607AzLWayfRA: doesn't show hand
*** SUMMARY ***
Total pot $34.50 | Rake $1.70
Board [Th 2s 6d]
Seat 1: xAU6q2/cwmby2sxmA8VcmA (big blind) folded before Flop
Seat 2: z7O9PO/WEcqRouIydFhS9Q folded on the Flop
Seat 3: BCEV3COoKY607AzLWayfRA collected ($32.80)
Seat 4: 1/mIuXfgx1ZyVkodrmfQDw folded before Flop (didn't bet)
Seat 5: 5lY8d6Cnm4HUkt/8FZSj4g (button) folded on the Flop
Seat 6: j7NIOHLZk7V2o9fOioO5ug (small blind) folded before Flop



PokerStars Game #59940571868:  Hold'em No Limit ($0.50/$1.00) - 2009/07/01 1:10:25 ET
Table 'GPp0HyAuggN8oE0sUWzPpA' 9-max Seat #9 is the button
Seat 1: qJr25HAtvv1w/7IBvjMM3g ($47.20 in chips)
Seat 2: m3U8I35Pn3gxKhoS2nmYIg ($39.55 in chips)
Seat 3: CCCXsirC+bO7ginAuUUVlQ ($49.35 in chips)
Seat 4: mBRWbnUl8diyBO1qTJaNzw ($103.65 in chips)
Seat 6: BK/GtNPkSx0TdUDj82id5A ($16.35 in chips)
Seat 7: DHdbHyysD15wCAtx+BhUjA ($93.50 in chips)
Seat 9: dzoSjPZmtjGuK83119030A ($34.15 in chips)
qJr25HAtvv1w/7IBvjMM3g: posts small blind $0.50
m3U8I35Pn3gxKhoS2nmYIg: posts big blind $1
P/6qLjycEfxRgZ5F/W90dw joins the table at seat #8
bLbSOSmSOnqE0iTcH/5dxA: sits out
*** HOLE CARDS ***
CCCXsirC+bO7ginAuUUVlQ: folds
mBRWbnUl8diyBO1qTJaNzw: folds
BK/GtNPkSx0TdUDj82id5A: folds
DHdbHyysD15wCAtx+BhUjA: folds
dzoSjPZmtjGuK83119030A: folds
qJr25HAtvv1w/7IBvjMM3g: calls $0.50
m3U8I35Pn3gxKhoS2nmYIg: checks
*** FLOP *** [7d Ad 4c]
qJr25HAtvv1w/7IBvjMM3g: bets $1
m3U8I35Pn3gxKhoS2nmYIg: calls $1
*** TURN *** [7d Ad 4c] [7c]
qJr25HAtvv1w/7IBvjMM3g: checks
m3U8I35Pn3gxKhoS2nmYIg: bets $1
qJr25HAtvv1w/7IBvjMM3g: folds
m3U8I35Pn3gxKhoS2nmYIg collected $3.85 from pot
*** SUMMARY ***
Total pot $4 | Rake $0.15
Board [7d Ad 4c 7c]
Seat 1: qJr25HAtvv1w/7IBvjMM3g (small blind) folded on the Turn
Seat 2: m3U8I35Pn3gxKhoS2nmYIg (big blind) collected ($3.85)
Seat 3: CCCXsirC+bO7ginAuUUVlQ folded before Flop (didn't bet)
Seat 4: mBRWbnUl8diyBO1qTJaNzw folded before Flop (didn't bet)
Seat 6: BK/GtNPkSx0TdUDj82id5A folded before Flop (didn't bet)
Seat 7: DHdbHyysD15wCAtx+BhUjA folded before Flop (didn't bet)
Seat 9: dzoSjPZmtjGuK83119030A (button) folded before Flop (didn't bet)



PokerStars Game #59940572158:  Hold'em No Limit ($0.50/$1.00) - 2009/07/01 1:10:26 ET
Table '7O9fB8yx1u7sJveJn8w6jA' 6-max Seat #3 is the button
Seat 1: jy52+7FotjH63o5tEEVgKw ($85.85 in chips)
Seat 2: wx3sQGkVi2x9wJXuWNHPBw ($186.45 in chips)
Seat 3: hpxXcmRkXXI9HE5+5/j/0Q ($102.70 in chips)
Seat 4: b2a+5TkFf4xJN/Ihhma58Q ($42.30 in chips)
Seat 5: BCEV3COoKY607AzLWayfRA ($121.05 in chips)
Seat 6: p1Ga2i1TuXUvRn+Rf/0FMw ($100 in chips)
b2a+5TkFf4xJN/Ihhma58Q: posts small blind $0.50
BCEV3COoKY607AzLWayfRA: posts big blind $1
p1Ga2i1TuXUvRn+Rf/0FMw: posts big blind $1
*** HOLE CARDS ***
p1Ga2i1TuXUvRn+Rf/0FMw: checks
jy52+7FotjH63o5tEEVgKw: folds
wx3sQGkVi2x9wJXuWNHPBw has timed out
wx3sQGkVi2x9wJXuWNHPBw: folds
wx3sQGkVi2x9wJXuWNHPBw is sitting out
hpxXcmRkXXI9HE5+5/j/0Q: folds
b2a+5TkFf4xJN/Ihhma58Q: calls $0.50
wx3sQGkVi2x9wJXuWNHPBw has returned
BCEV3COoKY607AzLWayfRA: checks
*** FLOP *** [4h 2d 8c]
b2a+5TkFf4xJN/Ihhma58Q: checks
BCEV3COoKY607AzLWayfRA: bets $3
p1Ga2i1TuXUvRn+Rf/0FMw: calls $3
b2a+5TkFf4xJN/Ihhma58Q: folds
*** TURN *** [4h 2d 8c] [Qd]
BCEV3COoKY607AzLWayfRA: bets $6
p1Ga2i1TuXUvRn+Rf/0FMw: raises $6 to $12
BCEV3COoKY607AzLWayfRA: calls $6
*** RIVER *** [4h 2d 8c Qd] [6h]
BCEV3COoKY607AzLWayfRA: checks
p1Ga2i1TuXUvRn+Rf/0FMw: bets $12
BCEV3COoKY607AzLWayfRA: calls $12
*** SHOW DOWN ***
p1Ga2i1TuXUvRn+Rf/0FMw: shows [6d 8s] (two pair, Eights and Sixes)
BCEV3COoKY607AzLWayfRA: mucks hand
p1Ga2i1TuXUvRn+Rf/0FMw collected $54.25 from pot
*** SUMMARY ***
Total pot $57 | Rake $2.75
Board [4h 2d 8c Qd 6h]
Seat 1: jy52+7FotjH63o5tEEVgKw folded before Flop (didn't bet)
Seat 2: wx3sQGkVi2x9wJXuWNHPBw folded before Flop (didn't bet)
Seat 3: hpxXcmRkXXI9HE5+5/j/0Q (button) folded before Flop (didn't bet)
Seat 4: b2a+5TkFf4xJN/Ihhma58Q (small blind) folded on the Flop
Seat 5: BCEV3COoKY607AzLWayfRA (big blind) mucked
Seat 6: p1Ga2i1TuXUvRn+Rf/0FMw showed [6d 8s] and won ($54.25) with two pair, Eights and Sixes



PokerStars Game #59940573222:  Hold'em No Limit ($0.50/$1.00) - 2009/07/01 1:10:27 ET
Table 'vs/5jr6ciwjVQ5+Soc+u2A' 6-max Seat #3 is the button
Seat 1: /P4w1pHg2zHYg/4ubJ0dPw ($89.80 in chips)
Seat 2: lXX4W7m3u++JiSOZ46yVMQ ($114.20 in chips)
Seat 3: G5ZSSN6RSON3gkNvk/SmYg ($125.35 in chips)
Seat 4: wk6Ohn4GDozoOMHc4eb2rw ($75.65 in chips)
Seat 5: +Nt3OPk3XR9SKjZgm2CexQ ($108.95 in chips)
Seat 6: Z2fXsGcjl+Eax+RzOgwOmg ($100 in chips)
wk6Ohn4GDozoOMHc4eb2rw: posts small blind $0.50
+Nt3OPk3XR9SKjZgm2CexQ: posts big blind $1
*** HOLE CARDS ***
Z2fXsGcjl+Eax+RzOgwOmg: folds
/P4w1pHg2zHYg/4ubJ0dPw: folds
lXX4W7m3u++JiSOZ46yVMQ: raises $2 to $3
G5ZSSN6RSON3gkNvk/SmYg: folds
wk6Ohn4GDozoOMHc4eb2rw: raises $2 to $5
+Nt3OPk3XR9SKjZgm2CexQ: folds
lXX4W7m3u++JiSOZ46yVMQ: raises $11 to $16
wk6Ohn4GDozoOMHc4eb2rw: calls $11
*** FLOP *** [8c 6h 5c]
wk6Ohn4GDozoOMHc4eb2rw: checks
lXX4W7m3u++JiSOZ46yVMQ: bets $22
wk6Ohn4GDozoOMHc4eb2rw: folds
lXX4W7m3u++JiSOZ46yVMQ collected $31.35 from pot
*** SUMMARY ***
Total pot $33 | Rake $1.65
Board [8c 6h 5c]
Seat 1: /P4w1pHg2zHYg/4ubJ0dPw folded before Flop (didn't bet)
Seat 2: lXX4W7m3u++JiSOZ46yVMQ collected ($31.35)
Seat 3: G5ZSSN6RSON3gkNvk/SmYg (button) folded before Flop (didn't bet)
Seat 4: wk6Ohn4GDozoOMHc4eb2rw (small blind) folded on the Flop
Seat 5: +Nt3OPk3XR9SKjZgm2CexQ (big blind) folded before Flop
Seat 6: Z2fXsGcjl+Eax+RzOgwOmg folded before Flop (didn't bet)



PokerStars Game #59940573494:  Hold'em No Limit ($0.50/$1.00) - 2009/07/01 1:10:28 ET
Table 'O96CPOtvMBWP6kzuYDfdFA' 6-max Seat #1 is the button
Seat 1: 6alLXQIITA2EZ/lBeym8Dw ($119.55 in chips)
Seat 2: 4d1rWhpu8DzLmzMbR3QKyA ($100 in chips)
Seat 4: /P4w1pHg2zHYg/4ubJ0dPw ($62.05 in chips)
Seat 5: G5ZSSN6RSON3gkNvk/SmYg ($100 in chips)
Seat 6: GYei5jXGWexiJYbAT2fELg ($44.90 in chips)
4d1rWhpu8DzLmzMbR3QKyA: posts small blind $0.50
/P4w1pHg2zHYg/4ubJ0dPw: posts big blind $1
*** HOLE CARDS ***
G5ZSSN6RSON3gkNvk/SmYg: folds
GYei5jXGWexiJYbAT2fELg: folds
6alLXQIITA2EZ/lBeym8Dw: folds
4d1rWhpu8DzLmzMbR3QKyA: folds
/P4w1pHg2zHYg/4ubJ0dPw collected $1 from pot
*** SUMMARY ***
Total pot $1 | Rake $0
Seat 1: 6alLXQIITA2EZ/lBeym8Dw (button) folded before Flop (didn't bet)
Seat 2: 4d1rWhpu8DzLmzMbR3QKyA (small blind) folded before Flop
Seat 4: /P4w1pHg2zHYg/4ubJ0dPw (big blind) collected ($1)
Seat 5: G5ZSSN6RSON3gkNvk/SmYg folded before Flop (didn't bet)
Seat 6: GYei5jXGWexiJYbAT2fELg folded before Flop (didn't bet)



PokerStars Game #59940575028:  Hold'em No Limit ($0.50/$1.00) - 2009/07/01 1:10:30 ET
Table 'pHrhryH8jPNdQfY62f8v+g' 6-max Seat #5 is the button
Seat 1: 4d1rWhpu8DzLmzMbR3QKyA ($100 in chips)
Seat 2: RqgF7gRoKgRNW8Zoi1ty4A ($141 in chips)
Seat 3: 8oS5O7iD/qnFXFXJrGIgNQ ($100 in chips)
Seat 4: 1f3beyIML24UqEMTbWy93g ($58.15 in chips)
Seat 5: r1/R7y0Ortgoz4lccgW8VA ($39.15 in chips)
Seat 6: xAU6q2/cwmby2sxmA8VcmA ($207.10 in chips)
xAU6q2/cwmby2sxmA8VcmA: posts small blind $0.50
4d1rWhpu8DzLmzMbR3QKyA: posts big blind $1
*** HOLE CARDS ***
RqgF7gRoKgRNW8Zoi1ty4A: folds
RqgF7gRoKgRNW8Zoi1ty4A is sitting out
8oS5O7iD/qnFXFXJrGIgNQ: folds
1f3beyIML24UqEMTbWy93g: folds
r1/R7y0Ortgoz4lccgW8VA: folds
xAU6q2/cwmby2sxmA8VcmA: raises $3 to $4
4d1rWhpu8DzLmzMbR3QKyA: folds
xAU6q2/cwmby2sxmA8VcmA collected $2 from pot
*** SUMMARY ***
Total pot $2 | Rake $0
Seat 1: 4d1rWhpu8DzLmzMbR3QKyA (big blind) folded before Flop
Seat 2: RqgF7gRoKgRNW8Zoi1ty4A folded before Flop (didn't bet)
Seat 3: 8oS5O7iD/qnFXFXJrGIgNQ folded before Flop (didn't bet)
Seat 4: 1f3beyIML24UqEMTbWy93g folded before Flop (didn't bet)
Seat 5: r1/R7y0Ortgoz4lccgW8VA (button) folded before Flop (didn't bet)
Seat 6: xAU6q2/cwmby2sxmA8VcmA (small blind) collected ($2)



PokerStars Game #59940577450:  Hold'em No Limit ($0.50/$1.00) - 2009/07/01 1:10:35 ET
Table 'QSIig7BLMc9wY/rgBechzw' 6-max Seat #4 is the button
Seat 1: Z2fXsGcjl+Eax+RzOgwOmg ($115 in chips)
Seat 2: mLOIkH/qmRa+mVujQIhBRg ($40.60 in chips)
Seat 3: +xW7QemQU0Fxs+4TnqBRow ($100 in chips)
Seat 4: +uSzP8Jwnw7sKfQ4s66b7w ($78.45 in chips)
Seat 5: lsLuWlcPA3Rh7kJVLzMh0Q ($102.85 in chips)
Seat 6: PxqfkAMdAWtkgbT+q2gciA ($35.75 in chips)
lsLuWlcPA3Rh7kJVLzMh0Q: posts small blind $0.50
PxqfkAMdAWtkgbT+q2gciA: posts big blind $1
*** HOLE CARDS ***
Z2fXsGcjl+Eax+RzOgwOmg: folds
mLOIkH/qmRa+mVujQIhBRg: calls $1
+xW7QemQU0Fxs+4TnqBRow: folds
+uSzP8Jwnw7sKfQ4s66b7w: folds
lsLuWlcPA3Rh7kJVLzMh0Q: folds
PxqfkAMdAWtkgbT+q2gciA: checks
*** FLOP *** [2h 7s 3d]
PxqfkAMdAWtkgbT+q2gciA: bets $2
mLOIkH/qmRa+mVujQIhBRg: folds
PxqfkAMdAWtkgbT+q2gciA collected $2.40 from pot
*** SUMMARY ***
Total pot $2.50 | Rake $0.10
Board [2h 7s 3d]
Seat 1: Z2fXsGcjl+Eax+RzOgwOmg folded before Flop (didn't bet)
Seat 2: mLOIkH/qmRa+mVujQIhBRg folded on the Flop
Seat 3: +xW7QemQU0Fxs+4TnqBRow folded before Flop (didn't bet)
Seat 4: +uSzP8Jwnw7sKfQ4s66b7w (button) folded before Flop (didn't bet)
Seat 5: lsLuWlcPA3Rh7kJVLzMh0Q (small blind) folded before Flop
Seat 6: PxqfkAMdAWtkgbT+q2gciA (big blind) collected ($2.40)



PokerStars Game #59940578390:  Hold'em No Limit ($0.50/$1.00) - 2009/07/01 1:10:36 ET
Table 'W/wyObTiXZm+Ckkl3YxcSw' 6-max Seat #5 is the button
Seat 1: eUBBn2R56C1IQ6Cs/vitwg ($180.75 in chips)
Seat 2: oDiBRCaF0QVtd3kO6xZIXw ($151.85 in chips)
Seat 3: dxyNCn/qxfkGDUIf28Cbng ($57.40 in chips)
Seat 4: aYii2DmxlOlbC1wbGRBWvQ ($108.60 in chips)
Seat 5: MFptnnT6AnJakWBooTkmeg ($23.65 in chips)
OGMLOcTNYZXZU81au7ztUw: is sitting out
eUBBn2R56C1IQ6Cs/vitwg: posts small blind $0.50
oDiBRCaF0QVtd3kO6xZIXw: posts big blind $1
*** HOLE CARDS ***
dxyNCn/qxfkGDUIf28Cbng: folds
aYii2DmxlOlbC1wbGRBWvQ: folds
MFptnnT6AnJakWBooTkmeg: raises $2 to $3
OGMLOcTNYZXZU81au7ztUw leaves the table
eUBBn2R56C1IQ6Cs/vitwg: folds
oDiBRCaF0QVtd3kO6xZIXw: raises $10 to $13
MFptnnT6AnJakWBooTkmeg: folds
oDiBRCaF0QVtd3kO6xZIXw collected $6.50 from pot
oDiBRCaF0QVtd3kO6xZIXw: doesn't show hand
*** SUMMARY ***
Total pot $6.50 | Rake $0
Seat 1: eUBBn2R56C1IQ6Cs/vitwg (small blind) folded before Flop
Seat 2: oDiBRCaF0QVtd3kO6xZIXw (big blind) collected ($6.50)
Seat 3: dxyNCn/qxfkGDUIf28Cbng folded before Flop (didn't bet)
Seat 4: aYii2DmxlOlbC1wbGRBWvQ folded before Flop (didn't bet)
Seat 5: MFptnnT6AnJakWBooTkmeg (button) folded before Flop



PokerStars Game #59940580298:  Hold'em No Limit ($0.50/$1.00) - 2009/07/01 1:10:40 ET
Table 'hugOjcwJvzEwZbK7tyiWuQ' 9-max Seat #2 is the button
Seat 1: S3Ex8K7v6xm5jqjRM7Fl3w ($25 in chips)
Seat 2: r27C1nIV4NS4+qbnrgBQSw ($281.70 in chips)
Seat 4: UWB3oeddt/GObx2Mix2Anw ($168 in chips)
Seat 5: 5BRGWf+R3nt2WS3b5xX+zA ($16.75 in chips)
Seat 6: gUUvmqdVlmvpal6B8nYrmg ($103.90 in chips)
Seat 7: FL3MrLspcF23LYvC4ipBOA ($110.30 in chips)
Seat 8: /zy+DB4S5fUQUSfZWFzYGw ($111.05 in chips)
Seat 9: W8P9bUKCs43TO1xHm0dL6w ($89.45 in chips)
UWB3oeddt/GObx2Mix2Anw: posts small blind $0.50
5BRGWf+R3nt2WS3b5xX+zA: posts big blind $1
S3Ex8K7v6xm5jqjRM7Fl3w: posts big blind $1
*** HOLE CARDS ***
gUUvmqdVlmvpal6B8nYrmg: folds
FL3MrLspcF23LYvC4ipBOA: folds
/zy+DB4S5fUQUSfZWFzYGw: folds
W8P9bUKCs43TO1xHm0dL6w: folds
S3Ex8K7v6xm5jqjRM7Fl3w: checks
r27C1nIV4NS4+qbnrgBQSw: folds
UWB3oeddt/GObx2Mix2Anw: calls $0.50
5BRGWf+R3nt2WS3b5xX+zA: checks
*** FLOP *** [5d 9h Jd]
UWB3oeddt/GObx2Mix2Anw: bets $2
5BRGWf+R3nt2WS3b5xX+zA: calls $2
S3Ex8K7v6xm5jqjRM7Fl3w: calls $2
*** TURN *** [5d 9h Jd] [8h]
UWB3oeddt/GObx2Mix2Anw: checks
5BRGWf+R3nt2WS3b5xX+zA: bets $5
S3Ex8K7v6xm5jqjRM7Fl3w: folds
UWB3oeddt/GObx2Mix2Anw: calls $5
*** RIVER *** [5d 9h Jd 8h] [2d]
UWB3oeddt/GObx2Mix2Anw: checks
5BRGWf+R3nt2WS3b5xX+zA: bets $8.75 and is all-in
UWB3oeddt/GObx2Mix2Anw: folds
5BRGWf+R3nt2WS3b5xX+zA collected $18.10 from pot
*** SUMMARY ***
Total pot $19 | Rake $0.90
Board [5d 9h Jd 8h 2d]
Seat 1: S3Ex8K7v6xm5jqjRM7Fl3w folded on the Turn
Seat 2: r27C1nIV4NS4+qbnrgBQSw (button) folded before Flop (didn't bet)
Seat 4: UWB3oeddt/GObx2Mix2Anw (small blind) folded on the River
Seat 5: 5BRGWf+R3nt2WS3b5xX+zA (big blind) collected ($18.10)
Seat 6: gUUvmqdVlmvpal6B8nYrmg folded before Flop (didn't bet)
Seat 7: FL3MrLspcF23LYvC4ipBOA folded before Flop (didn't bet)
Seat 8: /zy+DB4S5fUQUSfZWFzYGw folded before Flop (didn't bet)
Seat 9: W8P9bUKCs43TO1xHm0dL6w folded before Flop (didn't bet)



PokerStars Game #59940580560:  Hold'em No Limit ($0.50/$1.00) - 2009/07/01 1:10:40 ET
Table '6YvsYDPNIDx2v5z3bJnwZQ' 9-max Seat #6 is the button
Seat 1: Ogn4JDV3mp4ZDKO49IFzKA ($21.20 in chips)
Seat 2: +hHqYgKILitkxIzFNGvvsA ($29.75 in chips)
Seat 4: kEr5NYB+JIG5+szcYMr6hA ($43.80 in chips)
Seat 5: mBRWbnUl8diyBO1qTJaNzw ($160.70 in chips)
Seat 6: 7RSwrjMohkYrZAhOd1uaZg ($12.55 in chips)
Seat 7: mae7OMTaJ/MFimNbZegCkg ($46.30 in chips)
Seat 8: PSFxpXgPedVZyHSu2Zhb7Q ($124.45 in chips)
Seat 9: yZYrOeNDxQxkzpbgKX1bng ($28 in chips)
mae7OMTaJ/MFimNbZegCkg: posts small blind $0.50
PSFxpXgPedVZyHSu2Zhb7Q: posts big blind $1
K6OJDis3KfxSm/PKlkATUA: sits out
*** HOLE CARDS ***
yZYrOeNDxQxkzpbgKX1bng: folds
Ogn4JDV3mp4ZDKO49IFzKA: folds
+hHqYgKILitkxIzFNGvvsA: calls $1
kEr5NYB+JIG5+szcYMr6hA: folds
mBRWbnUl8diyBO1qTJaNzw: folds
7RSwrjMohkYrZAhOd1uaZg: calls $1
mae7OMTaJ/MFimNbZegCkg: folds
PSFxpXgPedVZyHSu2Zhb7Q: checks
*** FLOP *** [Jh Th 6s]
PSFxpXgPedVZyHSu2Zhb7Q: checks
+hHqYgKILitkxIzFNGvvsA: checks
7RSwrjMohkYrZAhOd1uaZg: checks
*** TURN *** [Jh Th 6s] [5d]
PSFxpXgPedVZyHSu2Zhb7Q: checks
+hHqYgKILitkxIzFNGvvsA: checks
7RSwrjMohkYrZAhOd1uaZg: bets $2
PSFxpXgPedVZyHSu2Zhb7Q: folds
+hHqYgKILitkxIzFNGvvsA: folds
7RSwrjMohkYrZAhOd1uaZg collected $3.35 from pot
*** SUMMARY ***
Total pot $3.50 | Rake $0.15
Board [Jh Th 6s 5d]
Seat 1: Ogn4JDV3mp4ZDKO49IFzKA folded before Flop (didn't bet)
Seat 2: +hHqYgKILitkxIzFNGvvsA folded on the Turn
Seat 4: kEr5NYB+JIG5+szcYMr6hA folded before Flop (didn't bet)
Seat 5: mBRWbnUl8diyBO1qTJaNzw folded before Flop (didn't bet)
Seat 6: 7RSwrjMohkYrZAhOd1uaZg (button) collected ($3.35)
Seat 7: mae7OMTaJ/MFimNbZegCkg (small blind) folded before Flop
Seat 8: PSFxpXgPedVZyHSu2Zhb7Q (big blind) folded on the Turn
Seat 9: yZYrOeNDxQxkzpbgKX1bng folded before Flop (didn't bet)



PokerStars Game #59940580840:  Hold'em No Limit ($0.50/$1.00) - 2009/07/01 1:10:41 ET
Table 'SQLOQoANiHscJ8AL7zffbw' 9-max Seat #5 is the button
Seat 1: jPTRd6SpCp4xqAy2XQiTOw ($67.90 in chips)
Seat 2: /zy+DB4S5fUQUSfZWFzYGw ($329.90 in chips)
Seat 3: 0eFnow7+D7veCYQ+CG9FFw ($95.50 in chips)
Seat 4: /mfensKw8/iZ1Vrx33S4xg ($21.50 in chips)
Seat 5: L9njYvloJ1NdXjP8edHEAg ($107.65 in chips)
Seat 6: H+DVy3Ei8L1UKS2tVOtJcw ($100 in chips)
Seat 7: bJckevFOcg//s0qyMQI6sQ ($104.55 in chips)
Seat 8: 2BV+oJIQYr65IO6nEChvbA ($60 in chips)
Seat 9: qJr25HAtvv1w/7IBvjMM3g ($200.15 in chips)
H+DVy3Ei8L1UKS2tVOtJcw: posts small blind $0.50
bJckevFOcg//s0qyMQI6sQ: posts big blind $1
*** HOLE CARDS ***
2BV+oJIQYr65IO6nEChvbA: folds
qJr25HAtvv1w/7IBvjMM3g: folds
jPTRd6SpCp4xqAy2XQiTOw said, "let me know when everyone is ready to play"
jPTRd6SpCp4xqAy2XQiTOw: calls $1
/zy+DB4S5fUQUSfZWFzYGw: raises $4 to $5
0eFnow7+D7veCYQ+CG9FFw: raises $12 to $17
/mfensKw8/iZ1Vrx33S4xg: folds
/mfensKw8/iZ1Vrx33S4xg leaves the table
L9njYvloJ1NdXjP8edHEAg: folds
H+DVy3Ei8L1UKS2tVOtJcw: folds
bJckevFOcg//s0qyMQI6sQ: folds
jPTRd6SpCp4xqAy2XQiTOw: folds
/zy+DB4S5fUQUSfZWFzYGw: folds
0eFnow7+D7veCYQ+CG9FFw collected $12.50 from pot
*** SUMMARY ***
Total pot $12.50 | Rake $0
Seat 1: jPTRd6SpCp4xqAy2XQiTOw folded before Flop
Seat 2: /zy+DB4S5fUQUSfZWFzYGw folded before Flop
Seat 3: 0eFnow7+D7veCYQ+CG9FFw collected ($12.50)
Seat 4: /mfensKw8/iZ1Vrx33S4xg folded before Flop (didn't bet)
Seat 5: L9njYvloJ1NdXjP8edHEAg (button) folded before Flop (didn't bet)
Seat 6: H+DVy3Ei8L1UKS2tVOtJcw (small blind) folded before Flop
Seat 7: bJckevFOcg//s0qyMQI6sQ (big blind) folded before Flop
Seat 8: 2BV+oJIQYr65IO6nEChvbA folded before Flop (didn't bet)
Seat 9: qJr25HAtvv1w/7IBvjMM3g folded before Flop (didn't bet)



PokerStars Game #59940581616:  Hold'em No Limit ($0.50/$1.00) - 2009/07/01 1:10:42 ET
Table '+cA8mcmhaedZ7YcrDdhmeQ' 6-max Seat #4 is the button
Seat 1: lsLuWlcPA3Rh7kJVLzMh0Q ($303.95 in chips)
Seat 2: RqgF7gRoKgRNW8Zoi1ty4A ($130.25 in chips)
Seat 3: DAIgyIWbYvAkL6PbAI27pg ($18.50 in chips)
Seat 4: 4OO5v3AVduL0tePNx8wk5A ($109.55 in chips)
Seat 5: +7hFKAL0b0O/n8G72TclJA ($135.20 in chips)
Seat 6: YfsTQsY/fxb+YqbdclTHuw ($17.10 in chips)
+7hFKAL0b0O/n8G72TclJA: posts small blind $0.50
YfsTQsY/fxb+YqbdclTHuw: posts big blind $1
*** HOLE CARDS ***
lsLuWlcPA3Rh7kJVLzMh0Q: folds
RqgF7gRoKgRNW8Zoi1ty4A: folds
DAIgyIWbYvAkL6PbAI27pg: folds
4OO5v3AVduL0tePNx8wk5A: folds
+7hFKAL0b0O/n8G72TclJA: calls $0.50
YfsTQsY/fxb+YqbdclTHuw: checks
*** FLOP *** [Kc 9h Qh]
+7hFKAL0b0O/n8G72TclJA: checks
YfsTQsY/fxb+YqbdclTHuw: checks
*** TURN *** [Kc 9h Qh] [3d]
+7hFKAL0b0O/n8G72TclJA: bets $2
YfsTQsY/fxb+YqbdclTHuw: folds
+7hFKAL0b0O/n8G72TclJA collected $1.90 from pot
*** SUMMARY ***
Total pot $2 | Rake $0.10
Board [Kc 9h Qh 3d]
Seat 1: lsLuWlcPA3Rh7kJVLzMh0Q folded before Flop (didn't bet)
Seat 2: RqgF7gRoKgRNW8Zoi1ty4A folded before Flop (didn't bet)
Seat 3: DAIgyIWbYvAkL6PbAI27pg folded before Flop (didn't bet)
Seat 4: 4OO5v3AVduL0tePNx8wk5A (button) folded before Flop (didn't bet)
Seat 5: +7hFKAL0b0O/n8G72TclJA (small blind) collected ($1.90)
Seat 6: YfsTQsY/fxb+YqbdclTHuw (big blind) folded on the Turn



PokerStars Game #59940583678:  Hold'em No Limit ($0.50/$1.00) - 2009/07/01 1:10:45 ET
Table 'fZjVbKj9D8yOB+Rj7NaP/A' 9-max Seat #2 is the button
Seat 1: Oh57946S8OPACStkrhQm7g ($126 in chips)
Seat 2: PTAFYDIUSsG+SArbxNl+Aw ($112 in chips)
Seat 3: yAbu2QsRPVcjPbqlf/jDxw ($103 in chips)
Seat 4: 997ViqAtWn1FPjJqcffwcA ($104.50 in chips)
Seat 5: PkGfq5xrSlNsujKaG/HF4Q ($100 in chips)
Seat 6: OvwYHV65yUbgdBjSmo1+5g ($34.50 in chips)
Seat 7: SyS20PAm3RpT6uLBsGkwOA ($113.25 in chips)
Seat 9: qheQay5YvP2DMAb3OUSxtw ($99 in chips)
yAbu2QsRPVcjPbqlf/jDxw: posts small blind $0.50
997ViqAtWn1FPjJqcffwcA: posts big blind $1
zDOE5r14tWqCf6xhuSHK6g: sits out
Oh57946S8OPACStkrhQm7g: posts big blind $1
*** HOLE CARDS ***
PkGfq5xrSlNsujKaG/HF4Q: folds
OvwYHV65yUbgdBjSmo1+5g: calls $1
SyS20PAm3RpT6uLBsGkwOA: folds
qheQay5YvP2DMAb3OUSxtw: folds
Oh57946S8OPACStkrhQm7g: checks
PTAFYDIUSsG+SArbxNl+Aw: raises $4 to $5
yAbu2QsRPVcjPbqlf/jDxw: folds
997ViqAtWn1FPjJqcffwcA: folds
OvwYHV65yUbgdBjSmo1+5g: calls $4
Oh57946S8OPACStkrhQm7g: folds
*** FLOP *** [Ah Jh 4h]
OvwYHV65yUbgdBjSmo1+5g: checks
PTAFYDIUSsG+SArbxNl+Aw: checks
*** TURN *** [Ah Jh 4h] [6h]
OvwYHV65yUbgdBjSmo1+5g: checks
PTAFYDIUSsG+SArbxNl+Aw: checks
*** RIVER *** [Ah Jh 4h 6h] [9c]
OvwYHV65yUbgdBjSmo1+5g: bets $5
PTAFYDIUSsG+SArbxNl+Aw: folds
OvwYHV65yUbgdBjSmo1+5g collected $11.90 from pot
*** SUMMARY ***
Total pot $12.50 | Rake $0.60
Board [Ah Jh 4h 6h 9c]
Seat 1: Oh57946S8OPACStkrhQm7g folded before Flop
Seat 2: PTAFYDIUSsG+SArbxNl+Aw (button) folded on the River
Seat 3: yAbu2QsRPVcjPbqlf/jDxw (small blind) folded before Flop
Seat 4: 997ViqAtWn1FPjJqcffwcA (big blind) folded before Flop
Seat 5: PkGfq5xrSlNsujKaG/HF4Q folded before Flop (didn't bet)
Seat 6: OvwYHV65yUbgdBjSmo1+5g collected ($11.90)
Seat 7: SyS20PAm3RpT6uLBsGkwOA folded before Flop (didn't bet)
Seat 9: qheQay5YvP2DMAb3OUSxtw folded before Flop (didn't bet)



PokerStars Game #59940583236:  Hold'em No Limit ($0.50/$1.00) - 2009/07/01 1:10:45 ET
Table 'O96CPOtvMBWP6kzuYDfdFA' 6-max Seat #2 is the button
Seat 1: 6alLXQIITA2EZ/lBeym8Dw ($119.55 in chips)
Seat 2: 4d1rWhpu8DzLmzMbR3QKyA ($100 in chips)
Seat 4: /P4w1pHg2zHYg/4ubJ0dPw ($62.55 in chips)
Seat 5: G5ZSSN6RSON3gkNvk/SmYg ($100 in chips)
Seat 6: GYei5jXGWexiJYbAT2fELg ($44.90 in chips)
/P4w1pHg2zHYg/4ubJ0dPw: posts small blind $0.50
G5ZSSN6RSON3gkNvk/SmYg: posts big blind $1
*** HOLE CARDS ***
GYei5jXGWexiJYbAT2fELg: calls $1
6alLXQIITA2EZ/lBeym8Dw: folds
4d1rWhpu8DzLmzMbR3QKyA: raises $3 to $4
/P4w1pHg2zHYg/4ubJ0dPw: folds
G5ZSSN6RSON3gkNvk/SmYg: folds
GYei5jXGWexiJYbAT2fELg: calls $3
*** FLOP *** [Th 9s 8h]
GYei5jXGWexiJYbAT2fELg: checks
4d1rWhpu8DzLmzMbR3QKyA: bets $7
GYei5jXGWexiJYbAT2fELg: calls $7
*** TURN *** [Th 9s 8h] [2h]
GYei5jXGWexiJYbAT2fELg: checks
4d1rWhpu8DzLmzMbR3QKyA: bets $14
GYei5jXGWexiJYbAT2fELg: folds
4d1rWhpu8DzLmzMbR3QKyA collected $22.35 from pot
*** SUMMARY ***
Total pot $23.50 | Rake $1.15
Board [Th 9s 8h 2h]
Seat 1: 6alLXQIITA2EZ/lBeym8Dw folded before Flop (didn't bet)
Seat 2: 4d1rWhpu8DzLmzMbR3QKyA (button) collected ($22.35)
Seat 4: /P4w1pHg2zHYg/4ubJ0dPw (small blind) folded before Flop
Seat 5: G5ZSSN6RSON3gkNvk/SmYg (big blind) folded before Flop
Seat 6: GYei5jXGWexiJYbAT2fELg folded on the Turn



PokerStars Game #59940583866:  Hold'em No Limit ($0.50/$1.00) - 2009/07/01 1:10:46 ET
Table 'JTT1XWaDZHSaMZQK7cR5uw' 2-max Seat #2 is the button
Seat 1: OLplZF6FEnLflv81Hz+Fxg ($153.45 in chips)
Seat 2: BcqgegiOUxmBD3F3umsljg ($51.95 in chips)
BcqgegiOUxmBD3F3umsljg: posts small blind $0.50
OLplZF6FEnLflv81Hz+Fxg: posts big blind $1
*** HOLE CARDS ***
BcqgegiOUxmBD3F3umsljg: raises $1 to $2
OLplZF6FEnLflv81Hz+Fxg: raises $5 to $7
BcqgegiOUxmBD3F3umsljg: folds
OLplZF6FEnLflv81Hz+Fxg collected $4 from pot
*** SUMMARY ***
Total pot $4 | Rake $0
Seat 1: OLplZF6FEnLflv81Hz+Fxg (big blind) collected ($4)
Seat 2: BcqgegiOUxmBD3F3umsljg (button) (small blind) folded before Flop



PokerStars Game #59940585824:  Hold'em No Limit ($0.50/$1.00) - 2009/07/01 1:10:49 ET
Table 'fTlPiCj0utgzC/5io+I7ew' 6-max Seat #1 is the button
Seat 1: YMJG+F++3Aj6P8dAWda5fw ($101.35 in chips)
Seat 3: Z2fXsGcjl+Eax+RzOgwOmg ($101.50 in chips)
Seat 4: uJVSceLggtsrJya+WtmUEA ($185.65 in chips)
Seat 6: /P4w1pHg2zHYg/4ubJ0dPw ($69.05 in chips)
Z2fXsGcjl+Eax+RzOgwOmg: posts small blind $0.50
uJVSceLggtsrJya+WtmUEA: posts big blind $1
XUk5GQsfNFpHvaToDZ0rZA: sits out
*** HOLE CARDS ***
/P4w1pHg2zHYg/4ubJ0dPw: folds
YMJG+F++3Aj6P8dAWda5fw: raises $2 to $3
Z2fXsGcjl+Eax+RzOgwOmg: folds
uJVSceLggtsrJya+WtmUEA: folds
YMJG+F++3Aj6P8dAWda5fw collected $2.50 from pot
*** SUMMARY ***
Total pot $2.50 | Rake $0
Seat 1: YMJG+F++3Aj6P8dAWda5fw (button) collected ($2.50)
Seat 3: Z2fXsGcjl+Eax+RzOgwOmg (small blind) folded before Flop
Seat 4: uJVSceLggtsrJya+WtmUEA (big blind) folded before Flop
Seat 6: /P4w1pHg2zHYg/4ubJ0dPw folded before Flop (didn't bet)



PokerStars Game #59940585942:  Hold'em No Limit ($0.50/$1.00) - 2009/07/01 1:10:49 ET
Table '7Nl0ffnjeK44/vmeexh3MQ' 9-max Seat #8 is the button
Seat 1: V138SURkdX8LdVBPKdJJag ($100 in chips)
Seat 2: OGgaARGdJQT4awWVNQ957w ($100 in chips)
Seat 3: JMmUYT5pIKCKh2pGjCB/4w ($42.95 in chips)
Seat 4: bLbSOSmSOnqE0iTcH/5dxA ($104.15 in chips)
Seat 5: 61sfw5QTu62YYIt68OsdrA ($79 in chips)
Seat 6: FVs16t7GgfWgQWt4JxsObQ ($31.35 in chips)
Seat 7: 997ViqAtWn1FPjJqcffwcA ($100 in chips)
Seat 8: D+W9Me7w6Hcx/WRUSKV0dw ($18.25 in chips)
Seat 9: ouwUBGRKnKK9uhn1G4Lf+A ($194.50 in chips)
ouwUBGRKnKK9uhn1G4Lf+A: posts small blind $0.50
V138SURkdX8LdVBPKdJJag: posts big blind $1
*** HOLE CARDS ***
OGgaARGdJQT4awWVNQ957w: folds
JMmUYT5pIKCKh2pGjCB/4w: folds
bLbSOSmSOnqE0iTcH/5dxA: folds
61sfw5QTu62YYIt68OsdrA: folds
FVs16t7GgfWgQWt4JxsObQ: folds
997ViqAtWn1FPjJqcffwcA: folds
D+W9Me7w6Hcx/WRUSKV0dw: folds
ouwUBGRKnKK9uhn1G4Lf+A: folds
V138SURkdX8LdVBPKdJJag collected $1 from pot
V138SURkdX8LdVBPKdJJag: doesn't show hand
*** SUMMARY ***
Total pot $1 | Rake $0
Seat 1: V138SURkdX8LdVBPKdJJag (big blind) collected ($1)
Seat 2: OGgaARGdJQT4awWVNQ957w folded before Flop (didn't bet)
Seat 3: JMmUYT5pIKCKh2pGjCB/4w folded before Flop (didn't bet)
Seat 4: bLbSOSmSOnqE0iTcH/5dxA folded before Flop (didn't bet)
Seat 5: 61sfw5QTu62YYIt68OsdrA folded before Flop (didn't bet)
Seat 6: FVs16t7GgfWgQWt4JxsObQ folded before Flop (didn't bet)
Seat 7: 997ViqAtWn1FPjJqcffwcA folded before Flop (didn't bet)
Seat 8: D+W9Me7w6Hcx/WRUSKV0dw (button) folded before Flop (didn't bet)
Seat 9: ouwUBGRKnKK9uhn1G4Lf+A (small blind) folded before Flop



PokerStars Game #59940587294:  Hold'em No Limit ($0.50/$1.00) - 2009/07/01 1:10:51 ET
Table 'cBDNutyLBKEk9+ptwsKmTw' 6-max Seat #4 is the button
Seat 1: xAU6q2/cwmby2sxmA8VcmA ($126.90 in chips)
Seat 2: 5lY8d6Cnm4HUkt/8FZSj4g ($8.70 in chips)
Seat 3: G5ZSSN6RSON3gkNvk/SmYg ($100 in chips)
Seat 4: 3q7F5QtzC30pSrn0nl9i+A ($48.60 in chips)
Seat 6: NqVlOSH2lp+pp/TK3vvK5g ($79.15 in chips)
hpxXcmRkXXI9HE5+5/j/0Q will be allowed to play after the button
NqVlOSH2lp+pp/TK3vvK5g: posts small blind $0.50
xAU6q2/cwmby2sxmA8VcmA: posts big blind $1
*** HOLE CARDS ***
5lY8d6Cnm4HUkt/8FZSj4g: folds
G5ZSSN6RSON3gkNvk/SmYg: folds
3q7F5QtzC30pSrn0nl9i+A: calls $1
NqVlOSH2lp+pp/TK3vvK5g: calls $0.50
xAU6q2/cwmby2sxmA8VcmA: checks
*** FLOP *** [2h 2c Jh]
NqVlOSH2lp+pp/TK3vvK5g: checks
xAU6q2/cwmby2sxmA8VcmA: checks
3q7F5QtzC30pSrn0nl9i+A: checks
*** TURN *** [2h 2c Jh] [Qc]
NqVlOSH2lp+pp/TK3vvK5g: bets $1
xAU6q2/cwmby2sxmA8VcmA: calls $1
3q7F5QtzC30pSrn0nl9i+A: calls $1
*** RIVER *** [2h 2c Jh Qc] [Ad]
NqVlOSH2lp+pp/TK3vvK5g: checks
xAU6q2/cwmby2sxmA8VcmA: bets $4
3q7F5QtzC30pSrn0nl9i+A: calls $4
NqVlOSH2lp+pp/TK3vvK5g: calls $4
*** SHOW DOWN ***
xAU6q2/cwmby2sxmA8VcmA: shows [Ts Kd] (a straight, Ten to Ace)
3q7F5QtzC30pSrn0nl9i+A: mucks hand
NqVlOSH2lp+pp/TK3vvK5g: mucks hand
xAU6q2/cwmby2sxmA8VcmA collected $17.15 from pot
*** SUMMARY ***
Total pot $18 | Rake $0.85
Board [2h 2c Jh Qc Ad]
Seat 1: xAU6q2/cwmby2sxmA8VcmA (big blind) showed [Ts Kd] and won ($17.15) with a straight, Ten to Ace
Seat 2: 5lY8d6Cnm4HUkt/8FZSj4g folded before Flop (didn't bet)
Seat 3: G5ZSSN6RSON3gkNvk/SmYg folded before Flop (didn't bet)
Seat 4: 3q7F5QtzC30pSrn0nl9i+A (button) mucked
Seat 6: NqVlOSH2lp+pp/TK3vvK5g (small blind) mucked



PokerStars Game #59940590072:  Hold'em No Limit ($0.50/$1.00) - 2009/07/01 1:10:56 ET
Table 'N2bNCDHL96aCQDvZIh+yQQ' 6-max Seat #4 is the button
Seat 2: TIB5eSBJLz62w6yz2+yeKw ($104.30 in chips)
Seat 3: Qy/UBNbD2HaA0Ogxg8Sf3w ($235.50 in chips)
Seat 4: uCqEjnxh2/vFBjKYkfTOkw ($201.50 in chips)
Seat 5: 8OEJHwpMpZZfyaTpXEDFfw ($6.45 in chips)
Seat 6: UU/mxjS3TL57GLD6iS6FPw ($20 in chips)
8OEJHwpMpZZfyaTpXEDFfw: posts small blind $0.50
UU/mxjS3TL57GLD6iS6FPw: posts big blind $1
*** HOLE CARDS ***
TIB5eSBJLz62w6yz2+yeKw: calls $1
Qy/UBNbD2HaA0Ogxg8Sf3w: folds
uCqEjnxh2/vFBjKYkfTOkw: folds
8OEJHwpMpZZfyaTpXEDFfw: calls $0.50
UU/mxjS3TL57GLD6iS6FPw: checks
*** FLOP *** [9s 5d 7d]
8OEJHwpMpZZfyaTpXEDFfw: checks
UU/mxjS3TL57GLD6iS6FPw: bets $1
TIB5eSBJLz62w6yz2+yeKw: calls $1
8OEJHwpMpZZfyaTpXEDFfw: calls $1
*** TURN *** [9s 5d 7d] [Qd]
8OEJHwpMpZZfyaTpXEDFfw: checks
UU/mxjS3TL57GLD6iS6FPw: checks
TIB5eSBJLz62w6yz2+yeKw: bets $3
8OEJHwpMpZZfyaTpXEDFfw: folds
UU/mxjS3TL57GLD6iS6FPw: folds
TIB5eSBJLz62w6yz2+yeKw collected $5.75 from pot
*** SUMMARY ***
Total pot $6 | Rake $0.25
Board [9s 5d 7d Qd]
Seat 2: TIB5eSBJLz62w6yz2+yeKw collected ($5.75)
Seat 3: Qy/UBNbD2HaA0Ogxg8Sf3w folded before Flop (didn't bet)
Seat 4: uCqEjnxh2/vFBjKYkfTOkw (button) folded before Flop (didn't bet)
Seat 5: 8OEJHwpMpZZfyaTpXEDFfw (small blind) folded on the Turn
Seat 6: UU/mxjS3TL57GLD6iS6FPw (big blind) folded on the Turn



PokerStars Game #59940589856:  Hold'em No Limit ($0.50/$1.00) - 2009/07/01 1:10:56 ET
Table 'JTT1XWaDZHSaMZQK7cR5uw' 2-max Seat #1 is the button
Seat 1: OLplZF6FEnLflv81Hz+Fxg ($155.45 in chips)
Seat 2: BcqgegiOUxmBD3F3umsljg ($49.95 in chips)
OLplZF6FEnLflv81Hz+Fxg: posts small blind $0.50
BcqgegiOUxmBD3F3umsljg: posts big blind $1
*** HOLE CARDS ***
OLplZF6FEnLflv81Hz+Fxg said, "100 please"
OLplZF6FEnLflv81Hz+Fxg: raises $2 to $3
BcqgegiOUxmBD3F3umsljg: raises $2 to $5
OLplZF6FEnLflv81Hz+Fxg: calls $2
*** FLOP *** [9h Qh Ah]
BcqgegiOUxmBD3F3umsljg: bets $3
OLplZF6FEnLflv81Hz+Fxg: folds
BcqgegiOUxmBD3F3umsljg collected $9.50 from pot
*** SUMMARY ***
Total pot $10 | Rake $0.50
Board [9h Qh Ah]
Seat 1: OLplZF6FEnLflv81Hz+Fxg (button) (small blind) folded on the Flop
Seat 2: BcqgegiOUxmBD3F3umsljg (big blind) collected ($9.50)



PokerStars Game #59940590416:  Hold'em No Limit ($0.50/$1.00) - 2009/07/01 1:10:57 ET
Table 'tyUh+jyNvrceIQdKMJjQ2wZFWj23PMihdwrNWv41OG/Qeat #2 is the button
Seat 1: o8A5MUdudVKu+pAwgZOX2w ($114.95 in chips)
Seat 2: 5uy3EN+iIYkgwbWZFTUBAQ ($100 in chips)
Seat 3: TalCiLYHCd+ffkmR3auPvA ($147.30 in chips)
Seat 4: hpxXcmRkXXI9HE5+5/j/0Q ($100 in chips)
Seat 5: j7NIOHLZk7V2o9fOioO5ug ($100 in chips)
Seat 6: 4OO5v3AVduL0tePNx8wk5A ($100 in chips)
TalCiLYHCd+ffkmR3auPvA: posts small blind $0.50
hpxXcmRkXXI9HE5+5/j/0Q: posts big blind $1
*** HOLE CARDS ***
j7NIOHLZk7V2o9fOioO5ug: folds
4OO5v3AVduL0tePNx8wk5A: folds
o8A5MUdudVKu+pAwgZOX2w: calls $1
5uy3EN+iIYkgwbWZFTUBAQ: raises $3.50 to $4.50
TalCiLYHCd+ffkmR3auPvA: folds
hpxXcmRkXXI9HE5+5/j/0Q: folds
o8A5MUdudVKu+pAwgZOX2w: calls $3.50
*** FLOP *** [7c 7h 3h]
o8A5MUdudVKu+pAwgZOX2w: checks
5uy3EN+iIYkgwbWZFTUBAQ: bets $8
o8A5MUdudVKu+pAwgZOX2w: folds
5uy3EN+iIYkgwbWZFTUBAQ collected $10 from pot
5uy3EN+iIYkgwbWZFTUBAQ: doesn't show hand
*** SUMMARY ***
Total pot $10.50 | Rake $0.50
Board [7c 7h 3h]
Seat 1: o8A5MUdudVKu+pAwgZOX2w folded on the Flop
Seat 2: 5uy3EN+iIYkgwbWZFTUBAQ (button) collected ($10)
Seat 3: TalCiLYHCd+ffkmR3auPvA (small blind) folded before Flop
Seat 4: hpxXcmRkXXI9HE5+5/j/0Q (big blind) folded before Flop
Seat 5: j7NIOHLZk7V2o9fOioO5ug folded before Flop (didn't bet)
Seat 6: 4OO5v3AVduL0tePNx8wk5A folded before Flop (didn't bet)



PokerStars Game #59940592708:  Hold'em No Limit ($0.50/$1.00) - 2009/07/01 1:11:01 ET
Table 'QSIig7BLMc9wY/rgBechzw' 6-max Seat #5 is the button
Seat 1: Z2fXsGcjl+Eax+RzOgwOmg ($115 in chips)
Seat 2: mLOIkH/qmRa+mVujQIhBRg ($39.60 in chips)
Seat 3: +xW7QemQU0Fxs+4TnqBRow ($100 in chips)
Seat 4: +uSzP8Jwnw7sKfQ4s66b7w ($78.45 in chips)
Seat 5: lsLuWlcPA3Rh7kJVLzMh0Q ($102.35 in chips)
Seat 6: PxqfkAMdAWtkgbT+q2gciA ($37.15 in chips)
PxqfkAMdAWtkgbT+q2gciA: posts small blind $0.50
Z2fXsGcjl+Eax+RzOgwOmg: posts big blind $1
*** HOLE CARDS ***
mLOIkH/qmRa+mVujQIhBRg: calls $1
+xW7QemQU0Fxs+4TnqBRow: folds
+uSzP8Jwnw7sKfQ4s66b7w: folds
lsLuWlcPA3Rh7kJVLzMh0Q: folds
PxqfkAMdAWtkgbT+q2gciA: calls $0.50
Z2fXsGcjl+Eax+RzOgwOmg: checks
*** FLOP *** [Jh 8s As]
PxqfkAMdAWtkgbT+q2gciA: bets $2
Z2fXsGcjl+Eax+RzOgwOmg: folds
mLOIkH/qmRa+mVujQIhBRg: folds
PxqfkAMdAWtkgbT+q2gciA collected $2.85 from pot
*** SUMMARY ***
Total pot $3 | Rake $0.15
Board [Jh 8s As]
Seat 1: Z2fXsGcjl+Eax+RzOgwOmg (big blind) folded on the Flop
Seat 2: mLOIkH/qmRa+mVujQIhBRg folded on the Flop
Seat 3: +xW7QemQU0Fxs+4TnqBRow folded before Flop (didn't bet)
Seat 4: +uSzP8Jwnw7sKfQ4s66b7w folded before Flop (didn't bet)
Seat 5: lsLuWlcPA3Rh7kJVLzMh0Q (button) folded before Flop (didn't bet)
Seat 6: PxqfkAMdAWtkgbT+q2gciA (small blind) collected ($2.85)



PokerStars Game #59940592906:  Hold'em No Limit ($0.50/$1.00) - 2009/07/01 1:11:01 ET
Table 'VOs36P6NW+QyXeQ1B62kmA' 6-max Seat #1 is the button
Seat 1: Z2fXsGcjl+Eax+RzOgwOmg ($100 in chips)
Seat 2: 2UMlbaZ8n8AbRli0Yr0mDw ($29.10 in chips)
Seat 3: FyNUCpzHVyQu/qX8pqNQFA ($100 in chips)
Seat 4: w02zQzNydODiyV9THKgo9w ($47.60 in chips)
Seat 5: ozrlafxxh1HmYdA0/h+MuA ($42.90 in chips)
Seat 6: slVKuQyEz8Qj4E3uLPYNXg ($108.80 in chips)
2UMlbaZ8n8AbRli0Yr0mDw: posts small blind $0.50
FyNUCpzHVyQu/qX8pqNQFA: posts big blind $1
*** HOLE CARDS ***
w02zQzNydODiyV9THKgo9w: folds
ozrlafxxh1HmYdA0/h+MuA: folds
slVKuQyEz8Qj4E3uLPYNXg: folds
Z2fXsGcjl+Eax+RzOgwOmg: folds
2UMlbaZ8n8AbRli0Yr0mDw: folds
FyNUCpzHVyQu/qX8pqNQFA collected $1 from pot
FyNUCpzHVyQu/qX8pqNQFA: doesn't show hand
*** SUMMARY ***
Total pot $1 | Rake $0
Seat 1: Z2fXsGcjl+Eax+RzOgwOmg (button) folded before Flop (didn't bet)
Seat 2: 2UMlbaZ8n8AbRli0Yr0mDw (small blind) folded before Flop
Seat 3: FyNUCpzHVyQu/qX8pqNQFA (big blind) collected ($1)
Seat 4: w02zQzNydODiyV9THKgo9w folded before Flop (didn't bet)
Seat 5: ozrlafxxh1HmYdA0/h+MuA folded before Flop (didn't bet)
Seat 6: slVKuQyEz8Qj4E3uLPYNXg folded before Flop (didn't bet)



PokerStars Game #59940594822:  Hold'em No Limit ($0.50/$1.00) - 2009/07/01 1:11:04 ET
Table 'kS0cTQAEi+fdUlJP2gQYvw' 9-max Seat #3 is the button
Seat 1: c/9X4zftzphFxYtxp5kp9w ($64.35 in chips)
Seat 2: D+W9Me7w6Hcx/WRUSKV0dw ($20.90 in chips)
Seat 3: 2BV+oJIQYr65IO6nEChvbA ($60 in chips)
Seat 5: 997ViqAtWn1FPjJqcffwcA ($101.65 in chips)
Seat 6: yAbu2QsRPVcjPbqlf/jDxw ($129.65 in chips)
Seat 7: Ffa7Nj4X5fddtROP01hfQg ($153.25 in chips)
Seat 9: OGgaARGdJQT4awWVNQ957w ($101.50 in chips)
997ViqAtWn1FPjJqcffwcA: posts small blind $0.50
yAbu2QsRPVcjPbqlf/jDxw: posts big blind $1
*** HOLE CARDS ***
Ffa7Nj4X5fddtROP01hfQg: calls $1
OGgaARGdJQT4awWVNQ957w: folds
c/9X4zftzphFxYtxp5kp9w: folds
D+W9Me7w6Hcx/WRUSKV0dw: folds
2BV+oJIQYr65IO6nEChvbA: calls $1
997ViqAtWn1FPjJqcffwcA: folds
yAbu2QsRPVcjPbqlf/jDxw: checks
*** FLOP *** [5c 6h 9d]
yAbu2QsRPVcjPbqlf/jDxw: bets $2
Ffa7Nj4X5fddtROP01hfQg: raises $2 to $4
2BV+oJIQYr65IO6nEChvbA: folds
yAbu2QsRPVcjPbqlf/jDxw: folds
Ffa7Nj4X5fddtROP01hfQg collected $7.15 from pot
*** SUMMARY ***
Total pot $7.50 | Rake $0.35
Board [5c 6h 9d]
Seat 1: c/9X4zftzphFxYtxp5kp9w folded before Flop (didn't bet)
Seat 2: D+W9Me7w6Hcx/WRUSKV0dw folded before Flop (didn't bet)
Seat 3: 2BV+oJIQYr65IO6nEChvbA (button) folded on the Flop
Seat 5: 997ViqAtWn1FPjJqcffwcA (small blind) folded before Flop
Seat 6: yAbu2QsRPVcjPbqlf/jDxw (big blind) folded on the Flop
Seat 7: Ffa7Nj4X5fddtROP01hfQg collected ($7.15)
Seat 9: OGgaARGdJQT4awWVNQ957w folded before Flop (didn't bet)



PokerStars Game #59940594510:  Hold'em No Limit ($0.50/$1.00) - 2009/07/01 1:11:04 ET
Table 'W/wyObTiXZm+Ckkl3YxcSw' 6-max Seat #1 is the button
Seat 1: eUBBn2R56C1IQ6Cs/vitwg ($180.25 in chips)
Seat 2: oDiBRCaF0QVtd3kO6xZIXw ($155.35 in chips)
Seat 3: dxyNCn/qxfkGDUIf28Cbng ($57.40 in chips)
Seat 4: aYii2DmxlOlbC1wbGRBWvQ ($108.60 in chips)
Seat 5: MFptnnT6AnJakWBooTkmeg ($20.65 in chips)
oDiBRCaF0QVtd3kO6xZIXw: posts small blind $0.50
dxyNCn/qxfkGDUIf28Cbng: posts big blind $1
*** HOLE CARDS ***
aYii2DmxlOlbC1wbGRBWvQ: calls $1
MFptnnT6AnJakWBooTkmeg: calls $1
eUBBn2R56C1IQ6Cs/vitwg: folds
oDiBRCaF0QVtd3kO6xZIXw: calls $0.50
dxyNCn/qxfkGDUIf28Cbng: checks
*** FLOP *** [Kc Qh Ac]
oDiBRCaF0QVtd3kO6xZIXw: checks
dxyNCn/qxfkGDUIf28Cbng: checks
aYii2DmxlOlbC1wbGRBWvQ: bets $3
MFptnnT6AnJakWBooTkmeg: folds
oDiBRCaF0QVtd3kO6xZIXw: folds
dxyNCn/qxfkGDUIf28Cbng: folds
aYii2DmxlOlbC1wbGRBWvQ collected $3.80 from pot
*** SUMMARY ***
Total pot $4 | Rake $0.20
Board [Kc Qh Ac]
Seat 1: eUBBn2R56C1IQ6Cs/vitwg (button) folded before Flop (didn't bet)
Seat 2: oDiBRCaF0QVtd3kO6xZIXw (small blind) folded on the Flop
Seat 3: dxyNCn/qxfkGDUIf28Cbng (big blind) folded on the Flop
Seat 4: aYii2DmxlOlbC1wbGRBWvQ collected ($3.80)
Seat 5: MFptnnT6AnJakWBooTkmeg folded on the Flop



PokerStars Game #59940595372:  Hold'em No Limit ($0.50/$1.00) - 2009/07/01 1:11:05 ET
Table 'pHrhryH8jPNdQfY62f8v+g' 6-max Seat #6 is the button
Seat 1: 4d1rWhpu8DzLmzMbR3QKyA ($100 in chips)
Seat 3: 8oS5O7iD/qnFXFXJrGIgNQ ($100 in chips)
Seat 4: 1f3beyIML24UqEMTbWy93g ($58.15 in chips)
Seat 5: r1/R7y0Ortgoz4lccgW8VA ($39.15 in chips)
Seat 6: xAU6q2/cwmby2sxmA8VcmA ($208.10 in chips)
4d1rWhpu8DzLmzMbR3QKyA: posts small blind $0.50
8oS5O7iD/qnFXFXJrGIgNQ: posts big blind $1
*** HOLE CARDS ***
RqgF7gRoKgRNW8Zoi1ty4A leaves the table
1f3beyIML24UqEMTbWy93g: raises $2 to $3
r1/R7y0Ortgoz4lccgW8VA: folds
xAU6q2/cwmby2sxmA8VcmA: folds
4d1rWhpu8DzLmzMbR3QKyA: folds
8oS5O7iD/qnFXFXJrGIgNQ: folds
1f3beyIML24UqEMTbWy93g collected $2.50 from pot
*** SUMMARY ***
Total pot $2.50 | Rake $0
Seat 1: 4d1rWhpu8DzLmzMbR3QKyA (small blind) folded before Flop
Seat 3: 8oS5O7iD/qnFXFXJrGIgNQ (big blind) folded before Flop
Seat 4: 1f3beyIML24UqEMTbWy93g collected ($2.50)
Seat 5: r1/R7y0Ortgoz4lccgW8VA folded before Flop (didn't bet)
Seat 6: xAU6q2/cwmby2sxmA8VcmA (button) folded before Flop (didn't bet)



PokerStars Game #59940595238:  Hold'em No Limit ($0.50/$1.00) - 2009/07/01 1:11:05 ET
Table 'vs/5jr6ciwjVQ5+Soc+u2A' 6-max Seat #4 is the button
Seat 1: /P4w1pHg2zHYg/4ubJ0dPw ($89.80 in chips)
Seat 2: lXX4W7m3u++JiSOZ46yVMQ ($129.55 in chips)
Seat 3: G5ZSSN6RSON3gkNvk/SmYg ($125.35 in chips)
Seat 4: wk6Ohn4GDozoOMHc4eb2rw ($59.65 in chips)
Seat 5: +Nt3OPk3XR9SKjZgm2CexQ ($107.95 in chips)
Seat 6: Z2fXsGcjl+Eax+RzOgwOmg ($100 in chips)
+Nt3OPk3XR9SKjZgm2CexQ: posts small blind $0.50
Z2fXsGcjl+Eax+RzOgwOmg: posts big blind $1
*** HOLE CARDS ***
/P4w1pHg2zHYg/4ubJ0dPw: folds
/P4w1pHg2zHYg/4ubJ0dPw leaves the table
lXX4W7m3u++JiSOZ46yVMQ: raises $2 to $3
G5ZSSN6RSON3gkNvk/SmYg: folds
wk6Ohn4GDozoOMHc4eb2rw: calls $3
+Nt3OPk3XR9SKjZgm2CexQ: folds
J798qwLuvXyq0BbzsIjOrA joins the table at seat #1
Z2fXsGcjl+Eax+RzOgwOmg: folds
*** FLOP *** [2d Kd 8h]
lXX4W7m3u++JiSOZ46yVMQ: checks
wk6Ohn4GDozoOMHc4eb2rw: bets $3
lXX4W7m3u++JiSOZ46yVMQ: folds
wk6Ohn4GDozoOMHc4eb2rw collected $7.15 from pot
wk6Ohn4GDozoOMHc4eb2rw: doesn't show hand
*** SUMMARY ***
Total pot $7.50 | Rake $0.35
Board [2d Kd 8h]
Seat 1: /P4w1pHg2zHYg/4ubJ0dPw folded before Flop (didn't bet)
Seat 2: lXX4W7m3u++JiSOZ46yVMQ folded on the Flop
Seat 3: G5ZSSN6RSON3gkNvk/SmYg folded before Flop (didn't bet)
Seat 4: wk6Ohn4GDozoOMHc4eb2rw (button) collected ($7.15)
Seat 5: +Nt3OPk3XR9SKjZgm2CexQ (small blind) folded before Flop
Seat 6: Z2fXsGcjl+Eax+RzOgwOmg (big blind) folded before Flop



PokerStars Game #59940595930:  Hold'em No Limit ($0.50/$1.00) - 2009/07/01 1:11:06 ET
Table 'mmbQQVBTrPdE+wy+s+9VPA' 6-max Seat #6 is the button
Seat 1: zyP4SPoWZnKUfTvIRLCVog ($70.55 in chips)
Seat 2: XK4Qsl+DA8gAJyg85/zBIw ($20 in chips)
Seat 3: wx3sQGkVi2x9wJXuWNHPBw ($111.15 in chips)
Seat 4: V3iZdcw61nXF3g5hD2RrsQ ($112.40 in chips)
Seat 5: YMJG+F++3Aj6P8dAWda5fw ($103.60 in chips)
Seat 6: U2CWBTv29qdCbj8RNF2sIw ($106.95 in chips)
zyP4SPoWZnKUfTvIRLCVog: posts small blind $0.50
XK4Qsl+DA8gAJyg85/zBIw: posts big blind $1
*** HOLE CARDS ***
wx3sQGkVi2x9wJXuWNHPBw: folds
V3iZdcw61nXF3g5hD2RrsQ: folds
YMJG+F++3Aj6P8dAWda5fw: folds
U2CWBTv29qdCbj8RNF2sIw: folds
zyP4SPoWZnKUfTvIRLCVog: calls $0.50
XK4Qsl+DA8gAJyg85/zBIw: checks
*** FLOP *** [9d 4d Td]
zyP4SPoWZnKUfTvIRLCVog: checks
XK4Qsl+DA8gAJyg85/zBIw: bets $2
zyP4SPoWZnKUfTvIRLCVog: calls $2
*** TURN *** [9d 4d Td] [3h]
zyP4SPoWZnKUfTvIRLCVog: checks
XK4Qsl+DA8gAJyg85/zBIw: bets $2
zyP4SPoWZnKUfTvIRLCVog: calls $2
*** RIVER *** [9d 4d Td 3h] [8d]
zyP4SPoWZnKUfTvIRLCVog: checks
XK4Qsl+DA8gAJyg85/zBIw: checks
*** SHOW DOWN ***
zyP4SPoWZnKUfTvIRLCVog: shows [Kh Qh] (high card King)
XK4Qsl+DA8gAJyg85/zBIw: shows [2d 4c] (a flush, Ten high)
XK4Qsl+DA8gAJyg85/zBIw collected $9.55 from pot
*** SUMMARY ***
Total pot $10 | Rake $0.45
Board [9d 4d Td 3h 8d]
Seat 1: zyP4SPoWZnKUfTvIRLCVog (small blind) showed [Kh Qh] and lost with high card King
Seat 2: XK4Qsl+DA8gAJyg85/zBIw (big blind) showed [2d 4c] and won ($9.55) with a flush, Ten high
Seat 3: wx3sQGkVi2x9wJXuWNHPBw folded before Flop (didn't bet)
Seat 4: V3iZdcw61nXF3g5hD2RrsQ folded before Flop (didn't bet)
Seat 5: YMJG+F++3Aj6P8dAWda5fw folded before Flop (didn't bet)
Seat 6: U2CWBTv29qdCbj8RNF2sIw (button) folded before Flop (didn't bet)



PokerStars Game #59940597358:  Hold'em No Limit ($0.50/$1.00) - 2009/07/01 1:11:09 ET
Table 'GPp0HyAuggN8oE0sUWzPpA' 9-max Seat #1 is the button
Seat 1: qJr25HAtvv1w/7IBvjMM3g ($45.20 in chips)
Seat 2: m3U8I35Pn3gxKhoS2nmYIg ($41.40 in chips)
Seat 3: CCCXsirC+bO7ginAuUUVlQ ($49.35 in chips)
Seat 4: mBRWbnUl8diyBO1qTJaNzw ($103.65 in chips)
Seat 6: BK/GtNPkSx0TdUDj82id5A ($16.35 in chips)
Seat 7: DHdbHyysD15wCAtx+BhUjA ($93.50 in chips)
Seat 9: dzoSjPZmtjGuK83119030A ($34.15 in chips)
m3U8I35Pn3gxKhoS2nmYIg: posts small blind $0.50
CCCXsirC+bO7ginAuUUVlQ: posts big blind $1
bLbSOSmSOnqE0iTcH/5dxA: sits out
P/6qLjycEfxRgZ5F/W90dw: sits out
*** HOLE CARDS ***
mBRWbnUl8diyBO1qTJaNzw: folds
BK/GtNPkSx0TdUDj82id5A: folds
DHdbHyysD15wCAtx+BhUjA: folds
dzoSjPZmtjGuK83119030A: folds
qJr25HAtvv1w/7IBvjMM3g: calls $1
m3U8I35Pn3gxKhoS2nmYIg: calls $0.50
CCCXsirC+bO7ginAuUUVlQ: raises $2 to $3
qJr25HAtvv1w/7IBvjMM3g: folds
m3U8I35Pn3gxKhoS2nmYIg: calls $2
*** FLOP *** [Ah 3s 5s]
m3U8I35Pn3gxKhoS2nmYIg: bets $5
CCCXsirC+bO7ginAuUUVlQ: calls $5
*** TURN *** [Ah 3s 5s] [Ac]
m3U8I35Pn3gxKhoS2nmYIg: bets $5
CCCXsirC+bO7ginAuUUVlQ: calls $5
*** RIVER *** [Ah 3s 5s Ac] [Kd]
m3U8I35Pn3gxKhoS2nmYIg: bets $5
CCCXsirC+bO7ginAuUUVlQ: raises $10 to $15
m3U8I35Pn3gxKhoS2nmYIg: calls $10
*** SHOW DOWN ***
CCCXsirC+bO7ginAuUUVlQ: shows [Ks As] (a full house, Aces full of Kings)
m3U8I35Pn3gxKhoS2nmYIg: mucks hand
CCCXsirC+bO7ginAuUUVlQ collected $54.25 from pot
*** SUMMARY ***
Total pot $57 | Rake $2.75
Board [Ah 3s 5s Ac Kd]
Seat 1: qJr25HAtvv1w/7IBvjMM3g (button) folded before Flop
Seat 2: m3U8I35Pn3gxKhoS2nmYIg (small blind) mucked
Seat 3: CCCXsirC+bO7ginAuUUVlQ (big blind) showed [Ks As] and won ($54.25) with a full house, Aces full of Kings
Seat 4: mBRWbnUl8diyBO1qTJaNzw folded before Flop (didn't bet)
Seat 6: BK/GtNPkSx0TdUDj82id5A folded before Flop (didn't bet)
Seat 7: DHdbHyysD15wCAtx+BhUjA folded before Flop (didn't bet)
Seat 9: dzoSjPZmtjGuK83119030A folded before Flop (didn't bet)



PokerStars Game #59940599180:  Hold'em No Limit ($0.50/$1.00) - 2009/07/01 1:11:12 ET
Table 'fTlPiCj0utgzC/5io+I7ew' 6-max Seat #3 is the button
Seat 1: YMJG+F++3Aj6P8dAWda5fw ($102.85 in chips)
Seat 3: Z2fXsGcjl+Eax+RzOgwOmg ($101 in chips)
Seat 4: uJVSceLggtsrJya+WtmUEA ($184.65 in chips)
Seat 5: XUk5GQsfNFpHvaToDZ0rZA ($50 in chips)
Seat 6: /P4w1pHg2zHYg/4ubJ0dPw ($69.05 in chips)
uJVSceLggtsrJya+WtmUEA: posts small blind $0.50
XUk5GQsfNFpHvaToDZ0rZA: posts big blind $1
*** HOLE CARDS ***
/P4w1pHg2zHYg/4ubJ0dPw: folds
YMJG+F++3Aj6P8dAWda5fw: folds
Z2fXsGcjl+Eax+RzOgwOmg: raises $2 to $3
uJVSceLggtsrJya+WtmUEA: folds
XUk5GQsfNFpHvaToDZ0rZA: folds
Z2fXsGcjl+Eax+RzOgwOmg collected $2.50 from pot
*** SUMMARY ***
Total pot $2.50 | Rake $0
Seat 1: YMJG+F++3Aj6P8dAWda5fw folded before Flop (didn't bet)
Seat 3: Z2fXsGcjl+Eax+RzOgwOmg (button) collected ($2.50)
Seat 4: uJVSceLggtsrJya+WtmUEA (small blind) folded before Flop
Seat 5: XUk5GQsfNFpHvaToDZ0rZA (big blind) folded before Flop
Seat 6: /P4w1pHg2zHYg/4ubJ0dPw folded before Flop (didn't bet)



PokerStars Game #59940600446:  Hold'em No Limit ($0.50/$1.00) - 2009/07/01 1:11:14 ET
Table 'JTT1XWaDZHSaMZQK7cR5uw' 2-max Seat #2 is the button
Seat 1: OLplZF6FEnLflv81Hz+Fxg ($150.45 in chips)
Seat 2: BcqgegiOUxmBD3F3umsljg ($54.45 in chips)
BcqgegiOUxmBD3F3umsljg: posts small blind $0.50
OLplZF6FEnLflv81Hz+Fxg: posts big blind $1
*** HOLE CARDS ***
BcqgegiOUxmBD3F3umsljg: folds
OLplZF6FEnLflv81Hz+Fxg collected $1 from pot
*** SUMMARY ***
Total pot $1 | Rake $0
Seat 1: OLplZF6FEnLflv81Hz+Fxg (big blind) collected ($1)
Seat 2: BcqgegiOUxmBD3F3umsljg (button) (small blind) folded before Flop



PokerStars Game #59940602956:  Hold'em No Limit ($0.50/$1.00) - 2009/07/01 1:11:18 ET
Table 'rmZfTK+oSebeUPJNbWhdAA' 6-max Seat #6 is the button
Seat 1: xAU6q2/cwmby2sxmA8VcmA ($147.50 in chips)
Seat 2: z7O9PO/WEcqRouIydFhS9Q ($124.40 in chips)
Seat 3: BCEV3COoKY607AzLWayfRA ($154.30 in chips)
Seat 4: 1/mIuXfgx1ZyVkodrmfQDw ($100 in chips)
Seat 5: 5lY8d6Cnm4HUkt/8FZSj4g ($52.95 in chips)
Seat 6: j7NIOHLZk7V2o9fOioO5ug ($130.50 in chips)
xAU6q2/cwmby2sxmA8VcmA: posts small blind $0.50
z7O9PO/WEcqRouIydFhS9Q: posts big blind $1
*** HOLE CARDS ***
BCEV3COoKY607AzLWayfRA: folds
1/mIuXfgx1ZyVkodrmfQDw: raises $2 to $3
5lY8d6Cnm4HUkt/8FZSj4g: calls $3
j7NIOHLZk7V2o9fOioO5ug: folds
xAU6q2/cwmby2sxmA8VcmA: folds
z7O9PO/WEcqRouIydFhS9Q: calls $2
*** FLOP *** [8s 3s 9c]
z7O9PO/WEcqRouIydFhS9Q: checks
1/mIuXfgx1ZyVkodrmfQDw: checks
5lY8d6Cnm4HUkt/8FZSj4g: checks
*** TURN *** [8s 3s 9c] [7d]
z7O9PO/WEcqRouIydFhS9Q: checks
1/mIuXfgx1ZyVkodrmfQDw: checks
5lY8d6Cnm4HUkt/8FZSj4g: checks
*** RIVER *** [8s 3s 9c 7d] [8h]
z7O9PO/WEcqRouIydFhS9Q: bets $5
1/mIuXfgx1ZyVkodrmfQDw: calls $5
5lY8d6Cnm4HUkt/8FZSj4g: folds
*** SHOW DOWN ***
z7O9PO/WEcqRouIydFhS9Q: shows [Qh 8d] (three of a kind, Eights)
1/mIuXfgx1ZyVkodrmfQDw: mucks hand
z7O9PO/WEcqRouIydFhS9Q collected $18.55 from pot
*** SUMMARY ***
Total pot $19.50 | Rake $0.95
Board [8s 3s 9c 7d 8h]
Seat 1: xAU6q2/cwmby2sxmA8VcmA (small blind) folded before Flop
Seat 2: z7O9PO/WEcqRouIydFhS9Q (big blind) showed [Qh 8d] and won ($18.55) with three of a kind, Eights
Seat 3: BCEV3COoKY607AzLWayfRA folded before Flop (didn't bet)
Seat 4: 1/mIuXfgx1ZyVkodrmfQDw mucked
Seat 5: 5lY8d6Cnm4HUkt/8FZSj4g folded on the River
Seat 6: j7NIOHLZk7V2o9fOioO5ug (button) folded before Flop (didn't bet)



PokerStars Game #59940603814:  Hold'em No Limit ($0.50/$1.00) - 2009/07/01 1:11:19 ET
Table 'VOs36P6NW+QyXeQ1B62kmA' 6-max Seat #2 is the button
Seat 1: Z2fXsGcjl+Eax+RzOgwOmg ($100 in chips)
Seat 2: 2UMlbaZ8n8AbRli0Yr0mDw ($28.60 in chips)
Seat 3: FyNUCpzHVyQu/qX8pqNQFA ($100.50 in chips)
Seat 4: w02zQzNydODiyV9THKgo9w ($47.60 in chips)
Seat 5: ozrlafxxh1HmYdA0/h+MuA ($42.90 in chips)
Seat 6: slVKuQyEz8Qj4E3uLPYNXg ($108.80 in chips)
FyNUCpzHVyQu/qX8pqNQFA: posts small blind $0.50
w02zQzNydODiyV9THKgo9w: posts big blind $1
*** HOLE CARDS ***
ozrlafxxh1HmYdA0/h+MuA: calls $1
slVKuQyEz8Qj4E3uLPYNXg: calls $1
Z2fXsGcjl+Eax+RzOgwOmg: folds
2UMlbaZ8n8AbRli0Yr0mDw: calls $1
FyNUCpzHVyQu/qX8pqNQFA: calls $0.50
w02zQzNydODiyV9THKgo9w: checks
*** FLOP *** [8d Th 2c]
FyNUCpzHVyQu/qX8pqNQFA: checks
w02zQzNydODiyV9THKgo9w: checks
ozrlafxxh1HmYdA0/h+MuA: checks
slVKuQyEz8Qj4E3uLPYNXg: checks
2UMlbaZ8n8AbRli0Yr0mDw: bets $4
FyNUCpzHVyQu/qX8pqNQFA: folds
w02zQzNydODiyV9THKgo9w: folds
ozrlafxxh1HmYdA0/h+MuA: folds
slVKuQyEz8Qj4E3uLPYNXg: folds
2UMlbaZ8n8AbRli0Yr0mDw collected $4.75 from pot
2UMlbaZ8n8AbRli0Yr0mDw: doesn't show hand
*** SUMMARY ***
Total pot $5 | Rake $0.25
Board [8d Th 2c]
Seat 1: Z2fXsGcjl+Eax+RzOgwOmg folded before Flop (didn't bet)
Seat 2: 2UMlbaZ8n8AbRli0Yr0mDw (button) collected ($4.75)
Seat 3: FyNUCpzHVyQu/qX8pqNQFA (small blind) folded on the Flop
Seat 4: w02zQzNydODiyV9THKgo9w (big blind) folded on the Flop
Seat 5: ozrlafxxh1HmYdA0/h+MuA folded on the Flop
Seat 6: slVKuQyEz8Qj4E3uLPYNXg folded on the Flop



PokerStars Game #59940604432:  Hold'em No Limit ($0.50/$1.00) - 2009/07/01 1:11:20 ET
Table 'JTT1XWaDZHSaMZQK7cR5uw' 2-max Seat #1 is the button
Seat 1: OLplZF6FEnLflv81Hz+Fxg ($150.95 in chips)
Seat 2: BcqgegiOUxmBD3F3umsljg ($53.95 in chips)
OLplZF6FEnLflv81Hz+Fxg: posts small blind $0.50
BcqgegiOUxmBD3F3umsljg: posts big blind $1
*** HOLE CARDS ***
OLplZF6FEnLflv81Hz+Fxg: folds
OLplZF6FEnLflv81Hz+Fxg is sitting out
BcqgegiOUxmBD3F3umsljg collected $1 from pot
*** SUMMARY ***
Total pot $1 | Rake $0
Seat 1: OLplZF6FEnLflv81Hz+Fxg (button) (small blind) folded before Flop
Seat 2: BcqgegiOUxmBD3F3umsljg (big blind) collected ($1)



PokerStars Game #59940603946:  Hold'em No Limit ($0.50/$1.00) - 2009/07/01 1:11:20 ET
Table '7Nl0ffnjeK44/vmeexh3MQ' 9-max Seat #9 is the button
Seat 1: V138SURkdX8LdVBPKdJJag ($100.50 in chips)
Seat 2: OGgaARGdJQT4awWVNQ957w ($100 in chips)
Seat 3: JMmUYT5pIKCKh2pGjCB/4w ($42.95 in chips)
Seat 4: bLbSOSmSOnqE0iTcH/5dxA ($104.15 in chips)
Seat 5: 61sfw5QTu62YYIt68OsdrA ($79 in chips)
Seat 6: FVs16t7GgfWgQWt4JxsObQ ($31.35 in chips)
Seat 7: 997ViqAtWn1FPjJqcffwcA ($100 in chips)
Seat 8: D+W9Me7w6Hcx/WRUSKV0dw ($18.25 in chips)
Seat 9: ouwUBGRKnKK9uhn1G4Lf+A ($194 in chips)
V138SURkdX8LdVBPKdJJag: posts small blind $0.50
OGgaARGdJQT4awWVNQ957w: posts big blind $1
*** HOLE CARDS ***
JMmUYT5pIKCKh2pGjCB/4w: calls $1
bLbSOSmSOnqE0iTcH/5dxA: folds
61sfw5QTu62YYIt68OsdrA: raises $4 to $5
FVs16t7GgfWgQWt4JxsObQ: folds
997ViqAtWn1FPjJqcffwcA: folds
D+W9Me7w6Hcx/WRUSKV0dw: folds
ouwUBGRKnKK9uhn1G4Lf+A: folds
V138SURkdX8LdVBPKdJJag: folds
OGgaARGdJQT4awWVNQ957w: folds
JMmUYT5pIKCKh2pGjCB/4w: folds
61sfw5QTu62YYIt68OsdrA collected $3.50 from pot
61sfw5QTu62YYIt68OsdrA: doesn't show hand
*** SUMMARY ***
Total pot $3.50 | Rake $0
Seat 1: V138SURkdX8LdVBPKdJJag (small blind) folded before Flop
Seat 2: OGgaARGdJQT4awWVNQ957w (big blind) folded before Flop
Seat 3: JMmUYT5pIKCKh2pGjCB/4w folded before Flop
Seat 4: bLbSOSmSOnqE0iTcH/5dxA folded before Flop (didn't bet)
Seat 5: 61sfw5QTu62YYIt68OsdrA collected ($3.50)
Seat 6: FVs16t7GgfWgQWt4JxsObQ folded before Flop (didn't bet)
Seat 7: 997ViqAtWn1FPjJqcffwcA folded before Flop (didn't bet)
Seat 8: D+W9Me7w6Hcx/WRUSKV0dw folded before Flop (didn't bet)
Seat 9: ouwUBGRKnKK9uhn1G4Lf+A (button) folded before Flop (didn't bet)



PokerStars Game #59940604750:  Hold'em No Limit ($0.50/$1.00) - 2009/07/01 1:11:21 ET
Table 'hdVBCnDy5t2X9dZo0AvD9w' 9-max Seat #7 is the button
Seat 1: sa/cZBFh73L9TapFXpn3BA ($70.85 in chips)
Seat 2: Ogn4JDV3mp4ZDKO49IFzKA ($22 in chips)
Seat 3: 1862487932 ($100 in chips)
Seat 4: YvSugbFKWSuAYx9iokQwUQ ($70 in chips)
Seat 5: H+DVy3Ei8L1UKS2tVOtJcw ($100 in chips)
Seat 6: bJckevFOcg//s0qyMQI6sQ ($100 in chips)
Seat 7: KqC3XiX79XzqwhoOYPVb4w ($163.05 in chips)
Seat 8: gUUvmqdVlmvpal6B8nYrmg ($139.90 in chips)
Seat 9: AMkLbywdoc0K30BTzaIfTQ ($187.90 in chips)
gUUvmqdVlmvpal6B8nYrmg: posts small blind $0.50
AMkLbywdoc0K30BTzaIfTQ: posts big blind $1
*** HOLE CARDS ***
sa/cZBFh73L9TapFXpn3BA: raises $1 to $2
Ogn4JDV3mp4ZDKO49IFzKA: folds
1862487932: folds
YvSugbFKWSuAYx9iokQwUQ: folds
H+DVy3Ei8L1UKS2tVOtJcw: folds
bJckevFOcg//s0qyMQI6sQ: folds
KqC3XiX79XzqwhoOYPVb4w: folds
gUUvmqdVlmvpal6B8nYrmg: folds
AMkLbywdoc0K30BTzaIfTQ: folds
sa/cZBFh73L9TapFXpn3BA collected $2.50 from pot
*** SUMMARY ***
Total pot $2.50 | Rake $0
Seat 1: sa/cZBFh73L9TapFXpn3BA collected ($2.50)
Seat 2: Ogn4JDV3mp4ZDKO49IFzKA folded before Flop (didn't bet)
Seat 3: 1862487932 folded before Flop (didn't bet)
Seat 4: YvSugbFKWSuAYx9iokQwUQ folded before Flop (didn't bet)
Seat 5: H+DVy3Ei8L1UKS2tVOtJcw folded before Flop (didn't bet)
Seat 6: bJckevFOcg//s0qyMQI6sQ folded before Flop (didn't bet)
Seat 7: KqC3XiX79XzqwhoOYPVb4w (button) folded before Flop (didn't bet)
Seat 8: gUUvmqdVlmvpal6B8nYrmg (small blind) folded before Flop
Seat 9: AMkLbywdoc0K30BTzaIfTQ (big blind) folded before Flop



PokerStars Game #59940606026:  Hold'em No Limit ($0.50/$1.00) - 2009/07/01 1:11:23 ET
Table 'tJq9SfN1ywY0r03VBlWlwQ' 9-max Seat #5 is the button
Seat 1: wZsU+w9r7G66x93UuvBf1Q ($335.30 in chips)
Seat 3: FVs16t7GgfWgQWt4JxsObQ ($14.10 in chips)
Seat 4: bLbSOSmSOnqE0iTcH/5dxA ($110.70 in chips)
Seat 5: h5ipsNTMyolp7xn/NAvWkA ($92.70 in chips)
Seat 6: gUUvmqdVlmvpal6B8nYrmg ($117.20 in chips)
Seat 8: G4DEhsZFmznGNVpy2SEocA ($29.90 in chips)
Seat 9: XE5QF1y74bpHog9JxWJMWQ ($100.50 in chips)
gUUvmqdVlmvpal6B8nYrmg: posts small blind $0.50
G4DEhsZFmznGNVpy2SEocA: posts big blind $1
*** HOLE CARDS ***
XE5QF1y74bpHog9JxWJMWQ: folds
wZsU+w9r7G66x93UuvBf1Q: folds
FVs16t7GgfWgQWt4JxsObQ: calls $1
bLbSOSmSOnqE0iTcH/5dxA: folds
h5ipsNTMyolp7xn/NAvWkA: calls $1
Pp/KTcXkfZKKUHkjyaLTdg joins the table at seat #7
gUUvmqdVlmvpal6B8nYrmg: calls $0.50
G4DEhsZFmznGNVpy2SEocA: checks
*** FLOP *** [6h Kc 9d]
gUUvmqdVlmvpal6B8nYrmg: checks
G4DEhsZFmznGNVpy2SEocA: checks
FVs16t7GgfWgQWt4JxsObQ: checks
h5ipsNTMyolp7xn/NAvWkA: bets $3
gUUvmqdVlmvpal6B8nYrmg: folds
G4DEhsZFmznGNVpy2SEocA: folds
FVs16t7GgfWgQWt4JxsObQ: folds
h5ipsNTMyolp7xn/NAvWkA collected $3.80 from pot
*** SUMMARY ***
Total pot $4 | Rake $0.20
Board [6h Kc 9d]
Seat 1: wZsU+w9r7G66x93UuvBf1Q folded before Flop (didn't bet)
Seat 3: FVs16t7GgfWgQWt4JxsObQ folded on the Flop
Seat 4: bLbSOSmSOnqE0iTcH/5dxA folded before Flop (didn't bet)
Seat 5: h5ipsNTMyolp7xn/NAvWkA (button) collected ($3.80)
Seat 6: gUUvmqdVlmvpal6B8nYrmg (small blind) folded on the Flop
Seat 8: G4DEhsZFmznGNVpy2SEocA (big blind) folded on the Flop
Seat 9: XE5QF1y74bpHog9JxWJMWQ folded before Flop (didn't bet)



PokerStars Game #59940607608:  Hold'em No Limit ($0.50/$1.00) - 2009/07/01 1:11:26 ET
Table '+cA8mcmhaedZ7YcrDdhmeQ' 6-max Seat #5 is the button
Seat 1: lsLuWlcPA3Rh7kJVLzMh0Q ($303.95 in chips)
Seat 2: RqgF7gRoKgRNW8Zoi1ty4A ($130.25 in chips)
Seat 3: DAIgyIWbYvAkL6PbAI27pg ($18.50 in chips)
Seat 4: 4OO5v3AVduL0tePNx8wk5A ($109.55 in chips)
Seat 5: +7hFKAL0b0O/n8G72TclJA ($136.10 in chips)
Seat 6: YfsTQsY/fxb+YqbdclTHuw ($16.10 in chips)
YfsTQsY/fxb+YqbdclTHuw: posts small blind $0.50
lsLuWlcPA3Rh7kJVLzMh0Q: posts big blind $1
*** HOLE CARDS ***
RqgF7gRoKgRNW8Zoi1ty4A: folds
DAIgyIWbYvAkL6PbAI27pg: folds
4OO5v3AVduL0tePNx8wk5A: folds
+7hFKAL0b0O/n8G72TclJA: raises $2 to $3
YfsTQsY/fxb+YqbdclTHuw: calls $2.50
lsLuWlcPA3Rh7kJVLzMh0Q: folds
*** FLOP *** [Ah 6s Ac]
YfsTQsY/fxb+YqbdclTHuw: checks
+7hFKAL0b0O/n8G72TclJA: checks
*** TURN *** [Ah 6s Ac] [8s]
YfsTQsY/fxb+YqbdclTHuw: checks
+7hFKAL0b0O/n8G72TclJA: bets $4
YfsTQsY/fxb+YqbdclTHuw: folds
+7hFKAL0b0O/n8G72TclJA collected $6.65 from pot
*** SUMMARY ***
Total pot $7 | Rake $0.35
Board [Ah 6s Ac 8s]
Seat 1: lsLuWlcPA3Rh7kJVLzMh0Q (big blind) folded before Flop
Seat 2: RqgF7gRoKgRNW8Zoi1ty4A folded before Flop (didn't bet)
Seat 3: DAIgyIWbYvAkL6PbAI27pg folded before Flop (didn't bet)
Seat 4: 4OO5v3AVduL0tePNx8wk5A folded before Flop (didn't bet)
Seat 5: +7hFKAL0b0O/n8G72TclJA (button) collected ($6.65)
Seat 6: YfsTQsY/fxb+YqbdclTHuw (small blind) folded on the Turn



PokerStars Game #59940607902:  Hold'em No Limit ($0.50/$1.00) - 2009/07/01 1:11:26 ET
Table 'MUPc8FEpe/nR0BKSeReX6Q' 6-max Seat #3 is the button
Seat 1: qhkK6+yCciTRd+rCFEbnEQ ($41.70 in chips)
Seat 2: xAU6q2/cwmby2sxmA8VcmA ($114.70 in chips)
Seat 3: wx3sQGkVi2x9wJXuWNHPBw ($216 in chips)
Seat 4: ZA1bp6g8IwtTxkUE4eCjDQ ($186.65 in chips)
Seat 5: UBZQqpnJZdTYYY1FTb0rLA ($100 in chips)
Seat 6: oxnw0GLLpFanjhGkxfRSqA ($55.50 in chips)
ZA1bp6g8IwtTxkUE4eCjDQ: posts small blind $0.50
UBZQqpnJZdTYYY1FTb0rLA: posts big blind $1
*** HOLE CARDS ***
oxnw0GLLpFanjhGkxfRSqA: folds
qhkK6+yCciTRd+rCFEbnEQ: folds
xAU6q2/cwmby2sxmA8VcmA: folds
wx3sQGkVi2x9wJXuWNHPBw: folds
ZA1bp6g8IwtTxkUE4eCjDQ: calls $0.50
UBZQqpnJZdTYYY1FTb0rLA: checks
*** FLOP *** [2d 7s 8s]
ZA1bp6g8IwtTxkUE4eCjDQ: bets $1
UBZQqpnJZdTYYY1FTb0rLA: raises $2 to $3
ZA1bp6g8IwtTxkUE4eCjDQ: calls $2
*** TURN *** [2d 7s 8s] [4c]
ZA1bp6g8IwtTxkUE4eCjDQ: checks
UBZQqpnJZdTYYY1FTb0rLA: bets $4
ZA1bp6g8IwtTxkUE4eCjDQ: calls $4
*** RIVER *** [2d 7s 8s 4c] [Ac]
ZA1bp6g8IwtTxkUE4eCjDQ: checks
UBZQqpnJZdTYYY1FTb0rLA: checks
*** SHOW DOWN ***
ZA1bp6g8IwtTxkUE4eCjDQ: shows [2c As] (two pair, Aces and Deuces)
UBZQqpnJZdTYYY1FTb0rLA: mucks hand
ZA1bp6g8IwtTxkUE4eCjDQ collected $15.25 from pot
*** SUMMARY ***
Total pot $16 | Rake $0.75
Board [2d 7s 8s 4c Ac]
Seat 1: qhkK6+yCciTRd+rCFEbnEQ folded before Flop (didn't bet)
Seat 2: xAU6q2/cwmby2sxmA8VcmA folded before Flop (didn't bet)
Seat 3: wx3sQGkVi2x9wJXuWNHPBw (button) folded before Flop (didn't bet)
Seat 4: ZA1bp6g8IwtTxkUE4eCjDQ (small blind) showed [2c As] and won ($15.25) with two pair, Aces and Deuces
Seat 5: UBZQqpnJZdTYYY1FTb0rLA (big blind) mucked
Seat 6: oxnw0GLLpFanjhGkxfRSqA folded before Flop (didn't bet)



PokerStars Game #59940609098:  Hold'em No Limit ($0.50/$1.00) - 2009/07/01 1:11:28 ET
Table 'pHrhryH8jPNdQfY62f8v+g' 6-max Seat #1 is the button
Seat 1: 4d1rWhpu8DzLmzMbR3QKyA ($100 in chips)
Seat 3: 8oS5O7iD/qnFXFXJrGIgNQ ($100 in chips)
Seat 4: 1f3beyIML24UqEMTbWy93g ($59.65 in chips)
Seat 5: r1/R7y0Ortgoz4lccgW8VA ($39.15 in chips)
Seat 6: xAU6q2/cwmby2sxmA8VcmA ($208.10 in chips)
8oS5O7iD/qnFXFXJrGIgNQ: posts small blind $0.50
1f3beyIML24UqEMTbWy93g: posts big blind $1
*** HOLE CARDS ***
r1/R7y0Ortgoz4lccgW8VA: calls $1
xAU6q2/cwmby2sxmA8VcmA: folds
4d1rWhpu8DzLmzMbR3QKyA: folds
8oS5O7iD/qnFXFXJrGIgNQ: folds
1f3beyIML24UqEMTbWy93g: checks
*** FLOP *** [2d 5h 9h]
1f3beyIML24UqEMTbWy93g: checks
r1/R7y0Ortgoz4lccgW8VA: checks
*** TURN *** [2d 5h 9h] [7s]
1f3beyIML24UqEMTbWy93g: checks
r1/R7y0Ortgoz4lccgW8VA: checks
*** RIVER *** [2d 5h 9h 7s] [Th]
1f3beyIML24UqEMTbWy93g: checks
r1/R7y0Ortgoz4lccgW8VA: checks
*** SHOW DOWN ***
1f3beyIML24UqEMTbWy93g: shows [5s Qc] (a pair of Fives)
r1/R7y0Ortgoz4lccgW8VA: shows [Qd Ts] (a pair of Tens)
r1/R7y0Ortgoz4lccgW8VA collected $2.40 from pot
*** SUMMARY ***
Total pot $2.50 | Rake $0.10
Board [2d 5h 9h 7s Th]
Seat 1: 4d1rWhpu8DzLmzMbR3QKyA (button) folded before Flop (didn't bet)
Seat 3: 8oS5O7iD/qnFXFXJrGIgNQ (small blind) folded before Flop
Seat 4: 1f3beyIML24UqEMTbWy93g (big blind) showed [5s Qc] and lost with a pair of Fives
Seat 5: r1/R7y0Ortgoz4lccgW8VA showed [Qd Ts] and won ($2.40) with a pair of Tens
Seat 6: xAU6q2/cwmby2sxmA8VcmA folded before Flop (didn't bet)



PokerStars Game #59940610444:  Hold'em No Limit ($0.50/$1.00) - 2009/07/01 1:11:31 ET
Table 'fTlPiCj0utgzC/5io+I7ew' 6-max Seat #4 is the button
Seat 1: YMJG+F++3Aj6P8dAWda5fw ($102.85 in chips)
Seat 3: Z2fXsGcjl+Eax+RzOgwOmg ($102.50 in chips)
Seat 4: uJVSceLggtsrJya+WtmUEA ($184.15 in chips)
Seat 5: XUk5GQsfNFpHvaToDZ0rZA ($49 in chips)
Seat 6: /P4w1pHg2zHYg/4ubJ0dPw ($69.05 in chips)
XUk5GQsfNFpHvaToDZ0rZA: posts small blind $0.50
/P4w1pHg2zHYg/4ubJ0dPw: posts big blind $1
*** HOLE CARDS ***
YMJG+F++3Aj6P8dAWda5fw: folds
Z2fXsGcjl+Eax+RzOgwOmg: folds
uJVSceLggtsrJya+WtmUEA: folds
XUk5GQsfNFpHvaToDZ0rZA: folds
/P4w1pHg2zHYg/4ubJ0dPw collected $1 from pot
*** SUMMARY ***
Total pot $1 | Rake $0
Seat 1: YMJG+F++3Aj6P8dAWda5fw folded before Flop (didn't bet)
Seat 3: Z2fXsGcjl+Eax+RzOgwOmg folded before Flop (didn't bet)
Seat 4: uJVSceLggtsrJya+WtmUEA (button) folded before Flop (didn't bet)
Seat 5: XUk5GQsfNFpHvaToDZ0rZA (small blind) folded before Flop
Seat 6: /P4w1pHg2zHYg/4ubJ0dPw (big blind) collected ($1)



PokerStars Game #59940610574:  Hold'em No Limit ($0.50/$1.00) - 2009/07/01 1:11:31 ET
Table 'cKH9c4x6u79IqCdaKKvXrw' 9-max Seat #8 is the button
Seat 1: Pp/KTcXkfZKKUHkjyaLTdg ($20 in chips)
Seat 2: 8S3JMH4TY3whgIlZmMv66w ($59.55 in chips)
Seat 3: 997ViqAtWn1FPjJqcffwcA ($155.60 in chips)
Seat 4: FL3MrLspcF23LYvC4ipBOA ($100 in chips)
Seat 5: Jjc7EHWzs4//xUAjJ0UWoA ($44.40 in chips)
Seat 6: Bsd/K5gAcLanYbGiPirRjw ($201.05 in chips)
Seat 7: 1GkkVBhlJ92guE6K5mS5Ig ($16.60 in chips)
Seat 8: myIxN7otsyr846M539YR8Q ($31.35 in chips)
Seat 9: 6XkTu4ahxzHnvjjc1R8YjQ ($40.60 in chips)
6XkTu4ahxzHnvjjc1R8YjQ: posts small blind $0.50
Pp/KTcXkfZKKUHkjyaLTdg: posts big blind $1
*** HOLE CARDS ***
8S3JMH4TY3whgIlZmMv66w: folds
997ViqAtWn1FPjJqcffwcA: folds
FL3MrLspcF23LYvC4ipBOA: folds
Jjc7EHWzs4//xUAjJ0UWoA: folds
Bsd/K5gAcLanYbGiPirRjw: folds
1GkkVBhlJ92guE6K5mS5Ig: calls $1
myIxN7otsyr846M539YR8Q: folds
6XkTu4ahxzHnvjjc1R8YjQ: folds
Pp/KTcXkfZKKUHkjyaLTdg: checks
*** FLOP *** [Ad Qd 9h]
Pp/KTcXkfZKKUHkjyaLTdg: checks
1GkkVBhlJ92guE6K5mS5Ig: bets $4
Pp/KTcXkfZKKUHkjyaLTdg: folds
1GkkVBhlJ92guE6K5mS5Ig collected $2.40 from pot
*** SUMMARY ***
Total pot $2.50 | Rake $0.10
Board [Ad Qd 9h]
Seat 1: Pp/KTcXkfZKKUHkjyaLTdg (big blind) folded on the Flop
Seat 2: 8S3JMH4TY3whgIlZmMv66w folded before Flop (didn't bet)
Seat 3: 997ViqAtWn1FPjJqcffwcA folded before Flop (didn't bet)
Seat 4: FL3MrLspcF23LYvC4ipBOA folded before Flop (didn't bet)
Seat 5: Jjc7EHWzs4//xUAjJ0UWoA folded before Flop (didn't bet)
Seat 6: Bsd/K5gAcLanYbGiPirRjw folded before Flop (didn't bet)
Seat 7: 1GkkVBhlJ92guE6K5mS5Ig collected ($2.40)
Seat 8: myIxN7otsyr846M539YR8Q (button) folded before Flop (didn't bet)
Seat 9: 6XkTu4ahxzHnvjjc1R8YjQ (small blind) folded before Flop



PokerStars Game #59940611202:  Hold'em No Limit ($0.50/$1.00) - 2009/07/01 1:11:32 ET
Table 'N2bNCDHL96aCQDvZIh+yQQ' 6-max Seat #5 is the button
Seat 2: TIB5eSBJLz62w6yz2+yeKw ($108.05 in chips)
Seat 3: Qy/UBNbD2HaA0Ogxg8Sf3w ($235.50 in chips)
Seat 4: uCqEjnxh2/vFBjKYkfTOkw ($201.50 in chips)
Seat 5: 8OEJHwpMpZZfyaTpXEDFfw ($4.45 in chips)
Seat 6: UU/mxjS3TL57GLD6iS6FPw ($18 in chips)
UU/mxjS3TL57GLD6iS6FPw: posts small blind $0.50
TIB5eSBJLz62w6yz2+yeKw: posts big blind $1
*** HOLE CARDS ***
Qy/UBNbD2HaA0Ogxg8Sf3w: folds
uCqEjnxh2/vFBjKYkfTOkw: folds
8OEJHwpMpZZfyaTpXEDFfw: folds
UU/mxjS3TL57GLD6iS6FPw: calls $0.50
TIB5eSBJLz62w6yz2+yeKw: checks
*** FLOP *** [6s Jc Ac]
UU/mxjS3TL57GLD6iS6FPw: bets $2
TIB5eSBJLz62w6yz2+yeKw: folds
UU/mxjS3TL57GLD6iS6FPw collected $1.90 from pot
*** SUMMARY ***
Total pot $2 | Rake $0.10
Board [6s Jc Ac]
Seat 2: TIB5eSBJLz62w6yz2+yeKw (big blind) folded on the Flop
Seat 3: Qy/UBNbD2HaA0Ogxg8Sf3w folded before Flop (didn't bet)
Seat 4: uCqEjnxh2/vFBjKYkfTOkw folded before Flop (didn't bet)
Seat 5: 8OEJHwpMpZZfyaTpXEDFfw (button) folded before Flop (didn't bet)
Seat 6: UU/mxjS3TL57GLD6iS6FPw (small blind) collected ($1.90)



PokerStars Game #59940613006:  Hold'em No Limit ($0.50/$1.00) - 2009/07/01 1:11:35 ET
Table 'vs/5jr6ciwjVQ5+Soc+u2A' 6-max Seat #5 is the button
Seat 1: J798qwLuvXyq0BbzsIjOrA ($100 in chips)
Seat 2: lXX4W7m3u++JiSOZ46yVMQ ($126.55 in chips)
Seat 3: G5ZSSN6RSON3gkNvk/SmYg ($125.35 in chips)
Seat 4: wk6Ohn4GDozoOMHc4eb2rw ($63.80 in chips)
Seat 5: +Nt3OPk3XR9SKjZgm2CexQ ($107.45 in chips)
Seat 6: Z2fXsGcjl+Eax+RzOgwOmg ($100 in chips)
Z2fXsGcjl+Eax+RzOgwOmg: posts small blind $0.50
J798qwLuvXyq0BbzsIjOrA: posts big blind $1
*** HOLE CARDS ***
lXX4W7m3u++JiSOZ46yVMQ: folds
G5ZSSN6RSON3gkNvk/SmYg: folds
wk6Ohn4GDozoOMHc4eb2rw: folds
+Nt3OPk3XR9SKjZgm2CexQ: raises $1.30 to $2.30
Z2fXsGcjl+Eax+RzOgwOmg: folds
J798qwLuvXyq0BbzsIjOrA: calls $1.30
*** FLOP *** [Js 2c 4c]
J798qwLuvXyq0BbzsIjOrA: checks
+Nt3OPk3XR9SKjZgm2CexQ: bets $3
J798qwLuvXyq0BbzsIjOrA: folds
+Nt3OPk3XR9SKjZgm2CexQ collected $4.85 from pot
+Nt3OPk3XR9SKjZgm2CexQ: doesn't show hand
*** SUMMARY ***
Total pot $5.10 | Rake $0.25
Board [Js 2c 4c]
Seat 1: J798qwLuvXyq0BbzsIjOrA (big blind) folded on the Flop
Seat 2: lXX4W7m3u++JiSOZ46yVMQ folded before Flop (didn't bet)
Seat 3: G5ZSSN6RSON3gkNvk/SmYg folded before Flop (didn't bet)
Seat 4: wk6Ohn4GDozoOMHc4eb2rw folded before Flop (didn't bet)
Seat 5: +Nt3OPk3XR9SKjZgm2CexQ (button) collected ($4.85)
Seat 6: Z2fXsGcjl+Eax+RzOgwOmg (small blind) folded before Flop



PokerStars Game #59940614368:  Hold'em No Limit ($0.50/$1.00) - 2009/07/01 1:11:38 ET
Table 'W/wyObTiXZm+Ckkl3YxcSw' 6-max Seat #2 is the button
Seat 1: eUBBn2R56C1IQ6Cs/vitwg ($180.25 in chips)
Seat 2: oDiBRCaF0QVtd3kO6xZIXw ($154.35 in chips)
Seat 3: dxyNCn/qxfkGDUIf28Cbng ($56.40 in chips)
Seat 4: aYii2DmxlOlbC1wbGRBWvQ ($111.40 in chips)
Seat 5: MFptnnT6AnJakWBooTkmeg ($19.65 in chips)
dxyNCn/qxfkGDUIf28Cbng: posts small blind $0.50
aYii2DmxlOlbC1wbGRBWvQ: posts big blind $1
*** HOLE CARDS ***
MFptnnT6AnJakWBooTkmeg: calls $1
eUBBn2R56C1IQ6Cs/vitwg: folds
oDiBRCaF0QVtd3kO6xZIXw: folds
dxyNCn/qxfkGDUIf28Cbng: calls $0.50
aYii2DmxlOlbC1wbGRBWvQ: checks
*** FLOP *** [9h Ts Th]
b2a+5TkFf4xJN/Ihhma58Q joins the table at seat #6
dxyNCn/qxfkGDUIf28Cbng: checks
aYii2DmxlOlbC1wbGRBWvQ: bets $3
MFptnnT6AnJakWBooTkmeg: folds
dxyNCn/qxfkGDUIf28Cbng: folds
aYii2DmxlOlbC1wbGRBWvQ collected $2.85 from pot
*** SUMMARY ***
Total pot $3 | Rake $0.15
Board [9h Ts Th]
Seat 1: eUBBn2R56C1IQ6Cs/vitwg folded before Flop (didn't bet)
Seat 2: oDiBRCaF0QVtd3kO6xZIXw (button) folded before Flop (didn't bet)
Seat 3: dxyNCn/qxfkGDUIf28Cbng (small blind) folded on the Flop
Seat 4: aYii2DmxlOlbC1wbGRBWvQ (big blind) collected ($2.85)
Seat 5: MFptnnT6AnJakWBooTkmeg folded on the Flop



PokerStars Game #59940615520:  Hold'em No Limit ($0.50/$1.00) - 2009/07/01 1:11:40 ET
Table 'O96CPOtvMBWP6kzuYDfdFA' 6-max Seat #4 is the button
Seat 1: 6alLXQIITA2EZ/lBeym8Dw ($119.55 in chips)
Seat 2: 4d1rWhpu8DzLmzMbR3QKyA ($111.35 in chips)
Seat 4: /P4w1pHg2zHYg/4ubJ0dPw ($62.05 in chips)
Seat 5: G5ZSSN6RSON3gkNvk/SmYg ($100 in chips)
Seat 6: GYei5jXGWexiJYbAT2fELg ($33.90 in chips)
G5ZSSN6RSON3gkNvk/SmYg: posts small blind $0.50
GYei5jXGWexiJYbAT2fELg: posts big blind $1
*** HOLE CARDS ***
6alLXQIITA2EZ/lBeym8Dw: folds
4d1rWhpu8DzLmzMbR3QKyA: folds
/P4w1pHg2zHYg/4ubJ0dPw: raises $2 to $3
G5ZSSN6RSON3gkNvk/SmYg: folds
GYei5jXGWexiJYbAT2fELg: folds
/P4w1pHg2zHYg/4ubJ0dPw collected $2.50 from pot
*** SUMMARY ***
Total pot $2.50 | Rake $0
Seat 1: 6alLXQIITA2EZ/lBeym8Dw folded before Flop (didn't bet)
Seat 2: 4d1rWhpu8DzLmzMbR3QKyA folded before Flop (didn't bet)
Seat 4: /P4w1pHg2zHYg/4ubJ0dPw (button) collected ($2.50)
Seat 5: G5ZSSN6RSON3gkNvk/SmYg (small blind) folded before Flop
Seat 6: GYei5jXGWexiJYbAT2fELg (big blind) folded before Flop



PokerStars Game #59940616194:  Hold'em No Limit ($0.50/$1.00) - 2009/07/01 1:11:41 ET
Table 'tyUh+jyNvrceIQdKMJjQ2wZFWj23PMihdwrNWv41OG/Qeat #3 is the button
Seat 1: o8A5MUdudVKu+pAwgZOX2w ($110.45 in chips)
Seat 2: 5uy3EN+iIYkgwbWZFTUBAQ ($105.50 in chips)
Seat 3: TalCiLYHCd+ffkmR3auPvA ($146.80 in chips)
Seat 4: hpxXcmRkXXI9HE5+5/j/0Q ($100 in chips)
Seat 5: j7NIOHLZk7V2o9fOioO5ug ($100 in chips)
Seat 6: 4OO5v3AVduL0tePNx8wk5A ($100 in chips)
hpxXcmRkXXI9HE5+5/j/0Q: posts small blind $0.50
j7NIOHLZk7V2o9fOioO5ug: posts big blind $1
*** HOLE CARDS ***
4OO5v3AVduL0tePNx8wk5A: folds
o8A5MUdudVKu+pAwgZOX2w: folds
5uy3EN+iIYkgwbWZFTUBAQ: folds
TalCiLYHCd+ffkmR3auPvA: raises $2 to $3
hpxXcmRkXXI9HE5+5/j/0Q: folds
j7NIOHLZk7V2o9fOioO5ug: calls $2
*** FLOP *** [6c Th Js]
j7NIOHLZk7V2o9fOioO5ug: checks
TalCiLYHCd+ffkmR3auPvA: checks
*** TURN *** [6c Th Js] [Kh]
j7NIOHLZk7V2o9fOioO5ug: bets $5
TalCiLYHCd+ffkmR3auPvA: calls $5
*** RIVER *** [6c Th Js Kh] [Jd]
j7NIOHLZk7V2o9fOioO5ug: bets $12
TalCiLYHCd+ffkmR3auPvA: folds
j7NIOHLZk7V2o9fOioO5ug collected $15.70 from pot
j7NIOHLZk7V2o9fOioO5ug: doesn't show hand
*** SUMMARY ***
Total pot $16.50 | Rake $0.80
Board [6c Th Js Kh Jd]
Seat 1: o8A5MUdudVKu+pAwgZOX2w folded before Flop (didn't bet)
Seat 2: 5uy3EN+iIYkgwbWZFTUBAQ folded before Flop (didn't bet)
Seat 3: TalCiLYHCd+ffkmR3auPvA (button) folded on the River
Seat 4: hpxXcmRkXXI9HE5+5/j/0Q (small blind) folded before Flop
Seat 5: j7NIOHLZk7V2o9fOioO5ug (big blind) collected ($15.70)
Seat 6: 4OO5v3AVduL0tePNx8wk5A folded before Flop (didn't bet)



PokerStars Game #59940617338:  Hold'em No Limit ($0.50/$1.00) - 2009/07/01 1:11:43 ET
Table 'GxCPo/gd3OSthkYrAxJngg' 6-max Seat #3 is the button
Seat 1: sH8BpAFP+jGFxCgVpD1Lew ($266.90 in chips)
Seat 3: o6plE+MSW4XFNTeONe16xg ($28.25 in chips)
Seat 4: YMJG+F++3Aj6P8dAWda5fw ($197.25 in chips)
Seat 5: G5ZSSN6RSON3gkNvk/SmYg ($116.10 in chips)
Seat 6: 4d1rWhpu8DzLmzMbR3QKyA ($100 in chips)
YMJG+F++3Aj6P8dAWda5fw: posts small blind $0.50
G5ZSSN6RSON3gkNvk/SmYg: posts big blind $1
*** HOLE CARDS ***
4d1rWhpu8DzLmzMbR3QKyA: folds
sH8BpAFP+jGFxCgVpD1Lew: folds
o6plE+MSW4XFNTeONe16xg: calls $1
YMJG+F++3Aj6P8dAWda5fw: folds
G5ZSSN6RSON3gkNvk/SmYg: checks
*** FLOP *** [Th As Qh]
G5ZSSN6RSON3gkNvk/SmYg: checks
o6plE+MSW4XFNTeONe16xg: bets $1
G5ZSSN6RSON3gkNvk/SmYg: folds
o6plE+MSW4XFNTeONe16xg collected $2.40 from pot
*** SUMMARY ***
Total pot $2.50 | Rake $0.10
Board [Th As Qh]
Seat 1: sH8BpAFP+jGFxCgVpD1Lew folded before Flop (didn't bet)
Seat 3: o6plE+MSW4XFNTeONe16xg (button) collected ($2.40)
Seat 4: YMJG+F++3Aj6P8dAWda5fw (small blind) folded before Flop
Seat 5: G5ZSSN6RSON3gkNvk/SmYg (big blind) folded on the Flop
Seat 6: 4d1rWhpu8DzLmzMbR3QKyA folded before Flop (didn't bet)



PokerStars Game #59940618246:  Hold'em No Limit ($0.50/$1.00) - 2009/07/01 1:11:44 ET
Table 'QSIig7BLMc9wY/rgBechzw' 6-max Seat #6 is the button
Seat 1: Z2fXsGcjl+Eax+RzOgwOmg ($114 in chips)
Seat 2: mLOIkH/qmRa+mVujQIhBRg ($38.60 in chips)
Seat 3: +xW7QemQU0Fxs+4TnqBRow ($100 in chips)
Seat 4: +uSzP8Jwnw7sKfQ4s66b7w ($78.45 in chips)
Seat 5: lsLuWlcPA3Rh7kJVLzMh0Q ($102.35 in chips)
Seat 6: PxqfkAMdAWtkgbT+q2gciA ($39 in chips)
Z2fXsGcjl+Eax+RzOgwOmg: posts small blind $0.50
mLOIkH/qmRa+mVujQIhBRg: posts big blind $1
*** HOLE CARDS ***
+xW7QemQU0Fxs+4TnqBRow: folds
+uSzP8Jwnw7sKfQ4s66b7w: folds
lsLuWlcPA3Rh7kJVLzMh0Q: folds
PxqfkAMdAWtkgbT+q2gciA: raises $2 to $3
Z2fXsGcjl+Eax+RzOgwOmg: folds
mLOIkH/qmRa+mVujQIhBRg: calls $2
*** FLOP *** [Qs 4d Ts]
mLOIkH/qmRa+mVujQIhBRg: checks
PxqfkAMdAWtkgbT+q2gciA: bets $2
mLOIkH/qmRa+mVujQIhBRg: calls $2
*** TURN *** [Qs 4d Ts] [8h]
mLOIkH/qmRa+mVujQIhBRg: checks
PxqfkAMdAWtkgbT+q2gciA: bets $3
mLOIkH/qmRa+mVujQIhBRg: calls $3
*** RIVER *** [Qs 4d Ts 8h] [3d]
mLOIkH/qmRa+mVujQIhBRg: checks
PxqfkAMdAWtkgbT+q2gciA: checks
*** SHOW DOWN ***
mLOIkH/qmRa+mVujQIhBRg: shows [Th 6h] (a pair of Tens)
PxqfkAMdAWtkgbT+q2gciA: mucks hand
mLOIkH/qmRa+mVujQIhBRg collected $15.70 from pot
*** SUMMARY ***
Total pot $16.50 | Rake $0.80
Board [Qs 4d Ts 8h 3d]
Seat 1: Z2fXsGcjl+Eax+RzOgwOmg (small blind) folded before Flop
Seat 2: mLOIkH/qmRa+mVujQIhBRg (big blind) showed [Th 6h] and won ($15.70) with a pair of Tens
Seat 3: +xW7QemQU0Fxs+4TnqBRow folded before Flop (didn't bet)
Seat 4: +uSzP8Jwnw7sKfQ4s66b7w folded before Flop (didn't bet)
Seat 5: lsLuWlcPA3Rh7kJVLzMh0Q folded before Flop (didn't bet)
Seat 6: PxqfkAMdAWtkgbT+q2gciA (button) mucked



PokerStars Game #59940622726:  Hold'em No Limit ($0.50/$1.00) - 2009/07/01 1:11:52 ET
Table '6YvsYDPNIDx2v5z3bJnwZQ' 9-max Seat #7 is the button
Seat 1: Ogn4JDV3mp4ZDKO49IFzKA ($21.20 in chips)
Seat 2: +hHqYgKILitkxIzFNGvvsA ($28.75 in chips)
Seat 4: kEr5NYB+JIG5+szcYMr6hA ($43.80 in chips)
Seat 5: mBRWbnUl8diyBO1qTJaNzw ($160.70 in chips)
Seat 6: 7RSwrjMohkYrZAhOd1uaZg ($14.90 in chips)
Seat 7: mae7OMTaJ/MFimNbZegCkg ($45.80 in chips)
Seat 8: PSFxpXgPedVZyHSu2Zhb7Q ($123.45 in chips)
Seat 9: yZYrOeNDxQxkzpbgKX1bng ($28 in chips)
PSFxpXgPedVZyHSu2Zhb7Q: posts small blind $0.50
yZYrOeNDxQxkzpbgKX1bng: posts big blind $1
K6OJDis3KfxSm/PKlkATUA: sits out
*** HOLE CARDS ***
Ogn4JDV3mp4ZDKO49IFzKA: folds
+hHqYgKILitkxIzFNGvvsA: calls $1
kEr5NYB+JIG5+szcYMr6hA: calls $1
mBRWbnUl8diyBO1qTJaNzw: folds
7RSwrjMohkYrZAhOd1uaZg: calls $1
mae7OMTaJ/MFimNbZegCkg: folds
PSFxpXgPedVZyHSu2Zhb7Q: calls $0.50
yZYrOeNDxQxkzpbgKX1bng: checks
*** FLOP *** [9c Qs 9d]
PSFxpXgPedVZyHSu2Zhb7Q: checks
yZYrOeNDxQxkzpbgKX1bng: checks
+hHqYgKILitkxIzFNGvvsA: checks
kEr5NYB+JIG5+szcYMr6hA: checks
7RSwrjMohkYrZAhOd1uaZg: checks
*** TURN *** [9c Qs 9d] [2d]
PSFxpXgPedVZyHSu2Zhb7Q: bets $2
yZYrOeNDxQxkzpbgKX1bng: folds
+hHqYgKILitkxIzFNGvvsA: folds
kEr5NYB+JIG5+szcYMr6hA: folds
7RSwrjMohkYrZAhOd1uaZg: calls $2
*** RIVER *** [9c Qs 9d 2d] [3c]
PSFxpXgPedVZyHSu2Zhb7Q: checks
7RSwrjMohkYrZAhOd1uaZg: checks
*** SHOW DOWN ***
PSFxpXgPedVZyHSu2Zhb7Q: shows [6s 2s] (two pair, Nines and Deuces)
7RSwrjMohkYrZAhOd1uaZg: mucks hand
PSFxpXgPedVZyHSu2Zhb7Q collected $8.60 from pot
*** SUMMARY ***
Total pot $9 | Rake $0.40
Board [9c Qs 9d 2d 3c]
Seat 1: Ogn4JDV3mp4ZDKO49IFzKA folded before Flop (didn't bet)
Seat 2: +hHqYgKILitkxIzFNGvvsA folded on the Turn
Seat 4: kEr5NYB+JIG5+szcYMr6hA folded on the Turn
Seat 5: mBRWbnUl8diyBO1qTJaNzw folded before Flop (didn't bet)
Seat 6: 7RSwrjMohkYrZAhOd1uaZg mucked
Seat 7: mae7OMTaJ/MFimNbZegCkg (button) folded before Flop (didn't bet)
Seat 8: PSFxpXgPedVZyHSu2Zhb7Q (small blind) showed [6s 2s] and won ($8.60) with two pair, Nines and Deuces
Seat 9: yZYrOeNDxQxkzpbgKX1bng (big blind) folded on the Turn



PokerStars Game #59940623096:  Hold'em No Limit ($0.50/$1.00) - 2009/07/01 1:11:53 ET
Table '3T4owEKJKyGTMePwrv50FQ' 9-max Seat #8 is the button
Seat 1: OGgaARGdJQT4awWVNQ957w ($101.10 in chips)
Seat 2: t+Id2O6herCLgwnC4m49PA ($41.80 in chips)
Seat 3: DOLzOcBTZYcph5jEfKFWuQ ($105.50 in chips)
Seat 4: O5Go3jrzbQWxRB6ESK+Ptg ($30.10 in chips)
Seat 5: eI48VADSCFoNZBx4T9qs2w ($31.85 in chips)
Seat 6: laA8va+Yv8WuMqT1zdR91g ($100 in chips)
Seat 7: 1862487932 ($104.50 in chips)
Seat 8: ucTB8uAUcQnKGsA70OSjNA ($18.50 in chips)
Seat 9: 61sfw5QTu62YYIt68OsdrA ($63.95 in chips)
61sfw5QTu62YYIt68OsdrA: posts small blind $0.50
OGgaARGdJQT4awWVNQ957w: posts big blind $1
*** HOLE CARDS ***
t+Id2O6herCLgwnC4m49PA: folds
DOLzOcBTZYcph5jEfKFWuQ: folds
O5Go3jrzbQWxRB6ESK+Ptg: folds
eI48VADSCFoNZBx4T9qs2w: folds
laA8va+Yv8WuMqT1zdR91g: raises $2 to $3
1862487932: folds
ucTB8uAUcQnKGsA70OSjNA: folds
61sfw5QTu62YYIt68OsdrA: folds
OGgaARGdJQT4awWVNQ957w: folds
laA8va+Yv8WuMqT1zdR91g collected $2.50 from pot
laA8va+Yv8WuMqT1zdR91g: doesn't show hand
*** SUMMARY ***
Total pot $2.50 | Rake $0
Seat 1: OGgaARGdJQT4awWVNQ957w (big blind) folded before Flop
Seat 2: t+Id2O6herCLgwnC4m49PA folded before Flop (didn't bet)
Seat 3: DOLzOcBTZYcph5jEfKFWuQ folded before Flop (didn't bet)
Seat 4: O5Go3jrzbQWxRB6ESK+Ptg folded before Flop (didn't bet)
Seat 5: eI48VADSCFoNZBx4T9qs2w folded before Flop (didn't bet)
Seat 6: laA8va+Yv8WuMqT1zdR91g collected ($2.50)
Seat 7: 1862487932 folded before Flop (didn't bet)
Seat 8: ucTB8uAUcQnKGsA70OSjNA (button) folded before Flop (didn't bet)
Seat 9: 61sfw5QTu62YYIt68OsdrA (small blind) folded before Flop



PokerStars Game #59940625498:  Hold'em No Limit ($0.50/$1.00) - 2009/07/01 1:11:57 ET
Table 'N2bNCDHL96aCQDvZIh+yQQ' 6-max Seat #6 is the button
Seat 2: TIB5eSBJLz62w6yz2+yeKw ($107.05 in chips)
Seat 4: uCqEjnxh2/vFBjKYkfTOkw ($201.50 in chips)
Seat 5: 8OEJHwpMpZZfyaTpXEDFfw ($4.45 in chips)
Seat 6: UU/mxjS3TL57GLD6iS6FPw ($18.90 in chips)
TIB5eSBJLz62w6yz2+yeKw: posts small blind $0.50
Qy/UBNbD2HaA0Ogxg8Sf3w: is sitting out
uCqEjnxh2/vFBjKYkfTOkw: posts big blind $1
*** HOLE CARDS ***
8OEJHwpMpZZfyaTpXEDFfw: folds
UU/mxjS3TL57GLD6iS6FPw: folds
TIB5eSBJLz62w6yz2+yeKw: calls $0.50
uCqEjnxh2/vFBjKYkfTOkw: raises $3 to $4
TIB5eSBJLz62w6yz2+yeKw: calls $3
*** FLOP *** [Kh 3s 6s]
TIB5eSBJLz62w6yz2+yeKw: checks
uCqEjnxh2/vFBjKYkfTOkw: bets $5
TIB5eSBJLz62w6yz2+yeKw: folds
TIB5eSBJLz62w6yz2+yeKw is sitting out
TIB5eSBJLz62w6yz2+yeKw leaves the table
uCqEjnxh2/vFBjKYkfTOkw collected $7.60 from pot
uCqEjnxh2/vFBjKYkfTOkw: doesn't show hand
*** SUMMARY ***
Total pot $8 | Rake $0.40
Board [Kh 3s 6s]
Seat 2: TIB5eSBJLz62w6yz2+yeKw (small blind) folded on the Flop
Seat 4: uCqEjnxh2/vFBjKYkfTOkw (big blind) collected ($7.60)
Seat 5: 8OEJHwpMpZZfyaTpXEDFfw folded before Flop (didn't bet)
Seat 6: UU/mxjS3TL57GLD6iS6FPw (button) folded before Flop (didn't bet)



PokerStars Game #59940625752:  Hold'em No Limit ($0.50/$1.00) - 2009/07/01 1:11:57 ET
Table 'kS0cTQAEi+fdUlJP2gQYvw' 9-max Seat #5 is the button
Seat 1: c/9X4zftzphFxYtxp5kp9w ($64.35 in chips)
Seat 2: D+W9Me7w6Hcx/WRUSKV0dw ($20.90 in chips)
Seat 3: 2BV+oJIQYr65IO6nEChvbA ($60 in chips)
Seat 5: 997ViqAtWn1FPjJqcffwcA ($101.15 in chips)
Seat 6: yAbu2QsRPVcjPbqlf/jDxw ($126.65 in chips)
Seat 7: Ffa7Nj4X5fddtROP01hfQg ($157.40 in chips)
Seat 9: OGgaARGdJQT4awWVNQ957w ($101.50 in chips)
yAbu2QsRPVcjPbqlf/jDxw: posts small blind $0.50
Ffa7Nj4X5fddtROP01hfQg: posts big blind $1
*** HOLE CARDS ***
OGgaARGdJQT4awWVNQ957w: folds
c/9X4zftzphFxYtxp5kp9w: folds
D+W9Me7w6Hcx/WRUSKV0dw: raises $1.45 to $2.45
2BV+oJIQYr65IO6nEChvbA: folds
997ViqAtWn1FPjJqcffwcA: folds
yAbu2QsRPVcjPbqlf/jDxw: folds
RUhhaALzha3TH1AkdakoGQ joins the table at seat #4
Ffa7Nj4X5fddtROP01hfQg: folds
D+W9Me7w6Hcx/WRUSKV0dw collected $2.50 from pot
D+W9Me7w6Hcx/WRUSKV0dw: doesn't show hand
*** SUMMARY ***
Total pot $2.50 | Rake $0
Seat 1: c/9X4zftzphFxYtxp5kp9w folded before Flop (didn't bet)
Seat 2: D+W9Me7w6Hcx/WRUSKV0dw collected ($2.50)
Seat 3: 2BV+oJIQYr65IO6nEChvbA folded before Flop (didn't bet)
Seat 5: 997ViqAtWn1FPjJqcffwcA (button) folded before Flop (didn't bet)
Seat 6: yAbu2QsRPVcjPbqlf/jDxw (small blind) folded before Flop
Seat 7: Ffa7Nj4X5fddtROP01hfQg (big blind) folded before Flop
Seat 9: OGgaARGdJQT4awWVNQ957w folded before Flop (didn't bet)



PokerStars Game #59940625886:  Hold'em No Limit ($0.50/$1.00) - 2009/07/01 1:11:57 ET
Table 'fTlPiCj0utgzC/5io+I7ew' 6-max Seat #5 is the button
Seat 1: YMJG+F++3Aj6P8dAWda5fw ($102.85 in chips)
Seat 3: Z2fXsGcjl+Eax+RzOgwOmg ($102.50 in chips)
Seat 4: uJVSceLggtsrJya+WtmUEA ($184.15 in chips)
Seat 5: XUk5GQsfNFpHvaToDZ0rZA ($48.50 in chips)
Seat 6: /P4w1pHg2zHYg/4ubJ0dPw ($69.55 in chips)
/P4w1pHg2zHYg/4ubJ0dPw: posts small blind $0.50
YMJG+F++3Aj6P8dAWda5fw: posts big blind $1
*** HOLE CARDS ***
Z2fXsGcjl+Eax+RzOgwOmg: folds
uJVSceLggtsrJya+WtmUEA: raises $2 to $3
XUk5GQsfNFpHvaToDZ0rZA: folds
/P4w1pHg2zHYg/4ubJ0dPw: raises $6 to $9
YMJG+F++3Aj6P8dAWda5fw: folds
uJVSceLggtsrJya+WtmUEA: calls $6
*** FLOP *** [4s 8c Kd]
/P4w1pHg2zHYg/4ubJ0dPw: bets $12.50
uJVSceLggtsrJya+WtmUEA: folds
/P4w1pHg2zHYg/4ubJ0dPw collected $18.05 from pot
*** SUMMARY ***
Total pot $19 | Rake $0.95
Board [4s 8c Kd]
Seat 1: YMJG+F++3Aj6P8dAWda5fw (big blind) folded before Flop
Seat 3: Z2fXsGcjl+Eax+RzOgwOmg folded before Flop (didn't bet)
Seat 4: uJVSceLggtsrJya+WtmUEA folded on the Flop
Seat 5: XUk5GQsfNFpHvaToDZ0rZA (button) folded before Flop (didn't bet)
Seat 6: /P4w1pHg2zHYg/4ubJ0dPw (small blind) collected ($18.05)



PokerStars Game #59940627190:  Hold'em No Limit ($0.50/$1.00) - 2009/07/01 1:12:00 ET
Table 'pHrhryH8jPNdQfY62f8v+g' 6-max Seat #3 is the button
Seat 1: 4d1rWhpu8DzLmzMbR3QKyA ($100 in chips)
Seat 3: 8oS5O7iD/qnFXFXJrGIgNQ ($100 in chips)
Seat 4: 1f3beyIML24UqEMTbWy93g ($58.65 in chips)
Seat 5: r1/R7y0Ortgoz4lccgW8VA ($40.55 in chips)
Seat 6: xAU6q2/cwmby2sxmA8VcmA ($208.10 in chips)
1f3beyIML24UqEMTbWy93g: posts small blind $0.50
r1/R7y0Ortgoz4lccgW8VA: posts big blind $1
*** HOLE CARDS ***
xAU6q2/cwmby2sxmA8VcmA: folds
4d1rWhpu8DzLmzMbR3QKyA: folds
8oS5O7iD/qnFXFXJrGIgNQ: folds
1f3beyIML24UqEMTbWy93g: folds
r1/R7y0Ortgoz4lccgW8VA collected $1 from pot
r1/R7y0Ortgoz4lccgW8VA: doesn't show hand
*** SUMMARY ***
Total pot $1 | Rake $0
Seat 1: 4d1rWhpu8DzLmzMbR3QKyA folded before Flop (didn't bet)
Seat 3: 8oS5O7iD/qnFXFXJrGIgNQ (button) folded before Flop (didn't bet)
Seat 4: 1f3beyIML24UqEMTbWy93g (small blind) folded before Flop
Seat 5: r1/R7y0Ortgoz4lccgW8VA (big blind) collected ($1)
Seat 6: xAU6q2/cwmby2sxmA8VcmA folded before Flop (didn't bet)



PokerStars Game #59940627430:  Hold'em No Limit ($0.50/$1.00) - 2009/07/01 1:12:00 ET
Table 'mmbQQVBTrPdE+wy+s+9VPA' 6-max Seat #1 is the button
Seat 1: zyP4SPoWZnKUfTvIRLCVog ($65.55 in chips)
Seat 2: XK4Qsl+DA8gAJyg85/zBIw ($24.55 in chips)
Seat 3: wx3sQGkVi2x9wJXuWNHPBw ($111.15 in chips)
Seat 4: V3iZdcw61nXF3g5hD2RrsQ ($112.40 in chips)
Seat 5: YMJG+F++3Aj6P8dAWda5fw ($103.60 in chips)
Seat 6: U2CWBTv29qdCbj8RNF2sIw ($106.95 in chips)
XK4Qsl+DA8gAJyg85/zBIw: posts small blind $0.50
wx3sQGkVi2x9wJXuWNHPBw: posts big blind $1
*** HOLE CARDS ***
V3iZdcw61nXF3g5hD2RrsQ: folds
YMJG+F++3Aj6P8dAWda5fw: folds
U2CWBTv29qdCbj8RNF2sIw: raises $2 to $3
zyP4SPoWZnKUfTvIRLCVog: calls $3
XK4Qsl+DA8gAJyg85/zBIw: folds
wx3sQGkVi2x9wJXuWNHPBw: folds
*** FLOP *** [3c Kh Jh]
U2CWBTv29qdCbj8RNF2sIw: bets $4
zyP4SPoWZnKUfTvIRLCVog: folds
U2CWBTv29qdCbj8RNF2sIw collected $7.15 from pot
*** SUMMARY ***
Total pot $7.50 | Rake $0.35
Board [3c Kh Jh]
Seat 1: zyP4SPoWZnKUfTvIRLCVog (button) folded on the Flop
Seat 2: XK4Qsl+DA8gAJyg85/zBIw (small blind) folded before Flop
Seat 3: wx3sQGkVi2x9wJXuWNHPBw (big blind) folded before Flop
Seat 4: V3iZdcw61nXF3g5hD2RrsQ folded before Flop (didn't bet)
Seat 5: YMJG+F++3Aj6P8dAWda5fw folded before Flop (didn't bet)
Seat 6: U2CWBTv29qdCbj8RNF2sIw collected ($7.15)



PokerStars Game #59940627866:  Hold'em No Limit ($0.50/$1.00) - 2009/07/01 1:12:01 ET
Table 'hdVBCnDy5t2X9dZo0AvD9w' 9-max Seat #8 is the button
Seat 1: sa/cZBFh73L9TapFXpn3BA ($72.35 in chips)
Seat 2: Ogn4JDV3mp4ZDKO49IFzKA ($22 in chips)
Seat 3: 1862487932 ($100 in chips)
Seat 4: YvSugbFKWSuAYx9iokQwUQ ($70 in chips)
Seat 5: H+DVy3Ei8L1UKS2tVOtJcw ($100 in chips)
Seat 6: bJckevFOcg//s0qyMQI6sQ ($100 in chips)
Seat 7: KqC3XiX79XzqwhoOYPVb4w ($163.05 in chips)
Seat 8: gUUvmqdVlmvpal6B8nYrmg ($139.40 in chips)
Seat 9: AMkLbywdoc0K30BTzaIfTQ ($186.90 in chips)
AMkLbywdoc0K30BTzaIfTQ: posts small blind $0.50
sa/cZBFh73L9TapFXpn3BA: posts big blind $1
*** HOLE CARDS ***
Ogn4JDV3mp4ZDKO49IFzKA: folds
1862487932: folds
YvSugbFKWSuAYx9iokQwUQ: raises $2 to $3
H+DVy3Ei8L1UKS2tVOtJcw: folds
bJckevFOcg//s0qyMQI6sQ: folds
KqC3XiX79XzqwhoOYPVb4w: folds
gUUvmqdVlmvpal6B8nYrmg: folds
AMkLbywdoc0K30BTzaIfTQ: folds
sa/cZBFh73L9TapFXpn3BA: calls $2
*** FLOP *** [Qd 8s Jh]
sa/cZBFh73L9TapFXpn3BA: checks
YvSugbFKWSuAYx9iokQwUQ: bets $4
sa/cZBFh73L9TapFXpn3BA: folds
YvSugbFKWSuAYx9iokQwUQ collected $6.20 from pot
*** SUMMARY ***
Total pot $6.50 | Rake $0.30
Board [Qd 8s Jh]
Seat 1: sa/cZBFh73L9TapFXpn3BA (big blind) folded on the Flop
Seat 2: Ogn4JDV3mp4ZDKO49IFzKA folded before Flop (didn't bet)
Seat 3: 1862487932 folded before Flop (didn't bet)
Seat 4: YvSugbFKWSuAYx9iokQwUQ collected ($6.20)
Seat 5: H+DVy3Ei8L1UKS2tVOtJcw folded before Flop (didn't bet)
Seat 6: bJckevFOcg//s0qyMQI6sQ folded before Flop (didn't bet)
Seat 7: KqC3XiX79XzqwhoOYPVb4w folded before Flop (didn't bet)
Seat 8: gUUvmqdVlmvpal6B8nYrmg (button) folded before Flop (didn't bet)
Seat 9: AMkLbywdoc0K30BTzaIfTQ (small blind) folded before Flop



PokerStars Game #59940630424:  Hold'em No Limit ($0.50/$1.00) - 2009/07/01 1:12:05 ET
Table 'hugOjcwJvzEwZbK7tyiWuQ' 9-max Seat #4 is the button
Seat 1: S3Ex8K7v6xm5jqjRM7Fl3w ($22 in chips)
Seat 2: r27C1nIV4NS4+qbnrgBQSw ($281.70 in chips)
Seat 4: UWB3oeddt/GObx2Mix2Anw ($160 in chips)
Seat 5: 5BRGWf+R3nt2WS3b5xX+zA ($26.85 in chips)
Seat 6: gUUvmqdVlmvpal6B8nYrmg ($103.90 in chips)
Seat 7: FL3MrLspcF23LYvC4ipBOA ($110.30 in chips)
Seat 8: /zy+DB4S5fUQUSfZWFzYGw ($111.05 in chips)
Seat 9: W8P9bUKCs43TO1xHm0dL6w ($89.45 in chips)
5BRGWf+R3nt2WS3b5xX+zA: posts small blind $0.50
gUUvmqdVlmvpal6B8nYrmg: posts big blind $1
*** HOLE CARDS ***
FL3MrLspcF23LYvC4ipBOA: folds
/zy+DB4S5fUQUSfZWFzYGw: folds
W8P9bUKCs43TO1xHm0dL6w: folds
S3Ex8K7v6xm5jqjRM7Fl3w: folds
r27C1nIV4NS4+qbnrgBQSw: folds
UWB3oeddt/GObx2Mix2Anw: raises $3 to $4
5BRGWf+R3nt2WS3b5xX+zA: folds
gUUvmqdVlmvpal6B8nYrmg: calls $3
*** FLOP *** [Qh Qc 6c]
gUUvmqdVlmvpal6B8nYrmg: checks
UWB3oeddt/GObx2Mix2Anw: bets $4
gUUvmqdVlmvpal6B8nYrmg: raises $4 to $8
UWB3oeddt/GObx2Mix2Anw: calls $4
*** TURN *** [Qh Qc 6c] [4c]
gUUvmqdVlmvpal6B8nYrmg: checks
UWB3oeddt/GObx2Mix2Anw: checks
*** RIVER *** [Qh Qc 6c 4c] [6d]
gUUvmqdVlmvpal6B8nYrmg: checks
UWB3oeddt/GObx2Mix2Anw: bets $13
gUUvmqdVlmvpal6B8nYrmg: folds
UWB3oeddt/GObx2Mix2Anw collected $23.30 from pot
*** SUMMARY ***
Total pot $24.50 | Rake $1.20
Board [Qh Qc 6c 4c 6d]
Seat 1: S3Ex8K7v6xm5jqjRM7Fl3w folded before Flop (didn't bet)
Seat 2: r27C1nIV4NS4+qbnrgBQSw folded before Flop (didn't bet)
Seat 4: UWB3oeddt/GObx2Mix2Anw (button) collected ($23.30)
Seat 5: 5BRGWf+R3nt2WS3b5xX+zA (small blind) folded before Flop
Seat 6: gUUvmqdVlmvpal6B8nYrmg (big blind) folded on the River
Seat 7: FL3MrLspcF23LYvC4ipBOA folded before Flop (didn't bet)
Seat 8: /zy+DB4S5fUQUSfZWFzYGw folded before Flop (didn't bet)
Seat 9: W8P9bUKCs43TO1xHm0dL6w folded before Flop (didn't bet)



PokerStars Game #59940631118:  Hold'em No Limit ($0.50/$1.00) - 2009/07/01 1:12:06 ET
Table 'cBDNutyLBKEk9+ptwsKmTw' 6-max Seat #6 is the button
Seat 1: xAU6q2/cwmby2sxmA8VcmA ($138.05 in chips)
Seat 2: 5lY8d6Cnm4HUkt/8FZSj4g ($8.70 in chips)
Seat 3: G5ZSSN6RSON3gkNvk/SmYg ($100 in chips)
Seat 4: 3q7F5QtzC30pSrn0nl9i+A ($42.60 in chips)
Seat 6: NqVlOSH2lp+pp/TK3vvK5g ($73.15 in chips)
xAU6q2/cwmby2sxmA8VcmA: posts small blind $0.50
5lY8d6Cnm4HUkt/8FZSj4g: posts big blind $1
hpxXcmRkXXI9HE5+5/j/0Q: sits out
*** HOLE CARDS ***
G5ZSSN6RSON3gkNvk/SmYg: folds
3q7F5QtzC30pSrn0nl9i+A: calls $1
NqVlOSH2lp+pp/TK3vvK5g: calls $1
xAU6q2/cwmby2sxmA8VcmA: folds
5lY8d6Cnm4HUkt/8FZSj4g: raises $7.70 to $8.70 and is all-in
3q7F5QtzC30pSrn0nl9i+A: folds
NqVlOSH2lp+pp/TK3vvK5g: calls $7.70
*** FLOP *** [3c 7d 3h]
*** TURN *** [3c 7d 3h] [7s]
*** RIVER *** [3c 7d 3h 7s] [Td]
*** SHOW DOWN ***
5lY8d6Cnm4HUkt/8FZSj4g: shows [Js Kh] (two pair, Sevens and Threes)
NqVlOSH2lp+pp/TK3vvK5g: shows [As Ks] (two pair, Sevens and Threes - Ace kicker)
NqVlOSH2lp+pp/TK3vvK5g collected $18 from pot
*** SUMMARY ***
Total pot $18.90 | Rake $0.90
Board [3c 7d 3h 7s Td]
Seat 1: xAU6q2/cwmby2sxmA8VcmA (small blind) folded before Flop
Seat 2: 5lY8d6Cnm4HUkt/8FZSj4g (big blind) showed [Js Kh] and lost with two pair, Sevens and Threes
Seat 3: G5ZSSN6RSON3gkNvk/SmYg folded before Flop (didn't bet)
Seat 4: 3q7F5QtzC30pSrn0nl9i+A folded before Flop
Seat 6: NqVlOSH2lp+pp/TK3vvK5g (button) showed [As Ks] and won ($18) with two pair, Sevens and Threes



PokerStars Game #59940631702:  Hold'em No Limit ($0.50/$1.00) - 2009/07/01 1:12:07 ET
Table 'fZjVbKj9D8yOB+Rj7NaP/A' 9-max Seat #3 is the button
Seat 1: Oh57946S8OPACStkrhQm7g ($125 in chips)
Seat 2: PTAFYDIUSsG+SArbxNl+Aw ($107 in chips)
Seat 3: yAbu2QsRPVcjPbqlf/jDxw ($102.50 in chips)
Seat 4: 997ViqAtWn1FPjJqcffwcA ($103.50 in chips)
Seat 5: PkGfq5xrSlNsujKaG/HF4Q ($100 in chips)
Seat 6: OvwYHV65yUbgdBjSmo1+5g ($41.40 in chips)
Seat 7: SyS20PAm3RpT6uLBsGkwOA ($113.25 in chips)
Seat 9: qheQay5YvP2DMAb3OUSxtw ($99 in chips)
997ViqAtWn1FPjJqcffwcA: posts small blind $0.50
PkGfq5xrSlNsujKaG/HF4Q: posts big blind $1
zDOE5r14tWqCf6xhuSHK6g: sits out
*** HOLE CARDS ***
OvwYHV65yUbgdBjSmo1+5g: folds
SyS20PAm3RpT6uLBsGkwOA: raises $4 to $5
qheQay5YvP2DMAb3OUSxtw: folds
Oh57946S8OPACStkrhQm7g: folds
PTAFYDIUSsG+SArbxNl+Aw: folds
yAbu2QsRPVcjPbqlf/jDxw: folds
997ViqAtWn1FPjJqcffwcA: folds
PkGfq5xrSlNsujKaG/HF4Q: folds
SyS20PAm3RpT6uLBsGkwOA collected $2.50 from pot
*** SUMMARY ***
Total pot $2.50 | Rake $0
Seat 1: Oh57946S8OPACStkrhQm7g folded before Flop (didn't bet)
Seat 2: PTAFYDIUSsG+SArbxNl+Aw folded before Flop (didn't bet)
Seat 3: yAbu2QsRPVcjPbqlf/jDxw (button) folded before Flop (didn't bet)
Seat 4: 997ViqAtWn1FPjJqcffwcA (small blind) folded before Flop
Seat 5: PkGfq5xrSlNsujKaG/HF4Q (big blind) folded before Flop
Seat 6: OvwYHV65yUbgdBjSmo1+5g folded before Flop (didn't bet)
Seat 7: SyS20PAm3RpT6uLBsGkwOA collected ($2.50)
Seat 9: qheQay5YvP2DMAb3OUSxtw folded before Flop (didn't bet)



PokerStars Game #59940631484:  Hold'em No Limit ($0.50/$1.00) - 2009/07/01 1:12:07 ET
Table '7Nl0ffnjeK44/vmeexh3MQ' 9-max Seat #1 is the button
Seat 1: V138SURkdX8LdVBPKdJJag ($100 in chips)
Seat 2: OGgaARGdJQT4awWVNQ957w ($100 in chips)
Seat 3: JMmUYT5pIKCKh2pGjCB/4w ($41.95 in chips)
Seat 4: bLbSOSmSOnqE0iTcH/5dxA ($104.15 in chips)
Seat 5: 61sfw5QTu62YYIt68OsdrA ($81.50 in chips)
Seat 6: FVs16t7GgfWgQWt4JxsObQ ($31.35 in chips)
Seat 7: 997ViqAtWn1FPjJqcffwcA ($100 in chips)
Seat 8: D+W9Me7w6Hcx/WRUSKV0dw ($18.25 in chips)
Seat 9: ouwUBGRKnKK9uhn1G4Lf+A ($194 in chips)
OGgaARGdJQT4awWVNQ957w: posts small blind $0.50
JMmUYT5pIKCKh2pGjCB/4w: posts big blind $1
*** HOLE CARDS ***
bLbSOSmSOnqE0iTcH/5dxA: folds
61sfw5QTu62YYIt68OsdrA: folds
FVs16t7GgfWgQWt4JxsObQ: folds
997ViqAtWn1FPjJqcffwcA: calls $1
D+W9Me7w6Hcx/WRUSKV0dw: folds
ouwUBGRKnKK9uhn1G4Lf+A: folds
V138SURkdX8LdVBPKdJJag: folds
OGgaARGdJQT4awWVNQ957w: raises $4 to $5
JMmUYT5pIKCKh2pGjCB/4w: folds
997ViqAtWn1FPjJqcffwcA: folds
OGgaARGdJQT4awWVNQ957w collected $3 from pot
OGgaARGdJQT4awWVNQ957w: doesn't show hand
*** SUMMARY ***
Total pot $3 | Rake $0
Seat 1: V138SURkdX8LdVBPKdJJag (button) folded before Flop (didn't bet)
Seat 2: OGgaARGdJQT4awWVNQ957w (small blind) collected ($3)
Seat 3: JMmUYT5pIKCKh2pGjCB/4w (big blind) folded before Flop
Seat 4: bLbSOSmSOnqE0iTcH/5dxA folded before Flop (didn't bet)
Seat 5: 61sfw5QTu62YYIt68OsdrA folded before Flop (didn't bet)
Seat 6: FVs16t7GgfWgQWt4JxsObQ folded before Flop (didn't bet)
Seat 7: 997ViqAtWn1FPjJqcffwcA folded before Flop
Seat 8: D+W9Me7w6Hcx/WRUSKV0dw folded before Flop (didn't bet)
Seat 9: ouwUBGRKnKK9uhn1G4Lf+A folded before Flop (didn't bet)



PokerStars Game #59940633410:  Hold'em No Limit ($0.50/$1.00) - 2009/07/01 1:12:10 ET
Table 'vs/5jr6ciwjVQ5+Soc+u2A' 6-max Seat #6 is the button
Seat 1: J798qwLuvXyq0BbzsIjOrA ($97.70 in chips)
Seat 2: lXX4W7m3u++JiSOZ46yVMQ ($126.55 in chips)
Seat 3: G5ZSSN6RSON3gkNvk/SmYg ($125.35 in chips)
Seat 4: wk6Ohn4GDozoOMHc4eb2rw ($63.80 in chips)
Seat 5: +Nt3OPk3XR9SKjZgm2CexQ ($110 in chips)
Seat 6: Z2fXsGcjl+Eax+RzOgwOmg ($100 in chips)
J798qwLuvXyq0BbzsIjOrA: posts small blind $0.50
lXX4W7m3u++JiSOZ46yVMQ: posts big blind $1
*** HOLE CARDS ***
G5ZSSN6RSON3gkNvk/SmYg: raises $3 to $4
wk6Ohn4GDozoOMHc4eb2rw: folds
+Nt3OPk3XR9SKjZgm2CexQ: folds
Z2fXsGcjl+Eax+RzOgwOmg: folds
J798qwLuvXyq0BbzsIjOrA: folds
lXX4W7m3u++JiSOZ46yVMQ: folds
G5ZSSN6RSON3gkNvk/SmYg collected $2.50 from pot
G5ZSSN6RSON3gkNvk/SmYg: doesn't show hand
*** SUMMARY ***
Total pot $2.50 | Rake $0
Seat 1: J798qwLuvXyq0BbzsIjOrA (small blind) folded before Flop
Seat 2: lXX4W7m3u++JiSOZ46yVMQ (big blind) folded before Flop
Seat 3: G5ZSSN6RSON3gkNvk/SmYg collected ($2.50)
Seat 4: wk6Ohn4GDozoOMHc4eb2rw folded before Flop (didn't bet)
Seat 5: +Nt3OPk3XR9SKjZgm2CexQ folded before Flop (didn't bet)
Seat 6: Z2fXsGcjl+Eax+RzOgwOmg (button) folded before Flop (didn't bet)



PokerStars Game #59940634494:  Hold'em No Limit ($0.50/$1.00) - 2009/07/01 1:12:12 ET
Table '+cA8mcmhaedZ7YcrDdhmeQ' 6-max Seat #6 is the button
Seat 1: lsLuWlcPA3Rh7kJVLzMh0Q ($302.95 in chips)
Seat 2: RqgF7gRoKgRNW8Zoi1ty4A ($130.25 in chips)
Seat 3: DAIgyIWbYvAkL6PbAI27pg ($18.50 in chips)
Seat 4: 4OO5v3AVduL0tePNx8wk5A ($109.55 in chips)
Seat 5: +7hFKAL0b0O/n8G72TclJA ($139.75 in chips)
Seat 6: YfsTQsY/fxb+YqbdclTHuw ($13.10 in chips)
lsLuWlcPA3Rh7kJVLzMh0Q: posts small blind $0.50
RqgF7gRoKgRNW8Zoi1ty4A: posts big blind $1
*** HOLE CARDS ***
DAIgyIWbYvAkL6PbAI27pg: folds
4OO5v3AVduL0tePNx8wk5A: folds
+7hFKAL0b0O/n8G72TclJA: raises $2 to $3
YfsTQsY/fxb+YqbdclTHuw: raises $10.10 to $13.10 and is all-in
lsLuWlcPA3Rh7kJVLzMh0Q: folds
RqgF7gRoKgRNW8Zoi1ty4A: folds
+7hFKAL0b0O/n8G72TclJA: folds
YfsTQsY/fxb+YqbdclTHuw collected $7.50 from pot
*** SUMMARY ***
Total pot $7.50 | Rake $0
Seat 1: lsLuWlcPA3Rh7kJVLzMh0Q (small blind) folded before Flop
Seat 2: RqgF7gRoKgRNW8Zoi1ty4A (big blind) folded before Flop
Seat 3: DAIgyIWbYvAkL6PbAI27pg folded before Flop (didn't bet)
Seat 4: 4OO5v3AVduL0tePNx8wk5A folded before Flop (didn't bet)
Seat 5: +7hFKAL0b0O/n8G72TclJA folded before Flop
Seat 6: YfsTQsY/fxb+YqbdclTHuw (button) collected ($7.50)



PokerStars Game #59940634848:  Hold'em No Limit ($0.50/$1.00) - 2009/07/01 1:12:12 ET
Table 'MUPc8FEpe/nR0BKSeReX6Q' 6-max Seat #4 is the button
Seat 1: qhkK6+yCciTRd+rCFEbnEQ ($41.70 in chips)
Seat 2: xAU6q2/cwmby2sxmA8VcmA ($114.70 in chips)
Seat 3: wx3sQGkVi2x9wJXuWNHPBw ($216 in chips)
Seat 4: ZA1bp6g8IwtTxkUE4eCjDQ ($193.90 in chips)
Seat 5: UBZQqpnJZdTYYY1FTb0rLA ($100 in chips)
Seat 6: oxnw0GLLpFanjhGkxfRSqA ($55.50 in chips)
UBZQqpnJZdTYYY1FTb0rLA: posts small blind $0.50
oxnw0GLLpFanjhGkxfRSqA: posts big blind $1
*** HOLE CARDS ***
qhkK6+yCciTRd+rCFEbnEQ: folds
xAU6q2/cwmby2sxmA8VcmA: folds
wx3sQGkVi2x9wJXuWNHPBw: folds
ZA1bp6g8IwtTxkUE4eCjDQ: folds
UBZQqpnJZdTYYY1FTb0rLA: calls $0.50
oxnw0GLLpFanjhGkxfRSqA: checks
*** FLOP *** [3h Qc Kc]
UBZQqpnJZdTYYY1FTb0rLA: bets $1
oxnw0GLLpFanjhGkxfRSqA: calls $1
*** TURN *** [3h Qc Kc] [Ad]
UBZQqpnJZdTYYY1FTb0rLA: checks
oxnw0GLLpFanjhGkxfRSqA: bets $2
UBZQqpnJZdTYYY1FTb0rLA: calls $2
*** RIVER *** [3h Qc Kc Ad] [6h]
UBZQqpnJZdTYYY1FTb0rLA: checks
oxnw0GLLpFanjhGkxfRSqA: checks
*** SHOW DOWN ***
UBZQqpnJZdTYYY1FTb0rLA: shows [Qd 9s] (a pair of Queens)
oxnw0GLLpFanjhGkxfRSqA: shows [As 5c] (a pair of Aces)
oxnw0GLLpFanjhGkxfRSqA collected $7.65 from pot
*** SUMMARY ***
Total pot $8 | Rake $0.35
Board [3h Qc Kc Ad 6h]
Seat 1: qhkK6+yCciTRd+rCFEbnEQ folded before Flop (didn't bet)
Seat 2: xAU6q2/cwmby2sxmA8VcmA folded before Flop (didn't bet)
Seat 3: wx3sQGkVi2x9wJXuWNHPBw folded before Flop (didn't bet)
Seat 4: ZA1bp6g8IwtTxkUE4eCjDQ (button) folded before Flop (didn't bet)
Seat 5: UBZQqpnJZdTYYY1FTb0rLA (small blind) showed [Qd 9s] and lost with a pair of Queens
Seat 6: oxnw0GLLpFanjhGkxfRSqA (big blind) showed [As 5c] and won ($7.65) with a pair of Aces



PokerStars Game #59940634870:  Hold'em No Limit ($0.50/$1.00) - 2009/07/01 1:12:12 ET
Table 'O96CPOtvMBWP6kzuYDfdFA' 6-max Seat #5 is the button
Seat 1: 6alLXQIITA2EZ/lBeym8Dw ($119.55 in chips)
Seat 2: 4d1rWhpu8DzLmzMbR3QKyA ($111.35 in chips)
Seat 4: /P4w1pHg2zHYg/4ubJ0dPw ($63.55 in chips)
Seat 5: G5ZSSN6RSON3gkNvk/SmYg ($100 in chips)
Seat 6: GYei5jXGWexiJYbAT2fELg ($32.90 in chips)
GYei5jXGWexiJYbAT2fELg: posts small blind $0.50
V89DGjxE171oPREEbAXiyg has returned
6alLXQIITA2EZ/lBeym8Dw: posts big blind $1
*** HOLE CARDS ***
4d1rWhpu8DzLmzMbR3QKyA: raises $2 to $3
/P4w1pHg2zHYg/4ubJ0dPw: folds
G5ZSSN6RSON3gkNvk/SmYg: folds
GYei5jXGWexiJYbAT2fELg: folds
6alLXQIITA2EZ/lBeym8Dw: folds
4d1rWhpu8DzLmzMbR3QKyA collected $2.50 from pot
*** SUMMARY ***
Total pot $2.50 | Rake $0
Seat 1: 6alLXQIITA2EZ/lBeym8Dw (big blind) folded before Flop
Seat 2: 4d1rWhpu8DzLmzMbR3QKyA collected ($2.50)
Seat 4: /P4w1pHg2zHYg/4ubJ0dPw folded before Flop (didn't bet)
Seat 5: G5ZSSN6RSON3gkNvk/SmYg (button) folded before Flop (didn't bet)
Seat 6: GYei5jXGWexiJYbAT2fELg (small blind) folded before Flop



PokerStars Game #59940637980:  Hold'em No Limit ($0.50/$1.00) - 2009/07/01 1:12:18 ET
Table 'W/wyObTiXZm+Ckkl3YxcSw' 6-max Seat #3 is the button
Seat 1: eUBBn2R56C1IQ6Cs/vitwg ($180.25 in chips)
Seat 2: oDiBRCaF0QVtd3kO6xZIXw ($154.35 in chips)
Seat 3: dxyNCn/qxfkGDUIf28Cbng ($55.40 in chips)
Seat 4: aYii2DmxlOlbC1wbGRBWvQ ($113.25 in chips)
Seat 5: MFptnnT6AnJakWBooTkmeg ($18.65 in chips)
aYii2DmxlOlbC1wbGRBWvQ: posts small blind $0.50
MFptnnT6AnJakWBooTkmeg: posts big blind $1
b2a+5TkFf4xJN/Ihhma58Q: sits out
*** HOLE CARDS ***
eUBBn2R56C1IQ6Cs/vitwg: folds
oDiBRCaF0QVtd3kO6xZIXw: raises $2 to $3
dxyNCn/qxfkGDUIf28Cbng: folds
aYii2DmxlOlbC1wbGRBWvQ: folds
MFptnnT6AnJakWBooTkmeg: calls $2
*** FLOP *** [Th 7s 5s]
MFptnnT6AnJakWBooTkmeg: checks
oDiBRCaF0QVtd3kO6xZIXw: bets $5
MFptnnT6AnJakWBooTkmeg: raises $10.65 to $15.65 and is all-in
oDiBRCaF0QVtd3kO6xZIXw: calls $10.65
*** TURN *** [Th 7s 5s] [Td]
*** RIVER *** [Th 7s 5s Td] [4d]
*** SHOW DOWN ***
MFptnnT6AnJakWBooTkmeg: shows [Tc Jh] (three of a kind, Tens)
oDiBRCaF0QVtd3kO6xZIXw: shows [6c 8c] (a straight, Four to Eight)
oDiBRCaF0QVtd3kO6xZIXw collected $35.95 from pot
*** SUMMARY ***
Total pot $37.80 | Rake $1.85
Board [Th 7s 5s Td 4d]
Seat 1: eUBBn2R56C1IQ6Cs/vitwg folded before Flop (didn't bet)
Seat 2: oDiBRCaF0QVtd3kO6xZIXw showed [6c 8c] and won ($35.95) with a straight, Four to Eight
Seat 3: dxyNCn/qxfkGDUIf28Cbng (button) folded before Flop (didn't bet)
Seat 4: aYii2DmxlOlbC1wbGRBWvQ (small blind) folded before Flop
Seat 5: MFptnnT6AnJakWBooTkmeg (big blind) showed [Tc Jh] and lost with three of a kind, Tens



PokerStars Game #59940637964:  Hold'em No Limit ($0.50/$1.00) - 2009/07/01 1:12:18 ET
Table 'rmZfTK+oSebeUPJNbWhdAA' 6-max Seat #1 is the button
Seat 1: xAU6q2/cwmby2sxmA8VcmA ($147 in chips)
Seat 2: z7O9PO/WEcqRouIydFhS9Q ($134.95 in chips)
Seat 3: BCEV3COoKY607AzLWayfRA ($154.30 in chips)
Seat 4: 1/mIuXfgx1ZyVkodrmfQDw ($100 in chips)
Seat 5: 5lY8d6Cnm4HUkt/8FZSj4g ($49.95 in chips)
Seat 6: j7NIOHLZk7V2o9fOioO5ug ($130.50 in chips)
z7O9PO/WEcqRouIydFhS9Q: posts small blind $0.50
BCEV3COoKY607AzLWayfRA: posts big blind $1
*** HOLE CARDS ***
1/mIuXfgx1ZyVkodrmfQDw: folds
5lY8d6Cnm4HUkt/8FZSj4g: folds
j7NIOHLZk7V2o9fOioO5ug: raises $2 to $3
xAU6q2/cwmby2sxmA8VcmA: folds
z7O9PO/WEcqRouIydFhS9Q: folds
BCEV3COoKY607AzLWayfRA: folds
j7NIOHLZk7V2o9fOioO5ug collected $2.50 from pot
j7NIOHLZk7V2o9fOioO5ug: doesn't show hand
*** SUMMARY ***
Total pot $2.50 | Rake $0
Seat 1: xAU6q2/cwmby2sxmA8VcmA (button) folded before Flop (didn't bet)
Seat 2: z7O9PO/WEcqRouIydFhS9Q (small blind) folded before Flop
Seat 3: BCEV3COoKY607AzLWayfRA (big blind) folded before Flop
Seat 4: 1/mIuXfgx1ZyVkodrmfQDw folded before Flop (didn't bet)
Seat 5: 5lY8d6Cnm4HUkt/8FZSj4g folded before Flop (didn't bet)
Seat 6: j7NIOHLZk7V2o9fOioO5ug collected ($2.50)



PokerStars Game #59940638268:  Hold'em No Limit ($0.50/$1.00) - 2009/07/01 1:12:18 ET
Table 'VOs36P6NW+QyXeQ1B62kmA' 6-max Seat #3 is the button
Seat 1: Z2fXsGcjl+Eax+RzOgwOmg ($100 in chips)
Seat 2: 2UMlbaZ8n8AbRli0Yr0mDw ($32.35 in chips)
Seat 3: FyNUCpzHVyQu/qX8pqNQFA ($100 in chips)
Seat 4: w02zQzNydODiyV9THKgo9w ($46.60 in chips)
Seat 5: ozrlafxxh1HmYdA0/h+MuA ($41.90 in chips)
Seat 6: slVKuQyEz8Qj4E3uLPYNXg ($107.80 in chips)
w02zQzNydODiyV9THKgo9w: posts small blind $0.50
ozrlafxxh1HmYdA0/h+MuA: posts big blind $1
*** HOLE CARDS ***
slVKuQyEz8Qj4E3uLPYNXg: folds
Z2fXsGcjl+Eax+RzOgwOmg: folds
2UMlbaZ8n8AbRli0Yr0mDw: calls $1
FyNUCpzHVyQu/qX8pqNQFA: folds
w02zQzNydODiyV9THKgo9w: calls $0.50
ozrlafxxh1HmYdA0/h+MuA: checks
*** FLOP *** [3d Ts Th]
w02zQzNydODiyV9THKgo9w: checks
ozrlafxxh1HmYdA0/h+MuA: checks
2UMlbaZ8n8AbRli0Yr0mDw: checks
*** TURN *** [3d Ts Th] [7d]
w02zQzNydODiyV9THKgo9w: checks
ozrlafxxh1HmYdA0/h+MuA: checks
2UMlbaZ8n8AbRli0Yr0mDw: checks
*** RIVER *** [3d Ts Th 7d] [9c]
w02zQzNydODiyV9THKgo9w: checks
ozrlafxxh1HmYdA0/h+MuA: checks
2UMlbaZ8n8AbRli0Yr0mDw: checks
*** SHOW DOWN ***
w02zQzNydODiyV9THKgo9w: shows [5d Qs] (a pair of Tens)
ozrlafxxh1HmYdA0/h+MuA: shows [Ac 8d] (a pair of Tens - Ace kicker)
2UMlbaZ8n8AbRli0Yr0mDw: mucks hand
ozrlafxxh1HmYdA0/h+MuA collected $2.85 from pot
*** SUMMARY ***
Total pot $3 | Rake $0.15
Board [3d Ts Th 7d 9c]
Seat 1: Z2fXsGcjl+Eax+RzOgwOmg folded before Flop (didn't bet)
Seat 2: 2UMlbaZ8n8AbRli0Yr0mDw mucked
Seat 3: FyNUCpzHVyQu/qX8pqNQFA (button) folded before Flop (didn't bet)
Seat 4: w02zQzNydODiyV9THKgo9w (small blind) showed [5d Qs] and lost with a pair of Tens
Seat 5: ozrlafxxh1HmYdA0/h+MuA (big blind) showed [Ac 8d] and won ($2.85) with a pair of Tens
Seat 6: slVKuQyEz8Qj4E3uLPYNXg folded before Flop (didn't bet)



PokerStars Game #59940639606:  Hold'em No Limit ($0.50/$1.00) - 2009/07/01 1:12:20 ET
Table 'cKH9c4x6u79IqCdaKKvXrw' 9-max Seat #9 is the button
Seat 1: Pp/KTcXkfZKKUHkjyaLTdg ($19 in chips)
Seat 2: 8S3JMH4TY3whgIlZmMv66w ($59.55 in chips)
Seat 3: 997ViqAtWn1FPjJqcffwcA ($155.60 in chips)
Seat 4: FL3MrLspcF23LYvC4ipBOA ($100 in chips)
Seat 5: Jjc7EHWzs4//xUAjJ0UWoA ($44.40 in chips)
Seat 6: Bsd/K5gAcLanYbGiPirRjw ($201.05 in chips)
Seat 7: 1GkkVBhlJ92guE6K5mS5Ig ($18 in chips)
Seat 8: myIxN7otsyr846M539YR8Q ($31.35 in chips)
Seat 9: 6XkTu4ahxzHnvjjc1R8YjQ ($40.10 in chips)
Pp/KTcXkfZKKUHkjyaLTdg: posts small blind $0.50
8S3JMH4TY3whgIlZmMv66w: posts big blind $1
*** HOLE CARDS ***
997ViqAtWn1FPjJqcffwcA: folds
FL3MrLspcF23LYvC4ipBOA: folds
Jjc7EHWzs4//xUAjJ0UWoA: folds
Bsd/K5gAcLanYbGiPirRjw: folds
1GkkVBhlJ92guE6K5mS5Ig: folds
myIxN7otsyr846M539YR8Q: folds
6XkTu4ahxzHnvjjc1R8YjQ: folds
Pp/KTcXkfZKKUHkjyaLTdg: folds
8S3JMH4TY3whgIlZmMv66w collected $1 from pot
*** SUMMARY ***
Total pot $1 | Rake $0
Seat 1: Pp/KTcXkfZKKUHkjyaLTdg (small blind) folded before Flop
Seat 2: 8S3JMH4TY3whgIlZmMv66w (big blind) collected ($1)
Seat 3: 997ViqAtWn1FPjJqcffwcA folded before Flop (didn't bet)
Seat 4: FL3MrLspcF23LYvC4ipBOA folded before Flop (didn't bet)
Seat 5: Jjc7EHWzs4//xUAjJ0UWoA folded before Flop (didn't bet)
Seat 6: Bsd/K5gAcLanYbGiPirRjw folded before Flop (didn't bet)
Seat 7: 1GkkVBhlJ92guE6K5mS5Ig folded before Flop (didn't bet)
Seat 8: myIxN7otsyr846M539YR8Q folded before Flop (didn't bet)
Seat 9: 6XkTu4ahxzHnvjjc1R8YjQ (button) folded before Flop (didn't bet)



PokerStars Game #59940640008:  Hold'em No Limit ($0.50/$1.00) - 2009/07/01 1:12:21 ET
Table 'kS0cTQAEi+fdUlJP2gQYvw' 9-max Seat #6 is the button
Seat 1: c/9X4zftzphFxYtxp5kp9w ($64.35 in chips)
Seat 2: D+W9Me7w6Hcx/WRUSKV0dw ($22.40 in chips)
Seat 3: 2BV+oJIQYr65IO6nEChvbA ($60 in chips)
Seat 4: RUhhaALzha3TH1AkdakoGQ ($50 in chips)
Seat 5: 997ViqAtWn1FPjJqcffwcA ($101.15 in chips)
Seat 6: yAbu2QsRPVcjPbqlf/jDxw ($126.15 in chips)
Seat 7: Ffa7Nj4X5fddtROP01hfQg ($156.40 in chips)
Seat 9: OGgaARGdJQT4awWVNQ957w ($101.50 in chips)
vKyFzTyzfT7fZcdX+HHN+Q joins the table at seat #8
Ffa7Nj4X5fddtROP01hfQg: posts small blind $0.50
OGgaARGdJQT4awWVNQ957w: posts big blind $1
RUhhaALzha3TH1AkdakoGQ: posts big blind $1
*** HOLE CARDS ***
c/9X4zftzphFxYtxp5kp9w: folds
D+W9Me7w6Hcx/WRUSKV0dw: folds
2BV+oJIQYr65IO6nEChvbA: folds
RUhhaALzha3TH1AkdakoGQ: checks
997ViqAtWn1FPjJqcffwcA: folds
yAbu2QsRPVcjPbqlf/jDxw: folds
Ffa7Nj4X5fddtROP01hfQg: raises $1 to $2
OGgaARGdJQT4awWVNQ957w: folds
RUhhaALzha3TH1AkdakoGQ: calls $1
*** FLOP *** [7c 8c 5h]
Ffa7Nj4X5fddtROP01hfQg: bets $2
RUhhaALzha3TH1AkdakoGQ: calls $2
*** TURN *** [7c 8c 5h] [Tc]
Ffa7Nj4X5fddtROP01hfQg: bets $2
RUhhaALzha3TH1AkdakoGQ: calls $2
*** RIVER *** [7c 8c 5h Tc] [8h]
Ffa7Nj4X5fddtROP01hfQg: bets $2
RUhhaALzha3TH1AkdakoGQ: folds
Ffa7Nj4X5fddtROP01hfQg collected $12.40 from pot
*** SUMMARY ***
Total pot $13 | Rake $0.60
Board [7c 8c 5h Tc 8h]
Seat 1: c/9X4zftzphFxYtxp5kp9w folded before Flop (didn't bet)
Seat 2: D+W9Me7w6Hcx/WRUSKV0dw folded before Flop (didn't bet)
Seat 3: 2BV+oJIQYr65IO6nEChvbA folded before Flop (didn't bet)
Seat 4: RUhhaALzha3TH1AkdakoGQ folded on the River
Seat 5: 997ViqAtWn1FPjJqcffwcA folded before Flop (didn't bet)
Seat 6: yAbu2QsRPVcjPbqlf/jDxw (button) folded before Flop (didn't bet)
Seat 7: Ffa7Nj4X5fddtROP01hfQg (small blind) collected ($12.40)
Seat 9: OGgaARGdJQT4awWVNQ957w (big blind) folded before Flop



PokerStars Game #59940640608:  Hold'em No Limit ($0.50/$1.00) - 2009/07/01 1:12:22 ET
Table 'GPp0HyAuggN8oE0sUWzPpA' 9-max Seat #2 is the button
Seat 1: qJr25HAtvv1w/7IBvjMM3g ($44.20 in chips)
Seat 2: m3U8I35Pn3gxKhoS2nmYIg ($13.40 in chips)
Seat 3: CCCXsirC+bO7ginAuUUVlQ ($75.60 in chips)
Seat 4: mBRWbnUl8diyBO1qTJaNzw ($103.65 in chips)
Seat 6: BK/GtNPkSx0TdUDj82id5A ($16.35 in chips)
Seat 7: DHdbHyysD15wCAtx+BhUjA ($93.50 in chips)
Seat 9: dzoSjPZmtjGuK83119030A ($34.15 in chips)
CCCXsirC+bO7ginAuUUVlQ: posts small blind $0.50
mBRWbnUl8diyBO1qTJaNzw: posts big blind $1
bLbSOSmSOnqE0iTcH/5dxA: sits out
P/6qLjycEfxRgZ5F/W90dw: sits out
*** HOLE CARDS ***
BK/GtNPkSx0TdUDj82id5A: calls $1
DHdbHyysD15wCAtx+BhUjA: folds
dzoSjPZmtjGuK83119030A: folds
qJr25HAtvv1w/7IBvjMM3g: calls $1
m3U8I35Pn3gxKhoS2nmYIg: folds
CCCXsirC+bO7ginAuUUVlQ: calls $0.50
mBRWbnUl8diyBO1qTJaNzw: checks
*** FLOP *** [3c Qh 5c]
CCCXsirC+bO7ginAuUUVlQ: bets $4
mBRWbnUl8diyBO1qTJaNzw: folds
BK/GtNPkSx0TdUDj82id5A: raises $4 to $8
qJr25HAtvv1w/7IBvjMM3g: folds
CCCXsirC+bO7ginAuUUVlQ: calls $4
*** TURN *** [3c Qh 5c] [2d]
CCCXsirC+bO7ginAuUUVlQ: bets $8
BK/GtNPkSx0TdUDj82id5A: calls $7.35 and is all-in
*** RIVER *** [3c Qh 5c 2d] [Td]
*** SHOW DOWN ***
CCCXsirC+bO7ginAuUUVlQ: shows [Kd Qs] (a pair of Queens)
BK/GtNPkSx0TdUDj82id5A: shows [3h 3d] (three of a kind, Threes)
BK/GtNPkSx0TdUDj82id5A collected $33.05 from pot
*** SUMMARY ***
Total pot $34.70 | Rake $1.65
Board [3c Qh 5c 2d Td]
Seat 1: qJr25HAtvv1w/7IBvjMM3g folded on the Flop
Seat 2: m3U8I35Pn3gxKhoS2nmYIg (button) folded before Flop (didn't bet)
Seat 3: CCCXsirC+bO7ginAuUUVlQ (small blind) showed [Kd Qs] and lost with a pair of Queens
Seat 4: mBRWbnUl8diyBO1qTJaNzw (big blind) folded on the Flop
Seat 6: BK/GtNPkSx0TdUDj82id5A showed [3h 3d] and won ($33.05) with three of a kind, Threes
Seat 7: DHdbHyysD15wCAtx+BhUjA folded before Flop (didn't bet)
Seat 9: dzoSjPZmtjGuK83119030A folded before Flop (didn't bet)



PokerStars Game #59940641232:  Hold'em No Limit ($0.50/$1.00) - 2009/07/01 1:12:23 ET
Table 'pHrhryH8jPNdQfY62f8v+g' 6-max Seat #4 is the button
Seat 1: 4d1rWhpu8DzLmzMbR3QKyA ($100 in chips)
Seat 3: 8oS5O7iD/qnFXFXJrGIgNQ ($100 in chips)
Seat 4: 1f3beyIML24UqEMTbWy93g ($58.15 in chips)
Seat 5: r1/R7y0Ortgoz4lccgW8VA ($41.05 in chips)
Seat 6: xAU6q2/cwmby2sxmA8VcmA ($208.10 in chips)
r1/R7y0Ortgoz4lccgW8VA: posts small blind $0.50
xAU6q2/cwmby2sxmA8VcmA: posts big blind $1
*** HOLE CARDS ***
4d1rWhpu8DzLmzMbR3QKyA: raises $2 to $3
JwCcjZl0bjJzG7hmE0dnTA joins the table at seat #2
8oS5O7iD/qnFXFXJrGIgNQ: folds
1f3beyIML24UqEMTbWy93g: folds
r1/R7y0Ortgoz4lccgW8VA: calls $2.50
xAU6q2/cwmby2sxmA8VcmA: folds
*** FLOP *** [3d 8d Jc]
r1/R7y0Ortgoz4lccgW8VA: checks
4d1rWhpu8DzLmzMbR3QKyA: checks
*** TURN *** [3d 8d Jc] [Jd]
r1/R7y0Ortgoz4lccgW8VA: checks
4d1rWhpu8DzLmzMbR3QKyA: bets $5
r1/R7y0Ortgoz4lccgW8VA: calls $5
*** RIVER *** [3d 8d Jc Jd] [Kc]
r1/R7y0Ortgoz4lccgW8VA: checks
4d1rWhpu8DzLmzMbR3QKyA: checks
*** SHOW DOWN ***
r1/R7y0Ortgoz4lccgW8VA: shows [Th 8h] (two pair, Jacks and Eights)
4d1rWhpu8DzLmzMbR3QKyA: shows [8c Ac] (two pair, Jacks and Eights - Ace kicker)
4d1rWhpu8DzLmzMbR3QKyA collected $16.20 from pot
*** SUMMARY ***
Total pot $17 | Rake $0.80
Board [3d 8d Jc Jd Kc]
Seat 1: 4d1rWhpu8DzLmzMbR3QKyA showed [8c Ac] and won ($16.20) with two pair, Jacks and Eights
Seat 3: 8oS5O7iD/qnFXFXJrGIgNQ folded before Flop (didn't bet)
Seat 4: 1f3beyIML24UqEMTbWy93g (button) folded before Flop (didn't bet)
Seat 5: r1/R7y0Ortgoz4lccgW8VA (small blind) showed [Th 8h] and lost with two pair, Jacks and Eights
Seat 6: xAU6q2/cwmby2sxmA8VcmA (big blind) folded before Flop



PokerStars Game #59940644212:  Hold'em No Limit ($0.50/$1.00) - 2009/07/01 1:12:28 ET
Table 'vs/5jr6ciwjVQ5+Soc+u2A' 6-max Seat #1 is the button
Seat 1: J798qwLuvXyq0BbzsIjOrA ($97.20 in chips)
Seat 2: lXX4W7m3u++JiSOZ46yVMQ ($125.55 in chips)
Seat 3: G5ZSSN6RSON3gkNvk/SmYg ($126.85 in chips)
Seat 4: wk6Ohn4GDozoOMHc4eb2rw ($63.80 in chips)
Seat 5: +Nt3OPk3XR9SKjZgm2CexQ ($110 in chips)
Seat 6: Z2fXsGcjl+Eax+RzOgwOmg ($100 in chips)
lXX4W7m3u++JiSOZ46yVMQ: posts small blind $0.50
G5ZSSN6RSON3gkNvk/SmYg: posts big blind $1
*** HOLE CARDS ***
wk6Ohn4GDozoOMHc4eb2rw: folds
+Nt3OPk3XR9SKjZgm2CexQ: raises $2 to $3
Z2fXsGcjl+Eax+RzOgwOmg: folds
J798qwLuvXyq0BbzsIjOrA: calls $3
lXX4W7m3u++JiSOZ46yVMQ: folds
G5ZSSN6RSON3gkNvk/SmYg: raises $8 to $11
+Nt3OPk3XR9SKjZgm2CexQ: folds
J798qwLuvXyq0BbzsIjOrA: calls $8
*** FLOP *** [9c 6c Ac]
G5ZSSN6RSON3gkNvk/SmYg: checks
J798qwLuvXyq0BbzsIjOrA: checks
*** TURN *** [9c 6c Ac] [9d]
G5ZSSN6RSON3gkNvk/SmYg: bets $16
J798qwLuvXyq0BbzsIjOrA: folds
G5ZSSN6RSON3gkNvk/SmYg collected $24.25 from pot
G5ZSSN6RSON3gkNvk/SmYg: doesn't show hand
*** SUMMARY ***
Total pot $25.50 | Rake $1.25
Board [9c 6c Ac 9d]
Seat 1: J798qwLuvXyq0BbzsIjOrA (button) folded on the Turn
Seat 2: lXX4W7m3u++JiSOZ46yVMQ (small blind) folded before Flop
Seat 3: G5ZSSN6RSON3gkNvk/SmYg (big blind) collected ($24.25)
Seat 4: wk6Ohn4GDozoOMHc4eb2rw folded before Flop (didn't bet)
Seat 5: +Nt3OPk3XR9SKjZgm2CexQ folded before Flop
Seat 6: Z2fXsGcjl+Eax+RzOgwOmg folded before Flop (didn't bet)



PokerStars Game #59940644078:  Hold'em No Limit ($0.50/$1.00) - 2009/07/01 1:12:28 ET
Table '7O9fB8yx1u7sJveJn8w6jA' 6-max Seat #4 is the button
Seat 1: jy52+7FotjH63o5tEEVgKw ($85.85 in chips)
Seat 2: wx3sQGkVi2x9wJXuWNHPBw ($186.45 in chips)
Seat 3: hpxXcmRkXXI9HE5+5/j/0Q ($102.70 in chips)
Seat 4: b2a+5TkFf4xJN/Ihhma58Q ($41.30 in chips)
Seat 5: BCEV3COoKY607AzLWayfRA ($100 in chips)
Seat 6: p1Ga2i1TuXUvRn+Rf/0FMw ($126.25 in chips)
BCEV3COoKY607AzLWayfRA: posts small blind $0.50
p1Ga2i1TuXUvRn+Rf/0FMw: posts big blind $1
*** HOLE CARDS ***
jy52+7FotjH63o5tEEVgKw: calls $1
wx3sQGkVi2x9wJXuWNHPBw: folds
hpxXcmRkXXI9HE5+5/j/0Q: folds
b2a+5TkFf4xJN/Ihhma58Q: folds
BCEV3COoKY607AzLWayfRA: calls $0.50
p1Ga2i1TuXUvRn+Rf/0FMw: checks
*** FLOP *** [6s Jc 3h]
BCEV3COoKY607AzLWayfRA: bets $3
p1Ga2i1TuXUvRn+Rf/0FMw: folds
jy52+7FotjH63o5tEEVgKw: folds
BCEV3COoKY607AzLWayfRA collected $2.85 from pot
BCEV3COoKY607AzLWayfRA: doesn't show hand
*** SUMMARY ***
Total pot $3 | Rake $0.15
Board [6s Jc 3h]
Seat 1: jy52+7FotjH63o5tEEVgKw folded on the Flop
Seat 2: wx3sQGkVi2x9wJXuWNHPBw folded before Flop (didn't bet)
Seat 3: hpxXcmRkXXI9HE5+5/j/0Q folded before Flop (didn't bet)
Seat 4: b2a+5TkFf4xJN/Ihhma58Q (button) folded before Flop (didn't bet)
Seat 5: BCEV3COoKY607AzLWayfRA (small blind) collected ($2.85)
Seat 6: p1Ga2i1TuXUvRn+Rf/0FMw (big blind) folded on the Flop



PokerStars Game #59940644710:  Hold'em No Limit ($0.50/$1.00) - 2009/07/01 1:12:29 ET
Table 'QSIig7BLMc9wY/rgBechzw' 6-max Seat #1 is the button
Seat 1: Z2fXsGcjl+Eax+RzOgwOmg ($113.50 in chips)
Seat 2: mLOIkH/qmRa+mVujQIhBRg ($46.30 in chips)
Seat 3: +xW7QemQU0Fxs+4TnqBRow ($100 in chips)
Seat 4: +uSzP8Jwnw7sKfQ4s66b7w ($78.45 in chips)
Seat 5: lsLuWlcPA3Rh7kJVLzMh0Q ($102.35 in chips)
Seat 6: PxqfkAMdAWtkgbT+q2gciA ($31 in chips)
mLOIkH/qmRa+mVujQIhBRg: posts small blind $0.50
+xW7QemQU0Fxs+4TnqBRow: posts big blind $1
*** HOLE CARDS ***
+uSzP8Jwnw7sKfQ4s66b7w: folds
lsLuWlcPA3Rh7kJVLzMh0Q: folds
PxqfkAMdAWtkgbT+q2gciA: folds
Z2fXsGcjl+Eax+RzOgwOmg: folds
mLOIkH/qmRa+mVujQIhBRg: calls $0.50
+xW7QemQU0Fxs+4TnqBRow: checks
*** FLOP *** [Th Tc 6c]
mLOIkH/qmRa+mVujQIhBRg: bets $1
+xW7QemQU0Fxs+4TnqBRow: raises $2 to $3
mLOIkH/qmRa+mVujQIhBRg: folds
+xW7QemQU0Fxs+4TnqBRow collected $3.85 from pot
+xW7QemQU0Fxs+4TnqBRow: doesn't show hand
*** SUMMARY ***
Total pot $4 | Rake $0.15
Board [Th Tc 6c]
Seat 1: Z2fXsGcjl+Eax+RzOgwOmg (button) folded before Flop (didn't bet)
Seat 2: mLOIkH/qmRa+mVujQIhBRg (small blind) folded on the Flop
Seat 3: +xW7QemQU0Fxs+4TnqBRow (big blind) collected ($3.85)
Seat 4: +uSzP8Jwnw7sKfQ4s66b7w folded before Flop (didn't bet)
Seat 5: lsLuWlcPA3Rh7kJVLzMh0Q folded before Flop (didn't bet)
Seat 6: PxqfkAMdAWtkgbT+q2gciA folded before Flop (didn't bet)



PokerStars Game #59940644858:  Hold'em No Limit ($0.50/$1.00) - 2009/07/01 1:12:29 ET
Table 'tJq9SfN1ywY0r03VBlWlwQ' 9-max Seat #6 is the button
Seat 1: wZsU+w9r7G66x93UuvBf1Q ($335.30 in chips)
Seat 3: FVs16t7GgfWgQWt4JxsObQ ($13.10 in chips)
Seat 4: bLbSOSmSOnqE0iTcH/5dxA ($110.70 in chips)
Seat 5: h5ipsNTMyolp7xn/NAvWkA ($95.50 in chips)
Seat 6: gUUvmqdVlmvpal6B8nYrmg ($116.20 in chips)
Seat 8: G4DEhsZFmznGNVpy2SEocA ($28.90 in chips)
Seat 9: XE5QF1y74bpHog9JxWJMWQ ($100.50 in chips)
Pp/KTcXkfZKKUHkjyaLTdg will be allowed to play after the button
G4DEhsZFmznGNVpy2SEocA: posts small blind $0.50
XE5QF1y74bpHog9JxWJMWQ: posts big blind $1
*** HOLE CARDS ***
wZsU+w9r7G66x93UuvBf1Q: folds
FVs16t7GgfWgQWt4JxsObQ: folds
bLbSOSmSOnqE0iTcH/5dxA: folds
h5ipsNTMyolp7xn/NAvWkA: raises $3 to $4
gUUvmqdVlmvpal6B8nYrmg: folds
G4DEhsZFmznGNVpy2SEocA: folds
XE5QF1y74bpHog9JxWJMWQ: folds
h5ipsNTMyolp7xn/NAvWkA collected $2.50 from pot
*** SUMMARY ***
Total pot $2.50 | Rake $0
Seat 1: wZsU+w9r7G66x93UuvBf1Q folded before Flop (didn't bet)
Seat 3: FVs16t7GgfWgQWt4JxsObQ folded before Flop (didn't bet)
Seat 4: bLbSOSmSOnqE0iTcH/5dxA folded before Flop (didn't bet)
Seat 5: h5ipsNTMyolp7xn/NAvWkA collected ($2.50)
Seat 6: gUUvmqdVlmvpal6B8nYrmg (button) folded before Flop (didn't bet)
Seat 8: G4DEhsZFmznGNVpy2SEocA (small blind) folded before Flop
Seat 9: XE5QF1y74bpHog9JxWJMWQ (big blind) folded before Flop



PokerStars Game #59940645538:  Hold'em No Limit ($0.50/$1.00) - 2009/07/01 1:12:31 ET
Table 'tyUh+jyNvrceIQdKMJjQ2wZFWj23PMihdwrNWv41OG/Qeat #4 is the button
Seat 1: o8A5MUdudVKu+pAwgZOX2w ($110.45 in chips)
Seat 2: 5uy3EN+iIYkgwbWZFTUBAQ ($105.50 in chips)
Seat 3: TalCiLYHCd+ffkmR3auPvA ($138.80 in chips)
Seat 4: hpxXcmRkXXI9HE5+5/j/0Q ($100 in chips)
Seat 5: j7NIOHLZk7V2o9fOioO5ug ($107.70 in chips)
Seat 6: 4OO5v3AVduL0tePNx8wk5A ($100 in chips)
j7NIOHLZk7V2o9fOioO5ug: posts small blind $0.50
4OO5v3AVduL0tePNx8wk5A: posts big blind $1
*** HOLE CARDS ***
o8A5MUdudVKu+pAwgZOX2w: calls $1
5uy3EN+iIYkgwbWZFTUBAQ: folds
TalCiLYHCd+ffkmR3auPvA: calls $1
hpxXcmRkXXI9HE5+5/j/0Q: folds
j7NIOHLZk7V2o9fOioO5ug: calls $0.50
4OO5v3AVduL0tePNx8wk5A: checks
*** FLOP *** [7c Ad 4h]
j7NIOHLZk7V2o9fOioO5ug: checks
4OO5v3AVduL0tePNx8wk5A: checks
o8A5MUdudVKu+pAwgZOX2w: bets $5
TalCiLYHCd+ffkmR3auPvA: folds
j7NIOHLZk7V2o9fOioO5ug: folds
4OO5v3AVduL0tePNx8wk5A: folds
o8A5MUdudVKu+pAwgZOX2w collected $3.80 from pot
o8A5MUdudVKu+pAwgZOX2w: doesn't show hand
*** SUMMARY ***
Total pot $4 | Rake $0.20
Board [7c Ad 4h]
Seat 1: o8A5MUdudVKu+pAwgZOX2w collected ($3.80)
Seat 2: 5uy3EN+iIYkgwbWZFTUBAQ folded before Flop (didn't bet)
Seat 3: TalCiLYHCd+ffkmR3auPvA folded on the Flop
Seat 4: hpxXcmRkXXI9HE5+5/j/0Q (button) folded before Flop (didn't bet)
Seat 5: j7NIOHLZk7V2o9fOioO5ug (small blind) folded on the Flop
Seat 6: 4OO5v3AVduL0tePNx8wk5A (big blind) folded on the Flop



PokerStars Game #59940645792:  Hold'em No Limit ($0.50/$1.00) - 2009/07/01 1:12:31 ET
Table 'O96CPOtvMBWP6kzuYDfdFA' 6-max Seat #6 is the button
Seat 1: 6alLXQIITA2EZ/lBeym8Dw ($118.55 in chips)
Seat 2: 4d1rWhpu8DzLmzMbR3QKyA ($112.85 in chips)
Seat 4: /P4w1pHg2zHYg/4ubJ0dPw ($63.55 in chips)
Seat 5: G5ZSSN6RSON3gkNvk/SmYg ($100 in chips)
Seat 6: GYei5jXGWexiJYbAT2fELg ($32.40 in chips)
6alLXQIITA2EZ/lBeym8Dw: posts small blind $0.50
4d1rWhpu8DzLmzMbR3QKyA: posts big blind $1
V89DGjxE171oPREEbAXiyg: sits out
*** HOLE CARDS ***
/P4w1pHg2zHYg/4ubJ0dPw: folds
G5ZSSN6RSON3gkNvk/SmYg: folds
GYei5jXGWexiJYbAT2fELg: calls $1
6alLXQIITA2EZ/lBeym8Dw: calls $0.50
4d1rWhpu8DzLmzMbR3QKyA: checks
*** FLOP *** [Js 7s 5s]
6alLXQIITA2EZ/lBeym8Dw: checks
4d1rWhpu8DzLmzMbR3QKyA: checks
GYei5jXGWexiJYbAT2fELg: bets $1
6alLXQIITA2EZ/lBeym8Dw: folds
4d1rWhpu8DzLmzMbR3QKyA: folds
GYei5jXGWexiJYbAT2fELg collected $2.85 from pot
*** SUMMARY ***
Total pot $3 | Rake $0.15
Board [Js 7s 5s]
Seat 1: 6alLXQIITA2EZ/lBeym8Dw (small blind) folded on the Flop
Seat 2: 4d1rWhpu8DzLmzMbR3QKyA (big blind) folded on the Flop
Seat 4: /P4w1pHg2zHYg/4ubJ0dPw folded before Flop (didn't bet)
Seat 5: G5ZSSN6RSON3gkNvk/SmYg folded before Flop (didn't bet)
Seat 6: GYei5jXGWexiJYbAT2fELg (button) collected ($2.85)



PokerStars Game #59940649148:  Hold'em No Limit ($0.50/$1.00) - 2009/07/01 1:12:37 ET
Table 'fZjVbKj9D8yOB+Rj7NaP/A' 9-max Seat #4 is the button
Seat 1: Oh57946S8OPACStkrhQm7g ($125 in chips)
Seat 2: PTAFYDIUSsG+SArbxNl+Aw ($107 in chips)
Seat 3: yAbu2QsRPVcjPbqlf/jDxw ($102.50 in chips)
Seat 4: 997ViqAtWn1FPjJqcffwcA ($103 in chips)
Seat 5: PkGfq5xrSlNsujKaG/HF4Q ($100 in chips)
Seat 6: OvwYHV65yUbgdBjSmo1+5g ($41.40 in chips)
Seat 7: SyS20PAm3RpT6uLBsGkwOA ($114.75 in chips)
Seat 9: qheQay5YvP2DMAb3OUSxtw ($99 in chips)
PkGfq5xrSlNsujKaG/HF4Q: posts small blind $0.50
OvwYHV65yUbgdBjSmo1+5g: posts big blind $1
zDOE5r14tWqCf6xhuSHK6g: sits out
*** HOLE CARDS ***
SyS20PAm3RpT6uLBsGkwOA: folds
qheQay5YvP2DMAb3OUSxtw: folds
Oh57946S8OPACStkrhQm7g: folds
PTAFYDIUSsG+SArbxNl+Aw: folds
yAbu2QsRPVcjPbqlf/jDxw: folds
997ViqAtWn1FPjJqcffwcA: folds
PkGfq5xrSlNsujKaG/HF4Q: folds
OvwYHV65yUbgdBjSmo1+5g collected $1 from pot
*** SUMMARY ***
Total pot $1 | Rake $0
Seat 1: Oh57946S8OPACStkrhQm7g folded before Flop (didn't bet)
Seat 2: PTAFYDIUSsG+SArbxNl+Aw folded before Flop (didn't bet)
Seat 3: yAbu2QsRPVcjPbqlf/jDxw folded before Flop (didn't bet)
Seat 4: 997ViqAtWn1FPjJqcffwcA (button) folded before Flop (didn't bet)
Seat 5: PkGfq5xrSlNsujKaG/HF4Q (small blind) folded before Flop
Seat 6: OvwYHV65yUbgdBjSmo1+5g (big blind) collected ($1)
Seat 7: SyS20PAm3RpT6uLBsGkwOA folded before Flop (didn't bet)
Seat 9: qheQay5YvP2DMAb3OUSxtw folded before Flop (didn't bet)



PokerStars Game #59940653994:  Hold'em No Limit ($0.50/$1.00) - 2009/07/01 1:12:45 ET
Table 'cKH9c4x6u79IqCdaKKvXrw' 9-max Seat #1 is the button
Seat 1: Pp/KTcXkfZKKUHkjyaLTdg ($18.50 in chips)
Seat 2: 8S3JMH4TY3whgIlZmMv66w ($60.05 in chips)
Seat 3: 997ViqAtWn1FPjJqcffwcA ($155.60 in chips)
Seat 4: FL3MrLspcF23LYvC4ipBOA ($100 in chips)
Seat 5: Jjc7EHWzs4//xUAjJ0UWoA ($44.40 in chips)
Seat 6: Bsd/K5gAcLanYbGiPirRjw ($201.05 in chips)
Seat 7: 1GkkVBhlJ92guE6K5mS5Ig ($18 in chips)
Seat 8: myIxN7otsyr846M539YR8Q ($31.35 in chips)
Seat 9: 6XkTu4ahxzHnvjjc1R8YjQ ($40.10 in chips)
8S3JMH4TY3whgIlZmMv66w: posts small blind $0.50
997ViqAtWn1FPjJqcffwcA: posts big blind $1
*** HOLE CARDS ***
FL3MrLspcF23LYvC4ipBOA: folds
Jjc7EHWzs4//xUAjJ0UWoA: folds
Bsd/K5gAcLanYbGiPirRjw: folds
1GkkVBhlJ92guE6K5mS5Ig: calls $1
myIxN7otsyr846M539YR8Q: folds
6XkTu4ahxzHnvjjc1R8YjQ: folds
Pp/KTcXkfZKKUHkjyaLTdg: folds
8S3JMH4TY3whgIlZmMv66w: folds
997ViqAtWn1FPjJqcffwcA: checks
*** FLOP *** [5d Ts 8s]
997ViqAtWn1FPjJqcffwcA: checks
1GkkVBhlJ92guE6K5mS5Ig: checks
*** TURN *** [5d Ts 8s] [Qh]
997ViqAtWn1FPjJqcffwcA: checks
1GkkVBhlJ92guE6K5mS5Ig: bets $3
997ViqAtWn1FPjJqcffwcA: folds
1GkkVBhlJ92guE6K5mS5Ig collected $2.40 from pot
*** SUMMARY ***
Total pot $2.50 | Rake $0.10
Board [5d Ts 8s Qh]
Seat 1: Pp/KTcXkfZKKUHkjyaLTdg (button) folded before Flop (didn't bet)
Seat 2: 8S3JMH4TY3whgIlZmMv66w (small blind) folded before Flop
Seat 3: 997ViqAtWn1FPjJqcffwcA (big blind) folded on the Turn
Seat 4: FL3MrLspcF23LYvC4ipBOA folded before Flop (didn't bet)
Seat 5: Jjc7EHWzs4//xUAjJ0UWoA folded before Flop (didn't bet)
Seat 6: Bsd/K5gAcLanYbGiPirRjw folded before Flop (didn't bet)
Seat 7: 1GkkVBhlJ92guE6K5mS5Ig collected ($2.40)
Seat 8: myIxN7otsyr846M539YR8Q folded before Flop (didn't bet)
Seat 9: 6XkTu4ahxzHnvjjc1R8YjQ folded before Flop (didn't bet)



PokerStars Game #59940655054:  Hold'em No Limit ($0.50/$1.00) - 2009/07/01 1:12:46 ET
Table 'cBDNutyLBKEk9+ptwsKmTw' 6-max Seat #1 is the button
Seat 1: xAU6q2/cwmby2sxmA8VcmA ($137.55 in chips)
Seat 3: G5ZSSN6RSON3gkNvk/SmYg ($100 in chips)
Seat 4: 3q7F5QtzC30pSrn0nl9i+A ($41.60 in chips)
Seat 6: NqVlOSH2lp+pp/TK3vvK5g ($82.45 in chips)
G5ZSSN6RSON3gkNvk/SmYg: posts small blind $0.50
3q7F5QtzC30pSrn0nl9i+A: posts big blind $1
hpxXcmRkXXI9HE5+5/j/0Q: sits out
*** HOLE CARDS ***
NqVlOSH2lp+pp/TK3vvK5g: raises $1 to $2
xAU6q2/cwmby2sxmA8VcmA: calls $2
5lY8d6Cnm4HUkt/8FZSj4g has returned
G5ZSSN6RSON3gkNvk/SmYg: folds
3q7F5QtzC30pSrn0nl9i+A: calls $1
*** FLOP *** [Jc 7c Kc]
3q7F5QtzC30pSrn0nl9i+A: bets $2
NqVlOSH2lp+pp/TK3vvK5g: calls $2
xAU6q2/cwmby2sxmA8VcmA: folds
*** TURN *** [Jc 7c Kc] [2s]
3q7F5QtzC30pSrn0nl9i+A: bets $5
NqVlOSH2lp+pp/TK3vvK5g: calls $5
*** RIVER *** [Jc 7c Kc 2s] [Qd]
3q7F5QtzC30pSrn0nl9i+A: checks
NqVlOSH2lp+pp/TK3vvK5g: checks
*** SHOW DOWN ***
3q7F5QtzC30pSrn0nl9i+A: shows [Ad 5c] (high card Ace)
NqVlOSH2lp+pp/TK3vvK5g: shows [Qc Ah] (a pair of Queens)
NqVlOSH2lp+pp/TK3vvK5g collected $19.50 from pot
*** SUMMARY ***
Total pot $20.50 | Rake $1
Board [Jc 7c Kc 2s Qd]
Seat 1: xAU6q2/cwmby2sxmA8VcmA (button) folded on the Flop
Seat 3: G5ZSSN6RSON3gkNvk/SmYg (small blind) folded before Flop
Seat 4: 3q7F5QtzC30pSrn0nl9i+A (big blind) showed [Ad 5c] and lost with high card Ace
Seat 6: NqVlOSH2lp+pp/TK3vvK5g showed [Qc Ah] and won ($19.50) with a pair of Queens



PokerStars Game #59940655244:  Hold'em No Limit ($0.50/$1.00) - 2009/07/01 1:12:47 ET
Table 'mmbQQVBTrPdE+wy+s+9VPA' 6-max Seat #2 is the button
Seat 1: zyP4SPoWZnKUfTvIRLCVog ($62.55 in chips)
Seat 2: XK4Qsl+DA8gAJyg85/zBIw ($24.05 in chips)
Seat 3: wx3sQGkVi2x9wJXuWNHPBw ($110.15 in chips)
Seat 4: V3iZdcw61nXF3g5hD2RrsQ ($112.40 in chips)
Seat 5: YMJG+F++3Aj6P8dAWda5fw ($103.60 in chips)
Seat 6: U2CWBTv29qdCbj8RNF2sIw ($111.10 in chips)
wx3sQGkVi2x9wJXuWNHPBw: posts small blind $0.50
V3iZdcw61nXF3g5hD2RrsQ: posts big blind $1
*** HOLE CARDS ***
YMJG+F++3Aj6P8dAWda5fw: folds
U2CWBTv29qdCbj8RNF2sIw: folds
zyP4SPoWZnKUfTvIRLCVog: folds
XK4Qsl+DA8gAJyg85/zBIw: folds
wx3sQGkVi2x9wJXuWNHPBw: folds
V3iZdcw61nXF3g5hD2RrsQ collected $1 from pot
*** SUMMARY ***
Total pot $1 | Rake $0
Seat 1: zyP4SPoWZnKUfTvIRLCVog folded before Flop (didn't bet)
Seat 2: XK4Qsl+DA8gAJyg85/zBIw (button) folded before Flop (didn't bet)
Seat 3: wx3sQGkVi2x9wJXuWNHPBw (small blind) folded before Flop
Seat 4: V3iZdcw61nXF3g5hD2RrsQ (big blind) collected ($1)
Seat 5: YMJG+F++3Aj6P8dAWda5fw folded before Flop (didn't bet)
Seat 6: U2CWBTv29qdCbj8RNF2sIw folded before Flop (didn't bet)



PokerStars Game #59940655832:  Hold'em No Limit ($0.50/$1.00) - 2009/07/01 1:12:48 ET
Table 'VOs36P6NW+QyXeQ1B62kmA' 6-max Seat #4 is the button
Seat 1: Z2fXsGcjl+Eax+RzOgwOmg ($100 in chips)
Seat 2: 2UMlbaZ8n8AbRli0Yr0mDw ($31.35 in chips)
Seat 3: FyNUCpzHVyQu/qX8pqNQFA ($100 in chips)
Seat 4: w02zQzNydODiyV9THKgo9w ($45.60 in chips)
Seat 5: ozrlafxxh1HmYdA0/h+MuA ($43.75 in chips)
Seat 6: slVKuQyEz8Qj4E3uLPYNXg ($107.80 in chips)
ozrlafxxh1HmYdA0/h+MuA: posts small blind $0.50
slVKuQyEz8Qj4E3uLPYNXg: posts big blind $1
*** HOLE CARDS ***
Z2fXsGcjl+Eax+RzOgwOmg: folds
2UMlbaZ8n8AbRli0Yr0mDw: folds
FyNUCpzHVyQu/qX8pqNQFA: folds
w02zQzNydODiyV9THKgo9w: calls $1
ozrlafxxh1HmYdA0/h+MuA: calls $0.50
slVKuQyEz8Qj4E3uLPYNXg: raises $3 to $4
w02zQzNydODiyV9THKgo9w: calls $3
ozrlafxxh1HmYdA0/h+MuA: folds
*** FLOP *** [Kc 3c 6s]
slVKuQyEz8Qj4E3uLPYNXg: bets $6
w02zQzNydODiyV9THKgo9w: folds
slVKuQyEz8Qj4E3uLPYNXg collected $8.55 from pot
slVKuQyEz8Qj4E3uLPYNXg: doesn't show hand
*** SUMMARY ***
Total pot $9 | Rake $0.45
Board [Kc 3c 6s]
Seat 1: Z2fXsGcjl+Eax+RzOgwOmg folded before Flop (didn't bet)
Seat 2: 2UMlbaZ8n8AbRli0Yr0mDw folded before Flop (didn't bet)
Seat 3: FyNUCpzHVyQu/qX8pqNQFA folded before Flop (didn't bet)
Seat 4: w02zQzNydODiyV9THKgo9w (button) folded on the Flop
Seat 5: ozrlafxxh1HmYdA0/h+MuA (small blind) folded before Flop
Seat 6: slVKuQyEz8Qj4E3uLPYNXg (big blind) collected ($8.55)



PokerStars Game #59940656614:  Hold'em No Limit ($0.50/$1.00) - 2009/07/01 1:12:49 ET
Table '3T4owEKJKyGTMePwrv50FQ' 9-max Seat #9 is the button
Seat 1: OGgaARGdJQT4awWVNQ957w ($100.10 in chips)
Seat 2: t+Id2O6herCLgwnC4m49PA ($41.80 in chips)
Seat 3: DOLzOcBTZYcph5jEfKFWuQ ($105.50 in chips)
Seat 4: O5Go3jrzbQWxRB6ESK+Ptg ($30.10 in chips)
Seat 5: eI48VADSCFoNZBx4T9qs2w ($31.85 in chips)
Seat 6: laA8va+Yv8WuMqT1zdR91g ($101.50 in chips)
Seat 7: 1862487932 ($104.50 in chips)
Seat 8: ucTB8uAUcQnKGsA70OSjNA ($18.50 in chips)
Seat 9: 61sfw5QTu62YYIt68OsdrA ($63.45 in chips)
OGgaARGdJQT4awWVNQ957w: posts small blind $0.50
t+Id2O6herCLgwnC4m49PA: posts big blind $1
*** HOLE CARDS ***
DOLzOcBTZYcph5jEfKFWuQ: folds
O5Go3jrzbQWxRB6ESK+Ptg: folds
eI48VADSCFoNZBx4T9qs2w: folds
laA8va+Yv8WuMqT1zdR91g: raises $2 to $3
1862487932: calls $3
ucTB8uAUcQnKGsA70OSjNA: folds
61sfw5QTu62YYIt68OsdrA: folds
OGgaARGdJQT4awWVNQ957w: folds
t+Id2O6herCLgwnC4m49PA: folds
*** FLOP *** [4d 3s Qh]
laA8va+Yv8WuMqT1zdR91g: checks
1862487932: bets $5
laA8va+Yv8WuMqT1zdR91g: folds
1862487932 collected $7.15 from pot
1862487932: doesn't show hand
*** SUMMARY ***
Total pot $7.50 | Rake $0.35
Board [4d 3s Qh]
Seat 1: OGgaARGdJQT4awWVNQ957w (small blind) folded before Flop
Seat 2: t+Id2O6herCLgwnC4m49PA (big blind) folded before Flop
Seat 3: DOLzOcBTZYcph5jEfKFWuQ folded before Flop (didn't bet)
Seat 4: O5Go3jrzbQWxRB6ESK+Ptg folded before Flop (didn't bet)
Seat 5: eI48VADSCFoNZBx4T9qs2w folded before Flop (didn't bet)
Seat 6: laA8va+Yv8WuMqT1zdR91g folded on the Flop
Seat 7: 1862487932 collected ($7.15)
Seat 8: ucTB8uAUcQnKGsA70OSjNA folded before Flop (didn't bet)
Seat 9: 61sfw5QTu62YYIt68OsdrA (button) folded before Flop (didn't bet)



PokerStars Game #59940658456:  Hold'em No Limit ($0.50/$1.00) - 2009/07/01 1:12:52 ET
Table 'SQLOQoANiHscJ8AL7zffbw' 9-max Seat #6 is the button
Seat 1: jPTRd6SpCp4xqAy2XQiTOw ($66.90 in chips)
Seat 2: /zy+DB4S5fUQUSfZWFzYGw ($324.90 in chips)
Seat 3: 0eFnow7+D7veCYQ+CG9FFw ($103 in chips)
Seat 5: L9njYvloJ1NdXjP8edHEAg ($107.65 in chips)
Seat 6: H+DVy3Ei8L1UKS2tVOtJcw ($100 in chips)
Seat 7: bJckevFOcg//s0qyMQI6sQ ($103.55 in chips)
Seat 8: 2BV+oJIQYr65IO6nEChvbA ($60 in chips)
Seat 9: qJr25HAtvv1w/7IBvjMM3g ($200.15 in chips)
bJckevFOcg//s0qyMQI6sQ: posts small blind $0.50
2BV+oJIQYr65IO6nEChvbA: posts big blind $1
*** HOLE CARDS ***
qJr25HAtvv1w/7IBvjMM3g: folds
jPTRd6SpCp4xqAy2XQiTOw: folds
/zy+DB4S5fUQUSfZWFzYGw: folds
0eFnow7+D7veCYQ+CG9FFw: folds
L9njYvloJ1NdXjP8edHEAg: folds
H+DVy3Ei8L1UKS2tVOtJcw: raises $1 to $2
bJckevFOcg//s0qyMQI6sQ: folds
2BV+oJIQYr65IO6nEChvbA: folds
H+DVy3Ei8L1UKS2tVOtJcw collected $2.50 from pot
*** SUMMARY ***
Total pot $2.50 | Rake $0
Seat 1: jPTRd6SpCp4xqAy2XQiTOw folded before Flop (didn't bet)
Seat 2: /zy+DB4S5fUQUSfZWFzYGw folded before Flop (didn't bet)
Seat 3: 0eFnow7+D7veCYQ+CG9FFw folded before Flop (didn't bet)
Seat 5: L9njYvloJ1NdXjP8edHEAg folded before Flop (didn't bet)
Seat 6: H+DVy3Ei8L1UKS2tVOtJcw (button) collected ($2.50)
Seat 7: bJckevFOcg//s0qyMQI6sQ (small blind) folded before Flop
Seat 8: 2BV+oJIQYr65IO6nEChvbA (big blind) folded before Flop
Seat 9: qJr25HAtvv1w/7IBvjMM3g folded before Flop (didn't bet)



PokerStars Game #59940659298:  Hold'em No Limit ($0.50/$1.00) - 2009/07/01 1:12:54 ET
Table 'fTlPiCj0utgzC/5io+I7ew' 6-max Seat #6 is the button
Seat 1: YMJG+F++3Aj6P8dAWda5fw ($101.85 in chips)
Seat 3: Z2fXsGcjl+Eax+RzOgwOmg ($102.50 in chips)
Seat 4: uJVSceLggtsrJya+WtmUEA ($175.15 in chips)
Seat 5: XUk5GQsfNFpHvaToDZ0rZA ($48.50 in chips)
Seat 6: /P4w1pHg2zHYg/4ubJ0dPw ($78.60 in chips)
YMJG+F++3Aj6P8dAWda5fw: posts small blind $0.50
Z2fXsGcjl+Eax+RzOgwOmg: posts big blind $1
*** HOLE CARDS ***
uJVSceLggtsrJya+WtmUEA: folds
XUk5GQsfNFpHvaToDZ0rZA: raises $2 to $3
/P4w1pHg2zHYg/4ubJ0dPw: folds
YMJG+F++3Aj6P8dAWda5fw: folds
Z2fXsGcjl+Eax+RzOgwOmg: folds
XUk5GQsfNFpHvaToDZ0rZA collected $2.50 from pot
*** SUMMARY ***
Total pot $2.50 | Rake $0
Seat 1: YMJG+F++3Aj6P8dAWda5fw (small blind) folded before Flop
Seat 3: Z2fXsGcjl+Eax+RzOgwOmg (big blind) folded before Flop
Seat 4: uJVSceLggtsrJya+WtmUEA folded before Flop (didn't bet)
Seat 5: XUk5GQsfNFpHvaToDZ0rZA collected ($2.50)
Seat 6: /P4w1pHg2zHYg/4ubJ0dPw (button) folded before Flop (didn't bet)



PokerStars Game #59940659308:  Hold'em No Limit ($0.50/$1.00) - 2009/07/01 1:12:54 ET
Table '7Nl0ffnjeK44/vmeexh3MQ' 9-max Seat #2 is the button
Seat 1: V138SURkdX8LdVBPKdJJag ($100 in chips)
Seat 2: OGgaARGdJQT4awWVNQ957w ($102 in chips)
Seat 3: JMmUYT5pIKCKh2pGjCB/4w ($40.95 in chips)
Seat 4: bLbSOSmSOnqE0iTcH/5dxA ($104.15 in chips)
Seat 5: 61sfw5QTu62YYIt68OsdrA ($81.50 in chips)
Seat 6: FVs16t7GgfWgQWt4JxsObQ ($31.35 in chips)
Seat 7: 997ViqAtWn1FPjJqcffwcA ($100 in chips)
Seat 8: D+W9Me7w6Hcx/WRUSKV0dw ($18.25 in chips)
Seat 9: ouwUBGRKnKK9uhn1G4Lf+A ($194 in chips)
JMmUYT5pIKCKh2pGjCB/4w: posts small blind $0.50
bLbSOSmSOnqE0iTcH/5dxA: posts big blind $1
*** HOLE CARDS ***
61sfw5QTu62YYIt68OsdrA: folds
FVs16t7GgfWgQWt4JxsObQ: calls $1
997ViqAtWn1FPjJqcffwcA: calls $1
D+W9Me7w6Hcx/WRUSKV0dw: folds
ouwUBGRKnKK9uhn1G4Lf+A: folds
V138SURkdX8LdVBPKdJJag: folds
OGgaARGdJQT4awWVNQ957w: folds
JMmUYT5pIKCKh2pGjCB/4w: calls $0.50
bLbSOSmSOnqE0iTcH/5dxA: checks
*** FLOP *** [Ah 6c 2c]
JMmUYT5pIKCKh2pGjCB/4w: bets $3
bLbSOSmSOnqE0iTcH/5dxA: calls $3
FVs16t7GgfWgQWt4JxsObQ: folds
997ViqAtWn1FPjJqcffwcA: folds
*** TURN *** [Ah 6c 2c] [Js]
JMmUYT5pIKCKh2pGjCB/4w: bets $4
bLbSOSmSOnqE0iTcH/5dxA: calls $4
*** RIVER *** [Ah 6c 2c Js] [Ks]
JMmUYT5pIKCKh2pGjCB/4w: bets $6
bLbSOSmSOnqE0iTcH/5dxA: calls $6
*** SHOW DOWN ***
JMmUYT5pIKCKh2pGjCB/4w: shows [8d Ac] (a pair of Aces)
bLbSOSmSOnqE0iTcH/5dxA: mucks hand
JMmUYT5pIKCKh2pGjCB/4w collected $28.55 from pot
*** SUMMARY ***
Total pot $30 | Rake $1.45
Board [Ah 6c 2c Js Ks]
Seat 1: V138SURkdX8LdVBPKdJJag folded before Flop (didn't bet)
Seat 2: OGgaARGdJQT4awWVNQ957w (button) folded before Flop (didn't bet)
Seat 3: JMmUYT5pIKCKh2pGjCB/4w (small blind) showed [8d Ac] and won ($28.55) with a pair of Aces
Seat 4: bLbSOSmSOnqE0iTcH/5dxA (big blind) mucked
Seat 5: 61sfw5QTu62YYIt68OsdrA folded before Flop (didn't bet)
Seat 6: FVs16t7GgfWgQWt4JxsObQ folded on the Flop
Seat 7: 997ViqAtWn1FPjJqcffwcA folded on the Flop
Seat 8: D+W9Me7w6Hcx/WRUSKV0dw folded before Flop (didn't bet)
Seat 9: ouwUBGRKnKK9uhn1G4Lf+A folded before Flop (didn't bet)



PokerStars Game #59940659822:  Hold'em No Limit ($0.50/$1.00) - 2009/07/01 1:12:55 ET
Table '+cA8mcmhaedZ7YcrDdhmeQ' 6-max Seat #1 is the button
Seat 1: lsLuWlcPA3Rh7kJVLzMh0Q ($302.45 in chips)
Seat 2: RqgF7gRoKgRNW8Zoi1ty4A ($129.25 in chips)
Seat 3: DAIgyIWbYvAkL6PbAI27pg ($18.50 in chips)
Seat 4: 4OO5v3AVduL0tePNx8wk5A ($109.55 in chips)
Seat 5: +7hFKAL0b0O/n8G72TclJA ($136.75 in chips)
Seat 6: YfsTQsY/fxb+YqbdclTHuw ($17.60 in chips)
RqgF7gRoKgRNW8Zoi1ty4A: posts small blind $0.50
DAIgyIWbYvAkL6PbAI27pg: posts big blind $1
*** HOLE CARDS ***
4OO5v3AVduL0tePNx8wk5A: folds
+7hFKAL0b0O/n8G72TclJA: folds
YfsTQsY/fxb+YqbdclTHuw: folds
lsLuWlcPA3Rh7kJVLzMh0Q: raises $2 to $3
RqgF7gRoKgRNW8Zoi1ty4A: raises $9 to $12
DAIgyIWbYvAkL6PbAI27pg: folds
lsLuWlcPA3Rh7kJVLzMh0Q: raises $17 to $29
RqgF7gRoKgRNW8Zoi1ty4A: raises $100.25 to $129.25 and is all-in
lsLuWlcPA3Rh7kJVLzMh0Q: folds
RqgF7gRoKgRNW8Zoi1ty4A collected $59 from pot
*** SUMMARY ***
Total pot $59 | Rake $0
Seat 1: lsLuWlcPA3Rh7kJVLzMh0Q (button) folded before Flop
Seat 2: RqgF7gRoKgRNW8Zoi1ty4A (small blind) collected ($59)
Seat 3: DAIgyIWbYvAkL6PbAI27pg (big blind) folded before Flop
Seat 4: 4OO5v3AVduL0tePNx8wk5A folded before Flop (didn't bet)
Seat 5: +7hFKAL0b0O/n8G72TclJA folded before Flop (didn't bet)
Seat 6: YfsTQsY/fxb+YqbdclTHuw folded before Flop (didn't bet)



PokerStars Game #59940660782:  Hold'em No Limit ($0.50/$1.00) - 2009/07/01 1:12:56 ET
Table 'W/wyObTiXZm+Ckkl3YxcSw' 6-max Seat #4 is the button
Seat 1: eUBBn2R56C1IQ6Cs/vitwg ($180.25 in chips)
Seat 2: oDiBRCaF0QVtd3kO6xZIXw ($171.65 in chips)
Seat 3: dxyNCn/qxfkGDUIf28Cbng ($55.40 in chips)
Seat 4: aYii2DmxlOlbC1wbGRBWvQ ($112.75 in chips)
b2a+5TkFf4xJN/Ihhma58Q will be allowed to play after the button
eUBBn2R56C1IQ6Cs/vitwg: posts small blind $0.50
oDiBRCaF0QVtd3kO6xZIXw: posts big blind $1
*** HOLE CARDS ***
dxyNCn/qxfkGDUIf28Cbng: folds
aYii2DmxlOlbC1wbGRBWvQ: folds
MFptnnT6AnJakWBooTkmeg leaves the table
eUBBn2R56C1IQ6Cs/vitwg: raises $2 to $3
oDiBRCaF0QVtd3kO6xZIXw: folds
eUBBn2R56C1IQ6Cs/vitwg collected $2 from pot
*** SUMMARY ***
Total pot $2 | Rake $0
Seat 1: eUBBn2R56C1IQ6Cs/vitwg (small blind) collected ($2)
Seat 2: oDiBRCaF0QVtd3kO6xZIXw (big blind) folded before Flop
Seat 3: dxyNCn/qxfkGDUIf28Cbng folded before Flop (didn't bet)
Seat 4: aYii2DmxlOlbC1wbGRBWvQ (button) folded before Flop (didn't bet)



PokerStars Game #59940660400:  Hold'em No Limit ($0.50/$1.00) - 2009/07/01 1:12:56 ET
Table 'GxCPo/gd3OSthkYrAxJngg' 6-max Seat #4 is the button
Seat 1: sH8BpAFP+jGFxCgVpD1Lew ($266.90 in chips)
Seat 3: o6plE+MSW4XFNTeONe16xg ($29.65 in chips)
Seat 4: YMJG+F++3Aj6P8dAWda5fw ($196.75 in chips)
Seat 5: G5ZSSN6RSON3gkNvk/SmYg ($115.10 in chips)
Seat 6: 4d1rWhpu8DzLmzMbR3QKyA ($100 in chips)
G5ZSSN6RSON3gkNvk/SmYg: posts small blind $0.50
4d1rWhpu8DzLmzMbR3QKyA: posts big blind $1
*** HOLE CARDS ***
sH8BpAFP+jGFxCgVpD1Lew: folds
o6plE+MSW4XFNTeONe16xg: folds
YMJG+F++3Aj6P8dAWda5fw: folds
G5ZSSN6RSON3gkNvk/SmYg: raises $2 to $3
4d1rWhpu8DzLmzMbR3QKyA: folds
G5ZSSN6RSON3gkNvk/SmYg collected $2 from pot
G5ZSSN6RSON3gkNvk/SmYg: doesn't show hand
*** SUMMARY ***
Total pot $2 | Rake $0
Seat 1: sH8BpAFP+jGFxCgVpD1Lew folded before Flop (didn't bet)
Seat 3: o6plE+MSW4XFNTeONe16xg folded before Flop (didn't bet)
Seat 4: YMJG+F++3Aj6P8dAWda5fw (button) folded before Flop (didn't bet)
Seat 5: G5ZSSN6RSON3gkNvk/SmYg (small blind) collected ($2)
Seat 6: 4d1rWhpu8DzLmzMbR3QKyA (big blind) folded before Flop



PokerStars Game #59940661158:  Hold'em No Limit ($0.50/$1.00) - 2009/07/01 1:12:57 ET
Table 'QSIig7BLMc9wY/rgBechzw' 6-max Seat #2 is the button
Seat 1: Z2fXsGcjl+Eax+RzOgwOmg ($113.50 in chips)
Seat 2: mLOIkH/qmRa+mVujQIhBRg ($44.30 in chips)
Seat 3: +xW7QemQU0Fxs+4TnqBRow ($101.85 in chips)
Seat 4: +uSzP8Jwnw7sKfQ4s66b7w ($78.45 in chips)
Seat 5: lsLuWlcPA3Rh7kJVLzMh0Q ($102.35 in chips)
Seat 6: PxqfkAMdAWtkgbT+q2gciA ($31 in chips)
+xW7QemQU0Fxs+4TnqBRow: posts small blind $0.50
+uSzP8Jwnw7sKfQ4s66b7w: posts big blind $1
*** HOLE CARDS ***
lsLuWlcPA3Rh7kJVLzMh0Q: folds
PxqfkAMdAWtkgbT+q2gciA: raises $3 to $4
Z2fXsGcjl+Eax+RzOgwOmg: folds
mLOIkH/qmRa+mVujQIhBRg: folds
+xW7QemQU0Fxs+4TnqBRow: folds
+uSzP8Jwnw7sKfQ4s66b7w: folds
PxqfkAMdAWtkgbT+q2gciA collected $2.50 from pot
*** SUMMARY ***
Total pot $2.50 | Rake $0
Seat 1: Z2fXsGcjl+Eax+RzOgwOmg folded before Flop (didn't bet)
Seat 2: mLOIkH/qmRa+mVujQIhBRg (button) folded before Flop (didn't bet)
Seat 3: +xW7QemQU0Fxs+4TnqBRow (small blind) folded before Flop
Seat 4: +uSzP8Jwnw7sKfQ4s66b7w (big blind) folded before Flop
Seat 5: lsLuWlcPA3Rh7kJVLzMh0Q folded before Flop (didn't bet)
Seat 6: PxqfkAMdAWtkgbT+q2gciA collected ($2.50)



PokerStars Game #59940662356:  Hold'em No Limit ($0.50/$1.00) - 2009/07/01 1:12:59 ET
Table 'MUPc8FEpe/nR0BKSeReX6Q' 6-max Seat #5 is the button
Seat 1: qhkK6+yCciTRd+rCFEbnEQ ($41.70 in chips)
Seat 2: xAU6q2/cwmby2sxmA8VcmA ($114.70 in chips)
Seat 3: wx3sQGkVi2x9wJXuWNHPBw ($216 in chips)
Seat 4: ZA1bp6g8IwtTxkUE4eCjDQ ($193.90 in chips)
Seat 5: UBZQqpnJZdTYYY1FTb0rLA ($100 in chips)
Seat 6: oxnw0GLLpFanjhGkxfRSqA ($59.15 in chips)
oxnw0GLLpFanjhGkxfRSqA: posts small blind $0.50
qhkK6+yCciTRd+rCFEbnEQ: posts big blind $1
*** HOLE CARDS ***
xAU6q2/cwmby2sxmA8VcmA: folds
wx3sQGkVi2x9wJXuWNHPBw: folds
ZA1bp6g8IwtTxkUE4eCjDQ: folds
UBZQqpnJZdTYYY1FTb0rLA: folds
oxnw0GLLpFanjhGkxfRSqA: calls $0.50
qhkK6+yCciTRd+rCFEbnEQ: checks
*** FLOP *** [Qd 9h 2d]
oxnw0GLLpFanjhGkxfRSqA: checks
qhkK6+yCciTRd+rCFEbnEQ: checks
*** TURN *** [Qd 9h 2d] [Jc]
oxnw0GLLpFanjhGkxfRSqA: checks
qhkK6+yCciTRd+rCFEbnEQ: checks
*** RIVER *** [Qd 9h 2d Jc] [Th]
oxnw0GLLpFanjhGkxfRSqA: checks
qhkK6+yCciTRd+rCFEbnEQ: checks
*** SHOW DOWN ***
oxnw0GLLpFanjhGkxfRSqA: shows [4h 3c] (high card Queen)
qhkK6+yCciTRd+rCFEbnEQ: shows [2h Kd] (a straight, Nine to King)
qhkK6+yCciTRd+rCFEbnEQ collected $1.90 from pot
*** SUMMARY ***
Total pot $2 | Rake $0.10
Board [Qd 9h 2d Jc Th]
Seat 1: qhkK6+yCciTRd+rCFEbnEQ (big blind) showed [2h Kd] and won ($1.90) with a straight, Nine to King
Seat 2: xAU6q2/cwmby2sxmA8VcmA folded before Flop (didn't bet)
Seat 3: wx3sQGkVi2x9wJXuWNHPBw folded before Flop (didn't bet)
Seat 4: ZA1bp6g8IwtTxkUE4eCjDQ folded before Flop (didn't bet)
Seat 5: UBZQqpnJZdTYYY1FTb0rLA (button) folded before Flop (didn't bet)
Seat 6: oxnw0GLLpFanjhGkxfRSqA (small blind) showed [4h 3c] and lost with high card Queen



PokerStars Game #59940666068:  Hold'em No Limit ($0.50/$1.00) - 2009/07/01 1:13:05 ET
Table 'mmbQQVBTrPdE+wy+s+9VPA' 6-max Seat #3 is the button
Seat 1: zyP4SPoWZnKUfTvIRLCVog ($62.55 in chips)
Seat 2: XK4Qsl+DA8gAJyg85/zBIw ($24.05 in chips)
Seat 3: wx3sQGkVi2x9wJXuWNHPBw ($109.65 in chips)
Seat 4: V3iZdcw61nXF3g5hD2RrsQ ($112.90 in chips)
Seat 5: YMJG+F++3Aj6P8dAWda5fw ($103.60 in chips)
Seat 6: U2CWBTv29qdCbj8RNF2sIw ($111.10 in chips)
V3iZdcw61nXF3g5hD2RrsQ: posts small blind $0.50
YMJG+F++3Aj6P8dAWda5fw: posts big blind $1
*** HOLE CARDS ***
U2CWBTv29qdCbj8RNF2sIw: folds
zyP4SPoWZnKUfTvIRLCVog: folds
XK4Qsl+DA8gAJyg85/zBIw: calls $1
wx3sQGkVi2x9wJXuWNHPBw: folds
V3iZdcw61nXF3g5hD2RrsQ: raises $3 to $4
YMJG+F++3Aj6P8dAWda5fw: folds
XK4Qsl+DA8gAJyg85/zBIw: folds
V3iZdcw61nXF3g5hD2RrsQ collected $3 from pot
*** SUMMARY ***
Total pot $3 | Rake $0
Seat 1: zyP4SPoWZnKUfTvIRLCVog folded before Flop (didn't bet)
Seat 2: XK4Qsl+DA8gAJyg85/zBIw folded before Flop
Seat 3: wx3sQGkVi2x9wJXuWNHPBw (button) folded before Flop (didn't bet)
Seat 4: V3iZdcw61nXF3g5hD2RrsQ (small blind) collected ($3)
Seat 5: YMJG+F++3Aj6P8dAWda5fw (big blind) folded before Flop
Seat 6: U2CWBTv29qdCbj8RNF2sIw folded before Flop (didn't bet)



PokerStars Game #59940666292:  Hold'em No Limit ($0.50/$1.00) - 2009/07/01 1:13:06 ET
Table 'rmZfTK+oSebeUPJNbWhdAA' 6-max Seat #2 is the button
Seat 1: xAU6q2/cwmby2sxmA8VcmA ($147 in chips)
Seat 2: z7O9PO/WEcqRouIydFhS9Q ($134.45 in chips)
Seat 3: BCEV3COoKY607AzLWayfRA ($153.30 in chips)
Seat 4: 1/mIuXfgx1ZyVkodrmfQDw ($100 in chips)
Seat 5: 5lY8d6Cnm4HUkt/8FZSj4g ($49.95 in chips)
Seat 6: j7NIOHLZk7V2o9fOioO5ug ($132 in chips)
BCEV3COoKY607AzLWayfRA: posts small blind $0.50
1/mIuXfgx1ZyVkodrmfQDw: posts big blind $1
*** HOLE CARDS ***
5lY8d6Cnm4HUkt/8FZSj4g: calls $1
j7NIOHLZk7V2o9fOioO5ug: folds
xAU6q2/cwmby2sxmA8VcmA: folds
z7O9PO/WEcqRouIydFhS9Q: raises $2 to $3
BCEV3COoKY607AzLWayfRA: folds
1/mIuXfgx1ZyVkodrmfQDw: folds
5lY8d6Cnm4HUkt/8FZSj4g: calls $2
*** FLOP *** [2s Ad Ts]
5lY8d6Cnm4HUkt/8FZSj4g: checks
z7O9PO/WEcqRouIydFhS9Q: checks
*** TURN *** [2s Ad Ts] [Kc]
5lY8d6Cnm4HUkt/8FZSj4g: checks
z7O9PO/WEcqRouIydFhS9Q: checks
*** RIVER *** [2s Ad Ts Kc] [4h]
5lY8d6Cnm4HUkt/8FZSj4g: checks
z7O9PO/WEcqRouIydFhS9Q: checks
*** SHOW DOWN ***
5lY8d6Cnm4HUkt/8FZSj4g: shows [5d 6d] (high card Ace)
z7O9PO/WEcqRouIydFhS9Q: shows [Kh Js] (a pair of Kings)
z7O9PO/WEcqRouIydFhS9Q collected $7.15 from pot
*** SUMMARY ***
Total pot $7.50 | Rake $0.35
Board [2s Ad Ts Kc 4h]
Seat 1: xAU6q2/cwmby2sxmA8VcmA folded before Flop (didn't bet)
Seat 2: z7O9PO/WEcqRouIydFhS9Q (button) showed [Kh Js] and won ($7.15) with a pair of Kings
Seat 3: BCEV3COoKY607AzLWayfRA (small blind) folded before Flop
Seat 4: 1/mIuXfgx1ZyVkodrmfQDw (big blind) folded before Flop
Seat 5: 5lY8d6Cnm4HUkt/8FZSj4g showed [5d 6d] and lost with high card Ace
Seat 6: j7NIOHLZk7V2o9fOioO5ug folded before Flop (didn't bet)



PokerStars Game #59940666692:  Hold'em No Limit ($0.50/$1.00) - 2009/07/01 1:13:06 ET
Table 'JTT1XWaDZHSaMZQK7cR5uw' 2-max Seat #2 is the button
Seat 1: OLplZF6FEnLflv81Hz+Fxg ($150.45 in chips)
Seat 2: mgi+mjKb1Sc3CCs7TlfoCw ($100 in chips)
mgi+mjKb1Sc3CCs7TlfoCw: posts small blind $0.50
OLplZF6FEnLflv81Hz+Fxg: posts big blind $1
*** HOLE CARDS ***
mgi+mjKb1Sc3CCs7TlfoCw: raises $2 to $3
OLplZF6FEnLflv81Hz+Fxg: calls $2
*** FLOP *** [4d Qs 6s]
OLplZF6FEnLflv81Hz+Fxg: checks
mgi+mjKb1Sc3CCs7TlfoCw: bets $7
OLplZF6FEnLflv81Hz+Fxg: folds
mgi+mjKb1Sc3CCs7TlfoCw collected $5.70 from pot
mgi+mjKb1Sc3CCs7TlfoCw: doesn't show hand
*** SUMMARY ***
Total pot $6 | Rake $0.30
Board [4d Qs 6s]
Seat 1: OLplZF6FEnLflv81Hz+Fxg (big blind) folded on the Flop
Seat 2: mgi+mjKb1Sc3CCs7TlfoCw (button) (small blind) collected ($5.70)



PokerStars Game #59940668126:  Hold'em No Limit ($0.50/$1.00) - 2009/07/01 1:13:09 ET
Table 'tJq9SfN1ywY0r03VBlWlwQ' 9-max Seat #8 is the button
Seat 1: wZsU+w9r7G66x93UuvBf1Q ($335.30 in chips)
Seat 3: FVs16t7GgfWgQWt4JxsObQ ($13.10 in chips)
Seat 4: bLbSOSmSOnqE0iTcH/5dxA ($110.70 in chips)
Seat 5: h5ipsNTMyolp7xn/NAvWkA ($97 in chips)
Seat 6: gUUvmqdVlmvpal6B8nYrmg ($116.20 in chips)
Seat 8: G4DEhsZFmznGNVpy2SEocA ($28.40 in chips)
Seat 9: XE5QF1y74bpHog9JxWJMWQ ($100 in chips)
XE5QF1y74bpHog9JxWJMWQ: posts small blind $0.50
wZsU+w9r7G66x93UuvBf1Q: posts big blind $1
Pp/KTcXkfZKKUHkjyaLTdg: sits out
*** HOLE CARDS ***
FVs16t7GgfWgQWt4JxsObQ: folds
bLbSOSmSOnqE0iTcH/5dxA: folds
h5ipsNTMyolp7xn/NAvWkA: calls $1
gUUvmqdVlmvpal6B8nYrmg: raises $1 to $2
G4DEhsZFmznGNVpy2SEocA: folds
XE5QF1y74bpHog9JxWJMWQ: folds
wZsU+w9r7G66x93UuvBf1Q: folds
h5ipsNTMyolp7xn/NAvWkA: calls $1
*** FLOP *** [6s 5c Ac]
h5ipsNTMyolp7xn/NAvWkA: bets $2
gUUvmqdVlmvpal6B8nYrmg: folds
h5ipsNTMyolp7xn/NAvWkA collected $5.25 from pot
*** SUMMARY ***
Total pot $5.50 | Rake $0.25
Board [6s 5c Ac]
Seat 1: wZsU+w9r7G66x93UuvBf1Q (big blind) folded before Flop
Seat 3: FVs16t7GgfWgQWt4JxsObQ folded before Flop (didn't bet)
Seat 4: bLbSOSmSOnqE0iTcH/5dxA folded before Flop (didn't bet)
Seat 5: h5ipsNTMyolp7xn/NAvWkA collected ($5.25)
Seat 6: gUUvmqdVlmvpal6B8nYrmg folded on the Flop
Seat 8: G4DEhsZFmznGNVpy2SEocA (button) folded before Flop (didn't bet)
Seat 9: XE5QF1y74bpHog9JxWJMWQ (small blind) folded before Flop



PokerStars Game #59940669946:  Hold'em No Limit ($0.50/$1.00) - 2009/07/01 1:13:12 ET
Table 'W/wyObTiXZm+Ckkl3YxcSw' 6-max Seat #1 is the button
Seat 1: eUBBn2R56C1IQ6Cs/vitwg ($181.25 in chips)
Seat 2: oDiBRCaF0QVtd3kO6xZIXw ($170.65 in chips)
Seat 3: dxyNCn/qxfkGDUIf28Cbng ($55.40 in chips)
Seat 4: aYii2DmxlOlbC1wbGRBWvQ ($112.75 in chips)
oDiBRCaF0QVtd3kO6xZIXw: posts small blind $0.50
dxyNCn/qxfkGDUIf28Cbng: posts big blind $1
b2a+5TkFf4xJN/Ihhma58Q: sits out
*** HOLE CARDS ***
aYii2DmxlOlbC1wbGRBWvQ: folds
eUBBn2R56C1IQ6Cs/vitwg: folds
oDiBRCaF0QVtd3kO6xZIXw: calls $0.50
dxyNCn/qxfkGDUIf28Cbng: checks
*** FLOP *** [Kd 6d 2d]
oDiBRCaF0QVtd3kO6xZIXw: checks
dxyNCn/qxfkGDUIf28Cbng: bets $2
oDiBRCaF0QVtd3kO6xZIXw: folds
dxyNCn/qxfkGDUIf28Cbng collected $1.90 from pot
dxyNCn/qxfkGDUIf28Cbng: doesn't show hand
*** SUMMARY ***
Total pot $2 | Rake $0.10
Board [Kd 6d 2d]
Seat 1: eUBBn2R56C1IQ6Cs/vitwg (button) folded before Flop (didn't bet)
Seat 2: oDiBRCaF0QVtd3kO6xZIXw (small blind) folded on the Flop
Seat 3: dxyNCn/qxfkGDUIf28Cbng (big blind) collected ($1.90)
Seat 4: aYii2DmxlOlbC1wbGRBWvQ folded before Flop (didn't bet)



PokerStars Game #59940670680:  Hold'em No Limit ($0.50/$1.00) - 2009/07/01 1:13:13 ET
Table 'QSIig7BLMc9wY/rgBechzw' 6-max Seat #3 is the button
Seat 1: Z2fXsGcjl+Eax+RzOgwOmg ($113.50 in chips)
Seat 2: mLOIkH/qmRa+mVujQIhBRg ($44.30 in chips)
Seat 3: +xW7QemQU0Fxs+4TnqBRow ($101.35 in chips)
Seat 4: +uSzP8Jwnw7sKfQ4s66b7w ($77.45 in chips)
Seat 5: lsLuWlcPA3Rh7kJVLzMh0Q ($102.35 in chips)
Seat 6: PxqfkAMdAWtkgbT+q2gciA ($32.50 in chips)
+uSzP8Jwnw7sKfQ4s66b7w: posts small blind $0.50
lsLuWlcPA3Rh7kJVLzMh0Q: posts big blind $1
*** HOLE CARDS ***
PxqfkAMdAWtkgbT+q2gciA: folds
Z2fXsGcjl+Eax+RzOgwOmg: folds
mLOIkH/qmRa+mVujQIhBRg: raises $2 to $3
+xW7QemQU0Fxs+4TnqBRow: folds
+uSzP8Jwnw7sKfQ4s66b7w: folds
lsLuWlcPA3Rh7kJVLzMh0Q: raises $6 to $9
mLOIkH/qmRa+mVujQIhBRg: calls $6
*** FLOP *** [5c 6d 7c]
lsLuWlcPA3Rh7kJVLzMh0Q: bets $16
mLOIkH/qmRa+mVujQIhBRg: folds
lsLuWlcPA3Rh7kJVLzMh0Q collected $17.60 from pot
lsLuWlcPA3Rh7kJVLzMh0Q: doesn't show hand
*** SUMMARY ***
Total pot $18.50 | Rake $0.90
Board [5c 6d 7c]
Seat 1: Z2fXsGcjl+Eax+RzOgwOmg folded before Flop (didn't bet)
Seat 2: mLOIkH/qmRa+mVujQIhBRg folded on the Flop
Seat 3: +xW7QemQU0Fxs+4TnqBRow (button) folded before Flop (didn't bet)
Seat 4: +uSzP8Jwnw7sKfQ4s66b7w (small blind) folded before Flop
Seat 5: lsLuWlcPA3Rh7kJVLzMh0Q (big blind) collected ($17.60)
Seat 6: PxqfkAMdAWtkgbT+q2gciA folded before Flop (didn't bet)



PokerStars Game #59940672096:  Hold'em No Limit ($0.50/$1.00) - 2009/07/01 1:13:16 ET
Table '7O9fB8yx1u7sJveJn8w6jA' 6-max Seat #5 is the button
Seat 1: jy52+7FotjH63o5tEEVgKw ($84.85 in chips)
Seat 2: wx3sQGkVi2x9wJXuWNHPBw ($186.45 in chips)
Seat 3: hpxXcmRkXXI9HE5+5/j/0Q ($102.70 in chips)
Seat 4: b2a+5TkFf4xJN/Ihhma58Q ($41.30 in chips)
Seat 5: BCEV3COoKY607AzLWayfRA ($101.85 in chips)
Seat 6: p1Ga2i1TuXUvRn+Rf/0FMw ($125.25 in chips)
p1Ga2i1TuXUvRn+Rf/0FMw: posts small blind $0.50
jy52+7FotjH63o5tEEVgKw: posts big blind $1
*** HOLE CARDS ***
wx3sQGkVi2x9wJXuWNHPBw: folds
hpxXcmRkXXI9HE5+5/j/0Q: raises $3 to $4
b2a+5TkFf4xJN/Ihhma58Q: folds
BCEV3COoKY607AzLWayfRA: folds
p1Ga2i1TuXUvRn+Rf/0FMw: folds
jy52+7FotjH63o5tEEVgKw: calls $3
*** FLOP *** [9h 8c 2c]
jy52+7FotjH63o5tEEVgKw: checks
hpxXcmRkXXI9HE5+5/j/0Q: bets $6
jy52+7FotjH63o5tEEVgKw: calls $6
*** TURN *** [9h 8c 2c] [6h]
jy52+7FotjH63o5tEEVgKw: checks
hpxXcmRkXXI9HE5+5/j/0Q: bets $15
jy52+7FotjH63o5tEEVgKw: calls $15
*** RIVER *** [9h 8c 2c 6h] [4c]
jy52+7FotjH63o5tEEVgKw: checks
hpxXcmRkXXI9HE5+5/j/0Q: checks
*** SHOW DOWN ***
jy52+7FotjH63o5tEEVgKw: shows [Kh 8h] (a pair of Eights)
hpxXcmRkXXI9HE5+5/j/0Q: shows [Jh Jc] (a pair of Jacks)
hpxXcmRkXXI9HE5+5/j/0Q collected $48.05 from pot
*** SUMMARY ***
Total pot $50.50 | Rake $2.45
Board [9h 8c 2c 6h 4c]
Seat 1: jy52+7FotjH63o5tEEVgKw (big blind) showed [Kh 8h] and lost with a pair of Eights
Seat 2: wx3sQGkVi2x9wJXuWNHPBw folded before Flop (didn't bet)
Seat 3: hpxXcmRkXXI9HE5+5/j/0Q showed [Jh Jc] and won ($48.05) with a pair of Jacks
Seat 4: b2a+5TkFf4xJN/Ihhma58Q folded before Flop (didn't bet)
Seat 5: BCEV3COoKY607AzLWayfRA (button) folded before Flop (didn't bet)
Seat 6: p1Ga2i1TuXUvRn+Rf/0FMw (small blind) folded before Flop



PokerStars Game #59940671858:  Hold'em No Limit ($0.50/$1.00) - 2009/07/01 1:13:16 ET
Table 'VOs36P6NW+QyXeQ1B62kmA' 6-max Seat #5 is the button
Seat 1: Z2fXsGcjl+Eax+RzOgwOmg ($100 in chips)
Seat 2: 2UMlbaZ8n8AbRli0Yr0mDw ($31.35 in chips)
Seat 3: FyNUCpzHVyQu/qX8pqNQFA ($100 in chips)
Seat 4: w02zQzNydODiyV9THKgo9w ($41.60 in chips)
Seat 5: ozrlafxxh1HmYdA0/h+MuA ($42.75 in chips)
Seat 6: slVKuQyEz8Qj4E3uLPYNXg ($112.35 in chips)
slVKuQyEz8Qj4E3uLPYNXg: posts small blind $0.50
Z2fXsGcjl+Eax+RzOgwOmg: posts big blind $1
*** HOLE CARDS ***
2UMlbaZ8n8AbRli0Yr0mDw: raises $1 to $2
FyNUCpzHVyQu/qX8pqNQFA: raises $5 to $7
w02zQzNydODiyV9THKgo9w: folds
ozrlafxxh1HmYdA0/h+MuA: folds
slVKuQyEz8Qj4E3uLPYNXg: folds
Z2fXsGcjl+Eax+RzOgwOmg: folds
2UMlbaZ8n8AbRli0Yr0mDw: calls $5
*** FLOP *** [Jh Qc Jc]
2UMlbaZ8n8AbRli0Yr0mDw: checks
FyNUCpzHVyQu/qX8pqNQFA: bets $4
2UMlbaZ8n8AbRli0Yr0mDw: folds
FyNUCpzHVyQu/qX8pqNQFA collected $14.75 from pot
FyNUCpzHVyQu/qX8pqNQFA: doesn't show hand
*** SUMMARY ***
Total pot $15.50 | Rake $0.75
Board [Jh Qc Jc]
Seat 1: Z2fXsGcjl+Eax+RzOgwOmg (big blind) folded before Flop
Seat 2: 2UMlbaZ8n8AbRli0Yr0mDw folded on the Flop
Seat 3: FyNUCpzHVyQu/qX8pqNQFA collected ($14.75)
Seat 4: w02zQzNydODiyV9THKgo9w folded before Flop (didn't bet)
Seat 5: ozrlafxxh1HmYdA0/h+MuA (button) folded before Flop (didn't bet)
Seat 6: slVKuQyEz8Qj4E3uLPYNXg (small blind) folded before Flop



PokerStars Game #59940672042:  Hold'em No Limit ($0.50/$1.00) - 2009/07/01 1:13:16 ET
Table 'pHrhryH8jPNdQfY62f8v+g' 6-max Seat #5 is the button
Seat 1: 4d1rWhpu8DzLmzMbR3QKyA ($108.20 in chips)
Seat 3: 8oS5O7iD/qnFXFXJrGIgNQ ($100 in chips)
Seat 4: 1f3beyIML24UqEMTbWy93g ($58.15 in chips)
Seat 5: r1/R7y0Ortgoz4lccgW8VA ($33.05 in chips)
Seat 6: xAU6q2/cwmby2sxmA8VcmA ($207.10 in chips)
xAU6q2/cwmby2sxmA8VcmA: posts small blind $0.50
4d1rWhpu8DzLmzMbR3QKyA: posts big blind $1
JwCcjZl0bjJzG7hmE0dnTA: sits out
*** HOLE CARDS ***
8oS5O7iD/qnFXFXJrGIgNQ: folds
1f3beyIML24UqEMTbWy93g: raises $2 to $3
r1/R7y0Ortgoz4lccgW8VA: calls $3
xAU6q2/cwmby2sxmA8VcmA: folds
4d1rWhpu8DzLmzMbR3QKyA: folds
*** FLOP *** [Ad 6h Qs]
1f3beyIML24UqEMTbWy93g: checks
r1/R7y0Ortgoz4lccgW8VA: bets $3
1f3beyIML24UqEMTbWy93g: folds
r1/R7y0Ortgoz4lccgW8VA collected $7.15 from pot
*** SUMMARY ***
Total pot $7.50 | Rake $0.35
Board [Ad 6h Qs]
Seat 1: 4d1rWhpu8DzLmzMbR3QKyA (big blind) folded before Flop
Seat 3: 8oS5O7iD/qnFXFXJrGIgNQ folded before Flop (didn't bet)
Seat 4: 1f3beyIML24UqEMTbWy93g folded on the Flop
Seat 5: r1/R7y0Ortgoz4lccgW8VA (button) collected ($7.15)
Seat 6: xAU6q2/cwmby2sxmA8VcmA (small blind) folded before Flop



PokerStars Game #59940672188:  Hold'em No Limit ($0.50/$1.00) - 2009/07/01 1:13:16 ET
Table 'fZjVbKj9D8yOB+Rj7NaP/A' 9-max Seat #5 is the button
Seat 1: Oh57946S8OPACStkrhQm7g ($125 in chips)
Seat 2: PTAFYDIUSsG+SArbxNl+Aw ($107 in chips)
Seat 3: yAbu2QsRPVcjPbqlf/jDxw ($102.50 in chips)
Seat 4: 997ViqAtWn1FPjJqcffwcA ($103 in chips)
Seat 5: PkGfq5xrSlNsujKaG/HF4Q ($100 in chips)
Seat 6: OvwYHV65yUbgdBjSmo1+5g ($41.90 in chips)
Seat 7: SyS20PAm3RpT6uLBsGkwOA ($114.75 in chips)
Seat 9: qheQay5YvP2DMAb3OUSxtw ($99 in chips)
OvwYHV65yUbgdBjSmo1+5g: posts small blind $0.50
SyS20PAm3RpT6uLBsGkwOA: posts big blind $1
zDOE5r14tWqCf6xhuSHK6g: sits out
*** HOLE CARDS ***
qheQay5YvP2DMAb3OUSxtw: folds
Oh57946S8OPACStkrhQm7g: raises $2 to $3
PTAFYDIUSsG+SArbxNl+Aw: folds
yAbu2QsRPVcjPbqlf/jDxw: folds
997ViqAtWn1FPjJqcffwcA: folds
PkGfq5xrSlNsujKaG/HF4Q: folds
OvwYHV65yUbgdBjSmo1+5g: calls $2.50
SyS20PAm3RpT6uLBsGkwOA: folds
*** FLOP *** [3c 9c Qd]
OvwYHV65yUbgdBjSmo1+5g: bets $3
Oh57946S8OPACStkrhQm7g: raises $7 to $10
OvwYHV65yUbgdBjSmo1+5g: folds
Oh57946S8OPACStkrhQm7g collected $12.40 from pot
*** SUMMARY ***
Total pot $13 | Rake $0.60
Board [3c 9c Qd]
Seat 1: Oh57946S8OPACStkrhQm7g collected ($12.40)
Seat 2: PTAFYDIUSsG+SArbxNl+Aw folded before Flop (didn't bet)
Seat 3: yAbu2QsRPVcjPbqlf/jDxw folded before Flop (didn't bet)
Seat 4: 997ViqAtWn1FPjJqcffwcA folded before Flop (didn't bet)
Seat 5: PkGfq5xrSlNsujKaG/HF4Q (button) folded before Flop (didn't bet)
Seat 6: OvwYHV65yUbgdBjSmo1+5g (small blind) folded on the Flop
Seat 7: SyS20PAm3RpT6uLBsGkwOA (big blind) folded before Flop
Seat 9: qheQay5YvP2DMAb3OUSxtw folded before Flop (didn't bet)



PokerStars Game #59940676468:  Hold'em No Limit ($0.50/$1.00) - 2009/07/01 1:13:23 ET
Table 'SQLOQoANiHscJ8AL7zffbw' 9-max Seat #7 is the button
Seat 1: jPTRd6SpCp4xqAy2XQiTOw ($66.90 in chips)
Seat 2: /zy+DB4S5fUQUSfZWFzYGw ($324.90 in chips)
Seat 3: 0eFnow7+D7veCYQ+CG9FFw ($103 in chips)
Seat 5: L9njYvloJ1NdXjP8edHEAg ($107.65 in chips)
Seat 6: H+DVy3Ei8L1UKS2tVOtJcw ($101.50 in chips)
Seat 7: bJckevFOcg//s0qyMQI6sQ ($103.05 in chips)
Seat 8: 2BV+oJIQYr65IO6nEChvbA ($60 in chips)
Seat 9: qJr25HAtvv1w/7IBvjMM3g ($200.15 in chips)
2BV+oJIQYr65IO6nEChvbA: posts small blind $0.50
qJr25HAtvv1w/7IBvjMM3g: posts big blind $1
*** HOLE CARDS ***
jPTRd6SpCp4xqAy2XQiTOw: folds
/zy+DB4S5fUQUSfZWFzYGw: raises $2 to $3
0eFnow7+D7veCYQ+CG9FFw: folds
L9njYvloJ1NdXjP8edHEAg: folds
H+DVy3Ei8L1UKS2tVOtJcw: calls $3
bJckevFOcg//s0qyMQI6sQ: folds
2BV+oJIQYr65IO6nEChvbA: folds
qJr25HAtvv1w/7IBvjMM3g: folds
*** FLOP *** [Td Js 8c]
/zy+DB4S5fUQUSfZWFzYGw: checks
H+DVy3Ei8L1UKS2tVOtJcw: checks
*** TURN *** [Td Js 8c] [Ah]
/zy+DB4S5fUQUSfZWFzYGw: bets $3
H+DVy3Ei8L1UKS2tVOtJcw: folds
/zy+DB4S5fUQUSfZWFzYGw collected $7.15 from pot
*** SUMMARY ***
Total pot $7.50 | Rake $0.35
Board [Td Js 8c Ah]
Seat 1: jPTRd6SpCp4xqAy2XQiTOw folded before Flop (didn't bet)
Seat 2: /zy+DB4S5fUQUSfZWFzYGw collected ($7.15)
Seat 3: 0eFnow7+D7veCYQ+CG9FFw folded before Flop (didn't bet)
Seat 5: L9njYvloJ1NdXjP8edHEAg folded before Flop (didn't bet)
Seat 6: H+DVy3Ei8L1UKS2tVOtJcw folded on the Turn
Seat 7: bJckevFOcg//s0qyMQI6sQ (button) folded before Flop (didn't bet)
Seat 8: 2BV+oJIQYr65IO6nEChvbA (small blind) folded before Flop
Seat 9: qJr25HAtvv1w/7IBvjMM3g (big blind) folded before Flop



PokerStars Game #59940676142:  Hold'em No Limit ($0.50/$1.00) - 2009/07/01 1:13:23 ET
Table 'O96CPOtvMBWP6kzuYDfdFA' 6-max Seat #1 is the button
Seat 1: 6alLXQIITA2EZ/lBeym8Dw ($117.55 in chips)
Seat 2: 4d1rWhpu8DzLmzMbR3QKyA ($111.85 in chips)
Seat 3: V89DGjxE171oPREEbAXiyg ($90.60 in chips)
Seat 4: /P4w1pHg2zHYg/4ubJ0dPw ($63.55 in chips)
Seat 5: G5ZSSN6RSON3gkNvk/SmYg ($100 in chips)
Seat 6: GYei5jXGWexiJYbAT2fELg ($34.25 in chips)
4d1rWhpu8DzLmzMbR3QKyA: posts small blind $0.50
V89DGjxE171oPREEbAXiyg: posts big blind $1
*** HOLE CARDS ***
/P4w1pHg2zHYg/4ubJ0dPw: folds
G5ZSSN6RSON3gkNvk/SmYg: folds
GYei5jXGWexiJYbAT2fELg: raises $3 to $4
6alLXQIITA2EZ/lBeym8Dw: folds
4d1rWhpu8DzLmzMbR3QKyA: folds
V89DGjxE171oPREEbAXiyg: folds
GYei5jXGWexiJYbAT2fELg collected $2.50 from pot
*** SUMMARY ***
Total pot $2.50 | Rake $0
Seat 1: 6alLXQIITA2EZ/lBeym8Dw (button) folded before Flop (didn't bet)
Seat 2: 4d1rWhpu8DzLmzMbR3QKyA (small blind) folded before Flop
Seat 3: V89DGjxE171oPREEbAXiyg (big blind) folded before Flop
Seat 4: /P4w1pHg2zHYg/4ubJ0dPw folded before Flop (didn't bet)
Seat 5: G5ZSSN6RSON3gkNvk/SmYg folded before Flop (didn't bet)
Seat 6: GYei5jXGWexiJYbAT2fELg collected ($2.50)



PokerStars Game #59940677398:  Hold'em No Limit ($0.50/$1.00) - 2009/07/01 1:13:25 ET
Table 'tyUh+jyNvrceIQdKMJjQ2wZFWj23PMihdwrNWv41OG/Qeat #5 is the button
Seat 1: o8A5MUdudVKu+pAwgZOX2w ($113.25 in chips)
Seat 2: 5uy3EN+iIYkgwbWZFTUBAQ ($105.50 in chips)
Seat 3: TalCiLYHCd+ffkmR3auPvA ($137.80 in chips)
Seat 4: hpxXcmRkXXI9HE5+5/j/0Q ($100 in chips)
Seat 5: j7NIOHLZk7V2o9fOioO5ug ($106.70 in chips)
Seat 6: 4OO5v3AVduL0tePNx8wk5A ($100 in chips)
4OO5v3AVduL0tePNx8wk5A: posts small blind $0.50
o8A5MUdudVKu+pAwgZOX2w: posts big blind $1
*** HOLE CARDS ***
5uy3EN+iIYkgwbWZFTUBAQ: raises $2.50 to $3.50
TalCiLYHCd+ffkmR3auPvA: folds
hpxXcmRkXXI9HE5+5/j/0Q: folds
j7NIOHLZk7V2o9fOioO5ug: folds
4OO5v3AVduL0tePNx8wk5A: folds
o8A5MUdudVKu+pAwgZOX2w: calls $2.50
*** FLOP *** [Js 6h Jc]
o8A5MUdudVKu+pAwgZOX2w: checks
5uy3EN+iIYkgwbWZFTUBAQ: bets $5.70
o8A5MUdudVKu+pAwgZOX2w: folds
5uy3EN+iIYkgwbWZFTUBAQ collected $7.15 from pot
5uy3EN+iIYkgwbWZFTUBAQ: doesn't show hand
*** SUMMARY ***
Total pot $7.50 | Rake $0.35
Board [Js 6h Jc]
Seat 1: o8A5MUdudVKu+pAwgZOX2w (big blind) folded on the Flop
Seat 2: 5uy3EN+iIYkgwbWZFTUBAQ collected ($7.15)
Seat 3: TalCiLYHCd+ffkmR3auPvA folded before Flop (didn't bet)
Seat 4: hpxXcmRkXXI9HE5+5/j/0Q folded before Flop (didn't bet)
Seat 5: j7NIOHLZk7V2o9fOioO5ug (button) folded before Flop (didn't bet)
Seat 6: 4OO5v3AVduL0tePNx8wk5A (small blind) folded before Flop



PokerStars Game #59940678726:  Hold'em No Limit ($0.50/$1.00) - 2009/07/01 1:13:27 ET
Table 'GPp0HyAuggN8oE0sUWzPpA' 9-max Seat #3 is the button
Seat 1: qJr25HAtvv1w/7IBvjMM3g ($43.20 in chips)
Seat 2: m3U8I35Pn3gxKhoS2nmYIg ($13.40 in chips)
Seat 3: CCCXsirC+bO7ginAuUUVlQ ($59.25 in chips)
Seat 4: mBRWbnUl8diyBO1qTJaNzw ($102.65 in chips)
Seat 5: bLbSOSmSOnqE0iTcH/5dxA ($100 in chips)
Seat 6: BK/GtNPkSx0TdUDj82id5A ($33.05 in chips)
Seat 7: DHdbHyysD15wCAtx+BhUjA ($93.50 in chips)
Seat 9: dzoSjPZmtjGuK83119030A ($34.15 in chips)
mBRWbnUl8diyBO1qTJaNzw: posts small blind $0.50
bLbSOSmSOnqE0iTcH/5dxA: posts big blind $1
P/6qLjycEfxRgZ5F/W90dw: sits out
*** HOLE CARDS ***
BK/GtNPkSx0TdUDj82id5A: calls $1
DHdbHyysD15wCAtx+BhUjA: folds
dzoSjPZmtjGuK83119030A: folds
qJr25HAtvv1w/7IBvjMM3g: calls $1
m3U8I35Pn3gxKhoS2nmYIg: folds
CCCXsirC+bO7ginAuUUVlQ: folds
mBRWbnUl8diyBO1qTJaNzw: calls $0.50
bLbSOSmSOnqE0iTcH/5dxA: checks
*** FLOP *** [5d 5h 9d]
mBRWbnUl8diyBO1qTJaNzw: checks
bLbSOSmSOnqE0iTcH/5dxA: checks
BK/GtNPkSx0TdUDj82id5A: checks
qJr25HAtvv1w/7IBvjMM3g: bets $2
mBRWbnUl8diyBO1qTJaNzw: folds
bLbSOSmSOnqE0iTcH/5dxA: folds
BK/GtNPkSx0TdUDj82id5A: calls $2
*** TURN *** [5d 5h 9d] [4s]
BK/GtNPkSx0TdUDj82id5A: checks
qJr25HAtvv1w/7IBvjMM3g: checks
*** RIVER *** [5d 5h 9d 4s] [4h]
BK/GtNPkSx0TdUDj82id5A: bets $5
qJr25HAtvv1w/7IBvjMM3g: folds
BK/GtNPkSx0TdUDj82id5A collected $7.65 from pot
*** SUMMARY ***
Total pot $8 | Rake $0.35
Board [5d 5h 9d 4s 4h]
Seat 1: qJr25HAtvv1w/7IBvjMM3g folded on the River
Seat 2: m3U8I35Pn3gxKhoS2nmYIg folded before Flop (didn't bet)
Seat 3: CCCXsirC+bO7ginAuUUVlQ (button) folded before Flop (didn't bet)
Seat 4: mBRWbnUl8diyBO1qTJaNzw (small blind) folded on the Flop
Seat 5: bLbSOSmSOnqE0iTcH/5dxA (big blind) folded on the Flop
Seat 6: BK/GtNPkSx0TdUDj82id5A collected ($7.65)
Seat 7: DHdbHyysD15wCAtx+BhUjA folded before Flop (didn't bet)
Seat 9: dzoSjPZmtjGuK83119030A folded before Flop (didn't bet)



PokerStars Game #59940680342:  Hold'em No Limit ($0.50/$1.00) - 2009/07/01 1:13:30 ET
Table 'cKH9c4x6u79IqCdaKKvXrw' 9-max Seat #2 is the button
Seat 1: Pp/KTcXkfZKKUHkjyaLTdg ($18.50 in chips)
Seat 2: 8S3JMH4TY3whgIlZmMv66w ($59.55 in chips)
Seat 3: 997ViqAtWn1FPjJqcffwcA ($154.60 in chips)
Seat 4: FL3MrLspcF23LYvC4ipBOA ($100 in chips)
Seat 5: Jjc7EHWzs4//xUAjJ0UWoA ($44.40 in chips)
Seat 6: Bsd/K5gAcLanYbGiPirRjw ($201.05 in chips)
Seat 7: 1GkkVBhlJ92guE6K5mS5Ig ($19.40 in chips)
Seat 8: myIxN7otsyr846M539YR8Q ($31.35 in chips)
Seat 9: 6XkTu4ahxzHnvjjc1R8YjQ ($40.10 in chips)
997ViqAtWn1FPjJqcffwcA: posts small blind $0.50
FL3MrLspcF23LYvC4ipBOA: posts big blind $1
*** HOLE CARDS ***
Jjc7EHWzs4//xUAjJ0UWoA: folds
Bsd/K5gAcLanYbGiPirRjw: folds
1GkkVBhlJ92guE6K5mS5Ig: calls $1
myIxN7otsyr846M539YR8Q: folds
6XkTu4ahxzHnvjjc1R8YjQ: folds
Pp/KTcXkfZKKUHkjyaLTdg: folds
8S3JMH4TY3whgIlZmMv66w: raises $2 to $3
997ViqAtWn1FPjJqcffwcA: folds
FL3MrLspcF23LYvC4ipBOA: folds
1GkkVBhlJ92guE6K5mS5Ig: calls $2
*** FLOP *** [7s 2s 9s]
1GkkVBhlJ92guE6K5mS5Ig: checks
8S3JMH4TY3whgIlZmMv66w: bets $3
1GkkVBhlJ92guE6K5mS5Ig: folds
8S3JMH4TY3whgIlZmMv66w collected $7.15 from pot
8S3JMH4TY3whgIlZmMv66w: doesn't show hand
*** SUMMARY ***
Total pot $7.50 | Rake $0.35
Board [7s 2s 9s]
Seat 1: Pp/KTcXkfZKKUHkjyaLTdg folded before Flop (didn't bet)
Seat 2: 8S3JMH4TY3whgIlZmMv66w (button) collected ($7.15)
Seat 3: 997ViqAtWn1FPjJqcffwcA (small blind) folded before Flop
Seat 4: FL3MrLspcF23LYvC4ipBOA (big blind) folded before Flop
Seat 5: Jjc7EHWzs4//xUAjJ0UWoA folded before Flop (didn't bet)
Seat 6: Bsd/K5gAcLanYbGiPirRjw folded before Flop (didn't bet)
Seat 7: 1GkkVBhlJ92guE6K5mS5Ig folded on the Flop
Seat 8: myIxN7otsyr846M539YR8Q folded before Flop (didn't bet)
Seat 9: 6XkTu4ahxzHnvjjc1R8YjQ folded before Flop (didn't bet)



PokerStars Game #59940681082:  Hold'em No Limit ($0.50/$1.00) - 2009/07/01 1:13:31 ET
Table 'MUPc8FEpe/nR0BKSeReX6Q' 6-max Seat #6 is the button
Seat 1: qhkK6+yCciTRd+rCFEbnEQ ($42.60 in chips)
Seat 2: xAU6q2/cwmby2sxmA8VcmA ($114.70 in chips)
Seat 3: wx3sQGkVi2x9wJXuWNHPBw ($216 in chips)
Seat 4: ZA1bp6g8IwtTxkUE4eCjDQ ($193.90 in chips)
Seat 5: UBZQqpnJZdTYYY1FTb0rLA ($100 in chips)
Seat 6: oxnw0GLLpFanjhGkxfRSqA ($58.15 in chips)
qhkK6+yCciTRd+rCFEbnEQ: posts small blind $0.50
xAU6q2/cwmby2sxmA8VcmA: posts big blind $1
*** HOLE CARDS ***
wx3sQGkVi2x9wJXuWNHPBw: folds
ZA1bp6g8IwtTxkUE4eCjDQ: folds
UBZQqpnJZdTYYY1FTb0rLA: folds
oxnw0GLLpFanjhGkxfRSqA: folds
qhkK6+yCciTRd+rCFEbnEQ: folds
xAU6q2/cwmby2sxmA8VcmA collected $1 from pot
xAU6q2/cwmby2sxmA8VcmA: doesn't show hand
*** SUMMARY ***
Total pot $1 | Rake $0
Seat 1: qhkK6+yCciTRd+rCFEbnEQ (small blind) folded before Flop
Seat 2: xAU6q2/cwmby2sxmA8VcmA (big blind) collected ($1)
Seat 3: wx3sQGkVi2x9wJXuWNHPBw folded before Flop (didn't bet)
Seat 4: ZA1bp6g8IwtTxkUE4eCjDQ folded before Flop (didn't bet)
Seat 5: UBZQqpnJZdTYYY1FTb0rLA folded before Flop (didn't bet)
Seat 6: oxnw0GLLpFanjhGkxfRSqA (button) folded before Flop (didn't bet)



PokerStars Game #59940680888:  Hold'em No Limit ($0.50/$1.00) - 2009/07/01 1:13:31 ET
Table 'GxCPo/gd3OSthkYrAxJngg' 6-max Seat #5 is the button
Seat 1: sH8BpAFP+jGFxCgVpD1Lew ($266.90 in chips)
Seat 3: o6plE+MSW4XFNTeONe16xg ($29.65 in chips)
Seat 4: YMJG+F++3Aj6P8dAWda5fw ($196.75 in chips)
Seat 5: G5ZSSN6RSON3gkNvk/SmYg ($116.10 in chips)
Seat 6: 4d1rWhpu8DzLmzMbR3QKyA ($100 in chips)
4d1rWhpu8DzLmzMbR3QKyA: posts small blind $0.50
sH8BpAFP+jGFxCgVpD1Lew: posts big blind $1
*** HOLE CARDS ***
o6plE+MSW4XFNTeONe16xg: folds
YMJG+F++3Aj6P8dAWda5fw: folds
G5ZSSN6RSON3gkNvk/SmYg: folds
4d1rWhpu8DzLmzMbR3QKyA: raises $3 to $4
YExX2paeIHrmfIwV1ivM/w has returned
o6plE+MSW4XFNTeONe16xg leaves the table
sH8BpAFP+jGFxCgVpD1Lew: calls $3
*** FLOP *** [8h Tc Qc]
4d1rWhpu8DzLmzMbR3QKyA: checks
sH8BpAFP+jGFxCgVpD1Lew: checks
*** TURN *** [8h Tc Qc] [Jc]
4d1rWhpu8DzLmzMbR3QKyA: bets $6
sH8BpAFP+jGFxCgVpD1Lew: folds
4d1rWhpu8DzLmzMbR3QKyA collected $7.60 from pot
*** SUMMARY ***
Total pot $8 | Rake $0.40
Board [8h Tc Qc Jc]
Seat 1: sH8BpAFP+jGFxCgVpD1Lew (big blind) folded on the Turn
Seat 3: o6plE+MSW4XFNTeONe16xg folded before Flop (didn't bet)
Seat 4: YMJG+F++3Aj6P8dAWda5fw folded before Flop (didn't bet)
Seat 5: G5ZSSN6RSON3gkNvk/SmYg (button) folded before Flop (didn't bet)
Seat 6: 4d1rWhpu8DzLmzMbR3QKyA (small blind) collected ($7.60)



PokerStars Game #59940681674:  Hold'em No Limit ($0.50/$1.00) - 2009/07/01 1:13:32 ET
Table 'fTlPiCj0utgzC/5io+I7ew' 6-max Seat #1 is the button
Seat 1: YMJG+F++3Aj6P8dAWda5fw ($101.35 in chips)
Seat 3: Z2fXsGcjl+Eax+RzOgwOmg ($101.50 in chips)
Seat 4: uJVSceLggtsrJya+WtmUEA ($175.15 in chips)
Seat 5: XUk5GQsfNFpHvaToDZ0rZA ($50 in chips)
Seat 6: /P4w1pHg2zHYg/4ubJ0dPw ($78.60 in chips)
Z2fXsGcjl+Eax+RzOgwOmg: posts small blind $0.50
uJVSceLggtsrJya+WtmUEA: posts big blind $1
*** HOLE CARDS ***
XUk5GQsfNFpHvaToDZ0rZA: raises $2 to $3
/P4w1pHg2zHYg/4ubJ0dPw: folds
YMJG+F++3Aj6P8dAWda5fw: folds
Z2fXsGcjl+Eax+RzOgwOmg: folds
uJVSceLggtsrJya+WtmUEA: folds
XUk5GQsfNFpHvaToDZ0rZA collected $2.50 from pot
*** SUMMARY ***
Total pot $2.50 | Rake $0
Seat 1: YMJG+F++3Aj6P8dAWda5fw (button) folded before Flop (didn't bet)
Seat 3: Z2fXsGcjl+Eax+RzOgwOmg (small blind) folded before Flop
Seat 4: uJVSceLggtsrJya+WtmUEA (big blind) folded before Flop
Seat 5: XUk5GQsfNFpHvaToDZ0rZA collected ($2.50)
Seat 6: /P4w1pHg2zHYg/4ubJ0dPw folded before Flop (didn't bet)



PokerStars Game #59940681592:  Hold'em No Limit ($0.50/$1.00) - 2009/07/01 1:13:32 ET
Table 'JTT1XWaDZHSaMZQK7cR5uw' 2-max Seat #1 is the button
Seat 1: OLplZF6FEnLflv81Hz+Fxg ($147.45 in chips)
Seat 2: mgi+mjKb1Sc3CCs7TlfoCw ($102.70 in chips)
OLplZF6FEnLflv81Hz+Fxg: posts small blind $0.50
mgi+mjKb1Sc3CCs7TlfoCw: posts big blind $1
*** HOLE CARDS ***
OLplZF6FEnLflv81Hz+Fxg: raises $2 to $3
mgi+mjKb1Sc3CCs7TlfoCw: calls $2
*** FLOP *** [Ts 8h Jc]
mgi+mjKb1Sc3CCs7TlfoCw: checks
OLplZF6FEnLflv81Hz+Fxg: checks
*** TURN *** [Ts 8h Jc] [Qc]
mgi+mjKb1Sc3CCs7TlfoCw: checks
OLplZF6FEnLflv81Hz+Fxg: checks
*** RIVER *** [Ts 8h Jc Qc] [6c]
mgi+mjKb1Sc3CCs7TlfoCw: checks
OLplZF6FEnLflv81Hz+Fxg: checks
*** SHOW DOWN ***
mgi+mjKb1Sc3CCs7TlfoCw: shows [8s Ad] (a pair of Eights)
OLplZF6FEnLflv81Hz+Fxg: mucks hand
mgi+mjKb1Sc3CCs7TlfoCw collected $5.70 from pot
*** SUMMARY ***
Total pot $6 | Rake $0.30
Board [Ts 8h Jc Qc 6c]
Seat 1: OLplZF6FEnLflv81Hz+Fxg (button) (small blind) mucked
Seat 2: mgi+mjKb1Sc3CCs7TlfoCw (big blind) showed [8s Ad] and won ($5.70) with a pair of Eights



PokerStars Game #59940681880:  Hold'em No Limit ($0.50/$1.00) - 2009/07/01 1:13:33 ET
Table 'W/wyObTiXZm+Ckkl3YxcSw' 6-max Seat #2 is the button
Seat 1: eUBBn2R56C1IQ6Cs/vitwg ($181.25 in chips)
Seat 2: oDiBRCaF0QVtd3kO6xZIXw ($169.65 in chips)
Seat 3: dxyNCn/qxfkGDUIf28Cbng ($56.30 in chips)
Seat 4: aYii2DmxlOlbC1wbGRBWvQ ($112.75 in chips)
dxyNCn/qxfkGDUIf28Cbng: posts small blind $0.50
aYii2DmxlOlbC1wbGRBWvQ: posts big blind $1
b2a+5TkFf4xJN/Ihhma58Q: sits out
*** HOLE CARDS ***
eUBBn2R56C1IQ6Cs/vitwg: folds
oDiBRCaF0QVtd3kO6xZIXw: folds
dxyNCn/qxfkGDUIf28Cbng: calls $0.50
+OrCjyw70oZhJiD22Mn+bg joins the table at seat #5
aYii2DmxlOlbC1wbGRBWvQ: checks
*** FLOP *** [5c 5d Jh]
dxyNCn/qxfkGDUIf28Cbng: checks
aYii2DmxlOlbC1wbGRBWvQ: bets $3
dxyNCn/qxfkGDUIf28Cbng: folds
aYii2DmxlOlbC1wbGRBWvQ collected $1.90 from pot
*** SUMMARY ***
Total pot $2 | Rake $0.10
Board [5c 5d Jh]
Seat 1: eUBBn2R56C1IQ6Cs/vitwg folded before Flop (didn't bet)
Seat 2: oDiBRCaF0QVtd3kO6xZIXw (button) folded before Flop (didn't bet)
Seat 3: dxyNCn/qxfkGDUIf28Cbng (small blind) folded on the Flop
Seat 4: aYii2DmxlOlbC1wbGRBWvQ (big blind) collected ($1.90)



PokerStars Game #59940683804:  Hold'em No Limit ($0.50/$1.00) - 2009/07/01 1:13:36 ET
Table 'kS0cTQAEi+fdUlJP2gQYvw' 9-max Seat #7 is the button
Seat 1: c/9X4zftzphFxYtxp5kp9w ($64.35 in chips)
Seat 2: D+W9Me7w6Hcx/WRUSKV0dw ($22.40 in chips)
Seat 3: 2BV+oJIQYr65IO6nEChvbA ($60 in chips)
Seat 4: RUhhaALzha3TH1AkdakoGQ ($44 in chips)
Seat 5: 997ViqAtWn1FPjJqcffwcA ($101.15 in chips)
Seat 6: yAbu2QsRPVcjPbqlf/jDxw ($126.15 in chips)
Seat 7: Ffa7Nj4X5fddtROP01hfQg ($162.80 in chips)
Seat 9: OGgaARGdJQT4awWVNQ957w ($100.50 in chips)
vKyFzTyzfT7fZcdX+HHN+Q will be allowed to play after the button
OGgaARGdJQT4awWVNQ957w: posts small blind $0.50
c/9X4zftzphFxYtxp5kp9w: posts big blind $1
*** HOLE CARDS ***
D+W9Me7w6Hcx/WRUSKV0dw: folds
2BV+oJIQYr65IO6nEChvbA: folds
RUhhaALzha3TH1AkdakoGQ: folds
997ViqAtWn1FPjJqcffwcA: folds
yAbu2QsRPVcjPbqlf/jDxw: folds
Ffa7Nj4X5fddtROP01hfQg: raises $1 to $2
OGgaARGdJQT4awWVNQ957w: folds
c/9X4zftzphFxYtxp5kp9w: calls $1
*** FLOP *** [8s Qh 6s]
c/9X4zftzphFxYtxp5kp9w: checks
Ffa7Nj4X5fddtROP01hfQg: checks
*** TURN *** [8s Qh 6s] [4c]
c/9X4zftzphFxYtxp5kp9w: checks
Ffa7Nj4X5fddtROP01hfQg: bets $2
c/9X4zftzphFxYtxp5kp9w: folds
Ffa7Nj4X5fddtROP01hfQg collected $4.30 from pot
*** SUMMARY ***
Total pot $4.50 | Rake $0.20
Board [8s Qh 6s 4c]
Seat 1: c/9X4zftzphFxYtxp5kp9w (big blind) folded on the Turn
Seat 2: D+W9Me7w6Hcx/WRUSKV0dw folded before Flop (didn't bet)
Seat 3: 2BV+oJIQYr65IO6nEChvbA folded before Flop (didn't bet)
Seat 4: RUhhaALzha3TH1AkdakoGQ folded before Flop (didn't bet)
Seat 5: 997ViqAtWn1FPjJqcffwcA folded before Flop (didn't bet)
Seat 6: yAbu2QsRPVcjPbqlf/jDxw folded before Flop (didn't bet)
Seat 7: Ffa7Nj4X5fddtROP01hfQg (button) collected ($4.30)
Seat 9: OGgaARGdJQT4awWVNQ957w (small blind) folded before Flop



PokerStars Game #59940686568:  Hold'em No Limit ($0.50/$1.00) - 2009/07/01 1:13:41 ET
Table 'mmbQQVBTrPdE+wy+s+9VPA' 6-max Seat #4 is the button
Seat 1: zyP4SPoWZnKUfTvIRLCVog ($62.55 in chips)
Seat 2: XK4Qsl+DA8gAJyg85/zBIw ($23.05 in chips)
Seat 3: wx3sQGkVi2x9wJXuWNHPBw ($109.65 in chips)
Seat 4: V3iZdcw61nXF3g5hD2RrsQ ($114.90 in chips)
Seat 5: YMJG+F++3Aj6P8dAWda5fw ($102.60 in chips)
Seat 6: U2CWBTv29qdCbj8RNF2sIw ($111.10 in chips)
YMJG+F++3Aj6P8dAWda5fw: posts small blind $0.50
U2CWBTv29qdCbj8RNF2sIw: posts big blind $1
*** HOLE CARDS ***
zyP4SPoWZnKUfTvIRLCVog: calls $1
XK4Qsl+DA8gAJyg85/zBIw: folds
wx3sQGkVi2x9wJXuWNHPBw: folds
V3iZdcw61nXF3g5hD2RrsQ: folds
YMJG+F++3Aj6P8dAWda5fw: folds
U2CWBTv29qdCbj8RNF2sIw: checks
*** FLOP *** [Kh 5h Ah]
U2CWBTv29qdCbj8RNF2sIw: bets $2
zyP4SPoWZnKUfTvIRLCVog: calls $2
*** TURN *** [Kh 5h Ah] [As]
U2CWBTv29qdCbj8RNF2sIw: bets $5
zyP4SPoWZnKUfTvIRLCVog: calls $5
*** RIVER *** [Kh 5h Ah As] [3c]
U2CWBTv29qdCbj8RNF2sIw: checks
zyP4SPoWZnKUfTvIRLCVog: checks
*** SHOW DOWN ***
U2CWBTv29qdCbj8RNF2sIw: shows [Qh 8s] (a pair of Aces)
zyP4SPoWZnKUfTvIRLCVog: shows [Jh Qc] (a pair of Aces - King+Queen+Jack kicker)
zyP4SPoWZnKUfTvIRLCVog collected $15.70 from pot
*** SUMMARY ***
Total pot $16.50 | Rake $0.80
Board [Kh 5h Ah As 3c]
Seat 1: zyP4SPoWZnKUfTvIRLCVog showed [Jh Qc] and won ($15.70) with a pair of Aces
Seat 2: XK4Qsl+DA8gAJyg85/zBIw folded before Flop (didn't bet)
Seat 3: wx3sQGkVi2x9wJXuWNHPBw folded before Flop (didn't bet)
Seat 4: V3iZdcw61nXF3g5hD2RrsQ (button) folded before Flop (didn't bet)
Seat 5: YMJG+F++3Aj6P8dAWda5fw (small blind) folded before Flop
Seat 6: U2CWBTv29qdCbj8RNF2sIw (big blind) showed [Qh 8s] and lost with a pair of Aces



PokerStars Game #59940687568:  Hold'em No Limit ($0.50/$1.00) - 2009/07/01 1:13:42 ET
Table 'MUPc8FEpe/nR0BKSeReX6Q' 6-max Seat #1 is the button
Seat 1: qhkK6+yCciTRd+rCFEbnEQ ($42.10 in chips)
Seat 2: xAU6q2/cwmby2sxmA8VcmA ($115.20 in chips)
Seat 3: wx3sQGkVi2x9wJXuWNHPBw ($216 in chips)
Seat 4: ZA1bp6g8IwtTxkUE4eCjDQ ($193.90 in chips)
Seat 5: UBZQqpnJZdTYYY1FTb0rLA ($100 in chips)
Seat 6: oxnw0GLLpFanjhGkxfRSqA ($58.15 in chips)
xAU6q2/cwmby2sxmA8VcmA: posts small blind $0.50
wx3sQGkVi2x9wJXuWNHPBw: posts big blind $1
*** HOLE CARDS ***
ZA1bp6g8IwtTxkUE4eCjDQ: calls $1
UBZQqpnJZdTYYY1FTb0rLA: folds
oxnw0GLLpFanjhGkxfRSqA: folds
UBZQqpnJZdTYYY1FTb0rLA leaves the table
qhkK6+yCciTRd+rCFEbnEQ has timed out
qhkK6+yCciTRd+rCFEbnEQ: folds
qhkK6+yCciTRd+rCFEbnEQ is sitting out
y27w5IK2WXqmYzS8OU0wKA joins the table at seat #5
xAU6q2/cwmby2sxmA8VcmA: folds
qhkK6+yCciTRd+rCFEbnEQ has returned
wx3sQGkVi2x9wJXuWNHPBw: checks
*** FLOP *** [Js 2c 6c]
wx3sQGkVi2x9wJXuWNHPBw: checks
ZA1bp6g8IwtTxkUE4eCjDQ: bets $2
wx3sQGkVi2x9wJXuWNHPBw: folds
ZA1bp6g8IwtTxkUE4eCjDQ collected $2.40 from pot
ZA1bp6g8IwtTxkUE4eCjDQ: doesn't show hand
*** SUMMARY ***
Total pot $2.50 | Rake $0.10
Board [Js 2c 6c]
Seat 1: qhkK6+yCciTRd+rCFEbnEQ (button) folded before Flop (didn't bet)
Seat 2: xAU6q2/cwmby2sxmA8VcmA (small blind) folded before Flop
Seat 3: wx3sQGkVi2x9wJXuWNHPBw (big blind) folded on the Flop
Seat 4: ZA1bp6g8IwtTxkUE4eCjDQ collected ($2.40)
Seat 5: UBZQqpnJZdTYYY1FTb0rLA folded before Flop (didn't bet)
Seat 6: oxnw0GLLpFanjhGkxfRSqA folded before Flop (didn't bet)



PokerStars Game #59940687326:  Hold'em No Limit ($0.50/$1.00) - 2009/07/01 1:13:42 ET
Table '6YvsYDPNIDx2v5z3bJnwZQ' 9-max Seat #8 is the button
Seat 1: Ogn4JDV3mp4ZDKO49IFzKA ($21.20 in chips)
Seat 2: +hHqYgKILitkxIzFNGvvsA ($27.75 in chips)
Seat 4: kEr5NYB+JIG5+szcYMr6hA ($42.80 in chips)
Seat 5: mBRWbnUl8diyBO1qTJaNzw ($160.70 in chips)
Seat 6: 7RSwrjMohkYrZAhOd1uaZg ($11.90 in chips)
Seat 7: mae7OMTaJ/MFimNbZegCkg ($45.80 in chips)
Seat 8: PSFxpXgPedVZyHSu2Zhb7Q ($129.05 in chips)
Seat 9: yZYrOeNDxQxkzpbgKX1bng ($27 in chips)
yZYrOeNDxQxkzpbgKX1bng: posts small blind $0.50
Ogn4JDV3mp4ZDKO49IFzKA: posts big blind $1
K6OJDis3KfxSm/PKlkATUA: sits out
*** HOLE CARDS ***
+hHqYgKILitkxIzFNGvvsA: calls $1
kEr5NYB+JIG5+szcYMr6hA: raises $2 to $3
mBRWbnUl8diyBO1qTJaNzw: folds
7RSwrjMohkYrZAhOd1uaZg: folds
mae7OMTaJ/MFimNbZegCkg: folds
PSFxpXgPedVZyHSu2Zhb7Q: folds
yZYrOeNDxQxkzpbgKX1bng: folds
Ogn4JDV3mp4ZDKO49IFzKA: folds
+hHqYgKILitkxIzFNGvvsA: calls $2
*** FLOP *** [2c 9d Kc]
+hHqYgKILitkxIzFNGvvsA: checks
kEr5NYB+JIG5+szcYMr6hA: bets $5
+hHqYgKILitkxIzFNGvvsA: folds
kEr5NYB+JIG5+szcYMr6hA collected $7.15 from pot
*** SUMMARY ***
Total pot $7.50 | Rake $0.35
Board [2c 9d Kc]
Seat 1: Ogn4JDV3mp4ZDKO49IFzKA (big blind) folded before Flop
Seat 2: +hHqYgKILitkxIzFNGvvsA folded on the Flop
Seat 4: kEr5NYB+JIG5+szcYMr6hA collected ($7.15)
Seat 5: mBRWbnUl8diyBO1qTJaNzw folded before Flop (didn't bet)
Seat 6: 7RSwrjMohkYrZAhOd1uaZg folded before Flop (didn't bet)
Seat 7: mae7OMTaJ/MFimNbZegCkg folded before Flop (didn't bet)
Seat 8: PSFxpXgPedVZyHSu2Zhb7Q (button) folded before Flop (didn't bet)
Seat 9: yZYrOeNDxQxkzpbgKX1bng (small blind) folded before Flop



PokerStars Game #59940689378:  Hold'em No Limit ($0.50/$1.00) - 2009/07/01 1:13:45 ET
Table '3T4owEKJKyGTMePwrv50FQ' 9-max Seat #1 is the button
Seat 1: OGgaARGdJQT4awWVNQ957w ($100 in chips)
Seat 2: t+Id2O6herCLgwnC4m49PA ($40.80 in chips)
Seat 3: DOLzOcBTZYcph5jEfKFWuQ ($105.50 in chips)
Seat 4: O5Go3jrzbQWxRB6ESK+Ptg ($30.10 in chips)
Seat 5: eI48VADSCFoNZBx4T9qs2w ($31.85 in chips)
Seat 6: laA8va+Yv8WuMqT1zdR91g ($100 in chips)
Seat 7: 1862487932 ($108.65 in chips)
Seat 8: ucTB8uAUcQnKGsA70OSjNA ($18.50 in chips)
Seat 9: 61sfw5QTu62YYIt68OsdrA ($63.45 in chips)
t+Id2O6herCLgwnC4m49PA: posts small blind $0.50
DOLzOcBTZYcph5jEfKFWuQ: posts big blind $1
*** HOLE CARDS ***
O5Go3jrzbQWxRB6ESK+Ptg: folds
eI48VADSCFoNZBx4T9qs2w: folds
laA8va+Yv8WuMqT1zdR91g: folds
1862487932: folds
ucTB8uAUcQnKGsA70OSjNA: folds
61sfw5QTu62YYIt68OsdrA: folds
OGgaARGdJQT4awWVNQ957w: raises $3 to $4
t+Id2O6herCLgwnC4m49PA: folds
DOLzOcBTZYcph5jEfKFWuQ: folds
OGgaARGdJQT4awWVNQ957w collected $2.50 from pot
OGgaARGdJQT4awWVNQ957w: doesn't show hand
*** SUMMARY ***
Total pot $2.50 | Rake $0
Seat 1: OGgaARGdJQT4awWVNQ957w (button) collected ($2.50)
Seat 2: t+Id2O6herCLgwnC4m49PA (small blind) folded before Flop
Seat 3: DOLzOcBTZYcph5jEfKFWuQ (big blind) folded before Flop
Seat 4: O5Go3jrzbQWxRB6ESK+Ptg folded before Flop (didn't bet)
Seat 5: eI48VADSCFoNZBx4T9qs2w folded before Flop (didn't bet)
Seat 6: laA8va+Yv8WuMqT1zdR91g folded before Flop (didn't bet)
Seat 7: 1862487932 folded before Flop (didn't bet)
Seat 8: ucTB8uAUcQnKGsA70OSjNA folded before Flop (didn't bet)
Seat 9: 61sfw5QTu62YYIt68OsdrA folded before Flop (didn't bet)



PokerStars Game #59940691362:  Hold'em No Limit ($0.50/$1.00) - 2009/07/01 1:13:49 ET
Table 'vs/5jr6ciwjVQ5+Soc+u2A' 6-max Seat #2 is the button
Seat 1: J798qwLuvXyq0BbzsIjOrA ($86.20 in chips)
Seat 2: lXX4W7m3u++JiSOZ46yVMQ ($125.05 in chips)
Seat 3: G5ZSSN6RSON3gkNvk/SmYg ($140.10 in chips)
Seat 4: wk6Ohn4GDozoOMHc4eb2rw ($63.80 in chips)
Seat 5: +Nt3OPk3XR9SKjZgm2CexQ ($107 in chips)
Seat 6: Z2fXsGcjl+Eax+RzOgwOmg ($100 in chips)
G5ZSSN6RSON3gkNvk/SmYg: posts small blind $0.50
wk6Ohn4GDozoOMHc4eb2rw: posts big blind $1
*** HOLE CARDS ***
+Nt3OPk3XR9SKjZgm2CexQ: folds
Z2fXsGcjl+Eax+RzOgwOmg: folds
J798qwLuvXyq0BbzsIjOrA: folds
lXX4W7m3u++JiSOZ46yVMQ: raises $2 to $3
G5ZSSN6RSON3gkNvk/SmYg: folds
wk6Ohn4GDozoOMHc4eb2rw: folds
lXX4W7m3u++JiSOZ46yVMQ collected $2.50 from pot
*** SUMMARY ***
Total pot $2.50 | Rake $0
Seat 1: J798qwLuvXyq0BbzsIjOrA folded before Flop (didn't bet)
Seat 2: lXX4W7m3u++JiSOZ46yVMQ (button) collected ($2.50)
Seat 3: G5ZSSN6RSON3gkNvk/SmYg (small blind) folded before Flop
Seat 4: wk6Ohn4GDozoOMHc4eb2rw (big blind) folded before Flop
Seat 5: +Nt3OPk3XR9SKjZgm2CexQ folded before Flop (didn't bet)
Seat 6: Z2fXsGcjl+Eax+RzOgwOmg folded before Flop (didn't bet)



PokerStars Game #59940691442:  Hold'em No Limit ($0.50/$1.00) - 2009/07/01 1:13:49 ET
Table 'cBDNutyLBKEk9+ptwsKmTw' 6-max Seat #3 is the button
Seat 1: xAU6q2/cwmby2sxmA8VcmA ($135.55 in chips)
Seat 2: 5lY8d6Cnm4HUkt/8FZSj4g ($100 in chips)
Seat 3: G5ZSSN6RSON3gkNvk/SmYg ($100 in chips)
Seat 4: 3q7F5QtzC30pSrn0nl9i+A ($32.60 in chips)
Seat 5: hpxXcmRkXXI9HE5+5/j/0Q ($100 in chips)
Seat 6: NqVlOSH2lp+pp/TK3vvK5g ($92.95 in chips)
3q7F5QtzC30pSrn0nl9i+A: posts small blind $0.50
hpxXcmRkXXI9HE5+5/j/0Q: posts big blind $1
5lY8d6Cnm4HUkt/8FZSj4g: posts small blind $0.50
*** HOLE CARDS ***
NqVlOSH2lp+pp/TK3vvK5g: raises $1 to $2
xAU6q2/cwmby2sxmA8VcmA: raises $9 to $11
5lY8d6Cnm4HUkt/8FZSj4g: calls $11
G5ZSSN6RSON3gkNvk/SmYg: folds
3q7F5QtzC30pSrn0nl9i+A: calls $10.50
hpxXcmRkXXI9HE5+5/j/0Q: folds
NqVlOSH2lp+pp/TK3vvK5g: calls $9
*** FLOP *** [5c 6h 2d]
3q7F5QtzC30pSrn0nl9i+A: checks
NqVlOSH2lp+pp/TK3vvK5g: bets $4
xAU6q2/cwmby2sxmA8VcmA: raises $18 to $22
5lY8d6Cnm4HUkt/8FZSj4g: folds
3q7F5QtzC30pSrn0nl9i+A: folds
NqVlOSH2lp+pp/TK3vvK5g: calls $18
*** TURN *** [5c 6h 2d] [3s]
NqVlOSH2lp+pp/TK3vvK5g: checks
xAU6q2/cwmby2sxmA8VcmA: bets $61
NqVlOSH2lp+pp/TK3vvK5g: calls $59.95 and is all-in
*** RIVER *** [5c 6h 2d 3s] [Qs]
*** SHOW DOWN ***
NqVlOSH2lp+pp/TK3vvK5g: shows [6s Ks] (a pair of Sixes)
xAU6q2/cwmby2sxmA8VcmA: shows [Td Ts] (a pair of Tens)
xAU6q2/cwmby2sxmA8VcmA collected $206.40 from pot
*** SUMMARY ***
Total pot $209.40 | Rake $3
Board [5c 6h 2d 3s Qs]
Seat 1: xAU6q2/cwmby2sxmA8VcmA showed [Td Ts] and won ($206.40) with a pair of Tens
Seat 2: 5lY8d6Cnm4HUkt/8FZSj4g folded on the Flop
Seat 3: G5ZSSN6RSON3gkNvk/SmYg (button) folded before Flop (didn't bet)
Seat 4: 3q7F5QtzC30pSrn0nl9i+A (small blind) folded on the Flop
Seat 5: hpxXcmRkXXI9HE5+5/j/0Q (big blind) folded before Flop
Seat 6: NqVlOSH2lp+pp/TK3vvK5g showed [6s Ks] and lost with a pair of Sixes



PokerStars Game #59940692252:  Hold'em No Limit ($0.50/$1.00) - 2009/07/01 1:13:50 ET
Table 'tyUh+jyNvrceIQdKMJjQ2wZFWj23PMihdwrNWv41OG/Qeat #6 is the button
Seat 1: o8A5MUdudVKu+pAwgZOX2w ($109.75 in chips)
Seat 2: 5uy3EN+iIYkgwbWZFTUBAQ ($109.15 in chips)
Seat 3: TalCiLYHCd+ffkmR3auPvA ($137.80 in chips)
Seat 4: hpxXcmRkXXI9HE5+5/j/0Q ($100 in chips)
Seat 5: j7NIOHLZk7V2o9fOioO5ug ($106.70 in chips)
Seat 6: 4OO5v3AVduL0tePNx8wk5A ($100 in chips)
o8A5MUdudVKu+pAwgZOX2w: posts small blind $0.50
5uy3EN+iIYkgwbWZFTUBAQ: posts big blind $1
*** HOLE CARDS ***
TalCiLYHCd+ffkmR3auPvA: calls $1
hpxXcmRkXXI9HE5+5/j/0Q: folds
j7NIOHLZk7V2o9fOioO5ug: folds
4OO5v3AVduL0tePNx8wk5A: raises $4 to $5
o8A5MUdudVKu+pAwgZOX2w: calls $4.50
5uy3EN+iIYkgwbWZFTUBAQ: folds
TalCiLYHCd+ffkmR3auPvA: calls $4
*** FLOP *** [4d 6c 2d]
o8A5MUdudVKu+pAwgZOX2w: checks
TalCiLYHCd+ffkmR3auPvA: checks
4OO5v3AVduL0tePNx8wk5A: bets $13
o8A5MUdudVKu+pAwgZOX2w: calls $13
TalCiLYHCd+ffkmR3auPvA: folds
*** TURN *** [4d 6c 2d] [7d]
o8A5MUdudVKu+pAwgZOX2w: checks
4OO5v3AVduL0tePNx8wk5A: checks
*** RIVER *** [4d 6c 2d 7d] [Jc]
o8A5MUdudVKu+pAwgZOX2w: bets $20
4OO5v3AVduL0tePNx8wk5A: folds
o8A5MUdudVKu+pAwgZOX2w collected $39.95 from pot
o8A5MUdudVKu+pAwgZOX2w: doesn't show hand
*** SUMMARY ***
Total pot $42 | Rake $2.05
Board [4d 6c 2d 7d Jc]
Seat 1: o8A5MUdudVKu+pAwgZOX2w (small blind) collected ($39.95)
Seat 2: 5uy3EN+iIYkgwbWZFTUBAQ (big blind) folded before Flop
Seat 3: TalCiLYHCd+ffkmR3auPvA folded on the Flop
Seat 4: hpxXcmRkXXI9HE5+5/j/0Q folded before Flop (didn't bet)
Seat 5: j7NIOHLZk7V2o9fOioO5ug folded before Flop (didn't bet)
Seat 6: 4OO5v3AVduL0tePNx8wk5A (button) folded on the River



PokerStars Game #59940692930:  Hold'em No Limit ($0.50/$1.00) - 2009/07/01 1:13:51 ET
Table 'O96CPOtvMBWP6kzuYDfdFA' 6-max Seat #2 is the button
Seat 1: 6alLXQIITA2EZ/lBeym8Dw ($117.55 in chips)
Seat 2: 4d1rWhpu8DzLmzMbR3QKyA ($111.35 in chips)
Seat 3: V89DGjxE171oPREEbAXiyg ($89.60 in chips)
Seat 4: /P4w1pHg2zHYg/4ubJ0dPw ($63.55 in chips)
Seat 5: G5ZSSN6RSON3gkNvk/SmYg ($100 in chips)
Seat 6: GYei5jXGWexiJYbAT2fELg ($35.75 in chips)
V89DGjxE171oPREEbAXiyg: posts small blind $0.50
/P4w1pHg2zHYg/4ubJ0dPw: posts big blind $1
*** HOLE CARDS ***
G5ZSSN6RSON3gkNvk/SmYg: folds
GYei5jXGWexiJYbAT2fELg: raises $3 to $4
6alLXQIITA2EZ/lBeym8Dw: folds
4d1rWhpu8DzLmzMbR3QKyA: folds
V89DGjxE171oPREEbAXiyg: folds
/P4w1pHg2zHYg/4ubJ0dPw: calls $3
*** FLOP *** [Jh Js Kc]
/P4w1pHg2zHYg/4ubJ0dPw: checks
GYei5jXGWexiJYbAT2fELg: bets $2
/P4w1pHg2zHYg/4ubJ0dPw: calls $2
*** TURN *** [Jh Js Kc] [2d]
/P4w1pHg2zHYg/4ubJ0dPw: checks
GYei5jXGWexiJYbAT2fELg: bets $2
/P4w1pHg2zHYg/4ubJ0dPw: folds
GYei5jXGWexiJYbAT2fELg collected $11.90 from pot
*** SUMMARY ***
Total pot $12.50 | Rake $0.60
Board [Jh Js Kc 2d]
Seat 1: 6alLXQIITA2EZ/lBeym8Dw folded before Flop (didn't bet)
Seat 2: 4d1rWhpu8DzLmzMbR3QKyA (button) folded before Flop (didn't bet)
Seat 3: V89DGjxE171oPREEbAXiyg (small blind) folded before Flop
Seat 4: /P4w1pHg2zHYg/4ubJ0dPw (big blind) folded on the Turn
Seat 5: G5ZSSN6RSON3gkNvk/SmYg folded before Flop (didn't bet)
Seat 6: GYei5jXGWexiJYbAT2fELg collected ($11.90)



PokerStars Game #59940692658:  Hold'em No Limit ($0.50/$1.00) - 2009/07/01 1:13:51 ET
Table 'JTT1XWaDZHSaMZQK7cR5uw' 2-max Seat #2 is the button
Seat 1: OLplZF6FEnLflv81Hz+Fxg ($144.45 in chips)
Seat 2: mgi+mjKb1Sc3CCs7TlfoCw ($105.40 in chips)
mgi+mjKb1Sc3CCs7TlfoCw: posts small blind $0.50
OLplZF6FEnLflv81Hz+Fxg: posts big blind $1
*** HOLE CARDS ***
mgi+mjKb1Sc3CCs7TlfoCw: folds
OLplZF6FEnLflv81Hz+Fxg collected $1 from pot
*** SUMMARY ***
Total pot $1 | Rake $0
Seat 1: OLplZF6FEnLflv81Hz+Fxg (big blind) collected ($1)
Seat 2: mgi+mjKb1Sc3CCs7TlfoCw (button) (small blind) folded before Flop



PokerStars Game #59940692972:  Hold'em No Limit ($0.50/$1.00) - 2009/07/01 1:13:51 ET
Table 'hdVBCnDy5t2X9dZo0AvD9w' 9-max Seat #9 is the button
Seat 1: sa/cZBFh73L9TapFXpn3BA ($69.35 in chips)
Seat 2: Ogn4JDV3mp4ZDKO49IFzKA ($22 in chips)
Seat 3: 1862487932 ($100 in chips)
Seat 4: YvSugbFKWSuAYx9iokQwUQ ($73.20 in chips)
Seat 5: H+DVy3Ei8L1UKS2tVOtJcw ($100 in chips)
Seat 6: bJckevFOcg//s0qyMQI6sQ ($100 in chips)
Seat 7: KqC3XiX79XzqwhoOYPVb4w ($163.05 in chips)
Seat 8: gUUvmqdVlmvpal6B8nYrmg ($139.40 in chips)
Seat 9: AMkLbywdoc0K30BTzaIfTQ ($186.40 in chips)
sa/cZBFh73L9TapFXpn3BA: posts small blind $0.50
Ogn4JDV3mp4ZDKO49IFzKA: posts big blind $1
*** HOLE CARDS ***
1862487932: folds
YvSugbFKWSuAYx9iokQwUQ: folds
H+DVy3Ei8L1UKS2tVOtJcw: raises $1 to $2
bJckevFOcg//s0qyMQI6sQ: folds
KqC3XiX79XzqwhoOYPVb4w: folds
gUUvmqdVlmvpal6B8nYrmg: raises $5 to $7
AMkLbywdoc0K30BTzaIfTQ: folds
sa/cZBFh73L9TapFXpn3BA: folds
Ogn4JDV3mp4ZDKO49IFzKA: folds
H+DVy3Ei8L1UKS2tVOtJcw: folds
gUUvmqdVlmvpal6B8nYrmg collected $5.50 from pot
*** SUMMARY ***
Total pot $5.50 | Rake $0
Seat 1: sa/cZBFh73L9TapFXpn3BA (small blind) folded before Flop
Seat 2: Ogn4JDV3mp4ZDKO49IFzKA (big blind) folded before Flop
Seat 3: 1862487932 folded before Flop (didn't bet)
Seat 4: YvSugbFKWSuAYx9iokQwUQ folded before Flop (didn't bet)
Seat 5: H+DVy3Ei8L1UKS2tVOtJcw folded before Flop
Seat 6: bJckevFOcg//s0qyMQI6sQ folded before Flop (didn't bet)
Seat 7: KqC3XiX79XzqwhoOYPVb4w folded before Flop (didn't bet)
Seat 8: gUUvmqdVlmvpal6B8nYrmg collected ($5.50)
Seat 9: AMkLbywdoc0K30BTzaIfTQ (button) folded before Flop (didn't bet)



PokerStars Game #59940694284:  Hold'em No Limit ($0.50/$1.00) - 2009/07/01 1:13:54 ET
Table '7Nl0ffnjeK44/vmeexh3MQ' 9-max Seat #3 is the button
Seat 1: V138SURkdX8LdVBPKdJJag ($100 in chips)
Seat 2: OGgaARGdJQT4awWVNQ957w ($102 in chips)
Seat 3: JMmUYT5pIKCKh2pGjCB/4w ($55.50 in chips)
Seat 4: bLbSOSmSOnqE0iTcH/5dxA ($100 in chips)
Seat 5: 61sfw5QTu62YYIt68OsdrA ($81.50 in chips)
Seat 6: FVs16t7GgfWgQWt4JxsObQ ($30.35 in chips)
Seat 7: 997ViqAtWn1FPjJqcffwcA ($100 in chips)
Seat 8: D+W9Me7w6Hcx/WRUSKV0dw ($18.25 in chips)
Seat 9: ouwUBGRKnKK9uhn1G4Lf+A ($194 in chips)
bLbSOSmSOnqE0iTcH/5dxA: posts small blind $0.50
61sfw5QTu62YYIt68OsdrA: posts big blind $1
*** HOLE CARDS ***
FVs16t7GgfWgQWt4JxsObQ: folds
997ViqAtWn1FPjJqcffwcA: folds
D+W9Me7w6Hcx/WRUSKV0dw: folds
ouwUBGRKnKK9uhn1G4Lf+A: folds
V138SURkdX8LdVBPKdJJag: folds
OGgaARGdJQT4awWVNQ957w: folds
JMmUYT5pIKCKh2pGjCB/4w: folds
OGgaARGdJQT4awWVNQ957w is sitting out
bLbSOSmSOnqE0iTcH/5dxA: folds
61sfw5QTu62YYIt68OsdrA collected $1 from pot
61sfw5QTu62YYIt68OsdrA: doesn't show hand
*** SUMMARY ***
Total pot $1 | Rake $0
Seat 1: V138SURkdX8LdVBPKdJJag folded before Flop (didn't bet)
Seat 2: OGgaARGdJQT4awWVNQ957w folded before Flop (didn't bet)
Seat 3: JMmUYT5pIKCKh2pGjCB/4w (button) folded before Flop (didn't bet)
Seat 4: bLbSOSmSOnqE0iTcH/5dxA (small blind) folded before Flop
Seat 5: 61sfw5QTu62YYIt68OsdrA (big blind) collected ($1)
Seat 6: FVs16t7GgfWgQWt4JxsObQ folded before Flop (didn't bet)
Seat 7: 997ViqAtWn1FPjJqcffwcA folded before Flop (didn't bet)
Seat 8: D+W9Me7w6Hcx/WRUSKV0dw folded before Flop (didn't bet)
Seat 9: ouwUBGRKnKK9uhn1G4Lf+A folded before Flop (didn't bet)



PokerStars Game #59940694908:  Hold'em No Limit ($0.50/$1.00) - 2009/07/01 1:13:55 ET
Table 'fTlPiCj0utgzC/5io+I7ew' 6-max Seat #3 is the button
Seat 1: YMJG+F++3Aj6P8dAWda5fw ($101.35 in chips)
Seat 3: Z2fXsGcjl+Eax+RzOgwOmg ($101 in chips)
Seat 4: uJVSceLggtsrJya+WtmUEA ($174.15 in chips)
Seat 5: XUk5GQsfNFpHvaToDZ0rZA ($51.50 in chips)
Seat 6: /P4w1pHg2zHYg/4ubJ0dPw ($78.60 in chips)
uJVSceLggtsrJya+WtmUEA: posts small blind $0.50
XUk5GQsfNFpHvaToDZ0rZA: posts big blind $1
*** HOLE CARDS ***
/P4w1pHg2zHYg/4ubJ0dPw: folds
YMJG+F++3Aj6P8dAWda5fw: raises $2 to $3
Z2fXsGcjl+Eax+RzOgwOmg: folds
uJVSceLggtsrJya+WtmUEA: folds
XUk5GQsfNFpHvaToDZ0rZA: folds
/P4w1pHg2zHYg/4ubJ0dPw leaves the table
YMJG+F++3Aj6P8dAWda5fw collected $2.50 from pot
*** SUMMARY ***
Total pot $2.50 | Rake $0
Seat 1: YMJG+F++3Aj6P8dAWda5fw collected ($2.50)
Seat 3: Z2fXsGcjl+Eax+RzOgwOmg (button) folded before Flop (didn't bet)
Seat 4: uJVSceLggtsrJya+WtmUEA (small blind) folded before Flop
Seat 5: XUk5GQsfNFpHvaToDZ0rZA (big blind) folded before Flop
Seat 6: /P4w1pHg2zHYg/4ubJ0dPw folded before Flop (didn't bet)



PokerStars Game #59940696024:  Hold'em No Limit ($0.50/$1.00) - 2009/07/01 1:13:57 ET
Table 'hugOjcwJvzEwZbK7tyiWuQ' 9-max Seat #5 is the button
Seat 1: S3Ex8K7v6xm5jqjRM7Fl3w ($22 in chips)
Seat 2: r27C1nIV4NS4+qbnrgBQSw ($281.70 in chips)
Seat 4: UWB3oeddt/GObx2Mix2Anw ($171.30 in chips)
Seat 5: 5BRGWf+R3nt2WS3b5xX+zA ($26.35 in chips)
Seat 6: gUUvmqdVlmvpal6B8nYrmg ($100 in chips)
Seat 7: FL3MrLspcF23LYvC4ipBOA ($110.30 in chips)
Seat 8: /zy+DB4S5fUQUSfZWFzYGw ($111.05 in chips)
Seat 9: W8P9bUKCs43TO1xHm0dL6w ($89.45 in chips)
gUUvmqdVlmvpal6B8nYrmg: posts small blind $0.50
FL3MrLspcF23LYvC4ipBOA: posts big blind $1
*** HOLE CARDS ***
/zy+DB4S5fUQUSfZWFzYGw: raises $2 to $3
W8P9bUKCs43TO1xHm0dL6w: folds
S3Ex8K7v6xm5jqjRM7Fl3w: folds
r27C1nIV4NS4+qbnrgBQSw: folds
UWB3oeddt/GObx2Mix2Anw: folds
5BRGWf+R3nt2WS3b5xX+zA: folds
gUUvmqdVlmvpal6B8nYrmg: folds
FL3MrLspcF23LYvC4ipBOA: folds
/zy+DB4S5fUQUSfZWFzYGw collected $2.50 from pot
*** SUMMARY ***
Total pot $2.50 | Rake $0
Seat 1: S3Ex8K7v6xm5jqjRM7Fl3w folded before Flop (didn't bet)
Seat 2: r27C1nIV4NS4+qbnrgBQSw folded before Flop (didn't bet)
Seat 4: UWB3oeddt/GObx2Mix2Anw folded before Flop (didn't bet)
Seat 5: 5BRGWf+R3nt2WS3b5xX+zA (button) folded before Flop (didn't bet)
Seat 6: gUUvmqdVlmvpal6B8nYrmg (small blind) folded before Flop
Seat 7: FL3MrLspcF23LYvC4ipBOA (big blind) folded before Flop
Seat 8: /zy+DB4S5fUQUSfZWFzYGw collected ($2.50)
Seat 9: W8P9bUKCs43TO1xHm0dL6w folded before Flop (didn't bet)



PokerStars Game #59940696322:  Hold'em No Limit ($0.50/$1.00) - 2009/07/01 1:13:57 ET
Table 'JTT1XWaDZHSaMZQK7cR5uw' 2-max Seat #1 is the button
Seat 1: OLplZF6FEnLflv81Hz+Fxg ($144.95 in chips)
Seat 2: mgi+mjKb1Sc3CCs7TlfoCw ($104.90 in chips)
OLplZF6FEnLflv81Hz+Fxg: posts small blind $0.50
mgi+mjKb1Sc3CCs7TlfoCw: posts big blind $1
*** HOLE CARDS ***
OLplZF6FEnLflv81Hz+Fxg: raises $2 to $3
mgi+mjKb1Sc3CCs7TlfoCw: folds
OLplZF6FEnLflv81Hz+Fxg collected $2 from pot
*** SUMMARY ***
Total pot $2 | Rake $0
Seat 1: OLplZF6FEnLflv81Hz+Fxg (button) (small blind) collected ($2)
Seat 2: mgi+mjKb1Sc3CCs7TlfoCw (big blind) folded before Flop



PokerStars Game #59940697616:  Hold'em No Limit ($0.50/$1.00) - 2009/07/01 1:14:00 ET
Table '7O9fB8yx1u7sJveJn8w6jA' 6-max Seat #6 is the button
Seat 1: jy52+7FotjH63o5tEEVgKw ($59.85 in chips)
Seat 2: wx3sQGkVi2x9wJXuWNHPBw ($186.45 in chips)
Seat 3: hpxXcmRkXXI9HE5+5/j/0Q ($125.75 in chips)
Seat 4: b2a+5TkFf4xJN/Ihhma58Q ($41.30 in chips)
Seat 5: BCEV3COoKY607AzLWayfRA ($101.85 in chips)
Seat 6: p1Ga2i1TuXUvRn+Rf/0FMw ($124.75 in chips)
jy52+7FotjH63o5tEEVgKw: posts small blind $0.50
wx3sQGkVi2x9wJXuWNHPBw: posts big blind $1
*** HOLE CARDS ***
hpxXcmRkXXI9HE5+5/j/0Q: folds
b2a+5TkFf4xJN/Ihhma58Q: folds
BCEV3COoKY607AzLWayfRA: folds
p1Ga2i1TuXUvRn+Rf/0FMw: calls $1
jy52+7FotjH63o5tEEVgKw: calls $0.50
wx3sQGkVi2x9wJXuWNHPBw: checks
*** FLOP *** [3d Tc Qd]
jy52+7FotjH63o5tEEVgKw: checks
wx3sQGkVi2x9wJXuWNHPBw: checks
p1Ga2i1TuXUvRn+Rf/0FMw: checks
*** TURN *** [3d Tc Qd] [3s]
jy52+7FotjH63o5tEEVgKw: checks
wx3sQGkVi2x9wJXuWNHPBw: bets $2
p1Ga2i1TuXUvRn+Rf/0FMw: calls $2
jy52+7FotjH63o5tEEVgKw: folds
*** RIVER *** [3d Tc Qd 3s] [7d]
wx3sQGkVi2x9wJXuWNHPBw: bets $4
p1Ga2i1TuXUvRn+Rf/0FMw: folds
wx3sQGkVi2x9wJXuWNHPBw collected $6.70 from pot
*** SUMMARY ***
Total pot $7 | Rake $0.30
Board [3d Tc Qd 3s 7d]
Seat 1: jy52+7FotjH63o5tEEVgKw (small blind) folded on the Turn
Seat 2: wx3sQGkVi2x9wJXuWNHPBw (big blind) collected ($6.70)
Seat 3: hpxXcmRkXXI9HE5+5/j/0Q folded before Flop (didn't bet)
Seat 4: b2a+5TkFf4xJN/Ihhma58Q folded before Flop (didn't bet)
Seat 5: BCEV3COoKY607AzLWayfRA folded before Flop (didn't bet)
Seat 6: p1Ga2i1TuXUvRn+Rf/0FMw (button) folded on the River



PokerStars Game #59940699316:  Hold'em No Limit ($0.50/$1.00) - 2009/07/01 1:14:02 ET
Table 'W/wyObTiXZm+Ckkl3YxcSw' 6-max Seat #3 is the button
Seat 1: eUBBn2R56C1IQ6Cs/vitwg ($181.25 in chips)
Seat 2: oDiBRCaF0QVtd3kO6xZIXw ($169.65 in chips)
Seat 3: dxyNCn/qxfkGDUIf28Cbng ($55.30 in chips)
Seat 4: aYii2DmxlOlbC1wbGRBWvQ ($113.65 in chips)
Seat 5: +OrCjyw70oZhJiD22Mn+bg ($100 in chips)
aYii2DmxlOlbC1wbGRBWvQ: posts small blind $0.50
+OrCjyw70oZhJiD22Mn+bg: posts big blind $1
b2a+5TkFf4xJN/Ihhma58Q: sits out
*** HOLE CARDS ***
eUBBn2R56C1IQ6Cs/vitwg: raises $3 to $4
oDiBRCaF0QVtd3kO6xZIXw: folds
dxyNCn/qxfkGDUIf28Cbng: calls $4
aYii2DmxlOlbC1wbGRBWvQ: folds
+OrCjyw70oZhJiD22Mn+bg: folds
*** FLOP *** [6s 8h 8s]
eUBBn2R56C1IQ6Cs/vitwg: bets $7
dxyNCn/qxfkGDUIf28Cbng: calls $7
*** TURN *** [6s 8h 8s] [5s]
eUBBn2R56C1IQ6Cs/vitwg: checks
dxyNCn/qxfkGDUIf28Cbng: bets $15
eUBBn2R56C1IQ6Cs/vitwg: folds
dxyNCn/qxfkGDUIf28Cbng collected $22.35 from pot
*** SUMMARY ***
Total pot $23.50 | Rake $1.15
Board [6s 8h 8s 5s]
Seat 1: eUBBn2R56C1IQ6Cs/vitwg folded on the Turn
Seat 2: oDiBRCaF0QVtd3kO6xZIXw folded before Flop (didn't bet)
Seat 3: dxyNCn/qxfkGDUIf28Cbng (button) collected ($22.35)
Seat 4: aYii2DmxlOlbC1wbGRBWvQ (small blind) folded before Flop
Seat 5: +OrCjyw70oZhJiD22Mn+bg (big blind) folded before Flop



PokerStars Game #59940700326:  Hold'em No Limit ($0.50/$1.00) - 2009/07/01 1:14:04 ET
Table 'pHrhryH8jPNdQfY62f8v+g' 6-max Seat #6 is the button
Seat 1: 4d1rWhpu8DzLmzMbR3QKyA ($107.20 in chips)
Seat 2: JwCcjZl0bjJzG7hmE0dnTA ($100 in chips)
Seat 3: 8oS5O7iD/qnFXFXJrGIgNQ ($100 in chips)
Seat 4: 1f3beyIML24UqEMTbWy93g ($55.15 in chips)
Seat 5: r1/R7y0Ortgoz4lccgW8VA ($37.20 in chips)
Seat 6: xAU6q2/cwmby2sxmA8VcmA ($206.60 in chips)
4d1rWhpu8DzLmzMbR3QKyA: posts small blind $0.50
JwCcjZl0bjJzG7hmE0dnTA: posts big blind $1
*** HOLE CARDS ***
8oS5O7iD/qnFXFXJrGIgNQ: folds
1f3beyIML24UqEMTbWy93g: raises $2 to $3
r1/R7y0Ortgoz4lccgW8VA: raises $4 to $7
xAU6q2/cwmby2sxmA8VcmA: folds
4d1rWhpu8DzLmzMbR3QKyA: folds
JwCcjZl0bjJzG7hmE0dnTA: folds
1f3beyIML24UqEMTbWy93g: calls $4
*** FLOP *** [7s 3h 4s]
1f3beyIML24UqEMTbWy93g: checks
r1/R7y0Ortgoz4lccgW8VA: bets $12
1f3beyIML24UqEMTbWy93g: folds
r1/R7y0Ortgoz4lccgW8VA collected $14.75 from pot
*** SUMMARY ***
Total pot $15.50 | Rake $0.75
Board [7s 3h 4s]
Seat 1: 4d1rWhpu8DzLmzMbR3QKyA (small blind) folded before Flop
Seat 2: JwCcjZl0bjJzG7hmE0dnTA (big blind) folded before Flop
Seat 3: 8oS5O7iD/qnFXFXJrGIgNQ folded before Flop (didn't bet)
Seat 4: 1f3beyIML24UqEMTbWy93g folded on the Flop
Seat 5: r1/R7y0Ortgoz4lccgW8VA collected ($14.75)
Seat 6: xAU6q2/cwmby2sxmA8VcmA (button) folded before Flop (didn't bet)



PokerStars Game #59940700232:  Hold'em No Limit ($0.50/$1.00) - 2009/07/01 1:14:04 ET
Table 'rmZfTK+oSebeUPJNbWhdAA' 6-max Seat #3 is the button
Seat 1: xAU6q2/cwmby2sxmA8VcmA ($147 in chips)
Seat 2: z7O9PO/WEcqRouIydFhS9Q ($138.60 in chips)
Seat 3: BCEV3COoKY607AzLWayfRA ($152.80 in chips)
Seat 4: 1/mIuXfgx1ZyVkodrmfQDw ($100 in chips)
Seat 5: 5lY8d6Cnm4HUkt/8FZSj4g ($46.95 in chips)
Seat 6: j7NIOHLZk7V2o9fOioO5ug ($132 in chips)
1/mIuXfgx1ZyVkodrmfQDw: posts small blind $0.50
5lY8d6Cnm4HUkt/8FZSj4g: posts big blind $1
*** HOLE CARDS ***
j7NIOHLZk7V2o9fOioO5ug: folds
xAU6q2/cwmby2sxmA8VcmA: raises $3 to $4
z7O9PO/WEcqRouIydFhS9Q: folds
BCEV3COoKY607AzLWayfRA: folds
1/mIuXfgx1ZyVkodrmfQDw: folds
5lY8d6Cnm4HUkt/8FZSj4g: folds
xAU6q2/cwmby2sxmA8VcmA collected $2.50 from pot
xAU6q2/cwmby2sxmA8VcmA: doesn't show hand
*** SUMMARY ***
Total pot $2.50 | Rake $0
Seat 1: xAU6q2/cwmby2sxmA8VcmA collected ($2.50)
Seat 2: z7O9PO/WEcqRouIydFhS9Q folded before Flop (didn't bet)
Seat 3: BCEV3COoKY607AzLWayfRA (button) folded before Flop (didn't bet)
Seat 4: 1/mIuXfgx1ZyVkodrmfQDw (small blind) folded before Flop
Seat 5: 5lY8d6Cnm4HUkt/8FZSj4g (big blind) folded before Flop
Seat 6: j7NIOHLZk7V2o9fOioO5ug folded before Flop (didn't bet)



PokerStars Game #59940701134:  Hold'em No Limit ($0.50/$1.00) - 2009/07/01 1:14:05 ET
Table 'vs/5jr6ciwjVQ5+Soc+u2A' 6-max Seat #3 is the button
Seat 1: J798qwLuvXyq0BbzsIjOrA ($100 in chips)
Seat 2: lXX4W7m3u++JiSOZ46yVMQ ($126.55 in chips)
Seat 3: G5ZSSN6RSON3gkNvk/SmYg ($139.60 in chips)
Seat 4: wk6Ohn4GDozoOMHc4eb2rw ($62.80 in chips)
Seat 5: +Nt3OPk3XR9SKjZgm2CexQ ($107 in chips)
Seat 6: Z2fXsGcjl+Eax+RzOgwOmg ($100 in chips)
wk6Ohn4GDozoOMHc4eb2rw: posts small blind $0.50
+Nt3OPk3XR9SKjZgm2CexQ: posts big blind $1
*** HOLE CARDS ***
Z2fXsGcjl+Eax+RzOgwOmg: folds
J798qwLuvXyq0BbzsIjOrA: raises $2 to $3
lXX4W7m3u++JiSOZ46yVMQ: calls $3
G5ZSSN6RSON3gkNvk/SmYg: folds
wk6Ohn4GDozoOMHc4eb2rw: folds
+Nt3OPk3XR9SKjZgm2CexQ: calls $2
*** FLOP *** [9h Kh Td]
+Nt3OPk3XR9SKjZgm2CexQ: bets $7
J798qwLuvXyq0BbzsIjOrA: folds
lXX4W7m3u++JiSOZ46yVMQ: folds
+Nt3OPk3XR9SKjZgm2CexQ collected $9.05 from pot
+Nt3OPk3XR9SKjZgm2CexQ: doesn't show hand
*** SUMMARY ***
Total pot $9.50 | Rake $0.45
Board [9h Kh Td]
Seat 1: J798qwLuvXyq0BbzsIjOrA folded on the Flop
Seat 2: lXX4W7m3u++JiSOZ46yVMQ folded on the Flop
Seat 3: G5ZSSN6RSON3gkNvk/SmYg (button) folded before Flop (didn't bet)
Seat 4: wk6Ohn4GDozoOMHc4eb2rw (small blind) folded before Flop
Seat 5: +Nt3OPk3XR9SKjZgm2CexQ (big blind) collected ($9.05)
Seat 6: Z2fXsGcjl+Eax+RzOgwOmg folded before Flop (didn't bet)



PokerStars Game #59940701108:  Hold'em No Limit ($0.50/$1.00) - 2009/07/01 1:14:05 ET
Table 'VOs36P6NW+QyXeQ1B62kmA' 6-max Seat #6 is the button
Seat 1: Z2fXsGcjl+Eax+RzOgwOmg ($100 in chips)
Seat 2: 2UMlbaZ8n8AbRli0Yr0mDw ($24.35 in chips)
Seat 3: FyNUCpzHVyQu/qX8pqNQFA ($107.75 in chips)
Seat 4: w02zQzNydODiyV9THKgo9w ($41.60 in chips)
Seat 5: ozrlafxxh1HmYdA0/h+MuA ($42.75 in chips)
Seat 6: slVKuQyEz8Qj4E3uLPYNXg ($111.85 in chips)
Z2fXsGcjl+Eax+RzOgwOmg: posts small blind $0.50
2UMlbaZ8n8AbRli0Yr0mDw: posts big blind $1
*** HOLE CARDS ***
FyNUCpzHVyQu/qX8pqNQFA: raises $2 to $3
w02zQzNydODiyV9THKgo9w: folds
ozrlafxxh1HmYdA0/h+MuA: folds
slVKuQyEz8Qj4E3uLPYNXg: folds
Z2fXsGcjl+Eax+RzOgwOmg: folds
2UMlbaZ8n8AbRli0Yr0mDw: folds
2UMlbaZ8n8AbRli0Yr0mDw is sitting out
FyNUCpzHVyQu/qX8pqNQFA collected $2.50 from pot
FyNUCpzHVyQu/qX8pqNQFA: doesn't show hand
2UMlbaZ8n8AbRli0Yr0mDw leaves the table
*** SUMMARY ***
Total pot $2.50 | Rake $0
Seat 1: Z2fXsGcjl+Eax+RzOgwOmg (small blind) folded before Flop
Seat 2: 2UMlbaZ8n8AbRli0Yr0mDw (big blind) folded before Flop
Seat 3: FyNUCpzHVyQu/qX8pqNQFA collected ($2.50)
Seat 4: w02zQzNydODiyV9THKgo9w folded before Flop (didn't bet)
Seat 5: ozrlafxxh1HmYdA0/h+MuA folded before Flop (didn't bet)
Seat 6: slVKuQyEz8Qj4E3uLPYNXg (button) folded before Flop (didn't bet)



PokerStars Game #59940701340:  Hold'em No Limit ($0.50/$1.00) - 2009/07/01 1:14:06 ET
Table 'JTT1XWaDZHSaMZQK7cR5uw' 2-max Seat #2 is the button
Seat 1: OLplZF6FEnLflv81Hz+Fxg ($145.95 in chips)
Seat 2: mgi+mjKb1Sc3CCs7TlfoCw ($103.90 in chips)
mgi+mjKb1Sc3CCs7TlfoCw: posts small blind $0.50
OLplZF6FEnLflv81Hz+Fxg: posts big blind $1
*** HOLE CARDS ***
mgi+mjKb1Sc3CCs7TlfoCw: raises $2 to $3
OLplZF6FEnLflv81Hz+Fxg: calls $2
*** FLOP *** [Th 8s 3h]
OLplZF6FEnLflv81Hz+Fxg: checks
mgi+mjKb1Sc3CCs7TlfoCw: checks
*** TURN *** [Th 8s 3h] [Qs]
OLplZF6FEnLflv81Hz+Fxg: bets $4
mgi+mjKb1Sc3CCs7TlfoCw: folds
OLplZF6FEnLflv81Hz+Fxg collected $5.70 from pot
*** SUMMARY ***
Total pot $6 | Rake $0.30
Board [Th 8s 3h Qs]
Seat 1: OLplZF6FEnLflv81Hz+Fxg (big blind) collected ($5.70)
Seat 2: mgi+mjKb1Sc3CCs7TlfoCw (button) (small blind) folded on the Turn



PokerStars Game #59940702260:  Hold'em No Limit ($0.50/$1.00) - 2009/07/01 1:14:07 ET
Table 'QSIig7BLMc9wY/rgBechzw' 6-max Seat #4 is the button
Seat 1: Z2fXsGcjl+Eax+RzOgwOmg ($113.50 in chips)
Seat 2: mLOIkH/qmRa+mVujQIhBRg ($35.30 in chips)
Seat 3: +xW7QemQU0Fxs+4TnqBRow ($101.35 in chips)
Seat 4: +uSzP8Jwnw7sKfQ4s66b7w ($76.95 in chips)
Seat 5: lsLuWlcPA3Rh7kJVLzMh0Q ($110.95 in chips)
Seat 6: PxqfkAMdAWtkgbT+q2gciA ($32.50 in chips)
lsLuWlcPA3Rh7kJVLzMh0Q: posts small blind $0.50
PxqfkAMdAWtkgbT+q2gciA: posts big blind $1
*** HOLE CARDS ***
Z2fXsGcjl+Eax+RzOgwOmg: folds
mLOIkH/qmRa+mVujQIhBRg: folds
+xW7QemQU0Fxs+4TnqBRow: folds
+uSzP8Jwnw7sKfQ4s66b7w: folds
lsLuWlcPA3Rh7kJVLzMh0Q: folds
PxqfkAMdAWtkgbT+q2gciA collected $1 from pot
*** SUMMARY ***
Total pot $1 | Rake $0
Seat 1: Z2fXsGcjl+Eax+RzOgwOmg folded before Flop (didn't bet)
Seat 2: mLOIkH/qmRa+mVujQIhBRg folded before Flop (didn't bet)
Seat 3: +xW7QemQU0Fxs+4TnqBRow folded before Flop (didn't bet)
Seat 4: +uSzP8Jwnw7sKfQ4s66b7w (button) folded before Flop (didn't bet)
Seat 5: lsLuWlcPA3Rh7kJVLzMh0Q (small blind) folded before Flop
Seat 6: PxqfkAMdAWtkgbT+q2gciA (big blind) collected ($1)



PokerStars Game #59940702536:  Hold'em No Limit ($0.50/$1.00) - 2009/07/01 1:14:08 ET
Table 'cKH9c4x6u79IqCdaKKvXrw' 9-max Seat #3 is the button
Seat 1: Pp/KTcXkfZKKUHkjyaLTdg ($18.50 in chips)
Seat 2: 8S3JMH4TY3whgIlZmMv66w ($63.70 in chips)
Seat 3: 997ViqAtWn1FPjJqcffwcA ($154.10 in chips)
Seat 4: FL3MrLspcF23LYvC4ipBOA ($100 in chips)
Seat 5: Jjc7EHWzs4//xUAjJ0UWoA ($44.40 in chips)
Seat 6: Bsd/K5gAcLanYbGiPirRjw ($201.05 in chips)
Seat 7: 1GkkVBhlJ92guE6K5mS5Ig ($16.40 in chips)
Seat 8: myIxN7otsyr846M539YR8Q ($31.35 in chips)
Seat 9: 6XkTu4ahxzHnvjjc1R8YjQ ($40.10 in chips)
FL3MrLspcF23LYvC4ipBOA: posts small blind $0.50
Jjc7EHWzs4//xUAjJ0UWoA: posts big blind $1
*** HOLE CARDS ***
Bsd/K5gAcLanYbGiPirRjw: raises $2 to $3
1GkkVBhlJ92guE6K5mS5Ig: folds
myIxN7otsyr846M539YR8Q: folds
6XkTu4ahxzHnvjjc1R8YjQ: calls $3
Pp/KTcXkfZKKUHkjyaLTdg: folds
8S3JMH4TY3whgIlZmMv66w: calls $3
997ViqAtWn1FPjJqcffwcA: folds
FL3MrLspcF23LYvC4ipBOA: folds
Jjc7EHWzs4//xUAjJ0UWoA: folds
*** FLOP *** [Ad 2c 2d]
Bsd/K5gAcLanYbGiPirRjw: checks
6XkTu4ahxzHnvjjc1R8YjQ: checks
8S3JMH4TY3whgIlZmMv66w: checks
*** TURN *** [Ad 2c 2d] [5d]
Bsd/K5gAcLanYbGiPirRjw: bets $7
6XkTu4ahxzHnvjjc1R8YjQ: folds
8S3JMH4TY3whgIlZmMv66w: folds
Bsd/K5gAcLanYbGiPirRjw collected $10 from pot
*** SUMMARY ***
Total pot $10.50 | Rake $0.50
Board [Ad 2c 2d 5d]
Seat 1: Pp/KTcXkfZKKUHkjyaLTdg folded before Flop (didn't bet)
Seat 2: 8S3JMH4TY3whgIlZmMv66w folded on the Turn
Seat 3: 997ViqAtWn1FPjJqcffwcA (button) folded before Flop (didn't bet)
Seat 4: FL3MrLspcF23LYvC4ipBOA (small blind) folded before Flop
Seat 5: Jjc7EHWzs4//xUAjJ0UWoA (big blind) folded before Flop
Seat 6: Bsd/K5gAcLanYbGiPirRjw collected ($10)
Seat 7: 1GkkVBhlJ92guE6K5mS5Ig folded before Flop (didn't bet)
Seat 8: myIxN7otsyr846M539YR8Q folded before Flop (didn't bet)
Seat 9: 6XkTu4ahxzHnvjjc1R8YjQ folded on the Turn



PokerStars Game #59940704448:  Hold'em No Limit ($0.50/$1.00) - 2009/07/01 1:14:11 ET
Table 'tJq9SfN1ywY0r03VBlWlwQ' 9-max Seat #9 is the button
Seat 1: wZsU+w9r7G66x93UuvBf1Q ($334.30 in chips)
Seat 3: FVs16t7GgfWgQWt4JxsObQ ($13.10 in chips)
Seat 4: bLbSOSmSOnqE0iTcH/5dxA ($110.70 in chips)
Seat 5: h5ipsNTMyolp7xn/NAvWkA ($100.25 in chips)
Seat 6: gUUvmqdVlmvpal6B8nYrmg ($114.20 in chips)
Seat 8: G4DEhsZFmznGNVpy2SEocA ($28.40 in chips)
Seat 9: XE5QF1y74bpHog9JxWJMWQ ($100 in chips)
wZsU+w9r7G66x93UuvBf1Q: posts small blind $0.50
FVs16t7GgfWgQWt4JxsObQ: posts big blind $1
Pp/KTcXkfZKKUHkjyaLTdg: sits out
*** HOLE CARDS ***
bLbSOSmSOnqE0iTcH/5dxA: folds
h5ipsNTMyolp7xn/NAvWkA: folds
gUUvmqdVlmvpal6B8nYrmg: folds
G4DEhsZFmznGNVpy2SEocA: folds
XE5QF1y74bpHog9JxWJMWQ: raises $2 to $3
wZsU+w9r7G66x93UuvBf1Q: folds
FVs16t7GgfWgQWt4JxsObQ: calls $2
*** FLOP *** [5s 3h 4c]
FVs16t7GgfWgQWt4JxsObQ: checks
XE5QF1y74bpHog9JxWJMWQ: bets $4.50
FVs16t7GgfWgQWt4JxsObQ: folds
XE5QF1y74bpHog9JxWJMWQ collected $6.20 from pot
*** SUMMARY ***
Total pot $6.50 | Rake $0.30
Board [5s 3h 4c]
Seat 1: wZsU+w9r7G66x93UuvBf1Q (small blind) folded before Flop
Seat 3: FVs16t7GgfWgQWt4JxsObQ (big blind) folded on the Flop
Seat 4: bLbSOSmSOnqE0iTcH/5dxA folded before Flop (didn't bet)
Seat 5: h5ipsNTMyolp7xn/NAvWkA folded before Flop (didn't bet)
Seat 6: gUUvmqdVlmvpal6B8nYrmg folded before Flop (didn't bet)
Seat 8: G4DEhsZFmznGNVpy2SEocA folded before Flop (didn't bet)
Seat 9: XE5QF1y74bpHog9JxWJMWQ (button) collected ($6.20)



PokerStars Game #59940709288:  Hold'em No Limit ($0.50/$1.00) - 2009/07/01 1:14:19 ET
Table 'kS0cTQAEi+fdUlJP2gQYvw' 9-max Seat #9 is the button
Seat 1: c/9X4zftzphFxYtxp5kp9w ($62.35 in chips)
Seat 2: D+W9Me7w6Hcx/WRUSKV0dw ($22.40 in chips)
Seat 3: 2BV+oJIQYr65IO6nEChvbA ($60 in chips)
Seat 4: RUhhaALzha3TH1AkdakoGQ ($44 in chips)
Seat 5: 997ViqAtWn1FPjJqcffwcA ($101.15 in chips)
Seat 6: yAbu2QsRPVcjPbqlf/jDxw ($126.15 in chips)
Seat 7: Ffa7Nj4X5fddtROP01hfQg ($165.10 in chips)
Seat 8: vKyFzTyzfT7fZcdX+HHN+Q ($20 in chips)
Seat 9: OGgaARGdJQT4awWVNQ957w ($100 in chips)
c/9X4zftzphFxYtxp5kp9w: posts small blind $0.50
D+W9Me7w6Hcx/WRUSKV0dw: posts big blind $1
vKyFzTyzfT7fZcdX+HHN+Q: posts big blind $1
*** HOLE CARDS ***
2BV+oJIQYr65IO6nEChvbA: folds
RUhhaALzha3TH1AkdakoGQ: folds
997ViqAtWn1FPjJqcffwcA: folds
yAbu2QsRPVcjPbqlf/jDxw: folds
Ffa7Nj4X5fddtROP01hfQg: calls $1
vKyFzTyzfT7fZcdX+HHN+Q: checks
OGgaARGdJQT4awWVNQ957w: raises $5 to $6
c/9X4zftzphFxYtxp5kp9w: calls $5.50
D+W9Me7w6Hcx/WRUSKV0dw: folds
Ffa7Nj4X5fddtROP01hfQg: folds
vKyFzTyzfT7fZcdX+HHN+Q: folds
*** FLOP *** [3s 4d Qd]
c/9X4zftzphFxYtxp5kp9w: checks
OGgaARGdJQT4awWVNQ957w: bets $11.40
c/9X4zftzphFxYtxp5kp9w: raises $44.95 to $56.35 and is all-in
OGgaARGdJQT4awWVNQ957w: folds
OGgaARGdJQT4awWVNQ957w is sitting out
c/9X4zftzphFxYtxp5kp9w collected $35.95 from pot
*** SUMMARY ***
Total pot $37.80 | Rake $1.85
Board [3s 4d Qd]
Seat 1: c/9X4zftzphFxYtxp5kp9w (small blind) collected ($35.95)
Seat 2: D+W9Me7w6Hcx/WRUSKV0dw (big blind) folded before Flop
Seat 3: 2BV+oJIQYr65IO6nEChvbA folded before Flop (didn't bet)
Seat 4: RUhhaALzha3TH1AkdakoGQ folded before Flop (didn't bet)
Seat 5: 997ViqAtWn1FPjJqcffwcA folded before Flop (didn't bet)
Seat 6: yAbu2QsRPVcjPbqlf/jDxw folded before Flop (didn't bet)
Seat 7: Ffa7Nj4X5fddtROP01hfQg folded before Flop
Seat 8: vKyFzTyzfT7fZcdX+HHN+Q folded before Flop
Seat 9: OGgaARGdJQT4awWVNQ957w (button) folded on the Flop



PokerStars Game #59940710044:  Hold'em No Limit ($0.50/$1.00) - 2009/07/01 1:14:21 ET
Table 'QSIig7BLMc9wY/rgBechzw' 6-max Seat #5 is the button
Seat 1: Z2fXsGcjl+Eax+RzOgwOmg ($113.50 in chips)
Seat 2: mLOIkH/qmRa+mVujQIhBRg ($35.30 in chips)
Seat 3: +xW7QemQU0Fxs+4TnqBRow ($101.35 in chips)
Seat 4: +uSzP8Jwnw7sKfQ4s66b7w ($76.95 in chips)
Seat 5: lsLuWlcPA3Rh7kJVLzMh0Q ($110.45 in chips)
Seat 6: PxqfkAMdAWtkgbT+q2gciA ($33 in chips)
PxqfkAMdAWtkgbT+q2gciA: posts small blind $0.50
Z2fXsGcjl+Eax+RzOgwOmg: posts big blind $1
*** HOLE CARDS ***
mLOIkH/qmRa+mVujQIhBRg: folds
+xW7QemQU0Fxs+4TnqBRow: folds
+uSzP8Jwnw7sKfQ4s66b7w: folds
lsLuWlcPA3Rh7kJVLzMh0Q: raises $2 to $3
PxqfkAMdAWtkgbT+q2gciA: folds
Z2fXsGcjl+Eax+RzOgwOmg: folds
lsLuWlcPA3Rh7kJVLzMh0Q collected $2.50 from pot
lsLuWlcPA3Rh7kJVLzMh0Q: doesn't show hand
*** SUMMARY ***
Total pot $2.50 | Rake $0
Seat 1: Z2fXsGcjl+Eax+RzOgwOmg (big blind) folded before Flop
Seat 2: mLOIkH/qmRa+mVujQIhBRg folded before Flop (didn't bet)
Seat 3: +xW7QemQU0Fxs+4TnqBRow folded before Flop (didn't bet)
Seat 4: +uSzP8Jwnw7sKfQ4s66b7w folded before Flop (didn't bet)
Seat 5: lsLuWlcPA3Rh7kJVLzMh0Q (button) collected ($2.50)
Seat 6: PxqfkAMdAWtkgbT+q2gciA (small blind) folded before Flop



PokerStars Game #59940710926:  Hold'em No Limit ($0.50/$1.00) - 2009/07/01 1:14:22 ET
Table 'fZjVbKj9D8yOB+Rj7NaP/A' 9-max Seat #6 is the button
Seat 1: Oh57946S8OPACStkrhQm7g ($131.40 in chips)
Seat 2: PTAFYDIUSsG+SArbxNl+Aw ($107 in chips)
Seat 3: yAbu2QsRPVcjPbqlf/jDxw ($102.50 in chips)
Seat 4: 997ViqAtWn1FPjJqcffwcA ($103 in chips)
Seat 5: PkGfq5xrSlNsujKaG/HF4Q ($100 in chips)
Seat 6: OvwYHV65yUbgdBjSmo1+5g ($35.90 in chips)
Seat 7: SyS20PAm3RpT6uLBsGkwOA ($113.75 in chips)
Seat 8: zDOE5r14tWqCf6xhuSHK6g ($50 in chips)
Seat 9: qheQay5YvP2DMAb3OUSxtw ($99 in chips)
SyS20PAm3RpT6uLBsGkwOA: posts small blind $0.50
zDOE5r14tWqCf6xhuSHK6g: posts big blind $1
*** HOLE CARDS ***
qheQay5YvP2DMAb3OUSxtw: raises $2 to $3
Oh57946S8OPACStkrhQm7g: folds
Oh57946S8OPACStkrhQm7g leaves the table
PTAFYDIUSsG+SArbxNl+Aw: folds
yAbu2QsRPVcjPbqlf/jDxw: folds
997ViqAtWn1FPjJqcffwcA: folds
PkGfq5xrSlNsujKaG/HF4Q: folds
OvwYHV65yUbgdBjSmo1+5g: folds
SyS20PAm3RpT6uLBsGkwOA: calls $2.50
zDOE5r14tWqCf6xhuSHK6g: calls $2
*** FLOP *** [5h 8s 3d]
SyS20PAm3RpT6uLBsGkwOA: bets $10
zDOE5r14tWqCf6xhuSHK6g: folds
qheQay5YvP2DMAb3OUSxtw: folds
SyS20PAm3RpT6uLBsGkwOA collected $8.55 from pot
*** SUMMARY ***
Total pot $9 | Rake $0.45
Board [5h 8s 3d]
Seat 1: Oh57946S8OPACStkrhQm7g folded before Flop (didn't bet)
Seat 2: PTAFYDIUSsG+SArbxNl+Aw folded before Flop (didn't bet)
Seat 3: yAbu2QsRPVcjPbqlf/jDxw folded before Flop (didn't bet)
Seat 4: 997ViqAtWn1FPjJqcffwcA folded before Flop (didn't bet)
Seat 5: PkGfq5xrSlNsujKaG/HF4Q folded before Flop (didn't bet)
Seat 6: OvwYHV65yUbgdBjSmo1+5g (button) folded before Flop (didn't bet)
Seat 7: SyS20PAm3RpT6uLBsGkwOA (small blind) collected ($8.55)
Seat 8: zDOE5r14tWqCf6xhuSHK6g (big blind) folded on the Flop
Seat 9: qheQay5YvP2DMAb3OUSxtw folded on the Flop



PokerStars Game #59940712316:  Hold'em No Limit ($0.50/$1.00) - 2009/07/01 1:14:24 ET
Table '+cA8mcmhaedZ7YcrDdhmeQ' 6-max Seat #2 is the button
Seat 1: lsLuWlcPA3Rh7kJVLzMh0Q ($273.45 in chips)
Seat 2: RqgF7gRoKgRNW8Zoi1ty4A ($159.25 in chips)
Seat 3: DAIgyIWbYvAkL6PbAI27pg ($17.50 in chips)
Seat 4: 4OO5v3AVduL0tePNx8wk5A ($109.55 in chips)
Seat 5: +7hFKAL0b0O/n8G72TclJA ($136.75 in chips)
Seat 6: YfsTQsY/fxb+YqbdclTHuw ($17.60 in chips)
DAIgyIWbYvAkL6PbAI27pg: posts small blind $0.50
4OO5v3AVduL0tePNx8wk5A: posts big blind $1
*** HOLE CARDS ***
+7hFKAL0b0O/n8G72TclJA: folds
YfsTQsY/fxb+YqbdclTHuw: calls $1
lsLuWlcPA3Rh7kJVLzMh0Q: folds
+7hFKAL0b0O/n8G72TclJA leaves the table
RqgF7gRoKgRNW8Zoi1ty4A: folds
DAIgyIWbYvAkL6PbAI27pg: folds
4OO5v3AVduL0tePNx8wk5A: checks
*** FLOP *** [6s 2d 8h]
4OO5v3AVduL0tePNx8wk5A: bets $1.50
YfsTQsY/fxb+YqbdclTHuw: raises $15.10 to $16.60 and is all-in
4OO5v3AVduL0tePNx8wk5A: folds
YfsTQsY/fxb+YqbdclTHuw collected $5.25 from pot
*** SUMMARY ***
Total pot $5.50 | Rake $0.25
Board [6s 2d 8h]
Seat 1: lsLuWlcPA3Rh7kJVLzMh0Q folded before Flop (didn't bet)
Seat 2: RqgF7gRoKgRNW8Zoi1ty4A (button) folded before Flop (didn't bet)
Seat 3: DAIgyIWbYvAkL6PbAI27pg (small blind) folded before Flop
Seat 4: 4OO5v3AVduL0tePNx8wk5A (big blind) folded on the Flop
Seat 5: +7hFKAL0b0O/n8G72TclJA folded before Flop (didn't bet)
Seat 6: YfsTQsY/fxb+YqbdclTHuw collected ($5.25)



PokerStars Game #59940711892:  Hold'em No Limit ($0.50/$1.00) - 2009/07/01 1:14:24 ET
Table 'VOs36P6NW+QyXeQ1B62kmA' 6-max Seat #1 is the button
Seat 1: Z2fXsGcjl+Eax+RzOgwOmg ($100 in chips)
Seat 3: FyNUCpzHVyQu/qX8pqNQFA ($109.25 in chips)
Seat 4: w02zQzNydODiyV9THKgo9w ($41.60 in chips)
Seat 5: ozrlafxxh1HmYdA0/h+MuA ($42.75 in chips)
Seat 6: slVKuQyEz8Qj4E3uLPYNXg ($111.85 in chips)
FyNUCpzHVyQu/qX8pqNQFA: posts small blind $0.50
w02zQzNydODiyV9THKgo9w: posts big blind $1
*** HOLE CARDS ***
ozrlafxxh1HmYdA0/h+MuA: folds
slVKuQyEz8Qj4E3uLPYNXg: folds
Z2fXsGcjl+Eax+RzOgwOmg: folds
y27w5IK2WXqmYzS8OU0wKA joins the table at seat #2
FyNUCpzHVyQu/qX8pqNQFA: folds
w02zQzNydODiyV9THKgo9w collected $1 from pot
*** SUMMARY ***
Total pot $1 | Rake $0
Seat 1: Z2fXsGcjl+Eax+RzOgwOmg (button) folded before Flop (didn't bet)
Seat 3: FyNUCpzHVyQu/qX8pqNQFA (small blind) folded before Flop
Seat 4: w02zQzNydODiyV9THKgo9w (big blind) collected ($1)
Seat 5: ozrlafxxh1HmYdA0/h+MuA folded before Flop (didn't bet)
Seat 6: slVKuQyEz8Qj4E3uLPYNXg folded before Flop (didn't bet)



PokerStars Game #59940713010:  Hold'em No Limit ($0.50/$1.00) - 2009/07/01 1:14:26 ET
Table 'fTlPiCj0utgzC/5io+I7ew' 6-max Seat #4 is the button
Seat 1: YMJG+F++3Aj6P8dAWda5fw ($102.85 in chips)
Seat 3: Z2fXsGcjl+Eax+RzOgwOmg ($101 in chips)
Seat 4: uJVSceLggtsrJya+WtmUEA ($173.65 in chips)
Seat 5: XUk5GQsfNFpHvaToDZ0rZA ($50.50 in chips)
Seat 6: y27w5IK2WXqmYzS8OU0wKA ($100 in chips)
XUk5GQsfNFpHvaToDZ0rZA: posts small blind $0.50
y27w5IK2WXqmYzS8OU0wKA: posts big blind $1
*** HOLE CARDS ***
YMJG+F++3Aj6P8dAWda5fw: folds
Z2fXsGcjl+Eax+RzOgwOmg: folds
uJVSceLggtsrJya+WtmUEA: raises $2 to $3
XUk5GQsfNFpHvaToDZ0rZA: folds
y27w5IK2WXqmYzS8OU0wKA: folds
Qy/UBNbD2HaA0Ogxg8Sf3w leaves the table
uJVSceLggtsrJya+WtmUEA collected $2.50 from pot
*** SUMMARY ***
Total pot $2.50 | Rake $0
Seat 1: YMJG+F++3Aj6P8dAWda5fw folded before Flop (didn't bet)
Seat 3: Z2fXsGcjl+Eax+RzOgwOmg folded before Flop (didn't bet)
Seat 4: uJVSceLggtsrJya+WtmUEA (button) collected ($2.50)
Seat 5: XUk5GQsfNFpHvaToDZ0rZA (small blind) folded before Flop
Seat 6: y27w5IK2WXqmYzS8OU0wKA (big blind) folded before Flop



PokerStars Game #59940714694:  Hold'em No Limit ($0.50/$1.00) - 2009/07/01 1:14:29 ET
Table 'gxFK0BVUD7cupu2uyRUZJg' 6-max Seat #5 is the button
Seat 1: M+X3uChmP6R63IwijVjgTg ($127.70 in chips)
Seat 2: hpxXcmRkXXI9HE5+5/j/0Q ($121.60 in chips)
Seat 3: Z2fXsGcjl+Eax+RzOgwOmg ($128.25 in chips)
Seat 5: WgIrs6CBinyyw18pqdDtWA ($35.90 in chips)
Seat 6: dYyb6/42PMC8aNFlm/eBeQ ($65.55 in chips)
dYyb6/42PMC8aNFlm/eBeQ: posts small blind $0.50
M+X3uChmP6R63IwijVjgTg: posts big blind $1
*** HOLE CARDS ***
hpxXcmRkXXI9HE5+5/j/0Q: folds
Z2fXsGcjl+Eax+RzOgwOmg: folds
WgIrs6CBinyyw18pqdDtWA: folds
dYyb6/42PMC8aNFlm/eBeQ: calls $0.50
M+X3uChmP6R63IwijVjgTg: checks
*** FLOP *** [Ks 4d 7c]
dYyb6/42PMC8aNFlm/eBeQ: checks
M+X3uChmP6R63IwijVjgTg: bets $2
dYyb6/42PMC8aNFlm/eBeQ: folds
M+X3uChmP6R63IwijVjgTg collected $1.90 from pot
*** SUMMARY ***
Total pot $2 | Rake $0.10
Board [Ks 4d 7c]
Seat 1: M+X3uChmP6R63IwijVjgTg (big blind) collected ($1.90)
Seat 2: hpxXcmRkXXI9HE5+5/j/0Q folded before Flop (didn't bet)
Seat 3: Z2fXsGcjl+Eax+RzOgwOmg folded before Flop (didn't bet)
Seat 5: WgIrs6CBinyyw18pqdDtWA (button) folded before Flop (didn't bet)
Seat 6: dYyb6/42PMC8aNFlm/eBeQ (small blind) folded on the Flop



PokerStars Game #59940715376:  Hold'em No Limit ($0.50/$1.00) - 2009/07/01 1:14:30 ET
Table 'rmZfTK+oSebeUPJNbWhdAA' 6-max Seat #4 is the button
Seat 1: xAU6q2/cwmby2sxmA8VcmA ($148.50 in chips)
Seat 2: z7O9PO/WEcqRouIydFhS9Q ($138.60 in chips)
Seat 3: BCEV3COoKY607AzLWayfRA ($152.80 in chips)
Seat 4: 1/mIuXfgx1ZyVkodrmfQDw ($100 in chips)
Seat 5: 5lY8d6Cnm4HUkt/8FZSj4g ($45.95 in chips)
Seat 6: j7NIOHLZk7V2o9fOioO5ug ($132 in chips)
5lY8d6Cnm4HUkt/8FZSj4g: posts small blind $0.50
j7NIOHLZk7V2o9fOioO5ug: posts big blind $1
*** HOLE CARDS ***
xAU6q2/cwmby2sxmA8VcmA: folds
z7O9PO/WEcqRouIydFhS9Q: folds
BCEV3COoKY607AzLWayfRA: folds
1/mIuXfgx1ZyVkodrmfQDw: folds
5lY8d6Cnm4HUkt/8FZSj4g: calls $0.50
j7NIOHLZk7V2o9fOioO5ug: raises $4 to $5
5lY8d6Cnm4HUkt/8FZSj4g: calls $4
*** FLOP *** [Kd 9c 2d]
5lY8d6Cnm4HUkt/8FZSj4g: checks
j7NIOHLZk7V2o9fOioO5ug: bets $8
5lY8d6Cnm4HUkt/8FZSj4g: folds
j7NIOHLZk7V2o9fOioO5ug collected $9.50 from pot
j7NIOHLZk7V2o9fOioO5ug: doesn't show hand
*** SUMMARY ***
Total pot $10 | Rake $0.50
Board [Kd 9c 2d]
Seat 1: xAU6q2/cwmby2sxmA8VcmA folded before Flop (didn't bet)
Seat 2: z7O9PO/WEcqRouIydFhS9Q folded before Flop (didn't bet)
Seat 3: BCEV3COoKY607AzLWayfRA folded before Flop (didn't bet)
Seat 4: 1/mIuXfgx1ZyVkodrmfQDw (button) folded before Flop (didn't bet)
Seat 5: 5lY8d6Cnm4HUkt/8FZSj4g (small blind) folded on the Flop
Seat 6: j7NIOHLZk7V2o9fOioO5ug (big blind) collected ($9.50)



PokerStars Game #59940718828:  Hold'em No Limit ($0.50/$1.00) - 2009/07/01 1:14:36 ET
Table '3T4owEKJKyGTMePwrv50FQ' 9-max Seat #2 is the button
Seat 1: OGgaARGdJQT4awWVNQ957w ($101.50 in chips)
Seat 2: t+Id2O6herCLgwnC4m49PA ($40.30 in chips)
Seat 3: DOLzOcBTZYcph5jEfKFWuQ ($104.50 in chips)
Seat 4: O5Go3jrzbQWxRB6ESK+Ptg ($30.10 in chips)
Seat 5: eI48VADSCFoNZBx4T9qs2w ($31.85 in chips)
Seat 6: laA8va+Yv8WuMqT1zdR91g ($100 in chips)
Seat 7: 1862487932 ($108.65 in chips)
Seat 8: ucTB8uAUcQnKGsA70OSjNA ($18.50 in chips)
Seat 9: 61sfw5QTu62YYIt68OsdrA ($63.45 in chips)
DOLzOcBTZYcph5jEfKFWuQ: posts small blind $0.50
O5Go3jrzbQWxRB6ESK+Ptg: posts big blind $1
*** HOLE CARDS ***
eI48VADSCFoNZBx4T9qs2w: folds
laA8va+Yv8WuMqT1zdR91g: folds
1862487932: folds
ucTB8uAUcQnKGsA70OSjNA: raises $2 to $3
61sfw5QTu62YYIt68OsdrA: folds
OGgaARGdJQT4awWVNQ957w: folds
OGgaARGdJQT4awWVNQ957w is sitting out
t+Id2O6herCLgwnC4m49PA: folds
DOLzOcBTZYcph5jEfKFWuQ: folds
O5Go3jrzbQWxRB6ESK+Ptg: raises $5 to $8
ucTB8uAUcQnKGsA70OSjNA: folds
O5Go3jrzbQWxRB6ESK+Ptg collected $6.50 from pot
*** SUMMARY ***
Total pot $6.50 | Rake $0
Seat 1: OGgaARGdJQT4awWVNQ957w folded before Flop (didn't bet)
Seat 2: t+Id2O6herCLgwnC4m49PA (button) folded before Flop (didn't bet)
Seat 3: DOLzOcBTZYcph5jEfKFWuQ (small blind) folded before Flop
Seat 4: O5Go3jrzbQWxRB6ESK+Ptg (big blind) collected ($6.50)
Seat 5: eI48VADSCFoNZBx4T9qs2w folded before Flop (didn't bet)
Seat 6: laA8va+Yv8WuMqT1zdR91g folded before Flop (didn't bet)
Seat 7: 1862487932 folded before Flop (didn't bet)
Seat 8: ucTB8uAUcQnKGsA70OSjNA folded before Flop
Seat 9: 61sfw5QTu62YYIt68OsdrA folded before Flop (didn't bet)



PokerStars Game #59940719616:  Hold'em No Limit ($0.50/$1.00) - 2009/07/01 1:14:37 ET
Table 'mmbQQVBTrPdE+wy+s+9VPA' 6-max Seat #5 is the button
Seat 1: zyP4SPoWZnKUfTvIRLCVog ($70.25 in chips)
Seat 2: XK4Qsl+DA8gAJyg85/zBIw ($23.05 in chips)
Seat 3: wx3sQGkVi2x9wJXuWNHPBw ($109.65 in chips)
Seat 4: V3iZdcw61nXF3g5hD2RrsQ ($114.90 in chips)
Seat 5: YMJG+F++3Aj6P8dAWda5fw ($102.10 in chips)
Seat 6: U2CWBTv29qdCbj8RNF2sIw ($103.10 in chips)
U2CWBTv29qdCbj8RNF2sIw: posts small blind $0.50
zyP4SPoWZnKUfTvIRLCVog: posts big blind $1
*** HOLE CARDS ***
XK4Qsl+DA8gAJyg85/zBIw: folds
wx3sQGkVi2x9wJXuWNHPBw: folds
V3iZdcw61nXF3g5hD2RrsQ: folds
YMJG+F++3Aj6P8dAWda5fw: folds
U2CWBTv29qdCbj8RNF2sIw said, "chasing a weaker flush, priceless"
U2CWBTv29qdCbj8RNF2sIw: folds
zyP4SPoWZnKUfTvIRLCVog collected $1 from pot
*** SUMMARY ***
Total pot $1 | Rake $0
Seat 1: zyP4SPoWZnKUfTvIRLCVog (big blind) collected ($1)
Seat 2: XK4Qsl+DA8gAJyg85/zBIw folded before Flop (didn't bet)
Seat 3: wx3sQGkVi2x9wJXuWNHPBw folded before Flop (didn't bet)
Seat 4: V3iZdcw61nXF3g5hD2RrsQ folded before Flop (didn't bet)
Seat 5: YMJG+F++3Aj6P8dAWda5fw (button) folded before Flop (didn't bet)
Seat 6: U2CWBTv29qdCbj8RNF2sIw (small blind) folded before Flop



PokerStars Game #59940720130:  Hold'em No Limit ($0.50/$1.00) - 2009/07/01 1:14:38 ET
Table 'vs/5jr6ciwjVQ5+Soc+u2A' 6-max Seat #4 is the button
Seat 1: J798qwLuvXyq0BbzsIjOrA ($97 in chips)
Seat 2: lXX4W7m3u++JiSOZ46yVMQ ($123.55 in chips)
Seat 3: G5ZSSN6RSON3gkNvk/SmYg ($139.60 in chips)
Seat 4: wk6Ohn4GDozoOMHc4eb2rw ($62.30 in chips)
Seat 5: +Nt3OPk3XR9SKjZgm2CexQ ($113.05 in chips)
Seat 6: Z2fXsGcjl+Eax+RzOgwOmg ($100 in chips)
+Nt3OPk3XR9SKjZgm2CexQ: posts small blind $0.50
Z2fXsGcjl+Eax+RzOgwOmg: posts big blind $1
*** HOLE CARDS ***
J798qwLuvXyq0BbzsIjOrA: folds
lXX4W7m3u++JiSOZ46yVMQ: raises $2 to $3
G5ZSSN6RSON3gkNvk/SmYg: folds
wk6Ohn4GDozoOMHc4eb2rw: folds
+Nt3OPk3XR9SKjZgm2CexQ: calls $2.50
Z2fXsGcjl+Eax+RzOgwOmg: folds
*** FLOP *** [Ks 6d Kd]
+Nt3OPk3XR9SKjZgm2CexQ: checks
lXX4W7m3u++JiSOZ46yVMQ: bets $5
+Nt3OPk3XR9SKjZgm2CexQ: raises $9 to $14
lXX4W7m3u++JiSOZ46yVMQ: calls $9
*** TURN *** [Ks 6d Kd] [9d]
+Nt3OPk3XR9SKjZgm2CexQ: bets $20
lXX4W7m3u++JiSOZ46yVMQ: calls $20
*** RIVER *** [Ks 6d Kd 9d] [4h]
+Nt3OPk3XR9SKjZgm2CexQ: bets $76.05 and is all-in
lXX4W7m3u++JiSOZ46yVMQ: folds
+Nt3OPk3XR9SKjZgm2CexQ collected $72 from pot
+Nt3OPk3XR9SKjZgm2CexQ: doesn't show hand
*** SUMMARY ***
Total pot $75 | Rake $3
Board [Ks 6d Kd 9d 4h]
Seat 1: J798qwLuvXyq0BbzsIjOrA folded before Flop (didn't bet)
Seat 2: lXX4W7m3u++JiSOZ46yVMQ folded on the River
Seat 3: G5ZSSN6RSON3gkNvk/SmYg folded before Flop (didn't bet)
Seat 4: wk6Ohn4GDozoOMHc4eb2rw (button) folded before Flop (didn't bet)
Seat 5: +Nt3OPk3XR9SKjZgm2CexQ (small blind) collected ($72)
Seat 6: Z2fXsGcjl+Eax+RzOgwOmg (big blind) folded before Flop



PokerStars Game #59940719846:  Hold'em No Limit ($0.50/$1.00) - 2009/07/01 1:14:38 ET
Table 'VOs36P6NW+QyXeQ1B62kmA' 6-max Seat #3 is the button
Seat 1: Z2fXsGcjl+Eax+RzOgwOmg ($100 in chips)
Seat 3: FyNUCpzHVyQu/qX8pqNQFA ($108.75 in chips)
Seat 4: w02zQzNydODiyV9THKgo9w ($42.10 in chips)
Seat 5: ozrlafxxh1HmYdA0/h+MuA ($42.75 in chips)
Seat 6: slVKuQyEz8Qj4E3uLPYNXg ($111.85 in chips)
w02zQzNydODiyV9THKgo9w: posts small blind $0.50
ozrlafxxh1HmYdA0/h+MuA: posts big blind $1
y27w5IK2WXqmYzS8OU0wKA: sits out
*** HOLE CARDS ***
slVKuQyEz8Qj4E3uLPYNXg: raises $2 to $3
Z2fXsGcjl+Eax+RzOgwOmg: folds
FyNUCpzHVyQu/qX8pqNQFA: folds
w02zQzNydODiyV9THKgo9w: folds
ozrlafxxh1HmYdA0/h+MuA: folds
slVKuQyEz8Qj4E3uLPYNXg collected $2.50 from pot
slVKuQyEz8Qj4E3uLPYNXg: doesn't show hand
*** SUMMARY ***
Total pot $2.50 | Rake $0
Seat 1: Z2fXsGcjl+Eax+RzOgwOmg folded before Flop (didn't bet)
Seat 3: FyNUCpzHVyQu/qX8pqNQFA (button) folded before Flop (didn't bet)
Seat 4: w02zQzNydODiyV9THKgo9w (small blind) folded before Flop
Seat 5: ozrlafxxh1HmYdA0/h+MuA (big blind) folded before Flop
Seat 6: slVKuQyEz8Qj4E3uLPYNXg collected ($2.50)



PokerStars Game #59940720932:  Hold'em No Limit ($0.50/$1.00) - 2009/07/01 1:14:39 ET
Table 'O96CPOtvMBWP6kzuYDfdFA' 6-max Seat #3 is the button
Seat 1: 6alLXQIITA2EZ/lBeym8Dw ($117.55 in chips)
Seat 2: 4d1rWhpu8DzLmzMbR3QKyA ($111.35 in chips)
Seat 3: V89DGjxE171oPREEbAXiyg ($89.10 in chips)
Seat 4: /P4w1pHg2zHYg/4ubJ0dPw ($60 in chips)
Seat 5: G5ZSSN6RSON3gkNvk/SmYg ($100 in chips)
Seat 6: GYei5jXGWexiJYbAT2fELg ($41.65 in chips)
/P4w1pHg2zHYg/4ubJ0dPw: posts small blind $0.50
G5ZSSN6RSON3gkNvk/SmYg: posts big blind $1
*** HOLE CARDS ***
GYei5jXGWexiJYbAT2fELg: folds
6alLXQIITA2EZ/lBeym8Dw: folds
4d1rWhpu8DzLmzMbR3QKyA: folds
V89DGjxE171oPREEbAXiyg: folds
/P4w1pHg2zHYg/4ubJ0dPw: folds
G5ZSSN6RSON3gkNvk/SmYg collected $1 from pot
*** SUMMARY ***
Total pot $1 | Rake $0
Seat 1: 6alLXQIITA2EZ/lBeym8Dw folded before Flop (didn't bet)
Seat 2: 4d1rWhpu8DzLmzMbR3QKyA folded before Flop (didn't bet)
Seat 3: V89DGjxE171oPREEbAXiyg (button) folded before Flop (didn't bet)
Seat 4: /P4w1pHg2zHYg/4ubJ0dPw (small blind) folded before Flop
Seat 5: G5ZSSN6RSON3gkNvk/SmYg (big blind) collected ($1)
Seat 6: GYei5jXGWexiJYbAT2fELg folded before Flop (didn't bet)



PokerStars Game #59940722234:  Hold'em No Limit ($0.50/$1.00) - 2009/07/01 1:14:42 ET
Table 'hugOjcwJvzEwZbK7tyiWuQ' 9-max Seat #6 is the button
Seat 1: S3Ex8K7v6xm5jqjRM7Fl3w ($22 in chips)
Seat 2: r27C1nIV4NS4+qbnrgBQSw ($281.70 in chips)
Seat 4: UWB3oeddt/GObx2Mix2Anw ($171.30 in chips)
Seat 5: 5BRGWf+R3nt2WS3b5xX+zA ($26.35 in chips)
Seat 6: gUUvmqdVlmvpal6B8nYrmg ($100 in chips)
Seat 7: FL3MrLspcF23LYvC4ipBOA ($109.30 in chips)
Seat 8: /zy+DB4S5fUQUSfZWFzYGw ($112.55 in chips)
Seat 9: W8P9bUKCs43TO1xHm0dL6w ($89.45 in chips)
FL3MrLspcF23LYvC4ipBOA: posts small blind $0.50
/zy+DB4S5fUQUSfZWFzYGw: posts big blind $1
*** HOLE CARDS ***
W8P9bUKCs43TO1xHm0dL6w: folds
S3Ex8K7v6xm5jqjRM7Fl3w: folds
r27C1nIV4NS4+qbnrgBQSw: folds
UWB3oeddt/GObx2Mix2Anw: folds
5BRGWf+R3nt2WS3b5xX+zA: folds
gUUvmqdVlmvpal6B8nYrmg: raises $1 to $2
FL3MrLspcF23LYvC4ipBOA: folds
/zy+DB4S5fUQUSfZWFzYGw: folds
gUUvmqdVlmvpal6B8nYrmg collected $2.50 from pot
*** SUMMARY ***
Total pot $2.50 | Rake $0
Seat 1: S3Ex8K7v6xm5jqjRM7Fl3w folded before Flop (didn't bet)
Seat 2: r27C1nIV4NS4+qbnrgBQSw folded before Flop (didn't bet)
Seat 4: UWB3oeddt/GObx2Mix2Anw folded before Flop (didn't bet)
Seat 5: 5BRGWf+R3nt2WS3b5xX+zA folded before Flop (didn't bet)
Seat 6: gUUvmqdVlmvpal6B8nYrmg (button) collected ($2.50)
Seat 7: FL3MrLspcF23LYvC4ipBOA (small blind) folded before Flop
Seat 8: /zy+DB4S5fUQUSfZWFzYGw (big blind) folded before Flop
Seat 9: W8P9bUKCs43TO1xHm0dL6w folded before Flop (didn't bet)



PokerStars Game #59940725326:  Hold'em No Limit ($0.50/$1.00) - 2009/07/01 1:14:47 ET
Table 'MUPc8FEpe/nR0BKSeReX6Q' 6-max Seat #2 is the button
Seat 1: qhkK6+yCciTRd+rCFEbnEQ ($42.10 in chips)
Seat 2: xAU6q2/cwmby2sxmA8VcmA ($114.70 in chips)
Seat 3: wx3sQGkVi2x9wJXuWNHPBw ($215 in chips)
Seat 4: ZA1bp6g8IwtTxkUE4eCjDQ ($195.30 in chips)
Seat 6: oxnw0GLLpFanjhGkxfRSqA ($58.15 in chips)
wx3sQGkVi2x9wJXuWNHPBw: posts small blind $0.50
ZA1bp6g8IwtTxkUE4eCjDQ: posts big blind $1
y27w5IK2WXqmYzS8OU0wKA: sits out
*** HOLE CARDS ***
oxnw0GLLpFanjhGkxfRSqA: folds
qhkK6+yCciTRd+rCFEbnEQ: raises $3 to $4
xAU6q2/cwmby2sxmA8VcmA: folds
wx3sQGkVi2x9wJXuWNHPBw: folds
ZA1bp6g8IwtTxkUE4eCjDQ: folds
qhkK6+yCciTRd+rCFEbnEQ collected $2.50 from pot
qhkK6+yCciTRd+rCFEbnEQ: doesn't show hand
*** SUMMARY ***
Total pot $2.50 | Rake $0
Seat 1: qhkK6+yCciTRd+rCFEbnEQ collected ($2.50)
Seat 2: xAU6q2/cwmby2sxmA8VcmA (button) folded before Flop (didn't bet)
Seat 3: wx3sQGkVi2x9wJXuWNHPBw (small blind) folded before Flop
Seat 4: ZA1bp6g8IwtTxkUE4eCjDQ (big blind) folded before Flop
Seat 6: oxnw0GLLpFanjhGkxfRSqA folded before Flop (didn't bet)



PokerStars Game #59940725062:  Hold'em No Limit ($0.50/$1.00) - 2009/07/01 1:14:47 ET
Table 'QSIig7BLMc9wY/rgBechzw' 6-max Seat #6 is the button
Seat 1: Z2fXsGcjl+Eax+RzOgwOmg ($112.50 in chips)
Seat 2: mLOIkH/qmRa+mVujQIhBRg ($35.30 in chips)
Seat 3: +xW7QemQU0Fxs+4TnqBRow ($101.35 in chips)
Seat 4: +uSzP8Jwnw7sKfQ4s66b7w ($76.95 in chips)
Seat 5: lsLuWlcPA3Rh7kJVLzMh0Q ($111.95 in chips)
Seat 6: PxqfkAMdAWtkgbT+q2gciA ($32.50 in chips)
Z2fXsGcjl+Eax+RzOgwOmg: posts small blind $0.50
mLOIkH/qmRa+mVujQIhBRg: posts big blind $1
*** HOLE CARDS ***
+xW7QemQU0Fxs+4TnqBRow: folds
+uSzP8Jwnw7sKfQ4s66b7w: folds
lsLuWlcPA3Rh7kJVLzMh0Q: raises $2 to $3
PxqfkAMdAWtkgbT+q2gciA: calls $3
Z2fXsGcjl+Eax+RzOgwOmg: folds
mLOIkH/qmRa+mVujQIhBRg: folds
*** FLOP *** [Th Ad 9d]
lsLuWlcPA3Rh7kJVLzMh0Q: checks
PxqfkAMdAWtkgbT+q2gciA: bets $4
lsLuWlcPA3Rh7kJVLzMh0Q: folds
PxqfkAMdAWtkgbT+q2gciA collected $7.15 from pot
PxqfkAMdAWtkgbT+q2gciA: doesn't show hand
*** SUMMARY ***
Total pot $7.50 | Rake $0.35
Board [Th Ad 9d]
Seat 1: Z2fXsGcjl+Eax+RzOgwOmg (small blind) folded before Flop
Seat 2: mLOIkH/qmRa+mVujQIhBRg (big blind) folded before Flop
Seat 3: +xW7QemQU0Fxs+4TnqBRow folded before Flop (didn't bet)
Seat 4: +uSzP8Jwnw7sKfQ4s66b7w folded before Flop (didn't bet)
Seat 5: lsLuWlcPA3Rh7kJVLzMh0Q folded on the Flop
Seat 6: PxqfkAMdAWtkgbT+q2gciA (button) collected ($7.15)



PokerStars Game #59940726054:  Hold'em No Limit ($0.50/$1.00) - 2009/07/01 1:14:48 ET
Table 'JTT1XWaDZHSaMZQK7cR5uw' 2-max Seat #1 is the button
Seat 1: OLplZF6FEnLflv81Hz+Fxg ($148.65 in chips)
Seat 2: mgi+mjKb1Sc3CCs7TlfoCw ($100.90 in chips)
OLplZF6FEnLflv81Hz+Fxg: posts small blind $0.50
mgi+mjKb1Sc3CCs7TlfoCw: posts big blind $1
*** HOLE CARDS ***
OLplZF6FEnLflv81Hz+Fxg: folds
mgi+mjKb1Sc3CCs7TlfoCw collected $1 from pot
mgi+mjKb1Sc3CCs7TlfoCw: doesn't show hand
*** SUMMARY ***
Total pot $1 | Rake $0
Seat 1: OLplZF6FEnLflv81Hz+Fxg (button) (small blind) folded before Flop
Seat 2: mgi+mjKb1Sc3CCs7TlfoCw (big blind) collected ($1)



PokerStars Game #59940725950:  Hold'em No Limit ($0.50/$1.00) - 2009/07/01 1:14:48 ET
Table 'hdVBCnDy5t2X9dZo0AvD9w' 9-max Seat #1 is the button
Seat 1: sa/cZBFh73L9TapFXpn3BA ($68.85 in chips)
Seat 2: Ogn4JDV3mp4ZDKO49IFzKA ($21 in chips)
Seat 3: 1862487932 ($100 in chips)
Seat 4: YvSugbFKWSuAYx9iokQwUQ ($73.20 in chips)
Seat 5: H+DVy3Ei8L1UKS2tVOtJcw ($100 in chips)
Seat 6: bJckevFOcg//s0qyMQI6sQ ($100 in chips)
Seat 7: KqC3XiX79XzqwhoOYPVb4w ($163.05 in chips)
Seat 8: gUUvmqdVlmvpal6B8nYrmg ($142.90 in chips)
Seat 9: AMkLbywdoc0K30BTzaIfTQ ($186.40 in chips)
Ogn4JDV3mp4ZDKO49IFzKA: posts small blind $0.50
1862487932: posts big blind $1
*** HOLE CARDS ***
YvSugbFKWSuAYx9iokQwUQ: folds
H+DVy3Ei8L1UKS2tVOtJcw: folds
bJckevFOcg//s0qyMQI6sQ: folds
KqC3XiX79XzqwhoOYPVb4w: folds
gUUvmqdVlmvpal6B8nYrmg: folds
AMkLbywdoc0K30BTzaIfTQ: raises $2 to $3
sa/cZBFh73L9TapFXpn3BA: calls $3
Ogn4JDV3mp4ZDKO49IFzKA: folds
1862487932: calls $2
*** FLOP *** [Qh 6d 7s]
1862487932: checks
AMkLbywdoc0K30BTzaIfTQ: checks
sa/cZBFh73L9TapFXpn3BA: bets $5
1862487932: folds
AMkLbywdoc0K30BTzaIfTQ: folds
sa/cZBFh73L9TapFXpn3BA collected $9.05 from pot
*** SUMMARY ***
Total pot $9.50 | Rake $0.45
Board [Qh 6d 7s]
Seat 1: sa/cZBFh73L9TapFXpn3BA (button) collected ($9.05)
Seat 2: Ogn4JDV3mp4ZDKO49IFzKA (small blind) folded before Flop
Seat 3: 1862487932 (big blind) folded on the Flop
Seat 4: YvSugbFKWSuAYx9iokQwUQ folded before Flop (didn't bet)
Seat 5: H+DVy3Ei8L1UKS2tVOtJcw folded before Flop (didn't bet)
Seat 6: bJckevFOcg//s0qyMQI6sQ folded before Flop (didn't bet)
Seat 7: KqC3XiX79XzqwhoOYPVb4w folded before Flop (didn't bet)
Seat 8: gUUvmqdVlmvpal6B8nYrmg folded before Flop (didn't bet)
Seat 9: AMkLbywdoc0K30BTzaIfTQ folded on the Flop



PokerStars Game #59940728462:  Hold'em No Limit ($0.50/$1.00) - 2009/07/01 1:14:52 ET
Table 'pHrhryH8jPNdQfY62f8v+g' 6-max Seat #1 is the button
Seat 1: 4d1rWhpu8DzLmzMbR3QKyA ($106.70 in chips)
Seat 2: JwCcjZl0bjJzG7hmE0dnTA ($100 in chips)
Seat 3: 8oS5O7iD/qnFXFXJrGIgNQ ($100 in chips)
Seat 4: 1f3beyIML24UqEMTbWy93g ($48.15 in chips)
Seat 5: r1/R7y0Ortgoz4lccgW8VA ($44.95 in chips)
Seat 6: xAU6q2/cwmby2sxmA8VcmA ($206.60 in chips)
JwCcjZl0bjJzG7hmE0dnTA: posts small blind $0.50
8oS5O7iD/qnFXFXJrGIgNQ: posts big blind $1
*** HOLE CARDS ***
1f3beyIML24UqEMTbWy93g: calls $1
r1/R7y0Ortgoz4lccgW8VA: calls $1
xAU6q2/cwmby2sxmA8VcmA: folds
4d1rWhpu8DzLmzMbR3QKyA: raises $4 to $5
JwCcjZl0bjJzG7hmE0dnTA: folds
8oS5O7iD/qnFXFXJrGIgNQ: folds
1f3beyIML24UqEMTbWy93g: calls $4
r1/R7y0Ortgoz4lccgW8VA: calls $4
*** FLOP *** [Td Ac 6d]
1f3beyIML24UqEMTbWy93g: checks
r1/R7y0Ortgoz4lccgW8VA: checks
4d1rWhpu8DzLmzMbR3QKyA: checks
*** TURN *** [Td Ac 6d] [8h]
1f3beyIML24UqEMTbWy93g: checks
r1/R7y0Ortgoz4lccgW8VA: checks
4d1rWhpu8DzLmzMbR3QKyA: bets $10
1f3beyIML24UqEMTbWy93g: folds
r1/R7y0Ortgoz4lccgW8VA: folds
4d1rWhpu8DzLmzMbR3QKyA collected $15.70 from pot
*** SUMMARY ***
Total pot $16.50 | Rake $0.80
Board [Td Ac 6d 8h]
Seat 1: 4d1rWhpu8DzLmzMbR3QKyA (button) collected ($15.70)
Seat 2: JwCcjZl0bjJzG7hmE0dnTA (small blind) folded before Flop
Seat 3: 8oS5O7iD/qnFXFXJrGIgNQ (big blind) folded before Flop
Seat 4: 1f3beyIML24UqEMTbWy93g folded on the Turn
Seat 5: r1/R7y0Ortgoz4lccgW8VA folded on the Turn
Seat 6: xAU6q2/cwmby2sxmA8VcmA folded before Flop (didn't bet)



PokerStars Game #59940728092:  Hold'em No Limit ($0.50/$1.00) - 2009/07/01 1:14:52 ET
Table 'fTlPiCj0utgzC/5io+I7ew' 6-max Seat #5 is the button
Seat 1: YMJG+F++3Aj6P8dAWda5fw ($102.85 in chips)
Seat 3: Z2fXsGcjl+Eax+RzOgwOmg ($101 in chips)
Seat 4: uJVSceLggtsrJya+WtmUEA ($175.15 in chips)
Seat 5: XUk5GQsfNFpHvaToDZ0rZA ($50 in chips)
Seat 6: y27w5IK2WXqmYzS8OU0wKA ($100 in chips)
y27w5IK2WXqmYzS8OU0wKA: posts small blind $0.50
YMJG+F++3Aj6P8dAWda5fw: posts big blind $1
*** HOLE CARDS ***
Z2fXsGcjl+Eax+RzOgwOmg: folds
uJVSceLggtsrJya+WtmUEA: folds
XUk5GQsfNFpHvaToDZ0rZA: raises $2 to $3
y27w5IK2WXqmYzS8OU0wKA: folds
YMJG+F++3Aj6P8dAWda5fw: folds
XUk5GQsfNFpHvaToDZ0rZA collected $2.50 from pot
*** SUMMARY ***
Total pot $2.50 | Rake $0
Seat 1: YMJG+F++3Aj6P8dAWda5fw (big blind) folded before Flop
Seat 3: Z2fXsGcjl+Eax+RzOgwOmg folded before Flop (didn't bet)
Seat 4: uJVSceLggtsrJya+WtmUEA folded before Flop (didn't bet)
Seat 5: XUk5GQsfNFpHvaToDZ0rZA (button) collected ($2.50)
Seat 6: y27w5IK2WXqmYzS8OU0wKA (small blind) folded before Flop



PokerStars Game #59940728440:  Hold'em No Limit ($0.50/$1.00) - 2009/07/01 1:14:52 ET
Table 'gxFK0BVUD7cupu2uyRUZJg' 6-max Seat #6 is the button
Seat 1: M+X3uChmP6R63IwijVjgTg ($128.60 in chips)
Seat 2: hpxXcmRkXXI9HE5+5/j/0Q ($121.60 in chips)
Seat 3: Z2fXsGcjl+Eax+RzOgwOmg ($128.25 in chips)
Seat 5: WgIrs6CBinyyw18pqdDtWA ($35.90 in chips)
Seat 6: dYyb6/42PMC8aNFlm/eBeQ ($64.55 in chips)
M+X3uChmP6R63IwijVjgTg: posts small blind $0.50
hpxXcmRkXXI9HE5+5/j/0Q: posts big blind $1
*** HOLE CARDS ***
Z2fXsGcjl+Eax+RzOgwOmg: folds
WgIrs6CBinyyw18pqdDtWA: calls $1
dYyb6/42PMC8aNFlm/eBeQ: calls $1
M+X3uChmP6R63IwijVjgTg: calls $0.50
hpxXcmRkXXI9HE5+5/j/0Q: checks
*** FLOP *** [3h Qs Ks]
M+X3uChmP6R63IwijVjgTg: checks
hpxXcmRkXXI9HE5+5/j/0Q: checks
WgIrs6CBinyyw18pqdDtWA: checks
dYyb6/42PMC8aNFlm/eBeQ: bets $2
M+X3uChmP6R63IwijVjgTg: folds
hpxXcmRkXXI9HE5+5/j/0Q: folds
WgIrs6CBinyyw18pqdDtWA: folds
dYyb6/42PMC8aNFlm/eBeQ collected $3.80 from pot
dYyb6/42PMC8aNFlm/eBeQ: doesn't show hand
*** SUMMARY ***
Total pot $4 | Rake $0.20
Board [3h Qs Ks]
Seat 1: M+X3uChmP6R63IwijVjgTg (small blind) folded on the Flop
Seat 2: hpxXcmRkXXI9HE5+5/j/0Q (big blind) folded on the Flop
Seat 3: Z2fXsGcjl+Eax+RzOgwOmg folded before Flop (didn't bet)
Seat 5: WgIrs6CBinyyw18pqdDtWA folded on the Flop
Seat 6: dYyb6/42PMC8aNFlm/eBeQ (button) collected ($3.80)



PokerStars Game #59940729256:  Hold'em No Limit ($0.50/$1.00) - 2009/07/01 1:14:54 ET
Table 'SQLOQoANiHscJ8AL7zffbw' 9-max Seat #8 is the button
Seat 1: jPTRd6SpCp4xqAy2XQiTOw ($66.90 in chips)
Seat 2: /zy+DB4S5fUQUSfZWFzYGw ($329.05 in chips)
Seat 3: 0eFnow7+D7veCYQ+CG9FFw ($103 in chips)
Seat 5: L9njYvloJ1NdXjP8edHEAg ($107.65 in chips)
Seat 6: H+DVy3Ei8L1UKS2tVOtJcw ($100 in chips)
Seat 7: bJckevFOcg//s0qyMQI6sQ ($103.05 in chips)
Seat 8: 2BV+oJIQYr65IO6nEChvbA ($60 in chips)
Seat 9: qJr25HAtvv1w/7IBvjMM3g ($199.15 in chips)
qJr25HAtvv1w/7IBvjMM3g: posts small blind $0.50
jPTRd6SpCp4xqAy2XQiTOw: posts big blind $1
*** HOLE CARDS ***
/zy+DB4S5fUQUSfZWFzYGw: raises $2 to $3
0eFnow7+D7veCYQ+CG9FFw: folds
L9njYvloJ1NdXjP8edHEAg: raises $6 to $9
H+DVy3Ei8L1UKS2tVOtJcw: folds
bJckevFOcg//s0qyMQI6sQ: folds
2BV+oJIQYr65IO6nEChvbA: calls $9
qJr25HAtvv1w/7IBvjMM3g: folds
jPTRd6SpCp4xqAy2XQiTOw: folds
/zy+DB4S5fUQUSfZWFzYGw: calls $6
*** FLOP *** [5d 7d 9h]
/zy+DB4S5fUQUSfZWFzYGw: checks
L9njYvloJ1NdXjP8edHEAg: checks
2BV+oJIQYr65IO6nEChvbA: bets $18
/zy+DB4S5fUQUSfZWFzYGw: calls $18
L9njYvloJ1NdXjP8edHEAg: folds
*** TURN *** [5d 7d 9h] [Jd]
5z1PAR8SNow/zUfYNbwq7A joins the table at seat #4
/zy+DB4S5fUQUSfZWFzYGw: checks
2BV+oJIQYr65IO6nEChvbA: bets $33 and is all-in
/zy+DB4S5fUQUSfZWFzYGw: calls $33
*** RIVER *** [5d 7d 9h Jd] [5h]
*** SHOW DOWN ***
/zy+DB4S5fUQUSfZWFzYGw: shows [9d 9c] (a full house, Nines full of Fives)
2BV+oJIQYr65IO6nEChvbA: mucks hand
/zy+DB4S5fUQUSfZWFzYGw collected $127.50 from pot
*** SUMMARY ***
Total pot $130.50 | Rake $3
Board [5d 7d 9h Jd 5h]
Seat 1: jPTRd6SpCp4xqAy2XQiTOw (big blind) folded before Flop
Seat 2: /zy+DB4S5fUQUSfZWFzYGw showed [9d 9c] and won ($127.50) with a full house, Nines full of Fives
Seat 3: 0eFnow7+D7veCYQ+CG9FFw folded before Flop (didn't bet)
Seat 5: L9njYvloJ1NdXjP8edHEAg folded on the Flop
Seat 6: H+DVy3Ei8L1UKS2tVOtJcw folded before Flop (didn't bet)
Seat 7: bJckevFOcg//s0qyMQI6sQ folded before Flop (didn't bet)
Seat 8: 2BV+oJIQYr65IO6nEChvbA (button) mucked
Seat 9: qJr25HAtvv1w/7IBvjMM3g (small blind) folded before Flop



PokerStars Game #59940729746:  Hold'em No Limit ($0.50/$1.00) - 2009/07/01 1:14:55 ET
Table 'W/wyObTiXZm+Ckkl3YxcSw' 6-max Seat #4 is the button
Seat 1: eUBBn2R56C1IQ6Cs/vitwg ($170.25 in chips)
Seat 2: oDiBRCaF0QVtd3kO6xZIXw ($169.65 in chips)
Seat 3: dxyNCn/qxfkGDUIf28Cbng ($66.65 in chips)
Seat 4: aYii2DmxlOlbC1wbGRBWvQ ($113.15 in chips)
Seat 5: +OrCjyw70oZhJiD22Mn+bg ($100 in chips)
Seat 6: b2a+5TkFf4xJN/Ihhma58Q ($40 in chips)
+OrCjyw70oZhJiD22Mn+bg: posts small blind $0.50
b2a+5TkFf4xJN/Ihhma58Q: posts big blind $1
*** HOLE CARDS ***
eUBBn2R56C1IQ6Cs/vitwg: raises $3 to $4
oDiBRCaF0QVtd3kO6xZIXw: folds
dxyNCn/qxfkGDUIf28Cbng: folds
aYii2DmxlOlbC1wbGRBWvQ: folds
+OrCjyw70oZhJiD22Mn+bg: folds
b2a+5TkFf4xJN/Ihhma58Q: folds
eUBBn2R56C1IQ6Cs/vitwg collected $2.50 from pot
*** SUMMARY ***
Total pot $2.50 | Rake $0
Seat 1: eUBBn2R56C1IQ6Cs/vitwg collected ($2.50)
Seat 2: oDiBRCaF0QVtd3kO6xZIXw folded before Flop (didn't bet)
Seat 3: dxyNCn/qxfkGDUIf28Cbng folded before Flop (didn't bet)
Seat 4: aYii2DmxlOlbC1wbGRBWvQ (button) folded before Flop (didn't bet)
Seat 5: +OrCjyw70oZhJiD22Mn+bg (small blind) folded before Flop
Seat 6: b2a+5TkFf4xJN/Ihhma58Q (big blind) folded before Flop



PokerStars Game #59940730962:  Hold'em No Limit ($0.50/$1.00) - 2009/07/01 1:14:57 ET
Table 'JTT1XWaDZHSaMZQK7cR5uw' 2-max Seat #2 is the button
Seat 1: OLplZF6FEnLflv81Hz+Fxg ($148.15 in chips)
Seat 2: mgi+mjKb1Sc3CCs7TlfoCw ($101.40 in chips)
mgi+mjKb1Sc3CCs7TlfoCw: posts small blind $0.50
OLplZF6FEnLflv81Hz+Fxg: posts big blind $1
*** HOLE CARDS ***
mgi+mjKb1Sc3CCs7TlfoCw: raises $2 to $3
OLplZF6FEnLflv81Hz+Fxg: folds
mgi+mjKb1Sc3CCs7TlfoCw collected $2 from pot
mgi+mjKb1Sc3CCs7TlfoCw: doesn't show hand
*** SUMMARY ***
Total pot $2 | Rake $0
Seat 1: OLplZF6FEnLflv81Hz+Fxg (big blind) folded before Flop
Seat 2: mgi+mjKb1Sc3CCs7TlfoCw (button) (small blind) collected ($2)



PokerStars Game #59940730878:  Hold'em No Limit ($0.50/$1.00) - 2009/07/01 1:14:57 ET
Table 'VOs36P6NW+QyXeQ1B62kmA' 6-max Seat #4 is the button
Seat 1: Z2fXsGcjl+Eax+RzOgwOmg ($100 in chips)
Seat 3: FyNUCpzHVyQu/qX8pqNQFA ($108.75 in chips)
Seat 4: w02zQzNydODiyV9THKgo9w ($41.60 in chips)
Seat 5: ozrlafxxh1HmYdA0/h+MuA ($41.75 in chips)
Seat 6: slVKuQyEz8Qj4E3uLPYNXg ($113.35 in chips)
ozrlafxxh1HmYdA0/h+MuA: posts small blind $0.50
slVKuQyEz8Qj4E3uLPYNXg: posts big blind $1
y27w5IK2WXqmYzS8OU0wKA: sits out
*** HOLE CARDS ***
Z2fXsGcjl+Eax+RzOgwOmg: raises $3 to $4
FyNUCpzHVyQu/qX8pqNQFA: folds
w02zQzNydODiyV9THKgo9w: folds
FyNUCpzHVyQu/qX8pqNQFA leaves the table
ozrlafxxh1HmYdA0/h+MuA: folds
slVKuQyEz8Qj4E3uLPYNXg: folds
Z2fXsGcjl+Eax+RzOgwOmg collected $2.50 from pot
Z2fXsGcjl+Eax+RzOgwOmg: doesn't show hand
*** SUMMARY ***
Total pot $2.50 | Rake $0
Seat 1: Z2fXsGcjl+Eax+RzOgwOmg collected ($2.50)
Seat 3: FyNUCpzHVyQu/qX8pqNQFA folded before Flop (didn't bet)
Seat 4: w02zQzNydODiyV9THKgo9w (button) folded before Flop (didn't bet)
Seat 5: ozrlafxxh1HmYdA0/h+MuA (small blind) folded before Flop
Seat 6: slVKuQyEz8Qj4E3uLPYNXg (big blind) folded before Flop



PokerStars Game #59940734612:  Hold'em No Limit ($0.50/$1.00) - 2009/07/01 1:15:03 ET
Table 'GPp0HyAuggN8oE0sUWzPpA' 9-max Seat #4 is the button
Seat 1: qJr25HAtvv1w/7IBvjMM3g ($40.20 in chips)
Seat 2: m3U8I35Pn3gxKhoS2nmYIg ($13.40 in chips)
Seat 3: CCCXsirC+bO7ginAuUUVlQ ($59.25 in chips)
Seat 4: mBRWbnUl8diyBO1qTJaNzw ($101.65 in chips)
Seat 5: bLbSOSmSOnqE0iTcH/5dxA ($100 in chips)
Seat 6: BK/GtNPkSx0TdUDj82id5A ($37.70 in chips)
Seat 7: DHdbHyysD15wCAtx+BhUjA ($93.50 in chips)
Seat 9: dzoSjPZmtjGuK83119030A ($34.15 in chips)
bLbSOSmSOnqE0iTcH/5dxA: posts small blind $0.50
BK/GtNPkSx0TdUDj82id5A: posts big blind $1
P/6qLjycEfxRgZ5F/W90dw: sits out
*** HOLE CARDS ***
DHdbHyysD15wCAtx+BhUjA: raises $2 to $3
dzoSjPZmtjGuK83119030A: folds
qJr25HAtvv1w/7IBvjMM3g: folds
m3U8I35Pn3gxKhoS2nmYIg: folds
CCCXsirC+bO7ginAuUUVlQ: folds
mBRWbnUl8diyBO1qTJaNzw: folds
bLbSOSmSOnqE0iTcH/5dxA: folds
BK/GtNPkSx0TdUDj82id5A: calls $2
*** FLOP *** [4s 8s Kh]
BK/GtNPkSx0TdUDj82id5A: checks
DHdbHyysD15wCAtx+BhUjA: bets $4
BK/GtNPkSx0TdUDj82id5A: folds
DHdbHyysD15wCAtx+BhUjA collected $6.20 from pot
*** SUMMARY ***
Total pot $6.50 | Rake $0.30
Board [4s 8s Kh]
Seat 1: qJr25HAtvv1w/7IBvjMM3g folded before Flop (didn't bet)
Seat 2: m3U8I35Pn3gxKhoS2nmYIg folded before Flop (didn't bet)
Seat 3: CCCXsirC+bO7ginAuUUVlQ folded before Flop (didn't bet)
Seat 4: mBRWbnUl8diyBO1qTJaNzw (button) folded before Flop (didn't bet)
Seat 5: bLbSOSmSOnqE0iTcH/5dxA (small blind) folded before Flop
Seat 6: BK/GtNPkSx0TdUDj82id5A (big blind) folded on the Flop
Seat 7: DHdbHyysD15wCAtx+BhUjA collected ($6.20)
Seat 9: dzoSjPZmtjGuK83119030A folded before Flop (didn't bet)



PokerStars Game #59940734516:  Hold'em No Limit ($0.50/$1.00) - 2009/07/01 1:15:03 ET
Table '7Nl0ffnjeK44/vmeexh3MQ' 9-max Seat #4 is the button
Seat 1: V138SURkdX8LdVBPKdJJag ($100 in chips)
Seat 3: JMmUYT5pIKCKh2pGjCB/4w ($55.50 in chips)
Seat 4: bLbSOSmSOnqE0iTcH/5dxA ($100 in chips)
Seat 5: 61sfw5QTu62YYIt68OsdrA ($82 in chips)
Seat 6: FVs16t7GgfWgQWt4JxsObQ ($30.35 in chips)
Seat 7: 997ViqAtWn1FPjJqcffwcA ($100 in chips)
Seat 8: D+W9Me7w6Hcx/WRUSKV0dw ($18.25 in chips)
Seat 9: ouwUBGRKnKK9uhn1G4Lf+A ($194 in chips)
61sfw5QTu62YYIt68OsdrA: posts small blind $0.50
FVs16t7GgfWgQWt4JxsObQ: posts big blind $1
*** HOLE CARDS ***
997ViqAtWn1FPjJqcffwcA: folds
D+W9Me7w6Hcx/WRUSKV0dw: folds
ouwUBGRKnKK9uhn1G4Lf+A: folds
V138SURkdX8LdVBPKdJJag: raises $2.50 to $3.50
JMmUYT5pIKCKh2pGjCB/4w: folds
bLbSOSmSOnqE0iTcH/5dxA: folds
61sfw5QTu62YYIt68OsdrA: folds
FVs16t7GgfWgQWt4JxsObQ: folds
V138SURkdX8LdVBPKdJJag collected $2.50 from pot
V138SURkdX8LdVBPKdJJag: doesn't show hand
*** SUMMARY ***
Total pot $2.50 | Rake $0
Seat 1: V138SURkdX8LdVBPKdJJag collected ($2.50)
Seat 3: JMmUYT5pIKCKh2pGjCB/4w folded before Flop (didn't bet)
Seat 4: bLbSOSmSOnqE0iTcH/5dxA (button) folded before Flop (didn't bet)
Seat 5: 61sfw5QTu62YYIt68OsdrA (small blind) folded before Flop
Seat 6: FVs16t7GgfWgQWt4JxsObQ (big blind) folded before Flop
Seat 7: 997ViqAtWn1FPjJqcffwcA folded before Flop (didn't bet)
Seat 8: D+W9Me7w6Hcx/WRUSKV0dw folded before Flop (didn't bet)
Seat 9: ouwUBGRKnKK9uhn1G4Lf+A folded before Flop (didn't bet)



PokerStars Game #59940734718:  Hold'em No Limit ($0.50/$1.00) - 2009/07/01 1:15:03 ET
Table 'cKH9c4x6u79IqCdaKKvXrw' 9-max Seat #4 is the button
Seat 1: Pp/KTcXkfZKKUHkjyaLTdg ($18.50 in chips)
Seat 2: 8S3JMH4TY3whgIlZmMv66w ($60.70 in chips)
Seat 3: 997ViqAtWn1FPjJqcffwcA ($154.10 in chips)
Seat 4: FL3MrLspcF23LYvC4ipBOA ($100 in chips)
Seat 5: Jjc7EHWzs4//xUAjJ0UWoA ($43.40 in chips)
Seat 6: Bsd/K5gAcLanYbGiPirRjw ($208.05 in chips)
Seat 7: 1GkkVBhlJ92guE6K5mS5Ig ($16.40 in chips)
Seat 8: myIxN7otsyr846M539YR8Q ($31.35 in chips)
Seat 9: 6XkTu4ahxzHnvjjc1R8YjQ ($37.10 in chips)
Jjc7EHWzs4//xUAjJ0UWoA: posts small blind $0.50
Bsd/K5gAcLanYbGiPirRjw: posts big blind $1
*** HOLE CARDS ***
1GkkVBhlJ92guE6K5mS5Ig: folds
myIxN7otsyr846M539YR8Q: folds
6XkTu4ahxzHnvjjc1R8YjQ: folds
Pp/KTcXkfZKKUHkjyaLTdg: folds
8S3JMH4TY3whgIlZmMv66w: calls $1
997ViqAtWn1FPjJqcffwcA: folds
FL3MrLspcF23LYvC4ipBOA: folds
Jjc7EHWzs4//xUAjJ0UWoA: calls $0.50
Bsd/K5gAcLanYbGiPirRjw: checks
*** FLOP *** [4s 8d 3h]
Jjc7EHWzs4//xUAjJ0UWoA: checks
Bsd/K5gAcLanYbGiPirRjw: checks
8S3JMH4TY3whgIlZmMv66w: checks
*** TURN *** [4s 8d 3h] [3c]
Jjc7EHWzs4//xUAjJ0UWoA: checks
Bsd/K5gAcLanYbGiPirRjw: checks
8S3JMH4TY3whgIlZmMv66w: bets $2
Jjc7EHWzs4//xUAjJ0UWoA: folds
Bsd/K5gAcLanYbGiPirRjw: folds
8S3JMH4TY3whgIlZmMv66w collected $2.85 from pot
8S3JMH4TY3whgIlZmMv66w: doesn't show hand
*** SUMMARY ***
Total pot $3 | Rake $0.15
Board [4s 8d 3h 3c]
Seat 1: Pp/KTcXkfZKKUHkjyaLTdg folded before Flop (didn't bet)
Seat 2: 8S3JMH4TY3whgIlZmMv66w collected ($2.85)
Seat 3: 997ViqAtWn1FPjJqcffwcA folded before Flop (didn't bet)
Seat 4: FL3MrLspcF23LYvC4ipBOA (button) folded before Flop (didn't bet)
Seat 5: Jjc7EHWzs4//xUAjJ0UWoA (small blind) folded on the Turn
Seat 6: Bsd/K5gAcLanYbGiPirRjw (big blind) folded on the Turn
Seat 7: 1GkkVBhlJ92guE6K5mS5Ig folded before Flop (didn't bet)
Seat 8: myIxN7otsyr846M539YR8Q folded before Flop (didn't bet)
Seat 9: 6XkTu4ahxzHnvjjc1R8YjQ folded before Flop (didn't bet)



PokerStars Game #59940735604:  Hold'em No Limit ($0.50/$1.00) - 2009/07/01 1:15:05 ET
Table 'MUPc8FEpe/nR0BKSeReX6Q' 6-max Seat #3 is the button
Seat 1: qhkK6+yCciTRd+rCFEbnEQ ($43.60 in chips)
Seat 2: xAU6q2/cwmby2sxmA8VcmA ($114.70 in chips)
Seat 3: wx3sQGkVi2x9wJXuWNHPBw ($214.50 in chips)
Seat 4: ZA1bp6g8IwtTxkUE4eCjDQ ($194.30 in chips)
Seat 5: y27w5IK2WXqmYzS8OU0wKA ($100 in chips)
Seat 6: oxnw0GLLpFanjhGkxfRSqA ($58.15 in chips)
ZA1bp6g8IwtTxkUE4eCjDQ: posts small blind $0.50
y27w5IK2WXqmYzS8OU0wKA: posts big blind $1
*** HOLE CARDS ***
oxnw0GLLpFanjhGkxfRSqA: folds
qhkK6+yCciTRd+rCFEbnEQ: folds
xAU6q2/cwmby2sxmA8VcmA: folds
wx3sQGkVi2x9wJXuWNHPBw: raises $3 to $4
ZA1bp6g8IwtTxkUE4eCjDQ: folds
y27w5IK2WXqmYzS8OU0wKA: folds
wx3sQGkVi2x9wJXuWNHPBw collected $2.50 from pot
*** SUMMARY ***
Total pot $2.50 | Rake $0
Seat 1: qhkK6+yCciTRd+rCFEbnEQ folded before Flop (didn't bet)
Seat 2: xAU6q2/cwmby2sxmA8VcmA folded before Flop (didn't bet)
Seat 3: wx3sQGkVi2x9wJXuWNHPBw (button) collected ($2.50)
Seat 4: ZA1bp6g8IwtTxkUE4eCjDQ (small blind) folded before Flop
Seat 5: y27w5IK2WXqmYzS8OU0wKA (big blind) folded before Flop
Seat 6: oxnw0GLLpFanjhGkxfRSqA folded before Flop (didn't bet)



PokerStars Game #59940736358:  Hold'em No Limit ($0.50/$1.00) - 2009/07/01 1:15:06 ET
Table 'mmbQQVBTrPdE+wy+s+9VPA' 6-max Seat #6 is the button
Seat 1: zyP4SPoWZnKUfTvIRLCVog ($70.75 in chips)
Seat 2: XK4Qsl+DA8gAJyg85/zBIw ($23.05 in chips)
Seat 3: wx3sQGkVi2x9wJXuWNHPBw ($109.65 in chips)
Seat 4: V3iZdcw61nXF3g5hD2RrsQ ($114.90 in chips)
Seat 5: YMJG+F++3Aj6P8dAWda5fw ($102.10 in chips)
Seat 6: U2CWBTv29qdCbj8RNF2sIw ($102.60 in chips)
zyP4SPoWZnKUfTvIRLCVog: posts small blind $0.50
XK4Qsl+DA8gAJyg85/zBIw: posts big blind $1
*** HOLE CARDS ***
wx3sQGkVi2x9wJXuWNHPBw: folds
V3iZdcw61nXF3g5hD2RrsQ: folds
YMJG+F++3Aj6P8dAWda5fw said, "he doesn't know that"
YMJG+F++3Aj6P8dAWda5fw: folds
U2CWBTv29qdCbj8RNF2sIw: folds
zyP4SPoWZnKUfTvIRLCVog: calls $0.50
zyP4SPoWZnKUfTvIRLCVog said, "ty"
XK4Qsl+DA8gAJyg85/zBIw: checks
*** FLOP *** [9s Ac 6h]
zyP4SPoWZnKUfTvIRLCVog: checks
XK4Qsl+DA8gAJyg85/zBIw: checks
*** TURN *** [9s Ac 6h] [Kd]
zyP4SPoWZnKUfTvIRLCVog: checks
XK4Qsl+DA8gAJyg85/zBIw: bets $3
zyP4SPoWZnKUfTvIRLCVog: folds
XK4Qsl+DA8gAJyg85/zBIw collected $1.90 from pot
*** SUMMARY ***
Total pot $2 | Rake $0.10
Board [9s Ac 6h Kd]
Seat 1: zyP4SPoWZnKUfTvIRLCVog (small blind) folded on the Turn
Seat 2: XK4Qsl+DA8gAJyg85/zBIw (big blind) collected ($1.90)
Seat 3: wx3sQGkVi2x9wJXuWNHPBw folded before Flop (didn't bet)
Seat 4: V3iZdcw61nXF3g5hD2RrsQ folded before Flop (didn't bet)
Seat 5: YMJG+F++3Aj6P8dAWda5fw folded before Flop (didn't bet)
Seat 6: U2CWBTv29qdCbj8RNF2sIw (button) folded before Flop (didn't bet)



PokerStars Game #59940736250:  Hold'em No Limit ($0.50/$1.00) - 2009/07/01 1:15:06 ET
Table 'fZjVbKj9D8yOB+Rj7NaP/A' 9-max Seat #7 is the button
Seat 2: PTAFYDIUSsG+SArbxNl+Aw ($107 in chips)
Seat 3: yAbu2QsRPVcjPbqlf/jDxw ($102.50 in chips)
Seat 4: 997ViqAtWn1FPjJqcffwcA ($103 in chips)
Seat 5: PkGfq5xrSlNsujKaG/HF4Q ($100 in chips)
Seat 6: OvwYHV65yUbgdBjSmo1+5g ($35.90 in chips)
Seat 7: SyS20PAm3RpT6uLBsGkwOA ($119.30 in chips)
Seat 8: zDOE5r14tWqCf6xhuSHK6g ($47 in chips)
Seat 9: qheQay5YvP2DMAb3OUSxtw ($99 in chips)
zDOE5r14tWqCf6xhuSHK6g: posts small blind $0.50
qheQay5YvP2DMAb3OUSxtw: posts big blind $1
*** HOLE CARDS ***
PTAFYDIUSsG+SArbxNl+Aw: folds
9BZCcac3+McErkkSN2YScA joins the table at seat #1
yAbu2QsRPVcjPbqlf/jDxw: folds
997ViqAtWn1FPjJqcffwcA: folds
PkGfq5xrSlNsujKaG/HF4Q: folds
OvwYHV65yUbgdBjSmo1+5g: calls $1
SyS20PAm3RpT6uLBsGkwOA: folds
zDOE5r14tWqCf6xhuSHK6g: calls $0.50
qheQay5YvP2DMAb3OUSxtw: checks
*** FLOP *** [6s Qh 7s]
zDOE5r14tWqCf6xhuSHK6g: checks
qheQay5YvP2DMAb3OUSxtw: checks
OvwYHV65yUbgdBjSmo1+5g: bets $3
zDOE5r14tWqCf6xhuSHK6g: folds
qheQay5YvP2DMAb3OUSxtw: folds
OvwYHV65yUbgdBjSmo1+5g collected $2.85 from pot
OvwYHV65yUbgdBjSmo1+5g: doesn't show hand
*** SUMMARY ***
Total pot $3 | Rake $0.15
Board [6s Qh 7s]
Seat 2: PTAFYDIUSsG+SArbxNl+Aw folded before Flop (didn't bet)
Seat 3: yAbu2QsRPVcjPbqlf/jDxw folded before Flop (didn't bet)
Seat 4: 997ViqAtWn1FPjJqcffwcA folded before Flop (didn't bet)
Seat 5: PkGfq5xrSlNsujKaG/HF4Q folded before Flop (didn't bet)
Seat 6: OvwYHV65yUbgdBjSmo1+5g collected ($2.85)
Seat 7: SyS20PAm3RpT6uLBsGkwOA (button) folded before Flop (didn't bet)
Seat 8: zDOE5r14tWqCf6xhuSHK6g (small blind) folded on the Flop
Seat 9: qheQay5YvP2DMAb3OUSxtw (big blind) folded on the Flop



PokerStars Game #59940737072:  Hold'em No Limit ($0.50/$1.00) - 2009/07/01 1:15:07 ET
Table 'JTT1XWaDZHSaMZQK7cR5uw' 2-max Seat #1 is the button
Seat 1: OLplZF6FEnLflv81Hz+Fxg ($147.15 in chips)
Seat 2: mgi+mjKb1Sc3CCs7TlfoCw ($102.40 in chips)
OLplZF6FEnLflv81Hz+Fxg: posts small blind $0.50
mgi+mjKb1Sc3CCs7TlfoCw: posts big blind $1
*** HOLE CARDS ***
OLplZF6FEnLflv81Hz+Fxg: raises $2 to $3
mgi+mjKb1Sc3CCs7TlfoCw: folds
OLplZF6FEnLflv81Hz+Fxg collected $2 from pot
*** SUMMARY ***
Total pot $2 | Rake $0
Seat 1: OLplZF6FEnLflv81Hz+Fxg (button) (small blind) collected ($2)
Seat 2: mgi+mjKb1Sc3CCs7TlfoCw (big blind) folded before Flop



PokerStars Game #59940738374:  Hold'em No Limit ($0.50/$1.00) - 2009/07/01 1:15:09 ET
Table 'W/wyObTiXZm+Ckkl3YxcSw' 6-max Seat #5 is the button
Seat 1: eUBBn2R56C1IQ6Cs/vitwg ($171.75 in chips)
Seat 2: oDiBRCaF0QVtd3kO6xZIXw ($169.65 in chips)
Seat 3: dxyNCn/qxfkGDUIf28Cbng ($66.65 in chips)
Seat 4: aYii2DmxlOlbC1wbGRBWvQ ($113.15 in chips)
Seat 5: +OrCjyw70oZhJiD22Mn+bg ($100 in chips)
Seat 6: b2a+5TkFf4xJN/Ihhma58Q ($39 in chips)
b2a+5TkFf4xJN/Ihhma58Q: posts small blind $0.50
eUBBn2R56C1IQ6Cs/vitwg: posts big blind $1
*** HOLE CARDS ***
oDiBRCaF0QVtd3kO6xZIXw: folds
dxyNCn/qxfkGDUIf28Cbng: folds
aYii2DmxlOlbC1wbGRBWvQ: folds
+OrCjyw70oZhJiD22Mn+bg: folds
b2a+5TkFf4xJN/Ihhma58Q: calls $0.50
eUBBn2R56C1IQ6Cs/vitwg: raises $3 to $4
b2a+5TkFf4xJN/Ihhma58Q: folds
eUBBn2R56C1IQ6Cs/vitwg collected $2 from pot
*** SUMMARY ***
Total pot $2 | Rake $0
Seat 1: eUBBn2R56C1IQ6Cs/vitwg (big blind) collected ($2)
Seat 2: oDiBRCaF0QVtd3kO6xZIXw folded before Flop (didn't bet)
Seat 3: dxyNCn/qxfkGDUIf28Cbng folded before Flop (didn't bet)
Seat 4: aYii2DmxlOlbC1wbGRBWvQ folded before Flop (didn't bet)
Seat 5: +OrCjyw70oZhJiD22Mn+bg (button) folded before Flop (didn't bet)
Seat 6: b2a+5TkFf4xJN/Ihhma58Q (small blind) folded before Flop



PokerStars Game #59940738204:  Hold'em No Limit ($0.50/$1.00) - 2009/07/01 1:15:09 ET
Table 'VOs36P6NW+QyXeQ1B62kmA' 6-max Seat #5 is the button
Seat 1: Z2fXsGcjl+Eax+RzOgwOmg ($101.50 in chips)
Seat 4: w02zQzNydODiyV9THKgo9w ($41.60 in chips)
Seat 5: ozrlafxxh1HmYdA0/h+MuA ($41.25 in chips)
Seat 6: slVKuQyEz8Qj4E3uLPYNXg ($112.35 in chips)
slVKuQyEz8Qj4E3uLPYNXg: posts small blind $0.50
Z2fXsGcjl+Eax+RzOgwOmg: posts big blind $1
y27w5IK2WXqmYzS8OU0wKA: sits out
*** HOLE CARDS ***
w02zQzNydODiyV9THKgo9w: folds
ozrlafxxh1HmYdA0/h+MuA: calls $1
slVKuQyEz8Qj4E3uLPYNXg: folds
Z2fXsGcjl+Eax+RzOgwOmg: raises $4 to $5
ozrlafxxh1HmYdA0/h+MuA: folds
6hLdALbOlkzGIrc53QKtPw joins the table at seat #3
Z2fXsGcjl+Eax+RzOgwOmg collected $2.50 from pot
Z2fXsGcjl+Eax+RzOgwOmg: doesn't show hand
*** SUMMARY ***
Total pot $2.50 | Rake $0
Seat 1: Z2fXsGcjl+Eax+RzOgwOmg (big blind) collected ($2.50)
Seat 4: w02zQzNydODiyV9THKgo9w folded before Flop (didn't bet)
Seat 5: ozrlafxxh1HmYdA0/h+MuA (button) folded before Flop
Seat 6: slVKuQyEz8Qj4E3uLPYNXg (small blind) folded before Flop



PokerStars Game #59940738862:  Hold'em No Limit ($0.50/$1.00) - 2009/07/01 1:15:10 ET
Table 'tJq9SfN1ywY0r03VBlWlwQ' 9-max Seat #1 is the button
Seat 1: wZsU+w9r7G66x93UuvBf1Q ($333.80 in chips)
Seat 3: FVs16t7GgfWgQWt4JxsObQ ($10.10 in chips)
Seat 4: bLbSOSmSOnqE0iTcH/5dxA ($110.70 in chips)
Seat 5: h5ipsNTMyolp7xn/NAvWkA ($100.25 in chips)
Seat 6: gUUvmqdVlmvpal6B8nYrmg ($114.20 in chips)
Seat 8: G4DEhsZFmznGNVpy2SEocA ($28.40 in chips)
Seat 9: XE5QF1y74bpHog9JxWJMWQ ($103.20 in chips)
FVs16t7GgfWgQWt4JxsObQ: posts small blind $0.50
bLbSOSmSOnqE0iTcH/5dxA: posts big blind $1
Pp/KTcXkfZKKUHkjyaLTdg: sits out
*** HOLE CARDS ***
h5ipsNTMyolp7xn/NAvWkA: raises $2 to $3
gUUvmqdVlmvpal6B8nYrmg: calls $3
G4DEhsZFmznGNVpy2SEocA: folds
XE5QF1y74bpHog9JxWJMWQ: calls $3
wZsU+w9r7G66x93UuvBf1Q: calls $3
FVs16t7GgfWgQWt4JxsObQ: folds
Artjax joins the table at seat #2
bLbSOSmSOnqE0iTcH/5dxA: folds
*** FLOP *** [8d Jc 3s]
Artjax leaves the table
h5ipsNTMyolp7xn/NAvWkA: bets $4
gUUvmqdVlmvpal6B8nYrmg: folds
XE5QF1y74bpHog9JxWJMWQ: folds
wZsU+w9r7G66x93UuvBf1Q: folds
h5ipsNTMyolp7xn/NAvWkA collected $12.85 from pot
*** SUMMARY ***
Total pot $13.50 | Rake $0.65
Board [8d Jc 3s]
Seat 1: wZsU+w9r7G66x93UuvBf1Q (button) folded on the Flop
Seat 3: FVs16t7GgfWgQWt4JxsObQ (small blind) folded before Flop
Seat 4: bLbSOSmSOnqE0iTcH/5dxA (big blind) folded before Flop
Seat 5: h5ipsNTMyolp7xn/NAvWkA collected ($12.85)
Seat 6: gUUvmqdVlmvpal6B8nYrmg folded on the Flop
Seat 8: G4DEhsZFmznGNVpy2SEocA folded before Flop (didn't bet)
Seat 9: XE5QF1y74bpHog9JxWJMWQ folded on the Flop



PokerStars Game #59940738844:  Hold'em No Limit ($0.50/$1.00) - 2009/07/01 1:15:10 ET
Table 'rmZfTK+oSebeUPJNbWhdAA' 6-max Seat #5 is the button
Seat 1: xAU6q2/cwmby2sxmA8VcmA ($148.50 in chips)
Seat 2: z7O9PO/WEcqRouIydFhS9Q ($138.60 in chips)
Seat 3: BCEV3COoKY607AzLWayfRA ($152.80 in chips)
Seat 4: 1/mIuXfgx1ZyVkodrmfQDw ($100 in chips)
Seat 5: 5lY8d6Cnm4HUkt/8FZSj4g ($40.95 in chips)
Seat 6: j7NIOHLZk7V2o9fOioO5ug ($136.50 in chips)
j7NIOHLZk7V2o9fOioO5ug: posts small blind $0.50
xAU6q2/cwmby2sxmA8VcmA: posts big blind $1
*** HOLE CARDS ***
z7O9PO/WEcqRouIydFhS9Q: folds
BCEV3COoKY607AzLWayfRA: folds
1/mIuXfgx1ZyVkodrmfQDw: folds
5lY8d6Cnm4HUkt/8FZSj4g: folds
j7NIOHLZk7V2o9fOioO5ug: raises $3 to $4
xAU6q2/cwmby2sxmA8VcmA: folds
j7NIOHLZk7V2o9fOioO5ug collected $2 from pot
j7NIOHLZk7V2o9fOioO5ug: doesn't show hand
*** SUMMARY ***
Total pot $2 | Rake $0
Seat 1: xAU6q2/cwmby2sxmA8VcmA (big blind) folded before Flop
Seat 2: z7O9PO/WEcqRouIydFhS9Q folded before Flop (didn't bet)
Seat 3: BCEV3COoKY607AzLWayfRA folded before Flop (didn't bet)
Seat 4: 1/mIuXfgx1ZyVkodrmfQDw folded before Flop (didn't bet)
Seat 5: 5lY8d6Cnm4HUkt/8FZSj4g (button) folded before Flop (didn't bet)
Seat 6: j7NIOHLZk7V2o9fOioO5ug (small blind) collected ($2)



PokerStars Game #59940739178:  Hold'em No Limit ($0.50/$1.00) - 2009/07/01 1:15:11 ET
Table 'O96CPOtvMBWP6kzuYDfdFA' 6-max Seat #4 is the button
Seat 1: 6alLXQIITA2EZ/lBeym8Dw ($117.55 in chips)
Seat 2: 4d1rWhpu8DzLmzMbR3QKyA ($111.35 in chips)
Seat 3: V89DGjxE171oPREEbAXiyg ($89.10 in chips)
Seat 4: /P4w1pHg2zHYg/4ubJ0dPw ($60 in chips)
Seat 5: G5ZSSN6RSON3gkNvk/SmYg ($100.50 in chips)
Seat 6: GYei5jXGWexiJYbAT2fELg ($41.65 in chips)
G5ZSSN6RSON3gkNvk/SmYg: posts small blind $0.50
GYei5jXGWexiJYbAT2fELg: posts big blind $1
*** HOLE CARDS ***
6alLXQIITA2EZ/lBeym8Dw: raises $2 to $3
4d1rWhpu8DzLmzMbR3QKyA: folds
V89DGjxE171oPREEbAXiyg: folds
/P4w1pHg2zHYg/4ubJ0dPw: folds
G5ZSSN6RSON3gkNvk/SmYg: folds
GYei5jXGWexiJYbAT2fELg: calls $2
*** FLOP *** [3d 9c 3c]
GYei5jXGWexiJYbAT2fELg: checks
6alLXQIITA2EZ/lBeym8Dw: bets $5
GYei5jXGWexiJYbAT2fELg: folds
6alLXQIITA2EZ/lBeym8Dw collected $6.20 from pot
*** SUMMARY ***
Total pot $6.50 | Rake $0.30
Board [3d 9c 3c]
Seat 1: 6alLXQIITA2EZ/lBeym8Dw collected ($6.20)
Seat 2: 4d1rWhpu8DzLmzMbR3QKyA folded before Flop (didn't bet)
Seat 3: V89DGjxE171oPREEbAXiyg folded before Flop (didn't bet)
Seat 4: /P4w1pHg2zHYg/4ubJ0dPw (button) folded before Flop (didn't bet)
Seat 5: G5ZSSN6RSON3gkNvk/SmYg (small blind) folded before Flop
Seat 6: GYei5jXGWexiJYbAT2fELg (big blind) folded on the Flop



PokerStars Game #59940742458:  Hold'em No Limit ($0.50/$1.00) - 2009/07/01 1:15:16 ET
Table '7O9fB8yx1u7sJveJn8w6jA' 6-max Seat #1 is the button
Seat 1: jy52+7FotjH63o5tEEVgKw ($58.85 in chips)
Seat 2: wx3sQGkVi2x9wJXuWNHPBw ($190.15 in chips)
Seat 3: hpxXcmRkXXI9HE5+5/j/0Q ($125.75 in chips)
Seat 4: b2a+5TkFf4xJN/Ihhma58Q ($41.30 in chips)
Seat 5: BCEV3COoKY607AzLWayfRA ($101.85 in chips)
Seat 6: p1Ga2i1TuXUvRn+Rf/0FMw ($121.75 in chips)
wx3sQGkVi2x9wJXuWNHPBw: posts small blind $0.50
hpxXcmRkXXI9HE5+5/j/0Q: posts big blind $1
*** HOLE CARDS ***
b2a+5TkFf4xJN/Ihhma58Q: folds
BCEV3COoKY607AzLWayfRA: folds
p1Ga2i1TuXUvRn+Rf/0FMw: calls $1
jy52+7FotjH63o5tEEVgKw: calls $1
wx3sQGkVi2x9wJXuWNHPBw: calls $0.50
hpxXcmRkXXI9HE5+5/j/0Q: checks
*** FLOP *** [7s Kh 7c]
wx3sQGkVi2x9wJXuWNHPBw: checks
hpxXcmRkXXI9HE5+5/j/0Q: checks
p1Ga2i1TuXUvRn+Rf/0FMw: checks
jy52+7FotjH63o5tEEVgKw: checks
*** TURN *** [7s Kh 7c] [6c]
wx3sQGkVi2x9wJXuWNHPBw: checks
hpxXcmRkXXI9HE5+5/j/0Q: checks
p1Ga2i1TuXUvRn+Rf/0FMw: checks
jy52+7FotjH63o5tEEVgKw: checks
*** RIVER *** [7s Kh 7c 6c] [Qd]
wx3sQGkVi2x9wJXuWNHPBw: bets $2.50
hpxXcmRkXXI9HE5+5/j/0Q: folds
p1Ga2i1TuXUvRn+Rf/0FMw: calls $2.50
jy52+7FotjH63o5tEEVgKw: folds
*** SHOW DOWN ***
wx3sQGkVi2x9wJXuWNHPBw: shows [8d Qh] (two pair, Queens and Sevens)
p1Ga2i1TuXUvRn+Rf/0FMw: mucks hand
wx3sQGkVi2x9wJXuWNHPBw collected $8.60 from pot
*** SUMMARY ***
Total pot $9 | Rake $0.40
Board [7s Kh 7c 6c Qd]
Seat 1: jy52+7FotjH63o5tEEVgKw (button) folded on the River
Seat 2: wx3sQGkVi2x9wJXuWNHPBw (small blind) showed [8d Qh] and won ($8.60) with two pair, Queens and Sevens
Seat 3: hpxXcmRkXXI9HE5+5/j/0Q (big blind) folded on the River
Seat 4: b2a+5TkFf4xJN/Ihhma58Q folded before Flop (didn't bet)
Seat 5: BCEV3COoKY607AzLWayfRA folded before Flop (didn't bet)
Seat 6: p1Ga2i1TuXUvRn+Rf/0FMw mucked



PokerStars Game #59940743054:  Hold'em No Limit ($0.50/$1.00) - 2009/07/01 1:15:17 ET
Table 'cBDNutyLBKEk9+ptwsKmTw' 6-max Seat #4 is the button
Seat 1: xAU6q2/cwmby2sxmA8VcmA ($249 in chips)
Seat 2: 5lY8d6Cnm4HUkt/8FZSj4g ($88.50 in chips)
Seat 3: G5ZSSN6RSON3gkNvk/SmYg ($100 in chips)
Seat 4: 3q7F5QtzC30pSrn0nl9i+A ($21.60 in chips)
Seat 5: hpxXcmRkXXI9HE5+5/j/0Q ($100 in chips)
hpxXcmRkXXI9HE5+5/j/0Q: posts small blind $0.50
xAU6q2/cwmby2sxmA8VcmA: posts big blind $1
*** HOLE CARDS ***
5lY8d6Cnm4HUkt/8FZSj4g: folds
G5ZSSN6RSON3gkNvk/SmYg: folds
NqVlOSH2lp+pp/TK3vvK5g leaves the table
3q7F5QtzC30pSrn0nl9i+A: folds
hpxXcmRkXXI9HE5+5/j/0Q: folds
QHvTZcrKe6+maWUfVjP29Q joins the table at seat #6
xAU6q2/cwmby2sxmA8VcmA collected $1 from pot
xAU6q2/cwmby2sxmA8VcmA: doesn't show hand
*** SUMMARY ***
Total pot $1 | Rake $0
Seat 1: xAU6q2/cwmby2sxmA8VcmA (big blind) collected ($1)
Seat 2: 5lY8d6Cnm4HUkt/8FZSj4g folded before Flop (didn't bet)
Seat 3: G5ZSSN6RSON3gkNvk/SmYg folded before Flop (didn't bet)
Seat 4: 3q7F5QtzC30pSrn0nl9i+A (button) folded before Flop (didn't bet)
Seat 5: hpxXcmRkXXI9HE5+5/j/0Q (small blind) folded before Flop



PokerStars Game #59940743576:  Hold'em No Limit ($0.50/$1.00) - 2009/07/01 1:15:18 ET
Table 'tyUh+jyNvrceIQdKMJjQ2wZFWj23PMihdwrNWv41OG/Qeat #1 is the button
Seat 1: o8A5MUdudVKu+pAwgZOX2w ($131.70 in chips)
Seat 2: 5uy3EN+iIYkgwbWZFTUBAQ ($108.15 in chips)
Seat 3: TalCiLYHCd+ffkmR3auPvA ($132.80 in chips)
Seat 4: hpxXcmRkXXI9HE5+5/j/0Q ($100 in chips)
Seat 5: j7NIOHLZk7V2o9fOioO5ug ($106.70 in chips)
Seat 6: 4OO5v3AVduL0tePNx8wk5A ($100 in chips)
5uy3EN+iIYkgwbWZFTUBAQ: posts small blind $0.50
TalCiLYHCd+ffkmR3auPvA: posts big blind $1
*** HOLE CARDS ***
hpxXcmRkXXI9HE5+5/j/0Q: folds
j7NIOHLZk7V2o9fOioO5ug: raises $2 to $3
4OO5v3AVduL0tePNx8wk5A said, "burn notice is awsum"
4OO5v3AVduL0tePNx8wk5A: folds
o8A5MUdudVKu+pAwgZOX2w: calls $3
5uy3EN+iIYkgwbWZFTUBAQ: folds
TalCiLYHCd+ffkmR3auPvA: folds
*** FLOP *** [6c Kc 4s]
j7NIOHLZk7V2o9fOioO5ug: bets $5
o8A5MUdudVKu+pAwgZOX2w: folds
j7NIOHLZk7V2o9fOioO5ug collected $7.15 from pot
j7NIOHLZk7V2o9fOioO5ug: doesn't show hand
*** SUMMARY ***
Total pot $7.50 | Rake $0.35
Board [6c Kc 4s]
Seat 1: o8A5MUdudVKu+pAwgZOX2w (button) folded on the Flop
Seat 2: 5uy3EN+iIYkgwbWZFTUBAQ (small blind) folded before Flop
Seat 3: TalCiLYHCd+ffkmR3auPvA (big blind) folded before Flop
Seat 4: hpxXcmRkXXI9HE5+5/j/0Q folded before Flop (didn't bet)
Seat 5: j7NIOHLZk7V2o9fOioO5ug collected ($7.15)
Seat 6: 4OO5v3AVduL0tePNx8wk5A folded before Flop (didn't bet)



PokerStars Game #59940744842:  Hold'em No Limit ($0.50/$1.00) - 2009/07/01 1:15:21 ET
Table '6YvsYDPNIDx2v5z3bJnwZQ' 9-max Seat #9 is the button
Seat 1: Ogn4JDV3mp4ZDKO49IFzKA ($20.20 in chips)
Seat 2: +hHqYgKILitkxIzFNGvvsA ($24.75 in chips)
Seat 4: kEr5NYB+JIG5+szcYMr6hA ($46.95 in chips)
Seat 5: mBRWbnUl8diyBO1qTJaNzw ($160.70 in chips)
Seat 6: 7RSwrjMohkYrZAhOd1uaZg ($11.90 in chips)
Seat 7: mae7OMTaJ/MFimNbZegCkg ($45.80 in chips)
Seat 8: PSFxpXgPedVZyHSu2Zhb7Q ($129.05 in chips)
Seat 9: yZYrOeNDxQxkzpbgKX1bng ($26.50 in chips)
Ogn4JDV3mp4ZDKO49IFzKA: posts small blind $0.50
+hHqYgKILitkxIzFNGvvsA: posts big blind $1
K6OJDis3KfxSm/PKlkATUA: sits out
*** HOLE CARDS ***
kEr5NYB+JIG5+szcYMr6hA: folds
mBRWbnUl8diyBO1qTJaNzw: folds
7RSwrjMohkYrZAhOd1uaZg: folds
mae7OMTaJ/MFimNbZegCkg: folds
PSFxpXgPedVZyHSu2Zhb7Q: folds
yZYrOeNDxQxkzpbgKX1bng: raises $1 to $2
Ogn4JDV3mp4ZDKO49IFzKA: folds
+hHqYgKILitkxIzFNGvvsA: calls $1
*** FLOP *** [Td Qs 3d]
+hHqYgKILitkxIzFNGvvsA: checks
yZYrOeNDxQxkzpbgKX1bng: bets $2
+hHqYgKILitkxIzFNGvvsA: folds
yZYrOeNDxQxkzpbgKX1bng collected $4.30 from pot
*** SUMMARY ***
Total pot $4.50 | Rake $0.20
Board [Td Qs 3d]
Seat 1: Ogn4JDV3mp4ZDKO49IFzKA (small blind) folded before Flop
Seat 2: +hHqYgKILitkxIzFNGvvsA (big blind) folded on the Flop
Seat 4: kEr5NYB+JIG5+szcYMr6hA folded before Flop (didn't bet)
Seat 5: mBRWbnUl8diyBO1qTJaNzw folded before Flop (didn't bet)
Seat 6: 7RSwrjMohkYrZAhOd1uaZg folded before Flop (didn't bet)
Seat 7: mae7OMTaJ/MFimNbZegCkg folded before Flop (didn't bet)
Seat 8: PSFxpXgPedVZyHSu2Zhb7Q folded before Flop (didn't bet)
Seat 9: yZYrOeNDxQxkzpbgKX1bng (button) collected ($4.30)



PokerStars Game #59940746826:  Hold'em No Limit ($0.50/$1.00) - 2009/07/01 1:15:24 ET
Table 'GxCPo/gd3OSthkYrAxJngg' 6-max Seat #6 is the button
Seat 1: sH8BpAFP+jGFxCgVpD1Lew ($262.90 in chips)
Seat 2: YExX2paeIHrmfIwV1ivM/w ($70.60 in chips)
Seat 4: YMJG+F++3Aj6P8dAWda5fw ($196.75 in chips)
Seat 5: G5ZSSN6RSON3gkNvk/SmYg ($116.10 in chips)
Seat 6: 4d1rWhpu8DzLmzMbR3QKyA ($103.60 in chips)
sH8BpAFP+jGFxCgVpD1Lew: posts small blind $0.50
YExX2paeIHrmfIwV1ivM/w: posts big blind $1
*** HOLE CARDS ***
YMJG+F++3Aj6P8dAWda5fw: folds
G5ZSSN6RSON3gkNvk/SmYg: folds
4d1rWhpu8DzLmzMbR3QKyA: raises $2 to $3
6hLdALbOlkzGIrc53QKtPw joins the table at seat #3
sH8BpAFP+jGFxCgVpD1Lew: calls $2.50
YExX2paeIHrmfIwV1ivM/w: folds
*** FLOP *** [2d Kh 5c]
sH8BpAFP+jGFxCgVpD1Lew: checks
4d1rWhpu8DzLmzMbR3QKyA: bets $5
sH8BpAFP+jGFxCgVpD1Lew: folds
4d1rWhpu8DzLmzMbR3QKyA collected $6.65 from pot
*** SUMMARY ***
Total pot $7 | Rake $0.35
Board [2d Kh 5c]
Seat 1: sH8BpAFP+jGFxCgVpD1Lew (small blind) folded on the Flop
Seat 2: YExX2paeIHrmfIwV1ivM/w (big blind) folded before Flop
Seat 4: YMJG+F++3Aj6P8dAWda5fw folded before Flop (didn't bet)
Seat 5: G5ZSSN6RSON3gkNvk/SmYg folded before Flop (didn't bet)
Seat 6: 4d1rWhpu8DzLmzMbR3QKyA (button) collected ($6.65)



PokerStars Game #59940747216:  Hold'em No Limit ($0.50/$1.00) - 2009/07/01 1:15:25 ET
Table 'hugOjcwJvzEwZbK7tyiWuQ' 9-max Seat #7 is the button
Seat 1: S3Ex8K7v6xm5jqjRM7Fl3w ($22 in chips)
Seat 2: r27C1nIV4NS4+qbnrgBQSw ($281.70 in chips)
Seat 4: UWB3oeddt/GObx2Mix2Anw ($171.30 in chips)
Seat 5: 5BRGWf+R3nt2WS3b5xX+zA ($26.35 in chips)
Seat 6: gUUvmqdVlmvpal6B8nYrmg ($101.50 in chips)
Seat 7: FL3MrLspcF23LYvC4ipBOA ($108.80 in chips)
Seat 8: /zy+DB4S5fUQUSfZWFzYGw ($111.55 in chips)
Seat 9: W8P9bUKCs43TO1xHm0dL6w ($89.45 in chips)
/zy+DB4S5fUQUSfZWFzYGw: posts small blind $0.50
W8P9bUKCs43TO1xHm0dL6w: posts big blind $1
*** HOLE CARDS ***
S3Ex8K7v6xm5jqjRM7Fl3w: folds
r27C1nIV4NS4+qbnrgBQSw: folds
UWB3oeddt/GObx2Mix2Anw: folds
5BRGWf+R3nt2WS3b5xX+zA: folds
gUUvmqdVlmvpal6B8nYrmg: raises $1 to $2
FL3MrLspcF23LYvC4ipBOA: folds
/zy+DB4S5fUQUSfZWFzYGw: folds
W8P9bUKCs43TO1xHm0dL6w: folds
gUUvmqdVlmvpal6B8nYrmg collected $2.50 from pot
*** SUMMARY ***
Total pot $2.50 | Rake $0
Seat 1: S3Ex8K7v6xm5jqjRM7Fl3w folded before Flop (didn't bet)
Seat 2: r27C1nIV4NS4+qbnrgBQSw folded before Flop (didn't bet)
Seat 4: UWB3oeddt/GObx2Mix2Anw folded before Flop (didn't bet)
Seat 5: 5BRGWf+R3nt2WS3b5xX+zA folded before Flop (didn't bet)
Seat 6: gUUvmqdVlmvpal6B8nYrmg collected ($2.50)
Seat 7: FL3MrLspcF23LYvC4ipBOA (button) folded before Flop (didn't bet)
Seat 8: /zy+DB4S5fUQUSfZWFzYGw (small blind) folded before Flop
Seat 9: W8P9bUKCs43TO1xHm0dL6w (big blind) folded before Flop



PokerStars Game #59940748438:  Hold'em No Limit ($0.50/$1.00) - 2009/07/01 1:15:27 ET
Table 'VOs36P6NW+QyXeQ1B62kmA' 6-max Seat #6 is the button
Seat 1: Z2fXsGcjl+Eax+RzOgwOmg ($103 in chips)
Seat 2: y27w5IK2WXqmYzS8OU0wKA ($100 in chips)
Seat 4: w02zQzNydODiyV9THKgo9w ($41.60 in chips)
Seat 5: ozrlafxxh1HmYdA0/h+MuA ($40.25 in chips)
Seat 6: slVKuQyEz8Qj4E3uLPYNXg ($111.85 in chips)
Z2fXsGcjl+Eax+RzOgwOmg: posts small blind $0.50
y27w5IK2WXqmYzS8OU0wKA: posts big blind $1
6hLdALbOlkzGIrc53QKtPw: sits out
*** HOLE CARDS ***
w02zQzNydODiyV9THKgo9w: calls $1
ozrlafxxh1HmYdA0/h+MuA: calls $1
slVKuQyEz8Qj4E3uLPYNXg: calls $1
Z2fXsGcjl+Eax+RzOgwOmg: folds
y27w5IK2WXqmYzS8OU0wKA: checks
*** FLOP *** [3h 8c 5h]
y27w5IK2WXqmYzS8OU0wKA: checks
w02zQzNydODiyV9THKgo9w: bets $4
ozrlafxxh1HmYdA0/h+MuA: folds
ozrlafxxh1HmYdA0/h+MuA is sitting out
slVKuQyEz8Qj4E3uLPYNXg: calls $4
y27w5IK2WXqmYzS8OU0wKA: folds
*** TURN *** [3h 8c 5h] [5s]
w02zQzNydODiyV9THKgo9w: bets $5
slVKuQyEz8Qj4E3uLPYNXg: calls $5
*** RIVER *** [3h 8c 5h 5s] [6d]
w02zQzNydODiyV9THKgo9w: bets $6
slVKuQyEz8Qj4E3uLPYNXg: raises $95.85 to $101.85 and is all-in
w02zQzNydODiyV9THKgo9w: calls $25.60 and is all-in
*** SHOW DOWN ***
slVKuQyEz8Qj4E3uLPYNXg: shows [8h 6h] (two pair, Eights and Sixes)
w02zQzNydODiyV9THKgo9w: mucks hand
slVKuQyEz8Qj4E3uLPYNXg collected $83.70 from pot
*** SUMMARY ***
Total pot $85.70 | Rake $2
Board [3h 8c 5h 5s 6d]
Seat 1: Z2fXsGcjl+Eax+RzOgwOmg (small blind) folded before Flop
Seat 2: y27w5IK2WXqmYzS8OU0wKA (big blind) folded on the Flop
Seat 4: w02zQzNydODiyV9THKgo9w mucked
Seat 5: ozrlafxxh1HmYdA0/h+MuA folded on the Flop
Seat 6: slVKuQyEz8Qj4E3uLPYNXg (button) showed [8h 6h] and won ($83.70) with two pair, Eights and Sixes



PokerStars Game #59940749218:  Hold'em No Limit ($0.50/$1.00) - 2009/07/01 1:15:28 ET
Table 'fTlPiCj0utgzC/5io+I7ew' 6-max Seat #6 is the button
Seat 1: YMJG+F++3Aj6P8dAWda5fw ($101.85 in chips)
Seat 3: Z2fXsGcjl+Eax+RzOgwOmg ($101 in chips)
Seat 4: uJVSceLggtsrJya+WtmUEA ($175.15 in chips)
Seat 5: XUk5GQsfNFpHvaToDZ0rZA ($51.50 in chips)
Seat 6: y27w5IK2WXqmYzS8OU0wKA ($100 in chips)
YMJG+F++3Aj6P8dAWda5fw: posts small blind $0.50
Z2fXsGcjl+Eax+RzOgwOmg: posts big blind $1
*** HOLE CARDS ***
uJVSceLggtsrJya+WtmUEA: folds
XUk5GQsfNFpHvaToDZ0rZA: folds
y27w5IK2WXqmYzS8OU0wKA: folds
KDYsHh8K2SUXXDvLsAhbJQ joins the table at seat #2
YMJG+F++3Aj6P8dAWda5fw: folds
Z2fXsGcjl+Eax+RzOgwOmg collected $1 from pot
*** SUMMARY ***
Total pot $1 | Rake $0
Seat 1: YMJG+F++3Aj6P8dAWda5fw (small blind) folded before Flop
Seat 3: Z2fXsGcjl+Eax+RzOgwOmg (big blind) collected ($1)
Seat 4: uJVSceLggtsrJya+WtmUEA folded before Flop (didn't bet)
Seat 5: XUk5GQsfNFpHvaToDZ0rZA folded before Flop (didn't bet)
Seat 6: y27w5IK2WXqmYzS8OU0wKA (button) folded before Flop (didn't bet)



PokerStars Game #59940751664:  Hold'em No Limit ($0.50/$1.00) - 2009/07/01 1:15:32 ET
Table '7Nl0ffnjeK44/vmeexh3MQ' 9-max Seat #5 is the button
Seat 1: V138SURkdX8LdVBPKdJJag ($101.50 in chips)
Seat 3: JMmUYT5pIKCKh2pGjCB/4w ($55.50 in chips)
Seat 4: bLbSOSmSOnqE0iTcH/5dxA ($100 in chips)
Seat 5: 61sfw5QTu62YYIt68OsdrA ($81.50 in chips)
Seat 6: FVs16t7GgfWgQWt4JxsObQ ($29.35 in chips)
Seat 7: 997ViqAtWn1FPjJqcffwcA ($100 in chips)
Seat 8: D+W9Me7w6Hcx/WRUSKV0dw ($18.25 in chips)
Seat 9: ouwUBGRKnKK9uhn1G4Lf+A ($194 in chips)
FVs16t7GgfWgQWt4JxsObQ: posts small blind $0.50
997ViqAtWn1FPjJqcffwcA: posts big blind $1
*** HOLE CARDS ***
D+W9Me7w6Hcx/WRUSKV0dw: folds
ouwUBGRKnKK9uhn1G4Lf+A: folds
V138SURkdX8LdVBPKdJJag: folds
JMmUYT5pIKCKh2pGjCB/4w: folds
OGgaARGdJQT4awWVNQ957w has returned
bLbSOSmSOnqE0iTcH/5dxA: folds
61sfw5QTu62YYIt68OsdrA: folds
FVs16t7GgfWgQWt4JxsObQ: calls $0.50
997ViqAtWn1FPjJqcffwcA: checks
*** FLOP *** [7s 7d Ac]
FVs16t7GgfWgQWt4JxsObQ: checks
997ViqAtWn1FPjJqcffwcA: checks
*** TURN *** [7s 7d Ac] [6c]
FVs16t7GgfWgQWt4JxsObQ: checks
997ViqAtWn1FPjJqcffwcA: checks
*** RIVER *** [7s 7d Ac 6c] [Ks]
FVs16t7GgfWgQWt4JxsObQ: checks
997ViqAtWn1FPjJqcffwcA: checks
*** SHOW DOWN ***
FVs16t7GgfWgQWt4JxsObQ: shows [4c Qh] (a pair of Sevens)
997ViqAtWn1FPjJqcffwcA: mucks hand
FVs16t7GgfWgQWt4JxsObQ collected $1.90 from pot
*** SUMMARY ***
Total pot $2 | Rake $0.10
Board [7s 7d Ac 6c Ks]
Seat 1: V138SURkdX8LdVBPKdJJag folded before Flop (didn't bet)
Seat 3: JMmUYT5pIKCKh2pGjCB/4w folded before Flop (didn't bet)
Seat 4: bLbSOSmSOnqE0iTcH/5dxA folded before Flop (didn't bet)
Seat 5: 61sfw5QTu62YYIt68OsdrA (button) folded before Flop (didn't bet)
Seat 6: FVs16t7GgfWgQWt4JxsObQ (small blind) showed [4c Qh] and won ($1.90) with a pair of Sevens
Seat 7: 997ViqAtWn1FPjJqcffwcA (big blind) mucked
Seat 8: D+W9Me7w6Hcx/WRUSKV0dw folded before Flop (didn't bet)
Seat 9: ouwUBGRKnKK9uhn1G4Lf+A folded before Flop (didn't bet)



PokerStars Game #59940751266:  Hold'em No Limit ($0.50/$1.00) - 2009/07/01 1:15:32 ET
Table 'MUPc8FEpe/nR0BKSeReX6Q' 6-max Seat #4 is the button
Seat 1: qhkK6+yCciTRd+rCFEbnEQ ($43.60 in chips)
Seat 2: xAU6q2/cwmby2sxmA8VcmA ($114.70 in chips)
Seat 3: wx3sQGkVi2x9wJXuWNHPBw ($216 in chips)
Seat 4: ZA1bp6g8IwtTxkUE4eCjDQ ($193.80 in chips)
Seat 5: y27w5IK2WXqmYzS8OU0wKA ($100 in chips)
Seat 6: oxnw0GLLpFanjhGkxfRSqA ($58.15 in chips)
y27w5IK2WXqmYzS8OU0wKA: posts small blind $0.50
oxnw0GLLpFanjhGkxfRSqA: posts big blind $1
*** HOLE CARDS ***
qhkK6+yCciTRd+rCFEbnEQ: folds
xAU6q2/cwmby2sxmA8VcmA: folds
wx3sQGkVi2x9wJXuWNHPBw: folds
ZA1bp6g8IwtTxkUE4eCjDQ: calls $1
y27w5IK2WXqmYzS8OU0wKA: folds
oxnw0GLLpFanjhGkxfRSqA: checks
*** FLOP *** [As Qs 7c]
oxnw0GLLpFanjhGkxfRSqA: checks
ZA1bp6g8IwtTxkUE4eCjDQ: bets $1
oxnw0GLLpFanjhGkxfRSqA: folds
ZA1bp6g8IwtTxkUE4eCjDQ collected $2.40 from pot
ZA1bp6g8IwtTxkUE4eCjDQ: doesn't show hand
*** SUMMARY ***
Total pot $2.50 | Rake $0.10
Board [As Qs 7c]
Seat 1: qhkK6+yCciTRd+rCFEbnEQ folded before Flop (didn't bet)
Seat 2: xAU6q2/cwmby2sxmA8VcmA folded before Flop (didn't bet)
Seat 3: wx3sQGkVi2x9wJXuWNHPBw folded before Flop (didn't bet)
Seat 4: ZA1bp6g8IwtTxkUE4eCjDQ (button) collected ($2.40)
Seat 5: y27w5IK2WXqmYzS8OU0wKA (small blind) folded before Flop
Seat 6: oxnw0GLLpFanjhGkxfRSqA (big blind) folded on the Flop



PokerStars Game #59940751878:  Hold'em No Limit ($0.50/$1.00) - 2009/07/01 1:15:33 ET
Table '3T4owEKJKyGTMePwrv50FQ' 9-max Seat #3 is the button
Seat 2: t+Id2O6herCLgwnC4m49PA ($40.30 in chips)
Seat 3: DOLzOcBTZYcph5jEfKFWuQ ($104 in chips)
Seat 4: O5Go3jrzbQWxRB6ESK+Ptg ($33.60 in chips)
Seat 5: eI48VADSCFoNZBx4T9qs2w ($31.85 in chips)
Seat 6: laA8va+Yv8WuMqT1zdR91g ($100 in chips)
Seat 7: 1862487932 ($108.65 in chips)
Seat 8: ucTB8uAUcQnKGsA70OSjNA ($15.50 in chips)
Seat 9: 61sfw5QTu62YYIt68OsdrA ($63.45 in chips)
O5Go3jrzbQWxRB6ESK+Ptg: posts small blind $0.50
eI48VADSCFoNZBx4T9qs2w: posts big blind $1
*** HOLE CARDS ***
laA8va+Yv8WuMqT1zdR91g: folds
1862487932: folds
ucTB8uAUcQnKGsA70OSjNA: folds
laA8va+Yv8WuMqT1zdR91g leaves the table
V138SURkdX8LdVBPKdJJag joins the table at seat #6
61sfw5QTu62YYIt68OsdrA: folds
t+Id2O6herCLgwnC4m49PA: folds
OGgaARGdJQT4awWVNQ957w has returned
DOLzOcBTZYcph5jEfKFWuQ: folds
O5Go3jrzbQWxRB6ESK+Ptg: calls $0.50
eI48VADSCFoNZBx4T9qs2w: checks
*** FLOP *** [3h Jc 4s]
O5Go3jrzbQWxRB6ESK+Ptg: bets $2
eI48VADSCFoNZBx4T9qs2w: raises $2 to $4
O5Go3jrzbQWxRB6ESK+Ptg: calls $2
*** TURN *** [3h Jc 4s] [5h]
O5Go3jrzbQWxRB6ESK+Ptg: checks
eI48VADSCFoNZBx4T9qs2w: bets $6
O5Go3jrzbQWxRB6ESK+Ptg: raises $6 to $12
eI48VADSCFoNZBx4T9qs2w: raises $14.85 to $26.85 and is all-in
O5Go3jrzbQWxRB6ESK+Ptg: calls $14.85
*** RIVER *** [3h Jc 4s 5h] [7c]
*** SHOW DOWN ***
O5Go3jrzbQWxRB6ESK+Ptg: shows [5s 5d] (three of a kind, Fives)
eI48VADSCFoNZBx4T9qs2w: mucks hand
O5Go3jrzbQWxRB6ESK+Ptg collected $60.70 from pot
*** SUMMARY ***
Total pot $63.70 | Rake $3
Board [3h Jc 4s 5h 7c]
Seat 2: t+Id2O6herCLgwnC4m49PA folded before Flop (didn't bet)
Seat 3: DOLzOcBTZYcph5jEfKFWuQ (button) folded before Flop (didn't bet)
Seat 4: O5Go3jrzbQWxRB6ESK+Ptg (small blind) showed [5s 5d] and won ($60.70) with three of a kind, Fives
Seat 5: eI48VADSCFoNZBx4T9qs2w (big blind) mucked
Seat 6: laA8va+Yv8WuMqT1zdR91g folded before Flop (didn't bet)
Seat 7: 1862487932 folded before Flop (didn't bet)
Seat 8: ucTB8uAUcQnKGsA70OSjNA folded before Flop (didn't bet)
Seat 9: 61sfw5QTu62YYIt68OsdrA folded before Flop (didn't bet)



PokerStars Game #59940754052:  Hold'em No Limit ($0.50/$1.00) - 2009/07/01 1:15:36 ET
Table 'kS0cTQAEi+fdUlJP2gQYvw' 9-max Seat #1 is the button
Seat 1: c/9X4zftzphFxYtxp5kp9w ($80.90 in chips)
Seat 2: D+W9Me7w6Hcx/WRUSKV0dw ($21.40 in chips)
Seat 3: 2BV+oJIQYr65IO6nEChvbA ($60 in chips)
Seat 4: RUhhaALzha3TH1AkdakoGQ ($44 in chips)
Seat 5: 997ViqAtWn1FPjJqcffwcA ($101.15 in chips)
Seat 6: yAbu2QsRPVcjPbqlf/jDxw ($126.15 in chips)
Seat 7: Ffa7Nj4X5fddtROP01hfQg ($164.10 in chips)
Seat 8: vKyFzTyzfT7fZcdX+HHN+Q ($19 in chips)
D+W9Me7w6Hcx/WRUSKV0dw: posts small blind $0.50
2BV+oJIQYr65IO6nEChvbA: posts big blind $1
*** HOLE CARDS ***
vKyFzTyzfT7fZcdX+HHN+Q is disconnected
RUhhaALzha3TH1AkdakoGQ: folds
997ViqAtWn1FPjJqcffwcA: folds
yAbu2QsRPVcjPbqlf/jDxw: folds
Ffa7Nj4X5fddtROP01hfQg: folds
OGgaARGdJQT4awWVNQ957w has returned
vKyFzTyzfT7fZcdX+HHN+Q has timed out while disconnected
vKyFzTyzfT7fZcdX+HHN+Q: folds
vKyFzTyzfT7fZcdX+HHN+Q is sitting out
c/9X4zftzphFxYtxp5kp9w: calls $1
D+W9Me7w6Hcx/WRUSKV0dw: raises $3.65 to $4.65
2BV+oJIQYr65IO6nEChvbA: folds
c/9X4zftzphFxYtxp5kp9w said, "what did you have there eye"
c/9X4zftzphFxYtxp5kp9w: calls $3.65
*** FLOP *** [Th Ac 7c]
D+W9Me7w6Hcx/WRUSKV0dw: bets $5.35
c/9X4zftzphFxYtxp5kp9w: folds
D+W9Me7w6Hcx/WRUSKV0dw collected $9.80 from pot
D+W9Me7w6Hcx/WRUSKV0dw: doesn't show hand
*** SUMMARY ***
Total pot $10.30 | Rake $0.50
Board [Th Ac 7c]
Seat 1: c/9X4zftzphFxYtxp5kp9w (button) folded on the Flop
Seat 2: D+W9Me7w6Hcx/WRUSKV0dw (small blind) collected ($9.80)
Seat 3: 2BV+oJIQYr65IO6nEChvbA (big blind) folded before Flop
Seat 4: RUhhaALzha3TH1AkdakoGQ folded before Flop (didn't bet)
Seat 5: 997ViqAtWn1FPjJqcffwcA folded before Flop (didn't bet)
Seat 6: yAbu2QsRPVcjPbqlf/jDxw folded before Flop (didn't bet)
Seat 7: Ffa7Nj4X5fddtROP01hfQg folded before Flop (didn't bet)
Seat 8: vKyFzTyzfT7fZcdX+HHN+Q folded before Flop (didn't bet)



PokerStars Game #59940754226:  Hold'em No Limit ($0.50/$1.00) - 2009/07/01 1:15:37 ET
Table 'cBDNutyLBKEk9+ptwsKmTw' 6-max Seat #5 is the button
Seat 1: xAU6q2/cwmby2sxmA8VcmA ($249.50 in chips)
Seat 2: 5lY8d6Cnm4HUkt/8FZSj4g ($88.50 in chips)
Seat 3: G5ZSSN6RSON3gkNvk/SmYg ($100 in chips)
Seat 4: 3q7F5QtzC30pSrn0nl9i+A ($21.60 in chips)
Seat 5: hpxXcmRkXXI9HE5+5/j/0Q ($100 in chips)
QHvTZcrKe6+maWUfVjP29Q will be allowed to play after the button
xAU6q2/cwmby2sxmA8VcmA: posts small blind $0.50
5lY8d6Cnm4HUkt/8FZSj4g: posts big blind $1
*** HOLE CARDS ***
G5ZSSN6RSON3gkNvk/SmYg: folds
3q7F5QtzC30pSrn0nl9i+A: calls $1
hpxXcmRkXXI9HE5+5/j/0Q: folds
xAU6q2/cwmby2sxmA8VcmA: folds
5lY8d6Cnm4HUkt/8FZSj4g: checks
*** FLOP *** [Kd Ad 7s]
5lY8d6Cnm4HUkt/8FZSj4g: checks
3q7F5QtzC30pSrn0nl9i+A: checks
*** TURN *** [Kd Ad 7s] [2h]
5lY8d6Cnm4HUkt/8FZSj4g: checks
3q7F5QtzC30pSrn0nl9i+A: bets $1
5lY8d6Cnm4HUkt/8FZSj4g: folds
3q7F5QtzC30pSrn0nl9i+A collected $2.40 from pot
*** SUMMARY ***
Total pot $2.50 | Rake $0.10
Board [Kd Ad 7s 2h]
Seat 1: xAU6q2/cwmby2sxmA8VcmA (small blind) folded before Flop
Seat 2: 5lY8d6Cnm4HUkt/8FZSj4g (big blind) folded on the Turn
Seat 3: G5ZSSN6RSON3gkNvk/SmYg folded before Flop (didn't bet)
Seat 4: 3q7F5QtzC30pSrn0nl9i+A collected ($2.40)
Seat 5: hpxXcmRkXXI9HE5+5/j/0Q (button) folded before Flop (didn't bet)



PokerStars Game #59940754992:  Hold'em No Limit ($0.50/$1.00) - 2009/07/01 1:15:38 ET
Table 'W/wyObTiXZm+Ckkl3YxcSw' 6-max Seat #6 is the button
Seat 1: eUBBn2R56C1IQ6Cs/vitwg ($172.75 in chips)
Seat 2: oDiBRCaF0QVtd3kO6xZIXw ($169.65 in chips)
Seat 3: dxyNCn/qxfkGDUIf28Cbng ($66.65 in chips)
Seat 4: aYii2DmxlOlbC1wbGRBWvQ ($113.15 in chips)
Seat 5: +OrCjyw70oZhJiD22Mn+bg ($100 in chips)
Seat 6: b2a+5TkFf4xJN/Ihhma58Q ($38 in chips)
eUBBn2R56C1IQ6Cs/vitwg: posts small blind $0.50
oDiBRCaF0QVtd3kO6xZIXw: posts big blind $1
*** HOLE CARDS ***
dxyNCn/qxfkGDUIf28Cbng: folds
aYii2DmxlOlbC1wbGRBWvQ: folds
+OrCjyw70oZhJiD22Mn+bg: folds
b2a+5TkFf4xJN/Ihhma58Q: folds
eUBBn2R56C1IQ6Cs/vitwg: folds
oDiBRCaF0QVtd3kO6xZIXw collected $1 from pot
oDiBRCaF0QVtd3kO6xZIXw: doesn't show hand
*** SUMMARY ***
Total pot $1 | Rake $0
Seat 1: eUBBn2R56C1IQ6Cs/vitwg (small blind) folded before Flop
Seat 2: oDiBRCaF0QVtd3kO6xZIXw (big blind) collected ($1)
Seat 3: dxyNCn/qxfkGDUIf28Cbng folded before Flop (didn't bet)
Seat 4: aYii2DmxlOlbC1wbGRBWvQ folded before Flop (didn't bet)
Seat 5: +OrCjyw70oZhJiD22Mn+bg folded before Flop (didn't bet)
Seat 6: b2a+5TkFf4xJN/Ihhma58Q (button) folded before Flop (didn't bet)



PokerStars Game #59940755734:  Hold'em No Limit ($0.50/$1.00) - 2009/07/01 1:15:39 ET
Table 'rmZfTK+oSebeUPJNbWhdAA' 6-max Seat #6 is the button
Seat 1: xAU6q2/cwmby2sxmA8VcmA ($147.50 in chips)
Seat 2: z7O9PO/WEcqRouIydFhS9Q ($138.60 in chips)
Seat 3: BCEV3COoKY607AzLWayfRA ($152.80 in chips)
Seat 4: 1/mIuXfgx1ZyVkodrmfQDw ($100 in chips)
Seat 5: 5lY8d6Cnm4HUkt/8FZSj4g ($40.95 in chips)
Seat 6: j7NIOHLZk7V2o9fOioO5ug ($137.50 in chips)
xAU6q2/cwmby2sxmA8VcmA: posts small blind $0.50
z7O9PO/WEcqRouIydFhS9Q: posts big blind $1
*** HOLE CARDS ***
BCEV3COoKY607AzLWayfRA: folds
1/mIuXfgx1ZyVkodrmfQDw: raises $2 to $3
5lY8d6Cnm4HUkt/8FZSj4g: calls $3
j7NIOHLZk7V2o9fOioO5ug: calls $3
xAU6q2/cwmby2sxmA8VcmA: folds
z7O9PO/WEcqRouIydFhS9Q: calls $2
*** FLOP *** [7h 6c Qh]
z7O9PO/WEcqRouIydFhS9Q: checks
1/mIuXfgx1ZyVkodrmfQDw: checks
5lY8d6Cnm4HUkt/8FZSj4g: checks
j7NIOHLZk7V2o9fOioO5ug: bets $8
z7O9PO/WEcqRouIydFhS9Q: folds
1/mIuXfgx1ZyVkodrmfQDw: folds
5lY8d6Cnm4HUkt/8FZSj4g: folds
j7NIOHLZk7V2o9fOioO5ug collected $11.90 from pot
j7NIOHLZk7V2o9fOioO5ug: doesn't show hand
*** SUMMARY ***
Total pot $12.50 | Rake $0.60
Board [7h 6c Qh]
Seat 1: xAU6q2/cwmby2sxmA8VcmA (small blind) folded before Flop
Seat 2: z7O9PO/WEcqRouIydFhS9Q (big blind) folded on the Flop
Seat 3: BCEV3COoKY607AzLWayfRA folded before Flop (didn't bet)
Seat 4: 1/mIuXfgx1ZyVkodrmfQDw folded on the Flop
Seat 5: 5lY8d6Cnm4HUkt/8FZSj4g folded on the Flop
Seat 6: j7NIOHLZk7V2o9fOioO5ug (button) collected ($11.90)



PokerStars Game #59940755854:  Hold'em No Limit ($0.50/$1.00) - 2009/07/01 1:15:40 ET
Table 'QSIig7BLMc9wY/rgBechzw' 6-max Seat #1 is the button
Seat 1: Z2fXsGcjl+Eax+RzOgwOmg ($112 in chips)
Seat 2: mLOIkH/qmRa+mVujQIhBRg ($34.30 in chips)
Seat 3: +xW7QemQU0Fxs+4TnqBRow ($101.35 in chips)
Seat 4: +uSzP8Jwnw7sKfQ4s66b7w ($76.95 in chips)
Seat 5: lsLuWlcPA3Rh7kJVLzMh0Q ($108.95 in chips)
Seat 6: PxqfkAMdAWtkgbT+q2gciA ($36.65 in chips)
mLOIkH/qmRa+mVujQIhBRg: posts small blind $0.50
+xW7QemQU0Fxs+4TnqBRow: posts big blind $1
*** HOLE CARDS ***
+uSzP8Jwnw7sKfQ4s66b7w: raises $2 to $3
lsLuWlcPA3Rh7kJVLzMh0Q: folds
PxqfkAMdAWtkgbT+q2gciA: folds
Z2fXsGcjl+Eax+RzOgwOmg: folds
mLOIkH/qmRa+mVujQIhBRg: calls $2.50
+xW7QemQU0Fxs+4TnqBRow: calls $2
*** FLOP *** [Jh 4s 7c]
mLOIkH/qmRa+mVujQIhBRg: checks
+xW7QemQU0Fxs+4TnqBRow: bets $6
+uSzP8Jwnw7sKfQ4s66b7w: folds
mLOIkH/qmRa+mVujQIhBRg: folds
+xW7QemQU0Fxs+4TnqBRow collected $8.55 from pot
+xW7QemQU0Fxs+4TnqBRow: doesn't show hand
*** SUMMARY ***
Total pot $9 | Rake $0.45
Board [Jh 4s 7c]
Seat 1: Z2fXsGcjl+Eax+RzOgwOmg (button) folded before Flop (didn't bet)
Seat 2: mLOIkH/qmRa+mVujQIhBRg (small blind) folded on the Flop
Seat 3: +xW7QemQU0Fxs+4TnqBRow (big blind) collected ($8.55)
Seat 4: +uSzP8Jwnw7sKfQ4s66b7w folded on the Flop
Seat 5: lsLuWlcPA3Rh7kJVLzMh0Q folded before Flop (didn't bet)
Seat 6: PxqfkAMdAWtkgbT+q2gciA folded before Flop (didn't bet)



PokerStars Game #59940757254:  Hold'em No Limit ($0.50/$1.00) - 2009/07/01 1:15:42 ET
Table '8jIjWCPY0NGprquL+xcMFg' 9-max Seat #8 is the button
Seat 1: tU883G5KFwdH+p2tFuGYtw ($50 in chips)
Seat 2: 7VpIzVwja9q3vCCNM7gRrg ($41 in chips)
Seat 4: XLnHQ8GEI3bUQAfNjJuO5Q ($56.55 in chips)
Seat 5: 2YpnxJiexJHyERfbqgwEcw ($49.55 in chips)
Seat 6: GTQkFJtSkbVbnGCktp6e3g ($101.50 in chips)
Seat 7: O5Go3jrzbQWxRB6ESK+Ptg ($46 in chips)
Seat 8: eI48VADSCFoNZBx4T9qs2w ($29.95 in chips)
Seat 9: DDzMn3tzCgfGf298Xxt5Iw ($29.50 in chips)
DDzMn3tzCgfGf298Xxt5Iw: posts small blind $0.50
tU883G5KFwdH+p2tFuGYtw: posts big blind $1
myIxN7otsyr846M539YR8Q: sits out
*** HOLE CARDS ***
7VpIzVwja9q3vCCNM7gRrg: folds
XLnHQ8GEI3bUQAfNjJuO5Q: calls $1
2YpnxJiexJHyERfbqgwEcw: calls $1
GTQkFJtSkbVbnGCktp6e3g: folds
O5Go3jrzbQWxRB6ESK+Ptg: folds
eI48VADSCFoNZBx4T9qs2w: raises $1 to $2
DDzMn3tzCgfGf298Xxt5Iw: folds
tU883G5KFwdH+p2tFuGYtw: folds
XLnHQ8GEI3bUQAfNjJuO5Q: calls $1
2YpnxJiexJHyERfbqgwEcw: calls $1
*** FLOP *** [Kc 7h Kd]
XLnHQ8GEI3bUQAfNjJuO5Q: checks
2YpnxJiexJHyERfbqgwEcw: checks
eI48VADSCFoNZBx4T9qs2w: bets $2
XLnHQ8GEI3bUQAfNjJuO5Q: calls $2
2YpnxJiexJHyERfbqgwEcw: folds
*** TURN *** [Kc 7h Kd] [Jd]
XLnHQ8GEI3bUQAfNjJuO5Q: bets $7
eI48VADSCFoNZBx4T9qs2w: calls $7
*** RIVER *** [Kc 7h Kd Jd] [4d]
XLnHQ8GEI3bUQAfNjJuO5Q: bets $45.55 and is all-in
eI48VADSCFoNZBx4T9qs2w: folds
XLnHQ8GEI3bUQAfNjJuO5Q collected $24.30 from pot
*** SUMMARY ***
Total pot $25.50 | Rake $1.20
Board [Kc 7h Kd Jd 4d]
Seat 1: tU883G5KFwdH+p2tFuGYtw (big blind) folded before Flop
Seat 2: 7VpIzVwja9q3vCCNM7gRrg folded before Flop (didn't bet)
Seat 4: XLnHQ8GEI3bUQAfNjJuO5Q collected ($24.30)
Seat 5: 2YpnxJiexJHyERfbqgwEcw folded on the Flop
Seat 6: GTQkFJtSkbVbnGCktp6e3g folded before Flop (didn't bet)
Seat 7: O5Go3jrzbQWxRB6ESK+Ptg folded before Flop (didn't bet)
Seat 8: eI48VADSCFoNZBx4T9qs2w (button) folded on the River
Seat 9: DDzMn3tzCgfGf298Xxt5Iw (small blind) folded before Flop



PokerStars Game #59940758388:  Hold'em No Limit ($0.50/$1.00) - 2009/07/01 1:15:44 ET
Table '+cA8mcmhaedZ7YcrDdhmeQ' 6-max Seat #3 is the button
Seat 1: lsLuWlcPA3Rh7kJVLzMh0Q ($273.45 in chips)
Seat 2: RqgF7gRoKgRNW8Zoi1ty4A ($159.25 in chips)
Seat 3: DAIgyIWbYvAkL6PbAI27pg ($17 in chips)
Seat 4: 4OO5v3AVduL0tePNx8wk5A ($107.05 in chips)
Seat 6: YfsTQsY/fxb+YqbdclTHuw ($20.35 in chips)
4OO5v3AVduL0tePNx8wk5A: posts small blind $0.50
YfsTQsY/fxb+YqbdclTHuw: posts big blind $1
*** HOLE CARDS ***
lsLuWlcPA3Rh7kJVLzMh0Q: folds
RqgF7gRoKgRNW8Zoi1ty4A: folds
DAIgyIWbYvAkL6PbAI27pg: folds
4OO5v3AVduL0tePNx8wk5A: folds
YfsTQsY/fxb+YqbdclTHuw collected $1 from pot
*** SUMMARY ***
Total pot $1 | Rake $0
Seat 1: lsLuWlcPA3Rh7kJVLzMh0Q folded before Flop (didn't bet)
Seat 2: RqgF7gRoKgRNW8Zoi1ty4A folded before Flop (didn't bet)
Seat 3: DAIgyIWbYvAkL6PbAI27pg (button) folded before Flop (didn't bet)
Seat 4: 4OO5v3AVduL0tePNx8wk5A (small blind) folded before Flop
Seat 6: YfsTQsY/fxb+YqbdclTHuw (big blind) collected ($1)



PokerStars Game #59940758766:  Hold'em No Limit ($0.50/$1.00) - 2009/07/01 1:15:45 ET
Table 'O96CPOtvMBWP6kzuYDfdFA' 6-max Seat #5 is the button
Seat 1: 6alLXQIITA2EZ/lBeym8Dw ($120.75 in chips)
Seat 2: 4d1rWhpu8DzLmzMbR3QKyA ($111.35 in chips)
Seat 3: V89DGjxE171oPREEbAXiyg ($89.10 in chips)
Seat 4: /P4w1pHg2zHYg/4ubJ0dPw ($60 in chips)
Seat 5: G5ZSSN6RSON3gkNvk/SmYg ($100 in chips)
Seat 6: GYei5jXGWexiJYbAT2fELg ($38.65 in chips)
GYei5jXGWexiJYbAT2fELg: posts small blind $0.50
6alLXQIITA2EZ/lBeym8Dw: posts big blind $1
*** HOLE CARDS ***
4d1rWhpu8DzLmzMbR3QKyA: folds
V89DGjxE171oPREEbAXiyg: folds
/P4w1pHg2zHYg/4ubJ0dPw: folds
G5ZSSN6RSON3gkNvk/SmYg: folds
GYei5jXGWexiJYbAT2fELg: folds
6alLXQIITA2EZ/lBeym8Dw collected $1 from pot
*** SUMMARY ***
Total pot $1 | Rake $0
Seat 1: 6alLXQIITA2EZ/lBeym8Dw (big blind) collected ($1)
Seat 2: 4d1rWhpu8DzLmzMbR3QKyA folded before Flop (didn't bet)
Seat 3: V89DGjxE171oPREEbAXiyg folded before Flop (didn't bet)
Seat 4: /P4w1pHg2zHYg/4ubJ0dPw folded before Flop (didn't bet)
Seat 5: G5ZSSN6RSON3gkNvk/SmYg (button) folded before Flop (didn't bet)
Seat 6: GYei5jXGWexiJYbAT2fELg (small blind) folded before Flop



PokerStars Game #59940760620:  Hold'em No Limit ($0.50/$1.00) - 2009/07/01 1:15:48 ET
Table '/RZcOwpZpHQ+OwPwjsbnRw' 6-max Seat #1 is the button
Seat 1: +uSzP8Jwnw7sKfQ4s66b7w ($52.25 in chips)
Seat 2: Z2fXsGcjl+Eax+RzOgwOmg ($100 in chips)
Seat 4: j7NIOHLZk7V2o9fOioO5ug ($108.20 in chips)
Seat 5: wx3sQGkVi2x9wJXuWNHPBw ($167.75 in chips)
Z2fXsGcjl+Eax+RzOgwOmg: posts small blind $0.50
j7NIOHLZk7V2o9fOioO5ug: posts big blind $1
*** HOLE CARDS ***
wx3sQGkVi2x9wJXuWNHPBw: folds
2d/PU00mMdO9azAaXqcSbw leaves the table
XnT1yK2DD/5FL+0bwuEhqg leaves the table
+uSzP8Jwnw7sKfQ4s66b7w: folds
Z2fXsGcjl+Eax+RzOgwOmg: raises $2 to $3
j7NIOHLZk7V2o9fOioO5ug: calls $2
*** FLOP *** [3s 8d 9h]
Z2fXsGcjl+Eax+RzOgwOmg: bets $4
j7NIOHLZk7V2o9fOioO5ug: calls $4
*** TURN *** [3s 8d 9h] [Kh]
6hLdALbOlkzGIrc53QKtPw joins the table at seat #3
Z2fXsGcjl+Eax+RzOgwOmg: bets $9
o3YLm/rSY916m/on1VjXPA joins the table at seat #6
j7NIOHLZk7V2o9fOioO5ug: calls $9
*** RIVER *** [3s 8d 9h Kh] [6c]
Z2fXsGcjl+Eax+RzOgwOmg: bets $22
j7NIOHLZk7V2o9fOioO5ug: calls $22
*** SHOW DOWN ***
Z2fXsGcjl+Eax+RzOgwOmg: shows [8c 7d] (a pair of Eights)
j7NIOHLZk7V2o9fOioO5ug: shows [Kc Qd] (a pair of Kings)
j7NIOHLZk7V2o9fOioO5ug collected $74 from pot
*** SUMMARY ***
Total pot $76 | Rake $2
Board [3s 8d 9h Kh 6c]
Seat 1: +uSzP8Jwnw7sKfQ4s66b7w (button) folded before Flop (didn't bet)
Seat 2: Z2fXsGcjl+Eax+RzOgwOmg (small blind) showed [8c 7d] and lost with a pair of Eights
Seat 4: j7NIOHLZk7V2o9fOioO5ug (big blind) showed [Kc Qd] and won ($74) with a pair of Kings
Seat 5: wx3sQGkVi2x9wJXuWNHPBw folded before Flop (didn't bet)



PokerStars Game #59940761686:  Hold'em No Limit ($0.50/$1.00) - 2009/07/01 1:15:50 ET
Table 'mmbQQVBTrPdE+wy+s+9VPA' 6-max Seat #1 is the button
Seat 1: zyP4SPoWZnKUfTvIRLCVog ($69.75 in chips)
Seat 2: XK4Qsl+DA8gAJyg85/zBIw ($23.95 in chips)
Seat 3: wx3sQGkVi2x9wJXuWNHPBw ($109.65 in chips)
Seat 4: V3iZdcw61nXF3g5hD2RrsQ ($114.90 in chips)
Seat 5: YMJG+F++3Aj6P8dAWda5fw ($102.10 in chips)
Seat 6: U2CWBTv29qdCbj8RNF2sIw ($102.60 in chips)
XK4Qsl+DA8gAJyg85/zBIw: posts small blind $0.50
wx3sQGkVi2x9wJXuWNHPBw: posts big blind $1
*** HOLE CARDS ***
V3iZdcw61nXF3g5hD2RrsQ: folds
U2CWBTv29qdCbj8RNF2sIw said, "he can't see my cards? weird"
YMJG+F++3Aj6P8dAWda5fw: raises $2 to $3
U2CWBTv29qdCbj8RNF2sIw: folds
zyP4SPoWZnKUfTvIRLCVog: calls $3
XK4Qsl+DA8gAJyg85/zBIw: calls $2.50
wx3sQGkVi2x9wJXuWNHPBw: calls $2
*** FLOP *** [4c Kh 9s]
XK4Qsl+DA8gAJyg85/zBIw: checks
wx3sQGkVi2x9wJXuWNHPBw: checks
XK4Qsl+DA8gAJyg85/zBIw said, "just start announcing what you have."
YMJG+F++3Aj6P8dAWda5fw: bets $7
zyP4SPoWZnKUfTvIRLCVog: folds
XK4Qsl+DA8gAJyg85/zBIw: folds
wx3sQGkVi2x9wJXuWNHPBw: folds
YMJG+F++3Aj6P8dAWda5fw collected $11.40 from pot
*** SUMMARY ***
Total pot $12 | Rake $0.60
Board [4c Kh 9s]
Seat 1: zyP4SPoWZnKUfTvIRLCVog (button) folded on the Flop
Seat 2: XK4Qsl+DA8gAJyg85/zBIw (small blind) folded on the Flop
Seat 3: wx3sQGkVi2x9wJXuWNHPBw (big blind) folded on the Flop
Seat 4: V3iZdcw61nXF3g5hD2RrsQ folded before Flop (didn't bet)
Seat 5: YMJG+F++3Aj6P8dAWda5fw collected ($11.40)
Seat 6: U2CWBTv29qdCbj8RNF2sIw folded before Flop (didn't bet)



PokerStars Game #59940762864:  Hold'em No Limit ($0.50/$1.00) - 2009/07/01 1:15:52 ET
Table 'fTlPiCj0utgzC/5io+I7ew' 6-max Seat #1 is the button
Seat 1: YMJG+F++3Aj6P8dAWda5fw ($101.35 in chips)
Seat 3: Z2fXsGcjl+Eax+RzOgwOmg ($101.50 in chips)
Seat 4: uJVSceLggtsrJya+WtmUEA ($175.15 in chips)
Seat 5: XUk5GQsfNFpHvaToDZ0rZA ($51.50 in chips)
Seat 6: y27w5IK2WXqmYzS8OU0wKA ($100 in chips)
KDYsHh8K2SUXXDvLsAhbJQ will be allowed to play after the button
Z2fXsGcjl+Eax+RzOgwOmg: posts small blind $0.50
uJVSceLggtsrJya+WtmUEA: posts big blind $1
*** HOLE CARDS ***
XUk5GQsfNFpHvaToDZ0rZA: folds
y27w5IK2WXqmYzS8OU0wKA: folds
YMJG+F++3Aj6P8dAWda5fw: folds
Z2fXsGcjl+Eax+RzOgwOmg: raises $2 to $3
uJVSceLggtsrJya+WtmUEA: folds
Z2fXsGcjl+Eax+RzOgwOmg collected $2 from pot
*** SUMMARY ***
Total pot $2 | Rake $0
Seat 1: YMJG+F++3Aj6P8dAWda5fw (button) folded before Flop (didn't bet)
Seat 3: Z2fXsGcjl+Eax+RzOgwOmg (small blind) collected ($2)
Seat 4: uJVSceLggtsrJya+WtmUEA (big blind) folded before Flop
Seat 5: XUk5GQsfNFpHvaToDZ0rZA folded before Flop (didn't bet)
Seat 6: y27w5IK2WXqmYzS8OU0wKA folded before Flop (didn't bet)



PokerStars Game #59940764794:  Hold'em No Limit ($0.50/$1.00) - 2009/07/01 1:15:55 ET
Table 'tyUh+jyNvrceIQdKMJjQ2wZFWj23PMihdwrNWv41OG/Qeat #2 is the button
Seat 1: o8A5MUdudVKu+pAwgZOX2w ($128.70 in chips)
Seat 2: 5uy3EN+iIYkgwbWZFTUBAQ ($107.65 in chips)
Seat 3: TalCiLYHCd+ffkmR3auPvA ($131.80 in chips)
Seat 4: hpxXcmRkXXI9HE5+5/j/0Q ($100 in chips)
Seat 5: j7NIOHLZk7V2o9fOioO5ug ($110.85 in chips)
Seat 6: 4OO5v3AVduL0tePNx8wk5A ($100 in chips)
TalCiLYHCd+ffkmR3auPvA: posts small blind $0.50
hpxXcmRkXXI9HE5+5/j/0Q: posts big blind $1
*** HOLE CARDS ***
j7NIOHLZk7V2o9fOioO5ug: folds
4OO5v3AVduL0tePNx8wk5A: folds
o8A5MUdudVKu+pAwgZOX2w: folds
o8A5MUdudVKu+pAwgZOX2w is sitting out
5uy3EN+iIYkgwbWZFTUBAQ: raises $2.50 to $3.50
TalCiLYHCd+ffkmR3auPvA: folds
hpxXcmRkXXI9HE5+5/j/0Q: folds
5uy3EN+iIYkgwbWZFTUBAQ collected $2.50 from pot
5uy3EN+iIYkgwbWZFTUBAQ: doesn't show hand
*** SUMMARY ***
Total pot $2.50 | Rake $0
Seat 1: o8A5MUdudVKu+pAwgZOX2w folded before Flop (didn't bet)
Seat 2: 5uy3EN+iIYkgwbWZFTUBAQ (button) collected ($2.50)
Seat 3: TalCiLYHCd+ffkmR3auPvA (small blind) folded before Flop
Seat 4: hpxXcmRkXXI9HE5+5/j/0Q (big blind) folded before Flop
Seat 5: j7NIOHLZk7V2o9fOioO5ug folded before Flop (didn't bet)
Seat 6: 4OO5v3AVduL0tePNx8wk5A folded before Flop (didn't bet)



PokerStars Game #59940764524:  Hold'em No Limit ($0.50/$1.00) - 2009/07/01 1:15:55 ET
Table 'fZjVbKj9D8yOB+Rj7NaP/A' 9-max Seat #8 is the button
Seat 1: 9BZCcac3+McErkkSN2YScA ($100 in chips)
Seat 2: PTAFYDIUSsG+SArbxNl+Aw ($107 in chips)
Seat 3: yAbu2QsRPVcjPbqlf/jDxw ($102.50 in chips)
Seat 4: 997ViqAtWn1FPjJqcffwcA ($103 in chips)
Seat 5: PkGfq5xrSlNsujKaG/HF4Q ($100 in chips)
Seat 6: OvwYHV65yUbgdBjSmo1+5g ($37.75 in chips)
Seat 7: SyS20PAm3RpT6uLBsGkwOA ($119.30 in chips)
Seat 8: zDOE5r14tWqCf6xhuSHK6g ($46 in chips)
Seat 9: qheQay5YvP2DMAb3OUSxtw ($99 in chips)
qheQay5YvP2DMAb3OUSxtw: posts small blind $0.50
9BZCcac3+McErkkSN2YScA: posts big blind $1
*** HOLE CARDS ***
PTAFYDIUSsG+SArbxNl+Aw: folds
yAbu2QsRPVcjPbqlf/jDxw: folds
997ViqAtWn1FPjJqcffwcA: folds
PkGfq5xrSlNsujKaG/HF4Q: folds
OvwYHV65yUbgdBjSmo1+5g: folds
SyS20PAm3RpT6uLBsGkwOA: folds
zDOE5r14tWqCf6xhuSHK6g: folds
qheQay5YvP2DMAb3OUSxtw: raises $2 to $3
9BZCcac3+McErkkSN2YScA: folds
qheQay5YvP2DMAb3OUSxtw collected $2 from pot
qheQay5YvP2DMAb3OUSxtw: doesn't show hand
*** SUMMARY ***
Total pot $2 | Rake $0
Seat 1: 9BZCcac3+McErkkSN2YScA (big blind) folded before Flop
Seat 2: PTAFYDIUSsG+SArbxNl+Aw folded before Flop (didn't bet)
Seat 3: yAbu2QsRPVcjPbqlf/jDxw folded before Flop (didn't bet)
Seat 4: 997ViqAtWn1FPjJqcffwcA folded before Flop (didn't bet)
Seat 5: PkGfq5xrSlNsujKaG/HF4Q folded before Flop (didn't bet)
Seat 6: OvwYHV65yUbgdBjSmo1+5g folded before Flop (didn't bet)
Seat 7: SyS20PAm3RpT6uLBsGkwOA folded before Flop (didn't bet)
Seat 8: zDOE5r14tWqCf6xhuSHK6g (button) folded before Flop (didn't bet)
Seat 9: qheQay5YvP2DMAb3OUSxtw (small blind) collected ($2)



PokerStars Game #59940765064:  Hold'em No Limit ($0.50/$1.00) - 2009/07/01 1:15:56 ET
Table 'MUPc8FEpe/nR0BKSeReX6Q' 6-max Seat #5 is the button
Seat 1: qhkK6+yCciTRd+rCFEbnEQ ($43.60 in chips)
Seat 2: xAU6q2/cwmby2sxmA8VcmA ($114.70 in chips)
Seat 3: wx3sQGkVi2x9wJXuWNHPBw ($216 in chips)
Seat 4: ZA1bp6g8IwtTxkUE4eCjDQ ($195.20 in chips)
Seat 5: y27w5IK2WXqmYzS8OU0wKA ($100 in chips)
Seat 6: oxnw0GLLpFanjhGkxfRSqA ($57.15 in chips)
oxnw0GLLpFanjhGkxfRSqA: posts small blind $0.50
qhkK6+yCciTRd+rCFEbnEQ: posts big blind $1
*** HOLE CARDS ***
xAU6q2/cwmby2sxmA8VcmA: folds
wx3sQGkVi2x9wJXuWNHPBw: raises $3 to $4
ZA1bp6g8IwtTxkUE4eCjDQ: folds
y27w5IK2WXqmYzS8OU0wKA: folds
oxnw0GLLpFanjhGkxfRSqA: calls $3.50
qhkK6+yCciTRd+rCFEbnEQ: folds
*** FLOP *** [Kc 5s Th]
oxnw0GLLpFanjhGkxfRSqA: checks
wx3sQGkVi2x9wJXuWNHPBw: bets $6
oxnw0GLLpFanjhGkxfRSqA: calls $6
*** TURN *** [Kc 5s Th] [9h]
oxnw0GLLpFanjhGkxfRSqA: checks
wx3sQGkVi2x9wJXuWNHPBw: checks
*** RIVER *** [Kc 5s Th 9h] [3d]
oxnw0GLLpFanjhGkxfRSqA: checks
wx3sQGkVi2x9wJXuWNHPBw: bets $18
oxnw0GLLpFanjhGkxfRSqA: folds
wx3sQGkVi2x9wJXuWNHPBw collected $20 from pot
*** SUMMARY ***
Total pot $21 | Rake $1
Board [Kc 5s Th 9h 3d]
Seat 1: qhkK6+yCciTRd+rCFEbnEQ (big blind) folded before Flop
Seat 2: xAU6q2/cwmby2sxmA8VcmA folded before Flop (didn't bet)
Seat 3: wx3sQGkVi2x9wJXuWNHPBw collected ($20)
Seat 4: ZA1bp6g8IwtTxkUE4eCjDQ folded before Flop (didn't bet)
Seat 5: y27w5IK2WXqmYzS8OU0wKA (button) folded before Flop (didn't bet)
Seat 6: oxnw0GLLpFanjhGkxfRSqA (small blind) folded on the River



PokerStars Game #59940765640:  Hold'em No Limit ($0.50/$1.00) - 2009/07/01 1:15:57 ET
Table 'W/wyObTiXZm+Ckkl3YxcSw' 6-max Seat #1 is the button
Seat 1: eUBBn2R56C1IQ6Cs/vitwg ($172.25 in chips)
Seat 2: oDiBRCaF0QVtd3kO6xZIXw ($170.15 in chips)
Seat 3: dxyNCn/qxfkGDUIf28Cbng ($66.65 in chips)
Seat 4: aYii2DmxlOlbC1wbGRBWvQ ($113.15 in chips)
Seat 5: +OrCjyw70oZhJiD22Mn+bg ($100 in chips)
Seat 6: b2a+5TkFf4xJN/Ihhma58Q ($38 in chips)
oDiBRCaF0QVtd3kO6xZIXw: posts small blind $0.50
dxyNCn/qxfkGDUIf28Cbng: posts big blind $1
*** HOLE CARDS ***
aYii2DmxlOlbC1wbGRBWvQ: folds
+OrCjyw70oZhJiD22Mn+bg: folds
b2a+5TkFf4xJN/Ihhma58Q: folds
eUBBn2R56C1IQ6Cs/vitwg: raises $2 to $3
oDiBRCaF0QVtd3kO6xZIXw: calls $2.50
dxyNCn/qxfkGDUIf28Cbng: folds
*** FLOP *** [6d 6h 3h]
oDiBRCaF0QVtd3kO6xZIXw: checks
eUBBn2R56C1IQ6Cs/vitwg: checks
*** TURN *** [6d 6h 3h] [9h]
oDiBRCaF0QVtd3kO6xZIXw: bets $4
eUBBn2R56C1IQ6Cs/vitwg: calls $4
*** RIVER *** [6d 6h 3h 9h] [3s]
oDiBRCaF0QVtd3kO6xZIXw: bets $8
eUBBn2R56C1IQ6Cs/vitwg: calls $8
*** SHOW DOWN ***
oDiBRCaF0QVtd3kO6xZIXw: shows [8s 5c] (two pair, Sixes and Threes)
eUBBn2R56C1IQ6Cs/vitwg: shows [9d Tc] (two pair, Nines and Sixes)
eUBBn2R56C1IQ6Cs/vitwg collected $29.50 from pot
*** SUMMARY ***
Total pot $31 | Rake $1.50
Board [6d 6h 3h 9h 3s]
Seat 1: eUBBn2R56C1IQ6Cs/vitwg (button) showed [9d Tc] and won ($29.50) with two pair, Nines and Sixes
Seat 2: oDiBRCaF0QVtd3kO6xZIXw (small blind) showed [8s 5c] and lost with two pair, Sixes and Threes
Seat 3: dxyNCn/qxfkGDUIf28Cbng (big blind) folded before Flop
Seat 4: aYii2DmxlOlbC1wbGRBWvQ folded before Flop (didn't bet)
Seat 5: +OrCjyw70oZhJiD22Mn+bg folded before Flop (didn't bet)
Seat 6: b2a+5TkFf4xJN/Ihhma58Q folded before Flop (didn't bet)



PokerStars Game #59940768988:  Hold'em No Limit ($0.50/$1.00) - 2009/07/01 1:16:03 ET
Table 'cKH9c4x6u79IqCdaKKvXrw' 9-max Seat #5 is the button
Seat 1: Pp/KTcXkfZKKUHkjyaLTdg ($18.50 in chips)
Seat 2: 8S3JMH4TY3whgIlZmMv66w ($62.55 in chips)
Seat 3: 997ViqAtWn1FPjJqcffwcA ($154.10 in chips)
Seat 4: FL3MrLspcF23LYvC4ipBOA ($100 in chips)
Seat 5: Jjc7EHWzs4//xUAjJ0UWoA ($42.40 in chips)
Seat 6: Bsd/K5gAcLanYbGiPirRjw ($207.05 in chips)
Seat 7: 1GkkVBhlJ92guE6K5mS5Ig ($16.40 in chips)
Seat 8: myIxN7otsyr846M539YR8Q ($31.35 in chips)
Seat 9: 6XkTu4ahxzHnvjjc1R8YjQ ($37.10 in chips)
Bsd/K5gAcLanYbGiPirRjw: posts small blind $0.50
1GkkVBhlJ92guE6K5mS5Ig: posts big blind $1
*** HOLE CARDS ***
myIxN7otsyr846M539YR8Q: folds
6XkTu4ahxzHnvjjc1R8YjQ: folds
Pp/KTcXkfZKKUHkjyaLTdg: raises $2.50 to $3.50
8S3JMH4TY3whgIlZmMv66w: folds
997ViqAtWn1FPjJqcffwcA: folds
FL3MrLspcF23LYvC4ipBOA: folds
Jjc7EHWzs4//xUAjJ0UWoA is disconnected
Jjc7EHWzs4//xUAjJ0UWoA is connected
Jjc7EHWzs4//xUAjJ0UWoA: folds
Bsd/K5gAcLanYbGiPirRjw: folds
1GkkVBhlJ92guE6K5mS5Ig: calls $2.50
*** FLOP *** [7d 9d 8d]
1GkkVBhlJ92guE6K5mS5Ig: checks
Pp/KTcXkfZKKUHkjyaLTdg: bets $3.50
1GkkVBhlJ92guE6K5mS5Ig: calls $3.50
*** TURN *** [7d 9d 8d] [Ks]
1GkkVBhlJ92guE6K5mS5Ig: checks
Pp/KTcXkfZKKUHkjyaLTdg: bets $11.50 and is all-in
1GkkVBhlJ92guE6K5mS5Ig: calls $9.40 and is all-in
*** RIVER *** [7d 9d 8d Ks] [Jd]
*** SHOW DOWN ***
1GkkVBhlJ92guE6K5mS5Ig: shows [Js Kd] (a flush, King high)
Pp/KTcXkfZKKUHkjyaLTdg: shows [Tc Td] (a straight flush, Seven to Jack)
Pp/KTcXkfZKKUHkjyaLTdg collected $31.70 from pot
*** SUMMARY ***
Total pot $33.30 | Rake $1.60
Board [7d 9d 8d Ks Jd]
Seat 1: Pp/KTcXkfZKKUHkjyaLTdg showed [Tc Td] and won ($31.70) with a straight flush, Seven to Jack
Seat 2: 8S3JMH4TY3whgIlZmMv66w folded before Flop (didn't bet)
Seat 3: 997ViqAtWn1FPjJqcffwcA folded before Flop (didn't bet)
Seat 4: FL3MrLspcF23LYvC4ipBOA folded before Flop (didn't bet)
Seat 5: Jjc7EHWzs4//xUAjJ0UWoA (button) folded before Flop (didn't bet)
Seat 6: Bsd/K5gAcLanYbGiPirRjw (small blind) folded before Flop
Seat 7: 1GkkVBhlJ92guE6K5mS5Ig (big blind) showed [Js Kd] and lost with a flush, King high
Seat 8: myIxN7otsyr846M539YR8Q folded before Flop (didn't bet)
Seat 9: 6XkTu4ahxzHnvjjc1R8YjQ folded before Flop (didn't bet)



PokerStars Game #59940770478:  Hold'em No Limit ($0.50/$1.00) - 2009/07/01 1:16:05 ET
Table '+cA8mcmhaedZ7YcrDdhmeQ' 6-max Seat #4 is the button
Seat 1: lsLuWlcPA3Rh7kJVLzMh0Q ($273.45 in chips)
Seat 2: RqgF7gRoKgRNW8Zoi1ty4A ($159.25 in chips)
Seat 3: DAIgyIWbYvAkL6PbAI27pg ($17 in chips)
Seat 4: 4OO5v3AVduL0tePNx8wk5A ($106.55 in chips)
Seat 6: YfsTQsY/fxb+YqbdclTHuw ($20.85 in chips)
YfsTQsY/fxb+YqbdclTHuw: posts small blind $0.50
lsLuWlcPA3Rh7kJVLzMh0Q: posts big blind $1
*** HOLE CARDS ***
RqgF7gRoKgRNW8Zoi1ty4A: raises $3 to $4
DAIgyIWbYvAkL6PbAI27pg: folds
4OO5v3AVduL0tePNx8wk5A: folds
YfsTQsY/fxb+YqbdclTHuw: calls $3.50
lsLuWlcPA3Rh7kJVLzMh0Q: folds
*** FLOP *** [Jc Ac 7h]
YfsTQsY/fxb+YqbdclTHuw: checks
RqgF7gRoKgRNW8Zoi1ty4A: bets $5
YfsTQsY/fxb+YqbdclTHuw: folds
RqgF7gRoKgRNW8Zoi1ty4A collected $8.55 from pot
*** SUMMARY ***
Total pot $9 | Rake $0.45
Board [Jc Ac 7h]
Seat 1: lsLuWlcPA3Rh7kJVLzMh0Q (big blind) folded before Flop
Seat 2: RqgF7gRoKgRNW8Zoi1ty4A collected ($8.55)
Seat 3: DAIgyIWbYvAkL6PbAI27pg folded before Flop (didn't bet)
Seat 4: 4OO5v3AVduL0tePNx8wk5A (button) folded before Flop (didn't bet)
Seat 6: YfsTQsY/fxb+YqbdclTHuw (small blind) folded on the Flop



PokerStars Game #59940770152:  Hold'em No Limit ($0.50/$1.00) - 2009/07/01 1:16:05 ET
Table 'gxFK0BVUD7cupu2uyRUZJg' 6-max Seat #1 is the button
Seat 1: M+X3uChmP6R63IwijVjgTg ($127.60 in chips)
Seat 2: hpxXcmRkXXI9HE5+5/j/0Q ($120.60 in chips)
Seat 3: Z2fXsGcjl+Eax+RzOgwOmg ($128.25 in chips)
Seat 5: WgIrs6CBinyyw18pqdDtWA ($34.90 in chips)
Seat 6: dYyb6/42PMC8aNFlm/eBeQ ($67.35 in chips)
hpxXcmRkXXI9HE5+5/j/0Q: posts small blind $0.50
Z2fXsGcjl+Eax+RzOgwOmg: posts big blind $1
*** HOLE CARDS ***
WgIrs6CBinyyw18pqdDtWA: folds
dYyb6/42PMC8aNFlm/eBeQ: folds
M+X3uChmP6R63IwijVjgTg: raises $3 to $4
hpxXcmRkXXI9HE5+5/j/0Q: folds
Z2fXsGcjl+Eax+RzOgwOmg: folds
M+X3uChmP6R63IwijVjgTg collected $2.50 from pot
*** SUMMARY ***
Total pot $2.50 | Rake $0
Seat 1: M+X3uChmP6R63IwijVjgTg (button) collected ($2.50)
Seat 2: hpxXcmRkXXI9HE5+5/j/0Q (small blind) folded before Flop
Seat 3: Z2fXsGcjl+Eax+RzOgwOmg (big blind) folded before Flop
Seat 5: WgIrs6CBinyyw18pqdDtWA folded before Flop (didn't bet)
Seat 6: dYyb6/42PMC8aNFlm/eBeQ folded before Flop (didn't bet)



PokerStars Game #59940771654:  Hold'em No Limit ($0.50/$1.00) - 2009/07/01 1:16:07 ET
Table 'hugOjcwJvzEwZbK7tyiWuQ' 9-max Seat #8 is the button
Seat 1: S3Ex8K7v6xm5jqjRM7Fl3w ($22 in chips)
Seat 2: r27C1nIV4NS4+qbnrgBQSw ($281.70 in chips)
Seat 4: UWB3oeddt/GObx2Mix2Anw ($171.30 in chips)
Seat 5: 5BRGWf+R3nt2WS3b5xX+zA ($26.35 in chips)
Seat 6: gUUvmqdVlmvpal6B8nYrmg ($103 in chips)
Seat 7: FL3MrLspcF23LYvC4ipBOA ($108.80 in chips)
Seat 8: /zy+DB4S5fUQUSfZWFzYGw ($111.05 in chips)
Seat 9: W8P9bUKCs43TO1xHm0dL6w ($88.45 in chips)
W8P9bUKCs43TO1xHm0dL6w: posts small blind $0.50
S3Ex8K7v6xm5jqjRM7Fl3w: posts big blind $1
*** HOLE CARDS ***
r27C1nIV4NS4+qbnrgBQSw: folds
UWB3oeddt/GObx2Mix2Anw: folds
5BRGWf+R3nt2WS3b5xX+zA: folds
gUUvmqdVlmvpal6B8nYrmg: folds
FL3MrLspcF23LYvC4ipBOA: raises $2 to $3
/zy+DB4S5fUQUSfZWFzYGw: raises $7 to $10
W8P9bUKCs43TO1xHm0dL6w: folds
S3Ex8K7v6xm5jqjRM7Fl3w: folds
FL3MrLspcF23LYvC4ipBOA: raises $21 to $31
/zy+DB4S5fUQUSfZWFzYGw: folds
FL3MrLspcF23LYvC4ipBOA collected $21.50 from pot
*** SUMMARY ***
Total pot $21.50 | Rake $0
Seat 1: S3Ex8K7v6xm5jqjRM7Fl3w (big blind) folded before Flop
Seat 2: r27C1nIV4NS4+qbnrgBQSw folded before Flop (didn't bet)
Seat 4: UWB3oeddt/GObx2Mix2Anw folded before Flop (didn't bet)
Seat 5: 5BRGWf+R3nt2WS3b5xX+zA folded before Flop (didn't bet)
Seat 6: gUUvmqdVlmvpal6B8nYrmg folded before Flop (didn't bet)
Seat 7: FL3MrLspcF23LYvC4ipBOA collected ($21.50)
Seat 8: /zy+DB4S5fUQUSfZWFzYGw (button) folded before Flop
Seat 9: W8P9bUKCs43TO1xHm0dL6w (small blind) folded before Flop



PokerStars Game #59940773138:  Hold'em No Limit ($0.50/$1.00) - 2009/07/01 1:16:10 ET
Table 'VOs36P6NW+QyXeQ1B62kmA' 6-max Seat #1 is the button
Seat 1: Z2fXsGcjl+Eax+RzOgwOmg ($102.50 in chips)
Seat 2: y27w5IK2WXqmYzS8OU0wKA ($100 in chips)
Seat 3: 6hLdALbOlkzGIrc53QKtPw ($20 in chips)
Seat 6: slVKuQyEz8Qj4E3uLPYNXg ($153.95 in chips)
y27w5IK2WXqmYzS8OU0wKA: posts small blind $0.50
6hLdALbOlkzGIrc53QKtPw: posts big blind $1
*** HOLE CARDS ***
slVKuQyEz8Qj4E3uLPYNXg: raises $1 to $2
Z2fXsGcjl+Eax+RzOgwOmg: folds
w02zQzNydODiyV9THKgo9w has returned
y27w5IK2WXqmYzS8OU0wKA: folds
6hLdALbOlkzGIrc53QKtPw: raises $18 to $20 and is all-in
slVKuQyEz8Qj4E3uLPYNXg: folds
6hLdALbOlkzGIrc53QKtPw collected $4.50 from pot
6hLdALbOlkzGIrc53QKtPw: doesn't show hand
*** SUMMARY ***
Total pot $4.50 | Rake $0
Seat 1: Z2fXsGcjl+Eax+RzOgwOmg (button) folded before Flop (didn't bet)
Seat 2: y27w5IK2WXqmYzS8OU0wKA (small blind) folded before Flop
Seat 3: 6hLdALbOlkzGIrc53QKtPw (big blind) collected ($4.50)
Seat 6: slVKuQyEz8Qj4E3uLPYNXg folded before Flop



PokerStars Game #59940773238:  Hold'em No Limit ($0.50/$1.00) - 2009/07/01 1:16:10 ET
Table '7O9fB8yx1u7sJveJn8w6jA' 6-max Seat #2 is the button
Seat 1: jy52+7FotjH63o5tEEVgKw ($57.85 in chips)
Seat 2: wx3sQGkVi2x9wJXuWNHPBw ($195.25 in chips)
Seat 3: hpxXcmRkXXI9HE5+5/j/0Q ($124.75 in chips)
Seat 4: b2a+5TkFf4xJN/Ihhma58Q ($41.30 in chips)
Seat 5: BCEV3COoKY607AzLWayfRA ($101.85 in chips)
Seat 6: p1Ga2i1TuXUvRn+Rf/0FMw ($118.25 in chips)
hpxXcmRkXXI9HE5+5/j/0Q: posts small blind $0.50
b2a+5TkFf4xJN/Ihhma58Q: posts big blind $1
*** HOLE CARDS ***
BCEV3COoKY607AzLWayfRA: folds
p1Ga2i1TuXUvRn+Rf/0FMw: calls $1
jy52+7FotjH63o5tEEVgKw: calls $1
wx3sQGkVi2x9wJXuWNHPBw: folds
hpxXcmRkXXI9HE5+5/j/0Q: folds
b2a+5TkFf4xJN/Ihhma58Q: checks
*** FLOP *** [Ac 7d 3h]
b2a+5TkFf4xJN/Ihhma58Q: checks
p1Ga2i1TuXUvRn+Rf/0FMw: checks
jy52+7FotjH63o5tEEVgKw: checks
*** TURN *** [Ac 7d 3h] [8c]
b2a+5TkFf4xJN/Ihhma58Q: checks
p1Ga2i1TuXUvRn+Rf/0FMw: checks
jy52+7FotjH63o5tEEVgKw: checks
*** RIVER *** [Ac 7d 3h 8c] [Qc]
b2a+5TkFf4xJN/Ihhma58Q: bets $2
p1Ga2i1TuXUvRn+Rf/0FMw: raises $2 to $4
jy52+7FotjH63o5tEEVgKw: folds
b2a+5TkFf4xJN/Ihhma58Q: folds
p1Ga2i1TuXUvRn+Rf/0FMw collected $7.15 from pot
*** SUMMARY ***
Total pot $7.50 | Rake $0.35
Board [Ac 7d 3h 8c Qc]
Seat 1: jy52+7FotjH63o5tEEVgKw folded on the River
Seat 2: wx3sQGkVi2x9wJXuWNHPBw (button) folded before Flop (didn't bet)
Seat 3: hpxXcmRkXXI9HE5+5/j/0Q (small blind) folded before Flop
Seat 4: b2a+5TkFf4xJN/Ihhma58Q (big blind) folded on the River
Seat 5: BCEV3COoKY607AzLWayfRA folded before Flop (didn't bet)
Seat 6: p1Ga2i1TuXUvRn+Rf/0FMw collected ($7.15)



PokerStars Game #59940774656:  Hold'em No Limit ($0.50/$1.00) - 2009/07/01 1:16:12 ET
Table 'QSIig7BLMc9wY/rgBechzw' 6-max Seat #2 is the button
Seat 1: Z2fXsGcjl+Eax+RzOgwOmg ($112 in chips)
Seat 2: mLOIkH/qmRa+mVujQIhBRg ($31.30 in chips)
Seat 3: +xW7QemQU0Fxs+4TnqBRow ($106.90 in chips)
Seat 4: +uSzP8Jwnw7sKfQ4s66b7w ($73.95 in chips)
Seat 5: lsLuWlcPA3Rh7kJVLzMh0Q ($108.95 in chips)
Seat 6: PxqfkAMdAWtkgbT+q2gciA ($36.65 in chips)
+xW7QemQU0Fxs+4TnqBRow: posts small blind $0.50
+uSzP8Jwnw7sKfQ4s66b7w: posts big blind $1
*** HOLE CARDS ***
lsLuWlcPA3Rh7kJVLzMh0Q: folds
PxqfkAMdAWtkgbT+q2gciA: folds
Z2fXsGcjl+Eax+RzOgwOmg: folds
mLOIkH/qmRa+mVujQIhBRg: raises $1 to $2
+xW7QemQU0Fxs+4TnqBRow: folds
+uSzP8Jwnw7sKfQ4s66b7w: calls $1
*** FLOP *** [3c 4c 8d]
+uSzP8Jwnw7sKfQ4s66b7w: checks
mLOIkH/qmRa+mVujQIhBRg: bets $2
+uSzP8Jwnw7sKfQ4s66b7w: folds
mLOIkH/qmRa+mVujQIhBRg collected $4.30 from pot
*** SUMMARY ***
Total pot $4.50 | Rake $0.20
Board [3c 4c 8d]
Seat 1: Z2fXsGcjl+Eax+RzOgwOmg folded before Flop (didn't bet)
Seat 2: mLOIkH/qmRa+mVujQIhBRg (button) collected ($4.30)
Seat 3: +xW7QemQU0Fxs+4TnqBRow (small blind) folded before Flop
Seat 4: +uSzP8Jwnw7sKfQ4s66b7w (big blind) folded on the Flop
Seat 5: lsLuWlcPA3Rh7kJVLzMh0Q folded before Flop (didn't bet)
Seat 6: PxqfkAMdAWtkgbT+q2gciA folded before Flop (didn't bet)



PokerStars Game #59940774288:  Hold'em No Limit ($0.50/$1.00) - 2009/07/01 1:16:12 ET
Table 'GPp0HyAuggN8oE0sUWzPpA' 9-max Seat #5 is the button
Seat 1: qJr25HAtvv1w/7IBvjMM3g ($40.20 in chips)
Seat 2: m3U8I35Pn3gxKhoS2nmYIg ($13.40 in chips)
Seat 3: CCCXsirC+bO7ginAuUUVlQ ($59.25 in chips)
Seat 4: mBRWbnUl8diyBO1qTJaNzw ($101.65 in chips)
Seat 5: bLbSOSmSOnqE0iTcH/5dxA ($100 in chips)
Seat 6: BK/GtNPkSx0TdUDj82id5A ($34.70 in chips)
Seat 7: DHdbHyysD15wCAtx+BhUjA ($96.70 in chips)
Seat 9: dzoSjPZmtjGuK83119030A ($34.15 in chips)
BK/GtNPkSx0TdUDj82id5A: posts small blind $0.50
DHdbHyysD15wCAtx+BhUjA: posts big blind $1
P/6qLjycEfxRgZ5F/W90dw: sits out
*** HOLE CARDS ***
dzoSjPZmtjGuK83119030A: folds
qJr25HAtvv1w/7IBvjMM3g: folds
m3U8I35Pn3gxKhoS2nmYIg: folds
CCCXsirC+bO7ginAuUUVlQ: folds
mBRWbnUl8diyBO1qTJaNzw: folds
bLbSOSmSOnqE0iTcH/5dxA: folds
BK/GtNPkSx0TdUDj82id5A: folds
DHdbHyysD15wCAtx+BhUjA collected $1 from pot
*** SUMMARY ***
Total pot $1 | Rake $0
Seat 1: qJr25HAtvv1w/7IBvjMM3g folded before Flop (didn't bet)
Seat 2: m3U8I35Pn3gxKhoS2nmYIg folded before Flop (didn't bet)
Seat 3: CCCXsirC+bO7ginAuUUVlQ folded before Flop (didn't bet)
Seat 4: mBRWbnUl8diyBO1qTJaNzw folded before Flop (didn't bet)
Seat 5: bLbSOSmSOnqE0iTcH/5dxA (button) folded before Flop (didn't bet)
Seat 6: BK/GtNPkSx0TdUDj82id5A (small blind) folded before Flop
Seat 7: DHdbHyysD15wCAtx+BhUjA (big blind) collected ($1)
Seat 9: dzoSjPZmtjGuK83119030A folded before Flop (didn't bet)



PokerStars Game #59940776110:  Hold'em No Limit ($0.50/$1.00) - 2009/07/01 1:16:15 ET
Table 'O96CPOtvMBWP6kzuYDfdFA' 6-max Seat #6 is the button
Seat 1: 6alLXQIITA2EZ/lBeym8Dw ($121.25 in chips)
Seat 2: 4d1rWhpu8DzLmzMbR3QKyA ($111.35 in chips)
Seat 3: V89DGjxE171oPREEbAXiyg ($89.10 in chips)
Seat 4: /P4w1pHg2zHYg/4ubJ0dPw ($60 in chips)
Seat 5: G5ZSSN6RSON3gkNvk/SmYg ($100 in chips)
Seat 6: GYei5jXGWexiJYbAT2fELg ($38.15 in chips)
6alLXQIITA2EZ/lBeym8Dw: posts small blind $0.50
4d1rWhpu8DzLmzMbR3QKyA: posts big blind $1
*** HOLE CARDS ***
V89DGjxE171oPREEbAXiyg: folds
/P4w1pHg2zHYg/4ubJ0dPw: folds
G5ZSSN6RSON3gkNvk/SmYg: folds
GYei5jXGWexiJYbAT2fELg: folds
6alLXQIITA2EZ/lBeym8Dw: raises $2 to $3
4d1rWhpu8DzLmzMbR3QKyA: folds
6alLXQIITA2EZ/lBeym8Dw collected $2 from pot
*** SUMMARY ***
Total pot $2 | Rake $0
Seat 1: 6alLXQIITA2EZ/lBeym8Dw (small blind) collected ($2)
Seat 2: 4d1rWhpu8DzLmzMbR3QKyA (big blind) folded before Flop
Seat 3: V89DGjxE171oPREEbAXiyg folded before Flop (didn't bet)
Seat 4: /P4w1pHg2zHYg/4ubJ0dPw folded before Flop (didn't bet)
Seat 5: G5ZSSN6RSON3gkNvk/SmYg folded before Flop (didn't bet)
Seat 6: GYei5jXGWexiJYbAT2fELg (button) folded before Flop (didn't bet)



PokerStars Game #59940777182:  Hold'em No Limit ($0.50/$1.00) - 2009/07/01 1:16:17 ET
Table 'tyUh+jyNvrceIQdKMJjQ2wZFWj23PMihdwrNWv41OG/Qeat #3 is the button
Seat 2: 5uy3EN+iIYkgwbWZFTUBAQ ($109.15 in chips)
Seat 3: TalCiLYHCd+ffkmR3auPvA ($131.30 in chips)
Seat 4: hpxXcmRkXXI9HE5+5/j/0Q ($100 in chips)
Seat 5: j7NIOHLZk7V2o9fOioO5ug ($110.85 in chips)
Seat 6: 4OO5v3AVduL0tePNx8wk5A ($100 in chips)
hpxXcmRkXXI9HE5+5/j/0Q: posts small blind $0.50
j7NIOHLZk7V2o9fOioO5ug: posts big blind $1
*** HOLE CARDS ***
o8A5MUdudVKu+pAwgZOX2w is disconnected
4OO5v3AVduL0tePNx8wk5A: raises $3 to $4
5uy3EN+iIYkgwbWZFTUBAQ: raises $9.50 to $13.50
TalCiLYHCd+ffkmR3auPvA: folds
hpxXcmRkXXI9HE5+5/j/0Q: folds
j7NIOHLZk7V2o9fOioO5ug: folds
4OO5v3AVduL0tePNx8wk5A: raises $20.50 to $34
5uy3EN+iIYkgwbWZFTUBAQ: folds
4OO5v3AVduL0tePNx8wk5A collected $28.50 from pot
4OO5v3AVduL0tePNx8wk5A: doesn't show hand
*** SUMMARY ***
Total pot $28.50 | Rake $0
Seat 2: 5uy3EN+iIYkgwbWZFTUBAQ folded before Flop
Seat 3: TalCiLYHCd+ffkmR3auPvA (button) folded before Flop (didn't bet)
Seat 4: hpxXcmRkXXI9HE5+5/j/0Q (small blind) folded before Flop
Seat 5: j7NIOHLZk7V2o9fOioO5ug (big blind) folded before Flop
Seat 6: 4OO5v3AVduL0tePNx8wk5A collected ($28.50)



PokerStars Game #59940778596:  Hold'em No Limit ($0.50/$1.00) - 2009/07/01 1:16:19 ET
Table 'pHrhryH8jPNdQfY62f8v+g' 6-max Seat #2 is the button
Seat 1: 4d1rWhpu8DzLmzMbR3QKyA ($117.40 in chips)
Seat 2: JwCcjZl0bjJzG7hmE0dnTA ($100 in chips)
Seat 3: 8oS5O7iD/qnFXFXJrGIgNQ ($100 in chips)
Seat 4: 1f3beyIML24UqEMTbWy93g ($43.15 in chips)
Seat 5: r1/R7y0Ortgoz4lccgW8VA ($39.95 in chips)
Seat 6: xAU6q2/cwmby2sxmA8VcmA ($206.60 in chips)
8oS5O7iD/qnFXFXJrGIgNQ: posts small blind $0.50
1f3beyIML24UqEMTbWy93g: posts big blind $1
*** HOLE CARDS ***
r1/R7y0Ortgoz4lccgW8VA: calls $1
xAU6q2/cwmby2sxmA8VcmA: folds
4d1rWhpu8DzLmzMbR3QKyA: folds
JwCcjZl0bjJzG7hmE0dnTA: folds
8oS5O7iD/qnFXFXJrGIgNQ: calls $0.50
1f3beyIML24UqEMTbWy93g: checks
*** FLOP *** [6c Tc 2c]
8oS5O7iD/qnFXFXJrGIgNQ: checks
1f3beyIML24UqEMTbWy93g: checks
r1/R7y0Ortgoz4lccgW8VA: checks
*** TURN *** [6c Tc 2c] [Jd]
8oS5O7iD/qnFXFXJrGIgNQ: bets $3
1f3beyIML24UqEMTbWy93g: folds
r1/R7y0Ortgoz4lccgW8VA: calls $3
*** RIVER *** [6c Tc 2c Jd] [Ah]
8oS5O7iD/qnFXFXJrGIgNQ: checks
r1/R7y0Ortgoz4lccgW8VA: bets $3
8oS5O7iD/qnFXFXJrGIgNQ: folds
r1/R7y0Ortgoz4lccgW8VA collected $8.60 from pot
*** SUMMARY ***
Total pot $9 | Rake $0.40
Board [6c Tc 2c Jd Ah]
Seat 1: 4d1rWhpu8DzLmzMbR3QKyA folded before Flop (didn't bet)
Seat 2: JwCcjZl0bjJzG7hmE0dnTA (button) folded before Flop (didn't bet)
Seat 3: 8oS5O7iD/qnFXFXJrGIgNQ (small blind) folded on the River
Seat 4: 1f3beyIML24UqEMTbWy93g (big blind) folded on the Turn
Seat 5: r1/R7y0Ortgoz4lccgW8VA collected ($8.60)
Seat 6: xAU6q2/cwmby2sxmA8VcmA folded before Flop (didn't bet)



PokerStars Game #59940779988:  Hold'em No Limit ($0.50/$1.00) - 2009/07/01 1:16:22 ET
Table 'tJq9SfN1ywY0r03VBlWlwQ' 9-max Seat #3 is the button
Seat 1: wZsU+w9r7G66x93UuvBf1Q ($330.80 in chips)
Seat 3: FVs16t7GgfWgQWt4JxsObQ ($9.60 in chips)
Seat 4: bLbSOSmSOnqE0iTcH/5dxA ($109.70 in chips)
Seat 5: h5ipsNTMyolp7xn/NAvWkA ($110.10 in chips)
Seat 6: gUUvmqdVlmvpal6B8nYrmg ($111.20 in chips)
Seat 8: G4DEhsZFmznGNVpy2SEocA ($28.40 in chips)
Seat 9: XE5QF1y74bpHog9JxWJMWQ ($100.20 in chips)
bLbSOSmSOnqE0iTcH/5dxA: posts small blind $0.50
VPF+HjszMvUIpy0CHIwH3A joins the table at seat #2
h5ipsNTMyolp7xn/NAvWkA: posts big blind $1
Pp/KTcXkfZKKUHkjyaLTdg: sits out
*** HOLE CARDS ***
gUUvmqdVlmvpal6B8nYrmg: folds
G4DEhsZFmznGNVpy2SEocA: raises $3 to $4
XE5QF1y74bpHog9JxWJMWQ: folds
wZsU+w9r7G66x93UuvBf1Q: folds
FVs16t7GgfWgQWt4JxsObQ: folds
bLbSOSmSOnqE0iTcH/5dxA: folds
h5ipsNTMyolp7xn/NAvWkA: calls $3
*** FLOP *** [3h 4d 2s]
h5ipsNTMyolp7xn/NAvWkA: bets $3
G4DEhsZFmznGNVpy2SEocA: calls $3
*** TURN *** [3h 4d 2s] [Kc]
h5ipsNTMyolp7xn/NAvWkA: bets $4
G4DEhsZFmznGNVpy2SEocA: raises $7 to $11
h5ipsNTMyolp7xn/NAvWkA: raises $92.10 to $103.10 and is all-in
G4DEhsZFmznGNVpy2SEocA: calls $10.40 and is all-in
*** RIVER *** [3h 4d 2s Kc] [7c]
*** SHOW DOWN ***
h5ipsNTMyolp7xn/NAvWkA: shows [Kh Ah] (a pair of Kings)
G4DEhsZFmznGNVpy2SEocA: shows [Kd As] (a pair of Kings)
h5ipsNTMyolp7xn/NAvWkA collected $27.25 from pot
G4DEhsZFmznGNVpy2SEocA collected $27.25 from pot
*** SUMMARY ***
Total pot $57.30 | Rake $2.80
Board [3h 4d 2s Kc 7c]
Seat 1: wZsU+w9r7G66x93UuvBf1Q folded before Flop (didn't bet)
Seat 3: FVs16t7GgfWgQWt4JxsObQ (button) folded before Flop (didn't bet)
Seat 4: bLbSOSmSOnqE0iTcH/5dxA (small blind) folded before Flop
Seat 5: h5ipsNTMyolp7xn/NAvWkA (big blind) showed [Kh Ah] and won ($27.25) with a pair of Kings
Seat 6: gUUvmqdVlmvpal6B8nYrmg folded before Flop (didn't bet)
Seat 8: G4DEhsZFmznGNVpy2SEocA showed [Kd As] and won ($27.25) with a pair of Kings
Seat 9: XE5QF1y74bpHog9JxWJMWQ folded before Flop (didn't bet)



PokerStars Game #59940781338:  Hold'em No Limit ($0.50/$1.00) - 2009/07/01 1:16:24 ET
Table 'cBDNutyLBKEk9+ptwsKmTw' 6-max Seat #1 is the button
Seat 1: xAU6q2/cwmby2sxmA8VcmA ($249 in chips)
Seat 2: 5lY8d6Cnm4HUkt/8FZSj4g ($87.50 in chips)
Seat 3: G5ZSSN6RSON3gkNvk/SmYg ($100 in chips)
Seat 4: 3q7F5QtzC30pSrn0nl9i+A ($23 in chips)
Seat 5: hpxXcmRkXXI9HE5+5/j/0Q ($100 in chips)
5lY8d6Cnm4HUkt/8FZSj4g: posts small blind $0.50
G5ZSSN6RSON3gkNvk/SmYg: posts big blind $1
QHvTZcrKe6+maWUfVjP29Q: sits out
*** HOLE CARDS ***
3q7F5QtzC30pSrn0nl9i+A: folds
hpxXcmRkXXI9HE5+5/j/0Q: folds
xAU6q2/cwmby2sxmA8VcmA: raises $3 to $4
5lY8d6Cnm4HUkt/8FZSj4g: calls $3.50
G5ZSSN6RSON3gkNvk/SmYg: folds
*** FLOP *** [Jd 6d 9s]
5lY8d6Cnm4HUkt/8FZSj4g: bets $7
xAU6q2/cwmby2sxmA8VcmA: raises $15 to $22
5lY8d6Cnm4HUkt/8FZSj4g: folds
xAU6q2/cwmby2sxmA8VcmA collected $21.90 from pot
xAU6q2/cwmby2sxmA8VcmA: doesn't show hand
*** SUMMARY ***
Total pot $23 | Rake $1.10
Board [Jd 6d 9s]
Seat 1: xAU6q2/cwmby2sxmA8VcmA (button) collected ($21.90)
Seat 2: 5lY8d6Cnm4HUkt/8FZSj4g (small blind) folded on the Flop
Seat 3: G5ZSSN6RSON3gkNvk/SmYg (big blind) folded before Flop
Seat 4: 3q7F5QtzC30pSrn0nl9i+A folded before Flop (didn't bet)
Seat 5: hpxXcmRkXXI9HE5+5/j/0Q folded before Flop (didn't bet)



PokerStars Game #59940782850:  Hold'em No Limit ($0.50/$1.00) - 2009/07/01 1:16:27 ET
Table 'gxFK0BVUD7cupu2uyRUZJg' 6-max Seat #2 is the button
Seat 1: M+X3uChmP6R63IwijVjgTg ($129.10 in chips)
Seat 2: hpxXcmRkXXI9HE5+5/j/0Q ($120.10 in chips)
Seat 3: Z2fXsGcjl+Eax+RzOgwOmg ($127.25 in chips)
Seat 5: WgIrs6CBinyyw18pqdDtWA ($34.90 in chips)
Seat 6: dYyb6/42PMC8aNFlm/eBeQ ($67.35 in chips)
Z2fXsGcjl+Eax+RzOgwOmg: posts small blind $0.50
WgIrs6CBinyyw18pqdDtWA: posts big blind $1
*** HOLE CARDS ***
dYyb6/42PMC8aNFlm/eBeQ: folds
M+X3uChmP6R63IwijVjgTg: folds
hpxXcmRkXXI9HE5+5/j/0Q: folds
Z2fXsGcjl+Eax+RzOgwOmg: folds
WgIrs6CBinyyw18pqdDtWA collected $1 from pot
*** SUMMARY ***
Total pot $1 | Rake $0
Seat 1: M+X3uChmP6R63IwijVjgTg folded before Flop (didn't bet)
Seat 2: hpxXcmRkXXI9HE5+5/j/0Q (button) folded before Flop (didn't bet)
Seat 3: Z2fXsGcjl+Eax+RzOgwOmg (small blind) folded before Flop
Seat 5: WgIrs6CBinyyw18pqdDtWA (big blind) collected ($1)
Seat 6: dYyb6/42PMC8aNFlm/eBeQ folded before Flop (didn't bet)



PokerStars Game #59940782928:  Hold'em No Limit ($0.50/$1.00) - 2009/07/01 1:16:27 ET
Table 'VOs36P6NW+QyXeQ1B62kmA' 6-max Seat #2 is the button
Seat 1: Z2fXsGcjl+Eax+RzOgwOmg ($102.50 in chips)
Seat 2: y27w5IK2WXqmYzS8OU0wKA ($100 in chips)
Seat 3: 6hLdALbOlkzGIrc53QKtPw ($22.50 in chips)
Seat 6: slVKuQyEz8Qj4E3uLPYNXg ($151.95 in chips)
6hLdALbOlkzGIrc53QKtPw: posts small blind $0.50
slVKuQyEz8Qj4E3uLPYNXg: posts big blind $1
*** HOLE CARDS ***
ozrlafxxh1HmYdA0/h+MuA leaves the table
Z2fXsGcjl+Eax+RzOgwOmg: folds
y27w5IK2WXqmYzS8OU0wKA: folds
Z2fXsGcjl+Eax+RzOgwOmg leaves the table
o3YLm/rSY916m/on1VjXPA joins the table at seat #5
6hLdALbOlkzGIrc53QKtPw: folds
slVKuQyEz8Qj4E3uLPYNXg collected $1 from pot
slVKuQyEz8Qj4E3uLPYNXg: doesn't show hand
*** SUMMARY ***
Total pot $1 | Rake $0
Seat 1: Z2fXsGcjl+Eax+RzOgwOmg folded before Flop (didn't bet)
Seat 2: y27w5IK2WXqmYzS8OU0wKA (button) folded before Flop (didn't bet)
Seat 3: 6hLdALbOlkzGIrc53QKtPw (small blind) folded before Flop
Seat 6: slVKuQyEz8Qj4E3uLPYNXg (big blind) collected ($1)



PokerStars Game #59940782990:  Hold'em No Limit ($0.50/$1.00) - 2009/07/01 1:16:27 ET
Table 'fZjVbKj9D8yOB+Rj7NaP/A' 9-max Seat #9 is the button
Seat 1: 9BZCcac3+McErkkSN2YScA ($100 in chips)
Seat 2: PTAFYDIUSsG+SArbxNl+Aw ($107 in chips)
Seat 3: yAbu2QsRPVcjPbqlf/jDxw ($102.50 in chips)
Seat 4: 997ViqAtWn1FPjJqcffwcA ($103 in chips)
Seat 5: PkGfq5xrSlNsujKaG/HF4Q ($100 in chips)
Seat 6: OvwYHV65yUbgdBjSmo1+5g ($37.75 in chips)
Seat 7: SyS20PAm3RpT6uLBsGkwOA ($119.30 in chips)
Seat 8: zDOE5r14tWqCf6xhuSHK6g ($46 in chips)
Seat 9: qheQay5YvP2DMAb3OUSxtw ($100 in chips)
9BZCcac3+McErkkSN2YScA: posts small blind $0.50
PTAFYDIUSsG+SArbxNl+Aw: posts big blind $1
*** HOLE CARDS ***
yAbu2QsRPVcjPbqlf/jDxw: folds
997ViqAtWn1FPjJqcffwcA: folds
PkGfq5xrSlNsujKaG/HF4Q: folds
OvwYHV65yUbgdBjSmo1+5g: calls $1
SyS20PAm3RpT6uLBsGkwOA: raises $4 to $5
zDOE5r14tWqCf6xhuSHK6g: calls $5
qheQay5YvP2DMAb3OUSxtw: folds
9BZCcac3+McErkkSN2YScA: folds
PTAFYDIUSsG+SArbxNl+Aw: folds
OvwYHV65yUbgdBjSmo1+5g: calls $4
*** FLOP *** [Qh Qs Ad]
OvwYHV65yUbgdBjSmo1+5g: bets $4
SyS20PAm3RpT6uLBsGkwOA: folds
zDOE5r14tWqCf6xhuSHK6g: folds
OvwYHV65yUbgdBjSmo1+5g collected $15.70 from pot
OvwYHV65yUbgdBjSmo1+5g: doesn't show hand
*** SUMMARY ***
Total pot $16.50 | Rake $0.80
Board [Qh Qs Ad]
Seat 1: 9BZCcac3+McErkkSN2YScA (small blind) folded before Flop
Seat 2: PTAFYDIUSsG+SArbxNl+Aw (big blind) folded before Flop
Seat 3: yAbu2QsRPVcjPbqlf/jDxw folded before Flop (didn't bet)
Seat 4: 997ViqAtWn1FPjJqcffwcA folded before Flop (didn't bet)
Seat 5: PkGfq5xrSlNsujKaG/HF4Q folded before Flop (didn't bet)
Seat 6: OvwYHV65yUbgdBjSmo1+5g collected ($15.70)
Seat 7: SyS20PAm3RpT6uLBsGkwOA folded on the Flop
Seat 8: zDOE5r14tWqCf6xhuSHK6g folded on the Flop
Seat 9: qheQay5YvP2DMAb3OUSxtw (button) folded before Flop (didn't bet)



PokerStars Game #59940784194:  Hold'em No Limit ($0.50/$1.00) - 2009/07/01 1:16:29 ET
Table '6YvsYDPNIDx2v5z3bJnwZQ' 9-max Seat #1 is the button
Seat 1: Ogn4JDV3mp4ZDKO49IFzKA ($19.70 in chips)
Seat 2: +hHqYgKILitkxIzFNGvvsA ($22.75 in chips)
Seat 3: K6OJDis3KfxSm/PKlkATUA ($50 in chips)
Seat 4: kEr5NYB+JIG5+szcYMr6hA ($46.95 in chips)
Seat 5: mBRWbnUl8diyBO1qTJaNzw ($160.70 in chips)
Seat 6: 7RSwrjMohkYrZAhOd1uaZg ($11.90 in chips)
Seat 7: mae7OMTaJ/MFimNbZegCkg ($45.80 in chips)
Seat 8: PSFxpXgPedVZyHSu2Zhb7Q ($129.05 in chips)
Seat 9: yZYrOeNDxQxkzpbgKX1bng ($28.80 in chips)
+hHqYgKILitkxIzFNGvvsA: posts small blind $0.50
K6OJDis3KfxSm/PKlkATUA: posts big blind $1
*** HOLE CARDS ***
kEr5NYB+JIG5+szcYMr6hA: folds
mBRWbnUl8diyBO1qTJaNzw: raises $3 to $4
7RSwrjMohkYrZAhOd1uaZg: folds
mae7OMTaJ/MFimNbZegCkg: calls $4
PSFxpXgPedVZyHSu2Zhb7Q: folds
yZYrOeNDxQxkzpbgKX1bng: calls $4
Ogn4JDV3mp4ZDKO49IFzKA: folds
+hHqYgKILitkxIzFNGvvsA: calls $3.50
K6OJDis3KfxSm/PKlkATUA: folds
*** FLOP *** [2c 9c 7c]
+hHqYgKILitkxIzFNGvvsA: checks
mBRWbnUl8diyBO1qTJaNzw: bets $12
mae7OMTaJ/MFimNbZegCkg: folds
yZYrOeNDxQxkzpbgKX1bng: calls $12
+hHqYgKILitkxIzFNGvvsA: folds
*** TURN *** [2c 9c 7c] [3d]
mBRWbnUl8diyBO1qTJaNzw: bets $22
yZYrOeNDxQxkzpbgKX1bng: calls $12.80 and is all-in
*** RIVER *** [2c 9c 7c 3d] [Ks]
*** SHOW DOWN ***
mBRWbnUl8diyBO1qTJaNzw: shows [Tc Td] (a pair of Tens)
yZYrOeNDxQxkzpbgKX1bng: shows [2d 2s] (three of a kind, Deuces)
yZYrOeNDxQxkzpbgKX1bng collected $63.60 from pot
*** SUMMARY ***
Total pot $66.60 | Rake $3
Board [2c 9c 7c 3d Ks]
Seat 1: Ogn4JDV3mp4ZDKO49IFzKA (button) folded before Flop (didn't bet)
Seat 2: +hHqYgKILitkxIzFNGvvsA (small blind) folded on the Flop
Seat 3: K6OJDis3KfxSm/PKlkATUA (big blind) folded before Flop
Seat 4: kEr5NYB+JIG5+szcYMr6hA folded before Flop (didn't bet)
Seat 5: mBRWbnUl8diyBO1qTJaNzw showed [Tc Td] and lost with a pair of Tens
Seat 6: 7RSwrjMohkYrZAhOd1uaZg folded before Flop (didn't bet)
Seat 7: mae7OMTaJ/MFimNbZegCkg folded on the Flop
Seat 8: PSFxpXgPedVZyHSu2Zhb7Q folded before Flop (didn't bet)
Seat 9: yZYrOeNDxQxkzpbgKX1bng showed [2d 2s] and won ($63.60) with three of a kind, Deuces



PokerStars Game #59940784808:  Hold'em No Limit ($0.50/$1.00) - 2009/07/01 1:16:30 ET
Table '7Nl0ffnjeK44/vmeexh3MQ' 9-max Seat #6 is the button
Seat 1: V138SURkdX8LdVBPKdJJag ($101.50 in chips)
Seat 2: OGgaARGdJQT4awWVNQ957w ($102 in chips)
Seat 3: JMmUYT5pIKCKh2pGjCB/4w ($55.50 in chips)
Seat 4: bLbSOSmSOnqE0iTcH/5dxA ($100 in chips)
Seat 5: 61sfw5QTu62YYIt68OsdrA ($81.50 in chips)
Seat 6: FVs16t7GgfWgQWt4JxsObQ ($30.25 in chips)
Seat 7: 997ViqAtWn1FPjJqcffwcA ($100 in chips)
Seat 8: D+W9Me7w6Hcx/WRUSKV0dw ($18.25 in chips)
Seat 9: ouwUBGRKnKK9uhn1G4Lf+A ($194 in chips)
997ViqAtWn1FPjJqcffwcA: posts small blind $0.50
D+W9Me7w6Hcx/WRUSKV0dw: posts big blind $1
*** HOLE CARDS ***
ouwUBGRKnKK9uhn1G4Lf+A: folds
V138SURkdX8LdVBPKdJJag: folds
OGgaARGdJQT4awWVNQ957w: folds
JMmUYT5pIKCKh2pGjCB/4w: folds
bLbSOSmSOnqE0iTcH/5dxA: folds
61sfw5QTu62YYIt68OsdrA: folds
FVs16t7GgfWgQWt4JxsObQ: calls $1
997ViqAtWn1FPjJqcffwcA: folds
D+W9Me7w6Hcx/WRUSKV0dw: raises $3.15 to $4.15
FVs16t7GgfWgQWt4JxsObQ: folds
D+W9Me7w6Hcx/WRUSKV0dw collected $2.50 from pot
D+W9Me7w6Hcx/WRUSKV0dw: doesn't show hand
*** SUMMARY ***
Total pot $2.50 | Rake $0
Seat 1: V138SURkdX8LdVBPKdJJag folded before Flop (didn't bet)
Seat 2: OGgaARGdJQT4awWVNQ957w folded before Flop (didn't bet)
Seat 3: JMmUYT5pIKCKh2pGjCB/4w folded before Flop (didn't bet)
Seat 4: bLbSOSmSOnqE0iTcH/5dxA folded before Flop (didn't bet)
Seat 5: 61sfw5QTu62YYIt68OsdrA folded before Flop (didn't bet)
Seat 6: FVs16t7GgfWgQWt4JxsObQ (button) folded before Flop
Seat 7: 997ViqAtWn1FPjJqcffwcA (small blind) folded before Flop
Seat 8: D+W9Me7w6Hcx/WRUSKV0dw (big blind) collected ($2.50)
Seat 9: ouwUBGRKnKK9uhn1G4Lf+A folded before Flop (didn't bet)



PokerStars Game #59940786390:  Hold'em No Limit ($0.50/$1.00) - 2009/07/01 1:16:33 ET
Table 'kS0cTQAEi+fdUlJP2gQYvw' 9-max Seat #2 is the button
Seat 1: c/9X4zftzphFxYtxp5kp9w ($76.25 in chips)
Seat 2: D+W9Me7w6Hcx/WRUSKV0dw ($26.55 in chips)
Seat 3: 2BV+oJIQYr65IO6nEChvbA ($60 in chips)
Seat 4: RUhhaALzha3TH1AkdakoGQ ($44 in chips)
Seat 5: 997ViqAtWn1FPjJqcffwcA ($101.15 in chips)
Seat 6: yAbu2QsRPVcjPbqlf/jDxw ($126.15 in chips)
Seat 7: Ffa7Nj4X5fddtROP01hfQg ($164.10 in chips)
Seat 9: OGgaARGdJQT4awWVNQ957w ($100 in chips)
2BV+oJIQYr65IO6nEChvbA: posts small blind $0.50
RUhhaALzha3TH1AkdakoGQ: posts big blind $1
*** HOLE CARDS ***
997ViqAtWn1FPjJqcffwcA: folds
yAbu2QsRPVcjPbqlf/jDxw: folds
c/9X4zftzphFxYtxp5kp9w said, "probably kk"
Ffa7Nj4X5fddtROP01hfQg: calls $1
OGgaARGdJQT4awWVNQ957w: folds
c/9X4zftzphFxYtxp5kp9w: raises $4 to $5
D+W9Me7w6Hcx/WRUSKV0dw: folds
2BV+oJIQYr65IO6nEChvbA: folds
RUhhaALzha3TH1AkdakoGQ: folds
Ffa7Nj4X5fddtROP01hfQg: folds
c/9X4zftzphFxYtxp5kp9w collected $3.50 from pot
*** SUMMARY ***
Total pot $3.50 | Rake $0
Seat 1: c/9X4zftzphFxYtxp5kp9w collected ($3.50)
Seat 2: D+W9Me7w6Hcx/WRUSKV0dw (button) folded before Flop (didn't bet)
Seat 3: 2BV+oJIQYr65IO6nEChvbA (small blind) folded before Flop
Seat 4: RUhhaALzha3TH1AkdakoGQ (big blind) folded before Flop
Seat 5: 997ViqAtWn1FPjJqcffwcA folded before Flop (didn't bet)
Seat 6: yAbu2QsRPVcjPbqlf/jDxw folded before Flop (didn't bet)
Seat 7: Ffa7Nj4X5fddtROP01hfQg folded before Flop
Seat 9: OGgaARGdJQT4awWVNQ957w folded before Flop (didn't bet)



PokerStars Game #59940787072:  Hold'em No Limit ($0.50/$1.00) - 2009/07/01 1:16:34 ET
Table 'hdVBCnDy5t2X9dZo0AvD9w' 9-max Seat #2 is the button
Seat 1: sa/cZBFh73L9TapFXpn3BA ($74.90 in chips)
Seat 2: Ogn4JDV3mp4ZDKO49IFzKA ($20.50 in chips)
Seat 3: 1862487932 ($100 in chips)
Seat 4: YvSugbFKWSuAYx9iokQwUQ ($73.20 in chips)
Seat 5: H+DVy3Ei8L1UKS2tVOtJcw ($100 in chips)
Seat 6: bJckevFOcg//s0qyMQI6sQ ($100 in chips)
Seat 7: KqC3XiX79XzqwhoOYPVb4w ($163.05 in chips)
Seat 8: gUUvmqdVlmvpal6B8nYrmg ($142.90 in chips)
Seat 9: AMkLbywdoc0K30BTzaIfTQ ($183.40 in chips)
1862487932: posts small blind $0.50
YvSugbFKWSuAYx9iokQwUQ: posts big blind $1
*** HOLE CARDS ***
H+DVy3Ei8L1UKS2tVOtJcw: folds
bJckevFOcg//s0qyMQI6sQ: folds
KqC3XiX79XzqwhoOYPVb4w: folds
gUUvmqdVlmvpal6B8nYrmg: raises $1 to $2
AMkLbywdoc0K30BTzaIfTQ: folds
sa/cZBFh73L9TapFXpn3BA: folds
Ogn4JDV3mp4ZDKO49IFzKA: folds
1862487932: folds
YvSugbFKWSuAYx9iokQwUQ: folds
gUUvmqdVlmvpal6B8nYrmg collected $2.50 from pot
*** SUMMARY ***
Total pot $2.50 | Rake $0
Seat 1: sa/cZBFh73L9TapFXpn3BA folded before Flop (didn't bet)
Seat 2: Ogn4JDV3mp4ZDKO49IFzKA (button) folded before Flop (didn't bet)
Seat 3: 1862487932 (small blind) folded before Flop
Seat 4: YvSugbFKWSuAYx9iokQwUQ (big blind) folded before Flop
Seat 5: H+DVy3Ei8L1UKS2tVOtJcw folded before Flop (didn't bet)
Seat 6: bJckevFOcg//s0qyMQI6sQ folded before Flop (didn't bet)
Seat 7: KqC3XiX79XzqwhoOYPVb4w folded before Flop (didn't bet)
Seat 8: gUUvmqdVlmvpal6B8nYrmg collected ($2.50)
Seat 9: AMkLbywdoc0K30BTzaIfTQ folded before Flop (didn't bet)



PokerStars Game #59940789120:  Hold'em No Limit ($0.50/$1.00) - 2009/07/01 1:16:37 ET
Table 'vs/5jr6ciwjVQ5+Soc+u2A' 6-max Seat #5 is the button
Seat 1: J798qwLuvXyq0BbzsIjOrA ($97 in chips)
Seat 2: lXX4W7m3u++JiSOZ46yVMQ ($86.55 in chips)
Seat 3: G5ZSSN6RSON3gkNvk/SmYg ($139.60 in chips)
Seat 4: wk6Ohn4GDozoOMHc4eb2rw ($62.30 in chips)
Seat 5: +Nt3OPk3XR9SKjZgm2CexQ ($148.05 in chips)
Seat 6: Z2fXsGcjl+Eax+RzOgwOmg ($100 in chips)
Z2fXsGcjl+Eax+RzOgwOmg: posts small blind $0.50
J798qwLuvXyq0BbzsIjOrA: posts big blind $1
*** HOLE CARDS ***
lXX4W7m3u++JiSOZ46yVMQ: folds
G5ZSSN6RSON3gkNvk/SmYg: folds
wk6Ohn4GDozoOMHc4eb2rw: folds
+Nt3OPk3XR9SKjZgm2CexQ: raises $1.30 to $2.30
Z2fXsGcjl+Eax+RzOgwOmg: folds
J798qwLuvXyq0BbzsIjOrA: calls $1.30
*** FLOP *** [6h 7d 7c]
J798qwLuvXyq0BbzsIjOrA: checks
+Nt3OPk3XR9SKjZgm2CexQ: bets $3
J798qwLuvXyq0BbzsIjOrA: folds
+Nt3OPk3XR9SKjZgm2CexQ collected $4.85 from pot
+Nt3OPk3XR9SKjZgm2CexQ: doesn't show hand
*** SUMMARY ***
Total pot $5.10 | Rake $0.25
Board [6h 7d 7c]
Seat 1: J798qwLuvXyq0BbzsIjOrA (big blind) folded on the Flop
Seat 2: lXX4W7m3u++JiSOZ46yVMQ folded before Flop (didn't bet)
Seat 3: G5ZSSN6RSON3gkNvk/SmYg folded before Flop (didn't bet)
Seat 4: wk6Ohn4GDozoOMHc4eb2rw folded before Flop (didn't bet)
Seat 5: +Nt3OPk3XR9SKjZgm2CexQ (button) collected ($4.85)
Seat 6: Z2fXsGcjl+Eax+RzOgwOmg (small blind) folded before Flop



PokerStars Game #59940790150:  Hold'em No Limit ($0.50/$1.00) - 2009/07/01 1:16:39 ET
Table 'O96CPOtvMBWP6kzuYDfdFA' 6-max Seat #1 is the button
Seat 1: 6alLXQIITA2EZ/lBeym8Dw ($122.25 in chips)
Seat 2: 4d1rWhpu8DzLmzMbR3QKyA ($110.35 in chips)
Seat 3: V89DGjxE171oPREEbAXiyg ($89.10 in chips)
Seat 4: /P4w1pHg2zHYg/4ubJ0dPw ($60 in chips)
Seat 5: G5ZSSN6RSON3gkNvk/SmYg ($100 in chips)
Seat 6: GYei5jXGWexiJYbAT2fELg ($38.15 in chips)
4d1rWhpu8DzLmzMbR3QKyA: posts small blind $0.50
V89DGjxE171oPREEbAXiyg: posts big blind $1
*** HOLE CARDS ***
/P4w1pHg2zHYg/4ubJ0dPw: folds
G5ZSSN6RSON3gkNvk/SmYg: folds
GYei5jXGWexiJYbAT2fELg: folds
6alLXQIITA2EZ/lBeym8Dw: folds
4d1rWhpu8DzLmzMbR3QKyA: folds
V89DGjxE171oPREEbAXiyg collected $1 from pot
*** SUMMARY ***
Total pot $1 | Rake $0
Seat 1: 6alLXQIITA2EZ/lBeym8Dw (button) folded before Flop (didn't bet)
Seat 2: 4d1rWhpu8DzLmzMbR3QKyA (small blind) folded before Flop
Seat 3: V89DGjxE171oPREEbAXiyg (big blind) collected ($1)
Seat 4: /P4w1pHg2zHYg/4ubJ0dPw folded before Flop (didn't bet)
Seat 5: G5ZSSN6RSON3gkNvk/SmYg folded before Flop (didn't bet)
Seat 6: GYei5jXGWexiJYbAT2fELg folded before Flop (didn't bet)



PokerStars Game #59940792514:  Hold'em No Limit ($0.50/$1.00) - 2009/07/01 1:16:43 ET
Table 'gxFK0BVUD7cupu2uyRUZJg' 6-max Seat #3 is the button
Seat 1: M+X3uChmP6R63IwijVjgTg ($129.10 in chips)
Seat 2: hpxXcmRkXXI9HE5+5/j/0Q ($120.10 in chips)
Seat 3: Z2fXsGcjl+Eax+RzOgwOmg ($126.75 in chips)
Seat 5: WgIrs6CBinyyw18pqdDtWA ($35.40 in chips)
Seat 6: dYyb6/42PMC8aNFlm/eBeQ ($67.35 in chips)
WgIrs6CBinyyw18pqdDtWA: posts small blind $0.50
dYyb6/42PMC8aNFlm/eBeQ: posts big blind $1
*** HOLE CARDS ***
M+X3uChmP6R63IwijVjgTg: folds
hpxXcmRkXXI9HE5+5/j/0Q: folds
Z2fXsGcjl+Eax+RzOgwOmg: raises $2 to $3
WgIrs6CBinyyw18pqdDtWA: calls $2.50
dYyb6/42PMC8aNFlm/eBeQ: folds
*** FLOP *** [Ks 3d 7h]
WgIrs6CBinyyw18pqdDtWA: checks
Z2fXsGcjl+Eax+RzOgwOmg: bets $4
WgIrs6CBinyyw18pqdDtWA: calls $4
*** TURN *** [Ks 3d 7h] [Th]
WgIrs6CBinyyw18pqdDtWA: checks
Z2fXsGcjl+Eax+RzOgwOmg: checks
*** RIVER *** [Ks 3d 7h Th] [5c]
WgIrs6CBinyyw18pqdDtWA: checks
Z2fXsGcjl+Eax+RzOgwOmg: checks
*** SHOW DOWN ***
WgIrs6CBinyyw18pqdDtWA: shows [9d 9s] (a pair of Nines)
Z2fXsGcjl+Eax+RzOgwOmg: mucks hand
WgIrs6CBinyyw18pqdDtWA collected $14.30 from pot
*** SUMMARY ***
Total pot $15 | Rake $0.70
Board [Ks 3d 7h Th 5c]
Seat 1: M+X3uChmP6R63IwijVjgTg folded before Flop (didn't bet)
Seat 2: hpxXcmRkXXI9HE5+5/j/0Q folded before Flop (didn't bet)
Seat 3: Z2fXsGcjl+Eax+RzOgwOmg (button) mucked
Seat 5: WgIrs6CBinyyw18pqdDtWA (small blind) showed [9d 9s] and won ($14.30) with a pair of Nines
Seat 6: dYyb6/42PMC8aNFlm/eBeQ (big blind) folded before Flop



PokerStars Game #59940792682:  Hold'em No Limit ($0.50/$1.00) - 2009/07/01 1:16:44 ET
Table 'GxCPo/gd3OSthkYrAxJngg' 6-max Seat #1 is the button
Seat 1: sH8BpAFP+jGFxCgVpD1Lew ($259.90 in chips)
Seat 2: YExX2paeIHrmfIwV1ivM/w ($69.60 in chips)
Seat 3: 6hLdALbOlkzGIrc53QKtPw ($20 in chips)
Seat 4: YMJG+F++3Aj6P8dAWda5fw ($196.75 in chips)
Seat 5: G5ZSSN6RSON3gkNvk/SmYg ($116.10 in chips)
Seat 6: 4d1rWhpu8DzLmzMbR3QKyA ($107.25 in chips)
YExX2paeIHrmfIwV1ivM/w: posts small blind $0.50
6hLdALbOlkzGIrc53QKtPw: posts big blind $1
*** HOLE CARDS ***
YMJG+F++3Aj6P8dAWda5fw: folds
G5ZSSN6RSON3gkNvk/SmYg: folds
4d1rWhpu8DzLmzMbR3QKyA: raises $2 to $3
sH8BpAFP+jGFxCgVpD1Lew: folds
YExX2paeIHrmfIwV1ivM/w: folds
6hLdALbOlkzGIrc53QKtPw: folds
4d1rWhpu8DzLmzMbR3QKyA collected $2.50 from pot
*** SUMMARY ***
Total pot $2.50 | Rake $0
Seat 1: sH8BpAFP+jGFxCgVpD1Lew (button) folded before Flop (didn't bet)
Seat 2: YExX2paeIHrmfIwV1ivM/w (small blind) folded before Flop
Seat 3: 6hLdALbOlkzGIrc53QKtPw (big blind) folded before Flop
Seat 4: YMJG+F++3Aj6P8dAWda5fw folded before Flop (didn't bet)
Seat 5: G5ZSSN6RSON3gkNvk/SmYg folded before Flop (didn't bet)
Seat 6: 4d1rWhpu8DzLmzMbR3QKyA collected ($2.50)



PokerStars Game #59940793200:  Hold'em No Limit ($0.50/$1.00) - 2009/07/01 1:16:45 ET
Table 'fTlPiCj0utgzC/5io+I7ew' 6-max Seat #3 is the button
Seat 1: YMJG+F++3Aj6P8dAWda5fw ($101.35 in chips)
Seat 2: KDYsHh8K2SUXXDvLsAhbJQ ($20 in chips)
Seat 3: Z2fXsGcjl+Eax+RzOgwOmg ($102.50 in chips)
Seat 4: uJVSceLggtsrJya+WtmUEA ($174.15 in chips)
Seat 5: XUk5GQsfNFpHvaToDZ0rZA ($51.50 in chips)
Seat 6: y27w5IK2WXqmYzS8OU0wKA ($100 in chips)
uJVSceLggtsrJya+WtmUEA: posts small blind $0.50
XUk5GQsfNFpHvaToDZ0rZA: posts big blind $1
KDYsHh8K2SUXXDvLsAhbJQ: posts big blind $1
*** HOLE CARDS ***
y27w5IK2WXqmYzS8OU0wKA: folds
YMJG+F++3Aj6P8dAWda5fw: folds
KDYsHh8K2SUXXDvLsAhbJQ: checks
Z2fXsGcjl+Eax+RzOgwOmg: folds
uJVSceLggtsrJya+WtmUEA: folds
XUk5GQsfNFpHvaToDZ0rZA: checks
*** FLOP *** [Ks 3d 3s]
XUk5GQsfNFpHvaToDZ0rZA: checks
KDYsHh8K2SUXXDvLsAhbJQ: checks
*** TURN *** [Ks 3d 3s] [2d]
XUk5GQsfNFpHvaToDZ0rZA: checks
KDYsHh8K2SUXXDvLsAhbJQ: bets $1
XUk5GQsfNFpHvaToDZ0rZA: folds
KDYsHh8K2SUXXDvLsAhbJQ collected $2.40 from pot
*** SUMMARY ***
Total pot $2.50 | Rake $0.10
Board [Ks 3d 3s 2d]
Seat 1: YMJG+F++3Aj6P8dAWda5fw folded before Flop (didn't bet)
Seat 2: KDYsHh8K2SUXXDvLsAhbJQ collected ($2.40)
Seat 3: Z2fXsGcjl+Eax+RzOgwOmg (button) folded before Flop (didn't bet)
Seat 4: uJVSceLggtsrJya+WtmUEA (small blind) folded before Flop
Seat 5: XUk5GQsfNFpHvaToDZ0rZA (big blind) folded on the Turn
Seat 6: y27w5IK2WXqmYzS8OU0wKA folded before Flop (didn't bet)



PokerStars Game #59940795314:  Hold'em No Limit ($0.50/$1.00) - 2009/07/01 1:16:48 ET
Table 'rmZfTK+oSebeUPJNbWhdAA' 6-max Seat #1 is the button
Seat 1: xAU6q2/cwmby2sxmA8VcmA ($147 in chips)
Seat 2: z7O9PO/WEcqRouIydFhS9Q ($135.60 in chips)
Seat 3: BCEV3COoKY607AzLWayfRA ($152.80 in chips)
Seat 4: 1/mIuXfgx1ZyVkodrmfQDw ($100 in chips)
Seat 5: 5lY8d6Cnm4HUkt/8FZSj4g ($73.25 in chips)
Seat 6: j7NIOHLZk7V2o9fOioO5ug ($146.40 in chips)
z7O9PO/WEcqRouIydFhS9Q: posts small blind $0.50
BCEV3COoKY607AzLWayfRA: posts big blind $1
*** HOLE CARDS ***
1/mIuXfgx1ZyVkodrmfQDw: raises $2 to $3
5lY8d6Cnm4HUkt/8FZSj4g: calls $3
j7NIOHLZk7V2o9fOioO5ug: folds
xAU6q2/cwmby2sxmA8VcmA: folds
z7O9PO/WEcqRouIydFhS9Q: folds
BCEV3COoKY607AzLWayfRA: folds
*** FLOP *** [3d Ah 6s]
1/mIuXfgx1ZyVkodrmfQDw: checks
5lY8d6Cnm4HUkt/8FZSj4g: checks
*** TURN *** [3d Ah 6s] [8s]
1/mIuXfgx1ZyVkodrmfQDw: bets $5
5lY8d6Cnm4HUkt/8FZSj4g: calls $5
*** RIVER *** [3d Ah 6s 8s] [2c]
1/mIuXfgx1ZyVkodrmfQDw: bets $9
5lY8d6Cnm4HUkt/8FZSj4g: folds
1/mIuXfgx1ZyVkodrmfQDw collected $16.65 from pot
1/mIuXfgx1ZyVkodrmfQDw: doesn't show hand
*** SUMMARY ***
Total pot $17.50 | Rake $0.85
Board [3d Ah 6s 8s 2c]
Seat 1: xAU6q2/cwmby2sxmA8VcmA (button) folded before Flop (didn't bet)
Seat 2: z7O9PO/WEcqRouIydFhS9Q (small blind) folded before Flop
Seat 3: BCEV3COoKY607AzLWayfRA (big blind) folded before Flop
Seat 4: 1/mIuXfgx1ZyVkodrmfQDw collected ($16.65)
Seat 5: 5lY8d6Cnm4HUkt/8FZSj4g folded on the River
Seat 6: j7NIOHLZk7V2o9fOioO5ug folded before Flop (didn't bet)



PokerStars Game #59940795388:  Hold'em No Limit ($0.50/$1.00) - 2009/07/01 1:16:48 ET
Table 'GPp0HyAuggN8oE0sUWzPpA' 9-max Seat #6 is the button
Seat 1: qJr25HAtvv1w/7IBvjMM3g ($40.20 in chips)
Seat 2: m3U8I35Pn3gxKhoS2nmYIg ($13.40 in chips)
Seat 3: CCCXsirC+bO7ginAuUUVlQ ($59.25 in chips)
Seat 4: mBRWbnUl8diyBO1qTJaNzw ($101.65 in chips)
Seat 5: bLbSOSmSOnqE0iTcH/5dxA ($100 in chips)
Seat 6: BK/GtNPkSx0TdUDj82id5A ($34.20 in chips)
Seat 7: DHdbHyysD15wCAtx+BhUjA ($97.20 in chips)
Seat 8: P/6qLjycEfxRgZ5F/W90dw ($100 in chips)
Seat 9: dzoSjPZmtjGuK83119030A ($34.15 in chips)
DHdbHyysD15wCAtx+BhUjA: posts small blind $0.50
P/6qLjycEfxRgZ5F/W90dw: posts big blind $1
*** HOLE CARDS ***
dzoSjPZmtjGuK83119030A: folds
qJr25HAtvv1w/7IBvjMM3g: calls $1
m3U8I35Pn3gxKhoS2nmYIg: folds
CCCXsirC+bO7ginAuUUVlQ: raises $2 to $3
mBRWbnUl8diyBO1qTJaNzw: folds
bLbSOSmSOnqE0iTcH/5dxA: folds
BK/GtNPkSx0TdUDj82id5A: folds
DHdbHyysD15wCAtx+BhUjA: folds
P/6qLjycEfxRgZ5F/W90dw: calls $2
qJr25HAtvv1w/7IBvjMM3g: calls $2
*** FLOP *** [Kc 5d Qs]
P/6qLjycEfxRgZ5F/W90dw: checks
qJr25HAtvv1w/7IBvjMM3g: checks
CCCXsirC+bO7ginAuUUVlQ: checks
*** TURN *** [Kc 5d Qs] [9c]
P/6qLjycEfxRgZ5F/W90dw: checks
qJr25HAtvv1w/7IBvjMM3g: checks
CCCXsirC+bO7ginAuUUVlQ: checks
*** RIVER *** [Kc 5d Qs 9c] [7h]
P/6qLjycEfxRgZ5F/W90dw: checks
qJr25HAtvv1w/7IBvjMM3g: bets $8
CCCXsirC+bO7ginAuUUVlQ: folds
P/6qLjycEfxRgZ5F/W90dw: folds
qJr25HAtvv1w/7IBvjMM3g collected $9.05 from pot
*** SUMMARY ***
Total pot $9.50 | Rake $0.45
Board [Kc 5d Qs 9c 7h]
Seat 1: qJr25HAtvv1w/7IBvjMM3g collected ($9.05)
Seat 2: m3U8I35Pn3gxKhoS2nmYIg folded before Flop (didn't bet)
Seat 3: CCCXsirC+bO7ginAuUUVlQ folded on the River
Seat 4: mBRWbnUl8diyBO1qTJaNzw folded before Flop (didn't bet)
Seat 5: bLbSOSmSOnqE0iTcH/5dxA folded before Flop (didn't bet)
Seat 6: BK/GtNPkSx0TdUDj82id5A (button) folded before Flop (didn't bet)
Seat 7: DHdbHyysD15wCAtx+BhUjA (small blind) folded before Flop
Seat 8: P/6qLjycEfxRgZ5F/W90dw (big blind) folded on the River
Seat 9: dzoSjPZmtjGuK83119030A folded before Flop (didn't bet)



PokerStars Game #59940796298:  Hold'em No Limit ($0.50/$1.00) - 2009/07/01 1:16:50 ET
Table '+cA8mcmhaedZ7YcrDdhmeQ' 6-max Seat #6 is the button
Seat 1: lsLuWlcPA3Rh7kJVLzMh0Q ($272.45 in chips)
Seat 3: DAIgyIWbYvAkL6PbAI27pg ($17 in chips)
Seat 4: 4OO5v3AVduL0tePNx8wk5A ($106.55 in chips)
Seat 6: YfsTQsY/fxb+YqbdclTHuw ($16.85 in chips)
lsLuWlcPA3Rh7kJVLzMh0Q: posts small blind $0.50
6hLdALbOlkzGIrc53QKtPw joins the table at seat #5
RqgF7gRoKgRNW8Zoi1ty4A: is sitting out
DAIgyIWbYvAkL6PbAI27pg: posts big blind $1
*** HOLE CARDS ***
RqgF7gRoKgRNW8Zoi1ty4A leaves the table
4OO5v3AVduL0tePNx8wk5A: folds
YfsTQsY/fxb+YqbdclTHuw: folds
lsLuWlcPA3Rh7kJVLzMh0Q: raises $2 to $3
14aYclSc98EYd6TrzN2l3Q joins the table at seat #2
DAIgyIWbYvAkL6PbAI27pg: folds
lsLuWlcPA3Rh7kJVLzMh0Q collected $2 from pot
lsLuWlcPA3Rh7kJVLzMh0Q: doesn't show hand
*** SUMMARY ***
Total pot $2 | Rake $0
Seat 1: lsLuWlcPA3Rh7kJVLzMh0Q (small blind) collected ($2)
Seat 3: DAIgyIWbYvAkL6PbAI27pg (big blind) folded before Flop
Seat 4: 4OO5v3AVduL0tePNx8wk5A folded before Flop (didn't bet)
Seat 6: YfsTQsY/fxb+YqbdclTHuw (button) folded before Flop (didn't bet)



PokerStars Game #59940796882:  Hold'em No Limit ($0.50/$1.00) - 2009/07/01 1:16:51 ET
Table 'mmbQQVBTrPdE+wy+s+9VPA' 6-max Seat #2 is the button
Seat 1: zyP4SPoWZnKUfTvIRLCVog ($66.75 in chips)
Seat 2: XK4Qsl+DA8gAJyg85/zBIw ($20.95 in chips)
Seat 3: wx3sQGkVi2x9wJXuWNHPBw ($106.65 in chips)
Seat 4: V3iZdcw61nXF3g5hD2RrsQ ($114.90 in chips)
Seat 5: YMJG+F++3Aj6P8dAWda5fw ($110.50 in chips)
Seat 6: U2CWBTv29qdCbj8RNF2sIw ($102.60 in chips)
wx3sQGkVi2x9wJXuWNHPBw: posts small blind $0.50
V3iZdcw61nXF3g5hD2RrsQ: posts big blind $1
*** HOLE CARDS ***
YMJG+F++3Aj6P8dAWda5fw: folds
U2CWBTv29qdCbj8RNF2sIw: folds
zyP4SPoWZnKUfTvIRLCVog: folds
XK4Qsl+DA8gAJyg85/zBIw: folds
wx3sQGkVi2x9wJXuWNHPBw: raises $3 to $4
V3iZdcw61nXF3g5hD2RrsQ: calls $3
*** FLOP *** [3c Ks 4s]
wx3sQGkVi2x9wJXuWNHPBw: bets $5.50
V3iZdcw61nXF3g5hD2RrsQ: calls $5.50
*** TURN *** [3c Ks 4s] [Js]
wx3sQGkVi2x9wJXuWNHPBw: checks
V3iZdcw61nXF3g5hD2RrsQ: checks
*** RIVER *** [3c Ks 4s Js] [Kc]
wx3sQGkVi2x9wJXuWNHPBw: checks
V3iZdcw61nXF3g5hD2RrsQ: checks
*** SHOW DOWN ***
wx3sQGkVi2x9wJXuWNHPBw: shows [Jd Qs] (two pair, Kings and Jacks)
V3iZdcw61nXF3g5hD2RrsQ: mucks hand
wx3sQGkVi2x9wJXuWNHPBw collected $18.10 from pot
*** SUMMARY ***
Total pot $19 | Rake $0.90
Board [3c Ks 4s Js Kc]
Seat 1: zyP4SPoWZnKUfTvIRLCVog folded before Flop (didn't bet)
Seat 2: XK4Qsl+DA8gAJyg85/zBIw (button) folded before Flop (didn't bet)
Seat 3: wx3sQGkVi2x9wJXuWNHPBw (small blind) showed [Jd Qs] and won ($18.10) with two pair, Kings and Jacks
Seat 4: V3iZdcw61nXF3g5hD2RrsQ (big blind) mucked
Seat 5: YMJG+F++3Aj6P8dAWda5fw folded before Flop (didn't bet)
Seat 6: U2CWBTv29qdCbj8RNF2sIw folded before Flop (didn't bet)



PokerStars Game #59940799362:  Hold'em No Limit ($0.50/$1.00) - 2009/07/01 1:16:55 ET
Table 'QSIig7BLMc9wY/rgBechzw' 6-max Seat #3 is the button
Seat 1: Z2fXsGcjl+Eax+RzOgwOmg ($112 in chips)
Seat 2: mLOIkH/qmRa+mVujQIhBRg ($33.60 in chips)
Seat 3: +xW7QemQU0Fxs+4TnqBRow ($106.40 in chips)
Seat 4: +uSzP8Jwnw7sKfQ4s66b7w ($71.95 in chips)
Seat 5: lsLuWlcPA3Rh7kJVLzMh0Q ($108.95 in chips)
Seat 6: PxqfkAMdAWtkgbT+q2gciA ($36.65 in chips)
+uSzP8Jwnw7sKfQ4s66b7w: posts small blind $0.50
lsLuWlcPA3Rh7kJVLzMh0Q: posts big blind $1
*** HOLE CARDS ***
PxqfkAMdAWtkgbT+q2gciA: folds
Z2fXsGcjl+Eax+RzOgwOmg: folds
mLOIkH/qmRa+mVujQIhBRg: calls $1
+xW7QemQU0Fxs+4TnqBRow: folds
+uSzP8Jwnw7sKfQ4s66b7w: calls $0.50
lsLuWlcPA3Rh7kJVLzMh0Q: checks
*** FLOP *** [3c 6d 2h]
+uSzP8Jwnw7sKfQ4s66b7w: checks
lsLuWlcPA3Rh7kJVLzMh0Q: checks
mLOIkH/qmRa+mVujQIhBRg: checks
*** TURN *** [3c 6d 2h] [Ah]
+uSzP8Jwnw7sKfQ4s66b7w: checks
lsLuWlcPA3Rh7kJVLzMh0Q: checks
mLOIkH/qmRa+mVujQIhBRg: bets $2
+uSzP8Jwnw7sKfQ4s66b7w: folds
lsLuWlcPA3Rh7kJVLzMh0Q: calls $2
*** RIVER *** [3c 6d 2h Ah] [8c]
lsLuWlcPA3Rh7kJVLzMh0Q: checks
mLOIkH/qmRa+mVujQIhBRg: bets $6
lsLuWlcPA3Rh7kJVLzMh0Q: folds
mLOIkH/qmRa+mVujQIhBRg collected $6.70 from pot
*** SUMMARY ***
Total pot $7 | Rake $0.30
Board [3c 6d 2h Ah 8c]
Seat 1: Z2fXsGcjl+Eax+RzOgwOmg folded before Flop (didn't bet)
Seat 2: mLOIkH/qmRa+mVujQIhBRg collected ($6.70)
Seat 3: +xW7QemQU0Fxs+4TnqBRow (button) folded before Flop (didn't bet)
Seat 4: +uSzP8Jwnw7sKfQ4s66b7w (small blind) folded on the Turn
Seat 5: lsLuWlcPA3Rh7kJVLzMh0Q (big blind) folded on the River
Seat 6: PxqfkAMdAWtkgbT+q2gciA folded before Flop (didn't bet)



PokerStars Game #59940799918:  Hold'em No Limit ($0.50/$1.00) - 2009/07/01 1:16:56 ET
Table 'SQLOQoANiHscJ8AL7zffbw' 9-max Seat #9 is the button
Seat 1: jPTRd6SpCp4xqAy2XQiTOw ($65.90 in chips)
Seat 2: /zy+DB4S5fUQUSfZWFzYGw ($396.55 in chips)
Seat 3: 0eFnow7+D7veCYQ+CG9FFw ($103 in chips)
Seat 4: 5z1PAR8SNow/zUfYNbwq7A ($44.35 in chips)
Seat 5: L9njYvloJ1NdXjP8edHEAg ($100 in chips)
Seat 6: H+DVy3Ei8L1UKS2tVOtJcw ($100 in chips)
Seat 7: bJckevFOcg//s0qyMQI6sQ ($103.05 in chips)
Seat 8: 2BV+oJIQYr65IO6nEChvbA ($60 in chips)
Seat 9: qJr25HAtvv1w/7IBvjMM3g ($198.65 in chips)
jPTRd6SpCp4xqAy2XQiTOw: posts small blind $0.50
/zy+DB4S5fUQUSfZWFzYGw: posts big blind $1
5z1PAR8SNow/zUfYNbwq7A: posts big blind $1
*** HOLE CARDS ***
0eFnow7+D7veCYQ+CG9FFw: folds
5z1PAR8SNow/zUfYNbwq7A: raises $3 to $4
L9njYvloJ1NdXjP8edHEAg: folds
H+DVy3Ei8L1UKS2tVOtJcw: folds
bJckevFOcg//s0qyMQI6sQ: folds
2BV+oJIQYr65IO6nEChvbA: folds
2BV+oJIQYr65IO6nEChvbA is sitting out
qJr25HAtvv1w/7IBvjMM3g: folds
jPTRd6SpCp4xqAy2XQiTOw: calls $3.50
2BV+oJIQYr65IO6nEChvbA leaves the table
/zy+DB4S5fUQUSfZWFzYGw: folds
*** FLOP *** [9d 2s 4d]
jPTRd6SpCp4xqAy2XQiTOw: bets $7
5z1PAR8SNow/zUfYNbwq7A: raises $10 to $17
jPTRd6SpCp4xqAy2XQiTOw: folds
9BZCcac3+McErkkSN2YScA joins the table at seat #8
5z1PAR8SNow/zUfYNbwq7A collected $21.90 from pot
*** SUMMARY ***
Total pot $23 | Rake $1.10
Board [9d 2s 4d]
Seat 1: jPTRd6SpCp4xqAy2XQiTOw (small blind) folded on the Flop
Seat 2: /zy+DB4S5fUQUSfZWFzYGw (big blind) folded before Flop
Seat 3: 0eFnow7+D7veCYQ+CG9FFw folded before Flop (didn't bet)
Seat 4: 5z1PAR8SNow/zUfYNbwq7A collected ($21.90)
Seat 5: L9njYvloJ1NdXjP8edHEAg folded before Flop (didn't bet)
Seat 6: H+DVy3Ei8L1UKS2tVOtJcw folded before Flop (didn't bet)
Seat 7: bJckevFOcg//s0qyMQI6sQ folded before Flop (didn't bet)
Seat 8: 2BV+oJIQYr65IO6nEChvbA folded before Flop (didn't bet)
Seat 9: qJr25HAtvv1w/7IBvjMM3g (button) folded before Flop (didn't bet)



PokerStars Game #59940800284:  Hold'em No Limit ($0.50/$1.00) - 2009/07/01 1:16:57 ET
Table '/RZcOwpZpHQ+OwPwjsbnRw' 6-max Seat #2 is the button
Seat 1: +uSzP8Jwnw7sKfQ4s66b7w ($52.25 in chips)
Seat 2: Z2fXsGcjl+Eax+RzOgwOmg ($100 in chips)
Seat 4: j7NIOHLZk7V2o9fOioO5ug ($144.20 in chips)
Seat 5: wx3sQGkVi2x9wJXuWNHPBw ($167.75 in chips)
6hLdALbOlkzGIrc53QKtPw will be allowed to play after the button
j7NIOHLZk7V2o9fOioO5ug: posts small blind $0.50
wx3sQGkVi2x9wJXuWNHPBw: posts big blind $1
o3YLm/rSY916m/on1VjXPA: sits out
*** HOLE CARDS ***
+uSzP8Jwnw7sKfQ4s66b7w: raises $2 to $3
Z2fXsGcjl+Eax+RzOgwOmg: folds
j7NIOHLZk7V2o9fOioO5ug: folds
wx3sQGkVi2x9wJXuWNHPBw: folds
+uSzP8Jwnw7sKfQ4s66b7w collected $2.50 from pot
*** SUMMARY ***
Total pot $2.50 | Rake $0
Seat 1: +uSzP8Jwnw7sKfQ4s66b7w collected ($2.50)
Seat 2: Z2fXsGcjl+Eax+RzOgwOmg (button) folded before Flop (didn't bet)
Seat 4: j7NIOHLZk7V2o9fOioO5ug (small blind) folded before Flop
Seat 5: wx3sQGkVi2x9wJXuWNHPBw (big blind) folded before Flop



PokerStars Game #59940801320:  Hold'em No Limit ($0.50/$1.00) - 2009/07/01 1:16:59 ET
Table '7Nl0ffnjeK44/vmeexh3MQ' 9-max Seat #7 is the button
Seat 1: V138SURkdX8LdVBPKdJJag ($101.50 in chips)
Seat 2: OGgaARGdJQT4awWVNQ957w ($102 in chips)
Seat 3: JMmUYT5pIKCKh2pGjCB/4w ($55.50 in chips)
Seat 4: bLbSOSmSOnqE0iTcH/5dxA ($100 in chips)
Seat 5: 61sfw5QTu62YYIt68OsdrA ($81.50 in chips)
Seat 6: FVs16t7GgfWgQWt4JxsObQ ($29.25 in chips)
Seat 7: 997ViqAtWn1FPjJqcffwcA ($100 in chips)
Seat 8: D+W9Me7w6Hcx/WRUSKV0dw ($19.75 in chips)
Seat 9: ouwUBGRKnKK9uhn1G4Lf+A ($194 in chips)
D+W9Me7w6Hcx/WRUSKV0dw: posts small blind $0.50
ouwUBGRKnKK9uhn1G4Lf+A: posts big blind $1
*** HOLE CARDS ***
V138SURkdX8LdVBPKdJJag: folds
OGgaARGdJQT4awWVNQ957w: folds
JMmUYT5pIKCKh2pGjCB/4w: calls $1
bLbSOSmSOnqE0iTcH/5dxA: folds
61sfw5QTu62YYIt68OsdrA: folds
FVs16t7GgfWgQWt4JxsObQ: folds
997ViqAtWn1FPjJqcffwcA: folds
D+W9Me7w6Hcx/WRUSKV0dw: folds
ouwUBGRKnKK9uhn1G4Lf+A: checks
*** FLOP *** [2c 3h Ks]
ouwUBGRKnKK9uhn1G4Lf+A: checks
JMmUYT5pIKCKh2pGjCB/4w: bets $1
ouwUBGRKnKK9uhn1G4Lf+A: folds
JMmUYT5pIKCKh2pGjCB/4w collected $2.40 from pot
JMmUYT5pIKCKh2pGjCB/4w: doesn't show hand
*** SUMMARY ***
Total pot $2.50 | Rake $0.10
Board [2c 3h Ks]
Seat 1: V138SURkdX8LdVBPKdJJag folded before Flop (didn't bet)
Seat 2: OGgaARGdJQT4awWVNQ957w folded before Flop (didn't bet)
Seat 3: JMmUYT5pIKCKh2pGjCB/4w collected ($2.40)
Seat 4: bLbSOSmSOnqE0iTcH/5dxA folded before Flop (didn't bet)
Seat 5: 61sfw5QTu62YYIt68OsdrA folded before Flop (didn't bet)
Seat 6: FVs16t7GgfWgQWt4JxsObQ folded before Flop (didn't bet)
Seat 7: 997ViqAtWn1FPjJqcffwcA (button) folded before Flop (didn't bet)
Seat 8: D+W9Me7w6Hcx/WRUSKV0dw (small blind) folded before Flop
Seat 9: ouwUBGRKnKK9uhn1G4Lf+A (big blind) folded on the Flop



PokerStars Game #59940803234:  Hold'em No Limit ($0.50/$1.00) - 2009/07/01 1:17:02 ET
Table 'MNvFfRVQNka/oY+Z5aMbZQ' 2-max Seat #2 is the button
Seat 1: DaZnoWHjO897dnh0CL2lVg ($50 in chips)
Seat 2: mgi+mjKb1Sc3CCs7TlfoCw ($49.35 in chips)
mgi+mjKb1Sc3CCs7TlfoCw: posts small blind $0.50
DaZnoWHjO897dnh0CL2lVg: posts big blind $1
*** HOLE CARDS ***
mgi+mjKb1Sc3CCs7TlfoCw: folds
DaZnoWHjO897dnh0CL2lVg collected $1 from pot
*** SUMMARY ***
Total pot $1 | Rake $0
Seat 1: DaZnoWHjO897dnh0CL2lVg (big blind) collected ($1)
Seat 2: mgi+mjKb1Sc3CCs7TlfoCw (button) (small blind) folded before Flop



PokerStars Game #59940803330:  Hold'em No Limit ($0.50/$1.00) - 2009/07/01 1:17:02 ET
Table 'hugOjcwJvzEwZbK7tyiWuQ' 9-max Seat #9 is the button
Seat 1: S3Ex8K7v6xm5jqjRM7Fl3w ($21 in chips)
Seat 2: r27C1nIV4NS4+qbnrgBQSw ($281.70 in chips)
Seat 4: UWB3oeddt/GObx2Mix2Anw ($171.30 in chips)
Seat 5: 5BRGWf+R3nt2WS3b5xX+zA ($26.35 in chips)
Seat 6: gUUvmqdVlmvpal6B8nYrmg ($103 in chips)
Seat 7: FL3MrLspcF23LYvC4ipBOA ($120.30 in chips)
Seat 8: /zy+DB4S5fUQUSfZWFzYGw ($101.05 in chips)
Seat 9: W8P9bUKCs43TO1xHm0dL6w ($87.95 in chips)
S3Ex8K7v6xm5jqjRM7Fl3w: posts small blind $0.50
r27C1nIV4NS4+qbnrgBQSw: posts big blind $1
*** HOLE CARDS ***
ZWdwcEAWYlrUhsRi6MOmoA joins the table at seat #3
UWB3oeddt/GObx2Mix2Anw: folds
5BRGWf+R3nt2WS3b5xX+zA: folds
gUUvmqdVlmvpal6B8nYrmg: folds
FL3MrLspcF23LYvC4ipBOA: folds
/zy+DB4S5fUQUSfZWFzYGw: folds
W8P9bUKCs43TO1xHm0dL6w: folds
S3Ex8K7v6xm5jqjRM7Fl3w: raises $1 to $2
r27C1nIV4NS4+qbnrgBQSw: folds
S3Ex8K7v6xm5jqjRM7Fl3w collected $2 from pot
*** SUMMARY ***
Total pot $2 | Rake $0
Seat 1: S3Ex8K7v6xm5jqjRM7Fl3w (small blind) collected ($2)
Seat 2: r27C1nIV4NS4+qbnrgBQSw (big blind) folded before Flop
Seat 4: UWB3oeddt/GObx2Mix2Anw folded before Flop (didn't bet)
Seat 5: 5BRGWf+R3nt2WS3b5xX+zA folded before Flop (didn't bet)
Seat 6: gUUvmqdVlmvpal6B8nYrmg folded before Flop (didn't bet)
Seat 7: FL3MrLspcF23LYvC4ipBOA folded before Flop (didn't bet)
Seat 8: /zy+DB4S5fUQUSfZWFzYGw folded before Flop (didn't bet)
Seat 9: W8P9bUKCs43TO1xHm0dL6w (button) folded before Flop (didn't bet)



PokerStars Game #59940804484:  Hold'em No Limit ($0.50/$1.00) - 2009/07/01 1:17:04 ET
Table 'O96CPOtvMBWP6kzuYDfdFA' 6-max Seat #2 is the button
Seat 1: 6alLXQIITA2EZ/lBeym8Dw ($122.25 in chips)
Seat 2: 4d1rWhpu8DzLmzMbR3QKyA ($109.85 in chips)
Seat 3: V89DGjxE171oPREEbAXiyg ($89.60 in chips)
Seat 4: /P4w1pHg2zHYg/4ubJ0dPw ($60 in chips)
Seat 5: G5ZSSN6RSON3gkNvk/SmYg ($100 in chips)
Seat 6: GYei5jXGWexiJYbAT2fELg ($38.15 in chips)
V89DGjxE171oPREEbAXiyg: posts small blind $0.50
/P4w1pHg2zHYg/4ubJ0dPw: posts big blind $1
*** HOLE CARDS ***
G5ZSSN6RSON3gkNvk/SmYg: folds
GYei5jXGWexiJYbAT2fELg: calls $1
6alLXQIITA2EZ/lBeym8Dw: folds
4d1rWhpu8DzLmzMbR3QKyA: folds
V89DGjxE171oPREEbAXiyg: calls $0.50
/P4w1pHg2zHYg/4ubJ0dPw: checks
*** FLOP *** [6h 9s Kh]
V89DGjxE171oPREEbAXiyg: checks
/P4w1pHg2zHYg/4ubJ0dPw: checks
GYei5jXGWexiJYbAT2fELg: checks
*** TURN *** [6h 9s Kh] [8d]
V89DGjxE171oPREEbAXiyg: bets $12
/P4w1pHg2zHYg/4ubJ0dPw: folds
GYei5jXGWexiJYbAT2fELg: folds
V89DGjxE171oPREEbAXiyg collected $2.85 from pot
*** SUMMARY ***
Total pot $3 | Rake $0.15
Board [6h 9s Kh 8d]
Seat 1: 6alLXQIITA2EZ/lBeym8Dw folded before Flop (didn't bet)
Seat 2: 4d1rWhpu8DzLmzMbR3QKyA (button) folded before Flop (didn't bet)
Seat 3: V89DGjxE171oPREEbAXiyg (small blind) collected ($2.85)
Seat 4: /P4w1pHg2zHYg/4ubJ0dPw (big blind) folded on the Turn
Seat 5: G5ZSSN6RSON3gkNvk/SmYg folded before Flop (didn't bet)
Seat 6: GYei5jXGWexiJYbAT2fELg folded on the Turn



PokerStars Game #59940804860:  Hold'em No Limit ($0.50/$1.00) - 2009/07/01 1:17:05 ET
Table 'W/wyObTiXZm+Ckkl3YxcSw' 6-max Seat #2 is the button
Seat 1: eUBBn2R56C1IQ6Cs/vitwg ($186.75 in chips)
Seat 2: oDiBRCaF0QVtd3kO6xZIXw ($155.15 in chips)
Seat 3: dxyNCn/qxfkGDUIf28Cbng ($65.65 in chips)
Seat 4: aYii2DmxlOlbC1wbGRBWvQ ($113.15 in chips)
Seat 5: +OrCjyw70oZhJiD22Mn+bg ($100 in chips)
Seat 6: b2a+5TkFf4xJN/Ihhma58Q ($38 in chips)
dxyNCn/qxfkGDUIf28Cbng: posts small blind $0.50
aYii2DmxlOlbC1wbGRBWvQ: posts big blind $1
*** HOLE CARDS ***
+OrCjyw70oZhJiD22Mn+bg: folds
b2a+5TkFf4xJN/Ihhma58Q: folds
eUBBn2R56C1IQ6Cs/vitwg: raises $2 to $3
oDiBRCaF0QVtd3kO6xZIXw: calls $3
dxyNCn/qxfkGDUIf28Cbng: folds
aYii2DmxlOlbC1wbGRBWvQ: calls $2
*** FLOP *** [6c Td 9s]
aYii2DmxlOlbC1wbGRBWvQ: bets $4
eUBBn2R56C1IQ6Cs/vitwg: calls $4
oDiBRCaF0QVtd3kO6xZIXw: folds
*** TURN *** [6c Td 9s] [Js]
aYii2DmxlOlbC1wbGRBWvQ: bets $6
eUBBn2R56C1IQ6Cs/vitwg: raises $12 to $18
aYii2DmxlOlbC1wbGRBWvQ: calls $12
*** RIVER *** [6c Td 9s Js] [Jh]
aYii2DmxlOlbC1wbGRBWvQ: bets $22
eUBBn2R56C1IQ6Cs/vitwg: raises $139.75 to $161.75 and is all-in
aYii2DmxlOlbC1wbGRBWvQ: calls $66.15 and is all-in
*** SHOW DOWN ***
eUBBn2R56C1IQ6Cs/vitwg: shows [Kc Qc] (a straight, Nine to King)
aYii2DmxlOlbC1wbGRBWvQ: mucks hand
eUBBn2R56C1IQ6Cs/vitwg collected $226.80 from pot
*** SUMMARY ***
Total pot $229.80 | Rake $3
Board [6c Td 9s Js Jh]
Seat 1: eUBBn2R56C1IQ6Cs/vitwg showed [Kc Qc] and won ($226.80) with a straight, Nine to King
Seat 2: oDiBRCaF0QVtd3kO6xZIXw (button) folded on the Flop
Seat 3: dxyNCn/qxfkGDUIf28Cbng (small blind) folded before Flop
Seat 4: aYii2DmxlOlbC1wbGRBWvQ (big blind) mucked
Seat 5: +OrCjyw70oZhJiD22Mn+bg folded before Flop (didn't bet)
Seat 6: b2a+5TkFf4xJN/Ihhma58Q folded before Flop (didn't bet)



PokerStars Game #59940806242:  Hold'em No Limit ($0.50/$1.00) - 2009/07/01 1:17:07 ET
Table 'MUPc8FEpe/nR0BKSeReX6Q' 6-max Seat #6 is the button
Seat 1: qhkK6+yCciTRd+rCFEbnEQ ($42.60 in chips)
Seat 2: xAU6q2/cwmby2sxmA8VcmA ($114.70 in chips)
Seat 3: wx3sQGkVi2x9wJXuWNHPBw ($226 in chips)
Seat 4: ZA1bp6g8IwtTxkUE4eCjDQ ($195.20 in chips)
Seat 5: y27w5IK2WXqmYzS8OU0wKA ($100 in chips)
Seat 6: oxnw0GLLpFanjhGkxfRSqA ($47.15 in chips)
qhkK6+yCciTRd+rCFEbnEQ: posts small blind $0.50
xAU6q2/cwmby2sxmA8VcmA: posts big blind $1
*** HOLE CARDS ***
wx3sQGkVi2x9wJXuWNHPBw has timed out
wx3sQGkVi2x9wJXuWNHPBw: folds
wx3sQGkVi2x9wJXuWNHPBw is sitting out
ZA1bp6g8IwtTxkUE4eCjDQ: folds
y27w5IK2WXqmYzS8OU0wKA: folds
wx3sQGkVi2x9wJXuWNHPBw has returned
oxnw0GLLpFanjhGkxfRSqA: calls $1
qhkK6+yCciTRd+rCFEbnEQ: folds
xAU6q2/cwmby2sxmA8VcmA: checks
*** FLOP *** [5c 2h Ad]
xAU6q2/cwmby2sxmA8VcmA: checks
oxnw0GLLpFanjhGkxfRSqA: bets $2
xAU6q2/cwmby2sxmA8VcmA: folds
oxnw0GLLpFanjhGkxfRSqA collected $2.40 from pot
*** SUMMARY ***
Total pot $2.50 | Rake $0.10
Board [5c 2h Ad]
Seat 1: qhkK6+yCciTRd+rCFEbnEQ (small blind) folded before Flop
Seat 2: xAU6q2/cwmby2sxmA8VcmA (big blind) folded on the Flop
Seat 3: wx3sQGkVi2x9wJXuWNHPBw folded before Flop (didn't bet)
Seat 4: ZA1bp6g8IwtTxkUE4eCjDQ folded before Flop (didn't bet)
Seat 5: y27w5IK2WXqmYzS8OU0wKA folded before Flop (didn't bet)
Seat 6: oxnw0GLLpFanjhGkxfRSqA (button) collected ($2.40)



PokerStars Game #59940809690:  Hold'em No Limit ($0.50/$1.00) - 2009/07/01 1:17:13 ET
Table 'MNvFfRVQNka/oY+Z5aMbZQ' 2-max Seat #1 is the button
Seat 1: DaZnoWHjO897dnh0CL2lVg ($50.50 in chips)
Seat 2: mgi+mjKb1Sc3CCs7TlfoCw ($48.85 in chips)
DaZnoWHjO897dnh0CL2lVg: posts small blind $0.50
mgi+mjKb1Sc3CCs7TlfoCw: posts big blind $1
*** HOLE CARDS ***
DaZnoWHjO897dnh0CL2lVg: raises $2 to $3
mgi+mjKb1Sc3CCs7TlfoCw: calls $2
*** FLOP *** [7s Qc 4s]
mgi+mjKb1Sc3CCs7TlfoCw: bets $4
DaZnoWHjO897dnh0CL2lVg: calls $4
*** TURN *** [7s Qc 4s] [Ts]
mgi+mjKb1Sc3CCs7TlfoCw: checks
DaZnoWHjO897dnh0CL2lVg: bets $4
mgi+mjKb1Sc3CCs7TlfoCw: calls $4
*** RIVER *** [7s Qc 4s Ts] [Kd]
mgi+mjKb1Sc3CCs7TlfoCw: checks
DaZnoWHjO897dnh0CL2lVg: bets $5
mgi+mjKb1Sc3CCs7TlfoCw: folds
DaZnoWHjO897dnh0CL2lVg collected $21.50 from pot
DaZnoWHjO897dnh0CL2lVg: doesn't show hand
*** SUMMARY ***
Total pot $22 | Rake $0.50
Board [7s Qc 4s Ts Kd]
Seat 1: DaZnoWHjO897dnh0CL2lVg (button) (small blind) collected ($21.50)
Seat 2: mgi+mjKb1Sc3CCs7TlfoCw (big blind) folded on the River



PokerStars Game #59940809392:  Hold'em No Limit ($0.50/$1.00) - 2009/07/01 1:17:13 ET
Table 'tyUh+jyNvrceIQdKMJjQ2wZFWj23PMihdwrNWv41OG/Qeat #4 is the button
Seat 2: 5uy3EN+iIYkgwbWZFTUBAQ ($100 in chips)
Seat 3: TalCiLYHCd+ffkmR3auPvA ($131.30 in chips)
Seat 4: hpxXcmRkXXI9HE5+5/j/0Q ($100 in chips)
Seat 5: j7NIOHLZk7V2o9fOioO5ug ($109.85 in chips)
Seat 6: 4OO5v3AVduL0tePNx8wk5A ($115 in chips)
j7NIOHLZk7V2o9fOioO5ug: posts small blind $0.50
4OO5v3AVduL0tePNx8wk5A: posts big blind $1
*** HOLE CARDS ***
5uy3EN+iIYkgwbWZFTUBAQ: folds
TalCiLYHCd+ffkmR3auPvA: calls $1
hpxXcmRkXXI9HE5+5/j/0Q: folds
j7NIOHLZk7V2o9fOioO5ug: calls $0.50
4OO5v3AVduL0tePNx8wk5A: checks
*** FLOP *** [Ac 9d Th]
j7NIOHLZk7V2o9fOioO5ug: bets $3
4OO5v3AVduL0tePNx8wk5A: folds
TalCiLYHCd+ffkmR3auPvA: folds
j7NIOHLZk7V2o9fOioO5ug collected $2.85 from pot
j7NIOHLZk7V2o9fOioO5ug: doesn't show hand
*** SUMMARY ***
Total pot $3 | Rake $0.15
Board [Ac 9d Th]
Seat 2: 5uy3EN+iIYkgwbWZFTUBAQ folded before Flop (didn't bet)
Seat 3: TalCiLYHCd+ffkmR3auPvA folded on the Flop
Seat 4: hpxXcmRkXXI9HE5+5/j/0Q (button) folded before Flop (didn't bet)
Seat 5: j7NIOHLZk7V2o9fOioO5ug (small blind) collected ($2.85)
Seat 6: 4OO5v3AVduL0tePNx8wk5A (big blind) folded on the Flop



PokerStars Game #59940810578:  Hold'em No Limit ($0.50/$1.00) - 2009/07/01 1:17:15 ET
Table 'pHrhryH8jPNdQfY62f8v+g' 6-max Seat #3 is the button
Seat 1: 4d1rWhpu8DzLmzMbR3QKyA ($117.40 in chips)
Seat 2: JwCcjZl0bjJzG7hmE0dnTA ($100 in chips)
Seat 3: 8oS5O7iD/qnFXFXJrGIgNQ ($100 in chips)
Seat 4: 1f3beyIML24UqEMTbWy93g ($42.15 in chips)
Seat 5: r1/R7y0Ortgoz4lccgW8VA ($44.55 in chips)
Seat 6: xAU6q2/cwmby2sxmA8VcmA ($206.60 in chips)
1f3beyIML24UqEMTbWy93g: posts small blind $0.50
r1/R7y0Ortgoz4lccgW8VA: posts big blind $1
*** HOLE CARDS ***
xAU6q2/cwmby2sxmA8VcmA: folds
4d1rWhpu8DzLmzMbR3QKyA: raises $2 to $3
JwCcjZl0bjJzG7hmE0dnTA: folds
8oS5O7iD/qnFXFXJrGIgNQ: folds
1f3beyIML24UqEMTbWy93g: folds
r1/R7y0Ortgoz4lccgW8VA: calls $2
*** FLOP *** [Qs Ks Js]
r1/R7y0Ortgoz4lccgW8VA: bets $6
4d1rWhpu8DzLmzMbR3QKyA: folds
r1/R7y0Ortgoz4lccgW8VA collected $6.20 from pot
*** SUMMARY ***
Total pot $6.50 | Rake $0.30
Board [Qs Ks Js]
Seat 1: 4d1rWhpu8DzLmzMbR3QKyA folded on the Flop
Seat 2: JwCcjZl0bjJzG7hmE0dnTA folded before Flop (didn't bet)
Seat 3: 8oS5O7iD/qnFXFXJrGIgNQ (button) folded before Flop (didn't bet)
Seat 4: 1f3beyIML24UqEMTbWy93g (small blind) folded before Flop
Seat 5: r1/R7y0Ortgoz4lccgW8VA (big blind) collected ($6.20)
Seat 6: xAU6q2/cwmby2sxmA8VcmA folded before Flop (didn't bet)



PokerStars Game #59940811210:  Hold'em No Limit ($0.50/$1.00) - 2009/07/01 1:17:16 ET
Table '7O9fB8yx1u7sJveJn8w6jA' 6-max Seat #3 is the button
Seat 1: jy52+7FotjH63o5tEEVgKw ($56.85 in chips)
Seat 2: wx3sQGkVi2x9wJXuWNHPBw ($195.25 in chips)
Seat 3: hpxXcmRkXXI9HE5+5/j/0Q ($124.25 in chips)
Seat 4: b2a+5TkFf4xJN/Ihhma58Q ($38.30 in chips)
Seat 5: BCEV3COoKY607AzLWayfRA ($101.85 in chips)
Seat 6: p1Ga2i1TuXUvRn+Rf/0FMw ($122.40 in chips)
b2a+5TkFf4xJN/Ihhma58Q: posts small blind $0.50
BCEV3COoKY607AzLWayfRA: posts big blind $1
*** HOLE CARDS ***
p1Ga2i1TuXUvRn+Rf/0FMw: calls $1
jy52+7FotjH63o5tEEVgKw: folds
wx3sQGkVi2x9wJXuWNHPBw: raises $4 to $5
hpxXcmRkXXI9HE5+5/j/0Q: folds
b2a+5TkFf4xJN/Ihhma58Q: folds
BCEV3COoKY607AzLWayfRA: folds
p1Ga2i1TuXUvRn+Rf/0FMw: calls $4
*** FLOP *** [Qs 8d 5d]
p1Ga2i1TuXUvRn+Rf/0FMw: checks
wx3sQGkVi2x9wJXuWNHPBw: bets $8
p1Ga2i1TuXUvRn+Rf/0FMw: folds
wx3sQGkVi2x9wJXuWNHPBw collected $10.95 from pot
*** SUMMARY ***
Total pot $11.50 | Rake $0.55
Board [Qs 8d 5d]
Seat 1: jy52+7FotjH63o5tEEVgKw folded before Flop (didn't bet)
Seat 2: wx3sQGkVi2x9wJXuWNHPBw collected ($10.95)
Seat 3: hpxXcmRkXXI9HE5+5/j/0Q (button) folded before Flop (didn't bet)
Seat 4: b2a+5TkFf4xJN/Ihhma58Q (small blind) folded before Flop
Seat 5: BCEV3COoKY607AzLWayfRA (big blind) folded before Flop
Seat 6: p1Ga2i1TuXUvRn+Rf/0FMw folded on the Flop



PokerStars Game #59940813160:  Hold'em No Limit ($0.50/$1.00) - 2009/07/01 1:17:19 ET
Table 'hdVBCnDy5t2X9dZo0AvD9w' 9-max Seat #3 is the button
Seat 1: sa/cZBFh73L9TapFXpn3BA ($74.90 in chips)
Seat 2: Ogn4JDV3mp4ZDKO49IFzKA ($20.50 in chips)
Seat 3: 1862487932 ($100 in chips)
Seat 4: YvSugbFKWSuAYx9iokQwUQ ($72.20 in chips)
Seat 5: H+DVy3Ei8L1UKS2tVOtJcw ($100 in chips)
Seat 6: bJckevFOcg//s0qyMQI6sQ ($100 in chips)
Seat 7: KqC3XiX79XzqwhoOYPVb4w ($163.05 in chips)
Seat 8: gUUvmqdVlmvpal6B8nYrmg ($144.40 in chips)
Seat 9: AMkLbywdoc0K30BTzaIfTQ ($183.40 in chips)
YvSugbFKWSuAYx9iokQwUQ: posts small blind $0.50
H+DVy3Ei8L1UKS2tVOtJcw: posts big blind $1
*** HOLE CARDS ***
bJckevFOcg//s0qyMQI6sQ: folds
KqC3XiX79XzqwhoOYPVb4w: folds
gUUvmqdVlmvpal6B8nYrmg: folds
AMkLbywdoc0K30BTzaIfTQ: folds
sa/cZBFh73L9TapFXpn3BA: raises $1 to $2
Ogn4JDV3mp4ZDKO49IFzKA: folds
1862487932: raises $5.50 to $7.50
YvSugbFKWSuAYx9iokQwUQ: folds
H+DVy3Ei8L1UKS2tVOtJcw: folds
sa/cZBFh73L9TapFXpn3BA: calls $5.50
*** FLOP *** [8h 3h Ks]
sa/cZBFh73L9TapFXpn3BA: bets $6
1862487932: raises $11 to $17
sa/cZBFh73L9TapFXpn3BA: raises $50.40 to $67.40 and is all-in
1862487932: folds
sa/cZBFh73L9TapFXpn3BA collected $48.05 from pot
*** SUMMARY ***
Total pot $50.50 | Rake $2.45
Board [8h 3h Ks]
Seat 1: sa/cZBFh73L9TapFXpn3BA collected ($48.05)
Seat 2: Ogn4JDV3mp4ZDKO49IFzKA folded before Flop (didn't bet)
Seat 3: 1862487932 (button) folded on the Flop
Seat 4: YvSugbFKWSuAYx9iokQwUQ (small blind) folded before Flop
Seat 5: H+DVy3Ei8L1UKS2tVOtJcw (big blind) folded before Flop
Seat 6: bJckevFOcg//s0qyMQI6sQ folded before Flop (didn't bet)
Seat 7: KqC3XiX79XzqwhoOYPVb4w folded before Flop (didn't bet)
Seat 8: gUUvmqdVlmvpal6B8nYrmg folded before Flop (didn't bet)
Seat 9: AMkLbywdoc0K30BTzaIfTQ folded before Flop (didn't bet)



PokerStars Game #59940813192:  Hold'em No Limit ($0.50/$1.00) - 2009/07/01 1:17:19 ET
Table 'kS0cTQAEi+fdUlJP2gQYvw' 9-max Seat #3 is the button
Seat 1: c/9X4zftzphFxYtxp5kp9w ($78.75 in chips)
Seat 2: D+W9Me7w6Hcx/WRUSKV0dw ($26.55 in chips)
Seat 3: 2BV+oJIQYr65IO6nEChvbA ($60 in chips)
Seat 4: RUhhaALzha3TH1AkdakoGQ ($43 in chips)
Seat 5: 997ViqAtWn1FPjJqcffwcA ($101.15 in chips)
Seat 6: yAbu2QsRPVcjPbqlf/jDxw ($126.15 in chips)
Seat 7: Ffa7Nj4X5fddtROP01hfQg ($163.10 in chips)
Seat 9: OGgaARGdJQT4awWVNQ957w ($100 in chips)
RUhhaALzha3TH1AkdakoGQ: posts small blind $0.50
vKyFzTyzfT7fZcdX+HHN+Q is connected
997ViqAtWn1FPjJqcffwcA: posts big blind $1
*** HOLE CARDS ***
vKyFzTyzfT7fZcdX+HHN+Q has returned
yAbu2QsRPVcjPbqlf/jDxw: folds
Ffa7Nj4X5fddtROP01hfQg: folds
OGgaARGdJQT4awWVNQ957w: folds
c/9X4zftzphFxYtxp5kp9w: folds
D+W9Me7w6Hcx/WRUSKV0dw: folds
2BV+oJIQYr65IO6nEChvbA: folds
RUhhaALzha3TH1AkdakoGQ: calls $0.50
997ViqAtWn1FPjJqcffwcA: checks
*** FLOP *** [4h 8c Th]
RUhhaALzha3TH1AkdakoGQ: checks
997ViqAtWn1FPjJqcffwcA: checks
*** TURN *** [4h 8c Th] [4c]
RUhhaALzha3TH1AkdakoGQ: bets $2
997ViqAtWn1FPjJqcffwcA: calls $2
*** RIVER *** [4h 8c Th 4c] [7c]
RUhhaALzha3TH1AkdakoGQ: checks
997ViqAtWn1FPjJqcffwcA: checks
*** SHOW DOWN ***
RUhhaALzha3TH1AkdakoGQ: shows [6d Kc] (a pair of Fours)
997ViqAtWn1FPjJqcffwcA: shows [6s Td] (two pair, Tens and Fours)
997ViqAtWn1FPjJqcffwcA collected $5.75 from pot
*** SUMMARY ***
Total pot $6 | Rake $0.25
Board [4h 8c Th 4c 7c]
Seat 1: c/9X4zftzphFxYtxp5kp9w folded before Flop (didn't bet)
Seat 2: D+W9Me7w6Hcx/WRUSKV0dw folded before Flop (didn't bet)
Seat 3: 2BV+oJIQYr65IO6nEChvbA (button) folded before Flop (didn't bet)
Seat 4: RUhhaALzha3TH1AkdakoGQ (small blind) showed [6d Kc] and lost with a pair of Fours
Seat 5: 997ViqAtWn1FPjJqcffwcA (big blind) showed [6s Td] and won ($5.75) with two pair, Tens and Fours
Seat 6: yAbu2QsRPVcjPbqlf/jDxw folded before Flop (didn't bet)
Seat 7: Ffa7Nj4X5fddtROP01hfQg folded before Flop (didn't bet)
Seat 9: OGgaARGdJQT4awWVNQ957w folded before Flop (didn't bet)



PokerStars Game #59940814356:  Hold'em No Limit ($0.50/$1.00) - 2009/07/01 1:17:22 ET
Table '+cA8mcmhaedZ7YcrDdhmeQ' 6-max Seat #1 is the button
Seat 1: lsLuWlcPA3Rh7kJVLzMh0Q ($273.45 in chips)
Seat 3: DAIgyIWbYvAkL6PbAI27pg ($16 in chips)
Seat 4: 4OO5v3AVduL0tePNx8wk5A ($106.55 in chips)
Seat 6: YfsTQsY/fxb+YqbdclTHuw ($16.85 in chips)
14aYclSc98EYd6TrzN2l3Q will be allowed to play after the button
DAIgyIWbYvAkL6PbAI27pg: posts small blind $0.50
4OO5v3AVduL0tePNx8wk5A: posts big blind $1
6hLdALbOlkzGIrc53QKtPw: sits out
*** HOLE CARDS ***
YfsTQsY/fxb+YqbdclTHuw: folds
lsLuWlcPA3Rh7kJVLzMh0Q: raises $1 to $2
DAIgyIWbYvAkL6PbAI27pg: folds
4OO5v3AVduL0tePNx8wk5A: folds
lsLuWlcPA3Rh7kJVLzMh0Q collected $2.50 from pot
*** SUMMARY ***
Total pot $2.50 | Rake $0
Seat 1: lsLuWlcPA3Rh7kJVLzMh0Q (button) collected ($2.50)
Seat 3: DAIgyIWbYvAkL6PbAI27pg (small blind) folded before Flop
Seat 4: 4OO5v3AVduL0tePNx8wk5A (big blind) folded before Flop
Seat 6: YfsTQsY/fxb+YqbdclTHuw folded before Flop (didn't bet)



PokerStars Game #59940818210:  Hold'em No Limit ($0.50/$1.00) - 2009/07/01 1:17:28 ET
Table 'cBDNutyLBKEk9+ptwsKmTw' 6-max Seat #2 is the button
Seat 1: xAU6q2/cwmby2sxmA8VcmA ($259.90 in chips)
Seat 2: 5lY8d6Cnm4HUkt/8FZSj4g ($76.50 in chips)
Seat 3: G5ZSSN6RSON3gkNvk/SmYg ($100 in chips)
Seat 4: 3q7F5QtzC30pSrn0nl9i+A ($23 in chips)
Seat 5: hpxXcmRkXXI9HE5+5/j/0Q ($100 in chips)
G5ZSSN6RSON3gkNvk/SmYg: posts small blind $0.50
3q7F5QtzC30pSrn0nl9i+A: posts big blind $1
QHvTZcrKe6+maWUfVjP29Q: sits out
*** HOLE CARDS ***
hpxXcmRkXXI9HE5+5/j/0Q: folds
xAU6q2/cwmby2sxmA8VcmA: folds
5lY8d6Cnm4HUkt/8FZSj4g: calls $1
G5ZSSN6RSON3gkNvk/SmYg: folds
3q7F5QtzC30pSrn0nl9i+A: checks
*** FLOP *** [Qs Kh 9s]
3q7F5QtzC30pSrn0nl9i+A: checks
5lY8d6Cnm4HUkt/8FZSj4g: checks
*** TURN *** [Qs Kh 9s] [7d]
3q7F5QtzC30pSrn0nl9i+A: bets $1
5lY8d6Cnm4HUkt/8FZSj4g: calls $1
*** RIVER *** [Qs Kh 9s 7d] [6d]
3q7F5QtzC30pSrn0nl9i+A: checks
5lY8d6Cnm4HUkt/8FZSj4g: checks
*** SHOW DOWN ***
3q7F5QtzC30pSrn0nl9i+A: shows [4h 5d] (high card King)
5lY8d6Cnm4HUkt/8FZSj4g: shows [Jc Ac] (high card Ace)
5lY8d6Cnm4HUkt/8FZSj4g collected $4.30 from pot
*** SUMMARY ***
Total pot $4.50 | Rake $0.20
Board [Qs Kh 9s 7d 6d]
Seat 1: xAU6q2/cwmby2sxmA8VcmA folded before Flop (didn't bet)
Seat 2: 5lY8d6Cnm4HUkt/8FZSj4g (button) showed [Jc Ac] and won ($4.30) with high card Ace
Seat 3: G5ZSSN6RSON3gkNvk/SmYg (small blind) folded before Flop
Seat 4: 3q7F5QtzC30pSrn0nl9i+A (big blind) showed [4h 5d] and lost with high card King
Seat 5: hpxXcmRkXXI9HE5+5/j/0Q folded before Flop (didn't bet)



PokerStars Game #59940820004:  Hold'em No Limit ($0.50/$1.00) - 2009/07/01 1:17:32 ET
Table '/RZcOwpZpHQ+OwPwjsbnRw' 6-max Seat #4 is the button
Seat 1: +uSzP8Jwnw7sKfQ4s66b7w ($53.75 in chips)
Seat 2: Z2fXsGcjl+Eax+RzOgwOmg ($100 in chips)
Seat 4: j7NIOHLZk7V2o9fOioO5ug ($143.70 in chips)
Seat 5: wx3sQGkVi2x9wJXuWNHPBw ($166.75 in chips)
Seat 6: o3YLm/rSY916m/on1VjXPA ($100 in chips)
wx3sQGkVi2x9wJXuWNHPBw: posts small blind $0.50
o3YLm/rSY916m/on1VjXPA: posts big blind $1
6hLdALbOlkzGIrc53QKtPw: sits out
*** HOLE CARDS ***
+uSzP8Jwnw7sKfQ4s66b7w: folds
Z2fXsGcjl+Eax+RzOgwOmg: folds
j7NIOHLZk7V2o9fOioO5ug: folds
wx3sQGkVi2x9wJXuWNHPBw: folds
o3YLm/rSY916m/on1VjXPA collected $1 from pot
o3YLm/rSY916m/on1VjXPA: doesn't show hand
*** SUMMARY ***
Total pot $1 | Rake $0
Seat 1: +uSzP8Jwnw7sKfQ4s66b7w folded before Flop (didn't bet)
Seat 2: Z2fXsGcjl+Eax+RzOgwOmg folded before Flop (didn't bet)
Seat 4: j7NIOHLZk7V2o9fOioO5ug (button) folded before Flop (didn't bet)
Seat 5: wx3sQGkVi2x9wJXuWNHPBw (small blind) folded before Flop
Seat 6: o3YLm/rSY916m/on1VjXPA (big blind) collected ($1)



PokerStars Game #59940820510:  Hold'em No Limit ($0.50/$1.00) - 2009/07/01 1:17:32 ET
Table 'fZjVbKj9D8yOB+Rj7NaP/A' 9-max Seat #1 is the button
Seat 1: 9BZCcac3+McErkkSN2YScA ($100 in chips)
Seat 2: PTAFYDIUSsG+SArbxNl+Aw ($106 in chips)
Seat 3: yAbu2QsRPVcjPbqlf/jDxw ($102.50 in chips)
Seat 4: 997ViqAtWn1FPjJqcffwcA ($103 in chips)
Seat 5: PkGfq5xrSlNsujKaG/HF4Q ($100 in chips)
Seat 6: OvwYHV65yUbgdBjSmo1+5g ($48.45 in chips)
Seat 7: SyS20PAm3RpT6uLBsGkwOA ($114.30 in chips)
Seat 8: zDOE5r14tWqCf6xhuSHK6g ($41 in chips)
Seat 9: qheQay5YvP2DMAb3OUSxtw ($100 in chips)
PTAFYDIUSsG+SArbxNl+Aw: posts small blind $0.50
yAbu2QsRPVcjPbqlf/jDxw: posts big blind $1
*** HOLE CARDS ***
997ViqAtWn1FPjJqcffwcA: folds
PkGfq5xrSlNsujKaG/HF4Q: folds
OvwYHV65yUbgdBjSmo1+5g: raises $1 to $2
SyS20PAm3RpT6uLBsGkwOA: folds
zDOE5r14tWqCf6xhuSHK6g: folds
qheQay5YvP2DMAb3OUSxtw: folds
9BZCcac3+McErkkSN2YScA: folds
PTAFYDIUSsG+SArbxNl+Aw: folds
yAbu2QsRPVcjPbqlf/jDxw: folds
OvwYHV65yUbgdBjSmo1+5g collected $2.50 from pot
OvwYHV65yUbgdBjSmo1+5g: doesn't show hand
*** SUMMARY ***
Total pot $2.50 | Rake $0
Seat 1: 9BZCcac3+McErkkSN2YScA (button) folded before Flop (didn't bet)
Seat 2: PTAFYDIUSsG+SArbxNl+Aw (small blind) folded before Flop
Seat 3: yAbu2QsRPVcjPbqlf/jDxw (big blind) folded before Flop
Seat 4: 997ViqAtWn1FPjJqcffwcA folded before Flop (didn't bet)
Seat 5: PkGfq5xrSlNsujKaG/HF4Q folded before Flop (didn't bet)
Seat 6: OvwYHV65yUbgdBjSmo1+5g collected ($2.50)
Seat 7: SyS20PAm3RpT6uLBsGkwOA folded before Flop (didn't bet)
Seat 8: zDOE5r14tWqCf6xhuSHK6g folded before Flop (didn't bet)
Seat 9: qheQay5YvP2DMAb3OUSxtw folded before Flop (didn't bet)



PokerStars Game #59940820806:  Hold'em No Limit ($0.50/$1.00) - 2009/07/01 1:17:33 ET
Table 'vs/5jr6ciwjVQ5+Soc+u2A' 6-max Seat #6 is the button
Seat 1: J798qwLuvXyq0BbzsIjOrA ($94.70 in chips)
Seat 2: lXX4W7m3u++JiSOZ46yVMQ ($100 in chips)
Seat 3: G5ZSSN6RSON3gkNvk/SmYg ($139.60 in chips)
Seat 4: wk6Ohn4GDozoOMHc4eb2rw ($62.30 in chips)
Seat 5: +Nt3OPk3XR9SKjZgm2CexQ ($150.60 in chips)
Seat 6: Z2fXsGcjl+Eax+RzOgwOmg ($100 in chips)
J798qwLuvXyq0BbzsIjOrA: posts small blind $0.50
lXX4W7m3u++JiSOZ46yVMQ: posts big blind $1
*** HOLE CARDS ***
G5ZSSN6RSON3gkNvk/SmYg: folds
wk6Ohn4GDozoOMHc4eb2rw: folds
+Nt3OPk3XR9SKjZgm2CexQ: folds
Z2fXsGcjl+Eax+RzOgwOmg: folds
J798qwLuvXyq0BbzsIjOrA: folds
lXX4W7m3u++JiSOZ46yVMQ collected $1 from pot
*** SUMMARY ***
Total pot $1 | Rake $0
Seat 1: J798qwLuvXyq0BbzsIjOrA (small blind) folded before Flop
Seat 2: lXX4W7m3u++JiSOZ46yVMQ (big blind) collected ($1)
Seat 3: G5ZSSN6RSON3gkNvk/SmYg folded before Flop (didn't bet)
Seat 4: wk6Ohn4GDozoOMHc4eb2rw folded before Flop (didn't bet)
Seat 5: +Nt3OPk3XR9SKjZgm2CexQ folded before Flop (didn't bet)
Seat 6: Z2fXsGcjl+Eax+RzOgwOmg (button) folded before Flop (didn't bet)



PokerStars Game #59940823484:  Hold'em No Limit ($0.50/$1.00) - 2009/07/01 1:17:38 ET
Table 'gxFK0BVUD7cupu2uyRUZJg' 6-max Seat #5 is the button
Seat 1: M+X3uChmP6R63IwijVjgTg ($129.10 in chips)
Seat 2: hpxXcmRkXXI9HE5+5/j/0Q ($120.10 in chips)
Seat 3: Z2fXsGcjl+Eax+RzOgwOmg ($119.75 in chips)
Seat 5: WgIrs6CBinyyw18pqdDtWA ($42.70 in chips)
Seat 6: dYyb6/42PMC8aNFlm/eBeQ ($66.35 in chips)
dYyb6/42PMC8aNFlm/eBeQ: posts small blind $0.50
M+X3uChmP6R63IwijVjgTg: posts big blind $1
*** HOLE CARDS ***
hpxXcmRkXXI9HE5+5/j/0Q: folds
Z2fXsGcjl+Eax+RzOgwOmg: folds
WgIrs6CBinyyw18pqdDtWA: raises $3 to $4
dYyb6/42PMC8aNFlm/eBeQ: folds
M+X3uChmP6R63IwijVjgTg: calls $3
*** FLOP *** [Qc 4d Jh]
M+X3uChmP6R63IwijVjgTg: checks
WgIrs6CBinyyw18pqdDtWA: bets $5
M+X3uChmP6R63IwijVjgTg: calls $5
*** TURN *** [Qc 4d Jh] [Td]
M+X3uChmP6R63IwijVjgTg: checks
WgIrs6CBinyyw18pqdDtWA: checks
*** RIVER *** [Qc 4d Jh Td] [Jc]
M+X3uChmP6R63IwijVjgTg: checks
WgIrs6CBinyyw18pqdDtWA: bets $7
M+X3uChmP6R63IwijVjgTg: calls $7
*** SHOW DOWN ***
WgIrs6CBinyyw18pqdDtWA: shows [2c 5c] (a pair of Jacks)
M+X3uChmP6R63IwijVjgTg: shows [7h 7s] (two pair, Jacks and Sevens)
M+X3uChmP6R63IwijVjgTg collected $30.95 from pot
*** SUMMARY ***
Total pot $32.50 | Rake $1.55
Board [Qc 4d Jh Td Jc]
Seat 1: M+X3uChmP6R63IwijVjgTg (big blind) showed [7h 7s] and won ($30.95) with two pair, Jacks and Sevens
Seat 2: hpxXcmRkXXI9HE5+5/j/0Q folded before Flop (didn't bet)
Seat 3: Z2fXsGcjl+Eax+RzOgwOmg folded before Flop (didn't bet)
Seat 5: WgIrs6CBinyyw18pqdDtWA (button) showed [2c 5c] and lost with a pair of Jacks
Seat 6: dYyb6/42PMC8aNFlm/eBeQ (small blind) folded before Flop



PokerStars Game #59940825120:  Hold'em No Limit ($0.50/$1.00) - 2009/07/01 1:17:40 ET
Table 'fTlPiCj0utgzC/5io+I7ew' 6-max Seat #4 is the button
Seat 1: YMJG+F++3Aj6P8dAWda5fw ($101.35 in chips)
Seat 2: KDYsHh8K2SUXXDvLsAhbJQ ($21.40 in chips)
Seat 3: Z2fXsGcjl+Eax+RzOgwOmg ($102.50 in chips)
Seat 4: uJVSceLggtsrJya+WtmUEA ($173.65 in chips)
Seat 5: XUk5GQsfNFpHvaToDZ0rZA ($50.50 in chips)
Seat 6: y27w5IK2WXqmYzS8OU0wKA ($100 in chips)
XUk5GQsfNFpHvaToDZ0rZA: posts small blind $0.50
y27w5IK2WXqmYzS8OU0wKA: posts big blind $1
*** HOLE CARDS ***
YMJG+F++3Aj6P8dAWda5fw: raises $2 to $3
KDYsHh8K2SUXXDvLsAhbJQ: folds
Z2fXsGcjl+Eax+RzOgwOmg: folds
uJVSceLggtsrJya+WtmUEA: folds
XUk5GQsfNFpHvaToDZ0rZA: calls $2.50
y27w5IK2WXqmYzS8OU0wKA: folds
*** FLOP *** [9h 9c 8h]
XUk5GQsfNFpHvaToDZ0rZA: checks
YMJG+F++3Aj6P8dAWda5fw: checks
*** TURN *** [9h 9c 8h] [6c]
XUk5GQsfNFpHvaToDZ0rZA: checks
YMJG+F++3Aj6P8dAWda5fw: checks
*** RIVER *** [9h 9c 8h 6c] [8d]
XUk5GQsfNFpHvaToDZ0rZA: checks
YMJG+F++3Aj6P8dAWda5fw: checks
*** SHOW DOWN ***
XUk5GQsfNFpHvaToDZ0rZA: shows [As Jc] (two pair, Nines and Eights)
YMJG+F++3Aj6P8dAWda5fw: mucks hand
XUk5GQsfNFpHvaToDZ0rZA collected $6.65 from pot
*** SUMMARY ***
Total pot $7 | Rake $0.35
Board [9h 9c 8h 6c 8d]
Seat 1: YMJG+F++3Aj6P8dAWda5fw mucked
Seat 2: KDYsHh8K2SUXXDvLsAhbJQ folded before Flop (didn't bet)
Seat 3: Z2fXsGcjl+Eax+RzOgwOmg folded before Flop (didn't bet)
Seat 4: uJVSceLggtsrJya+WtmUEA (button) folded before Flop (didn't bet)
Seat 5: XUk5GQsfNFpHvaToDZ0rZA (small blind) showed [As Jc] and won ($6.65) with two pair, Nines and Eights
Seat 6: y27w5IK2WXqmYzS8OU0wKA (big blind) folded before Flop



PokerStars Game #59940826648:  Hold'em No Limit ($0.50/$1.00) - 2009/07/01 1:17:43 ET
Table 'tJq9SfN1ywY0r03VBlWlwQ' 9-max Seat #4 is the button
Seat 1: wZsU+w9r7G66x93UuvBf1Q ($330.80 in chips)
Seat 3: FVs16t7GgfWgQWt4JxsObQ ($9.60 in chips)
Seat 4: bLbSOSmSOnqE0iTcH/5dxA ($109.20 in chips)
Seat 5: h5ipsNTMyolp7xn/NAvWkA ($108.95 in chips)
Seat 6: gUUvmqdVlmvpal6B8nYrmg ($111.20 in chips)
Seat 8: G4DEhsZFmznGNVpy2SEocA ($27.25 in chips)
Seat 9: XE5QF1y74bpHog9JxWJMWQ ($100.20 in chips)
h5ipsNTMyolp7xn/NAvWkA: posts small blind $0.50
gUUvmqdVlmvpal6B8nYrmg: posts big blind $1
Pp/KTcXkfZKKUHkjyaLTdg: sits out
VPF+HjszMvUIpy0CHIwH3A: sits out
*** HOLE CARDS ***
G4DEhsZFmznGNVpy2SEocA: folds
XE5QF1y74bpHog9JxWJMWQ: folds
wZsU+w9r7G66x93UuvBf1Q: folds
FVs16t7GgfWgQWt4JxsObQ: raises $2 to $3
bLbSOSmSOnqE0iTcH/5dxA: folds
h5ipsNTMyolp7xn/NAvWkA: folds
gUUvmqdVlmvpal6B8nYrmg: raises $6.60 to $9.60
FVs16t7GgfWgQWt4JxsObQ: calls $6.60 and is all-in
*** FLOP *** [Ts 3h 7s]
*** TURN *** [Ts 3h 7s] [5h]
*** RIVER *** [Ts 3h 7s 5h] [8h]
*** SHOW DOWN ***
gUUvmqdVlmvpal6B8nYrmg: shows [9d 9h] (a pair of Nines)
FVs16t7GgfWgQWt4JxsObQ: shows [Ac Th] (a pair of Tens)
FVs16t7GgfWgQWt4JxsObQ collected $18.75 from pot
*** SUMMARY ***
Total pot $19.70 | Rake $0.95
Board [Ts 3h 7s 5h 8h]
Seat 1: wZsU+w9r7G66x93UuvBf1Q folded before Flop (didn't bet)
Seat 3: FVs16t7GgfWgQWt4JxsObQ showed [Ac Th] and won ($18.75) with a pair of Tens
Seat 4: bLbSOSmSOnqE0iTcH/5dxA (button) folded before Flop (didn't bet)
Seat 5: h5ipsNTMyolp7xn/NAvWkA (small blind) folded before Flop
Seat 6: gUUvmqdVlmvpal6B8nYrmg (big blind) showed [9d 9h] and lost with a pair of Nines
Seat 8: G4DEhsZFmznGNVpy2SEocA folded before Flop (didn't bet)
Seat 9: XE5QF1y74bpHog9JxWJMWQ folded before Flop (didn't bet)



PokerStars Game #59940827056:  Hold'em No Limit ($0.50/$1.00) - 2009/07/01 1:17:44 ET
Table 'mmbQQVBTrPdE+wy+s+9VPA' 6-max Seat #3 is the button
Seat 1: zyP4SPoWZnKUfTvIRLCVog ($66.75 in chips)
Seat 2: XK4Qsl+DA8gAJyg85/zBIw ($20.95 in chips)
Seat 3: wx3sQGkVi2x9wJXuWNHPBw ($115.25 in chips)
Seat 4: V3iZdcw61nXF3g5hD2RrsQ ($105.40 in chips)
Seat 5: YMJG+F++3Aj6P8dAWda5fw ($110.50 in chips)
Seat 6: U2CWBTv29qdCbj8RNF2sIw ($102.60 in chips)
V3iZdcw61nXF3g5hD2RrsQ: posts small blind $0.50
YMJG+F++3Aj6P8dAWda5fw: posts big blind $1
*** HOLE CARDS ***
U2CWBTv29qdCbj8RNF2sIw: raises $2 to $3
zyP4SPoWZnKUfTvIRLCVog: calls $3
XK4Qsl+DA8gAJyg85/zBIw: calls $3
wx3sQGkVi2x9wJXuWNHPBw: calls $3
V3iZdcw61nXF3g5hD2RrsQ: folds
YMJG+F++3Aj6P8dAWda5fw: calls $2
*** FLOP *** [3d Ks 9h]
YMJG+F++3Aj6P8dAWda5fw: checks
U2CWBTv29qdCbj8RNF2sIw: checks
zyP4SPoWZnKUfTvIRLCVog: checks
XK4Qsl+DA8gAJyg85/zBIw: checks
wx3sQGkVi2x9wJXuWNHPBw: checks
*** TURN *** [3d Ks 9h] [2c]
YMJG+F++3Aj6P8dAWda5fw: checks
U2CWBTv29qdCbj8RNF2sIw: bets $2
zyP4SPoWZnKUfTvIRLCVog: folds
XK4Qsl+DA8gAJyg85/zBIw: folds
wx3sQGkVi2x9wJXuWNHPBw: calls $2
YMJG+F++3Aj6P8dAWda5fw: folds
*** RIVER *** [3d Ks 9h 2c] [8s]
U2CWBTv29qdCbj8RNF2sIw: checks
wx3sQGkVi2x9wJXuWNHPBw: checks
*** SHOW DOWN ***
U2CWBTv29qdCbj8RNF2sIw: shows [7c 7d] (a pair of Sevens)
wx3sQGkVi2x9wJXuWNHPBw: shows [9d 6d] (a pair of Nines)
wx3sQGkVi2x9wJXuWNHPBw collected $18.60 from pot
*** SUMMARY ***
Total pot $19.50 | Rake $0.90
Board [3d Ks 9h 2c 8s]
Seat 1: zyP4SPoWZnKUfTvIRLCVog folded on the Turn
Seat 2: XK4Qsl+DA8gAJyg85/zBIw folded on the Turn
Seat 3: wx3sQGkVi2x9wJXuWNHPBw (button) showed [9d 6d] and won ($18.60) with a pair of Nines
Seat 4: V3iZdcw61nXF3g5hD2RrsQ (small blind) folded before Flop
Seat 5: YMJG+F++3Aj6P8dAWda5fw (big blind) folded on the Turn
Seat 6: U2CWBTv29qdCbj8RNF2sIw showed [7c 7d] and lost with a pair of Sevens



PokerStars Game #59940827758:  Hold'em No Limit ($0.50/$1.00) - 2009/07/01 1:17:45 ET
Table '/RZcOwpZpHQ+OwPwjsbnRw' 6-max Seat #5 is the button
Seat 1: +uSzP8Jwnw7sKfQ4s66b7w ($53.75 in chips)
Seat 2: Z2fXsGcjl+Eax+RzOgwOmg ($100 in chips)
Seat 4: j7NIOHLZk7V2o9fOioO5ug ($143.70 in chips)
Seat 5: wx3sQGkVi2x9wJXuWNHPBw ($166.25 in chips)
Seat 6: o3YLm/rSY916m/on1VjXPA ($100.50 in chips)
o3YLm/rSY916m/on1VjXPA: posts small blind $0.50
+uSzP8Jwnw7sKfQ4s66b7w: posts big blind $1
6hLdALbOlkzGIrc53QKtPw: sits out
*** HOLE CARDS ***
Z2fXsGcjl+Eax+RzOgwOmg: folds
j7NIOHLZk7V2o9fOioO5ug: raises $2 to $3
wx3sQGkVi2x9wJXuWNHPBw: folds
o3YLm/rSY916m/on1VjXPA: folds
+uSzP8Jwnw7sKfQ4s66b7w: folds
j7NIOHLZk7V2o9fOioO5ug collected $2.50 from pot
j7NIOHLZk7V2o9fOioO5ug: doesn't show hand
*** SUMMARY ***
Total pot $2.50 | Rake $0
Seat 1: +uSzP8Jwnw7sKfQ4s66b7w (big blind) folded before Flop
Seat 2: Z2fXsGcjl+Eax+RzOgwOmg folded before Flop (didn't bet)
Seat 4: j7NIOHLZk7V2o9fOioO5ug collected ($2.50)
Seat 5: wx3sQGkVi2x9wJXuWNHPBw (button) folded before Flop (didn't bet)
Seat 6: o3YLm/rSY916m/on1VjXPA (small blind) folded before Flop



PokerStars Game #59940828490:  Hold'em No Limit ($0.50/$1.00) - 2009/07/01 1:17:47 ET
Table 'vs/5jr6ciwjVQ5+Soc+u2A' 6-max Seat #1 is the button
Seat 1: J798qwLuvXyq0BbzsIjOrA ($94.20 in chips)
Seat 2: lXX4W7m3u++JiSOZ46yVMQ ($100.50 in chips)
Seat 3: G5ZSSN6RSON3gkNvk/SmYg ($139.60 in chips)
Seat 4: wk6Ohn4GDozoOMHc4eb2rw ($62.30 in chips)
Seat 5: +Nt3OPk3XR9SKjZgm2CexQ ($150.60 in chips)
Seat 6: Z2fXsGcjl+Eax+RzOgwOmg ($100 in chips)
lXX4W7m3u++JiSOZ46yVMQ: posts small blind $0.50
G5ZSSN6RSON3gkNvk/SmYg: posts big blind $1
*** HOLE CARDS ***
wk6Ohn4GDozoOMHc4eb2rw: folds
+Nt3OPk3XR9SKjZgm2CexQ: folds
Z2fXsGcjl+Eax+RzOgwOmg: raises $3 to $4
J798qwLuvXyq0BbzsIjOrA: folds
lXX4W7m3u++JiSOZ46yVMQ: folds
G5ZSSN6RSON3gkNvk/SmYg: folds
Z2fXsGcjl+Eax+RzOgwOmg collected $2.50 from pot
Z2fXsGcjl+Eax+RzOgwOmg: doesn't show hand
*** SUMMARY ***
Total pot $2.50 | Rake $0
Seat 1: J798qwLuvXyq0BbzsIjOrA (button) folded before Flop (didn't bet)
Seat 2: lXX4W7m3u++JiSOZ46yVMQ (small blind) folded before Flop
Seat 3: G5ZSSN6RSON3gkNvk/SmYg (big blind) folded before Flop
Seat 4: wk6Ohn4GDozoOMHc4eb2rw folded before Flop (didn't bet)
Seat 5: +Nt3OPk3XR9SKjZgm2CexQ folded before Flop (didn't bet)
Seat 6: Z2fXsGcjl+Eax+RzOgwOmg collected ($2.50)



PokerStars Game #59940830026:  Hold'em No Limit ($0.50/$1.00) - 2009/07/01 1:17:49 ET
Table '7Nl0ffnjeK44/vmeexh3MQ' 9-max Seat #8 is the button
Seat 1: V138SURkdX8LdVBPKdJJag ($101.50 in chips)
Seat 2: OGgaARGdJQT4awWVNQ957w ($102 in chips)
Seat 3: JMmUYT5pIKCKh2pGjCB/4w ($56.90 in chips)
Seat 4: bLbSOSmSOnqE0iTcH/5dxA ($100 in chips)
Seat 5: 61sfw5QTu62YYIt68OsdrA ($81.50 in chips)
Seat 6: FVs16t7GgfWgQWt4JxsObQ ($29.25 in chips)
Seat 7: 997ViqAtWn1FPjJqcffwcA ($100 in chips)
Seat 8: D+W9Me7w6Hcx/WRUSKV0dw ($19.25 in chips)
Seat 9: ouwUBGRKnKK9uhn1G4Lf+A ($193 in chips)
ouwUBGRKnKK9uhn1G4Lf+A: posts small blind $0.50
V138SURkdX8LdVBPKdJJag: posts big blind $1
*** HOLE CARDS ***
OGgaARGdJQT4awWVNQ957w: folds
JMmUYT5pIKCKh2pGjCB/4w: folds
bLbSOSmSOnqE0iTcH/5dxA: folds
61sfw5QTu62YYIt68OsdrA: folds
FVs16t7GgfWgQWt4JxsObQ: raises $2 to $3
997ViqAtWn1FPjJqcffwcA: folds
D+W9Me7w6Hcx/WRUSKV0dw: folds
ouwUBGRKnKK9uhn1G4Lf+A: folds
V138SURkdX8LdVBPKdJJag: folds
FVs16t7GgfWgQWt4JxsObQ collected $2.50 from pot
*** SUMMARY ***
Total pot $2.50 | Rake $0
Seat 1: V138SURkdX8LdVBPKdJJag (big blind) folded before Flop
Seat 2: OGgaARGdJQT4awWVNQ957w folded before Flop (didn't bet)
Seat 3: JMmUYT5pIKCKh2pGjCB/4w folded before Flop (didn't bet)
Seat 4: bLbSOSmSOnqE0iTcH/5dxA folded before Flop (didn't bet)
Seat 5: 61sfw5QTu62YYIt68OsdrA folded before Flop (didn't bet)
Seat 6: FVs16t7GgfWgQWt4JxsObQ collected ($2.50)
Seat 7: 997ViqAtWn1FPjJqcffwcA folded before Flop (didn't bet)
Seat 8: D+W9Me7w6Hcx/WRUSKV0dw (button) folded before Flop (didn't bet)
Seat 9: ouwUBGRKnKK9uhn1G4Lf+A (small blind) folded before Flop



PokerStars Game #59940831928:  Hold'em No Limit ($0.50/$1.00) - 2009/07/01 1:17:52 ET
Table 'hugOjcwJvzEwZbK7tyiWuQ' 9-max Seat #1 is the button
Seat 1: S3Ex8K7v6xm5jqjRM7Fl3w ($22 in chips)
Seat 2: r27C1nIV4NS4+qbnrgBQSw ($280.70 in chips)
Seat 3: ZWdwcEAWYlrUhsRi6MOmoA ($21 in chips)
Seat 4: UWB3oeddt/GObx2Mix2Anw ($171.30 in chips)
Seat 5: 5BRGWf+R3nt2WS3b5xX+zA ($26.35 in chips)
Seat 6: gUUvmqdVlmvpal6B8nYrmg ($103 in chips)
Seat 7: FL3MrLspcF23LYvC4ipBOA ($120.30 in chips)
Seat 8: /zy+DB4S5fUQUSfZWFzYGw ($101.05 in chips)
Seat 9: W8P9bUKCs43TO1xHm0dL6w ($87.95 in chips)
r27C1nIV4NS4+qbnrgBQSw: posts small blind $0.50
ZWdwcEAWYlrUhsRi6MOmoA: posts big blind $1
*** HOLE CARDS ***
UWB3oeddt/GObx2Mix2Anw: folds
5BRGWf+R3nt2WS3b5xX+zA: raises $2 to $3
gUUvmqdVlmvpal6B8nYrmg: folds
FL3MrLspcF23LYvC4ipBOA: folds
/zy+DB4S5fUQUSfZWFzYGw: raises $8 to $11
W8P9bUKCs43TO1xHm0dL6w: folds
S3Ex8K7v6xm5jqjRM7Fl3w: folds
r27C1nIV4NS4+qbnrgBQSw: folds
ZWdwcEAWYlrUhsRi6MOmoA: folds
5BRGWf+R3nt2WS3b5xX+zA: calls $8
*** FLOP *** [7d 9d 5s]
5BRGWf+R3nt2WS3b5xX+zA: bets $15.35 and is all-in
/zy+DB4S5fUQUSfZWFzYGw: calls $15.35
*** TURN *** [7d 9d 5s] [Ts]
*** RIVER *** [7d 9d 5s Ts] [6d]
*** SHOW DOWN ***
5BRGWf+R3nt2WS3b5xX+zA: shows [As Kd] (high card Ace)
/zy+DB4S5fUQUSfZWFzYGw: shows [Kc Kh] (a pair of Kings)
/zy+DB4S5fUQUSfZWFzYGw collected $51.55 from pot
*** SUMMARY ***
Total pot $54.20 | Rake $2.65
Board [7d 9d 5s Ts 6d]
Seat 1: S3Ex8K7v6xm5jqjRM7Fl3w (button) folded before Flop (didn't bet)
Seat 2: r27C1nIV4NS4+qbnrgBQSw (small blind) folded before Flop
Seat 3: ZWdwcEAWYlrUhsRi6MOmoA (big blind) folded before Flop
Seat 4: UWB3oeddt/GObx2Mix2Anw folded before Flop (didn't bet)
Seat 5: 5BRGWf+R3nt2WS3b5xX+zA showed [As Kd] and lost with high card Ace
Seat 6: gUUvmqdVlmvpal6B8nYrmg folded before Flop (didn't bet)
Seat 7: FL3MrLspcF23LYvC4ipBOA folded before Flop (didn't bet)
Seat 8: /zy+DB4S5fUQUSfZWFzYGw showed [Kc Kh] and won ($51.55) with a pair of Kings
Seat 9: W8P9bUKCs43TO1xHm0dL6w folded before Flop (didn't bet)



PokerStars Game #59940831496:  Hold'em No Limit ($0.50/$1.00) - 2009/07/01 1:17:52 ET
Table 'rmZfTK+oSebeUPJNbWhdAA' 6-max Seat #2 is the button
Seat 1: xAU6q2/cwmby2sxmA8VcmA ($147 in chips)
Seat 2: z7O9PO/WEcqRouIydFhS9Q ($135.10 in chips)
Seat 3: BCEV3COoKY607AzLWayfRA ($151.80 in chips)
Seat 4: 1/mIuXfgx1ZyVkodrmfQDw ($108.65 in chips)
Seat 5: 5lY8d6Cnm4HUkt/8FZSj4g ($65.25 in chips)
Seat 6: j7NIOHLZk7V2o9fOioO5ug ($146.40 in chips)
BCEV3COoKY607AzLWayfRA: posts small blind $0.50
1/mIuXfgx1ZyVkodrmfQDw: posts big blind $1
*** HOLE CARDS ***
5lY8d6Cnm4HUkt/8FZSj4g: folds
j7NIOHLZk7V2o9fOioO5ug: folds
xAU6q2/cwmby2sxmA8VcmA: folds
z7O9PO/WEcqRouIydFhS9Q: raises $2 to $3
BCEV3COoKY607AzLWayfRA: folds
1/mIuXfgx1ZyVkodrmfQDw: folds
z7O9PO/WEcqRouIydFhS9Q collected $2.50 from pot
z7O9PO/WEcqRouIydFhS9Q: doesn't show hand
*** SUMMARY ***
Total pot $2.50 | Rake $0
Seat 1: xAU6q2/cwmby2sxmA8VcmA folded before Flop (didn't bet)
Seat 2: z7O9PO/WEcqRouIydFhS9Q (button) collected ($2.50)
Seat 3: BCEV3COoKY607AzLWayfRA (small blind) folded before Flop
Seat 4: 1/mIuXfgx1ZyVkodrmfQDw (big blind) folded before Flop
Seat 5: 5lY8d6Cnm4HUkt/8FZSj4g folded before Flop (didn't bet)
Seat 6: j7NIOHLZk7V2o9fOioO5ug folded before Flop (didn't bet)



PokerStars Game #59940831656:  Hold'em No Limit ($0.50/$1.00) - 2009/07/01 1:17:52 ET
Table 'MUPc8FEpe/nR0BKSeReX6Q' 6-max Seat #1 is the button
Seat 1: qhkK6+yCciTRd+rCFEbnEQ ($42.10 in chips)
Seat 2: xAU6q2/cwmby2sxmA8VcmA ($113.70 in chips)
Seat 3: wx3sQGkVi2x9wJXuWNHPBw ($226 in chips)
Seat 4: ZA1bp6g8IwtTxkUE4eCjDQ ($195.20 in chips)
Seat 5: y27w5IK2WXqmYzS8OU0wKA ($100 in chips)
Seat 6: oxnw0GLLpFanjhGkxfRSqA ($48.55 in chips)
xAU6q2/cwmby2sxmA8VcmA: posts small blind $0.50
wx3sQGkVi2x9wJXuWNHPBw: posts big blind $1
*** HOLE CARDS ***
ZA1bp6g8IwtTxkUE4eCjDQ: folds
y27w5IK2WXqmYzS8OU0wKA: raises $2 to $3
oxnw0GLLpFanjhGkxfRSqA: folds
qhkK6+yCciTRd+rCFEbnEQ: folds
xAU6q2/cwmby2sxmA8VcmA: folds
wx3sQGkVi2x9wJXuWNHPBw: folds
y27w5IK2WXqmYzS8OU0wKA collected $2.50 from pot
y27w5IK2WXqmYzS8OU0wKA: doesn't show hand
*** SUMMARY ***
Total pot $2.50 | Rake $0
Seat 1: qhkK6+yCciTRd+rCFEbnEQ (button) folded before Flop (didn't bet)
Seat 2: xAU6q2/cwmby2sxmA8VcmA (small blind) folded before Flop
Seat 3: wx3sQGkVi2x9wJXuWNHPBw (big blind) folded before Flop
Seat 4: ZA1bp6g8IwtTxkUE4eCjDQ folded before Flop (didn't bet)
Seat 5: y27w5IK2WXqmYzS8OU0wKA collected ($2.50)
Seat 6: oxnw0GLLpFanjhGkxfRSqA folded before Flop (didn't bet)



PokerStars Game #59940832980:  Hold'em No Limit ($0.50/$1.00) - 2009/07/01 1:17:54 ET
Table 'MNvFfRVQNka/oY+Z5aMbZQ' 2-max Seat #2 is the button
Seat 1: DaZnoWHjO897dnh0CL2lVg ($61 in chips)
Seat 2: mgi+mjKb1Sc3CCs7TlfoCw ($37.85 in chips)
mgi+mjKb1Sc3CCs7TlfoCw: posts small blind $0.50
DaZnoWHjO897dnh0CL2lVg: posts big blind $1
*** HOLE CARDS ***
mgi+mjKb1Sc3CCs7TlfoCw: raises $2 to $3
DaZnoWHjO897dnh0CL2lVg: calls $2
*** FLOP *** [Qd 3s 4c]
DaZnoWHjO897dnh0CL2lVg: checks
mgi+mjKb1Sc3CCs7TlfoCw: bets $6
DaZnoWHjO897dnh0CL2lVg: folds
mgi+mjKb1Sc3CCs7TlfoCw collected $5.70 from pot
mgi+mjKb1Sc3CCs7TlfoCw: doesn't show hand
*** SUMMARY ***
Total pot $6 | Rake $0.30
Board [Qd 3s 4c]
Seat 1: DaZnoWHjO897dnh0CL2lVg (big blind) folded on the Flop
Seat 2: mgi+mjKb1Sc3CCs7TlfoCw (button) (small blind) collected ($5.70)



PokerStars Game #59940833576:  Hold'em No Limit ($0.50/$1.00) - 2009/07/01 1:17:55 ET
Table 'GPp0HyAuggN8oE0sUWzPpA' 9-max Seat #7 is the button
Seat 1: qJr25HAtvv1w/7IBvjMM3g ($46.25 in chips)
Seat 2: m3U8I35Pn3gxKhoS2nmYIg ($13.40 in chips)
Seat 3: CCCXsirC+bO7ginAuUUVlQ ($56.25 in chips)
Seat 4: mBRWbnUl8diyBO1qTJaNzw ($101.65 in chips)
Seat 5: bLbSOSmSOnqE0iTcH/5dxA ($100 in chips)
Seat 6: BK/GtNPkSx0TdUDj82id5A ($34.20 in chips)
Seat 7: DHdbHyysD15wCAtx+BhUjA ($96.70 in chips)
Seat 8: P/6qLjycEfxRgZ5F/W90dw ($97 in chips)
Seat 9: dzoSjPZmtjGuK83119030A ($34.15 in chips)
P/6qLjycEfxRgZ5F/W90dw: posts small blind $0.50
dzoSjPZmtjGuK83119030A: posts big blind $1
*** HOLE CARDS ***
qJr25HAtvv1w/7IBvjMM3g: folds
m3U8I35Pn3gxKhoS2nmYIg: folds
CCCXsirC+bO7ginAuUUVlQ: calls $1
mBRWbnUl8diyBO1qTJaNzw: folds
bLbSOSmSOnqE0iTcH/5dxA: folds
BK/GtNPkSx0TdUDj82id5A: calls $1
DHdbHyysD15wCAtx+BhUjA: folds
P/6qLjycEfxRgZ5F/W90dw: calls $0.50
dzoSjPZmtjGuK83119030A: raises $3 to $4
CCCXsirC+bO7ginAuUUVlQ: calls $3
BK/GtNPkSx0TdUDj82id5A: folds
P/6qLjycEfxRgZ5F/W90dw: folds
*** FLOP *** [5c 6c 4d]
dzoSjPZmtjGuK83119030A: bets $4
CCCXsirC+bO7ginAuUUVlQ: folds
dzoSjPZmtjGuK83119030A collected $9.50 from pot
*** SUMMARY ***
Total pot $10 | Rake $0.50
Board [5c 6c 4d]
Seat 1: qJr25HAtvv1w/7IBvjMM3g folded before Flop (didn't bet)
Seat 2: m3U8I35Pn3gxKhoS2nmYIg folded before Flop (didn't bet)
Seat 3: CCCXsirC+bO7ginAuUUVlQ folded on the Flop
Seat 4: mBRWbnUl8diyBO1qTJaNzw folded before Flop (didn't bet)
Seat 5: bLbSOSmSOnqE0iTcH/5dxA folded before Flop (didn't bet)
Seat 6: BK/GtNPkSx0TdUDj82id5A folded before Flop
Seat 7: DHdbHyysD15wCAtx+BhUjA (button) folded before Flop (didn't bet)
Seat 8: P/6qLjycEfxRgZ5F/W90dw (small blind) folded before Flop
Seat 9: dzoSjPZmtjGuK83119030A (big blind) collected ($9.50)



PokerStars Game #59940836522:  Hold'em No Limit ($0.50/$1.00) - 2009/07/01 1:18:01 ET
Table 'pHrhryH8jPNdQfY62f8v+g' 6-max Seat #4 is the button
Seat 1: 4d1rWhpu8DzLmzMbR3QKyA ($114.40 in chips)
Seat 2: JwCcjZl0bjJzG7hmE0dnTA ($100 in chips)
Seat 3: 8oS5O7iD/qnFXFXJrGIgNQ ($100 in chips)
Seat 4: 1f3beyIML24UqEMTbWy93g ($41.65 in chips)
Seat 5: r1/R7y0Ortgoz4lccgW8VA ($47.75 in chips)
Seat 6: xAU6q2/cwmby2sxmA8VcmA ($206.60 in chips)
r1/R7y0Ortgoz4lccgW8VA: posts small blind $0.50
xAU6q2/cwmby2sxmA8VcmA: posts big blind $1
*** HOLE CARDS ***
4d1rWhpu8DzLmzMbR3QKyA: folds
JwCcjZl0bjJzG7hmE0dnTA: folds
8oS5O7iD/qnFXFXJrGIgNQ: folds
1f3beyIML24UqEMTbWy93g: folds
r1/R7y0Ortgoz4lccgW8VA: raises $2 to $3
xAU6q2/cwmby2sxmA8VcmA: folds
r1/R7y0Ortgoz4lccgW8VA collected $2 from pot
*** SUMMARY ***
Total pot $2 | Rake $0
Seat 1: 4d1rWhpu8DzLmzMbR3QKyA folded before Flop (didn't bet)
Seat 2: JwCcjZl0bjJzG7hmE0dnTA folded before Flop (didn't bet)
Seat 3: 8oS5O7iD/qnFXFXJrGIgNQ folded before Flop (didn't bet)
Seat 4: 1f3beyIML24UqEMTbWy93g (button) folded before Flop (didn't bet)
Seat 5: r1/R7y0Ortgoz4lccgW8VA (small blind) collected ($2)
Seat 6: xAU6q2/cwmby2sxmA8VcmA (big blind) folded before Flop



PokerStars Game #59940836594:  Hold'em No Limit ($0.50/$1.00) - 2009/07/01 1:18:01 ET
Table '+cA8mcmhaedZ7YcrDdhmeQ' 6-max Seat #3 is the button
Seat 1: lsLuWlcPA3Rh7kJVLzMh0Q ($274.95 in chips)
Seat 2: 14aYclSc98EYd6TrzN2l3Q ($33 in chips)
Seat 3: DAIgyIWbYvAkL6PbAI27pg ($15.50 in chips)
Seat 4: 4OO5v3AVduL0tePNx8wk5A ($105.55 in chips)
Seat 5: 6hLdALbOlkzGIrc53QKtPw ($20 in chips)
Seat 6: YfsTQsY/fxb+YqbdclTHuw ($16.85 in chips)
4OO5v3AVduL0tePNx8wk5A: posts small blind $0.50
6hLdALbOlkzGIrc53QKtPw: posts big blind $1
14aYclSc98EYd6TrzN2l3Q: posts big blind $1
*** HOLE CARDS ***
YfsTQsY/fxb+YqbdclTHuw: calls $1
lsLuWlcPA3Rh7kJVLzMh0Q: folds
14aYclSc98EYd6TrzN2l3Q: checks
DAIgyIWbYvAkL6PbAI27pg: folds
4OO5v3AVduL0tePNx8wk5A: folds
6hLdALbOlkzGIrc53QKtPw: checks
*** FLOP *** [3h As 9s]
6hLdALbOlkzGIrc53QKtPw: bets $2
YfsTQsY/fxb+YqbdclTHuw: folds
14aYclSc98EYd6TrzN2l3Q: calls $2
*** TURN *** [3h As 9s] [Qs]
6hLdALbOlkzGIrc53QKtPw: bets $5.50
14aYclSc98EYd6TrzN2l3Q: raises $6.50 to $12
6hLdALbOlkzGIrc53QKtPw: raises $5 to $17 and is all-in
14aYclSc98EYd6TrzN2l3Q: calls $5
*** RIVER *** [3h As 9s Qs] [8c]
*** SHOW DOWN ***
6hLdALbOlkzGIrc53QKtPw: shows [Ad 3s] (two pair, Aces and Threes)
14aYclSc98EYd6TrzN2l3Q: mucks hand
6hLdALbOlkzGIrc53QKtPw collected $39.45 from pot
*** SUMMARY ***
Total pot $41.50 | Rake $2.05
Board [3h As 9s Qs 8c]
Seat 1: lsLuWlcPA3Rh7kJVLzMh0Q folded before Flop (didn't bet)
Seat 2: 14aYclSc98EYd6TrzN2l3Q mucked
Seat 3: DAIgyIWbYvAkL6PbAI27pg (button) folded before Flop (didn't bet)
Seat 4: 4OO5v3AVduL0tePNx8wk5A (small blind) folded before Flop
Seat 5: 6hLdALbOlkzGIrc53QKtPw (big blind) showed [Ad 3s] and won ($39.45) with two pair, Aces and Threes
Seat 6: YfsTQsY/fxb+YqbdclTHuw folded on the Flop



PokerStars Game #59940837652:  Hold'em No Limit ($0.50/$1.00) - 2009/07/01 1:18:03 ET
Table 'tyUh+jyNvrceIQdKMJjQ2wZFWj23PMihdwrNWv41OG/Qeat #5 is the button
Seat 3: TalCiLYHCd+ffkmR3auPvA ($130.30 in chips)
Seat 4: hpxXcmRkXXI9HE5+5/j/0Q ($100 in chips)
Seat 5: j7NIOHLZk7V2o9fOioO5ug ($111.70 in chips)
Seat 6: 4OO5v3AVduL0tePNx8wk5A ($114 in chips)
4OO5v3AVduL0tePNx8wk5A: posts small blind $0.50
5uy3EN+iIYkgwbWZFTUBAQ: is sitting out
TalCiLYHCd+ffkmR3auPvA: posts big blind $1
*** HOLE CARDS ***
hpxXcmRkXXI9HE5+5/j/0Q: folds
j7NIOHLZk7V2o9fOioO5ug: folds
4OO5v3AVduL0tePNx8wk5A: raises $2 to $3
TalCiLYHCd+ffkmR3auPvA: calls $2
*** FLOP *** [6d 7c 9s]
4OO5v3AVduL0tePNx8wk5A: bets $5
TalCiLYHCd+ffkmR3auPvA: raises $5 to $10
4OO5v3AVduL0tePNx8wk5A: raises $14.50 to $24.50
TalCiLYHCd+ffkmR3auPvA: calls $14.50
*** TURN *** [6d 7c 9s] [Jc]
4OO5v3AVduL0tePNx8wk5A: bets $42.50
TalCiLYHCd+ffkmR3auPvA: raises $42.50 to $85
4OO5v3AVduL0tePNx8wk5A: raises $1.50 to $86.50 and is all-in
TalCiLYHCd+ffkmR3auPvA: calls $1.50
*** RIVER *** [6d 7c 9s Jc] [Kd]
*** SHOW DOWN ***
4OO5v3AVduL0tePNx8wk5A: shows [Qs Qh] (a pair of Queens)
TalCiLYHCd+ffkmR3auPvA: shows [Jd 7h] (two pair, Jacks and Sevens)
TalCiLYHCd+ffkmR3auPvA collected $226 from pot
*** SUMMARY ***
Total pot $228 | Rake $2
Board [6d 7c 9s Jc Kd]
Seat 3: TalCiLYHCd+ffkmR3auPvA (big blind) showed [Jd 7h] and won ($226) with two pair, Jacks and Sevens
Seat 4: hpxXcmRkXXI9HE5+5/j/0Q folded before Flop (didn't bet)
Seat 5: j7NIOHLZk7V2o9fOioO5ug (button) folded before Flop (didn't bet)
Seat 6: 4OO5v3AVduL0tePNx8wk5A (small blind) showed [Qs Qh] and lost with a pair of Queens



PokerStars Game #59940839274:  Hold'em No Limit ($0.50/$1.00) - 2009/07/01 1:18:05 ET
Table 'QSIig7BLMc9wY/rgBechzw' 6-max Seat #4 is the button
Seat 1: Z2fXsGcjl+Eax+RzOgwOmg ($112 in chips)
Seat 2: mLOIkH/qmRa+mVujQIhBRg ($37.30 in chips)
Seat 3: +xW7QemQU0Fxs+4TnqBRow ($106.40 in chips)
Seat 4: +uSzP8Jwnw7sKfQ4s66b7w ($70.95 in chips)
Seat 5: lsLuWlcPA3Rh7kJVLzMh0Q ($105.95 in chips)
Seat 6: PxqfkAMdAWtkgbT+q2gciA ($36.65 in chips)
lsLuWlcPA3Rh7kJVLzMh0Q: posts small blind $0.50
PxqfkAMdAWtkgbT+q2gciA: posts big blind $1
*** HOLE CARDS ***
Z2fXsGcjl+Eax+RzOgwOmg: folds
mLOIkH/qmRa+mVujQIhBRg: folds
+xW7QemQU0Fxs+4TnqBRow: folds
+uSzP8Jwnw7sKfQ4s66b7w: folds
lsLuWlcPA3Rh7kJVLzMh0Q: folds
PxqfkAMdAWtkgbT+q2gciA collected $1 from pot
*** SUMMARY ***
Total pot $1 | Rake $0
Seat 1: Z2fXsGcjl+Eax+RzOgwOmg folded before Flop (didn't bet)
Seat 2: mLOIkH/qmRa+mVujQIhBRg folded before Flop (didn't bet)
Seat 3: +xW7QemQU0Fxs+4TnqBRow folded before Flop (didn't bet)
Seat 4: +uSzP8Jwnw7sKfQ4s66b7w (button) folded before Flop (didn't bet)
Seat 5: lsLuWlcPA3Rh7kJVLzMh0Q (small blind) folded before Flop
Seat 6: PxqfkAMdAWtkgbT+q2gciA (big blind) collected ($1)



PokerStars Game #59940840748:  Hold'em No Limit ($0.50/$1.00) - 2009/07/01 1:18:08 ET
Table 'vs/5jr6ciwjVQ5+Soc+u2A' 6-max Seat #2 is the button
Seat 1: J798qwLuvXyq0BbzsIjOrA ($94.20 in chips)
Seat 2: lXX4W7m3u++JiSOZ46yVMQ ($100 in chips)
Seat 3: G5ZSSN6RSON3gkNvk/SmYg ($138.60 in chips)
Seat 4: wk6Ohn4GDozoOMHc4eb2rw ($62.30 in chips)
Seat 5: +Nt3OPk3XR9SKjZgm2CexQ ($150.60 in chips)
Seat 6: Z2fXsGcjl+Eax+RzOgwOmg ($101.50 in chips)
G5ZSSN6RSON3gkNvk/SmYg: posts small blind $0.50
wk6Ohn4GDozoOMHc4eb2rw: posts big blind $1
*** HOLE CARDS ***
+Nt3OPk3XR9SKjZgm2CexQ: folds
Z2fXsGcjl+Eax+RzOgwOmg: folds
J798qwLuvXyq0BbzsIjOrA: folds
lXX4W7m3u++JiSOZ46yVMQ: raises $2 to $3
G5ZSSN6RSON3gkNvk/SmYg: folds
wk6Ohn4GDozoOMHc4eb2rw: folds
lXX4W7m3u++JiSOZ46yVMQ collected $2.50 from pot
*** SUMMARY ***
Total pot $2.50 | Rake $0
Seat 1: J798qwLuvXyq0BbzsIjOrA folded before Flop (didn't bet)
Seat 2: lXX4W7m3u++JiSOZ46yVMQ (button) collected ($2.50)
Seat 3: G5ZSSN6RSON3gkNvk/SmYg (small blind) folded before Flop
Seat 4: wk6Ohn4GDozoOMHc4eb2rw (big blind) folded before Flop
Seat 5: +Nt3OPk3XR9SKjZgm2CexQ folded before Flop (didn't bet)
Seat 6: Z2fXsGcjl+Eax+RzOgwOmg folded before Flop (didn't bet)



PokerStars Game #59940840776:  Hold'em No Limit ($0.50/$1.00) - 2009/07/01 1:18:08 ET
Table '/RZcOwpZpHQ+OwPwjsbnRw' 6-max Seat #6 is the button
Seat 1: +uSzP8Jwnw7sKfQ4s66b7w ($52.75 in chips)
Seat 2: Z2fXsGcjl+Eax+RzOgwOmg ($100 in chips)
Seat 4: j7NIOHLZk7V2o9fOioO5ug ($145.20 in chips)
Seat 5: wx3sQGkVi2x9wJXuWNHPBw ($166.25 in chips)
Seat 6: o3YLm/rSY916m/on1VjXPA ($100 in chips)
+uSzP8Jwnw7sKfQ4s66b7w: posts small blind $0.50
Z2fXsGcjl+Eax+RzOgwOmg: posts big blind $1
6hLdALbOlkzGIrc53QKtPw: sits out
*** HOLE CARDS ***
j7NIOHLZk7V2o9fOioO5ug: folds
wx3sQGkVi2x9wJXuWNHPBw: folds
o3YLm/rSY916m/on1VjXPA: folds
+uSzP8Jwnw7sKfQ4s66b7w: folds
Z2fXsGcjl+Eax+RzOgwOmg collected $1 from pot
Z2fXsGcjl+Eax+RzOgwOmg: doesn't show hand
*** SUMMARY ***
Total pot $1 | Rake $0
Seat 1: +uSzP8Jwnw7sKfQ4s66b7w (small blind) folded before Flop
Seat 2: Z2fXsGcjl+Eax+RzOgwOmg (big blind) collected ($1)
Seat 4: j7NIOHLZk7V2o9fOioO5ug folded before Flop (didn't bet)
Seat 5: wx3sQGkVi2x9wJXuWNHPBw folded before Flop (didn't bet)
Seat 6: o3YLm/rSY916m/on1VjXPA (button) folded before Flop (didn't bet)



PokerStars Game #59940842224:  Hold'em No Limit ($0.50/$1.00) - 2009/07/01 1:18:11 ET
Table 'O96CPOtvMBWP6kzuYDfdFA' 6-max Seat #3 is the button
Seat 1: 6alLXQIITA2EZ/lBeym8Dw ($122.25 in chips)
Seat 2: 4d1rWhpu8DzLmzMbR3QKyA ($109.85 in chips)
Seat 3: V89DGjxE171oPREEbAXiyg ($91.45 in chips)
Seat 4: /P4w1pHg2zHYg/4ubJ0dPw ($60 in chips)
Seat 5: G5ZSSN6RSON3gkNvk/SmYg ($100 in chips)
Seat 6: GYei5jXGWexiJYbAT2fELg ($37.15 in chips)
/P4w1pHg2zHYg/4ubJ0dPw: posts small blind $0.50
G5ZSSN6RSON3gkNvk/SmYg: posts big blind $1
*** HOLE CARDS ***
GYei5jXGWexiJYbAT2fELg: folds
6alLXQIITA2EZ/lBeym8Dw: raises $2 to $3
4d1rWhpu8DzLmzMbR3QKyA: folds
V89DGjxE171oPREEbAXiyg: folds
/P4w1pHg2zHYg/4ubJ0dPw: folds
G5ZSSN6RSON3gkNvk/SmYg: folds
6alLXQIITA2EZ/lBeym8Dw collected $2.50 from pot
*** SUMMARY ***
Total pot $2.50 | Rake $0
Seat 1: 6alLXQIITA2EZ/lBeym8Dw collected ($2.50)
Seat 2: 4d1rWhpu8DzLmzMbR3QKyA folded before Flop (didn't bet)
Seat 3: V89DGjxE171oPREEbAXiyg (button) folded before Flop (didn't bet)
Seat 4: /P4w1pHg2zHYg/4ubJ0dPw (small blind) folded before Flop
Seat 5: G5ZSSN6RSON3gkNvk/SmYg (big blind) folded before Flop
Seat 6: GYei5jXGWexiJYbAT2fELg folded before Flop (didn't bet)



PokerStars Game #59940842456:  Hold'em No Limit ($0.50/$1.00) - 2009/07/01 1:18:11 ET
Table 'MNvFfRVQNka/oY+Z5aMbZQ' 2-max Seat #1 is the button
Seat 1: DaZnoWHjO897dnh0CL2lVg ($58 in chips)
Seat 2: mgi+mjKb1Sc3CCs7TlfoCw ($66.55 in chips)
DaZnoWHjO897dnh0CL2lVg: posts small blind $0.50
mgi+mjKb1Sc3CCs7TlfoCw: posts big blind $1
*** HOLE CARDS ***
DaZnoWHjO897dnh0CL2lVg: calls $0.50
mgi+mjKb1Sc3CCs7TlfoCw: checks
*** FLOP *** [Js 6c 8s]
mgi+mjKb1Sc3CCs7TlfoCw: checks
DaZnoWHjO897dnh0CL2lVg: bets $2
mgi+mjKb1Sc3CCs7TlfoCw: folds
DaZnoWHjO897dnh0CL2lVg collected $1.90 from pot
DaZnoWHjO897dnh0CL2lVg: doesn't show hand
*** SUMMARY ***
Total pot $2 | Rake $0.10
Board [Js 6c 8s]
Seat 1: DaZnoWHjO897dnh0CL2lVg (button) (small blind) collected ($1.90)
Seat 2: mgi+mjKb1Sc3CCs7TlfoCw (big blind) folded on the Flop



PokerStars Game #59940843358:  Hold'em No Limit ($0.50/$1.00) - 2009/07/01 1:18:13 ET
Table 'rmZfTK+oSebeUPJNbWhdAA' 6-max Seat #3 is the button
Seat 1: xAU6q2/cwmby2sxmA8VcmA ($147 in chips)
Seat 2: z7O9PO/WEcqRouIydFhS9Q ($136.60 in chips)
Seat 3: BCEV3COoKY607AzLWayfRA ($151.30 in chips)
Seat 4: 1/mIuXfgx1ZyVkodrmfQDw ($107.65 in chips)
Seat 5: 5lY8d6Cnm4HUkt/8FZSj4g ($65.25 in chips)
Seat 6: j7NIOHLZk7V2o9fOioO5ug ($146.40 in chips)
1/mIuXfgx1ZyVkodrmfQDw: posts small blind $0.50
5lY8d6Cnm4HUkt/8FZSj4g: posts big blind $1
*** HOLE CARDS ***
j7NIOHLZk7V2o9fOioO5ug: folds
xAU6q2/cwmby2sxmA8VcmA: folds
z7O9PO/WEcqRouIydFhS9Q: raises $2 to $3
BCEV3COoKY607AzLWayfRA: folds
1/mIuXfgx1ZyVkodrmfQDw: folds
5lY8d6Cnm4HUkt/8FZSj4g: calls $2
*** FLOP *** [3s 8d 4d]
5lY8d6Cnm4HUkt/8FZSj4g: bets $3
z7O9PO/WEcqRouIydFhS9Q: calls $3
*** TURN *** [3s 8d 4d] [Ah]
5lY8d6Cnm4HUkt/8FZSj4g: bets $6
z7O9PO/WEcqRouIydFhS9Q: calls $6
*** RIVER *** [3s 8d 4d Ah] [Tc]
5lY8d6Cnm4HUkt/8FZSj4g: checks
z7O9PO/WEcqRouIydFhS9Q: bets $10
5lY8d6Cnm4HUkt/8FZSj4g: folds
z7O9PO/WEcqRouIydFhS9Q collected $23.35 from pot
*** SUMMARY ***
Total pot $24.50 | Rake $1.15
Board [3s 8d 4d Ah Tc]
Seat 1: xAU6q2/cwmby2sxmA8VcmA folded before Flop (didn't bet)
Seat 2: z7O9PO/WEcqRouIydFhS9Q collected ($23.35)
Seat 3: BCEV3COoKY607AzLWayfRA (button) folded before Flop (didn't bet)
Seat 4: 1/mIuXfgx1ZyVkodrmfQDw (small blind) folded before Flop
Seat 5: 5lY8d6Cnm4HUkt/8FZSj4g (big blind) folded on the River
Seat 6: j7NIOHLZk7V2o9fOioO5ug folded before Flop (didn't bet)



PokerStars Game #59940843800:  Hold'em No Limit ($0.50/$1.00) - 2009/07/01 1:18:13 ET
Table '8jIjWCPY0NGprquL+xcMFg' 9-max Seat #9 is the button
Seat 1: tU883G5KFwdH+p2tFuGYtw ($50 in chips)
Seat 2: 7VpIzVwja9q3vCCNM7gRrg ($41 in chips)
Seat 4: XLnHQ8GEI3bUQAfNjJuO5Q ($69.85 in chips)
Seat 5: 2YpnxJiexJHyERfbqgwEcw ($47.55 in chips)
Seat 6: GTQkFJtSkbVbnGCktp6e3g ($101.50 in chips)
Seat 7: O5Go3jrzbQWxRB6ESK+Ptg ($46 in chips)
Seat 8: eI48VADSCFoNZBx4T9qs2w ($18.95 in chips)
Seat 9: DDzMn3tzCgfGf298Xxt5Iw ($29 in chips)
tU883G5KFwdH+p2tFuGYtw: posts small blind $0.50
7VpIzVwja9q3vCCNM7gRrg: posts big blind $1
myIxN7otsyr846M539YR8Q: sits out
*** HOLE CARDS ***
XLnHQ8GEI3bUQAfNjJuO5Q: calls $1
2YpnxJiexJHyERfbqgwEcw: folds
GTQkFJtSkbVbnGCktp6e3g: folds
O5Go3jrzbQWxRB6ESK+Ptg: folds
eI48VADSCFoNZBx4T9qs2w: calls $1
DDzMn3tzCgfGf298Xxt5Iw: raises $6 to $7
tU883G5KFwdH+p2tFuGYtw: folds
7VpIzVwja9q3vCCNM7gRrg: calls $6
XLnHQ8GEI3bUQAfNjJuO5Q: folds
eI48VADSCFoNZBx4T9qs2w: folds
*** FLOP *** [2h 3s 3c]
7VpIzVwja9q3vCCNM7gRrg: checks
DDzMn3tzCgfGf298Xxt5Iw: bets $6
7VpIzVwja9q3vCCNM7gRrg: calls $6
*** TURN *** [2h 3s 3c] [8s]
7VpIzVwja9q3vCCNM7gRrg: bets $28 and is all-in
DDzMn3tzCgfGf298Xxt5Iw: folds
7VpIzVwja9q3vCCNM7gRrg collected $27.15 from pot
*** SUMMARY ***
Total pot $28.50 | Rake $1.35
Board [2h 3s 3c 8s]
Seat 1: tU883G5KFwdH+p2tFuGYtw (small blind) folded before Flop
Seat 2: 7VpIzVwja9q3vCCNM7gRrg (big blind) collected ($27.15)
Seat 4: XLnHQ8GEI3bUQAfNjJuO5Q folded before Flop
Seat 5: 2YpnxJiexJHyERfbqgwEcw folded before Flop (didn't bet)
Seat 6: GTQkFJtSkbVbnGCktp6e3g folded before Flop (didn't bet)
Seat 7: O5Go3jrzbQWxRB6ESK+Ptg folded before Flop (didn't bet)
Seat 8: eI48VADSCFoNZBx4T9qs2w folded before Flop
Seat 9: DDzMn3tzCgfGf298Xxt5Iw (button) folded on the Turn



PokerStars Game #59940845076:  Hold'em No Limit ($0.50/$1.00) - 2009/07/01 1:18:16 ET
Table '6YvsYDPNIDx2v5z3bJnwZQ' 9-max Seat #2 is the button
Seat 1: Ogn4JDV3mp4ZDKO49IFzKA ($19.70 in chips)
Seat 2: +hHqYgKILitkxIzFNGvvsA ($18.75 in chips)
Seat 3: K6OJDis3KfxSm/PKlkATUA ($49 in chips)
Seat 4: kEr5NYB+JIG5+szcYMr6hA ($46.95 in chips)
Seat 5: mBRWbnUl8diyBO1qTJaNzw ($131.90 in chips)
Seat 6: 7RSwrjMohkYrZAhOd1uaZg ($11.90 in chips)
Seat 7: mae7OMTaJ/MFimNbZegCkg ($41.80 in chips)
Seat 8: PSFxpXgPedVZyHSu2Zhb7Q ($129.05 in chips)
Seat 9: yZYrOeNDxQxkzpbgKX1bng ($63.60 in chips)
K6OJDis3KfxSm/PKlkATUA: posts small blind $0.50
kEr5NYB+JIG5+szcYMr6hA: posts big blind $1
*** HOLE CARDS ***
mBRWbnUl8diyBO1qTJaNzw: folds
7RSwrjMohkYrZAhOd1uaZg: folds
mae7OMTaJ/MFimNbZegCkg: raises $2 to $3
PSFxpXgPedVZyHSu2Zhb7Q: folds
yZYrOeNDxQxkzpbgKX1bng: folds
Ogn4JDV3mp4ZDKO49IFzKA: folds
+hHqYgKILitkxIzFNGvvsA: folds
K6OJDis3KfxSm/PKlkATUA: folds
kEr5NYB+JIG5+szcYMr6hA: folds
mae7OMTaJ/MFimNbZegCkg collected $2.50 from pot
*** SUMMARY ***
Total pot $2.50 | Rake $0
Seat 1: Ogn4JDV3mp4ZDKO49IFzKA folded before Flop (didn't bet)
Seat 2: +hHqYgKILitkxIzFNGvvsA (button) folded before Flop (didn't bet)
Seat 3: K6OJDis3KfxSm/PKlkATUA (small blind) folded before Flop
Seat 4: kEr5NYB+JIG5+szcYMr6hA (big blind) folded before Flop
Seat 5: mBRWbnUl8diyBO1qTJaNzw folded before Flop (didn't bet)
Seat 6: 7RSwrjMohkYrZAhOd1uaZg folded before Flop (didn't bet)
Seat 7: mae7OMTaJ/MFimNbZegCkg collected ($2.50)
Seat 8: PSFxpXgPedVZyHSu2Zhb7Q folded before Flop (didn't bet)
Seat 9: yZYrOeNDxQxkzpbgKX1bng folded before Flop (didn't bet)



PokerStars Game #59940846028:  Hold'em No Limit ($0.50/$1.00) - 2009/07/01 1:18:17 ET
Table '7O9fB8yx1u7sJveJn8w6jA' 6-max Seat #4 is the button
Seat 1: jy52+7FotjH63o5tEEVgKw ($56.85 in chips)
Seat 2: wx3sQGkVi2x9wJXuWNHPBw ($201.20 in chips)
Seat 3: hpxXcmRkXXI9HE5+5/j/0Q ($124.25 in chips)
Seat 4: b2a+5TkFf4xJN/Ihhma58Q ($37.80 in chips)
Seat 5: BCEV3COoKY607AzLWayfRA ($100.85 in chips)
Seat 6: p1Ga2i1TuXUvRn+Rf/0FMw ($117.40 in chips)
BCEV3COoKY607AzLWayfRA: posts small blind $0.50
p1Ga2i1TuXUvRn+Rf/0FMw: posts big blind $1
*** HOLE CARDS ***
jy52+7FotjH63o5tEEVgKw: folds
wx3sQGkVi2x9wJXuWNHPBw: folds
hpxXcmRkXXI9HE5+5/j/0Q: folds
b2a+5TkFf4xJN/Ihhma58Q: folds
BCEV3COoKY607AzLWayfRA: folds
p1Ga2i1TuXUvRn+Rf/0FMw collected $1 from pot
*** SUMMARY ***
Total pot $1 | Rake $0
Seat 1: jy52+7FotjH63o5tEEVgKw folded before Flop (didn't bet)
Seat 2: wx3sQGkVi2x9wJXuWNHPBw folded before Flop (didn't bet)
Seat 3: hpxXcmRkXXI9HE5+5/j/0Q folded before Flop (didn't bet)
Seat 4: b2a+5TkFf4xJN/Ihhma58Q (button) folded before Flop (didn't bet)
Seat 5: BCEV3COoKY607AzLWayfRA (small blind) folded before Flop
Seat 6: p1Ga2i1TuXUvRn+Rf/0FMw (big blind) collected ($1)



PokerStars Game #59940846344:  Hold'em No Limit ($0.50/$1.00) - 2009/07/01 1:18:18 ET
Table 'cBDNutyLBKEk9+ptwsKmTw' 6-max Seat #3 is the button
Seat 1: xAU6q2/cwmby2sxmA8VcmA ($259.90 in chips)
Seat 2: 5lY8d6Cnm4HUkt/8FZSj4g ($78.80 in chips)
Seat 3: G5ZSSN6RSON3gkNvk/SmYg ($100 in chips)
Seat 4: 3q7F5QtzC30pSrn0nl9i+A ($21 in chips)
Seat 5: hpxXcmRkXXI9HE5+5/j/0Q ($100 in chips)
3q7F5QtzC30pSrn0nl9i+A: posts small blind $0.50
hpxXcmRkXXI9HE5+5/j/0Q: posts big blind $1
QHvTZcrKe6+maWUfVjP29Q: sits out
*** HOLE CARDS ***
xAU6q2/cwmby2sxmA8VcmA: folds
5lY8d6Cnm4HUkt/8FZSj4g: calls $1
G5ZSSN6RSON3gkNvk/SmYg: folds
3q7F5QtzC30pSrn0nl9i+A: calls $0.50
hpxXcmRkXXI9HE5+5/j/0Q: checks
*** FLOP *** [Kd Qh 5s]
3q7F5QtzC30pSrn0nl9i+A: checks
hpxXcmRkXXI9HE5+5/j/0Q: bets $2
5lY8d6Cnm4HUkt/8FZSj4g: calls $2
3q7F5QtzC30pSrn0nl9i+A: folds
*** TURN *** [Kd Qh 5s] [Jc]
hpxXcmRkXXI9HE5+5/j/0Q: checks
5lY8d6Cnm4HUkt/8FZSj4g: bets $6
hpxXcmRkXXI9HE5+5/j/0Q: folds
5lY8d6Cnm4HUkt/8FZSj4g collected $6.70 from pot
*** SUMMARY ***
Total pot $7 | Rake $0.30
Board [Kd Qh 5s Jc]
Seat 1: xAU6q2/cwmby2sxmA8VcmA folded before Flop (didn't bet)
Seat 2: 5lY8d6Cnm4HUkt/8FZSj4g collected ($6.70)
Seat 3: G5ZSSN6RSON3gkNvk/SmYg (button) folded before Flop (didn't bet)
Seat 4: 3q7F5QtzC30pSrn0nl9i+A (small blind) folded on the Flop
Seat 5: hpxXcmRkXXI9HE5+5/j/0Q (big blind) folded on the Turn



PokerStars Game #59940847030:  Hold'em No Limit ($0.50/$1.00) - 2009/07/01 1:18:19 ET
Table 'kS0cTQAEi+fdUlJP2gQYvw' 9-max Seat #4 is the button
Seat 1: c/9X4zftzphFxYtxp5kp9w ($78.75 in chips)
Seat 2: D+W9Me7w6Hcx/WRUSKV0dw ($26.55 in chips)
Seat 3: 2BV+oJIQYr65IO6nEChvbA ($60 in chips)
Seat 4: RUhhaALzha3TH1AkdakoGQ ($40 in chips)
Seat 5: 997ViqAtWn1FPjJqcffwcA ($103.90 in chips)
Seat 6: yAbu2QsRPVcjPbqlf/jDxw ($126.15 in chips)
Seat 7: Ffa7Nj4X5fddtROP01hfQg ($163.10 in chips)
Seat 8: vKyFzTyzfT7fZcdX+HHN+Q ($19 in chips)
Seat 9: OGgaARGdJQT4awWVNQ957w ($100 in chips)
997ViqAtWn1FPjJqcffwcA: posts small blind $0.50
yAbu2QsRPVcjPbqlf/jDxw: posts big blind $1
*** HOLE CARDS ***
Ffa7Nj4X5fddtROP01hfQg: folds
vKyFzTyzfT7fZcdX+HHN+Q: calls $1
OGgaARGdJQT4awWVNQ957w: folds
c/9X4zftzphFxYtxp5kp9w: folds
D+W9Me7w6Hcx/WRUSKV0dw: folds
2BV+oJIQYr65IO6nEChvbA: folds
RUhhaALzha3TH1AkdakoGQ: folds
997ViqAtWn1FPjJqcffwcA: folds
yAbu2QsRPVcjPbqlf/jDxw: checks
*** FLOP *** [Js 3s 9c]
yAbu2QsRPVcjPbqlf/jDxw: checks
vKyFzTyzfT7fZcdX+HHN+Q: bets $1
yAbu2QsRPVcjPbqlf/jDxw: folds
vKyFzTyzfT7fZcdX+HHN+Q collected $2.40 from pot
*** SUMMARY ***
Total pot $2.50 | Rake $0.10
Board [Js 3s 9c]
Seat 1: c/9X4zftzphFxYtxp5kp9w folded before Flop (didn't bet)
Seat 2: D+W9Me7w6Hcx/WRUSKV0dw folded before Flop (didn't bet)
Seat 3: 2BV+oJIQYr65IO6nEChvbA folded before Flop (didn't bet)
Seat 4: RUhhaALzha3TH1AkdakoGQ (button) folded before Flop (didn't bet)
Seat 5: 997ViqAtWn1FPjJqcffwcA (small blind) folded before Flop
Seat 6: yAbu2QsRPVcjPbqlf/jDxw (big blind) folded on the Flop
Seat 7: Ffa7Nj4X5fddtROP01hfQg folded before Flop (didn't bet)
Seat 8: vKyFzTyzfT7fZcdX+HHN+Q collected ($2.40)
Seat 9: OGgaARGdJQT4awWVNQ957w folded before Flop (didn't bet)



PokerStars Game #59940848436:  Hold'em No Limit ($0.50/$1.00) - 2009/07/01 1:18:22 ET
Table 'pHrhryH8jPNdQfY62f8v+g' 6-max Seat #5 is the button
Seat 1: 4d1rWhpu8DzLmzMbR3QKyA ($114.40 in chips)
Seat 2: JwCcjZl0bjJzG7hmE0dnTA ($100 in chips)
Seat 3: 8oS5O7iD/qnFXFXJrGIgNQ ($100 in chips)
Seat 4: 1f3beyIML24UqEMTbWy93g ($41.65 in chips)
Seat 5: r1/R7y0Ortgoz4lccgW8VA ($48.75 in chips)
Seat 6: xAU6q2/cwmby2sxmA8VcmA ($205.60 in chips)
xAU6q2/cwmby2sxmA8VcmA: posts small blind $0.50
4d1rWhpu8DzLmzMbR3QKyA: posts big blind $1
*** HOLE CARDS ***
JwCcjZl0bjJzG7hmE0dnTA: folds
8oS5O7iD/qnFXFXJrGIgNQ: raises $2.50 to $3.50
1f3beyIML24UqEMTbWy93g: folds
r1/R7y0Ortgoz4lccgW8VA: folds
xAU6q2/cwmby2sxmA8VcmA: folds
4d1rWhpu8DzLmzMbR3QKyA: folds
8oS5O7iD/qnFXFXJrGIgNQ collected $2.50 from pot
*** SUMMARY ***
Total pot $2.50 | Rake $0
Seat 1: 4d1rWhpu8DzLmzMbR3QKyA (big blind) folded before Flop
Seat 2: JwCcjZl0bjJzG7hmE0dnTA folded before Flop (didn't bet)
Seat 3: 8oS5O7iD/qnFXFXJrGIgNQ collected ($2.50)
Seat 4: 1f3beyIML24UqEMTbWy93g folded before Flop (didn't bet)
Seat 5: r1/R7y0Ortgoz4lccgW8VA (button) folded before Flop (didn't bet)
Seat 6: xAU6q2/cwmby2sxmA8VcmA (small blind) folded before Flop



PokerStars Game #59940848840:  Hold'em No Limit ($0.50/$1.00) - 2009/07/01 1:18:22 ET
Table 'QSIig7BLMc9wY/rgBechzw' 6-max Seat #5 is the button
Seat 1: Z2fXsGcjl+Eax+RzOgwOmg ($112 in chips)
Seat 2: mLOIkH/qmRa+mVujQIhBRg ($37.30 in chips)
Seat 3: +xW7QemQU0Fxs+4TnqBRow ($106.40 in chips)
Seat 4: +uSzP8Jwnw7sKfQ4s66b7w ($70.95 in chips)
Seat 5: lsLuWlcPA3Rh7kJVLzMh0Q ($105.45 in chips)
Seat 6: PxqfkAMdAWtkgbT+q2gciA ($37.15 in chips)
PxqfkAMdAWtkgbT+q2gciA: posts small blind $0.50
Z2fXsGcjl+Eax+RzOgwOmg: posts big blind $1
*** HOLE CARDS ***
mLOIkH/qmRa+mVujQIhBRg: folds
+xW7QemQU0Fxs+4TnqBRow: raises $3 to $4
+uSzP8Jwnw7sKfQ4s66b7w: folds
lsLuWlcPA3Rh7kJVLzMh0Q: folds
PxqfkAMdAWtkgbT+q2gciA: folds
Z2fXsGcjl+Eax+RzOgwOmg: folds
+xW7QemQU0Fxs+4TnqBRow collected $2.50 from pot
+xW7QemQU0Fxs+4TnqBRow: doesn't show hand
*** SUMMARY ***
Total pot $2.50 | Rake $0
Seat 1: Z2fXsGcjl+Eax+RzOgwOmg (big blind) folded before Flop
Seat 2: mLOIkH/qmRa+mVujQIhBRg folded before Flop (didn't bet)
Seat 3: +xW7QemQU0Fxs+4TnqBRow collected ($2.50)
Seat 4: +uSzP8Jwnw7sKfQ4s66b7w folded before Flop (didn't bet)
Seat 5: lsLuWlcPA3Rh7kJVLzMh0Q (button) folded before Flop (didn't bet)
Seat 6: PxqfkAMdAWtkgbT+q2gciA (small blind) folded before Flop



PokerStars Game #59940852106:  Hold'em No Limit ($0.50/$1.00) - 2009/07/01 1:18:28 ET
Table 'SQLOQoANiHscJ8AL7zffbw' 9-max Seat #1 is the button
Seat 1: jPTRd6SpCp4xqAy2XQiTOw ($54.90 in chips)
Seat 2: /zy+DB4S5fUQUSfZWFzYGw ($395.55 in chips)
Seat 3: 0eFnow7+D7veCYQ+CG9FFw ($103 in chips)
Seat 4: 5z1PAR8SNow/zUfYNbwq7A ($55.25 in chips)
Seat 5: L9njYvloJ1NdXjP8edHEAg ($100 in chips)
Seat 6: H+DVy3Ei8L1UKS2tVOtJcw ($100 in chips)
Seat 7: bJckevFOcg//s0qyMQI6sQ ($103.05 in chips)
Seat 9: qJr25HAtvv1w/7IBvjMM3g ($198.65 in chips)
/zy+DB4S5fUQUSfZWFzYGw: posts small blind $0.50
0eFnow7+D7veCYQ+CG9FFw: posts big blind $1
9BZCcac3+McErkkSN2YScA: sits out
*** HOLE CARDS ***
5z1PAR8SNow/zUfYNbwq7A: folds
L9njYvloJ1NdXjP8edHEAg: folds
H+DVy3Ei8L1UKS2tVOtJcw: folds
bJckevFOcg//s0qyMQI6sQ: folds
qJr25HAtvv1w/7IBvjMM3g: folds
jPTRd6SpCp4xqAy2XQiTOw: folds
/zy+DB4S5fUQUSfZWFzYGw: folds
0eFnow7+D7veCYQ+CG9FFw collected $1 from pot
*** SUMMARY ***
Total pot $1 | Rake $0
Seat 1: jPTRd6SpCp4xqAy2XQiTOw (button) folded before Flop (didn't bet)
Seat 2: /zy+DB4S5fUQUSfZWFzYGw (small blind) folded before Flop
Seat 3: 0eFnow7+D7veCYQ+CG9FFw (big blind) collected ($1)
Seat 4: 5z1PAR8SNow/zUfYNbwq7A folded before Flop (didn't bet)
Seat 5: L9njYvloJ1NdXjP8edHEAg folded before Flop (didn't bet)
Seat 6: H+DVy3Ei8L1UKS2tVOtJcw folded before Flop (didn't bet)
Seat 7: bJckevFOcg//s0qyMQI6sQ folded before Flop (didn't bet)
Seat 9: qJr25HAtvv1w/7IBvjMM3g folded before Flop (didn't bet)



PokerStars Game #59940852406:  Hold'em No Limit ($0.50/$1.00) - 2009/07/01 1:18:29 ET
Table 'MNvFfRVQNka/oY+Z5aMbZQ' 2-max Seat #2 is the button
Seat 1: DaZnoWHjO897dnh0CL2lVg ($58.90 in chips)
Seat 2: mgi+mjKb1Sc3CCs7TlfoCw ($65.55 in chips)
mgi+mjKb1Sc3CCs7TlfoCw: posts small blind $0.50
DaZnoWHjO897dnh0CL2lVg: posts big blind $1
*** HOLE CARDS ***
mgi+mjKb1Sc3CCs7TlfoCw: raises $2 to $3
DaZnoWHjO897dnh0CL2lVg: folds
mgi+mjKb1Sc3CCs7TlfoCw collected $2 from pot
mgi+mjKb1Sc3CCs7TlfoCw: doesn't show hand
*** SUMMARY ***
Total pot $2 | Rake $0
Seat 1: DaZnoWHjO897dnh0CL2lVg (big blind) folded before Flop
Seat 2: mgi+mjKb1Sc3CCs7TlfoCw (button) (small blind) collected ($2)



PokerStars Game #59940853514:  Hold'em No Limit ($0.50/$1.00) - 2009/07/01 1:18:30 ET
Table 'vs/5jr6ciwjVQ5+Soc+u2A' 6-max Seat #3 is the button
Seat 1: J798qwLuvXyq0BbzsIjOrA ($94.20 in chips)
Seat 2: lXX4W7m3u++JiSOZ46yVMQ ($101.50 in chips)
Seat 3: G5ZSSN6RSON3gkNvk/SmYg ($138.10 in chips)
Seat 4: wk6Ohn4GDozoOMHc4eb2rw ($61.30 in chips)
Seat 5: +Nt3OPk3XR9SKjZgm2CexQ ($150.60 in chips)
Seat 6: Z2fXsGcjl+Eax+RzOgwOmg ($101.50 in chips)
wk6Ohn4GDozoOMHc4eb2rw: posts small blind $0.50
+Nt3OPk3XR9SKjZgm2CexQ: posts big blind $1
*** HOLE CARDS ***
Z2fXsGcjl+Eax+RzOgwOmg: folds
J798qwLuvXyq0BbzsIjOrA: raises $2 to $3
lXX4W7m3u++JiSOZ46yVMQ: calls $3
G5ZSSN6RSON3gkNvk/SmYg: folds
wk6Ohn4GDozoOMHc4eb2rw: folds
+Nt3OPk3XR9SKjZgm2CexQ: folds
*** FLOP *** [Kc 8c 8d]
J798qwLuvXyq0BbzsIjOrA: checks
lXX4W7m3u++JiSOZ46yVMQ: bets $5
J798qwLuvXyq0BbzsIjOrA: folds
lXX4W7m3u++JiSOZ46yVMQ collected $7.15 from pot
*** SUMMARY ***
Total pot $7.50 | Rake $0.35
Board [Kc 8c 8d]
Seat 1: J798qwLuvXyq0BbzsIjOrA folded on the Flop
Seat 2: lXX4W7m3u++JiSOZ46yVMQ collected ($7.15)
Seat 3: G5ZSSN6RSON3gkNvk/SmYg (button) folded before Flop (didn't bet)
Seat 4: wk6Ohn4GDozoOMHc4eb2rw (small blind) folded before Flop
Seat 5: +Nt3OPk3XR9SKjZgm2CexQ (big blind) folded before Flop
Seat 6: Z2fXsGcjl+Eax+RzOgwOmg folded before Flop (didn't bet)



PokerStars Game #59940854344:  Hold'em No Limit ($0.50/$1.00) - 2009/07/01 1:18:32 ET
Table '/RZcOwpZpHQ+OwPwjsbnRw' 6-max Seat #1 is the button
Seat 1: +uSzP8Jwnw7sKfQ4s66b7w ($52.25 in chips)
Seat 2: Z2fXsGcjl+Eax+RzOgwOmg ($100.50 in chips)
Seat 3: 6hLdALbOlkzGIrc53QKtPw ($20 in chips)
Seat 4: j7NIOHLZk7V2o9fOioO5ug ($145.20 in chips)
Seat 5: wx3sQGkVi2x9wJXuWNHPBw ($166.25 in chips)
Seat 6: o3YLm/rSY916m/on1VjXPA ($100 in chips)
Z2fXsGcjl+Eax+RzOgwOmg: posts small blind $0.50
6hLdALbOlkzGIrc53QKtPw: posts big blind $1
*** HOLE CARDS ***
j7NIOHLZk7V2o9fOioO5ug: folds
wx3sQGkVi2x9wJXuWNHPBw: folds
o3YLm/rSY916m/on1VjXPA: folds
+uSzP8Jwnw7sKfQ4s66b7w: folds
Z2fXsGcjl+Eax+RzOgwOmg: raises $2 to $3
6hLdALbOlkzGIrc53QKtPw: folds
Z2fXsGcjl+Eax+RzOgwOmg collected $2 from pot
Z2fXsGcjl+Eax+RzOgwOmg: doesn't show hand
*** SUMMARY ***
Total pot $2 | Rake $0
Seat 1: +uSzP8Jwnw7sKfQ4s66b7w (button) folded before Flop (didn't bet)
Seat 2: Z2fXsGcjl+Eax+RzOgwOmg (small blind) collected ($2)
Seat 3: 6hLdALbOlkzGIrc53QKtPw (big blind) folded before Flop
Seat 4: j7NIOHLZk7V2o9fOioO5ug folded before Flop (didn't bet)
Seat 5: wx3sQGkVi2x9wJXuWNHPBw folded before Flop (didn't bet)
Seat 6: o3YLm/rSY916m/on1VjXPA folded before Flop (didn't bet)



PokerStars Game #59940854736:  Hold'em No Limit ($0.50/$1.00) - 2009/07/01 1:18:32 ET
Table '7Nl0ffnjeK44/vmeexh3MQ' 9-max Seat #9 is the button
Seat 1: V138SURkdX8LdVBPKdJJag ($100.50 in chips)
Seat 2: OGgaARGdJQT4awWVNQ957w ($102 in chips)
Seat 3: JMmUYT5pIKCKh2pGjCB/4w ($56.90 in chips)
Seat 4: bLbSOSmSOnqE0iTcH/5dxA ($100 in chips)
Seat 5: 61sfw5QTu62YYIt68OsdrA ($81.50 in chips)
Seat 6: FVs16t7GgfWgQWt4JxsObQ ($30.75 in chips)
Seat 7: 997ViqAtWn1FPjJqcffwcA ($100 in chips)
Seat 8: D+W9Me7w6Hcx/WRUSKV0dw ($19.25 in chips)
Seat 9: ouwUBGRKnKK9uhn1G4Lf+A ($192.50 in chips)
V138SURkdX8LdVBPKdJJag: posts small blind $0.50
OGgaARGdJQT4awWVNQ957w: posts big blind $1
*** HOLE CARDS ***
JMmUYT5pIKCKh2pGjCB/4w: folds
bLbSOSmSOnqE0iTcH/5dxA: folds
61sfw5QTu62YYIt68OsdrA: folds
FVs16t7GgfWgQWt4JxsObQ: folds
997ViqAtWn1FPjJqcffwcA: folds
D+W9Me7w6Hcx/WRUSKV0dw: folds
ouwUBGRKnKK9uhn1G4Lf+A: raises $1.50 to $2.50
V138SURkdX8LdVBPKdJJag: folds
OGgaARGdJQT4awWVNQ957w: folds
ouwUBGRKnKK9uhn1G4Lf+A collected $2.50 from pot
ouwUBGRKnKK9uhn1G4Lf+A: doesn't show hand
*** SUMMARY ***
Total pot $2.50 | Rake $0
Seat 1: V138SURkdX8LdVBPKdJJag (small blind) folded before Flop
Seat 2: OGgaARGdJQT4awWVNQ957w (big blind) folded before Flop
Seat 3: JMmUYT5pIKCKh2pGjCB/4w folded before Flop (didn't bet)
Seat 4: bLbSOSmSOnqE0iTcH/5dxA folded before Flop (didn't bet)
Seat 5: 61sfw5QTu62YYIt68OsdrA folded before Flop (didn't bet)
Seat 6: FVs16t7GgfWgQWt4JxsObQ folded before Flop (didn't bet)
Seat 7: 997ViqAtWn1FPjJqcffwcA folded before Flop (didn't bet)
Seat 8: D+W9Me7w6Hcx/WRUSKV0dw folded before Flop (didn't bet)
Seat 9: ouwUBGRKnKK9uhn1G4Lf+A (button) collected ($2.50)



PokerStars Game #59940855104:  Hold'em No Limit ($0.50/$1.00) - 2009/07/01 1:18:33 ET
Table 'W/wyObTiXZm+Ckkl3YxcSw' 6-max Seat #3 is the button
Seat 1: eUBBn2R56C1IQ6Cs/vitwg ($300.40 in chips)
Seat 2: oDiBRCaF0QVtd3kO6xZIXw ($152.15 in chips)
Seat 3: dxyNCn/qxfkGDUIf28Cbng ($65.15 in chips)
Seat 5: +OrCjyw70oZhJiD22Mn+bg ($100 in chips)
Seat 6: b2a+5TkFf4xJN/Ihhma58Q ($38 in chips)
+OrCjyw70oZhJiD22Mn+bg: posts small blind $0.50
b2a+5TkFf4xJN/Ihhma58Q: posts big blind $1
*** HOLE CARDS ***
eUBBn2R56C1IQ6Cs/vitwg: folds
oDiBRCaF0QVtd3kO6xZIXw: calls $1
aYii2DmxlOlbC1wbGRBWvQ leaves the table
dxyNCn/qxfkGDUIf28Cbng: raises $2 to $3
+OrCjyw70oZhJiD22Mn+bg: folds
b2a+5TkFf4xJN/Ihhma58Q: folds
oDiBRCaF0QVtd3kO6xZIXw: calls $2
*** FLOP *** [2c 3d 5d]
oDiBRCaF0QVtd3kO6xZIXw: checks
UBZQqpnJZdTYYY1FTb0rLA joins the table at seat #4
dxyNCn/qxfkGDUIf28Cbng: bets $2
oDiBRCaF0QVtd3kO6xZIXw: folds
dxyNCn/qxfkGDUIf28Cbng collected $7.15 from pot
*** SUMMARY ***
Total pot $7.50 | Rake $0.35
Board [2c 3d 5d]
Seat 1: eUBBn2R56C1IQ6Cs/vitwg folded before Flop (didn't bet)
Seat 2: oDiBRCaF0QVtd3kO6xZIXw folded on the Flop
Seat 3: dxyNCn/qxfkGDUIf28Cbng (button) collected ($7.15)
Seat 5: +OrCjyw70oZhJiD22Mn+bg (small blind) folded before Flop
Seat 6: b2a+5TkFf4xJN/Ihhma58Q (big blind) folded before Flop



PokerStars Game #59940855482:  Hold'em No Limit ($0.50/$1.00) - 2009/07/01 1:18:34 ET
Table 'tJq9SfN1ywY0r03VBlWlwQ' 9-max Seat #5 is the button
Seat 1: wZsU+w9r7G66x93UuvBf1Q ($330.80 in chips)
Seat 3: FVs16t7GgfWgQWt4JxsObQ ($18.75 in chips)
Seat 4: bLbSOSmSOnqE0iTcH/5dxA ($109.20 in chips)
Seat 5: h5ipsNTMyolp7xn/NAvWkA ($108.45 in chips)
Seat 6: gUUvmqdVlmvpal6B8nYrmg ($101.60 in chips)
Seat 7: Pp/KTcXkfZKKUHkjyaLTdg ($20 in chips)
Seat 8: G4DEhsZFmznGNVpy2SEocA ($27.25 in chips)
Seat 9: XE5QF1y74bpHog9JxWJMWQ ($100.20 in chips)
gUUvmqdVlmvpal6B8nYrmg: posts small blind $0.50
Pp/KTcXkfZKKUHkjyaLTdg: posts big blind $1
VPF+HjszMvUIpy0CHIwH3A: sits out
*** HOLE CARDS ***
G4DEhsZFmznGNVpy2SEocA: folds
XE5QF1y74bpHog9JxWJMWQ: folds
wZsU+w9r7G66x93UuvBf1Q: folds
FVs16t7GgfWgQWt4JxsObQ: calls $1
bLbSOSmSOnqE0iTcH/5dxA: folds
h5ipsNTMyolp7xn/NAvWkA: folds
gUUvmqdVlmvpal6B8nYrmg: calls $0.50
Pp/KTcXkfZKKUHkjyaLTdg: checks
*** FLOP *** [Tc Qc 9h]
gUUvmqdVlmvpal6B8nYrmg: bets $1
Pp/KTcXkfZKKUHkjyaLTdg: folds
FVs16t7GgfWgQWt4JxsObQ: raises $3 to $4
gUUvmqdVlmvpal6B8nYrmg: folds
FVs16t7GgfWgQWt4JxsObQ collected $4.80 from pot
*** SUMMARY ***
Total pot $5 | Rake $0.20
Board [Tc Qc 9h]
Seat 1: wZsU+w9r7G66x93UuvBf1Q folded before Flop (didn't bet)
Seat 3: FVs16t7GgfWgQWt4JxsObQ collected ($4.80)
Seat 4: bLbSOSmSOnqE0iTcH/5dxA folded before Flop (didn't bet)
Seat 5: h5ipsNTMyolp7xn/NAvWkA (button) folded before Flop (didn't bet)
Seat 6: gUUvmqdVlmvpal6B8nYrmg (small blind) folded on the Flop
Seat 7: Pp/KTcXkfZKKUHkjyaLTdg (big blind) folded on the Flop
Seat 8: G4DEhsZFmznGNVpy2SEocA folded before Flop (didn't bet)
Seat 9: XE5QF1y74bpHog9JxWJMWQ folded before Flop (didn't bet)



PokerStars Game #59940855692:  Hold'em No Limit ($0.50/$1.00) - 2009/07/01 1:18:34 ET
Table 'MUPc8FEpe/nR0BKSeReX6Q' 6-max Seat #2 is the button
Seat 1: qhkK6+yCciTRd+rCFEbnEQ ($42.10 in chips)
Seat 2: xAU6q2/cwmby2sxmA8VcmA ($113.20 in chips)
Seat 3: wx3sQGkVi2x9wJXuWNHPBw ($225 in chips)
Seat 4: ZA1bp6g8IwtTxkUE4eCjDQ ($195.20 in chips)
Seat 5: y27w5IK2WXqmYzS8OU0wKA ($101.50 in chips)
Seat 6: oxnw0GLLpFanjhGkxfRSqA ($48.55 in chips)
wx3sQGkVi2x9wJXuWNHPBw: posts small blind $0.50
ZA1bp6g8IwtTxkUE4eCjDQ: posts big blind $1
*** HOLE CARDS ***
y27w5IK2WXqmYzS8OU0wKA: folds
oxnw0GLLpFanjhGkxfRSqA: calls $1
qhkK6+yCciTRd+rCFEbnEQ: folds
xAU6q2/cwmby2sxmA8VcmA: folds
wx3sQGkVi2x9wJXuWNHPBw: folds
ZA1bp6g8IwtTxkUE4eCjDQ: checks
*** FLOP *** [4c Ks Kh]
ZA1bp6g8IwtTxkUE4eCjDQ: checks
oxnw0GLLpFanjhGkxfRSqA: bets $2
ZA1bp6g8IwtTxkUE4eCjDQ: folds
oxnw0GLLpFanjhGkxfRSqA collected $2.40 from pot
*** SUMMARY ***
Total pot $2.50 | Rake $0.10
Board [4c Ks Kh]
Seat 1: qhkK6+yCciTRd+rCFEbnEQ folded before Flop (didn't bet)
Seat 2: xAU6q2/cwmby2sxmA8VcmA (button) folded before Flop (didn't bet)
Seat 3: wx3sQGkVi2x9wJXuWNHPBw (small blind) folded before Flop
Seat 4: ZA1bp6g8IwtTxkUE4eCjDQ (big blind) folded on the Flop
Seat 5: y27w5IK2WXqmYzS8OU0wKA folded before Flop (didn't bet)
Seat 6: oxnw0GLLpFanjhGkxfRSqA collected ($2.40)



PokerStars Game #59940856082:  Hold'em No Limit ($0.50/$1.00) - 2009/07/01 1:18:35 ET
Table 'O96CPOtvMBWP6kzuYDfdFA' 6-max Seat #4 is the button
Seat 1: 6alLXQIITA2EZ/lBeym8Dw ($123.75 in chips)
Seat 2: 4d1rWhpu8DzLmzMbR3QKyA ($109.85 in chips)
Seat 3: V89DGjxE171oPREEbAXiyg ($91.45 in chips)
Seat 4: /P4w1pHg2zHYg/4ubJ0dPw ($60 in chips)
Seat 5: G5ZSSN6RSON3gkNvk/SmYg ($100 in chips)
Seat 6: GYei5jXGWexiJYbAT2fELg ($37.15 in chips)
G5ZSSN6RSON3gkNvk/SmYg: posts small blind $0.50
GYei5jXGWexiJYbAT2fELg: posts big blind $1
*** HOLE CARDS ***
6alLXQIITA2EZ/lBeym8Dw: folds
4d1rWhpu8DzLmzMbR3QKyA: folds
V89DGjxE171oPREEbAXiyg: raises $2 to $3
/P4w1pHg2zHYg/4ubJ0dPw: folds
G5ZSSN6RSON3gkNvk/SmYg: folds
GYei5jXGWexiJYbAT2fELg: calls $2
*** FLOP *** [5c 2s Jd]
GYei5jXGWexiJYbAT2fELg: checks
V89DGjxE171oPREEbAXiyg: checks
*** TURN *** [5c 2s Jd] [Qs]
GYei5jXGWexiJYbAT2fELg: checks
V89DGjxE171oPREEbAXiyg: bets $2
GYei5jXGWexiJYbAT2fELg: folds
V89DGjxE171oPREEbAXiyg collected $6.20 from pot
*** SUMMARY ***
Total pot $6.50 | Rake $0.30
Board [5c 2s Jd Qs]
Seat 1: 6alLXQIITA2EZ/lBeym8Dw folded before Flop (didn't bet)
Seat 2: 4d1rWhpu8DzLmzMbR3QKyA folded before Flop (didn't bet)
Seat 3: V89DGjxE171oPREEbAXiyg collected ($6.20)
Seat 4: /P4w1pHg2zHYg/4ubJ0dPw (button) folded before Flop (didn't bet)
Seat 5: G5ZSSN6RSON3gkNvk/SmYg (small blind) folded before Flop
Seat 6: GYei5jXGWexiJYbAT2fELg (big blind) folded on the Turn



PokerStars Game #59940857916:  Hold'em No Limit ($0.50/$1.00) - 2009/07/01 1:18:38 ET
Table 'MNvFfRVQNka/oY+Z5aMbZQ' 2-max Seat #1 is the button
Seat 1: DaZnoWHjO897dnh0CL2lVg ($57.90 in chips)
Seat 2: mgi+mjKb1Sc3CCs7TlfoCw ($66.55 in chips)
DaZnoWHjO897dnh0CL2lVg: posts small blind $0.50
mgi+mjKb1Sc3CCs7TlfoCw: posts big blind $1
*** HOLE CARDS ***
DaZnoWHjO897dnh0CL2lVg: raises $1 to $2
mgi+mjKb1Sc3CCs7TlfoCw: folds
DaZnoWHjO897dnh0CL2lVg collected $2 from pot
DaZnoWHjO897dnh0CL2lVg: doesn't show hand
*** SUMMARY ***
Total pot $2 | Rake $0
Seat 1: DaZnoWHjO897dnh0CL2lVg (button) (small blind) collected ($2)
Seat 2: mgi+mjKb1Sc3CCs7TlfoCw (big blind) folded before Flop



PokerStars Game #59940859328:  Hold'em No Limit ($0.50/$1.00) - 2009/07/01 1:18:40 ET
Table '7O9fB8yx1u7sJveJn8w6jA' 6-max Seat #5 is the button
Seat 1: jy52+7FotjH63o5tEEVgKw ($56.85 in chips)
Seat 2: wx3sQGkVi2x9wJXuWNHPBw ($201.20 in chips)
Seat 3: hpxXcmRkXXI9HE5+5/j/0Q ($124.25 in chips)
Seat 4: b2a+5TkFf4xJN/Ihhma58Q ($37.80 in chips)
Seat 5: BCEV3COoKY607AzLWayfRA ($100.35 in chips)
Seat 6: p1Ga2i1TuXUvRn+Rf/0FMw ($117.90 in chips)
p1Ga2i1TuXUvRn+Rf/0FMw: posts small blind $0.50
jy52+7FotjH63o5tEEVgKw: posts big blind $1
*** HOLE CARDS ***
wx3sQGkVi2x9wJXuWNHPBw: folds
hpxXcmRkXXI9HE5+5/j/0Q: folds
b2a+5TkFf4xJN/Ihhma58Q: raises $1 to $2
BCEV3COoKY607AzLWayfRA: folds
p1Ga2i1TuXUvRn+Rf/0FMw: folds
jy52+7FotjH63o5tEEVgKw: calls $1
*** FLOP *** [4c Kd 7c]
jy52+7FotjH63o5tEEVgKw: checks
b2a+5TkFf4xJN/Ihhma58Q: checks
*** TURN *** [4c Kd 7c] [9h]
p1Ga2i1TuXUvRn+Rf/0FMw leaves the table
jy52+7FotjH63o5tEEVgKw: bets $3
b2a+5TkFf4xJN/Ihhma58Q: folds
jy52+7FotjH63o5tEEVgKw collected $4.30 from pot
6hLdALbOlkzGIrc53QKtPw joins the table at seat #6
*** SUMMARY ***
Total pot $4.50 | Rake $0.20
Board [4c Kd 7c 9h]
Seat 1: jy52+7FotjH63o5tEEVgKw (big blind) collected ($4.30)
Seat 2: wx3sQGkVi2x9wJXuWNHPBw folded before Flop (didn't bet)
Seat 3: hpxXcmRkXXI9HE5+5/j/0Q folded before Flop (didn't bet)
Seat 4: b2a+5TkFf4xJN/Ihhma58Q folded on the Turn
Seat 5: BCEV3COoKY607AzLWayfRA (button) folded before Flop (didn't bet)
Seat 6: p1Ga2i1TuXUvRn+Rf/0FMw (small blind) folded before Flop



PokerStars Game #59940860116:  Hold'em No Limit ($0.50/$1.00) - 2009/07/01 1:18:42 ET
Table 'fZjVbKj9D8yOB+Rj7NaP/A' 9-max Seat #3 is the button
Seat 1: 9BZCcac3+McErkkSN2YScA ($100 in chips)
Seat 2: PTAFYDIUSsG+SArbxNl+Aw ($105.50 in chips)
Seat 3: yAbu2QsRPVcjPbqlf/jDxw ($101 in chips)
Seat 4: 997ViqAtWn1FPjJqcffwcA ($103.50 in chips)
Seat 5: PkGfq5xrSlNsujKaG/HF4Q ($100 in chips)
Seat 6: OvwYHV65yUbgdBjSmo1+5g ($49.95 in chips)
Seat 7: SyS20PAm3RpT6uLBsGkwOA ($114.30 in chips)
Seat 8: zDOE5r14tWqCf6xhuSHK6g ($41 in chips)
Seat 9: qheQay5YvP2DMAb3OUSxtw ($100 in chips)
997ViqAtWn1FPjJqcffwcA: posts small blind $0.50
PkGfq5xrSlNsujKaG/HF4Q: posts big blind $1
*** HOLE CARDS ***
OvwYHV65yUbgdBjSmo1+5g: folds
SyS20PAm3RpT6uLBsGkwOA: folds
zDOE5r14tWqCf6xhuSHK6g: folds
qheQay5YvP2DMAb3OUSxtw: folds
9BZCcac3+McErkkSN2YScA: folds
PTAFYDIUSsG+SArbxNl+Aw: folds
yAbu2QsRPVcjPbqlf/jDxw: folds
997ViqAtWn1FPjJqcffwcA: folds
PkGfq5xrSlNsujKaG/HF4Q collected $1 from pot
PkGfq5xrSlNsujKaG/HF4Q: doesn't show hand
*** SUMMARY ***
Total pot $1 | Rake $0
Seat 1: 9BZCcac3+McErkkSN2YScA folded before Flop (didn't bet)
Seat 2: PTAFYDIUSsG+SArbxNl+Aw folded before Flop (didn't bet)
Seat 3: yAbu2QsRPVcjPbqlf/jDxw (button) folded before Flop (didn't bet)
Seat 4: 997ViqAtWn1FPjJqcffwcA (small blind) folded before Flop
Seat 5: PkGfq5xrSlNsujKaG/HF4Q (big blind) collected ($1)
Seat 6: OvwYHV65yUbgdBjSmo1+5g folded before Flop (didn't bet)
Seat 7: SyS20PAm3RpT6uLBsGkwOA folded before Flop (didn't bet)
Seat 8: zDOE5r14tWqCf6xhuSHK6g folded before Flop (didn't bet)
Seat 9: qheQay5YvP2DMAb3OUSxtw folded before Flop (didn't bet)



PokerStars Game #59940860836:  Hold'em No Limit ($0.50/$1.00) - 2009/07/01 1:18:43 ET
Table 'QSIig7BLMc9wY/rgBechzw' 6-max Seat #6 is the button
Seat 1: Z2fXsGcjl+Eax+RzOgwOmg ($111 in chips)
Seat 2: mLOIkH/qmRa+mVujQIhBRg ($37.30 in chips)
Seat 3: +xW7QemQU0Fxs+4TnqBRow ($107.90 in chips)
Seat 4: +uSzP8Jwnw7sKfQ4s66b7w ($70.95 in chips)
Seat 5: lsLuWlcPA3Rh7kJVLzMh0Q ($105.45 in chips)
Seat 6: PxqfkAMdAWtkgbT+q2gciA ($36.65 in chips)
Z2fXsGcjl+Eax+RzOgwOmg: posts small blind $0.50
mLOIkH/qmRa+mVujQIhBRg: posts big blind $1
*** HOLE CARDS ***
+xW7QemQU0Fxs+4TnqBRow: folds
+uSzP8Jwnw7sKfQ4s66b7w: folds
lsLuWlcPA3Rh7kJVLzMh0Q: folds
PxqfkAMdAWtkgbT+q2gciA: folds
Z2fXsGcjl+Eax+RzOgwOmg: folds
mLOIkH/qmRa+mVujQIhBRg collected $1 from pot
*** SUMMARY ***
Total pot $1 | Rake $0
Seat 1: Z2fXsGcjl+Eax+RzOgwOmg (small blind) folded before Flop
Seat 2: mLOIkH/qmRa+mVujQIhBRg (big blind) collected ($1)
Seat 3: +xW7QemQU0Fxs+4TnqBRow folded before Flop (didn't bet)
Seat 4: +uSzP8Jwnw7sKfQ4s66b7w folded before Flop (didn't bet)
Seat 5: lsLuWlcPA3Rh7kJVLzMh0Q folded before Flop (didn't bet)
Seat 6: PxqfkAMdAWtkgbT+q2gciA (button) folded before Flop (didn't bet)



PokerStars Game #59940861742:  Hold'em No Limit ($0.50/$1.00) - 2009/07/01 1:18:45 ET
Table 'pHrhryH8jPNdQfY62f8v+g' 6-max Seat #6 is the button
Seat 1: 4d1rWhpu8DzLmzMbR3QKyA ($113.40 in chips)
Seat 2: JwCcjZl0bjJzG7hmE0dnTA ($100 in chips)
Seat 3: 8oS5O7iD/qnFXFXJrGIgNQ ($101.50 in chips)
Seat 4: 1f3beyIML24UqEMTbWy93g ($41.65 in chips)
Seat 5: r1/R7y0Ortgoz4lccgW8VA ($48.75 in chips)
Seat 6: xAU6q2/cwmby2sxmA8VcmA ($205.10 in chips)
4d1rWhpu8DzLmzMbR3QKyA: posts small blind $0.50
JwCcjZl0bjJzG7hmE0dnTA: posts big blind $1
*** HOLE CARDS ***
8oS5O7iD/qnFXFXJrGIgNQ: folds
1f3beyIML24UqEMTbWy93g: raises $2 to $3
r1/R7y0Ortgoz4lccgW8VA: calls $3
xAU6q2/cwmby2sxmA8VcmA: folds
4d1rWhpu8DzLmzMbR3QKyA: folds
JwCcjZl0bjJzG7hmE0dnTA: calls $2
*** FLOP *** [3h 8h Jd]
JwCcjZl0bjJzG7hmE0dnTA: checks
1f3beyIML24UqEMTbWy93g: bets $4
r1/R7y0Ortgoz4lccgW8VA: calls $4
JwCcjZl0bjJzG7hmE0dnTA: folds
*** TURN *** [3h 8h Jd] [7s]
1f3beyIML24UqEMTbWy93g: bets $8
r1/R7y0Ortgoz4lccgW8VA: calls $8
*** RIVER *** [3h 8h Jd 7s] [4s]
1f3beyIML24UqEMTbWy93g: bets $9
r1/R7y0Ortgoz4lccgW8VA: calls $9
*** SHOW DOWN ***
1f3beyIML24UqEMTbWy93g: shows [Jh Qs] (a pair of Jacks)
r1/R7y0Ortgoz4lccgW8VA: mucks hand
1f3beyIML24UqEMTbWy93g collected $49.05 from pot
*** SUMMARY ***
Total pot $51.50 | Rake $2.45
Board [3h 8h Jd 7s 4s]
Seat 1: 4d1rWhpu8DzLmzMbR3QKyA (small blind) folded before Flop
Seat 2: JwCcjZl0bjJzG7hmE0dnTA (big blind) folded on the Flop
Seat 3: 8oS5O7iD/qnFXFXJrGIgNQ folded before Flop (didn't bet)
Seat 4: 1f3beyIML24UqEMTbWy93g showed [Jh Qs] and won ($49.05) with a pair of Jacks
Seat 5: r1/R7y0Ortgoz4lccgW8VA mucked
Seat 6: xAU6q2/cwmby2sxmA8VcmA (button) folded before Flop (didn't bet)



PokerStars Game #59940861988:  Hold'em No Limit ($0.50/$1.00) - 2009/07/01 1:18:45 ET
Table 'fTlPiCj0utgzC/5io+I7ew' 6-max Seat #5 is the button
Seat 1: YMJG+F++3Aj6P8dAWda5fw ($98.35 in chips)
Seat 2: KDYsHh8K2SUXXDvLsAhbJQ ($21.40 in chips)
Seat 3: Z2fXsGcjl+Eax+RzOgwOmg ($102.50 in chips)
Seat 4: uJVSceLggtsrJya+WtmUEA ($173.65 in chips)
Seat 5: XUk5GQsfNFpHvaToDZ0rZA ($54.15 in chips)
Seat 6: y27w5IK2WXqmYzS8OU0wKA ($100 in chips)
y27w5IK2WXqmYzS8OU0wKA: posts small blind $0.50
YMJG+F++3Aj6P8dAWda5fw: posts big blind $1
*** HOLE CARDS ***
KDYsHh8K2SUXXDvLsAhbJQ: calls $1
Z2fXsGcjl+Eax+RzOgwOmg: folds
uJVSceLggtsrJya+WtmUEA: folds
XUk5GQsfNFpHvaToDZ0rZA: folds
y27w5IK2WXqmYzS8OU0wKA: folds
YMJG+F++3Aj6P8dAWda5fw: checks
*** FLOP *** [Kd 9c Ks]
YMJG+F++3Aj6P8dAWda5fw: checks
KDYsHh8K2SUXXDvLsAhbJQ: checks
*** TURN *** [Kd 9c Ks] [2c]
YMJG+F++3Aj6P8dAWda5fw: checks
KDYsHh8K2SUXXDvLsAhbJQ: checks
*** RIVER *** [Kd 9c Ks 2c] [8d]
YMJG+F++3Aj6P8dAWda5fw: checks
KDYsHh8K2SUXXDvLsAhbJQ: checks
*** SHOW DOWN ***
YMJG+F++3Aj6P8dAWda5fw: shows [4c 8h] (two pair, Kings and Eights)
KDYsHh8K2SUXXDvLsAhbJQ: shows [8s 5s] (two pair, Kings and Eights)
YMJG+F++3Aj6P8dAWda5fw collected $1.20 from pot
KDYsHh8K2SUXXDvLsAhbJQ collected $1.20 from pot
*** SUMMARY ***
Total pot $2.50 | Rake $0.10
Board [Kd 9c Ks 2c 8d]
Seat 1: YMJG+F++3Aj6P8dAWda5fw (big blind) showed [4c 8h] and won ($1.20) with two pair, Kings and Eights
Seat 2: KDYsHh8K2SUXXDvLsAhbJQ showed [8s 5s] and won ($1.20) with two pair, Kings and Eights
Seat 3: Z2fXsGcjl+Eax+RzOgwOmg folded before Flop (didn't bet)
Seat 4: uJVSceLggtsrJya+WtmUEA folded before Flop (didn't bet)
Seat 5: XUk5GQsfNFpHvaToDZ0rZA (button) folded before Flop (didn't bet)
Seat 6: y27w5IK2WXqmYzS8OU0wKA (small blind) folded before Flop



PokerStars Game #59940862534:  Hold'em No Limit ($0.50/$1.00) - 2009/07/01 1:18:46 ET
Table 'MNvFfRVQNka/oY+Z5aMbZQ' 2-max Seat #2 is the button
Seat 1: DaZnoWHjO897dnh0CL2lVg ($58.90 in chips)
Seat 2: mgi+mjKb1Sc3CCs7TlfoCw ($65.55 in chips)
mgi+mjKb1Sc3CCs7TlfoCw: posts small blind $0.50
DaZnoWHjO897dnh0CL2lVg: posts big blind $1
*** HOLE CARDS ***
mgi+mjKb1Sc3CCs7TlfoCw: folds
DaZnoWHjO897dnh0CL2lVg collected $1 from pot
DaZnoWHjO897dnh0CL2lVg: doesn't show hand
*** SUMMARY ***
Total pot $1 | Rake $0
Seat 1: DaZnoWHjO897dnh0CL2lVg (big blind) collected ($1)
Seat 2: mgi+mjKb1Sc3CCs7TlfoCw (button) (small blind) folded before Flop



PokerStars Game #59940864244:  Hold'em No Limit ($0.50/$1.00) - 2009/07/01 1:18:49 ET
Table 'mmbQQVBTrPdE+wy+s+9VPA' 6-max Seat #4 is the button
Seat 1: zyP4SPoWZnKUfTvIRLCVog ($63.75 in chips)
Seat 2: XK4Qsl+DA8gAJyg85/zBIw ($17.95 in chips)
Seat 3: wx3sQGkVi2x9wJXuWNHPBw ($128.85 in chips)
Seat 4: V3iZdcw61nXF3g5hD2RrsQ ($104.90 in chips)
Seat 5: YMJG+F++3Aj6P8dAWda5fw ($107.50 in chips)
Seat 6: U2CWBTv29qdCbj8RNF2sIw ($97.60 in chips)
YMJG+F++3Aj6P8dAWda5fw: posts small blind $0.50
U2CWBTv29qdCbj8RNF2sIw said, "vnh"
U2CWBTv29qdCbj8RNF2sIw: posts big blind $1
*** HOLE CARDS ***
zyP4SPoWZnKUfTvIRLCVog: folds
XK4Qsl+DA8gAJyg85/zBIw: folds
wx3sQGkVi2x9wJXuWNHPBw: folds
V3iZdcw61nXF3g5hD2RrsQ: raises $2 to $3
YMJG+F++3Aj6P8dAWda5fw: folds
U2CWBTv29qdCbj8RNF2sIw: folds
V3iZdcw61nXF3g5hD2RrsQ collected $2.50 from pot
*** SUMMARY ***
Total pot $2.50 | Rake $0
Seat 1: zyP4SPoWZnKUfTvIRLCVog folded before Flop (didn't bet)
Seat 2: XK4Qsl+DA8gAJyg85/zBIw folded before Flop (didn't bet)
Seat 3: wx3sQGkVi2x9wJXuWNHPBw folded before Flop (didn't bet)
Seat 4: V3iZdcw61nXF3g5hD2RrsQ (button) collected ($2.50)
Seat 5: YMJG+F++3Aj6P8dAWda5fw (small blind) folded before Flop
Seat 6: U2CWBTv29qdCbj8RNF2sIw (big blind) folded before Flop



PokerStars Game #59940865440:  Hold'em No Limit ($0.50/$1.00) - 2009/07/01 1:18:51 ET
Table 'gxFK0BVUD7cupu2uyRUZJg' 6-max Seat #6 is the button
Seat 1: M+X3uChmP6R63IwijVjgTg ($144.05 in chips)
Seat 2: hpxXcmRkXXI9HE5+5/j/0Q ($120.10 in chips)
Seat 3: Z2fXsGcjl+Eax+RzOgwOmg ($119.75 in chips)
Seat 5: WgIrs6CBinyyw18pqdDtWA ($26.70 in chips)
Seat 6: dYyb6/42PMC8aNFlm/eBeQ ($65.85 in chips)
M+X3uChmP6R63IwijVjgTg: posts small blind $0.50
hpxXcmRkXXI9HE5+5/j/0Q: posts big blind $1
*** HOLE CARDS ***
Z2fXsGcjl+Eax+RzOgwOmg: folds
WgIrs6CBinyyw18pqdDtWA: calls $1
dYyb6/42PMC8aNFlm/eBeQ: folds
M+X3uChmP6R63IwijVjgTg: calls $0.50
hpxXcmRkXXI9HE5+5/j/0Q: checks
*** FLOP *** [6c 9s 3d]
M+X3uChmP6R63IwijVjgTg: checks
hpxXcmRkXXI9HE5+5/j/0Q: checks
WgIrs6CBinyyw18pqdDtWA: bets $2
M+X3uChmP6R63IwijVjgTg: calls $2
hpxXcmRkXXI9HE5+5/j/0Q: folds
*** TURN *** [6c 9s 3d] [7s]
M+X3uChmP6R63IwijVjgTg: checks
WgIrs6CBinyyw18pqdDtWA: bets $5
M+X3uChmP6R63IwijVjgTg: calls $5
*** RIVER *** [6c 9s 3d 7s] [Th]
M+X3uChmP6R63IwijVjgTg: bets $10
WgIrs6CBinyyw18pqdDtWA: calls $10
*** SHOW DOWN ***
M+X3uChmP6R63IwijVjgTg: shows [Ts 6d] (two pair, Tens and Sixes)
WgIrs6CBinyyw18pqdDtWA: mucks hand
M+X3uChmP6R63IwijVjgTg collected $35.20 from pot
*** SUMMARY ***
Total pot $37 | Rake $1.80
Board [6c 9s 3d 7s Th]
Seat 1: M+X3uChmP6R63IwijVjgTg (small blind) showed [Ts 6d] and won ($35.20) with two pair, Tens and Sixes
Seat 2: hpxXcmRkXXI9HE5+5/j/0Q (big blind) folded on the Flop
Seat 3: Z2fXsGcjl+Eax+RzOgwOmg folded before Flop (didn't bet)
Seat 5: WgIrs6CBinyyw18pqdDtWA mucked
Seat 6: dYyb6/42PMC8aNFlm/eBeQ (button) folded before Flop (didn't bet)



PokerStars Game #59940866460:  Hold'em No Limit ($0.50/$1.00) - 2009/07/01 1:18:53 ET
Table 'uNlePsyMIqzM691Xkrlk6Q' 9-max Seat #8 is the button
Seat 1: bLbSOSmSOnqE0iTcH/5dxA ($114.50 in chips)
Seat 2: +OqpStnt0FqbCfyHAWaLbg ($88.80 in chips)
Seat 3: h7qXkU57Bb8ZuPwMyxR8Ug ($37 in chips)
Seat 4: TRx/IDriSKVaxeebBKhcFQ ($20.90 in chips)
Seat 5: 9jIz1JKIpvRv9Xv6qqhAMA ($76.80 in chips)
Seat 7: KNAaBvPYSXyLqb88ypSbuQ ($26.95 in chips)
Seat 8: yWcEtGJ3ijZsF6HqlHqkrg ($105.40 in chips)
OGgaARGdJQT4awWVNQ957w will be allowed to play after the button
bLbSOSmSOnqE0iTcH/5dxA: posts small blind $0.50
+OqpStnt0FqbCfyHAWaLbg: posts big blind $1
froChili: sits out
*** HOLE CARDS ***
h7qXkU57Bb8ZuPwMyxR8Ug: raises $2 to $3
TRx/IDriSKVaxeebBKhcFQ: folds
9jIz1JKIpvRv9Xv6qqhAMA: folds
KNAaBvPYSXyLqb88ypSbuQ: folds
yWcEtGJ3ijZsF6HqlHqkrg: folds
bLbSOSmSOnqE0iTcH/5dxA: folds
+OqpStnt0FqbCfyHAWaLbg: folds
h7qXkU57Bb8ZuPwMyxR8Ug collected $2.50 from pot
*** SUMMARY ***
Total pot $2.50 | Rake $0
Seat 1: bLbSOSmSOnqE0iTcH/5dxA (small blind) folded before Flop
Seat 2: +OqpStnt0FqbCfyHAWaLbg (big blind) folded before Flop
Seat 3: h7qXkU57Bb8ZuPwMyxR8Ug collected ($2.50)
Seat 4: TRx/IDriSKVaxeebBKhcFQ folded before Flop (didn't bet)
Seat 5: 9jIz1JKIpvRv9Xv6qqhAMA folded before Flop (didn't bet)
Seat 7: KNAaBvPYSXyLqb88ypSbuQ folded before Flop (didn't bet)
Seat 8: yWcEtGJ3ijZsF6HqlHqkrg (button) folded before Flop (didn't bet)



PokerStars Game #59940867494:  Hold'em No Limit ($0.50/$1.00) - 2009/07/01 1:18:55 ET
Table 'GPp0HyAuggN8oE0sUWzPpA' 9-max Seat #8 is the button
Seat 1: qJr25HAtvv1w/7IBvjMM3g ($46.25 in chips)
Seat 2: m3U8I35Pn3gxKhoS2nmYIg ($13.40 in chips)
Seat 3: CCCXsirC+bO7ginAuUUVlQ ($52.25 in chips)
Seat 4: mBRWbnUl8diyBO1qTJaNzw ($101.65 in chips)
Seat 5: bLbSOSmSOnqE0iTcH/5dxA ($100 in chips)
Seat 6: BK/GtNPkSx0TdUDj82id5A ($33.20 in chips)
Seat 7: DHdbHyysD15wCAtx+BhUjA ($96.70 in chips)
Seat 8: P/6qLjycEfxRgZ5F/W90dw ($96 in chips)
Seat 9: dzoSjPZmtjGuK83119030A ($39.65 in chips)
dzoSjPZmtjGuK83119030A: posts small blind $0.50
qJr25HAtvv1w/7IBvjMM3g: posts big blind $1
*** HOLE CARDS ***
m3U8I35Pn3gxKhoS2nmYIg: folds
CCCXsirC+bO7ginAuUUVlQ: folds
mBRWbnUl8diyBO1qTJaNzw: folds
bLbSOSmSOnqE0iTcH/5dxA: folds
BK/GtNPkSx0TdUDj82id5A: raises $2 to $3
DHdbHyysD15wCAtx+BhUjA: folds
P/6qLjycEfxRgZ5F/W90dw: folds
dzoSjPZmtjGuK83119030A: folds
qJr25HAtvv1w/7IBvjMM3g: folds
BK/GtNPkSx0TdUDj82id5A collected $2.50 from pot
*** SUMMARY ***
Total pot $2.50 | Rake $0
Seat 1: qJr25HAtvv1w/7IBvjMM3g (big blind) folded before Flop
Seat 2: m3U8I35Pn3gxKhoS2nmYIg folded before Flop (didn't bet)
Seat 3: CCCXsirC+bO7ginAuUUVlQ folded before Flop (didn't bet)
Seat 4: mBRWbnUl8diyBO1qTJaNzw folded before Flop (didn't bet)
Seat 5: bLbSOSmSOnqE0iTcH/5dxA folded before Flop (didn't bet)
Seat 6: BK/GtNPkSx0TdUDj82id5A collected ($2.50)
Seat 7: DHdbHyysD15wCAtx+BhUjA folded before Flop (didn't bet)
Seat 8: P/6qLjycEfxRgZ5F/W90dw (button) folded before Flop (didn't bet)
Seat 9: dzoSjPZmtjGuK83119030A (small blind) folded before Flop



PokerStars Game #59940867838:  Hold'em No Limit ($0.50/$1.00) - 2009/07/01 1:18:55 ET
Table 'MNvFfRVQNka/oY+Z5aMbZQ' 2-max Seat #1 is the button
Seat 1: DaZnoWHjO897dnh0CL2lVg ($59.40 in chips)
Seat 2: mgi+mjKb1Sc3CCs7TlfoCw ($65.05 in chips)
DaZnoWHjO897dnh0CL2lVg: posts small blind $0.50
mgi+mjKb1Sc3CCs7TlfoCw: posts big blind $1
*** HOLE CARDS ***
DaZnoWHjO897dnh0CL2lVg: calls $0.50
mgi+mjKb1Sc3CCs7TlfoCw: checks
*** FLOP *** [7c Qh 3c]
mgi+mjKb1Sc3CCs7TlfoCw: checks
DaZnoWHjO897dnh0CL2lVg: checks
*** TURN *** [7c Qh 3c] [2d]
mgi+mjKb1Sc3CCs7TlfoCw: bets $2
DaZnoWHjO897dnh0CL2lVg: calls $2
*** RIVER *** [7c Qh 3c 2d] [8c]
mgi+mjKb1Sc3CCs7TlfoCw: checks
DaZnoWHjO897dnh0CL2lVg: bets $4
mgi+mjKb1Sc3CCs7TlfoCw: folds
DaZnoWHjO897dnh0CL2lVg collected $5.75 from pot
DaZnoWHjO897dnh0CL2lVg: doesn't show hand
*** SUMMARY ***
Total pot $6 | Rake $0.25
Board [7c Qh 3c 2d 8c]
Seat 1: DaZnoWHjO897dnh0CL2lVg (button) (small blind) collected ($5.75)
Seat 2: mgi+mjKb1Sc3CCs7TlfoCw (big blind) folded on the River



PokerStars Game #59940868626:  Hold'em No Limit ($0.50/$1.00) - 2009/07/01 1:18:57 ET
Table '6YvsYDPNIDx2v5z3bJnwZQ' 9-max Seat #3 is the button
Seat 1: Ogn4JDV3mp4ZDKO49IFzKA ($19.70 in chips)
Seat 2: +hHqYgKILitkxIzFNGvvsA ($18.75 in chips)
Seat 3: K6OJDis3KfxSm/PKlkATUA ($48.50 in chips)
Seat 4: kEr5NYB+JIG5+szcYMr6hA ($45.95 in chips)
Seat 5: mBRWbnUl8diyBO1qTJaNzw ($131.90 in chips)
Seat 6: 7RSwrjMohkYrZAhOd1uaZg ($11.90 in chips)
Seat 7: mae7OMTaJ/MFimNbZegCkg ($43.30 in chips)
Seat 8: PSFxpXgPedVZyHSu2Zhb7Q ($129.05 in chips)
Seat 9: yZYrOeNDxQxkzpbgKX1bng ($63.60 in chips)
kEr5NYB+JIG5+szcYMr6hA: posts small blind $0.50
mBRWbnUl8diyBO1qTJaNzw: posts big blind $1
*** HOLE CARDS ***
7RSwrjMohkYrZAhOd1uaZg: calls $1
mae7OMTaJ/MFimNbZegCkg: folds
PSFxpXgPedVZyHSu2Zhb7Q: folds
yZYrOeNDxQxkzpbgKX1bng: raises $3 to $4
Ogn4JDV3mp4ZDKO49IFzKA: folds
+hHqYgKILitkxIzFNGvvsA: folds
K6OJDis3KfxSm/PKlkATUA: folds
kEr5NYB+JIG5+szcYMr6hA: folds
mBRWbnUl8diyBO1qTJaNzw: calls $3
7RSwrjMohkYrZAhOd1uaZg: folds
*** FLOP *** [5h 9s 5d]
mBRWbnUl8diyBO1qTJaNzw: checks
yZYrOeNDxQxkzpbgKX1bng: bets $5
mBRWbnUl8diyBO1qTJaNzw: folds
yZYrOeNDxQxkzpbgKX1bng collected $9.05 from pot
*** SUMMARY ***
Total pot $9.50 | Rake $0.45
Board [5h 9s 5d]
Seat 1: Ogn4JDV3mp4ZDKO49IFzKA folded before Flop (didn't bet)
Seat 2: +hHqYgKILitkxIzFNGvvsA folded before Flop (didn't bet)
Seat 3: K6OJDis3KfxSm/PKlkATUA (button) folded before Flop (didn't bet)
Seat 4: kEr5NYB+JIG5+szcYMr6hA (small blind) folded before Flop
Seat 5: mBRWbnUl8diyBO1qTJaNzw (big blind) folded on the Flop
Seat 6: 7RSwrjMohkYrZAhOd1uaZg folded before Flop
Seat 7: mae7OMTaJ/MFimNbZegCkg folded before Flop (didn't bet)
Seat 8: PSFxpXgPedVZyHSu2Zhb7Q folded before Flop (didn't bet)
Seat 9: yZYrOeNDxQxkzpbgKX1bng collected ($9.05)



PokerStars Game #59940869498:  Hold'em No Limit ($0.50/$1.00) - 2009/07/01 1:18:58 ET
Table 'hugOjcwJvzEwZbK7tyiWuQ' 9-max Seat #2 is the button
Seat 1: S3Ex8K7v6xm5jqjRM7Fl3w ($22 in chips)
Seat 2: r27C1nIV4NS4+qbnrgBQSw ($280.20 in chips)
Seat 3: ZWdwcEAWYlrUhsRi6MOmoA ($20 in chips)
Seat 4: UWB3oeddt/GObx2Mix2Anw ($171.30 in chips)
Seat 6: gUUvmqdVlmvpal6B8nYrmg ($103 in chips)
Seat 7: FL3MrLspcF23LYvC4ipBOA ($120.30 in chips)
Seat 8: /zy+DB4S5fUQUSfZWFzYGw ($126.25 in chips)
Seat 9: W8P9bUKCs43TO1xHm0dL6w ($87.95 in chips)
ZWdwcEAWYlrUhsRi6MOmoA: posts small blind $0.50
UWB3oeddt/GObx2Mix2Anw: posts big blind $1
*** HOLE CARDS ***
gUUvmqdVlmvpal6B8nYrmg: raises $1 to $2
FL3MrLspcF23LYvC4ipBOA: folds
/zy+DB4S5fUQUSfZWFzYGw: folds
W8P9bUKCs43TO1xHm0dL6w: folds
S3Ex8K7v6xm5jqjRM7Fl3w: folds
r27C1nIV4NS4+qbnrgBQSw: calls $2
ZWdwcEAWYlrUhsRi6MOmoA: folds
UWB3oeddt/GObx2Mix2Anw: raises $6 to $8
gUUvmqdVlmvpal6B8nYrmg: calls $6
r27C1nIV4NS4+qbnrgBQSw: calls $6
*** FLOP *** [Ad 4d Ac]
5BRGWf+R3nt2WS3b5xX+zA leaves the table
UWB3oeddt/GObx2Mix2Anw: bets $8
gUUvmqdVlmvpal6B8nYrmg: folds
r27C1nIV4NS4+qbnrgBQSw: folds
UWB3oeddt/GObx2Mix2Anw collected $23.30 from pot
*** SUMMARY ***
Total pot $24.50 | Rake $1.20
Board [Ad 4d Ac]
Seat 1: S3Ex8K7v6xm5jqjRM7Fl3w folded before Flop (didn't bet)
Seat 2: r27C1nIV4NS4+qbnrgBQSw (button) folded on the Flop
Seat 3: ZWdwcEAWYlrUhsRi6MOmoA (small blind) folded before Flop
Seat 4: UWB3oeddt/GObx2Mix2Anw (big blind) collected ($23.30)
Seat 6: gUUvmqdVlmvpal6B8nYrmg folded on the Flop
Seat 7: FL3MrLspcF23LYvC4ipBOA folded before Flop (didn't bet)
Seat 8: /zy+DB4S5fUQUSfZWFzYGw folded before Flop (didn't bet)
Seat 9: W8P9bUKCs43TO1xHm0dL6w folded before Flop (didn't bet)



PokerStars Game #59940871406:  Hold'em No Limit ($0.50/$1.00) - 2009/07/01 1:19:02 ET
Table 'tyUh+jyNvrceIQdKMJjQ2wZFWj23PMihdwrNWv41OG/Qeat #6 is the button
Seat 3: TalCiLYHCd+ffkmR3auPvA ($242.30 in chips)
Seat 4: hpxXcmRkXXI9HE5+5/j/0Q ($100 in chips)
Seat 5: j7NIOHLZk7V2o9fOioO5ug ($111.70 in chips)
Seat 6: 4OO5v3AVduL0tePNx8wk5A ($100 in chips)
TalCiLYHCd+ffkmR3auPvA: posts small blind $0.50
hpxXcmRkXXI9HE5+5/j/0Q: posts big blind $1
*** HOLE CARDS ***
j7NIOHLZk7V2o9fOioO5ug: folds
4OO5v3AVduL0tePNx8wk5A: folds
TalCiLYHCd+ffkmR3auPvA: raises $2 to $3
hpxXcmRkXXI9HE5+5/j/0Q: folds
TalCiLYHCd+ffkmR3auPvA collected $2 from pot
TalCiLYHCd+ffkmR3auPvA: doesn't show hand
*** SUMMARY ***
Total pot $2 | Rake $0
Seat 3: TalCiLYHCd+ffkmR3auPvA (small blind) collected ($2)
Seat 4: hpxXcmRkXXI9HE5+5/j/0Q (big blind) folded before Flop
Seat 5: j7NIOHLZk7V2o9fOioO5ug folded before Flop (didn't bet)
Seat 6: 4OO5v3AVduL0tePNx8wk5A (button) folded before Flop (didn't bet)



PokerStars Game #59940872344:  Hold'em No Limit ($0.50/$1.00) - 2009/07/01 1:19:03 ET
Table 'QSIig7BLMc9wY/rgBechzw' 6-max Seat #1 is the button
Seat 1: Z2fXsGcjl+Eax+RzOgwOmg ($110.50 in chips)
Seat 2: mLOIkH/qmRa+mVujQIhBRg ($37.80 in chips)
Seat 3: +xW7QemQU0Fxs+4TnqBRow ($107.90 in chips)
Seat 4: +uSzP8Jwnw7sKfQ4s66b7w ($70.95 in chips)
Seat 5: lsLuWlcPA3Rh7kJVLzMh0Q ($105.45 in chips)
Seat 6: PxqfkAMdAWtkgbT+q2gciA ($36.65 in chips)
mLOIkH/qmRa+mVujQIhBRg: posts small blind $0.50
+xW7QemQU0Fxs+4TnqBRow: posts big blind $1
*** HOLE CARDS ***
+uSzP8Jwnw7sKfQ4s66b7w: raises $2 to $3
lsLuWlcPA3Rh7kJVLzMh0Q: folds
PxqfkAMdAWtkgbT+q2gciA: folds
Z2fXsGcjl+Eax+RzOgwOmg: calls $3
mLOIkH/qmRa+mVujQIhBRg: raises $6 to $9
+xW7QemQU0Fxs+4TnqBRow: folds
+uSzP8Jwnw7sKfQ4s66b7w: calls $6
Z2fXsGcjl+Eax+RzOgwOmg: calls $6
*** FLOP *** [5h 7h Qd]
mLOIkH/qmRa+mVujQIhBRg: bets $12
+uSzP8Jwnw7sKfQ4s66b7w: folds
Z2fXsGcjl+Eax+RzOgwOmg: folds
mLOIkH/qmRa+mVujQIhBRg collected $26.60 from pot
*** SUMMARY ***
Total pot $28 | Rake $1.40
Board [5h 7h Qd]
Seat 1: Z2fXsGcjl+Eax+RzOgwOmg (button) folded on the Flop
Seat 2: mLOIkH/qmRa+mVujQIhBRg (small blind) collected ($26.60)
Seat 3: +xW7QemQU0Fxs+4TnqBRow (big blind) folded before Flop
Seat 4: +uSzP8Jwnw7sKfQ4s66b7w folded on the Flop
Seat 5: lsLuWlcPA3Rh7kJVLzMh0Q folded before Flop (didn't bet)
Seat 6: PxqfkAMdAWtkgbT+q2gciA folded before Flop (didn't bet)



PokerStars Game #59940873208:  Hold'em No Limit ($0.50/$1.00) - 2009/07/01 1:19:05 ET
Table '/RZcOwpZpHQ+OwPwjsbnRw' 6-max Seat #2 is the button
Seat 1: +uSzP8Jwnw7sKfQ4s66b7w ($52.25 in chips)
Seat 2: Z2fXsGcjl+Eax+RzOgwOmg ($101.50 in chips)
Seat 3: 6hLdALbOlkzGIrc53QKtPw ($20 in chips)
Seat 4: j7NIOHLZk7V2o9fOioO5ug ($145.20 in chips)
Seat 5: wx3sQGkVi2x9wJXuWNHPBw ($166.25 in chips)
Seat 6: o3YLm/rSY916m/on1VjXPA ($100 in chips)
6hLdALbOlkzGIrc53QKtPw: posts small blind $0.50
j7NIOHLZk7V2o9fOioO5ug: posts big blind $1
*** HOLE CARDS ***
wx3sQGkVi2x9wJXuWNHPBw: folds
o3YLm/rSY916m/on1VjXPA: folds
+uSzP8Jwnw7sKfQ4s66b7w: folds
Z2fXsGcjl+Eax+RzOgwOmg: raises $2 to $3
6hLdALbOlkzGIrc53QKtPw: folds
j7NIOHLZk7V2o9fOioO5ug: folds
Z2fXsGcjl+Eax+RzOgwOmg collected $2.50 from pot
Z2fXsGcjl+Eax+RzOgwOmg: doesn't show hand
*** SUMMARY ***
Total pot $2.50 | Rake $0
Seat 1: +uSzP8Jwnw7sKfQ4s66b7w folded before Flop (didn't bet)
Seat 2: Z2fXsGcjl+Eax+RzOgwOmg (button) collected ($2.50)
Seat 3: 6hLdALbOlkzGIrc53QKtPw (small blind) folded before Flop
Seat 4: j7NIOHLZk7V2o9fOioO5ug (big blind) folded before Flop
Seat 5: wx3sQGkVi2x9wJXuWNHPBw folded before Flop (didn't bet)
Seat 6: o3YLm/rSY916m/on1VjXPA folded before Flop (didn't bet)



PokerStars Game #59940873620:  Hold'em No Limit ($0.50/$1.00) - 2009/07/01 1:19:06 ET
Table 'W/wyObTiXZm+Ckkl3YxcSw' 6-max Seat #5 is the button
Seat 1: eUBBn2R56C1IQ6Cs/vitwg ($300.40 in chips)
Seat 2: oDiBRCaF0QVtd3kO6xZIXw ($149.15 in chips)
Seat 3: dxyNCn/qxfkGDUIf28Cbng ($69.30 in chips)
Seat 5: +OrCjyw70oZhJiD22Mn+bg ($100 in chips)
Seat 6: b2a+5TkFf4xJN/Ihhma58Q ($37 in chips)
b2a+5TkFf4xJN/Ihhma58Q: posts small blind $0.50
eUBBn2R56C1IQ6Cs/vitwg: posts big blind $1
UBZQqpnJZdTYYY1FTb0rLA: sits out
*** HOLE CARDS ***
oDiBRCaF0QVtd3kO6xZIXw: folds
dxyNCn/qxfkGDUIf28Cbng: folds
+OrCjyw70oZhJiD22Mn+bg: raises $3 to $4
b2a+5TkFf4xJN/Ihhma58Q: folds
eUBBn2R56C1IQ6Cs/vitwg: folds
+OrCjyw70oZhJiD22Mn+bg collected $2.50 from pot
+OrCjyw70oZhJiD22Mn+bg: doesn't show hand
*** SUMMARY ***
Total pot $2.50 | Rake $0
Seat 1: eUBBn2R56C1IQ6Cs/vitwg (big blind) folded before Flop
Seat 2: oDiBRCaF0QVtd3kO6xZIXw folded before Flop (didn't bet)
Seat 3: dxyNCn/qxfkGDUIf28Cbng folded before Flop (didn't bet)
Seat 5: +OrCjyw70oZhJiD22Mn+bg (button) collected ($2.50)
Seat 6: b2a+5TkFf4xJN/Ihhma58Q (small blind) folded before Flop



PokerStars Game #59940875102:  Hold'em No Limit ($0.50/$1.00) - 2009/07/01 1:19:08 ET
Table '7Nl0ffnjeK44/vmeexh3MQ' 9-max Seat #1 is the button
Seat 1: V138SURkdX8LdVBPKdJJag ($100 in chips)
Seat 2: OGgaARGdJQT4awWVNQ957w ($101 in chips)
Seat 3: JMmUYT5pIKCKh2pGjCB/4w ($56.90 in chips)
Seat 4: bLbSOSmSOnqE0iTcH/5dxA ($100 in chips)
Seat 5: 61sfw5QTu62YYIt68OsdrA ($81.50 in chips)
Seat 6: FVs16t7GgfWgQWt4JxsObQ ($30.75 in chips)
Seat 7: 997ViqAtWn1FPjJqcffwcA ($100 in chips)
Seat 8: D+W9Me7w6Hcx/WRUSKV0dw ($19.25 in chips)
Seat 9: ouwUBGRKnKK9uhn1G4Lf+A ($194 in chips)
OGgaARGdJQT4awWVNQ957w: posts small blind $0.50
JMmUYT5pIKCKh2pGjCB/4w: posts big blind $1
*** HOLE CARDS ***
bLbSOSmSOnqE0iTcH/5dxA: folds
61sfw5QTu62YYIt68OsdrA: folds
FVs16t7GgfWgQWt4JxsObQ: folds
997ViqAtWn1FPjJqcffwcA: folds
D+W9Me7w6Hcx/WRUSKV0dw: folds
ouwUBGRKnKK9uhn1G4Lf+A: raises $2 to $3
V138SURkdX8LdVBPKdJJag: folds
OGgaARGdJQT4awWVNQ957w: folds
JMmUYT5pIKCKh2pGjCB/4w: folds
ouwUBGRKnKK9uhn1G4Lf+A collected $2.50 from pot
ouwUBGRKnKK9uhn1G4Lf+A: doesn't show hand
*** SUMMARY ***
Total pot $2.50 | Rake $0
Seat 1: V138SURkdX8LdVBPKdJJag (button) folded before Flop (didn't bet)
Seat 2: OGgaARGdJQT4awWVNQ957w (small blind) folded before Flop
Seat 3: JMmUYT5pIKCKh2pGjCB/4w (big blind) folded before Flop
Seat 4: bLbSOSmSOnqE0iTcH/5dxA folded before Flop (didn't bet)
Seat 5: 61sfw5QTu62YYIt68OsdrA folded before Flop (didn't bet)
Seat 6: FVs16t7GgfWgQWt4JxsObQ folded before Flop (didn't bet)
Seat 7: 997ViqAtWn1FPjJqcffwcA folded before Flop (didn't bet)
Seat 8: D+W9Me7w6Hcx/WRUSKV0dw folded before Flop (didn't bet)
Seat 9: ouwUBGRKnKK9uhn1G4Lf+A collected ($2.50)



PokerStars Game #59940875318:  Hold'em No Limit ($0.50/$1.00) - 2009/07/01 1:19:09 ET
Table 'rmZfTK+oSebeUPJNbWhdAA' 6-max Seat #4 is the button
Seat 1: xAU6q2/cwmby2sxmA8VcmA ($147 in chips)
Seat 2: z7O9PO/WEcqRouIydFhS9Q ($147.95 in chips)
Seat 3: BCEV3COoKY607AzLWayfRA ($151.30 in chips)
Seat 4: 1/mIuXfgx1ZyVkodrmfQDw ($107.15 in chips)
Seat 5: 5lY8d6Cnm4HUkt/8FZSj4g ($53.25 in chips)
Seat 6: j7NIOHLZk7V2o9fOioO5ug ($146.40 in chips)
5lY8d6Cnm4HUkt/8FZSj4g: posts small blind $0.50
j7NIOHLZk7V2o9fOioO5ug: posts big blind $1
*** HOLE CARDS ***
xAU6q2/cwmby2sxmA8VcmA: raises $3 to $4
z7O9PO/WEcqRouIydFhS9Q: folds
BCEV3COoKY607AzLWayfRA: folds
1/mIuXfgx1ZyVkodrmfQDw: folds
5lY8d6Cnm4HUkt/8FZSj4g: raises $49.25 to $53.25 and is all-in
j7NIOHLZk7V2o9fOioO5ug: folds
xAU6q2/cwmby2sxmA8VcmA: folds
5lY8d6Cnm4HUkt/8FZSj4g collected $9 from pot
*** SUMMARY ***
Total pot $9 | Rake $0
Seat 1: xAU6q2/cwmby2sxmA8VcmA folded before Flop
Seat 2: z7O9PO/WEcqRouIydFhS9Q folded before Flop (didn't bet)
Seat 3: BCEV3COoKY607AzLWayfRA folded before Flop (didn't bet)
Seat 4: 1/mIuXfgx1ZyVkodrmfQDw (button) folded before Flop (didn't bet)
Seat 5: 5lY8d6Cnm4HUkt/8FZSj4g (small blind) collected ($9)
Seat 6: j7NIOHLZk7V2o9fOioO5ug (big blind) folded before Flop



PokerStars Game #59940876132:  Hold'em No Limit ($0.50/$1.00) - 2009/07/01 1:19:10 ET
Table 'fZjVbKj9D8yOB+Rj7NaP/A' 9-max Seat #4 is the button
Seat 1: 9BZCcac3+McErkkSN2YScA ($100 in chips)
Seat 2: PTAFYDIUSsG+SArbxNl+Aw ($105.50 in chips)
Seat 3: yAbu2QsRPVcjPbqlf/jDxw ($101 in chips)
Seat 4: 997ViqAtWn1FPjJqcffwcA ($103 in chips)
Seat 5: PkGfq5xrSlNsujKaG/HF4Q ($100.50 in chips)
Seat 6: OvwYHV65yUbgdBjSmo1+5g ($49.95 in chips)
Seat 7: SyS20PAm3RpT6uLBsGkwOA ($114.30 in chips)
Seat 8: zDOE5r14tWqCf6xhuSHK6g ($41 in chips)
Seat 9: qheQay5YvP2DMAb3OUSxtw ($100 in chips)
PkGfq5xrSlNsujKaG/HF4Q: posts small blind $0.50
OvwYHV65yUbgdBjSmo1+5g: posts big blind $1
*** HOLE CARDS ***
SyS20PAm3RpT6uLBsGkwOA: calls $1
zDOE5r14tWqCf6xhuSHK6g: folds
qheQay5YvP2DMAb3OUSxtw: folds
9BZCcac3+McErkkSN2YScA: folds
PTAFYDIUSsG+SArbxNl+Aw: folds
yAbu2QsRPVcjPbqlf/jDxw: folds
997ViqAtWn1FPjJqcffwcA: raises $1 to $2
PkGfq5xrSlNsujKaG/HF4Q: folds
OvwYHV65yUbgdBjSmo1+5g: folds
SyS20PAm3RpT6uLBsGkwOA: raises $4 to $6
997ViqAtWn1FPjJqcffwcA: folds
SyS20PAm3RpT6uLBsGkwOA collected $5.50 from pot
*** SUMMARY ***
Total pot $5.50 | Rake $0
Seat 1: 9BZCcac3+McErkkSN2YScA folded before Flop (didn't bet)
Seat 2: PTAFYDIUSsG+SArbxNl+Aw folded before Flop (didn't bet)
Seat 3: yAbu2QsRPVcjPbqlf/jDxw folded before Flop (didn't bet)
Seat 4: 997ViqAtWn1FPjJqcffwcA (button) folded before Flop
Seat 5: PkGfq5xrSlNsujKaG/HF4Q (small blind) folded before Flop
Seat 6: OvwYHV65yUbgdBjSmo1+5g (big blind) folded before Flop
Seat 7: SyS20PAm3RpT6uLBsGkwOA collected ($5.50)
Seat 8: zDOE5r14tWqCf6xhuSHK6g folded before Flop (didn't bet)
Seat 9: qheQay5YvP2DMAb3OUSxtw folded before Flop (didn't bet)



PokerStars Game #59940877052:  Hold'em No Limit ($0.50/$1.00) - 2009/07/01 1:19:12 ET
Table 'kS0cTQAEi+fdUlJP2gQYvw' 9-max Seat #5 is the button
Seat 1: c/9X4zftzphFxYtxp5kp9w ($78.75 in chips)
Seat 2: D+W9Me7w6Hcx/WRUSKV0dw ($26.55 in chips)
Seat 3: 2BV+oJIQYr65IO6nEChvbA ($60 in chips)
Seat 4: RUhhaALzha3TH1AkdakoGQ ($40 in chips)
Seat 5: 997ViqAtWn1FPjJqcffwcA ($103.40 in chips)
Seat 6: yAbu2QsRPVcjPbqlf/jDxw ($125.15 in chips)
Seat 7: Ffa7Nj4X5fddtROP01hfQg ($163.10 in chips)
Seat 8: vKyFzTyzfT7fZcdX+HHN+Q ($20.40 in chips)
Seat 9: OGgaARGdJQT4awWVNQ957w ($100 in chips)
yAbu2QsRPVcjPbqlf/jDxw: posts small blind $0.50
Ffa7Nj4X5fddtROP01hfQg: posts big blind $1
*** HOLE CARDS ***
vKyFzTyzfT7fZcdX+HHN+Q: calls $1
OGgaARGdJQT4awWVNQ957w: folds
c/9X4zftzphFxYtxp5kp9w: folds
D+W9Me7w6Hcx/WRUSKV0dw: folds
2BV+oJIQYr65IO6nEChvbA: folds
RUhhaALzha3TH1AkdakoGQ: folds
997ViqAtWn1FPjJqcffwcA: folds
yAbu2QsRPVcjPbqlf/jDxw: folds
Ffa7Nj4X5fddtROP01hfQg: raises $1 to $2
vKyFzTyzfT7fZcdX+HHN+Q: calls $1
*** FLOP *** [Ac Qh 6d]
Ffa7Nj4X5fddtROP01hfQg: bets $2
vKyFzTyzfT7fZcdX+HHN+Q: raises $4 to $6
Ffa7Nj4X5fddtROP01hfQg: calls $4
*** TURN *** [Ac Qh 6d] [Ah]
Ffa7Nj4X5fddtROP01hfQg: checks
vKyFzTyzfT7fZcdX+HHN+Q: bets $12.40 and is all-in
Ffa7Nj4X5fddtROP01hfQg: folds
vKyFzTyzfT7fZcdX+HHN+Q collected $15.70 from pot
*** SUMMARY ***
Total pot $16.50 | Rake $0.80
Board [Ac Qh 6d Ah]
Seat 1: c/9X4zftzphFxYtxp5kp9w folded before Flop (didn't bet)
Seat 2: D+W9Me7w6Hcx/WRUSKV0dw folded before Flop (didn't bet)
Seat 3: 2BV+oJIQYr65IO6nEChvbA folded before Flop (didn't bet)
Seat 4: RUhhaALzha3TH1AkdakoGQ folded before Flop (didn't bet)
Seat 5: 997ViqAtWn1FPjJqcffwcA (button) folded before Flop (didn't bet)
Seat 6: yAbu2QsRPVcjPbqlf/jDxw (small blind) folded before Flop
Seat 7: Ffa7Nj4X5fddtROP01hfQg (big blind) folded on the Turn
Seat 8: vKyFzTyzfT7fZcdX+HHN+Q collected ($15.70)
Seat 9: OGgaARGdJQT4awWVNQ957w folded before Flop (didn't bet)



PokerStars Game #59940877452:  Hold'em No Limit ($0.50/$1.00) - 2009/07/01 1:19:12 ET
Table 'mmbQQVBTrPdE+wy+s+9VPA' 6-max Seat #5 is the button
Seat 1: zyP4SPoWZnKUfTvIRLCVog ($63.75 in chips)
Seat 2: XK4Qsl+DA8gAJyg85/zBIw ($17.95 in chips)
Seat 3: wx3sQGkVi2x9wJXuWNHPBw ($128.85 in chips)
Seat 4: V3iZdcw61nXF3g5hD2RrsQ ($106.40 in chips)
Seat 5: YMJG+F++3Aj6P8dAWda5fw ($107 in chips)
Seat 6: U2CWBTv29qdCbj8RNF2sIw ($96.60 in chips)
U2CWBTv29qdCbj8RNF2sIw: posts small blind $0.50
zyP4SPoWZnKUfTvIRLCVog: posts big blind $1
*** HOLE CARDS ***
XK4Qsl+DA8gAJyg85/zBIw: folds
wx3sQGkVi2x9wJXuWNHPBw: folds
V3iZdcw61nXF3g5hD2RrsQ: folds
YMJG+F++3Aj6P8dAWda5fw: folds
U2CWBTv29qdCbj8RNF2sIw: raises $2 to $3
zyP4SPoWZnKUfTvIRLCVog: raises $6 to $9
U2CWBTv29qdCbj8RNF2sIw: calls $6
*** FLOP *** [Ts As 5c]
U2CWBTv29qdCbj8RNF2sIw: checks
zyP4SPoWZnKUfTvIRLCVog: bets $4
U2CWBTv29qdCbj8RNF2sIw: folds
zyP4SPoWZnKUfTvIRLCVog collected $17.10 from pot
*** SUMMARY ***
Total pot $18 | Rake $0.90
Board [Ts As 5c]
Seat 1: zyP4SPoWZnKUfTvIRLCVog (big blind) collected ($17.10)
Seat 2: XK4Qsl+DA8gAJyg85/zBIw folded before Flop (didn't bet)
Seat 3: wx3sQGkVi2x9wJXuWNHPBw folded before Flop (didn't bet)
Seat 4: V3iZdcw61nXF3g5hD2RrsQ folded before Flop (didn't bet)
Seat 5: YMJG+F++3Aj6P8dAWda5fw (button) folded before Flop (didn't bet)
Seat 6: U2CWBTv29qdCbj8RNF2sIw (small blind) folded on the Flop



PokerStars Game #59940877870:  Hold'em No Limit ($0.50/$1.00) - 2009/07/01 1:19:13 ET
Table 'vs/5jr6ciwjVQ5+Soc+u2A' 6-max Seat #4 is the button
Seat 1: J798qwLuvXyq0BbzsIjOrA ($91.20 in chips)
Seat 2: lXX4W7m3u++JiSOZ46yVMQ ($105.65 in chips)
Seat 3: G5ZSSN6RSON3gkNvk/SmYg ($138.10 in chips)
Seat 4: wk6Ohn4GDozoOMHc4eb2rw ($60.80 in chips)
Seat 5: +Nt3OPk3XR9SKjZgm2CexQ ($149.60 in chips)
Seat 6: Z2fXsGcjl+Eax+RzOgwOmg ($101.50 in chips)
+Nt3OPk3XR9SKjZgm2CexQ: posts small blind $0.50
Z2fXsGcjl+Eax+RzOgwOmg: posts big blind $1
*** HOLE CARDS ***
J798qwLuvXyq0BbzsIjOrA: folds
lXX4W7m3u++JiSOZ46yVMQ: raises $2 to $3
G5ZSSN6RSON3gkNvk/SmYg: folds
wk6Ohn4GDozoOMHc4eb2rw: folds
+Nt3OPk3XR9SKjZgm2CexQ: folds
Z2fXsGcjl+Eax+RzOgwOmg: folds
lXX4W7m3u++JiSOZ46yVMQ collected $2.50 from pot
*** SUMMARY ***
Total pot $2.50 | Rake $0
Seat 1: J798qwLuvXyq0BbzsIjOrA folded before Flop (didn't bet)
Seat 2: lXX4W7m3u++JiSOZ46yVMQ collected ($2.50)
Seat 3: G5ZSSN6RSON3gkNvk/SmYg folded before Flop (didn't bet)
Seat 4: wk6Ohn4GDozoOMHc4eb2rw (button) folded before Flop (didn't bet)
Seat 5: +Nt3OPk3XR9SKjZgm2CexQ (small blind) folded before Flop
Seat 6: Z2fXsGcjl+Eax+RzOgwOmg (big blind) folded before Flop



PokerStars Game #59940877824:  Hold'em No Limit ($0.50/$1.00) - 2009/07/01 1:19:13 ET
Table 'MUPc8FEpe/nR0BKSeReX6Q' 6-max Seat #3 is the button
Seat 1: qhkK6+yCciTRd+rCFEbnEQ ($42.10 in chips)
Seat 2: xAU6q2/cwmby2sxmA8VcmA ($113.20 in chips)
Seat 3: wx3sQGkVi2x9wJXuWNHPBw ($224.50 in chips)
Seat 4: ZA1bp6g8IwtTxkUE4eCjDQ ($194.20 in chips)
Seat 5: y27w5IK2WXqmYzS8OU0wKA ($101.50 in chips)
Seat 6: oxnw0GLLpFanjhGkxfRSqA ($49.95 in chips)
ZA1bp6g8IwtTxkUE4eCjDQ: posts small blind $0.50
y27w5IK2WXqmYzS8OU0wKA: posts big blind $1
*** HOLE CARDS ***
oxnw0GLLpFanjhGkxfRSqA: raises $2 to $3
qhkK6+yCciTRd+rCFEbnEQ: calls $3
xAU6q2/cwmby2sxmA8VcmA: folds
wx3sQGkVi2x9wJXuWNHPBw: folds
ZA1bp6g8IwtTxkUE4eCjDQ: calls $2.50
y27w5IK2WXqmYzS8OU0wKA: folds
*** FLOP *** [Kd 4s 9s]
ZA1bp6g8IwtTxkUE4eCjDQ: checks
oxnw0GLLpFanjhGkxfRSqA: checks
qhkK6+yCciTRd+rCFEbnEQ: checks
*** TURN *** [Kd 4s 9s] [Jh]
ZA1bp6g8IwtTxkUE4eCjDQ: checks
oxnw0GLLpFanjhGkxfRSqA: checks
qhkK6+yCciTRd+rCFEbnEQ: bets $4
ZA1bp6g8IwtTxkUE4eCjDQ: raises $5 to $9
oxnw0GLLpFanjhGkxfRSqA: folds
qhkK6+yCciTRd+rCFEbnEQ: calls $5
*** RIVER *** [Kd 4s 9s Jh] [Ks]
ZA1bp6g8IwtTxkUE4eCjDQ: bets $39
qhkK6+yCciTRd+rCFEbnEQ: calls $30.10 and is all-in
*** SHOW DOWN ***
ZA1bp6g8IwtTxkUE4eCjDQ: shows [5s 6s] (a flush, King high)
qhkK6+yCciTRd+rCFEbnEQ: shows [Qs 8s] (a flush, King high - Queen higher)
qhkK6+yCciTRd+rCFEbnEQ collected $85.20 from pot
*** SUMMARY ***
Total pot $88.20 | Rake $3
Board [Kd 4s 9s Jh Ks]
Seat 1: qhkK6+yCciTRd+rCFEbnEQ showed [Qs 8s] and won ($85.20) with a flush, King high
Seat 2: xAU6q2/cwmby2sxmA8VcmA folded before Flop (didn't bet)
Seat 3: wx3sQGkVi2x9wJXuWNHPBw (button) folded before Flop (didn't bet)
Seat 4: ZA1bp6g8IwtTxkUE4eCjDQ (small blind) showed [5s 6s] and lost with a flush, King high
Seat 5: y27w5IK2WXqmYzS8OU0wKA (big blind) folded before Flop
Seat 6: oxnw0GLLpFanjhGkxfRSqA folded on the Turn



PokerStars Game #59940880604:  Hold'em No Limit ($0.50/$1.00) - 2009/07/01 1:19:18 ET
Table 'SQLOQoANiHscJ8AL7zffbw' 9-max Seat #2 is the button
Seat 1: jPTRd6SpCp4xqAy2XQiTOw ($54.90 in chips)
Seat 2: /zy+DB4S5fUQUSfZWFzYGw ($395.05 in chips)
Seat 3: 0eFnow7+D7veCYQ+CG9FFw ($103.50 in chips)
Seat 4: 5z1PAR8SNow/zUfYNbwq7A ($55.25 in chips)
Seat 5: L9njYvloJ1NdXjP8edHEAg ($100 in chips)
Seat 6: H+DVy3Ei8L1UKS2tVOtJcw ($100 in chips)
Seat 7: bJckevFOcg//s0qyMQI6sQ ($103.05 in chips)
Seat 9: qJr25HAtvv1w/7IBvjMM3g ($198.65 in chips)
0eFnow7+D7veCYQ+CG9FFw: posts small blind $0.50
5z1PAR8SNow/zUfYNbwq7A: posts big blind $1
9BZCcac3+McErkkSN2YScA: sits out
*** HOLE CARDS ***
L9njYvloJ1NdXjP8edHEAg: folds
H+DVy3Ei8L1UKS2tVOtJcw: folds
bJckevFOcg//s0qyMQI6sQ: folds
qJr25HAtvv1w/7IBvjMM3g: raises $1 to $2
jPTRd6SpCp4xqAy2XQiTOw: calls $2
/zy+DB4S5fUQUSfZWFzYGw: folds
0eFnow7+D7veCYQ+CG9FFw: folds
5z1PAR8SNow/zUfYNbwq7A: calls $1
*** FLOP *** [Jd Ks 3c]
5z1PAR8SNow/zUfYNbwq7A: checks
qJr25HAtvv1w/7IBvjMM3g: checks
jPTRd6SpCp4xqAy2XQiTOw: checks
*** TURN *** [Jd Ks 3c] [9s]
5z1PAR8SNow/zUfYNbwq7A: bets $2
qJr25HAtvv1w/7IBvjMM3g: folds
jPTRd6SpCp4xqAy2XQiTOw: folds
5z1PAR8SNow/zUfYNbwq7A collected $6.20 from pot
*** SUMMARY ***
Total pot $6.50 | Rake $0.30
Board [Jd Ks 3c 9s]
Seat 1: jPTRd6SpCp4xqAy2XQiTOw folded on the Turn
Seat 2: /zy+DB4S5fUQUSfZWFzYGw (button) folded before Flop (didn't bet)
Seat 3: 0eFnow7+D7veCYQ+CG9FFw (small blind) folded before Flop
Seat 4: 5z1PAR8SNow/zUfYNbwq7A (big blind) collected ($6.20)
Seat 5: L9njYvloJ1NdXjP8edHEAg folded before Flop (didn't bet)
Seat 6: H+DVy3Ei8L1UKS2tVOtJcw folded before Flop (didn't bet)
Seat 7: bJckevFOcg//s0qyMQI6sQ folded before Flop (didn't bet)
Seat 9: qJr25HAtvv1w/7IBvjMM3g folded on the Turn



PokerStars Game #59940881524:  Hold'em No Limit ($0.50/$1.00) - 2009/07/01 1:19:19 ET
Table 'uNlePsyMIqzM691Xkrlk6Q' 9-max Seat #1 is the button
Seat 1: bLbSOSmSOnqE0iTcH/5dxA ($114 in chips)
Seat 2: +OqpStnt0FqbCfyHAWaLbg ($87.80 in chips)
Seat 3: h7qXkU57Bb8ZuPwMyxR8Ug ($38.50 in chips)
Seat 4: TRx/IDriSKVaxeebBKhcFQ ($20.90 in chips)
Seat 5: 9jIz1JKIpvRv9Xv6qqhAMA ($76.80 in chips)
Seat 7: KNAaBvPYSXyLqb88ypSbuQ ($26.95 in chips)
Seat 8: yWcEtGJ3ijZsF6HqlHqkrg ($105.40 in chips)
+OqpStnt0FqbCfyHAWaLbg: posts small blind $0.50
h7qXkU57Bb8ZuPwMyxR8Ug: posts big blind $1
froChili: sits out
OGgaARGdJQT4awWVNQ957w: sits out
*** HOLE CARDS ***
TRx/IDriSKVaxeebBKhcFQ: folds
9jIz1JKIpvRv9Xv6qqhAMA: folds
KNAaBvPYSXyLqb88ypSbuQ: folds
yWcEtGJ3ijZsF6HqlHqkrg: folds
bLbSOSmSOnqE0iTcH/5dxA: folds
+OqpStnt0FqbCfyHAWaLbg: calls $0.50
h7qXkU57Bb8ZuPwMyxR8Ug: checks
*** FLOP *** [Th Qh 9c]
+OqpStnt0FqbCfyHAWaLbg: checks
h7qXkU57Bb8ZuPwMyxR8Ug: bets $1
+OqpStnt0FqbCfyHAWaLbg: calls $1
*** TURN *** [Th Qh 9c] [9h]
+OqpStnt0FqbCfyHAWaLbg: bets $2
h7qXkU57Bb8ZuPwMyxR8Ug: calls $2
*** RIVER *** [Th Qh 9c 9h] [8s]
+OqpStnt0FqbCfyHAWaLbg: bets $4
h7qXkU57Bb8ZuPwMyxR8Ug: calls $4
*** SHOW DOWN ***
+OqpStnt0FqbCfyHAWaLbg: shows [2d Ks] (a pair of Nines)
h7qXkU57Bb8ZuPwMyxR8Ug: shows [Td Jc] (a straight, Eight to Queen)
h7qXkU57Bb8ZuPwMyxR8Ug collected $15.25 from pot
*** SUMMARY ***
Total pot $16 | Rake $0.75
Board [Th Qh 9c 9h 8s]
Seat 1: bLbSOSmSOnqE0iTcH/5dxA (button) folded before Flop (didn't bet)
Seat 2: +OqpStnt0FqbCfyHAWaLbg (small blind) showed [2d Ks] and lost with a pair of Nines
Seat 3: h7qXkU57Bb8ZuPwMyxR8Ug (big blind) showed [Td Jc] and won ($15.25) with a straight, Eight to Queen
Seat 4: TRx/IDriSKVaxeebBKhcFQ folded before Flop (didn't bet)
Seat 5: 9jIz1JKIpvRv9Xv6qqhAMA folded before Flop (didn't bet)
Seat 7: KNAaBvPYSXyLqb88ypSbuQ folded before Flop (didn't bet)
Seat 8: yWcEtGJ3ijZsF6HqlHqkrg folded before Flop (didn't bet)



PokerStars Game #59940882322:  Hold'em No Limit ($0.50/$1.00) - 2009/07/01 1:19:21 ET
Table 'W/wyObTiXZm+Ckkl3YxcSw' 6-max Seat #6 is the button
Seat 1: eUBBn2R56C1IQ6Cs/vitwg ($299.40 in chips)
Seat 2: oDiBRCaF0QVtd3kO6xZIXw ($149.15 in chips)
Seat 3: dxyNCn/qxfkGDUIf28Cbng ($69.30 in chips)
Seat 5: +OrCjyw70oZhJiD22Mn+bg ($101.50 in chips)
Seat 6: b2a+5TkFf4xJN/Ihhma58Q ($36.50 in chips)
eUBBn2R56C1IQ6Cs/vitwg: posts small blind $0.50
oDiBRCaF0QVtd3kO6xZIXw: posts big blind $1
UBZQqpnJZdTYYY1FTb0rLA: sits out
*** HOLE CARDS ***
dxyNCn/qxfkGDUIf28Cbng: folds
+OrCjyw70oZhJiD22Mn+bg: folds
b2a+5TkFf4xJN/Ihhma58Q: folds
eUBBn2R56C1IQ6Cs/vitwg: folds
oDiBRCaF0QVtd3kO6xZIXw collected $1 from pot
oDiBRCaF0QVtd3kO6xZIXw: doesn't show hand
*** SUMMARY ***
Total pot $1 | Rake $0
Seat 1: eUBBn2R56C1IQ6Cs/vitwg (small blind) folded before Flop
Seat 2: oDiBRCaF0QVtd3kO6xZIXw (big blind) collected ($1)
Seat 3: dxyNCn/qxfkGDUIf28Cbng folded before Flop (didn't bet)
Seat 5: +OrCjyw70oZhJiD22Mn+bg folded before Flop (didn't bet)
Seat 6: b2a+5TkFf4xJN/Ihhma58Q (button) folded before Flop (didn't bet)



PokerStars Game #59940882918:  Hold'em No Limit ($0.50/$1.00) - 2009/07/01 1:19:22 ET
Table 'MNvFfRVQNka/oY+Z5aMbZQ' 2-max Seat #2 is the button
Seat 1: DaZnoWHjO897dnh0CL2lVg ($62.15 in chips)
Seat 2: mgi+mjKb1Sc3CCs7TlfoCw ($62.05 in chips)
mgi+mjKb1Sc3CCs7TlfoCw: posts small blind $0.50
DaZnoWHjO897dnh0CL2lVg: posts big blind $1
*** HOLE CARDS ***
mgi+mjKb1Sc3CCs7TlfoCw: folds
DaZnoWHjO897dnh0CL2lVg collected $1 from pot
DaZnoWHjO897dnh0CL2lVg: doesn't show hand
*** SUMMARY ***
Total pot $1 | Rake $0
Seat 1: DaZnoWHjO897dnh0CL2lVg (big blind) collected ($1)
Seat 2: mgi+mjKb1Sc3CCs7TlfoCw (button) (small blind) folded before Flop



PokerStars Game #59940885206:  Hold'em No Limit ($0.50/$1.00) - 2009/07/01 1:19:26 ET
Table '7O9fB8yx1u7sJveJn8w6jA' 6-max Seat #1 is the button
Seat 1: jy52+7FotjH63o5tEEVgKw ($59.15 in chips)
Seat 2: wx3sQGkVi2x9wJXuWNHPBw ($201.20 in chips)
Seat 3: hpxXcmRkXXI9HE5+5/j/0Q ($124.25 in chips)
Seat 4: b2a+5TkFf4xJN/Ihhma58Q ($35.80 in chips)
Seat 5: BCEV3COoKY607AzLWayfRA ($100.35 in chips)
wx3sQGkVi2x9wJXuWNHPBw: posts small blind $0.50
hpxXcmRkXXI9HE5+5/j/0Q: posts big blind $1
6hLdALbOlkzGIrc53QKtPw: sits out
*** HOLE CARDS ***
b2a+5TkFf4xJN/Ihhma58Q: raises $1 to $2
BCEV3COoKY607AzLWayfRA: folds
jy52+7FotjH63o5tEEVgKw: folds
wx3sQGkVi2x9wJXuWNHPBw: folds
hpxXcmRkXXI9HE5+5/j/0Q: folds
b2a+5TkFf4xJN/Ihhma58Q collected $2.50 from pot
*** SUMMARY ***
Total pot $2.50 | Rake $0
Seat 1: jy52+7FotjH63o5tEEVgKw (button) folded before Flop (didn't bet)
Seat 2: wx3sQGkVi2x9wJXuWNHPBw (small blind) folded before Flop
Seat 3: hpxXcmRkXXI9HE5+5/j/0Q (big blind) folded before Flop
Seat 4: b2a+5TkFf4xJN/Ihhma58Q collected ($2.50)
Seat 5: BCEV3COoKY607AzLWayfRA folded before Flop (didn't bet)



PokerStars Game #59940886064:  Hold'em No Limit ($0.50/$1.00) - 2009/07/01 1:19:27 ET
Table '8jIjWCPY0NGprquL+xcMFg' 9-max Seat #1 is the button
Seat 1: tU883G5KFwdH+p2tFuGYtw ($50 in chips)
Seat 2: 7VpIzVwja9q3vCCNM7gRrg ($55.15 in chips)
Seat 3: myIxN7otsyr846M539YR8Q ($20 in chips)
Seat 4: XLnHQ8GEI3bUQAfNjJuO5Q ($68.85 in chips)
Seat 5: 2YpnxJiexJHyERfbqgwEcw ($47.55 in chips)
Seat 6: GTQkFJtSkbVbnGCktp6e3g ($101.50 in chips)
Seat 7: O5Go3jrzbQWxRB6ESK+Ptg ($46 in chips)
Seat 8: eI48VADSCFoNZBx4T9qs2w ($17.95 in chips)
Seat 9: DDzMn3tzCgfGf298Xxt5Iw ($16 in chips)
7VpIzVwja9q3vCCNM7gRrg: posts small blind $0.50
myIxN7otsyr846M539YR8Q: posts big blind $1
*** HOLE CARDS ***
XLnHQ8GEI3bUQAfNjJuO5Q: calls $1
2YpnxJiexJHyERfbqgwEcw: folds
GTQkFJtSkbVbnGCktp6e3g: folds
O5Go3jrzbQWxRB6ESK+Ptg: folds
eI48VADSCFoNZBx4T9qs2w: folds
DDzMn3tzCgfGf298Xxt5Iw: raises $8 to $9
tU883G5KFwdH+p2tFuGYtw: folds
7VpIzVwja9q3vCCNM7gRrg: folds
myIxN7otsyr846M539YR8Q: raises $11 to $20 and is all-in
XLnHQ8GEI3bUQAfNjJuO5Q: folds
DDzMn3tzCgfGf298Xxt5Iw: calls $7 and is all-in
*** FLOP *** [Jd 9s 9c]
*** TURN *** [Jd 9s 9c] [Qd]
*** RIVER *** [Jd 9s 9c Qd] [8c]
*** SHOW DOWN ***
myIxN7otsyr846M539YR8Q: shows [Ad Ac] (two pair, Aces and Nines)
DDzMn3tzCgfGf298Xxt5Iw: shows [Td Tc] (a straight, Eight to Queen)
DDzMn3tzCgfGf298Xxt5Iw collected $31.85 from pot
*** SUMMARY ***
Total pot $33.50 | Rake $1.65
Board [Jd 9s 9c Qd 8c]
Seat 1: tU883G5KFwdH+p2tFuGYtw (button) folded before Flop (didn't bet)
Seat 2: 7VpIzVwja9q3vCCNM7gRrg (small blind) folded before Flop
Seat 3: myIxN7otsyr846M539YR8Q (big blind) showed [Ad Ac] and lost with two pair, Aces and Nines
Seat 4: XLnHQ8GEI3bUQAfNjJuO5Q folded before Flop
Seat 5: 2YpnxJiexJHyERfbqgwEcw folded before Flop (didn't bet)
Seat 6: GTQkFJtSkbVbnGCktp6e3g folded before Flop (didn't bet)
Seat 7: O5Go3jrzbQWxRB6ESK+Ptg folded before Flop (didn't bet)
Seat 8: eI48VADSCFoNZBx4T9qs2w folded before Flop (didn't bet)
Seat 9: DDzMn3tzCgfGf298Xxt5Iw showed [Td Tc] and won ($31.85) with a straight, Eight to Queen



PokerStars Game #59940886382:  Hold'em No Limit ($0.50/$1.00) - 2009/07/01 1:19:28 ET
Table 'MNvFfRVQNka/oY+Z5aMbZQ' 2-max Seat #1 is the button
Seat 1: DaZnoWHjO897dnh0CL2lVg ($62.65 in chips)
Seat 2: mgi+mjKb1Sc3CCs7TlfoCw ($61.55 in chips)
DaZnoWHjO897dnh0CL2lVg: posts small blind $0.50
mgi+mjKb1Sc3CCs7TlfoCw: posts big blind $1
*** HOLE CARDS ***
DaZnoWHjO897dnh0CL2lVg: folds
mgi+mjKb1Sc3CCs7TlfoCw collected $1 from pot
mgi+mjKb1Sc3CCs7TlfoCw: doesn't show hand
*** SUMMARY ***
Total pot $1 | Rake $0
Seat 1: DaZnoWHjO897dnh0CL2lVg (button) (small blind) folded before Flop
Seat 2: mgi+mjKb1Sc3CCs7TlfoCw (big blind) collected ($1)



PokerStars Game #59940887160:  Hold'em No Limit ($0.50/$1.00) - 2009/07/01 1:19:29 ET
Table 'fTlPiCj0utgzC/5io+I7ew' 6-max Seat #6 is the button
Seat 1: YMJG+F++3Aj6P8dAWda5fw ($98.55 in chips)
Seat 2: KDYsHh8K2SUXXDvLsAhbJQ ($21.60 in chips)
Seat 3: Z2fXsGcjl+Eax+RzOgwOmg ($102.50 in chips)
Seat 4: uJVSceLggtsrJya+WtmUEA ($173.65 in chips)
Seat 5: XUk5GQsfNFpHvaToDZ0rZA ($54.15 in chips)
Seat 6: y27w5IK2WXqmYzS8OU0wKA ($100 in chips)
YMJG+F++3Aj6P8dAWda5fw: posts small blind $0.50
KDYsHh8K2SUXXDvLsAhbJQ: posts big blind $1
*** HOLE CARDS ***
Z2fXsGcjl+Eax+RzOgwOmg: folds
uJVSceLggtsrJya+WtmUEA: folds
XUk5GQsfNFpHvaToDZ0rZA: folds
y27w5IK2WXqmYzS8OU0wKA: folds
YMJG+F++3Aj6P8dAWda5fw: folds
KDYsHh8K2SUXXDvLsAhbJQ collected $1 from pot
*** SUMMARY ***
Total pot $1 | Rake $0
Seat 1: YMJG+F++3Aj6P8dAWda5fw (small blind) folded before Flop
Seat 2: KDYsHh8K2SUXXDvLsAhbJQ (big blind) collected ($1)
Seat 3: Z2fXsGcjl+Eax+RzOgwOmg folded before Flop (didn't bet)
Seat 4: uJVSceLggtsrJya+WtmUEA folded before Flop (didn't bet)
Seat 5: XUk5GQsfNFpHvaToDZ0rZA folded before Flop (didn't bet)
Seat 6: y27w5IK2WXqmYzS8OU0wKA (button) folded before Flop (didn't bet)



PokerStars Game #59940888098:  Hold'em No Limit ($0.50/$1.00) - 2009/07/01 1:19:31 ET
Table 'O96CPOtvMBWP6kzuYDfdFA' 6-max Seat #5 is the button
Seat 1: 6alLXQIITA2EZ/lBeym8Dw ($123.75 in chips)
Seat 2: 4d1rWhpu8DzLmzMbR3QKyA ($109.85 in chips)
Seat 3: V89DGjxE171oPREEbAXiyg ($94.65 in chips)
Seat 4: /P4w1pHg2zHYg/4ubJ0dPw ($60 in chips)
Seat 5: G5ZSSN6RSON3gkNvk/SmYg ($100 in chips)
Seat 6: GYei5jXGWexiJYbAT2fELg ($34.15 in chips)
GYei5jXGWexiJYbAT2fELg: posts small blind $0.50
6alLXQIITA2EZ/lBeym8Dw: posts big blind $1
*** HOLE CARDS ***
4d1rWhpu8DzLmzMbR3QKyA: folds
V89DGjxE171oPREEbAXiyg: folds
/P4w1pHg2zHYg/4ubJ0dPw: folds
G5ZSSN6RSON3gkNvk/SmYg: folds
GYei5jXGWexiJYbAT2fELg: folds
6alLXQIITA2EZ/lBeym8Dw collected $1 from pot
*** SUMMARY ***
Total pot $1 | Rake $0
Seat 1: 6alLXQIITA2EZ/lBeym8Dw (big blind) collected ($1)
Seat 2: 4d1rWhpu8DzLmzMbR3QKyA folded before Flop (didn't bet)
Seat 3: V89DGjxE171oPREEbAXiyg folded before Flop (didn't bet)
Seat 4: /P4w1pHg2zHYg/4ubJ0dPw folded before Flop (didn't bet)
Seat 5: G5ZSSN6RSON3gkNvk/SmYg (button) folded before Flop (didn't bet)
Seat 6: GYei5jXGWexiJYbAT2fELg (small blind) folded before Flop



PokerStars Game #59940888350:  Hold'em No Limit ($0.50/$1.00) - 2009/07/01 1:19:31 ET
Table 'hdVBCnDy5t2X9dZo0AvD9w' 9-max Seat #4 is the button
Seat 1: sa/cZBFh73L9TapFXpn3BA ($98.45 in chips)
Seat 2: Ogn4JDV3mp4ZDKO49IFzKA ($20.50 in chips)
Seat 3: 1862487932 ($100 in chips)
Seat 4: YvSugbFKWSuAYx9iokQwUQ ($71.70 in chips)
Seat 5: H+DVy3Ei8L1UKS2tVOtJcw ($100 in chips)
Seat 6: bJckevFOcg//s0qyMQI6sQ ($100 in chips)
Seat 7: KqC3XiX79XzqwhoOYPVb4w ($163.05 in chips)
Seat 8: gUUvmqdVlmvpal6B8nYrmg ($144.40 in chips)
Seat 9: AMkLbywdoc0K30BTzaIfTQ ($183.40 in chips)
H+DVy3Ei8L1UKS2tVOtJcw: posts small blind $0.50
bJckevFOcg//s0qyMQI6sQ: posts big blind $1
*** HOLE CARDS ***
KqC3XiX79XzqwhoOYPVb4w: folds
gUUvmqdVlmvpal6B8nYrmg: folds
AMkLbywdoc0K30BTzaIfTQ: folds
sa/cZBFh73L9TapFXpn3BA: folds
Ogn4JDV3mp4ZDKO49IFzKA: calls $1
1862487932: folds
YvSugbFKWSuAYx9iokQwUQ: raises $2 to $3
H+DVy3Ei8L1UKS2tVOtJcw: folds
bJckevFOcg//s0qyMQI6sQ: folds
Ogn4JDV3mp4ZDKO49IFzKA: folds
YvSugbFKWSuAYx9iokQwUQ collected $3.50 from pot
YvSugbFKWSuAYx9iokQwUQ: doesn't show hand
*** SUMMARY ***
Total pot $3.50 | Rake $0
Seat 1: sa/cZBFh73L9TapFXpn3BA folded before Flop (didn't bet)
Seat 2: Ogn4JDV3mp4ZDKO49IFzKA folded before Flop
Seat 3: 1862487932 folded before Flop (didn't bet)
Seat 4: YvSugbFKWSuAYx9iokQwUQ (button) collected ($3.50)
Seat 5: H+DVy3Ei8L1UKS2tVOtJcw (small blind) folded before Flop
Seat 6: bJckevFOcg//s0qyMQI6sQ (big blind) folded before Flop
Seat 7: KqC3XiX79XzqwhoOYPVb4w folded before Flop (didn't bet)
Seat 8: gUUvmqdVlmvpal6B8nYrmg folded before Flop (didn't bet)
Seat 9: AMkLbywdoc0K30BTzaIfTQ folded before Flop (didn't bet)



PokerStars Game #59940888176:  Hold'em No Limit ($0.50/$1.00) - 2009/07/01 1:19:31 ET
Table 'W/wyObTiXZm+Ckkl3YxcSw' 6-max Seat #1 is the button
Seat 1: eUBBn2R56C1IQ6Cs/vitwg ($298.90 in chips)
Seat 2: oDiBRCaF0QVtd3kO6xZIXw ($149.65 in chips)
Seat 3: dxyNCn/qxfkGDUIf28Cbng ($69.30 in chips)
Seat 5: +OrCjyw70oZhJiD22Mn+bg ($101.50 in chips)
Seat 6: b2a+5TkFf4xJN/Ihhma58Q ($36.50 in chips)
oDiBRCaF0QVtd3kO6xZIXw: posts small blind $0.50
dxyNCn/qxfkGDUIf28Cbng: posts big blind $1
UBZQqpnJZdTYYY1FTb0rLA: sits out
*** HOLE CARDS ***
+OrCjyw70oZhJiD22Mn+bg: folds
b2a+5TkFf4xJN/Ihhma58Q: folds
eUBBn2R56C1IQ6Cs/vitwg: folds
oDiBRCaF0QVtd3kO6xZIXw: calls $0.50
dxyNCn/qxfkGDUIf28Cbng: checks
*** FLOP *** [As 9s 5c]
oDiBRCaF0QVtd3kO6xZIXw: bets $1.50
dxyNCn/qxfkGDUIf28Cbng: folds
oDiBRCaF0QVtd3kO6xZIXw collected $1.90 from pot
oDiBRCaF0QVtd3kO6xZIXw: doesn't show hand
*** SUMMARY ***
Total pot $2 | Rake $0.10
Board [As 9s 5c]
Seat 1: eUBBn2R56C1IQ6Cs/vitwg (button) folded before Flop (didn't bet)
Seat 2: oDiBRCaF0QVtd3kO6xZIXw (small blind) collected ($1.90)
Seat 3: dxyNCn/qxfkGDUIf28Cbng (big blind) folded on the Flop
Seat 5: +OrCjyw70oZhJiD22Mn+bg folded before Flop (didn't bet)
Seat 6: b2a+5TkFf4xJN/Ihhma58Q folded before Flop (didn't bet)



PokerStars Game #59940888536:  Hold'em No Limit ($0.50/$1.00) - 2009/07/01 1:19:32 ET
Table 'GPp0HyAuggN8oE0sUWzPpA' 9-max Seat #9 is the button
Seat 1: qJr25HAtvv1w/7IBvjMM3g ($45.25 in chips)
Seat 2: m3U8I35Pn3gxKhoS2nmYIg ($13.40 in chips)
Seat 3: CCCXsirC+bO7ginAuUUVlQ ($52.25 in chips)
Seat 4: mBRWbnUl8diyBO1qTJaNzw ($101.65 in chips)
Seat 5: bLbSOSmSOnqE0iTcH/5dxA ($100 in chips)
Seat 6: BK/GtNPkSx0TdUDj82id5A ($34.70 in chips)
Seat 7: DHdbHyysD15wCAtx+BhUjA ($96.70 in chips)
Seat 8: P/6qLjycEfxRgZ5F/W90dw ($96 in chips)
Seat 9: dzoSjPZmtjGuK83119030A ($39.15 in chips)
qJr25HAtvv1w/7IBvjMM3g: posts small blind $0.50
m3U8I35Pn3gxKhoS2nmYIg: posts big blind $1
*** HOLE CARDS ***
CCCXsirC+bO7ginAuUUVlQ: folds
mBRWbnUl8diyBO1qTJaNzw: folds
bLbSOSmSOnqE0iTcH/5dxA: folds
BK/GtNPkSx0TdUDj82id5A: folds
DHdbHyysD15wCAtx+BhUjA: folds
P/6qLjycEfxRgZ5F/W90dw: folds
dzoSjPZmtjGuK83119030A: raises $2 to $3
qJr25HAtvv1w/7IBvjMM3g: folds
m3U8I35Pn3gxKhoS2nmYIg: calls $2
*** FLOP *** [4d Jh Kc]
m3U8I35Pn3gxKhoS2nmYIg: checks
dzoSjPZmtjGuK83119030A: checks
*** TURN *** [4d Jh Kc] [9s]
m3U8I35Pn3gxKhoS2nmYIg: bets $3
dzoSjPZmtjGuK83119030A: raises $3 to $6
m3U8I35Pn3gxKhoS2nmYIg: raises $4.40 to $10.40 and is all-in
dzoSjPZmtjGuK83119030A: calls $4.40
*** RIVER *** [4d Jh Kc 9s] [Qd]
*** SHOW DOWN ***
m3U8I35Pn3gxKhoS2nmYIg: shows [Jc Kh] (two pair, Kings and Jacks)
dzoSjPZmtjGuK83119030A: mucks hand
m3U8I35Pn3gxKhoS2nmYIg collected $25.95 from pot
*** SUMMARY ***
Total pot $27.30 | Rake $1.35
Board [4d Jh Kc 9s Qd]
Seat 1: qJr25HAtvv1w/7IBvjMM3g (small blind) folded before Flop
Seat 2: m3U8I35Pn3gxKhoS2nmYIg (big blind) showed [Jc Kh] and won ($25.95) with two pair, Kings and Jacks
Seat 3: CCCXsirC+bO7ginAuUUVlQ folded before Flop (didn't bet)
Seat 4: mBRWbnUl8diyBO1qTJaNzw folded before Flop (didn't bet)
Seat 5: bLbSOSmSOnqE0iTcH/5dxA folded before Flop (didn't bet)
Seat 6: BK/GtNPkSx0TdUDj82id5A folded before Flop (didn't bet)
Seat 7: DHdbHyysD15wCAtx+BhUjA folded before Flop (didn't bet)
Seat 8: P/6qLjycEfxRgZ5F/W90dw folded before Flop (didn't bet)
Seat 9: dzoSjPZmtjGuK83119030A (button) mucked



PokerStars Game #59940889906:  Hold'em No Limit ($0.50/$1.00) - 2009/07/01 1:19:34 ET
Table 'vs/5jr6ciwjVQ5+Soc+u2A' 6-max Seat #5 is the button
Seat 1: J798qwLuvXyq0BbzsIjOrA ($91.20 in chips)
Seat 2: lXX4W7m3u++JiSOZ46yVMQ ($107.15 in chips)
Seat 3: G5ZSSN6RSON3gkNvk/SmYg ($138.10 in chips)
Seat 4: wk6Ohn4GDozoOMHc4eb2rw ($60.80 in chips)
Seat 5: +Nt3OPk3XR9SKjZgm2CexQ ($149.10 in chips)
Seat 6: Z2fXsGcjl+Eax+RzOgwOmg ($100.50 in chips)
Z2fXsGcjl+Eax+RzOgwOmg: posts small blind $0.50
J798qwLuvXyq0BbzsIjOrA: posts big blind $1
*** HOLE CARDS ***
lXX4W7m3u++JiSOZ46yVMQ: folds
G5ZSSN6RSON3gkNvk/SmYg: folds
wk6Ohn4GDozoOMHc4eb2rw: folds
+Nt3OPk3XR9SKjZgm2CexQ: folds
Z2fXsGcjl+Eax+RzOgwOmg: raises $2 to $3
J798qwLuvXyq0BbzsIjOrA: calls $2
*** FLOP *** [5d 8c 3h]
Z2fXsGcjl+Eax+RzOgwOmg: bets $4
J798qwLuvXyq0BbzsIjOrA: raises $6 to $10
Z2fXsGcjl+Eax+RzOgwOmg: calls $6
*** TURN *** [5d 8c 3h] [Td]
Z2fXsGcjl+Eax+RzOgwOmg: checks
J798qwLuvXyq0BbzsIjOrA: checks
*** RIVER *** [5d 8c 3h Td] [4s]
Z2fXsGcjl+Eax+RzOgwOmg: bets $11
J798qwLuvXyq0BbzsIjOrA: calls $11
*** SHOW DOWN ***
Z2fXsGcjl+Eax+RzOgwOmg: shows [8d Jd] (a pair of Eights)
J798qwLuvXyq0BbzsIjOrA: shows [9h 9s] (a pair of Nines)
J798qwLuvXyq0BbzsIjOrA collected $45.70 from pot
*** SUMMARY ***
Total pot $48 | Rake $2.30
Board [5d 8c 3h Td 4s]
Seat 1: J798qwLuvXyq0BbzsIjOrA (big blind) showed [9h 9s] and won ($45.70) with a pair of Nines
Seat 2: lXX4W7m3u++JiSOZ46yVMQ folded before Flop (didn't bet)
Seat 3: G5ZSSN6RSON3gkNvk/SmYg folded before Flop (didn't bet)
Seat 4: wk6Ohn4GDozoOMHc4eb2rw folded before Flop (didn't bet)
Seat 5: +Nt3OPk3XR9SKjZgm2CexQ (button) folded before Flop (didn't bet)
Seat 6: Z2fXsGcjl+Eax+RzOgwOmg (small blind) showed [8d Jd] and lost with a pair of Eights



PokerStars Game #59940889908:  Hold'em No Limit ($0.50/$1.00) - 2009/07/01 1:19:34 ET
Table 'MNvFfRVQNka/oY+Z5aMbZQ' 2-max Seat #2 is the button
Seat 1: DaZnoWHjO897dnh0CL2lVg ($62.15 in chips)
Seat 2: mgi+mjKb1Sc3CCs7TlfoCw ($62.05 in chips)
mgi+mjKb1Sc3CCs7TlfoCw: posts small blind $0.50
DaZnoWHjO897dnh0CL2lVg: posts big blind $1
*** HOLE CARDS ***
mgi+mjKb1Sc3CCs7TlfoCw: raises $2 to $3
DaZnoWHjO897dnh0CL2lVg: folds
mgi+mjKb1Sc3CCs7TlfoCw collected $2 from pot
mgi+mjKb1Sc3CCs7TlfoCw: doesn't show hand
*** SUMMARY ***
Total pot $2 | Rake $0
Seat 1: DaZnoWHjO897dnh0CL2lVg (big blind) folded before Flop
Seat 2: mgi+mjKb1Sc3CCs7TlfoCw (button) (small blind) collected ($2)



PokerStars Game #59940890830:  Hold'em No Limit ($0.50/$1.00) - 2009/07/01 1:19:36 ET
Table '7Nl0ffnjeK44/vmeexh3MQ' 9-max Seat #2 is the button
Seat 1: V138SURkdX8LdVBPKdJJag ($100 in chips)
Seat 2: OGgaARGdJQT4awWVNQ957w ($100.50 in chips)
Seat 3: JMmUYT5pIKCKh2pGjCB/4w ($55.90 in chips)
Seat 4: bLbSOSmSOnqE0iTcH/5dxA ($100 in chips)
Seat 5: 61sfw5QTu62YYIt68OsdrA ($81.50 in chips)
Seat 6: FVs16t7GgfWgQWt4JxsObQ ($30.75 in chips)
Seat 7: 997ViqAtWn1FPjJqcffwcA ($100 in chips)
Seat 8: D+W9Me7w6Hcx/WRUSKV0dw ($19.25 in chips)
Seat 9: ouwUBGRKnKK9uhn1G4Lf+A ($195.50 in chips)
JMmUYT5pIKCKh2pGjCB/4w: posts small blind $0.50
bLbSOSmSOnqE0iTcH/5dxA: posts big blind $1
*** HOLE CARDS ***
61sfw5QTu62YYIt68OsdrA: folds
FVs16t7GgfWgQWt4JxsObQ: calls $1
997ViqAtWn1FPjJqcffwcA: folds
D+W9Me7w6Hcx/WRUSKV0dw: folds
ouwUBGRKnKK9uhn1G4Lf+A: folds
V138SURkdX8LdVBPKdJJag: folds
OGgaARGdJQT4awWVNQ957w: folds
JMmUYT5pIKCKh2pGjCB/4w: calls $0.50
bLbSOSmSOnqE0iTcH/5dxA: checks
*** FLOP *** [3s Qc Tc]
JMmUYT5pIKCKh2pGjCB/4w: checks
bLbSOSmSOnqE0iTcH/5dxA: checks
FVs16t7GgfWgQWt4JxsObQ: checks
*** TURN *** [3s Qc Tc] [2c]
JMmUYT5pIKCKh2pGjCB/4w: checks
bLbSOSmSOnqE0iTcH/5dxA: checks
FVs16t7GgfWgQWt4JxsObQ: checks
*** RIVER *** [3s Qc Tc 2c] [6c]
JMmUYT5pIKCKh2pGjCB/4w: checks
bLbSOSmSOnqE0iTcH/5dxA: checks
FVs16t7GgfWgQWt4JxsObQ: checks
*** SHOW DOWN ***
JMmUYT5pIKCKh2pGjCB/4w: shows [2h Kd] (a pair of Deuces)
bLbSOSmSOnqE0iTcH/5dxA: shows [Jd Ts] (a pair of Tens)
FVs16t7GgfWgQWt4JxsObQ: mucks hand
bLbSOSmSOnqE0iTcH/5dxA collected $2.85 from pot
*** SUMMARY ***
Total pot $3 | Rake $0.15
Board [3s Qc Tc 2c 6c]
Seat 1: V138SURkdX8LdVBPKdJJag folded before Flop (didn't bet)
Seat 2: OGgaARGdJQT4awWVNQ957w (button) folded before Flop (didn't bet)
Seat 3: JMmUYT5pIKCKh2pGjCB/4w (small blind) showed [2h Kd] and lost with a pair of Deuces
Seat 4: bLbSOSmSOnqE0iTcH/5dxA (big blind) showed [Jd Ts] and won ($2.85) with a pair of Tens
Seat 5: 61sfw5QTu62YYIt68OsdrA folded before Flop (didn't bet)
Seat 6: FVs16t7GgfWgQWt4JxsObQ mucked
Seat 7: 997ViqAtWn1FPjJqcffwcA folded before Flop (didn't bet)
Seat 8: D+W9Me7w6Hcx/WRUSKV0dw folded before Flop (didn't bet)
Seat 9: ouwUBGRKnKK9uhn1G4Lf+A folded before Flop (didn't bet)



PokerStars Game #59940891272:  Hold'em No Limit ($0.50/$1.00) - 2009/07/01 1:19:37 ET
Table 'tJq9SfN1ywY0r03VBlWlwQ' 9-max Seat #6 is the button
Seat 1: wZsU+w9r7G66x93UuvBf1Q ($330.80 in chips)
Seat 3: FVs16t7GgfWgQWt4JxsObQ ($21.55 in chips)
Seat 4: bLbSOSmSOnqE0iTcH/5dxA ($109.20 in chips)
Seat 5: h5ipsNTMyolp7xn/NAvWkA ($108.45 in chips)
Seat 6: gUUvmqdVlmvpal6B8nYrmg ($100 in chips)
Seat 7: Pp/KTcXkfZKKUHkjyaLTdg ($19 in chips)
Seat 8: G4DEhsZFmznGNVpy2SEocA ($27.25 in chips)
Seat 9: XE5QF1y74bpHog9JxWJMWQ ($100.20 in chips)
Pp/KTcXkfZKKUHkjyaLTdg: posts small blind $0.50
G4DEhsZFmznGNVpy2SEocA: posts big blind $1
VPF+HjszMvUIpy0CHIwH3A: sits out
*** HOLE CARDS ***
XE5QF1y74bpHog9JxWJMWQ: folds
wZsU+w9r7G66x93UuvBf1Q: folds
FVs16t7GgfWgQWt4JxsObQ: calls $1
bLbSOSmSOnqE0iTcH/5dxA: raises $4 to $5
h5ipsNTMyolp7xn/NAvWkA: folds
gUUvmqdVlmvpal6B8nYrmg: folds
Pp/KTcXkfZKKUHkjyaLTdg: folds
G4DEhsZFmznGNVpy2SEocA: folds
FVs16t7GgfWgQWt4JxsObQ: calls $4
*** FLOP *** [6s Qs 6c]
FVs16t7GgfWgQWt4JxsObQ: checks
bLbSOSmSOnqE0iTcH/5dxA: bets $8
FVs16t7GgfWgQWt4JxsObQ: folds
bLbSOSmSOnqE0iTcH/5dxA collected $10.95 from pot
*** SUMMARY ***
Total pot $11.50 | Rake $0.55
Board [6s Qs 6c]
Seat 1: wZsU+w9r7G66x93UuvBf1Q folded before Flop (didn't bet)
Seat 3: FVs16t7GgfWgQWt4JxsObQ folded on the Flop
Seat 4: bLbSOSmSOnqE0iTcH/5dxA collected ($10.95)
Seat 5: h5ipsNTMyolp7xn/NAvWkA folded before Flop (didn't bet)
Seat 6: gUUvmqdVlmvpal6B8nYrmg (button) folded before Flop (didn't bet)
Seat 7: Pp/KTcXkfZKKUHkjyaLTdg (small blind) folded before Flop
Seat 8: G4DEhsZFmznGNVpy2SEocA (big blind) folded before Flop
Seat 9: XE5QF1y74bpHog9JxWJMWQ folded before Flop (didn't bet)



PokerStars Game #59940893504:  Hold'em No Limit ($0.50/$1.00) - 2009/07/01 1:19:40 ET
Table '+cA8mcmhaedZ7YcrDdhmeQ' 6-max Seat #4 is the button
Seat 2: 14aYclSc98EYd6TrzN2l3Q ($13 in chips)
Seat 3: DAIgyIWbYvAkL6PbAI27pg ($15.50 in chips)
Seat 4: 4OO5v3AVduL0tePNx8wk5A ($105.05 in chips)
Seat 6: YfsTQsY/fxb+YqbdclTHuw ($15.85 in chips)
6hLdALbOlkzGIrc53QKtPw: is sitting out
6hLdALbOlkzGIrc53QKtPw leaves the table
YfsTQsY/fxb+YqbdclTHuw: posts small blind $0.50
lsLuWlcPA3Rh7kJVLzMh0Q: is sitting out
lsLuWlcPA3Rh7kJVLzMh0Q leaves the table
n5xXfJeDtWZSChGAdq//Tw joins the table at seat #5
14aYclSc98EYd6TrzN2l3Q: posts big blind $1
*** HOLE CARDS ***
iIgNoBh+3/Ix1/fLsg+HuA joins the table at seat #1
DAIgyIWbYvAkL6PbAI27pg: folds
4OO5v3AVduL0tePNx8wk5A: folds
YfsTQsY/fxb+YqbdclTHuw: calls $0.50
14aYclSc98EYd6TrzN2l3Q: raises $1 to $2
YfsTQsY/fxb+YqbdclTHuw: calls $1
*** FLOP *** [6s 3c Td]
YfsTQsY/fxb+YqbdclTHuw: checks
14aYclSc98EYd6TrzN2l3Q: bets $4
YfsTQsY/fxb+YqbdclTHuw: folds
14aYclSc98EYd6TrzN2l3Q collected $3.80 from pot
14aYclSc98EYd6TrzN2l3Q: doesn't show hand
*** SUMMARY ***
Total pot $4 | Rake $0.20
Board [6s 3c Td]
Seat 2: 14aYclSc98EYd6TrzN2l3Q (big blind) collected ($3.80)
Seat 3: DAIgyIWbYvAkL6PbAI27pg folded before Flop (didn't bet)
Seat 4: 4OO5v3AVduL0tePNx8wk5A (button) folded before Flop (didn't bet)
Seat 6: YfsTQsY/fxb+YqbdclTHuw (small blind) folded on the Flop



PokerStars Game #59940894514:  Hold'em No Limit ($0.50/$1.00) - 2009/07/01 1:19:42 ET
Table 'MNvFfRVQNka/oY+Z5aMbZQ' 2-max Seat #1 is the button
Seat 1: DaZnoWHjO897dnh0CL2lVg ($61.15 in chips)
Seat 2: mgi+mjKb1Sc3CCs7TlfoCw ($63.05 in chips)
DaZnoWHjO897dnh0CL2lVg: posts small blind $0.50
mgi+mjKb1Sc3CCs7TlfoCw: posts big blind $1
*** HOLE CARDS ***
DaZnoWHjO897dnh0CL2lVg: folds
mgi+mjKb1Sc3CCs7TlfoCw collected $1 from pot
mgi+mjKb1Sc3CCs7TlfoCw: doesn't show hand
*** SUMMARY ***
Total pot $1 | Rake $0
Seat 1: DaZnoWHjO897dnh0CL2lVg (button) (small blind) folded before Flop
Seat 2: mgi+mjKb1Sc3CCs7TlfoCw (big blind) collected ($1)



PokerStars Game #59940894784:  Hold'em No Limit ($0.50/$1.00) - 2009/07/01 1:19:43 ET
Table '/RZcOwpZpHQ+OwPwjsbnRw' 6-max Seat #3 is the button
Seat 1: +uSzP8Jwnw7sKfQ4s66b7w ($52.25 in chips)
Seat 2: Z2fXsGcjl+Eax+RzOgwOmg ($103 in chips)
Seat 3: 6hLdALbOlkzGIrc53QKtPw ($20 in chips)
Seat 4: j7NIOHLZk7V2o9fOioO5ug ($144.20 in chips)
Seat 5: wx3sQGkVi2x9wJXuWNHPBw ($166.25 in chips)
Seat 6: o3YLm/rSY916m/on1VjXPA ($100 in chips)
j7NIOHLZk7V2o9fOioO5ug: posts small blind $0.50
wx3sQGkVi2x9wJXuWNHPBw: posts big blind $1
*** HOLE CARDS ***
o3YLm/rSY916m/on1VjXPA: folds
+uSzP8Jwnw7sKfQ4s66b7w: folds
Z2fXsGcjl+Eax+RzOgwOmg: folds
6hLdALbOlkzGIrc53QKtPw: raises $1 to $2
j7NIOHLZk7V2o9fOioO5ug: folds
wx3sQGkVi2x9wJXuWNHPBw: calls $1
*** FLOP *** [Jh Js Ah]
wx3sQGkVi2x9wJXuWNHPBw: checks
6hLdALbOlkzGIrc53QKtPw: checks
*** TURN *** [Jh Js Ah] [Tc]
wx3sQGkVi2x9wJXuWNHPBw: bets $4
6hLdALbOlkzGIrc53QKtPw: folds
wx3sQGkVi2x9wJXuWNHPBw collected $4.30 from pot
*** SUMMARY ***
Total pot $4.50 | Rake $0.20
Board [Jh Js Ah Tc]
Seat 1: +uSzP8Jwnw7sKfQ4s66b7w folded before Flop (didn't bet)
Seat 2: Z2fXsGcjl+Eax+RzOgwOmg folded before Flop (didn't bet)
Seat 3: 6hLdALbOlkzGIrc53QKtPw (button) folded on the Turn
Seat 4: j7NIOHLZk7V2o9fOioO5ug (small blind) folded before Flop
Seat 5: wx3sQGkVi2x9wJXuWNHPBw (big blind) collected ($4.30)
Seat 6: o3YLm/rSY916m/on1VjXPA folded before Flop (didn't bet)



PokerStars Game #59940894744:  Hold'em No Limit ($0.50/$1.00) - 2009/07/01 1:19:43 ET
Table 'rmZfTK+oSebeUPJNbWhdAA' 6-max Seat #5 is the button
Seat 1: xAU6q2/cwmby2sxmA8VcmA ($143 in chips)
Seat 2: z7O9PO/WEcqRouIydFhS9Q ($147.95 in chips)
Seat 3: BCEV3COoKY607AzLWayfRA ($151.30 in chips)
Seat 4: 1/mIuXfgx1ZyVkodrmfQDw ($107.15 in chips)
Seat 5: 5lY8d6Cnm4HUkt/8FZSj4g ($58.25 in chips)
Seat 6: j7NIOHLZk7V2o9fOioO5ug ($145.40 in chips)
j7NIOHLZk7V2o9fOioO5ug: posts small blind $0.50
xAU6q2/cwmby2sxmA8VcmA: posts big blind $1
*** HOLE CARDS ***
z7O9PO/WEcqRouIydFhS9Q: folds
BCEV3COoKY607AzLWayfRA: folds
1/mIuXfgx1ZyVkodrmfQDw: folds
5lY8d6Cnm4HUkt/8FZSj4g: calls $1
j7NIOHLZk7V2o9fOioO5ug: calls $0.50
xAU6q2/cwmby2sxmA8VcmA: checks
*** FLOP *** [6s 8c 3h]
j7NIOHLZk7V2o9fOioO5ug: bets $3
xAU6q2/cwmby2sxmA8VcmA: folds
5lY8d6Cnm4HUkt/8FZSj4g: folds
j7NIOHLZk7V2o9fOioO5ug collected $2.85 from pot
j7NIOHLZk7V2o9fOioO5ug: doesn't show hand
*** SUMMARY ***
Total pot $3 | Rake $0.15
Board [6s 8c 3h]
Seat 1: xAU6q2/cwmby2sxmA8VcmA (big blind) folded on the Flop
Seat 2: z7O9PO/WEcqRouIydFhS9Q folded before Flop (didn't bet)
Seat 3: BCEV3COoKY607AzLWayfRA folded before Flop (didn't bet)
Seat 4: 1/mIuXfgx1ZyVkodrmfQDw folded before Flop (didn't bet)
Seat 5: 5lY8d6Cnm4HUkt/8FZSj4g (button) folded on the Flop
Seat 6: j7NIOHLZk7V2o9fOioO5ug (small blind) collected ($2.85)



PokerStars Game #59940896908:  Hold'em No Limit ($0.50/$1.00) - 2009/07/01 1:19:46 ET
Table 'cBDNutyLBKEk9+ptwsKmTw' 6-max Seat #4 is the button
Seat 1: xAU6q2/cwmby2sxmA8VcmA ($259.90 in chips)
Seat 2: 5lY8d6Cnm4HUkt/8FZSj4g ($82.50 in chips)
Seat 3: G5ZSSN6RSON3gkNvk/SmYg ($100 in chips)
Seat 4: 3q7F5QtzC30pSrn0nl9i+A ($20 in chips)
Seat 5: hpxXcmRkXXI9HE5+5/j/0Q ($100 in chips)
Seat 6: QHvTZcrKe6+maWUfVjP29Q ($100 in chips)
hpxXcmRkXXI9HE5+5/j/0Q: posts small blind $0.50
QHvTZcrKe6+maWUfVjP29Q: posts big blind $1
*** HOLE CARDS ***
xAU6q2/cwmby2sxmA8VcmA: folds
5lY8d6Cnm4HUkt/8FZSj4g: calls $1
G5ZSSN6RSON3gkNvk/SmYg: raises $4 to $5
3q7F5QtzC30pSrn0nl9i+A: folds
hpxXcmRkXXI9HE5+5/j/0Q: folds
QHvTZcrKe6+maWUfVjP29Q: folds
5lY8d6Cnm4HUkt/8FZSj4g: calls $4
*** FLOP *** [9s 3d 6h]
5lY8d6Cnm4HUkt/8FZSj4g: checks
G5ZSSN6RSON3gkNvk/SmYg: checks
*** TURN *** [9s 3d 6h] [7s]
5lY8d6Cnm4HUkt/8FZSj4g: checks
G5ZSSN6RSON3gkNvk/SmYg: checks
*** RIVER *** [9s 3d 6h 7s] [5c]
5lY8d6Cnm4HUkt/8FZSj4g: checks
G5ZSSN6RSON3gkNvk/SmYg: checks
*** SHOW DOWN ***
5lY8d6Cnm4HUkt/8FZSj4g: shows [Ks Th] (high card King)
G5ZSSN6RSON3gkNvk/SmYg: shows [Kh Qd] (high card King - Queen kicker)
G5ZSSN6RSON3gkNvk/SmYg collected $10.95 from pot
*** SUMMARY ***
Total pot $11.50 | Rake $0.55
Board [9s 3d 6h 7s 5c]
Seat 1: xAU6q2/cwmby2sxmA8VcmA folded before Flop (didn't bet)
Seat 2: 5lY8d6Cnm4HUkt/8FZSj4g showed [Ks Th] and lost with high card King
Seat 3: G5ZSSN6RSON3gkNvk/SmYg showed [Kh Qd] and won ($10.95) with high card King
Seat 4: 3q7F5QtzC30pSrn0nl9i+A (button) folded before Flop (didn't bet)
Seat 5: hpxXcmRkXXI9HE5+5/j/0Q (small blind) folded before Flop
Seat 6: QHvTZcrKe6+maWUfVjP29Q (big blind) folded before Flop



PokerStars Game #59940897340:  Hold'em No Limit ($0.50/$1.00) - 2009/07/01 1:19:47 ET
Table '7O9fB8yx1u7sJveJn8w6jA' 6-max Seat #2 is the button
Seat 1: jy52+7FotjH63o5tEEVgKw ($59.15 in chips)
Seat 2: wx3sQGkVi2x9wJXuWNHPBw ($200.70 in chips)
Seat 3: hpxXcmRkXXI9HE5+5/j/0Q ($123.25 in chips)
Seat 4: b2a+5TkFf4xJN/Ihhma58Q ($37.30 in chips)
Seat 5: BCEV3COoKY607AzLWayfRA ($100.35 in chips)
hpxXcmRkXXI9HE5+5/j/0Q: posts small blind $0.50
b2a+5TkFf4xJN/Ihhma58Q: posts big blind $1
6hLdALbOlkzGIrc53QKtPw: sits out
*** HOLE CARDS ***
BCEV3COoKY607AzLWayfRA: folds
jy52+7FotjH63o5tEEVgKw: calls $1
wx3sQGkVi2x9wJXuWNHPBw: folds
hpxXcmRkXXI9HE5+5/j/0Q: folds
b2a+5TkFf4xJN/Ihhma58Q: checks
*** FLOP *** [5d 8s 7d]
b2a+5TkFf4xJN/Ihhma58Q: bets $2
jy52+7FotjH63o5tEEVgKw: calls $2
*** TURN *** [5d 8s 7d] [2h]
b2a+5TkFf4xJN/Ihhma58Q: bets $3
jy52+7FotjH63o5tEEVgKw: calls $3
*** RIVER *** [5d 8s 7d 2h] [3s]
b2a+5TkFf4xJN/Ihhma58Q: bets $3
jy52+7FotjH63o5tEEVgKw: calls $3
*** SHOW DOWN ***
b2a+5TkFf4xJN/Ihhma58Q: shows [8h Qh] (a pair of Eights)
jy52+7FotjH63o5tEEVgKw: shows [8c Ad] (a pair of Eights - Ace kicker)
jy52+7FotjH63o5tEEVgKw collected $17.65 from pot
*** SUMMARY ***
Total pot $18.50 | Rake $0.85
Board [5d 8s 7d 2h 3s]
Seat 1: jy52+7FotjH63o5tEEVgKw showed [8c Ad] and won ($17.65) with a pair of Eights
Seat 2: wx3sQGkVi2x9wJXuWNHPBw (button) folded before Flop (didn't bet)
Seat 3: hpxXcmRkXXI9HE5+5/j/0Q (small blind) folded before Flop
Seat 4: b2a+5TkFf4xJN/Ihhma58Q (big blind) showed [8h Qh] and lost with a pair of Eights
Seat 5: BCEV3COoKY607AzLWayfRA folded before Flop (didn't bet)



PokerStars Game #59940897852:  Hold'em No Limit ($0.50/$1.00) - 2009/07/01 1:19:48 ET
Table 'MNvFfRVQNka/oY+Z5aMbZQ' 2-max Seat #2 is the button
Seat 1: DaZnoWHjO897dnh0CL2lVg ($60.65 in chips)
Seat 2: mgi+mjKb1Sc3CCs7TlfoCw ($63.55 in chips)
mgi+mjKb1Sc3CCs7TlfoCw: posts small blind $0.50
DaZnoWHjO897dnh0CL2lVg: posts big blind $1
*** HOLE CARDS ***
mgi+mjKb1Sc3CCs7TlfoCw: folds
DaZnoWHjO897dnh0CL2lVg collected $1 from pot
DaZnoWHjO897dnh0CL2lVg: doesn't show hand
*** SUMMARY ***
Total pot $1 | Rake $0
Seat 1: DaZnoWHjO897dnh0CL2lVg (big blind) collected ($1)
Seat 2: mgi+mjKb1Sc3CCs7TlfoCw (button) (small blind) folded before Flop



PokerStars Game #59940899076:  Hold'em No Limit ($0.50/$1.00) - 2009/07/01 1:19:50 ET
Table 'pHrhryH8jPNdQfY62f8v+g' 6-max Seat #1 is the button
Seat 1: 4d1rWhpu8DzLmzMbR3QKyA ($112.90 in chips)
Seat 2: JwCcjZl0bjJzG7hmE0dnTA ($100 in chips)
Seat 3: 8oS5O7iD/qnFXFXJrGIgNQ ($101.50 in chips)
Seat 4: 1f3beyIML24UqEMTbWy93g ($66.70 in chips)
Seat 5: r1/R7y0Ortgoz4lccgW8VA ($24.75 in chips)
Seat 6: xAU6q2/cwmby2sxmA8VcmA ($205.10 in chips)
JwCcjZl0bjJzG7hmE0dnTA: posts small blind $0.50
8oS5O7iD/qnFXFXJrGIgNQ: posts big blind $1
*** HOLE CARDS ***
1f3beyIML24UqEMTbWy93g: raises $2 to $3
r1/R7y0Ortgoz4lccgW8VA: folds
xAU6q2/cwmby2sxmA8VcmA: folds
4d1rWhpu8DzLmzMbR3QKyA: folds
JwCcjZl0bjJzG7hmE0dnTA: folds
8oS5O7iD/qnFXFXJrGIgNQ: folds
1f3beyIML24UqEMTbWy93g collected $2.50 from pot
*** SUMMARY ***
Total pot $2.50 | Rake $0
Seat 1: 4d1rWhpu8DzLmzMbR3QKyA (button) folded before Flop (didn't bet)
Seat 2: JwCcjZl0bjJzG7hmE0dnTA (small blind) folded before Flop
Seat 3: 8oS5O7iD/qnFXFXJrGIgNQ (big blind) folded before Flop
Seat 4: 1f3beyIML24UqEMTbWy93g collected ($2.50)
Seat 5: r1/R7y0Ortgoz4lccgW8VA folded before Flop (didn't bet)
Seat 6: xAU6q2/cwmby2sxmA8VcmA folded before Flop (didn't bet)



PokerStars Game #59940901464:  Hold'em No Limit ($0.50/$1.00) - 2009/07/01 1:19:54 ET
Table 'mmbQQVBTrPdE+wy+s+9VPA' 6-max Seat #6 is the button
Seat 1: zyP4SPoWZnKUfTvIRLCVog ($71.85 in chips)
Seat 2: XK4Qsl+DA8gAJyg85/zBIw ($17.95 in chips)
Seat 3: wx3sQGkVi2x9wJXuWNHPBw ($128.85 in chips)
Seat 4: V3iZdcw61nXF3g5hD2RrsQ ($106.40 in chips)
Seat 5: YMJG+F++3Aj6P8dAWda5fw ($107 in chips)
Seat 6: U2CWBTv29qdCbj8RNF2sIw ($100 in chips)
zyP4SPoWZnKUfTvIRLCVog: posts small blind $0.50
XK4Qsl+DA8gAJyg85/zBIw: posts big blind $1
*** HOLE CARDS ***
wx3sQGkVi2x9wJXuWNHPBw: folds
V3iZdcw61nXF3g5hD2RrsQ: folds
YMJG+F++3Aj6P8dAWda5fw: raises $2 to $3
U2CWBTv29qdCbj8RNF2sIw: folds
zyP4SPoWZnKUfTvIRLCVog: calls $2.50
XK4Qsl+DA8gAJyg85/zBIw: folds
*** FLOP *** [2d 9d 8c]
zyP4SPoWZnKUfTvIRLCVog: checks
YMJG+F++3Aj6P8dAWda5fw: bets $4
zyP4SPoWZnKUfTvIRLCVog: calls $4
*** TURN *** [2d 9d 8c] [4s]
zyP4SPoWZnKUfTvIRLCVog: checks
YMJG+F++3Aj6P8dAWda5fw: bets $13
zyP4SPoWZnKUfTvIRLCVog: folds
YMJG+F++3Aj6P8dAWda5fw collected $14.30 from pot
*** SUMMARY ***
Total pot $15 | Rake $0.70
Board [2d 9d 8c 4s]
Seat 1: zyP4SPoWZnKUfTvIRLCVog (small blind) folded on the Turn
Seat 2: XK4Qsl+DA8gAJyg85/zBIw (big blind) folded before Flop
Seat 3: wx3sQGkVi2x9wJXuWNHPBw folded before Flop (didn't bet)
Seat 4: V3iZdcw61nXF3g5hD2RrsQ folded before Flop (didn't bet)
Seat 5: YMJG+F++3Aj6P8dAWda5fw collected ($14.30)
Seat 6: U2CWBTv29qdCbj8RNF2sIw (button) folded before Flop (didn't bet)



PokerStars Game #59940901164:  Hold'em No Limit ($0.50/$1.00) - 2009/07/01 1:19:54 ET
Table 'MNvFfRVQNka/oY+Z5aMbZQ' 2-max Seat #1 is the button
Seat 1: DaZnoWHjO897dnh0CL2lVg ($61.15 in chips)
Seat 2: mgi+mjKb1Sc3CCs7TlfoCw ($63.05 in chips)
DaZnoWHjO897dnh0CL2lVg: posts small blind $0.50
mgi+mjKb1Sc3CCs7TlfoCw: posts big blind $1
*** HOLE CARDS ***
DaZnoWHjO897dnh0CL2lVg: raises $2 to $3
mgi+mjKb1Sc3CCs7TlfoCw: folds
DaZnoWHjO897dnh0CL2lVg collected $2 from pot
DaZnoWHjO897dnh0CL2lVg: doesn't show hand
*** SUMMARY ***
Total pot $2 | Rake $0
Seat 1: DaZnoWHjO897dnh0CL2lVg (button) (small blind) collected ($2)
Seat 2: mgi+mjKb1Sc3CCs7TlfoCw (big blind) folded before Flop



PokerStars Game #59940904124:  Hold'em No Limit ($0.50/$1.00) - 2009/07/01 1:19:59 ET
Table 'fTlPiCj0utgzC/5io+I7ew' 6-max Seat #1 is the button
Seat 1: YMJG+F++3Aj6P8dAWda5fw ($98.05 in chips)
Seat 2: KDYsHh8K2SUXXDvLsAhbJQ ($22.10 in chips)
Seat 3: Z2fXsGcjl+Eax+RzOgwOmg ($102.50 in chips)
Seat 4: uJVSceLggtsrJya+WtmUEA ($173.65 in chips)
Seat 5: XUk5GQsfNFpHvaToDZ0rZA ($54.15 in chips)
Seat 6: y27w5IK2WXqmYzS8OU0wKA ($100 in chips)
KDYsHh8K2SUXXDvLsAhbJQ: posts small blind $0.50
Z2fXsGcjl+Eax+RzOgwOmg: posts big blind $1
*** HOLE CARDS ***
uJVSceLggtsrJya+WtmUEA: raises $2 to $3
XUk5GQsfNFpHvaToDZ0rZA: folds
y27w5IK2WXqmYzS8OU0wKA: folds
YMJG+F++3Aj6P8dAWda5fw: calls $3
KDYsHh8K2SUXXDvLsAhbJQ: calls $2.50
Z2fXsGcjl+Eax+RzOgwOmg: raises $14 to $17
uJVSceLggtsrJya+WtmUEA: folds
YMJG+F++3Aj6P8dAWda5fw: folds
KDYsHh8K2SUXXDvLsAhbJQ: calls $14
*** FLOP *** [Tc Js 9d]
KDYsHh8K2SUXXDvLsAhbJQ: checks
Z2fXsGcjl+Eax+RzOgwOmg: bets $6
KDYsHh8K2SUXXDvLsAhbJQ: calls $5.10 and is all-in
*** TURN *** [Tc Js 9d] [3h]
*** RIVER *** [Tc Js 9d 3h] [7d]
*** SHOW DOWN ***
KDYsHh8K2SUXXDvLsAhbJQ: shows [6d Kd] (high card King)
Z2fXsGcjl+Eax+RzOgwOmg: shows [Ah Ks] (high card Ace)
KDYsHh8K2SUXXDvLsAhbJQ is sitting out
Z2fXsGcjl+Eax+RzOgwOmg collected $47.80 from pot
*** SUMMARY ***
Total pot $50.20 | Rake $2.40
Board [Tc Js 9d 3h 7d]
Seat 1: YMJG+F++3Aj6P8dAWda5fw (button) folded before Flop
Seat 2: KDYsHh8K2SUXXDvLsAhbJQ (small blind) showed [6d Kd] and lost with high card King
Seat 3: Z2fXsGcjl+Eax+RzOgwOmg (big blind) showed [Ah Ks] and won ($47.80) with high card Ace
Seat 4: uJVSceLggtsrJya+WtmUEA folded before Flop
Seat 5: XUk5GQsfNFpHvaToDZ0rZA folded before Flop (didn't bet)
Seat 6: y27w5IK2WXqmYzS8OU0wKA folded before Flop (didn't bet)



PokerStars Game #59940903654:  Hold'em No Limit ($0.50/$1.00) - 2009/07/01 1:19:59 ET
Table 'O96CPOtvMBWP6kzuYDfdFA' 6-max Seat #6 is the button
Seat 1: 6alLXQIITA2EZ/lBeym8Dw ($124.25 in chips)
Seat 2: 4d1rWhpu8DzLmzMbR3QKyA ($109.85 in chips)
Seat 3: V89DGjxE171oPREEbAXiyg ($94.65 in chips)
Seat 4: /P4w1pHg2zHYg/4ubJ0dPw ($60 in chips)
Seat 5: G5ZSSN6RSON3gkNvk/SmYg ($100 in chips)
Seat 6: GYei5jXGWexiJYbAT2fELg ($33.65 in chips)
6alLXQIITA2EZ/lBeym8Dw: posts small blind $0.50
4d1rWhpu8DzLmzMbR3QKyA: posts big blind $1
*** HOLE CARDS ***
V89DGjxE171oPREEbAXiyg: folds
/P4w1pHg2zHYg/4ubJ0dPw: folds
G5ZSSN6RSON3gkNvk/SmYg: folds
GYei5jXGWexiJYbAT2fELg: folds
6alLXQIITA2EZ/lBeym8Dw: raises $2 to $3
4d1rWhpu8DzLmzMbR3QKyA: folds
6alLXQIITA2EZ/lBeym8Dw collected $2 from pot
*** SUMMARY ***
Total pot $2 | Rake $0
Seat 1: 6alLXQIITA2EZ/lBeym8Dw (small blind) collected ($2)
Seat 2: 4d1rWhpu8DzLmzMbR3QKyA (big blind) folded before Flop
Seat 3: V89DGjxE171oPREEbAXiyg folded before Flop (didn't bet)
Seat 4: /P4w1pHg2zHYg/4ubJ0dPw folded before Flop (didn't bet)
Seat 5: G5ZSSN6RSON3gkNvk/SmYg folded before Flop (didn't bet)
Seat 6: GYei5jXGWexiJYbAT2fELg (button) folded before Flop (didn't bet)



PokerStars Game #59940903828:  Hold'em No Limit ($0.50/$1.00) - 2009/07/01 1:19:59 ET
Table 'hugOjcwJvzEwZbK7tyiWuQ' 9-max Seat #3 is the button
Seat 1: S3Ex8K7v6xm5jqjRM7Fl3w ($22 in chips)
Seat 2: r27C1nIV4NS4+qbnrgBQSw ($272.20 in chips)
Seat 3: ZWdwcEAWYlrUhsRi6MOmoA ($19.50 in chips)
Seat 4: UWB3oeddt/GObx2Mix2Anw ($186.60 in chips)
Seat 6: gUUvmqdVlmvpal6B8nYrmg ($100 in chips)
Seat 7: FL3MrLspcF23LYvC4ipBOA ($120.30 in chips)
Seat 8: /zy+DB4S5fUQUSfZWFzYGw ($126.25 in chips)
Seat 9: W8P9bUKCs43TO1xHm0dL6w ($87.95 in chips)
UWB3oeddt/GObx2Mix2Anw: posts small blind $0.50
gUUvmqdVlmvpal6B8nYrmg: posts big blind $1
*** HOLE CARDS ***
FL3MrLspcF23LYvC4ipBOA: folds
/zy+DB4S5fUQUSfZWFzYGw: folds
W8P9bUKCs43TO1xHm0dL6w: raises $2 to $3
S3Ex8K7v6xm5jqjRM7Fl3w: folds
r27C1nIV4NS4+qbnrgBQSw: folds
ZWdwcEAWYlrUhsRi6MOmoA: calls $3
UWB3oeddt/GObx2Mix2Anw: folds
gUUvmqdVlmvpal6B8nYrmg: folds
*** FLOP *** [5s Td 6c]
W8P9bUKCs43TO1xHm0dL6w: bets $5
ZWdwcEAWYlrUhsRi6MOmoA: raises $11.50 to $16.50 and is all-in
W8P9bUKCs43TO1xHm0dL6w: calls $11.50
*** TURN *** [5s Td 6c] [Ad]
*** RIVER *** [5s Td 6c Ad] [6s]
*** SHOW DOWN ***
W8P9bUKCs43TO1xHm0dL6w: shows [Jd Js] (two pair, Jacks and Sixes)
ZWdwcEAWYlrUhsRi6MOmoA: mucks hand
W8P9bUKCs43TO1xHm0dL6w collected $38.50 from pot
*** SUMMARY ***
Total pot $40.50 | Rake $2
Board [5s Td 6c Ad 6s]
Seat 1: S3Ex8K7v6xm5jqjRM7Fl3w folded before Flop (didn't bet)
Seat 2: r27C1nIV4NS4+qbnrgBQSw folded before Flop (didn't bet)
Seat 3: ZWdwcEAWYlrUhsRi6MOmoA (button) mucked
Seat 4: UWB3oeddt/GObx2Mix2Anw (small blind) folded before Flop
Seat 6: gUUvmqdVlmvpal6B8nYrmg (big blind) folded before Flop
Seat 7: FL3MrLspcF23LYvC4ipBOA folded before Flop (didn't bet)
Seat 8: /zy+DB4S5fUQUSfZWFzYGw folded before Flop (didn't bet)
Seat 9: W8P9bUKCs43TO1xHm0dL6w showed [Jd Js] and won ($38.50) with two pair, Jacks and Sixes



PokerStars Game #59940906958:  Hold'em No Limit ($0.50/$1.00) - 2009/07/01 1:20:04 ET
Table 'QSIig7BLMc9wY/rgBechzw' 6-max Seat #2 is the button
Seat 1: Z2fXsGcjl+Eax+RzOgwOmg ($101.50 in chips)
Seat 2: mLOIkH/qmRa+mVujQIhBRg ($55.40 in chips)
Seat 3: +xW7QemQU0Fxs+4TnqBRow ($106.90 in chips)
Seat 4: +uSzP8Jwnw7sKfQ4s66b7w ($61.95 in chips)
Seat 5: lsLuWlcPA3Rh7kJVLzMh0Q ($105.45 in chips)
Seat 6: PxqfkAMdAWtkgbT+q2gciA ($36.65 in chips)
+xW7QemQU0Fxs+4TnqBRow: posts small blind $0.50
+uSzP8Jwnw7sKfQ4s66b7w: posts big blind $1
*** HOLE CARDS ***
lsLuWlcPA3Rh7kJVLzMh0Q: folds
PxqfkAMdAWtkgbT+q2gciA: folds
Z2fXsGcjl+Eax+RzOgwOmg: raises $3 to $4
mLOIkH/qmRa+mVujQIhBRg: folds
+xW7QemQU0Fxs+4TnqBRow: folds
+uSzP8Jwnw7sKfQ4s66b7w: folds
Z2fXsGcjl+Eax+RzOgwOmg collected $2.50 from pot
Z2fXsGcjl+Eax+RzOgwOmg: doesn't show hand
*** SUMMARY ***
Total pot $2.50 | Rake $0
Seat 1: Z2fXsGcjl+Eax+RzOgwOmg collected ($2.50)
Seat 2: mLOIkH/qmRa+mVujQIhBRg (button) folded before Flop (didn't bet)
Seat 3: +xW7QemQU0Fxs+4TnqBRow (small blind) folded before Flop
Seat 4: +uSzP8Jwnw7sKfQ4s66b7w (big blind) folded before Flop
Seat 5: lsLuWlcPA3Rh7kJVLzMh0Q folded before Flop (didn't bet)
Seat 6: PxqfkAMdAWtkgbT+q2gciA folded before Flop (didn't bet)



PokerStars Game #59940907610:  Hold'em No Limit ($0.50/$1.00) - 2009/07/01 1:20:05 ET
Table 'MNvFfRVQNka/oY+Z5aMbZQ' 2-max Seat #2 is the button
Seat 1: DaZnoWHjO897dnh0CL2lVg ($62.15 in chips)
Seat 2: mgi+mjKb1Sc3CCs7TlfoCw ($62.05 in chips)
mgi+mjKb1Sc3CCs7TlfoCw: posts small blind $0.50
DaZnoWHjO897dnh0CL2lVg: posts big blind $1
*** HOLE CARDS ***
mgi+mjKb1Sc3CCs7TlfoCw: raises $2 to $3
DaZnoWHjO897dnh0CL2lVg: calls $2
*** FLOP *** [Kd Jh Js]
DaZnoWHjO897dnh0CL2lVg: checks
mgi+mjKb1Sc3CCs7TlfoCw: bets $5
DaZnoWHjO897dnh0CL2lVg: folds
mgi+mjKb1Sc3CCs7TlfoCw collected $5.70 from pot
mgi+mjKb1Sc3CCs7TlfoCw: doesn't show hand
*** SUMMARY ***
Total pot $6 | Rake $0.30
Board [Kd Jh Js]
Seat 1: DaZnoWHjO897dnh0CL2lVg (big blind) folded on the Flop
Seat 2: mgi+mjKb1Sc3CCs7TlfoCw (button) (small blind) collected ($5.70)



PokerStars Game #59940908394:  Hold'em No Limit ($0.50/$1.00) - 2009/07/01 1:20:07 ET
Table 'tyUh+jyNvrceIQdKMJjQ2wZFWj23PMihdwrNWv41OG/Qeat #4 is the button
Seat 3: TalCiLYHCd+ffkmR3auPvA ($243.30 in chips)
Seat 4: hpxXcmRkXXI9HE5+5/j/0Q ($100 in chips)
Seat 5: j7NIOHLZk7V2o9fOioO5ug ($115.30 in chips)
Seat 6: 4OO5v3AVduL0tePNx8wk5A ($100 in chips)
j7NIOHLZk7V2o9fOioO5ug: posts small blind $0.50
4OO5v3AVduL0tePNx8wk5A: posts big blind $1
*** HOLE CARDS ***
TalCiLYHCd+ffkmR3auPvA: folds
hpxXcmRkXXI9HE5+5/j/0Q: raises $3 to $4
j7NIOHLZk7V2o9fOioO5ug: folds
TalCiLYHCd+ffkmR3auPvA is sitting out
4OO5v3AVduL0tePNx8wk5A: calls $3
*** FLOP *** [Jd 3c 7c]
4OO5v3AVduL0tePNx8wk5A: checks
hpxXcmRkXXI9HE5+5/j/0Q: bets $6
4OO5v3AVduL0tePNx8wk5A: folds
hpxXcmRkXXI9HE5+5/j/0Q collected $8.10 from pot
hpxXcmRkXXI9HE5+5/j/0Q: doesn't show hand
*** SUMMARY ***
Total pot $8.50 | Rake $0.40
Board [Jd 3c 7c]
Seat 3: TalCiLYHCd+ffkmR3auPvA folded before Flop (didn't bet)
Seat 4: hpxXcmRkXXI9HE5+5/j/0Q (button) collected ($8.10)
Seat 5: j7NIOHLZk7V2o9fOioO5ug (small blind) folded before Flop
Seat 6: 4OO5v3AVduL0tePNx8wk5A (big blind) folded on the Flop



PokerStars Game #59940908800:  Hold'em No Limit ($0.50/$1.00) - 2009/07/01 1:20:07 ET
Table 'fZjVbKj9D8yOB+Rj7NaP/A' 9-max Seat #5 is the button
Seat 1: 9BZCcac3+McErkkSN2YScA ($100 in chips)
Seat 2: PTAFYDIUSsG+SArbxNl+Aw ($105.50 in chips)
Seat 3: yAbu2QsRPVcjPbqlf/jDxw ($101 in chips)
Seat 4: 997ViqAtWn1FPjJqcffwcA ($101 in chips)
Seat 5: PkGfq5xrSlNsujKaG/HF4Q ($100 in chips)
Seat 6: OvwYHV65yUbgdBjSmo1+5g ($48.95 in chips)
Seat 7: SyS20PAm3RpT6uLBsGkwOA ($117.80 in chips)
Seat 8: zDOE5r14tWqCf6xhuSHK6g ($41 in chips)
Seat 9: qheQay5YvP2DMAb3OUSxtw ($100 in chips)
OvwYHV65yUbgdBjSmo1+5g: posts small blind $0.50
SyS20PAm3RpT6uLBsGkwOA: posts big blind $1
*** HOLE CARDS ***
zDOE5r14tWqCf6xhuSHK6g: folds
qheQay5YvP2DMAb3OUSxtw: folds
9BZCcac3+McErkkSN2YScA: folds
PTAFYDIUSsG+SArbxNl+Aw: folds
yAbu2QsRPVcjPbqlf/jDxw: folds
997ViqAtWn1FPjJqcffwcA: folds
PkGfq5xrSlNsujKaG/HF4Q: folds
OvwYHV65yUbgdBjSmo1+5g: calls $0.50
SyS20PAm3RpT6uLBsGkwOA: checks
*** FLOP *** [7c 9c 2s]
OvwYHV65yUbgdBjSmo1+5g: checks
SyS20PAm3RpT6uLBsGkwOA: checks
*** TURN *** [7c 9c 2s] [5h]
OvwYHV65yUbgdBjSmo1+5g: bets $2
SyS20PAm3RpT6uLBsGkwOA: raises $6 to $8
OvwYHV65yUbgdBjSmo1+5g: folds
SyS20PAm3RpT6uLBsGkwOA collected $5.75 from pot
*** SUMMARY ***
Total pot $6 | Rake $0.25
Board [7c 9c 2s 5h]
Seat 1: 9BZCcac3+McErkkSN2YScA folded before Flop (didn't bet)
Seat 2: PTAFYDIUSsG+SArbxNl+Aw folded before Flop (didn't bet)
Seat 3: yAbu2QsRPVcjPbqlf/jDxw folded before Flop (didn't bet)
Seat 4: 997ViqAtWn1FPjJqcffwcA folded before Flop (didn't bet)
Seat 5: PkGfq5xrSlNsujKaG/HF4Q (button) folded before Flop (didn't bet)
Seat 6: OvwYHV65yUbgdBjSmo1+5g (small blind) folded on the Turn
Seat 7: SyS20PAm3RpT6uLBsGkwOA (big blind) collected ($5.75)
Seat 8: zDOE5r14tWqCf6xhuSHK6g folded before Flop (didn't bet)
Seat 9: qheQay5YvP2DMAb3OUSxtw folded before Flop (didn't bet)



PokerStars Game #59940909106:  Hold'em No Limit ($0.50/$1.00) - 2009/07/01 1:20:08 ET
Table '6YvsYDPNIDx2v5z3bJnwZQ' 9-max Seat #4 is the button
Seat 1: Ogn4JDV3mp4ZDKO49IFzKA ($19.70 in chips)
Seat 2: +hHqYgKILitkxIzFNGvvsA ($18.75 in chips)
Seat 3: K6OJDis3KfxSm/PKlkATUA ($48.50 in chips)
Seat 4: kEr5NYB+JIG5+szcYMr6hA ($45.45 in chips)
Seat 5: mBRWbnUl8diyBO1qTJaNzw ($127.90 in chips)
Seat 6: 7RSwrjMohkYrZAhOd1uaZg ($10.90 in chips)
Seat 7: mae7OMTaJ/MFimNbZegCkg ($43.30 in chips)
Seat 8: PSFxpXgPedVZyHSu2Zhb7Q ($129.05 in chips)
Seat 9: yZYrOeNDxQxkzpbgKX1bng ($68.65 in chips)
mBRWbnUl8diyBO1qTJaNzw: posts small blind $0.50
7RSwrjMohkYrZAhOd1uaZg: posts big blind $1
*** HOLE CARDS ***
mae7OMTaJ/MFimNbZegCkg: folds
PSFxpXgPedVZyHSu2Zhb7Q: folds
yZYrOeNDxQxkzpbgKX1bng: folds
Ogn4JDV3mp4ZDKO49IFzKA: folds
+hHqYgKILitkxIzFNGvvsA: calls $1
K6OJDis3KfxSm/PKlkATUA: folds
kEr5NYB+JIG5+szcYMr6hA: folds
mBRWbnUl8diyBO1qTJaNzw: folds
7RSwrjMohkYrZAhOd1uaZg: checks
*** FLOP *** [5d Kh Kd]
7RSwrjMohkYrZAhOd1uaZg: bets $1
+hHqYgKILitkxIzFNGvvsA: calls $1
*** TURN *** [5d Kh Kd] [4d]
7RSwrjMohkYrZAhOd1uaZg: checks
+hHqYgKILitkxIzFNGvvsA: checks
*** RIVER *** [5d Kh Kd 4d] [Ac]
7RSwrjMohkYrZAhOd1uaZg: bets $2
+hHqYgKILitkxIzFNGvvsA: calls $2
*** SHOW DOWN ***
7RSwrjMohkYrZAhOd1uaZg: shows [Qs 5h] (two pair, Kings and Fives)
+hHqYgKILitkxIzFNGvvsA: shows [Jh Ah] (two pair, Aces and Kings)
+hHqYgKILitkxIzFNGvvsA collected $8.10 from pot
*** SUMMARY ***
Total pot $8.50 | Rake $0.40
Board [5d Kh Kd 4d Ac]
Seat 1: Ogn4JDV3mp4ZDKO49IFzKA folded before Flop (didn't bet)
Seat 2: +hHqYgKILitkxIzFNGvvsA showed [Jh Ah] and won ($8.10) with two pair, Aces and Kings
Seat 3: K6OJDis3KfxSm/PKlkATUA folded before Flop (didn't bet)
Seat 4: kEr5NYB+JIG5+szcYMr6hA (button) folded before Flop (didn't bet)
Seat 5: mBRWbnUl8diyBO1qTJaNzw (small blind) folded before Flop
Seat 6: 7RSwrjMohkYrZAhOd1uaZg (big blind) showed [Qs 5h] and lost with two pair, Kings and Fives
Seat 7: mae7OMTaJ/MFimNbZegCkg folded before Flop (didn't bet)
Seat 8: PSFxpXgPedVZyHSu2Zhb7Q folded before Flop (didn't bet)
Seat 9: yZYrOeNDxQxkzpbgKX1bng folded before Flop (didn't bet)



PokerStars Game #59940909634:  Hold'em No Limit ($0.50/$1.00) - 2009/07/01 1:20:09 ET
Table 'W/wyObTiXZm+Ckkl3YxcSw' 6-max Seat #2 is the button
Seat 1: eUBBn2R56C1IQ6Cs/vitwg ($298.90 in chips)
Seat 2: oDiBRCaF0QVtd3kO6xZIXw ($150.55 in chips)
Seat 3: dxyNCn/qxfkGDUIf28Cbng ($68.30 in chips)
Seat 4: UBZQqpnJZdTYYY1FTb0rLA ($100 in chips)
Seat 5: +OrCjyw70oZhJiD22Mn+bg ($101.50 in chips)
Seat 6: b2a+5TkFf4xJN/Ihhma58Q ($36.50 in chips)
dxyNCn/qxfkGDUIf28Cbng: posts small blind $0.50
UBZQqpnJZdTYYY1FTb0rLA: posts big blind $1
*** HOLE CARDS ***
+OrCjyw70oZhJiD22Mn+bg: folds
b2a+5TkFf4xJN/Ihhma58Q: folds
eUBBn2R56C1IQ6Cs/vitwg: folds
oDiBRCaF0QVtd3kO6xZIXw: folds
dxyNCn/qxfkGDUIf28Cbng: folds
UBZQqpnJZdTYYY1FTb0rLA collected $1 from pot
UBZQqpnJZdTYYY1FTb0rLA: doesn't show hand
*** SUMMARY ***
Total pot $1 | Rake $0
Seat 1: eUBBn2R56C1IQ6Cs/vitwg folded before Flop (didn't bet)
Seat 2: oDiBRCaF0QVtd3kO6xZIXw (button) folded before Flop (didn't bet)
Seat 3: dxyNCn/qxfkGDUIf28Cbng (small blind) folded before Flop
Seat 4: UBZQqpnJZdTYYY1FTb0rLA (big blind) collected ($1)
Seat 5: +OrCjyw70oZhJiD22Mn+bg folded before Flop (didn't bet)
Seat 6: b2a+5TkFf4xJN/Ihhma58Q folded before Flop (didn't bet)



PokerStars Game #59940913850:  Hold'em No Limit ($0.50/$1.00) - 2009/07/01 1:20:17 ET
Table 'rmZfTK+oSebeUPJNbWhdAA' 6-max Seat #6 is the button
Seat 1: xAU6q2/cwmby2sxmA8VcmA ($142 in chips)
Seat 2: z7O9PO/WEcqRouIydFhS9Q ($147.95 in chips)
Seat 3: BCEV3COoKY607AzLWayfRA ($151.30 in chips)
Seat 4: 1/mIuXfgx1ZyVkodrmfQDw ($107.15 in chips)
Seat 5: 5lY8d6Cnm4HUkt/8FZSj4g ($57.25 in chips)
Seat 6: j7NIOHLZk7V2o9fOioO5ug ($147.25 in chips)
xAU6q2/cwmby2sxmA8VcmA: posts small blind $0.50
z7O9PO/WEcqRouIydFhS9Q: posts big blind $1
*** HOLE CARDS ***
BCEV3COoKY607AzLWayfRA: folds
1/mIuXfgx1ZyVkodrmfQDw: raises $2 to $3
5lY8d6Cnm4HUkt/8FZSj4g: folds
j7NIOHLZk7V2o9fOioO5ug: folds
xAU6q2/cwmby2sxmA8VcmA: folds
z7O9PO/WEcqRouIydFhS9Q: calls $2
*** FLOP *** [Jh 6s 3c]
z7O9PO/WEcqRouIydFhS9Q: checks
1/mIuXfgx1ZyVkodrmfQDw: bets $5
z7O9PO/WEcqRouIydFhS9Q: calls $5
*** TURN *** [Jh 6s 3c] [Qs]
z7O9PO/WEcqRouIydFhS9Q: checks
1/mIuXfgx1ZyVkodrmfQDw: checks
*** RIVER *** [Jh 6s 3c Qs] [2c]
z7O9PO/WEcqRouIydFhS9Q: checks
1/mIuXfgx1ZyVkodrmfQDw: bets $11
z7O9PO/WEcqRouIydFhS9Q: calls $11
*** SHOW DOWN ***
1/mIuXfgx1ZyVkodrmfQDw: shows [Ad Jc] (a pair of Jacks)
z7O9PO/WEcqRouIydFhS9Q: mucks hand
1/mIuXfgx1ZyVkodrmfQDw collected $36.65 from pot
*** SUMMARY ***
Total pot $38.50 | Rake $1.85
Board [Jh 6s 3c Qs 2c]
Seat 1: xAU6q2/cwmby2sxmA8VcmA (small blind) folded before Flop
Seat 2: z7O9PO/WEcqRouIydFhS9Q (big blind) mucked
Seat 3: BCEV3COoKY607AzLWayfRA folded before Flop (didn't bet)
Seat 4: 1/mIuXfgx1ZyVkodrmfQDw showed [Ad Jc] and won ($36.65) with a pair of Jacks
Seat 5: 5lY8d6Cnm4HUkt/8FZSj4g folded before Flop (didn't bet)
Seat 6: j7NIOHLZk7V2o9fOioO5ug (button) folded before Flop (didn't bet)



PokerStars Game #59940914204:  Hold'em No Limit ($0.50/$1.00) - 2009/07/01 1:20:17 ET
Table 'SQLOQoANiHscJ8AL7zffbw' 9-max Seat #3 is the button
Seat 1: jPTRd6SpCp4xqAy2XQiTOw ($52.90 in chips)
Seat 2: /zy+DB4S5fUQUSfZWFzYGw ($395.05 in chips)
Seat 3: 0eFnow7+D7veCYQ+CG9FFw ($103 in chips)
Seat 4: 5z1PAR8SNow/zUfYNbwq7A ($59.45 in chips)
Seat 5: L9njYvloJ1NdXjP8edHEAg ($100 in chips)
Seat 6: H+DVy3Ei8L1UKS2tVOtJcw ($100 in chips)
Seat 7: bJckevFOcg//s0qyMQI6sQ ($103.05 in chips)
Seat 9: qJr25HAtvv1w/7IBvjMM3g ($196.65 in chips)
5z1PAR8SNow/zUfYNbwq7A: posts small blind $0.50
L9njYvloJ1NdXjP8edHEAg: posts big blind $1
9BZCcac3+McErkkSN2YScA: sits out
*** HOLE CARDS ***
H+DVy3Ei8L1UKS2tVOtJcw: folds
bJckevFOcg//s0qyMQI6sQ: folds
qJr25HAtvv1w/7IBvjMM3g: folds
jPTRd6SpCp4xqAy2XQiTOw: calls $1
/zy+DB4S5fUQUSfZWFzYGw: folds
0eFnow7+D7veCYQ+CG9FFw: folds
5z1PAR8SNow/zUfYNbwq7A: calls $0.50
L9njYvloJ1NdXjP8edHEAg: checks
*** FLOP *** [Ks 9s Ts]
5z1PAR8SNow/zUfYNbwq7A: checks
L9njYvloJ1NdXjP8edHEAg: bets $3
jPTRd6SpCp4xqAy2XQiTOw: calls $3
5z1PAR8SNow/zUfYNbwq7A: folds
*** TURN *** [Ks 9s Ts] [4c]
L9njYvloJ1NdXjP8edHEAg: bets $8
jPTRd6SpCp4xqAy2XQiTOw: calls $8
*** RIVER *** [Ks 9s Ts 4c] [Td]
L9njYvloJ1NdXjP8edHEAg: bets $88 and is all-in
jPTRd6SpCp4xqAy2XQiTOw: folds
L9njYvloJ1NdXjP8edHEAg collected $23.80 from pot
*** SUMMARY ***
Total pot $25 | Rake $1.20
Board [Ks 9s Ts 4c Td]
Seat 1: jPTRd6SpCp4xqAy2XQiTOw folded on the River
Seat 2: /zy+DB4S5fUQUSfZWFzYGw folded before Flop (didn't bet)
Seat 3: 0eFnow7+D7veCYQ+CG9FFw (button) folded before Flop (didn't bet)
Seat 4: 5z1PAR8SNow/zUfYNbwq7A (small blind) folded on the Flop
Seat 5: L9njYvloJ1NdXjP8edHEAg (big blind) collected ($23.80)
Seat 6: H+DVy3Ei8L1UKS2tVOtJcw folded before Flop (didn't bet)
Seat 7: bJckevFOcg//s0qyMQI6sQ folded before Flop (didn't bet)
Seat 9: qJr25HAtvv1w/7IBvjMM3g folded before Flop (didn't bet)



PokerStars Game #59940915198:  Hold'em No Limit ($0.50/$1.00) - 2009/07/01 1:20:19 ET
Table 'MNvFfRVQNka/oY+Z5aMbZQ' 2-max Seat #1 is the button
Seat 1: DaZnoWHjO897dnh0CL2lVg ($59.15 in chips)
Seat 2: mgi+mjKb1Sc3CCs7TlfoCw ($64.75 in chips)
DaZnoWHjO897dnh0CL2lVg: posts small blind $0.50
mgi+mjKb1Sc3CCs7TlfoCw: posts big blind $1
*** HOLE CARDS ***
DaZnoWHjO897dnh0CL2lVg: raises $2 to $3
mgi+mjKb1Sc3CCs7TlfoCw: folds
DaZnoWHjO897dnh0CL2lVg collected $2 from pot
DaZnoWHjO897dnh0CL2lVg: doesn't show hand
*** SUMMARY ***
Total pot $2 | Rake $0
Seat 1: DaZnoWHjO897dnh0CL2lVg (button) (small blind) collected ($2)
Seat 2: mgi+mjKb1Sc3CCs7TlfoCw (big blind) folded before Flop



PokerStars Game #59940915656:  Hold'em No Limit ($0.50/$1.00) - 2009/07/01 1:20:20 ET
Table 'pHrhryH8jPNdQfY62f8v+g' 6-max Seat #2 is the button
Seat 1: 4d1rWhpu8DzLmzMbR3QKyA ($112.90 in chips)
Seat 2: JwCcjZl0bjJzG7hmE0dnTA ($100 in chips)
Seat 3: 8oS5O7iD/qnFXFXJrGIgNQ ($100.50 in chips)
Seat 4: 1f3beyIML24UqEMTbWy93g ($68.20 in chips)
Seat 5: r1/R7y0Ortgoz4lccgW8VA ($24.75 in chips)
Seat 6: xAU6q2/cwmby2sxmA8VcmA ($205.10 in chips)
8oS5O7iD/qnFXFXJrGIgNQ: posts small blind $0.50
1f3beyIML24UqEMTbWy93g: posts big blind $1
*** HOLE CARDS ***
r1/R7y0Ortgoz4lccgW8VA: raises $2 to $3
xAU6q2/cwmby2sxmA8VcmA: folds
4d1rWhpu8DzLmzMbR3QKyA: calls $3
JwCcjZl0bjJzG7hmE0dnTA: folds
8oS5O7iD/qnFXFXJrGIgNQ: folds
1f3beyIML24UqEMTbWy93g: folds
*** FLOP *** [7c Qs 9c]
r1/R7y0Ortgoz4lccgW8VA: checks
4d1rWhpu8DzLmzMbR3QKyA: bets $5
r1/R7y0Ortgoz4lccgW8VA: folds
4d1rWhpu8DzLmzMbR3QKyA collected $7.15 from pot
4d1rWhpu8DzLmzMbR3QKyA: doesn't show hand
*** SUMMARY ***
Total pot $7.50 | Rake $0.35
Board [7c Qs 9c]
Seat 1: 4d1rWhpu8DzLmzMbR3QKyA collected ($7.15)
Seat 2: JwCcjZl0bjJzG7hmE0dnTA (button) folded before Flop (didn't bet)
Seat 3: 8oS5O7iD/qnFXFXJrGIgNQ (small blind) folded before Flop
Seat 4: 1f3beyIML24UqEMTbWy93g (big blind) folded before Flop
Seat 5: r1/R7y0Ortgoz4lccgW8VA folded on the Flop
Seat 6: xAU6q2/cwmby2sxmA8VcmA folded before Flop (didn't bet)



PokerStars Game #59940916012:  Hold'em No Limit ($0.50/$1.00) - 2009/07/01 1:20:21 ET
Table 'MUPc8FEpe/nR0BKSeReX6Q' 6-max Seat #4 is the button
Seat 1: qhkK6+yCciTRd+rCFEbnEQ ($85.20 in chips)
Seat 2: xAU6q2/cwmby2sxmA8VcmA ($113.20 in chips)
Seat 3: wx3sQGkVi2x9wJXuWNHPBw ($224.50 in chips)
Seat 4: ZA1bp6g8IwtTxkUE4eCjDQ ($152.10 in chips)
Seat 5: y27w5IK2WXqmYzS8OU0wKA ($100.50 in chips)
Seat 6: oxnw0GLLpFanjhGkxfRSqA ($46.95 in chips)
y27w5IK2WXqmYzS8OU0wKA: posts small blind $0.50
oxnw0GLLpFanjhGkxfRSqA: posts big blind $1
*** HOLE CARDS ***
ZA1bp6g8IwtTxkUE4eCjDQ said, "lol"
qhkK6+yCciTRd+rCFEbnEQ: raises $3 to $4
xAU6q2/cwmby2sxmA8VcmA: folds
wx3sQGkVi2x9wJXuWNHPBw: folds
ZA1bp6g8IwtTxkUE4eCjDQ: folds
y27w5IK2WXqmYzS8OU0wKA: folds
oxnw0GLLpFanjhGkxfRSqA: folds
qhkK6+yCciTRd+rCFEbnEQ collected $2.50 from pot
qhkK6+yCciTRd+rCFEbnEQ: doesn't show hand
*** SUMMARY ***
Total pot $2.50 | Rake $0
Seat 1: qhkK6+yCciTRd+rCFEbnEQ collected ($2.50)
Seat 2: xAU6q2/cwmby2sxmA8VcmA folded before Flop (didn't bet)
Seat 3: wx3sQGkVi2x9wJXuWNHPBw folded before Flop (didn't bet)
Seat 4: ZA1bp6g8IwtTxkUE4eCjDQ (button) folded before Flop (didn't bet)
Seat 5: y27w5IK2WXqmYzS8OU0wKA (small blind) folded before Flop
Seat 6: oxnw0GLLpFanjhGkxfRSqA (big blind) folded before Flop



PokerStars Game #59940916100:  Hold'em No Limit ($0.50/$1.00) - 2009/07/01 1:20:21 ET
Table 'gxFK0BVUD7cupu2uyRUZJg' 6-max Seat #1 is the button
Seat 1: M+X3uChmP6R63IwijVjgTg ($161.25 in chips)
Seat 2: hpxXcmRkXXI9HE5+5/j/0Q ($119.10 in chips)
Seat 3: Z2fXsGcjl+Eax+RzOgwOmg ($119.75 in chips)
Seat 5: WgIrs6CBinyyw18pqdDtWA ($8.70 in chips)
Seat 6: dYyb6/42PMC8aNFlm/eBeQ ($65.85 in chips)
hpxXcmRkXXI9HE5+5/j/0Q: posts small blind $0.50
Z2fXsGcjl+Eax+RzOgwOmg: posts big blind $1
*** HOLE CARDS ***
WgIrs6CBinyyw18pqdDtWA: folds
dYyb6/42PMC8aNFlm/eBeQ: folds
M+X3uChmP6R63IwijVjgTg: folds
hpxXcmRkXXI9HE5+5/j/0Q: raises $3 to $4
Z2fXsGcjl+Eax+RzOgwOmg: folds
hpxXcmRkXXI9HE5+5/j/0Q collected $2 from pot
hpxXcmRkXXI9HE5+5/j/0Q: doesn't show hand
*** SUMMARY ***
Total pot $2 | Rake $0
Seat 1: M+X3uChmP6R63IwijVjgTg (button) folded before Flop (didn't bet)
Seat 2: hpxXcmRkXXI9HE5+5/j/0Q (small blind) collected ($2)
Seat 3: Z2fXsGcjl+Eax+RzOgwOmg (big blind) folded before Flop
Seat 5: WgIrs6CBinyyw18pqdDtWA folded before Flop (didn't bet)
Seat 6: dYyb6/42PMC8aNFlm/eBeQ folded before Flop (didn't bet)



PokerStars Game #59940916644:  Hold'em No Limit ($0.50/$1.00) - 2009/07/01 1:20:22 ET
Table '/RZcOwpZpHQ+OwPwjsbnRw' 6-max Seat #4 is the button
Seat 1: +uSzP8Jwnw7sKfQ4s66b7w ($52.25 in chips)
Seat 2: Z2fXsGcjl+Eax+RzOgwOmg ($103 in chips)
Seat 3: 6hLdALbOlkzGIrc53QKtPw ($20 in chips)
Seat 4: j7NIOHLZk7V2o9fOioO5ug ($143.70 in chips)
Seat 5: wx3sQGkVi2x9wJXuWNHPBw ($168.55 in chips)
Seat 6: o3YLm/rSY916m/on1VjXPA ($100 in chips)
wx3sQGkVi2x9wJXuWNHPBw: posts small blind $0.50
o3YLm/rSY916m/on1VjXPA: posts big blind $1
*** HOLE CARDS ***
+uSzP8Jwnw7sKfQ4s66b7w: folds
Z2fXsGcjl+Eax+RzOgwOmg: folds
6hLdALbOlkzGIrc53QKtPw: folds
j7NIOHLZk7V2o9fOioO5ug: folds
wx3sQGkVi2x9wJXuWNHPBw: folds
o3YLm/rSY916m/on1VjXPA collected $1 from pot
o3YLm/rSY916m/on1VjXPA: doesn't show hand
*** SUMMARY ***
Total pot $1 | Rake $0
Seat 1: +uSzP8Jwnw7sKfQ4s66b7w folded before Flop (didn't bet)
Seat 2: Z2fXsGcjl+Eax+RzOgwOmg folded before Flop (didn't bet)
Seat 3: 6hLdALbOlkzGIrc53QKtPw folded before Flop (didn't bet)
Seat 4: j7NIOHLZk7V2o9fOioO5ug (button) folded before Flop (didn't bet)
Seat 5: wx3sQGkVi2x9wJXuWNHPBw (small blind) folded before Flop
Seat 6: o3YLm/rSY916m/on1VjXPA (big blind) collected ($1)



PokerStars Game #59940917818:  Hold'em No Limit ($0.50/$1.00) - 2009/07/01 1:20:24 ET
Table 'O96CPOtvMBWP6kzuYDfdFA' 6-max Seat #1 is the button
Seat 1: 6alLXQIITA2EZ/lBeym8Dw ($125.25 in chips)
Seat 2: 4d1rWhpu8DzLmzMbR3QKyA ($108.85 in chips)
Seat 3: V89DGjxE171oPREEbAXiyg ($94.65 in chips)
Seat 4: /P4w1pHg2zHYg/4ubJ0dPw ($60 in chips)
Seat 5: G5ZSSN6RSON3gkNvk/SmYg ($100 in chips)
Seat 6: GYei5jXGWexiJYbAT2fELg ($33.65 in chips)
4d1rWhpu8DzLmzMbR3QKyA: posts small blind $0.50
V89DGjxE171oPREEbAXiyg: posts big blind $1
*** HOLE CARDS ***
/P4w1pHg2zHYg/4ubJ0dPw: folds
G5ZSSN6RSON3gkNvk/SmYg: folds
GYei5jXGWexiJYbAT2fELg: raises $2 to $3
6alLXQIITA2EZ/lBeym8Dw: folds
4d1rWhpu8DzLmzMbR3QKyA: folds
V89DGjxE171oPREEbAXiyg: folds
GYei5jXGWexiJYbAT2fELg collected $2.50 from pot
*** SUMMARY ***
Total pot $2.50 | Rake $0
Seat 1: 6alLXQIITA2EZ/lBeym8Dw (button) folded before Flop (didn't bet)
Seat 2: 4d1rWhpu8DzLmzMbR3QKyA (small blind) folded before Flop
Seat 3: V89DGjxE171oPREEbAXiyg (big blind) folded before Flop
Seat 4: /P4w1pHg2zHYg/4ubJ0dPw folded before Flop (didn't bet)
Seat 5: G5ZSSN6RSON3gkNvk/SmYg folded before Flop (didn't bet)
Seat 6: GYei5jXGWexiJYbAT2fELg collected ($2.50)



PokerStars Game #59940918690:  Hold'em No Limit ($0.50/$1.00) - 2009/07/01 1:20:25 ET
Table '8jIjWCPY0NGprquL+xcMFg' 9-max Seat #2 is the button
Seat 1: tU883G5KFwdH+p2tFuGYtw ($50 in chips)
Seat 2: 7VpIzVwja9q3vCCNM7gRrg ($54.65 in chips)
Seat 3: myIxN7otsyr846M539YR8Q ($20 in chips)
Seat 4: XLnHQ8GEI3bUQAfNjJuO5Q ($67.85 in chips)
Seat 5: 2YpnxJiexJHyERfbqgwEcw ($47.55 in chips)
Seat 6: GTQkFJtSkbVbnGCktp6e3g ($101.50 in chips)
Seat 7: O5Go3jrzbQWxRB6ESK+Ptg ($46 in chips)
Seat 8: eI48VADSCFoNZBx4T9qs2w ($17.95 in chips)
Seat 9: DDzMn3tzCgfGf298Xxt5Iw ($31.85 in chips)
myIxN7otsyr846M539YR8Q: posts small blind $0.50
XLnHQ8GEI3bUQAfNjJuO5Q: posts big blind $1
*** HOLE CARDS ***
2YpnxJiexJHyERfbqgwEcw: raises $2 to $3
GTQkFJtSkbVbnGCktp6e3g: folds
O5Go3jrzbQWxRB6ESK+Ptg: folds
eI48VADSCFoNZBx4T9qs2w: folds
DDzMn3tzCgfGf298Xxt5Iw: calls $3
tU883G5KFwdH+p2tFuGYtw: calls $3
7VpIzVwja9q3vCCNM7gRrg: folds
myIxN7otsyr846M539YR8Q: folds
XLnHQ8GEI3bUQAfNjJuO5Q: folds
*** FLOP *** [Qc Kh 2c]
2YpnxJiexJHyERfbqgwEcw: bets $5
DDzMn3tzCgfGf298Xxt5Iw: folds
tU883G5KFwdH+p2tFuGYtw: calls $5
*** TURN *** [Qc Kh 2c] [Qs]
2YpnxJiexJHyERfbqgwEcw: checks
tU883G5KFwdH+p2tFuGYtw: checks
*** RIVER *** [Qc Kh 2c Qs] [Qd]
2YpnxJiexJHyERfbqgwEcw: checks
tU883G5KFwdH+p2tFuGYtw: checks
*** SHOW DOWN ***
2YpnxJiexJHyERfbqgwEcw: shows [3h 2h] (a full house, Queens full of Deuces)
tU883G5KFwdH+p2tFuGYtw: mucks hand
2YpnxJiexJHyERfbqgwEcw collected $19.50 from pot
*** SUMMARY ***
Total pot $20.50 | Rake $1
Board [Qc Kh 2c Qs Qd]
Seat 1: tU883G5KFwdH+p2tFuGYtw mucked
Seat 2: 7VpIzVwja9q3vCCNM7gRrg (button) folded before Flop (didn't bet)
Seat 3: myIxN7otsyr846M539YR8Q (small blind) folded before Flop
Seat 4: XLnHQ8GEI3bUQAfNjJuO5Q (big blind) folded before Flop
Seat 5: 2YpnxJiexJHyERfbqgwEcw showed [3h 2h] and won ($19.50) with a full house, Queens full of Deuces
Seat 6: GTQkFJtSkbVbnGCktp6e3g folded before Flop (didn't bet)
Seat 7: O5Go3jrzbQWxRB6ESK+Ptg folded before Flop (didn't bet)
Seat 8: eI48VADSCFoNZBx4T9qs2w folded before Flop (didn't bet)
Seat 9: DDzMn3tzCgfGf298Xxt5Iw folded on the Flop



PokerStars Game #59940918488:  Hold'em No Limit ($0.50/$1.00) - 2009/07/01 1:20:25 ET
Table '7O9fB8yx1u7sJveJn8w6jA' 6-max Seat #3 is the button
Seat 1: jy52+7FotjH63o5tEEVgKw ($67.80 in chips)
Seat 2: wx3sQGkVi2x9wJXuWNHPBw ($200.70 in chips)
Seat 3: hpxXcmRkXXI9HE5+5/j/0Q ($122.75 in chips)
Seat 4: b2a+5TkFf4xJN/Ihhma58Q ($28.30 in chips)
Seat 5: BCEV3COoKY607AzLWayfRA ($100.35 in chips)
b2a+5TkFf4xJN/Ihhma58Q: posts small blind $0.50
BCEV3COoKY607AzLWayfRA: posts big blind $1
6hLdALbOlkzGIrc53QKtPw: sits out
*** HOLE CARDS ***
jy52+7FotjH63o5tEEVgKw: calls $1
wx3sQGkVi2x9wJXuWNHPBw: folds
hpxXcmRkXXI9HE5+5/j/0Q: folds
b2a+5TkFf4xJN/Ihhma58Q: calls $0.50
BCEV3COoKY607AzLWayfRA: checks
*** FLOP *** [8c 7d 5s]
b2a+5TkFf4xJN/Ihhma58Q: bets $2
BCEV3COoKY607AzLWayfRA: folds
jy52+7FotjH63o5tEEVgKw: folds
b2a+5TkFf4xJN/Ihhma58Q collected $2.85 from pot
*** SUMMARY ***
Total pot $3 | Rake $0.15
Board [8c 7d 5s]
Seat 1: jy52+7FotjH63o5tEEVgKw folded on the Flop
Seat 2: wx3sQGkVi2x9wJXuWNHPBw folded before Flop (didn't bet)
Seat 3: hpxXcmRkXXI9HE5+5/j/0Q (button) folded before Flop (didn't bet)
Seat 4: b2a+5TkFf4xJN/Ihhma58Q (small blind) collected ($2.85)
Seat 5: BCEV3COoKY607AzLWayfRA (big blind) folded on the Flop



PokerStars Game #59940919832:  Hold'em No Limit ($0.50/$1.00) - 2009/07/01 1:20:27 ET
Table 'GPp0HyAuggN8oE0sUWzPpA' 9-max Seat #1 is the button
Seat 1: qJr25HAtvv1w/7IBvjMM3g ($44.75 in chips)
Seat 2: m3U8I35Pn3gxKhoS2nmYIg ($25.95 in chips)
Seat 3: CCCXsirC+bO7ginAuUUVlQ ($52.25 in chips)
Seat 4: mBRWbnUl8diyBO1qTJaNzw ($101.65 in chips)
Seat 5: bLbSOSmSOnqE0iTcH/5dxA ($100 in chips)
Seat 6: BK/GtNPkSx0TdUDj82id5A ($34.70 in chips)
Seat 7: DHdbHyysD15wCAtx+BhUjA ($96.70 in chips)
Seat 8: P/6qLjycEfxRgZ5F/W90dw ($96 in chips)
Seat 9: dzoSjPZmtjGuK83119030A ($25.75 in chips)
m3U8I35Pn3gxKhoS2nmYIg: posts small blind $0.50
CCCXsirC+bO7ginAuUUVlQ: posts big blind $1
*** HOLE CARDS ***
mBRWbnUl8diyBO1qTJaNzw: folds
bLbSOSmSOnqE0iTcH/5dxA: folds
BK/GtNPkSx0TdUDj82id5A: folds
DHdbHyysD15wCAtx+BhUjA: folds
P/6qLjycEfxRgZ5F/W90dw: folds
dzoSjPZmtjGuK83119030A: calls $1
qJr25HAtvv1w/7IBvjMM3g: calls $1
m3U8I35Pn3gxKhoS2nmYIg: folds
CCCXsirC+bO7ginAuUUVlQ: checks
*** FLOP *** [Ac Ts 6c]
CCCXsirC+bO7ginAuUUVlQ: checks
dzoSjPZmtjGuK83119030A: bets $1
qJr25HAtvv1w/7IBvjMM3g: raises $2 to $3
CCCXsirC+bO7ginAuUUVlQ: folds
dzoSjPZmtjGuK83119030A: folds
qJr25HAtvv1w/7IBvjMM3g collected $5.25 from pot
*** SUMMARY ***
Total pot $5.50 | Rake $0.25
Board [Ac Ts 6c]
Seat 1: qJr25HAtvv1w/7IBvjMM3g (button) collected ($5.25)
Seat 2: m3U8I35Pn3gxKhoS2nmYIg (small blind) folded before Flop
Seat 3: CCCXsirC+bO7ginAuUUVlQ (big blind) folded on the Flop
Seat 4: mBRWbnUl8diyBO1qTJaNzw folded before Flop (didn't bet)
Seat 5: bLbSOSmSOnqE0iTcH/5dxA folded before Flop (didn't bet)
Seat 6: BK/GtNPkSx0TdUDj82id5A folded before Flop (didn't bet)
Seat 7: DHdbHyysD15wCAtx+BhUjA folded before Flop (didn't bet)
Seat 8: P/6qLjycEfxRgZ5F/W90dw folded before Flop (didn't bet)
Seat 9: dzoSjPZmtjGuK83119030A folded on the Flop



PokerStars Game #59940920490:  Hold'em No Limit ($0.50/$1.00) - 2009/07/01 1:20:29 ET
Table 'MNvFfRVQNka/oY+Z5aMbZQ' 2-max Seat #2 is the button
Seat 1: DaZnoWHjO897dnh0CL2lVg ($60.15 in chips)
Seat 2: mgi+mjKb1Sc3CCs7TlfoCw ($63.75 in chips)
mgi+mjKb1Sc3CCs7TlfoCw: posts small blind $0.50
DaZnoWHjO897dnh0CL2lVg: posts big blind $1
*** HOLE CARDS ***
mgi+mjKb1Sc3CCs7TlfoCw: raises $2 to $3
DaZnoWHjO897dnh0CL2lVg: calls $2
*** FLOP *** [4h 3h 7s]
DaZnoWHjO897dnh0CL2lVg: checks
mgi+mjKb1Sc3CCs7TlfoCw: bets $5
DaZnoWHjO897dnh0CL2lVg: folds
mgi+mjKb1Sc3CCs7TlfoCw collected $5.70 from pot
mgi+mjKb1Sc3CCs7TlfoCw: doesn't show hand
*** SUMMARY ***
Total pot $6 | Rake $0.30
Board [4h 3h 7s]
Seat 1: DaZnoWHjO897dnh0CL2lVg (big blind) folded on the Flop
Seat 2: mgi+mjKb1Sc3CCs7TlfoCw (button) (small blind) collected ($5.70)



PokerStars Game #59940921080:  Hold'em No Limit ($0.50/$1.00) - 2009/07/01 1:20:30 ET
Table 'W/wyObTiXZm+Ckkl3YxcSw' 6-max Seat #3 is the button
Seat 1: eUBBn2R56C1IQ6Cs/vitwg ($298.90 in chips)
Seat 2: oDiBRCaF0QVtd3kO6xZIXw ($150.55 in chips)
Seat 3: dxyNCn/qxfkGDUIf28Cbng ($67.80 in chips)
Seat 4: UBZQqpnJZdTYYY1FTb0rLA ($100.50 in chips)
Seat 5: +OrCjyw70oZhJiD22Mn+bg ($101.50 in chips)
Seat 6: b2a+5TkFf4xJN/Ihhma58Q ($36.50 in chips)
UBZQqpnJZdTYYY1FTb0rLA: posts small blind $0.50
+OrCjyw70oZhJiD22Mn+bg: posts big blind $1
*** HOLE CARDS ***
b2a+5TkFf4xJN/Ihhma58Q: folds
eUBBn2R56C1IQ6Cs/vitwg: raises $3 to $4
oDiBRCaF0QVtd3kO6xZIXw: folds
dxyNCn/qxfkGDUIf28Cbng: folds
UBZQqpnJZdTYYY1FTb0rLA: folds
+OrCjyw70oZhJiD22Mn+bg: folds
eUBBn2R56C1IQ6Cs/vitwg collected $2.50 from pot
*** SUMMARY ***
Total pot $2.50 | Rake $0
Seat 1: eUBBn2R56C1IQ6Cs/vitwg collected ($2.50)
Seat 2: oDiBRCaF0QVtd3kO6xZIXw folded before Flop (didn't bet)
Seat 3: dxyNCn/qxfkGDUIf28Cbng (button) folded before Flop (didn't bet)
Seat 4: UBZQqpnJZdTYYY1FTb0rLA (small blind) folded before Flop
Seat 5: +OrCjyw70oZhJiD22Mn+bg (big blind) folded before Flop
Seat 6: b2a+5TkFf4xJN/Ihhma58Q folded before Flop (didn't bet)



PokerStars Game #59940921040:  Hold'em No Limit ($0.50/$1.00) - 2009/07/01 1:20:30 ET
Table 'kS0cTQAEi+fdUlJP2gQYvw' 9-max Seat #6 is the button
Seat 1: c/9X4zftzphFxYtxp5kp9w ($78.75 in chips)
Seat 2: D+W9Me7w6Hcx/WRUSKV0dw ($26.55 in chips)
Seat 3: 2BV+oJIQYr65IO6nEChvbA ($60 in chips)
Seat 4: RUhhaALzha3TH1AkdakoGQ ($40 in chips)
Seat 5: 997ViqAtWn1FPjJqcffwcA ($103.40 in chips)
Seat 6: yAbu2QsRPVcjPbqlf/jDxw ($124.65 in chips)
Seat 7: Ffa7Nj4X5fddtROP01hfQg ($155.10 in chips)
Seat 8: vKyFzTyzfT7fZcdX+HHN+Q ($28.10 in chips)
Seat 9: OGgaARGdJQT4awWVNQ957w ($100 in chips)
Ffa7Nj4X5fddtROP01hfQg: posts small blind $0.50
vKyFzTyzfT7fZcdX+HHN+Q: posts big blind $1
*** HOLE CARDS ***
OGgaARGdJQT4awWVNQ957w: folds
c/9X4zftzphFxYtxp5kp9w: raises $3 to $4
D+W9Me7w6Hcx/WRUSKV0dw: folds
2BV+oJIQYr65IO6nEChvbA: folds
RUhhaALzha3TH1AkdakoGQ: calls $4
997ViqAtWn1FPjJqcffwcA: folds
yAbu2QsRPVcjPbqlf/jDxw: folds
Ffa7Nj4X5fddtROP01hfQg: folds
vKyFzTyzfT7fZcdX+HHN+Q: folds
*** FLOP *** [Qh 7d Jd]
c/9X4zftzphFxYtxp5kp9w: checks
RUhhaALzha3TH1AkdakoGQ: bets $5
c/9X4zftzphFxYtxp5kp9w: calls $5
*** TURN *** [Qh 7d Jd] [9h]
c/9X4zftzphFxYtxp5kp9w: checks
RUhhaALzha3TH1AkdakoGQ: bets $6
c/9X4zftzphFxYtxp5kp9w: calls $6
*** RIVER *** [Qh 7d Jd 9h] [3d]
c/9X4zftzphFxYtxp5kp9w: checks
RUhhaALzha3TH1AkdakoGQ: checks
*** SHOW DOWN ***
c/9X4zftzphFxYtxp5kp9w: shows [Kh Ah] (high card Ace)
RUhhaALzha3TH1AkdakoGQ: shows [Td Jc] (a pair of Jacks)
RUhhaALzha3TH1AkdakoGQ collected $30 from pot
*** SUMMARY ***
Total pot $31.50 | Rake $1.50
Board [Qh 7d Jd 9h 3d]
Seat 1: c/9X4zftzphFxYtxp5kp9w showed [Kh Ah] and lost with high card Ace
Seat 2: D+W9Me7w6Hcx/WRUSKV0dw folded before Flop (didn't bet)
Seat 3: 2BV+oJIQYr65IO6nEChvbA folded before Flop (didn't bet)
Seat 4: RUhhaALzha3TH1AkdakoGQ showed [Td Jc] and won ($30) with a pair of Jacks
Seat 5: 997ViqAtWn1FPjJqcffwcA folded before Flop (didn't bet)
Seat 6: yAbu2QsRPVcjPbqlf/jDxw (button) folded before Flop (didn't bet)
Seat 7: Ffa7Nj4X5fddtROP01hfQg (small blind) folded before Flop
Seat 8: vKyFzTyzfT7fZcdX+HHN+Q (big blind) folded before Flop
Seat 9: OGgaARGdJQT4awWVNQ957w folded before Flop (didn't bet)



PokerStars Game #59940922042:  Hold'em No Limit ($0.50/$1.00) - 2009/07/01 1:20:31 ET
Table 'QSIig7BLMc9wY/rgBechzw' 6-max Seat #3 is the button
Seat 1: Z2fXsGcjl+Eax+RzOgwOmg ($103 in chips)
Seat 2: mLOIkH/qmRa+mVujQIhBRg ($55.40 in chips)
Seat 3: +xW7QemQU0Fxs+4TnqBRow ($106.40 in chips)
Seat 4: +uSzP8Jwnw7sKfQ4s66b7w ($60.95 in chips)
Seat 5: lsLuWlcPA3Rh7kJVLzMh0Q ($105.45 in chips)
Seat 6: PxqfkAMdAWtkgbT+q2gciA ($36.65 in chips)
+uSzP8Jwnw7sKfQ4s66b7w: posts small blind $0.50
lsLuWlcPA3Rh7kJVLzMh0Q: posts big blind $1
*** HOLE CARDS ***
PxqfkAMdAWtkgbT+q2gciA: raises $3 to $4
Z2fXsGcjl+Eax+RzOgwOmg: folds
mLOIkH/qmRa+mVujQIhBRg: folds
+xW7QemQU0Fxs+4TnqBRow: calls $4
+uSzP8Jwnw7sKfQ4s66b7w: folds
lsLuWlcPA3Rh7kJVLzMh0Q: folds
*** FLOP *** [4s Jc Kd]
PxqfkAMdAWtkgbT+q2gciA: bets $3
+xW7QemQU0Fxs+4TnqBRow: raises $4 to $7
PxqfkAMdAWtkgbT+q2gciA: calls $4
*** TURN *** [4s Jc Kd] [Qs]
PxqfkAMdAWtkgbT+q2gciA: bets $10
+xW7QemQU0Fxs+4TnqBRow: folds
PxqfkAMdAWtkgbT+q2gciA collected $22.35 from pot
*** SUMMARY ***
Total pot $23.50 | Rake $1.15
Board [4s Jc Kd Qs]
Seat 1: Z2fXsGcjl+Eax+RzOgwOmg folded before Flop (didn't bet)
Seat 2: mLOIkH/qmRa+mVujQIhBRg folded before Flop (didn't bet)
Seat 3: +xW7QemQU0Fxs+4TnqBRow (button) folded on the Turn
Seat 4: +uSzP8Jwnw7sKfQ4s66b7w (small blind) folded before Flop
Seat 5: lsLuWlcPA3Rh7kJVLzMh0Q (big blind) folded before Flop
Seat 6: PxqfkAMdAWtkgbT+q2gciA collected ($22.35)



PokerStars Game #59940923092:  Hold'em No Limit ($0.50/$1.00) - 2009/07/01 1:20:33 ET
Table 'uNlePsyMIqzM691Xkrlk6Q' 9-max Seat #2 is the button
Seat 1: bLbSOSmSOnqE0iTcH/5dxA ($114 in chips)
Seat 2: +OqpStnt0FqbCfyHAWaLbg ($79.80 in chips)
Seat 3: h7qXkU57Bb8ZuPwMyxR8Ug ($45.75 in chips)
Seat 4: TRx/IDriSKVaxeebBKhcFQ ($20.90 in chips)
Seat 5: 9jIz1JKIpvRv9Xv6qqhAMA ($76.80 in chips)
Seat 7: KNAaBvPYSXyLqb88ypSbuQ ($26.95 in chips)
Seat 8: yWcEtGJ3ijZsF6HqlHqkrg ($105.40 in chips)
h7qXkU57Bb8ZuPwMyxR8Ug: posts small blind $0.50
TRx/IDriSKVaxeebBKhcFQ: posts big blind $1
froChili: sits out
OGgaARGdJQT4awWVNQ957w: sits out
*** HOLE CARDS ***
9jIz1JKIpvRv9Xv6qqhAMA: raises $2 to $3
KNAaBvPYSXyLqb88ypSbuQ: folds
yWcEtGJ3ijZsF6HqlHqkrg: folds
bLbSOSmSOnqE0iTcH/5dxA: folds
+OqpStnt0FqbCfyHAWaLbg: calls $3
h7qXkU57Bb8ZuPwMyxR8Ug: folds
TRx/IDriSKVaxeebBKhcFQ: folds
*** FLOP *** [Qc Qs 8s]
9jIz1JKIpvRv9Xv6qqhAMA: checks
+OqpStnt0FqbCfyHAWaLbg: checks
*** TURN *** [Qc Qs 8s] [4h]
9jIz1JKIpvRv9Xv6qqhAMA: checks
+OqpStnt0FqbCfyHAWaLbg: bets $2
9jIz1JKIpvRv9Xv6qqhAMA: calls $2
*** RIVER *** [Qc Qs 8s 4h] [Ks]
9jIz1JKIpvRv9Xv6qqhAMA: checks
+OqpStnt0FqbCfyHAWaLbg: bets $3
9jIz1JKIpvRv9Xv6qqhAMA: calls $3
*** SHOW DOWN ***
+OqpStnt0FqbCfyHAWaLbg: shows [Qh Jc] (three of a kind, Queens)
9jIz1JKIpvRv9Xv6qqhAMA: mucks hand
+OqpStnt0FqbCfyHAWaLbg collected $16.70 from pot
*** SUMMARY ***
Total pot $17.50 | Rake $0.80
Board [Qc Qs 8s 4h Ks]
Seat 1: bLbSOSmSOnqE0iTcH/5dxA folded before Flop (didn't bet)
Seat 2: +OqpStnt0FqbCfyHAWaLbg (button) showed [Qh Jc] and won ($16.70) with three of a kind, Queens
Seat 3: h7qXkU57Bb8ZuPwMyxR8Ug (small blind) folded before Flop
Seat 4: TRx/IDriSKVaxeebBKhcFQ (big blind) folded before Flop
Seat 5: 9jIz1JKIpvRv9Xv6qqhAMA mucked
Seat 7: KNAaBvPYSXyLqb88ypSbuQ folded before Flop (didn't bet)
Seat 8: yWcEtGJ3ijZsF6HqlHqkrg folded before Flop (didn't bet)



PokerStars Game #59940923444:  Hold'em No Limit ($0.50/$1.00) - 2009/07/01 1:20:34 ET
Table 'vs/5jr6ciwjVQ5+Soc+u2A' 6-max Seat #6 is the button
Seat 1: J798qwLuvXyq0BbzsIjOrA ($112.90 in chips)
Seat 2: lXX4W7m3u++JiSOZ46yVMQ ($107.15 in chips)
Seat 3: G5ZSSN6RSON3gkNvk/SmYg ($138.10 in chips)
Seat 4: wk6Ohn4GDozoOMHc4eb2rw ($60.80 in chips)
Seat 5: +Nt3OPk3XR9SKjZgm2CexQ ($149.10 in chips)
Seat 6: Z2fXsGcjl+Eax+RzOgwOmg ($100 in chips)
J798qwLuvXyq0BbzsIjOrA: posts small blind $0.50
lXX4W7m3u++JiSOZ46yVMQ: posts big blind $1
*** HOLE CARDS ***
G5ZSSN6RSON3gkNvk/SmYg: folds
wk6Ohn4GDozoOMHc4eb2rw: folds
+Nt3OPk3XR9SKjZgm2CexQ: folds
Z2fXsGcjl+Eax+RzOgwOmg: raises $2 to $3
J798qwLuvXyq0BbzsIjOrA: folds
lXX4W7m3u++JiSOZ46yVMQ: folds
Z2fXsGcjl+Eax+RzOgwOmg collected $2.50 from pot
Z2fXsGcjl+Eax+RzOgwOmg: doesn't show hand
*** SUMMARY ***
Total pot $2.50 | Rake $0
Seat 1: J798qwLuvXyq0BbzsIjOrA (small blind) folded before Flop
Seat 2: lXX4W7m3u++JiSOZ46yVMQ (big blind) folded before Flop
Seat 3: G5ZSSN6RSON3gkNvk/SmYg folded before Flop (didn't bet)
Seat 4: wk6Ohn4GDozoOMHc4eb2rw folded before Flop (didn't bet)
Seat 5: +Nt3OPk3XR9SKjZgm2CexQ folded before Flop (didn't bet)
Seat 6: Z2fXsGcjl+Eax+RzOgwOmg (button) collected ($2.50)



PokerStars Game #59940925560:  Hold'em No Limit ($0.50/$1.00) - 2009/07/01 1:20:37 ET
Table 'tJq9SfN1ywY0r03VBlWlwQ' 9-max Seat #7 is the button
Seat 1: wZsU+w9r7G66x93UuvBf1Q ($330.80 in chips)
Seat 3: FVs16t7GgfWgQWt4JxsObQ ($16.55 in chips)
Seat 4: bLbSOSmSOnqE0iTcH/5dxA ($115.15 in chips)
Seat 5: h5ipsNTMyolp7xn/NAvWkA ($108.45 in chips)
Seat 6: gUUvmqdVlmvpal6B8nYrmg ($100 in chips)
Seat 7: Pp/KTcXkfZKKUHkjyaLTdg ($18.50 in chips)
Seat 8: G4DEhsZFmznGNVpy2SEocA ($26.25 in chips)
Seat 9: XE5QF1y74bpHog9JxWJMWQ ($100.20 in chips)
G4DEhsZFmznGNVpy2SEocA: posts small blind $0.50
XE5QF1y74bpHog9JxWJMWQ: posts big blind $1
VPF+HjszMvUIpy0CHIwH3A: sits out
*** HOLE CARDS ***
wZsU+w9r7G66x93UuvBf1Q: raises $3 to $4
FVs16t7GgfWgQWt4JxsObQ: folds
bLbSOSmSOnqE0iTcH/5dxA: folds
h5ipsNTMyolp7xn/NAvWkA: calls $4
gUUvmqdVlmvpal6B8nYrmg: folds
Pp/KTcXkfZKKUHkjyaLTdg: folds
G4DEhsZFmznGNVpy2SEocA: calls $3.50
XE5QF1y74bpHog9JxWJMWQ: calls $3
*** FLOP *** [3d Ks Jh]
G4DEhsZFmznGNVpy2SEocA: checks
XE5QF1y74bpHog9JxWJMWQ: checks
wZsU+w9r7G66x93UuvBf1Q: checks
h5ipsNTMyolp7xn/NAvWkA: bets $4
G4DEhsZFmznGNVpy2SEocA: folds
XE5QF1y74bpHog9JxWJMWQ: folds
wZsU+w9r7G66x93UuvBf1Q: folds
h5ipsNTMyolp7xn/NAvWkA collected $15.20 from pot
*** SUMMARY ***
Total pot $16 | Rake $0.80
Board [3d Ks Jh]
Seat 1: wZsU+w9r7G66x93UuvBf1Q folded on the Flop
Seat 3: FVs16t7GgfWgQWt4JxsObQ folded before Flop (didn't bet)
Seat 4: bLbSOSmSOnqE0iTcH/5dxA folded before Flop (didn't bet)
Seat 5: h5ipsNTMyolp7xn/NAvWkA collected ($15.20)
Seat 6: gUUvmqdVlmvpal6B8nYrmg folded before Flop (didn't bet)
Seat 7: Pp/KTcXkfZKKUHkjyaLTdg (button) folded before Flop (didn't bet)
Seat 8: G4DEhsZFmznGNVpy2SEocA (small blind) folded on the Flop
Seat 9: XE5QF1y74bpHog9JxWJMWQ (big blind) folded on the Flop



PokerStars Game #59940926834:  Hold'em No Limit ($0.50/$1.00) - 2009/07/01 1:20:40 ET
Table '+cA8mcmhaedZ7YcrDdhmeQ' 6-max Seat #6 is the button
Seat 2: 14aYclSc98EYd6TrzN2l3Q ($14.80 in chips)
Seat 3: DAIgyIWbYvAkL6PbAI27pg ($15.50 in chips)
Seat 4: 4OO5v3AVduL0tePNx8wk5A ($105.05 in chips)
Seat 5: n5xXfJeDtWZSChGAdq//Tw ($21.05 in chips)
Seat 6: YfsTQsY/fxb+YqbdclTHuw ($13.85 in chips)
iIgNoBh+3/Ix1/fLsg+HuA will be allowed to play after the button
14aYclSc98EYd6TrzN2l3Q: posts small blind $0.50
DAIgyIWbYvAkL6PbAI27pg: posts big blind $1
n5xXfJeDtWZSChGAdq//Tw: posts big blind $1
*** HOLE CARDS ***
4OO5v3AVduL0tePNx8wk5A: folds
n5xXfJeDtWZSChGAdq//Tw: checks
YfsTQsY/fxb+YqbdclTHuw: folds
14aYclSc98EYd6TrzN2l3Q: calls $0.50
DAIgyIWbYvAkL6PbAI27pg: raises $14.50 to $15.50 and is all-in
n5xXfJeDtWZSChGAdq//Tw: folds
14aYclSc98EYd6TrzN2l3Q: folds
DAIgyIWbYvAkL6PbAI27pg collected $3 from pot
*** SUMMARY ***
Total pot $3 | Rake $0
Seat 2: 14aYclSc98EYd6TrzN2l3Q (small blind) folded before Flop
Seat 3: DAIgyIWbYvAkL6PbAI27pg (big blind) collected ($3)
Seat 4: 4OO5v3AVduL0tePNx8wk5A folded before Flop (didn't bet)
Seat 5: n5xXfJeDtWZSChGAdq//Tw folded before Flop
Seat 6: YfsTQsY/fxb+YqbdclTHuw (button) folded before Flop (didn't bet)



PokerStars Game #59940927284:  Hold'em No Limit ($0.50/$1.00) - 2009/07/01 1:20:40 ET
Table 'mmbQQVBTrPdE+wy+s+9VPA' 6-max Seat #1 is the button
Seat 1: zyP4SPoWZnKUfTvIRLCVog ($64.85 in chips)
Seat 2: XK4Qsl+DA8gAJyg85/zBIw ($16.95 in chips)
Seat 3: wx3sQGkVi2x9wJXuWNHPBw ($128.85 in chips)
Seat 4: V3iZdcw61nXF3g5hD2RrsQ ($106.40 in chips)
Seat 5: YMJG+F++3Aj6P8dAWda5fw ($114.30 in chips)
Seat 6: U2CWBTv29qdCbj8RNF2sIw ($100 in chips)
XK4Qsl+DA8gAJyg85/zBIw: posts small blind $0.50
wx3sQGkVi2x9wJXuWNHPBw: posts big blind $1
*** HOLE CARDS ***
V3iZdcw61nXF3g5hD2RrsQ: folds
YMJG+F++3Aj6P8dAWda5fw: folds
U2CWBTv29qdCbj8RNF2sIw: folds
zyP4SPoWZnKUfTvIRLCVog: raises $2 to $3
XK4Qsl+DA8gAJyg85/zBIw: folds
wx3sQGkVi2x9wJXuWNHPBw: folds
zyP4SPoWZnKUfTvIRLCVog collected $2.50 from pot
*** SUMMARY ***
Total pot $2.50 | Rake $0
Seat 1: zyP4SPoWZnKUfTvIRLCVog (button) collected ($2.50)
Seat 2: XK4Qsl+DA8gAJyg85/zBIw (small blind) folded before Flop
Seat 3: wx3sQGkVi2x9wJXuWNHPBw (big blind) folded before Flop
Seat 4: V3iZdcw61nXF3g5hD2RrsQ folded before Flop (didn't bet)
Seat 5: YMJG+F++3Aj6P8dAWda5fw folded before Flop (didn't bet)
Seat 6: U2CWBTv29qdCbj8RNF2sIw folded before Flop (didn't bet)



PokerStars Game #59940928050:  Hold'em No Limit ($0.50/$1.00) - 2009/07/01 1:20:42 ET
Table 'O96CPOtvMBWP6kzuYDfdFA' 6-max Seat #2 is the button
Seat 1: 6alLXQIITA2EZ/lBeym8Dw ($125.25 in chips)
Seat 2: 4d1rWhpu8DzLmzMbR3QKyA ($108.35 in chips)
Seat 3: V89DGjxE171oPREEbAXiyg ($93.65 in chips)
Seat 4: /P4w1pHg2zHYg/4ubJ0dPw ($60 in chips)
Seat 5: G5ZSSN6RSON3gkNvk/SmYg ($100 in chips)
Seat 6: GYei5jXGWexiJYbAT2fELg ($35.15 in chips)
V89DGjxE171oPREEbAXiyg: posts small blind $0.50
/P4w1pHg2zHYg/4ubJ0dPw: posts big blind $1
*** HOLE CARDS ***
G5ZSSN6RSON3gkNvk/SmYg: raises $3 to $4
GYei5jXGWexiJYbAT2fELg: folds
6alLXQIITA2EZ/lBeym8Dw: folds
4d1rWhpu8DzLmzMbR3QKyA: folds
V89DGjxE171oPREEbAXiyg: folds
/P4w1pHg2zHYg/4ubJ0dPw: folds
G5ZSSN6RSON3gkNvk/SmYg collected $2.50 from pot
G5ZSSN6RSON3gkNvk/SmYg: doesn't show hand
*** SUMMARY ***
Total pot $2.50 | Rake $0
Seat 1: 6alLXQIITA2EZ/lBeym8Dw folded before Flop (didn't bet)
Seat 2: 4d1rWhpu8DzLmzMbR3QKyA (button) folded before Flop (didn't bet)
Seat 3: V89DGjxE171oPREEbAXiyg (small blind) folded before Flop
Seat 4: /P4w1pHg2zHYg/4ubJ0dPw (big blind) folded before Flop
Seat 5: G5ZSSN6RSON3gkNvk/SmYg collected ($2.50)
Seat 6: GYei5jXGWexiJYbAT2fELg folded before Flop (didn't bet)



PokerStars Game #59940929414:  Hold'em No Limit ($0.50/$1.00) - 2009/07/01 1:20:44 ET
Table '/RZcOwpZpHQ+OwPwjsbnRw' 6-max Seat #5 is the button
Seat 1: +uSzP8Jwnw7sKfQ4s66b7w ($52.25 in chips)
Seat 2: Z2fXsGcjl+Eax+RzOgwOmg ($103 in chips)
Seat 3: 6hLdALbOlkzGIrc53QKtPw ($20 in chips)
Seat 4: j7NIOHLZk7V2o9fOioO5ug ($143.70 in chips)
Seat 5: wx3sQGkVi2x9wJXuWNHPBw ($168.05 in chips)
Seat 6: o3YLm/rSY916m/on1VjXPA ($100.50 in chips)
o3YLm/rSY916m/on1VjXPA: posts small blind $0.50
+uSzP8Jwnw7sKfQ4s66b7w: posts big blind $1
*** HOLE CARDS ***
Z2fXsGcjl+Eax+RzOgwOmg: folds
6hLdALbOlkzGIrc53QKtPw: raises $1 to $2
j7NIOHLZk7V2o9fOioO5ug: folds
wx3sQGkVi2x9wJXuWNHPBw: calls $2
o3YLm/rSY916m/on1VjXPA: folds
+uSzP8Jwnw7sKfQ4s66b7w: calls $1
*** FLOP *** [3c Jd Ts]
+uSzP8Jwnw7sKfQ4s66b7w: checks
6hLdALbOlkzGIrc53QKtPw: bets $5
wx3sQGkVi2x9wJXuWNHPBw: folds
+uSzP8Jwnw7sKfQ4s66b7w: folds
6hLdALbOlkzGIrc53QKtPw collected $6.20 from pot
6hLdALbOlkzGIrc53QKtPw: doesn't show hand
*** SUMMARY ***
Total pot $6.50 | Rake $0.30
Board [3c Jd Ts]
Seat 1: +uSzP8Jwnw7sKfQ4s66b7w (big blind) folded on the Flop
Seat 2: Z2fXsGcjl+Eax+RzOgwOmg folded before Flop (didn't bet)
Seat 3: 6hLdALbOlkzGIrc53QKtPw collected ($6.20)
Seat 4: j7NIOHLZk7V2o9fOioO5ug folded before Flop (didn't bet)
Seat 5: wx3sQGkVi2x9wJXuWNHPBw (button) folded on the Flop
Seat 6: o3YLm/rSY916m/on1VjXPA (small blind) folded before Flop



PokerStars Game #59940929392:  Hold'em No Limit ($0.50/$1.00) - 2009/07/01 1:20:44 ET
Table 'gxFK0BVUD7cupu2uyRUZJg' 6-max Seat #2 is the button
Seat 1: M+X3uChmP6R63IwijVjgTg ($161.25 in chips)
Seat 2: hpxXcmRkXXI9HE5+5/j/0Q ($120.10 in chips)
Seat 3: Z2fXsGcjl+Eax+RzOgwOmg ($118.75 in chips)
Seat 5: WgIrs6CBinyyw18pqdDtWA ($33.70 in chips)
Seat 6: dYyb6/42PMC8aNFlm/eBeQ ($65.85 in chips)
Z2fXsGcjl+Eax+RzOgwOmg: posts small blind $0.50
WgIrs6CBinyyw18pqdDtWA: posts big blind $1
*** HOLE CARDS ***
dYyb6/42PMC8aNFlm/eBeQ: folds
M+X3uChmP6R63IwijVjgTg has timed out
M+X3uChmP6R63IwijVjgTg: folds
M+X3uChmP6R63IwijVjgTg is sitting out
hpxXcmRkXXI9HE5+5/j/0Q: raises $3 to $4
Z2fXsGcjl+Eax+RzOgwOmg: folds
WgIrs6CBinyyw18pqdDtWA: folds
hpxXcmRkXXI9HE5+5/j/0Q collected $2.50 from pot
hpxXcmRkXXI9HE5+5/j/0Q: doesn't show hand
*** SUMMARY ***
Total pot $2.50 | Rake $0
Seat 1: M+X3uChmP6R63IwijVjgTg folded before Flop (didn't bet)
Seat 2: hpxXcmRkXXI9HE5+5/j/0Q (button) collected ($2.50)
Seat 3: Z2fXsGcjl+Eax+RzOgwOmg (small blind) folded before Flop
Seat 5: WgIrs6CBinyyw18pqdDtWA (big blind) folded before Flop
Seat 6: dYyb6/42PMC8aNFlm/eBeQ folded before Flop (didn't bet)



PokerStars Game #59940929774:  Hold'em No Limit ($0.50/$1.00) - 2009/07/01 1:20:45 ET
Table '305hiksPPCCdC6V2LNsO5w' 6-max Seat #4 is the button
Seat 1: RTuDLJHh/9zPfBftoc9vsw ($18 in chips)
Seat 2: j7NIOHLZk7V2o9fOioO5ug ($124.55 in chips)
Seat 3: +zIVjZKLpcidfRHgVZW8lA ($17 in chips)
Seat 4: uJVSceLggtsrJya+WtmUEA ($222.15 in chips)
Seat 5: +Nt3OPk3XR9SKjZgm2CexQ ($117.15 in chips)
Seat 6: 9/Tq8dw7kWW68uN8bFupXg ($22.50 in chips)
+Nt3OPk3XR9SKjZgm2CexQ: posts small blind $0.50
9/Tq8dw7kWW68uN8bFupXg: posts big blind $1
*** HOLE CARDS ***
RTuDLJHh/9zPfBftoc9vsw: folds
j7NIOHLZk7V2o9fOioO5ug: folds
+zIVjZKLpcidfRHgVZW8lA: folds
uJVSceLggtsrJya+WtmUEA: folds
+Nt3OPk3XR9SKjZgm2CexQ: raises $2 to $3
9/Tq8dw7kWW68uN8bFupXg: calls $2
*** FLOP *** [7s Js 9h]
+Nt3OPk3XR9SKjZgm2CexQ: checks
9/Tq8dw7kWW68uN8bFupXg: checks
*** TURN *** [7s Js 9h] [2s]
+Nt3OPk3XR9SKjZgm2CexQ: checks
9/Tq8dw7kWW68uN8bFupXg: bets $4
+Nt3OPk3XR9SKjZgm2CexQ: folds
9/Tq8dw7kWW68uN8bFupXg collected $5.70 from pot
*** SUMMARY ***
Total pot $6 | Rake $0.30
Board [7s Js 9h 2s]
Seat 1: RTuDLJHh/9zPfBftoc9vsw folded before Flop (didn't bet)
Seat 2: j7NIOHLZk7V2o9fOioO5ug folded before Flop (didn't bet)
Seat 3: +zIVjZKLpcidfRHgVZW8lA folded before Flop (didn't bet)
Seat 4: uJVSceLggtsrJya+WtmUEA (button) folded before Flop (didn't bet)
Seat 5: +Nt3OPk3XR9SKjZgm2CexQ (small blind) folded on the Turn
Seat 6: 9/Tq8dw7kWW68uN8bFupXg (big blind) collected ($5.70)



PokerStars Game #59940930446:  Hold'em No Limit ($0.50/$1.00) - 2009/07/01 1:20:46 ET
Table 'MNvFfRVQNka/oY+Z5aMbZQ' 2-max Seat #1 is the button
Seat 1: DaZnoWHjO897dnh0CL2lVg ($57.15 in chips)
Seat 2: mgi+mjKb1Sc3CCs7TlfoCw ($66.45 in chips)
DaZnoWHjO897dnh0CL2lVg: posts small blind $0.50
mgi+mjKb1Sc3CCs7TlfoCw: posts big blind $1
*** HOLE CARDS ***
DaZnoWHjO897dnh0CL2lVg: calls $0.50
mgi+mjKb1Sc3CCs7TlfoCw: raises $1 to $2
DaZnoWHjO897dnh0CL2lVg: calls $1
*** FLOP *** [Jh 5d 3d]
mgi+mjKb1Sc3CCs7TlfoCw: bets $2
DaZnoWHjO897dnh0CL2lVg: calls $2
*** TURN *** [Jh 5d 3d] [3c]
mgi+mjKb1Sc3CCs7TlfoCw: bets $5
DaZnoWHjO897dnh0CL2lVg: calls $5
*** RIVER *** [Jh 5d 3d 3c] [5h]
mgi+mjKb1Sc3CCs7TlfoCw: checks
DaZnoWHjO897dnh0CL2lVg: bets $7
mgi+mjKb1Sc3CCs7TlfoCw: folds
DaZnoWHjO897dnh0CL2lVg collected $17.50 from pot
DaZnoWHjO897dnh0CL2lVg: doesn't show hand
*** SUMMARY ***
Total pot $18 | Rake $0.50
Board [Jh 5d 3d 3c 5h]
Seat 1: DaZnoWHjO897dnh0CL2lVg (button) (small blind) collected ($17.50)
Seat 2: mgi+mjKb1Sc3CCs7TlfoCw (big blind) folded on the River



PokerStars Game #59940932194:  Hold'em No Limit ($0.50/$1.00) - 2009/07/01 1:20:49 ET
Table 'W/wyObTiXZm+Ckkl3YxcSw' 6-max Seat #4 is the button
Seat 1: eUBBn2R56C1IQ6Cs/vitwg ($300.40 in chips)
Seat 2: oDiBRCaF0QVtd3kO6xZIXw ($150.55 in chips)
Seat 3: dxyNCn/qxfkGDUIf28Cbng ($67.80 in chips)
Seat 4: UBZQqpnJZdTYYY1FTb0rLA ($100 in chips)
Seat 5: +OrCjyw70oZhJiD22Mn+bg ($100.50 in chips)
Seat 6: b2a+5TkFf4xJN/Ihhma58Q ($36.50 in chips)
+OrCjyw70oZhJiD22Mn+bg: posts small blind $0.50
b2a+5TkFf4xJN/Ihhma58Q: posts big blind $1
*** HOLE CARDS ***
eUBBn2R56C1IQ6Cs/vitwg: folds
oDiBRCaF0QVtd3kO6xZIXw: folds
dxyNCn/qxfkGDUIf28Cbng: folds
UBZQqpnJZdTYYY1FTb0rLA: folds
+OrCjyw70oZhJiD22Mn+bg: folds
b2a+5TkFf4xJN/Ihhma58Q collected $1 from pot
*** SUMMARY ***
Total pot $1 | Rake $0
Seat 1: eUBBn2R56C1IQ6Cs/vitwg folded before Flop (didn't bet)
Seat 2: oDiBRCaF0QVtd3kO6xZIXw folded before Flop (didn't bet)
Seat 3: dxyNCn/qxfkGDUIf28Cbng folded before Flop (didn't bet)
Seat 4: UBZQqpnJZdTYYY1FTb0rLA (button) folded before Flop (didn't bet)
Seat 5: +OrCjyw70oZhJiD22Mn+bg (small blind) folded before Flop
Seat 6: b2a+5TkFf4xJN/Ihhma58Q (big blind) collected ($1)



PokerStars Game #59940931856:  Hold'em No Limit ($0.50/$1.00) - 2009/07/01 1:20:49 ET
Table 'MUPc8FEpe/nR0BKSeReX6Q' 6-max Seat #5 is the button
Seat 1: qhkK6+yCciTRd+rCFEbnEQ ($86.70 in chips)
Seat 2: xAU6q2/cwmby2sxmA8VcmA ($113.20 in chips)
Seat 3: wx3sQGkVi2x9wJXuWNHPBw ($224.50 in chips)
Seat 4: ZA1bp6g8IwtTxkUE4eCjDQ ($152.10 in chips)
Seat 5: y27w5IK2WXqmYzS8OU0wKA ($100 in chips)
Seat 6: oxnw0GLLpFanjhGkxfRSqA ($45.95 in chips)
oxnw0GLLpFanjhGkxfRSqA: posts small blind $0.50
qhkK6+yCciTRd+rCFEbnEQ: posts big blind $1
*** HOLE CARDS ***
xAU6q2/cwmby2sxmA8VcmA: folds
wx3sQGkVi2x9wJXuWNHPBw: folds
ZA1bp6g8IwtTxkUE4eCjDQ: folds
y27w5IK2WXqmYzS8OU0wKA: folds
oxnw0GLLpFanjhGkxfRSqA: folds
qhkK6+yCciTRd+rCFEbnEQ collected $1 from pot
qhkK6+yCciTRd+rCFEbnEQ: doesn't show hand
*** SUMMARY ***
Total pot $1 | Rake $0
Seat 1: qhkK6+yCciTRd+rCFEbnEQ (big blind) collected ($1)
Seat 2: xAU6q2/cwmby2sxmA8VcmA folded before Flop (didn't bet)
Seat 3: wx3sQGkVi2x9wJXuWNHPBw folded before Flop (didn't bet)
Seat 4: ZA1bp6g8IwtTxkUE4eCjDQ folded before Flop (didn't bet)
Seat 5: y27w5IK2WXqmYzS8OU0wKA (button) folded before Flop (didn't bet)
Seat 6: oxnw0GLLpFanjhGkxfRSqA (small blind) folded before Flop



PokerStars Game #59940933210:  Hold'em No Limit ($0.50/$1.00) - 2009/07/01 1:20:51 ET
Table 'hdVBCnDy5t2X9dZo0AvD9w' 9-max Seat #5 is the button
Seat 1: sa/cZBFh73L9TapFXpn3BA ($98.45 in chips)
Seat 2: Ogn4JDV3mp4ZDKO49IFzKA ($19.50 in chips)
Seat 3: 1862487932 ($100 in chips)
Seat 4: YvSugbFKWSuAYx9iokQwUQ ($74.20 in chips)
Seat 5: H+DVy3Ei8L1UKS2tVOtJcw ($100 in chips)
Seat 6: bJckevFOcg//s0qyMQI6sQ ($100 in chips)
Seat 8: gUUvmqdVlmvpal6B8nYrmg ($144.40 in chips)
Seat 9: AMkLbywdoc0K30BTzaIfTQ ($183.40 in chips)
bJckevFOcg//s0qyMQI6sQ: posts small blind $0.50
KqC3XiX79XzqwhoOYPVb4w: is sitting out
gUUvmqdVlmvpal6B8nYrmg: posts big blind $1
*** HOLE CARDS ***
AMkLbywdoc0K30BTzaIfTQ: folds
KqC3XiX79XzqwhoOYPVb4w leaves the table
laA8va+Yv8WuMqT1zdR91g joins the table at seat #7
sa/cZBFh73L9TapFXpn3BA: raises $1 to $2
Ogn4JDV3mp4ZDKO49IFzKA: folds
1862487932: folds
YvSugbFKWSuAYx9iokQwUQ: folds
YvSugbFKWSuAYx9iokQwUQ is sitting out
H+DVy3Ei8L1UKS2tVOtJcw: calls $2
bJckevFOcg//s0qyMQI6sQ: calls $1.50
gUUvmqdVlmvpal6B8nYrmg: calls $1
*** FLOP *** [As 3h 3s]
bJckevFOcg//s0qyMQI6sQ: bets $5
gUUvmqdVlmvpal6B8nYrmg: folds
sa/cZBFh73L9TapFXpn3BA: folds
H+DVy3Ei8L1UKS2tVOtJcw: folds
bJckevFOcg//s0qyMQI6sQ collected $7.60 from pot
*** SUMMARY ***
Total pot $8 | Rake $0.40
Board [As 3h 3s]
Seat 1: sa/cZBFh73L9TapFXpn3BA folded on the Flop
Seat 2: Ogn4JDV3mp4ZDKO49IFzKA folded before Flop (didn't bet)
Seat 3: 1862487932 folded before Flop (didn't bet)
Seat 4: YvSugbFKWSuAYx9iokQwUQ folded before Flop (didn't bet)
Seat 5: H+DVy3Ei8L1UKS2tVOtJcw (button) folded on the Flop
Seat 6: bJckevFOcg//s0qyMQI6sQ (small blind) collected ($7.60)
Seat 8: gUUvmqdVlmvpal6B8nYrmg (big blind) folded on the Flop
Seat 9: AMkLbywdoc0K30BTzaIfTQ folded before Flop (didn't bet)



PokerStars Game #59940934340:  Hold'em No Limit ($0.50/$1.00) - 2009/07/01 1:20:53 ET
Table 'vs/5jr6ciwjVQ5+Soc+u2A' 6-max Seat #1 is the button
Seat 1: J798qwLuvXyq0BbzsIjOrA ($112.40 in chips)
Seat 2: lXX4W7m3u++JiSOZ46yVMQ ($106.15 in chips)
Seat 3: G5ZSSN6RSON3gkNvk/SmYg ($138.10 in chips)
Seat 4: wk6Ohn4GDozoOMHc4eb2rw ($60.80 in chips)
Seat 5: +Nt3OPk3XR9SKjZgm2CexQ ($149.10 in chips)
Seat 6: Z2fXsGcjl+Eax+RzOgwOmg ($101.50 in chips)
lXX4W7m3u++JiSOZ46yVMQ: posts small blind $0.50
G5ZSSN6RSON3gkNvk/SmYg: posts big blind $1
*** HOLE CARDS ***
wk6Ohn4GDozoOMHc4eb2rw: folds
+Nt3OPk3XR9SKjZgm2CexQ: folds
Z2fXsGcjl+Eax+RzOgwOmg: raises $3 to $4
J798qwLuvXyq0BbzsIjOrA: calls $4
lXX4W7m3u++JiSOZ46yVMQ: folds
G5ZSSN6RSON3gkNvk/SmYg: folds
*** FLOP *** [5s Td 4h]
Z2fXsGcjl+Eax+RzOgwOmg: bets $6
J798qwLuvXyq0BbzsIjOrA: calls $6
*** TURN *** [5s Td 4h] [5d]
Z2fXsGcjl+Eax+RzOgwOmg: checks
J798qwLuvXyq0BbzsIjOrA: checks
*** RIVER *** [5s Td 4h 5d] [As]
Z2fXsGcjl+Eax+RzOgwOmg: bets $15
J798qwLuvXyq0BbzsIjOrA: raises $20 to $35
Z2fXsGcjl+Eax+RzOgwOmg: calls $20
*** SHOW DOWN ***
J798qwLuvXyq0BbzsIjOrA: shows [5c Qc] (three of a kind, Fives)
Z2fXsGcjl+Eax+RzOgwOmg: mucks hand
J798qwLuvXyq0BbzsIjOrA collected $88.50 from pot
*** SUMMARY ***
Total pot $91.50 | Rake $3
Board [5s Td 4h 5d As]
Seat 1: J798qwLuvXyq0BbzsIjOrA (button) showed [5c Qc] and won ($88.50) with three of a kind, Fives
Seat 2: lXX4W7m3u++JiSOZ46yVMQ (small blind) folded before Flop
Seat 3: G5ZSSN6RSON3gkNvk/SmYg (big blind) folded before Flop
Seat 4: wk6Ohn4GDozoOMHc4eb2rw folded before Flop (didn't bet)
Seat 5: +Nt3OPk3XR9SKjZgm2CexQ folded before Flop (didn't bet)
Seat 6: Z2fXsGcjl+Eax+RzOgwOmg mucked



PokerStars Game #59940935136:  Hold'em No Limit ($0.50/$1.00) - 2009/07/01 1:20:55 ET
Table 'Evb7VW0qfDhFkbgBL3gcqQ' 2-max Seat #1 is the button
Seat 1: NYi6JFscYNrofSXy4sM+Yw ($107.70 in chips)
Seat 2: AoEQlM/FNYM0d7Txn1TfBQ ($100 in chips)
NYi6JFscYNrofSXy4sM+Yw: posts small blind $0.50
AoEQlM/FNYM0d7Txn1TfBQ: posts big blind $1
*** HOLE CARDS ***
NYi6JFscYNrofSXy4sM+Yw: folds
AoEQlM/FNYM0d7Txn1TfBQ collected $1 from pot
*** SUMMARY ***
Total pot $1 | Rake $0
Seat 1: NYi6JFscYNrofSXy4sM+Yw (button) (small blind) folded before Flop
Seat 2: AoEQlM/FNYM0d7Txn1TfBQ (big blind) collected ($1)



PokerStars Game #59940935802:  Hold'em No Limit ($0.50/$1.00) - 2009/07/01 1:20:56 ET
Table 'cBDNutyLBKEk9+ptwsKmTw' 6-max Seat #5 is the button
Seat 1: xAU6q2/cwmby2sxmA8VcmA ($259.90 in chips)
Seat 2: 5lY8d6Cnm4HUkt/8FZSj4g ($77.50 in chips)
Seat 3: G5ZSSN6RSON3gkNvk/SmYg ($105.95 in chips)
Seat 4: 3q7F5QtzC30pSrn0nl9i+A ($20 in chips)
Seat 5: hpxXcmRkXXI9HE5+5/j/0Q ($100 in chips)
Seat 6: QHvTZcrKe6+maWUfVjP29Q ($100 in chips)
QHvTZcrKe6+maWUfVjP29Q: posts small blind $0.50
xAU6q2/cwmby2sxmA8VcmA: posts big blind $1
*** HOLE CARDS ***
5lY8d6Cnm4HUkt/8FZSj4g: calls $1
G5ZSSN6RSON3gkNvk/SmYg: raises $4 to $5
3q7F5QtzC30pSrn0nl9i+A: folds
hpxXcmRkXXI9HE5+5/j/0Q: folds
QHvTZcrKe6+maWUfVjP29Q: folds
xAU6q2/cwmby2sxmA8VcmA: folds
5lY8d6Cnm4HUkt/8FZSj4g: calls $4
*** FLOP *** [5s Js 8h]
5lY8d6Cnm4HUkt/8FZSj4g: checks
G5ZSSN6RSON3gkNvk/SmYg: bets $5
5lY8d6Cnm4HUkt/8FZSj4g: folds
G5ZSSN6RSON3gkNvk/SmYg collected $10.95 from pot
G5ZSSN6RSON3gkNvk/SmYg: doesn't show hand
*** SUMMARY ***
Total pot $11.50 | Rake $0.55
Board [5s Js 8h]
Seat 1: xAU6q2/cwmby2sxmA8VcmA (big blind) folded before Flop
Seat 2: 5lY8d6Cnm4HUkt/8FZSj4g folded on the Flop
Seat 3: G5ZSSN6RSON3gkNvk/SmYg collected ($10.95)
Seat 4: 3q7F5QtzC30pSrn0nl9i+A folded before Flop (didn't bet)
Seat 5: hpxXcmRkXXI9HE5+5/j/0Q (button) folded before Flop (didn't bet)
Seat 6: QHvTZcrKe6+maWUfVjP29Q (small blind) folded before Flop



PokerStars Game #59940935876:  Hold'em No Limit ($0.50/$1.00) - 2009/07/01 1:20:56 ET
Table 'hugOjcwJvzEwZbK7tyiWuQ' 9-max Seat #4 is the button
Seat 1: S3Ex8K7v6xm5jqjRM7Fl3w ($22 in chips)
Seat 2: r27C1nIV4NS4+qbnrgBQSw ($272.20 in chips)
Seat 4: UWB3oeddt/GObx2Mix2Anw ($186.10 in chips)
Seat 6: gUUvmqdVlmvpal6B8nYrmg ($100 in chips)
Seat 7: FL3MrLspcF23LYvC4ipBOA ($120.30 in chips)
Seat 8: /zy+DB4S5fUQUSfZWFzYGw ($126.25 in chips)
Seat 9: W8P9bUKCs43TO1xHm0dL6w ($106.95 in chips)
gUUvmqdVlmvpal6B8nYrmg: posts small blind $0.50
FL3MrLspcF23LYvC4ipBOA: posts big blind $1
*** HOLE CARDS ***
ZWdwcEAWYlrUhsRi6MOmoA has returned
/zy+DB4S5fUQUSfZWFzYGw: folds
W8P9bUKCs43TO1xHm0dL6w: folds
S3Ex8K7v6xm5jqjRM7Fl3w: folds
r27C1nIV4NS4+qbnrgBQSw: folds
UWB3oeddt/GObx2Mix2Anw: raises $2 to $3
gUUvmqdVlmvpal6B8nYrmg: folds
FL3MrLspcF23LYvC4ipBOA: folds
UWB3oeddt/GObx2Mix2Anw collected $2.50 from pot
*** SUMMARY ***
Total pot $2.50 | Rake $0
Seat 1: S3Ex8K7v6xm5jqjRM7Fl3w folded before Flop (didn't bet)
Seat 2: r27C1nIV4NS4+qbnrgBQSw folded before Flop (didn't bet)
Seat 4: UWB3oeddt/GObx2Mix2Anw (button) collected ($2.50)
Seat 6: gUUvmqdVlmvpal6B8nYrmg (small blind) folded before Flop
Seat 7: FL3MrLspcF23LYvC4ipBOA (big blind) folded before Flop
Seat 8: /zy+DB4S5fUQUSfZWFzYGw folded before Flop (didn't bet)
Seat 9: W8P9bUKCs43TO1xHm0dL6w folded before Flop (didn't bet)



PokerStars Game #59940935676:  Hold'em No Limit ($0.50/$1.00) - 2009/07/01 1:20:56 ET
Table '7Nl0ffnjeK44/vmeexh3MQ' 9-max Seat #3 is the button
Seat 1: V138SURkdX8LdVBPKdJJag ($100 in chips)
Seat 2: OGgaARGdJQT4awWVNQ957w ($100.50 in chips)
Seat 3: JMmUYT5pIKCKh2pGjCB/4w ($54.90 in chips)
Seat 4: bLbSOSmSOnqE0iTcH/5dxA ($101.85 in chips)
Seat 6: FVs16t7GgfWgQWt4JxsObQ ($29.75 in chips)
Seat 7: 997ViqAtWn1FPjJqcffwcA ($100 in chips)
Seat 8: D+W9Me7w6Hcx/WRUSKV0dw ($19.25 in chips)
Seat 9: ouwUBGRKnKK9uhn1G4Lf+A ($195.50 in chips)
bLbSOSmSOnqE0iTcH/5dxA: posts small blind $0.50
61sfw5QTu62YYIt68OsdrA: is sitting out
FVs16t7GgfWgQWt4JxsObQ: posts big blind $1
*** HOLE CARDS ***
997ViqAtWn1FPjJqcffwcA: folds
D+W9Me7w6Hcx/WRUSKV0dw: folds
ouwUBGRKnKK9uhn1G4Lf+A: folds
V138SURkdX8LdVBPKdJJag: folds
OGgaARGdJQT4awWVNQ957w: folds
JMmUYT5pIKCKh2pGjCB/4w: folds
bLbSOSmSOnqE0iTcH/5dxA: folds
FVs16t7GgfWgQWt4JxsObQ collected $1 from pot
*** SUMMARY ***
Total pot $1 | Rake $0
Seat 1: V138SURkdX8LdVBPKdJJag folded before Flop (didn't bet)
Seat 2: OGgaARGdJQT4awWVNQ957w folded before Flop (didn't bet)
Seat 3: JMmUYT5pIKCKh2pGjCB/4w (button) folded before Flop (didn't bet)
Seat 4: bLbSOSmSOnqE0iTcH/5dxA (small blind) folded before Flop
Seat 6: FVs16t7GgfWgQWt4JxsObQ (big blind) collected ($1)
Seat 7: 997ViqAtWn1FPjJqcffwcA folded before Flop (didn't bet)
Seat 8: D+W9Me7w6Hcx/WRUSKV0dw folded before Flop (didn't bet)
Seat 9: ouwUBGRKnKK9uhn1G4Lf+A folded before Flop (didn't bet)



PokerStars Game #59940940298:  Hold'em No Limit ($0.50/$1.00) - 2009/07/01 1:21:04 ET
Table 'MUPc8FEpe/nR0BKSeReX6Q' 6-max Seat #6 is the button
Seat 1: qhkK6+yCciTRd+rCFEbnEQ ($87.20 in chips)
Seat 2: xAU6q2/cwmby2sxmA8VcmA ($113.20 in chips)
Seat 3: wx3sQGkVi2x9wJXuWNHPBw ($224.50 in chips)
Seat 4: ZA1bp6g8IwtTxkUE4eCjDQ ($152.10 in chips)
Seat 5: y27w5IK2WXqmYzS8OU0wKA ($100 in chips)
Seat 6: oxnw0GLLpFanjhGkxfRSqA ($45.45 in chips)
qhkK6+yCciTRd+rCFEbnEQ: posts small blind $0.50
xAU6q2/cwmby2sxmA8VcmA: posts big blind $1
*** HOLE CARDS ***
wx3sQGkVi2x9wJXuWNHPBw: folds
ZA1bp6g8IwtTxkUE4eCjDQ: raises $1 to $2
y27w5IK2WXqmYzS8OU0wKA: folds
oxnw0GLLpFanjhGkxfRSqA: folds
qhkK6+yCciTRd+rCFEbnEQ: calls $1.50
xAU6q2/cwmby2sxmA8VcmA: folds
*** FLOP *** [Js 4h 3h]
qhkK6+yCciTRd+rCFEbnEQ: checks
ZA1bp6g8IwtTxkUE4eCjDQ: bets $2
qhkK6+yCciTRd+rCFEbnEQ: calls $2
*** TURN *** [Js 4h 3h] [Td]
qhkK6+yCciTRd+rCFEbnEQ: checks
ZA1bp6g8IwtTxkUE4eCjDQ: bets $7
qhkK6+yCciTRd+rCFEbnEQ: folds
ZA1bp6g8IwtTxkUE4eCjDQ collected $8.60 from pot
ZA1bp6g8IwtTxkUE4eCjDQ: doesn't show hand
*** SUMMARY ***
Total pot $9 | Rake $0.40
Board [Js 4h 3h Td]
Seat 1: qhkK6+yCciTRd+rCFEbnEQ (small blind) folded on the Turn
Seat 2: xAU6q2/cwmby2sxmA8VcmA (big blind) folded before Flop
Seat 3: wx3sQGkVi2x9wJXuWNHPBw folded before Flop (didn't bet)
Seat 4: ZA1bp6g8IwtTxkUE4eCjDQ collected ($8.60)
Seat 5: y27w5IK2WXqmYzS8OU0wKA folded before Flop (didn't bet)
Seat 6: oxnw0GLLpFanjhGkxfRSqA (button) folded before Flop (didn't bet)



PokerStars Game #59940940262:  Hold'em No Limit ($0.50/$1.00) - 2009/07/01 1:21:04 ET
Table 'Evb7VW0qfDhFkbgBL3gcqQ' 2-max Seat #2 is the button
Seat 1: NYi6JFscYNrofSXy4sM+Yw ($107.20 in chips)
Seat 2: AoEQlM/FNYM0d7Txn1TfBQ ($100.50 in chips)
AoEQlM/FNYM0d7Txn1TfBQ: posts small blind $0.50
NYi6JFscYNrofSXy4sM+Yw: posts big blind $1
*** HOLE CARDS ***
AoEQlM/FNYM0d7Txn1TfBQ: raises $3 to $4
NYi6JFscYNrofSXy4sM+Yw: folds
AoEQlM/FNYM0d7Txn1TfBQ collected $2 from pot
AoEQlM/FNYM0d7Txn1TfBQ: doesn't show hand
*** SUMMARY ***
Total pot $2 | Rake $0
Seat 1: NYi6JFscYNrofSXy4sM+Yw (big blind) folded before Flop
Seat 2: AoEQlM/FNYM0d7Txn1TfBQ (button) (small blind) collected ($2)



PokerStars Game #59940940504:  Hold'em No Limit ($0.50/$1.00) - 2009/07/01 1:21:05 ET
Table 'TvsifD4n+q//fIZ4fM1xxQ' 2-max Seat #2 is the button
Seat 1: NYi6JFscYNrofSXy4sM+Yw ($100 in chips)
Seat 2: +W/hy0gBp0sJy8pjLz6Yrg ($61.50 in chips)
+W/hy0gBp0sJy8pjLz6Yrg: posts small blind $0.50
NYi6JFscYNrofSXy4sM+Yw: posts big blind $1
*** HOLE CARDS ***
+W/hy0gBp0sJy8pjLz6Yrg: calls $0.50
NYi6JFscYNrofSXy4sM+Yw: checks
*** FLOP *** [6h Qh 4s]
NYi6JFscYNrofSXy4sM+Yw: bets $2
+W/hy0gBp0sJy8pjLz6Yrg: raises $3 to $5
NYi6JFscYNrofSXy4sM+Yw: folds
+W/hy0gBp0sJy8pjLz6Yrg collected $5.75 from pot
*** SUMMARY ***
Total pot $6 | Rake $0.25
Board [6h Qh 4s]
Seat 1: NYi6JFscYNrofSXy4sM+Yw (big blind) folded on the Flop
Seat 2: +W/hy0gBp0sJy8pjLz6Yrg (button) (small blind) collected ($5.75)



PokerStars Game #59940943400:  Hold'em No Limit ($0.50/$1.00) - 2009/07/01 1:21:09 ET
Table 'pHrhryH8jPNdQfY62f8v+g' 6-max Seat #3 is the button
Seat 1: 4d1rWhpu8DzLmzMbR3QKyA ($117.05 in chips)
Seat 2: JwCcjZl0bjJzG7hmE0dnTA ($100 in chips)
Seat 3: 8oS5O7iD/qnFXFXJrGIgNQ ($100 in chips)
Seat 4: 1f3beyIML24UqEMTbWy93g ($67.20 in chips)
Seat 5: r1/R7y0Ortgoz4lccgW8VA ($21.75 in chips)
Seat 6: xAU6q2/cwmby2sxmA8VcmA ($205.10 in chips)
1f3beyIML24UqEMTbWy93g: posts small blind $0.50
r1/R7y0Ortgoz4lccgW8VA: posts big blind $1
*** HOLE CARDS ***
xAU6q2/cwmby2sxmA8VcmA: folds
4d1rWhpu8DzLmzMbR3QKyA: folds
JwCcjZl0bjJzG7hmE0dnTA: raises $2 to $3
8oS5O7iD/qnFXFXJrGIgNQ: folds
1f3beyIML24UqEMTbWy93g: folds
r1/R7y0Ortgoz4lccgW8VA: folds
JwCcjZl0bjJzG7hmE0dnTA collected $2.50 from pot
*** SUMMARY ***
Total pot $2.50 | Rake $0
Seat 1: 4d1rWhpu8DzLmzMbR3QKyA folded before Flop (didn't bet)
Seat 2: JwCcjZl0bjJzG7hmE0dnTA collected ($2.50)
Seat 3: 8oS5O7iD/qnFXFXJrGIgNQ (button) folded before Flop (didn't bet)
Seat 4: 1f3beyIML24UqEMTbWy93g (small blind) folded before Flop
Seat 5: r1/R7y0Ortgoz4lccgW8VA (big blind) folded before Flop
Seat 6: xAU6q2/cwmby2sxmA8VcmA folded before Flop (didn't bet)



PokerStars Game #59940943024:  Hold'em No Limit ($0.50/$1.00) - 2009/07/01 1:21:09 ET
Table 'W/wyObTiXZm+Ckkl3YxcSw' 6-max Seat #5 is the button
Seat 1: eUBBn2R56C1IQ6Cs/vitwg ($300.40 in chips)
Seat 2: oDiBRCaF0QVtd3kO6xZIXw ($150.55 in chips)
Seat 3: dxyNCn/qxfkGDUIf28Cbng ($67.80 in chips)
Seat 4: UBZQqpnJZdTYYY1FTb0rLA ($100 in chips)
Seat 5: +OrCjyw70oZhJiD22Mn+bg ($100 in chips)
Seat 6: b2a+5TkFf4xJN/Ihhma58Q ($37 in chips)
b2a+5TkFf4xJN/Ihhma58Q: posts small blind $0.50
eUBBn2R56C1IQ6Cs/vitwg: posts big blind $1
*** HOLE CARDS ***
oDiBRCaF0QVtd3kO6xZIXw: folds
dxyNCn/qxfkGDUIf28Cbng: folds
UBZQqpnJZdTYYY1FTb0rLA: folds
+OrCjyw70oZhJiD22Mn+bg: folds
b2a+5TkFf4xJN/Ihhma58Q: calls $0.50
eUBBn2R56C1IQ6Cs/vitwg: raises $3 to $4
b2a+5TkFf4xJN/Ihhma58Q: calls $3
*** FLOP *** [7c Qd Js]
b2a+5TkFf4xJN/Ihhma58Q: checks
eUBBn2R56C1IQ6Cs/vitwg: bets $6
b2a+5TkFf4xJN/Ihhma58Q: raises $12 to $18
eUBBn2R56C1IQ6Cs/vitwg: folds
b2a+5TkFf4xJN/Ihhma58Q collected $19.05 from pot
*** SUMMARY ***
Total pot $20 | Rake $0.95
Board [7c Qd Js]
Seat 1: eUBBn2R56C1IQ6Cs/vitwg (big blind) folded on the Flop
Seat 2: oDiBRCaF0QVtd3kO6xZIXw folded before Flop (didn't bet)
Seat 3: dxyNCn/qxfkGDUIf28Cbng folded before Flop (didn't bet)
Seat 4: UBZQqpnJZdTYYY1FTb0rLA folded before Flop (didn't bet)
Seat 5: +OrCjyw70oZhJiD22Mn+bg (button) folded before Flop (didn't bet)
Seat 6: b2a+5TkFf4xJN/Ihhma58Q (small blind) collected ($19.05)



PokerStars Game #59940944638:  Hold'em No Limit ($0.50/$1.00) - 2009/07/01 1:21:11 ET
Table 'GPp0HyAuggN8oE0sUWzPpA' 9-max Seat #2 is the button
Seat 1: qJr25HAtvv1w/7IBvjMM3g ($48 in chips)
Seat 2: m3U8I35Pn3gxKhoS2nmYIg ($25.45 in chips)
Seat 3: CCCXsirC+bO7ginAuUUVlQ ($51.25 in chips)
Seat 4: mBRWbnUl8diyBO1qTJaNzw ($101.65 in chips)
Seat 5: bLbSOSmSOnqE0iTcH/5dxA ($100 in chips)
Seat 6: BK/GtNPkSx0TdUDj82id5A ($34.70 in chips)
Seat 7: DHdbHyysD15wCAtx+BhUjA ($96.70 in chips)
Seat 8: P/6qLjycEfxRgZ5F/W90dw ($96 in chips)
Seat 9: dzoSjPZmtjGuK83119030A ($23.75 in chips)
CCCXsirC+bO7ginAuUUVlQ: posts small blind $0.50
mBRWbnUl8diyBO1qTJaNzw: posts big blind $1
*** HOLE CARDS ***
bLbSOSmSOnqE0iTcH/5dxA: folds
BK/GtNPkSx0TdUDj82id5A: folds
DHdbHyysD15wCAtx+BhUjA: folds
P/6qLjycEfxRgZ5F/W90dw: folds
dzoSjPZmtjGuK83119030A: folds
dzoSjPZmtjGuK83119030A leaves the table
qJr25HAtvv1w/7IBvjMM3g: folds
m3U8I35Pn3gxKhoS2nmYIg: calls $1
myIxN7otsyr846M539YR8Q joins the table at seat #9
CCCXsirC+bO7ginAuUUVlQ: calls $0.50
mBRWbnUl8diyBO1qTJaNzw: checks
*** FLOP *** [Ks 9s Jd]
CCCXsirC+bO7ginAuUUVlQ: checks
mBRWbnUl8diyBO1qTJaNzw: checks
m3U8I35Pn3gxKhoS2nmYIg: checks
*** TURN *** [Ks 9s Jd] [4c]
CCCXsirC+bO7ginAuUUVlQ: checks
mBRWbnUl8diyBO1qTJaNzw: checks
m3U8I35Pn3gxKhoS2nmYIg: checks
*** RIVER *** [Ks 9s Jd 4c] [Tc]
CCCXsirC+bO7ginAuUUVlQ: bets $2
mBRWbnUl8diyBO1qTJaNzw: folds
m3U8I35Pn3gxKhoS2nmYIg: folds
CCCXsirC+bO7ginAuUUVlQ collected $2.85 from pot
*** SUMMARY ***
Total pot $3 | Rake $0.15
Board [Ks 9s Jd 4c Tc]
Seat 1: qJr25HAtvv1w/7IBvjMM3g folded before Flop (didn't bet)
Seat 2: m3U8I35Pn3gxKhoS2nmYIg (button) folded on the River
Seat 3: CCCXsirC+bO7ginAuUUVlQ (small blind) collected ($2.85)
Seat 4: mBRWbnUl8diyBO1qTJaNzw (big blind) folded on the River
Seat 5: bLbSOSmSOnqE0iTcH/5dxA folded before Flop (didn't bet)
Seat 6: BK/GtNPkSx0TdUDj82id5A folded before Flop (didn't bet)
Seat 7: DHdbHyysD15wCAtx+BhUjA folded before Flop (didn't bet)
Seat 8: P/6qLjycEfxRgZ5F/W90dw folded before Flop (didn't bet)
Seat 9: dzoSjPZmtjGuK83119030A folded before Flop (didn't bet)



PokerStars Game #59940944838:  Hold'em No Limit ($0.50/$1.00) - 2009/07/01 1:21:12 ET
Table 'O96CPOtvMBWP6kzuYDfdFA' 6-max Seat #3 is the button
Seat 1: 6alLXQIITA2EZ/lBeym8Dw ($125.25 in chips)
Seat 2: 4d1rWhpu8DzLmzMbR3QKyA ($108.35 in chips)
Seat 3: V89DGjxE171oPREEbAXiyg ($93.15 in chips)
Seat 4: /P4w1pHg2zHYg/4ubJ0dPw ($60 in chips)
Seat 5: G5ZSSN6RSON3gkNvk/SmYg ($101.50 in chips)
Seat 6: GYei5jXGWexiJYbAT2fELg ($35.15 in chips)
/P4w1pHg2zHYg/4ubJ0dPw: posts small blind $0.50
G5ZSSN6RSON3gkNvk/SmYg: posts big blind $1
*** HOLE CARDS ***
GYei5jXGWexiJYbAT2fELg: calls $1
6alLXQIITA2EZ/lBeym8Dw: folds
4d1rWhpu8DzLmzMbR3QKyA: raises $3 to $4
V89DGjxE171oPREEbAXiyg: folds
/P4w1pHg2zHYg/4ubJ0dPw: folds
G5ZSSN6RSON3gkNvk/SmYg: folds
GYei5jXGWexiJYbAT2fELg: calls $3
*** FLOP *** [6h Td Ks]
GYei5jXGWexiJYbAT2fELg: checks
4d1rWhpu8DzLmzMbR3QKyA: bets $7
GYei5jXGWexiJYbAT2fELg: folds
4d1rWhpu8DzLmzMbR3QKyA collected $9.05 from pot
*** SUMMARY ***
Total pot $9.50 | Rake $0.45
Board [6h Td Ks]
Seat 1: 6alLXQIITA2EZ/lBeym8Dw folded before Flop (didn't bet)
Seat 2: 4d1rWhpu8DzLmzMbR3QKyA collected ($9.05)
Seat 3: V89DGjxE171oPREEbAXiyg (button) folded before Flop (didn't bet)
Seat 4: /P4w1pHg2zHYg/4ubJ0dPw (small blind) folded before Flop
Seat 5: G5ZSSN6RSON3gkNvk/SmYg (big blind) folded before Flop
Seat 6: GYei5jXGWexiJYbAT2fELg folded on the Flop



PokerStars Game #59940945758:  Hold'em No Limit ($0.50/$1.00) - 2009/07/01 1:21:13 ET
Table '7O9fB8yx1u7sJveJn8w6jA' 6-max Seat #4 is the button
Seat 1: jy52+7FotjH63o5tEEVgKw ($66.80 in chips)
Seat 2: wx3sQGkVi2x9wJXuWNHPBw ($200.70 in chips)
Seat 3: hpxXcmRkXXI9HE5+5/j/0Q ($122.75 in chips)
Seat 4: b2a+5TkFf4xJN/Ihhma58Q ($30.15 in chips)
Seat 5: BCEV3COoKY607AzLWayfRA ($100 in chips)
Seat 6: 6hLdALbOlkzGIrc53QKtPw ($20 in chips)
BCEV3COoKY607AzLWayfRA: posts small blind $0.50
6hLdALbOlkzGIrc53QKtPw: posts big blind $1
*** HOLE CARDS ***
jy52+7FotjH63o5tEEVgKw: calls $1
wx3sQGkVi2x9wJXuWNHPBw: folds
hpxXcmRkXXI9HE5+5/j/0Q: folds
b2a+5TkFf4xJN/Ihhma58Q: folds
BCEV3COoKY607AzLWayfRA: calls $0.50
6hLdALbOlkzGIrc53QKtPw: checks
*** FLOP *** [Ac Kd 5h]
BCEV3COoKY607AzLWayfRA: bets $3
6hLdALbOlkzGIrc53QKtPw: folds
jy52+7FotjH63o5tEEVgKw: folds
BCEV3COoKY607AzLWayfRA collected $2.85 from pot
BCEV3COoKY607AzLWayfRA: doesn't show hand
*** SUMMARY ***
Total pot $3 | Rake $0.15
Board [Ac Kd 5h]
Seat 1: jy52+7FotjH63o5tEEVgKw folded on the Flop
Seat 2: wx3sQGkVi2x9wJXuWNHPBw folded before Flop (didn't bet)
Seat 3: hpxXcmRkXXI9HE5+5/j/0Q folded before Flop (didn't bet)
Seat 4: b2a+5TkFf4xJN/Ihhma58Q (button) folded before Flop (didn't bet)
Seat 5: BCEV3COoKY607AzLWayfRA (small blind) collected ($2.85)
Seat 6: 6hLdALbOlkzGIrc53QKtPw (big blind) folded on the Flop



PokerStars Game #59940947366:  Hold'em No Limit ($0.50/$1.00) - 2009/07/01 1:21:16 ET
Table 'fZjVbKj9D8yOB+Rj7NaP/A' 9-max Seat #6 is the button
Seat 1: 9BZCcac3+McErkkSN2YScA ($100 in chips)
Seat 2: PTAFYDIUSsG+SArbxNl+Aw ($105.50 in chips)
Seat 3: yAbu2QsRPVcjPbqlf/jDxw ($101 in chips)
Seat 4: 997ViqAtWn1FPjJqcffwcA ($101 in chips)
Seat 5: PkGfq5xrSlNsujKaG/HF4Q ($100 in chips)
Seat 6: OvwYHV65yUbgdBjSmo1+5g ($45.95 in chips)
Seat 7: SyS20PAm3RpT6uLBsGkwOA ($120.55 in chips)
Seat 8: zDOE5r14tWqCf6xhuSHK6g ($41 in chips)
Seat 9: qheQay5YvP2DMAb3OUSxtw ($100 in chips)
SyS20PAm3RpT6uLBsGkwOA: posts small blind $0.50
zDOE5r14tWqCf6xhuSHK6g: posts big blind $1
*** HOLE CARDS ***
qheQay5YvP2DMAb3OUSxtw: folds
9BZCcac3+McErkkSN2YScA: folds
PTAFYDIUSsG+SArbxNl+Aw: folds
yAbu2QsRPVcjPbqlf/jDxw: folds
997ViqAtWn1FPjJqcffwcA: folds
PkGfq5xrSlNsujKaG/HF4Q: raises $3 to $4
OvwYHV65yUbgdBjSmo1+5g: folds
SyS20PAm3RpT6uLBsGkwOA: folds
zDOE5r14tWqCf6xhuSHK6g: folds
PkGfq5xrSlNsujKaG/HF4Q collected $2.50 from pot
PkGfq5xrSlNsujKaG/HF4Q: doesn't show hand
*** SUMMARY ***
Total pot $2.50 | Rake $0
Seat 1: 9BZCcac3+McErkkSN2YScA folded before Flop (didn't bet)
Seat 2: PTAFYDIUSsG+SArbxNl+Aw folded before Flop (didn't bet)
Seat 3: yAbu2QsRPVcjPbqlf/jDxw folded before Flop (didn't bet)
Seat 4: 997ViqAtWn1FPjJqcffwcA folded before Flop (didn't bet)
Seat 5: PkGfq5xrSlNsujKaG/HF4Q collected ($2.50)
Seat 6: OvwYHV65yUbgdBjSmo1+5g (button) folded before Flop (didn't bet)
Seat 7: SyS20PAm3RpT6uLBsGkwOA (small blind) folded before Flop
Seat 8: zDOE5r14tWqCf6xhuSHK6g (big blind) folded before Flop
Seat 9: qheQay5YvP2DMAb3OUSxtw folded before Flop (didn't bet)



PokerStars Game #59940948942:  Hold'em No Limit ($0.50/$1.00) - 2009/07/01 1:21:19 ET
Table 'MNvFfRVQNka/oY+Z5aMbZQ' 2-max Seat #2 is the button
Seat 1: DaZnoWHjO897dnh0CL2lVg ($65.65 in chips)
Seat 2: mgi+mjKb1Sc3CCs7TlfoCw ($57.45 in chips)
mgi+mjKb1Sc3CCs7TlfoCw: posts small blind $0.50
DaZnoWHjO897dnh0CL2lVg: posts big blind $1
*** HOLE CARDS ***
mgi+mjKb1Sc3CCs7TlfoCw: raises $2 to $3
DaZnoWHjO897dnh0CL2lVg: folds
mgi+mjKb1Sc3CCs7TlfoCw collected $2 from pot
mgi+mjKb1Sc3CCs7TlfoCw: doesn't show hand
*** SUMMARY ***
Total pot $2 | Rake $0
Seat 1: DaZnoWHjO897dnh0CL2lVg (big blind) folded before Flop
Seat 2: mgi+mjKb1Sc3CCs7TlfoCw (button) (small blind) collected ($2)



PokerStars Game #59940948994:  Hold'em No Limit ($0.50/$1.00) - 2009/07/01 1:21:19 ET
Table '7Nl0ffnjeK44/vmeexh3MQ' 9-max Seat #4 is the button
Seat 1: V138SURkdX8LdVBPKdJJag ($100 in chips)
Seat 2: OGgaARGdJQT4awWVNQ957w ($100.50 in chips)
Seat 3: JMmUYT5pIKCKh2pGjCB/4w ($54.90 in chips)
Seat 4: bLbSOSmSOnqE0iTcH/5dxA ($101.35 in chips)
Seat 6: FVs16t7GgfWgQWt4JxsObQ ($30.25 in chips)
Seat 7: 997ViqAtWn1FPjJqcffwcA ($100 in chips)
Seat 8: D+W9Me7w6Hcx/WRUSKV0dw ($19.25 in chips)
Seat 9: ouwUBGRKnKK9uhn1G4Lf+A ($195.50 in chips)
FVs16t7GgfWgQWt4JxsObQ: posts small blind $0.50
997ViqAtWn1FPjJqcffwcA: posts big blind $1
*** HOLE CARDS ***
D+W9Me7w6Hcx/WRUSKV0dw: folds
ouwUBGRKnKK9uhn1G4Lf+A: folds
V138SURkdX8LdVBPKdJJag: folds
ouwUBGRKnKK9uhn1G4Lf+A leaves the table
OGgaARGdJQT4awWVNQ957w: folds
JMmUYT5pIKCKh2pGjCB/4w: raises $3 to $4
rFvc7K/96V9eGvYRfmpoUQ joins the table at seat #9
bLbSOSmSOnqE0iTcH/5dxA: folds
FVs16t7GgfWgQWt4JxsObQ: calls $3.50
997ViqAtWn1FPjJqcffwcA: folds
*** FLOP *** [8h Ks 4c]
FVs16t7GgfWgQWt4JxsObQ: bets $1
JMmUYT5pIKCKh2pGjCB/4w: raises $3 to $4
FVs16t7GgfWgQWt4JxsObQ: folds
JMmUYT5pIKCKh2pGjCB/4w collected $10.50 from pot
JMmUYT5pIKCKh2pGjCB/4w: doesn't show hand
*** SUMMARY ***
Total pot $11 | Rake $0.50
Board [8h Ks 4c]
Seat 1: V138SURkdX8LdVBPKdJJag folded before Flop (didn't bet)
Seat 2: OGgaARGdJQT4awWVNQ957w folded before Flop (didn't bet)
Seat 3: JMmUYT5pIKCKh2pGjCB/4w collected ($10.50)
Seat 4: bLbSOSmSOnqE0iTcH/5dxA (button) folded before Flop (didn't bet)
Seat 6: FVs16t7GgfWgQWt4JxsObQ (small blind) folded on the Flop
Seat 7: 997ViqAtWn1FPjJqcffwcA (big blind) folded before Flop
Seat 8: D+W9Me7w6Hcx/WRUSKV0dw folded before Flop (didn't bet)
Seat 9: ouwUBGRKnKK9uhn1G4Lf+A folded before Flop (didn't bet)



PokerStars Game #59940949318:  Hold'em No Limit ($0.50/$1.00) - 2009/07/01 1:21:20 ET
Table 'Evb7VW0qfDhFkbgBL3gcqQ' 2-max Seat #1 is the button
Seat 1: NYi6JFscYNrofSXy4sM+Yw ($106.20 in chips)
Seat 2: AoEQlM/FNYM0d7Txn1TfBQ ($101.50 in chips)
NYi6JFscYNrofSXy4sM+Yw: posts small blind $0.50
AoEQlM/FNYM0d7Txn1TfBQ: posts big blind $1
*** HOLE CARDS ***
NYi6JFscYNrofSXy4sM+Yw: raises $2 to $3
AoEQlM/FNYM0d7Txn1TfBQ: folds
NYi6JFscYNrofSXy4sM+Yw collected $2 from pot
*** SUMMARY ***
Total pot $2 | Rake $0
Seat 1: NYi6JFscYNrofSXy4sM+Yw (button) (small blind) collected ($2)
Seat 2: AoEQlM/FNYM0d7Txn1TfBQ (big blind) folded before Flop



PokerStars Game #59940950142:  Hold'em No Limit ($0.50/$1.00) - 2009/07/01 1:21:21 ET
Table 'uNlePsyMIqzM691Xkrlk6Q' 9-max Seat #3 is the button
Seat 1: bLbSOSmSOnqE0iTcH/5dxA ($114 in chips)
Seat 2: +OqpStnt0FqbCfyHAWaLbg ($88.50 in chips)
Seat 3: h7qXkU57Bb8ZuPwMyxR8Ug ($45.25 in chips)
Seat 4: TRx/IDriSKVaxeebBKhcFQ ($19.90 in chips)
Seat 5: 9jIz1JKIpvRv9Xv6qqhAMA ($68.80 in chips)
Seat 7: KNAaBvPYSXyLqb88ypSbuQ ($26.95 in chips)
Seat 8: yWcEtGJ3ijZsF6HqlHqkrg ($105.40 in chips)
TRx/IDriSKVaxeebBKhcFQ: posts small blind $0.50
9jIz1JKIpvRv9Xv6qqhAMA: posts big blind $1
froChili: sits out
OGgaARGdJQT4awWVNQ957w: sits out
*** HOLE CARDS ***
KNAaBvPYSXyLqb88ypSbuQ: folds
yWcEtGJ3ijZsF6HqlHqkrg: folds
bLbSOSmSOnqE0iTcH/5dxA: folds
+OqpStnt0FqbCfyHAWaLbg: folds
h7qXkU57Bb8ZuPwMyxR8Ug: raises $3 to $4
TRx/IDriSKVaxeebBKhcFQ: folds
9jIz1JKIpvRv9Xv6qqhAMA: calls $3
*** FLOP *** [Th Jd As]
9jIz1JKIpvRv9Xv6qqhAMA: checks
h7qXkU57Bb8ZuPwMyxR8Ug: bets $4
9jIz1JKIpvRv9Xv6qqhAMA: calls $4
*** TURN *** [Th Jd As] [Ac]
9jIz1JKIpvRv9Xv6qqhAMA: checks
h7qXkU57Bb8ZuPwMyxR8Ug: bets $4
9jIz1JKIpvRv9Xv6qqhAMA: calls $4
*** RIVER *** [Th Jd As Ac] [Td]
9jIz1JKIpvRv9Xv6qqhAMA: checks
h7qXkU57Bb8ZuPwMyxR8Ug: bets $6
9jIz1JKIpvRv9Xv6qqhAMA: calls $6
*** SHOW DOWN ***
h7qXkU57Bb8ZuPwMyxR8Ug: shows [Kh Ad] (a full house, Aces full of Tens)
9jIz1JKIpvRv9Xv6qqhAMA: mucks hand
h7qXkU57Bb8ZuPwMyxR8Ug collected $34.75 from pot
*** SUMMARY ***
Total pot $36.50 | Rake $1.75
Board [Th Jd As Ac Td]
Seat 1: bLbSOSmSOnqE0iTcH/5dxA folded before Flop (didn't bet)
Seat 2: +OqpStnt0FqbCfyHAWaLbg folded before Flop (didn't bet)
Seat 3: h7qXkU57Bb8ZuPwMyxR8Ug (button) showed [Kh Ad] and won ($34.75) with a full house, Aces full of Tens
Seat 4: TRx/IDriSKVaxeebBKhcFQ (small blind) folded before Flop
Seat 5: 9jIz1JKIpvRv9Xv6qqhAMA (big blind) mucked
Seat 7: KNAaBvPYSXyLqb88ypSbuQ folded before Flop (didn't bet)
Seat 8: yWcEtGJ3ijZsF6HqlHqkrg folded before Flop (didn't bet)



PokerStars Game #59940950880:  Hold'em No Limit ($0.50/$1.00) - 2009/07/01 1:21:23 ET
Table 'TvsifD4n+q//fIZ4fM1xxQ' 2-max Seat #1 is the button
Seat 1: NYi6JFscYNrofSXy4sM+Yw ($100 in chips)
Seat 2: +W/hy0gBp0sJy8pjLz6Yrg ($64.25 in chips)
NYi6JFscYNrofSXy4sM+Yw: posts small blind $0.50
+W/hy0gBp0sJy8pjLz6Yrg: posts big blind $1
*** HOLE CARDS ***
NYi6JFscYNrofSXy4sM+Yw: raises $2 to $3
+W/hy0gBp0sJy8pjLz6Yrg: calls $2
*** FLOP *** [2c 6h 9d]
+W/hy0gBp0sJy8pjLz6Yrg: checks
NYi6JFscYNrofSXy4sM+Yw: bets $3
+W/hy0gBp0sJy8pjLz6Yrg: calls $3
*** TURN *** [2c 6h 9d] [Qc]
+W/hy0gBp0sJy8pjLz6Yrg: checks
NYi6JFscYNrofSXy4sM+Yw: bets $7
+W/hy0gBp0sJy8pjLz6Yrg: folds
NYi6JFscYNrofSXy4sM+Yw collected $11.50 from pot
*** SUMMARY ***
Total pot $12 | Rake $0.50
Board [2c 6h 9d Qc]
Seat 1: NYi6JFscYNrofSXy4sM+Yw (button) (small blind) collected ($11.50)
Seat 2: +W/hy0gBp0sJy8pjLz6Yrg (big blind) folded on the Turn



PokerStars Game #59940951084:  Hold'em No Limit ($0.50/$1.00) - 2009/07/01 1:21:23 ET
Table '+cA8mcmhaedZ7YcrDdhmeQ' 6-max Seat #2 is the button
Seat 1: iIgNoBh+3/Ix1/fLsg+HuA ($36 in chips)
Seat 2: 14aYclSc98EYd6TrzN2l3Q ($13.80 in chips)
Seat 3: DAIgyIWbYvAkL6PbAI27pg ($17.50 in chips)
Seat 4: 4OO5v3AVduL0tePNx8wk5A ($105.05 in chips)
Seat 5: n5xXfJeDtWZSChGAdq//Tw ($20.05 in chips)
Seat 6: YfsTQsY/fxb+YqbdclTHuw ($13.85 in chips)
DAIgyIWbYvAkL6PbAI27pg: posts small blind $0.50
4OO5v3AVduL0tePNx8wk5A: posts big blind $1
iIgNoBh+3/Ix1/fLsg+HuA: posts big blind $1
*** HOLE CARDS ***
n5xXfJeDtWZSChGAdq//Tw: folds
YfsTQsY/fxb+YqbdclTHuw: folds
iIgNoBh+3/Ix1/fLsg+HuA: checks
14aYclSc98EYd6TrzN2l3Q: raises $3 to $4
DAIgyIWbYvAkL6PbAI27pg: folds
4OO5v3AVduL0tePNx8wk5A: folds
iIgNoBh+3/Ix1/fLsg+HuA: folds
14aYclSc98EYd6TrzN2l3Q collected $3.50 from pot
*** SUMMARY ***
Total pot $3.50 | Rake $0
Seat 1: iIgNoBh+3/Ix1/fLsg+HuA folded before Flop
Seat 2: 14aYclSc98EYd6TrzN2l3Q (button) collected ($3.50)
Seat 3: DAIgyIWbYvAkL6PbAI27pg (small blind) folded before Flop
Seat 4: 4OO5v3AVduL0tePNx8wk5A (big blind) folded before Flop
Seat 5: n5xXfJeDtWZSChGAdq//Tw folded before Flop (didn't bet)
Seat 6: YfsTQsY/fxb+YqbdclTHuw folded before Flop (didn't bet)



PokerStars Game #59940951644:  Hold'em No Limit ($0.50/$1.00) - 2009/07/01 1:21:24 ET
Table 'hugOjcwJvzEwZbK7tyiWuQ' 9-max Seat #6 is the button
Seat 1: S3Ex8K7v6xm5jqjRM7Fl3w ($22 in chips)
Seat 2: r27C1nIV4NS4+qbnrgBQSw ($272.20 in chips)
Seat 4: UWB3oeddt/GObx2Mix2Anw ($187.60 in chips)
Seat 6: gUUvmqdVlmvpal6B8nYrmg ($100 in chips)
Seat 7: FL3MrLspcF23LYvC4ipBOA ($119.30 in chips)
Seat 8: /zy+DB4S5fUQUSfZWFzYGw ($126.25 in chips)
Seat 9: W8P9bUKCs43TO1xHm0dL6w ($106.95 in chips)
FL3MrLspcF23LYvC4ipBOA: posts small blind $0.50
/zy+DB4S5fUQUSfZWFzYGw: posts big blind $1
*** HOLE CARDS ***
W8P9bUKCs43TO1xHm0dL6w: folds
ZWdwcEAWYlrUhsRi6MOmoA leaves the table
S3Ex8K7v6xm5jqjRM7Fl3w: folds
r27C1nIV4NS4+qbnrgBQSw: folds
UWB3oeddt/GObx2Mix2Anw: folds
gUUvmqdVlmvpal6B8nYrmg: raises $1 to $2
FL3MrLspcF23LYvC4ipBOA: calls $1.50
/zy+DB4S5fUQUSfZWFzYGw: calls $1
*** FLOP *** [7d 3h 2h]
FL3MrLspcF23LYvC4ipBOA: checks
/zy+DB4S5fUQUSfZWFzYGw: bets $4
gUUvmqdVlmvpal6B8nYrmg: raises $4 to $8
FL3MrLspcF23LYvC4ipBOA: folds
/zy+DB4S5fUQUSfZWFzYGw: calls $4
*** TURN *** [7d 3h 2h] [Kh]
/zy+DB4S5fUQUSfZWFzYGw: checks
gUUvmqdVlmvpal6B8nYrmg: bets $14
/zy+DB4S5fUQUSfZWFzYGw: folds
gUUvmqdVlmvpal6B8nYrmg collected $20.95 from pot
*** SUMMARY ***
Total pot $22 | Rake $1.05
Board [7d 3h 2h Kh]
Seat 1: S3Ex8K7v6xm5jqjRM7Fl3w folded before Flop (didn't bet)
Seat 2: r27C1nIV4NS4+qbnrgBQSw folded before Flop (didn't bet)
Seat 4: UWB3oeddt/GObx2Mix2Anw folded before Flop (didn't bet)
Seat 6: gUUvmqdVlmvpal6B8nYrmg (button) collected ($20.95)
Seat 7: FL3MrLspcF23LYvC4ipBOA (small blind) folded on the Flop
Seat 8: /zy+DB4S5fUQUSfZWFzYGw (big blind) folded on the Turn
Seat 9: W8P9bUKCs43TO1xHm0dL6w folded before Flop (didn't bet)



PokerStars Game #59940952060:  Hold'em No Limit ($0.50/$1.00) - 2009/07/01 1:21:25 ET
Table '8jIjWCPY0NGprquL+xcMFg' 9-max Seat #3 is the button
Seat 1: tU883G5KFwdH+p2tFuGYtw ($50 in chips)
Seat 2: 7VpIzVwja9q3vCCNM7gRrg ($54.65 in chips)
Seat 3: myIxN7otsyr846M539YR8Q ($19.50 in chips)
Seat 4: XLnHQ8GEI3bUQAfNjJuO5Q ($66.85 in chips)
Seat 5: 2YpnxJiexJHyERfbqgwEcw ($59.05 in chips)
Seat 6: GTQkFJtSkbVbnGCktp6e3g ($101.50 in chips)
Seat 7: O5Go3jrzbQWxRB6ESK+Ptg ($46 in chips)
Seat 8: eI48VADSCFoNZBx4T9qs2w ($17.95 in chips)
Seat 9: DDzMn3tzCgfGf298Xxt5Iw ($28.85 in chips)
XLnHQ8GEI3bUQAfNjJuO5Q: posts small blind $0.50
2YpnxJiexJHyERfbqgwEcw: posts big blind $1
*** HOLE CARDS ***
GTQkFJtSkbVbnGCktp6e3g: folds
tU883G5KFwdH+p2tFuGYtw said, "nh lol"
O5Go3jrzbQWxRB6ESK+Ptg: calls $1
eI48VADSCFoNZBx4T9qs2w: calls $1
2YpnxJiexJHyERfbqgwEcw said, "i was calling haha"
DDzMn3tzCgfGf298Xxt5Iw: raises $3 to $4
tU883G5KFwdH+p2tFuGYtw: raises $7 to $11
7VpIzVwja9q3vCCNM7gRrg: folds
myIxN7otsyr846M539YR8Q: folds
tU883G5KFwdH+p2tFuGYtw said, "a j"
XLnHQ8GEI3bUQAfNjJuO5Q: folds
2YpnxJiexJHyERfbqgwEcw: folds
O5Go3jrzbQWxRB6ESK+Ptg: folds
eI48VADSCFoNZBx4T9qs2w: folds
DDzMn3tzCgfGf298Xxt5Iw: calls $7
*** FLOP *** [Qh 3c 2h]
DDzMn3tzCgfGf298Xxt5Iw: checks
tU883G5KFwdH+p2tFuGYtw: bets $1
DDzMn3tzCgfGf298Xxt5Iw: calls $1
*** TURN *** [Qh 3c 2h] [Ah]
DDzMn3tzCgfGf298Xxt5Iw: checks
tU883G5KFwdH+p2tFuGYtw: bets $11
DDzMn3tzCgfGf298Xxt5Iw: folds
tU883G5KFwdH+p2tFuGYtw collected $26.20 from pot
tU883G5KFwdH+p2tFuGYtw: doesn't show hand
*** SUMMARY ***
Total pot $27.50 | Rake $1.30
Board [Qh 3c 2h Ah]
Seat 1: tU883G5KFwdH+p2tFuGYtw collected ($26.20)
Seat 2: 7VpIzVwja9q3vCCNM7gRrg folded before Flop (didn't bet)
Seat 3: myIxN7otsyr846M539YR8Q (button) folded before Flop (didn't bet)
Seat 4: XLnHQ8GEI3bUQAfNjJuO5Q (small blind) folded before Flop
Seat 5: 2YpnxJiexJHyERfbqgwEcw (big blind) folded before Flop
Seat 6: GTQkFJtSkbVbnGCktp6e3g folded before Flop (didn't bet)
Seat 7: O5Go3jrzbQWxRB6ESK+Ptg folded before Flop
Seat 8: eI48VADSCFoNZBx4T9qs2w folded before Flop
Seat 9: DDzMn3tzCgfGf298Xxt5Iw folded on the Turn



PokerStars Game #59940952248:  Hold'em No Limit ($0.50/$1.00) - 2009/07/01 1:21:25 ET
Table 'mmbQQVBTrPdE+wy+s+9VPA' 6-max Seat #2 is the button
Seat 1: zyP4SPoWZnKUfTvIRLCVog ($66.35 in chips)
Seat 2: XK4Qsl+DA8gAJyg85/zBIw ($16.45 in chips)
Seat 3: wx3sQGkVi2x9wJXuWNHPBw ($127.85 in chips)
Seat 4: V3iZdcw61nXF3g5hD2RrsQ ($106.40 in chips)
Seat 5: YMJG+F++3Aj6P8dAWda5fw ($114.30 in chips)
Seat 6: U2CWBTv29qdCbj8RNF2sIw ($100 in chips)
wx3sQGkVi2x9wJXuWNHPBw: posts small blind $0.50
V3iZdcw61nXF3g5hD2RrsQ: posts big blind $1
*** HOLE CARDS ***
YMJG+F++3Aj6P8dAWda5fw: folds
U2CWBTv29qdCbj8RNF2sIw: raises $2 to $3
zyP4SPoWZnKUfTvIRLCVog: folds
XK4Qsl+DA8gAJyg85/zBIw: calls $3
wx3sQGkVi2x9wJXuWNHPBw: folds
V3iZdcw61nXF3g5hD2RrsQ: folds
*** FLOP *** [Td Jh Ad]
U2CWBTv29qdCbj8RNF2sIw: bets $8
XK4Qsl+DA8gAJyg85/zBIw: raises $5.45 to $13.45 and is all-in
U2CWBTv29qdCbj8RNF2sIw: calls $5.45
*** TURN *** [Td Jh Ad] [8d]
*** RIVER *** [Td Jh Ad 8d] [6s]
*** SHOW DOWN ***
U2CWBTv29qdCbj8RNF2sIw: shows [Kc As] (a pair of Aces)
XK4Qsl+DA8gAJyg85/zBIw: mucks hand
U2CWBTv29qdCbj8RNF2sIw collected $32.70 from pot
*** SUMMARY ***
Total pot $34.40 | Rake $1.70
Board [Td Jh Ad 8d 6s]
Seat 1: zyP4SPoWZnKUfTvIRLCVog folded before Flop (didn't bet)
Seat 2: XK4Qsl+DA8gAJyg85/zBIw (button) mucked
Seat 3: wx3sQGkVi2x9wJXuWNHPBw (small blind) folded before Flop
Seat 4: V3iZdcw61nXF3g5hD2RrsQ (big blind) folded before Flop
Seat 5: YMJG+F++3Aj6P8dAWda5fw folded before Flop (didn't bet)
Seat 6: U2CWBTv29qdCbj8RNF2sIw showed [Kc As] and won ($32.70) with a pair of Aces



PokerStars Game #59940952782:  Hold'em No Limit ($0.50/$1.00) - 2009/07/01 1:21:26 ET
Table 'QSIig7BLMc9wY/rgBechzw' 6-max Seat #4 is the button
Seat 1: Z2fXsGcjl+Eax+RzOgwOmg ($103 in chips)
Seat 2: mLOIkH/qmRa+mVujQIhBRg ($55.40 in chips)
Seat 3: +xW7QemQU0Fxs+4TnqBRow ($100 in chips)
Seat 4: +uSzP8Jwnw7sKfQ4s66b7w ($60.45 in chips)
Seat 5: lsLuWlcPA3Rh7kJVLzMh0Q ($104.45 in chips)
Seat 6: PxqfkAMdAWtkgbT+q2gciA ($48 in chips)
lsLuWlcPA3Rh7kJVLzMh0Q: posts small blind $0.50
PxqfkAMdAWtkgbT+q2gciA: posts big blind $1
*** HOLE CARDS ***
Z2fXsGcjl+Eax+RzOgwOmg: folds
mLOIkH/qmRa+mVujQIhBRg: calls $1
+xW7QemQU0Fxs+4TnqBRow: folds
+uSzP8Jwnw7sKfQ4s66b7w: folds
lsLuWlcPA3Rh7kJVLzMh0Q: calls $0.50
PxqfkAMdAWtkgbT+q2gciA: checks
*** FLOP *** [5h Jd 9c]
lsLuWlcPA3Rh7kJVLzMh0Q: checks
PxqfkAMdAWtkgbT+q2gciA: bets $2
mLOIkH/qmRa+mVujQIhBRg: folds
lsLuWlcPA3Rh7kJVLzMh0Q: folds
PxqfkAMdAWtkgbT+q2gciA collected $2.85 from pot
*** SUMMARY ***
Total pot $3 | Rake $0.15
Board [5h Jd 9c]
Seat 1: Z2fXsGcjl+Eax+RzOgwOmg folded before Flop (didn't bet)
Seat 2: mLOIkH/qmRa+mVujQIhBRg folded on the Flop
Seat 3: +xW7QemQU0Fxs+4TnqBRow folded before Flop (didn't bet)
Seat 4: +uSzP8Jwnw7sKfQ4s66b7w (button) folded before Flop (didn't bet)
Seat 5: lsLuWlcPA3Rh7kJVLzMh0Q (small blind) folded on the Flop
Seat 6: PxqfkAMdAWtkgbT+q2gciA (big blind) collected ($2.85)



PokerStars Game #59940952714:  Hold'em No Limit ($0.50/$1.00) - 2009/07/01 1:21:26 ET
Table 'gxFK0BVUD7cupu2uyRUZJg' 6-max Seat #3 is the button
Seat 2: hpxXcmRkXXI9HE5+5/j/0Q ($121.60 in chips)
Seat 3: Z2fXsGcjl+Eax+RzOgwOmg ($118.25 in chips)
Seat 5: WgIrs6CBinyyw18pqdDtWA ($32.70 in chips)
Seat 6: dYyb6/42PMC8aNFlm/eBeQ ($65.85 in chips)
WgIrs6CBinyyw18pqdDtWA: posts small blind $0.50
dYyb6/42PMC8aNFlm/eBeQ: posts big blind $1
*** HOLE CARDS ***
hpxXcmRkXXI9HE5+5/j/0Q: folds
Z2fXsGcjl+Eax+RzOgwOmg: raises $2 to $3
WgIrs6CBinyyw18pqdDtWA: calls $2.50
dYyb6/42PMC8aNFlm/eBeQ: calls $2
*** FLOP *** [Ac 2c Kh]
WgIrs6CBinyyw18pqdDtWA: checks
dYyb6/42PMC8aNFlm/eBeQ: bets $5
Z2fXsGcjl+Eax+RzOgwOmg: raises $14 to $19
WgIrs6CBinyyw18pqdDtWA: folds
dYyb6/42PMC8aNFlm/eBeQ: raises $43.85 to $62.85 and is all-in
Z2fXsGcjl+Eax+RzOgwOmg: calls $43.85
*** TURN *** [Ac 2c Kh] [5s]
*** RIVER *** [Ac 2c Kh 5s] [Tc]
*** SHOW DOWN ***
dYyb6/42PMC8aNFlm/eBeQ: shows [Ts Ah] (two pair, Aces and Tens)
Z2fXsGcjl+Eax+RzOgwOmg: mucks hand
dYyb6/42PMC8aNFlm/eBeQ collected $132.70 from pot
*** SUMMARY ***
Total pot $134.70 | Rake $2
Board [Ac 2c Kh 5s Tc]
Seat 2: hpxXcmRkXXI9HE5+5/j/0Q folded before Flop (didn't bet)
Seat 3: Z2fXsGcjl+Eax+RzOgwOmg (button) mucked
Seat 5: WgIrs6CBinyyw18pqdDtWA (small blind) folded on the Flop
Seat 6: dYyb6/42PMC8aNFlm/eBeQ (big blind) showed [Ts Ah] and won ($132.70) with two pair, Aces and Tens



PokerStars Game #59940953378:  Hold'em No Limit ($0.50/$1.00) - 2009/07/01 1:21:27 ET
Table 'MNvFfRVQNka/oY+Z5aMbZQ' 2-max Seat #1 is the button
Seat 1: DaZnoWHjO897dnh0CL2lVg ($64.65 in chips)
Seat 2: mgi+mjKb1Sc3CCs7TlfoCw ($58.45 in chips)
DaZnoWHjO897dnh0CL2lVg: posts small blind $0.50
mgi+mjKb1Sc3CCs7TlfoCw: posts big blind $1
*** HOLE CARDS ***
DaZnoWHjO897dnh0CL2lVg: calls $0.50
mgi+mjKb1Sc3CCs7TlfoCw: checks
*** FLOP *** [9d 5h 3c]
mgi+mjKb1Sc3CCs7TlfoCw: checks
DaZnoWHjO897dnh0CL2lVg: bets $1
mgi+mjKb1Sc3CCs7TlfoCw: calls $1
*** TURN *** [9d 5h 3c] [3d]
mgi+mjKb1Sc3CCs7TlfoCw: checks
DaZnoWHjO897dnh0CL2lVg: bets $1
mgi+mjKb1Sc3CCs7TlfoCw: folds
DaZnoWHjO897dnh0CL2lVg collected $3.85 from pot
DaZnoWHjO897dnh0CL2lVg: doesn't show hand
*** SUMMARY ***
Total pot $4 | Rake $0.15
Board [9d 5h 3c 3d]
Seat 1: DaZnoWHjO897dnh0CL2lVg (button) (small blind) collected ($3.85)
Seat 2: mgi+mjKb1Sc3CCs7TlfoCw (big blind) folded on the Turn



PokerStars Game #59940956538:  Hold'em No Limit ($0.50/$1.00) - 2009/07/01 1:21:33 ET
Table 'pHrhryH8jPNdQfY62f8v+g' 6-max Seat #4 is the button
Seat 1: 4d1rWhpu8DzLmzMbR3QKyA ($117.05 in chips)
Seat 2: JwCcjZl0bjJzG7hmE0dnTA ($101.50 in chips)
Seat 3: 8oS5O7iD/qnFXFXJrGIgNQ ($100 in chips)
Seat 4: 1f3beyIML24UqEMTbWy93g ($66.70 in chips)
Seat 5: r1/R7y0Ortgoz4lccgW8VA ($20.75 in chips)
Seat 6: xAU6q2/cwmby2sxmA8VcmA ($205.10 in chips)
r1/R7y0Ortgoz4lccgW8VA: posts small blind $0.50
xAU6q2/cwmby2sxmA8VcmA: posts big blind $1
*** HOLE CARDS ***
4d1rWhpu8DzLmzMbR3QKyA: raises $2 to $3
JwCcjZl0bjJzG7hmE0dnTA: folds
8oS5O7iD/qnFXFXJrGIgNQ: folds
1f3beyIML24UqEMTbWy93g: calls $3
r1/R7y0Ortgoz4lccgW8VA: folds
xAU6q2/cwmby2sxmA8VcmA: folds
*** FLOP *** [9c Ts 4c]
4d1rWhpu8DzLmzMbR3QKyA: bets $6
1f3beyIML24UqEMTbWy93g: calls $6
*** TURN *** [9c Ts 4c] [Jh]
4d1rWhpu8DzLmzMbR3QKyA: checks
1f3beyIML24UqEMTbWy93g: checks
*** RIVER *** [9c Ts 4c Jh] [Js]
4d1rWhpu8DzLmzMbR3QKyA: checks
1f3beyIML24UqEMTbWy93g: bets $9
4d1rWhpu8DzLmzMbR3QKyA: calls $9
*** SHOW DOWN ***
1f3beyIML24UqEMTbWy93g: shows [5c 6c] (a pair of Jacks)
4d1rWhpu8DzLmzMbR3QKyA: shows [Tc Qc] (two pair, Jacks and Tens)
4d1rWhpu8DzLmzMbR3QKyA collected $35.70 from pot
*** SUMMARY ***
Total pot $37.50 | Rake $1.80
Board [9c Ts 4c Jh Js]
Seat 1: 4d1rWhpu8DzLmzMbR3QKyA showed [Tc Qc] and won ($35.70) with two pair, Jacks and Tens
Seat 2: JwCcjZl0bjJzG7hmE0dnTA folded before Flop (didn't bet)
Seat 3: 8oS5O7iD/qnFXFXJrGIgNQ folded before Flop (didn't bet)
Seat 4: 1f3beyIML24UqEMTbWy93g (button) showed [5c 6c] and lost with a pair of Jacks
Seat 5: r1/R7y0Ortgoz4lccgW8VA (small blind) folded before Flop
Seat 6: xAU6q2/cwmby2sxmA8VcmA (big blind) folded before Flop



PokerStars Game #59940957232:  Hold'em No Limit ($0.50/$1.00) - 2009/07/01 1:21:34 ET
Table 'Evb7VW0qfDhFkbgBL3gcqQ' 2-max Seat #2 is the button
Seat 1: NYi6JFscYNrofSXy4sM+Yw ($107.20 in chips)
Seat 2: AoEQlM/FNYM0d7Txn1TfBQ ($100.50 in chips)
AoEQlM/FNYM0d7Txn1TfBQ: posts small blind $0.50
NYi6JFscYNrofSXy4sM+Yw: posts big blind $1
*** HOLE CARDS ***
AoEQlM/FNYM0d7Txn1TfBQ: calls $0.50
NYi6JFscYNrofSXy4sM+Yw: checks
*** FLOP *** [As 9h Ts]
NYi6JFscYNrofSXy4sM+Yw: bets $2
AoEQlM/FNYM0d7Txn1TfBQ: folds
NYi6JFscYNrofSXy4sM+Yw collected $1.90 from pot
*** SUMMARY ***
Total pot $2 | Rake $0.10
Board [As 9h Ts]
Seat 1: NYi6JFscYNrofSXy4sM+Yw (big blind) collected ($1.90)
Seat 2: AoEQlM/FNYM0d7Txn1TfBQ (button) (small blind) folded on the Flop



PokerStars Game #59940960554:  Hold'em No Limit ($0.50/$1.00) - 2009/07/01 1:21:40 ET
Table 'kS0cTQAEi+fdUlJP2gQYvw' 9-max Seat #7 is the button
Seat 1: c/9X4zftzphFxYtxp5kp9w ($63.75 in chips)
Seat 2: D+W9Me7w6Hcx/WRUSKV0dw ($26.55 in chips)
Seat 3: 2BV+oJIQYr65IO6nEChvbA ($60 in chips)
Seat 4: RUhhaALzha3TH1AkdakoGQ ($55 in chips)
Seat 5: 997ViqAtWn1FPjJqcffwcA ($103.40 in chips)
Seat 6: yAbu2QsRPVcjPbqlf/jDxw ($124.65 in chips)
Seat 7: Ffa7Nj4X5fddtROP01hfQg ($154.60 in chips)
Seat 8: vKyFzTyzfT7fZcdX+HHN+Q ($27.10 in chips)
Seat 9: OGgaARGdJQT4awWVNQ957w ($100 in chips)
vKyFzTyzfT7fZcdX+HHN+Q: posts small blind $0.50
OGgaARGdJQT4awWVNQ957w: posts big blind $1
*** HOLE CARDS ***
c/9X4zftzphFxYtxp5kp9w: folds
c/9X4zftzphFxYtxp5kp9w leaves the table
D+W9Me7w6Hcx/WRUSKV0dw: folds
2BV+oJIQYr65IO6nEChvbA: folds
RUhhaALzha3TH1AkdakoGQ: folds
997ViqAtWn1FPjJqcffwcA: raises $3 to $4
yAbu2QsRPVcjPbqlf/jDxw: folds
Ffa7Nj4X5fddtROP01hfQg: folds
vKyFzTyzfT7fZcdX+HHN+Q: calls $3.50
/mfensKw8/iZ1Vrx33S4xg joins the table at seat #1
OGgaARGdJQT4awWVNQ957w: folds
*** FLOP *** [Qd Jh 8c]
2BV+oJIQYr65IO6nEChvbA is disconnected
2BV+oJIQYr65IO6nEChvbA is connected
vKyFzTyzfT7fZcdX+HHN+Q is disconnected
vKyFzTyzfT7fZcdX+HHN+Q is connected
vKyFzTyzfT7fZcdX+HHN+Q: bets $7
997ViqAtWn1FPjJqcffwcA: folds
vKyFzTyzfT7fZcdX+HHN+Q collected $8.55 from pot
*** SUMMARY ***
Total pot $9 | Rake $0.45
Board [Qd Jh 8c]
Seat 1: c/9X4zftzphFxYtxp5kp9w folded before Flop (didn't bet)
Seat 2: D+W9Me7w6Hcx/WRUSKV0dw folded before Flop (didn't bet)
Seat 3: 2BV+oJIQYr65IO6nEChvbA folded before Flop (didn't bet)
Seat 4: RUhhaALzha3TH1AkdakoGQ folded before Flop (didn't bet)
Seat 5: 997ViqAtWn1FPjJqcffwcA folded on the Flop
Seat 6: yAbu2QsRPVcjPbqlf/jDxw folded before Flop (didn't bet)
Seat 7: Ffa7Nj4X5fddtROP01hfQg (button) folded before Flop (didn't bet)
Seat 8: vKyFzTyzfT7fZcdX+HHN+Q (small blind) collected ($8.55)
Seat 9: OGgaARGdJQT4awWVNQ957w (big blind) folded before Flop



PokerStars Game #59940961374:  Hold'em No Limit ($0.50/$1.00) - 2009/07/01 1:21:41 ET
Table 'MUPc8FEpe/nR0BKSeReX6Q' 6-max Seat #1 is the button
Seat 1: qhkK6+yCciTRd+rCFEbnEQ ($83.20 in chips)
Seat 2: xAU6q2/cwmby2sxmA8VcmA ($112.20 in chips)
Seat 3: wx3sQGkVi2x9wJXuWNHPBw ($224.50 in chips)
Seat 4: ZA1bp6g8IwtTxkUE4eCjDQ ($156.70 in chips)
Seat 5: y27w5IK2WXqmYzS8OU0wKA ($100 in chips)
Seat 6: oxnw0GLLpFanjhGkxfRSqA ($45.45 in chips)
xAU6q2/cwmby2sxmA8VcmA: posts small blind $0.50
wx3sQGkVi2x9wJXuWNHPBw: posts big blind $1
*** HOLE CARDS ***
ZA1bp6g8IwtTxkUE4eCjDQ: calls $1
y27w5IK2WXqmYzS8OU0wKA: folds
oxnw0GLLpFanjhGkxfRSqA: calls $1
qhkK6+yCciTRd+rCFEbnEQ: folds
xAU6q2/cwmby2sxmA8VcmA: folds
wx3sQGkVi2x9wJXuWNHPBw: checks
*** FLOP *** [3h 4d Ad]
wx3sQGkVi2x9wJXuWNHPBw: checks
ZA1bp6g8IwtTxkUE4eCjDQ: bets $1
oxnw0GLLpFanjhGkxfRSqA: raises $4 to $5
wx3sQGkVi2x9wJXuWNHPBw: calls $5
ZA1bp6g8IwtTxkUE4eCjDQ: calls $4
*** TURN *** [3h 4d Ad] [2d]
wx3sQGkVi2x9wJXuWNHPBw: checks
ZA1bp6g8IwtTxkUE4eCjDQ: bets $27
oxnw0GLLpFanjhGkxfRSqA: folds
wx3sQGkVi2x9wJXuWNHPBw: raises $27 to $54
ZA1bp6g8IwtTxkUE4eCjDQ: calls $27
*** RIVER *** [3h 4d Ad 2d] [5d]
wx3sQGkVi2x9wJXuWNHPBw: bets $100.50
ZA1bp6g8IwtTxkUE4eCjDQ: folds
wx3sQGkVi2x9wJXuWNHPBw collected $123.50 from pot
*** SUMMARY ***
Total pot $126.50 | Rake $3
Board [3h 4d Ad 2d 5d]
Seat 1: qhkK6+yCciTRd+rCFEbnEQ (button) folded before Flop (didn't bet)
Seat 2: xAU6q2/cwmby2sxmA8VcmA (small blind) folded before Flop
Seat 3: wx3sQGkVi2x9wJXuWNHPBw (big blind) collected ($123.50)
Seat 4: ZA1bp6g8IwtTxkUE4eCjDQ folded on the River
Seat 5: y27w5IK2WXqmYzS8OU0wKA folded before Flop (didn't bet)
Seat 6: oxnw0GLLpFanjhGkxfRSqA folded on the Turn



PokerStars Game #59940961390:  Hold'em No Limit ($0.50/$1.00) - 2009/07/01 1:21:41 ET
Table 'iSx0wTgVb4o7MyZeOe06ZA' 9-max Seat #7 is the button
Seat 1: VPF+HjszMvUIpy0CHIwH3A ($17.50 in chips)
Seat 2: rFvc7K/96V9eGvYRfmpoUQ ($20 in chips)
Seat 3: /inIs/z/PcX+TniIFpaxpg ($17 in chips)
Seat 4: 0fXz44fzDo5QmhAaJCvFfA ($47.50 in chips)
Seat 5: 7rJvZYDzYT+lYOns8ZPL0w ($100 in chips)
Seat 7: w4NnqVr/Sfoj65ux/fEUyQ ($61.30 in chips)
Seat 8: gUUvmqdVlmvpal6B8nYrmg ($100 in chips)
Seat 9: mQADhUTC1xGjAJkD7PEg6A ($108.65 in chips)
gUUvmqdVlmvpal6B8nYrmg: posts small blind $0.50
mQADhUTC1xGjAJkD7PEg6A: posts big blind $1
*** HOLE CARDS ***
VPF+HjszMvUIpy0CHIwH3A: folds
Lik6kFnIxdZEESN5kBGZzA has returned
rFvc7K/96V9eGvYRfmpoUQ: folds
/inIs/z/PcX+TniIFpaxpg: folds
0fXz44fzDo5QmhAaJCvFfA: folds
7rJvZYDzYT+lYOns8ZPL0w: raises $2 to $3
w4NnqVr/Sfoj65ux/fEUyQ: folds
gUUvmqdVlmvpal6B8nYrmg: calls $2.50
mQADhUTC1xGjAJkD7PEg6A: folds
*** FLOP *** [9c 5d Jh]
gUUvmqdVlmvpal6B8nYrmg: checks
7rJvZYDzYT+lYOns8ZPL0w: bets $4
gUUvmqdVlmvpal6B8nYrmg: folds
7rJvZYDzYT+lYOns8ZPL0w collected $6.65 from pot
7rJvZYDzYT+lYOns8ZPL0w: doesn't show hand
*** SUMMARY ***
Total pot $7 | Rake $0.35
Board [9c 5d Jh]
Seat 1: VPF+HjszMvUIpy0CHIwH3A folded before Flop (didn't bet)
Seat 2: rFvc7K/96V9eGvYRfmpoUQ folded before Flop (didn't bet)
Seat 3: /inIs/z/PcX+TniIFpaxpg folded before Flop (didn't bet)
Seat 4: 0fXz44fzDo5QmhAaJCvFfA folded before Flop (didn't bet)
Seat 5: 7rJvZYDzYT+lYOns8ZPL0w collected ($6.65)
Seat 7: w4NnqVr/Sfoj65ux/fEUyQ (button) folded before Flop (didn't bet)
Seat 8: gUUvmqdVlmvpal6B8nYrmg (small blind) folded on the Flop
Seat 9: mQADhUTC1xGjAJkD7PEg6A (big blind) folded before Flop



PokerStars Game #59940962726:  Hold'em No Limit ($0.50/$1.00) - 2009/07/01 1:21:44 ET
Table 'SQLOQoANiHscJ8AL7zffbw' 9-max Seat #4 is the button
Seat 1: jPTRd6SpCp4xqAy2XQiTOw ($40.90 in chips)
Seat 2: /zy+DB4S5fUQUSfZWFzYGw ($395.05 in chips)
Seat 3: 0eFnow7+D7veCYQ+CG9FFw ($103 in chips)
Seat 4: 5z1PAR8SNow/zUfYNbwq7A ($58.45 in chips)
Seat 5: L9njYvloJ1NdXjP8edHEAg ($111.80 in chips)
Seat 6: H+DVy3Ei8L1UKS2tVOtJcw ($100 in chips)
Seat 7: bJckevFOcg//s0qyMQI6sQ ($103.05 in chips)
Seat 9: qJr25HAtvv1w/7IBvjMM3g ($196.65 in chips)
L9njYvloJ1NdXjP8edHEAg: posts small blind $0.50
H+DVy3Ei8L1UKS2tVOtJcw: posts big blind $1
9BZCcac3+McErkkSN2YScA: sits out
*** HOLE CARDS ***
bJckevFOcg//s0qyMQI6sQ: folds
qJr25HAtvv1w/7IBvjMM3g: folds
jPTRd6SpCp4xqAy2XQiTOw: folds
/zy+DB4S5fUQUSfZWFzYGw: folds
0eFnow7+D7veCYQ+CG9FFw: folds
5z1PAR8SNow/zUfYNbwq7A: folds
L9njYvloJ1NdXjP8edHEAg: folds
H+DVy3Ei8L1UKS2tVOtJcw collected $1 from pot
*** SUMMARY ***
Total pot $1 | Rake $0
Seat 1: jPTRd6SpCp4xqAy2XQiTOw folded before Flop (didn't bet)
Seat 2: /zy+DB4S5fUQUSfZWFzYGw folded before Flop (didn't bet)
Seat 3: 0eFnow7+D7veCYQ+CG9FFw folded before Flop (didn't bet)
Seat 4: 5z1PAR8SNow/zUfYNbwq7A (button) folded before Flop (didn't bet)
Seat 5: L9njYvloJ1NdXjP8edHEAg (small blind) folded before Flop
Seat 6: H+DVy3Ei8L1UKS2tVOtJcw (big blind) collected ($1)
Seat 7: bJckevFOcg//s0qyMQI6sQ folded before Flop (didn't bet)
Seat 9: qJr25HAtvv1w/7IBvjMM3g folded before Flop (didn't bet)



PokerStars Game #59940963892:  Hold'em No Limit ($0.50/$1.00) - 2009/07/01 1:21:46 ET
Table '7O9fB8yx1u7sJveJn8w6jA' 6-max Seat #5 is the button
Seat 1: jy52+7FotjH63o5tEEVgKw ($65.80 in chips)
Seat 2: wx3sQGkVi2x9wJXuWNHPBw ($200.70 in chips)
Seat 3: hpxXcmRkXXI9HE5+5/j/0Q ($122.75 in chips)
Seat 4: b2a+5TkFf4xJN/Ihhma58Q ($30.15 in chips)
Seat 5: BCEV3COoKY607AzLWayfRA ($101.85 in chips)
Seat 6: 6hLdALbOlkzGIrc53QKtPw ($20 in chips)
6hLdALbOlkzGIrc53QKtPw: posts small blind $0.50
jy52+7FotjH63o5tEEVgKw: posts big blind $1
*** HOLE CARDS ***
wx3sQGkVi2x9wJXuWNHPBw: folds
hpxXcmRkXXI9HE5+5/j/0Q: folds
b2a+5TkFf4xJN/Ihhma58Q: folds
BCEV3COoKY607AzLWayfRA: raises $2 to $3
6hLdALbOlkzGIrc53QKtPw: folds
jy52+7FotjH63o5tEEVgKw: folds
BCEV3COoKY607AzLWayfRA collected $2.50 from pot
BCEV3COoKY607AzLWayfRA: doesn't show hand
*** SUMMARY ***
Total pot $2.50 | Rake $0
Seat 1: jy52+7FotjH63o5tEEVgKw (big blind) folded before Flop
Seat 2: wx3sQGkVi2x9wJXuWNHPBw folded before Flop (didn't bet)
Seat 3: hpxXcmRkXXI9HE5+5/j/0Q folded before Flop (didn't bet)
Seat 4: b2a+5TkFf4xJN/Ihhma58Q folded before Flop (didn't bet)
Seat 5: BCEV3COoKY607AzLWayfRA (button) collected ($2.50)
Seat 6: 6hLdALbOlkzGIrc53QKtPw (small blind) folded before Flop



PokerStars Game #59940965088:  Hold'em No Limit ($0.50/$1.00) - 2009/07/01 1:21:48 ET
Table 'cBDNutyLBKEk9+ptwsKmTw' 6-max Seat #6 is the button
Seat 1: xAU6q2/cwmby2sxmA8VcmA ($258.90 in chips)
Seat 2: 5lY8d6Cnm4HUkt/8FZSj4g ($72.50 in chips)
Seat 3: G5ZSSN6RSON3gkNvk/SmYg ($111.90 in chips)
Seat 4: 3q7F5QtzC30pSrn0nl9i+A ($20 in chips)
Seat 5: hpxXcmRkXXI9HE5+5/j/0Q ($100 in chips)
Seat 6: QHvTZcrKe6+maWUfVjP29Q ($100 in chips)
xAU6q2/cwmby2sxmA8VcmA: posts small blind $0.50
5lY8d6Cnm4HUkt/8FZSj4g: posts big blind $1
*** HOLE CARDS ***
G5ZSSN6RSON3gkNvk/SmYg: folds
3q7F5QtzC30pSrn0nl9i+A: folds
hpxXcmRkXXI9HE5+5/j/0Q: folds
QHvTZcrKe6+maWUfVjP29Q: folds
xAU6q2/cwmby2sxmA8VcmA: raises $3 to $4
5lY8d6Cnm4HUkt/8FZSj4g: calls $3
*** FLOP *** [Jh 8d 6h]
xAU6q2/cwmby2sxmA8VcmA: bets $6
5lY8d6Cnm4HUkt/8FZSj4g: calls $6
*** TURN *** [Jh 8d 6h] [7d]
xAU6q2/cwmby2sxmA8VcmA: checks
5lY8d6Cnm4HUkt/8FZSj4g: checks
*** RIVER *** [Jh 8d 6h 7d] [7h]
xAU6q2/cwmby2sxmA8VcmA: checks
5lY8d6Cnm4HUkt/8FZSj4g: checks
*** SHOW DOWN ***
xAU6q2/cwmby2sxmA8VcmA: shows [4c 4d] (two pair, Sevens and Fours)
5lY8d6Cnm4HUkt/8FZSj4g: shows [9s 8s] (two pair, Eights and Sevens)
5lY8d6Cnm4HUkt/8FZSj4g collected $19.05 from pot
*** SUMMARY ***
Total pot $20 | Rake $0.95
Board [Jh 8d 6h 7d 7h]
Seat 1: xAU6q2/cwmby2sxmA8VcmA (small blind) showed [4c 4d] and lost with two pair, Sevens and Fours
Seat 2: 5lY8d6Cnm4HUkt/8FZSj4g (big blind) showed [9s 8s] and won ($19.05) with two pair, Eights and Sevens
Seat 3: G5ZSSN6RSON3gkNvk/SmYg folded before Flop (didn't bet)
Seat 4: 3q7F5QtzC30pSrn0nl9i+A folded before Flop (didn't bet)
Seat 5: hpxXcmRkXXI9HE5+5/j/0Q folded before Flop (didn't bet)
Seat 6: QHvTZcrKe6+maWUfVjP29Q (button) folded before Flop (didn't bet)



PokerStars Game #59940965854:  Hold'em No Limit ($0.50/$1.00) - 2009/07/01 1:21:49 ET
Table 'O96CPOtvMBWP6kzuYDfdFA' 6-max Seat #4 is the button
Seat 1: 6alLXQIITA2EZ/lBeym8Dw ($125.25 in chips)
Seat 2: 4d1rWhpu8DzLmzMbR3QKyA ($113.40 in chips)
Seat 3: V89DGjxE171oPREEbAXiyg ($93.15 in chips)
Seat 4: /P4w1pHg2zHYg/4ubJ0dPw ($60 in chips)
Seat 5: G5ZSSN6RSON3gkNvk/SmYg ($100.50 in chips)
Seat 6: GYei5jXGWexiJYbAT2fELg ($31.15 in chips)
G5ZSSN6RSON3gkNvk/SmYg: posts small blind $0.50
GYei5jXGWexiJYbAT2fELg: posts big blind $1
*** HOLE CARDS ***
6alLXQIITA2EZ/lBeym8Dw: raises $2 to $3
4d1rWhpu8DzLmzMbR3QKyA: folds
V89DGjxE171oPREEbAXiyg: folds
/P4w1pHg2zHYg/4ubJ0dPw: folds
G5ZSSN6RSON3gkNvk/SmYg: folds
GYei5jXGWexiJYbAT2fELg: folds
6alLXQIITA2EZ/lBeym8Dw collected $2.50 from pot
*** SUMMARY ***
Total pot $2.50 | Rake $0
Seat 1: 6alLXQIITA2EZ/lBeym8Dw collected ($2.50)
Seat 2: 4d1rWhpu8DzLmzMbR3QKyA folded before Flop (didn't bet)
Seat 3: V89DGjxE171oPREEbAXiyg folded before Flop (didn't bet)
Seat 4: /P4w1pHg2zHYg/4ubJ0dPw (button) folded before Flop (didn't bet)
Seat 5: G5ZSSN6RSON3gkNvk/SmYg (small blind) folded before Flop
Seat 6: GYei5jXGWexiJYbAT2fELg (big blind) folded before Flop



PokerStars Game #59940965976:  Hold'em No Limit ($0.50/$1.00) - 2009/07/01 1:21:49 ET
Table 'Evb7VW0qfDhFkbgBL3gcqQ' 2-max Seat #1 is the button
Seat 1: NYi6JFscYNrofSXy4sM+Yw ($108.10 in chips)
Seat 2: AoEQlM/FNYM0d7Txn1TfBQ ($99.50 in chips)
NYi6JFscYNrofSXy4sM+Yw: posts small blind $0.50
AoEQlM/FNYM0d7Txn1TfBQ: posts big blind $1
*** HOLE CARDS ***
NYi6JFscYNrofSXy4sM+Yw: folds
AoEQlM/FNYM0d7Txn1TfBQ collected $1 from pot
*** SUMMARY ***
Total pot $1 | Rake $0
Seat 1: NYi6JFscYNrofSXy4sM+Yw (button) (small blind) folded before Flop
Seat 2: AoEQlM/FNYM0d7Txn1TfBQ (big blind) collected ($1)



PokerStars Game #59940967010:  Hold'em No Limit ($0.50/$1.00) - 2009/07/01 1:21:51 ET
Table 'MNvFfRVQNka/oY+Z5aMbZQ' 2-max Seat #2 is the button
Seat 1: DaZnoWHjO897dnh0CL2lVg ($66.50 in chips)
Seat 2: mgi+mjKb1Sc3CCs7TlfoCw ($56.45 in chips)
mgi+mjKb1Sc3CCs7TlfoCw: posts small blind $0.50
DaZnoWHjO897dnh0CL2lVg: posts big blind $1
*** HOLE CARDS ***
mgi+mjKb1Sc3CCs7TlfoCw: folds
DaZnoWHjO897dnh0CL2lVg collected $1 from pot
DaZnoWHjO897dnh0CL2lVg: doesn't show hand
*** SUMMARY ***
Total pot $1 | Rake $0
Seat 1: DaZnoWHjO897dnh0CL2lVg (big blind) collected ($1)
Seat 2: mgi+mjKb1Sc3CCs7TlfoCw (button) (small blind) folded before Flop



PokerStars Game #59940966704:  Hold'em No Limit ($0.50/$1.00) - 2009/07/01 1:21:51 ET
Table 'tJq9SfN1ywY0r03VBlWlwQ' 9-max Seat #8 is the button
Seat 1: wZsU+w9r7G66x93UuvBf1Q ($326.80 in chips)
Seat 3: FVs16t7GgfWgQWt4JxsObQ ($16.55 in chips)
Seat 4: bLbSOSmSOnqE0iTcH/5dxA ($115.15 in chips)
Seat 5: h5ipsNTMyolp7xn/NAvWkA ($119.65 in chips)
Seat 6: gUUvmqdVlmvpal6B8nYrmg ($100 in chips)
Seat 7: Pp/KTcXkfZKKUHkjyaLTdg ($18.50 in chips)
Seat 8: G4DEhsZFmznGNVpy2SEocA ($22.25 in chips)
Seat 9: XE5QF1y74bpHog9JxWJMWQ ($100 in chips)
XE5QF1y74bpHog9JxWJMWQ: posts small blind $0.50
wZsU+w9r7G66x93UuvBf1Q: posts big blind $1
VPF+HjszMvUIpy0CHIwH3A: sits out
*** HOLE CARDS ***
FVs16t7GgfWgQWt4JxsObQ: calls $1
bLbSOSmSOnqE0iTcH/5dxA: folds
h5ipsNTMyolp7xn/NAvWkA: folds
gUUvmqdVlmvpal6B8nYrmg: raises $1 to $2
Pp/KTcXkfZKKUHkjyaLTdg: folds
G4DEhsZFmznGNVpy2SEocA: folds
XE5QF1y74bpHog9JxWJMWQ: folds
wZsU+w9r7G66x93UuvBf1Q: folds
FVs16t7GgfWgQWt4JxsObQ: calls $1
*** FLOP *** [3s Qs Jh]
FVs16t7GgfWgQWt4JxsObQ: checks
gUUvmqdVlmvpal6B8nYrmg: checks
*** TURN *** [3s Qs Jh] [Jc]
FVs16t7GgfWgQWt4JxsObQ: bets $2
XE5QF1y74bpHog9JxWJMWQ is sitting out
gUUvmqdVlmvpal6B8nYrmg: folds
FVs16t7GgfWgQWt4JxsObQ collected $5.25 from pot
*** SUMMARY ***
Total pot $5.50 | Rake $0.25
Board [3s Qs Jh Jc]
Seat 1: wZsU+w9r7G66x93UuvBf1Q (big blind) folded before Flop
Seat 3: FVs16t7GgfWgQWt4JxsObQ collected ($5.25)
Seat 4: bLbSOSmSOnqE0iTcH/5dxA folded before Flop (didn't bet)
Seat 5: h5ipsNTMyolp7xn/NAvWkA folded before Flop (didn't bet)
Seat 6: gUUvmqdVlmvpal6B8nYrmg folded on the Turn
Seat 7: Pp/KTcXkfZKKUHkjyaLTdg folded before Flop (didn't bet)
Seat 8: G4DEhsZFmznGNVpy2SEocA (button) folded before Flop (didn't bet)
Seat 9: XE5QF1y74bpHog9JxWJMWQ (small blind) folded before Flop



PokerStars Game #59940968084:  Hold'em No Limit ($0.50/$1.00) - 2009/07/01 1:21:53 ET
Table '+cA8mcmhaedZ7YcrDdhmeQ' 6-max Seat #3 is the button
Seat 1: iIgNoBh+3/Ix1/fLsg+HuA ($35 in chips)
Seat 2: 14aYclSc98EYd6TrzN2l3Q ($16.30 in chips)
Seat 3: DAIgyIWbYvAkL6PbAI27pg ($17 in chips)
Seat 4: 4OO5v3AVduL0tePNx8wk5A ($104.05 in chips)
Seat 5: n5xXfJeDtWZSChGAdq//Tw ($20.05 in chips)
Seat 6: YfsTQsY/fxb+YqbdclTHuw ($13.85 in chips)
4OO5v3AVduL0tePNx8wk5A: posts small blind $0.50
n5xXfJeDtWZSChGAdq//Tw: posts big blind $1
*** HOLE CARDS ***
YfsTQsY/fxb+YqbdclTHuw: folds
iIgNoBh+3/Ix1/fLsg+HuA: folds
14aYclSc98EYd6TrzN2l3Q: calls $1
DAIgyIWbYvAkL6PbAI27pg: folds
4OO5v3AVduL0tePNx8wk5A: raises $3 to $4
n5xXfJeDtWZSChGAdq//Tw: folds
14aYclSc98EYd6TrzN2l3Q: calls $3
*** FLOP *** [2d 9c 7s]
4OO5v3AVduL0tePNx8wk5A: checks
14aYclSc98EYd6TrzN2l3Q: bets $12.30 and is all-in
4OO5v3AVduL0tePNx8wk5A: folds
14aYclSc98EYd6TrzN2l3Q collected $8.55 from pot
*** SUMMARY ***
Total pot $9 | Rake $0.45
Board [2d 9c 7s]
Seat 1: iIgNoBh+3/Ix1/fLsg+HuA folded before Flop (didn't bet)
Seat 2: 14aYclSc98EYd6TrzN2l3Q collected ($8.55)
Seat 3: DAIgyIWbYvAkL6PbAI27pg (button) folded before Flop (didn't bet)
Seat 4: 4OO5v3AVduL0tePNx8wk5A (small blind) folded on the Flop
Seat 5: n5xXfJeDtWZSChGAdq//Tw (big blind) folded before Flop
Seat 6: YfsTQsY/fxb+YqbdclTHuw folded before Flop (didn't bet)



PokerStars Game #59940969902:  Hold'em No Limit ($0.50/$1.00) - 2009/07/01 1:21:56 ET
Table 'Evb7VW0qfDhFkbgBL3gcqQ' 2-max Seat #2 is the button
Seat 1: NYi6JFscYNrofSXy4sM+Yw ($107.60 in chips)
Seat 2: AoEQlM/FNYM0d7Txn1TfBQ ($100 in chips)
AoEQlM/FNYM0d7Txn1TfBQ: posts small blind $0.50
NYi6JFscYNrofSXy4sM+Yw: posts big blind $1
*** HOLE CARDS ***
AoEQlM/FNYM0d7Txn1TfBQ: folds
NYi6JFscYNrofSXy4sM+Yw collected $1 from pot
*** SUMMARY ***
Total pot $1 | Rake $0
Seat 1: NYi6JFscYNrofSXy4sM+Yw (big blind) collected ($1)
Seat 2: AoEQlM/FNYM0d7Txn1TfBQ (button) (small blind) folded before Flop



PokerStars Game #59940970202:  Hold'em No Limit ($0.50/$1.00) - 2009/07/01 1:21:57 ET
Table 'QSIig7BLMc9wY/rgBechzw' 6-max Seat #5 is the button
Seat 1: Z2fXsGcjl+Eax+RzOgwOmg ($103 in chips)
Seat 2: mLOIkH/qmRa+mVujQIhBRg ($54.40 in chips)
Seat 3: +xW7QemQU0Fxs+4TnqBRow ($100 in chips)
Seat 4: +uSzP8Jwnw7sKfQ4s66b7w ($60.45 in chips)
Seat 5: lsLuWlcPA3Rh7kJVLzMh0Q ($103.45 in chips)
Seat 6: PxqfkAMdAWtkgbT+q2gciA ($49.85 in chips)
PxqfkAMdAWtkgbT+q2gciA: posts small blind $0.50
Z2fXsGcjl+Eax+RzOgwOmg: posts big blind $1
*** HOLE CARDS ***
mLOIkH/qmRa+mVujQIhBRg: folds
+xW7QemQU0Fxs+4TnqBRow: folds
+uSzP8Jwnw7sKfQ4s66b7w: folds
lsLuWlcPA3Rh7kJVLzMh0Q: folds
PxqfkAMdAWtkgbT+q2gciA: raises $2 to $3
Z2fXsGcjl+Eax+RzOgwOmg: raises $8 to $11
PxqfkAMdAWtkgbT+q2gciA: folds
Z2fXsGcjl+Eax+RzOgwOmg collected $6 from pot
Z2fXsGcjl+Eax+RzOgwOmg: doesn't show hand
*** SUMMARY ***
Total pot $6 | Rake $0
Seat 1: Z2fXsGcjl+Eax+RzOgwOmg (big blind) collected ($6)
Seat 2: mLOIkH/qmRa+mVujQIhBRg folded before Flop (didn't bet)
Seat 3: +xW7QemQU0Fxs+4TnqBRow folded before Flop (didn't bet)
Seat 4: +uSzP8Jwnw7sKfQ4s66b7w folded before Flop (didn't bet)
Seat 5: lsLuWlcPA3Rh7kJVLzMh0Q (button) folded before Flop (didn't bet)
Seat 6: PxqfkAMdAWtkgbT+q2gciA (small blind) folded before Flop



PokerStars Game #59940970640:  Hold'em No Limit ($0.50/$1.00) - 2009/07/01 1:21:58 ET
Table 'MNvFfRVQNka/oY+Z5aMbZQ' 2-max Seat #1 is the button
Seat 1: DaZnoWHjO897dnh0CL2lVg ($67 in chips)
Seat 2: mgi+mjKb1Sc3CCs7TlfoCw ($55.95 in chips)
DaZnoWHjO897dnh0CL2lVg: posts small blind $0.50
mgi+mjKb1Sc3CCs7TlfoCw: posts big blind $1
*** HOLE CARDS ***
DaZnoWHjO897dnh0CL2lVg: raises $2 to $3
mgi+mjKb1Sc3CCs7TlfoCw: folds
DaZnoWHjO897dnh0CL2lVg collected $2 from pot
DaZnoWHjO897dnh0CL2lVg: doesn't show hand
*** SUMMARY ***
Total pot $2 | Rake $0
Seat 1: DaZnoWHjO897dnh0CL2lVg (button) (small blind) collected ($2)
Seat 2: mgi+mjKb1Sc3CCs7TlfoCw (big blind) folded before Flop



PokerStars Game #59940973060:  Hold'em No Limit ($0.50/$1.00) - 2009/07/01 1:21:58 ET
Table 'fTlPiCj0utgzC/5io+I7ew' 6-max Seat #3 is the button
Seat 1: YMJG+F++3Aj6P8dAWda5fw ($95.05 in chips)
Seat 3: Z2fXsGcjl+Eax+RzOgwOmg ($128.20 in chips)
Seat 4: uJVSceLggtsrJya+WtmUEA ($170.65 in chips)
Seat 5: XUk5GQsfNFpHvaToDZ0rZA ($54.15 in chips)
Seat 6: y27w5IK2WXqmYzS8OU0wKA ($100 in chips)
uJVSceLggtsrJya+WtmUEA: posts small blind $0.50
XUk5GQsfNFpHvaToDZ0rZA: posts big blind $1
*** HOLE CARDS ***
y27w5IK2WXqmYzS8OU0wKA: folds
YMJG+F++3Aj6P8dAWda5fw: folds
Z2fXsGcjl+Eax+RzOgwOmg: raises $2 to $3
uJVSceLggtsrJya+WtmUEA: folds
XUk5GQsfNFpHvaToDZ0rZA: calls $2
*** FLOP *** [3h 3c 4h]
XUk5GQsfNFpHvaToDZ0rZA: checks
Z2fXsGcjl+Eax+RzOgwOmg: bets $5
XUk5GQsfNFpHvaToDZ0rZA: calls $5
*** TURN *** [3h 3c 4h] [5d]
XUk5GQsfNFpHvaToDZ0rZA: checks
Z2fXsGcjl+Eax+RzOgwOmg: bets $12
XUk5GQsfNFpHvaToDZ0rZA: folds
KDYsHh8K2SUXXDvLsAhbJQ leaves the table
Z2fXsGcjl+Eax+RzOgwOmg collected $15.70 from pot
*** SUMMARY ***
Total pot $16.50 | Rake $0.80
Board [3h 3c 4h 5d]
Seat 1: YMJG+F++3Aj6P8dAWda5fw folded before Flop (didn't bet)
Seat 3: Z2fXsGcjl+Eax+RzOgwOmg (button) collected ($15.70)
Seat 4: uJVSceLggtsrJya+WtmUEA (small blind) folded before Flop
Seat 5: XUk5GQsfNFpHvaToDZ0rZA (big blind) folded on the Turn
Seat 6: y27w5IK2WXqmYzS8OU0wKA folded before Flop (didn't bet)



PokerStars Game #59940973294:  Hold'em No Limit ($0.50/$1.00) - 2009/07/01 1:21:59 ET
Table 'W/wyObTiXZm+Ckkl3YxcSw' 6-max Seat #6 is the button
Seat 1: eUBBn2R56C1IQ6Cs/vitwg ($290.40 in chips)
Seat 2: oDiBRCaF0QVtd3kO6xZIXw ($150.55 in chips)
Seat 3: dxyNCn/qxfkGDUIf28Cbng ($67.80 in chips)
Seat 4: UBZQqpnJZdTYYY1FTb0rLA ($100 in chips)
Seat 5: +OrCjyw70oZhJiD22Mn+bg ($100 in chips)
Seat 6: b2a+5TkFf4xJN/Ihhma58Q ($46.05 in chips)
eUBBn2R56C1IQ6Cs/vitwg: posts small blind $0.50
oDiBRCaF0QVtd3kO6xZIXw: posts big blind $1
*** HOLE CARDS ***
dxyNCn/qxfkGDUIf28Cbng: folds
UBZQqpnJZdTYYY1FTb0rLA: folds
+OrCjyw70oZhJiD22Mn+bg: folds
b2a+5TkFf4xJN/Ihhma58Q: folds
eUBBn2R56C1IQ6Cs/vitwg: folds
oDiBRCaF0QVtd3kO6xZIXw collected $1 from pot
oDiBRCaF0QVtd3kO6xZIXw: doesn't show hand
*** SUMMARY ***
Total pot $1 | Rake $0
Seat 1: eUBBn2R56C1IQ6Cs/vitwg (small blind) folded before Flop
Seat 2: oDiBRCaF0QVtd3kO6xZIXw (big blind) collected ($1)
Seat 3: dxyNCn/qxfkGDUIf28Cbng folded before Flop (didn't bet)
Seat 4: UBZQqpnJZdTYYY1FTb0rLA folded before Flop (didn't bet)
Seat 5: +OrCjyw70oZhJiD22Mn+bg folded before Flop (didn't bet)
Seat 6: b2a+5TkFf4xJN/Ihhma58Q (button) folded before Flop (didn't bet)



PokerStars Game #59940973174:  Hold'em No Limit ($0.50/$1.00) - 2009/07/01 1:21:59 ET
Table 'fZjVbKj9D8yOB+Rj7NaP/A' 9-max Seat #7 is the button
Seat 1: 9BZCcac3+McErkkSN2YScA ($100 in chips)
Seat 2: PTAFYDIUSsG+SArbxNl+Aw ($105.50 in chips)
Seat 3: yAbu2QsRPVcjPbqlf/jDxw ($101 in chips)
Seat 4: 997ViqAtWn1FPjJqcffwcA ($101 in chips)
Seat 5: PkGfq5xrSlNsujKaG/HF4Q ($101.50 in chips)
Seat 6: OvwYHV65yUbgdBjSmo1+5g ($45.95 in chips)
Seat 7: SyS20PAm3RpT6uLBsGkwOA ($120.05 in chips)
Seat 8: zDOE5r14tWqCf6xhuSHK6g ($40 in chips)
Seat 9: qheQay5YvP2DMAb3OUSxtw ($100 in chips)
zDOE5r14tWqCf6xhuSHK6g: posts small blind $0.50
qheQay5YvP2DMAb3OUSxtw: posts big blind $1
*** HOLE CARDS ***
9BZCcac3+McErkkSN2YScA: folds
PTAFYDIUSsG+SArbxNl+Aw: folds
yAbu2QsRPVcjPbqlf/jDxw: folds
997ViqAtWn1FPjJqcffwcA: folds
PkGfq5xrSlNsujKaG/HF4Q: raises $3 to $4
OvwYHV65yUbgdBjSmo1+5g: calls $4
SyS20PAm3RpT6uLBsGkwOA: folds
zDOE5r14tWqCf6xhuSHK6g: calls $3.50
qheQay5YvP2DMAb3OUSxtw: folds
*** FLOP *** [8d 6c 8h]
zDOE5r14tWqCf6xhuSHK6g: checks
PkGfq5xrSlNsujKaG/HF4Q: checks
OvwYHV65yUbgdBjSmo1+5g: bets $5
zDOE5r14tWqCf6xhuSHK6g: calls $5
PkGfq5xrSlNsujKaG/HF4Q: folds
*** TURN *** [8d 6c 8h] [7c]
zDOE5r14tWqCf6xhuSHK6g: checks
OvwYHV65yUbgdBjSmo1+5g: checks
*** RIVER *** [8d 6c 8h 7c] [9h]
zDOE5r14tWqCf6xhuSHK6g: bets $6
OvwYHV65yUbgdBjSmo1+5g: folds
zDOE5r14tWqCf6xhuSHK6g collected $21.90 from pot
*** SUMMARY ***
Total pot $23 | Rake $1.10
Board [8d 6c 8h 7c 9h]
Seat 1: 9BZCcac3+McErkkSN2YScA folded before Flop (didn't bet)
Seat 2: PTAFYDIUSsG+SArbxNl+Aw folded before Flop (didn't bet)
Seat 3: yAbu2QsRPVcjPbqlf/jDxw folded before Flop (didn't bet)
Seat 4: 997ViqAtWn1FPjJqcffwcA folded before Flop (didn't bet)
Seat 5: PkGfq5xrSlNsujKaG/HF4Q folded on the Flop
Seat 6: OvwYHV65yUbgdBjSmo1+5g folded on the River
Seat 7: SyS20PAm3RpT6uLBsGkwOA (button) folded before Flop (didn't bet)
Seat 8: zDOE5r14tWqCf6xhuSHK6g (small blind) collected ($21.90)
Seat 9: qheQay5YvP2DMAb3OUSxtw (big blind) folded before Flop



PokerStars Game #59940975280:  Hold'em No Limit ($0.50/$1.00) - 2009/07/01 1:22:02 ET
Table 'Evb7VW0qfDhFkbgBL3gcqQ' 2-max Seat #1 is the button
Seat 1: NYi6JFscYNrofSXy4sM+Yw ($108.10 in chips)
Seat 2: AoEQlM/FNYM0d7Txn1TfBQ ($99.50 in chips)
NYi6JFscYNrofSXy4sM+Yw: posts small blind $0.50
AoEQlM/FNYM0d7Txn1TfBQ: posts big blind $1
*** HOLE CARDS ***
NYi6JFscYNrofSXy4sM+Yw: raises $2 to $3
AoEQlM/FNYM0d7Txn1TfBQ: folds
NYi6JFscYNrofSXy4sM+Yw collected $2 from pot
*** SUMMARY ***
Total pot $2 | Rake $0
Seat 1: NYi6JFscYNrofSXy4sM+Yw (button) (small blind) collected ($2)
Seat 2: AoEQlM/FNYM0d7Txn1TfBQ (big blind) folded before Flop



PokerStars Game #59940976378:  Hold'em No Limit ($0.50/$1.00) - 2009/07/01 1:22:04 ET
Table 'TvsifD4n+q//fIZ4fM1xxQ' 2-max Seat #2 is the button
Seat 1: NYi6JFscYNrofSXy4sM+Yw ($105.50 in chips)
Seat 2: +W/hy0gBp0sJy8pjLz6Yrg ($58.25 in chips)
+W/hy0gBp0sJy8pjLz6Yrg: posts small blind $0.50
NYi6JFscYNrofSXy4sM+Yw: posts big blind $1
*** HOLE CARDS ***
+W/hy0gBp0sJy8pjLz6Yrg: raises $1 to $2
NYi6JFscYNrofSXy4sM+Yw: calls $1
*** FLOP *** [6s 4h Qc]
NYi6JFscYNrofSXy4sM+Yw: checks
+W/hy0gBp0sJy8pjLz6Yrg: bets $1
NYi6JFscYNrofSXy4sM+Yw: folds
+W/hy0gBp0sJy8pjLz6Yrg collected $3.80 from pot
*** SUMMARY ***
Total pot $4 | Rake $0.20
Board [6s 4h Qc]
Seat 1: NYi6JFscYNrofSXy4sM+Yw (big blind) folded on the Flop
Seat 2: +W/hy0gBp0sJy8pjLz6Yrg (button) (small blind) collected ($3.80)



PokerStars Game #59940976164:  Hold'em No Limit ($0.50/$1.00) - 2009/07/01 1:22:04 ET
Table 'hdVBCnDy5t2X9dZo0AvD9w' 9-max Seat #6 is the button
Seat 1: sa/cZBFh73L9TapFXpn3BA ($96.45 in chips)
Seat 2: Ogn4JDV3mp4ZDKO49IFzKA ($19.50 in chips)
Seat 3: 1862487932 ($100 in chips)
Seat 5: H+DVy3Ei8L1UKS2tVOtJcw ($100 in chips)
Seat 6: bJckevFOcg//s0qyMQI6sQ ($105.60 in chips)
Seat 8: gUUvmqdVlmvpal6B8nYrmg ($142.40 in chips)
Seat 9: AMkLbywdoc0K30BTzaIfTQ ($183.40 in chips)
laA8va+Yv8WuMqT1zdR91g will be allowed to play after the button
gUUvmqdVlmvpal6B8nYrmg: posts small blind $0.50
AMkLbywdoc0K30BTzaIfTQ: posts big blind $1
*** HOLE CARDS ***
sa/cZBFh73L9TapFXpn3BA: folds
Ogn4JDV3mp4ZDKO49IFzKA: folds
1862487932: folds
H+DVy3Ei8L1UKS2tVOtJcw: folds
bJckevFOcg//s0qyMQI6sQ: folds
gUUvmqdVlmvpal6B8nYrmg: raises $1 to $2
AMkLbywdoc0K30BTzaIfTQ: folds
gUUvmqdVlmvpal6B8nYrmg collected $2 from pot
*** SUMMARY ***
Total pot $2 | Rake $0
Seat 1: sa/cZBFh73L9TapFXpn3BA folded before Flop (didn't bet)
Seat 2: Ogn4JDV3mp4ZDKO49IFzKA folded before Flop (didn't bet)
Seat 3: 1862487932 folded before Flop (didn't bet)
Seat 5: H+DVy3Ei8L1UKS2tVOtJcw folded before Flop (didn't bet)
Seat 6: bJckevFOcg//s0qyMQI6sQ (button) folded before Flop (didn't bet)
Seat 8: gUUvmqdVlmvpal6B8nYrmg (small blind) collected ($2)
Seat 9: AMkLbywdoc0K30BTzaIfTQ (big blind) folded before Flop



PokerStars Game #59940977674:  Hold'em No Limit ($0.50/$1.00) - 2009/07/01 1:22:06 ET
Table '/RZcOwpZpHQ+OwPwjsbnRw' 6-max Seat #6 is the button
Seat 1: +uSzP8Jwnw7sKfQ4s66b7w ($50.25 in chips)
Seat 2: Z2fXsGcjl+Eax+RzOgwOmg ($103 in chips)
Seat 3: 6hLdALbOlkzGIrc53QKtPw ($24.20 in chips)
Seat 4: j7NIOHLZk7V2o9fOioO5ug ($143.70 in chips)
Seat 5: wx3sQGkVi2x9wJXuWNHPBw ($166.05 in chips)
Seat 6: o3YLm/rSY916m/on1VjXPA ($100 in chips)
+uSzP8Jwnw7sKfQ4s66b7w: posts small blind $0.50
Z2fXsGcjl+Eax+RzOgwOmg: posts big blind $1
*** HOLE CARDS ***
6hLdALbOlkzGIrc53QKtPw: folds
j7NIOHLZk7V2o9fOioO5ug: folds
wx3sQGkVi2x9wJXuWNHPBw: folds
o3YLm/rSY916m/on1VjXPA: folds
+uSzP8Jwnw7sKfQ4s66b7w: folds
Z2fXsGcjl+Eax+RzOgwOmg collected $1 from pot
Z2fXsGcjl+Eax+RzOgwOmg: doesn't show hand
*** SUMMARY ***
Total pot $1 | Rake $0
Seat 1: +uSzP8Jwnw7sKfQ4s66b7w (small blind) folded before Flop
Seat 2: Z2fXsGcjl+Eax+RzOgwOmg (big blind) collected ($1)
Seat 3: 6hLdALbOlkzGIrc53QKtPw folded before Flop (didn't bet)
Seat 4: j7NIOHLZk7V2o9fOioO5ug folded before Flop (didn't bet)
Seat 5: wx3sQGkVi2x9wJXuWNHPBw folded before Flop (didn't bet)
Seat 6: o3YLm/rSY916m/on1VjXPA (button) folded before Flop (didn't bet)



PokerStars Game #59940977876:  Hold'em No Limit ($0.50/$1.00) - 2009/07/01 1:22:07 ET
Table '7O9fB8yx1u7sJveJn8w6jA' 6-max Seat #6 is the button
Seat 1: jy52+7FotjH63o5tEEVgKw ($64.80 in chips)
Seat 2: wx3sQGkVi2x9wJXuWNHPBw ($200.70 in chips)
Seat 3: hpxXcmRkXXI9HE5+5/j/0Q ($122.75 in chips)
Seat 4: b2a+5TkFf4xJN/Ihhma58Q ($30.15 in chips)
Seat 5: BCEV3COoKY607AzLWayfRA ($103.35 in chips)
Seat 6: 6hLdALbOlkzGIrc53QKtPw ($20 in chips)
jy52+7FotjH63o5tEEVgKw: posts small blind $0.50
wx3sQGkVi2x9wJXuWNHPBw: posts big blind $1
*** HOLE CARDS ***
hpxXcmRkXXI9HE5+5/j/0Q: folds
b2a+5TkFf4xJN/Ihhma58Q: folds
BCEV3COoKY607AzLWayfRA: raises $3 to $4
6hLdALbOlkzGIrc53QKtPw: folds
jy52+7FotjH63o5tEEVgKw: folds
wx3sQGkVi2x9wJXuWNHPBw: folds
BCEV3COoKY607AzLWayfRA collected $2.50 from pot
BCEV3COoKY607AzLWayfRA: doesn't show hand
*** SUMMARY ***
Total pot $2.50 | Rake $0
Seat 1: jy52+7FotjH63o5tEEVgKw (small blind) folded before Flop
Seat 2: wx3sQGkVi2x9wJXuWNHPBw (big blind) folded before Flop
Seat 3: hpxXcmRkXXI9HE5+5/j/0Q folded before Flop (didn't bet)
Seat 4: b2a+5TkFf4xJN/Ihhma58Q folded before Flop (didn't bet)
Seat 5: BCEV3COoKY607AzLWayfRA collected ($2.50)
Seat 6: 6hLdALbOlkzGIrc53QKtPw (button) folded before Flop (didn't bet)



PokerStars Game #59940978450:  Hold'em No Limit ($0.50/$1.00) - 2009/07/01 1:22:08 ET
Table 'MNvFfRVQNka/oY+Z5aMbZQ' 2-max Seat #2 is the button
Seat 1: DaZnoWHjO897dnh0CL2lVg ($68 in chips)
Seat 2: mgi+mjKb1Sc3CCs7TlfoCw ($54.95 in chips)
mgi+mjKb1Sc3CCs7TlfoCw: posts small blind $0.50
DaZnoWHjO897dnh0CL2lVg: posts big blind $1
*** HOLE CARDS ***
mgi+mjKb1Sc3CCs7TlfoCw: folds
DaZnoWHjO897dnh0CL2lVg collected $1 from pot
DaZnoWHjO897dnh0CL2lVg: doesn't show hand
*** SUMMARY ***
Total pot $1 | Rake $0
Seat 1: DaZnoWHjO897dnh0CL2lVg (big blind) collected ($1)
Seat 2: mgi+mjKb1Sc3CCs7TlfoCw (button) (small blind) folded before Flop



PokerStars Game #59940978954:  Hold'em No Limit ($0.50/$1.00) - 2009/07/01 1:22:09 ET
Table 'vs/5jr6ciwjVQ5+Soc+u2A' 6-max Seat #2 is the button
Seat 1: J798qwLuvXyq0BbzsIjOrA ($155.90 in chips)
Seat 2: lXX4W7m3u++JiSOZ46yVMQ ($105.65 in chips)
Seat 3: G5ZSSN6RSON3gkNvk/SmYg ($137.10 in chips)
Seat 4: wk6Ohn4GDozoOMHc4eb2rw ($60.80 in chips)
Seat 5: +Nt3OPk3XR9SKjZgm2CexQ ($149.10 in chips)
Seat 6: Z2fXsGcjl+Eax+RzOgwOmg ($100 in chips)
G5ZSSN6RSON3gkNvk/SmYg: posts small blind $0.50
wk6Ohn4GDozoOMHc4eb2rw: posts big blind $1
*** HOLE CARDS ***
+Nt3OPk3XR9SKjZgm2CexQ: raises $2 to $3
Z2fXsGcjl+Eax+RzOgwOmg: folds
J798qwLuvXyq0BbzsIjOrA: folds
lXX4W7m3u++JiSOZ46yVMQ: folds
G5ZSSN6RSON3gkNvk/SmYg: folds
wk6Ohn4GDozoOMHc4eb2rw: folds
+Nt3OPk3XR9SKjZgm2CexQ collected $2.50 from pot
+Nt3OPk3XR9SKjZgm2CexQ: doesn't show hand
*** SUMMARY ***
Total pot $2.50 | Rake $0
Seat 1: J798qwLuvXyq0BbzsIjOrA folded before Flop (didn't bet)
Seat 2: lXX4W7m3u++JiSOZ46yVMQ (button) folded before Flop (didn't bet)
Seat 3: G5ZSSN6RSON3gkNvk/SmYg (small blind) folded before Flop
Seat 4: wk6Ohn4GDozoOMHc4eb2rw (big blind) folded before Flop
Seat 5: +Nt3OPk3XR9SKjZgm2CexQ collected ($2.50)
Seat 6: Z2fXsGcjl+Eax+RzOgwOmg folded before Flop (didn't bet)



PokerStars Game #59940979096:  Hold'em No Limit ($0.50/$1.00) - 2009/07/01 1:22:09 ET
Table 'O96CPOtvMBWP6kzuYDfdFA' 6-max Seat #5 is the button
Seat 1: 6alLXQIITA2EZ/lBeym8Dw ($126.75 in chips)
Seat 2: 4d1rWhpu8DzLmzMbR3QKyA ($113.40 in chips)
Seat 3: V89DGjxE171oPREEbAXiyg ($93.15 in chips)
Seat 4: /P4w1pHg2zHYg/4ubJ0dPw ($60 in chips)
Seat 5: G5ZSSN6RSON3gkNvk/SmYg ($100 in chips)
Seat 6: GYei5jXGWexiJYbAT2fELg ($30.15 in chips)
GYei5jXGWexiJYbAT2fELg: posts small blind $0.50
6alLXQIITA2EZ/lBeym8Dw: posts big blind $1
*** HOLE CARDS ***
4d1rWhpu8DzLmzMbR3QKyA: folds
V89DGjxE171oPREEbAXiyg: folds
/P4w1pHg2zHYg/4ubJ0dPw: raises $2.50 to $3.50
G5ZSSN6RSON3gkNvk/SmYg: folds
GYei5jXGWexiJYbAT2fELg: folds
6alLXQIITA2EZ/lBeym8Dw: calls $2.50
*** FLOP *** [Js Kc 5d]
6alLXQIITA2EZ/lBeym8Dw: checks
/P4w1pHg2zHYg/4ubJ0dPw: bets $4
6alLXQIITA2EZ/lBeym8Dw: folds
/P4w1pHg2zHYg/4ubJ0dPw collected $7.15 from pot
*** SUMMARY ***
Total pot $7.50 | Rake $0.35
Board [Js Kc 5d]
Seat 1: 6alLXQIITA2EZ/lBeym8Dw (big blind) folded on the Flop
Seat 2: 4d1rWhpu8DzLmzMbR3QKyA folded before Flop (didn't bet)
Seat 3: V89DGjxE171oPREEbAXiyg folded before Flop (didn't bet)
Seat 4: /P4w1pHg2zHYg/4ubJ0dPw collected ($7.15)
Seat 5: G5ZSSN6RSON3gkNvk/SmYg (button) folded before Flop (didn't bet)
Seat 6: GYei5jXGWexiJYbAT2fELg (small blind) folded before Flop



PokerStars Game #59940978818:  Hold'em No Limit ($0.50/$1.00) - 2009/07/01 1:22:09 ET
Table '305hiksPPCCdC6V2LNsO5w' 6-max Seat #5 is the button
Seat 1: RTuDLJHh/9zPfBftoc9vsw ($18 in chips)
Seat 2: j7NIOHLZk7V2o9fOioO5ug ($124.55 in chips)
Seat 3: +zIVjZKLpcidfRHgVZW8lA ($17 in chips)
Seat 4: uJVSceLggtsrJya+WtmUEA ($222.15 in chips)
Seat 5: +Nt3OPk3XR9SKjZgm2CexQ ($114.15 in chips)
Seat 6: 9/Tq8dw7kWW68uN8bFupXg ($25.20 in chips)
9/Tq8dw7kWW68uN8bFupXg: posts small blind $0.50
RTuDLJHh/9zPfBftoc9vsw: posts big blind $1
*** HOLE CARDS ***
j7NIOHLZk7V2o9fOioO5ug: folds
+zIVjZKLpcidfRHgVZW8lA: folds
uJVSceLggtsrJya+WtmUEA: folds
+Nt3OPk3XR9SKjZgm2CexQ: folds
9/Tq8dw7kWW68uN8bFupXg: calls $0.50
RTuDLJHh/9zPfBftoc9vsw: checks
*** FLOP *** [5c Tc 3s]
9/Tq8dw7kWW68uN8bFupXg: bets $1
RTuDLJHh/9zPfBftoc9vsw: folds
9/Tq8dw7kWW68uN8bFupXg collected $1.90 from pot
*** SUMMARY ***
Total pot $2 | Rake $0.10
Board [5c Tc 3s]
Seat 1: RTuDLJHh/9zPfBftoc9vsw (big blind) folded on the Flop
Seat 2: j7NIOHLZk7V2o9fOioO5ug folded before Flop (didn't bet)
Seat 3: +zIVjZKLpcidfRHgVZW8lA folded before Flop (didn't bet)
Seat 4: uJVSceLggtsrJya+WtmUEA folded before Flop (didn't bet)
Seat 5: +Nt3OPk3XR9SKjZgm2CexQ (button) folded before Flop (didn't bet)
Seat 6: 9/Tq8dw7kWW68uN8bFupXg (small blind) collected ($1.90)



PokerStars Game #59940979648:  Hold'em No Limit ($0.50/$1.00) - 2009/07/01 1:22:10 ET
Table 'Evb7VW0qfDhFkbgBL3gcqQ' 2-max Seat #2 is the button
Seat 1: NYi6JFscYNrofSXy4sM+Yw ($109.10 in chips)
Seat 2: AoEQlM/FNYM0d7Txn1TfBQ ($98.50 in chips)
AoEQlM/FNYM0d7Txn1TfBQ: posts small blind $0.50
NYi6JFscYNrofSXy4sM+Yw: posts big blind $1
*** HOLE CARDS ***
AoEQlM/FNYM0d7Txn1TfBQ: raises $2 to $3
NYi6JFscYNrofSXy4sM+Yw: calls $2
*** FLOP *** [Ac Th 4c]
NYi6JFscYNrofSXy4sM+Yw: checks
AoEQlM/FNYM0d7Txn1TfBQ: bets $5
NYi6JFscYNrofSXy4sM+Yw: calls $5
*** TURN *** [Ac Th 4c] [8d]
NYi6JFscYNrofSXy4sM+Yw: checks
AoEQlM/FNYM0d7Txn1TfBQ: checks
*** RIVER *** [Ac Th 4c 8d] [3d]
NYi6JFscYNrofSXy4sM+Yw: bets $11
AoEQlM/FNYM0d7Txn1TfBQ: folds
NYi6JFscYNrofSXy4sM+Yw collected $15.50 from pot
*** SUMMARY ***
Total pot $16 | Rake $0.50
Board [Ac Th 4c 8d 3d]
Seat 1: NYi6JFscYNrofSXy4sM+Yw (big blind) collected ($15.50)
Seat 2: AoEQlM/FNYM0d7Txn1TfBQ (button) (small blind) folded on the River



PokerStars Game #59940981900:  Hold'em No Limit ($0.50/$1.00) - 2009/07/01 1:22:14 ET
Table 'MNvFfRVQNka/oY+Z5aMbZQ' 2-max Seat #1 is the button
Seat 1: DaZnoWHjO897dnh0CL2lVg ($68.50 in chips)
Seat 2: mgi+mjKb1Sc3CCs7TlfoCw ($54.45 in chips)
DaZnoWHjO897dnh0CL2lVg: posts small blind $0.50
mgi+mjKb1Sc3CCs7TlfoCw: posts big blind $1
*** HOLE CARDS ***
DaZnoWHjO897dnh0CL2lVg: raises $2 to $3
mgi+mjKb1Sc3CCs7TlfoCw: folds
DaZnoWHjO897dnh0CL2lVg collected $2 from pot
DaZnoWHjO897dnh0CL2lVg: doesn't show hand
*** SUMMARY ***
Total pot $2 | Rake $0
Seat 1: DaZnoWHjO897dnh0CL2lVg (button) (small blind) collected ($2)
Seat 2: mgi+mjKb1Sc3CCs7TlfoCw (big blind) folded before Flop



PokerStars Game #59940983952:  Hold'em No Limit ($0.50/$1.00) - 2009/07/01 1:22:18 ET
Table '8jIjWCPY0NGprquL+xcMFg' 9-max Seat #4 is the button
Seat 1: tU883G5KFwdH+p2tFuGYtw ($64.20 in chips)
Seat 2: 7VpIzVwja9q3vCCNM7gRrg ($54.65 in chips)
Seat 3: myIxN7otsyr846M539YR8Q ($19.50 in chips)
Seat 4: XLnHQ8GEI3bUQAfNjJuO5Q ($66.35 in chips)
Seat 5: 2YpnxJiexJHyERfbqgwEcw ($58.05 in chips)
Seat 6: GTQkFJtSkbVbnGCktp6e3g ($101.50 in chips)
Seat 7: O5Go3jrzbQWxRB6ESK+Ptg ($45 in chips)
Seat 8: eI48VADSCFoNZBx4T9qs2w ($16.95 in chips)
Seat 9: DDzMn3tzCgfGf298Xxt5Iw ($16.85 in chips)
2YpnxJiexJHyERfbqgwEcw: posts small blind $0.50
GTQkFJtSkbVbnGCktp6e3g: posts big blind $1
*** HOLE CARDS ***
O5Go3jrzbQWxRB6ESK+Ptg: folds
eI48VADSCFoNZBx4T9qs2w: folds
DDzMn3tzCgfGf298Xxt5Iw: folds
tU883G5KFwdH+p2tFuGYtw: folds
7VpIzVwja9q3vCCNM7gRrg: folds
myIxN7otsyr846M539YR8Q: folds
XLnHQ8GEI3bUQAfNjJuO5Q: calls $1
2YpnxJiexJHyERfbqgwEcw: raises $2 to $3
GTQkFJtSkbVbnGCktp6e3g: folds
XLnHQ8GEI3bUQAfNjJuO5Q: calls $2
*** FLOP *** [4c 8h 6h]
2YpnxJiexJHyERfbqgwEcw: bets $3
XLnHQ8GEI3bUQAfNjJuO5Q: raises $12 to $15
2YpnxJiexJHyERfbqgwEcw: calls $12
*** TURN *** [4c 8h 6h] [3d]
2YpnxJiexJHyERfbqgwEcw: checks
XLnHQ8GEI3bUQAfNjJuO5Q: bets $15
2YpnxJiexJHyERfbqgwEcw: raises $25.05 to $40.05 and is all-in
XLnHQ8GEI3bUQAfNjJuO5Q: calls $25.05
*** RIVER *** [4c 8h 6h 3d] [Ah]
*** SHOW DOWN ***
2YpnxJiexJHyERfbqgwEcw: shows [5s 2s] (a straight, Deuce to Six)
XLnHQ8GEI3bUQAfNjJuO5Q: shows [Jh 2h] (a flush, Ace high)
XLnHQ8GEI3bUQAfNjJuO5Q collected $114.10 from pot
*** SUMMARY ***
Total pot $117.10 | Rake $3
Board [4c 8h 6h 3d Ah]
Seat 1: tU883G5KFwdH+p2tFuGYtw folded before Flop (didn't bet)
Seat 2: 7VpIzVwja9q3vCCNM7gRrg folded before Flop (didn't bet)
Seat 3: myIxN7otsyr846M539YR8Q folded before Flop (didn't bet)
Seat 4: XLnHQ8GEI3bUQAfNjJuO5Q (button) showed [Jh 2h] and won ($114.10) with a flush, Ace high
Seat 5: 2YpnxJiexJHyERfbqgwEcw (small blind) showed [5s 2s] and lost with a straight, Deuce to Six
Seat 6: GTQkFJtSkbVbnGCktp6e3g (big blind) folded before Flop
Seat 7: O5Go3jrzbQWxRB6ESK+Ptg folded before Flop (didn't bet)
Seat 8: eI48VADSCFoNZBx4T9qs2w folded before Flop (didn't bet)
Seat 9: DDzMn3tzCgfGf298Xxt5Iw folded before Flop (didn't bet)



PokerStars Game #59940984614:  Hold'em No Limit ($0.50/$1.00) - 2009/07/01 1:22:19 ET
Table 'SQLOQoANiHscJ8AL7zffbw' 9-max Seat #5 is the button
Seat 1: jPTRd6SpCp4xqAy2XQiTOw ($40.90 in chips)
Seat 2: /zy+DB4S5fUQUSfZWFzYGw ($395.05 in chips)
Seat 3: 0eFnow7+D7veCYQ+CG9FFw ($103 in chips)
Seat 4: 5z1PAR8SNow/zUfYNbwq7A ($58.45 in chips)
Seat 5: L9njYvloJ1NdXjP8edHEAg ($111.30 in chips)
Seat 6: H+DVy3Ei8L1UKS2tVOtJcw ($100.50 in chips)
Seat 8: 9BZCcac3+McErkkSN2YScA ($100 in chips)
Seat 9: qJr25HAtvv1w/7IBvjMM3g ($196.65 in chips)
H+DVy3Ei8L1UKS2tVOtJcw: posts small blind $0.50
bJckevFOcg//s0qyMQI6sQ: is sitting out
9BZCcac3+McErkkSN2YScA: posts big blind $1
*** HOLE CARDS ***
qJr25HAtvv1w/7IBvjMM3g: folds
jPTRd6SpCp4xqAy2XQiTOw: folds
qJr25HAtvv1w/7IBvjMM3g leaves the table
/zy+DB4S5fUQUSfZWFzYGw: folds
0eFnow7+D7veCYQ+CG9FFw: folds
XE5QF1y74bpHog9JxWJMWQ joins the table at seat #9
5z1PAR8SNow/zUfYNbwq7A: raises $2 to $3
L9njYvloJ1NdXjP8edHEAg: folds
H+DVy3Ei8L1UKS2tVOtJcw: folds
9BZCcac3+McErkkSN2YScA: folds
XE5QF1y74bpHog9JxWJMWQ is sitting out
5z1PAR8SNow/zUfYNbwq7A collected $2.50 from pot
*** SUMMARY ***
Total pot $2.50 | Rake $0
Seat 1: jPTRd6SpCp4xqAy2XQiTOw folded before Flop (didn't bet)
Seat 2: /zy+DB4S5fUQUSfZWFzYGw folded before Flop (didn't bet)
Seat 3: 0eFnow7+D7veCYQ+CG9FFw folded before Flop (didn't bet)
Seat 4: 5z1PAR8SNow/zUfYNbwq7A collected ($2.50)
Seat 5: L9njYvloJ1NdXjP8edHEAg (button) folded before Flop (didn't bet)
Seat 6: H+DVy3Ei8L1UKS2tVOtJcw (small blind) folded before Flop
Seat 8: 9BZCcac3+McErkkSN2YScA (big blind) folded before Flop
Seat 9: qJr25HAtvv1w/7IBvjMM3g folded before Flop (didn't bet)



PokerStars Game #59940984292:  Hold'em No Limit ($0.50/$1.00) - 2009/07/01 1:22:19 ET
Table 'GPp0HyAuggN8oE0sUWzPpA' 9-max Seat #3 is the button
Seat 1: qJr25HAtvv1w/7IBvjMM3g ($48 in chips)
Seat 2: m3U8I35Pn3gxKhoS2nmYIg ($24.45 in chips)
Seat 3: CCCXsirC+bO7ginAuUUVlQ ($53.10 in chips)
Seat 4: mBRWbnUl8diyBO1qTJaNzw ($100.65 in chips)
Seat 5: bLbSOSmSOnqE0iTcH/5dxA ($100 in chips)
Seat 6: BK/GtNPkSx0TdUDj82id5A ($34.70 in chips)
Seat 7: DHdbHyysD15wCAtx+BhUjA ($96.70 in chips)
Seat 8: P/6qLjycEfxRgZ5F/W90dw ($96 in chips)
mBRWbnUl8diyBO1qTJaNzw: posts small blind $0.50
bLbSOSmSOnqE0iTcH/5dxA: posts big blind $1
myIxN7otsyr846M539YR8Q: sits out
*** HOLE CARDS ***
BK/GtNPkSx0TdUDj82id5A: folds
DHdbHyysD15wCAtx+BhUjA: folds
P/6qLjycEfxRgZ5F/W90dw: folds
qJr25HAtvv1w/7IBvjMM3g: folds
m3U8I35Pn3gxKhoS2nmYIg: raises $2 to $3
CCCXsirC+bO7ginAuUUVlQ: folds
mBRWbnUl8diyBO1qTJaNzw: folds
bLbSOSmSOnqE0iTcH/5dxA: folds
m3U8I35Pn3gxKhoS2nmYIg collected $2.50 from pot
*** SUMMARY ***
Total pot $2.50 | Rake $0
Seat 1: qJr25HAtvv1w/7IBvjMM3g folded before Flop (didn't bet)
Seat 2: m3U8I35Pn3gxKhoS2nmYIg collected ($2.50)
Seat 3: CCCXsirC+bO7ginAuUUVlQ (button) folded before Flop (didn't bet)
Seat 4: mBRWbnUl8diyBO1qTJaNzw (small blind) folded before Flop
Seat 5: bLbSOSmSOnqE0iTcH/5dxA (big blind) folded before Flop
Seat 6: BK/GtNPkSx0TdUDj82id5A folded before Flop (didn't bet)
Seat 7: DHdbHyysD15wCAtx+BhUjA folded before Flop (didn't bet)
Seat 8: P/6qLjycEfxRgZ5F/W90dw folded before Flop (didn't bet)



PokerStars Game #59940985144:  Hold'em No Limit ($0.50/$1.00) - 2009/07/01 1:22:20 ET
Table '7Nl0ffnjeK44/vmeexh3MQ' 9-max Seat #6 is the button
Seat 1: V138SURkdX8LdVBPKdJJag ($100 in chips)
Seat 2: OGgaARGdJQT4awWVNQ957w ($100.50 in chips)
Seat 3: JMmUYT5pIKCKh2pGjCB/4w ($60.40 in chips)
Seat 4: bLbSOSmSOnqE0iTcH/5dxA ($101.35 in chips)
Seat 6: FVs16t7GgfWgQWt4JxsObQ ($25.25 in chips)
Seat 7: 997ViqAtWn1FPjJqcffwcA ($100 in chips)
Seat 8: D+W9Me7w6Hcx/WRUSKV0dw ($19.25 in chips)
997ViqAtWn1FPjJqcffwcA: posts small blind $0.50
D+W9Me7w6Hcx/WRUSKV0dw: posts big blind $1
rFvc7K/96V9eGvYRfmpoUQ: sits out
*** HOLE CARDS ***
V138SURkdX8LdVBPKdJJag: folds
OGgaARGdJQT4awWVNQ957w: folds
JMmUYT5pIKCKh2pGjCB/4w: folds
bLbSOSmSOnqE0iTcH/5dxA: folds
FVs16t7GgfWgQWt4JxsObQ: calls $1
997ViqAtWn1FPjJqcffwcA: folds
D+W9Me7w6Hcx/WRUSKV0dw: checks
*** FLOP *** [Jh 5c As]
D+W9Me7w6Hcx/WRUSKV0dw: checks
FVs16t7GgfWgQWt4JxsObQ: bets $1
61sfw5QTu62YYIt68OsdrA is disconnected
D+W9Me7w6Hcx/WRUSKV0dw: folds
FVs16t7GgfWgQWt4JxsObQ collected $2.40 from pot
*** SUMMARY ***
Total pot $2.50 | Rake $0.10
Board [Jh 5c As]
Seat 1: V138SURkdX8LdVBPKdJJag folded before Flop (didn't bet)
Seat 2: OGgaARGdJQT4awWVNQ957w folded before Flop (didn't bet)
Seat 3: JMmUYT5pIKCKh2pGjCB/4w folded before Flop (didn't bet)
Seat 4: bLbSOSmSOnqE0iTcH/5dxA folded before Flop (didn't bet)
Seat 6: FVs16t7GgfWgQWt4JxsObQ (button) collected ($2.40)
Seat 7: 997ViqAtWn1FPjJqcffwcA (small blind) folded before Flop
Seat 8: D+W9Me7w6Hcx/WRUSKV0dw (big blind) folded on the Flop



PokerStars Game #59940984696:  Hold'em No Limit ($0.50/$1.00) - 2009/07/01 1:22:20 ET
Table 'mmbQQVBTrPdE+wy+s+9VPA' 6-max Seat #3 is the button
Seat 1: zyP4SPoWZnKUfTvIRLCVog ($66.35 in chips)
Seat 2: XK4Qsl+DA8gAJyg85/zBIw ($31.30 in chips)
Seat 3: wx3sQGkVi2x9wJXuWNHPBw ($127.35 in chips)
Seat 4: V3iZdcw61nXF3g5hD2RrsQ ($105.40 in chips)
Seat 5: YMJG+F++3Aj6P8dAWda5fw ($114.30 in chips)
Seat 6: U2CWBTv29qdCbj8RNF2sIw ($116.25 in chips)
V3iZdcw61nXF3g5hD2RrsQ: posts small blind $0.50
YMJG+F++3Aj6P8dAWda5fw: posts big blind $1
*** HOLE CARDS ***
U2CWBTv29qdCbj8RNF2sIw: folds
zyP4SPoWZnKUfTvIRLCVog: calls $1
XK4Qsl+DA8gAJyg85/zBIw: folds
wx3sQGkVi2x9wJXuWNHPBw: folds
V3iZdcw61nXF3g5hD2RrsQ: folds
YMJG+F++3Aj6P8dAWda5fw: raises $3 to $4
zyP4SPoWZnKUfTvIRLCVog: calls $3
*** FLOP *** [Qc Ah Ts]
YMJG+F++3Aj6P8dAWda5fw: checks
zyP4SPoWZnKUfTvIRLCVog: checks
*** TURN *** [Qc Ah Ts] [4c]
YMJG+F++3Aj6P8dAWda5fw: checks
zyP4SPoWZnKUfTvIRLCVog: checks
*** RIVER *** [Qc Ah Ts 4c] [2c]
YMJG+F++3Aj6P8dAWda5fw: checks
zyP4SPoWZnKUfTvIRLCVog: checks
*** SHOW DOWN ***
YMJG+F++3Aj6P8dAWda5fw: shows [Js Jh] (a pair of Jacks)
zyP4SPoWZnKUfTvIRLCVog: mucks hand
YMJG+F++3Aj6P8dAWda5fw collected $8.10 from pot
*** SUMMARY ***
Total pot $8.50 | Rake $0.40
Board [Qc Ah Ts 4c 2c]
Seat 1: zyP4SPoWZnKUfTvIRLCVog mucked
Seat 2: XK4Qsl+DA8gAJyg85/zBIw folded before Flop (didn't bet)
Seat 3: wx3sQGkVi2x9wJXuWNHPBw (button) folded before Flop (didn't bet)
Seat 4: V3iZdcw61nXF3g5hD2RrsQ (small blind) folded before Flop
Seat 5: YMJG+F++3Aj6P8dAWda5fw (big blind) showed [Js Jh] and won ($8.10) with a pair of Jacks
Seat 6: U2CWBTv29qdCbj8RNF2sIw folded before Flop (didn't bet)



PokerStars Game #59940985342:  Hold'em No Limit ($0.50/$1.00) - 2009/07/01 1:22:21 ET
Table 'MNvFfRVQNka/oY+Z5aMbZQ' 2-max Seat #2 is the button
Seat 1: DaZnoWHjO897dnh0CL2lVg ($69.50 in chips)
Seat 2: mgi+mjKb1Sc3CCs7TlfoCw ($53.45 in chips)
mgi+mjKb1Sc3CCs7TlfoCw: posts small blind $0.50
DaZnoWHjO897dnh0CL2lVg: posts big blind $1
*** HOLE CARDS ***
mgi+mjKb1Sc3CCs7TlfoCw: raises $2 to $3
DaZnoWHjO897dnh0CL2lVg: folds
mgi+mjKb1Sc3CCs7TlfoCw collected $2 from pot
mgi+mjKb1Sc3CCs7TlfoCw: doesn't show hand
*** SUMMARY ***
Total pot $2 | Rake $0
Seat 1: DaZnoWHjO897dnh0CL2lVg (big blind) folded before Flop
Seat 2: mgi+mjKb1Sc3CCs7TlfoCw (button) (small blind) collected ($2)



PokerStars Game #59940986686:  Hold'em No Limit ($0.50/$1.00) - 2009/07/01 1:22:23 ET
Table 'QSIig7BLMc9wY/rgBechzw' 6-max Seat #6 is the button
Seat 1: Z2fXsGcjl+Eax+RzOgwOmg ($106 in chips)
Seat 2: mLOIkH/qmRa+mVujQIhBRg ($54.40 in chips)
Seat 3: +xW7QemQU0Fxs+4TnqBRow ($100 in chips)
Seat 4: +uSzP8Jwnw7sKfQ4s66b7w ($60.45 in chips)
Seat 5: lsLuWlcPA3Rh7kJVLzMh0Q ($103.45 in chips)
Seat 6: PxqfkAMdAWtkgbT+q2gciA ($46.85 in chips)
Z2fXsGcjl+Eax+RzOgwOmg: posts small blind $0.50
mLOIkH/qmRa+mVujQIhBRg: posts big blind $1
*** HOLE CARDS ***
+xW7QemQU0Fxs+4TnqBRow: folds
+uSzP8Jwnw7sKfQ4s66b7w: raises $2 to $3
lsLuWlcPA3Rh7kJVLzMh0Q: folds
PxqfkAMdAWtkgbT+q2gciA: folds
Z2fXsGcjl+Eax+RzOgwOmg: folds
mLOIkH/qmRa+mVujQIhBRg: calls $2
*** FLOP *** [Kh Ah 3d]
mLOIkH/qmRa+mVujQIhBRg: checks
+uSzP8Jwnw7sKfQ4s66b7w: bets $4
mLOIkH/qmRa+mVujQIhBRg: folds
+uSzP8Jwnw7sKfQ4s66b7w collected $6.20 from pot
*** SUMMARY ***
Total pot $6.50 | Rake $0.30
Board [Kh Ah 3d]
Seat 1: Z2fXsGcjl+Eax+RzOgwOmg (small blind) folded before Flop
Seat 2: mLOIkH/qmRa+mVujQIhBRg (big blind) folded on the Flop
Seat 3: +xW7QemQU0Fxs+4TnqBRow folded before Flop (didn't bet)
Seat 4: +uSzP8Jwnw7sKfQ4s66b7w collected ($6.20)
Seat 5: lsLuWlcPA3Rh7kJVLzMh0Q folded before Flop (didn't bet)
Seat 6: PxqfkAMdAWtkgbT+q2gciA (button) folded before Flop (didn't bet)



PokerStars Game #59940987462:  Hold'em No Limit ($0.50/$1.00) - 2009/07/01 1:22:25 ET
Table 'TvsifD4n+q//fIZ4fM1xxQ' 2-max Seat #1 is the button
Seat 1: NYi6JFscYNrofSXy4sM+Yw ($103.50 in chips)
Seat 2: +W/hy0gBp0sJy8pjLz6Yrg ($60.05 in chips)
NYi6JFscYNrofSXy4sM+Yw: posts small blind $0.50
+W/hy0gBp0sJy8pjLz6Yrg: posts big blind $1
*** HOLE CARDS ***
NYi6JFscYNrofSXy4sM+Yw: folds
+W/hy0gBp0sJy8pjLz6Yrg collected $1 from pot
*** SUMMARY ***
Total pot $1 | Rake $0
Seat 1: NYi6JFscYNrofSXy4sM+Yw (button) (small blind) folded before Flop
Seat 2: +W/hy0gBp0sJy8pjLz6Yrg (big blind) collected ($1)



PokerStars Game #59940988664:  Hold'em No Limit ($0.50/$1.00) - 2009/07/01 1:22:26 ET
Table 'vs/5jr6ciwjVQ5+Soc+u2A' 6-max Seat #3 is the button
Seat 1: J798qwLuvXyq0BbzsIjOrA ($155.90 in chips)
Seat 2: lXX4W7m3u++JiSOZ46yVMQ ($105.65 in chips)
Seat 3: G5ZSSN6RSON3gkNvk/SmYg ($136.60 in chips)
Seat 4: wk6Ohn4GDozoOMHc4eb2rw ($59.80 in chips)
Seat 5: +Nt3OPk3XR9SKjZgm2CexQ ($150.60 in chips)
Seat 6: Z2fXsGcjl+Eax+RzOgwOmg ($100 in chips)
wk6Ohn4GDozoOMHc4eb2rw: posts small blind $0.50
+Nt3OPk3XR9SKjZgm2CexQ: posts big blind $1
*** HOLE CARDS ***
Z2fXsGcjl+Eax+RzOgwOmg: folds
J798qwLuvXyq0BbzsIjOrA: folds
lXX4W7m3u++JiSOZ46yVMQ: folds
G5ZSSN6RSON3gkNvk/SmYg: raises $2 to $3
wk6Ohn4GDozoOMHc4eb2rw: folds
+Nt3OPk3XR9SKjZgm2CexQ: folds
G5ZSSN6RSON3gkNvk/SmYg collected $2.50 from pot
G5ZSSN6RSON3gkNvk/SmYg: doesn't show hand
*** SUMMARY ***
Total pot $2.50 | Rake $0
Seat 1: J798qwLuvXyq0BbzsIjOrA folded before Flop (didn't bet)
Seat 2: lXX4W7m3u++JiSOZ46yVMQ folded before Flop (didn't bet)
Seat 3: G5ZSSN6RSON3gkNvk/SmYg (button) collected ($2.50)
Seat 4: wk6Ohn4GDozoOMHc4eb2rw (small blind) folded before Flop
Seat 5: +Nt3OPk3XR9SKjZgm2CexQ (big blind) folded before Flop
Seat 6: Z2fXsGcjl+Eax+RzOgwOmg folded before Flop (didn't bet)



PokerStars Game #59940988802:  Hold'em No Limit ($0.50/$1.00) - 2009/07/01 1:22:27 ET
Table 'gxFK0BVUD7cupu2uyRUZJg' 6-max Seat #5 is the button
Seat 2: hpxXcmRkXXI9HE5+5/j/0Q ($121.60 in chips)
Seat 3: Z2fXsGcjl+Eax+RzOgwOmg ($100 in chips)
Seat 5: WgIrs6CBinyyw18pqdDtWA ($29.70 in chips)
Seat 6: dYyb6/42PMC8aNFlm/eBeQ ($132.70 in chips)
dYyb6/42PMC8aNFlm/eBeQ: posts small blind $0.50
hpxXcmRkXXI9HE5+5/j/0Q: posts big blind $1
*** HOLE CARDS ***
Z2fXsGcjl+Eax+RzOgwOmg: folds
WgIrs6CBinyyw18pqdDtWA: calls $1
dYyb6/42PMC8aNFlm/eBeQ: calls $0.50
hpxXcmRkXXI9HE5+5/j/0Q: checks
*** FLOP *** [Kh Ah 3h]
dYyb6/42PMC8aNFlm/eBeQ: bets $2
hpxXcmRkXXI9HE5+5/j/0Q: folds
WgIrs6CBinyyw18pqdDtWA: calls $2
*** TURN *** [Kh Ah 3h] [9c]
dYyb6/42PMC8aNFlm/eBeQ: bets $4
WgIrs6CBinyyw18pqdDtWA: calls $4
*** RIVER *** [Kh Ah 3h 9c] [7c]
dYyb6/42PMC8aNFlm/eBeQ: checks
WgIrs6CBinyyw18pqdDtWA: checks
*** SHOW DOWN ***
dYyb6/42PMC8aNFlm/eBeQ: shows [Ad 5s] (a pair of Aces)
WgIrs6CBinyyw18pqdDtWA: mucks hand
dYyb6/42PMC8aNFlm/eBeQ collected $14.30 from pot
*** SUMMARY ***
Total pot $15 | Rake $0.70
Board [Kh Ah 3h 9c 7c]
Seat 2: hpxXcmRkXXI9HE5+5/j/0Q (big blind) folded on the Flop
Seat 3: Z2fXsGcjl+Eax+RzOgwOmg folded before Flop (didn't bet)
Seat 5: WgIrs6CBinyyw18pqdDtWA (button) mucked
Seat 6: dYyb6/42PMC8aNFlm/eBeQ (small blind) showed [Ad 5s] and won ($14.30) with a pair of Aces



PokerStars Game #59940990136:  Hold'em No Limit ($0.50/$1.00) - 2009/07/01 1:22:29 ET
Table '7O9fB8yx1u7sJveJn8w6jA' 6-max Seat #1 is the button
Seat 1: jy52+7FotjH63o5tEEVgKw ($64.30 in chips)
Seat 2: wx3sQGkVi2x9wJXuWNHPBw ($199.70 in chips)
Seat 3: hpxXcmRkXXI9HE5+5/j/0Q ($122.75 in chips)
Seat 4: b2a+5TkFf4xJN/Ihhma58Q ($30.15 in chips)
Seat 5: BCEV3COoKY607AzLWayfRA ($104.85 in chips)
Seat 6: 6hLdALbOlkzGIrc53QKtPw ($20 in chips)
wx3sQGkVi2x9wJXuWNHPBw: posts small blind $0.50
hpxXcmRkXXI9HE5+5/j/0Q: posts big blind $1
*** HOLE CARDS ***
b2a+5TkFf4xJN/Ihhma58Q: raises $1 to $2
BCEV3COoKY607AzLWayfRA: folds
6hLdALbOlkzGIrc53QKtPw: folds
jy52+7FotjH63o5tEEVgKw: folds
wx3sQGkVi2x9wJXuWNHPBw: folds
hpxXcmRkXXI9HE5+5/j/0Q: folds
b2a+5TkFf4xJN/Ihhma58Q collected $2.50 from pot
*** SUMMARY ***
Total pot $2.50 | Rake $0
Seat 1: jy52+7FotjH63o5tEEVgKw (button) folded before Flop (didn't bet)
Seat 2: wx3sQGkVi2x9wJXuWNHPBw (small blind) folded before Flop
Seat 3: hpxXcmRkXXI9HE5+5/j/0Q (big blind) folded before Flop
Seat 4: b2a+5TkFf4xJN/Ihhma58Q collected ($2.50)
Seat 5: BCEV3COoKY607AzLWayfRA folded before Flop (didn't bet)
Seat 6: 6hLdALbOlkzGIrc53QKtPw folded before Flop (didn't bet)



PokerStars Game #59940990010:  Hold'em No Limit ($0.50/$1.00) - 2009/07/01 1:22:29 ET
Table 'MNvFfRVQNka/oY+Z5aMbZQ' 2-max Seat #1 is the button
Seat 1: DaZnoWHjO897dnh0CL2lVg ($68.50 in chips)
Seat 2: mgi+mjKb1Sc3CCs7TlfoCw ($54.45 in chips)
DaZnoWHjO897dnh0CL2lVg: posts small blind $0.50
mgi+mjKb1Sc3CCs7TlfoCw: posts big blind $1
*** HOLE CARDS ***
DaZnoWHjO897dnh0CL2lVg: folds
mgi+mjKb1Sc3CCs7TlfoCw collected $1 from pot
mgi+mjKb1Sc3CCs7TlfoCw: doesn't show hand
*** SUMMARY ***
Total pot $1 | Rake $0
Seat 1: DaZnoWHjO897dnh0CL2lVg (button) (small blind) folded before Flop
Seat 2: mgi+mjKb1Sc3CCs7TlfoCw (big blind) collected ($1)



PokerStars Game #59940990434:  Hold'em No Limit ($0.50/$1.00) - 2009/07/01 1:22:30 ET
Table '/RZcOwpZpHQ+OwPwjsbnRw' 6-max Seat #1 is the button
Seat 1: +uSzP8Jwnw7sKfQ4s66b7w ($49.75 in chips)
Seat 2: Z2fXsGcjl+Eax+RzOgwOmg ($103.50 in chips)
Seat 3: 6hLdALbOlkzGIrc53QKtPw ($24.20 in chips)
Seat 4: j7NIOHLZk7V2o9fOioO5ug ($143.70 in chips)
Seat 5: wx3sQGkVi2x9wJXuWNHPBw ($166.05 in chips)
Seat 6: o3YLm/rSY916m/on1VjXPA ($100 in chips)
Z2fXsGcjl+Eax+RzOgwOmg: posts small blind $0.50
6hLdALbOlkzGIrc53QKtPw: posts big blind $1
*** HOLE CARDS ***
j7NIOHLZk7V2o9fOioO5ug: folds
wx3sQGkVi2x9wJXuWNHPBw: folds
o3YLm/rSY916m/on1VjXPA: raises $2 to $3
+uSzP8Jwnw7sKfQ4s66b7w: folds
Z2fXsGcjl+Eax+RzOgwOmg: folds
6hLdALbOlkzGIrc53QKtPw: folds
o3YLm/rSY916m/on1VjXPA collected $2.50 from pot
o3YLm/rSY916m/on1VjXPA: doesn't show hand
*** SUMMARY ***
Total pot $2.50 | Rake $0
Seat 1: +uSzP8Jwnw7sKfQ4s66b7w (button) folded before Flop (didn't bet)
Seat 2: Z2fXsGcjl+Eax+RzOgwOmg (small blind) folded before Flop
Seat 3: 6hLdALbOlkzGIrc53QKtPw (big blind) folded before Flop
Seat 4: j7NIOHLZk7V2o9fOioO5ug folded before Flop (didn't bet)
Seat 5: wx3sQGkVi2x9wJXuWNHPBw folded before Flop (didn't bet)
Seat 6: o3YLm/rSY916m/on1VjXPA collected ($2.50)



PokerStars Game #59940990746:  Hold'em No Limit ($0.50/$1.00) - 2009/07/01 1:22:30 ET
Table 'W/wyObTiXZm+Ckkl3YxcSw' 6-max Seat #1 is the button
Seat 1: eUBBn2R56C1IQ6Cs/vitwg ($289.90 in chips)
Seat 2: oDiBRCaF0QVtd3kO6xZIXw ($151.05 in chips)
Seat 3: dxyNCn/qxfkGDUIf28Cbng ($67.80 in chips)
Seat 4: UBZQqpnJZdTYYY1FTb0rLA ($100 in chips)
Seat 5: +OrCjyw70oZhJiD22Mn+bg ($100 in chips)
Seat 6: b2a+5TkFf4xJN/Ihhma58Q ($46.05 in chips)
oDiBRCaF0QVtd3kO6xZIXw: posts small blind $0.50
dxyNCn/qxfkGDUIf28Cbng: posts big blind $1
*** HOLE CARDS ***
UBZQqpnJZdTYYY1FTb0rLA: folds
+OrCjyw70oZhJiD22Mn+bg: folds
b2a+5TkFf4xJN/Ihhma58Q: folds
eUBBn2R56C1IQ6Cs/vitwg: folds
oDiBRCaF0QVtd3kO6xZIXw: raises $2 to $3
dxyNCn/qxfkGDUIf28Cbng: folds
oDiBRCaF0QVtd3kO6xZIXw collected $2 from pot
oDiBRCaF0QVtd3kO6xZIXw: doesn't show hand
*** SUMMARY ***
Total pot $2 | Rake $0
Seat 1: eUBBn2R56C1IQ6Cs/vitwg (button) folded before Flop (didn't bet)
Seat 2: oDiBRCaF0QVtd3kO6xZIXw (small blind) collected ($2)
Seat 3: dxyNCn/qxfkGDUIf28Cbng (big blind) folded before Flop
Seat 4: UBZQqpnJZdTYYY1FTb0rLA folded before Flop (didn't bet)
Seat 5: +OrCjyw70oZhJiD22Mn+bg folded before Flop (didn't bet)
Seat 6: b2a+5TkFf4xJN/Ihhma58Q folded before Flop (didn't bet)



PokerStars Game #59940991138:  Hold'em No Limit ($0.50/$1.00) - 2009/07/01 1:22:31 ET
Table 'TvsifD4n+q//fIZ4fM1xxQ' 2-max Seat #2 is the button
Seat 1: NYi6JFscYNrofSXy4sM+Yw ($103 in chips)
Seat 2: +W/hy0gBp0sJy8pjLz6Yrg ($60.55 in chips)
+W/hy0gBp0sJy8pjLz6Yrg: posts small blind $0.50
NYi6JFscYNrofSXy4sM+Yw: posts big blind $1
*** HOLE CARDS ***
+W/hy0gBp0sJy8pjLz6Yrg: raises $1 to $2
NYi6JFscYNrofSXy4sM+Yw: folds
+W/hy0gBp0sJy8pjLz6Yrg collected $2 from pot
*** SUMMARY ***
Total pot $2 | Rake $0
Seat 1: NYi6JFscYNrofSXy4sM+Yw (big blind) folded before Flop
Seat 2: +W/hy0gBp0sJy8pjLz6Yrg (button) (small blind) collected ($2)



PokerStars Game #59940993214:  Hold'em No Limit ($0.50/$1.00) - 2009/07/01 1:22:35 ET
Table 'MNvFfRVQNka/oY+Z5aMbZQ' 2-max Seat #2 is the button
Seat 1: DaZnoWHjO897dnh0CL2lVg ($68 in chips)
Seat 2: mgi+mjKb1Sc3CCs7TlfoCw ($54.95 in chips)
mgi+mjKb1Sc3CCs7TlfoCw: posts small blind $0.50
DaZnoWHjO897dnh0CL2lVg: posts big blind $1
*** HOLE CARDS ***
mgi+mjKb1Sc3CCs7TlfoCw: folds
DaZnoWHjO897dnh0CL2lVg collected $1 from pot
DaZnoWHjO897dnh0CL2lVg: doesn't show hand
*** SUMMARY ***
Total pot $1 | Rake $0
Seat 1: DaZnoWHjO897dnh0CL2lVg (big blind) collected ($1)
Seat 2: mgi+mjKb1Sc3CCs7TlfoCw (button) (small blind) folded before Flop



PokerStars Game #59940995618:  Hold'em No Limit ($0.50/$1.00) - 2009/07/01 1:22:39 ET
Table 'TvsifD4n+q//fIZ4fM1xxQ' 2-max Seat #1 is the button
Seat 1: NYi6JFscYNrofSXy4sM+Yw ($102 in chips)
Seat 2: +W/hy0gBp0sJy8pjLz6Yrg ($61.55 in chips)
NYi6JFscYNrofSXy4sM+Yw: posts small blind $0.50
+W/hy0gBp0sJy8pjLz6Yrg: posts big blind $1
*** HOLE CARDS ***
NYi6JFscYNrofSXy4sM+Yw: raises $2 to $3
+W/hy0gBp0sJy8pjLz6Yrg: raises $7 to $10
NYi6JFscYNrofSXy4sM+Yw: folds
+W/hy0gBp0sJy8pjLz6Yrg collected $6 from pot
*** SUMMARY ***
Total pot $6 | Rake $0
Seat 1: NYi6JFscYNrofSXy4sM+Yw (button) (small blind) folded before Flop
Seat 2: +W/hy0gBp0sJy8pjLz6Yrg (big blind) collected ($6)



PokerStars Game #59940996110:  Hold'em No Limit ($0.50/$1.00) - 2009/07/01 1:22:40 ET
Table 'hugOjcwJvzEwZbK7tyiWuQ' 9-max Seat #7 is the button
Seat 1: S3Ex8K7v6xm5jqjRM7Fl3w ($22 in chips)
Seat 2: r27C1nIV4NS4+qbnrgBQSw ($272.20 in chips)
Seat 4: UWB3oeddt/GObx2Mix2Anw ($187.60 in chips)
Seat 6: gUUvmqdVlmvpal6B8nYrmg ($110.95 in chips)
Seat 7: FL3MrLspcF23LYvC4ipBOA ($117.30 in chips)
Seat 8: /zy+DB4S5fUQUSfZWFzYGw ($116.25 in chips)
Seat 9: W8P9bUKCs43TO1xHm0dL6w ($106.95 in chips)
/zy+DB4S5fUQUSfZWFzYGw: posts small blind $0.50
W8P9bUKCs43TO1xHm0dL6w: posts big blind $1
*** HOLE CARDS ***
S3Ex8K7v6xm5jqjRM7Fl3w: folds
r27C1nIV4NS4+qbnrgBQSw: raises $3 to $4
UWB3oeddt/GObx2Mix2Anw: folds
gUUvmqdVlmvpal6B8nYrmg: folds
FL3MrLspcF23LYvC4ipBOA: folds
/zy+DB4S5fUQUSfZWFzYGw: folds
W8P9bUKCs43TO1xHm0dL6w: folds
r27C1nIV4NS4+qbnrgBQSw collected $2.50 from pot
*** SUMMARY ***
Total pot $2.50 | Rake $0
Seat 1: S3Ex8K7v6xm5jqjRM7Fl3w folded before Flop (didn't bet)
Seat 2: r27C1nIV4NS4+qbnrgBQSw collected ($2.50)
Seat 4: UWB3oeddt/GObx2Mix2Anw folded before Flop (didn't bet)
Seat 6: gUUvmqdVlmvpal6B8nYrmg folded before Flop (didn't bet)
Seat 7: FL3MrLspcF23LYvC4ipBOA (button) folded before Flop (didn't bet)
Seat 8: /zy+DB4S5fUQUSfZWFzYGw (small blind) folded before Flop
Seat 9: W8P9bUKCs43TO1xHm0dL6w (big blind) folded before Flop



PokerStars Game #59940997772:  Hold'em No Limit ($0.50/$1.00) - 2009/07/01 1:22:43 ET
Table 'MNvFfRVQNka/oY+Z5aMbZQ' 2-max Seat #1 is the button
Seat 1: DaZnoWHjO897dnh0CL2lVg ($68.50 in chips)
Seat 2: mgi+mjKb1Sc3CCs7TlfoCw ($54.45 in chips)
DaZnoWHjO897dnh0CL2lVg: posts small blind $0.50
mgi+mjKb1Sc3CCs7TlfoCw: posts big blind $1
*** HOLE CARDS ***
DaZnoWHjO897dnh0CL2lVg: raises $2 to $3
mgi+mjKb1Sc3CCs7TlfoCw: raises $10 to $13
DaZnoWHjO897dnh0CL2lVg: folds
mgi+mjKb1Sc3CCs7TlfoCw collected $6 from pot
mgi+mjKb1Sc3CCs7TlfoCw: doesn't show hand
*** SUMMARY ***
Total pot $6 | Rake $0
Seat 1: DaZnoWHjO897dnh0CL2lVg (button) (small blind) folded before Flop
Seat 2: mgi+mjKb1Sc3CCs7TlfoCw (big blind) collected ($6)



PokerStars Game #59940998740:  Hold'em No Limit ($0.50/$1.00) - 2009/07/01 1:22:44 ET
Table 'Evb7VW0qfDhFkbgBL3gcqQ' 2-max Seat #1 is the button
Seat 1: NYi6JFscYNrofSXy4sM+Yw ($116.60 in chips)
Seat 2: AoEQlM/FNYM0d7Txn1TfBQ ($90.50 in chips)
NYi6JFscYNrofSXy4sM+Yw: posts small blind $0.50
AoEQlM/FNYM0d7Txn1TfBQ: posts big blind $1
*** HOLE CARDS ***
NYi6JFscYNrofSXy4sM+Yw: raises $2 to $3
AoEQlM/FNYM0d7Txn1TfBQ: folds
NYi6JFscYNrofSXy4sM+Yw collected $2 from pot
*** SUMMARY ***
Total pot $2 | Rake $0
Seat 1: NYi6JFscYNrofSXy4sM+Yw (button) (small blind) collected ($2)
Seat 2: AoEQlM/FNYM0d7Txn1TfBQ (big blind) folded before Flop



PokerStars Game #59940999104:  Hold'em No Limit ($0.50/$1.00) - 2009/07/01 1:22:45 ET
Table '305hiksPPCCdC6V2LNsO5w' 6-max Seat #6 is the button
Seat 1: RTuDLJHh/9zPfBftoc9vsw ($17 in chips)
Seat 2: j7NIOHLZk7V2o9fOioO5ug ($124.55 in chips)
Seat 3: +zIVjZKLpcidfRHgVZW8lA ($17 in chips)
Seat 4: uJVSceLggtsrJya+WtmUEA ($222.15 in chips)
Seat 5: +Nt3OPk3XR9SKjZgm2CexQ ($114.15 in chips)
Seat 6: 9/Tq8dw7kWW68uN8bFupXg ($26.10 in chips)
RTuDLJHh/9zPfBftoc9vsw: posts small blind $0.50
j7NIOHLZk7V2o9fOioO5ug: posts big blind $1
*** HOLE CARDS ***
+zIVjZKLpcidfRHgVZW8lA: folds
uJVSceLggtsrJya+WtmUEA: folds
+Nt3OPk3XR9SKjZgm2CexQ: folds
9/Tq8dw7kWW68uN8bFupXg: raises $1 to $2
RTuDLJHh/9zPfBftoc9vsw: folds
j7NIOHLZk7V2o9fOioO5ug: calls $1
*** FLOP *** [7h Qc 4h]
j7NIOHLZk7V2o9fOioO5ug: bets $5
9/Tq8dw7kWW68uN8bFupXg: folds
j7NIOHLZk7V2o9fOioO5ug collected $4.30 from pot
*** SUMMARY ***
Total pot $4.50 | Rake $0.20
Board [7h Qc 4h]
Seat 1: RTuDLJHh/9zPfBftoc9vsw (small blind) folded before Flop
Seat 2: j7NIOHLZk7V2o9fOioO5ug (big blind) collected ($4.30)
Seat 3: +zIVjZKLpcidfRHgVZW8lA folded before Flop (didn't bet)
Seat 4: uJVSceLggtsrJya+WtmUEA folded before Flop (didn't bet)
Seat 5: +Nt3OPk3XR9SKjZgm2CexQ folded before Flop (didn't bet)
Seat 6: 9/Tq8dw7kWW68uN8bFupXg (button) folded on the Flop



PokerStars Game #59940999714:  Hold'em No Limit ($0.50/$1.00) - 2009/07/01 1:22:46 ET
Table 'cBDNutyLBKEk9+ptwsKmTw' 6-max Seat #1 is the button
Seat 1: xAU6q2/cwmby2sxmA8VcmA ($248.90 in chips)
Seat 2: 5lY8d6Cnm4HUkt/8FZSj4g ($81.55 in chips)
Seat 3: G5ZSSN6RSON3gkNvk/SmYg ($111.90 in chips)
Seat 4: 3q7F5QtzC30pSrn0nl9i+A ($20 in chips)
Seat 5: hpxXcmRkXXI9HE5+5/j/0Q ($100 in chips)
Seat 6: QHvTZcrKe6+maWUfVjP29Q ($100 in chips)
5lY8d6Cnm4HUkt/8FZSj4g: posts small blind $0.50
G5ZSSN6RSON3gkNvk/SmYg: posts big blind $1
*** HOLE CARDS ***
3q7F5QtzC30pSrn0nl9i+A: folds
hpxXcmRkXXI9HE5+5/j/0Q: raises $2 to $3
QHvTZcrKe6+maWUfVjP29Q: raises $6 to $9
xAU6q2/cwmby2sxmA8VcmA: folds
5lY8d6Cnm4HUkt/8FZSj4g: calls $8.50
G5ZSSN6RSON3gkNvk/SmYg: folds
hpxXcmRkXXI9HE5+5/j/0Q: folds
*** FLOP *** [Ah 5s Kh]
5lY8d6Cnm4HUkt/8FZSj4g: checks
QHvTZcrKe6+maWUfVjP29Q: bets $12
5lY8d6Cnm4HUkt/8FZSj4g: calls $12
*** TURN *** [Ah 5s Kh] [8s]
5lY8d6Cnm4HUkt/8FZSj4g: checks
QHvTZcrKe6+maWUfVjP29Q: bets $30
5lY8d6Cnm4HUkt/8FZSj4g: calls $30
*** RIVER *** [Ah 5s Kh 8s] [5d]
5lY8d6Cnm4HUkt/8FZSj4g: checks
QHvTZcrKe6+maWUfVjP29Q: bets $49 and is all-in
5lY8d6Cnm4HUkt/8FZSj4g: folds
QHvTZcrKe6+maWUfVjP29Q collected $103 from pot
QHvTZcrKe6+maWUfVjP29Q: doesn't show hand
*** SUMMARY ***
Total pot $106 | Rake $3
Board [Ah 5s Kh 8s 5d]
Seat 1: xAU6q2/cwmby2sxmA8VcmA (button) folded before Flop (didn't bet)
Seat 2: 5lY8d6Cnm4HUkt/8FZSj4g (small blind) folded on the River
Seat 3: G5ZSSN6RSON3gkNvk/SmYg (big blind) folded before Flop
Seat 4: 3q7F5QtzC30pSrn0nl9i+A folded before Flop (didn't bet)
Seat 5: hpxXcmRkXXI9HE5+5/j/0Q folded before Flop
Seat 6: QHvTZcrKe6+maWUfVjP29Q collected ($103)



PokerStars Game #59941000406:  Hold'em No Limit ($0.50/$1.00) - 2009/07/01 1:22:47 ET
Table '+cA8mcmhaedZ7YcrDdhmeQ' 6-max Seat #4 is the button
Seat 1: iIgNoBh+3/Ix1/fLsg+HuA ($35 in chips)
Seat 2: 14aYclSc98EYd6TrzN2l3Q ($20.85 in chips)
Seat 3: DAIgyIWbYvAkL6PbAI27pg ($17 in chips)
Seat 4: 4OO5v3AVduL0tePNx8wk5A ($100.05 in chips)
Seat 5: n5xXfJeDtWZSChGAdq//Tw ($19.05 in chips)
Seat 6: YfsTQsY/fxb+YqbdclTHuw ($13.85 in chips)
n5xXfJeDtWZSChGAdq//Tw: posts small blind $0.50
YfsTQsY/fxb+YqbdclTHuw: posts big blind $1
*** HOLE CARDS ***
iIgNoBh+3/Ix1/fLsg+HuA: folds
14aYclSc98EYd6TrzN2l3Q: calls $1
DAIgyIWbYvAkL6PbAI27pg: raises $16 to $17 and is all-in
4OO5v3AVduL0tePNx8wk5A: folds
n5xXfJeDtWZSChGAdq//Tw: folds
YfsTQsY/fxb+YqbdclTHuw: calls $12.85 and is all-in
14aYclSc98EYd6TrzN2l3Q: folds
*** FLOP *** [Qc 8s Ad]
*** TURN *** [Qc 8s Ad] [9c]
*** RIVER *** [Qc 8s Ad 9c] [Th]
*** SHOW DOWN ***
YfsTQsY/fxb+YqbdclTHuw: shows [Ac As] (three of a kind, Aces)
DAIgyIWbYvAkL6PbAI27pg: mucks hand
YfsTQsY/fxb+YqbdclTHuw collected $27.75 from pot
*** SUMMARY ***
Total pot $29.20 | Rake $1.45
Board [Qc 8s Ad 9c Th]
Seat 1: iIgNoBh+3/Ix1/fLsg+HuA folded before Flop (didn't bet)
Seat 2: 14aYclSc98EYd6TrzN2l3Q folded before Flop
Seat 3: DAIgyIWbYvAkL6PbAI27pg mucked
Seat 4: 4OO5v3AVduL0tePNx8wk5A (button) folded before Flop (didn't bet)
Seat 5: n5xXfJeDtWZSChGAdq//Tw (small blind) folded before Flop
Seat 6: YfsTQsY/fxb+YqbdclTHuw (big blind) showed [Ac As] and won ($27.75) with three of a kind, Aces



PokerStars Game #59941000148:  Hold'em No Limit ($0.50/$1.00) - 2009/07/01 1:22:47 ET
Table 'W/wyObTiXZm+Ckkl3YxcSw' 6-max Seat #2 is the button
Seat 1: eUBBn2R56C1IQ6Cs/vitwg ($289.90 in chips)
Seat 2: oDiBRCaF0QVtd3kO6xZIXw ($152.05 in chips)
Seat 3: dxyNCn/qxfkGDUIf28Cbng ($66.80 in chips)
Seat 4: UBZQqpnJZdTYYY1FTb0rLA ($100 in chips)
Seat 5: +OrCjyw70oZhJiD22Mn+bg ($100 in chips)
Seat 6: b2a+5TkFf4xJN/Ihhma58Q ($46.05 in chips)
dxyNCn/qxfkGDUIf28Cbng: posts small blind $0.50
UBZQqpnJZdTYYY1FTb0rLA: posts big blind $1
*** HOLE CARDS ***
+OrCjyw70oZhJiD22Mn+bg: folds
b2a+5TkFf4xJN/Ihhma58Q: folds
eUBBn2R56C1IQ6Cs/vitwg: folds
oDiBRCaF0QVtd3kO6xZIXw: folds
dxyNCn/qxfkGDUIf28Cbng: folds
UBZQqpnJZdTYYY1FTb0rLA collected $1 from pot
UBZQqpnJZdTYYY1FTb0rLA: doesn't show hand
*** SUMMARY ***
Total pot $1 | Rake $0
Seat 1: eUBBn2R56C1IQ6Cs/vitwg folded before Flop (didn't bet)
Seat 2: oDiBRCaF0QVtd3kO6xZIXw (button) folded before Flop (didn't bet)
Seat 3: dxyNCn/qxfkGDUIf28Cbng (small blind) folded before Flop
Seat 4: UBZQqpnJZdTYYY1FTb0rLA (big blind) collected ($1)
Seat 5: +OrCjyw70oZhJiD22Mn+bg folded before Flop (didn't bet)
Seat 6: b2a+5TkFf4xJN/Ihhma58Q folded before Flop (didn't bet)



PokerStars Game #59941001500:  Hold'em No Limit ($0.50/$1.00) - 2009/07/01 1:22:49 ET
Table 'O96CPOtvMBWP6kzuYDfdFA' 6-max Seat #6 is the button
Seat 1: 6alLXQIITA2EZ/lBeym8Dw ($123.25 in chips)
Seat 2: 4d1rWhpu8DzLmzMbR3QKyA ($113.40 in chips)
Seat 3: V89DGjxE171oPREEbAXiyg ($93.15 in chips)
Seat 4: /P4w1pHg2zHYg/4ubJ0dPw ($63.65 in chips)
Seat 5: G5ZSSN6RSON3gkNvk/SmYg ($100 in chips)
Seat 6: GYei5jXGWexiJYbAT2fELg ($29.65 in chips)
6alLXQIITA2EZ/lBeym8Dw: posts small blind $0.50
4d1rWhpu8DzLmzMbR3QKyA: posts big blind $1
*** HOLE CARDS ***
V89DGjxE171oPREEbAXiyg: folds
/P4w1pHg2zHYg/4ubJ0dPw: folds
G5ZSSN6RSON3gkNvk/SmYg: folds
GYei5jXGWexiJYbAT2fELg: calls $1
6alLXQIITA2EZ/lBeym8Dw: folds
4d1rWhpu8DzLmzMbR3QKyA: checks
*** FLOP *** [3c Js Th]
4d1rWhpu8DzLmzMbR3QKyA: bets $2
GYei5jXGWexiJYbAT2fELg: calls $2
*** TURN *** [3c Js Th] [8h]
4d1rWhpu8DzLmzMbR3QKyA: bets $5
GYei5jXGWexiJYbAT2fELg: folds
4d1rWhpu8DzLmzMbR3QKyA collected $6.20 from pot
*** SUMMARY ***
Total pot $6.50 | Rake $0.30
Board [3c Js Th 8h]
Seat 1: 6alLXQIITA2EZ/lBeym8Dw (small blind) folded before Flop
Seat 2: 4d1rWhpu8DzLmzMbR3QKyA (big blind) collected ($6.20)
Seat 3: V89DGjxE171oPREEbAXiyg folded before Flop (didn't bet)
Seat 4: /P4w1pHg2zHYg/4ubJ0dPw folded before Flop (didn't bet)
Seat 5: G5ZSSN6RSON3gkNvk/SmYg folded before Flop (didn't bet)
Seat 6: GYei5jXGWexiJYbAT2fELg (button) folded on the Turn



PokerStars Game #59941001428:  Hold'em No Limit ($0.50/$1.00) - 2009/07/01 1:22:49 ET
Table 'TvsifD4n+q//fIZ4fM1xxQ' 2-max Seat #2 is the button
Seat 1: NYi6JFscYNrofSXy4sM+Yw ($100 in chips)
Seat 2: +W/hy0gBp0sJy8pjLz6Yrg ($64.55 in chips)
+W/hy0gBp0sJy8pjLz6Yrg: posts small blind $0.50
NYi6JFscYNrofSXy4sM+Yw: posts big blind $1
*** HOLE CARDS ***
+W/hy0gBp0sJy8pjLz6Yrg: raises $1 to $2
NYi6JFscYNrofSXy4sM+Yw: folds
+W/hy0gBp0sJy8pjLz6Yrg collected $2 from pot
*** SUMMARY ***
Total pot $2 | Rake $0
Seat 1: NYi6JFscYNrofSXy4sM+Yw (big blind) folded before Flop
Seat 2: +W/hy0gBp0sJy8pjLz6Yrg (button) (small blind) collected ($2)



PokerStars Game #59941003220:  Hold'em No Limit ($0.50/$1.00) - 2009/07/01 1:22:52 ET
Table 'Evb7VW0qfDhFkbgBL3gcqQ' 2-max Seat #2 is the button
Seat 1: NYi6JFscYNrofSXy4sM+Yw ($117.60 in chips)
Seat 2: AoEQlM/FNYM0d7Txn1TfBQ ($89.50 in chips)
AoEQlM/FNYM0d7Txn1TfBQ: posts small blind $0.50
NYi6JFscYNrofSXy4sM+Yw: posts big blind $1
*** HOLE CARDS ***
AoEQlM/FNYM0d7Txn1TfBQ: folds
NYi6JFscYNrofSXy4sM+Yw collected $1 from pot
*** SUMMARY ***
Total pot $1 | Rake $0
Seat 1: NYi6JFscYNrofSXy4sM+Yw (big blind) collected ($1)
Seat 2: AoEQlM/FNYM0d7Txn1TfBQ (button) (small blind) folded before Flop



PokerStars Game #59941002858:  Hold'em No Limit ($0.50/$1.00) - 2009/07/01 1:22:52 ET
Table 'QSIig7BLMc9wY/rgBechzw' 6-max Seat #1 is the button
Seat 1: Z2fXsGcjl+Eax+RzOgwOmg ($105.50 in chips)
Seat 2: mLOIkH/qmRa+mVujQIhBRg ($51.40 in chips)
Seat 3: +xW7QemQU0Fxs+4TnqBRow ($100 in chips)
Seat 4: +uSzP8Jwnw7sKfQ4s66b7w ($63.65 in chips)
Seat 5: lsLuWlcPA3Rh7kJVLzMh0Q ($103.45 in chips)
Seat 6: PxqfkAMdAWtkgbT+q2gciA ($46.85 in chips)
mLOIkH/qmRa+mVujQIhBRg: posts small blind $0.50
+xW7QemQU0Fxs+4TnqBRow: posts big blind $1
*** HOLE CARDS ***
+uSzP8Jwnw7sKfQ4s66b7w: folds
lsLuWlcPA3Rh7kJVLzMh0Q: folds
PxqfkAMdAWtkgbT+q2gciA: calls $1
Z2fXsGcjl+Eax+RzOgwOmg: raises $4 to $5
mLOIkH/qmRa+mVujQIhBRg: folds
+xW7QemQU0Fxs+4TnqBRow: folds
PxqfkAMdAWtkgbT+q2gciA: folds
Z2fXsGcjl+Eax+RzOgwOmg collected $3.50 from pot
Z2fXsGcjl+Eax+RzOgwOmg: doesn't show hand
*** SUMMARY ***
Total pot $3.50 | Rake $0
Seat 1: Z2fXsGcjl+Eax+RzOgwOmg (button) collected ($3.50)
Seat 2: mLOIkH/qmRa+mVujQIhBRg (small blind) folded before Flop
Seat 3: +xW7QemQU0Fxs+4TnqBRow (big blind) folded before Flop
Seat 4: +uSzP8Jwnw7sKfQ4s66b7w folded before Flop (didn't bet)
Seat 5: lsLuWlcPA3Rh7kJVLzMh0Q folded before Flop (didn't bet)
Seat 6: PxqfkAMdAWtkgbT+q2gciA folded before Flop



PokerStars Game #59941003574:  Hold'em No Limit ($0.50/$1.00) - 2009/07/01 1:22:53 ET
Table '7Nl0ffnjeK44/vmeexh3MQ' 9-max Seat #7 is the button
Seat 1: V138SURkdX8LdVBPKdJJag ($100 in chips)
Seat 2: OGgaARGdJQT4awWVNQ957w ($100.50 in chips)
Seat 3: JMmUYT5pIKCKh2pGjCB/4w ($60.40 in chips)
Seat 4: bLbSOSmSOnqE0iTcH/5dxA ($101.35 in chips)
Seat 6: FVs16t7GgfWgQWt4JxsObQ ($26.65 in chips)
Seat 7: 997ViqAtWn1FPjJqcffwcA ($100 in chips)
Seat 8: D+W9Me7w6Hcx/WRUSKV0dw ($18.25 in chips)
Seat 9: rFvc7K/96V9eGvYRfmpoUQ ($20 in chips)
D+W9Me7w6Hcx/WRUSKV0dw: posts small blind $0.50
rFvc7K/96V9eGvYRfmpoUQ: posts big blind $1
*** HOLE CARDS ***
V138SURkdX8LdVBPKdJJag: folds
OGgaARGdJQT4awWVNQ957w: folds
JMmUYT5pIKCKh2pGjCB/4w: folds
bLbSOSmSOnqE0iTcH/5dxA: raises $3 to $4
FVs16t7GgfWgQWt4JxsObQ: calls $4
997ViqAtWn1FPjJqcffwcA: folds
D+W9Me7w6Hcx/WRUSKV0dw: folds
rFvc7K/96V9eGvYRfmpoUQ: folds
*** FLOP *** [Kc Qc 5d]
bLbSOSmSOnqE0iTcH/5dxA: bets $6
FVs16t7GgfWgQWt4JxsObQ: calls $6
*** TURN *** [Kc Qc 5d] [3c]
bLbSOSmSOnqE0iTcH/5dxA: bets $17
FVs16t7GgfWgQWt4JxsObQ: folds
bLbSOSmSOnqE0iTcH/5dxA collected $20.45 from pot
bLbSOSmSOnqE0iTcH/5dxA: doesn't show hand
*** SUMMARY ***
Total pot $21.50 | Rake $1.05
Board [Kc Qc 5d 3c]
Seat 1: V138SURkdX8LdVBPKdJJag folded before Flop (didn't bet)
Seat 2: OGgaARGdJQT4awWVNQ957w folded before Flop (didn't bet)
Seat 3: JMmUYT5pIKCKh2pGjCB/4w folded before Flop (didn't bet)
Seat 4: bLbSOSmSOnqE0iTcH/5dxA collected ($20.45)
Seat 6: FVs16t7GgfWgQWt4JxsObQ folded on the Turn
Seat 7: 997ViqAtWn1FPjJqcffwcA (button) folded before Flop (didn't bet)
Seat 8: D+W9Me7w6Hcx/WRUSKV0dw (small blind) folded before Flop
Seat 9: rFvc7K/96V9eGvYRfmpoUQ (big blind) folded before Flop



PokerStars Game #59941004492:  Hold'em No Limit ($0.50/$1.00) - 2009/07/01 1:22:54 ET
Table '/RZcOwpZpHQ+OwPwjsbnRw' 6-max Seat #2 is the button
Seat 1: +uSzP8Jwnw7sKfQ4s66b7w ($49.75 in chips)
Seat 2: Z2fXsGcjl+Eax+RzOgwOmg ($103 in chips)
Seat 3: 6hLdALbOlkzGIrc53QKtPw ($23.20 in chips)
Seat 4: j7NIOHLZk7V2o9fOioO5ug ($143.70 in chips)
Seat 5: wx3sQGkVi2x9wJXuWNHPBw ($166.05 in chips)
Seat 6: o3YLm/rSY916m/on1VjXPA ($101.50 in chips)
6hLdALbOlkzGIrc53QKtPw: posts small blind $0.50
j7NIOHLZk7V2o9fOioO5ug: posts big blind $1
*** HOLE CARDS ***
wx3sQGkVi2x9wJXuWNHPBw: folds
o3YLm/rSY916m/on1VjXPA: raises $2 to $3
+uSzP8Jwnw7sKfQ4s66b7w: folds
Z2fXsGcjl+Eax+RzOgwOmg: folds
6hLdALbOlkzGIrc53QKtPw: folds
j7NIOHLZk7V2o9fOioO5ug: calls $2
*** FLOP *** [3d 5c Qc]
j7NIOHLZk7V2o9fOioO5ug: checks
o3YLm/rSY916m/on1VjXPA: bets $4
j7NIOHLZk7V2o9fOioO5ug: raises $4 to $8
o3YLm/rSY916m/on1VjXPA: raises $16 to $24
j7NIOHLZk7V2o9fOioO5ug: raises $116.70 to $140.70 and is all-in
o3YLm/rSY916m/on1VjXPA: calls $74.50 and is all-in
*** TURN *** [3d 5c Qc] [2d]
*** RIVER *** [3d 5c Qc 2d] [2s]
*** SHOW DOWN ***
j7NIOHLZk7V2o9fOioO5ug: shows [Qd Ad] (two pair, Queens and Deuces)
o3YLm/rSY916m/on1VjXPA: shows [5s 5h] (a full house, Fives full of Deuces)
o3YLm/rSY916m/on1VjXPA collected $200.50 from pot
*** SUMMARY ***
Total pot $203.50 | Rake $3
Board [3d 5c Qc 2d 2s]
Seat 1: +uSzP8Jwnw7sKfQ4s66b7w folded before Flop (didn't bet)
Seat 2: Z2fXsGcjl+Eax+RzOgwOmg (button) folded before Flop (didn't bet)
Seat 3: 6hLdALbOlkzGIrc53QKtPw (small blind) folded before Flop
Seat 4: j7NIOHLZk7V2o9fOioO5ug (big blind) showed [Qd Ad] and lost with two pair, Queens and Deuces
Seat 5: wx3sQGkVi2x9wJXuWNHPBw folded before Flop (didn't bet)
Seat 6: o3YLm/rSY916m/on1VjXPA showed [5s 5h] and won ($200.50) with a full house, Fives full of Deuces



PokerStars Game #59941005690:  Hold'em No Limit ($0.50/$1.00) - 2009/07/01 1:22:56 ET
Table 'TvsifD4n+q//fIZ4fM1xxQ' 2-max Seat #1 is the button
Seat 1: NYi6JFscYNrofSXy4sM+Yw ($100 in chips)
Seat 2: +W/hy0gBp0sJy8pjLz6Yrg ($65.55 in chips)
NYi6JFscYNrofSXy4sM+Yw: posts small blind $0.50
+W/hy0gBp0sJy8pjLz6Yrg: posts big blind $1
*** HOLE CARDS ***
NYi6JFscYNrofSXy4sM+Yw: raises $2 to $3
+W/hy0gBp0sJy8pjLz6Yrg: folds
NYi6JFscYNrofSXy4sM+Yw collected $2 from pot
*** SUMMARY ***
Total pot $2 | Rake $0
Seat 1: NYi6JFscYNrofSXy4sM+Yw (button) (small blind) collected ($2)
Seat 2: +W/hy0gBp0sJy8pjLz6Yrg (big blind) folded before Flop



PokerStars Game #59941005466:  Hold'em No Limit ($0.50/$1.00) - 2009/07/01 1:22:56 ET
Table 'MNvFfRVQNka/oY+Z5aMbZQ' 2-max Seat #2 is the button
Seat 1: DaZnoWHjO897dnh0CL2lVg ($65.50 in chips)
Seat 2: mgi+mjKb1Sc3CCs7TlfoCw ($57.45 in chips)
mgi+mjKb1Sc3CCs7TlfoCw: posts small blind $0.50
DaZnoWHjO897dnh0CL2lVg: posts big blind $1
*** HOLE CARDS ***
mgi+mjKb1Sc3CCs7TlfoCw: raises $2 to $3
DaZnoWHjO897dnh0CL2lVg: calls $2
*** FLOP *** [5c Ac 9c]
DaZnoWHjO897dnh0CL2lVg: checks
mgi+mjKb1Sc3CCs7TlfoCw: bets $3
DaZnoWHjO897dnh0CL2lVg: folds
mgi+mjKb1Sc3CCs7TlfoCw collected $5.70 from pot
mgi+mjKb1Sc3CCs7TlfoCw: doesn't show hand
*** SUMMARY ***
Total pot $6 | Rake $0.30
Board [5c Ac 9c]
Seat 1: DaZnoWHjO897dnh0CL2lVg (big blind) folded on the Flop
Seat 2: mgi+mjKb1Sc3CCs7TlfoCw (button) (small blind) collected ($5.70)



PokerStars Game #59941006090:  Hold'em No Limit ($0.50/$1.00) - 2009/07/01 1:22:57 ET
Table '7O9fB8yx1u7sJveJn8w6jA' 6-max Seat #2 is the button
Seat 1: jy52+7FotjH63o5tEEVgKw ($64.30 in chips)
Seat 2: wx3sQGkVi2x9wJXuWNHPBw ($199.20 in chips)
Seat 3: hpxXcmRkXXI9HE5+5/j/0Q ($121.75 in chips)
Seat 4: b2a+5TkFf4xJN/Ihhma58Q ($31.65 in chips)
Seat 5: BCEV3COoKY607AzLWayfRA ($104.85 in chips)
Seat 6: 6hLdALbOlkzGIrc53QKtPw ($20 in chips)
hpxXcmRkXXI9HE5+5/j/0Q: posts small blind $0.50
b2a+5TkFf4xJN/Ihhma58Q: posts big blind $1
*** HOLE CARDS ***
BCEV3COoKY607AzLWayfRA: folds
6hLdALbOlkzGIrc53QKtPw: folds
jy52+7FotjH63o5tEEVgKw: calls $1
wx3sQGkVi2x9wJXuWNHPBw: calls $1
hpxXcmRkXXI9HE5+5/j/0Q: folds
b2a+5TkFf4xJN/Ihhma58Q: raises $2 to $3
jy52+7FotjH63o5tEEVgKw: calls $2
wx3sQGkVi2x9wJXuWNHPBw: calls $2
*** FLOP *** [Ts Kc 3c]
b2a+5TkFf4xJN/Ihhma58Q: checks
jy52+7FotjH63o5tEEVgKw: checks
wx3sQGkVi2x9wJXuWNHPBw: checks
*** TURN *** [Ts Kc 3c] [8h]
b2a+5TkFf4xJN/Ihhma58Q: checks
jy52+7FotjH63o5tEEVgKw: checks
wx3sQGkVi2x9wJXuWNHPBw: checks
*** RIVER *** [Ts Kc 3c 8h] [4c]
b2a+5TkFf4xJN/Ihhma58Q: checks
jy52+7FotjH63o5tEEVgKw: checks
wx3sQGkVi2x9wJXuWNHPBw: checks
*** SHOW DOWN ***
b2a+5TkFf4xJN/Ihhma58Q: shows [Qc As] (high card Ace)
jy52+7FotjH63o5tEEVgKw: mucks hand
wx3sQGkVi2x9wJXuWNHPBw: mucks hand
b2a+5TkFf4xJN/Ihhma58Q collected $9.05 from pot
*** SUMMARY ***
Total pot $9.50 | Rake $0.45
Board [Ts Kc 3c 8h 4c]
Seat 1: jy52+7FotjH63o5tEEVgKw mucked
Seat 2: wx3sQGkVi2x9wJXuWNHPBw (button) mucked
Seat 3: hpxXcmRkXXI9HE5+5/j/0Q (small blind) folded before Flop
Seat 4: b2a+5TkFf4xJN/Ihhma58Q (big blind) showed [Qc As] and won ($9.05) with high card Ace
Seat 5: BCEV3COoKY607AzLWayfRA folded before Flop (didn't bet)
Seat 6: 6hLdALbOlkzGIrc53QKtPw folded before Flop (didn't bet)



PokerStars Game #59941006516:  Hold'em No Limit ($0.50/$1.00) - 2009/07/01 1:22:58 ET
Table 'Evb7VW0qfDhFkbgBL3gcqQ' 2-max Seat #1 is the button
Seat 1: NYi6JFscYNrofSXy4sM+Yw ($118.10 in chips)
Seat 2: AoEQlM/FNYM0d7Txn1TfBQ ($89 in chips)
NYi6JFscYNrofSXy4sM+Yw: posts small blind $0.50
AoEQlM/FNYM0d7Txn1TfBQ: posts big blind $1
*** HOLE CARDS ***
NYi6JFscYNrofSXy4sM+Yw: raises $2 to $3
AoEQlM/FNYM0d7Txn1TfBQ: calls $2
*** FLOP *** [3d 4d Tc]
AoEQlM/FNYM0d7Txn1TfBQ: checks
NYi6JFscYNrofSXy4sM+Yw: bets $3
AoEQlM/FNYM0d7Txn1TfBQ: calls $3
*** TURN *** [3d 4d Tc] [Ad]
AoEQlM/FNYM0d7Txn1TfBQ: checks
NYi6JFscYNrofSXy4sM+Yw: checks
*** RIVER *** [3d 4d Tc Ad] [6d]
AoEQlM/FNYM0d7Txn1TfBQ: checks
NYi6JFscYNrofSXy4sM+Yw: checks
*** SHOW DOWN ***
AoEQlM/FNYM0d7Txn1TfBQ: shows [7c 4s] (a pair of Fours)
NYi6JFscYNrofSXy4sM+Yw: shows [Ts Kh] (a pair of Tens)
NYi6JFscYNrofSXy4sM+Yw collected $11.50 from pot
*** SUMMARY ***
Total pot $12 | Rake $0.50
Board [3d 4d Tc Ad 6d]
Seat 1: NYi6JFscYNrofSXy4sM+Yw (button) (small blind) showed [Ts Kh] and won ($11.50) with a pair of Tens
Seat 2: AoEQlM/FNYM0d7Txn1TfBQ (big blind) showed [7c 4s] and lost with a pair of Fours



PokerStars Game #59941006650:  Hold'em No Limit ($0.50/$1.00) - 2009/07/01 1:22:58 ET
Table 'hdVBCnDy5t2X9dZo0AvD9w' 9-max Seat #8 is the button
Seat 1: sa/cZBFh73L9TapFXpn3BA ($96.45 in chips)
Seat 2: Ogn4JDV3mp4ZDKO49IFzKA ($19.50 in chips)
Seat 3: 1862487932 ($100 in chips)
Seat 5: H+DVy3Ei8L1UKS2tVOtJcw ($100 in chips)
Seat 6: bJckevFOcg//s0qyMQI6sQ ($105.60 in chips)
Seat 8: gUUvmqdVlmvpal6B8nYrmg ($143.40 in chips)
Seat 9: AMkLbywdoc0K30BTzaIfTQ ($182.40 in chips)
AMkLbywdoc0K30BTzaIfTQ: posts small blind $0.50
sa/cZBFh73L9TapFXpn3BA: posts big blind $1
laA8va+Yv8WuMqT1zdR91g: sits out
*** HOLE CARDS ***
Ogn4JDV3mp4ZDKO49IFzKA: folds
1862487932: folds
H+DVy3Ei8L1UKS2tVOtJcw: raises $1 to $2
bJckevFOcg//s0qyMQI6sQ: folds
gUUvmqdVlmvpal6B8nYrmg: folds
AMkLbywdoc0K30BTzaIfTQ: folds
sa/cZBFh73L9TapFXpn3BA: calls $1
*** FLOP *** [Jd 3h 4c]
sa/cZBFh73L9TapFXpn3BA: bets $1
H+DVy3Ei8L1UKS2tVOtJcw: calls $1
*** TURN *** [Jd 3h 4c] [7d]
sa/cZBFh73L9TapFXpn3BA: bets $2
H+DVy3Ei8L1UKS2tVOtJcw: calls $2
*** RIVER *** [Jd 3h 4c 7d] [8c]
sa/cZBFh73L9TapFXpn3BA: bets $7
H+DVy3Ei8L1UKS2tVOtJcw: calls $7
*** SHOW DOWN ***
sa/cZBFh73L9TapFXpn3BA: shows [2h 6s] (high card Jack)
H+DVy3Ei8L1UKS2tVOtJcw: shows [Ks Js] (a pair of Jacks)
H+DVy3Ei8L1UKS2tVOtJcw collected $23.30 from pot
*** SUMMARY ***
Total pot $24.50 | Rake $1.20
Board [Jd 3h 4c 7d 8c]
Seat 1: sa/cZBFh73L9TapFXpn3BA (big blind) showed [2h 6s] and lost with high card Jack
Seat 2: Ogn4JDV3mp4ZDKO49IFzKA folded before Flop (didn't bet)
Seat 3: 1862487932 folded before Flop (didn't bet)
Seat 5: H+DVy3Ei8L1UKS2tVOtJcw showed [Ks Js] and won ($23.30) with a pair of Jacks
Seat 6: bJckevFOcg//s0qyMQI6sQ folded before Flop (didn't bet)
Seat 8: gUUvmqdVlmvpal6B8nYrmg (button) folded before Flop (didn't bet)
Seat 9: AMkLbywdoc0K30BTzaIfTQ (small blind) folded before Flop



PokerStars Game #59941007168:  Hold'em No Limit ($0.50/$1.00) - 2009/07/01 1:22:59 ET
Table 'MUPc8FEpe/nR0BKSeReX6Q' 6-max Seat #2 is the button
Seat 1: qhkK6+yCciTRd+rCFEbnEQ ($83.20 in chips)
Seat 2: xAU6q2/cwmby2sxmA8VcmA ($111.70 in chips)
Seat 3: wx3sQGkVi2x9wJXuWNHPBw ($288 in chips)
Seat 4: ZA1bp6g8IwtTxkUE4eCjDQ ($96.70 in chips)
Seat 5: y27w5IK2WXqmYzS8OU0wKA ($100 in chips)
Seat 6: oxnw0GLLpFanjhGkxfRSqA ($39.45 in chips)
oxnw0GLLpFanjhGkxfRSqA said, "lol"
wx3sQGkVi2x9wJXuWNHPBw: posts small blind $0.50
ZA1bp6g8IwtTxkUE4eCjDQ: posts big blind $1
*** HOLE CARDS ***
oxnw0GLLpFanjhGkxfRSqA said, "nh dumbass"
y27w5IK2WXqmYzS8OU0wKA: folds
oxnw0GLLpFanjhGkxfRSqA: raises $4 to $5
qhkK6+yCciTRd+rCFEbnEQ: folds
xAU6q2/cwmby2sxmA8VcmA: folds
wx3sQGkVi2x9wJXuWNHPBw: folds
ZA1bp6g8IwtTxkUE4eCjDQ: raises $91.70 to $96.70 and is all-in
oxnw0GLLpFanjhGkxfRSqA: calls $34.45 and is all-in
*** FLOP *** [Ts Ks 3d]
*** TURN *** [Ts Ks 3d] [4d]
*** RIVER *** [Ts Ks 3d 4d] [6c]
*** SHOW DOWN ***
ZA1bp6g8IwtTxkUE4eCjDQ: shows [Js Jh] (a pair of Jacks)
oxnw0GLLpFanjhGkxfRSqA: shows [Ah Kh] (a pair of Kings)
oxnw0GLLpFanjhGkxfRSqA collected $76.40 from pot
*** SUMMARY ***
Total pot $79.40 | Rake $3
Board [Ts Ks 3d 4d 6c]
Seat 1: qhkK6+yCciTRd+rCFEbnEQ folded before Flop (didn't bet)
Seat 2: xAU6q2/cwmby2sxmA8VcmA (button) folded before Flop (didn't bet)
Seat 3: wx3sQGkVi2x9wJXuWNHPBw (small blind) folded before Flop
Seat 4: ZA1bp6g8IwtTxkUE4eCjDQ (big blind) showed [Js Jh] and lost with a pair of Jacks
Seat 5: y27w5IK2WXqmYzS8OU0wKA folded before Flop (didn't bet)
Seat 6: oxnw0GLLpFanjhGkxfRSqA showed [Ah Kh] and won ($76.40) with a pair of Kings



PokerStars Game #59941007848:  Hold'em No Limit ($0.50/$1.00) - 2009/07/01 1:23:00 ET
Table 'W/wyObTiXZm+Ckkl3YxcSw' 6-max Seat #3 is the button
Seat 1: eUBBn2R56C1IQ6Cs/vitwg ($289.90 in chips)
Seat 2: oDiBRCaF0QVtd3kO6xZIXw ($152.05 in chips)
Seat 3: dxyNCn/qxfkGDUIf28Cbng ($66.30 in chips)
Seat 4: UBZQqpnJZdTYYY1FTb0rLA ($100.50 in chips)
Seat 5: +OrCjyw70oZhJiD22Mn+bg ($100 in chips)
Seat 6: b2a+5TkFf4xJN/Ihhma58Q ($46.05 in chips)
UBZQqpnJZdTYYY1FTb0rLA: posts small blind $0.50
+OrCjyw70oZhJiD22Mn+bg: posts big blind $1
*** HOLE CARDS ***
b2a+5TkFf4xJN/Ihhma58Q: raises $1 to $2
eUBBn2R56C1IQ6Cs/vitwg: folds
oDiBRCaF0QVtd3kO6xZIXw: folds
dxyNCn/qxfkGDUIf28Cbng: folds
UBZQqpnJZdTYYY1FTb0rLA: folds
+OrCjyw70oZhJiD22Mn+bg: folds
b2a+5TkFf4xJN/Ihhma58Q collected $2.50 from pot
*** SUMMARY ***
Total pot $2.50 | Rake $0
Seat 1: eUBBn2R56C1IQ6Cs/vitwg folded before Flop (didn't bet)
Seat 2: oDiBRCaF0QVtd3kO6xZIXw folded before Flop (didn't bet)
Seat 3: dxyNCn/qxfkGDUIf28Cbng (button) folded before Flop (didn't bet)
Seat 4: UBZQqpnJZdTYYY1FTb0rLA (small blind) folded before Flop
Seat 5: +OrCjyw70oZhJiD22Mn+bg (big blind) folded before Flop
Seat 6: b2a+5TkFf4xJN/Ihhma58Q collected ($2.50)



PokerStars Game #59941008452:  Hold'em No Limit ($0.50/$1.00) - 2009/07/01 1:23:01 ET
Table 'SQLOQoANiHscJ8AL7zffbw' 9-max Seat #6 is the button
Seat 1: jPTRd6SpCp4xqAy2XQiTOw ($40.90 in chips)
Seat 2: /zy+DB4S5fUQUSfZWFzYGw ($395.05 in chips)
Seat 3: 0eFnow7+D7veCYQ+CG9FFw ($103 in chips)
Seat 4: 5z1PAR8SNow/zUfYNbwq7A ($59.95 in chips)
Seat 5: L9njYvloJ1NdXjP8edHEAg ($111.30 in chips)
Seat 6: H+DVy3Ei8L1UKS2tVOtJcw ($100 in chips)
Seat 8: 9BZCcac3+McErkkSN2YScA ($100 in chips)
9BZCcac3+McErkkSN2YScA: posts small blind $0.50
jPTRd6SpCp4xqAy2XQiTOw: posts big blind $1
*** HOLE CARDS ***
/zy+DB4S5fUQUSfZWFzYGw: raises $2 to $3
0eFnow7+D7veCYQ+CG9FFw: folds
5z1PAR8SNow/zUfYNbwq7A: raises $2 to $5
L9njYvloJ1NdXjP8edHEAg: folds
H+DVy3Ei8L1UKS2tVOtJcw: folds
9BZCcac3+McErkkSN2YScA: folds
jPTRd6SpCp4xqAy2XQiTOw: calls $4
/zy+DB4S5fUQUSfZWFzYGw: calls $2
*** FLOP *** [Qs 9h Td]
jPTRd6SpCp4xqAy2XQiTOw: checks
/zy+DB4S5fUQUSfZWFzYGw: checks
5z1PAR8SNow/zUfYNbwq7A: bets $5
jPTRd6SpCp4xqAy2XQiTOw: raises $13 to $18
/zy+DB4S5fUQUSfZWFzYGw: folds
5z1PAR8SNow/zUfYNbwq7A: calls $13
*** TURN *** [Qs 9h Td] [8s]
jPTRd6SpCp4xqAy2XQiTOw: bets $17.90 and is all-in
5z1PAR8SNow/zUfYNbwq7A: folds
jPTRd6SpCp4xqAy2XQiTOw collected $49 from pot
*** SUMMARY ***
Total pot $51.50 | Rake $2.50
Board [Qs 9h Td 8s]
Seat 1: jPTRd6SpCp4xqAy2XQiTOw (big blind) collected ($49)
Seat 2: /zy+DB4S5fUQUSfZWFzYGw folded on the Flop
Seat 3: 0eFnow7+D7veCYQ+CG9FFw folded before Flop (didn't bet)
Seat 4: 5z1PAR8SNow/zUfYNbwq7A folded on the Turn
Seat 5: L9njYvloJ1NdXjP8edHEAg folded before Flop (didn't bet)
Seat 6: H+DVy3Ei8L1UKS2tVOtJcw (button) folded before Flop (didn't bet)
Seat 8: 9BZCcac3+McErkkSN2YScA (small blind) folded before Flop



PokerStars Game #59941008502:  Hold'em No Limit ($0.50/$1.00) - 2009/07/01 1:23:01 ET
Table 'GPp0HyAuggN8oE0sUWzPpA' 9-max Seat #4 is the button
Seat 1: qJr25HAtvv1w/7IBvjMM3g ($48 in chips)
Seat 2: m3U8I35Pn3gxKhoS2nmYIg ($25.95 in chips)
Seat 3: CCCXsirC+bO7ginAuUUVlQ ($53.10 in chips)
Seat 4: mBRWbnUl8diyBO1qTJaNzw ($100.15 in chips)
Seat 5: bLbSOSmSOnqE0iTcH/5dxA ($100 in chips)
Seat 6: BK/GtNPkSx0TdUDj82id5A ($34.70 in chips)
Seat 7: DHdbHyysD15wCAtx+BhUjA ($96.70 in chips)
Seat 8: P/6qLjycEfxRgZ5F/W90dw ($96 in chips)
bLbSOSmSOnqE0iTcH/5dxA: posts small blind $0.50
BK/GtNPkSx0TdUDj82id5A: posts big blind $1
myIxN7otsyr846M539YR8Q: sits out
*** HOLE CARDS ***
DHdbHyysD15wCAtx+BhUjA: folds
P/6qLjycEfxRgZ5F/W90dw: raises $2 to $3
qJr25HAtvv1w/7IBvjMM3g: folds
m3U8I35Pn3gxKhoS2nmYIg: folds
CCCXsirC+bO7ginAuUUVlQ: folds
mBRWbnUl8diyBO1qTJaNzw: folds
bLbSOSmSOnqE0iTcH/5dxA: folds
BK/GtNPkSx0TdUDj82id5A: folds
P/6qLjycEfxRgZ5F/W90dw collected $2.50 from pot
*** SUMMARY ***
Total pot $2.50 | Rake $0
Seat 1: qJr25HAtvv1w/7IBvjMM3g folded before Flop (didn't bet)
Seat 2: m3U8I35Pn3gxKhoS2nmYIg folded before Flop (didn't bet)
Seat 3: CCCXsirC+bO7ginAuUUVlQ folded before Flop (didn't bet)
Seat 4: mBRWbnUl8diyBO1qTJaNzw (button) folded before Flop (didn't bet)
Seat 5: bLbSOSmSOnqE0iTcH/5dxA (small blind) folded before Flop
Seat 6: BK/GtNPkSx0TdUDj82id5A (big blind) folded before Flop
Seat 7: DHdbHyysD15wCAtx+BhUjA folded before Flop (didn't bet)
Seat 8: P/6qLjycEfxRgZ5F/W90dw collected ($2.50)



PokerStars Game #59941009856:  Hold'em No Limit ($0.50/$1.00) - 2009/07/01 1:23:03 ET
Table 'tJq9SfN1ywY0r03VBlWlwQ' 9-max Seat #1 is the button
Seat 1: wZsU+w9r7G66x93UuvBf1Q ($325.80 in chips)
Seat 3: FVs16t7GgfWgQWt4JxsObQ ($19.80 in chips)
Seat 4: bLbSOSmSOnqE0iTcH/5dxA ($115.15 in chips)
Seat 5: h5ipsNTMyolp7xn/NAvWkA ($119.65 in chips)
Seat 6: gUUvmqdVlmvpal6B8nYrmg ($100 in chips)
Seat 7: Pp/KTcXkfZKKUHkjyaLTdg ($18.50 in chips)
Seat 8: G4DEhsZFmznGNVpy2SEocA ($22.25 in chips)
VPF+HjszMvUIpy0CHIwH3A will be allowed to play after the button
FVs16t7GgfWgQWt4JxsObQ: posts small blind $0.50
bLbSOSmSOnqE0iTcH/5dxA: posts big blind $1
*** HOLE CARDS ***
h5ipsNTMyolp7xn/NAvWkA: raises $2 to $3
gUUvmqdVlmvpal6B8nYrmg: folds
Pp/KTcXkfZKKUHkjyaLTdg: folds
G4DEhsZFmznGNVpy2SEocA: folds
wZsU+w9r7G66x93UuvBf1Q: calls $3
FVs16t7GgfWgQWt4JxsObQ: folds
bLbSOSmSOnqE0iTcH/5dxA: folds
*** FLOP *** [Kh 2d Tc]
h5ipsNTMyolp7xn/NAvWkA: checks
wZsU+w9r7G66x93UuvBf1Q: checks
*** TURN *** [Kh 2d Tc] [Js]
h5ipsNTMyolp7xn/NAvWkA: bets $3
wZsU+w9r7G66x93UuvBf1Q: folds
h5ipsNTMyolp7xn/NAvWkA collected $7.15 from pot
*** SUMMARY ***
Total pot $7.50 | Rake $0.35
Board [Kh 2d Tc Js]
Seat 1: wZsU+w9r7G66x93UuvBf1Q (button) folded on the Turn
Seat 3: FVs16t7GgfWgQWt4JxsObQ (small blind) folded before Flop
Seat 4: bLbSOSmSOnqE0iTcH/5dxA (big blind) folded before Flop
Seat 5: h5ipsNTMyolp7xn/NAvWkA collected ($7.15)
Seat 6: gUUvmqdVlmvpal6B8nYrmg folded before Flop (didn't bet)
Seat 7: Pp/KTcXkfZKKUHkjyaLTdg folded before Flop (didn't bet)
Seat 8: G4DEhsZFmznGNVpy2SEocA folded before Flop (didn't bet)



PokerStars Game #59941010302:  Hold'em No Limit ($0.50/$1.00) - 2009/07/01 1:23:04 ET
Table 'TvsifD4n+q//fIZ4fM1xxQ' 2-max Seat #2 is the button
Seat 1: NYi6JFscYNrofSXy4sM+Yw ($101 in chips)
Seat 2: +W/hy0gBp0sJy8pjLz6Yrg ($64.55 in chips)
+W/hy0gBp0sJy8pjLz6Yrg: posts small blind $0.50
NYi6JFscYNrofSXy4sM+Yw: posts big blind $1
*** HOLE CARDS ***
+W/hy0gBp0sJy8pjLz6Yrg: calls $0.50
NYi6JFscYNrofSXy4sM+Yw: checks
*** FLOP *** [7d 4c 6s]
NYi6JFscYNrofSXy4sM+Yw: checks
+W/hy0gBp0sJy8pjLz6Yrg: bets $1
NYi6JFscYNrofSXy4sM+Yw: folds
+W/hy0gBp0sJy8pjLz6Yrg collected $1.90 from pot
*** SUMMARY ***
Total pot $2 | Rake $0.10
Board [7d 4c 6s]
Seat 1: NYi6JFscYNrofSXy4sM+Yw (big blind) folded on the Flop
Seat 2: +W/hy0gBp0sJy8pjLz6Yrg (button) (small blind) collected ($1.90)



PokerStars Game #59941010426:  Hold'em No Limit ($0.50/$1.00) - 2009/07/01 1:23:05 ET
Table 'vs/5jr6ciwjVQ5+Soc+u2A' 6-max Seat #4 is the button
Seat 1: J798qwLuvXyq0BbzsIjOrA ($155.90 in chips)
Seat 2: lXX4W7m3u++JiSOZ46yVMQ ($105.65 in chips)
Seat 3: G5ZSSN6RSON3gkNvk/SmYg ($138.10 in chips)
Seat 4: wk6Ohn4GDozoOMHc4eb2rw ($59.30 in chips)
Seat 5: +Nt3OPk3XR9SKjZgm2CexQ ($149.60 in chips)
Seat 6: Z2fXsGcjl+Eax+RzOgwOmg ($100 in chips)
+Nt3OPk3XR9SKjZgm2CexQ: posts small blind $0.50
Z2fXsGcjl+Eax+RzOgwOmg: posts big blind $1
*** HOLE CARDS ***
J798qwLuvXyq0BbzsIjOrA: calls $1
lXX4W7m3u++JiSOZ46yVMQ: folds
G5ZSSN6RSON3gkNvk/SmYg: folds
wk6Ohn4GDozoOMHc4eb2rw: folds
+Nt3OPk3XR9SKjZgm2CexQ: folds
Z2fXsGcjl+Eax+RzOgwOmg: raises $4 to $5
J798qwLuvXyq0BbzsIjOrA: calls $4
*** FLOP *** [5s 5d Ts]
Z2fXsGcjl+Eax+RzOgwOmg: bets $8
J798qwLuvXyq0BbzsIjOrA: folds
Z2fXsGcjl+Eax+RzOgwOmg collected $10 from pot
Z2fXsGcjl+Eax+RzOgwOmg: doesn't show hand
*** SUMMARY ***
Total pot $10.50 | Rake $0.50
Board [5s 5d Ts]
Seat 1: J798qwLuvXyq0BbzsIjOrA folded on the Flop
Seat 2: lXX4W7m3u++JiSOZ46yVMQ folded before Flop (didn't bet)
Seat 3: G5ZSSN6RSON3gkNvk/SmYg folded before Flop (didn't bet)
Seat 4: wk6Ohn4GDozoOMHc4eb2rw (button) folded before Flop (didn't bet)
Seat 5: +Nt3OPk3XR9SKjZgm2CexQ (small blind) folded before Flop
Seat 6: Z2fXsGcjl+Eax+RzOgwOmg (big blind) collected ($10)



PokerStars Game #59941012818:  Hold'em No Limit ($0.50/$1.00) - 2009/07/01 1:23:09 ET
Table 'iSx0wTgVb4o7MyZeOe06ZA' 9-max Seat #8 is the button
Seat 1: VPF+HjszMvUIpy0CHIwH3A ($17.50 in chips)
Seat 2: rFvc7K/96V9eGvYRfmpoUQ ($20 in chips)
Seat 3: /inIs/z/PcX+TniIFpaxpg ($17 in chips)
Seat 4: 0fXz44fzDo5QmhAaJCvFfA ($47.50 in chips)
Seat 5: 7rJvZYDzYT+lYOns8ZPL0w ($103.65 in chips)
Seat 6: Lik6kFnIxdZEESN5kBGZzA ($20 in chips)
Seat 7: w4NnqVr/Sfoj65ux/fEUyQ ($61.30 in chips)
Seat 8: gUUvmqdVlmvpal6B8nYrmg ($100 in chips)
Seat 9: mQADhUTC1xGjAJkD7PEg6A ($107.65 in chips)
mQADhUTC1xGjAJkD7PEg6A: posts small blind $0.50
VPF+HjszMvUIpy0CHIwH3A: posts big blind $1
*** HOLE CARDS ***
rFvc7K/96V9eGvYRfmpoUQ: folds
/inIs/z/PcX+TniIFpaxpg: folds
0fXz44fzDo5QmhAaJCvFfA: folds
7rJvZYDzYT+lYOns8ZPL0w: raises $2.50 to $3.50
Lik6kFnIxdZEESN5kBGZzA: folds
w4NnqVr/Sfoj65ux/fEUyQ: folds
gUUvmqdVlmvpal6B8nYrmg: folds
mQADhUTC1xGjAJkD7PEg6A: raises $5.50 to $9
VPF+HjszMvUIpy0CHIwH3A: folds
7rJvZYDzYT+lYOns8ZPL0w: calls $5.50
*** FLOP *** [Ad Jh 7s]
mQADhUTC1xGjAJkD7PEg6A: bets $11
7rJvZYDzYT+lYOns8ZPL0w: raises $19 to $30
mQADhUTC1xGjAJkD7PEg6A: folds
7rJvZYDzYT+lYOns8ZPL0w collected $39 from pot
*** SUMMARY ***
Total pot $41 | Rake $2
Board [Ad Jh 7s]
Seat 1: VPF+HjszMvUIpy0CHIwH3A (big blind) folded before Flop
Seat 2: rFvc7K/96V9eGvYRfmpoUQ folded before Flop (didn't bet)
Seat 3: /inIs/z/PcX+TniIFpaxpg folded before Flop (didn't bet)
Seat 4: 0fXz44fzDo5QmhAaJCvFfA folded before Flop (didn't bet)
Seat 5: 7rJvZYDzYT+lYOns8ZPL0w collected ($39)
Seat 6: Lik6kFnIxdZEESN5kBGZzA folded before Flop (didn't bet)
Seat 7: w4NnqVr/Sfoj65ux/fEUyQ folded before Flop (didn't bet)
Seat 8: gUUvmqdVlmvpal6B8nYrmg (button) folded before Flop (didn't bet)
Seat 9: mQADhUTC1xGjAJkD7PEg6A (small blind) folded on the Flop



PokerStars Game #59941013602:  Hold'em No Limit ($0.50/$1.00) - 2009/07/01 1:23:10 ET
Table 'mmbQQVBTrPdE+wy+s+9VPA' 6-max Seat #4 is the button
Seat 1: zyP4SPoWZnKUfTvIRLCVog ($62.35 in chips)
Seat 2: XK4Qsl+DA8gAJyg85/zBIw ($31.30 in chips)
Seat 3: wx3sQGkVi2x9wJXuWNHPBw ($127.35 in chips)
Seat 4: V3iZdcw61nXF3g5hD2RrsQ ($104.90 in chips)
Seat 5: YMJG+F++3Aj6P8dAWda5fw ($118.40 in chips)
Seat 6: U2CWBTv29qdCbj8RNF2sIw ($116.25 in chips)
YMJG+F++3Aj6P8dAWda5fw: posts small blind $0.50
U2CWBTv29qdCbj8RNF2sIw: posts big blind $1
*** HOLE CARDS ***
zyP4SPoWZnKUfTvIRLCVog: folds
XK4Qsl+DA8gAJyg85/zBIw: folds
wx3sQGkVi2x9wJXuWNHPBw: folds
V3iZdcw61nXF3g5hD2RrsQ: folds
YMJG+F++3Aj6P8dAWda5fw: folds
U2CWBTv29qdCbj8RNF2sIw collected $1 from pot
*** SUMMARY ***
Total pot $1 | Rake $0
Seat 1: zyP4SPoWZnKUfTvIRLCVog folded before Flop (didn't bet)
Seat 2: XK4Qsl+DA8gAJyg85/zBIw folded before Flop (didn't bet)
Seat 3: wx3sQGkVi2x9wJXuWNHPBw folded before Flop (didn't bet)
Seat 4: V3iZdcw61nXF3g5hD2RrsQ (button) folded before Flop (didn't bet)
Seat 5: YMJG+F++3Aj6P8dAWda5fw (small blind) folded before Flop
Seat 6: U2CWBTv29qdCbj8RNF2sIw (big blind) collected ($1)



PokerStars Game #59941017394:  Hold'em No Limit ($0.50/$1.00) - 2009/07/01 1:23:17 ET
Table 'TvsifD4n+q//fIZ4fM1xxQ' 2-max Seat #1 is the button
Seat 1: NYi6JFscYNrofSXy4sM+Yw ($100 in chips)
Seat 2: +W/hy0gBp0sJy8pjLz6Yrg ($65.45 in chips)
NYi6JFscYNrofSXy4sM+Yw: posts small blind $0.50
+W/hy0gBp0sJy8pjLz6Yrg: posts big blind $1
*** HOLE CARDS ***
NYi6JFscYNrofSXy4sM+Yw: raises $2 to $3
+W/hy0gBp0sJy8pjLz6Yrg: calls $2
*** FLOP *** [3d Kh 2c]
+W/hy0gBp0sJy8pjLz6Yrg: checks
NYi6JFscYNrofSXy4sM+Yw: bets $2
+W/hy0gBp0sJy8pjLz6Yrg: folds
NYi6JFscYNrofSXy4sM+Yw collected $5.70 from pot
*** SUMMARY ***
Total pot $6 | Rake $0.30
Board [3d Kh 2c]
Seat 1: NYi6JFscYNrofSXy4sM+Yw (button) (small blind) collected ($5.70)
Seat 2: +W/hy0gBp0sJy8pjLz6Yrg (big blind) folded on the Flop



PokerStars Game #59941018122:  Hold'em No Limit ($0.50/$1.00) - 2009/07/01 1:23:18 ET
Table 'MNvFfRVQNka/oY+Z5aMbZQ' 2-max Seat #1 is the button
Seat 1: DaZnoWHjO897dnh0CL2lVg ($62.50 in chips)
Seat 2: mgi+mjKb1Sc3CCs7TlfoCw ($60.15 in chips)
DaZnoWHjO897dnh0CL2lVg: posts small blind $0.50
mgi+mjKb1Sc3CCs7TlfoCw: posts big blind $1
*** HOLE CARDS ***
DaZnoWHjO897dnh0CL2lVg: folds
mgi+mjKb1Sc3CCs7TlfoCw collected $1 from pot
mgi+mjKb1Sc3CCs7TlfoCw: doesn't show hand
*** SUMMARY ***
Total pot $1 | Rake $0
Seat 1: DaZnoWHjO897dnh0CL2lVg (button) (small blind) folded before Flop
Seat 2: mgi+mjKb1Sc3CCs7TlfoCw (big blind) collected ($1)



PokerStars Game #59941019062:  Hold'em No Limit ($0.50/$1.00) - 2009/07/01 1:23:19 ET
Table 'QSIig7BLMc9wY/rgBechzw' 6-max Seat #2 is the button
Seat 1: Z2fXsGcjl+Eax+RzOgwOmg ($108 in chips)
Seat 2: mLOIkH/qmRa+mVujQIhBRg ($50.90 in chips)
Seat 3: +xW7QemQU0Fxs+4TnqBRow ($100 in chips)
Seat 4: +uSzP8Jwnw7sKfQ4s66b7w ($63.65 in chips)
Seat 5: lsLuWlcPA3Rh7kJVLzMh0Q ($103.45 in chips)
Seat 6: PxqfkAMdAWtkgbT+q2gciA ($45.85 in chips)
+xW7QemQU0Fxs+4TnqBRow: posts small blind $0.50
+uSzP8Jwnw7sKfQ4s66b7w: posts big blind $1
*** HOLE CARDS ***
lsLuWlcPA3Rh7kJVLzMh0Q: raises $3 to $4
PxqfkAMdAWtkgbT+q2gciA: folds
Z2fXsGcjl+Eax+RzOgwOmg: folds
mLOIkH/qmRa+mVujQIhBRg: folds
+xW7QemQU0Fxs+4TnqBRow: calls $3.50
+uSzP8Jwnw7sKfQ4s66b7w: folds
*** FLOP *** [Qc 7s 9h]
+xW7QemQU0Fxs+4TnqBRow: checks
lsLuWlcPA3Rh7kJVLzMh0Q: bets $6
+xW7QemQU0Fxs+4TnqBRow: calls $6
*** TURN *** [Qc 7s 9h] [3h]
+xW7QemQU0Fxs+4TnqBRow: checks
lsLuWlcPA3Rh7kJVLzMh0Q: checks
*** RIVER *** [Qc 7s 9h 3h] [Ad]
+xW7QemQU0Fxs+4TnqBRow: checks
lsLuWlcPA3Rh7kJVLzMh0Q: checks
*** SHOW DOWN ***
+xW7QemQU0Fxs+4TnqBRow: shows [Td Tc] (a pair of Tens)
lsLuWlcPA3Rh7kJVLzMh0Q: mucks hand
+xW7QemQU0Fxs+4TnqBRow collected $20 from pot
*** SUMMARY ***
Total pot $21 | Rake $1
Board [Qc 7s 9h 3h Ad]
Seat 1: Z2fXsGcjl+Eax+RzOgwOmg folded before Flop (didn't bet)
Seat 2: mLOIkH/qmRa+mVujQIhBRg (button) folded before Flop (didn't bet)
Seat 3: +xW7QemQU0Fxs+4TnqBRow (small blind) showed [Td Tc] and won ($20) with a pair of Tens
Seat 4: +uSzP8Jwnw7sKfQ4s66b7w (big blind) folded before Flop
Seat 5: lsLuWlcPA3Rh7kJVLzMh0Q mucked
Seat 6: PxqfkAMdAWtkgbT+q2gciA folded before Flop (didn't bet)



PokerStars Game #59941019746:  Hold'em No Limit ($0.50/$1.00) - 2009/07/01 1:23:20 ET
Table 'pHrhryH8jPNdQfY62f8v+g' 6-max Seat #5 is the button
Seat 1: 4d1rWhpu8DzLmzMbR3QKyA ($134.75 in chips)
Seat 2: JwCcjZl0bjJzG7hmE0dnTA ($101.50 in chips)
Seat 3: 8oS5O7iD/qnFXFXJrGIgNQ ($100 in chips)
Seat 4: 1f3beyIML24UqEMTbWy93g ($48.70 in chips)
Seat 5: r1/R7y0Ortgoz4lccgW8VA ($20.25 in chips)
Seat 6: xAU6q2/cwmby2sxmA8VcmA ($204.10 in chips)
xAU6q2/cwmby2sxmA8VcmA: posts small blind $0.50
4d1rWhpu8DzLmzMbR3QKyA: posts big blind $1
*** HOLE CARDS ***
JwCcjZl0bjJzG7hmE0dnTA: raises $2 to $3
8oS5O7iD/qnFXFXJrGIgNQ: folds
1f3beyIML24UqEMTbWy93g: folds
r1/R7y0Ortgoz4lccgW8VA: calls $3
xAU6q2/cwmby2sxmA8VcmA: folds
4d1rWhpu8DzLmzMbR3QKyA: folds
*** FLOP *** [Kd Ah 5s]
JwCcjZl0bjJzG7hmE0dnTA: bets $4
r1/R7y0Ortgoz4lccgW8VA: folds
JwCcjZl0bjJzG7hmE0dnTA collected $7.15 from pot
*** SUMMARY ***
Total pot $7.50 | Rake $0.35
Board [Kd Ah 5s]
Seat 1: 4d1rWhpu8DzLmzMbR3QKyA (big blind) folded before Flop
Seat 2: JwCcjZl0bjJzG7hmE0dnTA collected ($7.15)
Seat 3: 8oS5O7iD/qnFXFXJrGIgNQ folded before Flop (didn't bet)
Seat 4: 1f3beyIML24UqEMTbWy93g folded before Flop (didn't bet)
Seat 5: r1/R7y0Ortgoz4lccgW8VA (button) folded on the Flop
Seat 6: xAU6q2/cwmby2sxmA8VcmA (small blind) folded before Flop



PokerStars Game #59941019282:  Hold'em No Limit ($0.50/$1.00) - 2009/07/01 1:23:20 ET
Table 'Evb7VW0qfDhFkbgBL3gcqQ' 2-max Seat #2 is the button
Seat 1: NYi6JFscYNrofSXy4sM+Yw ($123.60 in chips)
Seat 2: AoEQlM/FNYM0d7Txn1TfBQ ($83 in chips)
AoEQlM/FNYM0d7Txn1TfBQ: posts small blind $0.50
NYi6JFscYNrofSXy4sM+Yw: posts big blind $1
*** HOLE CARDS ***
AoEQlM/FNYM0d7Txn1TfBQ: folds
NYi6JFscYNrofSXy4sM+Yw collected $1 from pot
*** SUMMARY ***
Total pot $1 | Rake $0
Seat 1: NYi6JFscYNrofSXy4sM+Yw (big blind) collected ($1)
Seat 2: AoEQlM/FNYM0d7Txn1TfBQ (button) (small blind) folded before Flop



PokerStars Game #59941021064:  Hold'em No Limit ($0.50/$1.00) - 2009/07/01 1:23:23 ET
Table 'W/wyObTiXZm+Ckkl3YxcSw' 6-max Seat #4 is the button
Seat 1: eUBBn2R56C1IQ6Cs/vitwg ($289.90 in chips)
Seat 2: oDiBRCaF0QVtd3kO6xZIXw ($152.05 in chips)
Seat 3: dxyNCn/qxfkGDUIf28Cbng ($66.30 in chips)
Seat 4: UBZQqpnJZdTYYY1FTb0rLA ($100 in chips)
Seat 5: +OrCjyw70oZhJiD22Mn+bg ($100 in chips)
Seat 6: b2a+5TkFf4xJN/Ihhma58Q ($47.55 in chips)
+OrCjyw70oZhJiD22Mn+bg: posts small blind $0.50
b2a+5TkFf4xJN/Ihhma58Q: posts big blind $1
*** HOLE CARDS ***
eUBBn2R56C1IQ6Cs/vitwg: folds
oDiBRCaF0QVtd3kO6xZIXw: folds
dxyNCn/qxfkGDUIf28Cbng: folds
UBZQqpnJZdTYYY1FTb0rLA: folds
+OrCjyw70oZhJiD22Mn+bg: folds
b2a+5TkFf4xJN/Ihhma58Q collected $1 from pot
*** SUMMARY ***
Total pot $1 | Rake $0
Seat 1: eUBBn2R56C1IQ6Cs/vitwg folded before Flop (didn't bet)
Seat 2: oDiBRCaF0QVtd3kO6xZIXw folded before Flop (didn't bet)
Seat 3: dxyNCn/qxfkGDUIf28Cbng folded before Flop (didn't bet)
Seat 4: UBZQqpnJZdTYYY1FTb0rLA (button) folded before Flop (didn't bet)
Seat 5: +OrCjyw70oZhJiD22Mn+bg (small blind) folded before Flop
Seat 6: b2a+5TkFf4xJN/Ihhma58Q (big blind) collected ($1)



PokerStars Game #59941021652:  Hold'em No Limit ($0.50/$1.00) - 2009/07/01 1:23:24 ET
Table 'MNvFfRVQNka/oY+Z5aMbZQ' 2-max Seat #2 is the button
Seat 1: DaZnoWHjO897dnh0CL2lVg ($62 in chips)
Seat 2: mgi+mjKb1Sc3CCs7TlfoCw ($60.65 in chips)
mgi+mjKb1Sc3CCs7TlfoCw: posts small blind $0.50
DaZnoWHjO897dnh0CL2lVg: posts big blind $1
*** HOLE CARDS ***
mgi+mjKb1Sc3CCs7TlfoCw: raises $2 to $3
DaZnoWHjO897dnh0CL2lVg: calls $2
*** FLOP *** [7s Qc Ad]
DaZnoWHjO897dnh0CL2lVg: checks
mgi+mjKb1Sc3CCs7TlfoCw: checks
*** TURN *** [7s Qc Ad] [7h]
DaZnoWHjO897dnh0CL2lVg: checks
mgi+mjKb1Sc3CCs7TlfoCw: checks
*** RIVER *** [7s Qc Ad 7h] [Qd]
DaZnoWHjO897dnh0CL2lVg: bets $3
mgi+mjKb1Sc3CCs7TlfoCw: folds
DaZnoWHjO897dnh0CL2lVg collected $5.70 from pot
DaZnoWHjO897dnh0CL2lVg: doesn't show hand
*** SUMMARY ***
Total pot $6 | Rake $0.30
Board [7s Qc Ad 7h Qd]
Seat 1: DaZnoWHjO897dnh0CL2lVg (big blind) collected ($5.70)
Seat 2: mgi+mjKb1Sc3CCs7TlfoCw (button) (small blind) folded on the River



PokerStars Game #59941022912:  Hold'em No Limit ($0.50/$1.00) - 2009/07/01 1:23:26 ET
Table 'Evb7VW0qfDhFkbgBL3gcqQ' 2-max Seat #1 is the button
Seat 1: NYi6JFscYNrofSXy4sM+Yw ($124.10 in chips)
Seat 2: AoEQlM/FNYM0d7Txn1TfBQ ($82.50 in chips)
NYi6JFscYNrofSXy4sM+Yw: posts small blind $0.50
AoEQlM/FNYM0d7Txn1TfBQ: posts big blind $1
*** HOLE CARDS ***
NYi6JFscYNrofSXy4sM+Yw: raises $2 to $3
AoEQlM/FNYM0d7Txn1TfBQ: raises $9 to $12
NYi6JFscYNrofSXy4sM+Yw: folds
AoEQlM/FNYM0d7Txn1TfBQ collected $6 from pot
AoEQlM/FNYM0d7Txn1TfBQ: doesn't show hand
*** SUMMARY ***
Total pot $6 | Rake $0
Seat 1: NYi6JFscYNrofSXy4sM+Yw (button) (small blind) folded before Flop
Seat 2: AoEQlM/FNYM0d7Txn1TfBQ (big blind) collected ($6)



PokerStars Game #59941023068:  Hold'em No Limit ($0.50/$1.00) - 2009/07/01 1:23:26 ET
Table 'hugOjcwJvzEwZbK7tyiWuQ' 9-max Seat #8 is the button
Seat 1: S3Ex8K7v6xm5jqjRM7Fl3w ($22 in chips)
Seat 2: r27C1nIV4NS4+qbnrgBQSw ($273.70 in chips)
Seat 4: UWB3oeddt/GObx2Mix2Anw ($187.60 in chips)
Seat 6: gUUvmqdVlmvpal6B8nYrmg ($110.95 in chips)
Seat 7: FL3MrLspcF23LYvC4ipBOA ($117.30 in chips)
Seat 8: /zy+DB4S5fUQUSfZWFzYGw ($115.75 in chips)
Seat 9: W8P9bUKCs43TO1xHm0dL6w ($105.95 in chips)
W8P9bUKCs43TO1xHm0dL6w: posts small blind $0.50
S3Ex8K7v6xm5jqjRM7Fl3w: posts big blind $1
*** HOLE CARDS ***
r27C1nIV4NS4+qbnrgBQSw: folds
UWB3oeddt/GObx2Mix2Anw: folds
gUUvmqdVlmvpal6B8nYrmg: raises $2 to $3
FL3MrLspcF23LYvC4ipBOA: folds
/zy+DB4S5fUQUSfZWFzYGw: folds
W8P9bUKCs43TO1xHm0dL6w: calls $2.50
S3Ex8K7v6xm5jqjRM7Fl3w: calls $2
*** FLOP *** [2c 4h 9c]
W8P9bUKCs43TO1xHm0dL6w: bets $4
S3Ex8K7v6xm5jqjRM7Fl3w: folds
gUUvmqdVlmvpal6B8nYrmg: folds
W8P9bUKCs43TO1xHm0dL6w collected $8.55 from pot
*** SUMMARY ***
Total pot $9 | Rake $0.45
Board [2c 4h 9c]
Seat 1: S3Ex8K7v6xm5jqjRM7Fl3w (big blind) folded on the Flop
Seat 2: r27C1nIV4NS4+qbnrgBQSw folded before Flop (didn't bet)
Seat 4: UWB3oeddt/GObx2Mix2Anw folded before Flop (didn't bet)
Seat 6: gUUvmqdVlmvpal6B8nYrmg folded on the Flop
Seat 7: FL3MrLspcF23LYvC4ipBOA folded before Flop (didn't bet)
Seat 8: /zy+DB4S5fUQUSfZWFzYGw (button) folded before Flop (didn't bet)
Seat 9: W8P9bUKCs43TO1xHm0dL6w (small blind) collected ($8.55)



PokerStars Game #59941026028:  Hold'em No Limit ($0.50/$1.00) - 2009/07/01 1:23:31 ET
Table 'fZjVbKj9D8yOB+Rj7NaP/A' 9-max Seat #8 is the button
Seat 1: 9BZCcac3+McErkkSN2YScA ($100 in chips)
Seat 2: PTAFYDIUSsG+SArbxNl+Aw ($105.50 in chips)
Seat 3: yAbu2QsRPVcjPbqlf/jDxw ($101 in chips)
Seat 4: 997ViqAtWn1FPjJqcffwcA ($101 in chips)
Seat 5: PkGfq5xrSlNsujKaG/HF4Q ($100 in chips)
Seat 6: OvwYHV65yUbgdBjSmo1+5g ($36.95 in chips)
Seat 7: SyS20PAm3RpT6uLBsGkwOA ($120.05 in chips)
Seat 8: zDOE5r14tWqCf6xhuSHK6g ($52.90 in chips)
Seat 9: qheQay5YvP2DMAb3OUSxtw ($99 in chips)
qheQay5YvP2DMAb3OUSxtw: posts small blind $0.50
9BZCcac3+McErkkSN2YScA: posts big blind $1
*** HOLE CARDS ***
PTAFYDIUSsG+SArbxNl+Aw: folds
yAbu2QsRPVcjPbqlf/jDxw: folds
997ViqAtWn1FPjJqcffwcA: folds
PkGfq5xrSlNsujKaG/HF4Q: folds
OvwYHV65yUbgdBjSmo1+5g: folds
SyS20PAm3RpT6uLBsGkwOA: folds
zDOE5r14tWqCf6xhuSHK6g: folds
qheQay5YvP2DMAb3OUSxtw: calls $0.50
9BZCcac3+McErkkSN2YScA: checks
*** FLOP *** [7s 2c 2s]
qheQay5YvP2DMAb3OUSxtw: checks
9BZCcac3+McErkkSN2YScA: bets $2
qheQay5YvP2DMAb3OUSxtw: calls $2
*** TURN *** [7s 2c 2s] [9c]
qheQay5YvP2DMAb3OUSxtw: checks
9BZCcac3+McErkkSN2YScA: bets $5
qheQay5YvP2DMAb3OUSxtw: folds
9BZCcac3+McErkkSN2YScA collected $5.75 from pot
9BZCcac3+McErkkSN2YScA: doesn't show hand
*** SUMMARY ***
Total pot $6 | Rake $0.25
Board [7s 2c 2s 9c]
Seat 1: 9BZCcac3+McErkkSN2YScA (big blind) collected ($5.75)
Seat 2: PTAFYDIUSsG+SArbxNl+Aw folded before Flop (didn't bet)
Seat 3: yAbu2QsRPVcjPbqlf/jDxw folded before Flop (didn't bet)
Seat 4: 997ViqAtWn1FPjJqcffwcA folded before Flop (didn't bet)
Seat 5: PkGfq5xrSlNsujKaG/HF4Q folded before Flop (didn't bet)
Seat 6: OvwYHV65yUbgdBjSmo1+5g folded before Flop (didn't bet)
Seat 7: SyS20PAm3RpT6uLBsGkwOA folded before Flop (didn't bet)
Seat 8: zDOE5r14tWqCf6xhuSHK6g (button) folded before Flop (didn't bet)
Seat 9: qheQay5YvP2DMAb3OUSxtw (small blind) folded on the Turn



PokerStars Game #59941025966:  Hold'em No Limit ($0.50/$1.00) - 2009/07/01 1:23:31 ET
Table 'TvsifD4n+q//fIZ4fM1xxQ' 2-max Seat #2 is the button
Seat 1: NYi6JFscYNrofSXy4sM+Yw ($102.70 in chips)
Seat 2: +W/hy0gBp0sJy8pjLz6Yrg ($62.45 in chips)
+W/hy0gBp0sJy8pjLz6Yrg: posts small blind $0.50
NYi6JFscYNrofSXy4sM+Yw: posts big blind $1
*** HOLE CARDS ***
+W/hy0gBp0sJy8pjLz6Yrg: raises $2 to $3
NYi6JFscYNrofSXy4sM+Yw: calls $2
*** FLOP *** [7c 3c Qc]
NYi6JFscYNrofSXy4sM+Yw: checks
+W/hy0gBp0sJy8pjLz6Yrg: checks
*** TURN *** [7c 3c Qc] [4s]
NYi6JFscYNrofSXy4sM+Yw: checks
+W/hy0gBp0sJy8pjLz6Yrg: bets $4
NYi6JFscYNrofSXy4sM+Yw: calls $4
*** RIVER *** [7c 3c Qc 4s] [Js]
NYi6JFscYNrofSXy4sM+Yw: checks
+W/hy0gBp0sJy8pjLz6Yrg: bets $5
NYi6JFscYNrofSXy4sM+Yw: calls $5
*** SHOW DOWN ***
+W/hy0gBp0sJy8pjLz6Yrg: shows [6h 5h] (a straight, Three to Seven)
NYi6JFscYNrofSXy4sM+Yw: mucks hand
+W/hy0gBp0sJy8pjLz6Yrg collected $23.50 from pot
*** SUMMARY ***
Total pot $24 | Rake $0.50
Board [7c 3c Qc 4s Js]
Seat 1: NYi6JFscYNrofSXy4sM+Yw (big blind) mucked
Seat 2: +W/hy0gBp0sJy8pjLz6Yrg (button) (small blind) showed [6h 5h] and won ($23.50) with a straight, Three to Seven



PokerStars Game #59941026456:  Hold'em No Limit ($0.50/$1.00) - 2009/07/01 1:23:32 ET
Table 'kS0cTQAEi+fdUlJP2gQYvw' 9-max Seat #8 is the button
Seat 1: /mfensKw8/iZ1Vrx33S4xg ($20 in chips)
Seat 2: D+W9Me7w6Hcx/WRUSKV0dw ($26.55 in chips)
Seat 3: 2BV+oJIQYr65IO6nEChvbA ($60 in chips)
Seat 4: RUhhaALzha3TH1AkdakoGQ ($55 in chips)
Seat 5: 997ViqAtWn1FPjJqcffwcA ($100 in chips)
Seat 6: yAbu2QsRPVcjPbqlf/jDxw ($124.65 in chips)
Seat 7: Ffa7Nj4X5fddtROP01hfQg ($154.60 in chips)
Seat 8: vKyFzTyzfT7fZcdX+HHN+Q ($31.65 in chips)
Seat 9: OGgaARGdJQT4awWVNQ957w ($100 in chips)
OGgaARGdJQT4awWVNQ957w: posts small blind $0.50
/mfensKw8/iZ1Vrx33S4xg: posts big blind $1
*** HOLE CARDS ***
D+W9Me7w6Hcx/WRUSKV0dw: folds
2BV+oJIQYr65IO6nEChvbA: folds
RUhhaALzha3TH1AkdakoGQ: folds
997ViqAtWn1FPjJqcffwcA: folds
yAbu2QsRPVcjPbqlf/jDxw: raises $3 to $4
Ffa7Nj4X5fddtROP01hfQg: folds
vKyFzTyzfT7fZcdX+HHN+Q: folds
OGgaARGdJQT4awWVNQ957w: folds
/mfensKw8/iZ1Vrx33S4xg: folds
yAbu2QsRPVcjPbqlf/jDxw collected $2.50 from pot
yAbu2QsRPVcjPbqlf/jDxw: doesn't show hand
*** SUMMARY ***
Total pot $2.50 | Rake $0
Seat 1: /mfensKw8/iZ1Vrx33S4xg (big blind) folded before Flop
Seat 2: D+W9Me7w6Hcx/WRUSKV0dw folded before Flop (didn't bet)
Seat 3: 2BV+oJIQYr65IO6nEChvbA folded before Flop (didn't bet)
Seat 4: RUhhaALzha3TH1AkdakoGQ folded before Flop (didn't bet)
Seat 5: 997ViqAtWn1FPjJqcffwcA folded before Flop (didn't bet)
Seat 6: yAbu2QsRPVcjPbqlf/jDxw collected ($2.50)
Seat 7: Ffa7Nj4X5fddtROP01hfQg folded before Flop (didn't bet)
Seat 8: vKyFzTyzfT7fZcdX+HHN+Q (button) folded before Flop (didn't bet)
Seat 9: OGgaARGdJQT4awWVNQ957w (small blind) folded before Flop



PokerStars Game #59941027652:  Hold'em No Limit ($0.50/$1.00) - 2009/07/01 1:23:34 ET
Table 'mmbQQVBTrPdE+wy+s+9VPA' 6-max Seat #5 is the button
Seat 1: zyP4SPoWZnKUfTvIRLCVog ($62.35 in chips)
Seat 2: XK4Qsl+DA8gAJyg85/zBIw ($31.30 in chips)
Seat 3: wx3sQGkVi2x9wJXuWNHPBw ($127.35 in chips)
Seat 4: V3iZdcw61nXF3g5hD2RrsQ ($104.90 in chips)
Seat 5: YMJG+F++3Aj6P8dAWda5fw ($117.90 in chips)
Seat 6: U2CWBTv29qdCbj8RNF2sIw ($116.75 in chips)
U2CWBTv29qdCbj8RNF2sIw: posts small blind $0.50
zyP4SPoWZnKUfTvIRLCVog: posts big blind $1
*** HOLE CARDS ***
XK4Qsl+DA8gAJyg85/zBIw: folds
wx3sQGkVi2x9wJXuWNHPBw: folds
V3iZdcw61nXF3g5hD2RrsQ: folds
YMJG+F++3Aj6P8dAWda5fw: folds
U2CWBTv29qdCbj8RNF2sIw: folds
zyP4SPoWZnKUfTvIRLCVog collected $1 from pot
*** SUMMARY ***
Total pot $1 | Rake $0
Seat 1: zyP4SPoWZnKUfTvIRLCVog (big blind) collected ($1)
Seat 2: XK4Qsl+DA8gAJyg85/zBIw folded before Flop (didn't bet)
Seat 3: wx3sQGkVi2x9wJXuWNHPBw folded before Flop (didn't bet)
Seat 4: V3iZdcw61nXF3g5hD2RrsQ folded before Flop (didn't bet)
Seat 5: YMJG+F++3Aj6P8dAWda5fw (button) folded before Flop (didn't bet)
Seat 6: U2CWBTv29qdCbj8RNF2sIw (small blind) folded before Flop



PokerStars Game #59941029206:  Hold'em No Limit ($0.50/$1.00) - 2009/07/01 1:23:37 ET
Table '+cA8mcmhaedZ7YcrDdhmeQ' 6-max Seat #5 is the button
Seat 1: iIgNoBh+3/Ix1/fLsg+HuA ($35 in chips)
Seat 2: 14aYclSc98EYd6TrzN2l3Q ($19.85 in chips)
Seat 3: DAIgyIWbYvAkL6PbAI27pg ($3.15 in chips)
Seat 4: 4OO5v3AVduL0tePNx8wk5A ($100.05 in chips)
Seat 5: n5xXfJeDtWZSChGAdq//Tw ($18.55 in chips)
Seat 6: YfsTQsY/fxb+YqbdclTHuw ($27.75 in chips)
YfsTQsY/fxb+YqbdclTHuw: posts small blind $0.50
iIgNoBh+3/Ix1/fLsg+HuA: posts big blind $1
*** HOLE CARDS ***
14aYclSc98EYd6TrzN2l3Q: folds
DAIgyIWbYvAkL6PbAI27pg: raises $2.15 to $3.15 and is all-in
4OO5v3AVduL0tePNx8wk5A: folds
n5xXfJeDtWZSChGAdq//Tw: folds
YfsTQsY/fxb+YqbdclTHuw: folds
iIgNoBh+3/Ix1/fLsg+HuA: calls $2.15
*** FLOP *** [Qd 3c 3h]
*** TURN *** [Qd 3c 3h] [8h]
*** RIVER *** [Qd 3c 3h 8h] [4s]
*** SHOW DOWN ***
iIgNoBh+3/Ix1/fLsg+HuA: shows [2s Kh] (a pair of Threes)
DAIgyIWbYvAkL6PbAI27pg: shows [Th Ts] (two pair, Tens and Threes)
DAIgyIWbYvAkL6PbAI27pg collected $6.50 from pot
*** SUMMARY ***
Total pot $6.80 | Rake $0.30
Board [Qd 3c 3h 8h 4s]
Seat 1: iIgNoBh+3/Ix1/fLsg+HuA (big blind) showed [2s Kh] and lost with a pair of Threes
Seat 2: 14aYclSc98EYd6TrzN2l3Q folded before Flop (didn't bet)
Seat 3: DAIgyIWbYvAkL6PbAI27pg showed [Th Ts] and won ($6.50) with two pair, Tens and Threes
Seat 4: 4OO5v3AVduL0tePNx8wk5A folded before Flop (didn't bet)
Seat 5: n5xXfJeDtWZSChGAdq//Tw (button) folded before Flop (didn't bet)
Seat 6: YfsTQsY/fxb+YqbdclTHuw (small blind) folded before Flop



PokerStars Game #59941030052:  Hold'em No Limit ($0.50/$1.00) - 2009/07/01 1:23:38 ET
Table 'vs/5jr6ciwjVQ5+Soc+u2A' 6-max Seat #5 is the button
Seat 1: J798qwLuvXyq0BbzsIjOrA ($150.90 in chips)
Seat 2: lXX4W7m3u++JiSOZ46yVMQ ($105.65 in chips)
Seat 3: G5ZSSN6RSON3gkNvk/SmYg ($138.10 in chips)
Seat 4: wk6Ohn4GDozoOMHc4eb2rw ($59.30 in chips)
Seat 5: +Nt3OPk3XR9SKjZgm2CexQ ($149.10 in chips)
Seat 6: Z2fXsGcjl+Eax+RzOgwOmg ($105 in chips)
Z2fXsGcjl+Eax+RzOgwOmg: posts small blind $0.50
J798qwLuvXyq0BbzsIjOrA: posts big blind $1
*** HOLE CARDS ***
lXX4W7m3u++JiSOZ46yVMQ: folds
G5ZSSN6RSON3gkNvk/SmYg: raises $3 to $4
wk6Ohn4GDozoOMHc4eb2rw: folds
+Nt3OPk3XR9SKjZgm2CexQ: folds
Z2fXsGcjl+Eax+RzOgwOmg: folds
J798qwLuvXyq0BbzsIjOrA: folds
G5ZSSN6RSON3gkNvk/SmYg collected $2.50 from pot
G5ZSSN6RSON3gkNvk/SmYg: doesn't show hand
*** SUMMARY ***
Total pot $2.50 | Rake $0
Seat 1: J798qwLuvXyq0BbzsIjOrA (big blind) folded before Flop
Seat 2: lXX4W7m3u++JiSOZ46yVMQ folded before Flop (didn't bet)
Seat 3: G5ZSSN6RSON3gkNvk/SmYg collected ($2.50)
Seat 4: wk6Ohn4GDozoOMHc4eb2rw folded before Flop (didn't bet)
Seat 5: +Nt3OPk3XR9SKjZgm2CexQ (button) folded before Flop (didn't bet)
Seat 6: Z2fXsGcjl+Eax+RzOgwOmg (small blind) folded before Flop



PokerStars Game #59941029970:  Hold'em No Limit ($0.50/$1.00) - 2009/07/01 1:23:38 ET
Table 'GPp0HyAuggN8oE0sUWzPpA' 9-max Seat #5 is the button
Seat 1: qJr25HAtvv1w/7IBvjMM3g ($48 in chips)
Seat 2: m3U8I35Pn3gxKhoS2nmYIg ($25.95 in chips)
Seat 3: CCCXsirC+bO7ginAuUUVlQ ($53.10 in chips)
Seat 4: mBRWbnUl8diyBO1qTJaNzw ($100.15 in chips)
Seat 5: bLbSOSmSOnqE0iTcH/5dxA ($100 in chips)
Seat 6: BK/GtNPkSx0TdUDj82id5A ($33.70 in chips)
Seat 7: DHdbHyysD15wCAtx+BhUjA ($96.70 in chips)
Seat 8: P/6qLjycEfxRgZ5F/W90dw ($97.50 in chips)
BK/GtNPkSx0TdUDj82id5A: posts small blind $0.50
DHdbHyysD15wCAtx+BhUjA: posts big blind $1
myIxN7otsyr846M539YR8Q: sits out
*** HOLE CARDS ***
P/6qLjycEfxRgZ5F/W90dw: folds
qJr25HAtvv1w/7IBvjMM3g: calls $1
m3U8I35Pn3gxKhoS2nmYIg: folds
CCCXsirC+bO7ginAuUUVlQ: folds
mBRWbnUl8diyBO1qTJaNzw: folds
bLbSOSmSOnqE0iTcH/5dxA: folds
BK/GtNPkSx0TdUDj82id5A: calls $0.50
DHdbHyysD15wCAtx+BhUjA: checks
*** FLOP *** [7c 3s 8s]
BK/GtNPkSx0TdUDj82id5A: checks
DHdbHyysD15wCAtx+BhUjA: bets $2
qJr25HAtvv1w/7IBvjMM3g: folds
BK/GtNPkSx0TdUDj82id5A: calls $2
*** TURN *** [7c 3s 8s] [Kh]
BK/GtNPkSx0TdUDj82id5A: checks
DHdbHyysD15wCAtx+BhUjA: checks
*** RIVER *** [7c 3s 8s Kh] [Jc]
BK/GtNPkSx0TdUDj82id5A: bets $6
DHdbHyysD15wCAtx+BhUjA: folds
BK/GtNPkSx0TdUDj82id5A collected $6.70 from pot
*** SUMMARY ***
Total pot $7 | Rake $0.30
Board [7c 3s 8s Kh Jc]
Seat 1: qJr25HAtvv1w/7IBvjMM3g folded on the Flop
Seat 2: m3U8I35Pn3gxKhoS2nmYIg folded before Flop (didn't bet)
Seat 3: CCCXsirC+bO7ginAuUUVlQ folded before Flop (didn't bet)
Seat 4: mBRWbnUl8diyBO1qTJaNzw folded before Flop (didn't bet)
Seat 5: bLbSOSmSOnqE0iTcH/5dxA (button) folded before Flop (didn't bet)
Seat 6: BK/GtNPkSx0TdUDj82id5A (small blind) collected ($6.70)
Seat 7: DHdbHyysD15wCAtx+BhUjA (big blind) folded on the River
Seat 8: P/6qLjycEfxRgZ5F/W90dw folded before Flop (didn't bet)



PokerStars Game #59941030742:  Hold'em No Limit ($0.50/$1.00) - 2009/07/01 1:23:39 ET
Table 'fTlPiCj0utgzC/5io+I7ew' 6-max Seat #4 is the button
Seat 1: YMJG+F++3Aj6P8dAWda5fw ($95.05 in chips)
Seat 3: Z2fXsGcjl+Eax+RzOgwOmg ($135.90 in chips)
Seat 4: uJVSceLggtsrJya+WtmUEA ($170.15 in chips)
Seat 5: XUk5GQsfNFpHvaToDZ0rZA ($46.15 in chips)
Seat 6: y27w5IK2WXqmYzS8OU0wKA ($100 in chips)
XUk5GQsfNFpHvaToDZ0rZA: posts small blind $0.50
y27w5IK2WXqmYzS8OU0wKA: posts big blind $1
*** HOLE CARDS ***
YMJG+F++3Aj6P8dAWda5fw: folds
Z2fXsGcjl+Eax+RzOgwOmg: folds
uJVSceLggtsrJya+WtmUEA: folds
qVr1nl3dy2xXPqS8UpTDlA joins the table at seat #2
XUk5GQsfNFpHvaToDZ0rZA: folds
y27w5IK2WXqmYzS8OU0wKA collected $1 from pot
*** SUMMARY ***
Total pot $1 | Rake $0
Seat 1: YMJG+F++3Aj6P8dAWda5fw folded before Flop (didn't bet)
Seat 3: Z2fXsGcjl+Eax+RzOgwOmg folded before Flop (didn't bet)
Seat 4: uJVSceLggtsrJya+WtmUEA (button) folded before Flop (didn't bet)
Seat 5: XUk5GQsfNFpHvaToDZ0rZA (small blind) folded before Flop
Seat 6: y27w5IK2WXqmYzS8OU0wKA (big blind) collected ($1)



PokerStars Game #59941030672:  Hold'em No Limit ($0.50/$1.00) - 2009/07/01 1:23:39 ET
Table 'W/wyObTiXZm+Ckkl3YxcSw' 6-max Seat #5 is the button
Seat 1: eUBBn2R56C1IQ6Cs/vitwg ($289.90 in chips)
Seat 2: oDiBRCaF0QVtd3kO6xZIXw ($152.05 in chips)
Seat 3: dxyNCn/qxfkGDUIf28Cbng ($66.30 in chips)
Seat 4: UBZQqpnJZdTYYY1FTb0rLA ($100 in chips)
Seat 5: +OrCjyw70oZhJiD22Mn+bg ($100 in chips)
Seat 6: b2a+5TkFf4xJN/Ihhma58Q ($48.05 in chips)
b2a+5TkFf4xJN/Ihhma58Q: posts small blind $0.50
eUBBn2R56C1IQ6Cs/vitwg: posts big blind $1
*** HOLE CARDS ***
oDiBRCaF0QVtd3kO6xZIXw: folds
dxyNCn/qxfkGDUIf28Cbng: folds
UBZQqpnJZdTYYY1FTb0rLA: folds
+OrCjyw70oZhJiD22Mn+bg: folds
b2a+5TkFf4xJN/Ihhma58Q: calls $0.50
eUBBn2R56C1IQ6Cs/vitwg: checks
*** FLOP *** [As 5s Qh]
b2a+5TkFf4xJN/Ihhma58Q: checks
eUBBn2R56C1IQ6Cs/vitwg: checks
*** TURN *** [As 5s Qh] [Ts]
b2a+5TkFf4xJN/Ihhma58Q: checks
eUBBn2R56C1IQ6Cs/vitwg: checks
*** RIVER *** [As 5s Qh Ts] [Qd]
b2a+5TkFf4xJN/Ihhma58Q: checks
eUBBn2R56C1IQ6Cs/vitwg: checks
*** SHOW DOWN ***
b2a+5TkFf4xJN/Ihhma58Q: shows [9d Jc] (a pair of Queens)
eUBBn2R56C1IQ6Cs/vitwg: mucks hand
b2a+5TkFf4xJN/Ihhma58Q collected $1.90 from pot
*** SUMMARY ***
Total pot $2 | Rake $0.10
Board [As 5s Qh Ts Qd]
Seat 1: eUBBn2R56C1IQ6Cs/vitwg (big blind) mucked
Seat 2: oDiBRCaF0QVtd3kO6xZIXw folded before Flop (didn't bet)
Seat 3: dxyNCn/qxfkGDUIf28Cbng folded before Flop (didn't bet)
Seat 4: UBZQqpnJZdTYYY1FTb0rLA folded before Flop (didn't bet)
Seat 5: +OrCjyw70oZhJiD22Mn+bg (button) folded before Flop (didn't bet)
Seat 6: b2a+5TkFf4xJN/Ihhma58Q (small blind) showed [9d Jc] and won ($1.90) with a pair of Queens



PokerStars Game #59941030648:  Hold'em No Limit ($0.50/$1.00) - 2009/07/01 1:23:39 ET
Table 'O96CPOtvMBWP6kzuYDfdFA' 6-max Seat #1 is the button
Seat 1: 6alLXQIITA2EZ/lBeym8Dw ($122.75 in chips)
Seat 2: 4d1rWhpu8DzLmzMbR3QKyA ($116.60 in chips)
Seat 3: V89DGjxE171oPREEbAXiyg ($93.15 in chips)
Seat 4: /P4w1pHg2zHYg/4ubJ0dPw ($63.65 in chips)
Seat 5: G5ZSSN6RSON3gkNvk/SmYg ($100 in chips)
Seat 6: GYei5jXGWexiJYbAT2fELg ($26.65 in chips)
4d1rWhpu8DzLmzMbR3QKyA: posts small blind $0.50
V89DGjxE171oPREEbAXiyg: posts big blind $1
*** HOLE CARDS ***
/P4w1pHg2zHYg/4ubJ0dPw: folds
G5ZSSN6RSON3gkNvk/SmYg: folds
GYei5jXGWexiJYbAT2fELg: calls $1
6alLXQIITA2EZ/lBeym8Dw: folds
4d1rWhpu8DzLmzMbR3QKyA: folds
V89DGjxE171oPREEbAXiyg: checks
*** FLOP *** [Qc Ah 7c]
V89DGjxE171oPREEbAXiyg: checks
GYei5jXGWexiJYbAT2fELg: checks
*** TURN *** [Qc Ah 7c] [2h]
V89DGjxE171oPREEbAXiyg: checks
GYei5jXGWexiJYbAT2fELg: bets $3
V89DGjxE171oPREEbAXiyg: folds
GYei5jXGWexiJYbAT2fELg collected $2.40 from pot
*** SUMMARY ***
Total pot $2.50 | Rake $0.10
Board [Qc Ah 7c 2h]
Seat 1: 6alLXQIITA2EZ/lBeym8Dw (button) folded before Flop (didn't bet)
Seat 2: 4d1rWhpu8DzLmzMbR3QKyA (small blind) folded before Flop
Seat 3: V89DGjxE171oPREEbAXiyg (big blind) folded on the Turn
Seat 4: /P4w1pHg2zHYg/4ubJ0dPw folded before Flop (didn't bet)
Seat 5: G5ZSSN6RSON3gkNvk/SmYg folded before Flop (didn't bet)
Seat 6: GYei5jXGWexiJYbAT2fELg collected ($2.40)



PokerStars Game #59941030536:  Hold'em No Limit ($0.50/$1.00) - 2009/07/01 1:23:39 ET
Table 'MUPc8FEpe/nR0BKSeReX6Q' 6-max Seat #3 is the button
Seat 1: qhkK6+yCciTRd+rCFEbnEQ ($83.20 in chips)
Seat 2: xAU6q2/cwmby2sxmA8VcmA ($111.70 in chips)
Seat 3: wx3sQGkVi2x9wJXuWNHPBw ($287.50 in chips)
Seat 4: ZA1bp6g8IwtTxkUE4eCjDQ ($57.25 in chips)
Seat 5: y27w5IK2WXqmYzS8OU0wKA ($100 in chips)
Seat 6: oxnw0GLLpFanjhGkxfRSqA ($76.40 in chips)
ZA1bp6g8IwtTxkUE4eCjDQ: posts small blind $0.50
y27w5IK2WXqmYzS8OU0wKA: posts big blind $1
*** HOLE CARDS ***
oxnw0GLLpFanjhGkxfRSqA said, "opps"
oxnw0GLLpFanjhGkxfRSqA: folds
qhkK6+yCciTRd+rCFEbnEQ: folds
xAU6q2/cwmby2sxmA8VcmA: folds
wx3sQGkVi2x9wJXuWNHPBw: folds
oxnw0GLLpFanjhGkxfRSqA said, "where did all your chips go"
ZA1bp6g8IwtTxkUE4eCjDQ: calls $0.50
y27w5IK2WXqmYzS8OU0wKA: checks
*** FLOP *** [5h 7s 9s]
ZA1bp6g8IwtTxkUE4eCjDQ: checks
y27w5IK2WXqmYzS8OU0wKA: bets $2
ZA1bp6g8IwtTxkUE4eCjDQ said, "will came back"
ZA1bp6g8IwtTxkUE4eCjDQ: calls $2
*** TURN *** [5h 7s 9s] [6c]
ZA1bp6g8IwtTxkUE4eCjDQ: checks
y27w5IK2WXqmYzS8OU0wKA: checks
*** RIVER *** [5h 7s 9s 6c] [4s]
ZA1bp6g8IwtTxkUE4eCjDQ: bets $2
y27w5IK2WXqmYzS8OU0wKA: calls $2
*** SHOW DOWN ***
ZA1bp6g8IwtTxkUE4eCjDQ: shows [9h Ac] (a pair of Nines)
y27w5IK2WXqmYzS8OU0wKA: shows [7h 3h] (a straight, Three to Seven)
y27w5IK2WXqmYzS8OU0wKA collected $9.55 from pot
*** SUMMARY ***
Total pot $10 | Rake $0.45
Board [5h 7s 9s 6c 4s]
Seat 1: qhkK6+yCciTRd+rCFEbnEQ folded before Flop (didn't bet)
Seat 2: xAU6q2/cwmby2sxmA8VcmA folded before Flop (didn't bet)
Seat 3: wx3sQGkVi2x9wJXuWNHPBw (button) folded before Flop (didn't bet)
Seat 4: ZA1bp6g8IwtTxkUE4eCjDQ (small blind) showed [9h Ac] and lost with a pair of Nines
Seat 5: y27w5IK2WXqmYzS8OU0wKA (big blind) showed [7h 3h] and won ($9.55) with a straight, Three to Seven
Seat 6: oxnw0GLLpFanjhGkxfRSqA folded before Flop (didn't bet)



PokerStars Game #59941030326:  Hold'em No Limit ($0.50/$1.00) - 2009/07/01 1:23:39 ET
Table 'Evb7VW0qfDhFkbgBL3gcqQ' 2-max Seat #2 is the button
Seat 1: NYi6JFscYNrofSXy4sM+Yw ($121.10 in chips)
Seat 2: AoEQlM/FNYM0d7Txn1TfBQ ($85.50 in chips)
AoEQlM/FNYM0d7Txn1TfBQ: posts small blind $0.50
NYi6JFscYNrofSXy4sM+Yw: posts big blind $1
*** HOLE CARDS ***
AoEQlM/FNYM0d7Txn1TfBQ: calls $0.50
NYi6JFscYNrofSXy4sM+Yw: raises $3 to $4
AoEQlM/FNYM0d7Txn1TfBQ: folds
NYi6JFscYNrofSXy4sM+Yw collected $2 from pot
*** SUMMARY ***
Total pot $2 | Rake $0
Seat 1: NYi6JFscYNrofSXy4sM+Yw (big blind) collected ($2)
Seat 2: AoEQlM/FNYM0d7Txn1TfBQ (button) (small blind) folded before Flop



PokerStars Game #59941032002:  Hold'em No Limit ($0.50/$1.00) - 2009/07/01 1:23:42 ET
Table 'gxFK0BVUD7cupu2uyRUZJg' 6-max Seat #6 is the button
Seat 2: hpxXcmRkXXI9HE5+5/j/0Q ($120.60 in chips)
Seat 3: Z2fXsGcjl+Eax+RzOgwOmg ($100 in chips)
Seat 5: WgIrs6CBinyyw18pqdDtWA ($22.70 in chips)
Seat 6: dYyb6/42PMC8aNFlm/eBeQ ($140 in chips)
hpxXcmRkXXI9HE5+5/j/0Q: posts small blind $0.50
Z2fXsGcjl+Eax+RzOgwOmg: posts big blind $1
*** HOLE CARDS ***
WgIrs6CBinyyw18pqdDtWA: folds
dYyb6/42PMC8aNFlm/eBeQ: calls $1
hpxXcmRkXXI9HE5+5/j/0Q: raises $4 to $5
Z2fXsGcjl+Eax+RzOgwOmg: folds
dYyb6/42PMC8aNFlm/eBeQ: folds
hpxXcmRkXXI9HE5+5/j/0Q collected $3 from pot
hpxXcmRkXXI9HE5+5/j/0Q: doesn't show hand
*** SUMMARY ***
Total pot $3 | Rake $0
Seat 2: hpxXcmRkXXI9HE5+5/j/0Q (small blind) collected ($3)
Seat 3: Z2fXsGcjl+Eax+RzOgwOmg (big blind) folded before Flop
Seat 5: WgIrs6CBinyyw18pqdDtWA folded before Flop (didn't bet)
Seat 6: dYyb6/42PMC8aNFlm/eBeQ (button) folded before Flop



PokerStars Game #59941032758:  Hold'em No Limit ($0.50/$1.00) - 2009/07/01 1:23:43 ET
Table '/RZcOwpZpHQ+OwPwjsbnRw' 6-max Seat #3 is the button
Seat 1: +uSzP8Jwnw7sKfQ4s66b7w ($49.75 in chips)
Seat 2: Z2fXsGcjl+Eax+RzOgwOmg ($103 in chips)
Seat 3: 6hLdALbOlkzGIrc53QKtPw ($22.70 in chips)
Seat 4: j7NIOHLZk7V2o9fOioO5ug ($100 in chips)
Seat 5: wx3sQGkVi2x9wJXuWNHPBw ($166.05 in chips)
Seat 6: o3YLm/rSY916m/on1VjXPA ($200.50 in chips)
j7NIOHLZk7V2o9fOioO5ug: posts small blind $0.50
wx3sQGkVi2x9wJXuWNHPBw: posts big blind $1
*** HOLE CARDS ***
o3YLm/rSY916m/on1VjXPA: folds
+uSzP8Jwnw7sKfQ4s66b7w: folds
Z2fXsGcjl+Eax+RzOgwOmg: folds
6hLdALbOlkzGIrc53QKtPw: folds
j7NIOHLZk7V2o9fOioO5ug: folds
wx3sQGkVi2x9wJXuWNHPBw collected $1 from pot
*** SUMMARY ***
Total pot $1 | Rake $0
Seat 1: +uSzP8Jwnw7sKfQ4s66b7w folded before Flop (didn't bet)
Seat 2: Z2fXsGcjl+Eax+RzOgwOmg folded before Flop (didn't bet)
Seat 3: 6hLdALbOlkzGIrc53QKtPw (button) folded before Flop (didn't bet)
Seat 4: j7NIOHLZk7V2o9fOioO5ug (small blind) folded before Flop
Seat 5: wx3sQGkVi2x9wJXuWNHPBw (big blind) collected ($1)
Seat 6: o3YLm/rSY916m/on1VjXPA folded before Flop (didn't bet)



PokerStars Game #59941032862:  Hold'em No Limit ($0.50/$1.00) - 2009/07/01 1:23:43 ET
Table '8jIjWCPY0NGprquL+xcMFg' 9-max Seat #6 is the button
Seat 1: tU883G5KFwdH+p2tFuGYtw ($64.20 in chips)
Seat 2: 7VpIzVwja9q3vCCNM7gRrg ($54.65 in chips)
Seat 3: myIxN7otsyr846M539YR8Q ($19.50 in chips)
Seat 4: XLnHQ8GEI3bUQAfNjJuO5Q ($122.40 in chips)
Seat 6: GTQkFJtSkbVbnGCktp6e3g ($100.50 in chips)
Seat 7: O5Go3jrzbQWxRB6ESK+Ptg ($45 in chips)
Seat 8: eI48VADSCFoNZBx4T9qs2w ($16.95 in chips)
Seat 9: DDzMn3tzCgfGf298Xxt5Iw ($16.85 in chips)
O5Go3jrzbQWxRB6ESK+Ptg: posts small blind $0.50
eI48VADSCFoNZBx4T9qs2w: posts big blind $1
*** HOLE CARDS ***
2YpnxJiexJHyERfbqgwEcw leaves the table
DDzMn3tzCgfGf298Xxt5Iw: calls $1
tU883G5KFwdH+p2tFuGYtw: folds
7VpIzVwja9q3vCCNM7gRrg: folds
myIxN7otsyr846M539YR8Q: folds
XLnHQ8GEI3bUQAfNjJuO5Q said, "how about that"
XLnHQ8GEI3bUQAfNjJuO5Q: calls $1
GTQkFJtSkbVbnGCktp6e3g: folds
3obndzTJ6fECz8+wWhMd1w joins the table at seat #5
O5Go3jrzbQWxRB6ESK+Ptg: raises $5 to $6
eI48VADSCFoNZBx4T9qs2w: folds
DDzMn3tzCgfGf298Xxt5Iw: folds
XLnHQ8GEI3bUQAfNjJuO5Q: calls $5
*** FLOP *** [6d Qd 2c]
O5Go3jrzbQWxRB6ESK+Ptg: checks
XLnHQ8GEI3bUQAfNjJuO5Q: checks
*** TURN *** [6d Qd 2c] [Ah]
O5Go3jrzbQWxRB6ESK+Ptg: checks
XLnHQ8GEI3bUQAfNjJuO5Q: bets $6
O5Go3jrzbQWxRB6ESK+Ptg: raises $6 to $12
XLnHQ8GEI3bUQAfNjJuO5Q: folds
O5Go3jrzbQWxRB6ESK+Ptg collected $24.75 from pot
*** SUMMARY ***
Total pot $26 | Rake $1.25
Board [6d Qd 2c Ah]
Seat 1: tU883G5KFwdH+p2tFuGYtw folded before Flop (didn't bet)
Seat 2: 7VpIzVwja9q3vCCNM7gRrg folded before Flop (didn't bet)
Seat 3: myIxN7otsyr846M539YR8Q folded before Flop (didn't bet)
Seat 4: XLnHQ8GEI3bUQAfNjJuO5Q folded on the Turn
Seat 6: GTQkFJtSkbVbnGCktp6e3g (button) folded before Flop (didn't bet)
Seat 7: O5Go3jrzbQWxRB6ESK+Ptg (small blind) collected ($24.75)
Seat 8: eI48VADSCFoNZBx4T9qs2w (big blind) folded before Flop
Seat 9: DDzMn3tzCgfGf298Xxt5Iw folded before Flop



PokerStars Game #59941035934:  Hold'em No Limit ($0.50/$1.00) - 2009/07/01 1:23:48 ET
Table 'Evb7VW0qfDhFkbgBL3gcqQ' 2-max Seat #1 is the button
Seat 1: NYi6JFscYNrofSXy4sM+Yw ($122.10 in chips)
Seat 2: AoEQlM/FNYM0d7Txn1TfBQ ($84.50 in chips)
NYi6JFscYNrofSXy4sM+Yw: posts small blind $0.50
AoEQlM/FNYM0d7Txn1TfBQ: posts big blind $1
*** HOLE CARDS ***
NYi6JFscYNrofSXy4sM+Yw: raises $2 to $3
AoEQlM/FNYM0d7Txn1TfBQ: calls $2
*** FLOP *** [Qh Th 8s]
AoEQlM/FNYM0d7Txn1TfBQ: checks
NYi6JFscYNrofSXy4sM+Yw: bets $2
AoEQlM/FNYM0d7Txn1TfBQ: calls $2
*** TURN *** [Qh Th 8s] [Js]
AoEQlM/FNYM0d7Txn1TfBQ: checks
NYi6JFscYNrofSXy4sM+Yw: checks
*** RIVER *** [Qh Th 8s Js] [Tc]
AoEQlM/FNYM0d7Txn1TfBQ: checks
NYi6JFscYNrofSXy4sM+Yw: checks
*** SHOW DOWN ***
AoEQlM/FNYM0d7Txn1TfBQ: shows [7d 6c] (a pair of Tens)
NYi6JFscYNrofSXy4sM+Yw: shows [4s Ah] (a pair of Tens - Ace kicker)
NYi6JFscYNrofSXy4sM+Yw collected $9.55 from pot
*** SUMMARY ***
Total pot $10 | Rake $0.45
Board [Qh Th 8s Js Tc]
Seat 1: NYi6JFscYNrofSXy4sM+Yw (button) (small blind) showed [4s Ah] and won ($9.55) with a pair of Tens
Seat 2: AoEQlM/FNYM0d7Txn1TfBQ (big blind) showed [7d 6c] and lost with a pair of Tens



PokerStars Game #59941038602:  Hold'em No Limit ($0.50/$1.00) - 2009/07/01 1:23:53 ET
Table 'MNvFfRVQNka/oY+Z5aMbZQ' 2-max Seat #1 is the button
Seat 1: DaZnoWHjO897dnh0CL2lVg ($64.70 in chips)
Seat 2: mgi+mjKb1Sc3CCs7TlfoCw ($57.65 in chips)
DaZnoWHjO897dnh0CL2lVg: posts small blind $0.50
mgi+mjKb1Sc3CCs7TlfoCw: posts big blind $1
*** HOLE CARDS ***
DaZnoWHjO897dnh0CL2lVg: calls $0.50
mgi+mjKb1Sc3CCs7TlfoCw: raises $2 to $3
DaZnoWHjO897dnh0CL2lVg: calls $2
*** FLOP *** [5h 4h Js]
mgi+mjKb1Sc3CCs7TlfoCw: checks
DaZnoWHjO897dnh0CL2lVg: checks
*** TURN *** [5h 4h Js] [2c]
mgi+mjKb1Sc3CCs7TlfoCw: checks
DaZnoWHjO897dnh0CL2lVg: bets $4
mgi+mjKb1Sc3CCs7TlfoCw: folds
DaZnoWHjO897dnh0CL2lVg collected $5.70 from pot
DaZnoWHjO897dnh0CL2lVg: doesn't show hand
*** SUMMARY ***
Total pot $6 | Rake $0.30
Board [5h 4h Js 2c]
Seat 1: DaZnoWHjO897dnh0CL2lVg (button) (small blind) collected ($5.70)
Seat 2: mgi+mjKb1Sc3CCs7TlfoCw (big blind) folded on the Turn



PokerStars Game #59941038522:  Hold'em No Limit ($0.50/$1.00) - 2009/07/01 1:23:53 ET
Table 'pHrhryH8jPNdQfY62f8v+g' 6-max Seat #6 is the button
Seat 1: 4d1rWhpu8DzLmzMbR3QKyA ($133.75 in chips)
Seat 2: JwCcjZl0bjJzG7hmE0dnTA ($105.65 in chips)
Seat 3: 8oS5O7iD/qnFXFXJrGIgNQ ($100 in chips)
Seat 4: 1f3beyIML24UqEMTbWy93g ($48.70 in chips)
Seat 5: r1/R7y0Ortgoz4lccgW8VA ($17.25 in chips)
Seat 6: xAU6q2/cwmby2sxmA8VcmA ($203.60 in chips)
4d1rWhpu8DzLmzMbR3QKyA: posts small blind $0.50
JwCcjZl0bjJzG7hmE0dnTA: posts big blind $1
*** HOLE CARDS ***
8oS5O7iD/qnFXFXJrGIgNQ: raises $2.50 to $3.50
1f3beyIML24UqEMTbWy93g: folds
r1/R7y0Ortgoz4lccgW8VA: calls $3.50
xAU6q2/cwmby2sxmA8VcmA: folds
4d1rWhpu8DzLmzMbR3QKyA: folds
JwCcjZl0bjJzG7hmE0dnTA: folds
*** FLOP *** [8s Qh 9c]
8oS5O7iD/qnFXFXJrGIgNQ said, "14"
8oS5O7iD/qnFXFXJrGIgNQ: bets $14
r1/R7y0Ortgoz4lccgW8VA: folds
8oS5O7iD/qnFXFXJrGIgNQ collected $8.10 from pot
8oS5O7iD/qnFXFXJrGIgNQ: doesn't show hand
*** SUMMARY ***
Total pot $8.50 | Rake $0.40
Board [8s Qh 9c]
Seat 1: 4d1rWhpu8DzLmzMbR3QKyA (small blind) folded before Flop
Seat 2: JwCcjZl0bjJzG7hmE0dnTA (big blind) folded before Flop
Seat 3: 8oS5O7iD/qnFXFXJrGIgNQ collected ($8.10)
Seat 4: 1f3beyIML24UqEMTbWy93g folded before Flop (didn't bet)
Seat 5: r1/R7y0Ortgoz4lccgW8VA folded on the Flop
Seat 6: xAU6q2/cwmby2sxmA8VcmA (button) folded before Flop (didn't bet)



PokerStars Game #59941039960:  Hold'em No Limit ($0.50/$1.00) - 2009/07/01 1:23:55 ET
Table '/RZcOwpZpHQ+OwPwjsbnRw' 6-max Seat #4 is the button
Seat 1: +uSzP8Jwnw7sKfQ4s66b7w ($49.75 in chips)
Seat 2: Z2fXsGcjl+Eax+RzOgwOmg ($103 in chips)
Seat 3: 6hLdALbOlkzGIrc53QKtPw ($22.70 in chips)
Seat 4: j7NIOHLZk7V2o9fOioO5ug ($100 in chips)
Seat 5: wx3sQGkVi2x9wJXuWNHPBw ($166.55 in chips)
Seat 6: o3YLm/rSY916m/on1VjXPA ($200.50 in chips)
wx3sQGkVi2x9wJXuWNHPBw: posts small blind $0.50
o3YLm/rSY916m/on1VjXPA: posts big blind $1
*** HOLE CARDS ***
+uSzP8Jwnw7sKfQ4s66b7w: folds
Z2fXsGcjl+Eax+RzOgwOmg: folds
6hLdALbOlkzGIrc53QKtPw: folds
j7NIOHLZk7V2o9fOioO5ug: folds
wx3sQGkVi2x9wJXuWNHPBw: folds
o3YLm/rSY916m/on1VjXPA collected $1 from pot
o3YLm/rSY916m/on1VjXPA: doesn't show hand
*** SUMMARY ***
Total pot $1 | Rake $0
Seat 1: +uSzP8Jwnw7sKfQ4s66b7w folded before Flop (didn't bet)
Seat 2: Z2fXsGcjl+Eax+RzOgwOmg folded before Flop (didn't bet)
Seat 3: 6hLdALbOlkzGIrc53QKtPw folded before Flop (didn't bet)
Seat 4: j7NIOHLZk7V2o9fOioO5ug (button) folded before Flop (didn't bet)
Seat 5: wx3sQGkVi2x9wJXuWNHPBw (small blind) folded before Flop
Seat 6: o3YLm/rSY916m/on1VjXPA (big blind) collected ($1)



PokerStars Game #59941040216:  Hold'em No Limit ($0.50/$1.00) - 2009/07/01 1:23:56 ET
Table '305hiksPPCCdC6V2LNsO5w' 6-max Seat #1 is the button
Seat 1: RTuDLJHh/9zPfBftoc9vsw ($16.50 in chips)
Seat 2: j7NIOHLZk7V2o9fOioO5ug ($126.85 in chips)
Seat 3: +zIVjZKLpcidfRHgVZW8lA ($17 in chips)
Seat 4: uJVSceLggtsrJya+WtmUEA ($222.15 in chips)
Seat 5: +Nt3OPk3XR9SKjZgm2CexQ ($114.15 in chips)
Seat 6: 9/Tq8dw7kWW68uN8bFupXg ($24.10 in chips)
j7NIOHLZk7V2o9fOioO5ug: posts small blind $0.50
+zIVjZKLpcidfRHgVZW8lA: posts big blind $1
*** HOLE CARDS ***
uJVSceLggtsrJya+WtmUEA: raises $2 to $3
+Nt3OPk3XR9SKjZgm2CexQ: folds
9/Tq8dw7kWW68uN8bFupXg: folds
RTuDLJHh/9zPfBftoc9vsw: folds
j7NIOHLZk7V2o9fOioO5ug: folds
+zIVjZKLpcidfRHgVZW8lA: folds
uJVSceLggtsrJya+WtmUEA collected $2.50 from pot
*** SUMMARY ***
Total pot $2.50 | Rake $0
Seat 1: RTuDLJHh/9zPfBftoc9vsw (button) folded before Flop (didn't bet)
Seat 2: j7NIOHLZk7V2o9fOioO5ug (small blind) folded before Flop
Seat 3: +zIVjZKLpcidfRHgVZW8lA (big blind) folded before Flop
Seat 4: uJVSceLggtsrJya+WtmUEA collected ($2.50)
Seat 5: +Nt3OPk3XR9SKjZgm2CexQ folded before Flop (didn't bet)
Seat 6: 9/Tq8dw7kWW68uN8bFupXg folded before Flop (didn't bet)



PokerStars Game #59941040614:  Hold'em No Limit ($0.50/$1.00) - 2009/07/01 1:23:57 ET
Table 'fTlPiCj0utgzC/5io+I7ew' 6-max Seat #5 is the button
Seat 1: YMJG+F++3Aj6P8dAWda5fw ($95.05 in chips)
Seat 3: Z2fXsGcjl+Eax+RzOgwOmg ($135.90 in chips)
Seat 4: uJVSceLggtsrJya+WtmUEA ($170.15 in chips)
Seat 5: XUk5GQsfNFpHvaToDZ0rZA ($45.65 in chips)
Seat 6: y27w5IK2WXqmYzS8OU0wKA ($100.50 in chips)
y27w5IK2WXqmYzS8OU0wKA: posts small blind $0.50
YMJG+F++3Aj6P8dAWda5fw: posts big blind $1
qVr1nl3dy2xXPqS8UpTDlA: sits out
*** HOLE CARDS ***
Z2fXsGcjl+Eax+RzOgwOmg: raises $3 to $4
uJVSceLggtsrJya+WtmUEA: folds
XUk5GQsfNFpHvaToDZ0rZA: folds
y27w5IK2WXqmYzS8OU0wKA: folds
YMJG+F++3Aj6P8dAWda5fw: folds
Z2fXsGcjl+Eax+RzOgwOmg collected $2.50 from pot
*** SUMMARY ***
Total pot $2.50 | Rake $0
Seat 1: YMJG+F++3Aj6P8dAWda5fw (big blind) folded before Flop
Seat 3: Z2fXsGcjl+Eax+RzOgwOmg collected ($2.50)
Seat 4: uJVSceLggtsrJya+WtmUEA folded before Flop (didn't bet)
Seat 5: XUk5GQsfNFpHvaToDZ0rZA (button) folded before Flop (didn't bet)
Seat 6: y27w5IK2WXqmYzS8OU0wKA (small blind) folded before Flop



PokerStars Game #59941041212:  Hold'em No Limit ($0.50/$1.00) - 2009/07/01 1:23:58 ET
Table 'jDQgUn1zGkyftPnHo0Awdw' 2-max Seat #1 is the button
Seat 1: a42+e5QB6s1kkG5FoSTZJw ($120.20 in chips)
Seat 2: q+vRKwm51mnr6kxX/161WQ ($78 in chips)
a42+e5QB6s1kkG5FoSTZJw: posts small blind $0.50
q+vRKwm51mnr6kxX/161WQ: posts big blind $1
*** HOLE CARDS ***
a42+e5QB6s1kkG5FoSTZJw: folds
q+vRKwm51mnr6kxX/161WQ collected $1 from pot
*** SUMMARY ***
Total pot $1 | Rake $0
Seat 1: a42+e5QB6s1kkG5FoSTZJw (button) (small blind) folded before Flop
Seat 2: q+vRKwm51mnr6kxX/161WQ (big blind) collected ($1)



PokerStars Game #59941041548:  Hold'em No Limit ($0.50/$1.00) - 2009/07/01 1:23:58 ET
Table 'gxFK0BVUD7cupu2uyRUZJg' 6-max Seat #2 is the button
Seat 2: hpxXcmRkXXI9HE5+5/j/0Q ($122.60 in chips)
Seat 3: Z2fXsGcjl+Eax+RzOgwOmg ($100 in chips)
Seat 5: WgIrs6CBinyyw18pqdDtWA ($22.70 in chips)
Seat 6: dYyb6/42PMC8aNFlm/eBeQ ($139 in chips)
Z2fXsGcjl+Eax+RzOgwOmg: posts small blind $0.50
WgIrs6CBinyyw18pqdDtWA: posts big blind $1
*** HOLE CARDS ***
dYyb6/42PMC8aNFlm/eBeQ: raises $4 to $5
hpxXcmRkXXI9HE5+5/j/0Q: raises $10 to $15
Z2fXsGcjl+Eax+RzOgwOmg: folds
WgIrs6CBinyyw18pqdDtWA: folds
dYyb6/42PMC8aNFlm/eBeQ: calls $10
*** FLOP *** [2h Tc 3h]
dYyb6/42PMC8aNFlm/eBeQ: checks
hpxXcmRkXXI9HE5+5/j/0Q: bets $21
dYyb6/42PMC8aNFlm/eBeQ: folds
hpxXcmRkXXI9HE5+5/j/0Q collected $29.95 from pot
hpxXcmRkXXI9HE5+5/j/0Q: doesn't show hand
*** SUMMARY ***
Total pot $31.50 | Rake $1.55
Board [2h Tc 3h]
Seat 2: hpxXcmRkXXI9HE5+5/j/0Q (button) collected ($29.95)
Seat 3: Z2fXsGcjl+Eax+RzOgwOmg (small blind) folded before Flop
Seat 5: WgIrs6CBinyyw18pqdDtWA (big blind) folded before Flop
Seat 6: dYyb6/42PMC8aNFlm/eBeQ folded on the Flop



PokerStars Game #59941041920:  Hold'em No Limit ($0.50/$1.00) - 2009/07/01 1:23:59 ET
Table 'TvsifD4n+q//fIZ4fM1xxQ' 2-max Seat #1 is the button
Seat 1: NYi6JFscYNrofSXy4sM+Yw ($100 in chips)
Seat 2: +W/hy0gBp0sJy8pjLz6Yrg ($73.95 in chips)
NYi6JFscYNrofSXy4sM+Yw: posts small blind $0.50
+W/hy0gBp0sJy8pjLz6Yrg: posts big blind $1
*** HOLE CARDS ***
NYi6JFscYNrofSXy4sM+Yw: raises $2 to $3
+W/hy0gBp0sJy8pjLz6Yrg: calls $2
*** FLOP *** [4c Kh 5h]
+W/hy0gBp0sJy8pjLz6Yrg: checks
NYi6JFscYNrofSXy4sM+Yw: bets $3
+W/hy0gBp0sJy8pjLz6Yrg: raises $3 to $6
NYi6JFscYNrofSXy4sM+Yw: calls $3
*** TURN *** [4c Kh 5h] [5s]
+W/hy0gBp0sJy8pjLz6Yrg: checks
NYi6JFscYNrofSXy4sM+Yw: checks
*** RIVER *** [4c Kh 5h 5s] [2d]
+W/hy0gBp0sJy8pjLz6Yrg: bets $8
NYi6JFscYNrofSXy4sM+Yw: raises $22 to $30
+W/hy0gBp0sJy8pjLz6Yrg: calls $22
*** SHOW DOWN ***
NYi6JFscYNrofSXy4sM+Yw: shows [3d 6h] (a straight, Deuce to Six)
+W/hy0gBp0sJy8pjLz6Yrg: mucks hand
NYi6JFscYNrofSXy4sM+Yw collected $77.50 from pot
*** SUMMARY ***
Total pot $78 | Rake $0.50
Board [4c Kh 5h 5s 2d]
Seat 1: NYi6JFscYNrofSXy4sM+Yw (button) (small blind) showed [3d 6h] and won ($77.50) with a straight, Deuce to Six
Seat 2: +W/hy0gBp0sJy8pjLz6Yrg (big blind) mucked



PokerStars Game #59941041738:  Hold'em No Limit ($0.50/$1.00) - 2009/07/01 1:23:59 ET
Table 'mmbQQVBTrPdE+wy+s+9VPA' 6-max Seat #6 is the button
Seat 1: zyP4SPoWZnKUfTvIRLCVog ($62.85 in chips)
Seat 2: XK4Qsl+DA8gAJyg85/zBIw ($31.30 in chips)
Seat 3: wx3sQGkVi2x9wJXuWNHPBw ($127.35 in chips)
Seat 4: V3iZdcw61nXF3g5hD2RrsQ ($104.90 in chips)
Seat 5: YMJG+F++3Aj6P8dAWda5fw ($117.90 in chips)
Seat 6: U2CWBTv29qdCbj8RNF2sIw ($116.25 in chips)
zyP4SPoWZnKUfTvIRLCVog: posts small blind $0.50
XK4Qsl+DA8gAJyg85/zBIw: posts big blind $1
*** HOLE CARDS ***
wx3sQGkVi2x9wJXuWNHPBw: folds
V3iZdcw61nXF3g5hD2RrsQ: raises $2 to $3
YMJG+F++3Aj6P8dAWda5fw: folds
U2CWBTv29qdCbj8RNF2sIw: calls $3
zyP4SPoWZnKUfTvIRLCVog: calls $2.50
XK4Qsl+DA8gAJyg85/zBIw: folds
*** FLOP *** [4d 3c Qs]
zyP4SPoWZnKUfTvIRLCVog: checks
V3iZdcw61nXF3g5hD2RrsQ: bets $7
U2CWBTv29qdCbj8RNF2sIw: folds
zyP4SPoWZnKUfTvIRLCVog: calls $7
*** TURN *** [4d 3c Qs] [3s]
zyP4SPoWZnKUfTvIRLCVog: checks
V3iZdcw61nXF3g5hD2RrsQ: checks
*** RIVER *** [4d 3c Qs 3s] [7c]
zyP4SPoWZnKUfTvIRLCVog: bets $4
V3iZdcw61nXF3g5hD2RrsQ: calls $4
*** SHOW DOWN ***
zyP4SPoWZnKUfTvIRLCVog: shows [Qd Ks] (two pair, Queens and Threes)
V3iZdcw61nXF3g5hD2RrsQ: mucks hand
zyP4SPoWZnKUfTvIRLCVog collected $30.50 from pot
*** SUMMARY ***
Total pot $32 | Rake $1.50
Board [4d 3c Qs 3s 7c]
Seat 1: zyP4SPoWZnKUfTvIRLCVog (small blind) showed [Qd Ks] and won ($30.50) with two pair, Queens and Threes
Seat 2: XK4Qsl+DA8gAJyg85/zBIw (big blind) folded before Flop
Seat 3: wx3sQGkVi2x9wJXuWNHPBw folded before Flop (didn't bet)
Seat 4: V3iZdcw61nXF3g5hD2RrsQ mucked
Seat 5: YMJG+F++3Aj6P8dAWda5fw folded before Flop (didn't bet)
Seat 6: U2CWBTv29qdCbj8RNF2sIw (button) folded on the Flop



PokerStars Game #59941043454:  Hold'em No Limit ($0.50/$1.00) - 2009/07/01 1:24:02 ET
Table 'vs/5jr6ciwjVQ5+Soc+u2A' 6-max Seat #6 is the button
Seat 1: J798qwLuvXyq0BbzsIjOrA ($149.90 in chips)
Seat 2: lXX4W7m3u++JiSOZ46yVMQ ($105.65 in chips)
Seat 3: G5ZSSN6RSON3gkNvk/SmYg ($139.60 in chips)
Seat 4: wk6Ohn4GDozoOMHc4eb2rw ($59.30 in chips)
Seat 5: +Nt3OPk3XR9SKjZgm2CexQ ($149.10 in chips)
Seat 6: Z2fXsGcjl+Eax+RzOgwOmg ($104.50 in chips)
J798qwLuvXyq0BbzsIjOrA: posts small blind $0.50
lXX4W7m3u++JiSOZ46yVMQ: posts big blind $1
*** HOLE CARDS ***
G5ZSSN6RSON3gkNvk/SmYg: folds
wk6Ohn4GDozoOMHc4eb2rw: folds
+Nt3OPk3XR9SKjZgm2CexQ: raises $2 to $3
Z2fXsGcjl+Eax+RzOgwOmg: folds
J798qwLuvXyq0BbzsIjOrA: calls $2.50
lXX4W7m3u++JiSOZ46yVMQ: folds
*** FLOP *** [Qc 4h 4d]
J798qwLuvXyq0BbzsIjOrA: checks
+Nt3OPk3XR9SKjZgm2CexQ: bets $3
J798qwLuvXyq0BbzsIjOrA: calls $3
*** TURN *** [Qc 4h 4d] [Kd]
J798qwLuvXyq0BbzsIjOrA: checks
+Nt3OPk3XR9SKjZgm2CexQ: bets $11
J798qwLuvXyq0BbzsIjOrA: folds
+Nt3OPk3XR9SKjZgm2CexQ collected $12.40 from pot
+Nt3OPk3XR9SKjZgm2CexQ: doesn't show hand
*** SUMMARY ***
Total pot $13 | Rake $0.60
Board [Qc 4h 4d Kd]
Seat 1: J798qwLuvXyq0BbzsIjOrA (small blind) folded on the Turn
Seat 2: lXX4W7m3u++JiSOZ46yVMQ (big blind) folded before Flop
Seat 3: G5ZSSN6RSON3gkNvk/SmYg folded before Flop (didn't bet)
Seat 4: wk6Ohn4GDozoOMHc4eb2rw folded before Flop (didn't bet)
Seat 5: +Nt3OPk3XR9SKjZgm2CexQ collected ($12.40)
Seat 6: Z2fXsGcjl+Eax+RzOgwOmg (button) folded before Flop (didn't bet)



PokerStars Game #59941044610:  Hold'em No Limit ($0.50/$1.00) - 2009/07/01 1:24:04 ET
Table 'jDQgUn1zGkyftPnHo0Awdw' 2-max Seat #2 is the button
Seat 1: a42+e5QB6s1kkG5FoSTZJw ($119.70 in chips)
Seat 2: q+vRKwm51mnr6kxX/161WQ ($78.50 in chips)
q+vRKwm51mnr6kxX/161WQ: posts small blind $0.50
a42+e5QB6s1kkG5FoSTZJw: posts big blind $1
*** HOLE CARDS ***
q+vRKwm51mnr6kxX/161WQ: raises $2 to $3
a42+e5QB6s1kkG5FoSTZJw: calls $2
*** FLOP *** [Js As 7h]
a42+e5QB6s1kkG5FoSTZJw: checks
q+vRKwm51mnr6kxX/161WQ: bets $4
a42+e5QB6s1kkG5FoSTZJw: calls $4
*** TURN *** [Js As 7h] [Jd]
a42+e5QB6s1kkG5FoSTZJw: checks
q+vRKwm51mnr6kxX/161WQ: bets $8
a42+e5QB6s1kkG5FoSTZJw: folds
q+vRKwm51mnr6kxX/161WQ collected $13.50 from pot
q+vRKwm51mnr6kxX/161WQ: doesn't show hand
*** SUMMARY ***
Total pot $14 | Rake $0.50
Board [Js As 7h Jd]
Seat 1: a42+e5QB6s1kkG5FoSTZJw (big blind) folded on the Turn
Seat 2: q+vRKwm51mnr6kxX/161WQ (button) (small blind) collected ($13.50)



PokerStars Game #59941046364:  Hold'em No Limit ($0.50/$1.00) - 2009/07/01 1:24:07 ET
Table 'kS0cTQAEi+fdUlJP2gQYvw' 9-max Seat #9 is the button
Seat 1: /mfensKw8/iZ1Vrx33S4xg ($20 in chips)
Seat 2: D+W9Me7w6Hcx/WRUSKV0dw ($26.55 in chips)
Seat 3: 2BV+oJIQYr65IO6nEChvbA ($60 in chips)
Seat 4: RUhhaALzha3TH1AkdakoGQ ($55 in chips)
Seat 5: 997ViqAtWn1FPjJqcffwcA ($100 in chips)
Seat 6: yAbu2QsRPVcjPbqlf/jDxw ($126.15 in chips)
Seat 7: Ffa7Nj4X5fddtROP01hfQg ($154.60 in chips)
Seat 8: vKyFzTyzfT7fZcdX+HHN+Q ($31.65 in chips)
Seat 9: OGgaARGdJQT4awWVNQ957w ($100 in chips)
/mfensKw8/iZ1Vrx33S4xg: posts small blind $0.50
D+W9Me7w6Hcx/WRUSKV0dw: posts big blind $1
*** HOLE CARDS ***
2BV+oJIQYr65IO6nEChvbA: folds
RUhhaALzha3TH1AkdakoGQ: folds
997ViqAtWn1FPjJqcffwcA: folds
yAbu2QsRPVcjPbqlf/jDxw: folds
Ffa7Nj4X5fddtROP01hfQg: folds
vKyFzTyzfT7fZcdX+HHN+Q: calls $1
OGgaARGdJQT4awWVNQ957w: folds
/mfensKw8/iZ1Vrx33S4xg: calls $0.50
D+W9Me7w6Hcx/WRUSKV0dw: checks
*** FLOP *** [6d 3c Ac]
/mfensKw8/iZ1Vrx33S4xg: checks
D+W9Me7w6Hcx/WRUSKV0dw: checks
vKyFzTyzfT7fZcdX+HHN+Q: checks
*** TURN *** [6d 3c Ac] [Jd]
/mfensKw8/iZ1Vrx33S4xg: checks
D+W9Me7w6Hcx/WRUSKV0dw: checks
vKyFzTyzfT7fZcdX+HHN+Q: bets $3
/mfensKw8/iZ1Vrx33S4xg: folds
D+W9Me7w6Hcx/WRUSKV0dw: folds
vKyFzTyzfT7fZcdX+HHN+Q collected $2.85 from pot
*** SUMMARY ***
Total pot $3 | Rake $0.15
Board [6d 3c Ac Jd]
Seat 1: /mfensKw8/iZ1Vrx33S4xg (small blind) folded on the Turn
Seat 2: D+W9Me7w6Hcx/WRUSKV0dw (big blind) folded on the Turn
Seat 3: 2BV+oJIQYr65IO6nEChvbA folded before Flop (didn't bet)
Seat 4: RUhhaALzha3TH1AkdakoGQ folded before Flop (didn't bet)
Seat 5: 997ViqAtWn1FPjJqcffwcA folded before Flop (didn't bet)
Seat 6: yAbu2QsRPVcjPbqlf/jDxw folded before Flop (didn't bet)
Seat 7: Ffa7Nj4X5fddtROP01hfQg folded before Flop (didn't bet)
Seat 8: vKyFzTyzfT7fZcdX+HHN+Q collected ($2.85)
Seat 9: OGgaARGdJQT4awWVNQ957w (button) folded before Flop (didn't bet)



PokerStars Game #59941048824:  Hold'em No Limit ($0.50/$1.00) - 2009/07/01 1:24:11 ET
Table '+cA8mcmhaedZ7YcrDdhmeQ' 6-max Seat #6 is the button
Seat 1: iIgNoBh+3/Ix1/fLsg+HuA ($31.85 in chips)
Seat 2: 14aYclSc98EYd6TrzN2l3Q ($19.85 in chips)
Seat 3: DAIgyIWbYvAkL6PbAI27pg ($6.50 in chips)
Seat 4: 4OO5v3AVduL0tePNx8wk5A ($100.05 in chips)
Seat 5: n5xXfJeDtWZSChGAdq//Tw ($18.55 in chips)
Seat 6: YfsTQsY/fxb+YqbdclTHuw ($27.25 in chips)
iIgNoBh+3/Ix1/fLsg+HuA: posts small blind $0.50
14aYclSc98EYd6TrzN2l3Q: posts big blind $1
*** HOLE CARDS ***
DAIgyIWbYvAkL6PbAI27pg: folds
4OO5v3AVduL0tePNx8wk5A: raises $2 to $3
n5xXfJeDtWZSChGAdq//Tw: folds
YfsTQsY/fxb+YqbdclTHuw: folds
iIgNoBh+3/Ix1/fLsg+HuA: folds
14aYclSc98EYd6TrzN2l3Q: calls $2
*** FLOP *** [4s 7c Qs]
14aYclSc98EYd6TrzN2l3Q: checks
4OO5v3AVduL0tePNx8wk5A: bets $4
14aYclSc98EYd6TrzN2l3Q: raises $7 to $11
4OO5v3AVduL0tePNx8wk5A: raises $25 to $36
14aYclSc98EYd6TrzN2l3Q: calls $5.85 and is all-in
*** TURN *** [4s 7c Qs] [4d]
*** RIVER *** [4s 7c Qs 4d] [Qh]
*** SHOW DOWN ***
14aYclSc98EYd6TrzN2l3Q: shows [Qd Kh] (a full house, Queens full of Fours)
4OO5v3AVduL0tePNx8wk5A: mucks hand
14aYclSc98EYd6TrzN2l3Q collected $38.25 from pot
*** SUMMARY ***
Total pot $40.20 | Rake $1.95
Board [4s 7c Qs 4d Qh]
Seat 1: iIgNoBh+3/Ix1/fLsg+HuA (small blind) folded before Flop
Seat 2: 14aYclSc98EYd6TrzN2l3Q (big blind) showed [Qd Kh] and won ($38.25) with a full house, Queens full of Fours
Seat 3: DAIgyIWbYvAkL6PbAI27pg folded before Flop (didn't bet)
Seat 4: 4OO5v3AVduL0tePNx8wk5A mucked
Seat 5: n5xXfJeDtWZSChGAdq//Tw folded before Flop (didn't bet)
Seat 6: YfsTQsY/fxb+YqbdclTHuw (button) folded before Flop (didn't bet)



PokerStars Game #59941048828:  Hold'em No Limit ($0.50/$1.00) - 2009/07/01 1:24:11 ET
Table 'cBDNutyLBKEk9+ptwsKmTw' 6-max Seat #2 is the button
Seat 1: xAU6q2/cwmby2sxmA8VcmA ($248.90 in chips)
Seat 2: 5lY8d6Cnm4HUkt/8FZSj4g ($30.55 in chips)
Seat 3: G5ZSSN6RSON3gkNvk/SmYg ($110.90 in chips)
Seat 4: 3q7F5QtzC30pSrn0nl9i+A ($20 in chips)
Seat 5: hpxXcmRkXXI9HE5+5/j/0Q ($100 in chips)
Seat 6: QHvTZcrKe6+maWUfVjP29Q ($152 in chips)
G5ZSSN6RSON3gkNvk/SmYg: posts small blind $0.50
3q7F5QtzC30pSrn0nl9i+A: posts big blind $1
*** HOLE CARDS ***
hpxXcmRkXXI9HE5+5/j/0Q: folds
QHvTZcrKe6+maWUfVjP29Q: folds
xAU6q2/cwmby2sxmA8VcmA: raises $3 to $4
5lY8d6Cnm4HUkt/8FZSj4g: folds
G5ZSSN6RSON3gkNvk/SmYg: folds
3q7F5QtzC30pSrn0nl9i+A: calls $3
*** FLOP *** [Jc 4h 4s]
3q7F5QtzC30pSrn0nl9i+A: checks
xAU6q2/cwmby2sxmA8VcmA: bets $16
3q7F5QtzC30pSrn0nl9i+A: folds
xAU6q2/cwmby2sxmA8VcmA collected $8.10 from pot
xAU6q2/cwmby2sxmA8VcmA: doesn't show hand
*** SUMMARY ***
Total pot $8.50 | Rake $0.40
Board [Jc 4h 4s]
Seat 1: xAU6q2/cwmby2sxmA8VcmA collected ($8.10)
Seat 2: 5lY8d6Cnm4HUkt/8FZSj4g (button) folded before Flop (didn't bet)
Seat 3: G5ZSSN6RSON3gkNvk/SmYg (small blind) folded before Flop
Seat 4: 3q7F5QtzC30pSrn0nl9i+A (big blind) folded on the Flop
Seat 5: hpxXcmRkXXI9HE5+5/j/0Q folded before Flop (didn't bet)
Seat 6: QHvTZcrKe6+maWUfVjP29Q folded before Flop (didn't bet)



PokerStars Game #59941049302:  Hold'em No Limit ($0.50/$1.00) - 2009/07/01 1:24:12 ET
Table '/RZcOwpZpHQ+OwPwjsbnRw' 6-max Seat #5 is the button
Seat 1: +uSzP8Jwnw7sKfQ4s66b7w ($49.75 in chips)
Seat 2: Z2fXsGcjl+Eax+RzOgwOmg ($103 in chips)
Seat 3: 6hLdALbOlkzGIrc53QKtPw ($22.70 in chips)
Seat 4: j7NIOHLZk7V2o9fOioO5ug ($100 in chips)
Seat 5: wx3sQGkVi2x9wJXuWNHPBw ($166.05 in chips)
Seat 6: o3YLm/rSY916m/on1VjXPA ($201 in chips)
o3YLm/rSY916m/on1VjXPA: posts small blind $0.50
+uSzP8Jwnw7sKfQ4s66b7w: posts big blind $1
*** HOLE CARDS ***
Z2fXsGcjl+Eax+RzOgwOmg: folds
6hLdALbOlkzGIrc53QKtPw: folds
j7NIOHLZk7V2o9fOioO5ug: raises $2 to $3
wx3sQGkVi2x9wJXuWNHPBw: folds
o3YLm/rSY916m/on1VjXPA: folds
+uSzP8Jwnw7sKfQ4s66b7w: folds
j7NIOHLZk7V2o9fOioO5ug collected $2.50 from pot
j7NIOHLZk7V2o9fOioO5ug: doesn't show hand
*** SUMMARY ***
Total pot $2.50 | Rake $0
Seat 1: +uSzP8Jwnw7sKfQ4s66b7w (big blind) folded before Flop
Seat 2: Z2fXsGcjl+Eax+RzOgwOmg folded before Flop (didn't bet)
Seat 3: 6hLdALbOlkzGIrc53QKtPw folded before Flop (didn't bet)
Seat 4: j7NIOHLZk7V2o9fOioO5ug collected ($2.50)
Seat 5: wx3sQGkVi2x9wJXuWNHPBw (button) folded before Flop (didn't bet)
Seat 6: o3YLm/rSY916m/on1VjXPA (small blind) folded before Flop



PokerStars Game #59941049530:  Hold'em No Limit ($0.50/$1.00) - 2009/07/01 1:24:12 ET
Table 'Evb7VW0qfDhFkbgBL3gcqQ' 2-max Seat #2 is the button
Seat 1: NYi6JFscYNrofSXy4sM+Yw ($126.65 in chips)
Seat 2: AoEQlM/FNYM0d7Txn1TfBQ ($79.50 in chips)
AoEQlM/FNYM0d7Txn1TfBQ: posts small blind $0.50
NYi6JFscYNrofSXy4sM+Yw: posts big blind $1
*** HOLE CARDS ***
AoEQlM/FNYM0d7Txn1TfBQ: folds
NYi6JFscYNrofSXy4sM+Yw collected $1 from pot
*** SUMMARY ***
Total pot $1 | Rake $0
Seat 1: NYi6JFscYNrofSXy4sM+Yw (big blind) collected ($1)
Seat 2: AoEQlM/FNYM0d7Txn1TfBQ (button) (small blind) folded before Flop



PokerStars Game #59941049574:  Hold'em No Limit ($0.50/$1.00) - 2009/07/01 1:24:12 ET
Table 'hugOjcwJvzEwZbK7tyiWuQ' 9-max Seat #9 is the button
Seat 1: S3Ex8K7v6xm5jqjRM7Fl3w ($19 in chips)
Seat 2: r27C1nIV4NS4+qbnrgBQSw ($273.70 in chips)
Seat 4: UWB3oeddt/GObx2Mix2Anw ($187.60 in chips)
Seat 6: gUUvmqdVlmvpal6B8nYrmg ($107.95 in chips)
Seat 7: FL3MrLspcF23LYvC4ipBOA ($117.30 in chips)
Seat 8: /zy+DB4S5fUQUSfZWFzYGw ($115.75 in chips)
Seat 9: W8P9bUKCs43TO1xHm0dL6w ($111.50 in chips)
S3Ex8K7v6xm5jqjRM7Fl3w: posts small blind $0.50
r27C1nIV4NS4+qbnrgBQSw: posts big blind $1
*** HOLE CARDS ***
UWB3oeddt/GObx2Mix2Anw: folds
gUUvmqdVlmvpal6B8nYrmg: folds
FL3MrLspcF23LYvC4ipBOA: folds
/zy+DB4S5fUQUSfZWFzYGw: folds
W8P9bUKCs43TO1xHm0dL6w: folds
S3Ex8K7v6xm5jqjRM7Fl3w: folds
r27C1nIV4NS4+qbnrgBQSw collected $1 from pot
*** SUMMARY ***
Total pot $1 | Rake $0
Seat 1: S3Ex8K7v6xm5jqjRM7Fl3w (small blind) folded before Flop
Seat 2: r27C1nIV4NS4+qbnrgBQSw (big blind) collected ($1)
Seat 4: UWB3oeddt/GObx2Mix2Anw folded before Flop (didn't bet)
Seat 6: gUUvmqdVlmvpal6B8nYrmg folded before Flop (didn't bet)
Seat 7: FL3MrLspcF23LYvC4ipBOA folded before Flop (didn't bet)
Seat 8: /zy+DB4S5fUQUSfZWFzYGw folded before Flop (didn't bet)
Seat 9: W8P9bUKCs43TO1xHm0dL6w (button) folded before Flop (didn't bet)



PokerStars Game #59941051346:  Hold'em No Limit ($0.50/$1.00) - 2009/07/01 1:24:15 ET
Table '7O9fB8yx1u7sJveJn8w6jA' 6-max Seat #3 is the button
Seat 1: jy52+7FotjH63o5tEEVgKw ($61.30 in chips)
Seat 2: wx3sQGkVi2x9wJXuWNHPBw ($196.20 in chips)
Seat 3: hpxXcmRkXXI9HE5+5/j/0Q ($121.25 in chips)
Seat 4: b2a+5TkFf4xJN/Ihhma58Q ($37.70 in chips)
Seat 5: BCEV3COoKY607AzLWayfRA ($104.85 in chips)
Seat 6: 6hLdALbOlkzGIrc53QKtPw ($20 in chips)
b2a+5TkFf4xJN/Ihhma58Q: posts small blind $0.50
BCEV3COoKY607AzLWayfRA: posts big blind $1
*** HOLE CARDS ***
6hLdALbOlkzGIrc53QKtPw: folds
jy52+7FotjH63o5tEEVgKw: calls $1
wx3sQGkVi2x9wJXuWNHPBw: folds
hpxXcmRkXXI9HE5+5/j/0Q: folds
b2a+5TkFf4xJN/Ihhma58Q: calls $0.50
BCEV3COoKY607AzLWayfRA: checks
*** FLOP *** [2h 8s Jc]
b2a+5TkFf4xJN/Ihhma58Q: checks
BCEV3COoKY607AzLWayfRA: checks
jy52+7FotjH63o5tEEVgKw: checks
*** TURN *** [2h 8s Jc] [3s]
b2a+5TkFf4xJN/Ihhma58Q: checks
BCEV3COoKY607AzLWayfRA: checks
jy52+7FotjH63o5tEEVgKw: checks
*** RIVER *** [2h 8s Jc 3s] [4s]
b2a+5TkFf4xJN/Ihhma58Q: checks
BCEV3COoKY607AzLWayfRA: checks
jy52+7FotjH63o5tEEVgKw: checks
*** SHOW DOWN ***
b2a+5TkFf4xJN/Ihhma58Q: shows [Kh 2s] (a pair of Deuces)
BCEV3COoKY607AzLWayfRA: mucks hand
jy52+7FotjH63o5tEEVgKw: mucks hand
b2a+5TkFf4xJN/Ihhma58Q collected $2.85 from pot
*** SUMMARY ***
Total pot $3 | Rake $0.15
Board [2h 8s Jc 3s 4s]
Seat 1: jy52+7FotjH63o5tEEVgKw mucked
Seat 2: wx3sQGkVi2x9wJXuWNHPBw folded before Flop (didn't bet)
Seat 3: hpxXcmRkXXI9HE5+5/j/0Q (button) folded before Flop (didn't bet)
Seat 4: b2a+5TkFf4xJN/Ihhma58Q (small blind) showed [Kh 2s] and won ($2.85) with a pair of Deuces
Seat 5: BCEV3COoKY607AzLWayfRA (big blind) mucked
Seat 6: 6hLdALbOlkzGIrc53QKtPw folded before Flop (didn't bet)



PokerStars Game #59941051872:  Hold'em No Limit ($0.50/$1.00) - 2009/07/01 1:24:16 ET
Table 'MNvFfRVQNka/oY+Z5aMbZQ' 2-max Seat #2 is the button
Seat 1: DaZnoWHjO897dnh0CL2lVg ($67.40 in chips)
Seat 2: mgi+mjKb1Sc3CCs7TlfoCw ($54.65 in chips)
mgi+mjKb1Sc3CCs7TlfoCw: posts small blind $0.50
DaZnoWHjO897dnh0CL2lVg: posts big blind $1
*** HOLE CARDS ***
mgi+mjKb1Sc3CCs7TlfoCw: raises $2 to $3
DaZnoWHjO897dnh0CL2lVg: calls $2
*** FLOP *** [5s Qd 4s]
DaZnoWHjO897dnh0CL2lVg: checks
mgi+mjKb1Sc3CCs7TlfoCw: checks
*** TURN *** [5s Qd 4s] [9c]
DaZnoWHjO897dnh0CL2lVg: checks
mgi+mjKb1Sc3CCs7TlfoCw: checks
*** RIVER *** [5s Qd 4s 9c] [3h]
DaZnoWHjO897dnh0CL2lVg: checks
mgi+mjKb1Sc3CCs7TlfoCw: checks
*** SHOW DOWN ***
DaZnoWHjO897dnh0CL2lVg: shows [2h Kc] (high card King)
mgi+mjKb1Sc3CCs7TlfoCw: shows [As 8h] (high card Ace)
mgi+mjKb1Sc3CCs7TlfoCw collected $5.70 from pot
*** SUMMARY ***
Total pot $6 | Rake $0.30
Board [5s Qd 4s 9c 3h]
Seat 1: DaZnoWHjO897dnh0CL2lVg (big blind) showed [2h Kc] and lost with high card King
Seat 2: mgi+mjKb1Sc3CCs7TlfoCw (button) (small blind) showed [As 8h] and won ($5.70) with high card Ace



PokerStars Game #59941052826:  Hold'em No Limit ($0.50/$1.00) - 2009/07/01 1:24:18 ET
Table 'SQLOQoANiHscJ8AL7zffbw' 9-max Seat #8 is the button
Seat 1: jPTRd6SpCp4xqAy2XQiTOw ($66.90 in chips)
Seat 2: /zy+DB4S5fUQUSfZWFzYGw ($390.05 in chips)
Seat 3: 0eFnow7+D7veCYQ+CG9FFw ($103 in chips)
Seat 4: 5z1PAR8SNow/zUfYNbwq7A ($36.95 in chips)
Seat 5: L9njYvloJ1NdXjP8edHEAg ($111.30 in chips)
Seat 6: H+DVy3Ei8L1UKS2tVOtJcw ($100 in chips)
Seat 8: 9BZCcac3+McErkkSN2YScA ($100 in chips)
jPTRd6SpCp4xqAy2XQiTOw: posts small blind $0.50
/zy+DB4S5fUQUSfZWFzYGw: posts big blind $1
*** HOLE CARDS ***
0eFnow7+D7veCYQ+CG9FFw: folds
5z1PAR8SNow/zUfYNbwq7A: calls $1
L9njYvloJ1NdXjP8edHEAg: folds
H+DVy3Ei8L1UKS2tVOtJcw: folds
9BZCcac3+McErkkSN2YScA: folds
XE5QF1y74bpHog9JxWJMWQ has returned
jPTRd6SpCp4xqAy2XQiTOw: calls $0.50
/zy+DB4S5fUQUSfZWFzYGw: raises $5 to $6
5z1PAR8SNow/zUfYNbwq7A: calls $5
jPTRd6SpCp4xqAy2XQiTOw: calls $5
*** FLOP *** [Tc 6s 6h]
jPTRd6SpCp4xqAy2XQiTOw: checks
/zy+DB4S5fUQUSfZWFzYGw: bets $11
5z1PAR8SNow/zUfYNbwq7A: folds
jPTRd6SpCp4xqAy2XQiTOw: folds
/zy+DB4S5fUQUSfZWFzYGw collected $17.10 from pot
*** SUMMARY ***
Total pot $18 | Rake $0.90
Board [Tc 6s 6h]
Seat 1: jPTRd6SpCp4xqAy2XQiTOw (small blind) folded on the Flop
Seat 2: /zy+DB4S5fUQUSfZWFzYGw (big blind) collected ($17.10)
Seat 3: 0eFnow7+D7veCYQ+CG9FFw folded before Flop (didn't bet)
Seat 4: 5z1PAR8SNow/zUfYNbwq7A folded on the Flop
Seat 5: L9njYvloJ1NdXjP8edHEAg folded before Flop (didn't bet)
Seat 6: H+DVy3Ei8L1UKS2tVOtJcw folded before Flop (didn't bet)
Seat 8: 9BZCcac3+McErkkSN2YScA (button) folded before Flop (didn't bet)



PokerStars Game #59941053784:  Hold'em No Limit ($0.50/$1.00) - 2009/07/01 1:24:19 ET
Table 'Evb7VW0qfDhFkbgBL3gcqQ' 2-max Seat #1 is the button
Seat 1: NYi6JFscYNrofSXy4sM+Yw ($127.15 in chips)
Seat 2: AoEQlM/FNYM0d7Txn1TfBQ ($79 in chips)
NYi6JFscYNrofSXy4sM+Yw: posts small blind $0.50
AoEQlM/FNYM0d7Txn1TfBQ: posts big blind $1
*** HOLE CARDS ***
NYi6JFscYNrofSXy4sM+Yw: raises $2 to $3
AoEQlM/FNYM0d7Txn1TfBQ: folds
NYi6JFscYNrofSXy4sM+Yw collected $2 from pot
*** SUMMARY ***
Total pot $2 | Rake $0
Seat 1: NYi6JFscYNrofSXy4sM+Yw (button) (small blind) collected ($2)
Seat 2: AoEQlM/FNYM0d7Txn1TfBQ (big blind) folded before Flop



PokerStars Game #59941053726:  Hold'em No Limit ($0.50/$1.00) - 2009/07/01 1:24:19 ET
Table '7Nl0ffnjeK44/vmeexh3MQ' 9-max Seat #8 is the button
Seat 1: V138SURkdX8LdVBPKdJJag ($100 in chips)
Seat 2: OGgaARGdJQT4awWVNQ957w ($100.50 in chips)
Seat 3: JMmUYT5pIKCKh2pGjCB/4w ($60.40 in chips)
Seat 4: bLbSOSmSOnqE0iTcH/5dxA ($111.80 in chips)
Seat 6: FVs16t7GgfWgQWt4JxsObQ ($16.65 in chips)
Seat 7: 997ViqAtWn1FPjJqcffwcA ($100 in chips)
Seat 8: D+W9Me7w6Hcx/WRUSKV0dw ($17.75 in chips)
Seat 9: rFvc7K/96V9eGvYRfmpoUQ ($20 in chips)
rFvc7K/96V9eGvYRfmpoUQ: posts small blind $0.50
V138SURkdX8LdVBPKdJJag: posts big blind $1
*** HOLE CARDS ***
OGgaARGdJQT4awWVNQ957w: folds
JMmUYT5pIKCKh2pGjCB/4w: folds
bLbSOSmSOnqE0iTcH/5dxA: folds
FVs16t7GgfWgQWt4JxsObQ: folds
997ViqAtWn1FPjJqcffwcA: folds
D+W9Me7w6Hcx/WRUSKV0dw: raises $1.45 to $2.45
rFvc7K/96V9eGvYRfmpoUQ: raises $17.55 to $20 and is all-in
V138SURkdX8LdVBPKdJJag: folds
D+W9Me7w6Hcx/WRUSKV0dw: folds
rFvc7K/96V9eGvYRfmpoUQ collected $5.90 from pot
rFvc7K/96V9eGvYRfmpoUQ: doesn't show hand
*** SUMMARY ***
Total pot $5.90 | Rake $0
Seat 1: V138SURkdX8LdVBPKdJJag (big blind) folded before Flop
Seat 2: OGgaARGdJQT4awWVNQ957w folded before Flop (didn't bet)
Seat 3: JMmUYT5pIKCKh2pGjCB/4w folded before Flop (didn't bet)
Seat 4: bLbSOSmSOnqE0iTcH/5dxA folded before Flop (didn't bet)
Seat 6: FVs16t7GgfWgQWt4JxsObQ folded before Flop (didn't bet)
Seat 7: 997ViqAtWn1FPjJqcffwcA folded before Flop (didn't bet)
Seat 8: D+W9Me7w6Hcx/WRUSKV0dw (button) folded before Flop
Seat 9: rFvc7K/96V9eGvYRfmpoUQ (small blind) collected ($5.90)



PokerStars Game #59941055638:  Hold'em No Limit ($0.50/$1.00) - 2009/07/01 1:24:22 ET
Table 'tJq9SfN1ywY0r03VBlWlwQ' 9-max Seat #3 is the button
Seat 1: wZsU+w9r7G66x93UuvBf1Q ($322.80 in chips)
Seat 3: FVs16t7GgfWgQWt4JxsObQ ($19.30 in chips)
Seat 4: bLbSOSmSOnqE0iTcH/5dxA ($114.15 in chips)
Seat 5: h5ipsNTMyolp7xn/NAvWkA ($123.80 in chips)
Seat 6: gUUvmqdVlmvpal6B8nYrmg ($100 in chips)
Seat 7: Pp/KTcXkfZKKUHkjyaLTdg ($18.50 in chips)
Seat 8: G4DEhsZFmznGNVpy2SEocA ($22.25 in chips)
bLbSOSmSOnqE0iTcH/5dxA: posts small blind $0.50
h5ipsNTMyolp7xn/NAvWkA: posts big blind $1
VPF+HjszMvUIpy0CHIwH3A: sits out
*** HOLE CARDS ***
gUUvmqdVlmvpal6B8nYrmg: raises $1 to $2
Pp/KTcXkfZKKUHkjyaLTdg: folds
G4DEhsZFmznGNVpy2SEocA: folds
XE5QF1y74bpHog9JxWJMWQ has returned
wZsU+w9r7G66x93UuvBf1Q: folds
FVs16t7GgfWgQWt4JxsObQ: calls $2
bLbSOSmSOnqE0iTcH/5dxA: folds
h5ipsNTMyolp7xn/NAvWkA: calls $1
*** FLOP *** [7c Kc As]
h5ipsNTMyolp7xn/NAvWkA: bets $3
gUUvmqdVlmvpal6B8nYrmg: folds
FVs16t7GgfWgQWt4JxsObQ: folds
h5ipsNTMyolp7xn/NAvWkA collected $6.20 from pot
*** SUMMARY ***
Total pot $6.50 | Rake $0.30
Board [7c Kc As]
Seat 1: wZsU+w9r7G66x93UuvBf1Q folded before Flop (didn't bet)
Seat 3: FVs16t7GgfWgQWt4JxsObQ (button) folded on the Flop
Seat 4: bLbSOSmSOnqE0iTcH/5dxA (small blind) folded before Flop
Seat 5: h5ipsNTMyolp7xn/NAvWkA (big blind) collected ($6.20)
Seat 6: gUUvmqdVlmvpal6B8nYrmg folded on the Flop
Seat 7: Pp/KTcXkfZKKUHkjyaLTdg folded before Flop (didn't bet)
Seat 8: G4DEhsZFmznGNVpy2SEocA folded before Flop (didn't bet)



PokerStars Game #59941056984:  Hold'em No Limit ($0.50/$1.00) - 2009/07/01 1:24:25 ET
Table 'TvsifD4n+q//fIZ4fM1xxQ' 2-max Seat #2 is the button
Seat 1: NYi6JFscYNrofSXy4sM+Yw ($138.50 in chips)
Seat 2: +W/hy0gBp0sJy8pjLz6Yrg ($34.95 in chips)
+W/hy0gBp0sJy8pjLz6Yrg: posts small blind $0.50
NYi6JFscYNrofSXy4sM+Yw: posts big blind $1
*** HOLE CARDS ***
+W/hy0gBp0sJy8pjLz6Yrg: calls $0.50
NYi6JFscYNrofSXy4sM+Yw: raises $2 to $3
+W/hy0gBp0sJy8pjLz6Yrg: calls $2
*** FLOP *** [Qh 2c 8d]
NYi6JFscYNrofSXy4sM+Yw: bets $3
+W/hy0gBp0sJy8pjLz6Yrg: calls $3
*** TURN *** [Qh 2c 8d] [3c]
NYi6JFscYNrofSXy4sM+Yw: bets $5
+W/hy0gBp0sJy8pjLz6Yrg: raises $5 to $10
NYi6JFscYNrofSXy4sM+Yw: calls $5
*** RIVER *** [Qh 2c 8d 3c] [7h]
NYi6JFscYNrofSXy4sM+Yw: checks
+W/hy0gBp0sJy8pjLz6Yrg: bets $18.95 and is all-in
NYi6JFscYNrofSXy4sM+Yw: calls $18.95
*** SHOW DOWN ***
+W/hy0gBp0sJy8pjLz6Yrg: shows [9s Th] (high card Queen)
NYi6JFscYNrofSXy4sM+Yw: shows [4h Qs] (a pair of Queens)
NYi6JFscYNrofSXy4sM+Yw collected $69.40 from pot
*** SUMMARY ***
Total pot $69.90 | Rake $0.50
Board [Qh 2c 8d 3c 7h]
Seat 1: NYi6JFscYNrofSXy4sM+Yw (big blind) showed [4h Qs] and won ($69.40) with a pair of Queens
Seat 2: +W/hy0gBp0sJy8pjLz6Yrg (button) (small blind) showed [9s Th] and lost with high card Queen



PokerStars Game #59941057884:  Hold'em No Limit ($0.50/$1.00) - 2009/07/01 1:24:26 ET
Table 'Evb7VW0qfDhFkbgBL3gcqQ' 2-max Seat #2 is the button
Seat 1: NYi6JFscYNrofSXy4sM+Yw ($128.15 in chips)
Seat 2: AoEQlM/FNYM0d7Txn1TfBQ ($78 in chips)
AoEQlM/FNYM0d7Txn1TfBQ: posts small blind $0.50
NYi6JFscYNrofSXy4sM+Yw: posts big blind $1
*** HOLE CARDS ***
AoEQlM/FNYM0d7Txn1TfBQ: folds
NYi6JFscYNrofSXy4sM+Yw collected $1 from pot
*** SUMMARY ***
Total pot $1 | Rake $0
Seat 1: NYi6JFscYNrofSXy4sM+Yw (big blind) collected ($1)
Seat 2: AoEQlM/FNYM0d7Txn1TfBQ (button) (small blind) folded before Flop



PokerStars Game #59941058968:  Hold'em No Limit ($0.50/$1.00) - 2009/07/01 1:24:28 ET
Table 'jDQgUn1zGkyftPnHo0Awdw' 2-max Seat #1 is the button
Seat 1: a42+e5QB6s1kkG5FoSTZJw ($112.70 in chips)
Seat 2: q+vRKwm51mnr6kxX/161WQ ($85 in chips)
a42+e5QB6s1kkG5FoSTZJw: posts small blind $0.50
q+vRKwm51mnr6kxX/161WQ: posts big blind $1
*** HOLE CARDS ***
a42+e5QB6s1kkG5FoSTZJw: raises $1 to $2
q+vRKwm51mnr6kxX/161WQ: folds
a42+e5QB6s1kkG5FoSTZJw collected $2 from pot
a42+e5QB6s1kkG5FoSTZJw: doesn't show hand
*** SUMMARY ***
Total pot $2 | Rake $0
Seat 1: a42+e5QB6s1kkG5FoSTZJw (button) (small blind) collected ($2)
Seat 2: q+vRKwm51mnr6kxX/161WQ (big blind) folded before Flop



PokerStars Game #59941058784:  Hold'em No Limit ($0.50/$1.00) - 2009/07/01 1:24:28 ET
Table 'W/wyObTiXZm+Ckkl3YxcSw' 6-max Seat #6 is the button
Seat 1: eUBBn2R56C1IQ6Cs/vitwg ($288.90 in chips)
Seat 2: oDiBRCaF0QVtd3kO6xZIXw ($152.05 in chips)
Seat 3: dxyNCn/qxfkGDUIf28Cbng ($66.30 in chips)
Seat 4: UBZQqpnJZdTYYY1FTb0rLA ($100 in chips)
Seat 5: +OrCjyw70oZhJiD22Mn+bg ($100 in chips)
Seat 6: b2a+5TkFf4xJN/Ihhma58Q ($48.95 in chips)
eUBBn2R56C1IQ6Cs/vitwg: posts small blind $0.50
oDiBRCaF0QVtd3kO6xZIXw: posts big blind $1
*** HOLE CARDS ***
dxyNCn/qxfkGDUIf28Cbng: folds
UBZQqpnJZdTYYY1FTb0rLA: folds
+OrCjyw70oZhJiD22Mn+bg: folds
b2a+5TkFf4xJN/Ihhma58Q: folds
eUBBn2R56C1IQ6Cs/vitwg: folds
oDiBRCaF0QVtd3kO6xZIXw collected $1 from pot
oDiBRCaF0QVtd3kO6xZIXw: doesn't show hand
*** SUMMARY ***
Total pot $1 | Rake $0
Seat 1: eUBBn2R56C1IQ6Cs/vitwg (small blind) folded before Flop
Seat 2: oDiBRCaF0QVtd3kO6xZIXw (big blind) collected ($1)
Seat 3: dxyNCn/qxfkGDUIf28Cbng folded before Flop (didn't bet)
Seat 4: UBZQqpnJZdTYYY1FTb0rLA folded before Flop (didn't bet)
Seat 5: +OrCjyw70oZhJiD22Mn+bg folded before Flop (didn't bet)
Seat 6: b2a+5TkFf4xJN/Ihhma58Q (button) folded before Flop (didn't bet)



PokerStars Game #59941059306:  Hold'em No Limit ($0.50/$1.00) - 2009/07/01 1:24:29 ET
Table 'QSIig7BLMc9wY/rgBechzw' 6-max Seat #3 is the button
Seat 1: Z2fXsGcjl+Eax+RzOgwOmg ($108 in chips)
Seat 2: mLOIkH/qmRa+mVujQIhBRg ($50.90 in chips)
Seat 3: +xW7QemQU0Fxs+4TnqBRow ($110 in chips)
Seat 4: +uSzP8Jwnw7sKfQ4s66b7w ($62.65 in chips)
Seat 5: lsLuWlcPA3Rh7kJVLzMh0Q ($100 in chips)
Seat 6: PxqfkAMdAWtkgbT+q2gciA ($45.85 in chips)
+uSzP8Jwnw7sKfQ4s66b7w: posts small blind $0.50
lsLuWlcPA3Rh7kJVLzMh0Q: posts big blind $1
*** HOLE CARDS ***
PxqfkAMdAWtkgbT+q2gciA: folds
Z2fXsGcjl+Eax+RzOgwOmg: raises $3 to $4
mLOIkH/qmRa+mVujQIhBRg: folds
+xW7QemQU0Fxs+4TnqBRow: folds
+uSzP8Jwnw7sKfQ4s66b7w: folds
lsLuWlcPA3Rh7kJVLzMh0Q: calls $3
*** FLOP *** [Kh 6d 9d]
lsLuWlcPA3Rh7kJVLzMh0Q: checks
Z2fXsGcjl+Eax+RzOgwOmg: bets $7
lsLuWlcPA3Rh7kJVLzMh0Q: folds
Z2fXsGcjl+Eax+RzOgwOmg collected $8.10 from pot
Z2fXsGcjl+Eax+RzOgwOmg: doesn't show hand
*** SUMMARY ***
Total pot $8.50 | Rake $0.40
Board [Kh 6d 9d]
Seat 1: Z2fXsGcjl+Eax+RzOgwOmg collected ($8.10)
Seat 2: mLOIkH/qmRa+mVujQIhBRg folded before Flop (didn't bet)
Seat 3: +xW7QemQU0Fxs+4TnqBRow (button) folded before Flop (didn't bet)
Seat 4: +uSzP8Jwnw7sKfQ4s66b7w (small blind) folded before Flop
Seat 5: lsLuWlcPA3Rh7kJVLzMh0Q (big blind) folded on the Flop
Seat 6: PxqfkAMdAWtkgbT+q2gciA folded before Flop (didn't bet)



PokerStars Game #59941059746:  Hold'em No Limit ($0.50/$1.00) - 2009/07/01 1:24:29 ET
Table '305hiksPPCCdC6V2LNsO5w' 6-max Seat #2 is the button
Seat 1: RTuDLJHh/9zPfBftoc9vsw ($16.50 in chips)
Seat 2: j7NIOHLZk7V2o9fOioO5ug ($126.35 in chips)
Seat 3: +zIVjZKLpcidfRHgVZW8lA ($16 in chips)
Seat 4: uJVSceLggtsrJya+WtmUEA ($223.65 in chips)
Seat 5: +Nt3OPk3XR9SKjZgm2CexQ ($114.15 in chips)
Seat 6: 9/Tq8dw7kWW68uN8bFupXg ($24.10 in chips)
+zIVjZKLpcidfRHgVZW8lA: posts small blind $0.50
uJVSceLggtsrJya+WtmUEA: posts big blind $1
*** HOLE CARDS ***
+Nt3OPk3XR9SKjZgm2CexQ: folds
9/Tq8dw7kWW68uN8bFupXg: raises $3 to $4
RTuDLJHh/9zPfBftoc9vsw: calls $4
j7NIOHLZk7V2o9fOioO5ug: folds
+zIVjZKLpcidfRHgVZW8lA: calls $3.50
uJVSceLggtsrJya+WtmUEA: folds
*** FLOP *** [8d Ad 8h]
+zIVjZKLpcidfRHgVZW8lA: checks
9/Tq8dw7kWW68uN8bFupXg: checks
RTuDLJHh/9zPfBftoc9vsw: checks
*** TURN *** [8d Ad 8h] [6s]
+zIVjZKLpcidfRHgVZW8lA: bets $6
9/Tq8dw7kWW68uN8bFupXg: raises $12 to $18
RTuDLJHh/9zPfBftoc9vsw: folds
+zIVjZKLpcidfRHgVZW8lA: calls $6 and is all-in
*** RIVER *** [8d Ad 8h 6s] [2c]
*** SHOW DOWN ***
+zIVjZKLpcidfRHgVZW8lA: shows [Ac Tc] (two pair, Aces and Eights)
9/Tq8dw7kWW68uN8bFupXg: mucks hand
+zIVjZKLpcidfRHgVZW8lA collected $35.20 from pot
*** SUMMARY ***
Total pot $37 | Rake $1.80
Board [8d Ad 8h 6s 2c]
Seat 1: RTuDLJHh/9zPfBftoc9vsw folded on the Turn
Seat 2: j7NIOHLZk7V2o9fOioO5ug (button) folded before Flop (didn't bet)
Seat 3: +zIVjZKLpcidfRHgVZW8lA (small blind) showed [Ac Tc] and won ($35.20) with two pair, Aces and Eights
Seat 4: uJVSceLggtsrJya+WtmUEA (big blind) folded before Flop
Seat 5: +Nt3OPk3XR9SKjZgm2CexQ folded before Flop (didn't bet)
Seat 6: 9/Tq8dw7kWW68uN8bFupXg mucked



PokerStars Game #59941061556:  Hold'em No Limit ($0.50/$1.00) - 2009/07/01 1:24:32 ET
Table 'Evb7VW0qfDhFkbgBL3gcqQ' 2-max Seat #1 is the button
Seat 1: NYi6JFscYNrofSXy4sM+Yw ($128.65 in chips)
Seat 2: AoEQlM/FNYM0d7Txn1TfBQ ($77.50 in chips)
NYi6JFscYNrofSXy4sM+Yw: posts small blind $0.50
AoEQlM/FNYM0d7Txn1TfBQ: posts big blind $1
*** HOLE CARDS ***
NYi6JFscYNrofSXy4sM+Yw: raises $2 to $3
AoEQlM/FNYM0d7Txn1TfBQ: raises $9 to $12
NYi6JFscYNrofSXy4sM+Yw: folds
AoEQlM/FNYM0d7Txn1TfBQ collected $6 from pot
AoEQlM/FNYM0d7Txn1TfBQ: doesn't show hand
*** SUMMARY ***
Total pot $6 | Rake $0
Seat 1: NYi6JFscYNrofSXy4sM+Yw (button) (small blind) folded before Flop
Seat 2: AoEQlM/FNYM0d7Txn1TfBQ (big blind) collected ($6)



PokerStars Game #59941062284:  Hold'em No Limit ($0.50/$1.00) - 2009/07/01 1:24:33 ET
Table 'fTlPiCj0utgzC/5io+I7ew' 6-max Seat #6 is the button
Seat 1: YMJG+F++3Aj6P8dAWda5fw ($94.05 in chips)
Seat 2: qVr1nl3dy2xXPqS8UpTDlA ($25.80 in chips)
Seat 3: Z2fXsGcjl+Eax+RzOgwOmg ($137.40 in chips)
Seat 4: uJVSceLggtsrJya+WtmUEA ($170.15 in chips)
Seat 5: XUk5GQsfNFpHvaToDZ0rZA ($45.65 in chips)
Seat 6: y27w5IK2WXqmYzS8OU0wKA ($100 in chips)
YMJG+F++3Aj6P8dAWda5fw: posts small blind $0.50
qVr1nl3dy2xXPqS8UpTDlA: posts big blind $1
*** HOLE CARDS ***
Z2fXsGcjl+Eax+RzOgwOmg: raises $3 to $4
uJVSceLggtsrJya+WtmUEA: folds
XUk5GQsfNFpHvaToDZ0rZA: folds
y27w5IK2WXqmYzS8OU0wKA: folds
YMJG+F++3Aj6P8dAWda5fw: folds
qVr1nl3dy2xXPqS8UpTDlA: calls $3
*** FLOP *** [8s 7s 8c]
qVr1nl3dy2xXPqS8UpTDlA: checks
Z2fXsGcjl+Eax+RzOgwOmg: bets $6
qVr1nl3dy2xXPqS8UpTDlA: folds
Z2fXsGcjl+Eax+RzOgwOmg collected $8.10 from pot
*** SUMMARY ***
Total pot $8.50 | Rake $0.40
Board [8s 7s 8c]
Seat 1: YMJG+F++3Aj6P8dAWda5fw (small blind) folded before Flop
Seat 2: qVr1nl3dy2xXPqS8UpTDlA (big blind) folded on the Flop
Seat 3: Z2fXsGcjl+Eax+RzOgwOmg collected ($8.10)
Seat 4: uJVSceLggtsrJya+WtmUEA folded before Flop (didn't bet)
Seat 5: XUk5GQsfNFpHvaToDZ0rZA folded before Flop (didn't bet)
Seat 6: y27w5IK2WXqmYzS8OU0wKA (button) folded before Flop (didn't bet)



PokerStars Game #59941062334:  Hold'em No Limit ($0.50/$1.00) - 2009/07/01 1:24:33 ET
Table 'O96CPOtvMBWP6kzuYDfdFA' 6-max Seat #2 is the button
Seat 1: 6alLXQIITA2EZ/lBeym8Dw ($122.75 in chips)
Seat 2: 4d1rWhpu8DzLmzMbR3QKyA ($116.10 in chips)
Seat 3: V89DGjxE171oPREEbAXiyg ($92.15 in chips)
Seat 4: /P4w1pHg2zHYg/4ubJ0dPw ($63.65 in chips)
Seat 5: G5ZSSN6RSON3gkNvk/SmYg ($100 in chips)
Seat 6: GYei5jXGWexiJYbAT2fELg ($28.05 in chips)
V89DGjxE171oPREEbAXiyg: posts small blind $0.50
/P4w1pHg2zHYg/4ubJ0dPw: posts big blind $1
*** HOLE CARDS ***
G5ZSSN6RSON3gkNvk/SmYg: folds
GYei5jXGWexiJYbAT2fELg: folds
6alLXQIITA2EZ/lBeym8Dw: folds
4d1rWhpu8DzLmzMbR3QKyA: folds
V89DGjxE171oPREEbAXiyg: folds
/P4w1pHg2zHYg/4ubJ0dPw collected $1 from pot
*** SUMMARY ***
Total pot $1 | Rake $0
Seat 1: 6alLXQIITA2EZ/lBeym8Dw folded before Flop (didn't bet)
Seat 2: 4d1rWhpu8DzLmzMbR3QKyA (button) folded before Flop (didn't bet)
Seat 3: V89DGjxE171oPREEbAXiyg (small blind) folded before Flop
Seat 4: /P4w1pHg2zHYg/4ubJ0dPw (big blind) collected ($1)
Seat 5: G5ZSSN6RSON3gkNvk/SmYg folded before Flop (didn't bet)
Seat 6: GYei5jXGWexiJYbAT2fELg folded before Flop (didn't bet)



PokerStars Game #59941063548:  Hold'em No Limit ($0.50/$1.00) - 2009/07/01 1:24:35 ET
Table 'pHrhryH8jPNdQfY62f8v+g' 6-max Seat #1 is the button
Seat 1: 4d1rWhpu8DzLmzMbR3QKyA ($133.25 in chips)
Seat 2: JwCcjZl0bjJzG7hmE0dnTA ($104.65 in chips)
Seat 3: 8oS5O7iD/qnFXFXJrGIgNQ ($104.60 in chips)
Seat 4: 1f3beyIML24UqEMTbWy93g ($48.70 in chips)
Seat 5: r1/R7y0Ortgoz4lccgW8VA ($13.75 in chips)
Seat 6: xAU6q2/cwmby2sxmA8VcmA ($203.60 in chips)
JwCcjZl0bjJzG7hmE0dnTA: posts small blind $0.50
8oS5O7iD/qnFXFXJrGIgNQ: posts big blind $1
*** HOLE CARDS ***
1f3beyIML24UqEMTbWy93g: folds
r1/R7y0Ortgoz4lccgW8VA: folds
xAU6q2/cwmby2sxmA8VcmA: folds
4d1rWhpu8DzLmzMbR3QKyA: folds
JwCcjZl0bjJzG7hmE0dnTA: folds
8oS5O7iD/qnFXFXJrGIgNQ collected $1 from pot
*** SUMMARY ***
Total pot $1 | Rake $0
Seat 1: 4d1rWhpu8DzLmzMbR3QKyA (button) folded before Flop (didn't bet)
Seat 2: JwCcjZl0bjJzG7hmE0dnTA (small blind) folded before Flop
Seat 3: 8oS5O7iD/qnFXFXJrGIgNQ (big blind) collected ($1)
Seat 4: 1f3beyIML24UqEMTbWy93g folded before Flop (didn't bet)
Seat 5: r1/R7y0Ortgoz4lccgW8VA folded before Flop (didn't bet)
Seat 6: xAU6q2/cwmby2sxmA8VcmA folded before Flop (didn't bet)



PokerStars Game #59941064316:  Hold'em No Limit ($0.50/$1.00) - 2009/07/01 1:24:37 ET
Table '/RZcOwpZpHQ+OwPwjsbnRw' 6-max Seat #6 is the button
Seat 1: +uSzP8Jwnw7sKfQ4s66b7w ($48.75 in chips)
Seat 2: Z2fXsGcjl+Eax+RzOgwOmg ($103 in chips)
Seat 3: 6hLdALbOlkzGIrc53QKtPw ($22.70 in chips)
Seat 4: j7NIOHLZk7V2o9fOioO5ug ($101.50 in chips)
Seat 5: wx3sQGkVi2x9wJXuWNHPBw ($166.05 in chips)
Seat 6: o3YLm/rSY916m/on1VjXPA ($200.50 in chips)
+uSzP8Jwnw7sKfQ4s66b7w: posts small blind $0.50
Z2fXsGcjl+Eax+RzOgwOmg: posts big blind $1
*** HOLE CARDS ***
6hLdALbOlkzGIrc53QKtPw: folds
j7NIOHLZk7V2o9fOioO5ug: folds
wx3sQGkVi2x9wJXuWNHPBw: folds
o3YLm/rSY916m/on1VjXPA: folds
+uSzP8Jwnw7sKfQ4s66b7w: folds
Z2fXsGcjl+Eax+RzOgwOmg collected $1 from pot
Z2fXsGcjl+Eax+RzOgwOmg: doesn't show hand
*** SUMMARY ***
Total pot $1 | Rake $0
Seat 1: +uSzP8Jwnw7sKfQ4s66b7w (small blind) folded before Flop
Seat 2: Z2fXsGcjl+Eax+RzOgwOmg (big blind) collected ($1)
Seat 3: 6hLdALbOlkzGIrc53QKtPw folded before Flop (didn't bet)
Seat 4: j7NIOHLZk7V2o9fOioO5ug folded before Flop (didn't bet)
Seat 5: wx3sQGkVi2x9wJXuWNHPBw folded before Flop (didn't bet)
Seat 6: o3YLm/rSY916m/on1VjXPA (button) folded before Flop (didn't bet)



PokerStars Game #59941064278:  Hold'em No Limit ($0.50/$1.00) - 2009/07/01 1:24:37 ET
Table 'jDQgUn1zGkyftPnHo0Awdw' 2-max Seat #2 is the button
Seat 1: a42+e5QB6s1kkG5FoSTZJw ($113.70 in chips)
Seat 2: q+vRKwm51mnr6kxX/161WQ ($84 in chips)
q+vRKwm51mnr6kxX/161WQ: posts small blind $0.50
a42+e5QB6s1kkG5FoSTZJw: posts big blind $1
*** HOLE CARDS ***
q+vRKwm51mnr6kxX/161WQ: raises $2 to $3
a42+e5QB6s1kkG5FoSTZJw: calls $2
*** FLOP *** [2h Jc 7d]
a42+e5QB6s1kkG5FoSTZJw: checks
q+vRKwm51mnr6kxX/161WQ: checks
*** TURN *** [2h Jc 7d] [Tc]
a42+e5QB6s1kkG5FoSTZJw: checks
q+vRKwm51mnr6kxX/161WQ: checks
*** RIVER *** [2h Jc 7d Tc] [Ac]
a42+e5QB6s1kkG5FoSTZJw: checks
q+vRKwm51mnr6kxX/161WQ: checks
*** SHOW DOWN ***
a42+e5QB6s1kkG5FoSTZJw: shows [6s 7c] (a pair of Sevens)
q+vRKwm51mnr6kxX/161WQ: shows [7s Kc] (a pair of Sevens - Ace+King kicker)
q+vRKwm51mnr6kxX/161WQ collected $5.70 from pot
*** SUMMARY ***
Total pot $6 | Rake $0.30
Board [2h Jc 7d Tc Ac]
Seat 1: a42+e5QB6s1kkG5FoSTZJw (big blind) showed [6s 7c] and lost with a pair of Sevens
Seat 2: q+vRKwm51mnr6kxX/161WQ (button) (small blind) showed [7s Kc] and won ($5.70) with a pair of Sevens



PokerStars Game #59941064148:  Hold'em No Limit ($0.50/$1.00) - 2009/07/01 1:24:37 ET
Table '8jIjWCPY0NGprquL+xcMFg' 9-max Seat #7 is the button
Seat 1: tU883G5KFwdH+p2tFuGYtw ($64.20 in chips)
Seat 2: 7VpIzVwja9q3vCCNM7gRrg ($54.65 in chips)
Seat 3: myIxN7otsyr846M539YR8Q ($19.50 in chips)
Seat 4: XLnHQ8GEI3bUQAfNjJuO5Q ($110.40 in chips)
Seat 6: GTQkFJtSkbVbnGCktp6e3g ($100.50 in chips)
Seat 7: O5Go3jrzbQWxRB6ESK+Ptg ($57.75 in chips)
Seat 8: eI48VADSCFoNZBx4T9qs2w ($15.95 in chips)
Seat 9: DDzMn3tzCgfGf298Xxt5Iw ($15.85 in chips)
eI48VADSCFoNZBx4T9qs2w: posts small blind $0.50
DDzMn3tzCgfGf298Xxt5Iw: posts big blind $1
3obndzTJ6fECz8+wWhMd1w: sits out
*** HOLE CARDS ***
tU883G5KFwdH+p2tFuGYtw: folds
7VpIzVwja9q3vCCNM7gRrg: folds
myIxN7otsyr846M539YR8Q: folds
XLnHQ8GEI3bUQAfNjJuO5Q: calls $1
GTQkFJtSkbVbnGCktp6e3g: folds
O5Go3jrzbQWxRB6ESK+Ptg: folds
eI48VADSCFoNZBx4T9qs2w: raises $2 to $3
DDzMn3tzCgfGf298Xxt5Iw: folds
XLnHQ8GEI3bUQAfNjJuO5Q: calls $2
*** FLOP *** [Qh 8c Kh]
eI48VADSCFoNZBx4T9qs2w: bets $3
XLnHQ8GEI3bUQAfNjJuO5Q: calls $3
*** TURN *** [Qh 8c Kh] [Th]
eI48VADSCFoNZBx4T9qs2w: bets $9.95 and is all-in
XLnHQ8GEI3bUQAfNjJuO5Q: calls $9.95
*** RIVER *** [Qh 8c Kh Th] [9s]
*** SHOW DOWN ***
eI48VADSCFoNZBx4T9qs2w: shows [6d As] (high card Ace)
XLnHQ8GEI3bUQAfNjJuO5Q: shows [Ah 3d] (high card Ace)
eI48VADSCFoNZBx4T9qs2w collected $15.65 from pot
XLnHQ8GEI3bUQAfNjJuO5Q collected $15.65 from pot
XLnHQ8GEI3bUQAfNjJuO5Q is sitting out
*** SUMMARY ***
Total pot $32.90 | Rake $1.60
Board [Qh 8c Kh Th 9s]
Seat 1: tU883G5KFwdH+p2tFuGYtw folded before Flop (didn't bet)
Seat 2: 7VpIzVwja9q3vCCNM7gRrg folded before Flop (didn't bet)
Seat 3: myIxN7otsyr846M539YR8Q folded before Flop (didn't bet)
Seat 4: XLnHQ8GEI3bUQAfNjJuO5Q showed [Ah 3d] and won ($15.65) with high card Ace
Seat 6: GTQkFJtSkbVbnGCktp6e3g folded before Flop (didn't bet)
Seat 7: O5Go3jrzbQWxRB6ESK+Ptg (button) folded before Flop (didn't bet)
Seat 8: eI48VADSCFoNZBx4T9qs2w (small blind) showed [6d As] and won ($15.65) with high card Ace
Seat 9: DDzMn3tzCgfGf298Xxt5Iw (big blind) folded before Flop



PokerStars Game #59941065314:  Hold'em No Limit ($0.50/$1.00) - 2009/07/01 1:24:39 ET
Table 'MUPc8FEpe/nR0BKSeReX6Q' 6-max Seat #4 is the button
Seat 1: qhkK6+yCciTRd+rCFEbnEQ ($83.20 in chips)
Seat 2: xAU6q2/cwmby2sxmA8VcmA ($111.70 in chips)
Seat 3: wx3sQGkVi2x9wJXuWNHPBw ($287.50 in chips)
Seat 4: ZA1bp6g8IwtTxkUE4eCjDQ ($52.25 in chips)
Seat 5: y27w5IK2WXqmYzS8OU0wKA ($104.55 in chips)
Seat 6: oxnw0GLLpFanjhGkxfRSqA ($76.40 in chips)
y27w5IK2WXqmYzS8OU0wKA: posts small blind $0.50
oxnw0GLLpFanjhGkxfRSqA: posts big blind $1
*** HOLE CARDS ***
qhkK6+yCciTRd+rCFEbnEQ: folds
xAU6q2/cwmby2sxmA8VcmA: folds
wx3sQGkVi2x9wJXuWNHPBw: folds
ZA1bp6g8IwtTxkUE4eCjDQ: folds
y27w5IK2WXqmYzS8OU0wKA: folds
oxnw0GLLpFanjhGkxfRSqA collected $1 from pot
*** SUMMARY ***
Total pot $1 | Rake $0
Seat 1: qhkK6+yCciTRd+rCFEbnEQ folded before Flop (didn't bet)
Seat 2: xAU6q2/cwmby2sxmA8VcmA folded before Flop (didn't bet)
Seat 3: wx3sQGkVi2x9wJXuWNHPBw folded before Flop (didn't bet)
Seat 4: ZA1bp6g8IwtTxkUE4eCjDQ (button) folded before Flop (didn't bet)
Seat 5: y27w5IK2WXqmYzS8OU0wKA (small blind) folded before Flop
Seat 6: oxnw0GLLpFanjhGkxfRSqA (big blind) collected ($1)



PokerStars Game #59941065294:  Hold'em No Limit ($0.50/$1.00) - 2009/07/01 1:24:39 ET
Table 'hugOjcwJvzEwZbK7tyiWuQ' 9-max Seat #1 is the button
Seat 1: S3Ex8K7v6xm5jqjRM7Fl3w ($18.50 in chips)
Seat 2: r27C1nIV4NS4+qbnrgBQSw ($274.20 in chips)
Seat 4: UWB3oeddt/GObx2Mix2Anw ($187.60 in chips)
Seat 6: gUUvmqdVlmvpal6B8nYrmg ($107.95 in chips)
Seat 7: FL3MrLspcF23LYvC4ipBOA ($117.30 in chips)
Seat 8: /zy+DB4S5fUQUSfZWFzYGw ($115.75 in chips)
Seat 9: W8P9bUKCs43TO1xHm0dL6w ($111.50 in chips)
r27C1nIV4NS4+qbnrgBQSw: posts small blind $0.50
UWB3oeddt/GObx2Mix2Anw: posts big blind $1
*** HOLE CARDS ***
gUUvmqdVlmvpal6B8nYrmg: folds
FL3MrLspcF23LYvC4ipBOA: folds
/zy+DB4S5fUQUSfZWFzYGw: raises $3 to $4
W8P9bUKCs43TO1xHm0dL6w: folds
S3Ex8K7v6xm5jqjRM7Fl3w: folds
r27C1nIV4NS4+qbnrgBQSw: folds
UWB3oeddt/GObx2Mix2Anw: calls $3
*** FLOP *** [Kd Jd 3s]
UWB3oeddt/GObx2Mix2Anw: checks
/zy+DB4S5fUQUSfZWFzYGw: bets $6
UWB3oeddt/GObx2Mix2Anw: folds
/zy+DB4S5fUQUSfZWFzYGw collected $8.10 from pot
*** SUMMARY ***
Total pot $8.50 | Rake $0.40
Board [Kd Jd 3s]
Seat 1: S3Ex8K7v6xm5jqjRM7Fl3w (button) folded before Flop (didn't bet)
Seat 2: r27C1nIV4NS4+qbnrgBQSw (small blind) folded before Flop
Seat 4: UWB3oeddt/GObx2Mix2Anw (big blind) folded on the Flop
Seat 6: gUUvmqdVlmvpal6B8nYrmg folded before Flop (didn't bet)
Seat 7: FL3MrLspcF23LYvC4ipBOA folded before Flop (didn't bet)
Seat 8: /zy+DB4S5fUQUSfZWFzYGw collected ($8.10)
Seat 9: W8P9bUKCs43TO1xHm0dL6w folded before Flop (didn't bet)



PokerStars Game #59941065158:  Hold'em No Limit ($0.50/$1.00) - 2009/07/01 1:24:39 ET
Table 'hdVBCnDy5t2X9dZo0AvD9w' 9-max Seat #9 is the button
Seat 1: sa/cZBFh73L9TapFXpn3BA ($84.45 in chips)
Seat 2: Ogn4JDV3mp4ZDKO49IFzKA ($19.50 in chips)
Seat 3: 1862487932 ($100 in chips)
Seat 5: H+DVy3Ei8L1UKS2tVOtJcw ($111.30 in chips)
Seat 6: bJckevFOcg//s0qyMQI6sQ ($105.60 in chips)
Seat 8: gUUvmqdVlmvpal6B8nYrmg ($143.40 in chips)
Seat 9: AMkLbywdoc0K30BTzaIfTQ ($181.90 in chips)
sa/cZBFh73L9TapFXpn3BA: posts small blind $0.50
YvSugbFKWSuAYx9iokQwUQ has returned
Ogn4JDV3mp4ZDKO49IFzKA: posts big blind $1
laA8va+Yv8WuMqT1zdR91g: sits out
*** HOLE CARDS ***
1862487932: folds
H+DVy3Ei8L1UKS2tVOtJcw: folds
bJckevFOcg//s0qyMQI6sQ: folds
gUUvmqdVlmvpal6B8nYrmg: folds
AMkLbywdoc0K30BTzaIfTQ: folds
sa/cZBFh73L9TapFXpn3BA: calls $0.50
Ogn4JDV3mp4ZDKO49IFzKA: checks
*** FLOP *** [9c 3d 2d]
sa/cZBFh73L9TapFXpn3BA: bets $2
Ogn4JDV3mp4ZDKO49IFzKA: folds
sa/cZBFh73L9TapFXpn3BA collected $1.90 from pot
sa/cZBFh73L9TapFXpn3BA: doesn't show hand
*** SUMMARY ***
Total pot $2 | Rake $0.10
Board [9c 3d 2d]
Seat 1: sa/cZBFh73L9TapFXpn3BA (small blind) collected ($1.90)
Seat 2: Ogn4JDV3mp4ZDKO49IFzKA (big blind) folded on the Flop
Seat 3: 1862487932 folded before Flop (didn't bet)
Seat 5: H+DVy3Ei8L1UKS2tVOtJcw folded before Flop (didn't bet)
Seat 6: bJckevFOcg//s0qyMQI6sQ folded before Flop (didn't bet)
Seat 8: gUUvmqdVlmvpal6B8nYrmg folded before Flop (didn't bet)
Seat 9: AMkLbywdoc0K30BTzaIfTQ (button) folded before Flop (didn't bet)



PokerStars Game #59941068644:  Hold'em No Limit ($0.50/$1.00) - 2009/07/01 1:24:45 ET
Table 'MNvFfRVQNka/oY+Z5aMbZQ' 2-max Seat #1 is the button
Seat 1: DaZnoWHjO897dnh0CL2lVg ($64.40 in chips)
Seat 2: mgi+mjKb1Sc3CCs7TlfoCw ($57.35 in chips)
DaZnoWHjO897dnh0CL2lVg: posts small blind $0.50
mgi+mjKb1Sc3CCs7TlfoCw: posts big blind $1
*** HOLE CARDS ***
DaZnoWHjO897dnh0CL2lVg: calls $0.50
mgi+mjKb1Sc3CCs7TlfoCw: raises $4 to $5
DaZnoWHjO897dnh0CL2lVg: folds
mgi+mjKb1Sc3CCs7TlfoCw collected $2 from pot
mgi+mjKb1Sc3CCs7TlfoCw: doesn't show hand
*** SUMMARY ***
Total pot $2 | Rake $0
Seat 1: DaZnoWHjO897dnh0CL2lVg (button) (small blind) folded before Flop
Seat 2: mgi+mjKb1Sc3CCs7TlfoCw (big blind) collected ($2)



PokerStars Game #59941069738:  Hold'em No Limit ($0.50/$1.00) - 2009/07/01 1:24:46 ET
Table 'CASNP0uy1C+jGLml/I4PtA' 9-max Seat #7 is the button
Seat 1: tkdBeXTJlFsZdioidNqLow ($61.50 in chips)
Seat 2: LUsAYklr0mQkiq7ASOyD9A ($62.50 in chips)
Seat 3: bJckevFOcg//s0qyMQI6sQ ($100 in chips)
Seat 4: B/G0GJacqZ8K59/ZVdq4kQ ($69.15 in chips)
Seat 5: Jjc7EHWzs4//xUAjJ0UWoA ($10.50 in chips)
Seat 6: FJEywSpo5JbRKByzmweboA ($100 in chips)
Seat 7: S3Ex8K7v6xm5jqjRM7Fl3w ($22 in chips)
Seat 8: L9njYvloJ1NdXjP8edHEAg ($104.95 in chips)
Seat 9: Pp/KTcXkfZKKUHkjyaLTdg ($20 in chips)
L9njYvloJ1NdXjP8edHEAg: posts small blind $0.50
Pp/KTcXkfZKKUHkjyaLTdg: posts big blind $1
*** HOLE CARDS ***
tkdBeXTJlFsZdioidNqLow: folds
LUsAYklr0mQkiq7ASOyD9A: folds
bJckevFOcg//s0qyMQI6sQ: folds
B/G0GJacqZ8K59/ZVdq4kQ: folds
Jjc7EHWzs4//xUAjJ0UWoA: folds
FJEywSpo5JbRKByzmweboA: folds
S3Ex8K7v6xm5jqjRM7Fl3w: folds
L9njYvloJ1NdXjP8edHEAg: folds
Pp/KTcXkfZKKUHkjyaLTdg collected $1 from pot
Pp/KTcXkfZKKUHkjyaLTdg: doesn't show hand
*** SUMMARY ***
Total pot $1 | Rake $0
Seat 1: tkdBeXTJlFsZdioidNqLow folded before Flop (didn't bet)
Seat 2: LUsAYklr0mQkiq7ASOyD9A folded before Flop (didn't bet)
Seat 3: bJckevFOcg//s0qyMQI6sQ folded before Flop (didn't bet)
Seat 4: B/G0GJacqZ8K59/ZVdq4kQ folded before Flop (didn't bet)
Seat 5: Jjc7EHWzs4//xUAjJ0UWoA folded before Flop (didn't bet)
Seat 6: FJEywSpo5JbRKByzmweboA folded before Flop (didn't bet)
Seat 7: S3Ex8K7v6xm5jqjRM7Fl3w (button) folded before Flop (didn't bet)
Seat 8: L9njYvloJ1NdXjP8edHEAg (small blind) folded before Flop
Seat 9: Pp/KTcXkfZKKUHkjyaLTdg (big blind) collected ($1)



PokerStars Game #59941070340:  Hold'em No Limit ($0.50/$1.00) - 2009/07/01 1:24:47 ET
Table 'ZFWj23PMihdwrNWv41OG/Q' 9-max Seat #6 is the button
Seat 1: yAbu2QsRPVcjPbqlf/jDxw ($123.85 in chips)
Seat 2: ARfmgHcEUKh68laBZy4veA ($71.80 in chips)
Seat 3: G9Fo2TZCN7HI43Po4zSN3A ($117.95 in chips)
Seat 4: D+W9Me7w6Hcx/WRUSKV0dw ($25.10 in chips)
Seat 5: tkdBeXTJlFsZdioidNqLow ($112.75 in chips)
Seat 6: 3obndzTJ6fECz8+wWhMd1w ($17 in chips)
Seat 7: 2uQqi2bcuMs+2q7ej+tN+Q ($91 in chips)
Seat 8: 997ViqAtWn1FPjJqcffwcA ($120.10 in chips)
2uQqi2bcuMs+2q7ej+tN+Q: posts small blind $0.50
997ViqAtWn1FPjJqcffwcA: posts big blind $1
6XkTu4ahxzHnvjjc1R8YjQ: sits out
*** HOLE CARDS ***
yAbu2QsRPVcjPbqlf/jDxw: folds
ARfmgHcEUKh68laBZy4veA: folds
G9Fo2TZCN7HI43Po4zSN3A: folds
D+W9Me7w6Hcx/WRUSKV0dw: folds
tkdBeXTJlFsZdioidNqLow: raises $2 to $3
3obndzTJ6fECz8+wWhMd1w: raises $14 to $17 and is all-in
2uQqi2bcuMs+2q7ej+tN+Q: folds
997ViqAtWn1FPjJqcffwcA: folds
tkdBeXTJlFsZdioidNqLow: folds
3obndzTJ6fECz8+wWhMd1w collected $7.50 from pot
3obndzTJ6fECz8+wWhMd1w: doesn't show hand
*** SUMMARY ***
Total pot $7.50 | Rake $0
Seat 1: yAbu2QsRPVcjPbqlf/jDxw folded before Flop (didn't bet)
Seat 2: ARfmgHcEUKh68laBZy4veA folded before Flop (didn't bet)
Seat 3: G9Fo2TZCN7HI43Po4zSN3A folded before Flop (didn't bet)
Seat 4: D+W9Me7w6Hcx/WRUSKV0dw folded before Flop (didn't bet)
Seat 5: tkdBeXTJlFsZdioidNqLow folded before Flop
Seat 6: 3obndzTJ6fECz8+wWhMd1w (button) collected ($7.50)
Seat 7: 2uQqi2bcuMs+2q7ej+tN+Q (small blind) folded before Flop
Seat 8: 997ViqAtWn1FPjJqcffwcA (big blind) folded before Flop



PokerStars Game #59941070780:  Hold'em No Limit ($0.50/$1.00) - 2009/07/01 1:24:48 ET
Table 'Evb7VW0qfDhFkbgBL3gcqQ' 2-max Seat #2 is the button
Seat 1: NYi6JFscYNrofSXy4sM+Yw ($125.65 in chips)
Seat 2: AoEQlM/FNYM0d7Txn1TfBQ ($80.50 in chips)
AoEQlM/FNYM0d7Txn1TfBQ: posts small blind $0.50
NYi6JFscYNrofSXy4sM+Yw: posts big blind $1
*** HOLE CARDS ***
AoEQlM/FNYM0d7Txn1TfBQ: calls $0.50
NYi6JFscYNrofSXy4sM+Yw: checks
*** FLOP *** [7s 8s 9s]
NYi6JFscYNrofSXy4sM+Yw: bets $2
AoEQlM/FNYM0d7Txn1TfBQ: calls $2
*** TURN *** [7s 8s 9s] [Jh]
NYi6JFscYNrofSXy4sM+Yw: checks
AoEQlM/FNYM0d7Txn1TfBQ: checks
*** RIVER *** [7s 8s 9s Jh] [5h]
NYi6JFscYNrofSXy4sM+Yw: checks
AoEQlM/FNYM0d7Txn1TfBQ: bets $3
NYi6JFscYNrofSXy4sM+Yw: folds
AoEQlM/FNYM0d7Txn1TfBQ collected $5.75 from pot
*** SUMMARY ***
Total pot $6 | Rake $0.25
Board [7s 8s 9s Jh 5h]
Seat 1: NYi6JFscYNrofSXy4sM+Yw (big blind) folded on the River
Seat 2: AoEQlM/FNYM0d7Txn1TfBQ (button) (small blind) collected ($5.75)



PokerStars Game #59941071026:  Hold'em No Limit ($0.50/$1.00) - 2009/07/01 1:24:49 ET
Table '/RZcOwpZpHQ+OwPwjsbnRw' 6-max Seat #1 is the button
Seat 1: +uSzP8Jwnw7sKfQ4s66b7w ($48.25 in chips)
Seat 2: Z2fXsGcjl+Eax+RzOgwOmg ($103.50 in chips)
Seat 3: 6hLdALbOlkzGIrc53QKtPw ($22.70 in chips)
Seat 4: j7NIOHLZk7V2o9fOioO5ug ($101.50 in chips)
Seat 5: wx3sQGkVi2x9wJXuWNHPBw ($166.05 in chips)
Seat 6: o3YLm/rSY916m/on1VjXPA ($200.50 in chips)
Z2fXsGcjl+Eax+RzOgwOmg: posts small blind $0.50
6hLdALbOlkzGIrc53QKtPw: posts big blind $1
*** HOLE CARDS ***
j7NIOHLZk7V2o9fOioO5ug: raises $2 to $3
wx3sQGkVi2x9wJXuWNHPBw: folds
o3YLm/rSY916m/on1VjXPA: folds
+uSzP8Jwnw7sKfQ4s66b7w: folds
Z2fXsGcjl+Eax+RzOgwOmg: folds
6hLdALbOlkzGIrc53QKtPw: folds
j7NIOHLZk7V2o9fOioO5ug collected $2.50 from pot
j7NIOHLZk7V2o9fOioO5ug: doesn't show hand
*** SUMMARY ***
Total pot $2.50 | Rake $0
Seat 1: +uSzP8Jwnw7sKfQ4s66b7w (button) folded before Flop (didn't bet)
Seat 2: Z2fXsGcjl+Eax+RzOgwOmg (small blind) folded before Flop
Seat 3: 6hLdALbOlkzGIrc53QKtPw (big blind) folded before Flop
Seat 4: j7NIOHLZk7V2o9fOioO5ug collected ($2.50)
Seat 5: wx3sQGkVi2x9wJXuWNHPBw folded before Flop (didn't bet)
Seat 6: o3YLm/rSY916m/on1VjXPA folded before Flop (didn't bet)



PokerStars Game #59941071296:  Hold'em No Limit ($0.50/$1.00) - 2009/07/01 1:24:49 ET
Table 'W/wyObTiXZm+Ckkl3YxcSw' 6-max Seat #1 is the button
Seat 1: eUBBn2R56C1IQ6Cs/vitwg ($288.40 in chips)
Seat 2: oDiBRCaF0QVtd3kO6xZIXw ($152.55 in chips)
Seat 3: dxyNCn/qxfkGDUIf28Cbng ($66.30 in chips)
Seat 4: UBZQqpnJZdTYYY1FTb0rLA ($100 in chips)
Seat 5: +OrCjyw70oZhJiD22Mn+bg ($100 in chips)
Seat 6: b2a+5TkFf4xJN/Ihhma58Q ($48.95 in chips)
oDiBRCaF0QVtd3kO6xZIXw: posts small blind $0.50
dxyNCn/qxfkGDUIf28Cbng: posts big blind $1
*** HOLE CARDS ***
UBZQqpnJZdTYYY1FTb0rLA: folds
+OrCjyw70oZhJiD22Mn+bg: folds
b2a+5TkFf4xJN/Ihhma58Q: folds
eUBBn2R56C1IQ6Cs/vitwg: raises $2 to $3
oDiBRCaF0QVtd3kO6xZIXw: folds
dxyNCn/qxfkGDUIf28Cbng: folds
eUBBn2R56C1IQ6Cs/vitwg collected $2.50 from pot
*** SUMMARY ***
Total pot $2.50 | Rake $0
Seat 1: eUBBn2R56C1IQ6Cs/vitwg (button) collected ($2.50)
Seat 2: oDiBRCaF0QVtd3kO6xZIXw (small blind) folded before Flop
Seat 3: dxyNCn/qxfkGDUIf28Cbng (big blind) folded before Flop
Seat 4: UBZQqpnJZdTYYY1FTb0rLA folded before Flop (didn't bet)
Seat 5: +OrCjyw70oZhJiD22Mn+bg folded before Flop (didn't bet)
Seat 6: b2a+5TkFf4xJN/Ihhma58Q folded before Flop (didn't bet)



PokerStars Game #59941071136:  Hold'em No Limit ($0.50/$1.00) - 2009/07/01 1:24:49 ET
Table 'cBDNutyLBKEk9+ptwsKmTw' 6-max Seat #3 is the button
Seat 1: xAU6q2/cwmby2sxmA8VcmA ($253 in chips)
Seat 2: 5lY8d6Cnm4HUkt/8FZSj4g ($30.55 in chips)
Seat 3: G5ZSSN6RSON3gkNvk/SmYg ($110.40 in chips)
Seat 4: 3q7F5QtzC30pSrn0nl9i+A ($16 in chips)
Seat 5: hpxXcmRkXXI9HE5+5/j/0Q ($100 in chips)
Seat 6: QHvTZcrKe6+maWUfVjP29Q ($152 in chips)
3q7F5QtzC30pSrn0nl9i+A: posts small blind $0.50
hpxXcmRkXXI9HE5+5/j/0Q: posts big blind $1
*** HOLE CARDS ***
QHvTZcrKe6+maWUfVjP29Q: folds
xAU6q2/cwmby2sxmA8VcmA: raises $3 to $4
5lY8d6Cnm4HUkt/8FZSj4g: calls $4
G5ZSSN6RSON3gkNvk/SmYg: folds
3q7F5QtzC30pSrn0nl9i+A: raises $12 to $16 and is all-in
hpxXcmRkXXI9HE5+5/j/0Q: folds
xAU6q2/cwmby2sxmA8VcmA: raises $24 to $40
5lY8d6Cnm4HUkt/8FZSj4g: calls $26.55 and is all-in
*** FLOP *** [9h 3c Jd]
*** TURN *** [9h 3c Jd] [6c]
*** RIVER *** [9h 3c Jd 6c] [Td]
*** SHOW DOWN ***
xAU6q2/cwmby2sxmA8VcmA: shows [Ts Th] (three of a kind, Tens)
5lY8d6Cnm4HUkt/8FZSj4g: mucks hand
xAU6q2/cwmby2sxmA8VcmA collected $28.55 from side pot
3q7F5QtzC30pSrn0nl9i+A: mucks hand
5lY8d6Cnm4HUkt/8FZSj4g leaves the table
xAU6q2/cwmby2sxmA8VcmA collected $46.55 from main pot
*** SUMMARY ***
Total pot $78.10 Main pot $46.55. Side pot $28.55. | Rake $3
Board [9h 3c Jd 6c Td]
Seat 1: xAU6q2/cwmby2sxmA8VcmA showed [Ts Th] and won ($75.10) with three of a kind, Tens
Seat 2: 5lY8d6Cnm4HUkt/8FZSj4g mucked
Seat 3: G5ZSSN6RSON3gkNvk/SmYg (button) folded before Flop (didn't bet)
Seat 4: 3q7F5QtzC30pSrn0nl9i+A (small blind) mucked
Seat 5: hpxXcmRkXXI9HE5+5/j/0Q (big blind) folded before Flop
Seat 6: QHvTZcrKe6+maWUfVjP29Q folded before Flop (didn't bet)



PokerStars Game #59941071144:  Hold'em No Limit ($0.50/$1.00) - 2009/07/01 1:24:49 ET
Table 'fZjVbKj9D8yOB+Rj7NaP/A' 9-max Seat #9 is the button
Seat 1: 9BZCcac3+McErkkSN2YScA ($102.75 in chips)
Seat 2: PTAFYDIUSsG+SArbxNl+Aw ($105.50 in chips)
Seat 3: yAbu2QsRPVcjPbqlf/jDxw ($101 in chips)
Seat 4: 997ViqAtWn1FPjJqcffwcA ($101 in chips)
Seat 5: PkGfq5xrSlNsujKaG/HF4Q ($100 in chips)
Seat 6: OvwYHV65yUbgdBjSmo1+5g ($36.95 in chips)
Seat 7: SyS20PAm3RpT6uLBsGkwOA ($120.05 in chips)
Seat 8: zDOE5r14tWqCf6xhuSHK6g ($52.90 in chips)
Seat 9: qheQay5YvP2DMAb3OUSxtw ($99 in chips)
9BZCcac3+McErkkSN2YScA: posts small blind $0.50
PTAFYDIUSsG+SArbxNl+Aw: posts big blind $1
*** HOLE CARDS ***
yAbu2QsRPVcjPbqlf/jDxw: folds
997ViqAtWn1FPjJqcffwcA: folds
PkGfq5xrSlNsujKaG/HF4Q: folds
OvwYHV65yUbgdBjSmo1+5g: folds
SyS20PAm3RpT6uLBsGkwOA: raises $4 to $5
zDOE5r14tWqCf6xhuSHK6g: folds
qheQay5YvP2DMAb3OUSxtw: folds
9BZCcac3+McErkkSN2YScA: folds
PTAFYDIUSsG+SArbxNl+Aw: folds
SyS20PAm3RpT6uLBsGkwOA collected $2.50 from pot
*** SUMMARY ***
Total pot $2.50 | Rake $0
Seat 1: 9BZCcac3+McErkkSN2YScA (small blind) folded before Flop
Seat 2: PTAFYDIUSsG+SArbxNl+Aw (big blind) folded before Flop
Seat 3: yAbu2QsRPVcjPbqlf/jDxw folded before Flop (didn't bet)
Seat 4: 997ViqAtWn1FPjJqcffwcA folded before Flop (didn't bet)
Seat 5: PkGfq5xrSlNsujKaG/HF4Q folded before Flop (didn't bet)
Seat 6: OvwYHV65yUbgdBjSmo1+5g folded before Flop (didn't bet)
Seat 7: SyS20PAm3RpT6uLBsGkwOA collected ($2.50)
Seat 8: zDOE5r14tWqCf6xhuSHK6g folded before Flop (didn't bet)
Seat 9: qheQay5YvP2DMAb3OUSxtw (button) folded before Flop (didn't bet)



PokerStars Game #59941072494:  Hold'em No Limit ($0.50/$1.00) - 2009/07/01 1:24:51 ET
Table 'iSx0wTgVb4o7MyZeOe06ZA' 9-max Seat #9 is the button
Seat 1: VPF+HjszMvUIpy0CHIwH3A ($16.50 in chips)
Seat 2: rFvc7K/96V9eGvYRfmpoUQ ($20 in chips)
Seat 3: /inIs/z/PcX+TniIFpaxpg ($17 in chips)
Seat 4: 0fXz44fzDo5QmhAaJCvFfA ($47.50 in chips)
Seat 5: 7rJvZYDzYT+lYOns8ZPL0w ($122.65 in chips)
Seat 6: Lik6kFnIxdZEESN5kBGZzA ($20 in chips)
Seat 7: w4NnqVr/Sfoj65ux/fEUyQ ($61.30 in chips)
Seat 8: gUUvmqdVlmvpal6B8nYrmg ($100 in chips)
Seat 9: mQADhUTC1xGjAJkD7PEg6A ($100 in chips)
VPF+HjszMvUIpy0CHIwH3A: posts small blind $0.50
rFvc7K/96V9eGvYRfmpoUQ: posts big blind $1
*** HOLE CARDS ***
/inIs/z/PcX+TniIFpaxpg: folds
0fXz44fzDo5QmhAaJCvFfA: folds
7rJvZYDzYT+lYOns8ZPL0w: folds
Lik6kFnIxdZEESN5kBGZzA: folds
w4NnqVr/Sfoj65ux/fEUyQ: folds
gUUvmqdVlmvpal6B8nYrmg: raises $1 to $2
mQADhUTC1xGjAJkD7PEg6A: folds
VPF+HjszMvUIpy0CHIwH3A: folds
rFvc7K/96V9eGvYRfmpoUQ: folds
rFvc7K/96V9eGvYRfmpoUQ leaves the table
gUUvmqdVlmvpal6B8nYrmg collected $2.50 from pot
*** SUMMARY ***
Total pot $2.50 | Rake $0
Seat 1: VPF+HjszMvUIpy0CHIwH3A (small blind) folded before Flop
Seat 2: rFvc7K/96V9eGvYRfmpoUQ (big blind) folded before Flop
Seat 3: /inIs/z/PcX+TniIFpaxpg folded before Flop (didn't bet)
Seat 4: 0fXz44fzDo5QmhAaJCvFfA folded before Flop (didn't bet)
Seat 5: 7rJvZYDzYT+lYOns8ZPL0w folded before Flop (didn't bet)
Seat 6: Lik6kFnIxdZEESN5kBGZzA folded before Flop (didn't bet)
Seat 7: w4NnqVr/Sfoj65ux/fEUyQ folded before Flop (didn't bet)
Seat 8: gUUvmqdVlmvpal6B8nYrmg collected ($2.50)
Seat 9: mQADhUTC1xGjAJkD7PEg6A (button) folded before Flop (didn't bet)



PokerStars Game #59941072818:  Hold'em No Limit ($0.50/$1.00) - 2009/07/01 1:24:52 ET
Table 'O96CPOtvMBWP6kzuYDfdFA' 6-max Seat #3 is the button
Seat 1: 6alLXQIITA2EZ/lBeym8Dw ($122.75 in chips)
Seat 2: 4d1rWhpu8DzLmzMbR3QKyA ($116.10 in chips)
Seat 3: V89DGjxE171oPREEbAXiyg ($91.65 in chips)
Seat 4: /P4w1pHg2zHYg/4ubJ0dPw ($64.15 in chips)
Seat 5: G5ZSSN6RSON3gkNvk/SmYg ($100 in chips)
Seat 6: GYei5jXGWexiJYbAT2fELg ($28.05 in chips)
/P4w1pHg2zHYg/4ubJ0dPw: posts small blind $0.50
G5ZSSN6RSON3gkNvk/SmYg: posts big blind $1
*** HOLE CARDS ***
GYei5jXGWexiJYbAT2fELg: calls $1
6alLXQIITA2EZ/lBeym8Dw: folds
4d1rWhpu8DzLmzMbR3QKyA: folds
V89DGjxE171oPREEbAXiyg: folds
/P4w1pHg2zHYg/4ubJ0dPw: folds
G5ZSSN6RSON3gkNvk/SmYg: checks
*** FLOP *** [5d 6d Kc]
G5ZSSN6RSON3gkNvk/SmYg: checks
GYei5jXGWexiJYbAT2fELg: bets $2
G5ZSSN6RSON3gkNvk/SmYg: folds
GYei5jXGWexiJYbAT2fELg collected $2.40 from pot
*** SUMMARY ***
Total pot $2.50 | Rake $0.10
Board [5d 6d Kc]
Seat 1: 6alLXQIITA2EZ/lBeym8Dw folded before Flop (didn't bet)
Seat 2: 4d1rWhpu8DzLmzMbR3QKyA folded before Flop (didn't bet)
Seat 3: V89DGjxE171oPREEbAXiyg (button) folded before Flop (didn't bet)
Seat 4: /P4w1pHg2zHYg/4ubJ0dPw (small blind) folded before Flop
Seat 5: G5ZSSN6RSON3gkNvk/SmYg (big blind) folded on the Flop
Seat 6: GYei5jXGWexiJYbAT2fELg collected ($2.40)



PokerStars Game #59941074680:  Hold'em No Limit ($0.50/$1.00) - 2009/07/01 1:24:55 ET
Table 'MUPc8FEpe/nR0BKSeReX6Q' 6-max Seat #5 is the button
Seat 1: qhkK6+yCciTRd+rCFEbnEQ ($83.20 in chips)
Seat 2: xAU6q2/cwmby2sxmA8VcmA ($111.70 in chips)
Seat 3: wx3sQGkVi2x9wJXuWNHPBw ($287.50 in chips)
Seat 4: ZA1bp6g8IwtTxkUE4eCjDQ ($52.25 in chips)
Seat 5: y27w5IK2WXqmYzS8OU0wKA ($104.05 in chips)
Seat 6: oxnw0GLLpFanjhGkxfRSqA ($76.90 in chips)
oxnw0GLLpFanjhGkxfRSqA: posts small blind $0.50
qhkK6+yCciTRd+rCFEbnEQ: posts big blind $1
*** HOLE CARDS ***
xAU6q2/cwmby2sxmA8VcmA: raises $3 to $4
wx3sQGkVi2x9wJXuWNHPBw: folds
ZA1bp6g8IwtTxkUE4eCjDQ: folds
y27w5IK2WXqmYzS8OU0wKA: folds
oxnw0GLLpFanjhGkxfRSqA: calls $3.50
qhkK6+yCciTRd+rCFEbnEQ: folds
*** FLOP *** [5h Kd 3d]
oxnw0GLLpFanjhGkxfRSqA: checks
xAU6q2/cwmby2sxmA8VcmA: bets $6
oxnw0GLLpFanjhGkxfRSqA: calls $6
*** TURN *** [5h Kd 3d] [Th]
oxnw0GLLpFanjhGkxfRSqA: checks
xAU6q2/cwmby2sxmA8VcmA: checks
*** RIVER *** [5h Kd 3d Th] [Ks]
oxnw0GLLpFanjhGkxfRSqA: checks
xAU6q2/cwmby2sxmA8VcmA: checks
*** SHOW DOWN ***
oxnw0GLLpFanjhGkxfRSqA: shows [Qc Ac] (a pair of Kings)
xAU6q2/cwmby2sxmA8VcmA: shows [8c 8s] (two pair, Kings and Eights)
xAU6q2/cwmby2sxmA8VcmA collected $20 from pot
*** SUMMARY ***
Total pot $21 | Rake $1
Board [5h Kd 3d Th Ks]
Seat 1: qhkK6+yCciTRd+rCFEbnEQ (big blind) folded before Flop
Seat 2: xAU6q2/cwmby2sxmA8VcmA showed [8c 8s] and won ($20) with two pair, Kings and Eights
Seat 3: wx3sQGkVi2x9wJXuWNHPBw folded before Flop (didn't bet)
Seat 4: ZA1bp6g8IwtTxkUE4eCjDQ folded before Flop (didn't bet)
Seat 5: y27w5IK2WXqmYzS8OU0wKA (button) folded before Flop (didn't bet)
Seat 6: oxnw0GLLpFanjhGkxfRSqA (small blind) showed [Qc Ac] and lost with a pair of Kings



PokerStars Game #59941075012:  Hold'em No Limit ($0.50/$1.00) - 2009/07/01 1:24:55 ET
Table 'MNvFfRVQNka/oY+Z5aMbZQ' 2-max Seat #2 is the button
Seat 1: DaZnoWHjO897dnh0CL2lVg ($63.40 in chips)
Seat 2: mgi+mjKb1Sc3CCs7TlfoCw ($58.35 in chips)
mgi+mjKb1Sc3CCs7TlfoCw: posts small blind $0.50
DaZnoWHjO897dnh0CL2lVg: posts big blind $1
*** HOLE CARDS ***
mgi+mjKb1Sc3CCs7TlfoCw: folds
DaZnoWHjO897dnh0CL2lVg collected $1 from pot
DaZnoWHjO897dnh0CL2lVg: doesn't show hand
*** SUMMARY ***
Total pot $1 | Rake $0
Seat 1: DaZnoWHjO897dnh0CL2lVg (big blind) collected ($1)
Seat 2: mgi+mjKb1Sc3CCs7TlfoCw (button) (small blind) folded before Flop



PokerStars Game #59941075372:  Hold'em No Limit ($0.50/$1.00) - 2009/07/01 1:24:56 ET
Table 'pHrhryH8jPNdQfY62f8v+g' 6-max Seat #2 is the button
Seat 1: 4d1rWhpu8DzLmzMbR3QKyA ($133.25 in chips)
Seat 2: JwCcjZl0bjJzG7hmE0dnTA ($104.15 in chips)
Seat 3: 8oS5O7iD/qnFXFXJrGIgNQ ($105.10 in chips)
Seat 4: 1f3beyIML24UqEMTbWy93g ($48.70 in chips)
Seat 5: r1/R7y0Ortgoz4lccgW8VA ($13.75 in chips)
Seat 6: xAU6q2/cwmby2sxmA8VcmA ($203.60 in chips)
8oS5O7iD/qnFXFXJrGIgNQ: posts small blind $0.50
1f3beyIML24UqEMTbWy93g: posts big blind $1
*** HOLE CARDS ***
r1/R7y0Ortgoz4lccgW8VA: folds
xAU6q2/cwmby2sxmA8VcmA: folds
4d1rWhpu8DzLmzMbR3QKyA: folds
JwCcjZl0bjJzG7hmE0dnTA: raises $2 to $3
8oS5O7iD/qnFXFXJrGIgNQ: folds
1f3beyIML24UqEMTbWy93g: calls $2
*** FLOP *** [Jh 3c Kd]
1f3beyIML24UqEMTbWy93g: checks
JwCcjZl0bjJzG7hmE0dnTA: bets $5
1f3beyIML24UqEMTbWy93g: calls $5
*** TURN *** [Jh 3c Kd] [Th]
1f3beyIML24UqEMTbWy93g: checks
JwCcjZl0bjJzG7hmE0dnTA: checks
*** RIVER *** [Jh 3c Kd Th] [As]
1f3beyIML24UqEMTbWy93g: bets $8
JwCcjZl0bjJzG7hmE0dnTA: folds
1f3beyIML24UqEMTbWy93g collected $15.70 from pot
*** SUMMARY ***
Total pot $16.50 | Rake $0.80
Board [Jh 3c Kd Th As]
Seat 1: 4d1rWhpu8DzLmzMbR3QKyA folded before Flop (didn't bet)
Seat 2: JwCcjZl0bjJzG7hmE0dnTA (button) folded on the River
Seat 3: 8oS5O7iD/qnFXFXJrGIgNQ (small blind) folded before Flop
Seat 4: 1f3beyIML24UqEMTbWy93g (big blind) collected ($15.70)
Seat 5: r1/R7y0Ortgoz4lccgW8VA folded before Flop (didn't bet)
Seat 6: xAU6q2/cwmby2sxmA8VcmA folded before Flop (didn't bet)



PokerStars Game #59941076220:  Hold'em No Limit ($0.50/$1.00) - 2009/07/01 1:24:57 ET
Table '7Nl0ffnjeK44/vmeexh3MQ' 9-max Seat #9 is the button
Seat 1: V138SURkdX8LdVBPKdJJag ($100 in chips)
Seat 2: OGgaARGdJQT4awWVNQ957w ($100.50 in chips)
Seat 3: JMmUYT5pIKCKh2pGjCB/4w ($60.40 in chips)
Seat 4: bLbSOSmSOnqE0iTcH/5dxA ($111.80 in chips)
Seat 6: FVs16t7GgfWgQWt4JxsObQ ($16.65 in chips)
Seat 7: 997ViqAtWn1FPjJqcffwcA ($100 in chips)
Seat 8: D+W9Me7w6Hcx/WRUSKV0dw ($20 in chips)
Seat 9: rFvc7K/96V9eGvYRfmpoUQ ($23.45 in chips)
V138SURkdX8LdVBPKdJJag: posts small blind $0.50
OGgaARGdJQT4awWVNQ957w: posts big blind $1
*** HOLE CARDS ***
JMmUYT5pIKCKh2pGjCB/4w: folds
bLbSOSmSOnqE0iTcH/5dxA: folds
FVs16t7GgfWgQWt4JxsObQ: folds
997ViqAtWn1FPjJqcffwcA: folds
D+W9Me7w6Hcx/WRUSKV0dw: folds
rFvc7K/96V9eGvYRfmpoUQ: folds
V138SURkdX8LdVBPKdJJag: folds
OGgaARGdJQT4awWVNQ957w collected $1 from pot
OGgaARGdJQT4awWVNQ957w: doesn't show hand
*** SUMMARY ***
Total pot $1 | Rake $0
Seat 1: V138SURkdX8LdVBPKdJJag (small blind) folded before Flop
Seat 2: OGgaARGdJQT4awWVNQ957w (big blind) collected ($1)
Seat 3: JMmUYT5pIKCKh2pGjCB/4w folded before Flop (didn't bet)
Seat 4: bLbSOSmSOnqE0iTcH/5dxA folded before Flop (didn't bet)
Seat 6: FVs16t7GgfWgQWt4JxsObQ folded before Flop (didn't bet)
Seat 7: 997ViqAtWn1FPjJqcffwcA folded before Flop (didn't bet)
Seat 8: D+W9Me7w6Hcx/WRUSKV0dw folded before Flop (didn't bet)
Seat 9: rFvc7K/96V9eGvYRfmpoUQ (button) folded before Flop (didn't bet)



PokerStars Game #59941076414:  Hold'em No Limit ($0.50/$1.00) - 2009/07/01 1:24:58 ET
Table 'jDQgUn1zGkyftPnHo0Awdw' 2-max Seat #1 is the button
Seat 1: a42+e5QB6s1kkG5FoSTZJw ($110.70 in chips)
Seat 2: q+vRKwm51mnr6kxX/161WQ ($86.70 in chips)
a42+e5QB6s1kkG5FoSTZJw: posts small blind $0.50
q+vRKwm51mnr6kxX/161WQ: posts big blind $1
*** HOLE CARDS ***
a42+e5QB6s1kkG5FoSTZJw: raises $2 to $3
q+vRKwm51mnr6kxX/161WQ: calls $2
*** FLOP *** [Jh 8d 8h]
q+vRKwm51mnr6kxX/161WQ: checks
a42+e5QB6s1kkG5FoSTZJw: checks
*** TURN *** [Jh 8d 8h] [6s]
q+vRKwm51mnr6kxX/161WQ: checks
a42+e5QB6s1kkG5FoSTZJw: bets $4
q+vRKwm51mnr6kxX/161WQ: calls $4
*** RIVER *** [Jh 8d 8h 6s] [Ts]
q+vRKwm51mnr6kxX/161WQ: checks
a42+e5QB6s1kkG5FoSTZJw: checks
*** SHOW DOWN ***
q+vRKwm51mnr6kxX/161WQ: shows [3s 3d] (two pair, Eights and Threes)
a42+e5QB6s1kkG5FoSTZJw: mucks hand
q+vRKwm51mnr6kxX/161WQ collected $13.50 from pot
*** SUMMARY ***
Total pot $14 | Rake $0.50
Board [Jh 8d 8h 6s Ts]
Seat 1: a42+e5QB6s1kkG5FoSTZJw (button) (small blind) mucked
Seat 2: q+vRKwm51mnr6kxX/161WQ (big blind) showed [3s 3d] and won ($13.50) with two pair, Eights and Threes



PokerStars Game #59941077180:  Hold'em No Limit ($0.50/$1.00) - 2009/07/01 1:24:59 ET
Table 'GPp0HyAuggN8oE0sUWzPpA' 9-max Seat #6 is the button
Seat 1: qJr25HAtvv1w/7IBvjMM3g ($47 in chips)
Seat 2: m3U8I35Pn3gxKhoS2nmYIg ($25.95 in chips)
Seat 3: CCCXsirC+bO7ginAuUUVlQ ($53.10 in chips)
Seat 4: mBRWbnUl8diyBO1qTJaNzw ($100.15 in chips)
Seat 5: bLbSOSmSOnqE0iTcH/5dxA ($100 in chips)
Seat 6: BK/GtNPkSx0TdUDj82id5A ($37.40 in chips)
Seat 7: DHdbHyysD15wCAtx+BhUjA ($93.70 in chips)
Seat 8: P/6qLjycEfxRgZ5F/W90dw ($97.50 in chips)
DHdbHyysD15wCAtx+BhUjA: posts small blind $0.50
P/6qLjycEfxRgZ5F/W90dw: posts big blind $1
myIxN7otsyr846M539YR8Q: sits out
*** HOLE CARDS ***
qJr25HAtvv1w/7IBvjMM3g: folds
m3U8I35Pn3gxKhoS2nmYIg: calls $1
CCCXsirC+bO7ginAuUUVlQ: folds
mBRWbnUl8diyBO1qTJaNzw: folds
bLbSOSmSOnqE0iTcH/5dxA: folds
BK/GtNPkSx0TdUDj82id5A: folds
DHdbHyysD15wCAtx+BhUjA: folds
P/6qLjycEfxRgZ5F/W90dw: checks
*** FLOP *** [2c Ad 9h]
P/6qLjycEfxRgZ5F/W90dw: checks
m3U8I35Pn3gxKhoS2nmYIg: checks
*** TURN *** [2c Ad 9h] [4s]
P/6qLjycEfxRgZ5F/W90dw: checks
m3U8I35Pn3gxKhoS2nmYIg: checks
*** RIVER *** [2c Ad 9h 4s] [8h]
P/6qLjycEfxRgZ5F/W90dw: checks
m3U8I35Pn3gxKhoS2nmYIg: bets $1
P/6qLjycEfxRgZ5F/W90dw: calls $1
*** SHOW DOWN ***
m3U8I35Pn3gxKhoS2nmYIg: shows [6h 6d] (a pair of Sixes)
P/6qLjycEfxRgZ5F/W90dw: mucks hand
m3U8I35Pn3gxKhoS2nmYIg collected $4.30 from pot
*** SUMMARY ***
Total pot $4.50 | Rake $0.20
Board [2c Ad 9h 4s 8h]
Seat 1: qJr25HAtvv1w/7IBvjMM3g folded before Flop (didn't bet)
Seat 2: m3U8I35Pn3gxKhoS2nmYIg showed [6h 6d] and won ($4.30) with a pair of Sixes
Seat 3: CCCXsirC+bO7ginAuUUVlQ folded before Flop (didn't bet)
Seat 4: mBRWbnUl8diyBO1qTJaNzw folded before Flop (didn't bet)
Seat 5: bLbSOSmSOnqE0iTcH/5dxA folded before Flop (didn't bet)
Seat 6: BK/GtNPkSx0TdUDj82id5A (button) folded before Flop (didn't bet)
Seat 7: DHdbHyysD15wCAtx+BhUjA (small blind) folded before Flop
Seat 8: P/6qLjycEfxRgZ5F/W90dw (big blind) mucked



PokerStars Game #59941078310:  Hold'em No Limit ($0.50/$1.00) - 2009/07/01 1:25:01 ET
Table 'gxFK0BVUD7cupu2uyRUZJg' 6-max Seat #3 is the button
Seat 2: hpxXcmRkXXI9HE5+5/j/0Q ($137.55 in chips)
Seat 3: Z2fXsGcjl+Eax+RzOgwOmg ($100 in chips)
Seat 5: WgIrs6CBinyyw18pqdDtWA ($21.70 in chips)
Seat 6: dYyb6/42PMC8aNFlm/eBeQ ($124 in chips)
WgIrs6CBinyyw18pqdDtWA: posts small blind $0.50
dYyb6/42PMC8aNFlm/eBeQ: posts big blind $1
*** HOLE CARDS ***
hpxXcmRkXXI9HE5+5/j/0Q: folds
Z2fXsGcjl+Eax+RzOgwOmg: folds
WgIrs6CBinyyw18pqdDtWA: folds
dYyb6/42PMC8aNFlm/eBeQ collected $1 from pot
dYyb6/42PMC8aNFlm/eBeQ: doesn't show hand
*** SUMMARY ***
Total pot $1 | Rake $0
Seat 2: hpxXcmRkXXI9HE5+5/j/0Q folded before Flop (didn't bet)
Seat 3: Z2fXsGcjl+Eax+RzOgwOmg (button) folded before Flop (didn't bet)
Seat 5: WgIrs6CBinyyw18pqdDtWA (small blind) folded before Flop
Seat 6: dYyb6/42PMC8aNFlm/eBeQ (big blind) collected ($1)



PokerStars Game #59941080266:  Hold'em No Limit ($0.50/$1.00) - 2009/07/01 1:25:04 ET
Table '+cA8mcmhaedZ7YcrDdhmeQ' 6-max Seat #1 is the button
Seat 1: iIgNoBh+3/Ix1/fLsg+HuA ($31.35 in chips)
Seat 2: 14aYclSc98EYd6TrzN2l3Q ($38.25 in chips)
Seat 3: DAIgyIWbYvAkL6PbAI27pg ($6.50 in chips)
Seat 4: 4OO5v3AVduL0tePNx8wk5A ($100 in chips)
Seat 5: n5xXfJeDtWZSChGAdq//Tw ($18.55 in chips)
Seat 6: YfsTQsY/fxb+YqbdclTHuw ($27.25 in chips)
14aYclSc98EYd6TrzN2l3Q: posts small blind $0.50
DAIgyIWbYvAkL6PbAI27pg: posts big blind $1
*** HOLE CARDS ***
4OO5v3AVduL0tePNx8wk5A: folds
n5xXfJeDtWZSChGAdq//Tw: folds
YfsTQsY/fxb+YqbdclTHuw: folds
iIgNoBh+3/Ix1/fLsg+HuA: raises $2 to $3
14aYclSc98EYd6TrzN2l3Q said, "hi"
14aYclSc98EYd6TrzN2l3Q: calls $2.50
DAIgyIWbYvAkL6PbAI27pg: raises $3.50 to $6.50 and is all-in
iIgNoBh+3/Ix1/fLsg+HuA: calls $3.50
14aYclSc98EYd6TrzN2l3Q: calls $3.50
*** FLOP *** [3c 4c 7h]
14aYclSc98EYd6TrzN2l3Q: checks
iIgNoBh+3/Ix1/fLsg+HuA: bets $6
14aYclSc98EYd6TrzN2l3Q: calls $6
*** TURN *** [3c 4c 7h] [Ac]
14aYclSc98EYd6TrzN2l3Q: bets $7
iIgNoBh+3/Ix1/fLsg+HuA: raises $11.85 to $18.85 and is all-in
14aYclSc98EYd6TrzN2l3Q: calls $11.85
*** RIVER *** [3c 4c 7h Ac] [Kc]
*** SHOW DOWN ***
14aYclSc98EYd6TrzN2l3Q: shows [5d 7d] (a pair of Sevens)
iIgNoBh+3/Ix1/fLsg+HuA: shows [Js 7s] (a pair of Sevens - Ace+King+Jack kicker)
iIgNoBh+3/Ix1/fLsg+HuA collected $47.65 from side pot
DAIgyIWbYvAkL6PbAI27pg: shows [5h Ad] (a pair of Aces)
DAIgyIWbYvAkL6PbAI27pg collected $18.55 from main pot
*** SUMMARY ***
Total pot $69.20 Main pot $18.55. Side pot $47.65. | Rake $3
Board [3c 4c 7h Ac Kc]
Seat 1: iIgNoBh+3/Ix1/fLsg+HuA (button) showed [Js 7s] and won ($47.65) with a pair of Sevens
Seat 2: 14aYclSc98EYd6TrzN2l3Q (small blind) showed [5d 7d] and lost with a pair of Sevens
Seat 3: DAIgyIWbYvAkL6PbAI27pg (big blind) showed [5h Ad] and won ($18.55) with a pair of Aces
Seat 4: 4OO5v3AVduL0tePNx8wk5A folded before Flop (didn't bet)
Seat 5: n5xXfJeDtWZSChGAdq//Tw folded before Flop (didn't bet)
Seat 6: YfsTQsY/fxb+YqbdclTHuw folded before Flop (didn't bet)



PokerStars Game #59941080884:  Hold'em No Limit ($0.50/$1.00) - 2009/07/01 1:25:06 ET
Table 'vs/5jr6ciwjVQ5+Soc+u2A' 6-max Seat #1 is the button
Seat 1: J798qwLuvXyq0BbzsIjOrA ($143.90 in chips)
Seat 2: lXX4W7m3u++JiSOZ46yVMQ ($104.65 in chips)
Seat 3: G5ZSSN6RSON3gkNvk/SmYg ($139.60 in chips)
Seat 4: wk6Ohn4GDozoOMHc4eb2rw ($59.30 in chips)
Seat 5: +Nt3OPk3XR9SKjZgm2CexQ ($155.50 in chips)
Seat 6: Z2fXsGcjl+Eax+RzOgwOmg ($104.50 in chips)
lXX4W7m3u++JiSOZ46yVMQ: posts small blind $0.50
G5ZSSN6RSON3gkNvk/SmYg: posts big blind $1
*** HOLE CARDS ***
wk6Ohn4GDozoOMHc4eb2rw: raises $3 to $4
+Nt3OPk3XR9SKjZgm2CexQ: folds
Z2fXsGcjl+Eax+RzOgwOmg: folds
J798qwLuvXyq0BbzsIjOrA: calls $4
lXX4W7m3u++JiSOZ46yVMQ: calls $3.50
G5ZSSN6RSON3gkNvk/SmYg: calls $3
*** FLOP *** [2s Jc Kc]
lXX4W7m3u++JiSOZ46yVMQ: checks
G5ZSSN6RSON3gkNvk/SmYg: checks
wk6Ohn4GDozoOMHc4eb2rw: checks
J798qwLuvXyq0BbzsIjOrA: bets $12
lXX4W7m3u++JiSOZ46yVMQ: folds
G5ZSSN6RSON3gkNvk/SmYg: calls $12
wk6Ohn4GDozoOMHc4eb2rw: folds
*** TURN *** [2s Jc Kc] [3h]
G5ZSSN6RSON3gkNvk/SmYg: checks
J798qwLuvXyq0BbzsIjOrA: bets $22
G5ZSSN6RSON3gkNvk/SmYg: folds
J798qwLuvXyq0BbzsIjOrA collected $38.05 from pot
J798qwLuvXyq0BbzsIjOrA: doesn't show hand
*** SUMMARY ***
Total pot $40 | Rake $1.95
Board [2s Jc Kc 3h]
Seat 1: J798qwLuvXyq0BbzsIjOrA (button) collected ($38.05)
Seat 2: lXX4W7m3u++JiSOZ46yVMQ (small blind) folded on the Flop
Seat 3: G5ZSSN6RSON3gkNvk/SmYg (big blind) folded on the Turn
Seat 4: wk6Ohn4GDozoOMHc4eb2rw folded on the Flop
Seat 5: +Nt3OPk3XR9SKjZgm2CexQ folded before Flop (didn't bet)
Seat 6: Z2fXsGcjl+Eax+RzOgwOmg folded before Flop (didn't bet)



PokerStars Game #59941081184:  Hold'em No Limit ($0.50/$1.00) - 2009/07/01 1:25:06 ET
Table 'kS0cTQAEi+fdUlJP2gQYvw' 9-max Seat #1 is the button
Seat 1: /mfensKw8/iZ1Vrx33S4xg ($20 in chips)
Seat 2: D+W9Me7w6Hcx/WRUSKV0dw ($25.55 in chips)
Seat 3: 2BV+oJIQYr65IO6nEChvbA ($60 in chips)
Seat 4: RUhhaALzha3TH1AkdakoGQ ($55 in chips)
Seat 5: 997ViqAtWn1FPjJqcffwcA ($100 in chips)
Seat 6: yAbu2QsRPVcjPbqlf/jDxw ($126.15 in chips)
Seat 7: Ffa7Nj4X5fddtROP01hfQg ($154.60 in chips)
Seat 8: vKyFzTyzfT7fZcdX+HHN+Q ($33.50 in chips)
Seat 9: OGgaARGdJQT4awWVNQ957w ($100 in chips)
D+W9Me7w6Hcx/WRUSKV0dw: posts small blind $0.50
2BV+oJIQYr65IO6nEChvbA: posts big blind $1
*** HOLE CARDS ***
RUhhaALzha3TH1AkdakoGQ: calls $1
997ViqAtWn1FPjJqcffwcA: folds
yAbu2QsRPVcjPbqlf/jDxw: folds
Ffa7Nj4X5fddtROP01hfQg: folds
vKyFzTyzfT7fZcdX+HHN+Q: calls $1
OGgaARGdJQT4awWVNQ957w: folds
/mfensKw8/iZ1Vrx33S4xg: calls $1
D+W9Me7w6Hcx/WRUSKV0dw: folds
2BV+oJIQYr65IO6nEChvbA: checks
*** FLOP *** [9h 7h 9s]
2BV+oJIQYr65IO6nEChvbA: bets $1
RUhhaALzha3TH1AkdakoGQ: folds
vKyFzTyzfT7fZcdX+HHN+Q: calls $1
/mfensKw8/iZ1Vrx33S4xg: folds
*** TURN *** [9h 7h 9s] [Qs]
2BV+oJIQYr65IO6nEChvbA: bets $2
vKyFzTyzfT7fZcdX+HHN+Q: folds
2BV+oJIQYr65IO6nEChvbA collected $6.20 from pot
2BV+oJIQYr65IO6nEChvbA: doesn't show hand
*** SUMMARY ***
Total pot $6.50 | Rake $0.30
Board [9h 7h 9s Qs]
Seat 1: /mfensKw8/iZ1Vrx33S4xg (button) folded on the Flop
Seat 2: D+W9Me7w6Hcx/WRUSKV0dw (small blind) folded before Flop
Seat 3: 2BV+oJIQYr65IO6nEChvbA (big blind) collected ($6.20)
Seat 4: RUhhaALzha3TH1AkdakoGQ folded on the Flop
Seat 5: 997ViqAtWn1FPjJqcffwcA folded before Flop (didn't bet)
Seat 6: yAbu2QsRPVcjPbqlf/jDxw folded before Flop (didn't bet)
Seat 7: Ffa7Nj4X5fddtROP01hfQg folded before Flop (didn't bet)
Seat 8: vKyFzTyzfT7fZcdX+HHN+Q folded on the Turn
Seat 9: OGgaARGdJQT4awWVNQ957w folded before Flop (didn't bet)



PokerStars Game #59941081722:  Hold'em No Limit ($0.50/$1.00) - 2009/07/01 1:25:07 ET
Table 'QSIig7BLMc9wY/rgBechzw' 6-max Seat #4 is the button
Seat 1: Z2fXsGcjl+Eax+RzOgwOmg ($112.10 in chips)
Seat 2: mLOIkH/qmRa+mVujQIhBRg ($50.90 in chips)
Seat 3: +xW7QemQU0Fxs+4TnqBRow ($110 in chips)
Seat 4: +uSzP8Jwnw7sKfQ4s66b7w ($62.15 in chips)
Seat 5: lsLuWlcPA3Rh7kJVLzMh0Q ($100 in chips)
Seat 6: PxqfkAMdAWtkgbT+q2gciA ($45.85 in chips)
lsLuWlcPA3Rh7kJVLzMh0Q: posts small blind $0.50
PxqfkAMdAWtkgbT+q2gciA: posts big blind $1
*** HOLE CARDS ***
Z2fXsGcjl+Eax+RzOgwOmg: folds
mLOIkH/qmRa+mVujQIhBRg: folds
+xW7QemQU0Fxs+4TnqBRow: raises $3 to $4
+uSzP8Jwnw7sKfQ4s66b7w: folds
lsLuWlcPA3Rh7kJVLzMh0Q: folds
PxqfkAMdAWtkgbT+q2gciA: folds
+xW7QemQU0Fxs+4TnqBRow collected $2.50 from pot
+xW7QemQU0Fxs+4TnqBRow: doesn't show hand
*** SUMMARY ***
Total pot $2.50 | Rake $0
Seat 1: Z2fXsGcjl+Eax+RzOgwOmg folded before Flop (didn't bet)
Seat 2: mLOIkH/qmRa+mVujQIhBRg folded before Flop (didn't bet)
Seat 3: +xW7QemQU0Fxs+4TnqBRow collected ($2.50)
Seat 4: +uSzP8Jwnw7sKfQ4s66b7w (button) folded before Flop (didn't bet)
Seat 5: lsLuWlcPA3Rh7kJVLzMh0Q (small blind) folded before Flop
Seat 6: PxqfkAMdAWtkgbT+q2gciA (big blind) folded before Flop



PokerStars Game #59941082460:  Hold'em No Limit ($0.50/$1.00) - 2009/07/01 1:25:08 ET
Table 'MNvFfRVQNka/oY+Z5aMbZQ' 2-max Seat #1 is the button
Seat 1: DaZnoWHjO897dnh0CL2lVg ($63.90 in chips)
Seat 2: mgi+mjKb1Sc3CCs7TlfoCw ($57.85 in chips)
DaZnoWHjO897dnh0CL2lVg: posts small blind $0.50
mgi+mjKb1Sc3CCs7TlfoCw: posts big blind $1
*** HOLE CARDS ***
DaZnoWHjO897dnh0CL2lVg: folds
mgi+mjKb1Sc3CCs7TlfoCw collected $1 from pot
mgi+mjKb1Sc3CCs7TlfoCw: doesn't show hand
*** SUMMARY ***
Total pot $1 | Rake $0
Seat 1: DaZnoWHjO897dnh0CL2lVg (button) (small blind) folded before Flop
Seat 2: mgi+mjKb1Sc3CCs7TlfoCw (big blind) collected ($1)



PokerStars Game #59941082986:  Hold'em No Limit ($0.50/$1.00) - 2009/07/01 1:25:09 ET
Table 'Evb7VW0qfDhFkbgBL3gcqQ' 2-max Seat #1 is the button
Seat 1: NYi6JFscYNrofSXy4sM+Yw ($122.65 in chips)
Seat 2: AoEQlM/FNYM0d7Txn1TfBQ ($83.25 in chips)
NYi6JFscYNrofSXy4sM+Yw: posts small blind $0.50
AoEQlM/FNYM0d7Txn1TfBQ: posts big blind $1
*** HOLE CARDS ***
NYi6JFscYNrofSXy4sM+Yw: raises $2 to $3
AoEQlM/FNYM0d7Txn1TfBQ: folds
NYi6JFscYNrofSXy4sM+Yw collected $2 from pot
*** SUMMARY ***
Total pot $2 | Rake $0
Seat 1: NYi6JFscYNrofSXy4sM+Yw (button) (small blind) collected ($2)
Seat 2: AoEQlM/FNYM0d7Txn1TfBQ (big blind) folded before Flop



PokerStars Game #59941083160:  Hold'em No Limit ($0.50/$1.00) - 2009/07/01 1:25:09 ET
Table 'TvsifD4n+q//fIZ4fM1xxQ' 2-max Seat #1 is the button
Seat 1: NYi6JFscYNrofSXy4sM+Yw ($172.95 in chips)
Seat 2: +W/hy0gBp0sJy8pjLz6Yrg ($100 in chips)
NYi6JFscYNrofSXy4sM+Yw: posts small blind $0.50
+W/hy0gBp0sJy8pjLz6Yrg: posts big blind $1
*** HOLE CARDS ***
NYi6JFscYNrofSXy4sM+Yw: raises $2 to $3
+W/hy0gBp0sJy8pjLz6Yrg: calls $2
*** FLOP *** [Kd Ts Tc]
+W/hy0gBp0sJy8pjLz6Yrg: checks
NYi6JFscYNrofSXy4sM+Yw: bets $3
+W/hy0gBp0sJy8pjLz6Yrg: folds
NYi6JFscYNrofSXy4sM+Yw collected $5.70 from pot
*** SUMMARY ***
Total pot $6 | Rake $0.30
Board [Kd Ts Tc]
Seat 1: NYi6JFscYNrofSXy4sM+Yw (button) (small blind) collected ($5.70)
Seat 2: +W/hy0gBp0sJy8pjLz6Yrg (big blind) folded on the Flop



PokerStars Game #59941084378:  Hold'em No Limit ($0.50/$1.00) - 2009/07/01 1:25:11 ET
Table '7O9fB8yx1u7sJveJn8w6jA' 6-max Seat #4 is the button
Seat 1: jy52+7FotjH63o5tEEVgKw ($60.30 in chips)
Seat 2: wx3sQGkVi2x9wJXuWNHPBw ($196.20 in chips)
Seat 3: hpxXcmRkXXI9HE5+5/j/0Q ($121.25 in chips)
Seat 4: b2a+5TkFf4xJN/Ihhma58Q ($39.55 in chips)
Seat 5: BCEV3COoKY607AzLWayfRA ($103.85 in chips)
Seat 6: 6hLdALbOlkzGIrc53QKtPw ($20 in chips)
BCEV3COoKY607AzLWayfRA: posts small blind $0.50
6hLdALbOlkzGIrc53QKtPw: posts big blind $1
*** HOLE CARDS ***
jy52+7FotjH63o5tEEVgKw: calls $1
wx3sQGkVi2x9wJXuWNHPBw: folds
hpxXcmRkXXI9HE5+5/j/0Q: folds
b2a+5TkFf4xJN/Ihhma58Q: folds
BCEV3COoKY607AzLWayfRA: folds
6hLdALbOlkzGIrc53QKtPw: checks
*** FLOP *** [3h Qc Qs]
6hLdALbOlkzGIrc53QKtPw: checks
jy52+7FotjH63o5tEEVgKw: checks
*** TURN *** [3h Qc Qs] [Js]
6hLdALbOlkzGIrc53QKtPw: checks
jy52+7FotjH63o5tEEVgKw: checks
*** RIVER *** [3h Qc Qs Js] [8c]
6hLdALbOlkzGIrc53QKtPw: checks
jy52+7FotjH63o5tEEVgKw: bets $3
6hLdALbOlkzGIrc53QKtPw: folds
jy52+7FotjH63o5tEEVgKw collected $2.40 from pot
*** SUMMARY ***
Total pot $2.50 | Rake $0.10
Board [3h Qc Qs Js 8c]
Seat 1: jy52+7FotjH63o5tEEVgKw collected ($2.40)
Seat 2: wx3sQGkVi2x9wJXuWNHPBw folded before Flop (didn't bet)
Seat 3: hpxXcmRkXXI9HE5+5/j/0Q folded before Flop (didn't bet)
Seat 4: b2a+5TkFf4xJN/Ihhma58Q (button) folded before Flop (didn't bet)
Seat 5: BCEV3COoKY607AzLWayfRA (small blind) folded before Flop
Seat 6: 6hLdALbOlkzGIrc53QKtPw (big blind) folded on the River



PokerStars Game #59941084744:  Hold'em No Limit ($0.50/$1.00) - 2009/07/01 1:25:12 ET
Table 'mmbQQVBTrPdE+wy+s+9VPA' 6-max Seat #1 is the button
Seat 1: zyP4SPoWZnKUfTvIRLCVog ($79.35 in chips)
Seat 2: XK4Qsl+DA8gAJyg85/zBIw ($30.30 in chips)
Seat 3: wx3sQGkVi2x9wJXuWNHPBw ($127.35 in chips)
Seat 4: V3iZdcw61nXF3g5hD2RrsQ ($100 in chips)
Seat 5: YMJG+F++3Aj6P8dAWda5fw ($117.90 in chips)
Seat 6: U2CWBTv29qdCbj8RNF2sIw ($113.25 in chips)
XK4Qsl+DA8gAJyg85/zBIw: posts small blind $0.50
wx3sQGkVi2x9wJXuWNHPBw: posts big blind $1
*** HOLE CARDS ***
V3iZdcw61nXF3g5hD2RrsQ: folds
YMJG+F++3Aj6P8dAWda5fw: folds
U2CWBTv29qdCbj8RNF2sIw: folds
zyP4SPoWZnKUfTvIRLCVog: folds
XK4Qsl+DA8gAJyg85/zBIw: folds
wx3sQGkVi2x9wJXuWNHPBw collected $1 from pot
*** SUMMARY ***
Total pot $1 | Rake $0
Seat 1: zyP4SPoWZnKUfTvIRLCVog (button) folded before Flop (didn't bet)
Seat 2: XK4Qsl+DA8gAJyg85/zBIw (small blind) folded before Flop
Seat 3: wx3sQGkVi2x9wJXuWNHPBw (big blind) collected ($1)
Seat 4: V3iZdcw61nXF3g5hD2RrsQ folded before Flop (didn't bet)
Seat 5: YMJG+F++3Aj6P8dAWda5fw folded before Flop (didn't bet)
Seat 6: U2CWBTv29qdCbj8RNF2sIw folded before Flop (didn't bet)



PokerStars Game #59941084734:  Hold'em No Limit ($0.50/$1.00) - 2009/07/01 1:25:12 ET
Table 'W/wyObTiXZm+Ckkl3YxcSw' 6-max Seat #2 is the button
Seat 1: eUBBn2R56C1IQ6Cs/vitwg ($289.90 in chips)
Seat 2: oDiBRCaF0QVtd3kO6xZIXw ($152.05 in chips)
Seat 3: dxyNCn/qxfkGDUIf28Cbng ($65.30 in chips)
Seat 4: UBZQqpnJZdTYYY1FTb0rLA ($100 in chips)
Seat 5: +OrCjyw70oZhJiD22Mn+bg ($100 in chips)
Seat 6: b2a+5TkFf4xJN/Ihhma58Q ($48.95 in chips)
dxyNCn/qxfkGDUIf28Cbng: posts small blind $0.50
UBZQqpnJZdTYYY1FTb0rLA: posts big blind $1
*** HOLE CARDS ***
+OrCjyw70oZhJiD22Mn+bg: folds
b2a+5TkFf4xJN/Ihhma58Q: folds
eUBBn2R56C1IQ6Cs/vitwg: raises $2 to $3
oDiBRCaF0QVtd3kO6xZIXw: folds
dxyNCn/qxfkGDUIf28Cbng: calls $2.50
UBZQqpnJZdTYYY1FTb0rLA: folds
*** FLOP *** [5s Qd 2c]
dxyNCn/qxfkGDUIf28Cbng: checks
eUBBn2R56C1IQ6Cs/vitwg: bets $4
dxyNCn/qxfkGDUIf28Cbng: folds
eUBBn2R56C1IQ6Cs/vitwg collected $6.65 from pot
*** SUMMARY ***
Total pot $7 | Rake $0.35
Board [5s Qd 2c]
Seat 1: eUBBn2R56C1IQ6Cs/vitwg collected ($6.65)
Seat 2: oDiBRCaF0QVtd3kO6xZIXw (button) folded before Flop (didn't bet)
Seat 3: dxyNCn/qxfkGDUIf28Cbng (small blind) folded on the Flop
Seat 4: UBZQqpnJZdTYYY1FTb0rLA (big blind) folded before Flop
Seat 5: +OrCjyw70oZhJiD22Mn+bg folded before Flop (didn't bet)
Seat 6: b2a+5TkFf4xJN/Ihhma58Q folded before Flop (didn't bet)



PokerStars Game #59941085632:  Hold'em No Limit ($0.50/$1.00) - 2009/07/01 1:25:13 ET
Table 'gxFK0BVUD7cupu2uyRUZJg' 6-max Seat #5 is the button
Seat 2: hpxXcmRkXXI9HE5+5/j/0Q ($137.55 in chips)
Seat 3: Z2fXsGcjl+Eax+RzOgwOmg ($100 in chips)
Seat 5: WgIrs6CBinyyw18pqdDtWA ($21.20 in chips)
Seat 6: dYyb6/42PMC8aNFlm/eBeQ ($124.50 in chips)
dYyb6/42PMC8aNFlm/eBeQ: posts small blind $0.50
hpxXcmRkXXI9HE5+5/j/0Q: posts big blind $1
*** HOLE CARDS ***
Z2fXsGcjl+Eax+RzOgwOmg: raises $3 to $4
WgIrs6CBinyyw18pqdDtWA: folds
dYyb6/42PMC8aNFlm/eBeQ: calls $3.50
hpxXcmRkXXI9HE5+5/j/0Q: folds
*** FLOP *** [8s 4d Qs]
dYyb6/42PMC8aNFlm/eBeQ: bets $1
Z2fXsGcjl+Eax+RzOgwOmg: raises $7 to $8
dYyb6/42PMC8aNFlm/eBeQ: folds
Z2fXsGcjl+Eax+RzOgwOmg collected $10.50 from pot
Z2fXsGcjl+Eax+RzOgwOmg: doesn't show hand
*** SUMMARY ***
Total pot $11 | Rake $0.50
Board [8s 4d Qs]
Seat 2: hpxXcmRkXXI9HE5+5/j/0Q (big blind) folded before Flop
Seat 3: Z2fXsGcjl+Eax+RzOgwOmg collected ($10.50)
Seat 5: WgIrs6CBinyyw18pqdDtWA (button) folded before Flop (didn't bet)
Seat 6: dYyb6/42PMC8aNFlm/eBeQ (small blind) folded on the Flop



PokerStars Game #59941085782:  Hold'em No Limit ($0.50/$1.00) - 2009/07/01 1:25:14 ET
Table '8jIjWCPY0NGprquL+xcMFg' 9-max Seat #8 is the button
Seat 1: tU883G5KFwdH+p2tFuGYtw ($64.20 in chips)
Seat 2: 7VpIzVwja9q3vCCNM7gRrg ($54.65 in chips)
Seat 3: myIxN7otsyr846M539YR8Q ($19.50 in chips)
Seat 6: GTQkFJtSkbVbnGCktp6e3g ($100.50 in chips)
Seat 7: O5Go3jrzbQWxRB6ESK+Ptg ($57.75 in chips)
Seat 8: eI48VADSCFoNZBx4T9qs2w ($15.65 in chips)
Seat 9: DDzMn3tzCgfGf298Xxt5Iw ($14.85 in chips)
DDzMn3tzCgfGf298Xxt5Iw: posts small blind $0.50
tU883G5KFwdH+p2tFuGYtw: posts big blind $1
3obndzTJ6fECz8+wWhMd1w: sits out
*** HOLE CARDS ***
7VpIzVwja9q3vCCNM7gRrg: calls $1
myIxN7otsyr846M539YR8Q: folds
GTQkFJtSkbVbnGCktp6e3g: calls $1
O5Go3jrzbQWxRB6ESK+Ptg: calls $1
eI48VADSCFoNZBx4T9qs2w: raises $4 to $5
DDzMn3tzCgfGf298Xxt5Iw: raises $9.85 to $14.85 and is all-in
tU883G5KFwdH+p2tFuGYtw: folds
7VpIzVwja9q3vCCNM7gRrg: folds
GTQkFJtSkbVbnGCktp6e3g: folds
O5Go3jrzbQWxRB6ESK+Ptg: folds
eI48VADSCFoNZBx4T9qs2w: calls $9.85
*** FLOP *** [5d 6c Tc]
*** TURN *** [5d 6c Tc] [3h]
*** RIVER *** [5d 6c Tc 3h] [9d]
*** SHOW DOWN ***
DDzMn3tzCgfGf298Xxt5Iw: shows [2h 2s] (a pair of Deuces)
eI48VADSCFoNZBx4T9qs2w: shows [Qc Qh] (a pair of Queens)
eI48VADSCFoNZBx4T9qs2w collected $32.05 from pot
*** SUMMARY ***
Total pot $33.70 | Rake $1.65
Board [5d 6c Tc 3h 9d]
Seat 1: tU883G5KFwdH+p2tFuGYtw (big blind) folded before Flop
Seat 2: 7VpIzVwja9q3vCCNM7gRrg folded before Flop
Seat 3: myIxN7otsyr846M539YR8Q folded before Flop (didn't bet)
Seat 6: GTQkFJtSkbVbnGCktp6e3g folded before Flop
Seat 7: O5Go3jrzbQWxRB6ESK+Ptg folded before Flop
Seat 8: eI48VADSCFoNZBx4T9qs2w (button) showed [Qc Qh] and won ($32.05) with a pair of Queens
Seat 9: DDzMn3tzCgfGf298Xxt5Iw (small blind) showed [2h 2s] and lost with a pair of Deuces



PokerStars Game #59941086302:  Hold'em No Limit ($0.50/$1.00) - 2009/07/01 1:25:15 ET
Table 'MNvFfRVQNka/oY+Z5aMbZQ' 2-max Seat #2 is the button
Seat 1: DaZnoWHjO897dnh0CL2lVg ($63.40 in chips)
Seat 2: mgi+mjKb1Sc3CCs7TlfoCw ($58.35 in chips)
mgi+mjKb1Sc3CCs7TlfoCw: posts small blind $0.50
DaZnoWHjO897dnh0CL2lVg: posts big blind $1
*** HOLE CARDS ***
mgi+mjKb1Sc3CCs7TlfoCw: raises $2 to $3
DaZnoWHjO897dnh0CL2lVg: calls $2
*** FLOP *** [Ts Ks As]
DaZnoWHjO897dnh0CL2lVg: checks
mgi+mjKb1Sc3CCs7TlfoCw: bets $4
DaZnoWHjO897dnh0CL2lVg: calls $4
*** TURN *** [Ts Ks As] [Ah]
DaZnoWHjO897dnh0CL2lVg: checks
mgi+mjKb1Sc3CCs7TlfoCw: checks
*** RIVER *** [Ts Ks As Ah] [2d]
DaZnoWHjO897dnh0CL2lVg: bets $7
mgi+mjKb1Sc3CCs7TlfoCw: folds
DaZnoWHjO897dnh0CL2lVg collected $13.50 from pot
DaZnoWHjO897dnh0CL2lVg: doesn't show hand
*** SUMMARY ***
Total pot $14 | Rake $0.50
Board [Ts Ks As Ah 2d]
Seat 1: DaZnoWHjO897dnh0CL2lVg (big blind) collected ($13.50)
Seat 2: mgi+mjKb1Sc3CCs7TlfoCw (button) (small blind) folded on the River



PokerStars Game #59941087860:  Hold'em No Limit ($0.50/$1.00) - 2009/07/01 1:25:17 ET
Table '/RZcOwpZpHQ+OwPwjsbnRw' 6-max Seat #2 is the button
Seat 1: +uSzP8Jwnw7sKfQ4s66b7w ($48.25 in chips)
Seat 2: Z2fXsGcjl+Eax+RzOgwOmg ($103 in chips)
Seat 3: 6hLdALbOlkzGIrc53QKtPw ($21.70 in chips)
Seat 4: j7NIOHLZk7V2o9fOioO5ug ($103 in chips)
Seat 5: wx3sQGkVi2x9wJXuWNHPBw ($166.05 in chips)
Seat 6: o3YLm/rSY916m/on1VjXPA ($200.50 in chips)
6hLdALbOlkzGIrc53QKtPw: posts small blind $0.50
j7NIOHLZk7V2o9fOioO5ug: posts big blind $1
*** HOLE CARDS ***
wx3sQGkVi2x9wJXuWNHPBw: folds
o3YLm/rSY916m/on1VjXPA: folds
+uSzP8Jwnw7sKfQ4s66b7w: raises $2 to $3
Z2fXsGcjl+Eax+RzOgwOmg: calls $3
6hLdALbOlkzGIrc53QKtPw: folds
j7NIOHLZk7V2o9fOioO5ug: folds
*** FLOP *** [Td Js 9h]
+uSzP8Jwnw7sKfQ4s66b7w: checks
Z2fXsGcjl+Eax+RzOgwOmg: bets $5
+uSzP8Jwnw7sKfQ4s66b7w: folds
Z2fXsGcjl+Eax+RzOgwOmg collected $7.15 from pot
Z2fXsGcjl+Eax+RzOgwOmg: doesn't show hand
*** SUMMARY ***
Total pot $7.50 | Rake $0.35
Board [Td Js 9h]
Seat 1: +uSzP8Jwnw7sKfQ4s66b7w folded on the Flop
Seat 2: Z2fXsGcjl+Eax+RzOgwOmg (button) collected ($7.15)
Seat 3: 6hLdALbOlkzGIrc53QKtPw (small blind) folded before Flop
Seat 4: j7NIOHLZk7V2o9fOioO5ug (big blind) folded before Flop
Seat 5: wx3sQGkVi2x9wJXuWNHPBw folded before Flop (didn't bet)
Seat 6: o3YLm/rSY916m/on1VjXPA folded before Flop (didn't bet)



PokerStars Game #59941088158:  Hold'em No Limit ($0.50/$1.00) - 2009/07/01 1:25:18 ET
Table 'hugOjcwJvzEwZbK7tyiWuQ' 9-max Seat #2 is the button
Seat 1: S3Ex8K7v6xm5jqjRM7Fl3w ($18.50 in chips)
Seat 2: r27C1nIV4NS4+qbnrgBQSw ($273.70 in chips)
Seat 4: UWB3oeddt/GObx2Mix2Anw ($183.60 in chips)
Seat 6: gUUvmqdVlmvpal6B8nYrmg ($107.95 in chips)
Seat 7: FL3MrLspcF23LYvC4ipBOA ($117.30 in chips)
Seat 8: /zy+DB4S5fUQUSfZWFzYGw ($119.85 in chips)
Seat 9: W8P9bUKCs43TO1xHm0dL6w ($111.50 in chips)
UWB3oeddt/GObx2Mix2Anw: posts small blind $0.50
gUUvmqdVlmvpal6B8nYrmg: posts big blind $1
*** HOLE CARDS ***
FL3MrLspcF23LYvC4ipBOA: folds
/zy+DB4S5fUQUSfZWFzYGw: folds
W8P9bUKCs43TO1xHm0dL6w: calls $1
S3Ex8K7v6xm5jqjRM7Fl3w: folds
r27C1nIV4NS4+qbnrgBQSw: folds
UWB3oeddt/GObx2Mix2Anw: folds
gUUvmqdVlmvpal6B8nYrmg: checks
*** FLOP *** [9s 7s 6c]
gUUvmqdVlmvpal6B8nYrmg: bets $1
W8P9bUKCs43TO1xHm0dL6w: calls $1
*** TURN *** [9s 7s 6c] [Kc]
massary joins the table at seat #5
gUUvmqdVlmvpal6B8nYrmg: checks
W8P9bUKCs43TO1xHm0dL6w: checks
*** RIVER *** [9s 7s 6c Kc] [Ts]
gUUvmqdVlmvpal6B8nYrmg: checks
W8P9bUKCs43TO1xHm0dL6w: bets $3
gUUvmqdVlmvpal6B8nYrmg: folds
W8P9bUKCs43TO1xHm0dL6w collected $4.30 from pot
*** SUMMARY ***
Total pot $4.50 | Rake $0.20
Board [9s 7s 6c Kc Ts]
Seat 1: S3Ex8K7v6xm5jqjRM7Fl3w folded before Flop (didn't bet)
Seat 2: r27C1nIV4NS4+qbnrgBQSw (button) folded before Flop (didn't bet)
Seat 4: UWB3oeddt/GObx2Mix2Anw (small blind) folded before Flop
Seat 6: gUUvmqdVlmvpal6B8nYrmg (big blind) folded on the River
Seat 7: FL3MrLspcF23LYvC4ipBOA folded before Flop (didn't bet)
Seat 8: /zy+DB4S5fUQUSfZWFzYGw folded before Flop (didn't bet)
Seat 9: W8P9bUKCs43TO1xHm0dL6w collected ($4.30)



PokerStars Game #59941089712:  Hold'em No Limit ($0.50/$1.00) - 2009/07/01 1:25:20 ET
Table 'jDQgUn1zGkyftPnHo0Awdw' 2-max Seat #2 is the button
Seat 1: a42+e5QB6s1kkG5FoSTZJw ($103.70 in chips)
Seat 2: q+vRKwm51mnr6kxX/161WQ ($93.20 in chips)
q+vRKwm51mnr6kxX/161WQ: posts small blind $0.50
a42+e5QB6s1kkG5FoSTZJw: posts big blind $1
*** HOLE CARDS ***
q+vRKwm51mnr6kxX/161WQ: folds
a42+e5QB6s1kkG5FoSTZJw collected $1 from pot
a42+e5QB6s1kkG5FoSTZJw: doesn't show hand
*** SUMMARY ***
Total pot $1 | Rake $0
Seat 1: a42+e5QB6s1kkG5FoSTZJw (big blind) collected ($1)
Seat 2: q+vRKwm51mnr6kxX/161WQ (button) (small blind) folded before Flop



PokerStars Game #59941089982:  Hold'em No Limit ($0.50/$1.00) - 2009/07/01 1:25:21 ET
Table 'Evb7VW0qfDhFkbgBL3gcqQ' 2-max Seat #2 is the button
Seat 1: NYi6JFscYNrofSXy4sM+Yw ($123.65 in chips)
Seat 2: AoEQlM/FNYM0d7Txn1TfBQ ($82.25 in chips)
AoEQlM/FNYM0d7Txn1TfBQ: posts small blind $0.50
NYi6JFscYNrofSXy4sM+Yw: posts big blind $1
*** HOLE CARDS ***
AoEQlM/FNYM0d7Txn1TfBQ: folds
NYi6JFscYNrofSXy4sM+Yw collected $1 from pot
*** SUMMARY ***
Total pot $1 | Rake $0
Seat 1: NYi6JFscYNrofSXy4sM+Yw (big blind) collected ($1)
Seat 2: AoEQlM/FNYM0d7Txn1TfBQ (button) (small blind) folded before Flop



PokerStars Game #59941090550:  Hold'em No Limit ($0.50/$1.00) - 2009/07/01 1:25:22 ET
Table 'tJq9SfN1ywY0r03VBlWlwQ' 9-max Seat #4 is the button
Seat 1: wZsU+w9r7G66x93UuvBf1Q ($322.80 in chips)
Seat 3: FVs16t7GgfWgQWt4JxsObQ ($17.30 in chips)
Seat 4: bLbSOSmSOnqE0iTcH/5dxA ($113.65 in chips)
Seat 5: h5ipsNTMyolp7xn/NAvWkA ($128 in chips)
Seat 6: gUUvmqdVlmvpal6B8nYrmg ($100 in chips)
Seat 7: Pp/KTcXkfZKKUHkjyaLTdg ($18.50 in chips)
Seat 8: G4DEhsZFmznGNVpy2SEocA ($22.25 in chips)
Seat 9: XE5QF1y74bpHog9JxWJMWQ ($100 in chips)
h5ipsNTMyolp7xn/NAvWkA: posts small blind $0.50
gUUvmqdVlmvpal6B8nYrmg: posts big blind $1
VPF+HjszMvUIpy0CHIwH3A: sits out
*** HOLE CARDS ***
Pp/KTcXkfZKKUHkjyaLTdg: raises $2.50 to $3.50
G4DEhsZFmznGNVpy2SEocA: folds
XE5QF1y74bpHog9JxWJMWQ: folds
wZsU+w9r7G66x93UuvBf1Q: folds
FVs16t7GgfWgQWt4JxsObQ: calls $3.50
bLbSOSmSOnqE0iTcH/5dxA: folds
h5ipsNTMyolp7xn/NAvWkA: folds
gUUvmqdVlmvpal6B8nYrmg: folds
*** FLOP *** [Qs 4c Th]
Pp/KTcXkfZKKUHkjyaLTdg: bets $4
FVs16t7GgfWgQWt4JxsObQ: calls $4
*** TURN *** [Qs 4c Th] [7d]
Pp/KTcXkfZKKUHkjyaLTdg: bets $11 and is all-in
FVs16t7GgfWgQWt4JxsObQ: calls $9.80 and is all-in
*** RIVER *** [Qs 4c Th 7d] [7c]
*** SHOW DOWN ***
Pp/KTcXkfZKKUHkjyaLTdg: shows [Ad As] (two pair, Aces and Sevens)
FVs16t7GgfWgQWt4JxsObQ: mucks hand
Pp/KTcXkfZKKUHkjyaLTdg collected $34.35 from pot
*** SUMMARY ***
Total pot $36.10 | Rake $1.75
Board [Qs 4c Th 7d 7c]
Seat 1: wZsU+w9r7G66x93UuvBf1Q folded before Flop (didn't bet)
Seat 3: FVs16t7GgfWgQWt4JxsObQ mucked
Seat 4: bLbSOSmSOnqE0iTcH/5dxA (button) folded before Flop (didn't bet)
Seat 5: h5ipsNTMyolp7xn/NAvWkA (small blind) folded before Flop
Seat 6: gUUvmqdVlmvpal6B8nYrmg (big blind) folded before Flop
Seat 7: Pp/KTcXkfZKKUHkjyaLTdg showed [Ad As] and won ($34.35) with two pair, Aces and Sevens
Seat 8: G4DEhsZFmznGNVpy2SEocA folded before Flop (didn't bet)
Seat 9: XE5QF1y74bpHog9JxWJMWQ folded before Flop (didn't bet)



PokerStars Game #59941091286:  Hold'em No Limit ($0.50/$1.00) - 2009/07/01 1:25:23 ET
Table 'O96CPOtvMBWP6kzuYDfdFA' 6-max Seat #4 is the button
Seat 1: 6alLXQIITA2EZ/lBeym8Dw ($122.75 in chips)
Seat 2: 4d1rWhpu8DzLmzMbR3QKyA ($116.10 in chips)
Seat 3: V89DGjxE171oPREEbAXiyg ($91.65 in chips)
Seat 4: /P4w1pHg2zHYg/4ubJ0dPw ($63.65 in chips)
Seat 5: G5ZSSN6RSON3gkNvk/SmYg ($100 in chips)
Seat 6: GYei5jXGWexiJYbAT2fELg ($29.45 in chips)
G5ZSSN6RSON3gkNvk/SmYg: posts small blind $0.50
GYei5jXGWexiJYbAT2fELg: posts big blind $1
*** HOLE CARDS ***
6alLXQIITA2EZ/lBeym8Dw: folds
4d1rWhpu8DzLmzMbR3QKyA: folds
V89DGjxE171oPREEbAXiyg: folds
/P4w1pHg2zHYg/4ubJ0dPw: folds
G5ZSSN6RSON3gkNvk/SmYg: folds
GYei5jXGWexiJYbAT2fELg collected $1 from pot
*** SUMMARY ***
Total pot $1 | Rake $0
Seat 1: 6alLXQIITA2EZ/lBeym8Dw folded before Flop (didn't bet)
Seat 2: 4d1rWhpu8DzLmzMbR3QKyA folded before Flop (didn't bet)
Seat 3: V89DGjxE171oPREEbAXiyg folded before Flop (didn't bet)
Seat 4: /P4w1pHg2zHYg/4ubJ0dPw (button) folded before Flop (didn't bet)
Seat 5: G5ZSSN6RSON3gkNvk/SmYg (small blind) folded before Flop
Seat 6: GYei5jXGWexiJYbAT2fELg (big blind) collected ($1)



PokerStars Game #59941091672:  Hold'em No Limit ($0.50/$1.00) - 2009/07/01 1:25:24 ET
Table '7Nl0ffnjeK44/vmeexh3MQ' 9-max Seat #1 is the button
Seat 1: V138SURkdX8LdVBPKdJJag ($100 in chips)
Seat 2: OGgaARGdJQT4awWVNQ957w ($101 in chips)
Seat 3: JMmUYT5pIKCKh2pGjCB/4w ($60.40 in chips)
Seat 4: bLbSOSmSOnqE0iTcH/5dxA ($111.80 in chips)
Seat 6: FVs16t7GgfWgQWt4JxsObQ ($16.65 in chips)
Seat 7: 997ViqAtWn1FPjJqcffwcA ($100 in chips)
Seat 8: D+W9Me7w6Hcx/WRUSKV0dw ($20 in chips)
Seat 9: rFvc7K/96V9eGvYRfmpoUQ ($23.45 in chips)
OGgaARGdJQT4awWVNQ957w: posts small blind $0.50
JMmUYT5pIKCKh2pGjCB/4w: posts big blind $1
*** HOLE CARDS ***
bLbSOSmSOnqE0iTcH/5dxA: folds
FVs16t7GgfWgQWt4JxsObQ: calls $1
997ViqAtWn1FPjJqcffwcA: folds
D+W9Me7w6Hcx/WRUSKV0dw: folds
rFvc7K/96V9eGvYRfmpoUQ: folds
rFvc7K/96V9eGvYRfmpoUQ leaves the table
V138SURkdX8LdVBPKdJJag: folds
OGgaARGdJQT4awWVNQ957w: folds
JMmUYT5pIKCKh2pGjCB/4w: checks
*** FLOP *** [Jc 3d 2s]
JMmUYT5pIKCKh2pGjCB/4w: checks
FVs16t7GgfWgQWt4JxsObQ: checks
*** TURN *** [Jc 3d 2s] [Qc]
JMmUYT5pIKCKh2pGjCB/4w: checks
Mozuss joins the table at seat #9
FVs16t7GgfWgQWt4JxsObQ: bets $3
JMmUYT5pIKCKh2pGjCB/4w: folds
FVs16t7GgfWgQWt4JxsObQ collected $2.40 from pot
*** SUMMARY ***
Total pot $2.50 | Rake $0.10
Board [Jc 3d 2s Qc]
Seat 1: V138SURkdX8LdVBPKdJJag (button) folded before Flop (didn't bet)
Seat 2: OGgaARGdJQT4awWVNQ957w (small blind) folded before Flop
Seat 3: JMmUYT5pIKCKh2pGjCB/4w (big blind) folded on the Turn
Seat 4: bLbSOSmSOnqE0iTcH/5dxA folded before Flop (didn't bet)
Seat 6: FVs16t7GgfWgQWt4JxsObQ collected ($2.40)
Seat 7: 997ViqAtWn1FPjJqcffwcA folded before Flop (didn't bet)
Seat 8: D+W9Me7w6Hcx/WRUSKV0dw folded before Flop (didn't bet)
Seat 9: rFvc7K/96V9eGvYRfmpoUQ folded before Flop (didn't bet)



PokerStars Game #59941092416:  Hold'em No Limit ($0.50/$1.00) - 2009/07/01 1:25:25 ET
Table 'QSIig7BLMc9wY/rgBechzw' 6-max Seat #5 is the button
Seat 1: Z2fXsGcjl+Eax+RzOgwOmg ($112.10 in chips)
Seat 2: mLOIkH/qmRa+mVujQIhBRg ($50.90 in chips)
Seat 3: +xW7QemQU0Fxs+4TnqBRow ($111.50 in chips)
Seat 4: +uSzP8Jwnw7sKfQ4s66b7w ($62.15 in chips)
Seat 5: lsLuWlcPA3Rh7kJVLzMh0Q ($100 in chips)
Seat 6: PxqfkAMdAWtkgbT+q2gciA ($44.85 in chips)
PxqfkAMdAWtkgbT+q2gciA: posts small blind $0.50
Z2fXsGcjl+Eax+RzOgwOmg: posts big blind $1
*** HOLE CARDS ***
mLOIkH/qmRa+mVujQIhBRg: calls $1
+xW7QemQU0Fxs+4TnqBRow: folds
+uSzP8Jwnw7sKfQ4s66b7w has timed out
+uSzP8Jwnw7sKfQ4s66b7w: folds
+uSzP8Jwnw7sKfQ4s66b7w is sitting out
lsLuWlcPA3Rh7kJVLzMh0Q: folds
PxqfkAMdAWtkgbT+q2gciA: raises $2 to $3
Z2fXsGcjl+Eax+RzOgwOmg: folds
+uSzP8Jwnw7sKfQ4s66b7w has returned
mLOIkH/qmRa+mVujQIhBRg: calls $2
*** FLOP *** [2d Jc Kc]
PxqfkAMdAWtkgbT+q2gciA: bets $3
mLOIkH/qmRa+mVujQIhBRg: folds
PxqfkAMdAWtkgbT+q2gciA collected $6.65 from pot
*** SUMMARY ***
Total pot $7 | Rake $0.35
Board [2d Jc Kc]
Seat 1: Z2fXsGcjl+Eax+RzOgwOmg (big blind) folded before Flop
Seat 2: mLOIkH/qmRa+mVujQIhBRg folded on the Flop
Seat 3: +xW7QemQU0Fxs+4TnqBRow folded before Flop (didn't bet)
Seat 4: +uSzP8Jwnw7sKfQ4s66b7w folded before Flop (didn't bet)
Seat 5: lsLuWlcPA3Rh7kJVLzMh0Q (button) folded before Flop (didn't bet)
Seat 6: PxqfkAMdAWtkgbT+q2gciA (small blind) collected ($6.65)



PokerStars Game #59941092294:  Hold'em No Limit ($0.50/$1.00) - 2009/07/01 1:25:25 ET
Table 'ZFWj23PMihdwrNWv41OG/Q' 9-max Seat #7 is the button
Seat 1: yAbu2QsRPVcjPbqlf/jDxw ($123.85 in chips)
Seat 2: ARfmgHcEUKh68laBZy4veA ($71.80 in chips)
Seat 3: G9Fo2TZCN7HI43Po4zSN3A ($117.95 in chips)
Seat 4: D+W9Me7w6Hcx/WRUSKV0dw ($25.10 in chips)
Seat 5: tkdBeXTJlFsZdioidNqLow ($109.75 in chips)
Seat 6: 3obndzTJ6fECz8+wWhMd1w ($21.50 in chips)
Seat 7: 2uQqi2bcuMs+2q7ej+tN+Q ($90.50 in chips)
Seat 8: 997ViqAtWn1FPjJqcffwcA ($119.10 in chips)
Seat 9: 6XkTu4ahxzHnvjjc1R8YjQ ($100 in chips)
997ViqAtWn1FPjJqcffwcA: posts small blind $0.50
6XkTu4ahxzHnvjjc1R8YjQ: posts big blind $1
*** HOLE CARDS ***
yAbu2QsRPVcjPbqlf/jDxw: folds
ARfmgHcEUKh68laBZy4veA: folds
G9Fo2TZCN7HI43Po4zSN3A: folds
D+W9Me7w6Hcx/WRUSKV0dw: folds
tkdBeXTJlFsZdioidNqLow has timed out
tkdBeXTJlFsZdioidNqLow: folds
tkdBeXTJlFsZdioidNqLow is sitting out
3obndzTJ6fECz8+wWhMd1w: folds
tkdBeXTJlFsZdioidNqLow has returned
2uQqi2bcuMs+2q7ej+tN+Q: raises $1 to $2
997ViqAtWn1FPjJqcffwcA: folds
6XkTu4ahxzHnvjjc1R8YjQ: folds
2uQqi2bcuMs+2q7ej+tN+Q collected $2.50 from pot
2uQqi2bcuMs+2q7ej+tN+Q: doesn't show hand
*** SUMMARY ***
Total pot $2.50 | Rake $0
Seat 1: yAbu2QsRPVcjPbqlf/jDxw folded before Flop (didn't bet)
Seat 2: ARfmgHcEUKh68laBZy4veA folded before Flop (didn't bet)
Seat 3: G9Fo2TZCN7HI43Po4zSN3A folded before Flop (didn't bet)
Seat 4: D+W9Me7w6Hcx/WRUSKV0dw folded before Flop (didn't bet)
Seat 5: tkdBeXTJlFsZdioidNqLow folded before Flop (didn't bet)
Seat 6: 3obndzTJ6fECz8+wWhMd1w folded before Flop (didn't bet)
Seat 7: 2uQqi2bcuMs+2q7ej+tN+Q (button) collected ($2.50)
Seat 8: 997ViqAtWn1FPjJqcffwcA (small blind) folded before Flop
Seat 9: 6XkTu4ahxzHnvjjc1R8YjQ (big blind) folded before Flop



PokerStars Game #59941092624:  Hold'em No Limit ($0.50/$1.00) - 2009/07/01 1:25:26 ET
Table 'TvsifD4n+q//fIZ4fM1xxQ' 2-max Seat #2 is the button
Seat 1: NYi6JFscYNrofSXy4sM+Yw ($175.65 in chips)
Seat 2: +W/hy0gBp0sJy8pjLz6Yrg ($97 in chips)
+W/hy0gBp0sJy8pjLz6Yrg: posts small blind $0.50
NYi6JFscYNrofSXy4sM+Yw: posts big blind $1
*** HOLE CARDS ***
+W/hy0gBp0sJy8pjLz6Yrg: calls $0.50
NYi6JFscYNrofSXy4sM+Yw: checks
*** FLOP *** [4h 6s 8c]
NYi6JFscYNrofSXy4sM+Yw: checks
+W/hy0gBp0sJy8pjLz6Yrg: checks
*** TURN *** [4h 6s 8c] [8s]
NYi6JFscYNrofSXy4sM+Yw: checks
+W/hy0gBp0sJy8pjLz6Yrg: checks
*** RIVER *** [4h 6s 8c 8s] [2c]
NYi6JFscYNrofSXy4sM+Yw: checks
+W/hy0gBp0sJy8pjLz6Yrg: checks
*** SHOW DOWN ***
NYi6JFscYNrofSXy4sM+Yw: shows [Jd 3d] (a pair of Eights)
+W/hy0gBp0sJy8pjLz6Yrg: shows [Qd 3c] (a pair of Eights - Queen kicker)
+W/hy0gBp0sJy8pjLz6Yrg collected $1.90 from pot
*** SUMMARY ***
Total pot $2 | Rake $0.10
Board [4h 6s 8c 8s 2c]
Seat 1: NYi6JFscYNrofSXy4sM+Yw (big blind) showed [Jd 3d] and lost with a pair of Eights
Seat 2: +W/hy0gBp0sJy8pjLz6Yrg (button) (small blind) showed [Qd 3c] and won ($1.90) with a pair of Eights



PokerStars Game #59941093098:  Hold'em No Limit ($0.50/$1.00) - 2009/07/01 1:25:26 ET
Table 'jDQgUn1zGkyftPnHo0Awdw' 2-max Seat #1 is the button
Seat 1: a42+e5QB6s1kkG5FoSTZJw ($104.20 in chips)
Seat 2: q+vRKwm51mnr6kxX/161WQ ($92.70 in chips)
a42+e5QB6s1kkG5FoSTZJw: posts small blind $0.50
q+vRKwm51mnr6kxX/161WQ: posts big blind $1
*** HOLE CARDS ***
a42+e5QB6s1kkG5FoSTZJw: raises $1 to $2
q+vRKwm51mnr6kxX/161WQ: calls $1
*** FLOP *** [Qs 6c Ad]
q+vRKwm51mnr6kxX/161WQ: checks
a42+e5QB6s1kkG5FoSTZJw: bets $1
q+vRKwm51mnr6kxX/161WQ: calls $1
*** TURN *** [Qs 6c Ad] [4h]
q+vRKwm51mnr6kxX/161WQ: checks
a42+e5QB6s1kkG5FoSTZJw: bets $3
q+vRKwm51mnr6kxX/161WQ: folds
a42+e5QB6s1kkG5FoSTZJw collected $5.75 from pot
a42+e5QB6s1kkG5FoSTZJw: doesn't show hand
*** SUMMARY ***
Total pot $6 | Rake $0.25
Board [Qs 6c Ad 4h]
Seat 1: a42+e5QB6s1kkG5FoSTZJw (button) (small blind) collected ($5.75)
Seat 2: q+vRKwm51mnr6kxX/161WQ (big blind) folded on the Turn



PokerStars Game #59941093328:  Hold'em No Limit ($0.50/$1.00) - 2009/07/01 1:25:27 ET
Table 'Evb7VW0qfDhFkbgBL3gcqQ' 2-max Seat #1 is the button
Seat 1: NYi6JFscYNrofSXy4sM+Yw ($124.15 in chips)
Seat 2: AoEQlM/FNYM0d7Txn1TfBQ ($81.75 in chips)
NYi6JFscYNrofSXy4sM+Yw: posts small blind $0.50
AoEQlM/FNYM0d7Txn1TfBQ: posts big blind $1
*** HOLE CARDS ***
NYi6JFscYNrofSXy4sM+Yw: folds
AoEQlM/FNYM0d7Txn1TfBQ collected $1 from pot
*** SUMMARY ***
Total pot $1 | Rake $0
Seat 1: NYi6JFscYNrofSXy4sM+Yw (button) (small blind) folded before Flop
Seat 2: AoEQlM/FNYM0d7Txn1TfBQ (big blind) collected ($1)



PokerStars Game #59941093514:  Hold'em No Limit ($0.50/$1.00) - 2009/07/01 1:25:27 ET
Table 'CASNP0uy1C+jGLml/I4PtA' 9-max Seat #8 is the button
Seat 1: tkdBeXTJlFsZdioidNqLow ($61.50 in chips)
Seat 2: LUsAYklr0mQkiq7ASOyD9A ($62.50 in chips)
Seat 3: bJckevFOcg//s0qyMQI6sQ ($100 in chips)
Seat 4: B/G0GJacqZ8K59/ZVdq4kQ ($69.15 in chips)
Seat 5: Jjc7EHWzs4//xUAjJ0UWoA ($10.50 in chips)
Seat 6: FJEywSpo5JbRKByzmweboA ($100 in chips)
Seat 7: S3Ex8K7v6xm5jqjRM7Fl3w ($22 in chips)
Seat 8: L9njYvloJ1NdXjP8edHEAg ($104.45 in chips)
Seat 9: Pp/KTcXkfZKKUHkjyaLTdg ($20.50 in chips)
Pp/KTcXkfZKKUHkjyaLTdg: posts small blind $0.50
tkdBeXTJlFsZdioidNqLow: posts big blind $1
*** HOLE CARDS ***
LUsAYklr0mQkiq7ASOyD9A: folds
bJckevFOcg//s0qyMQI6sQ: folds
B/G0GJacqZ8K59/ZVdq4kQ: calls $1
Jjc7EHWzs4//xUAjJ0UWoA: folds
FJEywSpo5JbRKByzmweboA: folds
S3Ex8K7v6xm5jqjRM7Fl3w: folds
L9njYvloJ1NdXjP8edHEAg: folds
Pp/KTcXkfZKKUHkjyaLTdg: folds
tkdBeXTJlFsZdioidNqLow: checks
*** FLOP *** [2s Qs 8d]
tkdBeXTJlFsZdioidNqLow: checks
B/G0GJacqZ8K59/ZVdq4kQ: checks
*** TURN *** [2s Qs 8d] [4h]
tkdBeXTJlFsZdioidNqLow: checks
B/G0GJacqZ8K59/ZVdq4kQ: bets $4
Jjc7EHWzs4//xUAjJ0UWoA is disconnected
tkdBeXTJlFsZdioidNqLow: folds
B/G0GJacqZ8K59/ZVdq4kQ collected $2.40 from pot
*** SUMMARY ***
Total pot $2.50 | Rake $0.10
Board [2s Qs 8d 4h]
Seat 1: tkdBeXTJlFsZdioidNqLow (big blind) folded on the Turn
Seat 2: LUsAYklr0mQkiq7ASOyD9A folded before Flop (didn't bet)
Seat 3: bJckevFOcg//s0qyMQI6sQ folded before Flop (didn't bet)
Seat 4: B/G0GJacqZ8K59/ZVdq4kQ collected ($2.40)
Seat 5: Jjc7EHWzs4//xUAjJ0UWoA folded before Flop (didn't bet)
Seat 6: FJEywSpo5JbRKByzmweboA folded before Flop (didn't bet)
Seat 7: S3Ex8K7v6xm5jqjRM7Fl3w folded before Flop (didn't bet)
Seat 8: L9njYvloJ1NdXjP8edHEAg (button) folded before Flop (didn't bet)
Seat 9: Pp/KTcXkfZKKUHkjyaLTdg (small blind) folded before Flop



PokerStars Game #59941093932:  Hold'em No Limit ($0.50/$1.00) - 2009/07/01 1:25:28 ET
Table '305hiksPPCCdC6V2LNsO5w' 6-max Seat #3 is the button
Seat 1: RTuDLJHh/9zPfBftoc9vsw ($12.50 in chips)
Seat 2: j7NIOHLZk7V2o9fOioO5ug ($126.35 in chips)
Seat 3: +zIVjZKLpcidfRHgVZW8lA ($35.20 in chips)
Seat 4: uJVSceLggtsrJya+WtmUEA ($222.65 in chips)
Seat 5: +Nt3OPk3XR9SKjZgm2CexQ ($114.15 in chips)
Seat 6: 9/Tq8dw7kWW68uN8bFupXg ($8.10 in chips)
uJVSceLggtsrJya+WtmUEA: posts small blind $0.50
+Nt3OPk3XR9SKjZgm2CexQ: posts big blind $1
*** HOLE CARDS ***
9/Tq8dw7kWW68uN8bFupXg: raises $1 to $2
RTuDLJHh/9zPfBftoc9vsw: folds
j7NIOHLZk7V2o9fOioO5ug: folds
+zIVjZKLpcidfRHgVZW8lA: folds
uJVSceLggtsrJya+WtmUEA: calls $1.50
+Nt3OPk3XR9SKjZgm2CexQ: folds
*** FLOP *** [4h Td 7d]
uJVSceLggtsrJya+WtmUEA: bets $7
9/Tq8dw7kWW68uN8bFupXg: calls $6.10 and is all-in
*** TURN *** [4h Td 7d] [8d]
*** RIVER *** [4h Td 7d 8d] [4s]
*** SHOW DOWN ***
uJVSceLggtsrJya+WtmUEA: shows [7c Ah] (two pair, Sevens and Fours)
9/Tq8dw7kWW68uN8bFupXg: shows [6s 5s] (a straight, Four to Eight)
9/Tq8dw7kWW68uN8bFupXg collected $16.40 from pot
*** SUMMARY ***
Total pot $17.20 | Rake $0.80
Board [4h Td 7d 8d 4s]
Seat 1: RTuDLJHh/9zPfBftoc9vsw folded before Flop (didn't bet)
Seat 2: j7NIOHLZk7V2o9fOioO5ug folded before Flop (didn't bet)
Seat 3: +zIVjZKLpcidfRHgVZW8lA (button) folded before Flop (didn't bet)
Seat 4: uJVSceLggtsrJya+WtmUEA (small blind) showed [7c Ah] and lost with two pair, Sevens and Fours
Seat 5: +Nt3OPk3XR9SKjZgm2CexQ (big blind) folded before Flop
Seat 6: 9/Tq8dw7kWW68uN8bFupXg showed [6s 5s] and won ($16.40) with a straight, Four to Eight



PokerStars Game #59941094980:  Hold'em No Limit ($0.50/$1.00) - 2009/07/01 1:25:30 ET
Table 'cBDNutyLBKEk9+ptwsKmTw' 6-max Seat #5 is the button
Seat 1: xAU6q2/cwmby2sxmA8VcmA ($297.55 in chips)
Seat 3: G5ZSSN6RSON3gkNvk/SmYg ($110.40 in chips)
Seat 5: hpxXcmRkXXI9HE5+5/j/0Q ($100 in chips)
Seat 6: QHvTZcrKe6+maWUfVjP29Q ($152 in chips)
QHvTZcrKe6+maWUfVjP29Q: posts small blind $0.50
xAU6q2/cwmby2sxmA8VcmA: posts big blind $1
*** HOLE CARDS ***
4OO5v3AVduL0tePNx8wk5A joins the table at seat #2
G5ZSSN6RSON3gkNvk/SmYg: folds
hpxXcmRkXXI9HE5+5/j/0Q: folds
QHvTZcrKe6+maWUfVjP29Q: folds
xAU6q2/cwmby2sxmA8VcmA collected $1 from pot
*** SUMMARY ***
Total pot $1 | Rake $0
Seat 1: xAU6q2/cwmby2sxmA8VcmA (big blind) collected ($1)
Seat 3: G5ZSSN6RSON3gkNvk/SmYg folded before Flop (didn't bet)
Seat 5: hpxXcmRkXXI9HE5+5/j/0Q (button) folded before Flop (didn't bet)
Seat 6: QHvTZcrKe6+maWUfVjP29Q (small blind) folded before Flop



PokerStars Game #59941096626:  Hold'em No Limit ($0.50/$1.00) - 2009/07/01 1:25:33 ET
Table 'Evb7VW0qfDhFkbgBL3gcqQ' 2-max Seat #2 is the button
Seat 1: NYi6JFscYNrofSXy4sM+Yw ($123.65 in chips)
Seat 2: AoEQlM/FNYM0d7Txn1TfBQ ($82.25 in chips)
AoEQlM/FNYM0d7Txn1TfBQ: posts small blind $0.50
NYi6JFscYNrofSXy4sM+Yw: posts big blind $1
*** HOLE CARDS ***
AoEQlM/FNYM0d7Txn1TfBQ: folds
NYi6JFscYNrofSXy4sM+Yw collected $1 from pot
*** SUMMARY ***
Total pot $1 | Rake $0
Seat 1: NYi6JFscYNrofSXy4sM+Yw (big blind) collected ($1)
Seat 2: AoEQlM/FNYM0d7Txn1TfBQ (button) (small blind) folded before Flop



PokerStars Game #59941097650:  Hold'em No Limit ($0.50/$1.00) - 2009/07/01 1:25:34 ET
Table 'N6LvHFrb+cdXY/COI6ByOw' 2-max Seat #2 is the button
Seat 1: lXX4W7m3u++JiSOZ46yVMQ ($97.50 in chips)
Seat 2: 9mAoSP3o/mikSZOW2LEEAw ($102.50 in chips)
9mAoSP3o/mikSZOW2LEEAw: posts small blind $0.50
lXX4W7m3u++JiSOZ46yVMQ: posts big blind $1
*** HOLE CARDS ***
9mAoSP3o/mikSZOW2LEEAw: raises $1 to $2
lXX4W7m3u++JiSOZ46yVMQ: folds
9mAoSP3o/mikSZOW2LEEAw collected $2 from pot
9mAoSP3o/mikSZOW2LEEAw: doesn't show hand
*** SUMMARY ***
Total pot $2 | Rake $0
Seat 1: lXX4W7m3u++JiSOZ46yVMQ (big blind) folded before Flop
Seat 2: 9mAoSP3o/mikSZOW2LEEAw (button) (small blind) collected ($2)



PokerStars Game #59941097170:  Hold'em No Limit ($0.50/$1.00) - 2009/07/01 1:25:34 ET
Table 'fZjVbKj9D8yOB+Rj7NaP/A' 9-max Seat #1 is the button
Seat 1: 9BZCcac3+McErkkSN2YScA ($102.25 in chips)
Seat 2: PTAFYDIUSsG+SArbxNl+Aw ($104.50 in chips)
Seat 3: yAbu2QsRPVcjPbqlf/jDxw ($101 in chips)
Seat 4: 997ViqAtWn1FPjJqcffwcA ($101 in chips)
Seat 5: PkGfq5xrSlNsujKaG/HF4Q ($100 in chips)
Seat 6: OvwYHV65yUbgdBjSmo1+5g ($36.95 in chips)
Seat 7: SyS20PAm3RpT6uLBsGkwOA ($121.55 in chips)
Seat 8: zDOE5r14tWqCf6xhuSHK6g ($52.90 in chips)
Seat 9: qheQay5YvP2DMAb3OUSxtw ($99 in chips)
PTAFYDIUSsG+SArbxNl+Aw: posts small blind $0.50
yAbu2QsRPVcjPbqlf/jDxw: posts big blind $1
*** HOLE CARDS ***
997ViqAtWn1FPjJqcffwcA: folds
PkGfq5xrSlNsujKaG/HF4Q: folds
OvwYHV65yUbgdBjSmo1+5g: folds
SyS20PAm3RpT6uLBsGkwOA: folds
zDOE5r14tWqCf6xhuSHK6g: folds
qheQay5YvP2DMAb3OUSxtw: folds
9BZCcac3+McErkkSN2YScA: folds
PTAFYDIUSsG+SArbxNl+Aw: folds
yAbu2QsRPVcjPbqlf/jDxw collected $1 from pot
yAbu2QsRPVcjPbqlf/jDxw: doesn't show hand
*** SUMMARY ***
Total pot $1 | Rake $0
Seat 1: 9BZCcac3+McErkkSN2YScA (button) folded before Flop (didn't bet)
Seat 2: PTAFYDIUSsG+SArbxNl+Aw (small blind) folded before Flop
Seat 3: yAbu2QsRPVcjPbqlf/jDxw (big blind) collected ($1)
Seat 4: 997ViqAtWn1FPjJqcffwcA folded before Flop (didn't bet)
Seat 5: PkGfq5xrSlNsujKaG/HF4Q folded before Flop (didn't bet)
Seat 6: OvwYHV65yUbgdBjSmo1+5g folded before Flop (didn't bet)
Seat 7: SyS20PAm3RpT6uLBsGkwOA folded before Flop (didn't bet)
Seat 8: zDOE5r14tWqCf6xhuSHK6g folded before Flop (didn't bet)
Seat 9: qheQay5YvP2DMAb3OUSxtw folded before Flop (didn't bet)



PokerStars Game #59941099660:  Hold'em No Limit ($0.50/$1.00) - 2009/07/01 1:25:38 ET
Table 'MNvFfRVQNka/oY+Z5aMbZQ' 2-max Seat #1 is the button
Seat 1: DaZnoWHjO897dnh0CL2lVg ($69.90 in chips)
Seat 2: mgi+mjKb1Sc3CCs7TlfoCw ($51.35 in chips)
DaZnoWHjO897dnh0CL2lVg: posts small blind $0.50
mgi+mjKb1Sc3CCs7TlfoCw: posts big blind $1
*** HOLE CARDS ***
DaZnoWHjO897dnh0CL2lVg: raises $2 to $3
mgi+mjKb1Sc3CCs7TlfoCw: folds
DaZnoWHjO897dnh0CL2lVg collected $2 from pot
DaZnoWHjO897dnh0CL2lVg: doesn't show hand
*** SUMMARY ***
Total pot $2 | Rake $0
Seat 1: DaZnoWHjO897dnh0CL2lVg (button) (small blind) collected ($2)
Seat 2: mgi+mjKb1Sc3CCs7TlfoCw (big blind) folded before Flop



PokerStars Game #59941100160:  Hold'em No Limit ($0.50/$1.00) - 2009/07/01 1:25:39 ET
Table 'Evb7VW0qfDhFkbgBL3gcqQ' 2-max Seat #1 is the button
Seat 1: NYi6JFscYNrofSXy4sM+Yw ($124.15 in chips)
Seat 2: AoEQlM/FNYM0d7Txn1TfBQ ($81.75 in chips)
NYi6JFscYNrofSXy4sM+Yw: posts small blind $0.50
AoEQlM/FNYM0d7Txn1TfBQ: posts big blind $1
*** HOLE CARDS ***
NYi6JFscYNrofSXy4sM+Yw: raises $1 to $2
AoEQlM/FNYM0d7Txn1TfBQ: raises $2 to $4
NYi6JFscYNrofSXy4sM+Yw: raises $10 to $14
AoEQlM/FNYM0d7Txn1TfBQ: calls $10
*** FLOP *** [Qs 3h Ks]
AoEQlM/FNYM0d7Txn1TfBQ: checks
NYi6JFscYNrofSXy4sM+Yw: bets $15
AoEQlM/FNYM0d7Txn1TfBQ: folds
NYi6JFscYNrofSXy4sM+Yw collected $27.50 from pot
*** SUMMARY ***
Total pot $28 | Rake $0.50
Board [Qs 3h Ks]
Seat 1: NYi6JFscYNrofSXy4sM+Yw (button) (small blind) collected ($27.50)
Seat 2: AoEQlM/FNYM0d7Txn1TfBQ (big blind) folded on the Flop



PokerStars Game #59941100560:  Hold'em No Limit ($0.50/$1.00) - 2009/07/01 1:25:39 ET
Table 'mmbQQVBTrPdE+wy+s+9VPA' 6-max Seat #2 is the button
Seat 1: zyP4SPoWZnKUfTvIRLCVog ($79.35 in chips)
Seat 2: XK4Qsl+DA8gAJyg85/zBIw ($29.80 in chips)
Seat 3: wx3sQGkVi2x9wJXuWNHPBw ($127.85 in chips)
Seat 4: V3iZdcw61nXF3g5hD2RrsQ ($100 in chips)
Seat 5: YMJG+F++3Aj6P8dAWda5fw ($117.90 in chips)
Seat 6: U2CWBTv29qdCbj8RNF2sIw ($113.25 in chips)
wx3sQGkVi2x9wJXuWNHPBw: posts small blind $0.50
V3iZdcw61nXF3g5hD2RrsQ: posts big blind $1
*** HOLE CARDS ***
YMJG+F++3Aj6P8dAWda5fw: folds
U2CWBTv29qdCbj8RNF2sIw: raises $2 to $3
zyP4SPoWZnKUfTvIRLCVog: folds
XK4Qsl+DA8gAJyg85/zBIw: folds
wx3sQGkVi2x9wJXuWNHPBw: folds
V3iZdcw61nXF3g5hD2RrsQ: folds
U2CWBTv29qdCbj8RNF2sIw collected $2.50 from pot
*** SUMMARY ***
Total pot $2.50 | Rake $0
Seat 1: zyP4SPoWZnKUfTvIRLCVog folded before Flop (didn't bet)
Seat 2: XK4Qsl+DA8gAJyg85/zBIw (button) folded before Flop (didn't bet)
Seat 3: wx3sQGkVi2x9wJXuWNHPBw (small blind) folded before Flop
Seat 4: V3iZdcw61nXF3g5hD2RrsQ (big blind) folded before Flop
Seat 5: YMJG+F++3Aj6P8dAWda5fw folded before Flop (didn't bet)
Seat 6: U2CWBTv29qdCbj8RNF2sIw collected ($2.50)



PokerStars Game #59941100970:  Hold'em No Limit ($0.50/$1.00) - 2009/07/01 1:25:40 ET
Table 'fTlPiCj0utgzC/5io+I7ew' 6-max Seat #1 is the button
Seat 1: YMJG+F++3Aj6P8dAWda5fw ($93.55 in chips)
Seat 2: qVr1nl3dy2xXPqS8UpTDlA ($21.80 in chips)
Seat 3: Z2fXsGcjl+Eax+RzOgwOmg ($141.50 in chips)
Seat 4: uJVSceLggtsrJya+WtmUEA ($170.15 in chips)
Seat 5: XUk5GQsfNFpHvaToDZ0rZA ($45.65 in chips)
Seat 6: y27w5IK2WXqmYzS8OU0wKA ($100 in chips)
qVr1nl3dy2xXPqS8UpTDlA: posts small blind $0.50
Z2fXsGcjl+Eax+RzOgwOmg: posts big blind $1
*** HOLE CARDS ***
uJVSceLggtsrJya+WtmUEA: raises $2 to $3
XUk5GQsfNFpHvaToDZ0rZA: folds
y27w5IK2WXqmYzS8OU0wKA: folds
YMJG+F++3Aj6P8dAWda5fw: raises $6 to $9
qVr1nl3dy2xXPqS8UpTDlA: folds
Z2fXsGcjl+Eax+RzOgwOmg: folds
uJVSceLggtsrJya+WtmUEA: calls $6
*** FLOP *** [2d 8c Kc]
uJVSceLggtsrJya+WtmUEA: checks
YMJG+F++3Aj6P8dAWda5fw: bets $14
uJVSceLggtsrJya+WtmUEA: folds
YMJG+F++3Aj6P8dAWda5fw collected $18.55 from pot
*** SUMMARY ***
Total pot $19.50 | Rake $0.95
Board [2d 8c Kc]
Seat 1: YMJG+F++3Aj6P8dAWda5fw (button) collected ($18.55)
Seat 2: qVr1nl3dy2xXPqS8UpTDlA (small blind) folded before Flop
Seat 3: Z2fXsGcjl+Eax+RzOgwOmg (big blind) folded before Flop
Seat 4: uJVSceLggtsrJya+WtmUEA folded on the Flop
Seat 5: XUk5GQsfNFpHvaToDZ0rZA folded before Flop (didn't bet)
Seat 6: y27w5IK2WXqmYzS8OU0wKA folded before Flop (didn't bet)



PokerStars Game #59941101380:  Hold'em No Limit ($0.50/$1.00) - 2009/07/01 1:25:41 ET
Table 'N6LvHFrb+cdXY/COI6ByOw' 2-max Seat #1 is the button
Seat 1: lXX4W7m3u++JiSOZ46yVMQ ($96.50 in chips)
Seat 2: 9mAoSP3o/mikSZOW2LEEAw ($103.50 in chips)
lXX4W7m3u++JiSOZ46yVMQ: posts small blind $0.50
9mAoSP3o/mikSZOW2LEEAw: posts big blind $1
*** HOLE CARDS ***
lXX4W7m3u++JiSOZ46yVMQ: raises $2 to $3
9mAoSP3o/mikSZOW2LEEAw: raises $2 to $5
lXX4W7m3u++JiSOZ46yVMQ: calls $2
*** FLOP *** [6d 2s 2d]
9mAoSP3o/mikSZOW2LEEAw: checks
lXX4W7m3u++JiSOZ46yVMQ: bets $6
9mAoSP3o/mikSZOW2LEEAw: calls $6
*** TURN *** [6d 2s 2d] [Kh]
9mAoSP3o/mikSZOW2LEEAw: bets $3
lXX4W7m3u++JiSOZ46yVMQ: calls $3
*** RIVER *** [6d 2s 2d Kh] [4h]
9mAoSP3o/mikSZOW2LEEAw: checks
lXX4W7m3u++JiSOZ46yVMQ: bets $23
9mAoSP3o/mikSZOW2LEEAw: folds
lXX4W7m3u++JiSOZ46yVMQ collected $27.50 from pot
*** SUMMARY ***
Total pot $28 | Rake $0.50
Board [6d 2s 2d Kh 4h]
Seat 1: lXX4W7m3u++JiSOZ46yVMQ (button) (small blind) collected ($27.50)
Seat 2: 9mAoSP3o/mikSZOW2LEEAw (big blind) folded on the River



PokerStars Game #59941102102:  Hold'em No Limit ($0.50/$1.00) - 2009/07/01 1:25:42 ET
Table 'gxFK0BVUD7cupu2uyRUZJg' 6-max Seat #6 is the button
Seat 2: hpxXcmRkXXI9HE5+5/j/0Q ($136.55 in chips)
Seat 3: Z2fXsGcjl+Eax+RzOgwOmg ($105.50 in chips)
Seat 5: WgIrs6CBinyyw18pqdDtWA ($21.20 in chips)
Seat 6: dYyb6/42PMC8aNFlm/eBeQ ($119.50 in chips)
hpxXcmRkXXI9HE5+5/j/0Q: posts small blind $0.50
Z2fXsGcjl+Eax+RzOgwOmg: posts big blind $1
*** HOLE CARDS ***
WgIrs6CBinyyw18pqdDtWA: folds
dYyb6/42PMC8aNFlm/eBeQ: calls $1
hpxXcmRkXXI9HE5+5/j/0Q: folds
Z2fXsGcjl+Eax+RzOgwOmg: checks
*** FLOP *** [7c Qh Qs]
Z2fXsGcjl+Eax+RzOgwOmg: checks
dYyb6/42PMC8aNFlm/eBeQ: checks
*** TURN *** [7c Qh Qs] [Tc]
Z2fXsGcjl+Eax+RzOgwOmg: bets $2
dYyb6/42PMC8aNFlm/eBeQ: calls $2
*** RIVER *** [7c Qh Qs Tc] [8h]
Z2fXsGcjl+Eax+RzOgwOmg: bets $12
M+X3uChmP6R63IwijVjgTg has returned
dYyb6/42PMC8aNFlm/eBeQ: calls $12
*** SHOW DOWN ***
Z2fXsGcjl+Eax+RzOgwOmg: shows [Jc 9c] (a straight, Eight to Queen)
dYyb6/42PMC8aNFlm/eBeQ: mucks hand
Z2fXsGcjl+Eax+RzOgwOmg collected $29 from pot
*** SUMMARY ***
Total pot $30.50 | Rake $1.50
Board [7c Qh Qs Tc 8h]
Seat 2: hpxXcmRkXXI9HE5+5/j/0Q (small blind) folded before Flop
Seat 3: Z2fXsGcjl+Eax+RzOgwOmg (big blind) showed [Jc 9c] and won ($29) with a straight, Eight to Queen
Seat 5: WgIrs6CBinyyw18pqdDtWA folded before Flop (didn't bet)
Seat 6: dYyb6/42PMC8aNFlm/eBeQ (button) mucked



PokerStars Game #59941102688:  Hold'em No Limit ($0.50/$1.00) - 2009/07/01 1:25:43 ET
Table 'cBDNutyLBKEk9+ptwsKmTw' 6-max Seat #6 is the button
Seat 1: xAU6q2/cwmby2sxmA8VcmA ($298.05 in chips)
Seat 2: 4OO5v3AVduL0tePNx8wk5A ($100 in chips)
Seat 3: G5ZSSN6RSON3gkNvk/SmYg ($110.40 in chips)
Seat 5: hpxXcmRkXXI9HE5+5/j/0Q ($100 in chips)
Seat 6: QHvTZcrKe6+maWUfVjP29Q ($151.50 in chips)
xAU6q2/cwmby2sxmA8VcmA: posts small blind $0.50
4OO5v3AVduL0tePNx8wk5A: posts big blind $1
*** HOLE CARDS ***
G5ZSSN6RSON3gkNvk/SmYg: folds
hpxXcmRkXXI9HE5+5/j/0Q: raises $3 to $4
QHvTZcrKe6+maWUfVjP29Q: folds
3q7F5QtzC30pSrn0nl9i+A leaves the table
xAU6q2/cwmby2sxmA8VcmA: folds
4OO5v3AVduL0tePNx8wk5A: folds
hpxXcmRkXXI9HE5+5/j/0Q collected $2.50 from pot
hpxXcmRkXXI9HE5+5/j/0Q: doesn't show hand
*** SUMMARY ***
Total pot $2.50 | Rake $0
Seat 1: xAU6q2/cwmby2sxmA8VcmA (small blind) folded before Flop
Seat 2: 4OO5v3AVduL0tePNx8wk5A (big blind) folded before Flop
Seat 3: G5ZSSN6RSON3gkNvk/SmYg folded before Flop (didn't bet)
Seat 5: hpxXcmRkXXI9HE5+5/j/0Q collected ($2.50)
Seat 6: QHvTZcrKe6+maWUfVjP29Q (button) folded before Flop (didn't bet)



PokerStars Game #59941103684:  Hold'em No Limit ($0.50/$1.00) - 2009/07/01 1:25:45 ET
Table 'MNvFfRVQNka/oY+Z5aMbZQ' 2-max Seat #2 is the button
Seat 1: DaZnoWHjO897dnh0CL2lVg ($70.90 in chips)
Seat 2: mgi+mjKb1Sc3CCs7TlfoCw ($50.35 in chips)
mgi+mjKb1Sc3CCs7TlfoCw: posts small blind $0.50
DaZnoWHjO897dnh0CL2lVg: posts big blind $1
*** HOLE CARDS ***
mgi+mjKb1Sc3CCs7TlfoCw: raises $2 to $3
DaZnoWHjO897dnh0CL2lVg: folds
mgi+mjKb1Sc3CCs7TlfoCw collected $2 from pot
mgi+mjKb1Sc3CCs7TlfoCw: doesn't show hand
*** SUMMARY ***
Total pot $2 | Rake $0
Seat 1: DaZnoWHjO897dnh0CL2lVg (big blind) folded before Flop
Seat 2: mgi+mjKb1Sc3CCs7TlfoCw (button) (small blind) collected ($2)



PokerStars Game #59941104018:  Hold'em No Limit ($0.50/$1.00) - 2009/07/01 1:25:45 ET
Table 'jDQgUn1zGkyftPnHo0Awdw' 2-max Seat #2 is the button
Seat 1: a42+e5QB6s1kkG5FoSTZJw ($106.95 in chips)
Seat 2: q+vRKwm51mnr6kxX/161WQ ($89.70 in chips)
q+vRKwm51mnr6kxX/161WQ: posts small blind $0.50
a42+e5QB6s1kkG5FoSTZJw: posts big blind $1
*** HOLE CARDS ***
q+vRKwm51mnr6kxX/161WQ: raises $2 to $3
a42+e5QB6s1kkG5FoSTZJw: calls $2
*** FLOP *** [8h 3h 9h]
a42+e5QB6s1kkG5FoSTZJw: checks
q+vRKwm51mnr6kxX/161WQ: bets $4
a42+e5QB6s1kkG5FoSTZJw: folds
q+vRKwm51mnr6kxX/161WQ collected $5.70 from pot
q+vRKwm51mnr6kxX/161WQ: doesn't show hand
*** SUMMARY ***
Total pot $6 | Rake $0.30
Board [8h 3h 9h]
Seat 1: a42+e5QB6s1kkG5FoSTZJw (big blind) folded on the Flop
Seat 2: q+vRKwm51mnr6kxX/161WQ (button) (small blind) collected ($5.70)



PokerStars Game #59941104640:  Hold'em No Limit ($0.50/$1.00) - 2009/07/01 1:25:47 ET
Table 'MUPc8FEpe/nR0BKSeReX6Q' 6-max Seat #6 is the button
Seat 1: qhkK6+yCciTRd+rCFEbnEQ ($82.20 in chips)
Seat 2: xAU6q2/cwmby2sxmA8VcmA ($121.70 in chips)
Seat 3: wx3sQGkVi2x9wJXuWNHPBw ($287.50 in chips)
Seat 4: ZA1bp6g8IwtTxkUE4eCjDQ ($52.25 in chips)
Seat 5: y27w5IK2WXqmYzS8OU0wKA ($104.05 in chips)
Seat 6: oxnw0GLLpFanjhGkxfRSqA ($66.90 in chips)
qhkK6+yCciTRd+rCFEbnEQ: posts small blind $0.50
xAU6q2/cwmby2sxmA8VcmA: posts big blind $1
*** HOLE CARDS ***
wx3sQGkVi2x9wJXuWNHPBw: folds
ZA1bp6g8IwtTxkUE4eCjDQ: raises $5 to $6
y27w5IK2WXqmYzS8OU0wKA: folds
oxnw0GLLpFanjhGkxfRSqA: calls $6
qhkK6+yCciTRd+rCFEbnEQ: folds
xAU6q2/cwmby2sxmA8VcmA: calls $5
*** FLOP *** [Kh Th 4c]
xAU6q2/cwmby2sxmA8VcmA: checks
ZA1bp6g8IwtTxkUE4eCjDQ: checks
oxnw0GLLpFanjhGkxfRSqA: bets $5
xAU6q2/cwmby2sxmA8VcmA: calls $5
ZA1bp6g8IwtTxkUE4eCjDQ: calls $5
*** TURN *** [Kh Th 4c] [7s]
xAU6q2/cwmby2sxmA8VcmA: checks
ZA1bp6g8IwtTxkUE4eCjDQ: checks
oxnw0GLLpFanjhGkxfRSqA: bets $5
xAU6q2/cwmby2sxmA8VcmA: calls $5
ZA1bp6g8IwtTxkUE4eCjDQ: raises $36.25 to $41.25 and is all-in
oxnw0GLLpFanjhGkxfRSqA: calls $36.25
xAU6q2/cwmby2sxmA8VcmA: folds
*** RIVER *** [Kh Th 4c 7s] [Ts]
*** SHOW DOWN ***
ZA1bp6g8IwtTxkUE4eCjDQ: shows [6d 6s] (two pair, Tens and Sixes)
oxnw0GLLpFanjhGkxfRSqA: shows [Jc Kc] (two pair, Kings and Tens)
oxnw0GLLpFanjhGkxfRSqA collected $118 from pot
*** SUMMARY ***
Total pot $121 | Rake $3
Board [Kh Th 4c 7s Ts]
Seat 1: qhkK6+yCciTRd+rCFEbnEQ (small blind) folded before Flop
Seat 2: xAU6q2/cwmby2sxmA8VcmA (big blind) folded on the Turn
Seat 3: wx3sQGkVi2x9wJXuWNHPBw folded before Flop (didn't bet)
Seat 4: ZA1bp6g8IwtTxkUE4eCjDQ showed [6d 6s] and lost with two pair, Tens and Sixes
Seat 5: y27w5IK2WXqmYzS8OU0wKA folded before Flop (didn't bet)
Seat 6: oxnw0GLLpFanjhGkxfRSqA (button) showed [Jc Kc] and won ($118) with two pair, Kings and Tens



PokerStars Game #59941105536:  Hold'em No Limit ($0.50/$1.00) - 2009/07/01 1:25:48 ET
Table 'TvsifD4n+q//fIZ4fM1xxQ' 2-max Seat #1 is the button
Seat 1: NYi6JFscYNrofSXy4sM+Yw ($174.65 in chips)
Seat 2: +W/hy0gBp0sJy8pjLz6Yrg ($97.90 in chips)
NYi6JFscYNrofSXy4sM+Yw: posts small blind $0.50
+W/hy0gBp0sJy8pjLz6Yrg: posts big blind $1
*** HOLE CARDS ***
NYi6JFscYNrofSXy4sM+Yw: raises $2 to $3
+W/hy0gBp0sJy8pjLz6Yrg: calls $2
*** FLOP *** [Ks 7c Jh]
+W/hy0gBp0sJy8pjLz6Yrg: checks
NYi6JFscYNrofSXy4sM+Yw: bets $3
+W/hy0gBp0sJy8pjLz6Yrg: folds
NYi6JFscYNrofSXy4sM+Yw collected $5.70 from pot
*** SUMMARY ***
Total pot $6 | Rake $0.30
Board [Ks 7c Jh]
Seat 1: NYi6JFscYNrofSXy4sM+Yw (button) (small blind) collected ($5.70)
Seat 2: +W/hy0gBp0sJy8pjLz6Yrg (big blind) folded on the Flop



PokerStars Game #59941105332:  Hold'em No Limit ($0.50/$1.00) - 2009/07/01 1:25:48 ET
Table 'GPp0HyAuggN8oE0sUWzPpA' 9-max Seat #7 is the button
Seat 1: qJr25HAtvv1w/7IBvjMM3g ($47 in chips)
Seat 2: m3U8I35Pn3gxKhoS2nmYIg ($28.25 in chips)
Seat 3: CCCXsirC+bO7ginAuUUVlQ ($53.10 in chips)
Seat 4: mBRWbnUl8diyBO1qTJaNzw ($100.15 in chips)
Seat 5: bLbSOSmSOnqE0iTcH/5dxA ($100 in chips)
Seat 6: BK/GtNPkSx0TdUDj82id5A ($37.40 in chips)
Seat 7: DHdbHyysD15wCAtx+BhUjA ($93.20 in chips)
Seat 8: P/6qLjycEfxRgZ5F/W90dw ($95.50 in chips)
Seat 9: myIxN7otsyr846M539YR8Q ($20 in chips)
P/6qLjycEfxRgZ5F/W90dw: posts small blind $0.50
myIxN7otsyr846M539YR8Q: posts big blind $1
*** HOLE CARDS ***
qJr25HAtvv1w/7IBvjMM3g: calls $1
m3U8I35Pn3gxKhoS2nmYIg: folds
CCCXsirC+bO7ginAuUUVlQ: folds
mBRWbnUl8diyBO1qTJaNzw: folds
bLbSOSmSOnqE0iTcH/5dxA: folds
BK/GtNPkSx0TdUDj82id5A: folds
DHdbHyysD15wCAtx+BhUjA: folds
P/6qLjycEfxRgZ5F/W90dw: calls $0.50
myIxN7otsyr846M539YR8Q: checks
*** FLOP *** [4h 5d 9h]
P/6qLjycEfxRgZ5F/W90dw: bets $3
myIxN7otsyr846M539YR8Q: folds
qJr25HAtvv1w/7IBvjMM3g: folds
P/6qLjycEfxRgZ5F/W90dw collected $2.85 from pot
*** SUMMARY ***
Total pot $3 | Rake $0.15
Board [4h 5d 9h]
Seat 1: qJr25HAtvv1w/7IBvjMM3g folded on the Flop
Seat 2: m3U8I35Pn3gxKhoS2nmYIg folded before Flop (didn't bet)
Seat 3: CCCXsirC+bO7ginAuUUVlQ folded before Flop (didn't bet)
Seat 4: mBRWbnUl8diyBO1qTJaNzw folded before Flop (didn't bet)
Seat 5: bLbSOSmSOnqE0iTcH/5dxA folded before Flop (didn't bet)
Seat 6: BK/GtNPkSx0TdUDj82id5A folded before Flop (didn't bet)
Seat 7: DHdbHyysD15wCAtx+BhUjA (button) folded before Flop (didn't bet)
Seat 8: P/6qLjycEfxRgZ5F/W90dw (small blind) collected ($2.85)
Seat 9: myIxN7otsyr846M539YR8Q (big blind) folded on the Flop



PokerStars Game #59941105966:  Hold'em No Limit ($0.50/$1.00) - 2009/07/01 1:25:49 ET
Table '7O9fB8yx1u7sJveJn8w6jA' 6-max Seat #5 is the button
Seat 1: jy52+7FotjH63o5tEEVgKw ($61.70 in chips)
Seat 2: wx3sQGkVi2x9wJXuWNHPBw ($196.20 in chips)
Seat 3: hpxXcmRkXXI9HE5+5/j/0Q ($121.25 in chips)
Seat 4: b2a+5TkFf4xJN/Ihhma58Q ($39.55 in chips)
Seat 5: BCEV3COoKY607AzLWayfRA ($103.35 in chips)
Seat 6: 6hLdALbOlkzGIrc53QKtPw ($20 in chips)
6hLdALbOlkzGIrc53QKtPw: posts small blind $0.50
jy52+7FotjH63o5tEEVgKw: posts big blind $1
*** HOLE CARDS ***
wx3sQGkVi2x9wJXuWNHPBw: folds
hpxXcmRkXXI9HE5+5/j/0Q: folds
b2a+5TkFf4xJN/Ihhma58Q: folds
BCEV3COoKY607AzLWayfRA: raises $3 to $4
6hLdALbOlkzGIrc53QKtPw: folds
jy52+7FotjH63o5tEEVgKw: calls $3
*** FLOP *** [2h 9d Qc]
jy52+7FotjH63o5tEEVgKw: checks
BCEV3COoKY607AzLWayfRA: bets $6
jy52+7FotjH63o5tEEVgKw: calls $6
*** TURN *** [2h 9d Qc] [2d]
jy52+7FotjH63o5tEEVgKw: checks
BCEV3COoKY607AzLWayfRA: bets $10
jy52+7FotjH63o5tEEVgKw: calls $10
*** RIVER *** [2h 9d Qc 2d] [2c]
jy52+7FotjH63o5tEEVgKw: bets $11
BCEV3COoKY607AzLWayfRA: folds
jy52+7FotjH63o5tEEVgKw collected $38.55 from pot
*** SUMMARY ***
Total pot $40.50 | Rake $1.95
Board [2h 9d Qc 2d 2c]
Seat 1: jy52+7FotjH63o5tEEVgKw (big blind) collected ($38.55)
Seat 2: wx3sQGkVi2x9wJXuWNHPBw folded before Flop (didn't bet)
Seat 3: hpxXcmRkXXI9HE5+5/j/0Q folded before Flop (didn't bet)
Seat 4: b2a+5TkFf4xJN/Ihhma58Q folded before Flop (didn't bet)
Seat 5: BCEV3COoKY607AzLWayfRA (button) folded on the River
Seat 6: 6hLdALbOlkzGIrc53QKtPw (small blind) folded before Flop



PokerStars Game #59941106622:  Hold'em No Limit ($0.50/$1.00) - 2009/07/01 1:25:50 ET
Table 'O96CPOtvMBWP6kzuYDfdFA' 6-max Seat #5 is the button
Seat 1: 6alLXQIITA2EZ/lBeym8Dw ($122.75 in chips)
Seat 2: 4d1rWhpu8DzLmzMbR3QKyA ($116.10 in chips)
Seat 3: V89DGjxE171oPREEbAXiyg ($91.65 in chips)
Seat 4: /P4w1pHg2zHYg/4ubJ0dPw ($63.65 in chips)
Seat 5: G5ZSSN6RSON3gkNvk/SmYg ($100 in chips)
Seat 6: GYei5jXGWexiJYbAT2fELg ($29.95 in chips)
GYei5jXGWexiJYbAT2fELg: posts small blind $0.50
6alLXQIITA2EZ/lBeym8Dw: posts big blind $1
*** HOLE CARDS ***
4d1rWhpu8DzLmzMbR3QKyA: folds
V89DGjxE171oPREEbAXiyg: folds
/P4w1pHg2zHYg/4ubJ0dPw: folds
G5ZSSN6RSON3gkNvk/SmYg: folds
GYei5jXGWexiJYbAT2fELg: folds
6alLXQIITA2EZ/lBeym8Dw collected $1 from pot
*** SUMMARY ***
Total pot $1 | Rake $0
Seat 1: 6alLXQIITA2EZ/lBeym8Dw (big blind) collected ($1)
Seat 2: 4d1rWhpu8DzLmzMbR3QKyA folded before Flop (didn't bet)
Seat 3: V89DGjxE171oPREEbAXiyg folded before Flop (didn't bet)
Seat 4: /P4w1pHg2zHYg/4ubJ0dPw folded before Flop (didn't bet)
Seat 5: G5ZSSN6RSON3gkNvk/SmYg (button) folded before Flop (didn't bet)
Seat 6: GYei5jXGWexiJYbAT2fELg (small blind) folded before Flop



PokerStars Game #59941108482:  Hold'em No Limit ($0.50/$1.00) - 2009/07/01 1:25:53 ET
Table 'W/wyObTiXZm+Ckkl3YxcSw' 6-max Seat #3 is the button
Seat 1: eUBBn2R56C1IQ6Cs/vitwg ($293.55 in chips)
Seat 2: oDiBRCaF0QVtd3kO6xZIXw ($152.05 in chips)
Seat 3: dxyNCn/qxfkGDUIf28Cbng ($62.30 in chips)
Seat 4: UBZQqpnJZdTYYY1FTb0rLA ($100 in chips)
Seat 5: +OrCjyw70oZhJiD22Mn+bg ($100 in chips)
Seat 6: b2a+5TkFf4xJN/Ihhma58Q ($48.95 in chips)
UBZQqpnJZdTYYY1FTb0rLA: posts small blind $0.50
+OrCjyw70oZhJiD22Mn+bg: posts big blind $1
*** HOLE CARDS ***
b2a+5TkFf4xJN/Ihhma58Q: folds
eUBBn2R56C1IQ6Cs/vitwg: folds
oDiBRCaF0QVtd3kO6xZIXw: folds
dxyNCn/qxfkGDUIf28Cbng: raises $2 to $3
UBZQqpnJZdTYYY1FTb0rLA: folds
+OrCjyw70oZhJiD22Mn+bg: folds
dxyNCn/qxfkGDUIf28Cbng collected $2.50 from pot
*** SUMMARY ***
Total pot $2.50 | Rake $0
Seat 1: eUBBn2R56C1IQ6Cs/vitwg folded before Flop (didn't bet)
Seat 2: oDiBRCaF0QVtd3kO6xZIXw folded before Flop (didn't bet)
Seat 3: dxyNCn/qxfkGDUIf28Cbng (button) collected ($2.50)
Seat 4: UBZQqpnJZdTYYY1FTb0rLA (small blind) folded before Flop
Seat 5: +OrCjyw70oZhJiD22Mn+bg (big blind) folded before Flop
Seat 6: b2a+5TkFf4xJN/Ihhma58Q folded before Flop (didn't bet)



PokerStars Game #59941108276:  Hold'em No Limit ($0.50/$1.00) - 2009/07/01 1:25:53 ET
Table 'MNvFfRVQNka/oY+Z5aMbZQ' 2-max Seat #1 is the button
Seat 1: DaZnoWHjO897dnh0CL2lVg ($69.90 in chips)
Seat 2: mgi+mjKb1Sc3CCs7TlfoCw ($51.35 in chips)
DaZnoWHjO897dnh0CL2lVg: posts small blind $0.50
mgi+mjKb1Sc3CCs7TlfoCw: posts big blind $1
*** HOLE CARDS ***
DaZnoWHjO897dnh0CL2lVg: raises $2 to $3
mgi+mjKb1Sc3CCs7TlfoCw: calls $2
*** FLOP *** [Jd 5s 5h]
mgi+mjKb1Sc3CCs7TlfoCw: checks
DaZnoWHjO897dnh0CL2lVg: checks
*** TURN *** [Jd 5s 5h] [2c]
mgi+mjKb1Sc3CCs7TlfoCw: checks
DaZnoWHjO897dnh0CL2lVg: checks
*** RIVER *** [Jd 5s 5h 2c] [Th]
mgi+mjKb1Sc3CCs7TlfoCw: checks
DaZnoWHjO897dnh0CL2lVg: checks
*** SHOW DOWN ***
mgi+mjKb1Sc3CCs7TlfoCw: shows [4s 7s] (a pair of Fives)
DaZnoWHjO897dnh0CL2lVg: shows [9s Ks] (a pair of Fives - King kicker)
DaZnoWHjO897dnh0CL2lVg collected $5.70 from pot
*** SUMMARY ***
Total pot $6 | Rake $0.30
Board [Jd 5s 5h 2c Th]
Seat 1: DaZnoWHjO897dnh0CL2lVg (button) (small blind) showed [9s Ks] and won ($5.70) with a pair of Fives
Seat 2: mgi+mjKb1Sc3CCs7TlfoCw (big blind) showed [4s 7s] and lost with a pair of Fives



PokerStars Game #59941112102:  Hold'em No Limit ($0.50/$1.00) - 2009/07/01 1:25:59 ET
Table 'jDQgUn1zGkyftPnHo0Awdw' 2-max Seat #1 is the button
Seat 1: a42+e5QB6s1kkG5FoSTZJw ($103.95 in chips)
Seat 2: q+vRKwm51mnr6kxX/161WQ ($92.40 in chips)
a42+e5QB6s1kkG5FoSTZJw: posts small blind $0.50
q+vRKwm51mnr6kxX/161WQ: posts big blind $1
*** HOLE CARDS ***
a42+e5QB6s1kkG5FoSTZJw: folds
q+vRKwm51mnr6kxX/161WQ collected $1 from pot
q+vRKwm51mnr6kxX/161WQ: doesn't show hand
*** SUMMARY ***
Total pot $1 | Rake $0
Seat 1: a42+e5QB6s1kkG5FoSTZJw (button) (small blind) folded before Flop
Seat 2: q+vRKwm51mnr6kxX/161WQ (big blind) collected ($1)



PokerStars Game #59941111690:  Hold'em No Limit ($0.50/$1.00) - 2009/07/01 1:25:59 ET
Table 'pHrhryH8jPNdQfY62f8v+g' 6-max Seat #3 is the button
Seat 1: 4d1rWhpu8DzLmzMbR3QKyA ($133.25 in chips)
Seat 2: JwCcjZl0bjJzG7hmE0dnTA ($100 in chips)
Seat 3: 8oS5O7iD/qnFXFXJrGIgNQ ($104.60 in chips)
Seat 4: 1f3beyIML24UqEMTbWy93g ($56.40 in chips)
Seat 5: r1/R7y0Ortgoz4lccgW8VA ($13.75 in chips)
Seat 6: xAU6q2/cwmby2sxmA8VcmA ($203.60 in chips)
1f3beyIML24UqEMTbWy93g: posts small blind $0.50
r1/R7y0Ortgoz4lccgW8VA: posts big blind $1
*** HOLE CARDS ***
xAU6q2/cwmby2sxmA8VcmA: folds
4d1rWhpu8DzLmzMbR3QKyA: folds
JwCcjZl0bjJzG7hmE0dnTA: raises $2 to $3
8oS5O7iD/qnFXFXJrGIgNQ: folds
1f3beyIML24UqEMTbWy93g: calls $2.50
r1/R7y0Ortgoz4lccgW8VA: calls $2
*** FLOP *** [3c 3s 9d]
1f3beyIML24UqEMTbWy93g: checks
r1/R7y0Ortgoz4lccgW8VA: checks
JwCcjZl0bjJzG7hmE0dnTA: bets $6
1f3beyIML24UqEMTbWy93g: folds
r1/R7y0Ortgoz4lccgW8VA: folds
JwCcjZl0bjJzG7hmE0dnTA collected $8.55 from pot
*** SUMMARY ***
Total pot $9 | Rake $0.45
Board [3c 3s 9d]
Seat 1: 4d1rWhpu8DzLmzMbR3QKyA folded before Flop (didn't bet)
Seat 2: JwCcjZl0bjJzG7hmE0dnTA collected ($8.55)
Seat 3: 8oS5O7iD/qnFXFXJrGIgNQ (button) folded before Flop (didn't bet)
Seat 4: 1f3beyIML24UqEMTbWy93g (small blind) folded on the Flop
Seat 5: r1/R7y0Ortgoz4lccgW8VA (big blind) folded on the Flop
Seat 6: xAU6q2/cwmby2sxmA8VcmA folded before Flop (didn't bet)



PokerStars Game #59941112796:  Hold'em No Limit ($0.50/$1.00) - 2009/07/01 1:26:01 ET
Table 'TvsifD4n+q//fIZ4fM1xxQ' 2-max Seat #2 is the button
Seat 1: NYi6JFscYNrofSXy4sM+Yw ($177.35 in chips)
Seat 2: +W/hy0gBp0sJy8pjLz6Yrg ($94.90 in chips)
+W/hy0gBp0sJy8pjLz6Yrg: posts small blind $0.50
NYi6JFscYNrofSXy4sM+Yw: posts big blind $1
*** HOLE CARDS ***
+W/hy0gBp0sJy8pjLz6Yrg: raises $2 to $3
NYi6JFscYNrofSXy4sM+Yw: calls $2
*** FLOP *** [Kh Kc 7d]
NYi6JFscYNrofSXy4sM+Yw: checks
+W/hy0gBp0sJy8pjLz6Yrg: checks
*** TURN *** [Kh Kc 7d] [6c]
NYi6JFscYNrofSXy4sM+Yw: checks
+W/hy0gBp0sJy8pjLz6Yrg: checks
*** RIVER *** [Kh Kc 7d 6c] [3h]
NYi6JFscYNrofSXy4sM+Yw: checks
+W/hy0gBp0sJy8pjLz6Yrg: checks
*** SHOW DOWN ***
NYi6JFscYNrofSXy4sM+Yw: shows [Ts Qd] (a pair of Kings)
+W/hy0gBp0sJy8pjLz6Yrg: mucks hand
NYi6JFscYNrofSXy4sM+Yw collected $5.70 from pot
*** SUMMARY ***
Total pot $6 | Rake $0.30
Board [Kh Kc 7d 6c 3h]
Seat 1: NYi6JFscYNrofSXy4sM+Yw (big blind) showed [Ts Qd] and won ($5.70) with a pair of Kings
Seat 2: +W/hy0gBp0sJy8pjLz6Yrg (button) (small blind) mucked



PokerStars Game #59941113002:  Hold'em No Limit ($0.50/$1.00) - 2009/07/01 1:26:01 ET
Table 'cBDNutyLBKEk9+ptwsKmTw' 6-max Seat #1 is the button
Seat 1: xAU6q2/cwmby2sxmA8VcmA ($297.55 in chips)
Seat 2: 4OO5v3AVduL0tePNx8wk5A ($100 in chips)
Seat 3: G5ZSSN6RSON3gkNvk/SmYg ($110.40 in chips)
Seat 5: hpxXcmRkXXI9HE5+5/j/0Q ($101.50 in chips)
Seat 6: QHvTZcrKe6+maWUfVjP29Q ($151.50 in chips)
4OO5v3AVduL0tePNx8wk5A: posts small blind $0.50
G5ZSSN6RSON3gkNvk/SmYg: posts big blind $1
hominidae312 joins the table at seat #4
*** HOLE CARDS ***
hpxXcmRkXXI9HE5+5/j/0Q: folds
QHvTZcrKe6+maWUfVjP29Q: folds
xAU6q2/cwmby2sxmA8VcmA: raises $3 to $4
4OO5v3AVduL0tePNx8wk5A: folds
G5ZSSN6RSON3gkNvk/SmYg: folds
xAU6q2/cwmby2sxmA8VcmA collected $2.50 from pot
xAU6q2/cwmby2sxmA8VcmA: doesn't show hand
*** SUMMARY ***
Total pot $2.50 | Rake $0
Seat 1: xAU6q2/cwmby2sxmA8VcmA (button) collected ($2.50)
Seat 2: 4OO5v3AVduL0tePNx8wk5A (small blind) folded before Flop
Seat 3: G5ZSSN6RSON3gkNvk/SmYg (big blind) folded before Flop
Seat 5: hpxXcmRkXXI9HE5+5/j/0Q folded before Flop (didn't bet)
Seat 6: QHvTZcrKe6+maWUfVjP29Q folded before Flop (didn't bet)



PokerStars Game #59941114538:  Hold'em No Limit ($0.50/$1.00) - 2009/07/01 1:26:03 ET
Table 'Evb7VW0qfDhFkbgBL3gcqQ' 2-max Seat #2 is the button
Seat 1: NYi6JFscYNrofSXy4sM+Yw ($137.65 in chips)
Seat 2: AoEQlM/FNYM0d7Txn1TfBQ ($67.75 in chips)
AoEQlM/FNYM0d7Txn1TfBQ: posts small blind $0.50
NYi6JFscYNrofSXy4sM+Yw: posts big blind $1
*** HOLE CARDS ***
AoEQlM/FNYM0d7Txn1TfBQ: calls $0.50
NYi6JFscYNrofSXy4sM+Yw: raises $2 to $3
AoEQlM/FNYM0d7Txn1TfBQ: calls $2
*** FLOP *** [Th Jh 9c]
NYi6JFscYNrofSXy4sM+Yw: bets $3
AoEQlM/FNYM0d7Txn1TfBQ: calls $3
*** TURN *** [Th Jh 9c] [7s]
NYi6JFscYNrofSXy4sM+Yw: bets $5
AoEQlM/FNYM0d7Txn1TfBQ: calls $5
*** RIVER *** [Th Jh 9c 7s] [Tc]
NYi6JFscYNrofSXy4sM+Yw: bets $21
AoEQlM/FNYM0d7Txn1TfBQ: folds
NYi6JFscYNrofSXy4sM+Yw collected $21.50 from pot
*** SUMMARY ***
Total pot $22 | Rake $0.50
Board [Th Jh 9c 7s Tc]
Seat 1: NYi6JFscYNrofSXy4sM+Yw (big blind) collected ($21.50)
Seat 2: AoEQlM/FNYM0d7Txn1TfBQ (button) (small blind) folded on the River



PokerStars Game #59941114118:  Hold'em No Limit ($0.50/$1.00) - 2009/07/01 1:26:03 ET
Table '+cA8mcmhaedZ7YcrDdhmeQ' 6-max Seat #2 is the button
Seat 1: iIgNoBh+3/Ix1/fLsg+HuA ($47.65 in chips)
Seat 2: 14aYclSc98EYd6TrzN2l3Q ($6.90 in chips)
Seat 3: DAIgyIWbYvAkL6PbAI27pg ($18.55 in chips)
Seat 4: 4OO5v3AVduL0tePNx8wk5A ($100 in chips)
Seat 5: n5xXfJeDtWZSChGAdq//Tw ($18.55 in chips)
Seat 6: YfsTQsY/fxb+YqbdclTHuw ($27.25 in chips)
DAIgyIWbYvAkL6PbAI27pg: posts small blind $0.50
4OO5v3AVduL0tePNx8wk5A: posts big blind $1
*** HOLE CARDS ***
n5xXfJeDtWZSChGAdq//Tw: folds
YfsTQsY/fxb+YqbdclTHuw: folds
iIgNoBh+3/Ix1/fLsg+HuA: raises $2 to $3
14aYclSc98EYd6TrzN2l3Q: raises $3.90 to $6.90 and is all-in
DAIgyIWbYvAkL6PbAI27pg: folds
4OO5v3AVduL0tePNx8wk5A: folds
iIgNoBh+3/Ix1/fLsg+HuA: calls $3.90
*** FLOP *** [9d 8s Ks]
*** TURN *** [9d 8s Ks] [Kc]
*** RIVER *** [9d 8s Ks Kc] [5d]
*** SHOW DOWN ***
iIgNoBh+3/Ix1/fLsg+HuA: shows [Qh Ad] (a pair of Kings)
14aYclSc98EYd6TrzN2l3Q: shows [Tc 8d] (two pair, Kings and Eights)
14aYclSc98EYd6TrzN2l3Q collected $14.55 from pot
*** SUMMARY ***
Total pot $15.30 | Rake $0.75
Board [9d 8s Ks Kc 5d]
Seat 1: iIgNoBh+3/Ix1/fLsg+HuA showed [Qh Ad] and lost with a pair of Kings
Seat 2: 14aYclSc98EYd6TrzN2l3Q (button) showed [Tc 8d] and won ($14.55) with two pair, Kings and Eights
Seat 3: DAIgyIWbYvAkL6PbAI27pg (small blind) folded before Flop
Seat 4: 4OO5v3AVduL0tePNx8wk5A (big blind) folded before Flop
Seat 5: n5xXfJeDtWZSChGAdq//Tw folded before Flop (didn't bet)
Seat 6: YfsTQsY/fxb+YqbdclTHuw folded before Flop (didn't bet)



PokerStars Game #59941114856:  Hold'em No Limit ($0.50/$1.00) - 2009/07/01 1:26:04 ET
Table 'kS0cTQAEi+fdUlJP2gQYvw' 9-max Seat #2 is the button
Seat 1: /mfensKw8/iZ1Vrx33S4xg ($20 in chips)
Seat 2: D+W9Me7w6Hcx/WRUSKV0dw ($25.05 in chips)
Seat 3: 2BV+oJIQYr65IO6nEChvbA ($64.20 in chips)
Seat 4: RUhhaALzha3TH1AkdakoGQ ($54 in chips)
Seat 5: 997ViqAtWn1FPjJqcffwcA ($100 in chips)
Seat 6: yAbu2QsRPVcjPbqlf/jDxw ($126.15 in chips)
Seat 7: Ffa7Nj4X5fddtROP01hfQg ($154.60 in chips)
Seat 8: vKyFzTyzfT7fZcdX+HHN+Q ($31.50 in chips)
Seat 9: OGgaARGdJQT4awWVNQ957w ($100 in chips)
2BV+oJIQYr65IO6nEChvbA: posts small blind $0.50
RUhhaALzha3TH1AkdakoGQ: posts big blind $1
*** HOLE CARDS ***
997ViqAtWn1FPjJqcffwcA: folds
yAbu2QsRPVcjPbqlf/jDxw: folds
Ffa7Nj4X5fddtROP01hfQg: folds
vKyFzTyzfT7fZcdX+HHN+Q: calls $1
OGgaARGdJQT4awWVNQ957w: folds
/mfensKw8/iZ1Vrx33S4xg: folds
/mfensKw8/iZ1Vrx33S4xg leaves the table
D+W9Me7w6Hcx/WRUSKV0dw: folds
2BV+oJIQYr65IO6nEChvbA: calls $0.50
RUhhaALzha3TH1AkdakoGQ: checks
*** FLOP *** [9s 2d 2h]
2BV+oJIQYr65IO6nEChvbA: checks
RUhhaALzha3TH1AkdakoGQ: checks
vKyFzTyzfT7fZcdX+HHN+Q: checks
*** TURN *** [9s 2d 2h] [Ah]
2BV+oJIQYr65IO6nEChvbA: bets $1
RUhhaALzha3TH1AkdakoGQ: folds
vKyFzTyzfT7fZcdX+HHN+Q: calls $1
*** RIVER *** [9s 2d 2h Ah] [5s]
2BV+oJIQYr65IO6nEChvbA: checks
vKyFzTyzfT7fZcdX+HHN+Q: checks
*** SHOW DOWN ***
2BV+oJIQYr65IO6nEChvbA: shows [As Js] (two pair, Aces and Deuces)
vKyFzTyzfT7fZcdX+HHN+Q: mucks hand
2BV+oJIQYr65IO6nEChvbA collected $4.80 from pot
*** SUMMARY ***
Total pot $5 | Rake $0.20
Board [9s 2d 2h Ah 5s]
Seat 1: /mfensKw8/iZ1Vrx33S4xg folded before Flop (didn't bet)
Seat 2: D+W9Me7w6Hcx/WRUSKV0dw (button) folded before Flop (didn't bet)
Seat 3: 2BV+oJIQYr65IO6nEChvbA (small blind) showed [As Js] and won ($4.80) with two pair, Aces and Deuces
Seat 4: RUhhaALzha3TH1AkdakoGQ (big blind) folded on the Turn
Seat 5: 997ViqAtWn1FPjJqcffwcA folded before Flop (didn't bet)
Seat 6: yAbu2QsRPVcjPbqlf/jDxw folded before Flop (didn't bet)
Seat 7: Ffa7Nj4X5fddtROP01hfQg folded before Flop (didn't bet)
Seat 8: vKyFzTyzfT7fZcdX+HHN+Q mucked
Seat 9: OGgaARGdJQT4awWVNQ957w folded before Flop (didn't bet)



PokerStars Game #59941115726:  Hold'em No Limit ($0.50/$1.00) - 2009/07/01 1:26:05 ET
Table 'ZFWj23PMihdwrNWv41OG/Q' 9-max Seat #8 is the button
Seat 1: yAbu2QsRPVcjPbqlf/jDxw ($123.85 in chips)
Seat 2: ARfmgHcEUKh68laBZy4veA ($71.80 in chips)
Seat 3: G9Fo2TZCN7HI43Po4zSN3A ($117.95 in chips)
Seat 4: D+W9Me7w6Hcx/WRUSKV0dw ($25.10 in chips)
Seat 5: tkdBeXTJlFsZdioidNqLow ($109.75 in chips)
Seat 6: 3obndzTJ6fECz8+wWhMd1w ($21.50 in chips)
Seat 7: 2uQqi2bcuMs+2q7ej+tN+Q ($92 in chips)
Seat 8: 997ViqAtWn1FPjJqcffwcA ($118.60 in chips)
Seat 9: 6XkTu4ahxzHnvjjc1R8YjQ ($99 in chips)
6XkTu4ahxzHnvjjc1R8YjQ: posts small blind $0.50
yAbu2QsRPVcjPbqlf/jDxw: posts big blind $1
*** HOLE CARDS ***
ARfmgHcEUKh68laBZy4veA: calls $1
G9Fo2TZCN7HI43Po4zSN3A: folds
D+W9Me7w6Hcx/WRUSKV0dw: folds
tkdBeXTJlFsZdioidNqLow has timed out
tkdBeXTJlFsZdioidNqLow: folds
tkdBeXTJlFsZdioidNqLow is sitting out
tkdBeXTJlFsZdioidNqLow has returned
3obndzTJ6fECz8+wWhMd1w: raises $4 to $5
2uQqi2bcuMs+2q7ej+tN+Q: folds
997ViqAtWn1FPjJqcffwcA: folds
6XkTu4ahxzHnvjjc1R8YjQ: folds
yAbu2QsRPVcjPbqlf/jDxw: folds
ARfmgHcEUKh68laBZy4veA: calls $4
*** FLOP *** [6d Qs Qh]
ARfmgHcEUKh68laBZy4veA: checks
3obndzTJ6fECz8+wWhMd1w: bets $5
ARfmgHcEUKh68laBZy4veA: calls $5
*** TURN *** [6d Qs Qh] [Kc]
ARfmgHcEUKh68laBZy4veA: checks
3obndzTJ6fECz8+wWhMd1w: bets $8
ARfmgHcEUKh68laBZy4veA: raises $8 to $16
3obndzTJ6fECz8+wWhMd1w: calls $3.50 and is all-in
*** RIVER *** [6d Qs Qh Kc] [9c]
*** SHOW DOWN ***
ARfmgHcEUKh68laBZy4veA: shows [Js Kh] (two pair, Kings and Queens)
3obndzTJ6fECz8+wWhMd1w: shows [Qd Ac] (three of a kind, Queens)
ARfmgHcEUKh68laBZy4veA is sitting out
3obndzTJ6fECz8+wWhMd1w collected $42.35 from pot
*** SUMMARY ***
Total pot $44.50 | Rake $2.15
Board [6d Qs Qh Kc 9c]
Seat 1: yAbu2QsRPVcjPbqlf/jDxw (big blind) folded before Flop
Seat 2: ARfmgHcEUKh68laBZy4veA showed [Js Kh] and lost with two pair, Kings and Queens
Seat 3: G9Fo2TZCN7HI43Po4zSN3A folded before Flop (didn't bet)
Seat 4: D+W9Me7w6Hcx/WRUSKV0dw folded before Flop (didn't bet)
Seat 5: tkdBeXTJlFsZdioidNqLow folded before Flop (didn't bet)
Seat 6: 3obndzTJ6fECz8+wWhMd1w showed [Qd Ac] and won ($42.35) with three of a kind, Queens
Seat 7: 2uQqi2bcuMs+2q7ej+tN+Q folded before Flop (didn't bet)
Seat 8: 997ViqAtWn1FPjJqcffwcA (button) folded before Flop (didn't bet)
Seat 9: 6XkTu4ahxzHnvjjc1R8YjQ (small blind) folded before Flop



PokerStars Game #59941115606:  Hold'em No Limit ($0.50/$1.00) - 2009/07/01 1:26:05 ET
Table 'fZjVbKj9D8yOB+Rj7NaP/A' 9-max Seat #2 is the button
Seat 1: 9BZCcac3+McErkkSN2YScA ($102.25 in chips)
Seat 2: PTAFYDIUSsG+SArbxNl+Aw ($104 in chips)
Seat 3: yAbu2QsRPVcjPbqlf/jDxw ($101.50 in chips)
Seat 4: 997ViqAtWn1FPjJqcffwcA ($101 in chips)
Seat 5: PkGfq5xrSlNsujKaG/HF4Q ($100 in chips)
Seat 6: OvwYHV65yUbgdBjSmo1+5g ($36.95 in chips)
Seat 7: SyS20PAm3RpT6uLBsGkwOA ($121.55 in chips)
Seat 8: zDOE5r14tWqCf6xhuSHK6g ($52.90 in chips)
Seat 9: qheQay5YvP2DMAb3OUSxtw ($99 in chips)
yAbu2QsRPVcjPbqlf/jDxw: posts small blind $0.50
997ViqAtWn1FPjJqcffwcA: posts big blind $1
*** HOLE CARDS ***
PkGfq5xrSlNsujKaG/HF4Q: folds
OvwYHV65yUbgdBjSmo1+5g: folds
SyS20PAm3RpT6uLBsGkwOA: folds
zDOE5r14tWqCf6xhuSHK6g: folds
qheQay5YvP2DMAb3OUSxtw: folds
9BZCcac3+McErkkSN2YScA has timed out
9BZCcac3+McErkkSN2YScA: folds
9BZCcac3+McErkkSN2YScA is sitting out
9BZCcac3+McErkkSN2YScA has returned
PTAFYDIUSsG+SArbxNl+Aw: raises $2 to $3
yAbu2QsRPVcjPbqlf/jDxw: folds
997ViqAtWn1FPjJqcffwcA: folds
PTAFYDIUSsG+SArbxNl+Aw collected $2.50 from pot
PTAFYDIUSsG+SArbxNl+Aw: doesn't show hand
*** SUMMARY ***
Total pot $2.50 | Rake $0
Seat 1: 9BZCcac3+McErkkSN2YScA folded before Flop (didn't bet)
Seat 2: PTAFYDIUSsG+SArbxNl+Aw (button) collected ($2.50)
Seat 3: yAbu2QsRPVcjPbqlf/jDxw (small blind) folded before Flop
Seat 4: 997ViqAtWn1FPjJqcffwcA (big blind) folded before Flop
Seat 5: PkGfq5xrSlNsujKaG/HF4Q folded before Flop (didn't bet)
Seat 6: OvwYHV65yUbgdBjSmo1+5g folded before Flop (didn't bet)
Seat 7: SyS20PAm3RpT6uLBsGkwOA folded before Flop (didn't bet)
Seat 8: zDOE5r14tWqCf6xhuSHK6g folded before Flop (didn't bet)
Seat 9: qheQay5YvP2DMAb3OUSxtw folded before Flop (didn't bet)



PokerStars Game #59941116020:  Hold'em No Limit ($0.50/$1.00) - 2009/07/01 1:26:06 ET
Table 'jDQgUn1zGkyftPnHo0Awdw' 2-max Seat #2 is the button
Seat 1: a42+e5QB6s1kkG5FoSTZJw ($103.45 in chips)
Seat 2: q+vRKwm51mnr6kxX/161WQ ($92.90 in chips)
q+vRKwm51mnr6kxX/161WQ: posts small blind $0.50
a42+e5QB6s1kkG5FoSTZJw: posts big blind $1
*** HOLE CARDS ***
q+vRKwm51mnr6kxX/161WQ: raises $2 to $3
a42+e5QB6s1kkG5FoSTZJw: folds
q+vRKwm51mnr6kxX/161WQ collected $2 from pot
q+vRKwm51mnr6kxX/161WQ: doesn't show hand
*** SUMMARY ***
Total pot $2 | Rake $0
Seat 1: a42+e5QB6s1kkG5FoSTZJw (big blind) folded before Flop
Seat 2: q+vRKwm51mnr6kxX/161WQ (button) (small blind) collected ($2)



PokerStars Game #59941116974:  Hold'em No Limit ($0.50/$1.00) - 2009/07/01 1:26:08 ET
Table 'mmbQQVBTrPdE+wy+s+9VPA' 6-max Seat #3 is the button
Seat 1: zyP4SPoWZnKUfTvIRLCVog ($79.35 in chips)
Seat 2: XK4Qsl+DA8gAJyg85/zBIw ($29.80 in chips)
Seat 3: wx3sQGkVi2x9wJXuWNHPBw ($127.35 in chips)
Seat 4: V3iZdcw61nXF3g5hD2RrsQ ($100 in chips)
Seat 5: YMJG+F++3Aj6P8dAWda5fw ($117.90 in chips)
Seat 6: U2CWBTv29qdCbj8RNF2sIw ($114.75 in chips)
V3iZdcw61nXF3g5hD2RrsQ: posts small blind $0.50
YMJG+F++3Aj6P8dAWda5fw: posts big blind $1
*** HOLE CARDS ***
U2CWBTv29qdCbj8RNF2sIw: folds
zyP4SPoWZnKUfTvIRLCVog: calls $1
XK4Qsl+DA8gAJyg85/zBIw: calls $1
wx3sQGkVi2x9wJXuWNHPBw: calls $1
V3iZdcw61nXF3g5hD2RrsQ: folds
YMJG+F++3Aj6P8dAWda5fw: checks
*** FLOP *** [Ks 3d Qd]
YMJG+F++3Aj6P8dAWda5fw: checks
zyP4SPoWZnKUfTvIRLCVog: checks
XK4Qsl+DA8gAJyg85/zBIw: bets $2
wx3sQGkVi2x9wJXuWNHPBw: folds
YMJG+F++3Aj6P8dAWda5fw: folds
zyP4SPoWZnKUfTvIRLCVog: folds
XK4Qsl+DA8gAJyg85/zBIw collected $4.30 from pot
*** SUMMARY ***
Total pot $4.50 | Rake $0.20
Board [Ks 3d Qd]
Seat 1: zyP4SPoWZnKUfTvIRLCVog folded on the Flop
Seat 2: XK4Qsl+DA8gAJyg85/zBIw collected ($4.30)
Seat 3: wx3sQGkVi2x9wJXuWNHPBw (button) folded on the Flop
Seat 4: V3iZdcw61nXF3g5hD2RrsQ (small blind) folded before Flop
Seat 5: YMJG+F++3Aj6P8dAWda5fw (big blind) folded on the Flop
Seat 6: U2CWBTv29qdCbj8RNF2sIw folded before Flop (didn't bet)



PokerStars Game #59941118056:  Hold'em No Limit ($0.50/$1.00) - 2009/07/01 1:26:09 ET
Table '/RZcOwpZpHQ+OwPwjsbnRw' 6-max Seat #3 is the button
Seat 1: +uSzP8Jwnw7sKfQ4s66b7w ($45.25 in chips)
Seat 2: Z2fXsGcjl+Eax+RzOgwOmg ($107.15 in chips)
Seat 3: 6hLdALbOlkzGIrc53QKtPw ($21.20 in chips)
Seat 4: j7NIOHLZk7V2o9fOioO5ug ($102 in chips)
Seat 5: wx3sQGkVi2x9wJXuWNHPBw ($166.05 in chips)
Seat 6: o3YLm/rSY916m/on1VjXPA ($200.50 in chips)
j7NIOHLZk7V2o9fOioO5ug: posts small blind $0.50
wx3sQGkVi2x9wJXuWNHPBw: posts big blind $1
*** HOLE CARDS ***
o3YLm/rSY916m/on1VjXPA: folds
+uSzP8Jwnw7sKfQ4s66b7w: folds
Z2fXsGcjl+Eax+RzOgwOmg: folds
6hLdALbOlkzGIrc53QKtPw: raises $1.50 to $2.50
j7NIOHLZk7V2o9fOioO5ug: folds
wx3sQGkVi2x9wJXuWNHPBw: folds
6hLdALbOlkzGIrc53QKtPw collected $2.50 from pot
6hLdALbOlkzGIrc53QKtPw: doesn't show hand
*** SUMMARY ***
Total pot $2.50 | Rake $0
Seat 1: +uSzP8Jwnw7sKfQ4s66b7w folded before Flop (didn't bet)
Seat 2: Z2fXsGcjl+Eax+RzOgwOmg folded before Flop (didn't bet)
Seat 3: 6hLdALbOlkzGIrc53QKtPw (button) collected ($2.50)
Seat 4: j7NIOHLZk7V2o9fOioO5ug (small blind) folded before Flop
Seat 5: wx3sQGkVi2x9wJXuWNHPBw (big blind) folded before Flop
Seat 6: o3YLm/rSY916m/on1VjXPA folded before Flop (didn't bet)



PokerStars Game #59941117596:  Hold'em No Limit ($0.50/$1.00) - 2009/07/01 1:26:09 ET
Table 'O96CPOtvMBWP6kzuYDfdFA' 6-max Seat #6 is the button
Seat 1: 6alLXQIITA2EZ/lBeym8Dw ($123.25 in chips)
Seat 2: 4d1rWhpu8DzLmzMbR3QKyA ($116.10 in chips)
Seat 3: V89DGjxE171oPREEbAXiyg ($91.65 in chips)
Seat 4: /P4w1pHg2zHYg/4ubJ0dPw ($63.65 in chips)
Seat 5: G5ZSSN6RSON3gkNvk/SmYg ($100 in chips)
Seat 6: GYei5jXGWexiJYbAT2fELg ($29.45 in chips)
6alLXQIITA2EZ/lBeym8Dw: posts small blind $0.50
4d1rWhpu8DzLmzMbR3QKyA: posts big blind $1
*** HOLE CARDS ***
V89DGjxE171oPREEbAXiyg: folds
/P4w1pHg2zHYg/4ubJ0dPw: folds
G5ZSSN6RSON3gkNvk/SmYg: raises $2 to $3
GYei5jXGWexiJYbAT2fELg: calls $3
6alLXQIITA2EZ/lBeym8Dw: folds
4d1rWhpu8DzLmzMbR3QKyA: folds
*** FLOP *** [Kh 7h Qs]
G5ZSSN6RSON3gkNvk/SmYg: checks
GYei5jXGWexiJYbAT2fELg: checks
*** TURN *** [Kh 7h Qs] [9h]
G5ZSSN6RSON3gkNvk/SmYg: checks
GYei5jXGWexiJYbAT2fELg: checks
*** RIVER *** [Kh 7h Qs 9h] [6c]
G5ZSSN6RSON3gkNvk/SmYg: checks
GYei5jXGWexiJYbAT2fELg: checks
*** SHOW DOWN ***
G5ZSSN6RSON3gkNvk/SmYg: shows [Jc Jd] (a pair of Jacks)
GYei5jXGWexiJYbAT2fELg: mucks hand
G5ZSSN6RSON3gkNvk/SmYg collected $7.15 from pot
*** SUMMARY ***
Total pot $7.50 | Rake $0.35
Board [Kh 7h Qs 9h 6c]
Seat 1: 6alLXQIITA2EZ/lBeym8Dw (small blind) folded before Flop
Seat 2: 4d1rWhpu8DzLmzMbR3QKyA (big blind) folded before Flop
Seat 3: V89DGjxE171oPREEbAXiyg folded before Flop (didn't bet)
Seat 4: /P4w1pHg2zHYg/4ubJ0dPw folded before Flop (didn't bet)
Seat 5: G5ZSSN6RSON3gkNvk/SmYg showed [Jc Jd] and won ($7.15) with a pair of Jacks
Seat 6: GYei5jXGWexiJYbAT2fELg (button) mucked



PokerStars Game #59941118606:  Hold'em No Limit ($0.50/$1.00) - 2009/07/01 1:26:10 ET
Table '305hiksPPCCdC6V2LNsO5w' 6-max Seat #4 is the button
Seat 1: RTuDLJHh/9zPfBftoc9vsw ($12.50 in chips)
Seat 2: j7NIOHLZk7V2o9fOioO5ug ($126.35 in chips)
Seat 3: +zIVjZKLpcidfRHgVZW8lA ($35.20 in chips)
Seat 4: uJVSceLggtsrJya+WtmUEA ($214.55 in chips)
Seat 5: +Nt3OPk3XR9SKjZgm2CexQ ($113.15 in chips)
Seat 6: 9/Tq8dw7kWW68uN8bFupXg ($16.40 in chips)
+Nt3OPk3XR9SKjZgm2CexQ: posts small blind $0.50
9/Tq8dw7kWW68uN8bFupXg: posts big blind $1
*** HOLE CARDS ***
RTuDLJHh/9zPfBftoc9vsw: folds
j7NIOHLZk7V2o9fOioO5ug: raises $2 to $3
+zIVjZKLpcidfRHgVZW8lA: folds
uJVSceLggtsrJya+WtmUEA: folds
+Nt3OPk3XR9SKjZgm2CexQ: folds
9/Tq8dw7kWW68uN8bFupXg: folds
j7NIOHLZk7V2o9fOioO5ug collected $2.50 from pot
*** SUMMARY ***
Total pot $2.50 | Rake $0
Seat 1: RTuDLJHh/9zPfBftoc9vsw folded before Flop (didn't bet)
Seat 2: j7NIOHLZk7V2o9fOioO5ug collected ($2.50)
Seat 3: +zIVjZKLpcidfRHgVZW8lA folded before Flop (didn't bet)
Seat 4: uJVSceLggtsrJya+WtmUEA (button) folded before Flop (didn't bet)
Seat 5: +Nt3OPk3XR9SKjZgm2CexQ (small blind) folded before Flop
Seat 6: 9/Tq8dw7kWW68uN8bFupXg (big blind) folded before Flop



PokerStars Game #59941118806:  Hold'em No Limit ($0.50/$1.00) - 2009/07/01 1:26:11 ET
Table 'QSIig7BLMc9wY/rgBechzw' 6-max Seat #6 is the button
Seat 1: Z2fXsGcjl+Eax+RzOgwOmg ($111.10 in chips)
Seat 2: mLOIkH/qmRa+mVujQIhBRg ($47.90 in chips)
Seat 3: +xW7QemQU0Fxs+4TnqBRow ($111.50 in chips)
Seat 4: +uSzP8Jwnw7sKfQ4s66b7w ($62.15 in chips)
Seat 5: lsLuWlcPA3Rh7kJVLzMh0Q ($100 in chips)
Seat 6: PxqfkAMdAWtkgbT+q2gciA ($48.50 in chips)
Z2fXsGcjl+Eax+RzOgwOmg: posts small blind $0.50
mLOIkH/qmRa+mVujQIhBRg: posts big blind $1
*** HOLE CARDS ***
+xW7QemQU0Fxs+4TnqBRow: folds
+uSzP8Jwnw7sKfQ4s66b7w: folds
lsLuWlcPA3Rh7kJVLzMh0Q: folds
PxqfkAMdAWtkgbT+q2gciA: calls $1
Z2fXsGcjl+Eax+RzOgwOmg: folds
mLOIkH/qmRa+mVujQIhBRg: raises $3 to $4
PxqfkAMdAWtkgbT+q2gciA: folds
mLOIkH/qmRa+mVujQIhBRg collected $2.50 from pot
*** SUMMARY ***
Total pot $2.50 | Rake $0
Seat 1: Z2fXsGcjl+Eax+RzOgwOmg (small blind) folded before Flop
Seat 2: mLOIkH/qmRa+mVujQIhBRg (big blind) collected ($2.50)
Seat 3: +xW7QemQU0Fxs+4TnqBRow folded before Flop (didn't bet)
Seat 4: +uSzP8Jwnw7sKfQ4s66b7w folded before Flop (didn't bet)
Seat 5: lsLuWlcPA3Rh7kJVLzMh0Q folded before Flop (didn't bet)
Seat 6: PxqfkAMdAWtkgbT+q2gciA (button) folded before Flop



PokerStars Game #59941120666:  Hold'em No Limit ($0.50/$1.00) - 2009/07/01 1:26:14 ET
Table 'jDQgUn1zGkyftPnHo0Awdw' 2-max Seat #1 is the button
Seat 1: a42+e5QB6s1kkG5FoSTZJw ($102.45 in chips)
Seat 2: q+vRKwm51mnr6kxX/161WQ ($93.90 in chips)
a42+e5QB6s1kkG5FoSTZJw: posts small blind $0.50
q+vRKwm51mnr6kxX/161WQ: posts big blind $1
*** HOLE CARDS ***
a42+e5QB6s1kkG5FoSTZJw: raises $1 to $2
q+vRKwm51mnr6kxX/161WQ: folds
a42+e5QB6s1kkG5FoSTZJw collected $2 from pot
a42+e5QB6s1kkG5FoSTZJw: doesn't show hand
*** SUMMARY ***
Total pot $2 | Rake $0
Seat 1: a42+e5QB6s1kkG5FoSTZJw (button) (small blind) collected ($2)
Seat 2: q+vRKwm51mnr6kxX/161WQ (big blind) folded before Flop



PokerStars Game #59941121262:  Hold'em No Limit ($0.50/$1.00) - 2009/07/01 1:26:15 ET
Table 'TvsifD4n+q//fIZ4fM1xxQ' 2-max Seat #1 is the button
Seat 1: NYi6JFscYNrofSXy4sM+Yw ($180.05 in chips)
Seat 2: +W/hy0gBp0sJy8pjLz6Yrg ($91.90 in chips)
NYi6JFscYNrofSXy4sM+Yw: posts small blind $0.50
+W/hy0gBp0sJy8pjLz6Yrg: posts big blind $1
*** HOLE CARDS ***
NYi6JFscYNrofSXy4sM+Yw: raises $2 to $3
+W/hy0gBp0sJy8pjLz6Yrg: folds
NYi6JFscYNrofSXy4sM+Yw collected $2 from pot
*** SUMMARY ***
Total pot $2 | Rake $0
Seat 1: NYi6JFscYNrofSXy4sM+Yw (button) (small blind) collected ($2)
Seat 2: +W/hy0gBp0sJy8pjLz6Yrg (big blind) folded before Flop



PokerStars Game #59941121798:  Hold'em No Limit ($0.50/$1.00) - 2009/07/01 1:26:16 ET
Table 'MNvFfRVQNka/oY+Z5aMbZQ' 2-max Seat #2 is the button
Seat 1: DaZnoWHjO897dnh0CL2lVg ($72.60 in chips)
Seat 2: mgi+mjKb1Sc3CCs7TlfoCw ($88.35 in chips)
mgi+mjKb1Sc3CCs7TlfoCw: posts small blind $0.50
DaZnoWHjO897dnh0CL2lVg: posts big blind $1
*** HOLE CARDS ***
mgi+mjKb1Sc3CCs7TlfoCw: raises $2 to $3
DaZnoWHjO897dnh0CL2lVg: calls $2
*** FLOP *** [2d 3s 7c]
DaZnoWHjO897dnh0CL2lVg: checks
mgi+mjKb1Sc3CCs7TlfoCw: bets $7
DaZnoWHjO897dnh0CL2lVg: folds
mgi+mjKb1Sc3CCs7TlfoCw collected $5.70 from pot
mgi+mjKb1Sc3CCs7TlfoCw: doesn't show hand
*** SUMMARY ***
Total pot $6 | Rake $0.30
Board [2d 3s 7c]
Seat 1: DaZnoWHjO897dnh0CL2lVg (big blind) folded on the Flop
Seat 2: mgi+mjKb1Sc3CCs7TlfoCw (button) (small blind) collected ($5.70)



PokerStars Game #59941125030:  Hold'em No Limit ($0.50/$1.00) - 2009/07/01 1:26:21 ET
Table '7Nl0ffnjeK44/vmeexh3MQ' 9-max Seat #2 is the button
Seat 1: V138SURkdX8LdVBPKdJJag ($100 in chips)
Seat 2: OGgaARGdJQT4awWVNQ957w ($100.50 in chips)
Seat 3: JMmUYT5pIKCKh2pGjCB/4w ($59.40 in chips)
Seat 4: bLbSOSmSOnqE0iTcH/5dxA ($111.80 in chips)
Seat 6: FVs16t7GgfWgQWt4JxsObQ ($18.05 in chips)
Seat 7: 997ViqAtWn1FPjJqcffwcA ($100 in chips)
Seat 8: D+W9Me7w6Hcx/WRUSKV0dw ($20 in chips)
JMmUYT5pIKCKh2pGjCB/4w: posts small blind $0.50
bLbSOSmSOnqE0iTcH/5dxA: posts big blind $1
Mozuss: sits out
*** HOLE CARDS ***
FVs16t7GgfWgQWt4JxsObQ: folds
997ViqAtWn1FPjJqcffwcA: folds
D+W9Me7w6Hcx/WRUSKV0dw: folds
V138SURkdX8LdVBPKdJJag: raises $2.50 to $3.50
61sfw5QTu62YYIt68OsdrA is connected
OGgaARGdJQT4awWVNQ957w: folds
JMmUYT5pIKCKh2pGjCB/4w: folds
bLbSOSmSOnqE0iTcH/5dxA: folds
61sfw5QTu62YYIt68OsdrA has returned
V138SURkdX8LdVBPKdJJag collected $2.50 from pot
V138SURkdX8LdVBPKdJJag: doesn't show hand
*** SUMMARY ***
Total pot $2.50 | Rake $0
Seat 1: V138SURkdX8LdVBPKdJJag collected ($2.50)
Seat 2: OGgaARGdJQT4awWVNQ957w (button) folded before Flop (didn't bet)
Seat 3: JMmUYT5pIKCKh2pGjCB/4w (small blind) folded before Flop
Seat 4: bLbSOSmSOnqE0iTcH/5dxA (big blind) folded before Flop
Seat 6: FVs16t7GgfWgQWt4JxsObQ folded before Flop (didn't bet)
Seat 7: 997ViqAtWn1FPjJqcffwcA folded before Flop (didn't bet)
Seat 8: D+W9Me7w6Hcx/WRUSKV0dw folded before Flop (didn't bet)



PokerStars Game #59941125282:  Hold'em No Limit ($0.50/$1.00) - 2009/07/01 1:26:22 ET
Table 'jDQgUn1zGkyftPnHo0Awdw' 2-max Seat #2 is the button
Seat 1: a42+e5QB6s1kkG5FoSTZJw ($103.45 in chips)
Seat 2: q+vRKwm51mnr6kxX/161WQ ($92.90 in chips)
q+vRKwm51mnr6kxX/161WQ: posts small blind $0.50
a42+e5QB6s1kkG5FoSTZJw: posts big blind $1
*** HOLE CARDS ***
q+vRKwm51mnr6kxX/161WQ: raises $2 to $3
a42+e5QB6s1kkG5FoSTZJw: folds
q+vRKwm51mnr6kxX/161WQ collected $2 from pot
q+vRKwm51mnr6kxX/161WQ: doesn't show hand
*** SUMMARY ***
Total pot $2 | Rake $0
Seat 1: a42+e5QB6s1kkG5FoSTZJw (big blind) folded before Flop
Seat 2: q+vRKwm51mnr6kxX/161WQ (button) (small blind) collected ($2)



PokerStars Game #59941125852:  Hold'em No Limit ($0.50/$1.00) - 2009/07/01 1:26:23 ET
Table 'TvsifD4n+q//fIZ4fM1xxQ' 2-max Seat #2 is the button
Seat 1: NYi6JFscYNrofSXy4sM+Yw ($181.05 in chips)
Seat 2: +W/hy0gBp0sJy8pjLz6Yrg ($90.90 in chips)
+W/hy0gBp0sJy8pjLz6Yrg: posts small blind $0.50
NYi6JFscYNrofSXy4sM+Yw: posts big blind $1
*** HOLE CARDS ***
+W/hy0gBp0sJy8pjLz6Yrg: raises $2 to $3
NYi6JFscYNrofSXy4sM+Yw: folds
+W/hy0gBp0sJy8pjLz6Yrg collected $2 from pot
*** SUMMARY ***
Total pot $2 | Rake $0
Seat 1: NYi6JFscYNrofSXy4sM+Yw (big blind) folded before Flop
Seat 2: +W/hy0gBp0sJy8pjLz6Yrg (button) (small blind) collected ($2)



PokerStars Game #59941127778:  Hold'em No Limit ($0.50/$1.00) - 2009/07/01 1:26:26 ET
Table 'Evb7VW0qfDhFkbgBL3gcqQ' 2-max Seat #1 is the button
Seat 1: NYi6JFscYNrofSXy4sM+Yw ($148.15 in chips)
Seat 2: AoEQlM/FNYM0d7Txn1TfBQ ($56.75 in chips)
NYi6JFscYNrofSXy4sM+Yw: posts small blind $0.50
AoEQlM/FNYM0d7Txn1TfBQ: posts big blind $1
*** HOLE CARDS ***
NYi6JFscYNrofSXy4sM+Yw: raises $2 to $3
AoEQlM/FNYM0d7Txn1TfBQ: calls $2
*** FLOP *** [Tc 4c 3c]
AoEQlM/FNYM0d7Txn1TfBQ: checks
NYi6JFscYNrofSXy4sM+Yw: bets $4.50
AoEQlM/FNYM0d7Txn1TfBQ: calls $4.50
*** TURN *** [Tc 4c 3c] [8s]
AoEQlM/FNYM0d7Txn1TfBQ: checks
NYi6JFscYNrofSXy4sM+Yw: bets $10
AoEQlM/FNYM0d7Txn1TfBQ: folds
NYi6JFscYNrofSXy4sM+Yw collected $14.50 from pot
*** SUMMARY ***
Total pot $15 | Rake $0.50
Board [Tc 4c 3c 8s]
Seat 1: NYi6JFscYNrofSXy4sM+Yw (button) (small blind) collected ($14.50)
Seat 2: AoEQlM/FNYM0d7Txn1TfBQ (big blind) folded on the Turn



PokerStars Game #59941129236:  Hold'em No Limit ($0.50/$1.00) - 2009/07/01 1:26:29 ET
Table 'N6LvHFrb+cdXY/COI6ByOw' 2-max Seat #2 is the button
Seat 1: lXX4W7m3u++JiSOZ46yVMQ ($110 in chips)
Seat 2: 9mAoSP3o/mikSZOW2LEEAw ($89.50 in chips)
9mAoSP3o/mikSZOW2LEEAw: posts small blind $0.50
lXX4W7m3u++JiSOZ46yVMQ: posts big blind $1
*** HOLE CARDS ***
9mAoSP3o/mikSZOW2LEEAw: calls $0.50
lXX4W7m3u++JiSOZ46yVMQ: checks
*** FLOP *** [Qs 2h As]
lXX4W7m3u++JiSOZ46yVMQ: checks
9mAoSP3o/mikSZOW2LEEAw: checks
*** TURN *** [Qs 2h As] [Qd]
lXX4W7m3u++JiSOZ46yVMQ: checks
9mAoSP3o/mikSZOW2LEEAw: checks
*** RIVER *** [Qs 2h As Qd] [4c]
lXX4W7m3u++JiSOZ46yVMQ: checks
9mAoSP3o/mikSZOW2LEEAw: checks
*** SHOW DOWN ***
lXX4W7m3u++JiSOZ46yVMQ: shows [Js 9c] (a pair of Queens)
9mAoSP3o/mikSZOW2LEEAw: shows [6h 9h] (a pair of Queens - lower kicker)
lXX4W7m3u++JiSOZ46yVMQ collected $1.90 from pot
*** SUMMARY ***
Total pot $2 | Rake $0.10
Board [Qs 2h As Qd 4c]
Seat 1: lXX4W7m3u++JiSOZ46yVMQ (big blind) showed [Js 9c] and won ($1.90) with a pair of Queens
Seat 2: 9mAoSP3o/mikSZOW2LEEAw (button) (small blind) showed [6h 9h] and lost with a pair of Queens



PokerStars Game #59941130156:  Hold'em No Limit ($0.50/$1.00) - 2009/07/01 1:26:30 ET
Table 'TvsifD4n+q//fIZ4fM1xxQ' 2-max Seat #1 is the button
Seat 1: NYi6JFscYNrofSXy4sM+Yw ($180.05 in chips)
Seat 2: +W/hy0gBp0sJy8pjLz6Yrg ($91.90 in chips)
NYi6JFscYNrofSXy4sM+Yw: posts small blind $0.50
+W/hy0gBp0sJy8pjLz6Yrg: posts big blind $1
*** HOLE CARDS ***
NYi6JFscYNrofSXy4sM+Yw: raises $2 to $3
+W/hy0gBp0sJy8pjLz6Yrg: raises $8 to $11
NYi6JFscYNrofSXy4sM+Yw: calls $8
*** FLOP *** [4c 9s 5s]
+W/hy0gBp0sJy8pjLz6Yrg: bets $80.90 and is all-in
NYi6JFscYNrofSXy4sM+Yw: folds
+W/hy0gBp0sJy8pjLz6Yrg collected $21.50 from pot
*** SUMMARY ***
Total pot $22 | Rake $0.50
Board [4c 9s 5s]
Seat 1: NYi6JFscYNrofSXy4sM+Yw (button) (small blind) folded on the Flop
Seat 2: +W/hy0gBp0sJy8pjLz6Yrg (big blind) collected ($21.50)



PokerStars Game #59941129874:  Hold'em No Limit ($0.50/$1.00) - 2009/07/01 1:26:30 ET
Table 'jDQgUn1zGkyftPnHo0Awdw' 2-max Seat #1 is the button
Seat 1: a42+e5QB6s1kkG5FoSTZJw ($102.45 in chips)
Seat 2: q+vRKwm51mnr6kxX/161WQ ($93.90 in chips)
a42+e5QB6s1kkG5FoSTZJw: posts small blind $0.50
q+vRKwm51mnr6kxX/161WQ: posts big blind $1
*** HOLE CARDS ***
a42+e5QB6s1kkG5FoSTZJw: raises $2 to $3
q+vRKwm51mnr6kxX/161WQ: calls $2
*** FLOP *** [2d Th 6c]
q+vRKwm51mnr6kxX/161WQ: checks
a42+e5QB6s1kkG5FoSTZJw: bets $4
q+vRKwm51mnr6kxX/161WQ: folds
a42+e5QB6s1kkG5FoSTZJw collected $5.70 from pot
a42+e5QB6s1kkG5FoSTZJw: doesn't show hand
*** SUMMARY ***
Total pot $6 | Rake $0.30
Board [2d Th 6c]
Seat 1: a42+e5QB6s1kkG5FoSTZJw (button) (small blind) collected ($5.70)
Seat 2: q+vRKwm51mnr6kxX/161WQ (big blind) folded on the Flop



PokerStars Game #59941130578:  Hold'em No Limit ($0.50/$1.00) - 2009/07/01 1:26:31 ET
Table '/FUb199IViHMJHi5YWmeuQ' 9-max Seat #3 is the button
Seat 1: 3obndzTJ6fECz8+wWhMd1w ($18.50 in chips)
Seat 2: FL3MrLspcF23LYvC4ipBOA ($185.55 in chips)
Seat 3: V138SURkdX8LdVBPKdJJag ($131.75 in chips)
Seat 4: pbAfmxe4uSZPxJQX7gOzZA ($66.35 in chips)
Seat 5: H+DVy3Ei8L1UKS2tVOtJcw ($138.85 in chips)
Seat 8: 997ViqAtWn1FPjJqcffwcA ($100 in chips)
Seat 9: RfLbneGRY8yQUpMgDnJCxA ($70.85 in chips)
pbAfmxe4uSZPxJQX7gOzZA: posts small blind $0.50
H+DVy3Ei8L1UKS2tVOtJcw: posts big blind $1
VPF+HjszMvUIpy0CHIwH3A: sits out
myIxN7otsyr846M539YR8Q: sits out
*** HOLE CARDS ***
997ViqAtWn1FPjJqcffwcA: folds
RfLbneGRY8yQUpMgDnJCxA: folds
3obndzTJ6fECz8+wWhMd1w: folds
FL3MrLspcF23LYvC4ipBOA: folds
V138SURkdX8LdVBPKdJJag: raises $2.50 to $3.50
pbAfmxe4uSZPxJQX7gOzZA: calls $3
H+DVy3Ei8L1UKS2tVOtJcw: folds
*** FLOP *** [5h 6d 8d]
pbAfmxe4uSZPxJQX7gOzZA: checks
V138SURkdX8LdVBPKdJJag: bets $3
pbAfmxe4uSZPxJQX7gOzZA: calls $3
*** TURN *** [5h 6d 8d] [Ad]
pbAfmxe4uSZPxJQX7gOzZA: checks
V138SURkdX8LdVBPKdJJag: checks
*** RIVER *** [5h 6d 8d Ad] [Qh]
pbAfmxe4uSZPxJQX7gOzZA: bets $3
V138SURkdX8LdVBPKdJJag: folds
pbAfmxe4uSZPxJQX7gOzZA collected $13.35 from pot
*** SUMMARY ***
Total pot $14 | Rake $0.65
Board [5h 6d 8d Ad Qh]
Seat 1: 3obndzTJ6fECz8+wWhMd1w folded before Flop (didn't bet)
Seat 2: FL3MrLspcF23LYvC4ipBOA folded before Flop (didn't bet)
Seat 3: V138SURkdX8LdVBPKdJJag (button) folded on the River
Seat 4: pbAfmxe4uSZPxJQX7gOzZA (small blind) collected ($13.35)
Seat 5: H+DVy3Ei8L1UKS2tVOtJcw (big blind) folded before Flop
Seat 8: 997ViqAtWn1FPjJqcffwcA folded before Flop (didn't bet)
Seat 9: RfLbneGRY8yQUpMgDnJCxA folded before Flop (didn't bet)



PokerStars Game #59941131984:  Hold'em No Limit ($0.50/$1.00) - 2009/07/01 1:26:33 ET
Table 'gxFK0BVUD7cupu2uyRUZJg' 6-max Seat #2 is the button
Seat 1: M+X3uChmP6R63IwijVjgTg ($161.25 in chips)
Seat 2: hpxXcmRkXXI9HE5+5/j/0Q ($136.05 in chips)
Seat 3: Z2fXsGcjl+Eax+RzOgwOmg ($119.50 in chips)
Seat 5: WgIrs6CBinyyw18pqdDtWA ($21.20 in chips)
Seat 6: dYyb6/42PMC8aNFlm/eBeQ ($104.50 in chips)
Z2fXsGcjl+Eax+RzOgwOmg: posts small blind $0.50
WgIrs6CBinyyw18pqdDtWA: posts big blind $1
M+X3uChmP6R63IwijVjgTg: posts small & big blinds $1.50
*** HOLE CARDS ***
dYyb6/42PMC8aNFlm/eBeQ: folds
M+X3uChmP6R63IwijVjgTg: raises $4 to $5
hpxXcmRkXXI9HE5+5/j/0Q: folds
Z2fXsGcjl+Eax+RzOgwOmg: folds
WgIrs6CBinyyw18pqdDtWA: folds
M+X3uChmP6R63IwijVjgTg collected $3 from pot
*** SUMMARY ***
Total pot $3 | Rake $0
Seat 1: M+X3uChmP6R63IwijVjgTg collected ($3)
Seat 2: hpxXcmRkXXI9HE5+5/j/0Q (button) folded before Flop (didn't bet)
Seat 3: Z2fXsGcjl+Eax+RzOgwOmg (small blind) folded before Flop
Seat 5: WgIrs6CBinyyw18pqdDtWA (big blind) folded before Flop
Seat 6: dYyb6/42PMC8aNFlm/eBeQ folded before Flop (didn't bet)



PokerStars Game #59941131884:  Hold'em No Limit ($0.50/$1.00) - 2009/07/01 1:26:33 ET
Table 'GPp0HyAuggN8oE0sUWzPpA' 9-max Seat #8 is the button
Seat 2: m3U8I35Pn3gxKhoS2nmYIg ($28.25 in chips)
Seat 3: CCCXsirC+bO7ginAuUUVlQ ($53.10 in chips)
Seat 4: mBRWbnUl8diyBO1qTJaNzw ($100.15 in chips)
Seat 5: bLbSOSmSOnqE0iTcH/5dxA ($100 in chips)
Seat 6: BK/GtNPkSx0TdUDj82id5A ($37.40 in chips)
Seat 7: DHdbHyysD15wCAtx+BhUjA ($93.20 in chips)
Seat 8: P/6qLjycEfxRgZ5F/W90dw ($97.35 in chips)
Seat 9: myIxN7otsyr846M539YR8Q ($19 in chips)
myIxN7otsyr846M539YR8Q: posts small blind $0.50
qJr25HAtvv1w/7IBvjMM3g: is sitting out
m3U8I35Pn3gxKhoS2nmYIg: posts big blind $1
*** HOLE CARDS ***
CCCXsirC+bO7ginAuUUVlQ: folds
mBRWbnUl8diyBO1qTJaNzw: folds
bLbSOSmSOnqE0iTcH/5dxA: folds
BK/GtNPkSx0TdUDj82id5A: folds
qJr25HAtvv1w/7IBvjMM3g leaves the table
DHdbHyysD15wCAtx+BhUjA: folds
P/6qLjycEfxRgZ5F/W90dw: folds
myIxN7otsyr846M539YR8Q: raises $18 to $19 and is all-in
m3U8I35Pn3gxKhoS2nmYIg: folds
myIxN7otsyr846M539YR8Q collected $2 from pot
*** SUMMARY ***
Total pot $2 | Rake $0
Seat 2: m3U8I35Pn3gxKhoS2nmYIg (big blind) folded before Flop
Seat 3: CCCXsirC+bO7ginAuUUVlQ folded before Flop (didn't bet)
Seat 4: mBRWbnUl8diyBO1qTJaNzw folded before Flop (didn't bet)
Seat 5: bLbSOSmSOnqE0iTcH/5dxA folded before Flop (didn't bet)
Seat 6: BK/GtNPkSx0TdUDj82id5A folded before Flop (didn't bet)
Seat 7: DHdbHyysD15wCAtx+BhUjA folded before Flop (didn't bet)
Seat 8: P/6qLjycEfxRgZ5F/W90dw (button) folded before Flop (didn't bet)
Seat 9: myIxN7otsyr846M539YR8Q (small blind) collected ($2)



PokerStars Game #59941133104:  Hold'em No Limit ($0.50/$1.00) - 2009/07/01 1:26:35 ET
Table 'W/wyObTiXZm+Ckkl3YxcSw' 6-max Seat #4 is the button
Seat 1: eUBBn2R56C1IQ6Cs/vitwg ($293.55 in chips)
Seat 2: oDiBRCaF0QVtd3kO6xZIXw ($152.05 in chips)
Seat 3: dxyNCn/qxfkGDUIf28Cbng ($63.80 in chips)
Seat 4: UBZQqpnJZdTYYY1FTb0rLA ($100 in chips)
Seat 5: +OrCjyw70oZhJiD22Mn+bg ($100 in chips)
Seat 6: b2a+5TkFf4xJN/Ihhma58Q ($48.95 in chips)
+OrCjyw70oZhJiD22Mn+bg: posts small blind $0.50
b2a+5TkFf4xJN/Ihhma58Q: posts big blind $1
*** HOLE CARDS ***
eUBBn2R56C1IQ6Cs/vitwg: folds
oDiBRCaF0QVtd3kO6xZIXw: folds
dxyNCn/qxfkGDUIf28Cbng: folds
UBZQqpnJZdTYYY1FTb0rLA: raises $2 to $3
+OrCjyw70oZhJiD22Mn+bg: folds
b2a+5TkFf4xJN/Ihhma58Q: calls $2
*** FLOP *** [Kd 4h 5s]
b2a+5TkFf4xJN/Ihhma58Q: checks
UBZQqpnJZdTYYY1FTb0rLA: bets $4
b2a+5TkFf4xJN/Ihhma58Q: folds
UBZQqpnJZdTYYY1FTb0rLA collected $6.20 from pot
UBZQqpnJZdTYYY1FTb0rLA: doesn't show hand
*** SUMMARY ***
Total pot $6.50 | Rake $0.30
Board [Kd 4h 5s]
Seat 1: eUBBn2R56C1IQ6Cs/vitwg folded before Flop (didn't bet)
Seat 2: oDiBRCaF0QVtd3kO6xZIXw folded before Flop (didn't bet)
Seat 3: dxyNCn/qxfkGDUIf28Cbng folded before Flop (didn't bet)
Seat 4: UBZQqpnJZdTYYY1FTb0rLA (button) collected ($6.20)
Seat 5: +OrCjyw70oZhJiD22Mn+bg (small blind) folded before Flop
Seat 6: b2a+5TkFf4xJN/Ihhma58Q (big blind) folded on the Flop



PokerStars Game #59941134856:  Hold'em No Limit ($0.50/$1.00) - 2009/07/01 1:26:38 ET
Table '/RZcOwpZpHQ+OwPwjsbnRw' 6-max Seat #4 is the button
Seat 1: +uSzP8Jwnw7sKfQ4s66b7w ($45.25 in chips)
Seat 2: Z2fXsGcjl+Eax+RzOgwOmg ($107.15 in chips)
Seat 3: 6hLdALbOlkzGIrc53QKtPw ($22.70 in chips)
Seat 4: j7NIOHLZk7V2o9fOioO5ug ($101.50 in chips)
Seat 5: wx3sQGkVi2x9wJXuWNHPBw ($165.05 in chips)
Seat 6: o3YLm/rSY916m/on1VjXPA ($200.50 in chips)
wx3sQGkVi2x9wJXuWNHPBw: posts small blind $0.50
o3YLm/rSY916m/on1VjXPA: posts big blind $1
*** HOLE CARDS ***
+uSzP8Jwnw7sKfQ4s66b7w: folds
Z2fXsGcjl+Eax+RzOgwOmg: folds
6hLdALbOlkzGIrc53QKtPw: folds
j7NIOHLZk7V2o9fOioO5ug: folds
wx3sQGkVi2x9wJXuWNHPBw: folds
o3YLm/rSY916m/on1VjXPA collected $1 from pot
o3YLm/rSY916m/on1VjXPA: doesn't show hand
*** SUMMARY ***
Total pot $1 | Rake $0
Seat 1: +uSzP8Jwnw7sKfQ4s66b7w folded before Flop (didn't bet)
Seat 2: Z2fXsGcjl+Eax+RzOgwOmg folded before Flop (didn't bet)
Seat 3: 6hLdALbOlkzGIrc53QKtPw folded before Flop (didn't bet)
Seat 4: j7NIOHLZk7V2o9fOioO5ug (button) folded before Flop (didn't bet)
Seat 5: wx3sQGkVi2x9wJXuWNHPBw (small blind) folded before Flop
Seat 6: o3YLm/rSY916m/on1VjXPA (big blind) collected ($1)



