PokerStars Game #59941134676:  Hold'em No Limit ($0.50/$1.00) - 2009/07/01 1:26:38 ET
Table 'tJq9SfN1ywY0r03VBlWlwQ' 9-max Seat #5 is the button
Seat 1: wZsU+w9r7G66x93UuvBf1Q ($322.80 in chips)
Seat 4: bLbSOSmSOnqE0iTcH/5dxA ($113.65 in chips)
Seat 5: h5ipsNTMyolp7xn/NAvWkA ($127.50 in chips)
Seat 6: gUUvmqdVlmvpal6B8nYrmg ($100 in chips)
Seat 7: Pp/KTcXkfZKKUHkjyaLTdg ($35.55 in chips)
Seat 8: G4DEhsZFmznGNVpy2SEocA ($22.25 in chips)
Seat 9: XE5QF1y74bpHog9JxWJMWQ ($100 in chips)
gUUvmqdVlmvpal6B8nYrmg: posts small blind $0.50
Pp/KTcXkfZKKUHkjyaLTdg: posts big blind $1
VPF+HjszMvUIpy0CHIwH3A: sits out
*** HOLE CARDS ***
G4DEhsZFmznGNVpy2SEocA: folds
XE5QF1y74bpHog9JxWJMWQ: folds
wZsU+w9r7G66x93UuvBf1Q: folds
bLbSOSmSOnqE0iTcH/5dxA: folds
h5ipsNTMyolp7xn/NAvWkA: raises $2 to $3
gUUvmqdVlmvpal6B8nYrmg: folds
Pp/KTcXkfZKKUHkjyaLTdg: folds
h5ipsNTMyolp7xn/NAvWkA collected $2.50 from pot
*** SUMMARY ***
Total pot $2.50 | Rake $0
Seat 1: wZsU+w9r7G66x93UuvBf1Q folded before Flop (didn't bet)
Seat 4: bLbSOSmSOnqE0iTcH/5dxA folded before Flop (didn't bet)
Seat 5: h5ipsNTMyolp7xn/NAvWkA (button) collected ($2.50)
Seat 6: gUUvmqdVlmvpal6B8nYrmg (small blind) folded before Flop
Seat 7: Pp/KTcXkfZKKUHkjyaLTdg (big blind) folded before Flop
Seat 8: G4DEhsZFmznGNVpy2SEocA folded before Flop (didn't bet)
Seat 9: XE5QF1y74bpHog9JxWJMWQ folded before Flop (didn't bet)



PokerStars Game #59941135686:  Hold'em No Limit ($0.50/$1.00) - 2009/07/01 1:26:39 ET
Table 'QSIig7BLMc9wY/rgBechzw' 6-max Seat #1 is the button
Seat 1: Z2fXsGcjl+Eax+RzOgwOmg ($110.60 in chips)
Seat 2: mLOIkH/qmRa+mVujQIhBRg ($49.40 in chips)
Seat 3: +xW7QemQU0Fxs+4TnqBRow ($111.50 in chips)
Seat 4: +uSzP8Jwnw7sKfQ4s66b7w ($62.15 in chips)
Seat 5: lsLuWlcPA3Rh7kJVLzMh0Q ($100 in chips)
Seat 6: PxqfkAMdAWtkgbT+q2gciA ($47.50 in chips)
mLOIkH/qmRa+mVujQIhBRg: posts small blind $0.50
+xW7QemQU0Fxs+4TnqBRow: posts big blind $1
*** HOLE CARDS ***
+uSzP8Jwnw7sKfQ4s66b7w: folds
lsLuWlcPA3Rh7kJVLzMh0Q: folds
PxqfkAMdAWtkgbT+q2gciA: raises $1 to $2
Z2fXsGcjl+Eax+RzOgwOmg: folds
mLOIkH/qmRa+mVujQIhBRg: folds
+xW7QemQU0Fxs+4TnqBRow: folds
PxqfkAMdAWtkgbT+q2gciA collected $2.50 from pot
*** SUMMARY ***
Total pot $2.50 | Rake $0
Seat 1: Z2fXsGcjl+Eax+RzOgwOmg (button) folded before Flop (didn't bet)
Seat 2: mLOIkH/qmRa+mVujQIhBRg (small blind) folded before Flop
Seat 3: +xW7QemQU0Fxs+4TnqBRow (big blind) folded before Flop
Seat 4: +uSzP8Jwnw7sKfQ4s66b7w folded before Flop (didn't bet)
Seat 5: lsLuWlcPA3Rh7kJVLzMh0Q folded before Flop (didn't bet)
Seat 6: PxqfkAMdAWtkgbT+q2gciA collected ($2.50)



PokerStars Game #59941135642:  Hold'em No Limit ($0.50/$1.00) - 2009/07/01 1:26:39 ET
Table 'cBDNutyLBKEk9+ptwsKmTw' 6-max Seat #2 is the button
Seat 1: xAU6q2/cwmby2sxmA8VcmA ($299.05 in chips)
Seat 2: 4OO5v3AVduL0tePNx8wk5A ($100 in chips)
Seat 3: G5ZSSN6RSON3gkNvk/SmYg ($109.40 in chips)
Seat 4: OMkHNxIUZxh1pHqcCjbjgw ($100 in chips)
Seat 5: hpxXcmRkXXI9HE5+5/j/0Q ($101.50 in chips)
Seat 6: QHvTZcrKe6+maWUfVjP29Q ($151.50 in chips)
G5ZSSN6RSON3gkNvk/SmYg: posts small blind $0.50
OMkHNxIUZxh1pHqcCjbjgw: posts big blind $1
*** HOLE CARDS ***
hpxXcmRkXXI9HE5+5/j/0Q: folds
QHvTZcrKe6+maWUfVjP29Q: folds
xAU6q2/cwmby2sxmA8VcmA: folds
4OO5v3AVduL0tePNx8wk5A: raises $2 to $3
G5ZSSN6RSON3gkNvk/SmYg: folds
OMkHNxIUZxh1pHqcCjbjgw: folds
4OO5v3AVduL0tePNx8wk5A collected $2.50 from pot
4OO5v3AVduL0tePNx8wk5A: doesn't show hand
*** SUMMARY ***
Total pot $2.50 | Rake $0
Seat 1: xAU6q2/cwmby2sxmA8VcmA folded before Flop (didn't bet)
Seat 2: 4OO5v3AVduL0tePNx8wk5A (button) collected ($2.50)
Seat 3: G5ZSSN6RSON3gkNvk/SmYg (small blind) folded before Flop
Seat 4: OMkHNxIUZxh1pHqcCjbjgw (big blind) folded before Flop
Seat 5: hpxXcmRkXXI9HE5+5/j/0Q folded before Flop (didn't bet)
Seat 6: QHvTZcrKe6+maWUfVjP29Q folded before Flop (didn't bet)



PokerStars Game #59941136364:  Hold'em No Limit ($0.50/$1.00) - 2009/07/01 1:26:41 ET
Table 'MNvFfRVQNka/oY+Z5aMbZQ' 2-max Seat #1 is the button
Seat 1: DaZnoWHjO897dnh0CL2lVg ($69.60 in chips)
Seat 2: mgi+mjKb1Sc3CCs7TlfoCw ($91.05 in chips)
DaZnoWHjO897dnh0CL2lVg: posts small blind $0.50
mgi+mjKb1Sc3CCs7TlfoCw: posts big blind $1
*** HOLE CARDS ***
DaZnoWHjO897dnh0CL2lVg: folds
mgi+mjKb1Sc3CCs7TlfoCw collected $1 from pot
mgi+mjKb1Sc3CCs7TlfoCw: doesn't show hand
*** SUMMARY ***
Total pot $1 | Rake $0
Seat 1: DaZnoWHjO897dnh0CL2lVg (button) (small blind) folded before Flop
Seat 2: mgi+mjKb1Sc3CCs7TlfoCw (big blind) collected ($1)



PokerStars Game #59941137918:  Hold'em No Limit ($0.50/$1.00) - 2009/07/01 1:26:43 ET
Table 'Evb7VW0qfDhFkbgBL3gcqQ' 2-max Seat #2 is the button
Seat 1: NYi6JFscYNrofSXy4sM+Yw ($155.15 in chips)
Seat 2: AoEQlM/FNYM0d7Txn1TfBQ ($49.25 in chips)
AoEQlM/FNYM0d7Txn1TfBQ: posts small blind $0.50
NYi6JFscYNrofSXy4sM+Yw: posts big blind $1
*** HOLE CARDS ***
AoEQlM/FNYM0d7Txn1TfBQ: calls $0.50
NYi6JFscYNrofSXy4sM+Yw: checks
*** FLOP *** [6h 5d Qd]
NYi6JFscYNrofSXy4sM+Yw: checks
AoEQlM/FNYM0d7Txn1TfBQ: bets $2
NYi6JFscYNrofSXy4sM+Yw: folds
AoEQlM/FNYM0d7Txn1TfBQ collected $1.90 from pot
*** SUMMARY ***
Total pot $2 | Rake $0.10
Board [6h 5d Qd]
Seat 1: NYi6JFscYNrofSXy4sM+Yw (big blind) folded on the Flop
Seat 2: AoEQlM/FNYM0d7Txn1TfBQ (button) (small blind) collected ($1.90)



PokerStars Game #59941139376:  Hold'em No Limit ($0.50/$1.00) - 2009/07/01 1:26:46 ET
Table 'pHrhryH8jPNdQfY62f8v+g' 6-max Seat #4 is the button
Seat 1: 4d1rWhpu8DzLmzMbR3QKyA ($133.25 in chips)
Seat 2: JwCcjZl0bjJzG7hmE0dnTA ($105.55 in chips)
Seat 3: 8oS5O7iD/qnFXFXJrGIgNQ ($104.60 in chips)
Seat 4: 1f3beyIML24UqEMTbWy93g ($53.40 in chips)
Seat 5: r1/R7y0Ortgoz4lccgW8VA ($10.75 in chips)
Seat 6: xAU6q2/cwmby2sxmA8VcmA ($203.60 in chips)
r1/R7y0Ortgoz4lccgW8VA: posts small blind $0.50
xAU6q2/cwmby2sxmA8VcmA: posts big blind $1
*** HOLE CARDS ***
4d1rWhpu8DzLmzMbR3QKyA: folds
JwCcjZl0bjJzG7hmE0dnTA: folds
8oS5O7iD/qnFXFXJrGIgNQ said, "3"
8oS5O7iD/qnFXFXJrGIgNQ: raises $2 to $3
1f3beyIML24UqEMTbWy93g: folds
r1/R7y0Ortgoz4lccgW8VA: calls $2.50
xAU6q2/cwmby2sxmA8VcmA: calls $2
*** FLOP *** [Kd As 5h]
r1/R7y0Ortgoz4lccgW8VA: checks
xAU6q2/cwmby2sxmA8VcmA: checks
8oS5O7iD/qnFXFXJrGIgNQ: checks
*** TURN *** [Kd As 5h] [Kc]
r1/R7y0Ortgoz4lccgW8VA: checks
xAU6q2/cwmby2sxmA8VcmA: checks
8oS5O7iD/qnFXFXJrGIgNQ: bets $8
r1/R7y0Ortgoz4lccgW8VA: folds
xAU6q2/cwmby2sxmA8VcmA: folds
8oS5O7iD/qnFXFXJrGIgNQ collected $8.55 from pot
*** SUMMARY ***
Total pot $9 | Rake $0.45
Board [Kd As 5h Kc]
Seat 1: 4d1rWhpu8DzLmzMbR3QKyA folded before Flop (didn't bet)
Seat 2: JwCcjZl0bjJzG7hmE0dnTA folded before Flop (didn't bet)
Seat 3: 8oS5O7iD/qnFXFXJrGIgNQ collected ($8.55)
Seat 4: 1f3beyIML24UqEMTbWy93g (button) folded before Flop (didn't bet)
Seat 5: r1/R7y0Ortgoz4lccgW8VA (small blind) folded on the Turn
Seat 6: xAU6q2/cwmby2sxmA8VcmA (big blind) folded on the Turn



PokerStars Game #59941140178:  Hold'em No Limit ($0.50/$1.00) - 2009/07/01 1:26:47 ET
Table 'MNvFfRVQNka/oY+Z5aMbZQ' 2-max Seat #2 is the button
Seat 1: DaZnoWHjO897dnh0CL2lVg ($69.10 in chips)
Seat 2: mgi+mjKb1Sc3CCs7TlfoCw ($91.55 in chips)
mgi+mjKb1Sc3CCs7TlfoCw: posts small blind $0.50
DaZnoWHjO897dnh0CL2lVg: posts big blind $1
*** HOLE CARDS ***
mgi+mjKb1Sc3CCs7TlfoCw: folds
DaZnoWHjO897dnh0CL2lVg collected $1 from pot
DaZnoWHjO897dnh0CL2lVg: doesn't show hand
*** SUMMARY ***
Total pot $1 | Rake $0
Seat 1: DaZnoWHjO897dnh0CL2lVg (big blind) collected ($1)
Seat 2: mgi+mjKb1Sc3CCs7TlfoCw (button) (small blind) folded before Flop



PokerStars Game #59941141928:  Hold'em No Limit ($0.50/$1.00) - 2009/07/01 1:26:50 ET
Table 'jDQgUn1zGkyftPnHo0Awdw' 2-max Seat #2 is the button
Seat 1: a42+e5QB6s1kkG5FoSTZJw ($105.15 in chips)
Seat 2: q+vRKwm51mnr6kxX/161WQ ($90.90 in chips)
q+vRKwm51mnr6kxX/161WQ: posts small blind $0.50
a42+e5QB6s1kkG5FoSTZJw: posts big blind $1
*** HOLE CARDS ***
q+vRKwm51mnr6kxX/161WQ: raises $2 to $3
a42+e5QB6s1kkG5FoSTZJw: calls $2
*** FLOP *** [2d 9s Js]
a42+e5QB6s1kkG5FoSTZJw: checks
q+vRKwm51mnr6kxX/161WQ: bets $4
a42+e5QB6s1kkG5FoSTZJw: calls $4
*** TURN *** [2d 9s Js] [8s]
a42+e5QB6s1kkG5FoSTZJw: checks
q+vRKwm51mnr6kxX/161WQ: checks
*** RIVER *** [2d 9s Js 8s] [Qs]
a42+e5QB6s1kkG5FoSTZJw: checks
q+vRKwm51mnr6kxX/161WQ: checks
*** SHOW DOWN ***
a42+e5QB6s1kkG5FoSTZJw: shows [3s 5s] (a flush, Queen high)
q+vRKwm51mnr6kxX/161WQ: mucks hand
a42+e5QB6s1kkG5FoSTZJw collected $13.50 from pot
*** SUMMARY ***
Total pot $14 | Rake $0.50
Board [2d 9s Js 8s Qs]
Seat 1: a42+e5QB6s1kkG5FoSTZJw (big blind) showed [3s 5s] and won ($13.50) with a flush, Queen high
Seat 2: q+vRKwm51mnr6kxX/161WQ (button) (small blind) mucked



PokerStars Game #59941141808:  Hold'em No Limit ($0.50/$1.00) - 2009/07/01 1:26:50 ET
Table '+cA8mcmhaedZ7YcrDdhmeQ' 6-max Seat #3 is the button
Seat 1: iIgNoBh+3/Ix1/fLsg+HuA ($40.75 in chips)
Seat 2: 14aYclSc98EYd6TrzN2l3Q ($14.55 in chips)
Seat 3: DAIgyIWbYvAkL6PbAI27pg ($18.05 in chips)
Seat 4: 4OO5v3AVduL0tePNx8wk5A ($100 in chips)
Seat 5: n5xXfJeDtWZSChGAdq//Tw ($18.55 in chips)
Seat 6: YfsTQsY/fxb+YqbdclTHuw ($27.25 in chips)
4OO5v3AVduL0tePNx8wk5A: posts small blind $0.50
n5xXfJeDtWZSChGAdq//Tw: posts big blind $1
*** HOLE CARDS ***
YfsTQsY/fxb+YqbdclTHuw: folds
iIgNoBh+3/Ix1/fLsg+HuA: folds
14aYclSc98EYd6TrzN2l3Q: folds
iIgNoBh+3/Ix1/fLsg+HuA leaves the table
DAIgyIWbYvAkL6PbAI27pg: folds
9XrTM0DuVxx1pjFAdSbD8A joins the table at seat #1
4OO5v3AVduL0tePNx8wk5A: raises $2 to $3
n5xXfJeDtWZSChGAdq//Tw: folds
4OO5v3AVduL0tePNx8wk5A collected $2 from pot
*** SUMMARY ***
Total pot $2 | Rake $0
Seat 1: iIgNoBh+3/Ix1/fLsg+HuA folded before Flop (didn't bet)
Seat 2: 14aYclSc98EYd6TrzN2l3Q folded before Flop (didn't bet)
Seat 3: DAIgyIWbYvAkL6PbAI27pg (button) folded before Flop (didn't bet)
Seat 4: 4OO5v3AVduL0tePNx8wk5A (small blind) collected ($2)
Seat 5: n5xXfJeDtWZSChGAdq//Tw (big blind) folded before Flop
Seat 6: YfsTQsY/fxb+YqbdclTHuw folded before Flop (didn't bet)



PokerStars Game #59941144352:  Hold'em No Limit ($0.50/$1.00) - 2009/07/01 1:26:54 ET
Table '/RZcOwpZpHQ+OwPwjsbnRw' 6-max Seat #5 is the button
Seat 1: +uSzP8Jwnw7sKfQ4s66b7w ($45.25 in chips)
Seat 2: Z2fXsGcjl+Eax+RzOgwOmg ($107.15 in chips)
Seat 3: 6hLdALbOlkzGIrc53QKtPw ($22.70 in chips)
Seat 4: j7NIOHLZk7V2o9fOioO5ug ($101.50 in chips)
Seat 5: wx3sQGkVi2x9wJXuWNHPBw ($164.55 in chips)
Seat 6: o3YLm/rSY916m/on1VjXPA ($201 in chips)
o3YLm/rSY916m/on1VjXPA: posts small blind $0.50
+uSzP8Jwnw7sKfQ4s66b7w: posts big blind $1
*** HOLE CARDS ***
Z2fXsGcjl+Eax+RzOgwOmg: folds
6hLdALbOlkzGIrc53QKtPw: folds
j7NIOHLZk7V2o9fOioO5ug: raises $2 to $3
wx3sQGkVi2x9wJXuWNHPBw: folds
o3YLm/rSY916m/on1VjXPA: calls $2.50
+uSzP8Jwnw7sKfQ4s66b7w: calls $2
*** FLOP *** [3h Jc Jh]
o3YLm/rSY916m/on1VjXPA: checks
+uSzP8Jwnw7sKfQ4s66b7w: checks
j7NIOHLZk7V2o9fOioO5ug: bets $7
o3YLm/rSY916m/on1VjXPA: folds
+uSzP8Jwnw7sKfQ4s66b7w: folds
j7NIOHLZk7V2o9fOioO5ug collected $8.55 from pot
j7NIOHLZk7V2o9fOioO5ug: doesn't show hand
*** SUMMARY ***
Total pot $9 | Rake $0.45
Board [3h Jc Jh]
Seat 1: +uSzP8Jwnw7sKfQ4s66b7w (big blind) folded on the Flop
Seat 2: Z2fXsGcjl+Eax+RzOgwOmg folded before Flop (didn't bet)
Seat 3: 6hLdALbOlkzGIrc53QKtPw folded before Flop (didn't bet)
Seat 4: j7NIOHLZk7V2o9fOioO5ug collected ($8.55)
Seat 5: wx3sQGkVi2x9wJXuWNHPBw (button) folded before Flop (didn't bet)
Seat 6: o3YLm/rSY916m/on1VjXPA (small blind) folded on the Flop



PokerStars Game #59941144918:  Hold'em No Limit ($0.50/$1.00) - 2009/07/01 1:26:55 ET
Table 'blHlQApStil0OPeQxQxPcw' 9-max Seat #3 is the button
Seat 1: Pp/KTcXkfZKKUHkjyaLTdg ($22.30 in chips)
Seat 2: V138SURkdX8LdVBPKdJJag ($124.35 in chips)
Seat 3: OGgaARGdJQT4awWVNQ957w ($100 in chips)
Seat 4: e3u1tVujx+9fNGL+1+YnaQ ($33.35 in chips)
Seat 5: uXrDE6JrIi8BZK1L8oQ9bQ ($61.10 in chips)
Seat 6: vljeiOoWscAIXU0fCuiEBw ($59.15 in chips)
Seat 7: GTQkFJtSkbVbnGCktp6e3g ($103.40 in chips)
Seat 8: laA8va+Yv8WuMqT1zdR91g ($100 in chips)
Seat 9: 6XkTu4ahxzHnvjjc1R8YjQ ($100 in chips)
e3u1tVujx+9fNGL+1+YnaQ: posts small blind $0.50
uXrDE6JrIi8BZK1L8oQ9bQ: posts big blind $1
*** HOLE CARDS ***
vljeiOoWscAIXU0fCuiEBw: calls $1
GTQkFJtSkbVbnGCktp6e3g: raises $4 to $5
laA8va+Yv8WuMqT1zdR91g: folds
6XkTu4ahxzHnvjjc1R8YjQ: folds
Pp/KTcXkfZKKUHkjyaLTdg: folds
V138SURkdX8LdVBPKdJJag: folds
OGgaARGdJQT4awWVNQ957w: folds
e3u1tVujx+9fNGL+1+YnaQ: folds
uXrDE6JrIi8BZK1L8oQ9bQ: folds
vljeiOoWscAIXU0fCuiEBw: calls $4
*** FLOP *** [Jd 8c Th]
vljeiOoWscAIXU0fCuiEBw: checks
GTQkFJtSkbVbnGCktp6e3g: bets $8
vljeiOoWscAIXU0fCuiEBw: calls $8
*** TURN *** [Jd 8c Th] [6d]
vljeiOoWscAIXU0fCuiEBw: checks
GTQkFJtSkbVbnGCktp6e3g: checks
*** RIVER *** [Jd 8c Th 6d] [Ac]
vljeiOoWscAIXU0fCuiEBw: checks
GTQkFJtSkbVbnGCktp6e3g: bets $22
vljeiOoWscAIXU0fCuiEBw: folds
GTQkFJtSkbVbnGCktp6e3g collected $26.20 from pot
GTQkFJtSkbVbnGCktp6e3g: doesn't show hand
*** SUMMARY ***
Total pot $27.50 | Rake $1.30
Board [Jd 8c Th 6d Ac]
Seat 1: Pp/KTcXkfZKKUHkjyaLTdg folded before Flop (didn't bet)
Seat 2: V138SURkdX8LdVBPKdJJag folded before Flop (didn't bet)
Seat 3: OGgaARGdJQT4awWVNQ957w (button) folded before Flop (didn't bet)
Seat 4: e3u1tVujx+9fNGL+1+YnaQ (small blind) folded before Flop
Seat 5: uXrDE6JrIi8BZK1L8oQ9bQ (big blind) folded before Flop
Seat 6: vljeiOoWscAIXU0fCuiEBw folded on the River
Seat 7: GTQkFJtSkbVbnGCktp6e3g collected ($26.20)
Seat 8: laA8va+Yv8WuMqT1zdR91g folded before Flop (didn't bet)
Seat 9: 6XkTu4ahxzHnvjjc1R8YjQ folded before Flop (didn't bet)



PokerStars Game #59941145436:  Hold'em No Limit ($0.50/$1.00) - 2009/07/01 1:26:56 ET
Table 'Evb7VW0qfDhFkbgBL3gcqQ' 2-max Seat #1 is the button
Seat 1: NYi6JFscYNrofSXy4sM+Yw ($154.15 in chips)
Seat 2: AoEQlM/FNYM0d7Txn1TfBQ ($50.15 in chips)
NYi6JFscYNrofSXy4sM+Yw: posts small blind $0.50
AoEQlM/FNYM0d7Txn1TfBQ: posts big blind $1
*** HOLE CARDS ***
NYi6JFscYNrofSXy4sM+Yw: raises $2 to $3
AoEQlM/FNYM0d7Txn1TfBQ: calls $2
*** FLOP *** [6d 7d Kc]
AoEQlM/FNYM0d7Txn1TfBQ: checks
NYi6JFscYNrofSXy4sM+Yw: bets $3
AoEQlM/FNYM0d7Txn1TfBQ: folds
NYi6JFscYNrofSXy4sM+Yw collected $5.70 from pot
*** SUMMARY ***
Total pot $6 | Rake $0.30
Board [6d 7d Kc]
Seat 1: NYi6JFscYNrofSXy4sM+Yw (button) (small blind) collected ($5.70)
Seat 2: AoEQlM/FNYM0d7Txn1TfBQ (big blind) folded on the Flop



PokerStars Game #59941145466:  Hold'em No Limit ($0.50/$1.00) - 2009/07/01 1:26:56 ET
Table '7Nl0ffnjeK44/vmeexh3MQ' 9-max Seat #3 is the button
Seat 1: V138SURkdX8LdVBPKdJJag ($101.50 in chips)
Seat 2: OGgaARGdJQT4awWVNQ957w ($100.50 in chips)
Seat 3: JMmUYT5pIKCKh2pGjCB/4w ($58.90 in chips)
Seat 4: bLbSOSmSOnqE0iTcH/5dxA ($110.80 in chips)
Seat 5: 61sfw5QTu62YYIt68OsdrA ($81.50 in chips)
Seat 6: FVs16t7GgfWgQWt4JxsObQ ($18.05 in chips)
Seat 7: 997ViqAtWn1FPjJqcffwcA ($100 in chips)
Seat 8: D+W9Me7w6Hcx/WRUSKV0dw ($20 in chips)
bLbSOSmSOnqE0iTcH/5dxA: posts small blind $0.50
61sfw5QTu62YYIt68OsdrA: posts big blind $1
/JHoNdt0fK6X+isrqRfV3w: sits out
*** HOLE CARDS ***
FVs16t7GgfWgQWt4JxsObQ: calls $1
997ViqAtWn1FPjJqcffwcA: folds
D+W9Me7w6Hcx/WRUSKV0dw: folds
V138SURkdX8LdVBPKdJJag: folds
OGgaARGdJQT4awWVNQ957w: folds
JMmUYT5pIKCKh2pGjCB/4w: folds
bLbSOSmSOnqE0iTcH/5dxA: raises $4 to $5
61sfw5QTu62YYIt68OsdrA: folds
FVs16t7GgfWgQWt4JxsObQ: calls $4
*** FLOP *** [7d 5c 3s]
bLbSOSmSOnqE0iTcH/5dxA: checks
FVs16t7GgfWgQWt4JxsObQ: bets $1
bLbSOSmSOnqE0iTcH/5dxA: calls $1
*** TURN *** [7d 5c 3s] [Jd]
bLbSOSmSOnqE0iTcH/5dxA: checks
FVs16t7GgfWgQWt4JxsObQ: bets $1
bLbSOSmSOnqE0iTcH/5dxA: calls $1
*** RIVER *** [7d 5c 3s Jd] [7h]
bLbSOSmSOnqE0iTcH/5dxA: checks
FVs16t7GgfWgQWt4JxsObQ: bets $5
bLbSOSmSOnqE0iTcH/5dxA: folds
FVs16t7GgfWgQWt4JxsObQ collected $14.30 from pot
*** SUMMARY ***
Total pot $15 | Rake $0.70
Board [7d 5c 3s Jd 7h]
Seat 1: V138SURkdX8LdVBPKdJJag folded before Flop (didn't bet)
Seat 2: OGgaARGdJQT4awWVNQ957w folded before Flop (didn't bet)
Seat 3: JMmUYT5pIKCKh2pGjCB/4w (button) folded before Flop (didn't bet)
Seat 4: bLbSOSmSOnqE0iTcH/5dxA (small blind) folded on the River
Seat 5: 61sfw5QTu62YYIt68OsdrA (big blind) folded before Flop
Seat 6: FVs16t7GgfWgQWt4JxsObQ collected ($14.30)
Seat 7: 997ViqAtWn1FPjJqcffwcA folded before Flop (didn't bet)
Seat 8: D+W9Me7w6Hcx/WRUSKV0dw folded before Flop (didn't bet)



PokerStars Game #59941146066:  Hold'em No Limit ($0.50/$1.00) - 2009/07/01 1:26:57 ET
Table 'TvsifD4n+q//fIZ4fM1xxQ' 2-max Seat #2 is the button
Seat 1: NYi6JFscYNrofSXy4sM+Yw ($169.05 in chips)
Seat 2: +W/hy0gBp0sJy8pjLz6Yrg ($102.40 in chips)
+W/hy0gBp0sJy8pjLz6Yrg: posts small blind $0.50
NYi6JFscYNrofSXy4sM+Yw: posts big blind $1
*** HOLE CARDS ***
+W/hy0gBp0sJy8pjLz6Yrg: raises $2 to $3
NYi6JFscYNrofSXy4sM+Yw: calls $2
*** FLOP *** [7s Td Qd]
NYi6JFscYNrofSXy4sM+Yw: checks
+W/hy0gBp0sJy8pjLz6Yrg: bets $5
NYi6JFscYNrofSXy4sM+Yw: folds
+W/hy0gBp0sJy8pjLz6Yrg collected $5.70 from pot
*** SUMMARY ***
Total pot $6 | Rake $0.30
Board [7s Td Qd]
Seat 1: NYi6JFscYNrofSXy4sM+Yw (big blind) folded on the Flop
Seat 2: +W/hy0gBp0sJy8pjLz6Yrg (button) (small blind) collected ($5.70)



PokerStars Game #59941145766:  Hold'em No Limit ($0.50/$1.00) - 2009/07/01 1:26:57 ET
Table 'O96CPOtvMBWP6kzuYDfdFA' 6-max Seat #1 is the button
Seat 1: 6alLXQIITA2EZ/lBeym8Dw ($122.75 in chips)
Seat 2: 4d1rWhpu8DzLmzMbR3QKyA ($115.10 in chips)
Seat 3: V89DGjxE171oPREEbAXiyg ($91.65 in chips)
Seat 4: /P4w1pHg2zHYg/4ubJ0dPw ($63.65 in chips)
Seat 5: G5ZSSN6RSON3gkNvk/SmYg ($104.15 in chips)
Seat 6: GYei5jXGWexiJYbAT2fELg ($26.45 in chips)
4d1rWhpu8DzLmzMbR3QKyA: posts small blind $0.50
V89DGjxE171oPREEbAXiyg: posts big blind $1
*** HOLE CARDS ***
/P4w1pHg2zHYg/4ubJ0dPw: folds
G5ZSSN6RSON3gkNvk/SmYg: folds
GYei5jXGWexiJYbAT2fELg: calls $1
6alLXQIITA2EZ/lBeym8Dw: raises $3 to $4
4d1rWhpu8DzLmzMbR3QKyA: folds
V89DGjxE171oPREEbAXiyg: raises $9 to $13
GYei5jXGWexiJYbAT2fELg: raises $13.45 to $26.45 and is all-in
6alLXQIITA2EZ/lBeym8Dw: folds
V89DGjxE171oPREEbAXiyg: calls $13.45
*** FLOP *** [3c Jd 9d]
*** TURN *** [3c Jd 9d] [Qs]
*** RIVER *** [3c Jd 9d Qs] [4d]
*** SHOW DOWN ***
V89DGjxE171oPREEbAXiyg: shows [Qd 9s] (two pair, Queens and Nines)
GYei5jXGWexiJYbAT2fELg: shows [Kd Kh] (a pair of Kings)
V89DGjxE171oPREEbAXiyg collected $54.55 from pot
*** SUMMARY ***
Total pot $57.40 | Rake $2.85
Board [3c Jd 9d Qs 4d]
Seat 1: 6alLXQIITA2EZ/lBeym8Dw (button) folded before Flop
Seat 2: 4d1rWhpu8DzLmzMbR3QKyA (small blind) folded before Flop
Seat 3: V89DGjxE171oPREEbAXiyg (big blind) showed [Qd 9s] and won ($54.55) with two pair, Queens and Nines
Seat 4: /P4w1pHg2zHYg/4ubJ0dPw folded before Flop (didn't bet)
Seat 5: G5ZSSN6RSON3gkNvk/SmYg folded before Flop (didn't bet)
Seat 6: GYei5jXGWexiJYbAT2fELg showed [Kd Kh] and lost with a pair of Kings



PokerStars Game #59941146196:  Hold'em No Limit ($0.50/$1.00) - 2009/07/01 1:26:58 ET
Table 'N6LvHFrb+cdXY/COI6ByOw' 2-max Seat #1 is the button
Seat 1: lXX4W7m3u++JiSOZ46yVMQ ($110.90 in chips)
Seat 2: 9mAoSP3o/mikSZOW2LEEAw ($88.50 in chips)
lXX4W7m3u++JiSOZ46yVMQ: posts small blind $0.50
9mAoSP3o/mikSZOW2LEEAw: posts big blind $1
*** HOLE CARDS ***
lXX4W7m3u++JiSOZ46yVMQ: folds
9mAoSP3o/mikSZOW2LEEAw collected $1 from pot
*** SUMMARY ***
Total pot $1 | Rake $0
Seat 1: lXX4W7m3u++JiSOZ46yVMQ (button) (small blind) folded before Flop
Seat 2: 9mAoSP3o/mikSZOW2LEEAw (big blind) collected ($1)



PokerStars Game #59941146954:  Hold'em No Limit ($0.50/$1.00) - 2009/07/01 1:26:59 ET
Table 'cBDNutyLBKEk9+ptwsKmTw' 6-max Seat #3 is the button
Seat 1: xAU6q2/cwmby2sxmA8VcmA ($299.05 in chips)
Seat 2: 4OO5v3AVduL0tePNx8wk5A ($101.50 in chips)
Seat 3: G5ZSSN6RSON3gkNvk/SmYg ($108.90 in chips)
Seat 4: OMkHNxIUZxh1pHqcCjbjgw ($99 in chips)
Seat 5: hpxXcmRkXXI9HE5+5/j/0Q ($101.50 in chips)
Seat 6: QHvTZcrKe6+maWUfVjP29Q ($151.50 in chips)
OMkHNxIUZxh1pHqcCjbjgw: posts small blind $0.50
hpxXcmRkXXI9HE5+5/j/0Q: posts big blind $1
*** HOLE CARDS ***
QHvTZcrKe6+maWUfVjP29Q: folds
xAU6q2/cwmby2sxmA8VcmA: folds
4OO5v3AVduL0tePNx8wk5A: folds
G5ZSSN6RSON3gkNvk/SmYg: folds
OMkHNxIUZxh1pHqcCjbjgw: folds
hpxXcmRkXXI9HE5+5/j/0Q collected $1 from pot
hpxXcmRkXXI9HE5+5/j/0Q: doesn't show hand
*** SUMMARY ***
Total pot $1 | Rake $0
Seat 1: xAU6q2/cwmby2sxmA8VcmA folded before Flop (didn't bet)
Seat 2: 4OO5v3AVduL0tePNx8wk5A folded before Flop (didn't bet)
Seat 3: G5ZSSN6RSON3gkNvk/SmYg (button) folded before Flop (didn't bet)
Seat 4: OMkHNxIUZxh1pHqcCjbjgw (small blind) folded before Flop
Seat 5: hpxXcmRkXXI9HE5+5/j/0Q (big blind) collected ($1)
Seat 6: QHvTZcrKe6+maWUfVjP29Q folded before Flop (didn't bet)



PokerStars Game #59941147024:  Hold'em No Limit ($0.50/$1.00) - 2009/07/01 1:26:59 ET
Table 'CASNP0uy1C+jGLml/I4PtA' 9-max Seat #9 is the button
Seat 1: tkdBeXTJlFsZdioidNqLow ($60.50 in chips)
Seat 2: LUsAYklr0mQkiq7ASOyD9A ($62.50 in chips)
Seat 3: bJckevFOcg//s0qyMQI6sQ ($100 in chips)
Seat 4: B/G0GJacqZ8K59/ZVdq4kQ ($70.55 in chips)
Seat 5: Jjc7EHWzs4//xUAjJ0UWoA ($10.50 in chips)
Seat 6: FJEywSpo5JbRKByzmweboA ($100 in chips)
Seat 7: S3Ex8K7v6xm5jqjRM7Fl3w ($22 in chips)
Seat 8: L9njYvloJ1NdXjP8edHEAg ($104.45 in chips)
Seat 9: Pp/KTcXkfZKKUHkjyaLTdg ($20 in chips)
tkdBeXTJlFsZdioidNqLow: posts small blind $0.50
LUsAYklr0mQkiq7ASOyD9A: posts big blind $1
*** HOLE CARDS ***
Jjc7EHWzs4//xUAjJ0UWoA is connected
bJckevFOcg//s0qyMQI6sQ: folds
B/G0GJacqZ8K59/ZVdq4kQ: folds
Jjc7EHWzs4//xUAjJ0UWoA: folds
FJEywSpo5JbRKByzmweboA: folds
S3Ex8K7v6xm5jqjRM7Fl3w: folds
L9njYvloJ1NdXjP8edHEAg: folds
Pp/KTcXkfZKKUHkjyaLTdg: folds
tkdBeXTJlFsZdioidNqLow: folds
LUsAYklr0mQkiq7ASOyD9A collected $1 from pot
*** SUMMARY ***
Total pot $1 | Rake $0
Seat 1: tkdBeXTJlFsZdioidNqLow (small blind) folded before Flop
Seat 2: LUsAYklr0mQkiq7ASOyD9A (big blind) collected ($1)
Seat 3: bJckevFOcg//s0qyMQI6sQ folded before Flop (didn't bet)
Seat 4: B/G0GJacqZ8K59/ZVdq4kQ folded before Flop (didn't bet)
Seat 5: Jjc7EHWzs4//xUAjJ0UWoA folded before Flop (didn't bet)
Seat 6: FJEywSpo5JbRKByzmweboA folded before Flop (didn't bet)
Seat 7: S3Ex8K7v6xm5jqjRM7Fl3w folded before Flop (didn't bet)
Seat 8: L9njYvloJ1NdXjP8edHEAg folded before Flop (didn't bet)
Seat 9: Pp/KTcXkfZKKUHkjyaLTdg (button) folded before Flop (didn't bet)



PokerStars Game #59941146922:  Hold'em No Limit ($0.50/$1.00) - 2009/07/01 1:26:59 ET
Table 'gxFK0BVUD7cupu2uyRUZJg' 6-max Seat #3 is the button
Seat 1: M+X3uChmP6R63IwijVjgTg ($162.75 in chips)
Seat 2: hpxXcmRkXXI9HE5+5/j/0Q ($136.05 in chips)
Seat 3: Z2fXsGcjl+Eax+RzOgwOmg ($119 in chips)
Seat 5: WgIrs6CBinyyw18pqdDtWA ($20.20 in chips)
Seat 6: dYyb6/42PMC8aNFlm/eBeQ ($104.50 in chips)
Vwildcat11 was removed from the table for failing to post
WgIrs6CBinyyw18pqdDtWA: posts small blind $0.50
dYyb6/42PMC8aNFlm/eBeQ: posts big blind $1
*** HOLE CARDS ***
M+X3uChmP6R63IwijVjgTg: folds
hpxXcmRkXXI9HE5+5/j/0Q: folds
Z2fXsGcjl+Eax+RzOgwOmg: raises $2 to $3
WgIrs6CBinyyw18pqdDtWA: folds
JwCcjZl0bjJzG7hmE0dnTA joins the table at seat #4
dYyb6/42PMC8aNFlm/eBeQ: folds
Z2fXsGcjl+Eax+RzOgwOmg collected $2.50 from pot
Z2fXsGcjl+Eax+RzOgwOmg: doesn't show hand
*** SUMMARY ***
Total pot $2.50 | Rake $0
Seat 1: M+X3uChmP6R63IwijVjgTg folded before Flop (didn't bet)
Seat 2: hpxXcmRkXXI9HE5+5/j/0Q folded before Flop (didn't bet)
Seat 3: Z2fXsGcjl+Eax+RzOgwOmg (button) collected ($2.50)
Seat 5: WgIrs6CBinyyw18pqdDtWA (small blind) folded before Flop
Seat 6: dYyb6/42PMC8aNFlm/eBeQ (big blind) folded before Flop



PokerStars Game #59941147254:  Hold'em No Limit ($0.50/$1.00) - 2009/07/01 1:27:00 ET
Table 'fZjVbKj9D8yOB+Rj7NaP/A' 9-max Seat #3 is the button
Seat 1: 9BZCcac3+McErkkSN2YScA ($102.25 in chips)
Seat 2: PTAFYDIUSsG+SArbxNl+Aw ($105.50 in chips)
Seat 3: yAbu2QsRPVcjPbqlf/jDxw ($101 in chips)
Seat 4: 997ViqAtWn1FPjJqcffwcA ($100 in chips)
Seat 5: PkGfq5xrSlNsujKaG/HF4Q ($100 in chips)
Seat 6: OvwYHV65yUbgdBjSmo1+5g ($36.95 in chips)
Seat 7: SyS20PAm3RpT6uLBsGkwOA ($121.55 in chips)
Seat 8: zDOE5r14tWqCf6xhuSHK6g ($52.90 in chips)
Seat 9: qheQay5YvP2DMAb3OUSxtw ($99 in chips)
997ViqAtWn1FPjJqcffwcA: posts small blind $0.50
PkGfq5xrSlNsujKaG/HF4Q: posts big blind $1
*** HOLE CARDS ***
OvwYHV65yUbgdBjSmo1+5g: raises $1 to $2
SyS20PAm3RpT6uLBsGkwOA: raises $4 to $6
zDOE5r14tWqCf6xhuSHK6g: folds
qheQay5YvP2DMAb3OUSxtw: folds
9BZCcac3+McErkkSN2YScA: folds
PTAFYDIUSsG+SArbxNl+Aw: folds
yAbu2QsRPVcjPbqlf/jDxw: folds
997ViqAtWn1FPjJqcffwcA: folds
PkGfq5xrSlNsujKaG/HF4Q: calls $5
OvwYHV65yUbgdBjSmo1+5g: calls $4
*** FLOP *** [3h 4d Jd]
PkGfq5xrSlNsujKaG/HF4Q: checks
OvwYHV65yUbgdBjSmo1+5g: bets $11
SyS20PAm3RpT6uLBsGkwOA: raises $30 to $41
PkGfq5xrSlNsujKaG/HF4Q: folds
OvwYHV65yUbgdBjSmo1+5g: calls $19.95 and is all-in
*** TURN *** [3h 4d Jd] [Kc]
*** RIVER *** [3h 4d Jd Kc] [9h]
*** SHOW DOWN ***
OvwYHV65yUbgdBjSmo1+5g: shows [Ks Kd] (three of a kind, Kings)
SyS20PAm3RpT6uLBsGkwOA: mucks hand
OvwYHV65yUbgdBjSmo1+5g collected $77.40 from pot
*** SUMMARY ***
Total pot $80.40 | Rake $3
Board [3h 4d Jd Kc 9h]
Seat 1: 9BZCcac3+McErkkSN2YScA folded before Flop (didn't bet)
Seat 2: PTAFYDIUSsG+SArbxNl+Aw folded before Flop (didn't bet)
Seat 3: yAbu2QsRPVcjPbqlf/jDxw (button) folded before Flop (didn't bet)
Seat 4: 997ViqAtWn1FPjJqcffwcA (small blind) folded before Flop
Seat 5: PkGfq5xrSlNsujKaG/HF4Q (big blind) folded on the Flop
Seat 6: OvwYHV65yUbgdBjSmo1+5g showed [Ks Kd] and won ($77.40) with three of a kind, Kings
Seat 7: SyS20PAm3RpT6uLBsGkwOA mucked
Seat 8: zDOE5r14tWqCf6xhuSHK6g folded before Flop (didn't bet)
Seat 9: qheQay5YvP2DMAb3OUSxtw folded before Flop (didn't bet)



PokerStars Game #59941147434:  Hold'em No Limit ($0.50/$1.00) - 2009/07/01 1:27:00 ET
Table 'hugOjcwJvzEwZbK7tyiWuQ' 9-max Seat #4 is the button
Seat 1: S3Ex8K7v6xm5jqjRM7Fl3w ($18.50 in chips)
Seat 2: r27C1nIV4NS4+qbnrgBQSw ($273.70 in chips)
Seat 4: UWB3oeddt/GObx2Mix2Anw ($183.10 in chips)
Seat 6: gUUvmqdVlmvpal6B8nYrmg ($105.95 in chips)
Seat 7: FL3MrLspcF23LYvC4ipBOA ($117.30 in chips)
Seat 8: /zy+DB4S5fUQUSfZWFzYGw ($119.85 in chips)
Seat 9: W8P9bUKCs43TO1xHm0dL6w ($113.80 in chips)
AexZ4puUV9meFWwVU6Nv0w will be allowed to play after the button
gUUvmqdVlmvpal6B8nYrmg: posts small blind $0.50
FL3MrLspcF23LYvC4ipBOA: posts big blind $1
*** HOLE CARDS ***
/zy+DB4S5fUQUSfZWFzYGw: folds
W8P9bUKCs43TO1xHm0dL6w: folds
S3Ex8K7v6xm5jqjRM7Fl3w: raises $2 to $3
r27C1nIV4NS4+qbnrgBQSw: folds
UWB3oeddt/GObx2Mix2Anw: folds
gUUvmqdVlmvpal6B8nYrmg: folds
FL3MrLspcF23LYvC4ipBOA: folds
S3Ex8K7v6xm5jqjRM7Fl3w collected $2.50 from pot
S3Ex8K7v6xm5jqjRM7Fl3w: doesn't show hand
*** SUMMARY ***
Total pot $2.50 | Rake $0
Seat 1: S3Ex8K7v6xm5jqjRM7Fl3w collected ($2.50)
Seat 2: r27C1nIV4NS4+qbnrgBQSw folded before Flop (didn't bet)
Seat 4: UWB3oeddt/GObx2Mix2Anw (button) folded before Flop (didn't bet)
Seat 6: gUUvmqdVlmvpal6B8nYrmg (small blind) folded before Flop
Seat 7: FL3MrLspcF23LYvC4ipBOA (big blind) folded before Flop
Seat 8: /zy+DB4S5fUQUSfZWFzYGw folded before Flop (didn't bet)
Seat 9: W8P9bUKCs43TO1xHm0dL6w folded before Flop (didn't bet)



PokerStars Game #59941147478:  Hold'em No Limit ($0.50/$1.00) - 2009/07/01 1:27:00 ET
Table 'MNvFfRVQNka/oY+Z5aMbZQ' 2-max Seat #1 is the button
Seat 1: DaZnoWHjO897dnh0CL2lVg ($69.60 in chips)
Seat 2: mgi+mjKb1Sc3CCs7TlfoCw ($91.05 in chips)
DaZnoWHjO897dnh0CL2lVg: posts small blind $0.50
mgi+mjKb1Sc3CCs7TlfoCw: posts big blind $1
*** HOLE CARDS ***
DaZnoWHjO897dnh0CL2lVg: raises $2 to $3
mgi+mjKb1Sc3CCs7TlfoCw: folds
DaZnoWHjO897dnh0CL2lVg collected $2 from pot
DaZnoWHjO897dnh0CL2lVg: doesn't show hand
*** SUMMARY ***
Total pot $2 | Rake $0
Seat 1: DaZnoWHjO897dnh0CL2lVg (button) (small blind) collected ($2)
Seat 2: mgi+mjKb1Sc3CCs7TlfoCw (big blind) folded before Flop



PokerStars Game #59941147966:  Hold'em No Limit ($0.50/$1.00) - 2009/07/01 1:27:01 ET
Table 'fTlPiCj0utgzC/5io+I7ew' 6-max Seat #2 is the button
Seat 1: YMJG+F++3Aj6P8dAWda5fw ($103.10 in chips)
Seat 2: qVr1nl3dy2xXPqS8UpTDlA ($21.30 in chips)
Seat 3: Z2fXsGcjl+Eax+RzOgwOmg ($140.50 in chips)
Seat 4: uJVSceLggtsrJya+WtmUEA ($161.15 in chips)
Seat 5: XUk5GQsfNFpHvaToDZ0rZA ($45.65 in chips)
Seat 6: y27w5IK2WXqmYzS8OU0wKA ($100 in chips)
Z2fXsGcjl+Eax+RzOgwOmg: posts small blind $0.50
uJVSceLggtsrJya+WtmUEA: posts big blind $1
*** HOLE CARDS ***
XUk5GQsfNFpHvaToDZ0rZA: folds
y27w5IK2WXqmYzS8OU0wKA: folds
YMJG+F++3Aj6P8dAWda5fw: folds
qVr1nl3dy2xXPqS8UpTDlA: calls $1
Z2fXsGcjl+Eax+RzOgwOmg: folds
uJVSceLggtsrJya+WtmUEA: raises $4 to $5
qVr1nl3dy2xXPqS8UpTDlA: folds
uJVSceLggtsrJya+WtmUEA collected $2.50 from pot
*** SUMMARY ***
Total pot $2.50 | Rake $0
Seat 1: YMJG+F++3Aj6P8dAWda5fw folded before Flop (didn't bet)
Seat 2: qVr1nl3dy2xXPqS8UpTDlA (button) folded before Flop
Seat 3: Z2fXsGcjl+Eax+RzOgwOmg (small blind) folded before Flop
Seat 4: uJVSceLggtsrJya+WtmUEA (big blind) collected ($2.50)
Seat 5: XUk5GQsfNFpHvaToDZ0rZA folded before Flop (didn't bet)
Seat 6: y27w5IK2WXqmYzS8OU0wKA folded before Flop (didn't bet)



PokerStars Game #59941148366:  Hold'em No Limit ($0.50/$1.00) - 2009/07/01 1:27:01 ET
Table 'QSIig7BLMc9wY/rgBechzw' 6-max Seat #2 is the button
Seat 1: Z2fXsGcjl+Eax+RzOgwOmg ($110.60 in chips)
Seat 2: mLOIkH/qmRa+mVujQIhBRg ($48.90 in chips)
Seat 3: +xW7QemQU0Fxs+4TnqBRow ($110.50 in chips)
Seat 4: +uSzP8Jwnw7sKfQ4s66b7w ($62.15 in chips)
Seat 5: lsLuWlcPA3Rh7kJVLzMh0Q ($100 in chips)
Seat 6: PxqfkAMdAWtkgbT+q2gciA ($49 in chips)
+xW7QemQU0Fxs+4TnqBRow: posts small blind $0.50
+uSzP8Jwnw7sKfQ4s66b7w: posts big blind $1
*** HOLE CARDS ***
lsLuWlcPA3Rh7kJVLzMh0Q: folds
PxqfkAMdAWtkgbT+q2gciA: folds
Z2fXsGcjl+Eax+RzOgwOmg: folds
mLOIkH/qmRa+mVujQIhBRg: raises $1 to $2
+xW7QemQU0Fxs+4TnqBRow: folds
+uSzP8Jwnw7sKfQ4s66b7w: calls $1
*** FLOP *** [5s 5h 8h]
+uSzP8Jwnw7sKfQ4s66b7w: checks
mLOIkH/qmRa+mVujQIhBRg: checks
*** TURN *** [5s 5h 8h] [3s]
+uSzP8Jwnw7sKfQ4s66b7w: bets $3
mLOIkH/qmRa+mVujQIhBRg: folds
+uSzP8Jwnw7sKfQ4s66b7w collected $4.30 from pot
*** SUMMARY ***
Total pot $4.50 | Rake $0.20
Board [5s 5h 8h 3s]
Seat 1: Z2fXsGcjl+Eax+RzOgwOmg folded before Flop (didn't bet)
Seat 2: mLOIkH/qmRa+mVujQIhBRg (button) folded on the Turn
Seat 3: +xW7QemQU0Fxs+4TnqBRow (small blind) folded before Flop
Seat 4: +uSzP8Jwnw7sKfQ4s66b7w (big blind) collected ($4.30)
Seat 5: lsLuWlcPA3Rh7kJVLzMh0Q folded before Flop (didn't bet)
Seat 6: PxqfkAMdAWtkgbT+q2gciA folded before Flop (didn't bet)



PokerStars Game #59941148166:  Hold'em No Limit ($0.50/$1.00) - 2009/07/01 1:27:01 ET
Table 'GPp0HyAuggN8oE0sUWzPpA' 9-max Seat #9 is the button
Seat 2: m3U8I35Pn3gxKhoS2nmYIg ($27.25 in chips)
Seat 3: CCCXsirC+bO7ginAuUUVlQ ($53.10 in chips)
Seat 4: mBRWbnUl8diyBO1qTJaNzw ($100.15 in chips)
Seat 5: bLbSOSmSOnqE0iTcH/5dxA ($100 in chips)
Seat 6: BK/GtNPkSx0TdUDj82id5A ($37.40 in chips)
Seat 7: DHdbHyysD15wCAtx+BhUjA ($93.20 in chips)
Seat 8: P/6qLjycEfxRgZ5F/W90dw ($97.35 in chips)
Seat 9: myIxN7otsyr846M539YR8Q ($20 in chips)
m3U8I35Pn3gxKhoS2nmYIg: posts small blind $0.50
CCCXsirC+bO7ginAuUUVlQ: posts big blind $1
*** HOLE CARDS ***
mBRWbnUl8diyBO1qTJaNzw: folds
bLbSOSmSOnqE0iTcH/5dxA: folds
BK/GtNPkSx0TdUDj82id5A: folds
DHdbHyysD15wCAtx+BhUjA: folds
P/6qLjycEfxRgZ5F/W90dw: folds
myIxN7otsyr846M539YR8Q: folds
m3U8I35Pn3gxKhoS2nmYIg: folds
CCCXsirC+bO7ginAuUUVlQ collected $1 from pot
*** SUMMARY ***
Total pot $1 | Rake $0
Seat 2: m3U8I35Pn3gxKhoS2nmYIg (small blind) folded before Flop
Seat 3: CCCXsirC+bO7ginAuUUVlQ (big blind) collected ($1)
Seat 4: mBRWbnUl8diyBO1qTJaNzw folded before Flop (didn't bet)
Seat 5: bLbSOSmSOnqE0iTcH/5dxA folded before Flop (didn't bet)
Seat 6: BK/GtNPkSx0TdUDj82id5A folded before Flop (didn't bet)
Seat 7: DHdbHyysD15wCAtx+BhUjA folded before Flop (didn't bet)
Seat 8: P/6qLjycEfxRgZ5F/W90dw folded before Flop (didn't bet)
Seat 9: myIxN7otsyr846M539YR8Q (button) folded before Flop (didn't bet)



PokerStars Game #59941148800:  Hold'em No Limit ($0.50/$1.00) - 2009/07/01 1:27:02 ET
Table 'MUPc8FEpe/nR0BKSeReX6Q' 6-max Seat #1 is the button
Seat 1: qhkK6+yCciTRd+rCFEbnEQ ($81.70 in chips)
Seat 2: xAU6q2/cwmby2sxmA8VcmA ($105.70 in chips)
Seat 3: wx3sQGkVi2x9wJXuWNHPBw ($287.50 in chips)
Seat 5: y27w5IK2WXqmYzS8OU0wKA ($104.05 in chips)
Seat 6: oxnw0GLLpFanjhGkxfRSqA ($132.65 in chips)
xAU6q2/cwmby2sxmA8VcmA: posts small blind $0.50
wx3sQGkVi2x9wJXuWNHPBw: posts big blind $1
*** HOLE CARDS ***
oxnw0GLLpFanjhGkxfRSqA said, "lol"
oxnw0GLLpFanjhGkxfRSqA said, "told u"
kalikay99 has returned
kalikay99 leaves the table
oxnw0GLLpFanjhGkxfRSqA said, "i was gonna bury you"
y27w5IK2WXqmYzS8OU0wKA: folds
r4lpoh2BJZ8S6zyQv1JeSw joins the table at seat #4
oxnw0GLLpFanjhGkxfRSqA: folds
qhkK6+yCciTRd+rCFEbnEQ: raises $3 to $4
xAU6q2/cwmby2sxmA8VcmA: folds
wx3sQGkVi2x9wJXuWNHPBw: folds
qhkK6+yCciTRd+rCFEbnEQ collected $2.50 from pot
qhkK6+yCciTRd+rCFEbnEQ: doesn't show hand
*** SUMMARY ***
Total pot $2.50 | Rake $0
Seat 1: qhkK6+yCciTRd+rCFEbnEQ (button) collected ($2.50)
Seat 2: xAU6q2/cwmby2sxmA8VcmA (small blind) folded before Flop
Seat 3: wx3sQGkVi2x9wJXuWNHPBw (big blind) folded before Flop
Seat 5: y27w5IK2WXqmYzS8OU0wKA folded before Flop (didn't bet)
Seat 6: oxnw0GLLpFanjhGkxfRSqA folded before Flop (didn't bet)



PokerStars Game #59941148946:  Hold'em No Limit ($0.50/$1.00) - 2009/07/01 1:27:02 ET
Table '305hiksPPCCdC6V2LNsO5w' 6-max Seat #5 is the button
Seat 1: RTuDLJHh/9zPfBftoc9vsw ($12.50 in chips)
Seat 2: j7NIOHLZk7V2o9fOioO5ug ($127.85 in chips)
Seat 3: +zIVjZKLpcidfRHgVZW8lA ($35.20 in chips)
Seat 4: uJVSceLggtsrJya+WtmUEA ($214.55 in chips)
Seat 5: +Nt3OPk3XR9SKjZgm2CexQ ($112.65 in chips)
Seat 6: 9/Tq8dw7kWW68uN8bFupXg ($15.40 in chips)
9/Tq8dw7kWW68uN8bFupXg: posts small blind $0.50
RTuDLJHh/9zPfBftoc9vsw: posts big blind $1
*** HOLE CARDS ***
j7NIOHLZk7V2o9fOioO5ug: raises $2 to $3
+zIVjZKLpcidfRHgVZW8lA: calls $3
uJVSceLggtsrJya+WtmUEA: folds
+Nt3OPk3XR9SKjZgm2CexQ: folds
9/Tq8dw7kWW68uN8bFupXg: folds
RTuDLJHh/9zPfBftoc9vsw: folds
*** FLOP *** [9s 7d 5d]
j7NIOHLZk7V2o9fOioO5ug: bets $6
+zIVjZKLpcidfRHgVZW8lA: folds
j7NIOHLZk7V2o9fOioO5ug collected $7.15 from pot
*** SUMMARY ***
Total pot $7.50 | Rake $0.35
Board [9s 7d 5d]
Seat 1: RTuDLJHh/9zPfBftoc9vsw (big blind) folded before Flop
Seat 2: j7NIOHLZk7V2o9fOioO5ug collected ($7.15)
Seat 3: +zIVjZKLpcidfRHgVZW8lA folded on the Flop
Seat 4: uJVSceLggtsrJya+WtmUEA folded before Flop (didn't bet)
Seat 5: +Nt3OPk3XR9SKjZgm2CexQ (button) folded before Flop (didn't bet)
Seat 6: 9/Tq8dw7kWW68uN8bFupXg (small blind) folded before Flop



PokerStars Game #59941149818:  Hold'em No Limit ($0.50/$1.00) - 2009/07/01 1:27:04 ET
Table '7O9fB8yx1u7sJveJn8w6jA' 6-max Seat #6 is the button
Seat 1: jy52+7FotjH63o5tEEVgKw ($80.25 in chips)
Seat 2: wx3sQGkVi2x9wJXuWNHPBw ($196.20 in chips)
Seat 3: hpxXcmRkXXI9HE5+5/j/0Q ($121.25 in chips)
Seat 4: b2a+5TkFf4xJN/Ihhma58Q ($39.55 in chips)
Seat 5: BCEV3COoKY607AzLWayfRA ($100 in chips)
Seat 6: 6hLdALbOlkzGIrc53QKtPw ($20 in chips)
jy52+7FotjH63o5tEEVgKw: posts small blind $0.50
wx3sQGkVi2x9wJXuWNHPBw: posts big blind $1
*** HOLE CARDS ***
hpxXcmRkXXI9HE5+5/j/0Q: folds
b2a+5TkFf4xJN/Ihhma58Q: raises $1 to $2
BCEV3COoKY607AzLWayfRA: folds
6hLdALbOlkzGIrc53QKtPw: folds
jy52+7FotjH63o5tEEVgKw: calls $1.50
wx3sQGkVi2x9wJXuWNHPBw: calls $1
*** FLOP *** [Ad 9s Kd]
jy52+7FotjH63o5tEEVgKw: checks
wx3sQGkVi2x9wJXuWNHPBw: checks
b2a+5TkFf4xJN/Ihhma58Q: checks
*** TURN *** [Ad 9s Kd] [5s]
jy52+7FotjH63o5tEEVgKw: bets $4
wx3sQGkVi2x9wJXuWNHPBw: folds
6hLdALbOlkzGIrc53QKtPw leaves the table
b2a+5TkFf4xJN/Ihhma58Q: calls $4
*** RIVER *** [Ad 9s Kd 5s] [Ts]
jy52+7FotjH63o5tEEVgKw: bets $12
r4lpoh2BJZ8S6zyQv1JeSw joins the table at seat #6
b2a+5TkFf4xJN/Ihhma58Q: folds
jy52+7FotjH63o5tEEVgKw collected $13.35 from pot
jy52+7FotjH63o5tEEVgKw: doesn't show hand
*** SUMMARY ***
Total pot $14 | Rake $0.65
Board [Ad 9s Kd 5s Ts]
Seat 1: jy52+7FotjH63o5tEEVgKw (small blind) collected ($13.35)
Seat 2: wx3sQGkVi2x9wJXuWNHPBw (big blind) folded on the Turn
Seat 3: hpxXcmRkXXI9HE5+5/j/0Q folded before Flop (didn't bet)
Seat 4: b2a+5TkFf4xJN/Ihhma58Q folded on the River
Seat 5: BCEV3COoKY607AzLWayfRA folded before Flop (didn't bet)
Seat 6: 6hLdALbOlkzGIrc53QKtPw (button) folded before Flop (didn't bet)



PokerStars Game #59941149656:  Hold'em No Limit ($0.50/$1.00) - 2009/07/01 1:27:04 ET
Table 'N6LvHFrb+cdXY/COI6ByOw' 2-max Seat #2 is the button
Seat 1: lXX4W7m3u++JiSOZ46yVMQ ($110.40 in chips)
Seat 2: 9mAoSP3o/mikSZOW2LEEAw ($89 in chips)
9mAoSP3o/mikSZOW2LEEAw: posts small blind $0.50
lXX4W7m3u++JiSOZ46yVMQ: posts big blind $1
*** HOLE CARDS ***
9mAoSP3o/mikSZOW2LEEAw: raises $1 to $2
lXX4W7m3u++JiSOZ46yVMQ: calls $1
*** FLOP *** [6c 2c 9c]
lXX4W7m3u++JiSOZ46yVMQ: bets $1
9mAoSP3o/mikSZOW2LEEAw: calls $1
*** TURN *** [6c 2c 9c] [Qh]
lXX4W7m3u++JiSOZ46yVMQ: bets $3
9mAoSP3o/mikSZOW2LEEAw: calls $3
*** RIVER *** [6c 2c 9c Qh] [As]
lXX4W7m3u++JiSOZ46yVMQ: bets $11
9mAoSP3o/mikSZOW2LEEAw: folds
lXX4W7m3u++JiSOZ46yVMQ collected $11.50 from pot
*** SUMMARY ***
Total pot $12 | Rake $0.50
Board [6c 2c 9c Qh As]
Seat 1: lXX4W7m3u++JiSOZ46yVMQ (big blind) collected ($11.50)
Seat 2: 9mAoSP3o/mikSZOW2LEEAw (button) (small blind) folded on the River



PokerStars Game #59941152242:  Hold'em No Limit ($0.50/$1.00) - 2009/07/01 1:27:08 ET
Table 'MNvFfRVQNka/oY+Z5aMbZQ' 2-max Seat #2 is the button
Seat 1: DaZnoWHjO897dnh0CL2lVg ($70.60 in chips)
Seat 2: mgi+mjKb1Sc3CCs7TlfoCw ($90.05 in chips)
mgi+mjKb1Sc3CCs7TlfoCw: posts small blind $0.50
DaZnoWHjO897dnh0CL2lVg: posts big blind $1
*** HOLE CARDS ***
mgi+mjKb1Sc3CCs7TlfoCw: folds
DaZnoWHjO897dnh0CL2lVg collected $1 from pot
DaZnoWHjO897dnh0CL2lVg: doesn't show hand
*** SUMMARY ***
Total pot $1 | Rake $0
Seat 1: DaZnoWHjO897dnh0CL2lVg (big blind) collected ($1)
Seat 2: mgi+mjKb1Sc3CCs7TlfoCw (button) (small blind) folded before Flop



PokerStars Game #59941154584:  Hold'em No Limit ($0.50/$1.00) - 2009/07/01 1:27:12 ET
Table 'W/wyObTiXZm+Ckkl3YxcSw' 6-max Seat #5 is the button
Seat 1: eUBBn2R56C1IQ6Cs/vitwg ($293.55 in chips)
Seat 2: oDiBRCaF0QVtd3kO6xZIXw ($152.05 in chips)
Seat 3: dxyNCn/qxfkGDUIf28Cbng ($63.80 in chips)
Seat 4: UBZQqpnJZdTYYY1FTb0rLA ($103.20 in chips)
Seat 5: +OrCjyw70oZhJiD22Mn+bg ($100 in chips)
Seat 6: b2a+5TkFf4xJN/Ihhma58Q ($45.95 in chips)
b2a+5TkFf4xJN/Ihhma58Q: posts small blind $0.50
eUBBn2R56C1IQ6Cs/vitwg: posts big blind $1
*** HOLE CARDS ***
oDiBRCaF0QVtd3kO6xZIXw: raises $2 to $3
dxyNCn/qxfkGDUIf28Cbng: folds
UBZQqpnJZdTYYY1FTb0rLA: folds
+OrCjyw70oZhJiD22Mn+bg: folds
b2a+5TkFf4xJN/Ihhma58Q: calls $2.50
eUBBn2R56C1IQ6Cs/vitwg: folds
*** FLOP *** [Td Th 6c]
b2a+5TkFf4xJN/Ihhma58Q: checks
oDiBRCaF0QVtd3kO6xZIXw: checks
*** TURN *** [Td Th 6c] [2s]
b2a+5TkFf4xJN/Ihhma58Q: checks
oDiBRCaF0QVtd3kO6xZIXw: bets $5
b2a+5TkFf4xJN/Ihhma58Q: calls $5
*** RIVER *** [Td Th 6c 2s] [8c]
b2a+5TkFf4xJN/Ihhma58Q: checks
oDiBRCaF0QVtd3kO6xZIXw: bets $10
b2a+5TkFf4xJN/Ihhma58Q: folds
oDiBRCaF0QVtd3kO6xZIXw collected $16.20 from pot
oDiBRCaF0QVtd3kO6xZIXw: doesn't show hand
*** SUMMARY ***
Total pot $17 | Rake $0.80
Board [Td Th 6c 2s 8c]
Seat 1: eUBBn2R56C1IQ6Cs/vitwg (big blind) folded before Flop
Seat 2: oDiBRCaF0QVtd3kO6xZIXw collected ($16.20)
Seat 3: dxyNCn/qxfkGDUIf28Cbng folded before Flop (didn't bet)
Seat 4: UBZQqpnJZdTYYY1FTb0rLA folded before Flop (didn't bet)
Seat 5: +OrCjyw70oZhJiD22Mn+bg (button) folded before Flop (didn't bet)
Seat 6: b2a+5TkFf4xJN/Ihhma58Q (small blind) folded on the River



PokerStars Game #59941155004:  Hold'em No Limit ($0.50/$1.00) - 2009/07/01 1:27:13 ET
Table 'vs/5jr6ciwjVQ5+Soc+u2A' 6-max Seat #2 is the button
Seat 1: J798qwLuvXyq0BbzsIjOrA ($165.95 in chips)
Seat 2: lXX4W7m3u++JiSOZ46yVMQ ($100.65 in chips)
Seat 3: G5ZSSN6RSON3gkNvk/SmYg ($123.60 in chips)
Seat 4: wk6Ohn4GDozoOMHc4eb2rw ($55.30 in chips)
Seat 5: +Nt3OPk3XR9SKjZgm2CexQ ($155.50 in chips)
Seat 6: Z2fXsGcjl+Eax+RzOgwOmg ($104.50 in chips)
G5ZSSN6RSON3gkNvk/SmYg: posts small blind $0.50
wk6Ohn4GDozoOMHc4eb2rw: posts big blind $1
*** HOLE CARDS ***
+Nt3OPk3XR9SKjZgm2CexQ: folds
Z2fXsGcjl+Eax+RzOgwOmg: raises $3 to $4
J798qwLuvXyq0BbzsIjOrA: folds
lXX4W7m3u++JiSOZ46yVMQ: folds
G5ZSSN6RSON3gkNvk/SmYg: folds
wk6Ohn4GDozoOMHc4eb2rw: folds
Z2fXsGcjl+Eax+RzOgwOmg collected $2.50 from pot
Z2fXsGcjl+Eax+RzOgwOmg: doesn't show hand
*** SUMMARY ***
Total pot $2.50 | Rake $0
Seat 1: J798qwLuvXyq0BbzsIjOrA folded before Flop (didn't bet)
Seat 2: lXX4W7m3u++JiSOZ46yVMQ (button) folded before Flop (didn't bet)
Seat 3: G5ZSSN6RSON3gkNvk/SmYg (small blind) folded before Flop
Seat 4: wk6Ohn4GDozoOMHc4eb2rw (big blind) folded before Flop
Seat 5: +Nt3OPk3XR9SKjZgm2CexQ folded before Flop (didn't bet)
Seat 6: Z2fXsGcjl+Eax+RzOgwOmg collected ($2.50)



PokerStars Game #59941154974:  Hold'em No Limit ($0.50/$1.00) - 2009/07/01 1:27:13 ET
Table 'Evb7VW0qfDhFkbgBL3gcqQ' 2-max Seat #2 is the button
Seat 1: NYi6JFscYNrofSXy4sM+Yw ($156.85 in chips)
Seat 2: AoEQlM/FNYM0d7Txn1TfBQ ($47.15 in chips)
AoEQlM/FNYM0d7Txn1TfBQ: posts small blind $0.50
NYi6JFscYNrofSXy4sM+Yw: posts big blind $1
*** HOLE CARDS ***
AoEQlM/FNYM0d7Txn1TfBQ: folds
NYi6JFscYNrofSXy4sM+Yw collected $1 from pot
*** SUMMARY ***
Total pot $1 | Rake $0
Seat 1: NYi6JFscYNrofSXy4sM+Yw (big blind) collected ($1)
Seat 2: AoEQlM/FNYM0d7Txn1TfBQ (button) (small blind) folded before Flop



PokerStars Game #59941155330:  Hold'em No Limit ($0.50/$1.00) - 2009/07/01 1:27:13 ET
Table 'kS0cTQAEi+fdUlJP2gQYvw' 9-max Seat #3 is the button
Seat 2: D+W9Me7w6Hcx/WRUSKV0dw ($25.05 in chips)
Seat 3: 2BV+oJIQYr65IO6nEChvbA ($67 in chips)
Seat 4: RUhhaALzha3TH1AkdakoGQ ($53 in chips)
Seat 5: 997ViqAtWn1FPjJqcffwcA ($100 in chips)
Seat 6: yAbu2QsRPVcjPbqlf/jDxw ($126.15 in chips)
Seat 7: Ffa7Nj4X5fddtROP01hfQg ($154.60 in chips)
Seat 8: vKyFzTyzfT7fZcdX+HHN+Q ($29.50 in chips)
Seat 9: OGgaARGdJQT4awWVNQ957w ($100 in chips)
RUhhaALzha3TH1AkdakoGQ: posts small blind $0.50
997ViqAtWn1FPjJqcffwcA: posts big blind $1
*** HOLE CARDS ***
yAbu2QsRPVcjPbqlf/jDxw: folds
Ffa7Nj4X5fddtROP01hfQg: calls $1
vKyFzTyzfT7fZcdX+HHN+Q: raises $1 to $2
OGgaARGdJQT4awWVNQ957w: folds
D+W9Me7w6Hcx/WRUSKV0dw: folds
2BV+oJIQYr65IO6nEChvbA: folds
RUhhaALzha3TH1AkdakoGQ: folds
997ViqAtWn1FPjJqcffwcA: folds
Ffa7Nj4X5fddtROP01hfQg: calls $1
*** FLOP *** [Kc 2c 9c]
Ffa7Nj4X5fddtROP01hfQg: bets $2
vKyFzTyzfT7fZcdX+HHN+Q: raises $6 to $8
Ffa7Nj4X5fddtROP01hfQg: folds
vKyFzTyzfT7fZcdX+HHN+Q collected $9.05 from pot
*** SUMMARY ***
Total pot $9.50 | Rake $0.45
Board [Kc 2c 9c]
Seat 2: D+W9Me7w6Hcx/WRUSKV0dw folded before Flop (didn't bet)
Seat 3: 2BV+oJIQYr65IO6nEChvbA (button) folded before Flop (didn't bet)
Seat 4: RUhhaALzha3TH1AkdakoGQ (small blind) folded before Flop
Seat 5: 997ViqAtWn1FPjJqcffwcA (big blind) folded before Flop
Seat 6: yAbu2QsRPVcjPbqlf/jDxw folded before Flop (didn't bet)
Seat 7: Ffa7Nj4X5fddtROP01hfQg folded on the Flop
Seat 8: vKyFzTyzfT7fZcdX+HHN+Q collected ($9.05)
Seat 9: OGgaARGdJQT4awWVNQ957w folded before Flop (didn't bet)



PokerStars Game #59941156102:  Hold'em No Limit ($0.50/$1.00) - 2009/07/01 1:27:14 ET
Table 'MNvFfRVQNka/oY+Z5aMbZQ' 2-max Seat #1 is the button
Seat 1: DaZnoWHjO897dnh0CL2lVg ($71.10 in chips)
Seat 2: mgi+mjKb1Sc3CCs7TlfoCw ($89.55 in chips)
DaZnoWHjO897dnh0CL2lVg: posts small blind $0.50
mgi+mjKb1Sc3CCs7TlfoCw: posts big blind $1
*** HOLE CARDS ***
DaZnoWHjO897dnh0CL2lVg: calls $0.50
mgi+mjKb1Sc3CCs7TlfoCw: checks
*** FLOP *** [Js 8c Kh]
mgi+mjKb1Sc3CCs7TlfoCw: checks
DaZnoWHjO897dnh0CL2lVg: bets $2
mgi+mjKb1Sc3CCs7TlfoCw: calls $2
*** TURN *** [Js 8c Kh] [6c]
mgi+mjKb1Sc3CCs7TlfoCw: bets $7
DaZnoWHjO897dnh0CL2lVg: calls $7
*** RIVER *** [Js 8c Kh 6c] [3c]
mgi+mjKb1Sc3CCs7TlfoCw: checks
DaZnoWHjO897dnh0CL2lVg: checks
*** SHOW DOWN ***
mgi+mjKb1Sc3CCs7TlfoCw: shows [7h 9s] (high card King)
DaZnoWHjO897dnh0CL2lVg: shows [6h 8h] (two pair, Eights and Sixes)
DaZnoWHjO897dnh0CL2lVg collected $19.50 from pot
*** SUMMARY ***
Total pot $20 | Rake $0.50
Board [Js 8c Kh 6c 3c]
Seat 1: DaZnoWHjO897dnh0CL2lVg (button) (small blind) showed [6h 8h] and won ($19.50) with two pair, Eights and Sixes
Seat 2: mgi+mjKb1Sc3CCs7TlfoCw (big blind) showed [7h 9s] and lost with high card King



PokerStars Game #59941155718:  Hold'em No Limit ($0.50/$1.00) - 2009/07/01 1:27:14 ET
Table 'jDQgUn1zGkyftPnHo0Awdw' 2-max Seat #1 is the button
Seat 1: a42+e5QB6s1kkG5FoSTZJw ($111.65 in chips)
Seat 2: q+vRKwm51mnr6kxX/161WQ ($83.90 in chips)
a42+e5QB6s1kkG5FoSTZJw: posts small blind $0.50
q+vRKwm51mnr6kxX/161WQ: posts big blind $1
*** HOLE CARDS ***
a42+e5QB6s1kkG5FoSTZJw: folds
q+vRKwm51mnr6kxX/161WQ collected $1 from pot
q+vRKwm51mnr6kxX/161WQ: doesn't show hand
*** SUMMARY ***
Total pot $1 | Rake $0
Seat 1: a42+e5QB6s1kkG5FoSTZJw (button) (small blind) folded before Flop
Seat 2: q+vRKwm51mnr6kxX/161WQ (big blind) collected ($1)



PokerStars Game #59941156320:  Hold'em No Limit ($0.50/$1.00) - 2009/07/01 1:27:15 ET
Table 'TvsifD4n+q//fIZ4fM1xxQ' 2-max Seat #1 is the button
Seat 1: NYi6JFscYNrofSXy4sM+Yw ($166.05 in chips)
Seat 2: +W/hy0gBp0sJy8pjLz6Yrg ($105.10 in chips)
NYi6JFscYNrofSXy4sM+Yw: posts small blind $0.50
+W/hy0gBp0sJy8pjLz6Yrg: posts big blind $1
*** HOLE CARDS ***
NYi6JFscYNrofSXy4sM+Yw: raises $2 to $3
+W/hy0gBp0sJy8pjLz6Yrg: calls $2
*** FLOP *** [Ad 9c Js]
+W/hy0gBp0sJy8pjLz6Yrg: checks
NYi6JFscYNrofSXy4sM+Yw: bets $3
+W/hy0gBp0sJy8pjLz6Yrg: calls $3
*** TURN *** [Ad 9c Js] [6h]
+W/hy0gBp0sJy8pjLz6Yrg: checks
NYi6JFscYNrofSXy4sM+Yw: bets $8.50
+W/hy0gBp0sJy8pjLz6Yrg: folds
NYi6JFscYNrofSXy4sM+Yw collected $11.50 from pot
*** SUMMARY ***
Total pot $12 | Rake $0.50
Board [Ad 9c Js 6h]
Seat 1: NYi6JFscYNrofSXy4sM+Yw (button) (small blind) collected ($11.50)
Seat 2: +W/hy0gBp0sJy8pjLz6Yrg (big blind) folded on the Turn



PokerStars Game #59941157352:  Hold'em No Limit ($0.50/$1.00) - 2009/07/01 1:27:17 ET
Table 'gxFK0BVUD7cupu2uyRUZJg' 6-max Seat #5 is the button
Seat 1: M+X3uChmP6R63IwijVjgTg ($162.75 in chips)
Seat 2: hpxXcmRkXXI9HE5+5/j/0Q ($136.05 in chips)
Seat 3: Z2fXsGcjl+Eax+RzOgwOmg ($120.50 in chips)
Seat 5: WgIrs6CBinyyw18pqdDtWA ($19.70 in chips)
Seat 6: dYyb6/42PMC8aNFlm/eBeQ ($103.50 in chips)
dYyb6/42PMC8aNFlm/eBeQ: posts small blind $0.50
M+X3uChmP6R63IwijVjgTg: posts big blind $1
JwCcjZl0bjJzG7hmE0dnTA: sits out
*** HOLE CARDS ***
hpxXcmRkXXI9HE5+5/j/0Q: folds
Z2fXsGcjl+Eax+RzOgwOmg: raises $3 to $4
WgIrs6CBinyyw18pqdDtWA: folds
dYyb6/42PMC8aNFlm/eBeQ: folds
M+X3uChmP6R63IwijVjgTg: folds
Z2fXsGcjl+Eax+RzOgwOmg collected $2.50 from pot
Z2fXsGcjl+Eax+RzOgwOmg: doesn't show hand
*** SUMMARY ***
Total pot $2.50 | Rake $0
Seat 1: M+X3uChmP6R63IwijVjgTg (big blind) folded before Flop
Seat 2: hpxXcmRkXXI9HE5+5/j/0Q folded before Flop (didn't bet)
Seat 3: Z2fXsGcjl+Eax+RzOgwOmg collected ($2.50)
Seat 5: WgIrs6CBinyyw18pqdDtWA (button) folded before Flop (didn't bet)
Seat 6: dYyb6/42PMC8aNFlm/eBeQ (small blind) folded before Flop



PokerStars Game #59941158002:  Hold'em No Limit ($0.50/$1.00) - 2009/07/01 1:27:18 ET
Table '/FUb199IViHMJHi5YWmeuQ' 9-max Seat #4 is the button
Seat 1: 3obndzTJ6fECz8+wWhMd1w ($18.50 in chips)
Seat 2: FL3MrLspcF23LYvC4ipBOA ($185.55 in chips)
Seat 3: V138SURkdX8LdVBPKdJJag ($125.25 in chips)
Seat 4: pbAfmxe4uSZPxJQX7gOzZA ($73.20 in chips)
Seat 5: H+DVy3Ei8L1UKS2tVOtJcw ($137.85 in chips)
Seat 6: VPF+HjszMvUIpy0CHIwH3A ($20 in chips)
Seat 8: 997ViqAtWn1FPjJqcffwcA ($100 in chips)
Seat 9: RfLbneGRY8yQUpMgDnJCxA ($70.85 in chips)
H+DVy3Ei8L1UKS2tVOtJcw: posts small blind $0.50
VPF+HjszMvUIpy0CHIwH3A: posts big blind $1
myIxN7otsyr846M539YR8Q: sits out
*** HOLE CARDS ***
997ViqAtWn1FPjJqcffwcA: folds
RfLbneGRY8yQUpMgDnJCxA: folds
3obndzTJ6fECz8+wWhMd1w: folds
FL3MrLspcF23LYvC4ipBOA: folds
V138SURkdX8LdVBPKdJJag: folds
pbAfmxe4uSZPxJQX7gOzZA: calls $1
H+DVy3Ei8L1UKS2tVOtJcw: calls $0.50
VPF+HjszMvUIpy0CHIwH3A: raises $19 to $20 and is all-in
pbAfmxe4uSZPxJQX7gOzZA: folds
H+DVy3Ei8L1UKS2tVOtJcw: folds
VPF+HjszMvUIpy0CHIwH3A collected $3 from pot
VPF+HjszMvUIpy0CHIwH3A: doesn't show hand
*** SUMMARY ***
Total pot $3 | Rake $0
Seat 1: 3obndzTJ6fECz8+wWhMd1w folded before Flop (didn't bet)
Seat 2: FL3MrLspcF23LYvC4ipBOA folded before Flop (didn't bet)
Seat 3: V138SURkdX8LdVBPKdJJag folded before Flop (didn't bet)
Seat 4: pbAfmxe4uSZPxJQX7gOzZA (button) folded before Flop
Seat 5: H+DVy3Ei8L1UKS2tVOtJcw (small blind) folded before Flop
Seat 6: VPF+HjszMvUIpy0CHIwH3A (big blind) collected ($3)
Seat 8: 997ViqAtWn1FPjJqcffwcA folded before Flop (didn't bet)
Seat 9: RfLbneGRY8yQUpMgDnJCxA folded before Flop (didn't bet)



PokerStars Game #59941158444:  Hold'em No Limit ($0.50/$1.00) - 2009/07/01 1:27:19 ET
Table 'Evb7VW0qfDhFkbgBL3gcqQ' 2-max Seat #1 is the button
Seat 1: NYi6JFscYNrofSXy4sM+Yw ($157.35 in chips)
Seat 2: AoEQlM/FNYM0d7Txn1TfBQ ($46.65 in chips)
NYi6JFscYNrofSXy4sM+Yw: posts small blind $0.50
AoEQlM/FNYM0d7Txn1TfBQ: posts big blind $1
*** HOLE CARDS ***
NYi6JFscYNrofSXy4sM+Yw: folds
AoEQlM/FNYM0d7Txn1TfBQ collected $1 from pot
*** SUMMARY ***
Total pot $1 | Rake $0
Seat 1: NYi6JFscYNrofSXy4sM+Yw (button) (small blind) folded before Flop
Seat 2: AoEQlM/FNYM0d7Txn1TfBQ (big blind) collected ($1)



PokerStars Game #59941159804:  Hold'em No Limit ($0.50/$1.00) - 2009/07/01 1:27:21 ET
Table 'cBDNutyLBKEk9+ptwsKmTw' 6-max Seat #4 is the button
Seat 1: xAU6q2/cwmby2sxmA8VcmA ($299.05 in chips)
Seat 2: 4OO5v3AVduL0tePNx8wk5A ($101.50 in chips)
Seat 3: G5ZSSN6RSON3gkNvk/SmYg ($108.90 in chips)
Seat 4: OMkHNxIUZxh1pHqcCjbjgw ($98.50 in chips)
Seat 5: hpxXcmRkXXI9HE5+5/j/0Q ($102 in chips)
Seat 6: QHvTZcrKe6+maWUfVjP29Q ($151.50 in chips)
hpxXcmRkXXI9HE5+5/j/0Q: posts small blind $0.50
QHvTZcrKe6+maWUfVjP29Q: posts big blind $1
*** HOLE CARDS ***
xAU6q2/cwmby2sxmA8VcmA: folds
4OO5v3AVduL0tePNx8wk5A: folds
G5ZSSN6RSON3gkNvk/SmYg: folds
OMkHNxIUZxh1pHqcCjbjgw: folds
hpxXcmRkXXI9HE5+5/j/0Q: raises $3 to $4
QHvTZcrKe6+maWUfVjP29Q: folds
hpxXcmRkXXI9HE5+5/j/0Q collected $2 from pot
hpxXcmRkXXI9HE5+5/j/0Q: doesn't show hand
*** SUMMARY ***
Total pot $2 | Rake $0
Seat 1: xAU6q2/cwmby2sxmA8VcmA folded before Flop (didn't bet)
Seat 2: 4OO5v3AVduL0tePNx8wk5A folded before Flop (didn't bet)
Seat 3: G5ZSSN6RSON3gkNvk/SmYg folded before Flop (didn't bet)
Seat 4: OMkHNxIUZxh1pHqcCjbjgw (button) folded before Flop (didn't bet)
Seat 5: hpxXcmRkXXI9HE5+5/j/0Q (small blind) collected ($2)
Seat 6: QHvTZcrKe6+maWUfVjP29Q (big blind) folded before Flop



PokerStars Game #59941161598:  Hold'em No Limit ($0.50/$1.00) - 2009/07/01 1:27:24 ET
Table 'GPp0HyAuggN8oE0sUWzPpA' 9-max Seat #2 is the button
Seat 2: m3U8I35Pn3gxKhoS2nmYIg ($26.75 in chips)
Seat 3: CCCXsirC+bO7ginAuUUVlQ ($53.60 in chips)
Seat 4: mBRWbnUl8diyBO1qTJaNzw ($100.15 in chips)
Seat 5: bLbSOSmSOnqE0iTcH/5dxA ($100 in chips)
Seat 6: BK/GtNPkSx0TdUDj82id5A ($37.40 in chips)
Seat 7: DHdbHyysD15wCAtx+BhUjA ($93.20 in chips)
Seat 8: P/6qLjycEfxRgZ5F/W90dw ($97.35 in chips)
Seat 9: myIxN7otsyr846M539YR8Q ($20 in chips)
CCCXsirC+bO7ginAuUUVlQ: posts small blind $0.50
mBRWbnUl8diyBO1qTJaNzw: posts big blind $1
*** HOLE CARDS ***
bLbSOSmSOnqE0iTcH/5dxA: folds
BK/GtNPkSx0TdUDj82id5A: folds
DHdbHyysD15wCAtx+BhUjA: folds
P/6qLjycEfxRgZ5F/W90dw: folds
laA8va+Yv8WuMqT1zdR91g joins the table at seat #1
myIxN7otsyr846M539YR8Q: raises $19 to $20 and is all-in
m3U8I35Pn3gxKhoS2nmYIg: folds
CCCXsirC+bO7ginAuUUVlQ: folds
mBRWbnUl8diyBO1qTJaNzw: folds
myIxN7otsyr846M539YR8Q collected $2.50 from pot
*** SUMMARY ***
Total pot $2.50 | Rake $0
Seat 2: m3U8I35Pn3gxKhoS2nmYIg (button) folded before Flop (didn't bet)
Seat 3: CCCXsirC+bO7ginAuUUVlQ (small blind) folded before Flop
Seat 4: mBRWbnUl8diyBO1qTJaNzw (big blind) folded before Flop
Seat 5: bLbSOSmSOnqE0iTcH/5dxA folded before Flop (didn't bet)
Seat 6: BK/GtNPkSx0TdUDj82id5A folded before Flop (didn't bet)
Seat 7: DHdbHyysD15wCAtx+BhUjA folded before Flop (didn't bet)
Seat 8: P/6qLjycEfxRgZ5F/W90dw folded before Flop (didn't bet)
Seat 9: myIxN7otsyr846M539YR8Q collected ($2.50)



PokerStars Game #59941162398:  Hold'em No Limit ($0.50/$1.00) - 2009/07/01 1:27:25 ET
Table 'hugOjcwJvzEwZbK7tyiWuQ' 9-max Seat #6 is the button
Seat 1: S3Ex8K7v6xm5jqjRM7Fl3w ($20 in chips)
Seat 2: r27C1nIV4NS4+qbnrgBQSw ($273.70 in chips)
Seat 4: UWB3oeddt/GObx2Mix2Anw ($183.10 in chips)
Seat 5: AexZ4puUV9meFWwVU6Nv0w ($20 in chips)
Seat 6: gUUvmqdVlmvpal6B8nYrmg ($105.45 in chips)
Seat 7: FL3MrLspcF23LYvC4ipBOA ($116.30 in chips)
Seat 8: /zy+DB4S5fUQUSfZWFzYGw ($119.85 in chips)
Seat 9: W8P9bUKCs43TO1xHm0dL6w ($113.80 in chips)
FL3MrLspcF23LYvC4ipBOA: posts small blind $0.50
/zy+DB4S5fUQUSfZWFzYGw: posts big blind $1
AexZ4puUV9meFWwVU6Nv0w: posts big blind $1
*** HOLE CARDS ***
W8P9bUKCs43TO1xHm0dL6w: folds
S3Ex8K7v6xm5jqjRM7Fl3w: folds
r27C1nIV4NS4+qbnrgBQSw: raises $4 to $5
UWB3oeddt/GObx2Mix2Anw: folds
AexZ4puUV9meFWwVU6Nv0w: folds
gUUvmqdVlmvpal6B8nYrmg: folds
FL3MrLspcF23LYvC4ipBOA: calls $4.50
/zy+DB4S5fUQUSfZWFzYGw: folds
*** FLOP *** [8s 3c Tc]
FL3MrLspcF23LYvC4ipBOA: checks
r27C1nIV4NS4+qbnrgBQSw: checks
*** TURN *** [8s 3c Tc] [Ks]
c/6hFCyfLNRn3VFvCeQ1ng joins the table at seat #3
FL3MrLspcF23LYvC4ipBOA: checks
r27C1nIV4NS4+qbnrgBQSw: checks
*** RIVER *** [8s 3c Tc Ks] [4s]
FL3MrLspcF23LYvC4ipBOA: checks
r27C1nIV4NS4+qbnrgBQSw: bets $7
FL3MrLspcF23LYvC4ipBOA: folds
r27C1nIV4NS4+qbnrgBQSw collected $11.40 from pot
*** SUMMARY ***
Total pot $12 | Rake $0.60
Board [8s 3c Tc Ks 4s]
Seat 1: S3Ex8K7v6xm5jqjRM7Fl3w folded before Flop (didn't bet)
Seat 2: r27C1nIV4NS4+qbnrgBQSw collected ($11.40)
Seat 4: UWB3oeddt/GObx2Mix2Anw folded before Flop (didn't bet)
Seat 5: AexZ4puUV9meFWwVU6Nv0w folded before Flop
Seat 6: gUUvmqdVlmvpal6B8nYrmg (button) folded before Flop (didn't bet)
Seat 7: FL3MrLspcF23LYvC4ipBOA (small blind) folded on the River
Seat 8: /zy+DB4S5fUQUSfZWFzYGw (big blind) folded before Flop
Seat 9: W8P9bUKCs43TO1xHm0dL6w folded before Flop (didn't bet)



PokerStars Game #59941161904:  Hold'em No Limit ($0.50/$1.00) - 2009/07/01 1:27:25 ET
Table 'Evb7VW0qfDhFkbgBL3gcqQ' 2-max Seat #2 is the button
Seat 1: NYi6JFscYNrofSXy4sM+Yw ($156.85 in chips)
Seat 2: AoEQlM/FNYM0d7Txn1TfBQ ($47.15 in chips)
AoEQlM/FNYM0d7Txn1TfBQ: posts small blind $0.50
NYi6JFscYNrofSXy4sM+Yw: posts big blind $1
*** HOLE CARDS ***
AoEQlM/FNYM0d7Txn1TfBQ: calls $0.50
NYi6JFscYNrofSXy4sM+Yw: raises $3 to $4
AoEQlM/FNYM0d7Txn1TfBQ: calls $3
*** FLOP *** [2s 7h 5d]
NYi6JFscYNrofSXy4sM+Yw: bets $3
AoEQlM/FNYM0d7Txn1TfBQ: calls $3
*** TURN *** [2s 7h 5d] [7c]
NYi6JFscYNrofSXy4sM+Yw: checks
AoEQlM/FNYM0d7Txn1TfBQ: checks
*** RIVER *** [2s 7h 5d 7c] [7s]
NYi6JFscYNrofSXy4sM+Yw: checks
AoEQlM/FNYM0d7Txn1TfBQ: checks
*** SHOW DOWN ***
NYi6JFscYNrofSXy4sM+Yw: shows [9c Qc] (three of a kind, Sevens)
AoEQlM/FNYM0d7Txn1TfBQ: mucks hand
NYi6JFscYNrofSXy4sM+Yw collected $13.50 from pot
*** SUMMARY ***
Total pot $14 | Rake $0.50
Board [2s 7h 5d 7c 7s]
Seat 1: NYi6JFscYNrofSXy4sM+Yw (big blind) showed [9c Qc] and won ($13.50) with three of a kind, Sevens
Seat 2: AoEQlM/FNYM0d7Txn1TfBQ (button) (small blind) mucked



PokerStars Game #59941165004:  Hold'em No Limit ($0.50/$1.00) - 2009/07/01 1:27:30 ET
Table 'tJq9SfN1ywY0r03VBlWlwQ' 9-max Seat #6 is the button
Seat 1: wZsU+w9r7G66x93UuvBf1Q ($322.80 in chips)
Seat 4: bLbSOSmSOnqE0iTcH/5dxA ($113.65 in chips)
Seat 5: h5ipsNTMyolp7xn/NAvWkA ($129 in chips)
Seat 6: gUUvmqdVlmvpal6B8nYrmg ($100 in chips)
Seat 7: Pp/KTcXkfZKKUHkjyaLTdg ($34.55 in chips)
Seat 8: G4DEhsZFmznGNVpy2SEocA ($22.25 in chips)
Seat 9: XE5QF1y74bpHog9JxWJMWQ ($100 in chips)
Pp/KTcXkfZKKUHkjyaLTdg: posts small blind $0.50
G4DEhsZFmznGNVpy2SEocA: posts big blind $1
VPF+HjszMvUIpy0CHIwH3A: sits out
*** HOLE CARDS ***
XE5QF1y74bpHog9JxWJMWQ: folds
wZsU+w9r7G66x93UuvBf1Q: raises $3 to $4
bLbSOSmSOnqE0iTcH/5dxA: folds
h5ipsNTMyolp7xn/NAvWkA: folds
gUUvmqdVlmvpal6B8nYrmg: folds
Pp/KTcXkfZKKUHkjyaLTdg: folds
G4DEhsZFmznGNVpy2SEocA: calls $3
*** FLOP *** [Kc Kd 8h]
G4DEhsZFmznGNVpy2SEocA: checks
wZsU+w9r7G66x93UuvBf1Q: checks
*** TURN *** [Kc Kd 8h] [3s]
G4DEhsZFmznGNVpy2SEocA: bets $5
wZsU+w9r7G66x93UuvBf1Q: calls $5
*** RIVER *** [Kc Kd 8h 3s] [Ad]
G4DEhsZFmznGNVpy2SEocA: bets $5
wZsU+w9r7G66x93UuvBf1Q: raises $11 to $16
G4DEhsZFmznGNVpy2SEocA: calls $8.25 and is all-in
*** SHOW DOWN ***
wZsU+w9r7G66x93UuvBf1Q: shows [Ks Ts] (three of a kind, Kings)
G4DEhsZFmznGNVpy2SEocA: shows [As Ah] (a full house, Aces full of Kings)
G4DEhsZFmznGNVpy2SEocA collected $42.80 from pot
*** SUMMARY ***
Total pot $45 | Rake $2.20
Board [Kc Kd 8h 3s Ad]
Seat 1: wZsU+w9r7G66x93UuvBf1Q showed [Ks Ts] and lost with three of a kind, Kings
Seat 4: bLbSOSmSOnqE0iTcH/5dxA folded before Flop (didn't bet)
Seat 5: h5ipsNTMyolp7xn/NAvWkA folded before Flop (didn't bet)
Seat 6: gUUvmqdVlmvpal6B8nYrmg (button) folded before Flop (didn't bet)
Seat 7: Pp/KTcXkfZKKUHkjyaLTdg (small blind) folded before Flop
Seat 8: G4DEhsZFmznGNVpy2SEocA (big blind) showed [As Ah] and won ($42.80) with a full house, Aces full of Kings
Seat 9: XE5QF1y74bpHog9JxWJMWQ folded before Flop (didn't bet)



PokerStars Game #59941165696:  Hold'em No Limit ($0.50/$1.00) - 2009/07/01 1:27:31 ET
Table 'vs/5jr6ciwjVQ5+Soc+u2A' 6-max Seat #3 is the button
Seat 1: J798qwLuvXyq0BbzsIjOrA ($165.95 in chips)
Seat 2: lXX4W7m3u++JiSOZ46yVMQ ($100.65 in chips)
Seat 3: G5ZSSN6RSON3gkNvk/SmYg ($123.10 in chips)
Seat 4: wk6Ohn4GDozoOMHc4eb2rw ($54.30 in chips)
Seat 5: +Nt3OPk3XR9SKjZgm2CexQ ($155.50 in chips)
Seat 6: Z2fXsGcjl+Eax+RzOgwOmg ($106 in chips)
wk6Ohn4GDozoOMHc4eb2rw: posts small blind $0.50
+Nt3OPk3XR9SKjZgm2CexQ: posts big blind $1
*** HOLE CARDS ***
Z2fXsGcjl+Eax+RzOgwOmg: folds
J798qwLuvXyq0BbzsIjOrA: raises $3 to $4
lXX4W7m3u++JiSOZ46yVMQ: folds
G5ZSSN6RSON3gkNvk/SmYg: calls $4
wk6Ohn4GDozoOMHc4eb2rw: folds
+Nt3OPk3XR9SKjZgm2CexQ: calls $3
*** FLOP *** [Ad 5s 6h]
+Nt3OPk3XR9SKjZgm2CexQ: checks
J798qwLuvXyq0BbzsIjOrA: checks
G5ZSSN6RSON3gkNvk/SmYg: checks
*** TURN *** [Ad 5s 6h] [3h]
+Nt3OPk3XR9SKjZgm2CexQ: bets $9
J798qwLuvXyq0BbzsIjOrA: folds
G5ZSSN6RSON3gkNvk/SmYg: folds
+Nt3OPk3XR9SKjZgm2CexQ collected $11.90 from pot
+Nt3OPk3XR9SKjZgm2CexQ: doesn't show hand
*** SUMMARY ***
Total pot $12.50 | Rake $0.60
Board [Ad 5s 6h 3h]
Seat 1: J798qwLuvXyq0BbzsIjOrA folded on the Turn
Seat 2: lXX4W7m3u++JiSOZ46yVMQ folded before Flop (didn't bet)
Seat 3: G5ZSSN6RSON3gkNvk/SmYg (button) folded on the Turn
Seat 4: wk6Ohn4GDozoOMHc4eb2rw (small blind) folded before Flop
Seat 5: +Nt3OPk3XR9SKjZgm2CexQ (big blind) collected ($11.90)
Seat 6: Z2fXsGcjl+Eax+RzOgwOmg folded before Flop (didn't bet)



PokerStars Game #59941165426:  Hold'em No Limit ($0.50/$1.00) - 2009/07/01 1:27:31 ET
Table '+cA8mcmhaedZ7YcrDdhmeQ' 6-max Seat #4 is the button
Seat 2: 14aYclSc98EYd6TrzN2l3Q ($14.55 in chips)
Seat 3: DAIgyIWbYvAkL6PbAI27pg ($18.05 in chips)
Seat 4: 4OO5v3AVduL0tePNx8wk5A ($101 in chips)
Seat 5: n5xXfJeDtWZSChGAdq//Tw ($17.55 in chips)
Seat 6: YfsTQsY/fxb+YqbdclTHuw ($27.25 in chips)
n5xXfJeDtWZSChGAdq//Tw: posts small blind $0.50
YfsTQsY/fxb+YqbdclTHuw: posts big blind $1
9XrTM0DuVxx1pjFAdSbD8A: sits out
*** HOLE CARDS ***
14aYclSc98EYd6TrzN2l3Q: calls $1
DAIgyIWbYvAkL6PbAI27pg: folds
4OO5v3AVduL0tePNx8wk5A: folds
n5xXfJeDtWZSChGAdq//Tw: folds
YfsTQsY/fxb+YqbdclTHuw: checks
*** FLOP *** [4d 9c 8s]
YfsTQsY/fxb+YqbdclTHuw: checks
14aYclSc98EYd6TrzN2l3Q: bets $1
YfsTQsY/fxb+YqbdclTHuw: folds
14aYclSc98EYd6TrzN2l3Q collected $2.40 from pot
*** SUMMARY ***
Total pot $2.50 | Rake $0.10
Board [4d 9c 8s]
Seat 2: 14aYclSc98EYd6TrzN2l3Q collected ($2.40)
Seat 3: DAIgyIWbYvAkL6PbAI27pg folded before Flop (didn't bet)
Seat 4: 4OO5v3AVduL0tePNx8wk5A (button) folded before Flop (didn't bet)
Seat 5: n5xXfJeDtWZSChGAdq//Tw (small blind) folded before Flop
Seat 6: YfsTQsY/fxb+YqbdclTHuw (big blind) folded on the Flop



PokerStars Game #59941166978:  Hold'em No Limit ($0.50/$1.00) - 2009/07/01 1:27:33 ET
Table 'N6LvHFrb+cdXY/COI6ByOw' 2-max Seat #1 is the button
Seat 1: lXX4W7m3u++JiSOZ46yVMQ ($115.90 in chips)
Seat 2: 9mAoSP3o/mikSZOW2LEEAw ($83 in chips)
lXX4W7m3u++JiSOZ46yVMQ: posts small blind $0.50
9mAoSP3o/mikSZOW2LEEAw: posts big blind $1
*** HOLE CARDS ***
lXX4W7m3u++JiSOZ46yVMQ: raises $2 to $3
9mAoSP3o/mikSZOW2LEEAw: calls $2
*** FLOP *** [Ah Qc Tc]
9mAoSP3o/mikSZOW2LEEAw: checks
lXX4W7m3u++JiSOZ46yVMQ: bets $3
9mAoSP3o/mikSZOW2LEEAw: folds
lXX4W7m3u++JiSOZ46yVMQ collected $5.70 from pot
*** SUMMARY ***
Total pot $6 | Rake $0.30
Board [Ah Qc Tc]
Seat 1: lXX4W7m3u++JiSOZ46yVMQ (button) (small blind) collected ($5.70)
Seat 2: 9mAoSP3o/mikSZOW2LEEAw (big blind) folded on the Flop



PokerStars Game #59941167270:  Hold'em No Limit ($0.50/$1.00) - 2009/07/01 1:27:34 ET
Table 'jDQgUn1zGkyftPnHo0Awdw' 2-max Seat #2 is the button
Seat 1: a42+e5QB6s1kkG5FoSTZJw ($111.15 in chips)
Seat 2: q+vRKwm51mnr6kxX/161WQ ($84.40 in chips)
q+vRKwm51mnr6kxX/161WQ: posts small blind $0.50
a42+e5QB6s1kkG5FoSTZJw: posts big blind $1
*** HOLE CARDS ***
q+vRKwm51mnr6kxX/161WQ: raises $2 to $3
a42+e5QB6s1kkG5FoSTZJw: calls $2
*** FLOP *** [2h Ad 8h]
a42+e5QB6s1kkG5FoSTZJw: checks
q+vRKwm51mnr6kxX/161WQ: bets $4
a42+e5QB6s1kkG5FoSTZJw: calls $4
*** TURN *** [2h Ad 8h] [5c]
a42+e5QB6s1kkG5FoSTZJw: checks
q+vRKwm51mnr6kxX/161WQ: checks
*** RIVER *** [2h Ad 8h 5c] [Th]
a42+e5QB6s1kkG5FoSTZJw: checks
q+vRKwm51mnr6kxX/161WQ: checks
*** SHOW DOWN ***
a42+e5QB6s1kkG5FoSTZJw: shows [Qh 8c] (a pair of Eights)
q+vRKwm51mnr6kxX/161WQ: mucks hand
a42+e5QB6s1kkG5FoSTZJw collected $13.50 from pot
*** SUMMARY ***
Total pot $14 | Rake $0.50
Board [2h Ad 8h 5c Th]
Seat 1: a42+e5QB6s1kkG5FoSTZJw (big blind) showed [Qh 8c] and won ($13.50) with a pair of Eights
Seat 2: q+vRKwm51mnr6kxX/161WQ (button) (small blind) mucked



PokerStars Game #59941167668:  Hold'em No Limit ($0.50/$1.00) - 2009/07/01 1:27:35 ET
Table 'mmbQQVBTrPdE+wy+s+9VPA' 6-max Seat #4 is the button
Seat 1: zyP4SPoWZnKUfTvIRLCVog ($78.35 in chips)
Seat 2: XK4Qsl+DA8gAJyg85/zBIw ($33.10 in chips)
Seat 3: wx3sQGkVi2x9wJXuWNHPBw ($126.35 in chips)
Seat 4: V3iZdcw61nXF3g5hD2RrsQ ($100 in chips)
Seat 5: YMJG+F++3Aj6P8dAWda5fw ($116.90 in chips)
Seat 6: U2CWBTv29qdCbj8RNF2sIw ($114.75 in chips)
YMJG+F++3Aj6P8dAWda5fw: posts small blind $0.50
U2CWBTv29qdCbj8RNF2sIw: posts big blind $1
*** HOLE CARDS ***
zyP4SPoWZnKUfTvIRLCVog: raises $2 to $3
XK4Qsl+DA8gAJyg85/zBIw: folds
wx3sQGkVi2x9wJXuWNHPBw: folds
V3iZdcw61nXF3g5hD2RrsQ: calls $3
YMJG+F++3Aj6P8dAWda5fw: raises $10 to $13
U2CWBTv29qdCbj8RNF2sIw: folds
zyP4SPoWZnKUfTvIRLCVog: folds
V3iZdcw61nXF3g5hD2RrsQ: folds
YMJG+F++3Aj6P8dAWda5fw collected $10 from pot
*** SUMMARY ***
Total pot $10 | Rake $0
Seat 1: zyP4SPoWZnKUfTvIRLCVog folded before Flop
Seat 2: XK4Qsl+DA8gAJyg85/zBIw folded before Flop (didn't bet)
Seat 3: wx3sQGkVi2x9wJXuWNHPBw folded before Flop (didn't bet)
Seat 4: V3iZdcw61nXF3g5hD2RrsQ (button) folded before Flop
Seat 5: YMJG+F++3Aj6P8dAWda5fw (small blind) collected ($10)
Seat 6: U2CWBTv29qdCbj8RNF2sIw (big blind) folded before Flop



PokerStars Game #59941167690:  Hold'em No Limit ($0.50/$1.00) - 2009/07/01 1:27:35 ET
Table '/RZcOwpZpHQ+OwPwjsbnRw' 6-max Seat #6 is the button
Seat 1: +uSzP8Jwnw7sKfQ4s66b7w ($42.25 in chips)
Seat 2: Z2fXsGcjl+Eax+RzOgwOmg ($107.15 in chips)
Seat 3: 6hLdALbOlkzGIrc53QKtPw ($22.70 in chips)
Seat 4: j7NIOHLZk7V2o9fOioO5ug ($107.05 in chips)
Seat 5: wx3sQGkVi2x9wJXuWNHPBw ($164.55 in chips)
Seat 6: o3YLm/rSY916m/on1VjXPA ($198 in chips)
+uSzP8Jwnw7sKfQ4s66b7w: posts small blind $0.50
Z2fXsGcjl+Eax+RzOgwOmg: posts big blind $1
*** HOLE CARDS ***
6hLdALbOlkzGIrc53QKtPw: folds
j7NIOHLZk7V2o9fOioO5ug: folds
wx3sQGkVi2x9wJXuWNHPBw: folds
o3YLm/rSY916m/on1VjXPA: raises $2 to $3
+uSzP8Jwnw7sKfQ4s66b7w: folds
6hLdALbOlkzGIrc53QKtPw leaves the table
Z2fXsGcjl+Eax+RzOgwOmg: folds
o3YLm/rSY916m/on1VjXPA collected $2.50 from pot
o3YLm/rSY916m/on1VjXPA: doesn't show hand
*** SUMMARY ***
Total pot $2.50 | Rake $0
Seat 1: +uSzP8Jwnw7sKfQ4s66b7w (small blind) folded before Flop
Seat 2: Z2fXsGcjl+Eax+RzOgwOmg (big blind) folded before Flop
Seat 3: 6hLdALbOlkzGIrc53QKtPw folded before Flop (didn't bet)
Seat 4: j7NIOHLZk7V2o9fOioO5ug folded before Flop (didn't bet)
Seat 5: wx3sQGkVi2x9wJXuWNHPBw folded before Flop (didn't bet)
Seat 6: o3YLm/rSY916m/on1VjXPA (button) collected ($2.50)



PokerStars Game #59941169828:  Hold'em No Limit ($0.50/$1.00) - 2009/07/01 1:27:38 ET
Table 'gxFK0BVUD7cupu2uyRUZJg' 6-max Seat #6 is the button
Seat 1: M+X3uChmP6R63IwijVjgTg ($161.75 in chips)
Seat 2: hpxXcmRkXXI9HE5+5/j/0Q ($136.05 in chips)
Seat 3: Z2fXsGcjl+Eax+RzOgwOmg ($122 in chips)
Seat 5: WgIrs6CBinyyw18pqdDtWA ($19.70 in chips)
Seat 6: dYyb6/42PMC8aNFlm/eBeQ ($103 in chips)
M+X3uChmP6R63IwijVjgTg: posts small blind $0.50
hpxXcmRkXXI9HE5+5/j/0Q: posts big blind $1
JwCcjZl0bjJzG7hmE0dnTA: sits out
*** HOLE CARDS ***
Z2fXsGcjl+Eax+RzOgwOmg: raises $3 to $4
WgIrs6CBinyyw18pqdDtWA: folds
dYyb6/42PMC8aNFlm/eBeQ: folds
M+X3uChmP6R63IwijVjgTg: folds
hpxXcmRkXXI9HE5+5/j/0Q: folds
Z2fXsGcjl+Eax+RzOgwOmg collected $2.50 from pot
Z2fXsGcjl+Eax+RzOgwOmg: doesn't show hand
*** SUMMARY ***
Total pot $2.50 | Rake $0
Seat 1: M+X3uChmP6R63IwijVjgTg (small blind) folded before Flop
Seat 2: hpxXcmRkXXI9HE5+5/j/0Q (big blind) folded before Flop
Seat 3: Z2fXsGcjl+Eax+RzOgwOmg collected ($2.50)
Seat 5: WgIrs6CBinyyw18pqdDtWA folded before Flop (didn't bet)
Seat 6: dYyb6/42PMC8aNFlm/eBeQ (button) folded before Flop (didn't bet)



PokerStars Game #59941171434:  Hold'em No Limit ($0.50/$1.00) - 2009/07/01 1:27:41 ET
Table 'QSIig7BLMc9wY/rgBechzw' 6-max Seat #3 is the button
Seat 1: Z2fXsGcjl+Eax+RzOgwOmg ($110.60 in chips)
Seat 2: mLOIkH/qmRa+mVujQIhBRg ($46.90 in chips)
Seat 3: +xW7QemQU0Fxs+4TnqBRow ($110 in chips)
Seat 4: +uSzP8Jwnw7sKfQ4s66b7w ($64.45 in chips)
Seat 5: lsLuWlcPA3Rh7kJVLzMh0Q ($100 in chips)
Seat 6: PxqfkAMdAWtkgbT+q2gciA ($49 in chips)
+uSzP8Jwnw7sKfQ4s66b7w: posts small blind $0.50
lsLuWlcPA3Rh7kJVLzMh0Q: posts big blind $1
*** HOLE CARDS ***
PxqfkAMdAWtkgbT+q2gciA: raises $1 to $2
Z2fXsGcjl+Eax+RzOgwOmg: raises $6 to $8
mLOIkH/qmRa+mVujQIhBRg: folds
+xW7QemQU0Fxs+4TnqBRow: folds
+uSzP8Jwnw7sKfQ4s66b7w: folds
lsLuWlcPA3Rh7kJVLzMh0Q: folds
PxqfkAMdAWtkgbT+q2gciA: calls $6
*** FLOP *** [Js 6d Tc]
PxqfkAMdAWtkgbT+q2gciA: checks
Z2fXsGcjl+Eax+RzOgwOmg: bets $11
PxqfkAMdAWtkgbT+q2gciA: calls $11
*** TURN *** [Js 6d Tc] [7c]
PxqfkAMdAWtkgbT+q2gciA: checks
Z2fXsGcjl+Eax+RzOgwOmg: checks
*** RIVER *** [Js 6d Tc 7c] [7s]
PxqfkAMdAWtkgbT+q2gciA: bets $12
Z2fXsGcjl+Eax+RzOgwOmg: folds
PxqfkAMdAWtkgbT+q2gciA collected $37.60 from pot
*** SUMMARY ***
Total pot $39.50 | Rake $1.90
Board [Js 6d Tc 7c 7s]
Seat 1: Z2fXsGcjl+Eax+RzOgwOmg folded on the River
Seat 2: mLOIkH/qmRa+mVujQIhBRg folded before Flop (didn't bet)
Seat 3: +xW7QemQU0Fxs+4TnqBRow (button) folded before Flop (didn't bet)
Seat 4: +uSzP8Jwnw7sKfQ4s66b7w (small blind) folded before Flop
Seat 5: lsLuWlcPA3Rh7kJVLzMh0Q (big blind) folded before Flop
Seat 6: PxqfkAMdAWtkgbT+q2gciA collected ($37.60)



PokerStars Game #59941172174:  Hold'em No Limit ($0.50/$1.00) - 2009/07/01 1:27:42 ET
Table 'fTlPiCj0utgzC/5io+I7ew' 6-max Seat #3 is the button
Seat 1: YMJG+F++3Aj6P8dAWda5fw ($103.10 in chips)
Seat 2: qVr1nl3dy2xXPqS8UpTDlA ($20.30 in chips)
Seat 3: Z2fXsGcjl+Eax+RzOgwOmg ($140 in chips)
Seat 4: uJVSceLggtsrJya+WtmUEA ($162.65 in chips)
Seat 5: XUk5GQsfNFpHvaToDZ0rZA ($45.65 in chips)
Seat 6: y27w5IK2WXqmYzS8OU0wKA ($100 in chips)
uJVSceLggtsrJya+WtmUEA: posts small blind $0.50
XUk5GQsfNFpHvaToDZ0rZA: posts big blind $1
*** HOLE CARDS ***
y27w5IK2WXqmYzS8OU0wKA: folds
YMJG+F++3Aj6P8dAWda5fw: raises $2 to $3
qVr1nl3dy2xXPqS8UpTDlA: folds
Z2fXsGcjl+Eax+RzOgwOmg: folds
uJVSceLggtsrJya+WtmUEA: folds
XUk5GQsfNFpHvaToDZ0rZA: folds
YMJG+F++3Aj6P8dAWda5fw collected $2.50 from pot
*** SUMMARY ***
Total pot $2.50 | Rake $0
Seat 1: YMJG+F++3Aj6P8dAWda5fw collected ($2.50)
Seat 2: qVr1nl3dy2xXPqS8UpTDlA folded before Flop (didn't bet)
Seat 3: Z2fXsGcjl+Eax+RzOgwOmg (button) folded before Flop (didn't bet)
Seat 4: uJVSceLggtsrJya+WtmUEA (small blind) folded before Flop
Seat 5: XUk5GQsfNFpHvaToDZ0rZA (big blind) folded before Flop
Seat 6: y27w5IK2WXqmYzS8OU0wKA folded before Flop (didn't bet)



PokerStars Game #59941171914:  Hold'em No Limit ($0.50/$1.00) - 2009/07/01 1:27:42 ET
Table 'MUPc8FEpe/nR0BKSeReX6Q' 6-max Seat #2 is the button
Seat 1: qhkK6+yCciTRd+rCFEbnEQ ($83.20 in chips)
Seat 2: xAU6q2/cwmby2sxmA8VcmA ($105.20 in chips)
Seat 3: wx3sQGkVi2x9wJXuWNHPBw ($286.50 in chips)
Seat 4: r4lpoh2BJZ8S6zyQv1JeSw ($100 in chips)
Seat 5: y27w5IK2WXqmYzS8OU0wKA ($104.05 in chips)
Seat 6: oxnw0GLLpFanjhGkxfRSqA ($132.65 in chips)
wx3sQGkVi2x9wJXuWNHPBw: posts small blind $0.50
r4lpoh2BJZ8S6zyQv1JeSw: posts big blind $1
*** HOLE CARDS ***
y27w5IK2WXqmYzS8OU0wKA: folds
oxnw0GLLpFanjhGkxfRSqA: calls $1
qhkK6+yCciTRd+rCFEbnEQ: folds
xAU6q2/cwmby2sxmA8VcmA: folds
wx3sQGkVi2x9wJXuWNHPBw: calls $0.50
r4lpoh2BJZ8S6zyQv1JeSw: checks
*** FLOP *** [As 9d 8h]
wx3sQGkVi2x9wJXuWNHPBw: checks
r4lpoh2BJZ8S6zyQv1JeSw: checks
oxnw0GLLpFanjhGkxfRSqA: bets $3
wx3sQGkVi2x9wJXuWNHPBw: folds
r4lpoh2BJZ8S6zyQv1JeSw: folds
oxnw0GLLpFanjhGkxfRSqA collected $2.85 from pot
*** SUMMARY ***
Total pot $3 | Rake $0.15
Board [As 9d 8h]
Seat 1: qhkK6+yCciTRd+rCFEbnEQ folded before Flop (didn't bet)
Seat 2: xAU6q2/cwmby2sxmA8VcmA (button) folded before Flop (didn't bet)
Seat 3: wx3sQGkVi2x9wJXuWNHPBw (small blind) folded on the Flop
Seat 4: r4lpoh2BJZ8S6zyQv1JeSw (big blind) folded on the Flop
Seat 5: y27w5IK2WXqmYzS8OU0wKA folded before Flop (didn't bet)
Seat 6: oxnw0GLLpFanjhGkxfRSqA collected ($2.85)



PokerStars Game #59941171948:  Hold'em No Limit ($0.50/$1.00) - 2009/07/01 1:27:42 ET
Table 'ZFWj23PMihdwrNWv41OG/Q' 9-max Seat #9 is the button
Seat 1: yAbu2QsRPVcjPbqlf/jDxw ($122.85 in chips)
Seat 3: G9Fo2TZCN7HI43Po4zSN3A ($117.95 in chips)
Seat 4: D+W9Me7w6Hcx/WRUSKV0dw ($25.10 in chips)
Seat 5: tkdBeXTJlFsZdioidNqLow ($109.75 in chips)
Seat 6: 3obndzTJ6fECz8+wWhMd1w ($42.35 in chips)
Seat 7: 2uQqi2bcuMs+2q7ej+tN+Q ($92 in chips)
Seat 8: 997ViqAtWn1FPjJqcffwcA ($118.60 in chips)
Seat 9: 6XkTu4ahxzHnvjjc1R8YjQ ($98.50 in chips)
yAbu2QsRPVcjPbqlf/jDxw: posts small blind $0.50
G9Fo2TZCN7HI43Po4zSN3A: posts big blind $1
*** HOLE CARDS ***
D+W9Me7w6Hcx/WRUSKV0dw: folds
skezes leaves the table
tkdBeXTJlFsZdioidNqLow: folds
3obndzTJ6fECz8+wWhMd1w: folds
2uQqi2bcuMs+2q7ej+tN+Q: folds
997ViqAtWn1FPjJqcffwcA: folds
6XkTu4ahxzHnvjjc1R8YjQ: folds
yAbu2QsRPVcjPbqlf/jDxw: folds
G9Fo2TZCN7HI43Po4zSN3A collected $1 from pot
G9Fo2TZCN7HI43Po4zSN3A: doesn't show hand
*** SUMMARY ***
Total pot $1 | Rake $0
Seat 1: yAbu2QsRPVcjPbqlf/jDxw (small blind) folded before Flop
Seat 3: G9Fo2TZCN7HI43Po4zSN3A (big blind) collected ($1)
Seat 4: D+W9Me7w6Hcx/WRUSKV0dw folded before Flop (didn't bet)
Seat 5: tkdBeXTJlFsZdioidNqLow folded before Flop (didn't bet)
Seat 6: 3obndzTJ6fECz8+wWhMd1w folded before Flop (didn't bet)
Seat 7: 2uQqi2bcuMs+2q7ej+tN+Q folded before Flop (didn't bet)
Seat 8: 997ViqAtWn1FPjJqcffwcA folded before Flop (didn't bet)
Seat 9: 6XkTu4ahxzHnvjjc1R8YjQ (button) folded before Flop (didn't bet)



PokerStars Game #59941173712:  Hold'em No Limit ($0.50/$1.00) - 2009/07/01 1:27:45 ET
Table 'MNvFfRVQNka/oY+Z5aMbZQ' 2-max Seat #2 is the button
Seat 1: DaZnoWHjO897dnh0CL2lVg ($80.60 in chips)
Seat 2: mgi+mjKb1Sc3CCs7TlfoCw ($79.55 in chips)
mgi+mjKb1Sc3CCs7TlfoCw: posts small blind $0.50
DaZnoWHjO897dnh0CL2lVg: posts big blind $1
*** HOLE CARDS ***
mgi+mjKb1Sc3CCs7TlfoCw: raises $2 to $3
DaZnoWHjO897dnh0CL2lVg: calls $2
*** FLOP *** [7s Js 7h]
DaZnoWHjO897dnh0CL2lVg: checks
mgi+mjKb1Sc3CCs7TlfoCw: checks
*** TURN *** [7s Js 7h] [3h]
DaZnoWHjO897dnh0CL2lVg: checks
mgi+mjKb1Sc3CCs7TlfoCw: bets $4
DaZnoWHjO897dnh0CL2lVg: folds
mgi+mjKb1Sc3CCs7TlfoCw collected $5.70 from pot
mgi+mjKb1Sc3CCs7TlfoCw: doesn't show hand
*** SUMMARY ***
Total pot $6 | Rake $0.30
Board [7s Js 7h 3h]
Seat 1: DaZnoWHjO897dnh0CL2lVg (big blind) folded on the Turn
Seat 2: mgi+mjKb1Sc3CCs7TlfoCw (button) (small blind) collected ($5.70)



PokerStars Game #59941174760:  Hold'em No Limit ($0.50/$1.00) - 2009/07/01 1:27:46 ET
Table 'NqGO/cV3MwFAx+ZPB5ANmQ' 2-max Seat #1 is the button
Seat 1: ItaRAnHOgvYOv5ynbG1iTw ($63.80 in chips)
Seat 2: GtFB+yyeb2djMdPFuOW/Xg ($143 in chips)
ItaRAnHOgvYOv5ynbG1iTw: posts small blind $0.50
GtFB+yyeb2djMdPFuOW/Xg: posts big blind $1
*** HOLE CARDS ***
ItaRAnHOgvYOv5ynbG1iTw: raises $2 to $3
GtFB+yyeb2djMdPFuOW/Xg: folds
ItaRAnHOgvYOv5ynbG1iTw collected $2 from pot
*** SUMMARY ***
Total pot $2 | Rake $0
Seat 1: ItaRAnHOgvYOv5ynbG1iTw (button) (small blind) collected ($2)
Seat 2: GtFB+yyeb2djMdPFuOW/Xg (big blind) folded before Flop



PokerStars Game #59941174628:  Hold'em No Limit ($0.50/$1.00) - 2009/07/01 1:27:46 ET
Table '305hiksPPCCdC6V2LNsO5w' 6-max Seat #6 is the button
Seat 1: RTuDLJHh/9zPfBftoc9vsw ($11.50 in chips)
Seat 2: j7NIOHLZk7V2o9fOioO5ug ($132 in chips)
Seat 3: +zIVjZKLpcidfRHgVZW8lA ($32.20 in chips)
Seat 4: uJVSceLggtsrJya+WtmUEA ($214.55 in chips)
Seat 5: +Nt3OPk3XR9SKjZgm2CexQ ($112.65 in chips)
Seat 6: 9/Tq8dw7kWW68uN8bFupXg ($14.90 in chips)
RTuDLJHh/9zPfBftoc9vsw: posts small blind $0.50
j7NIOHLZk7V2o9fOioO5ug: posts big blind $1
*** HOLE CARDS ***
+zIVjZKLpcidfRHgVZW8lA: folds
uJVSceLggtsrJya+WtmUEA: folds
+Nt3OPk3XR9SKjZgm2CexQ: folds
9/Tq8dw7kWW68uN8bFupXg: raises $1 to $2
RTuDLJHh/9zPfBftoc9vsw: folds
j7NIOHLZk7V2o9fOioO5ug: folds
9/Tq8dw7kWW68uN8bFupXg collected $2.50 from pot
*** SUMMARY ***
Total pot $2.50 | Rake $0
Seat 1: RTuDLJHh/9zPfBftoc9vsw (small blind) folded before Flop
Seat 2: j7NIOHLZk7V2o9fOioO5ug (big blind) folded before Flop
Seat 3: +zIVjZKLpcidfRHgVZW8lA folded before Flop (didn't bet)
Seat 4: uJVSceLggtsrJya+WtmUEA folded before Flop (didn't bet)
Seat 5: +Nt3OPk3XR9SKjZgm2CexQ folded before Flop (didn't bet)
Seat 6: 9/Tq8dw7kWW68uN8bFupXg (button) collected ($2.50)



PokerStars Game #59941176202:  Hold'em No Limit ($0.50/$1.00) - 2009/07/01 1:27:49 ET
Table 'pHrhryH8jPNdQfY62f8v+g' 6-max Seat #5 is the button
Seat 1: 4d1rWhpu8DzLmzMbR3QKyA ($133.25 in chips)
Seat 2: JwCcjZl0bjJzG7hmE0dnTA ($105.55 in chips)
Seat 3: 8oS5O7iD/qnFXFXJrGIgNQ ($110.15 in chips)
Seat 4: 1f3beyIML24UqEMTbWy93g ($53.40 in chips)
Seat 5: r1/R7y0Ortgoz4lccgW8VA ($7.75 in chips)
Seat 6: xAU6q2/cwmby2sxmA8VcmA ($200.60 in chips)
xAU6q2/cwmby2sxmA8VcmA: posts small blind $0.50
4d1rWhpu8DzLmzMbR3QKyA: posts big blind $1
*** HOLE CARDS ***
JwCcjZl0bjJzG7hmE0dnTA: folds
8oS5O7iD/qnFXFXJrGIgNQ: folds
1f3beyIML24UqEMTbWy93g: raises $2 to $3
r1/R7y0Ortgoz4lccgW8VA: folds
xAU6q2/cwmby2sxmA8VcmA: calls $2.50
4d1rWhpu8DzLmzMbR3QKyA: folds
*** FLOP *** [3s 3h 2c]
xAU6q2/cwmby2sxmA8VcmA: checks
1f3beyIML24UqEMTbWy93g: checks
*** TURN *** [3s 3h 2c] [Jh]
xAU6q2/cwmby2sxmA8VcmA: bets $4
1f3beyIML24UqEMTbWy93g: folds
xAU6q2/cwmby2sxmA8VcmA collected $6.65 from pot
*** SUMMARY ***
Total pot $7 | Rake $0.35
Board [3s 3h 2c Jh]
Seat 1: 4d1rWhpu8DzLmzMbR3QKyA (big blind) folded before Flop
Seat 2: JwCcjZl0bjJzG7hmE0dnTA folded before Flop (didn't bet)
Seat 3: 8oS5O7iD/qnFXFXJrGIgNQ folded before Flop (didn't bet)
Seat 4: 1f3beyIML24UqEMTbWy93g folded on the Turn
Seat 5: r1/R7y0Ortgoz4lccgW8VA (button) folded before Flop (didn't bet)
Seat 6: xAU6q2/cwmby2sxmA8VcmA (small blind) collected ($6.65)



PokerStars Game #59941176310:  Hold'em No Limit ($0.50/$1.00) - 2009/07/01 1:27:49 ET
Table 'Evb7VW0qfDhFkbgBL3gcqQ' 2-max Seat #1 is the button
Seat 1: NYi6JFscYNrofSXy4sM+Yw ($163.35 in chips)
Seat 2: AoEQlM/FNYM0d7Txn1TfBQ ($40.15 in chips)
NYi6JFscYNrofSXy4sM+Yw: posts small blind $0.50
AoEQlM/FNYM0d7Txn1TfBQ: posts big blind $1
*** HOLE CARDS ***
NYi6JFscYNrofSXy4sM+Yw: raises $2 to $3
AoEQlM/FNYM0d7Txn1TfBQ: folds
NYi6JFscYNrofSXy4sM+Yw collected $2 from pot
NYi6JFscYNrofSXy4sM+Yw: doesn't show hand
*** SUMMARY ***
Total pot $2 | Rake $0
Seat 1: NYi6JFscYNrofSXy4sM+Yw (button) (small blind) collected ($2)
Seat 2: AoEQlM/FNYM0d7Txn1TfBQ (big blind) folded before Flop



PokerStars Game #59941176154:  Hold'em No Limit ($0.50/$1.00) - 2009/07/01 1:27:49 ET
Table '3T4owEKJKyGTMePwrv50FQ' 9-max Seat #4 is the button
Seat 1: OGgaARGdJQT4awWVNQ957w ($101.50 in chips)
Seat 3: DOLzOcBTZYcph5jEfKFWuQ ($102 in chips)
Seat 4: O5Go3jrzbQWxRB6ESK+Ptg ($80.60 in chips)
Seat 5: mMc/PBpqlN24gdi3C/1tOw ($46 in chips)
Seat 6: V138SURkdX8LdVBPKdJJag ($101.50 in chips)
Seat 7: 1862487932 ($119.15 in chips)
Seat 8: bLbSOSmSOnqE0iTcH/5dxA ($100 in chips)
mMc/PBpqlN24gdi3C/1tOw: posts small blind $0.50
V138SURkdX8LdVBPKdJJag: posts big blind $1
61sfw5QTu62YYIt68OsdrA: sits out
t+Id2O6herCLgwnC4m49PA: sits out
*** HOLE CARDS ***
1862487932: folds
bLbSOSmSOnqE0iTcH/5dxA: folds
OGgaARGdJQT4awWVNQ957w: folds
DOLzOcBTZYcph5jEfKFWuQ: folds
O5Go3jrzbQWxRB6ESK+Ptg: folds
mMc/PBpqlN24gdi3C/1tOw: calls $0.50
V138SURkdX8LdVBPKdJJag: checks
*** FLOP *** [Jc 4h Ah]
mMc/PBpqlN24gdi3C/1tOw: checks
61sfw5QTu62YYIt68OsdrA is disconnected
V138SURkdX8LdVBPKdJJag: checks
*** TURN *** [Jc 4h Ah] [Qd]
mMc/PBpqlN24gdi3C/1tOw: checks
V138SURkdX8LdVBPKdJJag: checks
*** RIVER *** [Jc 4h Ah Qd] [5h]
mMc/PBpqlN24gdi3C/1tOw: checks
V138SURkdX8LdVBPKdJJag: checks
*** SHOW DOWN ***
mMc/PBpqlN24gdi3C/1tOw: shows [Qc 9s] (a pair of Queens)
V138SURkdX8LdVBPKdJJag: mucks hand
61sfw5QTu62YYIt68OsdrA is connected
mMc/PBpqlN24gdi3C/1tOw collected $1.90 from pot
*** SUMMARY ***
Total pot $2 | Rake $0.10
Board [Jc 4h Ah Qd 5h]
Seat 1: OGgaARGdJQT4awWVNQ957w folded before Flop (didn't bet)
Seat 3: DOLzOcBTZYcph5jEfKFWuQ folded before Flop (didn't bet)
Seat 4: O5Go3jrzbQWxRB6ESK+Ptg (button) folded before Flop (didn't bet)
Seat 5: mMc/PBpqlN24gdi3C/1tOw (small blind) showed [Qc 9s] and won ($1.90) with a pair of Queens
Seat 6: V138SURkdX8LdVBPKdJJag (big blind) mucked
Seat 7: 1862487932 folded before Flop (didn't bet)
Seat 8: bLbSOSmSOnqE0iTcH/5dxA folded before Flop (didn't bet)



PokerStars Game #59941177354:  Hold'em No Limit ($0.50/$1.00) - 2009/07/01 1:27:51 ET
Table 'gxFK0BVUD7cupu2uyRUZJg' 6-max Seat #1 is the button
Seat 1: M+X3uChmP6R63IwijVjgTg ($161.25 in chips)
Seat 2: hpxXcmRkXXI9HE5+5/j/0Q ($135.05 in chips)
Seat 3: Z2fXsGcjl+Eax+RzOgwOmg ($123.50 in chips)
Seat 5: WgIrs6CBinyyw18pqdDtWA ($19.70 in chips)
Seat 6: dYyb6/42PMC8aNFlm/eBeQ ($103 in chips)
hpxXcmRkXXI9HE5+5/j/0Q: posts small blind $0.50
Z2fXsGcjl+Eax+RzOgwOmg: posts big blind $1
JwCcjZl0bjJzG7hmE0dnTA: sits out
*** HOLE CARDS ***
WgIrs6CBinyyw18pqdDtWA: folds
dYyb6/42PMC8aNFlm/eBeQ: calls $1
M+X3uChmP6R63IwijVjgTg: folds
hpxXcmRkXXI9HE5+5/j/0Q: folds
Z2fXsGcjl+Eax+RzOgwOmg: checks
*** FLOP *** [8c 9c 3h]
Z2fXsGcjl+Eax+RzOgwOmg: checks
dYyb6/42PMC8aNFlm/eBeQ: checks
*** TURN *** [8c 9c 3h] [2d]
Z2fXsGcjl+Eax+RzOgwOmg: checks
dYyb6/42PMC8aNFlm/eBeQ: checks
*** RIVER *** [8c 9c 3h 2d] [4s]
Z2fXsGcjl+Eax+RzOgwOmg: checks
dYyb6/42PMC8aNFlm/eBeQ: checks
*** SHOW DOWN ***
Z2fXsGcjl+Eax+RzOgwOmg: shows [Jc Qh] (high card Queen)
dYyb6/42PMC8aNFlm/eBeQ: shows [7s Ah] (high card Ace)
dYyb6/42PMC8aNFlm/eBeQ collected $2.40 from pot
*** SUMMARY ***
Total pot $2.50 | Rake $0.10
Board [8c 9c 3h 2d 4s]
Seat 1: M+X3uChmP6R63IwijVjgTg (button) folded before Flop (didn't bet)
Seat 2: hpxXcmRkXXI9HE5+5/j/0Q (small blind) folded before Flop
Seat 3: Z2fXsGcjl+Eax+RzOgwOmg (big blind) showed [Jc Qh] and lost with high card Queen
Seat 5: WgIrs6CBinyyw18pqdDtWA folded before Flop (didn't bet)
Seat 6: dYyb6/42PMC8aNFlm/eBeQ showed [7s Ah] and won ($2.40) with high card Ace



PokerStars Game #59941178920:  Hold'em No Limit ($0.50/$1.00) - 2009/07/01 1:27:54 ET
Table 'NqGO/cV3MwFAx+ZPB5ANmQ' 2-max Seat #2 is the button
Seat 1: ItaRAnHOgvYOv5ynbG1iTw ($64.80 in chips)
Seat 2: GtFB+yyeb2djMdPFuOW/Xg ($142 in chips)
GtFB+yyeb2djMdPFuOW/Xg: posts small blind $0.50
ItaRAnHOgvYOv5ynbG1iTw: posts big blind $1
*** HOLE CARDS ***
GtFB+yyeb2djMdPFuOW/Xg: raises $2 to $3
ItaRAnHOgvYOv5ynbG1iTw: raises $4 to $7
GtFB+yyeb2djMdPFuOW/Xg: calls $4
*** FLOP *** [7s Td Ts]
ItaRAnHOgvYOv5ynbG1iTw: bets $6
GtFB+yyeb2djMdPFuOW/Xg: calls $6
*** TURN *** [7s Td Ts] [6h]
ItaRAnHOgvYOv5ynbG1iTw: checks
GtFB+yyeb2djMdPFuOW/Xg: bets $10
ItaRAnHOgvYOv5ynbG1iTw: folds
GtFB+yyeb2djMdPFuOW/Xg collected $25.50 from pot
*** SUMMARY ***
Total pot $26 | Rake $0.50
Board [7s Td Ts 6h]
Seat 1: ItaRAnHOgvYOv5ynbG1iTw (big blind) folded on the Turn
Seat 2: GtFB+yyeb2djMdPFuOW/Xg (button) (small blind) collected ($25.50)



PokerStars Game #59941179704:  Hold'em No Limit ($0.50/$1.00) - 2009/07/01 1:27:55 ET
Table 'cBDNutyLBKEk9+ptwsKmTw' 6-max Seat #5 is the button
Seat 1: xAU6q2/cwmby2sxmA8VcmA ($299.05 in chips)
Seat 2: 4OO5v3AVduL0tePNx8wk5A ($101.50 in chips)
Seat 3: G5ZSSN6RSON3gkNvk/SmYg ($108.90 in chips)
Seat 4: OMkHNxIUZxh1pHqcCjbjgw ($98.50 in chips)
Seat 5: hpxXcmRkXXI9HE5+5/j/0Q ($103 in chips)
Seat 6: QHvTZcrKe6+maWUfVjP29Q ($150.50 in chips)
QHvTZcrKe6+maWUfVjP29Q: posts small blind $0.50
xAU6q2/cwmby2sxmA8VcmA: posts big blind $1
*** HOLE CARDS ***
4OO5v3AVduL0tePNx8wk5A: raises $3 to $4
G5ZSSN6RSON3gkNvk/SmYg: folds
OMkHNxIUZxh1pHqcCjbjgw: calls $4
hpxXcmRkXXI9HE5+5/j/0Q: folds
QHvTZcrKe6+maWUfVjP29Q: folds
xAU6q2/cwmby2sxmA8VcmA: folds
*** FLOP *** [6d 9d Ac]
4OO5v3AVduL0tePNx8wk5A: bets $8
OMkHNxIUZxh1pHqcCjbjgw: folds
4OO5v3AVduL0tePNx8wk5A collected $9.05 from pot
4OO5v3AVduL0tePNx8wk5A: doesn't show hand
*** SUMMARY ***
Total pot $9.50 | Rake $0.45
Board [6d 9d Ac]
Seat 1: xAU6q2/cwmby2sxmA8VcmA (big blind) folded before Flop
Seat 2: 4OO5v3AVduL0tePNx8wk5A collected ($9.05)
Seat 3: G5ZSSN6RSON3gkNvk/SmYg folded before Flop (didn't bet)
Seat 4: OMkHNxIUZxh1pHqcCjbjgw folded on the Flop
Seat 5: hpxXcmRkXXI9HE5+5/j/0Q (button) folded before Flop (didn't bet)
Seat 6: QHvTZcrKe6+maWUfVjP29Q (small blind) folded before Flop



PokerStars Game #59941180408:  Hold'em No Limit ($0.50/$1.00) - 2009/07/01 1:27:56 ET
Table 'Evb7VW0qfDhFkbgBL3gcqQ' 2-max Seat #2 is the button
Seat 1: NYi6JFscYNrofSXy4sM+Yw ($164.35 in chips)
Seat 2: AoEQlM/FNYM0d7Txn1TfBQ ($39.15 in chips)
AoEQlM/FNYM0d7Txn1TfBQ: posts small blind $0.50
NYi6JFscYNrofSXy4sM+Yw: posts big blind $1
*** HOLE CARDS ***
AoEQlM/FNYM0d7Txn1TfBQ: folds
NYi6JFscYNrofSXy4sM+Yw collected $1 from pot
*** SUMMARY ***
Total pot $1 | Rake $0
Seat 1: NYi6JFscYNrofSXy4sM+Yw (big blind) collected ($1)
Seat 2: AoEQlM/FNYM0d7Txn1TfBQ (button) (small blind) folded before Flop



PokerStars Game #59941180820:  Hold'em No Limit ($0.50/$1.00) - 2009/07/01 1:27:57 ET
Table 'jDQgUn1zGkyftPnHo0Awdw' 2-max Seat #1 is the button
Seat 1: a42+e5QB6s1kkG5FoSTZJw ($117.65 in chips)
Seat 2: q+vRKwm51mnr6kxX/161WQ ($77.40 in chips)
a42+e5QB6s1kkG5FoSTZJw: posts small blind $0.50
q+vRKwm51mnr6kxX/161WQ: posts big blind $1
*** HOLE CARDS ***
a42+e5QB6s1kkG5FoSTZJw: folds
q+vRKwm51mnr6kxX/161WQ collected $1 from pot
q+vRKwm51mnr6kxX/161WQ: doesn't show hand
*** SUMMARY ***
Total pot $1 | Rake $0
Seat 1: a42+e5QB6s1kkG5FoSTZJw (button) (small blind) folded before Flop
Seat 2: q+vRKwm51mnr6kxX/161WQ (big blind) collected ($1)



PokerStars Game #59941180548:  Hold'em No Limit ($0.50/$1.00) - 2009/07/01 1:27:57 ET
Table 'O96CPOtvMBWP6kzuYDfdFA' 6-max Seat #2 is the button
Seat 1: 6alLXQIITA2EZ/lBeym8Dw ($118.75 in chips)
Seat 2: 4d1rWhpu8DzLmzMbR3QKyA ($114.60 in chips)
Seat 3: V89DGjxE171oPREEbAXiyg ($119.75 in chips)
Seat 4: /P4w1pHg2zHYg/4ubJ0dPw ($63.65 in chips)
Seat 5: G5ZSSN6RSON3gkNvk/SmYg ($104.15 in chips)
GYei5jXGWexiJYbAT2fELg leaves the table
V89DGjxE171oPREEbAXiyg: posts small blind $0.50
/P4w1pHg2zHYg/4ubJ0dPw: posts big blind $1
*** HOLE CARDS ***
G5ZSSN6RSON3gkNvk/SmYg: folds
6alLXQIITA2EZ/lBeym8Dw: folds
4d1rWhpu8DzLmzMbR3QKyA: raises $2 to $3
V89DGjxE171oPREEbAXiyg: folds
/P4w1pHg2zHYg/4ubJ0dPw: raises $6 to $9
4d1rWhpu8DzLmzMbR3QKyA: folds
/P4w1pHg2zHYg/4ubJ0dPw collected $6.50 from pot
*** SUMMARY ***
Total pot $6.50 | Rake $0
Seat 1: 6alLXQIITA2EZ/lBeym8Dw folded before Flop (didn't bet)
Seat 2: 4d1rWhpu8DzLmzMbR3QKyA (button) folded before Flop
Seat 3: V89DGjxE171oPREEbAXiyg (small blind) folded before Flop
Seat 4: /P4w1pHg2zHYg/4ubJ0dPw (big blind) collected ($6.50)
Seat 5: G5ZSSN6RSON3gkNvk/SmYg folded before Flop (didn't bet)



PokerStars Game #59941182228:  Hold'em No Limit ($0.50/$1.00) - 2009/07/01 1:27:59 ET
Table 'CASNP0uy1C+jGLml/I4PtA' 9-max Seat #1 is the button
Seat 1: tkdBeXTJlFsZdioidNqLow ($60 in chips)
Seat 2: LUsAYklr0mQkiq7ASOyD9A ($63 in chips)
Seat 4: B/G0GJacqZ8K59/ZVdq4kQ ($70.55 in chips)
Seat 5: Jjc7EHWzs4//xUAjJ0UWoA ($10.50 in chips)
Seat 6: FJEywSpo5JbRKByzmweboA ($100 in chips)
Seat 7: S3Ex8K7v6xm5jqjRM7Fl3w ($22 in chips)
Seat 8: L9njYvloJ1NdXjP8edHEAg ($104.45 in chips)
Seat 9: Pp/KTcXkfZKKUHkjyaLTdg ($20 in chips)
LUsAYklr0mQkiq7ASOyD9A: posts small blind $0.50
bJckevFOcg//s0qyMQI6sQ: is sitting out
B/G0GJacqZ8K59/ZVdq4kQ: posts big blind $1
*** HOLE CARDS ***
Jjc7EHWzs4//xUAjJ0UWoA: folds
FJEywSpo5JbRKByzmweboA: folds
S3Ex8K7v6xm5jqjRM7Fl3w: folds
L9njYvloJ1NdXjP8edHEAg: folds
Pp/KTcXkfZKKUHkjyaLTdg: raises $2.50 to $3.50
tkdBeXTJlFsZdioidNqLow: folds
LUsAYklr0mQkiq7ASOyD9A: calls $3
B/G0GJacqZ8K59/ZVdq4kQ: folds
*** FLOP *** [4h 9d 6d]
LUsAYklr0mQkiq7ASOyD9A: checks
Pp/KTcXkfZKKUHkjyaLTdg: checks
*** TURN *** [4h 9d 6d] [7d]
LUsAYklr0mQkiq7ASOyD9A: checks
Pp/KTcXkfZKKUHkjyaLTdg: bets $5.50
LUsAYklr0mQkiq7ASOyD9A: folds
Pp/KTcXkfZKKUHkjyaLTdg collected $7.60 from pot
*** SUMMARY ***
Total pot $8 | Rake $0.40
Board [4h 9d 6d 7d]
Seat 1: tkdBeXTJlFsZdioidNqLow (button) folded before Flop (didn't bet)
Seat 2: LUsAYklr0mQkiq7ASOyD9A (small blind) folded on the Turn
Seat 4: B/G0GJacqZ8K59/ZVdq4kQ (big blind) folded before Flop
Seat 5: Jjc7EHWzs4//xUAjJ0UWoA folded before Flop (didn't bet)
Seat 6: FJEywSpo5JbRKByzmweboA folded before Flop (didn't bet)
Seat 7: S3Ex8K7v6xm5jqjRM7Fl3w folded before Flop (didn't bet)
Seat 8: L9njYvloJ1NdXjP8edHEAg folded before Flop (didn't bet)
Seat 9: Pp/KTcXkfZKKUHkjyaLTdg collected ($7.60)



PokerStars Game #59941182720:  Hold'em No Limit ($0.50/$1.00) - 2009/07/01 1:28:00 ET
Table '+cA8mcmhaedZ7YcrDdhmeQ' 6-max Seat #5 is the button
Seat 1: 9XrTM0DuVxx1pjFAdSbD8A ($55.70 in chips)
Seat 2: 14aYclSc98EYd6TrzN2l3Q ($15.95 in chips)
Seat 3: DAIgyIWbYvAkL6PbAI27pg ($18.05 in chips)
Seat 4: 4OO5v3AVduL0tePNx8wk5A ($101 in chips)
Seat 5: n5xXfJeDtWZSChGAdq//Tw ($17.05 in chips)
Seat 6: YfsTQsY/fxb+YqbdclTHuw ($26.25 in chips)
YfsTQsY/fxb+YqbdclTHuw: posts small blind $0.50
9XrTM0DuVxx1pjFAdSbD8A: posts big blind $1
*** HOLE CARDS ***
14aYclSc98EYd6TrzN2l3Q: raises $1 to $2
DAIgyIWbYvAkL6PbAI27pg: folds
4OO5v3AVduL0tePNx8wk5A: folds
n5xXfJeDtWZSChGAdq//Tw: folds
YfsTQsY/fxb+YqbdclTHuw: calls $1.50
9XrTM0DuVxx1pjFAdSbD8A: calls $1
*** FLOP *** [5c Kd 3c]
YfsTQsY/fxb+YqbdclTHuw: checks
9XrTM0DuVxx1pjFAdSbD8A: checks
14aYclSc98EYd6TrzN2l3Q: bets $4
YfsTQsY/fxb+YqbdclTHuw: folds
9XrTM0DuVxx1pjFAdSbD8A: folds
14aYclSc98EYd6TrzN2l3Q collected $5.70 from pot
*** SUMMARY ***
Total pot $6 | Rake $0.30
Board [5c Kd 3c]
Seat 1: 9XrTM0DuVxx1pjFAdSbD8A (big blind) folded on the Flop
Seat 2: 14aYclSc98EYd6TrzN2l3Q collected ($5.70)
Seat 3: DAIgyIWbYvAkL6PbAI27pg folded before Flop (didn't bet)
Seat 4: 4OO5v3AVduL0tePNx8wk5A folded before Flop (didn't bet)
Seat 5: n5xXfJeDtWZSChGAdq//Tw (button) folded before Flop (didn't bet)
Seat 6: YfsTQsY/fxb+YqbdclTHuw (small blind) folded on the Flop



PokerStars Game #59941183046:  Hold'em No Limit ($0.50/$1.00) - 2009/07/01 1:28:01 ET
Table 'N6LvHFrb+cdXY/COI6ByOw' 2-max Seat #2 is the button
Seat 1: lXX4W7m3u++JiSOZ46yVMQ ($118.60 in chips)
Seat 2: 9mAoSP3o/mikSZOW2LEEAw ($80 in chips)
9mAoSP3o/mikSZOW2LEEAw: posts small blind $0.50
lXX4W7m3u++JiSOZ46yVMQ: posts big blind $1
*** HOLE CARDS ***
9mAoSP3o/mikSZOW2LEEAw: raises $1 to $2
lXX4W7m3u++JiSOZ46yVMQ: calls $1
*** FLOP *** [Qs Tc 9c]
lXX4W7m3u++JiSOZ46yVMQ: checks
9mAoSP3o/mikSZOW2LEEAw: bets $2
lXX4W7m3u++JiSOZ46yVMQ: folds
9mAoSP3o/mikSZOW2LEEAw collected $3.80 from pot
9mAoSP3o/mikSZOW2LEEAw: doesn't show hand
*** SUMMARY ***
Total pot $4 | Rake $0.20
Board [Qs Tc 9c]
Seat 1: lXX4W7m3u++JiSOZ46yVMQ (big blind) folded on the Flop
Seat 2: 9mAoSP3o/mikSZOW2LEEAw (button) (small blind) collected ($3.80)



PokerStars Game #59941183970:  Hold'em No Limit ($0.50/$1.00) - 2009/07/01 1:28:02 ET
Table 'MNvFfRVQNka/oY+Z5aMbZQ' 2-max Seat #1 is the button
Seat 1: DaZnoWHjO897dnh0CL2lVg ($77.60 in chips)
Seat 2: mgi+mjKb1Sc3CCs7TlfoCw ($82.25 in chips)
DaZnoWHjO897dnh0CL2lVg: posts small blind $0.50
mgi+mjKb1Sc3CCs7TlfoCw: posts big blind $1
*** HOLE CARDS ***
DaZnoWHjO897dnh0CL2lVg: raises $2 to $3
mgi+mjKb1Sc3CCs7TlfoCw: raises $10 to $13
DaZnoWHjO897dnh0CL2lVg: folds
mgi+mjKb1Sc3CCs7TlfoCw collected $6 from pot
mgi+mjKb1Sc3CCs7TlfoCw: doesn't show hand
*** SUMMARY ***
Total pot $6 | Rake $0
Seat 1: DaZnoWHjO897dnh0CL2lVg (button) (small blind) folded before Flop
Seat 2: mgi+mjKb1Sc3CCs7TlfoCw (big blind) collected ($6)



PokerStars Game #59941184076:  Hold'em No Limit ($0.50/$1.00) - 2009/07/01 1:28:03 ET
Table 'Evb7VW0qfDhFkbgBL3gcqQ' 2-max Seat #1 is the button
Seat 1: NYi6JFscYNrofSXy4sM+Yw ($164.85 in chips)
Seat 2: AoEQlM/FNYM0d7Txn1TfBQ ($38.65 in chips)
NYi6JFscYNrofSXy4sM+Yw: posts small blind $0.50
AoEQlM/FNYM0d7Txn1TfBQ: posts big blind $1
*** HOLE CARDS ***
NYi6JFscYNrofSXy4sM+Yw: raises $2 to $3
AoEQlM/FNYM0d7Txn1TfBQ: calls $2
*** FLOP *** [5d 7d Jc]
AoEQlM/FNYM0d7Txn1TfBQ: checks
NYi6JFscYNrofSXy4sM+Yw: bets $3
AoEQlM/FNYM0d7Txn1TfBQ: folds
NYi6JFscYNrofSXy4sM+Yw collected $5.70 from pot
*** SUMMARY ***
Total pot $6 | Rake $0.30
Board [5d 7d Jc]
Seat 1: NYi6JFscYNrofSXy4sM+Yw (button) (small blind) collected ($5.70)
Seat 2: AoEQlM/FNYM0d7Txn1TfBQ (big blind) folded on the Flop



PokerStars Game #59941184662:  Hold'em No Limit ($0.50/$1.00) - 2009/07/01 1:28:04 ET
Table 'jDQgUn1zGkyftPnHo0Awdw' 2-max Seat #2 is the button
Seat 1: a42+e5QB6s1kkG5FoSTZJw ($117.15 in chips)
Seat 2: q+vRKwm51mnr6kxX/161WQ ($77.90 in chips)
q+vRKwm51mnr6kxX/161WQ: posts small blind $0.50
a42+e5QB6s1kkG5FoSTZJw: posts big blind $1
*** HOLE CARDS ***
q+vRKwm51mnr6kxX/161WQ: raises $2 to $3
a42+e5QB6s1kkG5FoSTZJw: calls $2
*** FLOP *** [4d 2s Qh]
a42+e5QB6s1kkG5FoSTZJw: checks
q+vRKwm51mnr6kxX/161WQ: checks
*** TURN *** [4d 2s Qh] [Ad]
a42+e5QB6s1kkG5FoSTZJw: bets $5
q+vRKwm51mnr6kxX/161WQ: calls $5
*** RIVER *** [4d 2s Qh Ad] [9c]
a42+e5QB6s1kkG5FoSTZJw: checks
q+vRKwm51mnr6kxX/161WQ: bets $9
a42+e5QB6s1kkG5FoSTZJw: calls $9
*** SHOW DOWN ***
q+vRKwm51mnr6kxX/161WQ: shows [Ac 7c] (a pair of Aces)
a42+e5QB6s1kkG5FoSTZJw: mucks hand
q+vRKwm51mnr6kxX/161WQ collected $33.50 from pot
*** SUMMARY ***
Total pot $34 | Rake $0.50
Board [4d 2s Qh Ad 9c]
Seat 1: a42+e5QB6s1kkG5FoSTZJw (big blind) mucked
Seat 2: q+vRKwm51mnr6kxX/161WQ (button) (small blind) showed [Ac 7c] and won ($33.50) with a pair of Aces



PokerStars Game #59941185002:  Hold'em No Limit ($0.50/$1.00) - 2009/07/01 1:28:04 ET
Table 'GPp0HyAuggN8oE0sUWzPpA' 9-max Seat #3 is the button
Seat 2: m3U8I35Pn3gxKhoS2nmYIg ($26.75 in chips)
Seat 3: CCCXsirC+bO7ginAuUUVlQ ($53.10 in chips)
Seat 4: mBRWbnUl8diyBO1qTJaNzw ($99.15 in chips)
Seat 5: bLbSOSmSOnqE0iTcH/5dxA ($100 in chips)
Seat 6: BK/GtNPkSx0TdUDj82id5A ($37.40 in chips)
Seat 7: DHdbHyysD15wCAtx+BhUjA ($93.20 in chips)
Seat 8: P/6qLjycEfxRgZ5F/W90dw ($97.35 in chips)
Seat 9: myIxN7otsyr846M539YR8Q ($21.50 in chips)
mBRWbnUl8diyBO1qTJaNzw: posts small blind $0.50
bLbSOSmSOnqE0iTcH/5dxA: posts big blind $1
laA8va+Yv8WuMqT1zdR91g: sits out
*** HOLE CARDS ***
BK/GtNPkSx0TdUDj82id5A: calls $1
DHdbHyysD15wCAtx+BhUjA: folds
P/6qLjycEfxRgZ5F/W90dw: folds
myIxN7otsyr846M539YR8Q: folds
m3U8I35Pn3gxKhoS2nmYIg: calls $1
CCCXsirC+bO7ginAuUUVlQ: folds
mBRWbnUl8diyBO1qTJaNzw: folds
bLbSOSmSOnqE0iTcH/5dxA: checks
*** FLOP *** [Tc Jc 8s]
bLbSOSmSOnqE0iTcH/5dxA: checks
BK/GtNPkSx0TdUDj82id5A: bets $3
m3U8I35Pn3gxKhoS2nmYIg: folds
bLbSOSmSOnqE0iTcH/5dxA: folds
BK/GtNPkSx0TdUDj82id5A collected $3.35 from pot
*** SUMMARY ***
Total pot $3.50 | Rake $0.15
Board [Tc Jc 8s]
Seat 2: m3U8I35Pn3gxKhoS2nmYIg folded on the Flop
Seat 3: CCCXsirC+bO7ginAuUUVlQ (button) folded before Flop (didn't bet)
Seat 4: mBRWbnUl8diyBO1qTJaNzw (small blind) folded before Flop
Seat 5: bLbSOSmSOnqE0iTcH/5dxA (big blind) folded on the Flop
Seat 6: BK/GtNPkSx0TdUDj82id5A collected ($3.35)
Seat 7: DHdbHyysD15wCAtx+BhUjA folded before Flop (didn't bet)
Seat 8: P/6qLjycEfxRgZ5F/W90dw folded before Flop (didn't bet)
Seat 9: myIxN7otsyr846M539YR8Q folded before Flop (didn't bet)



PokerStars Game #59941185814:  Hold'em No Limit ($0.50/$1.00) - 2009/07/01 1:28:06 ET
Table '7Nl0ffnjeK44/vmeexh3MQ' 9-max Seat #4 is the button
Seat 1: V138SURkdX8LdVBPKdJJag ($101.50 in chips)
Seat 2: OGgaARGdJQT4awWVNQ957w ($100.50 in chips)
Seat 3: JMmUYT5pIKCKh2pGjCB/4w ($58.90 in chips)
Seat 4: bLbSOSmSOnqE0iTcH/5dxA ($103.80 in chips)
Seat 6: FVs16t7GgfWgQWt4JxsObQ ($25.35 in chips)
Seat 7: 997ViqAtWn1FPjJqcffwcA ($100 in chips)
Seat 8: D+W9Me7w6Hcx/WRUSKV0dw ($20 in chips)
61sfw5QTu62YYIt68OsdrA has timed out while being disconnected
61sfw5QTu62YYIt68OsdrA: is sitting out
FVs16t7GgfWgQWt4JxsObQ: posts small blind $0.50
997ViqAtWn1FPjJqcffwcA: posts big blind $1
/JHoNdt0fK6X+isrqRfV3w: sits out
*** HOLE CARDS ***
D+W9Me7w6Hcx/WRUSKV0dw: folds
61sfw5QTu62YYIt68OsdrA is disconnected
V138SURkdX8LdVBPKdJJag: folds
OGgaARGdJQT4awWVNQ957w: folds
JMmUYT5pIKCKh2pGjCB/4w: folds
bLbSOSmSOnqE0iTcH/5dxA: raises $3 to $4
FVs16t7GgfWgQWt4JxsObQ: folds
997ViqAtWn1FPjJqcffwcA: folds
61sfw5QTu62YYIt68OsdrA is connected
bLbSOSmSOnqE0iTcH/5dxA collected $2.50 from pot
bLbSOSmSOnqE0iTcH/5dxA: doesn't show hand
*** SUMMARY ***
Total pot $2.50 | Rake $0
Seat 1: V138SURkdX8LdVBPKdJJag folded before Flop (didn't bet)
Seat 2: OGgaARGdJQT4awWVNQ957w folded before Flop (didn't bet)
Seat 3: JMmUYT5pIKCKh2pGjCB/4w folded before Flop (didn't bet)
Seat 4: bLbSOSmSOnqE0iTcH/5dxA (button) collected ($2.50)
Seat 6: FVs16t7GgfWgQWt4JxsObQ (small blind) folded before Flop
Seat 7: 997ViqAtWn1FPjJqcffwcA (big blind) folded before Flop
Seat 8: D+W9Me7w6Hcx/WRUSKV0dw folded before Flop (didn't bet)



PokerStars Game #59941186298:  Hold'em No Limit ($0.50/$1.00) - 2009/07/01 1:28:07 ET
Table 'fTlPiCj0utgzC/5io+I7ew' 6-max Seat #4 is the button
Seat 1: YMJG+F++3Aj6P8dAWda5fw ($104.60 in chips)
Seat 2: qVr1nl3dy2xXPqS8UpTDlA ($20.30 in chips)
Seat 3: Z2fXsGcjl+Eax+RzOgwOmg ($140 in chips)
Seat 4: uJVSceLggtsrJya+WtmUEA ($162.15 in chips)
Seat 5: XUk5GQsfNFpHvaToDZ0rZA ($44.65 in chips)
Seat 6: y27w5IK2WXqmYzS8OU0wKA ($100 in chips)
XUk5GQsfNFpHvaToDZ0rZA: posts small blind $0.50
y27w5IK2WXqmYzS8OU0wKA: posts big blind $1
*** HOLE CARDS ***
YMJG+F++3Aj6P8dAWda5fw: folds
qVr1nl3dy2xXPqS8UpTDlA: calls $1
Z2fXsGcjl+Eax+RzOgwOmg: folds
uJVSceLggtsrJya+WtmUEA: raises $3 to $4
XUk5GQsfNFpHvaToDZ0rZA: folds
y27w5IK2WXqmYzS8OU0wKA: folds
qVr1nl3dy2xXPqS8UpTDlA: folds
uJVSceLggtsrJya+WtmUEA collected $3.50 from pot
*** SUMMARY ***
Total pot $3.50 | Rake $0
Seat 1: YMJG+F++3Aj6P8dAWda5fw folded before Flop (didn't bet)
Seat 2: qVr1nl3dy2xXPqS8UpTDlA folded before Flop
Seat 3: Z2fXsGcjl+Eax+RzOgwOmg folded before Flop (didn't bet)
Seat 4: uJVSceLggtsrJya+WtmUEA (button) collected ($3.50)
Seat 5: XUk5GQsfNFpHvaToDZ0rZA (small blind) folded before Flop
Seat 6: y27w5IK2WXqmYzS8OU0wKA (big blind) folded before Flop



PokerStars Game #59941187186:  Hold'em No Limit ($0.50/$1.00) - 2009/07/01 1:28:08 ET
Table 'ZFWj23PMihdwrNWv41OG/Q' 9-max Seat #1 is the button
Seat 1: yAbu2QsRPVcjPbqlf/jDxw ($122.35 in chips)
Seat 3: G9Fo2TZCN7HI43Po4zSN3A ($118.45 in chips)
Seat 5: tkdBeXTJlFsZdioidNqLow ($109.75 in chips)
Seat 6: 3obndzTJ6fECz8+wWhMd1w ($42.35 in chips)
Seat 7: 2uQqi2bcuMs+2q7ej+tN+Q ($92 in chips)
Seat 8: 997ViqAtWn1FPjJqcffwcA ($118.60 in chips)
Seat 9: 6XkTu4ahxzHnvjjc1R8YjQ ($98.50 in chips)
G9Fo2TZCN7HI43Po4zSN3A: posts small blind $0.50
D+W9Me7w6Hcx/WRUSKV0dw: is sitting out
tkdBeXTJlFsZdioidNqLow: posts big blind $1
*** HOLE CARDS ***
3obndzTJ6fECz8+wWhMd1w: folds
2uQqi2bcuMs+2q7ej+tN+Q: folds
997ViqAtWn1FPjJqcffwcA: folds
6XkTu4ahxzHnvjjc1R8YjQ: folds
yAbu2QsRPVcjPbqlf/jDxw: raises $2 to $3
G9Fo2TZCN7HI43Po4zSN3A: folds
tkdBeXTJlFsZdioidNqLow: folds
yAbu2QsRPVcjPbqlf/jDxw collected $2.50 from pot
yAbu2QsRPVcjPbqlf/jDxw: doesn't show hand
*** SUMMARY ***
Total pot $2.50 | Rake $0
Seat 1: yAbu2QsRPVcjPbqlf/jDxw (button) collected ($2.50)
Seat 3: G9Fo2TZCN7HI43Po4zSN3A (small blind) folded before Flop
Seat 5: tkdBeXTJlFsZdioidNqLow (big blind) folded before Flop
Seat 6: 3obndzTJ6fECz8+wWhMd1w folded before Flop (didn't bet)
Seat 7: 2uQqi2bcuMs+2q7ej+tN+Q folded before Flop (didn't bet)
Seat 8: 997ViqAtWn1FPjJqcffwcA folded before Flop (didn't bet)
Seat 9: 6XkTu4ahxzHnvjjc1R8YjQ folded before Flop (didn't bet)



PokerStars Game #59941187148:  Hold'em No Limit ($0.50/$1.00) - 2009/07/01 1:28:08 ET
Table 'kS0cTQAEi+fdUlJP2gQYvw' 9-max Seat #4 is the button
Seat 2: D+W9Me7w6Hcx/WRUSKV0dw ($25.05 in chips)
Seat 3: 2BV+oJIQYr65IO6nEChvbA ($67 in chips)
Seat 4: RUhhaALzha3TH1AkdakoGQ ($52.50 in chips)
Seat 5: 997ViqAtWn1FPjJqcffwcA ($100 in chips)
Seat 6: yAbu2QsRPVcjPbqlf/jDxw ($126.15 in chips)
Seat 7: Ffa7Nj4X5fddtROP01hfQg ($150.60 in chips)
Seat 8: vKyFzTyzfT7fZcdX+HHN+Q ($34.55 in chips)
Seat 9: OGgaARGdJQT4awWVNQ957w ($100 in chips)
997ViqAtWn1FPjJqcffwcA: posts small blind $0.50
yAbu2QsRPVcjPbqlf/jDxw: posts big blind $1
*** HOLE CARDS ***
Ffa7Nj4X5fddtROP01hfQg: folds
vKyFzTyzfT7fZcdX+HHN+Q: calls $1
OGgaARGdJQT4awWVNQ957w: folds
D+W9Me7w6Hcx/WRUSKV0dw: folds
2BV+oJIQYr65IO6nEChvbA: folds
RUhhaALzha3TH1AkdakoGQ: folds
997ViqAtWn1FPjJqcffwcA: folds
SqsWPukL8kLqrhq5ZrQdSQ joins the table at seat #1
yAbu2QsRPVcjPbqlf/jDxw: checks
*** FLOP *** [2d 8c Jh]
yAbu2QsRPVcjPbqlf/jDxw: checks
vKyFzTyzfT7fZcdX+HHN+Q: checks
*** TURN *** [2d 8c Jh] [Ks]
yAbu2QsRPVcjPbqlf/jDxw: checks
vKyFzTyzfT7fZcdX+HHN+Q: checks
*** RIVER *** [2d 8c Jh Ks] [Js]
yAbu2QsRPVcjPbqlf/jDxw: checks
vKyFzTyzfT7fZcdX+HHN+Q: checks
*** SHOW DOWN ***
yAbu2QsRPVcjPbqlf/jDxw: shows [4s 3c] (a pair of Jacks)
vKyFzTyzfT7fZcdX+HHN+Q: shows [Ac 7d] (a pair of Jacks - Ace kicker)
vKyFzTyzfT7fZcdX+HHN+Q collected $2.40 from pot
*** SUMMARY ***
Total pot $2.50 | Rake $0.10
Board [2d 8c Jh Ks Js]
Seat 2: D+W9Me7w6Hcx/WRUSKV0dw folded before Flop (didn't bet)
Seat 3: 2BV+oJIQYr65IO6nEChvbA folded before Flop (didn't bet)
Seat 4: RUhhaALzha3TH1AkdakoGQ (button) folded before Flop (didn't bet)
Seat 5: 997ViqAtWn1FPjJqcffwcA (small blind) folded before Flop
Seat 6: yAbu2QsRPVcjPbqlf/jDxw (big blind) showed [4s 3c] and lost with a pair of Jacks
Seat 7: Ffa7Nj4X5fddtROP01hfQg folded before Flop (didn't bet)
Seat 8: vKyFzTyzfT7fZcdX+HHN+Q showed [Ac 7d] and won ($2.40) with a pair of Jacks
Seat 9: OGgaARGdJQT4awWVNQ957w folded before Flop (didn't bet)



PokerStars Game #59941188164:  Hold'em No Limit ($0.50/$1.00) - 2009/07/01 1:28:10 ET
Table '/RZcOwpZpHQ+OwPwjsbnRw' 6-max Seat #1 is the button
Seat 1: +uSzP8Jwnw7sKfQ4s66b7w ($41.75 in chips)
Seat 2: Z2fXsGcjl+Eax+RzOgwOmg ($106.15 in chips)
Seat 4: j7NIOHLZk7V2o9fOioO5ug ($107.05 in chips)
Seat 5: wx3sQGkVi2x9wJXuWNHPBw ($164.55 in chips)
Seat 6: o3YLm/rSY916m/on1VjXPA ($199.50 in chips)
Z2fXsGcjl+Eax+RzOgwOmg: posts small blind $0.50
j7NIOHLZk7V2o9fOioO5ug: posts big blind $1
*** HOLE CARDS ***
wx3sQGkVi2x9wJXuWNHPBw: folds
o3YLm/rSY916m/on1VjXPA: folds
+uSzP8Jwnw7sKfQ4s66b7w: folds
Z2fXsGcjl+Eax+RzOgwOmg: folds
j7NIOHLZk7V2o9fOioO5ug collected $1 from pot
j7NIOHLZk7V2o9fOioO5ug: doesn't show hand
*** SUMMARY ***
Total pot $1 | Rake $0
Seat 1: +uSzP8Jwnw7sKfQ4s66b7w (button) folded before Flop (didn't bet)
Seat 2: Z2fXsGcjl+Eax+RzOgwOmg (small blind) folded before Flop
Seat 4: j7NIOHLZk7V2o9fOioO5ug (big blind) collected ($1)
Seat 5: wx3sQGkVi2x9wJXuWNHPBw folded before Flop (didn't bet)
Seat 6: o3YLm/rSY916m/on1VjXPA folded before Flop (didn't bet)



PokerStars Game #59941188280:  Hold'em No Limit ($0.50/$1.00) - 2009/07/01 1:28:10 ET
Table '305hiksPPCCdC6V2LNsO5w' 6-max Seat #1 is the button
Seat 1: RTuDLJHh/9zPfBftoc9vsw ($11 in chips)
Seat 2: j7NIOHLZk7V2o9fOioO5ug ($131 in chips)
Seat 3: +zIVjZKLpcidfRHgVZW8lA ($32.20 in chips)
Seat 4: uJVSceLggtsrJya+WtmUEA ($214.55 in chips)
Seat 5: +Nt3OPk3XR9SKjZgm2CexQ ($112.65 in chips)
Seat 6: 9/Tq8dw7kWW68uN8bFupXg ($16.40 in chips)
j7NIOHLZk7V2o9fOioO5ug: posts small blind $0.50
+zIVjZKLpcidfRHgVZW8lA: posts big blind $1
*** HOLE CARDS ***
uJVSceLggtsrJya+WtmUEA: folds
+Nt3OPk3XR9SKjZgm2CexQ: raises $2 to $3
9/Tq8dw7kWW68uN8bFupXg: raises $13.40 to $16.40 and is all-in
RTuDLJHh/9zPfBftoc9vsw: folds
j7NIOHLZk7V2o9fOioO5ug: folds
+zIVjZKLpcidfRHgVZW8lA: folds
+Nt3OPk3XR9SKjZgm2CexQ: folds
9/Tq8dw7kWW68uN8bFupXg collected $7.50 from pot
*** SUMMARY ***
Total pot $7.50 | Rake $0
Seat 1: RTuDLJHh/9zPfBftoc9vsw (button) folded before Flop (didn't bet)
Seat 2: j7NIOHLZk7V2o9fOioO5ug (small blind) folded before Flop
Seat 3: +zIVjZKLpcidfRHgVZW8lA (big blind) folded before Flop
Seat 4: uJVSceLggtsrJya+WtmUEA folded before Flop (didn't bet)
Seat 5: +Nt3OPk3XR9SKjZgm2CexQ folded before Flop
Seat 6: 9/Tq8dw7kWW68uN8bFupXg collected ($7.50)



PokerStars Game #59941189180:  Hold'em No Limit ($0.50/$1.00) - 2009/07/01 1:28:12 ET
Table '/FUb199IViHMJHi5YWmeuQ' 9-max Seat #5 is the button
Seat 1: 3obndzTJ6fECz8+wWhMd1w ($18.50 in chips)
Seat 2: FL3MrLspcF23LYvC4ipBOA ($185.55 in chips)
Seat 3: V138SURkdX8LdVBPKdJJag ($125.25 in chips)
Seat 4: pbAfmxe4uSZPxJQX7gOzZA ($72.20 in chips)
Seat 5: H+DVy3Ei8L1UKS2tVOtJcw ($136.85 in chips)
Seat 6: VPF+HjszMvUIpy0CHIwH3A ($22 in chips)
Seat 7: myIxN7otsyr846M539YR8Q ($20 in chips)
Seat 8: 997ViqAtWn1FPjJqcffwcA ($100 in chips)
Seat 9: RfLbneGRY8yQUpMgDnJCxA ($70.85 in chips)
VPF+HjszMvUIpy0CHIwH3A: posts small blind $0.50
myIxN7otsyr846M539YR8Q: posts big blind $1
*** HOLE CARDS ***
997ViqAtWn1FPjJqcffwcA: folds
RfLbneGRY8yQUpMgDnJCxA: calls $1
3obndzTJ6fECz8+wWhMd1w: folds
FL3MrLspcF23LYvC4ipBOA: folds
V138SURkdX8LdVBPKdJJag: folds
pbAfmxe4uSZPxJQX7gOzZA: raises $1 to $2
H+DVy3Ei8L1UKS2tVOtJcw: folds
VPF+HjszMvUIpy0CHIwH3A: folds
myIxN7otsyr846M539YR8Q: folds
RfLbneGRY8yQUpMgDnJCxA: raises $4 to $6
pbAfmxe4uSZPxJQX7gOzZA: calls $4
*** FLOP *** [Jd 8c 8h]
RfLbneGRY8yQUpMgDnJCxA: bets $6
pbAfmxe4uSZPxJQX7gOzZA: folds
RfLbneGRY8yQUpMgDnJCxA collected $12.85 from pot
*** SUMMARY ***
Total pot $13.50 | Rake $0.65
Board [Jd 8c 8h]
Seat 1: 3obndzTJ6fECz8+wWhMd1w folded before Flop (didn't bet)
Seat 2: FL3MrLspcF23LYvC4ipBOA folded before Flop (didn't bet)
Seat 3: V138SURkdX8LdVBPKdJJag folded before Flop (didn't bet)
Seat 4: pbAfmxe4uSZPxJQX7gOzZA folded on the Flop
Seat 5: H+DVy3Ei8L1UKS2tVOtJcw (button) folded before Flop (didn't bet)
Seat 6: VPF+HjszMvUIpy0CHIwH3A (small blind) folded before Flop
Seat 7: myIxN7otsyr846M539YR8Q (big blind) folded before Flop
Seat 8: 997ViqAtWn1FPjJqcffwcA folded before Flop (didn't bet)
Seat 9: RfLbneGRY8yQUpMgDnJCxA collected ($12.85)



PokerStars Game #59941191192:  Hold'em No Limit ($0.50/$1.00) - 2009/07/01 1:28:15 ET
Table 'N6LvHFrb+cdXY/COI6ByOw' 2-max Seat #1 is the button
Seat 1: lXX4W7m3u++JiSOZ46yVMQ ($116.60 in chips)
Seat 2: 9mAoSP3o/mikSZOW2LEEAw ($81.80 in chips)
lXX4W7m3u++JiSOZ46yVMQ: posts small blind $0.50
9mAoSP3o/mikSZOW2LEEAw: posts big blind $1
*** HOLE CARDS ***
lXX4W7m3u++JiSOZ46yVMQ: raises $2 to $3
9mAoSP3o/mikSZOW2LEEAw: calls $2
*** FLOP *** [2h As 2d]
9mAoSP3o/mikSZOW2LEEAw: bets $2
lXX4W7m3u++JiSOZ46yVMQ: folds
9mAoSP3o/mikSZOW2LEEAw collected $5.70 from pot
9mAoSP3o/mikSZOW2LEEAw: shows [9s Qd] (a pair of Deuces)
*** SUMMARY ***
Total pot $6 | Rake $0.30
Board [2h As 2d]
Seat 1: lXX4W7m3u++JiSOZ46yVMQ (button) (small blind) folded on the Flop
Seat 2: 9mAoSP3o/mikSZOW2LEEAw (big blind) collected ($5.70)



PokerStars Game #59941192446:  Hold'em No Limit ($0.50/$1.00) - 2009/07/01 1:28:17 ET
Table 'Evb7VW0qfDhFkbgBL3gcqQ' 2-max Seat #2 is the button
Seat 1: NYi6JFscYNrofSXy4sM+Yw ($167.55 in chips)
Seat 2: AoEQlM/FNYM0d7Txn1TfBQ ($35.65 in chips)
AoEQlM/FNYM0d7Txn1TfBQ: posts small blind $0.50
NYi6JFscYNrofSXy4sM+Yw: posts big blind $1
*** HOLE CARDS ***
AoEQlM/FNYM0d7Txn1TfBQ: folds
NYi6JFscYNrofSXy4sM+Yw collected $1 from pot
*** SUMMARY ***
Total pot $1 | Rake $0
Seat 1: NYi6JFscYNrofSXy4sM+Yw (big blind) collected ($1)
Seat 2: AoEQlM/FNYM0d7Txn1TfBQ (button) (small blind) folded before Flop



PokerStars Game #59941194164:  Hold'em No Limit ($0.50/$1.00) - 2009/07/01 1:28:20 ET
Table 'fZjVbKj9D8yOB+Rj7NaP/A' 9-max Seat #4 is the button
Seat 1: 9BZCcac3+McErkkSN2YScA ($102.25 in chips)
Seat 2: PTAFYDIUSsG+SArbxNl+Aw ($105.50 in chips)
Seat 3: yAbu2QsRPVcjPbqlf/jDxw ($101 in chips)
Seat 4: 997ViqAtWn1FPjJqcffwcA ($100 in chips)
Seat 5: PkGfq5xrSlNsujKaG/HF4Q ($100 in chips)
Seat 6: OvwYHV65yUbgdBjSmo1+5g ($77.40 in chips)
Seat 7: SyS20PAm3RpT6uLBsGkwOA ($84.60 in chips)
Seat 8: zDOE5r14tWqCf6xhuSHK6g ($52.90 in chips)
Seat 9: qheQay5YvP2DMAb3OUSxtw ($99 in chips)
PkGfq5xrSlNsujKaG/HF4Q: posts small blind $0.50
OvwYHV65yUbgdBjSmo1+5g: posts big blind $1
*** HOLE CARDS ***
SyS20PAm3RpT6uLBsGkwOA: folds
zDOE5r14tWqCf6xhuSHK6g: folds
qheQay5YvP2DMAb3OUSxtw: raises $3 to $4
9BZCcac3+McErkkSN2YScA: folds
PTAFYDIUSsG+SArbxNl+Aw: folds
yAbu2QsRPVcjPbqlf/jDxw: folds
997ViqAtWn1FPjJqcffwcA: folds
PkGfq5xrSlNsujKaG/HF4Q: folds
OvwYHV65yUbgdBjSmo1+5g: folds
qheQay5YvP2DMAb3OUSxtw collected $2.50 from pot
qheQay5YvP2DMAb3OUSxtw: doesn't show hand
*** SUMMARY ***
Total pot $2.50 | Rake $0
Seat 1: 9BZCcac3+McErkkSN2YScA folded before Flop (didn't bet)
Seat 2: PTAFYDIUSsG+SArbxNl+Aw folded before Flop (didn't bet)
Seat 3: yAbu2QsRPVcjPbqlf/jDxw folded before Flop (didn't bet)
Seat 4: 997ViqAtWn1FPjJqcffwcA (button) folded before Flop (didn't bet)
Seat 5: PkGfq5xrSlNsujKaG/HF4Q (small blind) folded before Flop
Seat 6: OvwYHV65yUbgdBjSmo1+5g (big blind) folded before Flop
Seat 7: SyS20PAm3RpT6uLBsGkwOA folded before Flop (didn't bet)
Seat 8: zDOE5r14tWqCf6xhuSHK6g folded before Flop (didn't bet)
Seat 9: qheQay5YvP2DMAb3OUSxtw collected ($2.50)



PokerStars Game #59941195376:  Hold'em No Limit ($0.50/$1.00) - 2009/07/01 1:28:23 ET
Table 'blHlQApStil0OPeQxQxPcw' 9-max Seat #4 is the button
Seat 1: Pp/KTcXkfZKKUHkjyaLTdg ($22.30 in chips)
Seat 2: V138SURkdX8LdVBPKdJJag ($124.35 in chips)
Seat 3: OGgaARGdJQT4awWVNQ957w ($100 in chips)
Seat 4: e3u1tVujx+9fNGL+1+YnaQ ($32.85 in chips)
Seat 5: uXrDE6JrIi8BZK1L8oQ9bQ ($60.10 in chips)
Seat 6: vljeiOoWscAIXU0fCuiEBw ($46.15 in chips)
Seat 7: GTQkFJtSkbVbnGCktp6e3g ($116.60 in chips)
Seat 8: laA8va+Yv8WuMqT1zdR91g ($100 in chips)
Seat 9: 6XkTu4ahxzHnvjjc1R8YjQ ($100 in chips)
uXrDE6JrIi8BZK1L8oQ9bQ: posts small blind $0.50
vljeiOoWscAIXU0fCuiEBw: posts big blind $1
*** HOLE CARDS ***
GTQkFJtSkbVbnGCktp6e3g: folds
laA8va+Yv8WuMqT1zdR91g: folds
6XkTu4ahxzHnvjjc1R8YjQ: folds
Pp/KTcXkfZKKUHkjyaLTdg: folds
V138SURkdX8LdVBPKdJJag: folds
OGgaARGdJQT4awWVNQ957w: folds
e3u1tVujx+9fNGL+1+YnaQ: calls $1
uXrDE6JrIi8BZK1L8oQ9bQ: raises $3 to $4
vljeiOoWscAIXU0fCuiEBw: calls $3
e3u1tVujx+9fNGL+1+YnaQ: calls $3
*** FLOP *** [4h As 2c]
uXrDE6JrIi8BZK1L8oQ9bQ: bets $1
vljeiOoWscAIXU0fCuiEBw: calls $1
e3u1tVujx+9fNGL+1+YnaQ: calls $1
*** TURN *** [4h As 2c] [2s]
uXrDE6JrIi8BZK1L8oQ9bQ: checks
vljeiOoWscAIXU0fCuiEBw: checks
e3u1tVujx+9fNGL+1+YnaQ: bets $5
uXrDE6JrIi8BZK1L8oQ9bQ: folds
vljeiOoWscAIXU0fCuiEBw: folds
e3u1tVujx+9fNGL+1+YnaQ collected $14.30 from pot
*** SUMMARY ***
Total pot $15 | Rake $0.70
Board [4h As 2c 2s]
Seat 1: Pp/KTcXkfZKKUHkjyaLTdg folded before Flop (didn't bet)
Seat 2: V138SURkdX8LdVBPKdJJag folded before Flop (didn't bet)
Seat 3: OGgaARGdJQT4awWVNQ957w folded before Flop (didn't bet)
Seat 4: e3u1tVujx+9fNGL+1+YnaQ (button) collected ($14.30)
Seat 5: uXrDE6JrIi8BZK1L8oQ9bQ (small blind) folded on the Turn
Seat 6: vljeiOoWscAIXU0fCuiEBw (big blind) folded on the Turn
Seat 7: GTQkFJtSkbVbnGCktp6e3g folded before Flop (didn't bet)
Seat 8: laA8va+Yv8WuMqT1zdR91g folded before Flop (didn't bet)
Seat 9: 6XkTu4ahxzHnvjjc1R8YjQ folded before Flop (didn't bet)



PokerStars Game #59941195880:  Hold'em No Limit ($0.50/$1.00) - 2009/07/01 1:28:23 ET
Table 'Evb7VW0qfDhFkbgBL3gcqQ' 2-max Seat #1 is the button
Seat 1: NYi6JFscYNrofSXy4sM+Yw ($168.05 in chips)
Seat 2: AoEQlM/FNYM0d7Txn1TfBQ ($35.15 in chips)
NYi6JFscYNrofSXy4sM+Yw: posts small blind $0.50
AoEQlM/FNYM0d7Txn1TfBQ: posts big blind $1
*** HOLE CARDS ***
NYi6JFscYNrofSXy4sM+Yw: raises $2 to $3
AoEQlM/FNYM0d7Txn1TfBQ: calls $2
*** FLOP *** [7h Ac 7c]
AoEQlM/FNYM0d7Txn1TfBQ: checks
NYi6JFscYNrofSXy4sM+Yw: bets $3
AoEQlM/FNYM0d7Txn1TfBQ: folds
NYi6JFscYNrofSXy4sM+Yw collected $5.70 from pot
*** SUMMARY ***
Total pot $6 | Rake $0.30
Board [7h Ac 7c]
Seat 1: NYi6JFscYNrofSXy4sM+Yw (button) (small blind) collected ($5.70)
Seat 2: AoEQlM/FNYM0d7Txn1TfBQ (big blind) folded on the Flop



PokerStars Game #59941195852:  Hold'em No Limit ($0.50/$1.00) - 2009/07/01 1:28:23 ET
Table 'N2bNCDHL96aCQDvZIh+yQQ' 6-max Seat #3 is the button
Seat 1: Jjgflx10PVjcLkziEmLhSA ($40.10 in chips)
Seat 2: y27w5IK2WXqmYzS8OU0wKA ($100.90 in chips)
Seat 3: UBZQqpnJZdTYYY1FTb0rLA ($122.05 in chips)
Seat 4: uCqEjnxh2/vFBjKYkfTOkw ($210.60 in chips)
Seat 5: frvgHLr3+LfZtjsBCBs3NA ($57.30 in chips)
uCqEjnxh2/vFBjKYkfTOkw: posts small blind $0.50
frvgHLr3+LfZtjsBCBs3NA: posts big blind $1
idVgoPAdspFPCzee6aF9Pg: sits out
*** HOLE CARDS ***
Jjgflx10PVjcLkziEmLhSA: folds
y27w5IK2WXqmYzS8OU0wKA: folds
UBZQqpnJZdTYYY1FTb0rLA: folds
uCqEjnxh2/vFBjKYkfTOkw: calls $0.50
frvgHLr3+LfZtjsBCBs3NA: raises $3 to $4
uCqEjnxh2/vFBjKYkfTOkw: calls $3
*** FLOP *** [6c 9h Ah]
uCqEjnxh2/vFBjKYkfTOkw: checks
frvgHLr3+LfZtjsBCBs3NA: bets $3
uCqEjnxh2/vFBjKYkfTOkw: calls $3
*** TURN *** [6c 9h Ah] [Th]
uCqEjnxh2/vFBjKYkfTOkw: bets $8
frvgHLr3+LfZtjsBCBs3NA: calls $8
*** RIVER *** [6c 9h Ah Th] [8d]
uCqEjnxh2/vFBjKYkfTOkw: bets $12
frvgHLr3+LfZtjsBCBs3NA: calls $12
*** SHOW DOWN ***
uCqEjnxh2/vFBjKYkfTOkw: shows [9c 6h] (two pair, Nines and Sixes)
frvgHLr3+LfZtjsBCBs3NA: shows [Qh Ac] (a pair of Aces)
uCqEjnxh2/vFBjKYkfTOkw collected $52 from pot
*** SUMMARY ***
Total pot $54 | Rake $2
Board [6c 9h Ah Th 8d]
Seat 1: Jjgflx10PVjcLkziEmLhSA folded before Flop (didn't bet)
Seat 2: y27w5IK2WXqmYzS8OU0wKA folded before Flop (didn't bet)
Seat 3: UBZQqpnJZdTYYY1FTb0rLA (button) folded before Flop (didn't bet)
Seat 4: uCqEjnxh2/vFBjKYkfTOkw (small blind) showed [9c 6h] and won ($52) with two pair, Nines and Sixes
Seat 5: frvgHLr3+LfZtjsBCBs3NA (big blind) showed [Qh Ac] and lost with a pair of Aces



PokerStars Game #59941196190:  Hold'em No Limit ($0.50/$1.00) - 2009/07/01 1:28:24 ET
Table 'mmbQQVBTrPdE+wy+s+9VPA' 6-max Seat #5 is the button
Seat 1: zyP4SPoWZnKUfTvIRLCVog ($75.35 in chips)
Seat 2: XK4Qsl+DA8gAJyg85/zBIw ($33.10 in chips)
Seat 3: wx3sQGkVi2x9wJXuWNHPBw ($126.35 in chips)
Seat 4: V3iZdcw61nXF3g5hD2RrsQ ($100 in chips)
Seat 5: YMJG+F++3Aj6P8dAWda5fw ($123.90 in chips)
Seat 6: U2CWBTv29qdCbj8RNF2sIw ($113.75 in chips)
U2CWBTv29qdCbj8RNF2sIw: posts small blind $0.50
zyP4SPoWZnKUfTvIRLCVog: posts big blind $1
*** HOLE CARDS ***
XK4Qsl+DA8gAJyg85/zBIw: folds
wx3sQGkVi2x9wJXuWNHPBw: folds
V3iZdcw61nXF3g5hD2RrsQ: folds
YMJG+F++3Aj6P8dAWda5fw: folds
U2CWBTv29qdCbj8RNF2sIw: raises $2 to $3
zyP4SPoWZnKUfTvIRLCVog: calls $2
*** FLOP *** [Jc Ts Js]
U2CWBTv29qdCbj8RNF2sIw: bets $3
zyP4SPoWZnKUfTvIRLCVog: calls $3
*** TURN *** [Jc Ts Js] [2c]
U2CWBTv29qdCbj8RNF2sIw: checks
zyP4SPoWZnKUfTvIRLCVog: checks
*** RIVER *** [Jc Ts Js 2c] [6d]
U2CWBTv29qdCbj8RNF2sIw: checks
zyP4SPoWZnKUfTvIRLCVog: checks
*** SHOW DOWN ***
U2CWBTv29qdCbj8RNF2sIw: shows [9s 9c] (two pair, Jacks and Nines)
zyP4SPoWZnKUfTvIRLCVog: mucks hand
U2CWBTv29qdCbj8RNF2sIw collected $11.45 from pot
*** SUMMARY ***
Total pot $12 | Rake $0.55
Board [Jc Ts Js 2c 6d]
Seat 1: zyP4SPoWZnKUfTvIRLCVog (big blind) mucked
Seat 2: XK4Qsl+DA8gAJyg85/zBIw folded before Flop (didn't bet)
Seat 3: wx3sQGkVi2x9wJXuWNHPBw folded before Flop (didn't bet)
Seat 4: V3iZdcw61nXF3g5hD2RrsQ folded before Flop (didn't bet)
Seat 5: YMJG+F++3Aj6P8dAWda5fw (button) folded before Flop (didn't bet)
Seat 6: U2CWBTv29qdCbj8RNF2sIw (small blind) showed [9s 9c] and won ($11.45) with two pair, Jacks and Nines



PokerStars Game #59941196892:  Hold'em No Limit ($0.50/$1.00) - 2009/07/01 1:28:25 ET
Table 'vs/5jr6ciwjVQ5+Soc+u2A' 6-max Seat #4 is the button
Seat 1: J798qwLuvXyq0BbzsIjOrA ($161.95 in chips)
Seat 2: lXX4W7m3u++JiSOZ46yVMQ ($100.65 in chips)
Seat 3: G5ZSSN6RSON3gkNvk/SmYg ($119.10 in chips)
Seat 4: wk6Ohn4GDozoOMHc4eb2rw ($53.80 in chips)
Seat 5: +Nt3OPk3XR9SKjZgm2CexQ ($163.40 in chips)
Seat 6: Z2fXsGcjl+Eax+RzOgwOmg ($106 in chips)
+Nt3OPk3XR9SKjZgm2CexQ: posts small blind $0.50
Z2fXsGcjl+Eax+RzOgwOmg: posts big blind $1
*** HOLE CARDS ***
J798qwLuvXyq0BbzsIjOrA: folds
lXX4W7m3u++JiSOZ46yVMQ: folds
G5ZSSN6RSON3gkNvk/SmYg: folds
wk6Ohn4GDozoOMHc4eb2rw: folds
+Nt3OPk3XR9SKjZgm2CexQ: raises $2 to $3
Z2fXsGcjl+Eax+RzOgwOmg: folds
+Nt3OPk3XR9SKjZgm2CexQ collected $2 from pot
+Nt3OPk3XR9SKjZgm2CexQ: doesn't show hand
*** SUMMARY ***
Total pot $2 | Rake $0
Seat 1: J798qwLuvXyq0BbzsIjOrA folded before Flop (didn't bet)
Seat 2: lXX4W7m3u++JiSOZ46yVMQ folded before Flop (didn't bet)
Seat 3: G5ZSSN6RSON3gkNvk/SmYg folded before Flop (didn't bet)
Seat 4: wk6Ohn4GDozoOMHc4eb2rw (button) folded before Flop (didn't bet)
Seat 5: +Nt3OPk3XR9SKjZgm2CexQ (small blind) collected ($2)
Seat 6: Z2fXsGcjl+Eax+RzOgwOmg (big blind) folded before Flop



PokerStars Game #59941197716:  Hold'em No Limit ($0.50/$1.00) - 2009/07/01 1:28:27 ET
Table 'MUPc8FEpe/nR0BKSeReX6Q' 6-max Seat #3 is the button
Seat 1: qhkK6+yCciTRd+rCFEbnEQ ($83.20 in chips)
Seat 2: xAU6q2/cwmby2sxmA8VcmA ($105.20 in chips)
Seat 3: wx3sQGkVi2x9wJXuWNHPBw ($285.50 in chips)
Seat 4: r4lpoh2BJZ8S6zyQv1JeSw ($100 in chips)
Seat 5: y27w5IK2WXqmYzS8OU0wKA ($104.05 in chips)
Seat 6: oxnw0GLLpFanjhGkxfRSqA ($134.50 in chips)
r4lpoh2BJZ8S6zyQv1JeSw: posts small blind $0.50
y27w5IK2WXqmYzS8OU0wKA: posts big blind $1
*** HOLE CARDS ***
oxnw0GLLpFanjhGkxfRSqA: folds
qhkK6+yCciTRd+rCFEbnEQ: folds
oxnw0GLLpFanjhGkxfRSqA is sitting out
xAU6q2/cwmby2sxmA8VcmA: folds
oxnw0GLLpFanjhGkxfRSqA leaves the table
wx3sQGkVi2x9wJXuWNHPBw: folds
r4lpoh2BJZ8S6zyQv1JeSw: folds
y27w5IK2WXqmYzS8OU0wKA collected $1 from pot
y27w5IK2WXqmYzS8OU0wKA: doesn't show hand
*** SUMMARY ***
Total pot $1 | Rake $0
Seat 1: qhkK6+yCciTRd+rCFEbnEQ folded before Flop (didn't bet)
Seat 2: xAU6q2/cwmby2sxmA8VcmA folded before Flop (didn't bet)
Seat 3: wx3sQGkVi2x9wJXuWNHPBw (button) folded before Flop (didn't bet)
Seat 4: r4lpoh2BJZ8S6zyQv1JeSw (small blind) folded before Flop
Seat 5: y27w5IK2WXqmYzS8OU0wKA (big blind) collected ($1)
Seat 6: oxnw0GLLpFanjhGkxfRSqA folded before Flop (didn't bet)



PokerStars Game #59941197780:  Hold'em No Limit ($0.50/$1.00) - 2009/07/01 1:28:27 ET
Table 'MNvFfRVQNka/oY+Z5aMbZQ' 2-max Seat #2 is the button
Seat 1: DaZnoWHjO897dnh0CL2lVg ($74.60 in chips)
Seat 2: mgi+mjKb1Sc3CCs7TlfoCw ($85.25 in chips)
mgi+mjKb1Sc3CCs7TlfoCw: posts small blind $0.50
DaZnoWHjO897dnh0CL2lVg: posts big blind $1
*** HOLE CARDS ***
mgi+mjKb1Sc3CCs7TlfoCw: raises $2 to $3
DaZnoWHjO897dnh0CL2lVg: calls $2
*** FLOP *** [7d Ts 9d]
DaZnoWHjO897dnh0CL2lVg: checks
mgi+mjKb1Sc3CCs7TlfoCw: checks
*** TURN *** [7d Ts 9d] [Qd]
DaZnoWHjO897dnh0CL2lVg: checks
mgi+mjKb1Sc3CCs7TlfoCw: checks
*** RIVER *** [7d Ts 9d Qd] [9s]
DaZnoWHjO897dnh0CL2lVg: checks
mgi+mjKb1Sc3CCs7TlfoCw: checks
*** SHOW DOWN ***
DaZnoWHjO897dnh0CL2lVg: shows [6h Kh] (a pair of Nines)
mgi+mjKb1Sc3CCs7TlfoCw: shows [As 4h] (a pair of Nines - Ace kicker)
mgi+mjKb1Sc3CCs7TlfoCw collected $5.70 from pot
*** SUMMARY ***
Total pot $6 | Rake $0.30
Board [7d Ts 9d Qd 9s]
Seat 1: DaZnoWHjO897dnh0CL2lVg (big blind) showed [6h Kh] and lost with a pair of Nines
Seat 2: mgi+mjKb1Sc3CCs7TlfoCw (button) (small blind) showed [As 4h] and won ($5.70) with a pair of Nines



PokerStars Game #59941198640:  Hold'em No Limit ($0.50/$1.00) - 2009/07/01 1:28:28 ET
Table 'O96CPOtvMBWP6kzuYDfdFA' 6-max Seat #3 is the button
Seat 1: 6alLXQIITA2EZ/lBeym8Dw ($118.75 in chips)
Seat 2: 4d1rWhpu8DzLmzMbR3QKyA ($111.60 in chips)
Seat 3: V89DGjxE171oPREEbAXiyg ($119.25 in chips)
Seat 4: /P4w1pHg2zHYg/4ubJ0dPw ($67.15 in chips)
Seat 5: G5ZSSN6RSON3gkNvk/SmYg ($104.15 in chips)
/P4w1pHg2zHYg/4ubJ0dPw: posts small blind $0.50
G5ZSSN6RSON3gkNvk/SmYg: posts big blind $1
*** HOLE CARDS ***
6alLXQIITA2EZ/lBeym8Dw: folds
4d1rWhpu8DzLmzMbR3QKyA: folds
V89DGjxE171oPREEbAXiyg: folds
/P4w1pHg2zHYg/4ubJ0dPw: folds
G5ZSSN6RSON3gkNvk/SmYg collected $1 from pot
*** SUMMARY ***
Total pot $1 | Rake $0
Seat 1: 6alLXQIITA2EZ/lBeym8Dw folded before Flop (didn't bet)
Seat 2: 4d1rWhpu8DzLmzMbR3QKyA folded before Flop (didn't bet)
Seat 3: V89DGjxE171oPREEbAXiyg (button) folded before Flop (didn't bet)
Seat 4: /P4w1pHg2zHYg/4ubJ0dPw (small blind) folded before Flop
Seat 5: G5ZSSN6RSON3gkNvk/SmYg (big blind) collected ($1)



PokerStars Game #59941199742:  Hold'em No Limit ($0.50/$1.00) - 2009/07/01 1:28:30 ET
Table 'W/wyObTiXZm+Ckkl3YxcSw' 6-max Seat #6 is the button
Seat 1: eUBBn2R56C1IQ6Cs/vitwg ($292.55 in chips)
Seat 2: oDiBRCaF0QVtd3kO6xZIXw ($160.25 in chips)
Seat 3: dxyNCn/qxfkGDUIf28Cbng ($63.80 in chips)
Seat 4: UBZQqpnJZdTYYY1FTb0rLA ($103.20 in chips)
Seat 5: +OrCjyw70oZhJiD22Mn+bg ($100 in chips)
Seat 6: b2a+5TkFf4xJN/Ihhma58Q ($37.95 in chips)
eUBBn2R56C1IQ6Cs/vitwg: posts small blind $0.50
oDiBRCaF0QVtd3kO6xZIXw: posts big blind $1
*** HOLE CARDS ***
dxyNCn/qxfkGDUIf28Cbng: calls $1
UBZQqpnJZdTYYY1FTb0rLA: folds
+OrCjyw70oZhJiD22Mn+bg: raises $4 to $5
b2a+5TkFf4xJN/Ihhma58Q: folds
eUBBn2R56C1IQ6Cs/vitwg: folds
oDiBRCaF0QVtd3kO6xZIXw: folds
dxyNCn/qxfkGDUIf28Cbng: folds
+OrCjyw70oZhJiD22Mn+bg collected $3.50 from pot
+OrCjyw70oZhJiD22Mn+bg: doesn't show hand
*** SUMMARY ***
Total pot $3.50 | Rake $0
Seat 1: eUBBn2R56C1IQ6Cs/vitwg (small blind) folded before Flop
Seat 2: oDiBRCaF0QVtd3kO6xZIXw (big blind) folded before Flop
Seat 3: dxyNCn/qxfkGDUIf28Cbng folded before Flop
Seat 4: UBZQqpnJZdTYYY1FTb0rLA folded before Flop (didn't bet)
Seat 5: +OrCjyw70oZhJiD22Mn+bg collected ($3.50)
Seat 6: b2a+5TkFf4xJN/Ihhma58Q (button) folded before Flop (didn't bet)



PokerStars Game #59941201656:  Hold'em No Limit ($0.50/$1.00) - 2009/07/01 1:28:33 ET
Table 'NqGO/cV3MwFAx+ZPB5ANmQ' 2-max Seat #1 is the button
Seat 1: ItaRAnHOgvYOv5ynbG1iTw ($51.80 in chips)
Seat 2: GtFB+yyeb2djMdPFuOW/Xg ($154.50 in chips)
ItaRAnHOgvYOv5ynbG1iTw: posts small blind $0.50
GtFB+yyeb2djMdPFuOW/Xg: posts big blind $1
*** HOLE CARDS ***
ItaRAnHOgvYOv5ynbG1iTw: raises $2 to $3
GtFB+yyeb2djMdPFuOW/Xg: calls $2
*** FLOP *** [Tc 4h Ks]
GtFB+yyeb2djMdPFuOW/Xg: checks
ItaRAnHOgvYOv5ynbG1iTw: bets $4
GtFB+yyeb2djMdPFuOW/Xg: raises $10 to $14
ItaRAnHOgvYOv5ynbG1iTw: calls $10
*** TURN *** [Tc 4h Ks] [9c]
GtFB+yyeb2djMdPFuOW/Xg: bets $10
ItaRAnHOgvYOv5ynbG1iTw: calls $10
*** RIVER *** [Tc 4h Ks 9c] [2d]
GtFB+yyeb2djMdPFuOW/Xg: bets $37
ItaRAnHOgvYOv5ynbG1iTw: folds
GtFB+yyeb2djMdPFuOW/Xg collected $53.50 from pot
*** SUMMARY ***
Total pot $54 | Rake $0.50
Board [Tc 4h Ks 9c 2d]
Seat 1: ItaRAnHOgvYOv5ynbG1iTw (button) (small blind) folded on the River
Seat 2: GtFB+yyeb2djMdPFuOW/Xg (big blind) collected ($53.50)



PokerStars Game #59941201876:  Hold'em No Limit ($0.50/$1.00) - 2009/07/01 1:28:34 ET
Table 'pHrhryH8jPNdQfY62f8v+g' 6-max Seat #6 is the button
Seat 1: 4d1rWhpu8DzLmzMbR3QKyA ($132.25 in chips)
Seat 2: JwCcjZl0bjJzG7hmE0dnTA ($105.55 in chips)
Seat 3: 8oS5O7iD/qnFXFXJrGIgNQ ($110.15 in chips)
Seat 4: 1f3beyIML24UqEMTbWy93g ($50.40 in chips)
Seat 5: r1/R7y0Ortgoz4lccgW8VA ($7.75 in chips)
Seat 6: xAU6q2/cwmby2sxmA8VcmA ($204.25 in chips)
4d1rWhpu8DzLmzMbR3QKyA: posts small blind $0.50
JwCcjZl0bjJzG7hmE0dnTA: posts big blind $1
*** HOLE CARDS ***
8oS5O7iD/qnFXFXJrGIgNQ: folds
1f3beyIML24UqEMTbWy93g: folds
r1/R7y0Ortgoz4lccgW8VA: folds
xAU6q2/cwmby2sxmA8VcmA: raises $3 to $4
4d1rWhpu8DzLmzMbR3QKyA: folds
JwCcjZl0bjJzG7hmE0dnTA: raises $8 to $12
xAU6q2/cwmby2sxmA8VcmA: raises $14 to $26
JwCcjZl0bjJzG7hmE0dnTA: raises $79.55 to $105.55 and is all-in
xAU6q2/cwmby2sxmA8VcmA: folds
JwCcjZl0bjJzG7hmE0dnTA collected $52.50 from pot
JwCcjZl0bjJzG7hmE0dnTA: doesn't show hand
*** SUMMARY ***
Total pot $52.50 | Rake $0
Seat 1: 4d1rWhpu8DzLmzMbR3QKyA (small blind) folded before Flop
Seat 2: JwCcjZl0bjJzG7hmE0dnTA (big blind) collected ($52.50)
Seat 3: 8oS5O7iD/qnFXFXJrGIgNQ folded before Flop (didn't bet)
Seat 4: 1f3beyIML24UqEMTbWy93g folded before Flop (didn't bet)
Seat 5: r1/R7y0Ortgoz4lccgW8VA folded before Flop (didn't bet)
Seat 6: xAU6q2/cwmby2sxmA8VcmA (button) folded before Flop



PokerStars Game #59941202560:  Hold'em No Limit ($0.50/$1.00) - 2009/07/01 1:28:35 ET
Table 'cBDNutyLBKEk9+ptwsKmTw' 6-max Seat #6 is the button
Seat 1: xAU6q2/cwmby2sxmA8VcmA ($298.05 in chips)
Seat 2: 4OO5v3AVduL0tePNx8wk5A ($106.55 in chips)
Seat 3: G5ZSSN6RSON3gkNvk/SmYg ($108.90 in chips)
Seat 4: OMkHNxIUZxh1pHqcCjbjgw ($94.50 in chips)
Seat 5: hpxXcmRkXXI9HE5+5/j/0Q ($103 in chips)
Seat 6: QHvTZcrKe6+maWUfVjP29Q ($150 in chips)
xAU6q2/cwmby2sxmA8VcmA: posts small blind $0.50
4OO5v3AVduL0tePNx8wk5A: posts big blind $1
*** HOLE CARDS ***
G5ZSSN6RSON3gkNvk/SmYg: folds
OMkHNxIUZxh1pHqcCjbjgw: folds
hpxXcmRkXXI9HE5+5/j/0Q: folds
QHvTZcrKe6+maWUfVjP29Q: folds
xAU6q2/cwmby2sxmA8VcmA: raises $3 to $4
4OO5v3AVduL0tePNx8wk5A: folds
xAU6q2/cwmby2sxmA8VcmA collected $2 from pot
xAU6q2/cwmby2sxmA8VcmA: doesn't show hand
*** SUMMARY ***
Total pot $2 | Rake $0
Seat 1: xAU6q2/cwmby2sxmA8VcmA (small blind) collected ($2)
Seat 2: 4OO5v3AVduL0tePNx8wk5A (big blind) folded before Flop
Seat 3: G5ZSSN6RSON3gkNvk/SmYg folded before Flop (didn't bet)
Seat 4: OMkHNxIUZxh1pHqcCjbjgw folded before Flop (didn't bet)
Seat 5: hpxXcmRkXXI9HE5+5/j/0Q folded before Flop (didn't bet)
Seat 6: QHvTZcrKe6+maWUfVjP29Q (button) folded before Flop (didn't bet)



PokerStars Game #59941203888:  Hold'em No Limit ($0.50/$1.00) - 2009/07/01 1:28:37 ET
Table 'Evb7VW0qfDhFkbgBL3gcqQ' 2-max Seat #2 is the button
Seat 1: NYi6JFscYNrofSXy4sM+Yw ($170.75 in chips)
Seat 2: AoEQlM/FNYM0d7Txn1TfBQ ($32.15 in chips)
AoEQlM/FNYM0d7Txn1TfBQ: posts small blind $0.50
NYi6JFscYNrofSXy4sM+Yw: posts big blind $1
*** HOLE CARDS ***
AoEQlM/FNYM0d7Txn1TfBQ: folds
NYi6JFscYNrofSXy4sM+Yw collected $1 from pot
NYi6JFscYNrofSXy4sM+Yw: doesn't show hand
*** SUMMARY ***
Total pot $1 | Rake $0
Seat 1: NYi6JFscYNrofSXy4sM+Yw (big blind) collected ($1)
Seat 2: AoEQlM/FNYM0d7Txn1TfBQ (button) (small blind) folded before Flop



PokerStars Game #59941205142:  Hold'em No Limit ($0.50/$1.00) - 2009/07/01 1:28:39 ET
Table 'tJq9SfN1ywY0r03VBlWlwQ' 9-max Seat #7 is the button
Seat 1: wZsU+w9r7G66x93UuvBf1Q ($300.55 in chips)
Seat 4: bLbSOSmSOnqE0iTcH/5dxA ($113.65 in chips)
Seat 5: h5ipsNTMyolp7xn/NAvWkA ($129 in chips)
Seat 6: gUUvmqdVlmvpal6B8nYrmg ($100 in chips)
Seat 7: Pp/KTcXkfZKKUHkjyaLTdg ($34.05 in chips)
Seat 8: G4DEhsZFmznGNVpy2SEocA ($42.80 in chips)
Seat 9: XE5QF1y74bpHog9JxWJMWQ ($100 in chips)
G4DEhsZFmznGNVpy2SEocA: posts small blind $0.50
XE5QF1y74bpHog9JxWJMWQ: posts big blind $1
VPF+HjszMvUIpy0CHIwH3A: sits out
*** HOLE CARDS ***
wZsU+w9r7G66x93UuvBf1Q: raises $3 to $4
bLbSOSmSOnqE0iTcH/5dxA: folds
h5ipsNTMyolp7xn/NAvWkA: folds
gUUvmqdVlmvpal6B8nYrmg: folds
Pp/KTcXkfZKKUHkjyaLTdg: folds
G4DEhsZFmznGNVpy2SEocA: folds
XE5QF1y74bpHog9JxWJMWQ: folds
wZsU+w9r7G66x93UuvBf1Q collected $2.50 from pot
*** SUMMARY ***
Total pot $2.50 | Rake $0
Seat 1: wZsU+w9r7G66x93UuvBf1Q collected ($2.50)
Seat 4: bLbSOSmSOnqE0iTcH/5dxA folded before Flop (didn't bet)
Seat 5: h5ipsNTMyolp7xn/NAvWkA folded before Flop (didn't bet)
Seat 6: gUUvmqdVlmvpal6B8nYrmg folded before Flop (didn't bet)
Seat 7: Pp/KTcXkfZKKUHkjyaLTdg (button) folded before Flop (didn't bet)
Seat 8: G4DEhsZFmznGNVpy2SEocA (small blind) folded before Flop
Seat 9: XE5QF1y74bpHog9JxWJMWQ (big blind) folded before Flop



PokerStars Game #59941205658:  Hold'em No Limit ($0.50/$1.00) - 2009/07/01 1:28:40 ET
Table 'QSIig7BLMc9wY/rgBechzw' 6-max Seat #4 is the button
Seat 1: Z2fXsGcjl+Eax+RzOgwOmg ($100 in chips)
Seat 2: mLOIkH/qmRa+mVujQIhBRg ($46.90 in chips)
Seat 3: +xW7QemQU0Fxs+4TnqBRow ($110 in chips)
Seat 4: +uSzP8Jwnw7sKfQ4s66b7w ($63.95 in chips)
Seat 5: lsLuWlcPA3Rh7kJVLzMh0Q ($100 in chips)
Seat 6: PxqfkAMdAWtkgbT+q2gciA ($67.60 in chips)
lsLuWlcPA3Rh7kJVLzMh0Q: posts small blind $0.50
PxqfkAMdAWtkgbT+q2gciA: posts big blind $1
*** HOLE CARDS ***
Z2fXsGcjl+Eax+RzOgwOmg: folds
mLOIkH/qmRa+mVujQIhBRg: folds
+xW7QemQU0Fxs+4TnqBRow: folds
+uSzP8Jwnw7sKfQ4s66b7w: folds
lsLuWlcPA3Rh7kJVLzMh0Q: folds
PxqfkAMdAWtkgbT+q2gciA collected $1 from pot
*** SUMMARY ***
Total pot $1 | Rake $0
Seat 1: Z2fXsGcjl+Eax+RzOgwOmg folded before Flop (didn't bet)
Seat 2: mLOIkH/qmRa+mVujQIhBRg folded before Flop (didn't bet)
Seat 3: +xW7QemQU0Fxs+4TnqBRow folded before Flop (didn't bet)
Seat 4: +uSzP8Jwnw7sKfQ4s66b7w (button) folded before Flop (didn't bet)
Seat 5: lsLuWlcPA3Rh7kJVLzMh0Q (small blind) folded before Flop
Seat 6: PxqfkAMdAWtkgbT+q2gciA (big blind) collected ($1)



PokerStars Game #59941206086:  Hold'em No Limit ($0.50/$1.00) - 2009/07/01 1:28:41 ET
Table 'N6LvHFrb+cdXY/COI6ByOw' 2-max Seat #2 is the button
Seat 1: lXX4W7m3u++JiSOZ46yVMQ ($113.60 in chips)
Seat 2: 9mAoSP3o/mikSZOW2LEEAw ($84.50 in chips)
9mAoSP3o/mikSZOW2LEEAw: posts small blind $0.50
lXX4W7m3u++JiSOZ46yVMQ: posts big blind $1
*** HOLE CARDS ***
9mAoSP3o/mikSZOW2LEEAw: raises $1 to $2
lXX4W7m3u++JiSOZ46yVMQ: calls $1
*** FLOP *** [As 4d 2c]
lXX4W7m3u++JiSOZ46yVMQ: checks
9mAoSP3o/mikSZOW2LEEAw: checks
*** TURN *** [As 4d 2c] [6s]
lXX4W7m3u++JiSOZ46yVMQ: checks
9mAoSP3o/mikSZOW2LEEAw: checks
*** RIVER *** [As 4d 2c 6s] [Js]
lXX4W7m3u++JiSOZ46yVMQ: checks
9mAoSP3o/mikSZOW2LEEAw: checks
*** SHOW DOWN ***
lXX4W7m3u++JiSOZ46yVMQ: shows [Th Kc] (high card Ace)
9mAoSP3o/mikSZOW2LEEAw: mucks hand
lXX4W7m3u++JiSOZ46yVMQ collected $3.80 from pot
*** SUMMARY ***
Total pot $4 | Rake $0.20
Board [As 4d 2c 6s Js]
Seat 1: lXX4W7m3u++JiSOZ46yVMQ (big blind) showed [Th Kc] and won ($3.80) with high card Ace
Seat 2: 9mAoSP3o/mikSZOW2LEEAw (button) (small blind) mucked



PokerStars Game #59941207266:  Hold'em No Limit ($0.50/$1.00) - 2009/07/01 1:28:43 ET
Table 'fTlPiCj0utgzC/5io+I7ew' 6-max Seat #5 is the button
Seat 1: YMJG+F++3Aj6P8dAWda5fw ($104.60 in chips)
Seat 2: qVr1nl3dy2xXPqS8UpTDlA ($19.30 in chips)
Seat 3: Z2fXsGcjl+Eax+RzOgwOmg ($140 in chips)
Seat 4: uJVSceLggtsrJya+WtmUEA ($164.65 in chips)
Seat 5: XUk5GQsfNFpHvaToDZ0rZA ($44.15 in chips)
Seat 6: y27w5IK2WXqmYzS8OU0wKA ($100 in chips)
y27w5IK2WXqmYzS8OU0wKA: posts small blind $0.50
YMJG+F++3Aj6P8dAWda5fw: posts big blind $1
*** HOLE CARDS ***
qVr1nl3dy2xXPqS8UpTDlA: folds
Z2fXsGcjl+Eax+RzOgwOmg: folds
uJVSceLggtsrJya+WtmUEA: folds
XUk5GQsfNFpHvaToDZ0rZA: folds
y27w5IK2WXqmYzS8OU0wKA: folds
YMJG+F++3Aj6P8dAWda5fw collected $1 from pot
*** SUMMARY ***
Total pot $1 | Rake $0
Seat 1: YMJG+F++3Aj6P8dAWda5fw (big blind) collected ($1)
Seat 2: qVr1nl3dy2xXPqS8UpTDlA folded before Flop (didn't bet)
Seat 3: Z2fXsGcjl+Eax+RzOgwOmg folded before Flop (didn't bet)
Seat 4: uJVSceLggtsrJya+WtmUEA folded before Flop (didn't bet)
Seat 5: XUk5GQsfNFpHvaToDZ0rZA (button) folded before Flop (didn't bet)
Seat 6: y27w5IK2WXqmYzS8OU0wKA (small blind) folded before Flop



PokerStars Game #59941207630:  Hold'em No Limit ($0.50/$1.00) - 2009/07/01 1:28:44 ET
Table 'MUPc8FEpe/nR0BKSeReX6Q' 6-max Seat #4 is the button
Seat 1: qhkK6+yCciTRd+rCFEbnEQ ($83.20 in chips)
Seat 2: xAU6q2/cwmby2sxmA8VcmA ($105.20 in chips)
Seat 3: wx3sQGkVi2x9wJXuWNHPBw ($285.50 in chips)
Seat 4: r4lpoh2BJZ8S6zyQv1JeSw ($100 in chips)
Seat 5: y27w5IK2WXqmYzS8OU0wKA ($104.55 in chips)
y27w5IK2WXqmYzS8OU0wKA: posts small blind $0.50
qhkK6+yCciTRd+rCFEbnEQ: posts big blind $1
*** HOLE CARDS ***
xAU6q2/cwmby2sxmA8VcmA: folds
wx3sQGkVi2x9wJXuWNHPBw: folds
r4lpoh2BJZ8S6zyQv1JeSw: folds
y27w5IK2WXqmYzS8OU0wKA: raises $2 to $3
qhkK6+yCciTRd+rCFEbnEQ: folds
y27w5IK2WXqmYzS8OU0wKA collected $2 from pot
y27w5IK2WXqmYzS8OU0wKA: doesn't show hand
*** SUMMARY ***
Total pot $2 | Rake $0
Seat 1: qhkK6+yCciTRd+rCFEbnEQ (big blind) folded before Flop
Seat 2: xAU6q2/cwmby2sxmA8VcmA folded before Flop (didn't bet)
Seat 3: wx3sQGkVi2x9wJXuWNHPBw folded before Flop (didn't bet)
Seat 4: r4lpoh2BJZ8S6zyQv1JeSw (button) folded before Flop (didn't bet)
Seat 5: y27w5IK2WXqmYzS8OU0wKA (small blind) collected ($2)



PokerStars Game #59941207780:  Hold'em No Limit ($0.50/$1.00) - 2009/07/01 1:28:44 ET
Table '7O9fB8yx1u7sJveJn8w6jA' 6-max Seat #1 is the button
Seat 1: jy52+7FotjH63o5tEEVgKw ($87.60 in chips)
Seat 2: wx3sQGkVi2x9wJXuWNHPBw ($194.20 in chips)
Seat 3: hpxXcmRkXXI9HE5+5/j/0Q ($121.25 in chips)
Seat 4: b2a+5TkFf4xJN/Ihhma58Q ($33.55 in chips)
Seat 5: BCEV3COoKY607AzLWayfRA ($100 in chips)
wx3sQGkVi2x9wJXuWNHPBw: posts small blind $0.50
hpxXcmRkXXI9HE5+5/j/0Q: posts big blind $1
r4lpoh2BJZ8S6zyQv1JeSw: sits out
*** HOLE CARDS ***
b2a+5TkFf4xJN/Ihhma58Q: folds
BCEV3COoKY607AzLWayfRA: folds
jy52+7FotjH63o5tEEVgKw: calls $1
wx3sQGkVi2x9wJXuWNHPBw: folds
hpxXcmRkXXI9HE5+5/j/0Q: checks
*** FLOP *** [As Ks 4d]
hpxXcmRkXXI9HE5+5/j/0Q: bets $2
jy52+7FotjH63o5tEEVgKw: calls $2
*** TURN *** [As Ks 4d] [8h]
hpxXcmRkXXI9HE5+5/j/0Q: bets $5
jy52+7FotjH63o5tEEVgKw: calls $5
*** RIVER *** [As Ks 4d 8h] [Jh]
hpxXcmRkXXI9HE5+5/j/0Q: bets $11
jy52+7FotjH63o5tEEVgKw: calls $11
*** SHOW DOWN ***
hpxXcmRkXXI9HE5+5/j/0Q: shows [Ac 8d] (two pair, Aces and Eights)
jy52+7FotjH63o5tEEVgKw: mucks hand
hpxXcmRkXXI9HE5+5/j/0Q collected $36.65 from pot
*** SUMMARY ***
Total pot $38.50 | Rake $1.85
Board [As Ks 4d 8h Jh]
Seat 1: jy52+7FotjH63o5tEEVgKw (button) mucked
Seat 2: wx3sQGkVi2x9wJXuWNHPBw (small blind) folded before Flop
Seat 3: hpxXcmRkXXI9HE5+5/j/0Q (big blind) showed [Ac 8d] and won ($36.65) with two pair, Aces and Eights
Seat 4: b2a+5TkFf4xJN/Ihhma58Q folded before Flop (didn't bet)
Seat 5: BCEV3COoKY607AzLWayfRA folded before Flop (didn't bet)



PokerStars Game #59941209846:  Hold'em No Limit ($0.50/$1.00) - 2009/07/01 1:28:47 ET
Table 'jDQgUn1zGkyftPnHo0Awdw' 2-max Seat #1 is the button
Seat 1: a42+e5QB6s1kkG5FoSTZJw ($100.15 in chips)
Seat 2: q+vRKwm51mnr6kxX/161WQ ($94.40 in chips)
a42+e5QB6s1kkG5FoSTZJw: posts small blind $0.50
q+vRKwm51mnr6kxX/161WQ: posts big blind $1
*** HOLE CARDS ***
a42+e5QB6s1kkG5FoSTZJw: raises $3 to $4
q+vRKwm51mnr6kxX/161WQ: folds
a42+e5QB6s1kkG5FoSTZJw collected $2 from pot
a42+e5QB6s1kkG5FoSTZJw: doesn't show hand
*** SUMMARY ***
Total pot $2 | Rake $0
Seat 1: a42+e5QB6s1kkG5FoSTZJw (button) (small blind) collected ($2)
Seat 2: q+vRKwm51mnr6kxX/161WQ (big blind) folded before Flop



PokerStars Game #59941210296:  Hold'em No Limit ($0.50/$1.00) - 2009/07/01 1:28:48 ET
Table 'MNvFfRVQNka/oY+Z5aMbZQ' 2-max Seat #1 is the button
Seat 1: DaZnoWHjO897dnh0CL2lVg ($71.60 in chips)
Seat 2: mgi+mjKb1Sc3CCs7TlfoCw ($87.95 in chips)
DaZnoWHjO897dnh0CL2lVg: posts small blind $0.50
mgi+mjKb1Sc3CCs7TlfoCw: posts big blind $1
*** HOLE CARDS ***
DaZnoWHjO897dnh0CL2lVg: raises $2 to $3
mgi+mjKb1Sc3CCs7TlfoCw: folds
DaZnoWHjO897dnh0CL2lVg collected $2 from pot
DaZnoWHjO897dnh0CL2lVg: doesn't show hand
*** SUMMARY ***
Total pot $2 | Rake $0
Seat 1: DaZnoWHjO897dnh0CL2lVg (button) (small blind) collected ($2)
Seat 2: mgi+mjKb1Sc3CCs7TlfoCw (big blind) folded before Flop



PokerStars Game #59941210408:  Hold'em No Limit ($0.50/$1.00) - 2009/07/01 1:28:48 ET
Table 'vs/5jr6ciwjVQ5+Soc+u2A' 6-max Seat #5 is the button
Seat 1: J798qwLuvXyq0BbzsIjOrA ($161.95 in chips)
Seat 2: lXX4W7m3u++JiSOZ46yVMQ ($100.65 in chips)
Seat 3: G5ZSSN6RSON3gkNvk/SmYg ($119.10 in chips)
Seat 4: wk6Ohn4GDozoOMHc4eb2rw ($53.80 in chips)
Seat 5: +Nt3OPk3XR9SKjZgm2CexQ ($164.40 in chips)
Seat 6: Z2fXsGcjl+Eax+RzOgwOmg ($105 in chips)
Z2fXsGcjl+Eax+RzOgwOmg: posts small blind $0.50
J798qwLuvXyq0BbzsIjOrA: posts big blind $1
*** HOLE CARDS ***
lXX4W7m3u++JiSOZ46yVMQ: folds
G5ZSSN6RSON3gkNvk/SmYg: folds
wk6Ohn4GDozoOMHc4eb2rw: raises $2 to $3
+Nt3OPk3XR9SKjZgm2CexQ: folds
Z2fXsGcjl+Eax+RzOgwOmg: folds
J798qwLuvXyq0BbzsIjOrA: calls $2
*** FLOP *** [7s 7h 9s]
J798qwLuvXyq0BbzsIjOrA: checks
wk6Ohn4GDozoOMHc4eb2rw: checks
*** TURN *** [7s 7h 9s] [5d]
J798qwLuvXyq0BbzsIjOrA: checks
wk6Ohn4GDozoOMHc4eb2rw: checks
*** RIVER *** [7s 7h 9s 5d] [6c]
J798qwLuvXyq0BbzsIjOrA: checks
wk6Ohn4GDozoOMHc4eb2rw: checks
*** SHOW DOWN ***
J798qwLuvXyq0BbzsIjOrA: shows [As 5s] (two pair, Sevens and Fives)
wk6Ohn4GDozoOMHc4eb2rw: mucks hand
J798qwLuvXyq0BbzsIjOrA collected $6.20 from pot
*** SUMMARY ***
Total pot $6.50 | Rake $0.30
Board [7s 7h 9s 5d 6c]
Seat 1: J798qwLuvXyq0BbzsIjOrA (big blind) showed [As 5s] and won ($6.20) with two pair, Sevens and Fives
Seat 2: lXX4W7m3u++JiSOZ46yVMQ folded before Flop (didn't bet)
Seat 3: G5ZSSN6RSON3gkNvk/SmYg folded before Flop (didn't bet)
Seat 4: wk6Ohn4GDozoOMHc4eb2rw mucked
Seat 5: +Nt3OPk3XR9SKjZgm2CexQ (button) folded before Flop (didn't bet)
Seat 6: Z2fXsGcjl+Eax+RzOgwOmg (small blind) folded before Flop



PokerStars Game #59941210888:  Hold'em No Limit ($0.50/$1.00) - 2009/07/01 1:28:49 ET
Table '/RZcOwpZpHQ+OwPwjsbnRw' 6-max Seat #2 is the button
Seat 1: +uSzP8Jwnw7sKfQ4s66b7w ($41.75 in chips)
Seat 2: Z2fXsGcjl+Eax+RzOgwOmg ($105.65 in chips)
Seat 4: j7NIOHLZk7V2o9fOioO5ug ($107.55 in chips)
Seat 5: wx3sQGkVi2x9wJXuWNHPBw ($164.55 in chips)
Seat 6: o3YLm/rSY916m/on1VjXPA ($199.50 in chips)
j7NIOHLZk7V2o9fOioO5ug: posts small blind $0.50
wx3sQGkVi2x9wJXuWNHPBw: posts big blind $1
*** HOLE CARDS ***
o3YLm/rSY916m/on1VjXPA: folds
+uSzP8Jwnw7sKfQ4s66b7w: folds
Z2fXsGcjl+Eax+RzOgwOmg: raises $2 to $3
j7NIOHLZk7V2o9fOioO5ug: folds
wx3sQGkVi2x9wJXuWNHPBw: calls $2
*** FLOP *** [8s Qh Tc]
wx3sQGkVi2x9wJXuWNHPBw: checks
Z2fXsGcjl+Eax+RzOgwOmg: checks
*** TURN *** [8s Qh Tc] [Qc]
wx3sQGkVi2x9wJXuWNHPBw: bets $4
Z2fXsGcjl+Eax+RzOgwOmg: folds
wx3sQGkVi2x9wJXuWNHPBw collected $6.20 from pot
*** SUMMARY ***
Total pot $6.50 | Rake $0.30
Board [8s Qh Tc Qc]
Seat 1: +uSzP8Jwnw7sKfQ4s66b7w folded before Flop (didn't bet)
Seat 2: Z2fXsGcjl+Eax+RzOgwOmg (button) folded on the Turn
Seat 4: j7NIOHLZk7V2o9fOioO5ug (small blind) folded before Flop
Seat 5: wx3sQGkVi2x9wJXuWNHPBw (big blind) collected ($6.20)
Seat 6: o3YLm/rSY916m/on1VjXPA folded before Flop (didn't bet)



PokerStars Game #59941211330:  Hold'em No Limit ($0.50/$1.00) - 2009/07/01 1:28:50 ET
Table 'O96CPOtvMBWP6kzuYDfdFA' 6-max Seat #4 is the button
Seat 1: 6alLXQIITA2EZ/lBeym8Dw ($118.75 in chips)
Seat 2: 4d1rWhpu8DzLmzMbR3QKyA ($111.60 in chips)
Seat 3: V89DGjxE171oPREEbAXiyg ($119.25 in chips)
Seat 4: /P4w1pHg2zHYg/4ubJ0dPw ($66.65 in chips)
Seat 5: G5ZSSN6RSON3gkNvk/SmYg ($104.65 in chips)
G5ZSSN6RSON3gkNvk/SmYg: posts small blind $0.50
6alLXQIITA2EZ/lBeym8Dw: posts big blind $1
*** HOLE CARDS ***
4d1rWhpu8DzLmzMbR3QKyA: folds
V89DGjxE171oPREEbAXiyg: folds
/P4w1pHg2zHYg/4ubJ0dPw: folds
G5ZSSN6RSON3gkNvk/SmYg: raises $2 to $3
6alLXQIITA2EZ/lBeym8Dw: folds
G5ZSSN6RSON3gkNvk/SmYg collected $2 from pot
*** SUMMARY ***
Total pot $2 | Rake $0
Seat 1: 6alLXQIITA2EZ/lBeym8Dw (big blind) folded before Flop
Seat 2: 4d1rWhpu8DzLmzMbR3QKyA folded before Flop (didn't bet)
Seat 3: V89DGjxE171oPREEbAXiyg folded before Flop (didn't bet)
Seat 4: /P4w1pHg2zHYg/4ubJ0dPw (button) folded before Flop (didn't bet)
Seat 5: G5ZSSN6RSON3gkNvk/SmYg (small blind) collected ($2)



PokerStars Game #59941211520:  Hold'em No Limit ($0.50/$1.00) - 2009/07/01 1:28:50 ET
Table '305hiksPPCCdC6V2LNsO5w' 6-max Seat #2 is the button
Seat 1: RTuDLJHh/9zPfBftoc9vsw ($11 in chips)
Seat 2: j7NIOHLZk7V2o9fOioO5ug ($130.50 in chips)
Seat 3: +zIVjZKLpcidfRHgVZW8lA ($31.20 in chips)
Seat 4: uJVSceLggtsrJya+WtmUEA ($214.55 in chips)
Seat 5: +Nt3OPk3XR9SKjZgm2CexQ ($109.65 in chips)
Seat 6: 9/Tq8dw7kWW68uN8bFupXg ($20.90 in chips)
+zIVjZKLpcidfRHgVZW8lA: posts small blind $0.50
uJVSceLggtsrJya+WtmUEA: posts big blind $1
*** HOLE CARDS ***
+Nt3OPk3XR9SKjZgm2CexQ: raises $2 to $3
9/Tq8dw7kWW68uN8bFupXg: folds
RTuDLJHh/9zPfBftoc9vsw: folds
j7NIOHLZk7V2o9fOioO5ug: folds
+zIVjZKLpcidfRHgVZW8lA: folds
uJVSceLggtsrJya+WtmUEA: folds
+Nt3OPk3XR9SKjZgm2CexQ collected $2.50 from pot
*** SUMMARY ***
Total pot $2.50 | Rake $0
Seat 1: RTuDLJHh/9zPfBftoc9vsw folded before Flop (didn't bet)
Seat 2: j7NIOHLZk7V2o9fOioO5ug (button) folded before Flop (didn't bet)
Seat 3: +zIVjZKLpcidfRHgVZW8lA (small blind) folded before Flop
Seat 4: uJVSceLggtsrJya+WtmUEA (big blind) folded before Flop
Seat 5: +Nt3OPk3XR9SKjZgm2CexQ collected ($2.50)
Seat 6: 9/Tq8dw7kWW68uN8bFupXg folded before Flop (didn't bet)



PokerStars Game #59941212180:  Hold'em No Limit ($0.50/$1.00) - 2009/07/01 1:28:52 ET
Table 'fZjVbKj9D8yOB+Rj7NaP/A' 9-max Seat #5 is the button
Seat 1: 9BZCcac3+McErkkSN2YScA ($102.25 in chips)
Seat 2: PTAFYDIUSsG+SArbxNl+Aw ($105.50 in chips)
Seat 3: yAbu2QsRPVcjPbqlf/jDxw ($101 in chips)
Seat 4: 997ViqAtWn1FPjJqcffwcA ($100 in chips)
Seat 5: PkGfq5xrSlNsujKaG/HF4Q ($100 in chips)
Seat 6: OvwYHV65yUbgdBjSmo1+5g ($76.40 in chips)
Seat 7: SyS20PAm3RpT6uLBsGkwOA ($84.60 in chips)
Seat 8: zDOE5r14tWqCf6xhuSHK6g ($52.90 in chips)
Seat 9: qheQay5YvP2DMAb3OUSxtw ($100.50 in chips)
OvwYHV65yUbgdBjSmo1+5g: posts small blind $0.50
SyS20PAm3RpT6uLBsGkwOA: posts big blind $1
*** HOLE CARDS ***
zDOE5r14tWqCf6xhuSHK6g: folds
qheQay5YvP2DMAb3OUSxtw: folds
9BZCcac3+McErkkSN2YScA: folds
PTAFYDIUSsG+SArbxNl+Aw: folds
yAbu2QsRPVcjPbqlf/jDxw: raises $3 to $4
997ViqAtWn1FPjJqcffwcA: folds
PkGfq5xrSlNsujKaG/HF4Q: folds
OvwYHV65yUbgdBjSmo1+5g: calls $3.50
SyS20PAm3RpT6uLBsGkwOA: calls $3
*** FLOP *** [Ks 6d Qc]
OvwYHV65yUbgdBjSmo1+5g: checks
SyS20PAm3RpT6uLBsGkwOA: bets $10
yAbu2QsRPVcjPbqlf/jDxw: calls $10
OvwYHV65yUbgdBjSmo1+5g: raises $10 to $20
SyS20PAm3RpT6uLBsGkwOA: folds
yAbu2QsRPVcjPbqlf/jDxw: calls $10
*** TURN *** [Ks 6d Qc] [8h]
OvwYHV65yUbgdBjSmo1+5g: bets $10
yAbu2QsRPVcjPbqlf/jDxw: calls $10
*** RIVER *** [Ks 6d Qc 8h] [9d]
OvwYHV65yUbgdBjSmo1+5g: bets $10
yAbu2QsRPVcjPbqlf/jDxw: calls $10
*** SHOW DOWN ***
OvwYHV65yUbgdBjSmo1+5g: shows [Qs Kc] (two pair, Kings and Queens)
yAbu2QsRPVcjPbqlf/jDxw: mucks hand
OvwYHV65yUbgdBjSmo1+5g collected $99 from pot
*** SUMMARY ***
Total pot $102 | Rake $3
Board [Ks 6d Qc 8h 9d]
Seat 1: 9BZCcac3+McErkkSN2YScA folded before Flop (didn't bet)
Seat 2: PTAFYDIUSsG+SArbxNl+Aw folded before Flop (didn't bet)
Seat 3: yAbu2QsRPVcjPbqlf/jDxw mucked
Seat 4: 997ViqAtWn1FPjJqcffwcA folded before Flop (didn't bet)
Seat 5: PkGfq5xrSlNsujKaG/HF4Q (button) folded before Flop (didn't bet)
Seat 6: OvwYHV65yUbgdBjSmo1+5g (small blind) showed [Qs Kc] and won ($99) with two pair, Kings and Queens
Seat 7: SyS20PAm3RpT6uLBsGkwOA (big blind) folded on the Flop
Seat 8: zDOE5r14tWqCf6xhuSHK6g folded before Flop (didn't bet)
Seat 9: qheQay5YvP2DMAb3OUSxtw folded before Flop (didn't bet)



PokerStars Game #59941213488:  Hold'em No Limit ($0.50/$1.00) - 2009/07/01 1:28:54 ET
Table 'gxFK0BVUD7cupu2uyRUZJg' 6-max Seat #2 is the button
Seat 1: M+X3uChmP6R63IwijVjgTg ($161.25 in chips)
Seat 2: hpxXcmRkXXI9HE5+5/j/0Q ($134.55 in chips)
Seat 3: Z2fXsGcjl+Eax+RzOgwOmg ($122.50 in chips)
Seat 4: JwCcjZl0bjJzG7hmE0dnTA ($100 in chips)
Seat 5: WgIrs6CBinyyw18pqdDtWA ($19.70 in chips)
Seat 6: dYyb6/42PMC8aNFlm/eBeQ ($104.40 in chips)
Z2fXsGcjl+Eax+RzOgwOmg: posts small blind $0.50
JwCcjZl0bjJzG7hmE0dnTA: posts big blind $1
*** HOLE CARDS ***
WgIrs6CBinyyw18pqdDtWA: folds
dYyb6/42PMC8aNFlm/eBeQ: folds
M+X3uChmP6R63IwijVjgTg: folds
hpxXcmRkXXI9HE5+5/j/0Q: folds
Z2fXsGcjl+Eax+RzOgwOmg: raises $2 to $3
JwCcjZl0bjJzG7hmE0dnTA: folds
Z2fXsGcjl+Eax+RzOgwOmg collected $2 from pot
Z2fXsGcjl+Eax+RzOgwOmg: doesn't show hand
*** SUMMARY ***
Total pot $2 | Rake $0
Seat 1: M+X3uChmP6R63IwijVjgTg folded before Flop (didn't bet)
Seat 2: hpxXcmRkXXI9HE5+5/j/0Q (button) folded before Flop (didn't bet)
Seat 3: Z2fXsGcjl+Eax+RzOgwOmg (small blind) collected ($2)
Seat 4: JwCcjZl0bjJzG7hmE0dnTA (big blind) folded before Flop
Seat 5: WgIrs6CBinyyw18pqdDtWA folded before Flop (didn't bet)
Seat 6: dYyb6/42PMC8aNFlm/eBeQ folded before Flop (didn't bet)



PokerStars Game #59941214376:  Hold'em No Limit ($0.50/$1.00) - 2009/07/01 1:28:55 ET
Table 'MNvFfRVQNka/oY+Z5aMbZQ' 2-max Seat #2 is the button
Seat 1: DaZnoWHjO897dnh0CL2lVg ($72.60 in chips)
Seat 2: mgi+mjKb1Sc3CCs7TlfoCw ($86.95 in chips)
mgi+mjKb1Sc3CCs7TlfoCw: posts small blind $0.50
DaZnoWHjO897dnh0CL2lVg: posts big blind $1
*** HOLE CARDS ***
mgi+mjKb1Sc3CCs7TlfoCw: folds
DaZnoWHjO897dnh0CL2lVg collected $1 from pot
*** SUMMARY ***
Total pot $1 | Rake $0
Seat 1: DaZnoWHjO897dnh0CL2lVg (big blind) collected ($1)
Seat 2: mgi+mjKb1Sc3CCs7TlfoCw (button) (small blind) folded before Flop



PokerStars Game #59941214080:  Hold'em No Limit ($0.50/$1.00) - 2009/07/01 1:28:55 ET
Table 'jDQgUn1zGkyftPnHo0Awdw' 2-max Seat #2 is the button
Seat 1: a42+e5QB6s1kkG5FoSTZJw ($101.15 in chips)
Seat 2: q+vRKwm51mnr6kxX/161WQ ($93.40 in chips)
q+vRKwm51mnr6kxX/161WQ: posts small blind $0.50
a42+e5QB6s1kkG5FoSTZJw: posts big blind $1
*** HOLE CARDS ***
q+vRKwm51mnr6kxX/161WQ: raises $2 to $3
a42+e5QB6s1kkG5FoSTZJw: calls $2
*** FLOP *** [Js As 3s]
a42+e5QB6s1kkG5FoSTZJw: checks
q+vRKwm51mnr6kxX/161WQ: checks
*** TURN *** [Js As 3s] [2c]
a42+e5QB6s1kkG5FoSTZJw: bets $5
q+vRKwm51mnr6kxX/161WQ: folds
a42+e5QB6s1kkG5FoSTZJw collected $5.70 from pot
a42+e5QB6s1kkG5FoSTZJw: doesn't show hand
*** SUMMARY ***
Total pot $6 | Rake $0.30
Board [Js As 3s 2c]
Seat 1: a42+e5QB6s1kkG5FoSTZJw (big blind) collected ($5.70)
Seat 2: q+vRKwm51mnr6kxX/161WQ (button) (small blind) folded on the Turn



PokerStars Game #59941214722:  Hold'em No Limit ($0.50/$1.00) - 2009/07/01 1:28:56 ET
Table '+cA8mcmhaedZ7YcrDdhmeQ' 6-max Seat #6 is the button
Seat 1: 9XrTM0DuVxx1pjFAdSbD8A ($53.70 in chips)
Seat 2: 14aYclSc98EYd6TrzN2l3Q ($19.65 in chips)
Seat 3: DAIgyIWbYvAkL6PbAI27pg ($18.05 in chips)
Seat 4: 4OO5v3AVduL0tePNx8wk5A ($101 in chips)
Seat 5: n5xXfJeDtWZSChGAdq//Tw ($17.05 in chips)
Seat 6: YfsTQsY/fxb+YqbdclTHuw ($24.25 in chips)
9XrTM0DuVxx1pjFAdSbD8A: posts small blind $0.50
14aYclSc98EYd6TrzN2l3Q: posts big blind $1
*** HOLE CARDS ***
DAIgyIWbYvAkL6PbAI27pg: folds
4OO5v3AVduL0tePNx8wk5A: raises $2 to $3
n5xXfJeDtWZSChGAdq//Tw: folds
YfsTQsY/fxb+YqbdclTHuw: folds
9XrTM0DuVxx1pjFAdSbD8A: folds
14aYclSc98EYd6TrzN2l3Q: raises $7 to $10
4OO5v3AVduL0tePNx8wk5A: folds
14aYclSc98EYd6TrzN2l3Q collected $6.50 from pot
*** SUMMARY ***
Total pot $6.50 | Rake $0
Seat 1: 9XrTM0DuVxx1pjFAdSbD8A (small blind) folded before Flop
Seat 2: 14aYclSc98EYd6TrzN2l3Q (big blind) collected ($6.50)
Seat 3: DAIgyIWbYvAkL6PbAI27pg folded before Flop (didn't bet)
Seat 4: 4OO5v3AVduL0tePNx8wk5A folded before Flop
Seat 5: n5xXfJeDtWZSChGAdq//Tw folded before Flop (didn't bet)
Seat 6: YfsTQsY/fxb+YqbdclTHuw (button) folded before Flop (didn't bet)



PokerStars Game #59941216782:  Hold'em No Limit ($0.50/$1.00) - 2009/07/01 1:29:00 ET
Table 'QSIig7BLMc9wY/rgBechzw' 6-max Seat #5 is the button
Seat 1: Z2fXsGcjl+Eax+RzOgwOmg ($100 in chips)
Seat 2: mLOIkH/qmRa+mVujQIhBRg ($46.90 in chips)
Seat 3: +xW7QemQU0Fxs+4TnqBRow ($110 in chips)
Seat 4: +uSzP8Jwnw7sKfQ4s66b7w ($63.95 in chips)
Seat 5: lsLuWlcPA3Rh7kJVLzMh0Q ($100 in chips)
Seat 6: PxqfkAMdAWtkgbT+q2gciA ($68.10 in chips)
PxqfkAMdAWtkgbT+q2gciA: posts small blind $0.50
Z2fXsGcjl+Eax+RzOgwOmg: posts big blind $1
*** HOLE CARDS ***
mLOIkH/qmRa+mVujQIhBRg: folds
+xW7QemQU0Fxs+4TnqBRow: folds
+uSzP8Jwnw7sKfQ4s66b7w: folds
lsLuWlcPA3Rh7kJVLzMh0Q: raises $2 to $3
PxqfkAMdAWtkgbT+q2gciA: calls $2.50
Z2fXsGcjl+Eax+RzOgwOmg: raises $11 to $14
lsLuWlcPA3Rh7kJVLzMh0Q: folds
PxqfkAMdAWtkgbT+q2gciA: folds
Z2fXsGcjl+Eax+RzOgwOmg collected $9 from pot
Z2fXsGcjl+Eax+RzOgwOmg: doesn't show hand
*** SUMMARY ***
Total pot $9 | Rake $0
Seat 1: Z2fXsGcjl+Eax+RzOgwOmg (big blind) collected ($9)
Seat 2: mLOIkH/qmRa+mVujQIhBRg folded before Flop (didn't bet)
Seat 3: +xW7QemQU0Fxs+4TnqBRow folded before Flop (didn't bet)
Seat 4: +uSzP8Jwnw7sKfQ4s66b7w folded before Flop (didn't bet)
Seat 5: lsLuWlcPA3Rh7kJVLzMh0Q (button) folded before Flop
Seat 6: PxqfkAMdAWtkgbT+q2gciA (small blind) folded before Flop



PokerStars Game #59941217788:  Hold'em No Limit ($0.50/$1.00) - 2009/07/01 1:29:02 ET
Table 'MNvFfRVQNka/oY+Z5aMbZQ' 2-max Seat #1 is the button
Seat 1: DaZnoWHjO897dnh0CL2lVg ($73.10 in chips)
Seat 2: mgi+mjKb1Sc3CCs7TlfoCw ($86.45 in chips)
DaZnoWHjO897dnh0CL2lVg: posts small blind $0.50
mgi+mjKb1Sc3CCs7TlfoCw: posts big blind $1
*** HOLE CARDS ***
DaZnoWHjO897dnh0CL2lVg: folds
mgi+mjKb1Sc3CCs7TlfoCw collected $1 from pot
*** SUMMARY ***
Total pot $1 | Rake $0
Seat 1: DaZnoWHjO897dnh0CL2lVg (button) (small blind) folded before Flop
Seat 2: mgi+mjKb1Sc3CCs7TlfoCw (big blind) collected ($1)



PokerStars Game #59941217890:  Hold'em No Limit ($0.50/$1.00) - 2009/07/01 1:29:02 ET
Table 'N6LvHFrb+cdXY/COI6ByOw' 2-max Seat #1 is the button
Seat 1: lXX4W7m3u++JiSOZ46yVMQ ($115.40 in chips)
Seat 2: 9mAoSP3o/mikSZOW2LEEAw ($82.50 in chips)
lXX4W7m3u++JiSOZ46yVMQ: posts small blind $0.50
9mAoSP3o/mikSZOW2LEEAw: posts big blind $1
*** HOLE CARDS ***
lXX4W7m3u++JiSOZ46yVMQ: raises $2 to $3
9mAoSP3o/mikSZOW2LEEAw: calls $2
*** FLOP *** [9c 5s 9s]
9mAoSP3o/mikSZOW2LEEAw: checks
lXX4W7m3u++JiSOZ46yVMQ: checks
*** TURN *** [9c 5s 9s] [2h]
9mAoSP3o/mikSZOW2LEEAw: checks
lXX4W7m3u++JiSOZ46yVMQ: checks
*** RIVER *** [9c 5s 9s 2h] [7h]
9mAoSP3o/mikSZOW2LEEAw: checks
lXX4W7m3u++JiSOZ46yVMQ: checks
*** SHOW DOWN ***
9mAoSP3o/mikSZOW2LEEAw: shows [2c Ks] (two pair, Nines and Deuces)
lXX4W7m3u++JiSOZ46yVMQ: mucks hand
9mAoSP3o/mikSZOW2LEEAw collected $5.70 from pot
*** SUMMARY ***
Total pot $6 | Rake $0.30
Board [9c 5s 9s 2h 7h]
Seat 1: lXX4W7m3u++JiSOZ46yVMQ (button) (small blind) mucked
Seat 2: 9mAoSP3o/mikSZOW2LEEAw (big blind) showed [2c Ks] and won ($5.70) with two pair, Nines and Deuces



PokerStars Game #59941218078:  Hold'em No Limit ($0.50/$1.00) - 2009/07/01 1:29:02 ET
Table 'CASNP0uy1C+jGLml/I4PtA' 9-max Seat #2 is the button
Seat 1: tkdBeXTJlFsZdioidNqLow ($60 in chips)
Seat 2: LUsAYklr0mQkiq7ASOyD9A ($59.50 in chips)
Seat 4: B/G0GJacqZ8K59/ZVdq4kQ ($69.55 in chips)
Seat 5: Jjc7EHWzs4//xUAjJ0UWoA ($10.50 in chips)
Seat 6: FJEywSpo5JbRKByzmweboA ($100 in chips)
Seat 7: S3Ex8K7v6xm5jqjRM7Fl3w ($22 in chips)
Seat 8: L9njYvloJ1NdXjP8edHEAg ($104.45 in chips)
Seat 9: Pp/KTcXkfZKKUHkjyaLTdg ($24.10 in chips)
B/G0GJacqZ8K59/ZVdq4kQ: posts small blind $0.50
Jjc7EHWzs4//xUAjJ0UWoA: posts big blind $1
*** HOLE CARDS ***
FJEywSpo5JbRKByzmweboA: folds
S3Ex8K7v6xm5jqjRM7Fl3w: folds
L9njYvloJ1NdXjP8edHEAg: folds
Pp/KTcXkfZKKUHkjyaLTdg: folds
tkdBeXTJlFsZdioidNqLow: raises $2 to $3
LUsAYklr0mQkiq7ASOyD9A: folds
B/G0GJacqZ8K59/ZVdq4kQ: calls $2.50
Jjc7EHWzs4//xUAjJ0UWoA: folds
*** FLOP *** [3c 3h 9c]
B/G0GJacqZ8K59/ZVdq4kQ: bets $1
tkdBeXTJlFsZdioidNqLow: raises $5 to $6
B/G0GJacqZ8K59/ZVdq4kQ: calls $5
*** TURN *** [3c 3h 9c] [6h]
B/G0GJacqZ8K59/ZVdq4kQ: checks
tkdBeXTJlFsZdioidNqLow: checks
*** RIVER *** [3c 3h 9c 6h] [8h]
B/G0GJacqZ8K59/ZVdq4kQ: bets $5
tkdBeXTJlFsZdioidNqLow: calls $5
*** SHOW DOWN ***
B/G0GJacqZ8K59/ZVdq4kQ: shows [4c 5c] (a pair of Threes)
tkdBeXTJlFsZdioidNqLow: shows [9d Tc] (two pair, Nines and Threes)
tkdBeXTJlFsZdioidNqLow collected $27.60 from pot
*** SUMMARY ***
Total pot $29 | Rake $1.40
Board [3c 3h 9c 6h 8h]
Seat 1: tkdBeXTJlFsZdioidNqLow showed [9d Tc] and won ($27.60) with two pair, Nines and Threes
Seat 2: LUsAYklr0mQkiq7ASOyD9A (button) folded before Flop (didn't bet)
Seat 4: B/G0GJacqZ8K59/ZVdq4kQ (small blind) showed [4c 5c] and lost with a pair of Threes
Seat 5: Jjc7EHWzs4//xUAjJ0UWoA (big blind) folded before Flop
Seat 6: FJEywSpo5JbRKByzmweboA folded before Flop (didn't bet)
Seat 7: S3Ex8K7v6xm5jqjRM7Fl3w folded before Flop (didn't bet)
Seat 8: L9njYvloJ1NdXjP8edHEAg folded before Flop (didn't bet)
Seat 9: Pp/KTcXkfZKKUHkjyaLTdg folded before Flop (didn't bet)



PokerStars Game #59941220074:  Hold'em No Limit ($0.50/$1.00) - 2009/07/01 1:29:05 ET
Table 'cBDNutyLBKEk9+ptwsKmTw' 6-max Seat #1 is the button
Seat 1: xAU6q2/cwmby2sxmA8VcmA ($299.05 in chips)
Seat 2: 4OO5v3AVduL0tePNx8wk5A ($105.55 in chips)
Seat 3: G5ZSSN6RSON3gkNvk/SmYg ($108.90 in chips)
Seat 4: OMkHNxIUZxh1pHqcCjbjgw ($94.50 in chips)
Seat 5: hpxXcmRkXXI9HE5+5/j/0Q ($103 in chips)
Seat 6: QHvTZcrKe6+maWUfVjP29Q ($150 in chips)
4OO5v3AVduL0tePNx8wk5A: posts small blind $0.50
G5ZSSN6RSON3gkNvk/SmYg: posts big blind $1
*** HOLE CARDS ***
OMkHNxIUZxh1pHqcCjbjgw: folds
hpxXcmRkXXI9HE5+5/j/0Q: folds
QHvTZcrKe6+maWUfVjP29Q: raises $2.50 to $3.50
xAU6q2/cwmby2sxmA8VcmA: folds
4OO5v3AVduL0tePNx8wk5A: folds
G5ZSSN6RSON3gkNvk/SmYg: folds
QHvTZcrKe6+maWUfVjP29Q collected $2.50 from pot
QHvTZcrKe6+maWUfVjP29Q: doesn't show hand
*** SUMMARY ***
Total pot $2.50 | Rake $0
Seat 1: xAU6q2/cwmby2sxmA8VcmA (button) folded before Flop (didn't bet)
Seat 2: 4OO5v3AVduL0tePNx8wk5A (small blind) folded before Flop
Seat 3: G5ZSSN6RSON3gkNvk/SmYg (big blind) folded before Flop
Seat 4: OMkHNxIUZxh1pHqcCjbjgw folded before Flop (didn't bet)
Seat 5: hpxXcmRkXXI9HE5+5/j/0Q folded before Flop (didn't bet)
Seat 6: QHvTZcrKe6+maWUfVjP29Q collected ($2.50)



PokerStars Game #59941219668:  Hold'em No Limit ($0.50/$1.00) - 2009/07/01 1:29:05 ET
Table 'hugOjcwJvzEwZbK7tyiWuQ' 9-max Seat #7 is the button
Seat 1: S3Ex8K7v6xm5jqjRM7Fl3w ($20 in chips)
Seat 2: r27C1nIV4NS4+qbnrgBQSw ($280.10 in chips)
Seat 3: c/6hFCyfLNRn3VFvCeQ1ng ($20 in chips)
Seat 4: UWB3oeddt/GObx2Mix2Anw ($183.10 in chips)
Seat 5: AexZ4puUV9meFWwVU6Nv0w ($19 in chips)
Seat 6: gUUvmqdVlmvpal6B8nYrmg ($105.45 in chips)
Seat 7: FL3MrLspcF23LYvC4ipBOA ($111.30 in chips)
Seat 8: /zy+DB4S5fUQUSfZWFzYGw ($118.85 in chips)
Seat 9: W8P9bUKCs43TO1xHm0dL6w ($113.80 in chips)
/zy+DB4S5fUQUSfZWFzYGw: posts small blind $0.50
W8P9bUKCs43TO1xHm0dL6w: posts big blind $1
c/6hFCyfLNRn3VFvCeQ1ng: posts big blind $1
*** HOLE CARDS ***
S3Ex8K7v6xm5jqjRM7Fl3w: folds
r27C1nIV4NS4+qbnrgBQSw: folds
c/6hFCyfLNRn3VFvCeQ1ng: checks
UWB3oeddt/GObx2Mix2Anw: raises $4 to $5
AexZ4puUV9meFWwVU6Nv0w: folds
gUUvmqdVlmvpal6B8nYrmg: folds
FL3MrLspcF23LYvC4ipBOA: folds
/zy+DB4S5fUQUSfZWFzYGw: folds
W8P9bUKCs43TO1xHm0dL6w: folds
c/6hFCyfLNRn3VFvCeQ1ng: calls $4
*** FLOP *** [7s 9d 8s]
c/6hFCyfLNRn3VFvCeQ1ng: checks
UWB3oeddt/GObx2Mix2Anw: checks
*** TURN *** [7s 9d 8s] [5d]
c/6hFCyfLNRn3VFvCeQ1ng: bets $4
UWB3oeddt/GObx2Mix2Anw: folds
c/6hFCyfLNRn3VFvCeQ1ng collected $10.95 from pot
*** SUMMARY ***
Total pot $11.50 | Rake $0.55
Board [7s 9d 8s 5d]
Seat 1: S3Ex8K7v6xm5jqjRM7Fl3w folded before Flop (didn't bet)
Seat 2: r27C1nIV4NS4+qbnrgBQSw folded before Flop (didn't bet)
Seat 3: c/6hFCyfLNRn3VFvCeQ1ng collected ($10.95)
Seat 4: UWB3oeddt/GObx2Mix2Anw folded on the Turn
Seat 5: AexZ4puUV9meFWwVU6Nv0w folded before Flop (didn't bet)
Seat 6: gUUvmqdVlmvpal6B8nYrmg folded before Flop (didn't bet)
Seat 7: FL3MrLspcF23LYvC4ipBOA (button) folded before Flop (didn't bet)
Seat 8: /zy+DB4S5fUQUSfZWFzYGw (small blind) folded before Flop
Seat 9: W8P9bUKCs43TO1xHm0dL6w (big blind) folded before Flop



PokerStars Game #59941221260:  Hold'em No Limit ($0.50/$1.00) - 2009/07/01 1:29:07 ET
Table 'N2bNCDHL96aCQDvZIh+yQQ' 6-max Seat #4 is the button
Seat 1: Jjgflx10PVjcLkziEmLhSA ($40.10 in chips)
Seat 2: y27w5IK2WXqmYzS8OU0wKA ($100.90 in chips)
Seat 3: UBZQqpnJZdTYYY1FTb0rLA ($122.05 in chips)
Seat 4: uCqEjnxh2/vFBjKYkfTOkw ($235.60 in chips)
Seat 5: frvgHLr3+LfZtjsBCBs3NA ($30.30 in chips)
Seat 6: idVgoPAdspFPCzee6aF9Pg ($100 in chips)
frvgHLr3+LfZtjsBCBs3NA: posts small blind $0.50
idVgoPAdspFPCzee6aF9Pg: posts big blind $1
*** HOLE CARDS ***
Jjgflx10PVjcLkziEmLhSA: folds
y27w5IK2WXqmYzS8OU0wKA: raises $2 to $3
UBZQqpnJZdTYYY1FTb0rLA: folds
uCqEjnxh2/vFBjKYkfTOkw: calls $3
frvgHLr3+LfZtjsBCBs3NA: calls $2.50
idVgoPAdspFPCzee6aF9Pg: folds
*** FLOP *** [4s As Td]
frvgHLr3+LfZtjsBCBs3NA: checks
y27w5IK2WXqmYzS8OU0wKA: checks
uCqEjnxh2/vFBjKYkfTOkw: bets $6
frvgHLr3+LfZtjsBCBs3NA: calls $6
y27w5IK2WXqmYzS8OU0wKA: raises $12 to $18
uCqEjnxh2/vFBjKYkfTOkw: folds
frvgHLr3+LfZtjsBCBs3NA: folds
y27w5IK2WXqmYzS8OU0wKA collected $26.65 from pot
y27w5IK2WXqmYzS8OU0wKA: doesn't show hand
*** SUMMARY ***
Total pot $28 | Rake $1.35
Board [4s As Td]
Seat 1: Jjgflx10PVjcLkziEmLhSA folded before Flop (didn't bet)
Seat 2: y27w5IK2WXqmYzS8OU0wKA collected ($26.65)
Seat 3: UBZQqpnJZdTYYY1FTb0rLA folded before Flop (didn't bet)
Seat 4: uCqEjnxh2/vFBjKYkfTOkw (button) folded on the Flop
Seat 5: frvgHLr3+LfZtjsBCBs3NA (small blind) folded on the Flop
Seat 6: idVgoPAdspFPCzee6aF9Pg (big blind) folded before Flop



PokerStars Game #59941221226:  Hold'em No Limit ($0.50/$1.00) - 2009/07/01 1:29:07 ET
Table 'gxFK0BVUD7cupu2uyRUZJg' 6-max Seat #3 is the button
Seat 1: M+X3uChmP6R63IwijVjgTg ($161.25 in chips)
Seat 2: hpxXcmRkXXI9HE5+5/j/0Q ($134.55 in chips)
Seat 3: Z2fXsGcjl+Eax+RzOgwOmg ($123.50 in chips)
Seat 4: JwCcjZl0bjJzG7hmE0dnTA ($100 in chips)
Seat 5: WgIrs6CBinyyw18pqdDtWA ($19.70 in chips)
Seat 6: dYyb6/42PMC8aNFlm/eBeQ ($104.40 in chips)
JwCcjZl0bjJzG7hmE0dnTA: posts small blind $0.50
WgIrs6CBinyyw18pqdDtWA: posts big blind $1
*** HOLE CARDS ***
dYyb6/42PMC8aNFlm/eBeQ: folds
M+X3uChmP6R63IwijVjgTg: calls $1
hpxXcmRkXXI9HE5+5/j/0Q: folds
Z2fXsGcjl+Eax+RzOgwOmg: folds
JwCcjZl0bjJzG7hmE0dnTA: folds
WgIrs6CBinyyw18pqdDtWA: checks
*** FLOP *** [2h 5c Jh]
WgIrs6CBinyyw18pqdDtWA: checks
M+X3uChmP6R63IwijVjgTg: checks
*** TURN *** [2h 5c Jh] [7h]
WgIrs6CBinyyw18pqdDtWA: checks
M+X3uChmP6R63IwijVjgTg: checks
*** RIVER *** [2h 5c Jh 7h] [9d]
WgIrs6CBinyyw18pqdDtWA: checks
M+X3uChmP6R63IwijVjgTg: checks
*** SHOW DOWN ***
WgIrs6CBinyyw18pqdDtWA: shows [Ac Qs] (high card Ace)
M+X3uChmP6R63IwijVjgTg: mucks hand
WgIrs6CBinyyw18pqdDtWA collected $2.40 from pot
*** SUMMARY ***
Total pot $2.50 | Rake $0.10
Board [2h 5c Jh 7h 9d]
Seat 1: M+X3uChmP6R63IwijVjgTg mucked
Seat 2: hpxXcmRkXXI9HE5+5/j/0Q folded before Flop (didn't bet)
Seat 3: Z2fXsGcjl+Eax+RzOgwOmg (button) folded before Flop (didn't bet)
Seat 4: JwCcjZl0bjJzG7hmE0dnTA (small blind) folded before Flop
Seat 5: WgIrs6CBinyyw18pqdDtWA (big blind) showed [Ac Qs] and won ($2.40) with high card Ace
Seat 6: dYyb6/42PMC8aNFlm/eBeQ folded before Flop (didn't bet)



PokerStars Game #59941221196:  Hold'em No Limit ($0.50/$1.00) - 2009/07/01 1:29:07 ET
Table 'MNvFfRVQNka/oY+Z5aMbZQ' 2-max Seat #2 is the button
Seat 1: DaZnoWHjO897dnh0CL2lVg ($72.60 in chips)
Seat 2: mgi+mjKb1Sc3CCs7TlfoCw ($86.95 in chips)
mgi+mjKb1Sc3CCs7TlfoCw: posts small blind $0.50
DaZnoWHjO897dnh0CL2lVg: posts big blind $1
*** HOLE CARDS ***
mgi+mjKb1Sc3CCs7TlfoCw: raises $3 to $4
DaZnoWHjO897dnh0CL2lVg: folds
mgi+mjKb1Sc3CCs7TlfoCw collected $2 from pot
mgi+mjKb1Sc3CCs7TlfoCw: doesn't show hand
*** SUMMARY ***
Total pot $2 | Rake $0
Seat 1: DaZnoWHjO897dnh0CL2lVg (big blind) folded before Flop
Seat 2: mgi+mjKb1Sc3CCs7TlfoCw (button) (small blind) collected ($2)



PokerStars Game #59941221626:  Hold'em No Limit ($0.50/$1.00) - 2009/07/01 1:29:08 ET
Table 'W/wyObTiXZm+Ckkl3YxcSw' 6-max Seat #1 is the button
Seat 1: eUBBn2R56C1IQ6Cs/vitwg ($292.05 in chips)
Seat 2: oDiBRCaF0QVtd3kO6xZIXw ($159.25 in chips)
Seat 3: dxyNCn/qxfkGDUIf28Cbng ($62.80 in chips)
Seat 4: UBZQqpnJZdTYYY1FTb0rLA ($103.20 in chips)
Seat 5: +OrCjyw70oZhJiD22Mn+bg ($102.50 in chips)
Seat 6: b2a+5TkFf4xJN/Ihhma58Q ($37.95 in chips)
oDiBRCaF0QVtd3kO6xZIXw: posts small blind $0.50
dxyNCn/qxfkGDUIf28Cbng: posts big blind $1
*** HOLE CARDS ***
UBZQqpnJZdTYYY1FTb0rLA: folds
+OrCjyw70oZhJiD22Mn+bg: folds
b2a+5TkFf4xJN/Ihhma58Q: raises $1 to $2
eUBBn2R56C1IQ6Cs/vitwg: folds
oDiBRCaF0QVtd3kO6xZIXw: calls $1.50
dxyNCn/qxfkGDUIf28Cbng: folds
*** FLOP *** [3s Qd 3c]
oDiBRCaF0QVtd3kO6xZIXw: checks
b2a+5TkFf4xJN/Ihhma58Q: checks
*** TURN *** [3s Qd 3c] [Qc]
oDiBRCaF0QVtd3kO6xZIXw: checks
b2a+5TkFf4xJN/Ihhma58Q: checks
*** RIVER *** [3s Qd 3c Qc] [Ah]
oDiBRCaF0QVtd3kO6xZIXw: checks
b2a+5TkFf4xJN/Ihhma58Q: checks
*** SHOW DOWN ***
oDiBRCaF0QVtd3kO6xZIXw: shows [8s 9s] (two pair, Queens and Threes)
b2a+5TkFf4xJN/Ihhma58Q: shows [Kc Tc] (two pair, Queens and Threes)
oDiBRCaF0QVtd3kO6xZIXw collected $2.40 from pot
b2a+5TkFf4xJN/Ihhma58Q collected $2.35 from pot
*** SUMMARY ***
Total pot $5 | Rake $0.25
Board [3s Qd 3c Qc Ah]
Seat 1: eUBBn2R56C1IQ6Cs/vitwg (button) folded before Flop (didn't bet)
Seat 2: oDiBRCaF0QVtd3kO6xZIXw (small blind) showed [8s 9s] and won ($2.40) with two pair, Queens and Threes
Seat 3: dxyNCn/qxfkGDUIf28Cbng (big blind) folded before Flop
Seat 4: UBZQqpnJZdTYYY1FTb0rLA folded before Flop (didn't bet)
Seat 5: +OrCjyw70oZhJiD22Mn+bg folded before Flop (didn't bet)
Seat 6: b2a+5TkFf4xJN/Ihhma58Q showed [Kc Tc] and won ($2.35) with two pair, Queens and Threes



PokerStars Game #59941221544:  Hold'em No Limit ($0.50/$1.00) - 2009/07/01 1:29:08 ET
Table 'MUPc8FEpe/nR0BKSeReX6Q' 6-max Seat #5 is the button
Seat 1: qhkK6+yCciTRd+rCFEbnEQ ($82.20 in chips)
Seat 2: xAU6q2/cwmby2sxmA8VcmA ($105.20 in chips)
Seat 3: wx3sQGkVi2x9wJXuWNHPBw ($285.50 in chips)
Seat 4: r4lpoh2BJZ8S6zyQv1JeSw ($100 in chips)
Seat 5: y27w5IK2WXqmYzS8OU0wKA ($105.55 in chips)
qhkK6+yCciTRd+rCFEbnEQ: posts small blind $0.50
xAU6q2/cwmby2sxmA8VcmA: posts big blind $1
*** HOLE CARDS ***
wx3sQGkVi2x9wJXuWNHPBw: folds
r4lpoh2BJZ8S6zyQv1JeSw: folds
y27w5IK2WXqmYzS8OU0wKA: folds
qhkK6+yCciTRd+rCFEbnEQ: folds
xAU6q2/cwmby2sxmA8VcmA collected $1 from pot
xAU6q2/cwmby2sxmA8VcmA: doesn't show hand
*** SUMMARY ***
Total pot $1 | Rake $0
Seat 1: qhkK6+yCciTRd+rCFEbnEQ (small blind) folded before Flop
Seat 2: xAU6q2/cwmby2sxmA8VcmA (big blind) collected ($1)
Seat 3: wx3sQGkVi2x9wJXuWNHPBw folded before Flop (didn't bet)
Seat 4: r4lpoh2BJZ8S6zyQv1JeSw folded before Flop (didn't bet)
Seat 5: y27w5IK2WXqmYzS8OU0wKA (button) folded before Flop (didn't bet)



PokerStars Game #59941222348:  Hold'em No Limit ($0.50/$1.00) - 2009/07/01 1:29:09 ET
Table 'NqGO/cV3MwFAx+ZPB5ANmQ' 2-max Seat #2 is the button
Seat 1: ItaRAnHOgvYOv5ynbG1iTw ($24.80 in chips)
Seat 2: GtFB+yyeb2djMdPFuOW/Xg ($181 in chips)
GtFB+yyeb2djMdPFuOW/Xg: posts small blind $0.50
ItaRAnHOgvYOv5ynbG1iTw: posts big blind $1
*** HOLE CARDS ***
GtFB+yyeb2djMdPFuOW/Xg: raises $2 to $3
ItaRAnHOgvYOv5ynbG1iTw: folds
GtFB+yyeb2djMdPFuOW/Xg collected $2 from pot
*** SUMMARY ***
Total pot $2 | Rake $0
Seat 1: ItaRAnHOgvYOv5ynbG1iTw (big blind) folded before Flop
Seat 2: GtFB+yyeb2djMdPFuOW/Xg (button) (small blind) collected ($2)



PokerStars Game #59941222190:  Hold'em No Limit ($0.50/$1.00) - 2009/07/01 1:29:09 ET
Table 'kS0cTQAEi+fdUlJP2gQYvw' 9-max Seat #5 is the button
Seat 1: SqsWPukL8kLqrhq5ZrQdSQ ($100 in chips)
Seat 2: D+W9Me7w6Hcx/WRUSKV0dw ($25.05 in chips)
Seat 3: 2BV+oJIQYr65IO6nEChvbA ($67 in chips)
Seat 4: RUhhaALzha3TH1AkdakoGQ ($52.50 in chips)
Seat 5: 997ViqAtWn1FPjJqcffwcA ($100 in chips)
Seat 6: yAbu2QsRPVcjPbqlf/jDxw ($125.15 in chips)
Seat 7: Ffa7Nj4X5fddtROP01hfQg ($150.60 in chips)
Seat 8: vKyFzTyzfT7fZcdX+HHN+Q ($35.95 in chips)
Seat 9: OGgaARGdJQT4awWVNQ957w ($100 in chips)
yAbu2QsRPVcjPbqlf/jDxw: posts small blind $0.50
Ffa7Nj4X5fddtROP01hfQg: posts big blind $1
SqsWPukL8kLqrhq5ZrQdSQ: posts big blind $1
*** HOLE CARDS ***
vKyFzTyzfT7fZcdX+HHN+Q: calls $1
OGgaARGdJQT4awWVNQ957w: raises $5 to $6
SqsWPukL8kLqrhq5ZrQdSQ: folds
D+W9Me7w6Hcx/WRUSKV0dw: folds
2BV+oJIQYr65IO6nEChvbA: folds
RUhhaALzha3TH1AkdakoGQ: folds
997ViqAtWn1FPjJqcffwcA: folds
yAbu2QsRPVcjPbqlf/jDxw: folds
Ffa7Nj4X5fddtROP01hfQg: calls $5
vKyFzTyzfT7fZcdX+HHN+Q: folds
*** FLOP *** [2s Jh 9c]
Ffa7Nj4X5fddtROP01hfQg: checks
OGgaARGdJQT4awWVNQ957w: bets $11
Ffa7Nj4X5fddtROP01hfQg: folds
OGgaARGdJQT4awWVNQ957w collected $13.80 from pot
OGgaARGdJQT4awWVNQ957w: doesn't show hand
*** SUMMARY ***
Total pot $14.50 | Rake $0.70
Board [2s Jh 9c]
Seat 1: SqsWPukL8kLqrhq5ZrQdSQ folded before Flop
Seat 2: D+W9Me7w6Hcx/WRUSKV0dw folded before Flop (didn't bet)
Seat 3: 2BV+oJIQYr65IO6nEChvbA folded before Flop (didn't bet)
Seat 4: RUhhaALzha3TH1AkdakoGQ folded before Flop (didn't bet)
Seat 5: 997ViqAtWn1FPjJqcffwcA (button) folded before Flop (didn't bet)
Seat 6: yAbu2QsRPVcjPbqlf/jDxw (small blind) folded before Flop
Seat 7: Ffa7Nj4X5fddtROP01hfQg (big blind) folded on the Flop
Seat 8: vKyFzTyzfT7fZcdX+HHN+Q folded before Flop
Seat 9: OGgaARGdJQT4awWVNQ957w collected ($13.80)



PokerStars Game #59941223668:  Hold'em No Limit ($0.50/$1.00) - 2009/07/01 1:29:11 ET
Table 'fTlPiCj0utgzC/5io+I7ew' 6-max Seat #6 is the button
Seat 1: YMJG+F++3Aj6P8dAWda5fw ($105.10 in chips)
Seat 2: qVr1nl3dy2xXPqS8UpTDlA ($19.30 in chips)
Seat 3: Z2fXsGcjl+Eax+RzOgwOmg ($140 in chips)
Seat 4: uJVSceLggtsrJya+WtmUEA ($164.65 in chips)
Seat 5: XUk5GQsfNFpHvaToDZ0rZA ($44.15 in chips)
Seat 6: y27w5IK2WXqmYzS8OU0wKA ($100 in chips)
YMJG+F++3Aj6P8dAWda5fw: posts small blind $0.50
qVr1nl3dy2xXPqS8UpTDlA: posts big blind $1
*** HOLE CARDS ***
Z2fXsGcjl+Eax+RzOgwOmg: folds
uJVSceLggtsrJya+WtmUEA: folds
XUk5GQsfNFpHvaToDZ0rZA: folds
y27w5IK2WXqmYzS8OU0wKA: folds
YMJG+F++3Aj6P8dAWda5fw: folds
qVr1nl3dy2xXPqS8UpTDlA collected $1 from pot
*** SUMMARY ***
Total pot $1 | Rake $0
Seat 1: YMJG+F++3Aj6P8dAWda5fw (small blind) folded before Flop
Seat 2: qVr1nl3dy2xXPqS8UpTDlA (big blind) collected ($1)
Seat 3: Z2fXsGcjl+Eax+RzOgwOmg folded before Flop (didn't bet)
Seat 4: uJVSceLggtsrJya+WtmUEA folded before Flop (didn't bet)
Seat 5: XUk5GQsfNFpHvaToDZ0rZA folded before Flop (didn't bet)
Seat 6: y27w5IK2WXqmYzS8OU0wKA (button) folded before Flop (didn't bet)



PokerStars Game #59941224358:  Hold'em No Limit ($0.50/$1.00) - 2009/07/01 1:29:12 ET
Table 'O96CPOtvMBWP6kzuYDfdFA' 6-max Seat #5 is the button
Seat 1: 6alLXQIITA2EZ/lBeym8Dw ($117.75 in chips)
Seat 2: 4d1rWhpu8DzLmzMbR3QKyA ($111.60 in chips)
Seat 3: V89DGjxE171oPREEbAXiyg ($119.25 in chips)
Seat 4: /P4w1pHg2zHYg/4ubJ0dPw ($66.65 in chips)
Seat 5: G5ZSSN6RSON3gkNvk/SmYg ($105.65 in chips)
6alLXQIITA2EZ/lBeym8Dw: posts small blind $0.50
4d1rWhpu8DzLmzMbR3QKyA: posts big blind $1
*** HOLE CARDS ***
3syOXva630dm1FTdwnuLpw joins the table at seat #6
V89DGjxE171oPREEbAXiyg: folds
/P4w1pHg2zHYg/4ubJ0dPw: folds
G5ZSSN6RSON3gkNvk/SmYg: folds
6alLXQIITA2EZ/lBeym8Dw: raises $2 to $3
4d1rWhpu8DzLmzMbR3QKyA: raises $7 to $10
6alLXQIITA2EZ/lBeym8Dw: raises $23 to $33
4d1rWhpu8DzLmzMbR3QKyA: folds
6alLXQIITA2EZ/lBeym8Dw collected $20 from pot
*** SUMMARY ***
Total pot $20 | Rake $0
Seat 1: 6alLXQIITA2EZ/lBeym8Dw (small blind) collected ($20)
Seat 2: 4d1rWhpu8DzLmzMbR3QKyA (big blind) folded before Flop
Seat 3: V89DGjxE171oPREEbAXiyg folded before Flop (didn't bet)
Seat 4: /P4w1pHg2zHYg/4ubJ0dPw folded before Flop (didn't bet)
Seat 5: G5ZSSN6RSON3gkNvk/SmYg (button) folded before Flop (didn't bet)



PokerStars Game #59941226120:  Hold'em No Limit ($0.50/$1.00) - 2009/07/01 1:29:15 ET
Table 'MNvFfRVQNka/oY+Z5aMbZQ' 2-max Seat #1 is the button
Seat 1: DaZnoWHjO897dnh0CL2lVg ($71.60 in chips)
Seat 2: mgi+mjKb1Sc3CCs7TlfoCw ($87.95 in chips)
DaZnoWHjO897dnh0CL2lVg: posts small blind $0.50
mgi+mjKb1Sc3CCs7TlfoCw: posts big blind $1
*** HOLE CARDS ***
DaZnoWHjO897dnh0CL2lVg: raises $2 to $3
mgi+mjKb1Sc3CCs7TlfoCw: raises $9 to $12
DaZnoWHjO897dnh0CL2lVg: folds
mgi+mjKb1Sc3CCs7TlfoCw collected $6 from pot
mgi+mjKb1Sc3CCs7TlfoCw: doesn't show hand
*** SUMMARY ***
Total pot $6 | Rake $0
Seat 1: DaZnoWHjO897dnh0CL2lVg (button) (small blind) folded before Flop
Seat 2: mgi+mjKb1Sc3CCs7TlfoCw (big blind) collected ($6)



PokerStars Game #59941226608:  Hold'em No Limit ($0.50/$1.00) - 2009/07/01 1:29:16 ET
Table 'NqGO/cV3MwFAx+ZPB5ANmQ' 2-max Seat #1 is the button
Seat 1: ItaRAnHOgvYOv5ynbG1iTw ($23.80 in chips)
Seat 2: GtFB+yyeb2djMdPFuOW/Xg ($182 in chips)
ItaRAnHOgvYOv5ynbG1iTw: posts small blind $0.50
GtFB+yyeb2djMdPFuOW/Xg: posts big blind $1
*** HOLE CARDS ***
ItaRAnHOgvYOv5ynbG1iTw: folds
GtFB+yyeb2djMdPFuOW/Xg collected $1 from pot
*** SUMMARY ***
Total pot $1 | Rake $0
Seat 1: ItaRAnHOgvYOv5ynbG1iTw (button) (small blind) folded before Flop
Seat 2: GtFB+yyeb2djMdPFuOW/Xg (big blind) collected ($1)



PokerStars Game #59941228142:  Hold'em No Limit ($0.50/$1.00) - 2009/07/01 1:29:19 ET
Table '3T4owEKJKyGTMePwrv50FQ' 9-max Seat #5 is the button
Seat 1: OGgaARGdJQT4awWVNQ957w ($101.50 in chips)
Seat 2: t+Id2O6herCLgwnC4m49PA ($37.80 in chips)
Seat 3: DOLzOcBTZYcph5jEfKFWuQ ($102 in chips)
Seat 4: O5Go3jrzbQWxRB6ESK+Ptg ($80.60 in chips)
Seat 5: mMc/PBpqlN24gdi3C/1tOw ($46.90 in chips)
Seat 6: V138SURkdX8LdVBPKdJJag ($100.50 in chips)
Seat 7: 1862487932 ($119.15 in chips)
Seat 8: bLbSOSmSOnqE0iTcH/5dxA ($100 in chips)
V138SURkdX8LdVBPKdJJag: posts small blind $0.50
1862487932: posts big blind $1
61sfw5QTu62YYIt68OsdrA: sits out
t+Id2O6herCLgwnC4m49PA: posts small & big blinds $1.50
*** HOLE CARDS ***
bLbSOSmSOnqE0iTcH/5dxA: folds
OGgaARGdJQT4awWVNQ957w: folds
t+Id2O6herCLgwnC4m49PA: checks
DOLzOcBTZYcph5jEfKFWuQ: raises $4.25 to $5.25
O5Go3jrzbQWxRB6ESK+Ptg: folds
mMc/PBpqlN24gdi3C/1tOw: folds
V138SURkdX8LdVBPKdJJag: raises $12.50 to $17.75
1862487932: folds
t+Id2O6herCLgwnC4m49PA: folds
DOLzOcBTZYcph5jEfKFWuQ: folds
V138SURkdX8LdVBPKdJJag collected $13 from pot
V138SURkdX8LdVBPKdJJag: doesn't show hand
*** SUMMARY ***
Total pot $13 | Rake $0
Seat 1: OGgaARGdJQT4awWVNQ957w folded before Flop (didn't bet)
Seat 2: t+Id2O6herCLgwnC4m49PA folded before Flop
Seat 3: DOLzOcBTZYcph5jEfKFWuQ folded before Flop
Seat 4: O5Go3jrzbQWxRB6ESK+Ptg folded before Flop (didn't bet)
Seat 5: mMc/PBpqlN24gdi3C/1tOw (button) folded before Flop (didn't bet)
Seat 6: V138SURkdX8LdVBPKdJJag (small blind) collected ($13)
Seat 7: 1862487932 (big blind) folded before Flop
Seat 8: bLbSOSmSOnqE0iTcH/5dxA folded before Flop (didn't bet)



PokerStars Game #59941229400:  Hold'em No Limit ($0.50/$1.00) - 2009/07/01 1:29:21 ET
Table 'GPp0HyAuggN8oE0sUWzPpA' 9-max Seat #4 is the button
Seat 2: m3U8I35Pn3gxKhoS2nmYIg ($25.75 in chips)
Seat 3: CCCXsirC+bO7ginAuUUVlQ ($53.10 in chips)
Seat 4: mBRWbnUl8diyBO1qTJaNzw ($98.65 in chips)
Seat 5: bLbSOSmSOnqE0iTcH/5dxA ($100 in chips)
Seat 6: BK/GtNPkSx0TdUDj82id5A ($39.75 in chips)
Seat 7: DHdbHyysD15wCAtx+BhUjA ($93.20 in chips)
Seat 8: P/6qLjycEfxRgZ5F/W90dw ($97.35 in chips)
Seat 9: myIxN7otsyr846M539YR8Q ($21.50 in chips)
bLbSOSmSOnqE0iTcH/5dxA: posts small blind $0.50
BK/GtNPkSx0TdUDj82id5A: posts big blind $1
laA8va+Yv8WuMqT1zdR91g: sits out
*** HOLE CARDS ***
DHdbHyysD15wCAtx+BhUjA: folds
DHdbHyysD15wCAtx+BhUjA leaves the table
P/6qLjycEfxRgZ5F/W90dw: folds
myIxN7otsyr846M539YR8Q: folds
m3U8I35Pn3gxKhoS2nmYIg: raises $2 to $3
aM6BB+PnB/rDUr2dbRda+A joins the table at seat #7
CCCXsirC+bO7ginAuUUVlQ: folds
mBRWbnUl8diyBO1qTJaNzw: folds
bLbSOSmSOnqE0iTcH/5dxA: folds
BK/GtNPkSx0TdUDj82id5A: calls $2
*** FLOP *** [Js Ts 9s]
BK/GtNPkSx0TdUDj82id5A: checks
m3U8I35Pn3gxKhoS2nmYIg: checks
*** TURN *** [Js Ts 9s] [Jc]
BK/GtNPkSx0TdUDj82id5A: checks
m3U8I35Pn3gxKhoS2nmYIg: bets $4
BK/GtNPkSx0TdUDj82id5A: folds
m3U8I35Pn3gxKhoS2nmYIg collected $6.20 from pot
*** SUMMARY ***
Total pot $6.50 | Rake $0.30
Board [Js Ts 9s Jc]
Seat 2: m3U8I35Pn3gxKhoS2nmYIg collected ($6.20)
Seat 3: CCCXsirC+bO7ginAuUUVlQ folded before Flop (didn't bet)
Seat 4: mBRWbnUl8diyBO1qTJaNzw (button) folded before Flop (didn't bet)
Seat 5: bLbSOSmSOnqE0iTcH/5dxA (small blind) folded before Flop
Seat 6: BK/GtNPkSx0TdUDj82id5A (big blind) folded on the Turn
Seat 7: DHdbHyysD15wCAtx+BhUjA folded before Flop (didn't bet)
Seat 8: P/6qLjycEfxRgZ5F/W90dw folded before Flop (didn't bet)
Seat 9: myIxN7otsyr846M539YR8Q folded before Flop (didn't bet)



PokerStars Game #59941229152:  Hold'em No Limit ($0.50/$1.00) - 2009/07/01 1:29:21 ET
Table '7Nl0ffnjeK44/vmeexh3MQ' 9-max Seat #6 is the button
Seat 1: V138SURkdX8LdVBPKdJJag ($101.50 in chips)
Seat 2: OGgaARGdJQT4awWVNQ957w ($100.50 in chips)
Seat 3: JMmUYT5pIKCKh2pGjCB/4w ($58.90 in chips)
Seat 4: bLbSOSmSOnqE0iTcH/5dxA ($105.30 in chips)
Seat 6: FVs16t7GgfWgQWt4JxsObQ ($24.85 in chips)
Seat 7: 997ViqAtWn1FPjJqcffwcA ($100 in chips)
Seat 9: /JHoNdt0fK6X+isrqRfV3w ($20 in chips)
997ViqAtWn1FPjJqcffwcA: posts small blind $0.50
D+W9Me7w6Hcx/WRUSKV0dw: is sitting out
/JHoNdt0fK6X+isrqRfV3w: posts big blind $1
*** HOLE CARDS ***
V138SURkdX8LdVBPKdJJag: folds
OGgaARGdJQT4awWVNQ957w: folds
JMmUYT5pIKCKh2pGjCB/4w: folds
61sfw5QTu62YYIt68OsdrA has returned
bLbSOSmSOnqE0iTcH/5dxA: folds
D+W9Me7w6Hcx/WRUSKV0dw leaves the table
FVs16t7GgfWgQWt4JxsObQ: folds
997ViqAtWn1FPjJqcffwcA: folds
/JHoNdt0fK6X+isrqRfV3w collected $1 from pot
/JHoNdt0fK6X+isrqRfV3w: doesn't show hand
*** SUMMARY ***
Total pot $1 | Rake $0
Seat 1: V138SURkdX8LdVBPKdJJag folded before Flop (didn't bet)
Seat 2: OGgaARGdJQT4awWVNQ957w folded before Flop (didn't bet)
Seat 3: JMmUYT5pIKCKh2pGjCB/4w folded before Flop (didn't bet)
Seat 4: bLbSOSmSOnqE0iTcH/5dxA folded before Flop (didn't bet)
Seat 6: FVs16t7GgfWgQWt4JxsObQ (button) folded before Flop (didn't bet)
Seat 7: 997ViqAtWn1FPjJqcffwcA (small blind) folded before Flop
Seat 9: /JHoNdt0fK6X+isrqRfV3w (big blind) collected ($1)



PokerStars Game #59941229794:  Hold'em No Limit ($0.50/$1.00) - 2009/07/01 1:29:22 ET
Table 'NqGO/cV3MwFAx+ZPB5ANmQ' 2-max Seat #2 is the button
Seat 1: ItaRAnHOgvYOv5ynbG1iTw ($23.30 in chips)
Seat 2: GtFB+yyeb2djMdPFuOW/Xg ($182.50 in chips)
GtFB+yyeb2djMdPFuOW/Xg: posts small blind $0.50
ItaRAnHOgvYOv5ynbG1iTw: posts big blind $1
*** HOLE CARDS ***
GtFB+yyeb2djMdPFuOW/Xg: raises $2 to $3
ItaRAnHOgvYOv5ynbG1iTw: raises $5 to $8
GtFB+yyeb2djMdPFuOW/Xg: calls $5
*** FLOP *** [Ks 6c 8d]
ItaRAnHOgvYOv5ynbG1iTw: checks
GtFB+yyeb2djMdPFuOW/Xg: bets $174.50 and is all-in
ItaRAnHOgvYOv5ynbG1iTw: folds
GtFB+yyeb2djMdPFuOW/Xg collected $15.50 from pot
*** SUMMARY ***
Total pot $16 | Rake $0.50
Board [Ks 6c 8d]
Seat 1: ItaRAnHOgvYOv5ynbG1iTw (big blind) folded on the Flop
Seat 2: GtFB+yyeb2djMdPFuOW/Xg (button) (small blind) collected ($15.50)



PokerStars Game #59941229976:  Hold'em No Limit ($0.50/$1.00) - 2009/07/01 1:29:22 ET
Table 'jDQgUn1zGkyftPnHo0Awdw' 2-max Seat #1 is the button
Seat 1: a42+e5QB6s1kkG5FoSTZJw ($103.85 in chips)
Seat 2: q+vRKwm51mnr6kxX/161WQ ($90.40 in chips)
a42+e5QB6s1kkG5FoSTZJw: posts small blind $0.50
q+vRKwm51mnr6kxX/161WQ: posts big blind $1
*** HOLE CARDS ***
a42+e5QB6s1kkG5FoSTZJw: raises $3 to $4
q+vRKwm51mnr6kxX/161WQ: calls $3
*** FLOP *** [Ks 4d 4c]
q+vRKwm51mnr6kxX/161WQ: checks
a42+e5QB6s1kkG5FoSTZJw: checks
*** TURN *** [Ks 4d 4c] [8c]
q+vRKwm51mnr6kxX/161WQ: checks
a42+e5QB6s1kkG5FoSTZJw: checks
*** RIVER *** [Ks 4d 4c 8c] [Qd]
q+vRKwm51mnr6kxX/161WQ: bets $4
a42+e5QB6s1kkG5FoSTZJw: folds
q+vRKwm51mnr6kxX/161WQ collected $7.60 from pot
q+vRKwm51mnr6kxX/161WQ: doesn't show hand
*** SUMMARY ***
Total pot $8 | Rake $0.40
Board [Ks 4d 4c 8c Qd]
Seat 1: a42+e5QB6s1kkG5FoSTZJw (button) (small blind) folded on the River
Seat 2: q+vRKwm51mnr6kxX/161WQ (big blind) collected ($7.60)



PokerStars Game #59941230570:  Hold'em No Limit ($0.50/$1.00) - 2009/07/01 1:29:23 ET
Table '+cA8mcmhaedZ7YcrDdhmeQ' 6-max Seat #1 is the button
Seat 1: 9XrTM0DuVxx1pjFAdSbD8A ($53.20 in chips)
Seat 2: 14aYclSc98EYd6TrzN2l3Q ($23.15 in chips)
Seat 3: DAIgyIWbYvAkL6PbAI27pg ($18.05 in chips)
Seat 4: 4OO5v3AVduL0tePNx8wk5A ($100 in chips)
Seat 5: n5xXfJeDtWZSChGAdq//Tw ($17.05 in chips)
Seat 6: YfsTQsY/fxb+YqbdclTHuw ($24.25 in chips)
14aYclSc98EYd6TrzN2l3Q: posts small blind $0.50
DAIgyIWbYvAkL6PbAI27pg: posts big blind $1
*** HOLE CARDS ***
4OO5v3AVduL0tePNx8wk5A: raises $3 to $4
n5xXfJeDtWZSChGAdq//Tw: raises $13.05 to $17.05 and is all-in
YfsTQsY/fxb+YqbdclTHuw: calls $17.05
9XrTM0DuVxx1pjFAdSbD8A: folds
14aYclSc98EYd6TrzN2l3Q: folds
DAIgyIWbYvAkL6PbAI27pg: folds
4OO5v3AVduL0tePNx8wk5A: folds
*** FLOP *** [As 2c Jh]
*** TURN *** [As 2c Jh] [3c]
*** RIVER *** [As 2c Jh 3c] [8d]
*** SHOW DOWN ***
n5xXfJeDtWZSChGAdq//Tw: shows [7c 7h] (a pair of Sevens)
YfsTQsY/fxb+YqbdclTHuw: shows [Ah Ac] (three of a kind, Aces)
YfsTQsY/fxb+YqbdclTHuw collected $37.65 from pot
*** SUMMARY ***
Total pot $39.60 | Rake $1.95
Board [As 2c Jh 3c 8d]
Seat 1: 9XrTM0DuVxx1pjFAdSbD8A (button) folded before Flop (didn't bet)
Seat 2: 14aYclSc98EYd6TrzN2l3Q (small blind) folded before Flop
Seat 3: DAIgyIWbYvAkL6PbAI27pg (big blind) folded before Flop
Seat 4: 4OO5v3AVduL0tePNx8wk5A folded before Flop
Seat 5: n5xXfJeDtWZSChGAdq//Tw showed [7c 7h] and lost with a pair of Sevens
Seat 6: YfsTQsY/fxb+YqbdclTHuw showed [Ah Ac] and won ($37.65) with three of a kind, Aces



PokerStars Game #59941230762:  Hold'em No Limit ($0.50/$1.00) - 2009/07/01 1:29:24 ET
Table 'N6LvHFrb+cdXY/COI6ByOw' 2-max Seat #2 is the button
Seat 1: lXX4W7m3u++JiSOZ46yVMQ ($112.40 in chips)
Seat 2: 9mAoSP3o/mikSZOW2LEEAw ($85.20 in chips)
9mAoSP3o/mikSZOW2LEEAw: posts small blind $0.50
lXX4W7m3u++JiSOZ46yVMQ: posts big blind $1
*** HOLE CARDS ***
9mAoSP3o/mikSZOW2LEEAw: calls $0.50
lXX4W7m3u++JiSOZ46yVMQ: checks
*** FLOP *** [8d Js Kc]
lXX4W7m3u++JiSOZ46yVMQ: checks
9mAoSP3o/mikSZOW2LEEAw: bets $2
lXX4W7m3u++JiSOZ46yVMQ: calls $2
*** TURN *** [8d Js Kc] [2s]
lXX4W7m3u++JiSOZ46yVMQ: checks
9mAoSP3o/mikSZOW2LEEAw: bets $2
lXX4W7m3u++JiSOZ46yVMQ: calls $2
*** RIVER *** [8d Js Kc 2s] [Ad]
lXX4W7m3u++JiSOZ46yVMQ: checks
9mAoSP3o/mikSZOW2LEEAw: checks
*** SHOW DOWN ***
lXX4W7m3u++JiSOZ46yVMQ: shows [4c Jc] (a pair of Jacks)
9mAoSP3o/mikSZOW2LEEAw: shows [As 9s] (a pair of Aces)
9mAoSP3o/mikSZOW2LEEAw collected $9.55 from pot
*** SUMMARY ***
Total pot $10 | Rake $0.45
Board [8d Js Kc 2s Ad]
Seat 1: lXX4W7m3u++JiSOZ46yVMQ (big blind) showed [4c Jc] and lost with a pair of Jacks
Seat 2: 9mAoSP3o/mikSZOW2LEEAw (button) (small blind) showed [As 9s] and won ($9.55) with a pair of Aces



PokerStars Game #59941231022:  Hold'em No Limit ($0.50/$1.00) - 2009/07/01 1:29:24 ET
Table 'MUPc8FEpe/nR0BKSeReX6Q' 6-max Seat #1 is the button
Seat 1: qhkK6+yCciTRd+rCFEbnEQ ($81.70 in chips)
Seat 2: xAU6q2/cwmby2sxmA8VcmA ($105.70 in chips)
Seat 3: wx3sQGkVi2x9wJXuWNHPBw ($285.50 in chips)
Seat 4: r4lpoh2BJZ8S6zyQv1JeSw ($100 in chips)
Seat 5: y27w5IK2WXqmYzS8OU0wKA ($105.55 in chips)
xAU6q2/cwmby2sxmA8VcmA: posts small blind $0.50
wx3sQGkVi2x9wJXuWNHPBw: posts big blind $1
*** HOLE CARDS ***
cl/QpVR/PLO58lj+C5mGLw joins the table at seat #6
r4lpoh2BJZ8S6zyQv1JeSw: folds
y27w5IK2WXqmYzS8OU0wKA: folds
qhkK6+yCciTRd+rCFEbnEQ: calls $1
xAU6q2/cwmby2sxmA8VcmA: folds
wx3sQGkVi2x9wJXuWNHPBw: checks
*** FLOP *** [6s Ks Ac]
wx3sQGkVi2x9wJXuWNHPBw: checks
qhkK6+yCciTRd+rCFEbnEQ: bets $2
wx3sQGkVi2x9wJXuWNHPBw: folds
qhkK6+yCciTRd+rCFEbnEQ collected $2.40 from pot
qhkK6+yCciTRd+rCFEbnEQ: doesn't show hand
*** SUMMARY ***
Total pot $2.50 | Rake $0.10
Board [6s Ks Ac]
Seat 1: qhkK6+yCciTRd+rCFEbnEQ (button) collected ($2.40)
Seat 2: xAU6q2/cwmby2sxmA8VcmA (small blind) folded before Flop
Seat 3: wx3sQGkVi2x9wJXuWNHPBw (big blind) folded on the Flop
Seat 4: r4lpoh2BJZ8S6zyQv1JeSw folded before Flop (didn't bet)
Seat 5: y27w5IK2WXqmYzS8OU0wKA folded before Flop (didn't bet)



PokerStars Game #59941231884:  Hold'em No Limit ($0.50/$1.00) - 2009/07/01 1:29:26 ET
Table 'pHrhryH8jPNdQfY62f8v+g' 6-max Seat #1 is the button
Seat 1: 4d1rWhpu8DzLmzMbR3QKyA ($131.75 in chips)
Seat 2: JwCcjZl0bjJzG7hmE0dnTA ($132.05 in chips)
Seat 3: 8oS5O7iD/qnFXFXJrGIgNQ ($110.15 in chips)
Seat 4: 1f3beyIML24UqEMTbWy93g ($50.40 in chips)
Seat 5: r1/R7y0Ortgoz4lccgW8VA ($7.75 in chips)
Seat 6: xAU6q2/cwmby2sxmA8VcmA ($178.25 in chips)
JwCcjZl0bjJzG7hmE0dnTA: posts small blind $0.50
8oS5O7iD/qnFXFXJrGIgNQ: posts big blind $1
*** HOLE CARDS ***
1f3beyIML24UqEMTbWy93g: raises $2 to $3
r1/R7y0Ortgoz4lccgW8VA: raises $4.75 to $7.75 and is all-in
xAU6q2/cwmby2sxmA8VcmA: folds
4d1rWhpu8DzLmzMbR3QKyA: folds
JwCcjZl0bjJzG7hmE0dnTA: folds
8oS5O7iD/qnFXFXJrGIgNQ: folds
1f3beyIML24UqEMTbWy93g: calls $4.75
*** FLOP *** [5c 7s Qd]
*** TURN *** [5c 7s Qd] [2c]
*** RIVER *** [5c 7s Qd 2c] [Kh]
*** SHOW DOWN ***
1f3beyIML24UqEMTbWy93g: shows [Th Ah] (high card Ace)
r1/R7y0Ortgoz4lccgW8VA: mucks hand
1f3beyIML24UqEMTbWy93g collected $16.15 from pot
*** SUMMARY ***
Total pot $17 | Rake $0.85
Board [5c 7s Qd 2c Kh]
Seat 1: 4d1rWhpu8DzLmzMbR3QKyA (button) folded before Flop (didn't bet)
Seat 2: JwCcjZl0bjJzG7hmE0dnTA (small blind) folded before Flop
Seat 3: 8oS5O7iD/qnFXFXJrGIgNQ (big blind) folded before Flop
Seat 4: 1f3beyIML24UqEMTbWy93g showed [Th Ah] and won ($16.15) with high card Ace
Seat 5: r1/R7y0Ortgoz4lccgW8VA mucked
Seat 6: xAU6q2/cwmby2sxmA8VcmA folded before Flop (didn't bet)



PokerStars Game #59941232680:  Hold'em No Limit ($0.50/$1.00) - 2009/07/01 1:29:27 ET
Table 'tJq9SfN1ywY0r03VBlWlwQ' 9-max Seat #8 is the button
Seat 1: wZsU+w9r7G66x93UuvBf1Q ($302.05 in chips)
Seat 4: bLbSOSmSOnqE0iTcH/5dxA ($113.65 in chips)
Seat 5: h5ipsNTMyolp7xn/NAvWkA ($129 in chips)
Seat 6: gUUvmqdVlmvpal6B8nYrmg ($100 in chips)
Seat 7: Pp/KTcXkfZKKUHkjyaLTdg ($34.05 in chips)
Seat 8: G4DEhsZFmznGNVpy2SEocA ($42.30 in chips)
Seat 9: XE5QF1y74bpHog9JxWJMWQ ($100 in chips)
XE5QF1y74bpHog9JxWJMWQ: posts small blind $0.50
wZsU+w9r7G66x93UuvBf1Q: posts big blind $1
VPF+HjszMvUIpy0CHIwH3A: sits out
*** HOLE CARDS ***
bLbSOSmSOnqE0iTcH/5dxA: raises $3 to $4
h5ipsNTMyolp7xn/NAvWkA: calls $4
gUUvmqdVlmvpal6B8nYrmg: folds
Pp/KTcXkfZKKUHkjyaLTdg: folds
G4DEhsZFmznGNVpy2SEocA: folds
XE5QF1y74bpHog9JxWJMWQ: folds
wZsU+w9r7G66x93UuvBf1Q: calls $3
*** FLOP *** [9d 2h 3h]
wZsU+w9r7G66x93UuvBf1Q: checks
bLbSOSmSOnqE0iTcH/5dxA: checks
h5ipsNTMyolp7xn/NAvWkA: bets $3
wZsU+w9r7G66x93UuvBf1Q: folds
bLbSOSmSOnqE0iTcH/5dxA: folds
h5ipsNTMyolp7xn/NAvWkA collected $11.90 from pot
*** SUMMARY ***
Total pot $12.50 | Rake $0.60
Board [9d 2h 3h]
Seat 1: wZsU+w9r7G66x93UuvBf1Q (big blind) folded on the Flop
Seat 4: bLbSOSmSOnqE0iTcH/5dxA folded on the Flop
Seat 5: h5ipsNTMyolp7xn/NAvWkA collected ($11.90)
Seat 6: gUUvmqdVlmvpal6B8nYrmg folded before Flop (didn't bet)
Seat 7: Pp/KTcXkfZKKUHkjyaLTdg folded before Flop (didn't bet)
Seat 8: G4DEhsZFmznGNVpy2SEocA (button) folded before Flop (didn't bet)
Seat 9: XE5QF1y74bpHog9JxWJMWQ (small blind) folded before Flop



PokerStars Game #59941232456:  Hold'em No Limit ($0.50/$1.00) - 2009/07/01 1:29:27 ET
Table '/FUb199IViHMJHi5YWmeuQ' 9-max Seat #6 is the button
Seat 1: 3obndzTJ6fECz8+wWhMd1w ($18.50 in chips)
Seat 2: FL3MrLspcF23LYvC4ipBOA ($185.55 in chips)
Seat 3: V138SURkdX8LdVBPKdJJag ($125.25 in chips)
Seat 4: pbAfmxe4uSZPxJQX7gOzZA ($66.20 in chips)
Seat 5: H+DVy3Ei8L1UKS2tVOtJcw ($136.85 in chips)
Seat 6: VPF+HjszMvUIpy0CHIwH3A ($21.50 in chips)
Seat 7: myIxN7otsyr846M539YR8Q ($19 in chips)
Seat 8: 997ViqAtWn1FPjJqcffwcA ($100 in chips)
Seat 9: RfLbneGRY8yQUpMgDnJCxA ($77.70 in chips)
myIxN7otsyr846M539YR8Q: posts small blind $0.50
997ViqAtWn1FPjJqcffwcA: posts big blind $1
*** HOLE CARDS ***
RfLbneGRY8yQUpMgDnJCxA: calls $1
3obndzTJ6fECz8+wWhMd1w: folds
FL3MrLspcF23LYvC4ipBOA: folds
V138SURkdX8LdVBPKdJJag: folds
pbAfmxe4uSZPxJQX7gOzZA: folds
H+DVy3Ei8L1UKS2tVOtJcw: folds
VPF+HjszMvUIpy0CHIwH3A: folds
myIxN7otsyr846M539YR8Q: folds
997ViqAtWn1FPjJqcffwcA: raises $5 to $6
RfLbneGRY8yQUpMgDnJCxA: folds
997ViqAtWn1FPjJqcffwcA collected $2.50 from pot
*** SUMMARY ***
Total pot $2.50 | Rake $0
Seat 1: 3obndzTJ6fECz8+wWhMd1w folded before Flop (didn't bet)
Seat 2: FL3MrLspcF23LYvC4ipBOA folded before Flop (didn't bet)
Seat 3: V138SURkdX8LdVBPKdJJag folded before Flop (didn't bet)
Seat 4: pbAfmxe4uSZPxJQX7gOzZA folded before Flop (didn't bet)
Seat 5: H+DVy3Ei8L1UKS2tVOtJcw folded before Flop (didn't bet)
Seat 6: VPF+HjszMvUIpy0CHIwH3A (button) folded before Flop (didn't bet)
Seat 7: myIxN7otsyr846M539YR8Q (small blind) folded before Flop
Seat 8: 997ViqAtWn1FPjJqcffwcA (big blind) collected ($2.50)
Seat 9: RfLbneGRY8yQUpMgDnJCxA folded before Flop



PokerStars Game #59941233550:  Hold'em No Limit ($0.50/$1.00) - 2009/07/01 1:29:28 ET
Table 'MNvFfRVQNka/oY+Z5aMbZQ' 2-max Seat #2 is the button
Seat 1: DaZnoWHjO897dnh0CL2lVg ($68.60 in chips)
Seat 2: mgi+mjKb1Sc3CCs7TlfoCw ($90.95 in chips)
mgi+mjKb1Sc3CCs7TlfoCw: posts small blind $0.50
DaZnoWHjO897dnh0CL2lVg: posts big blind $1
*** HOLE CARDS ***
mgi+mjKb1Sc3CCs7TlfoCw: raises $2 to $3
DaZnoWHjO897dnh0CL2lVg: calls $2
*** FLOP *** [Qh 7h 8c]
DaZnoWHjO897dnh0CL2lVg: checks
mgi+mjKb1Sc3CCs7TlfoCw: checks
*** TURN *** [Qh 7h 8c] [4h]
DaZnoWHjO897dnh0CL2lVg: checks
mgi+mjKb1Sc3CCs7TlfoCw: checks
*** RIVER *** [Qh 7h 8c 4h] [Ks]
DaZnoWHjO897dnh0CL2lVg: checks
mgi+mjKb1Sc3CCs7TlfoCw: checks
*** SHOW DOWN ***
DaZnoWHjO897dnh0CL2lVg: shows [Jh 8s] (a pair of Eights)
mgi+mjKb1Sc3CCs7TlfoCw: mucks hand
DaZnoWHjO897dnh0CL2lVg collected $5.70 from pot
*** SUMMARY ***
Total pot $6 | Rake $0.30
Board [Qh 7h 8c 4h Ks]
Seat 1: DaZnoWHjO897dnh0CL2lVg (big blind) showed [Jh 8s] and won ($5.70) with a pair of Eights
Seat 2: mgi+mjKb1Sc3CCs7TlfoCw (button) (small blind) mucked



PokerStars Game #59941233746:  Hold'em No Limit ($0.50/$1.00) - 2009/07/01 1:29:29 ET
Table '305hiksPPCCdC6V2LNsO5w' 6-max Seat #3 is the button
Seat 1: RTuDLJHh/9zPfBftoc9vsw ($11 in chips)
Seat 2: j7NIOHLZk7V2o9fOioO5ug ($130.50 in chips)
Seat 3: +zIVjZKLpcidfRHgVZW8lA ($30.70 in chips)
Seat 4: uJVSceLggtsrJya+WtmUEA ($213.55 in chips)
Seat 5: +Nt3OPk3XR9SKjZgm2CexQ ($111.15 in chips)
Seat 6: 9/Tq8dw7kWW68uN8bFupXg ($20.90 in chips)
uJVSceLggtsrJya+WtmUEA: posts small blind $0.50
+Nt3OPk3XR9SKjZgm2CexQ: posts big blind $1
*** HOLE CARDS ***
9/Tq8dw7kWW68uN8bFupXg: folds
RTuDLJHh/9zPfBftoc9vsw: folds
j7NIOHLZk7V2o9fOioO5ug: raises $2 to $3
+zIVjZKLpcidfRHgVZW8lA: folds
uJVSceLggtsrJya+WtmUEA: folds
+Nt3OPk3XR9SKjZgm2CexQ: folds
j7NIOHLZk7V2o9fOioO5ug collected $2.50 from pot
*** SUMMARY ***
Total pot $2.50 | Rake $0
Seat 1: RTuDLJHh/9zPfBftoc9vsw folded before Flop (didn't bet)
Seat 2: j7NIOHLZk7V2o9fOioO5ug collected ($2.50)
Seat 3: +zIVjZKLpcidfRHgVZW8lA (button) folded before Flop (didn't bet)
Seat 4: uJVSceLggtsrJya+WtmUEA (small blind) folded before Flop
Seat 5: +Nt3OPk3XR9SKjZgm2CexQ (big blind) folded before Flop
Seat 6: 9/Tq8dw7kWW68uN8bFupXg folded before Flop (didn't bet)



PokerStars Game #59941234928:  Hold'em No Limit ($0.50/$1.00) - 2009/07/01 1:29:31 ET
Table 'Drbq5nV2NRQTKwxtAM3cFA' 2-max Seat #2 is the button
Seat 1: PY4NvRocCFPfSIHKbh0euQ ($24.70 in chips)
Seat 2: mgi+mjKb1Sc3CCs7TlfoCw ($69.35 in chips)
mgi+mjKb1Sc3CCs7TlfoCw: posts small blind $0.50
PY4NvRocCFPfSIHKbh0euQ: posts big blind $1
*** HOLE CARDS ***
mgi+mjKb1Sc3CCs7TlfoCw: raises $2 to $3
PY4NvRocCFPfSIHKbh0euQ: folds
mgi+mjKb1Sc3CCs7TlfoCw collected $2 from pot
mgi+mjKb1Sc3CCs7TlfoCw: doesn't show hand
*** SUMMARY ***
Total pot $2 | Rake $0
Seat 1: PY4NvRocCFPfSIHKbh0euQ (big blind) folded before Flop
Seat 2: mgi+mjKb1Sc3CCs7TlfoCw (button) (small blind) collected ($2)



PokerStars Game #59941235578:  Hold'em No Limit ($0.50/$1.00) - 2009/07/01 1:29:32 ET
Table '7O9fB8yx1u7sJveJn8w6jA' 6-max Seat #2 is the button
Seat 1: jy52+7FotjH63o5tEEVgKw ($68.60 in chips)
Seat 2: wx3sQGkVi2x9wJXuWNHPBw ($193.70 in chips)
Seat 3: hpxXcmRkXXI9HE5+5/j/0Q ($138.90 in chips)
Seat 4: b2a+5TkFf4xJN/Ihhma58Q ($33.55 in chips)
Seat 5: BCEV3COoKY607AzLWayfRA ($100 in chips)
hpxXcmRkXXI9HE5+5/j/0Q: posts small blind $0.50
b2a+5TkFf4xJN/Ihhma58Q: posts big blind $1
r4lpoh2BJZ8S6zyQv1JeSw: sits out
*** HOLE CARDS ***
BCEV3COoKY607AzLWayfRA: folds
jy52+7FotjH63o5tEEVgKw: calls $1
wx3sQGkVi2x9wJXuWNHPBw: folds
hpxXcmRkXXI9HE5+5/j/0Q: folds
b2a+5TkFf4xJN/Ihhma58Q: raises $1 to $2
jy52+7FotjH63o5tEEVgKw: calls $1
*** FLOP *** [4s 5d As]
b2a+5TkFf4xJN/Ihhma58Q: checks
jy52+7FotjH63o5tEEVgKw: checks
*** TURN *** [4s 5d As] [8c]
b2a+5TkFf4xJN/Ihhma58Q: checks
jy52+7FotjH63o5tEEVgKw: checks
*** RIVER *** [4s 5d As 8c] [Qs]
b2a+5TkFf4xJN/Ihhma58Q: checks
jy52+7FotjH63o5tEEVgKw: checks
*** SHOW DOWN ***
b2a+5TkFf4xJN/Ihhma58Q: shows [6d 6c] (a pair of Sixes)
jy52+7FotjH63o5tEEVgKw: mucks hand
b2a+5TkFf4xJN/Ihhma58Q collected $4.30 from pot
*** SUMMARY ***
Total pot $4.50 | Rake $0.20
Board [4s 5d As 8c Qs]
Seat 1: jy52+7FotjH63o5tEEVgKw mucked
Seat 2: wx3sQGkVi2x9wJXuWNHPBw (button) folded before Flop (didn't bet)
Seat 3: hpxXcmRkXXI9HE5+5/j/0Q (small blind) folded before Flop
Seat 4: b2a+5TkFf4xJN/Ihhma58Q (big blind) showed [6d 6c] and won ($4.30) with a pair of Sixes
Seat 5: BCEV3COoKY607AzLWayfRA folded before Flop (didn't bet)



PokerStars Game #59941235954:  Hold'em No Limit ($0.50/$1.00) - 2009/07/01 1:29:33 ET
Table 'mmbQQVBTrPdE+wy+s+9VPA' 6-max Seat #6 is the button
Seat 1: zyP4SPoWZnKUfTvIRLCVog ($69.35 in chips)
Seat 2: XK4Qsl+DA8gAJyg85/zBIw ($33.10 in chips)
Seat 3: wx3sQGkVi2x9wJXuWNHPBw ($126.35 in chips)
Seat 4: V3iZdcw61nXF3g5hD2RrsQ ($100 in chips)
Seat 5: YMJG+F++3Aj6P8dAWda5fw ($123.90 in chips)
Seat 6: U2CWBTv29qdCbj8RNF2sIw ($119.20 in chips)
zyP4SPoWZnKUfTvIRLCVog: posts small blind $0.50
XK4Qsl+DA8gAJyg85/zBIw: posts big blind $1
*** HOLE CARDS ***
wx3sQGkVi2x9wJXuWNHPBw: folds
V3iZdcw61nXF3g5hD2RrsQ: raises $2 to $3
YMJG+F++3Aj6P8dAWda5fw: folds
U2CWBTv29qdCbj8RNF2sIw: folds
zyP4SPoWZnKUfTvIRLCVog: calls $2.50
XK4Qsl+DA8gAJyg85/zBIw: folds
*** FLOP *** [6d 4c Qh]
zyP4SPoWZnKUfTvIRLCVog: checks
V3iZdcw61nXF3g5hD2RrsQ: bets $4
zyP4SPoWZnKUfTvIRLCVog: calls $4
*** TURN *** [6d 4c Qh] [7d]
zyP4SPoWZnKUfTvIRLCVog: checks
V3iZdcw61nXF3g5hD2RrsQ: checks
*** RIVER *** [6d 4c Qh 7d] [5h]
zyP4SPoWZnKUfTvIRLCVog: checks
V3iZdcw61nXF3g5hD2RrsQ: checks
*** SHOW DOWN ***
zyP4SPoWZnKUfTvIRLCVog: shows [Js Ac] (high card Ace)
V3iZdcw61nXF3g5hD2RrsQ: mucks hand
zyP4SPoWZnKUfTvIRLCVog collected $14.30 from pot
*** SUMMARY ***
Total pot $15 | Rake $0.70
Board [6d 4c Qh 7d 5h]
Seat 1: zyP4SPoWZnKUfTvIRLCVog (small blind) showed [Js Ac] and won ($14.30) with high card Ace
Seat 2: XK4Qsl+DA8gAJyg85/zBIw (big blind) folded before Flop
Seat 3: wx3sQGkVi2x9wJXuWNHPBw folded before Flop (didn't bet)
Seat 4: V3iZdcw61nXF3g5hD2RrsQ mucked
Seat 5: YMJG+F++3Aj6P8dAWda5fw folded before Flop (didn't bet)
Seat 6: U2CWBTv29qdCbj8RNF2sIw (button) folded before Flop (didn't bet)



PokerStars Game #59941238066:  Hold'em No Limit ($0.50/$1.00) - 2009/07/01 1:29:37 ET
Table 'fTlPiCj0utgzC/5io+I7ew' 6-max Seat #1 is the button
Seat 1: YMJG+F++3Aj6P8dAWda5fw ($104.60 in chips)
Seat 2: qVr1nl3dy2xXPqS8UpTDlA ($19.80 in chips)
Seat 3: Z2fXsGcjl+Eax+RzOgwOmg ($140 in chips)
Seat 4: uJVSceLggtsrJya+WtmUEA ($164.65 in chips)
Seat 5: XUk5GQsfNFpHvaToDZ0rZA ($44.15 in chips)
Seat 6: y27w5IK2WXqmYzS8OU0wKA ($100 in chips)
qVr1nl3dy2xXPqS8UpTDlA: posts small blind $0.50
Z2fXsGcjl+Eax+RzOgwOmg: posts big blind $1
*** HOLE CARDS ***
uJVSceLggtsrJya+WtmUEA: folds
XUk5GQsfNFpHvaToDZ0rZA: folds
y27w5IK2WXqmYzS8OU0wKA: folds
YMJG+F++3Aj6P8dAWda5fw: folds
qVr1nl3dy2xXPqS8UpTDlA: calls $0.50
Z2fXsGcjl+Eax+RzOgwOmg: raises $124 to $125
qVr1nl3dy2xXPqS8UpTDlA: folds
Z2fXsGcjl+Eax+RzOgwOmg collected $2 from pot
*** SUMMARY ***
Total pot $2 | Rake $0
Seat 1: YMJG+F++3Aj6P8dAWda5fw (button) folded before Flop (didn't bet)
Seat 2: qVr1nl3dy2xXPqS8UpTDlA (small blind) folded before Flop
Seat 3: Z2fXsGcjl+Eax+RzOgwOmg (big blind) collected ($2)
Seat 4: uJVSceLggtsrJya+WtmUEA folded before Flop (didn't bet)
Seat 5: XUk5GQsfNFpHvaToDZ0rZA folded before Flop (didn't bet)
Seat 6: y27w5IK2WXqmYzS8OU0wKA folded before Flop (didn't bet)



PokerStars Game #59941238114:  Hold'em No Limit ($0.50/$1.00) - 2009/07/01 1:29:37 ET
Table 'vs/5jr6ciwjVQ5+Soc+u2A' 6-max Seat #6 is the button
Seat 1: J798qwLuvXyq0BbzsIjOrA ($165.15 in chips)
Seat 2: lXX4W7m3u++JiSOZ46yVMQ ($100.65 in chips)
Seat 3: G5ZSSN6RSON3gkNvk/SmYg ($119.10 in chips)
Seat 4: wk6Ohn4GDozoOMHc4eb2rw ($50.80 in chips)
Seat 5: +Nt3OPk3XR9SKjZgm2CexQ ($164.40 in chips)
Seat 6: Z2fXsGcjl+Eax+RzOgwOmg ($104.50 in chips)
J798qwLuvXyq0BbzsIjOrA: posts small blind $0.50
lXX4W7m3u++JiSOZ46yVMQ: posts big blind $1
*** HOLE CARDS ***
G5ZSSN6RSON3gkNvk/SmYg: folds
wk6Ohn4GDozoOMHc4eb2rw: folds
+Nt3OPk3XR9SKjZgm2CexQ: folds
Z2fXsGcjl+Eax+RzOgwOmg: folds
J798qwLuvXyq0BbzsIjOrA: calls $0.50
lXX4W7m3u++JiSOZ46yVMQ: checks
*** FLOP *** [4c 5c Jd]
J798qwLuvXyq0BbzsIjOrA: checks
lXX4W7m3u++JiSOZ46yVMQ: bets $1
J798qwLuvXyq0BbzsIjOrA: calls $1
*** TURN *** [4c 5c Jd] [Qs]
J798qwLuvXyq0BbzsIjOrA: checks
lXX4W7m3u++JiSOZ46yVMQ: bets $2
J798qwLuvXyq0BbzsIjOrA: folds
lXX4W7m3u++JiSOZ46yVMQ collected $3.85 from pot
*** SUMMARY ***
Total pot $4 | Rake $0.15
Board [4c 5c Jd Qs]
Seat 1: J798qwLuvXyq0BbzsIjOrA (small blind) folded on the Turn
Seat 2: lXX4W7m3u++JiSOZ46yVMQ (big blind) collected ($3.85)
Seat 3: G5ZSSN6RSON3gkNvk/SmYg folded before Flop (didn't bet)
Seat 4: wk6Ohn4GDozoOMHc4eb2rw folded before Flop (didn't bet)
Seat 5: +Nt3OPk3XR9SKjZgm2CexQ folded before Flop (didn't bet)
Seat 6: Z2fXsGcjl+Eax+RzOgwOmg (button) folded before Flop (didn't bet)



PokerStars Game #59941240148:  Hold'em No Limit ($0.50/$1.00) - 2009/07/01 1:29:40 ET
Table '/RZcOwpZpHQ+OwPwjsbnRw' 6-max Seat #4 is the button
Seat 1: +uSzP8Jwnw7sKfQ4s66b7w ($41.75 in chips)
Seat 2: Z2fXsGcjl+Eax+RzOgwOmg ($102.65 in chips)
Seat 4: j7NIOHLZk7V2o9fOioO5ug ($107.05 in chips)
Seat 5: wx3sQGkVi2x9wJXuWNHPBw ($167.75 in chips)
Seat 6: o3YLm/rSY916m/on1VjXPA ($199.50 in chips)
wx3sQGkVi2x9wJXuWNHPBw: posts small blind $0.50
o3YLm/rSY916m/on1VjXPA: posts big blind $1
*** HOLE CARDS ***
+uSzP8Jwnw7sKfQ4s66b7w: folds
Z2fXsGcjl+Eax+RzOgwOmg: folds
LJMw/I77xpnw0R5T4HnMUg joins the table at seat #3
j7NIOHLZk7V2o9fOioO5ug: raises $2 to $3
wx3sQGkVi2x9wJXuWNHPBw: folds
o3YLm/rSY916m/on1VjXPA: calls $2
*** FLOP *** [6h Qd As]
o3YLm/rSY916m/on1VjXPA: checks
j7NIOHLZk7V2o9fOioO5ug: bets $5
o3YLm/rSY916m/on1VjXPA: raises $10 to $15
j7NIOHLZk7V2o9fOioO5ug: folds
o3YLm/rSY916m/on1VjXPA collected $15.70 from pot
o3YLm/rSY916m/on1VjXPA: doesn't show hand
*** SUMMARY ***
Total pot $16.50 | Rake $0.80
Board [6h Qd As]
Seat 1: +uSzP8Jwnw7sKfQ4s66b7w folded before Flop (didn't bet)
Seat 2: Z2fXsGcjl+Eax+RzOgwOmg folded before Flop (didn't bet)
Seat 4: j7NIOHLZk7V2o9fOioO5ug (button) folded on the Flop
Seat 5: wx3sQGkVi2x9wJXuWNHPBw (small blind) folded before Flop
Seat 6: o3YLm/rSY916m/on1VjXPA (big blind) collected ($15.70)



PokerStars Game #59941240504:  Hold'em No Limit ($0.50/$1.00) - 2009/07/01 1:29:41 ET
Table 'NqGO/cV3MwFAx+ZPB5ANmQ' 2-max Seat #1 is the button
Seat 1: ItaRAnHOgvYOv5ynbG1iTw ($15.30 in chips)
Seat 2: GtFB+yyeb2djMdPFuOW/Xg ($190 in chips)
ItaRAnHOgvYOv5ynbG1iTw: posts small blind $0.50
GtFB+yyeb2djMdPFuOW/Xg: posts big blind $1
*** HOLE CARDS ***
ItaRAnHOgvYOv5ynbG1iTw: folds
GtFB+yyeb2djMdPFuOW/Xg collected $1 from pot
*** SUMMARY ***
Total pot $1 | Rake $0
Seat 1: ItaRAnHOgvYOv5ynbG1iTw (button) (small blind) folded before Flop
Seat 2: GtFB+yyeb2djMdPFuOW/Xg (big blind) collected ($1)



PokerStars Game #59941241176:  Hold'em No Limit ($0.50/$1.00) - 2009/07/01 1:29:42 ET
Table 'Drbq5nV2NRQTKwxtAM3cFA' 2-max Seat #1 is the button
Seat 1: PY4NvRocCFPfSIHKbh0euQ ($23.70 in chips)
Seat 2: mgi+mjKb1Sc3CCs7TlfoCw ($70.35 in chips)
PY4NvRocCFPfSIHKbh0euQ: posts small blind $0.50
mgi+mjKb1Sc3CCs7TlfoCw: posts big blind $1
*** HOLE CARDS ***
PY4NvRocCFPfSIHKbh0euQ: calls $0.50
mgi+mjKb1Sc3CCs7TlfoCw: checks
*** FLOP *** [Ks 3s Td]
mgi+mjKb1Sc3CCs7TlfoCw: bets $3
PY4NvRocCFPfSIHKbh0euQ: folds
mgi+mjKb1Sc3CCs7TlfoCw collected $1.90 from pot
mgi+mjKb1Sc3CCs7TlfoCw: doesn't show hand
*** SUMMARY ***
Total pot $2 | Rake $0.10
Board [Ks 3s Td]
Seat 1: PY4NvRocCFPfSIHKbh0euQ (button) (small blind) folded on the Flop
Seat 2: mgi+mjKb1Sc3CCs7TlfoCw (big blind) collected ($1.90)



PokerStars Game #59941241120:  Hold'em No Limit ($0.50/$1.00) - 2009/07/01 1:29:42 ET
Table 'QSIig7BLMc9wY/rgBechzw' 6-max Seat #6 is the button
Seat 1: Z2fXsGcjl+Eax+RzOgwOmg ($106 in chips)
Seat 2: mLOIkH/qmRa+mVujQIhBRg ($46.90 in chips)
Seat 3: +xW7QemQU0Fxs+4TnqBRow ($110 in chips)
Seat 4: +uSzP8Jwnw7sKfQ4s66b7w ($63.95 in chips)
Seat 5: lsLuWlcPA3Rh7kJVLzMh0Q ($100 in chips)
Seat 6: PxqfkAMdAWtkgbT+q2gciA ($65.10 in chips)
Z2fXsGcjl+Eax+RzOgwOmg: posts small blind $0.50
mLOIkH/qmRa+mVujQIhBRg: posts big blind $1
*** HOLE CARDS ***
+xW7QemQU0Fxs+4TnqBRow: folds
+uSzP8Jwnw7sKfQ4s66b7w: folds
lsLuWlcPA3Rh7kJVLzMh0Q: raises $2 to $3
PxqfkAMdAWtkgbT+q2gciA: folds
Z2fXsGcjl+Eax+RzOgwOmg: folds
mLOIkH/qmRa+mVujQIhBRg: calls $2
*** FLOP *** [2c Th Td]
mLOIkH/qmRa+mVujQIhBRg: checks
lsLuWlcPA3Rh7kJVLzMh0Q: bets $3
mLOIkH/qmRa+mVujQIhBRg: folds
lsLuWlcPA3Rh7kJVLzMh0Q collected $6.20 from pot
lsLuWlcPA3Rh7kJVLzMh0Q: doesn't show hand
*** SUMMARY ***
Total pot $6.50 | Rake $0.30
Board [2c Th Td]
Seat 1: Z2fXsGcjl+Eax+RzOgwOmg (small blind) folded before Flop
Seat 2: mLOIkH/qmRa+mVujQIhBRg (big blind) folded on the Flop
Seat 3: +xW7QemQU0Fxs+4TnqBRow folded before Flop (didn't bet)
Seat 4: +uSzP8Jwnw7sKfQ4s66b7w folded before Flop (didn't bet)
Seat 5: lsLuWlcPA3Rh7kJVLzMh0Q collected ($6.20)
Seat 6: PxqfkAMdAWtkgbT+q2gciA (button) folded before Flop (didn't bet)



PokerStars Game #59941241934:  Hold'em No Limit ($0.50/$1.00) - 2009/07/01 1:29:43 ET
Table 'cBDNutyLBKEk9+ptwsKmTw' 6-max Seat #2 is the button
Seat 1: xAU6q2/cwmby2sxmA8VcmA ($299.05 in chips)
Seat 2: 4OO5v3AVduL0tePNx8wk5A ($105.05 in chips)
Seat 3: G5ZSSN6RSON3gkNvk/SmYg ($107.90 in chips)
Seat 4: OMkHNxIUZxh1pHqcCjbjgw ($94.50 in chips)
Seat 5: hpxXcmRkXXI9HE5+5/j/0Q ($103 in chips)
Seat 6: QHvTZcrKe6+maWUfVjP29Q ($151.50 in chips)
G5ZSSN6RSON3gkNvk/SmYg: posts small blind $0.50
OMkHNxIUZxh1pHqcCjbjgw: posts big blind $1
*** HOLE CARDS ***
hpxXcmRkXXI9HE5+5/j/0Q: raises $2 to $3
QHvTZcrKe6+maWUfVjP29Q: folds
xAU6q2/cwmby2sxmA8VcmA: folds
4OO5v3AVduL0tePNx8wk5A: folds
G5ZSSN6RSON3gkNvk/SmYg: folds
OMkHNxIUZxh1pHqcCjbjgw: calls $2
*** FLOP *** [2h 6d 9h]
OMkHNxIUZxh1pHqcCjbjgw: checks
hpxXcmRkXXI9HE5+5/j/0Q: bets $5
OMkHNxIUZxh1pHqcCjbjgw: folds
hpxXcmRkXXI9HE5+5/j/0Q collected $6.20 from pot
hpxXcmRkXXI9HE5+5/j/0Q: doesn't show hand
*** SUMMARY ***
Total pot $6.50 | Rake $0.30
Board [2h 6d 9h]
Seat 1: xAU6q2/cwmby2sxmA8VcmA folded before Flop (didn't bet)
Seat 2: 4OO5v3AVduL0tePNx8wk5A (button) folded before Flop (didn't bet)
Seat 3: G5ZSSN6RSON3gkNvk/SmYg (small blind) folded before Flop
Seat 4: OMkHNxIUZxh1pHqcCjbjgw (big blind) folded on the Flop
Seat 5: hpxXcmRkXXI9HE5+5/j/0Q collected ($6.20)
Seat 6: QHvTZcrKe6+maWUfVjP29Q folded before Flop (didn't bet)



PokerStars Game #59941242164:  Hold'em No Limit ($0.50/$1.00) - 2009/07/01 1:29:44 ET
Table 'jDQgUn1zGkyftPnHo0Awdw' 2-max Seat #2 is the button
Seat 1: a42+e5QB6s1kkG5FoSTZJw ($99.85 in chips)
Seat 2: q+vRKwm51mnr6kxX/161WQ ($94 in chips)
q+vRKwm51mnr6kxX/161WQ: posts small blind $0.50
a42+e5QB6s1kkG5FoSTZJw: posts big blind $1
*** HOLE CARDS ***
q+vRKwm51mnr6kxX/161WQ: raises $2 to $3
a42+e5QB6s1kkG5FoSTZJw: folds
q+vRKwm51mnr6kxX/161WQ collected $2 from pot
q+vRKwm51mnr6kxX/161WQ: doesn't show hand
*** SUMMARY ***
Total pot $2 | Rake $0
Seat 1: a42+e5QB6s1kkG5FoSTZJw (big blind) folded before Flop
Seat 2: q+vRKwm51mnr6kxX/161WQ (button) (small blind) collected ($2)



PokerStars Game #59941242086:  Hold'em No Limit ($0.50/$1.00) - 2009/07/01 1:29:44 ET
Table 'b8oW/dOL7fDza5DfZ/dOJQ' 6-max Seat #6 is the button
Seat 2: TSuRyAHnUPCFjP7Z0rEE0w ($120.50 in chips)
Seat 4: X87W8qaGsudJTSkClK2Cig ($21.85 in chips)
Seat 5: r4lpoh2BJZ8S6zyQv1JeSw ($101 in chips)
Seat 6: PvfYaKbzMpsmUcbOExckbQ ($100 in chips)
TSuRyAHnUPCFjP7Z0rEE0w: posts small blind $0.50
xAU6q2/cwmby2sxmA8VcmA: is sitting out
X87W8qaGsudJTSkClK2Cig: posts big blind $1
*** HOLE CARDS ***
NakujTNjHFgzceydFf+E2Q joins the table at seat #1
r4lpoh2BJZ8S6zyQv1JeSw: raises $2 to $3
PvfYaKbzMpsmUcbOExckbQ: folds
xAU6q2/cwmby2sxmA8VcmA leaves the table
TSuRyAHnUPCFjP7Z0rEE0w: folds
X87W8qaGsudJTSkClK2Cig: folds
r4lpoh2BJZ8S6zyQv1JeSw collected $2.50 from pot
r4lpoh2BJZ8S6zyQv1JeSw: doesn't show hand
*** SUMMARY ***
Total pot $2.50 | Rake $0
Seat 2: TSuRyAHnUPCFjP7Z0rEE0w (small blind) folded before Flop
Seat 4: X87W8qaGsudJTSkClK2Cig (big blind) folded before Flop
Seat 5: r4lpoh2BJZ8S6zyQv1JeSw collected ($2.50)
Seat 6: PvfYaKbzMpsmUcbOExckbQ (button) folded before Flop (didn't bet)



PokerStars Game #59941244060:  Hold'em No Limit ($0.50/$1.00) - 2009/07/01 1:29:47 ET
Table 'NqGO/cV3MwFAx+ZPB5ANmQ' 2-max Seat #2 is the button
Seat 1: ItaRAnHOgvYOv5ynbG1iTw ($100 in chips)
Seat 2: GtFB+yyeb2djMdPFuOW/Xg ($190.50 in chips)
GtFB+yyeb2djMdPFuOW/Xg: posts small blind $0.50
ItaRAnHOgvYOv5ynbG1iTw: posts big blind $1
*** HOLE CARDS ***
GtFB+yyeb2djMdPFuOW/Xg: folds
ItaRAnHOgvYOv5ynbG1iTw collected $1 from pot
ItaRAnHOgvYOv5ynbG1iTw: doesn't show hand
*** SUMMARY ***
Total pot $1 | Rake $0
Seat 1: ItaRAnHOgvYOv5ynbG1iTw (big blind) collected ($1)
Seat 2: GtFB+yyeb2djMdPFuOW/Xg (button) (small blind) folded before Flop



PokerStars Game #59941245064:  Hold'em No Limit ($0.50/$1.00) - 2009/07/01 1:29:49 ET
Table 'N6LvHFrb+cdXY/COI6ByOw' 2-max Seat #1 is the button
Seat 1: lXX4W7m3u++JiSOZ46yVMQ ($107.40 in chips)
Seat 2: 9mAoSP3o/mikSZOW2LEEAw ($89.75 in chips)
lXX4W7m3u++JiSOZ46yVMQ: posts small blind $0.50
9mAoSP3o/mikSZOW2LEEAw: posts big blind $1
*** HOLE CARDS ***
lXX4W7m3u++JiSOZ46yVMQ: raises $2 to $3
9mAoSP3o/mikSZOW2LEEAw: calls $2
*** FLOP *** [8c 5h 8s]
9mAoSP3o/mikSZOW2LEEAw: checks
lXX4W7m3u++JiSOZ46yVMQ: checks
*** TURN *** [8c 5h 8s] [Ts]
9mAoSP3o/mikSZOW2LEEAw: checks
lXX4W7m3u++JiSOZ46yVMQ: checks
*** RIVER *** [8c 5h 8s Ts] [Js]
9mAoSP3o/mikSZOW2LEEAw: checks
lXX4W7m3u++JiSOZ46yVMQ: checks
*** SHOW DOWN ***
9mAoSP3o/mikSZOW2LEEAw: shows [Jc 6s] (two pair, Jacks and Eights)
lXX4W7m3u++JiSOZ46yVMQ: mucks hand
9mAoSP3o/mikSZOW2LEEAw collected $5.70 from pot
*** SUMMARY ***
Total pot $6 | Rake $0.30
Board [8c 5h 8s Ts Js]
Seat 1: lXX4W7m3u++JiSOZ46yVMQ (button) (small blind) mucked
Seat 2: 9mAoSP3o/mikSZOW2LEEAw (big blind) showed [Jc 6s] and won ($5.70) with two pair, Jacks and Eights



PokerStars Game #59941245328:  Hold'em No Limit ($0.50/$1.00) - 2009/07/01 1:29:49 ET
Table 'blHlQApStil0OPeQxQxPcw' 9-max Seat #5 is the button
Seat 1: Pp/KTcXkfZKKUHkjyaLTdg ($22.30 in chips)
Seat 2: V138SURkdX8LdVBPKdJJag ($124.35 in chips)
Seat 3: OGgaARGdJQT4awWVNQ957w ($100 in chips)
Seat 4: e3u1tVujx+9fNGL+1+YnaQ ($42.15 in chips)
Seat 5: uXrDE6JrIi8BZK1L8oQ9bQ ($55.10 in chips)
Seat 6: vljeiOoWscAIXU0fCuiEBw ($41.15 in chips)
Seat 8: laA8va+Yv8WuMqT1zdR91g ($100 in chips)
Seat 9: 6XkTu4ahxzHnvjjc1R8YjQ ($100 in chips)
vljeiOoWscAIXU0fCuiEBw: posts small blind $0.50
GTQkFJtSkbVbnGCktp6e3g: is sitting out
laA8va+Yv8WuMqT1zdR91g: posts big blind $1
*** HOLE CARDS ***
6XkTu4ahxzHnvjjc1R8YjQ: folds
GTQkFJtSkbVbnGCktp6e3g leaves the table
Pp/KTcXkfZKKUHkjyaLTdg: folds
VPF+HjszMvUIpy0CHIwH3A joins the table at seat #7
V138SURkdX8LdVBPKdJJag: folds
OGgaARGdJQT4awWVNQ957w: raises $3 to $4
e3u1tVujx+9fNGL+1+YnaQ: calls $4
uXrDE6JrIi8BZK1L8oQ9bQ: folds
vljeiOoWscAIXU0fCuiEBw: calls $3.50
laA8va+Yv8WuMqT1zdR91g: calls $3
*** FLOP *** [Ks 2h 6c]
vljeiOoWscAIXU0fCuiEBw: checks
laA8va+Yv8WuMqT1zdR91g: checks
OGgaARGdJQT4awWVNQ957w: checks
e3u1tVujx+9fNGL+1+YnaQ: bets $5
vljeiOoWscAIXU0fCuiEBw: folds
laA8va+Yv8WuMqT1zdR91g: folds
OGgaARGdJQT4awWVNQ957w: folds
e3u1tVujx+9fNGL+1+YnaQ collected $15.20 from pot
*** SUMMARY ***
Total pot $16 | Rake $0.80
Board [Ks 2h 6c]
Seat 1: Pp/KTcXkfZKKUHkjyaLTdg folded before Flop (didn't bet)
Seat 2: V138SURkdX8LdVBPKdJJag folded before Flop (didn't bet)
Seat 3: OGgaARGdJQT4awWVNQ957w folded on the Flop
Seat 4: e3u1tVujx+9fNGL+1+YnaQ collected ($15.20)
Seat 5: uXrDE6JrIi8BZK1L8oQ9bQ (button) folded before Flop (didn't bet)
Seat 6: vljeiOoWscAIXU0fCuiEBw (small blind) folded on the Flop
Seat 8: laA8va+Yv8WuMqT1zdR91g (big blind) folded on the Flop
Seat 9: 6XkTu4ahxzHnvjjc1R8YjQ folded before Flop (didn't bet)



PokerStars Game #59941246126:  Hold'em No Limit ($0.50/$1.00) - 2009/07/01 1:29:50 ET
Table 'MNvFfRVQNka/oY+Z5aMbZQ' 2-max Seat #1 is the button
Seat 1: DaZnoWHjO897dnh0CL2lVg ($71.30 in chips)
Seat 2: mgi+mjKb1Sc3CCs7TlfoCw ($87.95 in chips)
DaZnoWHjO897dnh0CL2lVg: posts small blind $0.50
mgi+mjKb1Sc3CCs7TlfoCw: posts big blind $1
*** HOLE CARDS ***
DaZnoWHjO897dnh0CL2lVg: calls $0.50
mgi+mjKb1Sc3CCs7TlfoCw: raises $4 to $5
DaZnoWHjO897dnh0CL2lVg: folds
mgi+mjKb1Sc3CCs7TlfoCw collected $2 from pot
mgi+mjKb1Sc3CCs7TlfoCw: doesn't show hand
*** SUMMARY ***
Total pot $2 | Rake $0
Seat 1: DaZnoWHjO897dnh0CL2lVg (button) (small blind) folded before Flop
Seat 2: mgi+mjKb1Sc3CCs7TlfoCw (big blind) collected ($2)



PokerStars Game #59941246770:  Hold'em No Limit ($0.50/$1.00) - 2009/07/01 1:29:51 ET
Table '7Nl0ffnjeK44/vmeexh3MQ' 9-max Seat #7 is the button
Seat 1: V138SURkdX8LdVBPKdJJag ($101.50 in chips)
Seat 2: OGgaARGdJQT4awWVNQ957w ($100.50 in chips)
Seat 3: JMmUYT5pIKCKh2pGjCB/4w ($58.90 in chips)
Seat 4: bLbSOSmSOnqE0iTcH/5dxA ($105.30 in chips)
Seat 6: FVs16t7GgfWgQWt4JxsObQ ($24.85 in chips)
Seat 7: 997ViqAtWn1FPjJqcffwcA ($100 in chips)
Seat 9: /JHoNdt0fK6X+isrqRfV3w ($20.50 in chips)
/JHoNdt0fK6X+isrqRfV3w: posts small blind $0.50
V138SURkdX8LdVBPKdJJag: posts big blind $1
61sfw5QTu62YYIt68OsdrA: sits out
*** HOLE CARDS ***
OGgaARGdJQT4awWVNQ957w: folds
JMmUYT5pIKCKh2pGjCB/4w: folds
bLbSOSmSOnqE0iTcH/5dxA: folds
FVs16t7GgfWgQWt4JxsObQ: folds
997ViqAtWn1FPjJqcffwcA: folds
/JHoNdt0fK6X+isrqRfV3w: folds
V138SURkdX8LdVBPKdJJag collected $1 from pot
V138SURkdX8LdVBPKdJJag: doesn't show hand
*** SUMMARY ***
Total pot $1 | Rake $0
Seat 1: V138SURkdX8LdVBPKdJJag (big blind) collected ($1)
Seat 2: OGgaARGdJQT4awWVNQ957w folded before Flop (didn't bet)
Seat 3: JMmUYT5pIKCKh2pGjCB/4w folded before Flop (didn't bet)
Seat 4: bLbSOSmSOnqE0iTcH/5dxA folded before Flop (didn't bet)
Seat 6: FVs16t7GgfWgQWt4JxsObQ folded before Flop (didn't bet)
Seat 7: 997ViqAtWn1FPjJqcffwcA (button) folded before Flop (didn't bet)
Seat 9: /JHoNdt0fK6X+isrqRfV3w (small blind) folded before Flop



PokerStars Game #59941246906:  Hold'em No Limit ($0.50/$1.00) - 2009/07/01 1:29:52 ET
Table 'W/wyObTiXZm+Ckkl3YxcSw' 6-max Seat #2 is the button
Seat 1: eUBBn2R56C1IQ6Cs/vitwg ($292.05 in chips)
Seat 2: oDiBRCaF0QVtd3kO6xZIXw ($159.65 in chips)
Seat 3: dxyNCn/qxfkGDUIf28Cbng ($61.80 in chips)
Seat 4: UBZQqpnJZdTYYY1FTb0rLA ($103.20 in chips)
Seat 5: +OrCjyw70oZhJiD22Mn+bg ($102.50 in chips)
Seat 6: b2a+5TkFf4xJN/Ihhma58Q ($38.30 in chips)
dxyNCn/qxfkGDUIf28Cbng: posts small blind $0.50
UBZQqpnJZdTYYY1FTb0rLA: posts big blind $1
*** HOLE CARDS ***
+OrCjyw70oZhJiD22Mn+bg: folds
b2a+5TkFf4xJN/Ihhma58Q: folds
eUBBn2R56C1IQ6Cs/vitwg: raises $2 to $3
oDiBRCaF0QVtd3kO6xZIXw: folds
dxyNCn/qxfkGDUIf28Cbng: folds
UBZQqpnJZdTYYY1FTb0rLA: folds
eUBBn2R56C1IQ6Cs/vitwg collected $2.50 from pot
*** SUMMARY ***
Total pot $2.50 | Rake $0
Seat 1: eUBBn2R56C1IQ6Cs/vitwg collected ($2.50)
Seat 2: oDiBRCaF0QVtd3kO6xZIXw (button) folded before Flop (didn't bet)
Seat 3: dxyNCn/qxfkGDUIf28Cbng (small blind) folded before Flop
Seat 4: UBZQqpnJZdTYYY1FTb0rLA (big blind) folded before Flop
Seat 5: +OrCjyw70oZhJiD22Mn+bg folded before Flop (didn't bet)
Seat 6: b2a+5TkFf4xJN/Ihhma58Q folded before Flop (didn't bet)



PokerStars Game #59941248756:  Hold'em No Limit ($0.50/$1.00) - 2009/07/01 1:29:55 ET
Table 'NqGO/cV3MwFAx+ZPB5ANmQ' 2-max Seat #1 is the button
Seat 1: ItaRAnHOgvYOv5ynbG1iTw ($100.50 in chips)
Seat 2: GtFB+yyeb2djMdPFuOW/Xg ($190 in chips)
ItaRAnHOgvYOv5ynbG1iTw: posts small blind $0.50
GtFB+yyeb2djMdPFuOW/Xg: posts big blind $1
*** HOLE CARDS ***
ItaRAnHOgvYOv5ynbG1iTw: raises $2 to $3
GtFB+yyeb2djMdPFuOW/Xg: raises $8 to $11
ItaRAnHOgvYOv5ynbG1iTw: calls $8
*** FLOP *** [Js 6s 3h]
GtFB+yyeb2djMdPFuOW/Xg: checks
ItaRAnHOgvYOv5ynbG1iTw: checks
*** TURN *** [Js 6s 3h] [4s]
GtFB+yyeb2djMdPFuOW/Xg: bets $13
ItaRAnHOgvYOv5ynbG1iTw: raises $19 to $32
GtFB+yyeb2djMdPFuOW/Xg: folds
ItaRAnHOgvYOv5ynbG1iTw collected $47.50 from pot
ItaRAnHOgvYOv5ynbG1iTw: doesn't show hand
*** SUMMARY ***
Total pot $48 | Rake $0.50
Board [Js 6s 3h 4s]
Seat 1: ItaRAnHOgvYOv5ynbG1iTw (button) (small blind) collected ($47.50)
Seat 2: GtFB+yyeb2djMdPFuOW/Xg (big blind) folded on the Turn



PokerStars Game #59941250082:  Hold'em No Limit ($0.50/$1.00) - 2009/07/01 1:29:57 ET
Table 'b8oW/dOL7fDza5DfZ/dOJQ' 6-max Seat #2 is the button
Seat 2: TSuRyAHnUPCFjP7Z0rEE0w ($120 in chips)
Seat 4: X87W8qaGsudJTSkClK2Cig ($20.85 in chips)
Seat 5: r4lpoh2BJZ8S6zyQv1JeSw ($102.50 in chips)
Seat 6: PvfYaKbzMpsmUcbOExckbQ ($100 in chips)
X87W8qaGsudJTSkClK2Cig: posts small blind $0.50
r4lpoh2BJZ8S6zyQv1JeSw: posts big blind $1
NakujTNjHFgzceydFf+E2Q: sits out
*** HOLE CARDS ***
PvfYaKbzMpsmUcbOExckbQ: folds
TSuRyAHnUPCFjP7Z0rEE0w: raises $3 to $4
X87W8qaGsudJTSkClK2Cig: folds
d8WX+9nUHoqlrAGagO0Wow joins the table at seat #3
r4lpoh2BJZ8S6zyQv1JeSw: folds
TSuRyAHnUPCFjP7Z0rEE0w collected $2.50 from pot
TSuRyAHnUPCFjP7Z0rEE0w: doesn't show hand
*** SUMMARY ***
Total pot $2.50 | Rake $0
Seat 2: TSuRyAHnUPCFjP7Z0rEE0w (button) collected ($2.50)
Seat 4: X87W8qaGsudJTSkClK2Cig (small blind) folded before Flop
Seat 5: r4lpoh2BJZ8S6zyQv1JeSw (big blind) folded before Flop
Seat 6: PvfYaKbzMpsmUcbOExckbQ folded before Flop (didn't bet)



PokerStars Game #59941252790:  Hold'em No Limit ($0.50/$1.00) - 2009/07/01 1:30:02 ET
Table 'gxFK0BVUD7cupu2uyRUZJg' 6-max Seat #4 is the button
Seat 1: M+X3uChmP6R63IwijVjgTg ($160.25 in chips)
Seat 2: hpxXcmRkXXI9HE5+5/j/0Q ($134.55 in chips)
Seat 3: Z2fXsGcjl+Eax+RzOgwOmg ($123.50 in chips)
Seat 4: JwCcjZl0bjJzG7hmE0dnTA ($100 in chips)
Seat 5: WgIrs6CBinyyw18pqdDtWA ($21.10 in chips)
Seat 6: dYyb6/42PMC8aNFlm/eBeQ ($104.40 in chips)
WgIrs6CBinyyw18pqdDtWA: posts small blind $0.50
dYyb6/42PMC8aNFlm/eBeQ: posts big blind $1
*** HOLE CARDS ***
M+X3uChmP6R63IwijVjgTg: folds
hpxXcmRkXXI9HE5+5/j/0Q: folds
Z2fXsGcjl+Eax+RzOgwOmg: raises $3 to $4
JwCcjZl0bjJzG7hmE0dnTA: raises $8 to $12
WgIrs6CBinyyw18pqdDtWA: folds
dYyb6/42PMC8aNFlm/eBeQ: folds
Z2fXsGcjl+Eax+RzOgwOmg: folds
JwCcjZl0bjJzG7hmE0dnTA collected $9.50 from pot
JwCcjZl0bjJzG7hmE0dnTA: doesn't show hand
*** SUMMARY ***
Total pot $9.50 | Rake $0
Seat 1: M+X3uChmP6R63IwijVjgTg folded before Flop (didn't bet)
Seat 2: hpxXcmRkXXI9HE5+5/j/0Q folded before Flop (didn't bet)
Seat 3: Z2fXsGcjl+Eax+RzOgwOmg folded before Flop
Seat 4: JwCcjZl0bjJzG7hmE0dnTA (button) collected ($9.50)
Seat 5: WgIrs6CBinyyw18pqdDtWA (small blind) folded before Flop
Seat 6: dYyb6/42PMC8aNFlm/eBeQ (big blind) folded before Flop



PokerStars Game #59941252686:  Hold'em No Limit ($0.50/$1.00) - 2009/07/01 1:30:02 ET
Table 'pHrhryH8jPNdQfY62f8v+g' 6-max Seat #2 is the button
Seat 1: 4d1rWhpu8DzLmzMbR3QKyA ($131.75 in chips)
Seat 2: JwCcjZl0bjJzG7hmE0dnTA ($131.55 in chips)
Seat 3: 8oS5O7iD/qnFXFXJrGIgNQ ($109.15 in chips)
Seat 4: 1f3beyIML24UqEMTbWy93g ($58.80 in chips)
Seat 6: xAU6q2/cwmby2sxmA8VcmA ($178.25 in chips)
8oS5O7iD/qnFXFXJrGIgNQ: posts small blind $0.50
1f3beyIML24UqEMTbWy93g: posts big blind $1
*** HOLE CARDS ***
xAU6q2/cwmby2sxmA8VcmA: folds
4d1rWhpu8DzLmzMbR3QKyA: raises $2 to $3
JwCcjZl0bjJzG7hmE0dnTA: raises $8 to $11
8oS5O7iD/qnFXFXJrGIgNQ: folds
1f3beyIML24UqEMTbWy93g: folds
4d1rWhpu8DzLmzMbR3QKyA: raises $15 to $26
d8WX+9nUHoqlrAGagO0Wow joins the table at seat #5
JwCcjZl0bjJzG7hmE0dnTA: folds
4d1rWhpu8DzLmzMbR3QKyA collected $23.50 from pot
*** SUMMARY ***
Total pot $23.50 | Rake $0
Seat 1: 4d1rWhpu8DzLmzMbR3QKyA collected ($23.50)
Seat 2: JwCcjZl0bjJzG7hmE0dnTA (button) folded before Flop
Seat 3: 8oS5O7iD/qnFXFXJrGIgNQ (small blind) folded before Flop
Seat 4: 1f3beyIML24UqEMTbWy93g (big blind) folded before Flop
Seat 6: xAU6q2/cwmby2sxmA8VcmA folded before Flop (didn't bet)



PokerStars Game #59941254160:  Hold'em No Limit ($0.50/$1.00) - 2009/07/01 1:30:04 ET
Table '+cA8mcmhaedZ7YcrDdhmeQ' 6-max Seat #2 is the button
Seat 1: 9XrTM0DuVxx1pjFAdSbD8A ($53.20 in chips)
Seat 2: 14aYclSc98EYd6TrzN2l3Q ($22.65 in chips)
Seat 3: DAIgyIWbYvAkL6PbAI27pg ($17.05 in chips)
Seat 4: 4OO5v3AVduL0tePNx8wk5A ($100 in chips)
Seat 6: YfsTQsY/fxb+YqbdclTHuw ($44.85 in chips)
DAIgyIWbYvAkL6PbAI27pg: posts small blind $0.50
4OO5v3AVduL0tePNx8wk5A: posts big blind $1
*** HOLE CARDS ***
YfsTQsY/fxb+YqbdclTHuw: folds
9XrTM0DuVxx1pjFAdSbD8A: folds
n5xXfJeDtWZSChGAdq//Tw leaves the table
14aYclSc98EYd6TrzN2l3Q: calls $1
DAIgyIWbYvAkL6PbAI27pg: folds
RqgF7gRoKgRNW8Zoi1ty4A joins the table at seat #5
4OO5v3AVduL0tePNx8wk5A: checks
*** FLOP *** [Qh Js 5h]
4OO5v3AVduL0tePNx8wk5A: checks
14aYclSc98EYd6TrzN2l3Q: bets $2
4OO5v3AVduL0tePNx8wk5A: folds
14aYclSc98EYd6TrzN2l3Q collected $2.40 from pot
*** SUMMARY ***
Total pot $2.50 | Rake $0.10
Board [Qh Js 5h]
Seat 1: 9XrTM0DuVxx1pjFAdSbD8A folded before Flop (didn't bet)
Seat 2: 14aYclSc98EYd6TrzN2l3Q (button) collected ($2.40)
Seat 3: DAIgyIWbYvAkL6PbAI27pg (small blind) folded before Flop
Seat 4: 4OO5v3AVduL0tePNx8wk5A (big blind) folded on the Flop
Seat 6: YfsTQsY/fxb+YqbdclTHuw folded before Flop (didn't bet)



PokerStars Game #59941254234:  Hold'em No Limit ($0.50/$1.00) - 2009/07/01 1:30:05 ET
Table 'O96CPOtvMBWP6kzuYDfdFA' 6-max Seat #1 is the button
Seat 1: 6alLXQIITA2EZ/lBeym8Dw ($127.75 in chips)
Seat 2: 4d1rWhpu8DzLmzMbR3QKyA ($101.60 in chips)
Seat 3: V89DGjxE171oPREEbAXiyg ($119.25 in chips)
Seat 4: /P4w1pHg2zHYg/4ubJ0dPw ($66.65 in chips)
Seat 5: G5ZSSN6RSON3gkNvk/SmYg ($105.65 in chips)
Seat 6: 3syOXva630dm1FTdwnuLpw ($60 in chips)
4d1rWhpu8DzLmzMbR3QKyA: posts small blind $0.50
V89DGjxE171oPREEbAXiyg: posts big blind $1
3syOXva630dm1FTdwnuLpw: posts big blind $1
*** HOLE CARDS ***
/P4w1pHg2zHYg/4ubJ0dPw: folds
G5ZSSN6RSON3gkNvk/SmYg: folds
3syOXva630dm1FTdwnuLpw: raises $2 to $3
6alLXQIITA2EZ/lBeym8Dw: folds
4d1rWhpu8DzLmzMbR3QKyA: calls $2.50
V89DGjxE171oPREEbAXiyg: folds
*** FLOP *** [7c 5s 9d]
4d1rWhpu8DzLmzMbR3QKyA: checks
3syOXva630dm1FTdwnuLpw: checks
*** TURN *** [7c 5s 9d] [8c]
4d1rWhpu8DzLmzMbR3QKyA: bets $5
3syOXva630dm1FTdwnuLpw: raises $7 to $12
4d1rWhpu8DzLmzMbR3QKyA: calls $7
*** RIVER *** [7c 5s 9d 8c] [4d]
4d1rWhpu8DzLmzMbR3QKyA: checks
3syOXva630dm1FTdwnuLpw: bets $45 and is all-in
4d1rWhpu8DzLmzMbR3QKyA: folds
3syOXva630dm1FTdwnuLpw collected $29.50 from pot
*** SUMMARY ***
Total pot $31 | Rake $1.50
Board [7c 5s 9d 8c 4d]
Seat 1: 6alLXQIITA2EZ/lBeym8Dw (button) folded before Flop (didn't bet)
Seat 2: 4d1rWhpu8DzLmzMbR3QKyA (small blind) folded on the River
Seat 3: V89DGjxE171oPREEbAXiyg (big blind) folded before Flop
Seat 4: /P4w1pHg2zHYg/4ubJ0dPw folded before Flop (didn't bet)
Seat 5: G5ZSSN6RSON3gkNvk/SmYg folded before Flop (didn't bet)
Seat 6: 3syOXva630dm1FTdwnuLpw collected ($29.50)



PokerStars Game #59941256120:  Hold'em No Limit ($0.50/$1.00) - 2009/07/01 1:30:08 ET
Table 'MUPc8FEpe/nR0BKSeReX6Q' 6-max Seat #2 is the button
Seat 1: qhkK6+yCciTRd+rCFEbnEQ ($83.10 in chips)
Seat 2: xAU6q2/cwmby2sxmA8VcmA ($105.20 in chips)
Seat 3: wx3sQGkVi2x9wJXuWNHPBw ($284.50 in chips)
Seat 4: r4lpoh2BJZ8S6zyQv1JeSw ($100 in chips)
Seat 5: y27w5IK2WXqmYzS8OU0wKA ($105.55 in chips)
Seat 6: cl/QpVR/PLO58lj+C5mGLw ($40 in chips)
wx3sQGkVi2x9wJXuWNHPBw: posts small blind $0.50
r4lpoh2BJZ8S6zyQv1JeSw: posts big blind $1
cl/QpVR/PLO58lj+C5mGLw: posts big blind $1
*** HOLE CARDS ***
y27w5IK2WXqmYzS8OU0wKA: raises $3 to $4
cl/QpVR/PLO58lj+C5mGLw: calls $3
qhkK6+yCciTRd+rCFEbnEQ: calls $4
xAU6q2/cwmby2sxmA8VcmA: folds
wx3sQGkVi2x9wJXuWNHPBw: folds
r4lpoh2BJZ8S6zyQv1JeSw: raises $20 to $24
y27w5IK2WXqmYzS8OU0wKA: folds
cl/QpVR/PLO58lj+C5mGLw: folds
qhkK6+yCciTRd+rCFEbnEQ: folds
r4lpoh2BJZ8S6zyQv1JeSw collected $16.50 from pot
r4lpoh2BJZ8S6zyQv1JeSw: doesn't show hand
*** SUMMARY ***
Total pot $16.50 | Rake $0
Seat 1: qhkK6+yCciTRd+rCFEbnEQ folded before Flop
Seat 2: xAU6q2/cwmby2sxmA8VcmA (button) folded before Flop (didn't bet)
Seat 3: wx3sQGkVi2x9wJXuWNHPBw (small blind) folded before Flop
Seat 4: r4lpoh2BJZ8S6zyQv1JeSw (big blind) collected ($16.50)
Seat 5: y27w5IK2WXqmYzS8OU0wKA folded before Flop
Seat 6: cl/QpVR/PLO58lj+C5mGLw folded before Flop



PokerStars Game #59941256266:  Hold'em No Limit ($0.50/$1.00) - 2009/07/01 1:30:08 ET
Table 'hugOjcwJvzEwZbK7tyiWuQ' 9-max Seat #8 is the button
Seat 1: S3Ex8K7v6xm5jqjRM7Fl3w ($20 in chips)
Seat 2: r27C1nIV4NS4+qbnrgBQSw ($280.10 in chips)
Seat 3: c/6hFCyfLNRn3VFvCeQ1ng ($25.95 in chips)
Seat 4: UWB3oeddt/GObx2Mix2Anw ($178.10 in chips)
Seat 5: AexZ4puUV9meFWwVU6Nv0w ($19 in chips)
Seat 6: gUUvmqdVlmvpal6B8nYrmg ($105.45 in chips)
Seat 7: FL3MrLspcF23LYvC4ipBOA ($111.30 in chips)
Seat 8: /zy+DB4S5fUQUSfZWFzYGw ($118.35 in chips)
Seat 9: W8P9bUKCs43TO1xHm0dL6w ($112.80 in chips)
W8P9bUKCs43TO1xHm0dL6w: posts small blind $0.50
S3Ex8K7v6xm5jqjRM7Fl3w: posts big blind $1
*** HOLE CARDS ***
r27C1nIV4NS4+qbnrgBQSw: folds
c/6hFCyfLNRn3VFvCeQ1ng: calls $1
UWB3oeddt/GObx2Mix2Anw: folds
AexZ4puUV9meFWwVU6Nv0w: calls $1
gUUvmqdVlmvpal6B8nYrmg: folds
FL3MrLspcF23LYvC4ipBOA: folds
/zy+DB4S5fUQUSfZWFzYGw: folds
W8P9bUKCs43TO1xHm0dL6w: calls $0.50
S3Ex8K7v6xm5jqjRM7Fl3w: checks
*** FLOP *** [Th 6d Kc]
W8P9bUKCs43TO1xHm0dL6w: bets $2
S3Ex8K7v6xm5jqjRM7Fl3w: folds
c/6hFCyfLNRn3VFvCeQ1ng: calls $2
AexZ4puUV9meFWwVU6Nv0w: folds
*** TURN *** [Th 6d Kc] [Ts]
W8P9bUKCs43TO1xHm0dL6w: checks
c/6hFCyfLNRn3VFvCeQ1ng: checks
*** RIVER *** [Th 6d Kc Ts] [8h]
W8P9bUKCs43TO1xHm0dL6w: checks
c/6hFCyfLNRn3VFvCeQ1ng: bets $5
W8P9bUKCs43TO1xHm0dL6w: folds
c/6hFCyfLNRn3VFvCeQ1ng collected $7.65 from pot
*** SUMMARY ***
Total pot $8 | Rake $0.35
Board [Th 6d Kc Ts 8h]
Seat 1: S3Ex8K7v6xm5jqjRM7Fl3w (big blind) folded on the Flop
Seat 2: r27C1nIV4NS4+qbnrgBQSw folded before Flop (didn't bet)
Seat 3: c/6hFCyfLNRn3VFvCeQ1ng collected ($7.65)
Seat 4: UWB3oeddt/GObx2Mix2Anw folded before Flop (didn't bet)
Seat 5: AexZ4puUV9meFWwVU6Nv0w folded on the Flop
Seat 6: gUUvmqdVlmvpal6B8nYrmg folded before Flop (didn't bet)
Seat 7: FL3MrLspcF23LYvC4ipBOA folded before Flop (didn't bet)
Seat 8: /zy+DB4S5fUQUSfZWFzYGw (button) folded before Flop (didn't bet)
Seat 9: W8P9bUKCs43TO1xHm0dL6w (small blind) folded on the River



PokerStars Game #59941256438:  Hold'em No Limit ($0.50/$1.00) - 2009/07/01 1:30:09 ET
Table '/FUb199IViHMJHi5YWmeuQ' 9-max Seat #7 is the button
Seat 1: 3obndzTJ6fECz8+wWhMd1w ($18.50 in chips)
Seat 2: FL3MrLspcF23LYvC4ipBOA ($185.55 in chips)
Seat 3: V138SURkdX8LdVBPKdJJag ($125.25 in chips)
Seat 4: pbAfmxe4uSZPxJQX7gOzZA ($66.20 in chips)
Seat 5: H+DVy3Ei8L1UKS2tVOtJcw ($136.85 in chips)
Seat 6: VPF+HjszMvUIpy0CHIwH3A ($21.50 in chips)
Seat 7: myIxN7otsyr846M539YR8Q ($18.50 in chips)
Seat 8: 997ViqAtWn1FPjJqcffwcA ($101.50 in chips)
Seat 9: RfLbneGRY8yQUpMgDnJCxA ($76.70 in chips)
997ViqAtWn1FPjJqcffwcA: posts small blind $0.50
RfLbneGRY8yQUpMgDnJCxA: posts big blind $1
*** HOLE CARDS ***
3obndzTJ6fECz8+wWhMd1w: folds
FL3MrLspcF23LYvC4ipBOA: folds
V138SURkdX8LdVBPKdJJag: raises $2.50 to $3.50
pbAfmxe4uSZPxJQX7gOzZA: calls $3.50
H+DVy3Ei8L1UKS2tVOtJcw: folds
VPF+HjszMvUIpy0CHIwH3A: folds
myIxN7otsyr846M539YR8Q: raises $15 to $18.50 and is all-in
997ViqAtWn1FPjJqcffwcA: folds
RfLbneGRY8yQUpMgDnJCxA: folds
V138SURkdX8LdVBPKdJJag: folds
pbAfmxe4uSZPxJQX7gOzZA: folds
myIxN7otsyr846M539YR8Q collected $12 from pot
myIxN7otsyr846M539YR8Q: doesn't show hand
*** SUMMARY ***
Total pot $12 | Rake $0
Seat 1: 3obndzTJ6fECz8+wWhMd1w folded before Flop (didn't bet)
Seat 2: FL3MrLspcF23LYvC4ipBOA folded before Flop (didn't bet)
Seat 3: V138SURkdX8LdVBPKdJJag folded before Flop
Seat 4: pbAfmxe4uSZPxJQX7gOzZA folded before Flop
Seat 5: H+DVy3Ei8L1UKS2tVOtJcw folded before Flop (didn't bet)
Seat 6: VPF+HjszMvUIpy0CHIwH3A folded before Flop (didn't bet)
Seat 7: myIxN7otsyr846M539YR8Q (button) collected ($12)
Seat 8: 997ViqAtWn1FPjJqcffwcA (small blind) folded before Flop
Seat 9: RfLbneGRY8yQUpMgDnJCxA (big blind) folded before Flop



PokerStars Game #59941258950:  Hold'em No Limit ($0.50/$1.00) - 2009/07/01 1:30:13 ET
Table 'jDQgUn1zGkyftPnHo0Awdw' 2-max Seat #1 is the button
Seat 1: a42+e5QB6s1kkG5FoSTZJw ($98.85 in chips)
Seat 2: q+vRKwm51mnr6kxX/161WQ ($95 in chips)
a42+e5QB6s1kkG5FoSTZJw: posts small blind $0.50
q+vRKwm51mnr6kxX/161WQ: posts big blind $1
*** HOLE CARDS ***
a42+e5QB6s1kkG5FoSTZJw: raises $1 to $2
q+vRKwm51mnr6kxX/161WQ: calls $1
*** FLOP *** [Kc Qc 9s]
q+vRKwm51mnr6kxX/161WQ: checks
a42+e5QB6s1kkG5FoSTZJw: bets $3
q+vRKwm51mnr6kxX/161WQ: folds
a42+e5QB6s1kkG5FoSTZJw collected $3.80 from pot
a42+e5QB6s1kkG5FoSTZJw: doesn't show hand
*** SUMMARY ***
Total pot $4 | Rake $0.20
Board [Kc Qc 9s]
Seat 1: a42+e5QB6s1kkG5FoSTZJw (button) (small blind) collected ($3.80)
Seat 2: q+vRKwm51mnr6kxX/161WQ (big blind) folded on the Flop



PokerStars Game #59941258876:  Hold'em No Limit ($0.50/$1.00) - 2009/07/01 1:30:13 ET
Table 'N6LvHFrb+cdXY/COI6ByOw' 2-max Seat #2 is the button
Seat 1: lXX4W7m3u++JiSOZ46yVMQ ($104.40 in chips)
Seat 2: 9mAoSP3o/mikSZOW2LEEAw ($92.45 in chips)
9mAoSP3o/mikSZOW2LEEAw: posts small blind $0.50
lXX4W7m3u++JiSOZ46yVMQ: posts big blind $1
*** HOLE CARDS ***
9mAoSP3o/mikSZOW2LEEAw: raises $2 to $3
lXX4W7m3u++JiSOZ46yVMQ: folds
9mAoSP3o/mikSZOW2LEEAw collected $2 from pot
*** SUMMARY ***
Total pot $2 | Rake $0
Seat 1: lXX4W7m3u++JiSOZ46yVMQ (big blind) folded before Flop
Seat 2: 9mAoSP3o/mikSZOW2LEEAw (button) (small blind) collected ($2)



PokerStars Game #59941259636:  Hold'em No Limit ($0.50/$1.00) - 2009/07/01 1:30:14 ET
Table 'MNvFfRVQNka/oY+Z5aMbZQ' 2-max Seat #2 is the button
Seat 1: DaZnoWHjO897dnh0CL2lVg ($70.30 in chips)
Seat 2: mgi+mjKb1Sc3CCs7TlfoCw ($88.95 in chips)
mgi+mjKb1Sc3CCs7TlfoCw: posts small blind $0.50
DaZnoWHjO897dnh0CL2lVg: posts big blind $1
*** HOLE CARDS ***
mgi+mjKb1Sc3CCs7TlfoCw: folds
DaZnoWHjO897dnh0CL2lVg collected $1 from pot
*** SUMMARY ***
Total pot $1 | Rake $0
Seat 1: DaZnoWHjO897dnh0CL2lVg (big blind) collected ($1)
Seat 2: mgi+mjKb1Sc3CCs7TlfoCw (button) (small blind) folded before Flop



PokerStars Game #59941259732:  Hold'em No Limit ($0.50/$1.00) - 2009/07/01 1:30:14 ET
Table '7Nl0ffnjeK44/vmeexh3MQ' 9-max Seat #9 is the button
Seat 1: V138SURkdX8LdVBPKdJJag ($102 in chips)
Seat 2: OGgaARGdJQT4awWVNQ957w ($100.50 in chips)
Seat 3: JMmUYT5pIKCKh2pGjCB/4w ($58.90 in chips)
Seat 4: bLbSOSmSOnqE0iTcH/5dxA ($105.30 in chips)
Seat 5: 61sfw5QTu62YYIt68OsdrA ($80.50 in chips)
Seat 6: FVs16t7GgfWgQWt4JxsObQ ($24.85 in chips)
Seat 7: 997ViqAtWn1FPjJqcffwcA ($100 in chips)
Seat 9: /JHoNdt0fK6X+isrqRfV3w ($20 in chips)
V138SURkdX8LdVBPKdJJag: posts small blind $0.50
OGgaARGdJQT4awWVNQ957w: posts big blind $1
61sfw5QTu62YYIt68OsdrA: posts small blind $0.50
*** HOLE CARDS ***
JMmUYT5pIKCKh2pGjCB/4w: folds
bLbSOSmSOnqE0iTcH/5dxA: folds
61sfw5QTu62YYIt68OsdrA: folds
FVs16t7GgfWgQWt4JxsObQ: calls $1
997ViqAtWn1FPjJqcffwcA: folds
/JHoNdt0fK6X+isrqRfV3w: folds
V138SURkdX8LdVBPKdJJag: folds
OGgaARGdJQT4awWVNQ957w: checks
*** FLOP *** [7d 9h Kd]
OGgaARGdJQT4awWVNQ957w: checks
FVs16t7GgfWgQWt4JxsObQ: bets $2
OGgaARGdJQT4awWVNQ957w: folds
FVs16t7GgfWgQWt4JxsObQ collected $2.85 from pot
*** SUMMARY ***
Total pot $3 | Rake $0.15
Board [7d 9h Kd]
Seat 1: V138SURkdX8LdVBPKdJJag (small blind) folded before Flop
Seat 2: OGgaARGdJQT4awWVNQ957w (big blind) folded on the Flop
Seat 3: JMmUYT5pIKCKh2pGjCB/4w folded before Flop (didn't bet)
Seat 4: bLbSOSmSOnqE0iTcH/5dxA folded before Flop (didn't bet)
Seat 5: 61sfw5QTu62YYIt68OsdrA folded before Flop
Seat 6: FVs16t7GgfWgQWt4JxsObQ collected ($2.85)
Seat 7: 997ViqAtWn1FPjJqcffwcA folded before Flop (didn't bet)
Seat 9: /JHoNdt0fK6X+isrqRfV3w (button) folded before Flop (didn't bet)



PokerStars Game #59941259954:  Hold'em No Limit ($0.50/$1.00) - 2009/07/01 1:30:15 ET
Table 'W/wyObTiXZm+Ckkl3YxcSw' 6-max Seat #3 is the button
Seat 1: eUBBn2R56C1IQ6Cs/vitwg ($293.55 in chips)
Seat 2: oDiBRCaF0QVtd3kO6xZIXw ($159.65 in chips)
Seat 3: dxyNCn/qxfkGDUIf28Cbng ($61.30 in chips)
Seat 4: UBZQqpnJZdTYYY1FTb0rLA ($102.20 in chips)
Seat 5: +OrCjyw70oZhJiD22Mn+bg ($102.50 in chips)
Seat 6: b2a+5TkFf4xJN/Ihhma58Q ($38.30 in chips)
UBZQqpnJZdTYYY1FTb0rLA: posts small blind $0.50
+OrCjyw70oZhJiD22Mn+bg: posts big blind $1
*** HOLE CARDS ***
b2a+5TkFf4xJN/Ihhma58Q: raises $1 to $2
eUBBn2R56C1IQ6Cs/vitwg: folds
oDiBRCaF0QVtd3kO6xZIXw: calls $2
dxyNCn/qxfkGDUIf28Cbng: folds
UBZQqpnJZdTYYY1FTb0rLA: folds
+OrCjyw70oZhJiD22Mn+bg: folds
*** FLOP *** [4d Ah 7s]
b2a+5TkFf4xJN/Ihhma58Q: checks
oDiBRCaF0QVtd3kO6xZIXw: bets $3.50
b2a+5TkFf4xJN/Ihhma58Q: folds
oDiBRCaF0QVtd3kO6xZIXw collected $5.25 from pot
oDiBRCaF0QVtd3kO6xZIXw: doesn't show hand
*** SUMMARY ***
Total pot $5.50 | Rake $0.25
Board [4d Ah 7s]
Seat 1: eUBBn2R56C1IQ6Cs/vitwg folded before Flop (didn't bet)
Seat 2: oDiBRCaF0QVtd3kO6xZIXw collected ($5.25)
Seat 3: dxyNCn/qxfkGDUIf28Cbng (button) folded before Flop (didn't bet)
Seat 4: UBZQqpnJZdTYYY1FTb0rLA (small blind) folded before Flop
Seat 5: +OrCjyw70oZhJiD22Mn+bg (big blind) folded before Flop
Seat 6: b2a+5TkFf4xJN/Ihhma58Q folded on the Flop



PokerStars Game #59941260604:  Hold'em No Limit ($0.50/$1.00) - 2009/07/01 1:30:16 ET
Table 'b8oW/dOL7fDza5DfZ/dOJQ' 6-max Seat #4 is the button
Seat 2: TSuRyAHnUPCFjP7Z0rEE0w ($121.50 in chips)
Seat 4: X87W8qaGsudJTSkClK2Cig ($20.35 in chips)
Seat 5: r4lpoh2BJZ8S6zyQv1JeSw ($101.50 in chips)
Seat 6: PvfYaKbzMpsmUcbOExckbQ ($100 in chips)
r4lpoh2BJZ8S6zyQv1JeSw: posts small blind $0.50
PvfYaKbzMpsmUcbOExckbQ: posts big blind $1
NakujTNjHFgzceydFf+E2Q: sits out
d8WX+9nUHoqlrAGagO0Wow: sits out
*** HOLE CARDS ***
TSuRyAHnUPCFjP7Z0rEE0w: folds
X87W8qaGsudJTSkClK2Cig: folds
r4lpoh2BJZ8S6zyQv1JeSw: raises $2 to $3
PvfYaKbzMpsmUcbOExckbQ: folds
r4lpoh2BJZ8S6zyQv1JeSw collected $2 from pot
r4lpoh2BJZ8S6zyQv1JeSw: doesn't show hand
*** SUMMARY ***
Total pot $2 | Rake $0
Seat 2: TSuRyAHnUPCFjP7Z0rEE0w folded before Flop (didn't bet)
Seat 4: X87W8qaGsudJTSkClK2Cig (button) folded before Flop (didn't bet)
Seat 5: r4lpoh2BJZ8S6zyQv1JeSw (small blind) collected ($2)
Seat 6: PvfYaKbzMpsmUcbOExckbQ (big blind) folded before Flop



PokerStars Game #59941261932:  Hold'em No Limit ($0.50/$1.00) - 2009/07/01 1:30:19 ET
Table 'tJq9SfN1ywY0r03VBlWlwQ' 9-max Seat #9 is the button
Seat 1: wZsU+w9r7G66x93UuvBf1Q ($298.05 in chips)
Seat 2: VPF+HjszMvUIpy0CHIwH3A ($20 in chips)
Seat 4: bLbSOSmSOnqE0iTcH/5dxA ($109.65 in chips)
Seat 5: h5ipsNTMyolp7xn/NAvWkA ($136.90 in chips)
Seat 6: gUUvmqdVlmvpal6B8nYrmg ($100 in chips)
Seat 7: Pp/KTcXkfZKKUHkjyaLTdg ($34.05 in chips)
Seat 8: G4DEhsZFmznGNVpy2SEocA ($42.30 in chips)
Seat 9: XE5QF1y74bpHog9JxWJMWQ ($100 in chips)
wZsU+w9r7G66x93UuvBf1Q: posts small blind $0.50
VPF+HjszMvUIpy0CHIwH3A: posts big blind $1
*** HOLE CARDS ***
bLbSOSmSOnqE0iTcH/5dxA: raises $3 to $4
h5ipsNTMyolp7xn/NAvWkA: folds
gUUvmqdVlmvpal6B8nYrmg: folds
Pp/KTcXkfZKKUHkjyaLTdg: folds
G4DEhsZFmznGNVpy2SEocA: folds
XE5QF1y74bpHog9JxWJMWQ: folds
wZsU+w9r7G66x93UuvBf1Q: folds
VPF+HjszMvUIpy0CHIwH3A: folds
bLbSOSmSOnqE0iTcH/5dxA collected $2.50 from pot
*** SUMMARY ***
Total pot $2.50 | Rake $0
Seat 1: wZsU+w9r7G66x93UuvBf1Q (small blind) folded before Flop
Seat 2: VPF+HjszMvUIpy0CHIwH3A (big blind) folded before Flop
Seat 4: bLbSOSmSOnqE0iTcH/5dxA collected ($2.50)
Seat 5: h5ipsNTMyolp7xn/NAvWkA folded before Flop (didn't bet)
Seat 6: gUUvmqdVlmvpal6B8nYrmg folded before Flop (didn't bet)
Seat 7: Pp/KTcXkfZKKUHkjyaLTdg folded before Flop (didn't bet)
Seat 8: G4DEhsZFmznGNVpy2SEocA folded before Flop (didn't bet)
Seat 9: XE5QF1y74bpHog9JxWJMWQ (button) folded before Flop (didn't bet)



PokerStars Game #59941262742:  Hold'em No Limit ($0.50/$1.00) - 2009/07/01 1:30:20 ET
Table 'QSIig7BLMc9wY/rgBechzw' 6-max Seat #1 is the button
Seat 1: Z2fXsGcjl+Eax+RzOgwOmg ($105.50 in chips)
Seat 2: mLOIkH/qmRa+mVujQIhBRg ($43.90 in chips)
Seat 3: +xW7QemQU0Fxs+4TnqBRow ($110 in chips)
Seat 4: +uSzP8Jwnw7sKfQ4s66b7w ($63.95 in chips)
Seat 5: lsLuWlcPA3Rh7kJVLzMh0Q ($103.20 in chips)
Seat 6: PxqfkAMdAWtkgbT+q2gciA ($65.10 in chips)
mLOIkH/qmRa+mVujQIhBRg: posts small blind $0.50
+xW7QemQU0Fxs+4TnqBRow: posts big blind $1
*** HOLE CARDS ***
+uSzP8Jwnw7sKfQ4s66b7w: folds
lsLuWlcPA3Rh7kJVLzMh0Q: folds
PxqfkAMdAWtkgbT+q2gciA: calls $1
Z2fXsGcjl+Eax+RzOgwOmg: raises $4 to $5
mLOIkH/qmRa+mVujQIhBRg: folds
+xW7QemQU0Fxs+4TnqBRow: folds
PxqfkAMdAWtkgbT+q2gciA: folds
Z2fXsGcjl+Eax+RzOgwOmg collected $3.50 from pot
Z2fXsGcjl+Eax+RzOgwOmg: doesn't show hand
*** SUMMARY ***
Total pot $3.50 | Rake $0
Seat 1: Z2fXsGcjl+Eax+RzOgwOmg (button) collected ($3.50)
Seat 2: mLOIkH/qmRa+mVujQIhBRg (small blind) folded before Flop
Seat 3: +xW7QemQU0Fxs+4TnqBRow (big blind) folded before Flop
Seat 4: +uSzP8Jwnw7sKfQ4s66b7w folded before Flop (didn't bet)
Seat 5: lsLuWlcPA3Rh7kJVLzMh0Q folded before Flop (didn't bet)
Seat 6: PxqfkAMdAWtkgbT+q2gciA folded before Flop



PokerStars Game #59941262482:  Hold'em No Limit ($0.50/$1.00) - 2009/07/01 1:30:20 ET
Table 'N6LvHFrb+cdXY/COI6ByOw' 2-max Seat #1 is the button
Seat 1: lXX4W7m3u++JiSOZ46yVMQ ($103.40 in chips)
Seat 2: 9mAoSP3o/mikSZOW2LEEAw ($93.45 in chips)
lXX4W7m3u++JiSOZ46yVMQ: posts small blind $0.50
9mAoSP3o/mikSZOW2LEEAw: posts big blind $1
*** HOLE CARDS ***
lXX4W7m3u++JiSOZ46yVMQ: calls $0.50
9mAoSP3o/mikSZOW2LEEAw: checks
*** FLOP *** [Qs 8d 3d]
9mAoSP3o/mikSZOW2LEEAw: checks
lXX4W7m3u++JiSOZ46yVMQ: bets $2
9mAoSP3o/mikSZOW2LEEAw: folds
lXX4W7m3u++JiSOZ46yVMQ collected $1.90 from pot
*** SUMMARY ***
Total pot $2 | Rake $0.10
Board [Qs 8d 3d]
Seat 1: lXX4W7m3u++JiSOZ46yVMQ (button) (small blind) collected ($1.90)
Seat 2: 9mAoSP3o/mikSZOW2LEEAw (big blind) folded on the Flop



PokerStars Game #59941263310:  Hold'em No Limit ($0.50/$1.00) - 2009/07/01 1:30:21 ET
Table 'MNvFfRVQNka/oY+Z5aMbZQ' 2-max Seat #1 is the button
Seat 1: DaZnoWHjO897dnh0CL2lVg ($70.80 in chips)
Seat 2: mgi+mjKb1Sc3CCs7TlfoCw ($88.45 in chips)
DaZnoWHjO897dnh0CL2lVg: posts small blind $0.50
mgi+mjKb1Sc3CCs7TlfoCw: posts big blind $1
*** HOLE CARDS ***
DaZnoWHjO897dnh0CL2lVg: raises $2 to $3
mgi+mjKb1Sc3CCs7TlfoCw: raises $8 to $11
DaZnoWHjO897dnh0CL2lVg: folds
mgi+mjKb1Sc3CCs7TlfoCw collected $6 from pot
*** SUMMARY ***
Total pot $6 | Rake $0
Seat 1: DaZnoWHjO897dnh0CL2lVg (button) (small blind) folded before Flop
Seat 2: mgi+mjKb1Sc3CCs7TlfoCw (big blind) collected ($6)



PokerStars Game #59941264424:  Hold'em No Limit ($0.50/$1.00) - 2009/07/01 1:30:23 ET
Table '305hiksPPCCdC6V2LNsO5w' 6-max Seat #4 is the button
Seat 1: RTuDLJHh/9zPfBftoc9vsw ($11 in chips)
Seat 2: j7NIOHLZk7V2o9fOioO5ug ($132 in chips)
Seat 3: +zIVjZKLpcidfRHgVZW8lA ($30.70 in chips)
Seat 4: uJVSceLggtsrJya+WtmUEA ($213.05 in chips)
Seat 5: +Nt3OPk3XR9SKjZgm2CexQ ($110.15 in chips)
Seat 6: 9/Tq8dw7kWW68uN8bFupXg ($20.90 in chips)
+Nt3OPk3XR9SKjZgm2CexQ: posts small blind $0.50
9/Tq8dw7kWW68uN8bFupXg: posts big blind $1
*** HOLE CARDS ***
RTuDLJHh/9zPfBftoc9vsw: folds
j7NIOHLZk7V2o9fOioO5ug: folds
+zIVjZKLpcidfRHgVZW8lA: calls $1
uJVSceLggtsrJya+WtmUEA: calls $1
+Nt3OPk3XR9SKjZgm2CexQ: calls $0.50
9/Tq8dw7kWW68uN8bFupXg: raises $19.90 to $20.90 and is all-in
+zIVjZKLpcidfRHgVZW8lA: folds
uJVSceLggtsrJya+WtmUEA: folds
+Nt3OPk3XR9SKjZgm2CexQ: folds
9/Tq8dw7kWW68uN8bFupXg collected $4 from pot
*** SUMMARY ***
Total pot $4 | Rake $0
Seat 1: RTuDLJHh/9zPfBftoc9vsw folded before Flop (didn't bet)
Seat 2: j7NIOHLZk7V2o9fOioO5ug folded before Flop (didn't bet)
Seat 3: +zIVjZKLpcidfRHgVZW8lA folded before Flop
Seat 4: uJVSceLggtsrJya+WtmUEA (button) folded before Flop
Seat 5: +Nt3OPk3XR9SKjZgm2CexQ (small blind) folded before Flop
Seat 6: 9/Tq8dw7kWW68uN8bFupXg (big blind) collected ($4)



PokerStars Game #59941264132:  Hold'em No Limit ($0.50/$1.00) - 2009/07/01 1:30:23 ET
Table 'kS0cTQAEi+fdUlJP2gQYvw' 9-max Seat #6 is the button
Seat 1: SqsWPukL8kLqrhq5ZrQdSQ ($99 in chips)
Seat 2: D+W9Me7w6Hcx/WRUSKV0dw ($25.05 in chips)
Seat 3: 2BV+oJIQYr65IO6nEChvbA ($67 in chips)
Seat 4: RUhhaALzha3TH1AkdakoGQ ($52.50 in chips)
Seat 5: 997ViqAtWn1FPjJqcffwcA ($100 in chips)
Seat 6: yAbu2QsRPVcjPbqlf/jDxw ($124.65 in chips)
Seat 7: Ffa7Nj4X5fddtROP01hfQg ($144.60 in chips)
Seat 8: vKyFzTyzfT7fZcdX+HHN+Q ($34.95 in chips)
Seat 9: OGgaARGdJQT4awWVNQ957w ($107.80 in chips)
Ffa7Nj4X5fddtROP01hfQg: posts small blind $0.50
vKyFzTyzfT7fZcdX+HHN+Q: posts big blind $1
*** HOLE CARDS ***
OGgaARGdJQT4awWVNQ957w: folds
SqsWPukL8kLqrhq5ZrQdSQ: folds
D+W9Me7w6Hcx/WRUSKV0dw: folds
2BV+oJIQYr65IO6nEChvbA: folds
RUhhaALzha3TH1AkdakoGQ: folds
997ViqAtWn1FPjJqcffwcA: folds
yAbu2QsRPVcjPbqlf/jDxw: folds
Ffa7Nj4X5fddtROP01hfQg: calls $0.50
vKyFzTyzfT7fZcdX+HHN+Q: checks
*** FLOP *** [6h Qh 7c]
Ffa7Nj4X5fddtROP01hfQg: checks
vKyFzTyzfT7fZcdX+HHN+Q: checks
*** TURN *** [6h Qh 7c] [Jh]
Ffa7Nj4X5fddtROP01hfQg: checks
vKyFzTyzfT7fZcdX+HHN+Q: checks
*** RIVER *** [6h Qh 7c Jh] [9s]
Ffa7Nj4X5fddtROP01hfQg: bets $3
vKyFzTyzfT7fZcdX+HHN+Q: folds
Ffa7Nj4X5fddtROP01hfQg collected $1.90 from pot
*** SUMMARY ***
Total pot $2 | Rake $0.10
Board [6h Qh 7c Jh 9s]
Seat 1: SqsWPukL8kLqrhq5ZrQdSQ folded before Flop (didn't bet)
Seat 2: D+W9Me7w6Hcx/WRUSKV0dw folded before Flop (didn't bet)
Seat 3: 2BV+oJIQYr65IO6nEChvbA folded before Flop (didn't bet)
Seat 4: RUhhaALzha3TH1AkdakoGQ folded before Flop (didn't bet)
Seat 5: 997ViqAtWn1FPjJqcffwcA folded before Flop (didn't bet)
Seat 6: yAbu2QsRPVcjPbqlf/jDxw (button) folded before Flop (didn't bet)
Seat 7: Ffa7Nj4X5fddtROP01hfQg (small blind) collected ($1.90)
Seat 8: vKyFzTyzfT7fZcdX+HHN+Q (big blind) folded on the River
Seat 9: OGgaARGdJQT4awWVNQ957w folded before Flop (didn't bet)



PokerStars Game #59941265128:  Hold'em No Limit ($0.50/$1.00) - 2009/07/01 1:30:25 ET
Table 'fZjVbKj9D8yOB+Rj7NaP/A' 9-max Seat #6 is the button
Seat 1: 9BZCcac3+McErkkSN2YScA ($102.25 in chips)
Seat 2: PTAFYDIUSsG+SArbxNl+Aw ($105.50 in chips)
Seat 3: yAbu2QsRPVcjPbqlf/jDxw ($100 in chips)
Seat 4: 997ViqAtWn1FPjJqcffwcA ($100 in chips)
Seat 5: PkGfq5xrSlNsujKaG/HF4Q ($100 in chips)
Seat 6: OvwYHV65yUbgdBjSmo1+5g ($131.40 in chips)
Seat 7: SyS20PAm3RpT6uLBsGkwOA ($70.60 in chips)
Seat 9: qheQay5YvP2DMAb3OUSxtw ($100.50 in chips)
SyS20PAm3RpT6uLBsGkwOA: posts small blind $0.50
zDOE5r14tWqCf6xhuSHK6g: is sitting out
qheQay5YvP2DMAb3OUSxtw: posts big blind $1
*** HOLE CARDS ***
9BZCcac3+McErkkSN2YScA: folds
PTAFYDIUSsG+SArbxNl+Aw: folds
zDOE5r14tWqCf6xhuSHK6g leaves the table
yAbu2QsRPVcjPbqlf/jDxw: folds
997ViqAtWn1FPjJqcffwcA: folds
PkGfq5xrSlNsujKaG/HF4Q: folds
OvwYHV65yUbgdBjSmo1+5g: folds
SyS20PAm3RpT6uLBsGkwOA: folds
qheQay5YvP2DMAb3OUSxtw collected $1 from pot
qheQay5YvP2DMAb3OUSxtw: doesn't show hand
*** SUMMARY ***
Total pot $1 | Rake $0
Seat 1: 9BZCcac3+McErkkSN2YScA folded before Flop (didn't bet)
Seat 2: PTAFYDIUSsG+SArbxNl+Aw folded before Flop (didn't bet)
Seat 3: yAbu2QsRPVcjPbqlf/jDxw folded before Flop (didn't bet)
Seat 4: 997ViqAtWn1FPjJqcffwcA folded before Flop (didn't bet)
Seat 5: PkGfq5xrSlNsujKaG/HF4Q folded before Flop (didn't bet)
Seat 6: OvwYHV65yUbgdBjSmo1+5g (button) folded before Flop (didn't bet)
Seat 7: SyS20PAm3RpT6uLBsGkwOA (small blind) folded before Flop
Seat 9: qheQay5YvP2DMAb3OUSxtw (big blind) collected ($1)



PokerStars Game #59941267798:  Hold'em No Limit ($0.50/$1.00) - 2009/07/01 1:30:29 ET
Table 'cBDNutyLBKEk9+ptwsKmTw' 6-max Seat #3 is the button
Seat 1: xAU6q2/cwmby2sxmA8VcmA ($299.05 in chips)
Seat 2: 4OO5v3AVduL0tePNx8wk5A ($105.05 in chips)
Seat 3: G5ZSSN6RSON3gkNvk/SmYg ($107.40 in chips)
Seat 4: OMkHNxIUZxh1pHqcCjbjgw ($91.50 in chips)
Seat 5: hpxXcmRkXXI9HE5+5/j/0Q ($106.20 in chips)
Seat 6: QHvTZcrKe6+maWUfVjP29Q ($151.50 in chips)
OMkHNxIUZxh1pHqcCjbjgw: posts small blind $0.50
hpxXcmRkXXI9HE5+5/j/0Q: posts big blind $1
*** HOLE CARDS ***
QHvTZcrKe6+maWUfVjP29Q: raises $2.50 to $3.50
xAU6q2/cwmby2sxmA8VcmA: folds
4OO5v3AVduL0tePNx8wk5A: folds
G5ZSSN6RSON3gkNvk/SmYg: folds
OMkHNxIUZxh1pHqcCjbjgw: folds
hpxXcmRkXXI9HE5+5/j/0Q: folds
QHvTZcrKe6+maWUfVjP29Q collected $2.50 from pot
QHvTZcrKe6+maWUfVjP29Q: doesn't show hand
*** SUMMARY ***
Total pot $2.50 | Rake $0
Seat 1: xAU6q2/cwmby2sxmA8VcmA folded before Flop (didn't bet)
Seat 2: 4OO5v3AVduL0tePNx8wk5A folded before Flop (didn't bet)
Seat 3: G5ZSSN6RSON3gkNvk/SmYg (button) folded before Flop (didn't bet)
Seat 4: OMkHNxIUZxh1pHqcCjbjgw (small blind) folded before Flop
Seat 5: hpxXcmRkXXI9HE5+5/j/0Q (big blind) folded before Flop
Seat 6: QHvTZcrKe6+maWUfVjP29Q collected ($2.50)



PokerStars Game #59941269862:  Hold'em No Limit ($0.50/$1.00) - 2009/07/01 1:30:32 ET
Table 'NqGO/cV3MwFAx+ZPB5ANmQ' 2-max Seat #2 is the button
Seat 1: ItaRAnHOgvYOv5ynbG1iTw ($124 in chips)
Seat 2: GtFB+yyeb2djMdPFuOW/Xg ($166 in chips)
GtFB+yyeb2djMdPFuOW/Xg: posts small blind $0.50
ItaRAnHOgvYOv5ynbG1iTw: posts big blind $1
*** HOLE CARDS ***
GtFB+yyeb2djMdPFuOW/Xg: folds
ItaRAnHOgvYOv5ynbG1iTw collected $1 from pot
*** SUMMARY ***
Total pot $1 | Rake $0
Seat 1: ItaRAnHOgvYOv5ynbG1iTw (big blind) collected ($1)
Seat 2: GtFB+yyeb2djMdPFuOW/Xg (button) (small blind) folded before Flop



PokerStars Game #59941269856:  Hold'em No Limit ($0.50/$1.00) - 2009/07/01 1:30:32 ET
Table 'N6LvHFrb+cdXY/COI6ByOw' 2-max Seat #2 is the button
Seat 1: lXX4W7m3u++JiSOZ46yVMQ ($104.30 in chips)
Seat 2: 9mAoSP3o/mikSZOW2LEEAw ($92.45 in chips)
9mAoSP3o/mikSZOW2LEEAw: posts small blind $0.50
lXX4W7m3u++JiSOZ46yVMQ: posts big blind $1
*** HOLE CARDS ***
9mAoSP3o/mikSZOW2LEEAw: raises $1 to $2
lXX4W7m3u++JiSOZ46yVMQ: folds
9mAoSP3o/mikSZOW2LEEAw collected $2 from pot
9mAoSP3o/mikSZOW2LEEAw: doesn't show hand
*** SUMMARY ***
Total pot $2 | Rake $0
Seat 1: lXX4W7m3u++JiSOZ46yVMQ (big blind) folded before Flop
Seat 2: 9mAoSP3o/mikSZOW2LEEAw (button) (small blind) collected ($2)



PokerStars Game #59941270558:  Hold'em No Limit ($0.50/$1.00) - 2009/07/01 1:30:33 ET
Table 'MNvFfRVQNka/oY+Z5aMbZQ' 2-max Seat #2 is the button
Seat 1: DaZnoWHjO897dnh0CL2lVg ($67.80 in chips)
Seat 2: mgi+mjKb1Sc3CCs7TlfoCw ($91.45 in chips)
mgi+mjKb1Sc3CCs7TlfoCw: posts small blind $0.50
DaZnoWHjO897dnh0CL2lVg: posts big blind $1
*** HOLE CARDS ***
mgi+mjKb1Sc3CCs7TlfoCw: raises $1 to $2
DaZnoWHjO897dnh0CL2lVg: calls $1
*** FLOP *** [Kd Qd 6h]
DaZnoWHjO897dnh0CL2lVg: checks
mgi+mjKb1Sc3CCs7TlfoCw: checks
*** TURN *** [Kd Qd 6h] [8h]
DaZnoWHjO897dnh0CL2lVg: checks
mgi+mjKb1Sc3CCs7TlfoCw: bets $1
DaZnoWHjO897dnh0CL2lVg: calls $1
*** RIVER *** [Kd Qd 6h 8h] [Td]
DaZnoWHjO897dnh0CL2lVg: checks
mgi+mjKb1Sc3CCs7TlfoCw: checks
*** SHOW DOWN ***
DaZnoWHjO897dnh0CL2lVg: shows [8d 9c] (a pair of Eights)
mgi+mjKb1Sc3CCs7TlfoCw: mucks hand
DaZnoWHjO897dnh0CL2lVg collected $5.75 from pot
*** SUMMARY ***
Total pot $6 | Rake $0.25
Board [Kd Qd 6h 8h Td]
Seat 1: DaZnoWHjO897dnh0CL2lVg (big blind) showed [8d 9c] and won ($5.75) with a pair of Eights
Seat 2: mgi+mjKb1Sc3CCs7TlfoCw (button) (small blind) mucked



PokerStars Game #59941269902:  Hold'em No Limit ($0.50/$1.00) - 2009/07/01 1:30:33 ET
Table 'fTlPiCj0utgzC/5io+I7ew' 6-max Seat #2 is the button
Seat 1: YMJG+F++3Aj6P8dAWda5fw ($104.60 in chips)
Seat 2: qVr1nl3dy2xXPqS8UpTDlA ($18.80 in chips)
Seat 3: Z2fXsGcjl+Eax+RzOgwOmg ($141 in chips)
Seat 4: uJVSceLggtsrJya+WtmUEA ($164.65 in chips)
Seat 5: XUk5GQsfNFpHvaToDZ0rZA ($44.15 in chips)
Seat 6: y27w5IK2WXqmYzS8OU0wKA ($100 in chips)
Z2fXsGcjl+Eax+RzOgwOmg: posts small blind $0.50
uJVSceLggtsrJya+WtmUEA: posts big blind $1
*** HOLE CARDS ***
XUk5GQsfNFpHvaToDZ0rZA: calls $1
y27w5IK2WXqmYzS8OU0wKA: folds
YMJG+F++3Aj6P8dAWda5fw: folds
qVr1nl3dy2xXPqS8UpTDlA: folds
Z2fXsGcjl+Eax+RzOgwOmg: folds
uJVSceLggtsrJya+WtmUEA has timed out
uJVSceLggtsrJya+WtmUEA: checks
*** FLOP *** [2d Ts Kh]
uJVSceLggtsrJya+WtmUEA: checks
XUk5GQsfNFpHvaToDZ0rZA: checks
*** TURN *** [2d Ts Kh] [Tc]
uJVSceLggtsrJya+WtmUEA: checks
XUk5GQsfNFpHvaToDZ0rZA: bets $1
uJVSceLggtsrJya+WtmUEA: folds
XUk5GQsfNFpHvaToDZ0rZA collected $2.40 from pot
*** SUMMARY ***
Total pot $2.50 | Rake $0.10
Board [2d Ts Kh Tc]
Seat 1: YMJG+F++3Aj6P8dAWda5fw folded before Flop (didn't bet)
Seat 2: qVr1nl3dy2xXPqS8UpTDlA (button) folded before Flop (didn't bet)
Seat 3: Z2fXsGcjl+Eax+RzOgwOmg (small blind) folded before Flop
Seat 4: uJVSceLggtsrJya+WtmUEA (big blind) folded on the Turn
Seat 5: XUk5GQsfNFpHvaToDZ0rZA collected ($2.40)
Seat 6: y27w5IK2WXqmYzS8OU0wKA folded before Flop (didn't bet)



PokerStars Game #59941271066:  Hold'em No Limit ($0.50/$1.00) - 2009/07/01 1:30:34 ET
Table '3T4owEKJKyGTMePwrv50FQ' 9-max Seat #6 is the button
Seat 1: OGgaARGdJQT4awWVNQ957w ($101.50 in chips)
Seat 2: t+Id2O6herCLgwnC4m49PA ($36.30 in chips)
Seat 3: DOLzOcBTZYcph5jEfKFWuQ ($100 in chips)
Seat 4: O5Go3jrzbQWxRB6ESK+Ptg ($80.60 in chips)
Seat 5: mMc/PBpqlN24gdi3C/1tOw ($46.90 in chips)
Seat 6: V138SURkdX8LdVBPKdJJag ($108.25 in chips)
Seat 7: 1862487932 ($118.15 in chips)
Seat 8: bLbSOSmSOnqE0iTcH/5dxA ($100 in chips)
1862487932: posts small blind $0.50
bLbSOSmSOnqE0iTcH/5dxA: posts big blind $1
61sfw5QTu62YYIt68OsdrA: sits out
*** HOLE CARDS ***
OGgaARGdJQT4awWVNQ957w: folds
t+Id2O6herCLgwnC4m49PA: calls $1
DOLzOcBTZYcph5jEfKFWuQ: folds
O5Go3jrzbQWxRB6ESK+Ptg: folds
mMc/PBpqlN24gdi3C/1tOw: calls $1
V138SURkdX8LdVBPKdJJag: folds
1862487932: raises $5.50 to $6.50
bLbSOSmSOnqE0iTcH/5dxA: calls $5.50
t+Id2O6herCLgwnC4m49PA: folds
mMc/PBpqlN24gdi3C/1tOw: folds
*** FLOP *** [4s 4h Qc]
1862487932: bets $11
bLbSOSmSOnqE0iTcH/5dxA: calls $11
*** TURN *** [4s 4h Qc] [4d]
1862487932: bets $22
bLbSOSmSOnqE0iTcH/5dxA: calls $22
*** RIVER *** [4s 4h Qc 4d] [Td]
1862487932: bets $61
bLbSOSmSOnqE0iTcH/5dxA: calls $60.50 and is all-in
*** SHOW DOWN ***
1862487932: shows [Qs Kc] (a full house, Fours full of Queens)
bLbSOSmSOnqE0iTcH/5dxA: shows [Ad As] (a full house, Fours full of Aces)
bLbSOSmSOnqE0iTcH/5dxA collected $199 from pot
*** SUMMARY ***
Total pot $202 | Rake $3
Board [4s 4h Qc 4d Td]
Seat 1: OGgaARGdJQT4awWVNQ957w folded before Flop (didn't bet)
Seat 2: t+Id2O6herCLgwnC4m49PA folded before Flop
Seat 3: DOLzOcBTZYcph5jEfKFWuQ folded before Flop (didn't bet)
Seat 4: O5Go3jrzbQWxRB6ESK+Ptg folded before Flop (didn't bet)
Seat 5: mMc/PBpqlN24gdi3C/1tOw folded before Flop
Seat 6: V138SURkdX8LdVBPKdJJag (button) folded before Flop (didn't bet)
Seat 7: 1862487932 (small blind) showed [Qs Kc] and lost with a full house, Fours full of Queens
Seat 8: bLbSOSmSOnqE0iTcH/5dxA (big blind) showed [Ad As] and won ($199) with a full house, Fours full of Aces



PokerStars Game #59941272474:  Hold'em No Limit ($0.50/$1.00) - 2009/07/01 1:30:37 ET
Table '+cA8mcmhaedZ7YcrDdhmeQ' 6-max Seat #3 is the button
Seat 1: 9XrTM0DuVxx1pjFAdSbD8A ($53.20 in chips)
Seat 2: 14aYclSc98EYd6TrzN2l3Q ($24.05 in chips)
Seat 3: DAIgyIWbYvAkL6PbAI27pg ($16.55 in chips)
Seat 4: 4OO5v3AVduL0tePNx8wk5A ($100 in chips)
Seat 5: RqgF7gRoKgRNW8Zoi1ty4A ($163.80 in chips)
Seat 6: YfsTQsY/fxb+YqbdclTHuw ($44.85 in chips)
4OO5v3AVduL0tePNx8wk5A: posts small blind $0.50
RqgF7gRoKgRNW8Zoi1ty4A: posts big blind $1
*** HOLE CARDS ***
YfsTQsY/fxb+YqbdclTHuw: folds
9XrTM0DuVxx1pjFAdSbD8A: raises $1 to $2
14aYclSc98EYd6TrzN2l3Q: folds
14aYclSc98EYd6TrzN2l3Q said, "house only playes 10's to bulets"
DAIgyIWbYvAkL6PbAI27pg: folds
14aYclSc98EYd6TrzN2l3Q said, "bullets"
4OO5v3AVduL0tePNx8wk5A: folds
RqgF7gRoKgRNW8Zoi1ty4A: folds
9XrTM0DuVxx1pjFAdSbD8A collected $2.50 from pot
*** SUMMARY ***
Total pot $2.50 | Rake $0
Seat 1: 9XrTM0DuVxx1pjFAdSbD8A collected ($2.50)
Seat 2: 14aYclSc98EYd6TrzN2l3Q folded before Flop (didn't bet)
Seat 3: DAIgyIWbYvAkL6PbAI27pg (button) folded before Flop (didn't bet)
Seat 4: 4OO5v3AVduL0tePNx8wk5A (small blind) folded before Flop
Seat 5: RqgF7gRoKgRNW8Zoi1ty4A (big blind) folded before Flop
Seat 6: YfsTQsY/fxb+YqbdclTHuw folded before Flop (didn't bet)



PokerStars Game #59941273460:  Hold'em No Limit ($0.50/$1.00) - 2009/07/01 1:30:38 ET
Table 'NqGO/cV3MwFAx+ZPB5ANmQ' 2-max Seat #1 is the button
Seat 1: ItaRAnHOgvYOv5ynbG1iTw ($124.50 in chips)
Seat 2: GtFB+yyeb2djMdPFuOW/Xg ($165.50 in chips)
ItaRAnHOgvYOv5ynbG1iTw: posts small blind $0.50
GtFB+yyeb2djMdPFuOW/Xg: posts big blind $1
*** HOLE CARDS ***
ItaRAnHOgvYOv5ynbG1iTw: raises $2 to $3
GtFB+yyeb2djMdPFuOW/Xg: folds
ItaRAnHOgvYOv5ynbG1iTw collected $2 from pot
*** SUMMARY ***
Total pot $2 | Rake $0
Seat 1: ItaRAnHOgvYOv5ynbG1iTw (button) (small blind) collected ($2)
Seat 2: GtFB+yyeb2djMdPFuOW/Xg (big blind) folded before Flop



PokerStars Game #59941274160:  Hold'em No Limit ($0.50/$1.00) - 2009/07/01 1:30:40 ET
Table 'N6LvHFrb+cdXY/COI6ByOw' 2-max Seat #1 is the button
Seat 1: lXX4W7m3u++JiSOZ46yVMQ ($103.30 in chips)
Seat 2: 9mAoSP3o/mikSZOW2LEEAw ($93.45 in chips)
lXX4W7m3u++JiSOZ46yVMQ: posts small blind $0.50
9mAoSP3o/mikSZOW2LEEAw: posts big blind $1
*** HOLE CARDS ***
lXX4W7m3u++JiSOZ46yVMQ: folds
9mAoSP3o/mikSZOW2LEEAw collected $1 from pot
9mAoSP3o/mikSZOW2LEEAw: doesn't show hand
*** SUMMARY ***
Total pot $1 | Rake $0
Seat 1: lXX4W7m3u++JiSOZ46yVMQ (button) (small blind) folded before Flop
Seat 2: 9mAoSP3o/mikSZOW2LEEAw (big blind) collected ($1)



PokerStars Game #59941274350:  Hold'em No Limit ($0.50/$1.00) - 2009/07/01 1:30:40 ET
Table '/RZcOwpZpHQ+OwPwjsbnRw' 6-max Seat #5 is the button
Seat 1: +uSzP8Jwnw7sKfQ4s66b7w ($41.75 in chips)
Seat 2: Z2fXsGcjl+Eax+RzOgwOmg ($102.65 in chips)
Seat 3: LJMw/I77xpnw0R5T4HnMUg ($100 in chips)
Seat 4: j7NIOHLZk7V2o9fOioO5ug ($100 in chips)
Seat 5: wx3sQGkVi2x9wJXuWNHPBw ($167.25 in chips)
Seat 6: o3YLm/rSY916m/on1VjXPA ($207.20 in chips)
o3YLm/rSY916m/on1VjXPA: posts small blind $0.50
+uSzP8Jwnw7sKfQ4s66b7w: posts big blind $1
LJMw/I77xpnw0R5T4HnMUg: posts big blind $1
*** HOLE CARDS ***
Z2fXsGcjl+Eax+RzOgwOmg: folds
LJMw/I77xpnw0R5T4HnMUg: checks
j7NIOHLZk7V2o9fOioO5ug: folds
wx3sQGkVi2x9wJXuWNHPBw: folds
o3YLm/rSY916m/on1VjXPA: folds
+uSzP8Jwnw7sKfQ4s66b7w: checks
*** FLOP *** [4h Ks 3c]
+uSzP8Jwnw7sKfQ4s66b7w: checks
LJMw/I77xpnw0R5T4HnMUg: checks
*** TURN *** [4h Ks 3c] [8d]
+uSzP8Jwnw7sKfQ4s66b7w: checks
LJMw/I77xpnw0R5T4HnMUg: bets $1
+uSzP8Jwnw7sKfQ4s66b7w: calls $1
*** RIVER *** [4h Ks 3c 8d] [Qd]
+uSzP8Jwnw7sKfQ4s66b7w: checks
LJMw/I77xpnw0R5T4HnMUg: bets $2
+uSzP8Jwnw7sKfQ4s66b7w: folds
LJMw/I77xpnw0R5T4HnMUg collected $4.30 from pot
LJMw/I77xpnw0R5T4HnMUg: doesn't show hand
*** SUMMARY ***
Total pot $4.50 | Rake $0.20
Board [4h Ks 3c 8d Qd]
Seat 1: +uSzP8Jwnw7sKfQ4s66b7w (big blind) folded on the River
Seat 2: Z2fXsGcjl+Eax+RzOgwOmg folded before Flop (didn't bet)
Seat 3: LJMw/I77xpnw0R5T4HnMUg collected ($4.30)
Seat 4: j7NIOHLZk7V2o9fOioO5ug folded before Flop (didn't bet)
Seat 5: wx3sQGkVi2x9wJXuWNHPBw (button) folded before Flop (didn't bet)
Seat 6: o3YLm/rSY916m/on1VjXPA (small blind) folded before Flop



PokerStars Game #59941275084:  Hold'em No Limit ($0.50/$1.00) - 2009/07/01 1:30:41 ET
Table 'QSIig7BLMc9wY/rgBechzw' 6-max Seat #2 is the button
Seat 1: Z2fXsGcjl+Eax+RzOgwOmg ($108 in chips)
Seat 2: mLOIkH/qmRa+mVujQIhBRg ($43.40 in chips)
Seat 3: +xW7QemQU0Fxs+4TnqBRow ($109 in chips)
Seat 4: +uSzP8Jwnw7sKfQ4s66b7w ($63.95 in chips)
Seat 5: lsLuWlcPA3Rh7kJVLzMh0Q ($103.20 in chips)
Seat 6: PxqfkAMdAWtkgbT+q2gciA ($64.10 in chips)
+xW7QemQU0Fxs+4TnqBRow: posts small blind $0.50
+uSzP8Jwnw7sKfQ4s66b7w: posts big blind $1
*** HOLE CARDS ***
lsLuWlcPA3Rh7kJVLzMh0Q: folds
PxqfkAMdAWtkgbT+q2gciA: calls $1
Z2fXsGcjl+Eax+RzOgwOmg: raises $4 to $5
mLOIkH/qmRa+mVujQIhBRg: folds
+xW7QemQU0Fxs+4TnqBRow: folds
+uSzP8Jwnw7sKfQ4s66b7w: folds
PxqfkAMdAWtkgbT+q2gciA: calls $4
*** FLOP *** [7c 8h 8d]
PxqfkAMdAWtkgbT+q2gciA: bets $4
Z2fXsGcjl+Eax+RzOgwOmg: raises $15 to $19
PxqfkAMdAWtkgbT+q2gciA: folds
Z2fXsGcjl+Eax+RzOgwOmg collected $18.60 from pot
Z2fXsGcjl+Eax+RzOgwOmg: doesn't show hand
*** SUMMARY ***
Total pot $19.50 | Rake $0.90
Board [7c 8h 8d]
Seat 1: Z2fXsGcjl+Eax+RzOgwOmg collected ($18.60)
Seat 2: mLOIkH/qmRa+mVujQIhBRg (button) folded before Flop (didn't bet)
Seat 3: +xW7QemQU0Fxs+4TnqBRow (small blind) folded before Flop
Seat 4: +uSzP8Jwnw7sKfQ4s66b7w (big blind) folded before Flop
Seat 5: lsLuWlcPA3Rh7kJVLzMh0Q folded before Flop (didn't bet)
Seat 6: PxqfkAMdAWtkgbT+q2gciA folded on the Flop



PokerStars Game #59941275236:  Hold'em No Limit ($0.50/$1.00) - 2009/07/01 1:30:42 ET
Table 'N2bNCDHL96aCQDvZIh+yQQ' 6-max Seat #5 is the button
Seat 1: Jjgflx10PVjcLkziEmLhSA ($40.10 in chips)
Seat 2: y27w5IK2WXqmYzS8OU0wKA ($118.55 in chips)
Seat 3: UBZQqpnJZdTYYY1FTb0rLA ($122.05 in chips)
Seat 4: uCqEjnxh2/vFBjKYkfTOkw ($226.60 in chips)
Seat 5: frvgHLr3+LfZtjsBCBs3NA ($21.30 in chips)
Seat 6: idVgoPAdspFPCzee6aF9Pg ($100 in chips)
idVgoPAdspFPCzee6aF9Pg: posts small blind $0.50
Jjgflx10PVjcLkziEmLhSA: posts big blind $1
*** HOLE CARDS ***
y27w5IK2WXqmYzS8OU0wKA: folds
UBZQqpnJZdTYYY1FTb0rLA: folds
uCqEjnxh2/vFBjKYkfTOkw: folds
frvgHLr3+LfZtjsBCBs3NA: folds
frvgHLr3+LfZtjsBCBs3NA said, "dumb ****"
idVgoPAdspFPCzee6aF9Pg: folds
Jjgflx10PVjcLkziEmLhSA collected $1 from pot
Jjgflx10PVjcLkziEmLhSA: doesn't show hand
*** SUMMARY ***
Total pot $1 | Rake $0
Seat 1: Jjgflx10PVjcLkziEmLhSA (big blind) collected ($1)
Seat 2: y27w5IK2WXqmYzS8OU0wKA folded before Flop (didn't bet)
Seat 3: UBZQqpnJZdTYYY1FTb0rLA folded before Flop (didn't bet)
Seat 4: uCqEjnxh2/vFBjKYkfTOkw folded before Flop (didn't bet)
Seat 5: frvgHLr3+LfZtjsBCBs3NA (button) folded before Flop (didn't bet)
Seat 6: idVgoPAdspFPCzee6aF9Pg (small blind) folded before Flop



PokerStars Game #59941276018:  Hold'em No Limit ($0.50/$1.00) - 2009/07/01 1:30:43 ET
Table 'b8oW/dOL7fDza5DfZ/dOJQ' 6-max Seat #5 is the button
Seat 1: NakujTNjHFgzceydFf+E2Q ($100 in chips)
Seat 2: TSuRyAHnUPCFjP7Z0rEE0w ($121.50 in chips)
Seat 4: X87W8qaGsudJTSkClK2Cig ($20.35 in chips)
Seat 5: r4lpoh2BJZ8S6zyQv1JeSw ($102.50 in chips)
Seat 6: PvfYaKbzMpsmUcbOExckbQ ($100 in chips)
PvfYaKbzMpsmUcbOExckbQ: posts small blind $0.50
NakujTNjHFgzceydFf+E2Q: posts big blind $1
d8WX+9nUHoqlrAGagO0Wow: sits out
*** HOLE CARDS ***
TSuRyAHnUPCFjP7Z0rEE0w: folds
X87W8qaGsudJTSkClK2Cig: raises $2 to $3
r4lpoh2BJZ8S6zyQv1JeSw: folds
PvfYaKbzMpsmUcbOExckbQ: folds
NakujTNjHFgzceydFf+E2Q: folds
X87W8qaGsudJTSkClK2Cig collected $2.50 from pot
*** SUMMARY ***
Total pot $2.50 | Rake $0
Seat 1: NakujTNjHFgzceydFf+E2Q (big blind) folded before Flop
Seat 2: TSuRyAHnUPCFjP7Z0rEE0w folded before Flop (didn't bet)
Seat 4: X87W8qaGsudJTSkClK2Cig collected ($2.50)
Seat 5: r4lpoh2BJZ8S6zyQv1JeSw (button) folded before Flop (didn't bet)
Seat 6: PvfYaKbzMpsmUcbOExckbQ (small blind) folded before Flop



PokerStars Game #59941276926:  Hold'em No Limit ($0.50/$1.00) - 2009/07/01 1:30:45 ET
Table 'jDQgUn1zGkyftPnHo0Awdw' 2-max Seat #2 is the button
Seat 1: a42+e5QB6s1kkG5FoSTZJw ($100.65 in chips)
Seat 2: q+vRKwm51mnr6kxX/161WQ ($93 in chips)
q+vRKwm51mnr6kxX/161WQ: posts small blind $0.50
a42+e5QB6s1kkG5FoSTZJw: posts big blind $1
*** HOLE CARDS ***
q+vRKwm51mnr6kxX/161WQ: raises $2 to $3
a42+e5QB6s1kkG5FoSTZJw: folds
q+vRKwm51mnr6kxX/161WQ collected $2 from pot
q+vRKwm51mnr6kxX/161WQ: doesn't show hand
*** SUMMARY ***
Total pot $2 | Rake $0
Seat 1: a42+e5QB6s1kkG5FoSTZJw (big blind) folded before Flop
Seat 2: q+vRKwm51mnr6kxX/161WQ (button) (small blind) collected ($2)



PokerStars Game #59941277864:  Hold'em No Limit ($0.50/$1.00) - 2009/07/01 1:30:46 ET
Table 'N6LvHFrb+cdXY/COI6ByOw' 2-max Seat #2 is the button
Seat 1: lXX4W7m3u++JiSOZ46yVMQ ($102.80 in chips)
Seat 2: 9mAoSP3o/mikSZOW2LEEAw ($93.95 in chips)
9mAoSP3o/mikSZOW2LEEAw: posts small blind $0.50
lXX4W7m3u++JiSOZ46yVMQ: posts big blind $1
*** HOLE CARDS ***
9mAoSP3o/mikSZOW2LEEAw: raises $1 to $2
lXX4W7m3u++JiSOZ46yVMQ: folds
9mAoSP3o/mikSZOW2LEEAw collected $2 from pot
*** SUMMARY ***
Total pot $2 | Rake $0
Seat 1: lXX4W7m3u++JiSOZ46yVMQ (big blind) folded before Flop
Seat 2: 9mAoSP3o/mikSZOW2LEEAw (button) (small blind) collected ($2)



PokerStars Game #59941279110:  Hold'em No Limit ($0.50/$1.00) - 2009/07/01 1:30:48 ET
Table 'gxFK0BVUD7cupu2uyRUZJg' 6-max Seat #5 is the button
Seat 1: M+X3uChmP6R63IwijVjgTg ($160.25 in chips)
Seat 2: hpxXcmRkXXI9HE5+5/j/0Q ($134.55 in chips)
Seat 3: Z2fXsGcjl+Eax+RzOgwOmg ($119.50 in chips)
Seat 4: JwCcjZl0bjJzG7hmE0dnTA ($105.50 in chips)
Seat 5: WgIrs6CBinyyw18pqdDtWA ($20.60 in chips)
Seat 6: dYyb6/42PMC8aNFlm/eBeQ ($103.40 in chips)
dYyb6/42PMC8aNFlm/eBeQ: posts small blind $0.50
M+X3uChmP6R63IwijVjgTg: posts big blind $1
*** HOLE CARDS ***
hpxXcmRkXXI9HE5+5/j/0Q: folds
Z2fXsGcjl+Eax+RzOgwOmg: folds
JwCcjZl0bjJzG7hmE0dnTA: folds
WgIrs6CBinyyw18pqdDtWA: folds
dYyb6/42PMC8aNFlm/eBeQ: calls $0.50
JwCcjZl0bjJzG7hmE0dnTA leaves the table
M+X3uChmP6R63IwijVjgTg: checks
*** FLOP *** [3s 2d Kc]
dYyb6/42PMC8aNFlm/eBeQ: checks
M+X3uChmP6R63IwijVjgTg: bets $2
dYyb6/42PMC8aNFlm/eBeQ: folds
M+X3uChmP6R63IwijVjgTg collected $1.90 from pot
*** SUMMARY ***
Total pot $2 | Rake $0.10
Board [3s 2d Kc]
Seat 1: M+X3uChmP6R63IwijVjgTg (big blind) collected ($1.90)
Seat 2: hpxXcmRkXXI9HE5+5/j/0Q folded before Flop (didn't bet)
Seat 3: Z2fXsGcjl+Eax+RzOgwOmg folded before Flop (didn't bet)
Seat 4: JwCcjZl0bjJzG7hmE0dnTA folded before Flop (didn't bet)
Seat 5: WgIrs6CBinyyw18pqdDtWA (button) folded before Flop (didn't bet)
Seat 6: dYyb6/42PMC8aNFlm/eBeQ (small blind) folded on the Flop



PokerStars Game #59941279042:  Hold'em No Limit ($0.50/$1.00) - 2009/07/01 1:30:48 ET
Table 'cBDNutyLBKEk9+ptwsKmTw' 6-max Seat #4 is the button
Seat 1: xAU6q2/cwmby2sxmA8VcmA ($299.05 in chips)
Seat 2: 4OO5v3AVduL0tePNx8wk5A ($105.05 in chips)
Seat 3: G5ZSSN6RSON3gkNvk/SmYg ($107.40 in chips)
Seat 4: OMkHNxIUZxh1pHqcCjbjgw ($91 in chips)
Seat 5: hpxXcmRkXXI9HE5+5/j/0Q ($105.20 in chips)
Seat 6: QHvTZcrKe6+maWUfVjP29Q ($153 in chips)
hpxXcmRkXXI9HE5+5/j/0Q: posts small blind $0.50
QHvTZcrKe6+maWUfVjP29Q: posts big blind $1
*** HOLE CARDS ***
xAU6q2/cwmby2sxmA8VcmA: folds
4OO5v3AVduL0tePNx8wk5A: folds
G5ZSSN6RSON3gkNvk/SmYg: folds
OMkHNxIUZxh1pHqcCjbjgw: folds
hpxXcmRkXXI9HE5+5/j/0Q: raises $3 to $4
QHvTZcrKe6+maWUfVjP29Q: folds
hpxXcmRkXXI9HE5+5/j/0Q collected $2 from pot
hpxXcmRkXXI9HE5+5/j/0Q: doesn't show hand
*** SUMMARY ***
Total pot $2 | Rake $0
Seat 1: xAU6q2/cwmby2sxmA8VcmA folded before Flop (didn't bet)
Seat 2: 4OO5v3AVduL0tePNx8wk5A folded before Flop (didn't bet)
Seat 3: G5ZSSN6RSON3gkNvk/SmYg folded before Flop (didn't bet)
Seat 4: OMkHNxIUZxh1pHqcCjbjgw (button) folded before Flop (didn't bet)
Seat 5: hpxXcmRkXXI9HE5+5/j/0Q (small blind) collected ($2)
Seat 6: QHvTZcrKe6+maWUfVjP29Q (big blind) folded before Flop



PokerStars Game #59941279160:  Hold'em No Limit ($0.50/$1.00) - 2009/07/01 1:30:49 ET
Table 'fZjVbKj9D8yOB+Rj7NaP/A' 9-max Seat #7 is the button
Seat 1: 9BZCcac3+McErkkSN2YScA ($102.25 in chips)
Seat 2: PTAFYDIUSsG+SArbxNl+Aw ($105.50 in chips)
Seat 3: yAbu2QsRPVcjPbqlf/jDxw ($100 in chips)
Seat 4: 997ViqAtWn1FPjJqcffwcA ($100 in chips)
Seat 5: PkGfq5xrSlNsujKaG/HF4Q ($100 in chips)
Seat 6: OvwYHV65yUbgdBjSmo1+5g ($131.40 in chips)
Seat 7: SyS20PAm3RpT6uLBsGkwOA ($70.10 in chips)
Seat 9: qheQay5YvP2DMAb3OUSxtw ($101 in chips)
qheQay5YvP2DMAb3OUSxtw: posts small blind $0.50
9BZCcac3+McErkkSN2YScA: posts big blind $1
*** HOLE CARDS ***
PTAFYDIUSsG+SArbxNl+Aw: folds
yAbu2QsRPVcjPbqlf/jDxw: folds
997ViqAtWn1FPjJqcffwcA: folds
PkGfq5xrSlNsujKaG/HF4Q: folds
OvwYHV65yUbgdBjSmo1+5g: calls $1
SyS20PAm3RpT6uLBsGkwOA: folds
qheQay5YvP2DMAb3OUSxtw: folds
9BZCcac3+McErkkSN2YScA: checks
*** FLOP *** [9d 3s 6c]
9BZCcac3+McErkkSN2YScA: bets $2
OvwYHV65yUbgdBjSmo1+5g: folds
9BZCcac3+McErkkSN2YScA collected $2.40 from pot
9BZCcac3+McErkkSN2YScA: doesn't show hand
*** SUMMARY ***
Total pot $2.50 | Rake $0.10
Board [9d 3s 6c]
Seat 1: 9BZCcac3+McErkkSN2YScA (big blind) collected ($2.40)
Seat 2: PTAFYDIUSsG+SArbxNl+Aw folded before Flop (didn't bet)
Seat 3: yAbu2QsRPVcjPbqlf/jDxw folded before Flop (didn't bet)
Seat 4: 997ViqAtWn1FPjJqcffwcA folded before Flop (didn't bet)
Seat 5: PkGfq5xrSlNsujKaG/HF4Q folded before Flop (didn't bet)
Seat 6: OvwYHV65yUbgdBjSmo1+5g folded on the Flop
Seat 7: SyS20PAm3RpT6uLBsGkwOA (button) folded before Flop (didn't bet)
Seat 9: qheQay5YvP2DMAb3OUSxtw (small blind) folded before Flop



PokerStars Game #59941279730:  Hold'em No Limit ($0.50/$1.00) - 2009/07/01 1:30:50 ET
Table 'mmbQQVBTrPdE+wy+s+9VPA' 6-max Seat #1 is the button
Seat 1: zyP4SPoWZnKUfTvIRLCVog ($76.65 in chips)
Seat 2: XK4Qsl+DA8gAJyg85/zBIw ($32.10 in chips)
Seat 3: wx3sQGkVi2x9wJXuWNHPBw ($126.35 in chips)
Seat 4: V3iZdcw61nXF3g5hD2RrsQ ($100 in chips)
Seat 5: YMJG+F++3Aj6P8dAWda5fw ($123.90 in chips)
Seat 6: U2CWBTv29qdCbj8RNF2sIw ($119.20 in chips)
XK4Qsl+DA8gAJyg85/zBIw: posts small blind $0.50
wx3sQGkVi2x9wJXuWNHPBw: posts big blind $1
*** HOLE CARDS ***
V3iZdcw61nXF3g5hD2RrsQ: raises $2 to $3
YMJG+F++3Aj6P8dAWda5fw: calls $3
U2CWBTv29qdCbj8RNF2sIw: folds
zyP4SPoWZnKUfTvIRLCVog: folds
XK4Qsl+DA8gAJyg85/zBIw: folds
wx3sQGkVi2x9wJXuWNHPBw: folds
*** FLOP *** [4d 5d Jd]
V3iZdcw61nXF3g5hD2RrsQ: bets $5
YMJG+F++3Aj6P8dAWda5fw: folds
V3iZdcw61nXF3g5hD2RrsQ collected $7.15 from pot
*** SUMMARY ***
Total pot $7.50 | Rake $0.35
Board [4d 5d Jd]
Seat 1: zyP4SPoWZnKUfTvIRLCVog (button) folded before Flop (didn't bet)
Seat 2: XK4Qsl+DA8gAJyg85/zBIw (small blind) folded before Flop
Seat 3: wx3sQGkVi2x9wJXuWNHPBw (big blind) folded before Flop
Seat 4: V3iZdcw61nXF3g5hD2RrsQ collected ($7.15)
Seat 5: YMJG+F++3Aj6P8dAWda5fw folded on the Flop
Seat 6: U2CWBTv29qdCbj8RNF2sIw folded before Flop (didn't bet)



PokerStars Game #59941280510:  Hold'em No Limit ($0.50/$1.00) - 2009/07/01 1:30:51 ET
Table 'pHrhryH8jPNdQfY62f8v+g' 6-max Seat #3 is the button
Seat 1: 4d1rWhpu8DzLmzMbR3QKyA ($144.25 in chips)
Seat 2: JwCcjZl0bjJzG7hmE0dnTA ($120.55 in chips)
Seat 3: 8oS5O7iD/qnFXFXJrGIgNQ ($108.65 in chips)
Seat 4: 1f3beyIML24UqEMTbWy93g ($57.80 in chips)
Seat 5: d8WX+9nUHoqlrAGagO0Wow ($20 in chips)
Seat 6: xAU6q2/cwmby2sxmA8VcmA ($178.25 in chips)
1f3beyIML24UqEMTbWy93g: posts small blind $0.50
d8WX+9nUHoqlrAGagO0Wow: posts big blind $1
*** HOLE CARDS ***
xAU6q2/cwmby2sxmA8VcmA: folds
4d1rWhpu8DzLmzMbR3QKyA: folds
JwCcjZl0bjJzG7hmE0dnTA: raises $2 to $3
8oS5O7iD/qnFXFXJrGIgNQ: calls $3
1f3beyIML24UqEMTbWy93g: folds
d8WX+9nUHoqlrAGagO0Wow: folds
*** FLOP *** [6s 4c 2h]
JwCcjZl0bjJzG7hmE0dnTA: checks
8oS5O7iD/qnFXFXJrGIgNQ: bets $7
JwCcjZl0bjJzG7hmE0dnTA: folds
8oS5O7iD/qnFXFXJrGIgNQ collected $7.15 from pot
*** SUMMARY ***
Total pot $7.50 | Rake $0.35
Board [6s 4c 2h]
Seat 1: 4d1rWhpu8DzLmzMbR3QKyA folded before Flop (didn't bet)
Seat 2: JwCcjZl0bjJzG7hmE0dnTA folded on the Flop
Seat 3: 8oS5O7iD/qnFXFXJrGIgNQ (button) collected ($7.15)
Seat 4: 1f3beyIML24UqEMTbWy93g (small blind) folded before Flop
Seat 5: d8WX+9nUHoqlrAGagO0Wow (big blind) folded before Flop
Seat 6: xAU6q2/cwmby2sxmA8VcmA folded before Flop (didn't bet)



PokerStars Game #59941281398:  Hold'em No Limit ($0.50/$1.00) - 2009/07/01 1:30:53 ET
Table 'jDQgUn1zGkyftPnHo0Awdw' 2-max Seat #1 is the button
Seat 1: a42+e5QB6s1kkG5FoSTZJw ($99.65 in chips)
Seat 2: q+vRKwm51mnr6kxX/161WQ ($94 in chips)
a42+e5QB6s1kkG5FoSTZJw: posts small blind $0.50
q+vRKwm51mnr6kxX/161WQ: posts big blind $1
*** HOLE CARDS ***
a42+e5QB6s1kkG5FoSTZJw: raises $2 to $3
q+vRKwm51mnr6kxX/161WQ: calls $2
*** FLOP *** [Th Js 4s]
q+vRKwm51mnr6kxX/161WQ: checks
a42+e5QB6s1kkG5FoSTZJw: bets $4
q+vRKwm51mnr6kxX/161WQ: raises $8 to $12
a42+e5QB6s1kkG5FoSTZJw: folds
q+vRKwm51mnr6kxX/161WQ collected $13.50 from pot
q+vRKwm51mnr6kxX/161WQ: doesn't show hand
*** SUMMARY ***
Total pot $14 | Rake $0.50
Board [Th Js 4s]
Seat 1: a42+e5QB6s1kkG5FoSTZJw (button) (small blind) folded on the Flop
Seat 2: q+vRKwm51mnr6kxX/161WQ (big blind) collected ($13.50)



PokerStars Game #59941281488:  Hold'em No Limit ($0.50/$1.00) - 2009/07/01 1:30:53 ET
Table '/FUb199IViHMJHi5YWmeuQ' 9-max Seat #8 is the button
Seat 1: 3obndzTJ6fECz8+wWhMd1w ($18.50 in chips)
Seat 2: FL3MrLspcF23LYvC4ipBOA ($185.55 in chips)
Seat 3: V138SURkdX8LdVBPKdJJag ($121.75 in chips)
Seat 4: pbAfmxe4uSZPxJQX7gOzZA ($62.70 in chips)
Seat 5: H+DVy3Ei8L1UKS2tVOtJcw ($136.85 in chips)
Seat 6: VPF+HjszMvUIpy0CHIwH3A ($21.50 in chips)
Seat 7: myIxN7otsyr846M539YR8Q ($27 in chips)
Seat 8: 997ViqAtWn1FPjJqcffwcA ($101 in chips)
Seat 9: RfLbneGRY8yQUpMgDnJCxA ($75.70 in chips)
RfLbneGRY8yQUpMgDnJCxA: posts small blind $0.50
3obndzTJ6fECz8+wWhMd1w: posts big blind $1
*** HOLE CARDS ***
FL3MrLspcF23LYvC4ipBOA: folds
V138SURkdX8LdVBPKdJJag: raises $2.50 to $3.50
pbAfmxe4uSZPxJQX7gOzZA: calls $3.50
H+DVy3Ei8L1UKS2tVOtJcw: folds
VPF+HjszMvUIpy0CHIwH3A: folds
myIxN7otsyr846M539YR8Q: folds
997ViqAtWn1FPjJqcffwcA: folds
RfLbneGRY8yQUpMgDnJCxA: folds
3obndzTJ6fECz8+wWhMd1w: folds
*** FLOP *** [7d 5c 8d]
V138SURkdX8LdVBPKdJJag: checks
pbAfmxe4uSZPxJQX7gOzZA: bets $3
V138SURkdX8LdVBPKdJJag: folds
pbAfmxe4uSZPxJQX7gOzZA collected $8.10 from pot
*** SUMMARY ***
Total pot $8.50 | Rake $0.40
Board [7d 5c 8d]
Seat 1: 3obndzTJ6fECz8+wWhMd1w (big blind) folded before Flop
Seat 2: FL3MrLspcF23LYvC4ipBOA folded before Flop (didn't bet)
Seat 3: V138SURkdX8LdVBPKdJJag folded on the Flop
Seat 4: pbAfmxe4uSZPxJQX7gOzZA collected ($8.10)
Seat 5: H+DVy3Ei8L1UKS2tVOtJcw folded before Flop (didn't bet)
Seat 6: VPF+HjszMvUIpy0CHIwH3A folded before Flop (didn't bet)
Seat 7: myIxN7otsyr846M539YR8Q folded before Flop (didn't bet)
Seat 8: 997ViqAtWn1FPjJqcffwcA (button) folded before Flop (didn't bet)
Seat 9: RfLbneGRY8yQUpMgDnJCxA (small blind) folded before Flop



PokerStars Game #59941282640:  Hold'em No Limit ($0.50/$1.00) - 2009/07/01 1:30:55 ET
Table 'MNvFfRVQNka/oY+Z5aMbZQ' 2-max Seat #1 is the button
Seat 1: DaZnoWHjO897dnh0CL2lVg ($70.55 in chips)
Seat 2: mgi+mjKb1Sc3CCs7TlfoCw ($88.45 in chips)
DaZnoWHjO897dnh0CL2lVg: posts small blind $0.50
mgi+mjKb1Sc3CCs7TlfoCw: posts big blind $1
*** HOLE CARDS ***
DaZnoWHjO897dnh0CL2lVg: folds
mgi+mjKb1Sc3CCs7TlfoCw collected $1 from pot
*** SUMMARY ***
Total pot $1 | Rake $0
Seat 1: DaZnoWHjO897dnh0CL2lVg (button) (small blind) folded before Flop
Seat 2: mgi+mjKb1Sc3CCs7TlfoCw (big blind) collected ($1)



PokerStars Game #59941283522:  Hold'em No Limit ($0.50/$1.00) - 2009/07/01 1:30:56 ET
Table 'N6LvHFrb+cdXY/COI6ByOw' 2-max Seat #1 is the button
Seat 1: lXX4W7m3u++JiSOZ46yVMQ ($101.80 in chips)
Seat 2: 9mAoSP3o/mikSZOW2LEEAw ($94.95 in chips)
lXX4W7m3u++JiSOZ46yVMQ: posts small blind $0.50
9mAoSP3o/mikSZOW2LEEAw: posts big blind $1
*** HOLE CARDS ***
lXX4W7m3u++JiSOZ46yVMQ: folds
9mAoSP3o/mikSZOW2LEEAw collected $1 from pot
*** SUMMARY ***
Total pot $1 | Rake $0
Seat 1: lXX4W7m3u++JiSOZ46yVMQ (button) (small blind) folded before Flop
Seat 2: 9mAoSP3o/mikSZOW2LEEAw (big blind) collected ($1)



PokerStars Game #59941283398:  Hold'em No Limit ($0.50/$1.00) - 2009/07/01 1:30:56 ET
Table 'GPp0HyAuggN8oE0sUWzPpA' 9-max Seat #5 is the button
Seat 2: m3U8I35Pn3gxKhoS2nmYIg ($28.95 in chips)
Seat 3: CCCXsirC+bO7ginAuUUVlQ ($53.10 in chips)
Seat 4: mBRWbnUl8diyBO1qTJaNzw ($98.65 in chips)
Seat 5: bLbSOSmSOnqE0iTcH/5dxA ($100 in chips)
Seat 6: BK/GtNPkSx0TdUDj82id5A ($36.75 in chips)
Seat 7: aM6BB+PnB/rDUr2dbRda+A ($100 in chips)
Seat 8: P/6qLjycEfxRgZ5F/W90dw ($97.35 in chips)
Seat 9: myIxN7otsyr846M539YR8Q ($21.50 in chips)
BK/GtNPkSx0TdUDj82id5A: posts small blind $0.50
aM6BB+PnB/rDUr2dbRda+A: posts big blind $1
laA8va+Yv8WuMqT1zdR91g: sits out
*** HOLE CARDS ***
P/6qLjycEfxRgZ5F/W90dw: folds
myIxN7otsyr846M539YR8Q: folds
m3U8I35Pn3gxKhoS2nmYIg: folds
CCCXsirC+bO7ginAuUUVlQ: folds
mBRWbnUl8diyBO1qTJaNzw: folds
bLbSOSmSOnqE0iTcH/5dxA: folds
BK/GtNPkSx0TdUDj82id5A: folds
aM6BB+PnB/rDUr2dbRda+A collected $1 from pot
*** SUMMARY ***
Total pot $1 | Rake $0
Seat 2: m3U8I35Pn3gxKhoS2nmYIg folded before Flop (didn't bet)
Seat 3: CCCXsirC+bO7ginAuUUVlQ folded before Flop (didn't bet)
Seat 4: mBRWbnUl8diyBO1qTJaNzw folded before Flop (didn't bet)
Seat 5: bLbSOSmSOnqE0iTcH/5dxA (button) folded before Flop (didn't bet)
Seat 6: BK/GtNPkSx0TdUDj82id5A (small blind) folded before Flop
Seat 7: aM6BB+PnB/rDUr2dbRda+A (big blind) collected ($1)
Seat 8: P/6qLjycEfxRgZ5F/W90dw folded before Flop (didn't bet)
Seat 9: myIxN7otsyr846M539YR8Q folded before Flop (didn't bet)



PokerStars Game #59941283732:  Hold'em No Limit ($0.50/$1.00) - 2009/07/01 1:30:57 ET
Table '7O9fB8yx1u7sJveJn8w6jA' 6-max Seat #3 is the button
Seat 1: jy52+7FotjH63o5tEEVgKw ($66.60 in chips)
Seat 2: wx3sQGkVi2x9wJXuWNHPBw ($193.70 in chips)
Seat 3: hpxXcmRkXXI9HE5+5/j/0Q ($138.40 in chips)
Seat 4: b2a+5TkFf4xJN/Ihhma58Q ($35.85 in chips)
Seat 5: BCEV3COoKY607AzLWayfRA ($100 in chips)
b2a+5TkFf4xJN/Ihhma58Q: posts small blind $0.50
BCEV3COoKY607AzLWayfRA: posts big blind $1
r4lpoh2BJZ8S6zyQv1JeSw: sits out
*** HOLE CARDS ***
jy52+7FotjH63o5tEEVgKw: folds
wx3sQGkVi2x9wJXuWNHPBw: raises $3 to $4
hpxXcmRkXXI9HE5+5/j/0Q: folds
b2a+5TkFf4xJN/Ihhma58Q: folds
BCEV3COoKY607AzLWayfRA: folds
wx3sQGkVi2x9wJXuWNHPBw collected $2.50 from pot
*** SUMMARY ***
Total pot $2.50 | Rake $0
Seat 1: jy52+7FotjH63o5tEEVgKw folded before Flop (didn't bet)
Seat 2: wx3sQGkVi2x9wJXuWNHPBw collected ($2.50)
Seat 3: hpxXcmRkXXI9HE5+5/j/0Q (button) folded before Flop (didn't bet)
Seat 4: b2a+5TkFf4xJN/Ihhma58Q (small blind) folded before Flop
Seat 5: BCEV3COoKY607AzLWayfRA (big blind) folded before Flop



PokerStars Game #59941284772:  Hold'em No Limit ($0.50/$1.00) - 2009/07/01 1:30:59 ET
Table 'NqGO/cV3MwFAx+ZPB5ANmQ' 2-max Seat #2 is the button
Seat 1: ItaRAnHOgvYOv5ynbG1iTw ($125.50 in chips)
Seat 2: GtFB+yyeb2djMdPFuOW/Xg ($164.50 in chips)
GtFB+yyeb2djMdPFuOW/Xg: posts small blind $0.50
ItaRAnHOgvYOv5ynbG1iTw: posts big blind $1
*** HOLE CARDS ***
GtFB+yyeb2djMdPFuOW/Xg: folds
ItaRAnHOgvYOv5ynbG1iTw collected $1 from pot
*** SUMMARY ***
Total pot $1 | Rake $0
Seat 1: ItaRAnHOgvYOv5ynbG1iTw (big blind) collected ($1)
Seat 2: GtFB+yyeb2djMdPFuOW/Xg (button) (small blind) folded before Flop



PokerStars Game #59941285454:  Hold'em No Limit ($0.50/$1.00) - 2009/07/01 1:31:00 ET
Table 'N2bNCDHL96aCQDvZIh+yQQ' 6-max Seat #6 is the button
Seat 1: Jjgflx10PVjcLkziEmLhSA ($40.60 in chips)
Seat 2: y27w5IK2WXqmYzS8OU0wKA ($118.55 in chips)
Seat 3: UBZQqpnJZdTYYY1FTb0rLA ($122.05 in chips)
Seat 4: uCqEjnxh2/vFBjKYkfTOkw ($226.60 in chips)
Seat 5: frvgHLr3+LfZtjsBCBs3NA ($21.30 in chips)
Seat 6: idVgoPAdspFPCzee6aF9Pg ($100 in chips)
Jjgflx10PVjcLkziEmLhSA: posts small blind $0.50
y27w5IK2WXqmYzS8OU0wKA: posts big blind $1
*** HOLE CARDS ***
UBZQqpnJZdTYYY1FTb0rLA: folds
uCqEjnxh2/vFBjKYkfTOkw: raises $3 to $4
frvgHLr3+LfZtjsBCBs3NA: folds
idVgoPAdspFPCzee6aF9Pg: folds
Jjgflx10PVjcLkziEmLhSA: folds
y27w5IK2WXqmYzS8OU0wKA: folds
uCqEjnxh2/vFBjKYkfTOkw collected $2.50 from pot
uCqEjnxh2/vFBjKYkfTOkw: doesn't show hand
*** SUMMARY ***
Total pot $2.50 | Rake $0
Seat 1: Jjgflx10PVjcLkziEmLhSA (small blind) folded before Flop
Seat 2: y27w5IK2WXqmYzS8OU0wKA (big blind) folded before Flop
Seat 3: UBZQqpnJZdTYYY1FTb0rLA folded before Flop (didn't bet)
Seat 4: uCqEjnxh2/vFBjKYkfTOkw collected ($2.50)
Seat 5: frvgHLr3+LfZtjsBCBs3NA folded before Flop (didn't bet)
Seat 6: idVgoPAdspFPCzee6aF9Pg (button) folded before Flop (didn't bet)



PokerStars Game #59941286106:  Hold'em No Limit ($0.50/$1.00) - 2009/07/01 1:31:01 ET
Table 'W/wyObTiXZm+Ckkl3YxcSw' 6-max Seat #4 is the button
Seat 1: eUBBn2R56C1IQ6Cs/vitwg ($293.55 in chips)
Seat 2: oDiBRCaF0QVtd3kO6xZIXw ($162.90 in chips)
Seat 3: dxyNCn/qxfkGDUIf28Cbng ($61.30 in chips)
Seat 4: UBZQqpnJZdTYYY1FTb0rLA ($101.70 in chips)
Seat 5: +OrCjyw70oZhJiD22Mn+bg ($101.50 in chips)
Seat 6: b2a+5TkFf4xJN/Ihhma58Q ($36.30 in chips)
+OrCjyw70oZhJiD22Mn+bg: posts small blind $0.50
b2a+5TkFf4xJN/Ihhma58Q: posts big blind $1
*** HOLE CARDS ***
eUBBn2R56C1IQ6Cs/vitwg: raises $3 to $4
oDiBRCaF0QVtd3kO6xZIXw: folds
dxyNCn/qxfkGDUIf28Cbng: folds
UBZQqpnJZdTYYY1FTb0rLA: folds
+OrCjyw70oZhJiD22Mn+bg: folds
b2a+5TkFf4xJN/Ihhma58Q: folds
eUBBn2R56C1IQ6Cs/vitwg collected $2.50 from pot
*** SUMMARY ***
Total pot $2.50 | Rake $0
Seat 1: eUBBn2R56C1IQ6Cs/vitwg collected ($2.50)
Seat 2: oDiBRCaF0QVtd3kO6xZIXw folded before Flop (didn't bet)
Seat 3: dxyNCn/qxfkGDUIf28Cbng folded before Flop (didn't bet)
Seat 4: UBZQqpnJZdTYYY1FTb0rLA (button) folded before Flop (didn't bet)
Seat 5: +OrCjyw70oZhJiD22Mn+bg (small blind) folded before Flop
Seat 6: b2a+5TkFf4xJN/Ihhma58Q (big blind) folded before Flop



PokerStars Game #59941286310:  Hold'em No Limit ($0.50/$1.00) - 2009/07/01 1:31:01 ET
Table 'MNvFfRVQNka/oY+Z5aMbZQ' 2-max Seat #2 is the button
Seat 1: DaZnoWHjO897dnh0CL2lVg ($70.05 in chips)
Seat 2: mgi+mjKb1Sc3CCs7TlfoCw ($88.95 in chips)
mgi+mjKb1Sc3CCs7TlfoCw: posts small blind $0.50
DaZnoWHjO897dnh0CL2lVg: posts big blind $1
*** HOLE CARDS ***
mgi+mjKb1Sc3CCs7TlfoCw: folds
DaZnoWHjO897dnh0CL2lVg collected $1 from pot
*** SUMMARY ***
Total pot $1 | Rake $0
Seat 1: DaZnoWHjO897dnh0CL2lVg (big blind) collected ($1)
Seat 2: mgi+mjKb1Sc3CCs7TlfoCw (button) (small blind) folded before Flop



PokerStars Game #59941286910:  Hold'em No Limit ($0.50/$1.00) - 2009/07/01 1:31:02 ET
Table 'GxCPo/gd3OSthkYrAxJngg' 6-max Seat #2 is the button
Seat 1: sH8BpAFP+jGFxCgVpD1Lew ($227.25 in chips)
Seat 2: YExX2paeIHrmfIwV1ivM/w ($66.10 in chips)
Seat 3: idVgoPAdspFPCzee6aF9Pg ($130.50 in chips)
Seat 4: YMJG+F++3Aj6P8dAWda5fw ($209.85 in chips)
Seat 5: G5ZSSN6RSON3gkNvk/SmYg ($117.60 in chips)
Seat 6: 4d1rWhpu8DzLmzMbR3QKyA ($100 in chips)
idVgoPAdspFPCzee6aF9Pg: posts small blind $0.50
YMJG+F++3Aj6P8dAWda5fw: posts big blind $1
*** HOLE CARDS ***
G5ZSSN6RSON3gkNvk/SmYg: folds
4d1rWhpu8DzLmzMbR3QKyA: folds
sH8BpAFP+jGFxCgVpD1Lew: folds
YExX2paeIHrmfIwV1ivM/w: raises $2 to $3
idVgoPAdspFPCzee6aF9Pg: folds
YMJG+F++3Aj6P8dAWda5fw: folds
YExX2paeIHrmfIwV1ivM/w collected $2.50 from pot
YExX2paeIHrmfIwV1ivM/w: doesn't show hand
*** SUMMARY ***
Total pot $2.50 | Rake $0
Seat 1: sH8BpAFP+jGFxCgVpD1Lew folded before Flop (didn't bet)
Seat 2: YExX2paeIHrmfIwV1ivM/w (button) collected ($2.50)
Seat 3: idVgoPAdspFPCzee6aF9Pg (small blind) folded before Flop
Seat 4: YMJG+F++3Aj6P8dAWda5fw (big blind) folded before Flop
Seat 5: G5ZSSN6RSON3gkNvk/SmYg folded before Flop (didn't bet)
Seat 6: 4d1rWhpu8DzLmzMbR3QKyA folded before Flop (didn't bet)



PokerStars Game #59941287156:  Hold'em No Limit ($0.50/$1.00) - 2009/07/01 1:31:03 ET
Table 'b8oW/dOL7fDza5DfZ/dOJQ' 6-max Seat #6 is the button
Seat 1: NakujTNjHFgzceydFf+E2Q ($99 in chips)
Seat 2: TSuRyAHnUPCFjP7Z0rEE0w ($121.50 in chips)
Seat 3: d8WX+9nUHoqlrAGagO0Wow ($20 in chips)
Seat 4: X87W8qaGsudJTSkClK2Cig ($21.85 in chips)
Seat 5: r4lpoh2BJZ8S6zyQv1JeSw ($102.50 in chips)
Seat 6: PvfYaKbzMpsmUcbOExckbQ ($100 in chips)
NakujTNjHFgzceydFf+E2Q: posts small blind $0.50
TSuRyAHnUPCFjP7Z0rEE0w: posts big blind $1
d8WX+9nUHoqlrAGagO0Wow: posts big blind $1
*** HOLE CARDS ***
d8WX+9nUHoqlrAGagO0Wow: checks
X87W8qaGsudJTSkClK2Cig: folds
r4lpoh2BJZ8S6zyQv1JeSw: folds
PvfYaKbzMpsmUcbOExckbQ: folds
NakujTNjHFgzceydFf+E2Q: raises $3 to $4
TSuRyAHnUPCFjP7Z0rEE0w: folds
d8WX+9nUHoqlrAGagO0Wow: folds
NakujTNjHFgzceydFf+E2Q collected $3 from pot
*** SUMMARY ***
Total pot $3 | Rake $0
Seat 1: NakujTNjHFgzceydFf+E2Q (small blind) collected ($3)
Seat 2: TSuRyAHnUPCFjP7Z0rEE0w (big blind) folded before Flop
Seat 3: d8WX+9nUHoqlrAGagO0Wow folded before Flop
Seat 4: X87W8qaGsudJTSkClK2Cig folded before Flop (didn't bet)
Seat 5: r4lpoh2BJZ8S6zyQv1JeSw folded before Flop (didn't bet)
Seat 6: PvfYaKbzMpsmUcbOExckbQ (button) folded before Flop (didn't bet)



PokerStars Game #59941287038:  Hold'em No Limit ($0.50/$1.00) - 2009/07/01 1:31:03 ET
Table 'N6LvHFrb+cdXY/COI6ByOw' 2-max Seat #2 is the button
Seat 1: lXX4W7m3u++JiSOZ46yVMQ ($101.30 in chips)
Seat 2: 9mAoSP3o/mikSZOW2LEEAw ($95.45 in chips)
9mAoSP3o/mikSZOW2LEEAw: posts small blind $0.50
lXX4W7m3u++JiSOZ46yVMQ: posts big blind $1
*** HOLE CARDS ***
9mAoSP3o/mikSZOW2LEEAw: calls $0.50
lXX4W7m3u++JiSOZ46yVMQ: checks
*** FLOP *** [Qs Ac 9d]
lXX4W7m3u++JiSOZ46yVMQ: checks
9mAoSP3o/mikSZOW2LEEAw: bets $2
lXX4W7m3u++JiSOZ46yVMQ: folds
9mAoSP3o/mikSZOW2LEEAw collected $1.90 from pot
9mAoSP3o/mikSZOW2LEEAw: doesn't show hand
*** SUMMARY ***
Total pot $2 | Rake $0.10
Board [Qs Ac 9d]
Seat 1: lXX4W7m3u++JiSOZ46yVMQ (big blind) folded on the Flop
Seat 2: 9mAoSP3o/mikSZOW2LEEAw (button) (small blind) collected ($1.90)



PokerStars Game #59941287042:  Hold'em No Limit ($0.50/$1.00) - 2009/07/01 1:31:03 ET
Table 'vs/5jr6ciwjVQ5+Soc+u2A' 6-max Seat #1 is the button
Seat 1: J798qwLuvXyq0BbzsIjOrA ($163.15 in chips)
Seat 2: lXX4W7m3u++JiSOZ46yVMQ ($102.50 in chips)
Seat 4: wk6Ohn4GDozoOMHc4eb2rw ($50.80 in chips)
Seat 5: +Nt3OPk3XR9SKjZgm2CexQ ($164.40 in chips)
Seat 6: Z2fXsGcjl+Eax+RzOgwOmg ($104.50 in chips)
lXX4W7m3u++JiSOZ46yVMQ: posts small blind $0.50
G5ZSSN6RSON3gkNvk/SmYg: is sitting out
wk6Ohn4GDozoOMHc4eb2rw: posts big blind $1
*** HOLE CARDS ***
+Nt3OPk3XR9SKjZgm2CexQ: folds
Z2fXsGcjl+Eax+RzOgwOmg: folds
J798qwLuvXyq0BbzsIjOrA: raises $3 to $4
lXX4W7m3u++JiSOZ46yVMQ: folds
wk6Ohn4GDozoOMHc4eb2rw: folds
J798qwLuvXyq0BbzsIjOrA collected $2.50 from pot
J798qwLuvXyq0BbzsIjOrA: doesn't show hand
*** SUMMARY ***
Total pot $2.50 | Rake $0
Seat 1: J798qwLuvXyq0BbzsIjOrA (button) collected ($2.50)
Seat 2: lXX4W7m3u++JiSOZ46yVMQ (small blind) folded before Flop
Seat 4: wk6Ohn4GDozoOMHc4eb2rw (big blind) folded before Flop
Seat 5: +Nt3OPk3XR9SKjZgm2CexQ folded before Flop (didn't bet)
Seat 6: Z2fXsGcjl+Eax+RzOgwOmg folded before Flop (didn't bet)



PokerStars Game #59941288084:  Hold'em No Limit ($0.50/$1.00) - 2009/07/01 1:31:04 ET
Table 'NqGO/cV3MwFAx+ZPB5ANmQ' 2-max Seat #1 is the button
Seat 1: ItaRAnHOgvYOv5ynbG1iTw ($126 in chips)
Seat 2: GtFB+yyeb2djMdPFuOW/Xg ($164 in chips)
ItaRAnHOgvYOv5ynbG1iTw: posts small blind $0.50
GtFB+yyeb2djMdPFuOW/Xg: posts big blind $1
*** HOLE CARDS ***
ItaRAnHOgvYOv5ynbG1iTw: raises $1 to $2
GtFB+yyeb2djMdPFuOW/Xg: folds
ItaRAnHOgvYOv5ynbG1iTw collected $2 from pot
*** SUMMARY ***
Total pot $2 | Rake $0
Seat 1: ItaRAnHOgvYOv5ynbG1iTw (button) (small blind) collected ($2)
Seat 2: GtFB+yyeb2djMdPFuOW/Xg (big blind) folded before Flop



PokerStars Game #59941289748:  Hold'em No Limit ($0.50/$1.00) - 2009/07/01 1:31:07 ET
Table 'B6WyB7hgR3aIkOTM444Ksg' 2-max Seat #2 is the button
Seat 1: FeErMt4Gvt/3PH2oB/pn4A ($20 in chips)
Seat 2: ZJMQWIk6PtgNpvl9rP1BoA ($100 in chips)
ZJMQWIk6PtgNpvl9rP1BoA: posts small blind $0.50
FeErMt4Gvt/3PH2oB/pn4A: posts big blind $1
*** HOLE CARDS ***
ZJMQWIk6PtgNpvl9rP1BoA: raises $1 to $2
FeErMt4Gvt/3PH2oB/pn4A: folds
ZJMQWIk6PtgNpvl9rP1BoA collected $2 from pot
*** SUMMARY ***
Total pot $2 | Rake $0
Seat 1: FeErMt4Gvt/3PH2oB/pn4A (big blind) folded before Flop
Seat 2: ZJMQWIk6PtgNpvl9rP1BoA (button) (small blind) collected ($2)



PokerStars Game #59941290706:  Hold'em No Limit ($0.50/$1.00) - 2009/07/01 1:31:09 ET
Table 'jDQgUn1zGkyftPnHo0Awdw' 2-max Seat #2 is the button
Seat 1: a42+e5QB6s1kkG5FoSTZJw ($92.65 in chips)
Seat 2: q+vRKwm51mnr6kxX/161WQ ($100.50 in chips)
q+vRKwm51mnr6kxX/161WQ: posts small blind $0.50
a42+e5QB6s1kkG5FoSTZJw: posts big blind $1
*** HOLE CARDS ***
q+vRKwm51mnr6kxX/161WQ: raises $2 to $3
a42+e5QB6s1kkG5FoSTZJw: folds
q+vRKwm51mnr6kxX/161WQ collected $2 from pot
q+vRKwm51mnr6kxX/161WQ: doesn't show hand
*** SUMMARY ***
Total pot $2 | Rake $0
Seat 1: a42+e5QB6s1kkG5FoSTZJw (big blind) folded before Flop
Seat 2: q+vRKwm51mnr6kxX/161WQ (button) (small blind) collected ($2)



PokerStars Game #59941290956:  Hold'em No Limit ($0.50/$1.00) - 2009/07/01 1:31:10 ET
Table 'tJq9SfN1ywY0r03VBlWlwQ' 9-max Seat #1 is the button
Seat 1: wZsU+w9r7G66x93UuvBf1Q ($297.55 in chips)
Seat 2: VPF+HjszMvUIpy0CHIwH3A ($19 in chips)
Seat 4: bLbSOSmSOnqE0iTcH/5dxA ($111.15 in chips)
Seat 5: h5ipsNTMyolp7xn/NAvWkA ($136.90 in chips)
Seat 6: gUUvmqdVlmvpal6B8nYrmg ($100 in chips)
Seat 7: Pp/KTcXkfZKKUHkjyaLTdg ($34.05 in chips)
Seat 8: G4DEhsZFmznGNVpy2SEocA ($42.30 in chips)
Seat 9: XE5QF1y74bpHog9JxWJMWQ ($100 in chips)
VPF+HjszMvUIpy0CHIwH3A: posts small blind $0.50
bLbSOSmSOnqE0iTcH/5dxA: posts big blind $1
*** HOLE CARDS ***
h5ipsNTMyolp7xn/NAvWkA: folds
gUUvmqdVlmvpal6B8nYrmg: folds
Pp/KTcXkfZKKUHkjyaLTdg: folds
G4DEhsZFmznGNVpy2SEocA: folds
XE5QF1y74bpHog9JxWJMWQ: folds
wZsU+w9r7G66x93UuvBf1Q: raises $2 to $3
VPF+HjszMvUIpy0CHIwH3A: folds
bLbSOSmSOnqE0iTcH/5dxA: folds
wZsU+w9r7G66x93UuvBf1Q collected $2.50 from pot
*** SUMMARY ***
Total pot $2.50 | Rake $0
Seat 1: wZsU+w9r7G66x93UuvBf1Q (button) collected ($2.50)
Seat 2: VPF+HjszMvUIpy0CHIwH3A (small blind) folded before Flop
Seat 4: bLbSOSmSOnqE0iTcH/5dxA (big blind) folded before Flop
Seat 5: h5ipsNTMyolp7xn/NAvWkA folded before Flop (didn't bet)
Seat 6: gUUvmqdVlmvpal6B8nYrmg folded before Flop (didn't bet)
Seat 7: Pp/KTcXkfZKKUHkjyaLTdg folded before Flop (didn't bet)
Seat 8: G4DEhsZFmznGNVpy2SEocA folded before Flop (didn't bet)
Seat 9: XE5QF1y74bpHog9JxWJMWQ folded before Flop (didn't bet)



PokerStars Game #59941291988:  Hold'em No Limit ($0.50/$1.00) - 2009/07/01 1:31:11 ET
Table 'MUPc8FEpe/nR0BKSeReX6Q' 6-max Seat #3 is the button
Seat 1: qhkK6+yCciTRd+rCFEbnEQ ($79.10 in chips)
Seat 2: xAU6q2/cwmby2sxmA8VcmA ($105.20 in chips)
Seat 3: wx3sQGkVi2x9wJXuWNHPBw ($284 in chips)
Seat 4: r4lpoh2BJZ8S6zyQv1JeSw ($112.50 in chips)
Seat 5: y27w5IK2WXqmYzS8OU0wKA ($101.55 in chips)
Seat 6: cl/QpVR/PLO58lj+C5mGLw ($36 in chips)
r4lpoh2BJZ8S6zyQv1JeSw: posts small blind $0.50
y27w5IK2WXqmYzS8OU0wKA: posts big blind $1
*** HOLE CARDS ***
cl/QpVR/PLO58lj+C5mGLw: folds
qhkK6+yCciTRd+rCFEbnEQ: folds
xAU6q2/cwmby2sxmA8VcmA: folds
wx3sQGkVi2x9wJXuWNHPBw has timed out
wx3sQGkVi2x9wJXuWNHPBw: folds
wx3sQGkVi2x9wJXuWNHPBw is sitting out
r4lpoh2BJZ8S6zyQv1JeSw: folds
y27w5IK2WXqmYzS8OU0wKA collected $1 from pot
y27w5IK2WXqmYzS8OU0wKA: doesn't show hand
wx3sQGkVi2x9wJXuWNHPBw has returned
*** SUMMARY ***
Total pot $1 | Rake $0
Seat 1: qhkK6+yCciTRd+rCFEbnEQ folded before Flop (didn't bet)
Seat 2: xAU6q2/cwmby2sxmA8VcmA folded before Flop (didn't bet)
Seat 3: wx3sQGkVi2x9wJXuWNHPBw (button) folded before Flop (didn't bet)
Seat 4: r4lpoh2BJZ8S6zyQv1JeSw (small blind) folded before Flop
Seat 5: y27w5IK2WXqmYzS8OU0wKA (big blind) collected ($1)
Seat 6: cl/QpVR/PLO58lj+C5mGLw folded before Flop (didn't bet)



PokerStars Game #59941292392:  Hold'em No Limit ($0.50/$1.00) - 2009/07/01 1:31:12 ET
Table 'cBDNutyLBKEk9+ptwsKmTw' 6-max Seat #5 is the button
Seat 1: xAU6q2/cwmby2sxmA8VcmA ($299.05 in chips)
Seat 2: 4OO5v3AVduL0tePNx8wk5A ($105.05 in chips)
Seat 3: G5ZSSN6RSON3gkNvk/SmYg ($107.40 in chips)
Seat 4: OMkHNxIUZxh1pHqcCjbjgw ($91 in chips)
Seat 5: hpxXcmRkXXI9HE5+5/j/0Q ($106.20 in chips)
Seat 6: QHvTZcrKe6+maWUfVjP29Q ($152 in chips)
QHvTZcrKe6+maWUfVjP29Q: posts small blind $0.50
xAU6q2/cwmby2sxmA8VcmA: posts big blind $1
*** HOLE CARDS ***
4OO5v3AVduL0tePNx8wk5A: folds
G5ZSSN6RSON3gkNvk/SmYg: folds
OMkHNxIUZxh1pHqcCjbjgw: folds
hpxXcmRkXXI9HE5+5/j/0Q: folds
QHvTZcrKe6+maWUfVjP29Q: folds
xAU6q2/cwmby2sxmA8VcmA collected $1 from pot
xAU6q2/cwmby2sxmA8VcmA: doesn't show hand
*** SUMMARY ***
Total pot $1 | Rake $0
Seat 1: xAU6q2/cwmby2sxmA8VcmA (big blind) collected ($1)
Seat 2: 4OO5v3AVduL0tePNx8wk5A folded before Flop (didn't bet)
Seat 3: G5ZSSN6RSON3gkNvk/SmYg folded before Flop (didn't bet)
Seat 4: OMkHNxIUZxh1pHqcCjbjgw folded before Flop (didn't bet)
Seat 5: hpxXcmRkXXI9HE5+5/j/0Q (button) folded before Flop (didn't bet)
Seat 6: QHvTZcrKe6+maWUfVjP29Q (small blind) folded before Flop



PokerStars Game #59941292278:  Hold'em No Limit ($0.50/$1.00) - 2009/07/01 1:31:12 ET
Table '7Nl0ffnjeK44/vmeexh3MQ' 9-max Seat #1 is the button
Seat 1: V138SURkdX8LdVBPKdJJag ($101.50 in chips)
Seat 2: OGgaARGdJQT4awWVNQ957w ($100 in chips)
Seat 3: JMmUYT5pIKCKh2pGjCB/4w ($58.90 in chips)
Seat 4: bLbSOSmSOnqE0iTcH/5dxA ($105.30 in chips)
Seat 5: 61sfw5QTu62YYIt68OsdrA ($80 in chips)
Seat 6: FVs16t7GgfWgQWt4JxsObQ ($26.70 in chips)
Seat 7: 997ViqAtWn1FPjJqcffwcA ($100 in chips)
Seat 9: /JHoNdt0fK6X+isrqRfV3w ($20 in chips)
OGgaARGdJQT4awWVNQ957w: posts small blind $0.50
JMmUYT5pIKCKh2pGjCB/4w: posts big blind $1
*** HOLE CARDS ***
bLbSOSmSOnqE0iTcH/5dxA: folds
61sfw5QTu62YYIt68OsdrA: folds
FVs16t7GgfWgQWt4JxsObQ: folds
997ViqAtWn1FPjJqcffwcA: folds
/JHoNdt0fK6X+isrqRfV3w: folds
V138SURkdX8LdVBPKdJJag: folds
OGgaARGdJQT4awWVNQ957w: folds
JMmUYT5pIKCKh2pGjCB/4w collected $1 from pot
JMmUYT5pIKCKh2pGjCB/4w: doesn't show hand
*** SUMMARY ***
Total pot $1 | Rake $0
Seat 1: V138SURkdX8LdVBPKdJJag (button) folded before Flop (didn't bet)
Seat 2: OGgaARGdJQT4awWVNQ957w (small blind) folded before Flop
Seat 3: JMmUYT5pIKCKh2pGjCB/4w (big blind) collected ($1)
Seat 4: bLbSOSmSOnqE0iTcH/5dxA folded before Flop (didn't bet)
Seat 5: 61sfw5QTu62YYIt68OsdrA folded before Flop (didn't bet)
Seat 6: FVs16t7GgfWgQWt4JxsObQ folded before Flop (didn't bet)
Seat 7: 997ViqAtWn1FPjJqcffwcA folded before Flop (didn't bet)
Seat 9: /JHoNdt0fK6X+isrqRfV3w folded before Flop (didn't bet)



PokerStars Game #59941293308:  Hold'em No Limit ($0.50/$1.00) - 2009/07/01 1:31:13 ET
Table 'CASNP0uy1C+jGLml/I4PtA' 9-max Seat #4 is the button
Seat 1: tkdBeXTJlFsZdioidNqLow ($73.60 in chips)
Seat 2: LUsAYklr0mQkiq7ASOyD9A ($59.50 in chips)
Seat 4: B/G0GJacqZ8K59/ZVdq4kQ ($55.55 in chips)
Seat 5: Jjc7EHWzs4//xUAjJ0UWoA ($9.50 in chips)
Seat 6: FJEywSpo5JbRKByzmweboA ($100 in chips)
Seat 7: S3Ex8K7v6xm5jqjRM7Fl3w ($22 in chips)
Seat 8: L9njYvloJ1NdXjP8edHEAg ($104.45 in chips)
Seat 9: Pp/KTcXkfZKKUHkjyaLTdg ($24.10 in chips)
Jjc7EHWzs4//xUAjJ0UWoA: posts small blind $0.50
FJEywSpo5JbRKByzmweboA: posts big blind $1
*** HOLE CARDS ***
S3Ex8K7v6xm5jqjRM7Fl3w: folds
L9njYvloJ1NdXjP8edHEAg: folds
Pp/KTcXkfZKKUHkjyaLTdg: folds
tkdBeXTJlFsZdioidNqLow: folds
LUsAYklr0mQkiq7ASOyD9A: raises $2 to $3
B/G0GJacqZ8K59/ZVdq4kQ: calls $3
Jjc7EHWzs4//xUAjJ0UWoA: folds
FJEywSpo5JbRKByzmweboA: calls $2
*** FLOP *** [9d 7s Ah]
FJEywSpo5JbRKByzmweboA: checks
LUsAYklr0mQkiq7ASOyD9A: bets $4
B/G0GJacqZ8K59/ZVdq4kQ: folds
FJEywSpo5JbRKByzmweboA: folds
LUsAYklr0mQkiq7ASOyD9A collected $9.05 from pot
*** SUMMARY ***
Total pot $9.50 | Rake $0.45
Board [9d 7s Ah]
Seat 1: tkdBeXTJlFsZdioidNqLow folded before Flop (didn't bet)
Seat 2: LUsAYklr0mQkiq7ASOyD9A collected ($9.05)
Seat 4: B/G0GJacqZ8K59/ZVdq4kQ (button) folded on the Flop
Seat 5: Jjc7EHWzs4//xUAjJ0UWoA (small blind) folded before Flop
Seat 6: FJEywSpo5JbRKByzmweboA (big blind) folded on the Flop
Seat 7: S3Ex8K7v6xm5jqjRM7Fl3w folded before Flop (didn't bet)
Seat 8: L9njYvloJ1NdXjP8edHEAg folded before Flop (didn't bet)
Seat 9: Pp/KTcXkfZKKUHkjyaLTdg folded before Flop (didn't bet)



PokerStars Game #59941293828:  Hold'em No Limit ($0.50/$1.00) - 2009/07/01 1:31:14 ET
Table 'NqGO/cV3MwFAx+ZPB5ANmQ' 2-max Seat #2 is the button
Seat 1: ItaRAnHOgvYOv5ynbG1iTw ($127 in chips)
Seat 2: GtFB+yyeb2djMdPFuOW/Xg ($163 in chips)
GtFB+yyeb2djMdPFuOW/Xg: posts small blind $0.50
ItaRAnHOgvYOv5ynbG1iTw: posts big blind $1
*** HOLE CARDS ***
GtFB+yyeb2djMdPFuOW/Xg: raises $2 to $3
ItaRAnHOgvYOv5ynbG1iTw: calls $2
*** FLOP *** [2s 2c Jc]
ItaRAnHOgvYOv5ynbG1iTw: checks
GtFB+yyeb2djMdPFuOW/Xg: checks
*** TURN *** [2s 2c Jc] [8c]
ItaRAnHOgvYOv5ynbG1iTw: bets $5
GtFB+yyeb2djMdPFuOW/Xg: folds
ItaRAnHOgvYOv5ynbG1iTw collected $5.70 from pot
*** SUMMARY ***
Total pot $6 | Rake $0.30
Board [2s 2c Jc 8c]
Seat 1: ItaRAnHOgvYOv5ynbG1iTw (big blind) collected ($5.70)
Seat 2: GtFB+yyeb2djMdPFuOW/Xg (button) (small blind) folded on the Turn



PokerStars Game #59941295306:  Hold'em No Limit ($0.50/$1.00) - 2009/07/01 1:31:17 ET
Table 'B6WyB7hgR3aIkOTM444Ksg' 2-max Seat #1 is the button
Seat 1: FeErMt4Gvt/3PH2oB/pn4A ($19 in chips)
Seat 2: ZJMQWIk6PtgNpvl9rP1BoA ($101 in chips)
FeErMt4Gvt/3PH2oB/pn4A: posts small blind $0.50
ZJMQWIk6PtgNpvl9rP1BoA: posts big blind $1
*** HOLE CARDS ***
FeErMt4Gvt/3PH2oB/pn4A: calls $0.50
ZJMQWIk6PtgNpvl9rP1BoA: raises $2 to $3
FeErMt4Gvt/3PH2oB/pn4A: folds
ZJMQWIk6PtgNpvl9rP1BoA collected $2 from pot
*** SUMMARY ***
Total pot $2 | Rake $0
Seat 1: FeErMt4Gvt/3PH2oB/pn4A (button) (small blind) folded before Flop
Seat 2: ZJMQWIk6PtgNpvl9rP1BoA (big blind) collected ($2)



PokerStars Game #59941295132:  Hold'em No Limit ($0.50/$1.00) - 2009/07/01 1:31:17 ET
Table 'jDQgUn1zGkyftPnHo0Awdw' 2-max Seat #1 is the button
Seat 1: a42+e5QB6s1kkG5FoSTZJw ($91.65 in chips)
Seat 2: q+vRKwm51mnr6kxX/161WQ ($101.50 in chips)
a42+e5QB6s1kkG5FoSTZJw: posts small blind $0.50
q+vRKwm51mnr6kxX/161WQ: posts big blind $1
*** HOLE CARDS ***
a42+e5QB6s1kkG5FoSTZJw: raises $3 to $4
q+vRKwm51mnr6kxX/161WQ: folds
a42+e5QB6s1kkG5FoSTZJw collected $2 from pot
a42+e5QB6s1kkG5FoSTZJw: doesn't show hand
*** SUMMARY ***
Total pot $2 | Rake $0
Seat 1: a42+e5QB6s1kkG5FoSTZJw (button) (small blind) collected ($2)
Seat 2: q+vRKwm51mnr6kxX/161WQ (big blind) folded before Flop



PokerStars Game #59941296260:  Hold'em No Limit ($0.50/$1.00) - 2009/07/01 1:31:19 ET
Table 'W/wyObTiXZm+Ckkl3YxcSw' 6-max Seat #5 is the button
Seat 1: eUBBn2R56C1IQ6Cs/vitwg ($295.05 in chips)
Seat 2: oDiBRCaF0QVtd3kO6xZIXw ($162.90 in chips)
Seat 3: dxyNCn/qxfkGDUIf28Cbng ($61.30 in chips)
Seat 4: UBZQqpnJZdTYYY1FTb0rLA ($101.70 in chips)
Seat 5: +OrCjyw70oZhJiD22Mn+bg ($101 in chips)
Seat 6: b2a+5TkFf4xJN/Ihhma58Q ($35.30 in chips)
b2a+5TkFf4xJN/Ihhma58Q: posts small blind $0.50
eUBBn2R56C1IQ6Cs/vitwg: posts big blind $1
*** HOLE CARDS ***
oDiBRCaF0QVtd3kO6xZIXw: folds
dxyNCn/qxfkGDUIf28Cbng: folds
UBZQqpnJZdTYYY1FTb0rLA: folds
+OrCjyw70oZhJiD22Mn+bg: folds
b2a+5TkFf4xJN/Ihhma58Q: calls $0.50
eUBBn2R56C1IQ6Cs/vitwg: raises $3 to $4
b2a+5TkFf4xJN/Ihhma58Q: folds
eUBBn2R56C1IQ6Cs/vitwg collected $2 from pot
*** SUMMARY ***
Total pot $2 | Rake $0
Seat 1: eUBBn2R56C1IQ6Cs/vitwg (big blind) collected ($2)
Seat 2: oDiBRCaF0QVtd3kO6xZIXw folded before Flop (didn't bet)
Seat 3: dxyNCn/qxfkGDUIf28Cbng folded before Flop (didn't bet)
Seat 4: UBZQqpnJZdTYYY1FTb0rLA folded before Flop (didn't bet)
Seat 5: +OrCjyw70oZhJiD22Mn+bg (button) folded before Flop (didn't bet)
Seat 6: b2a+5TkFf4xJN/Ihhma58Q (small blind) folded before Flop



PokerStars Game #59941296980:  Hold'em No Limit ($0.50/$1.00) - 2009/07/01 1:31:20 ET
Table 'gxFK0BVUD7cupu2uyRUZJg' 6-max Seat #6 is the button
Seat 1: M+X3uChmP6R63IwijVjgTg ($161.15 in chips)
Seat 2: hpxXcmRkXXI9HE5+5/j/0Q ($134.55 in chips)
Seat 3: Z2fXsGcjl+Eax+RzOgwOmg ($119.50 in chips)
Seat 5: WgIrs6CBinyyw18pqdDtWA ($20.60 in chips)
Seat 6: dYyb6/42PMC8aNFlm/eBeQ ($102.40 in chips)
M+X3uChmP6R63IwijVjgTg: posts small blind $0.50
hpxXcmRkXXI9HE5+5/j/0Q: posts big blind $1
*** HOLE CARDS ***
Z2fXsGcjl+Eax+RzOgwOmg: folds
WgIrs6CBinyyw18pqdDtWA: folds
Hcr4S4Nbkj5idKsvYK/eqQ joins the table at seat #4
dYyb6/42PMC8aNFlm/eBeQ: raises $1 to $2
M+X3uChmP6R63IwijVjgTg: folds
hpxXcmRkXXI9HE5+5/j/0Q: folds
dYyb6/42PMC8aNFlm/eBeQ collected $2.50 from pot
dYyb6/42PMC8aNFlm/eBeQ: doesn't show hand
*** SUMMARY ***
Total pot $2.50 | Rake $0
Seat 1: M+X3uChmP6R63IwijVjgTg (small blind) folded before Flop
Seat 2: hpxXcmRkXXI9HE5+5/j/0Q (big blind) folded before Flop
Seat 3: Z2fXsGcjl+Eax+RzOgwOmg folded before Flop (didn't bet)
Seat 5: WgIrs6CBinyyw18pqdDtWA folded before Flop (didn't bet)
Seat 6: dYyb6/42PMC8aNFlm/eBeQ (button) collected ($2.50)



PokerStars Game #59941297650:  Hold'em No Limit ($0.50/$1.00) - 2009/07/01 1:31:21 ET
Table 'O96CPOtvMBWP6kzuYDfdFA' 6-max Seat #2 is the button
Seat 1: 6alLXQIITA2EZ/lBeym8Dw ($127.75 in chips)
Seat 2: 4d1rWhpu8DzLmzMbR3QKyA ($100 in chips)
Seat 3: V89DGjxE171oPREEbAXiyg ($118.25 in chips)
Seat 4: /P4w1pHg2zHYg/4ubJ0dPw ($66.65 in chips)
Seat 5: G5ZSSN6RSON3gkNvk/SmYg ($105.65 in chips)
Seat 6: 3syOXva630dm1FTdwnuLpw ($74.50 in chips)
V89DGjxE171oPREEbAXiyg: posts small blind $0.50
/P4w1pHg2zHYg/4ubJ0dPw: posts big blind $1
*** HOLE CARDS ***
G5ZSSN6RSON3gkNvk/SmYg: folds
3syOXva630dm1FTdwnuLpw: folds
6alLXQIITA2EZ/lBeym8Dw: folds
4d1rWhpu8DzLmzMbR3QKyA: raises $2 to $3
V89DGjxE171oPREEbAXiyg: folds
/P4w1pHg2zHYg/4ubJ0dPw: folds
4d1rWhpu8DzLmzMbR3QKyA collected $2.50 from pot
*** SUMMARY ***
Total pot $2.50 | Rake $0
Seat 1: 6alLXQIITA2EZ/lBeym8Dw folded before Flop (didn't bet)
Seat 2: 4d1rWhpu8DzLmzMbR3QKyA (button) collected ($2.50)
Seat 3: V89DGjxE171oPREEbAXiyg (small blind) folded before Flop
Seat 4: /P4w1pHg2zHYg/4ubJ0dPw (big blind) folded before Flop
Seat 5: G5ZSSN6RSON3gkNvk/SmYg folded before Flop (didn't bet)
Seat 6: 3syOXva630dm1FTdwnuLpw folded before Flop (didn't bet)



PokerStars Game #59941298974:  Hold'em No Limit ($0.50/$1.00) - 2009/07/01 1:31:23 ET
Table '7O9fB8yx1u7sJveJn8w6jA' 6-max Seat #4 is the button
Seat 1: jy52+7FotjH63o5tEEVgKw ($66.60 in chips)
Seat 2: wx3sQGkVi2x9wJXuWNHPBw ($195.20 in chips)
Seat 3: hpxXcmRkXXI9HE5+5/j/0Q ($138.40 in chips)
Seat 4: b2a+5TkFf4xJN/Ihhma58Q ($35.35 in chips)
Seat 5: BCEV3COoKY607AzLWayfRA ($100 in chips)
Seat 6: r4lpoh2BJZ8S6zyQv1JeSw ($100 in chips)
BCEV3COoKY607AzLWayfRA: posts small blind $0.50
r4lpoh2BJZ8S6zyQv1JeSw: posts big blind $1
*** HOLE CARDS ***
jy52+7FotjH63o5tEEVgKw: folds
wx3sQGkVi2x9wJXuWNHPBw: raises $3 to $4
jy52+7FotjH63o5tEEVgKw leaves the table
hpxXcmRkXXI9HE5+5/j/0Q: folds
b2a+5TkFf4xJN/Ihhma58Q: folds
BCEV3COoKY607AzLWayfRA: folds
r4lpoh2BJZ8S6zyQv1JeSw: folds
wx3sQGkVi2x9wJXuWNHPBw collected $2.50 from pot
*** SUMMARY ***
Total pot $2.50 | Rake $0
Seat 1: jy52+7FotjH63o5tEEVgKw folded before Flop (didn't bet)
Seat 2: wx3sQGkVi2x9wJXuWNHPBw collected ($2.50)
Seat 3: hpxXcmRkXXI9HE5+5/j/0Q folded before Flop (didn't bet)
Seat 4: b2a+5TkFf4xJN/Ihhma58Q (button) folded before Flop (didn't bet)
Seat 5: BCEV3COoKY607AzLWayfRA (small blind) folded before Flop
Seat 6: r4lpoh2BJZ8S6zyQv1JeSw (big blind) folded before Flop



PokerStars Game #59941299252:  Hold'em No Limit ($0.50/$1.00) - 2009/07/01 1:31:24 ET
Table 'mmbQQVBTrPdE+wy+s+9VPA' 6-max Seat #2 is the button
Seat 1: zyP4SPoWZnKUfTvIRLCVog ($76.65 in chips)
Seat 2: XK4Qsl+DA8gAJyg85/zBIw ($31.60 in chips)
Seat 3: wx3sQGkVi2x9wJXuWNHPBw ($125.35 in chips)
Seat 4: V3iZdcw61nXF3g5hD2RrsQ ($104.15 in chips)
Seat 5: YMJG+F++3Aj6P8dAWda5fw ($120.90 in chips)
Seat 6: U2CWBTv29qdCbj8RNF2sIw ($119.20 in chips)
wx3sQGkVi2x9wJXuWNHPBw: posts small blind $0.50
V3iZdcw61nXF3g5hD2RrsQ: posts big blind $1
*** HOLE CARDS ***
YMJG+F++3Aj6P8dAWda5fw: folds
U2CWBTv29qdCbj8RNF2sIw: folds
zyP4SPoWZnKUfTvIRLCVog: calls $1
XK4Qsl+DA8gAJyg85/zBIw: folds
wx3sQGkVi2x9wJXuWNHPBw: folds
V3iZdcw61nXF3g5hD2RrsQ: checks
*** FLOP *** [3d 6h 4d]
V3iZdcw61nXF3g5hD2RrsQ: checks
zyP4SPoWZnKUfTvIRLCVog: checks
*** TURN *** [3d 6h 4d] [7s]
V3iZdcw61nXF3g5hD2RrsQ: bets $3
zyP4SPoWZnKUfTvIRLCVog: folds
V3iZdcw61nXF3g5hD2RrsQ collected $2.40 from pot
*** SUMMARY ***
Total pot $2.50 | Rake $0.10
Board [3d 6h 4d 7s]
Seat 1: zyP4SPoWZnKUfTvIRLCVog folded on the Turn
Seat 2: XK4Qsl+DA8gAJyg85/zBIw (button) folded before Flop (didn't bet)
Seat 3: wx3sQGkVi2x9wJXuWNHPBw (small blind) folded before Flop
Seat 4: V3iZdcw61nXF3g5hD2RrsQ (big blind) collected ($2.40)
Seat 5: YMJG+F++3Aj6P8dAWda5fw folded before Flop (didn't bet)
Seat 6: U2CWBTv29qdCbj8RNF2sIw folded before Flop (didn't bet)



PokerStars Game #59941299548:  Hold'em No Limit ($0.50/$1.00) - 2009/07/01 1:31:24 ET
Table 'N2bNCDHL96aCQDvZIh+yQQ' 6-max Seat #1 is the button
Seat 1: Jjgflx10PVjcLkziEmLhSA ($40.10 in chips)
Seat 2: y27w5IK2WXqmYzS8OU0wKA ($117.55 in chips)
Seat 3: UBZQqpnJZdTYYY1FTb0rLA ($122.05 in chips)
Seat 4: uCqEjnxh2/vFBjKYkfTOkw ($228.10 in chips)
Seat 5: frvgHLr3+LfZtjsBCBs3NA ($21.30 in chips)
Seat 6: idVgoPAdspFPCzee6aF9Pg ($100 in chips)
y27w5IK2WXqmYzS8OU0wKA: posts small blind $0.50
UBZQqpnJZdTYYY1FTb0rLA: posts big blind $1
*** HOLE CARDS ***
uCqEjnxh2/vFBjKYkfTOkw: folds
frvgHLr3+LfZtjsBCBs3NA: calls $1
idVgoPAdspFPCzee6aF9Pg: folds
Jjgflx10PVjcLkziEmLhSA: calls $1
y27w5IK2WXqmYzS8OU0wKA: calls $0.50
UBZQqpnJZdTYYY1FTb0rLA: checks
*** FLOP *** [Th 3d Tc]
y27w5IK2WXqmYzS8OU0wKA: checks
UBZQqpnJZdTYYY1FTb0rLA: checks
frvgHLr3+LfZtjsBCBs3NA: bets $2
Jjgflx10PVjcLkziEmLhSA: folds
y27w5IK2WXqmYzS8OU0wKA: folds
UBZQqpnJZdTYYY1FTb0rLA: folds
frvgHLr3+LfZtjsBCBs3NA collected $3.80 from pot
frvgHLr3+LfZtjsBCBs3NA: doesn't show hand
*** SUMMARY ***
Total pot $4 | Rake $0.20
Board [Th 3d Tc]
Seat 1: Jjgflx10PVjcLkziEmLhSA (button) folded on the Flop
Seat 2: y27w5IK2WXqmYzS8OU0wKA (small blind) folded on the Flop
Seat 3: UBZQqpnJZdTYYY1FTb0rLA (big blind) folded on the Flop
Seat 4: uCqEjnxh2/vFBjKYkfTOkw folded before Flop (didn't bet)
Seat 5: frvgHLr3+LfZtjsBCBs3NA collected ($3.80)
Seat 6: idVgoPAdspFPCzee6aF9Pg folded before Flop (didn't bet)



PokerStars Game #59941299784:  Hold'em No Limit ($0.50/$1.00) - 2009/07/01 1:31:25 ET
Table 'jDQgUn1zGkyftPnHo0Awdw' 2-max Seat #2 is the button
Seat 1: a42+e5QB6s1kkG5FoSTZJw ($92.65 in chips)
Seat 2: q+vRKwm51mnr6kxX/161WQ ($100.50 in chips)
q+vRKwm51mnr6kxX/161WQ: posts small blind $0.50
a42+e5QB6s1kkG5FoSTZJw: posts big blind $1
*** HOLE CARDS ***
q+vRKwm51mnr6kxX/161WQ: raises $2 to $3
a42+e5QB6s1kkG5FoSTZJw: raises $6 to $9
q+vRKwm51mnr6kxX/161WQ: calls $6
*** FLOP *** [5d 9d Jc]
a42+e5QB6s1kkG5FoSTZJw: bets $12
q+vRKwm51mnr6kxX/161WQ: folds
a42+e5QB6s1kkG5FoSTZJw collected $17.50 from pot
a42+e5QB6s1kkG5FoSTZJw: doesn't show hand
*** SUMMARY ***
Total pot $18 | Rake $0.50
Board [5d 9d Jc]
Seat 1: a42+e5QB6s1kkG5FoSTZJw (big blind) collected ($17.50)
Seat 2: q+vRKwm51mnr6kxX/161WQ (button) (small blind) folded on the Flop



PokerStars Game #59941300004:  Hold'em No Limit ($0.50/$1.00) - 2009/07/01 1:31:25 ET
Table 'N6LvHFrb+cdXY/COI6ByOw' 2-max Seat #1 is the button
Seat 1: lXX4W7m3u++JiSOZ46yVMQ ($100.30 in chips)
Seat 2: 9mAoSP3o/mikSZOW2LEEAw ($96.35 in chips)
lXX4W7m3u++JiSOZ46yVMQ: posts small blind $0.50
9mAoSP3o/mikSZOW2LEEAw: posts big blind $1
*** HOLE CARDS ***
lXX4W7m3u++JiSOZ46yVMQ: raises $2 to $3
9mAoSP3o/mikSZOW2LEEAw: raises $2 to $5
lXX4W7m3u++JiSOZ46yVMQ: calls $2
*** FLOP *** [4d Ac 8c]
9mAoSP3o/mikSZOW2LEEAw: bets $4
lXX4W7m3u++JiSOZ46yVMQ: calls $4
*** TURN *** [4d Ac 8c] [7d]
9mAoSP3o/mikSZOW2LEEAw: bets $3
lXX4W7m3u++JiSOZ46yVMQ: calls $3
*** RIVER *** [4d Ac 8c 7d] [9s]
9mAoSP3o/mikSZOW2LEEAw: checks
lXX4W7m3u++JiSOZ46yVMQ: checks
*** SHOW DOWN ***
9mAoSP3o/mikSZOW2LEEAw: shows [Tc Th] (a pair of Tens)
lXX4W7m3u++JiSOZ46yVMQ: shows [As 3s] (a pair of Aces)
lXX4W7m3u++JiSOZ46yVMQ collected $23.50 from pot
*** SUMMARY ***
Total pot $24 | Rake $0.50
Board [4d Ac 8c 7d 9s]
Seat 1: lXX4W7m3u++JiSOZ46yVMQ (button) (small blind) showed [As 3s] and won ($23.50) with a pair of Aces
Seat 2: 9mAoSP3o/mikSZOW2LEEAw (big blind) showed [Tc Th] and lost with a pair of Tens



PokerStars Game #59941300168:  Hold'em No Limit ($0.50/$1.00) - 2009/07/01 1:31:25 ET
Table '/FUb199IViHMJHi5YWmeuQ' 9-max Seat #9 is the button
Seat 1: 3obndzTJ6fECz8+wWhMd1w ($17.50 in chips)
Seat 2: FL3MrLspcF23LYvC4ipBOA ($185.55 in chips)
Seat 3: V138SURkdX8LdVBPKdJJag ($118.25 in chips)
Seat 4: pbAfmxe4uSZPxJQX7gOzZA ($67.30 in chips)
Seat 5: H+DVy3Ei8L1UKS2tVOtJcw ($136.85 in chips)
Seat 6: VPF+HjszMvUIpy0CHIwH3A ($21.50 in chips)
Seat 7: myIxN7otsyr846M539YR8Q ($27 in chips)
Seat 8: 997ViqAtWn1FPjJqcffwcA ($101 in chips)
Seat 9: RfLbneGRY8yQUpMgDnJCxA ($75.20 in chips)
3obndzTJ6fECz8+wWhMd1w: posts small blind $0.50
FL3MrLspcF23LYvC4ipBOA: posts big blind $1
*** HOLE CARDS ***
V138SURkdX8LdVBPKdJJag: folds
pbAfmxe4uSZPxJQX7gOzZA: calls $1
H+DVy3Ei8L1UKS2tVOtJcw: folds
VPF+HjszMvUIpy0CHIwH3A: folds
myIxN7otsyr846M539YR8Q: folds
997ViqAtWn1FPjJqcffwcA: folds
RfLbneGRY8yQUpMgDnJCxA: folds
3obndzTJ6fECz8+wWhMd1w: calls $0.50
FL3MrLspcF23LYvC4ipBOA: checks
*** FLOP *** [Qd 7d 6s]
3obndzTJ6fECz8+wWhMd1w: checks
FL3MrLspcF23LYvC4ipBOA: checks
pbAfmxe4uSZPxJQX7gOzZA: bets $2
3obndzTJ6fECz8+wWhMd1w: folds
FL3MrLspcF23LYvC4ipBOA: folds
pbAfmxe4uSZPxJQX7gOzZA collected $2.85 from pot
*** SUMMARY ***
Total pot $3 | Rake $0.15
Board [Qd 7d 6s]
Seat 1: 3obndzTJ6fECz8+wWhMd1w (small blind) folded on the Flop
Seat 2: FL3MrLspcF23LYvC4ipBOA (big blind) folded on the Flop
Seat 3: V138SURkdX8LdVBPKdJJag folded before Flop (didn't bet)
Seat 4: pbAfmxe4uSZPxJQX7gOzZA collected ($2.85)
Seat 5: H+DVy3Ei8L1UKS2tVOtJcw folded before Flop (didn't bet)
Seat 6: VPF+HjszMvUIpy0CHIwH3A folded before Flop (didn't bet)
Seat 7: myIxN7otsyr846M539YR8Q folded before Flop (didn't bet)
Seat 8: 997ViqAtWn1FPjJqcffwcA folded before Flop (didn't bet)
Seat 9: RfLbneGRY8yQUpMgDnJCxA (button) folded before Flop (didn't bet)



PokerStars Game #59941300650:  Hold'em No Limit ($0.50/$1.00) - 2009/07/01 1:31:26 ET
Table 'B6WyB7hgR3aIkOTM444Ksg' 2-max Seat #2 is the button
Seat 1: FeErMt4Gvt/3PH2oB/pn4A ($18 in chips)
Seat 2: ZJMQWIk6PtgNpvl9rP1BoA ($102 in chips)
ZJMQWIk6PtgNpvl9rP1BoA: posts small blind $0.50
FeErMt4Gvt/3PH2oB/pn4A: posts big blind $1
*** HOLE CARDS ***
ZJMQWIk6PtgNpvl9rP1BoA: raises $2 to $3
FeErMt4Gvt/3PH2oB/pn4A: calls $2
*** FLOP *** [3d Qc Jh]
FeErMt4Gvt/3PH2oB/pn4A: checks
ZJMQWIk6PtgNpvl9rP1BoA: bets $3
FeErMt4Gvt/3PH2oB/pn4A: raises $12 to $15 and is all-in
ZJMQWIk6PtgNpvl9rP1BoA: folds
FeErMt4Gvt/3PH2oB/pn4A collected $11.50 from pot
FeErMt4Gvt/3PH2oB/pn4A: doesn't show hand
*** SUMMARY ***
Total pot $12 | Rake $0.50
Board [3d Qc Jh]
Seat 1: FeErMt4Gvt/3PH2oB/pn4A (big blind) collected ($11.50)
Seat 2: ZJMQWIk6PtgNpvl9rP1BoA (button) (small blind) folded on the Flop



PokerStars Game #59941300780:  Hold'em No Limit ($0.50/$1.00) - 2009/07/01 1:31:26 ET
Table 'b8oW/dOL7fDza5DfZ/dOJQ' 6-max Seat #1 is the button
Seat 1: NakujTNjHFgzceydFf+E2Q ($101 in chips)
Seat 2: TSuRyAHnUPCFjP7Z0rEE0w ($120.50 in chips)
Seat 3: d8WX+9nUHoqlrAGagO0Wow ($19 in chips)
Seat 4: X87W8qaGsudJTSkClK2Cig ($21.85 in chips)
Seat 5: r4lpoh2BJZ8S6zyQv1JeSw ($102.50 in chips)
Seat 6: PvfYaKbzMpsmUcbOExckbQ ($100 in chips)
TSuRyAHnUPCFjP7Z0rEE0w: posts small blind $0.50
d8WX+9nUHoqlrAGagO0Wow: posts big blind $1
*** HOLE CARDS ***
X87W8qaGsudJTSkClK2Cig: folds
r4lpoh2BJZ8S6zyQv1JeSw: folds
PvfYaKbzMpsmUcbOExckbQ: folds
NakujTNjHFgzceydFf+E2Q: folds
TSuRyAHnUPCFjP7Z0rEE0w: raises $3 to $4
d8WX+9nUHoqlrAGagO0Wow: folds
TSuRyAHnUPCFjP7Z0rEE0w collected $2 from pot
TSuRyAHnUPCFjP7Z0rEE0w: doesn't show hand
*** SUMMARY ***
Total pot $2 | Rake $0
Seat 1: NakujTNjHFgzceydFf+E2Q (button) folded before Flop (didn't bet)
Seat 2: TSuRyAHnUPCFjP7Z0rEE0w (small blind) collected ($2)
Seat 3: d8WX+9nUHoqlrAGagO0Wow (big blind) folded before Flop
Seat 4: X87W8qaGsudJTSkClK2Cig folded before Flop (didn't bet)
Seat 5: r4lpoh2BJZ8S6zyQv1JeSw folded before Flop (didn't bet)
Seat 6: PvfYaKbzMpsmUcbOExckbQ folded before Flop (didn't bet)



PokerStars Game #59941301074:  Hold'em No Limit ($0.50/$1.00) - 2009/07/01 1:31:27 ET
Table 'kS0cTQAEi+fdUlJP2gQYvw' 9-max Seat #7 is the button
Seat 1: SqsWPukL8kLqrhq5ZrQdSQ ($99 in chips)
Seat 2: D+W9Me7w6Hcx/WRUSKV0dw ($25.05 in chips)
Seat 3: 2BV+oJIQYr65IO6nEChvbA ($67 in chips)
Seat 4: RUhhaALzha3TH1AkdakoGQ ($52.50 in chips)
Seat 5: 997ViqAtWn1FPjJqcffwcA ($100 in chips)
Seat 6: yAbu2QsRPVcjPbqlf/jDxw ($124.65 in chips)
Seat 7: Ffa7Nj4X5fddtROP01hfQg ($145.50 in chips)
Seat 8: vKyFzTyzfT7fZcdX+HHN+Q ($33.95 in chips)
Seat 9: OGgaARGdJQT4awWVNQ957w ($107.80 in chips)
vKyFzTyzfT7fZcdX+HHN+Q: posts small blind $0.50
OGgaARGdJQT4awWVNQ957w: posts big blind $1
*** HOLE CARDS ***
SqsWPukL8kLqrhq5ZrQdSQ: folds
D+W9Me7w6Hcx/WRUSKV0dw: folds
2BV+oJIQYr65IO6nEChvbA: folds
RUhhaALzha3TH1AkdakoGQ: folds
997ViqAtWn1FPjJqcffwcA: folds
yAbu2QsRPVcjPbqlf/jDxw: raises $2 to $3
Ffa7Nj4X5fddtROP01hfQg: folds
vKyFzTyzfT7fZcdX+HHN+Q: calls $2.50
OGgaARGdJQT4awWVNQ957w: folds
*** FLOP *** [2c 2s 7d]
vKyFzTyzfT7fZcdX+HHN+Q: bets $3
yAbu2QsRPVcjPbqlf/jDxw: calls $3
*** TURN *** [2c 2s 7d] [5s]
vKyFzTyzfT7fZcdX+HHN+Q: bets $5
yAbu2QsRPVcjPbqlf/jDxw: folds
vKyFzTyzfT7fZcdX+HHN+Q collected $12.40 from pot
*** SUMMARY ***
Total pot $13 | Rake $0.60
Board [2c 2s 7d 5s]
Seat 1: SqsWPukL8kLqrhq5ZrQdSQ folded before Flop (didn't bet)
Seat 2: D+W9Me7w6Hcx/WRUSKV0dw folded before Flop (didn't bet)
Seat 3: 2BV+oJIQYr65IO6nEChvbA folded before Flop (didn't bet)
Seat 4: RUhhaALzha3TH1AkdakoGQ folded before Flop (didn't bet)
Seat 5: 997ViqAtWn1FPjJqcffwcA folded before Flop (didn't bet)
Seat 6: yAbu2QsRPVcjPbqlf/jDxw folded on the Turn
Seat 7: Ffa7Nj4X5fddtROP01hfQg (button) folded before Flop (didn't bet)
Seat 8: vKyFzTyzfT7fZcdX+HHN+Q (small blind) collected ($12.40)
Seat 9: OGgaARGdJQT4awWVNQ957w (big blind) folded before Flop



PokerStars Game #59941301472:  Hold'em No Limit ($0.50/$1.00) - 2009/07/01 1:31:28 ET
Table '+cA8mcmhaedZ7YcrDdhmeQ' 6-max Seat #4 is the button
Seat 1: 9XrTM0DuVxx1pjFAdSbD8A ($54.70 in chips)
Seat 2: 14aYclSc98EYd6TrzN2l3Q ($24.05 in chips)
Seat 3: DAIgyIWbYvAkL6PbAI27pg ($16.55 in chips)
Seat 4: 4OO5v3AVduL0tePNx8wk5A ($100 in chips)
Seat 5: RqgF7gRoKgRNW8Zoi1ty4A ($162.80 in chips)
Seat 6: YfsTQsY/fxb+YqbdclTHuw ($44.85 in chips)
RqgF7gRoKgRNW8Zoi1ty4A: posts small blind $0.50
YfsTQsY/fxb+YqbdclTHuw: posts big blind $1
*** HOLE CARDS ***
9XrTM0DuVxx1pjFAdSbD8A: folds
14aYclSc98EYd6TrzN2l3Q: raises $1 to $2
DAIgyIWbYvAkL6PbAI27pg: folds
4OO5v3AVduL0tePNx8wk5A: calls $2
RqgF7gRoKgRNW8Zoi1ty4A: folds
YfsTQsY/fxb+YqbdclTHuw: folds
*** FLOP *** [2c 8h 4s]
14aYclSc98EYd6TrzN2l3Q: bets $3
4OO5v3AVduL0tePNx8wk5A: calls $3
*** TURN *** [2c 8h 4s] [Kc]
14aYclSc98EYd6TrzN2l3Q: checks
4OO5v3AVduL0tePNx8wk5A: checks
*** RIVER *** [2c 8h 4s Kc] [Th]
14aYclSc98EYd6TrzN2l3Q: checks
14aYclSc98EYd6TrzN2l3Q said, "no tha nks"
4OO5v3AVduL0tePNx8wk5A: checks
*** SHOW DOWN ***
14aYclSc98EYd6TrzN2l3Q: shows [6h 7d] (high card King)
4OO5v3AVduL0tePNx8wk5A: shows [4h Ah] (a pair of Fours)
4OO5v3AVduL0tePNx8wk5A collected $10.95 from pot
*** SUMMARY ***
Total pot $11.50 | Rake $0.55
Board [2c 8h 4s Kc Th]
Seat 1: 9XrTM0DuVxx1pjFAdSbD8A folded before Flop (didn't bet)
Seat 2: 14aYclSc98EYd6TrzN2l3Q showed [6h 7d] and lost with high card King
Seat 3: DAIgyIWbYvAkL6PbAI27pg folded before Flop (didn't bet)
Seat 4: 4OO5v3AVduL0tePNx8wk5A (button) showed [4h Ah] and won ($10.95) with a pair of Fours
Seat 5: RqgF7gRoKgRNW8Zoi1ty4A (small blind) folded before Flop
Seat 6: YfsTQsY/fxb+YqbdclTHuw (big blind) folded before Flop



PokerStars Game #59941302176:  Hold'em No Limit ($0.50/$1.00) - 2009/07/01 1:31:29 ET
Table 'fZjVbKj9D8yOB+Rj7NaP/A' 9-max Seat #9 is the button
Seat 1: 9BZCcac3+McErkkSN2YScA ($103.65 in chips)
Seat 2: PTAFYDIUSsG+SArbxNl+Aw ($105.50 in chips)
Seat 3: yAbu2QsRPVcjPbqlf/jDxw ($100 in chips)
Seat 4: 997ViqAtWn1FPjJqcffwcA ($100 in chips)
Seat 5: PkGfq5xrSlNsujKaG/HF4Q ($100 in chips)
Seat 6: OvwYHV65yUbgdBjSmo1+5g ($130.40 in chips)
Seat 7: SyS20PAm3RpT6uLBsGkwOA ($70.10 in chips)
Seat 9: qheQay5YvP2DMAb3OUSxtw ($100.50 in chips)
9BZCcac3+McErkkSN2YScA: posts small blind $0.50
PTAFYDIUSsG+SArbxNl+Aw: posts big blind $1
*** HOLE CARDS ***
yAbu2QsRPVcjPbqlf/jDxw: folds
997ViqAtWn1FPjJqcffwcA: folds
PkGfq5xrSlNsujKaG/HF4Q: raises $3 to $4
OvwYHV65yUbgdBjSmo1+5g: folds
SyS20PAm3RpT6uLBsGkwOA: folds
qheQay5YvP2DMAb3OUSxtw: folds
9BZCcac3+McErkkSN2YScA: folds
PTAFYDIUSsG+SArbxNl+Aw: folds
PkGfq5xrSlNsujKaG/HF4Q collected $2.50 from pot
PkGfq5xrSlNsujKaG/HF4Q: doesn't show hand
*** SUMMARY ***
Total pot $2.50 | Rake $0
Seat 1: 9BZCcac3+McErkkSN2YScA (small blind) folded before Flop
Seat 2: PTAFYDIUSsG+SArbxNl+Aw (big blind) folded before Flop
Seat 3: yAbu2QsRPVcjPbqlf/jDxw folded before Flop (didn't bet)
Seat 4: 997ViqAtWn1FPjJqcffwcA folded before Flop (didn't bet)
Seat 5: PkGfq5xrSlNsujKaG/HF4Q collected ($2.50)
Seat 6: OvwYHV65yUbgdBjSmo1+5g folded before Flop (didn't bet)
Seat 7: SyS20PAm3RpT6uLBsGkwOA folded before Flop (didn't bet)
Seat 9: qheQay5YvP2DMAb3OUSxtw (button) folded before Flop (didn't bet)



PokerStars Game #59941303086:  Hold'em No Limit ($0.50/$1.00) - 2009/07/01 1:31:31 ET
Table 'QSIig7BLMc9wY/rgBechzw' 6-max Seat #3 is the button
Seat 1: Z2fXsGcjl+Eax+RzOgwOmg ($117.60 in chips)
Seat 2: mLOIkH/qmRa+mVujQIhBRg ($43.40 in chips)
Seat 3: +xW7QemQU0Fxs+4TnqBRow ($108.50 in chips)
Seat 4: +uSzP8Jwnw7sKfQ4s66b7w ($62.95 in chips)
Seat 5: lsLuWlcPA3Rh7kJVLzMh0Q ($103.20 in chips)
Seat 6: PxqfkAMdAWtkgbT+q2gciA ($55.10 in chips)
+uSzP8Jwnw7sKfQ4s66b7w: posts small blind $0.50
lsLuWlcPA3Rh7kJVLzMh0Q: posts big blind $1
*** HOLE CARDS ***
PxqfkAMdAWtkgbT+q2gciA: folds
Z2fXsGcjl+Eax+RzOgwOmg: folds
mLOIkH/qmRa+mVujQIhBRg: calls $1
+xW7QemQU0Fxs+4TnqBRow: raises $4 to $5
+uSzP8Jwnw7sKfQ4s66b7w: calls $4.50
lsLuWlcPA3Rh7kJVLzMh0Q: folds
mLOIkH/qmRa+mVujQIhBRg: calls $4
*** FLOP *** [3h Jh Ts]
+uSzP8Jwnw7sKfQ4s66b7w: checks
mLOIkH/qmRa+mVujQIhBRg: checks
+xW7QemQU0Fxs+4TnqBRow: bets $12
+uSzP8Jwnw7sKfQ4s66b7w: folds
mLOIkH/qmRa+mVujQIhBRg: folds
+xW7QemQU0Fxs+4TnqBRow collected $15.20 from pot
+xW7QemQU0Fxs+4TnqBRow: doesn't show hand
*** SUMMARY ***
Total pot $16 | Rake $0.80
Board [3h Jh Ts]
Seat 1: Z2fXsGcjl+Eax+RzOgwOmg folded before Flop (didn't bet)
Seat 2: mLOIkH/qmRa+mVujQIhBRg folded on the Flop
Seat 3: +xW7QemQU0Fxs+4TnqBRow (button) collected ($15.20)
Seat 4: +uSzP8Jwnw7sKfQ4s66b7w (small blind) folded on the Flop
Seat 5: lsLuWlcPA3Rh7kJVLzMh0Q (big blind) folded before Flop
Seat 6: PxqfkAMdAWtkgbT+q2gciA folded before Flop (didn't bet)



PokerStars Game #59941305048:  Hold'em No Limit ($0.50/$1.00) - 2009/07/01 1:31:34 ET
Table 'cBDNutyLBKEk9+ptwsKmTw' 6-max Seat #6 is the button
Seat 1: xAU6q2/cwmby2sxmA8VcmA ($299.55 in chips)
Seat 2: 4OO5v3AVduL0tePNx8wk5A ($105.05 in chips)
Seat 3: G5ZSSN6RSON3gkNvk/SmYg ($107.40 in chips)
Seat 4: OMkHNxIUZxh1pHqcCjbjgw ($100 in chips)
Seat 5: hpxXcmRkXXI9HE5+5/j/0Q ($106.20 in chips)
Seat 6: QHvTZcrKe6+maWUfVjP29Q ($151.50 in chips)
xAU6q2/cwmby2sxmA8VcmA: posts small blind $0.50
4OO5v3AVduL0tePNx8wk5A: posts big blind $1
*** HOLE CARDS ***
G5ZSSN6RSON3gkNvk/SmYg: folds
OMkHNxIUZxh1pHqcCjbjgw: folds
hpxXcmRkXXI9HE5+5/j/0Q: folds
QHvTZcrKe6+maWUfVjP29Q: raises $2 to $3
xAU6q2/cwmby2sxmA8VcmA: raises $9 to $12
4OO5v3AVduL0tePNx8wk5A: calls $11
QHvTZcrKe6+maWUfVjP29Q: folds
*** FLOP *** [4d Ac 4c]
xAU6q2/cwmby2sxmA8VcmA: checks
4OO5v3AVduL0tePNx8wk5A: checks
*** TURN *** [4d Ac 4c] [8h]
xAU6q2/cwmby2sxmA8VcmA: bets $17
4OO5v3AVduL0tePNx8wk5A: calls $17
*** RIVER *** [4d Ac 4c 8h] [Qc]
xAU6q2/cwmby2sxmA8VcmA: checks
4OO5v3AVduL0tePNx8wk5A: bets $43.50
xAU6q2/cwmby2sxmA8VcmA: folds
4OO5v3AVduL0tePNx8wk5A collected $58.05 from pot
4OO5v3AVduL0tePNx8wk5A: doesn't show hand
*** SUMMARY ***
Total pot $61 | Rake $2.95
Board [4d Ac 4c 8h Qc]
Seat 1: xAU6q2/cwmby2sxmA8VcmA (small blind) folded on the River
Seat 2: 4OO5v3AVduL0tePNx8wk5A (big blind) collected ($58.05)
Seat 3: G5ZSSN6RSON3gkNvk/SmYg folded before Flop (didn't bet)
Seat 4: OMkHNxIUZxh1pHqcCjbjgw folded before Flop (didn't bet)
Seat 5: hpxXcmRkXXI9HE5+5/j/0Q folded before Flop (didn't bet)
Seat 6: QHvTZcrKe6+maWUfVjP29Q (button) folded before Flop



PokerStars Game #59941305884:  Hold'em No Limit ($0.50/$1.00) - 2009/07/01 1:31:36 ET
Table 'tJq9SfN1ywY0r03VBlWlwQ' 9-max Seat #2 is the button
Seat 1: wZsU+w9r7G66x93UuvBf1Q ($299.05 in chips)
Seat 2: VPF+HjszMvUIpy0CHIwH3A ($18.50 in chips)
Seat 4: bLbSOSmSOnqE0iTcH/5dxA ($110.15 in chips)
Seat 5: h5ipsNTMyolp7xn/NAvWkA ($136.90 in chips)
Seat 6: gUUvmqdVlmvpal6B8nYrmg ($100 in chips)
Seat 7: Pp/KTcXkfZKKUHkjyaLTdg ($34.05 in chips)
Seat 8: G4DEhsZFmznGNVpy2SEocA ($42.30 in chips)
Seat 9: XE5QF1y74bpHog9JxWJMWQ ($100 in chips)
bLbSOSmSOnqE0iTcH/5dxA: posts small blind $0.50
h5ipsNTMyolp7xn/NAvWkA: posts big blind $1
*** HOLE CARDS ***
gUUvmqdVlmvpal6B8nYrmg: folds
Pp/KTcXkfZKKUHkjyaLTdg: folds
G4DEhsZFmznGNVpy2SEocA: folds
XE5QF1y74bpHog9JxWJMWQ: folds
wZsU+w9r7G66x93UuvBf1Q: folds
VPF+HjszMvUIpy0CHIwH3A: raises $17.50 to $18.50 and is all-in
bLbSOSmSOnqE0iTcH/5dxA: folds
h5ipsNTMyolp7xn/NAvWkA: folds
VPF+HjszMvUIpy0CHIwH3A collected $2.50 from pot
*** SUMMARY ***
Total pot $2.50 | Rake $0
Seat 1: wZsU+w9r7G66x93UuvBf1Q folded before Flop (didn't bet)
Seat 2: VPF+HjszMvUIpy0CHIwH3A (button) collected ($2.50)
Seat 4: bLbSOSmSOnqE0iTcH/5dxA (small blind) folded before Flop
Seat 5: h5ipsNTMyolp7xn/NAvWkA (big blind) folded before Flop
Seat 6: gUUvmqdVlmvpal6B8nYrmg folded before Flop (didn't bet)
Seat 7: Pp/KTcXkfZKKUHkjyaLTdg folded before Flop (didn't bet)
Seat 8: G4DEhsZFmznGNVpy2SEocA folded before Flop (didn't bet)
Seat 9: XE5QF1y74bpHog9JxWJMWQ folded before Flop (didn't bet)



PokerStars Game #59941307498:  Hold'em No Limit ($0.50/$1.00) - 2009/07/01 1:31:38 ET
Table '/RZcOwpZpHQ+OwPwjsbnRw' 6-max Seat #6 is the button
Seat 1: +uSzP8Jwnw7sKfQ4s66b7w ($39.75 in chips)
Seat 2: Z2fXsGcjl+Eax+RzOgwOmg ($102.65 in chips)
Seat 3: LJMw/I77xpnw0R5T4HnMUg ($102.30 in chips)
Seat 4: j7NIOHLZk7V2o9fOioO5ug ($100 in chips)
Seat 5: wx3sQGkVi2x9wJXuWNHPBw ($167.25 in chips)
Seat 6: o3YLm/rSY916m/on1VjXPA ($206.70 in chips)
+uSzP8Jwnw7sKfQ4s66b7w: posts small blind $0.50
Z2fXsGcjl+Eax+RzOgwOmg: posts big blind $1
*** HOLE CARDS ***
LJMw/I77xpnw0R5T4HnMUg: folds
j7NIOHLZk7V2o9fOioO5ug: raises $2 to $3
wx3sQGkVi2x9wJXuWNHPBw: folds
o3YLm/rSY916m/on1VjXPA: folds
+uSzP8Jwnw7sKfQ4s66b7w: folds
Z2fXsGcjl+Eax+RzOgwOmg: folds
j7NIOHLZk7V2o9fOioO5ug collected $2.50 from pot
j7NIOHLZk7V2o9fOioO5ug: doesn't show hand
*** SUMMARY ***
Total pot $2.50 | Rake $0
Seat 1: +uSzP8Jwnw7sKfQ4s66b7w (small blind) folded before Flop
Seat 2: Z2fXsGcjl+Eax+RzOgwOmg (big blind) folded before Flop
Seat 3: LJMw/I77xpnw0R5T4HnMUg folded before Flop (didn't bet)
Seat 4: j7NIOHLZk7V2o9fOioO5ug collected ($2.50)
Seat 5: wx3sQGkVi2x9wJXuWNHPBw folded before Flop (didn't bet)
Seat 6: o3YLm/rSY916m/on1VjXPA (button) folded before Flop (didn't bet)



PokerStars Game #59941307756:  Hold'em No Limit ($0.50/$1.00) - 2009/07/01 1:31:39 ET
Table 'MUPc8FEpe/nR0BKSeReX6Q' 6-max Seat #4 is the button
Seat 1: qhkK6+yCciTRd+rCFEbnEQ ($79.10 in chips)
Seat 2: xAU6q2/cwmby2sxmA8VcmA ($105.20 in chips)
Seat 3: wx3sQGkVi2x9wJXuWNHPBw ($284 in chips)
Seat 4: r4lpoh2BJZ8S6zyQv1JeSw ($112 in chips)
Seat 5: y27w5IK2WXqmYzS8OU0wKA ($102.05 in chips)
Seat 6: cl/QpVR/PLO58lj+C5mGLw ($36 in chips)
y27w5IK2WXqmYzS8OU0wKA: posts small blind $0.50
cl/QpVR/PLO58lj+C5mGLw: posts big blind $1
*** HOLE CARDS ***
qhkK6+yCciTRd+rCFEbnEQ: raises $1 to $2
xAU6q2/cwmby2sxmA8VcmA: folds
wx3sQGkVi2x9wJXuWNHPBw: folds
r4lpoh2BJZ8S6zyQv1JeSw: folds
y27w5IK2WXqmYzS8OU0wKA: folds
cl/QpVR/PLO58lj+C5mGLw: calls $1
*** FLOP *** [Ks Kd 6h]
cl/QpVR/PLO58lj+C5mGLw: bets $2
qhkK6+yCciTRd+rCFEbnEQ: raises $5 to $7
cl/QpVR/PLO58lj+C5mGLw: calls $5
*** TURN *** [Ks Kd 6h] [2d]
cl/QpVR/PLO58lj+C5mGLw: checks
qhkK6+yCciTRd+rCFEbnEQ: bets $14
cl/QpVR/PLO58lj+C5mGLw: folds
qhkK6+yCciTRd+rCFEbnEQ collected $17.60 from pot
qhkK6+yCciTRd+rCFEbnEQ: doesn't show hand
*** SUMMARY ***
Total pot $18.50 | Rake $0.90
Board [Ks Kd 6h 2d]
Seat 1: qhkK6+yCciTRd+rCFEbnEQ collected ($17.60)
Seat 2: xAU6q2/cwmby2sxmA8VcmA folded before Flop (didn't bet)
Seat 3: wx3sQGkVi2x9wJXuWNHPBw folded before Flop (didn't bet)
Seat 4: r4lpoh2BJZ8S6zyQv1JeSw (button) folded before Flop (didn't bet)
Seat 5: y27w5IK2WXqmYzS8OU0wKA (small blind) folded before Flop
Seat 6: cl/QpVR/PLO58lj+C5mGLw (big blind) folded on the Turn



PokerStars Game #59941308232:  Hold'em No Limit ($0.50/$1.00) - 2009/07/01 1:31:40 ET
Table 'NqGO/cV3MwFAx+ZPB5ANmQ' 2-max Seat #1 is the button
Seat 1: ItaRAnHOgvYOv5ynbG1iTw ($129.70 in chips)
Seat 2: GtFB+yyeb2djMdPFuOW/Xg ($160 in chips)
ItaRAnHOgvYOv5ynbG1iTw: posts small blind $0.50
GtFB+yyeb2djMdPFuOW/Xg: posts big blind $1
*** HOLE CARDS ***
ItaRAnHOgvYOv5ynbG1iTw: raises $2 to $3
GtFB+yyeb2djMdPFuOW/Xg: folds
ItaRAnHOgvYOv5ynbG1iTw collected $2 from pot
*** SUMMARY ***
Total pot $2 | Rake $0
Seat 1: ItaRAnHOgvYOv5ynbG1iTw (button) (small blind) collected ($2)
Seat 2: GtFB+yyeb2djMdPFuOW/Xg (big blind) folded before Flop



PokerStars Game #59941309190:  Hold'em No Limit ($0.50/$1.00) - 2009/07/01 1:31:41 ET
Table 'b8oW/dOL7fDza5DfZ/dOJQ' 6-max Seat #2 is the button
Seat 1: NakujTNjHFgzceydFf+E2Q ($101 in chips)
Seat 2: TSuRyAHnUPCFjP7Z0rEE0w ($121.50 in chips)
Seat 3: d8WX+9nUHoqlrAGagO0Wow ($18 in chips)
Seat 4: X87W8qaGsudJTSkClK2Cig ($21.85 in chips)
Seat 5: r4lpoh2BJZ8S6zyQv1JeSw ($102.50 in chips)
Seat 6: PvfYaKbzMpsmUcbOExckbQ ($100 in chips)
d8WX+9nUHoqlrAGagO0Wow: posts small blind $0.50
X87W8qaGsudJTSkClK2Cig: posts big blind $1
*** HOLE CARDS ***
r4lpoh2BJZ8S6zyQv1JeSw: folds
PvfYaKbzMpsmUcbOExckbQ: raises $2.50 to $3.50
NakujTNjHFgzceydFf+E2Q: folds
TSuRyAHnUPCFjP7Z0rEE0w: folds
d8WX+9nUHoqlrAGagO0Wow: calls $3
X87W8qaGsudJTSkClK2Cig: folds
*** FLOP *** [2s Qd 4c]
d8WX+9nUHoqlrAGagO0Wow: checks
PvfYaKbzMpsmUcbOExckbQ: bets $4
d8WX+9nUHoqlrAGagO0Wow: folds
PvfYaKbzMpsmUcbOExckbQ collected $7.60 from pot
PvfYaKbzMpsmUcbOExckbQ: doesn't show hand
*** SUMMARY ***
Total pot $8 | Rake $0.40
Board [2s Qd 4c]
Seat 1: NakujTNjHFgzceydFf+E2Q folded before Flop (didn't bet)
Seat 2: TSuRyAHnUPCFjP7Z0rEE0w (button) folded before Flop (didn't bet)
Seat 3: d8WX+9nUHoqlrAGagO0Wow (small blind) folded on the Flop
Seat 4: X87W8qaGsudJTSkClK2Cig (big blind) folded before Flop
Seat 5: r4lpoh2BJZ8S6zyQv1JeSw folded before Flop (didn't bet)
Seat 6: PvfYaKbzMpsmUcbOExckbQ collected ($7.60)



PokerStars Game #59941309402:  Hold'em No Limit ($0.50/$1.00) - 2009/07/01 1:31:42 ET
Table 'gxFK0BVUD7cupu2uyRUZJg' 6-max Seat #1 is the button
Seat 1: M+X3uChmP6R63IwijVjgTg ($160.65 in chips)
Seat 2: hpxXcmRkXXI9HE5+5/j/0Q ($133.55 in chips)
Seat 3: Z2fXsGcjl+Eax+RzOgwOmg ($119.50 in chips)
Seat 5: WgIrs6CBinyyw18pqdDtWA ($20.60 in chips)
Seat 6: dYyb6/42PMC8aNFlm/eBeQ ($103.90 in chips)
hpxXcmRkXXI9HE5+5/j/0Q: posts small blind $0.50
Z2fXsGcjl+Eax+RzOgwOmg: posts big blind $1
Hcr4S4Nbkj5idKsvYK/eqQ: sits out
*** HOLE CARDS ***
WgIrs6CBinyyw18pqdDtWA: folds
dYyb6/42PMC8aNFlm/eBeQ: folds
M+X3uChmP6R63IwijVjgTg: calls $1
hpxXcmRkXXI9HE5+5/j/0Q: folds
Z2fXsGcjl+Eax+RzOgwOmg: checks
*** FLOP *** [4c Qc 4h]
Z2fXsGcjl+Eax+RzOgwOmg: checks
M+X3uChmP6R63IwijVjgTg: bets $2
Z2fXsGcjl+Eax+RzOgwOmg: folds
M+X3uChmP6R63IwijVjgTg collected $2.40 from pot
*** SUMMARY ***
Total pot $2.50 | Rake $0.10
Board [4c Qc 4h]
Seat 1: M+X3uChmP6R63IwijVjgTg (button) collected ($2.40)
Seat 2: hpxXcmRkXXI9HE5+5/j/0Q (small blind) folded before Flop
Seat 3: Z2fXsGcjl+Eax+RzOgwOmg (big blind) folded on the Flop
Seat 5: WgIrs6CBinyyw18pqdDtWA folded before Flop (didn't bet)
Seat 6: dYyb6/42PMC8aNFlm/eBeQ folded before Flop (didn't bet)



PokerStars Game #59941310476:  Hold'em No Limit ($0.50/$1.00) - 2009/07/01 1:31:43 ET
Table 'jDQgUn1zGkyftPnHo0Awdw' 2-max Seat #1 is the button
Seat 1: a42+e5QB6s1kkG5FoSTZJw ($101.15 in chips)
Seat 2: q+vRKwm51mnr6kxX/161WQ ($91.50 in chips)
a42+e5QB6s1kkG5FoSTZJw: posts small blind $0.50
q+vRKwm51mnr6kxX/161WQ: posts big blind $1
*** HOLE CARDS ***
a42+e5QB6s1kkG5FoSTZJw: raises $2 to $3
q+vRKwm51mnr6kxX/161WQ: folds
a42+e5QB6s1kkG5FoSTZJw collected $2 from pot
a42+e5QB6s1kkG5FoSTZJw: doesn't show hand
*** SUMMARY ***
Total pot $2 | Rake $0
Seat 1: a42+e5QB6s1kkG5FoSTZJw (button) (small blind) collected ($2)
Seat 2: q+vRKwm51mnr6kxX/161WQ (big blind) folded before Flop



PokerStars Game #59941310522:  Hold'em No Limit ($0.50/$1.00) - 2009/07/01 1:31:44 ET
Table 'vs/5jr6ciwjVQ5+Soc+u2A' 6-max Seat #2 is the button
Seat 1: J798qwLuvXyq0BbzsIjOrA ($164.65 in chips)
Seat 2: lXX4W7m3u++JiSOZ46yVMQ ($102 in chips)
Seat 4: wk6Ohn4GDozoOMHc4eb2rw ($49.80 in chips)
Seat 5: +Nt3OPk3XR9SKjZgm2CexQ ($164.40 in chips)
Seat 6: Z2fXsGcjl+Eax+RzOgwOmg ($104.50 in chips)
wk6Ohn4GDozoOMHc4eb2rw: posts small blind $0.50
+Nt3OPk3XR9SKjZgm2CexQ: posts big blind $1
*** HOLE CARDS ***
Z2fXsGcjl+Eax+RzOgwOmg: folds
J798qwLuvXyq0BbzsIjOrA: folds
lXX4W7m3u++JiSOZ46yVMQ: folds
wk6Ohn4GDozoOMHc4eb2rw: raises $1 to $2
+Nt3OPk3XR9SKjZgm2CexQ: calls $1
*** FLOP *** [9c 9s 2s]
wk6Ohn4GDozoOMHc4eb2rw: checks
+Nt3OPk3XR9SKjZgm2CexQ: bets $2
wk6Ohn4GDozoOMHc4eb2rw: folds
+Nt3OPk3XR9SKjZgm2CexQ collected $3.80 from pot
+Nt3OPk3XR9SKjZgm2CexQ: doesn't show hand
*** SUMMARY ***
Total pot $4 | Rake $0.20
Board [9c 9s 2s]
Seat 1: J798qwLuvXyq0BbzsIjOrA folded before Flop (didn't bet)
Seat 2: lXX4W7m3u++JiSOZ46yVMQ (button) folded before Flop (didn't bet)
Seat 4: wk6Ohn4GDozoOMHc4eb2rw (small blind) folded on the Flop
Seat 5: +Nt3OPk3XR9SKjZgm2CexQ (big blind) collected ($3.80)
Seat 6: Z2fXsGcjl+Eax+RzOgwOmg folded before Flop (didn't bet)



PokerStars Game #59941310962:  Hold'em No Limit ($0.50/$1.00) - 2009/07/01 1:31:44 ET
Table '7O9fB8yx1u7sJveJn8w6jA' 6-max Seat #5 is the button
Seat 2: wx3sQGkVi2x9wJXuWNHPBw ($196.70 in chips)
Seat 3: hpxXcmRkXXI9HE5+5/j/0Q ($138.40 in chips)
Seat 4: b2a+5TkFf4xJN/Ihhma58Q ($35.35 in chips)
Seat 5: BCEV3COoKY607AzLWayfRA ($100 in chips)
Seat 6: r4lpoh2BJZ8S6zyQv1JeSw ($100 in chips)
r4lpoh2BJZ8S6zyQv1JeSw: posts small blind $0.50
wx3sQGkVi2x9wJXuWNHPBw: posts big blind $1
*** HOLE CARDS ***
841740 joins the table at seat #1
hpxXcmRkXXI9HE5+5/j/0Q: folds
b2a+5TkFf4xJN/Ihhma58Q: folds
BCEV3COoKY607AzLWayfRA: raises $3 to $4
r4lpoh2BJZ8S6zyQv1JeSw: folds
wx3sQGkVi2x9wJXuWNHPBw: folds
BCEV3COoKY607AzLWayfRA collected $2.50 from pot
BCEV3COoKY607AzLWayfRA: doesn't show hand
*** SUMMARY ***
Total pot $2.50 | Rake $0
Seat 2: wx3sQGkVi2x9wJXuWNHPBw (big blind) folded before Flop
Seat 3: hpxXcmRkXXI9HE5+5/j/0Q folded before Flop (didn't bet)
Seat 4: b2a+5TkFf4xJN/Ihhma58Q folded before Flop (didn't bet)
Seat 5: BCEV3COoKY607AzLWayfRA (button) collected ($2.50)
Seat 6: r4lpoh2BJZ8S6zyQv1JeSw (small blind) folded before Flop



PokerStars Game #59941311860:  Hold'em No Limit ($0.50/$1.00) - 2009/07/01 1:31:46 ET
Table 'GPp0HyAuggN8oE0sUWzPpA' 9-max Seat #6 is the button
Seat 2: m3U8I35Pn3gxKhoS2nmYIg ($28.95 in chips)
Seat 3: CCCXsirC+bO7ginAuUUVlQ ($53.10 in chips)
Seat 4: mBRWbnUl8diyBO1qTJaNzw ($98.65 in chips)
Seat 5: bLbSOSmSOnqE0iTcH/5dxA ($100 in chips)
Seat 6: BK/GtNPkSx0TdUDj82id5A ($36.25 in chips)
Seat 7: aM6BB+PnB/rDUr2dbRda+A ($100.50 in chips)
Seat 8: P/6qLjycEfxRgZ5F/W90dw ($97.35 in chips)
Seat 9: myIxN7otsyr846M539YR8Q ($21.50 in chips)
aM6BB+PnB/rDUr2dbRda+A: posts small blind $0.50
P/6qLjycEfxRgZ5F/W90dw: posts big blind $1
laA8va+Yv8WuMqT1zdR91g: sits out
*** HOLE CARDS ***
myIxN7otsyr846M539YR8Q: folds
m3U8I35Pn3gxKhoS2nmYIg: folds
CCCXsirC+bO7ginAuUUVlQ: folds
mBRWbnUl8diyBO1qTJaNzw: folds
bLbSOSmSOnqE0iTcH/5dxA: raises $3 to $4
BK/GtNPkSx0TdUDj82id5A: folds
aM6BB+PnB/rDUr2dbRda+A: folds
P/6qLjycEfxRgZ5F/W90dw: folds
bLbSOSmSOnqE0iTcH/5dxA collected $2.50 from pot
*** SUMMARY ***
Total pot $2.50 | Rake $0
Seat 2: m3U8I35Pn3gxKhoS2nmYIg folded before Flop (didn't bet)
Seat 3: CCCXsirC+bO7ginAuUUVlQ folded before Flop (didn't bet)
Seat 4: mBRWbnUl8diyBO1qTJaNzw folded before Flop (didn't bet)
Seat 5: bLbSOSmSOnqE0iTcH/5dxA collected ($2.50)
Seat 6: BK/GtNPkSx0TdUDj82id5A (button) folded before Flop (didn't bet)
Seat 7: aM6BB+PnB/rDUr2dbRda+A (small blind) folded before Flop
Seat 8: P/6qLjycEfxRgZ5F/W90dw (big blind) folded before Flop
Seat 9: myIxN7otsyr846M539YR8Q folded before Flop (didn't bet)



PokerStars Game #59941312336:  Hold'em No Limit ($0.50/$1.00) - 2009/07/01 1:31:47 ET
Table 'pHrhryH8jPNdQfY62f8v+g' 6-max Seat #4 is the button
Seat 1: 4d1rWhpu8DzLmzMbR3QKyA ($144.25 in chips)
Seat 2: JwCcjZl0bjJzG7hmE0dnTA ($117.55 in chips)
Seat 3: 8oS5O7iD/qnFXFXJrGIgNQ ($112.80 in chips)
Seat 4: 1f3beyIML24UqEMTbWy93g ($57.30 in chips)
Seat 5: d8WX+9nUHoqlrAGagO0Wow ($19 in chips)
Seat 6: xAU6q2/cwmby2sxmA8VcmA ($178.25 in chips)
d8WX+9nUHoqlrAGagO0Wow: posts small blind $0.50
xAU6q2/cwmby2sxmA8VcmA: posts big blind $1
*** HOLE CARDS ***
4d1rWhpu8DzLmzMbR3QKyA: folds
JwCcjZl0bjJzG7hmE0dnTA: folds
8oS5O7iD/qnFXFXJrGIgNQ: raises $2.50 to $3.50
1f3beyIML24UqEMTbWy93g: folds
d8WX+9nUHoqlrAGagO0Wow: folds
xAU6q2/cwmby2sxmA8VcmA: folds
8oS5O7iD/qnFXFXJrGIgNQ collected $2.50 from pot
*** SUMMARY ***
Total pot $2.50 | Rake $0
Seat 1: 4d1rWhpu8DzLmzMbR3QKyA folded before Flop (didn't bet)
Seat 2: JwCcjZl0bjJzG7hmE0dnTA folded before Flop (didn't bet)
Seat 3: 8oS5O7iD/qnFXFXJrGIgNQ collected ($2.50)
Seat 4: 1f3beyIML24UqEMTbWy93g (button) folded before Flop (didn't bet)
Seat 5: d8WX+9nUHoqlrAGagO0Wow (small blind) folded before Flop
Seat 6: xAU6q2/cwmby2sxmA8VcmA (big blind) folded before Flop



PokerStars Game #59941312924:  Hold'em No Limit ($0.50/$1.00) - 2009/07/01 1:31:48 ET
Table 'blHlQApStil0OPeQxQxPcw' 9-max Seat #6 is the button
Seat 1: Pp/KTcXkfZKKUHkjyaLTdg ($22.30 in chips)
Seat 2: V138SURkdX8LdVBPKdJJag ($124.35 in chips)
Seat 3: OGgaARGdJQT4awWVNQ957w ($100 in chips)
Seat 4: e3u1tVujx+9fNGL+1+YnaQ ($53.35 in chips)
Seat 5: uXrDE6JrIi8BZK1L8oQ9bQ ($55.10 in chips)
Seat 6: vljeiOoWscAIXU0fCuiEBw ($37.15 in chips)
Seat 8: laA8va+Yv8WuMqT1zdR91g ($100 in chips)
Seat 9: 6XkTu4ahxzHnvjjc1R8YjQ ($100 in chips)
VPF+HjszMvUIpy0CHIwH3A will be allowed to play after the button
laA8va+Yv8WuMqT1zdR91g: posts small blind $0.50
6XkTu4ahxzHnvjjc1R8YjQ: posts big blind $1
*** HOLE CARDS ***
Pp/KTcXkfZKKUHkjyaLTdg: folds
V138SURkdX8LdVBPKdJJag: folds
OGgaARGdJQT4awWVNQ957w: folds
e3u1tVujx+9fNGL+1+YnaQ: calls $1
uXrDE6JrIi8BZK1L8oQ9bQ: folds
vljeiOoWscAIXU0fCuiEBw: calls $1
laA8va+Yv8WuMqT1zdR91g: folds
6XkTu4ahxzHnvjjc1R8YjQ: raises $4 to $5
e3u1tVujx+9fNGL+1+YnaQ: calls $4
vljeiOoWscAIXU0fCuiEBw: calls $4
*** FLOP *** [3s 8s Js]
6XkTu4ahxzHnvjjc1R8YjQ: bets $6
e3u1tVujx+9fNGL+1+YnaQ: calls $6
vljeiOoWscAIXU0fCuiEBw: folds
*** TURN *** [3s 8s Js] [Kh]
6XkTu4ahxzHnvjjc1R8YjQ: bets $18
e3u1tVujx+9fNGL+1+YnaQ: raises $24.35 to $42.35 and is all-in
6XkTu4ahxzHnvjjc1R8YjQ: calls $24.35
*** RIVER *** [3s 8s Js Kh] [Jh]
*** SHOW DOWN ***
6XkTu4ahxzHnvjjc1R8YjQ: shows [Kc Ks] (a full house, Kings full of Jacks)
e3u1tVujx+9fNGL+1+YnaQ: mucks hand
6XkTu4ahxzHnvjjc1R8YjQ collected $109.20 from pot
*** SUMMARY ***
Total pot $112.20 | Rake $3
Board [3s 8s Js Kh Jh]
Seat 1: Pp/KTcXkfZKKUHkjyaLTdg folded before Flop (didn't bet)
Seat 2: V138SURkdX8LdVBPKdJJag folded before Flop (didn't bet)
Seat 3: OGgaARGdJQT4awWVNQ957w folded before Flop (didn't bet)
Seat 4: e3u1tVujx+9fNGL+1+YnaQ mucked
Seat 5: uXrDE6JrIi8BZK1L8oQ9bQ folded before Flop (didn't bet)
Seat 6: vljeiOoWscAIXU0fCuiEBw (button) folded on the Flop
Seat 8: laA8va+Yv8WuMqT1zdR91g (small blind) folded before Flop
Seat 9: 6XkTu4ahxzHnvjjc1R8YjQ (big blind) showed [Kc Ks] and won ($109.20) with a full house, Kings full of Jacks



PokerStars Game #59941312864:  Hold'em No Limit ($0.50/$1.00) - 2009/07/01 1:31:48 ET
Table 'O96CPOtvMBWP6kzuYDfdFA' 6-max Seat #3 is the button
Seat 1: 6alLXQIITA2EZ/lBeym8Dw ($127.75 in chips)
Seat 2: 4d1rWhpu8DzLmzMbR3QKyA ($101.50 in chips)
Seat 3: V89DGjxE171oPREEbAXiyg ($117.75 in chips)
Seat 4: /P4w1pHg2zHYg/4ubJ0dPw ($65.65 in chips)
Seat 6: 3syOXva630dm1FTdwnuLpw ($74.50 in chips)
/P4w1pHg2zHYg/4ubJ0dPw: posts small blind $0.50
G5ZSSN6RSON3gkNvk/SmYg: is sitting out
3syOXva630dm1FTdwnuLpw: posts big blind $1
*** HOLE CARDS ***
6alLXQIITA2EZ/lBeym8Dw: folds
4d1rWhpu8DzLmzMbR3QKyA: raises $2 to $3
V89DGjxE171oPREEbAXiyg: folds
/P4w1pHg2zHYg/4ubJ0dPw: folds
3syOXva630dm1FTdwnuLpw: folds
4d1rWhpu8DzLmzMbR3QKyA collected $2.50 from pot
*** SUMMARY ***
Total pot $2.50 | Rake $0
Seat 1: 6alLXQIITA2EZ/lBeym8Dw folded before Flop (didn't bet)
Seat 2: 4d1rWhpu8DzLmzMbR3QKyA collected ($2.50)
Seat 3: V89DGjxE171oPREEbAXiyg (button) folded before Flop (didn't bet)
Seat 4: /P4w1pHg2zHYg/4ubJ0dPw (small blind) folded before Flop
Seat 6: 3syOXva630dm1FTdwnuLpw (big blind) folded before Flop



PokerStars Game #59941313228:  Hold'em No Limit ($0.50/$1.00) - 2009/07/01 1:31:49 ET
Table 'W/wyObTiXZm+Ckkl3YxcSw' 6-max Seat #6 is the button
Seat 1: eUBBn2R56C1IQ6Cs/vitwg ($296.05 in chips)
Seat 2: oDiBRCaF0QVtd3kO6xZIXw ($162.90 in chips)
Seat 3: dxyNCn/qxfkGDUIf28Cbng ($61.30 in chips)
Seat 4: UBZQqpnJZdTYYY1FTb0rLA ($101.70 in chips)
Seat 5: +OrCjyw70oZhJiD22Mn+bg ($101 in chips)
Seat 6: b2a+5TkFf4xJN/Ihhma58Q ($34.30 in chips)
eUBBn2R56C1IQ6Cs/vitwg: posts small blind $0.50
oDiBRCaF0QVtd3kO6xZIXw: posts big blind $1
*** HOLE CARDS ***
dxyNCn/qxfkGDUIf28Cbng: folds
UBZQqpnJZdTYYY1FTb0rLA: folds
+OrCjyw70oZhJiD22Mn+bg: folds
b2a+5TkFf4xJN/Ihhma58Q: raises $1 to $2
eUBBn2R56C1IQ6Cs/vitwg: folds
oDiBRCaF0QVtd3kO6xZIXw: folds
b2a+5TkFf4xJN/Ihhma58Q collected $2.50 from pot
*** SUMMARY ***
Total pot $2.50 | Rake $0
Seat 1: eUBBn2R56C1IQ6Cs/vitwg (small blind) folded before Flop
Seat 2: oDiBRCaF0QVtd3kO6xZIXw (big blind) folded before Flop
Seat 3: dxyNCn/qxfkGDUIf28Cbng folded before Flop (didn't bet)
Seat 4: UBZQqpnJZdTYYY1FTb0rLA folded before Flop (didn't bet)
Seat 5: +OrCjyw70oZhJiD22Mn+bg folded before Flop (didn't bet)
Seat 6: b2a+5TkFf4xJN/Ihhma58Q (button) collected ($2.50)



PokerStars Game #59941313536:  Hold'em No Limit ($0.50/$1.00) - 2009/07/01 1:31:49 ET
Table 'NqGO/cV3MwFAx+ZPB5ANmQ' 2-max Seat #2 is the button
Seat 1: ItaRAnHOgvYOv5ynbG1iTw ($130.70 in chips)
Seat 2: GtFB+yyeb2djMdPFuOW/Xg ($159 in chips)
GtFB+yyeb2djMdPFuOW/Xg: posts small blind $0.50
ItaRAnHOgvYOv5ynbG1iTw: posts big blind $1
*** HOLE CARDS ***
GtFB+yyeb2djMdPFuOW/Xg: raises $2 to $3
ItaRAnHOgvYOv5ynbG1iTw: calls $2
*** FLOP *** [4s 4d 9h]
ItaRAnHOgvYOv5ynbG1iTw: checks
GtFB+yyeb2djMdPFuOW/Xg: bets $5
ItaRAnHOgvYOv5ynbG1iTw: folds
GtFB+yyeb2djMdPFuOW/Xg collected $5.70 from pot
*** SUMMARY ***
Total pot $6 | Rake $0.30
Board [4s 4d 9h]
Seat 1: ItaRAnHOgvYOv5ynbG1iTw (big blind) folded on the Flop
Seat 2: GtFB+yyeb2djMdPFuOW/Xg (button) (small blind) collected ($5.70)



PokerStars Game #59941313384:  Hold'em No Limit ($0.50/$1.00) - 2009/07/01 1:31:49 ET
Table 'hugOjcwJvzEwZbK7tyiWuQ' 9-max Seat #9 is the button
Seat 1: S3Ex8K7v6xm5jqjRM7Fl3w ($19 in chips)
Seat 2: r27C1nIV4NS4+qbnrgBQSw ($280.10 in chips)
Seat 3: c/6hFCyfLNRn3VFvCeQ1ng ($30.60 in chips)
Seat 4: UWB3oeddt/GObx2Mix2Anw ($178.10 in chips)
Seat 5: AexZ4puUV9meFWwVU6Nv0w ($18 in chips)
Seat 6: gUUvmqdVlmvpal6B8nYrmg ($105.45 in chips)
Seat 7: FL3MrLspcF23LYvC4ipBOA ($111.30 in chips)
Seat 8: /zy+DB4S5fUQUSfZWFzYGw ($118.35 in chips)
Seat 9: W8P9bUKCs43TO1xHm0dL6w ($109.80 in chips)
S3Ex8K7v6xm5jqjRM7Fl3w: posts small blind $0.50
r27C1nIV4NS4+qbnrgBQSw: posts big blind $1
*** HOLE CARDS ***
c/6hFCyfLNRn3VFvCeQ1ng: folds
c/6hFCyfLNRn3VFvCeQ1ng is sitting out
UWB3oeddt/GObx2Mix2Anw: raises $3 to $4
AexZ4puUV9meFWwVU6Nv0w: calls $4
gUUvmqdVlmvpal6B8nYrmg: folds
FL3MrLspcF23LYvC4ipBOA: folds
/zy+DB4S5fUQUSfZWFzYGw: folds
W8P9bUKCs43TO1xHm0dL6w: folds
S3Ex8K7v6xm5jqjRM7Fl3w: folds
r27C1nIV4NS4+qbnrgBQSw: folds
*** FLOP *** [4s Qh 5h]
UWB3oeddt/GObx2Mix2Anw: bets $5
AexZ4puUV9meFWwVU6Nv0w: calls $5
*** TURN *** [4s Qh 5h] [Jd]
UWB3oeddt/GObx2Mix2Anw: checks
AexZ4puUV9meFWwVU6Nv0w: bets $9 and is all-in
UWB3oeddt/GObx2Mix2Anw: calls $9
*** RIVER *** [4s Qh 5h Jd] [Kd]
*** SHOW DOWN ***
UWB3oeddt/GObx2Mix2Anw: shows [8h 8c] (a pair of Eights)
AexZ4puUV9meFWwVU6Nv0w: shows [Ks Jh] (two pair, Kings and Jacks)
AexZ4puUV9meFWwVU6Nv0w collected $35.70 from pot
*** SUMMARY ***
Total pot $37.50 | Rake $1.80
Board [4s Qh 5h Jd Kd]
Seat 1: S3Ex8K7v6xm5jqjRM7Fl3w (small blind) folded before Flop
Seat 2: r27C1nIV4NS4+qbnrgBQSw (big blind) folded before Flop
Seat 3: c/6hFCyfLNRn3VFvCeQ1ng folded before Flop (didn't bet)
Seat 4: UWB3oeddt/GObx2Mix2Anw showed [8h 8c] and lost with a pair of Eights
Seat 5: AexZ4puUV9meFWwVU6Nv0w showed [Ks Jh] and won ($35.70) with two pair, Kings and Jacks
Seat 6: gUUvmqdVlmvpal6B8nYrmg folded before Flop (didn't bet)
Seat 7: FL3MrLspcF23LYvC4ipBOA folded before Flop (didn't bet)
Seat 8: /zy+DB4S5fUQUSfZWFzYGw folded before Flop (didn't bet)
Seat 9: W8P9bUKCs43TO1xHm0dL6w (button) folded before Flop (didn't bet)



PokerStars Game #59941314196:  Hold'em No Limit ($0.50/$1.00) - 2009/07/01 1:31:50 ET
Table 'jDQgUn1zGkyftPnHo0Awdw' 2-max Seat #2 is the button
Seat 1: a42+e5QB6s1kkG5FoSTZJw ($102.15 in chips)
Seat 2: q+vRKwm51mnr6kxX/161WQ ($90.50 in chips)
q+vRKwm51mnr6kxX/161WQ: posts small blind $0.50
a42+e5QB6s1kkG5FoSTZJw: posts big blind $1
*** HOLE CARDS ***
q+vRKwm51mnr6kxX/161WQ: raises $2 to $3
a42+e5QB6s1kkG5FoSTZJw: calls $2
*** FLOP *** [6h 4d 8d]
a42+e5QB6s1kkG5FoSTZJw: checks
q+vRKwm51mnr6kxX/161WQ: bets $4
a42+e5QB6s1kkG5FoSTZJw: raises $7 to $11
q+vRKwm51mnr6kxX/161WQ: raises $76.50 to $87.50 and is all-in
a42+e5QB6s1kkG5FoSTZJw: calls $76.50
*** TURN *** [6h 4d 8d] [9d]
*** RIVER *** [6h 4d 8d 9d] [7h]
*** SHOW DOWN ***
a42+e5QB6s1kkG5FoSTZJw: shows [4s 6s] (two pair, Sixes and Fours)
q+vRKwm51mnr6kxX/161WQ: shows [7d Td] (a flush, Ten high)
q+vRKwm51mnr6kxX/161WQ collected $180.50 from pot
*** SUMMARY ***
Total pot $181 | Rake $0.50
Board [6h 4d 8d 9d 7h]
Seat 1: a42+e5QB6s1kkG5FoSTZJw (big blind) showed [4s 6s] and lost with two pair, Sixes and Fours
Seat 2: q+vRKwm51mnr6kxX/161WQ (button) (small blind) showed [7d Td] and won ($180.50) with a flush, Ten high



PokerStars Game #59941315108:  Hold'em No Limit ($0.50/$1.00) - 2009/07/01 1:31:52 ET
Table '305hiksPPCCdC6V2LNsO5w' 6-max Seat #5 is the button
Seat 1: RTuDLJHh/9zPfBftoc9vsw ($11 in chips)
Seat 2: j7NIOHLZk7V2o9fOioO5ug ($132 in chips)
Seat 3: +zIVjZKLpcidfRHgVZW8lA ($29.70 in chips)
Seat 4: uJVSceLggtsrJya+WtmUEA ($212.05 in chips)
Seat 5: +Nt3OPk3XR9SKjZgm2CexQ ($109.15 in chips)
Seat 6: 9/Tq8dw7kWW68uN8bFupXg ($23.90 in chips)
9/Tq8dw7kWW68uN8bFupXg: posts small blind $0.50
RTuDLJHh/9zPfBftoc9vsw: posts big blind $1
*** HOLE CARDS ***
j7NIOHLZk7V2o9fOioO5ug: folds
+zIVjZKLpcidfRHgVZW8lA: calls $1
uJVSceLggtsrJya+WtmUEA: raises $3 to $4
+Nt3OPk3XR9SKjZgm2CexQ: folds
9/Tq8dw7kWW68uN8bFupXg: folds
RTuDLJHh/9zPfBftoc9vsw: folds
+zIVjZKLpcidfRHgVZW8lA: folds
uJVSceLggtsrJya+WtmUEA collected $3.50 from pot
*** SUMMARY ***
Total pot $3.50 | Rake $0
Seat 1: RTuDLJHh/9zPfBftoc9vsw (big blind) folded before Flop
Seat 2: j7NIOHLZk7V2o9fOioO5ug folded before Flop (didn't bet)
Seat 3: +zIVjZKLpcidfRHgVZW8lA folded before Flop
Seat 4: uJVSceLggtsrJya+WtmUEA collected ($3.50)
Seat 5: +Nt3OPk3XR9SKjZgm2CexQ (button) folded before Flop (didn't bet)
Seat 6: 9/Tq8dw7kWW68uN8bFupXg (small blind) folded before Flop



PokerStars Game #59941315964:  Hold'em No Limit ($0.50/$1.00) - 2009/07/01 1:31:53 ET
Table '7Nl0ffnjeK44/vmeexh3MQ' 9-max Seat #2 is the button
Seat 1: V138SURkdX8LdVBPKdJJag ($101.50 in chips)
Seat 2: OGgaARGdJQT4awWVNQ957w ($100 in chips)
Seat 3: JMmUYT5pIKCKh2pGjCB/4w ($59.40 in chips)
Seat 4: bLbSOSmSOnqE0iTcH/5dxA ($105.30 in chips)
Seat 5: 61sfw5QTu62YYIt68OsdrA ($80 in chips)
Seat 6: FVs16t7GgfWgQWt4JxsObQ ($26.70 in chips)
Seat 7: 997ViqAtWn1FPjJqcffwcA ($100 in chips)
Seat 9: /JHoNdt0fK6X+isrqRfV3w ($20 in chips)
JMmUYT5pIKCKh2pGjCB/4w: posts small blind $0.50
bLbSOSmSOnqE0iTcH/5dxA: posts big blind $1
*** HOLE CARDS ***
61sfw5QTu62YYIt68OsdrA: folds
FVs16t7GgfWgQWt4JxsObQ: calls $1
997ViqAtWn1FPjJqcffwcA: folds
/JHoNdt0fK6X+isrqRfV3w: folds
V138SURkdX8LdVBPKdJJag: folds
OGgaARGdJQT4awWVNQ957w: folds
JMmUYT5pIKCKh2pGjCB/4w: calls $0.50
bLbSOSmSOnqE0iTcH/5dxA: raises $4.50 to $5.50
FVs16t7GgfWgQWt4JxsObQ: folds
JMmUYT5pIKCKh2pGjCB/4w: folds
bLbSOSmSOnqE0iTcH/5dxA collected $3 from pot
bLbSOSmSOnqE0iTcH/5dxA: doesn't show hand
*** SUMMARY ***
Total pot $3 | Rake $0
Seat 1: V138SURkdX8LdVBPKdJJag folded before Flop (didn't bet)
Seat 2: OGgaARGdJQT4awWVNQ957w (button) folded before Flop (didn't bet)
Seat 3: JMmUYT5pIKCKh2pGjCB/4w (small blind) folded before Flop
Seat 4: bLbSOSmSOnqE0iTcH/5dxA (big blind) collected ($3)
Seat 5: 61sfw5QTu62YYIt68OsdrA folded before Flop (didn't bet)
Seat 6: FVs16t7GgfWgQWt4JxsObQ folded before Flop
Seat 7: 997ViqAtWn1FPjJqcffwcA folded before Flop (didn't bet)
Seat 9: /JHoNdt0fK6X+isrqRfV3w folded before Flop (didn't bet)



PokerStars Game #59941319492:  Hold'em No Limit ($0.50/$1.00) - 2009/07/01 1:31:59 ET
Table 'GxCPo/gd3OSthkYrAxJngg' 6-max Seat #3 is the button
Seat 1: sH8BpAFP+jGFxCgVpD1Lew ($227.25 in chips)
Seat 2: YExX2paeIHrmfIwV1ivM/w ($67.60 in chips)
Seat 3: idVgoPAdspFPCzee6aF9Pg ($130 in chips)
Seat 4: YMJG+F++3Aj6P8dAWda5fw ($208.85 in chips)
Seat 6: 4d1rWhpu8DzLmzMbR3QKyA ($100 in chips)
YMJG+F++3Aj6P8dAWda5fw: posts small blind $0.50
G5ZSSN6RSON3gkNvk/SmYg: is sitting out
4d1rWhpu8DzLmzMbR3QKyA: posts big blind $1
*** HOLE CARDS ***
sH8BpAFP+jGFxCgVpD1Lew: folds
YExX2paeIHrmfIwV1ivM/w: folds
idVgoPAdspFPCzee6aF9Pg: raises $2 to $3
YMJG+F++3Aj6P8dAWda5fw: folds
4d1rWhpu8DzLmzMbR3QKyA: folds
idVgoPAdspFPCzee6aF9Pg collected $2.50 from pot
*** SUMMARY ***
Total pot $2.50 | Rake $0
Seat 1: sH8BpAFP+jGFxCgVpD1Lew folded before Flop (didn't bet)
Seat 2: YExX2paeIHrmfIwV1ivM/w folded before Flop (didn't bet)
Seat 3: idVgoPAdspFPCzee6aF9Pg (button) collected ($2.50)
Seat 4: YMJG+F++3Aj6P8dAWda5fw (small blind) folded before Flop
Seat 6: 4d1rWhpu8DzLmzMbR3QKyA (big blind) folded before Flop



PokerStars Game #59941320214:  Hold'em No Limit ($0.50/$1.00) - 2009/07/01 1:32:00 ET
Table 'mmbQQVBTrPdE+wy+s+9VPA' 6-max Seat #3 is the button
Seat 1: zyP4SPoWZnKUfTvIRLCVog ($75.65 in chips)
Seat 2: XK4Qsl+DA8gAJyg85/zBIw ($31.60 in chips)
Seat 3: wx3sQGkVi2x9wJXuWNHPBw ($124.85 in chips)
Seat 4: V3iZdcw61nXF3g5hD2RrsQ ($105.55 in chips)
Seat 5: YMJG+F++3Aj6P8dAWda5fw ($120.90 in chips)
Seat 6: U2CWBTv29qdCbj8RNF2sIw ($119.20 in chips)
V3iZdcw61nXF3g5hD2RrsQ: posts small blind $0.50
YMJG+F++3Aj6P8dAWda5fw: posts big blind $1
*** HOLE CARDS ***
U2CWBTv29qdCbj8RNF2sIw: raises $2 to $3
zyP4SPoWZnKUfTvIRLCVog: folds
XK4Qsl+DA8gAJyg85/zBIw: calls $3
wx3sQGkVi2x9wJXuWNHPBw: folds
V3iZdcw61nXF3g5hD2RrsQ: folds
YMJG+F++3Aj6P8dAWda5fw: folds
*** FLOP *** [Ks Kd Th]
U2CWBTv29qdCbj8RNF2sIw: checks
XK4Qsl+DA8gAJyg85/zBIw: checks
*** TURN *** [Ks Kd Th] [6c]
U2CWBTv29qdCbj8RNF2sIw: checks
XK4Qsl+DA8gAJyg85/zBIw: checks
*** RIVER *** [Ks Kd Th 6c] [Js]
U2CWBTv29qdCbj8RNF2sIw: bets $2
XK4Qsl+DA8gAJyg85/zBIw: calls $2
*** SHOW DOWN ***
U2CWBTv29qdCbj8RNF2sIw: shows [Qc Qh] (two pair, Kings and Queens)
XK4Qsl+DA8gAJyg85/zBIw: mucks hand
U2CWBTv29qdCbj8RNF2sIw collected $10.95 from pot
*** SUMMARY ***
Total pot $11.50 | Rake $0.55
Board [Ks Kd Th 6c Js]
Seat 1: zyP4SPoWZnKUfTvIRLCVog folded before Flop (didn't bet)
Seat 2: XK4Qsl+DA8gAJyg85/zBIw mucked
Seat 3: wx3sQGkVi2x9wJXuWNHPBw (button) folded before Flop (didn't bet)
Seat 4: V3iZdcw61nXF3g5hD2RrsQ (small blind) folded before Flop
Seat 5: YMJG+F++3Aj6P8dAWda5fw (big blind) folded before Flop
Seat 6: U2CWBTv29qdCbj8RNF2sIw showed [Qc Qh] and won ($10.95) with two pair, Kings and Queens



PokerStars Game #59941322358:  Hold'em No Limit ($0.50/$1.00) - 2009/07/01 1:32:04 ET
Table '/RZcOwpZpHQ+OwPwjsbnRw' 6-max Seat #1 is the button
Seat 1: +uSzP8Jwnw7sKfQ4s66b7w ($39.25 in chips)
Seat 2: Z2fXsGcjl+Eax+RzOgwOmg ($101.65 in chips)
Seat 3: LJMw/I77xpnw0R5T4HnMUg ($102.30 in chips)
Seat 4: j7NIOHLZk7V2o9fOioO5ug ($101.50 in chips)
Seat 5: wx3sQGkVi2x9wJXuWNHPBw ($167.25 in chips)
Seat 6: o3YLm/rSY916m/on1VjXPA ($206.70 in chips)
Z2fXsGcjl+Eax+RzOgwOmg: posts small blind $0.50
LJMw/I77xpnw0R5T4HnMUg: posts big blind $1
*** HOLE CARDS ***
j7NIOHLZk7V2o9fOioO5ug: folds
wx3sQGkVi2x9wJXuWNHPBw: folds
o3YLm/rSY916m/on1VjXPA: folds
+uSzP8Jwnw7sKfQ4s66b7w: folds
Z2fXsGcjl+Eax+RzOgwOmg: folds
LJMw/I77xpnw0R5T4HnMUg collected $1 from pot
LJMw/I77xpnw0R5T4HnMUg: doesn't show hand
*** SUMMARY ***
Total pot $1 | Rake $0
Seat 1: +uSzP8Jwnw7sKfQ4s66b7w (button) folded before Flop (didn't bet)
Seat 2: Z2fXsGcjl+Eax+RzOgwOmg (small blind) folded before Flop
Seat 3: LJMw/I77xpnw0R5T4HnMUg (big blind) collected ($1)
Seat 4: j7NIOHLZk7V2o9fOioO5ug folded before Flop (didn't bet)
Seat 5: wx3sQGkVi2x9wJXuWNHPBw folded before Flop (didn't bet)
Seat 6: o3YLm/rSY916m/on1VjXPA folded before Flop (didn't bet)



PokerStars Game #59941322188:  Hold'em No Limit ($0.50/$1.00) - 2009/07/01 1:32:04 ET
Table '7O9fB8yx1u7sJveJn8w6jA' 6-max Seat #6 is the button
Seat 2: wx3sQGkVi2x9wJXuWNHPBw ($195.70 in chips)
Seat 3: hpxXcmRkXXI9HE5+5/j/0Q ($138.40 in chips)
Seat 4: b2a+5TkFf4xJN/Ihhma58Q ($35.35 in chips)
Seat 5: BCEV3COoKY607AzLWayfRA ($101.50 in chips)
Seat 6: r4lpoh2BJZ8S6zyQv1JeSw ($100 in chips)
841740 will be allowed to play after the button
wx3sQGkVi2x9wJXuWNHPBw: posts small blind $0.50
hpxXcmRkXXI9HE5+5/j/0Q: posts big blind $1
*** HOLE CARDS ***
b2a+5TkFf4xJN/Ihhma58Q: folds
BCEV3COoKY607AzLWayfRA: folds
r4lpoh2BJZ8S6zyQv1JeSw: folds
wx3sQGkVi2x9wJXuWNHPBw: folds
hpxXcmRkXXI9HE5+5/j/0Q collected $1 from pot
hpxXcmRkXXI9HE5+5/j/0Q: doesn't show hand
*** SUMMARY ***
Total pot $1 | Rake $0
Seat 2: wx3sQGkVi2x9wJXuWNHPBw (small blind) folded before Flop
Seat 3: hpxXcmRkXXI9HE5+5/j/0Q (big blind) collected ($1)
Seat 4: b2a+5TkFf4xJN/Ihhma58Q folded before Flop (didn't bet)
Seat 5: BCEV3COoKY607AzLWayfRA folded before Flop (didn't bet)
Seat 6: r4lpoh2BJZ8S6zyQv1JeSw (button) folded before Flop (didn't bet)



PokerStars Game #59941322650:  Hold'em No Limit ($0.50/$1.00) - 2009/07/01 1:32:05 ET
Table '/FUb199IViHMJHi5YWmeuQ' 9-max Seat #1 is the button
Seat 1: 3obndzTJ6fECz8+wWhMd1w ($16.50 in chips)
Seat 2: FL3MrLspcF23LYvC4ipBOA ($184.55 in chips)
Seat 3: V138SURkdX8LdVBPKdJJag ($118.25 in chips)
Seat 4: pbAfmxe4uSZPxJQX7gOzZA ($69.15 in chips)
Seat 5: H+DVy3Ei8L1UKS2tVOtJcw ($136.85 in chips)
Seat 6: VPF+HjszMvUIpy0CHIwH3A ($21.50 in chips)
Seat 7: myIxN7otsyr846M539YR8Q ($27 in chips)
Seat 8: 997ViqAtWn1FPjJqcffwcA ($101 in chips)
Seat 9: RfLbneGRY8yQUpMgDnJCxA ($75.20 in chips)
FL3MrLspcF23LYvC4ipBOA: posts small blind $0.50
V138SURkdX8LdVBPKdJJag: posts big blind $1
*** HOLE CARDS ***
pbAfmxe4uSZPxJQX7gOzZA: calls $1
H+DVy3Ei8L1UKS2tVOtJcw: raises $4 to $5
VPF+HjszMvUIpy0CHIwH3A: folds
myIxN7otsyr846M539YR8Q: folds
997ViqAtWn1FPjJqcffwcA: folds
RfLbneGRY8yQUpMgDnJCxA: folds
3obndzTJ6fECz8+wWhMd1w: folds
FL3MrLspcF23LYvC4ipBOA: folds
V138SURkdX8LdVBPKdJJag: folds
pbAfmxe4uSZPxJQX7gOzZA: folds
H+DVy3Ei8L1UKS2tVOtJcw collected $3.50 from pot
H+DVy3Ei8L1UKS2tVOtJcw: doesn't show hand
*** SUMMARY ***
Total pot $3.50 | Rake $0
Seat 1: 3obndzTJ6fECz8+wWhMd1w (button) folded before Flop (didn't bet)
Seat 2: FL3MrLspcF23LYvC4ipBOA (small blind) folded before Flop
Seat 3: V138SURkdX8LdVBPKdJJag (big blind) folded before Flop
Seat 4: pbAfmxe4uSZPxJQX7gOzZA folded before Flop
Seat 5: H+DVy3Ei8L1UKS2tVOtJcw collected ($3.50)
Seat 6: VPF+HjszMvUIpy0CHIwH3A folded before Flop (didn't bet)
Seat 7: myIxN7otsyr846M539YR8Q folded before Flop (didn't bet)
Seat 8: 997ViqAtWn1FPjJqcffwcA folded before Flop (didn't bet)
Seat 9: RfLbneGRY8yQUpMgDnJCxA folded before Flop (didn't bet)



PokerStars Game #59941324430:  Hold'em No Limit ($0.50/$1.00) - 2009/07/01 1:32:08 ET
Table 'b8oW/dOL7fDza5DfZ/dOJQ' 6-max Seat #3 is the button
Seat 1: NakujTNjHFgzceydFf+E2Q ($101 in chips)
Seat 2: TSuRyAHnUPCFjP7Z0rEE0w ($121.50 in chips)
Seat 3: d8WX+9nUHoqlrAGagO0Wow ($14.50 in chips)
Seat 4: X87W8qaGsudJTSkClK2Cig ($20.85 in chips)
Seat 5: r4lpoh2BJZ8S6zyQv1JeSw ($102.50 in chips)
Seat 6: PvfYaKbzMpsmUcbOExckbQ ($104.10 in chips)
X87W8qaGsudJTSkClK2Cig: posts small blind $0.50
r4lpoh2BJZ8S6zyQv1JeSw: posts big blind $1
*** HOLE CARDS ***
PvfYaKbzMpsmUcbOExckbQ: folds
NakujTNjHFgzceydFf+E2Q: folds
TSuRyAHnUPCFjP7Z0rEE0w: folds
d8WX+9nUHoqlrAGagO0Wow: folds
X87W8qaGsudJTSkClK2Cig: folds
r4lpoh2BJZ8S6zyQv1JeSw collected $1 from pot
r4lpoh2BJZ8S6zyQv1JeSw: doesn't show hand
*** SUMMARY ***
Total pot $1 | Rake $0
Seat 1: NakujTNjHFgzceydFf+E2Q folded before Flop (didn't bet)
Seat 2: TSuRyAHnUPCFjP7Z0rEE0w folded before Flop (didn't bet)
Seat 3: d8WX+9nUHoqlrAGagO0Wow (button) folded before Flop (didn't bet)
Seat 4: X87W8qaGsudJTSkClK2Cig (small blind) folded before Flop
Seat 5: r4lpoh2BJZ8S6zyQv1JeSw (big blind) collected ($1)
Seat 6: PvfYaKbzMpsmUcbOExckbQ folded before Flop (didn't bet)



PokerStars Game #59941324706:  Hold'em No Limit ($0.50/$1.00) - 2009/07/01 1:32:08 ET
Table 'tJq9SfN1ywY0r03VBlWlwQ' 9-max Seat #4 is the button
Seat 1: wZsU+w9r7G66x93UuvBf1Q ($299.05 in chips)
Seat 2: VPF+HjszMvUIpy0CHIwH3A ($20 in chips)
Seat 4: bLbSOSmSOnqE0iTcH/5dxA ($109.65 in chips)
Seat 5: h5ipsNTMyolp7xn/NAvWkA ($135.90 in chips)
Seat 6: gUUvmqdVlmvpal6B8nYrmg ($100 in chips)
Seat 7: Pp/KTcXkfZKKUHkjyaLTdg ($34.05 in chips)
Seat 8: G4DEhsZFmznGNVpy2SEocA ($42.30 in chips)
Seat 9: XE5QF1y74bpHog9JxWJMWQ ($100 in chips)
h5ipsNTMyolp7xn/NAvWkA: posts small blind $0.50
gUUvmqdVlmvpal6B8nYrmg: posts big blind $1
*** HOLE CARDS ***
Pp/KTcXkfZKKUHkjyaLTdg: folds
Pp/KTcXkfZKKUHkjyaLTdg leaves the table
G4DEhsZFmznGNVpy2SEocA: folds
XE5QF1y74bpHog9JxWJMWQ: folds
wZsU+w9r7G66x93UuvBf1Q: folds
VPF+HjszMvUIpy0CHIwH3A: folds
bLbSOSmSOnqE0iTcH/5dxA: raises $3 to $4
h5ipsNTMyolp7xn/NAvWkA: calls $3.50
gUUvmqdVlmvpal6B8nYrmg: folds
*** FLOP *** [2s 3s 4h]
Ogn4JDV3mp4ZDKO49IFzKA joins the table at seat #7
h5ipsNTMyolp7xn/NAvWkA: checks
bLbSOSmSOnqE0iTcH/5dxA: bets $6
h5ipsNTMyolp7xn/NAvWkA: folds
bLbSOSmSOnqE0iTcH/5dxA collected $8.55 from pot
*** SUMMARY ***
Total pot $9 | Rake $0.45
Board [2s 3s 4h]
Seat 1: wZsU+w9r7G66x93UuvBf1Q folded before Flop (didn't bet)
Seat 2: VPF+HjszMvUIpy0CHIwH3A folded before Flop (didn't bet)
Seat 4: bLbSOSmSOnqE0iTcH/5dxA (button) collected ($8.55)
Seat 5: h5ipsNTMyolp7xn/NAvWkA (small blind) folded on the Flop
Seat 6: gUUvmqdVlmvpal6B8nYrmg (big blind) folded before Flop
Seat 7: Pp/KTcXkfZKKUHkjyaLTdg folded before Flop (didn't bet)
Seat 8: G4DEhsZFmznGNVpy2SEocA folded before Flop (didn't bet)
Seat 9: XE5QF1y74bpHog9JxWJMWQ folded before Flop (didn't bet)



PokerStars Game #59941325202:  Hold'em No Limit ($0.50/$1.00) - 2009/07/01 1:32:09 ET
Table 'N2bNCDHL96aCQDvZIh+yQQ' 6-max Seat #2 is the button
Seat 1: Jjgflx10PVjcLkziEmLhSA ($39.10 in chips)
Seat 2: y27w5IK2WXqmYzS8OU0wKA ($116.55 in chips)
Seat 3: UBZQqpnJZdTYYY1FTb0rLA ($121.05 in chips)
Seat 4: uCqEjnxh2/vFBjKYkfTOkw ($228.10 in chips)
Seat 5: frvgHLr3+LfZtjsBCBs3NA ($24.10 in chips)
Seat 6: idVgoPAdspFPCzee6aF9Pg ($100 in chips)
UBZQqpnJZdTYYY1FTb0rLA: posts small blind $0.50
uCqEjnxh2/vFBjKYkfTOkw: posts big blind $1
*** HOLE CARDS ***
frvgHLr3+LfZtjsBCBs3NA: folds
idVgoPAdspFPCzee6aF9Pg: folds
Jjgflx10PVjcLkziEmLhSA: raises $2 to $3
y27w5IK2WXqmYzS8OU0wKA: folds
UBZQqpnJZdTYYY1FTb0rLA: folds
uCqEjnxh2/vFBjKYkfTOkw: raises $5 to $8
Jjgflx10PVjcLkziEmLhSA: calls $5
*** FLOP *** [Ts 7c Jh]
uCqEjnxh2/vFBjKYkfTOkw: bets $15
Jjgflx10PVjcLkziEmLhSA: raises $16.10 to $31.10 and is all-in
uCqEjnxh2/vFBjKYkfTOkw: calls $16.10
*** TURN *** [Ts 7c Jh] [7h]
*** RIVER *** [Ts 7c Jh 7h] [Td]
*** SHOW DOWN ***
uCqEjnxh2/vFBjKYkfTOkw: shows [Ah Kd] (two pair, Tens and Sevens)
Jjgflx10PVjcLkziEmLhSA: shows [Qh Qc] (two pair, Queens and Tens)
Jjgflx10PVjcLkziEmLhSA collected $75.70 from pot
*** SUMMARY ***
Total pot $78.70 | Rake $3
Board [Ts 7c Jh 7h Td]
Seat 1: Jjgflx10PVjcLkziEmLhSA showed [Qh Qc] and won ($75.70) with two pair, Queens and Tens
Seat 2: y27w5IK2WXqmYzS8OU0wKA (button) folded before Flop (didn't bet)
Seat 3: UBZQqpnJZdTYYY1FTb0rLA (small blind) folded before Flop
Seat 4: uCqEjnxh2/vFBjKYkfTOkw (big blind) showed [Ah Kd] and lost with two pair, Tens and Sevens
Seat 5: frvgHLr3+LfZtjsBCBs3NA folded before Flop (didn't bet)
Seat 6: idVgoPAdspFPCzee6aF9Pg folded before Flop (didn't bet)



PokerStars Game #59941325994:  Hold'em No Limit ($0.50/$1.00) - 2009/07/01 1:32:11 ET
Table 'jDQgUn1zGkyftPnHo0Awdw' 2-max Seat #1 is the button
Seat 1: a42+e5QB6s1kkG5FoSTZJw ($11.65 in chips)
Seat 2: q+vRKwm51mnr6kxX/161WQ ($180.50 in chips)
a42+e5QB6s1kkG5FoSTZJw: posts small blind $0.50
q+vRKwm51mnr6kxX/161WQ: posts big blind $1
*** HOLE CARDS ***
a42+e5QB6s1kkG5FoSTZJw: raises $3 to $4
q+vRKwm51mnr6kxX/161WQ: folds
a42+e5QB6s1kkG5FoSTZJw collected $2 from pot
a42+e5QB6s1kkG5FoSTZJw: doesn't show hand
*** SUMMARY ***
Total pot $2 | Rake $0
Seat 1: a42+e5QB6s1kkG5FoSTZJw (button) (small blind) collected ($2)
Seat 2: q+vRKwm51mnr6kxX/161WQ (big blind) folded before Flop



PokerStars Game #59941326296:  Hold'em No Limit ($0.50/$1.00) - 2009/07/01 1:32:11 ET
Table 'O96CPOtvMBWP6kzuYDfdFA' 6-max Seat #4 is the button
Seat 1: 6alLXQIITA2EZ/lBeym8Dw ($127.75 in chips)
Seat 2: 4d1rWhpu8DzLmzMbR3QKyA ($103 in chips)
Seat 3: V89DGjxE171oPREEbAXiyg ($117.75 in chips)
Seat 4: /P4w1pHg2zHYg/4ubJ0dPw ($65.15 in chips)
Seat 6: 3syOXva630dm1FTdwnuLpw ($73.50 in chips)
3syOXva630dm1FTdwnuLpw: posts small blind $0.50
6alLXQIITA2EZ/lBeym8Dw: posts big blind $1
*** HOLE CARDS ***
4d1rWhpu8DzLmzMbR3QKyA: folds
V89DGjxE171oPREEbAXiyg: folds
/P4w1pHg2zHYg/4ubJ0dPw: raises $2 to $3
3syOXva630dm1FTdwnuLpw: folds
6alLXQIITA2EZ/lBeym8Dw: folds
/P4w1pHg2zHYg/4ubJ0dPw collected $2.50 from pot
*** SUMMARY ***
Total pot $2.50 | Rake $0
Seat 1: 6alLXQIITA2EZ/lBeym8Dw (big blind) folded before Flop
Seat 2: 4d1rWhpu8DzLmzMbR3QKyA folded before Flop (didn't bet)
Seat 3: V89DGjxE171oPREEbAXiyg folded before Flop (didn't bet)
Seat 4: /P4w1pHg2zHYg/4ubJ0dPw (button) collected ($2.50)
Seat 6: 3syOXva630dm1FTdwnuLpw (small blind) folded before Flop



PokerStars Game #59941327508:  Hold'em No Limit ($0.50/$1.00) - 2009/07/01 1:32:13 ET
Table 'vs/5jr6ciwjVQ5+Soc+u2A' 6-max Seat #4 is the button
Seat 1: J798qwLuvXyq0BbzsIjOrA ($164.65 in chips)
Seat 2: lXX4W7m3u++JiSOZ46yVMQ ($102 in chips)
Seat 4: wk6Ohn4GDozoOMHc4eb2rw ($47.80 in chips)
Seat 5: +Nt3OPk3XR9SKjZgm2CexQ ($166.20 in chips)
Seat 6: Z2fXsGcjl+Eax+RzOgwOmg ($104.50 in chips)
+Nt3OPk3XR9SKjZgm2CexQ: posts small blind $0.50
Z2fXsGcjl+Eax+RzOgwOmg: posts big blind $1
*** HOLE CARDS ***
J798qwLuvXyq0BbzsIjOrA: calls $1
lXX4W7m3u++JiSOZ46yVMQ: raises $2 to $3
wk6Ohn4GDozoOMHc4eb2rw: folds
wk6Ohn4GDozoOMHc4eb2rw leaves the table
+Nt3OPk3XR9SKjZgm2CexQ: folds
Z2fXsGcjl+Eax+RzOgwOmg: folds
J798qwLuvXyq0BbzsIjOrA: calls $2
*** FLOP *** [6d 6s Td]
J798qwLuvXyq0BbzsIjOrA: checks
lXX4W7m3u++JiSOZ46yVMQ: bets $4
J798qwLuvXyq0BbzsIjOrA: raises $4 to $8
lXX4W7m3u++JiSOZ46yVMQ: calls $4
*** TURN *** [6d 6s Td] [Ks]
J798qwLuvXyq0BbzsIjOrA: checks
0smcry9L0OOTCP+KzIS5SA joins the table at seat #4
G5ZSSN6RSON3gkNvk/SmYg leaves the table
lXX4W7m3u++JiSOZ46yVMQ: checks
*** RIVER *** [6d 6s Td Ks] [9s]
J798qwLuvXyq0BbzsIjOrA: bets $17
lXX4W7m3u++JiSOZ46yVMQ: folds
J798qwLuvXyq0BbzsIjOrA collected $22.35 from pot
J798qwLuvXyq0BbzsIjOrA: doesn't show hand
*** SUMMARY ***
Total pot $23.50 | Rake $1.15
Board [6d 6s Td Ks 9s]
Seat 1: J798qwLuvXyq0BbzsIjOrA collected ($22.35)
Seat 2: lXX4W7m3u++JiSOZ46yVMQ folded on the River
Seat 4: wk6Ohn4GDozoOMHc4eb2rw (button) folded before Flop (didn't bet)
Seat 5: +Nt3OPk3XR9SKjZgm2CexQ (small blind) folded before Flop
Seat 6: Z2fXsGcjl+Eax+RzOgwOmg (big blind) folded before Flop



PokerStars Game #59941327738:  Hold'em No Limit ($0.50/$1.00) - 2009/07/01 1:32:14 ET
Table 'CASNP0uy1C+jGLml/I4PtA' 9-max Seat #5 is the button
Seat 1: tkdBeXTJlFsZdioidNqLow ($73.60 in chips)
Seat 2: LUsAYklr0mQkiq7ASOyD9A ($65.55 in chips)
Seat 4: B/G0GJacqZ8K59/ZVdq4kQ ($52.55 in chips)
Seat 5: Jjc7EHWzs4//xUAjJ0UWoA ($9 in chips)
Seat 6: FJEywSpo5JbRKByzmweboA ($100 in chips)
Seat 7: S3Ex8K7v6xm5jqjRM7Fl3w ($22 in chips)
Seat 8: L9njYvloJ1NdXjP8edHEAg ($104.45 in chips)
Seat 9: Pp/KTcXkfZKKUHkjyaLTdg ($24.10 in chips)
FJEywSpo5JbRKByzmweboA: posts small blind $0.50
S3Ex8K7v6xm5jqjRM7Fl3w: posts big blind $1
*** HOLE CARDS ***
L9njYvloJ1NdXjP8edHEAg: folds
Pp/KTcXkfZKKUHkjyaLTdg: folds
tkdBeXTJlFsZdioidNqLow: folds
LUsAYklr0mQkiq7ASOyD9A: folds
B/G0GJacqZ8K59/ZVdq4kQ: folds
Jjc7EHWzs4//xUAjJ0UWoA: raises $2 to $3
FJEywSpo5JbRKByzmweboA: folds
S3Ex8K7v6xm5jqjRM7Fl3w: folds
Jjc7EHWzs4//xUAjJ0UWoA collected $2.50 from pot
*** SUMMARY ***
Total pot $2.50 | Rake $0
Seat 1: tkdBeXTJlFsZdioidNqLow folded before Flop (didn't bet)
Seat 2: LUsAYklr0mQkiq7ASOyD9A folded before Flop (didn't bet)
Seat 4: B/G0GJacqZ8K59/ZVdq4kQ folded before Flop (didn't bet)
Seat 5: Jjc7EHWzs4//xUAjJ0UWoA (button) collected ($2.50)
Seat 6: FJEywSpo5JbRKByzmweboA (small blind) folded before Flop
Seat 7: S3Ex8K7v6xm5jqjRM7Fl3w (big blind) folded before Flop
Seat 8: L9njYvloJ1NdXjP8edHEAg folded before Flop (didn't bet)
Seat 9: Pp/KTcXkfZKKUHkjyaLTdg folded before Flop (didn't bet)



PokerStars Game #59941327866:  Hold'em No Limit ($0.50/$1.00) - 2009/07/01 1:32:14 ET
Table 'pHrhryH8jPNdQfY62f8v+g' 6-max Seat #5 is the button
Seat 1: 4d1rWhpu8DzLmzMbR3QKyA ($144.25 in chips)
Seat 2: JwCcjZl0bjJzG7hmE0dnTA ($117.55 in chips)
Seat 3: 8oS5O7iD/qnFXFXJrGIgNQ ($114.30 in chips)
Seat 4: 1f3beyIML24UqEMTbWy93g ($57.30 in chips)
Seat 5: d8WX+9nUHoqlrAGagO0Wow ($18.50 in chips)
Seat 6: xAU6q2/cwmby2sxmA8VcmA ($177.25 in chips)
xAU6q2/cwmby2sxmA8VcmA: posts small blind $0.50
4d1rWhpu8DzLmzMbR3QKyA: posts big blind $1
*** HOLE CARDS ***
JwCcjZl0bjJzG7hmE0dnTA: folds
8oS5O7iD/qnFXFXJrGIgNQ: folds
1f3beyIML24UqEMTbWy93g: raises $2 to $3
d8WX+9nUHoqlrAGagO0Wow: folds
xAU6q2/cwmby2sxmA8VcmA: folds
4d1rWhpu8DzLmzMbR3QKyA: folds
1f3beyIML24UqEMTbWy93g collected $2.50 from pot
*** SUMMARY ***
Total pot $2.50 | Rake $0
Seat 1: 4d1rWhpu8DzLmzMbR3QKyA (big blind) folded before Flop
Seat 2: JwCcjZl0bjJzG7hmE0dnTA folded before Flop (didn't bet)
Seat 3: 8oS5O7iD/qnFXFXJrGIgNQ folded before Flop (didn't bet)
Seat 4: 1f3beyIML24UqEMTbWy93g collected ($2.50)
Seat 5: d8WX+9nUHoqlrAGagO0Wow (button) folded before Flop (didn't bet)
Seat 6: xAU6q2/cwmby2sxmA8VcmA (small blind) folded before Flop



PokerStars Game #59941329314:  Hold'em No Limit ($0.50/$1.00) - 2009/07/01 1:32:16 ET
Table 'W/wyObTiXZm+Ckkl3YxcSw' 6-max Seat #1 is the button
Seat 1: eUBBn2R56C1IQ6Cs/vitwg ($295.55 in chips)
Seat 2: oDiBRCaF0QVtd3kO6xZIXw ($161.90 in chips)
Seat 3: dxyNCn/qxfkGDUIf28Cbng ($61.30 in chips)
Seat 4: UBZQqpnJZdTYYY1FTb0rLA ($101.70 in chips)
Seat 5: +OrCjyw70oZhJiD22Mn+bg ($101 in chips)
Seat 6: b2a+5TkFf4xJN/Ihhma58Q ($35.80 in chips)
oDiBRCaF0QVtd3kO6xZIXw: posts small blind $0.50
dxyNCn/qxfkGDUIf28Cbng: posts big blind $1
*** HOLE CARDS ***
UBZQqpnJZdTYYY1FTb0rLA: raises $2 to $3
+OrCjyw70oZhJiD22Mn+bg: folds
b2a+5TkFf4xJN/Ihhma58Q: folds
eUBBn2R56C1IQ6Cs/vitwg: folds
oDiBRCaF0QVtd3kO6xZIXw: folds
dxyNCn/qxfkGDUIf28Cbng: folds
UBZQqpnJZdTYYY1FTb0rLA collected $2.50 from pot
UBZQqpnJZdTYYY1FTb0rLA: doesn't show hand
*** SUMMARY ***
Total pot $2.50 | Rake $0
Seat 1: eUBBn2R56C1IQ6Cs/vitwg (button) folded before Flop (didn't bet)
Seat 2: oDiBRCaF0QVtd3kO6xZIXw (small blind) folded before Flop
Seat 3: dxyNCn/qxfkGDUIf28Cbng (big blind) folded before Flop
Seat 4: UBZQqpnJZdTYYY1FTb0rLA collected ($2.50)
Seat 5: +OrCjyw70oZhJiD22Mn+bg folded before Flop (didn't bet)
Seat 6: b2a+5TkFf4xJN/Ihhma58Q folded before Flop (didn't bet)



PokerStars Game #59941329250:  Hold'em No Limit ($0.50/$1.00) - 2009/07/01 1:32:16 ET
Table 'gxFK0BVUD7cupu2uyRUZJg' 6-max Seat #2 is the button
Seat 1: M+X3uChmP6R63IwijVjgTg ($162.05 in chips)
Seat 2: hpxXcmRkXXI9HE5+5/j/0Q ($133.05 in chips)
Seat 3: Z2fXsGcjl+Eax+RzOgwOmg ($118.50 in chips)
Seat 4: Hcr4S4Nbkj5idKsvYK/eqQ ($100 in chips)
Seat 5: WgIrs6CBinyyw18pqdDtWA ($20.60 in chips)
Seat 6: dYyb6/42PMC8aNFlm/eBeQ ($103.90 in chips)
Z2fXsGcjl+Eax+RzOgwOmg: posts small blind $0.50
Hcr4S4Nbkj5idKsvYK/eqQ: posts big blind $1
*** HOLE CARDS ***
WgIrs6CBinyyw18pqdDtWA: calls $1
dYyb6/42PMC8aNFlm/eBeQ: raises $3 to $4
M+X3uChmP6R63IwijVjgTg: folds
hpxXcmRkXXI9HE5+5/j/0Q: folds
Z2fXsGcjl+Eax+RzOgwOmg: folds
Hcr4S4Nbkj5idKsvYK/eqQ: folds
WgIrs6CBinyyw18pqdDtWA: calls $3
*** FLOP *** [3c 8c 6s]
WgIrs6CBinyyw18pqdDtWA: checks
dYyb6/42PMC8aNFlm/eBeQ: bets $7
WgIrs6CBinyyw18pqdDtWA: raises $9.60 to $16.60 and is all-in
dYyb6/42PMC8aNFlm/eBeQ: calls $9.60
*** TURN *** [3c 8c 6s] [Jd]
*** RIVER *** [3c 8c 6s Jd] [Kh]
*** SHOW DOWN ***
WgIrs6CBinyyw18pqdDtWA: shows [9c Kc] (a pair of Kings)
dYyb6/42PMC8aNFlm/eBeQ: shows [Js Jh] (three of a kind, Jacks)
dYyb6/42PMC8aNFlm/eBeQ collected $40.60 from pot
*** SUMMARY ***
Total pot $42.70 | Rake $2.10
Board [3c 8c 6s Jd Kh]
Seat 1: M+X3uChmP6R63IwijVjgTg folded before Flop (didn't bet)
Seat 2: hpxXcmRkXXI9HE5+5/j/0Q (button) folded before Flop (didn't bet)
Seat 3: Z2fXsGcjl+Eax+RzOgwOmg (small blind) folded before Flop
Seat 4: Hcr4S4Nbkj5idKsvYK/eqQ (big blind) folded before Flop
Seat 5: WgIrs6CBinyyw18pqdDtWA showed [9c Kc] and lost with a pair of Kings
Seat 6: dYyb6/42PMC8aNFlm/eBeQ showed [Js Jh] and won ($40.60) with three of a kind, Jacks



PokerStars Game #59941328824:  Hold'em No Limit ($0.50/$1.00) - 2009/07/01 1:32:16 ET
Table 'tHb+N6GaPEmmBAe36B2R9Q' 2-max Seat #1 is the button
Seat 1: rL+Zpv4/vX2BVHcyfh/NXA ($136.90 in chips)
Seat 2: Pm1sDZZi0zFtnFGXLznkug ($94.70 in chips)
rL+Zpv4/vX2BVHcyfh/NXA: posts small blind $0.50
Pm1sDZZi0zFtnFGXLznkug: posts big blind $1
*** HOLE CARDS ***
Pm1sDZZi0zFtnFGXLznkug said, "lucky lucky"
rL+Zpv4/vX2BVHcyfh/NXA: raises $2 to $3
Pm1sDZZi0zFtnFGXLznkug: folds
rL+Zpv4/vX2BVHcyfh/NXA collected $2 from pot
rL+Zpv4/vX2BVHcyfh/NXA: doesn't show hand
*** SUMMARY ***
Total pot $2 | Rake $0
Seat 1: rL+Zpv4/vX2BVHcyfh/NXA (button) (small blind) collected ($2)
Seat 2: Pm1sDZZi0zFtnFGXLznkug (big blind) folded before Flop



PokerStars Game #59941329066:  Hold'em No Limit ($0.50/$1.00) - 2009/07/01 1:32:16 ET
Table 'fZjVbKj9D8yOB+Rj7NaP/A' 9-max Seat #1 is the button
Seat 1: 9BZCcac3+McErkkSN2YScA ($103.15 in chips)
Seat 2: PTAFYDIUSsG+SArbxNl+Aw ($104.50 in chips)
Seat 3: yAbu2QsRPVcjPbqlf/jDxw ($100 in chips)
Seat 4: 997ViqAtWn1FPjJqcffwcA ($100 in chips)
Seat 5: PkGfq5xrSlNsujKaG/HF4Q ($101.50 in chips)
Seat 6: OvwYHV65yUbgdBjSmo1+5g ($130.40 in chips)
Seat 7: SyS20PAm3RpT6uLBsGkwOA ($70.10 in chips)
Seat 9: qheQay5YvP2DMAb3OUSxtw ($100.50 in chips)
PTAFYDIUSsG+SArbxNl+Aw: posts small blind $0.50
yAbu2QsRPVcjPbqlf/jDxw: posts big blind $1
*** HOLE CARDS ***
997ViqAtWn1FPjJqcffwcA: folds
PkGfq5xrSlNsujKaG/HF4Q: raises $3 to $4
OvwYHV65yUbgdBjSmo1+5g: folds
SyS20PAm3RpT6uLBsGkwOA: raises $8 to $12
qheQay5YvP2DMAb3OUSxtw: folds
9BZCcac3+McErkkSN2YScA: folds
PTAFYDIUSsG+SArbxNl+Aw: folds
yAbu2QsRPVcjPbqlf/jDxw: folds
PkGfq5xrSlNsujKaG/HF4Q: folds
SyS20PAm3RpT6uLBsGkwOA collected $9.50 from pot
*** SUMMARY ***
Total pot $9.50 | Rake $0
Seat 1: 9BZCcac3+McErkkSN2YScA (button) folded before Flop (didn't bet)
Seat 2: PTAFYDIUSsG+SArbxNl+Aw (small blind) folded before Flop
Seat 3: yAbu2QsRPVcjPbqlf/jDxw (big blind) folded before Flop
Seat 4: 997ViqAtWn1FPjJqcffwcA folded before Flop (didn't bet)
Seat 5: PkGfq5xrSlNsujKaG/HF4Q folded before Flop
Seat 6: OvwYHV65yUbgdBjSmo1+5g folded before Flop (didn't bet)
Seat 7: SyS20PAm3RpT6uLBsGkwOA collected ($9.50)
Seat 9: qheQay5YvP2DMAb3OUSxtw folded before Flop (didn't bet)



PokerStars Game #59941329468:  Hold'em No Limit ($0.50/$1.00) - 2009/07/01 1:32:17 ET
Table 'QSIig7BLMc9wY/rgBechzw' 6-max Seat #4 is the button
Seat 1: Z2fXsGcjl+Eax+RzOgwOmg ($117.60 in chips)
Seat 2: mLOIkH/qmRa+mVujQIhBRg ($38.40 in chips)
Seat 3: +xW7QemQU0Fxs+4TnqBRow ($118.70 in chips)
Seat 4: +uSzP8Jwnw7sKfQ4s66b7w ($57.95 in chips)
Seat 5: lsLuWlcPA3Rh7kJVLzMh0Q ($102.20 in chips)
Seat 6: PxqfkAMdAWtkgbT+q2gciA ($55.10 in chips)
lsLuWlcPA3Rh7kJVLzMh0Q: posts small blind $0.50
PxqfkAMdAWtkgbT+q2gciA: posts big blind $1
*** HOLE CARDS ***
Z2fXsGcjl+Eax+RzOgwOmg: raises $3 to $4
mLOIkH/qmRa+mVujQIhBRg: folds
+xW7QemQU0Fxs+4TnqBRow: folds
+uSzP8Jwnw7sKfQ4s66b7w: folds
lsLuWlcPA3Rh7kJVLzMh0Q: folds
PxqfkAMdAWtkgbT+q2gciA: folds
Z2fXsGcjl+Eax+RzOgwOmg collected $2.50 from pot
Z2fXsGcjl+Eax+RzOgwOmg: doesn't show hand
*** SUMMARY ***
Total pot $2.50 | Rake $0
Seat 1: Z2fXsGcjl+Eax+RzOgwOmg collected ($2.50)
Seat 2: mLOIkH/qmRa+mVujQIhBRg folded before Flop (didn't bet)
Seat 3: +xW7QemQU0Fxs+4TnqBRow folded before Flop (didn't bet)
Seat 4: +uSzP8Jwnw7sKfQ4s66b7w (button) folded before Flop (didn't bet)
Seat 5: lsLuWlcPA3Rh7kJVLzMh0Q (small blind) folded before Flop
Seat 6: PxqfkAMdAWtkgbT+q2gciA (big blind) folded before Flop



PokerStars Game #59941329996:  Hold'em No Limit ($0.50/$1.00) - 2009/07/01 1:32:18 ET
Table '3T4owEKJKyGTMePwrv50FQ' 9-max Seat #7 is the button
Seat 1: OGgaARGdJQT4awWVNQ957w ($101.50 in chips)
Seat 2: t+Id2O6herCLgwnC4m49PA ($35.30 in chips)
Seat 3: DOLzOcBTZYcph5jEfKFWuQ ($100 in chips)
Seat 4: O5Go3jrzbQWxRB6ESK+Ptg ($80.60 in chips)
Seat 5: mMc/PBpqlN24gdi3C/1tOw ($45.90 in chips)
Seat 6: V138SURkdX8LdVBPKdJJag ($108.25 in chips)
Seat 7: 1862487932 ($100 in chips)
Seat 8: bLbSOSmSOnqE0iTcH/5dxA ($199 in chips)
Seat 9: 61sfw5QTu62YYIt68OsdrA ($61.95 in chips)
bLbSOSmSOnqE0iTcH/5dxA: posts small blind $0.50
61sfw5QTu62YYIt68OsdrA: posts big blind $1
*** HOLE CARDS ***
OGgaARGdJQT4awWVNQ957w: folds
t+Id2O6herCLgwnC4m49PA: folds
DOLzOcBTZYcph5jEfKFWuQ: raises $2 to $3
O5Go3jrzbQWxRB6ESK+Ptg: folds
mMc/PBpqlN24gdi3C/1tOw: folds
V138SURkdX8LdVBPKdJJag: folds
1862487932: folds
bLbSOSmSOnqE0iTcH/5dxA: folds
61sfw5QTu62YYIt68OsdrA: calls $2
*** FLOP *** [6h Th 3h]
61sfw5QTu62YYIt68OsdrA: checks
DOLzOcBTZYcph5jEfKFWuQ: checks
*** TURN *** [6h Th 3h] [Ts]
61sfw5QTu62YYIt68OsdrA: checks
DOLzOcBTZYcph5jEfKFWuQ: checks
*** RIVER *** [6h Th 3h Ts] [9c]
61sfw5QTu62YYIt68OsdrA: bets $6
DOLzOcBTZYcph5jEfKFWuQ: folds
61sfw5QTu62YYIt68OsdrA collected $6.20 from pot
61sfw5QTu62YYIt68OsdrA: doesn't show hand
*** SUMMARY ***
Total pot $6.50 | Rake $0.30
Board [6h Th 3h Ts 9c]
Seat 1: OGgaARGdJQT4awWVNQ957w folded before Flop (didn't bet)
Seat 2: t+Id2O6herCLgwnC4m49PA folded before Flop (didn't bet)
Seat 3: DOLzOcBTZYcph5jEfKFWuQ folded on the River
Seat 4: O5Go3jrzbQWxRB6ESK+Ptg folded before Flop (didn't bet)
Seat 5: mMc/PBpqlN24gdi3C/1tOw folded before Flop (didn't bet)
Seat 6: V138SURkdX8LdVBPKdJJag folded before Flop (didn't bet)
Seat 7: 1862487932 (button) folded before Flop (didn't bet)
Seat 8: bLbSOSmSOnqE0iTcH/5dxA (small blind) folded before Flop
Seat 9: 61sfw5QTu62YYIt68OsdrA (big blind) collected ($6.20)



PokerStars Game #59941330808:  Hold'em No Limit ($0.50/$1.00) - 2009/07/01 1:32:19 ET
Table 'jDQgUn1zGkyftPnHo0Awdw' 2-max Seat #2 is the button
Seat 1: a42+e5QB6s1kkG5FoSTZJw ($78.30 in chips)
Seat 2: q+vRKwm51mnr6kxX/161WQ ($179.50 in chips)
q+vRKwm51mnr6kxX/161WQ: posts small blind $0.50
a42+e5QB6s1kkG5FoSTZJw: posts big blind $1
*** HOLE CARDS ***
q+vRKwm51mnr6kxX/161WQ: folds
a42+e5QB6s1kkG5FoSTZJw collected $1 from pot
a42+e5QB6s1kkG5FoSTZJw: doesn't show hand
*** SUMMARY ***
Total pot $1 | Rake $0
Seat 1: a42+e5QB6s1kkG5FoSTZJw (big blind) collected ($1)
Seat 2: q+vRKwm51mnr6kxX/161WQ (button) (small blind) folded before Flop



PokerStars Game #59941331480:  Hold'em No Limit ($0.50/$1.00) - 2009/07/01 1:32:20 ET
Table '305hiksPPCCdC6V2LNsO5w' 6-max Seat #6 is the button
Seat 1: RTuDLJHh/9zPfBftoc9vsw ($10 in chips)
Seat 2: j7NIOHLZk7V2o9fOioO5ug ($132 in chips)
Seat 3: +zIVjZKLpcidfRHgVZW8lA ($28.70 in chips)
Seat 4: uJVSceLggtsrJya+WtmUEA ($214.55 in chips)
Seat 5: +Nt3OPk3XR9SKjZgm2CexQ ($109.15 in chips)
Seat 6: 9/Tq8dw7kWW68uN8bFupXg ($23.40 in chips)
RTuDLJHh/9zPfBftoc9vsw: posts small blind $0.50
j7NIOHLZk7V2o9fOioO5ug: posts big blind $1
*** HOLE CARDS ***
+zIVjZKLpcidfRHgVZW8lA: folds
uJVSceLggtsrJya+WtmUEA: raises $2 to $3
+Nt3OPk3XR9SKjZgm2CexQ: folds
9/Tq8dw7kWW68uN8bFupXg: calls $3
RTuDLJHh/9zPfBftoc9vsw: folds
j7NIOHLZk7V2o9fOioO5ug: folds
*** FLOP *** [Jc 2c Kc]
uJVSceLggtsrJya+WtmUEA: checks
9/Tq8dw7kWW68uN8bFupXg: bets $4
uJVSceLggtsrJya+WtmUEA: raises $11 to $15
9/Tq8dw7kWW68uN8bFupXg: folds
uJVSceLggtsrJya+WtmUEA collected $14.75 from pot
*** SUMMARY ***
Total pot $15.50 | Rake $0.75
Board [Jc 2c Kc]
Seat 1: RTuDLJHh/9zPfBftoc9vsw (small blind) folded before Flop
Seat 2: j7NIOHLZk7V2o9fOioO5ug (big blind) folded before Flop
Seat 3: +zIVjZKLpcidfRHgVZW8lA folded before Flop (didn't bet)
Seat 4: uJVSceLggtsrJya+WtmUEA collected ($14.75)
Seat 5: +Nt3OPk3XR9SKjZgm2CexQ folded before Flop (didn't bet)
Seat 6: 9/Tq8dw7kWW68uN8bFupXg (button) folded on the Flop



PokerStars Game #59941333610:  Hold'em No Limit ($0.50/$1.00) - 2009/07/01 1:32:24 ET
Table 'b8oW/dOL7fDza5DfZ/dOJQ' 6-max Seat #4 is the button
Seat 1: NakujTNjHFgzceydFf+E2Q ($101 in chips)
Seat 2: TSuRyAHnUPCFjP7Z0rEE0w ($121.50 in chips)
Seat 3: d8WX+9nUHoqlrAGagO0Wow ($14.50 in chips)
Seat 4: X87W8qaGsudJTSkClK2Cig ($20.35 in chips)
Seat 5: r4lpoh2BJZ8S6zyQv1JeSw ($103 in chips)
Seat 6: PvfYaKbzMpsmUcbOExckbQ ($104.10 in chips)
r4lpoh2BJZ8S6zyQv1JeSw: posts small blind $0.50
PvfYaKbzMpsmUcbOExckbQ: posts big blind $1
*** HOLE CARDS ***
NakujTNjHFgzceydFf+E2Q: folds
TSuRyAHnUPCFjP7Z0rEE0w: folds
d8WX+9nUHoqlrAGagO0Wow: folds
X87W8qaGsudJTSkClK2Cig: raises $2 to $3
r4lpoh2BJZ8S6zyQv1JeSw: folds
PvfYaKbzMpsmUcbOExckbQ: folds
X87W8qaGsudJTSkClK2Cig collected $2.50 from pot
*** SUMMARY ***
Total pot $2.50 | Rake $0
Seat 1: NakujTNjHFgzceydFf+E2Q folded before Flop (didn't bet)
Seat 2: TSuRyAHnUPCFjP7Z0rEE0w folded before Flop (didn't bet)
Seat 3: d8WX+9nUHoqlrAGagO0Wow folded before Flop (didn't bet)
Seat 4: X87W8qaGsudJTSkClK2Cig (button) collected ($2.50)
Seat 5: r4lpoh2BJZ8S6zyQv1JeSw (small blind) folded before Flop
Seat 6: PvfYaKbzMpsmUcbOExckbQ (big blind) folded before Flop



PokerStars Game #59941334282:  Hold'em No Limit ($0.50/$1.00) - 2009/07/01 1:32:25 ET
Table 'jDQgUn1zGkyftPnHo0Awdw' 2-max Seat #1 is the button
Seat 1: a42+e5QB6s1kkG5FoSTZJw ($78.80 in chips)
Seat 2: q+vRKwm51mnr6kxX/161WQ ($179 in chips)
a42+e5QB6s1kkG5FoSTZJw: posts small blind $0.50
q+vRKwm51mnr6kxX/161WQ: posts big blind $1
*** HOLE CARDS ***
a42+e5QB6s1kkG5FoSTZJw: raises $3 to $4
q+vRKwm51mnr6kxX/161WQ: calls $3
*** FLOP *** [5s Ks Ah]
q+vRKwm51mnr6kxX/161WQ: checks
a42+e5QB6s1kkG5FoSTZJw: bets $5
q+vRKwm51mnr6kxX/161WQ: calls $5
*** TURN *** [5s Ks Ah] [Jd]
q+vRKwm51mnr6kxX/161WQ: checks
a42+e5QB6s1kkG5FoSTZJw: checks
*** RIVER *** [5s Ks Ah Jd] [5c]
q+vRKwm51mnr6kxX/161WQ: checks
a42+e5QB6s1kkG5FoSTZJw: checks
*** SHOW DOWN ***
q+vRKwm51mnr6kxX/161WQ: shows [Qc Ad] (two pair, Aces and Fives)
a42+e5QB6s1kkG5FoSTZJw: mucks hand
q+vRKwm51mnr6kxX/161WQ collected $17.50 from pot
*** SUMMARY ***
Total pot $18 | Rake $0.50
Board [5s Ks Ah Jd 5c]
Seat 1: a42+e5QB6s1kkG5FoSTZJw (button) (small blind) mucked
Seat 2: q+vRKwm51mnr6kxX/161WQ (big blind) showed [Qc Ad] and won ($17.50) with two pair, Aces and Fives



PokerStars Game #59941334524:  Hold'em No Limit ($0.50/$1.00) - 2009/07/01 1:32:26 ET
Table 'tHb+N6GaPEmmBAe36B2R9Q' 2-max Seat #2 is the button
Seat 1: rL+Zpv4/vX2BVHcyfh/NXA ($137.90 in chips)
Seat 2: Pm1sDZZi0zFtnFGXLznkug ($93.70 in chips)
Pm1sDZZi0zFtnFGXLznkug: posts small blind $0.50
rL+Zpv4/vX2BVHcyfh/NXA: posts big blind $1
*** HOLE CARDS ***
Pm1sDZZi0zFtnFGXLznkug: calls $0.50
rL+Zpv4/vX2BVHcyfh/NXA said, "yeah wasn't slow rolling, had hand on another table"
rL+Zpv4/vX2BVHcyfh/NXA: checks
*** FLOP *** [9c 8d Ks]
rL+Zpv4/vX2BVHcyfh/NXA: bets $2
Pm1sDZZi0zFtnFGXLznkug said, "no prob"
Pm1sDZZi0zFtnFGXLznkug: raises $7 to $9
rL+Zpv4/vX2BVHcyfh/NXA: calls $7
*** TURN *** [9c 8d Ks] [7s]
rL+Zpv4/vX2BVHcyfh/NXA: checks
Pm1sDZZi0zFtnFGXLznkug: checks
*** RIVER *** [9c 8d Ks 7s] [3h]
rL+Zpv4/vX2BVHcyfh/NXA: checks
Pm1sDZZi0zFtnFGXLznkug: bets $10
rL+Zpv4/vX2BVHcyfh/NXA: calls $10
*** SHOW DOWN ***
Pm1sDZZi0zFtnFGXLznkug: shows [Ad As] (a pair of Aces)
rL+Zpv4/vX2BVHcyfh/NXA: mucks hand
Pm1sDZZi0zFtnFGXLznkug collected $39.50 from pot
*** SUMMARY ***
Total pot $40 | Rake $0.50
Board [9c 8d Ks 7s 3h]
Seat 1: rL+Zpv4/vX2BVHcyfh/NXA (big blind) mucked
Seat 2: Pm1sDZZi0zFtnFGXLznkug (button) (small blind) showed [Ad As] and won ($39.50) with a pair of Aces



PokerStars Game #59941336896:  Hold'em No Limit ($0.50/$1.00) - 2009/07/01 1:32:30 ET
Table 'fTlPiCj0utgzC/5io+I7ew' 6-max Seat #3 is the button
Seat 1: YMJG+F++3Aj6P8dAWda5fw ($104.60 in chips)
Seat 2: qVr1nl3dy2xXPqS8UpTDlA ($18.80 in chips)
Seat 3: Z2fXsGcjl+Eax+RzOgwOmg ($140.50 in chips)
Seat 4: uJVSceLggtsrJya+WtmUEA ($163.65 in chips)
Seat 5: XUk5GQsfNFpHvaToDZ0rZA ($45.55 in chips)
Seat 6: y27w5IK2WXqmYzS8OU0wKA ($100 in chips)
uJVSceLggtsrJya+WtmUEA: posts small blind $0.50
XUk5GQsfNFpHvaToDZ0rZA: posts big blind $1
*** HOLE CARDS ***
y27w5IK2WXqmYzS8OU0wKA: folds
YMJG+F++3Aj6P8dAWda5fw: folds
qVr1nl3dy2xXPqS8UpTDlA: folds
Z2fXsGcjl+Eax+RzOgwOmg: raises $2 to $3
uJVSceLggtsrJya+WtmUEA: folds
XUk5GQsfNFpHvaToDZ0rZA: folds
Z2fXsGcjl+Eax+RzOgwOmg collected $2.50 from pot
*** SUMMARY ***
Total pot $2.50 | Rake $0
Seat 1: YMJG+F++3Aj6P8dAWda5fw folded before Flop (didn't bet)
Seat 2: qVr1nl3dy2xXPqS8UpTDlA folded before Flop (didn't bet)
Seat 3: Z2fXsGcjl+Eax+RzOgwOmg (button) collected ($2.50)
Seat 4: uJVSceLggtsrJya+WtmUEA (small blind) folded before Flop
Seat 5: XUk5GQsfNFpHvaToDZ0rZA (big blind) folded before Flop
Seat 6: y27w5IK2WXqmYzS8OU0wKA folded before Flop (didn't bet)



PokerStars Game #59941337072:  Hold'em No Limit ($0.50/$1.00) - 2009/07/01 1:32:30 ET
Table 'QSIig7BLMc9wY/rgBechzw' 6-max Seat #5 is the button
Seat 1: Z2fXsGcjl+Eax+RzOgwOmg ($119.10 in chips)
Seat 2: mLOIkH/qmRa+mVujQIhBRg ($38.40 in chips)
Seat 3: +xW7QemQU0Fxs+4TnqBRow ($118.70 in chips)
Seat 4: +uSzP8Jwnw7sKfQ4s66b7w ($57.95 in chips)
Seat 5: lsLuWlcPA3Rh7kJVLzMh0Q ($101.70 in chips)
Seat 6: PxqfkAMdAWtkgbT+q2gciA ($54.10 in chips)
PxqfkAMdAWtkgbT+q2gciA: posts small blind $0.50
Z2fXsGcjl+Eax+RzOgwOmg: posts big blind $1
*** HOLE CARDS ***
mLOIkH/qmRa+mVujQIhBRg: folds
+xW7QemQU0Fxs+4TnqBRow: folds
+uSzP8Jwnw7sKfQ4s66b7w: raises $2 to $3
lsLuWlcPA3Rh7kJVLzMh0Q: folds
PxqfkAMdAWtkgbT+q2gciA: folds
Z2fXsGcjl+Eax+RzOgwOmg: folds
+uSzP8Jwnw7sKfQ4s66b7w collected $2.50 from pot
*** SUMMARY ***
Total pot $2.50 | Rake $0
Seat 1: Z2fXsGcjl+Eax+RzOgwOmg (big blind) folded before Flop
Seat 2: mLOIkH/qmRa+mVujQIhBRg folded before Flop (didn't bet)
Seat 3: +xW7QemQU0Fxs+4TnqBRow folded before Flop (didn't bet)
Seat 4: +uSzP8Jwnw7sKfQ4s66b7w collected ($2.50)
Seat 5: lsLuWlcPA3Rh7kJVLzMh0Q (button) folded before Flop (didn't bet)
Seat 6: PxqfkAMdAWtkgbT+q2gciA (small blind) folded before Flop



PokerStars Game #59941338858:  Hold'em No Limit ($0.50/$1.00) - 2009/07/01 1:32:33 ET
Table 'O96CPOtvMBWP6kzuYDfdFA' 6-max Seat #6 is the button
Seat 1: 6alLXQIITA2EZ/lBeym8Dw ($126.75 in chips)
Seat 2: 4d1rWhpu8DzLmzMbR3QKyA ($103 in chips)
Seat 3: V89DGjxE171oPREEbAXiyg ($117.75 in chips)
Seat 4: /P4w1pHg2zHYg/4ubJ0dPw ($66.65 in chips)
Seat 6: 3syOXva630dm1FTdwnuLpw ($73 in chips)
6alLXQIITA2EZ/lBeym8Dw: posts small blind $0.50
4d1rWhpu8DzLmzMbR3QKyA: posts big blind $1
*** HOLE CARDS ***
V89DGjxE171oPREEbAXiyg: folds
/P4w1pHg2zHYg/4ubJ0dPw: folds
3syOXva630dm1FTdwnuLpw: raises $2 to $3
V89DGjxE171oPREEbAXiyg is sitting out
6alLXQIITA2EZ/lBeym8Dw: calls $2.50
4d1rWhpu8DzLmzMbR3QKyA: folds
*** FLOP *** [Qd Ac Jc]
6alLXQIITA2EZ/lBeym8Dw: checks
3syOXva630dm1FTdwnuLpw: checks
*** TURN *** [Qd Ac Jc] [Ks]
6alLXQIITA2EZ/lBeym8Dw: checks
3syOXva630dm1FTdwnuLpw: bets $3
6alLXQIITA2EZ/lBeym8Dw: folds
3syOXva630dm1FTdwnuLpw collected $6.65 from pot
*** SUMMARY ***
Total pot $7 | Rake $0.35
Board [Qd Ac Jc Ks]
Seat 1: 6alLXQIITA2EZ/lBeym8Dw (small blind) folded on the Turn
Seat 2: 4d1rWhpu8DzLmzMbR3QKyA (big blind) folded before Flop
Seat 3: V89DGjxE171oPREEbAXiyg folded before Flop (didn't bet)
Seat 4: /P4w1pHg2zHYg/4ubJ0dPw folded before Flop (didn't bet)
Seat 6: 3syOXva630dm1FTdwnuLpw (button) collected ($6.65)



PokerStars Game #59941339366:  Hold'em No Limit ($0.50/$1.00) - 2009/07/01 1:32:34 ET
Table 'W/wyObTiXZm+Ckkl3YxcSw' 6-max Seat #2 is the button
Seat 1: eUBBn2R56C1IQ6Cs/vitwg ($295.55 in chips)
Seat 2: oDiBRCaF0QVtd3kO6xZIXw ($161.40 in chips)
Seat 3: dxyNCn/qxfkGDUIf28Cbng ($60.30 in chips)
Seat 4: UBZQqpnJZdTYYY1FTb0rLA ($103.20 in chips)
Seat 5: +OrCjyw70oZhJiD22Mn+bg ($101 in chips)
Seat 6: b2a+5TkFf4xJN/Ihhma58Q ($35.80 in chips)
dxyNCn/qxfkGDUIf28Cbng: posts small blind $0.50
UBZQqpnJZdTYYY1FTb0rLA: posts big blind $1
*** HOLE CARDS ***
+OrCjyw70oZhJiD22Mn+bg: raises $3 to $4
b2a+5TkFf4xJN/Ihhma58Q: folds
eUBBn2R56C1IQ6Cs/vitwg: folds
oDiBRCaF0QVtd3kO6xZIXw: folds
dxyNCn/qxfkGDUIf28Cbng: folds
UBZQqpnJZdTYYY1FTb0rLA: folds
+OrCjyw70oZhJiD22Mn+bg collected $2.50 from pot
+OrCjyw70oZhJiD22Mn+bg: doesn't show hand
*** SUMMARY ***
Total pot $2.50 | Rake $0
Seat 1: eUBBn2R56C1IQ6Cs/vitwg folded before Flop (didn't bet)
Seat 2: oDiBRCaF0QVtd3kO6xZIXw (button) folded before Flop (didn't bet)
Seat 3: dxyNCn/qxfkGDUIf28Cbng (small blind) folded before Flop
Seat 4: UBZQqpnJZdTYYY1FTb0rLA (big blind) folded before Flop
Seat 5: +OrCjyw70oZhJiD22Mn+bg collected ($2.50)
Seat 6: b2a+5TkFf4xJN/Ihhma58Q folded before Flop (didn't bet)



PokerStars Game #59941339942:  Hold'em No Limit ($0.50/$1.00) - 2009/07/01 1:32:35 ET
Table '/RZcOwpZpHQ+OwPwjsbnRw' 6-max Seat #2 is the button
Seat 1: +uSzP8Jwnw7sKfQ4s66b7w ($39.25 in chips)
Seat 2: Z2fXsGcjl+Eax+RzOgwOmg ($101.15 in chips)
Seat 3: LJMw/I77xpnw0R5T4HnMUg ($102.80 in chips)
Seat 4: j7NIOHLZk7V2o9fOioO5ug ($101.50 in chips)
Seat 5: wx3sQGkVi2x9wJXuWNHPBw ($167.25 in chips)
Seat 6: o3YLm/rSY916m/on1VjXPA ($206.70 in chips)
LJMw/I77xpnw0R5T4HnMUg: posts small blind $0.50
j7NIOHLZk7V2o9fOioO5ug: posts big blind $1
*** HOLE CARDS ***
wx3sQGkVi2x9wJXuWNHPBw: folds
o3YLm/rSY916m/on1VjXPA: raises $2 to $3
+uSzP8Jwnw7sKfQ4s66b7w: folds
Z2fXsGcjl+Eax+RzOgwOmg: folds
LJMw/I77xpnw0R5T4HnMUg: calls $2.50
j7NIOHLZk7V2o9fOioO5ug: folds
*** FLOP *** [6s 7h Jd]
LJMw/I77xpnw0R5T4HnMUg: checks
o3YLm/rSY916m/on1VjXPA: checks
*** TURN *** [6s 7h Jd] [9c]
LJMw/I77xpnw0R5T4HnMUg: bets $4
o3YLm/rSY916m/on1VjXPA: calls $4
*** RIVER *** [6s 7h Jd 9c] [Ac]
LJMw/I77xpnw0R5T4HnMUg: checks
o3YLm/rSY916m/on1VjXPA: bets $9
LJMw/I77xpnw0R5T4HnMUg: folds
o3YLm/rSY916m/on1VjXPA collected $14.30 from pot
o3YLm/rSY916m/on1VjXPA: doesn't show hand
*** SUMMARY ***
Total pot $15 | Rake $0.70
Board [6s 7h Jd 9c Ac]
Seat 1: +uSzP8Jwnw7sKfQ4s66b7w folded before Flop (didn't bet)
Seat 2: Z2fXsGcjl+Eax+RzOgwOmg (button) folded before Flop (didn't bet)
Seat 3: LJMw/I77xpnw0R5T4HnMUg (small blind) folded on the River
Seat 4: j7NIOHLZk7V2o9fOioO5ug (big blind) folded before Flop
Seat 5: wx3sQGkVi2x9wJXuWNHPBw folded before Flop (didn't bet)
Seat 6: o3YLm/rSY916m/on1VjXPA collected ($14.30)



PokerStars Game #59941339466:  Hold'em No Limit ($0.50/$1.00) - 2009/07/01 1:32:35 ET
Table 'kS0cTQAEi+fdUlJP2gQYvw' 9-max Seat #8 is the button
Seat 1: SqsWPukL8kLqrhq5ZrQdSQ ($99 in chips)
Seat 2: D+W9Me7w6Hcx/WRUSKV0dw ($25.05 in chips)
Seat 3: 2BV+oJIQYr65IO6nEChvbA ($67 in chips)
Seat 4: RUhhaALzha3TH1AkdakoGQ ($52.50 in chips)
Seat 5: 997ViqAtWn1FPjJqcffwcA ($100 in chips)
Seat 6: yAbu2QsRPVcjPbqlf/jDxw ($118.65 in chips)
Seat 7: Ffa7Nj4X5fddtROP01hfQg ($145.50 in chips)
Seat 8: vKyFzTyzfT7fZcdX+HHN+Q ($40.35 in chips)
Seat 9: OGgaARGdJQT4awWVNQ957w ($106.80 in chips)
OGgaARGdJQT4awWVNQ957w: posts small blind $0.50
SqsWPukL8kLqrhq5ZrQdSQ: posts big blind $1
*** HOLE CARDS ***
D+W9Me7w6Hcx/WRUSKV0dw: raises $1.45 to $2.45
2BV+oJIQYr65IO6nEChvbA: calls $2.45
RUhhaALzha3TH1AkdakoGQ: folds
997ViqAtWn1FPjJqcffwcA: folds
yAbu2QsRPVcjPbqlf/jDxw: folds
Ffa7Nj4X5fddtROP01hfQg: folds
vKyFzTyzfT7fZcdX+HHN+Q: folds
OGgaARGdJQT4awWVNQ957w: raises $7.85 to $10.30
SqsWPukL8kLqrhq5ZrQdSQ: folds
D+W9Me7w6Hcx/WRUSKV0dw: raises $14.75 to $25.05 and is all-in
2BV+oJIQYr65IO6nEChvbA: folds
OGgaARGdJQT4awWVNQ957w: calls $14.75
*** FLOP *** [8s Jd Jc]
*** TURN *** [8s Jd Jc] [Qc]
*** RIVER *** [8s Jd Jc Qc] [3c]
*** SHOW DOWN ***
OGgaARGdJQT4awWVNQ957w: shows [Ac Kd] (a pair of Jacks)
D+W9Me7w6Hcx/WRUSKV0dw: shows [Ah Kh] (a pair of Jacks)
OGgaARGdJQT4awWVNQ957w collected $25.45 from pot
D+W9Me7w6Hcx/WRUSKV0dw collected $25.45 from pot
*** SUMMARY ***
Total pot $53.55 | Rake $2.65
Board [8s Jd Jc Qc 3c]
Seat 1: SqsWPukL8kLqrhq5ZrQdSQ (big blind) folded before Flop
Seat 2: D+W9Me7w6Hcx/WRUSKV0dw showed [Ah Kh] and won ($25.45) with a pair of Jacks
Seat 3: 2BV+oJIQYr65IO6nEChvbA folded before Flop
Seat 4: RUhhaALzha3TH1AkdakoGQ folded before Flop (didn't bet)
Seat 5: 997ViqAtWn1FPjJqcffwcA folded before Flop (didn't bet)
Seat 6: yAbu2QsRPVcjPbqlf/jDxw folded before Flop (didn't bet)
Seat 7: Ffa7Nj4X5fddtROP01hfQg folded before Flop (didn't bet)
Seat 8: vKyFzTyzfT7fZcdX+HHN+Q (button) folded before Flop (didn't bet)
Seat 9: OGgaARGdJQT4awWVNQ957w (small blind) showed [Ac Kd] and won ($25.45) with a pair of Jacks



PokerStars Game #59941340206:  Hold'em No Limit ($0.50/$1.00) - 2009/07/01 1:32:36 ET
Table '7O9fB8yx1u7sJveJn8w6jA' 6-max Seat #2 is the button
Seat 1: 841740 ($54.45 in chips)
Seat 2: wx3sQGkVi2x9wJXuWNHPBw ($195.20 in chips)
Seat 3: hpxXcmRkXXI9HE5+5/j/0Q ($138.90 in chips)
Seat 4: b2a+5TkFf4xJN/Ihhma58Q ($35.35 in chips)
Seat 5: BCEV3COoKY607AzLWayfRA ($101.50 in chips)
Seat 6: r4lpoh2BJZ8S6zyQv1JeSw ($100 in chips)
hpxXcmRkXXI9HE5+5/j/0Q: posts small blind $0.50
b2a+5TkFf4xJN/Ihhma58Q: posts big blind $1
841740: posts big blind $1
*** HOLE CARDS ***
BCEV3COoKY607AzLWayfRA: folds
r4lpoh2BJZ8S6zyQv1JeSw: folds
841740: checks
wx3sQGkVi2x9wJXuWNHPBw: raises $4 to $5
hpxXcmRkXXI9HE5+5/j/0Q: folds
b2a+5TkFf4xJN/Ihhma58Q: folds
841740: folds
wx3sQGkVi2x9wJXuWNHPBw collected $3.50 from pot
*** SUMMARY ***
Total pot $3.50 | Rake $0
Seat 1: 841740 folded before Flop
Seat 2: wx3sQGkVi2x9wJXuWNHPBw (button) collected ($3.50)
Seat 3: hpxXcmRkXXI9HE5+5/j/0Q (small blind) folded before Flop
Seat 4: b2a+5TkFf4xJN/Ihhma58Q (big blind) folded before Flop
Seat 5: BCEV3COoKY607AzLWayfRA folded before Flop (didn't bet)
Seat 6: r4lpoh2BJZ8S6zyQv1JeSw folded before Flop (didn't bet)



PokerStars Game #59941340596:  Hold'em No Limit ($0.50/$1.00) - 2009/07/01 1:32:37 ET
Table 'GxCPo/gd3OSthkYrAxJngg' 6-max Seat #4 is the button
Seat 1: sH8BpAFP+jGFxCgVpD1Lew ($227.25 in chips)
Seat 2: YExX2paeIHrmfIwV1ivM/w ($67.60 in chips)
Seat 3: idVgoPAdspFPCzee6aF9Pg ($131.50 in chips)
Seat 4: YMJG+F++3Aj6P8dAWda5fw ($208.35 in chips)
Seat 6: 4d1rWhpu8DzLmzMbR3QKyA ($100 in chips)
4d1rWhpu8DzLmzMbR3QKyA: posts small blind $0.50
sH8BpAFP+jGFxCgVpD1Lew: posts big blind $1
*** HOLE CARDS ***
YExX2paeIHrmfIwV1ivM/w: folds
idVgoPAdspFPCzee6aF9Pg: folds
YMJG+F++3Aj6P8dAWda5fw: folds
4d1rWhpu8DzLmzMbR3QKyA: folds
sH8BpAFP+jGFxCgVpD1Lew collected $1 from pot
*** SUMMARY ***
Total pot $1 | Rake $0
Seat 1: sH8BpAFP+jGFxCgVpD1Lew (big blind) collected ($1)
Seat 2: YExX2paeIHrmfIwV1ivM/w folded before Flop (didn't bet)
Seat 3: idVgoPAdspFPCzee6aF9Pg folded before Flop (didn't bet)
Seat 4: YMJG+F++3Aj6P8dAWda5fw (button) folded before Flop (didn't bet)
Seat 6: 4d1rWhpu8DzLmzMbR3QKyA (small blind) folded before Flop



PokerStars Game #59941341134:  Hold'em No Limit ($0.50/$1.00) - 2009/07/01 1:32:38 ET
Table 'N6LvHFrb+cdXY/COI6ByOw' 2-max Seat #2 is the button
Seat 1: lXX4W7m3u++JiSOZ46yVMQ ($111.80 in chips)
Seat 2: 9mAoSP3o/mikSZOW2LEEAw ($84.35 in chips)
9mAoSP3o/mikSZOW2LEEAw: posts small blind $0.50
lXX4W7m3u++JiSOZ46yVMQ: posts big blind $1
*** HOLE CARDS ***
9mAoSP3o/mikSZOW2LEEAw: folds
lXX4W7m3u++JiSOZ46yVMQ collected $1 from pot
*** SUMMARY ***
Total pot $1 | Rake $0
Seat 1: lXX4W7m3u++JiSOZ46yVMQ (big blind) collected ($1)
Seat 2: 9mAoSP3o/mikSZOW2LEEAw (button) (small blind) folded before Flop



PokerStars Game #59941342002:  Hold'em No Limit ($0.50/$1.00) - 2009/07/01 1:32:40 ET
Table '/FUb199IViHMJHi5YWmeuQ' 9-max Seat #2 is the button
Seat 1: 3obndzTJ6fECz8+wWhMd1w ($16.50 in chips)
Seat 2: FL3MrLspcF23LYvC4ipBOA ($184.05 in chips)
Seat 3: V138SURkdX8LdVBPKdJJag ($117.25 in chips)
Seat 4: pbAfmxe4uSZPxJQX7gOzZA ($68.15 in chips)
Seat 5: H+DVy3Ei8L1UKS2tVOtJcw ($139.35 in chips)
Seat 6: VPF+HjszMvUIpy0CHIwH3A ($21.50 in chips)
Seat 7: myIxN7otsyr846M539YR8Q ($27 in chips)
Seat 8: 997ViqAtWn1FPjJqcffwcA ($101 in chips)
Seat 9: RfLbneGRY8yQUpMgDnJCxA ($75.20 in chips)
V138SURkdX8LdVBPKdJJag: posts small blind $0.50
pbAfmxe4uSZPxJQX7gOzZA: posts big blind $1
*** HOLE CARDS ***
H+DVy3Ei8L1UKS2tVOtJcw: folds
VPF+HjszMvUIpy0CHIwH3A: folds
myIxN7otsyr846M539YR8Q: folds
997ViqAtWn1FPjJqcffwcA: folds
RfLbneGRY8yQUpMgDnJCxA: folds
3obndzTJ6fECz8+wWhMd1w: raises $2 to $3
FL3MrLspcF23LYvC4ipBOA: folds
V138SURkdX8LdVBPKdJJag: raises $6.50 to $9.50
pbAfmxe4uSZPxJQX7gOzZA: folds
3obndzTJ6fECz8+wWhMd1w: raises $7 to $16.50 and is all-in
V138SURkdX8LdVBPKdJJag: calls $7
*** FLOP *** [Jc 3h Kd]
*** TURN *** [Jc 3h Kd] [4c]
*** RIVER *** [Jc 3h Kd 4c] [5s]
*** SHOW DOWN ***
V138SURkdX8LdVBPKdJJag: shows [Ts Tc] (a pair of Tens)
3obndzTJ6fECz8+wWhMd1w: shows [As Js] (a pair of Jacks)
3obndzTJ6fECz8+wWhMd1w collected $32.30 from pot
*** SUMMARY ***
Total pot $34 | Rake $1.70
Board [Jc 3h Kd 4c 5s]
Seat 1: 3obndzTJ6fECz8+wWhMd1w showed [As Js] and won ($32.30) with a pair of Jacks
Seat 2: FL3MrLspcF23LYvC4ipBOA (button) folded before Flop (didn't bet)
Seat 3: V138SURkdX8LdVBPKdJJag (small blind) showed [Ts Tc] and lost with a pair of Tens
Seat 4: pbAfmxe4uSZPxJQX7gOzZA (big blind) folded before Flop
Seat 5: H+DVy3Ei8L1UKS2tVOtJcw folded before Flop (didn't bet)
Seat 6: VPF+HjszMvUIpy0CHIwH3A folded before Flop (didn't bet)
Seat 7: myIxN7otsyr846M539YR8Q folded before Flop (didn't bet)
Seat 8: 997ViqAtWn1FPjJqcffwcA folded before Flop (didn't bet)
Seat 9: RfLbneGRY8yQUpMgDnJCxA folded before Flop (didn't bet)



PokerStars Game #59941342554:  Hold'em No Limit ($0.50/$1.00) - 2009/07/01 1:32:41 ET
Table '7Nl0ffnjeK44/vmeexh3MQ' 9-max Seat #3 is the button
Seat 1: V138SURkdX8LdVBPKdJJag ($101.50 in chips)
Seat 2: OGgaARGdJQT4awWVNQ957w ($100 in chips)
Seat 3: JMmUYT5pIKCKh2pGjCB/4w ($58.40 in chips)
Seat 4: bLbSOSmSOnqE0iTcH/5dxA ($107.30 in chips)
Seat 5: 61sfw5QTu62YYIt68OsdrA ($80 in chips)
Seat 6: FVs16t7GgfWgQWt4JxsObQ ($25.70 in chips)
Seat 7: 997ViqAtWn1FPjJqcffwcA ($100 in chips)
Seat 9: /JHoNdt0fK6X+isrqRfV3w ($20 in chips)
bLbSOSmSOnqE0iTcH/5dxA: posts small blind $0.50
61sfw5QTu62YYIt68OsdrA: posts big blind $1
*** HOLE CARDS ***
FVs16t7GgfWgQWt4JxsObQ: calls $1
997ViqAtWn1FPjJqcffwcA: folds
/JHoNdt0fK6X+isrqRfV3w: folds
V138SURkdX8LdVBPKdJJag: folds
OGgaARGdJQT4awWVNQ957w: folds
JMmUYT5pIKCKh2pGjCB/4w: folds
bLbSOSmSOnqE0iTcH/5dxA: folds
61sfw5QTu62YYIt68OsdrA: checks
*** FLOP *** [5h 8h 7s]
61sfw5QTu62YYIt68OsdrA: checks
FVs16t7GgfWgQWt4JxsObQ: bets $2
61sfw5QTu62YYIt68OsdrA: folds
FVs16t7GgfWgQWt4JxsObQ collected $2.40 from pot
*** SUMMARY ***
Total pot $2.50 | Rake $0.10
Board [5h 8h 7s]
Seat 1: V138SURkdX8LdVBPKdJJag folded before Flop (didn't bet)
Seat 2: OGgaARGdJQT4awWVNQ957w folded before Flop (didn't bet)
Seat 3: JMmUYT5pIKCKh2pGjCB/4w (button) folded before Flop (didn't bet)
Seat 4: bLbSOSmSOnqE0iTcH/5dxA (small blind) folded before Flop
Seat 5: 61sfw5QTu62YYIt68OsdrA (big blind) folded on the Flop
Seat 6: FVs16t7GgfWgQWt4JxsObQ collected ($2.40)
Seat 7: 997ViqAtWn1FPjJqcffwcA folded before Flop (didn't bet)
Seat 9: /JHoNdt0fK6X+isrqRfV3w folded before Flop (didn't bet)



PokerStars Game #59941343906:  Hold'em No Limit ($0.50/$1.00) - 2009/07/01 1:32:43 ET
Table 'hugOjcwJvzEwZbK7tyiWuQ' 9-max Seat #1 is the button
Seat 1: S3Ex8K7v6xm5jqjRM7Fl3w ($18.50 in chips)
Seat 2: r27C1nIV4NS4+qbnrgBQSw ($279.10 in chips)
Seat 4: UWB3oeddt/GObx2Mix2Anw ($160.10 in chips)
Seat 5: AexZ4puUV9meFWwVU6Nv0w ($35.70 in chips)
Seat 6: gUUvmqdVlmvpal6B8nYrmg ($105.45 in chips)
Seat 7: FL3MrLspcF23LYvC4ipBOA ($111.30 in chips)
Seat 8: /zy+DB4S5fUQUSfZWFzYGw ($118.35 in chips)
Seat 9: W8P9bUKCs43TO1xHm0dL6w ($109.80 in chips)
r27C1nIV4NS4+qbnrgBQSw: posts small blind $0.50
UWB3oeddt/GObx2Mix2Anw: posts big blind $1
*** HOLE CARDS ***
AexZ4puUV9meFWwVU6Nv0w: calls $1
gUUvmqdVlmvpal6B8nYrmg: folds
FL3MrLspcF23LYvC4ipBOA: folds
/zy+DB4S5fUQUSfZWFzYGw: folds
W8P9bUKCs43TO1xHm0dL6w: folds
S3Ex8K7v6xm5jqjRM7Fl3w: raises $2 to $3
r27C1nIV4NS4+qbnrgBQSw: folds
UWB3oeddt/GObx2Mix2Anw: calls $2
AexZ4puUV9meFWwVU6Nv0w: calls $2
*** FLOP *** [Js 3d 9d]
UWB3oeddt/GObx2Mix2Anw: checks
AexZ4puUV9meFWwVU6Nv0w: checks
S3Ex8K7v6xm5jqjRM7Fl3w: bets $2
UWB3oeddt/GObx2Mix2Anw: calls $2
AexZ4puUV9meFWwVU6Nv0w: folds
*** TURN *** [Js 3d 9d] [3c]
UWB3oeddt/GObx2Mix2Anw: checks
S3Ex8K7v6xm5jqjRM7Fl3w: checks
*** RIVER *** [Js 3d 9d 3c] [5s]
UWB3oeddt/GObx2Mix2Anw: checks
S3Ex8K7v6xm5jqjRM7Fl3w: bets $3
UWB3oeddt/GObx2Mix2Anw: folds
S3Ex8K7v6xm5jqjRM7Fl3w collected $12.85 from pot
S3Ex8K7v6xm5jqjRM7Fl3w: doesn't show hand
*** SUMMARY ***
Total pot $13.50 | Rake $0.65
Board [Js 3d 9d 3c 5s]
Seat 1: S3Ex8K7v6xm5jqjRM7Fl3w (button) collected ($12.85)
Seat 2: r27C1nIV4NS4+qbnrgBQSw (small blind) folded before Flop
Seat 4: UWB3oeddt/GObx2Mix2Anw (big blind) folded on the River
Seat 5: AexZ4puUV9meFWwVU6Nv0w folded on the Flop
Seat 6: gUUvmqdVlmvpal6B8nYrmg folded before Flop (didn't bet)
Seat 7: FL3MrLspcF23LYvC4ipBOA folded before Flop (didn't bet)
Seat 8: /zy+DB4S5fUQUSfZWFzYGw folded before Flop (didn't bet)
Seat 9: W8P9bUKCs43TO1xHm0dL6w folded before Flop (didn't bet)



PokerStars Game #59941343754:  Hold'em No Limit ($0.50/$1.00) - 2009/07/01 1:32:43 ET
Table 'pHrhryH8jPNdQfY62f8v+g' 6-max Seat #6 is the button
Seat 1: 4d1rWhpu8DzLmzMbR3QKyA ($143.25 in chips)
Seat 2: JwCcjZl0bjJzG7hmE0dnTA ($117.55 in chips)
Seat 3: 8oS5O7iD/qnFXFXJrGIgNQ ($114.30 in chips)
Seat 4: 1f3beyIML24UqEMTbWy93g ($58.80 in chips)
Seat 5: d8WX+9nUHoqlrAGagO0Wow ($18.50 in chips)
Seat 6: xAU6q2/cwmby2sxmA8VcmA ($176.75 in chips)
4d1rWhpu8DzLmzMbR3QKyA: posts small blind $0.50
JwCcjZl0bjJzG7hmE0dnTA: posts big blind $1
*** HOLE CARDS ***
8oS5O7iD/qnFXFXJrGIgNQ: folds
1f3beyIML24UqEMTbWy93g: calls $1
d8WX+9nUHoqlrAGagO0Wow: folds
xAU6q2/cwmby2sxmA8VcmA: folds
4d1rWhpu8DzLmzMbR3QKyA: folds
JwCcjZl0bjJzG7hmE0dnTA: checks
*** FLOP *** [Qd 5h Qh]
JwCcjZl0bjJzG7hmE0dnTA: checks
1f3beyIML24UqEMTbWy93g: bets $2
JwCcjZl0bjJzG7hmE0dnTA: folds
1f3beyIML24UqEMTbWy93g collected $2.40 from pot
*** SUMMARY ***
Total pot $2.50 | Rake $0.10
Board [Qd 5h Qh]
Seat 1: 4d1rWhpu8DzLmzMbR3QKyA (small blind) folded before Flop
Seat 2: JwCcjZl0bjJzG7hmE0dnTA (big blind) folded on the Flop
Seat 3: 8oS5O7iD/qnFXFXJrGIgNQ folded before Flop (didn't bet)
Seat 4: 1f3beyIML24UqEMTbWy93g collected ($2.40)
Seat 5: d8WX+9nUHoqlrAGagO0Wow folded before Flop (didn't bet)
Seat 6: xAU6q2/cwmby2sxmA8VcmA (button) folded before Flop (didn't bet)



PokerStars Game #59941344288:  Hold'em No Limit ($0.50/$1.00) - 2009/07/01 1:32:44 ET
Table 'b8oW/dOL7fDza5DfZ/dOJQ' 6-max Seat #5 is the button
Seat 1: NakujTNjHFgzceydFf+E2Q ($101 in chips)
Seat 2: TSuRyAHnUPCFjP7Z0rEE0w ($121.50 in chips)
Seat 3: d8WX+9nUHoqlrAGagO0Wow ($14.50 in chips)
Seat 4: X87W8qaGsudJTSkClK2Cig ($21.85 in chips)
Seat 5: r4lpoh2BJZ8S6zyQv1JeSw ($102.50 in chips)
Seat 6: PvfYaKbzMpsmUcbOExckbQ ($103.10 in chips)
PvfYaKbzMpsmUcbOExckbQ: posts small blind $0.50
NakujTNjHFgzceydFf+E2Q: posts big blind $1
*** HOLE CARDS ***
TSuRyAHnUPCFjP7Z0rEE0w: raises $3 to $4
d8WX+9nUHoqlrAGagO0Wow: folds
X87W8qaGsudJTSkClK2Cig: folds
r4lpoh2BJZ8S6zyQv1JeSw: folds
PvfYaKbzMpsmUcbOExckbQ: folds
NakujTNjHFgzceydFf+E2Q: folds
TSuRyAHnUPCFjP7Z0rEE0w collected $2.50 from pot
TSuRyAHnUPCFjP7Z0rEE0w: doesn't show hand
*** SUMMARY ***
Total pot $2.50 | Rake $0
Seat 1: NakujTNjHFgzceydFf+E2Q (big blind) folded before Flop
Seat 2: TSuRyAHnUPCFjP7Z0rEE0w collected ($2.50)
Seat 3: d8WX+9nUHoqlrAGagO0Wow folded before Flop (didn't bet)
Seat 4: X87W8qaGsudJTSkClK2Cig folded before Flop (didn't bet)
Seat 5: r4lpoh2BJZ8S6zyQv1JeSw (button) folded before Flop (didn't bet)
Seat 6: PvfYaKbzMpsmUcbOExckbQ (small blind) folded before Flop



PokerStars Game #59941344296:  Hold'em No Limit ($0.50/$1.00) - 2009/07/01 1:32:44 ET
Table 'N6LvHFrb+cdXY/COI6ByOw' 2-max Seat #1 is the button
Seat 1: lXX4W7m3u++JiSOZ46yVMQ ($112.30 in chips)
Seat 2: 9mAoSP3o/mikSZOW2LEEAw ($83.85 in chips)
lXX4W7m3u++JiSOZ46yVMQ: posts small blind $0.50
9mAoSP3o/mikSZOW2LEEAw: posts big blind $1
*** HOLE CARDS ***
lXX4W7m3u++JiSOZ46yVMQ: folds
9mAoSP3o/mikSZOW2LEEAw collected $1 from pot
9mAoSP3o/mikSZOW2LEEAw: shows [2d 2s] (a pair of Deuces)
*** SUMMARY ***
Total pot $1 | Rake $0
Seat 1: lXX4W7m3u++JiSOZ46yVMQ (button) (small blind) folded before Flop
Seat 2: 9mAoSP3o/mikSZOW2LEEAw (big blind) collected ($1)



PokerStars Game #59941344782:  Hold'em No Limit ($0.50/$1.00) - 2009/07/01 1:32:45 ET
Table 'qj0HBN4HhQKogreu1bg7xg' 2-max Seat #1 is the button
Seat 1: NYi6JFscYNrofSXy4sM+Yw ($100 in chips)
Seat 2: qtyl8CSb0/4yWdbuEPJejA ($153.40 in chips)
NYi6JFscYNrofSXy4sM+Yw: posts small blind $0.50
qtyl8CSb0/4yWdbuEPJejA: posts big blind $1
*** HOLE CARDS ***
NYi6JFscYNrofSXy4sM+Yw: raises $2 to $3
qtyl8CSb0/4yWdbuEPJejA: folds
NYi6JFscYNrofSXy4sM+Yw collected $2 from pot
*** SUMMARY ***
Total pot $2 | Rake $0
Seat 1: NYi6JFscYNrofSXy4sM+Yw (button) (small blind) collected ($2)
Seat 2: qtyl8CSb0/4yWdbuEPJejA (big blind) folded before Flop



PokerStars Game #59941345742:  Hold'em No Limit ($0.50/$1.00) - 2009/07/01 1:32:47 ET
Table 'jDQgUn1zGkyftPnHo0Awdw' 2-max Seat #2 is the button
Seat 1: a42+e5QB6s1kkG5FoSTZJw ($69.80 in chips)
Seat 2: q+vRKwm51mnr6kxX/161WQ ($187.50 in chips)
q+vRKwm51mnr6kxX/161WQ: posts small blind $0.50
a42+e5QB6s1kkG5FoSTZJw: posts big blind $1
*** HOLE CARDS ***
q+vRKwm51mnr6kxX/161WQ: folds
a42+e5QB6s1kkG5FoSTZJw collected $1 from pot
a42+e5QB6s1kkG5FoSTZJw: doesn't show hand
*** SUMMARY ***
Total pot $1 | Rake $0
Seat 1: a42+e5QB6s1kkG5FoSTZJw (big blind) collected ($1)
Seat 2: q+vRKwm51mnr6kxX/161WQ (button) (small blind) folded before Flop



PokerStars Game #59941346622:  Hold'em No Limit ($0.50/$1.00) - 2009/07/01 1:32:47 ET
Table '+cA8mcmhaedZ7YcrDdhmeQ' 6-max Seat #5 is the button
Seat 1: 9XrTM0DuVxx1pjFAdSbD8A ($54.70 in chips)
Seat 2: 14aYclSc98EYd6TrzN2l3Q ($19.05 in chips)
Seat 3: DAIgyIWbYvAkL6PbAI27pg ($16.55 in chips)
Seat 4: 4OO5v3AVduL0tePNx8wk5A ($105.95 in chips)
Seat 5: RqgF7gRoKgRNW8Zoi1ty4A ($162.30 in chips)
Seat 6: YfsTQsY/fxb+YqbdclTHuw ($43.85 in chips)
YfsTQsY/fxb+YqbdclTHuw: posts small blind $0.50
9XrTM0DuVxx1pjFAdSbD8A: posts big blind $1
*** HOLE CARDS ***
14aYclSc98EYd6TrzN2l3Q: raises $1 to $2
DAIgyIWbYvAkL6PbAI27pg: folds
4OO5v3AVduL0tePNx8wk5A: raises $5 to $7
RqgF7gRoKgRNW8Zoi1ty4A: folds
YfsTQsY/fxb+YqbdclTHuw: folds
9XrTM0DuVxx1pjFAdSbD8A: folds
14aYclSc98EYd6TrzN2l3Q: calls $5
*** FLOP *** [8d 5h 5s]
14aYclSc98EYd6TrzN2l3Q: bets $2
4OO5v3AVduL0tePNx8wk5A: raises $17 to $19
14aYclSc98EYd6TrzN2l3Q: folds
4OO5v3AVduL0tePNx8wk5A collected $18.60 from pot
*** SUMMARY ***
Total pot $19.50 | Rake $0.90
Board [8d 5h 5s]
Seat 1: 9XrTM0DuVxx1pjFAdSbD8A (big blind) folded before Flop
Seat 2: 14aYclSc98EYd6TrzN2l3Q folded on the Flop
Seat 3: DAIgyIWbYvAkL6PbAI27pg folded before Flop (didn't bet)
Seat 4: 4OO5v3AVduL0tePNx8wk5A collected ($18.60)
Seat 5: RqgF7gRoKgRNW8Zoi1ty4A (button) folded before Flop (didn't bet)
Seat 6: YfsTQsY/fxb+YqbdclTHuw (small blind) folded before Flop



PokerStars Game #59941346396:  Hold'em No Limit ($0.50/$1.00) - 2009/07/01 1:32:47 ET
Table 'QSIig7BLMc9wY/rgBechzw' 6-max Seat #6 is the button
Seat 1: Z2fXsGcjl+Eax+RzOgwOmg ($118.10 in chips)
Seat 2: mLOIkH/qmRa+mVujQIhBRg ($38.40 in chips)
Seat 3: +xW7QemQU0Fxs+4TnqBRow ($118.70 in chips)
Seat 4: +uSzP8Jwnw7sKfQ4s66b7w ($59.45 in chips)
Seat 5: lsLuWlcPA3Rh7kJVLzMh0Q ($101.70 in chips)
Seat 6: PxqfkAMdAWtkgbT+q2gciA ($53.60 in chips)
Z2fXsGcjl+Eax+RzOgwOmg: posts small blind $0.50
mLOIkH/qmRa+mVujQIhBRg: posts big blind $1
*** HOLE CARDS ***
+xW7QemQU0Fxs+4TnqBRow: folds
+uSzP8Jwnw7sKfQ4s66b7w: folds
lsLuWlcPA3Rh7kJVLzMh0Q: folds
PxqfkAMdAWtkgbT+q2gciA: folds
Z2fXsGcjl+Eax+RzOgwOmg: raises $2 to $3
mLOIkH/qmRa+mVujQIhBRg: calls $2
*** FLOP *** [8c Jc 4s]
Z2fXsGcjl+Eax+RzOgwOmg: bets $4
mLOIkH/qmRa+mVujQIhBRg: calls $4
*** TURN *** [8c Jc 4s] [8s]
Z2fXsGcjl+Eax+RzOgwOmg: bets $9
mLOIkH/qmRa+mVujQIhBRg: calls $9
*** RIVER *** [8c Jc 4s 8s] [As]
Z2fXsGcjl+Eax+RzOgwOmg: bets $26
mLOIkH/qmRa+mVujQIhBRg: folds
Z2fXsGcjl+Eax+RzOgwOmg collected $30.45 from pot
Z2fXsGcjl+Eax+RzOgwOmg: doesn't show hand
*** SUMMARY ***
Total pot $32 | Rake $1.55
Board [8c Jc 4s 8s As]
Seat 1: Z2fXsGcjl+Eax+RzOgwOmg (small blind) collected ($30.45)
Seat 2: mLOIkH/qmRa+mVujQIhBRg (big blind) folded on the River
Seat 3: +xW7QemQU0Fxs+4TnqBRow folded before Flop (didn't bet)
Seat 4: +uSzP8Jwnw7sKfQ4s66b7w folded before Flop (didn't bet)
Seat 5: lsLuWlcPA3Rh7kJVLzMh0Q folded before Flop (didn't bet)
Seat 6: PxqfkAMdAWtkgbT+q2gciA (button) folded before Flop (didn't bet)



PokerStars Game #59941345916:  Hold'em No Limit ($0.50/$1.00) - 2009/07/01 1:32:47 ET
Table 'GPp0HyAuggN8oE0sUWzPpA' 9-max Seat #7 is the button
Seat 2: m3U8I35Pn3gxKhoS2nmYIg ($28.95 in chips)
Seat 3: CCCXsirC+bO7ginAuUUVlQ ($53.10 in chips)
Seat 4: mBRWbnUl8diyBO1qTJaNzw ($98.65 in chips)
Seat 5: bLbSOSmSOnqE0iTcH/5dxA ($101.50 in chips)
Seat 6: BK/GtNPkSx0TdUDj82id5A ($36.25 in chips)
Seat 7: aM6BB+PnB/rDUr2dbRda+A ($100 in chips)
Seat 8: P/6qLjycEfxRgZ5F/W90dw ($96.35 in chips)
Seat 9: myIxN7otsyr846M539YR8Q ($21.50 in chips)
P/6qLjycEfxRgZ5F/W90dw: posts small blind $0.50
myIxN7otsyr846M539YR8Q: posts big blind $1
laA8va+Yv8WuMqT1zdR91g: sits out
*** HOLE CARDS ***
m3U8I35Pn3gxKhoS2nmYIg: calls $1
CCCXsirC+bO7ginAuUUVlQ: calls $1
mBRWbnUl8diyBO1qTJaNzw: folds
bLbSOSmSOnqE0iTcH/5dxA: raises $5 to $6
BK/GtNPkSx0TdUDj82id5A: folds
aM6BB+PnB/rDUr2dbRda+A: folds
P/6qLjycEfxRgZ5F/W90dw: folds
myIxN7otsyr846M539YR8Q: folds
m3U8I35Pn3gxKhoS2nmYIg: calls $5
CCCXsirC+bO7ginAuUUVlQ: folds
*** FLOP *** [Td 6h 2h]
m3U8I35Pn3gxKhoS2nmYIg: checks
bLbSOSmSOnqE0iTcH/5dxA: bets $7
m3U8I35Pn3gxKhoS2nmYIg: calls $7
*** TURN *** [Td 6h 2h] [Jd]
m3U8I35Pn3gxKhoS2nmYIg: checks
bLbSOSmSOnqE0iTcH/5dxA: bets $16
m3U8I35Pn3gxKhoS2nmYIg: calls $15.95 and is all-in
*** RIVER *** [Td 6h 2h Jd] [As]
*** SHOW DOWN ***
m3U8I35Pn3gxKhoS2nmYIg: shows [Ks 2s] (a pair of Deuces)
bLbSOSmSOnqE0iTcH/5dxA: shows [Jh Js] (three of a kind, Jacks)
bLbSOSmSOnqE0iTcH/5dxA collected $57.45 from pot
*** SUMMARY ***
Total pot $60.40 | Rake $2.95
Board [Td 6h 2h Jd As]
Seat 2: m3U8I35Pn3gxKhoS2nmYIg showed [Ks 2s] and lost with a pair of Deuces
Seat 3: CCCXsirC+bO7ginAuUUVlQ folded before Flop
Seat 4: mBRWbnUl8diyBO1qTJaNzw folded before Flop (didn't bet)
Seat 5: bLbSOSmSOnqE0iTcH/5dxA showed [Jh Js] and won ($57.45) with three of a kind, Jacks
Seat 6: BK/GtNPkSx0TdUDj82id5A folded before Flop (didn't bet)
Seat 7: aM6BB+PnB/rDUr2dbRda+A (button) folded before Flop (didn't bet)
Seat 8: P/6qLjycEfxRgZ5F/W90dw (small blind) folded before Flop
Seat 9: myIxN7otsyr846M539YR8Q (big blind) folded before Flop



PokerStars Game #59941347568:  Hold'em No Limit ($0.50/$1.00) - 2009/07/01 1:32:49 ET
Table 'CASNP0uy1C+jGLml/I4PtA' 9-max Seat #6 is the button
Seat 1: tkdBeXTJlFsZdioidNqLow ($73.60 in chips)
Seat 2: LUsAYklr0mQkiq7ASOyD9A ($65.55 in chips)
Seat 4: B/G0GJacqZ8K59/ZVdq4kQ ($52.55 in chips)
Seat 5: Jjc7EHWzs4//xUAjJ0UWoA ($10.50 in chips)
Seat 6: FJEywSpo5JbRKByzmweboA ($100 in chips)
Seat 7: S3Ex8K7v6xm5jqjRM7Fl3w ($21 in chips)
Seat 8: L9njYvloJ1NdXjP8edHEAg ($104.45 in chips)
Seat 9: Pp/KTcXkfZKKUHkjyaLTdg ($24.10 in chips)
S3Ex8K7v6xm5jqjRM7Fl3w: posts small blind $0.50
L9njYvloJ1NdXjP8edHEAg: posts big blind $1
*** HOLE CARDS ***
Pp/KTcXkfZKKUHkjyaLTdg: folds
tkdBeXTJlFsZdioidNqLow: folds
LUsAYklr0mQkiq7ASOyD9A: folds
B/G0GJacqZ8K59/ZVdq4kQ: folds
Jjc7EHWzs4//xUAjJ0UWoA: raises $2 to $3
FJEywSpo5JbRKByzmweboA: folds
S3Ex8K7v6xm5jqjRM7Fl3w: folds
L9njYvloJ1NdXjP8edHEAg: folds
Jjc7EHWzs4//xUAjJ0UWoA collected $2.50 from pot
*** SUMMARY ***
Total pot $2.50 | Rake $0
Seat 1: tkdBeXTJlFsZdioidNqLow folded before Flop (didn't bet)
Seat 2: LUsAYklr0mQkiq7ASOyD9A folded before Flop (didn't bet)
Seat 4: B/G0GJacqZ8K59/ZVdq4kQ folded before Flop (didn't bet)
Seat 5: Jjc7EHWzs4//xUAjJ0UWoA collected ($2.50)
Seat 6: FJEywSpo5JbRKByzmweboA (button) folded before Flop (didn't bet)
Seat 7: S3Ex8K7v6xm5jqjRM7Fl3w (small blind) folded before Flop
Seat 8: L9njYvloJ1NdXjP8edHEAg (big blind) folded before Flop
Seat 9: Pp/KTcXkfZKKUHkjyaLTdg folded before Flop (didn't bet)



PokerStars Game #59941347952:  Hold'em No Limit ($0.50/$1.00) - 2009/07/01 1:32:50 ET
Table 'ZFWj23PMihdwrNWv41OG/QtyUh+jyNvrceIQdKMJjQ2weat #4 is the button
Seat 1: j3hj7KQwBVU5NTFmtYomSw ($43.70 in chips)
Seat 2: U7xFsli2XvMiGlVDxk8a/Q ($116.70 in chips)
Seat 3: cWwhvq/+r/w8nkhwrJoekQ ($40.35 in chips)
Seat 4: O5ZesE/6mHyuWWbvkiH/Fg ($42.35 in chips)
Seat 5: j7NIOHLZk7V2o9fOioO5ug ($100 in chips)
Seat 6: u23r4AyKPgHioZ6t7z6qrA ($100 in chips)
j7NIOHLZk7V2o9fOioO5ug: posts small blind $0.50
u23r4AyKPgHioZ6t7z6qrA: posts big blind $1
*** HOLE CARDS ***
j3hj7KQwBVU5NTFmtYomSw: folds
U7xFsli2XvMiGlVDxk8a/Q: folds
cWwhvq/+r/w8nkhwrJoekQ: folds
O5ZesE/6mHyuWWbvkiH/Fg: folds
j7NIOHLZk7V2o9fOioO5ug: raises $3 to $4
u23r4AyKPgHioZ6t7z6qrA: folds
j7NIOHLZk7V2o9fOioO5ug collected $2 from pot
j7NIOHLZk7V2o9fOioO5ug: doesn't show hand
*** SUMMARY ***
Total pot $2 | Rake $0
Seat 1: j3hj7KQwBVU5NTFmtYomSw folded before Flop (didn't bet)
Seat 2: U7xFsli2XvMiGlVDxk8a/Q folded before Flop (didn't bet)
Seat 3: cWwhvq/+r/w8nkhwrJoekQ folded before Flop (didn't bet)
Seat 4: O5ZesE/6mHyuWWbvkiH/Fg (button) folded before Flop (didn't bet)
Seat 5: j7NIOHLZk7V2o9fOioO5ug (small blind) collected ($2)
Seat 6: u23r4AyKPgHioZ6t7z6qrA (big blind) folded before Flop



PokerStars Game #59941347988:  Hold'em No Limit ($0.50/$1.00) - 2009/07/01 1:32:50 ET
Table 'N6LvHFrb+cdXY/COI6ByOw' 2-max Seat #2 is the button
Seat 1: lXX4W7m3u++JiSOZ46yVMQ ($111.80 in chips)
Seat 2: 9mAoSP3o/mikSZOW2LEEAw ($84.35 in chips)
9mAoSP3o/mikSZOW2LEEAw: posts small blind $0.50
lXX4W7m3u++JiSOZ46yVMQ: posts big blind $1
*** HOLE CARDS ***
9mAoSP3o/mikSZOW2LEEAw: raises $1 to $2
lXX4W7m3u++JiSOZ46yVMQ: raises $6 to $8
9mAoSP3o/mikSZOW2LEEAw: calls $6
*** FLOP *** [3h 2s Ks]
lXX4W7m3u++JiSOZ46yVMQ: bets $11
9mAoSP3o/mikSZOW2LEEAw: calls $11
*** TURN *** [3h 2s Ks] [Js]
lXX4W7m3u++JiSOZ46yVMQ: bets $26
9mAoSP3o/mikSZOW2LEEAw: raises $26 to $52
lXX4W7m3u++JiSOZ46yVMQ: raises $40.80 to $92.80 and is all-in
9mAoSP3o/mikSZOW2LEEAw: calls $13.35 and is all-in
*** RIVER *** [3h 2s Ks Js] [6c]
*** SHOW DOWN ***
lXX4W7m3u++JiSOZ46yVMQ: shows [Ac Kc] (a pair of Kings)
9mAoSP3o/mikSZOW2LEEAw: shows [5s 7s] (a flush, King high)
9mAoSP3o/mikSZOW2LEEAw collected $168.20 from pot
*** SUMMARY ***
Total pot $168.70 | Rake $0.50
Board [3h 2s Ks Js 6c]
Seat 1: lXX4W7m3u++JiSOZ46yVMQ (big blind) showed [Ac Kc] and lost with a pair of Kings
Seat 2: 9mAoSP3o/mikSZOW2LEEAw (button) (small blind) showed [5s 7s] and won ($168.20) with a flush, King high



PokerStars Game #59941348426:  Hold'em No Limit ($0.50/$1.00) - 2009/07/01 1:32:51 ET
Table 'gxFK0BVUD7cupu2uyRUZJg' 6-max Seat #3 is the button
Seat 1: M+X3uChmP6R63IwijVjgTg ($162.05 in chips)
Seat 2: hpxXcmRkXXI9HE5+5/j/0Q ($133.05 in chips)
Seat 3: Z2fXsGcjl+Eax+RzOgwOmg ($118 in chips)
Seat 4: Hcr4S4Nbkj5idKsvYK/eqQ ($100 in chips)
Seat 6: dYyb6/42PMC8aNFlm/eBeQ ($123.90 in chips)
Hcr4S4Nbkj5idKsvYK/eqQ: posts small blind $0.50
dYyb6/42PMC8aNFlm/eBeQ: posts big blind $1
*** HOLE CARDS ***
M+X3uChmP6R63IwijVjgTg: raises $3 to $4
hpxXcmRkXXI9HE5+5/j/0Q: folds
Z2fXsGcjl+Eax+RzOgwOmg: calls $4
Hcr4S4Nbkj5idKsvYK/eqQ: folds
dYyb6/42PMC8aNFlm/eBeQ: calls $3
*** FLOP *** [6s 2c Td]
dYyb6/42PMC8aNFlm/eBeQ: checks
WgIrs6CBinyyw18pqdDtWA leaves the table
0smcry9L0OOTCP+KzIS5SA joins the table at seat #5
M+X3uChmP6R63IwijVjgTg: bets $7
Z2fXsGcjl+Eax+RzOgwOmg: raises $15 to $22
dYyb6/42PMC8aNFlm/eBeQ: folds
M+X3uChmP6R63IwijVjgTg: calls $15
*** TURN *** [6s 2c Td] [5h]
M+X3uChmP6R63IwijVjgTg: checks
Z2fXsGcjl+Eax+RzOgwOmg: checks
*** RIVER *** [6s 2c Td 5h] [6h]
M+X3uChmP6R63IwijVjgTg: bets $10
Z2fXsGcjl+Eax+RzOgwOmg: raises $42 to $52
M+X3uChmP6R63IwijVjgTg: calls $42
*** SHOW DOWN ***
Z2fXsGcjl+Eax+RzOgwOmg: shows [Jh As] (a pair of Sixes)
M+X3uChmP6R63IwijVjgTg: shows [Ad Ah] (two pair, Aces and Sixes)
M+X3uChmP6R63IwijVjgTg collected $158.50 from pot
*** SUMMARY ***
Total pot $160.50 | Rake $2
Board [6s 2c Td 5h 6h]
Seat 1: M+X3uChmP6R63IwijVjgTg showed [Ad Ah] and won ($158.50) with two pair, Aces and Sixes
Seat 2: hpxXcmRkXXI9HE5+5/j/0Q folded before Flop (didn't bet)
Seat 3: Z2fXsGcjl+Eax+RzOgwOmg (button) showed [Jh As] and lost with a pair of Sixes
Seat 4: Hcr4S4Nbkj5idKsvYK/eqQ (small blind) folded before Flop
Seat 6: dYyb6/42PMC8aNFlm/eBeQ (big blind) folded on the Flop



PokerStars Game #59941349730:  Hold'em No Limit ($0.50/$1.00) - 2009/07/01 1:32:53 ET
Table 'tJq9SfN1ywY0r03VBlWlwQ' 9-max Seat #5 is the button
Seat 1: wZsU+w9r7G66x93UuvBf1Q ($299.05 in chips)
Seat 2: VPF+HjszMvUIpy0CHIwH3A ($20 in chips)
Seat 4: bLbSOSmSOnqE0iTcH/5dxA ($114.20 in chips)
Seat 5: h5ipsNTMyolp7xn/NAvWkA ($131.90 in chips)
Seat 6: gUUvmqdVlmvpal6B8nYrmg ($100 in chips)
Seat 7: Ogn4JDV3mp4ZDKO49IFzKA ($20 in chips)
Seat 8: G4DEhsZFmznGNVpy2SEocA ($42.30 in chips)
Seat 9: XE5QF1y74bpHog9JxWJMWQ ($100 in chips)
gUUvmqdVlmvpal6B8nYrmg: posts small blind $0.50
Ogn4JDV3mp4ZDKO49IFzKA: posts big blind $1
*** HOLE CARDS ***
G4DEhsZFmznGNVpy2SEocA: folds
XE5QF1y74bpHog9JxWJMWQ: folds
wZsU+w9r7G66x93UuvBf1Q: folds
VPF+HjszMvUIpy0CHIwH3A: folds
bLbSOSmSOnqE0iTcH/5dxA: folds
h5ipsNTMyolp7xn/NAvWkA: raises $2 to $3
gUUvmqdVlmvpal6B8nYrmg: folds
Ogn4JDV3mp4ZDKO49IFzKA: folds
h5ipsNTMyolp7xn/NAvWkA collected $2.50 from pot
*** SUMMARY ***
Total pot $2.50 | Rake $0
Seat 1: wZsU+w9r7G66x93UuvBf1Q folded before Flop (didn't bet)
Seat 2: VPF+HjszMvUIpy0CHIwH3A folded before Flop (didn't bet)
Seat 4: bLbSOSmSOnqE0iTcH/5dxA folded before Flop (didn't bet)
Seat 5: h5ipsNTMyolp7xn/NAvWkA (button) collected ($2.50)
Seat 6: gUUvmqdVlmvpal6B8nYrmg (small blind) folded before Flop
Seat 7: Ogn4JDV3mp4ZDKO49IFzKA (big blind) folded before Flop
Seat 8: G4DEhsZFmznGNVpy2SEocA folded before Flop (didn't bet)
Seat 9: XE5QF1y74bpHog9JxWJMWQ folded before Flop (didn't bet)



PokerStars Game #59941349646:  Hold'em No Limit ($0.50/$1.00) - 2009/07/01 1:32:53 ET
Table 'jDQgUn1zGkyftPnHo0Awdw' 2-max Seat #1 is the button
Seat 1: a42+e5QB6s1kkG5FoSTZJw ($70.30 in chips)
Seat 2: q+vRKwm51mnr6kxX/161WQ ($187 in chips)
a42+e5QB6s1kkG5FoSTZJw: posts small blind $0.50
q+vRKwm51mnr6kxX/161WQ: posts big blind $1
*** HOLE CARDS ***
a42+e5QB6s1kkG5FoSTZJw: raises $3 to $4
q+vRKwm51mnr6kxX/161WQ: calls $3
*** FLOP *** [6d Kd 3c]
q+vRKwm51mnr6kxX/161WQ: checks
a42+e5QB6s1kkG5FoSTZJw: bets $5
q+vRKwm51mnr6kxX/161WQ: calls $5
*** TURN *** [6d Kd 3c] [6h]
q+vRKwm51mnr6kxX/161WQ: bets $11
a42+e5QB6s1kkG5FoSTZJw: calls $11
*** RIVER *** [6d Kd 3c 6h] [Jh]
q+vRKwm51mnr6kxX/161WQ: checks
a42+e5QB6s1kkG5FoSTZJw: checks
*** SHOW DOWN ***
q+vRKwm51mnr6kxX/161WQ: shows [Jd 7d] (two pair, Jacks and Sixes)
a42+e5QB6s1kkG5FoSTZJw: mucks hand
q+vRKwm51mnr6kxX/161WQ collected $39.50 from pot
*** SUMMARY ***
Total pot $40 | Rake $0.50
Board [6d Kd 3c 6h Jh]
Seat 1: a42+e5QB6s1kkG5FoSTZJw (button) (small blind) mucked
Seat 2: q+vRKwm51mnr6kxX/161WQ (big blind) showed [Jd 7d] and won ($39.50) with two pair, Jacks and Sixes



PokerStars Game #59941349694:  Hold'em No Limit ($0.50/$1.00) - 2009/07/01 1:32:53 ET
Table 'qj0HBN4HhQKogreu1bg7xg' 2-max Seat #2 is the button
Seat 1: NYi6JFscYNrofSXy4sM+Yw ($101 in chips)
Seat 2: qtyl8CSb0/4yWdbuEPJejA ($152.40 in chips)
qtyl8CSb0/4yWdbuEPJejA: posts small blind $0.50
NYi6JFscYNrofSXy4sM+Yw: posts big blind $1
*** HOLE CARDS ***
qtyl8CSb0/4yWdbuEPJejA: raises $2 to $3
NYi6JFscYNrofSXy4sM+Yw: folds
qtyl8CSb0/4yWdbuEPJejA collected $2 from pot
qtyl8CSb0/4yWdbuEPJejA: doesn't show hand
*** SUMMARY ***
Total pot $2 | Rake $0
Seat 1: NYi6JFscYNrofSXy4sM+Yw (big blind) folded before Flop
Seat 2: qtyl8CSb0/4yWdbuEPJejA (button) (small blind) collected ($2)



PokerStars Game #59941350600:  Hold'em No Limit ($0.50/$1.00) - 2009/07/01 1:32:54 ET
Table '7O9fB8yx1u7sJveJn8w6jA' 6-max Seat #3 is the button
Seat 1: 841740 ($53.45 in chips)
Seat 2: wx3sQGkVi2x9wJXuWNHPBw ($197.70 in chips)
Seat 3: hpxXcmRkXXI9HE5+5/j/0Q ($138.40 in chips)
Seat 4: b2a+5TkFf4xJN/Ihhma58Q ($34.35 in chips)
Seat 5: BCEV3COoKY607AzLWayfRA ($101.50 in chips)
Seat 6: r4lpoh2BJZ8S6zyQv1JeSw ($100 in chips)
b2a+5TkFf4xJN/Ihhma58Q: posts small blind $0.50
BCEV3COoKY607AzLWayfRA: posts big blind $1
*** HOLE CARDS ***
r4lpoh2BJZ8S6zyQv1JeSw: folds
841740: raises $2 to $3
wx3sQGkVi2x9wJXuWNHPBw: folds
hpxXcmRkXXI9HE5+5/j/0Q: raises $9 to $12
b2a+5TkFf4xJN/Ihhma58Q: folds
BCEV3COoKY607AzLWayfRA: folds
841740: folds
hpxXcmRkXXI9HE5+5/j/0Q collected $7.50 from pot
hpxXcmRkXXI9HE5+5/j/0Q: doesn't show hand
*** SUMMARY ***
Total pot $7.50 | Rake $0
Seat 1: 841740 folded before Flop
Seat 2: wx3sQGkVi2x9wJXuWNHPBw folded before Flop (didn't bet)
Seat 3: hpxXcmRkXXI9HE5+5/j/0Q (button) collected ($7.50)
Seat 4: b2a+5TkFf4xJN/Ihhma58Q (small blind) folded before Flop
Seat 5: BCEV3COoKY607AzLWayfRA (big blind) folded before Flop
Seat 6: r4lpoh2BJZ8S6zyQv1JeSw folded before Flop (didn't bet)



PokerStars Game #59941350802:  Hold'em No Limit ($0.50/$1.00) - 2009/07/01 1:32:55 ET
Table 'W/wyObTiXZm+Ckkl3YxcSw' 6-max Seat #3 is the button
Seat 1: eUBBn2R56C1IQ6Cs/vitwg ($295.55 in chips)
Seat 2: oDiBRCaF0QVtd3kO6xZIXw ($161.40 in chips)
Seat 3: dxyNCn/qxfkGDUIf28Cbng ($59.80 in chips)
Seat 4: UBZQqpnJZdTYYY1FTb0rLA ($102.20 in chips)
Seat 5: +OrCjyw70oZhJiD22Mn+bg ($102.50 in chips)
Seat 6: b2a+5TkFf4xJN/Ihhma58Q ($35.80 in chips)
UBZQqpnJZdTYYY1FTb0rLA: posts small blind $0.50
+OrCjyw70oZhJiD22Mn+bg: posts big blind $1
*** HOLE CARDS ***
b2a+5TkFf4xJN/Ihhma58Q: folds
eUBBn2R56C1IQ6Cs/vitwg: folds
oDiBRCaF0QVtd3kO6xZIXw: folds
dxyNCn/qxfkGDUIf28Cbng: folds
UBZQqpnJZdTYYY1FTb0rLA: raises $2 to $3
+OrCjyw70oZhJiD22Mn+bg: folds
UBZQqpnJZdTYYY1FTb0rLA collected $2 from pot
UBZQqpnJZdTYYY1FTb0rLA: doesn't show hand
*** SUMMARY ***
Total pot $2 | Rake $0
Seat 1: eUBBn2R56C1IQ6Cs/vitwg folded before Flop (didn't bet)
Seat 2: oDiBRCaF0QVtd3kO6xZIXw folded before Flop (didn't bet)
Seat 3: dxyNCn/qxfkGDUIf28Cbng (button) folded before Flop (didn't bet)
Seat 4: UBZQqpnJZdTYYY1FTb0rLA (small blind) collected ($2)
Seat 5: +OrCjyw70oZhJiD22Mn+bg (big blind) folded before Flop
Seat 6: b2a+5TkFf4xJN/Ihhma58Q folded before Flop (didn't bet)



PokerStars Game #59941351520:  Hold'em No Limit ($0.50/$1.00) - 2009/07/01 1:32:56 ET
Table 'b8oW/dOL7fDza5DfZ/dOJQ' 6-max Seat #6 is the button
Seat 1: NakujTNjHFgzceydFf+E2Q ($100 in chips)
Seat 2: TSuRyAHnUPCFjP7Z0rEE0w ($123 in chips)
Seat 3: d8WX+9nUHoqlrAGagO0Wow ($14.50 in chips)
Seat 4: X87W8qaGsudJTSkClK2Cig ($21.85 in chips)
Seat 5: r4lpoh2BJZ8S6zyQv1JeSw ($102.50 in chips)
Seat 6: PvfYaKbzMpsmUcbOExckbQ ($102.60 in chips)
NakujTNjHFgzceydFf+E2Q: posts small blind $0.50
TSuRyAHnUPCFjP7Z0rEE0w: posts big blind $1
*** HOLE CARDS ***
d8WX+9nUHoqlrAGagO0Wow: calls $1
X87W8qaGsudJTSkClK2Cig: calls $1
r4lpoh2BJZ8S6zyQv1JeSw: folds
PvfYaKbzMpsmUcbOExckbQ: folds
NakujTNjHFgzceydFf+E2Q: folds
TSuRyAHnUPCFjP7Z0rEE0w: checks
*** FLOP *** [Ac 6d 2h]
TSuRyAHnUPCFjP7Z0rEE0w: bets $2.50
d8WX+9nUHoqlrAGagO0Wow: calls $2.50
X87W8qaGsudJTSkClK2Cig: raises $8.50 to $11
TSuRyAHnUPCFjP7Z0rEE0w: folds
d8WX+9nUHoqlrAGagO0Wow: raises $2.50 to $13.50 and is all-in
X87W8qaGsudJTSkClK2Cig: calls $2.50
*** TURN *** [Ac 6d 2h] [5d]
*** RIVER *** [Ac 6d 2h 5d] [3d]
*** SHOW DOWN ***
d8WX+9nUHoqlrAGagO0Wow: shows [2d 2c] (three of a kind, Deuces)
X87W8qaGsudJTSkClK2Cig: mucks hand
d8WX+9nUHoqlrAGagO0Wow collected $31.40 from pot
*** SUMMARY ***
Total pot $33 | Rake $1.60
Board [Ac 6d 2h 5d 3d]
Seat 1: NakujTNjHFgzceydFf+E2Q (small blind) folded before Flop
Seat 2: TSuRyAHnUPCFjP7Z0rEE0w (big blind) folded on the Flop
Seat 3: d8WX+9nUHoqlrAGagO0Wow showed [2d 2c] and won ($31.40) with three of a kind, Deuces
Seat 4: X87W8qaGsudJTSkClK2Cig mucked
Seat 5: r4lpoh2BJZ8S6zyQv1JeSw folded before Flop (didn't bet)
Seat 6: PvfYaKbzMpsmUcbOExckbQ (button) folded before Flop (didn't bet)



PokerStars Game #59941352096:  Hold'em No Limit ($0.50/$1.00) - 2009/07/01 1:32:57 ET
Table 'N2bNCDHL96aCQDvZIh+yQQ' 6-max Seat #3 is the button
Seat 1: Jjgflx10PVjcLkziEmLhSA ($75.70 in chips)
Seat 2: y27w5IK2WXqmYzS8OU0wKA ($116.55 in chips)
Seat 3: UBZQqpnJZdTYYY1FTb0rLA ($120.55 in chips)
Seat 4: uCqEjnxh2/vFBjKYkfTOkw ($189 in chips)
Seat 5: frvgHLr3+LfZtjsBCBs3NA ($24.10 in chips)
Seat 6: idVgoPAdspFPCzee6aF9Pg ($100 in chips)
uCqEjnxh2/vFBjKYkfTOkw: posts small blind $0.50
frvgHLr3+LfZtjsBCBs3NA: posts big blind $1
*** HOLE CARDS ***
idVgoPAdspFPCzee6aF9Pg: folds
Jjgflx10PVjcLkziEmLhSA: folds
y27w5IK2WXqmYzS8OU0wKA: folds
UBZQqpnJZdTYYY1FTb0rLA: folds
uCqEjnxh2/vFBjKYkfTOkw: folds
frvgHLr3+LfZtjsBCBs3NA collected $1 from pot
*** SUMMARY ***
Total pot $1 | Rake $0
Seat 1: Jjgflx10PVjcLkziEmLhSA folded before Flop (didn't bet)
Seat 2: y27w5IK2WXqmYzS8OU0wKA folded before Flop (didn't bet)
Seat 3: UBZQqpnJZdTYYY1FTb0rLA (button) folded before Flop (didn't bet)
Seat 4: uCqEjnxh2/vFBjKYkfTOkw (small blind) folded before Flop
Seat 5: frvgHLr3+LfZtjsBCBs3NA (big blind) collected ($1)
Seat 6: idVgoPAdspFPCzee6aF9Pg folded before Flop (didn't bet)



PokerStars Game #59941352856:  Hold'em No Limit ($0.50/$1.00) - 2009/07/01 1:32:58 ET
Table 'MUPc8FEpe/nR0BKSeReX6Q' 6-max Seat #5 is the button
Seat 1: qhkK6+yCciTRd+rCFEbnEQ ($87.70 in chips)
Seat 2: xAU6q2/cwmby2sxmA8VcmA ($105.20 in chips)
Seat 3: wx3sQGkVi2x9wJXuWNHPBw ($284 in chips)
Seat 4: r4lpoh2BJZ8S6zyQv1JeSw ($112 in chips)
Seat 5: y27w5IK2WXqmYzS8OU0wKA ($101.55 in chips)
Seat 6: cl/QpVR/PLO58lj+C5mGLw ($27 in chips)
cl/QpVR/PLO58lj+C5mGLw: posts small blind $0.50
qhkK6+yCciTRd+rCFEbnEQ: posts big blind $1
*** HOLE CARDS ***
xAU6q2/cwmby2sxmA8VcmA: folds
wx3sQGkVi2x9wJXuWNHPBw: folds
r4lpoh2BJZ8S6zyQv1JeSw: folds
y27w5IK2WXqmYzS8OU0wKA: folds
cl/QpVR/PLO58lj+C5mGLw: calls $0.50
qhkK6+yCciTRd+rCFEbnEQ: checks
*** FLOP *** [4d Jc 6c]
cl/QpVR/PLO58lj+C5mGLw: checks
qhkK6+yCciTRd+rCFEbnEQ: checks
*** TURN *** [4d Jc 6c] [7s]
cl/QpVR/PLO58lj+C5mGLw: bets $1
qhkK6+yCciTRd+rCFEbnEQ: folds
cl/QpVR/PLO58lj+C5mGLw collected $1.90 from pot
*** SUMMARY ***
Total pot $2 | Rake $0.10
Board [4d Jc 6c 7s]
Seat 1: qhkK6+yCciTRd+rCFEbnEQ (big blind) folded on the Turn
Seat 2: xAU6q2/cwmby2sxmA8VcmA folded before Flop (didn't bet)
Seat 3: wx3sQGkVi2x9wJXuWNHPBw folded before Flop (didn't bet)
Seat 4: r4lpoh2BJZ8S6zyQv1JeSw folded before Flop (didn't bet)
Seat 5: y27w5IK2WXqmYzS8OU0wKA (button) folded before Flop (didn't bet)
Seat 6: cl/QpVR/PLO58lj+C5mGLw (small blind) collected ($1.90)



PokerStars Game #59941353500:  Hold'em No Limit ($0.50/$1.00) - 2009/07/01 1:32:59 ET
Table 'NqGO/cV3MwFAx+ZPB5ANmQ' 2-max Seat #1 is the button
Seat 1: ItaRAnHOgvYOv5ynbG1iTw ($127.70 in chips)
Seat 2: GtFB+yyeb2djMdPFuOW/Xg ($161.70 in chips)
ItaRAnHOgvYOv5ynbG1iTw: posts small blind $0.50
GtFB+yyeb2djMdPFuOW/Xg: posts big blind $1
*** HOLE CARDS ***
ItaRAnHOgvYOv5ynbG1iTw: raises $2 to $3
GtFB+yyeb2djMdPFuOW/Xg: folds
ItaRAnHOgvYOv5ynbG1iTw collected $2 from pot
*** SUMMARY ***
Total pot $2 | Rake $0
Seat 1: ItaRAnHOgvYOv5ynbG1iTw (button) (small blind) collected ($2)
Seat 2: GtFB+yyeb2djMdPFuOW/Xg (big blind) folded before Flop



PokerStars Game #59941354476:  Hold'em No Limit ($0.50/$1.00) - 2009/07/01 1:33:01 ET
Table 'fTlPiCj0utgzC/5io+I7ew' 6-max Seat #4 is the button
Seat 1: YMJG+F++3Aj6P8dAWda5fw ($104.60 in chips)
Seat 2: qVr1nl3dy2xXPqS8UpTDlA ($18.80 in chips)
Seat 3: Z2fXsGcjl+Eax+RzOgwOmg ($142 in chips)
Seat 4: uJVSceLggtsrJya+WtmUEA ($163.15 in chips)
Seat 5: XUk5GQsfNFpHvaToDZ0rZA ($44.55 in chips)
Seat 6: y27w5IK2WXqmYzS8OU0wKA ($100 in chips)
XUk5GQsfNFpHvaToDZ0rZA: posts small blind $0.50
y27w5IK2WXqmYzS8OU0wKA: posts big blind $1
*** HOLE CARDS ***
YMJG+F++3Aj6P8dAWda5fw: folds
qVr1nl3dy2xXPqS8UpTDlA: folds
Z2fXsGcjl+Eax+RzOgwOmg: folds
uJVSceLggtsrJya+WtmUEA: raises $2 to $3
XUk5GQsfNFpHvaToDZ0rZA: folds
y27w5IK2WXqmYzS8OU0wKA: calls $2
*** FLOP *** [8c 3c 4s]
y27w5IK2WXqmYzS8OU0wKA: checks
uJVSceLggtsrJya+WtmUEA: bets $5
y27w5IK2WXqmYzS8OU0wKA: folds
uJVSceLggtsrJya+WtmUEA collected $6.20 from pot
*** SUMMARY ***
Total pot $6.50 | Rake $0.30
Board [8c 3c 4s]
Seat 1: YMJG+F++3Aj6P8dAWda5fw folded before Flop (didn't bet)
Seat 2: qVr1nl3dy2xXPqS8UpTDlA folded before Flop (didn't bet)
Seat 3: Z2fXsGcjl+Eax+RzOgwOmg folded before Flop (didn't bet)
Seat 4: uJVSceLggtsrJya+WtmUEA (button) collected ($6.20)
Seat 5: XUk5GQsfNFpHvaToDZ0rZA (small blind) folded before Flop
Seat 6: y27w5IK2WXqmYzS8OU0wKA (big blind) folded on the Flop



PokerStars Game #59941354522:  Hold'em No Limit ($0.50/$1.00) - 2009/07/01 1:33:01 ET
Table 'mmbQQVBTrPdE+wy+s+9VPA' 6-max Seat #4 is the button
Seat 1: zyP4SPoWZnKUfTvIRLCVog ($75.65 in chips)
Seat 2: XK4Qsl+DA8gAJyg85/zBIw ($26.60 in chips)
Seat 3: wx3sQGkVi2x9wJXuWNHPBw ($124.85 in chips)
Seat 4: V3iZdcw61nXF3g5hD2RrsQ ($105.05 in chips)
Seat 5: YMJG+F++3Aj6P8dAWda5fw ($119.90 in chips)
Seat 6: U2CWBTv29qdCbj8RNF2sIw ($125.15 in chips)
YMJG+F++3Aj6P8dAWda5fw: posts small blind $0.50
U2CWBTv29qdCbj8RNF2sIw: posts big blind $1
*** HOLE CARDS ***
zyP4SPoWZnKUfTvIRLCVog: calls $1
XK4Qsl+DA8gAJyg85/zBIw: folds
wx3sQGkVi2x9wJXuWNHPBw: raises $4 to $5
V3iZdcw61nXF3g5hD2RrsQ: folds
YMJG+F++3Aj6P8dAWda5fw: folds
U2CWBTv29qdCbj8RNF2sIw: calls $4
zyP4SPoWZnKUfTvIRLCVog: calls $4
*** FLOP *** [Qh 7d 7s]
U2CWBTv29qdCbj8RNF2sIw: checks
zyP4SPoWZnKUfTvIRLCVog: checks
wx3sQGkVi2x9wJXuWNHPBw: bets $9
U2CWBTv29qdCbj8RNF2sIw: folds
zyP4SPoWZnKUfTvIRLCVog: folds
wx3sQGkVi2x9wJXuWNHPBw collected $14.75 from pot
*** SUMMARY ***
Total pot $15.50 | Rake $0.75
Board [Qh 7d 7s]
Seat 1: zyP4SPoWZnKUfTvIRLCVog folded on the Flop
Seat 2: XK4Qsl+DA8gAJyg85/zBIw folded before Flop (didn't bet)
Seat 3: wx3sQGkVi2x9wJXuWNHPBw collected ($14.75)
Seat 4: V3iZdcw61nXF3g5hD2RrsQ (button) folded before Flop (didn't bet)
Seat 5: YMJG+F++3Aj6P8dAWda5fw (small blind) folded before Flop
Seat 6: U2CWBTv29qdCbj8RNF2sIw (big blind) folded on the Flop



PokerStars Game #59941354928:  Hold'em No Limit ($0.50/$1.00) - 2009/07/01 1:33:02 ET
Table 'qj0HBN4HhQKogreu1bg7xg' 2-max Seat #1 is the button
Seat 1: NYi6JFscYNrofSXy4sM+Yw ($100 in chips)
Seat 2: qtyl8CSb0/4yWdbuEPJejA ($153.40 in chips)
NYi6JFscYNrofSXy4sM+Yw: posts small blind $0.50
qtyl8CSb0/4yWdbuEPJejA: posts big blind $1
*** HOLE CARDS ***
NYi6JFscYNrofSXy4sM+Yw: raises $2 to $3
qtyl8CSb0/4yWdbuEPJejA: raises $4 to $7
NYi6JFscYNrofSXy4sM+Yw: calls $4
*** FLOP *** [2s 8s Ts]
qtyl8CSb0/4yWdbuEPJejA: checks
NYi6JFscYNrofSXy4sM+Yw: bets $9
qtyl8CSb0/4yWdbuEPJejA: raises $12 to $21
NYi6JFscYNrofSXy4sM+Yw: calls $12
*** TURN *** [2s 8s Ts] [Js]
qtyl8CSb0/4yWdbuEPJejA: checks
NYi6JFscYNrofSXy4sM+Yw: checks
*** RIVER *** [2s 8s Ts Js] [6c]
qtyl8CSb0/4yWdbuEPJejA: bets $15
NYi6JFscYNrofSXy4sM+Yw: folds
qtyl8CSb0/4yWdbuEPJejA collected $55.50 from pot
qtyl8CSb0/4yWdbuEPJejA: doesn't show hand
*** SUMMARY ***
Total pot $56 | Rake $0.50
Board [2s 8s Ts Js 6c]
Seat 1: NYi6JFscYNrofSXy4sM+Yw (button) (small blind) folded on the River
Seat 2: qtyl8CSb0/4yWdbuEPJejA (big blind) collected ($55.50)



PokerStars Game #59941356186:  Hold'em No Limit ($0.50/$1.00) - 2009/07/01 1:33:04 ET
Table 'ZFWj23PMihdwrNWv41OG/QtyUh+jyNvrceIQdKMJjQ2weat #5 is the button
Seat 1: j3hj7KQwBVU5NTFmtYomSw ($43.70 in chips)
Seat 2: U7xFsli2XvMiGlVDxk8a/Q ($116.70 in chips)
Seat 3: cWwhvq/+r/w8nkhwrJoekQ ($40.35 in chips)
Seat 4: O5ZesE/6mHyuWWbvkiH/Fg ($42.35 in chips)
Seat 5: j7NIOHLZk7V2o9fOioO5ug ($101 in chips)
Seat 6: u23r4AyKPgHioZ6t7z6qrA ($99 in chips)
u23r4AyKPgHioZ6t7z6qrA: posts small blind $0.50
j3hj7KQwBVU5NTFmtYomSw: posts big blind $1
*** HOLE CARDS ***
U7xFsli2XvMiGlVDxk8a/Q: folds
cWwhvq/+r/w8nkhwrJoekQ: folds
U7xFsli2XvMiGlVDxk8a/Q leaves the table
O5ZesE/6mHyuWWbvkiH/Fg: folds
0smcry9L0OOTCP+KzIS5SA joins the table at seat #2
j7NIOHLZk7V2o9fOioO5ug: folds
u23r4AyKPgHioZ6t7z6qrA: folds
j3hj7KQwBVU5NTFmtYomSw collected $1 from pot
*** SUMMARY ***
Total pot $1 | Rake $0
Seat 1: j3hj7KQwBVU5NTFmtYomSw (big blind) collected ($1)
Seat 2: U7xFsli2XvMiGlVDxk8a/Q folded before Flop (didn't bet)
Seat 3: cWwhvq/+r/w8nkhwrJoekQ folded before Flop (didn't bet)
Seat 4: O5ZesE/6mHyuWWbvkiH/Fg folded before Flop (didn't bet)
Seat 5: j7NIOHLZk7V2o9fOioO5ug (button) folded before Flop (didn't bet)
Seat 6: u23r4AyKPgHioZ6t7z6qrA (small blind) folded before Flop



PokerStars Game #59941356102:  Hold'em No Limit ($0.50/$1.00) - 2009/07/01 1:33:04 ET
Table 'cBDNutyLBKEk9+ptwsKmTw' 6-max Seat #1 is the button
Seat 1: xAU6q2/cwmby2sxmA8VcmA ($270.55 in chips)
Seat 2: 4OO5v3AVduL0tePNx8wk5A ($134.10 in chips)
Seat 4: OMkHNxIUZxh1pHqcCjbjgw ($100 in chips)
Seat 5: hpxXcmRkXXI9HE5+5/j/0Q ($106.20 in chips)
Seat 6: QHvTZcrKe6+maWUfVjP29Q ($148.50 in chips)
4OO5v3AVduL0tePNx8wk5A: posts small blind $0.50
G5ZSSN6RSON3gkNvk/SmYg: is sitting out
OMkHNxIUZxh1pHqcCjbjgw: posts big blind $1
*** HOLE CARDS ***
hpxXcmRkXXI9HE5+5/j/0Q: folds
QHvTZcrKe6+maWUfVjP29Q: folds
xAU6q2/cwmby2sxmA8VcmA: folds
4OO5v3AVduL0tePNx8wk5A: raises $2 to $3
OMkHNxIUZxh1pHqcCjbjgw: folds
4OO5v3AVduL0tePNx8wk5A collected $2 from pot
4OO5v3AVduL0tePNx8wk5A: doesn't show hand
*** SUMMARY ***
Total pot $2 | Rake $0
Seat 1: xAU6q2/cwmby2sxmA8VcmA (button) folded before Flop (didn't bet)
Seat 2: 4OO5v3AVduL0tePNx8wk5A (small blind) collected ($2)
Seat 4: OMkHNxIUZxh1pHqcCjbjgw (big blind) folded before Flop
Seat 5: hpxXcmRkXXI9HE5+5/j/0Q folded before Flop (didn't bet)
Seat 6: QHvTZcrKe6+maWUfVjP29Q folded before Flop (didn't bet)



PokerStars Game #59941357790:  Hold'em No Limit ($0.50/$1.00) - 2009/07/01 1:33:07 ET
Table 'GxCPo/gd3OSthkYrAxJngg' 6-max Seat #6 is the button
Seat 1: sH8BpAFP+jGFxCgVpD1Lew ($227.75 in chips)
Seat 2: YExX2paeIHrmfIwV1ivM/w ($67.60 in chips)
Seat 3: idVgoPAdspFPCzee6aF9Pg ($131.50 in chips)
Seat 4: YMJG+F++3Aj6P8dAWda5fw ($208.35 in chips)
Seat 6: 4d1rWhpu8DzLmzMbR3QKyA ($100 in chips)
sH8BpAFP+jGFxCgVpD1Lew: posts small blind $0.50
YExX2paeIHrmfIwV1ivM/w: posts big blind $1
*** HOLE CARDS ***
idVgoPAdspFPCzee6aF9Pg: folds
YMJG+F++3Aj6P8dAWda5fw: folds
4d1rWhpu8DzLmzMbR3QKyA: raises $2 to $3
G5ZSSN6RSON3gkNvk/SmYg leaves the table
sH8BpAFP+jGFxCgVpD1Lew: raises $6 to $9
YExX2paeIHrmfIwV1ivM/w: folds
4d1rWhpu8DzLmzMbR3QKyA: folds
sH8BpAFP+jGFxCgVpD1Lew collected $7 from pot
sH8BpAFP+jGFxCgVpD1Lew: doesn't show hand
*** SUMMARY ***
Total pot $7 | Rake $0
Seat 1: sH8BpAFP+jGFxCgVpD1Lew (small blind) collected ($7)
Seat 2: YExX2paeIHrmfIwV1ivM/w (big blind) folded before Flop
Seat 3: idVgoPAdspFPCzee6aF9Pg folded before Flop (didn't bet)
Seat 4: YMJG+F++3Aj6P8dAWda5fw folded before Flop (didn't bet)
Seat 6: 4d1rWhpu8DzLmzMbR3QKyA (button) folded before Flop



PokerStars Game #59941357932:  Hold'em No Limit ($0.50/$1.00) - 2009/07/01 1:33:07 ET
Table 'rK8IGAmHXd06C9ia4Dis4A' 2-max Seat #2 is the button
Seat 1: FeErMt4Gvt/3PH2oB/pn4A ($20 in chips)
Seat 2: mgi+mjKb1Sc3CCs7TlfoCw ($69.35 in chips)
mgi+mjKb1Sc3CCs7TlfoCw: posts small blind $0.50
FeErMt4Gvt/3PH2oB/pn4A: posts big blind $1
*** HOLE CARDS ***
mgi+mjKb1Sc3CCs7TlfoCw: folds
FeErMt4Gvt/3PH2oB/pn4A collected $1 from pot
FeErMt4Gvt/3PH2oB/pn4A: doesn't show hand
*** SUMMARY ***
Total pot $1 | Rake $0
Seat 1: FeErMt4Gvt/3PH2oB/pn4A (big blind) collected ($1)
Seat 2: mgi+mjKb1Sc3CCs7TlfoCw (button) (small blind) folded before Flop



PokerStars Game #59941358898:  Hold'em No Limit ($0.50/$1.00) - 2009/07/01 1:33:09 ET
Table 'O96CPOtvMBWP6kzuYDfdFA' 6-max Seat #1 is the button
Seat 1: 6alLXQIITA2EZ/lBeym8Dw ($123.75 in chips)
Seat 2: 4d1rWhpu8DzLmzMbR3QKyA ($102 in chips)
Seat 4: /P4w1pHg2zHYg/4ubJ0dPw ($66.65 in chips)
Seat 6: 3syOXva630dm1FTdwnuLpw ($76.65 in chips)
4d1rWhpu8DzLmzMbR3QKyA: posts small blind $0.50
/P4w1pHg2zHYg/4ubJ0dPw: posts big blind $1
*** HOLE CARDS ***
3syOXva630dm1FTdwnuLpw: folds
6alLXQIITA2EZ/lBeym8Dw: folds
4d1rWhpu8DzLmzMbR3QKyA: raises $3 to $4
/P4w1pHg2zHYg/4ubJ0dPw: folds
4d1rWhpu8DzLmzMbR3QKyA collected $2 from pot
*** SUMMARY ***
Total pot $2 | Rake $0
Seat 1: 6alLXQIITA2EZ/lBeym8Dw (button) folded before Flop (didn't bet)
Seat 2: 4d1rWhpu8DzLmzMbR3QKyA (small blind) collected ($2)
Seat 4: /P4w1pHg2zHYg/4ubJ0dPw (big blind) folded before Flop
Seat 6: 3syOXva630dm1FTdwnuLpw folded before Flop (didn't bet)



PokerStars Game #59941360890:  Hold'em No Limit ($0.50/$1.00) - 2009/07/01 1:33:13 ET
Table 'N2bNCDHL96aCQDvZIh+yQQ' 6-max Seat #4 is the button
Seat 1: Jjgflx10PVjcLkziEmLhSA ($75.70 in chips)
Seat 2: y27w5IK2WXqmYzS8OU0wKA ($116.55 in chips)
Seat 3: UBZQqpnJZdTYYY1FTb0rLA ($120.55 in chips)
Seat 4: uCqEjnxh2/vFBjKYkfTOkw ($188.50 in chips)
Seat 5: frvgHLr3+LfZtjsBCBs3NA ($24.60 in chips)
Seat 6: idVgoPAdspFPCzee6aF9Pg ($100 in chips)
frvgHLr3+LfZtjsBCBs3NA: posts small blind $0.50
idVgoPAdspFPCzee6aF9Pg: posts big blind $1
*** HOLE CARDS ***
Jjgflx10PVjcLkziEmLhSA: folds
y27w5IK2WXqmYzS8OU0wKA: raises $2 to $3
UBZQqpnJZdTYYY1FTb0rLA: folds
uCqEjnxh2/vFBjKYkfTOkw: folds
frvgHLr3+LfZtjsBCBs3NA: raises $2 to $5
idVgoPAdspFPCzee6aF9Pg: folds
y27w5IK2WXqmYzS8OU0wKA: raises $16 to $21
frvgHLr3+LfZtjsBCBs3NA: folds
y27w5IK2WXqmYzS8OU0wKA collected $11 from pot
y27w5IK2WXqmYzS8OU0wKA: doesn't show hand
*** SUMMARY ***
Total pot $11 | Rake $0
Seat 1: Jjgflx10PVjcLkziEmLhSA folded before Flop (didn't bet)
Seat 2: y27w5IK2WXqmYzS8OU0wKA collected ($11)
Seat 3: UBZQqpnJZdTYYY1FTb0rLA folded before Flop (didn't bet)
Seat 4: uCqEjnxh2/vFBjKYkfTOkw (button) folded before Flop (didn't bet)
Seat 5: frvgHLr3+LfZtjsBCBs3NA (small blind) folded before Flop
Seat 6: idVgoPAdspFPCzee6aF9Pg (big blind) folded before Flop



PokerStars Game #59941361702:  Hold'em No Limit ($0.50/$1.00) - 2009/07/01 1:33:14 ET
Table 'W/wyObTiXZm+Ckkl3YxcSw' 6-max Seat #4 is the button
Seat 1: eUBBn2R56C1IQ6Cs/vitwg ($295.55 in chips)
Seat 2: oDiBRCaF0QVtd3kO6xZIXw ($161.40 in chips)
Seat 3: dxyNCn/qxfkGDUIf28Cbng ($59.80 in chips)
Seat 4: UBZQqpnJZdTYYY1FTb0rLA ($103.20 in chips)
Seat 5: +OrCjyw70oZhJiD22Mn+bg ($101.50 in chips)
Seat 6: b2a+5TkFf4xJN/Ihhma58Q ($35.80 in chips)
+OrCjyw70oZhJiD22Mn+bg: posts small blind $0.50
b2a+5TkFf4xJN/Ihhma58Q: posts big blind $1
*** HOLE CARDS ***
eUBBn2R56C1IQ6Cs/vitwg: folds
oDiBRCaF0QVtd3kO6xZIXw: folds
dxyNCn/qxfkGDUIf28Cbng: folds
UBZQqpnJZdTYYY1FTb0rLA: folds
+OrCjyw70oZhJiD22Mn+bg: folds
b2a+5TkFf4xJN/Ihhma58Q collected $1 from pot
*** SUMMARY ***
Total pot $1 | Rake $0
Seat 1: eUBBn2R56C1IQ6Cs/vitwg folded before Flop (didn't bet)
Seat 2: oDiBRCaF0QVtd3kO6xZIXw folded before Flop (didn't bet)
Seat 3: dxyNCn/qxfkGDUIf28Cbng folded before Flop (didn't bet)
Seat 4: UBZQqpnJZdTYYY1FTb0rLA (button) folded before Flop (didn't bet)
Seat 5: +OrCjyw70oZhJiD22Mn+bg (small blind) folded before Flop
Seat 6: b2a+5TkFf4xJN/Ihhma58Q (big blind) collected ($1)



PokerStars Game #59941361834:  Hold'em No Limit ($0.50/$1.00) - 2009/07/01 1:33:15 ET
Table 'rK8IGAmHXd06C9ia4Dis4A' 2-max Seat #1 is the button
Seat 1: FeErMt4Gvt/3PH2oB/pn4A ($20.50 in chips)
Seat 2: mgi+mjKb1Sc3CCs7TlfoCw ($68.85 in chips)
FeErMt4Gvt/3PH2oB/pn4A: posts small blind $0.50
mgi+mjKb1Sc3CCs7TlfoCw: posts big blind $1
*** HOLE CARDS ***
FeErMt4Gvt/3PH2oB/pn4A: calls $0.50
mgi+mjKb1Sc3CCs7TlfoCw: raises $3 to $4
FeErMt4Gvt/3PH2oB/pn4A: folds
mgi+mjKb1Sc3CCs7TlfoCw collected $2 from pot
mgi+mjKb1Sc3CCs7TlfoCw: doesn't show hand
*** SUMMARY ***
Total pot $2 | Rake $0
Seat 1: FeErMt4Gvt/3PH2oB/pn4A (button) (small blind) folded before Flop
Seat 2: mgi+mjKb1Sc3CCs7TlfoCw (big blind) collected ($2)



PokerStars Game #59941364386:  Hold'em No Limit ($0.50/$1.00) - 2009/07/01 1:33:19 ET
Table 'blHlQApStil0OPeQxQxPcw' 9-max Seat #8 is the button
Seat 1: Pp/KTcXkfZKKUHkjyaLTdg ($22.30 in chips)
Seat 2: V138SURkdX8LdVBPKdJJag ($124.35 in chips)
Seat 3: OGgaARGdJQT4awWVNQ957w ($100 in chips)
Seat 5: uXrDE6JrIi8BZK1L8oQ9bQ ($55.10 in chips)
Seat 6: vljeiOoWscAIXU0fCuiEBw ($32.15 in chips)
Seat 8: laA8va+Yv8WuMqT1zdR91g ($100 in chips)
Seat 9: 6XkTu4ahxzHnvjjc1R8YjQ ($155.85 in chips)
6XkTu4ahxzHnvjjc1R8YjQ: posts small blind $0.50
Pp/KTcXkfZKKUHkjyaLTdg: posts big blind $1
VPF+HjszMvUIpy0CHIwH3A: sits out
*** HOLE CARDS ***
V138SURkdX8LdVBPKdJJag: folds
OGgaARGdJQT4awWVNQ957w: folds
uXrDE6JrIi8BZK1L8oQ9bQ: calls $1
vljeiOoWscAIXU0fCuiEBw: raises $3 to $4
laA8va+Yv8WuMqT1zdR91g: folds
6XkTu4ahxzHnvjjc1R8YjQ: folds
Pp/KTcXkfZKKUHkjyaLTdg: folds
uXrDE6JrIi8BZK1L8oQ9bQ: calls $3
*** FLOP *** [Qc 2c 2d]
uXrDE6JrIi8BZK1L8oQ9bQ: checks
vljeiOoWscAIXU0fCuiEBw: bets $15
uXrDE6JrIi8BZK1L8oQ9bQ: folds
vljeiOoWscAIXU0fCuiEBw collected $9.05 from pot
*** SUMMARY ***
Total pot $9.50 | Rake $0.45
Board [Qc 2c 2d]
Seat 1: Pp/KTcXkfZKKUHkjyaLTdg (big blind) folded before Flop
Seat 2: V138SURkdX8LdVBPKdJJag folded before Flop (didn't bet)
Seat 3: OGgaARGdJQT4awWVNQ957w folded before Flop (didn't bet)
Seat 5: uXrDE6JrIi8BZK1L8oQ9bQ folded on the Flop
Seat 6: vljeiOoWscAIXU0fCuiEBw collected ($9.05)
Seat 8: laA8va+Yv8WuMqT1zdR91g (button) folded before Flop (didn't bet)
Seat 9: 6XkTu4ahxzHnvjjc1R8YjQ (small blind) folded before Flop



PokerStars Game #59941364570:  Hold'em No Limit ($0.50/$1.00) - 2009/07/01 1:33:19 ET
Table 'cBDNutyLBKEk9+ptwsKmTw' 6-max Seat #2 is the button
Seat 1: xAU6q2/cwmby2sxmA8VcmA ($270.55 in chips)
Seat 2: 4OO5v3AVduL0tePNx8wk5A ($135.10 in chips)
Seat 4: OMkHNxIUZxh1pHqcCjbjgw ($99 in chips)
Seat 5: hpxXcmRkXXI9HE5+5/j/0Q ($106.20 in chips)
Seat 6: QHvTZcrKe6+maWUfVjP29Q ($148.50 in chips)
OMkHNxIUZxh1pHqcCjbjgw: posts small blind $0.50
hpxXcmRkXXI9HE5+5/j/0Q: posts big blind $1
*** HOLE CARDS ***
QHvTZcrKe6+maWUfVjP29Q: folds
xAU6q2/cwmby2sxmA8VcmA: folds
4OO5v3AVduL0tePNx8wk5A: folds
G5ZSSN6RSON3gkNvk/SmYg leaves the table
OMkHNxIUZxh1pHqcCjbjgw: raises $2 to $3
hpxXcmRkXXI9HE5+5/j/0Q: folds
OMkHNxIUZxh1pHqcCjbjgw collected $2 from pot
OMkHNxIUZxh1pHqcCjbjgw: doesn't show hand
*** SUMMARY ***
Total pot $2 | Rake $0
Seat 1: xAU6q2/cwmby2sxmA8VcmA folded before Flop (didn't bet)
Seat 2: 4OO5v3AVduL0tePNx8wk5A (button) folded before Flop (didn't bet)
Seat 4: OMkHNxIUZxh1pHqcCjbjgw (small blind) collected ($2)
Seat 5: hpxXcmRkXXI9HE5+5/j/0Q (big blind) folded before Flop
Seat 6: QHvTZcrKe6+maWUfVjP29Q folded before Flop (didn't bet)



PokerStars Game #59941365384:  Hold'em No Limit ($0.50/$1.00) - 2009/07/01 1:33:21 ET
Table 'fZjVbKj9D8yOB+Rj7NaP/A' 9-max Seat #2 is the button
Seat 1: 9BZCcac3+McErkkSN2YScA ($103.15 in chips)
Seat 2: PTAFYDIUSsG+SArbxNl+Aw ($104 in chips)
Seat 3: yAbu2QsRPVcjPbqlf/jDxw ($100 in chips)
Seat 4: 997ViqAtWn1FPjJqcffwcA ($100 in chips)
Seat 5: PkGfq5xrSlNsujKaG/HF4Q ($100 in chips)
Seat 6: OvwYHV65yUbgdBjSmo1+5g ($130.40 in chips)
Seat 7: SyS20PAm3RpT6uLBsGkwOA ($75.60 in chips)
Seat 9: qheQay5YvP2DMAb3OUSxtw ($100.50 in chips)
yAbu2QsRPVcjPbqlf/jDxw: posts small blind $0.50
997ViqAtWn1FPjJqcffwcA: posts big blind $1
*** HOLE CARDS ***
PkGfq5xrSlNsujKaG/HF4Q: folds
OvwYHV65yUbgdBjSmo1+5g: folds
SyS20PAm3RpT6uLBsGkwOA: calls $1
qheQay5YvP2DMAb3OUSxtw: folds
9BZCcac3+McErkkSN2YScA: folds
PTAFYDIUSsG+SArbxNl+Aw: folds
yAbu2QsRPVcjPbqlf/jDxw: folds
997ViqAtWn1FPjJqcffwcA: checks
*** FLOP *** [5d Jc 3d]
997ViqAtWn1FPjJqcffwcA: checks
SyS20PAm3RpT6uLBsGkwOA: checks
*** TURN *** [5d Jc 3d] [Js]
997ViqAtWn1FPjJqcffwcA: checks
SyS20PAm3RpT6uLBsGkwOA: checks
*** RIVER *** [5d Jc 3d Js] [7s]
997ViqAtWn1FPjJqcffwcA: checks
SyS20PAm3RpT6uLBsGkwOA: checks
*** SHOW DOWN ***
997ViqAtWn1FPjJqcffwcA: shows [4s Kd] (a pair of Jacks)
SyS20PAm3RpT6uLBsGkwOA: shows [3h 6h] (two pair, Jacks and Threes)
SyS20PAm3RpT6uLBsGkwOA collected $2.40 from pot
*** SUMMARY ***
Total pot $2.50 | Rake $0.10
Board [5d Jc 3d Js 7s]
Seat 1: 9BZCcac3+McErkkSN2YScA folded before Flop (didn't bet)
Seat 2: PTAFYDIUSsG+SArbxNl+Aw (button) folded before Flop (didn't bet)
Seat 3: yAbu2QsRPVcjPbqlf/jDxw (small blind) folded before Flop
Seat 4: 997ViqAtWn1FPjJqcffwcA (big blind) showed [4s Kd] and lost with a pair of Jacks
Seat 5: PkGfq5xrSlNsujKaG/HF4Q folded before Flop (didn't bet)
Seat 6: OvwYHV65yUbgdBjSmo1+5g folded before Flop (didn't bet)
Seat 7: SyS20PAm3RpT6uLBsGkwOA showed [3h 6h] and won ($2.40) with two pair, Jacks and Threes
Seat 9: qheQay5YvP2DMAb3OUSxtw folded before Flop (didn't bet)



PokerStars Game #59941365266:  Hold'em No Limit ($0.50/$1.00) - 2009/07/01 1:33:21 ET
Table 'NqGO/cV3MwFAx+ZPB5ANmQ' 2-max Seat #2 is the button
Seat 1: ItaRAnHOgvYOv5ynbG1iTw ($128.70 in chips)
Seat 2: GtFB+yyeb2djMdPFuOW/Xg ($160.70 in chips)
GtFB+yyeb2djMdPFuOW/Xg: posts small blind $0.50
ItaRAnHOgvYOv5ynbG1iTw: posts big blind $1
*** HOLE CARDS ***
GtFB+yyeb2djMdPFuOW/Xg: raises $2 to $3
ItaRAnHOgvYOv5ynbG1iTw: folds
GtFB+yyeb2djMdPFuOW/Xg collected $2 from pot
*** SUMMARY ***
Total pot $2 | Rake $0
Seat 1: ItaRAnHOgvYOv5ynbG1iTw (big blind) folded before Flop
Seat 2: GtFB+yyeb2djMdPFuOW/Xg (button) (small blind) collected ($2)



PokerStars Game #59941365578:  Hold'em No Limit ($0.50/$1.00) - 2009/07/01 1:33:21 ET
Table 'pHrhryH8jPNdQfY62f8v+g' 6-max Seat #1 is the button
Seat 1: 4d1rWhpu8DzLmzMbR3QKyA ($142.75 in chips)
Seat 2: JwCcjZl0bjJzG7hmE0dnTA ($116.55 in chips)
Seat 3: 8oS5O7iD/qnFXFXJrGIgNQ ($114.30 in chips)
Seat 4: 1f3beyIML24UqEMTbWy93g ($60.20 in chips)
Seat 5: d8WX+9nUHoqlrAGagO0Wow ($18.50 in chips)
Seat 6: xAU6q2/cwmby2sxmA8VcmA ($176.75 in chips)
JwCcjZl0bjJzG7hmE0dnTA: posts small blind $0.50
8oS5O7iD/qnFXFXJrGIgNQ: posts big blind $1
*** HOLE CARDS ***
1f3beyIML24UqEMTbWy93g: folds
d8WX+9nUHoqlrAGagO0Wow: folds
xAU6q2/cwmby2sxmA8VcmA: folds
4d1rWhpu8DzLmzMbR3QKyA: raises $2 to $3
JwCcjZl0bjJzG7hmE0dnTA: folds
8oS5O7iD/qnFXFXJrGIgNQ: calls $2
*** FLOP *** [Jh 7c Jc]
8oS5O7iD/qnFXFXJrGIgNQ: checks
4d1rWhpu8DzLmzMbR3QKyA: bets $5
8oS5O7iD/qnFXFXJrGIgNQ: folds
4d1rWhpu8DzLmzMbR3QKyA collected $6.20 from pot
*** SUMMARY ***
Total pot $6.50 | Rake $0.30
Board [Jh 7c Jc]
Seat 1: 4d1rWhpu8DzLmzMbR3QKyA (button) collected ($6.20)
Seat 2: JwCcjZl0bjJzG7hmE0dnTA (small blind) folded before Flop
Seat 3: 8oS5O7iD/qnFXFXJrGIgNQ (big blind) folded on the Flop
Seat 4: 1f3beyIML24UqEMTbWy93g folded before Flop (didn't bet)
Seat 5: d8WX+9nUHoqlrAGagO0Wow folded before Flop (didn't bet)
Seat 6: xAU6q2/cwmby2sxmA8VcmA folded before Flop (didn't bet)



PokerStars Game #59941365598:  Hold'em No Limit ($0.50/$1.00) - 2009/07/01 1:33:21 ET
Table 'ZFWj23PMihdwrNWv41OG/QtyUh+jyNvrceIQdKMJjQ2weat #6 is the button
Seat 1: j3hj7KQwBVU5NTFmtYomSw ($44.20 in chips)
Seat 2: 0smcry9L0OOTCP+KzIS5SA ($100 in chips)
Seat 3: cWwhvq/+r/w8nkhwrJoekQ ($40.35 in chips)
Seat 4: O5ZesE/6mHyuWWbvkiH/Fg ($42.35 in chips)
Seat 5: j7NIOHLZk7V2o9fOioO5ug ($101 in chips)
Seat 6: u23r4AyKPgHioZ6t7z6qrA ($98.50 in chips)
j3hj7KQwBVU5NTFmtYomSw: posts small blind $0.50
0smcry9L0OOTCP+KzIS5SA: posts big blind $1
*** HOLE CARDS ***
cWwhvq/+r/w8nkhwrJoekQ: calls $1
O5ZesE/6mHyuWWbvkiH/Fg: folds
j7NIOHLZk7V2o9fOioO5ug: raises $4 to $5
u23r4AyKPgHioZ6t7z6qrA: calls $5
j3hj7KQwBVU5NTFmtYomSw: folds
0smcry9L0OOTCP+KzIS5SA: folds
cWwhvq/+r/w8nkhwrJoekQ: raises $35.35 to $40.35 and is all-in
j7NIOHLZk7V2o9fOioO5ug: folds
u23r4AyKPgHioZ6t7z6qrA: folds
cWwhvq/+r/w8nkhwrJoekQ collected $16.50 from pot
*** SUMMARY ***
Total pot $16.50 | Rake $0
Seat 1: j3hj7KQwBVU5NTFmtYomSw (small blind) folded before Flop
Seat 2: 0smcry9L0OOTCP+KzIS5SA (big blind) folded before Flop
Seat 3: cWwhvq/+r/w8nkhwrJoekQ collected ($16.50)
Seat 4: O5ZesE/6mHyuWWbvkiH/Fg folded before Flop (didn't bet)
Seat 5: j7NIOHLZk7V2o9fOioO5ug folded before Flop
Seat 6: u23r4AyKPgHioZ6t7z6qrA (button) folded before Flop



PokerStars Game #59941367084:  Hold'em No Limit ($0.50/$1.00) - 2009/07/01 1:33:24 ET
Table '305hiksPPCCdC6V2LNsO5w' 6-max Seat #1 is the button
Seat 1: RTuDLJHh/9zPfBftoc9vsw ($9.50 in chips)
Seat 2: j7NIOHLZk7V2o9fOioO5ug ($131 in chips)
Seat 3: +zIVjZKLpcidfRHgVZW8lA ($28.70 in chips)
Seat 4: uJVSceLggtsrJya+WtmUEA ($222.30 in chips)
Seat 5: +Nt3OPk3XR9SKjZgm2CexQ ($109.15 in chips)
Seat 6: 9/Tq8dw7kWW68uN8bFupXg ($16.40 in chips)
j7NIOHLZk7V2o9fOioO5ug: posts small blind $0.50
+zIVjZKLpcidfRHgVZW8lA: posts big blind $1
*** HOLE CARDS ***
uJVSceLggtsrJya+WtmUEA: folds
+Nt3OPk3XR9SKjZgm2CexQ: raises $2 to $3
9/Tq8dw7kWW68uN8bFupXg: folds
RTuDLJHh/9zPfBftoc9vsw: folds
j7NIOHLZk7V2o9fOioO5ug: folds
+zIVjZKLpcidfRHgVZW8lA: folds
+Nt3OPk3XR9SKjZgm2CexQ collected $2.50 from pot
*** SUMMARY ***
Total pot $2.50 | Rake $0
Seat 1: RTuDLJHh/9zPfBftoc9vsw (button) folded before Flop (didn't bet)
Seat 2: j7NIOHLZk7V2o9fOioO5ug (small blind) folded before Flop
Seat 3: +zIVjZKLpcidfRHgVZW8lA (big blind) folded before Flop
Seat 4: uJVSceLggtsrJya+WtmUEA folded before Flop (didn't bet)
Seat 5: +Nt3OPk3XR9SKjZgm2CexQ collected ($2.50)
Seat 6: 9/Tq8dw7kWW68uN8bFupXg folded before Flop (didn't bet)



PokerStars Game #59941367286:  Hold'em No Limit ($0.50/$1.00) - 2009/07/01 1:33:24 ET
Table 'tHb+N6GaPEmmBAe36B2R9Q' 2-max Seat #1 is the button
Seat 1: rL+Zpv4/vX2BVHcyfh/NXA ($117.90 in chips)
Seat 2: Pm1sDZZi0zFtnFGXLznkug ($113.20 in chips)
rL+Zpv4/vX2BVHcyfh/NXA: posts small blind $0.50
Pm1sDZZi0zFtnFGXLznkug: posts big blind $1
*** HOLE CARDS ***
rL+Zpv4/vX2BVHcyfh/NXA: raises $2 to $3
Pm1sDZZi0zFtnFGXLznkug: calls $2
*** FLOP *** [As 5c 6h]
Pm1sDZZi0zFtnFGXLznkug: checks
rL+Zpv4/vX2BVHcyfh/NXA: bets $4
Pm1sDZZi0zFtnFGXLznkug: calls $4
*** TURN *** [As 5c 6h] [3h]
Pm1sDZZi0zFtnFGXLznkug: checks
rL+Zpv4/vX2BVHcyfh/NXA: bets $9
Pm1sDZZi0zFtnFGXLznkug: calls $9
*** RIVER *** [As 5c 6h 3h] [4d]
Pm1sDZZi0zFtnFGXLznkug: checks
rL+Zpv4/vX2BVHcyfh/NXA: checks
*** SHOW DOWN ***
Pm1sDZZi0zFtnFGXLznkug: shows [3c 3s] (three of a kind, Threes)
rL+Zpv4/vX2BVHcyfh/NXA: mucks hand
Pm1sDZZi0zFtnFGXLznkug collected $31.50 from pot
*** SUMMARY ***
Total pot $32 | Rake $0.50
Board [As 5c 6h 3h 4d]
Seat 1: rL+Zpv4/vX2BVHcyfh/NXA (button) (small blind) mucked
Seat 2: Pm1sDZZi0zFtnFGXLznkug (big blind) showed [3c 3s] and won ($31.50) with three of a kind, Threes



PokerStars Game #59941367248:  Hold'em No Limit ($0.50/$1.00) - 2009/07/01 1:33:24 ET
Table 'rK8IGAmHXd06C9ia4Dis4A' 2-max Seat #2 is the button
Seat 1: FeErMt4Gvt/3PH2oB/pn4A ($19.50 in chips)
Seat 2: mgi+mjKb1Sc3CCs7TlfoCw ($69.85 in chips)
mgi+mjKb1Sc3CCs7TlfoCw: posts small blind $0.50
FeErMt4Gvt/3PH2oB/pn4A: posts big blind $1
*** HOLE CARDS ***
mgi+mjKb1Sc3CCs7TlfoCw: raises $2 to $3
FeErMt4Gvt/3PH2oB/pn4A: calls $2
*** FLOP *** [6h 8c 7h]
FeErMt4Gvt/3PH2oB/pn4A: checks
mgi+mjKb1Sc3CCs7TlfoCw: checks
*** TURN *** [6h 8c 7h] [3d]
FeErMt4Gvt/3PH2oB/pn4A: bets $2
mgi+mjKb1Sc3CCs7TlfoCw: calls $2
*** RIVER *** [6h 8c 7h 3d] [9c]
FeErMt4Gvt/3PH2oB/pn4A: bets $3.50
mgi+mjKb1Sc3CCs7TlfoCw: raises $17.50 to $21
FeErMt4Gvt/3PH2oB/pn4A: calls $11 and is all-in
*** SHOW DOWN ***
mgi+mjKb1Sc3CCs7TlfoCw: shows [5d 2d] (a straight, Five to Nine)
FeErMt4Gvt/3PH2oB/pn4A: shows [Td Kh] (a straight, Six to Ten)
FeErMt4Gvt/3PH2oB/pn4A collected $38.50 from pot
*** SUMMARY ***
Total pot $39 | Rake $0.50
Board [6h 8c 7h 3d 9c]
Seat 1: FeErMt4Gvt/3PH2oB/pn4A (big blind) showed [Td Kh] and won ($38.50) with a straight, Six to Ten
Seat 2: mgi+mjKb1Sc3CCs7TlfoCw (button) (small blind) showed [5d 2d] and lost with a straight, Five to Nine



PokerStars Game #59941367254:  Hold'em No Limit ($0.50/$1.00) - 2009/07/01 1:33:24 ET
Table '/FUb199IViHMJHi5YWmeuQ' 9-max Seat #3 is the button
Seat 1: 3obndzTJ6fECz8+wWhMd1w ($32.30 in chips)
Seat 2: FL3MrLspcF23LYvC4ipBOA ($184.05 in chips)
Seat 3: V138SURkdX8LdVBPKdJJag ($100.75 in chips)
Seat 4: pbAfmxe4uSZPxJQX7gOzZA ($67.15 in chips)
Seat 6: VPF+HjszMvUIpy0CHIwH3A ($21.50 in chips)
Seat 7: myIxN7otsyr846M539YR8Q ($27 in chips)
Seat 8: 997ViqAtWn1FPjJqcffwcA ($101 in chips)
Seat 9: RfLbneGRY8yQUpMgDnJCxA ($75.20 in chips)
pbAfmxe4uSZPxJQX7gOzZA: posts small blind $0.50
H+DVy3Ei8L1UKS2tVOtJcw: is sitting out
VPF+HjszMvUIpy0CHIwH3A: posts big blind $1
*** HOLE CARDS ***
H+DVy3Ei8L1UKS2tVOtJcw leaves the table
myIxN7otsyr846M539YR8Q: folds
997ViqAtWn1FPjJqcffwcA: folds
RfLbneGRY8yQUpMgDnJCxA: calls $1
3obndzTJ6fECz8+wWhMd1w: folds
FL3MrLspcF23LYvC4ipBOA: folds
V138SURkdX8LdVBPKdJJag: folds
pbAfmxe4uSZPxJQX7gOzZA: calls $0.50
VPF+HjszMvUIpy0CHIwH3A: raises $20.50 to $21.50 and is all-in
1862487932 joins the table at seat #5
RfLbneGRY8yQUpMgDnJCxA: folds
pbAfmxe4uSZPxJQX7gOzZA: calls $20.50
*** FLOP *** [Ac 6d Tc]
*** TURN *** [Ac 6d Tc] [Qs]
*** RIVER *** [Ac 6d Tc Qs] [7c]
*** SHOW DOWN ***
pbAfmxe4uSZPxJQX7gOzZA: shows [As 3c] (a pair of Aces)
VPF+HjszMvUIpy0CHIwH3A: shows [Kd Ah] (a pair of Aces - King kicker)
VPF+HjszMvUIpy0CHIwH3A collected $41.80 from pot
*** SUMMARY ***
Total pot $44 | Rake $2.20
Board [Ac 6d Tc Qs 7c]
Seat 1: 3obndzTJ6fECz8+wWhMd1w folded before Flop (didn't bet)
Seat 2: FL3MrLspcF23LYvC4ipBOA folded before Flop (didn't bet)
Seat 3: V138SURkdX8LdVBPKdJJag (button) folded before Flop (didn't bet)
Seat 4: pbAfmxe4uSZPxJQX7gOzZA (small blind) showed [As 3c] and lost with a pair of Aces
Seat 6: VPF+HjszMvUIpy0CHIwH3A (big blind) showed [Kd Ah] and won ($41.80) with a pair of Aces
Seat 7: myIxN7otsyr846M539YR8Q folded before Flop (didn't bet)
Seat 8: 997ViqAtWn1FPjJqcffwcA folded before Flop (didn't bet)
Seat 9: RfLbneGRY8yQUpMgDnJCxA folded before Flop



PokerStars Game #59941368018:  Hold'em No Limit ($0.50/$1.00) - 2009/07/01 1:33:26 ET
Table '7O9fB8yx1u7sJveJn8w6jA' 6-max Seat #4 is the button
Seat 1: 841740 ($50.45 in chips)
Seat 2: wx3sQGkVi2x9wJXuWNHPBw ($197.70 in chips)
Seat 3: hpxXcmRkXXI9HE5+5/j/0Q ($142.90 in chips)
Seat 4: b2a+5TkFf4xJN/Ihhma58Q ($33.85 in chips)
Seat 5: BCEV3COoKY607AzLWayfRA ($100.50 in chips)
Seat 6: r4lpoh2BJZ8S6zyQv1JeSw ($100 in chips)
BCEV3COoKY607AzLWayfRA: posts small blind $0.50
r4lpoh2BJZ8S6zyQv1JeSw: posts big blind $1
*** HOLE CARDS ***
841740: folds
wx3sQGkVi2x9wJXuWNHPBw: raises $3 to $4
hpxXcmRkXXI9HE5+5/j/0Q: folds
b2a+5TkFf4xJN/Ihhma58Q: folds
BCEV3COoKY607AzLWayfRA: folds
r4lpoh2BJZ8S6zyQv1JeSw: folds
wx3sQGkVi2x9wJXuWNHPBw collected $2.50 from pot
*** SUMMARY ***
Total pot $2.50 | Rake $0
Seat 1: 841740 folded before Flop (didn't bet)
Seat 2: wx3sQGkVi2x9wJXuWNHPBw collected ($2.50)
Seat 3: hpxXcmRkXXI9HE5+5/j/0Q folded before Flop (didn't bet)
Seat 4: b2a+5TkFf4xJN/Ihhma58Q (button) folded before Flop (didn't bet)
Seat 5: BCEV3COoKY607AzLWayfRA (small blind) folded before Flop
Seat 6: r4lpoh2BJZ8S6zyQv1JeSw (big blind) folded before Flop



PokerStars Game #59941368706:  Hold'em No Limit ($0.50/$1.00) - 2009/07/01 1:33:27 ET
Table 'O96CPOtvMBWP6kzuYDfdFA' 6-max Seat #2 is the button
Seat 1: 6alLXQIITA2EZ/lBeym8Dw ($123.75 in chips)
Seat 2: 4d1rWhpu8DzLmzMbR3QKyA ($103 in chips)
Seat 4: /P4w1pHg2zHYg/4ubJ0dPw ($65.65 in chips)
Seat 6: 3syOXva630dm1FTdwnuLpw ($76.65 in chips)
/P4w1pHg2zHYg/4ubJ0dPw: posts small blind $0.50
3syOXva630dm1FTdwnuLpw: posts big blind $1
*** HOLE CARDS ***
6alLXQIITA2EZ/lBeym8Dw: folds
4d1rWhpu8DzLmzMbR3QKyA: raises $2 to $3
/P4w1pHg2zHYg/4ubJ0dPw: folds
G5ZSSN6RSON3gkNvk/SmYg leaves the table
3syOXva630dm1FTdwnuLpw: raises $6 to $9
4d1rWhpu8DzLmzMbR3QKyA: folds
3syOXva630dm1FTdwnuLpw collected $6.50 from pot
*** SUMMARY ***
Total pot $6.50 | Rake $0
Seat 1: 6alLXQIITA2EZ/lBeym8Dw folded before Flop (didn't bet)
Seat 2: 4d1rWhpu8DzLmzMbR3QKyA (button) folded before Flop
Seat 4: /P4w1pHg2zHYg/4ubJ0dPw (small blind) folded before Flop
Seat 6: 3syOXva630dm1FTdwnuLpw (big blind) collected ($6.50)



PokerStars Game #59941368694:  Hold'em No Limit ($0.50/$1.00) - 2009/07/01 1:33:27 ET
Table 'kS0cTQAEi+fdUlJP2gQYvw' 9-max Seat #9 is the button
Seat 1: SqsWPukL8kLqrhq5ZrQdSQ ($98 in chips)
Seat 3: 2BV+oJIQYr65IO6nEChvbA ($64.55 in chips)
Seat 4: RUhhaALzha3TH1AkdakoGQ ($52.50 in chips)
Seat 5: 997ViqAtWn1FPjJqcffwcA ($100 in chips)
Seat 6: yAbu2QsRPVcjPbqlf/jDxw ($118.65 in chips)
Seat 7: Ffa7Nj4X5fddtROP01hfQg ($145.50 in chips)
Seat 8: vKyFzTyzfT7fZcdX+HHN+Q ($40.35 in chips)
Seat 9: OGgaARGdJQT4awWVNQ957w ($107.20 in chips)
SqsWPukL8kLqrhq5ZrQdSQ: posts small blind $0.50
D+W9Me7w6Hcx/WRUSKV0dw: is sitting out
2BV+oJIQYr65IO6nEChvbA: posts big blind $1
*** HOLE CARDS ***
D+W9Me7w6Hcx/WRUSKV0dw leaves the table
RUhhaALzha3TH1AkdakoGQ: folds
997ViqAtWn1FPjJqcffwcA: folds
yAbu2QsRPVcjPbqlf/jDxw: folds
Ffa7Nj4X5fddtROP01hfQg: folds
vKyFzTyzfT7fZcdX+HHN+Q: calls $1
OGgaARGdJQT4awWVNQ957w: folds
SqsWPukL8kLqrhq5ZrQdSQ: raises $3 to $4
2BV+oJIQYr65IO6nEChvbA: folds
vKyFzTyzfT7fZcdX+HHN+Q: calls $3
*** FLOP *** [8s 8h Kd]
SqsWPukL8kLqrhq5ZrQdSQ: bets $4
vKyFzTyzfT7fZcdX+HHN+Q: raises $32.35 to $36.35 and is all-in
SqsWPukL8kLqrhq5ZrQdSQ: folds
vKyFzTyzfT7fZcdX+HHN+Q collected $16.20 from pot
*** SUMMARY ***
Total pot $17 | Rake $0.80
Board [8s 8h Kd]
Seat 1: SqsWPukL8kLqrhq5ZrQdSQ (small blind) folded on the Flop
Seat 3: 2BV+oJIQYr65IO6nEChvbA (big blind) folded before Flop
Seat 4: RUhhaALzha3TH1AkdakoGQ folded before Flop (didn't bet)
Seat 5: 997ViqAtWn1FPjJqcffwcA folded before Flop (didn't bet)
Seat 6: yAbu2QsRPVcjPbqlf/jDxw folded before Flop (didn't bet)
Seat 7: Ffa7Nj4X5fddtROP01hfQg folded before Flop (didn't bet)
Seat 8: vKyFzTyzfT7fZcdX+HHN+Q collected ($16.20)
Seat 9: OGgaARGdJQT4awWVNQ957w (button) folded before Flop (didn't bet)



PokerStars Game #59941369770:  Hold'em No Limit ($0.50/$1.00) - 2009/07/01 1:33:29 ET
Table 'W/wyObTiXZm+Ckkl3YxcSw' 6-max Seat #5 is the button
Seat 1: eUBBn2R56C1IQ6Cs/vitwg ($295.55 in chips)
Seat 2: oDiBRCaF0QVtd3kO6xZIXw ($161.40 in chips)
Seat 3: dxyNCn/qxfkGDUIf28Cbng ($59.80 in chips)
Seat 4: UBZQqpnJZdTYYY1FTb0rLA ($103.20 in chips)
Seat 5: +OrCjyw70oZhJiD22Mn+bg ($101 in chips)
Seat 6: b2a+5TkFf4xJN/Ihhma58Q ($36.30 in chips)
b2a+5TkFf4xJN/Ihhma58Q: posts small blind $0.50
eUBBn2R56C1IQ6Cs/vitwg: posts big blind $1
*** HOLE CARDS ***
oDiBRCaF0QVtd3kO6xZIXw: folds
dxyNCn/qxfkGDUIf28Cbng: folds
UBZQqpnJZdTYYY1FTb0rLA: raises $2 to $3
+OrCjyw70oZhJiD22Mn+bg: raises $7 to $10
b2a+5TkFf4xJN/Ihhma58Q: folds
eUBBn2R56C1IQ6Cs/vitwg: folds
UBZQqpnJZdTYYY1FTb0rLA: folds
+OrCjyw70oZhJiD22Mn+bg collected $7.50 from pot
+OrCjyw70oZhJiD22Mn+bg: doesn't show hand
*** SUMMARY ***
Total pot $7.50 | Rake $0
Seat 1: eUBBn2R56C1IQ6Cs/vitwg (big blind) folded before Flop
Seat 2: oDiBRCaF0QVtd3kO6xZIXw folded before Flop (didn't bet)
Seat 3: dxyNCn/qxfkGDUIf28Cbng folded before Flop (didn't bet)
Seat 4: UBZQqpnJZdTYYY1FTb0rLA folded before Flop
Seat 5: +OrCjyw70oZhJiD22Mn+bg (button) collected ($7.50)
Seat 6: b2a+5TkFf4xJN/Ihhma58Q (small blind) folded before Flop



PokerStars Game #59941370674:  Hold'em No Limit ($0.50/$1.00) - 2009/07/01 1:33:30 ET
Table 'N6LvHFrb+cdXY/COI6ByOw' 2-max Seat #1 is the button
Seat 1: lXX4W7m3u++JiSOZ46yVMQ ($27.45 in chips)
Seat 2: 9mAoSP3o/mikSZOW2LEEAw ($168.20 in chips)
lXX4W7m3u++JiSOZ46yVMQ: posts small blind $0.50
9mAoSP3o/mikSZOW2LEEAw: posts big blind $1
*** HOLE CARDS ***
lXX4W7m3u++JiSOZ46yVMQ: raises $2 to $3
9mAoSP3o/mikSZOW2LEEAw: calls $2
*** FLOP *** [6h Qd 5s]
9mAoSP3o/mikSZOW2LEEAw: bets $1
lXX4W7m3u++JiSOZ46yVMQ: calls $1
*** TURN *** [6h Qd 5s] [Ad]
9mAoSP3o/mikSZOW2LEEAw: checks
lXX4W7m3u++JiSOZ46yVMQ: checks
*** RIVER *** [6h Qd 5s Ad] [6s]
9mAoSP3o/mikSZOW2LEEAw: bets $4
lXX4W7m3u++JiSOZ46yVMQ: calls $4
*** SHOW DOWN ***
9mAoSP3o/mikSZOW2LEEAw: shows [7h 6d] (three of a kind, Sixes)
lXX4W7m3u++JiSOZ46yVMQ: mucks hand
9mAoSP3o/mikSZOW2LEEAw collected $15.50 from pot
*** SUMMARY ***
Total pot $16 | Rake $0.50
Board [6h Qd 5s Ad 6s]
Seat 1: lXX4W7m3u++JiSOZ46yVMQ (button) (small blind) mucked
Seat 2: 9mAoSP3o/mikSZOW2LEEAw (big blind) showed [7h 6d] and won ($15.50) with three of a kind, Sixes



PokerStars Game #59941372790:  Hold'em No Limit ($0.50/$1.00) - 2009/07/01 1:33:34 ET
Table '/RZcOwpZpHQ+OwPwjsbnRw' 6-max Seat #3 is the button
Seat 1: +uSzP8Jwnw7sKfQ4s66b7w ($39.25 in chips)
Seat 2: Z2fXsGcjl+Eax+RzOgwOmg ($101.15 in chips)
Seat 3: LJMw/I77xpnw0R5T4HnMUg ($95.80 in chips)
Seat 4: j7NIOHLZk7V2o9fOioO5ug ($100.50 in chips)
Seat 5: wx3sQGkVi2x9wJXuWNHPBw ($167.25 in chips)
Seat 6: o3YLm/rSY916m/on1VjXPA ($214 in chips)
j7NIOHLZk7V2o9fOioO5ug: posts small blind $0.50
wx3sQGkVi2x9wJXuWNHPBw: posts big blind $1
*** HOLE CARDS ***
o3YLm/rSY916m/on1VjXPA: folds
+uSzP8Jwnw7sKfQ4s66b7w: folds
Z2fXsGcjl+Eax+RzOgwOmg: raises $3 to $4
LJMw/I77xpnw0R5T4HnMUg: calls $4
j7NIOHLZk7V2o9fOioO5ug: folds
wx3sQGkVi2x9wJXuWNHPBw: folds
*** FLOP *** [Ks Qc 8s]
Z2fXsGcjl+Eax+RzOgwOmg: bets $7
LJMw/I77xpnw0R5T4HnMUg: raises $7 to $14
Z2fXsGcjl+Eax+RzOgwOmg: folds
LJMw/I77xpnw0R5T4HnMUg collected $22.35 from pot
LJMw/I77xpnw0R5T4HnMUg: doesn't show hand
*** SUMMARY ***
Total pot $23.50 | Rake $1.15
Board [Ks Qc 8s]
Seat 1: +uSzP8Jwnw7sKfQ4s66b7w folded before Flop (didn't bet)
Seat 2: Z2fXsGcjl+Eax+RzOgwOmg folded on the Flop
Seat 3: LJMw/I77xpnw0R5T4HnMUg (button) collected ($22.35)
Seat 4: j7NIOHLZk7V2o9fOioO5ug (small blind) folded before Flop
Seat 5: wx3sQGkVi2x9wJXuWNHPBw (big blind) folded before Flop
Seat 6: o3YLm/rSY916m/on1VjXPA folded before Flop (didn't bet)



PokerStars Game #59941373162:  Hold'em No Limit ($0.50/$1.00) - 2009/07/01 1:33:35 ET
Table 'tJq9SfN1ywY0r03VBlWlwQ' 9-max Seat #6 is the button
Seat 1: wZsU+w9r7G66x93UuvBf1Q ($299.05 in chips)
Seat 2: VPF+HjszMvUIpy0CHIwH3A ($20 in chips)
Seat 4: bLbSOSmSOnqE0iTcH/5dxA ($114.20 in chips)
Seat 5: h5ipsNTMyolp7xn/NAvWkA ($133.40 in chips)
Seat 6: gUUvmqdVlmvpal6B8nYrmg ($100 in chips)
Seat 7: Ogn4JDV3mp4ZDKO49IFzKA ($19 in chips)
Seat 8: G4DEhsZFmznGNVpy2SEocA ($42.30 in chips)
Seat 9: XE5QF1y74bpHog9JxWJMWQ ($100 in chips)
Ogn4JDV3mp4ZDKO49IFzKA: posts small blind $0.50
G4DEhsZFmznGNVpy2SEocA: posts big blind $1
*** HOLE CARDS ***
XE5QF1y74bpHog9JxWJMWQ: folds
wZsU+w9r7G66x93UuvBf1Q: folds
VPF+HjszMvUIpy0CHIwH3A: folds
bLbSOSmSOnqE0iTcH/5dxA: folds
h5ipsNTMyolp7xn/NAvWkA: calls $1
gUUvmqdVlmvpal6B8nYrmg: folds
Ogn4JDV3mp4ZDKO49IFzKA: folds
G4DEhsZFmznGNVpy2SEocA: checks
*** FLOP *** [Ad Qs 3s]
G4DEhsZFmznGNVpy2SEocA: checks
h5ipsNTMyolp7xn/NAvWkA: bets $3
G4DEhsZFmznGNVpy2SEocA: folds
h5ipsNTMyolp7xn/NAvWkA collected $2.40 from pot
*** SUMMARY ***
Total pot $2.50 | Rake $0.10
Board [Ad Qs 3s]
Seat 1: wZsU+w9r7G66x93UuvBf1Q folded before Flop (didn't bet)
Seat 2: VPF+HjszMvUIpy0CHIwH3A folded before Flop (didn't bet)
Seat 4: bLbSOSmSOnqE0iTcH/5dxA folded before Flop (didn't bet)
Seat 5: h5ipsNTMyolp7xn/NAvWkA collected ($2.40)
Seat 6: gUUvmqdVlmvpal6B8nYrmg (button) folded before Flop (didn't bet)
Seat 7: Ogn4JDV3mp4ZDKO49IFzKA (small blind) folded before Flop
Seat 8: G4DEhsZFmznGNVpy2SEocA (big blind) folded on the Flop
Seat 9: XE5QF1y74bpHog9JxWJMWQ folded before Flop (didn't bet)



PokerStars Game #59941375172:  Hold'em No Limit ($0.50/$1.00) - 2009/07/01 1:33:38 ET
Table 'CASNP0uy1C+jGLml/I4PtA' 9-max Seat #7 is the button
Seat 1: tkdBeXTJlFsZdioidNqLow ($73.60 in chips)
Seat 2: LUsAYklr0mQkiq7ASOyD9A ($65.55 in chips)
Seat 4: B/G0GJacqZ8K59/ZVdq4kQ ($52.55 in chips)
Seat 5: Jjc7EHWzs4//xUAjJ0UWoA ($12 in chips)
Seat 6: FJEywSpo5JbRKByzmweboA ($100 in chips)
Seat 7: S3Ex8K7v6xm5jqjRM7Fl3w ($20.50 in chips)
Seat 8: L9njYvloJ1NdXjP8edHEAg ($103.45 in chips)
Seat 9: Pp/KTcXkfZKKUHkjyaLTdg ($24.10 in chips)
L9njYvloJ1NdXjP8edHEAg: posts small blind $0.50
Pp/KTcXkfZKKUHkjyaLTdg: posts big blind $1
*** HOLE CARDS ***
tkdBeXTJlFsZdioidNqLow: folds
LUsAYklr0mQkiq7ASOyD9A: folds
B/G0GJacqZ8K59/ZVdq4kQ: raises $5 to $6
Jjc7EHWzs4//xUAjJ0UWoA: folds
FJEywSpo5JbRKByzmweboA: calls $6
S3Ex8K7v6xm5jqjRM7Fl3w: folds
L9njYvloJ1NdXjP8edHEAg: folds
Pp/KTcXkfZKKUHkjyaLTdg: folds
*** FLOP *** [7h Qs Td]
B/G0GJacqZ8K59/ZVdq4kQ: checks
FJEywSpo5JbRKByzmweboA: bets $8.90
B/G0GJacqZ8K59/ZVdq4kQ: calls $8.90
*** TURN *** [7h Qs Td] [Tc]
B/G0GJacqZ8K59/ZVdq4kQ: bets $5
FJEywSpo5JbRKByzmweboA: calls $5
*** RIVER *** [7h Qs Td Tc] [Th]
B/G0GJacqZ8K59/ZVdq4kQ: bets $12
FJEywSpo5JbRKByzmweboA: calls $12
*** SHOW DOWN ***
B/G0GJacqZ8K59/ZVdq4kQ: shows [Jc 9h] (three of a kind, Tens)
FJEywSpo5JbRKByzmweboA: shows [As Qh] (a full house, Tens full of Queens)
FJEywSpo5JbRKByzmweboA collected $62.30 from pot
*** SUMMARY ***
Total pot $65.30 | Rake $3
Board [7h Qs Td Tc Th]
Seat 1: tkdBeXTJlFsZdioidNqLow folded before Flop (didn't bet)
Seat 2: LUsAYklr0mQkiq7ASOyD9A folded before Flop (didn't bet)
Seat 4: B/G0GJacqZ8K59/ZVdq4kQ showed [Jc 9h] and lost with three of a kind, Tens
Seat 5: Jjc7EHWzs4//xUAjJ0UWoA folded before Flop (didn't bet)
Seat 6: FJEywSpo5JbRKByzmweboA showed [As Qh] and won ($62.30) with a full house, Tens full of Queens
Seat 7: S3Ex8K7v6xm5jqjRM7Fl3w (button) folded before Flop (didn't bet)
Seat 8: L9njYvloJ1NdXjP8edHEAg (small blind) folded before Flop
Seat 9: Pp/KTcXkfZKKUHkjyaLTdg (big blind) folded before Flop



PokerStars Game #59941375240:  Hold'em No Limit ($0.50/$1.00) - 2009/07/01 1:33:38 ET
Table 'NqGO/cV3MwFAx+ZPB5ANmQ' 2-max Seat #1 is the button
Seat 1: ItaRAnHOgvYOv5ynbG1iTw ($127.70 in chips)
Seat 2: GtFB+yyeb2djMdPFuOW/Xg ($161.70 in chips)
ItaRAnHOgvYOv5ynbG1iTw: posts small blind $0.50
GtFB+yyeb2djMdPFuOW/Xg: posts big blind $1
*** HOLE CARDS ***
ItaRAnHOgvYOv5ynbG1iTw: raises $2 to $3
GtFB+yyeb2djMdPFuOW/Xg: folds
ItaRAnHOgvYOv5ynbG1iTw collected $2 from pot
*** SUMMARY ***
Total pot $2 | Rake $0
Seat 1: ItaRAnHOgvYOv5ynbG1iTw (button) (small blind) collected ($2)
Seat 2: GtFB+yyeb2djMdPFuOW/Xg (big blind) folded before Flop



PokerStars Game #59941375382:  Hold'em No Limit ($0.50/$1.00) - 2009/07/01 1:33:39 ET
Table 'qj0HBN4HhQKogreu1bg7xg' 2-max Seat #2 is the button
Seat 1: NYi6JFscYNrofSXy4sM+Yw ($100 in chips)
Seat 2: qtyl8CSb0/4yWdbuEPJejA ($180.90 in chips)
qtyl8CSb0/4yWdbuEPJejA: posts small blind $0.50
NYi6JFscYNrofSXy4sM+Yw: posts big blind $1
*** HOLE CARDS ***
qtyl8CSb0/4yWdbuEPJejA: folds
NYi6JFscYNrofSXy4sM+Yw collected $1 from pot
*** SUMMARY ***
Total pot $1 | Rake $0
Seat 1: NYi6JFscYNrofSXy4sM+Yw (big blind) collected ($1)
Seat 2: qtyl8CSb0/4yWdbuEPJejA (button) (small blind) folded before Flop



PokerStars Game #59941375556:  Hold'em No Limit ($0.50/$1.00) - 2009/07/01 1:33:39 ET
Table 'MUPc8FEpe/nR0BKSeReX6Q' 6-max Seat #6 is the button
Seat 1: qhkK6+yCciTRd+rCFEbnEQ ($86.70 in chips)
Seat 2: xAU6q2/cwmby2sxmA8VcmA ($105.20 in chips)
Seat 3: wx3sQGkVi2x9wJXuWNHPBw ($284 in chips)
Seat 4: r4lpoh2BJZ8S6zyQv1JeSw ($112 in chips)
Seat 5: y27w5IK2WXqmYzS8OU0wKA ($101.55 in chips)
Seat 6: cl/QpVR/PLO58lj+C5mGLw ($27.90 in chips)
qhkK6+yCciTRd+rCFEbnEQ: posts small blind $0.50
xAU6q2/cwmby2sxmA8VcmA: posts big blind $1
*** HOLE CARDS ***
wx3sQGkVi2x9wJXuWNHPBw: folds
r4lpoh2BJZ8S6zyQv1JeSw: folds
y27w5IK2WXqmYzS8OU0wKA: folds
cl/QpVR/PLO58lj+C5mGLw: raises $2 to $3
qhkK6+yCciTRd+rCFEbnEQ: calls $2.50
xAU6q2/cwmby2sxmA8VcmA: folds
*** FLOP *** [5d 6d 3s]
qhkK6+yCciTRd+rCFEbnEQ: checks
cl/QpVR/PLO58lj+C5mGLw: checks
*** TURN *** [5d 6d 3s] [Jh]
qhkK6+yCciTRd+rCFEbnEQ: checks
cl/QpVR/PLO58lj+C5mGLw: bets $1
qhkK6+yCciTRd+rCFEbnEQ: raises $6 to $7
cl/QpVR/PLO58lj+C5mGLw: calls $6
*** RIVER *** [5d 6d 3s Jh] [9s]
qhkK6+yCciTRd+rCFEbnEQ: bets $17
cl/QpVR/PLO58lj+C5mGLw: calls $17
*** SHOW DOWN ***
qhkK6+yCciTRd+rCFEbnEQ: shows [Qh Qc] (a pair of Queens)
cl/QpVR/PLO58lj+C5mGLw: shows [5c 5s] (three of a kind, Fives)
cl/QpVR/PLO58lj+C5mGLw collected $52.30 from pot
*** SUMMARY ***
Total pot $55 | Rake $2.70
Board [5d 6d 3s Jh 9s]
Seat 1: qhkK6+yCciTRd+rCFEbnEQ (small blind) showed [Qh Qc] and lost with a pair of Queens
Seat 2: xAU6q2/cwmby2sxmA8VcmA (big blind) folded before Flop
Seat 3: wx3sQGkVi2x9wJXuWNHPBw folded before Flop (didn't bet)
Seat 4: r4lpoh2BJZ8S6zyQv1JeSw folded before Flop (didn't bet)
Seat 5: y27w5IK2WXqmYzS8OU0wKA folded before Flop (didn't bet)
Seat 6: cl/QpVR/PLO58lj+C5mGLw (button) showed [5c 5s] and won ($52.30) with three of a kind, Fives



PokerStars Game #59941376072:  Hold'em No Limit ($0.50/$1.00) - 2009/07/01 1:33:40 ET
Table '7Nl0ffnjeK44/vmeexh3MQ' 9-max Seat #4 is the button
Seat 1: V138SURkdX8LdVBPKdJJag ($101.50 in chips)
Seat 2: OGgaARGdJQT4awWVNQ957w ($100 in chips)
Seat 3: JMmUYT5pIKCKh2pGjCB/4w ($58.40 in chips)
Seat 4: bLbSOSmSOnqE0iTcH/5dxA ($106.80 in chips)
Seat 5: 61sfw5QTu62YYIt68OsdrA ($79 in chips)
Seat 6: FVs16t7GgfWgQWt4JxsObQ ($27.10 in chips)
Seat 7: 997ViqAtWn1FPjJqcffwcA ($100 in chips)
Seat 9: /JHoNdt0fK6X+isrqRfV3w ($20 in chips)
61sfw5QTu62YYIt68OsdrA: posts small blind $0.50
FVs16t7GgfWgQWt4JxsObQ: posts big blind $1
*** HOLE CARDS ***
997ViqAtWn1FPjJqcffwcA: folds
/JHoNdt0fK6X+isrqRfV3w: folds
V138SURkdX8LdVBPKdJJag: folds
OGgaARGdJQT4awWVNQ957w: folds
JMmUYT5pIKCKh2pGjCB/4w: folds
bLbSOSmSOnqE0iTcH/5dxA: folds
61sfw5QTu62YYIt68OsdrA: calls $0.50
FVs16t7GgfWgQWt4JxsObQ: checks
*** FLOP *** [3h Td 4s]
61sfw5QTu62YYIt68OsdrA: checks
FVs16t7GgfWgQWt4JxsObQ: bets $1
61sfw5QTu62YYIt68OsdrA: calls $1
*** TURN *** [3h Td 4s] [3c]
61sfw5QTu62YYIt68OsdrA: checks
FVs16t7GgfWgQWt4JxsObQ: bets $3
61sfw5QTu62YYIt68OsdrA: calls $3
*** RIVER *** [3h Td 4s 3c] [Ah]
61sfw5QTu62YYIt68OsdrA: bets $9
FVs16t7GgfWgQWt4JxsObQ: folds
61sfw5QTu62YYIt68OsdrA collected $9.55 from pot
61sfw5QTu62YYIt68OsdrA: doesn't show hand
*** SUMMARY ***
Total pot $10 | Rake $0.45
Board [3h Td 4s 3c Ah]
Seat 1: V138SURkdX8LdVBPKdJJag folded before Flop (didn't bet)
Seat 2: OGgaARGdJQT4awWVNQ957w folded before Flop (didn't bet)
Seat 3: JMmUYT5pIKCKh2pGjCB/4w folded before Flop (didn't bet)
Seat 4: bLbSOSmSOnqE0iTcH/5dxA (button) folded before Flop (didn't bet)
Seat 5: 61sfw5QTu62YYIt68OsdrA (small blind) collected ($9.55)
Seat 6: FVs16t7GgfWgQWt4JxsObQ (big blind) folded on the River
Seat 7: 997ViqAtWn1FPjJqcffwcA folded before Flop (didn't bet)
Seat 9: /JHoNdt0fK6X+isrqRfV3w folded before Flop (didn't bet)



PokerStars Game #59941376908:  Hold'em No Limit ($0.50/$1.00) - 2009/07/01 1:33:41 ET
Table '7O9fB8yx1u7sJveJn8w6jA' 6-max Seat #5 is the button
Seat 1: 841740 ($50.45 in chips)
Seat 2: wx3sQGkVi2x9wJXuWNHPBw ($199.20 in chips)
Seat 3: hpxXcmRkXXI9HE5+5/j/0Q ($142.90 in chips)
Seat 4: b2a+5TkFf4xJN/Ihhma58Q ($33.85 in chips)
Seat 5: BCEV3COoKY607AzLWayfRA ($100 in chips)
Seat 6: r4lpoh2BJZ8S6zyQv1JeSw ($100 in chips)
r4lpoh2BJZ8S6zyQv1JeSw: posts small blind $0.50
841740: posts big blind $1
*** HOLE CARDS ***
wx3sQGkVi2x9wJXuWNHPBw: raises $3 to $4
hpxXcmRkXXI9HE5+5/j/0Q: folds
b2a+5TkFf4xJN/Ihhma58Q: folds
BCEV3COoKY607AzLWayfRA: folds
r4lpoh2BJZ8S6zyQv1JeSw: folds
841740: calls $3
*** FLOP *** [Js 3c As]
841740: checks
wx3sQGkVi2x9wJXuWNHPBw: bets $1
841740: folds
wx3sQGkVi2x9wJXuWNHPBw collected $8.10 from pot
*** SUMMARY ***
Total pot $8.50 | Rake $0.40
Board [Js 3c As]
Seat 1: 841740 (big blind) folded on the Flop
Seat 2: wx3sQGkVi2x9wJXuWNHPBw collected ($8.10)
Seat 3: hpxXcmRkXXI9HE5+5/j/0Q folded before Flop (didn't bet)
Seat 4: b2a+5TkFf4xJN/Ihhma58Q folded before Flop (didn't bet)
Seat 5: BCEV3COoKY607AzLWayfRA (button) folded before Flop (didn't bet)
Seat 6: r4lpoh2BJZ8S6zyQv1JeSw (small blind) folded before Flop



PokerStars Game #59941378018:  Hold'em No Limit ($0.50/$1.00) - 2009/07/01 1:33:43 ET
Table 'VOs36P6NW+QyXeQ1B62kmAE9S5sEoK9Q3olj2a53gABASeat #4 is the button
Seat 1: 4h8XtuVJtWh3DJpxGo7k5Q ($21.35 in chips)
Seat 2: y27w5IK2WXqmYzS8OU0wKA ($137 in chips)
Seat 3: p00KmyZiD/isPc/lZwNBTg ($22 in chips)
Seat 4: ene3nLSnQ4N961iBaUsSmA ($100 in chips)
Seat 5: o3YLm/rSY916m/on1VjXPA ($126.85 in chips)
Seat 6: slVKuQyEz8Qj4E3uLPYNXg ($51.45 in chips)
o3YLm/rSY916m/on1VjXPA: posts small blind $0.50
slVKuQyEz8Qj4E3uLPYNXg: posts big blind $1
*** HOLE CARDS ***
4h8XtuVJtWh3DJpxGo7k5Q: calls $1
y27w5IK2WXqmYzS8OU0wKA: raises $4 to $5
p00KmyZiD/isPc/lZwNBTg: calls $5
ene3nLSnQ4N961iBaUsSmA: folds
o3YLm/rSY916m/on1VjXPA: folds
slVKuQyEz8Qj4E3uLPYNXg: folds
4h8XtuVJtWh3DJpxGo7k5Q: calls $4
*** FLOP *** [7d Ad 9c]
4h8XtuVJtWh3DJpxGo7k5Q: checks
y27w5IK2WXqmYzS8OU0wKA: checks
p00KmyZiD/isPc/lZwNBTg: checks
*** TURN *** [7d Ad 9c] [Kc]
4h8XtuVJtWh3DJpxGo7k5Q: bets $1
y27w5IK2WXqmYzS8OU0wKA: raises $11 to $12
p00KmyZiD/isPc/lZwNBTg: folds
4h8XtuVJtWh3DJpxGo7k5Q: folds
y27w5IK2WXqmYzS8OU0wKA collected $17.65 from pot
y27w5IK2WXqmYzS8OU0wKA: doesn't show hand
*** SUMMARY ***
Total pot $18.50 | Rake $0.85
Board [7d Ad 9c Kc]
Seat 1: 4h8XtuVJtWh3DJpxGo7k5Q folded on the Turn
Seat 2: y27w5IK2WXqmYzS8OU0wKA collected ($17.65)
Seat 3: p00KmyZiD/isPc/lZwNBTg folded on the Turn
Seat 4: ene3nLSnQ4N961iBaUsSmA (button) folded before Flop (didn't bet)
Seat 5: o3YLm/rSY916m/on1VjXPA (small blind) folded before Flop
Seat 6: slVKuQyEz8Qj4E3uLPYNXg (big blind) folded before Flop



PokerStars Game #59941377670:  Hold'em No Limit ($0.50/$1.00) - 2009/07/01 1:33:43 ET
Table '3T4owEKJKyGTMePwrv50FQ' 9-max Seat #8 is the button
Seat 1: OGgaARGdJQT4awWVNQ957w ($101.50 in chips)
Seat 2: t+Id2O6herCLgwnC4m49PA ($35.30 in chips)
Seat 3: DOLzOcBTZYcph5jEfKFWuQ ($100 in chips)
Seat 4: O5Go3jrzbQWxRB6ESK+Ptg ($80.60 in chips)
Seat 5: mMc/PBpqlN24gdi3C/1tOw ($45.90 in chips)
Seat 6: V138SURkdX8LdVBPKdJJag ($108.25 in chips)
Seat 7: 1862487932 ($100 in chips)
Seat 8: bLbSOSmSOnqE0iTcH/5dxA ($198.50 in chips)
Seat 9: 61sfw5QTu62YYIt68OsdrA ($65.15 in chips)
61sfw5QTu62YYIt68OsdrA: posts small blind $0.50
OGgaARGdJQT4awWVNQ957w: posts big blind $1
*** HOLE CARDS ***
t+Id2O6herCLgwnC4m49PA: calls $1
DOLzOcBTZYcph5jEfKFWuQ: folds
O5Go3jrzbQWxRB6ESK+Ptg: folds
mMc/PBpqlN24gdi3C/1tOw: folds
V138SURkdX8LdVBPKdJJag: folds
1862487932: folds
bLbSOSmSOnqE0iTcH/5dxA: folds
61sfw5QTu62YYIt68OsdrA: calls $0.50
OGgaARGdJQT4awWVNQ957w: checks
*** FLOP *** [9c Qd 4h]
61sfw5QTu62YYIt68OsdrA: checks
OGgaARGdJQT4awWVNQ957w: checks
t+Id2O6herCLgwnC4m49PA: bets $2
61sfw5QTu62YYIt68OsdrA: folds
OGgaARGdJQT4awWVNQ957w: folds
t+Id2O6herCLgwnC4m49PA collected $2.85 from pot
*** SUMMARY ***
Total pot $3 | Rake $0.15
Board [9c Qd 4h]
Seat 1: OGgaARGdJQT4awWVNQ957w (big blind) folded on the Flop
Seat 2: t+Id2O6herCLgwnC4m49PA collected ($2.85)
Seat 3: DOLzOcBTZYcph5jEfKFWuQ folded before Flop (didn't bet)
Seat 4: O5Go3jrzbQWxRB6ESK+Ptg folded before Flop (didn't bet)
Seat 5: mMc/PBpqlN24gdi3C/1tOw folded before Flop (didn't bet)
Seat 6: V138SURkdX8LdVBPKdJJag folded before Flop (didn't bet)
Seat 7: 1862487932 folded before Flop (didn't bet)
Seat 8: bLbSOSmSOnqE0iTcH/5dxA (button) folded before Flop (didn't bet)
Seat 9: 61sfw5QTu62YYIt68OsdrA (small blind) folded on the Flop



PokerStars Game #59941378264:  Hold'em No Limit ($0.50/$1.00) - 2009/07/01 1:33:44 ET
Table 'b8oW/dOL7fDza5DfZ/dOJQ' 6-max Seat #1 is the button
Seat 1: NakujTNjHFgzceydFf+E2Q ($99.50 in chips)
Seat 2: TSuRyAHnUPCFjP7Z0rEE0w ($119.50 in chips)
Seat 3: d8WX+9nUHoqlrAGagO0Wow ($31.40 in chips)
Seat 4: X87W8qaGsudJTSkClK2Cig ($7.35 in chips)
Seat 5: r4lpoh2BJZ8S6zyQv1JeSw ($102.50 in chips)
Seat 6: PvfYaKbzMpsmUcbOExckbQ ($102.60 in chips)
TSuRyAHnUPCFjP7Z0rEE0w: posts small blind $0.50
d8WX+9nUHoqlrAGagO0Wow: posts big blind $1
*** HOLE CARDS ***
X87W8qaGsudJTSkClK2Cig: folds
r4lpoh2BJZ8S6zyQv1JeSw: folds
PvfYaKbzMpsmUcbOExckbQ: folds
NakujTNjHFgzceydFf+E2Q: folds
TSuRyAHnUPCFjP7Z0rEE0w: folds
d8WX+9nUHoqlrAGagO0Wow collected $1 from pot
*** SUMMARY ***
Total pot $1 | Rake $0
Seat 1: NakujTNjHFgzceydFf+E2Q (button) folded before Flop (didn't bet)
Seat 2: TSuRyAHnUPCFjP7Z0rEE0w (small blind) folded before Flop
Seat 3: d8WX+9nUHoqlrAGagO0Wow (big blind) collected ($1)
Seat 4: X87W8qaGsudJTSkClK2Cig folded before Flop (didn't bet)
Seat 5: r4lpoh2BJZ8S6zyQv1JeSw folded before Flop (didn't bet)
Seat 6: PvfYaKbzMpsmUcbOExckbQ folded before Flop (didn't bet)



PokerStars Game #59941378306:  Hold'em No Limit ($0.50/$1.00) - 2009/07/01 1:33:44 ET
Table 'QSIig7BLMc9wY/rgBechzw' 6-max Seat #1 is the button
Seat 1: Z2fXsGcjl+Eax+RzOgwOmg ($132.55 in chips)
Seat 2: mLOIkH/qmRa+mVujQIhBRg ($22.40 in chips)
Seat 4: +uSzP8Jwnw7sKfQ4s66b7w ($59.45 in chips)
Seat 5: lsLuWlcPA3Rh7kJVLzMh0Q ($101.70 in chips)
Seat 6: PxqfkAMdAWtkgbT+q2gciA ($53.60 in chips)
mLOIkH/qmRa+mVujQIhBRg: posts small blind $0.50
+xW7QemQU0Fxs+4TnqBRow: is sitting out
+uSzP8Jwnw7sKfQ4s66b7w: posts big blind $1
*** HOLE CARDS ***
+xW7QemQU0Fxs+4TnqBRow leaves the table
lsLuWlcPA3Rh7kJVLzMh0Q: folds
PxqfkAMdAWtkgbT+q2gciA: folds
Z2fXsGcjl+Eax+RzOgwOmg: folds
mLOIkH/qmRa+mVujQIhBRg: calls $0.50
+uSzP8Jwnw7sKfQ4s66b7w: checks
*** FLOP *** [7s 6h 9d]
mLOIkH/qmRa+mVujQIhBRg: bets $1
+uSzP8Jwnw7sKfQ4s66b7w: calls $1
*** TURN *** [7s 6h 9d] [Th]
4OO5v3AVduL0tePNx8wk5A joins the table at seat #3
mLOIkH/qmRa+mVujQIhBRg: checks
+uSzP8Jwnw7sKfQ4s66b7w: checks
*** RIVER *** [7s 6h 9d Th] [Qc]
mLOIkH/qmRa+mVujQIhBRg: checks
+uSzP8Jwnw7sKfQ4s66b7w: bets $4
mLOIkH/qmRa+mVujQIhBRg: folds
+uSzP8Jwnw7sKfQ4s66b7w collected $3.85 from pot
*** SUMMARY ***
Total pot $4 | Rake $0.15
Board [7s 6h 9d Th Qc]
Seat 1: Z2fXsGcjl+Eax+RzOgwOmg (button) folded before Flop (didn't bet)
Seat 2: mLOIkH/qmRa+mVujQIhBRg (small blind) folded on the River
Seat 4: +uSzP8Jwnw7sKfQ4s66b7w (big blind) collected ($3.85)
Seat 5: lsLuWlcPA3Rh7kJVLzMh0Q folded before Flop (didn't bet)
Seat 6: PxqfkAMdAWtkgbT+q2gciA folded before Flop (didn't bet)



PokerStars Game #59941378884:  Hold'em No Limit ($0.50/$1.00) - 2009/07/01 1:33:45 ET
Table 'cBDNutyLBKEk9+ptwsKmTw' 6-max Seat #4 is the button
Seat 1: xAU6q2/cwmby2sxmA8VcmA ($270.55 in chips)
Seat 2: 4OO5v3AVduL0tePNx8wk5A ($135.10 in chips)
Seat 4: OMkHNxIUZxh1pHqcCjbjgw ($100 in chips)
Seat 5: hpxXcmRkXXI9HE5+5/j/0Q ($105.20 in chips)
Seat 6: QHvTZcrKe6+maWUfVjP29Q ($148.50 in chips)
hpxXcmRkXXI9HE5+5/j/0Q: posts small blind $0.50
QHvTZcrKe6+maWUfVjP29Q: posts big blind $1
*** HOLE CARDS ***
xAU6q2/cwmby2sxmA8VcmA: folds
4OO5v3AVduL0tePNx8wk5A: folds
OMkHNxIUZxh1pHqcCjbjgw: raises $2 to $3
hpxXcmRkXXI9HE5+5/j/0Q: folds
QHvTZcrKe6+maWUfVjP29Q: folds
OMkHNxIUZxh1pHqcCjbjgw collected $2.50 from pot
OMkHNxIUZxh1pHqcCjbjgw: doesn't show hand
*** SUMMARY ***
Total pot $2.50 | Rake $0
Seat 1: xAU6q2/cwmby2sxmA8VcmA folded before Flop (didn't bet)
Seat 2: 4OO5v3AVduL0tePNx8wk5A folded before Flop (didn't bet)
Seat 4: OMkHNxIUZxh1pHqcCjbjgw (button) collected ($2.50)
Seat 5: hpxXcmRkXXI9HE5+5/j/0Q (small blind) folded before Flop
Seat 6: QHvTZcrKe6+maWUfVjP29Q (big blind) folded before Flop



PokerStars Game #59941379196:  Hold'em No Limit ($0.50/$1.00) - 2009/07/01 1:33:45 ET
Table 'qj0HBN4HhQKogreu1bg7xg' 2-max Seat #1 is the button
Seat 1: NYi6JFscYNrofSXy4sM+Yw ($100.50 in chips)
Seat 2: qtyl8CSb0/4yWdbuEPJejA ($180.40 in chips)
NYi6JFscYNrofSXy4sM+Yw: posts small blind $0.50
qtyl8CSb0/4yWdbuEPJejA: posts big blind $1
*** HOLE CARDS ***
NYi6JFscYNrofSXy4sM+Yw: raises $2 to $3
qtyl8CSb0/4yWdbuEPJejA: folds
NYi6JFscYNrofSXy4sM+Yw collected $2 from pot
NYi6JFscYNrofSXy4sM+Yw: doesn't show hand
*** SUMMARY ***
Total pot $2 | Rake $0
Seat 1: NYi6JFscYNrofSXy4sM+Yw (button) (small blind) collected ($2)
Seat 2: qtyl8CSb0/4yWdbuEPJejA (big blind) folded before Flop



PokerStars Game #59941382022:  Hold'em No Limit ($0.50/$1.00) - 2009/07/01 1:33:50 ET
Table 'mmbQQVBTrPdE+wy+s+9VPA' 6-max Seat #5 is the button
Seat 1: zyP4SPoWZnKUfTvIRLCVog ($70.65 in chips)
Seat 2: XK4Qsl+DA8gAJyg85/zBIw ($26.60 in chips)
Seat 3: wx3sQGkVi2x9wJXuWNHPBw ($134.60 in chips)
Seat 4: V3iZdcw61nXF3g5hD2RrsQ ($105.05 in chips)
Seat 5: YMJG+F++3Aj6P8dAWda5fw ($119.40 in chips)
Seat 6: U2CWBTv29qdCbj8RNF2sIw ($120.15 in chips)
U2CWBTv29qdCbj8RNF2sIw: posts small blind $0.50
zyP4SPoWZnKUfTvIRLCVog: posts big blind $1
*** HOLE CARDS ***
XK4Qsl+DA8gAJyg85/zBIw: folds
wx3sQGkVi2x9wJXuWNHPBw: raises $3 to $4
V3iZdcw61nXF3g5hD2RrsQ: folds
YMJG+F++3Aj6P8dAWda5fw: calls $4
U2CWBTv29qdCbj8RNF2sIw: calls $3.50
zyP4SPoWZnKUfTvIRLCVog: folds
*** FLOP *** [Jc 3h 5h]
U2CWBTv29qdCbj8RNF2sIw: checks
wx3sQGkVi2x9wJXuWNHPBw: bets $9
YMJG+F++3Aj6P8dAWda5fw: folds
U2CWBTv29qdCbj8RNF2sIw: calls $9
*** TURN *** [Jc 3h 5h] [9s]
U2CWBTv29qdCbj8RNF2sIw: checks
wx3sQGkVi2x9wJXuWNHPBw: bets $19
U2CWBTv29qdCbj8RNF2sIw: calls $19
*** RIVER *** [Jc 3h 5h 9s] [Td]
U2CWBTv29qdCbj8RNF2sIw: checks
wx3sQGkVi2x9wJXuWNHPBw: bets $43.50
U2CWBTv29qdCbj8RNF2sIw: raises $43.50 to $87
wx3sQGkVi2x9wJXuWNHPBw: calls $43.50
*** SHOW DOWN ***
U2CWBTv29qdCbj8RNF2sIw: shows [6d 6c] (a pair of Sixes)
wx3sQGkVi2x9wJXuWNHPBw: shows [Jh Jd] (three of a kind, Jacks)
wx3sQGkVi2x9wJXuWNHPBw collected $240 from pot
*** SUMMARY ***
Total pot $243 | Rake $3
Board [Jc 3h 5h 9s Td]
Seat 1: zyP4SPoWZnKUfTvIRLCVog (big blind) folded before Flop
Seat 2: XK4Qsl+DA8gAJyg85/zBIw folded before Flop (didn't bet)
Seat 3: wx3sQGkVi2x9wJXuWNHPBw showed [Jh Jd] and won ($240) with three of a kind, Jacks
Seat 4: V3iZdcw61nXF3g5hD2RrsQ folded before Flop (didn't bet)
Seat 5: YMJG+F++3Aj6P8dAWda5fw (button) folded on the Flop
Seat 6: U2CWBTv29qdCbj8RNF2sIw (small blind) showed [6d 6c] and lost with a pair of Sixes



PokerStars Game #59941381946:  Hold'em No Limit ($0.50/$1.00) - 2009/07/01 1:33:50 ET
Table 'W/wyObTiXZm+Ckkl3YxcSw' 6-max Seat #6 is the button
Seat 1: eUBBn2R56C1IQ6Cs/vitwg ($294.55 in chips)
Seat 2: oDiBRCaF0QVtd3kO6xZIXw ($161.40 in chips)
Seat 3: dxyNCn/qxfkGDUIf28Cbng ($59.80 in chips)
Seat 4: UBZQqpnJZdTYYY1FTb0rLA ($100.20 in chips)
Seat 5: +OrCjyw70oZhJiD22Mn+bg ($105.50 in chips)
Seat 6: b2a+5TkFf4xJN/Ihhma58Q ($35.80 in chips)
eUBBn2R56C1IQ6Cs/vitwg: posts small blind $0.50
oDiBRCaF0QVtd3kO6xZIXw: posts big blind $1
*** HOLE CARDS ***
dxyNCn/qxfkGDUIf28Cbng: folds
UBZQqpnJZdTYYY1FTb0rLA: raises $2 to $3
+OrCjyw70oZhJiD22Mn+bg: folds
b2a+5TkFf4xJN/Ihhma58Q: folds
eUBBn2R56C1IQ6Cs/vitwg: folds
oDiBRCaF0QVtd3kO6xZIXw: calls $2
*** FLOP *** [Qs 8h Th]
oDiBRCaF0QVtd3kO6xZIXw: bets $4
UBZQqpnJZdTYYY1FTb0rLA: calls $4
*** TURN *** [Qs 8h Th] [2h]
oDiBRCaF0QVtd3kO6xZIXw: checks
UBZQqpnJZdTYYY1FTb0rLA: bets $7
oDiBRCaF0QVtd3kO6xZIXw: calls $7
*** RIVER *** [Qs 8h Th 2h] [2c]
oDiBRCaF0QVtd3kO6xZIXw: checks
UBZQqpnJZdTYYY1FTb0rLA: bets $15
oDiBRCaF0QVtd3kO6xZIXw: raises $30 to $45
UBZQqpnJZdTYYY1FTb0rLA: raises $41.20 to $86.20 and is all-in
oDiBRCaF0QVtd3kO6xZIXw: folds
UBZQqpnJZdTYYY1FTb0rLA collected $115.50 from pot
UBZQqpnJZdTYYY1FTb0rLA: doesn't show hand
*** SUMMARY ***
Total pot $118.50 | Rake $3
Board [Qs 8h Th 2h 2c]
Seat 1: eUBBn2R56C1IQ6Cs/vitwg (small blind) folded before Flop
Seat 2: oDiBRCaF0QVtd3kO6xZIXw (big blind) folded on the River
Seat 3: dxyNCn/qxfkGDUIf28Cbng folded before Flop (didn't bet)
Seat 4: UBZQqpnJZdTYYY1FTb0rLA collected ($115.50)
Seat 5: +OrCjyw70oZhJiD22Mn+bg folded before Flop (didn't bet)
Seat 6: b2a+5TkFf4xJN/Ihhma58Q (button) folded before Flop (didn't bet)



PokerStars Game #59941383074:  Hold'em No Limit ($0.50/$1.00) - 2009/07/01 1:33:52 ET
Table 'O96CPOtvMBWP6kzuYDfdFA' 6-max Seat #4 is the button
Seat 1: 6alLXQIITA2EZ/lBeym8Dw ($123.75 in chips)
Seat 2: 4d1rWhpu8DzLmzMbR3QKyA ($100 in chips)
Seat 4: /P4w1pHg2zHYg/4ubJ0dPw ($65.15 in chips)
Seat 6: 3syOXva630dm1FTdwnuLpw ($80.15 in chips)
3syOXva630dm1FTdwnuLpw: posts small blind $0.50
6alLXQIITA2EZ/lBeym8Dw: posts big blind $1
*** HOLE CARDS ***
4d1rWhpu8DzLmzMbR3QKyA: raises $2 to $3
/P4w1pHg2zHYg/4ubJ0dPw: folds
3syOXva630dm1FTdwnuLpw: folds
6alLXQIITA2EZ/lBeym8Dw: raises $8 to $11
vX+iYAEINFeLxwMla7DY1Q joins the table at seat #5
4d1rWhpu8DzLmzMbR3QKyA: folds
6alLXQIITA2EZ/lBeym8Dw collected $6.50 from pot
*** SUMMARY ***
Total pot $6.50 | Rake $0
Seat 1: 6alLXQIITA2EZ/lBeym8Dw (big blind) collected ($6.50)
Seat 2: 4d1rWhpu8DzLmzMbR3QKyA folded before Flop
Seat 4: /P4w1pHg2zHYg/4ubJ0dPw (button) folded before Flop (didn't bet)
Seat 6: 3syOXva630dm1FTdwnuLpw (small blind) folded before Flop



PokerStars Game #59941385806:  Hold'em No Limit ($0.50/$1.00) - 2009/07/01 1:33:57 ET
Table '+cA8mcmhaedZ7YcrDdhmeQ' 6-max Seat #6 is the button
Seat 1: 9XrTM0DuVxx1pjFAdSbD8A ($53.70 in chips)
Seat 3: DAIgyIWbYvAkL6PbAI27pg ($16.55 in chips)
Seat 4: 4OO5v3AVduL0tePNx8wk5A ($115.55 in chips)
Seat 5: RqgF7gRoKgRNW8Zoi1ty4A ($162.30 in chips)
Seat 6: YfsTQsY/fxb+YqbdclTHuw ($43.35 in chips)
9XrTM0DuVxx1pjFAdSbD8A: posts small blind $0.50
14aYclSc98EYd6TrzN2l3Q: is sitting out
DAIgyIWbYvAkL6PbAI27pg: posts big blind $1
*** HOLE CARDS ***
14aYclSc98EYd6TrzN2l3Q has returned
4OO5v3AVduL0tePNx8wk5A: folds
RqgF7gRoKgRNW8Zoi1ty4A: folds
YfsTQsY/fxb+YqbdclTHuw: calls $1
9XrTM0DuVxx1pjFAdSbD8A: calls $0.50
DAIgyIWbYvAkL6PbAI27pg: checks
*** FLOP *** [Jd Ad 4c]
9XrTM0DuVxx1pjFAdSbD8A: checks
DAIgyIWbYvAkL6PbAI27pg: checks
YfsTQsY/fxb+YqbdclTHuw: bets $3
9XrTM0DuVxx1pjFAdSbD8A: folds
DAIgyIWbYvAkL6PbAI27pg: folds
YfsTQsY/fxb+YqbdclTHuw collected $2.85 from pot
*** SUMMARY ***
Total pot $3 | Rake $0.15
Board [Jd Ad 4c]
Seat 1: 9XrTM0DuVxx1pjFAdSbD8A (small blind) folded on the Flop
Seat 3: DAIgyIWbYvAkL6PbAI27pg (big blind) folded on the Flop
Seat 4: 4OO5v3AVduL0tePNx8wk5A folded before Flop (didn't bet)
Seat 5: RqgF7gRoKgRNW8Zoi1ty4A folded before Flop (didn't bet)
Seat 6: YfsTQsY/fxb+YqbdclTHuw (button) collected ($2.85)



PokerStars Game #59941387826:  Hold'em No Limit ($0.50/$1.00) - 2009/07/01 1:34:01 ET
Table 'tHb+N6GaPEmmBAe36B2R9Q' 2-max Seat #2 is the button
Seat 1: rL+Zpv4/vX2BVHcyfh/NXA ($101.90 in chips)
Seat 2: Pm1sDZZi0zFtnFGXLznkug ($128.70 in chips)
Pm1sDZZi0zFtnFGXLznkug: posts small blind $0.50
rL+Zpv4/vX2BVHcyfh/NXA: posts big blind $1
*** HOLE CARDS ***
Pm1sDZZi0zFtnFGXLznkug: calls $0.50
rL+Zpv4/vX2BVHcyfh/NXA: raises $3 to $4
Pm1sDZZi0zFtnFGXLznkug said, "wasmt sure u had the ace"
Pm1sDZZi0zFtnFGXLznkug said, "sorry"
Pm1sDZZi0zFtnFGXLznkug: folds
rL+Zpv4/vX2BVHcyfh/NXA collected $2 from pot
rL+Zpv4/vX2BVHcyfh/NXA: doesn't show hand
*** SUMMARY ***
Total pot $2 | Rake $0
Seat 1: rL+Zpv4/vX2BVHcyfh/NXA (big blind) collected ($2)
Seat 2: Pm1sDZZi0zFtnFGXLznkug (button) (small blind) folded before Flop



PokerStars Game #59941387592:  Hold'em No Limit ($0.50/$1.00) - 2009/07/01 1:34:01 ET
Table 'qj0HBN4HhQKogreu1bg7xg' 2-max Seat #2 is the button
Seat 1: NYi6JFscYNrofSXy4sM+Yw ($101.50 in chips)
Seat 2: qtyl8CSb0/4yWdbuEPJejA ($179.40 in chips)
qtyl8CSb0/4yWdbuEPJejA: posts small blind $0.50
NYi6JFscYNrofSXy4sM+Yw: posts big blind $1
*** HOLE CARDS ***
qtyl8CSb0/4yWdbuEPJejA: folds
NYi6JFscYNrofSXy4sM+Yw collected $1 from pot
*** SUMMARY ***
Total pot $1 | Rake $0
Seat 1: NYi6JFscYNrofSXy4sM+Yw (big blind) collected ($1)
Seat 2: qtyl8CSb0/4yWdbuEPJejA (button) (small blind) folded before Flop



PokerStars Game #59941388234:  Hold'em No Limit ($0.50/$1.00) - 2009/07/01 1:34:02 ET
Table 'N2bNCDHL96aCQDvZIh+yQQ' 6-max Seat #5 is the button
Seat 1: Jjgflx10PVjcLkziEmLhSA ($75.70 in chips)
Seat 2: y27w5IK2WXqmYzS8OU0wKA ($122.55 in chips)
Seat 3: UBZQqpnJZdTYYY1FTb0rLA ($120.55 in chips)
Seat 4: uCqEjnxh2/vFBjKYkfTOkw ($188.50 in chips)
Seat 5: frvgHLr3+LfZtjsBCBs3NA ($19.60 in chips)
Seat 6: idVgoPAdspFPCzee6aF9Pg ($100 in chips)
idVgoPAdspFPCzee6aF9Pg: posts small blind $0.50
Jjgflx10PVjcLkziEmLhSA: posts big blind $1
*** HOLE CARDS ***
y27w5IK2WXqmYzS8OU0wKA: folds
UBZQqpnJZdTYYY1FTb0rLA: folds
uCqEjnxh2/vFBjKYkfTOkw: calls $1
frvgHLr3+LfZtjsBCBs3NA: folds
idVgoPAdspFPCzee6aF9Pg: folds
Jjgflx10PVjcLkziEmLhSA: checks
*** FLOP *** [4d Th 6s]
Jjgflx10PVjcLkziEmLhSA: checks
uCqEjnxh2/vFBjKYkfTOkw: bets $1
Jjgflx10PVjcLkziEmLhSA: calls $1
*** TURN *** [4d Th 6s] [Jh]
Jjgflx10PVjcLkziEmLhSA: checks
uCqEjnxh2/vFBjKYkfTOkw: bets $3
Jjgflx10PVjcLkziEmLhSA: folds
uCqEjnxh2/vFBjKYkfTOkw collected $4.30 from pot
uCqEjnxh2/vFBjKYkfTOkw: doesn't show hand
*** SUMMARY ***
Total pot $4.50 | Rake $0.20
Board [4d Th 6s Jh]
Seat 1: Jjgflx10PVjcLkziEmLhSA (big blind) folded on the Turn
Seat 2: y27w5IK2WXqmYzS8OU0wKA folded before Flop (didn't bet)
Seat 3: UBZQqpnJZdTYYY1FTb0rLA folded before Flop (didn't bet)
Seat 4: uCqEjnxh2/vFBjKYkfTOkw collected ($4.30)
Seat 5: frvgHLr3+LfZtjsBCBs3NA (button) folded before Flop (didn't bet)
Seat 6: idVgoPAdspFPCzee6aF9Pg (small blind) folded before Flop



PokerStars Game #59941388890:  Hold'em No Limit ($0.50/$1.00) - 2009/07/01 1:34:03 ET
Table '305hiksPPCCdC6V2LNsO5w' 6-max Seat #2 is the button
Seat 1: RTuDLJHh/9zPfBftoc9vsw ($9.50 in chips)
Seat 2: j7NIOHLZk7V2o9fOioO5ug ($130.50 in chips)
Seat 3: +zIVjZKLpcidfRHgVZW8lA ($27.70 in chips)
Seat 4: uJVSceLggtsrJya+WtmUEA ($222.30 in chips)
Seat 5: +Nt3OPk3XR9SKjZgm2CexQ ($110.65 in chips)
Seat 6: 9/Tq8dw7kWW68uN8bFupXg ($16.40 in chips)
+zIVjZKLpcidfRHgVZW8lA: posts small blind $0.50
uJVSceLggtsrJya+WtmUEA: posts big blind $1
*** HOLE CARDS ***
+Nt3OPk3XR9SKjZgm2CexQ: folds
9/Tq8dw7kWW68uN8bFupXg: raises $2 to $3
RTuDLJHh/9zPfBftoc9vsw: calls $3
j7NIOHLZk7V2o9fOioO5ug: folds
+zIVjZKLpcidfRHgVZW8lA: folds
uJVSceLggtsrJya+WtmUEA: calls $2
*** FLOP *** [Qc Ts Kc]
uJVSceLggtsrJya+WtmUEA: checks
9/Tq8dw7kWW68uN8bFupXg: bets $13.40 and is all-in
RTuDLJHh/9zPfBftoc9vsw: folds
uJVSceLggtsrJya+WtmUEA: folds
9/Tq8dw7kWW68uN8bFupXg collected $9.05 from pot
*** SUMMARY ***
Total pot $9.50 | Rake $0.45
Board [Qc Ts Kc]
Seat 1: RTuDLJHh/9zPfBftoc9vsw folded on the Flop
Seat 2: j7NIOHLZk7V2o9fOioO5ug (button) folded before Flop (didn't bet)
Seat 3: +zIVjZKLpcidfRHgVZW8lA (small blind) folded before Flop
Seat 4: uJVSceLggtsrJya+WtmUEA (big blind) folded on the Flop
Seat 5: +Nt3OPk3XR9SKjZgm2CexQ folded before Flop (didn't bet)
Seat 6: 9/Tq8dw7kWW68uN8bFupXg collected ($9.05)



PokerStars Game #59941389264:  Hold'em No Limit ($0.50/$1.00) - 2009/07/01 1:34:04 ET
Table 'NqGO/cV3MwFAx+ZPB5ANmQ' 2-max Seat #2 is the button
Seat 1: ItaRAnHOgvYOv5ynbG1iTw ($128.70 in chips)
Seat 2: GtFB+yyeb2djMdPFuOW/Xg ($160.70 in chips)
GtFB+yyeb2djMdPFuOW/Xg: posts small blind $0.50
ItaRAnHOgvYOv5ynbG1iTw: posts big blind $1
*** HOLE CARDS ***
GtFB+yyeb2djMdPFuOW/Xg: raises $2 to $3
ItaRAnHOgvYOv5ynbG1iTw: folds
GtFB+yyeb2djMdPFuOW/Xg collected $2 from pot
*** SUMMARY ***
Total pot $2 | Rake $0
Seat 1: ItaRAnHOgvYOv5ynbG1iTw (big blind) folded before Flop
Seat 2: GtFB+yyeb2djMdPFuOW/Xg (button) (small blind) collected ($2)



PokerStars Game #59941390728:  Hold'em No Limit ($0.50/$1.00) - 2009/07/01 1:34:06 ET
Table 'qj0HBN4HhQKogreu1bg7xg' 2-max Seat #1 is the button
Seat 1: NYi6JFscYNrofSXy4sM+Yw ($102 in chips)
Seat 2: qtyl8CSb0/4yWdbuEPJejA ($178.90 in chips)
NYi6JFscYNrofSXy4sM+Yw: posts small blind $0.50
qtyl8CSb0/4yWdbuEPJejA: posts big blind $1
*** HOLE CARDS ***
NYi6JFscYNrofSXy4sM+Yw: raises $2 to $3
qtyl8CSb0/4yWdbuEPJejA: raises $5 to $8
NYi6JFscYNrofSXy4sM+Yw: calls $5
*** FLOP *** [Qh 2s 6d]
qtyl8CSb0/4yWdbuEPJejA: bets $5
NYi6JFscYNrofSXy4sM+Yw: raises $10 to $15
qtyl8CSb0/4yWdbuEPJejA: folds
NYi6JFscYNrofSXy4sM+Yw collected $25.50 from pot
*** SUMMARY ***
Total pot $26 | Rake $0.50
Board [Qh 2s 6d]
Seat 1: NYi6JFscYNrofSXy4sM+Yw (button) (small blind) collected ($25.50)
Seat 2: qtyl8CSb0/4yWdbuEPJejA (big blind) folded on the Flop



PokerStars Game #59941390890:  Hold'em No Limit ($0.50/$1.00) - 2009/07/01 1:34:06 ET
Table 'cBDNutyLBKEk9+ptwsKmTw' 6-max Seat #5 is the button
Seat 1: xAU6q2/cwmby2sxmA8VcmA ($270.55 in chips)
Seat 2: 4OO5v3AVduL0tePNx8wk5A ($135.10 in chips)
Seat 4: OMkHNxIUZxh1pHqcCjbjgw ($101.50 in chips)
Seat 5: hpxXcmRkXXI9HE5+5/j/0Q ($104.70 in chips)
Seat 6: QHvTZcrKe6+maWUfVjP29Q ($147.50 in chips)
QHvTZcrKe6+maWUfVjP29Q: posts small blind $0.50
xAU6q2/cwmby2sxmA8VcmA: posts big blind $1
*** HOLE CARDS ***
4OO5v3AVduL0tePNx8wk5A: folds
OMkHNxIUZxh1pHqcCjbjgw: folds
hpxXcmRkXXI9HE5+5/j/0Q: folds
QHvTZcrKe6+maWUfVjP29Q: folds
xAU6q2/cwmby2sxmA8VcmA collected $1 from pot
xAU6q2/cwmby2sxmA8VcmA: doesn't show hand
*** SUMMARY ***
Total pot $1 | Rake $0
Seat 1: xAU6q2/cwmby2sxmA8VcmA (big blind) collected ($1)
Seat 2: 4OO5v3AVduL0tePNx8wk5A folded before Flop (didn't bet)
Seat 4: OMkHNxIUZxh1pHqcCjbjgw folded before Flop (didn't bet)
Seat 5: hpxXcmRkXXI9HE5+5/j/0Q (button) folded before Flop (didn't bet)
Seat 6: QHvTZcrKe6+maWUfVjP29Q (small blind) folded before Flop



PokerStars Game #59941391816:  Hold'em No Limit ($0.50/$1.00) - 2009/07/01 1:34:08 ET
Table 'fTlPiCj0utgzC/5io+I7ew' 6-max Seat #5 is the button
Seat 1: YMJG+F++3Aj6P8dAWda5fw ($104.60 in chips)
Seat 2: qVr1nl3dy2xXPqS8UpTDlA ($18.80 in chips)
Seat 3: Z2fXsGcjl+Eax+RzOgwOmg ($142 in chips)
Seat 4: uJVSceLggtsrJya+WtmUEA ($166.35 in chips)
Seat 5: XUk5GQsfNFpHvaToDZ0rZA ($44.05 in chips)
Seat 6: y27w5IK2WXqmYzS8OU0wKA ($100 in chips)
y27w5IK2WXqmYzS8OU0wKA: posts small blind $0.50
YMJG+F++3Aj6P8dAWda5fw: posts big blind $1
*** HOLE CARDS ***
qVr1nl3dy2xXPqS8UpTDlA: folds
Z2fXsGcjl+Eax+RzOgwOmg: raises $3 to $4
uJVSceLggtsrJya+WtmUEA: folds
XUk5GQsfNFpHvaToDZ0rZA: folds
y27w5IK2WXqmYzS8OU0wKA: folds
YMJG+F++3Aj6P8dAWda5fw: raises $9 to $13
Z2fXsGcjl+Eax+RzOgwOmg: folds
YMJG+F++3Aj6P8dAWda5fw collected $8.50 from pot
*** SUMMARY ***
Total pot $8.50 | Rake $0
Seat 1: YMJG+F++3Aj6P8dAWda5fw (big blind) collected ($8.50)
Seat 2: qVr1nl3dy2xXPqS8UpTDlA folded before Flop (didn't bet)
Seat 3: Z2fXsGcjl+Eax+RzOgwOmg folded before Flop
Seat 4: uJVSceLggtsrJya+WtmUEA folded before Flop (didn't bet)
Seat 5: XUk5GQsfNFpHvaToDZ0rZA (button) folded before Flop (didn't bet)
Seat 6: y27w5IK2WXqmYzS8OU0wKA (small blind) folded before Flop



PokerStars Game #59941391856:  Hold'em No Limit ($0.50/$1.00) - 2009/07/01 1:34:08 ET
Table '/FUb199IViHMJHi5YWmeuQ' 9-max Seat #4 is the button
Seat 1: 3obndzTJ6fECz8+wWhMd1w ($32.30 in chips)
Seat 2: FL3MrLspcF23LYvC4ipBOA ($184.05 in chips)
Seat 3: V138SURkdX8LdVBPKdJJag ($100.75 in chips)
Seat 4: pbAfmxe4uSZPxJQX7gOzZA ($45.65 in chips)
Seat 6: VPF+HjszMvUIpy0CHIwH3A ($41.80 in chips)
Seat 8: 997ViqAtWn1FPjJqcffwcA ($101 in chips)
Seat 9: RfLbneGRY8yQUpMgDnJCxA ($74.20 in chips)
1862487932 will be allowed to play after the button
VPF+HjszMvUIpy0CHIwH3A: posts small blind $0.50
myIxN7otsyr846M539YR8Q: is sitting out
997ViqAtWn1FPjJqcffwcA: posts big blind $1
*** HOLE CARDS ***
RfLbneGRY8yQUpMgDnJCxA: calls $1
3obndzTJ6fECz8+wWhMd1w: folds
myIxN7otsyr846M539YR8Q leaves the table
aM6BB+PnB/rDUr2dbRda+A joins the table at seat #7
FL3MrLspcF23LYvC4ipBOA: folds
V138SURkdX8LdVBPKdJJag: folds
pbAfmxe4uSZPxJQX7gOzZA: folds
VPF+HjszMvUIpy0CHIwH3A: folds
997ViqAtWn1FPjJqcffwcA: checks
*** FLOP *** [2d 7c 6s]
997ViqAtWn1FPjJqcffwcA: checks
RfLbneGRY8yQUpMgDnJCxA: checks
*** TURN *** [2d 7c 6s] [Jc]
997ViqAtWn1FPjJqcffwcA: checks
RfLbneGRY8yQUpMgDnJCxA: bets $1
997ViqAtWn1FPjJqcffwcA: folds
RfLbneGRY8yQUpMgDnJCxA collected $2.40 from pot
RfLbneGRY8yQUpMgDnJCxA: doesn't show hand
*** SUMMARY ***
Total pot $2.50 | Rake $0.10
Board [2d 7c 6s Jc]
Seat 1: 3obndzTJ6fECz8+wWhMd1w folded before Flop (didn't bet)
Seat 2: FL3MrLspcF23LYvC4ipBOA folded before Flop (didn't bet)
Seat 3: V138SURkdX8LdVBPKdJJag folded before Flop (didn't bet)
Seat 4: pbAfmxe4uSZPxJQX7gOzZA (button) folded before Flop (didn't bet)
Seat 6: VPF+HjszMvUIpy0CHIwH3A (small blind) folded before Flop
Seat 8: 997ViqAtWn1FPjJqcffwcA (big blind) folded on the Turn
Seat 9: RfLbneGRY8yQUpMgDnJCxA collected ($2.40)



PokerStars Game #59941392056:  Hold'em No Limit ($0.50/$1.00) - 2009/07/01 1:34:09 ET
Table 'blHlQApStil0OPeQxQxPcw' 9-max Seat #9 is the button
Seat 1: Pp/KTcXkfZKKUHkjyaLTdg ($21.30 in chips)
Seat 2: V138SURkdX8LdVBPKdJJag ($124.35 in chips)
Seat 3: OGgaARGdJQT4awWVNQ957w ($100 in chips)
Seat 5: uXrDE6JrIi8BZK1L8oQ9bQ ($51.10 in chips)
Seat 6: vljeiOoWscAIXU0fCuiEBw ($37.20 in chips)
Seat 8: laA8va+Yv8WuMqT1zdR91g ($100 in chips)
Seat 9: 6XkTu4ahxzHnvjjc1R8YjQ ($155.35 in chips)
Pp/KTcXkfZKKUHkjyaLTdg: posts small blind $0.50
V138SURkdX8LdVBPKdJJag: posts big blind $1
VPF+HjszMvUIpy0CHIwH3A: sits out
*** HOLE CARDS ***
OGgaARGdJQT4awWVNQ957w: folds
uXrDE6JrIi8BZK1L8oQ9bQ: calls $1
vljeiOoWscAIXU0fCuiEBw: calls $1
laA8va+Yv8WuMqT1zdR91g: folds
6XkTu4ahxzHnvjjc1R8YjQ: folds
Pp/KTcXkfZKKUHkjyaLTdg: calls $0.50
V138SURkdX8LdVBPKdJJag: checks
*** FLOP *** [Ad Kd 6d]
Pp/KTcXkfZKKUHkjyaLTdg: checks
e3u1tVujx+9fNGL+1+YnaQ leaves the table
V138SURkdX8LdVBPKdJJag: checks
uXrDE6JrIi8BZK1L8oQ9bQ: checks
vljeiOoWscAIXU0fCuiEBw: checks
*** TURN *** [Ad Kd 6d] [Qc]
Pp/KTcXkfZKKUHkjyaLTdg: checks
V138SURkdX8LdVBPKdJJag: checks
1862487932 joins the table at seat #4
uXrDE6JrIi8BZK1L8oQ9bQ: checks
vljeiOoWscAIXU0fCuiEBw: checks
*** RIVER *** [Ad Kd 6d Qc] [As]
Pp/KTcXkfZKKUHkjyaLTdg: bets $2
V138SURkdX8LdVBPKdJJag: folds
uXrDE6JrIi8BZK1L8oQ9bQ: folds
vljeiOoWscAIXU0fCuiEBw: folds
Pp/KTcXkfZKKUHkjyaLTdg collected $3.80 from pot
Pp/KTcXkfZKKUHkjyaLTdg: doesn't show hand
*** SUMMARY ***
Total pot $4 | Rake $0.20
Board [Ad Kd 6d Qc As]
Seat 1: Pp/KTcXkfZKKUHkjyaLTdg (small blind) collected ($3.80)
Seat 2: V138SURkdX8LdVBPKdJJag (big blind) folded on the River
Seat 3: OGgaARGdJQT4awWVNQ957w folded before Flop (didn't bet)
Seat 5: uXrDE6JrIi8BZK1L8oQ9bQ folded on the River
Seat 6: vljeiOoWscAIXU0fCuiEBw folded on the River
Seat 8: laA8va+Yv8WuMqT1zdR91g folded before Flop (didn't bet)
Seat 9: 6XkTu4ahxzHnvjjc1R8YjQ (button) folded before Flop (didn't bet)



PokerStars Game #59941392604:  Hold'em No Limit ($0.50/$1.00) - 2009/07/01 1:34:09 ET
Table 'b8oW/dOL7fDza5DfZ/dOJQ' 6-max Seat #2 is the button
Seat 1: NakujTNjHFgzceydFf+E2Q ($99.50 in chips)
Seat 2: TSuRyAHnUPCFjP7Z0rEE0w ($119 in chips)
Seat 3: d8WX+9nUHoqlrAGagO0Wow ($31.90 in chips)
Seat 4: X87W8qaGsudJTSkClK2Cig ($7.35 in chips)
Seat 5: r4lpoh2BJZ8S6zyQv1JeSw ($102.50 in chips)
Seat 6: PvfYaKbzMpsmUcbOExckbQ ($102.60 in chips)
d8WX+9nUHoqlrAGagO0Wow: posts small blind $0.50
X87W8qaGsudJTSkClK2Cig: posts big blind $1
*** HOLE CARDS ***
r4lpoh2BJZ8S6zyQv1JeSw: folds
PvfYaKbzMpsmUcbOExckbQ: folds
NakujTNjHFgzceydFf+E2Q: folds
TSuRyAHnUPCFjP7Z0rEE0w: raises $3 to $4
d8WX+9nUHoqlrAGagO0Wow: folds
X87W8qaGsudJTSkClK2Cig: folds
TSuRyAHnUPCFjP7Z0rEE0w collected $2.50 from pot
TSuRyAHnUPCFjP7Z0rEE0w: doesn't show hand
*** SUMMARY ***
Total pot $2.50 | Rake $0
Seat 1: NakujTNjHFgzceydFf+E2Q folded before Flop (didn't bet)
Seat 2: TSuRyAHnUPCFjP7Z0rEE0w (button) collected ($2.50)
Seat 3: d8WX+9nUHoqlrAGagO0Wow (small blind) folded before Flop
Seat 4: X87W8qaGsudJTSkClK2Cig (big blind) folded before Flop
Seat 5: r4lpoh2BJZ8S6zyQv1JeSw folded before Flop (didn't bet)
Seat 6: PvfYaKbzMpsmUcbOExckbQ folded before Flop (didn't bet)



PokerStars Game #59941392434:  Hold'em No Limit ($0.50/$1.00) - 2009/07/01 1:34:09 ET
Table 'N6LvHFrb+cdXY/COI6ByOw' 2-max Seat #2 is the button
Seat 1: lXX4W7m3u++JiSOZ46yVMQ ($19.45 in chips)
Seat 2: 9mAoSP3o/mikSZOW2LEEAw ($175.70 in chips)
9mAoSP3o/mikSZOW2LEEAw: posts small blind $0.50
lXX4W7m3u++JiSOZ46yVMQ: posts big blind $1
*** HOLE CARDS ***
9mAoSP3o/mikSZOW2LEEAw: calls $0.50
lXX4W7m3u++JiSOZ46yVMQ: raises $2 to $3
9mAoSP3o/mikSZOW2LEEAw: calls $2
*** FLOP *** [Ah Ad 4d]
lXX4W7m3u++JiSOZ46yVMQ: checks
9mAoSP3o/mikSZOW2LEEAw: checks
*** TURN *** [Ah Ad 4d] [Qs]
lXX4W7m3u++JiSOZ46yVMQ: checks
9mAoSP3o/mikSZOW2LEEAw: checks
*** RIVER *** [Ah Ad 4d Qs] [7c]
lXX4W7m3u++JiSOZ46yVMQ: checks
9mAoSP3o/mikSZOW2LEEAw: checks
*** SHOW DOWN ***
lXX4W7m3u++JiSOZ46yVMQ: shows [7d Jh] (two pair, Aces and Sevens)
9mAoSP3o/mikSZOW2LEEAw: shows [Kh 4c] (two pair, Aces and Fours)
lXX4W7m3u++JiSOZ46yVMQ collected $5.70 from pot
*** SUMMARY ***
Total pot $6 | Rake $0.30
Board [Ah Ad 4d Qs 7c]
Seat 1: lXX4W7m3u++JiSOZ46yVMQ (big blind) showed [7d Jh] and won ($5.70) with two pair, Aces and Sevens
Seat 2: 9mAoSP3o/mikSZOW2LEEAw (button) (small blind) showed [Kh 4c] and lost with two pair, Aces and Fours



PokerStars Game #59941392876:  Hold'em No Limit ($0.50/$1.00) - 2009/07/01 1:34:10 ET
Table 'GxCPo/gd3OSthkYrAxJngg' 6-max Seat #1 is the button
Seat 1: sH8BpAFP+jGFxCgVpD1Lew ($231.75 in chips)
Seat 2: YExX2paeIHrmfIwV1ivM/w ($66.60 in chips)
Seat 3: idVgoPAdspFPCzee6aF9Pg ($131.50 in chips)
Seat 4: YMJG+F++3Aj6P8dAWda5fw ($208.35 in chips)
Seat 6: 4d1rWhpu8DzLmzMbR3QKyA ($100 in chips)
YExX2paeIHrmfIwV1ivM/w: posts small blind $0.50
idVgoPAdspFPCzee6aF9Pg: posts big blind $1
*** HOLE CARDS ***
YMJG+F++3Aj6P8dAWda5fw: folds
4d1rWhpu8DzLmzMbR3QKyA: raises $2 to $3
sH8BpAFP+jGFxCgVpD1Lew: folds
vX+iYAEINFeLxwMla7DY1Q joins the table at seat #5
YExX2paeIHrmfIwV1ivM/w: folds
idVgoPAdspFPCzee6aF9Pg: folds
4d1rWhpu8DzLmzMbR3QKyA collected $2.50 from pot
*** SUMMARY ***
Total pot $2.50 | Rake $0
Seat 1: sH8BpAFP+jGFxCgVpD1Lew (button) folded before Flop (didn't bet)
Seat 2: YExX2paeIHrmfIwV1ivM/w (small blind) folded before Flop
Seat 3: idVgoPAdspFPCzee6aF9Pg (big blind) folded before Flop
Seat 4: YMJG+F++3Aj6P8dAWda5fw folded before Flop (didn't bet)
Seat 6: 4d1rWhpu8DzLmzMbR3QKyA collected ($2.50)



PokerStars Game #59941392804:  Hold'em No Limit ($0.50/$1.00) - 2009/07/01 1:34:10 ET
Table 'hugOjcwJvzEwZbK7tyiWuQ' 9-max Seat #2 is the button
Seat 1: S3Ex8K7v6xm5jqjRM7Fl3w ($26.35 in chips)
Seat 2: r27C1nIV4NS4+qbnrgBQSw ($278.60 in chips)
Seat 4: UWB3oeddt/GObx2Mix2Anw ($155.10 in chips)
Seat 5: AexZ4puUV9meFWwVU6Nv0w ($32.70 in chips)
Seat 6: gUUvmqdVlmvpal6B8nYrmg ($105.45 in chips)
Seat 7: FL3MrLspcF23LYvC4ipBOA ($111.30 in chips)
Seat 8: /zy+DB4S5fUQUSfZWFzYGw ($118.35 in chips)
Seat 9: W8P9bUKCs43TO1xHm0dL6w ($109.80 in chips)
UWB3oeddt/GObx2Mix2Anw: posts small blind $0.50
AexZ4puUV9meFWwVU6Nv0w: posts big blind $1
*** HOLE CARDS ***
gUUvmqdVlmvpal6B8nYrmg: folds
FL3MrLspcF23LYvC4ipBOA: folds
/zy+DB4S5fUQUSfZWFzYGw: folds
W8P9bUKCs43TO1xHm0dL6w: calls $1
S3Ex8K7v6xm5jqjRM7Fl3w: folds
r27C1nIV4NS4+qbnrgBQSw: folds
UWB3oeddt/GObx2Mix2Anw: calls $0.50
AexZ4puUV9meFWwVU6Nv0w: checks
*** FLOP *** [8s Qh 5h]
c/6hFCyfLNRn3VFvCeQ1ng has returned
UWB3oeddt/GObx2Mix2Anw: bets $3
AexZ4puUV9meFWwVU6Nv0w: folds
W8P9bUKCs43TO1xHm0dL6w: folds
UWB3oeddt/GObx2Mix2Anw collected $2.85 from pot
*** SUMMARY ***
Total pot $3 | Rake $0.15
Board [8s Qh 5h]
Seat 1: S3Ex8K7v6xm5jqjRM7Fl3w folded before Flop (didn't bet)
Seat 2: r27C1nIV4NS4+qbnrgBQSw (button) folded before Flop (didn't bet)
Seat 4: UWB3oeddt/GObx2Mix2Anw (small blind) collected ($2.85)
Seat 5: AexZ4puUV9meFWwVU6Nv0w (big blind) folded on the Flop
Seat 6: gUUvmqdVlmvpal6B8nYrmg folded before Flop (didn't bet)
Seat 7: FL3MrLspcF23LYvC4ipBOA folded before Flop (didn't bet)
Seat 8: /zy+DB4S5fUQUSfZWFzYGw folded before Flop (didn't bet)
Seat 9: W8P9bUKCs43TO1xHm0dL6w folded on the Flop



PokerStars Game #59941395376:  Hold'em No Limit ($0.50/$1.00) - 2009/07/01 1:34:14 ET
Table 'pHrhryH8jPNdQfY62f8v+g' 6-max Seat #2 is the button
Seat 1: 4d1rWhpu8DzLmzMbR3QKyA ($145.95 in chips)
Seat 2: JwCcjZl0bjJzG7hmE0dnTA ($116.05 in chips)
Seat 3: 8oS5O7iD/qnFXFXJrGIgNQ ($111.30 in chips)
Seat 4: 1f3beyIML24UqEMTbWy93g ($60.20 in chips)
Seat 5: d8WX+9nUHoqlrAGagO0Wow ($18.50 in chips)
Seat 6: xAU6q2/cwmby2sxmA8VcmA ($176.75 in chips)
8oS5O7iD/qnFXFXJrGIgNQ: posts small blind $0.50
1f3beyIML24UqEMTbWy93g: posts big blind $1
*** HOLE CARDS ***
d8WX+9nUHoqlrAGagO0Wow: folds
xAU6q2/cwmby2sxmA8VcmA: folds
4d1rWhpu8DzLmzMbR3QKyA: raises $2 to $3
JwCcjZl0bjJzG7hmE0dnTA: folds
8oS5O7iD/qnFXFXJrGIgNQ: folds
1f3beyIML24UqEMTbWy93g: folds
4d1rWhpu8DzLmzMbR3QKyA collected $2.50 from pot
*** SUMMARY ***
Total pot $2.50 | Rake $0
Seat 1: 4d1rWhpu8DzLmzMbR3QKyA collected ($2.50)
Seat 2: JwCcjZl0bjJzG7hmE0dnTA (button) folded before Flop (didn't bet)
Seat 3: 8oS5O7iD/qnFXFXJrGIgNQ (small blind) folded before Flop
Seat 4: 1f3beyIML24UqEMTbWy93g (big blind) folded before Flop
Seat 5: d8WX+9nUHoqlrAGagO0Wow folded before Flop (didn't bet)
Seat 6: xAU6q2/cwmby2sxmA8VcmA folded before Flop (didn't bet)



PokerStars Game #59941396688:  Hold'em No Limit ($0.50/$1.00) - 2009/07/01 1:34:17 ET
Table 'NqGO/cV3MwFAx+ZPB5ANmQ' 2-max Seat #1 is the button
Seat 1: ItaRAnHOgvYOv5ynbG1iTw ($127.70 in chips)
Seat 2: GtFB+yyeb2djMdPFuOW/Xg ($161.70 in chips)
ItaRAnHOgvYOv5ynbG1iTw: posts small blind $0.50
GtFB+yyeb2djMdPFuOW/Xg: posts big blind $1
*** HOLE CARDS ***
ItaRAnHOgvYOv5ynbG1iTw: folds
GtFB+yyeb2djMdPFuOW/Xg collected $1 from pot
*** SUMMARY ***
Total pot $1 | Rake $0
Seat 1: ItaRAnHOgvYOv5ynbG1iTw (button) (small blind) folded before Flop
Seat 2: GtFB+yyeb2djMdPFuOW/Xg (big blind) collected ($1)



PokerStars Game #59941397384:  Hold'em No Limit ($0.50/$1.00) - 2009/07/01 1:34:18 ET
Table 'vs/5jr6ciwjVQ5+Soc+u2A' 6-max Seat #5 is the button
Seat 1: J798qwLuvXyq0BbzsIjOrA ($176 in chips)
Seat 2: lXX4W7m3u++JiSOZ46yVMQ ($100 in chips)
Seat 5: +Nt3OPk3XR9SKjZgm2CexQ ($165.70 in chips)
Seat 6: Z2fXsGcjl+Eax+RzOgwOmg ($103.50 in chips)
Z2fXsGcjl+Eax+RzOgwOmg: posts small blind $0.50
J798qwLuvXyq0BbzsIjOrA: posts big blind $1
0smcry9L0OOTCP+KzIS5SA: sits out
*** HOLE CARDS ***
lXX4W7m3u++JiSOZ46yVMQ: raises $2 to $3
+Nt3OPk3XR9SKjZgm2CexQ: calls $3
Z2fXsGcjl+Eax+RzOgwOmg: folds
J798qwLuvXyq0BbzsIjOrA: folds
*** FLOP *** [5d 7h 9d]
lXX4W7m3u++JiSOZ46yVMQ: checks
+Nt3OPk3XR9SKjZgm2CexQ: checks
*** TURN *** [5d 7h 9d] [7c]
lXX4W7m3u++JiSOZ46yVMQ: checks
+Nt3OPk3XR9SKjZgm2CexQ: checks
*** RIVER *** [5d 7h 9d 7c] [6c]
lXX4W7m3u++JiSOZ46yVMQ: checks
+Nt3OPk3XR9SKjZgm2CexQ: checks
*** SHOW DOWN ***
lXX4W7m3u++JiSOZ46yVMQ: shows [Tc Ks] (a pair of Sevens)
+Nt3OPk3XR9SKjZgm2CexQ: shows [3d 3s] (two pair, Sevens and Threes)
+Nt3OPk3XR9SKjZgm2CexQ collected $7.15 from pot
*** SUMMARY ***
Total pot $7.50 | Rake $0.35
Board [5d 7h 9d 7c 6c]
Seat 1: J798qwLuvXyq0BbzsIjOrA (big blind) folded before Flop
Seat 2: lXX4W7m3u++JiSOZ46yVMQ showed [Tc Ks] and lost with a pair of Sevens
Seat 5: +Nt3OPk3XR9SKjZgm2CexQ (button) showed [3d 3s] and won ($7.15) with two pair, Sevens and Threes
Seat 6: Z2fXsGcjl+Eax+RzOgwOmg (small blind) folded before Flop



PokerStars Game #59941397906:  Hold'em No Limit ($0.50/$1.00) - 2009/07/01 1:34:19 ET
Table '7O9fB8yx1u7sJveJn8w6jA' 6-max Seat #6 is the button
Seat 1: 841740 ($46.45 in chips)
Seat 2: wx3sQGkVi2x9wJXuWNHPBw ($203.30 in chips)
Seat 3: hpxXcmRkXXI9HE5+5/j/0Q ($142.90 in chips)
Seat 4: b2a+5TkFf4xJN/Ihhma58Q ($33.85 in chips)
Seat 5: BCEV3COoKY607AzLWayfRA ($100 in chips)
Seat 6: r4lpoh2BJZ8S6zyQv1JeSw ($100 in chips)
841740: posts small blind $0.50
wx3sQGkVi2x9wJXuWNHPBw: posts big blind $1
*** HOLE CARDS ***
hpxXcmRkXXI9HE5+5/j/0Q: folds
b2a+5TkFf4xJN/Ihhma58Q: folds
BCEV3COoKY607AzLWayfRA: folds
r4lpoh2BJZ8S6zyQv1JeSw: folds
841740: calls $0.50
wx3sQGkVi2x9wJXuWNHPBw: checks
*** FLOP *** [8c Td Ts]
841740: checks
wx3sQGkVi2x9wJXuWNHPBw: folds
841740 collected $1.90 from pot
*** SUMMARY ***
Total pot $2 | Rake $0.10
Board [8c Td Ts]
Seat 1: 841740 (small blind) collected ($1.90)
Seat 2: wx3sQGkVi2x9wJXuWNHPBw (big blind) folded on the Flop
Seat 3: hpxXcmRkXXI9HE5+5/j/0Q folded before Flop (didn't bet)
Seat 4: b2a+5TkFf4xJN/Ihhma58Q folded before Flop (didn't bet)
Seat 5: BCEV3COoKY607AzLWayfRA folded before Flop (didn't bet)
Seat 6: r4lpoh2BJZ8S6zyQv1JeSw (button) folded before Flop (didn't bet)



PokerStars Game #59941399746:  Hold'em No Limit ($0.50/$1.00) - 2009/07/01 1:34:22 ET
Table 'O96CPOtvMBWP6kzuYDfdFA' 6-max Seat #6 is the button
Seat 1: 6alLXQIITA2EZ/lBeym8Dw ($127.25 in chips)
Seat 2: 4d1rWhpu8DzLmzMbR3QKyA ($100 in chips)
Seat 4: /P4w1pHg2zHYg/4ubJ0dPw ($65.15 in chips)
Seat 6: 3syOXva630dm1FTdwnuLpw ($79.65 in chips)
6alLXQIITA2EZ/lBeym8Dw: posts small blind $0.50
4d1rWhpu8DzLmzMbR3QKyA: posts big blind $1
vX+iYAEINFeLxwMla7DY1Q: sits out
*** HOLE CARDS ***
/P4w1pHg2zHYg/4ubJ0dPw: folds
3syOXva630dm1FTdwnuLpw: folds
6alLXQIITA2EZ/lBeym8Dw: raises $2 to $3
4d1rWhpu8DzLmzMbR3QKyA: folds
6alLXQIITA2EZ/lBeym8Dw collected $2 from pot
*** SUMMARY ***
Total pot $2 | Rake $0
Seat 1: 6alLXQIITA2EZ/lBeym8Dw (small blind) collected ($2)
Seat 2: 4d1rWhpu8DzLmzMbR3QKyA (big blind) folded before Flop
Seat 4: /P4w1pHg2zHYg/4ubJ0dPw folded before Flop (didn't bet)
Seat 6: 3syOXva630dm1FTdwnuLpw (button) folded before Flop (didn't bet)



PokerStars Game #59941400252:  Hold'em No Limit ($0.50/$1.00) - 2009/07/01 1:34:23 ET
Table 'qj0HBN4HhQKogreu1bg7xg' 2-max Seat #2 is the button
Seat 1: NYi6JFscYNrofSXy4sM+Yw ($114.50 in chips)
Seat 2: qtyl8CSb0/4yWdbuEPJejA ($165.90 in chips)
qtyl8CSb0/4yWdbuEPJejA: posts small blind $0.50
NYi6JFscYNrofSXy4sM+Yw: posts big blind $1
*** HOLE CARDS ***
qtyl8CSb0/4yWdbuEPJejA: raises $2 to $3
NYi6JFscYNrofSXy4sM+Yw: folds
qtyl8CSb0/4yWdbuEPJejA collected $2 from pot
qtyl8CSb0/4yWdbuEPJejA: doesn't show hand
*** SUMMARY ***
Total pot $2 | Rake $0
Seat 1: NYi6JFscYNrofSXy4sM+Yw (big blind) folded before Flop
Seat 2: qtyl8CSb0/4yWdbuEPJejA (button) (small blind) collected ($2)



PokerStars Game #59941400198:  Hold'em No Limit ($0.50/$1.00) - 2009/07/01 1:34:23 ET
Table 'cBDNutyLBKEk9+ptwsKmTw' 6-max Seat #6 is the button
Seat 1: xAU6q2/cwmby2sxmA8VcmA ($271.05 in chips)
Seat 2: 4OO5v3AVduL0tePNx8wk5A ($135.10 in chips)
Seat 4: OMkHNxIUZxh1pHqcCjbjgw ($101.50 in chips)
Seat 5: hpxXcmRkXXI9HE5+5/j/0Q ($104.70 in chips)
Seat 6: QHvTZcrKe6+maWUfVjP29Q ($147 in chips)
xAU6q2/cwmby2sxmA8VcmA: posts small blind $0.50
4OO5v3AVduL0tePNx8wk5A: posts big blind $1
*** HOLE CARDS ***
OMkHNxIUZxh1pHqcCjbjgw: folds
hpxXcmRkXXI9HE5+5/j/0Q has timed out
hpxXcmRkXXI9HE5+5/j/0Q: folds
hpxXcmRkXXI9HE5+5/j/0Q is sitting out
QHvTZcrKe6+maWUfVjP29Q: folds
xAU6q2/cwmby2sxmA8VcmA: raises $3 to $4
4OO5v3AVduL0tePNx8wk5A: folds
xAU6q2/cwmby2sxmA8VcmA collected $2 from pot
xAU6q2/cwmby2sxmA8VcmA: doesn't show hand
*** SUMMARY ***
Total pot $2 | Rake $0
Seat 1: xAU6q2/cwmby2sxmA8VcmA (small blind) collected ($2)
Seat 2: 4OO5v3AVduL0tePNx8wk5A (big blind) folded before Flop
Seat 4: OMkHNxIUZxh1pHqcCjbjgw folded before Flop (didn't bet)
Seat 5: hpxXcmRkXXI9HE5+5/j/0Q folded before Flop (didn't bet)
Seat 6: QHvTZcrKe6+maWUfVjP29Q (button) folded before Flop (didn't bet)



PokerStars Game #59941400496:  Hold'em No Limit ($0.50/$1.00) - 2009/07/01 1:34:24 ET
Table 'QSIig7BLMc9wY/rgBechzw' 6-max Seat #2 is the button
Seat 1: Z2fXsGcjl+Eax+RzOgwOmg ($132.55 in chips)
Seat 2: mLOIkH/qmRa+mVujQIhBRg ($20.40 in chips)
Seat 4: +uSzP8Jwnw7sKfQ4s66b7w ($61.30 in chips)
Seat 5: lsLuWlcPA3Rh7kJVLzMh0Q ($101.70 in chips)
Seat 6: PxqfkAMdAWtkgbT+q2gciA ($53.60 in chips)
4OO5v3AVduL0tePNx8wk5A will be allowed to play after the button
+uSzP8Jwnw7sKfQ4s66b7w: posts small blind $0.50
lsLuWlcPA3Rh7kJVLzMh0Q: posts big blind $1
*** HOLE CARDS ***
PxqfkAMdAWtkgbT+q2gciA: folds
Z2fXsGcjl+Eax+RzOgwOmg: folds
mLOIkH/qmRa+mVujQIhBRg: folds
+uSzP8Jwnw7sKfQ4s66b7w: raises $3 to $4
lsLuWlcPA3Rh7kJVLzMh0Q: folds
+uSzP8Jwnw7sKfQ4s66b7w collected $2 from pot
*** SUMMARY ***
Total pot $2 | Rake $0
Seat 1: Z2fXsGcjl+Eax+RzOgwOmg folded before Flop (didn't bet)
Seat 2: mLOIkH/qmRa+mVujQIhBRg (button) folded before Flop (didn't bet)
Seat 4: +uSzP8Jwnw7sKfQ4s66b7w (small blind) collected ($2)
Seat 5: lsLuWlcPA3Rh7kJVLzMh0Q (big blind) folded before Flop
Seat 6: PxqfkAMdAWtkgbT+q2gciA folded before Flop (didn't bet)



PokerStars Game #59941400954:  Hold'em No Limit ($0.50/$1.00) - 2009/07/01 1:34:24 ET
Table 'b8oW/dOL7fDza5DfZ/dOJQ' 6-max Seat #3 is the button
Seat 1: NakujTNjHFgzceydFf+E2Q ($99.50 in chips)
Seat 2: TSuRyAHnUPCFjP7Z0rEE0w ($120.50 in chips)
Seat 3: d8WX+9nUHoqlrAGagO0Wow ($31.40 in chips)
Seat 4: X87W8qaGsudJTSkClK2Cig ($6.35 in chips)
Seat 5: r4lpoh2BJZ8S6zyQv1JeSw ($102.50 in chips)
Seat 6: PvfYaKbzMpsmUcbOExckbQ ($102.60 in chips)
X87W8qaGsudJTSkClK2Cig: posts small blind $0.50
r4lpoh2BJZ8S6zyQv1JeSw: posts big blind $1
*** HOLE CARDS ***
PvfYaKbzMpsmUcbOExckbQ: folds
NakujTNjHFgzceydFf+E2Q: folds
TSuRyAHnUPCFjP7Z0rEE0w: folds
d8WX+9nUHoqlrAGagO0Wow: folds
X87W8qaGsudJTSkClK2Cig: calls $0.50
r4lpoh2BJZ8S6zyQv1JeSw: checks
*** FLOP *** [Ad Ks 2c]
X87W8qaGsudJTSkClK2Cig: bets $2
r4lpoh2BJZ8S6zyQv1JeSw: folds
X87W8qaGsudJTSkClK2Cig collected $1.90 from pot
*** SUMMARY ***
Total pot $2 | Rake $0.10
Board [Ad Ks 2c]
Seat 1: NakujTNjHFgzceydFf+E2Q folded before Flop (didn't bet)
Seat 2: TSuRyAHnUPCFjP7Z0rEE0w folded before Flop (didn't bet)
Seat 3: d8WX+9nUHoqlrAGagO0Wow (button) folded before Flop (didn't bet)
Seat 4: X87W8qaGsudJTSkClK2Cig (small blind) collected ($1.90)
Seat 5: r4lpoh2BJZ8S6zyQv1JeSw (big blind) folded on the Flop
Seat 6: PvfYaKbzMpsmUcbOExckbQ folded before Flop (didn't bet)



PokerStars Game #59941401312:  Hold'em No Limit ($0.50/$1.00) - 2009/07/01 1:34:25 ET
Table 'NqGO/cV3MwFAx+ZPB5ANmQ' 2-max Seat #2 is the button
Seat 1: ItaRAnHOgvYOv5ynbG1iTw ($127.20 in chips)
Seat 2: GtFB+yyeb2djMdPFuOW/Xg ($162.20 in chips)
GtFB+yyeb2djMdPFuOW/Xg: posts small blind $0.50
ItaRAnHOgvYOv5ynbG1iTw: posts big blind $1
*** HOLE CARDS ***
GtFB+yyeb2djMdPFuOW/Xg: raises $2 to $3
ItaRAnHOgvYOv5ynbG1iTw: raises $5 to $8
GtFB+yyeb2djMdPFuOW/Xg: calls $5
*** FLOP *** [Ks 3h 5c]
ItaRAnHOgvYOv5ynbG1iTw: bets $9
GtFB+yyeb2djMdPFuOW/Xg: calls $9
*** TURN *** [Ks 3h 5c] [9d]
ItaRAnHOgvYOv5ynbG1iTw: bets $7
GtFB+yyeb2djMdPFuOW/Xg: raises $20 to $27
ItaRAnHOgvYOv5ynbG1iTw: calls $20
*** RIVER *** [Ks 3h 5c 9d] [3s]
ItaRAnHOgvYOv5ynbG1iTw: checks
GtFB+yyeb2djMdPFuOW/Xg: bets $65
ItaRAnHOgvYOv5ynbG1iTw: calls $65
*** SHOW DOWN ***
GtFB+yyeb2djMdPFuOW/Xg: shows [6s 5h] (two pair, Fives and Threes)
ItaRAnHOgvYOv5ynbG1iTw: shows [Td Kh] (two pair, Kings and Threes)
ItaRAnHOgvYOv5ynbG1iTw collected $217.50 from pot
*** SUMMARY ***
Total pot $218 | Rake $0.50
Board [Ks 3h 5c 9d 3s]
Seat 1: ItaRAnHOgvYOv5ynbG1iTw (big blind) showed [Td Kh] and won ($217.50) with two pair, Kings and Threes
Seat 2: GtFB+yyeb2djMdPFuOW/Xg (button) (small blind) showed [6s 5h] and lost with two pair, Fives and Threes



PokerStars Game #59941401210:  Hold'em No Limit ($0.50/$1.00) - 2009/07/01 1:34:25 ET
Table 'tJq9SfN1ywY0r03VBlWlwQ' 9-max Seat #7 is the button
Seat 1: wZsU+w9r7G66x93UuvBf1Q ($299.05 in chips)
Seat 2: VPF+HjszMvUIpy0CHIwH3A ($20 in chips)
Seat 4: bLbSOSmSOnqE0iTcH/5dxA ($114.20 in chips)
Seat 5: h5ipsNTMyolp7xn/NAvWkA ($134.80 in chips)
Seat 6: gUUvmqdVlmvpal6B8nYrmg ($100 in chips)
Seat 7: Ogn4JDV3mp4ZDKO49IFzKA ($18.50 in chips)
Seat 8: G4DEhsZFmznGNVpy2SEocA ($41.30 in chips)
Seat 9: XE5QF1y74bpHog9JxWJMWQ ($100 in chips)
G4DEhsZFmznGNVpy2SEocA: posts small blind $0.50
XE5QF1y74bpHog9JxWJMWQ: posts big blind $1
*** HOLE CARDS ***
wZsU+w9r7G66x93UuvBf1Q: folds
VPF+HjszMvUIpy0CHIwH3A: folds
bLbSOSmSOnqE0iTcH/5dxA: folds
h5ipsNTMyolp7xn/NAvWkA: folds
gUUvmqdVlmvpal6B8nYrmg: folds
Ogn4JDV3mp4ZDKO49IFzKA: calls $1
G4DEhsZFmznGNVpy2SEocA: folds
XE5QF1y74bpHog9JxWJMWQ: checks
*** FLOP *** [5h 4h 8c]
XE5QF1y74bpHog9JxWJMWQ: checks
Ogn4JDV3mp4ZDKO49IFzKA: bets $2
XE5QF1y74bpHog9JxWJMWQ: folds
Ogn4JDV3mp4ZDKO49IFzKA collected $2.40 from pot
*** SUMMARY ***
Total pot $2.50 | Rake $0.10
Board [5h 4h 8c]
Seat 1: wZsU+w9r7G66x93UuvBf1Q folded before Flop (didn't bet)
Seat 2: VPF+HjszMvUIpy0CHIwH3A folded before Flop (didn't bet)
Seat 4: bLbSOSmSOnqE0iTcH/5dxA folded before Flop (didn't bet)
Seat 5: h5ipsNTMyolp7xn/NAvWkA folded before Flop (didn't bet)
Seat 6: gUUvmqdVlmvpal6B8nYrmg folded before Flop (didn't bet)
Seat 7: Ogn4JDV3mp4ZDKO49IFzKA (button) collected ($2.40)
Seat 8: G4DEhsZFmznGNVpy2SEocA (small blind) folded before Flop
Seat 9: XE5QF1y74bpHog9JxWJMWQ (big blind) folded on the Flop



PokerStars Game #59941402256:  Hold'em No Limit ($0.50/$1.00) - 2009/07/01 1:34:27 ET
Table '/RZcOwpZpHQ+OwPwjsbnRw' 6-max Seat #4 is the button
Seat 1: +uSzP8Jwnw7sKfQ4s66b7w ($39.25 in chips)
Seat 2: Z2fXsGcjl+Eax+RzOgwOmg ($100 in chips)
Seat 3: LJMw/I77xpnw0R5T4HnMUg ($107.15 in chips)
Seat 4: j7NIOHLZk7V2o9fOioO5ug ($100 in chips)
Seat 5: wx3sQGkVi2x9wJXuWNHPBw ($166.25 in chips)
Seat 6: o3YLm/rSY916m/on1VjXPA ($214 in chips)
wx3sQGkVi2x9wJXuWNHPBw: posts small blind $0.50
o3YLm/rSY916m/on1VjXPA: posts big blind $1
*** HOLE CARDS ***
+uSzP8Jwnw7sKfQ4s66b7w: raises $2 to $3
Z2fXsGcjl+Eax+RzOgwOmg: folds
LJMw/I77xpnw0R5T4HnMUg: folds
j7NIOHLZk7V2o9fOioO5ug: folds
wx3sQGkVi2x9wJXuWNHPBw: folds
o3YLm/rSY916m/on1VjXPA: folds
+uSzP8Jwnw7sKfQ4s66b7w collected $2.50 from pot
*** SUMMARY ***
Total pot $2.50 | Rake $0
Seat 1: +uSzP8Jwnw7sKfQ4s66b7w collected ($2.50)
Seat 2: Z2fXsGcjl+Eax+RzOgwOmg folded before Flop (didn't bet)
Seat 3: LJMw/I77xpnw0R5T4HnMUg folded before Flop (didn't bet)
Seat 4: j7NIOHLZk7V2o9fOioO5ug (button) folded before Flop (didn't bet)
Seat 5: wx3sQGkVi2x9wJXuWNHPBw (small blind) folded before Flop
Seat 6: o3YLm/rSY916m/on1VjXPA (big blind) folded before Flop



PokerStars Game #59941403156:  Hold'em No Limit ($0.50/$1.00) - 2009/07/01 1:34:28 ET
Table 'kS0cTQAEi+fdUlJP2gQYvw' 9-max Seat #1 is the button
Seat 1: SqsWPukL8kLqrhq5ZrQdSQ ($90 in chips)
Seat 3: 2BV+oJIQYr65IO6nEChvbA ($63.55 in chips)
Seat 4: RUhhaALzha3TH1AkdakoGQ ($52.50 in chips)
Seat 5: 997ViqAtWn1FPjJqcffwcA ($100 in chips)
Seat 6: yAbu2QsRPVcjPbqlf/jDxw ($118.65 in chips)
Seat 7: Ffa7Nj4X5fddtROP01hfQg ($145.50 in chips)
Seat 8: vKyFzTyzfT7fZcdX+HHN+Q ($48.55 in chips)
Seat 9: OGgaARGdJQT4awWVNQ957w ($107.20 in chips)
2BV+oJIQYr65IO6nEChvbA: posts small blind $0.50
RUhhaALzha3TH1AkdakoGQ: posts big blind $1
*** HOLE CARDS ***
997ViqAtWn1FPjJqcffwcA: folds
yAbu2QsRPVcjPbqlf/jDxw: folds
Ffa7Nj4X5fddtROP01hfQg: folds
vKyFzTyzfT7fZcdX+HHN+Q: calls $1
OGgaARGdJQT4awWVNQ957w: folds
SqsWPukL8kLqrhq5ZrQdSQ: calls $1
2BV+oJIQYr65IO6nEChvbA: calls $0.50
RUhhaALzha3TH1AkdakoGQ: checks
*** FLOP *** [6c Jc Js]
2BV+oJIQYr65IO6nEChvbA: checks
RUhhaALzha3TH1AkdakoGQ: checks
+JautI/vSNALzwSvsOqbCQ joins the table at seat #2
vKyFzTyzfT7fZcdX+HHN+Q has timed out
vKyFzTyzfT7fZcdX+HHN+Q: checks
SqsWPukL8kLqrhq5ZrQdSQ: checks
*** TURN *** [6c Jc Js] [5h]
2BV+oJIQYr65IO6nEChvbA: checks
RUhhaALzha3TH1AkdakoGQ: checks
vKyFzTyzfT7fZcdX+HHN+Q: bets $47.55 and is all-in
SqsWPukL8kLqrhq5ZrQdSQ: folds
2BV+oJIQYr65IO6nEChvbA: folds
RUhhaALzha3TH1AkdakoGQ: folds
vKyFzTyzfT7fZcdX+HHN+Q collected $3.80 from pot
*** SUMMARY ***
Total pot $4 | Rake $0.20
Board [6c Jc Js 5h]
Seat 1: SqsWPukL8kLqrhq5ZrQdSQ (button) folded on the Turn
Seat 3: 2BV+oJIQYr65IO6nEChvbA (small blind) folded on the Turn
Seat 4: RUhhaALzha3TH1AkdakoGQ (big blind) folded on the Turn
Seat 5: 997ViqAtWn1FPjJqcffwcA folded before Flop (didn't bet)
Seat 6: yAbu2QsRPVcjPbqlf/jDxw folded before Flop (didn't bet)
Seat 7: Ffa7Nj4X5fddtROP01hfQg folded before Flop (didn't bet)
Seat 8: vKyFzTyzfT7fZcdX+HHN+Q collected ($3.80)
Seat 9: OGgaARGdJQT4awWVNQ957w folded before Flop (didn't bet)



PokerStars Game #59941403830:  Hold'em No Limit ($0.50/$1.00) - 2009/07/01 1:34:29 ET
Table 'tHb+N6GaPEmmBAe36B2R9Q' 2-max Seat #1 is the button
Seat 1: rL+Zpv4/vX2BVHcyfh/NXA ($102.90 in chips)
Seat 2: Pm1sDZZi0zFtnFGXLznkug ($127.70 in chips)
rL+Zpv4/vX2BVHcyfh/NXA: posts small blind $0.50
Pm1sDZZi0zFtnFGXLznkug: posts big blind $1
*** HOLE CARDS ***
rL+Zpv4/vX2BVHcyfh/NXA: raises $2 to $3
Pm1sDZZi0zFtnFGXLznkug said, "my turn to get lucky i guess"
Pm1sDZZi0zFtnFGXLznkug: folds
rL+Zpv4/vX2BVHcyfh/NXA said, "all good :)"
rL+Zpv4/vX2BVHcyfh/NXA collected $2 from pot
rL+Zpv4/vX2BVHcyfh/NXA: doesn't show hand
*** SUMMARY ***
Total pot $2 | Rake $0
Seat 1: rL+Zpv4/vX2BVHcyfh/NXA (button) (small blind) collected ($2)
Seat 2: Pm1sDZZi0zFtnFGXLznkug (big blind) folded before Flop



PokerStars Game #59941404728:  Hold'em No Limit ($0.50/$1.00) - 2009/07/01 1:34:31 ET
Table 'qj0HBN4HhQKogreu1bg7xg' 2-max Seat #1 is the button
Seat 1: NYi6JFscYNrofSXy4sM+Yw ($113.50 in chips)
Seat 2: qtyl8CSb0/4yWdbuEPJejA ($166.90 in chips)
NYi6JFscYNrofSXy4sM+Yw: posts small blind $0.50
qtyl8CSb0/4yWdbuEPJejA: posts big blind $1
*** HOLE CARDS ***
NYi6JFscYNrofSXy4sM+Yw: raises $2 to $3
qtyl8CSb0/4yWdbuEPJejA: folds
NYi6JFscYNrofSXy4sM+Yw collected $2 from pot
NYi6JFscYNrofSXy4sM+Yw: doesn't show hand
*** SUMMARY ***
Total pot $2 | Rake $0
Seat 1: NYi6JFscYNrofSXy4sM+Yw (button) (small blind) collected ($2)
Seat 2: qtyl8CSb0/4yWdbuEPJejA (big blind) folded before Flop



PokerStars Game #59941404456:  Hold'em No Limit ($0.50/$1.00) - 2009/07/01 1:34:31 ET
Table 'ZFWj23PMihdwrNWv41OG/QtyUh+jyNvrceIQdKMJjQ2weat #1 is the button
Seat 1: j3hj7KQwBVU5NTFmtYomSw ($43.70 in chips)
Seat 2: 0smcry9L0OOTCP+KzIS5SA ($99 in chips)
Seat 3: cWwhvq/+r/w8nkhwrJoekQ ($51.85 in chips)
Seat 4: O5ZesE/6mHyuWWbvkiH/Fg ($42.35 in chips)
Seat 5: j7NIOHLZk7V2o9fOioO5ug ($100 in chips)
Seat 6: u23r4AyKPgHioZ6t7z6qrA ($93.50 in chips)
0smcry9L0OOTCP+KzIS5SA: posts small blind $0.50
cWwhvq/+r/w8nkhwrJoekQ: posts big blind $1
*** HOLE CARDS ***
O5ZesE/6mHyuWWbvkiH/Fg: folds
j7NIOHLZk7V2o9fOioO5ug: folds
u23r4AyKPgHioZ6t7z6qrA: raises $3 to $4
j3hj7KQwBVU5NTFmtYomSw: calls $4
0smcry9L0OOTCP+KzIS5SA: folds
cWwhvq/+r/w8nkhwrJoekQ: calls $3
*** FLOP *** [5c 2d 8h]
cWwhvq/+r/w8nkhwrJoekQ: checks
u23r4AyKPgHioZ6t7z6qrA: bets $4
j3hj7KQwBVU5NTFmtYomSw: calls $4
cWwhvq/+r/w8nkhwrJoekQ: folds
*** TURN *** [5c 2d 8h] [8c]
u23r4AyKPgHioZ6t7z6qrA: bets $4
j3hj7KQwBVU5NTFmtYomSw: calls $4
*** RIVER *** [5c 2d 8h 8c] [Qd]
u23r4AyKPgHioZ6t7z6qrA: bets $5
j3hj7KQwBVU5NTFmtYomSw: raises $6.50 to $11.50
u23r4AyKPgHioZ6t7z6qrA: calls $6.50
*** SHOW DOWN ***
j3hj7KQwBVU5NTFmtYomSw: shows [5h 5d] (a full house, Fives full of Eights)
u23r4AyKPgHioZ6t7z6qrA: mucks hand
j3hj7KQwBVU5NTFmtYomSw collected $49 from pot
*** SUMMARY ***
Total pot $51.50 | Rake $2.50
Board [5c 2d 8h 8c Qd]
Seat 1: j3hj7KQwBVU5NTFmtYomSw (button) showed [5h 5d] and won ($49) with a full house, Fives full of Eights
Seat 2: 0smcry9L0OOTCP+KzIS5SA (small blind) folded before Flop
Seat 3: cWwhvq/+r/w8nkhwrJoekQ (big blind) folded on the Flop
Seat 4: O5ZesE/6mHyuWWbvkiH/Fg folded before Flop (didn't bet)
Seat 5: j7NIOHLZk7V2o9fOioO5ug folded before Flop (didn't bet)
Seat 6: u23r4AyKPgHioZ6t7z6qrA mucked



PokerStars Game #59941406024:  Hold'em No Limit ($0.50/$1.00) - 2009/07/01 1:34:33 ET
Table 'fZjVbKj9D8yOB+Rj7NaP/A' 9-max Seat #3 is the button
Seat 1: 9BZCcac3+McErkkSN2YScA ($103.15 in chips)
Seat 2: PTAFYDIUSsG+SArbxNl+Aw ($104 in chips)
Seat 3: yAbu2QsRPVcjPbqlf/jDxw ($100 in chips)
Seat 4: 997ViqAtWn1FPjJqcffwcA ($100 in chips)
Seat 5: PkGfq5xrSlNsujKaG/HF4Q ($100 in chips)
Seat 6: OvwYHV65yUbgdBjSmo1+5g ($130.40 in chips)
Seat 7: SyS20PAm3RpT6uLBsGkwOA ($77 in chips)
Seat 9: qheQay5YvP2DMAb3OUSxtw ($100.50 in chips)
997ViqAtWn1FPjJqcffwcA: posts small blind $0.50
PkGfq5xrSlNsujKaG/HF4Q: posts big blind $1
*** HOLE CARDS ***
OvwYHV65yUbgdBjSmo1+5g: folds
SyS20PAm3RpT6uLBsGkwOA: folds
qheQay5YvP2DMAb3OUSxtw: folds
9BZCcac3+McErkkSN2YScA: folds
PTAFYDIUSsG+SArbxNl+Aw: folds
yAbu2QsRPVcjPbqlf/jDxw: raises $2 to $3
997ViqAtWn1FPjJqcffwcA: calls $2.50
PkGfq5xrSlNsujKaG/HF4Q: folds
*** FLOP *** [6s 6d 7h]
997ViqAtWn1FPjJqcffwcA: checks
yAbu2QsRPVcjPbqlf/jDxw: bets $3
997ViqAtWn1FPjJqcffwcA: folds
yAbu2QsRPVcjPbqlf/jDxw collected $6.65 from pot
yAbu2QsRPVcjPbqlf/jDxw: doesn't show hand
*** SUMMARY ***
Total pot $7 | Rake $0.35
Board [6s 6d 7h]
Seat 1: 9BZCcac3+McErkkSN2YScA folded before Flop (didn't bet)
Seat 2: PTAFYDIUSsG+SArbxNl+Aw folded before Flop (didn't bet)
Seat 3: yAbu2QsRPVcjPbqlf/jDxw (button) collected ($6.65)
Seat 4: 997ViqAtWn1FPjJqcffwcA (small blind) folded on the Flop
Seat 5: PkGfq5xrSlNsujKaG/HF4Q (big blind) folded before Flop
Seat 6: OvwYHV65yUbgdBjSmo1+5g folded before Flop (didn't bet)
Seat 7: SyS20PAm3RpT6uLBsGkwOA folded before Flop (didn't bet)
Seat 9: qheQay5YvP2DMAb3OUSxtw folded before Flop (didn't bet)



PokerStars Game #59941407092:  Hold'em No Limit ($0.50/$1.00) - 2009/07/01 1:34:35 ET
Table 'gxFK0BVUD7cupu2uyRUZJg' 6-max Seat #4 is the button
Seat 1: M+X3uChmP6R63IwijVjgTg ($242.55 in chips)
Seat 2: hpxXcmRkXXI9HE5+5/j/0Q ($133.05 in chips)
Seat 3: Z2fXsGcjl+Eax+RzOgwOmg ($100 in chips)
Seat 4: Hcr4S4Nbkj5idKsvYK/eqQ ($100 in chips)
Seat 6: dYyb6/42PMC8aNFlm/eBeQ ($119.90 in chips)
0smcry9L0OOTCP+KzIS5SA will be allowed to play after the button
dYyb6/42PMC8aNFlm/eBeQ: posts small blind $0.50
M+X3uChmP6R63IwijVjgTg: posts big blind $1
*** HOLE CARDS ***
hpxXcmRkXXI9HE5+5/j/0Q: folds
Z2fXsGcjl+Eax+RzOgwOmg: folds
Hcr4S4Nbkj5idKsvYK/eqQ: raises $2 to $3
dYyb6/42PMC8aNFlm/eBeQ: calls $2.50
M+X3uChmP6R63IwijVjgTg: folds
*** FLOP *** [5h Qs 4s]
dYyb6/42PMC8aNFlm/eBeQ: bets $3
Hcr4S4Nbkj5idKsvYK/eqQ: calls $3
*** TURN *** [5h Qs 4s] [Td]
dYyb6/42PMC8aNFlm/eBeQ: bets $4
Hcr4S4Nbkj5idKsvYK/eqQ: calls $4
*** RIVER *** [5h Qs 4s Td] [5s]
dYyb6/42PMC8aNFlm/eBeQ: bets $10
Hcr4S4Nbkj5idKsvYK/eqQ: folds
dYyb6/42PMC8aNFlm/eBeQ collected $20 from pot
dYyb6/42PMC8aNFlm/eBeQ: doesn't show hand
*** SUMMARY ***
Total pot $21 | Rake $1
Board [5h Qs 4s Td 5s]
Seat 1: M+X3uChmP6R63IwijVjgTg (big blind) folded before Flop
Seat 2: hpxXcmRkXXI9HE5+5/j/0Q folded before Flop (didn't bet)
Seat 3: Z2fXsGcjl+Eax+RzOgwOmg folded before Flop (didn't bet)
Seat 4: Hcr4S4Nbkj5idKsvYK/eqQ (button) folded on the River
Seat 6: dYyb6/42PMC8aNFlm/eBeQ (small blind) collected ($20)



PokerStars Game #59941406978:  Hold'em No Limit ($0.50/$1.00) - 2009/07/01 1:34:35 ET
Table 'rmZfTK+oSebeUPJNbWhdAA' 6-max Seat #5 is the button
Seat 1: xAU6q2/cwmby2sxmA8VcmA ($133 in chips)
Seat 2: z7O9PO/WEcqRouIydFhS9Q ($189.50 in chips)
Seat 3: BCEV3COoKY607AzLWayfRA ($193.80 in chips)
Seat 4: 1/mIuXfgx1ZyVkodrmfQDw ($122.60 in chips)
Seat 5: 5lY8d6Cnm4HUkt/8FZSj4g ($51.05 in chips)
Seat 6: j7NIOHLZk7V2o9fOioO5ug ($100 in chips)
j7NIOHLZk7V2o9fOioO5ug: posts small blind $0.50
xAU6q2/cwmby2sxmA8VcmA: posts big blind $1
*** HOLE CARDS ***
z7O9PO/WEcqRouIydFhS9Q: folds
BCEV3COoKY607AzLWayfRA: folds
1/mIuXfgx1ZyVkodrmfQDw: raises $2 to $3
5lY8d6Cnm4HUkt/8FZSj4g: calls $3
j7NIOHLZk7V2o9fOioO5ug: folds
xAU6q2/cwmby2sxmA8VcmA: folds
*** FLOP *** [Qc 9s 6h]
1/mIuXfgx1ZyVkodrmfQDw: bets $5
5lY8d6Cnm4HUkt/8FZSj4g: calls $5
*** TURN *** [Qc 9s 6h] [3d]
1/mIuXfgx1ZyVkodrmfQDw: bets $13
5lY8d6Cnm4HUkt/8FZSj4g: calls $13
*** RIVER *** [Qc 9s 6h 3d] [Ts]
1/mIuXfgx1ZyVkodrmfQDw: bets $33
5lY8d6Cnm4HUkt/8FZSj4g: calls $30.05 and is all-in
*** SHOW DOWN ***
1/mIuXfgx1ZyVkodrmfQDw: shows [Kc Kd] (a pair of Kings)
5lY8d6Cnm4HUkt/8FZSj4g: mucks hand
1/mIuXfgx1ZyVkodrmfQDw collected $100.60 from pot
*** SUMMARY ***
Total pot $103.60 | Rake $3
Board [Qc 9s 6h 3d Ts]
Seat 1: xAU6q2/cwmby2sxmA8VcmA (big blind) folded before Flop
Seat 2: z7O9PO/WEcqRouIydFhS9Q folded before Flop (didn't bet)
Seat 3: BCEV3COoKY607AzLWayfRA folded before Flop (didn't bet)
Seat 4: 1/mIuXfgx1ZyVkodrmfQDw showed [Kc Kd] and won ($100.60) with a pair of Kings
Seat 5: 5lY8d6Cnm4HUkt/8FZSj4g (button) mucked
Seat 6: j7NIOHLZk7V2o9fOioO5ug (small blind) folded before Flop



PokerStars Game #59941407542:  Hold'em No Limit ($0.50/$1.00) - 2009/07/01 1:34:36 ET
Table 'N2bNCDHL96aCQDvZIh+yQQ' 6-max Seat #6 is the button
Seat 1: Jjgflx10PVjcLkziEmLhSA ($73.70 in chips)
Seat 2: y27w5IK2WXqmYzS8OU0wKA ($122.55 in chips)
Seat 3: UBZQqpnJZdTYYY1FTb0rLA ($120.55 in chips)
Seat 4: uCqEjnxh2/vFBjKYkfTOkw ($190.80 in chips)
Seat 5: frvgHLr3+LfZtjsBCBs3NA ($19.60 in chips)
Seat 6: idVgoPAdspFPCzee6aF9Pg ($100 in chips)
Jjgflx10PVjcLkziEmLhSA: posts small blind $0.50
y27w5IK2WXqmYzS8OU0wKA: posts big blind $1
*** HOLE CARDS ***
UBZQqpnJZdTYYY1FTb0rLA: raises $2 to $3
uCqEjnxh2/vFBjKYkfTOkw: folds
frvgHLr3+LfZtjsBCBs3NA: folds
idVgoPAdspFPCzee6aF9Pg: folds
Jjgflx10PVjcLkziEmLhSA: folds
y27w5IK2WXqmYzS8OU0wKA: folds
UBZQqpnJZdTYYY1FTb0rLA collected $2.50 from pot
UBZQqpnJZdTYYY1FTb0rLA: doesn't show hand
*** SUMMARY ***
Total pot $2.50 | Rake $0
Seat 1: Jjgflx10PVjcLkziEmLhSA (small blind) folded before Flop
Seat 2: y27w5IK2WXqmYzS8OU0wKA (big blind) folded before Flop
Seat 3: UBZQqpnJZdTYYY1FTb0rLA collected ($2.50)
Seat 4: uCqEjnxh2/vFBjKYkfTOkw folded before Flop (didn't bet)
Seat 5: frvgHLr3+LfZtjsBCBs3NA folded before Flop (didn't bet)
Seat 6: idVgoPAdspFPCzee6aF9Pg (button) folded before Flop (didn't bet)



PokerStars Game #59941407884:  Hold'em No Limit ($0.50/$1.00) - 2009/07/01 1:34:37 ET
Table 'N6LvHFrb+cdXY/COI6ByOw' 2-max Seat #1 is the button
Seat 1: lXX4W7m3u++JiSOZ46yVMQ ($100 in chips)
Seat 2: 9mAoSP3o/mikSZOW2LEEAw ($172.70 in chips)
lXX4W7m3u++JiSOZ46yVMQ: posts small blind $0.50
9mAoSP3o/mikSZOW2LEEAw: posts big blind $1
*** HOLE CARDS ***
lXX4W7m3u++JiSOZ46yVMQ: folds
9mAoSP3o/mikSZOW2LEEAw collected $1 from pot
*** SUMMARY ***
Total pot $1 | Rake $0
Seat 1: lXX4W7m3u++JiSOZ46yVMQ (button) (small blind) folded before Flop
Seat 2: 9mAoSP3o/mikSZOW2LEEAw (big blind) collected ($1)



PokerStars Game #59941408850:  Hold'em No Limit ($0.50/$1.00) - 2009/07/01 1:34:38 ET
Table 'pHrhryH8jPNdQfY62f8v+g' 6-max Seat #3 is the button
Seat 1: 4d1rWhpu8DzLmzMbR3QKyA ($147.45 in chips)
Seat 2: JwCcjZl0bjJzG7hmE0dnTA ($116.05 in chips)
Seat 3: 8oS5O7iD/qnFXFXJrGIgNQ ($110.80 in chips)
Seat 4: 1f3beyIML24UqEMTbWy93g ($59.20 in chips)
Seat 5: d8WX+9nUHoqlrAGagO0Wow ($18.50 in chips)
Seat 6: xAU6q2/cwmby2sxmA8VcmA ($176.75 in chips)
1f3beyIML24UqEMTbWy93g: posts small blind $0.50
d8WX+9nUHoqlrAGagO0Wow: posts big blind $1
*** HOLE CARDS ***
xAU6q2/cwmby2sxmA8VcmA: folds
4d1rWhpu8DzLmzMbR3QKyA: folds
JwCcjZl0bjJzG7hmE0dnTA: folds
8oS5O7iD/qnFXFXJrGIgNQ: folds
1f3beyIML24UqEMTbWy93g: folds
d8WX+9nUHoqlrAGagO0Wow collected $1 from pot
*** SUMMARY ***
Total pot $1 | Rake $0
Seat 1: 4d1rWhpu8DzLmzMbR3QKyA folded before Flop (didn't bet)
Seat 2: JwCcjZl0bjJzG7hmE0dnTA folded before Flop (didn't bet)
Seat 3: 8oS5O7iD/qnFXFXJrGIgNQ (button) folded before Flop (didn't bet)
Seat 4: 1f3beyIML24UqEMTbWy93g (small blind) folded before Flop
Seat 5: d8WX+9nUHoqlrAGagO0Wow (big blind) collected ($1)
Seat 6: xAU6q2/cwmby2sxmA8VcmA folded before Flop (didn't bet)



PokerStars Game #59941408986:  Hold'em No Limit ($0.50/$1.00) - 2009/07/01 1:34:39 ET
Table 'MUPc8FEpe/nR0BKSeReX6Q' 6-max Seat #1 is the button
Seat 1: qhkK6+yCciTRd+rCFEbnEQ ($59.70 in chips)
Seat 2: xAU6q2/cwmby2sxmA8VcmA ($104.20 in chips)
Seat 3: wx3sQGkVi2x9wJXuWNHPBw ($284 in chips)
Seat 4: r4lpoh2BJZ8S6zyQv1JeSw ($112 in chips)
Seat 5: y27w5IK2WXqmYzS8OU0wKA ($101.55 in chips)
Seat 6: cl/QpVR/PLO58lj+C5mGLw ($53.20 in chips)
xAU6q2/cwmby2sxmA8VcmA: posts small blind $0.50
wx3sQGkVi2x9wJXuWNHPBw: posts big blind $1
*** HOLE CARDS ***
r4lpoh2BJZ8S6zyQv1JeSw: folds
y27w5IK2WXqmYzS8OU0wKA: raises $2 to $3
cl/QpVR/PLO58lj+C5mGLw: folds
qhkK6+yCciTRd+rCFEbnEQ: folds
xAU6q2/cwmby2sxmA8VcmA: folds
wx3sQGkVi2x9wJXuWNHPBw: folds
y27w5IK2WXqmYzS8OU0wKA collected $2.50 from pot
y27w5IK2WXqmYzS8OU0wKA: doesn't show hand
*** SUMMARY ***
Total pot $2.50 | Rake $0
Seat 1: qhkK6+yCciTRd+rCFEbnEQ (button) folded before Flop (didn't bet)
Seat 2: xAU6q2/cwmby2sxmA8VcmA (small blind) folded before Flop
Seat 3: wx3sQGkVi2x9wJXuWNHPBw (big blind) folded before Flop
Seat 4: r4lpoh2BJZ8S6zyQv1JeSw folded before Flop (didn't bet)
Seat 5: y27w5IK2WXqmYzS8OU0wKA collected ($2.50)
Seat 6: cl/QpVR/PLO58lj+C5mGLw folded before Flop (didn't bet)



PokerStars Game #59941409288:  Hold'em No Limit ($0.50/$1.00) - 2009/07/01 1:34:39 ET
Table 'qj0HBN4HhQKogreu1bg7xg' 2-max Seat #2 is the button
Seat 1: NYi6JFscYNrofSXy4sM+Yw ($114.50 in chips)
Seat 2: qtyl8CSb0/4yWdbuEPJejA ($165.90 in chips)
qtyl8CSb0/4yWdbuEPJejA: posts small blind $0.50
NYi6JFscYNrofSXy4sM+Yw: posts big blind $1
*** HOLE CARDS ***
qtyl8CSb0/4yWdbuEPJejA: raises $2 to $3
NYi6JFscYNrofSXy4sM+Yw: calls $2
*** FLOP *** [5d 2h 3c]
NYi6JFscYNrofSXy4sM+Yw: checks
qtyl8CSb0/4yWdbuEPJejA: bets $4
NYi6JFscYNrofSXy4sM+Yw: folds
qtyl8CSb0/4yWdbuEPJejA collected $5.70 from pot
qtyl8CSb0/4yWdbuEPJejA: doesn't show hand
*** SUMMARY ***
Total pot $6 | Rake $0.30
Board [5d 2h 3c]
Seat 1: NYi6JFscYNrofSXy4sM+Yw (big blind) folded on the Flop
Seat 2: qtyl8CSb0/4yWdbuEPJejA (button) (small blind) collected ($5.70)



PokerStars Game #59941411106:  Hold'em No Limit ($0.50/$1.00) - 2009/07/01 1:34:42 ET
Table 'tHb+N6GaPEmmBAe36B2R9Q' 2-max Seat #2 is the button
Seat 1: rL+Zpv4/vX2BVHcyfh/NXA ($103.90 in chips)
Seat 2: Pm1sDZZi0zFtnFGXLznkug ($126.70 in chips)
Pm1sDZZi0zFtnFGXLznkug: posts small blind $0.50
rL+Zpv4/vX2BVHcyfh/NXA: posts big blind $1
*** HOLE CARDS ***
Pm1sDZZi0zFtnFGXLznkug: raises $2 to $3
rL+Zpv4/vX2BVHcyfh/NXA: calls $2
*** FLOP *** [Ks 5d 2c]
rL+Zpv4/vX2BVHcyfh/NXA: checks
Pm1sDZZi0zFtnFGXLznkug: checks
*** TURN *** [Ks 5d 2c] [2d]
rL+Zpv4/vX2BVHcyfh/NXA: checks
Pm1sDZZi0zFtnFGXLznkug: checks
*** RIVER *** [Ks 5d 2c 2d] [8c]
rL+Zpv4/vX2BVHcyfh/NXA: checks
Pm1sDZZi0zFtnFGXLznkug: checks
*** SHOW DOWN ***
rL+Zpv4/vX2BVHcyfh/NXA: shows [9d Th] (a pair of Deuces)
Pm1sDZZi0zFtnFGXLznkug: shows [8d 6s] (two pair, Eights and Deuces)
Pm1sDZZi0zFtnFGXLznkug collected $5.70 from pot
*** SUMMARY ***
Total pot $6 | Rake $0.30
Board [Ks 5d 2c 2d 8c]
Seat 1: rL+Zpv4/vX2BVHcyfh/NXA (big blind) showed [9d Th] and lost with a pair of Deuces
Seat 2: Pm1sDZZi0zFtnFGXLznkug (button) (small blind) showed [8d 6s] and won ($5.70) with two pair, Eights and Deuces



PokerStars Game #59941411702:  Hold'em No Limit ($0.50/$1.00) - 2009/07/01 1:34:43 ET
Table 'N6LvHFrb+cdXY/COI6ByOw' 2-max Seat #2 is the button
Seat 1: lXX4W7m3u++JiSOZ46yVMQ ($99.50 in chips)
Seat 2: 9mAoSP3o/mikSZOW2LEEAw ($173.20 in chips)
9mAoSP3o/mikSZOW2LEEAw: posts small blind $0.50
lXX4W7m3u++JiSOZ46yVMQ: posts big blind $1
*** HOLE CARDS ***
9mAoSP3o/mikSZOW2LEEAw: raises $1 to $2
lXX4W7m3u++JiSOZ46yVMQ: calls $1
*** FLOP *** [Kd Qc 9h]
lXX4W7m3u++JiSOZ46yVMQ: checks
9mAoSP3o/mikSZOW2LEEAw: checks
*** TURN *** [Kd Qc 9h] [4s]
lXX4W7m3u++JiSOZ46yVMQ: checks
9mAoSP3o/mikSZOW2LEEAw: checks
*** RIVER *** [Kd Qc 9h 4s] [8d]
lXX4W7m3u++JiSOZ46yVMQ: checks
9mAoSP3o/mikSZOW2LEEAw: checks
*** SHOW DOWN ***
lXX4W7m3u++JiSOZ46yVMQ: shows [As 4c] (a pair of Fours)
9mAoSP3o/mikSZOW2LEEAw: shows [Ts 3s] (high card King)
lXX4W7m3u++JiSOZ46yVMQ collected $3.80 from pot
*** SUMMARY ***
Total pot $4 | Rake $0.20
Board [Kd Qc 9h 4s 8d]
Seat 1: lXX4W7m3u++JiSOZ46yVMQ (big blind) showed [As 4c] and won ($3.80) with a pair of Fours
Seat 2: 9mAoSP3o/mikSZOW2LEEAw (button) (small blind) showed [Ts 3s] and lost with high card King



PokerStars Game #59941411382:  Hold'em No Limit ($0.50/$1.00) - 2009/07/01 1:34:43 ET
Table 'O96CPOtvMBWP6kzuYDfdFA' 6-max Seat #1 is the button
Seat 1: 6alLXQIITA2EZ/lBeym8Dw ($128.25 in chips)
Seat 2: 4d1rWhpu8DzLmzMbR3QKyA ($100 in chips)
Seat 4: /P4w1pHg2zHYg/4ubJ0dPw ($65.15 in chips)
Seat 6: 3syOXva630dm1FTdwnuLpw ($79.65 in chips)
4d1rWhpu8DzLmzMbR3QKyA: posts small blind $0.50
/P4w1pHg2zHYg/4ubJ0dPw: posts big blind $1
vX+iYAEINFeLxwMla7DY1Q: sits out
*** HOLE CARDS ***
3syOXva630dm1FTdwnuLpw: folds
6alLXQIITA2EZ/lBeym8Dw: folds
4d1rWhpu8DzLmzMbR3QKyA: folds
/P4w1pHg2zHYg/4ubJ0dPw collected $1 from pot
*** SUMMARY ***
Total pot $1 | Rake $0
Seat 1: 6alLXQIITA2EZ/lBeym8Dw (button) folded before Flop (didn't bet)
Seat 2: 4d1rWhpu8DzLmzMbR3QKyA (small blind) folded before Flop
Seat 4: /P4w1pHg2zHYg/4ubJ0dPw (big blind) collected ($1)
Seat 6: 3syOXva630dm1FTdwnuLpw folded before Flop (didn't bet)



PokerStars Game #59941411838:  Hold'em No Limit ($0.50/$1.00) - 2009/07/01 1:34:44 ET
Table 'GxCPo/gd3OSthkYrAxJngg' 6-max Seat #2 is the button
Seat 1: sH8BpAFP+jGFxCgVpD1Lew ($231.75 in chips)
Seat 2: YExX2paeIHrmfIwV1ivM/w ($66.10 in chips)
Seat 3: idVgoPAdspFPCzee6aF9Pg ($130.50 in chips)
Seat 4: YMJG+F++3Aj6P8dAWda5fw ($208.35 in chips)
Seat 6: 4d1rWhpu8DzLmzMbR3QKyA ($101.50 in chips)
idVgoPAdspFPCzee6aF9Pg: posts small blind $0.50
YMJG+F++3Aj6P8dAWda5fw: posts big blind $1
vX+iYAEINFeLxwMla7DY1Q: sits out
*** HOLE CARDS ***
4d1rWhpu8DzLmzMbR3QKyA: folds
sH8BpAFP+jGFxCgVpD1Lew: folds
YExX2paeIHrmfIwV1ivM/w: raises $2 to $3
idVgoPAdspFPCzee6aF9Pg: raises $8 to $11
YMJG+F++3Aj6P8dAWda5fw: folds
YExX2paeIHrmfIwV1ivM/w: folds
idVgoPAdspFPCzee6aF9Pg collected $7 from pot
idVgoPAdspFPCzee6aF9Pg: doesn't show hand
*** SUMMARY ***
Total pot $7 | Rake $0
Seat 1: sH8BpAFP+jGFxCgVpD1Lew folded before Flop (didn't bet)
Seat 2: YExX2paeIHrmfIwV1ivM/w (button) folded before Flop
Seat 3: idVgoPAdspFPCzee6aF9Pg (small blind) collected ($7)
Seat 4: YMJG+F++3Aj6P8dAWda5fw (big blind) folded before Flop
Seat 6: 4d1rWhpu8DzLmzMbR3QKyA folded before Flop (didn't bet)



PokerStars Game #59941413956:  Hold'em No Limit ($0.50/$1.00) - 2009/07/01 1:34:48 ET
Table 'QSIig7BLMc9wY/rgBechzw' 6-max Seat #4 is the button
Seat 1: Z2fXsGcjl+Eax+RzOgwOmg ($132.55 in chips)
Seat 2: mLOIkH/qmRa+mVujQIhBRg ($20.40 in chips)
Seat 4: +uSzP8Jwnw7sKfQ4s66b7w ($62.30 in chips)
Seat 5: lsLuWlcPA3Rh7kJVLzMh0Q ($100.70 in chips)
Seat 6: PxqfkAMdAWtkgbT+q2gciA ($53.60 in chips)
lsLuWlcPA3Rh7kJVLzMh0Q: posts small blind $0.50
PxqfkAMdAWtkgbT+q2gciA: posts big blind $1
4OO5v3AVduL0tePNx8wk5A: sits out
*** HOLE CARDS ***
Z2fXsGcjl+Eax+RzOgwOmg: folds
mLOIkH/qmRa+mVujQIhBRg is disconnected
mLOIkH/qmRa+mVujQIhBRg has timed out while disconnected
mLOIkH/qmRa+mVujQIhBRg: folds
mLOIkH/qmRa+mVujQIhBRg is sitting out
+uSzP8Jwnw7sKfQ4s66b7w: folds
lsLuWlcPA3Rh7kJVLzMh0Q: folds
PxqfkAMdAWtkgbT+q2gciA collected $1 from pot
*** SUMMARY ***
Total pot $1 | Rake $0
Seat 1: Z2fXsGcjl+Eax+RzOgwOmg folded before Flop (didn't bet)
Seat 2: mLOIkH/qmRa+mVujQIhBRg folded before Flop (didn't bet)
Seat 4: +uSzP8Jwnw7sKfQ4s66b7w (button) folded before Flop (didn't bet)
Seat 5: lsLuWlcPA3Rh7kJVLzMh0Q (small blind) folded before Flop
Seat 6: PxqfkAMdAWtkgbT+q2gciA (big blind) collected ($1)



PokerStars Game #59941416618:  Hold'em No Limit ($0.50/$1.00) - 2009/07/01 1:34:52 ET
Table 'qj0HBN4HhQKogreu1bg7xg' 2-max Seat #1 is the button
Seat 1: NYi6JFscYNrofSXy4sM+Yw ($111.50 in chips)
Seat 2: qtyl8CSb0/4yWdbuEPJejA ($168.60 in chips)
NYi6JFscYNrofSXy4sM+Yw: posts small blind $0.50
qtyl8CSb0/4yWdbuEPJejA: posts big blind $1
*** HOLE CARDS ***
NYi6JFscYNrofSXy4sM+Yw: raises $2 to $3
qtyl8CSb0/4yWdbuEPJejA: folds
NYi6JFscYNrofSXy4sM+Yw collected $2 from pot
*** SUMMARY ***
Total pot $2 | Rake $0
Seat 1: NYi6JFscYNrofSXy4sM+Yw (button) (small blind) collected ($2)
Seat 2: qtyl8CSb0/4yWdbuEPJejA (big blind) folded before Flop



PokerStars Game #59941416998:  Hold'em No Limit ($0.50/$1.00) - 2009/07/01 1:34:53 ET
Table 'b8oW/dOL7fDza5DfZ/dOJQ' 6-max Seat #4 is the button
Seat 1: NakujTNjHFgzceydFf+E2Q ($99.50 in chips)
Seat 2: TSuRyAHnUPCFjP7Z0rEE0w ($120.50 in chips)
Seat 3: d8WX+9nUHoqlrAGagO0Wow ($31.40 in chips)
Seat 4: X87W8qaGsudJTSkClK2Cig ($7.25 in chips)
Seat 5: r4lpoh2BJZ8S6zyQv1JeSw ($101.50 in chips)
Seat 6: PvfYaKbzMpsmUcbOExckbQ ($102.60 in chips)
r4lpoh2BJZ8S6zyQv1JeSw: posts small blind $0.50
PvfYaKbzMpsmUcbOExckbQ: posts big blind $1
*** HOLE CARDS ***
NakujTNjHFgzceydFf+E2Q: folds
TSuRyAHnUPCFjP7Z0rEE0w: folds
d8WX+9nUHoqlrAGagO0Wow: folds
X87W8qaGsudJTSkClK2Cig: raises $2 to $3
r4lpoh2BJZ8S6zyQv1JeSw: folds
PvfYaKbzMpsmUcbOExckbQ: raises $6 to $9
X87W8qaGsudJTSkClK2Cig: calls $4.25 and is all-in
*** FLOP *** [2s 9d Th]
*** TURN *** [2s 9d Th] [7c]
*** RIVER *** [2s 9d Th 7c] [Ah]
*** SHOW DOWN ***
PvfYaKbzMpsmUcbOExckbQ: shows [9c Jc] (a pair of Nines)
X87W8qaGsudJTSkClK2Cig: mucks hand
PvfYaKbzMpsmUcbOExckbQ collected $14.25 from pot
*** SUMMARY ***
Total pot $15 | Rake $0.75
Board [2s 9d Th 7c Ah]
Seat 1: NakujTNjHFgzceydFf+E2Q folded before Flop (didn't bet)
Seat 2: TSuRyAHnUPCFjP7Z0rEE0w folded before Flop (didn't bet)
Seat 3: d8WX+9nUHoqlrAGagO0Wow folded before Flop (didn't bet)
Seat 4: X87W8qaGsudJTSkClK2Cig (button) mucked
Seat 5: r4lpoh2BJZ8S6zyQv1JeSw (small blind) folded before Flop
Seat 6: PvfYaKbzMpsmUcbOExckbQ (big blind) showed [9c Jc] and won ($14.25) with a pair of Nines



PokerStars Game #59941419998:  Hold'em No Limit ($0.50/$1.00) - 2009/07/01 1:34:58 ET
Table 'cBDNutyLBKEk9+ptwsKmTw' 6-max Seat #1 is the button
Seat 1: xAU6q2/cwmby2sxmA8VcmA ($272.05 in chips)
Seat 2: 4OO5v3AVduL0tePNx8wk5A ($134.10 in chips)
Seat 4: OMkHNxIUZxh1pHqcCjbjgw ($101.50 in chips)
Seat 6: QHvTZcrKe6+maWUfVjP29Q ($147 in chips)
4OO5v3AVduL0tePNx8wk5A: posts small blind $0.50
OMkHNxIUZxh1pHqcCjbjgw: posts big blind $1
*** HOLE CARDS ***
QHvTZcrKe6+maWUfVjP29Q: folds
xAU6q2/cwmby2sxmA8VcmA: folds
4OO5v3AVduL0tePNx8wk5A: folds
OMkHNxIUZxh1pHqcCjbjgw collected $1 from pot
OMkHNxIUZxh1pHqcCjbjgw: doesn't show hand
*** SUMMARY ***
Total pot $1 | Rake $0
Seat 1: xAU6q2/cwmby2sxmA8VcmA (button) folded before Flop (didn't bet)
Seat 2: 4OO5v3AVduL0tePNx8wk5A (small blind) folded before Flop
Seat 4: OMkHNxIUZxh1pHqcCjbjgw (big blind) collected ($1)
Seat 6: QHvTZcrKe6+maWUfVjP29Q folded before Flop (didn't bet)



PokerStars Game #59941419878:  Hold'em No Limit ($0.50/$1.00) - 2009/07/01 1:34:58 ET
Table '/FUb199IViHMJHi5YWmeuQ' 9-max Seat #6 is the button
Seat 1: 3obndzTJ6fECz8+wWhMd1w ($32.30 in chips)
Seat 2: FL3MrLspcF23LYvC4ipBOA ($184.05 in chips)
Seat 3: V138SURkdX8LdVBPKdJJag ($100.75 in chips)
Seat 4: pbAfmxe4uSZPxJQX7gOzZA ($45.65 in chips)
Seat 6: VPF+HjszMvUIpy0CHIwH3A ($41.30 in chips)
Seat 8: 997ViqAtWn1FPjJqcffwcA ($100 in chips)
Seat 9: RfLbneGRY8yQUpMgDnJCxA ($75.60 in chips)
aM6BB+PnB/rDUr2dbRda+A will be allowed to play after the button
997ViqAtWn1FPjJqcffwcA: posts small blind $0.50
RfLbneGRY8yQUpMgDnJCxA: posts big blind $1
1862487932: sits out
*** HOLE CARDS ***
3obndzTJ6fECz8+wWhMd1w: folds
FL3MrLspcF23LYvC4ipBOA: folds
V138SURkdX8LdVBPKdJJag: folds
pbAfmxe4uSZPxJQX7gOzZA: raises $1 to $2
VPF+HjszMvUIpy0CHIwH3A: folds
997ViqAtWn1FPjJqcffwcA: folds
RfLbneGRY8yQUpMgDnJCxA: folds
pbAfmxe4uSZPxJQX7gOzZA collected $2.50 from pot
pbAfmxe4uSZPxJQX7gOzZA: doesn't show hand
*** SUMMARY ***
Total pot $2.50 | Rake $0
Seat 1: 3obndzTJ6fECz8+wWhMd1w folded before Flop (didn't bet)
Seat 2: FL3MrLspcF23LYvC4ipBOA folded before Flop (didn't bet)
Seat 3: V138SURkdX8LdVBPKdJJag folded before Flop (didn't bet)
Seat 4: pbAfmxe4uSZPxJQX7gOzZA collected ($2.50)
Seat 6: VPF+HjszMvUIpy0CHIwH3A (button) folded before Flop (didn't bet)
Seat 8: 997ViqAtWn1FPjJqcffwcA (small blind) folded before Flop
Seat 9: RfLbneGRY8yQUpMgDnJCxA (big blind) folded before Flop



PokerStars Game #59941421504:  Hold'em No Limit ($0.50/$1.00) - 2009/07/01 1:35:00 ET
Table 'N2bNCDHL96aCQDvZIh+yQQ' 6-max Seat #1 is the button
Seat 1: Jjgflx10PVjcLkziEmLhSA ($73.20 in chips)
Seat 2: y27w5IK2WXqmYzS8OU0wKA ($121.55 in chips)
Seat 3: UBZQqpnJZdTYYY1FTb0rLA ($122.05 in chips)
Seat 4: uCqEjnxh2/vFBjKYkfTOkw ($190.80 in chips)
Seat 5: frvgHLr3+LfZtjsBCBs3NA ($19.60 in chips)
Seat 6: idVgoPAdspFPCzee6aF9Pg ($100 in chips)
y27w5IK2WXqmYzS8OU0wKA: posts small blind $0.50
UBZQqpnJZdTYYY1FTb0rLA: posts big blind $1
*** HOLE CARDS ***
uCqEjnxh2/vFBjKYkfTOkw: folds
frvgHLr3+LfZtjsBCBs3NA: calls $1
idVgoPAdspFPCzee6aF9Pg: folds
Jjgflx10PVjcLkziEmLhSA: calls $1
y27w5IK2WXqmYzS8OU0wKA: folds
UBZQqpnJZdTYYY1FTb0rLA: checks
*** FLOP *** [4c Qh 2d]
UBZQqpnJZdTYYY1FTb0rLA: checks
frvgHLr3+LfZtjsBCBs3NA: bets $2
Jjgflx10PVjcLkziEmLhSA: calls $2
UBZQqpnJZdTYYY1FTb0rLA: folds
*** TURN *** [4c Qh 2d] [5d]
frvgHLr3+LfZtjsBCBs3NA: checks
Jjgflx10PVjcLkziEmLhSA: bets $5
frvgHLr3+LfZtjsBCBs3NA: folds
Jjgflx10PVjcLkziEmLhSA collected $7.15 from pot
Jjgflx10PVjcLkziEmLhSA: doesn't show hand
*** SUMMARY ***
Total pot $7.50 | Rake $0.35
Board [4c Qh 2d 5d]
Seat 1: Jjgflx10PVjcLkziEmLhSA (button) collected ($7.15)
Seat 2: y27w5IK2WXqmYzS8OU0wKA (small blind) folded before Flop
Seat 3: UBZQqpnJZdTYYY1FTb0rLA (big blind) folded on the Flop
Seat 4: uCqEjnxh2/vFBjKYkfTOkw folded before Flop (didn't bet)
Seat 5: frvgHLr3+LfZtjsBCBs3NA folded on the Turn
Seat 6: idVgoPAdspFPCzee6aF9Pg folded before Flop (didn't bet)



PokerStars Game #59941421454:  Hold'em No Limit ($0.50/$1.00) - 2009/07/01 1:35:00 ET
Table '305hiksPPCCdC6V2LNsO5w' 6-max Seat #3 is the button
Seat 1: RTuDLJHh/9zPfBftoc9vsw ($6.50 in chips)
Seat 2: j7NIOHLZk7V2o9fOioO5ug ($130.50 in chips)
Seat 3: +zIVjZKLpcidfRHgVZW8lA ($27.20 in chips)
Seat 4: uJVSceLggtsrJya+WtmUEA ($219.30 in chips)
Seat 5: +Nt3OPk3XR9SKjZgm2CexQ ($110.65 in chips)
Seat 6: 9/Tq8dw7kWW68uN8bFupXg ($22.45 in chips)
uJVSceLggtsrJya+WtmUEA: posts small blind $0.50
+Nt3OPk3XR9SKjZgm2CexQ: posts big blind $1
*** HOLE CARDS ***
9/Tq8dw7kWW68uN8bFupXg: folds
RTuDLJHh/9zPfBftoc9vsw: folds
j7NIOHLZk7V2o9fOioO5ug: folds
+zIVjZKLpcidfRHgVZW8lA: folds
uJVSceLggtsrJya+WtmUEA: folds
+Nt3OPk3XR9SKjZgm2CexQ collected $1 from pot
*** SUMMARY ***
Total pot $1 | Rake $0
Seat 1: RTuDLJHh/9zPfBftoc9vsw folded before Flop (didn't bet)
Seat 2: j7NIOHLZk7V2o9fOioO5ug folded before Flop (didn't bet)
Seat 3: +zIVjZKLpcidfRHgVZW8lA (button) folded before Flop (didn't bet)
Seat 4: uJVSceLggtsrJya+WtmUEA (small blind) folded before Flop
Seat 5: +Nt3OPk3XR9SKjZgm2CexQ (big blind) collected ($1)
Seat 6: 9/Tq8dw7kWW68uN8bFupXg folded before Flop (didn't bet)



PokerStars Game #59941420886:  Hold'em No Limit ($0.50/$1.00) - 2009/07/01 1:35:00 ET
Table 'O96CPOtvMBWP6kzuYDfdFA' 6-max Seat #2 is the button
Seat 1: 6alLXQIITA2EZ/lBeym8Dw ($128.25 in chips)
Seat 2: 4d1rWhpu8DzLmzMbR3QKyA ($100 in chips)
Seat 4: /P4w1pHg2zHYg/4ubJ0dPw ($65.65 in chips)
Seat 5: vX+iYAEINFeLxwMla7DY1Q ($100 in chips)
Seat 6: 3syOXva630dm1FTdwnuLpw ($79.65 in chips)
/P4w1pHg2zHYg/4ubJ0dPw: posts small blind $0.50
vX+iYAEINFeLxwMla7DY1Q: posts big blind $1
*** HOLE CARDS ***
3syOXva630dm1FTdwnuLpw: folds
6alLXQIITA2EZ/lBeym8Dw: folds
4d1rWhpu8DzLmzMbR3QKyA: raises $2 to $3
/P4w1pHg2zHYg/4ubJ0dPw: folds
vX+iYAEINFeLxwMla7DY1Q: folds
4d1rWhpu8DzLmzMbR3QKyA collected $2.50 from pot
*** SUMMARY ***
Total pot $2.50 | Rake $0
Seat 1: 6alLXQIITA2EZ/lBeym8Dw folded before Flop (didn't bet)
Seat 2: 4d1rWhpu8DzLmzMbR3QKyA (button) collected ($2.50)
Seat 4: /P4w1pHg2zHYg/4ubJ0dPw (small blind) folded before Flop
Seat 5: vX+iYAEINFeLxwMla7DY1Q (big blind) folded before Flop
Seat 6: 3syOXva630dm1FTdwnuLpw folded before Flop (didn't bet)



PokerStars Game #59941421690:  Hold'em No Limit ($0.50/$1.00) - 2009/07/01 1:35:01 ET
Table 'vs/5jr6ciwjVQ5+Soc+u2A' 6-max Seat #6 is the button
Seat 1: J798qwLuvXyq0BbzsIjOrA ($175 in chips)
Seat 2: lXX4W7m3u++JiSOZ46yVMQ ($97 in chips)
Seat 5: +Nt3OPk3XR9SKjZgm2CexQ ($169.85 in chips)
Seat 6: Z2fXsGcjl+Eax+RzOgwOmg ($103 in chips)
J798qwLuvXyq0BbzsIjOrA: posts small blind $0.50
lXX4W7m3u++JiSOZ46yVMQ: posts big blind $1
0smcry9L0OOTCP+KzIS5SA: sits out
*** HOLE CARDS ***
+Nt3OPk3XR9SKjZgm2CexQ has timed out
+Nt3OPk3XR9SKjZgm2CexQ: folds
+Nt3OPk3XR9SKjZgm2CexQ is sitting out
Z2fXsGcjl+Eax+RzOgwOmg: folds
+Nt3OPk3XR9SKjZgm2CexQ has returned
J798qwLuvXyq0BbzsIjOrA: raises $3 to $4
lXX4W7m3u++JiSOZ46yVMQ: folds
J798qwLuvXyq0BbzsIjOrA collected $2 from pot
J798qwLuvXyq0BbzsIjOrA: doesn't show hand
*** SUMMARY ***
Total pot $2 | Rake $0
Seat 1: J798qwLuvXyq0BbzsIjOrA (small blind) collected ($2)
Seat 2: lXX4W7m3u++JiSOZ46yVMQ (big blind) folded before Flop
Seat 5: +Nt3OPk3XR9SKjZgm2CexQ folded before Flop (didn't bet)
Seat 6: Z2fXsGcjl+Eax+RzOgwOmg (button) folded before Flop (didn't bet)



PokerStars Game #59941422086:  Hold'em No Limit ($0.50/$1.00) - 2009/07/01 1:35:02 ET
Table 'qj0HBN4HhQKogreu1bg7xg' 2-max Seat #2 is the button
Seat 1: NYi6JFscYNrofSXy4sM+Yw ($112.50 in chips)
Seat 2: qtyl8CSb0/4yWdbuEPJejA ($167.60 in chips)
qtyl8CSb0/4yWdbuEPJejA: posts small blind $0.50
NYi6JFscYNrofSXy4sM+Yw: posts big blind $1
*** HOLE CARDS ***
qtyl8CSb0/4yWdbuEPJejA: raises $2 to $3
NYi6JFscYNrofSXy4sM+Yw: folds
qtyl8CSb0/4yWdbuEPJejA collected $2 from pot
qtyl8CSb0/4yWdbuEPJejA: doesn't show hand
*** SUMMARY ***
Total pot $2 | Rake $0
Seat 1: NYi6JFscYNrofSXy4sM+Yw (big blind) folded before Flop
Seat 2: qtyl8CSb0/4yWdbuEPJejA (button) (small blind) collected ($2)



PokerStars Game #59941423224:  Hold'em No Limit ($0.50/$1.00) - 2009/07/01 1:35:03 ET
Table '7Nl0ffnjeK44/vmeexh3MQ' 9-max Seat #5 is the button
Seat 1: V138SURkdX8LdVBPKdJJag ($101.50 in chips)
Seat 2: OGgaARGdJQT4awWVNQ957w ($100 in chips)
Seat 3: JMmUYT5pIKCKh2pGjCB/4w ($58.40 in chips)
Seat 4: bLbSOSmSOnqE0iTcH/5dxA ($106.80 in chips)
Seat 5: 61sfw5QTu62YYIt68OsdrA ($83.55 in chips)
Seat 6: FVs16t7GgfWgQWt4JxsObQ ($22.10 in chips)
Seat 7: 997ViqAtWn1FPjJqcffwcA ($100 in chips)
Seat 9: /JHoNdt0fK6X+isrqRfV3w ($20 in chips)
FVs16t7GgfWgQWt4JxsObQ: posts small blind $0.50
997ViqAtWn1FPjJqcffwcA: posts big blind $1
*** HOLE CARDS ***
/JHoNdt0fK6X+isrqRfV3w: folds
V138SURkdX8LdVBPKdJJag: folds
OGgaARGdJQT4awWVNQ957w: folds
JMmUYT5pIKCKh2pGjCB/4w: folds
bLbSOSmSOnqE0iTcH/5dxA: folds
HRJJZiSxFAehJGaET63dlA joins the table at seat #8
61sfw5QTu62YYIt68OsdrA: raises $2 to $3
FVs16t7GgfWgQWt4JxsObQ: raises $3 to $6
997ViqAtWn1FPjJqcffwcA: folds
61sfw5QTu62YYIt68OsdrA: calls $3
*** FLOP *** [5d 2c Ts]
FVs16t7GgfWgQWt4JxsObQ: bets $5
61sfw5QTu62YYIt68OsdrA: folds
FVs16t7GgfWgQWt4JxsObQ collected $12.35 from pot
*** SUMMARY ***
Total pot $13 | Rake $0.65
Board [5d 2c Ts]
Seat 1: V138SURkdX8LdVBPKdJJag folded before Flop (didn't bet)
Seat 2: OGgaARGdJQT4awWVNQ957w folded before Flop (didn't bet)
Seat 3: JMmUYT5pIKCKh2pGjCB/4w folded before Flop (didn't bet)
Seat 4: bLbSOSmSOnqE0iTcH/5dxA folded before Flop (didn't bet)
Seat 5: 61sfw5QTu62YYIt68OsdrA (button) folded on the Flop
Seat 6: FVs16t7GgfWgQWt4JxsObQ (small blind) collected ($12.35)
Seat 7: 997ViqAtWn1FPjJqcffwcA (big blind) folded before Flop
Seat 9: /JHoNdt0fK6X+isrqRfV3w folded before Flop (didn't bet)



PokerStars Game #59941423686:  Hold'em No Limit ($0.50/$1.00) - 2009/07/01 1:35:04 ET
Table '7O9fB8yx1u7sJveJn8w6jA' 6-max Seat #1 is the button
Seat 1: 841740 ($47.35 in chips)
Seat 2: wx3sQGkVi2x9wJXuWNHPBw ($202.30 in chips)
Seat 3: hpxXcmRkXXI9HE5+5/j/0Q ($142.90 in chips)
Seat 4: b2a+5TkFf4xJN/Ihhma58Q ($33.85 in chips)
Seat 5: BCEV3COoKY607AzLWayfRA ($100 in chips)
Seat 6: r4lpoh2BJZ8S6zyQv1JeSw ($100 in chips)
wx3sQGkVi2x9wJXuWNHPBw: posts small blind $0.50
hpxXcmRkXXI9HE5+5/j/0Q: posts big blind $1
*** HOLE CARDS ***
b2a+5TkFf4xJN/Ihhma58Q: folds
BCEV3COoKY607AzLWayfRA: folds
r4lpoh2BJZ8S6zyQv1JeSw: folds
841740: raises $1 to $2
wx3sQGkVi2x9wJXuWNHPBw: folds
hpxXcmRkXXI9HE5+5/j/0Q: folds
841740 collected $2.50 from pot
*** SUMMARY ***
Total pot $2.50 | Rake $0
Seat 1: 841740 (button) collected ($2.50)
Seat 2: wx3sQGkVi2x9wJXuWNHPBw (small blind) folded before Flop
Seat 3: hpxXcmRkXXI9HE5+5/j/0Q (big blind) folded before Flop
Seat 4: b2a+5TkFf4xJN/Ihhma58Q folded before Flop (didn't bet)
Seat 5: BCEV3COoKY607AzLWayfRA folded before Flop (didn't bet)
Seat 6: r4lpoh2BJZ8S6zyQv1JeSw folded before Flop (didn't bet)



PokerStars Game #59941423792:  Hold'em No Limit ($0.50/$1.00) - 2009/07/01 1:35:05 ET
Table '/RZcOwpZpHQ+OwPwjsbnRw' 6-max Seat #5 is the button
Seat 1: +uSzP8Jwnw7sKfQ4s66b7w ($40.75 in chips)
Seat 2: Z2fXsGcjl+Eax+RzOgwOmg ($100 in chips)
Seat 3: LJMw/I77xpnw0R5T4HnMUg ($107.15 in chips)
Seat 4: j7NIOHLZk7V2o9fOioO5ug ($100 in chips)
Seat 5: wx3sQGkVi2x9wJXuWNHPBw ($165.75 in chips)
Seat 6: o3YLm/rSY916m/on1VjXPA ($213 in chips)
o3YLm/rSY916m/on1VjXPA: posts small blind $0.50
+uSzP8Jwnw7sKfQ4s66b7w: posts big blind $1
*** HOLE CARDS ***
Z2fXsGcjl+Eax+RzOgwOmg: folds
LJMw/I77xpnw0R5T4HnMUg: folds
j7NIOHLZk7V2o9fOioO5ug: folds
wx3sQGkVi2x9wJXuWNHPBw: folds
o3YLm/rSY916m/on1VjXPA: raises $2 to $3
+uSzP8Jwnw7sKfQ4s66b7w: calls $2
*** FLOP *** [6c 9s Qc]
o3YLm/rSY916m/on1VjXPA: bets $3
+uSzP8Jwnw7sKfQ4s66b7w: raises $8 to $11
o3YLm/rSY916m/on1VjXPA: folds
+uSzP8Jwnw7sKfQ4s66b7w collected $11.45 from pot
*** SUMMARY ***
Total pot $12 | Rake $0.55
Board [6c 9s Qc]
Seat 1: +uSzP8Jwnw7sKfQ4s66b7w (big blind) collected ($11.45)
Seat 2: Z2fXsGcjl+Eax+RzOgwOmg folded before Flop (didn't bet)
Seat 3: LJMw/I77xpnw0R5T4HnMUg folded before Flop (didn't bet)
Seat 4: j7NIOHLZk7V2o9fOioO5ug folded before Flop (didn't bet)
Seat 5: wx3sQGkVi2x9wJXuWNHPBw (button) folded before Flop (didn't bet)
Seat 6: o3YLm/rSY916m/on1VjXPA (small blind) folded on the Flop



PokerStars Game #59941424600:  Hold'em No Limit ($0.50/$1.00) - 2009/07/01 1:35:06 ET
Table 'N6LvHFrb+cdXY/COI6ByOw' 2-max Seat #1 is the button
Seat 1: lXX4W7m3u++JiSOZ46yVMQ ($101.30 in chips)
Seat 2: 9mAoSP3o/mikSZOW2LEEAw ($171.20 in chips)
lXX4W7m3u++JiSOZ46yVMQ: posts small blind $0.50
9mAoSP3o/mikSZOW2LEEAw: posts big blind $1
*** HOLE CARDS ***
lXX4W7m3u++JiSOZ46yVMQ: raises $2 to $3
9mAoSP3o/mikSZOW2LEEAw: calls $2
*** FLOP *** [Jc 5h Ah]
9mAoSP3o/mikSZOW2LEEAw: checks
lXX4W7m3u++JiSOZ46yVMQ: bets $3
9mAoSP3o/mikSZOW2LEEAw: folds
lXX4W7m3u++JiSOZ46yVMQ collected $5.70 from pot
*** SUMMARY ***
Total pot $6 | Rake $0.30
Board [Jc 5h Ah]
Seat 1: lXX4W7m3u++JiSOZ46yVMQ (button) (small blind) collected ($5.70)
Seat 2: 9mAoSP3o/mikSZOW2LEEAw (big blind) folded on the Flop



PokerStars Game #59941425518:  Hold'em No Limit ($0.50/$1.00) - 2009/07/01 1:35:07 ET
Table '+cA8mcmhaedZ7YcrDdhmeQ' 6-max Seat #1 is the button
Seat 1: 9XrTM0DuVxx1pjFAdSbD8A ($52.70 in chips)
Seat 3: DAIgyIWbYvAkL6PbAI27pg ($15.55 in chips)
Seat 4: 4OO5v3AVduL0tePNx8wk5A ($115.55 in chips)
Seat 5: RqgF7gRoKgRNW8Zoi1ty4A ($162.30 in chips)
Seat 6: YfsTQsY/fxb+YqbdclTHuw ($45.20 in chips)
14aYclSc98EYd6TrzN2l3Q will be allowed to play after the button
DAIgyIWbYvAkL6PbAI27pg: posts small blind $0.50
4OO5v3AVduL0tePNx8wk5A: posts big blind $1
*** HOLE CARDS ***
RqgF7gRoKgRNW8Zoi1ty4A: folds
YfsTQsY/fxb+YqbdclTHuw: raises $2 to $3
9XrTM0DuVxx1pjFAdSbD8A: folds
DAIgyIWbYvAkL6PbAI27pg: raises $12.55 to $15.55 and is all-in
4OO5v3AVduL0tePNx8wk5A: folds
YfsTQsY/fxb+YqbdclTHuw: calls $12.55
*** FLOP *** [9d 3s As]
*** TURN *** [9d 3s As] [Ad]
*** RIVER *** [9d 3s As Ad] [9c]
*** SHOW DOWN ***
DAIgyIWbYvAkL6PbAI27pg: shows [Kd Jc] (two pair, Aces and Nines)
YfsTQsY/fxb+YqbdclTHuw: shows [9h Ac] (a full house, Aces full of Nines)
YfsTQsY/fxb+YqbdclTHuw collected $30.50 from pot
*** SUMMARY ***
Total pot $32.10 | Rake $1.60
Board [9d 3s As Ad 9c]
Seat 1: 9XrTM0DuVxx1pjFAdSbD8A (button) folded before Flop (didn't bet)
Seat 3: DAIgyIWbYvAkL6PbAI27pg (small blind) showed [Kd Jc] and lost with two pair, Aces and Nines
Seat 4: 4OO5v3AVduL0tePNx8wk5A (big blind) folded before Flop
Seat 5: RqgF7gRoKgRNW8Zoi1ty4A folded before Flop (didn't bet)
Seat 6: YfsTQsY/fxb+YqbdclTHuw showed [9h Ac] and won ($30.50) with a full house, Aces full of Nines



PokerStars Game #59941425974:  Hold'em No Limit ($0.50/$1.00) - 2009/07/01 1:35:08 ET
Table 'qj0HBN4HhQKogreu1bg7xg' 2-max Seat #1 is the button
Seat 1: NYi6JFscYNrofSXy4sM+Yw ($111.50 in chips)
Seat 2: qtyl8CSb0/4yWdbuEPJejA ($168.60 in chips)
NYi6JFscYNrofSXy4sM+Yw: posts small blind $0.50
qtyl8CSb0/4yWdbuEPJejA: posts big blind $1
*** HOLE CARDS ***
NYi6JFscYNrofSXy4sM+Yw: raises $2 to $3
qtyl8CSb0/4yWdbuEPJejA: folds
NYi6JFscYNrofSXy4sM+Yw collected $2 from pot
NYi6JFscYNrofSXy4sM+Yw: doesn't show hand
*** SUMMARY ***
Total pot $2 | Rake $0
Seat 1: NYi6JFscYNrofSXy4sM+Yw (button) (small blind) collected ($2)
Seat 2: qtyl8CSb0/4yWdbuEPJejA (big blind) folded before Flop



PokerStars Game #59941425874:  Hold'em No Limit ($0.50/$1.00) - 2009/07/01 1:35:08 ET
Table '3T4owEKJKyGTMePwrv50FQ' 9-max Seat #9 is the button
Seat 1: OGgaARGdJQT4awWVNQ957w ($100.50 in chips)
Seat 2: t+Id2O6herCLgwnC4m49PA ($37.15 in chips)
Seat 3: DOLzOcBTZYcph5jEfKFWuQ ($100 in chips)
Seat 4: O5Go3jrzbQWxRB6ESK+Ptg ($80.60 in chips)
Seat 5: mMc/PBpqlN24gdi3C/1tOw ($45.90 in chips)
Seat 6: V138SURkdX8LdVBPKdJJag ($108.25 in chips)
Seat 7: 1862487932 ($100 in chips)
Seat 8: bLbSOSmSOnqE0iTcH/5dxA ($198.50 in chips)
Seat 9: 61sfw5QTu62YYIt68OsdrA ($64.15 in chips)
OGgaARGdJQT4awWVNQ957w: posts small blind $0.50
t+Id2O6herCLgwnC4m49PA: posts big blind $1
*** HOLE CARDS ***
DOLzOcBTZYcph5jEfKFWuQ: folds
O5Go3jrzbQWxRB6ESK+Ptg: folds
mMc/PBpqlN24gdi3C/1tOw: calls $1
V138SURkdX8LdVBPKdJJag: folds
1862487932: raises $3.50 to $4.50
bLbSOSmSOnqE0iTcH/5dxA: folds
61sfw5QTu62YYIt68OsdrA: folds
OGgaARGdJQT4awWVNQ957w: folds
t+Id2O6herCLgwnC4m49PA: folds
mMc/PBpqlN24gdi3C/1tOw: calls $3.50
*** FLOP *** [6s 6d 4d]
mMc/PBpqlN24gdi3C/1tOw: checks
1862487932: bets $6
mMc/PBpqlN24gdi3C/1tOw: folds
1862487932 collected $10 from pot
1862487932: doesn't show hand
*** SUMMARY ***
Total pot $10.50 | Rake $0.50
Board [6s 6d 4d]
Seat 1: OGgaARGdJQT4awWVNQ957w (small blind) folded before Flop
Seat 2: t+Id2O6herCLgwnC4m49PA (big blind) folded before Flop
Seat 3: DOLzOcBTZYcph5jEfKFWuQ folded before Flop (didn't bet)
Seat 4: O5Go3jrzbQWxRB6ESK+Ptg folded before Flop (didn't bet)
Seat 5: mMc/PBpqlN24gdi3C/1tOw folded on the Flop
Seat 6: V138SURkdX8LdVBPKdJJag folded before Flop (didn't bet)
Seat 7: 1862487932 collected ($10)
Seat 8: bLbSOSmSOnqE0iTcH/5dxA folded before Flop (didn't bet)
Seat 9: 61sfw5QTu62YYIt68OsdrA (button) folded before Flop (didn't bet)



PokerStars Game #59941426630:  Hold'em No Limit ($0.50/$1.00) - 2009/07/01 1:35:09 ET
Table 'hugOjcwJvzEwZbK7tyiWuQ' 9-max Seat #4 is the button
Seat 1: S3Ex8K7v6xm5jqjRM7Fl3w ($26.35 in chips)
Seat 2: r27C1nIV4NS4+qbnrgBQSw ($278.60 in chips)
Seat 3: c/6hFCyfLNRn3VFvCeQ1ng ($30.60 in chips)
Seat 4: UWB3oeddt/GObx2Mix2Anw ($156.95 in chips)
Seat 5: AexZ4puUV9meFWwVU6Nv0w ($31.70 in chips)
Seat 6: gUUvmqdVlmvpal6B8nYrmg ($105.45 in chips)
Seat 7: FL3MrLspcF23LYvC4ipBOA ($111.30 in chips)
Seat 8: /zy+DB4S5fUQUSfZWFzYGw ($118.35 in chips)
Seat 9: W8P9bUKCs43TO1xHm0dL6w ($108.80 in chips)
AexZ4puUV9meFWwVU6Nv0w: posts small blind $0.50
gUUvmqdVlmvpal6B8nYrmg: posts big blind $1
c/6hFCyfLNRn3VFvCeQ1ng: posts small & big blinds $1.50
*** HOLE CARDS ***
FL3MrLspcF23LYvC4ipBOA: folds
/zy+DB4S5fUQUSfZWFzYGw: folds
W8P9bUKCs43TO1xHm0dL6w: calls $1
S3Ex8K7v6xm5jqjRM7Fl3w: raises $3 to $4
r27C1nIV4NS4+qbnrgBQSw: folds
c/6hFCyfLNRn3VFvCeQ1ng: calls $3
UWB3oeddt/GObx2Mix2Anw: folds
AexZ4puUV9meFWwVU6Nv0w: folds
gUUvmqdVlmvpal6B8nYrmg: folds
W8P9bUKCs43TO1xHm0dL6w: folds
*** FLOP *** [Js 6c Qc]
S3Ex8K7v6xm5jqjRM7Fl3w: checks
c/6hFCyfLNRn3VFvCeQ1ng: bets $5
S3Ex8K7v6xm5jqjRM7Fl3w: folds
c/6hFCyfLNRn3VFvCeQ1ng collected $10.45 from pot
*** SUMMARY ***
Total pot $11 | Rake $0.55
Board [Js 6c Qc]
Seat 1: S3Ex8K7v6xm5jqjRM7Fl3w folded on the Flop
Seat 2: r27C1nIV4NS4+qbnrgBQSw folded before Flop (didn't bet)
Seat 3: c/6hFCyfLNRn3VFvCeQ1ng collected ($10.45)
Seat 4: UWB3oeddt/GObx2Mix2Anw (button) folded before Flop (didn't bet)
Seat 5: AexZ4puUV9meFWwVU6Nv0w (small blind) folded before Flop
Seat 6: gUUvmqdVlmvpal6B8nYrmg (big blind) folded before Flop
Seat 7: FL3MrLspcF23LYvC4ipBOA folded before Flop (didn't bet)
Seat 8: /zy+DB4S5fUQUSfZWFzYGw folded before Flop (didn't bet)
Seat 9: W8P9bUKCs43TO1xHm0dL6w folded before Flop



PokerStars Game #59941427094:  Hold'em No Limit ($0.50/$1.00) - 2009/07/01 1:35:10 ET
Table 'tJq9SfN1ywY0r03VBlWlwQ' 9-max Seat #8 is the button
Seat 1: wZsU+w9r7G66x93UuvBf1Q ($299.05 in chips)
Seat 2: VPF+HjszMvUIpy0CHIwH3A ($20 in chips)
Seat 4: bLbSOSmSOnqE0iTcH/5dxA ($114.20 in chips)
Seat 5: h5ipsNTMyolp7xn/NAvWkA ($134.80 in chips)
Seat 6: gUUvmqdVlmvpal6B8nYrmg ($100 in chips)
Seat 7: Ogn4JDV3mp4ZDKO49IFzKA ($19.90 in chips)
Seat 8: G4DEhsZFmznGNVpy2SEocA ($40.80 in chips)
Seat 9: XE5QF1y74bpHog9JxWJMWQ ($100 in chips)
XE5QF1y74bpHog9JxWJMWQ: posts small blind $0.50
wZsU+w9r7G66x93UuvBf1Q: posts big blind $1
*** HOLE CARDS ***
VPF+HjszMvUIpy0CHIwH3A: folds
bLbSOSmSOnqE0iTcH/5dxA: folds
h5ipsNTMyolp7xn/NAvWkA: folds
gUUvmqdVlmvpal6B8nYrmg: folds
Ogn4JDV3mp4ZDKO49IFzKA: folds
G4DEhsZFmznGNVpy2SEocA: folds
XE5QF1y74bpHog9JxWJMWQ: raises $3 to $4
wZsU+w9r7G66x93UuvBf1Q: calls $3
*** FLOP *** [3c 8s Kc]
XE5QF1y74bpHog9JxWJMWQ: bets $5
wZsU+w9r7G66x93UuvBf1Q: folds
XE5QF1y74bpHog9JxWJMWQ collected $7.60 from pot
*** SUMMARY ***
Total pot $8 | Rake $0.40
Board [3c 8s Kc]
Seat 1: wZsU+w9r7G66x93UuvBf1Q (big blind) folded on the Flop
Seat 2: VPF+HjszMvUIpy0CHIwH3A folded before Flop (didn't bet)
Seat 4: bLbSOSmSOnqE0iTcH/5dxA folded before Flop (didn't bet)
Seat 5: h5ipsNTMyolp7xn/NAvWkA folded before Flop (didn't bet)
Seat 6: gUUvmqdVlmvpal6B8nYrmg folded before Flop (didn't bet)
Seat 7: Ogn4JDV3mp4ZDKO49IFzKA folded before Flop (didn't bet)
Seat 8: G4DEhsZFmznGNVpy2SEocA (button) folded before Flop (didn't bet)
Seat 9: XE5QF1y74bpHog9JxWJMWQ (small blind) collected ($7.60)



PokerStars Game #59941427890:  Hold'em No Limit ($0.50/$1.00) - 2009/07/01 1:35:12 ET
Table 'tHb+N6GaPEmmBAe36B2R9Q' 2-max Seat #1 is the button
Seat 1: rL+Zpv4/vX2BVHcyfh/NXA ($100.90 in chips)
Seat 2: Pm1sDZZi0zFtnFGXLznkug ($129.40 in chips)
rL+Zpv4/vX2BVHcyfh/NXA: posts small blind $0.50
Pm1sDZZi0zFtnFGXLznkug: posts big blind $1
*** HOLE CARDS ***
rL+Zpv4/vX2BVHcyfh/NXA: raises $2 to $3
Pm1sDZZi0zFtnFGXLznkug: raises $11 to $14
rL+Zpv4/vX2BVHcyfh/NXA: folds
Pm1sDZZi0zFtnFGXLznkug collected $6 from pot
Pm1sDZZi0zFtnFGXLznkug: doesn't show hand
*** SUMMARY ***
Total pot $6 | Rake $0
Seat 1: rL+Zpv4/vX2BVHcyfh/NXA (button) (small blind) folded before Flop
Seat 2: Pm1sDZZi0zFtnFGXLznkug (big blind) collected ($6)



PokerStars Game #59941429812:  Hold'em No Limit ($0.50/$1.00) - 2009/07/01 1:35:15 ET
Table 'qj0HBN4HhQKogreu1bg7xg' 2-max Seat #2 is the button
Seat 1: NYi6JFscYNrofSXy4sM+Yw ($112.50 in chips)
Seat 2: qtyl8CSb0/4yWdbuEPJejA ($167.60 in chips)
qtyl8CSb0/4yWdbuEPJejA: posts small blind $0.50
NYi6JFscYNrofSXy4sM+Yw: posts big blind $1
*** HOLE CARDS ***
qtyl8CSb0/4yWdbuEPJejA: raises $2 to $3
NYi6JFscYNrofSXy4sM+Yw: folds
qtyl8CSb0/4yWdbuEPJejA collected $2 from pot
qtyl8CSb0/4yWdbuEPJejA: doesn't show hand
*** SUMMARY ***
Total pot $2 | Rake $0
Seat 1: NYi6JFscYNrofSXy4sM+Yw (big blind) folded before Flop
Seat 2: qtyl8CSb0/4yWdbuEPJejA (button) (small blind) collected ($2)



PokerStars Game #59941430702:  Hold'em No Limit ($0.50/$1.00) - 2009/07/01 1:35:17 ET
Table 'pHrhryH8jPNdQfY62f8v+g' 6-max Seat #4 is the button
Seat 1: 4d1rWhpu8DzLmzMbR3QKyA ($147.45 in chips)
Seat 2: JwCcjZl0bjJzG7hmE0dnTA ($116.05 in chips)
Seat 3: 8oS5O7iD/qnFXFXJrGIgNQ ($110.80 in chips)
Seat 4: 1f3beyIML24UqEMTbWy93g ($58.70 in chips)
Seat 5: d8WX+9nUHoqlrAGagO0Wow ($19 in chips)
Seat 6: xAU6q2/cwmby2sxmA8VcmA ($176.75 in chips)
d8WX+9nUHoqlrAGagO0Wow: posts small blind $0.50
xAU6q2/cwmby2sxmA8VcmA: posts big blind $1
*** HOLE CARDS ***
4d1rWhpu8DzLmzMbR3QKyA: folds
JwCcjZl0bjJzG7hmE0dnTA: folds
8oS5O7iD/qnFXFXJrGIgNQ: folds
1f3beyIML24UqEMTbWy93g: raises $2 to $3
d8WX+9nUHoqlrAGagO0Wow: calls $2.50
xAU6q2/cwmby2sxmA8VcmA: folds
*** FLOP *** [7s Ts 4s]
d8WX+9nUHoqlrAGagO0Wow: checks
1f3beyIML24UqEMTbWy93g: checks
*** TURN *** [7s Ts 4s] [7d]
d8WX+9nUHoqlrAGagO0Wow: checks
1f3beyIML24UqEMTbWy93g: checks
*** RIVER *** [7s Ts 4s 7d] [2d]
d8WX+9nUHoqlrAGagO0Wow: bets $3
1f3beyIML24UqEMTbWy93g: folds
d8WX+9nUHoqlrAGagO0Wow collected $6.65 from pot
*** SUMMARY ***
Total pot $7 | Rake $0.35
Board [7s Ts 4s 7d 2d]
Seat 1: 4d1rWhpu8DzLmzMbR3QKyA folded before Flop (didn't bet)
Seat 2: JwCcjZl0bjJzG7hmE0dnTA folded before Flop (didn't bet)
Seat 3: 8oS5O7iD/qnFXFXJrGIgNQ folded before Flop (didn't bet)
Seat 4: 1f3beyIML24UqEMTbWy93g (button) folded on the River
Seat 5: d8WX+9nUHoqlrAGagO0Wow (small blind) collected ($6.65)
Seat 6: xAU6q2/cwmby2sxmA8VcmA (big blind) folded before Flop



PokerStars Game #59941430908:  Hold'em No Limit ($0.50/$1.00) - 2009/07/01 1:35:17 ET
Table '305hiksPPCCdC6V2LNsO5w' 6-max Seat #4 is the button
Seat 1: RTuDLJHh/9zPfBftoc9vsw ($6.50 in chips)
Seat 2: j7NIOHLZk7V2o9fOioO5ug ($130.50 in chips)
Seat 3: +zIVjZKLpcidfRHgVZW8lA ($27.20 in chips)
Seat 4: uJVSceLggtsrJya+WtmUEA ($218.80 in chips)
Seat 5: +Nt3OPk3XR9SKjZgm2CexQ ($111.15 in chips)
Seat 6: 9/Tq8dw7kWW68uN8bFupXg ($22.45 in chips)
+Nt3OPk3XR9SKjZgm2CexQ: posts small blind $0.50
9/Tq8dw7kWW68uN8bFupXg: posts big blind $1
*** HOLE CARDS ***
RTuDLJHh/9zPfBftoc9vsw: folds
j7NIOHLZk7V2o9fOioO5ug: raises $2 to $3
+zIVjZKLpcidfRHgVZW8lA: folds
uJVSceLggtsrJya+WtmUEA: calls $3
+Nt3OPk3XR9SKjZgm2CexQ: raises $12 to $15
9/Tq8dw7kWW68uN8bFupXg: folds
j7NIOHLZk7V2o9fOioO5ug: calls $12
uJVSceLggtsrJya+WtmUEA: calls $12
*** FLOP *** [Ah Th 2d]
+Nt3OPk3XR9SKjZgm2CexQ: checks
j7NIOHLZk7V2o9fOioO5ug: bets $23
uJVSceLggtsrJya+WtmUEA: folds
+Nt3OPk3XR9SKjZgm2CexQ: folds
j7NIOHLZk7V2o9fOioO5ug collected $43.70 from pot
*** SUMMARY ***
Total pot $46 | Rake $2.30
Board [Ah Th 2d]
Seat 1: RTuDLJHh/9zPfBftoc9vsw folded before Flop (didn't bet)
Seat 2: j7NIOHLZk7V2o9fOioO5ug collected ($43.70)
Seat 3: +zIVjZKLpcidfRHgVZW8lA folded before Flop (didn't bet)
Seat 4: uJVSceLggtsrJya+WtmUEA (button) folded on the Flop
Seat 5: +Nt3OPk3XR9SKjZgm2CexQ (small blind) folded on the Flop
Seat 6: 9/Tq8dw7kWW68uN8bFupXg (big blind) folded before Flop



PokerStars Game #59941431586:  Hold'em No Limit ($0.50/$1.00) - 2009/07/01 1:35:18 ET
Table 'fTlPiCj0utgzC/5io+I7ew' 6-max Seat #6 is the button
Seat 1: YMJG+F++3Aj6P8dAWda5fw ($109.10 in chips)
Seat 2: qVr1nl3dy2xXPqS8UpTDlA ($18.80 in chips)
Seat 3: Z2fXsGcjl+Eax+RzOgwOmg ($138 in chips)
Seat 4: uJVSceLggtsrJya+WtmUEA ($166.35 in chips)
Seat 5: XUk5GQsfNFpHvaToDZ0rZA ($44.05 in chips)
Seat 6: y27w5IK2WXqmYzS8OU0wKA ($100 in chips)
YMJG+F++3Aj6P8dAWda5fw: posts small blind $0.50
qVr1nl3dy2xXPqS8UpTDlA: posts big blind $1
*** HOLE CARDS ***
Z2fXsGcjl+Eax+RzOgwOmg: folds
uJVSceLggtsrJya+WtmUEA: folds
XUk5GQsfNFpHvaToDZ0rZA: folds
y27w5IK2WXqmYzS8OU0wKA: folds
YMJG+F++3Aj6P8dAWda5fw: folds
qVr1nl3dy2xXPqS8UpTDlA collected $1 from pot
*** SUMMARY ***
Total pot $1 | Rake $0
Seat 1: YMJG+F++3Aj6P8dAWda5fw (small blind) folded before Flop
Seat 2: qVr1nl3dy2xXPqS8UpTDlA (big blind) collected ($1)
Seat 3: Z2fXsGcjl+Eax+RzOgwOmg folded before Flop (didn't bet)
Seat 4: uJVSceLggtsrJya+WtmUEA folded before Flop (didn't bet)
Seat 5: XUk5GQsfNFpHvaToDZ0rZA folded before Flop (didn't bet)
Seat 6: y27w5IK2WXqmYzS8OU0wKA (button) folded before Flop (didn't bet)



PokerStars Game #59941431768:  Hold'em No Limit ($0.50/$1.00) - 2009/07/01 1:35:18 ET
Table 'W/wyObTiXZm+Ckkl3YxcSw' 6-max Seat #1 is the button
Seat 1: eUBBn2R56C1IQ6Cs/vitwg ($294.05 in chips)
Seat 2: oDiBRCaF0QVtd3kO6xZIXw ($102.40 in chips)
Seat 3: dxyNCn/qxfkGDUIf28Cbng ($59.80 in chips)
Seat 4: UBZQqpnJZdTYYY1FTb0rLA ($156.70 in chips)
Seat 5: +OrCjyw70oZhJiD22Mn+bg ($105.50 in chips)
Seat 6: b2a+5TkFf4xJN/Ihhma58Q ($35.80 in chips)
oDiBRCaF0QVtd3kO6xZIXw: posts small blind $0.50
dxyNCn/qxfkGDUIf28Cbng: posts big blind $1
*** HOLE CARDS ***
UBZQqpnJZdTYYY1FTb0rLA: folds
+OrCjyw70oZhJiD22Mn+bg: folds
b2a+5TkFf4xJN/Ihhma58Q: folds
eUBBn2R56C1IQ6Cs/vitwg: raises $2 to $3
oDiBRCaF0QVtd3kO6xZIXw: calls $2.50
dxyNCn/qxfkGDUIf28Cbng: folds
*** FLOP *** [7h 8c 6d]
oDiBRCaF0QVtd3kO6xZIXw: bets $4
eUBBn2R56C1IQ6Cs/vitwg: raises $8 to $12
oDiBRCaF0QVtd3kO6xZIXw: raises $8 to $20
eUBBn2R56C1IQ6Cs/vitwg: folds
oDiBRCaF0QVtd3kO6xZIXw collected $29.50 from pot
oDiBRCaF0QVtd3kO6xZIXw: doesn't show hand
*** SUMMARY ***
Total pot $31 | Rake $1.50
Board [7h 8c 6d]
Seat 1: eUBBn2R56C1IQ6Cs/vitwg (button) folded on the Flop
Seat 2: oDiBRCaF0QVtd3kO6xZIXw (small blind) collected ($29.50)
Seat 3: dxyNCn/qxfkGDUIf28Cbng (big blind) folded before Flop
Seat 4: UBZQqpnJZdTYYY1FTb0rLA folded before Flop (didn't bet)
Seat 5: +OrCjyw70oZhJiD22Mn+bg folded before Flop (didn't bet)
Seat 6: b2a+5TkFf4xJN/Ihhma58Q folded before Flop (didn't bet)



PokerStars Game #59941431396:  Hold'em No Limit ($0.50/$1.00) - 2009/07/01 1:35:18 ET
Table '7O9fB8yx1u7sJveJn8w6jA' 6-max Seat #2 is the button
Seat 1: 841740 ($48.85 in chips)
Seat 2: wx3sQGkVi2x9wJXuWNHPBw ($201.80 in chips)
Seat 3: hpxXcmRkXXI9HE5+5/j/0Q ($141.90 in chips)
Seat 4: b2a+5TkFf4xJN/Ihhma58Q ($33.85 in chips)
Seat 5: BCEV3COoKY607AzLWayfRA ($100 in chips)
Seat 6: r4lpoh2BJZ8S6zyQv1JeSw ($100 in chips)
hpxXcmRkXXI9HE5+5/j/0Q: posts small blind $0.50
b2a+5TkFf4xJN/Ihhma58Q: posts big blind $1
*** HOLE CARDS ***
BCEV3COoKY607AzLWayfRA: folds
r4lpoh2BJZ8S6zyQv1JeSw: folds
841740: calls $1
wx3sQGkVi2x9wJXuWNHPBw: folds
hpxXcmRkXXI9HE5+5/j/0Q: raises $4 to $5
b2a+5TkFf4xJN/Ihhma58Q: folds
841740: calls $4
*** FLOP *** [Kd 4c 6c]
hpxXcmRkXXI9HE5+5/j/0Q: checks
841740: bets $6
hpxXcmRkXXI9HE5+5/j/0Q: folds
841740 collected $10.45 from pot
*** SUMMARY ***
Total pot $11 | Rake $0.55
Board [Kd 4c 6c]
Seat 1: 841740 collected ($10.45)
Seat 2: wx3sQGkVi2x9wJXuWNHPBw (button) folded before Flop (didn't bet)
Seat 3: hpxXcmRkXXI9HE5+5/j/0Q (small blind) folded on the Flop
Seat 4: b2a+5TkFf4xJN/Ihhma58Q (big blind) folded before Flop
Seat 5: BCEV3COoKY607AzLWayfRA folded before Flop (didn't bet)
Seat 6: r4lpoh2BJZ8S6zyQv1JeSw folded before Flop (didn't bet)



PokerStars Game #59941431216:  Hold'em No Limit ($0.50/$1.00) - 2009/07/01 1:35:18 ET
Table 'VOs36P6NW+QyXeQ1B62kmAE9S5sEoK9Q3olj2a53gABASeat #5 is the button
Seat 1: 4h8XtuVJtWh3DJpxGo7k5Q ($15.35 in chips)
Seat 2: y27w5IK2WXqmYzS8OU0wKA ($148.65 in chips)
Seat 3: p00KmyZiD/isPc/lZwNBTg ($17 in chips)
Seat 4: ene3nLSnQ4N961iBaUsSmA ($100 in chips)
Seat 5: o3YLm/rSY916m/on1VjXPA ($126.35 in chips)
Seat 6: slVKuQyEz8Qj4E3uLPYNXg ($50.45 in chips)
slVKuQyEz8Qj4E3uLPYNXg: posts small blind $0.50
4h8XtuVJtWh3DJpxGo7k5Q: posts big blind $1
*** HOLE CARDS ***
y27w5IK2WXqmYzS8OU0wKA: folds
p00KmyZiD/isPc/lZwNBTg: calls $1
ene3nLSnQ4N961iBaUsSmA: folds
o3YLm/rSY916m/on1VjXPA: folds
slVKuQyEz8Qj4E3uLPYNXg: folds
4h8XtuVJtWh3DJpxGo7k5Q: checks
*** FLOP *** [Ah 3h 7h]
4h8XtuVJtWh3DJpxGo7k5Q: bets $3
p00KmyZiD/isPc/lZwNBTg: calls $3
*** TURN *** [Ah 3h 7h] [4h]
4h8XtuVJtWh3DJpxGo7k5Q: bets $5
p00KmyZiD/isPc/lZwNBTg: folds
4h8XtuVJtWh3DJpxGo7k5Q collected $8.10 from pot
4h8XtuVJtWh3DJpxGo7k5Q: doesn't show hand
*** SUMMARY ***
Total pot $8.50 | Rake $0.40
Board [Ah 3h 7h 4h]
Seat 1: 4h8XtuVJtWh3DJpxGo7k5Q (big blind) collected ($8.10)
Seat 2: y27w5IK2WXqmYzS8OU0wKA folded before Flop (didn't bet)
Seat 3: p00KmyZiD/isPc/lZwNBTg folded on the Turn
Seat 4: ene3nLSnQ4N961iBaUsSmA folded before Flop (didn't bet)
Seat 5: o3YLm/rSY916m/on1VjXPA (button) folded before Flop (didn't bet)
Seat 6: slVKuQyEz8Qj4E3uLPYNXg (small blind) folded before Flop



PokerStars Game #59941432148:  Hold'em No Limit ($0.50/$1.00) - 2009/07/01 1:35:19 ET
Table 'ZFWj23PMihdwrNWv41OG/QtyUh+jyNvrceIQdKMJjQ2weat #2 is the button
Seat 1: j3hj7KQwBVU5NTFmtYomSw ($69.20 in chips)
Seat 2: 0smcry9L0OOTCP+KzIS5SA ($98.50 in chips)
Seat 3: cWwhvq/+r/w8nkhwrJoekQ ($47.85 in chips)
Seat 4: O5ZesE/6mHyuWWbvkiH/Fg ($42.35 in chips)
Seat 5: j7NIOHLZk7V2o9fOioO5ug ($100 in chips)
Seat 6: u23r4AyKPgHioZ6t7z6qrA ($70 in chips)
cWwhvq/+r/w8nkhwrJoekQ: posts small blind $0.50
O5ZesE/6mHyuWWbvkiH/Fg: posts big blind $1
*** HOLE CARDS ***
j7NIOHLZk7V2o9fOioO5ug: raises $2 to $3
u23r4AyKPgHioZ6t7z6qrA: folds
j3hj7KQwBVU5NTFmtYomSw: folds
0smcry9L0OOTCP+KzIS5SA: folds
cWwhvq/+r/w8nkhwrJoekQ: folds
O5ZesE/6mHyuWWbvkiH/Fg: folds
j7NIOHLZk7V2o9fOioO5ug collected $2.50 from pot
j7NIOHLZk7V2o9fOioO5ug: doesn't show hand
*** SUMMARY ***
Total pot $2.50 | Rake $0
Seat 1: j3hj7KQwBVU5NTFmtYomSw folded before Flop (didn't bet)
Seat 2: 0smcry9L0OOTCP+KzIS5SA (button) folded before Flop (didn't bet)
Seat 3: cWwhvq/+r/w8nkhwrJoekQ (small blind) folded before Flop
Seat 4: O5ZesE/6mHyuWWbvkiH/Fg (big blind) folded before Flop
Seat 5: j7NIOHLZk7V2o9fOioO5ug collected ($2.50)
Seat 6: u23r4AyKPgHioZ6t7z6qrA folded before Flop (didn't bet)



PokerStars Game #59941432528:  Hold'em No Limit ($0.50/$1.00) - 2009/07/01 1:35:20 ET
Table 'NqGO/cV3MwFAx+ZPB5ANmQ' 2-max Seat #1 is the button
Seat 1: ItaRAnHOgvYOv5ynbG1iTw ($235.70 in chips)
Seat 2: GtFB+yyeb2djMdPFuOW/Xg ($100 in chips)
ItaRAnHOgvYOv5ynbG1iTw: posts small blind $0.50
GtFB+yyeb2djMdPFuOW/Xg: posts big blind $1
*** HOLE CARDS ***
ItaRAnHOgvYOv5ynbG1iTw: raises $2 to $3
GtFB+yyeb2djMdPFuOW/Xg: folds
ItaRAnHOgvYOv5ynbG1iTw collected $2 from pot
*** SUMMARY ***
Total pot $2 | Rake $0
Seat 1: ItaRAnHOgvYOv5ynbG1iTw (button) (small blind) collected ($2)
Seat 2: GtFB+yyeb2djMdPFuOW/Xg (big blind) folded before Flop



PokerStars Game #59941433758:  Hold'em No Limit ($0.50/$1.00) - 2009/07/01 1:35:22 ET
Table 'qj0HBN4HhQKogreu1bg7xg' 2-max Seat #1 is the button
Seat 1: NYi6JFscYNrofSXy4sM+Yw ($111.50 in chips)
Seat 2: qtyl8CSb0/4yWdbuEPJejA ($168.60 in chips)
NYi6JFscYNrofSXy4sM+Yw: posts small blind $0.50
qtyl8CSb0/4yWdbuEPJejA: posts big blind $1
*** HOLE CARDS ***
NYi6JFscYNrofSXy4sM+Yw: raises $2 to $3
qtyl8CSb0/4yWdbuEPJejA: folds
NYi6JFscYNrofSXy4sM+Yw collected $2 from pot
*** SUMMARY ***
Total pot $2 | Rake $0
Seat 1: NYi6JFscYNrofSXy4sM+Yw (button) (small blind) collected ($2)
Seat 2: qtyl8CSb0/4yWdbuEPJejA (big blind) folded before Flop



PokerStars Game #59941433874:  Hold'em No Limit ($0.50/$1.00) - 2009/07/01 1:35:22 ET
Table 'mmbQQVBTrPdE+wy+s+9VPA' 6-max Seat #6 is the button
Seat 1: zyP4SPoWZnKUfTvIRLCVog ($69.65 in chips)
Seat 2: XK4Qsl+DA8gAJyg85/zBIw ($26.60 in chips)
Seat 3: wx3sQGkVi2x9wJXuWNHPBw ($255.60 in chips)
Seat 4: V3iZdcw61nXF3g5hD2RrsQ ($105.05 in chips)
Seat 5: YMJG+F++3Aj6P8dAWda5fw ($115.40 in chips)
Seat 6: U2CWBTv29qdCbj8RNF2sIw ($1.15 in chips)
zyP4SPoWZnKUfTvIRLCVog: posts small blind $0.50
XK4Qsl+DA8gAJyg85/zBIw: posts big blind $1
*** HOLE CARDS ***
wx3sQGkVi2x9wJXuWNHPBw: folds
V3iZdcw61nXF3g5hD2RrsQ: folds
YMJG+F++3Aj6P8dAWda5fw: folds
U2CWBTv29qdCbj8RNF2sIw: folds
U2CWBTv29qdCbj8RNF2sIw is sitting out
U2CWBTv29qdCbj8RNF2sIw leaves the table
zyP4SPoWZnKUfTvIRLCVog: folds
XK4Qsl+DA8gAJyg85/zBIw collected $1 from pot
*** SUMMARY ***
Total pot $1 | Rake $0
Seat 1: zyP4SPoWZnKUfTvIRLCVog (small blind) folded before Flop
Seat 2: XK4Qsl+DA8gAJyg85/zBIw (big blind) collected ($1)
Seat 3: wx3sQGkVi2x9wJXuWNHPBw folded before Flop (didn't bet)
Seat 4: V3iZdcw61nXF3g5hD2RrsQ folded before Flop (didn't bet)
Seat 5: YMJG+F++3Aj6P8dAWda5fw folded before Flop (didn't bet)
Seat 6: U2CWBTv29qdCbj8RNF2sIw (button) folded before Flop (didn't bet)



PokerStars Game #59941434872:  Hold'em No Limit ($0.50/$1.00) - 2009/07/01 1:35:24 ET
Table 'MUPc8FEpe/nR0BKSeReX6Q' 6-max Seat #2 is the button
Seat 1: qhkK6+yCciTRd+rCFEbnEQ ($59.70 in chips)
Seat 2: xAU6q2/cwmby2sxmA8VcmA ($103.70 in chips)
Seat 3: wx3sQGkVi2x9wJXuWNHPBw ($283 in chips)
Seat 4: r4lpoh2BJZ8S6zyQv1JeSw ($112 in chips)
Seat 5: y27w5IK2WXqmYzS8OU0wKA ($103.05 in chips)
Seat 6: cl/QpVR/PLO58lj+C5mGLw ($53.20 in chips)
wx3sQGkVi2x9wJXuWNHPBw: posts small blind $0.50
r4lpoh2BJZ8S6zyQv1JeSw: posts big blind $1
*** HOLE CARDS ***
y27w5IK2WXqmYzS8OU0wKA: folds
cl/QpVR/PLO58lj+C5mGLw: calls $1
qhkK6+yCciTRd+rCFEbnEQ: calls $1
xAU6q2/cwmby2sxmA8VcmA: folds
wx3sQGkVi2x9wJXuWNHPBw: calls $0.50
r4lpoh2BJZ8S6zyQv1JeSw: checks
*** FLOP *** [9s As 3d]
wx3sQGkVi2x9wJXuWNHPBw: checks
r4lpoh2BJZ8S6zyQv1JeSw: bets $2
cl/QpVR/PLO58lj+C5mGLw: folds
qhkK6+yCciTRd+rCFEbnEQ: folds
wx3sQGkVi2x9wJXuWNHPBw: calls $2
*** TURN *** [9s As 3d] [Ah]
wx3sQGkVi2x9wJXuWNHPBw: checks
r4lpoh2BJZ8S6zyQv1JeSw: checks
*** RIVER *** [9s As 3d Ah] [2d]
wx3sQGkVi2x9wJXuWNHPBw: checks
r4lpoh2BJZ8S6zyQv1JeSw: checks
*** SHOW DOWN ***
wx3sQGkVi2x9wJXuWNHPBw: shows [9c Qs] (two pair, Aces and Nines)
r4lpoh2BJZ8S6zyQv1JeSw: mucks hand
wx3sQGkVi2x9wJXuWNHPBw collected $7.65 from pot
*** SUMMARY ***
Total pot $8 | Rake $0.35
Board [9s As 3d Ah 2d]
Seat 1: qhkK6+yCciTRd+rCFEbnEQ folded on the Flop
Seat 2: xAU6q2/cwmby2sxmA8VcmA (button) folded before Flop (didn't bet)
Seat 3: wx3sQGkVi2x9wJXuWNHPBw (small blind) showed [9c Qs] and won ($7.65) with two pair, Aces and Nines
Seat 4: r4lpoh2BJZ8S6zyQv1JeSw (big blind) mucked
Seat 5: y27w5IK2WXqmYzS8OU0wKA folded before Flop (didn't bet)
Seat 6: cl/QpVR/PLO58lj+C5mGLw folded on the Flop



PokerStars Game #59941435192:  Hold'em No Limit ($0.50/$1.00) - 2009/07/01 1:35:25 ET
Table 'QSIig7BLMc9wY/rgBechzw' 6-max Seat #5 is the button
Seat 1: Z2fXsGcjl+Eax+RzOgwOmg ($132.55 in chips)
Seat 4: +uSzP8Jwnw7sKfQ4s66b7w ($62.30 in chips)
Seat 5: lsLuWlcPA3Rh7kJVLzMh0Q ($100.20 in chips)
Seat 6: PxqfkAMdAWtkgbT+q2gciA ($54.10 in chips)
PxqfkAMdAWtkgbT+q2gciA: posts small blind $0.50
Z2fXsGcjl+Eax+RzOgwOmg: posts big blind $1
4OO5v3AVduL0tePNx8wk5A: sits out
*** HOLE CARDS ***
+uSzP8Jwnw7sKfQ4s66b7w: folds
lsLuWlcPA3Rh7kJVLzMh0Q: folds
PxqfkAMdAWtkgbT+q2gciA: calls $0.50
Z2fXsGcjl+Eax+RzOgwOmg: raises $3 to $4
PxqfkAMdAWtkgbT+q2gciA: calls $3
*** FLOP *** [Jd 5c 9c]
PxqfkAMdAWtkgbT+q2gciA: checks
Z2fXsGcjl+Eax+RzOgwOmg: bets $5
PxqfkAMdAWtkgbT+q2gciA: calls $5
*** TURN *** [Jd 5c 9c] [9s]
PxqfkAMdAWtkgbT+q2gciA: checks
Z2fXsGcjl+Eax+RzOgwOmg: checks
*** RIVER *** [Jd 5c 9c 9s] [6d]
mLOIkH/qmRa+mVujQIhBRg is connected
mLOIkH/qmRa+mVujQIhBRg has returned
PxqfkAMdAWtkgbT+q2gciA: bets $10
Z2fXsGcjl+Eax+RzOgwOmg: calls $10
*** SHOW DOWN ***
PxqfkAMdAWtkgbT+q2gciA: shows [Tc 9d] (three of a kind, Nines)
Z2fXsGcjl+Eax+RzOgwOmg: mucks hand
PxqfkAMdAWtkgbT+q2gciA collected $36.15 from pot
*** SUMMARY ***
Total pot $38 | Rake $1.85
Board [Jd 5c 9c 9s 6d]
Seat 1: Z2fXsGcjl+Eax+RzOgwOmg (big blind) mucked
Seat 4: +uSzP8Jwnw7sKfQ4s66b7w folded before Flop (didn't bet)
Seat 5: lsLuWlcPA3Rh7kJVLzMh0Q (button) folded before Flop (didn't bet)
Seat 6: PxqfkAMdAWtkgbT+q2gciA (small blind) showed [Tc 9d] and won ($36.15) with three of a kind, Nines



PokerStars Game #59941435232:  Hold'em No Limit ($0.50/$1.00) - 2009/07/01 1:35:25 ET
Table 'O96CPOtvMBWP6kzuYDfdFA' 6-max Seat #4 is the button
Seat 1: 6alLXQIITA2EZ/lBeym8Dw ($128.25 in chips)
Seat 2: 4d1rWhpu8DzLmzMbR3QKyA ($101.50 in chips)
Seat 4: /P4w1pHg2zHYg/4ubJ0dPw ($65.15 in chips)
Seat 5: vX+iYAEINFeLxwMla7DY1Q ($99 in chips)
Seat 6: 3syOXva630dm1FTdwnuLpw ($79.65 in chips)
vX+iYAEINFeLxwMla7DY1Q: posts small blind $0.50
3syOXva630dm1FTdwnuLpw: posts big blind $1
*** HOLE CARDS ***
6alLXQIITA2EZ/lBeym8Dw: folds
4d1rWhpu8DzLmzMbR3QKyA: folds
/P4w1pHg2zHYg/4ubJ0dPw: raises $2 to $3
vX+iYAEINFeLxwMla7DY1Q: folds
3syOXva630dm1FTdwnuLpw: folds
/P4w1pHg2zHYg/4ubJ0dPw collected $2.50 from pot
*** SUMMARY ***
Total pot $2.50 | Rake $0
Seat 1: 6alLXQIITA2EZ/lBeym8Dw folded before Flop (didn't bet)
Seat 2: 4d1rWhpu8DzLmzMbR3QKyA folded before Flop (didn't bet)
Seat 4: /P4w1pHg2zHYg/4ubJ0dPw (button) collected ($2.50)
Seat 5: vX+iYAEINFeLxwMla7DY1Q (small blind) folded before Flop
Seat 6: 3syOXva630dm1FTdwnuLpw (big blind) folded before Flop



PokerStars Game #59941436172:  Hold'em No Limit ($0.50/$1.00) - 2009/07/01 1:35:27 ET
Table 'N6LvHFrb+cdXY/COI6ByOw' 2-max Seat #2 is the button
Seat 1: lXX4W7m3u++JiSOZ46yVMQ ($104 in chips)
Seat 2: 9mAoSP3o/mikSZOW2LEEAw ($168.20 in chips)
9mAoSP3o/mikSZOW2LEEAw: posts small blind $0.50
lXX4W7m3u++JiSOZ46yVMQ: posts big blind $1
*** HOLE CARDS ***
9mAoSP3o/mikSZOW2LEEAw: raises $1 to $2
lXX4W7m3u++JiSOZ46yVMQ: folds
9mAoSP3o/mikSZOW2LEEAw collected $2 from pot
9mAoSP3o/mikSZOW2LEEAw: shows [5d 4d] (high card Five)
*** SUMMARY ***
Total pot $2 | Rake $0
Seat 1: lXX4W7m3u++JiSOZ46yVMQ (big blind) folded before Flop
Seat 2: 9mAoSP3o/mikSZOW2LEEAw (button) (small blind) collected ($2)



PokerStars Game #59941436788:  Hold'em No Limit ($0.50/$1.00) - 2009/07/01 1:35:28 ET
Table 'vs/5jr6ciwjVQ5+Soc+u2A' 6-max Seat #1 is the button
Seat 1: J798qwLuvXyq0BbzsIjOrA ($176 in chips)
Seat 2: lXX4W7m3u++JiSOZ46yVMQ ($96 in chips)
Seat 4: 0smcry9L0OOTCP+KzIS5SA ($100 in chips)
Seat 5: +Nt3OPk3XR9SKjZgm2CexQ ($169.85 in chips)
Seat 6: Z2fXsGcjl+Eax+RzOgwOmg ($103 in chips)
lXX4W7m3u++JiSOZ46yVMQ: posts small blind $0.50
0smcry9L0OOTCP+KzIS5SA: posts big blind $1
*** HOLE CARDS ***
+Nt3OPk3XR9SKjZgm2CexQ: raises $2 to $3
Z2fXsGcjl+Eax+RzOgwOmg: folds
J798qwLuvXyq0BbzsIjOrA: raises $6 to $9
lXX4W7m3u++JiSOZ46yVMQ: folds
0smcry9L0OOTCP+KzIS5SA: folds
+Nt3OPk3XR9SKjZgm2CexQ: calls $6
*** FLOP *** [2h 2c 8c]
Ws/3Uo3rQIk8hLgW0P+2xA joins the table at seat #3
+Nt3OPk3XR9SKjZgm2CexQ: checks
J798qwLuvXyq0BbzsIjOrA: bets $6
+Nt3OPk3XR9SKjZgm2CexQ: folds
J798qwLuvXyq0BbzsIjOrA collected $18.55 from pot
J798qwLuvXyq0BbzsIjOrA: doesn't show hand
*** SUMMARY ***
Total pot $19.50 | Rake $0.95
Board [2h 2c 8c]
Seat 1: J798qwLuvXyq0BbzsIjOrA (button) collected ($18.55)
Seat 2: lXX4W7m3u++JiSOZ46yVMQ (small blind) folded before Flop
Seat 4: 0smcry9L0OOTCP+KzIS5SA (big blind) folded before Flop
Seat 5: +Nt3OPk3XR9SKjZgm2CexQ folded on the Flop
Seat 6: Z2fXsGcjl+Eax+RzOgwOmg folded before Flop (didn't bet)



PokerStars Game #59941437586:  Hold'em No Limit ($0.50/$1.00) - 2009/07/01 1:35:29 ET
Table 'qj0HBN4HhQKogreu1bg7xg' 2-max Seat #2 is the button
Seat 1: NYi6JFscYNrofSXy4sM+Yw ($112.50 in chips)
Seat 2: qtyl8CSb0/4yWdbuEPJejA ($167.60 in chips)
qtyl8CSb0/4yWdbuEPJejA: posts small blind $0.50
NYi6JFscYNrofSXy4sM+Yw: posts big blind $1
*** HOLE CARDS ***
qtyl8CSb0/4yWdbuEPJejA: folds
NYi6JFscYNrofSXy4sM+Yw collected $1 from pot
NYi6JFscYNrofSXy4sM+Yw: doesn't show hand
*** SUMMARY ***
Total pot $1 | Rake $0
Seat 1: NYi6JFscYNrofSXy4sM+Yw (big blind) collected ($1)
Seat 2: qtyl8CSb0/4yWdbuEPJejA (button) (small blind) folded before Flop



PokerStars Game #59941437978:  Hold'em No Limit ($0.50/$1.00) - 2009/07/01 1:35:30 ET
Table 'NqGO/cV3MwFAx+ZPB5ANmQ' 2-max Seat #2 is the button
Seat 1: ItaRAnHOgvYOv5ynbG1iTw ($236.70 in chips)
Seat 2: GtFB+yyeb2djMdPFuOW/Xg ($100 in chips)
GtFB+yyeb2djMdPFuOW/Xg: posts small blind $0.50
ItaRAnHOgvYOv5ynbG1iTw: posts big blind $1
*** HOLE CARDS ***
GtFB+yyeb2djMdPFuOW/Xg: raises $2 to $3
ItaRAnHOgvYOv5ynbG1iTw: folds
GtFB+yyeb2djMdPFuOW/Xg collected $2 from pot
*** SUMMARY ***
Total pot $2 | Rake $0
Seat 1: ItaRAnHOgvYOv5ynbG1iTw (big blind) folded before Flop
Seat 2: GtFB+yyeb2djMdPFuOW/Xg (button) (small blind) collected ($2)



PokerStars Game #59941437712:  Hold'em No Limit ($0.50/$1.00) - 2009/07/01 1:35:30 ET
Table 'rmZfTK+oSebeUPJNbWhdAA' 6-max Seat #6 is the button
Seat 1: xAU6q2/cwmby2sxmA8VcmA ($132 in chips)
Seat 2: z7O9PO/WEcqRouIydFhS9Q ($189.50 in chips)
Seat 3: BCEV3COoKY607AzLWayfRA ($193.80 in chips)
Seat 4: 1/mIuXfgx1ZyVkodrmfQDw ($172.15 in chips)
Seat 6: j7NIOHLZk7V2o9fOioO5ug ($100 in chips)
xAU6q2/cwmby2sxmA8VcmA: posts small blind $0.50
z7O9PO/WEcqRouIydFhS9Q: posts big blind $1
*** HOLE CARDS ***
BCEV3COoKY607AzLWayfRA: raises $3 to $4
1/mIuXfgx1ZyVkodrmfQDw: folds
j7NIOHLZk7V2o9fOioO5ug: folds
5lY8d6Cnm4HUkt/8FZSj4g leaves the table
xAU6q2/cwmby2sxmA8VcmA: folds
z7O9PO/WEcqRouIydFhS9Q: folds
BCEV3COoKY607AzLWayfRA collected $2.50 from pot
BCEV3COoKY607AzLWayfRA: doesn't show hand
*** SUMMARY ***
Total pot $2.50 | Rake $0
Seat 1: xAU6q2/cwmby2sxmA8VcmA (small blind) folded before Flop
Seat 2: z7O9PO/WEcqRouIydFhS9Q (big blind) folded before Flop
Seat 3: BCEV3COoKY607AzLWayfRA collected ($2.50)
Seat 4: 1/mIuXfgx1ZyVkodrmfQDw folded before Flop (didn't bet)
Seat 6: j7NIOHLZk7V2o9fOioO5ug (button) folded before Flop (didn't bet)



PokerStars Game #59941438654:  Hold'em No Limit ($0.50/$1.00) - 2009/07/01 1:35:31 ET
Table 'CASNP0uy1C+jGLml/I4PtA' 9-max Seat #8 is the button
Seat 1: tkdBeXTJlFsZdioidNqLow ($73.60 in chips)
Seat 2: LUsAYklr0mQkiq7ASOyD9A ($65.55 in chips)
Seat 4: B/G0GJacqZ8K59/ZVdq4kQ ($20.65 in chips)
Seat 5: Jjc7EHWzs4//xUAjJ0UWoA ($12 in chips)
Seat 6: FJEywSpo5JbRKByzmweboA ($130.40 in chips)
Seat 7: S3Ex8K7v6xm5jqjRM7Fl3w ($20.50 in chips)
Seat 8: L9njYvloJ1NdXjP8edHEAg ($102.95 in chips)
Seat 9: Pp/KTcXkfZKKUHkjyaLTdg ($23.10 in chips)
Pp/KTcXkfZKKUHkjyaLTdg: posts small blind $0.50
tkdBeXTJlFsZdioidNqLow: posts big blind $1
*** HOLE CARDS ***
LUsAYklr0mQkiq7ASOyD9A: folds
B/G0GJacqZ8K59/ZVdq4kQ: calls $1
Jjc7EHWzs4//xUAjJ0UWoA: folds
FJEywSpo5JbRKByzmweboA: folds
LUsAYklr0mQkiq7ASOyD9A leaves the table
S3Ex8K7v6xm5jqjRM7Fl3w: folds
L9njYvloJ1NdXjP8edHEAg: folds
Pp/KTcXkfZKKUHkjyaLTdg: folds
Ogn4JDV3mp4ZDKO49IFzKA joins the table at seat #2
tkdBeXTJlFsZdioidNqLow: checks
*** FLOP *** [Qs 9s Jc]
tkdBeXTJlFsZdioidNqLow: checks
B/G0GJacqZ8K59/ZVdq4kQ: bets $3
tkdBeXTJlFsZdioidNqLow: folds
B/G0GJacqZ8K59/ZVdq4kQ collected $2.40 from pot
*** SUMMARY ***
Total pot $2.50 | Rake $0.10
Board [Qs 9s Jc]
Seat 1: tkdBeXTJlFsZdioidNqLow (big blind) folded on the Flop
Seat 2: LUsAYklr0mQkiq7ASOyD9A folded before Flop (didn't bet)
Seat 4: B/G0GJacqZ8K59/ZVdq4kQ collected ($2.40)
Seat 5: Jjc7EHWzs4//xUAjJ0UWoA folded before Flop (didn't bet)
Seat 6: FJEywSpo5JbRKByzmweboA folded before Flop (didn't bet)
Seat 7: S3Ex8K7v6xm5jqjRM7Fl3w folded before Flop (didn't bet)
Seat 8: L9njYvloJ1NdXjP8edHEAg (button) folded before Flop (didn't bet)
Seat 9: Pp/KTcXkfZKKUHkjyaLTdg (small blind) folded before Flop



PokerStars Game #59941438834:  Hold'em No Limit ($0.50/$1.00) - 2009/07/01 1:35:31 ET
Table 'fZjVbKj9D8yOB+Rj7NaP/A' 9-max Seat #4 is the button
Seat 1: 9BZCcac3+McErkkSN2YScA ($103.15 in chips)
Seat 2: PTAFYDIUSsG+SArbxNl+Aw ($104 in chips)
Seat 3: yAbu2QsRPVcjPbqlf/jDxw ($103.65 in chips)
Seat 4: 997ViqAtWn1FPjJqcffwcA ($100 in chips)
Seat 5: PkGfq5xrSlNsujKaG/HF4Q ($100 in chips)
Seat 6: OvwYHV65yUbgdBjSmo1+5g ($130.40 in chips)
Seat 7: SyS20PAm3RpT6uLBsGkwOA ($77 in chips)
Seat 9: qheQay5YvP2DMAb3OUSxtw ($100.50 in chips)
PkGfq5xrSlNsujKaG/HF4Q: posts small blind $0.50
OvwYHV65yUbgdBjSmo1+5g: posts big blind $1
*** HOLE CARDS ***
SyS20PAm3RpT6uLBsGkwOA: folds
qheQay5YvP2DMAb3OUSxtw: folds
9BZCcac3+McErkkSN2YScA: folds
PTAFYDIUSsG+SArbxNl+Aw: folds
yAbu2QsRPVcjPbqlf/jDxw: folds
997ViqAtWn1FPjJqcffwcA: folds
PkGfq5xrSlNsujKaG/HF4Q: raises $3 to $4
OvwYHV65yUbgdBjSmo1+5g: calls $3
*** FLOP *** [Qs 5c Ah]
PkGfq5xrSlNsujKaG/HF4Q: checks
OvwYHV65yUbgdBjSmo1+5g: bets $3
EVvb0huXeMB7dnOAiO4ggA joins the table at seat #8
PkGfq5xrSlNsujKaG/HF4Q: calls $3
*** TURN *** [Qs 5c Ah] [9c]
PkGfq5xrSlNsujKaG/HF4Q: checks
OvwYHV65yUbgdBjSmo1+5g: bets $3
PkGfq5xrSlNsujKaG/HF4Q: calls $3
*** RIVER *** [Qs 5c Ah 9c] [7s]
PkGfq5xrSlNsujKaG/HF4Q: checks
OvwYHV65yUbgdBjSmo1+5g: checks
*** SHOW DOWN ***
PkGfq5xrSlNsujKaG/HF4Q: shows [Ts Qd] (a pair of Queens)
OvwYHV65yUbgdBjSmo1+5g: shows [Qc Kh] (a pair of Queens - Ace+King kicker)
OvwYHV65yUbgdBjSmo1+5g collected $19.05 from pot
*** SUMMARY ***
Total pot $20 | Rake $0.95
Board [Qs 5c Ah 9c 7s]
Seat 1: 9BZCcac3+McErkkSN2YScA folded before Flop (didn't bet)
Seat 2: PTAFYDIUSsG+SArbxNl+Aw folded before Flop (didn't bet)
Seat 3: yAbu2QsRPVcjPbqlf/jDxw folded before Flop (didn't bet)
Seat 4: 997ViqAtWn1FPjJqcffwcA (button) folded before Flop (didn't bet)
Seat 5: PkGfq5xrSlNsujKaG/HF4Q (small blind) showed [Ts Qd] and lost with a pair of Queens
Seat 6: OvwYHV65yUbgdBjSmo1+5g (big blind) showed [Qc Kh] and won ($19.05) with a pair of Queens
Seat 7: SyS20PAm3RpT6uLBsGkwOA folded before Flop (didn't bet)
Seat 9: qheQay5YvP2DMAb3OUSxtw folded before Flop (didn't bet)



PokerStars Game #59941438728:  Hold'em No Limit ($0.50/$1.00) - 2009/07/01 1:35:31 ET
Table 'GxCPo/gd3OSthkYrAxJngg' 6-max Seat #3 is the button
Seat 1: sH8BpAFP+jGFxCgVpD1Lew ($231.75 in chips)
Seat 2: YExX2paeIHrmfIwV1ivM/w ($63.10 in chips)
Seat 3: idVgoPAdspFPCzee6aF9Pg ($134.50 in chips)
Seat 4: YMJG+F++3Aj6P8dAWda5fw ($207.35 in chips)
Seat 5: vX+iYAEINFeLxwMla7DY1Q ($100 in chips)
Seat 6: 4d1rWhpu8DzLmzMbR3QKyA ($101.50 in chips)
YMJG+F++3Aj6P8dAWda5fw: posts small blind $0.50
vX+iYAEINFeLxwMla7DY1Q: posts big blind $1
*** HOLE CARDS ***
4d1rWhpu8DzLmzMbR3QKyA: folds
sH8BpAFP+jGFxCgVpD1Lew: folds
YExX2paeIHrmfIwV1ivM/w: folds
idVgoPAdspFPCzee6aF9Pg: folds
YMJG+F++3Aj6P8dAWda5fw: raises $2 to $3
vX+iYAEINFeLxwMla7DY1Q: folds
YMJG+F++3Aj6P8dAWda5fw collected $2 from pot
*** SUMMARY ***
Total pot $2 | Rake $0
Seat 1: sH8BpAFP+jGFxCgVpD1Lew folded before Flop (didn't bet)
Seat 2: YExX2paeIHrmfIwV1ivM/w folded before Flop (didn't bet)
Seat 3: idVgoPAdspFPCzee6aF9Pg (button) folded before Flop (didn't bet)
Seat 4: YMJG+F++3Aj6P8dAWda5fw (small blind) collected ($2)
Seat 5: vX+iYAEINFeLxwMla7DY1Q (big blind) folded before Flop
Seat 6: 4d1rWhpu8DzLmzMbR3QKyA folded before Flop (didn't bet)



PokerStars Game #59941438948:  Hold'em No Limit ($0.50/$1.00) - 2009/07/01 1:35:32 ET
Table 'ZFWj23PMihdwrNWv41OG/QtyUh+jyNvrceIQdKMJjQ2weat #3 is the button
Seat 1: j3hj7KQwBVU5NTFmtYomSw ($69.20 in chips)
Seat 2: 0smcry9L0OOTCP+KzIS5SA ($98.50 in chips)
Seat 3: cWwhvq/+r/w8nkhwrJoekQ ($47.35 in chips)
Seat 4: O5ZesE/6mHyuWWbvkiH/Fg ($41.35 in chips)
Seat 5: j7NIOHLZk7V2o9fOioO5ug ($101.50 in chips)
Seat 6: u23r4AyKPgHioZ6t7z6qrA ($70 in chips)
O5ZesE/6mHyuWWbvkiH/Fg: posts small blind $0.50
j7NIOHLZk7V2o9fOioO5ug: posts big blind $1
*** HOLE CARDS ***
u23r4AyKPgHioZ6t7z6qrA: folds
j3hj7KQwBVU5NTFmtYomSw: folds
0smcry9L0OOTCP+KzIS5SA: folds
cWwhvq/+r/w8nkhwrJoekQ: raises $2 to $3
O5ZesE/6mHyuWWbvkiH/Fg: folds
j7NIOHLZk7V2o9fOioO5ug: folds
cWwhvq/+r/w8nkhwrJoekQ collected $2.50 from pot
*** SUMMARY ***
Total pot $2.50 | Rake $0
Seat 1: j3hj7KQwBVU5NTFmtYomSw folded before Flop (didn't bet)
Seat 2: 0smcry9L0OOTCP+KzIS5SA folded before Flop (didn't bet)
Seat 3: cWwhvq/+r/w8nkhwrJoekQ (button) collected ($2.50)
Seat 4: O5ZesE/6mHyuWWbvkiH/Fg (small blind) folded before Flop
Seat 5: j7NIOHLZk7V2o9fOioO5ug (big blind) folded before Flop
Seat 6: u23r4AyKPgHioZ6t7z6qrA folded before Flop (didn't bet)



PokerStars Game #59941440004:  Hold'em No Limit ($0.50/$1.00) - 2009/07/01 1:35:33 ET
Table 'N6LvHFrb+cdXY/COI6ByOw' 2-max Seat #1 is the button
Seat 1: lXX4W7m3u++JiSOZ46yVMQ ($103 in chips)
Seat 2: 9mAoSP3o/mikSZOW2LEEAw ($169.20 in chips)
lXX4W7m3u++JiSOZ46yVMQ: posts small blind $0.50
9mAoSP3o/mikSZOW2LEEAw: posts big blind $1
*** HOLE CARDS ***
lXX4W7m3u++JiSOZ46yVMQ: folds
9mAoSP3o/mikSZOW2LEEAw collected $1 from pot
*** SUMMARY ***
Total pot $1 | Rake $0
Seat 1: lXX4W7m3u++JiSOZ46yVMQ (button) (small blind) folded before Flop
Seat 2: 9mAoSP3o/mikSZOW2LEEAw (big blind) collected ($1)



PokerStars Game #59941439532:  Hold'em No Limit ($0.50/$1.00) - 2009/07/01 1:35:33 ET
Table 'b8oW/dOL7fDza5DfZ/dOJQ' 6-max Seat #5 is the button
Seat 1: NakujTNjHFgzceydFf+E2Q ($99.50 in chips)
Seat 2: TSuRyAHnUPCFjP7Z0rEE0w ($120.50 in chips)
Seat 3: d8WX+9nUHoqlrAGagO0Wow ($31.40 in chips)
Seat 5: r4lpoh2BJZ8S6zyQv1JeSw ($101 in chips)
Seat 6: PvfYaKbzMpsmUcbOExckbQ ($109.60 in chips)
PvfYaKbzMpsmUcbOExckbQ: posts small blind $0.50
NakujTNjHFgzceydFf+E2Q: posts big blind $1
*** HOLE CARDS ***
TSuRyAHnUPCFjP7Z0rEE0w: folds
d8WX+9nUHoqlrAGagO0Wow: calls $1
r4lpoh2BJZ8S6zyQv1JeSw: folds
PvfYaKbzMpsmUcbOExckbQ: folds
NakujTNjHFgzceydFf+E2Q: checks
*** FLOP *** [4h Th Js]
X87W8qaGsudJTSkClK2Cig leaves the table
NakujTNjHFgzceydFf+E2Q: checks
d8WX+9nUHoqlrAGagO0Wow: checks
*** TURN *** [4h Th Js] [9h]
NakujTNjHFgzceydFf+E2Q: checks
d8WX+9nUHoqlrAGagO0Wow: checks
*** RIVER *** [4h Th Js 9h] [2c]
NakujTNjHFgzceydFf+E2Q: checks
d8WX+9nUHoqlrAGagO0Wow: checks
*** SHOW DOWN ***
NakujTNjHFgzceydFf+E2Q: shows [3s 5h] (high card Jack)
d8WX+9nUHoqlrAGagO0Wow: shows [Ac 7s] (high card Ace)
d8WX+9nUHoqlrAGagO0Wow collected $2.40 from pot
*** SUMMARY ***
Total pot $2.50 | Rake $0.10
Board [4h Th Js 9h 2c]
Seat 1: NakujTNjHFgzceydFf+E2Q (big blind) showed [3s 5h] and lost with high card Jack
Seat 2: TSuRyAHnUPCFjP7Z0rEE0w folded before Flop (didn't bet)
Seat 3: d8WX+9nUHoqlrAGagO0Wow showed [Ac 7s] and won ($2.40) with high card Ace
Seat 5: r4lpoh2BJZ8S6zyQv1JeSw (button) folded before Flop (didn't bet)
Seat 6: PvfYaKbzMpsmUcbOExckbQ (small blind) folded before Flop



PokerStars Game #59941441190:  Hold'em No Limit ($0.50/$1.00) - 2009/07/01 1:35:35 ET
Table 'tHb+N6GaPEmmBAe36B2R9Q' 2-max Seat #2 is the button
Seat 1: rL+Zpv4/vX2BVHcyfh/NXA ($100 in chips)
Seat 2: Pm1sDZZi0zFtnFGXLznkug ($132.40 in chips)
Pm1sDZZi0zFtnFGXLznkug: posts small blind $0.50
rL+Zpv4/vX2BVHcyfh/NXA: posts big blind $1
*** HOLE CARDS ***
Pm1sDZZi0zFtnFGXLznkug: calls $0.50
rL+Zpv4/vX2BVHcyfh/NXA: checks
*** FLOP *** [8d 5s Ad]
rL+Zpv4/vX2BVHcyfh/NXA: checks
Pm1sDZZi0zFtnFGXLznkug: checks
*** TURN *** [8d 5s Ad] [Qc]
rL+Zpv4/vX2BVHcyfh/NXA: checks
Pm1sDZZi0zFtnFGXLznkug: checks
*** RIVER *** [8d 5s Ad Qc] [Ah]
rL+Zpv4/vX2BVHcyfh/NXA: checks
Pm1sDZZi0zFtnFGXLznkug: bets $2
rL+Zpv4/vX2BVHcyfh/NXA: folds
Pm1sDZZi0zFtnFGXLznkug collected $1.90 from pot
Pm1sDZZi0zFtnFGXLznkug: doesn't show hand
*** SUMMARY ***
Total pot $2 | Rake $0.10
Board [8d 5s Ad Qc Ah]
Seat 1: rL+Zpv4/vX2BVHcyfh/NXA (big blind) folded on the River
Seat 2: Pm1sDZZi0zFtnFGXLznkug (button) (small blind) collected ($1.90)



PokerStars Game #59941440884:  Hold'em No Limit ($0.50/$1.00) - 2009/07/01 1:35:35 ET
Table 'qj0HBN4HhQKogreu1bg7xg' 2-max Seat #1 is the button
Seat 1: NYi6JFscYNrofSXy4sM+Yw ($113 in chips)
Seat 2: qtyl8CSb0/4yWdbuEPJejA ($167.10 in chips)
NYi6JFscYNrofSXy4sM+Yw: posts small blind $0.50
qtyl8CSb0/4yWdbuEPJejA: posts big blind $1
*** HOLE CARDS ***
NYi6JFscYNrofSXy4sM+Yw: folds
qtyl8CSb0/4yWdbuEPJejA collected $1 from pot
qtyl8CSb0/4yWdbuEPJejA: doesn't show hand
*** SUMMARY ***
Total pot $1 | Rake $0
Seat 1: NYi6JFscYNrofSXy4sM+Yw (button) (small blind) folded before Flop
Seat 2: qtyl8CSb0/4yWdbuEPJejA (big blind) collected ($1)



PokerStars Game #59941442858:  Hold'em No Limit ($0.50/$1.00) - 2009/07/01 1:35:38 ET
Table 'gxFK0BVUD7cupu2uyRUZJg' 6-max Seat #6 is the button
Seat 1: M+X3uChmP6R63IwijVjgTg ($241.55 in chips)
Seat 2: hpxXcmRkXXI9HE5+5/j/0Q ($133.05 in chips)
Seat 3: Z2fXsGcjl+Eax+RzOgwOmg ($100 in chips)
Seat 4: Hcr4S4Nbkj5idKsvYK/eqQ ($90 in chips)
Seat 6: dYyb6/42PMC8aNFlm/eBeQ ($129.90 in chips)
M+X3uChmP6R63IwijVjgTg: posts small blind $0.50
hpxXcmRkXXI9HE5+5/j/0Q: posts big blind $1
0smcry9L0OOTCP+KzIS5SA: sits out
*** HOLE CARDS ***
Z2fXsGcjl+Eax+RzOgwOmg: folds
Hcr4S4Nbkj5idKsvYK/eqQ: folds
dYyb6/42PMC8aNFlm/eBeQ: calls $1
M+X3uChmP6R63IwijVjgTg: calls $0.50
hpxXcmRkXXI9HE5+5/j/0Q: checks
*** FLOP *** [2s Td Kd]
M+X3uChmP6R63IwijVjgTg: bets $3
hpxXcmRkXXI9HE5+5/j/0Q: folds
dYyb6/42PMC8aNFlm/eBeQ: folds
M+X3uChmP6R63IwijVjgTg collected $2.85 from pot
*** SUMMARY ***
Total pot $3 | Rake $0.15
Board [2s Td Kd]
Seat 1: M+X3uChmP6R63IwijVjgTg (small blind) collected ($2.85)
Seat 2: hpxXcmRkXXI9HE5+5/j/0Q (big blind) folded on the Flop
Seat 3: Z2fXsGcjl+Eax+RzOgwOmg folded before Flop (didn't bet)
Seat 4: Hcr4S4Nbkj5idKsvYK/eqQ folded before Flop (didn't bet)
Seat 6: dYyb6/42PMC8aNFlm/eBeQ (button) folded on the Flop



PokerStars Game #59941443364:  Hold'em No Limit ($0.50/$1.00) - 2009/07/01 1:35:39 ET
Table 'N6LvHFrb+cdXY/COI6ByOw' 2-max Seat #2 is the button
Seat 1: lXX4W7m3u++JiSOZ46yVMQ ($102.50 in chips)
Seat 2: 9mAoSP3o/mikSZOW2LEEAw ($169.70 in chips)
9mAoSP3o/mikSZOW2LEEAw: posts small blind $0.50
lXX4W7m3u++JiSOZ46yVMQ: posts big blind $1
*** HOLE CARDS ***
9mAoSP3o/mikSZOW2LEEAw: raises $1 to $2
lXX4W7m3u++JiSOZ46yVMQ: folds
9mAoSP3o/mikSZOW2LEEAw collected $2 from pot
9mAoSP3o/mikSZOW2LEEAw: doesn't show hand
*** SUMMARY ***
Total pot $2 | Rake $0
Seat 1: lXX4W7m3u++JiSOZ46yVMQ (big blind) folded before Flop
Seat 2: 9mAoSP3o/mikSZOW2LEEAw (button) (small blind) collected ($2)



PokerStars Game #59941443550:  Hold'em No Limit ($0.50/$1.00) - 2009/07/01 1:35:40 ET
Table 'NqGO/cV3MwFAx+ZPB5ANmQ' 2-max Seat #1 is the button
Seat 1: ItaRAnHOgvYOv5ynbG1iTw ($235.70 in chips)
Seat 2: GtFB+yyeb2djMdPFuOW/Xg ($101 in chips)
ItaRAnHOgvYOv5ynbG1iTw: posts small blind $0.50
GtFB+yyeb2djMdPFuOW/Xg: posts big blind $1
*** HOLE CARDS ***
ItaRAnHOgvYOv5ynbG1iTw: raises $2 to $3
GtFB+yyeb2djMdPFuOW/Xg: folds
ItaRAnHOgvYOv5ynbG1iTw collected $2 from pot
*** SUMMARY ***
Total pot $2 | Rake $0
Seat 1: ItaRAnHOgvYOv5ynbG1iTw (button) (small blind) collected ($2)
Seat 2: GtFB+yyeb2djMdPFuOW/Xg (big blind) folded before Flop



PokerStars Game #59941443730:  Hold'em No Limit ($0.50/$1.00) - 2009/07/01 1:35:40 ET
Table 'qj0HBN4HhQKogreu1bg7xg' 2-max Seat #2 is the button
Seat 1: NYi6JFscYNrofSXy4sM+Yw ($112.50 in chips)
Seat 2: qtyl8CSb0/4yWdbuEPJejA ($167.60 in chips)
qtyl8CSb0/4yWdbuEPJejA: posts small blind $0.50
NYi6JFscYNrofSXy4sM+Yw: posts big blind $1
*** HOLE CARDS ***
qtyl8CSb0/4yWdbuEPJejA: raises $2 to $3
NYi6JFscYNrofSXy4sM+Yw: calls $2
*** FLOP *** [3h 3s 4s]
NYi6JFscYNrofSXy4sM+Yw: checks
qtyl8CSb0/4yWdbuEPJejA: checks
*** TURN *** [3h 3s 4s] [7s]
NYi6JFscYNrofSXy4sM+Yw: bets $3
qtyl8CSb0/4yWdbuEPJejA: folds
NYi6JFscYNrofSXy4sM+Yw collected $5.70 from pot
*** SUMMARY ***
Total pot $6 | Rake $0.30
Board [3h 3s 4s 7s]
Seat 1: NYi6JFscYNrofSXy4sM+Yw (big blind) collected ($5.70)
Seat 2: qtyl8CSb0/4yWdbuEPJejA (button) (small blind) folded on the Turn



PokerStars Game #59941443950:  Hold'em No Limit ($0.50/$1.00) - 2009/07/01 1:35:40 ET
Table 'mmbQQVBTrPdE+wy+s+9VPA' 6-max Seat #1 is the button
Seat 1: zyP4SPoWZnKUfTvIRLCVog ($69.15 in chips)
Seat 2: XK4Qsl+DA8gAJyg85/zBIw ($27.10 in chips)
Seat 3: wx3sQGkVi2x9wJXuWNHPBw ($255.60 in chips)
Seat 4: V3iZdcw61nXF3g5hD2RrsQ ($105.05 in chips)
Seat 5: YMJG+F++3Aj6P8dAWda5fw ($115.40 in chips)
XK4Qsl+DA8gAJyg85/zBIw: posts small blind $0.50
wx3sQGkVi2x9wJXuWNHPBw: posts big blind $1
*** HOLE CARDS ***
V3iZdcw61nXF3g5hD2RrsQ: folds
YMJG+F++3Aj6P8dAWda5fw: raises $2 to $3
zyP4SPoWZnKUfTvIRLCVog: folds
XK4Qsl+DA8gAJyg85/zBIw: folds
wx3sQGkVi2x9wJXuWNHPBw: folds
YMJG+F++3Aj6P8dAWda5fw collected $2.50 from pot
*** SUMMARY ***
Total pot $2.50 | Rake $0
Seat 1: zyP4SPoWZnKUfTvIRLCVog (button) folded before Flop (didn't bet)
Seat 2: XK4Qsl+DA8gAJyg85/zBIw (small blind) folded before Flop
Seat 3: wx3sQGkVi2x9wJXuWNHPBw (big blind) folded before Flop
Seat 4: V3iZdcw61nXF3g5hD2RrsQ folded before Flop (didn't bet)
Seat 5: YMJG+F++3Aj6P8dAWda5fw collected ($2.50)



PokerStars Game #59941444606:  Hold'em No Limit ($0.50/$1.00) - 2009/07/01 1:35:42 ET
Table 'blHlQApStil0OPeQxQxPcw' 9-max Seat #1 is the button
Seat 1: Pp/KTcXkfZKKUHkjyaLTdg ($24.10 in chips)
Seat 2: V138SURkdX8LdVBPKdJJag ($123.35 in chips)
Seat 3: OGgaARGdJQT4awWVNQ957w ($100 in chips)
Seat 5: uXrDE6JrIi8BZK1L8oQ9bQ ($50.10 in chips)
Seat 6: vljeiOoWscAIXU0fCuiEBw ($36.20 in chips)
Seat 8: laA8va+Yv8WuMqT1zdR91g ($100 in chips)
Seat 9: 6XkTu4ahxzHnvjjc1R8YjQ ($155.35 in chips)
V138SURkdX8LdVBPKdJJag: posts small blind $0.50
OGgaARGdJQT4awWVNQ957w: posts big blind $1
1862487932: sits out
VPF+HjszMvUIpy0CHIwH3A: sits out
*** HOLE CARDS ***
uXrDE6JrIi8BZK1L8oQ9bQ: folds
vljeiOoWscAIXU0fCuiEBw: raises $2 to $3
laA8va+Yv8WuMqT1zdR91g: folds
6XkTu4ahxzHnvjjc1R8YjQ: folds
Pp/KTcXkfZKKUHkjyaLTdg: folds
V138SURkdX8LdVBPKdJJag: folds
OGgaARGdJQT4awWVNQ957w: folds
vljeiOoWscAIXU0fCuiEBw collected $2.50 from pot
*** SUMMARY ***
Total pot $2.50 | Rake $0
Seat 1: Pp/KTcXkfZKKUHkjyaLTdg (button) folded before Flop (didn't bet)
Seat 2: V138SURkdX8LdVBPKdJJag (small blind) folded before Flop
Seat 3: OGgaARGdJQT4awWVNQ957w (big blind) folded before Flop
Seat 5: uXrDE6JrIi8BZK1L8oQ9bQ folded before Flop (didn't bet)
Seat 6: vljeiOoWscAIXU0fCuiEBw collected ($2.50)
Seat 8: laA8va+Yv8WuMqT1zdR91g folded before Flop (didn't bet)
Seat 9: 6XkTu4ahxzHnvjjc1R8YjQ folded before Flop (didn't bet)



PokerStars Game #59941446474:  Hold'em No Limit ($0.50/$1.00) - 2009/07/01 1:35:45 ET
Table 'O96CPOtvMBWP6kzuYDfdFA' 6-max Seat #5 is the button
Seat 1: 6alLXQIITA2EZ/lBeym8Dw ($128.25 in chips)
Seat 2: 4d1rWhpu8DzLmzMbR3QKyA ($101.50 in chips)
Seat 4: /P4w1pHg2zHYg/4ubJ0dPw ($66.65 in chips)
Seat 5: vX+iYAEINFeLxwMla7DY1Q ($98.50 in chips)
Seat 6: 3syOXva630dm1FTdwnuLpw ($78.65 in chips)
3syOXva630dm1FTdwnuLpw: posts small blind $0.50
6alLXQIITA2EZ/lBeym8Dw: posts big blind $1
*** HOLE CARDS ***
4d1rWhpu8DzLmzMbR3QKyA: folds
/P4w1pHg2zHYg/4ubJ0dPw: raises $2.50 to $3.50
vX+iYAEINFeLxwMla7DY1Q: folds
3syOXva630dm1FTdwnuLpw: calls $3
6alLXQIITA2EZ/lBeym8Dw: folds
*** FLOP *** [4s 4c 5d]
3syOXva630dm1FTdwnuLpw: checks
/P4w1pHg2zHYg/4ubJ0dPw: checks
*** TURN *** [4s 4c 5d] [Ks]
3syOXva630dm1FTdwnuLpw: checks
/P4w1pHg2zHYg/4ubJ0dPw: checks
*** RIVER *** [4s 4c 5d Ks] [4h]
3syOXva630dm1FTdwnuLpw: checks
/P4w1pHg2zHYg/4ubJ0dPw: checks
*** SHOW DOWN ***
3syOXva630dm1FTdwnuLpw: shows [Ad 6h] (three of a kind, Fours)
/P4w1pHg2zHYg/4ubJ0dPw: shows [2s 2h] (a full house, Fours full of Deuces)
/P4w1pHg2zHYg/4ubJ0dPw collected $7.60 from pot
*** SUMMARY ***
Total pot $8 | Rake $0.40
Board [4s 4c 5d Ks 4h]
Seat 1: 6alLXQIITA2EZ/lBeym8Dw (big blind) folded before Flop
Seat 2: 4d1rWhpu8DzLmzMbR3QKyA folded before Flop (didn't bet)
Seat 4: /P4w1pHg2zHYg/4ubJ0dPw showed [2s 2h] and won ($7.60) with a full house, Fours full of Deuces
Seat 5: vX+iYAEINFeLxwMla7DY1Q (button) folded before Flop (didn't bet)
Seat 6: 3syOXva630dm1FTdwnuLpw (small blind) showed [Ad 6h] and lost with three of a kind, Fours



PokerStars Game #59941447960:  Hold'em No Limit ($0.50/$1.00) - 2009/07/01 1:35:47 ET
Table 'N6LvHFrb+cdXY/COI6ByOw' 2-max Seat #1 is the button
Seat 1: lXX4W7m3u++JiSOZ46yVMQ ($101.50 in chips)
Seat 2: 9mAoSP3o/mikSZOW2LEEAw ($170.70 in chips)
lXX4W7m3u++JiSOZ46yVMQ: posts small blind $0.50
9mAoSP3o/mikSZOW2LEEAw: posts big blind $1
*** HOLE CARDS ***
lXX4W7m3u++JiSOZ46yVMQ: raises $2 to $3
9mAoSP3o/mikSZOW2LEEAw: folds
lXX4W7m3u++JiSOZ46yVMQ collected $2 from pot
*** SUMMARY ***
Total pot $2 | Rake $0
Seat 1: lXX4W7m3u++JiSOZ46yVMQ (button) (small blind) collected ($2)
Seat 2: 9mAoSP3o/mikSZOW2LEEAw (big blind) folded before Flop



PokerStars Game #59941448154:  Hold'em No Limit ($0.50/$1.00) - 2009/07/01 1:35:48 ET
Table 'fTlPiCj0utgzC/5io+I7ew' 6-max Seat #1 is the button
Seat 1: YMJG+F++3Aj6P8dAWda5fw ($108.60 in chips)
Seat 2: qVr1nl3dy2xXPqS8UpTDlA ($19.30 in chips)
Seat 3: Z2fXsGcjl+Eax+RzOgwOmg ($138 in chips)
Seat 4: uJVSceLggtsrJya+WtmUEA ($166.35 in chips)
Seat 5: XUk5GQsfNFpHvaToDZ0rZA ($44.05 in chips)
Seat 6: y27w5IK2WXqmYzS8OU0wKA ($100 in chips)
qVr1nl3dy2xXPqS8UpTDlA: posts small blind $0.50
Z2fXsGcjl+Eax+RzOgwOmg: posts big blind $1
*** HOLE CARDS ***
uJVSceLggtsrJya+WtmUEA has timed out
uJVSceLggtsrJya+WtmUEA: folds
uJVSceLggtsrJya+WtmUEA is sitting out
XUk5GQsfNFpHvaToDZ0rZA: folds
y27w5IK2WXqmYzS8OU0wKA: raises $2 to $3
uJVSceLggtsrJya+WtmUEA has returned
YMJG+F++3Aj6P8dAWda5fw: folds
qVr1nl3dy2xXPqS8UpTDlA: calls $2.50
Z2fXsGcjl+Eax+RzOgwOmg: folds
*** FLOP *** [6c 9c 7d]
qVr1nl3dy2xXPqS8UpTDlA: bets $3
y27w5IK2WXqmYzS8OU0wKA: folds
qVr1nl3dy2xXPqS8UpTDlA collected $6.65 from pot
*** SUMMARY ***
Total pot $7 | Rake $0.35
Board [6c 9c 7d]
Seat 1: YMJG+F++3Aj6P8dAWda5fw (button) folded before Flop (didn't bet)
Seat 2: qVr1nl3dy2xXPqS8UpTDlA (small blind) collected ($6.65)
Seat 3: Z2fXsGcjl+Eax+RzOgwOmg (big blind) folded before Flop
Seat 4: uJVSceLggtsrJya+WtmUEA folded before Flop (didn't bet)
Seat 5: XUk5GQsfNFpHvaToDZ0rZA folded before Flop (didn't bet)
Seat 6: y27w5IK2WXqmYzS8OU0wKA folded on the Flop



PokerStars Game #59941448740:  Hold'em No Limit ($0.50/$1.00) - 2009/07/01 1:35:49 ET
Table '/RZcOwpZpHQ+OwPwjsbnRw' 6-max Seat #6 is the button
Seat 1: +uSzP8Jwnw7sKfQ4s66b7w ($46.20 in chips)
Seat 2: Z2fXsGcjl+Eax+RzOgwOmg ($100 in chips)
Seat 3: LJMw/I77xpnw0R5T4HnMUg ($107.15 in chips)
Seat 4: j7NIOHLZk7V2o9fOioO5ug ($100 in chips)
Seat 5: wx3sQGkVi2x9wJXuWNHPBw ($165.75 in chips)
Seat 6: o3YLm/rSY916m/on1VjXPA ($207 in chips)
+uSzP8Jwnw7sKfQ4s66b7w: posts small blind $0.50
Z2fXsGcjl+Eax+RzOgwOmg: posts big blind $1
*** HOLE CARDS ***
LJMw/I77xpnw0R5T4HnMUg: folds
j7NIOHLZk7V2o9fOioO5ug: raises $2 to $3
wx3sQGkVi2x9wJXuWNHPBw: folds
o3YLm/rSY916m/on1VjXPA: folds
+uSzP8Jwnw7sKfQ4s66b7w: folds
Z2fXsGcjl+Eax+RzOgwOmg: folds
j7NIOHLZk7V2o9fOioO5ug collected $2.50 from pot
j7NIOHLZk7V2o9fOioO5ug: doesn't show hand
*** SUMMARY ***
Total pot $2.50 | Rake $0
Seat 1: +uSzP8Jwnw7sKfQ4s66b7w (small blind) folded before Flop
Seat 2: Z2fXsGcjl+Eax+RzOgwOmg (big blind) folded before Flop
Seat 3: LJMw/I77xpnw0R5T4HnMUg folded before Flop (didn't bet)
Seat 4: j7NIOHLZk7V2o9fOioO5ug collected ($2.50)
Seat 5: wx3sQGkVi2x9wJXuWNHPBw folded before Flop (didn't bet)
Seat 6: o3YLm/rSY916m/on1VjXPA (button) folded before Flop (didn't bet)



PokerStars Game #59941449022:  Hold'em No Limit ($0.50/$1.00) - 2009/07/01 1:35:49 ET
Table '7O9fB8yx1u7sJveJn8w6jA' 6-max Seat #3 is the button
Seat 1: 841740 ($54.30 in chips)
Seat 2: wx3sQGkVi2x9wJXuWNHPBw ($201.80 in chips)
Seat 3: hpxXcmRkXXI9HE5+5/j/0Q ($136.90 in chips)
Seat 4: b2a+5TkFf4xJN/Ihhma58Q ($32.85 in chips)
Seat 5: BCEV3COoKY607AzLWayfRA ($100 in chips)
Seat 6: r4lpoh2BJZ8S6zyQv1JeSw ($100 in chips)
b2a+5TkFf4xJN/Ihhma58Q: posts small blind $0.50
BCEV3COoKY607AzLWayfRA: posts big blind $1
*** HOLE CARDS ***
r4lpoh2BJZ8S6zyQv1JeSw: folds
841740: folds
wx3sQGkVi2x9wJXuWNHPBw: folds
hpxXcmRkXXI9HE5+5/j/0Q: folds
b2a+5TkFf4xJN/Ihhma58Q: calls $0.50
BCEV3COoKY607AzLWayfRA: raises $3 to $4
b2a+5TkFf4xJN/Ihhma58Q: folds
BCEV3COoKY607AzLWayfRA collected $2 from pot
BCEV3COoKY607AzLWayfRA: doesn't show hand
*** SUMMARY ***
Total pot $2 | Rake $0
Seat 1: 841740 folded before Flop (didn't bet)
Seat 2: wx3sQGkVi2x9wJXuWNHPBw folded before Flop (didn't bet)
Seat 3: hpxXcmRkXXI9HE5+5/j/0Q (button) folded before Flop (didn't bet)
Seat 4: b2a+5TkFf4xJN/Ihhma58Q (small blind) folded before Flop
Seat 5: BCEV3COoKY607AzLWayfRA (big blind) collected ($2)
Seat 6: r4lpoh2BJZ8S6zyQv1JeSw folded before Flop (didn't bet)



PokerStars Game #59941449756:  Hold'em No Limit ($0.50/$1.00) - 2009/07/01 1:35:51 ET
Table 'NqGO/cV3MwFAx+ZPB5ANmQ' 2-max Seat #2 is the button
Seat 1: ItaRAnHOgvYOv5ynbG1iTw ($236.70 in chips)
Seat 2: GtFB+yyeb2djMdPFuOW/Xg ($100 in chips)
GtFB+yyeb2djMdPFuOW/Xg: posts small blind $0.50
ItaRAnHOgvYOv5ynbG1iTw: posts big blind $1
*** HOLE CARDS ***
GtFB+yyeb2djMdPFuOW/Xg: folds
ItaRAnHOgvYOv5ynbG1iTw collected $1 from pot
*** SUMMARY ***
Total pot $1 | Rake $0
Seat 1: ItaRAnHOgvYOv5ynbG1iTw (big blind) collected ($1)
Seat 2: GtFB+yyeb2djMdPFuOW/Xg (button) (small blind) folded before Flop



PokerStars Game #59941449994:  Hold'em No Limit ($0.50/$1.00) - 2009/07/01 1:35:51 ET
Table 'kS0cTQAEi+fdUlJP2gQYvw' 9-max Seat #3 is the button
Seat 1: SqsWPukL8kLqrhq5ZrQdSQ ($89 in chips)
Seat 2: +JautI/vSNALzwSvsOqbCQ ($79 in chips)
Seat 3: 2BV+oJIQYr65IO6nEChvbA ($62.55 in chips)
Seat 4: RUhhaALzha3TH1AkdakoGQ ($51.50 in chips)
Seat 5: 997ViqAtWn1FPjJqcffwcA ($100 in chips)
Seat 6: yAbu2QsRPVcjPbqlf/jDxw ($118.65 in chips)
Seat 7: Ffa7Nj4X5fddtROP01hfQg ($145.50 in chips)
Seat 8: vKyFzTyzfT7fZcdX+HHN+Q ($51.35 in chips)
Seat 9: OGgaARGdJQT4awWVNQ957w ($107.20 in chips)
RUhhaALzha3TH1AkdakoGQ: posts small blind $0.50
997ViqAtWn1FPjJqcffwcA: posts big blind $1
+JautI/vSNALzwSvsOqbCQ: posts big blind $1
*** HOLE CARDS ***
yAbu2QsRPVcjPbqlf/jDxw: folds
Ffa7Nj4X5fddtROP01hfQg: folds
RUhhaALzha3TH1AkdakoGQ said, "there was only 3 dollars in the pot"
vKyFzTyzfT7fZcdX+HHN+Q is disconnected
vKyFzTyzfT7fZcdX+HHN+Q has timed out while disconnected
vKyFzTyzfT7fZcdX+HHN+Q: folds
vKyFzTyzfT7fZcdX+HHN+Q is sitting out
OGgaARGdJQT4awWVNQ957w: raises $4 to $5
vKyFzTyzfT7fZcdX+HHN+Q is connected
SqsWPukL8kLqrhq5ZrQdSQ: folds
vKyFzTyzfT7fZcdX+HHN+Q has returned
+JautI/vSNALzwSvsOqbCQ: folds
2BV+oJIQYr65IO6nEChvbA: folds
RUhhaALzha3TH1AkdakoGQ: folds
997ViqAtWn1FPjJqcffwcA: folds
OGgaARGdJQT4awWVNQ957w collected $3.50 from pot
OGgaARGdJQT4awWVNQ957w: doesn't show hand
*** SUMMARY ***
Total pot $3.50 | Rake $0
Seat 1: SqsWPukL8kLqrhq5ZrQdSQ folded before Flop (didn't bet)
Seat 2: +JautI/vSNALzwSvsOqbCQ folded before Flop
Seat 3: 2BV+oJIQYr65IO6nEChvbA (button) folded before Flop (didn't bet)
Seat 4: RUhhaALzha3TH1AkdakoGQ (small blind) folded before Flop
Seat 5: 997ViqAtWn1FPjJqcffwcA (big blind) folded before Flop
Seat 6: yAbu2QsRPVcjPbqlf/jDxw folded before Flop (didn't bet)
Seat 7: Ffa7Nj4X5fddtROP01hfQg folded before Flop (didn't bet)
Seat 8: vKyFzTyzfT7fZcdX+HHN+Q folded before Flop (didn't bet)
Seat 9: OGgaARGdJQT4awWVNQ957w collected ($3.50)



PokerStars Game #59941451490:  Hold'em No Limit ($0.50/$1.00) - 2009/07/01 1:35:54 ET
Table 'qj0HBN4HhQKogreu1bg7xg' 2-max Seat #1 is the button
Seat 1: NYi6JFscYNrofSXy4sM+Yw ($115.20 in chips)
Seat 2: qtyl8CSb0/4yWdbuEPJejA ($164.60 in chips)
NYi6JFscYNrofSXy4sM+Yw: posts small blind $0.50
qtyl8CSb0/4yWdbuEPJejA: posts big blind $1
*** HOLE CARDS ***
NYi6JFscYNrofSXy4sM+Yw: raises $2 to $3
qtyl8CSb0/4yWdbuEPJejA: folds
NYi6JFscYNrofSXy4sM+Yw collected $2 from pot
*** SUMMARY ***
Total pot $2 | Rake $0
Seat 1: NYi6JFscYNrofSXy4sM+Yw (button) (small blind) collected ($2)
Seat 2: qtyl8CSb0/4yWdbuEPJejA (big blind) folded before Flop



PokerStars Game #59941451464:  Hold'em No Limit ($0.50/$1.00) - 2009/07/01 1:35:54 ET
Table 'ZFWj23PMihdwrNWv41OG/QtyUh+jyNvrceIQdKMJjQ2weat #4 is the button
Seat 1: j3hj7KQwBVU5NTFmtYomSw ($69.20 in chips)
Seat 2: 0smcry9L0OOTCP+KzIS5SA ($98.50 in chips)
Seat 3: cWwhvq/+r/w8nkhwrJoekQ ($48.85 in chips)
Seat 4: O5ZesE/6mHyuWWbvkiH/Fg ($40.85 in chips)
Seat 5: j7NIOHLZk7V2o9fOioO5ug ($100.50 in chips)
Seat 6: u23r4AyKPgHioZ6t7z6qrA ($70 in chips)
u23r4AyKPgHioZ6t7z6qrA said, "nice hand"
j7NIOHLZk7V2o9fOioO5ug: posts small blind $0.50
u23r4AyKPgHioZ6t7z6qrA: posts big blind $1
*** HOLE CARDS ***
j3hj7KQwBVU5NTFmtYomSw: raises $2 to $3
0smcry9L0OOTCP+KzIS5SA: folds
cWwhvq/+r/w8nkhwrJoekQ: calls $3
O5ZesE/6mHyuWWbvkiH/Fg: folds
j7NIOHLZk7V2o9fOioO5ug: folds
u23r4AyKPgHioZ6t7z6qrA: folds
*** FLOP *** [7s 3h 6d]
j3hj7KQwBVU5NTFmtYomSw: bets $10
cWwhvq/+r/w8nkhwrJoekQ: folds
j3hj7KQwBVU5NTFmtYomSw collected $7.15 from pot
j3hj7KQwBVU5NTFmtYomSw: doesn't show hand
*** SUMMARY ***
Total pot $7.50 | Rake $0.35
Board [7s 3h 6d]
Seat 1: j3hj7KQwBVU5NTFmtYomSw collected ($7.15)
Seat 2: 0smcry9L0OOTCP+KzIS5SA folded before Flop (didn't bet)
Seat 3: cWwhvq/+r/w8nkhwrJoekQ folded on the Flop
Seat 4: O5ZesE/6mHyuWWbvkiH/Fg (button) folded before Flop (didn't bet)
Seat 5: j7NIOHLZk7V2o9fOioO5ug (small blind) folded before Flop
Seat 6: u23r4AyKPgHioZ6t7z6qrA (big blind) folded before Flop



PokerStars Game #59941451778:  Hold'em No Limit ($0.50/$1.00) - 2009/07/01 1:35:54 ET
Table 'rmZfTK+oSebeUPJNbWhdAA' 6-max Seat #1 is the button
Seat 1: xAU6q2/cwmby2sxmA8VcmA ($131.50 in chips)
Seat 2: z7O9PO/WEcqRouIydFhS9Q ($188.50 in chips)
Seat 3: BCEV3COoKY607AzLWayfRA ($195.30 in chips)
Seat 4: 1/mIuXfgx1ZyVkodrmfQDw ($172.15 in chips)
Seat 6: j7NIOHLZk7V2o9fOioO5ug ($100 in chips)
z7O9PO/WEcqRouIydFhS9Q: posts small blind $0.50
BCEV3COoKY607AzLWayfRA: posts big blind $1
*** HOLE CARDS ***
1/mIuXfgx1ZyVkodrmfQDw: folds
j7NIOHLZk7V2o9fOioO5ug: folds
xAU6q2/cwmby2sxmA8VcmA: folds
z7O9PO/WEcqRouIydFhS9Q: folds
BCEV3COoKY607AzLWayfRA collected $1 from pot
BCEV3COoKY607AzLWayfRA: doesn't show hand
*** SUMMARY ***
Total pot $1 | Rake $0
Seat 1: xAU6q2/cwmby2sxmA8VcmA (button) folded before Flop (didn't bet)
Seat 2: z7O9PO/WEcqRouIydFhS9Q (small blind) folded before Flop
Seat 3: BCEV3COoKY607AzLWayfRA (big blind) collected ($1)
Seat 4: 1/mIuXfgx1ZyVkodrmfQDw folded before Flop (didn't bet)
Seat 6: j7NIOHLZk7V2o9fOioO5ug folded before Flop (didn't bet)



PokerStars Game #59941452272:  Hold'em No Limit ($0.50/$1.00) - 2009/07/01 1:35:55 ET
Table 'N6LvHFrb+cdXY/COI6ByOw' 2-max Seat #2 is the button
Seat 1: lXX4W7m3u++JiSOZ46yVMQ ($102.50 in chips)
Seat 2: 9mAoSP3o/mikSZOW2LEEAw ($169.70 in chips)
9mAoSP3o/mikSZOW2LEEAw: posts small blind $0.50
lXX4W7m3u++JiSOZ46yVMQ: posts big blind $1
*** HOLE CARDS ***
9mAoSP3o/mikSZOW2LEEAw: folds
lXX4W7m3u++JiSOZ46yVMQ collected $1 from pot
*** SUMMARY ***
Total pot $1 | Rake $0
Seat 1: lXX4W7m3u++JiSOZ46yVMQ (big blind) collected ($1)
Seat 2: 9mAoSP3o/mikSZOW2LEEAw (button) (small blind) folded before Flop



PokerStars Game #59941452948:  Hold'em No Limit ($0.50/$1.00) - 2009/07/01 1:35:56 ET
Table 'NqGO/cV3MwFAx+ZPB5ANmQ' 2-max Seat #1 is the button
Seat 1: ItaRAnHOgvYOv5ynbG1iTw ($237.20 in chips)
Seat 2: GtFB+yyeb2djMdPFuOW/Xg ($100 in chips)
ItaRAnHOgvYOv5ynbG1iTw: posts small blind $0.50
GtFB+yyeb2djMdPFuOW/Xg: posts big blind $1
*** HOLE CARDS ***
ItaRAnHOgvYOv5ynbG1iTw: folds
GtFB+yyeb2djMdPFuOW/Xg collected $1 from pot
*** SUMMARY ***
Total pot $1 | Rake $0
Seat 1: ItaRAnHOgvYOv5ynbG1iTw (button) (small blind) folded before Flop
Seat 2: GtFB+yyeb2djMdPFuOW/Xg (big blind) collected ($1)



PokerStars Game #59941455738:  Hold'em No Limit ($0.50/$1.00) - 2009/07/01 1:36:01 ET
Table 'qj0HBN4HhQKogreu1bg7xg' 2-max Seat #2 is the button
Seat 1: NYi6JFscYNrofSXy4sM+Yw ($116.20 in chips)
Seat 2: qtyl8CSb0/4yWdbuEPJejA ($163.60 in chips)
qtyl8CSb0/4yWdbuEPJejA: posts small blind $0.50
NYi6JFscYNrofSXy4sM+Yw: posts big blind $1
*** HOLE CARDS ***
qtyl8CSb0/4yWdbuEPJejA: raises $2 to $3
NYi6JFscYNrofSXy4sM+Yw: calls $2
*** FLOP *** [4d As 8h]
NYi6JFscYNrofSXy4sM+Yw: checks
qtyl8CSb0/4yWdbuEPJejA: bets $5
NYi6JFscYNrofSXy4sM+Yw: folds
qtyl8CSb0/4yWdbuEPJejA collected $5.70 from pot
qtyl8CSb0/4yWdbuEPJejA: doesn't show hand
*** SUMMARY ***
Total pot $6 | Rake $0.30
Board [4d As 8h]
Seat 1: NYi6JFscYNrofSXy4sM+Yw (big blind) folded on the Flop
Seat 2: qtyl8CSb0/4yWdbuEPJejA (button) (small blind) collected ($5.70)



PokerStars Game #59941455568:  Hold'em No Limit ($0.50/$1.00) - 2009/07/01 1:36:01 ET
Table 'N6LvHFrb+cdXY/COI6ByOw' 2-max Seat #1 is the button
Seat 1: lXX4W7m3u++JiSOZ46yVMQ ($103 in chips)
Seat 2: 9mAoSP3o/mikSZOW2LEEAw ($169.20 in chips)
lXX4W7m3u++JiSOZ46yVMQ: posts small blind $0.50
9mAoSP3o/mikSZOW2LEEAw: posts big blind $1
*** HOLE CARDS ***
lXX4W7m3u++JiSOZ46yVMQ: folds
9mAoSP3o/mikSZOW2LEEAw collected $1 from pot
*** SUMMARY ***
Total pot $1 | Rake $0
Seat 1: lXX4W7m3u++JiSOZ46yVMQ (button) (small blind) folded before Flop
Seat 2: 9mAoSP3o/mikSZOW2LEEAw (big blind) collected ($1)



PokerStars Game #59941455400:  Hold'em No Limit ($0.50/$1.00) - 2009/07/01 1:36:01 ET
Table 'N2bNCDHL96aCQDvZIh+yQQ' 6-max Seat #2 is the button
Seat 1: Jjgflx10PVjcLkziEmLhSA ($77.35 in chips)
Seat 2: y27w5IK2WXqmYzS8OU0wKA ($121.05 in chips)
Seat 3: UBZQqpnJZdTYYY1FTb0rLA ($121.05 in chips)
Seat 4: uCqEjnxh2/vFBjKYkfTOkw ($190.80 in chips)
Seat 5: frvgHLr3+LfZtjsBCBs3NA ($16.60 in chips)
Seat 6: idVgoPAdspFPCzee6aF9Pg ($100 in chips)
UBZQqpnJZdTYYY1FTb0rLA: posts small blind $0.50
uCqEjnxh2/vFBjKYkfTOkw: posts big blind $1
*** HOLE CARDS ***
frvgHLr3+LfZtjsBCBs3NA: folds
idVgoPAdspFPCzee6aF9Pg: raises $2 to $3
Jjgflx10PVjcLkziEmLhSA: folds
y27w5IK2WXqmYzS8OU0wKA: folds
UBZQqpnJZdTYYY1FTb0rLA: folds
uCqEjnxh2/vFBjKYkfTOkw: folds
idVgoPAdspFPCzee6aF9Pg collected $2.50 from pot
idVgoPAdspFPCzee6aF9Pg: doesn't show hand
*** SUMMARY ***
Total pot $2.50 | Rake $0
Seat 1: Jjgflx10PVjcLkziEmLhSA folded before Flop (didn't bet)
Seat 2: y27w5IK2WXqmYzS8OU0wKA (button) folded before Flop (didn't bet)
Seat 3: UBZQqpnJZdTYYY1FTb0rLA (small blind) folded before Flop
Seat 4: uCqEjnxh2/vFBjKYkfTOkw (big blind) folded before Flop
Seat 5: frvgHLr3+LfZtjsBCBs3NA folded before Flop (didn't bet)
Seat 6: idVgoPAdspFPCzee6aF9Pg collected ($2.50)



PokerStars Game #59941455292:  Hold'em No Limit ($0.50/$1.00) - 2009/07/01 1:36:01 ET
Table 'mmbQQVBTrPdE+wy+s+9VPA' 6-max Seat #2 is the button
Seat 1: zyP4SPoWZnKUfTvIRLCVog ($69.15 in chips)
Seat 2: XK4Qsl+DA8gAJyg85/zBIw ($26.60 in chips)
Seat 3: wx3sQGkVi2x9wJXuWNHPBw ($254.60 in chips)
Seat 4: V3iZdcw61nXF3g5hD2RrsQ ($105.05 in chips)
Seat 5: YMJG+F++3Aj6P8dAWda5fw ($116.90 in chips)
wx3sQGkVi2x9wJXuWNHPBw: posts small blind $0.50
V3iZdcw61nXF3g5hD2RrsQ: posts big blind $1
*** HOLE CARDS ***
YMJG+F++3Aj6P8dAWda5fw: folds
zyP4SPoWZnKUfTvIRLCVog: raises $2 to $3
UOHYuj23MyK9R8ciY2t6FA joins the table at seat #6
XK4Qsl+DA8gAJyg85/zBIw: folds
wx3sQGkVi2x9wJXuWNHPBw: folds
V3iZdcw61nXF3g5hD2RrsQ: folds
zyP4SPoWZnKUfTvIRLCVog collected $2.50 from pot
*** SUMMARY ***
Total pot $2.50 | Rake $0
Seat 1: zyP4SPoWZnKUfTvIRLCVog collected ($2.50)
Seat 2: XK4Qsl+DA8gAJyg85/zBIw (button) folded before Flop (didn't bet)
Seat 3: wx3sQGkVi2x9wJXuWNHPBw (small blind) folded before Flop
Seat 4: V3iZdcw61nXF3g5hD2RrsQ (big blind) folded before Flop
Seat 5: YMJG+F++3Aj6P8dAWda5fw folded before Flop (didn't bet)



PokerStars Game #59941456366:  Hold'em No Limit ($0.50/$1.00) - 2009/07/01 1:36:03 ET
Table 'b8oW/dOL7fDza5DfZ/dOJQ' 6-max Seat #6 is the button
Seat 1: NakujTNjHFgzceydFf+E2Q ($98.50 in chips)
Seat 2: TSuRyAHnUPCFjP7Z0rEE0w ($120.50 in chips)
Seat 3: d8WX+9nUHoqlrAGagO0Wow ($32.80 in chips)
Seat 5: r4lpoh2BJZ8S6zyQv1JeSw ($101 in chips)
Seat 6: PvfYaKbzMpsmUcbOExckbQ ($109.10 in chips)
8rDbzImSi1zgxtqtF1pSbA joins the table at seat #4
NakujTNjHFgzceydFf+E2Q: posts small blind $0.50
TSuRyAHnUPCFjP7Z0rEE0w: posts big blind $1
*** HOLE CARDS ***
d8WX+9nUHoqlrAGagO0Wow: folds
r4lpoh2BJZ8S6zyQv1JeSw: folds
PvfYaKbzMpsmUcbOExckbQ: raises $2 to $3
NakujTNjHFgzceydFf+E2Q: folds
TSuRyAHnUPCFjP7Z0rEE0w: folds
PvfYaKbzMpsmUcbOExckbQ collected $2.50 from pot
PvfYaKbzMpsmUcbOExckbQ: doesn't show hand
*** SUMMARY ***
Total pot $2.50 | Rake $0
Seat 1: NakujTNjHFgzceydFf+E2Q (small blind) folded before Flop
Seat 2: TSuRyAHnUPCFjP7Z0rEE0w (big blind) folded before Flop
Seat 3: d8WX+9nUHoqlrAGagO0Wow folded before Flop (didn't bet)
Seat 5: r4lpoh2BJZ8S6zyQv1JeSw folded before Flop (didn't bet)
Seat 6: PvfYaKbzMpsmUcbOExckbQ (button) collected ($2.50)



PokerStars Game #59941456530:  Hold'em No Limit ($0.50/$1.00) - 2009/07/01 1:36:03 ET
Table 'pHrhryH8jPNdQfY62f8v+g' 6-max Seat #5 is the button
Seat 1: 4d1rWhpu8DzLmzMbR3QKyA ($147.45 in chips)
Seat 2: JwCcjZl0bjJzG7hmE0dnTA ($116.05 in chips)
Seat 3: 8oS5O7iD/qnFXFXJrGIgNQ ($110.80 in chips)
Seat 4: 1f3beyIML24UqEMTbWy93g ($55.70 in chips)
Seat 5: d8WX+9nUHoqlrAGagO0Wow ($22.65 in chips)
Seat 6: xAU6q2/cwmby2sxmA8VcmA ($175.75 in chips)
xAU6q2/cwmby2sxmA8VcmA: posts small blind $0.50
4d1rWhpu8DzLmzMbR3QKyA: posts big blind $1
*** HOLE CARDS ***
JwCcjZl0bjJzG7hmE0dnTA: folds
8oS5O7iD/qnFXFXJrGIgNQ: folds
1f3beyIML24UqEMTbWy93g: folds
d8WX+9nUHoqlrAGagO0Wow: raises $2 to $3
xAU6q2/cwmby2sxmA8VcmA: folds
4d1rWhpu8DzLmzMbR3QKyA: folds
d8WX+9nUHoqlrAGagO0Wow collected $2.50 from pot
*** SUMMARY ***
Total pot $2.50 | Rake $0
Seat 1: 4d1rWhpu8DzLmzMbR3QKyA (big blind) folded before Flop
Seat 2: JwCcjZl0bjJzG7hmE0dnTA folded before Flop (didn't bet)
Seat 3: 8oS5O7iD/qnFXFXJrGIgNQ folded before Flop (didn't bet)
Seat 4: 1f3beyIML24UqEMTbWy93g folded before Flop (didn't bet)
Seat 5: d8WX+9nUHoqlrAGagO0Wow (button) collected ($2.50)
Seat 6: xAU6q2/cwmby2sxmA8VcmA (small blind) folded before Flop



PokerStars Game #59941457114:  Hold'em No Limit ($0.50/$1.00) - 2009/07/01 1:36:04 ET
Table 'NqGO/cV3MwFAx+ZPB5ANmQ' 2-max Seat #2 is the button
Seat 1: ItaRAnHOgvYOv5ynbG1iTw ($236.70 in chips)
Seat 2: GtFB+yyeb2djMdPFuOW/Xg ($100.50 in chips)
GtFB+yyeb2djMdPFuOW/Xg: posts small blind $0.50
ItaRAnHOgvYOv5ynbG1iTw: posts big blind $1
*** HOLE CARDS ***
GtFB+yyeb2djMdPFuOW/Xg: raises $2 to $3
ItaRAnHOgvYOv5ynbG1iTw: folds
GtFB+yyeb2djMdPFuOW/Xg collected $2 from pot
*** SUMMARY ***
Total pot $2 | Rake $0
Seat 1: ItaRAnHOgvYOv5ynbG1iTw (big blind) folded before Flop
Seat 2: GtFB+yyeb2djMdPFuOW/Xg (button) (small blind) collected ($2)



PokerStars Game #59941458992:  Hold'em No Limit ($0.50/$1.00) - 2009/07/01 1:36:07 ET
Table 'N6LvHFrb+cdXY/COI6ByOw' 2-max Seat #2 is the button
Seat 1: lXX4W7m3u++JiSOZ46yVMQ ($102.50 in chips)
Seat 2: 9mAoSP3o/mikSZOW2LEEAw ($169.70 in chips)
9mAoSP3o/mikSZOW2LEEAw: posts small blind $0.50
lXX4W7m3u++JiSOZ46yVMQ: posts big blind $1
*** HOLE CARDS ***
9mAoSP3o/mikSZOW2LEEAw: raises $1 to $2
lXX4W7m3u++JiSOZ46yVMQ: calls $1
*** FLOP *** [5d Qc 8d]
lXX4W7m3u++JiSOZ46yVMQ: bets $2
9mAoSP3o/mikSZOW2LEEAw: raises $2 to $4
lXX4W7m3u++JiSOZ46yVMQ: calls $2
*** TURN *** [5d Qc 8d] [9d]
lXX4W7m3u++JiSOZ46yVMQ: bets $5
9mAoSP3o/mikSZOW2LEEAw: calls $5
*** RIVER *** [5d Qc 8d 9d] [3d]
lXX4W7m3u++JiSOZ46yVMQ: checks
9mAoSP3o/mikSZOW2LEEAw: checks
*** SHOW DOWN ***
lXX4W7m3u++JiSOZ46yVMQ: shows [Tc Jh] (a straight, Eight to Queen)
9mAoSP3o/mikSZOW2LEEAw: shows [Ac Qd] (a flush, Queen high)
9mAoSP3o/mikSZOW2LEEAw collected $21.50 from pot
*** SUMMARY ***
Total pot $22 | Rake $0.50
Board [5d Qc 8d 9d 3d]
Seat 1: lXX4W7m3u++JiSOZ46yVMQ (big blind) showed [Tc Jh] and lost with a straight, Eight to Queen
Seat 2: 9mAoSP3o/mikSZOW2LEEAw (button) (small blind) showed [Ac Qd] and won ($21.50) with a flush, Queen high



PokerStars Game #59941459106:  Hold'em No Limit ($0.50/$1.00) - 2009/07/01 1:36:07 ET
Table 'W/wyObTiXZm+Ckkl3YxcSw' 6-max Seat #2 is the button
Seat 1: eUBBn2R56C1IQ6Cs/vitwg ($279.05 in chips)
Seat 2: oDiBRCaF0QVtd3kO6xZIXw ($116.90 in chips)
Seat 3: dxyNCn/qxfkGDUIf28Cbng ($58.80 in chips)
Seat 4: UBZQqpnJZdTYYY1FTb0rLA ($156.70 in chips)
Seat 5: +OrCjyw70oZhJiD22Mn+bg ($105.50 in chips)
Seat 6: b2a+5TkFf4xJN/Ihhma58Q ($35.80 in chips)
dxyNCn/qxfkGDUIf28Cbng: posts small blind $0.50
UBZQqpnJZdTYYY1FTb0rLA: posts big blind $1
*** HOLE CARDS ***
+OrCjyw70oZhJiD22Mn+bg: folds
b2a+5TkFf4xJN/Ihhma58Q: folds
eUBBn2R56C1IQ6Cs/vitwg: folds
oDiBRCaF0QVtd3kO6xZIXw: folds
dxyNCn/qxfkGDUIf28Cbng: calls $0.50
UBZQqpnJZdTYYY1FTb0rLA: checks
*** FLOP *** [Td Ac Kh]
dxyNCn/qxfkGDUIf28Cbng: bets $2
UBZQqpnJZdTYYY1FTb0rLA: folds
dxyNCn/qxfkGDUIf28Cbng collected $1.90 from pot
*** SUMMARY ***
Total pot $2 | Rake $0.10
Board [Td Ac Kh]
Seat 1: eUBBn2R56C1IQ6Cs/vitwg folded before Flop (didn't bet)
Seat 2: oDiBRCaF0QVtd3kO6xZIXw (button) folded before Flop (didn't bet)
Seat 3: dxyNCn/qxfkGDUIf28Cbng (small blind) collected ($1.90)
Seat 4: UBZQqpnJZdTYYY1FTb0rLA (big blind) folded on the Flop
Seat 5: +OrCjyw70oZhJiD22Mn+bg folded before Flop (didn't bet)
Seat 6: b2a+5TkFf4xJN/Ihhma58Q folded before Flop (didn't bet)



PokerStars Game #59941459008:  Hold'em No Limit ($0.50/$1.00) - 2009/07/01 1:36:07 ET
Table 'hugOjcwJvzEwZbK7tyiWuQ' 9-max Seat #5 is the button
Seat 1: S3Ex8K7v6xm5jqjRM7Fl3w ($22.35 in chips)
Seat 2: r27C1nIV4NS4+qbnrgBQSw ($278.60 in chips)
Seat 3: c/6hFCyfLNRn3VFvCeQ1ng ($36.55 in chips)
Seat 4: UWB3oeddt/GObx2Mix2Anw ($156.95 in chips)
Seat 5: AexZ4puUV9meFWwVU6Nv0w ($31.20 in chips)
Seat 6: gUUvmqdVlmvpal6B8nYrmg ($104.45 in chips)
Seat 7: FL3MrLspcF23LYvC4ipBOA ($111.30 in chips)
Seat 8: /zy+DB4S5fUQUSfZWFzYGw ($118.35 in chips)
Seat 9: W8P9bUKCs43TO1xHm0dL6w ($107.80 in chips)
gUUvmqdVlmvpal6B8nYrmg: posts small blind $0.50
FL3MrLspcF23LYvC4ipBOA: posts big blind $1
*** HOLE CARDS ***
/zy+DB4S5fUQUSfZWFzYGw: folds
W8P9bUKCs43TO1xHm0dL6w: calls $1
S3Ex8K7v6xm5jqjRM7Fl3w: folds
c/6hFCyfLNRn3VFvCeQ1ng said, "had trips"
r27C1nIV4NS4+qbnrgBQSw: folds
c/6hFCyfLNRn3VFvCeQ1ng: folds
c/6hFCyfLNRn3VFvCeQ1ng said, "again"
UWB3oeddt/GObx2Mix2Anw: raises $4 to $5
AexZ4puUV9meFWwVU6Nv0w: folds
gUUvmqdVlmvpal6B8nYrmg: folds
FL3MrLspcF23LYvC4ipBOA: folds
W8P9bUKCs43TO1xHm0dL6w: folds
UWB3oeddt/GObx2Mix2Anw collected $3.50 from pot
*** SUMMARY ***
Total pot $3.50 | Rake $0
Seat 1: S3Ex8K7v6xm5jqjRM7Fl3w folded before Flop (didn't bet)
Seat 2: r27C1nIV4NS4+qbnrgBQSw folded before Flop (didn't bet)
Seat 3: c/6hFCyfLNRn3VFvCeQ1ng folded before Flop (didn't bet)
Seat 4: UWB3oeddt/GObx2Mix2Anw collected ($3.50)
Seat 5: AexZ4puUV9meFWwVU6Nv0w (button) folded before Flop (didn't bet)
Seat 6: gUUvmqdVlmvpal6B8nYrmg (small blind) folded before Flop
Seat 7: FL3MrLspcF23LYvC4ipBOA (big blind) folded before Flop
Seat 8: /zy+DB4S5fUQUSfZWFzYGw folded before Flop (didn't bet)
Seat 9: W8P9bUKCs43TO1xHm0dL6w folded before Flop



PokerStars Game #59941459086:  Hold'em No Limit ($0.50/$1.00) - 2009/07/01 1:36:07 ET
Table 'tJq9SfN1ywY0r03VBlWlwQ' 9-max Seat #9 is the button
Seat 1: wZsU+w9r7G66x93UuvBf1Q ($295.05 in chips)
Seat 2: VPF+HjszMvUIpy0CHIwH3A ($20 in chips)
Seat 4: bLbSOSmSOnqE0iTcH/5dxA ($114.20 in chips)
Seat 5: h5ipsNTMyolp7xn/NAvWkA ($134.80 in chips)
Seat 6: gUUvmqdVlmvpal6B8nYrmg ($100 in chips)
Seat 7: Ogn4JDV3mp4ZDKO49IFzKA ($19.90 in chips)
Seat 8: G4DEhsZFmznGNVpy2SEocA ($40.80 in chips)
Seat 9: XE5QF1y74bpHog9JxWJMWQ ($103.60 in chips)
wZsU+w9r7G66x93UuvBf1Q: posts small blind $0.50
VPF+HjszMvUIpy0CHIwH3A: posts big blind $1
*** HOLE CARDS ***
bLbSOSmSOnqE0iTcH/5dxA: folds
h5ipsNTMyolp7xn/NAvWkA: calls $1
gUUvmqdVlmvpal6B8nYrmg: folds
Ogn4JDV3mp4ZDKO49IFzKA: folds
G4DEhsZFmznGNVpy2SEocA: folds
XE5QF1y74bpHog9JxWJMWQ: folds
wZsU+w9r7G66x93UuvBf1Q: raises $4 to $5
VPF+HjszMvUIpy0CHIwH3A: folds
h5ipsNTMyolp7xn/NAvWkA: folds
wZsU+w9r7G66x93UuvBf1Q collected $3 from pot
*** SUMMARY ***
Total pot $3 | Rake $0
Seat 1: wZsU+w9r7G66x93UuvBf1Q (small blind) collected ($3)
Seat 2: VPF+HjszMvUIpy0CHIwH3A (big blind) folded before Flop
Seat 4: bLbSOSmSOnqE0iTcH/5dxA folded before Flop (didn't bet)
Seat 5: h5ipsNTMyolp7xn/NAvWkA folded before Flop
Seat 6: gUUvmqdVlmvpal6B8nYrmg folded before Flop (didn't bet)
Seat 7: Ogn4JDV3mp4ZDKO49IFzKA folded before Flop (didn't bet)
Seat 8: G4DEhsZFmznGNVpy2SEocA folded before Flop (didn't bet)
Seat 9: XE5QF1y74bpHog9JxWJMWQ (button) folded before Flop (didn't bet)



PokerStars Game #59941459558:  Hold'em No Limit ($0.50/$1.00) - 2009/07/01 1:36:08 ET
Table 'tHb+N6GaPEmmBAe36B2R9Q' 2-max Seat #1 is the button
Seat 1: rL+Zpv4/vX2BVHcyfh/NXA ($100 in chips)
Seat 2: Pm1sDZZi0zFtnFGXLznkug ($133.30 in chips)
rL+Zpv4/vX2BVHcyfh/NXA: posts small blind $0.50
Pm1sDZZi0zFtnFGXLznkug: posts big blind $1
*** HOLE CARDS ***
rL+Zpv4/vX2BVHcyfh/NXA: raises $2 to $3
Pm1sDZZi0zFtnFGXLznkug: folds
rL+Zpv4/vX2BVHcyfh/NXA collected $2 from pot
rL+Zpv4/vX2BVHcyfh/NXA: doesn't show hand
*** SUMMARY ***
Total pot $2 | Rake $0
Seat 1: rL+Zpv4/vX2BVHcyfh/NXA (button) (small blind) collected ($2)
Seat 2: Pm1sDZZi0zFtnFGXLznkug (big blind) folded before Flop



PokerStars Game #59941459788:  Hold'em No Limit ($0.50/$1.00) - 2009/07/01 1:36:09 ET
Table 'rmZfTK+oSebeUPJNbWhdAA' 6-max Seat #2 is the button
Seat 1: xAU6q2/cwmby2sxmA8VcmA ($131.50 in chips)
Seat 2: z7O9PO/WEcqRouIydFhS9Q ($188 in chips)
Seat 3: BCEV3COoKY607AzLWayfRA ($195.80 in chips)
Seat 4: 1/mIuXfgx1ZyVkodrmfQDw ($172.15 in chips)
Seat 6: j7NIOHLZk7V2o9fOioO5ug ($100 in chips)
BCEV3COoKY607AzLWayfRA: posts small blind $0.50
1/mIuXfgx1ZyVkodrmfQDw: posts big blind $1
*** HOLE CARDS ***
j7NIOHLZk7V2o9fOioO5ug: folds
xAU6q2/cwmby2sxmA8VcmA: folds
z7O9PO/WEcqRouIydFhS9Q: folds
BWhgxe7gWiYobRbwdG+d2Q joins the table at seat #5
BCEV3COoKY607AzLWayfRA: folds
1/mIuXfgx1ZyVkodrmfQDw collected $1 from pot
1/mIuXfgx1ZyVkodrmfQDw: doesn't show hand
*** SUMMARY ***
Total pot $1 | Rake $0
Seat 1: xAU6q2/cwmby2sxmA8VcmA folded before Flop (didn't bet)
Seat 2: z7O9PO/WEcqRouIydFhS9Q (button) folded before Flop (didn't bet)
Seat 3: BCEV3COoKY607AzLWayfRA (small blind) folded before Flop
Seat 4: 1/mIuXfgx1ZyVkodrmfQDw (big blind) collected ($1)
Seat 6: j7NIOHLZk7V2o9fOioO5ug folded before Flop (didn't bet)



PokerStars Game #59941460232:  Hold'em No Limit ($0.50/$1.00) - 2009/07/01 1:36:10 ET
Table 'gxFK0BVUD7cupu2uyRUZJg' 6-max Seat #1 is the button
Seat 1: M+X3uChmP6R63IwijVjgTg ($243.40 in chips)
Seat 2: hpxXcmRkXXI9HE5+5/j/0Q ($132.05 in chips)
Seat 3: Z2fXsGcjl+Eax+RzOgwOmg ($100 in chips)
Seat 4: Hcr4S4Nbkj5idKsvYK/eqQ ($100 in chips)
Seat 6: dYyb6/42PMC8aNFlm/eBeQ ($128.90 in chips)
hpxXcmRkXXI9HE5+5/j/0Q: posts small blind $0.50
Z2fXsGcjl+Eax+RzOgwOmg: posts big blind $1
0smcry9L0OOTCP+KzIS5SA: sits out
*** HOLE CARDS ***
Hcr4S4Nbkj5idKsvYK/eqQ: folds
dYyb6/42PMC8aNFlm/eBeQ: folds
M+X3uChmP6R63IwijVjgTg: raises $3 to $4
hpxXcmRkXXI9HE5+5/j/0Q: folds
Z2fXsGcjl+Eax+RzOgwOmg: folds
M+X3uChmP6R63IwijVjgTg collected $2.50 from pot
*** SUMMARY ***
Total pot $2.50 | Rake $0
Seat 1: M+X3uChmP6R63IwijVjgTg (button) collected ($2.50)
Seat 2: hpxXcmRkXXI9HE5+5/j/0Q (small blind) folded before Flop
Seat 3: Z2fXsGcjl+Eax+RzOgwOmg (big blind) folded before Flop
Seat 4: Hcr4S4Nbkj5idKsvYK/eqQ folded before Flop (didn't bet)
Seat 6: dYyb6/42PMC8aNFlm/eBeQ folded before Flop (didn't bet)



PokerStars Game #59941461714:  Hold'em No Limit ($0.50/$1.00) - 2009/07/01 1:36:12 ET
Table 'QSIig7BLMc9wY/rgBechzw' 6-max Seat #6 is the button
Seat 1: Z2fXsGcjl+Eax+RzOgwOmg ($113.55 in chips)
Seat 2: mLOIkH/qmRa+mVujQIhBRg ($20.40 in chips)
Seat 4: +uSzP8Jwnw7sKfQ4s66b7w ($62.30 in chips)
Seat 5: lsLuWlcPA3Rh7kJVLzMh0Q ($100.20 in chips)
Seat 6: PxqfkAMdAWtkgbT+q2gciA ($71.25 in chips)
Z2fXsGcjl+Eax+RzOgwOmg: posts small blind $0.50
mLOIkH/qmRa+mVujQIhBRg: posts big blind $1
4OO5v3AVduL0tePNx8wk5A: sits out
*** HOLE CARDS ***
+uSzP8Jwnw7sKfQ4s66b7w: raises $2 to $3
lsLuWlcPA3Rh7kJVLzMh0Q: folds
PxqfkAMdAWtkgbT+q2gciA: calls $3
Z2fXsGcjl+Eax+RzOgwOmg: folds
mLOIkH/qmRa+mVujQIhBRg: calls $2
*** FLOP *** [2h 5h 9h]
mLOIkH/qmRa+mVujQIhBRg: checks
+uSzP8Jwnw7sKfQ4s66b7w: checks
PxqfkAMdAWtkgbT+q2gciA: checks
*** TURN *** [2h 5h 9h] [8h]
mLOIkH/qmRa+mVujQIhBRg: checks
+uSzP8Jwnw7sKfQ4s66b7w: checks
PxqfkAMdAWtkgbT+q2gciA: checks
*** RIVER *** [2h 5h 9h 8h] [Jd]
mLOIkH/qmRa+mVujQIhBRg: bets $6
+uSzP8Jwnw7sKfQ4s66b7w: folds
PxqfkAMdAWtkgbT+q2gciA: folds
mLOIkH/qmRa+mVujQIhBRg collected $9.05 from pot
*** SUMMARY ***
Total pot $9.50 | Rake $0.45
Board [2h 5h 9h 8h Jd]
Seat 1: Z2fXsGcjl+Eax+RzOgwOmg (small blind) folded before Flop
Seat 2: mLOIkH/qmRa+mVujQIhBRg (big blind) collected ($9.05)
Seat 4: +uSzP8Jwnw7sKfQ4s66b7w folded on the River
Seat 5: lsLuWlcPA3Rh7kJVLzMh0Q folded before Flop (didn't bet)
Seat 6: PxqfkAMdAWtkgbT+q2gciA (button) folded on the River



PokerStars Game #59941462122:  Hold'em No Limit ($0.50/$1.00) - 2009/07/01 1:36:13 ET
Table 'NqGO/cV3MwFAx+ZPB5ANmQ' 2-max Seat #1 is the button
Seat 1: ItaRAnHOgvYOv5ynbG1iTw ($235.70 in chips)
Seat 2: GtFB+yyeb2djMdPFuOW/Xg ($101.50 in chips)
ItaRAnHOgvYOv5ynbG1iTw: posts small blind $0.50
GtFB+yyeb2djMdPFuOW/Xg: posts big blind $1
*** HOLE CARDS ***
ItaRAnHOgvYOv5ynbG1iTw: raises $2 to $3
GtFB+yyeb2djMdPFuOW/Xg: folds
ItaRAnHOgvYOv5ynbG1iTw collected $2 from pot
*** SUMMARY ***
Total pot $2 | Rake $0
Seat 1: ItaRAnHOgvYOv5ynbG1iTw (button) (small blind) collected ($2)
Seat 2: GtFB+yyeb2djMdPFuOW/Xg (big blind) folded before Flop



PokerStars Game #59941462118:  Hold'em No Limit ($0.50/$1.00) - 2009/07/01 1:36:13 ET
Table '+cA8mcmhaedZ7YcrDdhmeQ' 6-max Seat #3 is the button
Seat 1: 9XrTM0DuVxx1pjFAdSbD8A ($52.70 in chips)
Seat 2: 14aYclSc98EYd6TrzN2l3Q ($25.05 in chips)
Seat 3: DAIgyIWbYvAkL6PbAI27pg ($20 in chips)
Seat 4: 4OO5v3AVduL0tePNx8wk5A ($114.55 in chips)
Seat 5: RqgF7gRoKgRNW8Zoi1ty4A ($162.30 in chips)
Seat 6: YfsTQsY/fxb+YqbdclTHuw ($60.15 in chips)
4OO5v3AVduL0tePNx8wk5A: posts small blind $0.50
RqgF7gRoKgRNW8Zoi1ty4A: posts big blind $1
14aYclSc98EYd6TrzN2l3Q: posts small & big blinds $1.50
*** HOLE CARDS ***
YfsTQsY/fxb+YqbdclTHuw: raises $2 to $3
9XrTM0DuVxx1pjFAdSbD8A: calls $3
14aYclSc98EYd6TrzN2l3Q: calls $2
DAIgyIWbYvAkL6PbAI27pg: folds
4OO5v3AVduL0tePNx8wk5A: raises $13.50 to $16.50
RqgF7gRoKgRNW8Zoi1ty4A: folds
YfsTQsY/fxb+YqbdclTHuw: folds
9XrTM0DuVxx1pjFAdSbD8A: folds
14aYclSc98EYd6TrzN2l3Q: calls $13.50
*** FLOP *** [8c Kc 7d]
4OO5v3AVduL0tePNx8wk5A: bets $34.50
14aYclSc98EYd6TrzN2l3Q: calls $8.05 and is all-in
*** TURN *** [8c Kc 7d] [5h]
*** RIVER *** [8c Kc 7d 5h] [6h]
*** SHOW DOWN ***
4OO5v3AVduL0tePNx8wk5A: shows [Js Jc] (a pair of Jacks)
14aYclSc98EYd6TrzN2l3Q: shows [Ks 3s] (a pair of Kings)
14aYclSc98EYd6TrzN2l3Q collected $53.90 from pot
*** SUMMARY ***
Total pot $56.60 | Rake $2.70
Board [8c Kc 7d 5h 6h]
Seat 1: 9XrTM0DuVxx1pjFAdSbD8A folded before Flop
Seat 2: 14aYclSc98EYd6TrzN2l3Q showed [Ks 3s] and won ($53.90) with a pair of Kings
Seat 3: DAIgyIWbYvAkL6PbAI27pg (button) folded before Flop (didn't bet)
Seat 4: 4OO5v3AVduL0tePNx8wk5A (small blind) showed [Js Jc] and lost with a pair of Jacks
Seat 5: RqgF7gRoKgRNW8Zoi1ty4A (big blind) folded before Flop
Seat 6: YfsTQsY/fxb+YqbdclTHuw folded before Flop



PokerStars Game #59941462380:  Hold'em No Limit ($0.50/$1.00) - 2009/07/01 1:36:14 ET
Table '/RZcOwpZpHQ+OwPwjsbnRw' 6-max Seat #1 is the button
Seat 1: +uSzP8Jwnw7sKfQ4s66b7w ($45.70 in chips)
Seat 2: Z2fXsGcjl+Eax+RzOgwOmg ($100 in chips)
Seat 3: LJMw/I77xpnw0R5T4HnMUg ($107.15 in chips)
Seat 4: j7NIOHLZk7V2o9fOioO5ug ($101.50 in chips)
Seat 5: wx3sQGkVi2x9wJXuWNHPBw ($165.75 in chips)
Seat 6: o3YLm/rSY916m/on1VjXPA ($207 in chips)
Z2fXsGcjl+Eax+RzOgwOmg: posts small blind $0.50
LJMw/I77xpnw0R5T4HnMUg: posts big blind $1
*** HOLE CARDS ***
j7NIOHLZk7V2o9fOioO5ug: folds
wx3sQGkVi2x9wJXuWNHPBw: folds
o3YLm/rSY916m/on1VjXPA: folds
+uSzP8Jwnw7sKfQ4s66b7w: folds
Z2fXsGcjl+Eax+RzOgwOmg: folds
LJMw/I77xpnw0R5T4HnMUg collected $1 from pot
LJMw/I77xpnw0R5T4HnMUg: doesn't show hand
*** SUMMARY ***
Total pot $1 | Rake $0
Seat 1: +uSzP8Jwnw7sKfQ4s66b7w (button) folded before Flop (didn't bet)
Seat 2: Z2fXsGcjl+Eax+RzOgwOmg (small blind) folded before Flop
Seat 3: LJMw/I77xpnw0R5T4HnMUg (big blind) collected ($1)
Seat 4: j7NIOHLZk7V2o9fOioO5ug folded before Flop (didn't bet)
Seat 5: wx3sQGkVi2x9wJXuWNHPBw folded before Flop (didn't bet)
Seat 6: o3YLm/rSY916m/on1VjXPA folded before Flop (didn't bet)



PokerStars Game #59941462620:  Hold'em No Limit ($0.50/$1.00) - 2009/07/01 1:36:14 ET
Table '7O9fB8yx1u7sJveJn8w6jA' 6-max Seat #4 is the button
Seat 1: 841740 ($54.30 in chips)
Seat 2: wx3sQGkVi2x9wJXuWNHPBw ($201.80 in chips)
Seat 3: hpxXcmRkXXI9HE5+5/j/0Q ($136.90 in chips)
Seat 4: b2a+5TkFf4xJN/Ihhma58Q ($31.85 in chips)
Seat 5: BCEV3COoKY607AzLWayfRA ($101 in chips)
Seat 6: r4lpoh2BJZ8S6zyQv1JeSw ($100 in chips)
BCEV3COoKY607AzLWayfRA: posts small blind $0.50
r4lpoh2BJZ8S6zyQv1JeSw: posts big blind $1
*** HOLE CARDS ***
841740: folds
wx3sQGkVi2x9wJXuWNHPBw: folds
hpxXcmRkXXI9HE5+5/j/0Q: folds
b2a+5TkFf4xJN/Ihhma58Q has timed out
b2a+5TkFf4xJN/Ihhma58Q: folds
b2a+5TkFf4xJN/Ihhma58Q is sitting out
BCEV3COoKY607AzLWayfRA: folds
r4lpoh2BJZ8S6zyQv1JeSw collected $1 from pot
r4lpoh2BJZ8S6zyQv1JeSw: doesn't show hand
*** SUMMARY ***
Total pot $1 | Rake $0
Seat 1: 841740 folded before Flop (didn't bet)
Seat 2: wx3sQGkVi2x9wJXuWNHPBw folded before Flop (didn't bet)
Seat 3: hpxXcmRkXXI9HE5+5/j/0Q folded before Flop (didn't bet)
Seat 4: b2a+5TkFf4xJN/Ihhma58Q (button) folded before Flop (didn't bet)
Seat 5: BCEV3COoKY607AzLWayfRA (small blind) folded before Flop
Seat 6: r4lpoh2BJZ8S6zyQv1JeSw (big blind) collected ($1)



PokerStars Game #59941463294:  Hold'em No Limit ($0.50/$1.00) - 2009/07/01 1:36:15 ET
Table 'qj0HBN4HhQKogreu1bg7xg' 2-max Seat #1 is the button
Seat 1: NYi6JFscYNrofSXy4sM+Yw ($113.20 in chips)
Seat 2: qtyl8CSb0/4yWdbuEPJejA ($166.30 in chips)
NYi6JFscYNrofSXy4sM+Yw: posts small blind $0.50
qtyl8CSb0/4yWdbuEPJejA: posts big blind $1
*** HOLE CARDS ***
NYi6JFscYNrofSXy4sM+Yw: folds
qtyl8CSb0/4yWdbuEPJejA collected $1 from pot
qtyl8CSb0/4yWdbuEPJejA: doesn't show hand
*** SUMMARY ***
Total pot $1 | Rake $0
Seat 1: NYi6JFscYNrofSXy4sM+Yw (button) (small blind) folded before Flop
Seat 2: qtyl8CSb0/4yWdbuEPJejA (big blind) collected ($1)



PokerStars Game #59941463828:  Hold'em No Limit ($0.50/$1.00) - 2009/07/01 1:36:16 ET
Table 'tHb+N6GaPEmmBAe36B2R9Q' 2-max Seat #2 is the button
Seat 1: rL+Zpv4/vX2BVHcyfh/NXA ($101 in chips)
Seat 2: Pm1sDZZi0zFtnFGXLznkug ($132.30 in chips)
Pm1sDZZi0zFtnFGXLznkug: posts small blind $0.50
rL+Zpv4/vX2BVHcyfh/NXA: posts big blind $1
*** HOLE CARDS ***
Pm1sDZZi0zFtnFGXLznkug: raises $2 to $3
rL+Zpv4/vX2BVHcyfh/NXA: folds
Pm1sDZZi0zFtnFGXLznkug collected $2 from pot
Pm1sDZZi0zFtnFGXLznkug: doesn't show hand
*** SUMMARY ***
Total pot $2 | Rake $0
Seat 1: rL+Zpv4/vX2BVHcyfh/NXA (big blind) folded before Flop
Seat 2: Pm1sDZZi0zFtnFGXLznkug (button) (small blind) collected ($2)



PokerStars Game #59941464264:  Hold'em No Limit ($0.50/$1.00) - 2009/07/01 1:36:17 ET
Table '3T4owEKJKyGTMePwrv50FQ' 9-max Seat #1 is the button
Seat 1: OGgaARGdJQT4awWVNQ957w ($100 in chips)
Seat 2: t+Id2O6herCLgwnC4m49PA ($36.15 in chips)
Seat 3: DOLzOcBTZYcph5jEfKFWuQ ($100 in chips)
Seat 4: O5Go3jrzbQWxRB6ESK+Ptg ($80.60 in chips)
Seat 5: mMc/PBpqlN24gdi3C/1tOw ($41.40 in chips)
Seat 6: V138SURkdX8LdVBPKdJJag ($108.25 in chips)
Seat 7: 1862487932 ($105.50 in chips)
Seat 8: bLbSOSmSOnqE0iTcH/5dxA ($198.50 in chips)
Seat 9: 61sfw5QTu62YYIt68OsdrA ($64.15 in chips)
t+Id2O6herCLgwnC4m49PA: posts small blind $0.50
DOLzOcBTZYcph5jEfKFWuQ: posts big blind $1
*** HOLE CARDS ***
O5Go3jrzbQWxRB6ESK+Ptg: raises $4 to $5
mMc/PBpqlN24gdi3C/1tOw: folds
V138SURkdX8LdVBPKdJJag: folds
1862487932: folds
bLbSOSmSOnqE0iTcH/5dxA: folds
61sfw5QTu62YYIt68OsdrA: calls $5
OGgaARGdJQT4awWVNQ957w: folds
t+Id2O6herCLgwnC4m49PA: folds
OGgaARGdJQT4awWVNQ957w is sitting out
DOLzOcBTZYcph5jEfKFWuQ: calls $4
*** FLOP *** [2d 5d 6s]
OGgaARGdJQT4awWVNQ957w has returned
DOLzOcBTZYcph5jEfKFWuQ: checks
O5Go3jrzbQWxRB6ESK+Ptg: bets $8
61sfw5QTu62YYIt68OsdrA: calls $8
DOLzOcBTZYcph5jEfKFWuQ: calls $8
*** TURN *** [2d 5d 6s] [Ks]
DOLzOcBTZYcph5jEfKFWuQ: checks
O5Go3jrzbQWxRB6ESK+Ptg: checks
61sfw5QTu62YYIt68OsdrA: checks
*** RIVER *** [2d 5d 6s Ks] [Td]
DOLzOcBTZYcph5jEfKFWuQ: checks
O5Go3jrzbQWxRB6ESK+Ptg: checks
61sfw5QTu62YYIt68OsdrA: checks
*** SHOW DOWN ***
DOLzOcBTZYcph5jEfKFWuQ: shows [Jh Js] (a pair of Jacks)
O5Go3jrzbQWxRB6ESK+Ptg: mucks hand
61sfw5QTu62YYIt68OsdrA: shows [Qh Qd] (a pair of Queens)
61sfw5QTu62YYIt68OsdrA collected $37.60 from pot
*** SUMMARY ***
Total pot $39.50 | Rake $1.90
Board [2d 5d 6s Ks Td]
Seat 1: OGgaARGdJQT4awWVNQ957w (button) folded before Flop (didn't bet)
Seat 2: t+Id2O6herCLgwnC4m49PA (small blind) folded before Flop
Seat 3: DOLzOcBTZYcph5jEfKFWuQ (big blind) showed [Jh Js] and lost with a pair of Jacks
Seat 4: O5Go3jrzbQWxRB6ESK+Ptg mucked
Seat 5: mMc/PBpqlN24gdi3C/1tOw folded before Flop (didn't bet)
Seat 6: V138SURkdX8LdVBPKdJJag folded before Flop (didn't bet)
Seat 7: 1862487932 folded before Flop (didn't bet)
Seat 8: bLbSOSmSOnqE0iTcH/5dxA folded before Flop (didn't bet)
Seat 9: 61sfw5QTu62YYIt68OsdrA showed [Qh Qd] and won ($37.60) with a pair of Queens



PokerStars Game #59941464928:  Hold'em No Limit ($0.50/$1.00) - 2009/07/01 1:36:18 ET
Table 'vs/5jr6ciwjVQ5+Soc+u2A' 6-max Seat #2 is the button
Seat 1: J798qwLuvXyq0BbzsIjOrA ($185.55 in chips)
Seat 2: lXX4W7m3u++JiSOZ46yVMQ ($95.50 in chips)
Seat 4: 0smcry9L0OOTCP+KzIS5SA ($99 in chips)
Seat 5: +Nt3OPk3XR9SKjZgm2CexQ ($160.85 in chips)
Seat 6: Z2fXsGcjl+Eax+RzOgwOmg ($103 in chips)
Ws/3Uo3rQIk8hLgW0P+2xA will be allowed to play after the button
0smcry9L0OOTCP+KzIS5SA: posts small blind $0.50
+Nt3OPk3XR9SKjZgm2CexQ: posts big blind $1
*** HOLE CARDS ***
Z2fXsGcjl+Eax+RzOgwOmg: raises $3 to $4
J798qwLuvXyq0BbzsIjOrA: folds
lXX4W7m3u++JiSOZ46yVMQ: folds
0smcry9L0OOTCP+KzIS5SA: folds
+Nt3OPk3XR9SKjZgm2CexQ: folds
Z2fXsGcjl+Eax+RzOgwOmg collected $2.50 from pot
Z2fXsGcjl+Eax+RzOgwOmg: doesn't show hand
*** SUMMARY ***
Total pot $2.50 | Rake $0
Seat 1: J798qwLuvXyq0BbzsIjOrA folded before Flop (didn't bet)
Seat 2: lXX4W7m3u++JiSOZ46yVMQ (button) folded before Flop (didn't bet)
Seat 4: 0smcry9L0OOTCP+KzIS5SA (small blind) folded before Flop
Seat 5: +Nt3OPk3XR9SKjZgm2CexQ (big blind) folded before Flop
Seat 6: Z2fXsGcjl+Eax+RzOgwOmg collected ($2.50)



PokerStars Game #59941465570:  Hold'em No Limit ($0.50/$1.00) - 2009/07/01 1:36:19 ET
Table 'ZFWj23PMihdwrNWv41OG/QtyUh+jyNvrceIQdKMJjQ2weat #5 is the button
Seat 1: j3hj7KQwBVU5NTFmtYomSw ($73.35 in chips)
Seat 2: 0smcry9L0OOTCP+KzIS5SA ($98.50 in chips)
Seat 3: cWwhvq/+r/w8nkhwrJoekQ ($45.85 in chips)
Seat 4: O5ZesE/6mHyuWWbvkiH/Fg ($40.85 in chips)
Seat 5: j7NIOHLZk7V2o9fOioO5ug ($100 in chips)
Seat 6: u23r4AyKPgHioZ6t7z6qrA ($69 in chips)
u23r4AyKPgHioZ6t7z6qrA: posts small blind $0.50
j3hj7KQwBVU5NTFmtYomSw: posts big blind $1
*** HOLE CARDS ***
j3hj7KQwBVU5NTFmtYomSw said, "thx"
0smcry9L0OOTCP+KzIS5SA: folds
cWwhvq/+r/w8nkhwrJoekQ: calls $1
O5ZesE/6mHyuWWbvkiH/Fg: folds
j7NIOHLZk7V2o9fOioO5ug: folds
u23r4AyKPgHioZ6t7z6qrA: calls $0.50
j3hj7KQwBVU5NTFmtYomSw: checks
*** FLOP *** [3d 8c 8d]
u23r4AyKPgHioZ6t7z6qrA: checks
j3hj7KQwBVU5NTFmtYomSw: checks
cWwhvq/+r/w8nkhwrJoekQ: checks
*** TURN *** [3d 8c 8d] [Jc]
u23r4AyKPgHioZ6t7z6qrA: checks
j3hj7KQwBVU5NTFmtYomSw: checks
cWwhvq/+r/w8nkhwrJoekQ: bets $4
u23r4AyKPgHioZ6t7z6qrA: folds
j3hj7KQwBVU5NTFmtYomSw: folds
cWwhvq/+r/w8nkhwrJoekQ collected $2.85 from pot
*** SUMMARY ***
Total pot $3 | Rake $0.15
Board [3d 8c 8d Jc]
Seat 1: j3hj7KQwBVU5NTFmtYomSw (big blind) folded on the Turn
Seat 2: 0smcry9L0OOTCP+KzIS5SA folded before Flop (didn't bet)
Seat 3: cWwhvq/+r/w8nkhwrJoekQ collected ($2.85)
Seat 4: O5ZesE/6mHyuWWbvkiH/Fg folded before Flop (didn't bet)
Seat 5: j7NIOHLZk7V2o9fOioO5ug (button) folded before Flop (didn't bet)
Seat 6: u23r4AyKPgHioZ6t7z6qrA (small blind) folded on the Turn



PokerStars Game #59941465858:  Hold'em No Limit ($0.50/$1.00) - 2009/07/01 1:36:20 ET
Table '7Nl0ffnjeK44/vmeexh3MQ' 9-max Seat #6 is the button
Seat 1: V138SURkdX8LdVBPKdJJag ($101.50 in chips)
Seat 2: OGgaARGdJQT4awWVNQ957w ($100 in chips)
Seat 3: JMmUYT5pIKCKh2pGjCB/4w ($58.40 in chips)
Seat 4: bLbSOSmSOnqE0iTcH/5dxA ($106.80 in chips)
Seat 5: 61sfw5QTu62YYIt68OsdrA ($77.55 in chips)
Seat 6: FVs16t7GgfWgQWt4JxsObQ ($28.45 in chips)
Seat 7: 997ViqAtWn1FPjJqcffwcA ($100 in chips)
Seat 8: HRJJZiSxFAehJGaET63dlA ($50 in chips)
Seat 9: /JHoNdt0fK6X+isrqRfV3w ($20 in chips)
997ViqAtWn1FPjJqcffwcA: posts small blind $0.50
HRJJZiSxFAehJGaET63dlA: posts big blind $1
*** HOLE CARDS ***
/JHoNdt0fK6X+isrqRfV3w: folds
V138SURkdX8LdVBPKdJJag: folds
OGgaARGdJQT4awWVNQ957w: folds
JMmUYT5pIKCKh2pGjCB/4w: folds
bLbSOSmSOnqE0iTcH/5dxA: folds
61sfw5QTu62YYIt68OsdrA: folds
FVs16t7GgfWgQWt4JxsObQ: calls $1
997ViqAtWn1FPjJqcffwcA: folds
HRJJZiSxFAehJGaET63dlA: raises $1.25 to $2.25
FVs16t7GgfWgQWt4JxsObQ: calls $1.25
*** FLOP *** [Kc Jc 3h]
HRJJZiSxFAehJGaET63dlA: bets $2.50
FVs16t7GgfWgQWt4JxsObQ: calls $2.50
*** TURN *** [Kc Jc 3h] [9s]
HRJJZiSxFAehJGaET63dlA: checks
FVs16t7GgfWgQWt4JxsObQ: bets $4
OGgaARGdJQT4awWVNQ957w is sitting out
HRJJZiSxFAehJGaET63dlA: folds
FVs16t7GgfWgQWt4JxsObQ collected $9.55 from pot
*** SUMMARY ***
Total pot $10 | Rake $0.45
Board [Kc Jc 3h 9s]
Seat 1: V138SURkdX8LdVBPKdJJag folded before Flop (didn't bet)
Seat 2: OGgaARGdJQT4awWVNQ957w folded before Flop (didn't bet)
Seat 3: JMmUYT5pIKCKh2pGjCB/4w folded before Flop (didn't bet)
Seat 4: bLbSOSmSOnqE0iTcH/5dxA folded before Flop (didn't bet)
Seat 5: 61sfw5QTu62YYIt68OsdrA folded before Flop (didn't bet)
Seat 6: FVs16t7GgfWgQWt4JxsObQ (button) collected ($9.55)
Seat 7: 997ViqAtWn1FPjJqcffwcA (small blind) folded before Flop
Seat 8: HRJJZiSxFAehJGaET63dlA (big blind) folded on the Turn
Seat 9: /JHoNdt0fK6X+isrqRfV3w folded before Flop (didn't bet)



PokerStars Game #59941466530:  Hold'em No Limit ($0.50/$1.00) - 2009/07/01 1:36:21 ET
Table 'qj0HBN4HhQKogreu1bg7xg' 2-max Seat #2 is the button
Seat 1: NYi6JFscYNrofSXy4sM+Yw ($112.70 in chips)
Seat 2: qtyl8CSb0/4yWdbuEPJejA ($166.80 in chips)
qtyl8CSb0/4yWdbuEPJejA: posts small blind $0.50
NYi6JFscYNrofSXy4sM+Yw: posts big blind $1
*** HOLE CARDS ***
qtyl8CSb0/4yWdbuEPJejA: raises $2 to $3
NYi6JFscYNrofSXy4sM+Yw: calls $2
*** FLOP *** [4h Ts Jh]
NYi6JFscYNrofSXy4sM+Yw: checks
qtyl8CSb0/4yWdbuEPJejA: checks
*** TURN *** [4h Ts Jh] [Tc]
NYi6JFscYNrofSXy4sM+Yw: checks
qtyl8CSb0/4yWdbuEPJejA: checks
*** RIVER *** [4h Ts Jh Tc] [8c]
NYi6JFscYNrofSXy4sM+Yw: checks
qtyl8CSb0/4yWdbuEPJejA: bets $3
NYi6JFscYNrofSXy4sM+Yw: calls $3
*** SHOW DOWN ***
qtyl8CSb0/4yWdbuEPJejA: shows [8d Kc] (two pair, Tens and Eights)
NYi6JFscYNrofSXy4sM+Yw: mucks hand
qtyl8CSb0/4yWdbuEPJejA collected $11.50 from pot
*** SUMMARY ***
Total pot $12 | Rake $0.50
Board [4h Ts Jh Tc 8c]
Seat 1: NYi6JFscYNrofSXy4sM+Yw (big blind) mucked
Seat 2: qtyl8CSb0/4yWdbuEPJejA (button) (small blind) showed [8d Kc] and won ($11.50) with two pair, Tens and Eights



PokerStars Game #59941466632:  Hold'em No Limit ($0.50/$1.00) - 2009/07/01 1:36:21 ET
Table 'mmbQQVBTrPdE+wy+s+9VPA' 6-max Seat #3 is the button
Seat 1: zyP4SPoWZnKUfTvIRLCVog ($70.65 in chips)
Seat 2: XK4Qsl+DA8gAJyg85/zBIw ($26.60 in chips)
Seat 3: wx3sQGkVi2x9wJXuWNHPBw ($254.10 in chips)
Seat 4: V3iZdcw61nXF3g5hD2RrsQ ($104.05 in chips)
Seat 5: YMJG+F++3Aj6P8dAWda5fw ($116.90 in chips)
V3iZdcw61nXF3g5hD2RrsQ: posts small blind $0.50
YMJG+F++3Aj6P8dAWda5fw: posts big blind $1
UOHYuj23MyK9R8ciY2t6FA: sits out
*** HOLE CARDS ***
zyP4SPoWZnKUfTvIRLCVog: folds
XK4Qsl+DA8gAJyg85/zBIw: folds
wx3sQGkVi2x9wJXuWNHPBw: raises $3 to $4
V3iZdcw61nXF3g5hD2RrsQ: calls $3.50
YMJG+F++3Aj6P8dAWda5fw: raises $11 to $15
wx3sQGkVi2x9wJXuWNHPBw: calls $11
V3iZdcw61nXF3g5hD2RrsQ: folds
*** FLOP *** [As Kd 2h]
YMJG+F++3Aj6P8dAWda5fw: bets $23
wx3sQGkVi2x9wJXuWNHPBw: folds
YMJG+F++3Aj6P8dAWda5fw collected $32.30 from pot
*** SUMMARY ***
Total pot $34 | Rake $1.70
Board [As Kd 2h]
Seat 1: zyP4SPoWZnKUfTvIRLCVog folded before Flop (didn't bet)
Seat 2: XK4Qsl+DA8gAJyg85/zBIw folded before Flop (didn't bet)
Seat 3: wx3sQGkVi2x9wJXuWNHPBw (button) folded on the Flop
Seat 4: V3iZdcw61nXF3g5hD2RrsQ (small blind) folded before Flop
Seat 5: YMJG+F++3Aj6P8dAWda5fw (big blind) collected ($32.30)



PokerStars Game #59941467004:  Hold'em No Limit ($0.50/$1.00) - 2009/07/01 1:36:22 ET
Table 'b8oW/dOL7fDza5DfZ/dOJQ' 6-max Seat #1 is the button
Seat 1: NakujTNjHFgzceydFf+E2Q ($98 in chips)
Seat 2: TSuRyAHnUPCFjP7Z0rEE0w ($119.50 in chips)
Seat 3: d8WX+9nUHoqlrAGagO0Wow ($32.80 in chips)
Seat 5: r4lpoh2BJZ8S6zyQv1JeSw ($101 in chips)
Seat 6: PvfYaKbzMpsmUcbOExckbQ ($110.60 in chips)
TSuRyAHnUPCFjP7Z0rEE0w: posts small blind $0.50
d8WX+9nUHoqlrAGagO0Wow: posts big blind $1
8rDbzImSi1zgxtqtF1pSbA: sits out
*** HOLE CARDS ***
r4lpoh2BJZ8S6zyQv1JeSw: folds
PvfYaKbzMpsmUcbOExckbQ: folds
NakujTNjHFgzceydFf+E2Q: folds
TSuRyAHnUPCFjP7Z0rEE0w: folds
d8WX+9nUHoqlrAGagO0Wow collected $1 from pot
*** SUMMARY ***
Total pot $1 | Rake $0
Seat 1: NakujTNjHFgzceydFf+E2Q (button) folded before Flop (didn't bet)
Seat 2: TSuRyAHnUPCFjP7Z0rEE0w (small blind) folded before Flop
Seat 3: d8WX+9nUHoqlrAGagO0Wow (big blind) collected ($1)
Seat 5: r4lpoh2BJZ8S6zyQv1JeSw folded before Flop (didn't bet)
Seat 6: PvfYaKbzMpsmUcbOExckbQ folded before Flop (didn't bet)



PokerStars Game #59941467342:  Hold'em No Limit ($0.50/$1.00) - 2009/07/01 1:36:22 ET
Table 'blHlQApStil0OPeQxQxPcw' 9-max Seat #2 is the button
Seat 1: Pp/KTcXkfZKKUHkjyaLTdg ($24.10 in chips)
Seat 2: V138SURkdX8LdVBPKdJJag ($122.85 in chips)
Seat 3: OGgaARGdJQT4awWVNQ957w ($100 in chips)
Seat 4: 1862487932 ($100 in chips)
Seat 5: uXrDE6JrIi8BZK1L8oQ9bQ ($50.10 in chips)
Seat 6: vljeiOoWscAIXU0fCuiEBw ($37.70 in chips)
Seat 8: laA8va+Yv8WuMqT1zdR91g ($100 in chips)
Seat 9: 6XkTu4ahxzHnvjjc1R8YjQ ($155.35 in chips)
OGgaARGdJQT4awWVNQ957w: posts small blind $0.50
1862487932: posts big blind $1
VPF+HjszMvUIpy0CHIwH3A: sits out
*** HOLE CARDS ***
uXrDE6JrIi8BZK1L8oQ9bQ: folds
vljeiOoWscAIXU0fCuiEBw: calls $1
laA8va+Yv8WuMqT1zdR91g: folds
6XkTu4ahxzHnvjjc1R8YjQ: folds
Pp/KTcXkfZKKUHkjyaLTdg: folds
V138SURkdX8LdVBPKdJJag: folds
OGgaARGdJQT4awWVNQ957w: folds
1862487932: checks
*** FLOP *** [Kd 6c Js]
1862487932: checks
vljeiOoWscAIXU0fCuiEBw: checks
*** TURN *** [Kd 6c Js] [Tc]
1862487932: checks
vljeiOoWscAIXU0fCuiEBw: bets $1
1862487932: folds
vljeiOoWscAIXU0fCuiEBw collected $2.40 from pot
*** SUMMARY ***
Total pot $2.50 | Rake $0.10
Board [Kd 6c Js Tc]
Seat 1: Pp/KTcXkfZKKUHkjyaLTdg folded before Flop (didn't bet)
Seat 2: V138SURkdX8LdVBPKdJJag (button) folded before Flop (didn't bet)
Seat 3: OGgaARGdJQT4awWVNQ957w (small blind) folded before Flop
Seat 4: 1862487932 (big blind) folded on the Turn
Seat 5: uXrDE6JrIi8BZK1L8oQ9bQ folded before Flop (didn't bet)
Seat 6: vljeiOoWscAIXU0fCuiEBw collected ($2.40)
Seat 8: laA8va+Yv8WuMqT1zdR91g folded before Flop (didn't bet)
Seat 9: 6XkTu4ahxzHnvjjc1R8YjQ folded before Flop (didn't bet)



PokerStars Game #59941467246:  Hold'em No Limit ($0.50/$1.00) - 2009/07/01 1:36:22 ET
Table 'NqGO/cV3MwFAx+ZPB5ANmQ' 2-max Seat #2 is the button
Seat 1: ItaRAnHOgvYOv5ynbG1iTw ($236.70 in chips)
Seat 2: GtFB+yyeb2djMdPFuOW/Xg ($100.50 in chips)
GtFB+yyeb2djMdPFuOW/Xg: posts small blind $0.50
ItaRAnHOgvYOv5ynbG1iTw: posts big blind $1
*** HOLE CARDS ***
GtFB+yyeb2djMdPFuOW/Xg: folds
ItaRAnHOgvYOv5ynbG1iTw collected $1 from pot
*** SUMMARY ***
Total pot $1 | Rake $0
Seat 1: ItaRAnHOgvYOv5ynbG1iTw (big blind) collected ($1)
Seat 2: GtFB+yyeb2djMdPFuOW/Xg (button) (small blind) folded before Flop



PokerStars Game #59941467212:  Hold'em No Limit ($0.50/$1.00) - 2009/07/01 1:36:22 ET
Table 'pHrhryH8jPNdQfY62f8v+g' 6-max Seat #6 is the button
Seat 1: 4d1rWhpu8DzLmzMbR3QKyA ($146.45 in chips)
Seat 2: JwCcjZl0bjJzG7hmE0dnTA ($116.05 in chips)
Seat 3: 8oS5O7iD/qnFXFXJrGIgNQ ($110.80 in chips)
Seat 4: 1f3beyIML24UqEMTbWy93g ($55.70 in chips)
Seat 5: d8WX+9nUHoqlrAGagO0Wow ($24.15 in chips)
Seat 6: xAU6q2/cwmby2sxmA8VcmA ($175.25 in chips)
4d1rWhpu8DzLmzMbR3QKyA: posts small blind $0.50
JwCcjZl0bjJzG7hmE0dnTA: posts big blind $1
*** HOLE CARDS ***
8oS5O7iD/qnFXFXJrGIgNQ: folds
1f3beyIML24UqEMTbWy93g: folds
d8WX+9nUHoqlrAGagO0Wow: folds
xAU6q2/cwmby2sxmA8VcmA: folds
4d1rWhpu8DzLmzMbR3QKyA: raises $3 to $4
JwCcjZl0bjJzG7hmE0dnTA: folds
4d1rWhpu8DzLmzMbR3QKyA collected $2 from pot
*** SUMMARY ***
Total pot $2 | Rake $0
Seat 1: 4d1rWhpu8DzLmzMbR3QKyA (small blind) collected ($2)
Seat 2: JwCcjZl0bjJzG7hmE0dnTA (big blind) folded before Flop
Seat 3: 8oS5O7iD/qnFXFXJrGIgNQ folded before Flop (didn't bet)
Seat 4: 1f3beyIML24UqEMTbWy93g folded before Flop (didn't bet)
Seat 5: d8WX+9nUHoqlrAGagO0Wow folded before Flop (didn't bet)
Seat 6: xAU6q2/cwmby2sxmA8VcmA (button) folded before Flop (didn't bet)



PokerStars Game #59941468372:  Hold'em No Limit ($0.50/$1.00) - 2009/07/01 1:36:24 ET
Table 'O96CPOtvMBWP6kzuYDfdFA' 6-max Seat #6 is the button
Seat 1: 6alLXQIITA2EZ/lBeym8Dw ($127.25 in chips)
Seat 2: 4d1rWhpu8DzLmzMbR3QKyA ($101.50 in chips)
Seat 4: /P4w1pHg2zHYg/4ubJ0dPw ($70.75 in chips)
Seat 5: vX+iYAEINFeLxwMla7DY1Q ($98.50 in chips)
Seat 6: 3syOXva630dm1FTdwnuLpw ($75.15 in chips)
6alLXQIITA2EZ/lBeym8Dw: posts small blind $0.50
4d1rWhpu8DzLmzMbR3QKyA: posts big blind $1
*** HOLE CARDS ***
/P4w1pHg2zHYg/4ubJ0dPw: folds
vX+iYAEINFeLxwMla7DY1Q: folds
3syOXva630dm1FTdwnuLpw: folds
6alLXQIITA2EZ/lBeym8Dw: raises $2 to $3
4d1rWhpu8DzLmzMbR3QKyA: folds
6alLXQIITA2EZ/lBeym8Dw collected $2 from pot
*** SUMMARY ***
Total pot $2 | Rake $0
Seat 1: 6alLXQIITA2EZ/lBeym8Dw (small blind) collected ($2)
Seat 2: 4d1rWhpu8DzLmzMbR3QKyA (big blind) folded before Flop
Seat 4: /P4w1pHg2zHYg/4ubJ0dPw folded before Flop (didn't bet)
Seat 5: vX+iYAEINFeLxwMla7DY1Q folded before Flop (didn't bet)
Seat 6: 3syOXva630dm1FTdwnuLpw (button) folded before Flop (didn't bet)



PokerStars Game #59941468606:  Hold'em No Limit ($0.50/$1.00) - 2009/07/01 1:36:25 ET
Table 'tHb+N6GaPEmmBAe36B2R9Q' 2-max Seat #1 is the button
Seat 1: rL+Zpv4/vX2BVHcyfh/NXA ($100 in chips)
Seat 2: Pm1sDZZi0zFtnFGXLznkug ($133.30 in chips)
rL+Zpv4/vX2BVHcyfh/NXA: posts small blind $0.50
Pm1sDZZi0zFtnFGXLznkug: posts big blind $1
*** HOLE CARDS ***
rL+Zpv4/vX2BVHcyfh/NXA: raises $2 to $3
Pm1sDZZi0zFtnFGXLznkug: folds
rL+Zpv4/vX2BVHcyfh/NXA collected $2 from pot
rL+Zpv4/vX2BVHcyfh/NXA: doesn't show hand
*** SUMMARY ***
Total pot $2 | Rake $0
Seat 1: rL+Zpv4/vX2BVHcyfh/NXA (button) (small blind) collected ($2)
Seat 2: Pm1sDZZi0zFtnFGXLznkug (big blind) folded before Flop



PokerStars Game #59941470136:  Hold'em No Limit ($0.50/$1.00) - 2009/07/01 1:36:27 ET
Table 'rmZfTK+oSebeUPJNbWhdAA' 6-max Seat #3 is the button
Seat 1: xAU6q2/cwmby2sxmA8VcmA ($131.50 in chips)
Seat 2: z7O9PO/WEcqRouIydFhS9Q ($188 in chips)
Seat 3: BCEV3COoKY607AzLWayfRA ($195.30 in chips)
Seat 4: 1/mIuXfgx1ZyVkodrmfQDw ($172.65 in chips)
Seat 5: BWhgxe7gWiYobRbwdG+d2Q ($100 in chips)
Seat 6: j7NIOHLZk7V2o9fOioO5ug ($100 in chips)
1/mIuXfgx1ZyVkodrmfQDw: posts small blind $0.50
BWhgxe7gWiYobRbwdG+d2Q: posts big blind $1
*** HOLE CARDS ***
j7NIOHLZk7V2o9fOioO5ug: folds
xAU6q2/cwmby2sxmA8VcmA: folds
z7O9PO/WEcqRouIydFhS9Q: folds
BCEV3COoKY607AzLWayfRA: folds
1/mIuXfgx1ZyVkodrmfQDw: folds
BWhgxe7gWiYobRbwdG+d2Q collected $1 from pot
BWhgxe7gWiYobRbwdG+d2Q: doesn't show hand
*** SUMMARY ***
Total pot $1 | Rake $0
Seat 1: xAU6q2/cwmby2sxmA8VcmA folded before Flop (didn't bet)
Seat 2: z7O9PO/WEcqRouIydFhS9Q folded before Flop (didn't bet)
Seat 3: BCEV3COoKY607AzLWayfRA (button) folded before Flop (didn't bet)
Seat 4: 1/mIuXfgx1ZyVkodrmfQDw (small blind) folded before Flop
Seat 5: BWhgxe7gWiYobRbwdG+d2Q (big blind) collected ($1)
Seat 6: j7NIOHLZk7V2o9fOioO5ug folded before Flop (didn't bet)



PokerStars Game #59941470562:  Hold'em No Limit ($0.50/$1.00) - 2009/07/01 1:36:28 ET
Table 'N2bNCDHL96aCQDvZIh+yQQ' 6-max Seat #3 is the button
Seat 1: Jjgflx10PVjcLkziEmLhSA ($77.35 in chips)
Seat 2: y27w5IK2WXqmYzS8OU0wKA ($121.05 in chips)
Seat 3: UBZQqpnJZdTYYY1FTb0rLA ($120.55 in chips)
Seat 4: uCqEjnxh2/vFBjKYkfTOkw ($189.80 in chips)
Seat 5: frvgHLr3+LfZtjsBCBs3NA ($16.60 in chips)
Seat 6: idVgoPAdspFPCzee6aF9Pg ($101.50 in chips)
uCqEjnxh2/vFBjKYkfTOkw: posts small blind $0.50
frvgHLr3+LfZtjsBCBs3NA: posts big blind $1
*** HOLE CARDS ***
idVgoPAdspFPCzee6aF9Pg: folds
Jjgflx10PVjcLkziEmLhSA: folds
y27w5IK2WXqmYzS8OU0wKA: folds
UBZQqpnJZdTYYY1FTb0rLA: raises $2 to $3
uCqEjnxh2/vFBjKYkfTOkw: folds
frvgHLr3+LfZtjsBCBs3NA: folds
UBZQqpnJZdTYYY1FTb0rLA collected $2.50 from pot
UBZQqpnJZdTYYY1FTb0rLA: doesn't show hand
*** SUMMARY ***
Total pot $2.50 | Rake $0
Seat 1: Jjgflx10PVjcLkziEmLhSA folded before Flop (didn't bet)
Seat 2: y27w5IK2WXqmYzS8OU0wKA folded before Flop (didn't bet)
Seat 3: UBZQqpnJZdTYYY1FTb0rLA (button) collected ($2.50)
Seat 4: uCqEjnxh2/vFBjKYkfTOkw (small blind) folded before Flop
Seat 5: frvgHLr3+LfZtjsBCBs3NA (big blind) folded before Flop
Seat 6: idVgoPAdspFPCzee6aF9Pg folded before Flop (didn't bet)



PokerStars Game #59941470422:  Hold'em No Limit ($0.50/$1.00) - 2009/07/01 1:36:28 ET
Table 'gxFK0BVUD7cupu2uyRUZJg' 6-max Seat #2 is the button
Seat 1: M+X3uChmP6R63IwijVjgTg ($244.90 in chips)
Seat 2: hpxXcmRkXXI9HE5+5/j/0Q ($131.55 in chips)
Seat 3: Z2fXsGcjl+Eax+RzOgwOmg ($100 in chips)
Seat 4: Hcr4S4Nbkj5idKsvYK/eqQ ($100 in chips)
Seat 6: dYyb6/42PMC8aNFlm/eBeQ ($128.90 in chips)
Z2fXsGcjl+Eax+RzOgwOmg: posts small blind $0.50
Hcr4S4Nbkj5idKsvYK/eqQ: posts big blind $1
0smcry9L0OOTCP+KzIS5SA: sits out
*** HOLE CARDS ***
dYyb6/42PMC8aNFlm/eBeQ: folds
M+X3uChmP6R63IwijVjgTg: folds
hpxXcmRkXXI9HE5+5/j/0Q: folds
Z2fXsGcjl+Eax+RzOgwOmg: folds
Hcr4S4Nbkj5idKsvYK/eqQ collected $1 from pot
*** SUMMARY ***
Total pot $1 | Rake $0
Seat 1: M+X3uChmP6R63IwijVjgTg folded before Flop (didn't bet)
Seat 2: hpxXcmRkXXI9HE5+5/j/0Q (button) folded before Flop (didn't bet)
Seat 3: Z2fXsGcjl+Eax+RzOgwOmg (small blind) folded before Flop
Seat 4: Hcr4S4Nbkj5idKsvYK/eqQ (big blind) collected ($1)
Seat 6: dYyb6/42PMC8aNFlm/eBeQ folded before Flop (didn't bet)



PokerStars Game #59941470810:  Hold'em No Limit ($0.50/$1.00) - 2009/07/01 1:36:29 ET
Table 'NqGO/cV3MwFAx+ZPB5ANmQ' 2-max Seat #1 is the button
Seat 1: ItaRAnHOgvYOv5ynbG1iTw ($237.20 in chips)
Seat 2: GtFB+yyeb2djMdPFuOW/Xg ($100 in chips)
ItaRAnHOgvYOv5ynbG1iTw: posts small blind $0.50
GtFB+yyeb2djMdPFuOW/Xg: posts big blind $1
*** HOLE CARDS ***
ItaRAnHOgvYOv5ynbG1iTw: raises $2 to $3
GtFB+yyeb2djMdPFuOW/Xg: folds
ItaRAnHOgvYOv5ynbG1iTw collected $2 from pot
*** SUMMARY ***
Total pot $2 | Rake $0
Seat 1: ItaRAnHOgvYOv5ynbG1iTw (button) (small blind) collected ($2)
Seat 2: GtFB+yyeb2djMdPFuOW/Xg (big blind) folded before Flop



PokerStars Game #59941472596:  Hold'em No Limit ($0.50/$1.00) - 2009/07/01 1:36:32 ET
Table 'N6LvHFrb+cdXY/COI6ByOw' 2-max Seat #1 is the button
Seat 1: lXX4W7m3u++JiSOZ46yVMQ ($91.50 in chips)
Seat 2: 9mAoSP3o/mikSZOW2LEEAw ($180.20 in chips)
lXX4W7m3u++JiSOZ46yVMQ: posts small blind $0.50
9mAoSP3o/mikSZOW2LEEAw: posts big blind $1
*** HOLE CARDS ***
lXX4W7m3u++JiSOZ46yVMQ: folds
9mAoSP3o/mikSZOW2LEEAw collected $1 from pot
*** SUMMARY ***
Total pot $1 | Rake $0
Seat 1: lXX4W7m3u++JiSOZ46yVMQ (button) (small blind) folded before Flop
Seat 2: 9mAoSP3o/mikSZOW2LEEAw (big blind) collected ($1)



PokerStars Game #59941473038:  Hold'em No Limit ($0.50/$1.00) - 2009/07/01 1:36:33 ET
Table 'fZjVbKj9D8yOB+Rj7NaP/A' 9-max Seat #5 is the button
Seat 1: 9BZCcac3+McErkkSN2YScA ($103.15 in chips)
Seat 2: PTAFYDIUSsG+SArbxNl+Aw ($104 in chips)
Seat 3: yAbu2QsRPVcjPbqlf/jDxw ($103.65 in chips)
Seat 4: 997ViqAtWn1FPjJqcffwcA ($100 in chips)
Seat 5: PkGfq5xrSlNsujKaG/HF4Q ($100 in chips)
Seat 6: OvwYHV65yUbgdBjSmo1+5g ($139.45 in chips)
Seat 7: SyS20PAm3RpT6uLBsGkwOA ($77 in chips)
Seat 9: qheQay5YvP2DMAb3OUSxtw ($100.50 in chips)
OvwYHV65yUbgdBjSmo1+5g: posts small blind $0.50
SyS20PAm3RpT6uLBsGkwOA: posts big blind $1
EVvb0huXeMB7dnOAiO4ggA: sits out
*** HOLE CARDS ***
qheQay5YvP2DMAb3OUSxtw: folds
9BZCcac3+McErkkSN2YScA: folds
PTAFYDIUSsG+SArbxNl+Aw: folds
yAbu2QsRPVcjPbqlf/jDxw: folds
997ViqAtWn1FPjJqcffwcA: folds
PkGfq5xrSlNsujKaG/HF4Q: folds
OvwYHV65yUbgdBjSmo1+5g: calls $0.50
SyS20PAm3RpT6uLBsGkwOA: raises $4 to $5
OvwYHV65yUbgdBjSmo1+5g: folds
SyS20PAm3RpT6uLBsGkwOA collected $2 from pot
*** SUMMARY ***
Total pot $2 | Rake $0
Seat 1: 9BZCcac3+McErkkSN2YScA folded before Flop (didn't bet)
Seat 2: PTAFYDIUSsG+SArbxNl+Aw folded before Flop (didn't bet)
Seat 3: yAbu2QsRPVcjPbqlf/jDxw folded before Flop (didn't bet)
Seat 4: 997ViqAtWn1FPjJqcffwcA folded before Flop (didn't bet)
Seat 5: PkGfq5xrSlNsujKaG/HF4Q (button) folded before Flop (didn't bet)
Seat 6: OvwYHV65yUbgdBjSmo1+5g (small blind) folded before Flop
Seat 7: SyS20PAm3RpT6uLBsGkwOA (big blind) collected ($2)
Seat 9: qheQay5YvP2DMAb3OUSxtw folded before Flop (didn't bet)



PokerStars Game #59941473982:  Hold'em No Limit ($0.50/$1.00) - 2009/07/01 1:36:34 ET
Table 'CASNP0uy1C+jGLml/I4PtA' 9-max Seat #9 is the button
Seat 1: tkdBeXTJlFsZdioidNqLow ($72.60 in chips)
Seat 2: Ogn4JDV3mp4ZDKO49IFzKA ($20 in chips)
Seat 4: B/G0GJacqZ8K59/ZVdq4kQ ($22.05 in chips)
Seat 5: Jjc7EHWzs4//xUAjJ0UWoA ($12 in chips)
Seat 6: FJEywSpo5JbRKByzmweboA ($130.40 in chips)
Seat 7: S3Ex8K7v6xm5jqjRM7Fl3w ($20.50 in chips)
Seat 8: L9njYvloJ1NdXjP8edHEAg ($102.95 in chips)
Seat 9: Pp/KTcXkfZKKUHkjyaLTdg ($22.60 in chips)
tkdBeXTJlFsZdioidNqLow: posts small blind $0.50
Ogn4JDV3mp4ZDKO49IFzKA: posts big blind $1
*** HOLE CARDS ***
B/G0GJacqZ8K59/ZVdq4kQ: folds
Jjc7EHWzs4//xUAjJ0UWoA: folds
FJEywSpo5JbRKByzmweboA: folds
S3Ex8K7v6xm5jqjRM7Fl3w: folds
L9njYvloJ1NdXjP8edHEAg: folds
Pp/KTcXkfZKKUHkjyaLTdg: folds
tkdBeXTJlFsZdioidNqLow: raises $1 to $2
Ogn4JDV3mp4ZDKO49IFzKA: raises $18 to $20 and is all-in
tkdBeXTJlFsZdioidNqLow: folds
Ogn4JDV3mp4ZDKO49IFzKA collected $4 from pot
*** SUMMARY ***
Total pot $4 | Rake $0
Seat 1: tkdBeXTJlFsZdioidNqLow (small blind) folded before Flop
Seat 2: Ogn4JDV3mp4ZDKO49IFzKA (big blind) collected ($4)
Seat 4: B/G0GJacqZ8K59/ZVdq4kQ folded before Flop (didn't bet)
Seat 5: Jjc7EHWzs4//xUAjJ0UWoA folded before Flop (didn't bet)
Seat 6: FJEywSpo5JbRKByzmweboA folded before Flop (didn't bet)
Seat 7: S3Ex8K7v6xm5jqjRM7Fl3w folded before Flop (didn't bet)
Seat 8: L9njYvloJ1NdXjP8edHEAg folded before Flop (didn't bet)
Seat 9: Pp/KTcXkfZKKUHkjyaLTdg (button) folded before Flop (didn't bet)



PokerStars Game #59941473478:  Hold'em No Limit ($0.50/$1.00) - 2009/07/01 1:36:34 ET
Table 'tHb+N6GaPEmmBAe36B2R9Q' 2-max Seat #2 is the button
Seat 1: rL+Zpv4/vX2BVHcyfh/NXA ($101 in chips)
Seat 2: Pm1sDZZi0zFtnFGXLznkug ($132.30 in chips)
Pm1sDZZi0zFtnFGXLznkug: posts small blind $0.50
rL+Zpv4/vX2BVHcyfh/NXA: posts big blind $1
*** HOLE CARDS ***
Pm1sDZZi0zFtnFGXLznkug: raises $2 to $3
rL+Zpv4/vX2BVHcyfh/NXA: folds
Pm1sDZZi0zFtnFGXLznkug collected $2 from pot
Pm1sDZZi0zFtnFGXLznkug: doesn't show hand
*** SUMMARY ***
Total pot $2 | Rake $0
Seat 1: rL+Zpv4/vX2BVHcyfh/NXA (big blind) folded before Flop
Seat 2: Pm1sDZZi0zFtnFGXLznkug (button) (small blind) collected ($2)



PokerStars Game #59941473966:  Hold'em No Limit ($0.50/$1.00) - 2009/07/01 1:36:34 ET
Table 'vs/5jr6ciwjVQ5+Soc+u2A' 6-max Seat #4 is the button
Seat 1: J798qwLuvXyq0BbzsIjOrA ($185.55 in chips)
Seat 2: lXX4W7m3u++JiSOZ46yVMQ ($95.50 in chips)
Seat 3: Ws/3Uo3rQIk8hLgW0P+2xA ($100 in chips)
Seat 4: 0smcry9L0OOTCP+KzIS5SA ($98.50 in chips)
Seat 5: +Nt3OPk3XR9SKjZgm2CexQ ($159.85 in chips)
Seat 6: Z2fXsGcjl+Eax+RzOgwOmg ($104.50 in chips)
+Nt3OPk3XR9SKjZgm2CexQ: posts small blind $0.50
Z2fXsGcjl+Eax+RzOgwOmg: posts big blind $1
Ws/3Uo3rQIk8hLgW0P+2xA: posts big blind $1
*** HOLE CARDS ***
J798qwLuvXyq0BbzsIjOrA: folds
lXX4W7m3u++JiSOZ46yVMQ: folds
Ws/3Uo3rQIk8hLgW0P+2xA: checks
0smcry9L0OOTCP+KzIS5SA: raises $2.50 to $3.50
+Nt3OPk3XR9SKjZgm2CexQ: folds
Z2fXsGcjl+Eax+RzOgwOmg: folds
Ws/3Uo3rQIk8hLgW0P+2xA: folds
0smcry9L0OOTCP+KzIS5SA collected $3.50 from pot
0smcry9L0OOTCP+KzIS5SA: doesn't show hand
*** SUMMARY ***
Total pot $3.50 | Rake $0
Seat 1: J798qwLuvXyq0BbzsIjOrA folded before Flop (didn't bet)
Seat 2: lXX4W7m3u++JiSOZ46yVMQ folded before Flop (didn't bet)
Seat 3: Ws/3Uo3rQIk8hLgW0P+2xA folded before Flop
Seat 4: 0smcry9L0OOTCP+KzIS5SA (button) collected ($3.50)
Seat 5: +Nt3OPk3XR9SKjZgm2CexQ (small blind) folded before Flop
Seat 6: Z2fXsGcjl+Eax+RzOgwOmg (big blind) folded before Flop



PokerStars Game #59941473810:  Hold'em No Limit ($0.50/$1.00) - 2009/07/01 1:36:34 ET
Table 'MUPc8FEpe/nR0BKSeReX6Q' 6-max Seat #3 is the button
Seat 1: qhkK6+yCciTRd+rCFEbnEQ ($58.70 in chips)
Seat 2: xAU6q2/cwmby2sxmA8VcmA ($103.70 in chips)
Seat 3: wx3sQGkVi2x9wJXuWNHPBw ($287.65 in chips)
Seat 4: r4lpoh2BJZ8S6zyQv1JeSw ($109 in chips)
Seat 5: y27w5IK2WXqmYzS8OU0wKA ($103.05 in chips)
Seat 6: cl/QpVR/PLO58lj+C5mGLw ($52.20 in chips)
r4lpoh2BJZ8S6zyQv1JeSw: posts small blind $0.50
y27w5IK2WXqmYzS8OU0wKA: posts big blind $1
*** HOLE CARDS ***
cl/QpVR/PLO58lj+C5mGLw: calls $1
qhkK6+yCciTRd+rCFEbnEQ: folds
xAU6q2/cwmby2sxmA8VcmA: folds
wx3sQGkVi2x9wJXuWNHPBw: folds
r4lpoh2BJZ8S6zyQv1JeSw: folds
y27w5IK2WXqmYzS8OU0wKA: checks
*** FLOP *** [Qc Kh 7c]
y27w5IK2WXqmYzS8OU0wKA: bets $2
cl/QpVR/PLO58lj+C5mGLw: folds
y27w5IK2WXqmYzS8OU0wKA collected $2.40 from pot
y27w5IK2WXqmYzS8OU0wKA: doesn't show hand
*** SUMMARY ***
Total pot $2.50 | Rake $0.10
Board [Qc Kh 7c]
Seat 1: qhkK6+yCciTRd+rCFEbnEQ folded before Flop (didn't bet)
Seat 2: xAU6q2/cwmby2sxmA8VcmA folded before Flop (didn't bet)
Seat 3: wx3sQGkVi2x9wJXuWNHPBw (button) folded before Flop (didn't bet)
Seat 4: r4lpoh2BJZ8S6zyQv1JeSw (small blind) folded before Flop
Seat 5: y27w5IK2WXqmYzS8OU0wKA (big blind) collected ($2.40)
Seat 6: cl/QpVR/PLO58lj+C5mGLw folded on the Flop



PokerStars Game #59941473760:  Hold'em No Limit ($0.50/$1.00) - 2009/07/01 1:36:34 ET
Table 'VOs36P6NW+QyXeQ1B62kmAE9S5sEoK9Q3olj2a53gABASeat #6 is the button
Seat 1: 4h8XtuVJtWh3DJpxGo7k5Q ($19.45 in chips)
Seat 2: y27w5IK2WXqmYzS8OU0wKA ($148.65 in chips)
Seat 3: p00KmyZiD/isPc/lZwNBTg ($13 in chips)
Seat 4: ene3nLSnQ4N961iBaUsSmA ($100 in chips)
Seat 5: o3YLm/rSY916m/on1VjXPA ($126.35 in chips)
Seat 6: slVKuQyEz8Qj4E3uLPYNXg ($49.95 in chips)
4h8XtuVJtWh3DJpxGo7k5Q: posts small blind $0.50
y27w5IK2WXqmYzS8OU0wKA: posts big blind $1
*** HOLE CARDS ***
p00KmyZiD/isPc/lZwNBTg: folds
ene3nLSnQ4N961iBaUsSmA: folds
o3YLm/rSY916m/on1VjXPA: folds
slVKuQyEz8Qj4E3uLPYNXg: raises $2 to $3
4h8XtuVJtWh3DJpxGo7k5Q: calls $2.50
y27w5IK2WXqmYzS8OU0wKA: folds
*** FLOP *** [7d 8h Ac]
4h8XtuVJtWh3DJpxGo7k5Q: bets $1
slVKuQyEz8Qj4E3uLPYNXg: calls $1
*** TURN *** [7d 8h Ac] [4s]
4h8XtuVJtWh3DJpxGo7k5Q: bets $7
slVKuQyEz8Qj4E3uLPYNXg: folds
4h8XtuVJtWh3DJpxGo7k5Q collected $8.60 from pot
4h8XtuVJtWh3DJpxGo7k5Q: doesn't show hand
*** SUMMARY ***
Total pot $9 | Rake $0.40
Board [7d 8h Ac 4s]
Seat 1: 4h8XtuVJtWh3DJpxGo7k5Q (small blind) collected ($8.60)
Seat 2: y27w5IK2WXqmYzS8OU0wKA (big blind) folded before Flop
Seat 3: p00KmyZiD/isPc/lZwNBTg folded before Flop (didn't bet)
Seat 4: ene3nLSnQ4N961iBaUsSmA folded before Flop (didn't bet)
Seat 5: o3YLm/rSY916m/on1VjXPA folded before Flop (didn't bet)
Seat 6: slVKuQyEz8Qj4E3uLPYNXg (button) folded on the Turn



PokerStars Game #59941474180:  Hold'em No Limit ($0.50/$1.00) - 2009/07/01 1:36:35 ET
Table 'b8oW/dOL7fDza5DfZ/dOJQ' 6-max Seat #2 is the button
Seat 1: NakujTNjHFgzceydFf+E2Q ($98 in chips)
Seat 2: TSuRyAHnUPCFjP7Z0rEE0w ($119 in chips)
Seat 3: d8WX+9nUHoqlrAGagO0Wow ($33.30 in chips)
Seat 4: 8rDbzImSi1zgxtqtF1pSbA ($20 in chips)
Seat 5: r4lpoh2BJZ8S6zyQv1JeSw ($101 in chips)
Seat 6: PvfYaKbzMpsmUcbOExckbQ ($110.60 in chips)
d8WX+9nUHoqlrAGagO0Wow: posts small blind $0.50
8rDbzImSi1zgxtqtF1pSbA: posts big blind $1
*** HOLE CARDS ***
r4lpoh2BJZ8S6zyQv1JeSw: folds
PvfYaKbzMpsmUcbOExckbQ: folds
NakujTNjHFgzceydFf+E2Q: folds
TSuRyAHnUPCFjP7Z0rEE0w: folds
d8WX+9nUHoqlrAGagO0Wow: folds
8rDbzImSi1zgxtqtF1pSbA collected $1 from pot
8rDbzImSi1zgxtqtF1pSbA: doesn't show hand
*** SUMMARY ***
Total pot $1 | Rake $0
Seat 1: NakujTNjHFgzceydFf+E2Q folded before Flop (didn't bet)
Seat 2: TSuRyAHnUPCFjP7Z0rEE0w (button) folded before Flop (didn't bet)
Seat 3: d8WX+9nUHoqlrAGagO0Wow (small blind) folded before Flop
Seat 4: 8rDbzImSi1zgxtqtF1pSbA (big blind) collected ($1)
Seat 5: r4lpoh2BJZ8S6zyQv1JeSw folded before Flop (didn't bet)
Seat 6: PvfYaKbzMpsmUcbOExckbQ folded before Flop (didn't bet)



PokerStars Game #59941474476:  Hold'em No Limit ($0.50/$1.00) - 2009/07/01 1:36:35 ET
Table 'kS0cTQAEi+fdUlJP2gQYvw' 9-max Seat #4 is the button
Seat 1: SqsWPukL8kLqrhq5ZrQdSQ ($89 in chips)
Seat 2: +JautI/vSNALzwSvsOqbCQ ($78 in chips)
Seat 3: 2BV+oJIQYr65IO6nEChvbA ($62.55 in chips)
Seat 4: RUhhaALzha3TH1AkdakoGQ ($51 in chips)
Seat 5: 997ViqAtWn1FPjJqcffwcA ($100 in chips)
Seat 6: yAbu2QsRPVcjPbqlf/jDxw ($118.65 in chips)
Seat 7: Ffa7Nj4X5fddtROP01hfQg ($145.50 in chips)
Seat 8: vKyFzTyzfT7fZcdX+HHN+Q ($51.35 in chips)
Seat 9: OGgaARGdJQT4awWVNQ957w ($109.70 in chips)
997ViqAtWn1FPjJqcffwcA: posts small blind $0.50
yAbu2QsRPVcjPbqlf/jDxw: posts big blind $1
*** HOLE CARDS ***
Ffa7Nj4X5fddtROP01hfQg: raises $1 to $2
vKyFzTyzfT7fZcdX+HHN+Q: calls $2
Ffa7Nj4X5fddtROP01hfQg said, "he really wanted it"
vKyFzTyzfT7fZcdX+HHN+Q said, "u should ov called"
OGgaARGdJQT4awWVNQ957w: folds
OGgaARGdJQT4awWVNQ957w is sitting out
SqsWPukL8kLqrhq5ZrQdSQ: folds
+JautI/vSNALzwSvsOqbCQ: folds
2BV+oJIQYr65IO6nEChvbA: folds
OGgaARGdJQT4awWVNQ957w has returned
RUhhaALzha3TH1AkdakoGQ said, "lol,..."
RUhhaALzha3TH1AkdakoGQ: folds
997ViqAtWn1FPjJqcffwcA: calls $1.50
yAbu2QsRPVcjPbqlf/jDxw: folds
*** FLOP *** [Tc Kc 8h]
997ViqAtWn1FPjJqcffwcA: checks
Ffa7Nj4X5fddtROP01hfQg: bets $2
vKyFzTyzfT7fZcdX+HHN+Q: raises $2 to $4
997ViqAtWn1FPjJqcffwcA: folds
Ffa7Nj4X5fddtROP01hfQg: raises $4 to $8
vKyFzTyzfT7fZcdX+HHN+Q: raises $4 to $12
Ffa7Nj4X5fddtROP01hfQg: raises $131.50 to $143.50 and is all-in
vKyFzTyzfT7fZcdX+HHN+Q: calls $37.35 and is all-in
*** TURN *** [Tc Kc 8h] [5h]
*** RIVER *** [Tc Kc 8h 5h] [Ts]
*** SHOW DOWN ***
Ffa7Nj4X5fddtROP01hfQg: shows [Ad Kd] (two pair, Kings and Tens)
vKyFzTyzfT7fZcdX+HHN+Q: shows [Td 4d] (three of a kind, Tens)
vKyFzTyzfT7fZcdX+HHN+Q collected $102.70 from pot
*** SUMMARY ***
Total pot $105.70 | Rake $3
Board [Tc Kc 8h 5h Ts]
Seat 1: SqsWPukL8kLqrhq5ZrQdSQ folded before Flop (didn't bet)
Seat 2: +JautI/vSNALzwSvsOqbCQ folded before Flop (didn't bet)
Seat 3: 2BV+oJIQYr65IO6nEChvbA folded before Flop (didn't bet)
Seat 4: RUhhaALzha3TH1AkdakoGQ (button) folded before Flop (didn't bet)
Seat 5: 997ViqAtWn1FPjJqcffwcA (small blind) folded on the Flop
Seat 6: yAbu2QsRPVcjPbqlf/jDxw (big blind) folded before Flop
Seat 7: Ffa7Nj4X5fddtROP01hfQg showed [Ad Kd] and lost with two pair, Kings and Tens
Seat 8: vKyFzTyzfT7fZcdX+HHN+Q showed [Td 4d] and won ($102.70) with three of a kind, Tens
Seat 9: OGgaARGdJQT4awWVNQ957w folded before Flop (didn't bet)



PokerStars Game #59941475240:  Hold'em No Limit ($0.50/$1.00) - 2009/07/01 1:36:37 ET
Table 'NqGO/cV3MwFAx+ZPB5ANmQ' 2-max Seat #2 is the button
Seat 1: ItaRAnHOgvYOv5ynbG1iTw ($238.20 in chips)
Seat 2: GtFB+yyeb2djMdPFuOW/Xg ($100 in chips)
GtFB+yyeb2djMdPFuOW/Xg: posts small blind $0.50
ItaRAnHOgvYOv5ynbG1iTw: posts big blind $1
*** HOLE CARDS ***
GtFB+yyeb2djMdPFuOW/Xg: raises $2 to $3
ItaRAnHOgvYOv5ynbG1iTw: folds
GtFB+yyeb2djMdPFuOW/Xg collected $2 from pot
*** SUMMARY ***
Total pot $2 | Rake $0
Seat 1: ItaRAnHOgvYOv5ynbG1iTw (big blind) folded before Flop
Seat 2: GtFB+yyeb2djMdPFuOW/Xg (button) (small blind) collected ($2)



PokerStars Game #59941476618:  Hold'em No Limit ($0.50/$1.00) - 2009/07/01 1:36:39 ET
Table 'hugOjcwJvzEwZbK7tyiWuQ' 9-max Seat #6 is the button
Seat 1: S3Ex8K7v6xm5jqjRM7Fl3w ($22.35 in chips)
Seat 2: r27C1nIV4NS4+qbnrgBQSw ($278.60 in chips)
Seat 3: c/6hFCyfLNRn3VFvCeQ1ng ($36.55 in chips)
Seat 4: UWB3oeddt/GObx2Mix2Anw ($159.45 in chips)
Seat 5: AexZ4puUV9meFWwVU6Nv0w ($31.20 in chips)
Seat 6: gUUvmqdVlmvpal6B8nYrmg ($103.95 in chips)
Seat 7: FL3MrLspcF23LYvC4ipBOA ($110.30 in chips)
Seat 8: /zy+DB4S5fUQUSfZWFzYGw ($118.35 in chips)
Seat 9: W8P9bUKCs43TO1xHm0dL6w ($106.80 in chips)
FL3MrLspcF23LYvC4ipBOA: posts small blind $0.50
/zy+DB4S5fUQUSfZWFzYGw: posts big blind $1
*** HOLE CARDS ***
W8P9bUKCs43TO1xHm0dL6w: folds
S3Ex8K7v6xm5jqjRM7Fl3w: folds
r27C1nIV4NS4+qbnrgBQSw: folds
c/6hFCyfLNRn3VFvCeQ1ng: folds
UWB3oeddt/GObx2Mix2Anw: folds
AexZ4puUV9meFWwVU6Nv0w: raises $2 to $3
gUUvmqdVlmvpal6B8nYrmg: folds
FL3MrLspcF23LYvC4ipBOA: folds
/zy+DB4S5fUQUSfZWFzYGw: folds
AexZ4puUV9meFWwVU6Nv0w collected $2.50 from pot
*** SUMMARY ***
Total pot $2.50 | Rake $0
Seat 1: S3Ex8K7v6xm5jqjRM7Fl3w folded before Flop (didn't bet)
Seat 2: r27C1nIV4NS4+qbnrgBQSw folded before Flop (didn't bet)
Seat 3: c/6hFCyfLNRn3VFvCeQ1ng folded before Flop (didn't bet)
Seat 4: UWB3oeddt/GObx2Mix2Anw folded before Flop (didn't bet)
Seat 5: AexZ4puUV9meFWwVU6Nv0w collected ($2.50)
Seat 6: gUUvmqdVlmvpal6B8nYrmg (button) folded before Flop (didn't bet)
Seat 7: FL3MrLspcF23LYvC4ipBOA (small blind) folded before Flop
Seat 8: /zy+DB4S5fUQUSfZWFzYGw (big blind) folded before Flop
Seat 9: W8P9bUKCs43TO1xHm0dL6w folded before Flop (didn't bet)



PokerStars Game #59941477434:  Hold'em No Limit ($0.50/$1.00) - 2009/07/01 1:36:40 ET
Table 'N6LvHFrb+cdXY/COI6ByOw' 2-max Seat #2 is the button
Seat 1: lXX4W7m3u++JiSOZ46yVMQ ($91 in chips)
Seat 2: 9mAoSP3o/mikSZOW2LEEAw ($180.70 in chips)
9mAoSP3o/mikSZOW2LEEAw: posts small blind $0.50
lXX4W7m3u++JiSOZ46yVMQ: posts big blind $1
*** HOLE CARDS ***
9mAoSP3o/mikSZOW2LEEAw: folds
lXX4W7m3u++JiSOZ46yVMQ collected $1 from pot
*** SUMMARY ***
Total pot $1 | Rake $0
Seat 1: lXX4W7m3u++JiSOZ46yVMQ (big blind) collected ($1)
Seat 2: 9mAoSP3o/mikSZOW2LEEAw (button) (small blind) folded before Flop



PokerStars Game #59941477184:  Hold'em No Limit ($0.50/$1.00) - 2009/07/01 1:36:40 ET
Table '/RZcOwpZpHQ+OwPwjsbnRw' 6-max Seat #2 is the button
Seat 1: +uSzP8Jwnw7sKfQ4s66b7w ($45.70 in chips)
Seat 2: Z2fXsGcjl+Eax+RzOgwOmg ($100 in chips)
Seat 3: LJMw/I77xpnw0R5T4HnMUg ($107.65 in chips)
Seat 4: j7NIOHLZk7V2o9fOioO5ug ($101.50 in chips)
Seat 5: wx3sQGkVi2x9wJXuWNHPBw ($165.75 in chips)
Seat 6: o3YLm/rSY916m/on1VjXPA ($207 in chips)
LJMw/I77xpnw0R5T4HnMUg: posts small blind $0.50
j7NIOHLZk7V2o9fOioO5ug: posts big blind $1
*** HOLE CARDS ***
wx3sQGkVi2x9wJXuWNHPBw: folds
o3YLm/rSY916m/on1VjXPA: folds
+uSzP8Jwnw7sKfQ4s66b7w: raises $2 to $3
Z2fXsGcjl+Eax+RzOgwOmg: folds
LJMw/I77xpnw0R5T4HnMUg: folds
j7NIOHLZk7V2o9fOioO5ug: raises $9 to $12
+uSzP8Jwnw7sKfQ4s66b7w: calls $9
*** FLOP *** [8h 4s 8s]
j7NIOHLZk7V2o9fOioO5ug: bets $35
+uSzP8Jwnw7sKfQ4s66b7w: calls $33.70 and is all-in
*** TURN *** [8h 4s 8s] [Ts]
*** RIVER *** [8h 4s 8s Ts] [Qh]
*** SHOW DOWN ***
j7NIOHLZk7V2o9fOioO5ug: shows [Qd Kd] (two pair, Queens and Eights)
+uSzP8Jwnw7sKfQ4s66b7w: shows [Js As] (a flush, Ace high)
+uSzP8Jwnw7sKfQ4s66b7w collected $88.90 from pot
*** SUMMARY ***
Total pot $91.90 | Rake $3
Board [8h 4s 8s Ts Qh]
Seat 1: +uSzP8Jwnw7sKfQ4s66b7w showed [Js As] and won ($88.90) with a flush, Ace high
Seat 2: Z2fXsGcjl+Eax+RzOgwOmg (button) folded before Flop (didn't bet)
Seat 3: LJMw/I77xpnw0R5T4HnMUg (small blind) folded before Flop
Seat 4: j7NIOHLZk7V2o9fOioO5ug (big blind) showed [Qd Kd] and lost with two pair, Queens and Eights
Seat 5: wx3sQGkVi2x9wJXuWNHPBw folded before Flop (didn't bet)
Seat 6: o3YLm/rSY916m/on1VjXPA folded before Flop (didn't bet)



PokerStars Game #59941477522:  Hold'em No Limit ($0.50/$1.00) - 2009/07/01 1:36:41 ET
Table 'qj0HBN4HhQKogreu1bg7xg' 2-max Seat #1 is the button
Seat 1: NYi6JFscYNrofSXy4sM+Yw ($106.70 in chips)
Seat 2: qtyl8CSb0/4yWdbuEPJejA ($172.30 in chips)
NYi6JFscYNrofSXy4sM+Yw: posts small blind $0.50
qtyl8CSb0/4yWdbuEPJejA: posts big blind $1
*** HOLE CARDS ***
NYi6JFscYNrofSXy4sM+Yw: raises $2 to $3
qtyl8CSb0/4yWdbuEPJejA: folds
NYi6JFscYNrofSXy4sM+Yw collected $2 from pot
*** SUMMARY ***
Total pot $2 | Rake $0
Seat 1: NYi6JFscYNrofSXy4sM+Yw (button) (small blind) collected ($2)
Seat 2: qtyl8CSb0/4yWdbuEPJejA (big blind) folded before Flop



PokerStars Game #59941478494:  Hold'em No Limit ($0.50/$1.00) - 2009/07/01 1:36:42 ET
Table 'W/wyObTiXZm+Ckkl3YxcSw' 6-max Seat #3 is the button
Seat 1: eUBBn2R56C1IQ6Cs/vitwg ($279.05 in chips)
Seat 2: oDiBRCaF0QVtd3kO6xZIXw ($116.90 in chips)
Seat 3: dxyNCn/qxfkGDUIf28Cbng ($59.70 in chips)
Seat 4: UBZQqpnJZdTYYY1FTb0rLA ($155.70 in chips)
Seat 5: +OrCjyw70oZhJiD22Mn+bg ($105.50 in chips)
Seat 6: b2a+5TkFf4xJN/Ihhma58Q ($35.80 in chips)
UBZQqpnJZdTYYY1FTb0rLA: posts small blind $0.50
+OrCjyw70oZhJiD22Mn+bg: posts big blind $1
*** HOLE CARDS ***
b2a+5TkFf4xJN/Ihhma58Q has timed out
b2a+5TkFf4xJN/Ihhma58Q: folds
b2a+5TkFf4xJN/Ihhma58Q is sitting out
eUBBn2R56C1IQ6Cs/vitwg: folds
oDiBRCaF0QVtd3kO6xZIXw: folds
dxyNCn/qxfkGDUIf28Cbng: folds
dxyNCn/qxfkGDUIf28Cbng leaves the table
UBZQqpnJZdTYYY1FTb0rLA: raises $2 to $3
+OrCjyw70oZhJiD22Mn+bg: folds
UBZQqpnJZdTYYY1FTb0rLA collected $2 from pot
UBZQqpnJZdTYYY1FTb0rLA: doesn't show hand
*** SUMMARY ***
Total pot $2 | Rake $0
Seat 1: eUBBn2R56C1IQ6Cs/vitwg folded before Flop (didn't bet)
Seat 2: oDiBRCaF0QVtd3kO6xZIXw folded before Flop (didn't bet)
Seat 3: dxyNCn/qxfkGDUIf28Cbng (button) folded before Flop (didn't bet)
Seat 4: UBZQqpnJZdTYYY1FTb0rLA (small blind) collected ($2)
Seat 5: +OrCjyw70oZhJiD22Mn+bg (big blind) folded before Flop
Seat 6: b2a+5TkFf4xJN/Ihhma58Q folded before Flop (didn't bet)



PokerStars Game #59941478866:  Hold'em No Limit ($0.50/$1.00) - 2009/07/01 1:36:43 ET
Table 'gxFK0BVUD7cupu2uyRUZJg' 6-max Seat #3 is the button
Seat 1: M+X3uChmP6R63IwijVjgTg ($244.90 in chips)
Seat 2: hpxXcmRkXXI9HE5+5/j/0Q ($131.55 in chips)
Seat 3: Z2fXsGcjl+Eax+RzOgwOmg ($100 in chips)
Seat 4: Hcr4S4Nbkj5idKsvYK/eqQ ($100.50 in chips)
Seat 5: 0smcry9L0OOTCP+KzIS5SA ($100 in chips)
Seat 6: dYyb6/42PMC8aNFlm/eBeQ ($128.90 in chips)
Hcr4S4Nbkj5idKsvYK/eqQ: posts small blind $0.50
0smcry9L0OOTCP+KzIS5SA: posts big blind $1
*** HOLE CARDS ***
dYyb6/42PMC8aNFlm/eBeQ: raises $1 to $2
M+X3uChmP6R63IwijVjgTg: calls $2
hpxXcmRkXXI9HE5+5/j/0Q: folds
Z2fXsGcjl+Eax+RzOgwOmg: folds
Hcr4S4Nbkj5idKsvYK/eqQ: folds
0smcry9L0OOTCP+KzIS5SA: raises $7 to $9
dYyb6/42PMC8aNFlm/eBeQ: folds
M+X3uChmP6R63IwijVjgTg: calls $7
*** FLOP *** [6d Td 2c]
0smcry9L0OOTCP+KzIS5SA: bets $14.50
M+X3uChmP6R63IwijVjgTg: folds
0smcry9L0OOTCP+KzIS5SA collected $19.50 from pot
0smcry9L0OOTCP+KzIS5SA: doesn't show hand
*** SUMMARY ***
Total pot $20.50 | Rake $1
Board [6d Td 2c]
Seat 1: M+X3uChmP6R63IwijVjgTg folded on the Flop
Seat 2: hpxXcmRkXXI9HE5+5/j/0Q folded before Flop (didn't bet)
Seat 3: Z2fXsGcjl+Eax+RzOgwOmg (button) folded before Flop (didn't bet)
Seat 4: Hcr4S4Nbkj5idKsvYK/eqQ (small blind) folded before Flop
Seat 5: 0smcry9L0OOTCP+KzIS5SA (big blind) collected ($19.50)
Seat 6: dYyb6/42PMC8aNFlm/eBeQ folded before Flop



PokerStars Game #59941479040:  Hold'em No Limit ($0.50/$1.00) - 2009/07/01 1:36:43 ET
Table 'tHb+N6GaPEmmBAe36B2R9Q' 2-max Seat #1 is the button
Seat 1: rL+Zpv4/vX2BVHcyfh/NXA ($100 in chips)
Seat 2: Pm1sDZZi0zFtnFGXLznkug ($133.30 in chips)
rL+Zpv4/vX2BVHcyfh/NXA: posts small blind $0.50
Pm1sDZZi0zFtnFGXLznkug: posts big blind $1
*** HOLE CARDS ***
rL+Zpv4/vX2BVHcyfh/NXA: raises $2 to $3
Pm1sDZZi0zFtnFGXLznkug: calls $2
*** FLOP *** [7s 5d Jd]
Pm1sDZZi0zFtnFGXLznkug: checks
rL+Zpv4/vX2BVHcyfh/NXA: bets $4
Pm1sDZZi0zFtnFGXLznkug: calls $4
*** TURN *** [7s 5d Jd] [3d]
Pm1sDZZi0zFtnFGXLznkug: checks
rL+Zpv4/vX2BVHcyfh/NXA: checks
*** RIVER *** [7s 5d Jd 3d] [Qd]
Pm1sDZZi0zFtnFGXLznkug: checks
rL+Zpv4/vX2BVHcyfh/NXA: checks
*** SHOW DOWN ***
Pm1sDZZi0zFtnFGXLznkug: shows [7h 4c] (a pair of Sevens)
rL+Zpv4/vX2BVHcyfh/NXA: shows [Qs 8h] (a pair of Queens)
rL+Zpv4/vX2BVHcyfh/NXA collected $13.50 from pot
*** SUMMARY ***
Total pot $14 | Rake $0.50
Board [7s 5d Jd 3d Qd]
Seat 1: rL+Zpv4/vX2BVHcyfh/NXA (button) (small blind) showed [Qs 8h] and won ($13.50) with a pair of Queens
Seat 2: Pm1sDZZi0zFtnFGXLznkug (big blind) showed [7h 4c] and lost with a pair of Sevens



PokerStars Game #59941479478:  Hold'em No Limit ($0.50/$1.00) - 2009/07/01 1:36:44 ET
Table 'GxCPo/gd3OSthkYrAxJngg' 6-max Seat #4 is the button
Seat 1: sH8BpAFP+jGFxCgVpD1Lew ($231.75 in chips)
Seat 2: YExX2paeIHrmfIwV1ivM/w ($63.10 in chips)
Seat 3: idVgoPAdspFPCzee6aF9Pg ($134.50 in chips)
Seat 4: YMJG+F++3Aj6P8dAWda5fw ($208.35 in chips)
Seat 5: vX+iYAEINFeLxwMla7DY1Q ($99 in chips)
Seat 6: 4d1rWhpu8DzLmzMbR3QKyA ($101.50 in chips)
vX+iYAEINFeLxwMla7DY1Q: posts small blind $0.50
4d1rWhpu8DzLmzMbR3QKyA: posts big blind $1
*** HOLE CARDS ***
sH8BpAFP+jGFxCgVpD1Lew: raises $2 to $3
YExX2paeIHrmfIwV1ivM/w: folds
idVgoPAdspFPCzee6aF9Pg: folds
YMJG+F++3Aj6P8dAWda5fw: calls $3
vX+iYAEINFeLxwMla7DY1Q: folds
4d1rWhpu8DzLmzMbR3QKyA: folds
*** FLOP *** [5s 2c 2d]
sH8BpAFP+jGFxCgVpD1Lew: bets $6
YMJG+F++3Aj6P8dAWda5fw: folds
sH8BpAFP+jGFxCgVpD1Lew collected $7.15 from pot
*** SUMMARY ***
Total pot $7.50 | Rake $0.35
Board [5s 2c 2d]
Seat 1: sH8BpAFP+jGFxCgVpD1Lew collected ($7.15)
Seat 2: YExX2paeIHrmfIwV1ivM/w folded before Flop (didn't bet)
Seat 3: idVgoPAdspFPCzee6aF9Pg folded before Flop (didn't bet)
Seat 4: YMJG+F++3Aj6P8dAWda5fw (button) folded on the Flop
Seat 5: vX+iYAEINFeLxwMla7DY1Q (small blind) folded before Flop
Seat 6: 4d1rWhpu8DzLmzMbR3QKyA (big blind) folded before Flop



PokerStars Game #59941479454:  Hold'em No Limit ($0.50/$1.00) - 2009/07/01 1:36:44 ET
Table 'N2bNCDHL96aCQDvZIh+yQQ' 6-max Seat #4 is the button
Seat 1: Jjgflx10PVjcLkziEmLhSA ($77.35 in chips)
Seat 2: y27w5IK2WXqmYzS8OU0wKA ($121.05 in chips)
Seat 3: UBZQqpnJZdTYYY1FTb0rLA ($122.05 in chips)
Seat 4: uCqEjnxh2/vFBjKYkfTOkw ($189.30 in chips)
Seat 5: frvgHLr3+LfZtjsBCBs3NA ($15.60 in chips)
Seat 6: idVgoPAdspFPCzee6aF9Pg ($101.50 in chips)
frvgHLr3+LfZtjsBCBs3NA: posts small blind $0.50
idVgoPAdspFPCzee6aF9Pg: posts big blind $1
*** HOLE CARDS ***
Jjgflx10PVjcLkziEmLhSA: folds
y27w5IK2WXqmYzS8OU0wKA: raises $2 to $3
UBZQqpnJZdTYYY1FTb0rLA: folds
uCqEjnxh2/vFBjKYkfTOkw: folds
frvgHLr3+LfZtjsBCBs3NA: calls $2.50
idVgoPAdspFPCzee6aF9Pg: folds
*** FLOP *** [Js 9h Jc]
frvgHLr3+LfZtjsBCBs3NA: checks
y27w5IK2WXqmYzS8OU0wKA: checks
*** TURN *** [Js 9h Jc] [Qc]
frvgHLr3+LfZtjsBCBs3NA: checks
y27w5IK2WXqmYzS8OU0wKA: checks
*** RIVER *** [Js 9h Jc Qc] [4d]
frvgHLr3+LfZtjsBCBs3NA: bets $3
y27w5IK2WXqmYzS8OU0wKA: raises $3 to $6
frvgHLr3+LfZtjsBCBs3NA: calls $3
*** SHOW DOWN ***
y27w5IK2WXqmYzS8OU0wKA: shows [Qd Ad] (two pair, Queens and Jacks)
frvgHLr3+LfZtjsBCBs3NA: mucks hand
y27w5IK2WXqmYzS8OU0wKA collected $18.10 from pot
*** SUMMARY ***
Total pot $19 | Rake $0.90
Board [Js 9h Jc Qc 4d]
Seat 1: Jjgflx10PVjcLkziEmLhSA folded before Flop (didn't bet)
Seat 2: y27w5IK2WXqmYzS8OU0wKA showed [Qd Ad] and won ($18.10) with two pair, Queens and Jacks
Seat 3: UBZQqpnJZdTYYY1FTb0rLA folded before Flop (didn't bet)
Seat 4: uCqEjnxh2/vFBjKYkfTOkw (button) folded before Flop (didn't bet)
Seat 5: frvgHLr3+LfZtjsBCBs3NA (small blind) mucked
Seat 6: idVgoPAdspFPCzee6aF9Pg (big blind) folded before Flop



PokerStars Game #59941480708:  Hold'em No Limit ($0.50/$1.00) - 2009/07/01 1:36:46 ET
Table 'N6LvHFrb+cdXY/COI6ByOw' 2-max Seat #1 is the button
Seat 1: lXX4W7m3u++JiSOZ46yVMQ ($91.50 in chips)
Seat 2: 9mAoSP3o/mikSZOW2LEEAw ($180.20 in chips)
lXX4W7m3u++JiSOZ46yVMQ: posts small blind $0.50
9mAoSP3o/mikSZOW2LEEAw: posts big blind $1
*** HOLE CARDS ***
lXX4W7m3u++JiSOZ46yVMQ: raises $2 to $3
9mAoSP3o/mikSZOW2LEEAw: calls $2
*** FLOP *** [Jh Qc 7d]
9mAoSP3o/mikSZOW2LEEAw: checks
lXX4W7m3u++JiSOZ46yVMQ: bets $4
9mAoSP3o/mikSZOW2LEEAw: folds
lXX4W7m3u++JiSOZ46yVMQ collected $5.70 from pot
*** SUMMARY ***
Total pot $6 | Rake $0.30
Board [Jh Qc 7d]
Seat 1: lXX4W7m3u++JiSOZ46yVMQ (button) (small blind) collected ($5.70)
Seat 2: 9mAoSP3o/mikSZOW2LEEAw (big blind) folded on the Flop



PokerStars Game #59941481212:  Hold'em No Limit ($0.50/$1.00) - 2009/07/01 1:36:47 ET
Table 'tJq9SfN1ywY0r03VBlWlwQ' 9-max Seat #1 is the button
Seat 1: wZsU+w9r7G66x93UuvBf1Q ($297.05 in chips)
Seat 2: VPF+HjszMvUIpy0CHIwH3A ($19 in chips)
Seat 4: bLbSOSmSOnqE0iTcH/5dxA ($114.20 in chips)
Seat 5: h5ipsNTMyolp7xn/NAvWkA ($133.80 in chips)
Seat 6: gUUvmqdVlmvpal6B8nYrmg ($100 in chips)
Seat 7: Ogn4JDV3mp4ZDKO49IFzKA ($19.90 in chips)
Seat 8: G4DEhsZFmznGNVpy2SEocA ($40.80 in chips)
Seat 9: XE5QF1y74bpHog9JxWJMWQ ($103.60 in chips)
VPF+HjszMvUIpy0CHIwH3A: posts small blind $0.50
bLbSOSmSOnqE0iTcH/5dxA: posts big blind $1
*** HOLE CARDS ***
h5ipsNTMyolp7xn/NAvWkA: folds
gUUvmqdVlmvpal6B8nYrmg: folds
Ogn4JDV3mp4ZDKO49IFzKA: folds
G4DEhsZFmznGNVpy2SEocA: folds
XE5QF1y74bpHog9JxWJMWQ: raises $3 to $4
wZsU+w9r7G66x93UuvBf1Q: folds
VPF+HjszMvUIpy0CHIwH3A: folds
bLbSOSmSOnqE0iTcH/5dxA: raises $9 to $13
XE5QF1y74bpHog9JxWJMWQ: folds
bLbSOSmSOnqE0iTcH/5dxA collected $8.50 from pot
*** SUMMARY ***
Total pot $8.50 | Rake $0
Seat 1: wZsU+w9r7G66x93UuvBf1Q (button) folded before Flop (didn't bet)
Seat 2: VPF+HjszMvUIpy0CHIwH3A (small blind) folded before Flop
Seat 4: bLbSOSmSOnqE0iTcH/5dxA (big blind) collected ($8.50)
Seat 5: h5ipsNTMyolp7xn/NAvWkA folded before Flop (didn't bet)
Seat 6: gUUvmqdVlmvpal6B8nYrmg folded before Flop (didn't bet)
Seat 7: Ogn4JDV3mp4ZDKO49IFzKA folded before Flop (didn't bet)
Seat 8: G4DEhsZFmznGNVpy2SEocA folded before Flop (didn't bet)
Seat 9: XE5QF1y74bpHog9JxWJMWQ folded before Flop



PokerStars Game #59941481148:  Hold'em No Limit ($0.50/$1.00) - 2009/07/01 1:36:47 ET
Table 'O96CPOtvMBWP6kzuYDfdFA' 6-max Seat #1 is the button
Seat 1: 6alLXQIITA2EZ/lBeym8Dw ($128.25 in chips)
Seat 2: 4d1rWhpu8DzLmzMbR3QKyA ($100.50 in chips)
Seat 4: /P4w1pHg2zHYg/4ubJ0dPw ($70.75 in chips)
Seat 5: vX+iYAEINFeLxwMla7DY1Q ($98.50 in chips)
Seat 6: 3syOXva630dm1FTdwnuLpw ($75.15 in chips)
4d1rWhpu8DzLmzMbR3QKyA: posts small blind $0.50
/P4w1pHg2zHYg/4ubJ0dPw: posts big blind $1
*** HOLE CARDS ***
vX+iYAEINFeLxwMla7DY1Q: raises $2 to $3
3syOXva630dm1FTdwnuLpw: folds
6alLXQIITA2EZ/lBeym8Dw: folds
4d1rWhpu8DzLmzMbR3QKyA: folds
/P4w1pHg2zHYg/4ubJ0dPw: folds
vX+iYAEINFeLxwMla7DY1Q collected $2.50 from pot
*** SUMMARY ***
Total pot $2.50 | Rake $0
Seat 1: 6alLXQIITA2EZ/lBeym8Dw (button) folded before Flop (didn't bet)
Seat 2: 4d1rWhpu8DzLmzMbR3QKyA (small blind) folded before Flop
Seat 4: /P4w1pHg2zHYg/4ubJ0dPw (big blind) folded before Flop
Seat 5: vX+iYAEINFeLxwMla7DY1Q collected ($2.50)
Seat 6: 3syOXva630dm1FTdwnuLpw folded before Flop (didn't bet)



PokerStars Game #59941481484:  Hold'em No Limit ($0.50/$1.00) - 2009/07/01 1:36:48 ET
Table '7O9fB8yx1u7sJveJn8w6jA' 6-max Seat #5 is the button
Seat 1: 841740 ($54.30 in chips)
Seat 2: wx3sQGkVi2x9wJXuWNHPBw ($201.80 in chips)
Seat 3: hpxXcmRkXXI9HE5+5/j/0Q ($136.90 in chips)
Seat 5: BCEV3COoKY607AzLWayfRA ($100.50 in chips)
Seat 6: r4lpoh2BJZ8S6zyQv1JeSw ($100.50 in chips)
r4lpoh2BJZ8S6zyQv1JeSw: posts small blind $0.50
841740: posts big blind $1
*** HOLE CARDS ***
wx3sQGkVi2x9wJXuWNHPBw: folds
hpxXcmRkXXI9HE5+5/j/0Q: folds
BCEV3COoKY607AzLWayfRA: folds
r4lpoh2BJZ8S6zyQv1JeSw: folds
841740 collected $1 from pot
*** SUMMARY ***
Total pot $1 | Rake $0
Seat 1: 841740 (big blind) collected ($1)
Seat 2: wx3sQGkVi2x9wJXuWNHPBw folded before Flop (didn't bet)
Seat 3: hpxXcmRkXXI9HE5+5/j/0Q folded before Flop (didn't bet)
Seat 5: BCEV3COoKY607AzLWayfRA (button) folded before Flop (didn't bet)
Seat 6: r4lpoh2BJZ8S6zyQv1JeSw (small blind) folded before Flop



PokerStars Game #59941481616:  Hold'em No Limit ($0.50/$1.00) - 2009/07/01 1:36:48 ET
Table 'NqGO/cV3MwFAx+ZPB5ANmQ' 2-max Seat #1 is the button
Seat 1: ItaRAnHOgvYOv5ynbG1iTw ($237.20 in chips)
Seat 2: GtFB+yyeb2djMdPFuOW/Xg ($101 in chips)
ItaRAnHOgvYOv5ynbG1iTw: posts small blind $0.50
GtFB+yyeb2djMdPFuOW/Xg: posts big blind $1
*** HOLE CARDS ***
ItaRAnHOgvYOv5ynbG1iTw: folds
GtFB+yyeb2djMdPFuOW/Xg collected $1 from pot
*** SUMMARY ***
Total pot $1 | Rake $0
Seat 1: ItaRAnHOgvYOv5ynbG1iTw (button) (small blind) folded before Flop
Seat 2: GtFB+yyeb2djMdPFuOW/Xg (big blind) collected ($1)



PokerStars Game #59941481756:  Hold'em No Limit ($0.50/$1.00) - 2009/07/01 1:36:48 ET
Table 'qj0HBN4HhQKogreu1bg7xg' 2-max Seat #2 is the button
Seat 1: NYi6JFscYNrofSXy4sM+Yw ($107.70 in chips)
Seat 2: qtyl8CSb0/4yWdbuEPJejA ($171.30 in chips)
qtyl8CSb0/4yWdbuEPJejA: posts small blind $0.50
NYi6JFscYNrofSXy4sM+Yw: posts big blind $1
*** HOLE CARDS ***
qtyl8CSb0/4yWdbuEPJejA: folds
NYi6JFscYNrofSXy4sM+Yw collected $1 from pot
*** SUMMARY ***
Total pot $1 | Rake $0
Seat 1: NYi6JFscYNrofSXy4sM+Yw (big blind) collected ($1)
Seat 2: qtyl8CSb0/4yWdbuEPJejA (button) (small blind) folded before Flop



PokerStars Game #59941482330:  Hold'em No Limit ($0.50/$1.00) - 2009/07/01 1:36:49 ET
Table 'rmZfTK+oSebeUPJNbWhdAA' 6-max Seat #4 is the button
Seat 1: xAU6q2/cwmby2sxmA8VcmA ($131.50 in chips)
Seat 2: z7O9PO/WEcqRouIydFhS9Q ($188 in chips)
Seat 3: BCEV3COoKY607AzLWayfRA ($195.30 in chips)
Seat 4: 1/mIuXfgx1ZyVkodrmfQDw ($172.15 in chips)
Seat 5: BWhgxe7gWiYobRbwdG+d2Q ($100.50 in chips)
Seat 6: j7NIOHLZk7V2o9fOioO5ug ($100 in chips)
BWhgxe7gWiYobRbwdG+d2Q: posts small blind $0.50
j7NIOHLZk7V2o9fOioO5ug: posts big blind $1
*** HOLE CARDS ***
xAU6q2/cwmby2sxmA8VcmA: folds
z7O9PO/WEcqRouIydFhS9Q: folds
BCEV3COoKY607AzLWayfRA: folds
1/mIuXfgx1ZyVkodrmfQDw: folds
BWhgxe7gWiYobRbwdG+d2Q: folds
j7NIOHLZk7V2o9fOioO5ug collected $1 from pot
j7NIOHLZk7V2o9fOioO5ug: doesn't show hand
*** SUMMARY ***
Total pot $1 | Rake $0
Seat 1: xAU6q2/cwmby2sxmA8VcmA folded before Flop (didn't bet)
Seat 2: z7O9PO/WEcqRouIydFhS9Q folded before Flop (didn't bet)
Seat 3: BCEV3COoKY607AzLWayfRA folded before Flop (didn't bet)
Seat 4: 1/mIuXfgx1ZyVkodrmfQDw (button) folded before Flop (didn't bet)
Seat 5: BWhgxe7gWiYobRbwdG+d2Q (small blind) folded before Flop
Seat 6: j7NIOHLZk7V2o9fOioO5ug (big blind) collected ($1)



PokerStars Game #59941483034:  Hold'em No Limit ($0.50/$1.00) - 2009/07/01 1:36:50 ET
Table 'ZFWj23PMihdwrNWv41OG/QtyUh+jyNvrceIQdKMJjQ2weat #6 is the button
Seat 1: j3hj7KQwBVU5NTFmtYomSw ($72.35 in chips)
Seat 2: 0smcry9L0OOTCP+KzIS5SA ($98.50 in chips)
Seat 3: cWwhvq/+r/w8nkhwrJoekQ ($47.70 in chips)
Seat 4: O5ZesE/6mHyuWWbvkiH/Fg ($40.85 in chips)
Seat 5: j7NIOHLZk7V2o9fOioO5ug ($100 in chips)
Seat 6: u23r4AyKPgHioZ6t7z6qrA ($68 in chips)
j3hj7KQwBVU5NTFmtYomSw: posts small blind $0.50
0smcry9L0OOTCP+KzIS5SA: posts big blind $1
*** HOLE CARDS ***
cWwhvq/+r/w8nkhwrJoekQ: folds
O5ZesE/6mHyuWWbvkiH/Fg: raises $2 to $3
j7NIOHLZk7V2o9fOioO5ug: folds
u23r4AyKPgHioZ6t7z6qrA: calls $3
j3hj7KQwBVU5NTFmtYomSw: folds
0smcry9L0OOTCP+KzIS5SA: folds
*** FLOP *** [9s 8s 8h]
O5ZesE/6mHyuWWbvkiH/Fg: checks
u23r4AyKPgHioZ6t7z6qrA: checks
*** TURN *** [9s 8s 8h] [Ts]
O5ZesE/6mHyuWWbvkiH/Fg: checks
u23r4AyKPgHioZ6t7z6qrA: bets $4
O5ZesE/6mHyuWWbvkiH/Fg: calls $4
*** RIVER *** [9s 8s 8h Ts] [Qh]
O5ZesE/6mHyuWWbvkiH/Fg: checks
u23r4AyKPgHioZ6t7z6qrA: bets $9
O5ZesE/6mHyuWWbvkiH/Fg: raises $11 to $20
u23r4AyKPgHioZ6t7z6qrA: calls $11
*** SHOW DOWN ***
O5ZesE/6mHyuWWbvkiH/Fg: shows [9h 9d] (a full house, Nines full of Eights)
u23r4AyKPgHioZ6t7z6qrA: mucks hand
O5ZesE/6mHyuWWbvkiH/Fg collected $52.80 from pot
*** SUMMARY ***
Total pot $55.50 | Rake $2.70
Board [9s 8s 8h Ts Qh]
Seat 1: j3hj7KQwBVU5NTFmtYomSw (small blind) folded before Flop
Seat 2: 0smcry9L0OOTCP+KzIS5SA (big blind) folded before Flop
Seat 3: cWwhvq/+r/w8nkhwrJoekQ folded before Flop (didn't bet)
Seat 4: O5ZesE/6mHyuWWbvkiH/Fg showed [9h 9d] and won ($52.80) with a full house, Nines full of Eights
Seat 5: j7NIOHLZk7V2o9fOioO5ug folded before Flop (didn't bet)
Seat 6: u23r4AyKPgHioZ6t7z6qrA (button) mucked



PokerStars Game #59941483916:  Hold'em No Limit ($0.50/$1.00) - 2009/07/01 1:36:52 ET
Table 'b8oW/dOL7fDza5DfZ/dOJQ' 6-max Seat #3 is the button
Seat 1: NakujTNjHFgzceydFf+E2Q ($98 in chips)
Seat 2: TSuRyAHnUPCFjP7Z0rEE0w ($119 in chips)
Seat 3: d8WX+9nUHoqlrAGagO0Wow ($32.80 in chips)
Seat 4: 8rDbzImSi1zgxtqtF1pSbA ($20.50 in chips)
Seat 5: r4lpoh2BJZ8S6zyQv1JeSw ($101 in chips)
Seat 6: PvfYaKbzMpsmUcbOExckbQ ($110.60 in chips)
8rDbzImSi1zgxtqtF1pSbA: posts small blind $0.50
r4lpoh2BJZ8S6zyQv1JeSw: posts big blind $1
*** HOLE CARDS ***
PvfYaKbzMpsmUcbOExckbQ: raises $2.50 to $3.50
NakujTNjHFgzceydFf+E2Q: calls $3.50
TSuRyAHnUPCFjP7Z0rEE0w: folds
d8WX+9nUHoqlrAGagO0Wow: folds
8rDbzImSi1zgxtqtF1pSbA: folds
r4lpoh2BJZ8S6zyQv1JeSw: folds
*** FLOP *** [3h Kc Ad]
PvfYaKbzMpsmUcbOExckbQ: bets $5
NakujTNjHFgzceydFf+E2Q: calls $5
*** TURN *** [3h Kc Ad] [2s]
PvfYaKbzMpsmUcbOExckbQ: bets $10
NakujTNjHFgzceydFf+E2Q: calls $10
*** RIVER *** [3h Kc Ad 2s] [8s]
PvfYaKbzMpsmUcbOExckbQ: bets $22
NakujTNjHFgzceydFf+E2Q: calls $22
*** SHOW DOWN ***
PvfYaKbzMpsmUcbOExckbQ: shows [Ah Kd] (two pair, Aces and Kings)
NakujTNjHFgzceydFf+E2Q: mucks hand
PvfYaKbzMpsmUcbOExckbQ collected $79.50 from pot
*** SUMMARY ***
Total pot $82.50 | Rake $3
Board [3h Kc Ad 2s 8s]
Seat 1: NakujTNjHFgzceydFf+E2Q mucked
Seat 2: TSuRyAHnUPCFjP7Z0rEE0w folded before Flop (didn't bet)
Seat 3: d8WX+9nUHoqlrAGagO0Wow (button) folded before Flop (didn't bet)
Seat 4: 8rDbzImSi1zgxtqtF1pSbA (small blind) folded before Flop
Seat 5: r4lpoh2BJZ8S6zyQv1JeSw (big blind) folded before Flop
Seat 6: PvfYaKbzMpsmUcbOExckbQ showed [Ah Kd] and won ($79.50) with two pair, Aces and Kings



PokerStars Game #59941485148:  Hold'em No Limit ($0.50/$1.00) - 2009/07/01 1:36:54 ET
Table 'pHrhryH8jPNdQfY62f8v+g' 6-max Seat #1 is the button
Seat 1: 4d1rWhpu8DzLmzMbR3QKyA ($147.45 in chips)
Seat 2: JwCcjZl0bjJzG7hmE0dnTA ($115.05 in chips)
Seat 3: 8oS5O7iD/qnFXFXJrGIgNQ ($110.80 in chips)
Seat 4: 1f3beyIML24UqEMTbWy93g ($55.70 in chips)
Seat 5: d8WX+9nUHoqlrAGagO0Wow ($24.15 in chips)
Seat 6: xAU6q2/cwmby2sxmA8VcmA ($175.25 in chips)
JwCcjZl0bjJzG7hmE0dnTA: posts small blind $0.50
8oS5O7iD/qnFXFXJrGIgNQ: posts big blind $1
*** HOLE CARDS ***
1f3beyIML24UqEMTbWy93g: folds
d8WX+9nUHoqlrAGagO0Wow: folds
xAU6q2/cwmby2sxmA8VcmA: raises $3 to $4
4d1rWhpu8DzLmzMbR3QKyA: folds
JwCcjZl0bjJzG7hmE0dnTA: calls $3.50
8oS5O7iD/qnFXFXJrGIgNQ: folds
*** FLOP *** [Js 4c Kc]
JwCcjZl0bjJzG7hmE0dnTA: checks
xAU6q2/cwmby2sxmA8VcmA: bets $6
JwCcjZl0bjJzG7hmE0dnTA: folds
xAU6q2/cwmby2sxmA8VcmA collected $8.55 from pot
*** SUMMARY ***
Total pot $9 | Rake $0.45
Board [Js 4c Kc]
Seat 1: 4d1rWhpu8DzLmzMbR3QKyA (button) folded before Flop (didn't bet)
Seat 2: JwCcjZl0bjJzG7hmE0dnTA (small blind) folded on the Flop
Seat 3: 8oS5O7iD/qnFXFXJrGIgNQ (big blind) folded before Flop
Seat 4: 1f3beyIML24UqEMTbWy93g folded before Flop (didn't bet)
Seat 5: d8WX+9nUHoqlrAGagO0Wow folded before Flop (didn't bet)
Seat 6: xAU6q2/cwmby2sxmA8VcmA collected ($8.55)



PokerStars Game #59941486234:  Hold'em No Limit ($0.50/$1.00) - 2009/07/01 1:36:56 ET
Table 'NqGO/cV3MwFAx+ZPB5ANmQ' 2-max Seat #2 is the button
Seat 1: ItaRAnHOgvYOv5ynbG1iTw ($236.70 in chips)
Seat 2: GtFB+yyeb2djMdPFuOW/Xg ($101.50 in chips)
GtFB+yyeb2djMdPFuOW/Xg: posts small blind $0.50
ItaRAnHOgvYOv5ynbG1iTw: posts big blind $1
*** HOLE CARDS ***
GtFB+yyeb2djMdPFuOW/Xg: raises $2 to $3
ItaRAnHOgvYOv5ynbG1iTw: calls $2
*** FLOP *** [9d Kc 5s]
ItaRAnHOgvYOv5ynbG1iTw: bets $1
GtFB+yyeb2djMdPFuOW/Xg: raises $6 to $7
ItaRAnHOgvYOv5ynbG1iTw: calls $6
*** TURN *** [9d Kc 5s] [5d]
ItaRAnHOgvYOv5ynbG1iTw: checks
GtFB+yyeb2djMdPFuOW/Xg: checks
*** RIVER *** [9d Kc 5s 5d] [Qh]
ItaRAnHOgvYOv5ynbG1iTw: checks
GtFB+yyeb2djMdPFuOW/Xg: bets $15
ItaRAnHOgvYOv5ynbG1iTw: folds
GtFB+yyeb2djMdPFuOW/Xg collected $19.50 from pot
*** SUMMARY ***
Total pot $20 | Rake $0.50
Board [9d Kc 5s 5d Qh]
Seat 1: ItaRAnHOgvYOv5ynbG1iTw (big blind) folded on the River
Seat 2: GtFB+yyeb2djMdPFuOW/Xg (button) (small blind) collected ($19.50)



PokerStars Game #59941486556:  Hold'em No Limit ($0.50/$1.00) - 2009/07/01 1:36:57 ET
Table 'vs/5jr6ciwjVQ5+Soc+u2A' 6-max Seat #5 is the button
Seat 1: J798qwLuvXyq0BbzsIjOrA ($185.55 in chips)
Seat 2: lXX4W7m3u++JiSOZ46yVMQ ($95.50 in chips)
Seat 3: Ws/3Uo3rQIk8hLgW0P+2xA ($99 in chips)
Seat 4: 0smcry9L0OOTCP+KzIS5SA ($101 in chips)
Seat 5: +Nt3OPk3XR9SKjZgm2CexQ ($159.35 in chips)
Seat 6: Z2fXsGcjl+Eax+RzOgwOmg ($103.50 in chips)
Z2fXsGcjl+Eax+RzOgwOmg: posts small blind $0.50
J798qwLuvXyq0BbzsIjOrA: posts big blind $1
*** HOLE CARDS ***
lXX4W7m3u++JiSOZ46yVMQ: raises $2 to $3
Ws/3Uo3rQIk8hLgW0P+2xA: folds
0smcry9L0OOTCP+KzIS5SA: folds
+Nt3OPk3XR9SKjZgm2CexQ: folds
Z2fXsGcjl+Eax+RzOgwOmg: folds
J798qwLuvXyq0BbzsIjOrA: raises $6 to $9
lXX4W7m3u++JiSOZ46yVMQ: calls $6
*** FLOP *** [Qd 4c 9s]
J798qwLuvXyq0BbzsIjOrA: bets $8
lXX4W7m3u++JiSOZ46yVMQ: folds
J798qwLuvXyq0BbzsIjOrA collected $17.60 from pot
J798qwLuvXyq0BbzsIjOrA: doesn't show hand
*** SUMMARY ***
Total pot $18.50 | Rake $0.90
Board [Qd 4c 9s]
Seat 1: J798qwLuvXyq0BbzsIjOrA (big blind) collected ($17.60)
Seat 2: lXX4W7m3u++JiSOZ46yVMQ folded on the Flop
Seat 3: Ws/3Uo3rQIk8hLgW0P+2xA folded before Flop (didn't bet)
Seat 4: 0smcry9L0OOTCP+KzIS5SA folded before Flop (didn't bet)
Seat 5: +Nt3OPk3XR9SKjZgm2CexQ (button) folded before Flop (didn't bet)
Seat 6: Z2fXsGcjl+Eax+RzOgwOmg (small blind) folded before Flop



PokerStars Game #59941487986:  Hold'em No Limit ($0.50/$1.00) - 2009/07/01 1:36:59 ET
Table 'qj0HBN4HhQKogreu1bg7xg' 2-max Seat #1 is the button
Seat 1: NYi6JFscYNrofSXy4sM+Yw ($108.20 in chips)
Seat 2: qtyl8CSb0/4yWdbuEPJejA ($170.80 in chips)
NYi6JFscYNrofSXy4sM+Yw: posts small blind $0.50
qtyl8CSb0/4yWdbuEPJejA: posts big blind $1
*** HOLE CARDS ***
NYi6JFscYNrofSXy4sM+Yw: raises $2 to $3
qtyl8CSb0/4yWdbuEPJejA: folds
NYi6JFscYNrofSXy4sM+Yw collected $2 from pot
*** SUMMARY ***
Total pot $2 | Rake $0
Seat 1: NYi6JFscYNrofSXy4sM+Yw (button) (small blind) collected ($2)
Seat 2: qtyl8CSb0/4yWdbuEPJejA (big blind) folded before Flop



PokerStars Game #59941488922:  Hold'em No Limit ($0.50/$1.00) - 2009/07/01 1:37:01 ET
Table '305hiksPPCCdC6V2LNsO5w' 6-max Seat #5 is the button
Seat 1: RTuDLJHh/9zPfBftoc9vsw ($6.50 in chips)
Seat 2: j7NIOHLZk7V2o9fOioO5ug ($159.20 in chips)
Seat 3: +zIVjZKLpcidfRHgVZW8lA ($27.20 in chips)
Seat 4: uJVSceLggtsrJya+WtmUEA ($203.80 in chips)
Seat 5: +Nt3OPk3XR9SKjZgm2CexQ ($100 in chips)
Seat 6: 9/Tq8dw7kWW68uN8bFupXg ($21.45 in chips)
9/Tq8dw7kWW68uN8bFupXg: posts small blind $0.50
RTuDLJHh/9zPfBftoc9vsw: posts big blind $1
*** HOLE CARDS ***
j7NIOHLZk7V2o9fOioO5ug: folds
+zIVjZKLpcidfRHgVZW8lA: folds
uJVSceLggtsrJya+WtmUEA: folds
+Nt3OPk3XR9SKjZgm2CexQ: folds
9/Tq8dw7kWW68uN8bFupXg: calls $0.50
RTuDLJHh/9zPfBftoc9vsw: checks
*** FLOP *** [Kc 4d Jd]
9/Tq8dw7kWW68uN8bFupXg: bets $1
RTuDLJHh/9zPfBftoc9vsw: calls $1
*** TURN *** [Kc 4d Jd] [Qc]
9/Tq8dw7kWW68uN8bFupXg: bets $1
RTuDLJHh/9zPfBftoc9vsw: calls $1
*** RIVER *** [Kc 4d Jd Qc] [5d]
9/Tq8dw7kWW68uN8bFupXg: checks
RTuDLJHh/9zPfBftoc9vsw: checks
*** SHOW DOWN ***
9/Tq8dw7kWW68uN8bFupXg: shows [5c 3c] (a pair of Fives)
RTuDLJHh/9zPfBftoc9vsw: shows [Ac Tc] (a straight, Ten to Ace)
RTuDLJHh/9zPfBftoc9vsw collected $5.75 from pot
*** SUMMARY ***
Total pot $6 | Rake $0.25
Board [Kc 4d Jd Qc 5d]
Seat 1: RTuDLJHh/9zPfBftoc9vsw (big blind) showed [Ac Tc] and won ($5.75) with a straight, Ten to Ace
Seat 2: j7NIOHLZk7V2o9fOioO5ug folded before Flop (didn't bet)
Seat 3: +zIVjZKLpcidfRHgVZW8lA folded before Flop (didn't bet)
Seat 4: uJVSceLggtsrJya+WtmUEA folded before Flop (didn't bet)
Seat 5: +Nt3OPk3XR9SKjZgm2CexQ (button) folded before Flop (didn't bet)
Seat 6: 9/Tq8dw7kWW68uN8bFupXg (small blind) showed [5c 3c] and lost with a pair of Fives



PokerStars Game #59941490950:  Hold'em No Limit ($0.50/$1.00) - 2009/07/01 1:37:05 ET
Table 'N6LvHFrb+cdXY/COI6ByOw' 2-max Seat #2 is the button
Seat 1: lXX4W7m3u++JiSOZ46yVMQ ($94.20 in chips)
Seat 2: 9mAoSP3o/mikSZOW2LEEAw ($177.20 in chips)
9mAoSP3o/mikSZOW2LEEAw: posts small blind $0.50
lXX4W7m3u++JiSOZ46yVMQ: posts big blind $1
*** HOLE CARDS ***
9mAoSP3o/mikSZOW2LEEAw: folds
lXX4W7m3u++JiSOZ46yVMQ collected $1 from pot
*** SUMMARY ***
Total pot $1 | Rake $0
Seat 1: lXX4W7m3u++JiSOZ46yVMQ (big blind) collected ($1)
Seat 2: 9mAoSP3o/mikSZOW2LEEAw (button) (small blind) folded before Flop



PokerStars Game #59941491874:  Hold'em No Limit ($0.50/$1.00) - 2009/07/01 1:37:06 ET
Table 'qj0HBN4HhQKogreu1bg7xg' 2-max Seat #2 is the button
Seat 1: NYi6JFscYNrofSXy4sM+Yw ($109.20 in chips)
Seat 2: qtyl8CSb0/4yWdbuEPJejA ($169.80 in chips)
qtyl8CSb0/4yWdbuEPJejA: posts small blind $0.50
NYi6JFscYNrofSXy4sM+Yw: posts big blind $1
*** HOLE CARDS ***
qtyl8CSb0/4yWdbuEPJejA: raises $2 to $3
NYi6JFscYNrofSXy4sM+Yw: folds
qtyl8CSb0/4yWdbuEPJejA collected $2 from pot
qtyl8CSb0/4yWdbuEPJejA: doesn't show hand
*** SUMMARY ***
Total pot $2 | Rake $0
Seat 1: NYi6JFscYNrofSXy4sM+Yw (big blind) folded before Flop
Seat 2: qtyl8CSb0/4yWdbuEPJejA (button) (small blind) collected ($2)



PokerStars Game #59941491586:  Hold'em No Limit ($0.50/$1.00) - 2009/07/01 1:37:06 ET
Table 'O96CPOtvMBWP6kzuYDfdFA' 6-max Seat #2 is the button
Seat 1: 6alLXQIITA2EZ/lBeym8Dw ($128.25 in chips)
Seat 2: 4d1rWhpu8DzLmzMbR3QKyA ($100 in chips)
Seat 4: /P4w1pHg2zHYg/4ubJ0dPw ($69.75 in chips)
Seat 5: vX+iYAEINFeLxwMla7DY1Q ($100 in chips)
Seat 6: 3syOXva630dm1FTdwnuLpw ($75.15 in chips)
/P4w1pHg2zHYg/4ubJ0dPw: posts small blind $0.50
vX+iYAEINFeLxwMla7DY1Q: posts big blind $1
*** HOLE CARDS ***
3syOXva630dm1FTdwnuLpw: folds
6alLXQIITA2EZ/lBeym8Dw: folds
4d1rWhpu8DzLmzMbR3QKyA: raises $2 to $3
/P4w1pHg2zHYg/4ubJ0dPw: folds
vX+iYAEINFeLxwMla7DY1Q: folds
4d1rWhpu8DzLmzMbR3QKyA collected $2.50 from pot
*** SUMMARY ***
Total pot $2.50 | Rake $0
Seat 1: 6alLXQIITA2EZ/lBeym8Dw folded before Flop (didn't bet)
Seat 2: 4d1rWhpu8DzLmzMbR3QKyA (button) collected ($2.50)
Seat 4: /P4w1pHg2zHYg/4ubJ0dPw (small blind) folded before Flop
Seat 5: vX+iYAEINFeLxwMla7DY1Q (big blind) folded before Flop
Seat 6: 3syOXva630dm1FTdwnuLpw folded before Flop (didn't bet)



PokerStars Game #59941492740:  Hold'em No Limit ($0.50/$1.00) - 2009/07/01 1:37:08 ET
Table 'rmZfTK+oSebeUPJNbWhdAA' 6-max Seat #5 is the button
Seat 1: xAU6q2/cwmby2sxmA8VcmA ($131.50 in chips)
Seat 2: z7O9PO/WEcqRouIydFhS9Q ($188 in chips)
Seat 3: BCEV3COoKY607AzLWayfRA ($195.30 in chips)
Seat 4: 1/mIuXfgx1ZyVkodrmfQDw ($172.15 in chips)
Seat 5: BWhgxe7gWiYobRbwdG+d2Q ($100 in chips)
Seat 6: j7NIOHLZk7V2o9fOioO5ug ($100.50 in chips)
j7NIOHLZk7V2o9fOioO5ug: posts small blind $0.50
xAU6q2/cwmby2sxmA8VcmA: posts big blind $1
*** HOLE CARDS ***
z7O9PO/WEcqRouIydFhS9Q: folds
BCEV3COoKY607AzLWayfRA: folds
1/mIuXfgx1ZyVkodrmfQDw: folds
BWhgxe7gWiYobRbwdG+d2Q: folds
j7NIOHLZk7V2o9fOioO5ug: folds
xAU6q2/cwmby2sxmA8VcmA collected $1 from pot
xAU6q2/cwmby2sxmA8VcmA: doesn't show hand
*** SUMMARY ***
Total pot $1 | Rake $0
Seat 1: xAU6q2/cwmby2sxmA8VcmA (big blind) collected ($1)
Seat 2: z7O9PO/WEcqRouIydFhS9Q folded before Flop (didn't bet)
Seat 3: BCEV3COoKY607AzLWayfRA folded before Flop (didn't bet)
Seat 4: 1/mIuXfgx1ZyVkodrmfQDw folded before Flop (didn't bet)
Seat 5: BWhgxe7gWiYobRbwdG+d2Q (button) folded before Flop (didn't bet)
Seat 6: j7NIOHLZk7V2o9fOioO5ug (small blind) folded before Flop



PokerStars Game #59941493636:  Hold'em No Limit ($0.50/$1.00) - 2009/07/01 1:37:09 ET
Table 'fZjVbKj9D8yOB+Rj7NaP/A' 9-max Seat #6 is the button
Seat 1: 9BZCcac3+McErkkSN2YScA ($103.15 in chips)
Seat 2: PTAFYDIUSsG+SArbxNl+Aw ($104 in chips)
Seat 3: yAbu2QsRPVcjPbqlf/jDxw ($103.65 in chips)
Seat 4: 997ViqAtWn1FPjJqcffwcA ($100 in chips)
Seat 5: PkGfq5xrSlNsujKaG/HF4Q ($100 in chips)
Seat 6: OvwYHV65yUbgdBjSmo1+5g ($138.45 in chips)
Seat 7: SyS20PAm3RpT6uLBsGkwOA ($78 in chips)
Seat 8: EVvb0huXeMB7dnOAiO4ggA ($50 in chips)
Seat 9: qheQay5YvP2DMAb3OUSxtw ($100.50 in chips)
SyS20PAm3RpT6uLBsGkwOA: posts small blind $0.50
EVvb0huXeMB7dnOAiO4ggA: posts big blind $1
*** HOLE CARDS ***
qheQay5YvP2DMAb3OUSxtw: folds
9BZCcac3+McErkkSN2YScA: folds
PTAFYDIUSsG+SArbxNl+Aw: folds
yAbu2QsRPVcjPbqlf/jDxw: folds
997ViqAtWn1FPjJqcffwcA: folds
PkGfq5xrSlNsujKaG/HF4Q: folds
OvwYHV65yUbgdBjSmo1+5g: calls $1
SyS20PAm3RpT6uLBsGkwOA: calls $0.50
EVvb0huXeMB7dnOAiO4ggA: checks
*** FLOP *** [Qd 9c 2d]
SyS20PAm3RpT6uLBsGkwOA: checks
EVvb0huXeMB7dnOAiO4ggA: checks
OvwYHV65yUbgdBjSmo1+5g: checks
*** TURN *** [Qd 9c 2d] [Ks]
SyS20PAm3RpT6uLBsGkwOA: checks
EVvb0huXeMB7dnOAiO4ggA: checks
OvwYHV65yUbgdBjSmo1+5g: bets $2
SyS20PAm3RpT6uLBsGkwOA: calls $2
EVvb0huXeMB7dnOAiO4ggA: folds
*** RIVER *** [Qd 9c 2d Ks] [8c]
SyS20PAm3RpT6uLBsGkwOA: bets $13
OvwYHV65yUbgdBjSmo1+5g: folds
SyS20PAm3RpT6uLBsGkwOA collected $6.70 from pot
*** SUMMARY ***
Total pot $7 | Rake $0.30
Board [Qd 9c 2d Ks 8c]
Seat 1: 9BZCcac3+McErkkSN2YScA folded before Flop (didn't bet)
Seat 2: PTAFYDIUSsG+SArbxNl+Aw folded before Flop (didn't bet)
Seat 3: yAbu2QsRPVcjPbqlf/jDxw folded before Flop (didn't bet)
Seat 4: 997ViqAtWn1FPjJqcffwcA folded before Flop (didn't bet)
Seat 5: PkGfq5xrSlNsujKaG/HF4Q folded before Flop (didn't bet)
Seat 6: OvwYHV65yUbgdBjSmo1+5g (button) folded on the River
Seat 7: SyS20PAm3RpT6uLBsGkwOA (small blind) collected ($6.70)
Seat 8: EVvb0huXeMB7dnOAiO4ggA (big blind) folded on the Turn
Seat 9: qheQay5YvP2DMAb3OUSxtw folded before Flop (didn't bet)



PokerStars Game #59941493992:  Hold'em No Limit ($0.50/$1.00) - 2009/07/01 1:37:10 ET
Table '7Nl0ffnjeK44/vmeexh3MQ' 9-max Seat #7 is the button
Seat 1: V138SURkdX8LdVBPKdJJag ($101.50 in chips)
Seat 3: JMmUYT5pIKCKh2pGjCB/4w ($58.40 in chips)
Seat 4: bLbSOSmSOnqE0iTcH/5dxA ($106.80 in chips)
Seat 5: 61sfw5QTu62YYIt68OsdrA ($77.55 in chips)
Seat 6: FVs16t7GgfWgQWt4JxsObQ ($33.25 in chips)
Seat 7: 997ViqAtWn1FPjJqcffwcA ($100 in chips)
Seat 8: HRJJZiSxFAehJGaET63dlA ($47.90 in chips)
Seat 9: /JHoNdt0fK6X+isrqRfV3w ($20 in chips)
HRJJZiSxFAehJGaET63dlA: posts small blind $0.50
/JHoNdt0fK6X+isrqRfV3w: posts big blind $1
*** HOLE CARDS ***
V138SURkdX8LdVBPKdJJag: raises $2.50 to $3.50
OGgaARGdJQT4awWVNQ957w has returned
JMmUYT5pIKCKh2pGjCB/4w: folds
bLbSOSmSOnqE0iTcH/5dxA: folds
61sfw5QTu62YYIt68OsdrA: folds
FVs16t7GgfWgQWt4JxsObQ: folds
997ViqAtWn1FPjJqcffwcA: calls $3.50
HRJJZiSxFAehJGaET63dlA: folds
/JHoNdt0fK6X+isrqRfV3w: folds
*** FLOP *** [5s Tc 4h]
V138SURkdX8LdVBPKdJJag: bets $5
997ViqAtWn1FPjJqcffwcA: calls $5
*** TURN *** [5s Tc 4h] [Jh]
V138SURkdX8LdVBPKdJJag: checks
997ViqAtWn1FPjJqcffwcA: bets $13
V138SURkdX8LdVBPKdJJag: folds
997ViqAtWn1FPjJqcffwcA collected $17.60 from pot
*** SUMMARY ***
Total pot $18.50 | Rake $0.90
Board [5s Tc 4h Jh]
Seat 1: V138SURkdX8LdVBPKdJJag folded on the Turn
Seat 3: JMmUYT5pIKCKh2pGjCB/4w folded before Flop (didn't bet)
Seat 4: bLbSOSmSOnqE0iTcH/5dxA folded before Flop (didn't bet)
Seat 5: 61sfw5QTu62YYIt68OsdrA folded before Flop (didn't bet)
Seat 6: FVs16t7GgfWgQWt4JxsObQ folded before Flop (didn't bet)
Seat 7: 997ViqAtWn1FPjJqcffwcA (button) collected ($17.60)
Seat 8: HRJJZiSxFAehJGaET63dlA (small blind) folded before Flop
Seat 9: /JHoNdt0fK6X+isrqRfV3w (big blind) folded before Flop



PokerStars Game #59941494522:  Hold'em No Limit ($0.50/$1.00) - 2009/07/01 1:37:11 ET
Table 'fTlPiCj0utgzC/5io+I7ew' 6-max Seat #2 is the button
Seat 1: YMJG+F++3Aj6P8dAWda5fw ($108.60 in chips)
Seat 2: qVr1nl3dy2xXPqS8UpTDlA ($22.95 in chips)
Seat 3: Z2fXsGcjl+Eax+RzOgwOmg ($137 in chips)
Seat 4: uJVSceLggtsrJya+WtmUEA ($166.35 in chips)
Seat 5: XUk5GQsfNFpHvaToDZ0rZA ($44.05 in chips)
Seat 6: y27w5IK2WXqmYzS8OU0wKA ($100 in chips)
Z2fXsGcjl+Eax+RzOgwOmg: posts small blind $0.50
uJVSceLggtsrJya+WtmUEA: posts big blind $1
*** HOLE CARDS ***
XUk5GQsfNFpHvaToDZ0rZA: folds
y27w5IK2WXqmYzS8OU0wKA: folds
YMJG+F++3Aj6P8dAWda5fw: raises $2 to $3
qVr1nl3dy2xXPqS8UpTDlA: calls $3
Z2fXsGcjl+Eax+RzOgwOmg: folds
uJVSceLggtsrJya+WtmUEA: folds
*** FLOP *** [2h Kh Ts]
YMJG+F++3Aj6P8dAWda5fw: bets $4
qVr1nl3dy2xXPqS8UpTDlA: calls $4
*** TURN *** [2h Kh Ts] [3h]
YMJG+F++3Aj6P8dAWda5fw: checks
qVr1nl3dy2xXPqS8UpTDlA: checks
*** RIVER *** [2h Kh Ts 3h] [9h]
YMJG+F++3Aj6P8dAWda5fw: bets $5
qVr1nl3dy2xXPqS8UpTDlA: raises $5 to $10
YMJG+F++3Aj6P8dAWda5fw: folds
qVr1nl3dy2xXPqS8UpTDlA collected $24.30 from pot
*** SUMMARY ***
Total pot $25.50 | Rake $1.20
Board [2h Kh Ts 3h 9h]
Seat 1: YMJG+F++3Aj6P8dAWda5fw folded on the River
Seat 2: qVr1nl3dy2xXPqS8UpTDlA (button) collected ($24.30)
Seat 3: Z2fXsGcjl+Eax+RzOgwOmg (small blind) folded before Flop
Seat 4: uJVSceLggtsrJya+WtmUEA (big blind) folded before Flop
Seat 5: XUk5GQsfNFpHvaToDZ0rZA folded before Flop (didn't bet)
Seat 6: y27w5IK2WXqmYzS8OU0wKA folded before Flop (didn't bet)



PokerStars Game #59941494882:  Hold'em No Limit ($0.50/$1.00) - 2009/07/01 1:37:12 ET
Table 'VOs36P6NW+QyXeQ1B62kmAE9S5sEoK9Q3olj2a53gABASeat #1 is the button
Seat 1: 4h8XtuVJtWh3DJpxGo7k5Q ($24.05 in chips)
Seat 2: y27w5IK2WXqmYzS8OU0wKA ($147.65 in chips)
Seat 3: p00KmyZiD/isPc/lZwNBTg ($23 in chips)
Seat 4: ene3nLSnQ4N961iBaUsSmA ($100 in chips)
Seat 5: o3YLm/rSY916m/on1VjXPA ($126.35 in chips)
Seat 6: slVKuQyEz8Qj4E3uLPYNXg ($45.95 in chips)
y27w5IK2WXqmYzS8OU0wKA: posts small blind $0.50
p00KmyZiD/isPc/lZwNBTg: posts big blind $1
*** HOLE CARDS ***
ene3nLSnQ4N961iBaUsSmA: raises $3 to $4
o3YLm/rSY916m/on1VjXPA: calls $4
slVKuQyEz8Qj4E3uLPYNXg: folds
4h8XtuVJtWh3DJpxGo7k5Q: folds
y27w5IK2WXqmYzS8OU0wKA: folds
p00KmyZiD/isPc/lZwNBTg: calls $3
*** FLOP *** [Tc Qh 7c]
p00KmyZiD/isPc/lZwNBTg: checks
ene3nLSnQ4N961iBaUsSmA: checks
o3YLm/rSY916m/on1VjXPA: checks
*** TURN *** [Tc Qh 7c] [Ad]
p00KmyZiD/isPc/lZwNBTg: bets $1
ene3nLSnQ4N961iBaUsSmA: folds
o3YLm/rSY916m/on1VjXPA: calls $1
*** RIVER *** [Tc Qh 7c Ad] [6c]
p00KmyZiD/isPc/lZwNBTg: bets $1
o3YLm/rSY916m/on1VjXPA: calls $1
*** SHOW DOWN ***
p00KmyZiD/isPc/lZwNBTg: shows [5c Kh] (high card Ace)
o3YLm/rSY916m/on1VjXPA: shows [Jh Js] (a pair of Jacks)
o3YLm/rSY916m/on1VjXPA collected $15.75 from pot
*** SUMMARY ***
Total pot $16.50 | Rake $0.75
Board [Tc Qh 7c Ad 6c]
Seat 1: 4h8XtuVJtWh3DJpxGo7k5Q (button) folded before Flop (didn't bet)
Seat 2: y27w5IK2WXqmYzS8OU0wKA (small blind) folded before Flop
Seat 3: p00KmyZiD/isPc/lZwNBTg (big blind) showed [5c Kh] and lost with high card Ace
Seat 4: ene3nLSnQ4N961iBaUsSmA folded on the Turn
Seat 5: o3YLm/rSY916m/on1VjXPA showed [Jh Js] and won ($15.75) with a pair of Jacks
Seat 6: slVKuQyEz8Qj4E3uLPYNXg folded before Flop (didn't bet)



PokerStars Game #59941495444:  Hold'em No Limit ($0.50/$1.00) - 2009/07/01 1:37:13 ET
Table 'qj0HBN4HhQKogreu1bg7xg' 2-max Seat #1 is the button
Seat 1: NYi6JFscYNrofSXy4sM+Yw ($108.20 in chips)
Seat 2: qtyl8CSb0/4yWdbuEPJejA ($170.80 in chips)
NYi6JFscYNrofSXy4sM+Yw: posts small blind $0.50
qtyl8CSb0/4yWdbuEPJejA: posts big blind $1
*** HOLE CARDS ***
NYi6JFscYNrofSXy4sM+Yw: raises $2 to $3
qtyl8CSb0/4yWdbuEPJejA: calls $2
*** FLOP *** [2d Tc 3h]
qtyl8CSb0/4yWdbuEPJejA: checks
NYi6JFscYNrofSXy4sM+Yw: bets $3
qtyl8CSb0/4yWdbuEPJejA: folds
NYi6JFscYNrofSXy4sM+Yw collected $5.70 from pot
*** SUMMARY ***
Total pot $6 | Rake $0.30
Board [2d Tc 3h]
Seat 1: NYi6JFscYNrofSXy4sM+Yw (button) (small blind) collected ($5.70)
Seat 2: qtyl8CSb0/4yWdbuEPJejA (big blind) folded on the Flop



PokerStars Game #59941495972:  Hold'em No Limit ($0.50/$1.00) - 2009/07/01 1:37:14 ET
Table 'N6LvHFrb+cdXY/COI6ByOw' 2-max Seat #1 is the button
Seat 1: lXX4W7m3u++JiSOZ46yVMQ ($94.70 in chips)
Seat 2: 9mAoSP3o/mikSZOW2LEEAw ($176.70 in chips)
lXX4W7m3u++JiSOZ46yVMQ: posts small blind $0.50
9mAoSP3o/mikSZOW2LEEAw: posts big blind $1
*** HOLE CARDS ***
lXX4W7m3u++JiSOZ46yVMQ: folds
9mAoSP3o/mikSZOW2LEEAw collected $1 from pot
*** SUMMARY ***
Total pot $1 | Rake $0
Seat 1: lXX4W7m3u++JiSOZ46yVMQ (button) (small blind) folded before Flop
Seat 2: 9mAoSP3o/mikSZOW2LEEAw (big blind) collected ($1)



PokerStars Game #59941497040:  Hold'em No Limit ($0.50/$1.00) - 2009/07/01 1:37:15 ET
Table 'MUPc8FEpe/nR0BKSeReX6Q' 6-max Seat #4 is the button
Seat 1: qhkK6+yCciTRd+rCFEbnEQ ($58.70 in chips)
Seat 2: xAU6q2/cwmby2sxmA8VcmA ($103.70 in chips)
Seat 3: wx3sQGkVi2x9wJXuWNHPBw ($287.65 in chips)
Seat 4: r4lpoh2BJZ8S6zyQv1JeSw ($108.50 in chips)
Seat 5: y27w5IK2WXqmYzS8OU0wKA ($104.45 in chips)
Seat 6: cl/QpVR/PLO58lj+C5mGLw ($51.20 in chips)
y27w5IK2WXqmYzS8OU0wKA: posts small blind $0.50
cl/QpVR/PLO58lj+C5mGLw: posts big blind $1
*** HOLE CARDS ***
qhkK6+yCciTRd+rCFEbnEQ: folds
xAU6q2/cwmby2sxmA8VcmA: folds
wx3sQGkVi2x9wJXuWNHPBw: folds
r4lpoh2BJZ8S6zyQv1JeSw: folds
y27w5IK2WXqmYzS8OU0wKA: folds
cl/QpVR/PLO58lj+C5mGLw collected $1 from pot
*** SUMMARY ***
Total pot $1 | Rake $0
Seat 1: qhkK6+yCciTRd+rCFEbnEQ folded before Flop (didn't bet)
Seat 2: xAU6q2/cwmby2sxmA8VcmA folded before Flop (didn't bet)
Seat 3: wx3sQGkVi2x9wJXuWNHPBw folded before Flop (didn't bet)
Seat 4: r4lpoh2BJZ8S6zyQv1JeSw (button) folded before Flop (didn't bet)
Seat 5: y27w5IK2WXqmYzS8OU0wKA (small blind) folded before Flop
Seat 6: cl/QpVR/PLO58lj+C5mGLw (big blind) collected ($1)



PokerStars Game #59941497014:  Hold'em No Limit ($0.50/$1.00) - 2009/07/01 1:37:15 ET
Table 'hugOjcwJvzEwZbK7tyiWuQ' 9-max Seat #7 is the button
Seat 1: S3Ex8K7v6xm5jqjRM7Fl3w ($22.35 in chips)
Seat 2: r27C1nIV4NS4+qbnrgBQSw ($278.60 in chips)
Seat 3: c/6hFCyfLNRn3VFvCeQ1ng ($36.55 in chips)
Seat 4: UWB3oeddt/GObx2Mix2Anw ($159.45 in chips)
Seat 5: AexZ4puUV9meFWwVU6Nv0w ($32.70 in chips)
Seat 6: gUUvmqdVlmvpal6B8nYrmg ($103.95 in chips)
Seat 7: FL3MrLspcF23LYvC4ipBOA ($109.80 in chips)
Seat 8: /zy+DB4S5fUQUSfZWFzYGw ($117.35 in chips)
Seat 9: W8P9bUKCs43TO1xHm0dL6w ($106.80 in chips)
/zy+DB4S5fUQUSfZWFzYGw: posts small blind $0.50
W8P9bUKCs43TO1xHm0dL6w: posts big blind $1
*** HOLE CARDS ***
S3Ex8K7v6xm5jqjRM7Fl3w: raises $1 to $2
r27C1nIV4NS4+qbnrgBQSw: folds
c/6hFCyfLNRn3VFvCeQ1ng: folds
UWB3oeddt/GObx2Mix2Anw: folds
AexZ4puUV9meFWwVU6Nv0w: folds
gUUvmqdVlmvpal6B8nYrmg: folds
FL3MrLspcF23LYvC4ipBOA: folds
/zy+DB4S5fUQUSfZWFzYGw: folds
W8P9bUKCs43TO1xHm0dL6w: folds
S3Ex8K7v6xm5jqjRM7Fl3w collected $2.50 from pot
*** SUMMARY ***
Total pot $2.50 | Rake $0
Seat 1: S3Ex8K7v6xm5jqjRM7Fl3w collected ($2.50)
Seat 2: r27C1nIV4NS4+qbnrgBQSw folded before Flop (didn't bet)
Seat 3: c/6hFCyfLNRn3VFvCeQ1ng folded before Flop (didn't bet)
Seat 4: UWB3oeddt/GObx2Mix2Anw folded before Flop (didn't bet)
Seat 5: AexZ4puUV9meFWwVU6Nv0w folded before Flop (didn't bet)
Seat 6: gUUvmqdVlmvpal6B8nYrmg folded before Flop (didn't bet)
Seat 7: FL3MrLspcF23LYvC4ipBOA (button) folded before Flop (didn't bet)
Seat 8: /zy+DB4S5fUQUSfZWFzYGw (small blind) folded before Flop
Seat 9: W8P9bUKCs43TO1xHm0dL6w (big blind) folded before Flop



PokerStars Game #59941497562:  Hold'em No Limit ($0.50/$1.00) - 2009/07/01 1:37:16 ET
Table 'QSIig7BLMc9wY/rgBechzw' 6-max Seat #1 is the button
Seat 1: Z2fXsGcjl+Eax+RzOgwOmg ($113.05 in chips)
Seat 2: mLOIkH/qmRa+mVujQIhBRg ($26.45 in chips)
Seat 3: 4OO5v3AVduL0tePNx8wk5A ($100 in chips)
Seat 4: +uSzP8Jwnw7sKfQ4s66b7w ($59.30 in chips)
Seat 5: lsLuWlcPA3Rh7kJVLzMh0Q ($100.20 in chips)
Seat 6: PxqfkAMdAWtkgbT+q2gciA ($68.25 in chips)
mLOIkH/qmRa+mVujQIhBRg: posts small blind $0.50
4OO5v3AVduL0tePNx8wk5A: posts big blind $1
*** HOLE CARDS ***
+uSzP8Jwnw7sKfQ4s66b7w: folds
lsLuWlcPA3Rh7kJVLzMh0Q: folds
PxqfkAMdAWtkgbT+q2gciA: folds
PxqfkAMdAWtkgbT+q2gciA leaves the table
Z2fXsGcjl+Eax+RzOgwOmg: raises $2 to $3
mLOIkH/qmRa+mVujQIhBRg: folds
4OO5v3AVduL0tePNx8wk5A: raises $7 to $10
Z2fXsGcjl+Eax+RzOgwOmg: folds
4OO5v3AVduL0tePNx8wk5A collected $6.50 from pot
4OO5v3AVduL0tePNx8wk5A: doesn't show hand
*** SUMMARY ***
Total pot $6.50 | Rake $0
Seat 1: Z2fXsGcjl+Eax+RzOgwOmg (button) folded before Flop
Seat 2: mLOIkH/qmRa+mVujQIhBRg (small blind) folded before Flop
Seat 3: 4OO5v3AVduL0tePNx8wk5A (big blind) collected ($6.50)
Seat 4: +uSzP8Jwnw7sKfQ4s66b7w folded before Flop (didn't bet)
Seat 5: lsLuWlcPA3Rh7kJVLzMh0Q folded before Flop (didn't bet)
Seat 6: PxqfkAMdAWtkgbT+q2gciA folded before Flop (didn't bet)



PokerStars Game #59941498006:  Hold'em No Limit ($0.50/$1.00) - 2009/07/01 1:37:17 ET
Table 'W/wyObTiXZm+Ckkl3YxcSw' 6-max Seat #4 is the button
Seat 1: eUBBn2R56C1IQ6Cs/vitwg ($279.05 in chips)
Seat 2: oDiBRCaF0QVtd3kO6xZIXw ($116.90 in chips)
Seat 4: UBZQqpnJZdTYYY1FTb0rLA ($156.70 in chips)
Seat 5: +OrCjyw70oZhJiD22Mn+bg ($104.50 in chips)
+OrCjyw70oZhJiD22Mn+bg: posts small blind $0.50
eUBBn2R56C1IQ6Cs/vitwg: posts big blind $1
*** HOLE CARDS ***
oDiBRCaF0QVtd3kO6xZIXw: folds
UBZQqpnJZdTYYY1FTb0rLA: folds
+OrCjyw70oZhJiD22Mn+bg: folds
eUBBn2R56C1IQ6Cs/vitwg collected $1 from pot
*** SUMMARY ***
Total pot $1 | Rake $0
Seat 1: eUBBn2R56C1IQ6Cs/vitwg (big blind) collected ($1)
Seat 2: oDiBRCaF0QVtd3kO6xZIXw folded before Flop (didn't bet)
Seat 4: UBZQqpnJZdTYYY1FTb0rLA (button) folded before Flop (didn't bet)
Seat 5: +OrCjyw70oZhJiD22Mn+bg (small blind) folded before Flop



PokerStars Game #59941498512:  Hold'em No Limit ($0.50/$1.00) - 2009/07/01 1:37:18 ET
Table '7O9fB8yx1u7sJveJn8w6jA' 6-max Seat #6 is the button
Seat 1: 841740 ($54.80 in chips)
Seat 2: wx3sQGkVi2x9wJXuWNHPBw ($201.80 in chips)
Seat 3: hpxXcmRkXXI9HE5+5/j/0Q ($136.90 in chips)
Seat 5: BCEV3COoKY607AzLWayfRA ($100.50 in chips)
Seat 6: r4lpoh2BJZ8S6zyQv1JeSw ($100 in chips)
841740: posts small blind $0.50
wx3sQGkVi2x9wJXuWNHPBw: posts big blind $1
*** HOLE CARDS ***
hpxXcmRkXXI9HE5+5/j/0Q: folds
BCEV3COoKY607AzLWayfRA: folds
r4lpoh2BJZ8S6zyQv1JeSw: raises $2 to $3
b2a+5TkFf4xJN/Ihhma58Q has returned
841740: calls $2.50
wx3sQGkVi2x9wJXuWNHPBw: calls $2
*** FLOP *** [4c Js Tc]
841740: checks
wx3sQGkVi2x9wJXuWNHPBw: bets $6
r4lpoh2BJZ8S6zyQv1JeSw: folds
841740: folds
wx3sQGkVi2x9wJXuWNHPBw collected $8.55 from pot
*** SUMMARY ***
Total pot $9 | Rake $0.45
Board [4c Js Tc]
Seat 1: 841740 (small blind) folded on the Flop
Seat 2: wx3sQGkVi2x9wJXuWNHPBw (big blind) collected ($8.55)
Seat 3: hpxXcmRkXXI9HE5+5/j/0Q folded before Flop (didn't bet)
Seat 5: BCEV3COoKY607AzLWayfRA folded before Flop (didn't bet)
Seat 6: r4lpoh2BJZ8S6zyQv1JeSw (button) folded on the Flop



PokerStars Game #59941498984:  Hold'em No Limit ($0.50/$1.00) - 2009/07/01 1:37:19 ET
Table 'N6LvHFrb+cdXY/COI6ByOw' 2-max Seat #2 is the button
Seat 1: lXX4W7m3u++JiSOZ46yVMQ ($94.20 in chips)
Seat 2: 9mAoSP3o/mikSZOW2LEEAw ($177.20 in chips)
9mAoSP3o/mikSZOW2LEEAw: posts small blind $0.50
lXX4W7m3u++JiSOZ46yVMQ: posts big blind $1
*** HOLE CARDS ***
9mAoSP3o/mikSZOW2LEEAw: raises $1 to $2
lXX4W7m3u++JiSOZ46yVMQ: calls $1
*** FLOP *** [2d Qs 8c]
lXX4W7m3u++JiSOZ46yVMQ: checks
9mAoSP3o/mikSZOW2LEEAw: checks
*** TURN *** [2d Qs 8c] [5d]
lXX4W7m3u++JiSOZ46yVMQ: checks
9mAoSP3o/mikSZOW2LEEAw: bets $3
lXX4W7m3u++JiSOZ46yVMQ: folds
9mAoSP3o/mikSZOW2LEEAw collected $3.80 from pot
9mAoSP3o/mikSZOW2LEEAw: shows [Jd 8d] (a pair of Eights)
*** SUMMARY ***
Total pot $4 | Rake $0.20
Board [2d Qs 8c 5d]
Seat 1: lXX4W7m3u++JiSOZ46yVMQ (big blind) folded on the Turn
Seat 2: 9mAoSP3o/mikSZOW2LEEAw (button) (small blind) collected ($3.80)



PokerStars Game #59941499462:  Hold'em No Limit ($0.50/$1.00) - 2009/07/01 1:37:20 ET
Table '+cA8mcmhaedZ7YcrDdhmeQ' 6-max Seat #4 is the button
Seat 1: 9XrTM0DuVxx1pjFAdSbD8A ($49.70 in chips)
Seat 2: 14aYclSc98EYd6TrzN2l3Q ($53.90 in chips)
Seat 3: DAIgyIWbYvAkL6PbAI27pg ($20 in chips)
Seat 4: 4OO5v3AVduL0tePNx8wk5A ($100 in chips)
Seat 5: RqgF7gRoKgRNW8Zoi1ty4A ($161.30 in chips)
Seat 6: YfsTQsY/fxb+YqbdclTHuw ($57.15 in chips)
RqgF7gRoKgRNW8Zoi1ty4A: posts small blind $0.50
YfsTQsY/fxb+YqbdclTHuw: posts big blind $1
*** HOLE CARDS ***
9XrTM0DuVxx1pjFAdSbD8A: folds
14aYclSc98EYd6TrzN2l3Q: calls $1
DAIgyIWbYvAkL6PbAI27pg: folds
4OO5v3AVduL0tePNx8wk5A: raises $4 to $5
RqgF7gRoKgRNW8Zoi1ty4A: folds
9XrTM0DuVxx1pjFAdSbD8A leaves the table
YfsTQsY/fxb+YqbdclTHuw: folds
14aYclSc98EYd6TrzN2l3Q: calls $4
*** FLOP *** [Kc 9d 8d]
RqgF7gRoKgRNW8Zoi1ty4A leaves the table
VB7TtBnfmT3JTA/cCL6dJg joins the table at seat #1
14aYclSc98EYd6TrzN2l3Q: checks
4OO5v3AVduL0tePNx8wk5A: bets $8.50
14aYclSc98EYd6TrzN2l3Q: calls $8.50
*** TURN *** [Kc 9d 8d] [Kd]
SJieaES+gCAfonfNNMCP6w joins the table at seat #5
14aYclSc98EYd6TrzN2l3Q: checks
4OO5v3AVduL0tePNx8wk5A: checks
*** RIVER *** [Kc 9d 8d Kd] [Jd]
14aYclSc98EYd6TrzN2l3Q: bets $13
4OO5v3AVduL0tePNx8wk5A: folds
14aYclSc98EYd6TrzN2l3Q collected $27.15 from pot
*** SUMMARY ***
Total pot $28.50 | Rake $1.35
Board [Kc 9d 8d Kd Jd]
Seat 1: 9XrTM0DuVxx1pjFAdSbD8A folded before Flop (didn't bet)
Seat 2: 14aYclSc98EYd6TrzN2l3Q collected ($27.15)
Seat 3: DAIgyIWbYvAkL6PbAI27pg folded before Flop (didn't bet)
Seat 4: 4OO5v3AVduL0tePNx8wk5A (button) folded on the River
Seat 5: RqgF7gRoKgRNW8Zoi1ty4A (small blind) folded before Flop
Seat 6: YfsTQsY/fxb+YqbdclTHuw (big blind) folded before Flop



PokerStars Game #59941500672:  Hold'em No Limit ($0.50/$1.00) - 2009/07/01 1:37:22 ET
Table 'tHb+N6GaPEmmBAe36B2R9Q' 2-max Seat #2 is the button
Seat 1: rL+Zpv4/vX2BVHcyfh/NXA ($106.50 in chips)
Seat 2: Pm1sDZZi0zFtnFGXLznkug ($126.30 in chips)
Pm1sDZZi0zFtnFGXLznkug: posts small blind $0.50
rL+Zpv4/vX2BVHcyfh/NXA: posts big blind $1
*** HOLE CARDS ***
Pm1sDZZi0zFtnFGXLznkug said, "grr"
Pm1sDZZi0zFtnFGXLznkug: folds
Pm1sDZZi0zFtnFGXLznkug said, "mh"
rL+Zpv4/vX2BVHcyfh/NXA collected $1 from pot
rL+Zpv4/vX2BVHcyfh/NXA: doesn't show hand
*** SUMMARY ***
Total pot $1 | Rake $0
Seat 1: rL+Zpv4/vX2BVHcyfh/NXA (big blind) collected ($1)
Seat 2: Pm1sDZZi0zFtnFGXLznkug (button) (small blind) folded before Flop



PokerStars Game #59941501952:  Hold'em No Limit ($0.50/$1.00) - 2009/07/01 1:37:24 ET
Table 'qj0HBN4HhQKogreu1bg7xg' 2-max Seat #2 is the button
Seat 1: NYi6JFscYNrofSXy4sM+Yw ($110.90 in chips)
Seat 2: qtyl8CSb0/4yWdbuEPJejA ($167.80 in chips)
qtyl8CSb0/4yWdbuEPJejA: posts small blind $0.50
NYi6JFscYNrofSXy4sM+Yw: posts big blind $1
*** HOLE CARDS ***
qtyl8CSb0/4yWdbuEPJejA: raises $2 to $3
NYi6JFscYNrofSXy4sM+Yw: folds
qtyl8CSb0/4yWdbuEPJejA collected $2 from pot
qtyl8CSb0/4yWdbuEPJejA: doesn't show hand
*** SUMMARY ***
Total pot $2 | Rake $0
Seat 1: NYi6JFscYNrofSXy4sM+Yw (big blind) folded before Flop
Seat 2: qtyl8CSb0/4yWdbuEPJejA (button) (small blind) collected ($2)



PokerStars Game #59941502454:  Hold'em No Limit ($0.50/$1.00) - 2009/07/01 1:37:25 ET
Table 'GxCPo/gd3OSthkYrAxJngg' 6-max Seat #5 is the button
Seat 1: sH8BpAFP+jGFxCgVpD1Lew ($235.90 in chips)
Seat 2: YExX2paeIHrmfIwV1ivM/w ($63.10 in chips)
Seat 3: idVgoPAdspFPCzee6aF9Pg ($134.50 in chips)
Seat 4: YMJG+F++3Aj6P8dAWda5fw ($205.35 in chips)
Seat 5: vX+iYAEINFeLxwMla7DY1Q ($98.50 in chips)
Seat 6: 4d1rWhpu8DzLmzMbR3QKyA ($100.50 in chips)
4d1rWhpu8DzLmzMbR3QKyA: posts small blind $0.50
sH8BpAFP+jGFxCgVpD1Lew: posts big blind $1
*** HOLE CARDS ***
YExX2paeIHrmfIwV1ivM/w: folds
idVgoPAdspFPCzee6aF9Pg: folds
YMJG+F++3Aj6P8dAWda5fw: folds
vX+iYAEINFeLxwMla7DY1Q: folds
4d1rWhpu8DzLmzMbR3QKyA: raises $3 to $4
sH8BpAFP+jGFxCgVpD1Lew: calls $3
*** FLOP *** [6d Qc 3h]
4d1rWhpu8DzLmzMbR3QKyA: bets $6
sH8BpAFP+jGFxCgVpD1Lew: calls $6
*** TURN *** [6d Qc 3h] [Js]
4d1rWhpu8DzLmzMbR3QKyA: bets $14
sH8BpAFP+jGFxCgVpD1Lew: folds
4d1rWhpu8DzLmzMbR3QKyA collected $19.05 from pot
*** SUMMARY ***
Total pot $20 | Rake $0.95
Board [6d Qc 3h Js]
Seat 1: sH8BpAFP+jGFxCgVpD1Lew (big blind) folded on the Turn
Seat 2: YExX2paeIHrmfIwV1ivM/w folded before Flop (didn't bet)
Seat 3: idVgoPAdspFPCzee6aF9Pg folded before Flop (didn't bet)
Seat 4: YMJG+F++3Aj6P8dAWda5fw folded before Flop (didn't bet)
Seat 5: vX+iYAEINFeLxwMla7DY1Q (button) folded before Flop (didn't bet)
Seat 6: 4d1rWhpu8DzLmzMbR3QKyA (small blind) collected ($19.05)



PokerStars Game #59941502888:  Hold'em No Limit ($0.50/$1.00) - 2009/07/01 1:37:26 ET
Table 'mmbQQVBTrPdE+wy+s+9VPA' 6-max Seat #4 is the button
Seat 1: zyP4SPoWZnKUfTvIRLCVog ($70.65 in chips)
Seat 2: XK4Qsl+DA8gAJyg85/zBIw ($26.60 in chips)
Seat 3: wx3sQGkVi2x9wJXuWNHPBw ($239.10 in chips)
Seat 4: V3iZdcw61nXF3g5hD2RrsQ ($100.05 in chips)
Seat 5: YMJG+F++3Aj6P8dAWda5fw ($134.20 in chips)
Seat 6: UOHYuj23MyK9R8ciY2t6FA ($100 in chips)
YMJG+F++3Aj6P8dAWda5fw: posts small blind $0.50
UOHYuj23MyK9R8ciY2t6FA: posts big blind $1
*** HOLE CARDS ***
zyP4SPoWZnKUfTvIRLCVog: calls $1
XK4Qsl+DA8gAJyg85/zBIw: raises $2 to $3
wx3sQGkVi2x9wJXuWNHPBw: folds
V3iZdcw61nXF3g5hD2RrsQ: folds
YMJG+F++3Aj6P8dAWda5fw: folds
UOHYuj23MyK9R8ciY2t6FA: folds
zyP4SPoWZnKUfTvIRLCVog: calls $2
*** FLOP *** [Kc 4h 7s]
zyP4SPoWZnKUfTvIRLCVog: checks
XK4Qsl+DA8gAJyg85/zBIw: bets $3
zyP4SPoWZnKUfTvIRLCVog: calls $3
*** TURN *** [Kc 4h 7s] [5c]
zyP4SPoWZnKUfTvIRLCVog: checks
XK4Qsl+DA8gAJyg85/zBIw: checks
*** RIVER *** [Kc 4h 7s 5c] [Js]
zyP4SPoWZnKUfTvIRLCVog: bets $3
XK4Qsl+DA8gAJyg85/zBIw: calls $3
*** SHOW DOWN ***
zyP4SPoWZnKUfTvIRLCVog: shows [Ks Qh] (a pair of Kings)
XK4Qsl+DA8gAJyg85/zBIw: mucks hand
zyP4SPoWZnKUfTvIRLCVog collected $18.60 from pot
*** SUMMARY ***
Total pot $19.50 | Rake $0.90
Board [Kc 4h 7s 5c Js]
Seat 1: zyP4SPoWZnKUfTvIRLCVog showed [Ks Qh] and won ($18.60) with a pair of Kings
Seat 2: XK4Qsl+DA8gAJyg85/zBIw mucked
Seat 3: wx3sQGkVi2x9wJXuWNHPBw folded before Flop (didn't bet)
Seat 4: V3iZdcw61nXF3g5hD2RrsQ (button) folded before Flop (didn't bet)
Seat 5: YMJG+F++3Aj6P8dAWda5fw (small blind) folded before Flop
Seat 6: UOHYuj23MyK9R8ciY2t6FA (big blind) folded before Flop



PokerStars Game #59941503622:  Hold'em No Limit ($0.50/$1.00) - 2009/07/01 1:37:27 ET
Table 'W/wyObTiXZm+Ckkl3YxcSw' 6-max Seat #5 is the button
Seat 1: eUBBn2R56C1IQ6Cs/vitwg ($279.55 in chips)
Seat 2: oDiBRCaF0QVtd3kO6xZIXw ($116.90 in chips)
Seat 4: UBZQqpnJZdTYYY1FTb0rLA ($156.70 in chips)
Seat 5: +OrCjyw70oZhJiD22Mn+bg ($104 in chips)
eUBBn2R56C1IQ6Cs/vitwg: posts small blind $0.50
oDiBRCaF0QVtd3kO6xZIXw: posts big blind $1
*** HOLE CARDS ***
UBZQqpnJZdTYYY1FTb0rLA: folds
b2a+5TkFf4xJN/Ihhma58Q has returned
+OrCjyw70oZhJiD22Mn+bg: raises $3 to $4
4OO5v3AVduL0tePNx8wk5A joins the table at seat #3
eUBBn2R56C1IQ6Cs/vitwg: calls $3.50
oDiBRCaF0QVtd3kO6xZIXw: folds
*** FLOP *** [3c 7s 6s]
eUBBn2R56C1IQ6Cs/vitwg: checks
+OrCjyw70oZhJiD22Mn+bg: bets $7
eUBBn2R56C1IQ6Cs/vitwg: raises $15 to $22
+OrCjyw70oZhJiD22Mn+bg: raises $78 to $100 and is all-in
eUBBn2R56C1IQ6Cs/vitwg: calls $78
*** TURN *** [3c 7s 6s] [2h]
*** RIVER *** [3c 7s 6s 2h] [Ks]
*** SHOW DOWN ***
eUBBn2R56C1IQ6Cs/vitwg: shows [6d 6c] (three of a kind, Sixes)
+OrCjyw70oZhJiD22Mn+bg: shows [Kh Kc] (three of a kind, Kings)
+OrCjyw70oZhJiD22Mn+bg collected $207 from pot
*** SUMMARY ***
Total pot $209 | Rake $2
Board [3c 7s 6s 2h Ks]
Seat 1: eUBBn2R56C1IQ6Cs/vitwg (small blind) showed [6d 6c] and lost with three of a kind, Sixes
Seat 2: oDiBRCaF0QVtd3kO6xZIXw (big blind) folded before Flop
Seat 4: UBZQqpnJZdTYYY1FTb0rLA folded before Flop (didn't bet)
Seat 5: +OrCjyw70oZhJiD22Mn+bg (button) showed [Kh Kc] and won ($207) with three of a kind, Kings



PokerStars Game #59941503840:  Hold'em No Limit ($0.50/$1.00) - 2009/07/01 1:37:28 ET
Table '/RZcOwpZpHQ+OwPwjsbnRw' 6-max Seat #3 is the button
Seat 1: +uSzP8Jwnw7sKfQ4s66b7w ($88.90 in chips)
Seat 2: Z2fXsGcjl+Eax+RzOgwOmg ($100 in chips)
Seat 3: LJMw/I77xpnw0R5T4HnMUg ($107.15 in chips)
Seat 4: j7NIOHLZk7V2o9fOioO5ug ($100 in chips)
Seat 5: wx3sQGkVi2x9wJXuWNHPBw ($165.75 in chips)
Seat 6: o3YLm/rSY916m/on1VjXPA ($207 in chips)
j7NIOHLZk7V2o9fOioO5ug: posts small blind $0.50
wx3sQGkVi2x9wJXuWNHPBw: posts big blind $1
*** HOLE CARDS ***
o3YLm/rSY916m/on1VjXPA: folds
+uSzP8Jwnw7sKfQ4s66b7w: folds
Z2fXsGcjl+Eax+RzOgwOmg: folds
LJMw/I77xpnw0R5T4HnMUg: folds
j7NIOHLZk7V2o9fOioO5ug: raises $3 to $4
wx3sQGkVi2x9wJXuWNHPBw: folds
j7NIOHLZk7V2o9fOioO5ug collected $2 from pot
j7NIOHLZk7V2o9fOioO5ug: doesn't show hand
*** SUMMARY ***
Total pot $2 | Rake $0
Seat 1: +uSzP8Jwnw7sKfQ4s66b7w folded before Flop (didn't bet)
Seat 2: Z2fXsGcjl+Eax+RzOgwOmg folded before Flop (didn't bet)
Seat 3: LJMw/I77xpnw0R5T4HnMUg (button) folded before Flop (didn't bet)
Seat 4: j7NIOHLZk7V2o9fOioO5ug (small blind) collected ($2)
Seat 5: wx3sQGkVi2x9wJXuWNHPBw (big blind) folded before Flop
Seat 6: o3YLm/rSY916m/on1VjXPA folded before Flop (didn't bet)



PokerStars Game #59941504550:  Hold'em No Limit ($0.50/$1.00) - 2009/07/01 1:37:29 ET
Table 'rmZfTK+oSebeUPJNbWhdAA' 6-max Seat #6 is the button
Seat 1: xAU6q2/cwmby2sxmA8VcmA ($132 in chips)
Seat 2: z7O9PO/WEcqRouIydFhS9Q ($188 in chips)
Seat 3: BCEV3COoKY607AzLWayfRA ($195.30 in chips)
Seat 4: 1/mIuXfgx1ZyVkodrmfQDw ($172.15 in chips)
Seat 5: BWhgxe7gWiYobRbwdG+d2Q ($100 in chips)
Seat 6: j7NIOHLZk7V2o9fOioO5ug ($100 in chips)
xAU6q2/cwmby2sxmA8VcmA: posts small blind $0.50
z7O9PO/WEcqRouIydFhS9Q: posts big blind $1
*** HOLE CARDS ***
BCEV3COoKY607AzLWayfRA: folds
1/mIuXfgx1ZyVkodrmfQDw: folds
BWhgxe7gWiYobRbwdG+d2Q: folds
j7NIOHLZk7V2o9fOioO5ug: folds
xAU6q2/cwmby2sxmA8VcmA: folds
z7O9PO/WEcqRouIydFhS9Q collected $1 from pot
*** SUMMARY ***
Total pot $1 | Rake $0
Seat 1: xAU6q2/cwmby2sxmA8VcmA (small blind) folded before Flop
Seat 2: z7O9PO/WEcqRouIydFhS9Q (big blind) collected ($1)
Seat 3: BCEV3COoKY607AzLWayfRA folded before Flop (didn't bet)
Seat 4: 1/mIuXfgx1ZyVkodrmfQDw folded before Flop (didn't bet)
Seat 5: BWhgxe7gWiYobRbwdG+d2Q folded before Flop (didn't bet)
Seat 6: j7NIOHLZk7V2o9fOioO5ug (button) folded before Flop (didn't bet)



PokerStars Game #59941505138:  Hold'em No Limit ($0.50/$1.00) - 2009/07/01 1:37:30 ET
Table 'tHb+N6GaPEmmBAe36B2R9Q' 2-max Seat #1 is the button
Seat 1: rL+Zpv4/vX2BVHcyfh/NXA ($107 in chips)
Seat 2: Pm1sDZZi0zFtnFGXLznkug ($125.80 in chips)
rL+Zpv4/vX2BVHcyfh/NXA: posts small blind $0.50
Pm1sDZZi0zFtnFGXLznkug: posts big blind $1
*** HOLE CARDS ***
rL+Zpv4/vX2BVHcyfh/NXA: raises $2 to $3
Pm1sDZZi0zFtnFGXLznkug: folds
rL+Zpv4/vX2BVHcyfh/NXA collected $2 from pot
rL+Zpv4/vX2BVHcyfh/NXA: doesn't show hand
*** SUMMARY ***
Total pot $2 | Rake $0
Seat 1: rL+Zpv4/vX2BVHcyfh/NXA (button) (small blind) collected ($2)
Seat 2: Pm1sDZZi0zFtnFGXLznkug (big blind) folded before Flop



PokerStars Game #59941506426:  Hold'em No Limit ($0.50/$1.00) - 2009/07/01 1:37:33 ET
Table 'qj0HBN4HhQKogreu1bg7xg' 2-max Seat #1 is the button
Seat 1: NYi6JFscYNrofSXy4sM+Yw ($109.90 in chips)
Seat 2: qtyl8CSb0/4yWdbuEPJejA ($168.80 in chips)
NYi6JFscYNrofSXy4sM+Yw: posts small blind $0.50
qtyl8CSb0/4yWdbuEPJejA: posts big blind $1
*** HOLE CARDS ***
NYi6JFscYNrofSXy4sM+Yw: folds
qtyl8CSb0/4yWdbuEPJejA collected $1 from pot
qtyl8CSb0/4yWdbuEPJejA: doesn't show hand
*** SUMMARY ***
Total pot $1 | Rake $0
Seat 1: NYi6JFscYNrofSXy4sM+Yw (button) (small blind) folded before Flop
Seat 2: qtyl8CSb0/4yWdbuEPJejA (big blind) collected ($1)



PokerStars Game #59941507282:  Hold'em No Limit ($0.50/$1.00) - 2009/07/01 1:37:34 ET
Table 'NqGO/cV3MwFAx+ZPB5ANmQ' 2-max Seat #1 is the button
Seat 1: ItaRAnHOgvYOv5ynbG1iTw ($226.70 in chips)
Seat 2: GtFB+yyeb2djMdPFuOW/Xg ($111 in chips)
ItaRAnHOgvYOv5ynbG1iTw: posts small blind $0.50
GtFB+yyeb2djMdPFuOW/Xg: posts big blind $1
*** HOLE CARDS ***
ItaRAnHOgvYOv5ynbG1iTw: folds
GtFB+yyeb2djMdPFuOW/Xg collected $1 from pot
*** SUMMARY ***
Total pot $1 | Rake $0
Seat 1: ItaRAnHOgvYOv5ynbG1iTw (button) (small blind) folded before Flop
Seat 2: GtFB+yyeb2djMdPFuOW/Xg (big blind) collected ($1)



PokerStars Game #59941508392:  Hold'em No Limit ($0.50/$1.00) - 2009/07/01 1:37:36 ET
Table 'CASNP0uy1C+jGLml/I4PtA' 9-max Seat #1 is the button
Seat 1: tkdBeXTJlFsZdioidNqLow ($70.60 in chips)
Seat 2: Ogn4JDV3mp4ZDKO49IFzKA ($22 in chips)
Seat 4: B/G0GJacqZ8K59/ZVdq4kQ ($22.05 in chips)
Seat 5: Jjc7EHWzs4//xUAjJ0UWoA ($12 in chips)
Seat 6: FJEywSpo5JbRKByzmweboA ($130.40 in chips)
Seat 7: S3Ex8K7v6xm5jqjRM7Fl3w ($20.50 in chips)
Seat 8: L9njYvloJ1NdXjP8edHEAg ($102.95 in chips)
Seat 9: Pp/KTcXkfZKKUHkjyaLTdg ($22.60 in chips)
Ogn4JDV3mp4ZDKO49IFzKA: posts small blind $0.50
B/G0GJacqZ8K59/ZVdq4kQ: posts big blind $1
*** HOLE CARDS ***
Jjc7EHWzs4//xUAjJ0UWoA: calls $1
FJEywSpo5JbRKByzmweboA: folds
S3Ex8K7v6xm5jqjRM7Fl3w: folds
L9njYvloJ1NdXjP8edHEAg: folds
Pp/KTcXkfZKKUHkjyaLTdg: folds
tkdBeXTJlFsZdioidNqLow: folds
Ogn4JDV3mp4ZDKO49IFzKA: calls $0.50
B/G0GJacqZ8K59/ZVdq4kQ: checks
*** FLOP *** [6d 4h Js]
Ogn4JDV3mp4ZDKO49IFzKA: bets $1
B/G0GJacqZ8K59/ZVdq4kQ: folds
Jjc7EHWzs4//xUAjJ0UWoA: folds
Ogn4JDV3mp4ZDKO49IFzKA collected $2.85 from pot
*** SUMMARY ***
Total pot $3 | Rake $0.15
Board [6d 4h Js]
Seat 1: tkdBeXTJlFsZdioidNqLow (button) folded before Flop (didn't bet)
Seat 2: Ogn4JDV3mp4ZDKO49IFzKA (small blind) collected ($2.85)
Seat 4: B/G0GJacqZ8K59/ZVdq4kQ (big blind) folded on the Flop
Seat 5: Jjc7EHWzs4//xUAjJ0UWoA folded on the Flop
Seat 6: FJEywSpo5JbRKByzmweboA folded before Flop (didn't bet)
Seat 7: S3Ex8K7v6xm5jqjRM7Fl3w folded before Flop (didn't bet)
Seat 8: L9njYvloJ1NdXjP8edHEAg folded before Flop (didn't bet)
Seat 9: Pp/KTcXkfZKKUHkjyaLTdg folded before Flop (didn't bet)



PokerStars Game #59941509262:  Hold'em No Limit ($0.50/$1.00) - 2009/07/01 1:37:38 ET
Table 'vs/5jr6ciwjVQ5+Soc+u2A' 6-max Seat #6 is the button
Seat 1: J798qwLuvXyq0BbzsIjOrA ($194.15 in chips)
Seat 2: lXX4W7m3u++JiSOZ46yVMQ ($100 in chips)
Seat 3: Ws/3Uo3rQIk8hLgW0P+2xA ($99 in chips)
Seat 4: 0smcry9L0OOTCP+KzIS5SA ($101 in chips)
Seat 5: +Nt3OPk3XR9SKjZgm2CexQ ($159.35 in chips)
Seat 6: Z2fXsGcjl+Eax+RzOgwOmg ($103 in chips)
J798qwLuvXyq0BbzsIjOrA: posts small blind $0.50
lXX4W7m3u++JiSOZ46yVMQ: posts big blind $1
*** HOLE CARDS ***
Ws/3Uo3rQIk8hLgW0P+2xA: folds
0smcry9L0OOTCP+KzIS5SA: raises $2 to $3
+Nt3OPk3XR9SKjZgm2CexQ: folds
Z2fXsGcjl+Eax+RzOgwOmg: raises $9 to $12
J798qwLuvXyq0BbzsIjOrA: folds
lXX4W7m3u++JiSOZ46yVMQ: folds
0smcry9L0OOTCP+KzIS5SA: folds
Z2fXsGcjl+Eax+RzOgwOmg collected $7.50 from pot
Z2fXsGcjl+Eax+RzOgwOmg: doesn't show hand
*** SUMMARY ***
Total pot $7.50 | Rake $0
Seat 1: J798qwLuvXyq0BbzsIjOrA (small blind) folded before Flop
Seat 2: lXX4W7m3u++JiSOZ46yVMQ (big blind) folded before Flop
Seat 3: Ws/3Uo3rQIk8hLgW0P+2xA folded before Flop (didn't bet)
Seat 4: 0smcry9L0OOTCP+KzIS5SA folded before Flop
Seat 5: +Nt3OPk3XR9SKjZgm2CexQ folded before Flop (didn't bet)
Seat 6: Z2fXsGcjl+Eax+RzOgwOmg (button) collected ($7.50)



PokerStars Game #59941510238:  Hold'em No Limit ($0.50/$1.00) - 2009/07/01 1:37:39 ET
Table 'MUPc8FEpe/nR0BKSeReX6Q' 6-max Seat #5 is the button
Seat 1: qhkK6+yCciTRd+rCFEbnEQ ($58.70 in chips)
Seat 2: xAU6q2/cwmby2sxmA8VcmA ($103.70 in chips)
Seat 3: wx3sQGkVi2x9wJXuWNHPBw ($287.65 in chips)
Seat 4: r4lpoh2BJZ8S6zyQv1JeSw ($108.50 in chips)
Seat 5: y27w5IK2WXqmYzS8OU0wKA ($103.95 in chips)
Seat 6: cl/QpVR/PLO58lj+C5mGLw ($51.70 in chips)
cl/QpVR/PLO58lj+C5mGLw: posts small blind $0.50
qhkK6+yCciTRd+rCFEbnEQ: posts big blind $1
*** HOLE CARDS ***
xAU6q2/cwmby2sxmA8VcmA: folds
wx3sQGkVi2x9wJXuWNHPBw: folds
r4lpoh2BJZ8S6zyQv1JeSw: folds
y27w5IK2WXqmYzS8OU0wKA: raises $2 to $3
cl/QpVR/PLO58lj+C5mGLw: calls $2.50
qhkK6+yCciTRd+rCFEbnEQ: folds
*** FLOP *** [6d 3s 5h]
cl/QpVR/PLO58lj+C5mGLw: checks
y27w5IK2WXqmYzS8OU0wKA: checks
*** TURN *** [6d 3s 5h] [Ah]
cl/QpVR/PLO58lj+C5mGLw: checks
y27w5IK2WXqmYzS8OU0wKA: bets $4
cl/QpVR/PLO58lj+C5mGLw: calls $4
*** RIVER *** [6d 3s 5h Ah] [Jh]
cl/QpVR/PLO58lj+C5mGLw: bets $7
y27w5IK2WXqmYzS8OU0wKA: raises $15 to $22
cl/QpVR/PLO58lj+C5mGLw: calls $15
*** SHOW DOWN ***
y27w5IK2WXqmYzS8OU0wKA: shows [9h 8h] (a flush, Ace high)
cl/QpVR/PLO58lj+C5mGLw: mucks hand
y27w5IK2WXqmYzS8OU0wKA collected $56.10 from pot
*** SUMMARY ***
Total pot $59 | Rake $2.90
Board [6d 3s 5h Ah Jh]
Seat 1: qhkK6+yCciTRd+rCFEbnEQ (big blind) folded before Flop
Seat 2: xAU6q2/cwmby2sxmA8VcmA folded before Flop (didn't bet)
Seat 3: wx3sQGkVi2x9wJXuWNHPBw folded before Flop (didn't bet)
Seat 4: r4lpoh2BJZ8S6zyQv1JeSw folded before Flop (didn't bet)
Seat 5: y27w5IK2WXqmYzS8OU0wKA (button) showed [9h 8h] and won ($56.10) with a flush, Ace high
Seat 6: cl/QpVR/PLO58lj+C5mGLw (small blind) mucked



PokerStars Game #59941510156:  Hold'em No Limit ($0.50/$1.00) - 2009/07/01 1:37:39 ET
Table 'qj0HBN4HhQKogreu1bg7xg' 2-max Seat #2 is the button
Seat 1: NYi6JFscYNrofSXy4sM+Yw ($109.40 in chips)
Seat 2: qtyl8CSb0/4yWdbuEPJejA ($169.30 in chips)
qtyl8CSb0/4yWdbuEPJejA: posts small blind $0.50
NYi6JFscYNrofSXy4sM+Yw: posts big blind $1
*** HOLE CARDS ***
qtyl8CSb0/4yWdbuEPJejA: folds
NYi6JFscYNrofSXy4sM+Yw collected $1 from pot
*** SUMMARY ***
Total pot $1 | Rake $0
Seat 1: NYi6JFscYNrofSXy4sM+Yw (big blind) collected ($1)
Seat 2: qtyl8CSb0/4yWdbuEPJejA (button) (small blind) folded before Flop



PokerStars Game #59941509954:  Hold'em No Limit ($0.50/$1.00) - 2009/07/01 1:37:39 ET
Table 'N6LvHFrb+cdXY/COI6ByOw' 2-max Seat #1 is the button
Seat 1: lXX4W7m3u++JiSOZ46yVMQ ($92.20 in chips)
Seat 2: 9mAoSP3o/mikSZOW2LEEAw ($179 in chips)
lXX4W7m3u++JiSOZ46yVMQ: posts small blind $0.50
9mAoSP3o/mikSZOW2LEEAw: posts big blind $1
*** HOLE CARDS ***
lXX4W7m3u++JiSOZ46yVMQ: folds
9mAoSP3o/mikSZOW2LEEAw collected $1 from pot
*** SUMMARY ***
Total pot $1 | Rake $0
Seat 1: lXX4W7m3u++JiSOZ46yVMQ (button) (small blind) folded before Flop
Seat 2: 9mAoSP3o/mikSZOW2LEEAw (big blind) collected ($1)



PokerStars Game #59941511392:  Hold'em No Limit ($0.50/$1.00) - 2009/07/01 1:37:41 ET
Table 'tHb+N6GaPEmmBAe36B2R9Q' 2-max Seat #2 is the button
Seat 1: rL+Zpv4/vX2BVHcyfh/NXA ($108 in chips)
Seat 2: Pm1sDZZi0zFtnFGXLznkug ($124.80 in chips)
Pm1sDZZi0zFtnFGXLznkug: posts small blind $0.50
rL+Zpv4/vX2BVHcyfh/NXA: posts big blind $1
*** HOLE CARDS ***
Pm1sDZZi0zFtnFGXLznkug: raises $3 to $4
rL+Zpv4/vX2BVHcyfh/NXA: folds
Pm1sDZZi0zFtnFGXLznkug collected $2 from pot
Pm1sDZZi0zFtnFGXLznkug: doesn't show hand
*** SUMMARY ***
Total pot $2 | Rake $0
Seat 1: rL+Zpv4/vX2BVHcyfh/NXA (big blind) folded before Flop
Seat 2: Pm1sDZZi0zFtnFGXLznkug (button) (small blind) collected ($2)



PokerStars Game #59941511328:  Hold'em No Limit ($0.50/$1.00) - 2009/07/01 1:37:41 ET
Table 'N2bNCDHL96aCQDvZIh+yQQ' 6-max Seat #5 is the button
Seat 1: Jjgflx10PVjcLkziEmLhSA ($77.35 in chips)
Seat 2: y27w5IK2WXqmYzS8OU0wKA ($130.15 in chips)
Seat 3: UBZQqpnJZdTYYY1FTb0rLA ($122.05 in chips)
Seat 4: uCqEjnxh2/vFBjKYkfTOkw ($189.30 in chips)
Seat 5: frvgHLr3+LfZtjsBCBs3NA ($6.60 in chips)
Seat 6: idVgoPAdspFPCzee6aF9Pg ($100.50 in chips)
idVgoPAdspFPCzee6aF9Pg: posts small blind $0.50
Jjgflx10PVjcLkziEmLhSA: posts big blind $1
*** HOLE CARDS ***
y27w5IK2WXqmYzS8OU0wKA: folds
UBZQqpnJZdTYYY1FTb0rLA: folds
uCqEjnxh2/vFBjKYkfTOkw: folds
frvgHLr3+LfZtjsBCBs3NA: folds
idVgoPAdspFPCzee6aF9Pg: folds
Jjgflx10PVjcLkziEmLhSA collected $1 from pot
Jjgflx10PVjcLkziEmLhSA: doesn't show hand
*** SUMMARY ***
Total pot $1 | Rake $0
Seat 1: Jjgflx10PVjcLkziEmLhSA (big blind) collected ($1)
Seat 2: y27w5IK2WXqmYzS8OU0wKA folded before Flop (didn't bet)
Seat 3: UBZQqpnJZdTYYY1FTb0rLA folded before Flop (didn't bet)
Seat 4: uCqEjnxh2/vFBjKYkfTOkw folded before Flop (didn't bet)
Seat 5: frvgHLr3+LfZtjsBCBs3NA (button) folded before Flop (didn't bet)
Seat 6: idVgoPAdspFPCzee6aF9Pg (small blind) folded before Flop



PokerStars Game #59941512710:  Hold'em No Limit ($0.50/$1.00) - 2009/07/01 1:37:44 ET
Table 'rmZfTK+oSebeUPJNbWhdAA' 6-max Seat #1 is the button
Seat 1: xAU6q2/cwmby2sxmA8VcmA ($131.50 in chips)
Seat 2: z7O9PO/WEcqRouIydFhS9Q ($188.50 in chips)
Seat 3: BCEV3COoKY607AzLWayfRA ($195.30 in chips)
Seat 4: 1/mIuXfgx1ZyVkodrmfQDw ($172.15 in chips)
Seat 5: BWhgxe7gWiYobRbwdG+d2Q ($100 in chips)
Seat 6: j7NIOHLZk7V2o9fOioO5ug ($100 in chips)
z7O9PO/WEcqRouIydFhS9Q: posts small blind $0.50
BCEV3COoKY607AzLWayfRA: posts big blind $1
*** HOLE CARDS ***
1/mIuXfgx1ZyVkodrmfQDw: folds
BWhgxe7gWiYobRbwdG+d2Q: raises $3 to $4
j7NIOHLZk7V2o9fOioO5ug: folds
xAU6q2/cwmby2sxmA8VcmA: folds
z7O9PO/WEcqRouIydFhS9Q: folds
BCEV3COoKY607AzLWayfRA: calls $3
*** FLOP *** [4h Qd 8d]
BCEV3COoKY607AzLWayfRA: checks
BWhgxe7gWiYobRbwdG+d2Q: bets $7
BCEV3COoKY607AzLWayfRA: raises $15 to $22
BWhgxe7gWiYobRbwdG+d2Q: calls $15
*** TURN *** [4h Qd 8d] [9c]
BCEV3COoKY607AzLWayfRA: bets $41
BWhgxe7gWiYobRbwdG+d2Q: folds
BCEV3COoKY607AzLWayfRA collected $49.90 from pot
BCEV3COoKY607AzLWayfRA: doesn't show hand
*** SUMMARY ***
Total pot $52.50 | Rake $2.60
Board [4h Qd 8d 9c]
Seat 1: xAU6q2/cwmby2sxmA8VcmA (button) folded before Flop (didn't bet)
Seat 2: z7O9PO/WEcqRouIydFhS9Q (small blind) folded before Flop
Seat 3: BCEV3COoKY607AzLWayfRA (big blind) collected ($49.90)
Seat 4: 1/mIuXfgx1ZyVkodrmfQDw folded before Flop (didn't bet)
Seat 5: BWhgxe7gWiYobRbwdG+d2Q folded on the Turn
Seat 6: j7NIOHLZk7V2o9fOioO5ug folded before Flop (didn't bet)



PokerStars Game #59941512664:  Hold'em No Limit ($0.50/$1.00) - 2009/07/01 1:37:44 ET
Table 'blHlQApStil0OPeQxQxPcw' 9-max Seat #3 is the button
Seat 1: Pp/KTcXkfZKKUHkjyaLTdg ($24.10 in chips)
Seat 2: V138SURkdX8LdVBPKdJJag ($122.85 in chips)
Seat 3: OGgaARGdJQT4awWVNQ957w ($100 in chips)
Seat 4: 1862487932 ($100 in chips)
Seat 5: uXrDE6JrIi8BZK1L8oQ9bQ ($50.10 in chips)
Seat 6: vljeiOoWscAIXU0fCuiEBw ($39.10 in chips)
Seat 8: laA8va+Yv8WuMqT1zdR91g ($100 in chips)
Seat 9: 6XkTu4ahxzHnvjjc1R8YjQ ($155.35 in chips)
1862487932: posts small blind $0.50
uXrDE6JrIi8BZK1L8oQ9bQ: posts big blind $1
VPF+HjszMvUIpy0CHIwH3A: sits out
*** HOLE CARDS ***
vljeiOoWscAIXU0fCuiEBw: folds
laA8va+Yv8WuMqT1zdR91g: folds
6XkTu4ahxzHnvjjc1R8YjQ: folds
Pp/KTcXkfZKKUHkjyaLTdg: folds
V138SURkdX8LdVBPKdJJag: folds
OGgaARGdJQT4awWVNQ957w: folds
1862487932: raises $2.50 to $3.50
uXrDE6JrIi8BZK1L8oQ9bQ: calls $2.50
*** FLOP *** [Qh 7d 7c]
1862487932: bets $4
uXrDE6JrIi8BZK1L8oQ9bQ: folds
1862487932 collected $6.65 from pot
1862487932: doesn't show hand
*** SUMMARY ***
Total pot $7 | Rake $0.35
Board [Qh 7d 7c]
Seat 1: Pp/KTcXkfZKKUHkjyaLTdg folded before Flop (didn't bet)
Seat 2: V138SURkdX8LdVBPKdJJag folded before Flop (didn't bet)
Seat 3: OGgaARGdJQT4awWVNQ957w (button) folded before Flop (didn't bet)
Seat 4: 1862487932 (small blind) collected ($6.65)
Seat 5: uXrDE6JrIi8BZK1L8oQ9bQ (big blind) folded on the Flop
Seat 6: vljeiOoWscAIXU0fCuiEBw folded before Flop (didn't bet)
Seat 8: laA8va+Yv8WuMqT1zdR91g folded before Flop (didn't bet)
Seat 9: 6XkTu4ahxzHnvjjc1R8YjQ folded before Flop (didn't bet)



PokerStars Game #59941512660:  Hold'em No Limit ($0.50/$1.00) - 2009/07/01 1:37:44 ET
Table 'O96CPOtvMBWP6kzuYDfdFA' 6-max Seat #4 is the button
Seat 1: 6alLXQIITA2EZ/lBeym8Dw ($128.25 in chips)
Seat 2: 4d1rWhpu8DzLmzMbR3QKyA ($101.50 in chips)
Seat 4: /P4w1pHg2zHYg/4ubJ0dPw ($69.25 in chips)
Seat 5: vX+iYAEINFeLxwMla7DY1Q ($99 in chips)
Seat 6: 3syOXva630dm1FTdwnuLpw ($75.15 in chips)
vX+iYAEINFeLxwMla7DY1Q: posts small blind $0.50
3syOXva630dm1FTdwnuLpw: posts big blind $1
*** HOLE CARDS ***
6alLXQIITA2EZ/lBeym8Dw: folds
4d1rWhpu8DzLmzMbR3QKyA: folds
/P4w1pHg2zHYg/4ubJ0dPw: raises $2 to $3
vX+iYAEINFeLxwMla7DY1Q: folds
3syOXva630dm1FTdwnuLpw: calls $2
*** FLOP *** [5d 3s 2s]
3syOXva630dm1FTdwnuLpw: checks
/P4w1pHg2zHYg/4ubJ0dPw: checks
*** TURN *** [5d 3s 2s] [7s]
3syOXva630dm1FTdwnuLpw: checks
/P4w1pHg2zHYg/4ubJ0dPw: checks
*** RIVER *** [5d 3s 2s 7s] [3h]
3syOXva630dm1FTdwnuLpw: checks
/P4w1pHg2zHYg/4ubJ0dPw: checks
*** SHOW DOWN ***
3syOXva630dm1FTdwnuLpw: shows [Jh Kh] (a pair of Threes)
/P4w1pHg2zHYg/4ubJ0dPw: shows [Jd Ah] (a pair of Threes - Ace kicker)
/P4w1pHg2zHYg/4ubJ0dPw collected $6.20 from pot
*** SUMMARY ***
Total pot $6.50 | Rake $0.30
Board [5d 3s 2s 7s 3h]
Seat 1: 6alLXQIITA2EZ/lBeym8Dw folded before Flop (didn't bet)
Seat 2: 4d1rWhpu8DzLmzMbR3QKyA folded before Flop (didn't bet)
Seat 4: /P4w1pHg2zHYg/4ubJ0dPw (button) showed [Jd Ah] and won ($6.20) with a pair of Threes
Seat 5: vX+iYAEINFeLxwMla7DY1Q (small blind) folded before Flop
Seat 6: 3syOXva630dm1FTdwnuLpw (big blind) showed [Jh Kh] and lost with a pair of Threes



PokerStars Game #59941513688:  Hold'em No Limit ($0.50/$1.00) - 2009/07/01 1:37:45 ET
Table 'qj0HBN4HhQKogreu1bg7xg' 2-max Seat #1 is the button
Seat 1: NYi6JFscYNrofSXy4sM+Yw ($109.90 in chips)
Seat 2: qtyl8CSb0/4yWdbuEPJejA ($168.80 in chips)
NYi6JFscYNrofSXy4sM+Yw: posts small blind $0.50
qtyl8CSb0/4yWdbuEPJejA: posts big blind $1
*** HOLE CARDS ***
NYi6JFscYNrofSXy4sM+Yw: raises $2 to $3
qtyl8CSb0/4yWdbuEPJejA: folds
NYi6JFscYNrofSXy4sM+Yw collected $2 from pot
*** SUMMARY ***
Total pot $2 | Rake $0
Seat 1: NYi6JFscYNrofSXy4sM+Yw (button) (small blind) collected ($2)
Seat 2: qtyl8CSb0/4yWdbuEPJejA (big blind) folded before Flop



PokerStars Game #59941513352:  Hold'em No Limit ($0.50/$1.00) - 2009/07/01 1:37:45 ET
Table 'N6LvHFrb+cdXY/COI6ByOw' 2-max Seat #2 is the button
Seat 1: lXX4W7m3u++JiSOZ46yVMQ ($91.70 in chips)
Seat 2: 9mAoSP3o/mikSZOW2LEEAw ($179.50 in chips)
9mAoSP3o/mikSZOW2LEEAw: posts small blind $0.50
lXX4W7m3u++JiSOZ46yVMQ: posts big blind $1
*** HOLE CARDS ***
9mAoSP3o/mikSZOW2LEEAw: raises $2 to $3
lXX4W7m3u++JiSOZ46yVMQ: calls $2
*** FLOP *** [Ts Qh 2h]
lXX4W7m3u++JiSOZ46yVMQ: checks
9mAoSP3o/mikSZOW2LEEAw: bets $4
lXX4W7m3u++JiSOZ46yVMQ: folds
9mAoSP3o/mikSZOW2LEEAw collected $5.70 from pot
*** SUMMARY ***
Total pot $6 | Rake $0.30
Board [Ts Qh 2h]
Seat 1: lXX4W7m3u++JiSOZ46yVMQ (big blind) folded on the Flop
Seat 2: 9mAoSP3o/mikSZOW2LEEAw (button) (small blind) collected ($5.70)



PokerStars Game #59941513652:  Hold'em No Limit ($0.50/$1.00) - 2009/07/01 1:37:45 ET
Table '7Nl0ffnjeK44/vmeexh3MQ' 9-max Seat #8 is the button
Seat 1: V138SURkdX8LdVBPKdJJag ($100 in chips)
Seat 2: OGgaARGdJQT4awWVNQ957w ($100 in chips)
Seat 3: JMmUYT5pIKCKh2pGjCB/4w ($58.40 in chips)
Seat 4: bLbSOSmSOnqE0iTcH/5dxA ($106.80 in chips)
Seat 5: 61sfw5QTu62YYIt68OsdrA ($77.55 in chips)
Seat 6: FVs16t7GgfWgQWt4JxsObQ ($33.25 in chips)
Seat 7: 997ViqAtWn1FPjJqcffwcA ($109.10 in chips)
Seat 8: HRJJZiSxFAehJGaET63dlA ($47.40 in chips)
Seat 9: /JHoNdt0fK6X+isrqRfV3w ($19 in chips)
/JHoNdt0fK6X+isrqRfV3w: posts small blind $0.50
V138SURkdX8LdVBPKdJJag: posts big blind $1
*** HOLE CARDS ***
OGgaARGdJQT4awWVNQ957w: folds
JMmUYT5pIKCKh2pGjCB/4w: folds
bLbSOSmSOnqE0iTcH/5dxA: folds
61sfw5QTu62YYIt68OsdrA: folds
FVs16t7GgfWgQWt4JxsObQ: calls $1
997ViqAtWn1FPjJqcffwcA: folds
HRJJZiSxFAehJGaET63dlA: calls $1
/JHoNdt0fK6X+isrqRfV3w: folds
V138SURkdX8LdVBPKdJJag: checks
*** FLOP *** [4s 7d 9c]
V138SURkdX8LdVBPKdJJag: bets $3
FVs16t7GgfWgQWt4JxsObQ: folds
HRJJZiSxFAehJGaET63dlA: folds
V138SURkdX8LdVBPKdJJag collected $3.35 from pot
V138SURkdX8LdVBPKdJJag: doesn't show hand
*** SUMMARY ***
Total pot $3.50 | Rake $0.15
Board [4s 7d 9c]
Seat 1: V138SURkdX8LdVBPKdJJag (big blind) collected ($3.35)
Seat 2: OGgaARGdJQT4awWVNQ957w folded before Flop (didn't bet)
Seat 3: JMmUYT5pIKCKh2pGjCB/4w folded before Flop (didn't bet)
Seat 4: bLbSOSmSOnqE0iTcH/5dxA folded before Flop (didn't bet)
Seat 5: 61sfw5QTu62YYIt68OsdrA folded before Flop (didn't bet)
Seat 6: FVs16t7GgfWgQWt4JxsObQ folded on the Flop
Seat 7: 997ViqAtWn1FPjJqcffwcA folded before Flop (didn't bet)
Seat 8: HRJJZiSxFAehJGaET63dlA (button) folded on the Flop
Seat 9: /JHoNdt0fK6X+isrqRfV3w (small blind) folded before Flop



PokerStars Game #59941514106:  Hold'em No Limit ($0.50/$1.00) - 2009/07/01 1:37:46 ET
Table 'pHrhryH8jPNdQfY62f8v+g' 6-max Seat #2 is the button
Seat 1: 4d1rWhpu8DzLmzMbR3QKyA ($147.45 in chips)
Seat 2: JwCcjZl0bjJzG7hmE0dnTA ($111.05 in chips)
Seat 3: 8oS5O7iD/qnFXFXJrGIgNQ ($109.80 in chips)
Seat 4: 1f3beyIML24UqEMTbWy93g ($55.70 in chips)
Seat 5: d8WX+9nUHoqlrAGagO0Wow ($24.15 in chips)
Seat 6: xAU6q2/cwmby2sxmA8VcmA ($179.80 in chips)
8oS5O7iD/qnFXFXJrGIgNQ: posts small blind $0.50
1f3beyIML24UqEMTbWy93g: posts big blind $1
*** HOLE CARDS ***
d8WX+9nUHoqlrAGagO0Wow: folds
xAU6q2/cwmby2sxmA8VcmA: folds
4d1rWhpu8DzLmzMbR3QKyA: raises $2 to $3
JwCcjZl0bjJzG7hmE0dnTA: folds
8oS5O7iD/qnFXFXJrGIgNQ: folds
1f3beyIML24UqEMTbWy93g: folds
4d1rWhpu8DzLmzMbR3QKyA collected $2.50 from pot
*** SUMMARY ***
Total pot $2.50 | Rake $0
Seat 1: 4d1rWhpu8DzLmzMbR3QKyA collected ($2.50)
Seat 2: JwCcjZl0bjJzG7hmE0dnTA (button) folded before Flop (didn't bet)
Seat 3: 8oS5O7iD/qnFXFXJrGIgNQ (small blind) folded before Flop
Seat 4: 1f3beyIML24UqEMTbWy93g (big blind) folded before Flop
Seat 5: d8WX+9nUHoqlrAGagO0Wow folded before Flop (didn't bet)
Seat 6: xAU6q2/cwmby2sxmA8VcmA folded before Flop (didn't bet)



PokerStars Game #59941514086:  Hold'em No Limit ($0.50/$1.00) - 2009/07/01 1:37:46 ET
Table 'ZFWj23PMihdwrNWv41OG/QtyUh+jyNvrceIQdKMJjQ2weat #1 is the button
Seat 1: j3hj7KQwBVU5NTFmtYomSw ($71.85 in chips)
Seat 2: 0smcry9L0OOTCP+KzIS5SA ($97.50 in chips)
Seat 3: cWwhvq/+r/w8nkhwrJoekQ ($47.70 in chips)
Seat 4: O5ZesE/6mHyuWWbvkiH/Fg ($66.65 in chips)
Seat 5: j7NIOHLZk7V2o9fOioO5ug ($100 in chips)
Seat 6: u23r4AyKPgHioZ6t7z6qrA ($41 in chips)
0smcry9L0OOTCP+KzIS5SA: posts small blind $0.50
cWwhvq/+r/w8nkhwrJoekQ: posts big blind $1
*** HOLE CARDS ***
O5ZesE/6mHyuWWbvkiH/Fg: folds
j7NIOHLZk7V2o9fOioO5ug: raises $2 to $3
u23r4AyKPgHioZ6t7z6qrA said, "unreal"
u23r4AyKPgHioZ6t7z6qrA: folds
j3hj7KQwBVU5NTFmtYomSw: calls $3
0smcry9L0OOTCP+KzIS5SA: folds
cWwhvq/+r/w8nkhwrJoekQ: folds
*** FLOP *** [7c 3d Ah]
j7NIOHLZk7V2o9fOioO5ug: bets $6
j3hj7KQwBVU5NTFmtYomSw: calls $6
*** TURN *** [7c 3d Ah] [Kc]
j7NIOHLZk7V2o9fOioO5ug: checks
j3hj7KQwBVU5NTFmtYomSw: bets $7
j7NIOHLZk7V2o9fOioO5ug: calls $7
*** RIVER *** [7c 3d Ah Kc] [Jh]
j7NIOHLZk7V2o9fOioO5ug: checks
j3hj7KQwBVU5NTFmtYomSw: bets $11
O5ZesE/6mHyuWWbvkiH/Fg said, "what u have Tilt"
j7NIOHLZk7V2o9fOioO5ug: folds
u23r4AyKPgHioZ6t7z6qrA said, "nicely played"
j3hj7KQwBVU5NTFmtYomSw collected $31.90 from pot
j3hj7KQwBVU5NTFmtYomSw: doesn't show hand
*** SUMMARY ***
Total pot $33.50 | Rake $1.60
Board [7c 3d Ah Kc Jh]
Seat 1: j3hj7KQwBVU5NTFmtYomSw (button) collected ($31.90)
Seat 2: 0smcry9L0OOTCP+KzIS5SA (small blind) folded before Flop
Seat 3: cWwhvq/+r/w8nkhwrJoekQ (big blind) folded before Flop
Seat 4: O5ZesE/6mHyuWWbvkiH/Fg folded before Flop (didn't bet)
Seat 5: j7NIOHLZk7V2o9fOioO5ug folded on the River
Seat 6: u23r4AyKPgHioZ6t7z6qrA folded before Flop (didn't bet)



PokerStars Game #59941514004:  Hold'em No Limit ($0.50/$1.00) - 2009/07/01 1:37:46 ET
Table 'b8oW/dOL7fDza5DfZ/dOJQ' 6-max Seat #4 is the button
Seat 1: NakujTNjHFgzceydFf+E2Q ($57.50 in chips)
Seat 2: TSuRyAHnUPCFjP7Z0rEE0w ($119 in chips)
Seat 3: d8WX+9nUHoqlrAGagO0Wow ($32.80 in chips)
Seat 4: 8rDbzImSi1zgxtqtF1pSbA ($20 in chips)
Seat 5: r4lpoh2BJZ8S6zyQv1JeSw ($100 in chips)
Seat 6: PvfYaKbzMpsmUcbOExckbQ ($149.60 in chips)
r4lpoh2BJZ8S6zyQv1JeSw: posts small blind $0.50
PvfYaKbzMpsmUcbOExckbQ: posts big blind $1
*** HOLE CARDS ***
NakujTNjHFgzceydFf+E2Q: folds
TSuRyAHnUPCFjP7Z0rEE0w: folds
d8WX+9nUHoqlrAGagO0Wow: raises $2 to $3
8rDbzImSi1zgxtqtF1pSbA: folds
r4lpoh2BJZ8S6zyQv1JeSw: folds
PvfYaKbzMpsmUcbOExckbQ: folds
d8WX+9nUHoqlrAGagO0Wow collected $2.50 from pot
*** SUMMARY ***
Total pot $2.50 | Rake $0
Seat 1: NakujTNjHFgzceydFf+E2Q folded before Flop (didn't bet)
Seat 2: TSuRyAHnUPCFjP7Z0rEE0w folded before Flop (didn't bet)
Seat 3: d8WX+9nUHoqlrAGagO0Wow collected ($2.50)
Seat 4: 8rDbzImSi1zgxtqtF1pSbA (button) folded before Flop (didn't bet)
Seat 5: r4lpoh2BJZ8S6zyQv1JeSw (small blind) folded before Flop
Seat 6: PvfYaKbzMpsmUcbOExckbQ (big blind) folded before Flop



PokerStars Game #59941514568:  Hold'em No Limit ($0.50/$1.00) - 2009/07/01 1:37:47 ET
Table 'gxFK0BVUD7cupu2uyRUZJg' 6-max Seat #4 is the button
Seat 1: M+X3uChmP6R63IwijVjgTg ($235.90 in chips)
Seat 2: hpxXcmRkXXI9HE5+5/j/0Q ($131.55 in chips)
Seat 3: Z2fXsGcjl+Eax+RzOgwOmg ($100 in chips)
Seat 4: Hcr4S4Nbkj5idKsvYK/eqQ ($100 in chips)
Seat 5: 0smcry9L0OOTCP+KzIS5SA ($110.50 in chips)
Seat 6: dYyb6/42PMC8aNFlm/eBeQ ($126.90 in chips)
0smcry9L0OOTCP+KzIS5SA: posts small blind $0.50
dYyb6/42PMC8aNFlm/eBeQ: posts big blind $1
*** HOLE CARDS ***
M+X3uChmP6R63IwijVjgTg: folds
hpxXcmRkXXI9HE5+5/j/0Q: folds
Z2fXsGcjl+Eax+RzOgwOmg: folds
Hcr4S4Nbkj5idKsvYK/eqQ: raises $2 to $3
0smcry9L0OOTCP+KzIS5SA: folds
dYyb6/42PMC8aNFlm/eBeQ: folds
Hcr4S4Nbkj5idKsvYK/eqQ collected $2.50 from pot
Hcr4S4Nbkj5idKsvYK/eqQ: doesn't show hand
*** SUMMARY ***
Total pot $2.50 | Rake $0
Seat 1: M+X3uChmP6R63IwijVjgTg folded before Flop (didn't bet)
Seat 2: hpxXcmRkXXI9HE5+5/j/0Q folded before Flop (didn't bet)
Seat 3: Z2fXsGcjl+Eax+RzOgwOmg folded before Flop (didn't bet)
Seat 4: Hcr4S4Nbkj5idKsvYK/eqQ (button) collected ($2.50)
Seat 5: 0smcry9L0OOTCP+KzIS5SA (small blind) folded before Flop
Seat 6: dYyb6/42PMC8aNFlm/eBeQ (big blind) folded before Flop



PokerStars Game #59941514956:  Hold'em No Limit ($0.50/$1.00) - 2009/07/01 1:37:48 ET
Table 'QSIig7BLMc9wY/rgBechzw' 6-max Seat #2 is the button
Seat 1: Z2fXsGcjl+Eax+RzOgwOmg ($110.05 in chips)
Seat 2: mLOIkH/qmRa+mVujQIhBRg ($25.95 in chips)
Seat 3: 4OO5v3AVduL0tePNx8wk5A ($103.50 in chips)
Seat 4: +uSzP8Jwnw7sKfQ4s66b7w ($59.30 in chips)
Seat 5: lsLuWlcPA3Rh7kJVLzMh0Q ($100.20 in chips)
4OO5v3AVduL0tePNx8wk5A: posts small blind $0.50
+uSzP8Jwnw7sKfQ4s66b7w: posts big blind $1
*** HOLE CARDS ***
lsLuWlcPA3Rh7kJVLzMh0Q: folds
Wj7mKnRFR90j40wWUu2+Og joins the table at seat #6
Z2fXsGcjl+Eax+RzOgwOmg: folds
mLOIkH/qmRa+mVujQIhBRg: calls $1
4OO5v3AVduL0tePNx8wk5A: folds
+uSzP8Jwnw7sKfQ4s66b7w: checks
*** FLOP *** [Kd Qd 5c]
+uSzP8Jwnw7sKfQ4s66b7w: checks
mLOIkH/qmRa+mVujQIhBRg: bets $2
+uSzP8Jwnw7sKfQ4s66b7w: folds
mLOIkH/qmRa+mVujQIhBRg collected $2.40 from pot
*** SUMMARY ***
Total pot $2.50 | Rake $0.10
Board [Kd Qd 5c]
Seat 1: Z2fXsGcjl+Eax+RzOgwOmg folded before Flop (didn't bet)
Seat 2: mLOIkH/qmRa+mVujQIhBRg (button) collected ($2.40)
Seat 3: 4OO5v3AVduL0tePNx8wk5A (small blind) folded before Flop
Seat 4: +uSzP8Jwnw7sKfQ4s66b7w (big blind) folded on the Flop
Seat 5: lsLuWlcPA3Rh7kJVLzMh0Q folded before Flop (didn't bet)



PokerStars Game #59941516132:  Hold'em No Limit ($0.50/$1.00) - 2009/07/01 1:37:50 ET
Table '7O9fB8yx1u7sJveJn8w6jA' 6-max Seat #1 is the button
Seat 1: 841740 ($51.80 in chips)
Seat 2: wx3sQGkVi2x9wJXuWNHPBw ($207.35 in chips)
Seat 3: hpxXcmRkXXI9HE5+5/j/0Q ($136.90 in chips)
Seat 4: b2a+5TkFf4xJN/Ihhma58Q ($31.85 in chips)
Seat 5: BCEV3COoKY607AzLWayfRA ($100.50 in chips)
Seat 6: r4lpoh2BJZ8S6zyQv1JeSw ($100 in chips)
wx3sQGkVi2x9wJXuWNHPBw: posts small blind $0.50
hpxXcmRkXXI9HE5+5/j/0Q: posts big blind $1
*** HOLE CARDS ***
b2a+5TkFf4xJN/Ihhma58Q: folds
BCEV3COoKY607AzLWayfRA: folds
r4lpoh2BJZ8S6zyQv1JeSw: folds
841740: raises $1 to $2
wx3sQGkVi2x9wJXuWNHPBw: folds
hpxXcmRkXXI9HE5+5/j/0Q: folds
841740 collected $2.50 from pot
*** SUMMARY ***
Total pot $2.50 | Rake $0
Seat 1: 841740 (button) collected ($2.50)
Seat 2: wx3sQGkVi2x9wJXuWNHPBw (small blind) folded before Flop
Seat 3: hpxXcmRkXXI9HE5+5/j/0Q (big blind) folded before Flop
Seat 4: b2a+5TkFf4xJN/Ihhma58Q folded before Flop (didn't bet)
Seat 5: BCEV3COoKY607AzLWayfRA folded before Flop (didn't bet)
Seat 6: r4lpoh2BJZ8S6zyQv1JeSw folded before Flop (didn't bet)



PokerStars Game #59941516538:  Hold'em No Limit ($0.50/$1.00) - 2009/07/01 1:37:50 ET
Table 'tHb+N6GaPEmmBAe36B2R9Q' 2-max Seat #1 is the button
Seat 1: rL+Zpv4/vX2BVHcyfh/NXA ($107 in chips)
Seat 2: Pm1sDZZi0zFtnFGXLznkug ($125.80 in chips)
rL+Zpv4/vX2BVHcyfh/NXA: posts small blind $0.50
Pm1sDZZi0zFtnFGXLznkug: posts big blind $1
*** HOLE CARDS ***
rL+Zpv4/vX2BVHcyfh/NXA: raises $2 to $3
Pm1sDZZi0zFtnFGXLznkug: raises $7 to $10
rL+Zpv4/vX2BVHcyfh/NXA: folds
Pm1sDZZi0zFtnFGXLznkug collected $6 from pot
Pm1sDZZi0zFtnFGXLznkug: doesn't show hand
*** SUMMARY ***
Total pot $6 | Rake $0
Seat 1: rL+Zpv4/vX2BVHcyfh/NXA (button) (small blind) folded before Flop
Seat 2: Pm1sDZZi0zFtnFGXLznkug (big blind) collected ($6)



PokerStars Game #59941516684:  Hold'em No Limit ($0.50/$1.00) - 2009/07/01 1:37:51 ET
Table 'kS0cTQAEi+fdUlJP2gQYvw' 9-max Seat #5 is the button
Seat 1: SqsWPukL8kLqrhq5ZrQdSQ ($89 in chips)
Seat 2: +JautI/vSNALzwSvsOqbCQ ($78 in chips)
Seat 3: 2BV+oJIQYr65IO6nEChvbA ($62.55 in chips)
Seat 4: RUhhaALzha3TH1AkdakoGQ ($51 in chips)
Seat 5: 997ViqAtWn1FPjJqcffwcA ($100 in chips)
Seat 6: yAbu2QsRPVcjPbqlf/jDxw ($117.65 in chips)
Seat 7: Ffa7Nj4X5fddtROP01hfQg ($94.15 in chips)
Seat 8: vKyFzTyzfT7fZcdX+HHN+Q ($102.70 in chips)
Seat 9: OGgaARGdJQT4awWVNQ957w ($109.70 in chips)
yAbu2QsRPVcjPbqlf/jDxw: posts small blind $0.50
Ffa7Nj4X5fddtROP01hfQg: posts big blind $1
*** HOLE CARDS ***
vKyFzTyzfT7fZcdX+HHN+Q: calls $1
OGgaARGdJQT4awWVNQ957w: folds
SqsWPukL8kLqrhq5ZrQdSQ: calls $1
+JautI/vSNALzwSvsOqbCQ: folds
2BV+oJIQYr65IO6nEChvbA: folds
RUhhaALzha3TH1AkdakoGQ: folds
997ViqAtWn1FPjJqcffwcA: folds
yAbu2QsRPVcjPbqlf/jDxw: folds
Ffa7Nj4X5fddtROP01hfQg: checks
*** FLOP *** [Td Jd 4d]
RUhhaALzha3TH1AkdakoGQ said, "stay here at this table sama!"
Ffa7Nj4X5fddtROP01hfQg: bets $2
vKyFzTyzfT7fZcdX+HHN+Q: folds
SqsWPukL8kLqrhq5ZrQdSQ: folds
Ffa7Nj4X5fddtROP01hfQg collected $3.35 from pot
*** SUMMARY ***
Total pot $3.50 | Rake $0.15
Board [Td Jd 4d]
Seat 1: SqsWPukL8kLqrhq5ZrQdSQ folded on the Flop
Seat 2: +JautI/vSNALzwSvsOqbCQ folded before Flop (didn't bet)
Seat 3: 2BV+oJIQYr65IO6nEChvbA folded before Flop (didn't bet)
Seat 4: RUhhaALzha3TH1AkdakoGQ folded before Flop (didn't bet)
Seat 5: 997ViqAtWn1FPjJqcffwcA (button) folded before Flop (didn't bet)
Seat 6: yAbu2QsRPVcjPbqlf/jDxw (small blind) folded before Flop
Seat 7: Ffa7Nj4X5fddtROP01hfQg (big blind) collected ($3.35)
Seat 8: vKyFzTyzfT7fZcdX+HHN+Q folded on the Flop
Seat 9: OGgaARGdJQT4awWVNQ957w folded before Flop (didn't bet)



PokerStars Game #59941517484:  Hold'em No Limit ($0.50/$1.00) - 2009/07/01 1:37:52 ET
Table 'NqGO/cV3MwFAx+ZPB5ANmQ' 2-max Seat #2 is the button
Seat 1: ItaRAnHOgvYOv5ynbG1iTw ($226.20 in chips)
Seat 2: GtFB+yyeb2djMdPFuOW/Xg ($111.50 in chips)
GtFB+yyeb2djMdPFuOW/Xg: posts small blind $0.50
ItaRAnHOgvYOv5ynbG1iTw: posts big blind $1
*** HOLE CARDS ***
GtFB+yyeb2djMdPFuOW/Xg: folds
ItaRAnHOgvYOv5ynbG1iTw collected $1 from pot
*** SUMMARY ***
Total pot $1 | Rake $0
Seat 1: ItaRAnHOgvYOv5ynbG1iTw (big blind) collected ($1)
Seat 2: GtFB+yyeb2djMdPFuOW/Xg (button) (small blind) folded before Flop



PokerStars Game #59941518242:  Hold'em No Limit ($0.50/$1.00) - 2009/07/01 1:37:54 ET
Table 'qj0HBN4HhQKogreu1bg7xg' 2-max Seat #2 is the button
Seat 1: NYi6JFscYNrofSXy4sM+Yw ($110.90 in chips)
Seat 2: qtyl8CSb0/4yWdbuEPJejA ($167.80 in chips)
qtyl8CSb0/4yWdbuEPJejA: posts small blind $0.50
NYi6JFscYNrofSXy4sM+Yw: posts big blind $1
*** HOLE CARDS ***
qtyl8CSb0/4yWdbuEPJejA: raises $2 to $3
NYi6JFscYNrofSXy4sM+Yw: folds
qtyl8CSb0/4yWdbuEPJejA collected $2 from pot
qtyl8CSb0/4yWdbuEPJejA: doesn't show hand
*** SUMMARY ***
Total pot $2 | Rake $0
Seat 1: NYi6JFscYNrofSXy4sM+Yw (big blind) folded before Flop
Seat 2: qtyl8CSb0/4yWdbuEPJejA (button) (small blind) collected ($2)



PokerStars Game #59941519582:  Hold'em No Limit ($0.50/$1.00) - 2009/07/01 1:37:56 ET
Table 'tJq9SfN1ywY0r03VBlWlwQ' 9-max Seat #2 is the button
Seat 1: wZsU+w9r7G66x93UuvBf1Q ($297.05 in chips)
Seat 2: VPF+HjszMvUIpy0CHIwH3A ($18.50 in chips)
Seat 4: bLbSOSmSOnqE0iTcH/5dxA ($118.70 in chips)
Seat 5: h5ipsNTMyolp7xn/NAvWkA ($133.80 in chips)
Seat 6: gUUvmqdVlmvpal6B8nYrmg ($100 in chips)
Seat 7: Ogn4JDV3mp4ZDKO49IFzKA ($19.90 in chips)
Seat 8: G4DEhsZFmznGNVpy2SEocA ($40.80 in chips)
Seat 9: XE5QF1y74bpHog9JxWJMWQ ($100 in chips)
bLbSOSmSOnqE0iTcH/5dxA: posts small blind $0.50
h5ipsNTMyolp7xn/NAvWkA: posts big blind $1
*** HOLE CARDS ***
gUUvmqdVlmvpal6B8nYrmg: folds
Ogn4JDV3mp4ZDKO49IFzKA: folds
G4DEhsZFmznGNVpy2SEocA: folds
XE5QF1y74bpHog9JxWJMWQ: folds
wZsU+w9r7G66x93UuvBf1Q: raises $3 to $4
VPF+HjszMvUIpy0CHIwH3A: folds
bLbSOSmSOnqE0iTcH/5dxA: folds
h5ipsNTMyolp7xn/NAvWkA: folds
wZsU+w9r7G66x93UuvBf1Q collected $2.50 from pot
*** SUMMARY ***
Total pot $2.50 | Rake $0
Seat 1: wZsU+w9r7G66x93UuvBf1Q collected ($2.50)
Seat 2: VPF+HjszMvUIpy0CHIwH3A (button) folded before Flop (didn't bet)
Seat 4: bLbSOSmSOnqE0iTcH/5dxA (small blind) folded before Flop
Seat 5: h5ipsNTMyolp7xn/NAvWkA (big blind) folded before Flop
Seat 6: gUUvmqdVlmvpal6B8nYrmg folded before Flop (didn't bet)
Seat 7: Ogn4JDV3mp4ZDKO49IFzKA folded before Flop (didn't bet)
Seat 8: G4DEhsZFmznGNVpy2SEocA folded before Flop (didn't bet)
Seat 9: XE5QF1y74bpHog9JxWJMWQ folded before Flop (didn't bet)



PokerStars Game #59941520036:  Hold'em No Limit ($0.50/$1.00) - 2009/07/01 1:37:57 ET
Table '305hiksPPCCdC6V2LNsO5w' 6-max Seat #6 is the button
Seat 1: RTuDLJHh/9zPfBftoc9vsw ($9.25 in chips)
Seat 2: j7NIOHLZk7V2o9fOioO5ug ($159.20 in chips)
Seat 3: +zIVjZKLpcidfRHgVZW8lA ($27.20 in chips)
Seat 4: uJVSceLggtsrJya+WtmUEA ($203.80 in chips)
Seat 5: +Nt3OPk3XR9SKjZgm2CexQ ($100 in chips)
Seat 6: 9/Tq8dw7kWW68uN8bFupXg ($18.45 in chips)
RTuDLJHh/9zPfBftoc9vsw: posts small blind $0.50
j7NIOHLZk7V2o9fOioO5ug: posts big blind $1
*** HOLE CARDS ***
+zIVjZKLpcidfRHgVZW8lA: calls $1
uJVSceLggtsrJya+WtmUEA: folds
+Nt3OPk3XR9SKjZgm2CexQ: folds
9/Tq8dw7kWW68uN8bFupXg: calls $1
RTuDLJHh/9zPfBftoc9vsw: calls $0.50
j7NIOHLZk7V2o9fOioO5ug: checks
*** FLOP *** [Ah 7s Ts]
RTuDLJHh/9zPfBftoc9vsw: checks
j7NIOHLZk7V2o9fOioO5ug: checks
+zIVjZKLpcidfRHgVZW8lA: bets $2
9/Tq8dw7kWW68uN8bFupXg: folds
RTuDLJHh/9zPfBftoc9vsw: folds
j7NIOHLZk7V2o9fOioO5ug: folds
+zIVjZKLpcidfRHgVZW8lA collected $3.80 from pot
*** SUMMARY ***
Total pot $4 | Rake $0.20
Board [Ah 7s Ts]
Seat 1: RTuDLJHh/9zPfBftoc9vsw (small blind) folded on the Flop
Seat 2: j7NIOHLZk7V2o9fOioO5ug (big blind) folded on the Flop
Seat 3: +zIVjZKLpcidfRHgVZW8lA collected ($3.80)
Seat 4: uJVSceLggtsrJya+WtmUEA folded before Flop (didn't bet)
Seat 5: +Nt3OPk3XR9SKjZgm2CexQ folded before Flop (didn't bet)
Seat 6: 9/Tq8dw7kWW68uN8bFupXg (button) folded on the Flop



PokerStars Game #59941520532:  Hold'em No Limit ($0.50/$1.00) - 2009/07/01 1:37:58 ET
Table 'E9S5sEoK9Q3olj2a53gABA' 2-max Seat #2 is the button
Seat 1: NYi6JFscYNrofSXy4sM+Yw ($100 in chips)
Seat 2: mgi+mjKb1Sc3CCs7TlfoCw ($43.20 in chips)
mgi+mjKb1Sc3CCs7TlfoCw: posts small blind $0.50
NYi6JFscYNrofSXy4sM+Yw: posts big blind $1
*** HOLE CARDS ***
mgi+mjKb1Sc3CCs7TlfoCw: raises $2 to $3
NYi6JFscYNrofSXy4sM+Yw: calls $2
*** FLOP *** [8h 8d 6d]
NYi6JFscYNrofSXy4sM+Yw: checks
mgi+mjKb1Sc3CCs7TlfoCw: checks
*** TURN *** [8h 8d 6d] [3s]
NYi6JFscYNrofSXy4sM+Yw: checks
mgi+mjKb1Sc3CCs7TlfoCw: checks
*** RIVER *** [8h 8d 6d 3s] [6h]
NYi6JFscYNrofSXy4sM+Yw: checks
mgi+mjKb1Sc3CCs7TlfoCw: checks
*** SHOW DOWN ***
NYi6JFscYNrofSXy4sM+Yw: shows [9h 5h] (two pair, Eights and Sixes)
mgi+mjKb1Sc3CCs7TlfoCw: shows [7h Kd] (two pair, Eights and Sixes - King kicker)
mgi+mjKb1Sc3CCs7TlfoCw collected $5.70 from pot
*** SUMMARY ***
Total pot $6 | Rake $0.30
Board [8h 8d 6d 3s 6h]
Seat 1: NYi6JFscYNrofSXy4sM+Yw (big blind) showed [9h 5h] and lost with two pair, Eights and Sixes
Seat 2: mgi+mjKb1Sc3CCs7TlfoCw (button) (small blind) showed [7h Kd] and won ($5.70) with two pair, Eights and Sixes



PokerStars Game #59941522252:  Hold'em No Limit ($0.50/$1.00) - 2009/07/01 1:38:01 ET
Table 'qj0HBN4HhQKogreu1bg7xg' 2-max Seat #1 is the button
Seat 1: NYi6JFscYNrofSXy4sM+Yw ($109.90 in chips)
Seat 2: qtyl8CSb0/4yWdbuEPJejA ($168.80 in chips)
NYi6JFscYNrofSXy4sM+Yw: posts small blind $0.50
qtyl8CSb0/4yWdbuEPJejA: posts big blind $1
*** HOLE CARDS ***
NYi6JFscYNrofSXy4sM+Yw: raises $2 to $3
qtyl8CSb0/4yWdbuEPJejA: raises $5 to $8
NYi6JFscYNrofSXy4sM+Yw: folds
qtyl8CSb0/4yWdbuEPJejA collected $6 from pot
qtyl8CSb0/4yWdbuEPJejA: doesn't show hand
*** SUMMARY ***
Total pot $6 | Rake $0
Seat 1: NYi6JFscYNrofSXy4sM+Yw (button) (small blind) folded before Flop
Seat 2: qtyl8CSb0/4yWdbuEPJejA (big blind) collected ($6)



PokerStars Game #59941522628:  Hold'em No Limit ($0.50/$1.00) - 2009/07/01 1:38:01 ET
Table 'N2bNCDHL96aCQDvZIh+yQQ' 6-max Seat #6 is the button
Seat 1: Jjgflx10PVjcLkziEmLhSA ($77.85 in chips)
Seat 2: y27w5IK2WXqmYzS8OU0wKA ($130.15 in chips)
Seat 3: UBZQqpnJZdTYYY1FTb0rLA ($122.05 in chips)
Seat 4: uCqEjnxh2/vFBjKYkfTOkw ($189.30 in chips)
Seat 5: frvgHLr3+LfZtjsBCBs3NA ($6.60 in chips)
Seat 6: idVgoPAdspFPCzee6aF9Pg ($100 in chips)
Jjgflx10PVjcLkziEmLhSA: posts small blind $0.50
y27w5IK2WXqmYzS8OU0wKA: posts big blind $1
*** HOLE CARDS ***
UBZQqpnJZdTYYY1FTb0rLA: folds
uCqEjnxh2/vFBjKYkfTOkw: raises $2 to $3
frvgHLr3+LfZtjsBCBs3NA: folds
idVgoPAdspFPCzee6aF9Pg: folds
Jjgflx10PVjcLkziEmLhSA: calls $2.50
y27w5IK2WXqmYzS8OU0wKA: folds
*** FLOP *** [5s 9h Jd]
Jjgflx10PVjcLkziEmLhSA: checks
uCqEjnxh2/vFBjKYkfTOkw: bets $4
Jjgflx10PVjcLkziEmLhSA: calls $4
*** TURN *** [5s 9h Jd] [8d]
Jjgflx10PVjcLkziEmLhSA: checks
uCqEjnxh2/vFBjKYkfTOkw: bets $8
Jjgflx10PVjcLkziEmLhSA: calls $8
*** RIVER *** [5s 9h Jd 8d] [Qd]
Jjgflx10PVjcLkziEmLhSA: bets $12
uCqEjnxh2/vFBjKYkfTOkw: folds
Jjgflx10PVjcLkziEmLhSA collected $29.50 from pot
*** SUMMARY ***
Total pot $31 | Rake $1.50
Board [5s 9h Jd 8d Qd]
Seat 1: Jjgflx10PVjcLkziEmLhSA (small blind) collected ($29.50)
Seat 2: y27w5IK2WXqmYzS8OU0wKA (big blind) folded before Flop
Seat 3: UBZQqpnJZdTYYY1FTb0rLA folded before Flop (didn't bet)
Seat 4: uCqEjnxh2/vFBjKYkfTOkw folded on the River
Seat 5: frvgHLr3+LfZtjsBCBs3NA folded before Flop (didn't bet)
Seat 6: idVgoPAdspFPCzee6aF9Pg (button) folded before Flop (didn't bet)



PokerStars Game #59941523124:  Hold'em No Limit ($0.50/$1.00) - 2009/07/01 1:38:02 ET
Table 'b8oW/dOL7fDza5DfZ/dOJQ' 6-max Seat #5 is the button
Seat 1: NakujTNjHFgzceydFf+E2Q ($57.50 in chips)
Seat 2: TSuRyAHnUPCFjP7Z0rEE0w ($119 in chips)
Seat 3: d8WX+9nUHoqlrAGagO0Wow ($34.30 in chips)
Seat 4: 8rDbzImSi1zgxtqtF1pSbA ($20 in chips)
Seat 5: r4lpoh2BJZ8S6zyQv1JeSw ($100 in chips)
Seat 6: PvfYaKbzMpsmUcbOExckbQ ($148.60 in chips)
PvfYaKbzMpsmUcbOExckbQ: posts small blind $0.50
NakujTNjHFgzceydFf+E2Q: posts big blind $1
*** HOLE CARDS ***
TSuRyAHnUPCFjP7Z0rEE0w: folds
d8WX+9nUHoqlrAGagO0Wow: folds
8rDbzImSi1zgxtqtF1pSbA: folds
r4lpoh2BJZ8S6zyQv1JeSw: folds
PvfYaKbzMpsmUcbOExckbQ: folds
NakujTNjHFgzceydFf+E2Q collected $1 from pot
*** SUMMARY ***
Total pot $1 | Rake $0
Seat 1: NakujTNjHFgzceydFf+E2Q (big blind) collected ($1)
Seat 2: TSuRyAHnUPCFjP7Z0rEE0w folded before Flop (didn't bet)
Seat 3: d8WX+9nUHoqlrAGagO0Wow folded before Flop (didn't bet)
Seat 4: 8rDbzImSi1zgxtqtF1pSbA folded before Flop (didn't bet)
Seat 5: r4lpoh2BJZ8S6zyQv1JeSw (button) folded before Flop (didn't bet)
Seat 6: PvfYaKbzMpsmUcbOExckbQ (small blind) folded before Flop



PokerStars Game #59941522842:  Hold'em No Limit ($0.50/$1.00) - 2009/07/01 1:38:02 ET
Table 'NqGO/cV3MwFAx+ZPB5ANmQ' 2-max Seat #1 is the button
Seat 1: ItaRAnHOgvYOv5ynbG1iTw ($226.70 in chips)
Seat 2: GtFB+yyeb2djMdPFuOW/Xg ($111 in chips)
ItaRAnHOgvYOv5ynbG1iTw: posts small blind $0.50
GtFB+yyeb2djMdPFuOW/Xg: posts big blind $1
*** HOLE CARDS ***
ItaRAnHOgvYOv5ynbG1iTw: folds
GtFB+yyeb2djMdPFuOW/Xg collected $1 from pot
*** SUMMARY ***
Total pot $1 | Rake $0
Seat 1: ItaRAnHOgvYOv5ynbG1iTw (button) (small blind) folded before Flop
Seat 2: GtFB+yyeb2djMdPFuOW/Xg (big blind) collected ($1)



PokerStars Game #59941524698:  Hold'em No Limit ($0.50/$1.00) - 2009/07/01 1:38:05 ET
Table '/RZcOwpZpHQ+OwPwjsbnRw' 6-max Seat #4 is the button
Seat 1: +uSzP8Jwnw7sKfQ4s66b7w ($88.90 in chips)
Seat 2: Z2fXsGcjl+Eax+RzOgwOmg ($100 in chips)
Seat 3: LJMw/I77xpnw0R5T4HnMUg ($107.15 in chips)
Seat 4: j7NIOHLZk7V2o9fOioO5ug ($101 in chips)
Seat 5: wx3sQGkVi2x9wJXuWNHPBw ($164.75 in chips)
Seat 6: o3YLm/rSY916m/on1VjXPA ($207 in chips)
wx3sQGkVi2x9wJXuWNHPBw: posts small blind $0.50
o3YLm/rSY916m/on1VjXPA: posts big blind $1
*** HOLE CARDS ***
+uSzP8Jwnw7sKfQ4s66b7w: folds
Z2fXsGcjl+Eax+RzOgwOmg: raises $1 to $2
LJMw/I77xpnw0R5T4HnMUg: calls $2
j7NIOHLZk7V2o9fOioO5ug: folds
wx3sQGkVi2x9wJXuWNHPBw: folds
o3YLm/rSY916m/on1VjXPA: folds
*** FLOP *** [5d Qs 9d]
Z2fXsGcjl+Eax+RzOgwOmg: bets $4
LJMw/I77xpnw0R5T4HnMUg: calls $4
*** TURN *** [5d Qs 9d] [7s]
Z2fXsGcjl+Eax+RzOgwOmg: checks
LJMw/I77xpnw0R5T4HnMUg: bets $5
Z2fXsGcjl+Eax+RzOgwOmg: calls $5
*** RIVER *** [5d Qs 9d 7s] [6c]
Z2fXsGcjl+Eax+RzOgwOmg: checks
LJMw/I77xpnw0R5T4HnMUg: checks
*** SHOW DOWN ***
Z2fXsGcjl+Eax+RzOgwOmg: shows [Tc Td] (a pair of Tens)
LJMw/I77xpnw0R5T4HnMUg: shows [Jd Qd] (a pair of Queens)
LJMw/I77xpnw0R5T4HnMUg collected $22.40 from pot
*** SUMMARY ***
Total pot $23.50 | Rake $1.10
Board [5d Qs 9d 7s 6c]
Seat 1: +uSzP8Jwnw7sKfQ4s66b7w folded before Flop (didn't bet)
Seat 2: Z2fXsGcjl+Eax+RzOgwOmg showed [Tc Td] and lost with a pair of Tens
Seat 3: LJMw/I77xpnw0R5T4HnMUg showed [Jd Qd] and won ($22.40) with a pair of Queens
Seat 4: j7NIOHLZk7V2o9fOioO5ug (button) folded before Flop (didn't bet)
Seat 5: wx3sQGkVi2x9wJXuWNHPBw (small blind) folded before Flop
Seat 6: o3YLm/rSY916m/on1VjXPA (big blind) folded before Flop



PokerStars Game #59941524410:  Hold'em No Limit ($0.50/$1.00) - 2009/07/01 1:38:05 ET
Table 'DE4ps3MTl+4avTytwFENAg' 6-max Seat #4 is the button
Seat 1: PvfYaKbzMpsmUcbOExckbQ ($103 in chips)
Seat 2: QHvTZcrKe6+maWUfVjP29Q ($106.40 in chips)
Seat 3: cGayYjcyk6+jN57tzIY4TA ($261.60 in chips)
Seat 4: iexehpxaQwzColGqeTEnLQ ($109.40 in chips)
Seat 5: UBZQqpnJZdTYYY1FTb0rLA ($175.40 in chips)
Seat 6: lsLuWlcPA3Rh7kJVLzMh0Q ($100 in chips)
UBZQqpnJZdTYYY1FTb0rLA: posts small blind $0.50
lsLuWlcPA3Rh7kJVLzMh0Q: posts big blind $1
*** HOLE CARDS ***
PvfYaKbzMpsmUcbOExckbQ: folds
QHvTZcrKe6+maWUfVjP29Q: folds
cGayYjcyk6+jN57tzIY4TA: calls $1
iexehpxaQwzColGqeTEnLQ: raises $3 to $4
UBZQqpnJZdTYYY1FTb0rLA: folds
lsLuWlcPA3Rh7kJVLzMh0Q: calls $3
cGayYjcyk6+jN57tzIY4TA: calls $3
*** FLOP *** [Qs 2c 7h]
lsLuWlcPA3Rh7kJVLzMh0Q: checks
cGayYjcyk6+jN57tzIY4TA: bets $5
iexehpxaQwzColGqeTEnLQ: raises $10 to $15
lsLuWlcPA3Rh7kJVLzMh0Q: folds
cGayYjcyk6+jN57tzIY4TA: folds
iexehpxaQwzColGqeTEnLQ collected $21.45 from pot
iexehpxaQwzColGqeTEnLQ: doesn't show hand
*** SUMMARY ***
Total pot $22.50 | Rake $1.05
Board [Qs 2c 7h]
Seat 1: PvfYaKbzMpsmUcbOExckbQ folded before Flop (didn't bet)
Seat 2: QHvTZcrKe6+maWUfVjP29Q folded before Flop (didn't bet)
Seat 3: cGayYjcyk6+jN57tzIY4TA folded on the Flop
Seat 4: iexehpxaQwzColGqeTEnLQ (button) collected ($21.45)
Seat 5: UBZQqpnJZdTYYY1FTb0rLA (small blind) folded before Flop
Seat 6: lsLuWlcPA3Rh7kJVLzMh0Q (big blind) folded on the Flop



PokerStars Game #59941525878:  Hold'em No Limit ($0.50/$1.00) - 2009/07/01 1:38:07 ET
Table 'N6LvHFrb+cdXY/COI6ByOw' 2-max Seat #1 is the button
Seat 1: lXX4W7m3u++JiSOZ46yVMQ ($88.70 in chips)
Seat 2: 9mAoSP3o/mikSZOW2LEEAw ($182.20 in chips)
lXX4W7m3u++JiSOZ46yVMQ: posts small blind $0.50
9mAoSP3o/mikSZOW2LEEAw: posts big blind $1
*** HOLE CARDS ***
lXX4W7m3u++JiSOZ46yVMQ: raises $2 to $3
9mAoSP3o/mikSZOW2LEEAw: calls $2
*** FLOP *** [Kd 6d Ks]
9mAoSP3o/mikSZOW2LEEAw: checks
lXX4W7m3u++JiSOZ46yVMQ: checks
*** TURN *** [Kd 6d Ks] [7s]
9mAoSP3o/mikSZOW2LEEAw: bets $3
lXX4W7m3u++JiSOZ46yVMQ: raises $7 to $10
9mAoSP3o/mikSZOW2LEEAw: calls $7
*** RIVER *** [Kd 6d Ks 7s] [Qs]
9mAoSP3o/mikSZOW2LEEAw: checks
lXX4W7m3u++JiSOZ46yVMQ: bets $38
9mAoSP3o/mikSZOW2LEEAw: folds
lXX4W7m3u++JiSOZ46yVMQ collected $25.50 from pot
*** SUMMARY ***
Total pot $26 | Rake $0.50
Board [Kd 6d Ks 7s Qs]
Seat 1: lXX4W7m3u++JiSOZ46yVMQ (button) (small blind) collected ($25.50)
Seat 2: 9mAoSP3o/mikSZOW2LEEAw (big blind) folded on the River



PokerStars Game #59941526298:  Hold'em No Limit ($0.50/$1.00) - 2009/07/01 1:38:08 ET
Table 'NqGO/cV3MwFAx+ZPB5ANmQ' 2-max Seat #2 is the button
Seat 1: ItaRAnHOgvYOv5ynbG1iTw ($226.20 in chips)
Seat 2: GtFB+yyeb2djMdPFuOW/Xg ($111.50 in chips)
GtFB+yyeb2djMdPFuOW/Xg: posts small blind $0.50
ItaRAnHOgvYOv5ynbG1iTw: posts big blind $1
*** HOLE CARDS ***
GtFB+yyeb2djMdPFuOW/Xg: raises $2 to $3
ItaRAnHOgvYOv5ynbG1iTw: folds
GtFB+yyeb2djMdPFuOW/Xg collected $2 from pot
*** SUMMARY ***
Total pot $2 | Rake $0
Seat 1: ItaRAnHOgvYOv5ynbG1iTw (big blind) folded before Flop
Seat 2: GtFB+yyeb2djMdPFuOW/Xg (button) (small blind) collected ($2)



PokerStars Game #59941526676:  Hold'em No Limit ($0.50/$1.00) - 2009/07/01 1:38:09 ET
Table '7O9fB8yx1u7sJveJn8w6jA' 6-max Seat #2 is the button
Seat 1: 841740 ($53.30 in chips)
Seat 2: wx3sQGkVi2x9wJXuWNHPBw ($206.85 in chips)
Seat 3: hpxXcmRkXXI9HE5+5/j/0Q ($135.90 in chips)
Seat 4: b2a+5TkFf4xJN/Ihhma58Q ($31.85 in chips)
Seat 5: BCEV3COoKY607AzLWayfRA ($100.50 in chips)
Seat 6: r4lpoh2BJZ8S6zyQv1JeSw ($100 in chips)
hpxXcmRkXXI9HE5+5/j/0Q: posts small blind $0.50
b2a+5TkFf4xJN/Ihhma58Q: posts big blind $1
*** HOLE CARDS ***
BCEV3COoKY607AzLWayfRA: folds
r4lpoh2BJZ8S6zyQv1JeSw: raises $2 to $3
841740: calls $3
wx3sQGkVi2x9wJXuWNHPBw: folds
hpxXcmRkXXI9HE5+5/j/0Q: folds
b2a+5TkFf4xJN/Ihhma58Q: folds
*** FLOP *** [Kh 3h 7d]
r4lpoh2BJZ8S6zyQv1JeSw: bets $4
841740: calls $4
*** TURN *** [Kh 3h 7d] [3d]
r4lpoh2BJZ8S6zyQv1JeSw: bets $11
841740: folds
r4lpoh2BJZ8S6zyQv1JeSw collected $14.75 from pot
r4lpoh2BJZ8S6zyQv1JeSw: doesn't show hand
*** SUMMARY ***
Total pot $15.50 | Rake $0.75
Board [Kh 3h 7d 3d]
Seat 1: 841740 folded on the Turn
Seat 2: wx3sQGkVi2x9wJXuWNHPBw (button) folded before Flop (didn't bet)
Seat 3: hpxXcmRkXXI9HE5+5/j/0Q (small blind) folded before Flop
Seat 4: b2a+5TkFf4xJN/Ihhma58Q (big blind) folded before Flop
Seat 5: BCEV3COoKY607AzLWayfRA folded before Flop (didn't bet)
Seat 6: r4lpoh2BJZ8S6zyQv1JeSw collected ($14.75)



PokerStars Game #59941526646:  Hold'em No Limit ($0.50/$1.00) - 2009/07/01 1:38:09 ET
Table 'vs/5jr6ciwjVQ5+Soc+u2A' 6-max Seat #1 is the button
Seat 1: J798qwLuvXyq0BbzsIjOrA ($193.65 in chips)
Seat 2: lXX4W7m3u++JiSOZ46yVMQ ($99 in chips)
Seat 4: 0smcry9L0OOTCP+KzIS5SA ($98 in chips)
Seat 5: +Nt3OPk3XR9SKjZgm2CexQ ($159.35 in chips)
Seat 6: Z2fXsGcjl+Eax+RzOgwOmg ($107.50 in chips)
lXX4W7m3u++JiSOZ46yVMQ: posts small blind $0.50
Ws/3Uo3rQIk8hLgW0P+2xA: is sitting out
0smcry9L0OOTCP+KzIS5SA: posts big blind $1
*** HOLE CARDS ***
Ws/3Uo3rQIk8hLgW0P+2xA has returned
+Nt3OPk3XR9SKjZgm2CexQ: folds
Z2fXsGcjl+Eax+RzOgwOmg: raises $3 to $4
J798qwLuvXyq0BbzsIjOrA: folds
lXX4W7m3u++JiSOZ46yVMQ: calls $3.50
0smcry9L0OOTCP+KzIS5SA: raises $10 to $14
Z2fXsGcjl+Eax+RzOgwOmg: raises $27 to $41
lXX4W7m3u++JiSOZ46yVMQ: folds
0smcry9L0OOTCP+KzIS5SA: folds
Z2fXsGcjl+Eax+RzOgwOmg collected $32 from pot
Z2fXsGcjl+Eax+RzOgwOmg: doesn't show hand
*** SUMMARY ***
Total pot $32 | Rake $0
Seat 1: J798qwLuvXyq0BbzsIjOrA (button) folded before Flop (didn't bet)
Seat 2: lXX4W7m3u++JiSOZ46yVMQ (small blind) folded before Flop
Seat 4: 0smcry9L0OOTCP+KzIS5SA (big blind) folded before Flop
Seat 5: +Nt3OPk3XR9SKjZgm2CexQ folded before Flop (didn't bet)
Seat 6: Z2fXsGcjl+Eax+RzOgwOmg collected ($32)



PokerStars Game #59941527090:  Hold'em No Limit ($0.50/$1.00) - 2009/07/01 1:38:10 ET
Table 'gxFK0BVUD7cupu2uyRUZJg' 6-max Seat #5 is the button
Seat 1: M+X3uChmP6R63IwijVjgTg ($235.90 in chips)
Seat 2: hpxXcmRkXXI9HE5+5/j/0Q ($131.55 in chips)
Seat 3: Z2fXsGcjl+Eax+RzOgwOmg ($100 in chips)
Seat 4: Hcr4S4Nbkj5idKsvYK/eqQ ($101.50 in chips)
Seat 5: 0smcry9L0OOTCP+KzIS5SA ($110 in chips)
Seat 6: dYyb6/42PMC8aNFlm/eBeQ ($125.90 in chips)
dYyb6/42PMC8aNFlm/eBeQ: posts small blind $0.50
M+X3uChmP6R63IwijVjgTg: posts big blind $1
*** HOLE CARDS ***
hpxXcmRkXXI9HE5+5/j/0Q: folds
Z2fXsGcjl+Eax+RzOgwOmg: folds
Hcr4S4Nbkj5idKsvYK/eqQ: folds
0smcry9L0OOTCP+KzIS5SA: folds
dYyb6/42PMC8aNFlm/eBeQ: raises $3 to $4
M+X3uChmP6R63IwijVjgTg: calls $3
*** FLOP *** [4s 9c 2s]
dYyb6/42PMC8aNFlm/eBeQ: bets $2
M+X3uChmP6R63IwijVjgTg: raises $4 to $6
dYyb6/42PMC8aNFlm/eBeQ: calls $4
*** TURN *** [4s 9c 2s] [Kh]
dYyb6/42PMC8aNFlm/eBeQ: checks
M+X3uChmP6R63IwijVjgTg: checks
*** RIVER *** [4s 9c 2s Kh] [Ah]
dYyb6/42PMC8aNFlm/eBeQ: bets $7
M+X3uChmP6R63IwijVjgTg: calls $7
*** SHOW DOWN ***
dYyb6/42PMC8aNFlm/eBeQ: shows [Ac Jh] (a pair of Aces)
M+X3uChmP6R63IwijVjgTg: mucks hand
dYyb6/42PMC8aNFlm/eBeQ collected $32.35 from pot
*** SUMMARY ***
Total pot $34 | Rake $1.65
Board [4s 9c 2s Kh Ah]
Seat 1: M+X3uChmP6R63IwijVjgTg (big blind) mucked
Seat 2: hpxXcmRkXXI9HE5+5/j/0Q folded before Flop (didn't bet)
Seat 3: Z2fXsGcjl+Eax+RzOgwOmg folded before Flop (didn't bet)
Seat 4: Hcr4S4Nbkj5idKsvYK/eqQ folded before Flop (didn't bet)
Seat 5: 0smcry9L0OOTCP+KzIS5SA (button) folded before Flop (didn't bet)
Seat 6: dYyb6/42PMC8aNFlm/eBeQ (small blind) showed [Ac Jh] and won ($32.35) with a pair of Aces



PokerStars Game #59941527710:  Hold'em No Limit ($0.50/$1.00) - 2009/07/01 1:38:11 ET
Table 'qj0HBN4HhQKogreu1bg7xg' 2-max Seat #2 is the button
Seat 1: NYi6JFscYNrofSXy4sM+Yw ($106.90 in chips)
Seat 2: qtyl8CSb0/4yWdbuEPJejA ($171.80 in chips)
qtyl8CSb0/4yWdbuEPJejA: posts small blind $0.50
NYi6JFscYNrofSXy4sM+Yw: posts big blind $1
*** HOLE CARDS ***
qtyl8CSb0/4yWdbuEPJejA: raises $2 to $3
NYi6JFscYNrofSXy4sM+Yw: calls $2
*** FLOP *** [4c 6d 9s]
NYi6JFscYNrofSXy4sM+Yw: checks
qtyl8CSb0/4yWdbuEPJejA: checks
*** TURN *** [4c 6d 9s] [4d]
NYi6JFscYNrofSXy4sM+Yw: bets $3
qtyl8CSb0/4yWdbuEPJejA: folds
NYi6JFscYNrofSXy4sM+Yw collected $5.70 from pot
*** SUMMARY ***
Total pot $6 | Rake $0.30
Board [4c 6d 9s 4d]
Seat 1: NYi6JFscYNrofSXy4sM+Yw (big blind) collected ($5.70)
Seat 2: qtyl8CSb0/4yWdbuEPJejA (button) (small blind) folded on the Turn



PokerStars Game #59941527874:  Hold'em No Limit ($0.50/$1.00) - 2009/07/01 1:38:11 ET
Table 'hugOjcwJvzEwZbK7tyiWuQ' 9-max Seat #8 is the button
Seat 1: S3Ex8K7v6xm5jqjRM7Fl3w ($23.85 in chips)
Seat 2: r27C1nIV4NS4+qbnrgBQSw ($278.60 in chips)
Seat 3: c/6hFCyfLNRn3VFvCeQ1ng ($36.55 in chips)
Seat 4: UWB3oeddt/GObx2Mix2Anw ($159.45 in chips)
Seat 5: AexZ4puUV9meFWwVU6Nv0w ($32.70 in chips)
Seat 6: gUUvmqdVlmvpal6B8nYrmg ($103.95 in chips)
Seat 7: FL3MrLspcF23LYvC4ipBOA ($109.80 in chips)
Seat 8: /zy+DB4S5fUQUSfZWFzYGw ($116.85 in chips)
Seat 9: W8P9bUKCs43TO1xHm0dL6w ($105.80 in chips)
W8P9bUKCs43TO1xHm0dL6w: posts small blind $0.50
S3Ex8K7v6xm5jqjRM7Fl3w: posts big blind $1
*** HOLE CARDS ***
r27C1nIV4NS4+qbnrgBQSw: folds
c/6hFCyfLNRn3VFvCeQ1ng: folds
UWB3oeddt/GObx2Mix2Anw: folds
AexZ4puUV9meFWwVU6Nv0w: calls $1
gUUvmqdVlmvpal6B8nYrmg: folds
FL3MrLspcF23LYvC4ipBOA: folds
/zy+DB4S5fUQUSfZWFzYGw: raises $4 to $5
W8P9bUKCs43TO1xHm0dL6w: folds
S3Ex8K7v6xm5jqjRM7Fl3w: folds
AexZ4puUV9meFWwVU6Nv0w: folds
/zy+DB4S5fUQUSfZWFzYGw collected $3.50 from pot
*** SUMMARY ***
Total pot $3.50 | Rake $0
Seat 1: S3Ex8K7v6xm5jqjRM7Fl3w (big blind) folded before Flop
Seat 2: r27C1nIV4NS4+qbnrgBQSw folded before Flop (didn't bet)
Seat 3: c/6hFCyfLNRn3VFvCeQ1ng folded before Flop (didn't bet)
Seat 4: UWB3oeddt/GObx2Mix2Anw folded before Flop (didn't bet)
Seat 5: AexZ4puUV9meFWwVU6Nv0w folded before Flop
Seat 6: gUUvmqdVlmvpal6B8nYrmg folded before Flop (didn't bet)
Seat 7: FL3MrLspcF23LYvC4ipBOA folded before Flop (didn't bet)
Seat 8: /zy+DB4S5fUQUSfZWFzYGw (button) collected ($3.50)
Seat 9: W8P9bUKCs43TO1xHm0dL6w (small blind) folded before Flop



PokerStars Game #59941528678:  Hold'em No Limit ($0.50/$1.00) - 2009/07/01 1:38:12 ET
Table '3T4owEKJKyGTMePwrv50FQ' 9-max Seat #2 is the button
Seat 1: OGgaARGdJQT4awWVNQ957w ($100 in chips)
Seat 2: t+Id2O6herCLgwnC4m49PA ($35.65 in chips)
Seat 3: DOLzOcBTZYcph5jEfKFWuQ ($100 in chips)
Seat 4: O5Go3jrzbQWxRB6ESK+Ptg ($67.60 in chips)
Seat 5: mMc/PBpqlN24gdi3C/1tOw ($41.40 in chips)
Seat 6: V138SURkdX8LdVBPKdJJag ($108.25 in chips)
Seat 7: 1862487932 ($105.50 in chips)
Seat 8: bLbSOSmSOnqE0iTcH/5dxA ($198.50 in chips)
Seat 9: 61sfw5QTu62YYIt68OsdrA ($88.75 in chips)
DOLzOcBTZYcph5jEfKFWuQ: posts small blind $0.50
O5Go3jrzbQWxRB6ESK+Ptg: posts big blind $1
*** HOLE CARDS ***
mMc/PBpqlN24gdi3C/1tOw: folds
V138SURkdX8LdVBPKdJJag: folds
1862487932: folds
bLbSOSmSOnqE0iTcH/5dxA: folds
61sfw5QTu62YYIt68OsdrA: folds
OGgaARGdJQT4awWVNQ957w: folds
t+Id2O6herCLgwnC4m49PA: calls $1
DOLzOcBTZYcph5jEfKFWuQ: folds
O5Go3jrzbQWxRB6ESK+Ptg: checks
*** FLOP *** [2c Qs 8s]
O5Go3jrzbQWxRB6ESK+Ptg: checks
t+Id2O6herCLgwnC4m49PA: bets $2
O5Go3jrzbQWxRB6ESK+Ptg: folds
t+Id2O6herCLgwnC4m49PA collected $2.40 from pot
*** SUMMARY ***
Total pot $2.50 | Rake $0.10
Board [2c Qs 8s]
Seat 1: OGgaARGdJQT4awWVNQ957w folded before Flop (didn't bet)
Seat 2: t+Id2O6herCLgwnC4m49PA (button) collected ($2.40)
Seat 3: DOLzOcBTZYcph5jEfKFWuQ (small blind) folded before Flop
Seat 4: O5Go3jrzbQWxRB6ESK+Ptg (big blind) folded on the Flop
Seat 5: mMc/PBpqlN24gdi3C/1tOw folded before Flop (didn't bet)
Seat 6: V138SURkdX8LdVBPKdJJag folded before Flop (didn't bet)
Seat 7: 1862487932 folded before Flop (didn't bet)
Seat 8: bLbSOSmSOnqE0iTcH/5dxA folded before Flop (didn't bet)
Seat 9: 61sfw5QTu62YYIt68OsdrA folded before Flop (didn't bet)



PokerStars Game #59941528526:  Hold'em No Limit ($0.50/$1.00) - 2009/07/01 1:38:12 ET
Table 'tHb+N6GaPEmmBAe36B2R9Q' 2-max Seat #2 is the button
Seat 1: rL+Zpv4/vX2BVHcyfh/NXA ($104 in chips)
Seat 2: Pm1sDZZi0zFtnFGXLznkug ($128.80 in chips)
Pm1sDZZi0zFtnFGXLznkug: posts small blind $0.50
rL+Zpv4/vX2BVHcyfh/NXA: posts big blind $1
*** HOLE CARDS ***
Pm1sDZZi0zFtnFGXLznkug: calls $0.50
rL+Zpv4/vX2BVHcyfh/NXA: checks
*** FLOP *** [2h Th 3d]
rL+Zpv4/vX2BVHcyfh/NXA: checks
Pm1sDZZi0zFtnFGXLznkug: bets $2
rL+Zpv4/vX2BVHcyfh/NXA: raises $4 to $6
Pm1sDZZi0zFtnFGXLznkug: calls $4
*** TURN *** [2h Th 3d] [Kd]
rL+Zpv4/vX2BVHcyfh/NXA: bets $10
Pm1sDZZi0zFtnFGXLznkug: calls $10
*** RIVER *** [2h Th 3d Kd] [7c]
rL+Zpv4/vX2BVHcyfh/NXA: bets $30
Pm1sDZZi0zFtnFGXLznkug: raises $81.80 to $111.80 and is all-in
rL+Zpv4/vX2BVHcyfh/NXA: folds
Pm1sDZZi0zFtnFGXLznkug collected $93.50 from pot
*** SUMMARY ***
Total pot $94 | Rake $0.50
Board [2h Th 3d Kd 7c]
Seat 1: rL+Zpv4/vX2BVHcyfh/NXA (big blind) folded on the River
Seat 2: Pm1sDZZi0zFtnFGXLznkug (button) (small blind) collected ($93.50)



PokerStars Game #59941529036:  Hold'em No Limit ($0.50/$1.00) - 2009/07/01 1:38:13 ET
Table 'pHrhryH8jPNdQfY62f8v+g' 6-max Seat #3 is the button
Seat 1: 4d1rWhpu8DzLmzMbR3QKyA ($148.95 in chips)
Seat 2: JwCcjZl0bjJzG7hmE0dnTA ($111.05 in chips)
Seat 3: 8oS5O7iD/qnFXFXJrGIgNQ ($109.30 in chips)
Seat 4: 1f3beyIML24UqEMTbWy93g ($54.70 in chips)
Seat 5: d8WX+9nUHoqlrAGagO0Wow ($24.15 in chips)
Seat 6: xAU6q2/cwmby2sxmA8VcmA ($179.80 in chips)
1f3beyIML24UqEMTbWy93g: posts small blind $0.50
d8WX+9nUHoqlrAGagO0Wow: posts big blind $1
*** HOLE CARDS ***
xAU6q2/cwmby2sxmA8VcmA: folds
4d1rWhpu8DzLmzMbR3QKyA: folds
JwCcjZl0bjJzG7hmE0dnTA: folds
8oS5O7iD/qnFXFXJrGIgNQ: raises $2.50 to $3.50
1f3beyIML24UqEMTbWy93g: folds
d8WX+9nUHoqlrAGagO0Wow: folds
8oS5O7iD/qnFXFXJrGIgNQ collected $2.50 from pot
*** SUMMARY ***
Total pot $2.50 | Rake $0
Seat 1: 4d1rWhpu8DzLmzMbR3QKyA folded before Flop (didn't bet)
Seat 2: JwCcjZl0bjJzG7hmE0dnTA folded before Flop (didn't bet)
Seat 3: 8oS5O7iD/qnFXFXJrGIgNQ (button) collected ($2.50)
Seat 4: 1f3beyIML24UqEMTbWy93g (small blind) folded before Flop
Seat 5: d8WX+9nUHoqlrAGagO0Wow (big blind) folded before Flop
Seat 6: xAU6q2/cwmby2sxmA8VcmA folded before Flop (didn't bet)



PokerStars Game #59941531262:  Hold'em No Limit ($0.50/$1.00) - 2009/07/01 1:38:17 ET
Table 'fZjVbKj9D8yOB+Rj7NaP/A' 9-max Seat #7 is the button
Seat 1: 9BZCcac3+McErkkSN2YScA ($103.15 in chips)
Seat 2: PTAFYDIUSsG+SArbxNl+Aw ($104 in chips)
Seat 3: yAbu2QsRPVcjPbqlf/jDxw ($103.65 in chips)
Seat 4: 997ViqAtWn1FPjJqcffwcA ($100 in chips)
Seat 5: PkGfq5xrSlNsujKaG/HF4Q ($100 in chips)
Seat 6: OvwYHV65yUbgdBjSmo1+5g ($135.45 in chips)
Seat 7: SyS20PAm3RpT6uLBsGkwOA ($81.70 in chips)
Seat 8: EVvb0huXeMB7dnOAiO4ggA ($49 in chips)
Seat 9: qheQay5YvP2DMAb3OUSxtw ($100.50 in chips)
EVvb0huXeMB7dnOAiO4ggA: posts small blind $0.50
qheQay5YvP2DMAb3OUSxtw: posts big blind $1
*** HOLE CARDS ***
9BZCcac3+McErkkSN2YScA: folds
9BZCcac3+McErkkSN2YScA leaves the table
PTAFYDIUSsG+SArbxNl+Aw: folds
yAbu2QsRPVcjPbqlf/jDxw: folds
997ViqAtWn1FPjJqcffwcA: folds
PkGfq5xrSlNsujKaG/HF4Q: folds
OvwYHV65yUbgdBjSmo1+5g: folds
SyS20PAm3RpT6uLBsGkwOA: raises $4 to $5
EVvb0huXeMB7dnOAiO4ggA: folds
qheQay5YvP2DMAb3OUSxtw: calls $4
*** FLOP *** [Ts 9d Th]
qheQay5YvP2DMAb3OUSxtw: checks
SyS20PAm3RpT6uLBsGkwOA: bets $10
qheQay5YvP2DMAb3OUSxtw: calls $10
*** TURN *** [Ts 9d Th] [Jc]
qheQay5YvP2DMAb3OUSxtw: checks
SyS20PAm3RpT6uLBsGkwOA: checks
*** RIVER *** [Ts 9d Th Jc] [3d]
qheQay5YvP2DMAb3OUSxtw: bets $16
SyS20PAm3RpT6uLBsGkwOA: raises $16 to $32
qheQay5YvP2DMAb3OUSxtw: calls $16
*** SHOW DOWN ***
SyS20PAm3RpT6uLBsGkwOA: shows [Qd Td] (three of a kind, Tens)
qheQay5YvP2DMAb3OUSxtw: shows [9h 9c] (a full house, Nines full of Tens)
qheQay5YvP2DMAb3OUSxtw collected $91.50 from pot
*** SUMMARY ***
Total pot $94.50 | Rake $3
Board [Ts 9d Th Jc 3d]
Seat 1: 9BZCcac3+McErkkSN2YScA folded before Flop (didn't bet)
Seat 2: PTAFYDIUSsG+SArbxNl+Aw folded before Flop (didn't bet)
Seat 3: yAbu2QsRPVcjPbqlf/jDxw folded before Flop (didn't bet)
Seat 4: 997ViqAtWn1FPjJqcffwcA folded before Flop (didn't bet)
Seat 5: PkGfq5xrSlNsujKaG/HF4Q folded before Flop (didn't bet)
Seat 6: OvwYHV65yUbgdBjSmo1+5g folded before Flop (didn't bet)
Seat 7: SyS20PAm3RpT6uLBsGkwOA (button) showed [Qd Td] and lost with three of a kind, Tens
Seat 8: EVvb0huXeMB7dnOAiO4ggA (small blind) folded before Flop
Seat 9: qheQay5YvP2DMAb3OUSxtw (big blind) showed [9h 9c] and won ($91.50) with a full house, Nines full of Tens



PokerStars Game #59941531864:  Hold'em No Limit ($0.50/$1.00) - 2009/07/01 1:38:18 ET
Table 'NqGO/cV3MwFAx+ZPB5ANmQ' 2-max Seat #1 is the button
Seat 1: ItaRAnHOgvYOv5ynbG1iTw ($225.20 in chips)
Seat 2: GtFB+yyeb2djMdPFuOW/Xg ($112.50 in chips)
ItaRAnHOgvYOv5ynbG1iTw: posts small blind $0.50
GtFB+yyeb2djMdPFuOW/Xg: posts big blind $1
*** HOLE CARDS ***
ItaRAnHOgvYOv5ynbG1iTw: raises $2 to $3
GtFB+yyeb2djMdPFuOW/Xg: raises $8 to $11
ItaRAnHOgvYOv5ynbG1iTw: calls $8
*** FLOP *** [5d Kh 8h]
GtFB+yyeb2djMdPFuOW/Xg: bets $15
ItaRAnHOgvYOv5ynbG1iTw: calls $15
*** TURN *** [5d Kh 8h] [8s]
GtFB+yyeb2djMdPFuOW/Xg: checks
ItaRAnHOgvYOv5ynbG1iTw: checks
*** RIVER *** [5d Kh 8h 8s] [6h]
GtFB+yyeb2djMdPFuOW/Xg: checks
ItaRAnHOgvYOv5ynbG1iTw: bets $35
GtFB+yyeb2djMdPFuOW/Xg: folds
ItaRAnHOgvYOv5ynbG1iTw collected $51.50 from pot
*** SUMMARY ***
Total pot $52 | Rake $0.50
Board [5d Kh 8h 8s 6h]
Seat 1: ItaRAnHOgvYOv5ynbG1iTw (button) (small blind) collected ($51.50)
Seat 2: GtFB+yyeb2djMdPFuOW/Xg (big blind) folded on the River



PokerStars Game #59941532196:  Hold'em No Limit ($0.50/$1.00) - 2009/07/01 1:38:19 ET
Table 'b8oW/dOL7fDza5DfZ/dOJQ' 6-max Seat #6 is the button
Seat 1: NakujTNjHFgzceydFf+E2Q ($58 in chips)
Seat 2: TSuRyAHnUPCFjP7Z0rEE0w ($119 in chips)
Seat 3: d8WX+9nUHoqlrAGagO0Wow ($34.30 in chips)
Seat 4: 8rDbzImSi1zgxtqtF1pSbA ($20 in chips)
Seat 5: r4lpoh2BJZ8S6zyQv1JeSw ($100 in chips)
Seat 6: PvfYaKbzMpsmUcbOExckbQ ($148.10 in chips)
NakujTNjHFgzceydFf+E2Q: posts small blind $0.50
TSuRyAHnUPCFjP7Z0rEE0w: posts big blind $1
*** HOLE CARDS ***
d8WX+9nUHoqlrAGagO0Wow: folds
8rDbzImSi1zgxtqtF1pSbA: folds
r4lpoh2BJZ8S6zyQv1JeSw: raises $2 to $3
PvfYaKbzMpsmUcbOExckbQ: folds
NakujTNjHFgzceydFf+E2Q: folds
TSuRyAHnUPCFjP7Z0rEE0w: folds
r4lpoh2BJZ8S6zyQv1JeSw collected $2.50 from pot
r4lpoh2BJZ8S6zyQv1JeSw: doesn't show hand
*** SUMMARY ***
Total pot $2.50 | Rake $0
Seat 1: NakujTNjHFgzceydFf+E2Q (small blind) folded before Flop
Seat 2: TSuRyAHnUPCFjP7Z0rEE0w (big blind) folded before Flop
Seat 3: d8WX+9nUHoqlrAGagO0Wow folded before Flop (didn't bet)
Seat 4: 8rDbzImSi1zgxtqtF1pSbA folded before Flop (didn't bet)
Seat 5: r4lpoh2BJZ8S6zyQv1JeSw collected ($2.50)
Seat 6: PvfYaKbzMpsmUcbOExckbQ (button) folded before Flop (didn't bet)



PokerStars Game #59941532210:  Hold'em No Limit ($0.50/$1.00) - 2009/07/01 1:38:19 ET
Table '7Nl0ffnjeK44/vmeexh3MQ' 9-max Seat #9 is the button
Seat 1: V138SURkdX8LdVBPKdJJag ($102.35 in chips)
Seat 2: OGgaARGdJQT4awWVNQ957w ($100 in chips)
Seat 3: JMmUYT5pIKCKh2pGjCB/4w ($58.40 in chips)
Seat 4: bLbSOSmSOnqE0iTcH/5dxA ($106.80 in chips)
Seat 5: 61sfw5QTu62YYIt68OsdrA ($77.55 in chips)
Seat 6: FVs16t7GgfWgQWt4JxsObQ ($32.25 in chips)
Seat 7: 997ViqAtWn1FPjJqcffwcA ($109.10 in chips)
Seat 8: HRJJZiSxFAehJGaET63dlA ($46.40 in chips)
Seat 9: /JHoNdt0fK6X+isrqRfV3w ($18.50 in chips)
V138SURkdX8LdVBPKdJJag: posts small blind $0.50
OGgaARGdJQT4awWVNQ957w: posts big blind $1
*** HOLE CARDS ***
JMmUYT5pIKCKh2pGjCB/4w: folds
bLbSOSmSOnqE0iTcH/5dxA: folds
61sfw5QTu62YYIt68OsdrA: folds
FVs16t7GgfWgQWt4JxsObQ: folds
997ViqAtWn1FPjJqcffwcA: folds
HRJJZiSxFAehJGaET63dlA: folds
/JHoNdt0fK6X+isrqRfV3w: folds
V138SURkdX8LdVBPKdJJag: folds
OGgaARGdJQT4awWVNQ957w collected $1 from pot
OGgaARGdJQT4awWVNQ957w: doesn't show hand
*** SUMMARY ***
Total pot $1 | Rake $0
Seat 1: V138SURkdX8LdVBPKdJJag (small blind) folded before Flop
Seat 2: OGgaARGdJQT4awWVNQ957w (big blind) collected ($1)
Seat 3: JMmUYT5pIKCKh2pGjCB/4w folded before Flop (didn't bet)
Seat 4: bLbSOSmSOnqE0iTcH/5dxA folded before Flop (didn't bet)
Seat 5: 61sfw5QTu62YYIt68OsdrA folded before Flop (didn't bet)
Seat 6: FVs16t7GgfWgQWt4JxsObQ folded before Flop (didn't bet)
Seat 7: 997ViqAtWn1FPjJqcffwcA folded before Flop (didn't bet)
Seat 8: HRJJZiSxFAehJGaET63dlA folded before Flop (didn't bet)
Seat 9: /JHoNdt0fK6X+isrqRfV3w (button) folded before Flop (didn't bet)



PokerStars Game #59941532754:  Hold'em No Limit ($0.50/$1.00) - 2009/07/01 1:38:20 ET
Table 'VOs36P6NW+QyXeQ1B62kmAE9S5sEoK9Q3olj2a53gABASeat #2 is the button
Seat 1: 4h8XtuVJtWh3DJpxGo7k5Q ($24.05 in chips)
Seat 2: y27w5IK2WXqmYzS8OU0wKA ($147.15 in chips)
Seat 3: p00KmyZiD/isPc/lZwNBTg ($17 in chips)
Seat 4: ene3nLSnQ4N961iBaUsSmA ($100 in chips)
Seat 5: o3YLm/rSY916m/on1VjXPA ($136.10 in chips)
Seat 6: slVKuQyEz8Qj4E3uLPYNXg ($45.95 in chips)
p00KmyZiD/isPc/lZwNBTg: posts small blind $0.50
ene3nLSnQ4N961iBaUsSmA: posts big blind $1
*** HOLE CARDS ***
o3YLm/rSY916m/on1VjXPA: folds
slVKuQyEz8Qj4E3uLPYNXg: folds
4h8XtuVJtWh3DJpxGo7k5Q: raises $1 to $2
y27w5IK2WXqmYzS8OU0wKA: folds
p00KmyZiD/isPc/lZwNBTg: calls $1.50
ene3nLSnQ4N961iBaUsSmA: folds
*** FLOP *** [Jc 3c 5s]
p00KmyZiD/isPc/lZwNBTg: checks
4h8XtuVJtWh3DJpxGo7k5Q: bets $6
p00KmyZiD/isPc/lZwNBTg: folds
4h8XtuVJtWh3DJpxGo7k5Q collected $4.75 from pot
4h8XtuVJtWh3DJpxGo7k5Q: doesn't show hand
*** SUMMARY ***
Total pot $5 | Rake $0.25
Board [Jc 3c 5s]
Seat 1: 4h8XtuVJtWh3DJpxGo7k5Q collected ($4.75)
Seat 2: y27w5IK2WXqmYzS8OU0wKA (button) folded before Flop (didn't bet)
Seat 3: p00KmyZiD/isPc/lZwNBTg (small blind) folded on the Flop
Seat 4: ene3nLSnQ4N961iBaUsSmA (big blind) folded before Flop
Seat 5: o3YLm/rSY916m/on1VjXPA folded before Flop (didn't bet)
Seat 6: slVKuQyEz8Qj4E3uLPYNXg folded before Flop (didn't bet)



PokerStars Game #59941534198:  Hold'em No Limit ($0.50/$1.00) - 2009/07/01 1:38:23 ET
Table 'W/wyObTiXZm+Ckkl3YxcSw' 6-max Seat #1 is the button
Seat 1: eUBBn2R56C1IQ6Cs/vitwg ($175.55 in chips)
Seat 2: oDiBRCaF0QVtd3kO6xZIXw ($115.90 in chips)
Seat 3: 4OO5v3AVduL0tePNx8wk5A ($100 in chips)
Seat 4: UBZQqpnJZdTYYY1FTb0rLA ($156.70 in chips)
Seat 5: +OrCjyw70oZhJiD22Mn+bg ($207 in chips)
Seat 6: b2a+5TkFf4xJN/Ihhma58Q ($35.80 in chips)
oDiBRCaF0QVtd3kO6xZIXw: posts small blind $0.50
4OO5v3AVduL0tePNx8wk5A: posts big blind $1
b2a+5TkFf4xJN/Ihhma58Q: posts small & big blinds $1.50
*** HOLE CARDS ***
UBZQqpnJZdTYYY1FTb0rLA: folds
+OrCjyw70oZhJiD22Mn+bg: raises $4 to $5
b2a+5TkFf4xJN/Ihhma58Q: folds
eUBBn2R56C1IQ6Cs/vitwg: folds
oDiBRCaF0QVtd3kO6xZIXw: calls $4.50
4OO5v3AVduL0tePNx8wk5A: folds
*** FLOP *** [5c Kd 7s]
eUBBn2R56C1IQ6Cs/vitwg said, "twice THAT HAPPEND"
eUBBn2R56C1IQ6Cs/vitwg said, "in less then ten minutes"
oDiBRCaF0QVtd3kO6xZIXw: bets $8
+OrCjyw70oZhJiD22Mn+bg: folds
eUBBn2R56C1IQ6Cs/vitwg said, "****ty variance wow"
oDiBRCaF0QVtd3kO6xZIXw collected $11.90 from pot
oDiBRCaF0QVtd3kO6xZIXw: doesn't show hand
*** SUMMARY ***
Total pot $12.50 | Rake $0.60
Board [5c Kd 7s]
Seat 1: eUBBn2R56C1IQ6Cs/vitwg (button) folded before Flop (didn't bet)
Seat 2: oDiBRCaF0QVtd3kO6xZIXw (small blind) collected ($11.90)
Seat 3: 4OO5v3AVduL0tePNx8wk5A (big blind) folded before Flop
Seat 4: UBZQqpnJZdTYYY1FTb0rLA folded before Flop (didn't bet)
Seat 5: +OrCjyw70oZhJiD22Mn+bg folded on the Flop
Seat 6: b2a+5TkFf4xJN/Ihhma58Q folded before Flop



PokerStars Game #59941534880:  Hold'em No Limit ($0.50/$1.00) - 2009/07/01 1:38:24 ET
Table 'GxCPo/gd3OSthkYrAxJngg' 6-max Seat #6 is the button
Seat 1: sH8BpAFP+jGFxCgVpD1Lew ($225.90 in chips)
Seat 2: YExX2paeIHrmfIwV1ivM/w ($63.10 in chips)
Seat 3: idVgoPAdspFPCzee6aF9Pg ($134.50 in chips)
Seat 4: YMJG+F++3Aj6P8dAWda5fw ($205.35 in chips)
Seat 5: vX+iYAEINFeLxwMla7DY1Q ($98.50 in chips)
Seat 6: 4d1rWhpu8DzLmzMbR3QKyA ($109.55 in chips)
sH8BpAFP+jGFxCgVpD1Lew: posts small blind $0.50
YExX2paeIHrmfIwV1ivM/w: posts big blind $1
*** HOLE CARDS ***
idVgoPAdspFPCzee6aF9Pg: folds
YMJG+F++3Aj6P8dAWda5fw: folds
vX+iYAEINFeLxwMla7DY1Q: folds
4d1rWhpu8DzLmzMbR3QKyA: raises $2 to $3
sH8BpAFP+jGFxCgVpD1Lew: calls $2.50
YExX2paeIHrmfIwV1ivM/w: folds
*** FLOP *** [Kh 2d 4c]
sH8BpAFP+jGFxCgVpD1Lew: checks
4d1rWhpu8DzLmzMbR3QKyA: checks
*** TURN *** [Kh 2d 4c] [7c]
sH8BpAFP+jGFxCgVpD1Lew: bets $6
4d1rWhpu8DzLmzMbR3QKyA: folds
sH8BpAFP+jGFxCgVpD1Lew collected $6.65 from pot
*** SUMMARY ***
Total pot $7 | Rake $0.35
Board [Kh 2d 4c 7c]
Seat 1: sH8BpAFP+jGFxCgVpD1Lew (small blind) collected ($6.65)
Seat 2: YExX2paeIHrmfIwV1ivM/w (big blind) folded before Flop
Seat 3: idVgoPAdspFPCzee6aF9Pg folded before Flop (didn't bet)
Seat 4: YMJG+F++3Aj6P8dAWda5fw folded before Flop (didn't bet)
Seat 5: vX+iYAEINFeLxwMla7DY1Q folded before Flop (didn't bet)
Seat 6: 4d1rWhpu8DzLmzMbR3QKyA (button) folded on the Turn



PokerStars Game #59941535546:  Hold'em No Limit ($0.50/$1.00) - 2009/07/01 1:38:25 ET
Table 'E9S5sEoK9Q3olj2a53gABA' 2-max Seat #1 is the button
Seat 1: NYi6JFscYNrofSXy4sM+Yw ($100 in chips)
Seat 2: mgi+mjKb1Sc3CCs7TlfoCw ($45.90 in chips)
NYi6JFscYNrofSXy4sM+Yw: posts small blind $0.50
mgi+mjKb1Sc3CCs7TlfoCw: posts big blind $1
*** HOLE CARDS ***
NYi6JFscYNrofSXy4sM+Yw: raises $2 to $3
mgi+mjKb1Sc3CCs7TlfoCw: folds
NYi6JFscYNrofSXy4sM+Yw collected $2 from pot
*** SUMMARY ***
Total pot $2 | Rake $0
Seat 1: NYi6JFscYNrofSXy4sM+Yw (button) (small blind) collected ($2)
Seat 2: mgi+mjKb1Sc3CCs7TlfoCw (big blind) folded before Flop



PokerStars Game #59941536778:  Hold'em No Limit ($0.50/$1.00) - 2009/07/01 1:38:27 ET
Table 'QSIig7BLMc9wY/rgBechzw' 6-max Seat #3 is the button
Seat 1: Z2fXsGcjl+Eax+RzOgwOmg ($110.05 in chips)
Seat 2: mLOIkH/qmRa+mVujQIhBRg ($27.35 in chips)
Seat 3: 4OO5v3AVduL0tePNx8wk5A ($103 in chips)
Seat 4: +uSzP8Jwnw7sKfQ4s66b7w ($58.30 in chips)
Seat 5: lsLuWlcPA3Rh7kJVLzMh0Q ($100.20 in chips)
+uSzP8Jwnw7sKfQ4s66b7w: posts small blind $0.50
lsLuWlcPA3Rh7kJVLzMh0Q: posts big blind $1
Wj7mKnRFR90j40wWUu2+Og: sits out
*** HOLE CARDS ***
Z2fXsGcjl+Eax+RzOgwOmg: raises $3 to $4
mLOIkH/qmRa+mVujQIhBRg: folds
4OO5v3AVduL0tePNx8wk5A: folds
+uSzP8Jwnw7sKfQ4s66b7w: folds
lsLuWlcPA3Rh7kJVLzMh0Q: folds
Z2fXsGcjl+Eax+RzOgwOmg collected $2.50 from pot
Z2fXsGcjl+Eax+RzOgwOmg: doesn't show hand
*** SUMMARY ***
Total pot $2.50 | Rake $0
Seat 1: Z2fXsGcjl+Eax+RzOgwOmg collected ($2.50)
Seat 2: mLOIkH/qmRa+mVujQIhBRg folded before Flop (didn't bet)
Seat 3: 4OO5v3AVduL0tePNx8wk5A (button) folded before Flop (didn't bet)
Seat 4: +uSzP8Jwnw7sKfQ4s66b7w (small blind) folded before Flop
Seat 5: lsLuWlcPA3Rh7kJVLzMh0Q (big blind) folded before Flop



PokerStars Game #59941536824:  Hold'em No Limit ($0.50/$1.00) - 2009/07/01 1:38:27 ET
Table 'O96CPOtvMBWP6kzuYDfdFA' 6-max Seat #5 is the button
Seat 1: 6alLXQIITA2EZ/lBeym8Dw ($128.25 in chips)
Seat 2: 4d1rWhpu8DzLmzMbR3QKyA ($101.50 in chips)
Seat 4: /P4w1pHg2zHYg/4ubJ0dPw ($72.45 in chips)
Seat 5: vX+iYAEINFeLxwMla7DY1Q ($98.50 in chips)
Seat 6: 3syOXva630dm1FTdwnuLpw ($72.15 in chips)
3syOXva630dm1FTdwnuLpw: posts small blind $0.50
6alLXQIITA2EZ/lBeym8Dw: posts big blind $1
*** HOLE CARDS ***
4d1rWhpu8DzLmzMbR3QKyA: folds
/P4w1pHg2zHYg/4ubJ0dPw: folds
vX+iYAEINFeLxwMla7DY1Q: folds
3syOXva630dm1FTdwnuLpw: raises $2 to $3
6alLXQIITA2EZ/lBeym8Dw: folds
3syOXva630dm1FTdwnuLpw collected $2 from pot
*** SUMMARY ***
Total pot $2 | Rake $0
Seat 1: 6alLXQIITA2EZ/lBeym8Dw (big blind) folded before Flop
Seat 2: 4d1rWhpu8DzLmzMbR3QKyA folded before Flop (didn't bet)
Seat 4: /P4w1pHg2zHYg/4ubJ0dPw folded before Flop (didn't bet)
Seat 5: vX+iYAEINFeLxwMla7DY1Q (button) folded before Flop (didn't bet)
Seat 6: 3syOXva630dm1FTdwnuLpw (small blind) collected ($2)



PokerStars Game #59941537012:  Hold'em No Limit ($0.50/$1.00) - 2009/07/01 1:38:28 ET
Table 'tJq9SfN1ywY0r03VBlWlwQ' 9-max Seat #4 is the button
Seat 1: wZsU+w9r7G66x93UuvBf1Q ($298.55 in chips)
Seat 2: VPF+HjszMvUIpy0CHIwH3A ($18.50 in chips)
Seat 4: bLbSOSmSOnqE0iTcH/5dxA ($118.20 in chips)
Seat 5: h5ipsNTMyolp7xn/NAvWkA ($132.80 in chips)
Seat 6: gUUvmqdVlmvpal6B8nYrmg ($100 in chips)
Seat 7: Ogn4JDV3mp4ZDKO49IFzKA ($19.90 in chips)
Seat 8: G4DEhsZFmznGNVpy2SEocA ($40.80 in chips)
Seat 9: XE5QF1y74bpHog9JxWJMWQ ($100 in chips)
h5ipsNTMyolp7xn/NAvWkA: posts small blind $0.50
gUUvmqdVlmvpal6B8nYrmg: posts big blind $1
*** HOLE CARDS ***
Ogn4JDV3mp4ZDKO49IFzKA: folds
G4DEhsZFmznGNVpy2SEocA: folds
XE5QF1y74bpHog9JxWJMWQ: folds
wZsU+w9r7G66x93UuvBf1Q: folds
VPF+HjszMvUIpy0CHIwH3A: folds
bLbSOSmSOnqE0iTcH/5dxA: folds
h5ipsNTMyolp7xn/NAvWkA: calls $0.50
gUUvmqdVlmvpal6B8nYrmg: raises $3 to $4
h5ipsNTMyolp7xn/NAvWkA: calls $3
*** FLOP *** [3s 2c Ts]
h5ipsNTMyolp7xn/NAvWkA: checks
gUUvmqdVlmvpal6B8nYrmg: bets $6
h5ipsNTMyolp7xn/NAvWkA: folds
gUUvmqdVlmvpal6B8nYrmg collected $7.60 from pot
*** SUMMARY ***
Total pot $8 | Rake $0.40
Board [3s 2c Ts]
Seat 1: wZsU+w9r7G66x93UuvBf1Q folded before Flop (didn't bet)
Seat 2: VPF+HjszMvUIpy0CHIwH3A folded before Flop (didn't bet)
Seat 4: bLbSOSmSOnqE0iTcH/5dxA (button) folded before Flop (didn't bet)
Seat 5: h5ipsNTMyolp7xn/NAvWkA (small blind) folded on the Flop
Seat 6: gUUvmqdVlmvpal6B8nYrmg (big blind) collected ($7.60)
Seat 7: Ogn4JDV3mp4ZDKO49IFzKA folded before Flop (didn't bet)
Seat 8: G4DEhsZFmznGNVpy2SEocA folded before Flop (didn't bet)
Seat 9: XE5QF1y74bpHog9JxWJMWQ folded before Flop (didn't bet)



PokerStars Game #59941537838:  Hold'em No Limit ($0.50/$1.00) - 2009/07/01 1:38:29 ET
Table 'qj0HBN4HhQKogreu1bg7xg' 2-max Seat #1 is the button
Seat 1: NYi6JFscYNrofSXy4sM+Yw ($109.60 in chips)
Seat 2: qtyl8CSb0/4yWdbuEPJejA ($168.80 in chips)
NYi6JFscYNrofSXy4sM+Yw: posts small blind $0.50
qtyl8CSb0/4yWdbuEPJejA: posts big blind $1
*** HOLE CARDS ***
NYi6JFscYNrofSXy4sM+Yw: raises $2 to $3
qtyl8CSb0/4yWdbuEPJejA: folds
NYi6JFscYNrofSXy4sM+Yw collected $2 from pot
NYi6JFscYNrofSXy4sM+Yw: doesn't show hand
*** SUMMARY ***
Total pot $2 | Rake $0
Seat 1: NYi6JFscYNrofSXy4sM+Yw (button) (small blind) collected ($2)
Seat 2: qtyl8CSb0/4yWdbuEPJejA (big blind) folded before Flop



PokerStars Game #59941540868:  Hold'em No Limit ($0.50/$1.00) - 2009/07/01 1:38:34 ET
Table 'E9S5sEoK9Q3olj2a53gABA' 2-max Seat #2 is the button
Seat 1: NYi6JFscYNrofSXy4sM+Yw ($101 in chips)
Seat 2: mgi+mjKb1Sc3CCs7TlfoCw ($44.90 in chips)
mgi+mjKb1Sc3CCs7TlfoCw: posts small blind $0.50
NYi6JFscYNrofSXy4sM+Yw: posts big blind $1
*** HOLE CARDS ***
mgi+mjKb1Sc3CCs7TlfoCw: folds
NYi6JFscYNrofSXy4sM+Yw collected $1 from pot
*** SUMMARY ***
Total pot $1 | Rake $0
Seat 1: NYi6JFscYNrofSXy4sM+Yw (big blind) collected ($1)
Seat 2: mgi+mjKb1Sc3CCs7TlfoCw (button) (small blind) folded before Flop



PokerStars Game #59941541376:  Hold'em No Limit ($0.50/$1.00) - 2009/07/01 1:38:35 ET
Table 'pHrhryH8jPNdQfY62f8v+g' 6-max Seat #4 is the button
Seat 1: 4d1rWhpu8DzLmzMbR3QKyA ($148.95 in chips)
Seat 2: JwCcjZl0bjJzG7hmE0dnTA ($111.05 in chips)
Seat 3: 8oS5O7iD/qnFXFXJrGIgNQ ($110.80 in chips)
Seat 4: 1f3beyIML24UqEMTbWy93g ($54.20 in chips)
Seat 5: d8WX+9nUHoqlrAGagO0Wow ($23.15 in chips)
Seat 6: xAU6q2/cwmby2sxmA8VcmA ($179.80 in chips)
d8WX+9nUHoqlrAGagO0Wow: posts small blind $0.50
xAU6q2/cwmby2sxmA8VcmA: posts big blind $1
*** HOLE CARDS ***
4d1rWhpu8DzLmzMbR3QKyA: folds
JwCcjZl0bjJzG7hmE0dnTA: folds
8oS5O7iD/qnFXFXJrGIgNQ: folds
1f3beyIML24UqEMTbWy93g: raises $2 to $3
d8WX+9nUHoqlrAGagO0Wow: calls $2.50
xAU6q2/cwmby2sxmA8VcmA: folds
*** FLOP *** [7d 5h Ah]
d8WX+9nUHoqlrAGagO0Wow: checks
1f3beyIML24UqEMTbWy93g: bets $4
d8WX+9nUHoqlrAGagO0Wow: folds
1f3beyIML24UqEMTbWy93g collected $6.65 from pot
*** SUMMARY ***
Total pot $7 | Rake $0.35
Board [7d 5h Ah]
Seat 1: 4d1rWhpu8DzLmzMbR3QKyA folded before Flop (didn't bet)
Seat 2: JwCcjZl0bjJzG7hmE0dnTA folded before Flop (didn't bet)
Seat 3: 8oS5O7iD/qnFXFXJrGIgNQ folded before Flop (didn't bet)
Seat 4: 1f3beyIML24UqEMTbWy93g (button) collected ($6.65)
Seat 5: d8WX+9nUHoqlrAGagO0Wow (small blind) folded on the Flop
Seat 6: xAU6q2/cwmby2sxmA8VcmA (big blind) folded before Flop



PokerStars Game #59941540944:  Hold'em No Limit ($0.50/$1.00) - 2009/07/01 1:38:35 ET
Table 'ZFWj23PMihdwrNWv41OG/QtyUh+jyNvrceIQdKMJjQ2weat #2 is the button
Seat 1: j3hj7KQwBVU5NTFmtYomSw ($87.75 in chips)
Seat 2: 0smcry9L0OOTCP+KzIS5SA ($97 in chips)
Seat 3: cWwhvq/+r/w8nkhwrJoekQ ($46.70 in chips)
Seat 4: O5ZesE/6mHyuWWbvkiH/Fg ($66.65 in chips)
Seat 5: j7NIOHLZk7V2o9fOioO5ug ($100 in chips)
Seat 6: u23r4AyKPgHioZ6t7z6qrA ($100 in chips)
cWwhvq/+r/w8nkhwrJoekQ: posts small blind $0.50
O5ZesE/6mHyuWWbvkiH/Fg: posts big blind $1
*** HOLE CARDS ***
O5ZesE/6mHyuWWbvkiH/Fg said, "ty"
j7NIOHLZk7V2o9fOioO5ug: raises $2 to $3
u23r4AyKPgHioZ6t7z6qrA said, "hit previose"
u23r4AyKPgHioZ6t7z6qrA: folds
j3hj7KQwBVU5NTFmtYomSw: folds
0smcry9L0OOTCP+KzIS5SA: folds
cWwhvq/+r/w8nkhwrJoekQ: folds
O5ZesE/6mHyuWWbvkiH/Fg: calls $2
*** FLOP *** [Td Ks Ah]
u23r4AyKPgHioZ6t7z6qrA said, "straight"
O5ZesE/6mHyuWWbvkiH/Fg: checks
O5ZesE/6mHyuWWbvkiH/Fg said, "wow"
j7NIOHLZk7V2o9fOioO5ug: bets $5
O5ZesE/6mHyuWWbvkiH/Fg: folds
j7NIOHLZk7V2o9fOioO5ug collected $6.20 from pot
j7NIOHLZk7V2o9fOioO5ug: doesn't show hand
*** SUMMARY ***
Total pot $6.50 | Rake $0.30
Board [Td Ks Ah]
Seat 1: j3hj7KQwBVU5NTFmtYomSw folded before Flop (didn't bet)
Seat 2: 0smcry9L0OOTCP+KzIS5SA (button) folded before Flop (didn't bet)
Seat 3: cWwhvq/+r/w8nkhwrJoekQ (small blind) folded before Flop
Seat 4: O5ZesE/6mHyuWWbvkiH/Fg (big blind) folded on the Flop
Seat 5: j7NIOHLZk7V2o9fOioO5ug collected ($6.20)
Seat 6: u23r4AyKPgHioZ6t7z6qrA folded before Flop (didn't bet)



PokerStars Game #59941540992:  Hold'em No Limit ($0.50/$1.00) - 2009/07/01 1:38:35 ET
Table 'b8oW/dOL7fDza5DfZ/dOJQ' 6-max Seat #1 is the button
Seat 1: NakujTNjHFgzceydFf+E2Q ($57.50 in chips)
Seat 2: TSuRyAHnUPCFjP7Z0rEE0w ($118 in chips)
Seat 3: d8WX+9nUHoqlrAGagO0Wow ($34.30 in chips)
Seat 4: 8rDbzImSi1zgxtqtF1pSbA ($20 in chips)
Seat 5: r4lpoh2BJZ8S6zyQv1JeSw ($101.50 in chips)
Seat 6: PvfYaKbzMpsmUcbOExckbQ ($148.10 in chips)
TSuRyAHnUPCFjP7Z0rEE0w: posts small blind $0.50
d8WX+9nUHoqlrAGagO0Wow: posts big blind $1
*** HOLE CARDS ***
8rDbzImSi1zgxtqtF1pSbA: raises $2 to $3
r4lpoh2BJZ8S6zyQv1JeSw: folds
PvfYaKbzMpsmUcbOExckbQ: calls $3
NakujTNjHFgzceydFf+E2Q: folds
TSuRyAHnUPCFjP7Z0rEE0w: folds
d8WX+9nUHoqlrAGagO0Wow: folds
*** FLOP *** [4c 5c 3c]
8rDbzImSi1zgxtqtF1pSbA: bets $3
PvfYaKbzMpsmUcbOExckbQ: raises $17 to $20
8rDbzImSi1zgxtqtF1pSbA: folds
PvfYaKbzMpsmUcbOExckbQ collected $12.85 from pot
PvfYaKbzMpsmUcbOExckbQ: doesn't show hand
*** SUMMARY ***
Total pot $13.50 | Rake $0.65
Board [4c 5c 3c]
Seat 1: NakujTNjHFgzceydFf+E2Q (button) folded before Flop (didn't bet)
Seat 2: TSuRyAHnUPCFjP7Z0rEE0w (small blind) folded before Flop
Seat 3: d8WX+9nUHoqlrAGagO0Wow (big blind) folded before Flop
Seat 4: 8rDbzImSi1zgxtqtF1pSbA folded on the Flop
Seat 5: r4lpoh2BJZ8S6zyQv1JeSw folded before Flop (didn't bet)
Seat 6: PvfYaKbzMpsmUcbOExckbQ collected ($12.85)



PokerStars Game #59941542030:  Hold'em No Limit ($0.50/$1.00) - 2009/07/01 1:38:36 ET
Table 'mmbQQVBTrPdE+wy+s+9VPA' 6-max Seat #5 is the button
Seat 1: zyP4SPoWZnKUfTvIRLCVog ($80.25 in chips)
Seat 2: XK4Qsl+DA8gAJyg85/zBIw ($17.60 in chips)
Seat 3: wx3sQGkVi2x9wJXuWNHPBw ($239.10 in chips)
Seat 4: V3iZdcw61nXF3g5hD2RrsQ ($100.05 in chips)
Seat 5: YMJG+F++3Aj6P8dAWda5fw ($133.70 in chips)
Seat 6: UOHYuj23MyK9R8ciY2t6FA ($100 in chips)
UOHYuj23MyK9R8ciY2t6FA: posts small blind $0.50
zyP4SPoWZnKUfTvIRLCVog: posts big blind $1
*** HOLE CARDS ***
XK4Qsl+DA8gAJyg85/zBIw: raises $2 to $3
wx3sQGkVi2x9wJXuWNHPBw: calls $3
V3iZdcw61nXF3g5hD2RrsQ: folds
YMJG+F++3Aj6P8dAWda5fw: calls $3
UOHYuj23MyK9R8ciY2t6FA: folds
zyP4SPoWZnKUfTvIRLCVog: calls $2
*** FLOP *** [5s Ah 4d]
zyP4SPoWZnKUfTvIRLCVog: checks
XK4Qsl+DA8gAJyg85/zBIw: checks
wx3sQGkVi2x9wJXuWNHPBw: checks
YMJG+F++3Aj6P8dAWda5fw: checks
*** TURN *** [5s Ah 4d] [9d]
zyP4SPoWZnKUfTvIRLCVog: checks
XK4Qsl+DA8gAJyg85/zBIw: bets $4
wx3sQGkVi2x9wJXuWNHPBw: folds
YMJG+F++3Aj6P8dAWda5fw: folds
zyP4SPoWZnKUfTvIRLCVog: folds
XK4Qsl+DA8gAJyg85/zBIw collected $11.90 from pot
*** SUMMARY ***
Total pot $12.50 | Rake $0.60
Board [5s Ah 4d 9d]
Seat 1: zyP4SPoWZnKUfTvIRLCVog (big blind) folded on the Turn
Seat 2: XK4Qsl+DA8gAJyg85/zBIw collected ($11.90)
Seat 3: wx3sQGkVi2x9wJXuWNHPBw folded on the Turn
Seat 4: V3iZdcw61nXF3g5hD2RrsQ folded before Flop (didn't bet)
Seat 5: YMJG+F++3Aj6P8dAWda5fw (button) folded on the Turn
Seat 6: UOHYuj23MyK9R8ciY2t6FA (small blind) folded before Flop



PokerStars Game #59941542652:  Hold'em No Limit ($0.50/$1.00) - 2009/07/01 1:38:38 ET
Table 'qj0HBN4HhQKogreu1bg7xg' 2-max Seat #2 is the button
Seat 1: NYi6JFscYNrofSXy4sM+Yw ($110.60 in chips)
Seat 2: qtyl8CSb0/4yWdbuEPJejA ($167.80 in chips)
qtyl8CSb0/4yWdbuEPJejA: posts small blind $0.50
NYi6JFscYNrofSXy4sM+Yw: posts big blind $1
*** HOLE CARDS ***
qtyl8CSb0/4yWdbuEPJejA: folds
NYi6JFscYNrofSXy4sM+Yw collected $1 from pot
*** SUMMARY ***
Total pot $1 | Rake $0
Seat 1: NYi6JFscYNrofSXy4sM+Yw (big blind) collected ($1)
Seat 2: qtyl8CSb0/4yWdbuEPJejA (button) (small blind) folded before Flop



PokerStars Game #59941542710:  Hold'em No Limit ($0.50/$1.00) - 2009/07/01 1:38:38 ET
Table 'kS0cTQAEi+fdUlJP2gQYvw' 9-max Seat #6 is the button
Seat 1: SqsWPukL8kLqrhq5ZrQdSQ ($88 in chips)
Seat 2: +JautI/vSNALzwSvsOqbCQ ($78 in chips)
Seat 3: 2BV+oJIQYr65IO6nEChvbA ($62.55 in chips)
Seat 4: RUhhaALzha3TH1AkdakoGQ ($51 in chips)
Seat 5: 997ViqAtWn1FPjJqcffwcA ($100 in chips)
Seat 6: yAbu2QsRPVcjPbqlf/jDxw ($117.15 in chips)
Seat 7: Ffa7Nj4X5fddtROP01hfQg ($96.50 in chips)
Seat 8: vKyFzTyzfT7fZcdX+HHN+Q ($101.70 in chips)
Seat 9: OGgaARGdJQT4awWVNQ957w ($109.70 in chips)
Ffa7Nj4X5fddtROP01hfQg: posts small blind $0.50
vKyFzTyzfT7fZcdX+HHN+Q: posts big blind $1
*** HOLE CARDS ***
Ffa7Nj4X5fddtROP01hfQg said, "at least i CAN LOOK FORWARD TO GETTING IT BACK"
OGgaARGdJQT4awWVNQ957w: folds
SqsWPukL8kLqrhq5ZrQdSQ: folds
Ffa7Nj4X5fddtROP01hfQg said, "sorry for cps"
+JautI/vSNALzwSvsOqbCQ: folds
2BV+oJIQYr65IO6nEChvbA: folds
RUhhaALzha3TH1AkdakoGQ said, "yup..."
RUhhaALzha3TH1AkdakoGQ: calls $1
997ViqAtWn1FPjJqcffwcA: folds
vKyFzTyzfT7fZcdX+HHN+Q said, "just hea ta play man"
yAbu2QsRPVcjPbqlf/jDxw: folds
Ffa7Nj4X5fddtROP01hfQg: calls $0.50
vKyFzTyzfT7fZcdX+HHN+Q: checks
*** FLOP *** [Qh 3d 3c]
Ffa7Nj4X5fddtROP01hfQg said, "really"
Ffa7Nj4X5fddtROP01hfQg said, "dumb play"
Ffa7Nj4X5fddtROP01hfQg: checks
vKyFzTyzfT7fZcdX+HHN+Q: checks
RUhhaALzha3TH1AkdakoGQ: checks
*** TURN *** [Qh 3d 3c] [8h]
Ffa7Nj4X5fddtROP01hfQg said, "keep it up"
vKyFzTyzfT7fZcdX+HHN+Q said, "it worked on u"
Ffa7Nj4X5fddtROP01hfQg: checks
vKyFzTyzfT7fZcdX+HHN+Q: checks
RUhhaALzha3TH1AkdakoGQ: checks
*** RIVER *** [Qh 3d 3c 8h] [9h]
Ffa7Nj4X5fddtROP01hfQg: checks
vKyFzTyzfT7fZcdX+HHN+Q: checks
RUhhaALzha3TH1AkdakoGQ: checks
*** SHOW DOWN ***
Ffa7Nj4X5fddtROP01hfQg: shows [6h Kc] (a pair of Threes)
vKyFzTyzfT7fZcdX+HHN+Q: mucks hand
RUhhaALzha3TH1AkdakoGQ: shows [6s 6c] (two pair, Sixes and Threes)
RUhhaALzha3TH1AkdakoGQ collected $2.85 from pot
Ffa7Nj4X5fddtROP01hfQg said, "hAve you played poker before?"
*** SUMMARY ***
Total pot $3 | Rake $0.15
Board [Qh 3d 3c 8h 9h]
Seat 1: SqsWPukL8kLqrhq5ZrQdSQ folded before Flop (didn't bet)
Seat 2: +JautI/vSNALzwSvsOqbCQ folded before Flop (didn't bet)
Seat 3: 2BV+oJIQYr65IO6nEChvbA folded before Flop (didn't bet)
Seat 4: RUhhaALzha3TH1AkdakoGQ showed [6s 6c] and won ($2.85) with two pair, Sixes and Threes
Seat 5: 997ViqAtWn1FPjJqcffwcA folded before Flop (didn't bet)
Seat 6: yAbu2QsRPVcjPbqlf/jDxw (button) folded before Flop (didn't bet)
Seat 7: Ffa7Nj4X5fddtROP01hfQg (small blind) showed [6h Kc] and lost with a pair of Threes
Seat 8: vKyFzTyzfT7fZcdX+HHN+Q (big blind) mucked
Seat 9: OGgaARGdJQT4awWVNQ957w folded before Flop (didn't bet)



PokerStars Game #59941543334:  Hold'em No Limit ($0.50/$1.00) - 2009/07/01 1:38:39 ET
Table '+cA8mcmhaedZ7YcrDdhmeQ' 6-max Seat #6 is the button
Seat 2: 14aYclSc98EYd6TrzN2l3Q ($67.55 in chips)
Seat 3: DAIgyIWbYvAkL6PbAI27pg ($20 in chips)
Seat 4: 4OO5v3AVduL0tePNx8wk5A ($100 in chips)
Seat 6: YfsTQsY/fxb+YqbdclTHuw ($56.15 in chips)
VB7TtBnfmT3JTA/cCL6dJg will be allowed to play after the button
14aYclSc98EYd6TrzN2l3Q: posts small blind $0.50
DAIgyIWbYvAkL6PbAI27pg: posts big blind $1
SJieaES+gCAfonfNNMCP6w: sits out
*** HOLE CARDS ***
4OO5v3AVduL0tePNx8wk5A: raises $3 to $4
YfsTQsY/fxb+YqbdclTHuw: folds
14aYclSc98EYd6TrzN2l3Q: calls $3.50
DAIgyIWbYvAkL6PbAI27pg: folds
*** FLOP *** [Kh Qh Js]
14aYclSc98EYd6TrzN2l3Q: bets $4
4OO5v3AVduL0tePNx8wk5A: calls $4
*** TURN *** [Kh Qh Js] [9c]
14aYclSc98EYd6TrzN2l3Q: checks
4OO5v3AVduL0tePNx8wk5A: checks
*** RIVER *** [Kh Qh Js 9c] [4h]
14aYclSc98EYd6TrzN2l3Q: checks
4OO5v3AVduL0tePNx8wk5A: checks
*** SHOW DOWN ***
14aYclSc98EYd6TrzN2l3Q: shows [5c 5d] (a pair of Fives)
4OO5v3AVduL0tePNx8wk5A: shows [Qs Ah] (a pair of Queens)
4OO5v3AVduL0tePNx8wk5A collected $16.20 from pot
*** SUMMARY ***
Total pot $17 | Rake $0.80
Board [Kh Qh Js 9c 4h]
Seat 2: 14aYclSc98EYd6TrzN2l3Q (small blind) showed [5c 5d] and lost with a pair of Fives
Seat 3: DAIgyIWbYvAkL6PbAI27pg (big blind) folded before Flop
Seat 4: 4OO5v3AVduL0tePNx8wk5A showed [Qs Ah] and won ($16.20) with a pair of Queens
Seat 6: YfsTQsY/fxb+YqbdclTHuw (button) folded before Flop (didn't bet)



PokerStars Game #59941543410:  Hold'em No Limit ($0.50/$1.00) - 2009/07/01 1:38:39 ET
Table '7Nl0ffnjeK44/vmeexh3MQ' 9-max Seat #1 is the button
Seat 1: V138SURkdX8LdVBPKdJJag ($101.85 in chips)
Seat 2: OGgaARGdJQT4awWVNQ957w ($100.50 in chips)
Seat 3: JMmUYT5pIKCKh2pGjCB/4w ($58.40 in chips)
Seat 4: bLbSOSmSOnqE0iTcH/5dxA ($106.80 in chips)
Seat 5: 61sfw5QTu62YYIt68OsdrA ($77.55 in chips)
Seat 6: FVs16t7GgfWgQWt4JxsObQ ($32.25 in chips)
Seat 7: 997ViqAtWn1FPjJqcffwcA ($109.10 in chips)
Seat 8: HRJJZiSxFAehJGaET63dlA ($46.40 in chips)
Seat 9: /JHoNdt0fK6X+isrqRfV3w ($18.50 in chips)
OGgaARGdJQT4awWVNQ957w: posts small blind $0.50
JMmUYT5pIKCKh2pGjCB/4w: posts big blind $1
*** HOLE CARDS ***
bLbSOSmSOnqE0iTcH/5dxA: folds
61sfw5QTu62YYIt68OsdrA: folds
FVs16t7GgfWgQWt4JxsObQ: calls $1
997ViqAtWn1FPjJqcffwcA: raises $4 to $5
HRJJZiSxFAehJGaET63dlA: folds
/JHoNdt0fK6X+isrqRfV3w: raises $13.50 to $18.50 and is all-in
V138SURkdX8LdVBPKdJJag: calls $18.50
OGgaARGdJQT4awWVNQ957w: folds
JMmUYT5pIKCKh2pGjCB/4w: folds
FVs16t7GgfWgQWt4JxsObQ: folds
997ViqAtWn1FPjJqcffwcA: calls $13.50
*** FLOP *** [Kd 3d 2d]
997ViqAtWn1FPjJqcffwcA: bets $38
V138SURkdX8LdVBPKdJJag: folds
*** TURN *** [Kd 3d 2d] [7h]
*** RIVER *** [Kd 3d 2d 7h] [Jd]
*** SHOW DOWN ***
997ViqAtWn1FPjJqcffwcA: shows [Kh Kc] (three of a kind, Kings)
/JHoNdt0fK6X+isrqRfV3w: mucks hand
997ViqAtWn1FPjJqcffwcA collected $55.10 from pot
*** SUMMARY ***
Total pot $58 | Rake $2.90
Board [Kd 3d 2d 7h Jd]
Seat 1: V138SURkdX8LdVBPKdJJag (button) folded on the Flop
Seat 2: OGgaARGdJQT4awWVNQ957w (small blind) folded before Flop
Seat 3: JMmUYT5pIKCKh2pGjCB/4w (big blind) folded before Flop
Seat 4: bLbSOSmSOnqE0iTcH/5dxA folded before Flop (didn't bet)
Seat 5: 61sfw5QTu62YYIt68OsdrA folded before Flop (didn't bet)
Seat 6: FVs16t7GgfWgQWt4JxsObQ folded before Flop
Seat 7: 997ViqAtWn1FPjJqcffwcA showed [Kh Kc] and won ($55.10) with three of a kind, Kings
Seat 8: HRJJZiSxFAehJGaET63dlA folded before Flop (didn't bet)
Seat 9: /JHoNdt0fK6X+isrqRfV3w mucked



PokerStars Game #59941543452:  Hold'em No Limit ($0.50/$1.00) - 2009/07/01 1:38:39 ET
Table 'blHlQApStil0OPeQxQxPcw' 9-max Seat #4 is the button
Seat 1: Pp/KTcXkfZKKUHkjyaLTdg ($24.10 in chips)
Seat 2: V138SURkdX8LdVBPKdJJag ($122.85 in chips)
Seat 3: OGgaARGdJQT4awWVNQ957w ($100 in chips)
Seat 4: 1862487932 ($103.15 in chips)
Seat 5: uXrDE6JrIi8BZK1L8oQ9bQ ($46.60 in chips)
Seat 6: vljeiOoWscAIXU0fCuiEBw ($39.10 in chips)
Seat 8: laA8va+Yv8WuMqT1zdR91g ($100 in chips)
Seat 9: 6XkTu4ahxzHnvjjc1R8YjQ ($155.35 in chips)
uXrDE6JrIi8BZK1L8oQ9bQ: posts small blind $0.50
vljeiOoWscAIXU0fCuiEBw: posts big blind $1
VPF+HjszMvUIpy0CHIwH3A: sits out
*** HOLE CARDS ***
laA8va+Yv8WuMqT1zdR91g: folds
6XkTu4ahxzHnvjjc1R8YjQ: folds
Pp/KTcXkfZKKUHkjyaLTdg: folds
V138SURkdX8LdVBPKdJJag: folds
OGgaARGdJQT4awWVNQ957w: folds
1862487932: raises $1.50 to $2.50
uXrDE6JrIi8BZK1L8oQ9bQ: calls $2
vljeiOoWscAIXU0fCuiEBw: calls $1.50
*** FLOP *** [9d 5d Jc]
uXrDE6JrIi8BZK1L8oQ9bQ: bets $2
vljeiOoWscAIXU0fCuiEBw: raises $4 to $6
1862487932: folds
uXrDE6JrIi8BZK1L8oQ9bQ: calls $4
*** TURN *** [9d 5d Jc] [5c]
uXrDE6JrIi8BZK1L8oQ9bQ: checks
vljeiOoWscAIXU0fCuiEBw: checks
*** RIVER *** [9d 5d Jc 5c] [6d]
uXrDE6JrIi8BZK1L8oQ9bQ: checks
vljeiOoWscAIXU0fCuiEBw: bets $11
uXrDE6JrIi8BZK1L8oQ9bQ: folds
vljeiOoWscAIXU0fCuiEBw collected $18.55 from pot
*** SUMMARY ***
Total pot $19.50 | Rake $0.95
Board [9d 5d Jc 5c 6d]
Seat 1: Pp/KTcXkfZKKUHkjyaLTdg folded before Flop (didn't bet)
Seat 2: V138SURkdX8LdVBPKdJJag folded before Flop (didn't bet)
Seat 3: OGgaARGdJQT4awWVNQ957w folded before Flop (didn't bet)
Seat 4: 1862487932 (button) folded on the Flop
Seat 5: uXrDE6JrIi8BZK1L8oQ9bQ (small blind) folded on the River
Seat 6: vljeiOoWscAIXU0fCuiEBw (big blind) collected ($18.55)
Seat 8: laA8va+Yv8WuMqT1zdR91g folded before Flop (didn't bet)
Seat 9: 6XkTu4ahxzHnvjjc1R8YjQ folded before Flop (didn't bet)



PokerStars Game #59941544462:  Hold'em No Limit ($0.50/$1.00) - 2009/07/01 1:38:41 ET
Table 'N6LvHFrb+cdXY/COI6ByOw' 2-max Seat #2 is the button
Seat 1: lXX4W7m3u++JiSOZ46yVMQ ($101.20 in chips)
Seat 2: 9mAoSP3o/mikSZOW2LEEAw ($169.20 in chips)
9mAoSP3o/mikSZOW2LEEAw: posts small blind $0.50
lXX4W7m3u++JiSOZ46yVMQ: posts big blind $1
*** HOLE CARDS ***
9mAoSP3o/mikSZOW2LEEAw: raises $1 to $2
lXX4W7m3u++JiSOZ46yVMQ: calls $1
*** FLOP *** [7s 5c 9d]
lXX4W7m3u++JiSOZ46yVMQ: checks
9mAoSP3o/mikSZOW2LEEAw: bets $3
lXX4W7m3u++JiSOZ46yVMQ: calls $3
*** TURN *** [7s 5c 9d] [Qd]
9mAoSP3o/mikSZOW2LEEAw said, "gg gotta go"
lXX4W7m3u++JiSOZ46yVMQ: checks
9mAoSP3o/mikSZOW2LEEAw: checks
*** RIVER *** [7s 5c 9d Qd] [3s]
lXX4W7m3u++JiSOZ46yVMQ: bets $4
9mAoSP3o/mikSZOW2LEEAw: calls $4
*** SHOW DOWN ***
lXX4W7m3u++JiSOZ46yVMQ: shows [Tc 6c] (high card Queen)
9mAoSP3o/mikSZOW2LEEAw: shows [Kc 9s] (a pair of Nines)
9mAoSP3o/mikSZOW2LEEAw collected $17.50 from pot
9mAoSP3o/mikSZOW2LEEAw is sitting out
*** SUMMARY ***
Total pot $18 | Rake $0.50
Board [7s 5c 9d Qd 3s]
Seat 1: lXX4W7m3u++JiSOZ46yVMQ (big blind) showed [Tc 6c] and lost with high card Queen
Seat 2: 9mAoSP3o/mikSZOW2LEEAw (button) (small blind) showed [Kc 9s] and won ($17.50) with a pair of Nines



PokerStars Game #59941545882:  Hold'em No Limit ($0.50/$1.00) - 2009/07/01 1:38:43 ET
Table 'QSIig7BLMc9wY/rgBechzw' 6-max Seat #4 is the button
Seat 1: Z2fXsGcjl+Eax+RzOgwOmg ($111.55 in chips)
Seat 2: mLOIkH/qmRa+mVujQIhBRg ($27.35 in chips)
Seat 3: 4OO5v3AVduL0tePNx8wk5A ($103 in chips)
Seat 4: +uSzP8Jwnw7sKfQ4s66b7w ($57.80 in chips)
Seat 5: lsLuWlcPA3Rh7kJVLzMh0Q ($100 in chips)
Seat 6: Wj7mKnRFR90j40wWUu2+Og ($60 in chips)
lsLuWlcPA3Rh7kJVLzMh0Q: posts small blind $0.50
Wj7mKnRFR90j40wWUu2+Og: posts big blind $1
*** HOLE CARDS ***
Z2fXsGcjl+Eax+RzOgwOmg: folds
mLOIkH/qmRa+mVujQIhBRg: calls $1
4OO5v3AVduL0tePNx8wk5A: folds
+uSzP8Jwnw7sKfQ4s66b7w: folds
lsLuWlcPA3Rh7kJVLzMh0Q: folds
Wj7mKnRFR90j40wWUu2+Og: checks
*** FLOP *** [6s 2c Ks]
Wj7mKnRFR90j40wWUu2+Og: checks
mLOIkH/qmRa+mVujQIhBRg: bets $1
Wj7mKnRFR90j40wWUu2+Og: folds
mLOIkH/qmRa+mVujQIhBRg collected $2.40 from pot
*** SUMMARY ***
Total pot $2.50 | Rake $0.10
Board [6s 2c Ks]
Seat 1: Z2fXsGcjl+Eax+RzOgwOmg folded before Flop (didn't bet)
Seat 2: mLOIkH/qmRa+mVujQIhBRg collected ($2.40)
Seat 3: 4OO5v3AVduL0tePNx8wk5A folded before Flop (didn't bet)
Seat 4: +uSzP8Jwnw7sKfQ4s66b7w (button) folded before Flop (didn't bet)
Seat 5: lsLuWlcPA3Rh7kJVLzMh0Q (small blind) folded before Flop
Seat 6: Wj7mKnRFR90j40wWUu2+Og (big blind) folded on the Flop



PokerStars Game #59941545924:  Hold'em No Limit ($0.50/$1.00) - 2009/07/01 1:38:44 ET
Table 'qj0HBN4HhQKogreu1bg7xg' 2-max Seat #1 is the button
Seat 1: NYi6JFscYNrofSXy4sM+Yw ($111.10 in chips)
Seat 2: qtyl8CSb0/4yWdbuEPJejA ($167.30 in chips)
NYi6JFscYNrofSXy4sM+Yw: posts small blind $0.50
qtyl8CSb0/4yWdbuEPJejA: posts big blind $1
*** HOLE CARDS ***
NYi6JFscYNrofSXy4sM+Yw: raises $2 to $3
qtyl8CSb0/4yWdbuEPJejA: folds
NYi6JFscYNrofSXy4sM+Yw collected $2 from pot
*** SUMMARY ***
Total pot $2 | Rake $0
Seat 1: NYi6JFscYNrofSXy4sM+Yw (button) (small blind) collected ($2)
Seat 2: qtyl8CSb0/4yWdbuEPJejA (big blind) folded before Flop



PokerStars Game #59941549468:  Hold'em No Limit ($0.50/$1.00) - 2009/07/01 1:38:50 ET
Table 'qj0HBN4HhQKogreu1bg7xg' 2-max Seat #2 is the button
Seat 1: NYi6JFscYNrofSXy4sM+Yw ($112.10 in chips)
Seat 2: qtyl8CSb0/4yWdbuEPJejA ($166.30 in chips)
qtyl8CSb0/4yWdbuEPJejA: posts small blind $0.50
NYi6JFscYNrofSXy4sM+Yw: posts big blind $1
*** HOLE CARDS ***
qtyl8CSb0/4yWdbuEPJejA: raises $2 to $3
NYi6JFscYNrofSXy4sM+Yw: folds
qtyl8CSb0/4yWdbuEPJejA collected $2 from pot
qtyl8CSb0/4yWdbuEPJejA: doesn't show hand
*** SUMMARY ***
Total pot $2 | Rake $0
Seat 1: NYi6JFscYNrofSXy4sM+Yw (big blind) folded before Flop
Seat 2: qtyl8CSb0/4yWdbuEPJejA (button) (small blind) collected ($2)



PokerStars Game #59941552398:  Hold'em No Limit ($0.50/$1.00) - 2009/07/01 1:38:55 ET
Table 'fTlPiCj0utgzC/5io+I7ew' 6-max Seat #3 is the button
Seat 1: YMJG+F++3Aj6P8dAWda5fw ($100 in chips)
Seat 2: qVr1nl3dy2xXPqS8UpTDlA ($35.25 in chips)
Seat 3: Z2fXsGcjl+Eax+RzOgwOmg ($136.50 in chips)
Seat 4: uJVSceLggtsrJya+WtmUEA ($165.35 in chips)
Seat 5: XUk5GQsfNFpHvaToDZ0rZA ($44.05 in chips)
Seat 6: y27w5IK2WXqmYzS8OU0wKA ($100 in chips)
uJVSceLggtsrJya+WtmUEA: posts small blind $0.50
XUk5GQsfNFpHvaToDZ0rZA: posts big blind $1
*** HOLE CARDS ***
y27w5IK2WXqmYzS8OU0wKA: folds
YMJG+F++3Aj6P8dAWda5fw: folds
qVr1nl3dy2xXPqS8UpTDlA: folds
Z2fXsGcjl+Eax+RzOgwOmg: folds
uJVSceLggtsrJya+WtmUEA has timed out
uJVSceLggtsrJya+WtmUEA: folds
uJVSceLggtsrJya+WtmUEA is sitting out
uJVSceLggtsrJya+WtmUEA has returned
XUk5GQsfNFpHvaToDZ0rZA collected $1 from pot
*** SUMMARY ***
Total pot $1 | Rake $0
Seat 1: YMJG+F++3Aj6P8dAWda5fw folded before Flop (didn't bet)
Seat 2: qVr1nl3dy2xXPqS8UpTDlA folded before Flop (didn't bet)
Seat 3: Z2fXsGcjl+Eax+RzOgwOmg (button) folded before Flop (didn't bet)
Seat 4: uJVSceLggtsrJya+WtmUEA (small blind) folded before Flop
Seat 5: XUk5GQsfNFpHvaToDZ0rZA (big blind) collected ($1)
Seat 6: y27w5IK2WXqmYzS8OU0wKA folded before Flop (didn't bet)



PokerStars Game #59941552732:  Hold'em No Limit ($0.50/$1.00) - 2009/07/01 1:38:56 ET
Table 'MUPc8FEpe/nR0BKSeReX6Q' 6-max Seat #6 is the button
Seat 1: qhkK6+yCciTRd+rCFEbnEQ ($57.70 in chips)
Seat 2: xAU6q2/cwmby2sxmA8VcmA ($103.70 in chips)
Seat 3: wx3sQGkVi2x9wJXuWNHPBw ($287.65 in chips)
Seat 4: r4lpoh2BJZ8S6zyQv1JeSw ($108.50 in chips)
Seat 5: y27w5IK2WXqmYzS8OU0wKA ($131.05 in chips)
Seat 6: cl/QpVR/PLO58lj+C5mGLw ($22.70 in chips)
qhkK6+yCciTRd+rCFEbnEQ: posts small blind $0.50
xAU6q2/cwmby2sxmA8VcmA: posts big blind $1
*** HOLE CARDS ***
wx3sQGkVi2x9wJXuWNHPBw: folds
r4lpoh2BJZ8S6zyQv1JeSw: folds
y27w5IK2WXqmYzS8OU0wKA: folds
cl/QpVR/PLO58lj+C5mGLw: raises $3 to $4
qhkK6+yCciTRd+rCFEbnEQ: raises $4 to $8
xAU6q2/cwmby2sxmA8VcmA: folds
cl/QpVR/PLO58lj+C5mGLw: raises $14.70 to $22.70 and is all-in
qhkK6+yCciTRd+rCFEbnEQ: calls $14.70
*** FLOP *** [6s 4d 2c]
*** TURN *** [6s 4d 2c] [7h]
*** RIVER *** [6s 4d 2c 7h] [3s]
*** SHOW DOWN ***
qhkK6+yCciTRd+rCFEbnEQ: shows [Ad 9h] (high card Ace)
cl/QpVR/PLO58lj+C5mGLw: mucks hand
qhkK6+yCciTRd+rCFEbnEQ collected $44.10 from pot
*** SUMMARY ***
Total pot $46.40 | Rake $2.30
Board [6s 4d 2c 7h 3s]
Seat 1: qhkK6+yCciTRd+rCFEbnEQ (small blind) showed [Ad 9h] and won ($44.10) with high card Ace
Seat 2: xAU6q2/cwmby2sxmA8VcmA (big blind) folded before Flop
Seat 3: wx3sQGkVi2x9wJXuWNHPBw folded before Flop (didn't bet)
Seat 4: r4lpoh2BJZ8S6zyQv1JeSw folded before Flop (didn't bet)
Seat 5: y27w5IK2WXqmYzS8OU0wKA folded before Flop (didn't bet)
Seat 6: cl/QpVR/PLO58lj+C5mGLw (button) mucked



PokerStars Game #59941552684:  Hold'em No Limit ($0.50/$1.00) - 2009/07/01 1:38:56 ET
Table 'CASNP0uy1C+jGLml/I4PtA' 9-max Seat #2 is the button
Seat 1: tkdBeXTJlFsZdioidNqLow ($70.60 in chips)
Seat 2: Ogn4JDV3mp4ZDKO49IFzKA ($23.85 in chips)
Seat 4: B/G0GJacqZ8K59/ZVdq4kQ ($21.05 in chips)
Seat 5: Jjc7EHWzs4//xUAjJ0UWoA ($11 in chips)
Seat 6: FJEywSpo5JbRKByzmweboA ($130.40 in chips)
Seat 7: S3Ex8K7v6xm5jqjRM7Fl3w ($20.50 in chips)
Seat 8: L9njYvloJ1NdXjP8edHEAg ($102.95 in chips)
Seat 9: Pp/KTcXkfZKKUHkjyaLTdg ($22.60 in chips)
B/G0GJacqZ8K59/ZVdq4kQ: posts small blind $0.50
Jjc7EHWzs4//xUAjJ0UWoA: posts big blind $1
*** HOLE CARDS ***
FJEywSpo5JbRKByzmweboA: folds
S3Ex8K7v6xm5jqjRM7Fl3w: raises $2 to $3
L9njYvloJ1NdXjP8edHEAg: folds
Pp/KTcXkfZKKUHkjyaLTdg: folds
tkdBeXTJlFsZdioidNqLow: folds
Ogn4JDV3mp4ZDKO49IFzKA: folds
B/G0GJacqZ8K59/ZVdq4kQ: calls $2.50
Jjc7EHWzs4//xUAjJ0UWoA: folds
*** FLOP *** [8c 9c Ks]
B/G0GJacqZ8K59/ZVdq4kQ: bets $18.05 and is all-in
S3Ex8K7v6xm5jqjRM7Fl3w: calls $17.50 and is all-in
*** TURN *** [8c 9c Ks] [5s]
*** RIVER *** [8c 9c Ks 5s] [9h]
*** SHOW DOWN ***
B/G0GJacqZ8K59/ZVdq4kQ: shows [Kd 8d] (two pair, Kings and Nines)
S3Ex8K7v6xm5jqjRM7Fl3w: shows [Ad Kh] (two pair, Kings and Nines - Ace kicker)
S3Ex8K7v6xm5jqjRM7Fl3w collected $39.95 from pot
*** SUMMARY ***
Total pot $42 | Rake $2.05
Board [8c 9c Ks 5s 9h]
Seat 1: tkdBeXTJlFsZdioidNqLow folded before Flop (didn't bet)
Seat 2: Ogn4JDV3mp4ZDKO49IFzKA (button) folded before Flop (didn't bet)
Seat 4: B/G0GJacqZ8K59/ZVdq4kQ (small blind) showed [Kd 8d] and lost with two pair, Kings and Nines
Seat 5: Jjc7EHWzs4//xUAjJ0UWoA (big blind) folded before Flop
Seat 6: FJEywSpo5JbRKByzmweboA folded before Flop (didn't bet)
Seat 7: S3Ex8K7v6xm5jqjRM7Fl3w showed [Ad Kh] and won ($39.95) with two pair, Kings and Nines
Seat 8: L9njYvloJ1NdXjP8edHEAg folded before Flop (didn't bet)
Seat 9: Pp/KTcXkfZKKUHkjyaLTdg folded before Flop (didn't bet)



PokerStars Game #59941553720:  Hold'em No Limit ($0.50/$1.00) - 2009/07/01 1:38:58 ET
Table 'qj0HBN4HhQKogreu1bg7xg' 2-max Seat #1 is the button
Seat 1: NYi6JFscYNrofSXy4sM+Yw ($111.10 in chips)
Seat 2: qtyl8CSb0/4yWdbuEPJejA ($167.30 in chips)
NYi6JFscYNrofSXy4sM+Yw: posts small blind $0.50
qtyl8CSb0/4yWdbuEPJejA: posts big blind $1
*** HOLE CARDS ***
NYi6JFscYNrofSXy4sM+Yw: folds
qtyl8CSb0/4yWdbuEPJejA collected $1 from pot
qtyl8CSb0/4yWdbuEPJejA: doesn't show hand
*** SUMMARY ***
Total pot $1 | Rake $0
Seat 1: NYi6JFscYNrofSXy4sM+Yw (button) (small blind) folded before Flop
Seat 2: qtyl8CSb0/4yWdbuEPJejA (big blind) collected ($1)



PokerStars Game #59941554918:  Hold'em No Limit ($0.50/$1.00) - 2009/07/01 1:39:00 ET
Table '3T4owEKJKyGTMePwrv50FQ' 9-max Seat #3 is the button
Seat 1: OGgaARGdJQT4awWVNQ957w ($100 in chips)
Seat 2: t+Id2O6herCLgwnC4m49PA ($37.05 in chips)
Seat 3: DOLzOcBTZYcph5jEfKFWuQ ($100 in chips)
Seat 4: O5Go3jrzbQWxRB6ESK+Ptg ($66.60 in chips)
Seat 5: mMc/PBpqlN24gdi3C/1tOw ($41.40 in chips)
Seat 6: V138SURkdX8LdVBPKdJJag ($108.25 in chips)
Seat 7: 1862487932 ($105.50 in chips)
Seat 8: bLbSOSmSOnqE0iTcH/5dxA ($198.50 in chips)
Seat 9: 61sfw5QTu62YYIt68OsdrA ($88.75 in chips)
O5Go3jrzbQWxRB6ESK+Ptg: posts small blind $0.50
mMc/PBpqlN24gdi3C/1tOw: posts big blind $1
*** HOLE CARDS ***
V138SURkdX8LdVBPKdJJag: folds
1862487932: folds
bLbSOSmSOnqE0iTcH/5dxA: folds
61sfw5QTu62YYIt68OsdrA: folds
OGgaARGdJQT4awWVNQ957w: folds
t+Id2O6herCLgwnC4m49PA: calls $1
DOLzOcBTZYcph5jEfKFWuQ: raises $4.50 to $5.50
O5Go3jrzbQWxRB6ESK+Ptg: folds
mMc/PBpqlN24gdi3C/1tOw: folds
t+Id2O6herCLgwnC4m49PA: calls $4.50
*** FLOP *** [2s Td Ts]
t+Id2O6herCLgwnC4m49PA: checks
DOLzOcBTZYcph5jEfKFWuQ: bets $6.85
t+Id2O6herCLgwnC4m49PA: folds
DOLzOcBTZYcph5jEfKFWuQ collected $11.90 from pot
*** SUMMARY ***
Total pot $12.50 | Rake $0.60
Board [2s Td Ts]
Seat 1: OGgaARGdJQT4awWVNQ957w folded before Flop (didn't bet)
Seat 2: t+Id2O6herCLgwnC4m49PA folded on the Flop
Seat 3: DOLzOcBTZYcph5jEfKFWuQ (button) collected ($11.90)
Seat 4: O5Go3jrzbQWxRB6ESK+Ptg (small blind) folded before Flop
Seat 5: mMc/PBpqlN24gdi3C/1tOw (big blind) folded before Flop
Seat 6: V138SURkdX8LdVBPKdJJag folded before Flop (didn't bet)
Seat 7: 1862487932 folded before Flop (didn't bet)
Seat 8: bLbSOSmSOnqE0iTcH/5dxA folded before Flop (didn't bet)
Seat 9: 61sfw5QTu62YYIt68OsdrA folded before Flop (didn't bet)



PokerStars Game #59941554844:  Hold'em No Limit ($0.50/$1.00) - 2009/07/01 1:39:00 ET
Table 'O96CPOtvMBWP6kzuYDfdFA' 6-max Seat #6 is the button
Seat 1: 6alLXQIITA2EZ/lBeym8Dw ($127.25 in chips)
Seat 2: 4d1rWhpu8DzLmzMbR3QKyA ($101.50 in chips)
Seat 4: /P4w1pHg2zHYg/4ubJ0dPw ($72.45 in chips)
Seat 5: vX+iYAEINFeLxwMla7DY1Q ($98.50 in chips)
Seat 6: 3syOXva630dm1FTdwnuLpw ($73.15 in chips)
6alLXQIITA2EZ/lBeym8Dw: posts small blind $0.50
4d1rWhpu8DzLmzMbR3QKyA: posts big blind $1
*** HOLE CARDS ***
/P4w1pHg2zHYg/4ubJ0dPw: raises $2.50 to $3.50
vX+iYAEINFeLxwMla7DY1Q: folds
3syOXva630dm1FTdwnuLpw: folds
6alLXQIITA2EZ/lBeym8Dw: folds
4d1rWhpu8DzLmzMbR3QKyA: folds
/P4w1pHg2zHYg/4ubJ0dPw collected $2.50 from pot
*** SUMMARY ***
Total pot $2.50 | Rake $0
Seat 1: 6alLXQIITA2EZ/lBeym8Dw (small blind) folded before Flop
Seat 2: 4d1rWhpu8DzLmzMbR3QKyA (big blind) folded before Flop
Seat 4: /P4w1pHg2zHYg/4ubJ0dPw collected ($2.50)
Seat 5: vX+iYAEINFeLxwMla7DY1Q folded before Flop (didn't bet)
Seat 6: 3syOXva630dm1FTdwnuLpw (button) folded before Flop (didn't bet)



PokerStars Game #59941555966:  Hold'em No Limit ($0.50/$1.00) - 2009/07/01 1:39:02 ET
Table 'DE4ps3MTl+4avTytwFENAg' 6-max Seat #5 is the button
Seat 1: PvfYaKbzMpsmUcbOExckbQ ($103 in chips)
Seat 2: QHvTZcrKe6+maWUfVjP29Q ($106.40 in chips)
Seat 3: cGayYjcyk6+jN57tzIY4TA ($252.60 in chips)
Seat 4: iexehpxaQwzColGqeTEnLQ ($121.85 in chips)
Seat 5: UBZQqpnJZdTYYY1FTb0rLA ($174.90 in chips)
Seat 6: lsLuWlcPA3Rh7kJVLzMh0Q ($100 in chips)
lsLuWlcPA3Rh7kJVLzMh0Q: posts small blind $0.50
PvfYaKbzMpsmUcbOExckbQ: posts big blind $1
*** HOLE CARDS ***
QHvTZcrKe6+maWUfVjP29Q: raises $2.50 to $3.50
cGayYjcyk6+jN57tzIY4TA: calls $3.50
iexehpxaQwzColGqeTEnLQ: folds
UBZQqpnJZdTYYY1FTb0rLA: folds
lsLuWlcPA3Rh7kJVLzMh0Q: folds
PvfYaKbzMpsmUcbOExckbQ: folds
*** FLOP *** [Qc 2h 2c]
QHvTZcrKe6+maWUfVjP29Q: bets $7
cGayYjcyk6+jN57tzIY4TA: calls $7
*** TURN *** [Qc 2h 2c] [8c]
QHvTZcrKe6+maWUfVjP29Q: bets $16
cGayYjcyk6+jN57tzIY4TA: raises $16 to $32
QHvTZcrKe6+maWUfVjP29Q: calls $16
*** RIVER *** [Qc 2h 2c 8c] [As]
QHvTZcrKe6+maWUfVjP29Q: checks
cGayYjcyk6+jN57tzIY4TA: bets $10
QHvTZcrKe6+maWUfVjP29Q: calls $10
*** SHOW DOWN ***
cGayYjcyk6+jN57tzIY4TA: shows [2s Js] (three of a kind, Deuces)
QHvTZcrKe6+maWUfVjP29Q: mucks hand
cGayYjcyk6+jN57tzIY4TA collected $103.50 from pot
*** SUMMARY ***
Total pot $106.50 | Rake $3
Board [Qc 2h 2c 8c As]
Seat 1: PvfYaKbzMpsmUcbOExckbQ (big blind) folded before Flop
Seat 2: QHvTZcrKe6+maWUfVjP29Q mucked
Seat 3: cGayYjcyk6+jN57tzIY4TA showed [2s Js] and won ($103.50) with three of a kind, Deuces
Seat 4: iexehpxaQwzColGqeTEnLQ folded before Flop (didn't bet)
Seat 5: UBZQqpnJZdTYYY1FTb0rLA (button) folded before Flop (didn't bet)
Seat 6: lsLuWlcPA3Rh7kJVLzMh0Q (small blind) folded before Flop



PokerStars Game #59941556892:  Hold'em No Limit ($0.50/$1.00) - 2009/07/01 1:39:03 ET
Table 'qj0HBN4HhQKogreu1bg7xg' 2-max Seat #2 is the button
Seat 1: NYi6JFscYNrofSXy4sM+Yw ($110.60 in chips)
Seat 2: qtyl8CSb0/4yWdbuEPJejA ($167.80 in chips)
qtyl8CSb0/4yWdbuEPJejA: posts small blind $0.50
NYi6JFscYNrofSXy4sM+Yw: posts big blind $1
*** HOLE CARDS ***
qtyl8CSb0/4yWdbuEPJejA: raises $2 to $3
NYi6JFscYNrofSXy4sM+Yw: raises $6 to $9
qtyl8CSb0/4yWdbuEPJejA: folds
NYi6JFscYNrofSXy4sM+Yw collected $6 from pot
*** SUMMARY ***
Total pot $6 | Rake $0
Seat 1: NYi6JFscYNrofSXy4sM+Yw (big blind) collected ($6)
Seat 2: qtyl8CSb0/4yWdbuEPJejA (button) (small blind) folded before Flop



PokerStars Game #59941556872:  Hold'em No Limit ($0.50/$1.00) - 2009/07/01 1:39:03 ET
Table 'vs/5jr6ciwjVQ5+Soc+u2A' 6-max Seat #2 is the button
Seat 1: J798qwLuvXyq0BbzsIjOrA ($193.65 in chips)
Seat 2: lXX4W7m3u++JiSOZ46yVMQ ($95 in chips)
Seat 4: 0smcry9L0OOTCP+KzIS5SA ($84 in chips)
Seat 5: +Nt3OPk3XR9SKjZgm2CexQ ($159.35 in chips)
Seat 6: Z2fXsGcjl+Eax+RzOgwOmg ($125.50 in chips)
Ws/3Uo3rQIk8hLgW0P+2xA will be allowed to play after the button
0smcry9L0OOTCP+KzIS5SA: posts small blind $0.50
+Nt3OPk3XR9SKjZgm2CexQ: posts big blind $1
*** HOLE CARDS ***
Z2fXsGcjl+Eax+RzOgwOmg: folds
J798qwLuvXyq0BbzsIjOrA: folds
lXX4W7m3u++JiSOZ46yVMQ: raises $2 to $3
0smcry9L0OOTCP+KzIS5SA: raises $8 to $11
+Nt3OPk3XR9SKjZgm2CexQ: folds
lXX4W7m3u++JiSOZ46yVMQ: folds
0smcry9L0OOTCP+KzIS5SA collected $7 from pot
0smcry9L0OOTCP+KzIS5SA: doesn't show hand
*** SUMMARY ***
Total pot $7 | Rake $0
Seat 1: J798qwLuvXyq0BbzsIjOrA folded before Flop (didn't bet)
Seat 2: lXX4W7m3u++JiSOZ46yVMQ (button) folded before Flop
Seat 4: 0smcry9L0OOTCP+KzIS5SA (small blind) collected ($7)
Seat 5: +Nt3OPk3XR9SKjZgm2CexQ (big blind) folded before Flop
Seat 6: Z2fXsGcjl+Eax+RzOgwOmg folded before Flop (didn't bet)



PokerStars Game #59941557458:  Hold'em No Limit ($0.50/$1.00) - 2009/07/01 1:39:04 ET
Table 'NqGO/cV3MwFAx+ZPB5ANmQ' 2-max Seat #2 is the button
Seat 1: ItaRAnHOgvYOv5ynbG1iTw ($250.70 in chips)
Seat 2: GtFB+yyeb2djMdPFuOW/Xg ($100 in chips)
GtFB+yyeb2djMdPFuOW/Xg: posts small blind $0.50
ItaRAnHOgvYOv5ynbG1iTw: posts big blind $1
*** HOLE CARDS ***
GtFB+yyeb2djMdPFuOW/Xg: folds
ItaRAnHOgvYOv5ynbG1iTw collected $1 from pot
*** SUMMARY ***
Total pot $1 | Rake $0
Seat 1: ItaRAnHOgvYOv5ynbG1iTw (big blind) collected ($1)
Seat 2: GtFB+yyeb2djMdPFuOW/Xg (button) (small blind) folded before Flop



PokerStars Game #59941556954:  Hold'em No Limit ($0.50/$1.00) - 2009/07/01 1:39:04 ET
Table 'VOs36P6NW+QyXeQ1B62kmAE9S5sEoK9Q3olj2a53gABASeat #3 is the button
Seat 1: 4h8XtuVJtWh3DJpxGo7k5Q ($26.80 in chips)
Seat 2: y27w5IK2WXqmYzS8OU0wKA ($147.15 in chips)
Seat 3: p00KmyZiD/isPc/lZwNBTg ($15 in chips)
Seat 4: ene3nLSnQ4N961iBaUsSmA ($100 in chips)
Seat 5: o3YLm/rSY916m/on1VjXPA ($136.10 in chips)
Seat 6: slVKuQyEz8Qj4E3uLPYNXg ($45.95 in chips)
ene3nLSnQ4N961iBaUsSmA: posts small blind $0.50
o3YLm/rSY916m/on1VjXPA: posts big blind $1
*** HOLE CARDS ***
slVKuQyEz8Qj4E3uLPYNXg: raises $2 to $3
4h8XtuVJtWh3DJpxGo7k5Q: calls $3
y27w5IK2WXqmYzS8OU0wKA: folds
p00KmyZiD/isPc/lZwNBTg: folds
ene3nLSnQ4N961iBaUsSmA: folds
o3YLm/rSY916m/on1VjXPA: folds
*** FLOP *** [Kd Tc 7c]
slVKuQyEz8Qj4E3uLPYNXg: checks
4h8XtuVJtWh3DJpxGo7k5Q: checks
*** TURN *** [Kd Tc 7c] [5h]
slVKuQyEz8Qj4E3uLPYNXg: bets $4
4h8XtuVJtWh3DJpxGo7k5Q: folds
slVKuQyEz8Qj4E3uLPYNXg collected $7.15 from pot
*** SUMMARY ***
Total pot $7.50 | Rake $0.35
Board [Kd Tc 7c 5h]
Seat 1: 4h8XtuVJtWh3DJpxGo7k5Q folded on the Turn
Seat 2: y27w5IK2WXqmYzS8OU0wKA folded before Flop (didn't bet)
Seat 3: p00KmyZiD/isPc/lZwNBTg (button) folded before Flop (didn't bet)
Seat 4: ene3nLSnQ4N961iBaUsSmA (small blind) folded before Flop
Seat 5: o3YLm/rSY916m/on1VjXPA (big blind) folded before Flop
Seat 6: slVKuQyEz8Qj4E3uLPYNXg collected ($7.15)



PokerStars Game #59941558174:  Hold'em No Limit ($0.50/$1.00) - 2009/07/01 1:39:06 ET
Table 'W/wyObTiXZm+Ckkl3YxcSw' 6-max Seat #2 is the button
Seat 1: eUBBn2R56C1IQ6Cs/vitwg ($175.55 in chips)
Seat 2: oDiBRCaF0QVtd3kO6xZIXw ($122.80 in chips)
Seat 3: 4OO5v3AVduL0tePNx8wk5A ($100 in chips)
Seat 4: UBZQqpnJZdTYYY1FTb0rLA ($156.70 in chips)
Seat 5: +OrCjyw70oZhJiD22Mn+bg ($202 in chips)
Seat 6: b2a+5TkFf4xJN/Ihhma58Q ($34.30 in chips)
4OO5v3AVduL0tePNx8wk5A: posts small blind $0.50
UBZQqpnJZdTYYY1FTb0rLA: posts big blind $1
*** HOLE CARDS ***
+OrCjyw70oZhJiD22Mn+bg: folds
b2a+5TkFf4xJN/Ihhma58Q: folds
eUBBn2R56C1IQ6Cs/vitwg: folds
oDiBRCaF0QVtd3kO6xZIXw: raises $3 to $4
4OO5v3AVduL0tePNx8wk5A: folds
UBZQqpnJZdTYYY1FTb0rLA: folds
oDiBRCaF0QVtd3kO6xZIXw collected $2.50 from pot
oDiBRCaF0QVtd3kO6xZIXw: doesn't show hand
*** SUMMARY ***
Total pot $2.50 | Rake $0
Seat 1: eUBBn2R56C1IQ6Cs/vitwg folded before Flop (didn't bet)
Seat 2: oDiBRCaF0QVtd3kO6xZIXw (button) collected ($2.50)
Seat 3: 4OO5v3AVduL0tePNx8wk5A (small blind) folded before Flop
Seat 4: UBZQqpnJZdTYYY1FTb0rLA (big blind) folded before Flop
Seat 5: +OrCjyw70oZhJiD22Mn+bg folded before Flop (didn't bet)
Seat 6: b2a+5TkFf4xJN/Ihhma58Q folded before Flop (didn't bet)



PokerStars Game #59941558462:  Hold'em No Limit ($0.50/$1.00) - 2009/07/01 1:39:06 ET
Table 'ZFWj23PMihdwrNWv41OG/QtyUh+jyNvrceIQdKMJjQ2weat #3 is the button
Seat 1: j3hj7KQwBVU5NTFmtYomSw ($87.75 in chips)
Seat 2: 0smcry9L0OOTCP+KzIS5SA ($97 in chips)
Seat 3: cWwhvq/+r/w8nkhwrJoekQ ($46.20 in chips)
Seat 4: O5ZesE/6mHyuWWbvkiH/Fg ($63.65 in chips)
Seat 5: j7NIOHLZk7V2o9fOioO5ug ($103.20 in chips)
Seat 6: u23r4AyKPgHioZ6t7z6qrA ($100 in chips)
O5ZesE/6mHyuWWbvkiH/Fg: posts small blind $0.50
j7NIOHLZk7V2o9fOioO5ug: posts big blind $1
*** HOLE CARDS ***
u23r4AyKPgHioZ6t7z6qrA: folds
j3hj7KQwBVU5NTFmtYomSw: folds
0smcry9L0OOTCP+KzIS5SA: folds
cWwhvq/+r/w8nkhwrJoekQ: folds
O5ZesE/6mHyuWWbvkiH/Fg: raises $1 to $2
u23r4AyKPgHioZ6t7z6qrA said, "drawing for the nut flush"
j7NIOHLZk7V2o9fOioO5ug: folds
O5ZesE/6mHyuWWbvkiH/Fg collected $2 from pot
O5ZesE/6mHyuWWbvkiH/Fg: doesn't show hand
*** SUMMARY ***
Total pot $2 | Rake $0
Seat 1: j3hj7KQwBVU5NTFmtYomSw folded before Flop (didn't bet)
Seat 2: 0smcry9L0OOTCP+KzIS5SA folded before Flop (didn't bet)
Seat 3: cWwhvq/+r/w8nkhwrJoekQ (button) folded before Flop (didn't bet)
Seat 4: O5ZesE/6mHyuWWbvkiH/Fg (small blind) collected ($2)
Seat 5: j7NIOHLZk7V2o9fOioO5ug (big blind) folded before Flop
Seat 6: u23r4AyKPgHioZ6t7z6qrA folded before Flop (didn't bet)



PokerStars Game #59941558458:  Hold'em No Limit ($0.50/$1.00) - 2009/07/01 1:39:06 ET
Table 'b8oW/dOL7fDza5DfZ/dOJQ' 6-max Seat #2 is the button
Seat 1: NakujTNjHFgzceydFf+E2Q ($57.50 in chips)
Seat 2: TSuRyAHnUPCFjP7Z0rEE0w ($117.50 in chips)
Seat 3: d8WX+9nUHoqlrAGagO0Wow ($33.30 in chips)
Seat 4: 8rDbzImSi1zgxtqtF1pSbA ($14 in chips)
Seat 5: r4lpoh2BJZ8S6zyQv1JeSw ($101.50 in chips)
Seat 6: PvfYaKbzMpsmUcbOExckbQ ($154.95 in chips)
d8WX+9nUHoqlrAGagO0Wow: posts small blind $0.50
8rDbzImSi1zgxtqtF1pSbA: posts big blind $1
*** HOLE CARDS ***
r4lpoh2BJZ8S6zyQv1JeSw: folds
r4lpoh2BJZ8S6zyQv1JeSw leaves the table
PvfYaKbzMpsmUcbOExckbQ: folds
NakujTNjHFgzceydFf+E2Q: folds
TSuRyAHnUPCFjP7Z0rEE0w: raises $3 to $4
d8WX+9nUHoqlrAGagO0Wow: folds
8rDbzImSi1zgxtqtF1pSbA: folds
sr/OkkgqNbtgwJf1tmnfNg joins the table at seat #5
TSuRyAHnUPCFjP7Z0rEE0w collected $2.50 from pot
TSuRyAHnUPCFjP7Z0rEE0w: doesn't show hand
*** SUMMARY ***
Total pot $2.50 | Rake $0
Seat 1: NakujTNjHFgzceydFf+E2Q folded before Flop (didn't bet)
Seat 2: TSuRyAHnUPCFjP7Z0rEE0w (button) collected ($2.50)
Seat 3: d8WX+9nUHoqlrAGagO0Wow (small blind) folded before Flop
Seat 4: 8rDbzImSi1zgxtqtF1pSbA (big blind) folded before Flop
Seat 5: r4lpoh2BJZ8S6zyQv1JeSw folded before Flop (didn't bet)
Seat 6: PvfYaKbzMpsmUcbOExckbQ folded before Flop (didn't bet)



PokerStars Game #59941558958:  Hold'em No Limit ($0.50/$1.00) - 2009/07/01 1:39:07 ET
Table 'N2bNCDHL96aCQDvZIh+yQQ' 6-max Seat #1 is the button
Seat 1: Jjgflx10PVjcLkziEmLhSA ($92.35 in chips)
Seat 2: y27w5IK2WXqmYzS8OU0wKA ($129.15 in chips)
Seat 3: UBZQqpnJZdTYYY1FTb0rLA ($122.05 in chips)
Seat 4: uCqEjnxh2/vFBjKYkfTOkw ($174.30 in chips)
Seat 5: frvgHLr3+LfZtjsBCBs3NA ($6.60 in chips)
Seat 6: idVgoPAdspFPCzee6aF9Pg ($100 in chips)
y27w5IK2WXqmYzS8OU0wKA: posts small blind $0.50
UBZQqpnJZdTYYY1FTb0rLA: posts big blind $1
*** HOLE CARDS ***
uCqEjnxh2/vFBjKYkfTOkw: folds
frvgHLr3+LfZtjsBCBs3NA: raises $5.60 to $6.60 and is all-in
idVgoPAdspFPCzee6aF9Pg: calls $6.60
Jjgflx10PVjcLkziEmLhSA: folds
y27w5IK2WXqmYzS8OU0wKA: folds
UBZQqpnJZdTYYY1FTb0rLA: folds
*** FLOP *** [6h Td 4s]
*** TURN *** [6h Td 4s] [4h]
*** RIVER *** [6h Td 4s 4h] [Ad]
*** SHOW DOWN ***
frvgHLr3+LfZtjsBCBs3NA: shows [5d Kd] (a pair of Fours)
idVgoPAdspFPCzee6aF9Pg: shows [9s 9h] (two pair, Nines and Fours)
idVgoPAdspFPCzee6aF9Pg collected $14 from pot
*** SUMMARY ***
Total pot $14.70 | Rake $0.70
Board [6h Td 4s 4h Ad]
Seat 1: Jjgflx10PVjcLkziEmLhSA (button) folded before Flop (didn't bet)
Seat 2: y27w5IK2WXqmYzS8OU0wKA (small blind) folded before Flop
Seat 3: UBZQqpnJZdTYYY1FTb0rLA (big blind) folded before Flop
Seat 4: uCqEjnxh2/vFBjKYkfTOkw folded before Flop (didn't bet)
Seat 5: frvgHLr3+LfZtjsBCBs3NA showed [5d Kd] and lost with a pair of Fours
Seat 6: idVgoPAdspFPCzee6aF9Pg showed [9s 9h] and won ($14) with two pair, Nines and Fours



PokerStars Game #59941559344:  Hold'em No Limit ($0.50/$1.00) - 2009/07/01 1:39:08 ET
Table '7O9fB8yx1u7sJveJn8w6jA' 6-max Seat #3 is the button
Seat 1: 841740 ($46.30 in chips)
Seat 2: wx3sQGkVi2x9wJXuWNHPBw ($206.85 in chips)
Seat 3: hpxXcmRkXXI9HE5+5/j/0Q ($135.40 in chips)
Seat 4: b2a+5TkFf4xJN/Ihhma58Q ($30.85 in chips)
Seat 5: BCEV3COoKY607AzLWayfRA ($100.50 in chips)
Seat 6: r4lpoh2BJZ8S6zyQv1JeSw ($107.75 in chips)
b2a+5TkFf4xJN/Ihhma58Q: posts small blind $0.50
BCEV3COoKY607AzLWayfRA: posts big blind $1
*** HOLE CARDS ***
r4lpoh2BJZ8S6zyQv1JeSw: folds
841740: raises $1 to $2
wx3sQGkVi2x9wJXuWNHPBw: folds
hpxXcmRkXXI9HE5+5/j/0Q: calls $2
b2a+5TkFf4xJN/Ihhma58Q: folds
BCEV3COoKY607AzLWayfRA: folds
*** FLOP *** [7c Td 9c]
841740: checks
hpxXcmRkXXI9HE5+5/j/0Q: bets $4
841740: folds
hpxXcmRkXXI9HE5+5/j/0Q collected $5.25 from pot
hpxXcmRkXXI9HE5+5/j/0Q: doesn't show hand
*** SUMMARY ***
Total pot $5.50 | Rake $0.25
Board [7c Td 9c]
Seat 1: 841740 folded on the Flop
Seat 2: wx3sQGkVi2x9wJXuWNHPBw folded before Flop (didn't bet)
Seat 3: hpxXcmRkXXI9HE5+5/j/0Q (button) collected ($5.25)
Seat 4: b2a+5TkFf4xJN/Ihhma58Q (small blind) folded before Flop
Seat 5: BCEV3COoKY607AzLWayfRA (big blind) folded before Flop
Seat 6: r4lpoh2BJZ8S6zyQv1JeSw folded before Flop (didn't bet)



PokerStars Game #59941559974:  Hold'em No Limit ($0.50/$1.00) - 2009/07/01 1:39:09 ET
Table 'pHrhryH8jPNdQfY62f8v+g' 6-max Seat #5 is the button
Seat 1: 4d1rWhpu8DzLmzMbR3QKyA ($148.95 in chips)
Seat 2: JwCcjZl0bjJzG7hmE0dnTA ($111.05 in chips)
Seat 3: 8oS5O7iD/qnFXFXJrGIgNQ ($110.80 in chips)
Seat 4: 1f3beyIML24UqEMTbWy93g ($57.85 in chips)
Seat 5: d8WX+9nUHoqlrAGagO0Wow ($20.15 in chips)
Seat 6: xAU6q2/cwmby2sxmA8VcmA ($178.80 in chips)
xAU6q2/cwmby2sxmA8VcmA: posts small blind $0.50
4d1rWhpu8DzLmzMbR3QKyA: posts big blind $1
*** HOLE CARDS ***
JwCcjZl0bjJzG7hmE0dnTA: folds
8oS5O7iD/qnFXFXJrGIgNQ: folds
1f3beyIML24UqEMTbWy93g: folds
d8WX+9nUHoqlrAGagO0Wow: raises $2 to $3
xAU6q2/cwmby2sxmA8VcmA: folds
4d1rWhpu8DzLmzMbR3QKyA: folds
d8WX+9nUHoqlrAGagO0Wow collected $2.50 from pot
*** SUMMARY ***
Total pot $2.50 | Rake $0
Seat 1: 4d1rWhpu8DzLmzMbR3QKyA (big blind) folded before Flop
Seat 2: JwCcjZl0bjJzG7hmE0dnTA folded before Flop (didn't bet)
Seat 3: 8oS5O7iD/qnFXFXJrGIgNQ folded before Flop (didn't bet)
Seat 4: 1f3beyIML24UqEMTbWy93g folded before Flop (didn't bet)
Seat 5: d8WX+9nUHoqlrAGagO0Wow (button) collected ($2.50)
Seat 6: xAU6q2/cwmby2sxmA8VcmA (small blind) folded before Flop



PokerStars Game #59941559778:  Hold'em No Limit ($0.50/$1.00) - 2009/07/01 1:39:09 ET
Table '/RZcOwpZpHQ+OwPwjsbnRw' 6-max Seat #5 is the button
Seat 1: +uSzP8Jwnw7sKfQ4s66b7w ($88.90 in chips)
Seat 2: Z2fXsGcjl+Eax+RzOgwOmg ($100 in chips)
Seat 3: LJMw/I77xpnw0R5T4HnMUg ($118.55 in chips)
Seat 4: j7NIOHLZk7V2o9fOioO5ug ($101 in chips)
Seat 5: wx3sQGkVi2x9wJXuWNHPBw ($164.25 in chips)
Seat 6: o3YLm/rSY916m/on1VjXPA ($206 in chips)
o3YLm/rSY916m/on1VjXPA: posts small blind $0.50
+uSzP8Jwnw7sKfQ4s66b7w: posts big blind $1
*** HOLE CARDS ***
Z2fXsGcjl+Eax+RzOgwOmg: folds
LJMw/I77xpnw0R5T4HnMUg: raises $3 to $4
j7NIOHLZk7V2o9fOioO5ug: folds
wx3sQGkVi2x9wJXuWNHPBw: folds
o3YLm/rSY916m/on1VjXPA: folds
+uSzP8Jwnw7sKfQ4s66b7w: folds
LJMw/I77xpnw0R5T4HnMUg collected $2.50 from pot
LJMw/I77xpnw0R5T4HnMUg: doesn't show hand
*** SUMMARY ***
Total pot $2.50 | Rake $0
Seat 1: +uSzP8Jwnw7sKfQ4s66b7w (big blind) folded before Flop
Seat 2: Z2fXsGcjl+Eax+RzOgwOmg folded before Flop (didn't bet)
Seat 3: LJMw/I77xpnw0R5T4HnMUg collected ($2.50)
Seat 4: j7NIOHLZk7V2o9fOioO5ug folded before Flop (didn't bet)
Seat 5: wx3sQGkVi2x9wJXuWNHPBw (button) folded before Flop (didn't bet)
Seat 6: o3YLm/rSY916m/on1VjXPA (small blind) folded before Flop



PokerStars Game #59941559910:  Hold'em No Limit ($0.50/$1.00) - 2009/07/01 1:39:09 ET
Table 'hugOjcwJvzEwZbK7tyiWuQ' 9-max Seat #9 is the button
Seat 1: S3Ex8K7v6xm5jqjRM7Fl3w ($22.85 in chips)
Seat 2: r27C1nIV4NS4+qbnrgBQSw ($278.60 in chips)
Seat 3: c/6hFCyfLNRn3VFvCeQ1ng ($36.55 in chips)
Seat 4: UWB3oeddt/GObx2Mix2Anw ($159.45 in chips)
Seat 5: AexZ4puUV9meFWwVU6Nv0w ($31.70 in chips)
Seat 6: gUUvmqdVlmvpal6B8nYrmg ($103.95 in chips)
Seat 7: FL3MrLspcF23LYvC4ipBOA ($109.80 in chips)
Seat 8: /zy+DB4S5fUQUSfZWFzYGw ($119.35 in chips)
Seat 9: W8P9bUKCs43TO1xHm0dL6w ($105.30 in chips)
S3Ex8K7v6xm5jqjRM7Fl3w: posts small blind $0.50
r27C1nIV4NS4+qbnrgBQSw: posts big blind $1
*** HOLE CARDS ***
c/6hFCyfLNRn3VFvCeQ1ng: folds
UWB3oeddt/GObx2Mix2Anw: folds
AexZ4puUV9meFWwVU6Nv0w: folds
gUUvmqdVlmvpal6B8nYrmg: folds
FL3MrLspcF23LYvC4ipBOA: folds
c/6hFCyfLNRn3VFvCeQ1ng is sitting out
c/6hFCyfLNRn3VFvCeQ1ng has returned
/zy+DB4S5fUQUSfZWFzYGw: raises $2 to $3
W8P9bUKCs43TO1xHm0dL6w: folds
S3Ex8K7v6xm5jqjRM7Fl3w: folds
r27C1nIV4NS4+qbnrgBQSw: calls $2
*** FLOP *** [Ad 6s 6h]
r27C1nIV4NS4+qbnrgBQSw: checks
/zy+DB4S5fUQUSfZWFzYGw: bets $5
r27C1nIV4NS4+qbnrgBQSw: folds
/zy+DB4S5fUQUSfZWFzYGw collected $6.20 from pot
*** SUMMARY ***
Total pot $6.50 | Rake $0.30
Board [Ad 6s 6h]
Seat 1: S3Ex8K7v6xm5jqjRM7Fl3w (small blind) folded before Flop
Seat 2: r27C1nIV4NS4+qbnrgBQSw (big blind) folded on the Flop
Seat 3: c/6hFCyfLNRn3VFvCeQ1ng folded before Flop (didn't bet)
Seat 4: UWB3oeddt/GObx2Mix2Anw folded before Flop (didn't bet)
Seat 5: AexZ4puUV9meFWwVU6Nv0w folded before Flop (didn't bet)
Seat 6: gUUvmqdVlmvpal6B8nYrmg folded before Flop (didn't bet)
Seat 7: FL3MrLspcF23LYvC4ipBOA folded before Flop (didn't bet)
Seat 8: /zy+DB4S5fUQUSfZWFzYGw collected ($6.20)
Seat 9: W8P9bUKCs43TO1xHm0dL6w (button) folded before Flop (didn't bet)



PokerStars Game #59941560684:  Hold'em No Limit ($0.50/$1.00) - 2009/07/01 1:39:10 ET
Table 'rmZfTK+oSebeUPJNbWhdAA' 6-max Seat #2 is the button
Seat 1: xAU6q2/cwmby2sxmA8VcmA ($131.50 in chips)
Seat 2: z7O9PO/WEcqRouIydFhS9Q ($188 in chips)
Seat 3: BCEV3COoKY607AzLWayfRA ($219.20 in chips)
Seat 4: 1/mIuXfgx1ZyVkodrmfQDw ($172.15 in chips)
Seat 5: BWhgxe7gWiYobRbwdG+d2Q ($100 in chips)
Seat 6: j7NIOHLZk7V2o9fOioO5ug ($100 in chips)
BCEV3COoKY607AzLWayfRA: posts small blind $0.50
1/mIuXfgx1ZyVkodrmfQDw: posts big blind $1
*** HOLE CARDS ***
BWhgxe7gWiYobRbwdG+d2Q: raises $3 to $4
j7NIOHLZk7V2o9fOioO5ug: folds
xAU6q2/cwmby2sxmA8VcmA: folds
z7O9PO/WEcqRouIydFhS9Q: folds
BCEV3COoKY607AzLWayfRA: folds
1/mIuXfgx1ZyVkodrmfQDw: folds
BWhgxe7gWiYobRbwdG+d2Q collected $2.50 from pot
BWhgxe7gWiYobRbwdG+d2Q: doesn't show hand
*** SUMMARY ***
Total pot $2.50 | Rake $0
Seat 1: xAU6q2/cwmby2sxmA8VcmA folded before Flop (didn't bet)
Seat 2: z7O9PO/WEcqRouIydFhS9Q (button) folded before Flop (didn't bet)
Seat 3: BCEV3COoKY607AzLWayfRA (small blind) folded before Flop
Seat 4: 1/mIuXfgx1ZyVkodrmfQDw (big blind) folded before Flop
Seat 5: BWhgxe7gWiYobRbwdG+d2Q collected ($2.50)
Seat 6: j7NIOHLZk7V2o9fOioO5ug folded before Flop (didn't bet)



PokerStars Game #59941560700:  Hold'em No Limit ($0.50/$1.00) - 2009/07/01 1:39:10 ET
Table '305hiksPPCCdC6V2LNsO5w' 6-max Seat #1 is the button
Seat 1: RTuDLJHh/9zPfBftoc9vsw ($8.25 in chips)
Seat 2: j7NIOHLZk7V2o9fOioO5ug ($158.20 in chips)
Seat 3: +zIVjZKLpcidfRHgVZW8lA ($30 in chips)
Seat 4: uJVSceLggtsrJya+WtmUEA ($203.80 in chips)
Seat 5: +Nt3OPk3XR9SKjZgm2CexQ ($100 in chips)
Seat 6: 9/Tq8dw7kWW68uN8bFupXg ($17.45 in chips)
j7NIOHLZk7V2o9fOioO5ug: posts small blind $0.50
+zIVjZKLpcidfRHgVZW8lA: posts big blind $1
*** HOLE CARDS ***
uJVSceLggtsrJya+WtmUEA: folds
+Nt3OPk3XR9SKjZgm2CexQ: folds
9/Tq8dw7kWW68uN8bFupXg: raises $2 to $3
RTuDLJHh/9zPfBftoc9vsw: folds
j7NIOHLZk7V2o9fOioO5ug: folds
+zIVjZKLpcidfRHgVZW8lA: folds
9/Tq8dw7kWW68uN8bFupXg collected $2.50 from pot
*** SUMMARY ***
Total pot $2.50 | Rake $0
Seat 1: RTuDLJHh/9zPfBftoc9vsw (button) folded before Flop (didn't bet)
Seat 2: j7NIOHLZk7V2o9fOioO5ug (small blind) folded before Flop
Seat 3: +zIVjZKLpcidfRHgVZW8lA (big blind) folded before Flop
Seat 4: uJVSceLggtsrJya+WtmUEA folded before Flop (didn't bet)
Seat 5: +Nt3OPk3XR9SKjZgm2CexQ folded before Flop (didn't bet)
Seat 6: 9/Tq8dw7kWW68uN8bFupXg collected ($2.50)



PokerStars Game #59941560872:  Hold'em No Limit ($0.50/$1.00) - 2009/07/01 1:39:11 ET
Table 'NqGO/cV3MwFAx+ZPB5ANmQ' 2-max Seat #1 is the button
Seat 1: ItaRAnHOgvYOv5ynbG1iTw ($251.20 in chips)
Seat 2: GtFB+yyeb2djMdPFuOW/Xg ($100 in chips)
ItaRAnHOgvYOv5ynbG1iTw: posts small blind $0.50
GtFB+yyeb2djMdPFuOW/Xg: posts big blind $1
*** HOLE CARDS ***
ItaRAnHOgvYOv5ynbG1iTw: folds
GtFB+yyeb2djMdPFuOW/Xg collected $1 from pot
*** SUMMARY ***
Total pot $1 | Rake $0
Seat 1: ItaRAnHOgvYOv5ynbG1iTw (button) (small blind) folded before Flop
Seat 2: GtFB+yyeb2djMdPFuOW/Xg (big blind) collected ($1)



PokerStars Game #59941562198:  Hold'em No Limit ($0.50/$1.00) - 2009/07/01 1:39:13 ET
Table 'qj0HBN4HhQKogreu1bg7xg' 2-max Seat #1 is the button
Seat 1: NYi6JFscYNrofSXy4sM+Yw ($113.60 in chips)
Seat 2: qtyl8CSb0/4yWdbuEPJejA ($164.80 in chips)
NYi6JFscYNrofSXy4sM+Yw: posts small blind $0.50
qtyl8CSb0/4yWdbuEPJejA: posts big blind $1
*** HOLE CARDS ***
NYi6JFscYNrofSXy4sM+Yw: raises $2 to $3
qtyl8CSb0/4yWdbuEPJejA: folds
NYi6JFscYNrofSXy4sM+Yw collected $2 from pot
*** SUMMARY ***
Total pot $2 | Rake $0
Seat 1: NYi6JFscYNrofSXy4sM+Yw (button) (small blind) collected ($2)
Seat 2: qtyl8CSb0/4yWdbuEPJejA (big blind) folded before Flop



PokerStars Game #59941562520:  Hold'em No Limit ($0.50/$1.00) - 2009/07/01 1:39:14 ET
Table 'tHb+N6GaPEmmBAe36B2R9Q' 2-max Seat #1 is the button
Seat 1: rL+Zpv4/vX2BVHcyfh/NXA ($100 in chips)
Seat 2: Pm1sDZZi0zFtnFGXLznkug ($175.30 in chips)
rL+Zpv4/vX2BVHcyfh/NXA: posts small blind $0.50
Pm1sDZZi0zFtnFGXLznkug: posts big blind $1
*** HOLE CARDS ***
rL+Zpv4/vX2BVHcyfh/NXA: raises $2 to $3
Pm1sDZZi0zFtnFGXLznkug: calls $2
*** FLOP *** [4h As 7d]
Pm1sDZZi0zFtnFGXLznkug: checks
rL+Zpv4/vX2BVHcyfh/NXA: bets $4
Pm1sDZZi0zFtnFGXLznkug: calls $4
*** TURN *** [4h As 7d] [6s]
Pm1sDZZi0zFtnFGXLznkug: checks
rL+Zpv4/vX2BVHcyfh/NXA: checks
*** RIVER *** [4h As 7d 6s] [9d]
Pm1sDZZi0zFtnFGXLznkug: bets $8
rL+Zpv4/vX2BVHcyfh/NXA: folds
Pm1sDZZi0zFtnFGXLznkug collected $13.50 from pot
Pm1sDZZi0zFtnFGXLznkug: doesn't show hand
*** SUMMARY ***
Total pot $14 | Rake $0.50
Board [4h As 7d 6s 9d]
Seat 1: rL+Zpv4/vX2BVHcyfh/NXA (button) (small blind) folded on the River
Seat 2: Pm1sDZZi0zFtnFGXLznkug (big blind) collected ($13.50)



PokerStars Game #59941562982:  Hold'em No Limit ($0.50/$1.00) - 2009/07/01 1:39:15 ET
Table 'O96CPOtvMBWP6kzuYDfdFA' 6-max Seat #1 is the button
Seat 1: 6alLXQIITA2EZ/lBeym8Dw ($126.75 in chips)
Seat 2: 4d1rWhpu8DzLmzMbR3QKyA ($100.50 in chips)
Seat 4: /P4w1pHg2zHYg/4ubJ0dPw ($73.95 in chips)
Seat 5: vX+iYAEINFeLxwMla7DY1Q ($98.50 in chips)
Seat 6: 3syOXva630dm1FTdwnuLpw ($73.15 in chips)
4d1rWhpu8DzLmzMbR3QKyA: posts small blind $0.50
/P4w1pHg2zHYg/4ubJ0dPw: posts big blind $1
*** HOLE CARDS ***
vX+iYAEINFeLxwMla7DY1Q: folds
3syOXva630dm1FTdwnuLpw: raises $2 to $3
6alLXQIITA2EZ/lBeym8Dw: folds
4d1rWhpu8DzLmzMbR3QKyA: folds
/P4w1pHg2zHYg/4ubJ0dPw: folds
3syOXva630dm1FTdwnuLpw collected $2.50 from pot
*** SUMMARY ***
Total pot $2.50 | Rake $0
Seat 1: 6alLXQIITA2EZ/lBeym8Dw (button) folded before Flop (didn't bet)
Seat 2: 4d1rWhpu8DzLmzMbR3QKyA (small blind) folded before Flop
Seat 4: /P4w1pHg2zHYg/4ubJ0dPw (big blind) folded before Flop
Seat 5: vX+iYAEINFeLxwMla7DY1Q folded before Flop (didn't bet)
Seat 6: 3syOXva630dm1FTdwnuLpw collected ($2.50)



PokerStars Game #59941567272:  Hold'em No Limit ($0.50/$1.00) - 2009/07/01 1:39:22 ET
Table 'GxCPo/gd3OSthkYrAxJngg' 6-max Seat #1 is the button
Seat 1: sH8BpAFP+jGFxCgVpD1Lew ($229.55 in chips)
Seat 2: YExX2paeIHrmfIwV1ivM/w ($62.10 in chips)
Seat 3: idVgoPAdspFPCzee6aF9Pg ($134.50 in chips)
Seat 4: YMJG+F++3Aj6P8dAWda5fw ($205.35 in chips)
Seat 5: vX+iYAEINFeLxwMla7DY1Q ($98.50 in chips)
Seat 6: 4d1rWhpu8DzLmzMbR3QKyA ($106.55 in chips)
YExX2paeIHrmfIwV1ivM/w: posts small blind $0.50
idVgoPAdspFPCzee6aF9Pg: posts big blind $1
*** HOLE CARDS ***
YMJG+F++3Aj6P8dAWda5fw: folds
vX+iYAEINFeLxwMla7DY1Q: folds
4d1rWhpu8DzLmzMbR3QKyA: folds
sH8BpAFP+jGFxCgVpD1Lew: folds
YExX2paeIHrmfIwV1ivM/w: folds
idVgoPAdspFPCzee6aF9Pg collected $1 from pot
*** SUMMARY ***
Total pot $1 | Rake $0
Seat 1: sH8BpAFP+jGFxCgVpD1Lew (button) folded before Flop (didn't bet)
Seat 2: YExX2paeIHrmfIwV1ivM/w (small blind) folded before Flop
Seat 3: idVgoPAdspFPCzee6aF9Pg (big blind) collected ($1)
Seat 4: YMJG+F++3Aj6P8dAWda5fw folded before Flop (didn't bet)
Seat 5: vX+iYAEINFeLxwMla7DY1Q folded before Flop (didn't bet)
Seat 6: 4d1rWhpu8DzLmzMbR3QKyA folded before Flop (didn't bet)



PokerStars Game #59941566860:  Hold'em No Limit ($0.50/$1.00) - 2009/07/01 1:39:22 ET
Table 'QSIig7BLMc9wY/rgBechzw' 6-max Seat #5 is the button
Seat 1: Z2fXsGcjl+Eax+RzOgwOmg ($111.55 in chips)
Seat 2: mLOIkH/qmRa+mVujQIhBRg ($28.75 in chips)
Seat 3: 4OO5v3AVduL0tePNx8wk5A ($103 in chips)
Seat 4: +uSzP8Jwnw7sKfQ4s66b7w ($57.80 in chips)
Seat 5: lsLuWlcPA3Rh7kJVLzMh0Q ($100 in chips)
Seat 6: Wj7mKnRFR90j40wWUu2+Og ($59 in chips)
Wj7mKnRFR90j40wWUu2+Og: posts small blind $0.50
Z2fXsGcjl+Eax+RzOgwOmg: posts big blind $1
*** HOLE CARDS ***
mLOIkH/qmRa+mVujQIhBRg: folds
4OO5v3AVduL0tePNx8wk5A: raises $2 to $3
+uSzP8Jwnw7sKfQ4s66b7w: folds
lsLuWlcPA3Rh7kJVLzMh0Q: calls $3
Wj7mKnRFR90j40wWUu2+Og: folds
Z2fXsGcjl+Eax+RzOgwOmg: folds
*** FLOP *** [5c Kh 6d]
4OO5v3AVduL0tePNx8wk5A: bets $6
lsLuWlcPA3Rh7kJVLzMh0Q: calls $6
*** TURN *** [5c Kh 6d] [8d]
4OO5v3AVduL0tePNx8wk5A: checks
lsLuWlcPA3Rh7kJVLzMh0Q: bets $14
4OO5v3AVduL0tePNx8wk5A: raises $24 to $38
lsLuWlcPA3Rh7kJVLzMh0Q: folds
4OO5v3AVduL0tePNx8wk5A collected $45.20 from pot
4OO5v3AVduL0tePNx8wk5A: doesn't show hand
*** SUMMARY ***
Total pot $47.50 | Rake $2.30
Board [5c Kh 6d 8d]
Seat 1: Z2fXsGcjl+Eax+RzOgwOmg (big blind) folded before Flop
Seat 2: mLOIkH/qmRa+mVujQIhBRg folded before Flop (didn't bet)
Seat 3: 4OO5v3AVduL0tePNx8wk5A collected ($45.20)
Seat 4: +uSzP8Jwnw7sKfQ4s66b7w folded before Flop (didn't bet)
Seat 5: lsLuWlcPA3Rh7kJVLzMh0Q (button) folded on the Turn
Seat 6: Wj7mKnRFR90j40wWUu2+Og (small blind) folded before Flop



PokerStars Game #59941567830:  Hold'em No Limit ($0.50/$1.00) - 2009/07/01 1:39:23 ET
Table 'qj0HBN4HhQKogreu1bg7xg' 2-max Seat #2 is the button
Seat 1: NYi6JFscYNrofSXy4sM+Yw ($114.60 in chips)
Seat 2: qtyl8CSb0/4yWdbuEPJejA ($163.80 in chips)
qtyl8CSb0/4yWdbuEPJejA: posts small blind $0.50
NYi6JFscYNrofSXy4sM+Yw: posts big blind $1
*** HOLE CARDS ***
qtyl8CSb0/4yWdbuEPJejA: raises $2 to $3
NYi6JFscYNrofSXy4sM+Yw: folds
qtyl8CSb0/4yWdbuEPJejA collected $2 from pot
qtyl8CSb0/4yWdbuEPJejA: doesn't show hand
*** SUMMARY ***
Total pot $2 | Rake $0
Seat 1: NYi6JFscYNrofSXy4sM+Yw (big blind) folded before Flop
Seat 2: qtyl8CSb0/4yWdbuEPJejA (button) (small blind) collected ($2)



PokerStars Game #59941568690:  Hold'em No Limit ($0.50/$1.00) - 2009/07/01 1:39:25 ET
Table 'gxFK0BVUD7cupu2uyRUZJg' 6-max Seat #6 is the button
Seat 1: M+X3uChmP6R63IwijVjgTg ($218.90 in chips)
Seat 2: hpxXcmRkXXI9HE5+5/j/0Q ($131.55 in chips)
Seat 3: Z2fXsGcjl+Eax+RzOgwOmg ($100 in chips)
Seat 4: Hcr4S4Nbkj5idKsvYK/eqQ ($101.50 in chips)
Seat 5: 0smcry9L0OOTCP+KzIS5SA ($110 in chips)
Seat 6: dYyb6/42PMC8aNFlm/eBeQ ($141.25 in chips)
M+X3uChmP6R63IwijVjgTg: posts small blind $0.50
hpxXcmRkXXI9HE5+5/j/0Q: posts big blind $1
*** HOLE CARDS ***
Z2fXsGcjl+Eax+RzOgwOmg: raises $3 to $4
Hcr4S4Nbkj5idKsvYK/eqQ: folds
0smcry9L0OOTCP+KzIS5SA: calls $4
dYyb6/42PMC8aNFlm/eBeQ: folds
M+X3uChmP6R63IwijVjgTg: folds
hpxXcmRkXXI9HE5+5/j/0Q: folds
*** FLOP *** [Ts 6d 5d]
Z2fXsGcjl+Eax+RzOgwOmg: bets $7
0smcry9L0OOTCP+KzIS5SA: raises $16 to $23
Z2fXsGcjl+Eax+RzOgwOmg: raises $40 to $63
0smcry9L0OOTCP+KzIS5SA: raises $43 to $106 and is all-in
Z2fXsGcjl+Eax+RzOgwOmg: calls $33 and is all-in
*** TURN *** [Ts 6d 5d] [Qc]
*** RIVER *** [Ts 6d 5d Qc] [2s]
*** SHOW DOWN ***
Z2fXsGcjl+Eax+RzOgwOmg: shows [Kc Kd] (a pair of Kings)
0smcry9L0OOTCP+KzIS5SA: shows [Th Tc] (three of a kind, Tens)
0smcry9L0OOTCP+KzIS5SA collected $198.50 from pot
*** SUMMARY ***
Total pot $201.50 | Rake $3
Board [Ts 6d 5d Qc 2s]
Seat 1: M+X3uChmP6R63IwijVjgTg (small blind) folded before Flop
Seat 2: hpxXcmRkXXI9HE5+5/j/0Q (big blind) folded before Flop
Seat 3: Z2fXsGcjl+Eax+RzOgwOmg showed [Kc Kd] and lost with a pair of Kings
Seat 4: Hcr4S4Nbkj5idKsvYK/eqQ folded before Flop (didn't bet)
Seat 5: 0smcry9L0OOTCP+KzIS5SA showed [Th Tc] and won ($198.50) with three of a kind, Tens
Seat 6: dYyb6/42PMC8aNFlm/eBeQ (button) folded before Flop (didn't bet)



PokerStars Game #59941569196:  Hold'em No Limit ($0.50/$1.00) - 2009/07/01 1:39:26 ET
Table 'ZFWj23PMihdwrNWv41OG/QtyUh+jyNvrceIQdKMJjQ2weat #4 is the button
Seat 1: j3hj7KQwBVU5NTFmtYomSw ($87.75 in chips)
Seat 2: 0smcry9L0OOTCP+KzIS5SA ($97 in chips)
Seat 3: cWwhvq/+r/w8nkhwrJoekQ ($46.20 in chips)
Seat 4: O5ZesE/6mHyuWWbvkiH/Fg ($64.65 in chips)
Seat 5: j7NIOHLZk7V2o9fOioO5ug ($102.20 in chips)
Seat 6: u23r4AyKPgHioZ6t7z6qrA ($100 in chips)
j7NIOHLZk7V2o9fOioO5ug: posts small blind $0.50
u23r4AyKPgHioZ6t7z6qrA: posts big blind $1
*** HOLE CARDS ***
j3hj7KQwBVU5NTFmtYomSw: folds
0smcry9L0OOTCP+KzIS5SA: folds
cWwhvq/+r/w8nkhwrJoekQ: calls $1
O5ZesE/6mHyuWWbvkiH/Fg: calls $1
j7NIOHLZk7V2o9fOioO5ug: folds
u23r4AyKPgHioZ6t7z6qrA said, "spade woulda been all in"
u23r4AyKPgHioZ6t7z6qrA: raises $2 to $3
cWwhvq/+r/w8nkhwrJoekQ: calls $2
O5ZesE/6mHyuWWbvkiH/Fg: calls $2
*** FLOP *** [9c 8c Js]
u23r4AyKPgHioZ6t7z6qrA: checks
cWwhvq/+r/w8nkhwrJoekQ: checks
O5ZesE/6mHyuWWbvkiH/Fg: checks
*** TURN *** [9c 8c Js] [Ah]
u23r4AyKPgHioZ6t7z6qrA: checks
cWwhvq/+r/w8nkhwrJoekQ: checks
O5ZesE/6mHyuWWbvkiH/Fg: checks
*** RIVER *** [9c 8c Js Ah] [6h]
u23r4AyKPgHioZ6t7z6qrA: checks
cWwhvq/+r/w8nkhwrJoekQ: checks
O5ZesE/6mHyuWWbvkiH/Fg: checks
*** SHOW DOWN ***
u23r4AyKPgHioZ6t7z6qrA: shows [Qc Ks] (high card Ace)
cWwhvq/+r/w8nkhwrJoekQ: shows [6d 7d] (a pair of Sixes)
O5ZesE/6mHyuWWbvkiH/Fg: shows [8d Kd] (a pair of Eights)
O5ZesE/6mHyuWWbvkiH/Fg collected $9.05 from pot
*** SUMMARY ***
Total pot $9.50 | Rake $0.45
Board [9c 8c Js Ah 6h]
Seat 1: j3hj7KQwBVU5NTFmtYomSw folded before Flop (didn't bet)
Seat 2: 0smcry9L0OOTCP+KzIS5SA folded before Flop (didn't bet)
Seat 3: cWwhvq/+r/w8nkhwrJoekQ showed [6d 7d] and lost with a pair of Sixes
Seat 4: O5ZesE/6mHyuWWbvkiH/Fg (button) showed [8d Kd] and won ($9.05) with a pair of Eights
Seat 5: j7NIOHLZk7V2o9fOioO5ug (small blind) folded before Flop
Seat 6: u23r4AyKPgHioZ6t7z6qrA (big blind) showed [Qc Ks] and lost with high card Ace



PokerStars Game #59941569322:  Hold'em No Limit ($0.50/$1.00) - 2009/07/01 1:39:26 ET
Table 'b8oW/dOL7fDza5DfZ/dOJQ' 6-max Seat #3 is the button
Seat 1: NakujTNjHFgzceydFf+E2Q ($57.50 in chips)
Seat 2: TSuRyAHnUPCFjP7Z0rEE0w ($119 in chips)
Seat 3: d8WX+9nUHoqlrAGagO0Wow ($32.80 in chips)
Seat 4: 8rDbzImSi1zgxtqtF1pSbA ($13 in chips)
Seat 5: sr/OkkgqNbtgwJf1tmnfNg ($60 in chips)
Seat 6: PvfYaKbzMpsmUcbOExckbQ ($154.95 in chips)
8rDbzImSi1zgxtqtF1pSbA: posts small blind $0.50
sr/OkkgqNbtgwJf1tmnfNg: posts big blind $1
*** HOLE CARDS ***
PvfYaKbzMpsmUcbOExckbQ: folds
NakujTNjHFgzceydFf+E2Q: folds
TSuRyAHnUPCFjP7Z0rEE0w: folds
d8WX+9nUHoqlrAGagO0Wow: raises $2 to $3
8rDbzImSi1zgxtqtF1pSbA: folds
sr/OkkgqNbtgwJf1tmnfNg: folds
d8WX+9nUHoqlrAGagO0Wow collected $2.50 from pot
*** SUMMARY ***
Total pot $2.50 | Rake $0
Seat 1: NakujTNjHFgzceydFf+E2Q folded before Flop (didn't bet)
Seat 2: TSuRyAHnUPCFjP7Z0rEE0w folded before Flop (didn't bet)
Seat 3: d8WX+9nUHoqlrAGagO0Wow (button) collected ($2.50)
Seat 4: 8rDbzImSi1zgxtqtF1pSbA (small blind) folded before Flop
Seat 5: sr/OkkgqNbtgwJf1tmnfNg (big blind) folded before Flop
Seat 6: PvfYaKbzMpsmUcbOExckbQ folded before Flop (didn't bet)



PokerStars Game #59941570714:  Hold'em No Limit ($0.50/$1.00) - 2009/07/01 1:39:28 ET
Table 'rmZfTK+oSebeUPJNbWhdAA' 6-max Seat #3 is the button
Seat 1: xAU6q2/cwmby2sxmA8VcmA ($131.50 in chips)
Seat 2: z7O9PO/WEcqRouIydFhS9Q ($188 in chips)
Seat 3: BCEV3COoKY607AzLWayfRA ($218.70 in chips)
Seat 4: 1/mIuXfgx1ZyVkodrmfQDw ($171.15 in chips)
Seat 6: j7NIOHLZk7V2o9fOioO5ug ($100 in chips)
1/mIuXfgx1ZyVkodrmfQDw: posts small blind $0.50
BWhgxe7gWiYobRbwdG+d2Q: is sitting out
j7NIOHLZk7V2o9fOioO5ug: posts big blind $1
*** HOLE CARDS ***
xAU6q2/cwmby2sxmA8VcmA: folds
z7O9PO/WEcqRouIydFhS9Q: folds
BWhgxe7gWiYobRbwdG+d2Q leaves the table
BCEV3COoKY607AzLWayfRA: folds
1/mIuXfgx1ZyVkodrmfQDw: raises $2 to $3
UOHYuj23MyK9R8ciY2t6FA joins the table at seat #5
j7NIOHLZk7V2o9fOioO5ug: calls $2
*** FLOP *** [7c 4c 7d]
1/mIuXfgx1ZyVkodrmfQDw: checks
j7NIOHLZk7V2o9fOioO5ug: bets $5
1/mIuXfgx1ZyVkodrmfQDw: folds
j7NIOHLZk7V2o9fOioO5ug collected $5.70 from pot
j7NIOHLZk7V2o9fOioO5ug: doesn't show hand
*** SUMMARY ***
Total pot $6 | Rake $0.30
Board [7c 4c 7d]
Seat 1: xAU6q2/cwmby2sxmA8VcmA folded before Flop (didn't bet)
Seat 2: z7O9PO/WEcqRouIydFhS9Q folded before Flop (didn't bet)
Seat 3: BCEV3COoKY607AzLWayfRA (button) folded before Flop (didn't bet)
Seat 4: 1/mIuXfgx1ZyVkodrmfQDw (small blind) folded on the Flop
Seat 6: j7NIOHLZk7V2o9fOioO5ug (big blind) collected ($5.70)



PokerStars Game #59941570742:  Hold'em No Limit ($0.50/$1.00) - 2009/07/01 1:39:29 ET
Table 'tJq9SfN1ywY0r03VBlWlwQ' 9-max Seat #5 is the button
Seat 1: wZsU+w9r7G66x93UuvBf1Q ($298.55 in chips)
Seat 2: VPF+HjszMvUIpy0CHIwH3A ($18.50 in chips)
Seat 4: bLbSOSmSOnqE0iTcH/5dxA ($118.20 in chips)
Seat 5: h5ipsNTMyolp7xn/NAvWkA ($128.80 in chips)
Seat 6: gUUvmqdVlmvpal6B8nYrmg ($103.60 in chips)
Seat 7: Ogn4JDV3mp4ZDKO49IFzKA ($19.90 in chips)
Seat 8: G4DEhsZFmznGNVpy2SEocA ($40.80 in chips)
Seat 9: XE5QF1y74bpHog9JxWJMWQ ($100 in chips)
gUUvmqdVlmvpal6B8nYrmg: posts small blind $0.50
Ogn4JDV3mp4ZDKO49IFzKA: posts big blind $1
*** HOLE CARDS ***
G4DEhsZFmznGNVpy2SEocA: folds
XE5QF1y74bpHog9JxWJMWQ: folds
wZsU+w9r7G66x93UuvBf1Q: raises $3 to $4
VPF+HjszMvUIpy0CHIwH3A: folds
bLbSOSmSOnqE0iTcH/5dxA: folds
h5ipsNTMyolp7xn/NAvWkA: folds
gUUvmqdVlmvpal6B8nYrmg: folds
Ogn4JDV3mp4ZDKO49IFzKA: folds
wZsU+w9r7G66x93UuvBf1Q collected $2.50 from pot
*** SUMMARY ***
Total pot $2.50 | Rake $0
Seat 1: wZsU+w9r7G66x93UuvBf1Q collected ($2.50)
Seat 2: VPF+HjszMvUIpy0CHIwH3A folded before Flop (didn't bet)
Seat 4: bLbSOSmSOnqE0iTcH/5dxA folded before Flop (didn't bet)
Seat 5: h5ipsNTMyolp7xn/NAvWkA (button) folded before Flop (didn't bet)
Seat 6: gUUvmqdVlmvpal6B8nYrmg (small blind) folded before Flop
Seat 7: Ogn4JDV3mp4ZDKO49IFzKA (big blind) folded before Flop
Seat 8: G4DEhsZFmznGNVpy2SEocA folded before Flop (didn't bet)
Seat 9: XE5QF1y74bpHog9JxWJMWQ folded before Flop (didn't bet)



PokerStars Game #59941571230:  Hold'em No Limit ($0.50/$1.00) - 2009/07/01 1:39:29 ET
Table '7Nl0ffnjeK44/vmeexh3MQ' 9-max Seat #2 is the button
Seat 1: V138SURkdX8LdVBPKdJJag ($100 in chips)
Seat 2: OGgaARGdJQT4awWVNQ957w ($100 in chips)
Seat 3: JMmUYT5pIKCKh2pGjCB/4w ($57.40 in chips)
Seat 4: bLbSOSmSOnqE0iTcH/5dxA ($106.80 in chips)
Seat 5: 61sfw5QTu62YYIt68OsdrA ($77.55 in chips)
Seat 6: FVs16t7GgfWgQWt4JxsObQ ($31.25 in chips)
Seat 7: 997ViqAtWn1FPjJqcffwcA ($145.70 in chips)
Seat 8: HRJJZiSxFAehJGaET63dlA ($46.40 in chips)
JMmUYT5pIKCKh2pGjCB/4w: posts small blind $0.50
bLbSOSmSOnqE0iTcH/5dxA: posts big blind $1
*** HOLE CARDS ***
/JHoNdt0fK6X+isrqRfV3w has returned
61sfw5QTu62YYIt68OsdrA: folds
FVs16t7GgfWgQWt4JxsObQ: folds
997ViqAtWn1FPjJqcffwcA: folds
HRJJZiSxFAehJGaET63dlA: raises $1.50 to $2.50
V138SURkdX8LdVBPKdJJag: folds
OGgaARGdJQT4awWVNQ957w: folds
JMmUYT5pIKCKh2pGjCB/4w: folds
bLbSOSmSOnqE0iTcH/5dxA: calls $1.50
*** FLOP *** [Kc Jc Kh]
bLbSOSmSOnqE0iTcH/5dxA: checks
HRJJZiSxFAehJGaET63dlA: bets $3.75
bLbSOSmSOnqE0iTcH/5dxA: folds
HRJJZiSxFAehJGaET63dlA collected $5.25 from pot
*** SUMMARY ***
Total pot $5.50 | Rake $0.25
Board [Kc Jc Kh]
Seat 1: V138SURkdX8LdVBPKdJJag folded before Flop (didn't bet)
Seat 2: OGgaARGdJQT4awWVNQ957w (button) folded before Flop (didn't bet)
Seat 3: JMmUYT5pIKCKh2pGjCB/4w (small blind) folded before Flop
Seat 4: bLbSOSmSOnqE0iTcH/5dxA (big blind) folded on the Flop
Seat 5: 61sfw5QTu62YYIt68OsdrA folded before Flop (didn't bet)
Seat 6: FVs16t7GgfWgQWt4JxsObQ folded before Flop (didn't bet)
Seat 7: 997ViqAtWn1FPjJqcffwcA folded before Flop (didn't bet)
Seat 8: HRJJZiSxFAehJGaET63dlA collected ($5.25)



PokerStars Game #59941571248:  Hold'em No Limit ($0.50/$1.00) - 2009/07/01 1:39:29 ET
Table 'vs/5jr6ciwjVQ5+Soc+u2A' 6-max Seat #4 is the button
Seat 1: J798qwLuvXyq0BbzsIjOrA ($193.65 in chips)
Seat 2: lXX4W7m3u++JiSOZ46yVMQ ($100 in chips)
Seat 3: Ws/3Uo3rQIk8hLgW0P+2xA ($99 in chips)
Seat 4: 0smcry9L0OOTCP+KzIS5SA ($88 in chips)
Seat 5: +Nt3OPk3XR9SKjZgm2CexQ ($158.35 in chips)
Seat 6: Z2fXsGcjl+Eax+RzOgwOmg ($125.50 in chips)
+Nt3OPk3XR9SKjZgm2CexQ: posts small blind $0.50
Z2fXsGcjl+Eax+RzOgwOmg: posts big blind $1
Ws/3Uo3rQIk8hLgW0P+2xA: posts small & big blinds $1.50
*** HOLE CARDS ***
J798qwLuvXyq0BbzsIjOrA: raises $3 to $4
lXX4W7m3u++JiSOZ46yVMQ: folds
Ws/3Uo3rQIk8hLgW0P+2xA: calls $3
0smcry9L0OOTCP+KzIS5SA: folds
+Nt3OPk3XR9SKjZgm2CexQ: folds
Z2fXsGcjl+Eax+RzOgwOmg: folds
*** FLOP *** [7s Th 6h]
J798qwLuvXyq0BbzsIjOrA: bets $9
Ws/3Uo3rQIk8hLgW0P+2xA: folds
J798qwLuvXyq0BbzsIjOrA collected $9.50 from pot
J798qwLuvXyq0BbzsIjOrA: doesn't show hand
*** SUMMARY ***
Total pot $10 | Rake $0.50
Board [7s Th 6h]
Seat 1: J798qwLuvXyq0BbzsIjOrA collected ($9.50)
Seat 2: lXX4W7m3u++JiSOZ46yVMQ folded before Flop (didn't bet)
Seat 3: Ws/3Uo3rQIk8hLgW0P+2xA folded on the Flop
Seat 4: 0smcry9L0OOTCP+KzIS5SA (button) folded before Flop (didn't bet)
Seat 5: +Nt3OPk3XR9SKjZgm2CexQ (small blind) folded before Flop
Seat 6: Z2fXsGcjl+Eax+RzOgwOmg (big blind) folded before Flop



PokerStars Game #59941571062:  Hold'em No Limit ($0.50/$1.00) - 2009/07/01 1:39:29 ET
Table '+cA8mcmhaedZ7YcrDdhmeQ' 6-max Seat #2 is the button
Seat 2: 14aYclSc98EYd6TrzN2l3Q ($59.55 in chips)
Seat 3: DAIgyIWbYvAkL6PbAI27pg ($19 in chips)
Seat 4: 4OO5v3AVduL0tePNx8wk5A ($108.20 in chips)
Seat 6: YfsTQsY/fxb+YqbdclTHuw ($56.15 in chips)
DAIgyIWbYvAkL6PbAI27pg: posts small blind $0.50
4OO5v3AVduL0tePNx8wk5A: posts big blind $1
SJieaES+gCAfonfNNMCP6w: sits out
VB7TtBnfmT3JTA/cCL6dJg: sits out
*** HOLE CARDS ***
YfsTQsY/fxb+YqbdclTHuw: folds
14aYclSc98EYd6TrzN2l3Q: raises $1 to $2
DAIgyIWbYvAkL6PbAI27pg: folds
4OO5v3AVduL0tePNx8wk5A: folds
14aYclSc98EYd6TrzN2l3Q collected $2.50 from pot
*** SUMMARY ***
Total pot $2.50 | Rake $0
Seat 2: 14aYclSc98EYd6TrzN2l3Q (button) collected ($2.50)
Seat 3: DAIgyIWbYvAkL6PbAI27pg (small blind) folded before Flop
Seat 4: 4OO5v3AVduL0tePNx8wk5A (big blind) folded before Flop
Seat 6: YfsTQsY/fxb+YqbdclTHuw folded before Flop (didn't bet)



PokerStars Game #59941571660:  Hold'em No Limit ($0.50/$1.00) - 2009/07/01 1:39:30 ET
Table 'hdVBCnDy5t2X9dZo0AvD9w' 9-max Seat #2 is the button
Seat 2: Ogn4JDV3mp4ZDKO49IFzKA ($17.40 in chips)
Seat 3: 1862487932 ($100 in chips)
Seat 4: YvSugbFKWSuAYx9iokQwUQ ($96.20 in chips)
Seat 5: H+DVy3Ei8L1UKS2tVOtJcw ($108.80 in chips)
Seat 7: laA8va+Yv8WuMqT1zdR91g ($100 in chips)
Seat 8: gUUvmqdVlmvpal6B8nYrmg ($144.15 in chips)
Seat 9: AMkLbywdoc0K30BTzaIfTQ ($174.90 in chips)
1862487932: posts small blind $0.50
YvSugbFKWSuAYx9iokQwUQ: posts big blind $1
*** HOLE CARDS ***
H+DVy3Ei8L1UKS2tVOtJcw: folds
laA8va+Yv8WuMqT1zdR91g: raises $2 to $3
gUUvmqdVlmvpal6B8nYrmg: folds
AMkLbywdoc0K30BTzaIfTQ: folds
Ogn4JDV3mp4ZDKO49IFzKA: folds
1862487932: folds
YvSugbFKWSuAYx9iokQwUQ: calls $2
*** FLOP *** [Qs 8s Ac]
YvSugbFKWSuAYx9iokQwUQ: checks
laA8va+Yv8WuMqT1zdR91g: checks
*** TURN *** [Qs 8s Ac] [7c]
YvSugbFKWSuAYx9iokQwUQ: bets $4
laA8va+Yv8WuMqT1zdR91g: folds
YvSugbFKWSuAYx9iokQwUQ collected $6.20 from pot
YvSugbFKWSuAYx9iokQwUQ: doesn't show hand
*** SUMMARY ***
Total pot $6.50 | Rake $0.30
Board [Qs 8s Ac 7c]
Seat 2: Ogn4JDV3mp4ZDKO49IFzKA (button) folded before Flop (didn't bet)
Seat 3: 1862487932 (small blind) folded before Flop
Seat 4: YvSugbFKWSuAYx9iokQwUQ (big blind) collected ($6.20)
Seat 5: H+DVy3Ei8L1UKS2tVOtJcw folded before Flop (didn't bet)
Seat 7: laA8va+Yv8WuMqT1zdR91g folded on the Turn
Seat 8: gUUvmqdVlmvpal6B8nYrmg folded before Flop (didn't bet)
Seat 9: AMkLbywdoc0K30BTzaIfTQ folded before Flop (didn't bet)



PokerStars Game #59941572130:  Hold'em No Limit ($0.50/$1.00) - 2009/07/01 1:39:31 ET
Table 'qj0HBN4HhQKogreu1bg7xg' 2-max Seat #1 is the button
Seat 1: NYi6JFscYNrofSXy4sM+Yw ($113.60 in chips)
Seat 2: qtyl8CSb0/4yWdbuEPJejA ($164.80 in chips)
NYi6JFscYNrofSXy4sM+Yw: posts small blind $0.50
qtyl8CSb0/4yWdbuEPJejA: posts big blind $1
*** HOLE CARDS ***
NYi6JFscYNrofSXy4sM+Yw: raises $2 to $3
qtyl8CSb0/4yWdbuEPJejA: folds
NYi6JFscYNrofSXy4sM+Yw collected $2 from pot
*** SUMMARY ***
Total pot $2 | Rake $0
Seat 1: NYi6JFscYNrofSXy4sM+Yw (button) (small blind) collected ($2)
Seat 2: qtyl8CSb0/4yWdbuEPJejA (big blind) folded before Flop



PokerStars Game #59941573452:  Hold'em No Limit ($0.50/$1.00) - 2009/07/01 1:39:33 ET
Table 'pHrhryH8jPNdQfY62f8v+g' 6-max Seat #6 is the button
Seat 1: 4d1rWhpu8DzLmzMbR3QKyA ($147.95 in chips)
Seat 2: JwCcjZl0bjJzG7hmE0dnTA ($111.05 in chips)
Seat 3: 8oS5O7iD/qnFXFXJrGIgNQ ($110.80 in chips)
Seat 4: 1f3beyIML24UqEMTbWy93g ($57.85 in chips)
Seat 5: d8WX+9nUHoqlrAGagO0Wow ($21.65 in chips)
Seat 6: xAU6q2/cwmby2sxmA8VcmA ($178.30 in chips)
4d1rWhpu8DzLmzMbR3QKyA: posts small blind $0.50
JwCcjZl0bjJzG7hmE0dnTA: posts big blind $1
*** HOLE CARDS ***
8oS5O7iD/qnFXFXJrGIgNQ: folds
1f3beyIML24UqEMTbWy93g: folds
d8WX+9nUHoqlrAGagO0Wow: raises $2 to $3
xAU6q2/cwmby2sxmA8VcmA: raises $9 to $12
4d1rWhpu8DzLmzMbR3QKyA: folds
JwCcjZl0bjJzG7hmE0dnTA: folds
d8WX+9nUHoqlrAGagO0Wow: calls $9
*** FLOP *** [3h 4s 7s]
d8WX+9nUHoqlrAGagO0Wow: checks
xAU6q2/cwmby2sxmA8VcmA: bets $11
d8WX+9nUHoqlrAGagO0Wow: calls $9.65 and is all-in
*** TURN *** [3h 4s 7s] [Qs]
*** RIVER *** [3h 4s 7s Qs] [9d]
*** SHOW DOWN ***
d8WX+9nUHoqlrAGagO0Wow: shows [Jh As] (high card Ace)
xAU6q2/cwmby2sxmA8VcmA: shows [5c 5h] (a pair of Fives)
xAU6q2/cwmby2sxmA8VcmA collected $42.65 from pot
*** SUMMARY ***
Total pot $44.80 | Rake $2.15
Board [3h 4s 7s Qs 9d]
Seat 1: 4d1rWhpu8DzLmzMbR3QKyA (small blind) folded before Flop
Seat 2: JwCcjZl0bjJzG7hmE0dnTA (big blind) folded before Flop
Seat 3: 8oS5O7iD/qnFXFXJrGIgNQ folded before Flop (didn't bet)
Seat 4: 1f3beyIML24UqEMTbWy93g folded before Flop (didn't bet)
Seat 5: d8WX+9nUHoqlrAGagO0Wow showed [Jh As] and lost with high card Ace
Seat 6: xAU6q2/cwmby2sxmA8VcmA (button) showed [5c 5h] and won ($42.65) with a pair of Fives



PokerStars Game #59941573764:  Hold'em No Limit ($0.50/$1.00) - 2009/07/01 1:39:34 ET
Table 'W/wyObTiXZm+Ckkl3YxcSw' 6-max Seat #3 is the button
Seat 1: eUBBn2R56C1IQ6Cs/vitwg ($175.55 in chips)
Seat 2: oDiBRCaF0QVtd3kO6xZIXw ($124.30 in chips)
Seat 3: 4OO5v3AVduL0tePNx8wk5A ($100 in chips)
Seat 4: UBZQqpnJZdTYYY1FTb0rLA ($155.70 in chips)
Seat 5: +OrCjyw70oZhJiD22Mn+bg ($202 in chips)
Seat 6: b2a+5TkFf4xJN/Ihhma58Q ($34.30 in chips)
UBZQqpnJZdTYYY1FTb0rLA: posts small blind $0.50
+OrCjyw70oZhJiD22Mn+bg: posts big blind $1
*** HOLE CARDS ***
b2a+5TkFf4xJN/Ihhma58Q: folds
eUBBn2R56C1IQ6Cs/vitwg: folds
oDiBRCaF0QVtd3kO6xZIXw: folds
4OO5v3AVduL0tePNx8wk5A: folds
UBZQqpnJZdTYYY1FTb0rLA: raises $2 to $3
+OrCjyw70oZhJiD22Mn+bg: folds
UBZQqpnJZdTYYY1FTb0rLA collected $2 from pot
UBZQqpnJZdTYYY1FTb0rLA: doesn't show hand
*** SUMMARY ***
Total pot $2 | Rake $0
Seat 1: eUBBn2R56C1IQ6Cs/vitwg folded before Flop (didn't bet)
Seat 2: oDiBRCaF0QVtd3kO6xZIXw folded before Flop (didn't bet)
Seat 3: 4OO5v3AVduL0tePNx8wk5A (button) folded before Flop (didn't bet)
Seat 4: UBZQqpnJZdTYYY1FTb0rLA (small blind) collected ($2)
Seat 5: +OrCjyw70oZhJiD22Mn+bg (big blind) folded before Flop
Seat 6: b2a+5TkFf4xJN/Ihhma58Q folded before Flop (didn't bet)



PokerStars Game #59941576278:  Hold'em No Limit ($0.50/$1.00) - 2009/07/01 1:39:38 ET
Table 'qj0HBN4HhQKogreu1bg7xg' 2-max Seat #2 is the button
Seat 1: NYi6JFscYNrofSXy4sM+Yw ($114.60 in chips)
Seat 2: qtyl8CSb0/4yWdbuEPJejA ($163.80 in chips)
qtyl8CSb0/4yWdbuEPJejA: posts small blind $0.50
NYi6JFscYNrofSXy4sM+Yw: posts big blind $1
*** HOLE CARDS ***
qtyl8CSb0/4yWdbuEPJejA: raises $2 to $3
NYi6JFscYNrofSXy4sM+Yw: calls $2
*** FLOP *** [2s Kc 9s]
NYi6JFscYNrofSXy4sM+Yw: checks
qtyl8CSb0/4yWdbuEPJejA: bets $4
NYi6JFscYNrofSXy4sM+Yw: calls $4
*** TURN *** [2s Kc 9s] [Td]
NYi6JFscYNrofSXy4sM+Yw: checks
qtyl8CSb0/4yWdbuEPJejA: checks
*** RIVER *** [2s Kc 9s Td] [6s]
NYi6JFscYNrofSXy4sM+Yw: bets $8.50
qtyl8CSb0/4yWdbuEPJejA: folds
NYi6JFscYNrofSXy4sM+Yw collected $13.50 from pot
*** SUMMARY ***
Total pot $14 | Rake $0.50
Board [2s Kc 9s Td 6s]
Seat 1: NYi6JFscYNrofSXy4sM+Yw (big blind) collected ($13.50)
Seat 2: qtyl8CSb0/4yWdbuEPJejA (button) (small blind) folded on the River



PokerStars Game #59941576106:  Hold'em No Limit ($0.50/$1.00) - 2009/07/01 1:39:38 ET
Table 'O96CPOtvMBWP6kzuYDfdFA' 6-max Seat #2 is the button
Seat 1: 6alLXQIITA2EZ/lBeym8Dw ($126.75 in chips)
Seat 2: 4d1rWhpu8DzLmzMbR3QKyA ($100 in chips)
Seat 4: /P4w1pHg2zHYg/4ubJ0dPw ($72.95 in chips)
Seat 5: vX+iYAEINFeLxwMla7DY1Q ($98.50 in chips)
Seat 6: 3syOXva630dm1FTdwnuLpw ($74.65 in chips)
V89DGjxE171oPREEbAXiyg was removed from the table for failing to post
/P4w1pHg2zHYg/4ubJ0dPw: posts small blind $0.50
vX+iYAEINFeLxwMla7DY1Q: posts big blind $1
*** HOLE CARDS ***
3syOXva630dm1FTdwnuLpw: folds
6alLXQIITA2EZ/lBeym8Dw: folds
4d1rWhpu8DzLmzMbR3QKyA: folds
/P4w1pHg2zHYg/4ubJ0dPw: folds
vX+iYAEINFeLxwMla7DY1Q collected $1 from pot
*** SUMMARY ***
Total pot $1 | Rake $0
Seat 1: 6alLXQIITA2EZ/lBeym8Dw folded before Flop (didn't bet)
Seat 2: 4d1rWhpu8DzLmzMbR3QKyA (button) folded before Flop (didn't bet)
Seat 4: /P4w1pHg2zHYg/4ubJ0dPw (small blind) folded before Flop
Seat 5: vX+iYAEINFeLxwMla7DY1Q (big blind) collected ($1)
Seat 6: 3syOXva630dm1FTdwnuLpw folded before Flop (didn't bet)



PokerStars Game #59941576434:  Hold'em No Limit ($0.50/$1.00) - 2009/07/01 1:39:39 ET
Table '/RZcOwpZpHQ+OwPwjsbnRw' 6-max Seat #6 is the button
Seat 1: +uSzP8Jwnw7sKfQ4s66b7w ($87.90 in chips)
Seat 2: Z2fXsGcjl+Eax+RzOgwOmg ($100 in chips)
Seat 3: LJMw/I77xpnw0R5T4HnMUg ($120.05 in chips)
Seat 4: j7NIOHLZk7V2o9fOioO5ug ($101 in chips)
Seat 5: wx3sQGkVi2x9wJXuWNHPBw ($164.25 in chips)
Seat 6: o3YLm/rSY916m/on1VjXPA ($205.50 in chips)
+uSzP8Jwnw7sKfQ4s66b7w: posts small blind $0.50
Z2fXsGcjl+Eax+RzOgwOmg: posts big blind $1
*** HOLE CARDS ***
LJMw/I77xpnw0R5T4HnMUg: folds
j7NIOHLZk7V2o9fOioO5ug: folds
wx3sQGkVi2x9wJXuWNHPBw: folds
o3YLm/rSY916m/on1VjXPA: folds
+uSzP8Jwnw7sKfQ4s66b7w: raises $3 to $4
Z2fXsGcjl+Eax+RzOgwOmg: folds
+uSzP8Jwnw7sKfQ4s66b7w collected $2 from pot
*** SUMMARY ***
Total pot $2 | Rake $0
Seat 1: +uSzP8Jwnw7sKfQ4s66b7w (small blind) collected ($2)
Seat 2: Z2fXsGcjl+Eax+RzOgwOmg (big blind) folded before Flop
Seat 3: LJMw/I77xpnw0R5T4HnMUg folded before Flop (didn't bet)
Seat 4: j7NIOHLZk7V2o9fOioO5ug folded before Flop (didn't bet)
Seat 5: wx3sQGkVi2x9wJXuWNHPBw folded before Flop (didn't bet)
Seat 6: o3YLm/rSY916m/on1VjXPA (button) folded before Flop (didn't bet)



PokerStars Game #59941577646:  Hold'em No Limit ($0.50/$1.00) - 2009/07/01 1:39:41 ET
Table 'NqGO/cV3MwFAx+ZPB5ANmQ' 2-max Seat #2 is the button
Seat 1: ItaRAnHOgvYOv5ynbG1iTw ($250.70 in chips)
Seat 2: GtFB+yyeb2djMdPFuOW/Xg ($100.50 in chips)
GtFB+yyeb2djMdPFuOW/Xg: posts small blind $0.50
ItaRAnHOgvYOv5ynbG1iTw: posts big blind $1
*** HOLE CARDS ***
GtFB+yyeb2djMdPFuOW/Xg: folds
ItaRAnHOgvYOv5ynbG1iTw collected $1 from pot
*** SUMMARY ***
Total pot $1 | Rake $0
Seat 1: ItaRAnHOgvYOv5ynbG1iTw (big blind) collected ($1)
Seat 2: GtFB+yyeb2djMdPFuOW/Xg (button) (small blind) folded before Flop



PokerStars Game #59941577990:  Hold'em No Limit ($0.50/$1.00) - 2009/07/01 1:39:42 ET
Table 'mmbQQVBTrPdE+wy+s+9VPA' 6-max Seat #6 is the button
Seat 1: zyP4SPoWZnKUfTvIRLCVog ($77.25 in chips)
Seat 2: XK4Qsl+DA8gAJyg85/zBIw ($26.50 in chips)
Seat 3: wx3sQGkVi2x9wJXuWNHPBw ($236.10 in chips)
Seat 4: V3iZdcw61nXF3g5hD2RrsQ ($100.05 in chips)
Seat 5: YMJG+F++3Aj6P8dAWda5fw ($130.70 in chips)
Seat 6: UOHYuj23MyK9R8ciY2t6FA ($100 in chips)
zyP4SPoWZnKUfTvIRLCVog: posts small blind $0.50
XK4Qsl+DA8gAJyg85/zBIw: posts big blind $1
*** HOLE CARDS ***
wx3sQGkVi2x9wJXuWNHPBw: raises $3 to $4
V3iZdcw61nXF3g5hD2RrsQ: folds
YMJG+F++3Aj6P8dAWda5fw: calls $4
UOHYuj23MyK9R8ciY2t6FA: folds
zyP4SPoWZnKUfTvIRLCVog: calls $3.50
XK4Qsl+DA8gAJyg85/zBIw: calls $3
*** FLOP *** [5d 3h Qc]
zyP4SPoWZnKUfTvIRLCVog: checks
XK4Qsl+DA8gAJyg85/zBIw: checks
wx3sQGkVi2x9wJXuWNHPBw: checks
YMJG+F++3Aj6P8dAWda5fw: checks
*** TURN *** [5d 3h Qc] [6h]
zyP4SPoWZnKUfTvIRLCVog: checks
XK4Qsl+DA8gAJyg85/zBIw: bets $22.50 and is all-in
wx3sQGkVi2x9wJXuWNHPBw: folds
YMJG+F++3Aj6P8dAWda5fw: folds
zyP4SPoWZnKUfTvIRLCVog: folds
XK4Qsl+DA8gAJyg85/zBIw collected $15.20 from pot
*** SUMMARY ***
Total pot $16 | Rake $0.80
Board [5d 3h Qc 6h]
Seat 1: zyP4SPoWZnKUfTvIRLCVog (small blind) folded on the Turn
Seat 2: XK4Qsl+DA8gAJyg85/zBIw (big blind) collected ($15.20)
Seat 3: wx3sQGkVi2x9wJXuWNHPBw folded on the Turn
Seat 4: V3iZdcw61nXF3g5hD2RrsQ folded before Flop (didn't bet)
Seat 5: YMJG+F++3Aj6P8dAWda5fw folded on the Turn
Seat 6: UOHYuj23MyK9R8ciY2t6FA (button) folded before Flop (didn't bet)



PokerStars Game #59941580314:  Hold'em No Limit ($0.50/$1.00) - 2009/07/01 1:39:46 ET
Table 'VOs36P6NW+QyXeQ1B62kmAE9S5sEoK9Q3olj2a53gABASeat #4 is the button
Seat 1: 4h8XtuVJtWh3DJpxGo7k5Q ($23.80 in chips)
Seat 2: y27w5IK2WXqmYzS8OU0wKA ($147.15 in chips)
Seat 3: p00KmyZiD/isPc/lZwNBTg ($15 in chips)
Seat 4: ene3nLSnQ4N961iBaUsSmA ($100 in chips)
Seat 5: o3YLm/rSY916m/on1VjXPA ($135.10 in chips)
Seat 6: slVKuQyEz8Qj4E3uLPYNXg ($50.10 in chips)
o3YLm/rSY916m/on1VjXPA: posts small blind $0.50
slVKuQyEz8Qj4E3uLPYNXg: posts big blind $1
*** HOLE CARDS ***
4h8XtuVJtWh3DJpxGo7k5Q: calls $1
y27w5IK2WXqmYzS8OU0wKA: folds
p00KmyZiD/isPc/lZwNBTg: calls $1
ene3nLSnQ4N961iBaUsSmA: folds
o3YLm/rSY916m/on1VjXPA: folds
slVKuQyEz8Qj4E3uLPYNXg: checks
*** FLOP *** [Th 3d Jd]
slVKuQyEz8Qj4E3uLPYNXg: bets $2
4h8XtuVJtWh3DJpxGo7k5Q: raises $6 to $8
p00KmyZiD/isPc/lZwNBTg: folds
slVKuQyEz8Qj4E3uLPYNXg: folds
4h8XtuVJtWh3DJpxGo7k5Q collected $7.15 from pot
4h8XtuVJtWh3DJpxGo7k5Q: doesn't show hand
*** SUMMARY ***
Total pot $7.50 | Rake $0.35
Board [Th 3d Jd]
Seat 1: 4h8XtuVJtWh3DJpxGo7k5Q collected ($7.15)
Seat 2: y27w5IK2WXqmYzS8OU0wKA folded before Flop (didn't bet)
Seat 3: p00KmyZiD/isPc/lZwNBTg folded on the Flop
Seat 4: ene3nLSnQ4N961iBaUsSmA (button) folded before Flop (didn't bet)
Seat 5: o3YLm/rSY916m/on1VjXPA (small blind) folded before Flop
Seat 6: slVKuQyEz8Qj4E3uLPYNXg (big blind) folded on the Flop



PokerStars Game #59941581050:  Hold'em No Limit ($0.50/$1.00) - 2009/07/01 1:39:47 ET
Table 'MUPc8FEpe/nR0BKSeReX6Q' 6-max Seat #1 is the button
Seat 1: qhkK6+yCciTRd+rCFEbnEQ ($79.10 in chips)
Seat 2: xAU6q2/cwmby2sxmA8VcmA ($102.70 in chips)
Seat 3: wx3sQGkVi2x9wJXuWNHPBw ($287.65 in chips)
Seat 4: r4lpoh2BJZ8S6zyQv1JeSw ($108.50 in chips)
Seat 5: y27w5IK2WXqmYzS8OU0wKA ($131.05 in chips)
xAU6q2/cwmby2sxmA8VcmA: posts small blind $0.50
wx3sQGkVi2x9wJXuWNHPBw: posts big blind $1
*** HOLE CARDS ***
cl/QpVR/PLO58lj+C5mGLw leaves the table
r4lpoh2BJZ8S6zyQv1JeSw: raises $2 to $3
y27w5IK2WXqmYzS8OU0wKA: folds
qhkK6+yCciTRd+rCFEbnEQ: folds
ene3nLSnQ4N961iBaUsSmA joins the table at seat #6
xAU6q2/cwmby2sxmA8VcmA: folds
wx3sQGkVi2x9wJXuWNHPBw: folds
r4lpoh2BJZ8S6zyQv1JeSw collected $2.50 from pot
r4lpoh2BJZ8S6zyQv1JeSw: doesn't show hand
*** SUMMARY ***
Total pot $2.50 | Rake $0
Seat 1: qhkK6+yCciTRd+rCFEbnEQ (button) folded before Flop (didn't bet)
Seat 2: xAU6q2/cwmby2sxmA8VcmA (small blind) folded before Flop
Seat 3: wx3sQGkVi2x9wJXuWNHPBw (big blind) folded before Flop
Seat 4: r4lpoh2BJZ8S6zyQv1JeSw collected ($2.50)
Seat 5: y27w5IK2WXqmYzS8OU0wKA folded before Flop (didn't bet)



PokerStars Game #59941581896:  Hold'em No Limit ($0.50/$1.00) - 2009/07/01 1:39:48 ET
Table 'fTlPiCj0utgzC/5io+I7ew' 6-max Seat #4 is the button
Seat 1: YMJG+F++3Aj6P8dAWda5fw ($100 in chips)
Seat 2: qVr1nl3dy2xXPqS8UpTDlA ($35.25 in chips)
Seat 3: Z2fXsGcjl+Eax+RzOgwOmg ($136.50 in chips)
Seat 4: uJVSceLggtsrJya+WtmUEA ($164.85 in chips)
Seat 5: XUk5GQsfNFpHvaToDZ0rZA ($44.55 in chips)
Seat 6: y27w5IK2WXqmYzS8OU0wKA ($100 in chips)
XUk5GQsfNFpHvaToDZ0rZA: posts small blind $0.50
y27w5IK2WXqmYzS8OU0wKA: posts big blind $1
*** HOLE CARDS ***
YMJG+F++3Aj6P8dAWda5fw: folds
qVr1nl3dy2xXPqS8UpTDlA: folds
Z2fXsGcjl+Eax+RzOgwOmg: folds
uJVSceLggtsrJya+WtmUEA: raises $2 to $3
XUk5GQsfNFpHvaToDZ0rZA: folds
y27w5IK2WXqmYzS8OU0wKA: folds
uJVSceLggtsrJya+WtmUEA collected $2.50 from pot
*** SUMMARY ***
Total pot $2.50 | Rake $0
Seat 1: YMJG+F++3Aj6P8dAWda5fw folded before Flop (didn't bet)
Seat 2: qVr1nl3dy2xXPqS8UpTDlA folded before Flop (didn't bet)
Seat 3: Z2fXsGcjl+Eax+RzOgwOmg folded before Flop (didn't bet)
Seat 4: uJVSceLggtsrJya+WtmUEA (button) collected ($2.50)
Seat 5: XUk5GQsfNFpHvaToDZ0rZA (small blind) folded before Flop
Seat 6: y27w5IK2WXqmYzS8OU0wKA (big blind) folded before Flop



PokerStars Game #59941582324:  Hold'em No Limit ($0.50/$1.00) - 2009/07/01 1:39:49 ET
Table 'fZjVbKj9D8yOB+Rj7NaP/A' 9-max Seat #8 is the button
Seat 2: PTAFYDIUSsG+SArbxNl+Aw ($104 in chips)
Seat 3: yAbu2QsRPVcjPbqlf/jDxw ($103.65 in chips)
Seat 4: 997ViqAtWn1FPjJqcffwcA ($100 in chips)
Seat 5: PkGfq5xrSlNsujKaG/HF4Q ($100 in chips)
Seat 6: OvwYHV65yUbgdBjSmo1+5g ($135.45 in chips)
Seat 7: SyS20PAm3RpT6uLBsGkwOA ($34.70 in chips)
Seat 8: EVvb0huXeMB7dnOAiO4ggA ($48.50 in chips)
Seat 9: qheQay5YvP2DMAb3OUSxtw ($145 in chips)
qheQay5YvP2DMAb3OUSxtw: posts small blind $0.50
PTAFYDIUSsG+SArbxNl+Aw: posts big blind $1
*** HOLE CARDS ***
yAbu2QsRPVcjPbqlf/jDxw: folds
997ViqAtWn1FPjJqcffwcA: folds
PkGfq5xrSlNsujKaG/HF4Q: folds
OvwYHV65yUbgdBjSmo1+5g: folds
SyS20PAm3RpT6uLBsGkwOA: folds
EVvb0huXeMB7dnOAiO4ggA: folds
qheQay5YvP2DMAb3OUSxtw: raises $3 to $4
PTAFYDIUSsG+SArbxNl+Aw: calls $3
*** FLOP *** [Td Kc 2c]
qheQay5YvP2DMAb3OUSxtw: bets $5
PTAFYDIUSsG+SArbxNl+Aw: folds
qheQay5YvP2DMAb3OUSxtw collected $7.60 from pot
qheQay5YvP2DMAb3OUSxtw: doesn't show hand
*** SUMMARY ***
Total pot $8 | Rake $0.40
Board [Td Kc 2c]
Seat 2: PTAFYDIUSsG+SArbxNl+Aw (big blind) folded on the Flop
Seat 3: yAbu2QsRPVcjPbqlf/jDxw folded before Flop (didn't bet)
Seat 4: 997ViqAtWn1FPjJqcffwcA folded before Flop (didn't bet)
Seat 5: PkGfq5xrSlNsujKaG/HF4Q folded before Flop (didn't bet)
Seat 6: OvwYHV65yUbgdBjSmo1+5g folded before Flop (didn't bet)
Seat 7: SyS20PAm3RpT6uLBsGkwOA folded before Flop (didn't bet)
Seat 8: EVvb0huXeMB7dnOAiO4ggA (button) folded before Flop (didn't bet)
Seat 9: qheQay5YvP2DMAb3OUSxtw (small blind) collected ($7.60)



PokerStars Game #59941582830:  Hold'em No Limit ($0.50/$1.00) - 2009/07/01 1:39:50 ET
Table 'NqGO/cV3MwFAx+ZPB5ANmQ' 2-max Seat #1 is the button
Seat 1: ItaRAnHOgvYOv5ynbG1iTw ($251.20 in chips)
Seat 2: GtFB+yyeb2djMdPFuOW/Xg ($100 in chips)
ItaRAnHOgvYOv5ynbG1iTw: posts small blind $0.50
GtFB+yyeb2djMdPFuOW/Xg: posts big blind $1
*** HOLE CARDS ***
ItaRAnHOgvYOv5ynbG1iTw: calls $0.50
GtFB+yyeb2djMdPFuOW/Xg: raises $4 to $5
ItaRAnHOgvYOv5ynbG1iTw: folds
GtFB+yyeb2djMdPFuOW/Xg collected $2 from pot
*** SUMMARY ***
Total pot $2 | Rake $0
Seat 1: ItaRAnHOgvYOv5ynbG1iTw (button) (small blind) folded before Flop
Seat 2: GtFB+yyeb2djMdPFuOW/Xg (big blind) collected ($2)



PokerStars Game #59941582614:  Hold'em No Limit ($0.50/$1.00) - 2009/07/01 1:39:50 ET
Table 'ebXZEgwgIhOgYayDkEzKQA' 2-max Seat #2 is the button
Seat 1: OMkHNxIUZxh1pHqcCjbjgw ($100 in chips)
Seat 2: UNpnKQk0gkkyFJen8upqag ($103 in chips)
UNpnKQk0gkkyFJen8upqag: posts small blind $0.50
OMkHNxIUZxh1pHqcCjbjgw: posts big blind $1
*** HOLE CARDS ***
UNpnKQk0gkkyFJen8upqag: folds
UNpnKQk0gkkyFJen8upqag is sitting out
UNpnKQk0gkkyFJen8upqag leaves the table
OMkHNxIUZxh1pHqcCjbjgw collected $1 from pot
OMkHNxIUZxh1pHqcCjbjgw: doesn't show hand
*** SUMMARY ***
Total pot $1 | Rake $0
Seat 1: OMkHNxIUZxh1pHqcCjbjgw (big blind) collected ($1)
Seat 2: UNpnKQk0gkkyFJen8upqag (button) (small blind) folded before Flop



PokerStars Game #59941582892:  Hold'em No Limit ($0.50/$1.00) - 2009/07/01 1:39:50 ET
Table 'SQLOQoANiHscJ8AL7zffbw' 9-max Seat #8 is the button
Seat 1: jPTRd6SpCp4xqAy2XQiTOw ($52.90 in chips)
Seat 2: /zy+DB4S5fUQUSfZWFzYGw ($388.65 in chips)
Seat 4: 5z1PAR8SNow/zUfYNbwq7A ($34.50 in chips)
Seat 5: L9njYvloJ1NdXjP8edHEAg ($119.70 in chips)
Seat 6: H+DVy3Ei8L1UKS2tVOtJcw ($100 in chips)
Seat 8: 9BZCcac3+McErkkSN2YScA ($104.50 in chips)
Seat 9: XE5QF1y74bpHog9JxWJMWQ ($107.20 in chips)
XE5QF1y74bpHog9JxWJMWQ: posts small blind $0.50
jPTRd6SpCp4xqAy2XQiTOw: posts big blind $1
*** HOLE CARDS ***
/zy+DB4S5fUQUSfZWFzYGw: folds
5z1PAR8SNow/zUfYNbwq7A: folds
L9njYvloJ1NdXjP8edHEAg: folds
H+DVy3Ei8L1UKS2tVOtJcw: folds
9BZCcac3+McErkkSN2YScA: folds
XE5QF1y74bpHog9JxWJMWQ: folds
jPTRd6SpCp4xqAy2XQiTOw collected $1 from pot
jPTRd6SpCp4xqAy2XQiTOw: doesn't show hand
*** SUMMARY ***
Total pot $1 | Rake $0
Seat 1: jPTRd6SpCp4xqAy2XQiTOw (big blind) collected ($1)
Seat 2: /zy+DB4S5fUQUSfZWFzYGw folded before Flop (didn't bet)
Seat 4: 5z1PAR8SNow/zUfYNbwq7A folded before Flop (didn't bet)
Seat 5: L9njYvloJ1NdXjP8edHEAg folded before Flop (didn't bet)
Seat 6: H+DVy3Ei8L1UKS2tVOtJcw folded before Flop (didn't bet)
Seat 8: 9BZCcac3+McErkkSN2YScA (button) folded before Flop (didn't bet)
Seat 9: XE5QF1y74bpHog9JxWJMWQ (small blind) folded before Flop



PokerStars Game #59941583362:  Hold'em No Limit ($0.50/$1.00) - 2009/07/01 1:39:51 ET
Table 'vs/5jr6ciwjVQ5+Soc+u2A' 6-max Seat #5 is the button
Seat 1: J798qwLuvXyq0BbzsIjOrA ($199.15 in chips)
Seat 2: lXX4W7m3u++JiSOZ46yVMQ ($100 in chips)
Seat 3: Ws/3Uo3rQIk8hLgW0P+2xA ($94.50 in chips)
Seat 4: 0smcry9L0OOTCP+KzIS5SA ($88 in chips)
Seat 5: +Nt3OPk3XR9SKjZgm2CexQ ($157.85 in chips)
Seat 6: Z2fXsGcjl+Eax+RzOgwOmg ($124.50 in chips)
Z2fXsGcjl+Eax+RzOgwOmg: posts small blind $0.50
J798qwLuvXyq0BbzsIjOrA: posts big blind $1
*** HOLE CARDS ***
lXX4W7m3u++JiSOZ46yVMQ: folds
Ws/3Uo3rQIk8hLgW0P+2xA: folds
0smcry9L0OOTCP+KzIS5SA: folds
+Nt3OPk3XR9SKjZgm2CexQ: folds
Z2fXsGcjl+Eax+RzOgwOmg: folds
J798qwLuvXyq0BbzsIjOrA collected $1 from pot
J798qwLuvXyq0BbzsIjOrA: doesn't show hand
*** SUMMARY ***
Total pot $1 | Rake $0
Seat 1: J798qwLuvXyq0BbzsIjOrA (big blind) collected ($1)
Seat 2: lXX4W7m3u++JiSOZ46yVMQ folded before Flop (didn't bet)
Seat 3: Ws/3Uo3rQIk8hLgW0P+2xA folded before Flop (didn't bet)
Seat 4: 0smcry9L0OOTCP+KzIS5SA folded before Flop (didn't bet)
Seat 5: +Nt3OPk3XR9SKjZgm2CexQ (button) folded before Flop (didn't bet)
Seat 6: Z2fXsGcjl+Eax+RzOgwOmg (small blind) folded before Flop



PokerStars Game #59941583812:  Hold'em No Limit ($0.50/$1.00) - 2009/07/01 1:39:52 ET
Table 'GxCPo/gd3OSthkYrAxJngg' 6-max Seat #2 is the button
Seat 1: sH8BpAFP+jGFxCgVpD1Lew ($229.55 in chips)
Seat 2: YExX2paeIHrmfIwV1ivM/w ($61.60 in chips)
Seat 3: idVgoPAdspFPCzee6aF9Pg ($135 in chips)
Seat 4: YMJG+F++3Aj6P8dAWda5fw ($205.35 in chips)
Seat 5: vX+iYAEINFeLxwMla7DY1Q ($98.50 in chips)
Seat 6: 4d1rWhpu8DzLmzMbR3QKyA ($106.55 in chips)
idVgoPAdspFPCzee6aF9Pg: posts small blind $0.50
YMJG+F++3Aj6P8dAWda5fw: posts big blind $1
*** HOLE CARDS ***
vX+iYAEINFeLxwMla7DY1Q: folds
4d1rWhpu8DzLmzMbR3QKyA: folds
sH8BpAFP+jGFxCgVpD1Lew: folds
YExX2paeIHrmfIwV1ivM/w: folds
idVgoPAdspFPCzee6aF9Pg: raises $2 to $3
YMJG+F++3Aj6P8dAWda5fw: folds
idVgoPAdspFPCzee6aF9Pg collected $2 from pot
*** SUMMARY ***
Total pot $2 | Rake $0
Seat 1: sH8BpAFP+jGFxCgVpD1Lew folded before Flop (didn't bet)
Seat 2: YExX2paeIHrmfIwV1ivM/w (button) folded before Flop (didn't bet)
Seat 3: idVgoPAdspFPCzee6aF9Pg (small blind) collected ($2)
Seat 4: YMJG+F++3Aj6P8dAWda5fw (big blind) folded before Flop
Seat 5: vX+iYAEINFeLxwMla7DY1Q folded before Flop (didn't bet)
Seat 6: 4d1rWhpu8DzLmzMbR3QKyA folded before Flop (didn't bet)



PokerStars Game #59941583880:  Hold'em No Limit ($0.50/$1.00) - 2009/07/01 1:39:52 ET
Table 'kS0cTQAEi+fdUlJP2gQYvw' 9-max Seat #7 is the button
Seat 1: SqsWPukL8kLqrhq5ZrQdSQ ($88 in chips)
Seat 2: +JautI/vSNALzwSvsOqbCQ ($78 in chips)
Seat 3: 2BV+oJIQYr65IO6nEChvbA ($62.55 in chips)
Seat 4: RUhhaALzha3TH1AkdakoGQ ($52.85 in chips)
Seat 5: 997ViqAtWn1FPjJqcffwcA ($100 in chips)
Seat 6: yAbu2QsRPVcjPbqlf/jDxw ($117.15 in chips)
Seat 7: Ffa7Nj4X5fddtROP01hfQg ($95.50 in chips)
Seat 8: vKyFzTyzfT7fZcdX+HHN+Q ($100.70 in chips)
Seat 9: OGgaARGdJQT4awWVNQ957w ($109.70 in chips)
vKyFzTyzfT7fZcdX+HHN+Q: posts small blind $0.50
OGgaARGdJQT4awWVNQ957w: posts big blind $1
*** HOLE CARDS ***
vKyFzTyzfT7fZcdX+HHN+Q said, "dnt get all cut up now"
SqsWPukL8kLqrhq5ZrQdSQ: calls $1
+JautI/vSNALzwSvsOqbCQ: folds
2BV+oJIQYr65IO6nEChvbA: folds
RUhhaALzha3TH1AkdakoGQ: calls $1
997ViqAtWn1FPjJqcffwcA: folds
yAbu2QsRPVcjPbqlf/jDxw: folds
Ffa7Nj4X5fddtROP01hfQg: folds
vKyFzTyzfT7fZcdX+HHN+Q: calls $0.50
OGgaARGdJQT4awWVNQ957w: checks
*** FLOP *** [5h Ad 2c]
RUhhaALzha3TH1AkdakoGQ said, "sama where did you learn those advance poker moves?"
vKyFzTyzfT7fZcdX+HHN+Q: checks
OGgaARGdJQT4awWVNQ957w: checks
SqsWPukL8kLqrhq5ZrQdSQ: checks
RUhhaALzha3TH1AkdakoGQ: checks
*** TURN *** [5h Ad 2c] [9s]
vKyFzTyzfT7fZcdX+HHN+Q: checks
Ffa7Nj4X5fddtROP01hfQg said, "i dont mind losing"
OGgaARGdJQT4awWVNQ957w: checks
SqsWPukL8kLqrhq5ZrQdSQ: checks
vKyFzTyzfT7fZcdX+HHN+Q said, "lolz go have a cry man i got ur chips n u aint gettin dem back lolz"
RUhhaALzha3TH1AkdakoGQ: checks
*** RIVER *** [5h Ad 2c 9s] [2s]
vKyFzTyzfT7fZcdX+HHN+Q: checks
Ffa7Nj4X5fddtROP01hfQg said, "but not ot such a douchebag play"
OGgaARGdJQT4awWVNQ957w: checks
SqsWPukL8kLqrhq5ZrQdSQ: checks
RUhhaALzha3TH1AkdakoGQ: checks
*** SHOW DOWN ***
vKyFzTyzfT7fZcdX+HHN+Q: shows [3h 8h] (a pair of Deuces)
OGgaARGdJQT4awWVNQ957w: shows [5c 4h] (two pair, Fives and Deuces)
SqsWPukL8kLqrhq5ZrQdSQ: mucks hand
RUhhaALzha3TH1AkdakoGQ: shows [6s 6d] (two pair, Sixes and Deuces)
RUhhaALzha3TH1AkdakoGQ collected $3.80 from pot
*** SUMMARY ***
Total pot $4 | Rake $0.20
Board [5h Ad 2c 9s 2s]
Seat 1: SqsWPukL8kLqrhq5ZrQdSQ mucked
Seat 2: +JautI/vSNALzwSvsOqbCQ folded before Flop (didn't bet)
Seat 3: 2BV+oJIQYr65IO6nEChvbA folded before Flop (didn't bet)
Seat 4: RUhhaALzha3TH1AkdakoGQ showed [6s 6d] and won ($3.80) with two pair, Sixes and Deuces
Seat 5: 997ViqAtWn1FPjJqcffwcA folded before Flop (didn't bet)
Seat 6: yAbu2QsRPVcjPbqlf/jDxw folded before Flop (didn't bet)
Seat 7: Ffa7Nj4X5fddtROP01hfQg (button) folded before Flop (didn't bet)
Seat 8: vKyFzTyzfT7fZcdX+HHN+Q (small blind) showed [3h 8h] and lost with a pair of Deuces
Seat 9: OGgaARGdJQT4awWVNQ957w (big blind) showed [5c 4h] and lost with two pair, Fives and Deuces



PokerStars Game #59941584076:  Hold'em No Limit ($0.50/$1.00) - 2009/07/01 1:39:52 ET
Table '+cA8mcmhaedZ7YcrDdhmeQ' 6-max Seat #3 is the button
Seat 2: 14aYclSc98EYd6TrzN2l3Q ($61.05 in chips)
Seat 3: DAIgyIWbYvAkL6PbAI27pg ($18.50 in chips)
Seat 4: 4OO5v3AVduL0tePNx8wk5A ($107.20 in chips)
Seat 5: SJieaES+gCAfonfNNMCP6w ($100 in chips)
Seat 6: YfsTQsY/fxb+YqbdclTHuw ($56.15 in chips)
4OO5v3AVduL0tePNx8wk5A: posts small blind $0.50
SJieaES+gCAfonfNNMCP6w: posts big blind $1
VB7TtBnfmT3JTA/cCL6dJg: sits out
*** HOLE CARDS ***
14aYclSc98EYd6TrzN2l3Q said, "i'm playing stars"
YfsTQsY/fxb+YqbdclTHuw: folds
14aYclSc98EYd6TrzN2l3Q: folds
DAIgyIWbYvAkL6PbAI27pg: folds
4OO5v3AVduL0tePNx8wk5A: raises $2 to $3
SJieaES+gCAfonfNNMCP6w: folds
4OO5v3AVduL0tePNx8wk5A collected $2 from pot
*** SUMMARY ***
Total pot $2 | Rake $0
Seat 2: 14aYclSc98EYd6TrzN2l3Q folded before Flop (didn't bet)
Seat 3: DAIgyIWbYvAkL6PbAI27pg (button) folded before Flop (didn't bet)
Seat 4: 4OO5v3AVduL0tePNx8wk5A (small blind) collected ($2)
Seat 5: SJieaES+gCAfonfNNMCP6w (big blind) folded before Flop
Seat 6: YfsTQsY/fxb+YqbdclTHuw folded before Flop (didn't bet)



PokerStars Game #59941584468:  Hold'em No Limit ($0.50/$1.00) - 2009/07/01 1:39:53 ET
Table 'N2bNCDHL96aCQDvZIh+yQQ' 6-max Seat #2 is the button
Seat 1: Jjgflx10PVjcLkziEmLhSA ($92.35 in chips)
Seat 2: y27w5IK2WXqmYzS8OU0wKA ($128.65 in chips)
Seat 3: UBZQqpnJZdTYYY1FTb0rLA ($121.05 in chips)
Seat 4: uCqEjnxh2/vFBjKYkfTOkw ($174.30 in chips)
Seat 6: idVgoPAdspFPCzee6aF9Pg ($107.40 in chips)
UBZQqpnJZdTYYY1FTb0rLA: posts small blind $0.50
uCqEjnxh2/vFBjKYkfTOkw: posts big blind $1
*** HOLE CARDS ***
idVgoPAdspFPCzee6aF9Pg: folds
Jjgflx10PVjcLkziEmLhSA: folds
y27w5IK2WXqmYzS8OU0wKA: folds
frvgHLr3+LfZtjsBCBs3NA leaves the table
UBZQqpnJZdTYYY1FTb0rLA: folds
uCqEjnxh2/vFBjKYkfTOkw collected $1 from pot
uCqEjnxh2/vFBjKYkfTOkw: doesn't show hand
*** SUMMARY ***
Total pot $1 | Rake $0
Seat 1: Jjgflx10PVjcLkziEmLhSA folded before Flop (didn't bet)
Seat 2: y27w5IK2WXqmYzS8OU0wKA (button) folded before Flop (didn't bet)
Seat 3: UBZQqpnJZdTYYY1FTb0rLA (small blind) folded before Flop
Seat 4: uCqEjnxh2/vFBjKYkfTOkw (big blind) collected ($1)
Seat 6: idVgoPAdspFPCzee6aF9Pg folded before Flop (didn't bet)



PokerStars Game #59941584254:  Hold'em No Limit ($0.50/$1.00) - 2009/07/01 1:39:53 ET
Table 'b8oW/dOL7fDza5DfZ/dOJQ' 6-max Seat #4 is the button
Seat 1: NakujTNjHFgzceydFf+E2Q ($57.50 in chips)
Seat 2: TSuRyAHnUPCFjP7Z0rEE0w ($119 in chips)
Seat 3: d8WX+9nUHoqlrAGagO0Wow ($34.30 in chips)
Seat 4: 8rDbzImSi1zgxtqtF1pSbA ($12.50 in chips)
Seat 5: sr/OkkgqNbtgwJf1tmnfNg ($59 in chips)
Seat 6: PvfYaKbzMpsmUcbOExckbQ ($154.95 in chips)
sr/OkkgqNbtgwJf1tmnfNg: posts small blind $0.50
PvfYaKbzMpsmUcbOExckbQ: posts big blind $1
*** HOLE CARDS ***
NakujTNjHFgzceydFf+E2Q: calls $1
TSuRyAHnUPCFjP7Z0rEE0w: folds
d8WX+9nUHoqlrAGagO0Wow: folds
8rDbzImSi1zgxtqtF1pSbA: calls $1
sr/OkkgqNbtgwJf1tmnfNg: folds
PvfYaKbzMpsmUcbOExckbQ: raises $4.50 to $5.50
NakujTNjHFgzceydFf+E2Q: calls $4.50
8rDbzImSi1zgxtqtF1pSbA: folds
*** FLOP *** [Td 7d 5c]
PvfYaKbzMpsmUcbOExckbQ: bets $7
NakujTNjHFgzceydFf+E2Q: folds
PvfYaKbzMpsmUcbOExckbQ collected $11.90 from pot
PvfYaKbzMpsmUcbOExckbQ: doesn't show hand
*** SUMMARY ***
Total pot $12.50 | Rake $0.60
Board [Td 7d 5c]
Seat 1: NakujTNjHFgzceydFf+E2Q folded on the Flop
Seat 2: TSuRyAHnUPCFjP7Z0rEE0w folded before Flop (didn't bet)
Seat 3: d8WX+9nUHoqlrAGagO0Wow folded before Flop (didn't bet)
Seat 4: 8rDbzImSi1zgxtqtF1pSbA (button) folded before Flop
Seat 5: sr/OkkgqNbtgwJf1tmnfNg (small blind) folded before Flop
Seat 6: PvfYaKbzMpsmUcbOExckbQ (big blind) collected ($11.90)



PokerStars Game #59941586284:  Hold'em No Limit ($0.50/$1.00) - 2009/07/01 1:39:56 ET
Table 'O96CPOtvMBWP6kzuYDfdFA' 6-max Seat #4 is the button
Seat 1: 6alLXQIITA2EZ/lBeym8Dw ($126.75 in chips)
Seat 2: 4d1rWhpu8DzLmzMbR3QKyA ($100 in chips)
Seat 4: /P4w1pHg2zHYg/4ubJ0dPw ($72.45 in chips)
Seat 5: vX+iYAEINFeLxwMla7DY1Q ($99 in chips)
Seat 6: 3syOXva630dm1FTdwnuLpw ($74.65 in chips)
vX+iYAEINFeLxwMla7DY1Q: posts small blind $0.50
3syOXva630dm1FTdwnuLpw: posts big blind $1
*** HOLE CARDS ***
6alLXQIITA2EZ/lBeym8Dw: folds
4d1rWhpu8DzLmzMbR3QKyA: folds
/P4w1pHg2zHYg/4ubJ0dPw: raises $2 to $3
vX+iYAEINFeLxwMla7DY1Q: folds
3syOXva630dm1FTdwnuLpw: raises $4 to $7
/P4w1pHg2zHYg/4ubJ0dPw: folds
3syOXva630dm1FTdwnuLpw collected $6.50 from pot
*** SUMMARY ***
Total pot $6.50 | Rake $0
Seat 1: 6alLXQIITA2EZ/lBeym8Dw folded before Flop (didn't bet)
Seat 2: 4d1rWhpu8DzLmzMbR3QKyA folded before Flop (didn't bet)
Seat 4: /P4w1pHg2zHYg/4ubJ0dPw (button) folded before Flop
Seat 5: vX+iYAEINFeLxwMla7DY1Q (small blind) folded before Flop
Seat 6: 3syOXva630dm1FTdwnuLpw (big blind) collected ($6.50)



PokerStars Game #59941586810:  Hold'em No Limit ($0.50/$1.00) - 2009/07/01 1:39:57 ET
Table 'rmZfTK+oSebeUPJNbWhdAA' 6-max Seat #4 is the button
Seat 1: xAU6q2/cwmby2sxmA8VcmA ($131.50 in chips)
Seat 2: z7O9PO/WEcqRouIydFhS9Q ($188 in chips)
Seat 3: BCEV3COoKY607AzLWayfRA ($218.70 in chips)
Seat 4: 1/mIuXfgx1ZyVkodrmfQDw ($168.15 in chips)
Seat 6: j7NIOHLZk7V2o9fOioO5ug ($102.70 in chips)
UOHYuj23MyK9R8ciY2t6FA will be allowed to play after the button
j7NIOHLZk7V2o9fOioO5ug: posts small blind $0.50
xAU6q2/cwmby2sxmA8VcmA: posts big blind $1
*** HOLE CARDS ***
z7O9PO/WEcqRouIydFhS9Q: folds
BCEV3COoKY607AzLWayfRA: folds
1/mIuXfgx1ZyVkodrmfQDw: raises $2 to $3
j7NIOHLZk7V2o9fOioO5ug: folds
xAU6q2/cwmby2sxmA8VcmA: raises $9 to $12
1/mIuXfgx1ZyVkodrmfQDw: folds
xAU6q2/cwmby2sxmA8VcmA collected $6.50 from pot
xAU6q2/cwmby2sxmA8VcmA: doesn't show hand
*** SUMMARY ***
Total pot $6.50 | Rake $0
Seat 1: xAU6q2/cwmby2sxmA8VcmA (big blind) collected ($6.50)
Seat 2: z7O9PO/WEcqRouIydFhS9Q folded before Flop (didn't bet)
Seat 3: BCEV3COoKY607AzLWayfRA folded before Flop (didn't bet)
Seat 4: 1/mIuXfgx1ZyVkodrmfQDw (button) folded before Flop
Seat 6: j7NIOHLZk7V2o9fOioO5ug (small blind) folded before Flop



PokerStars Game #59941586642:  Hold'em No Limit ($0.50/$1.00) - 2009/07/01 1:39:57 ET
Table 'blHlQApStil0OPeQxQxPcw' 9-max Seat #5 is the button
Seat 1: Pp/KTcXkfZKKUHkjyaLTdg ($24.10 in chips)
Seat 2: V138SURkdX8LdVBPKdJJag ($122.85 in chips)
Seat 3: OGgaARGdJQT4awWVNQ957w ($100 in chips)
Seat 4: 1862487932 ($100.65 in chips)
Seat 5: uXrDE6JrIi8BZK1L8oQ9bQ ($38.10 in chips)
Seat 6: vljeiOoWscAIXU0fCuiEBw ($49.15 in chips)
Seat 7: VPF+HjszMvUIpy0CHIwH3A ($20 in chips)
Seat 8: laA8va+Yv8WuMqT1zdR91g ($100 in chips)
Seat 9: 6XkTu4ahxzHnvjjc1R8YjQ ($155.35 in chips)
vljeiOoWscAIXU0fCuiEBw: posts small blind $0.50
uXrDE6JrIi8BZK1L8oQ9bQ said, "idiot"
VPF+HjszMvUIpy0CHIwH3A: posts big blind $1
*** HOLE CARDS ***
laA8va+Yv8WuMqT1zdR91g: folds
6XkTu4ahxzHnvjjc1R8YjQ: folds
uXrDE6JrIi8BZK1L8oQ9bQ said, "you call everything"
Pp/KTcXkfZKKUHkjyaLTdg: folds
V138SURkdX8LdVBPKdJJag: folds
OGgaARGdJQT4awWVNQ957w: folds
1862487932: raises $2.50 to $3.50
uXrDE6JrIi8BZK1L8oQ9bQ: folds
vljeiOoWscAIXU0fCuiEBw: folds
VPF+HjszMvUIpy0CHIwH3A: folds
1862487932 collected $2.50 from pot
1862487932: doesn't show hand
*** SUMMARY ***
Total pot $2.50 | Rake $0
Seat 1: Pp/KTcXkfZKKUHkjyaLTdg folded before Flop (didn't bet)
Seat 2: V138SURkdX8LdVBPKdJJag folded before Flop (didn't bet)
Seat 3: OGgaARGdJQT4awWVNQ957w folded before Flop (didn't bet)
Seat 4: 1862487932 collected ($2.50)
Seat 5: uXrDE6JrIi8BZK1L8oQ9bQ (button) folded before Flop (didn't bet)
Seat 6: vljeiOoWscAIXU0fCuiEBw (small blind) folded before Flop
Seat 7: VPF+HjszMvUIpy0CHIwH3A (big blind) folded before Flop
Seat 8: laA8va+Yv8WuMqT1zdR91g folded before Flop (didn't bet)
Seat 9: 6XkTu4ahxzHnvjjc1R8YjQ folded before Flop (didn't bet)



PokerStars Game #59941587924:  Hold'em No Limit ($0.50/$1.00) - 2009/07/01 1:39:59 ET
Table 'qj0HBN4HhQKogreu1bg7xg' 2-max Seat #1 is the button
Seat 1: NYi6JFscYNrofSXy4sM+Yw ($121.10 in chips)
Seat 2: qtyl8CSb0/4yWdbuEPJejA ($156.80 in chips)
NYi6JFscYNrofSXy4sM+Yw: posts small blind $0.50
qtyl8CSb0/4yWdbuEPJejA: posts big blind $1
*** HOLE CARDS ***
NYi6JFscYNrofSXy4sM+Yw: raises $2 to $3
qtyl8CSb0/4yWdbuEPJejA: raises $6 to $9
NYi6JFscYNrofSXy4sM+Yw: folds
qtyl8CSb0/4yWdbuEPJejA collected $6 from pot
qtyl8CSb0/4yWdbuEPJejA: doesn't show hand
*** SUMMARY ***
Total pot $6 | Rake $0
Seat 1: NYi6JFscYNrofSXy4sM+Yw (button) (small blind) folded before Flop
Seat 2: qtyl8CSb0/4yWdbuEPJejA (big blind) collected ($6)



PokerStars Game #59941587952:  Hold'em No Limit ($0.50/$1.00) - 2009/07/01 1:39:59 ET
Table 'tJq9SfN1ywY0r03VBlWlwQ' 9-max Seat #6 is the button
Seat 1: wZsU+w9r7G66x93UuvBf1Q ($300.05 in chips)
Seat 2: VPF+HjszMvUIpy0CHIwH3A ($18.50 in chips)
Seat 4: bLbSOSmSOnqE0iTcH/5dxA ($118.20 in chips)
Seat 5: h5ipsNTMyolp7xn/NAvWkA ($128.80 in chips)
Seat 6: gUUvmqdVlmvpal6B8nYrmg ($103.10 in chips)
Seat 7: Ogn4JDV3mp4ZDKO49IFzKA ($18.90 in chips)
Seat 8: G4DEhsZFmznGNVpy2SEocA ($40.80 in chips)
Seat 9: XE5QF1y74bpHog9JxWJMWQ ($100 in chips)
Ogn4JDV3mp4ZDKO49IFzKA: posts small blind $0.50
G4DEhsZFmznGNVpy2SEocA: posts big blind $1
*** HOLE CARDS ***
XE5QF1y74bpHog9JxWJMWQ: folds
wZsU+w9r7G66x93UuvBf1Q: folds
VPF+HjszMvUIpy0CHIwH3A: folds
bLbSOSmSOnqE0iTcH/5dxA: folds
h5ipsNTMyolp7xn/NAvWkA: raises $3 to $4
gUUvmqdVlmvpal6B8nYrmg: raises $9 to $13
Ogn4JDV3mp4ZDKO49IFzKA: folds
G4DEhsZFmznGNVpy2SEocA: folds
h5ipsNTMyolp7xn/NAvWkA: folds
gUUvmqdVlmvpal6B8nYrmg collected $9.50 from pot
*** SUMMARY ***
Total pot $9.50 | Rake $0
Seat 1: wZsU+w9r7G66x93UuvBf1Q folded before Flop (didn't bet)
Seat 2: VPF+HjszMvUIpy0CHIwH3A folded before Flop (didn't bet)
Seat 4: bLbSOSmSOnqE0iTcH/5dxA folded before Flop (didn't bet)
Seat 5: h5ipsNTMyolp7xn/NAvWkA folded before Flop
Seat 6: gUUvmqdVlmvpal6B8nYrmg (button) collected ($9.50)
Seat 7: Ogn4JDV3mp4ZDKO49IFzKA (small blind) folded before Flop
Seat 8: G4DEhsZFmznGNVpy2SEocA (big blind) folded before Flop
Seat 9: XE5QF1y74bpHog9JxWJMWQ folded before Flop (didn't bet)



PokerStars Game #59941588546:  Hold'em No Limit ($0.50/$1.00) - 2009/07/01 1:40:00 ET
Table 'hugOjcwJvzEwZbK7tyiWuQ' 9-max Seat #1 is the button
Seat 1: S3Ex8K7v6xm5jqjRM7Fl3w ($22.35 in chips)
Seat 2: r27C1nIV4NS4+qbnrgBQSw ($275.60 in chips)
Seat 3: c/6hFCyfLNRn3VFvCeQ1ng ($36.55 in chips)
Seat 4: UWB3oeddt/GObx2Mix2Anw ($159.45 in chips)
Seat 5: AexZ4puUV9meFWwVU6Nv0w ($31.70 in chips)
Seat 6: gUUvmqdVlmvpal6B8nYrmg ($103.95 in chips)
Seat 7: FL3MrLspcF23LYvC4ipBOA ($109.80 in chips)
Seat 8: /zy+DB4S5fUQUSfZWFzYGw ($122.55 in chips)
Seat 9: W8P9bUKCs43TO1xHm0dL6w ($105.30 in chips)
r27C1nIV4NS4+qbnrgBQSw: posts small blind $0.50
c/6hFCyfLNRn3VFvCeQ1ng: posts big blind $1
*** HOLE CARDS ***
UWB3oeddt/GObx2Mix2Anw: raises $2 to $3
AexZ4puUV9meFWwVU6Nv0w: calls $3
gUUvmqdVlmvpal6B8nYrmg: folds
FL3MrLspcF23LYvC4ipBOA: folds
/zy+DB4S5fUQUSfZWFzYGw: folds
W8P9bUKCs43TO1xHm0dL6w: folds
S3Ex8K7v6xm5jqjRM7Fl3w: folds
r27C1nIV4NS4+qbnrgBQSw: folds
c/6hFCyfLNRn3VFvCeQ1ng: calls $2
*** FLOP *** [Ks Ad 3h]
c/6hFCyfLNRn3VFvCeQ1ng: bets $1
UWB3oeddt/GObx2Mix2Anw: calls $1
AexZ4puUV9meFWwVU6Nv0w: calls $1
*** TURN *** [Ks Ad 3h] [2d]
c/6hFCyfLNRn3VFvCeQ1ng: checks
UWB3oeddt/GObx2Mix2Anw: checks
AexZ4puUV9meFWwVU6Nv0w: bets $5
c/6hFCyfLNRn3VFvCeQ1ng: folds
UWB3oeddt/GObx2Mix2Anw: calls $5
*** RIVER *** [Ks Ad 3h 2d] [4d]
UWB3oeddt/GObx2Mix2Anw: checks
AexZ4puUV9meFWwVU6Nv0w: bets $10
UWB3oeddt/GObx2Mix2Anw: raises $16 to $26
AexZ4puUV9meFWwVU6Nv0w: folds
UWB3oeddt/GObx2Mix2Anw collected $40.45 from pot
*** SUMMARY ***
Total pot $42.50 | Rake $2.05
Board [Ks Ad 3h 2d 4d]
Seat 1: S3Ex8K7v6xm5jqjRM7Fl3w (button) folded before Flop (didn't bet)
Seat 2: r27C1nIV4NS4+qbnrgBQSw (small blind) folded before Flop
Seat 3: c/6hFCyfLNRn3VFvCeQ1ng (big blind) folded on the Turn
Seat 4: UWB3oeddt/GObx2Mix2Anw collected ($40.45)
Seat 5: AexZ4puUV9meFWwVU6Nv0w folded on the River
Seat 6: gUUvmqdVlmvpal6B8nYrmg folded before Flop (didn't bet)
Seat 7: FL3MrLspcF23LYvC4ipBOA folded before Flop (didn't bet)
Seat 8: /zy+DB4S5fUQUSfZWFzYGw folded before Flop (didn't bet)
Seat 9: W8P9bUKCs43TO1xHm0dL6w folded before Flop (didn't bet)



PokerStars Game #59941590460:  Hold'em No Limit ($0.50/$1.00) - 2009/07/01 1:40:04 ET
Table '7O9fB8yx1u7sJveJn8w6jA' 6-max Seat #4 is the button
Seat 1: 841740 ($44.30 in chips)
Seat 2: wx3sQGkVi2x9wJXuWNHPBw ($206.85 in chips)
Seat 3: hpxXcmRkXXI9HE5+5/j/0Q ($138.65 in chips)
Seat 4: b2a+5TkFf4xJN/Ihhma58Q ($30.35 in chips)
Seat 5: BCEV3COoKY607AzLWayfRA ($100 in chips)
Seat 6: r4lpoh2BJZ8S6zyQv1JeSw ($107.75 in chips)
BCEV3COoKY607AzLWayfRA: posts small blind $0.50
r4lpoh2BJZ8S6zyQv1JeSw: posts big blind $1
*** HOLE CARDS ***
841740: folds
wx3sQGkVi2x9wJXuWNHPBw: folds
hpxXcmRkXXI9HE5+5/j/0Q: folds
b2a+5TkFf4xJN/Ihhma58Q: folds
BCEV3COoKY607AzLWayfRA: raises $3 to $4
r4lpoh2BJZ8S6zyQv1JeSw: folds
BCEV3COoKY607AzLWayfRA collected $2 from pot
BCEV3COoKY607AzLWayfRA: doesn't show hand
*** SUMMARY ***
Total pot $2 | Rake $0
Seat 1: 841740 folded before Flop (didn't bet)
Seat 2: wx3sQGkVi2x9wJXuWNHPBw folded before Flop (didn't bet)
Seat 3: hpxXcmRkXXI9HE5+5/j/0Q folded before Flop (didn't bet)
Seat 4: b2a+5TkFf4xJN/Ihhma58Q (button) folded before Flop (didn't bet)
Seat 5: BCEV3COoKY607AzLWayfRA (small blind) collected ($2)
Seat 6: r4lpoh2BJZ8S6zyQv1JeSw (big blind) folded before Flop



PokerStars Game #59941590912:  Hold'em No Limit ($0.50/$1.00) - 2009/07/01 1:40:05 ET
Table 'NqGO/cV3MwFAx+ZPB5ANmQ' 2-max Seat #2 is the button
Seat 1: ItaRAnHOgvYOv5ynbG1iTw ($250.20 in chips)
Seat 2: GtFB+yyeb2djMdPFuOW/Xg ($101 in chips)
GtFB+yyeb2djMdPFuOW/Xg: posts small blind $0.50
ItaRAnHOgvYOv5ynbG1iTw: posts big blind $1
*** HOLE CARDS ***
GtFB+yyeb2djMdPFuOW/Xg: folds
ItaRAnHOgvYOv5ynbG1iTw collected $1 from pot
*** SUMMARY ***
Total pot $1 | Rake $0
Seat 1: ItaRAnHOgvYOv5ynbG1iTw (big blind) collected ($1)
Seat 2: GtFB+yyeb2djMdPFuOW/Xg (button) (small blind) folded before Flop



PokerStars Game #59941591384:  Hold'em No Limit ($0.50/$1.00) - 2009/07/01 1:40:05 ET
Table 'CASNP0uy1C+jGLml/I4PtA' 9-max Seat #5 is the button
Seat 1: tkdBeXTJlFsZdioidNqLow ($70.60 in chips)
Seat 2: Ogn4JDV3mp4ZDKO49IFzKA ($23.85 in chips)
Seat 5: Jjc7EHWzs4//xUAjJ0UWoA ($10 in chips)
Seat 6: FJEywSpo5JbRKByzmweboA ($130.40 in chips)
Seat 7: S3Ex8K7v6xm5jqjRM7Fl3w ($39.95 in chips)
Seat 8: L9njYvloJ1NdXjP8edHEAg ($102.95 in chips)
Seat 9: Pp/KTcXkfZKKUHkjyaLTdg ($22.60 in chips)
FJEywSpo5JbRKByzmweboA: posts small blind $0.50
S3Ex8K7v6xm5jqjRM7Fl3w: posts big blind $1
*** HOLE CARDS ***
L9njYvloJ1NdXjP8edHEAg: folds
Pp/KTcXkfZKKUHkjyaLTdg: folds
tkdBeXTJlFsZdioidNqLow: folds
Ogn4JDV3mp4ZDKO49IFzKA: folds
Jjc7EHWzs4//xUAjJ0UWoA: raises $2 to $3
B/G0GJacqZ8K59/ZVdq4kQ is disconnected
FJEywSpo5JbRKByzmweboA: folds
S3Ex8K7v6xm5jqjRM7Fl3w: raises $4 to $7
Jjc7EHWzs4//xUAjJ0UWoA: raises $3 to $10 and is all-in
S3Ex8K7v6xm5jqjRM7Fl3w: calls $3
*** FLOP *** [Qc 4s 4d]
*** TURN *** [Qc 4s 4d] [6c]
*** RIVER *** [Qc 4s 4d 6c] [9s]
*** SHOW DOWN ***
S3Ex8K7v6xm5jqjRM7Fl3w: shows [Ad Qs] (two pair, Queens and Fours)
Jjc7EHWzs4//xUAjJ0UWoA: mucks hand
B/G0GJacqZ8K59/ZVdq4kQ is connected
S3Ex8K7v6xm5jqjRM7Fl3w collected $19.50 from pot
*** SUMMARY ***
Total pot $20.50 | Rake $1
Board [Qc 4s 4d 6c 9s]
Seat 1: tkdBeXTJlFsZdioidNqLow folded before Flop (didn't bet)
Seat 2: Ogn4JDV3mp4ZDKO49IFzKA folded before Flop (didn't bet)
Seat 5: Jjc7EHWzs4//xUAjJ0UWoA (button) mucked
Seat 6: FJEywSpo5JbRKByzmweboA (small blind) folded before Flop
Seat 7: S3Ex8K7v6xm5jqjRM7Fl3w (big blind) showed [Ad Qs] and won ($19.50) with two pair, Queens and Fours
Seat 8: L9njYvloJ1NdXjP8edHEAg folded before Flop (didn't bet)
Seat 9: Pp/KTcXkfZKKUHkjyaLTdg folded before Flop (didn't bet)



PokerStars Game #59941591822:  Hold'em No Limit ($0.50/$1.00) - 2009/07/01 1:40:06 ET
Table '/RZcOwpZpHQ+OwPwjsbnRw' 6-max Seat #1 is the button
Seat 1: +uSzP8Jwnw7sKfQ4s66b7w ($88.90 in chips)
Seat 2: Z2fXsGcjl+Eax+RzOgwOmg ($100 in chips)
Seat 3: LJMw/I77xpnw0R5T4HnMUg ($120.05 in chips)
Seat 4: j7NIOHLZk7V2o9fOioO5ug ($101 in chips)
Seat 5: wx3sQGkVi2x9wJXuWNHPBw ($164.25 in chips)
Seat 6: o3YLm/rSY916m/on1VjXPA ($205.50 in chips)
Z2fXsGcjl+Eax+RzOgwOmg: posts small blind $0.50
LJMw/I77xpnw0R5T4HnMUg: posts big blind $1
*** HOLE CARDS ***
j7NIOHLZk7V2o9fOioO5ug: raises $2 to $3
wx3sQGkVi2x9wJXuWNHPBw: folds
o3YLm/rSY916m/on1VjXPA: folds
+uSzP8Jwnw7sKfQ4s66b7w: folds
Z2fXsGcjl+Eax+RzOgwOmg: folds
LJMw/I77xpnw0R5T4HnMUg: calls $2
*** FLOP *** [Js 3c 5c]
LJMw/I77xpnw0R5T4HnMUg: checks
j7NIOHLZk7V2o9fOioO5ug: bets $5
LJMw/I77xpnw0R5T4HnMUg: raises $5 to $10
j7NIOHLZk7V2o9fOioO5ug: raises $15 to $25
LJMw/I77xpnw0R5T4HnMUg: folds
j7NIOHLZk7V2o9fOioO5ug collected $25.20 from pot
j7NIOHLZk7V2o9fOioO5ug: doesn't show hand
*** SUMMARY ***
Total pot $26.50 | Rake $1.30
Board [Js 3c 5c]
Seat 1: +uSzP8Jwnw7sKfQ4s66b7w (button) folded before Flop (didn't bet)
Seat 2: Z2fXsGcjl+Eax+RzOgwOmg (small blind) folded before Flop
Seat 3: LJMw/I77xpnw0R5T4HnMUg (big blind) folded on the Flop
Seat 4: j7NIOHLZk7V2o9fOioO5ug collected ($25.20)
Seat 5: wx3sQGkVi2x9wJXuWNHPBw folded before Flop (didn't bet)
Seat 6: o3YLm/rSY916m/on1VjXPA folded before Flop (didn't bet)



PokerStars Game #59941591440:  Hold'em No Limit ($0.50/$1.00) - 2009/07/01 1:40:06 ET
Table 'W/wyObTiXZm+Ckkl3YxcSw' 6-max Seat #4 is the button
Seat 1: eUBBn2R56C1IQ6Cs/vitwg ($175.55 in chips)
Seat 2: oDiBRCaF0QVtd3kO6xZIXw ($124.30 in chips)
Seat 3: 4OO5v3AVduL0tePNx8wk5A ($100 in chips)
Seat 4: UBZQqpnJZdTYYY1FTb0rLA ($156.70 in chips)
Seat 5: +OrCjyw70oZhJiD22Mn+bg ($201 in chips)
Seat 6: b2a+5TkFf4xJN/Ihhma58Q ($34.30 in chips)
+OrCjyw70oZhJiD22Mn+bg: posts small blind $0.50
b2a+5TkFf4xJN/Ihhma58Q: posts big blind $1
*** HOLE CARDS ***
eUBBn2R56C1IQ6Cs/vitwg: folds
oDiBRCaF0QVtd3kO6xZIXw: folds
4OO5v3AVduL0tePNx8wk5A: folds
UBZQqpnJZdTYYY1FTb0rLA: raises $2 to $3
+OrCjyw70oZhJiD22Mn+bg: folds
b2a+5TkFf4xJN/Ihhma58Q: folds
UBZQqpnJZdTYYY1FTb0rLA collected $2.50 from pot
UBZQqpnJZdTYYY1FTb0rLA: doesn't show hand
*** SUMMARY ***
Total pot $2.50 | Rake $0
Seat 1: eUBBn2R56C1IQ6Cs/vitwg folded before Flop (didn't bet)
Seat 2: oDiBRCaF0QVtd3kO6xZIXw folded before Flop (didn't bet)
Seat 3: 4OO5v3AVduL0tePNx8wk5A folded before Flop (didn't bet)
Seat 4: UBZQqpnJZdTYYY1FTb0rLA (button) collected ($2.50)
Seat 5: +OrCjyw70oZhJiD22Mn+bg (small blind) folded before Flop
Seat 6: b2a+5TkFf4xJN/Ihhma58Q (big blind) folded before Flop



PokerStars Game #59941591972:  Hold'em No Limit ($0.50/$1.00) - 2009/07/01 1:40:06 ET
Table '305hiksPPCCdC6V2LNsO5w' 6-max Seat #2 is the button
Seat 1: RTuDLJHh/9zPfBftoc9vsw ($8.25 in chips)
Seat 2: j7NIOHLZk7V2o9fOioO5ug ($157.70 in chips)
Seat 3: +zIVjZKLpcidfRHgVZW8lA ($29 in chips)
Seat 4: uJVSceLggtsrJya+WtmUEA ($203.80 in chips)
Seat 5: +Nt3OPk3XR9SKjZgm2CexQ ($100 in chips)
Seat 6: 9/Tq8dw7kWW68uN8bFupXg ($18.95 in chips)
+zIVjZKLpcidfRHgVZW8lA: posts small blind $0.50
uJVSceLggtsrJya+WtmUEA: posts big blind $1
*** HOLE CARDS ***
+Nt3OPk3XR9SKjZgm2CexQ: folds
9/Tq8dw7kWW68uN8bFupXg: folds
RTuDLJHh/9zPfBftoc9vsw: folds
j7NIOHLZk7V2o9fOioO5ug: raises $2 to $3
+zIVjZKLpcidfRHgVZW8lA: folds
uJVSceLggtsrJya+WtmUEA: folds
j7NIOHLZk7V2o9fOioO5ug collected $2.50 from pot
*** SUMMARY ***
Total pot $2.50 | Rake $0
Seat 1: RTuDLJHh/9zPfBftoc9vsw folded before Flop (didn't bet)
Seat 2: j7NIOHLZk7V2o9fOioO5ug (button) collected ($2.50)
Seat 3: +zIVjZKLpcidfRHgVZW8lA (small blind) folded before Flop
Seat 4: uJVSceLggtsrJya+WtmUEA (big blind) folded before Flop
Seat 5: +Nt3OPk3XR9SKjZgm2CexQ folded before Flop (didn't bet)
Seat 6: 9/Tq8dw7kWW68uN8bFupXg folded before Flop (didn't bet)



PokerStars Game #59941591542:  Hold'em No Limit ($0.50/$1.00) - 2009/07/01 1:40:06 ET
Table 'N2bNCDHL96aCQDvZIh+yQQ' 6-max Seat #3 is the button
Seat 1: Jjgflx10PVjcLkziEmLhSA ($92.35 in chips)
Seat 2: y27w5IK2WXqmYzS8OU0wKA ($128.65 in chips)
Seat 3: UBZQqpnJZdTYYY1FTb0rLA ($120.55 in chips)
Seat 4: uCqEjnxh2/vFBjKYkfTOkw ($174.80 in chips)
Seat 6: idVgoPAdspFPCzee6aF9Pg ($107.40 in chips)
uCqEjnxh2/vFBjKYkfTOkw: posts small blind $0.50
idVgoPAdspFPCzee6aF9Pg: posts big blind $1
*** HOLE CARDS ***
Jjgflx10PVjcLkziEmLhSA: calls $1
ene3nLSnQ4N961iBaUsSmA joins the table at seat #5
y27w5IK2WXqmYzS8OU0wKA: folds
UBZQqpnJZdTYYY1FTb0rLA: folds
uCqEjnxh2/vFBjKYkfTOkw: folds
idVgoPAdspFPCzee6aF9Pg: checks
*** FLOP *** [4s 9c 3c]
idVgoPAdspFPCzee6aF9Pg: checks
Jjgflx10PVjcLkziEmLhSA: bets $2
idVgoPAdspFPCzee6aF9Pg: folds
Jjgflx10PVjcLkziEmLhSA collected $2.40 from pot
Jjgflx10PVjcLkziEmLhSA: doesn't show hand
*** SUMMARY ***
Total pot $2.50 | Rake $0.10
Board [4s 9c 3c]
Seat 1: Jjgflx10PVjcLkziEmLhSA collected ($2.40)
Seat 2: y27w5IK2WXqmYzS8OU0wKA folded before Flop (didn't bet)
Seat 3: UBZQqpnJZdTYYY1FTb0rLA (button) folded before Flop (didn't bet)
Seat 4: uCqEjnxh2/vFBjKYkfTOkw (small blind) folded before Flop
Seat 6: idVgoPAdspFPCzee6aF9Pg (big blind) folded on the Flop



PokerStars Game #59941592428:  Hold'em No Limit ($0.50/$1.00) - 2009/07/01 1:40:07 ET
Table 'MUPc8FEpe/nR0BKSeReX6Q' 6-max Seat #2 is the button
Seat 1: qhkK6+yCciTRd+rCFEbnEQ ($79.10 in chips)
Seat 2: xAU6q2/cwmby2sxmA8VcmA ($102.20 in chips)
Seat 3: wx3sQGkVi2x9wJXuWNHPBw ($286.65 in chips)
Seat 4: r4lpoh2BJZ8S6zyQv1JeSw ($110 in chips)
Seat 5: y27w5IK2WXqmYzS8OU0wKA ($131.05 in chips)
wx3sQGkVi2x9wJXuWNHPBw: posts small blind $0.50
r4lpoh2BJZ8S6zyQv1JeSw: posts big blind $1
ene3nLSnQ4N961iBaUsSmA: sits out
*** HOLE CARDS ***
y27w5IK2WXqmYzS8OU0wKA: folds
qhkK6+yCciTRd+rCFEbnEQ: folds
xAU6q2/cwmby2sxmA8VcmA: raises $3 to $4
wx3sQGkVi2x9wJXuWNHPBw: folds
r4lpoh2BJZ8S6zyQv1JeSw: folds
xAU6q2/cwmby2sxmA8VcmA collected $2.50 from pot
xAU6q2/cwmby2sxmA8VcmA: doesn't show hand
*** SUMMARY ***
Total pot $2.50 | Rake $0
Seat 1: qhkK6+yCciTRd+rCFEbnEQ folded before Flop (didn't bet)
Seat 2: xAU6q2/cwmby2sxmA8VcmA (button) collected ($2.50)
Seat 3: wx3sQGkVi2x9wJXuWNHPBw (small blind) folded before Flop
Seat 4: r4lpoh2BJZ8S6zyQv1JeSw (big blind) folded before Flop
Seat 5: y27w5IK2WXqmYzS8OU0wKA folded before Flop (didn't bet)



PokerStars Game #59941593590:  Hold'em No Limit ($0.50/$1.00) - 2009/07/01 1:40:09 ET
Table 'ZFWj23PMihdwrNWv41OG/QtyUh+jyNvrceIQdKMJjQ2weat #5 is the button
Seat 1: j3hj7KQwBVU5NTFmtYomSw ($87.75 in chips)
Seat 2: 0smcry9L0OOTCP+KzIS5SA ($97 in chips)
Seat 3: cWwhvq/+r/w8nkhwrJoekQ ($43.20 in chips)
Seat 4: O5ZesE/6mHyuWWbvkiH/Fg ($70.70 in chips)
Seat 5: j7NIOHLZk7V2o9fOioO5ug ($101.70 in chips)
Seat 6: u23r4AyKPgHioZ6t7z6qrA ($97 in chips)
u23r4AyKPgHioZ6t7z6qrA: posts small blind $0.50
j3hj7KQwBVU5NTFmtYomSw: posts big blind $1
*** HOLE CARDS ***
0smcry9L0OOTCP+KzIS5SA: folds
cWwhvq/+r/w8nkhwrJoekQ: calls $1
O5ZesE/6mHyuWWbvkiH/Fg: folds
j7NIOHLZk7V2o9fOioO5ug: folds
u23r4AyKPgHioZ6t7z6qrA: raises $2 to $3
j3hj7KQwBVU5NTFmtYomSw: folds
cWwhvq/+r/w8nkhwrJoekQ: raises $40.20 to $43.20 and is all-in
u23r4AyKPgHioZ6t7z6qrA: folds
cWwhvq/+r/w8nkhwrJoekQ collected $7 from pot
*** SUMMARY ***
Total pot $7 | Rake $0
Seat 1: j3hj7KQwBVU5NTFmtYomSw (big blind) folded before Flop
Seat 2: 0smcry9L0OOTCP+KzIS5SA folded before Flop (didn't bet)
Seat 3: cWwhvq/+r/w8nkhwrJoekQ collected ($7)
Seat 4: O5ZesE/6mHyuWWbvkiH/Fg folded before Flop (didn't bet)
Seat 5: j7NIOHLZk7V2o9fOioO5ug (button) folded before Flop (didn't bet)
Seat 6: u23r4AyKPgHioZ6t7z6qrA (small blind) folded before Flop



PokerStars Game #59941594706:  Hold'em No Limit ($0.50/$1.00) - 2009/07/01 1:40:11 ET
Table 'qj0HBN4HhQKogreu1bg7xg' 2-max Seat #2 is the button
Seat 1: NYi6JFscYNrofSXy4sM+Yw ($118.10 in chips)
Seat 2: qtyl8CSb0/4yWdbuEPJejA ($159.80 in chips)
qtyl8CSb0/4yWdbuEPJejA: posts small blind $0.50
NYi6JFscYNrofSXy4sM+Yw: posts big blind $1
*** HOLE CARDS ***
qtyl8CSb0/4yWdbuEPJejA: folds
NYi6JFscYNrofSXy4sM+Yw collected $1 from pot
NYi6JFscYNrofSXy4sM+Yw: doesn't show hand
*** SUMMARY ***
Total pot $1 | Rake $0
Seat 1: NYi6JFscYNrofSXy4sM+Yw (big blind) collected ($1)
Seat 2: qtyl8CSb0/4yWdbuEPJejA (button) (small blind) folded before Flop



PokerStars Game #59941594882:  Hold'em No Limit ($0.50/$1.00) - 2009/07/01 1:40:12 ET
Table 'NqGO/cV3MwFAx+ZPB5ANmQ' 2-max Seat #1 is the button
Seat 1: ItaRAnHOgvYOv5ynbG1iTw ($250.70 in chips)
Seat 2: GtFB+yyeb2djMdPFuOW/Xg ($100.50 in chips)
ItaRAnHOgvYOv5ynbG1iTw: posts small blind $0.50
GtFB+yyeb2djMdPFuOW/Xg: posts big blind $1
*** HOLE CARDS ***
ItaRAnHOgvYOv5ynbG1iTw: raises $2 to $3
GtFB+yyeb2djMdPFuOW/Xg: folds
ItaRAnHOgvYOv5ynbG1iTw collected $2 from pot
*** SUMMARY ***
Total pot $2 | Rake $0
Seat 1: ItaRAnHOgvYOv5ynbG1iTw (button) (small blind) collected ($2)
Seat 2: GtFB+yyeb2djMdPFuOW/Xg (big blind) folded before Flop



PokerStars Game #59941595686:  Hold'em No Limit ($0.50/$1.00) - 2009/07/01 1:40:13 ET
Table 'vs/5jr6ciwjVQ5+Soc+u2A' 6-max Seat #6 is the button
Seat 1: J798qwLuvXyq0BbzsIjOrA ($199.65 in chips)
Seat 2: lXX4W7m3u++JiSOZ46yVMQ ($100 in chips)
Seat 3: Ws/3Uo3rQIk8hLgW0P+2xA ($94.50 in chips)
Seat 4: 0smcry9L0OOTCP+KzIS5SA ($88 in chips)
Seat 5: +Nt3OPk3XR9SKjZgm2CexQ ($157.85 in chips)
Seat 6: Z2fXsGcjl+Eax+RzOgwOmg ($124 in chips)
J798qwLuvXyq0BbzsIjOrA: posts small blind $0.50
lXX4W7m3u++JiSOZ46yVMQ: posts big blind $1
*** HOLE CARDS ***
Ws/3Uo3rQIk8hLgW0P+2xA: calls $1
0smcry9L0OOTCP+KzIS5SA: folds
+Nt3OPk3XR9SKjZgm2CexQ: folds
Z2fXsGcjl+Eax+RzOgwOmg: folds
J798qwLuvXyq0BbzsIjOrA: folds
lXX4W7m3u++JiSOZ46yVMQ: checks
*** FLOP *** [7d 4d 2s]
lXX4W7m3u++JiSOZ46yVMQ: checks
Ws/3Uo3rQIk8hLgW0P+2xA: checks
*** TURN *** [7d 4d 2s] [5c]
lXX4W7m3u++JiSOZ46yVMQ: checks
Ws/3Uo3rQIk8hLgW0P+2xA: checks
*** RIVER *** [7d 4d 2s 5c] [9d]
lXX4W7m3u++JiSOZ46yVMQ: checks
Ws/3Uo3rQIk8hLgW0P+2xA: checks
*** SHOW DOWN ***
lXX4W7m3u++JiSOZ46yVMQ: shows [Js Td] (high card Jack)
Ws/3Uo3rQIk8hLgW0P+2xA: shows [8s Ks] (high card King)
Ws/3Uo3rQIk8hLgW0P+2xA collected $2.40 from pot
*** SUMMARY ***
Total pot $2.50 | Rake $0.10
Board [7d 4d 2s 5c 9d]
Seat 1: J798qwLuvXyq0BbzsIjOrA (small blind) folded before Flop
Seat 2: lXX4W7m3u++JiSOZ46yVMQ (big blind) showed [Js Td] and lost with high card Jack
Seat 3: Ws/3Uo3rQIk8hLgW0P+2xA showed [8s Ks] and won ($2.40) with high card King
Seat 4: 0smcry9L0OOTCP+KzIS5SA folded before Flop (didn't bet)
Seat 5: +Nt3OPk3XR9SKjZgm2CexQ folded before Flop (didn't bet)
Seat 6: Z2fXsGcjl+Eax+RzOgwOmg (button) folded before Flop (didn't bet)



PokerStars Game #59941595928:  Hold'em No Limit ($0.50/$1.00) - 2009/07/01 1:40:14 ET
Table '3T4owEKJKyGTMePwrv50FQ' 9-max Seat #4 is the button
Seat 1: OGgaARGdJQT4awWVNQ957w ($100 in chips)
Seat 2: t+Id2O6herCLgwnC4m49PA ($31.55 in chips)
Seat 3: DOLzOcBTZYcph5jEfKFWuQ ($106.40 in chips)
Seat 4: O5Go3jrzbQWxRB6ESK+Ptg ($66.10 in chips)
Seat 5: mMc/PBpqlN24gdi3C/1tOw ($40.40 in chips)
Seat 6: V138SURkdX8LdVBPKdJJag ($108.25 in chips)
Seat 7: 1862487932 ($105.50 in chips)
Seat 8: bLbSOSmSOnqE0iTcH/5dxA ($198.50 in chips)
Seat 9: 61sfw5QTu62YYIt68OsdrA ($88.75 in chips)
mMc/PBpqlN24gdi3C/1tOw: posts small blind $0.50
V138SURkdX8LdVBPKdJJag: posts big blind $1
*** HOLE CARDS ***
1862487932: folds
bLbSOSmSOnqE0iTcH/5dxA: folds
61sfw5QTu62YYIt68OsdrA: calls $1
OGgaARGdJQT4awWVNQ957w: folds
t+Id2O6herCLgwnC4m49PA: calls $1
DOLzOcBTZYcph5jEfKFWuQ: folds
O5Go3jrzbQWxRB6ESK+Ptg: calls $1
mMc/PBpqlN24gdi3C/1tOw: calls $0.50
V138SURkdX8LdVBPKdJJag: checks
*** FLOP *** [9s 4s 7s]
mMc/PBpqlN24gdi3C/1tOw: bets $3
V138SURkdX8LdVBPKdJJag: folds
61sfw5QTu62YYIt68OsdrA: calls $3
t+Id2O6herCLgwnC4m49PA: folds
O5Go3jrzbQWxRB6ESK+Ptg: calls $3
*** TURN *** [9s 4s 7s] [2h]
mMc/PBpqlN24gdi3C/1tOw: bets $6
61sfw5QTu62YYIt68OsdrA: folds
O5Go3jrzbQWxRB6ESK+Ptg: folds
mMc/PBpqlN24gdi3C/1tOw collected $13.35 from pot
*** SUMMARY ***
Total pot $14 | Rake $0.65
Board [9s 4s 7s 2h]
Seat 1: OGgaARGdJQT4awWVNQ957w folded before Flop (didn't bet)
Seat 2: t+Id2O6herCLgwnC4m49PA folded on the Flop
Seat 3: DOLzOcBTZYcph5jEfKFWuQ folded before Flop (didn't bet)
Seat 4: O5Go3jrzbQWxRB6ESK+Ptg (button) folded on the Turn
Seat 5: mMc/PBpqlN24gdi3C/1tOw (small blind) collected ($13.35)
Seat 6: V138SURkdX8LdVBPKdJJag (big blind) folded on the Flop
Seat 7: 1862487932 folded before Flop (didn't bet)
Seat 8: bLbSOSmSOnqE0iTcH/5dxA folded before Flop (didn't bet)
Seat 9: 61sfw5QTu62YYIt68OsdrA folded on the Turn



PokerStars Game #59941596986:  Hold'em No Limit ($0.50/$1.00) - 2009/07/01 1:40:16 ET
Table 'SQLOQoANiHscJ8AL7zffbw' 9-max Seat #9 is the button
Seat 1: jPTRd6SpCp4xqAy2XQiTOw ($53.40 in chips)
Seat 2: /zy+DB4S5fUQUSfZWFzYGw ($388.65 in chips)
Seat 4: 5z1PAR8SNow/zUfYNbwq7A ($34.50 in chips)
Seat 5: L9njYvloJ1NdXjP8edHEAg ($119.70 in chips)
Seat 6: H+DVy3Ei8L1UKS2tVOtJcw ($100 in chips)
Seat 8: 9BZCcac3+McErkkSN2YScA ($104.50 in chips)
Seat 9: XE5QF1y74bpHog9JxWJMWQ ($106.70 in chips)
jPTRd6SpCp4xqAy2XQiTOw: posts small blind $0.50
/zy+DB4S5fUQUSfZWFzYGw: posts big blind $1
*** HOLE CARDS ***
5z1PAR8SNow/zUfYNbwq7A: raises $3 to $4
L9njYvloJ1NdXjP8edHEAg: folds
H+DVy3Ei8L1UKS2tVOtJcw: folds
9BZCcac3+McErkkSN2YScA: folds
XE5QF1y74bpHog9JxWJMWQ: folds
jPTRd6SpCp4xqAy2XQiTOw: folds
/zy+DB4S5fUQUSfZWFzYGw: folds
5z1PAR8SNow/zUfYNbwq7A collected $2.50 from pot
*** SUMMARY ***
Total pot $2.50 | Rake $0
Seat 1: jPTRd6SpCp4xqAy2XQiTOw (small blind) folded before Flop
Seat 2: /zy+DB4S5fUQUSfZWFzYGw (big blind) folded before Flop
Seat 4: 5z1PAR8SNow/zUfYNbwq7A collected ($2.50)
Seat 5: L9njYvloJ1NdXjP8edHEAg folded before Flop (didn't bet)
Seat 6: H+DVy3Ei8L1UKS2tVOtJcw folded before Flop (didn't bet)
Seat 8: 9BZCcac3+McErkkSN2YScA folded before Flop (didn't bet)
Seat 9: XE5QF1y74bpHog9JxWJMWQ (button) folded before Flop (didn't bet)



PokerStars Game #59941597940:  Hold'em No Limit ($0.50/$1.00) - 2009/07/01 1:40:18 ET
Table 'qj0HBN4HhQKogreu1bg7xg' 2-max Seat #1 is the button
Seat 1: NYi6JFscYNrofSXy4sM+Yw ($118.60 in chips)
Seat 2: qtyl8CSb0/4yWdbuEPJejA ($159.30 in chips)
NYi6JFscYNrofSXy4sM+Yw: posts small blind $0.50
qtyl8CSb0/4yWdbuEPJejA: posts big blind $1
*** HOLE CARDS ***
NYi6JFscYNrofSXy4sM+Yw: raises $2 to $3
qtyl8CSb0/4yWdbuEPJejA: folds
NYi6JFscYNrofSXy4sM+Yw collected $2 from pot
*** SUMMARY ***
Total pot $2 | Rake $0
Seat 1: NYi6JFscYNrofSXy4sM+Yw (button) (small blind) collected ($2)
Seat 2: qtyl8CSb0/4yWdbuEPJejA (big blind) folded before Flop



PokerStars Game #59941600088:  Hold'em No Limit ($0.50/$1.00) - 2009/07/01 1:40:21 ET
Table 'gxFK0BVUD7cupu2uyRUZJg' 6-max Seat #1 is the button
Seat 1: M+X3uChmP6R63IwijVjgTg ($218.40 in chips)
Seat 2: hpxXcmRkXXI9HE5+5/j/0Q ($130.55 in chips)
Seat 3: Z2fXsGcjl+Eax+RzOgwOmg ($100 in chips)
Seat 4: Hcr4S4Nbkj5idKsvYK/eqQ ($101.50 in chips)
Seat 5: 0smcry9L0OOTCP+KzIS5SA ($208.50 in chips)
Seat 6: dYyb6/42PMC8aNFlm/eBeQ ($141.25 in chips)
hpxXcmRkXXI9HE5+5/j/0Q: posts small blind $0.50
Z2fXsGcjl+Eax+RzOgwOmg: posts big blind $1
*** HOLE CARDS ***
Hcr4S4Nbkj5idKsvYK/eqQ: folds
0smcry9L0OOTCP+KzIS5SA: folds
dYyb6/42PMC8aNFlm/eBeQ: folds
M+X3uChmP6R63IwijVjgTg: folds
hpxXcmRkXXI9HE5+5/j/0Q: raises $3 to $4
Z2fXsGcjl+Eax+RzOgwOmg: folds
hpxXcmRkXXI9HE5+5/j/0Q collected $2 from pot
hpxXcmRkXXI9HE5+5/j/0Q: doesn't show hand
*** SUMMARY ***
Total pot $2 | Rake $0
Seat 1: M+X3uChmP6R63IwijVjgTg (button) folded before Flop (didn't bet)
Seat 2: hpxXcmRkXXI9HE5+5/j/0Q (small blind) collected ($2)
Seat 3: Z2fXsGcjl+Eax+RzOgwOmg (big blind) folded before Flop
Seat 4: Hcr4S4Nbkj5idKsvYK/eqQ folded before Flop (didn't bet)
Seat 5: 0smcry9L0OOTCP+KzIS5SA folded before Flop (didn't bet)
Seat 6: dYyb6/42PMC8aNFlm/eBeQ folded before Flop (didn't bet)



PokerStars Game #59941600380:  Hold'em No Limit ($0.50/$1.00) - 2009/07/01 1:40:22 ET
Table 'O96CPOtvMBWP6kzuYDfdFA' 6-max Seat #5 is the button
Seat 1: 6alLXQIITA2EZ/lBeym8Dw ($126.75 in chips)
Seat 2: 4d1rWhpu8DzLmzMbR3QKyA ($100 in chips)
Seat 3: ieBUmHu5QBR86BArTtK4FQ ($21.05 in chips)
Seat 4: /P4w1pHg2zHYg/4ubJ0dPw ($69.45 in chips)
Seat 5: vX+iYAEINFeLxwMla7DY1Q ($98.50 in chips)
Seat 6: 3syOXva630dm1FTdwnuLpw ($78.15 in chips)
3syOXva630dm1FTdwnuLpw: posts small blind $0.50
6alLXQIITA2EZ/lBeym8Dw: posts big blind $1
ieBUmHu5QBR86BArTtK4FQ: posts big blind $1
*** HOLE CARDS ***
4d1rWhpu8DzLmzMbR3QKyA: folds
ieBUmHu5QBR86BArTtK4FQ: checks
/P4w1pHg2zHYg/4ubJ0dPw: raises $3 to $4
vX+iYAEINFeLxwMla7DY1Q: folds
3syOXva630dm1FTdwnuLpw: folds
6alLXQIITA2EZ/lBeym8Dw: raises $11 to $15
ieBUmHu5QBR86BArTtK4FQ: folds
/P4w1pHg2zHYg/4ubJ0dPw: folds
6alLXQIITA2EZ/lBeym8Dw collected $9.50 from pot
*** SUMMARY ***
Total pot $9.50 | Rake $0
Seat 1: 6alLXQIITA2EZ/lBeym8Dw (big blind) collected ($9.50)
Seat 2: 4d1rWhpu8DzLmzMbR3QKyA folded before Flop (didn't bet)
Seat 3: ieBUmHu5QBR86BArTtK4FQ folded before Flop
Seat 4: /P4w1pHg2zHYg/4ubJ0dPw folded before Flop
Seat 5: vX+iYAEINFeLxwMla7DY1Q (button) folded before Flop (didn't bet)
Seat 6: 3syOXva630dm1FTdwnuLpw (small blind) folded before Flop



PokerStars Game #59941601230:  Hold'em No Limit ($0.50/$1.00) - 2009/07/01 1:40:23 ET
Table 'GxCPo/gd3OSthkYrAxJngg' 6-max Seat #3 is the button
Seat 1: sH8BpAFP+jGFxCgVpD1Lew ($229.55 in chips)
Seat 2: YExX2paeIHrmfIwV1ivM/w ($61.60 in chips)
Seat 3: idVgoPAdspFPCzee6aF9Pg ($136 in chips)
Seat 4: YMJG+F++3Aj6P8dAWda5fw ($204.35 in chips)
Seat 5: vX+iYAEINFeLxwMla7DY1Q ($98.50 in chips)
Seat 6: 4d1rWhpu8DzLmzMbR3QKyA ($106.55 in chips)
YMJG+F++3Aj6P8dAWda5fw: posts small blind $0.50
vX+iYAEINFeLxwMla7DY1Q: posts big blind $1
*** HOLE CARDS ***
4d1rWhpu8DzLmzMbR3QKyA: folds
sH8BpAFP+jGFxCgVpD1Lew: folds
YExX2paeIHrmfIwV1ivM/w: folds
idVgoPAdspFPCzee6aF9Pg: folds
YMJG+F++3Aj6P8dAWda5fw: folds
vX+iYAEINFeLxwMla7DY1Q collected $1 from pot
*** SUMMARY ***
Total pot $1 | Rake $0
Seat 1: sH8BpAFP+jGFxCgVpD1Lew folded before Flop (didn't bet)
Seat 2: YExX2paeIHrmfIwV1ivM/w folded before Flop (didn't bet)
Seat 3: idVgoPAdspFPCzee6aF9Pg (button) folded before Flop (didn't bet)
Seat 4: YMJG+F++3Aj6P8dAWda5fw (small blind) folded before Flop
Seat 5: vX+iYAEINFeLxwMla7DY1Q (big blind) collected ($1)
Seat 6: 4d1rWhpu8DzLmzMbR3QKyA folded before Flop (didn't bet)



PokerStars Game #59941601078:  Hold'em No Limit ($0.50/$1.00) - 2009/07/01 1:40:23 ET
Table 'NqGO/cV3MwFAx+ZPB5ANmQ' 2-max Seat #2 is the button
Seat 1: ItaRAnHOgvYOv5ynbG1iTw ($251.70 in chips)
Seat 2: GtFB+yyeb2djMdPFuOW/Xg ($100 in chips)
GtFB+yyeb2djMdPFuOW/Xg: posts small blind $0.50
ItaRAnHOgvYOv5ynbG1iTw: posts big blind $1
*** HOLE CARDS ***
GtFB+yyeb2djMdPFuOW/Xg: folds
ItaRAnHOgvYOv5ynbG1iTw collected $1 from pot
*** SUMMARY ***
Total pot $1 | Rake $0
Seat 1: ItaRAnHOgvYOv5ynbG1iTw (big blind) collected ($1)
Seat 2: GtFB+yyeb2djMdPFuOW/Xg (button) (small blind) folded before Flop



PokerStars Game #59941601518:  Hold'em No Limit ($0.50/$1.00) - 2009/07/01 1:40:24 ET
Table 'rmZfTK+oSebeUPJNbWhdAA' 6-max Seat #6 is the button
Seat 1: xAU6q2/cwmby2sxmA8VcmA ($135 in chips)
Seat 2: z7O9PO/WEcqRouIydFhS9Q ($188 in chips)
Seat 3: BCEV3COoKY607AzLWayfRA ($218.70 in chips)
Seat 4: 1/mIuXfgx1ZyVkodrmfQDw ($165.15 in chips)
Seat 6: j7NIOHLZk7V2o9fOioO5ug ($102.20 in chips)
xAU6q2/cwmby2sxmA8VcmA: posts small blind $0.50
z7O9PO/WEcqRouIydFhS9Q: posts big blind $1
UOHYuj23MyK9R8ciY2t6FA: sits out
*** HOLE CARDS ***
BCEV3COoKY607AzLWayfRA: folds
1/mIuXfgx1ZyVkodrmfQDw: raises $2 to $3
j7NIOHLZk7V2o9fOioO5ug: folds
xAU6q2/cwmby2sxmA8VcmA: folds
z7O9PO/WEcqRouIydFhS9Q: calls $2
*** FLOP *** [Ts Jc Qd]
z7O9PO/WEcqRouIydFhS9Q: checks
1/mIuXfgx1ZyVkodrmfQDw: bets $5
z7O9PO/WEcqRouIydFhS9Q: folds
1/mIuXfgx1ZyVkodrmfQDw collected $6.20 from pot
*** SUMMARY ***
Total pot $6.50 | Rake $0.30
Board [Ts Jc Qd]
Seat 1: xAU6q2/cwmby2sxmA8VcmA (small blind) folded before Flop
Seat 2: z7O9PO/WEcqRouIydFhS9Q (big blind) folded on the Flop
Seat 3: BCEV3COoKY607AzLWayfRA folded before Flop (didn't bet)
Seat 4: 1/mIuXfgx1ZyVkodrmfQDw collected ($6.20)
Seat 6: j7NIOHLZk7V2o9fOioO5ug (button) folded before Flop (didn't bet)



PokerStars Game #59941603036:  Hold'em No Limit ($0.50/$1.00) - 2009/07/01 1:40:27 ET
Table 'blHlQApStil0OPeQxQxPcw' 9-max Seat #6 is the button
Seat 1: Pp/KTcXkfZKKUHkjyaLTdg ($24.10 in chips)
Seat 2: V138SURkdX8LdVBPKdJJag ($122.85 in chips)
Seat 3: OGgaARGdJQT4awWVNQ957w ($100 in chips)
Seat 4: 1862487932 ($102.15 in chips)
Seat 5: uXrDE6JrIi8BZK1L8oQ9bQ ($38.10 in chips)
Seat 6: vljeiOoWscAIXU0fCuiEBw ($48.65 in chips)
Seat 7: VPF+HjszMvUIpy0CHIwH3A ($19 in chips)
Seat 9: 6XkTu4ahxzHnvjjc1R8YjQ ($155.35 in chips)
VPF+HjszMvUIpy0CHIwH3A: posts small blind $0.50
laA8va+Yv8WuMqT1zdR91g: is sitting out
6XkTu4ahxzHnvjjc1R8YjQ: posts big blind $1
*** HOLE CARDS ***
Pp/KTcXkfZKKUHkjyaLTdg: folds
V138SURkdX8LdVBPKdJJag: folds
OGgaARGdJQT4awWVNQ957w: folds
1862487932: folds
uXrDE6JrIi8BZK1L8oQ9bQ: folds
vljeiOoWscAIXU0fCuiEBw: folds
VPF+HjszMvUIpy0CHIwH3A: raises $18 to $19 and is all-in
6XkTu4ahxzHnvjjc1R8YjQ: folds
VPF+HjszMvUIpy0CHIwH3A collected $2 from pot
VPF+HjszMvUIpy0CHIwH3A: doesn't show hand
*** SUMMARY ***
Total pot $2 | Rake $0
Seat 1: Pp/KTcXkfZKKUHkjyaLTdg folded before Flop (didn't bet)
Seat 2: V138SURkdX8LdVBPKdJJag folded before Flop (didn't bet)
Seat 3: OGgaARGdJQT4awWVNQ957w folded before Flop (didn't bet)
Seat 4: 1862487932 folded before Flop (didn't bet)
Seat 5: uXrDE6JrIi8BZK1L8oQ9bQ folded before Flop (didn't bet)
Seat 6: vljeiOoWscAIXU0fCuiEBw (button) folded before Flop (didn't bet)
Seat 7: VPF+HjszMvUIpy0CHIwH3A (small blind) collected ($2)
Seat 9: 6XkTu4ahxzHnvjjc1R8YjQ (big blind) folded before Flop



PokerStars Game #59941604518:  Hold'em No Limit ($0.50/$1.00) - 2009/07/01 1:40:29 ET
Table 'fTlPiCj0utgzC/5io+I7ew' 6-max Seat #5 is the button
Seat 1: YMJG+F++3Aj6P8dAWda5fw ($100 in chips)
Seat 2: qVr1nl3dy2xXPqS8UpTDlA ($35.25 in chips)
Seat 3: Z2fXsGcjl+Eax+RzOgwOmg ($136.50 in chips)
Seat 4: uJVSceLggtsrJya+WtmUEA ($166.35 in chips)
Seat 5: XUk5GQsfNFpHvaToDZ0rZA ($44.05 in chips)
Seat 6: y27w5IK2WXqmYzS8OU0wKA ($100 in chips)
y27w5IK2WXqmYzS8OU0wKA: posts small blind $0.50
YMJG+F++3Aj6P8dAWda5fw: posts big blind $1
*** HOLE CARDS ***
qVr1nl3dy2xXPqS8UpTDlA: raises $1 to $2
Z2fXsGcjl+Eax+RzOgwOmg: folds
uJVSceLggtsrJya+WtmUEA: folds
XUk5GQsfNFpHvaToDZ0rZA: calls $2
y27w5IK2WXqmYzS8OU0wKA: folds
YMJG+F++3Aj6P8dAWda5fw: calls $1
*** FLOP *** [5h Tc Js]
YMJG+F++3Aj6P8dAWda5fw: checks
qVr1nl3dy2xXPqS8UpTDlA: bets $3
XUk5GQsfNFpHvaToDZ0rZA: folds
YMJG+F++3Aj6P8dAWda5fw: folds
qVr1nl3dy2xXPqS8UpTDlA collected $6.20 from pot
*** SUMMARY ***
Total pot $6.50 | Rake $0.30
Board [5h Tc Js]
Seat 1: YMJG+F++3Aj6P8dAWda5fw (big blind) folded on the Flop
Seat 2: qVr1nl3dy2xXPqS8UpTDlA collected ($6.20)
Seat 3: Z2fXsGcjl+Eax+RzOgwOmg folded before Flop (didn't bet)
Seat 4: uJVSceLggtsrJya+WtmUEA folded before Flop (didn't bet)
Seat 5: XUk5GQsfNFpHvaToDZ0rZA (button) folded on the Flop
Seat 6: y27w5IK2WXqmYzS8OU0wKA (small blind) folded before Flop



PokerStars Game #59941605862:  Hold'em No Limit ($0.50/$1.00) - 2009/07/01 1:40:31 ET
Table 'NqGO/cV3MwFAx+ZPB5ANmQ' 2-max Seat #1 is the button
Seat 1: ItaRAnHOgvYOv5ynbG1iTw ($252.20 in chips)
Seat 2: GtFB+yyeb2djMdPFuOW/Xg ($100 in chips)
ItaRAnHOgvYOv5ynbG1iTw: posts small blind $0.50
GtFB+yyeb2djMdPFuOW/Xg: posts big blind $1
*** HOLE CARDS ***
ItaRAnHOgvYOv5ynbG1iTw: raises $2 to $3
GtFB+yyeb2djMdPFuOW/Xg: folds
ItaRAnHOgvYOv5ynbG1iTw collected $2 from pot
*** SUMMARY ***
Total pot $2 | Rake $0
Seat 1: ItaRAnHOgvYOv5ynbG1iTw (button) (small blind) collected ($2)
Seat 2: GtFB+yyeb2djMdPFuOW/Xg (big blind) folded before Flop



PokerStars Game #59941605418:  Hold'em No Limit ($0.50/$1.00) - 2009/07/01 1:40:31 ET
Table '7Nl0ffnjeK44/vmeexh3MQ' 9-max Seat #3 is the button
Seat 1: V138SURkdX8LdVBPKdJJag ($100 in chips)
Seat 2: OGgaARGdJQT4awWVNQ957w ($100 in chips)
Seat 3: JMmUYT5pIKCKh2pGjCB/4w ($56.90 in chips)
Seat 4: bLbSOSmSOnqE0iTcH/5dxA ($104.30 in chips)
Seat 5: 61sfw5QTu62YYIt68OsdrA ($77.55 in chips)
Seat 6: FVs16t7GgfWgQWt4JxsObQ ($31.25 in chips)
Seat 7: 997ViqAtWn1FPjJqcffwcA ($145.70 in chips)
Seat 8: HRJJZiSxFAehJGaET63dlA ($49.15 in chips)
Seat 9: /JHoNdt0fK6X+isrqRfV3w ($20 in chips)
bLbSOSmSOnqE0iTcH/5dxA: posts small blind $0.50
61sfw5QTu62YYIt68OsdrA: posts big blind $1
*** HOLE CARDS ***
FVs16t7GgfWgQWt4JxsObQ: raises $2 to $3
997ViqAtWn1FPjJqcffwcA: folds
HRJJZiSxFAehJGaET63dlA: folds
/JHoNdt0fK6X+isrqRfV3w: folds
V138SURkdX8LdVBPKdJJag: raises $6.50 to $9.50
OGgaARGdJQT4awWVNQ957w: folds
JMmUYT5pIKCKh2pGjCB/4w: folds
bLbSOSmSOnqE0iTcH/5dxA: folds
61sfw5QTu62YYIt68OsdrA: folds
FVs16t7GgfWgQWt4JxsObQ: calls $6.50
*** FLOP *** [Jc Js 7h]
FVs16t7GgfWgQWt4JxsObQ: bets $1
V138SURkdX8LdVBPKdJJag: calls $1
*** TURN *** [Jc Js 7h] [As]
FVs16t7GgfWgQWt4JxsObQ: bets $3
V138SURkdX8LdVBPKdJJag: calls $3
*** RIVER *** [Jc Js 7h As] [3d]
FVs16t7GgfWgQWt4JxsObQ: bets $1
V138SURkdX8LdVBPKdJJag: raises $20.40 to $21.40
FVs16t7GgfWgQWt4JxsObQ: folds
V138SURkdX8LdVBPKdJJag collected $29.05 from pot
V138SURkdX8LdVBPKdJJag: doesn't show hand
*** SUMMARY ***
Total pot $30.50 | Rake $1.45
Board [Jc Js 7h As 3d]
Seat 1: V138SURkdX8LdVBPKdJJag collected ($29.05)
Seat 2: OGgaARGdJQT4awWVNQ957w folded before Flop (didn't bet)
Seat 3: JMmUYT5pIKCKh2pGjCB/4w (button) folded before Flop (didn't bet)
Seat 4: bLbSOSmSOnqE0iTcH/5dxA (small blind) folded before Flop
Seat 5: 61sfw5QTu62YYIt68OsdrA (big blind) folded before Flop
Seat 6: FVs16t7GgfWgQWt4JxsObQ folded on the River
Seat 7: 997ViqAtWn1FPjJqcffwcA folded before Flop (didn't bet)
Seat 8: HRJJZiSxFAehJGaET63dlA folded before Flop (didn't bet)
Seat 9: /JHoNdt0fK6X+isrqRfV3w folded before Flop (didn't bet)



PokerStars Game #59941606142:  Hold'em No Limit ($0.50/$1.00) - 2009/07/01 1:40:32 ET
Table 'DE4ps3MTl+4avTytwFENAg' 6-max Seat #6 is the button
Seat 1: PvfYaKbzMpsmUcbOExckbQ ($102 in chips)
Seat 2: QHvTZcrKe6+maWUfVjP29Q ($100 in chips)
Seat 3: cGayYjcyk6+jN57tzIY4TA ($303.60 in chips)
Seat 4: iexehpxaQwzColGqeTEnLQ ($121.85 in chips)
Seat 5: UBZQqpnJZdTYYY1FTb0rLA ($174.90 in chips)
Seat 6: lsLuWlcPA3Rh7kJVLzMh0Q ($100 in chips)
PvfYaKbzMpsmUcbOExckbQ: posts small blind $0.50
QHvTZcrKe6+maWUfVjP29Q: posts big blind $1
*** HOLE CARDS ***
cGayYjcyk6+jN57tzIY4TA: raises $1 to $2
iexehpxaQwzColGqeTEnLQ: folds
UBZQqpnJZdTYYY1FTb0rLA: folds
lsLuWlcPA3Rh7kJVLzMh0Q: folds
PvfYaKbzMpsmUcbOExckbQ: folds
QHvTZcrKe6+maWUfVjP29Q: folds
cGayYjcyk6+jN57tzIY4TA collected $2.50 from pot
*** SUMMARY ***
Total pot $2.50 | Rake $0
Seat 1: PvfYaKbzMpsmUcbOExckbQ (small blind) folded before Flop
Seat 2: QHvTZcrKe6+maWUfVjP29Q (big blind) folded before Flop
Seat 3: cGayYjcyk6+jN57tzIY4TA collected ($2.50)
Seat 4: iexehpxaQwzColGqeTEnLQ folded before Flop (didn't bet)
Seat 5: UBZQqpnJZdTYYY1FTb0rLA folded before Flop (didn't bet)
Seat 6: lsLuWlcPA3Rh7kJVLzMh0Q (button) folded before Flop (didn't bet)



PokerStars Game #59941606420:  Hold'em No Limit ($0.50/$1.00) - 2009/07/01 1:40:32 ET
Table 'b8oW/dOL7fDza5DfZ/dOJQ' 6-max Seat #5 is the button
Seat 1: NakujTNjHFgzceydFf+E2Q ($52 in chips)
Seat 2: TSuRyAHnUPCFjP7Z0rEE0w ($119 in chips)
Seat 3: d8WX+9nUHoqlrAGagO0Wow ($34.30 in chips)
Seat 4: 8rDbzImSi1zgxtqtF1pSbA ($11.50 in chips)
Seat 5: sr/OkkgqNbtgwJf1tmnfNg ($58.50 in chips)
Seat 6: PvfYaKbzMpsmUcbOExckbQ ($161.35 in chips)
PvfYaKbzMpsmUcbOExckbQ: posts small blind $0.50
NakujTNjHFgzceydFf+E2Q: posts big blind $1
*** HOLE CARDS ***
TSuRyAHnUPCFjP7Z0rEE0w: folds
d8WX+9nUHoqlrAGagO0Wow: folds
8rDbzImSi1zgxtqtF1pSbA: folds
sr/OkkgqNbtgwJf1tmnfNg: folds
PvfYaKbzMpsmUcbOExckbQ: folds
NakujTNjHFgzceydFf+E2Q collected $1 from pot
*** SUMMARY ***
Total pot $1 | Rake $0
Seat 1: NakujTNjHFgzceydFf+E2Q (big blind) collected ($1)
Seat 2: TSuRyAHnUPCFjP7Z0rEE0w folded before Flop (didn't bet)
Seat 3: d8WX+9nUHoqlrAGagO0Wow folded before Flop (didn't bet)
Seat 4: 8rDbzImSi1zgxtqtF1pSbA folded before Flop (didn't bet)
Seat 5: sr/OkkgqNbtgwJf1tmnfNg (button) folded before Flop (didn't bet)
Seat 6: PvfYaKbzMpsmUcbOExckbQ (small blind) folded before Flop



PokerStars Game #59941605990:  Hold'em No Limit ($0.50/$1.00) - 2009/07/01 1:40:32 ET
Table 'MUPc8FEpe/nR0BKSeReX6Q' 6-max Seat #3 is the button
Seat 1: qhkK6+yCciTRd+rCFEbnEQ ($79.10 in chips)
Seat 2: xAU6q2/cwmby2sxmA8VcmA ($103.70 in chips)
Seat 3: wx3sQGkVi2x9wJXuWNHPBw ($286.15 in chips)
Seat 4: r4lpoh2BJZ8S6zyQv1JeSw ($109 in chips)
Seat 5: y27w5IK2WXqmYzS8OU0wKA ($131.05 in chips)
r4lpoh2BJZ8S6zyQv1JeSw: posts small blind $0.50
y27w5IK2WXqmYzS8OU0wKA: posts big blind $1
ene3nLSnQ4N961iBaUsSmA: sits out
*** HOLE CARDS ***
qhkK6+yCciTRd+rCFEbnEQ: folds
xAU6q2/cwmby2sxmA8VcmA: folds
wx3sQGkVi2x9wJXuWNHPBw: folds
r4lpoh2BJZ8S6zyQv1JeSw: raises $2 to $3
y27w5IK2WXqmYzS8OU0wKA: folds
r4lpoh2BJZ8S6zyQv1JeSw collected $2 from pot
r4lpoh2BJZ8S6zyQv1JeSw: doesn't show hand
*** SUMMARY ***
Total pot $2 | Rake $0
Seat 1: qhkK6+yCciTRd+rCFEbnEQ folded before Flop (didn't bet)
Seat 2: xAU6q2/cwmby2sxmA8VcmA folded before Flop (didn't bet)
Seat 3: wx3sQGkVi2x9wJXuWNHPBw (button) folded before Flop (didn't bet)
Seat 4: r4lpoh2BJZ8S6zyQv1JeSw (small blind) collected ($2)
Seat 5: y27w5IK2WXqmYzS8OU0wKA (big blind) folded before Flop



PokerStars Game #59941606904:  Hold'em No Limit ($0.50/$1.00) - 2009/07/01 1:40:33 ET
Table 'pHrhryH8jPNdQfY62f8v+g' 6-max Seat #1 is the button
Seat 1: 4d1rWhpu8DzLmzMbR3QKyA ($147.45 in chips)
Seat 2: JwCcjZl0bjJzG7hmE0dnTA ($110.05 in chips)
Seat 3: 8oS5O7iD/qnFXFXJrGIgNQ ($110.80 in chips)
Seat 4: 1f3beyIML24UqEMTbWy93g ($57.85 in chips)
Seat 6: xAU6q2/cwmby2sxmA8VcmA ($199.30 in chips)
JwCcjZl0bjJzG7hmE0dnTA: posts small blind $0.50
8oS5O7iD/qnFXFXJrGIgNQ: posts big blind $1
*** HOLE CARDS ***
1f3beyIML24UqEMTbWy93g: folds
d8WX+9nUHoqlrAGagO0Wow has returned
xAU6q2/cwmby2sxmA8VcmA: folds
4d1rWhpu8DzLmzMbR3QKyA: folds
JwCcjZl0bjJzG7hmE0dnTA: folds
8oS5O7iD/qnFXFXJrGIgNQ collected $1 from pot
*** SUMMARY ***
Total pot $1 | Rake $0
Seat 1: 4d1rWhpu8DzLmzMbR3QKyA (button) folded before Flop (didn't bet)
Seat 2: JwCcjZl0bjJzG7hmE0dnTA (small blind) folded before Flop
Seat 3: 8oS5O7iD/qnFXFXJrGIgNQ (big blind) collected ($1)
Seat 4: 1f3beyIML24UqEMTbWy93g folded before Flop (didn't bet)
Seat 6: xAU6q2/cwmby2sxmA8VcmA folded before Flop (didn't bet)



PokerStars Game #59941606816:  Hold'em No Limit ($0.50/$1.00) - 2009/07/01 1:40:33 ET
Table 'ZFWj23PMihdwrNWv41OG/QtyUh+jyNvrceIQdKMJjQ2weat #6 is the button
Seat 1: j3hj7KQwBVU5NTFmtYomSw ($86.75 in chips)
Seat 2: 0smcry9L0OOTCP+KzIS5SA ($97 in chips)
Seat 3: cWwhvq/+r/w8nkhwrJoekQ ($47.20 in chips)
Seat 4: O5ZesE/6mHyuWWbvkiH/Fg ($70.70 in chips)
Seat 5: j7NIOHLZk7V2o9fOioO5ug ($101.70 in chips)
Seat 6: u23r4AyKPgHioZ6t7z6qrA ($94 in chips)
j3hj7KQwBVU5NTFmtYomSw: posts small blind $0.50
0smcry9L0OOTCP+KzIS5SA: posts big blind $1
*** HOLE CARDS ***
cWwhvq/+r/w8nkhwrJoekQ: raises $2 to $3
O5ZesE/6mHyuWWbvkiH/Fg: folds
j7NIOHLZk7V2o9fOioO5ug: folds
u23r4AyKPgHioZ6t7z6qrA: folds
j3hj7KQwBVU5NTFmtYomSw: folds
O5ZesE/6mHyuWWbvkiH/Fg said, "be glad it wasnt"
0smcry9L0OOTCP+KzIS5SA: folds
cWwhvq/+r/w8nkhwrJoekQ collected $2.50 from pot
*** SUMMARY ***
Total pot $2.50 | Rake $0
Seat 1: j3hj7KQwBVU5NTFmtYomSw (small blind) folded before Flop
Seat 2: 0smcry9L0OOTCP+KzIS5SA (big blind) folded before Flop
Seat 3: cWwhvq/+r/w8nkhwrJoekQ collected ($2.50)
Seat 4: O5ZesE/6mHyuWWbvkiH/Fg folded before Flop (didn't bet)
Seat 5: j7NIOHLZk7V2o9fOioO5ug folded before Flop (didn't bet)
Seat 6: u23r4AyKPgHioZ6t7z6qrA (button) folded before Flop (didn't bet)



PokerStars Game #59941606586:  Hold'em No Limit ($0.50/$1.00) - 2009/07/01 1:40:33 ET
Table '7O9fB8yx1u7sJveJn8w6jA' 6-max Seat #5 is the button
Seat 1: 841740 ($44.30 in chips)
Seat 2: wx3sQGkVi2x9wJXuWNHPBw ($206.85 in chips)
Seat 3: hpxXcmRkXXI9HE5+5/j/0Q ($138.65 in chips)
Seat 4: b2a+5TkFf4xJN/Ihhma58Q ($30.35 in chips)
Seat 5: BCEV3COoKY607AzLWayfRA ($101 in chips)
Seat 6: r4lpoh2BJZ8S6zyQv1JeSw ($106.75 in chips)
r4lpoh2BJZ8S6zyQv1JeSw: posts small blind $0.50
841740: posts big blind $1
*** HOLE CARDS ***
wx3sQGkVi2x9wJXuWNHPBw: folds
hpxXcmRkXXI9HE5+5/j/0Q: raises $2 to $3
b2a+5TkFf4xJN/Ihhma58Q has timed out
b2a+5TkFf4xJN/Ihhma58Q: folds
b2a+5TkFf4xJN/Ihhma58Q is sitting out
BCEV3COoKY607AzLWayfRA: folds
r4lpoh2BJZ8S6zyQv1JeSw: folds
841740: calls $2
*** FLOP *** [Kh 4h 8d]
b2a+5TkFf4xJN/Ihhma58Q has returned
841740: checks
hpxXcmRkXXI9HE5+5/j/0Q: bets $5
841740: folds
hpxXcmRkXXI9HE5+5/j/0Q collected $6.20 from pot
hpxXcmRkXXI9HE5+5/j/0Q: doesn't show hand
*** SUMMARY ***
Total pot $6.50 | Rake $0.30
Board [Kh 4h 8d]
Seat 1: 841740 (big blind) folded on the Flop
Seat 2: wx3sQGkVi2x9wJXuWNHPBw folded before Flop (didn't bet)
Seat 3: hpxXcmRkXXI9HE5+5/j/0Q collected ($6.20)
Seat 4: b2a+5TkFf4xJN/Ihhma58Q folded before Flop (didn't bet)
Seat 5: BCEV3COoKY607AzLWayfRA (button) folded before Flop (didn't bet)
Seat 6: r4lpoh2BJZ8S6zyQv1JeSw (small blind) folded before Flop



PokerStars Game #59941606794:  Hold'em No Limit ($0.50/$1.00) - 2009/07/01 1:40:33 ET
Table 'qj0HBN4HhQKogreu1bg7xg' 2-max Seat #1 is the button
Seat 1: NYi6JFscYNrofSXy4sM+Yw ($118.60 in chips)
Seat 2: qtyl8CSb0/4yWdbuEPJejA ($159.30 in chips)
NYi6JFscYNrofSXy4sM+Yw: posts small blind $0.50
qtyl8CSb0/4yWdbuEPJejA: posts big blind $1
*** HOLE CARDS ***
NYi6JFscYNrofSXy4sM+Yw: raises $2 to $3
qtyl8CSb0/4yWdbuEPJejA: raises $5 to $8
NYi6JFscYNrofSXy4sM+Yw: calls $5
*** FLOP *** [Qs Ts 5c]
qtyl8CSb0/4yWdbuEPJejA: bets $9
NYi6JFscYNrofSXy4sM+Yw: calls $9
*** TURN *** [Qs Ts 5c] [3s]
qtyl8CSb0/4yWdbuEPJejA: checks
NYi6JFscYNrofSXy4sM+Yw: checks
*** RIVER *** [Qs Ts 5c 3s] [9h]
qtyl8CSb0/4yWdbuEPJejA: checks
NYi6JFscYNrofSXy4sM+Yw: checks
*** SHOW DOWN ***
qtyl8CSb0/4yWdbuEPJejA: shows [Ad 5h] (a pair of Fives)
NYi6JFscYNrofSXy4sM+Yw: shows [7h Tc] (a pair of Tens)
NYi6JFscYNrofSXy4sM+Yw collected $33.50 from pot
*** SUMMARY ***
Total pot $34 | Rake $0.50
Board [Qs Ts 5c 3s 9h]
Seat 1: NYi6JFscYNrofSXy4sM+Yw (button) (small blind) showed [7h Tc] and won ($33.50) with a pair of Tens
Seat 2: qtyl8CSb0/4yWdbuEPJejA (big blind) showed [Ad 5h] and lost with a pair of Fives



PokerStars Game #59941607796:  Hold'em No Limit ($0.50/$1.00) - 2009/07/01 1:40:35 ET
Table 'mmbQQVBTrPdE+wy+s+9VPA' 6-max Seat #1 is the button
Seat 1: zyP4SPoWZnKUfTvIRLCVog ($73.25 in chips)
Seat 2: XK4Qsl+DA8gAJyg85/zBIw ($37.70 in chips)
Seat 3: wx3sQGkVi2x9wJXuWNHPBw ($232.10 in chips)
Seat 4: V3iZdcw61nXF3g5hD2RrsQ ($100.05 in chips)
Seat 5: YMJG+F++3Aj6P8dAWda5fw ($126.70 in chips)
Seat 6: UOHYuj23MyK9R8ciY2t6FA ($100 in chips)
XK4Qsl+DA8gAJyg85/zBIw: posts small blind $0.50
wx3sQGkVi2x9wJXuWNHPBw: posts big blind $1
*** HOLE CARDS ***
V3iZdcw61nXF3g5hD2RrsQ: folds
YMJG+F++3Aj6P8dAWda5fw: folds
UOHYuj23MyK9R8ciY2t6FA: folds
zyP4SPoWZnKUfTvIRLCVog: folds
XK4Qsl+DA8gAJyg85/zBIw: calls $0.50
wx3sQGkVi2x9wJXuWNHPBw: checks
*** FLOP *** [9c Kc Ks]
XK4Qsl+DA8gAJyg85/zBIw: checks
wx3sQGkVi2x9wJXuWNHPBw: bets $2
XK4Qsl+DA8gAJyg85/zBIw: calls $2
*** TURN *** [9c Kc Ks] [7c]
XK4Qsl+DA8gAJyg85/zBIw: checks
wx3sQGkVi2x9wJXuWNHPBw: checks
*** RIVER *** [9c Kc Ks 7c] [Ts]
XK4Qsl+DA8gAJyg85/zBIw: checks
wx3sQGkVi2x9wJXuWNHPBw: checks
*** SHOW DOWN ***
XK4Qsl+DA8gAJyg85/zBIw: shows [8h As] (a pair of Kings)
wx3sQGkVi2x9wJXuWNHPBw: mucks hand
XK4Qsl+DA8gAJyg85/zBIw collected $5.75 from pot
*** SUMMARY ***
Total pot $6 | Rake $0.25
Board [9c Kc Ks 7c Ts]
Seat 1: zyP4SPoWZnKUfTvIRLCVog (button) folded before Flop (didn't bet)
Seat 2: XK4Qsl+DA8gAJyg85/zBIw (small blind) showed [8h As] and won ($5.75) with a pair of Kings
Seat 3: wx3sQGkVi2x9wJXuWNHPBw (big blind) mucked
Seat 4: V3iZdcw61nXF3g5hD2RrsQ folded before Flop (didn't bet)
Seat 5: YMJG+F++3Aj6P8dAWda5fw folded before Flop (didn't bet)
Seat 6: UOHYuj23MyK9R8ciY2t6FA folded before Flop (didn't bet)



PokerStars Game #59941609798:  Hold'em No Limit ($0.50/$1.00) - 2009/07/01 1:40:39 ET
Table 'NqGO/cV3MwFAx+ZPB5ANmQ' 2-max Seat #2 is the button
Seat 1: ItaRAnHOgvYOv5ynbG1iTw ($253.20 in chips)
Seat 2: GtFB+yyeb2djMdPFuOW/Xg ($100 in chips)
GtFB+yyeb2djMdPFuOW/Xg: posts small blind $0.50
ItaRAnHOgvYOv5ynbG1iTw: posts big blind $1
*** HOLE CARDS ***
GtFB+yyeb2djMdPFuOW/Xg: raises $2 to $3
ItaRAnHOgvYOv5ynbG1iTw: calls $2
*** FLOP *** [2h Js Jh]
ItaRAnHOgvYOv5ynbG1iTw: checks
GtFB+yyeb2djMdPFuOW/Xg: bets $5
ItaRAnHOgvYOv5ynbG1iTw: folds
GtFB+yyeb2djMdPFuOW/Xg collected $5.70 from pot
*** SUMMARY ***
Total pot $6 | Rake $0.30
Board [2h Js Jh]
Seat 1: ItaRAnHOgvYOv5ynbG1iTw (big blind) folded on the Flop
Seat 2: GtFB+yyeb2djMdPFuOW/Xg (button) (small blind) collected ($5.70)



PokerStars Game #59941610850:  Hold'em No Limit ($0.50/$1.00) - 2009/07/01 1:40:41 ET
Table 'gxFK0BVUD7cupu2uyRUZJg' 6-max Seat #2 is the button
Seat 1: M+X3uChmP6R63IwijVjgTg ($218.40 in chips)
Seat 2: hpxXcmRkXXI9HE5+5/j/0Q ($131.55 in chips)
Seat 3: Z2fXsGcjl+Eax+RzOgwOmg ($100 in chips)
Seat 4: Hcr4S4Nbkj5idKsvYK/eqQ ($101.50 in chips)
Seat 5: 0smcry9L0OOTCP+KzIS5SA ($208.50 in chips)
Seat 6: dYyb6/42PMC8aNFlm/eBeQ ($141.25 in chips)
Z2fXsGcjl+Eax+RzOgwOmg: posts small blind $0.50
Hcr4S4Nbkj5idKsvYK/eqQ: posts big blind $1
*** HOLE CARDS ***
0smcry9L0OOTCP+KzIS5SA: raises $2 to $3
dYyb6/42PMC8aNFlm/eBeQ: folds
M+X3uChmP6R63IwijVjgTg: folds
hpxXcmRkXXI9HE5+5/j/0Q: folds
Z2fXsGcjl+Eax+RzOgwOmg: folds
Hcr4S4Nbkj5idKsvYK/eqQ: folds
0smcry9L0OOTCP+KzIS5SA collected $2.50 from pot
0smcry9L0OOTCP+KzIS5SA: doesn't show hand
*** SUMMARY ***
Total pot $2.50 | Rake $0
Seat 1: M+X3uChmP6R63IwijVjgTg folded before Flop (didn't bet)
Seat 2: hpxXcmRkXXI9HE5+5/j/0Q (button) folded before Flop (didn't bet)
Seat 3: Z2fXsGcjl+Eax+RzOgwOmg (small blind) folded before Flop
Seat 4: Hcr4S4Nbkj5idKsvYK/eqQ (big blind) folded before Flop
Seat 5: 0smcry9L0OOTCP+KzIS5SA collected ($2.50)
Seat 6: dYyb6/42PMC8aNFlm/eBeQ folded before Flop (didn't bet)



PokerStars Game #59941611150:  Hold'em No Limit ($0.50/$1.00) - 2009/07/01 1:40:41 ET
Table '+cA8mcmhaedZ7YcrDdhmeQ' 6-max Seat #4 is the button
Seat 2: 14aYclSc98EYd6TrzN2l3Q ($61.05 in chips)
Seat 3: DAIgyIWbYvAkL6PbAI27pg ($18.50 in chips)
Seat 4: 4OO5v3AVduL0tePNx8wk5A ($108.20 in chips)
Seat 5: SJieaES+gCAfonfNNMCP6w ($100 in chips)
Seat 6: YfsTQsY/fxb+YqbdclTHuw ($56.15 in chips)
SJieaES+gCAfonfNNMCP6w: posts small blind $0.50
YfsTQsY/fxb+YqbdclTHuw: posts big blind $1
VB7TtBnfmT3JTA/cCL6dJg: sits out
*** HOLE CARDS ***
14aYclSc98EYd6TrzN2l3Q: raises $1 to $2
DAIgyIWbYvAkL6PbAI27pg: folds
4OO5v3AVduL0tePNx8wk5A: folds
SJieaES+gCAfonfNNMCP6w: folds
YfsTQsY/fxb+YqbdclTHuw: calls $1
*** FLOP *** [Ts Kh 7d]
YfsTQsY/fxb+YqbdclTHuw: checks
14aYclSc98EYd6TrzN2l3Q: checks
*** TURN *** [Ts Kh 7d] [4s]
YfsTQsY/fxb+YqbdclTHuw: checks
14aYclSc98EYd6TrzN2l3Q: bets $3
YfsTQsY/fxb+YqbdclTHuw: folds
14aYclSc98EYd6TrzN2l3Q collected $4.30 from pot
*** SUMMARY ***
Total pot $4.50 | Rake $0.20
Board [Ts Kh 7d 4s]
Seat 2: 14aYclSc98EYd6TrzN2l3Q collected ($4.30)
Seat 3: DAIgyIWbYvAkL6PbAI27pg folded before Flop (didn't bet)
Seat 4: 4OO5v3AVduL0tePNx8wk5A (button) folded before Flop (didn't bet)
Seat 5: SJieaES+gCAfonfNNMCP6w (small blind) folded before Flop
Seat 6: YfsTQsY/fxb+YqbdclTHuw (big blind) folded on the Turn



PokerStars Game #59941611848:  Hold'em No Limit ($0.50/$1.00) - 2009/07/01 1:40:42 ET
Table 'VOs36P6NW+QyXeQ1B62kmAE9S5sEoK9Q3olj2a53gABASeat #5 is the button
Seat 1: 4h8XtuVJtWh3DJpxGo7k5Q ($27.95 in chips)
Seat 2: y27w5IK2WXqmYzS8OU0wKA ($147.15 in chips)
Seat 3: p00KmyZiD/isPc/lZwNBTg ($14 in chips)
Seat 4: ene3nLSnQ4N961iBaUsSmA ($100 in chips)
Seat 5: o3YLm/rSY916m/on1VjXPA ($134.60 in chips)
Seat 6: slVKuQyEz8Qj4E3uLPYNXg ($47.10 in chips)
slVKuQyEz8Qj4E3uLPYNXg: posts small blind $0.50
4h8XtuVJtWh3DJpxGo7k5Q: posts big blind $1
*** HOLE CARDS ***
y27w5IK2WXqmYzS8OU0wKA: folds
p00KmyZiD/isPc/lZwNBTg: calls $1
ene3nLSnQ4N961iBaUsSmA: folds
o3YLm/rSY916m/on1VjXPA: folds
slVKuQyEz8Qj4E3uLPYNXg: folds
4h8XtuVJtWh3DJpxGo7k5Q: checks
*** FLOP *** [Ks Kh 9c]
4h8XtuVJtWh3DJpxGo7k5Q: checks
p00KmyZiD/isPc/lZwNBTg: checks
*** TURN *** [Ks Kh 9c] [Ad]
4h8XtuVJtWh3DJpxGo7k5Q: bets $3
p00KmyZiD/isPc/lZwNBTg: calls $3
*** RIVER *** [Ks Kh 9c Ad] [9h]
4h8XtuVJtWh3DJpxGo7k5Q: bets $1
p00KmyZiD/isPc/lZwNBTg: calls $1
*** SHOW DOWN ***
4h8XtuVJtWh3DJpxGo7k5Q: shows [3d Jd] (two pair, Kings and Nines)
p00KmyZiD/isPc/lZwNBTg: shows [Qc 7d] (two pair, Kings and Nines)
4h8XtuVJtWh3DJpxGo7k5Q collected $5 from pot
p00KmyZiD/isPc/lZwNBTg collected $5 from pot
*** SUMMARY ***
Total pot $10.50 | Rake $0.50
Board [Ks Kh 9c Ad 9h]
Seat 1: 4h8XtuVJtWh3DJpxGo7k5Q (big blind) showed [3d Jd] and won ($5) with two pair, Kings and Nines
Seat 2: y27w5IK2WXqmYzS8OU0wKA folded before Flop (didn't bet)
Seat 3: p00KmyZiD/isPc/lZwNBTg showed [Qc 7d] and won ($5) with two pair, Kings and Nines
Seat 4: ene3nLSnQ4N961iBaUsSmA folded before Flop (didn't bet)
Seat 5: o3YLm/rSY916m/on1VjXPA (button) folded before Flop (didn't bet)
Seat 6: slVKuQyEz8Qj4E3uLPYNXg (small blind) folded before Flop



PokerStars Game #59941612260:  Hold'em No Limit ($0.50/$1.00) - 2009/07/01 1:40:43 ET
Table 'QSIig7BLMc9wY/rgBechzw' 6-max Seat #6 is the button
Seat 1: Z2fXsGcjl+Eax+RzOgwOmg ($110.55 in chips)
Seat 2: mLOIkH/qmRa+mVujQIhBRg ($28.75 in chips)
Seat 3: 4OO5v3AVduL0tePNx8wk5A ($125.20 in chips)
Seat 4: +uSzP8Jwnw7sKfQ4s66b7w ($57.80 in chips)
Seat 5: lsLuWlcPA3Rh7kJVLzMh0Q ($100 in chips)
Seat 6: Wj7mKnRFR90j40wWUu2+Og ($58.50 in chips)
Z2fXsGcjl+Eax+RzOgwOmg: posts small blind $0.50
mLOIkH/qmRa+mVujQIhBRg: posts big blind $1
*** HOLE CARDS ***
4OO5v3AVduL0tePNx8wk5A: folds
+uSzP8Jwnw7sKfQ4s66b7w: folds
lsLuWlcPA3Rh7kJVLzMh0Q: folds
Wj7mKnRFR90j40wWUu2+Og: calls $1
Z2fXsGcjl+Eax+RzOgwOmg: folds
mLOIkH/qmRa+mVujQIhBRg: checks
*** FLOP *** [6s 8s Kh]
mLOIkH/qmRa+mVujQIhBRg: checks
Wj7mKnRFR90j40wWUu2+Og: bets $1
mLOIkH/qmRa+mVujQIhBRg: calls $1
*** TURN *** [6s 8s Kh] [Jh]
mLOIkH/qmRa+mVujQIhBRg: checks
Wj7mKnRFR90j40wWUu2+Og: checks
*** RIVER *** [6s 8s Kh Jh] [4h]
mLOIkH/qmRa+mVujQIhBRg: bets $3
Wj7mKnRFR90j40wWUu2+Og: raises $3 to $6
mLOIkH/qmRa+mVujQIhBRg: folds
Wj7mKnRFR90j40wWUu2+Og collected $10 from pot
*** SUMMARY ***
Total pot $10.50 | Rake $0.50
Board [6s 8s Kh Jh 4h]
Seat 1: Z2fXsGcjl+Eax+RzOgwOmg (small blind) folded before Flop
Seat 2: mLOIkH/qmRa+mVujQIhBRg (big blind) folded on the River
Seat 3: 4OO5v3AVduL0tePNx8wk5A folded before Flop (didn't bet)
Seat 4: +uSzP8Jwnw7sKfQ4s66b7w folded before Flop (didn't bet)
Seat 5: lsLuWlcPA3Rh7kJVLzMh0Q folded before Flop (didn't bet)
Seat 6: Wj7mKnRFR90j40wWUu2+Og (button) collected ($10)



PokerStars Game #59941612564:  Hold'em No Limit ($0.50/$1.00) - 2009/07/01 1:40:44 ET
Table 'vs/5jr6ciwjVQ5+Soc+u2A' 6-max Seat #1 is the button
Seat 1: J798qwLuvXyq0BbzsIjOrA ($199.15 in chips)
Seat 2: lXX4W7m3u++JiSOZ46yVMQ ($99 in chips)
Seat 3: Ws/3Uo3rQIk8hLgW0P+2xA ($95.90 in chips)
Seat 4: 0smcry9L0OOTCP+KzIS5SA ($88 in chips)
Seat 5: +Nt3OPk3XR9SKjZgm2CexQ ($157.85 in chips)
Seat 6: Z2fXsGcjl+Eax+RzOgwOmg ($124 in chips)
lXX4W7m3u++JiSOZ46yVMQ: posts small blind $0.50
Ws/3Uo3rQIk8hLgW0P+2xA: posts big blind $1
*** HOLE CARDS ***
0smcry9L0OOTCP+KzIS5SA: folds
+Nt3OPk3XR9SKjZgm2CexQ: folds
Z2fXsGcjl+Eax+RzOgwOmg: folds
J798qwLuvXyq0BbzsIjOrA: folds
lXX4W7m3u++JiSOZ46yVMQ: folds
Ws/3Uo3rQIk8hLgW0P+2xA collected $1 from pot
*** SUMMARY ***
Total pot $1 | Rake $0
Seat 1: J798qwLuvXyq0BbzsIjOrA (button) folded before Flop (didn't bet)
Seat 2: lXX4W7m3u++JiSOZ46yVMQ (small blind) folded before Flop
Seat 3: Ws/3Uo3rQIk8hLgW0P+2xA (big blind) collected ($1)
Seat 4: 0smcry9L0OOTCP+KzIS5SA folded before Flop (didn't bet)
Seat 5: +Nt3OPk3XR9SKjZgm2CexQ folded before Flop (didn't bet)
Seat 6: Z2fXsGcjl+Eax+RzOgwOmg folded before Flop (didn't bet)



PokerStars Game #59941614194:  Hold'em No Limit ($0.50/$1.00) - 2009/07/01 1:40:46 ET
Table 'W/wyObTiXZm+Ckkl3YxcSw' 6-max Seat #5 is the button
Seat 1: eUBBn2R56C1IQ6Cs/vitwg ($175.55 in chips)
Seat 2: oDiBRCaF0QVtd3kO6xZIXw ($124.30 in chips)
Seat 3: 4OO5v3AVduL0tePNx8wk5A ($100 in chips)
Seat 4: UBZQqpnJZdTYYY1FTb0rLA ($158.20 in chips)
Seat 5: +OrCjyw70oZhJiD22Mn+bg ($200.50 in chips)
Seat 6: b2a+5TkFf4xJN/Ihhma58Q ($33.30 in chips)
b2a+5TkFf4xJN/Ihhma58Q: posts small blind $0.50
eUBBn2R56C1IQ6Cs/vitwg: posts big blind $1
*** HOLE CARDS ***
oDiBRCaF0QVtd3kO6xZIXw: folds
4OO5v3AVduL0tePNx8wk5A: folds
UBZQqpnJZdTYYY1FTb0rLA: folds
+OrCjyw70oZhJiD22Mn+bg: folds
b2a+5TkFf4xJN/Ihhma58Q: calls $0.50
eUBBn2R56C1IQ6Cs/vitwg: raises $3 to $4
b2a+5TkFf4xJN/Ihhma58Q: folds
eUBBn2R56C1IQ6Cs/vitwg collected $2 from pot
*** SUMMARY ***
Total pot $2 | Rake $0
Seat 1: eUBBn2R56C1IQ6Cs/vitwg (big blind) collected ($2)
Seat 2: oDiBRCaF0QVtd3kO6xZIXw folded before Flop (didn't bet)
Seat 3: 4OO5v3AVduL0tePNx8wk5A folded before Flop (didn't bet)
Seat 4: UBZQqpnJZdTYYY1FTb0rLA folded before Flop (didn't bet)
Seat 5: +OrCjyw70oZhJiD22Mn+bg (button) folded before Flop (didn't bet)
Seat 6: b2a+5TkFf4xJN/Ihhma58Q (small blind) folded before Flop



PokerStars Game #59941614908:  Hold'em No Limit ($0.50/$1.00) - 2009/07/01 1:40:48 ET
Table 'MUPc8FEpe/nR0BKSeReX6Q' 6-max Seat #4 is the button
Seat 1: qhkK6+yCciTRd+rCFEbnEQ ($79.10 in chips)
Seat 2: xAU6q2/cwmby2sxmA8VcmA ($103.70 in chips)
Seat 3: wx3sQGkVi2x9wJXuWNHPBw ($286.15 in chips)
Seat 4: r4lpoh2BJZ8S6zyQv1JeSw ($110 in chips)
Seat 5: y27w5IK2WXqmYzS8OU0wKA ($130.05 in chips)
Seat 6: ene3nLSnQ4N961iBaUsSmA ($100 in chips)
y27w5IK2WXqmYzS8OU0wKA: posts small blind $0.50
ene3nLSnQ4N961iBaUsSmA: posts big blind $1
*** HOLE CARDS ***
qhkK6+yCciTRd+rCFEbnEQ: raises $3 to $4
xAU6q2/cwmby2sxmA8VcmA: folds
wx3sQGkVi2x9wJXuWNHPBw: folds
r4lpoh2BJZ8S6zyQv1JeSw: folds
y27w5IK2WXqmYzS8OU0wKA: folds
ene3nLSnQ4N961iBaUsSmA: folds
qhkK6+yCciTRd+rCFEbnEQ collected $2.50 from pot
qhkK6+yCciTRd+rCFEbnEQ: doesn't show hand
*** SUMMARY ***
Total pot $2.50 | Rake $0
Seat 1: qhkK6+yCciTRd+rCFEbnEQ collected ($2.50)
Seat 2: xAU6q2/cwmby2sxmA8VcmA folded before Flop (didn't bet)
Seat 3: wx3sQGkVi2x9wJXuWNHPBw folded before Flop (didn't bet)
Seat 4: r4lpoh2BJZ8S6zyQv1JeSw (button) folded before Flop (didn't bet)
Seat 5: y27w5IK2WXqmYzS8OU0wKA (small blind) folded before Flop
Seat 6: ene3nLSnQ4N961iBaUsSmA (big blind) folded before Flop



PokerStars Game #59941615872:  Hold'em No Limit ($0.50/$1.00) - 2009/07/01 1:40:49 ET
Table 'rmZfTK+oSebeUPJNbWhdAA' 6-max Seat #1 is the button
Seat 1: xAU6q2/cwmby2sxmA8VcmA ($134.50 in chips)
Seat 2: z7O9PO/WEcqRouIydFhS9Q ($185 in chips)
Seat 3: BCEV3COoKY607AzLWayfRA ($218.70 in chips)
Seat 4: 1/mIuXfgx1ZyVkodrmfQDw ($168.35 in chips)
Seat 6: j7NIOHLZk7V2o9fOioO5ug ($102.20 in chips)
z7O9PO/WEcqRouIydFhS9Q: posts small blind $0.50
BCEV3COoKY607AzLWayfRA: posts big blind $1
UOHYuj23MyK9R8ciY2t6FA: sits out
*** HOLE CARDS ***
1/mIuXfgx1ZyVkodrmfQDw: folds
j7NIOHLZk7V2o9fOioO5ug: folds
xAU6q2/cwmby2sxmA8VcmA: raises $3 to $4
z7O9PO/WEcqRouIydFhS9Q: calls $3.50
BCEV3COoKY607AzLWayfRA: folds
*** FLOP *** [Kh Jh 3s]
z7O9PO/WEcqRouIydFhS9Q: checks
xAU6q2/cwmby2sxmA8VcmA: bets $7
z7O9PO/WEcqRouIydFhS9Q: calls $7
*** TURN *** [Kh Jh 3s] [8h]
z7O9PO/WEcqRouIydFhS9Q: checks
xAU6q2/cwmby2sxmA8VcmA: checks
*** RIVER *** [Kh Jh 3s 8h] [4s]
z7O9PO/WEcqRouIydFhS9Q: bets $10
xAU6q2/cwmby2sxmA8VcmA: folds
z7O9PO/WEcqRouIydFhS9Q collected $21.90 from pot
*** SUMMARY ***
Total pot $23 | Rake $1.10
Board [Kh Jh 3s 8h 4s]
Seat 1: xAU6q2/cwmby2sxmA8VcmA (button) folded on the River
Seat 2: z7O9PO/WEcqRouIydFhS9Q (small blind) collected ($21.90)
Seat 3: BCEV3COoKY607AzLWayfRA (big blind) folded before Flop
Seat 4: 1/mIuXfgx1ZyVkodrmfQDw folded before Flop (didn't bet)
Seat 6: j7NIOHLZk7V2o9fOioO5ug folded before Flop (didn't bet)



PokerStars Game #59941616298:  Hold'em No Limit ($0.50/$1.00) - 2009/07/01 1:40:50 ET
Table 'b8oW/dOL7fDza5DfZ/dOJQ' 6-max Seat #6 is the button
Seat 1: NakujTNjHFgzceydFf+E2Q ($52.50 in chips)
Seat 2: TSuRyAHnUPCFjP7Z0rEE0w ($119 in chips)
Seat 3: d8WX+9nUHoqlrAGagO0Wow ($34.30 in chips)
Seat 4: 8rDbzImSi1zgxtqtF1pSbA ($11.50 in chips)
Seat 5: sr/OkkgqNbtgwJf1tmnfNg ($58.50 in chips)
Seat 6: PvfYaKbzMpsmUcbOExckbQ ($160.85 in chips)
NakujTNjHFgzceydFf+E2Q: posts small blind $0.50
TSuRyAHnUPCFjP7Z0rEE0w: posts big blind $1
*** HOLE CARDS ***
d8WX+9nUHoqlrAGagO0Wow: folds
8rDbzImSi1zgxtqtF1pSbA: calls $1
sr/OkkgqNbtgwJf1tmnfNg: raises $3 to $4
PvfYaKbzMpsmUcbOExckbQ: folds
NakujTNjHFgzceydFf+E2Q: folds
TSuRyAHnUPCFjP7Z0rEE0w: folds
8rDbzImSi1zgxtqtF1pSbA: folds
sr/OkkgqNbtgwJf1tmnfNg collected $3.50 from pot
*** SUMMARY ***
Total pot $3.50 | Rake $0
Seat 1: NakujTNjHFgzceydFf+E2Q (small blind) folded before Flop
Seat 2: TSuRyAHnUPCFjP7Z0rEE0w (big blind) folded before Flop
Seat 3: d8WX+9nUHoqlrAGagO0Wow folded before Flop (didn't bet)
Seat 4: 8rDbzImSi1zgxtqtF1pSbA folded before Flop
Seat 5: sr/OkkgqNbtgwJf1tmnfNg collected ($3.50)
Seat 6: PvfYaKbzMpsmUcbOExckbQ (button) folded before Flop (didn't bet)



PokerStars Game #59941616824:  Hold'em No Limit ($0.50/$1.00) - 2009/07/01 1:40:51 ET
Table 'fZjVbKj9D8yOB+Rj7NaP/A' 9-max Seat #9 is the button
Seat 2: PTAFYDIUSsG+SArbxNl+Aw ($100 in chips)
Seat 3: yAbu2QsRPVcjPbqlf/jDxw ($103.65 in chips)
Seat 4: 997ViqAtWn1FPjJqcffwcA ($100 in chips)
Seat 5: PkGfq5xrSlNsujKaG/HF4Q ($100 in chips)
Seat 6: OvwYHV65yUbgdBjSmo1+5g ($135.45 in chips)
Seat 7: SyS20PAm3RpT6uLBsGkwOA ($100 in chips)
Seat 8: EVvb0huXeMB7dnOAiO4ggA ($48.50 in chips)
Seat 9: qheQay5YvP2DMAb3OUSxtw ($148.60 in chips)
PTAFYDIUSsG+SArbxNl+Aw: posts small blind $0.50
yAbu2QsRPVcjPbqlf/jDxw: posts big blind $1
*** HOLE CARDS ***
997ViqAtWn1FPjJqcffwcA: raises $3 to $4
PkGfq5xrSlNsujKaG/HF4Q: folds
OvwYHV65yUbgdBjSmo1+5g: folds
SyS20PAm3RpT6uLBsGkwOA: folds
EVvb0huXeMB7dnOAiO4ggA: folds
qheQay5YvP2DMAb3OUSxtw: folds
PTAFYDIUSsG+SArbxNl+Aw: folds
yAbu2QsRPVcjPbqlf/jDxw: folds
997ViqAtWn1FPjJqcffwcA collected $2.50 from pot
*** SUMMARY ***
Total pot $2.50 | Rake $0
Seat 2: PTAFYDIUSsG+SArbxNl+Aw (small blind) folded before Flop
Seat 3: yAbu2QsRPVcjPbqlf/jDxw (big blind) folded before Flop
Seat 4: 997ViqAtWn1FPjJqcffwcA collected ($2.50)
Seat 5: PkGfq5xrSlNsujKaG/HF4Q folded before Flop (didn't bet)
Seat 6: OvwYHV65yUbgdBjSmo1+5g folded before Flop (didn't bet)
Seat 7: SyS20PAm3RpT6uLBsGkwOA folded before Flop (didn't bet)
Seat 8: EVvb0huXeMB7dnOAiO4ggA folded before Flop (didn't bet)
Seat 9: qheQay5YvP2DMAb3OUSxtw (button) folded before Flop (didn't bet)



PokerStars Game #59941618036:  Hold'em No Limit ($0.50/$1.00) - 2009/07/01 1:40:53 ET
Table 'pHrhryH8jPNdQfY62f8v+g' 6-max Seat #2 is the button
Seat 1: 4d1rWhpu8DzLmzMbR3QKyA ($147.45 in chips)
Seat 2: JwCcjZl0bjJzG7hmE0dnTA ($109.55 in chips)
Seat 3: 8oS5O7iD/qnFXFXJrGIgNQ ($111.30 in chips)
Seat 4: 1f3beyIML24UqEMTbWy93g ($57.85 in chips)
Seat 5: d8WX+9nUHoqlrAGagO0Wow ($20 in chips)
Seat 6: xAU6q2/cwmby2sxmA8VcmA ($199.30 in chips)
8oS5O7iD/qnFXFXJrGIgNQ: posts small blind $0.50
1f3beyIML24UqEMTbWy93g: posts big blind $1
*** HOLE CARDS ***
d8WX+9nUHoqlrAGagO0Wow: folds
xAU6q2/cwmby2sxmA8VcmA: folds
4d1rWhpu8DzLmzMbR3QKyA: folds
JwCcjZl0bjJzG7hmE0dnTA: raises $3 to $4
8oS5O7iD/qnFXFXJrGIgNQ: folds
1f3beyIML24UqEMTbWy93g: calls $3
*** FLOP *** [9h 6h 8s]
1f3beyIML24UqEMTbWy93g: checks
JwCcjZl0bjJzG7hmE0dnTA: checks
*** TURN *** [9h 6h 8s] [Js]
1f3beyIML24UqEMTbWy93g: bets $5
JwCcjZl0bjJzG7hmE0dnTA: calls $5
*** RIVER *** [9h 6h 8s Js] [5c]
1f3beyIML24UqEMTbWy93g: bets $1
JwCcjZl0bjJzG7hmE0dnTA: raises $13 to $14
1f3beyIML24UqEMTbWy93g: folds
JwCcjZl0bjJzG7hmE0dnTA collected $19.55 from pot
*** SUMMARY ***
Total pot $20.50 | Rake $0.95
Board [9h 6h 8s Js 5c]
Seat 1: 4d1rWhpu8DzLmzMbR3QKyA folded before Flop (didn't bet)
Seat 2: JwCcjZl0bjJzG7hmE0dnTA (button) collected ($19.55)
Seat 3: 8oS5O7iD/qnFXFXJrGIgNQ (small blind) folded before Flop
Seat 4: 1f3beyIML24UqEMTbWy93g (big blind) folded on the River
Seat 5: d8WX+9nUHoqlrAGagO0Wow folded before Flop (didn't bet)
Seat 6: xAU6q2/cwmby2sxmA8VcmA folded before Flop (didn't bet)



PokerStars Game #59941619264:  Hold'em No Limit ($0.50/$1.00) - 2009/07/01 1:40:55 ET
Table 'O96CPOtvMBWP6kzuYDfdFA' 6-max Seat #6 is the button
Seat 1: 6alLXQIITA2EZ/lBeym8Dw ($132.25 in chips)
Seat 2: 4d1rWhpu8DzLmzMbR3QKyA ($100 in chips)
Seat 3: ieBUmHu5QBR86BArTtK4FQ ($20.05 in chips)
Seat 4: /P4w1pHg2zHYg/4ubJ0dPw ($65.45 in chips)
Seat 5: vX+iYAEINFeLxwMla7DY1Q ($98.50 in chips)
Seat 6: 3syOXva630dm1FTdwnuLpw ($77.65 in chips)
6alLXQIITA2EZ/lBeym8Dw: posts small blind $0.50
4d1rWhpu8DzLmzMbR3QKyA: posts big blind $1
*** HOLE CARDS ***
ieBUmHu5QBR86BArTtK4FQ: folds
/P4w1pHg2zHYg/4ubJ0dPw: folds
vX+iYAEINFeLxwMla7DY1Q: raises $2 to $3
3syOXva630dm1FTdwnuLpw: calls $3
6alLXQIITA2EZ/lBeym8Dw: folds
4d1rWhpu8DzLmzMbR3QKyA: folds
*** FLOP *** [Kd Ts 7s]
vX+iYAEINFeLxwMla7DY1Q: checks
3syOXva630dm1FTdwnuLpw: checks
*** TURN *** [Kd Ts 7s] [8s]
vX+iYAEINFeLxwMla7DY1Q: bets $5
3syOXva630dm1FTdwnuLpw: calls $5
*** RIVER *** [Kd Ts 7s 8s] [4h]
vX+iYAEINFeLxwMla7DY1Q: checks
3syOXva630dm1FTdwnuLpw: checks
*** SHOW DOWN ***
vX+iYAEINFeLxwMla7DY1Q: shows [Tc 9c] (a pair of Tens)
3syOXva630dm1FTdwnuLpw: shows [Jd Td] (a pair of Tens - King+Jack kicker)
3syOXva630dm1FTdwnuLpw collected $16.65 from pot
*** SUMMARY ***
Total pot $17.50 | Rake $0.85
Board [Kd Ts 7s 8s 4h]
Seat 1: 6alLXQIITA2EZ/lBeym8Dw (small blind) folded before Flop
Seat 2: 4d1rWhpu8DzLmzMbR3QKyA (big blind) folded before Flop
Seat 3: ieBUmHu5QBR86BArTtK4FQ folded before Flop (didn't bet)
Seat 4: /P4w1pHg2zHYg/4ubJ0dPw folded before Flop (didn't bet)
Seat 5: vX+iYAEINFeLxwMla7DY1Q showed [Tc 9c] and lost with a pair of Tens
Seat 6: 3syOXva630dm1FTdwnuLpw (button) showed [Jd Td] and won ($16.65) with a pair of Tens



PokerStars Game #59941619540:  Hold'em No Limit ($0.50/$1.00) - 2009/07/01 1:40:56 ET
Table 'ZFWj23PMihdwrNWv41OG/QtyUh+jyNvrceIQdKMJjQ2weat #1 is the button
Seat 1: j3hj7KQwBVU5NTFmtYomSw ($86.25 in chips)
Seat 2: 0smcry9L0OOTCP+KzIS5SA ($96 in chips)
Seat 3: cWwhvq/+r/w8nkhwrJoekQ ($48.70 in chips)
Seat 4: O5ZesE/6mHyuWWbvkiH/Fg ($70.70 in chips)
Seat 5: j7NIOHLZk7V2o9fOioO5ug ($101.70 in chips)
Seat 6: u23r4AyKPgHioZ6t7z6qrA ($100 in chips)
0smcry9L0OOTCP+KzIS5SA: posts small blind $0.50
cWwhvq/+r/w8nkhwrJoekQ: posts big blind $1
*** HOLE CARDS ***
O5ZesE/6mHyuWWbvkiH/Fg: folds
j7NIOHLZk7V2o9fOioO5ug: folds
u23r4AyKPgHioZ6t7z6qrA: folds
j3hj7KQwBVU5NTFmtYomSw: folds
0smcry9L0OOTCP+KzIS5SA: folds
cWwhvq/+r/w8nkhwrJoekQ collected $1 from pot
*** SUMMARY ***
Total pot $1 | Rake $0
Seat 1: j3hj7KQwBVU5NTFmtYomSw (button) folded before Flop (didn't bet)
Seat 2: 0smcry9L0OOTCP+KzIS5SA (small blind) folded before Flop
Seat 3: cWwhvq/+r/w8nkhwrJoekQ (big blind) collected ($1)
Seat 4: O5ZesE/6mHyuWWbvkiH/Fg folded before Flop (didn't bet)
Seat 5: j7NIOHLZk7V2o9fOioO5ug folded before Flop (didn't bet)
Seat 6: u23r4AyKPgHioZ6t7z6qrA folded before Flop (didn't bet)



PokerStars Game #59941619646:  Hold'em No Limit ($0.50/$1.00) - 2009/07/01 1:40:56 ET
Table 'DE4ps3MTl+4avTytwFENAg' 6-max Seat #1 is the button
Seat 1: PvfYaKbzMpsmUcbOExckbQ ($101.50 in chips)
Seat 2: QHvTZcrKe6+maWUfVjP29Q ($100 in chips)
Seat 3: cGayYjcyk6+jN57tzIY4TA ($305.10 in chips)
Seat 4: iexehpxaQwzColGqeTEnLQ ($121.85 in chips)
Seat 5: UBZQqpnJZdTYYY1FTb0rLA ($174.90 in chips)
Seat 6: lsLuWlcPA3Rh7kJVLzMh0Q ($100 in chips)
QHvTZcrKe6+maWUfVjP29Q: posts small blind $0.50
cGayYjcyk6+jN57tzIY4TA: posts big blind $1
*** HOLE CARDS ***
iexehpxaQwzColGqeTEnLQ: folds
UBZQqpnJZdTYYY1FTb0rLA: raises $2 to $3
lsLuWlcPA3Rh7kJVLzMh0Q: folds
PvfYaKbzMpsmUcbOExckbQ: raises $6 to $9
QHvTZcrKe6+maWUfVjP29Q: folds
cGayYjcyk6+jN57tzIY4TA: folds
UBZQqpnJZdTYYY1FTb0rLA: calls $6
*** FLOP *** [6d Jd Ad]
UBZQqpnJZdTYYY1FTb0rLA: checks
PvfYaKbzMpsmUcbOExckbQ: checks
*** TURN *** [6d Jd Ad] [3d]
UBZQqpnJZdTYYY1FTb0rLA: checks
PvfYaKbzMpsmUcbOExckbQ: checks
*** RIVER *** [6d Jd Ad 3d] [Qd]
UBZQqpnJZdTYYY1FTb0rLA: checks
PvfYaKbzMpsmUcbOExckbQ: checks
*** SHOW DOWN ***
UBZQqpnJZdTYYY1FTb0rLA: shows [Jh Ah] (a flush, Ace high)
PvfYaKbzMpsmUcbOExckbQ: shows [Kc Ks] (a flush, Ace high)
UBZQqpnJZdTYYY1FTb0rLA collected $9.30 from pot
PvfYaKbzMpsmUcbOExckbQ collected $9.25 from pot
*** SUMMARY ***
Total pot $19.50 | Rake $0.95
Board [6d Jd Ad 3d Qd]
Seat 1: PvfYaKbzMpsmUcbOExckbQ (button) showed [Kc Ks] and won ($9.25) with a flush, Ace high
Seat 2: QHvTZcrKe6+maWUfVjP29Q (small blind) folded before Flop
Seat 3: cGayYjcyk6+jN57tzIY4TA (big blind) folded before Flop
Seat 4: iexehpxaQwzColGqeTEnLQ folded before Flop (didn't bet)
Seat 5: UBZQqpnJZdTYYY1FTb0rLA showed [Jh Ah] and won ($9.30) with a flush, Ace high
Seat 6: lsLuWlcPA3Rh7kJVLzMh0Q folded before Flop (didn't bet)



PokerStars Game #59941619610:  Hold'em No Limit ($0.50/$1.00) - 2009/07/01 1:40:56 ET
Table 'NqGO/cV3MwFAx+ZPB5ANmQ' 2-max Seat #1 is the button
Seat 1: ItaRAnHOgvYOv5ynbG1iTw ($250.20 in chips)
Seat 2: GtFB+yyeb2djMdPFuOW/Xg ($102.70 in chips)
ItaRAnHOgvYOv5ynbG1iTw: posts small blind $0.50
GtFB+yyeb2djMdPFuOW/Xg: posts big blind $1
*** HOLE CARDS ***
ItaRAnHOgvYOv5ynbG1iTw: raises $2 to $3
GtFB+yyeb2djMdPFuOW/Xg: raises $8 to $11
ItaRAnHOgvYOv5ynbG1iTw: calls $8
*** FLOP *** [Jh 5h 9c]
GtFB+yyeb2djMdPFuOW/Xg: bets $15
ItaRAnHOgvYOv5ynbG1iTw: calls $15
*** TURN *** [Jh 5h 9c] [7c]
GtFB+yyeb2djMdPFuOW/Xg: checks
ItaRAnHOgvYOv5ynbG1iTw: bets $30
GtFB+yyeb2djMdPFuOW/Xg: folds
ItaRAnHOgvYOv5ynbG1iTw collected $51.50 from pot
*** SUMMARY ***
Total pot $52 | Rake $0.50
Board [Jh 5h 9c 7c]
Seat 1: ItaRAnHOgvYOv5ynbG1iTw (button) (small blind) collected ($51.50)
Seat 2: GtFB+yyeb2djMdPFuOW/Xg (big blind) folded on the Turn



PokerStars Game #59941619578:  Hold'em No Limit ($0.50/$1.00) - 2009/07/01 1:40:56 ET
Table 'SQLOQoANiHscJ8AL7zffbw' 9-max Seat #1 is the button
Seat 1: jPTRd6SpCp4xqAy2XQiTOw ($52.90 in chips)
Seat 2: /zy+DB4S5fUQUSfZWFzYGw ($387.65 in chips)
Seat 4: 5z1PAR8SNow/zUfYNbwq7A ($36 in chips)
Seat 5: L9njYvloJ1NdXjP8edHEAg ($119.70 in chips)
Seat 6: H+DVy3Ei8L1UKS2tVOtJcw ($100 in chips)
Seat 8: 9BZCcac3+McErkkSN2YScA ($104.50 in chips)
Seat 9: XE5QF1y74bpHog9JxWJMWQ ($106.70 in chips)
/zy+DB4S5fUQUSfZWFzYGw: posts small blind $0.50
5z1PAR8SNow/zUfYNbwq7A: posts big blind $1
*** HOLE CARDS ***
L9njYvloJ1NdXjP8edHEAg: folds
H+DVy3Ei8L1UKS2tVOtJcw: folds
9BZCcac3+McErkkSN2YScA: folds
XE5QF1y74bpHog9JxWJMWQ: folds
jPTRd6SpCp4xqAy2XQiTOw: calls $1
/zy+DB4S5fUQUSfZWFzYGw: folds
5z1PAR8SNow/zUfYNbwq7A: checks
*** FLOP *** [8h Tc 3s]
5z1PAR8SNow/zUfYNbwq7A: bets $1
jPTRd6SpCp4xqAy2XQiTOw: calls $1
*** TURN *** [8h Tc 3s] [Kc]
5z1PAR8SNow/zUfYNbwq7A: bets $1
jPTRd6SpCp4xqAy2XQiTOw: calls $1
*** RIVER *** [8h Tc 3s Kc] [2h]
5z1PAR8SNow/zUfYNbwq7A: checks
jPTRd6SpCp4xqAy2XQiTOw: bets $5
5z1PAR8SNow/zUfYNbwq7A: folds
jPTRd6SpCp4xqAy2XQiTOw collected $6.20 from pot
*** SUMMARY ***
Total pot $6.50 | Rake $0.30
Board [8h Tc 3s Kc 2h]
Seat 1: jPTRd6SpCp4xqAy2XQiTOw (button) collected ($6.20)
Seat 2: /zy+DB4S5fUQUSfZWFzYGw (small blind) folded before Flop
Seat 4: 5z1PAR8SNow/zUfYNbwq7A (big blind) folded on the River
Seat 5: L9njYvloJ1NdXjP8edHEAg folded before Flop (didn't bet)
Seat 6: H+DVy3Ei8L1UKS2tVOtJcw folded before Flop (didn't bet)
Seat 8: 9BZCcac3+McErkkSN2YScA folded before Flop (didn't bet)
Seat 9: XE5QF1y74bpHog9JxWJMWQ folded before Flop (didn't bet)



PokerStars Game #59941619986:  Hold'em No Limit ($0.50/$1.00) - 2009/07/01 1:40:57 ET
Table 'N2bNCDHL96aCQDvZIh+yQQ' 6-max Seat #4 is the button
Seat 1: Jjgflx10PVjcLkziEmLhSA ($93.75 in chips)
Seat 2: y27w5IK2WXqmYzS8OU0wKA ($128.65 in chips)
Seat 3: UBZQqpnJZdTYYY1FTb0rLA ($120.55 in chips)
Seat 4: uCqEjnxh2/vFBjKYkfTOkw ($174.30 in chips)
Seat 6: idVgoPAdspFPCzee6aF9Pg ($106.40 in chips)
ene3nLSnQ4N961iBaUsSmA will be allowed to play after the button
idVgoPAdspFPCzee6aF9Pg: posts small blind $0.50
Jjgflx10PVjcLkziEmLhSA: posts big blind $1
*** HOLE CARDS ***
y27w5IK2WXqmYzS8OU0wKA: raises $2 to $3
UBZQqpnJZdTYYY1FTb0rLA: folds
uCqEjnxh2/vFBjKYkfTOkw: folds
idVgoPAdspFPCzee6aF9Pg: folds
Jjgflx10PVjcLkziEmLhSA: folds
y27w5IK2WXqmYzS8OU0wKA collected $2.50 from pot
y27w5IK2WXqmYzS8OU0wKA: doesn't show hand
*** SUMMARY ***
Total pot $2.50 | Rake $0
Seat 1: Jjgflx10PVjcLkziEmLhSA (big blind) folded before Flop
Seat 2: y27w5IK2WXqmYzS8OU0wKA collected ($2.50)
Seat 3: UBZQqpnJZdTYYY1FTb0rLA folded before Flop (didn't bet)
Seat 4: uCqEjnxh2/vFBjKYkfTOkw (button) folded before Flop (didn't bet)
Seat 6: idVgoPAdspFPCzee6aF9Pg (small blind) folded before Flop



PokerStars Game #59941620634:  Hold'em No Limit ($0.50/$1.00) - 2009/07/01 1:40:58 ET
Table 'vs/5jr6ciwjVQ5+Soc+u2A' 6-max Seat #2 is the button
Seat 1: J798qwLuvXyq0BbzsIjOrA ($199.15 in chips)
Seat 2: lXX4W7m3u++JiSOZ46yVMQ ($98.50 in chips)
Seat 3: Ws/3Uo3rQIk8hLgW0P+2xA ($96.40 in chips)
Seat 4: 0smcry9L0OOTCP+KzIS5SA ($88 in chips)
Seat 5: +Nt3OPk3XR9SKjZgm2CexQ ($157.85 in chips)
Seat 6: Z2fXsGcjl+Eax+RzOgwOmg ($124 in chips)
Ws/3Uo3rQIk8hLgW0P+2xA: posts small blind $0.50
0smcry9L0OOTCP+KzIS5SA: posts big blind $1
*** HOLE CARDS ***
+Nt3OPk3XR9SKjZgm2CexQ: raises $2 to $3
Z2fXsGcjl+Eax+RzOgwOmg: folds
J798qwLuvXyq0BbzsIjOrA: folds
lXX4W7m3u++JiSOZ46yVMQ: folds
Ws/3Uo3rQIk8hLgW0P+2xA: folds
0smcry9L0OOTCP+KzIS5SA: folds
+Nt3OPk3XR9SKjZgm2CexQ collected $2.50 from pot
+Nt3OPk3XR9SKjZgm2CexQ: doesn't show hand
*** SUMMARY ***
Total pot $2.50 | Rake $0
Seat 1: J798qwLuvXyq0BbzsIjOrA folded before Flop (didn't bet)
Seat 2: lXX4W7m3u++JiSOZ46yVMQ (button) folded before Flop (didn't bet)
Seat 3: Ws/3Uo3rQIk8hLgW0P+2xA (small blind) folded before Flop
Seat 4: 0smcry9L0OOTCP+KzIS5SA (big blind) folded before Flop
Seat 5: +Nt3OPk3XR9SKjZgm2CexQ collected ($2.50)
Seat 6: Z2fXsGcjl+Eax+RzOgwOmg folded before Flop (didn't bet)



PokerStars Game #59941622612:  Hold'em No Limit ($0.50/$1.00) - 2009/07/01 1:41:01 ET
Table 'gxFK0BVUD7cupu2uyRUZJg' 6-max Seat #3 is the button
Seat 1: M+X3uChmP6R63IwijVjgTg ($218.40 in chips)
Seat 2: hpxXcmRkXXI9HE5+5/j/0Q ($131.55 in chips)
Seat 3: Z2fXsGcjl+Eax+RzOgwOmg ($100 in chips)
Seat 4: Hcr4S4Nbkj5idKsvYK/eqQ ($100.50 in chips)
Seat 5: 0smcry9L0OOTCP+KzIS5SA ($210 in chips)
Seat 6: dYyb6/42PMC8aNFlm/eBeQ ($141.25 in chips)
Hcr4S4Nbkj5idKsvYK/eqQ: posts small blind $0.50
0smcry9L0OOTCP+KzIS5SA: posts big blind $1
*** HOLE CARDS ***
dYyb6/42PMC8aNFlm/eBeQ: folds
M+X3uChmP6R63IwijVjgTg: folds
hpxXcmRkXXI9HE5+5/j/0Q: folds
Z2fXsGcjl+Eax+RzOgwOmg: folds
Hcr4S4Nbkj5idKsvYK/eqQ: folds
0smcry9L0OOTCP+KzIS5SA collected $1 from pot
0smcry9L0OOTCP+KzIS5SA: doesn't show hand
*** SUMMARY ***
Total pot $1 | Rake $0
Seat 1: M+X3uChmP6R63IwijVjgTg folded before Flop (didn't bet)
Seat 2: hpxXcmRkXXI9HE5+5/j/0Q folded before Flop (didn't bet)
Seat 3: Z2fXsGcjl+Eax+RzOgwOmg (button) folded before Flop (didn't bet)
Seat 4: Hcr4S4Nbkj5idKsvYK/eqQ (small blind) folded before Flop
Seat 5: 0smcry9L0OOTCP+KzIS5SA (big blind) collected ($1)
Seat 6: dYyb6/42PMC8aNFlm/eBeQ folded before Flop (didn't bet)



PokerStars Game #59941623742:  Hold'em No Limit ($0.50/$1.00) - 2009/07/01 1:41:03 ET
Table '305hiksPPCCdC6V2LNsO5w' 6-max Seat #3 is the button
Seat 1: RTuDLJHh/9zPfBftoc9vsw ($8.25 in chips)
Seat 2: j7NIOHLZk7V2o9fOioO5ug ($159.20 in chips)
Seat 3: +zIVjZKLpcidfRHgVZW8lA ($28.50 in chips)
Seat 4: uJVSceLggtsrJya+WtmUEA ($202.80 in chips)
Seat 5: +Nt3OPk3XR9SKjZgm2CexQ ($100 in chips)
Seat 6: 9/Tq8dw7kWW68uN8bFupXg ($18.95 in chips)
uJVSceLggtsrJya+WtmUEA: posts small blind $0.50
+Nt3OPk3XR9SKjZgm2CexQ: posts big blind $1
*** HOLE CARDS ***
9/Tq8dw7kWW68uN8bFupXg: folds
RTuDLJHh/9zPfBftoc9vsw: folds
j7NIOHLZk7V2o9fOioO5ug: folds
+zIVjZKLpcidfRHgVZW8lA: folds
uJVSceLggtsrJya+WtmUEA: folds
+Nt3OPk3XR9SKjZgm2CexQ collected $1 from pot
*** SUMMARY ***
Total pot $1 | Rake $0
Seat 1: RTuDLJHh/9zPfBftoc9vsw folded before Flop (didn't bet)
Seat 2: j7NIOHLZk7V2o9fOioO5ug folded before Flop (didn't bet)
Seat 3: +zIVjZKLpcidfRHgVZW8lA (button) folded before Flop (didn't bet)
Seat 4: uJVSceLggtsrJya+WtmUEA (small blind) folded before Flop
Seat 5: +Nt3OPk3XR9SKjZgm2CexQ (big blind) collected ($1)
Seat 6: 9/Tq8dw7kWW68uN8bFupXg folded before Flop (didn't bet)



PokerStars Game #59941624490:  Hold'em No Limit ($0.50/$1.00) - 2009/07/01 1:41:04 ET
Table 'tJq9SfN1ywY0r03VBlWlwQ' 9-max Seat #7 is the button
Seat 1: wZsU+w9r7G66x93UuvBf1Q ($300.05 in chips)
Seat 2: VPF+HjszMvUIpy0CHIwH3A ($18.50 in chips)
Seat 4: bLbSOSmSOnqE0iTcH/5dxA ($118.20 in chips)
Seat 5: h5ipsNTMyolp7xn/NAvWkA ($124.80 in chips)
Seat 6: gUUvmqdVlmvpal6B8nYrmg ($108.60 in chips)
Seat 7: Ogn4JDV3mp4ZDKO49IFzKA ($18.40 in chips)
Seat 8: G4DEhsZFmznGNVpy2SEocA ($39.80 in chips)
Seat 9: XE5QF1y74bpHog9JxWJMWQ ($100 in chips)
G4DEhsZFmznGNVpy2SEocA: posts small blind $0.50
XE5QF1y74bpHog9JxWJMWQ: posts big blind $1
*** HOLE CARDS ***
wZsU+w9r7G66x93UuvBf1Q: raises $3 to $4
VPF+HjszMvUIpy0CHIwH3A: folds
bLbSOSmSOnqE0iTcH/5dxA: folds
h5ipsNTMyolp7xn/NAvWkA: folds
gUUvmqdVlmvpal6B8nYrmg: folds
Ogn4JDV3mp4ZDKO49IFzKA: folds
G4DEhsZFmznGNVpy2SEocA: folds
XE5QF1y74bpHog9JxWJMWQ: folds
wZsU+w9r7G66x93UuvBf1Q collected $2.50 from pot
*** SUMMARY ***
Total pot $2.50 | Rake $0
Seat 1: wZsU+w9r7G66x93UuvBf1Q collected ($2.50)
Seat 2: VPF+HjszMvUIpy0CHIwH3A folded before Flop (didn't bet)
Seat 4: bLbSOSmSOnqE0iTcH/5dxA folded before Flop (didn't bet)
Seat 5: h5ipsNTMyolp7xn/NAvWkA folded before Flop (didn't bet)
Seat 6: gUUvmqdVlmvpal6B8nYrmg folded before Flop (didn't bet)
Seat 7: Ogn4JDV3mp4ZDKO49IFzKA (button) folded before Flop (didn't bet)
Seat 8: G4DEhsZFmznGNVpy2SEocA (small blind) folded before Flop
Seat 9: XE5QF1y74bpHog9JxWJMWQ (big blind) folded before Flop



PokerStars Game #59941624832:  Hold'em No Limit ($0.50/$1.00) - 2009/07/01 1:41:05 ET
Table 'qj0HBN4HhQKogreu1bg7xg' 2-max Seat #1 is the button
Seat 1: NYi6JFscYNrofSXy4sM+Yw ($134.10 in chips)
Seat 2: qtyl8CSb0/4yWdbuEPJejA ($143.30 in chips)
NYi6JFscYNrofSXy4sM+Yw: posts small blind $0.50
qtyl8CSb0/4yWdbuEPJejA: posts big blind $1
*** HOLE CARDS ***
NYi6JFscYNrofSXy4sM+Yw: raises $2 to $3
qtyl8CSb0/4yWdbuEPJejA: folds
NYi6JFscYNrofSXy4sM+Yw collected $2 from pot
*** SUMMARY ***
Total pot $2 | Rake $0
Seat 1: NYi6JFscYNrofSXy4sM+Yw (button) (small blind) collected ($2)
Seat 2: qtyl8CSb0/4yWdbuEPJejA (big blind) folded before Flop



PokerStars Game #59941625924:  Hold'em No Limit ($0.50/$1.00) - 2009/07/01 1:41:07 ET
Table 'blHlQApStil0OPeQxQxPcw' 9-max Seat #7 is the button
Seat 1: Pp/KTcXkfZKKUHkjyaLTdg ($24.10 in chips)
Seat 2: V138SURkdX8LdVBPKdJJag ($122.85 in chips)
Seat 3: OGgaARGdJQT4awWVNQ957w ($100 in chips)
Seat 4: 1862487932 ($102.15 in chips)
Seat 5: uXrDE6JrIi8BZK1L8oQ9bQ ($38.10 in chips)
Seat 6: vljeiOoWscAIXU0fCuiEBw ($48.65 in chips)
Seat 7: VPF+HjszMvUIpy0CHIwH3A ($20 in chips)
Seat 9: 6XkTu4ahxzHnvjjc1R8YjQ ($154.35 in chips)
6XkTu4ahxzHnvjjc1R8YjQ: posts small blind $0.50
Pp/KTcXkfZKKUHkjyaLTdg: posts big blind $1
*** HOLE CARDS ***
V138SURkdX8LdVBPKdJJag: folds
OGgaARGdJQT4awWVNQ957w: folds
1862487932: folds
uXrDE6JrIi8BZK1L8oQ9bQ: folds
vljeiOoWscAIXU0fCuiEBw: raises $1 to $2
VPF+HjszMvUIpy0CHIwH3A: folds
6XkTu4ahxzHnvjjc1R8YjQ: folds
Pp/KTcXkfZKKUHkjyaLTdg: folds
vljeiOoWscAIXU0fCuiEBw collected $2.50 from pot
vljeiOoWscAIXU0fCuiEBw: shows [Tc Ts] (a pair of Tens)
*** SUMMARY ***
Total pot $2.50 | Rake $0
Seat 1: Pp/KTcXkfZKKUHkjyaLTdg (big blind) folded before Flop
Seat 2: V138SURkdX8LdVBPKdJJag folded before Flop (didn't bet)
Seat 3: OGgaARGdJQT4awWVNQ957w folded before Flop (didn't bet)
Seat 4: 1862487932 folded before Flop (didn't bet)
Seat 5: uXrDE6JrIi8BZK1L8oQ9bQ folded before Flop (didn't bet)
Seat 6: vljeiOoWscAIXU0fCuiEBw collected ($2.50)
Seat 7: VPF+HjszMvUIpy0CHIwH3A (button) folded before Flop (didn't bet)
Seat 9: 6XkTu4ahxzHnvjjc1R8YjQ (small blind) folded before Flop



PokerStars Game #59941627216:  Hold'em No Limit ($0.50/$1.00) - 2009/07/01 1:41:09 ET
Table 'b8oW/dOL7fDza5DfZ/dOJQ' 6-max Seat #1 is the button
Seat 1: NakujTNjHFgzceydFf+E2Q ($52 in chips)
Seat 2: TSuRyAHnUPCFjP7Z0rEE0w ($118 in chips)
Seat 3: d8WX+9nUHoqlrAGagO0Wow ($34.30 in chips)
Seat 4: 8rDbzImSi1zgxtqtF1pSbA ($10.50 in chips)
Seat 5: sr/OkkgqNbtgwJf1tmnfNg ($61 in chips)
Seat 6: PvfYaKbzMpsmUcbOExckbQ ($160.85 in chips)
TSuRyAHnUPCFjP7Z0rEE0w: posts small blind $0.50
d8WX+9nUHoqlrAGagO0Wow: posts big blind $1
*** HOLE CARDS ***
8rDbzImSi1zgxtqtF1pSbA: folds
sr/OkkgqNbtgwJf1tmnfNg: folds
PvfYaKbzMpsmUcbOExckbQ: folds
NakujTNjHFgzceydFf+E2Q: calls $1
TSuRyAHnUPCFjP7Z0rEE0w: folds
d8WX+9nUHoqlrAGagO0Wow: checks
*** FLOP *** [5c 6c Td]
d8WX+9nUHoqlrAGagO0Wow: checks
NakujTNjHFgzceydFf+E2Q: bets $2
d8WX+9nUHoqlrAGagO0Wow: folds
NakujTNjHFgzceydFf+E2Q collected $2.40 from pot
*** SUMMARY ***
Total pot $2.50 | Rake $0.10
Board [5c 6c Td]
Seat 1: NakujTNjHFgzceydFf+E2Q (button) collected ($2.40)
Seat 2: TSuRyAHnUPCFjP7Z0rEE0w (small blind) folded before Flop
Seat 3: d8WX+9nUHoqlrAGagO0Wow (big blind) folded on the Flop
Seat 4: 8rDbzImSi1zgxtqtF1pSbA folded before Flop (didn't bet)
Seat 5: sr/OkkgqNbtgwJf1tmnfNg folded before Flop (didn't bet)
Seat 6: PvfYaKbzMpsmUcbOExckbQ folded before Flop (didn't bet)



PokerStars Game #59941629096:  Hold'em No Limit ($0.50/$1.00) - 2009/07/01 1:41:13 ET
Table 'uNlePsyMIqzM691Xkrlk6Q' 9-max Seat #5 is the button
Seat 1: bLbSOSmSOnqE0iTcH/5dxA ($110.90 in chips)
Seat 2: TAfo4veNRaRlzDXMMYS3Jg ($18.50 in chips)
Seat 3: h7qXkU57Bb8ZuPwMyxR8Ug ($119 in chips)
Seat 4: WRTVKFHeb0vRJnVi5NdJZw ($41.40 in chips)
Seat 5: G9Fo2TZCN7HI43Po4zSN3A ($109.40 in chips)
Seat 6: mMc/PBpqlN24gdi3C/1tOw ($40 in chips)
Seat 7: KNAaBvPYSXyLqb88ypSbuQ ($36.05 in chips)
Seat 8: yWcEtGJ3ijZsF6HqlHqkrg ($118.70 in chips)
Seat 9: OGgaARGdJQT4awWVNQ957w ($113.60 in chips)
mMc/PBpqlN24gdi3C/1tOw: posts small blind $0.50
KNAaBvPYSXyLqb88ypSbuQ: posts big blind $1
*** HOLE CARDS ***
yWcEtGJ3ijZsF6HqlHqkrg: folds
OGgaARGdJQT4awWVNQ957w: folds
bLbSOSmSOnqE0iTcH/5dxA: folds
TAfo4veNRaRlzDXMMYS3Jg: folds
h7qXkU57Bb8ZuPwMyxR8Ug: folds
WRTVKFHeb0vRJnVi5NdJZw: calls $1
G9Fo2TZCN7HI43Po4zSN3A: folds
mMc/PBpqlN24gdi3C/1tOw: calls $0.50
KNAaBvPYSXyLqb88ypSbuQ: checks
*** FLOP *** [9c 9d Jh]
mMc/PBpqlN24gdi3C/1tOw: checks
KNAaBvPYSXyLqb88ypSbuQ: checks
WRTVKFHeb0vRJnVi5NdJZw: checks
*** TURN *** [9c 9d Jh] [Tc]
mMc/PBpqlN24gdi3C/1tOw: checks
KNAaBvPYSXyLqb88ypSbuQ: checks
WRTVKFHeb0vRJnVi5NdJZw: checks
*** RIVER *** [9c 9d Jh Tc] [Kh]
mMc/PBpqlN24gdi3C/1tOw: checks
KNAaBvPYSXyLqb88ypSbuQ: checks
WRTVKFHeb0vRJnVi5NdJZw: checks
*** SHOW DOWN ***
mMc/PBpqlN24gdi3C/1tOw: shows [8s Th] (two pair, Tens and Nines)
KNAaBvPYSXyLqb88ypSbuQ: mucks hand
WRTVKFHeb0vRJnVi5NdJZw: shows [Ks 2s] (two pair, Kings and Nines)
WRTVKFHeb0vRJnVi5NdJZw collected $2.85 from pot
*** SUMMARY ***
Total pot $3 | Rake $0.15
Board [9c 9d Jh Tc Kh]
Seat 1: bLbSOSmSOnqE0iTcH/5dxA folded before Flop (didn't bet)
Seat 2: TAfo4veNRaRlzDXMMYS3Jg folded before Flop (didn't bet)
Seat 3: h7qXkU57Bb8ZuPwMyxR8Ug folded before Flop (didn't bet)
Seat 4: WRTVKFHeb0vRJnVi5NdJZw showed [Ks 2s] and won ($2.85) with two pair, Kings and Nines
Seat 5: G9Fo2TZCN7HI43Po4zSN3A (button) folded before Flop (didn't bet)
Seat 6: mMc/PBpqlN24gdi3C/1tOw (small blind) showed [8s Th] and lost with two pair, Tens and Nines
Seat 7: KNAaBvPYSXyLqb88ypSbuQ (big blind) mucked
Seat 8: yWcEtGJ3ijZsF6HqlHqkrg folded before Flop (didn't bet)
Seat 9: OGgaARGdJQT4awWVNQ957w folded before Flop (didn't bet)



PokerStars Game #59941630182:  Hold'em No Limit ($0.50/$1.00) - 2009/07/01 1:41:15 ET
Table 'vs/5jr6ciwjVQ5+Soc+u2A' 6-max Seat #3 is the button
Seat 1: J798qwLuvXyq0BbzsIjOrA ($199.15 in chips)
Seat 2: lXX4W7m3u++JiSOZ46yVMQ ($98.50 in chips)
Seat 3: Ws/3Uo3rQIk8hLgW0P+2xA ($95.90 in chips)
Seat 4: 0smcry9L0OOTCP+KzIS5SA ($87 in chips)
Seat 5: +Nt3OPk3XR9SKjZgm2CexQ ($159.35 in chips)
Seat 6: Z2fXsGcjl+Eax+RzOgwOmg ($124 in chips)
0smcry9L0OOTCP+KzIS5SA: posts small blind $0.50
+Nt3OPk3XR9SKjZgm2CexQ: posts big blind $1
*** HOLE CARDS ***
Z2fXsGcjl+Eax+RzOgwOmg: folds
J798qwLuvXyq0BbzsIjOrA: folds
lXX4W7m3u++JiSOZ46yVMQ: folds
Ws/3Uo3rQIk8hLgW0P+2xA: folds
0smcry9L0OOTCP+KzIS5SA: raises $2 to $3
+Nt3OPk3XR9SKjZgm2CexQ: folds
0smcry9L0OOTCP+KzIS5SA collected $2 from pot
0smcry9L0OOTCP+KzIS5SA: doesn't show hand
*** SUMMARY ***
Total pot $2 | Rake $0
Seat 1: J798qwLuvXyq0BbzsIjOrA folded before Flop (didn't bet)
Seat 2: lXX4W7m3u++JiSOZ46yVMQ folded before Flop (didn't bet)
Seat 3: Ws/3Uo3rQIk8hLgW0P+2xA (button) folded before Flop (didn't bet)
Seat 4: 0smcry9L0OOTCP+KzIS5SA (small blind) collected ($2)
Seat 5: +Nt3OPk3XR9SKjZgm2CexQ (big blind) folded before Flop
Seat 6: Z2fXsGcjl+Eax+RzOgwOmg folded before Flop (didn't bet)



PokerStars Game #59941630030:  Hold'em No Limit ($0.50/$1.00) - 2009/07/01 1:41:15 ET
Table 'GxCPo/gd3OSthkYrAxJngg' 6-max Seat #4 is the button
Seat 1: sH8BpAFP+jGFxCgVpD1Lew ($229.55 in chips)
Seat 2: YExX2paeIHrmfIwV1ivM/w ($61.60 in chips)
Seat 3: idVgoPAdspFPCzee6aF9Pg ($136 in chips)
Seat 4: YMJG+F++3Aj6P8dAWda5fw ($203.85 in chips)
Seat 5: vX+iYAEINFeLxwMla7DY1Q ($99 in chips)
Seat 6: 4d1rWhpu8DzLmzMbR3QKyA ($106.55 in chips)
vX+iYAEINFeLxwMla7DY1Q: posts small blind $0.50
4d1rWhpu8DzLmzMbR3QKyA: posts big blind $1
*** HOLE CARDS ***
sH8BpAFP+jGFxCgVpD1Lew: calls $1
YExX2paeIHrmfIwV1ivM/w: folds
idVgoPAdspFPCzee6aF9Pg: folds
YMJG+F++3Aj6P8dAWda5fw: folds
vX+iYAEINFeLxwMla7DY1Q: calls $0.50
4d1rWhpu8DzLmzMbR3QKyA: checks
*** FLOP *** [9s 3h 5d]
vX+iYAEINFeLxwMla7DY1Q: checks
4d1rWhpu8DzLmzMbR3QKyA: bets $2
sH8BpAFP+jGFxCgVpD1Lew: calls $2
vX+iYAEINFeLxwMla7DY1Q: folds
*** TURN *** [9s 3h 5d] [Kc]
4d1rWhpu8DzLmzMbR3QKyA: bets $5
sH8BpAFP+jGFxCgVpD1Lew: calls $5
*** RIVER *** [9s 3h 5d Kc] [4c]
4d1rWhpu8DzLmzMbR3QKyA: bets $10
sH8BpAFP+jGFxCgVpD1Lew: raises $20 to $30
4d1rWhpu8DzLmzMbR3QKyA said, "444 hum?"
4d1rWhpu8DzLmzMbR3QKyA: folds
sH8BpAFP+jGFxCgVpD1Lew collected $35.20 from pot
*** SUMMARY ***
Total pot $37 | Rake $1.80
Board [9s 3h 5d Kc 4c]
Seat 1: sH8BpAFP+jGFxCgVpD1Lew collected ($35.20)
Seat 2: YExX2paeIHrmfIwV1ivM/w folded before Flop (didn't bet)
Seat 3: idVgoPAdspFPCzee6aF9Pg folded before Flop (didn't bet)
Seat 4: YMJG+F++3Aj6P8dAWda5fw (button) folded before Flop (didn't bet)
Seat 5: vX+iYAEINFeLxwMla7DY1Q (small blind) folded on the Flop
Seat 6: 4d1rWhpu8DzLmzMbR3QKyA (big blind) folded on the River



PokerStars Game #59941630316:  Hold'em No Limit ($0.50/$1.00) - 2009/07/01 1:41:15 ET
Table '7O9fB8yx1u7sJveJn8w6jA' 6-max Seat #6 is the button
Seat 1: 841740 ($41.30 in chips)
Seat 2: wx3sQGkVi2x9wJXuWNHPBw ($206.85 in chips)
Seat 3: hpxXcmRkXXI9HE5+5/j/0Q ($141.85 in chips)
Seat 4: b2a+5TkFf4xJN/Ihhma58Q ($30.35 in chips)
Seat 5: BCEV3COoKY607AzLWayfRA ($101 in chips)
Seat 6: r4lpoh2BJZ8S6zyQv1JeSw ($106.25 in chips)
841740: posts small blind $0.50
wx3sQGkVi2x9wJXuWNHPBw: posts big blind $1
*** HOLE CARDS ***
hpxXcmRkXXI9HE5+5/j/0Q: folds
b2a+5TkFf4xJN/Ihhma58Q: folds
BCEV3COoKY607AzLWayfRA: folds
r4lpoh2BJZ8S6zyQv1JeSw: raises $2 to $3
841740: folds
wx3sQGkVi2x9wJXuWNHPBw: folds
r4lpoh2BJZ8S6zyQv1JeSw collected $2.50 from pot
r4lpoh2BJZ8S6zyQv1JeSw: doesn't show hand
*** SUMMARY ***
Total pot $2.50 | Rake $0
Seat 1: 841740 (small blind) folded before Flop
Seat 2: wx3sQGkVi2x9wJXuWNHPBw (big blind) folded before Flop
Seat 3: hpxXcmRkXXI9HE5+5/j/0Q folded before Flop (didn't bet)
Seat 4: b2a+5TkFf4xJN/Ihhma58Q folded before Flop (didn't bet)
Seat 5: BCEV3COoKY607AzLWayfRA folded before Flop (didn't bet)
Seat 6: r4lpoh2BJZ8S6zyQv1JeSw (button) collected ($2.50)



PokerStars Game #59941630744:  Hold'em No Limit ($0.50/$1.00) - 2009/07/01 1:41:16 ET
Table 'fTlPiCj0utgzC/5io+I7ew' 6-max Seat #6 is the button
Seat 1: YMJG+F++3Aj6P8dAWda5fw ($98 in chips)
Seat 2: qVr1nl3dy2xXPqS8UpTDlA ($39.45 in chips)
Seat 3: Z2fXsGcjl+Eax+RzOgwOmg ($136.50 in chips)
Seat 4: uJVSceLggtsrJya+WtmUEA ($166.35 in chips)
Seat 5: XUk5GQsfNFpHvaToDZ0rZA ($42.05 in chips)
Seat 6: y27w5IK2WXqmYzS8OU0wKA ($100 in chips)
YMJG+F++3Aj6P8dAWda5fw: posts small blind $0.50
qVr1nl3dy2xXPqS8UpTDlA: posts big blind $1
*** HOLE CARDS ***
Z2fXsGcjl+Eax+RzOgwOmg: raises $3 to $4
uJVSceLggtsrJya+WtmUEA: folds
XUk5GQsfNFpHvaToDZ0rZA: folds
y27w5IK2WXqmYzS8OU0wKA: folds
YMJG+F++3Aj6P8dAWda5fw: raises $9 to $13
qVr1nl3dy2xXPqS8UpTDlA: folds
Z2fXsGcjl+Eax+RzOgwOmg: folds
YMJG+F++3Aj6P8dAWda5fw collected $9 from pot
*** SUMMARY ***
Total pot $9 | Rake $0
Seat 1: YMJG+F++3Aj6P8dAWda5fw (small blind) collected ($9)
Seat 2: qVr1nl3dy2xXPqS8UpTDlA (big blind) folded before Flop
Seat 3: Z2fXsGcjl+Eax+RzOgwOmg folded before Flop
Seat 4: uJVSceLggtsrJya+WtmUEA folded before Flop (didn't bet)
Seat 5: XUk5GQsfNFpHvaToDZ0rZA folded before Flop (didn't bet)
Seat 6: y27w5IK2WXqmYzS8OU0wKA (button) folded before Flop (didn't bet)



PokerStars Game #59941630774:  Hold'em No Limit ($0.50/$1.00) - 2009/07/01 1:41:16 ET
Table 'gxFK0BVUD7cupu2uyRUZJg' 6-max Seat #4 is the button
Seat 1: M+X3uChmP6R63IwijVjgTg ($218.40 in chips)
Seat 2: hpxXcmRkXXI9HE5+5/j/0Q ($131.55 in chips)
Seat 3: Z2fXsGcjl+Eax+RzOgwOmg ($100 in chips)
Seat 4: Hcr4S4Nbkj5idKsvYK/eqQ ($100 in chips)
Seat 5: 0smcry9L0OOTCP+KzIS5SA ($210.50 in chips)
Seat 6: dYyb6/42PMC8aNFlm/eBeQ ($141.25 in chips)
0smcry9L0OOTCP+KzIS5SA: posts small blind $0.50
dYyb6/42PMC8aNFlm/eBeQ: posts big blind $1
*** HOLE CARDS ***
M+X3uChmP6R63IwijVjgTg: folds
hpxXcmRkXXI9HE5+5/j/0Q: folds
Z2fXsGcjl+Eax+RzOgwOmg: raises $3 to $4
Hcr4S4Nbkj5idKsvYK/eqQ: folds
0smcry9L0OOTCP+KzIS5SA: folds
dYyb6/42PMC8aNFlm/eBeQ: folds
Z2fXsGcjl+Eax+RzOgwOmg collected $2.50 from pot
Z2fXsGcjl+Eax+RzOgwOmg: doesn't show hand
*** SUMMARY ***
Total pot $2.50 | Rake $0
Seat 1: M+X3uChmP6R63IwijVjgTg folded before Flop (didn't bet)
Seat 2: hpxXcmRkXXI9HE5+5/j/0Q folded before Flop (didn't bet)
Seat 3: Z2fXsGcjl+Eax+RzOgwOmg collected ($2.50)
Seat 4: Hcr4S4Nbkj5idKsvYK/eqQ (button) folded before Flop (didn't bet)
Seat 5: 0smcry9L0OOTCP+KzIS5SA (small blind) folded before Flop
Seat 6: dYyb6/42PMC8aNFlm/eBeQ (big blind) folded before Flop



PokerStars Game #59941630580:  Hold'em No Limit ($0.50/$1.00) - 2009/07/01 1:41:16 ET
Table 'fZjVbKj9D8yOB+Rj7NaP/A' 9-max Seat #2 is the button
Seat 2: PTAFYDIUSsG+SArbxNl+Aw ($100 in chips)
Seat 3: yAbu2QsRPVcjPbqlf/jDxw ($102.65 in chips)
Seat 5: PkGfq5xrSlNsujKaG/HF4Q ($100 in chips)
Seat 6: OvwYHV65yUbgdBjSmo1+5g ($135.45 in chips)
Seat 7: SyS20PAm3RpT6uLBsGkwOA ($100 in chips)
Seat 8: EVvb0huXeMB7dnOAiO4ggA ($48.50 in chips)
Seat 9: qheQay5YvP2DMAb3OUSxtw ($148.60 in chips)
yAbu2QsRPVcjPbqlf/jDxw: posts small blind $0.50
997ViqAtWn1FPjJqcffwcA: is sitting out
PkGfq5xrSlNsujKaG/HF4Q: posts big blind $1
*** HOLE CARDS ***
OvwYHV65yUbgdBjSmo1+5g: folds
SyS20PAm3RpT6uLBsGkwOA: raises $4 to $5
EVvb0huXeMB7dnOAiO4ggA: folds
997ViqAtWn1FPjJqcffwcA leaves the table
kiakSwxX0e64PwYGAPQvLw joins the table at seat #1
qheQay5YvP2DMAb3OUSxtw: calls $5
PTAFYDIUSsG+SArbxNl+Aw: calls $5
yAbu2QsRPVcjPbqlf/jDxw: folds
PkGfq5xrSlNsujKaG/HF4Q: folds
*** FLOP *** [Ac 7h 3s]
SyS20PAm3RpT6uLBsGkwOA: bets $10
qheQay5YvP2DMAb3OUSxtw: folds
PTAFYDIUSsG+SArbxNl+Aw: folds
SyS20PAm3RpT6uLBsGkwOA collected $15.70 from pot
*** SUMMARY ***
Total pot $16.50 | Rake $0.80
Board [Ac 7h 3s]
Seat 2: PTAFYDIUSsG+SArbxNl+Aw (button) folded on the Flop
Seat 3: yAbu2QsRPVcjPbqlf/jDxw (small blind) folded before Flop
Seat 5: PkGfq5xrSlNsujKaG/HF4Q (big blind) folded before Flop
Seat 6: OvwYHV65yUbgdBjSmo1+5g folded before Flop (didn't bet)
Seat 7: SyS20PAm3RpT6uLBsGkwOA collected ($15.70)
Seat 8: EVvb0huXeMB7dnOAiO4ggA folded before Flop (didn't bet)
Seat 9: qheQay5YvP2DMAb3OUSxtw folded on the Flop



PokerStars Game #59941631464:  Hold'em No Limit ($0.50/$1.00) - 2009/07/01 1:41:17 ET
Table 'MUPc8FEpe/nR0BKSeReX6Q' 6-max Seat #5 is the button
Seat 1: qhkK6+yCciTRd+rCFEbnEQ ($80.60 in chips)
Seat 2: xAU6q2/cwmby2sxmA8VcmA ($103.70 in chips)
Seat 3: wx3sQGkVi2x9wJXuWNHPBw ($286.15 in chips)
Seat 4: r4lpoh2BJZ8S6zyQv1JeSw ($110 in chips)
Seat 5: y27w5IK2WXqmYzS8OU0wKA ($129.55 in chips)
Seat 6: ene3nLSnQ4N961iBaUsSmA ($100 in chips)
ene3nLSnQ4N961iBaUsSmA: posts small blind $0.50
qhkK6+yCciTRd+rCFEbnEQ: posts big blind $1
*** HOLE CARDS ***
xAU6q2/cwmby2sxmA8VcmA: folds
wx3sQGkVi2x9wJXuWNHPBw has timed out
wx3sQGkVi2x9wJXuWNHPBw: folds
wx3sQGkVi2x9wJXuWNHPBw is sitting out
r4lpoh2BJZ8S6zyQv1JeSw: folds
wx3sQGkVi2x9wJXuWNHPBw has returned
y27w5IK2WXqmYzS8OU0wKA: folds
ene3nLSnQ4N961iBaUsSmA: raises $3 to $4
qhkK6+yCciTRd+rCFEbnEQ: calls $3
*** FLOP *** [7d 4h 3d]
ene3nLSnQ4N961iBaUsSmA: checks
qhkK6+yCciTRd+rCFEbnEQ: bets $5
ene3nLSnQ4N961iBaUsSmA: folds
qhkK6+yCciTRd+rCFEbnEQ collected $7.60 from pot
qhkK6+yCciTRd+rCFEbnEQ: doesn't show hand
*** SUMMARY ***
Total pot $8 | Rake $0.40
Board [7d 4h 3d]
Seat 1: qhkK6+yCciTRd+rCFEbnEQ (big blind) collected ($7.60)
Seat 2: xAU6q2/cwmby2sxmA8VcmA folded before Flop (didn't bet)
Seat 3: wx3sQGkVi2x9wJXuWNHPBw folded before Flop (didn't bet)
Seat 4: r4lpoh2BJZ8S6zyQv1JeSw folded before Flop (didn't bet)
Seat 5: y27w5IK2WXqmYzS8OU0wKA (button) folded before Flop (didn't bet)
Seat 6: ene3nLSnQ4N961iBaUsSmA (small blind) folded on the Flop



PokerStars Game #59941632044:  Hold'em No Limit ($0.50/$1.00) - 2009/07/01 1:41:18 ET
Table 'N2bNCDHL96aCQDvZIh+yQQ' 6-max Seat #6 is the button
Seat 1: Jjgflx10PVjcLkziEmLhSA ($92.75 in chips)
Seat 2: y27w5IK2WXqmYzS8OU0wKA ($130.15 in chips)
Seat 3: UBZQqpnJZdTYYY1FTb0rLA ($120.55 in chips)
Seat 4: uCqEjnxh2/vFBjKYkfTOkw ($174.30 in chips)
Seat 6: idVgoPAdspFPCzee6aF9Pg ($105.90 in chips)
Jjgflx10PVjcLkziEmLhSA: posts small blind $0.50
y27w5IK2WXqmYzS8OU0wKA: posts big blind $1
ene3nLSnQ4N961iBaUsSmA: sits out
*** HOLE CARDS ***
UBZQqpnJZdTYYY1FTb0rLA: folds
uCqEjnxh2/vFBjKYkfTOkw: folds
idVgoPAdspFPCzee6aF9Pg: folds
Jjgflx10PVjcLkziEmLhSA: folds
y27w5IK2WXqmYzS8OU0wKA collected $1 from pot
y27w5IK2WXqmYzS8OU0wKA: doesn't show hand
*** SUMMARY ***
Total pot $1 | Rake $0
Seat 1: Jjgflx10PVjcLkziEmLhSA (small blind) folded before Flop
Seat 2: y27w5IK2WXqmYzS8OU0wKA (big blind) collected ($1)
Seat 3: UBZQqpnJZdTYYY1FTb0rLA folded before Flop (didn't bet)
Seat 4: uCqEjnxh2/vFBjKYkfTOkw folded before Flop (didn't bet)
Seat 6: idVgoPAdspFPCzee6aF9Pg (button) folded before Flop (didn't bet)



PokerStars Game #59941633780:  Hold'em No Limit ($0.50/$1.00) - 2009/07/01 1:41:21 ET
Table 'ZFWj23PMihdwrNWv41OG/QtyUh+jyNvrceIQdKMJjQ2weat #2 is the button
Seat 1: j3hj7KQwBVU5NTFmtYomSw ($86.25 in chips)
Seat 2: 0smcry9L0OOTCP+KzIS5SA ($95.50 in chips)
Seat 3: cWwhvq/+r/w8nkhwrJoekQ ($49.20 in chips)
Seat 4: O5ZesE/6mHyuWWbvkiH/Fg ($70.70 in chips)
Seat 5: j7NIOHLZk7V2o9fOioO5ug ($101.70 in chips)
Seat 6: u23r4AyKPgHioZ6t7z6qrA ($100 in chips)
cWwhvq/+r/w8nkhwrJoekQ: posts small blind $0.50
O5ZesE/6mHyuWWbvkiH/Fg: posts big blind $1
*** HOLE CARDS ***
j7NIOHLZk7V2o9fOioO5ug: folds
u23r4AyKPgHioZ6t7z6qrA: folds
j3hj7KQwBVU5NTFmtYomSw: folds
0smcry9L0OOTCP+KzIS5SA: raises $2 to $3
cWwhvq/+r/w8nkhwrJoekQ: folds
O5ZesE/6mHyuWWbvkiH/Fg: folds
0smcry9L0OOTCP+KzIS5SA collected $2.50 from pot
0smcry9L0OOTCP+KzIS5SA: doesn't show hand
*** SUMMARY ***
Total pot $2.50 | Rake $0
Seat 1: j3hj7KQwBVU5NTFmtYomSw folded before Flop (didn't bet)
Seat 2: 0smcry9L0OOTCP+KzIS5SA (button) collected ($2.50)
Seat 3: cWwhvq/+r/w8nkhwrJoekQ (small blind) folded before Flop
Seat 4: O5ZesE/6mHyuWWbvkiH/Fg (big blind) folded before Flop
Seat 5: j7NIOHLZk7V2o9fOioO5ug folded before Flop (didn't bet)
Seat 6: u23r4AyKPgHioZ6t7z6qrA folded before Flop (didn't bet)



PokerStars Game #59941633460:  Hold'em No Limit ($0.50/$1.00) - 2009/07/01 1:41:21 ET
Table 'qj0HBN4HhQKogreu1bg7xg' 2-max Seat #1 is the button
Seat 1: NYi6JFscYNrofSXy4sM+Yw ($138.10 in chips)
Seat 2: qtyl8CSb0/4yWdbuEPJejA ($139.30 in chips)
NYi6JFscYNrofSXy4sM+Yw: posts small blind $0.50
qtyl8CSb0/4yWdbuEPJejA: posts big blind $1
*** HOLE CARDS ***
NYi6JFscYNrofSXy4sM+Yw: raises $1 to $2
qtyl8CSb0/4yWdbuEPJejA: calls $1
*** FLOP *** [3c 6h 5d]
qtyl8CSb0/4yWdbuEPJejA: bets $4
NYi6JFscYNrofSXy4sM+Yw: raises $9 to $13
qtyl8CSb0/4yWdbuEPJejA: calls $9
*** TURN *** [3c 6h 5d] [Kd]
qtyl8CSb0/4yWdbuEPJejA: checks
NYi6JFscYNrofSXy4sM+Yw: checks
*** RIVER *** [3c 6h 5d Kd] [Ac]
qtyl8CSb0/4yWdbuEPJejA: checks
NYi6JFscYNrofSXy4sM+Yw: checks
*** SHOW DOWN ***
qtyl8CSb0/4yWdbuEPJejA: shows [3h 7h] (a pair of Threes)
NYi6JFscYNrofSXy4sM+Yw: shows [4s 6c] (a pair of Sixes)
NYi6JFscYNrofSXy4sM+Yw collected $29.50 from pot
*** SUMMARY ***
Total pot $30 | Rake $0.50
Board [3c 6h 5d Kd Ac]
Seat 1: NYi6JFscYNrofSXy4sM+Yw (button) (small blind) showed [4s 6c] and won ($29.50) with a pair of Sixes
Seat 2: qtyl8CSb0/4yWdbuEPJejA (big blind) showed [3h 7h] and lost with a pair of Threes



PokerStars Game #59941633988:  Hold'em No Limit ($0.50/$1.00) - 2009/07/01 1:41:22 ET
Table '+cA8mcmhaedZ7YcrDdhmeQ' 6-max Seat #5 is the button
Seat 1: VB7TtBnfmT3JTA/cCL6dJg ($100 in chips)
Seat 2: 14aYclSc98EYd6TrzN2l3Q ($63.35 in chips)
Seat 3: DAIgyIWbYvAkL6PbAI27pg ($18.50 in chips)
Seat 4: 4OO5v3AVduL0tePNx8wk5A ($108.20 in chips)
Seat 5: SJieaES+gCAfonfNNMCP6w ($100 in chips)
Seat 6: YfsTQsY/fxb+YqbdclTHuw ($54.15 in chips)
YfsTQsY/fxb+YqbdclTHuw: posts small blind $0.50
VB7TtBnfmT3JTA/cCL6dJg: posts big blind $1
*** HOLE CARDS ***
14aYclSc98EYd6TrzN2l3Q: calls $1
DAIgyIWbYvAkL6PbAI27pg: folds
4OO5v3AVduL0tePNx8wk5A: folds
SJieaES+gCAfonfNNMCP6w: folds
YfsTQsY/fxb+YqbdclTHuw: raises $3 to $4
VB7TtBnfmT3JTA/cCL6dJg: folds
14aYclSc98EYd6TrzN2l3Q: calls $3
*** FLOP *** [9d 4h 7h]
YfsTQsY/fxb+YqbdclTHuw: bets $6
14aYclSc98EYd6TrzN2l3Q: calls $6
*** TURN *** [9d 4h 7h] [As]
YfsTQsY/fxb+YqbdclTHuw: bets $12
14aYclSc98EYd6TrzN2l3Q: raises $17 to $29
YfsTQsY/fxb+YqbdclTHuw: folds
14aYclSc98EYd6TrzN2l3Q collected $42.80 from pot
*** SUMMARY ***
Total pot $45 | Rake $2.20
Board [9d 4h 7h As]
Seat 1: VB7TtBnfmT3JTA/cCL6dJg (big blind) folded before Flop
Seat 2: 14aYclSc98EYd6TrzN2l3Q collected ($42.80)
Seat 3: DAIgyIWbYvAkL6PbAI27pg folded before Flop (didn't bet)
Seat 4: 4OO5v3AVduL0tePNx8wk5A folded before Flop (didn't bet)
Seat 5: SJieaES+gCAfonfNNMCP6w (button) folded before Flop (didn't bet)
Seat 6: YfsTQsY/fxb+YqbdclTHuw (small blind) folded on the Turn



PokerStars Game #59941634516:  Hold'em No Limit ($0.50/$1.00) - 2009/07/01 1:41:23 ET
Table 'mmbQQVBTrPdE+wy+s+9VPA' 6-max Seat #2 is the button
Seat 1: zyP4SPoWZnKUfTvIRLCVog ($73.25 in chips)
Seat 2: XK4Qsl+DA8gAJyg85/zBIw ($40.45 in chips)
Seat 3: wx3sQGkVi2x9wJXuWNHPBw ($229.10 in chips)
Seat 4: V3iZdcw61nXF3g5hD2RrsQ ($100.05 in chips)
Seat 5: YMJG+F++3Aj6P8dAWda5fw ($126.70 in chips)
Seat 6: UOHYuj23MyK9R8ciY2t6FA ($100 in chips)
wx3sQGkVi2x9wJXuWNHPBw: posts small blind $0.50
V3iZdcw61nXF3g5hD2RrsQ: posts big blind $1
*** HOLE CARDS ***
YMJG+F++3Aj6P8dAWda5fw: raises $2 to $3
UOHYuj23MyK9R8ciY2t6FA: folds
zyP4SPoWZnKUfTvIRLCVog: folds
XK4Qsl+DA8gAJyg85/zBIw: folds
wx3sQGkVi2x9wJXuWNHPBw: folds
V3iZdcw61nXF3g5hD2RrsQ: folds
YMJG+F++3Aj6P8dAWda5fw collected $2.50 from pot
*** SUMMARY ***
Total pot $2.50 | Rake $0
Seat 1: zyP4SPoWZnKUfTvIRLCVog folded before Flop (didn't bet)
Seat 2: XK4Qsl+DA8gAJyg85/zBIw (button) folded before Flop (didn't bet)
Seat 3: wx3sQGkVi2x9wJXuWNHPBw (small blind) folded before Flop
Seat 4: V3iZdcw61nXF3g5hD2RrsQ (big blind) folded before Flop
Seat 5: YMJG+F++3Aj6P8dAWda5fw collected ($2.50)
Seat 6: UOHYuj23MyK9R8ciY2t6FA folded before Flop (didn't bet)



PokerStars Game #59941634778:  Hold'em No Limit ($0.50/$1.00) - 2009/07/01 1:41:23 ET
Table 'NqGO/cV3MwFAx+ZPB5ANmQ' 2-max Seat #2 is the button
Seat 1: ItaRAnHOgvYOv5ynbG1iTw ($275.70 in chips)
Seat 2: GtFB+yyeb2djMdPFuOW/Xg ($100 in chips)
GtFB+yyeb2djMdPFuOW/Xg: posts small blind $0.50
ItaRAnHOgvYOv5ynbG1iTw: posts big blind $1
*** HOLE CARDS ***
GtFB+yyeb2djMdPFuOW/Xg: raises $2 to $3
ItaRAnHOgvYOv5ynbG1iTw: folds
GtFB+yyeb2djMdPFuOW/Xg collected $2 from pot
*** SUMMARY ***
Total pot $2 | Rake $0
Seat 1: ItaRAnHOgvYOv5ynbG1iTw (big blind) folded before Flop
Seat 2: GtFB+yyeb2djMdPFuOW/Xg (button) (small blind) collected ($2)



PokerStars Game #59941636896:  Hold'em No Limit ($0.50/$1.00) - 2009/07/01 1:41:27 ET
Table 'hdVBCnDy5t2X9dZo0AvD9w' 9-max Seat #3 is the button
Seat 2: Ogn4JDV3mp4ZDKO49IFzKA ($17.40 in chips)
Seat 3: 1862487932 ($100 in chips)
Seat 4: YvSugbFKWSuAYx9iokQwUQ ($99.40 in chips)
Seat 5: H+DVy3Ei8L1UKS2tVOtJcw ($108.80 in chips)
Seat 7: laA8va+Yv8WuMqT1zdR91g ($100 in chips)
Seat 8: gUUvmqdVlmvpal6B8nYrmg ($144.15 in chips)
Seat 9: AMkLbywdoc0K30BTzaIfTQ ($174.90 in chips)
YvSugbFKWSuAYx9iokQwUQ: posts small blind $0.50
H+DVy3Ei8L1UKS2tVOtJcw: posts big blind $1
*** HOLE CARDS ***
laA8va+Yv8WuMqT1zdR91g: folds
gUUvmqdVlmvpal6B8nYrmg: folds
AMkLbywdoc0K30BTzaIfTQ: folds
Ogn4JDV3mp4ZDKO49IFzKA: calls $1
1862487932: folds
YvSugbFKWSuAYx9iokQwUQ: folds
H+DVy3Ei8L1UKS2tVOtJcw: checks
*** FLOP *** [2s 5d 3s]
H+DVy3Ei8L1UKS2tVOtJcw: checks
Ogn4JDV3mp4ZDKO49IFzKA: bets $2
H+DVy3Ei8L1UKS2tVOtJcw: folds
Ogn4JDV3mp4ZDKO49IFzKA collected $2.40 from pot
*** SUMMARY ***
Total pot $2.50 | Rake $0.10
Board [2s 5d 3s]
Seat 2: Ogn4JDV3mp4ZDKO49IFzKA collected ($2.40)
Seat 3: 1862487932 (button) folded before Flop (didn't bet)
Seat 4: YvSugbFKWSuAYx9iokQwUQ (small blind) folded before Flop
Seat 5: H+DVy3Ei8L1UKS2tVOtJcw (big blind) folded on the Flop
Seat 7: laA8va+Yv8WuMqT1zdR91g folded before Flop (didn't bet)
Seat 8: gUUvmqdVlmvpal6B8nYrmg folded before Flop (didn't bet)
Seat 9: AMkLbywdoc0K30BTzaIfTQ folded before Flop (didn't bet)



PokerStars Game #59941637804:  Hold'em No Limit ($0.50/$1.00) - 2009/07/01 1:41:29 ET
Table '/RZcOwpZpHQ+OwPwjsbnRw' 6-max Seat #2 is the button
Seat 1: +uSzP8Jwnw7sKfQ4s66b7w ($88.90 in chips)
Seat 2: Z2fXsGcjl+Eax+RzOgwOmg ($100 in chips)
Seat 3: LJMw/I77xpnw0R5T4HnMUg ($107.05 in chips)
Seat 4: j7NIOHLZk7V2o9fOioO5ug ($113.20 in chips)
Seat 5: wx3sQGkVi2x9wJXuWNHPBw ($164.25 in chips)
Seat 6: o3YLm/rSY916m/on1VjXPA ($205.50 in chips)
LJMw/I77xpnw0R5T4HnMUg: posts small blind $0.50
j7NIOHLZk7V2o9fOioO5ug: posts big blind $1
*** HOLE CARDS ***
wx3sQGkVi2x9wJXuWNHPBw: folds
o3YLm/rSY916m/on1VjXPA: folds
+uSzP8Jwnw7sKfQ4s66b7w: folds
Z2fXsGcjl+Eax+RzOgwOmg: raises $2 to $3
LJMw/I77xpnw0R5T4HnMUg: folds
j7NIOHLZk7V2o9fOioO5ug: raises $7 to $10
Z2fXsGcjl+Eax+RzOgwOmg: folds
j7NIOHLZk7V2o9fOioO5ug collected $6.50 from pot
j7NIOHLZk7V2o9fOioO5ug: doesn't show hand
*** SUMMARY ***
Total pot $6.50 | Rake $0
Seat 1: +uSzP8Jwnw7sKfQ4s66b7w folded before Flop (didn't bet)
Seat 2: Z2fXsGcjl+Eax+RzOgwOmg (button) folded before Flop
Seat 3: LJMw/I77xpnw0R5T4HnMUg (small blind) folded before Flop
Seat 4: j7NIOHLZk7V2o9fOioO5ug (big blind) collected ($6.50)
Seat 5: wx3sQGkVi2x9wJXuWNHPBw folded before Flop (didn't bet)
Seat 6: o3YLm/rSY916m/on1VjXPA folded before Flop (didn't bet)



PokerStars Game #59941638410:  Hold'em No Limit ($0.50/$1.00) - 2009/07/01 1:41:30 ET
Table '305hiksPPCCdC6V2LNsO5w' 6-max Seat #4 is the button
Seat 1: RTuDLJHh/9zPfBftoc9vsw ($8.25 in chips)
Seat 2: j7NIOHLZk7V2o9fOioO5ug ($159.20 in chips)
Seat 3: +zIVjZKLpcidfRHgVZW8lA ($28.50 in chips)
Seat 4: uJVSceLggtsrJya+WtmUEA ($202.30 in chips)
Seat 5: +Nt3OPk3XR9SKjZgm2CexQ ($100.50 in chips)
Seat 6: 9/Tq8dw7kWW68uN8bFupXg ($18.95 in chips)
+Nt3OPk3XR9SKjZgm2CexQ: posts small blind $0.50
9/Tq8dw7kWW68uN8bFupXg: posts big blind $1
*** HOLE CARDS ***
RTuDLJHh/9zPfBftoc9vsw: calls $1
j7NIOHLZk7V2o9fOioO5ug: folds
+zIVjZKLpcidfRHgVZW8lA: folds
uJVSceLggtsrJya+WtmUEA: folds
+Nt3OPk3XR9SKjZgm2CexQ: folds
9/Tq8dw7kWW68uN8bFupXg: checks
*** FLOP *** [9s Td 7h]
9/Tq8dw7kWW68uN8bFupXg: checks
RTuDLJHh/9zPfBftoc9vsw: checks
*** TURN *** [9s Td 7h] [3c]
9/Tq8dw7kWW68uN8bFupXg: bets $1
RTuDLJHh/9zPfBftoc9vsw: folds
9/Tq8dw7kWW68uN8bFupXg collected $2.40 from pot
*** SUMMARY ***
Total pot $2.50 | Rake $0.10
Board [9s Td 7h 3c]
Seat 1: RTuDLJHh/9zPfBftoc9vsw folded on the Turn
Seat 2: j7NIOHLZk7V2o9fOioO5ug folded before Flop (didn't bet)
Seat 3: +zIVjZKLpcidfRHgVZW8lA folded before Flop (didn't bet)
Seat 4: uJVSceLggtsrJya+WtmUEA (button) folded before Flop (didn't bet)
Seat 5: +Nt3OPk3XR9SKjZgm2CexQ (small blind) folded before Flop
Seat 6: 9/Tq8dw7kWW68uN8bFupXg (big blind) collected ($2.40)



PokerStars Game #59941639064:  Hold'em No Limit ($0.50/$1.00) - 2009/07/01 1:41:31 ET
Table 'W/wyObTiXZm+Ckkl3YxcSw' 6-max Seat #6 is the button
Seat 1: eUBBn2R56C1IQ6Cs/vitwg ($176.55 in chips)
Seat 2: oDiBRCaF0QVtd3kO6xZIXw ($124.30 in chips)
Seat 3: 4OO5v3AVduL0tePNx8wk5A ($100 in chips)
Seat 4: UBZQqpnJZdTYYY1FTb0rLA ($158.20 in chips)
Seat 5: +OrCjyw70oZhJiD22Mn+bg ($200.50 in chips)
Seat 6: b2a+5TkFf4xJN/Ihhma58Q ($32.30 in chips)
eUBBn2R56C1IQ6Cs/vitwg: posts small blind $0.50
oDiBRCaF0QVtd3kO6xZIXw: posts big blind $1
*** HOLE CARDS ***
4OO5v3AVduL0tePNx8wk5A: raises $3 to $4
UBZQqpnJZdTYYY1FTb0rLA: folds
+OrCjyw70oZhJiD22Mn+bg: folds
b2a+5TkFf4xJN/Ihhma58Q: folds
eUBBn2R56C1IQ6Cs/vitwg: raises $8 to $12
oDiBRCaF0QVtd3kO6xZIXw: folds
4OO5v3AVduL0tePNx8wk5A: folds
eUBBn2R56C1IQ6Cs/vitwg collected $9 from pot
*** SUMMARY ***
Total pot $9 | Rake $0
Seat 1: eUBBn2R56C1IQ6Cs/vitwg (small blind) collected ($9)
Seat 2: oDiBRCaF0QVtd3kO6xZIXw (big blind) folded before Flop
Seat 3: 4OO5v3AVduL0tePNx8wk5A folded before Flop
Seat 4: UBZQqpnJZdTYYY1FTb0rLA folded before Flop (didn't bet)
Seat 5: +OrCjyw70oZhJiD22Mn+bg folded before Flop (didn't bet)
Seat 6: b2a+5TkFf4xJN/Ihhma58Q (button) folded before Flop (didn't bet)



PokerStars Game #59941639164:  Hold'em No Limit ($0.50/$1.00) - 2009/07/01 1:41:31 ET
Table '3T4owEKJKyGTMePwrv50FQ' 9-max Seat #5 is the button
Seat 1: OGgaARGdJQT4awWVNQ957w ($100 in chips)
Seat 2: t+Id2O6herCLgwnC4m49PA ($30.55 in chips)
Seat 3: DOLzOcBTZYcph5jEfKFWuQ ($106.40 in chips)
Seat 4: O5Go3jrzbQWxRB6ESK+Ptg ($62.10 in chips)
Seat 5: mMc/PBpqlN24gdi3C/1tOw ($49.75 in chips)
Seat 6: V138SURkdX8LdVBPKdJJag ($107.25 in chips)
Seat 7: 1862487932 ($105.50 in chips)
Seat 8: bLbSOSmSOnqE0iTcH/5dxA ($198.50 in chips)
Seat 9: 61sfw5QTu62YYIt68OsdrA ($84.75 in chips)
V138SURkdX8LdVBPKdJJag: posts small blind $0.50
1862487932: posts big blind $1
*** HOLE CARDS ***
bLbSOSmSOnqE0iTcH/5dxA: folds
61sfw5QTu62YYIt68OsdrA: folds
OGgaARGdJQT4awWVNQ957w: raises $3 to $4
t+Id2O6herCLgwnC4m49PA: folds
DOLzOcBTZYcph5jEfKFWuQ: folds
O5Go3jrzbQWxRB6ESK+Ptg: folds
mMc/PBpqlN24gdi3C/1tOw: folds
V138SURkdX8LdVBPKdJJag: folds
1862487932: folds
OGgaARGdJQT4awWVNQ957w collected $2.50 from pot
OGgaARGdJQT4awWVNQ957w: doesn't show hand
*** SUMMARY ***
Total pot $2.50 | Rake $0
Seat 1: OGgaARGdJQT4awWVNQ957w collected ($2.50)
Seat 2: t+Id2O6herCLgwnC4m49PA folded before Flop (didn't bet)
Seat 3: DOLzOcBTZYcph5jEfKFWuQ folded before Flop (didn't bet)
Seat 4: O5Go3jrzbQWxRB6ESK+Ptg folded before Flop (didn't bet)
Seat 5: mMc/PBpqlN24gdi3C/1tOw (button) folded before Flop (didn't bet)
Seat 6: V138SURkdX8LdVBPKdJJag (small blind) folded before Flop
Seat 7: 1862487932 (big blind) folded before Flop
Seat 8: bLbSOSmSOnqE0iTcH/5dxA folded before Flop (didn't bet)
Seat 9: 61sfw5QTu62YYIt68OsdrA folded before Flop (didn't bet)



PokerStars Game #59941639212:  Hold'em No Limit ($0.50/$1.00) - 2009/07/01 1:41:31 ET
Table 'tJq9SfN1ywY0r03VBlWlwQ' 9-max Seat #8 is the button
Seat 1: wZsU+w9r7G66x93UuvBf1Q ($301.55 in chips)
Seat 2: VPF+HjszMvUIpy0CHIwH3A ($18.50 in chips)
Seat 4: bLbSOSmSOnqE0iTcH/5dxA ($118.20 in chips)
Seat 5: h5ipsNTMyolp7xn/NAvWkA ($124.80 in chips)
Seat 6: gUUvmqdVlmvpal6B8nYrmg ($108.60 in chips)
Seat 7: Ogn4JDV3mp4ZDKO49IFzKA ($18.40 in chips)
Seat 8: G4DEhsZFmznGNVpy2SEocA ($39.30 in chips)
Seat 9: XE5QF1y74bpHog9JxWJMWQ ($100 in chips)
XE5QF1y74bpHog9JxWJMWQ: posts small blind $0.50
wZsU+w9r7G66x93UuvBf1Q: posts big blind $1
*** HOLE CARDS ***
VPF+HjszMvUIpy0CHIwH3A: folds
bLbSOSmSOnqE0iTcH/5dxA: folds
h5ipsNTMyolp7xn/NAvWkA: raises $2 to $3
gUUvmqdVlmvpal6B8nYrmg: folds
Ogn4JDV3mp4ZDKO49IFzKA: folds
G4DEhsZFmznGNVpy2SEocA: folds
XE5QF1y74bpHog9JxWJMWQ: folds
wZsU+w9r7G66x93UuvBf1Q: folds
h5ipsNTMyolp7xn/NAvWkA collected $2.50 from pot
*** SUMMARY ***
Total pot $2.50 | Rake $0
Seat 1: wZsU+w9r7G66x93UuvBf1Q (big blind) folded before Flop
Seat 2: VPF+HjszMvUIpy0CHIwH3A folded before Flop (didn't bet)
Seat 4: bLbSOSmSOnqE0iTcH/5dxA folded before Flop (didn't bet)
Seat 5: h5ipsNTMyolp7xn/NAvWkA collected ($2.50)
Seat 6: gUUvmqdVlmvpal6B8nYrmg folded before Flop (didn't bet)
Seat 7: Ogn4JDV3mp4ZDKO49IFzKA folded before Flop (didn't bet)
Seat 8: G4DEhsZFmznGNVpy2SEocA (button) folded before Flop (didn't bet)
Seat 9: XE5QF1y74bpHog9JxWJMWQ (small blind) folded before Flop



PokerStars Game #59941640658:  Hold'em No Limit ($0.50/$1.00) - 2009/07/01 1:41:34 ET
Table 'blHlQApStil0OPeQxQxPcw' 9-max Seat #9 is the button
Seat 1: Pp/KTcXkfZKKUHkjyaLTdg ($23.10 in chips)
Seat 2: V138SURkdX8LdVBPKdJJag ($122.85 in chips)
Seat 3: OGgaARGdJQT4awWVNQ957w ($100 in chips)
Seat 4: 1862487932 ($102.15 in chips)
Seat 5: uXrDE6JrIi8BZK1L8oQ9bQ ($38.10 in chips)
Seat 6: vljeiOoWscAIXU0fCuiEBw ($50.15 in chips)
Seat 7: VPF+HjszMvUIpy0CHIwH3A ($20 in chips)
Seat 9: 6XkTu4ahxzHnvjjc1R8YjQ ($153.85 in chips)
Pp/KTcXkfZKKUHkjyaLTdg: posts small blind $0.50
V138SURkdX8LdVBPKdJJag: posts big blind $1
*** HOLE CARDS ***
OGgaARGdJQT4awWVNQ957w: folds
1862487932: raises $2.50 to $3.50
uXrDE6JrIi8BZK1L8oQ9bQ: folds
vljeiOoWscAIXU0fCuiEBw: calls $3.50
VPF+HjszMvUIpy0CHIwH3A: folds
6XkTu4ahxzHnvjjc1R8YjQ: folds
Pp/KTcXkfZKKUHkjyaLTdg: folds
V138SURkdX8LdVBPKdJJag: folds
*** FLOP *** [5c 2h Ah]
1862487932: bets $7
vljeiOoWscAIXU0fCuiEBw: folds
1862487932 collected $8.10 from pot
1862487932: doesn't show hand
*** SUMMARY ***
Total pot $8.50 | Rake $0.40
Board [5c 2h Ah]
Seat 1: Pp/KTcXkfZKKUHkjyaLTdg (small blind) folded before Flop
Seat 2: V138SURkdX8LdVBPKdJJag (big blind) folded before Flop
Seat 3: OGgaARGdJQT4awWVNQ957w folded before Flop (didn't bet)
Seat 4: 1862487932 collected ($8.10)
Seat 5: uXrDE6JrIi8BZK1L8oQ9bQ folded before Flop (didn't bet)
Seat 6: vljeiOoWscAIXU0fCuiEBw folded on the Flop
Seat 7: VPF+HjszMvUIpy0CHIwH3A folded before Flop (didn't bet)
Seat 9: 6XkTu4ahxzHnvjjc1R8YjQ (button) folded before Flop (didn't bet)



PokerStars Game #59941641474:  Hold'em No Limit ($0.50/$1.00) - 2009/07/01 1:41:35 ET
Table 'N2bNCDHL96aCQDvZIh+yQQ' 6-max Seat #1 is the button
Seat 1: Jjgflx10PVjcLkziEmLhSA ($92.25 in chips)
Seat 2: y27w5IK2WXqmYzS8OU0wKA ($130.65 in chips)
Seat 4: uCqEjnxh2/vFBjKYkfTOkw ($174.30 in chips)
Seat 6: idVgoPAdspFPCzee6aF9Pg ($105.90 in chips)
y27w5IK2WXqmYzS8OU0wKA: posts small blind $0.50
UBZQqpnJZdTYYY1FTb0rLA: is sitting out
uCqEjnxh2/vFBjKYkfTOkw: posts big blind $1
ene3nLSnQ4N961iBaUsSmA: sits out
*** HOLE CARDS ***
idVgoPAdspFPCzee6aF9Pg: folds
Jjgflx10PVjcLkziEmLhSA: folds
y27w5IK2WXqmYzS8OU0wKA: folds
uCqEjnxh2/vFBjKYkfTOkw collected $1 from pot
uCqEjnxh2/vFBjKYkfTOkw: doesn't show hand
UBZQqpnJZdTYYY1FTb0rLA leaves the table
*** SUMMARY ***
Total pot $1 | Rake $0
Seat 1: Jjgflx10PVjcLkziEmLhSA (button) folded before Flop (didn't bet)
Seat 2: y27w5IK2WXqmYzS8OU0wKA (small blind) folded before Flop
Seat 4: uCqEjnxh2/vFBjKYkfTOkw (big blind) collected ($1)
Seat 6: idVgoPAdspFPCzee6aF9Pg folded before Flop (didn't bet)



PokerStars Game #59941642022:  Hold'em No Limit ($0.50/$1.00) - 2009/07/01 1:41:36 ET
Table 'vs/5jr6ciwjVQ5+Soc+u2A' 6-max Seat #4 is the button
Seat 1: J798qwLuvXyq0BbzsIjOrA ($199.15 in chips)
Seat 2: lXX4W7m3u++JiSOZ46yVMQ ($98.50 in chips)
Seat 3: Ws/3Uo3rQIk8hLgW0P+2xA ($95.90 in chips)
Seat 4: 0smcry9L0OOTCP+KzIS5SA ($88 in chips)
Seat 5: +Nt3OPk3XR9SKjZgm2CexQ ($158.35 in chips)
Seat 6: Z2fXsGcjl+Eax+RzOgwOmg ($124 in chips)
+Nt3OPk3XR9SKjZgm2CexQ: posts small blind $0.50
Z2fXsGcjl+Eax+RzOgwOmg: posts big blind $1
*** HOLE CARDS ***
J798qwLuvXyq0BbzsIjOrA: calls $1
lXX4W7m3u++JiSOZ46yVMQ: folds
Ws/3Uo3rQIk8hLgW0P+2xA: folds
0smcry9L0OOTCP+KzIS5SA: folds
+Nt3OPk3XR9SKjZgm2CexQ: raises $4 to $5
Z2fXsGcjl+Eax+RzOgwOmg: folds
J798qwLuvXyq0BbzsIjOrA: calls $4
*** FLOP *** [8h 6s 9d]
+Nt3OPk3XR9SKjZgm2CexQ: checks
J798qwLuvXyq0BbzsIjOrA: bets $6
+Nt3OPk3XR9SKjZgm2CexQ: calls $6
*** TURN *** [8h 6s 9d] [Js]
+Nt3OPk3XR9SKjZgm2CexQ: checks
J798qwLuvXyq0BbzsIjOrA: bets $16
+Nt3OPk3XR9SKjZgm2CexQ: calls $16
*** RIVER *** [8h 6s 9d Js] [3c]
+Nt3OPk3XR9SKjZgm2CexQ: checks
J798qwLuvXyq0BbzsIjOrA: bets $38
+Nt3OPk3XR9SKjZgm2CexQ: folds
J798qwLuvXyq0BbzsIjOrA collected $52.35 from pot
J798qwLuvXyq0BbzsIjOrA: doesn't show hand
*** SUMMARY ***
Total pot $55 | Rake $2.65
Board [8h 6s 9d Js 3c]
Seat 1: J798qwLuvXyq0BbzsIjOrA collected ($52.35)
Seat 2: lXX4W7m3u++JiSOZ46yVMQ folded before Flop (didn't bet)
Seat 3: Ws/3Uo3rQIk8hLgW0P+2xA folded before Flop (didn't bet)
Seat 4: 0smcry9L0OOTCP+KzIS5SA (button) folded before Flop (didn't bet)
Seat 5: +Nt3OPk3XR9SKjZgm2CexQ (small blind) folded on the River
Seat 6: Z2fXsGcjl+Eax+RzOgwOmg (big blind) folded before Flop



PokerStars Game #59941642748:  Hold'em No Limit ($0.50/$1.00) - 2009/07/01 1:41:37 ET
Table 'DE4ps3MTl+4avTytwFENAg' 6-max Seat #2 is the button
Seat 1: PvfYaKbzMpsmUcbOExckbQ ($101.75 in chips)
Seat 2: QHvTZcrKe6+maWUfVjP29Q ($100 in chips)
Seat 3: cGayYjcyk6+jN57tzIY4TA ($304.10 in chips)
Seat 4: iexehpxaQwzColGqeTEnLQ ($121.85 in chips)
Seat 5: UBZQqpnJZdTYYY1FTb0rLA ($175.20 in chips)
Seat 6: lsLuWlcPA3Rh7kJVLzMh0Q ($100 in chips)
cGayYjcyk6+jN57tzIY4TA: posts small blind $0.50
iexehpxaQwzColGqeTEnLQ: posts big blind $1
*** HOLE CARDS ***
UBZQqpnJZdTYYY1FTb0rLA: raises $2 to $3
lsLuWlcPA3Rh7kJVLzMh0Q: folds
PvfYaKbzMpsmUcbOExckbQ: folds
QHvTZcrKe6+maWUfVjP29Q: folds
cGayYjcyk6+jN57tzIY4TA: folds
iexehpxaQwzColGqeTEnLQ: folds
UBZQqpnJZdTYYY1FTb0rLA collected $2.50 from pot
*** SUMMARY ***
Total pot $2.50 | Rake $0
Seat 1: PvfYaKbzMpsmUcbOExckbQ folded before Flop (didn't bet)
Seat 2: QHvTZcrKe6+maWUfVjP29Q (button) folded before Flop (didn't bet)
Seat 3: cGayYjcyk6+jN57tzIY4TA (small blind) folded before Flop
Seat 4: iexehpxaQwzColGqeTEnLQ (big blind) folded before Flop
Seat 5: UBZQqpnJZdTYYY1FTb0rLA collected ($2.50)
Seat 6: lsLuWlcPA3Rh7kJVLzMh0Q folded before Flop (didn't bet)



PokerStars Game #59941643102:  Hold'em No Limit ($0.50/$1.00) - 2009/07/01 1:41:38 ET
Table 'VOs36P6NW+QyXeQ1B62kmAE9S5sEoK9Q3olj2a53gABASeat #6 is the button
Seat 1: 4h8XtuVJtWh3DJpxGo7k5Q ($27.95 in chips)
Seat 2: y27w5IK2WXqmYzS8OU0wKA ($147.15 in chips)
Seat 3: p00KmyZiD/isPc/lZwNBTg ($14 in chips)
Seat 4: ene3nLSnQ4N961iBaUsSmA ($100 in chips)
Seat 5: o3YLm/rSY916m/on1VjXPA ($134.60 in chips)
Seat 6: slVKuQyEz8Qj4E3uLPYNXg ($46.60 in chips)
4h8XtuVJtWh3DJpxGo7k5Q: posts small blind $0.50
y27w5IK2WXqmYzS8OU0wKA: posts big blind $1
*** HOLE CARDS ***
p00KmyZiD/isPc/lZwNBTg: calls $1
ene3nLSnQ4N961iBaUsSmA: folds
o3YLm/rSY916m/on1VjXPA: folds
slVKuQyEz8Qj4E3uLPYNXg: folds
4h8XtuVJtWh3DJpxGo7k5Q: calls $0.50
y27w5IK2WXqmYzS8OU0wKA: folds
*** FLOP *** [4d 4c Qs]
4h8XtuVJtWh3DJpxGo7k5Q: checks
p00KmyZiD/isPc/lZwNBTg: checks
*** TURN *** [4d 4c Qs] [5d]
4h8XtuVJtWh3DJpxGo7k5Q: checks
p00KmyZiD/isPc/lZwNBTg: bets $3
4h8XtuVJtWh3DJpxGo7k5Q: folds
p00KmyZiD/isPc/lZwNBTg collected $2.85 from pot
*** SUMMARY ***
Total pot $3 | Rake $0.15
Board [4d 4c Qs 5d]
Seat 1: 4h8XtuVJtWh3DJpxGo7k5Q (small blind) folded on the Turn
Seat 2: y27w5IK2WXqmYzS8OU0wKA (big blind) folded before Flop
Seat 3: p00KmyZiD/isPc/lZwNBTg collected ($2.85)
Seat 4: ene3nLSnQ4N961iBaUsSmA folded before Flop (didn't bet)
Seat 5: o3YLm/rSY916m/on1VjXPA folded before Flop (didn't bet)
Seat 6: slVKuQyEz8Qj4E3uLPYNXg (button) folded before Flop (didn't bet)



PokerStars Game #59941643870:  Hold'em No Limit ($0.50/$1.00) - 2009/07/01 1:41:39 ET
Table 'O96CPOtvMBWP6kzuYDfdFA' 6-max Seat #1 is the button
Seat 1: 6alLXQIITA2EZ/lBeym8Dw ($131.75 in chips)
Seat 2: 4d1rWhpu8DzLmzMbR3QKyA ($100 in chips)
Seat 3: ieBUmHu5QBR86BArTtK4FQ ($20.05 in chips)
Seat 4: /P4w1pHg2zHYg/4ubJ0dPw ($65.45 in chips)
Seat 5: vX+iYAEINFeLxwMla7DY1Q ($90.50 in chips)
Seat 6: 3syOXva630dm1FTdwnuLpw ($86.30 in chips)
4d1rWhpu8DzLmzMbR3QKyA: posts small blind $0.50
ieBUmHu5QBR86BArTtK4FQ: posts big blind $1
*** HOLE CARDS ***
/P4w1pHg2zHYg/4ubJ0dPw: folds
vX+iYAEINFeLxwMla7DY1Q: folds
3syOXva630dm1FTdwnuLpw: folds
6alLXQIITA2EZ/lBeym8Dw: folds
4d1rWhpu8DzLmzMbR3QKyA: folds
ieBUmHu5QBR86BArTtK4FQ collected $1 from pot
*** SUMMARY ***
Total pot $1 | Rake $0
Seat 1: 6alLXQIITA2EZ/lBeym8Dw (button) folded before Flop (didn't bet)
Seat 2: 4d1rWhpu8DzLmzMbR3QKyA (small blind) folded before Flop
Seat 3: ieBUmHu5QBR86BArTtK4FQ (big blind) collected ($1)
Seat 4: /P4w1pHg2zHYg/4ubJ0dPw folded before Flop (didn't bet)
Seat 5: vX+iYAEINFeLxwMla7DY1Q folded before Flop (didn't bet)
Seat 6: 3syOXva630dm1FTdwnuLpw folded before Flop (didn't bet)



PokerStars Game #59941644220:  Hold'em No Limit ($0.50/$1.00) - 2009/07/01 1:41:40 ET
Table 'kS0cTQAEi+fdUlJP2gQYvw' 9-max Seat #8 is the button
Seat 1: SqsWPukL8kLqrhq5ZrQdSQ ($87 in chips)
Seat 2: +JautI/vSNALzwSvsOqbCQ ($78 in chips)
Seat 3: 2BV+oJIQYr65IO6nEChvbA ($62.55 in chips)
Seat 4: RUhhaALzha3TH1AkdakoGQ ($55.65 in chips)
Seat 5: 997ViqAtWn1FPjJqcffwcA ($100 in chips)
Seat 6: yAbu2QsRPVcjPbqlf/jDxw ($117.15 in chips)
Seat 7: Ffa7Nj4X5fddtROP01hfQg ($95.50 in chips)
Seat 8: vKyFzTyzfT7fZcdX+HHN+Q ($99.70 in chips)
Seat 9: OGgaARGdJQT4awWVNQ957w ($108.70 in chips)
OGgaARGdJQT4awWVNQ957w: posts small blind $0.50
SqsWPukL8kLqrhq5ZrQdSQ: posts big blind $1
*** HOLE CARDS ***
+JautI/vSNALzwSvsOqbCQ: folds
2BV+oJIQYr65IO6nEChvbA: folds
RUhhaALzha3TH1AkdakoGQ: folds
997ViqAtWn1FPjJqcffwcA: folds
yAbu2QsRPVcjPbqlf/jDxw: folds
Ffa7Nj4X5fddtROP01hfQg: raises $1 to $2
vKyFzTyzfT7fZcdX+HHN+Q: calls $2
Ffa7Nj4X5fddtROP01hfQg said, "i will get them or someone else will"
OGgaARGdJQT4awWVNQ957w: folds
SqsWPukL8kLqrhq5ZrQdSQ: calls $1
*** FLOP *** [Ad 8s Ah]
SqsWPukL8kLqrhq5ZrQdSQ: checks
Ffa7Nj4X5fddtROP01hfQg said, "the only waqy you keep them is to leave"
Ffa7Nj4X5fddtROP01hfQg: checks
vKyFzTyzfT7fZcdX+HHN+Q: checks
*** TURN *** [Ad 8s Ah] [Jd]
SqsWPukL8kLqrhq5ZrQdSQ: bets $3
Ffa7Nj4X5fddtROP01hfQg: calls $3
vKyFzTyzfT7fZcdX+HHN+Q: folds
*** RIVER *** [Ad 8s Ah Jd] [Qs]
vKyFzTyzfT7fZcdX+HHN+Q said, "c ya"
SqsWPukL8kLqrhq5ZrQdSQ: bets $5
Ffa7Nj4X5fddtROP01hfQg: raises $5 to $10
SqsWPukL8kLqrhq5ZrQdSQ: raises $15 to $25
vKyFzTyzfT7fZcdX+HHN+Q said, "good luck man"
Ffa7Nj4X5fddtROP01hfQg: raises $65.50 to $90.50 and is all-in
SqsWPukL8kLqrhq5ZrQdSQ: calls $57 and is all-in
*** SHOW DOWN ***
Ffa7Nj4X5fddtROP01hfQg: shows [Jh Js] (a full house, Jacks full of Aces)
SqsWPukL8kLqrhq5ZrQdSQ: shows [As Jc] (a full house, Aces full of Jacks)
SqsWPukL8kLqrhq5ZrQdSQ collected $173.50 from pot
*** SUMMARY ***
Total pot $176.50 | Rake $3
Board [Ad 8s Ah Jd Qs]
Seat 1: SqsWPukL8kLqrhq5ZrQdSQ (big blind) showed [As Jc] and won ($173.50) with a full house, Aces full of Jacks
Seat 2: +JautI/vSNALzwSvsOqbCQ folded before Flop (didn't bet)
Seat 3: 2BV+oJIQYr65IO6nEChvbA folded before Flop (didn't bet)
Seat 4: RUhhaALzha3TH1AkdakoGQ folded before Flop (didn't bet)
Seat 5: 997ViqAtWn1FPjJqcffwcA folded before Flop (didn't bet)
Seat 6: yAbu2QsRPVcjPbqlf/jDxw folded before Flop (didn't bet)
Seat 7: Ffa7Nj4X5fddtROP01hfQg showed [Jh Js] and lost with a full house, Jacks full of Aces
Seat 8: vKyFzTyzfT7fZcdX+HHN+Q (button) folded on the Turn
Seat 9: OGgaARGdJQT4awWVNQ957w (small blind) folded before Flop



PokerStars Game #59941644870:  Hold'em No Limit ($0.50/$1.00) - 2009/07/01 1:41:41 ET
Table 'gxFK0BVUD7cupu2uyRUZJg' 6-max Seat #5 is the button
Seat 1: M+X3uChmP6R63IwijVjgTg ($218.40 in chips)
Seat 2: hpxXcmRkXXI9HE5+5/j/0Q ($131.55 in chips)
Seat 3: Z2fXsGcjl+Eax+RzOgwOmg ($101.50 in chips)
Seat 4: Hcr4S4Nbkj5idKsvYK/eqQ ($100 in chips)
Seat 5: 0smcry9L0OOTCP+KzIS5SA ($210 in chips)
Seat 6: dYyb6/42PMC8aNFlm/eBeQ ($140.25 in chips)
dYyb6/42PMC8aNFlm/eBeQ: posts small blind $0.50
M+X3uChmP6R63IwijVjgTg: posts big blind $1
*** HOLE CARDS ***
hpxXcmRkXXI9HE5+5/j/0Q: folds
Z2fXsGcjl+Eax+RzOgwOmg: raises $3 to $4
Hcr4S4Nbkj5idKsvYK/eqQ: calls $4
0smcry9L0OOTCP+KzIS5SA: folds
dYyb6/42PMC8aNFlm/eBeQ: calls $3.50
M+X3uChmP6R63IwijVjgTg: folds
*** FLOP *** [2h As 8d]
dYyb6/42PMC8aNFlm/eBeQ: checks
Z2fXsGcjl+Eax+RzOgwOmg: bets $8
Hcr4S4Nbkj5idKsvYK/eqQ: calls $8
dYyb6/42PMC8aNFlm/eBeQ: folds
*** TURN *** [2h As 8d] [4h]
Z2fXsGcjl+Eax+RzOgwOmg: checks
Hcr4S4Nbkj5idKsvYK/eqQ: checks
*** RIVER *** [2h As 8d 4h] [Jh]
Z2fXsGcjl+Eax+RzOgwOmg: checks
Hcr4S4Nbkj5idKsvYK/eqQ: checks
*** SHOW DOWN ***
Z2fXsGcjl+Eax+RzOgwOmg: shows [Kc Js] (a pair of Jacks)
Hcr4S4Nbkj5idKsvYK/eqQ: mucks hand
Z2fXsGcjl+Eax+RzOgwOmg collected $27.60 from pot
*** SUMMARY ***
Total pot $29 | Rake $1.40
Board [2h As 8d 4h Jh]
Seat 1: M+X3uChmP6R63IwijVjgTg (big blind) folded before Flop
Seat 2: hpxXcmRkXXI9HE5+5/j/0Q folded before Flop (didn't bet)
Seat 3: Z2fXsGcjl+Eax+RzOgwOmg showed [Kc Js] and won ($27.60) with a pair of Jacks
Seat 4: Hcr4S4Nbkj5idKsvYK/eqQ mucked
Seat 5: 0smcry9L0OOTCP+KzIS5SA (button) folded before Flop (didn't bet)
Seat 6: dYyb6/42PMC8aNFlm/eBeQ (small blind) folded on the Flop



PokerStars Game #59941645400:  Hold'em No Limit ($0.50/$1.00) - 2009/07/01 1:41:42 ET
Table 'QSIig7BLMc9wY/rgBechzw' 6-max Seat #1 is the button
Seat 1: Z2fXsGcjl+Eax+RzOgwOmg ($110.05 in chips)
Seat 2: mLOIkH/qmRa+mVujQIhBRg ($23.75 in chips)
Seat 3: 4OO5v3AVduL0tePNx8wk5A ($125.20 in chips)
Seat 4: +uSzP8Jwnw7sKfQ4s66b7w ($57.80 in chips)
Seat 5: lsLuWlcPA3Rh7kJVLzMh0Q ($100 in chips)
Seat 6: Wj7mKnRFR90j40wWUu2+Og ($63.50 in chips)
mLOIkH/qmRa+mVujQIhBRg: posts small blind $0.50
4OO5v3AVduL0tePNx8wk5A: posts big blind $1
*** HOLE CARDS ***
+uSzP8Jwnw7sKfQ4s66b7w: folds
lsLuWlcPA3Rh7kJVLzMh0Q: folds
Wj7mKnRFR90j40wWUu2+Og: calls $1
Z2fXsGcjl+Eax+RzOgwOmg: raises $4 to $5
mLOIkH/qmRa+mVujQIhBRg: calls $4.50
4OO5v3AVduL0tePNx8wk5A: folds
Wj7mKnRFR90j40wWUu2+Og: folds
*** FLOP *** [6d As 2h]
mLOIkH/qmRa+mVujQIhBRg: checks
Z2fXsGcjl+Eax+RzOgwOmg: checks
*** TURN *** [6d As 2h] [Tc]
mLOIkH/qmRa+mVujQIhBRg: checks
Z2fXsGcjl+Eax+RzOgwOmg: bets $6
mLOIkH/qmRa+mVujQIhBRg: folds
Z2fXsGcjl+Eax+RzOgwOmg collected $11.40 from pot
Z2fXsGcjl+Eax+RzOgwOmg: doesn't show hand
*** SUMMARY ***
Total pot $12 | Rake $0.60
Board [6d As 2h Tc]
Seat 1: Z2fXsGcjl+Eax+RzOgwOmg (button) collected ($11.40)
Seat 2: mLOIkH/qmRa+mVujQIhBRg (small blind) folded on the Turn
Seat 3: 4OO5v3AVduL0tePNx8wk5A (big blind) folded before Flop
Seat 4: +uSzP8Jwnw7sKfQ4s66b7w folded before Flop (didn't bet)
Seat 5: lsLuWlcPA3Rh7kJVLzMh0Q folded before Flop (didn't bet)
Seat 6: Wj7mKnRFR90j40wWUu2+Og folded before Flop



PokerStars Game #59941646058:  Hold'em No Limit ($0.50/$1.00) - 2009/07/01 1:41:43 ET
Table 'ZFWj23PMihdwrNWv41OG/QtyUh+jyNvrceIQdKMJjQ2weat #3 is the button
Seat 1: j3hj7KQwBVU5NTFmtYomSw ($86.25 in chips)
Seat 2: 0smcry9L0OOTCP+KzIS5SA ($97 in chips)
Seat 3: cWwhvq/+r/w8nkhwrJoekQ ($48.70 in chips)
Seat 4: O5ZesE/6mHyuWWbvkiH/Fg ($69.70 in chips)
Seat 5: j7NIOHLZk7V2o9fOioO5ug ($101.70 in chips)
Seat 6: u23r4AyKPgHioZ6t7z6qrA ($100 in chips)
O5ZesE/6mHyuWWbvkiH/Fg: posts small blind $0.50
j7NIOHLZk7V2o9fOioO5ug: posts big blind $1
*** HOLE CARDS ***
u23r4AyKPgHioZ6t7z6qrA: calls $1
j3hj7KQwBVU5NTFmtYomSw: folds
0smcry9L0OOTCP+KzIS5SA: folds
cWwhvq/+r/w8nkhwrJoekQ: folds
O5ZesE/6mHyuWWbvkiH/Fg: raises $2 to $3
j7NIOHLZk7V2o9fOioO5ug: folds
u23r4AyKPgHioZ6t7z6qrA: calls $2
*** FLOP *** [Ac 4h 4d]
O5ZesE/6mHyuWWbvkiH/Fg: bets $3
u23r4AyKPgHioZ6t7z6qrA: folds
O5ZesE/6mHyuWWbvkiH/Fg collected $6.65 from pot
O5ZesE/6mHyuWWbvkiH/Fg: doesn't show hand
*** SUMMARY ***
Total pot $7 | Rake $0.35
Board [Ac 4h 4d]
Seat 1: j3hj7KQwBVU5NTFmtYomSw folded before Flop (didn't bet)
Seat 2: 0smcry9L0OOTCP+KzIS5SA folded before Flop (didn't bet)
Seat 3: cWwhvq/+r/w8nkhwrJoekQ (button) folded before Flop (didn't bet)
Seat 4: O5ZesE/6mHyuWWbvkiH/Fg (small blind) collected ($6.65)
Seat 5: j7NIOHLZk7V2o9fOioO5ug (big blind) folded before Flop
Seat 6: u23r4AyKPgHioZ6t7z6qrA folded on the Flop



PokerStars Game #59941646036:  Hold'em No Limit ($0.50/$1.00) - 2009/07/01 1:41:43 ET
Table 'b8oW/dOL7fDza5DfZ/dOJQ' 6-max Seat #2 is the button
Seat 1: NakujTNjHFgzceydFf+E2Q ($53.40 in chips)
Seat 2: TSuRyAHnUPCFjP7Z0rEE0w ($117.50 in chips)
Seat 3: d8WX+9nUHoqlrAGagO0Wow ($33.30 in chips)
Seat 4: 8rDbzImSi1zgxtqtF1pSbA ($10.50 in chips)
Seat 5: sr/OkkgqNbtgwJf1tmnfNg ($61 in chips)
Seat 6: PvfYaKbzMpsmUcbOExckbQ ($160.85 in chips)
d8WX+9nUHoqlrAGagO0Wow: posts small blind $0.50
8rDbzImSi1zgxtqtF1pSbA: posts big blind $1
*** HOLE CARDS ***
sr/OkkgqNbtgwJf1tmnfNg: folds
PvfYaKbzMpsmUcbOExckbQ: folds
NakujTNjHFgzceydFf+E2Q: folds
TSuRyAHnUPCFjP7Z0rEE0w: folds
d8WX+9nUHoqlrAGagO0Wow: raises $1 to $2
8rDbzImSi1zgxtqtF1pSbA: calls $1
*** FLOP *** [Jd 8d 4s]
d8WX+9nUHoqlrAGagO0Wow: bets $2
8rDbzImSi1zgxtqtF1pSbA: raises $4 to $6
d8WX+9nUHoqlrAGagO0Wow: calls $4
*** TURN *** [Jd 8d 4s] [Ad]
d8WX+9nUHoqlrAGagO0Wow: checks
8rDbzImSi1zgxtqtF1pSbA: bets $2.50 and is all-in
d8WX+9nUHoqlrAGagO0Wow: calls $2.50
*** RIVER *** [Jd 8d 4s Ad] [8s]
*** SHOW DOWN ***
d8WX+9nUHoqlrAGagO0Wow: shows [3c 4c] (two pair, Eights and Fours)
8rDbzImSi1zgxtqtF1pSbA: shows [9h 8c] (three of a kind, Eights)
8rDbzImSi1zgxtqtF1pSbA collected $20 from pot
*** SUMMARY ***
Total pot $21 | Rake $1
Board [Jd 8d 4s Ad 8s]
Seat 1: NakujTNjHFgzceydFf+E2Q folded before Flop (didn't bet)
Seat 2: TSuRyAHnUPCFjP7Z0rEE0w (button) folded before Flop (didn't bet)
Seat 3: d8WX+9nUHoqlrAGagO0Wow (small blind) showed [3c 4c] and lost with two pair, Eights and Fours
Seat 4: 8rDbzImSi1zgxtqtF1pSbA (big blind) showed [9h 8c] and won ($20) with three of a kind, Eights
Seat 5: sr/OkkgqNbtgwJf1tmnfNg folded before Flop (didn't bet)
Seat 6: PvfYaKbzMpsmUcbOExckbQ folded before Flop (didn't bet)



PokerStars Game #59941646812:  Hold'em No Limit ($0.50/$1.00) - 2009/07/01 1:41:45 ET
Table 'mmbQQVBTrPdE+wy+s+9VPA' 6-max Seat #3 is the button
Seat 1: zyP4SPoWZnKUfTvIRLCVog ($73.25 in chips)
Seat 2: XK4Qsl+DA8gAJyg85/zBIw ($40.45 in chips)
Seat 3: wx3sQGkVi2x9wJXuWNHPBw ($228.60 in chips)
Seat 4: V3iZdcw61nXF3g5hD2RrsQ ($100 in chips)
Seat 5: YMJG+F++3Aj6P8dAWda5fw ($128.20 in chips)
Seat 6: UOHYuj23MyK9R8ciY2t6FA ($100 in chips)
V3iZdcw61nXF3g5hD2RrsQ: posts small blind $0.50
YMJG+F++3Aj6P8dAWda5fw: posts big blind $1
*** HOLE CARDS ***
UOHYuj23MyK9R8ciY2t6FA: raises $2 to $3
zyP4SPoWZnKUfTvIRLCVog: folds
XK4Qsl+DA8gAJyg85/zBIw: calls $3
wx3sQGkVi2x9wJXuWNHPBw: calls $3
V3iZdcw61nXF3g5hD2RrsQ: folds
YMJG+F++3Aj6P8dAWda5fw: folds
*** FLOP *** [2d 4h 2h]
UOHYuj23MyK9R8ciY2t6FA: checks
XK4Qsl+DA8gAJyg85/zBIw: checks
wx3sQGkVi2x9wJXuWNHPBw: bets $7.50
UOHYuj23MyK9R8ciY2t6FA: folds
XK4Qsl+DA8gAJyg85/zBIw: folds
wx3sQGkVi2x9wJXuWNHPBw collected $10 from pot
*** SUMMARY ***
Total pot $10.50 | Rake $0.50
Board [2d 4h 2h]
Seat 1: zyP4SPoWZnKUfTvIRLCVog folded before Flop (didn't bet)
Seat 2: XK4Qsl+DA8gAJyg85/zBIw folded on the Flop
Seat 3: wx3sQGkVi2x9wJXuWNHPBw (button) collected ($10)
Seat 4: V3iZdcw61nXF3g5hD2RrsQ (small blind) folded before Flop
Seat 5: YMJG+F++3Aj6P8dAWda5fw (big blind) folded before Flop
Seat 6: UOHYuj23MyK9R8ciY2t6FA folded on the Flop



PokerStars Game #59941647040:  Hold'em No Limit ($0.50/$1.00) - 2009/07/01 1:41:45 ET
Table 'N2bNCDHL96aCQDvZIh+yQQ' 6-max Seat #2 is the button
Seat 1: Jjgflx10PVjcLkziEmLhSA ($92.25 in chips)
Seat 2: y27w5IK2WXqmYzS8OU0wKA ($130.15 in chips)
Seat 4: uCqEjnxh2/vFBjKYkfTOkw ($174.80 in chips)
Seat 5: ene3nLSnQ4N961iBaUsSmA ($100 in chips)
Seat 6: idVgoPAdspFPCzee6aF9Pg ($105.90 in chips)
uCqEjnxh2/vFBjKYkfTOkw: posts small blind $0.50
ene3nLSnQ4N961iBaUsSmA: posts big blind $1
*** HOLE CARDS ***
idVgoPAdspFPCzee6aF9Pg: folds
Jjgflx10PVjcLkziEmLhSA: raises $1 to $2
y27w5IK2WXqmYzS8OU0wKA: folds
VB7TtBnfmT3JTA/cCL6dJg joins the table at seat #3
uCqEjnxh2/vFBjKYkfTOkw: folds
ene3nLSnQ4N961iBaUsSmA: folds
Jjgflx10PVjcLkziEmLhSA collected $2.50 from pot
Jjgflx10PVjcLkziEmLhSA: doesn't show hand
*** SUMMARY ***
Total pot $2.50 | Rake $0
Seat 1: Jjgflx10PVjcLkziEmLhSA collected ($2.50)
Seat 2: y27w5IK2WXqmYzS8OU0wKA (button) folded before Flop (didn't bet)
Seat 4: uCqEjnxh2/vFBjKYkfTOkw (small blind) folded before Flop
Seat 5: ene3nLSnQ4N961iBaUsSmA (big blind) folded before Flop
Seat 6: idVgoPAdspFPCzee6aF9Pg folded before Flop (didn't bet)



PokerStars Game #59941649086:  Hold'em No Limit ($0.50/$1.00) - 2009/07/01 1:41:49 ET
Table 'rmZfTK+oSebeUPJNbWhdAA' 6-max Seat #2 is the button
Seat 1: xAU6q2/cwmby2sxmA8VcmA ($123.50 in chips)
Seat 2: z7O9PO/WEcqRouIydFhS9Q ($195.90 in chips)
Seat 3: BCEV3COoKY607AzLWayfRA ($217.70 in chips)
Seat 4: 1/mIuXfgx1ZyVkodrmfQDw ($168.35 in chips)
Seat 6: j7NIOHLZk7V2o9fOioO5ug ($102.20 in chips)
BCEV3COoKY607AzLWayfRA: posts small blind $0.50
1/mIuXfgx1ZyVkodrmfQDw: posts big blind $1
UOHYuj23MyK9R8ciY2t6FA: sits out
*** HOLE CARDS ***
j7NIOHLZk7V2o9fOioO5ug: folds
xAU6q2/cwmby2sxmA8VcmA: folds
z7O9PO/WEcqRouIydFhS9Q: folds
BCEV3COoKY607AzLWayfRA: raises $2 to $3
1/mIuXfgx1ZyVkodrmfQDw: folds
BCEV3COoKY607AzLWayfRA collected $2 from pot
BCEV3COoKY607AzLWayfRA: doesn't show hand
*** SUMMARY ***
Total pot $2 | Rake $0
Seat 1: xAU6q2/cwmby2sxmA8VcmA folded before Flop (didn't bet)
Seat 2: z7O9PO/WEcqRouIydFhS9Q (button) folded before Flop (didn't bet)
Seat 3: BCEV3COoKY607AzLWayfRA (small blind) collected ($2)
Seat 4: 1/mIuXfgx1ZyVkodrmfQDw (big blind) folded before Flop
Seat 6: j7NIOHLZk7V2o9fOioO5ug folded before Flop (didn't bet)



PokerStars Game #59941649742:  Hold'em No Limit ($0.50/$1.00) - 2009/07/01 1:41:50 ET
Table '7O9fB8yx1u7sJveJn8w6jA' 6-max Seat #1 is the button
Seat 1: 841740 ($40.80 in chips)
Seat 2: wx3sQGkVi2x9wJXuWNHPBw ($205.85 in chips)
Seat 3: hpxXcmRkXXI9HE5+5/j/0Q ($141.85 in chips)
Seat 4: b2a+5TkFf4xJN/Ihhma58Q ($30.35 in chips)
Seat 5: BCEV3COoKY607AzLWayfRA ($101 in chips)
Seat 6: r4lpoh2BJZ8S6zyQv1JeSw ($107.75 in chips)
wx3sQGkVi2x9wJXuWNHPBw: posts small blind $0.50
hpxXcmRkXXI9HE5+5/j/0Q: posts big blind $1
*** HOLE CARDS ***
b2a+5TkFf4xJN/Ihhma58Q: folds
BCEV3COoKY607AzLWayfRA: raises $3 to $4
r4lpoh2BJZ8S6zyQv1JeSw: folds
841740: folds
wx3sQGkVi2x9wJXuWNHPBw: folds
hpxXcmRkXXI9HE5+5/j/0Q: calls $3
*** FLOP *** [7s 8d 5d]
hpxXcmRkXXI9HE5+5/j/0Q: checks
BCEV3COoKY607AzLWayfRA: checks
*** TURN *** [7s 8d 5d] [7d]
hpxXcmRkXXI9HE5+5/j/0Q: bets $7
BCEV3COoKY607AzLWayfRA: folds
hpxXcmRkXXI9HE5+5/j/0Q collected $8.10 from pot
hpxXcmRkXXI9HE5+5/j/0Q: doesn't show hand
*** SUMMARY ***
Total pot $8.50 | Rake $0.40
Board [7s 8d 5d 7d]
Seat 1: 841740 (button) folded before Flop (didn't bet)
Seat 2: wx3sQGkVi2x9wJXuWNHPBw (small blind) folded before Flop
Seat 3: hpxXcmRkXXI9HE5+5/j/0Q (big blind) collected ($8.10)
Seat 4: b2a+5TkFf4xJN/Ihhma58Q folded before Flop (didn't bet)
Seat 5: BCEV3COoKY607AzLWayfRA folded on the Turn
Seat 6: r4lpoh2BJZ8S6zyQv1JeSw folded before Flop (didn't bet)



PokerStars Game #59941652578:  Hold'em No Limit ($0.50/$1.00) - 2009/07/01 1:41:55 ET
Table 'qj0HBN4HhQKogreu1bg7xg' 2-max Seat #2 is the button
Seat 1: NYi6JFscYNrofSXy4sM+Yw ($152.60 in chips)
Seat 2: qtyl8CSb0/4yWdbuEPJejA ($124.30 in chips)
qtyl8CSb0/4yWdbuEPJejA: posts small blind $0.50
NYi6JFscYNrofSXy4sM+Yw: posts big blind $1
*** HOLE CARDS ***
qtyl8CSb0/4yWdbuEPJejA: raises $2 to $3
NYi6JFscYNrofSXy4sM+Yw: folds
qtyl8CSb0/4yWdbuEPJejA collected $2 from pot
*** SUMMARY ***
Total pot $2 | Rake $0
Seat 1: NYi6JFscYNrofSXy4sM+Yw (big blind) folded before Flop
Seat 2: qtyl8CSb0/4yWdbuEPJejA (button) (small blind) collected ($2)



PokerStars Game #59941652346:  Hold'em No Limit ($0.50/$1.00) - 2009/07/01 1:41:55 ET
Table 'hugOjcwJvzEwZbK7tyiWuQ' 9-max Seat #2 is the button
Seat 1: S3Ex8K7v6xm5jqjRM7Fl3w ($22.35 in chips)
Seat 2: r27C1nIV4NS4+qbnrgBQSw ($275.10 in chips)
Seat 3: c/6hFCyfLNRn3VFvCeQ1ng ($32.55 in chips)
Seat 4: UWB3oeddt/GObx2Mix2Anw ($180.90 in chips)
Seat 5: AexZ4puUV9meFWwVU6Nv0w ($12.70 in chips)
Seat 6: gUUvmqdVlmvpal6B8nYrmg ($103.95 in chips)
Seat 7: FL3MrLspcF23LYvC4ipBOA ($109.80 in chips)
Seat 8: /zy+DB4S5fUQUSfZWFzYGw ($122.55 in chips)
Seat 9: W8P9bUKCs43TO1xHm0dL6w ($105.30 in chips)
c/6hFCyfLNRn3VFvCeQ1ng: posts small blind $0.50
UWB3oeddt/GObx2Mix2Anw: posts big blind $1
*** HOLE CARDS ***
AexZ4puUV9meFWwVU6Nv0w: calls $1
gUUvmqdVlmvpal6B8nYrmg: folds
FL3MrLspcF23LYvC4ipBOA: folds
/zy+DB4S5fUQUSfZWFzYGw: calls $1
W8P9bUKCs43TO1xHm0dL6w: folds
S3Ex8K7v6xm5jqjRM7Fl3w: calls $1
r27C1nIV4NS4+qbnrgBQSw: folds
c/6hFCyfLNRn3VFvCeQ1ng: calls $0.50
UWB3oeddt/GObx2Mix2Anw: checks
*** FLOP *** [5h Kh 9c]
c/6hFCyfLNRn3VFvCeQ1ng: checks
UWB3oeddt/GObx2Mix2Anw: bets $4
AexZ4puUV9meFWwVU6Nv0w: calls $4
/zy+DB4S5fUQUSfZWFzYGw: folds
S3Ex8K7v6xm5jqjRM7Fl3w: folds
c/6hFCyfLNRn3VFvCeQ1ng: folds
*** TURN *** [5h Kh 9c] [8s]
UWB3oeddt/GObx2Mix2Anw: bets $9
AexZ4puUV9meFWwVU6Nv0w: calls $7.70 and is all-in
*** RIVER *** [5h Kh 9c 8s] [2h]
*** SHOW DOWN ***
UWB3oeddt/GObx2Mix2Anw: shows [Kc Ts] (a pair of Kings)
AexZ4puUV9meFWwVU6Nv0w: shows [Jh Jc] (a pair of Jacks)
UWB3oeddt/GObx2Mix2Anw collected $27.05 from pot
*** SUMMARY ***
Total pot $28.40 | Rake $1.35
Board [5h Kh 9c 8s 2h]
Seat 1: S3Ex8K7v6xm5jqjRM7Fl3w folded on the Flop
Seat 2: r27C1nIV4NS4+qbnrgBQSw (button) folded before Flop (didn't bet)
Seat 3: c/6hFCyfLNRn3VFvCeQ1ng (small blind) folded on the Flop
Seat 4: UWB3oeddt/GObx2Mix2Anw (big blind) showed [Kc Ts] and won ($27.05) with a pair of Kings
Seat 5: AexZ4puUV9meFWwVU6Nv0w showed [Jh Jc] and lost with a pair of Jacks
Seat 6: gUUvmqdVlmvpal6B8nYrmg folded before Flop (didn't bet)
Seat 7: FL3MrLspcF23LYvC4ipBOA folded before Flop (didn't bet)
Seat 8: /zy+DB4S5fUQUSfZWFzYGw folded on the Flop
Seat 9: W8P9bUKCs43TO1xHm0dL6w folded before Flop (didn't bet)



PokerStars Game #59941653506:  Hold'em No Limit ($0.50/$1.00) - 2009/07/01 1:41:57 ET
Table 'O96CPOtvMBWP6kzuYDfdFA' 6-max Seat #2 is the button
Seat 1: 6alLXQIITA2EZ/lBeym8Dw ($131.75 in chips)
Seat 2: 4d1rWhpu8DzLmzMbR3QKyA ($100 in chips)
Seat 3: ieBUmHu5QBR86BArTtK4FQ ($20.55 in chips)
Seat 4: /P4w1pHg2zHYg/4ubJ0dPw ($65.45 in chips)
Seat 5: vX+iYAEINFeLxwMla7DY1Q ($90.50 in chips)
Seat 6: 3syOXva630dm1FTdwnuLpw ($86.30 in chips)
ieBUmHu5QBR86BArTtK4FQ: posts small blind $0.50
/P4w1pHg2zHYg/4ubJ0dPw: posts big blind $1
*** HOLE CARDS ***
vX+iYAEINFeLxwMla7DY1Q: folds
3syOXva630dm1FTdwnuLpw: folds
6alLXQIITA2EZ/lBeym8Dw: folds
4d1rWhpu8DzLmzMbR3QKyA: raises $2 to $3
ieBUmHu5QBR86BArTtK4FQ: folds
/P4w1pHg2zHYg/4ubJ0dPw: folds
4d1rWhpu8DzLmzMbR3QKyA collected $2.50 from pot
*** SUMMARY ***
Total pot $2.50 | Rake $0
Seat 1: 6alLXQIITA2EZ/lBeym8Dw folded before Flop (didn't bet)
Seat 2: 4d1rWhpu8DzLmzMbR3QKyA (button) collected ($2.50)
Seat 3: ieBUmHu5QBR86BArTtK4FQ (small blind) folded before Flop
Seat 4: /P4w1pHg2zHYg/4ubJ0dPw (big blind) folded before Flop
Seat 5: vX+iYAEINFeLxwMla7DY1Q folded before Flop (didn't bet)
Seat 6: 3syOXva630dm1FTdwnuLpw folded before Flop (didn't bet)



PokerStars Game #59941654314:  Hold'em No Limit ($0.50/$1.00) - 2009/07/01 1:41:59 ET
Table 'DE4ps3MTl+4avTytwFENAg' 6-max Seat #3 is the button
Seat 1: PvfYaKbzMpsmUcbOExckbQ ($101.75 in chips)
Seat 2: QHvTZcrKe6+maWUfVjP29Q ($100 in chips)
Seat 3: cGayYjcyk6+jN57tzIY4TA ($303.60 in chips)
Seat 4: iexehpxaQwzColGqeTEnLQ ($120.85 in chips)
Seat 6: lsLuWlcPA3Rh7kJVLzMh0Q ($100 in chips)
iexehpxaQwzColGqeTEnLQ: posts small blind $0.50
UBZQqpnJZdTYYY1FTb0rLA: is sitting out
lsLuWlcPA3Rh7kJVLzMh0Q: posts big blind $1
*** HOLE CARDS ***
UBZQqpnJZdTYYY1FTb0rLA leaves the table
PvfYaKbzMpsmUcbOExckbQ: folds
QHvTZcrKe6+maWUfVjP29Q: folds
cGayYjcyk6+jN57tzIY4TA: folds
iexehpxaQwzColGqeTEnLQ: raises $2 to $3
lsLuWlcPA3Rh7kJVLzMh0Q: calls $2
*** FLOP *** [9c Jh 8d]
iexehpxaQwzColGqeTEnLQ: bets $5
lsLuWlcPA3Rh7kJVLzMh0Q: raises $11 to $16
iexehpxaQwzColGqeTEnLQ: folds
lsLuWlcPA3Rh7kJVLzMh0Q collected $15.25 from pot
*** SUMMARY ***
Total pot $16 | Rake $0.75
Board [9c Jh 8d]
Seat 1: PvfYaKbzMpsmUcbOExckbQ folded before Flop (didn't bet)
Seat 2: QHvTZcrKe6+maWUfVjP29Q folded before Flop (didn't bet)
Seat 3: cGayYjcyk6+jN57tzIY4TA (button) folded before Flop (didn't bet)
Seat 4: iexehpxaQwzColGqeTEnLQ (small blind) folded on the Flop
Seat 6: lsLuWlcPA3Rh7kJVLzMh0Q (big blind) collected ($15.25)



PokerStars Game #59941656168:  Hold'em No Limit ($0.50/$1.00) - 2009/07/01 1:42:02 ET
Table 'iSx0wTgVb4o7MyZeOe06ZA' 9-max Seat #9 is the button
Seat 1: VPF+HjszMvUIpy0CHIwH3A ($16.25 in chips)
Seat 2: PI+yBZKhGReWUpHutlCOkw ($80.30 in chips)
Seat 3: /inIs/z/PcX+TniIFpaxpg ($15 in chips)
Seat 4: ri8CLkX3e9JF34dQNbsHGA ($33.45 in chips)
Seat 5: Pce2Q8yz4j5M9A62KvvNKw ($67.10 in chips)
Seat 6: Lik6kFnIxdZEESN5kBGZzA ($29.35 in chips)
Seat 7: w4NnqVr/Sfoj65ux/fEUyQ ($68.80 in chips)
Seat 8: gUUvmqdVlmvpal6B8nYrmg ($126.20 in chips)
Seat 9: mQADhUTC1xGjAJkD7PEg6A ($100 in chips)
VPF+HjszMvUIpy0CHIwH3A: posts small blind $0.50
PI+yBZKhGReWUpHutlCOkw: posts big blind $1
*** HOLE CARDS ***
/inIs/z/PcX+TniIFpaxpg: folds
ri8CLkX3e9JF34dQNbsHGA: folds
Pce2Q8yz4j5M9A62KvvNKw: calls $1
Lik6kFnIxdZEESN5kBGZzA: folds
w4NnqVr/Sfoj65ux/fEUyQ: calls $1
gUUvmqdVlmvpal6B8nYrmg: folds
mQADhUTC1xGjAJkD7PEg6A: folds
VPF+HjszMvUIpy0CHIwH3A: folds
PI+yBZKhGReWUpHutlCOkw: checks
*** FLOP *** [4h Kh Jd]
PI+yBZKhGReWUpHutlCOkw: checks
Pce2Q8yz4j5M9A62KvvNKw: checks
w4NnqVr/Sfoj65ux/fEUyQ: bets $3
PI+yBZKhGReWUpHutlCOkw: folds
Pce2Q8yz4j5M9A62KvvNKw: folds
w4NnqVr/Sfoj65ux/fEUyQ collected $3.35 from pot
w4NnqVr/Sfoj65ux/fEUyQ: doesn't show hand
*** SUMMARY ***
Total pot $3.50 | Rake $0.15
Board [4h Kh Jd]
Seat 1: VPF+HjszMvUIpy0CHIwH3A (small blind) folded before Flop
Seat 2: PI+yBZKhGReWUpHutlCOkw (big blind) folded on the Flop
Seat 3: /inIs/z/PcX+TniIFpaxpg folded before Flop (didn't bet)
Seat 4: ri8CLkX3e9JF34dQNbsHGA folded before Flop (didn't bet)
Seat 5: Pce2Q8yz4j5M9A62KvvNKw folded on the Flop
Seat 6: Lik6kFnIxdZEESN5kBGZzA folded before Flop (didn't bet)
Seat 7: w4NnqVr/Sfoj65ux/fEUyQ collected ($3.35)
Seat 8: gUUvmqdVlmvpal6B8nYrmg folded before Flop (didn't bet)
Seat 9: mQADhUTC1xGjAJkD7PEg6A (button) folded before Flop (didn't bet)



PokerStars Game #59941656528:  Hold'em No Limit ($0.50/$1.00) - 2009/07/01 1:42:03 ET
Table '7Nl0ffnjeK44/vmeexh3MQ' 9-max Seat #4 is the button
Seat 1: V138SURkdX8LdVBPKdJJag ($114.55 in chips)
Seat 2: OGgaARGdJQT4awWVNQ957w ($100 in chips)
Seat 3: JMmUYT5pIKCKh2pGjCB/4w ($56.90 in chips)
Seat 4: bLbSOSmSOnqE0iTcH/5dxA ($103.80 in chips)
Seat 5: 61sfw5QTu62YYIt68OsdrA ($76.55 in chips)
Seat 6: FVs16t7GgfWgQWt4JxsObQ ($16.75 in chips)
Seat 7: 997ViqAtWn1FPjJqcffwcA ($145.70 in chips)
Seat 8: HRJJZiSxFAehJGaET63dlA ($49.15 in chips)
Seat 9: /JHoNdt0fK6X+isrqRfV3w ($20 in chips)
61sfw5QTu62YYIt68OsdrA: posts small blind $0.50
FVs16t7GgfWgQWt4JxsObQ: posts big blind $1
*** HOLE CARDS ***
997ViqAtWn1FPjJqcffwcA: folds
997ViqAtWn1FPjJqcffwcA leaves the table
HRJJZiSxFAehJGaET63dlA: folds
/JHoNdt0fK6X+isrqRfV3w: folds
2fVA6XTmacKkwJ4SpKDAtA joins the table at seat #7
V138SURkdX8LdVBPKdJJag: folds
OGgaARGdJQT4awWVNQ957w: folds
JMmUYT5pIKCKh2pGjCB/4w: folds
bLbSOSmSOnqE0iTcH/5dxA: folds
61sfw5QTu62YYIt68OsdrA: folds
FVs16t7GgfWgQWt4JxsObQ collected $1 from pot
*** SUMMARY ***
Total pot $1 | Rake $0
Seat 1: V138SURkdX8LdVBPKdJJag folded before Flop (didn't bet)
Seat 2: OGgaARGdJQT4awWVNQ957w folded before Flop (didn't bet)
Seat 3: JMmUYT5pIKCKh2pGjCB/4w folded before Flop (didn't bet)
Seat 4: bLbSOSmSOnqE0iTcH/5dxA (button) folded before Flop (didn't bet)
Seat 5: 61sfw5QTu62YYIt68OsdrA (small blind) folded before Flop
Seat 6: FVs16t7GgfWgQWt4JxsObQ (big blind) collected ($1)
Seat 7: 997ViqAtWn1FPjJqcffwcA folded before Flop (didn't bet)
Seat 8: HRJJZiSxFAehJGaET63dlA folded before Flop (didn't bet)
Seat 9: /JHoNdt0fK6X+isrqRfV3w folded before Flop (didn't bet)



PokerStars Game #59941657022:  Hold'em No Limit ($0.50/$1.00) - 2009/07/01 1:42:04 ET
Table 'qj0HBN4HhQKogreu1bg7xg' 2-max Seat #1 is the button
Seat 1: NYi6JFscYNrofSXy4sM+Yw ($151.60 in chips)
Seat 2: qtyl8CSb0/4yWdbuEPJejA ($125.30 in chips)
NYi6JFscYNrofSXy4sM+Yw: posts small blind $0.50
qtyl8CSb0/4yWdbuEPJejA: posts big blind $1
*** HOLE CARDS ***
NYi6JFscYNrofSXy4sM+Yw: raises $2 to $3
qtyl8CSb0/4yWdbuEPJejA: folds
NYi6JFscYNrofSXy4sM+Yw collected $2 from pot
*** SUMMARY ***
Total pot $2 | Rake $0
Seat 1: NYi6JFscYNrofSXy4sM+Yw (button) (small blind) collected ($2)
Seat 2: qtyl8CSb0/4yWdbuEPJejA (big blind) folded before Flop



PokerStars Game #59941658914:  Hold'em No Limit ($0.50/$1.00) - 2009/07/01 1:42:07 ET
Table 'tJq9SfN1ywY0r03VBlWlwQ' 9-max Seat #9 is the button
Seat 1: wZsU+w9r7G66x93UuvBf1Q ($300.55 in chips)
Seat 4: bLbSOSmSOnqE0iTcH/5dxA ($118.20 in chips)
Seat 5: h5ipsNTMyolp7xn/NAvWkA ($126.30 in chips)
Seat 6: gUUvmqdVlmvpal6B8nYrmg ($108.60 in chips)
Seat 7: Ogn4JDV3mp4ZDKO49IFzKA ($18.40 in chips)
Seat 8: G4DEhsZFmznGNVpy2SEocA ($39.30 in chips)
Seat 9: XE5QF1y74bpHog9JxWJMWQ ($100 in chips)
wZsU+w9r7G66x93UuvBf1Q: posts small blind $0.50
VPF+HjszMvUIpy0CHIwH3A: is sitting out
bLbSOSmSOnqE0iTcH/5dxA: posts big blind $1
*** HOLE CARDS ***
h5ipsNTMyolp7xn/NAvWkA: folds
VPF+HjszMvUIpy0CHIwH3A leaves the table
myIxN7otsyr846M539YR8Q joins the table at seat #2
gUUvmqdVlmvpal6B8nYrmg: folds
Ogn4JDV3mp4ZDKO49IFzKA: folds
G4DEhsZFmznGNVpy2SEocA: folds
XE5QF1y74bpHog9JxWJMWQ: folds
wZsU+w9r7G66x93UuvBf1Q: raises $2 to $3
bLbSOSmSOnqE0iTcH/5dxA: folds
wZsU+w9r7G66x93UuvBf1Q collected $2 from pot
*** SUMMARY ***
Total pot $2 | Rake $0
Seat 1: wZsU+w9r7G66x93UuvBf1Q (small blind) collected ($2)
Seat 4: bLbSOSmSOnqE0iTcH/5dxA (big blind) folded before Flop
Seat 5: h5ipsNTMyolp7xn/NAvWkA folded before Flop (didn't bet)
Seat 6: gUUvmqdVlmvpal6B8nYrmg folded before Flop (didn't bet)
Seat 7: Ogn4JDV3mp4ZDKO49IFzKA folded before Flop (didn't bet)
Seat 8: G4DEhsZFmznGNVpy2SEocA folded before Flop (didn't bet)
Seat 9: XE5QF1y74bpHog9JxWJMWQ (button) folded before Flop (didn't bet)



PokerStars Game #59941659620:  Hold'em No Limit ($0.50/$1.00) - 2009/07/01 1:42:09 ET
Table '3T4owEKJKyGTMePwrv50FQ' 9-max Seat #6 is the button
Seat 1: OGgaARGdJQT4awWVNQ957w ($101.50 in chips)
Seat 2: t+Id2O6herCLgwnC4m49PA ($30.55 in chips)
Seat 3: DOLzOcBTZYcph5jEfKFWuQ ($106.40 in chips)
Seat 4: O5Go3jrzbQWxRB6ESK+Ptg ($62.10 in chips)
Seat 5: mMc/PBpqlN24gdi3C/1tOw ($49.75 in chips)
Seat 6: V138SURkdX8LdVBPKdJJag ($106.75 in chips)
Seat 7: 1862487932 ($104.50 in chips)
Seat 8: bLbSOSmSOnqE0iTcH/5dxA ($198.50 in chips)
Seat 9: 61sfw5QTu62YYIt68OsdrA ($84.75 in chips)
1862487932: posts small blind $0.50
bLbSOSmSOnqE0iTcH/5dxA: posts big blind $1
*** HOLE CARDS ***
61sfw5QTu62YYIt68OsdrA: folds
OGgaARGdJQT4awWVNQ957w: folds
t+Id2O6herCLgwnC4m49PA: calls $1
DOLzOcBTZYcph5jEfKFWuQ: folds
O5Go3jrzbQWxRB6ESK+Ptg: folds
mMc/PBpqlN24gdi3C/1tOw: calls $1
V138SURkdX8LdVBPKdJJag: raises $5 to $6
1862487932: folds
bLbSOSmSOnqE0iTcH/5dxA: folds
t+Id2O6herCLgwnC4m49PA: folds
mMc/PBpqlN24gdi3C/1tOw: folds
V138SURkdX8LdVBPKdJJag collected $4.50 from pot
V138SURkdX8LdVBPKdJJag: doesn't show hand
*** SUMMARY ***
Total pot $4.50 | Rake $0
Seat 1: OGgaARGdJQT4awWVNQ957w folded before Flop (didn't bet)
Seat 2: t+Id2O6herCLgwnC4m49PA folded before Flop
Seat 3: DOLzOcBTZYcph5jEfKFWuQ folded before Flop (didn't bet)
Seat 4: O5Go3jrzbQWxRB6ESK+Ptg folded before Flop (didn't bet)
Seat 5: mMc/PBpqlN24gdi3C/1tOw folded before Flop
Seat 6: V138SURkdX8LdVBPKdJJag (button) collected ($4.50)
Seat 7: 1862487932 (small blind) folded before Flop
Seat 8: bLbSOSmSOnqE0iTcH/5dxA (big blind) folded before Flop
Seat 9: 61sfw5QTu62YYIt68OsdrA folded before Flop (didn't bet)



PokerStars Game #59941659814:  Hold'em No Limit ($0.50/$1.00) - 2009/07/01 1:42:09 ET
Table 'rmZfTK+oSebeUPJNbWhdAA' 6-max Seat #3 is the button
Seat 1: xAU6q2/cwmby2sxmA8VcmA ($123.50 in chips)
Seat 2: z7O9PO/WEcqRouIydFhS9Q ($195.90 in chips)
Seat 3: BCEV3COoKY607AzLWayfRA ($218.70 in chips)
Seat 4: 1/mIuXfgx1ZyVkodrmfQDw ($167.35 in chips)
Seat 5: UOHYuj23MyK9R8ciY2t6FA ($100 in chips)
Seat 6: j7NIOHLZk7V2o9fOioO5ug ($102.20 in chips)
1/mIuXfgx1ZyVkodrmfQDw: posts small blind $0.50
UOHYuj23MyK9R8ciY2t6FA: posts big blind $1
*** HOLE CARDS ***
j7NIOHLZk7V2o9fOioO5ug: folds
xAU6q2/cwmby2sxmA8VcmA: folds
z7O9PO/WEcqRouIydFhS9Q: raises $2 to $3
BCEV3COoKY607AzLWayfRA: folds
1/mIuXfgx1ZyVkodrmfQDw: folds
UOHYuj23MyK9R8ciY2t6FA: folds
z7O9PO/WEcqRouIydFhS9Q collected $2.50 from pot
z7O9PO/WEcqRouIydFhS9Q: doesn't show hand
*** SUMMARY ***
Total pot $2.50 | Rake $0
Seat 1: xAU6q2/cwmby2sxmA8VcmA folded before Flop (didn't bet)
Seat 2: z7O9PO/WEcqRouIydFhS9Q collected ($2.50)
Seat 3: BCEV3COoKY607AzLWayfRA (button) folded before Flop (didn't bet)
Seat 4: 1/mIuXfgx1ZyVkodrmfQDw (small blind) folded before Flop
Seat 5: UOHYuj23MyK9R8ciY2t6FA (big blind) folded before Flop
Seat 6: j7NIOHLZk7V2o9fOioO5ug folded before Flop (didn't bet)



PokerStars Game #59941660654:  Hold'em No Limit ($0.50/$1.00) - 2009/07/01 1:42:11 ET
Table 'qj0HBN4HhQKogreu1bg7xg' 2-max Seat #2 is the button
Seat 1: NYi6JFscYNrofSXy4sM+Yw ($152.60 in chips)
Seat 2: qtyl8CSb0/4yWdbuEPJejA ($124.30 in chips)
qtyl8CSb0/4yWdbuEPJejA: posts small blind $0.50
NYi6JFscYNrofSXy4sM+Yw: posts big blind $1
*** HOLE CARDS ***
qtyl8CSb0/4yWdbuEPJejA: raises $2 to $3
NYi6JFscYNrofSXy4sM+Yw: calls $2
*** FLOP *** [8c Jh Ks]
NYi6JFscYNrofSXy4sM+Yw: checks
qtyl8CSb0/4yWdbuEPJejA: bets $7
NYi6JFscYNrofSXy4sM+Yw: folds
qtyl8CSb0/4yWdbuEPJejA collected $5.70 from pot
qtyl8CSb0/4yWdbuEPJejA: doesn't show hand
*** SUMMARY ***
Total pot $6 | Rake $0.30
Board [8c Jh Ks]
Seat 1: NYi6JFscYNrofSXy4sM+Yw (big blind) folded on the Flop
Seat 2: qtyl8CSb0/4yWdbuEPJejA (button) (small blind) collected ($5.70)



PokerStars Game #59941661630:  Hold'em No Limit ($0.50/$1.00) - 2009/07/01 1:42:12 ET
Table 'N2bNCDHL96aCQDvZIh+yQQ' 6-max Seat #4 is the button
Seat 1: Jjgflx10PVjcLkziEmLhSA ($93.75 in chips)
Seat 2: y27w5IK2WXqmYzS8OU0wKA ($130.15 in chips)
Seat 4: uCqEjnxh2/vFBjKYkfTOkw ($174.30 in chips)
Seat 5: ene3nLSnQ4N961iBaUsSmA ($100 in chips)
Seat 6: idVgoPAdspFPCzee6aF9Pg ($105.90 in chips)
ene3nLSnQ4N961iBaUsSmA: posts small blind $0.50
idVgoPAdspFPCzee6aF9Pg: posts big blind $1
VB7TtBnfmT3JTA/cCL6dJg: sits out
*** HOLE CARDS ***
Jjgflx10PVjcLkziEmLhSA: folds
y27w5IK2WXqmYzS8OU0wKA: folds
uCqEjnxh2/vFBjKYkfTOkw: folds
ene3nLSnQ4N961iBaUsSmA: folds
idVgoPAdspFPCzee6aF9Pg collected $1 from pot
idVgoPAdspFPCzee6aF9Pg: doesn't show hand
*** SUMMARY ***
Total pot $1 | Rake $0
Seat 1: Jjgflx10PVjcLkziEmLhSA folded before Flop (didn't bet)
Seat 2: y27w5IK2WXqmYzS8OU0wKA folded before Flop (didn't bet)
Seat 4: uCqEjnxh2/vFBjKYkfTOkw (button) folded before Flop (didn't bet)
Seat 5: ene3nLSnQ4N961iBaUsSmA (small blind) folded before Flop
Seat 6: idVgoPAdspFPCzee6aF9Pg (big blind) collected ($1)



PokerStars Game #59941662170:  Hold'em No Limit ($0.50/$1.00) - 2009/07/01 1:42:13 ET
Table '/RZcOwpZpHQ+OwPwjsbnRw' 6-max Seat #3 is the button
Seat 1: +uSzP8Jwnw7sKfQ4s66b7w ($88.90 in chips)
Seat 2: Z2fXsGcjl+Eax+RzOgwOmg ($100 in chips)
Seat 3: LJMw/I77xpnw0R5T4HnMUg ($106.55 in chips)
Seat 4: j7NIOHLZk7V2o9fOioO5ug ($116.70 in chips)
Seat 5: wx3sQGkVi2x9wJXuWNHPBw ($164.25 in chips)
Seat 6: o3YLm/rSY916m/on1VjXPA ($205.50 in chips)
j7NIOHLZk7V2o9fOioO5ug: posts small blind $0.50
wx3sQGkVi2x9wJXuWNHPBw: posts big blind $1
*** HOLE CARDS ***
o3YLm/rSY916m/on1VjXPA: raises $2 to $3
+uSzP8Jwnw7sKfQ4s66b7w: folds
Z2fXsGcjl+Eax+RzOgwOmg: calls $3
LJMw/I77xpnw0R5T4HnMUg: folds
j7NIOHLZk7V2o9fOioO5ug: folds
wx3sQGkVi2x9wJXuWNHPBw: folds
*** FLOP *** [7h 3d 8c]
o3YLm/rSY916m/on1VjXPA: checks
Z2fXsGcjl+Eax+RzOgwOmg: bets $5
o3YLm/rSY916m/on1VjXPA: folds
Z2fXsGcjl+Eax+RzOgwOmg collected $7.15 from pot
Z2fXsGcjl+Eax+RzOgwOmg: doesn't show hand
*** SUMMARY ***
Total pot $7.50 | Rake $0.35
Board [7h 3d 8c]
Seat 1: +uSzP8Jwnw7sKfQ4s66b7w folded before Flop (didn't bet)
Seat 2: Z2fXsGcjl+Eax+RzOgwOmg collected ($7.15)
Seat 3: LJMw/I77xpnw0R5T4HnMUg (button) folded before Flop (didn't bet)
Seat 4: j7NIOHLZk7V2o9fOioO5ug (small blind) folded before Flop
Seat 5: wx3sQGkVi2x9wJXuWNHPBw (big blind) folded before Flop
Seat 6: o3YLm/rSY916m/on1VjXPA folded on the Flop



PokerStars Game #59941662586:  Hold'em No Limit ($0.50/$1.00) - 2009/07/01 1:42:14 ET
Table 'fZjVbKj9D8yOB+Rj7NaP/A' 9-max Seat #3 is the button
Seat 2: PTAFYDIUSsG+SArbxNl+Aw ($100 in chips)
Seat 3: yAbu2QsRPVcjPbqlf/jDxw ($102.15 in chips)
Seat 5: PkGfq5xrSlNsujKaG/HF4Q ($100 in chips)
Seat 6: OvwYHV65yUbgdBjSmo1+5g ($135.45 in chips)
Seat 7: SyS20PAm3RpT6uLBsGkwOA ($110.70 in chips)
Seat 8: EVvb0huXeMB7dnOAiO4ggA ($48.50 in chips)
Seat 9: qheQay5YvP2DMAb3OUSxtw ($143.60 in chips)
PkGfq5xrSlNsujKaG/HF4Q: posts small blind $0.50
OvwYHV65yUbgdBjSmo1+5g: posts big blind $1
kiakSwxX0e64PwYGAPQvLw: sits out
*** HOLE CARDS ***
SyS20PAm3RpT6uLBsGkwOA: folds
EVvb0huXeMB7dnOAiO4ggA: folds
qheQay5YvP2DMAb3OUSxtw: folds
PTAFYDIUSsG+SArbxNl+Aw: raises $2 to $3
yAbu2QsRPVcjPbqlf/jDxw: folds
PkGfq5xrSlNsujKaG/HF4Q: raises $8 to $11
OvwYHV65yUbgdBjSmo1+5g: folds
likAqWsWycNGwDQIcHN6GA joins the table at seat #4
PTAFYDIUSsG+SArbxNl+Aw: raises $18 to $29
PkGfq5xrSlNsujKaG/HF4Q: folds
PTAFYDIUSsG+SArbxNl+Aw collected $23 from pot
PTAFYDIUSsG+SArbxNl+Aw: doesn't show hand
*** SUMMARY ***
Total pot $23 | Rake $0
Seat 2: PTAFYDIUSsG+SArbxNl+Aw collected ($23)
Seat 3: yAbu2QsRPVcjPbqlf/jDxw (button) folded before Flop (didn't bet)
Seat 5: PkGfq5xrSlNsujKaG/HF4Q (small blind) folded before Flop
Seat 6: OvwYHV65yUbgdBjSmo1+5g (big blind) folded before Flop
Seat 7: SyS20PAm3RpT6uLBsGkwOA folded before Flop (didn't bet)
Seat 8: EVvb0huXeMB7dnOAiO4ggA folded before Flop (didn't bet)
Seat 9: qheQay5YvP2DMAb3OUSxtw folded before Flop (didn't bet)



PokerStars Game #59941663488:  Hold'em No Limit ($0.50/$1.00) - 2009/07/01 1:42:16 ET
Table 'fTlPiCj0utgzC/5io+I7ew' 6-max Seat #1 is the button
Seat 1: YMJG+F++3Aj6P8dAWda5fw ($103 in chips)
Seat 2: qVr1nl3dy2xXPqS8UpTDlA ($38.45 in chips)
Seat 3: Z2fXsGcjl+Eax+RzOgwOmg ($132.50 in chips)
Seat 4: uJVSceLggtsrJya+WtmUEA ($166.35 in chips)
Seat 5: XUk5GQsfNFpHvaToDZ0rZA ($42.05 in chips)
Seat 6: y27w5IK2WXqmYzS8OU0wKA ($100 in chips)
qVr1nl3dy2xXPqS8UpTDlA: posts small blind $0.50
Z2fXsGcjl+Eax+RzOgwOmg: posts big blind $1
*** HOLE CARDS ***
uJVSceLggtsrJya+WtmUEA: folds
XUk5GQsfNFpHvaToDZ0rZA: folds
y27w5IK2WXqmYzS8OU0wKA: folds
YMJG+F++3Aj6P8dAWda5fw: folds
qVr1nl3dy2xXPqS8UpTDlA: raises $1 to $2
Z2fXsGcjl+Eax+RzOgwOmg: calls $1
*** FLOP *** [6h 9d 2c]
qVr1nl3dy2xXPqS8UpTDlA: bets $2
Z2fXsGcjl+Eax+RzOgwOmg: folds
qVr1nl3dy2xXPqS8UpTDlA collected $3.80 from pot
*** SUMMARY ***
Total pot $4 | Rake $0.20
Board [6h 9d 2c]
Seat 1: YMJG+F++3Aj6P8dAWda5fw (button) folded before Flop (didn't bet)
Seat 2: qVr1nl3dy2xXPqS8UpTDlA (small blind) collected ($3.80)
Seat 3: Z2fXsGcjl+Eax+RzOgwOmg (big blind) folded on the Flop
Seat 4: uJVSceLggtsrJya+WtmUEA folded before Flop (didn't bet)
Seat 5: XUk5GQsfNFpHvaToDZ0rZA folded before Flop (didn't bet)
Seat 6: y27w5IK2WXqmYzS8OU0wKA folded before Flop (didn't bet)



PokerStars Game #59941664372:  Hold'em No Limit ($0.50/$1.00) - 2009/07/01 1:42:18 ET
Table 'ZFWj23PMihdwrNWv41OG/QtyUh+jyNvrceIQdKMJjQ2weat #4 is the button
Seat 1: j3hj7KQwBVU5NTFmtYomSw ($86.25 in chips)
Seat 2: 0smcry9L0OOTCP+KzIS5SA ($97 in chips)
Seat 3: cWwhvq/+r/w8nkhwrJoekQ ($48.70 in chips)
Seat 4: O5ZesE/6mHyuWWbvkiH/Fg ($73.35 in chips)
Seat 5: j7NIOHLZk7V2o9fOioO5ug ($100.70 in chips)
Seat 6: u23r4AyKPgHioZ6t7z6qrA ($97 in chips)
j7NIOHLZk7V2o9fOioO5ug: posts small blind $0.50
u23r4AyKPgHioZ6t7z6qrA: posts big blind $1
*** HOLE CARDS ***
j3hj7KQwBVU5NTFmtYomSw: folds
j3hj7KQwBVU5NTFmtYomSw leaves the table
0smcry9L0OOTCP+KzIS5SA: raises $2 to $3
cWwhvq/+r/w8nkhwrJoekQ: raises $45.70 to $48.70 and is all-in
O5ZesE/6mHyuWWbvkiH/Fg: folds
j7NIOHLZk7V2o9fOioO5ug: folds
u23r4AyKPgHioZ6t7z6qrA: folds
0smcry9L0OOTCP+KzIS5SA: folds
cWwhvq/+r/w8nkhwrJoekQ collected $7.50 from pot
*** SUMMARY ***
Total pot $7.50 | Rake $0
Seat 1: j3hj7KQwBVU5NTFmtYomSw folded before Flop (didn't bet)
Seat 2: 0smcry9L0OOTCP+KzIS5SA folded before Flop
Seat 3: cWwhvq/+r/w8nkhwrJoekQ collected ($7.50)
Seat 4: O5ZesE/6mHyuWWbvkiH/Fg (button) folded before Flop (didn't bet)
Seat 5: j7NIOHLZk7V2o9fOioO5ug (small blind) folded before Flop
Seat 6: u23r4AyKPgHioZ6t7z6qrA (big blind) folded before Flop



PokerStars Game #59941664674:  Hold'em No Limit ($0.50/$1.00) - 2009/07/01 1:42:18 ET
Table 'O96CPOtvMBWP6kzuYDfdFA' 6-max Seat #3 is the button
Seat 1: 6alLXQIITA2EZ/lBeym8Dw ($131.75 in chips)
Seat 2: 4d1rWhpu8DzLmzMbR3QKyA ($101.50 in chips)
Seat 3: ieBUmHu5QBR86BArTtK4FQ ($20.05 in chips)
Seat 4: /P4w1pHg2zHYg/4ubJ0dPw ($64.45 in chips)
Seat 5: vX+iYAEINFeLxwMla7DY1Q ($90.50 in chips)
Seat 6: 3syOXva630dm1FTdwnuLpw ($86.30 in chips)
/P4w1pHg2zHYg/4ubJ0dPw: posts small blind $0.50
vX+iYAEINFeLxwMla7DY1Q: posts big blind $1
*** HOLE CARDS ***
3syOXva630dm1FTdwnuLpw: folds
6alLXQIITA2EZ/lBeym8Dw: folds
4d1rWhpu8DzLmzMbR3QKyA: folds
ieBUmHu5QBR86BArTtK4FQ: raises $1 to $2
/P4w1pHg2zHYg/4ubJ0dPw: folds
vX+iYAEINFeLxwMla7DY1Q: folds
ieBUmHu5QBR86BArTtK4FQ collected $2.50 from pot
ieBUmHu5QBR86BArTtK4FQ: doesn't show hand
*** SUMMARY ***
Total pot $2.50 | Rake $0
Seat 1: 6alLXQIITA2EZ/lBeym8Dw folded before Flop (didn't bet)
Seat 2: 4d1rWhpu8DzLmzMbR3QKyA folded before Flop (didn't bet)
Seat 3: ieBUmHu5QBR86BArTtK4FQ (button) collected ($2.50)
Seat 4: /P4w1pHg2zHYg/4ubJ0dPw (small blind) folded before Flop
Seat 5: vX+iYAEINFeLxwMla7DY1Q (big blind) folded before Flop
Seat 6: 3syOXva630dm1FTdwnuLpw folded before Flop (didn't bet)



PokerStars Game #59941666360:  Hold'em No Limit ($0.50/$1.00) - 2009/07/01 1:42:21 ET
Table 'uNlePsyMIqzM691Xkrlk6Q' 9-max Seat #6 is the button
Seat 1: bLbSOSmSOnqE0iTcH/5dxA ($110.90 in chips)
Seat 2: TAfo4veNRaRlzDXMMYS3Jg ($18.50 in chips)
Seat 3: h7qXkU57Bb8ZuPwMyxR8Ug ($119 in chips)
Seat 4: WRTVKFHeb0vRJnVi5NdJZw ($43.25 in chips)
Seat 5: G9Fo2TZCN7HI43Po4zSN3A ($109.40 in chips)
Seat 6: mMc/PBpqlN24gdi3C/1tOw ($39 in chips)
Seat 7: KNAaBvPYSXyLqb88ypSbuQ ($35.05 in chips)
Seat 8: yWcEtGJ3ijZsF6HqlHqkrg ($118.70 in chips)
Seat 9: OGgaARGdJQT4awWVNQ957w ($113.60 in chips)
KNAaBvPYSXyLqb88ypSbuQ: posts small blind $0.50
yWcEtGJ3ijZsF6HqlHqkrg: posts big blind $1
*** HOLE CARDS ***
OGgaARGdJQT4awWVNQ957w: folds
bLbSOSmSOnqE0iTcH/5dxA: folds
TAfo4veNRaRlzDXMMYS3Jg: raises $17.50 to $18.50 and is all-in
h7qXkU57Bb8ZuPwMyxR8Ug: folds
WRTVKFHeb0vRJnVi5NdJZw: folds
G9Fo2TZCN7HI43Po4zSN3A: folds
mMc/PBpqlN24gdi3C/1tOw: folds
KNAaBvPYSXyLqb88ypSbuQ: folds
yWcEtGJ3ijZsF6HqlHqkrg: folds
TAfo4veNRaRlzDXMMYS3Jg collected $2.50 from pot
TAfo4veNRaRlzDXMMYS3Jg: doesn't show hand
*** SUMMARY ***
Total pot $2.50 | Rake $0
Seat 1: bLbSOSmSOnqE0iTcH/5dxA folded before Flop (didn't bet)
Seat 2: TAfo4veNRaRlzDXMMYS3Jg collected ($2.50)
Seat 3: h7qXkU57Bb8ZuPwMyxR8Ug folded before Flop (didn't bet)
Seat 4: WRTVKFHeb0vRJnVi5NdJZw folded before Flop (didn't bet)
Seat 5: G9Fo2TZCN7HI43Po4zSN3A folded before Flop (didn't bet)
Seat 6: mMc/PBpqlN24gdi3C/1tOw (button) folded before Flop (didn't bet)
Seat 7: KNAaBvPYSXyLqb88ypSbuQ (small blind) folded before Flop
Seat 8: yWcEtGJ3ijZsF6HqlHqkrg (big blind) folded before Flop
Seat 9: OGgaARGdJQT4awWVNQ957w folded before Flop (didn't bet)



PokerStars Game #59941667340:  Hold'em No Limit ($0.50/$1.00) - 2009/07/01 1:42:23 ET
Table '7Nl0ffnjeK44/vmeexh3MQ' 9-max Seat #5 is the button
Seat 1: V138SURkdX8LdVBPKdJJag ($114.55 in chips)
Seat 2: OGgaARGdJQT4awWVNQ957w ($100 in chips)
Seat 3: JMmUYT5pIKCKh2pGjCB/4w ($56.90 in chips)
Seat 4: bLbSOSmSOnqE0iTcH/5dxA ($103.80 in chips)
Seat 5: 61sfw5QTu62YYIt68OsdrA ($76.05 in chips)
Seat 6: FVs16t7GgfWgQWt4JxsObQ ($17.25 in chips)
Seat 7: 2fVA6XTmacKkwJ4SpKDAtA ($100 in chips)
Seat 8: HRJJZiSxFAehJGaET63dlA ($49.15 in chips)
Seat 9: /JHoNdt0fK6X+isrqRfV3w ($20 in chips)
FVs16t7GgfWgQWt4JxsObQ: posts small blind $0.50
2fVA6XTmacKkwJ4SpKDAtA: posts big blind $1
*** HOLE CARDS ***
HRJJZiSxFAehJGaET63dlA: raises $1.25 to $2.25
/JHoNdt0fK6X+isrqRfV3w: folds
V138SURkdX8LdVBPKdJJag: folds
OGgaARGdJQT4awWVNQ957w: folds
JMmUYT5pIKCKh2pGjCB/4w: folds
bLbSOSmSOnqE0iTcH/5dxA: raises $6.25 to $8.50
61sfw5QTu62YYIt68OsdrA: folds
FVs16t7GgfWgQWt4JxsObQ: folds
2fVA6XTmacKkwJ4SpKDAtA: folds
HRJJZiSxFAehJGaET63dlA: folds
bLbSOSmSOnqE0iTcH/5dxA collected $6 from pot
bLbSOSmSOnqE0iTcH/5dxA: doesn't show hand
*** SUMMARY ***
Total pot $6 | Rake $0
Seat 1: V138SURkdX8LdVBPKdJJag folded before Flop (didn't bet)
Seat 2: OGgaARGdJQT4awWVNQ957w folded before Flop (didn't bet)
Seat 3: JMmUYT5pIKCKh2pGjCB/4w folded before Flop (didn't bet)
Seat 4: bLbSOSmSOnqE0iTcH/5dxA collected ($6)
Seat 5: 61sfw5QTu62YYIt68OsdrA (button) folded before Flop (didn't bet)
Seat 6: FVs16t7GgfWgQWt4JxsObQ (small blind) folded before Flop
Seat 7: 2fVA6XTmacKkwJ4SpKDAtA (big blind) folded before Flop
Seat 8: HRJJZiSxFAehJGaET63dlA folded before Flop
Seat 9: /JHoNdt0fK6X+isrqRfV3w folded before Flop (didn't bet)



PokerStars Game #59941667938:  Hold'em No Limit ($0.50/$1.00) - 2009/07/01 1:42:24 ET
Table '305hiksPPCCdC6V2LNsO5w' 6-max Seat #5 is the button
Seat 1: RTuDLJHh/9zPfBftoc9vsw ($7.25 in chips)
Seat 2: j7NIOHLZk7V2o9fOioO5ug ($159.20 in chips)
Seat 3: +zIVjZKLpcidfRHgVZW8lA ($28.50 in chips)
Seat 4: uJVSceLggtsrJya+WtmUEA ($202.30 in chips)
Seat 5: +Nt3OPk3XR9SKjZgm2CexQ ($100 in chips)
Seat 6: 9/Tq8dw7kWW68uN8bFupXg ($20.35 in chips)
9/Tq8dw7kWW68uN8bFupXg: posts small blind $0.50
RTuDLJHh/9zPfBftoc9vsw: posts big blind $1
*** HOLE CARDS ***
j7NIOHLZk7V2o9fOioO5ug: folds
+zIVjZKLpcidfRHgVZW8lA: folds
uJVSceLggtsrJya+WtmUEA: folds
+Nt3OPk3XR9SKjZgm2CexQ: folds
9/Tq8dw7kWW68uN8bFupXg: raises $19.35 to $20.35 and is all-in
RTuDLJHh/9zPfBftoc9vsw: calls $6.25 and is all-in
*** FLOP *** [9h 8h Js]
*** TURN *** [9h 8h Js] [Ad]
*** RIVER *** [9h 8h Js Ad] [Jd]
*** SHOW DOWN ***
9/Tq8dw7kWW68uN8bFupXg: shows [Ah 7h] (two pair, Aces and Jacks)
RTuDLJHh/9zPfBftoc9vsw: mucks hand
9/Tq8dw7kWW68uN8bFupXg collected $13.80 from pot
RTuDLJHh/9zPfBftoc9vsw leaves the table
*** SUMMARY ***
Total pot $14.50 | Rake $0.70
Board [9h 8h Js Ad Jd]
Seat 1: RTuDLJHh/9zPfBftoc9vsw (big blind) mucked
Seat 2: j7NIOHLZk7V2o9fOioO5ug folded before Flop (didn't bet)
Seat 3: +zIVjZKLpcidfRHgVZW8lA folded before Flop (didn't bet)
Seat 4: uJVSceLggtsrJya+WtmUEA folded before Flop (didn't bet)
Seat 5: +Nt3OPk3XR9SKjZgm2CexQ (button) folded before Flop (didn't bet)
Seat 6: 9/Tq8dw7kWW68uN8bFupXg (small blind) showed [Ah 7h] and won ($13.80) with two pair, Aces and Jacks



PokerStars Game #59941668670:  Hold'em No Limit ($0.50/$1.00) - 2009/07/01 1:42:26 ET
Table 'rmZfTK+oSebeUPJNbWhdAA' 6-max Seat #4 is the button
Seat 1: xAU6q2/cwmby2sxmA8VcmA ($123.50 in chips)
Seat 2: z7O9PO/WEcqRouIydFhS9Q ($197.40 in chips)
Seat 3: BCEV3COoKY607AzLWayfRA ($218.70 in chips)
Seat 4: 1/mIuXfgx1ZyVkodrmfQDw ($166.85 in chips)
Seat 5: UOHYuj23MyK9R8ciY2t6FA ($100 in chips)
Seat 6: j7NIOHLZk7V2o9fOioO5ug ($102.20 in chips)
UOHYuj23MyK9R8ciY2t6FA: posts small blind $0.50
j7NIOHLZk7V2o9fOioO5ug: posts big blind $1
*** HOLE CARDS ***
xAU6q2/cwmby2sxmA8VcmA: folds
z7O9PO/WEcqRouIydFhS9Q: raises $2 to $3
BCEV3COoKY607AzLWayfRA: calls $3
1/mIuXfgx1ZyVkodrmfQDw: folds
UOHYuj23MyK9R8ciY2t6FA: folds
j7NIOHLZk7V2o9fOioO5ug: folds
*** FLOP *** [Qs 3d 7d]
z7O9PO/WEcqRouIydFhS9Q: checks
BCEV3COoKY607AzLWayfRA: checks
*** TURN *** [Qs 3d 7d] [9s]
z7O9PO/WEcqRouIydFhS9Q: checks
BCEV3COoKY607AzLWayfRA: bets $6
z7O9PO/WEcqRouIydFhS9Q: calls $6
*** RIVER *** [Qs 3d 7d 9s] [9d]
z7O9PO/WEcqRouIydFhS9Q: checks
BCEV3COoKY607AzLWayfRA: checks
*** SHOW DOWN ***
z7O9PO/WEcqRouIydFhS9Q: shows [Kd Ad] (a flush, Ace high)
BCEV3COoKY607AzLWayfRA: mucks hand
z7O9PO/WEcqRouIydFhS9Q collected $18.55 from pot
*** SUMMARY ***
Total pot $19.50 | Rake $0.95
Board [Qs 3d 7d 9s 9d]
Seat 1: xAU6q2/cwmby2sxmA8VcmA folded before Flop (didn't bet)
Seat 2: z7O9PO/WEcqRouIydFhS9Q showed [Kd Ad] and won ($18.55) with a flush, Ace high
Seat 3: BCEV3COoKY607AzLWayfRA mucked
Seat 4: 1/mIuXfgx1ZyVkodrmfQDw (button) folded before Flop (didn't bet)
Seat 5: UOHYuj23MyK9R8ciY2t6FA (small blind) folded before Flop
Seat 6: j7NIOHLZk7V2o9fOioO5ug (big blind) folded before Flop



PokerStars Game #59941668742:  Hold'em No Limit ($0.50/$1.00) - 2009/07/01 1:42:26 ET
Table 'qj0HBN4HhQKogreu1bg7xg' 2-max Seat #1 is the button
Seat 1: NYi6JFscYNrofSXy4sM+Yw ($149.60 in chips)
Seat 2: qtyl8CSb0/4yWdbuEPJejA ($127 in chips)
NYi6JFscYNrofSXy4sM+Yw: posts small blind $0.50
qtyl8CSb0/4yWdbuEPJejA: posts big blind $1
*** HOLE CARDS ***
NYi6JFscYNrofSXy4sM+Yw: raises $2 to $3
qtyl8CSb0/4yWdbuEPJejA: folds
NYi6JFscYNrofSXy4sM+Yw collected $2 from pot
*** SUMMARY ***
Total pot $2 | Rake $0
Seat 1: NYi6JFscYNrofSXy4sM+Yw (button) (small blind) collected ($2)
Seat 2: qtyl8CSb0/4yWdbuEPJejA (big blind) folded before Flop



PokerStars Game #59941670042:  Hold'em No Limit ($0.50/$1.00) - 2009/07/01 1:42:28 ET
Table 'MUPc8FEpe/nR0BKSeReX6Q' 6-max Seat #6 is the button
Seat 1: qhkK6+yCciTRd+rCFEbnEQ ($84.20 in chips)
Seat 2: xAU6q2/cwmby2sxmA8VcmA ($103.70 in chips)
Seat 3: wx3sQGkVi2x9wJXuWNHPBw ($286.15 in chips)
Seat 4: r4lpoh2BJZ8S6zyQv1JeSw ($110 in chips)
Seat 5: y27w5IK2WXqmYzS8OU0wKA ($129.55 in chips)
Seat 6: ene3nLSnQ4N961iBaUsSmA ($100 in chips)
qhkK6+yCciTRd+rCFEbnEQ: posts small blind $0.50
xAU6q2/cwmby2sxmA8VcmA: posts big blind $1
*** HOLE CARDS ***
wx3sQGkVi2x9wJXuWNHPBw: folds
r4lpoh2BJZ8S6zyQv1JeSw: folds
y27w5IK2WXqmYzS8OU0wKA: folds
ene3nLSnQ4N961iBaUsSmA: folds
qhkK6+yCciTRd+rCFEbnEQ: folds
xAU6q2/cwmby2sxmA8VcmA collected $1 from pot
xAU6q2/cwmby2sxmA8VcmA: doesn't show hand
*** SUMMARY ***
Total pot $1 | Rake $0
Seat 1: qhkK6+yCciTRd+rCFEbnEQ (small blind) folded before Flop
Seat 2: xAU6q2/cwmby2sxmA8VcmA (big blind) collected ($1)
Seat 3: wx3sQGkVi2x9wJXuWNHPBw folded before Flop (didn't bet)
Seat 4: r4lpoh2BJZ8S6zyQv1JeSw folded before Flop (didn't bet)
Seat 5: y27w5IK2WXqmYzS8OU0wKA folded before Flop (didn't bet)
Seat 6: ene3nLSnQ4N961iBaUsSmA (button) folded before Flop (didn't bet)



PokerStars Game #59941669936:  Hold'em No Limit ($0.50/$1.00) - 2009/07/01 1:42:28 ET
Table 'blHlQApStil0OPeQxQxPcw' 9-max Seat #1 is the button
Seat 1: Pp/KTcXkfZKKUHkjyaLTdg ($22.60 in chips)
Seat 2: V138SURkdX8LdVBPKdJJag ($121.85 in chips)
Seat 3: OGgaARGdJQT4awWVNQ957w ($100 in chips)
Seat 4: 1862487932 ($106.75 in chips)
Seat 5: uXrDE6JrIi8BZK1L8oQ9bQ ($38.10 in chips)
Seat 6: vljeiOoWscAIXU0fCuiEBw ($46.65 in chips)
Seat 7: VPF+HjszMvUIpy0CHIwH3A ($20 in chips)
Seat 9: 6XkTu4ahxzHnvjjc1R8YjQ ($153.85 in chips)
V138SURkdX8LdVBPKdJJag: posts small blind $0.50
OGgaARGdJQT4awWVNQ957w: posts big blind $1
*** HOLE CARDS ***
1862487932: folds
uXrDE6JrIi8BZK1L8oQ9bQ: calls $1
vljeiOoWscAIXU0fCuiEBw: calls $1
VPF+HjszMvUIpy0CHIwH3A: folds
6XkTu4ahxzHnvjjc1R8YjQ: calls $1
Pp/KTcXkfZKKUHkjyaLTdg: raises $5.50 to $6.50
V138SURkdX8LdVBPKdJJag: folds
OGgaARGdJQT4awWVNQ957w: folds
uXrDE6JrIi8BZK1L8oQ9bQ: folds
vljeiOoWscAIXU0fCuiEBw: folds
6XkTu4ahxzHnvjjc1R8YjQ: folds
Pp/KTcXkfZKKUHkjyaLTdg collected $5.50 from pot
Pp/KTcXkfZKKUHkjyaLTdg: doesn't show hand
*** SUMMARY ***
Total pot $5.50 | Rake $0
Seat 1: Pp/KTcXkfZKKUHkjyaLTdg (button) collected ($5.50)
Seat 2: V138SURkdX8LdVBPKdJJag (small blind) folded before Flop
Seat 3: OGgaARGdJQT4awWVNQ957w (big blind) folded before Flop
Seat 4: 1862487932 folded before Flop (didn't bet)
Seat 5: uXrDE6JrIi8BZK1L8oQ9bQ folded before Flop
Seat 6: vljeiOoWscAIXU0fCuiEBw folded before Flop
Seat 7: VPF+HjszMvUIpy0CHIwH3A folded before Flop (didn't bet)
Seat 9: 6XkTu4ahxzHnvjjc1R8YjQ folded before Flop



PokerStars Game #59941670534:  Hold'em No Limit ($0.50/$1.00) - 2009/07/01 1:42:29 ET
Table 'W/wyObTiXZm+Ckkl3YxcSw' 6-max Seat #1 is the button
Seat 1: eUBBn2R56C1IQ6Cs/vitwg ($181.55 in chips)
Seat 2: oDiBRCaF0QVtd3kO6xZIXw ($123.30 in chips)
Seat 3: 4OO5v3AVduL0tePNx8wk5A ($100 in chips)
Seat 4: UBZQqpnJZdTYYY1FTb0rLA ($158.20 in chips)
Seat 5: +OrCjyw70oZhJiD22Mn+bg ($200.50 in chips)
Seat 6: b2a+5TkFf4xJN/Ihhma58Q ($32.30 in chips)
oDiBRCaF0QVtd3kO6xZIXw: posts small blind $0.50
4OO5v3AVduL0tePNx8wk5A: posts big blind $1
*** HOLE CARDS ***
UBZQqpnJZdTYYY1FTb0rLA: folds
UBZQqpnJZdTYYY1FTb0rLA leaves the table
+OrCjyw70oZhJiD22Mn+bg: folds
b2a+5TkFf4xJN/Ihhma58Q: folds
eUBBn2R56C1IQ6Cs/vitwg: folds
oDiBRCaF0QVtd3kO6xZIXw: raises $2 to $3
4OO5v3AVduL0tePNx8wk5A: calls $2
*** FLOP *** [6d 6s Ts]
oDiBRCaF0QVtd3kO6xZIXw: bets $4
4OO5v3AVduL0tePNx8wk5A: calls $4
*** TURN *** [6d 6s Ts] [9c]
oDiBRCaF0QVtd3kO6xZIXw: bets $8
rHlMOfR7kpQQxe+PFQz0xQ joins the table at seat #4
4OO5v3AVduL0tePNx8wk5A: folds
oDiBRCaF0QVtd3kO6xZIXw collected $13.35 from pot
oDiBRCaF0QVtd3kO6xZIXw: doesn't show hand
*** SUMMARY ***
Total pot $14 | Rake $0.65
Board [6d 6s Ts 9c]
Seat 1: eUBBn2R56C1IQ6Cs/vitwg (button) folded before Flop (didn't bet)
Seat 2: oDiBRCaF0QVtd3kO6xZIXw (small blind) collected ($13.35)
Seat 3: 4OO5v3AVduL0tePNx8wk5A (big blind) folded on the Turn
Seat 4: UBZQqpnJZdTYYY1FTb0rLA folded before Flop (didn't bet)
Seat 5: +OrCjyw70oZhJiD22Mn+bg folded before Flop (didn't bet)
Seat 6: b2a+5TkFf4xJN/Ihhma58Q folded before Flop (didn't bet)



PokerStars Game #59941670636:  Hold'em No Limit ($0.50/$1.00) - 2009/07/01 1:42:29 ET
Table 'VOs36P6NW+QyXeQ1B62kmAE9S5sEoK9Q3olj2a53gABASeat #1 is the button
Seat 1: 4h8XtuVJtWh3DJpxGo7k5Q ($26.95 in chips)
Seat 2: y27w5IK2WXqmYzS8OU0wKA ($146.15 in chips)
Seat 3: p00KmyZiD/isPc/lZwNBTg ($15.85 in chips)
Seat 4: ene3nLSnQ4N961iBaUsSmA ($100 in chips)
Seat 5: o3YLm/rSY916m/on1VjXPA ($134.60 in chips)
Seat 6: slVKuQyEz8Qj4E3uLPYNXg ($46.60 in chips)
y27w5IK2WXqmYzS8OU0wKA: posts small blind $0.50
p00KmyZiD/isPc/lZwNBTg: posts big blind $1
*** HOLE CARDS ***
ene3nLSnQ4N961iBaUsSmA: folds
o3YLm/rSY916m/on1VjXPA: folds
slVKuQyEz8Qj4E3uLPYNXg: folds
4h8XtuVJtWh3DJpxGo7k5Q: calls $1
y27w5IK2WXqmYzS8OU0wKA: folds
p00KmyZiD/isPc/lZwNBTg: checks
*** FLOP *** [5s Kc Tc]
p00KmyZiD/isPc/lZwNBTg: bets $1
4h8XtuVJtWh3DJpxGo7k5Q: folds
p00KmyZiD/isPc/lZwNBTg collected $2.40 from pot
*** SUMMARY ***
Total pot $2.50 | Rake $0.10
Board [5s Kc Tc]
Seat 1: 4h8XtuVJtWh3DJpxGo7k5Q (button) folded on the Flop
Seat 2: y27w5IK2WXqmYzS8OU0wKA (small blind) folded before Flop
Seat 3: p00KmyZiD/isPc/lZwNBTg (big blind) collected ($2.40)
Seat 4: ene3nLSnQ4N961iBaUsSmA folded before Flop (didn't bet)
Seat 5: o3YLm/rSY916m/on1VjXPA folded before Flop (didn't bet)
Seat 6: slVKuQyEz8Qj4E3uLPYNXg folded before Flop (didn't bet)



PokerStars Game #59941672780:  Hold'em No Limit ($0.50/$1.00) - 2009/07/01 1:42:33 ET
Table 'pHrhryH8jPNdQfY62f8v+g' 6-max Seat #3 is the button
Seat 1: 4d1rWhpu8DzLmzMbR3QKyA ($147.45 in chips)
Seat 2: JwCcjZl0bjJzG7hmE0dnTA ($119.10 in chips)
Seat 3: 8oS5O7iD/qnFXFXJrGIgNQ ($110.80 in chips)
Seat 4: 1f3beyIML24UqEMTbWy93g ($47.85 in chips)
Seat 5: d8WX+9nUHoqlrAGagO0Wow ($20 in chips)
Seat 6: xAU6q2/cwmby2sxmA8VcmA ($199.30 in chips)
1f3beyIML24UqEMTbWy93g: posts small blind $0.50
d8WX+9nUHoqlrAGagO0Wow: posts big blind $1
*** HOLE CARDS ***
xAU6q2/cwmby2sxmA8VcmA: folds
4d1rWhpu8DzLmzMbR3QKyA: folds
JwCcjZl0bjJzG7hmE0dnTA: folds
8oS5O7iD/qnFXFXJrGIgNQ: raises $2 to $3
1f3beyIML24UqEMTbWy93g: folds
d8WX+9nUHoqlrAGagO0Wow: folds
8oS5O7iD/qnFXFXJrGIgNQ collected $2.50 from pot
*** SUMMARY ***
Total pot $2.50 | Rake $0
Seat 1: 4d1rWhpu8DzLmzMbR3QKyA folded before Flop (didn't bet)
Seat 2: JwCcjZl0bjJzG7hmE0dnTA folded before Flop (didn't bet)
Seat 3: 8oS5O7iD/qnFXFXJrGIgNQ (button) collected ($2.50)
Seat 4: 1f3beyIML24UqEMTbWy93g (small blind) folded before Flop
Seat 5: d8WX+9nUHoqlrAGagO0Wow (big blind) folded before Flop
Seat 6: xAU6q2/cwmby2sxmA8VcmA folded before Flop (didn't bet)



PokerStars Game #59941672616:  Hold'em No Limit ($0.50/$1.00) - 2009/07/01 1:42:33 ET
Table 'N2bNCDHL96aCQDvZIh+yQQ' 6-max Seat #5 is the button
Seat 1: Jjgflx10PVjcLkziEmLhSA ($93.75 in chips)
Seat 2: y27w5IK2WXqmYzS8OU0wKA ($130.15 in chips)
Seat 4: uCqEjnxh2/vFBjKYkfTOkw ($174.30 in chips)
Seat 5: ene3nLSnQ4N961iBaUsSmA ($100 in chips)
Seat 6: idVgoPAdspFPCzee6aF9Pg ($106.40 in chips)
idVgoPAdspFPCzee6aF9Pg: posts small blind $0.50
Jjgflx10PVjcLkziEmLhSA: posts big blind $1
VB7TtBnfmT3JTA/cCL6dJg: sits out
*** HOLE CARDS ***
y27w5IK2WXqmYzS8OU0wKA: folds
uCqEjnxh2/vFBjKYkfTOkw: raises $3 to $4
ene3nLSnQ4N961iBaUsSmA: raises $7 to $11
idVgoPAdspFPCzee6aF9Pg: folds
Jjgflx10PVjcLkziEmLhSA: folds
uCqEjnxh2/vFBjKYkfTOkw: calls $7
*** FLOP *** [6d Qs 8d]
uCqEjnxh2/vFBjKYkfTOkw: checks
ene3nLSnQ4N961iBaUsSmA: bets $18
uCqEjnxh2/vFBjKYkfTOkw: raises $22 to $40
ene3nLSnQ4N961iBaUsSmA: raises $49 to $89 and is all-in
uCqEjnxh2/vFBjKYkfTOkw: folds
ene3nLSnQ4N961iBaUsSmA collected $101.50 from pot
ene3nLSnQ4N961iBaUsSmA: doesn't show hand
*** SUMMARY ***
Total pot $103.50 | Rake $2
Board [6d Qs 8d]
Seat 1: Jjgflx10PVjcLkziEmLhSA (big blind) folded before Flop
Seat 2: y27w5IK2WXqmYzS8OU0wKA folded before Flop (didn't bet)
Seat 4: uCqEjnxh2/vFBjKYkfTOkw folded on the Flop
Seat 5: ene3nLSnQ4N961iBaUsSmA (button) collected ($101.50)
Seat 6: idVgoPAdspFPCzee6aF9Pg (small blind) folded before Flop



PokerStars Game #59941673504:  Hold'em No Limit ($0.50/$1.00) - 2009/07/01 1:42:34 ET
Table 'QSIig7BLMc9wY/rgBechzw' 6-max Seat #2 is the button
Seat 1: Z2fXsGcjl+Eax+RzOgwOmg ($116.45 in chips)
Seat 2: mLOIkH/qmRa+mVujQIhBRg ($18.75 in chips)
Seat 3: 4OO5v3AVduL0tePNx8wk5A ($124.20 in chips)
Seat 4: +uSzP8Jwnw7sKfQ4s66b7w ($57.80 in chips)
Seat 5: lsLuWlcPA3Rh7kJVLzMh0Q ($100 in chips)
Seat 6: Wj7mKnRFR90j40wWUu2+Og ($62.50 in chips)
4OO5v3AVduL0tePNx8wk5A: posts small blind $0.50
+uSzP8Jwnw7sKfQ4s66b7w: posts big blind $1
*** HOLE CARDS ***
lsLuWlcPA3Rh7kJVLzMh0Q: folds
Wj7mKnRFR90j40wWUu2+Og: folds
Z2fXsGcjl+Eax+RzOgwOmg: folds
mLOIkH/qmRa+mVujQIhBRg: raises $2 to $3
4OO5v3AVduL0tePNx8wk5A: folds
+uSzP8Jwnw7sKfQ4s66b7w: raises $6 to $9
mLOIkH/qmRa+mVujQIhBRg: raises $9.75 to $18.75 and is all-in
+uSzP8Jwnw7sKfQ4s66b7w: calls $9.75
*** FLOP *** [8h 6s 4c]
*** TURN *** [8h 6s 4c] [5s]
*** RIVER *** [8h 6s 4c 5s] [9s]
*** SHOW DOWN ***
+uSzP8Jwnw7sKfQ4s66b7w: shows [Ks Kd] (a pair of Kings)
mLOIkH/qmRa+mVujQIhBRg: mucks hand
+uSzP8Jwnw7sKfQ4s66b7w collected $36.10 from pot
*** SUMMARY ***
Total pot $38 | Rake $1.90
Board [8h 6s 4c 5s 9s]
Seat 1: Z2fXsGcjl+Eax+RzOgwOmg folded before Flop (didn't bet)
Seat 2: mLOIkH/qmRa+mVujQIhBRg (button) mucked
Seat 3: 4OO5v3AVduL0tePNx8wk5A (small blind) folded before Flop
Seat 4: +uSzP8Jwnw7sKfQ4s66b7w (big blind) showed [Ks Kd] and won ($36.10) with a pair of Kings
Seat 5: lsLuWlcPA3Rh7kJVLzMh0Q folded before Flop (didn't bet)
Seat 6: Wj7mKnRFR90j40wWUu2+Og folded before Flop (didn't bet)



PokerStars Game #59941673088:  Hold'em No Limit ($0.50/$1.00) - 2009/07/01 1:42:34 ET
Table 'qj0HBN4HhQKogreu1bg7xg' 2-max Seat #2 is the button
Seat 1: NYi6JFscYNrofSXy4sM+Yw ($150.60 in chips)
Seat 2: qtyl8CSb0/4yWdbuEPJejA ($126 in chips)
qtyl8CSb0/4yWdbuEPJejA: posts small blind $0.50
NYi6JFscYNrofSXy4sM+Yw: posts big blind $1
*** HOLE CARDS ***
qtyl8CSb0/4yWdbuEPJejA: folds
NYi6JFscYNrofSXy4sM+Yw collected $1 from pot
*** SUMMARY ***
Total pot $1 | Rake $0
Seat 1: NYi6JFscYNrofSXy4sM+Yw (big blind) collected ($1)
Seat 2: qtyl8CSb0/4yWdbuEPJejA (button) (small blind) folded before Flop



PokerStars Game #59941675112:  Hold'em No Limit ($0.50/$1.00) - 2009/07/01 1:42:37 ET
Table 'mmbQQVBTrPdE+wy+s+9VPA' 6-max Seat #4 is the button
Seat 1: zyP4SPoWZnKUfTvIRLCVog ($73.25 in chips)
Seat 2: XK4Qsl+DA8gAJyg85/zBIw ($37.45 in chips)
Seat 3: wx3sQGkVi2x9wJXuWNHPBw ($235.60 in chips)
Seat 4: V3iZdcw61nXF3g5hD2RrsQ ($100 in chips)
Seat 5: YMJG+F++3Aj6P8dAWda5fw ($127.20 in chips)
Seat 6: UOHYuj23MyK9R8ciY2t6FA ($100 in chips)
YMJG+F++3Aj6P8dAWda5fw: posts small blind $0.50
UOHYuj23MyK9R8ciY2t6FA: posts big blind $1
*** HOLE CARDS ***
zyP4SPoWZnKUfTvIRLCVog: folds
XK4Qsl+DA8gAJyg85/zBIw: calls $1
wx3sQGkVi2x9wJXuWNHPBw: folds
V3iZdcw61nXF3g5hD2RrsQ: folds
YMJG+F++3Aj6P8dAWda5fw: folds
UOHYuj23MyK9R8ciY2t6FA: checks
*** FLOP *** [Qh Td 8h]
UOHYuj23MyK9R8ciY2t6FA: checks
XK4Qsl+DA8gAJyg85/zBIw: checks
*** TURN *** [Qh Td 8h] [Js]
UOHYuj23MyK9R8ciY2t6FA: checks
XK4Qsl+DA8gAJyg85/zBIw: checks
*** RIVER *** [Qh Td 8h Js] [Qd]
UOHYuj23MyK9R8ciY2t6FA: checks
XK4Qsl+DA8gAJyg85/zBIw: bets $3
UOHYuj23MyK9R8ciY2t6FA: folds
XK4Qsl+DA8gAJyg85/zBIw collected $2.40 from pot
*** SUMMARY ***
Total pot $2.50 | Rake $0.10
Board [Qh Td 8h Js Qd]
Seat 1: zyP4SPoWZnKUfTvIRLCVog folded before Flop (didn't bet)
Seat 2: XK4Qsl+DA8gAJyg85/zBIw collected ($2.40)
Seat 3: wx3sQGkVi2x9wJXuWNHPBw folded before Flop (didn't bet)
Seat 4: V3iZdcw61nXF3g5hD2RrsQ (button) folded before Flop (didn't bet)
Seat 5: YMJG+F++3Aj6P8dAWda5fw (small blind) folded before Flop
Seat 6: UOHYuj23MyK9R8ciY2t6FA (big blind) folded on the River



PokerStars Game #59941675562:  Hold'em No Limit ($0.50/$1.00) - 2009/07/01 1:42:38 ET
Table 'b8oW/dOL7fDza5DfZ/dOJQ' 6-max Seat #3 is the button
Seat 1: NakujTNjHFgzceydFf+E2Q ($53.40 in chips)
Seat 2: TSuRyAHnUPCFjP7Z0rEE0w ($117.50 in chips)
Seat 3: d8WX+9nUHoqlrAGagO0Wow ($22.80 in chips)
Seat 4: 8rDbzImSi1zgxtqtF1pSbA ($20 in chips)
Seat 5: sr/OkkgqNbtgwJf1tmnfNg ($61 in chips)
Seat 6: PvfYaKbzMpsmUcbOExckbQ ($160.85 in chips)
8rDbzImSi1zgxtqtF1pSbA: posts small blind $0.50
sr/OkkgqNbtgwJf1tmnfNg: posts big blind $1
*** HOLE CARDS ***
PvfYaKbzMpsmUcbOExckbQ: folds
NakujTNjHFgzceydFf+E2Q: folds
TSuRyAHnUPCFjP7Z0rEE0w: folds
d8WX+9nUHoqlrAGagO0Wow: raises $2 to $3
8rDbzImSi1zgxtqtF1pSbA: calls $2.50
sr/OkkgqNbtgwJf1tmnfNg: folds
*** FLOP *** [7c Td 9s]
8rDbzImSi1zgxtqtF1pSbA: bets $3
d8WX+9nUHoqlrAGagO0Wow: calls $3
*** TURN *** [7c Td 9s] [4h]
8rDbzImSi1zgxtqtF1pSbA: bets $4
d8WX+9nUHoqlrAGagO0Wow: calls $4
*** RIVER *** [7c Td 9s 4h] [4d]
8rDbzImSi1zgxtqtF1pSbA: checks
d8WX+9nUHoqlrAGagO0Wow: checks
*** SHOW DOWN ***
8rDbzImSi1zgxtqtF1pSbA: shows [Ac 8c] (a pair of Fours)
d8WX+9nUHoqlrAGagO0Wow: shows [As Kd] (a pair of Fours - Ace+King kicker)
d8WX+9nUHoqlrAGagO0Wow collected $20 from pot
*** SUMMARY ***
Total pot $21 | Rake $1
Board [7c Td 9s 4h 4d]
Seat 1: NakujTNjHFgzceydFf+E2Q folded before Flop (didn't bet)
Seat 2: TSuRyAHnUPCFjP7Z0rEE0w folded before Flop (didn't bet)
Seat 3: d8WX+9nUHoqlrAGagO0Wow (button) showed [As Kd] and won ($20) with a pair of Fours
Seat 4: 8rDbzImSi1zgxtqtF1pSbA (small blind) showed [Ac 8c] and lost with a pair of Fours
Seat 5: sr/OkkgqNbtgwJf1tmnfNg (big blind) folded before Flop
Seat 6: PvfYaKbzMpsmUcbOExckbQ folded before Flop (didn't bet)



PokerStars Game #59941675868:  Hold'em No Limit ($0.50/$1.00) - 2009/07/01 1:42:39 ET
Table 'O96CPOtvMBWP6kzuYDfdFA' 6-max Seat #4 is the button
Seat 1: 6alLXQIITA2EZ/lBeym8Dw ($131.75 in chips)
Seat 2: 4d1rWhpu8DzLmzMbR3QKyA ($101.50 in chips)
Seat 3: ieBUmHu5QBR86BArTtK4FQ ($21.55 in chips)
Seat 4: /P4w1pHg2zHYg/4ubJ0dPw ($63.95 in chips)
Seat 5: vX+iYAEINFeLxwMla7DY1Q ($89.50 in chips)
Seat 6: 3syOXva630dm1FTdwnuLpw ($86.30 in chips)
vX+iYAEINFeLxwMla7DY1Q: posts small blind $0.50
3syOXva630dm1FTdwnuLpw: posts big blind $1
*** HOLE CARDS ***
6alLXQIITA2EZ/lBeym8Dw: raises $2 to $3
4d1rWhpu8DzLmzMbR3QKyA: folds
ieBUmHu5QBR86BArTtK4FQ: folds
/P4w1pHg2zHYg/4ubJ0dPw: folds
vX+iYAEINFeLxwMla7DY1Q: folds
3syOXva630dm1FTdwnuLpw: calls $2
*** FLOP *** [9c As 9h]
3syOXva630dm1FTdwnuLpw: checks
6alLXQIITA2EZ/lBeym8Dw: bets $4
3syOXva630dm1FTdwnuLpw: calls $4
*** TURN *** [9c As 9h] [6s]
3syOXva630dm1FTdwnuLpw: checks
6alLXQIITA2EZ/lBeym8Dw: checks
*** RIVER *** [9c As 9h 6s] [5d]
3syOXva630dm1FTdwnuLpw: bets $8
6alLXQIITA2EZ/lBeym8Dw: folds
3syOXva630dm1FTdwnuLpw collected $13.80 from pot
*** SUMMARY ***
Total pot $14.50 | Rake $0.70
Board [9c As 9h 6s 5d]
Seat 1: 6alLXQIITA2EZ/lBeym8Dw folded on the River
Seat 2: 4d1rWhpu8DzLmzMbR3QKyA folded before Flop (didn't bet)
Seat 3: ieBUmHu5QBR86BArTtK4FQ folded before Flop (didn't bet)
Seat 4: /P4w1pHg2zHYg/4ubJ0dPw (button) folded before Flop (didn't bet)
Seat 5: vX+iYAEINFeLxwMla7DY1Q (small blind) folded before Flop
Seat 6: 3syOXva630dm1FTdwnuLpw (big blind) collected ($13.80)



PokerStars Game #59941676532:  Hold'em No Limit ($0.50/$1.00) - 2009/07/01 1:42:40 ET
Table 'qj0HBN4HhQKogreu1bg7xg' 2-max Seat #1 is the button
Seat 1: NYi6JFscYNrofSXy4sM+Yw ($151.10 in chips)
Seat 2: qtyl8CSb0/4yWdbuEPJejA ($125.50 in chips)
NYi6JFscYNrofSXy4sM+Yw: posts small blind $0.50
qtyl8CSb0/4yWdbuEPJejA: posts big blind $1
*** HOLE CARDS ***
NYi6JFscYNrofSXy4sM+Yw: raises $2 to $3
qtyl8CSb0/4yWdbuEPJejA: raises $6 to $9
NYi6JFscYNrofSXy4sM+Yw: folds
qtyl8CSb0/4yWdbuEPJejA collected $6 from pot
qtyl8CSb0/4yWdbuEPJejA: doesn't show hand
*** SUMMARY ***
Total pot $6 | Rake $0
Seat 1: NYi6JFscYNrofSXy4sM+Yw (button) (small blind) folded before Flop
Seat 2: qtyl8CSb0/4yWdbuEPJejA (big blind) collected ($6)



PokerStars Game #59941676452:  Hold'em No Limit ($0.50/$1.00) - 2009/07/01 1:42:40 ET
Table 'ZFWj23PMihdwrNWv41OG/QtyUh+jyNvrceIQdKMJjQ2weat #5 is the button
Seat 2: 0smcry9L0OOTCP+KzIS5SA ($94 in chips)
Seat 3: cWwhvq/+r/w8nkhwrJoekQ ($53.20 in chips)
Seat 4: O5ZesE/6mHyuWWbvkiH/Fg ($73.35 in chips)
Seat 5: j7NIOHLZk7V2o9fOioO5ug ($100.20 in chips)
Seat 6: u23r4AyKPgHioZ6t7z6qrA ($100 in chips)
u23r4AyKPgHioZ6t7z6qrA: posts small blind $0.50
0smcry9L0OOTCP+KzIS5SA: posts big blind $1
*** HOLE CARDS ***
cWwhvq/+r/w8nkhwrJoekQ: folds
O5ZesE/6mHyuWWbvkiH/Fg: folds
j7NIOHLZk7V2o9fOioO5ug: raises $2 to $3
u23r4AyKPgHioZ6t7z6qrA: folds
0smcry9L0OOTCP+KzIS5SA: folds
j7NIOHLZk7V2o9fOioO5ug collected $2.50 from pot
j7NIOHLZk7V2o9fOioO5ug: doesn't show hand
*** SUMMARY ***
Total pot $2.50 | Rake $0
Seat 2: 0smcry9L0OOTCP+KzIS5SA (big blind) folded before Flop
Seat 3: cWwhvq/+r/w8nkhwrJoekQ folded before Flop (didn't bet)
Seat 4: O5ZesE/6mHyuWWbvkiH/Fg folded before Flop (didn't bet)
Seat 5: j7NIOHLZk7V2o9fOioO5ug (button) collected ($2.50)
Seat 6: u23r4AyKPgHioZ6t7z6qrA (small blind) folded before Flop



PokerStars Game #59941681626:  Hold'em No Limit ($0.50/$1.00) - 2009/07/01 1:42:50 ET
Table 'qj0HBN4HhQKogreu1bg7xg' 2-max Seat #2 is the button
Seat 1: NYi6JFscYNrofSXy4sM+Yw ($148.10 in chips)
Seat 2: qtyl8CSb0/4yWdbuEPJejA ($128.50 in chips)
qtyl8CSb0/4yWdbuEPJejA: posts small blind $0.50
NYi6JFscYNrofSXy4sM+Yw: posts big blind $1
*** HOLE CARDS ***
qtyl8CSb0/4yWdbuEPJejA: folds
NYi6JFscYNrofSXy4sM+Yw collected $1 from pot
*** SUMMARY ***
Total pot $1 | Rake $0
Seat 1: NYi6JFscYNrofSXy4sM+Yw (big blind) collected ($1)
Seat 2: qtyl8CSb0/4yWdbuEPJejA (button) (small blind) folded before Flop



PokerStars Game #59941682158:  Hold'em No Limit ($0.50/$1.00) - 2009/07/01 1:42:50 ET
Table 'uNlePsyMIqzM691Xkrlk6Q' 9-max Seat #7 is the button
Seat 1: bLbSOSmSOnqE0iTcH/5dxA ($110.90 in chips)
Seat 2: TAfo4veNRaRlzDXMMYS3Jg ($20 in chips)
Seat 3: h7qXkU57Bb8ZuPwMyxR8Ug ($119 in chips)
Seat 4: WRTVKFHeb0vRJnVi5NdJZw ($43.25 in chips)
Seat 5: G9Fo2TZCN7HI43Po4zSN3A ($109.40 in chips)
Seat 6: mMc/PBpqlN24gdi3C/1tOw ($39 in chips)
Seat 7: KNAaBvPYSXyLqb88ypSbuQ ($34.55 in chips)
Seat 8: yWcEtGJ3ijZsF6HqlHqkrg ($117.70 in chips)
Seat 9: OGgaARGdJQT4awWVNQ957w ($113.60 in chips)
yWcEtGJ3ijZsF6HqlHqkrg: posts small blind $0.50
OGgaARGdJQT4awWVNQ957w: posts big blind $1
*** HOLE CARDS ***
bLbSOSmSOnqE0iTcH/5dxA: calls $1
TAfo4veNRaRlzDXMMYS3Jg: folds
h7qXkU57Bb8ZuPwMyxR8Ug: folds
WRTVKFHeb0vRJnVi5NdJZw: folds
G9Fo2TZCN7HI43Po4zSN3A: folds
mMc/PBpqlN24gdi3C/1tOw: folds
KNAaBvPYSXyLqb88ypSbuQ: folds
yWcEtGJ3ijZsF6HqlHqkrg: calls $0.50
OGgaARGdJQT4awWVNQ957w: checks
*** FLOP *** [6c 9h 5s]
yWcEtGJ3ijZsF6HqlHqkrg: checks
OGgaARGdJQT4awWVNQ957w: checks
bLbSOSmSOnqE0iTcH/5dxA: checks
*** TURN *** [6c 9h 5s] [Th]
yWcEtGJ3ijZsF6HqlHqkrg: checks
OGgaARGdJQT4awWVNQ957w: checks
bLbSOSmSOnqE0iTcH/5dxA: checks
*** RIVER *** [6c 9h 5s Th] [Kh]
yWcEtGJ3ijZsF6HqlHqkrg: checks
OGgaARGdJQT4awWVNQ957w: bets $1.70
bLbSOSmSOnqE0iTcH/5dxA: folds
yWcEtGJ3ijZsF6HqlHqkrg: calls $1.70
*** SHOW DOWN ***
OGgaARGdJQT4awWVNQ957w: shows [8h 2h] (a flush, King high)
yWcEtGJ3ijZsF6HqlHqkrg: mucks hand
OGgaARGdJQT4awWVNQ957w collected $6.10 from pot
*** SUMMARY ***
Total pot $6.40 | Rake $0.30
Board [6c 9h 5s Th Kh]
Seat 1: bLbSOSmSOnqE0iTcH/5dxA folded on the River
Seat 2: TAfo4veNRaRlzDXMMYS3Jg folded before Flop (didn't bet)
Seat 3: h7qXkU57Bb8ZuPwMyxR8Ug folded before Flop (didn't bet)
Seat 4: WRTVKFHeb0vRJnVi5NdJZw folded before Flop (didn't bet)
Seat 5: G9Fo2TZCN7HI43Po4zSN3A folded before Flop (didn't bet)
Seat 6: mMc/PBpqlN24gdi3C/1tOw folded before Flop (didn't bet)
Seat 7: KNAaBvPYSXyLqb88ypSbuQ (button) folded before Flop (didn't bet)
Seat 8: yWcEtGJ3ijZsF6HqlHqkrg (small blind) mucked
Seat 9: OGgaARGdJQT4awWVNQ957w (big blind) showed [8h 2h] and won ($6.10) with a flush, King high



PokerStars Game #59941682310:  Hold'em No Limit ($0.50/$1.00) - 2009/07/01 1:42:51 ET
Table '7O9fB8yx1u7sJveJn8w6jA' 6-max Seat #2 is the button
Seat 1: 841740 ($40.80 in chips)
Seat 2: wx3sQGkVi2x9wJXuWNHPBw ($205.35 in chips)
Seat 3: hpxXcmRkXXI9HE5+5/j/0Q ($145.95 in chips)
Seat 4: b2a+5TkFf4xJN/Ihhma58Q ($30.35 in chips)
Seat 5: BCEV3COoKY607AzLWayfRA ($100 in chips)
Seat 6: r4lpoh2BJZ8S6zyQv1JeSw ($107.75 in chips)
hpxXcmRkXXI9HE5+5/j/0Q: posts small blind $0.50
b2a+5TkFf4xJN/Ihhma58Q: posts big blind $1
*** HOLE CARDS ***
BCEV3COoKY607AzLWayfRA: folds
r4lpoh2BJZ8S6zyQv1JeSw: folds
841740: raises $1 to $2
wx3sQGkVi2x9wJXuWNHPBw: folds
hpxXcmRkXXI9HE5+5/j/0Q: folds
b2a+5TkFf4xJN/Ihhma58Q: raises $4 to $6
841740: folds
b2a+5TkFf4xJN/Ihhma58Q collected $4.50 from pot
*** SUMMARY ***
Total pot $4.50 | Rake $0
Seat 1: 841740 folded before Flop
Seat 2: wx3sQGkVi2x9wJXuWNHPBw (button) folded before Flop (didn't bet)
Seat 3: hpxXcmRkXXI9HE5+5/j/0Q (small blind) folded before Flop
Seat 4: b2a+5TkFf4xJN/Ihhma58Q (big blind) collected ($4.50)
Seat 5: BCEV3COoKY607AzLWayfRA folded before Flop (didn't bet)
Seat 6: r4lpoh2BJZ8S6zyQv1JeSw folded before Flop (didn't bet)



PokerStars Game #59941683858:  Hold'em No Limit ($0.50/$1.00) - 2009/07/01 1:42:54 ET
Table 'DE4ps3MTl+4avTytwFENAg' 6-max Seat #4 is the button
Seat 1: PvfYaKbzMpsmUcbOExckbQ ($101.75 in chips)
Seat 2: QHvTZcrKe6+maWUfVjP29Q ($100 in chips)
Seat 3: cGayYjcyk6+jN57tzIY4TA ($303.60 in chips)
Seat 4: iexehpxaQwzColGqeTEnLQ ($112.85 in chips)
Seat 6: lsLuWlcPA3Rh7kJVLzMh0Q ($107.25 in chips)
lsLuWlcPA3Rh7kJVLzMh0Q: posts small blind $0.50
PvfYaKbzMpsmUcbOExckbQ: posts big blind $1
*** HOLE CARDS ***
QHvTZcrKe6+maWUfVjP29Q: folds
cGayYjcyk6+jN57tzIY4TA: folds
iexehpxaQwzColGqeTEnLQ: raises $2 to $3
lsLuWlcPA3Rh7kJVLzMh0Q: folds
PvfYaKbzMpsmUcbOExckbQ: folds
iexehpxaQwzColGqeTEnLQ collected $2.50 from pot
*** SUMMARY ***
Total pot $2.50 | Rake $0
Seat 1: PvfYaKbzMpsmUcbOExckbQ (big blind) folded before Flop
Seat 2: QHvTZcrKe6+maWUfVjP29Q folded before Flop (didn't bet)
Seat 3: cGayYjcyk6+jN57tzIY4TA folded before Flop (didn't bet)
Seat 4: iexehpxaQwzColGqeTEnLQ (button) collected ($2.50)
Seat 6: lsLuWlcPA3Rh7kJVLzMh0Q (small blind) folded before Flop



PokerStars Game #59941684610:  Hold'em No Limit ($0.50/$1.00) - 2009/07/01 1:42:55 ET
Table 'ZFWj23PMihdwrNWv41OG/QtyUh+jyNvrceIQdKMJjQ2weat #6 is the button
Seat 2: 0smcry9L0OOTCP+KzIS5SA ($93 in chips)
Seat 3: cWwhvq/+r/w8nkhwrJoekQ ($53.20 in chips)
Seat 4: O5ZesE/6mHyuWWbvkiH/Fg ($73.35 in chips)
Seat 5: j7NIOHLZk7V2o9fOioO5ug ($101.70 in chips)
Seat 6: u23r4AyKPgHioZ6t7z6qrA ($100 in chips)
0smcry9L0OOTCP+KzIS5SA: posts small blind $0.50
cWwhvq/+r/w8nkhwrJoekQ: posts big blind $1
*** HOLE CARDS ***
O5ZesE/6mHyuWWbvkiH/Fg: folds
j7NIOHLZk7V2o9fOioO5ug: folds
u23r4AyKPgHioZ6t7z6qrA: folds
0smcry9L0OOTCP+KzIS5SA: calls $0.50
cWwhvq/+r/w8nkhwrJoekQ: checks
*** FLOP *** [Ad Th 4s]
rHlMOfR7kpQQxe+PFQz0xQ joins the table at seat #1
0smcry9L0OOTCP+KzIS5SA: checks
cWwhvq/+r/w8nkhwrJoekQ: checks
*** TURN *** [Ad Th 4s] [3s]
0smcry9L0OOTCP+KzIS5SA: checks
cWwhvq/+r/w8nkhwrJoekQ: checks
*** RIVER *** [Ad Th 4s 3s] [6s]
0smcry9L0OOTCP+KzIS5SA: checks
cWwhvq/+r/w8nkhwrJoekQ: checks
*** SHOW DOWN ***
0smcry9L0OOTCP+KzIS5SA: shows [9h Jh] (high card Ace)
cWwhvq/+r/w8nkhwrJoekQ: shows [8c Qs] (high card Ace - Queen kicker)
cWwhvq/+r/w8nkhwrJoekQ collected $1.90 from pot
*** SUMMARY ***
Total pot $2 | Rake $0.10
Board [Ad Th 4s 3s 6s]
Seat 2: 0smcry9L0OOTCP+KzIS5SA (small blind) showed [9h Jh] and lost with high card Ace
Seat 3: cWwhvq/+r/w8nkhwrJoekQ (big blind) showed [8c Qs] and won ($1.90) with high card Ace
Seat 4: O5ZesE/6mHyuWWbvkiH/Fg folded before Flop (didn't bet)
Seat 5: j7NIOHLZk7V2o9fOioO5ug folded before Flop (didn't bet)
Seat 6: u23r4AyKPgHioZ6t7z6qrA (button) folded before Flop (didn't bet)



PokerStars Game #59941686382:  Hold'em No Limit ($0.50/$1.00) - 2009/07/01 1:42:58 ET
Table 'gxFK0BVUD7cupu2uyRUZJg' 6-max Seat #6 is the button
Seat 1: M+X3uChmP6R63IwijVjgTg ($217.40 in chips)
Seat 2: hpxXcmRkXXI9HE5+5/j/0Q ($131.55 in chips)
Seat 3: Z2fXsGcjl+Eax+RzOgwOmg ($117.10 in chips)
Seat 4: Hcr4S4Nbkj5idKsvYK/eqQ ($88 in chips)
Seat 5: 0smcry9L0OOTCP+KzIS5SA ($210 in chips)
Seat 6: dYyb6/42PMC8aNFlm/eBeQ ($136.25 in chips)
M+X3uChmP6R63IwijVjgTg: posts small blind $0.50
hpxXcmRkXXI9HE5+5/j/0Q: posts big blind $1
*** HOLE CARDS ***
Z2fXsGcjl+Eax+RzOgwOmg: folds
Hcr4S4Nbkj5idKsvYK/eqQ: folds
0smcry9L0OOTCP+KzIS5SA: folds
dYyb6/42PMC8aNFlm/eBeQ: calls $1
M+X3uChmP6R63IwijVjgTg: calls $0.50
hpxXcmRkXXI9HE5+5/j/0Q: checks
*** FLOP *** [8h Ah 3s]
M+X3uChmP6R63IwijVjgTg: checks
hpxXcmRkXXI9HE5+5/j/0Q: bets $3
dYyb6/42PMC8aNFlm/eBeQ: calls $3
M+X3uChmP6R63IwijVjgTg: calls $3
*** TURN *** [8h Ah 3s] [9h]
M+X3uChmP6R63IwijVjgTg: checks
hpxXcmRkXXI9HE5+5/j/0Q: bets $10
dYyb6/42PMC8aNFlm/eBeQ: calls $10
M+X3uChmP6R63IwijVjgTg: raises $15 to $25
hpxXcmRkXXI9HE5+5/j/0Q: calls $15
dYyb6/42PMC8aNFlm/eBeQ: calls $15
*** RIVER *** [8h Ah 3s 9h] [Ts]
M+X3uChmP6R63IwijVjgTg: bets $71
hpxXcmRkXXI9HE5+5/j/0Q: calls $71
dYyb6/42PMC8aNFlm/eBeQ: calls $71
*** SHOW DOWN ***
M+X3uChmP6R63IwijVjgTg: shows [Kh 5h] (a flush, Ace high)
hpxXcmRkXXI9HE5+5/j/0Q: mucks hand
dYyb6/42PMC8aNFlm/eBeQ: mucks hand
M+X3uChmP6R63IwijVjgTg collected $297 from pot
*** SUMMARY ***
Total pot $300 | Rake $3
Board [8h Ah 3s 9h Ts]
Seat 1: M+X3uChmP6R63IwijVjgTg (small blind) showed [Kh 5h] and won ($297) with a flush, Ace high
Seat 2: hpxXcmRkXXI9HE5+5/j/0Q (big blind) mucked
Seat 3: Z2fXsGcjl+Eax+RzOgwOmg folded before Flop (didn't bet)
Seat 4: Hcr4S4Nbkj5idKsvYK/eqQ folded before Flop (didn't bet)
Seat 5: 0smcry9L0OOTCP+KzIS5SA folded before Flop (didn't bet)
Seat 6: dYyb6/42PMC8aNFlm/eBeQ (button) mucked



PokerStars Game #59941686560:  Hold'em No Limit ($0.50/$1.00) - 2009/07/01 1:42:59 ET
Table 'fTlPiCj0utgzC/5io+I7ew' 6-max Seat #2 is the button
Seat 1: YMJG+F++3Aj6P8dAWda5fw ($103 in chips)
Seat 2: qVr1nl3dy2xXPqS8UpTDlA ($40.25 in chips)
Seat 3: Z2fXsGcjl+Eax+RzOgwOmg ($130.50 in chips)
Seat 4: uJVSceLggtsrJya+WtmUEA ($166.35 in chips)
Seat 5: XUk5GQsfNFpHvaToDZ0rZA ($42.05 in chips)
Seat 6: y27w5IK2WXqmYzS8OU0wKA ($100 in chips)
Z2fXsGcjl+Eax+RzOgwOmg: posts small blind $0.50
uJVSceLggtsrJya+WtmUEA: posts big blind $1
*** HOLE CARDS ***
XUk5GQsfNFpHvaToDZ0rZA: raises $2 to $3
y27w5IK2WXqmYzS8OU0wKA: folds
YMJG+F++3Aj6P8dAWda5fw: calls $3
qVr1nl3dy2xXPqS8UpTDlA: folds
Z2fXsGcjl+Eax+RzOgwOmg: folds
uJVSceLggtsrJya+WtmUEA: calls $2
*** FLOP *** [Jc 9d 2c]
uJVSceLggtsrJya+WtmUEA: checks
XUk5GQsfNFpHvaToDZ0rZA: checks
YMJG+F++3Aj6P8dAWda5fw: bets $5
uJVSceLggtsrJya+WtmUEA: raises $10 to $15
XUk5GQsfNFpHvaToDZ0rZA: folds
YMJG+F++3Aj6P8dAWda5fw: calls $10
*** TURN *** [Jc 9d 2c] [3c]
uJVSceLggtsrJya+WtmUEA: checks
YMJG+F++3Aj6P8dAWda5fw: checks
*** RIVER *** [Jc 9d 2c 3c] [5s]
uJVSceLggtsrJya+WtmUEA: bets $148.35 and is all-in
YMJG+F++3Aj6P8dAWda5fw: calls $85 and is all-in
*** SHOW DOWN ***
uJVSceLggtsrJya+WtmUEA: shows [Ac 4c] (a flush, Ace high)
YMJG+F++3Aj6P8dAWda5fw: mucks hand
uJVSceLggtsrJya+WtmUEA collected $206.50 from pot
*** SUMMARY ***
Total pot $209.50 | Rake $3
Board [Jc 9d 2c 3c 5s]
Seat 1: YMJG+F++3Aj6P8dAWda5fw mucked
Seat 2: qVr1nl3dy2xXPqS8UpTDlA (button) folded before Flop (didn't bet)
Seat 3: Z2fXsGcjl+Eax+RzOgwOmg (small blind) folded before Flop
Seat 4: uJVSceLggtsrJya+WtmUEA (big blind) showed [Ac 4c] and won ($206.50) with a flush, Ace high
Seat 5: XUk5GQsfNFpHvaToDZ0rZA folded on the Flop
Seat 6: y27w5IK2WXqmYzS8OU0wKA folded before Flop (didn't bet)



PokerStars Game #59941686930:  Hold'em No Limit ($0.50/$1.00) - 2009/07/01 1:42:59 ET
Table 'MUPc8FEpe/nR0BKSeReX6Q' 6-max Seat #1 is the button
Seat 1: qhkK6+yCciTRd+rCFEbnEQ ($83.70 in chips)
Seat 2: xAU6q2/cwmby2sxmA8VcmA ($104.20 in chips)
Seat 3: wx3sQGkVi2x9wJXuWNHPBw ($286.15 in chips)
Seat 4: r4lpoh2BJZ8S6zyQv1JeSw ($110 in chips)
Seat 5: y27w5IK2WXqmYzS8OU0wKA ($129.55 in chips)
Seat 6: ene3nLSnQ4N961iBaUsSmA ($100 in chips)
xAU6q2/cwmby2sxmA8VcmA: posts small blind $0.50
wx3sQGkVi2x9wJXuWNHPBw: posts big blind $1
*** HOLE CARDS ***
r4lpoh2BJZ8S6zyQv1JeSw: folds
y27w5IK2WXqmYzS8OU0wKA: folds
ene3nLSnQ4N961iBaUsSmA: folds
qhkK6+yCciTRd+rCFEbnEQ: folds
xAU6q2/cwmby2sxmA8VcmA: folds
wx3sQGkVi2x9wJXuWNHPBw collected $1 from pot
*** SUMMARY ***
Total pot $1 | Rake $0
Seat 1: qhkK6+yCciTRd+rCFEbnEQ (button) folded before Flop (didn't bet)
Seat 2: xAU6q2/cwmby2sxmA8VcmA (small blind) folded before Flop
Seat 3: wx3sQGkVi2x9wJXuWNHPBw (big blind) collected ($1)
Seat 4: r4lpoh2BJZ8S6zyQv1JeSw folded before Flop (didn't bet)
Seat 5: y27w5IK2WXqmYzS8OU0wKA folded before Flop (didn't bet)
Seat 6: ene3nLSnQ4N961iBaUsSmA folded before Flop (didn't bet)



PokerStars Game #59941686480:  Hold'em No Limit ($0.50/$1.00) - 2009/07/01 1:42:59 ET
Table 'qj0HBN4HhQKogreu1bg7xg' 2-max Seat #1 is the button
Seat 1: NYi6JFscYNrofSXy4sM+Yw ($148.60 in chips)
Seat 2: qtyl8CSb0/4yWdbuEPJejA ($128 in chips)
NYi6JFscYNrofSXy4sM+Yw: posts small blind $0.50
qtyl8CSb0/4yWdbuEPJejA: posts big blind $1
*** HOLE CARDS ***
NYi6JFscYNrofSXy4sM+Yw: raises $2 to $3
qtyl8CSb0/4yWdbuEPJejA: raises $6 to $9
NYi6JFscYNrofSXy4sM+Yw: folds
qtyl8CSb0/4yWdbuEPJejA collected $6 from pot
qtyl8CSb0/4yWdbuEPJejA: doesn't show hand
*** SUMMARY ***
Total pot $6 | Rake $0
Seat 1: NYi6JFscYNrofSXy4sM+Yw (button) (small blind) folded before Flop
Seat 2: qtyl8CSb0/4yWdbuEPJejA (big blind) collected ($6)



PokerStars Game #59941686648:  Hold'em No Limit ($0.50/$1.00) - 2009/07/01 1:42:59 ET
Table '7Nl0ffnjeK44/vmeexh3MQ' 9-max Seat #6 is the button
Seat 1: V138SURkdX8LdVBPKdJJag ($114.55 in chips)
Seat 2: OGgaARGdJQT4awWVNQ957w ($100 in chips)
Seat 3: JMmUYT5pIKCKh2pGjCB/4w ($56.90 in chips)
Seat 4: bLbSOSmSOnqE0iTcH/5dxA ($107.55 in chips)
Seat 5: 61sfw5QTu62YYIt68OsdrA ($76.05 in chips)
Seat 6: FVs16t7GgfWgQWt4JxsObQ ($16.75 in chips)
Seat 7: 2fVA6XTmacKkwJ4SpKDAtA ($99 in chips)
Seat 8: HRJJZiSxFAehJGaET63dlA ($46.90 in chips)
Seat 9: /JHoNdt0fK6X+isrqRfV3w ($20 in chips)
2fVA6XTmacKkwJ4SpKDAtA: posts small blind $0.50
HRJJZiSxFAehJGaET63dlA: posts big blind $1
*** HOLE CARDS ***
/JHoNdt0fK6X+isrqRfV3w: folds
V138SURkdX8LdVBPKdJJag: folds
OGgaARGdJQT4awWVNQ957w: raises $3 to $4
JMmUYT5pIKCKh2pGjCB/4w: folds
bLbSOSmSOnqE0iTcH/5dxA: folds
61sfw5QTu62YYIt68OsdrA: folds
FVs16t7GgfWgQWt4JxsObQ: folds
2fVA6XTmacKkwJ4SpKDAtA: folds
HRJJZiSxFAehJGaET63dlA: folds
OGgaARGdJQT4awWVNQ957w collected $2.50 from pot
OGgaARGdJQT4awWVNQ957w: doesn't show hand
*** SUMMARY ***
Total pot $2.50 | Rake $0
Seat 1: V138SURkdX8LdVBPKdJJag folded before Flop (didn't bet)
Seat 2: OGgaARGdJQT4awWVNQ957w collected ($2.50)
Seat 3: JMmUYT5pIKCKh2pGjCB/4w folded before Flop (didn't bet)
Seat 4: bLbSOSmSOnqE0iTcH/5dxA folded before Flop (didn't bet)
Seat 5: 61sfw5QTu62YYIt68OsdrA folded before Flop (didn't bet)
Seat 6: FVs16t7GgfWgQWt4JxsObQ (button) folded before Flop (didn't bet)
Seat 7: 2fVA6XTmacKkwJ4SpKDAtA (small blind) folded before Flop
Seat 8: HRJJZiSxFAehJGaET63dlA (big blind) folded before Flop
Seat 9: /JHoNdt0fK6X+isrqRfV3w folded before Flop (didn't bet)



PokerStars Game #59941687172:  Hold'em No Limit ($0.50/$1.00) - 2009/07/01 1:43:00 ET
Table '3T4owEKJKyGTMePwrv50FQ' 9-max Seat #7 is the button
Seat 1: OGgaARGdJQT4awWVNQ957w ($101.50 in chips)
Seat 2: t+Id2O6herCLgwnC4m49PA ($29.55 in chips)
Seat 3: DOLzOcBTZYcph5jEfKFWuQ ($106.40 in chips)
Seat 4: O5Go3jrzbQWxRB6ESK+Ptg ($62.10 in chips)
Seat 5: mMc/PBpqlN24gdi3C/1tOw ($48.75 in chips)
Seat 6: V138SURkdX8LdVBPKdJJag ($110.25 in chips)
Seat 7: 1862487932 ($104 in chips)
Seat 8: bLbSOSmSOnqE0iTcH/5dxA ($197.50 in chips)
Seat 9: 61sfw5QTu62YYIt68OsdrA ($84.75 in chips)
bLbSOSmSOnqE0iTcH/5dxA: posts small blind $0.50
61sfw5QTu62YYIt68OsdrA: posts big blind $1
*** HOLE CARDS ***
OGgaARGdJQT4awWVNQ957w: folds
t+Id2O6herCLgwnC4m49PA: folds
DOLzOcBTZYcph5jEfKFWuQ: folds
O5Go3jrzbQWxRB6ESK+Ptg: folds
mMc/PBpqlN24gdi3C/1tOw: raises $2 to $3
V138SURkdX8LdVBPKdJJag: folds
1862487932: folds
bLbSOSmSOnqE0iTcH/5dxA: folds
61sfw5QTu62YYIt68OsdrA: folds
mMc/PBpqlN24gdi3C/1tOw collected $2.50 from pot
*** SUMMARY ***
Total pot $2.50 | Rake $0
Seat 1: OGgaARGdJQT4awWVNQ957w folded before Flop (didn't bet)
Seat 2: t+Id2O6herCLgwnC4m49PA folded before Flop (didn't bet)
Seat 3: DOLzOcBTZYcph5jEfKFWuQ folded before Flop (didn't bet)
Seat 4: O5Go3jrzbQWxRB6ESK+Ptg folded before Flop (didn't bet)
Seat 5: mMc/PBpqlN24gdi3C/1tOw collected ($2.50)
Seat 6: V138SURkdX8LdVBPKdJJag folded before Flop (didn't bet)
Seat 7: 1862487932 (button) folded before Flop (didn't bet)
Seat 8: bLbSOSmSOnqE0iTcH/5dxA (small blind) folded before Flop
Seat 9: 61sfw5QTu62YYIt68OsdrA (big blind) folded before Flop



PokerStars Game #59941687726:  Hold'em No Limit ($0.50/$1.00) - 2009/07/01 1:43:01 ET
Table 'tJq9SfN1ywY0r03VBlWlwQ' 9-max Seat #1 is the button
Seat 1: wZsU+w9r7G66x93UuvBf1Q ($301.55 in chips)
Seat 4: bLbSOSmSOnqE0iTcH/5dxA ($117.20 in chips)
Seat 5: h5ipsNTMyolp7xn/NAvWkA ($126.30 in chips)
Seat 6: gUUvmqdVlmvpal6B8nYrmg ($108.60 in chips)
Seat 7: Ogn4JDV3mp4ZDKO49IFzKA ($18.40 in chips)
Seat 8: G4DEhsZFmznGNVpy2SEocA ($39.30 in chips)
Seat 9: XE5QF1y74bpHog9JxWJMWQ ($100 in chips)
myIxN7otsyr846M539YR8Q will be allowed to play after the button
bLbSOSmSOnqE0iTcH/5dxA: posts small blind $0.50
h5ipsNTMyolp7xn/NAvWkA: posts big blind $1
*** HOLE CARDS ***
gUUvmqdVlmvpal6B8nYrmg: folds
Ogn4JDV3mp4ZDKO49IFzKA: folds
G4DEhsZFmznGNVpy2SEocA: folds
XE5QF1y74bpHog9JxWJMWQ: folds
wZsU+w9r7G66x93UuvBf1Q: raises $2 to $3
bLbSOSmSOnqE0iTcH/5dxA: folds
h5ipsNTMyolp7xn/NAvWkA: calls $2
*** FLOP *** [6s 5c Jc]
h5ipsNTMyolp7xn/NAvWkA: bets $2
wZsU+w9r7G66x93UuvBf1Q: raises $7 to $9
h5ipsNTMyolp7xn/NAvWkA: calls $7
*** TURN *** [6s 5c Jc] [4d]
h5ipsNTMyolp7xn/NAvWkA: checks
wZsU+w9r7G66x93UuvBf1Q: bets $18
h5ipsNTMyolp7xn/NAvWkA: calls $18
*** RIVER *** [6s 5c Jc 4d] [Kd]
h5ipsNTMyolp7xn/NAvWkA: checks
wZsU+w9r7G66x93UuvBf1Q: bets $25
h5ipsNTMyolp7xn/NAvWkA: folds
wZsU+w9r7G66x93UuvBf1Q collected $57.55 from pot
*** SUMMARY ***
Total pot $60.50 | Rake $2.95
Board [6s 5c Jc 4d Kd]
Seat 1: wZsU+w9r7G66x93UuvBf1Q (button) collected ($57.55)
Seat 4: bLbSOSmSOnqE0iTcH/5dxA (small blind) folded before Flop
Seat 5: h5ipsNTMyolp7xn/NAvWkA (big blind) folded on the River
Seat 6: gUUvmqdVlmvpal6B8nYrmg folded before Flop (didn't bet)
Seat 7: Ogn4JDV3mp4ZDKO49IFzKA folded before Flop (didn't bet)
Seat 8: G4DEhsZFmznGNVpy2SEocA folded before Flop (didn't bet)
Seat 9: XE5QF1y74bpHog9JxWJMWQ folded before Flop (didn't bet)



PokerStars Game #59941687702:  Hold'em No Limit ($0.50/$1.00) - 2009/07/01 1:43:01 ET
Table '+cA8mcmhaedZ7YcrDdhmeQ' 6-max Seat #6 is the button
Seat 1: VB7TtBnfmT3JTA/cCL6dJg ($100 in chips)
Seat 2: 14aYclSc98EYd6TrzN2l3Q ($84.15 in chips)
Seat 3: DAIgyIWbYvAkL6PbAI27pg ($18.50 in chips)
Seat 4: 4OO5v3AVduL0tePNx8wk5A ($108.20 in chips)
Seat 5: SJieaES+gCAfonfNNMCP6w ($100 in chips)
Seat 6: YfsTQsY/fxb+YqbdclTHuw ($32.15 in chips)
VB7TtBnfmT3JTA/cCL6dJg: posts small blind $0.50
14aYclSc98EYd6TrzN2l3Q: posts big blind $1
*** HOLE CARDS ***
DAIgyIWbYvAkL6PbAI27pg: folds
4OO5v3AVduL0tePNx8wk5A: folds
SJieaES+gCAfonfNNMCP6w: raises $2.50 to $3.50
YfsTQsY/fxb+YqbdclTHuw: folds
YfsTQsY/fxb+YqbdclTHuw is sitting out
VB7TtBnfmT3JTA/cCL6dJg: folds
14aYclSc98EYd6TrzN2l3Q: calls $2.50
*** FLOP *** [2d 3s Th]
14aYclSc98EYd6TrzN2l3Q: checks
SJieaES+gCAfonfNNMCP6w: checks
*** TURN *** [2d 3s Th] [7c]
14aYclSc98EYd6TrzN2l3Q: bets $3
SJieaES+gCAfonfNNMCP6w: folds
14aYclSc98EYd6TrzN2l3Q collected $7.15 from pot
*** SUMMARY ***
Total pot $7.50 | Rake $0.35
Board [2d 3s Th 7c]
Seat 1: VB7TtBnfmT3JTA/cCL6dJg (small blind) folded before Flop
Seat 2: 14aYclSc98EYd6TrzN2l3Q (big blind) collected ($7.15)
Seat 3: DAIgyIWbYvAkL6PbAI27pg folded before Flop (didn't bet)
Seat 4: 4OO5v3AVduL0tePNx8wk5A folded before Flop (didn't bet)
Seat 5: SJieaES+gCAfonfNNMCP6w folded on the Turn
Seat 6: YfsTQsY/fxb+YqbdclTHuw (button) folded before Flop (didn't bet)



PokerStars Game #59941688660:  Hold'em No Limit ($0.50/$1.00) - 2009/07/01 1:43:02 ET
Table '/RZcOwpZpHQ+OwPwjsbnRw' 6-max Seat #4 is the button
Seat 1: +uSzP8Jwnw7sKfQ4s66b7w ($88.90 in chips)
Seat 2: Z2fXsGcjl+Eax+RzOgwOmg ($104.15 in chips)
Seat 3: LJMw/I77xpnw0R5T4HnMUg ($106.55 in chips)
Seat 4: j7NIOHLZk7V2o9fOioO5ug ($116.20 in chips)
Seat 5: wx3sQGkVi2x9wJXuWNHPBw ($163.25 in chips)
Seat 6: o3YLm/rSY916m/on1VjXPA ($202.50 in chips)
wx3sQGkVi2x9wJXuWNHPBw: posts small blind $0.50
o3YLm/rSY916m/on1VjXPA: posts big blind $1
*** HOLE CARDS ***
+uSzP8Jwnw7sKfQ4s66b7w: folds
Z2fXsGcjl+Eax+RzOgwOmg: folds
LJMw/I77xpnw0R5T4HnMUg: folds
j7NIOHLZk7V2o9fOioO5ug: folds
wx3sQGkVi2x9wJXuWNHPBw: folds
o3YLm/rSY916m/on1VjXPA collected $1 from pot
o3YLm/rSY916m/on1VjXPA: doesn't show hand
*** SUMMARY ***
Total pot $1 | Rake $0
Seat 1: +uSzP8Jwnw7sKfQ4s66b7w folded before Flop (didn't bet)
Seat 2: Z2fXsGcjl+Eax+RzOgwOmg folded before Flop (didn't bet)
Seat 3: LJMw/I77xpnw0R5T4HnMUg folded before Flop (didn't bet)
Seat 4: j7NIOHLZk7V2o9fOioO5ug (button) folded before Flop (didn't bet)
Seat 5: wx3sQGkVi2x9wJXuWNHPBw (small blind) folded before Flop
Seat 6: o3YLm/rSY916m/on1VjXPA (big blind) collected ($1)



PokerStars Game #59941691692:  Hold'em No Limit ($0.50/$1.00) - 2009/07/01 1:43:08 ET
Table 'hugOjcwJvzEwZbK7tyiWuQ' 9-max Seat #3 is the button
Seat 1: S3Ex8K7v6xm5jqjRM7Fl3w ($21.35 in chips)
Seat 2: r27C1nIV4NS4+qbnrgBQSw ($275.10 in chips)
Seat 3: c/6hFCyfLNRn3VFvCeQ1ng ($31.55 in chips)
Seat 4: UWB3oeddt/GObx2Mix2Anw ($195.25 in chips)
Seat 6: gUUvmqdVlmvpal6B8nYrmg ($103.95 in chips)
Seat 7: FL3MrLspcF23LYvC4ipBOA ($109.80 in chips)
Seat 8: /zy+DB4S5fUQUSfZWFzYGw ($121.55 in chips)
Seat 9: W8P9bUKCs43TO1xHm0dL6w ($105.30 in chips)
UWB3oeddt/GObx2Mix2Anw: posts small blind $0.50
gUUvmqdVlmvpal6B8nYrmg: posts big blind $1
*** HOLE CARDS ***
AexZ4puUV9meFWwVU6Nv0w leaves the table
FL3MrLspcF23LYvC4ipBOA: folds
/zy+DB4S5fUQUSfZWFzYGw: folds
W8P9bUKCs43TO1xHm0dL6w: folds
S3Ex8K7v6xm5jqjRM7Fl3w: folds
aM6BB+PnB/rDUr2dbRda+A joins the table at seat #5
r27C1nIV4NS4+qbnrgBQSw: raises $2 to $3
c/6hFCyfLNRn3VFvCeQ1ng: folds
UWB3oeddt/GObx2Mix2Anw: folds
gUUvmqdVlmvpal6B8nYrmg: folds
r27C1nIV4NS4+qbnrgBQSw collected $2.50 from pot
r27C1nIV4NS4+qbnrgBQSw: doesn't show hand
*** SUMMARY ***
Total pot $2.50 | Rake $0
Seat 1: S3Ex8K7v6xm5jqjRM7Fl3w folded before Flop (didn't bet)
Seat 2: r27C1nIV4NS4+qbnrgBQSw collected ($2.50)
Seat 3: c/6hFCyfLNRn3VFvCeQ1ng (button) folded before Flop (didn't bet)
Seat 4: UWB3oeddt/GObx2Mix2Anw (small blind) folded before Flop
Seat 6: gUUvmqdVlmvpal6B8nYrmg (big blind) folded before Flop
Seat 7: FL3MrLspcF23LYvC4ipBOA folded before Flop (didn't bet)
Seat 8: /zy+DB4S5fUQUSfZWFzYGw folded before Flop (didn't bet)
Seat 9: W8P9bUKCs43TO1xHm0dL6w folded before Flop (didn't bet)



PokerStars Game #59941692248:  Hold'em No Limit ($0.50/$1.00) - 2009/07/01 1:43:09 ET
Table 'qj0HBN4HhQKogreu1bg7xg' 2-max Seat #2 is the button
Seat 1: NYi6JFscYNrofSXy4sM+Yw ($145.60 in chips)
Seat 2: qtyl8CSb0/4yWdbuEPJejA ($131 in chips)
qtyl8CSb0/4yWdbuEPJejA: posts small blind $0.50
NYi6JFscYNrofSXy4sM+Yw: posts big blind $1
*** HOLE CARDS ***
qtyl8CSb0/4yWdbuEPJejA: folds
NYi6JFscYNrofSXy4sM+Yw collected $1 from pot
*** SUMMARY ***
Total pot $1 | Rake $0
Seat 1: NYi6JFscYNrofSXy4sM+Yw (big blind) collected ($1)
Seat 2: qtyl8CSb0/4yWdbuEPJejA (button) (small blind) folded before Flop



PokerStars Game #59941692070:  Hold'em No Limit ($0.50/$1.00) - 2009/07/01 1:43:09 ET
Table 'blHlQApStil0OPeQxQxPcw' 9-max Seat #2 is the button
Seat 1: Pp/KTcXkfZKKUHkjyaLTdg ($27.10 in chips)
Seat 2: V138SURkdX8LdVBPKdJJag ($121.35 in chips)
Seat 3: OGgaARGdJQT4awWVNQ957w ($100 in chips)
Seat 5: uXrDE6JrIi8BZK1L8oQ9bQ ($37.10 in chips)
Seat 6: vljeiOoWscAIXU0fCuiEBw ($45.65 in chips)
Seat 7: VPF+HjszMvUIpy0CHIwH3A ($20 in chips)
Seat 9: 6XkTu4ahxzHnvjjc1R8YjQ ($152.85 in chips)
OGgaARGdJQT4awWVNQ957w: posts small blind $0.50
1862487932: is sitting out
uXrDE6JrIi8BZK1L8oQ9bQ: posts big blind $1
*** HOLE CARDS ***
vljeiOoWscAIXU0fCuiEBw: calls $1
1862487932 leaves the table
VPF+HjszMvUIpy0CHIwH3A: folds
6XkTu4ahxzHnvjjc1R8YjQ: calls $1
myIxN7otsyr846M539YR8Q joins the table at seat #4
Pp/KTcXkfZKKUHkjyaLTdg: raises $4.50 to $5.50
V138SURkdX8LdVBPKdJJag: folds
OGgaARGdJQT4awWVNQ957w: folds
uXrDE6JrIi8BZK1L8oQ9bQ: folds
vljeiOoWscAIXU0fCuiEBw: folds
6XkTu4ahxzHnvjjc1R8YjQ: folds
Pp/KTcXkfZKKUHkjyaLTdg collected $4.50 from pot
Pp/KTcXkfZKKUHkjyaLTdg: doesn't show hand
*** SUMMARY ***
Total pot $4.50 | Rake $0
Seat 1: Pp/KTcXkfZKKUHkjyaLTdg collected ($4.50)
Seat 2: V138SURkdX8LdVBPKdJJag (button) folded before Flop (didn't bet)
Seat 3: OGgaARGdJQT4awWVNQ957w (small blind) folded before Flop
Seat 5: uXrDE6JrIi8BZK1L8oQ9bQ (big blind) folded before Flop
Seat 6: vljeiOoWscAIXU0fCuiEBw folded before Flop
Seat 7: VPF+HjszMvUIpy0CHIwH3A folded before Flop (didn't bet)
Seat 9: 6XkTu4ahxzHnvjjc1R8YjQ folded before Flop



PokerStars Game #59941692622:  Hold'em No Limit ($0.50/$1.00) - 2009/07/01 1:43:10 ET
Table 'iSx0wTgVb4o7MyZeOe06ZA' 9-max Seat #1 is the button
Seat 1: VPF+HjszMvUIpy0CHIwH3A ($15.75 in chips)
Seat 2: PI+yBZKhGReWUpHutlCOkw ($79.30 in chips)
Seat 4: ri8CLkX3e9JF34dQNbsHGA ($33.45 in chips)
Seat 5: Pce2Q8yz4j5M9A62KvvNKw ($66.10 in chips)
Seat 6: Lik6kFnIxdZEESN5kBGZzA ($29.35 in chips)
Seat 7: w4NnqVr/Sfoj65ux/fEUyQ ($71.15 in chips)
Seat 8: gUUvmqdVlmvpal6B8nYrmg ($126.20 in chips)
Seat 9: mQADhUTC1xGjAJkD7PEg6A ($100 in chips)
PI+yBZKhGReWUpHutlCOkw: posts small blind $0.50
/inIs/z/PcX+TniIFpaxpg: is sitting out
/inIs/z/PcX+TniIFpaxpg leaves the table
ri8CLkX3e9JF34dQNbsHGA: posts big blind $1
*** HOLE CARDS ***
Pce2Q8yz4j5M9A62KvvNKw: calls $1
Lik6kFnIxdZEESN5kBGZzA: calls $1
w4NnqVr/Sfoj65ux/fEUyQ: folds
LvVcduCnUGWnxGDVhSrOXw joins the table at seat #3
gUUvmqdVlmvpal6B8nYrmg: folds
mQADhUTC1xGjAJkD7PEg6A: calls $1
VPF+HjszMvUIpy0CHIwH3A: folds
PI+yBZKhGReWUpHutlCOkw: folds
ri8CLkX3e9JF34dQNbsHGA: checks
*** FLOP *** [Tc 5h 9h]
ri8CLkX3e9JF34dQNbsHGA: checks
Pce2Q8yz4j5M9A62KvvNKw: bets $1
Lik6kFnIxdZEESN5kBGZzA: raises $3 to $4
mQADhUTC1xGjAJkD7PEg6A: calls $4
PI+yBZKhGReWUpHutlCOkw leaves the table
ri8CLkX3e9JF34dQNbsHGA: folds
Pce2Q8yz4j5M9A62KvvNKw: folds
*** TURN *** [Tc 5h 9h] [9c]
K6Pl7V7WGoykFCZOT8s6IQ joins the table at seat #2
Lik6kFnIxdZEESN5kBGZzA: bets $6
mQADhUTC1xGjAJkD7PEg6A: calls $6
*** RIVER *** [Tc 5h 9h 9c] [8d]
Lik6kFnIxdZEESN5kBGZzA: checks
mQADhUTC1xGjAJkD7PEg6A: checks
*** SHOW DOWN ***
Lik6kFnIxdZEESN5kBGZzA: shows [8s Ts] (two pair, Tens and Nines)
mQADhUTC1xGjAJkD7PEg6A: mucks hand
Lik6kFnIxdZEESN5kBGZzA collected $24.30 from pot
*** SUMMARY ***
Total pot $25.50 | Rake $1.20
Board [Tc 5h 9h 9c 8d]
Seat 1: VPF+HjszMvUIpy0CHIwH3A (button) folded before Flop (didn't bet)
Seat 2: PI+yBZKhGReWUpHutlCOkw (small blind) folded before Flop
Seat 4: ri8CLkX3e9JF34dQNbsHGA (big blind) folded on the Flop
Seat 5: Pce2Q8yz4j5M9A62KvvNKw folded on the Flop
Seat 6: Lik6kFnIxdZEESN5kBGZzA showed [8s Ts] and won ($24.30) with two pair, Tens and Nines
Seat 7: w4NnqVr/Sfoj65ux/fEUyQ folded before Flop (didn't bet)
Seat 8: gUUvmqdVlmvpal6B8nYrmg folded before Flop (didn't bet)
Seat 9: mQADhUTC1xGjAJkD7PEg6A mucked



PokerStars Game #59941693148:  Hold'em No Limit ($0.50/$1.00) - 2009/07/01 1:43:11 ET
Table 'QSIig7BLMc9wY/rgBechzw' 6-max Seat #3 is the button
Seat 1: Z2fXsGcjl+Eax+RzOgwOmg ($116.45 in chips)
Seat 3: 4OO5v3AVduL0tePNx8wk5A ($123.70 in chips)
Seat 4: +uSzP8Jwnw7sKfQ4s66b7w ($75.15 in chips)
Seat 5: lsLuWlcPA3Rh7kJVLzMh0Q ($100 in chips)
Seat 6: Wj7mKnRFR90j40wWUu2+Og ($62.50 in chips)
+uSzP8Jwnw7sKfQ4s66b7w: posts small blind $0.50
lsLuWlcPA3Rh7kJVLzMh0Q: posts big blind $1
*** HOLE CARDS ***
Wj7mKnRFR90j40wWUu2+Og: folds
Z2fXsGcjl+Eax+RzOgwOmg: folds
mLOIkH/qmRa+mVujQIhBRg leaves the table
4OO5v3AVduL0tePNx8wk5A: raises $2 to $3
+uSzP8Jwnw7sKfQ4s66b7w: folds
lsLuWlcPA3Rh7kJVLzMh0Q: folds
Wj7mKnRFR90j40wWUu2+Og is sitting out
4OO5v3AVduL0tePNx8wk5A collected $2.50 from pot
4OO5v3AVduL0tePNx8wk5A: doesn't show hand
*** SUMMARY ***
Total pot $2.50 | Rake $0
Seat 1: Z2fXsGcjl+Eax+RzOgwOmg folded before Flop (didn't bet)
Seat 3: 4OO5v3AVduL0tePNx8wk5A (button) collected ($2.50)
Seat 4: +uSzP8Jwnw7sKfQ4s66b7w (small blind) folded before Flop
Seat 5: lsLuWlcPA3Rh7kJVLzMh0Q (big blind) folded before Flop
Seat 6: Wj7mKnRFR90j40wWUu2+Og folded before Flop (didn't bet)



PokerStars Game #59941693514:  Hold'em No Limit ($0.50/$1.00) - 2009/07/01 1:43:11 ET
Table 'GxCPo/gd3OSthkYrAxJngg' 6-max Seat #5 is the button
Seat 1: sH8BpAFP+jGFxCgVpD1Lew ($246.75 in chips)
Seat 2: YExX2paeIHrmfIwV1ivM/w ($61.60 in chips)
Seat 3: idVgoPAdspFPCzee6aF9Pg ($136 in chips)
Seat 4: YMJG+F++3Aj6P8dAWda5fw ($203.85 in chips)
Seat 5: vX+iYAEINFeLxwMla7DY1Q ($98 in chips)
Seat 6: 4d1rWhpu8DzLmzMbR3QKyA ($100 in chips)
4d1rWhpu8DzLmzMbR3QKyA: posts small blind $0.50
sH8BpAFP+jGFxCgVpD1Lew: posts big blind $1
*** HOLE CARDS ***
YExX2paeIHrmfIwV1ivM/w: folds
idVgoPAdspFPCzee6aF9Pg: folds
YMJG+F++3Aj6P8dAWda5fw: raises $2 to $3
vX+iYAEINFeLxwMla7DY1Q: folds
4d1rWhpu8DzLmzMbR3QKyA: folds
sH8BpAFP+jGFxCgVpD1Lew: calls $2
*** FLOP *** [9c Qs Th]
sH8BpAFP+jGFxCgVpD1Lew: checks
YMJG+F++3Aj6P8dAWda5fw: bets $3
sH8BpAFP+jGFxCgVpD1Lew: calls $3
*** TURN *** [9c Qs Th] [6s]
sH8BpAFP+jGFxCgVpD1Lew: checks
YMJG+F++3Aj6P8dAWda5fw: bets $9
sH8BpAFP+jGFxCgVpD1Lew: folds
YMJG+F++3Aj6P8dAWda5fw collected $11.90 from pot
*** SUMMARY ***
Total pot $12.50 | Rake $0.60
Board [9c Qs Th 6s]
Seat 1: sH8BpAFP+jGFxCgVpD1Lew (big blind) folded on the Turn
Seat 2: YExX2paeIHrmfIwV1ivM/w folded before Flop (didn't bet)
Seat 3: idVgoPAdspFPCzee6aF9Pg folded before Flop (didn't bet)
Seat 4: YMJG+F++3Aj6P8dAWda5fw collected ($11.90)
Seat 5: vX+iYAEINFeLxwMla7DY1Q (button) folded before Flop (didn't bet)
Seat 6: 4d1rWhpu8DzLmzMbR3QKyA (small blind) folded before Flop



PokerStars Game #59941693972:  Hold'em No Limit ($0.50/$1.00) - 2009/07/01 1:43:12 ET
Table 'kS0cTQAEi+fdUlJP2gQYvw' 9-max Seat #9 is the button
Seat 1: SqsWPukL8kLqrhq5ZrQdSQ ($173.50 in chips)
Seat 2: +JautI/vSNALzwSvsOqbCQ ($78 in chips)
Seat 3: 2BV+oJIQYr65IO6nEChvbA ($62.55 in chips)
Seat 4: RUhhaALzha3TH1AkdakoGQ ($55.65 in chips)
Seat 5: 997ViqAtWn1FPjJqcffwcA ($100 in chips)
Seat 6: yAbu2QsRPVcjPbqlf/jDxw ($117.15 in chips)
Seat 7: Ffa7Nj4X5fddtROP01hfQg ($8.50 in chips)
Seat 8: vKyFzTyzfT7fZcdX+HHN+Q ($97.70 in chips)
Seat 9: OGgaARGdJQT4awWVNQ957w ($108.20 in chips)
SqsWPukL8kLqrhq5ZrQdSQ: posts small blind $0.50
+JautI/vSNALzwSvsOqbCQ: posts big blind $1
*** HOLE CARDS ***
2BV+oJIQYr65IO6nEChvbA: folds
RUhhaALzha3TH1AkdakoGQ: calls $1
997ViqAtWn1FPjJqcffwcA: folds
yAbu2QsRPVcjPbqlf/jDxw: folds
Ffa7Nj4X5fddtROP01hfQg: folds
vKyFzTyzfT7fZcdX+HHN+Q: folds
vKyFzTyzfT7fZcdX+HHN+Q leaves the table
V138SURkdX8LdVBPKdJJag joins the table at seat #8
OGgaARGdJQT4awWVNQ957w: folds
SqsWPukL8kLqrhq5ZrQdSQ: calls $0.50
+JautI/vSNALzwSvsOqbCQ: checks
*** FLOP *** [3d 2h 6s]
SqsWPukL8kLqrhq5ZrQdSQ: checks
Ffa7Nj4X5fddtROP01hfQg said, "would have won the bad beat at the bad beat at the casino i play at $37k"
+JautI/vSNALzwSvsOqbCQ: checks
RUhhaALzha3TH1AkdakoGQ: checks
*** TURN *** [3d 2h 6s] [Tc]
SqsWPukL8kLqrhq5ZrQdSQ: checks
+JautI/vSNALzwSvsOqbCQ: checks
RUhhaALzha3TH1AkdakoGQ: bets $2
SqsWPukL8kLqrhq5ZrQdSQ: folds
+JautI/vSNALzwSvsOqbCQ: folds
RUhhaALzha3TH1AkdakoGQ collected $2.85 from pot
*** SUMMARY ***
Total pot $3 | Rake $0.15
Board [3d 2h 6s Tc]
Seat 1: SqsWPukL8kLqrhq5ZrQdSQ (small blind) folded on the Turn
Seat 2: +JautI/vSNALzwSvsOqbCQ (big blind) folded on the Turn
Seat 3: 2BV+oJIQYr65IO6nEChvbA folded before Flop (didn't bet)
Seat 4: RUhhaALzha3TH1AkdakoGQ collected ($2.85)
Seat 5: 997ViqAtWn1FPjJqcffwcA folded before Flop (didn't bet)
Seat 6: yAbu2QsRPVcjPbqlf/jDxw folded before Flop (didn't bet)
Seat 7: Ffa7Nj4X5fddtROP01hfQg folded before Flop (didn't bet)
Seat 8: vKyFzTyzfT7fZcdX+HHN+Q folded before Flop (didn't bet)
Seat 9: OGgaARGdJQT4awWVNQ957w (button) folded before Flop (didn't bet)



PokerStars Game #59941694130:  Hold'em No Limit ($0.50/$1.00) - 2009/07/01 1:43:13 ET
Table 'pHrhryH8jPNdQfY62f8v+g' 6-max Seat #4 is the button
Seat 1: 4d1rWhpu8DzLmzMbR3QKyA ($147.45 in chips)
Seat 2: JwCcjZl0bjJzG7hmE0dnTA ($119.10 in chips)
Seat 3: 8oS5O7iD/qnFXFXJrGIgNQ ($112.30 in chips)
Seat 4: 1f3beyIML24UqEMTbWy93g ($47.35 in chips)
Seat 5: d8WX+9nUHoqlrAGagO0Wow ($19 in chips)
Seat 6: xAU6q2/cwmby2sxmA8VcmA ($199.30 in chips)
d8WX+9nUHoqlrAGagO0Wow: posts small blind $0.50
xAU6q2/cwmby2sxmA8VcmA: posts big blind $1
*** HOLE CARDS ***
4d1rWhpu8DzLmzMbR3QKyA: folds
JwCcjZl0bjJzG7hmE0dnTA: folds
8oS5O7iD/qnFXFXJrGIgNQ: raises $2.50 to $3.50
1f3beyIML24UqEMTbWy93g: calls $3.50
d8WX+9nUHoqlrAGagO0Wow: folds
xAU6q2/cwmby2sxmA8VcmA: folds
*** FLOP *** [Jd Js 3s]
8oS5O7iD/qnFXFXJrGIgNQ: bets $6
1f3beyIML24UqEMTbWy93g: folds
8oS5O7iD/qnFXFXJrGIgNQ collected $8.10 from pot
*** SUMMARY ***
Total pot $8.50 | Rake $0.40
Board [Jd Js 3s]
Seat 1: 4d1rWhpu8DzLmzMbR3QKyA folded before Flop (didn't bet)
Seat 2: JwCcjZl0bjJzG7hmE0dnTA folded before Flop (didn't bet)
Seat 3: 8oS5O7iD/qnFXFXJrGIgNQ collected ($8.10)
Seat 4: 1f3beyIML24UqEMTbWy93g (button) folded on the Flop
Seat 5: d8WX+9nUHoqlrAGagO0Wow (small blind) folded before Flop
Seat 6: xAU6q2/cwmby2sxmA8VcmA (big blind) folded before Flop



PokerStars Game #59941694824:  Hold'em No Limit ($0.50/$1.00) - 2009/07/01 1:43:14 ET
Table 'DE4ps3MTl+4avTytwFENAg' 6-max Seat #6 is the button
Seat 1: PvfYaKbzMpsmUcbOExckbQ ($100.75 in chips)
Seat 2: QHvTZcrKe6+maWUfVjP29Q ($100 in chips)
Seat 3: cGayYjcyk6+jN57tzIY4TA ($303.60 in chips)
Seat 4: iexehpxaQwzColGqeTEnLQ ($114.35 in chips)
Seat 6: lsLuWlcPA3Rh7kJVLzMh0Q ($106.75 in chips)
PvfYaKbzMpsmUcbOExckbQ: posts small blind $0.50
QHvTZcrKe6+maWUfVjP29Q: posts big blind $1
*** HOLE CARDS ***
BWhgxe7gWiYobRbwdG+d2Q joins the table at seat #5
cGayYjcyk6+jN57tzIY4TA: calls $1
iexehpxaQwzColGqeTEnLQ: raises $3 to $4
lsLuWlcPA3Rh7kJVLzMh0Q: folds
PvfYaKbzMpsmUcbOExckbQ: folds
QHvTZcrKe6+maWUfVjP29Q: folds
cGayYjcyk6+jN57tzIY4TA: calls $3
*** FLOP *** [Th Ac 7s]
cGayYjcyk6+jN57tzIY4TA: bets $3
iexehpxaQwzColGqeTEnLQ: raises $7 to $10
cGayYjcyk6+jN57tzIY4TA: calls $7
*** TURN *** [Th Ac 7s] [4s]
cGayYjcyk6+jN57tzIY4TA: bets $10
iexehpxaQwzColGqeTEnLQ: folds
cGayYjcyk6+jN57tzIY4TA collected $28.05 from pot
*** SUMMARY ***
Total pot $29.50 | Rake $1.45
Board [Th Ac 7s 4s]
Seat 1: PvfYaKbzMpsmUcbOExckbQ (small blind) folded before Flop
Seat 2: QHvTZcrKe6+maWUfVjP29Q (big blind) folded before Flop
Seat 3: cGayYjcyk6+jN57tzIY4TA collected ($28.05)
Seat 4: iexehpxaQwzColGqeTEnLQ folded on the Turn
Seat 6: lsLuWlcPA3Rh7kJVLzMh0Q (button) folded before Flop (didn't bet)



PokerStars Game #59941695396:  Hold'em No Limit ($0.50/$1.00) - 2009/07/01 1:43:15 ET
Table 'qj0HBN4HhQKogreu1bg7xg' 2-max Seat #1 is the button
Seat 1: NYi6JFscYNrofSXy4sM+Yw ($146.10 in chips)
Seat 2: qtyl8CSb0/4yWdbuEPJejA ($130.50 in chips)
NYi6JFscYNrofSXy4sM+Yw: posts small blind $0.50
qtyl8CSb0/4yWdbuEPJejA: posts big blind $1
*** HOLE CARDS ***
NYi6JFscYNrofSXy4sM+Yw: raises $2 to $3
qtyl8CSb0/4yWdbuEPJejA: folds
NYi6JFscYNrofSXy4sM+Yw collected $2 from pot
*** SUMMARY ***
Total pot $2 | Rake $0
Seat 1: NYi6JFscYNrofSXy4sM+Yw (button) (small blind) collected ($2)
Seat 2: qtyl8CSb0/4yWdbuEPJejA (big blind) folded before Flop



PokerStars Game #59941695826:  Hold'em No Limit ($0.50/$1.00) - 2009/07/01 1:43:16 ET
Table 'b8oW/dOL7fDza5DfZ/dOJQ' 6-max Seat #4 is the button
Seat 1: NakujTNjHFgzceydFf+E2Q ($53.40 in chips)
Seat 2: TSuRyAHnUPCFjP7Z0rEE0w ($117.50 in chips)
Seat 3: d8WX+9nUHoqlrAGagO0Wow ($32.80 in chips)
Seat 4: 8rDbzImSi1zgxtqtF1pSbA ($10 in chips)
Seat 5: sr/OkkgqNbtgwJf1tmnfNg ($60 in chips)
Seat 6: PvfYaKbzMpsmUcbOExckbQ ($160.85 in chips)
sr/OkkgqNbtgwJf1tmnfNg: posts small blind $0.50
PvfYaKbzMpsmUcbOExckbQ: posts big blind $1
*** HOLE CARDS ***
NakujTNjHFgzceydFf+E2Q: folds
TSuRyAHnUPCFjP7Z0rEE0w: folds
d8WX+9nUHoqlrAGagO0Wow: folds
8rDbzImSi1zgxtqtF1pSbA: folds
sr/OkkgqNbtgwJf1tmnfNg: calls $0.50
PvfYaKbzMpsmUcbOExckbQ: checks
*** FLOP *** [4d 5s 7d]
sr/OkkgqNbtgwJf1tmnfNg: checks
PvfYaKbzMpsmUcbOExckbQ: bets $2
sr/OkkgqNbtgwJf1tmnfNg: calls $2
*** TURN *** [4d 5s 7d] [8h]
sr/OkkgqNbtgwJf1tmnfNg: checks
PvfYaKbzMpsmUcbOExckbQ: checks
*** RIVER *** [4d 5s 7d 8h] [5d]
sr/OkkgqNbtgwJf1tmnfNg: bets $4
PvfYaKbzMpsmUcbOExckbQ: folds
sr/OkkgqNbtgwJf1tmnfNg collected $5.75 from pot
*** SUMMARY ***
Total pot $6 | Rake $0.25
Board [4d 5s 7d 8h 5d]
Seat 1: NakujTNjHFgzceydFf+E2Q folded before Flop (didn't bet)
Seat 2: TSuRyAHnUPCFjP7Z0rEE0w folded before Flop (didn't bet)
Seat 3: d8WX+9nUHoqlrAGagO0Wow folded before Flop (didn't bet)
Seat 4: 8rDbzImSi1zgxtqtF1pSbA (button) folded before Flop (didn't bet)
Seat 5: sr/OkkgqNbtgwJf1tmnfNg (small blind) collected ($5.75)
Seat 6: PvfYaKbzMpsmUcbOExckbQ (big blind) folded on the River



PokerStars Game #59941696318:  Hold'em No Limit ($0.50/$1.00) - 2009/07/01 1:43:17 ET
Table 'W/wyObTiXZm+Ckkl3YxcSw' 6-max Seat #2 is the button
Seat 1: eUBBn2R56C1IQ6Cs/vitwg ($181.55 in chips)
Seat 2: oDiBRCaF0QVtd3kO6xZIXw ($129.65 in chips)
Seat 3: 4OO5v3AVduL0tePNx8wk5A ($100 in chips)
Seat 4: rHlMOfR7kpQQxe+PFQz0xQ ($50 in chips)
Seat 5: +OrCjyw70oZhJiD22Mn+bg ($200.50 in chips)
Seat 6: b2a+5TkFf4xJN/Ihhma58Q ($32.30 in chips)
4OO5v3AVduL0tePNx8wk5A: posts small blind $0.50
rHlMOfR7kpQQxe+PFQz0xQ: posts big blind $1
*** HOLE CARDS ***
+OrCjyw70oZhJiD22Mn+bg: folds
b2a+5TkFf4xJN/Ihhma58Q: folds
eUBBn2R56C1IQ6Cs/vitwg: raises $2 to $3
oDiBRCaF0QVtd3kO6xZIXw: folds
4OO5v3AVduL0tePNx8wk5A: folds
rHlMOfR7kpQQxe+PFQz0xQ: folds
eUBBn2R56C1IQ6Cs/vitwg collected $2.50 from pot
*** SUMMARY ***
Total pot $2.50 | Rake $0
Seat 1: eUBBn2R56C1IQ6Cs/vitwg collected ($2.50)
Seat 2: oDiBRCaF0QVtd3kO6xZIXw (button) folded before Flop (didn't bet)
Seat 3: 4OO5v3AVduL0tePNx8wk5A (small blind) folded before Flop
Seat 4: rHlMOfR7kpQQxe+PFQz0xQ (big blind) folded before Flop
Seat 5: +OrCjyw70oZhJiD22Mn+bg folded before Flop (didn't bet)
Seat 6: b2a+5TkFf4xJN/Ihhma58Q folded before Flop (didn't bet)



PokerStars Game #59941696380:  Hold'em No Limit ($0.50/$1.00) - 2009/07/01 1:43:17 ET
Table 'MUPc8FEpe/nR0BKSeReX6Q' 6-max Seat #2 is the button
Seat 1: qhkK6+yCciTRd+rCFEbnEQ ($83.70 in chips)
Seat 2: xAU6q2/cwmby2sxmA8VcmA ($103.70 in chips)
Seat 3: wx3sQGkVi2x9wJXuWNHPBw ($286.65 in chips)
Seat 4: r4lpoh2BJZ8S6zyQv1JeSw ($110 in chips)
Seat 5: y27w5IK2WXqmYzS8OU0wKA ($129.55 in chips)
Seat 6: ene3nLSnQ4N961iBaUsSmA ($100 in chips)
wx3sQGkVi2x9wJXuWNHPBw: posts small blind $0.50
r4lpoh2BJZ8S6zyQv1JeSw: posts big blind $1
*** HOLE CARDS ***
y27w5IK2WXqmYzS8OU0wKA: raises $2 to $3
ene3nLSnQ4N961iBaUsSmA: folds
qhkK6+yCciTRd+rCFEbnEQ: folds
xAU6q2/cwmby2sxmA8VcmA: folds
wx3sQGkVi2x9wJXuWNHPBw: folds
r4lpoh2BJZ8S6zyQv1JeSw: folds
y27w5IK2WXqmYzS8OU0wKA collected $2.50 from pot
y27w5IK2WXqmYzS8OU0wKA: doesn't show hand
*** SUMMARY ***
Total pot $2.50 | Rake $0
Seat 1: qhkK6+yCciTRd+rCFEbnEQ folded before Flop (didn't bet)
Seat 2: xAU6q2/cwmby2sxmA8VcmA (button) folded before Flop (didn't bet)
Seat 3: wx3sQGkVi2x9wJXuWNHPBw (small blind) folded before Flop
Seat 4: r4lpoh2BJZ8S6zyQv1JeSw (big blind) folded before Flop
Seat 5: y27w5IK2WXqmYzS8OU0wKA collected ($2.50)
Seat 6: ene3nLSnQ4N961iBaUsSmA folded before Flop (didn't bet)



PokerStars Game #59941696820:  Hold'em No Limit ($0.50/$1.00) - 2009/07/01 1:43:18 ET
Table 'fZjVbKj9D8yOB+Rj7NaP/A' 9-max Seat #5 is the button
Seat 2: PTAFYDIUSsG+SArbxNl+Aw ($112 in chips)
Seat 3: yAbu2QsRPVcjPbqlf/jDxw ($102.15 in chips)
Seat 4: likAqWsWycNGwDQIcHN6GA ($100 in chips)
Seat 5: PkGfq5xrSlNsujKaG/HF4Q ($100 in chips)
Seat 6: OvwYHV65yUbgdBjSmo1+5g ($134.45 in chips)
Seat 7: SyS20PAm3RpT6uLBsGkwOA ($110.70 in chips)
Seat 8: EVvb0huXeMB7dnOAiO4ggA ($48.50 in chips)
Seat 9: qheQay5YvP2DMAb3OUSxtw ($143.60 in chips)
OvwYHV65yUbgdBjSmo1+5g: posts small blind $0.50
SyS20PAm3RpT6uLBsGkwOA: posts big blind $1
kiakSwxX0e64PwYGAPQvLw: sits out
likAqWsWycNGwDQIcHN6GA: posts big blind $1
*** HOLE CARDS ***
EVvb0huXeMB7dnOAiO4ggA: folds
qheQay5YvP2DMAb3OUSxtw: folds
PTAFYDIUSsG+SArbxNl+Aw: folds
yAbu2QsRPVcjPbqlf/jDxw: raises $4 to $5
likAqWsWycNGwDQIcHN6GA: folds
PkGfq5xrSlNsujKaG/HF4Q: folds
OvwYHV65yUbgdBjSmo1+5g: calls $4.50
SyS20PAm3RpT6uLBsGkwOA: calls $4
*** FLOP *** [6s Jc Kc]
OvwYHV65yUbgdBjSmo1+5g: bets $5
SyS20PAm3RpT6uLBsGkwOA: folds
yAbu2QsRPVcjPbqlf/jDxw: folds
OvwYHV65yUbgdBjSmo1+5g collected $15.20 from pot
*** SUMMARY ***
Total pot $16 | Rake $0.80
Board [6s Jc Kc]
Seat 2: PTAFYDIUSsG+SArbxNl+Aw folded before Flop (didn't bet)
Seat 3: yAbu2QsRPVcjPbqlf/jDxw folded on the Flop
Seat 4: likAqWsWycNGwDQIcHN6GA folded before Flop
Seat 5: PkGfq5xrSlNsujKaG/HF4Q (button) folded before Flop (didn't bet)
Seat 6: OvwYHV65yUbgdBjSmo1+5g (small blind) collected ($15.20)
Seat 7: SyS20PAm3RpT6uLBsGkwOA (big blind) folded on the Flop
Seat 8: EVvb0huXeMB7dnOAiO4ggA folded before Flop (didn't bet)
Seat 9: qheQay5YvP2DMAb3OUSxtw folded before Flop (didn't bet)



PokerStars Game #59941699330:  Hold'em No Limit ($0.50/$1.00) - 2009/07/01 1:43:22 ET
Table 'qj0HBN4HhQKogreu1bg7xg' 2-max Seat #2 is the button
Seat 1: NYi6JFscYNrofSXy4sM+Yw ($147.10 in chips)
Seat 2: qtyl8CSb0/4yWdbuEPJejA ($129.50 in chips)
qtyl8CSb0/4yWdbuEPJejA: posts small blind $0.50
NYi6JFscYNrofSXy4sM+Yw: posts big blind $1
*** HOLE CARDS ***
qtyl8CSb0/4yWdbuEPJejA: raises $2 to $3
NYi6JFscYNrofSXy4sM+Yw: folds
qtyl8CSb0/4yWdbuEPJejA collected $2 from pot
qtyl8CSb0/4yWdbuEPJejA: doesn't show hand
*** SUMMARY ***
Total pot $2 | Rake $0
Seat 1: NYi6JFscYNrofSXy4sM+Yw (big blind) folded before Flop
Seat 2: qtyl8CSb0/4yWdbuEPJejA (button) (small blind) collected ($2)



PokerStars Game #59941699766:  Hold'em No Limit ($0.50/$1.00) - 2009/07/01 1:43:23 ET
Table '7O9fB8yx1u7sJveJn8w6jA' 6-max Seat #3 is the button
Seat 1: 841740 ($38.80 in chips)
Seat 2: wx3sQGkVi2x9wJXuWNHPBw ($205.35 in chips)
Seat 3: hpxXcmRkXXI9HE5+5/j/0Q ($145.45 in chips)
Seat 4: b2a+5TkFf4xJN/Ihhma58Q ($32.85 in chips)
Seat 5: BCEV3COoKY607AzLWayfRA ($100 in chips)
Seat 6: r4lpoh2BJZ8S6zyQv1JeSw ($107.75 in chips)
b2a+5TkFf4xJN/Ihhma58Q: posts small blind $0.50
BCEV3COoKY607AzLWayfRA: posts big blind $1
*** HOLE CARDS ***
r4lpoh2BJZ8S6zyQv1JeSw: folds
841740: calls $1
wx3sQGkVi2x9wJXuWNHPBw: folds
hpxXcmRkXXI9HE5+5/j/0Q: folds
b2a+5TkFf4xJN/Ihhma58Q: raises $1 to $2
BCEV3COoKY607AzLWayfRA: raises $5.50 to $7.50
841740: folds
b2a+5TkFf4xJN/Ihhma58Q: calls $5.50
*** FLOP *** [Kc Ac 7c]
b2a+5TkFf4xJN/Ihhma58Q: checks
BCEV3COoKY607AzLWayfRA: bets $12
b2a+5TkFf4xJN/Ihhma58Q: folds
BCEV3COoKY607AzLWayfRA collected $15.20 from pot
BCEV3COoKY607AzLWayfRA: doesn't show hand
*** SUMMARY ***
Total pot $16 | Rake $0.80
Board [Kc Ac 7c]
Seat 1: 841740 folded before Flop
Seat 2: wx3sQGkVi2x9wJXuWNHPBw folded before Flop (didn't bet)
Seat 3: hpxXcmRkXXI9HE5+5/j/0Q (button) folded before Flop (didn't bet)
Seat 4: b2a+5TkFf4xJN/Ihhma58Q (small blind) folded on the Flop
Seat 5: BCEV3COoKY607AzLWayfRA (big blind) collected ($15.20)
Seat 6: r4lpoh2BJZ8S6zyQv1JeSw folded before Flop (didn't bet)



PokerStars Game #59941700014:  Hold'em No Limit ($0.50/$1.00) - 2009/07/01 1:43:24 ET
Table '/RZcOwpZpHQ+OwPwjsbnRw' 6-max Seat #5 is the button
Seat 1: +uSzP8Jwnw7sKfQ4s66b7w ($88.90 in chips)
Seat 2: Z2fXsGcjl+Eax+RzOgwOmg ($104.15 in chips)
Seat 3: LJMw/I77xpnw0R5T4HnMUg ($106.55 in chips)
Seat 4: j7NIOHLZk7V2o9fOioO5ug ($116.20 in chips)
Seat 5: wx3sQGkVi2x9wJXuWNHPBw ($162.75 in chips)
Seat 6: o3YLm/rSY916m/on1VjXPA ($203 in chips)
o3YLm/rSY916m/on1VjXPA: posts small blind $0.50
+uSzP8Jwnw7sKfQ4s66b7w: posts big blind $1
*** HOLE CARDS ***
Z2fXsGcjl+Eax+RzOgwOmg: folds
LJMw/I77xpnw0R5T4HnMUg: folds
j7NIOHLZk7V2o9fOioO5ug: raises $2 to $3
wx3sQGkVi2x9wJXuWNHPBw: raises $9 to $12
o3YLm/rSY916m/on1VjXPA: folds
+uSzP8Jwnw7sKfQ4s66b7w: folds
j7NIOHLZk7V2o9fOioO5ug: folds
wx3sQGkVi2x9wJXuWNHPBw collected $7.50 from pot
*** SUMMARY ***
Total pot $7.50 | Rake $0
Seat 1: +uSzP8Jwnw7sKfQ4s66b7w (big blind) folded before Flop
Seat 2: Z2fXsGcjl+Eax+RzOgwOmg folded before Flop (didn't bet)
Seat 3: LJMw/I77xpnw0R5T4HnMUg folded before Flop (didn't bet)
Seat 4: j7NIOHLZk7V2o9fOioO5ug folded before Flop
Seat 5: wx3sQGkVi2x9wJXuWNHPBw (button) collected ($7.50)
Seat 6: o3YLm/rSY916m/on1VjXPA (small blind) folded before Flop



PokerStars Game #59941700576:  Hold'em No Limit ($0.50/$1.00) - 2009/07/01 1:43:25 ET
Table 'O96CPOtvMBWP6kzuYDfdFA' 6-max Seat #5 is the button
Seat 1: 6alLXQIITA2EZ/lBeym8Dw ($124.75 in chips)
Seat 2: 4d1rWhpu8DzLmzMbR3QKyA ($101.50 in chips)
Seat 3: ieBUmHu5QBR86BArTtK4FQ ($21.55 in chips)
Seat 4: /P4w1pHg2zHYg/4ubJ0dPw ($63.95 in chips)
Seat 5: vX+iYAEINFeLxwMla7DY1Q ($89 in chips)
Seat 6: 3syOXva630dm1FTdwnuLpw ($93.10 in chips)
3syOXva630dm1FTdwnuLpw: posts small blind $0.50
6alLXQIITA2EZ/lBeym8Dw: posts big blind $1
*** HOLE CARDS ***
4d1rWhpu8DzLmzMbR3QKyA: folds
ieBUmHu5QBR86BArTtK4FQ: raises $1 to $2
/P4w1pHg2zHYg/4ubJ0dPw: calls $2
vX+iYAEINFeLxwMla7DY1Q: calls $2
3syOXva630dm1FTdwnuLpw: calls $1.50
6alLXQIITA2EZ/lBeym8Dw: raises $11 to $13
ieBUmHu5QBR86BArTtK4FQ: folds
/P4w1pHg2zHYg/4ubJ0dPw: folds
vX+iYAEINFeLxwMla7DY1Q: folds
3syOXva630dm1FTdwnuLpw: calls $11
*** FLOP *** [4c 8d 2c]
3syOXva630dm1FTdwnuLpw: checks
6alLXQIITA2EZ/lBeym8Dw: bets $17
3syOXva630dm1FTdwnuLpw: folds
6alLXQIITA2EZ/lBeym8Dw collected $30.40 from pot
6alLXQIITA2EZ/lBeym8Dw: doesn't show hand
*** SUMMARY ***
Total pot $32 | Rake $1.60
Board [4c 8d 2c]
Seat 1: 6alLXQIITA2EZ/lBeym8Dw (big blind) collected ($30.40)
Seat 2: 4d1rWhpu8DzLmzMbR3QKyA folded before Flop (didn't bet)
Seat 3: ieBUmHu5QBR86BArTtK4FQ folded before Flop
Seat 4: /P4w1pHg2zHYg/4ubJ0dPw folded before Flop
Seat 5: vX+iYAEINFeLxwMla7DY1Q (button) folded before Flop
Seat 6: 3syOXva630dm1FTdwnuLpw (small blind) folded on the Flop



PokerStars Game #59941700996:  Hold'em No Limit ($0.50/$1.00) - 2009/07/01 1:43:25 ET
Table '305hiksPPCCdC6V2LNsO5w' 6-max Seat #6 is the button
Seat 2: j7NIOHLZk7V2o9fOioO5ug ($159.20 in chips)
Seat 3: +zIVjZKLpcidfRHgVZW8lA ($28.50 in chips)
Seat 4: uJVSceLggtsrJya+WtmUEA ($202.30 in chips)
Seat 5: +Nt3OPk3XR9SKjZgm2CexQ ($100 in chips)
Seat 6: 9/Tq8dw7kWW68uN8bFupXg ($26.90 in chips)
j7NIOHLZk7V2o9fOioO5ug: posts small blind $0.50
+zIVjZKLpcidfRHgVZW8lA: posts big blind $1
*** HOLE CARDS ***
uJVSceLggtsrJya+WtmUEA has timed out
uJVSceLggtsrJya+WtmUEA: folds
uJVSceLggtsrJya+WtmUEA is sitting out
+Nt3OPk3XR9SKjZgm2CexQ: folds
9/Tq8dw7kWW68uN8bFupXg: raises $1 to $2
j7NIOHLZk7V2o9fOioO5ug: folds
+zIVjZKLpcidfRHgVZW8lA: calls $1
*** FLOP *** [4h 6d 9d]
+zIVjZKLpcidfRHgVZW8lA: checks
9/Tq8dw7kWW68uN8bFupXg: checks
*** TURN *** [4h 6d 9d] [Qs]
+zIVjZKLpcidfRHgVZW8lA: bets $2
9/Tq8dw7kWW68uN8bFupXg: calls $2
*** RIVER *** [4h 6d 9d Qs] [9c]
+zIVjZKLpcidfRHgVZW8lA: bets $4
9/Tq8dw7kWW68uN8bFupXg: calls $4
*** SHOW DOWN ***
+zIVjZKLpcidfRHgVZW8lA: shows [2d Qd] (two pair, Queens and Nines)
9/Tq8dw7kWW68uN8bFupXg: mucks hand
+zIVjZKLpcidfRHgVZW8lA collected $15.70 from pot
*** SUMMARY ***
Total pot $16.50 | Rake $0.80
Board [4h 6d 9d Qs 9c]
Seat 2: j7NIOHLZk7V2o9fOioO5ug (small blind) folded before Flop
Seat 3: +zIVjZKLpcidfRHgVZW8lA (big blind) showed [2d Qd] and won ($15.70) with two pair, Queens and Nines
Seat 4: uJVSceLggtsrJya+WtmUEA folded before Flop (didn't bet)
Seat 5: +Nt3OPk3XR9SKjZgm2CexQ folded before Flop (didn't bet)
Seat 6: 9/Tq8dw7kWW68uN8bFupXg (button) mucked



PokerStars Game #59941701420:  Hold'em No Limit ($0.50/$1.00) - 2009/07/01 1:43:26 ET
Table 'VOs36P6NW+QyXeQ1B62kmAE9S5sEoK9Q3olj2a53gABASeat #2 is the button
Seat 1: 4h8XtuVJtWh3DJpxGo7k5Q ($25.95 in chips)
Seat 2: y27w5IK2WXqmYzS8OU0wKA ($145.65 in chips)
Seat 3: p00KmyZiD/isPc/lZwNBTg ($17.25 in chips)
Seat 4: ene3nLSnQ4N961iBaUsSmA ($100 in chips)
Seat 5: o3YLm/rSY916m/on1VjXPA ($134.60 in chips)
Seat 6: slVKuQyEz8Qj4E3uLPYNXg ($46.60 in chips)
p00KmyZiD/isPc/lZwNBTg: posts small blind $0.50
ene3nLSnQ4N961iBaUsSmA: posts big blind $1
*** HOLE CARDS ***
o3YLm/rSY916m/on1VjXPA: folds
slVKuQyEz8Qj4E3uLPYNXg: raises $2 to $3
4h8XtuVJtWh3DJpxGo7k5Q: folds
y27w5IK2WXqmYzS8OU0wKA: folds
p00KmyZiD/isPc/lZwNBTg: calls $2.50
ene3nLSnQ4N961iBaUsSmA: folds
*** FLOP *** [8h 9d Ac]
p00KmyZiD/isPc/lZwNBTg: checks
slVKuQyEz8Qj4E3uLPYNXg: checks
*** TURN *** [8h 9d Ac] [7s]
p00KmyZiD/isPc/lZwNBTg: checks
slVKuQyEz8Qj4E3uLPYNXg: bets $3
p00KmyZiD/isPc/lZwNBTg: folds
slVKuQyEz8Qj4E3uLPYNXg collected $6.65 from pot
*** SUMMARY ***
Total pot $7 | Rake $0.35
Board [8h 9d Ac 7s]
Seat 1: 4h8XtuVJtWh3DJpxGo7k5Q folded before Flop (didn't bet)
Seat 2: y27w5IK2WXqmYzS8OU0wKA (button) folded before Flop (didn't bet)
Seat 3: p00KmyZiD/isPc/lZwNBTg (small blind) folded on the Turn
Seat 4: ene3nLSnQ4N961iBaUsSmA (big blind) folded before Flop
Seat 5: o3YLm/rSY916m/on1VjXPA folded before Flop (didn't bet)
Seat 6: slVKuQyEz8Qj4E3uLPYNXg collected ($6.65)



PokerStars Game #59941701844:  Hold'em No Limit ($0.50/$1.00) - 2009/07/01 1:43:27 ET
Table '7Nl0ffnjeK44/vmeexh3MQ' 9-max Seat #7 is the button
Seat 1: V138SURkdX8LdVBPKdJJag ($114.55 in chips)
Seat 2: OGgaARGdJQT4awWVNQ957w ($101.50 in chips)
Seat 3: JMmUYT5pIKCKh2pGjCB/4w ($56.90 in chips)
Seat 4: bLbSOSmSOnqE0iTcH/5dxA ($107.55 in chips)
Seat 5: 61sfw5QTu62YYIt68OsdrA ($76.05 in chips)
Seat 6: FVs16t7GgfWgQWt4JxsObQ ($16.75 in chips)
Seat 7: 2fVA6XTmacKkwJ4SpKDAtA ($98.50 in chips)
Seat 8: HRJJZiSxFAehJGaET63dlA ($45.90 in chips)
Seat 9: /JHoNdt0fK6X+isrqRfV3w ($20 in chips)
HRJJZiSxFAehJGaET63dlA: posts small blind $0.50
/JHoNdt0fK6X+isrqRfV3w: posts big blind $1
*** HOLE CARDS ***
V138SURkdX8LdVBPKdJJag: folds
OGgaARGdJQT4awWVNQ957w: folds
JMmUYT5pIKCKh2pGjCB/4w: folds
bLbSOSmSOnqE0iTcH/5dxA: folds
61sfw5QTu62YYIt68OsdrA: folds
FVs16t7GgfWgQWt4JxsObQ: calls $1
2fVA6XTmacKkwJ4SpKDAtA: raises $3 to $4
JMmUYT5pIKCKh2pGjCB/4w is sitting out
HRJJZiSxFAehJGaET63dlA: folds
JMmUYT5pIKCKh2pGjCB/4w has returned
/JHoNdt0fK6X+isrqRfV3w: folds
FVs16t7GgfWgQWt4JxsObQ: calls $3
*** FLOP *** [9h 7h 8d]
FVs16t7GgfWgQWt4JxsObQ: checks
2fVA6XTmacKkwJ4SpKDAtA: bets $8
FVs16t7GgfWgQWt4JxsObQ: calls $8
*** TURN *** [9h 7h 8d] [3c]
FVs16t7GgfWgQWt4JxsObQ: bets $1
2fVA6XTmacKkwJ4SpKDAtA: calls $1
*** RIVER *** [9h 7h 8d 3c] [Ts]
FVs16t7GgfWgQWt4JxsObQ: bets $1
2fVA6XTmacKkwJ4SpKDAtA: folds
FVs16t7GgfWgQWt4JxsObQ collected $26.20 from pot
*** SUMMARY ***
Total pot $27.50 | Rake $1.30
Board [9h 7h 8d 3c Ts]
Seat 1: V138SURkdX8LdVBPKdJJag folded before Flop (didn't bet)
Seat 2: OGgaARGdJQT4awWVNQ957w folded before Flop (didn't bet)
Seat 3: JMmUYT5pIKCKh2pGjCB/4w folded before Flop (didn't bet)
Seat 4: bLbSOSmSOnqE0iTcH/5dxA folded before Flop (didn't bet)
Seat 5: 61sfw5QTu62YYIt68OsdrA folded before Flop (didn't bet)
Seat 6: FVs16t7GgfWgQWt4JxsObQ collected ($26.20)
Seat 7: 2fVA6XTmacKkwJ4SpKDAtA (button) folded on the River
Seat 8: HRJJZiSxFAehJGaET63dlA (small blind) folded before Flop
Seat 9: /JHoNdt0fK6X+isrqRfV3w (big blind) folded before Flop



PokerStars Game #59941703298:  Hold'em No Limit ($0.50/$1.00) - 2009/07/01 1:43:30 ET
Table '3T4owEKJKyGTMePwrv50FQ' 9-max Seat #8 is the button
Seat 1: OGgaARGdJQT4awWVNQ957w ($101.50 in chips)
Seat 2: t+Id2O6herCLgwnC4m49PA ($29.55 in chips)
Seat 3: DOLzOcBTZYcph5jEfKFWuQ ($106.40 in chips)
Seat 4: O5Go3jrzbQWxRB6ESK+Ptg ($62.10 in chips)
Seat 5: mMc/PBpqlN24gdi3C/1tOw ($50.25 in chips)
Seat 6: V138SURkdX8LdVBPKdJJag ($110.25 in chips)
Seat 7: 1862487932 ($104 in chips)
Seat 8: bLbSOSmSOnqE0iTcH/5dxA ($197 in chips)
Seat 9: 61sfw5QTu62YYIt68OsdrA ($83.75 in chips)
61sfw5QTu62YYIt68OsdrA: posts small blind $0.50
OGgaARGdJQT4awWVNQ957w: posts big blind $1
*** HOLE CARDS ***
t+Id2O6herCLgwnC4m49PA: calls $1
DOLzOcBTZYcph5jEfKFWuQ: folds
O5Go3jrzbQWxRB6ESK+Ptg: folds
O5Go3jrzbQWxRB6ESK+Ptg leaves the table
mMc/PBpqlN24gdi3C/1tOw: folds
V138SURkdX8LdVBPKdJJag: raises $3.75 to $4.75
1862487932: folds
bLbSOSmSOnqE0iTcH/5dxA: folds
61sfw5QTu62YYIt68OsdrA: folds
OGgaARGdJQT4awWVNQ957w: folds
t+Id2O6herCLgwnC4m49PA: calls $3.75
*** FLOP *** [Ad Ac Qd]
t+Id2O6herCLgwnC4m49PA: bets $5
V138SURkdX8LdVBPKdJJag: folds
t+Id2O6herCLgwnC4m49PA collected $10.45 from pot
*** SUMMARY ***
Total pot $11 | Rake $0.55
Board [Ad Ac Qd]
Seat 1: OGgaARGdJQT4awWVNQ957w (big blind) folded before Flop
Seat 2: t+Id2O6herCLgwnC4m49PA collected ($10.45)
Seat 3: DOLzOcBTZYcph5jEfKFWuQ folded before Flop (didn't bet)
Seat 4: O5Go3jrzbQWxRB6ESK+Ptg folded before Flop (didn't bet)
Seat 5: mMc/PBpqlN24gdi3C/1tOw folded before Flop (didn't bet)
Seat 6: V138SURkdX8LdVBPKdJJag folded on the Flop
Seat 7: 1862487932 folded before Flop (didn't bet)
Seat 8: bLbSOSmSOnqE0iTcH/5dxA (button) folded before Flop (didn't bet)
Seat 9: 61sfw5QTu62YYIt68OsdrA (small blind) folded before Flop



PokerStars Game #59941704124:  Hold'em No Limit ($0.50/$1.00) - 2009/07/01 1:43:31 ET
Table 'QSIig7BLMc9wY/rgBechzw' 6-max Seat #4 is the button
Seat 1: Z2fXsGcjl+Eax+RzOgwOmg ($116.45 in chips)
Seat 3: 4OO5v3AVduL0tePNx8wk5A ($125.20 in chips)
Seat 4: +uSzP8Jwnw7sKfQ4s66b7w ($74.65 in chips)
Seat 5: lsLuWlcPA3Rh7kJVLzMh0Q ($100 in chips)
lsLuWlcPA3Rh7kJVLzMh0Q: posts small blind $0.50
Z2fXsGcjl+Eax+RzOgwOmg: posts big blind $1
*** HOLE CARDS ***
w13GSGRwQhbN/aLrrRaMKw joins the table at seat #2
Wj7mKnRFR90j40wWUu2+Og leaves the table
4OO5v3AVduL0tePNx8wk5A: folds
+uSzP8Jwnw7sKfQ4s66b7w: folds
lsLuWlcPA3Rh7kJVLzMh0Q: raises $2 to $3
rHlMOfR7kpQQxe+PFQz0xQ joins the table at seat #6
Z2fXsGcjl+Eax+RzOgwOmg: raises $8 to $11
lsLuWlcPA3Rh7kJVLzMh0Q: calls $8
*** FLOP *** [5c Jc Kd]
lsLuWlcPA3Rh7kJVLzMh0Q: checks
Z2fXsGcjl+Eax+RzOgwOmg: bets $14
lsLuWlcPA3Rh7kJVLzMh0Q: raises $18 to $32
Z2fXsGcjl+Eax+RzOgwOmg: folds
lsLuWlcPA3Rh7kJVLzMh0Q collected $48 from pot
*** SUMMARY ***
Total pot $50 | Rake $2
Board [5c Jc Kd]
Seat 1: Z2fXsGcjl+Eax+RzOgwOmg (big blind) folded on the Flop
Seat 3: 4OO5v3AVduL0tePNx8wk5A folded before Flop (didn't bet)
Seat 4: +uSzP8Jwnw7sKfQ4s66b7w (button) folded before Flop (didn't bet)
Seat 5: lsLuWlcPA3Rh7kJVLzMh0Q (small blind) collected ($48)



PokerStars Game #59941703864:  Hold'em No Limit ($0.50/$1.00) - 2009/07/01 1:43:31 ET
Table 'qj0HBN4HhQKogreu1bg7xg' 2-max Seat #1 is the button
Seat 1: NYi6JFscYNrofSXy4sM+Yw ($146.10 in chips)
Seat 2: qtyl8CSb0/4yWdbuEPJejA ($130.50 in chips)
NYi6JFscYNrofSXy4sM+Yw: posts small blind $0.50
qtyl8CSb0/4yWdbuEPJejA: posts big blind $1
*** HOLE CARDS ***
NYi6JFscYNrofSXy4sM+Yw: raises $2 to $3
qtyl8CSb0/4yWdbuEPJejA: folds
NYi6JFscYNrofSXy4sM+Yw collected $2 from pot
*** SUMMARY ***
Total pot $2 | Rake $0
Seat 1: NYi6JFscYNrofSXy4sM+Yw (button) (small blind) collected ($2)
Seat 2: qtyl8CSb0/4yWdbuEPJejA (big blind) folded before Flop



PokerStars Game #59941705042:  Hold'em No Limit ($0.50/$1.00) - 2009/07/01 1:43:33 ET
Table 'W/wyObTiXZm+Ckkl3YxcSw' 6-max Seat #3 is the button
Seat 1: eUBBn2R56C1IQ6Cs/vitwg ($183.05 in chips)
Seat 2: oDiBRCaF0QVtd3kO6xZIXw ($129.65 in chips)
Seat 3: 4OO5v3AVduL0tePNx8wk5A ($100 in chips)
Seat 4: rHlMOfR7kpQQxe+PFQz0xQ ($49 in chips)
Seat 5: +OrCjyw70oZhJiD22Mn+bg ($200.50 in chips)
Seat 6: b2a+5TkFf4xJN/Ihhma58Q ($32.30 in chips)
rHlMOfR7kpQQxe+PFQz0xQ: posts small blind $0.50
+OrCjyw70oZhJiD22Mn+bg: posts big blind $1
*** HOLE CARDS ***
b2a+5TkFf4xJN/Ihhma58Q: folds
eUBBn2R56C1IQ6Cs/vitwg: folds
oDiBRCaF0QVtd3kO6xZIXw: raises $2 to $3
4OO5v3AVduL0tePNx8wk5A: folds
rHlMOfR7kpQQxe+PFQz0xQ: raises $8 to $11
+OrCjyw70oZhJiD22Mn+bg: folds
oDiBRCaF0QVtd3kO6xZIXw: raises $8 to $19
rHlMOfR7kpQQxe+PFQz0xQ: raises $15 to $34
oDiBRCaF0QVtd3kO6xZIXw: calls $15
*** FLOP *** [4s 9d 3c]
rHlMOfR7kpQQxe+PFQz0xQ: bets $15 and is all-in
oDiBRCaF0QVtd3kO6xZIXw: calls $15
*** TURN *** [4s 9d 3c] [9c]
*** RIVER *** [4s 9d 3c 9c] [2s]
*** SHOW DOWN ***
rHlMOfR7kpQQxe+PFQz0xQ: shows [Ah Ad] (two pair, Aces and Nines)
oDiBRCaF0QVtd3kO6xZIXw: mucks hand
rHlMOfR7kpQQxe+PFQz0xQ collected $96 from pot
*** SUMMARY ***
Total pot $99 | Rake $3
Board [4s 9d 3c 9c 2s]
Seat 1: eUBBn2R56C1IQ6Cs/vitwg folded before Flop (didn't bet)
Seat 2: oDiBRCaF0QVtd3kO6xZIXw mucked
Seat 3: 4OO5v3AVduL0tePNx8wk5A (button) folded before Flop (didn't bet)
Seat 4: rHlMOfR7kpQQxe+PFQz0xQ (small blind) showed [Ah Ad] and won ($96) with two pair, Aces and Nines
Seat 5: +OrCjyw70oZhJiD22Mn+bg (big blind) folded before Flop
Seat 6: b2a+5TkFf4xJN/Ihhma58Q folded before Flop (didn't bet)



PokerStars Game #59941704950:  Hold'em No Limit ($0.50/$1.00) - 2009/07/01 1:43:33 ET
Table 'ZFWj23PMihdwrNWv41OG/QtyUh+jyNvrceIQdKMJjQ2weat #2 is the button
Seat 2: 0smcry9L0OOTCP+KzIS5SA ($92 in chips)
Seat 3: cWwhvq/+r/w8nkhwrJoekQ ($54.10 in chips)
Seat 4: O5ZesE/6mHyuWWbvkiH/Fg ($73.35 in chips)
Seat 5: j7NIOHLZk7V2o9fOioO5ug ($101.70 in chips)
Seat 6: u23r4AyKPgHioZ6t7z6qrA ($100 in chips)
cWwhvq/+r/w8nkhwrJoekQ: posts small blind $0.50
O5ZesE/6mHyuWWbvkiH/Fg: posts big blind $1
rHlMOfR7kpQQxe+PFQz0xQ: sits out
*** HOLE CARDS ***
j7NIOHLZk7V2o9fOioO5ug: folds
u23r4AyKPgHioZ6t7z6qrA: raises $2 to $3
0smcry9L0OOTCP+KzIS5SA: folds
cWwhvq/+r/w8nkhwrJoekQ: folds
O5ZesE/6mHyuWWbvkiH/Fg: folds
u23r4AyKPgHioZ6t7z6qrA collected $2.50 from pot
*** SUMMARY ***
Total pot $2.50 | Rake $0
Seat 2: 0smcry9L0OOTCP+KzIS5SA (button) folded before Flop (didn't bet)
Seat 3: cWwhvq/+r/w8nkhwrJoekQ (small blind) folded before Flop
Seat 4: O5ZesE/6mHyuWWbvkiH/Fg (big blind) folded before Flop
Seat 5: j7NIOHLZk7V2o9fOioO5ug folded before Flop (didn't bet)
Seat 6: u23r4AyKPgHioZ6t7z6qrA collected ($2.50)



PokerStars Game #59941706180:  Hold'em No Limit ($0.50/$1.00) - 2009/07/01 1:43:35 ET
Table 'mmbQQVBTrPdE+wy+s+9VPA' 6-max Seat #5 is the button
Seat 1: zyP4SPoWZnKUfTvIRLCVog ($73.25 in chips)
Seat 2: XK4Qsl+DA8gAJyg85/zBIw ($38.85 in chips)
Seat 3: wx3sQGkVi2x9wJXuWNHPBw ($235.60 in chips)
Seat 4: V3iZdcw61nXF3g5hD2RrsQ ($100 in chips)
Seat 5: YMJG+F++3Aj6P8dAWda5fw ($126.70 in chips)
Seat 6: UOHYuj23MyK9R8ciY2t6FA ($100 in chips)
UOHYuj23MyK9R8ciY2t6FA: posts small blind $0.50
zyP4SPoWZnKUfTvIRLCVog: posts big blind $1
*** HOLE CARDS ***
XK4Qsl+DA8gAJyg85/zBIw: raises $3 to $4
wx3sQGkVi2x9wJXuWNHPBw: folds
V3iZdcw61nXF3g5hD2RrsQ: folds
YMJG+F++3Aj6P8dAWda5fw: folds
UOHYuj23MyK9R8ciY2t6FA: folds
zyP4SPoWZnKUfTvIRLCVog: folds
XK4Qsl+DA8gAJyg85/zBIw collected $2.50 from pot
*** SUMMARY ***
Total pot $2.50 | Rake $0
Seat 1: zyP4SPoWZnKUfTvIRLCVog (big blind) folded before Flop
Seat 2: XK4Qsl+DA8gAJyg85/zBIw collected ($2.50)
Seat 3: wx3sQGkVi2x9wJXuWNHPBw folded before Flop (didn't bet)
Seat 4: V3iZdcw61nXF3g5hD2RrsQ folded before Flop (didn't bet)
Seat 5: YMJG+F++3Aj6P8dAWda5fw (button) folded before Flop (didn't bet)
Seat 6: UOHYuj23MyK9R8ciY2t6FA (small blind) folded before Flop



PokerStars Game #59941706082:  Hold'em No Limit ($0.50/$1.00) - 2009/07/01 1:43:35 ET
Table 'rmZfTK+oSebeUPJNbWhdAA' 6-max Seat #5 is the button
Seat 1: xAU6q2/cwmby2sxmA8VcmA ($123.50 in chips)
Seat 2: z7O9PO/WEcqRouIydFhS9Q ($206.95 in chips)
Seat 3: BCEV3COoKY607AzLWayfRA ($209.70 in chips)
Seat 4: 1/mIuXfgx1ZyVkodrmfQDw ($166.85 in chips)
Seat 5: UOHYuj23MyK9R8ciY2t6FA ($100 in chips)
Seat 6: j7NIOHLZk7V2o9fOioO5ug ($101.20 in chips)
j7NIOHLZk7V2o9fOioO5ug: posts small blind $0.50
xAU6q2/cwmby2sxmA8VcmA: posts big blind $1
*** HOLE CARDS ***
z7O9PO/WEcqRouIydFhS9Q: folds
BCEV3COoKY607AzLWayfRA: folds
1/mIuXfgx1ZyVkodrmfQDw: raises $2 to $3
UOHYuj23MyK9R8ciY2t6FA: folds
j7NIOHLZk7V2o9fOioO5ug: folds
xAU6q2/cwmby2sxmA8VcmA: raises $9 to $12
1/mIuXfgx1ZyVkodrmfQDw: calls $9
*** FLOP *** [4h 2h 9h]
xAU6q2/cwmby2sxmA8VcmA: bets $17
1/mIuXfgx1ZyVkodrmfQDw: folds
xAU6q2/cwmby2sxmA8VcmA collected $23.30 from pot
xAU6q2/cwmby2sxmA8VcmA: doesn't show hand
*** SUMMARY ***
Total pot $24.50 | Rake $1.20
Board [4h 2h 9h]
Seat 1: xAU6q2/cwmby2sxmA8VcmA (big blind) collected ($23.30)
Seat 2: z7O9PO/WEcqRouIydFhS9Q folded before Flop (didn't bet)
Seat 3: BCEV3COoKY607AzLWayfRA folded before Flop (didn't bet)
Seat 4: 1/mIuXfgx1ZyVkodrmfQDw folded on the Flop
Seat 5: UOHYuj23MyK9R8ciY2t6FA (button) folded before Flop (didn't bet)
Seat 6: j7NIOHLZk7V2o9fOioO5ug (small blind) folded before Flop



PokerStars Game #59941707806:  Hold'em No Limit ($0.50/$1.00) - 2009/07/01 1:43:38 ET
Table 'N2bNCDHL96aCQDvZIh+yQQ' 6-max Seat #6 is the button
Seat 1: Jjgflx10PVjcLkziEmLhSA ($92.75 in chips)
Seat 2: y27w5IK2WXqmYzS8OU0wKA ($130.15 in chips)
Seat 4: uCqEjnxh2/vFBjKYkfTOkw ($123.30 in chips)
Seat 5: ene3nLSnQ4N961iBaUsSmA ($150.50 in chips)
Seat 6: idVgoPAdspFPCzee6aF9Pg ($105.90 in chips)
Jjgflx10PVjcLkziEmLhSA: posts small blind $0.50
y27w5IK2WXqmYzS8OU0wKA: posts big blind $1
VB7TtBnfmT3JTA/cCL6dJg: sits out
*** HOLE CARDS ***
uCqEjnxh2/vFBjKYkfTOkw: calls $1
ene3nLSnQ4N961iBaUsSmA: folds
idVgoPAdspFPCzee6aF9Pg: raises $3 to $4
Jjgflx10PVjcLkziEmLhSA: folds
y27w5IK2WXqmYzS8OU0wKA: folds
uCqEjnxh2/vFBjKYkfTOkw: calls $3
*** FLOP *** [7c 6c 8h]
uCqEjnxh2/vFBjKYkfTOkw: checks
idVgoPAdspFPCzee6aF9Pg: bets $6
uCqEjnxh2/vFBjKYkfTOkw: calls $6
*** TURN *** [7c 6c 8h] [Qh]
uCqEjnxh2/vFBjKYkfTOkw: checks
idVgoPAdspFPCzee6aF9Pg: checks
*** RIVER *** [7c 6c 8h Qh] [4d]
uCqEjnxh2/vFBjKYkfTOkw: bets $25
idVgoPAdspFPCzee6aF9Pg: calls $25
*** SHOW DOWN ***
uCqEjnxh2/vFBjKYkfTOkw: shows [5h Ah] (a straight, Four to Eight)
idVgoPAdspFPCzee6aF9Pg: mucks hand
uCqEjnxh2/vFBjKYkfTOkw collected $69.50 from pot
*** SUMMARY ***
Total pot $71.50 | Rake $2
Board [7c 6c 8h Qh 4d]
Seat 1: Jjgflx10PVjcLkziEmLhSA (small blind) folded before Flop
Seat 2: y27w5IK2WXqmYzS8OU0wKA (big blind) folded before Flop
Seat 4: uCqEjnxh2/vFBjKYkfTOkw showed [5h Ah] and won ($69.50) with a straight, Four to Eight
Seat 5: ene3nLSnQ4N961iBaUsSmA folded before Flop (didn't bet)
Seat 6: idVgoPAdspFPCzee6aF9Pg (button) mucked



PokerStars Game #59941708226:  Hold'em No Limit ($0.50/$1.00) - 2009/07/01 1:43:39 ET
Table 'qj0HBN4HhQKogreu1bg7xg' 2-max Seat #2 is the button
Seat 1: NYi6JFscYNrofSXy4sM+Yw ($147.10 in chips)
Seat 2: qtyl8CSb0/4yWdbuEPJejA ($129.50 in chips)
qtyl8CSb0/4yWdbuEPJejA: posts small blind $0.50
NYi6JFscYNrofSXy4sM+Yw: posts big blind $1
*** HOLE CARDS ***
qtyl8CSb0/4yWdbuEPJejA: raises $2 to $3
NYi6JFscYNrofSXy4sM+Yw: folds
qtyl8CSb0/4yWdbuEPJejA collected $2 from pot
qtyl8CSb0/4yWdbuEPJejA: doesn't show hand
*** SUMMARY ***
Total pot $2 | Rake $0
Seat 1: NYi6JFscYNrofSXy4sM+Yw (big blind) folded before Flop
Seat 2: qtyl8CSb0/4yWdbuEPJejA (button) (small blind) collected ($2)



PokerStars Game #59941710150:  Hold'em No Limit ($0.50/$1.00) - 2009/07/01 1:43:43 ET
Table 'blHlQApStil0OPeQxQxPcw' 9-max Seat #3 is the button
Seat 1: Pp/KTcXkfZKKUHkjyaLTdg ($30.60 in chips)
Seat 2: V138SURkdX8LdVBPKdJJag ($121.35 in chips)
Seat 3: OGgaARGdJQT4awWVNQ957w ($100 in chips)
Seat 5: uXrDE6JrIi8BZK1L8oQ9bQ ($36.10 in chips)
Seat 6: vljeiOoWscAIXU0fCuiEBw ($44.65 in chips)
Seat 7: VPF+HjszMvUIpy0CHIwH3A ($20 in chips)
Seat 9: 6XkTu4ahxzHnvjjc1R8YjQ ($151.85 in chips)
myIxN7otsyr846M539YR8Q will be allowed to play after the button
uXrDE6JrIi8BZK1L8oQ9bQ: posts small blind $0.50
vljeiOoWscAIXU0fCuiEBw: posts big blind $1
*** HOLE CARDS ***
VPF+HjszMvUIpy0CHIwH3A: folds
6XkTu4ahxzHnvjjc1R8YjQ: folds
Pp/KTcXkfZKKUHkjyaLTdg: folds
V138SURkdX8LdVBPKdJJag: folds
OGgaARGdJQT4awWVNQ957w: folds
uXrDE6JrIi8BZK1L8oQ9bQ: folds
vljeiOoWscAIXU0fCuiEBw collected $1 from pot
*** SUMMARY ***
Total pot $1 | Rake $0
Seat 1: Pp/KTcXkfZKKUHkjyaLTdg folded before Flop (didn't bet)
Seat 2: V138SURkdX8LdVBPKdJJag folded before Flop (didn't bet)
Seat 3: OGgaARGdJQT4awWVNQ957w (button) folded before Flop (didn't bet)
Seat 5: uXrDE6JrIi8BZK1L8oQ9bQ (small blind) folded before Flop
Seat 6: vljeiOoWscAIXU0fCuiEBw (big blind) collected ($1)
Seat 7: VPF+HjszMvUIpy0CHIwH3A folded before Flop (didn't bet)
Seat 9: 6XkTu4ahxzHnvjjc1R8YjQ folded before Flop (didn't bet)



PokerStars Game #59941711586:  Hold'em No Limit ($0.50/$1.00) - 2009/07/01 1:43:45 ET
Table 'MUPc8FEpe/nR0BKSeReX6Q' 6-max Seat #3 is the button
Seat 1: qhkK6+yCciTRd+rCFEbnEQ ($83.70 in chips)
Seat 2: xAU6q2/cwmby2sxmA8VcmA ($103.70 in chips)
Seat 3: wx3sQGkVi2x9wJXuWNHPBw ($286.15 in chips)
Seat 4: r4lpoh2BJZ8S6zyQv1JeSw ($109 in chips)
Seat 5: y27w5IK2WXqmYzS8OU0wKA ($131.05 in chips)
Seat 6: ene3nLSnQ4N961iBaUsSmA ($100 in chips)
r4lpoh2BJZ8S6zyQv1JeSw: posts small blind $0.50
y27w5IK2WXqmYzS8OU0wKA: posts big blind $1
*** HOLE CARDS ***
ene3nLSnQ4N961iBaUsSmA: folds
qhkK6+yCciTRd+rCFEbnEQ has timed out
qhkK6+yCciTRd+rCFEbnEQ: folds
qhkK6+yCciTRd+rCFEbnEQ is sitting out
xAU6q2/cwmby2sxmA8VcmA: folds
qhkK6+yCciTRd+rCFEbnEQ has returned
wx3sQGkVi2x9wJXuWNHPBw: folds
r4lpoh2BJZ8S6zyQv1JeSw: folds
y27w5IK2WXqmYzS8OU0wKA collected $1 from pot
y27w5IK2WXqmYzS8OU0wKA: doesn't show hand
*** SUMMARY ***
Total pot $1 | Rake $0
Seat 1: qhkK6+yCciTRd+rCFEbnEQ folded before Flop (didn't bet)
Seat 2: xAU6q2/cwmby2sxmA8VcmA folded before Flop (didn't bet)
Seat 3: wx3sQGkVi2x9wJXuWNHPBw (button) folded before Flop (didn't bet)
Seat 4: r4lpoh2BJZ8S6zyQv1JeSw (small blind) folded before Flop
Seat 5: y27w5IK2WXqmYzS8OU0wKA (big blind) collected ($1)
Seat 6: ene3nLSnQ4N961iBaUsSmA folded before Flop (didn't bet)



PokerStars Game #59941711610:  Hold'em No Limit ($0.50/$1.00) - 2009/07/01 1:43:45 ET
Table 'ZFWj23PMihdwrNWv41OG/QtyUh+jyNvrceIQdKMJjQ2weat #3 is the button
Seat 2: 0smcry9L0OOTCP+KzIS5SA ($92 in chips)
Seat 3: cWwhvq/+r/w8nkhwrJoekQ ($53.60 in chips)
Seat 4: O5ZesE/6mHyuWWbvkiH/Fg ($72.35 in chips)
Seat 5: j7NIOHLZk7V2o9fOioO5ug ($101.70 in chips)
Seat 6: u23r4AyKPgHioZ6t7z6qrA ($101.50 in chips)
O5ZesE/6mHyuWWbvkiH/Fg: posts small blind $0.50
j7NIOHLZk7V2o9fOioO5ug: posts big blind $1
rHlMOfR7kpQQxe+PFQz0xQ: sits out
*** HOLE CARDS ***
u23r4AyKPgHioZ6t7z6qrA: raises $2 to $3
0smcry9L0OOTCP+KzIS5SA: folds
cWwhvq/+r/w8nkhwrJoekQ: folds
O5ZesE/6mHyuWWbvkiH/Fg: folds
j7NIOHLZk7V2o9fOioO5ug: folds
u23r4AyKPgHioZ6t7z6qrA collected $2.50 from pot
*** SUMMARY ***
Total pot $2.50 | Rake $0
Seat 2: 0smcry9L0OOTCP+KzIS5SA folded before Flop (didn't bet)
Seat 3: cWwhvq/+r/w8nkhwrJoekQ (button) folded before Flop (didn't bet)
Seat 4: O5ZesE/6mHyuWWbvkiH/Fg (small blind) folded before Flop
Seat 5: j7NIOHLZk7V2o9fOioO5ug (big blind) folded before Flop
Seat 6: u23r4AyKPgHioZ6t7z6qrA collected ($2.50)



PokerStars Game #59941712122:  Hold'em No Limit ($0.50/$1.00) - 2009/07/01 1:43:46 ET
Table 'qj0HBN4HhQKogreu1bg7xg' 2-max Seat #1 is the button
Seat 1: NYi6JFscYNrofSXy4sM+Yw ($146.10 in chips)
Seat 2: qtyl8CSb0/4yWdbuEPJejA ($130.50 in chips)
NYi6JFscYNrofSXy4sM+Yw: posts small blind $0.50
qtyl8CSb0/4yWdbuEPJejA: posts big blind $1
*** HOLE CARDS ***
NYi6JFscYNrofSXy4sM+Yw: raises $2 to $3
qtyl8CSb0/4yWdbuEPJejA: folds
NYi6JFscYNrofSXy4sM+Yw collected $2 from pot
NYi6JFscYNrofSXy4sM+Yw: doesn't show hand
*** SUMMARY ***
Total pot $2 | Rake $0
Seat 1: NYi6JFscYNrofSXy4sM+Yw (button) (small blind) collected ($2)
Seat 2: qtyl8CSb0/4yWdbuEPJejA (big blind) folded before Flop



PokerStars Game #59941712862:  Hold'em No Limit ($0.50/$1.00) - 2009/07/01 1:43:48 ET
Table '/RZcOwpZpHQ+OwPwjsbnRw' 6-max Seat #6 is the button
Seat 1: +uSzP8Jwnw7sKfQ4s66b7w ($87.90 in chips)
Seat 2: Z2fXsGcjl+Eax+RzOgwOmg ($104.15 in chips)
Seat 3: LJMw/I77xpnw0R5T4HnMUg ($106.55 in chips)
Seat 4: j7NIOHLZk7V2o9fOioO5ug ($113.20 in chips)
Seat 5: wx3sQGkVi2x9wJXuWNHPBw ($167.25 in chips)
Seat 6: o3YLm/rSY916m/on1VjXPA ($202.50 in chips)
+uSzP8Jwnw7sKfQ4s66b7w: posts small blind $0.50
Z2fXsGcjl+Eax+RzOgwOmg: posts big blind $1
*** HOLE CARDS ***
LJMw/I77xpnw0R5T4HnMUg: folds
j7NIOHLZk7V2o9fOioO5ug: folds
wx3sQGkVi2x9wJXuWNHPBw: folds
o3YLm/rSY916m/on1VjXPA: raises $2 to $3
+uSzP8Jwnw7sKfQ4s66b7w: folds
Z2fXsGcjl+Eax+RzOgwOmg: folds
o3YLm/rSY916m/on1VjXPA collected $2.50 from pot
o3YLm/rSY916m/on1VjXPA: doesn't show hand
*** SUMMARY ***
Total pot $2.50 | Rake $0
Seat 1: +uSzP8Jwnw7sKfQ4s66b7w (small blind) folded before Flop
Seat 2: Z2fXsGcjl+Eax+RzOgwOmg (big blind) folded before Flop
Seat 3: LJMw/I77xpnw0R5T4HnMUg folded before Flop (didn't bet)
Seat 4: j7NIOHLZk7V2o9fOioO5ug folded before Flop (didn't bet)
Seat 5: wx3sQGkVi2x9wJXuWNHPBw folded before Flop (didn't bet)
Seat 6: o3YLm/rSY916m/on1VjXPA (button) collected ($2.50)



PokerStars Game #59941714224:  Hold'em No Limit ($0.50/$1.00) - 2009/07/01 1:43:50 ET
Table 'vs/5jr6ciwjVQ5+Soc+u2A' 6-max Seat #5 is the button
Seat 1: J798qwLuvXyq0BbzsIjOrA ($224.50 in chips)
Seat 2: lXX4W7m3u++JiSOZ46yVMQ ($98.50 in chips)
Seat 3: Ws/3Uo3rQIk8hLgW0P+2xA ($95.90 in chips)
Seat 4: 0smcry9L0OOTCP+KzIS5SA ($88 in chips)
Seat 5: +Nt3OPk3XR9SKjZgm2CexQ ($131.35 in chips)
Seat 6: Z2fXsGcjl+Eax+RzOgwOmg ($123 in chips)
Z2fXsGcjl+Eax+RzOgwOmg: posts small blind $0.50
J798qwLuvXyq0BbzsIjOrA: posts big blind $1
*** HOLE CARDS ***
lXX4W7m3u++JiSOZ46yVMQ: raises $2 to $3
Ws/3Uo3rQIk8hLgW0P+2xA: folds
0smcry9L0OOTCP+KzIS5SA: folds
+Nt3OPk3XR9SKjZgm2CexQ: folds
Z2fXsGcjl+Eax+RzOgwOmg: folds
J798qwLuvXyq0BbzsIjOrA: folds
lXX4W7m3u++JiSOZ46yVMQ collected $2.50 from pot
*** SUMMARY ***
Total pot $2.50 | Rake $0
Seat 1: J798qwLuvXyq0BbzsIjOrA (big blind) folded before Flop
Seat 2: lXX4W7m3u++JiSOZ46yVMQ collected ($2.50)
Seat 3: Ws/3Uo3rQIk8hLgW0P+2xA folded before Flop (didn't bet)
Seat 4: 0smcry9L0OOTCP+KzIS5SA folded before Flop (didn't bet)
Seat 5: +Nt3OPk3XR9SKjZgm2CexQ (button) folded before Flop (didn't bet)
Seat 6: Z2fXsGcjl+Eax+RzOgwOmg (small blind) folded before Flop



PokerStars Game #59941715718:  Hold'em No Limit ($0.50/$1.00) - 2009/07/01 1:43:53 ET
Table 'pHrhryH8jPNdQfY62f8v+g' 6-max Seat #5 is the button
Seat 1: 4d1rWhpu8DzLmzMbR3QKyA ($147.45 in chips)
Seat 2: JwCcjZl0bjJzG7hmE0dnTA ($119.10 in chips)
Seat 3: 8oS5O7iD/qnFXFXJrGIgNQ ($116.90 in chips)
Seat 4: 1f3beyIML24UqEMTbWy93g ($43.85 in chips)
Seat 5: d8WX+9nUHoqlrAGagO0Wow ($18.50 in chips)
Seat 6: xAU6q2/cwmby2sxmA8VcmA ($198.30 in chips)
xAU6q2/cwmby2sxmA8VcmA: posts small blind $0.50
4d1rWhpu8DzLmzMbR3QKyA: posts big blind $1
*** HOLE CARDS ***
JwCcjZl0bjJzG7hmE0dnTA: folds
8oS5O7iD/qnFXFXJrGIgNQ: folds
1f3beyIML24UqEMTbWy93g: folds
d8WX+9nUHoqlrAGagO0Wow: folds
xAU6q2/cwmby2sxmA8VcmA: folds
4d1rWhpu8DzLmzMbR3QKyA collected $1 from pot
*** SUMMARY ***
Total pot $1 | Rake $0
Seat 1: 4d1rWhpu8DzLmzMbR3QKyA (big blind) collected ($1)
Seat 2: JwCcjZl0bjJzG7hmE0dnTA folded before Flop (didn't bet)
Seat 3: 8oS5O7iD/qnFXFXJrGIgNQ folded before Flop (didn't bet)
Seat 4: 1f3beyIML24UqEMTbWy93g folded before Flop (didn't bet)
Seat 5: d8WX+9nUHoqlrAGagO0Wow (button) folded before Flop (didn't bet)
Seat 6: xAU6q2/cwmby2sxmA8VcmA (small blind) folded before Flop



PokerStars Game #59941715928:  Hold'em No Limit ($0.50/$1.00) - 2009/07/01 1:43:54 ET
Table 'qj0HBN4HhQKogreu1bg7xg' 2-max Seat #2 is the button
Seat 1: NYi6JFscYNrofSXy4sM+Yw ($147.10 in chips)
Seat 2: qtyl8CSb0/4yWdbuEPJejA ($129.50 in chips)
qtyl8CSb0/4yWdbuEPJejA: posts small blind $0.50
NYi6JFscYNrofSXy4sM+Yw: posts big blind $1
*** HOLE CARDS ***
qtyl8CSb0/4yWdbuEPJejA: raises $2 to $3
NYi6JFscYNrofSXy4sM+Yw: folds
qtyl8CSb0/4yWdbuEPJejA collected $2 from pot
qtyl8CSb0/4yWdbuEPJejA: doesn't show hand
*** SUMMARY ***
Total pot $2 | Rake $0
Seat 1: NYi6JFscYNrofSXy4sM+Yw (big blind) folded before Flop
Seat 2: qtyl8CSb0/4yWdbuEPJejA (button) (small blind) collected ($2)



PokerStars Game #59941717334:  Hold'em No Limit ($0.50/$1.00) - 2009/07/01 1:43:56 ET
Table '+cA8mcmhaedZ7YcrDdhmeQ' 6-max Seat #1 is the button
Seat 1: VB7TtBnfmT3JTA/cCL6dJg ($100 in chips)
Seat 2: 14aYclSc98EYd6TrzN2l3Q ($87.80 in chips)
Seat 3: DAIgyIWbYvAkL6PbAI27pg ($18.50 in chips)
Seat 4: 4OO5v3AVduL0tePNx8wk5A ($108.20 in chips)
Seat 5: SJieaES+gCAfonfNNMCP6w ($100 in chips)
14aYclSc98EYd6TrzN2l3Q: posts small blind $0.50
DAIgyIWbYvAkL6PbAI27pg: posts big blind $1
*** HOLE CARDS ***
4OO5v3AVduL0tePNx8wk5A: folds
SJieaES+gCAfonfNNMCP6w: folds
VB7TtBnfmT3JTA/cCL6dJg: folds
14aYclSc98EYd6TrzN2l3Q: raises $1 to $2
DAIgyIWbYvAkL6PbAI27pg: folds
14aYclSc98EYd6TrzN2l3Q collected $2 from pot
*** SUMMARY ***
Total pot $2 | Rake $0
Seat 1: VB7TtBnfmT3JTA/cCL6dJg (button) folded before Flop (didn't bet)
Seat 2: 14aYclSc98EYd6TrzN2l3Q (small blind) collected ($2)
Seat 3: DAIgyIWbYvAkL6PbAI27pg (big blind) folded before Flop
Seat 4: 4OO5v3AVduL0tePNx8wk5A folded before Flop (didn't bet)
Seat 5: SJieaES+gCAfonfNNMCP6w folded before Flop (didn't bet)



PokerStars Game #59941718220:  Hold'em No Limit ($0.50/$1.00) - 2009/07/01 1:43:58 ET
Table 'ZFWj23PMihdwrNWv41OG/QtyUh+jyNvrceIQdKMJjQ2weat #4 is the button
Seat 2: 0smcry9L0OOTCP+KzIS5SA ($92 in chips)
Seat 3: cWwhvq/+r/w8nkhwrJoekQ ($53.60 in chips)
Seat 4: O5ZesE/6mHyuWWbvkiH/Fg ($71.85 in chips)
Seat 5: j7NIOHLZk7V2o9fOioO5ug ($100.70 in chips)
Seat 6: u23r4AyKPgHioZ6t7z6qrA ($103 in chips)
j7NIOHLZk7V2o9fOioO5ug: posts small blind $0.50
u23r4AyKPgHioZ6t7z6qrA: posts big blind $1
rHlMOfR7kpQQxe+PFQz0xQ: sits out
*** HOLE CARDS ***
0smcry9L0OOTCP+KzIS5SA: folds
cWwhvq/+r/w8nkhwrJoekQ: calls $1
O5ZesE/6mHyuWWbvkiH/Fg: folds
j7NIOHLZk7V2o9fOioO5ug: calls $0.50
u23r4AyKPgHioZ6t7z6qrA: checks
*** FLOP *** [Kc 9c Qs]
j7NIOHLZk7V2o9fOioO5ug: checks
u23r4AyKPgHioZ6t7z6qrA: bets $1
cWwhvq/+r/w8nkhwrJoekQ: raises $2 to $3
j7NIOHLZk7V2o9fOioO5ug: folds
u23r4AyKPgHioZ6t7z6qrA: calls $2
*** TURN *** [Kc 9c Qs] [5s]
u23r4AyKPgHioZ6t7z6qrA: checks
cWwhvq/+r/w8nkhwrJoekQ: bets $10
u23r4AyKPgHioZ6t7z6qrA: calls $10
*** RIVER *** [Kc 9c Qs 5s] [6s]
u23r4AyKPgHioZ6t7z6qrA: checks
cWwhvq/+r/w8nkhwrJoekQ: checks
*** SHOW DOWN ***
u23r4AyKPgHioZ6t7z6qrA: shows [4c 7c] (high card King)
cWwhvq/+r/w8nkhwrJoekQ: shows [As Kh] (a pair of Kings)
cWwhvq/+r/w8nkhwrJoekQ collected $27.60 from pot
*** SUMMARY ***
Total pot $29 | Rake $1.40
Board [Kc 9c Qs 5s 6s]
Seat 2: 0smcry9L0OOTCP+KzIS5SA folded before Flop (didn't bet)
Seat 3: cWwhvq/+r/w8nkhwrJoekQ showed [As Kh] and won ($27.60) with a pair of Kings
Seat 4: O5ZesE/6mHyuWWbvkiH/Fg (button) folded before Flop (didn't bet)
Seat 5: j7NIOHLZk7V2o9fOioO5ug (small blind) folded on the Flop
Seat 6: u23r4AyKPgHioZ6t7z6qrA (big blind) showed [4c 7c] and lost with high card King



PokerStars Game #59941719696:  Hold'em No Limit ($0.50/$1.00) - 2009/07/01 1:44:00 ET
Table 'qj0HBN4HhQKogreu1bg7xg' 2-max Seat #1 is the button
Seat 1: NYi6JFscYNrofSXy4sM+Yw ($146.10 in chips)
Seat 2: qtyl8CSb0/4yWdbuEPJejA ($130.50 in chips)
NYi6JFscYNrofSXy4sM+Yw: posts small blind $0.50
qtyl8CSb0/4yWdbuEPJejA: posts big blind $1
*** HOLE CARDS ***
NYi6JFscYNrofSXy4sM+Yw: raises $2 to $3
qtyl8CSb0/4yWdbuEPJejA: folds
NYi6JFscYNrofSXy4sM+Yw collected $2 from pot
NYi6JFscYNrofSXy4sM+Yw: doesn't show hand
*** SUMMARY ***
Total pot $2 | Rake $0
Seat 1: NYi6JFscYNrofSXy4sM+Yw (button) (small blind) collected ($2)
Seat 2: qtyl8CSb0/4yWdbuEPJejA (big blind) folded before Flop



PokerStars Game #59941720196:  Hold'em No Limit ($0.50/$1.00) - 2009/07/01 1:44:01 ET
Table '/FUb199IViHMJHi5YWmeuQ' 9-max Seat #5 is the button
Seat 1: sa/cZBFh73L9TapFXpn3BA ($80.60 in chips)
Seat 2: FL3MrLspcF23LYvC4ipBOA ($179.55 in chips)
Seat 3: V138SURkdX8LdVBPKdJJag ($100 in chips)
Seat 5: 1862487932 ($102 in chips)
Seat 6: sEsscZZxcJ47/dgWBiUH9g ($75.40 in chips)
Seat 7: aM6BB+PnB/rDUr2dbRda+A ($102.75 in chips)
Seat 8: 997ViqAtWn1FPjJqcffwcA ($100 in chips)
Seat 9: xbnULiMJm4tqqOlOMoxRHw ($76.30 in chips)
sEsscZZxcJ47/dgWBiUH9g: posts small blind $0.50
aM6BB+PnB/rDUr2dbRda+A: posts big blind $1
*** HOLE CARDS ***
997ViqAtWn1FPjJqcffwcA: folds
997ViqAtWn1FPjJqcffwcA leaves the table
xbnULiMJm4tqqOlOMoxRHw: calls $1
MikeB_099 joins the table at seat #4
sa/cZBFh73L9TapFXpn3BA: raises $1 to $2
FL3MrLspcF23LYvC4ipBOA: raises $7 to $9
V138SURkdX8LdVBPKdJJag: folds
1862487932: folds
sEsscZZxcJ47/dgWBiUH9g: folds
aM6BB+PnB/rDUr2dbRda+A: folds
xbnULiMJm4tqqOlOMoxRHw: calls $8
sa/cZBFh73L9TapFXpn3BA: raises $71.60 to $80.60 and is all-in
FL3MrLspcF23LYvC4ipBOA: calls $71.60
xbnULiMJm4tqqOlOMoxRHw: folds
*** FLOP *** [Qd 6s 6d]
*** TURN *** [Qd 6s 6d] [Ac]
*** RIVER *** [Qd 6s 6d Ac] [5c]
*** SHOW DOWN ***
sa/cZBFh73L9TapFXpn3BA: shows [Ad Kd] (two pair, Aces and Sixes)
FL3MrLspcF23LYvC4ipBOA: shows [Ks As] (two pair, Aces and Sixes)
sa/cZBFh73L9TapFXpn3BA collected $84.35 from pot
FL3MrLspcF23LYvC4ipBOA collected $84.35 from pot
*** SUMMARY ***
Total pot $171.70 | Rake $3
Board [Qd 6s 6d Ac 5c]
Seat 1: sa/cZBFh73L9TapFXpn3BA showed [Ad Kd] and won ($84.35) with two pair, Aces and Sixes
Seat 2: FL3MrLspcF23LYvC4ipBOA showed [Ks As] and won ($84.35) with two pair, Aces and Sixes
Seat 3: V138SURkdX8LdVBPKdJJag folded before Flop (didn't bet)
Seat 5: 1862487932 (button) folded before Flop (didn't bet)
Seat 6: sEsscZZxcJ47/dgWBiUH9g (small blind) folded before Flop
Seat 7: aM6BB+PnB/rDUr2dbRda+A (big blind) folded before Flop
Seat 8: 997ViqAtWn1FPjJqcffwcA folded before Flop (didn't bet)
Seat 9: xbnULiMJm4tqqOlOMoxRHw folded before Flop



PokerStars Game #59941721014:  Hold'em No Limit ($0.50/$1.00) - 2009/07/01 1:44:03 ET
Table 'mmbQQVBTrPdE+wy+s+9VPA' 6-max Seat #6 is the button
Seat 1: zyP4SPoWZnKUfTvIRLCVog ($72.25 in chips)
Seat 2: XK4Qsl+DA8gAJyg85/zBIw ($40.35 in chips)
Seat 3: wx3sQGkVi2x9wJXuWNHPBw ($235.60 in chips)
Seat 4: V3iZdcw61nXF3g5hD2RrsQ ($100 in chips)
Seat 5: YMJG+F++3Aj6P8dAWda5fw ($126.70 in chips)
Seat 6: UOHYuj23MyK9R8ciY2t6FA ($100 in chips)
zyP4SPoWZnKUfTvIRLCVog: posts small blind $0.50
XK4Qsl+DA8gAJyg85/zBIw: posts big blind $1
*** HOLE CARDS ***
wx3sQGkVi2x9wJXuWNHPBw: folds
V3iZdcw61nXF3g5hD2RrsQ: folds
YMJG+F++3Aj6P8dAWda5fw: folds
UOHYuj23MyK9R8ciY2t6FA: folds
zyP4SPoWZnKUfTvIRLCVog: calls $0.50
XK4Qsl+DA8gAJyg85/zBIw: checks
*** FLOP *** [Tc Ac 7d]
zyP4SPoWZnKUfTvIRLCVog: checks
XK4Qsl+DA8gAJyg85/zBIw: checks
*** TURN *** [Tc Ac 7d] [2c]
zyP4SPoWZnKUfTvIRLCVog: checks
XK4Qsl+DA8gAJyg85/zBIw: bets $2
zyP4SPoWZnKUfTvIRLCVog: folds
XK4Qsl+DA8gAJyg85/zBIw collected $1.90 from pot
*** SUMMARY ***
Total pot $2 | Rake $0.10
Board [Tc Ac 7d 2c]
Seat 1: zyP4SPoWZnKUfTvIRLCVog (small blind) folded on the Turn
Seat 2: XK4Qsl+DA8gAJyg85/zBIw (big blind) collected ($1.90)
Seat 3: wx3sQGkVi2x9wJXuWNHPBw folded before Flop (didn't bet)
Seat 4: V3iZdcw61nXF3g5hD2RrsQ folded before Flop (didn't bet)
Seat 5: YMJG+F++3Aj6P8dAWda5fw folded before Flop (didn't bet)
Seat 6: UOHYuj23MyK9R8ciY2t6FA (button) folded before Flop (didn't bet)



PokerStars Game #59941722408:  Hold'em No Limit ($0.50/$1.00) - 2009/07/01 1:44:05 ET
Table 'VOs36P6NW+QyXeQ1B62kmAE9S5sEoK9Q3olj2a53gABASeat #3 is the button
Seat 1: 4h8XtuVJtWh3DJpxGo7k5Q ($25.95 in chips)
Seat 2: y27w5IK2WXqmYzS8OU0wKA ($145.65 in chips)
Seat 3: p00KmyZiD/isPc/lZwNBTg ($14.25 in chips)
Seat 4: ene3nLSnQ4N961iBaUsSmA ($100 in chips)
Seat 5: o3YLm/rSY916m/on1VjXPA ($134.60 in chips)
Seat 6: slVKuQyEz8Qj4E3uLPYNXg ($50.25 in chips)
ene3nLSnQ4N961iBaUsSmA: posts small blind $0.50
o3YLm/rSY916m/on1VjXPA: posts big blind $1
*** HOLE CARDS ***
slVKuQyEz8Qj4E3uLPYNXg: folds
4h8XtuVJtWh3DJpxGo7k5Q: folds
y27w5IK2WXqmYzS8OU0wKA: raises $2 to $3
p00KmyZiD/isPc/lZwNBTg: calls $3
ene3nLSnQ4N961iBaUsSmA: folds
o3YLm/rSY916m/on1VjXPA: folds
*** FLOP *** [5c 7c 8d]
y27w5IK2WXqmYzS8OU0wKA: bets $3
p00KmyZiD/isPc/lZwNBTg: calls $3
*** TURN *** [5c 7c 8d] [Kd]
y27w5IK2WXqmYzS8OU0wKA: bets $69
p00KmyZiD/isPc/lZwNBTg: folds
y27w5IK2WXqmYzS8OU0wKA collected $12.85 from pot
y27w5IK2WXqmYzS8OU0wKA: doesn't show hand
*** SUMMARY ***
Total pot $13.50 | Rake $0.65
Board [5c 7c 8d Kd]
Seat 1: 4h8XtuVJtWh3DJpxGo7k5Q folded before Flop (didn't bet)
Seat 2: y27w5IK2WXqmYzS8OU0wKA collected ($12.85)
Seat 3: p00KmyZiD/isPc/lZwNBTg (button) folded on the Turn
Seat 4: ene3nLSnQ4N961iBaUsSmA (small blind) folded before Flop
Seat 5: o3YLm/rSY916m/on1VjXPA (big blind) folded before Flop
Seat 6: slVKuQyEz8Qj4E3uLPYNXg folded before Flop (didn't bet)



PokerStars Game #59941722214:  Hold'em No Limit ($0.50/$1.00) - 2009/07/01 1:44:05 ET
Table 'DvFb+QVx+4Mvu7tghrGtVg' 6-max Seat #1 is the button
Seat 1: 1ifNpObXxyEaiFAVxWBVNQ ($145.20 in chips)
Seat 2: YMJG+F++3Aj6P8dAWda5fw ($100.50 in chips)
Seat 3: TSuRyAHnUPCFjP7Z0rEE0w ($100 in chips)
Seat 4: hpxXcmRkXXI9HE5+5/j/0Q ($105.90 in chips)
Seat 5: V3iZdcw61nXF3g5hD2RrsQ ($110 in chips)
Seat 6: y27w5IK2WXqmYzS8OU0wKA ($187.50 in chips)
YMJG+F++3Aj6P8dAWda5fw: posts small blind $0.50
TSuRyAHnUPCFjP7Z0rEE0w: posts big blind $1
*** HOLE CARDS ***
hpxXcmRkXXI9HE5+5/j/0Q: folds
V3iZdcw61nXF3g5hD2RrsQ: folds
y27w5IK2WXqmYzS8OU0wKA: folds
1ifNpObXxyEaiFAVxWBVNQ: folds
YMJG+F++3Aj6P8dAWda5fw: raises $2 to $3
TSuRyAHnUPCFjP7Z0rEE0w: folds
YMJG+F++3Aj6P8dAWda5fw collected $2 from pot
*** SUMMARY ***
Total pot $2 | Rake $0
Seat 1: 1ifNpObXxyEaiFAVxWBVNQ (button) folded before Flop (didn't bet)
Seat 2: YMJG+F++3Aj6P8dAWda5fw (small blind) collected ($2)
Seat 3: TSuRyAHnUPCFjP7Z0rEE0w (big blind) folded before Flop
Seat 4: hpxXcmRkXXI9HE5+5/j/0Q folded before Flop (didn't bet)
Seat 5: V3iZdcw61nXF3g5hD2RrsQ folded before Flop (didn't bet)
Seat 6: y27w5IK2WXqmYzS8OU0wKA folded before Flop (didn't bet)



PokerStars Game #59941723332:  Hold'em No Limit ($0.50/$1.00) - 2009/07/01 1:44:07 ET
Table 'qj0HBN4HhQKogreu1bg7xg' 2-max Seat #2 is the button
Seat 1: NYi6JFscYNrofSXy4sM+Yw ($147.10 in chips)
Seat 2: qtyl8CSb0/4yWdbuEPJejA ($129.50 in chips)
qtyl8CSb0/4yWdbuEPJejA: posts small blind $0.50
NYi6JFscYNrofSXy4sM+Yw: posts big blind $1
*** HOLE CARDS ***
qtyl8CSb0/4yWdbuEPJejA: raises $2 to $3
NYi6JFscYNrofSXy4sM+Yw: calls $2
*** FLOP *** [3h 8h Qs]
NYi6JFscYNrofSXy4sM+Yw: checks
qtyl8CSb0/4yWdbuEPJejA: bets $5
NYi6JFscYNrofSXy4sM+Yw: folds
qtyl8CSb0/4yWdbuEPJejA collected $5.70 from pot
qtyl8CSb0/4yWdbuEPJejA: doesn't show hand
*** SUMMARY ***
Total pot $6 | Rake $0.30
Board [3h 8h Qs]
Seat 1: NYi6JFscYNrofSXy4sM+Yw (big blind) folded on the Flop
Seat 2: qtyl8CSb0/4yWdbuEPJejA (button) (small blind) collected ($5.70)



PokerStars Game #59941724328:  Hold'em No Limit ($0.50/$1.00) - 2009/07/01 1:44:09 ET
Table 'b8oW/dOL7fDza5DfZ/dOJQ' 6-max Seat #5 is the button
Seat 1: NakujTNjHFgzceydFf+E2Q ($53.40 in chips)
Seat 2: TSuRyAHnUPCFjP7Z0rEE0w ($117.50 in chips)
Seat 3: d8WX+9nUHoqlrAGagO0Wow ($32.80 in chips)
Seat 4: 8rDbzImSi1zgxtqtF1pSbA ($10 in chips)
Seat 5: sr/OkkgqNbtgwJf1tmnfNg ($62.75 in chips)
Seat 6: PvfYaKbzMpsmUcbOExckbQ ($157.85 in chips)
PvfYaKbzMpsmUcbOExckbQ: posts small blind $0.50
NakujTNjHFgzceydFf+E2Q: posts big blind $1
*** HOLE CARDS ***
TSuRyAHnUPCFjP7Z0rEE0w: folds
d8WX+9nUHoqlrAGagO0Wow: folds
8rDbzImSi1zgxtqtF1pSbA: folds
sr/OkkgqNbtgwJf1tmnfNg: folds
PvfYaKbzMpsmUcbOExckbQ: raises $2 to $3
NakujTNjHFgzceydFf+E2Q: calls $2
*** FLOP *** [5h Qh 8h]
PvfYaKbzMpsmUcbOExckbQ: bets $4
NakujTNjHFgzceydFf+E2Q: folds
PvfYaKbzMpsmUcbOExckbQ collected $5.70 from pot
PvfYaKbzMpsmUcbOExckbQ: doesn't show hand
*** SUMMARY ***
Total pot $6 | Rake $0.30
Board [5h Qh 8h]
Seat 1: NakujTNjHFgzceydFf+E2Q (big blind) folded on the Flop
Seat 2: TSuRyAHnUPCFjP7Z0rEE0w folded before Flop (didn't bet)
Seat 3: d8WX+9nUHoqlrAGagO0Wow folded before Flop (didn't bet)
Seat 4: 8rDbzImSi1zgxtqtF1pSbA folded before Flop (didn't bet)
Seat 5: sr/OkkgqNbtgwJf1tmnfNg (button) folded before Flop (didn't bet)
Seat 6: PvfYaKbzMpsmUcbOExckbQ (small blind) collected ($5.70)



PokerStars Game #59941724704:  Hold'em No Limit ($0.50/$1.00) - 2009/07/01 1:44:10 ET
Table 'hugOjcwJvzEwZbK7tyiWuQ' 9-max Seat #4 is the button
Seat 1: S3Ex8K7v6xm5jqjRM7Fl3w ($21.35 in chips)
Seat 2: r27C1nIV4NS4+qbnrgBQSw ($276.60 in chips)
Seat 3: c/6hFCyfLNRn3VFvCeQ1ng ($31.55 in chips)
Seat 4: UWB3oeddt/GObx2Mix2Anw ($194.75 in chips)
Seat 6: gUUvmqdVlmvpal6B8nYrmg ($102.95 in chips)
Seat 7: FL3MrLspcF23LYvC4ipBOA ($109.80 in chips)
Seat 8: /zy+DB4S5fUQUSfZWFzYGw ($121.55 in chips)
Seat 9: W8P9bUKCs43TO1xHm0dL6w ($105.30 in chips)
aM6BB+PnB/rDUr2dbRda+A will be allowed to play after the button
gUUvmqdVlmvpal6B8nYrmg: posts small blind $0.50
FL3MrLspcF23LYvC4ipBOA: posts big blind $1
*** HOLE CARDS ***
/zy+DB4S5fUQUSfZWFzYGw: folds
W8P9bUKCs43TO1xHm0dL6w: folds
S3Ex8K7v6xm5jqjRM7Fl3w: folds
r27C1nIV4NS4+qbnrgBQSw: raises $2 to $3
c/6hFCyfLNRn3VFvCeQ1ng: folds
UWB3oeddt/GObx2Mix2Anw: folds
gUUvmqdVlmvpal6B8nYrmg: folds
FL3MrLspcF23LYvC4ipBOA: folds
r27C1nIV4NS4+qbnrgBQSw collected $2.50 from pot
*** SUMMARY ***
Total pot $2.50 | Rake $0
Seat 1: S3Ex8K7v6xm5jqjRM7Fl3w folded before Flop (didn't bet)
Seat 2: r27C1nIV4NS4+qbnrgBQSw collected ($2.50)
Seat 3: c/6hFCyfLNRn3VFvCeQ1ng folded before Flop (didn't bet)
Seat 4: UWB3oeddt/GObx2Mix2Anw (button) folded before Flop (didn't bet)
Seat 6: gUUvmqdVlmvpal6B8nYrmg (small blind) folded before Flop
Seat 7: FL3MrLspcF23LYvC4ipBOA (big blind) folded before Flop
Seat 8: /zy+DB4S5fUQUSfZWFzYGw folded before Flop (didn't bet)
Seat 9: W8P9bUKCs43TO1xHm0dL6w folded before Flop (didn't bet)



PokerStars Game #59941725394:  Hold'em No Limit ($0.50/$1.00) - 2009/07/01 1:44:11 ET
Table 'fZjVbKj9D8yOB+Rj7NaP/A' 9-max Seat #6 is the button
Seat 2: PTAFYDIUSsG+SArbxNl+Aw ($112 in chips)
Seat 3: yAbu2QsRPVcjPbqlf/jDxw ($100 in chips)
Seat 4: likAqWsWycNGwDQIcHN6GA ($99 in chips)
Seat 5: PkGfq5xrSlNsujKaG/HF4Q ($100 in chips)
Seat 6: OvwYHV65yUbgdBjSmo1+5g ($144.65 in chips)
Seat 7: SyS20PAm3RpT6uLBsGkwOA ($105.70 in chips)
Seat 8: EVvb0huXeMB7dnOAiO4ggA ($48.50 in chips)
Seat 9: qheQay5YvP2DMAb3OUSxtw ($143.60 in chips)
SyS20PAm3RpT6uLBsGkwOA: posts small blind $0.50
EVvb0huXeMB7dnOAiO4ggA: posts big blind $1
kiakSwxX0e64PwYGAPQvLw: sits out
*** HOLE CARDS ***
qheQay5YvP2DMAb3OUSxtw: folds
PTAFYDIUSsG+SArbxNl+Aw: folds
yAbu2QsRPVcjPbqlf/jDxw: folds
likAqWsWycNGwDQIcHN6GA: folds
PkGfq5xrSlNsujKaG/HF4Q: folds
OvwYHV65yUbgdBjSmo1+5g: raises $1 to $2
SyS20PAm3RpT6uLBsGkwOA: folds
EVvb0huXeMB7dnOAiO4ggA: calls $1
*** FLOP *** [8s 8h Jd]
EVvb0huXeMB7dnOAiO4ggA: checks
OvwYHV65yUbgdBjSmo1+5g: bets $4
EVvb0huXeMB7dnOAiO4ggA: folds
OvwYHV65yUbgdBjSmo1+5g collected $4.30 from pot
*** SUMMARY ***
Total pot $4.50 | Rake $0.20
Board [8s 8h Jd]
Seat 2: PTAFYDIUSsG+SArbxNl+Aw folded before Flop (didn't bet)
Seat 3: yAbu2QsRPVcjPbqlf/jDxw folded before Flop (didn't bet)
Seat 4: likAqWsWycNGwDQIcHN6GA folded before Flop (didn't bet)
Seat 5: PkGfq5xrSlNsujKaG/HF4Q folded before Flop (didn't bet)
Seat 6: OvwYHV65yUbgdBjSmo1+5g (button) collected ($4.30)
Seat 7: SyS20PAm3RpT6uLBsGkwOA (small blind) folded before Flop
Seat 8: EVvb0huXeMB7dnOAiO4ggA (big blind) folded on the Flop
Seat 9: qheQay5YvP2DMAb3OUSxtw folded before Flop (didn't bet)



PokerStars Game #59941726498:  Hold'em No Limit ($0.50/$1.00) - 2009/07/01 1:44:13 ET
Table 'pHrhryH8jPNdQfY62f8v+g' 6-max Seat #6 is the button
Seat 1: 4d1rWhpu8DzLmzMbR3QKyA ($147.95 in chips)
Seat 2: JwCcjZl0bjJzG7hmE0dnTA ($119.10 in chips)
Seat 3: 8oS5O7iD/qnFXFXJrGIgNQ ($116.90 in chips)
Seat 4: 1f3beyIML24UqEMTbWy93g ($43.85 in chips)
Seat 5: d8WX+9nUHoqlrAGagO0Wow ($18.50 in chips)
Seat 6: xAU6q2/cwmby2sxmA8VcmA ($197.80 in chips)
4d1rWhpu8DzLmzMbR3QKyA: posts small blind $0.50
JwCcjZl0bjJzG7hmE0dnTA: posts big blind $1
*** HOLE CARDS ***
8oS5O7iD/qnFXFXJrGIgNQ: folds
1f3beyIML24UqEMTbWy93g: folds
d8WX+9nUHoqlrAGagO0Wow: folds
xAU6q2/cwmby2sxmA8VcmA: folds
4d1rWhpu8DzLmzMbR3QKyA: raises $3 to $4
JwCcjZl0bjJzG7hmE0dnTA: raises $8 to $12
4d1rWhpu8DzLmzMbR3QKyA: folds
JwCcjZl0bjJzG7hmE0dnTA collected $8 from pot
*** SUMMARY ***
Total pot $8 | Rake $0
Seat 1: 4d1rWhpu8DzLmzMbR3QKyA (small blind) folded before Flop
Seat 2: JwCcjZl0bjJzG7hmE0dnTA (big blind) collected ($8)
Seat 3: 8oS5O7iD/qnFXFXJrGIgNQ folded before Flop (didn't bet)
Seat 4: 1f3beyIML24UqEMTbWy93g folded before Flop (didn't bet)
Seat 5: d8WX+9nUHoqlrAGagO0Wow folded before Flop (didn't bet)
Seat 6: xAU6q2/cwmby2sxmA8VcmA (button) folded before Flop (didn't bet)



PokerStars Game #59941726882:  Hold'em No Limit ($0.50/$1.00) - 2009/07/01 1:44:14 ET
Table 'DE4ps3MTl+4avTytwFENAg' 6-max Seat #1 is the button
Seat 1: PvfYaKbzMpsmUcbOExckbQ ($100.25 in chips)
Seat 2: QHvTZcrKe6+maWUfVjP29Q ($100 in chips)
Seat 3: cGayYjcyk6+jN57tzIY4TA ($317.65 in chips)
Seat 4: iexehpxaQwzColGqeTEnLQ ($100.35 in chips)
Seat 6: lsLuWlcPA3Rh7kJVLzMh0Q ($106.75 in chips)
QHvTZcrKe6+maWUfVjP29Q: posts small blind $0.50
cGayYjcyk6+jN57tzIY4TA: posts big blind $1
BWhgxe7gWiYobRbwdG+d2Q: sits out
*** HOLE CARDS ***
iexehpxaQwzColGqeTEnLQ: folds
lsLuWlcPA3Rh7kJVLzMh0Q: folds
PvfYaKbzMpsmUcbOExckbQ: folds
QHvTZcrKe6+maWUfVjP29Q: raises $3 to $4
cGayYjcyk6+jN57tzIY4TA: calls $3
*** FLOP *** [3c Kd 7h]
QHvTZcrKe6+maWUfVjP29Q: bets $5
cGayYjcyk6+jN57tzIY4TA: calls $5
*** TURN *** [3c Kd 7h] [6c]
QHvTZcrKe6+maWUfVjP29Q: bets $12
cGayYjcyk6+jN57tzIY4TA: folds
QHvTZcrKe6+maWUfVjP29Q collected $17.15 from pot
*** SUMMARY ***
Total pot $18 | Rake $0.85
Board [3c Kd 7h 6c]
Seat 1: PvfYaKbzMpsmUcbOExckbQ (button) folded before Flop (didn't bet)
Seat 2: QHvTZcrKe6+maWUfVjP29Q (small blind) collected ($17.15)
Seat 3: cGayYjcyk6+jN57tzIY4TA (big blind) folded on the Turn
Seat 4: iexehpxaQwzColGqeTEnLQ folded before Flop (didn't bet)
Seat 6: lsLuWlcPA3Rh7kJVLzMh0Q folded before Flop (didn't bet)



PokerStars Game #59941727610:  Hold'em No Limit ($0.50/$1.00) - 2009/07/01 1:44:15 ET
Table 'uNlePsyMIqzM691Xkrlk6Q' 9-max Seat #8 is the button
Seat 1: bLbSOSmSOnqE0iTcH/5dxA ($109.90 in chips)
Seat 2: TAfo4veNRaRlzDXMMYS3Jg ($20 in chips)
Seat 3: h7qXkU57Bb8ZuPwMyxR8Ug ($119 in chips)
Seat 4: WRTVKFHeb0vRJnVi5NdJZw ($43.25 in chips)
Seat 5: G9Fo2TZCN7HI43Po4zSN3A ($109.40 in chips)
Seat 6: mMc/PBpqlN24gdi3C/1tOw ($39 in chips)
Seat 7: KNAaBvPYSXyLqb88ypSbuQ ($34.55 in chips)
Seat 8: yWcEtGJ3ijZsF6HqlHqkrg ($115 in chips)
Seat 9: OGgaARGdJQT4awWVNQ957w ($117 in chips)
OGgaARGdJQT4awWVNQ957w: posts small blind $0.50
bLbSOSmSOnqE0iTcH/5dxA: posts big blind $1
*** HOLE CARDS ***
TAfo4veNRaRlzDXMMYS3Jg: folds
h7qXkU57Bb8ZuPwMyxR8Ug: folds
WRTVKFHeb0vRJnVi5NdJZw: folds
G9Fo2TZCN7HI43Po4zSN3A: folds
mMc/PBpqlN24gdi3C/1tOw: folds
KNAaBvPYSXyLqb88ypSbuQ: calls $1
yWcEtGJ3ijZsF6HqlHqkrg: folds
OGgaARGdJQT4awWVNQ957w: folds
bLbSOSmSOnqE0iTcH/5dxA: checks
*** FLOP *** [Jh 2h Qc]
bLbSOSmSOnqE0iTcH/5dxA: checks
KNAaBvPYSXyLqb88ypSbuQ: checks
*** TURN *** [Jh 2h Qc] [Ad]
bLbSOSmSOnqE0iTcH/5dxA: checks
KNAaBvPYSXyLqb88ypSbuQ: checks
*** RIVER *** [Jh 2h Qc Ad] [Tc]
bLbSOSmSOnqE0iTcH/5dxA: checks
KNAaBvPYSXyLqb88ypSbuQ: bets $2
bLbSOSmSOnqE0iTcH/5dxA: folds
KNAaBvPYSXyLqb88ypSbuQ collected $2.40 from pot
*** SUMMARY ***
Total pot $2.50 | Rake $0.10
Board [Jh 2h Qc Ad Tc]
Seat 1: bLbSOSmSOnqE0iTcH/5dxA (big blind) folded on the River
Seat 2: TAfo4veNRaRlzDXMMYS3Jg folded before Flop (didn't bet)
Seat 3: h7qXkU57Bb8ZuPwMyxR8Ug folded before Flop (didn't bet)
Seat 4: WRTVKFHeb0vRJnVi5NdJZw folded before Flop (didn't bet)
Seat 5: G9Fo2TZCN7HI43Po4zSN3A folded before Flop (didn't bet)
Seat 6: mMc/PBpqlN24gdi3C/1tOw folded before Flop (didn't bet)
Seat 7: KNAaBvPYSXyLqb88ypSbuQ collected ($2.40)
Seat 8: yWcEtGJ3ijZsF6HqlHqkrg (button) folded before Flop (didn't bet)
Seat 9: OGgaARGdJQT4awWVNQ957w (small blind) folded before Flop



PokerStars Game #59941728932:  Hold'em No Limit ($0.50/$1.00) - 2009/07/01 1:44:18 ET
Table 'blHlQApStil0OPeQxQxPcw' 9-max Seat #5 is the button
Seat 1: Pp/KTcXkfZKKUHkjyaLTdg ($30.60 in chips)
Seat 2: V138SURkdX8LdVBPKdJJag ($121.35 in chips)
Seat 3: OGgaARGdJQT4awWVNQ957w ($100 in chips)
Seat 5: uXrDE6JrIi8BZK1L8oQ9bQ ($35.60 in chips)
Seat 6: vljeiOoWscAIXU0fCuiEBw ($45.15 in chips)
Seat 7: VPF+HjszMvUIpy0CHIwH3A ($20 in chips)
Seat 9: 6XkTu4ahxzHnvjjc1R8YjQ ($151.85 in chips)
vljeiOoWscAIXU0fCuiEBw: posts small blind $0.50
VPF+HjszMvUIpy0CHIwH3A: posts big blind $1
myIxN7otsyr846M539YR8Q: sits out
*** HOLE CARDS ***
6XkTu4ahxzHnvjjc1R8YjQ: folds
Pp/KTcXkfZKKUHkjyaLTdg: folds
V138SURkdX8LdVBPKdJJag: folds
OGgaARGdJQT4awWVNQ957w: raises $3 to $4
uXrDE6JrIi8BZK1L8oQ9bQ: folds
vljeiOoWscAIXU0fCuiEBw: folds
VPF+HjszMvUIpy0CHIwH3A: folds
OGgaARGdJQT4awWVNQ957w collected $2.50 from pot
OGgaARGdJQT4awWVNQ957w: doesn't show hand
*** SUMMARY ***
Total pot $2.50 | Rake $0
Seat 1: Pp/KTcXkfZKKUHkjyaLTdg folded before Flop (didn't bet)
Seat 2: V138SURkdX8LdVBPKdJJag folded before Flop (didn't bet)
Seat 3: OGgaARGdJQT4awWVNQ957w collected ($2.50)
Seat 5: uXrDE6JrIi8BZK1L8oQ9bQ (button) folded before Flop (didn't bet)
Seat 6: vljeiOoWscAIXU0fCuiEBw (small blind) folded before Flop
Seat 7: VPF+HjszMvUIpy0CHIwH3A (big blind) folded before Flop
Seat 9: 6XkTu4ahxzHnvjjc1R8YjQ folded before Flop (didn't bet)



PokerStars Game #59941729308:  Hold'em No Limit ($0.50/$1.00) - 2009/07/01 1:44:19 ET
Table 'vs/5jr6ciwjVQ5+Soc+u2A' 6-max Seat #6 is the button
Seat 1: J798qwLuvXyq0BbzsIjOrA ($223.50 in chips)
Seat 2: lXX4W7m3u++JiSOZ46yVMQ ($100 in chips)
Seat 3: Ws/3Uo3rQIk8hLgW0P+2xA ($95.90 in chips)
Seat 4: 0smcry9L0OOTCP+KzIS5SA ($88 in chips)
Seat 5: +Nt3OPk3XR9SKjZgm2CexQ ($131.35 in chips)
Seat 6: Z2fXsGcjl+Eax+RzOgwOmg ($122.50 in chips)
J798qwLuvXyq0BbzsIjOrA: posts small blind $0.50
lXX4W7m3u++JiSOZ46yVMQ: posts big blind $1
*** HOLE CARDS ***
Ws/3Uo3rQIk8hLgW0P+2xA: raises $1 to $2
0smcry9L0OOTCP+KzIS5SA: calls $2
+Nt3OPk3XR9SKjZgm2CexQ: folds
Z2fXsGcjl+Eax+RzOgwOmg: folds
J798qwLuvXyq0BbzsIjOrA: calls $1.50
lXX4W7m3u++JiSOZ46yVMQ: calls $1
*** FLOP *** [Qs 6c Qc]
J798qwLuvXyq0BbzsIjOrA: checks
lXX4W7m3u++JiSOZ46yVMQ: checks
Ws/3Uo3rQIk8hLgW0P+2xA: bets $4
0smcry9L0OOTCP+KzIS5SA: folds
J798qwLuvXyq0BbzsIjOrA: folds
lXX4W7m3u++JiSOZ46yVMQ: folds
Ws/3Uo3rQIk8hLgW0P+2xA collected $7.60 from pot
*** SUMMARY ***
Total pot $8 | Rake $0.40
Board [Qs 6c Qc]
Seat 1: J798qwLuvXyq0BbzsIjOrA (small blind) folded on the Flop
Seat 2: lXX4W7m3u++JiSOZ46yVMQ (big blind) folded on the Flop
Seat 3: Ws/3Uo3rQIk8hLgW0P+2xA collected ($7.60)
Seat 4: 0smcry9L0OOTCP+KzIS5SA folded on the Flop
Seat 5: +Nt3OPk3XR9SKjZgm2CexQ folded before Flop (didn't bet)
Seat 6: Z2fXsGcjl+Eax+RzOgwOmg (button) folded before Flop (didn't bet)



PokerStars Game #59941729794:  Hold'em No Limit ($0.50/$1.00) - 2009/07/01 1:44:19 ET
Table '/RZcOwpZpHQ+OwPwjsbnRw' 6-max Seat #1 is the button
Seat 1: +uSzP8Jwnw7sKfQ4s66b7w ($87.40 in chips)
Seat 2: Z2fXsGcjl+Eax+RzOgwOmg ($103.15 in chips)
Seat 3: LJMw/I77xpnw0R5T4HnMUg ($106.55 in chips)
Seat 4: j7NIOHLZk7V2o9fOioO5ug ($113.20 in chips)
Seat 5: wx3sQGkVi2x9wJXuWNHPBw ($167.25 in chips)
Seat 6: o3YLm/rSY916m/on1VjXPA ($204 in chips)
Z2fXsGcjl+Eax+RzOgwOmg: posts small blind $0.50
LJMw/I77xpnw0R5T4HnMUg: posts big blind $1
*** HOLE CARDS ***
j7NIOHLZk7V2o9fOioO5ug: folds
wx3sQGkVi2x9wJXuWNHPBw: folds
o3YLm/rSY916m/on1VjXPA: folds
+uSzP8Jwnw7sKfQ4s66b7w: raises $2 to $3
Z2fXsGcjl+Eax+RzOgwOmg: folds
LJMw/I77xpnw0R5T4HnMUg: calls $2
*** FLOP *** [6c Td 2s]
LJMw/I77xpnw0R5T4HnMUg: checks
+uSzP8Jwnw7sKfQ4s66b7w: checks
*** TURN *** [6c Td 2s] [2c]
LJMw/I77xpnw0R5T4HnMUg: bets $5
+uSzP8Jwnw7sKfQ4s66b7w: calls $5
*** RIVER *** [6c Td 2s 2c] [6s]
LJMw/I77xpnw0R5T4HnMUg: bets $15
+uSzP8Jwnw7sKfQ4s66b7w: calls $15
*** SHOW DOWN ***
LJMw/I77xpnw0R5T4HnMUg: shows [Kc 9c] (two pair, Sixes and Deuces)
+uSzP8Jwnw7sKfQ4s66b7w: shows [Jd As] (two pair, Sixes and Deuces - Ace kicker)
+uSzP8Jwnw7sKfQ4s66b7w collected $44.25 from pot
*** SUMMARY ***
Total pot $46.50 | Rake $2.25
Board [6c Td 2s 2c 6s]
Seat 1: +uSzP8Jwnw7sKfQ4s66b7w (button) showed [Jd As] and won ($44.25) with two pair, Sixes and Deuces
Seat 2: Z2fXsGcjl+Eax+RzOgwOmg (small blind) folded before Flop
Seat 3: LJMw/I77xpnw0R5T4HnMUg (big blind) showed [Kc 9c] and lost with two pair, Sixes and Deuces
Seat 4: j7NIOHLZk7V2o9fOioO5ug folded before Flop (didn't bet)
Seat 5: wx3sQGkVi2x9wJXuWNHPBw folded before Flop (didn't bet)
Seat 6: o3YLm/rSY916m/on1VjXPA folded before Flop (didn't bet)



PokerStars Game #59941729574:  Hold'em No Limit ($0.50/$1.00) - 2009/07/01 1:44:19 ET
Table 'qj0HBN4HhQKogreu1bg7xg' 2-max Seat #1 is the button
Seat 1: NYi6JFscYNrofSXy4sM+Yw ($144.10 in chips)
Seat 2: qtyl8CSb0/4yWdbuEPJejA ($132.20 in chips)
NYi6JFscYNrofSXy4sM+Yw: posts small blind $0.50
qtyl8CSb0/4yWdbuEPJejA: posts big blind $1
*** HOLE CARDS ***
NYi6JFscYNrofSXy4sM+Yw: raises $2 to $3
qtyl8CSb0/4yWdbuEPJejA: folds
NYi6JFscYNrofSXy4sM+Yw collected $2 from pot
*** SUMMARY ***
Total pot $2 | Rake $0
Seat 1: NYi6JFscYNrofSXy4sM+Yw (button) (small blind) collected ($2)
Seat 2: qtyl8CSb0/4yWdbuEPJejA (big blind) folded before Flop



PokerStars Game #59941730308:  Hold'em No Limit ($0.50/$1.00) - 2009/07/01 1:44:20 ET
Table 'MUPc8FEpe/nR0BKSeReX6Q' 6-max Seat #4 is the button
Seat 1: qhkK6+yCciTRd+rCFEbnEQ ($83.70 in chips)
Seat 2: xAU6q2/cwmby2sxmA8VcmA ($103.70 in chips)
Seat 3: wx3sQGkVi2x9wJXuWNHPBw ($286.15 in chips)
Seat 4: r4lpoh2BJZ8S6zyQv1JeSw ($108.50 in chips)
Seat 5: y27w5IK2WXqmYzS8OU0wKA ($131.55 in chips)
Seat 6: ene3nLSnQ4N961iBaUsSmA ($100 in chips)
y27w5IK2WXqmYzS8OU0wKA: posts small blind $0.50
ene3nLSnQ4N961iBaUsSmA: posts big blind $1
*** HOLE CARDS ***
qhkK6+yCciTRd+rCFEbnEQ: folds
xAU6q2/cwmby2sxmA8VcmA: folds
wx3sQGkVi2x9wJXuWNHPBw: folds
r4lpoh2BJZ8S6zyQv1JeSw: raises $2 to $3
y27w5IK2WXqmYzS8OU0wKA: folds
ene3nLSnQ4N961iBaUsSmA: folds
r4lpoh2BJZ8S6zyQv1JeSw collected $2.50 from pot
r4lpoh2BJZ8S6zyQv1JeSw: doesn't show hand
*** SUMMARY ***
Total pot $2.50 | Rake $0
Seat 1: qhkK6+yCciTRd+rCFEbnEQ folded before Flop (didn't bet)
Seat 2: xAU6q2/cwmby2sxmA8VcmA folded before Flop (didn't bet)
Seat 3: wx3sQGkVi2x9wJXuWNHPBw folded before Flop (didn't bet)
Seat 4: r4lpoh2BJZ8S6zyQv1JeSw (button) collected ($2.50)
Seat 5: y27w5IK2WXqmYzS8OU0wKA (small blind) folded before Flop
Seat 6: ene3nLSnQ4N961iBaUsSmA (big blind) folded before Flop



PokerStars Game #59941729902:  Hold'em No Limit ($0.50/$1.00) - 2009/07/01 1:44:20 ET
Table '+cA8mcmhaedZ7YcrDdhmeQ' 6-max Seat #2 is the button
Seat 1: VB7TtBnfmT3JTA/cCL6dJg ($100 in chips)
Seat 2: 14aYclSc98EYd6TrzN2l3Q ($88.80 in chips)
Seat 3: DAIgyIWbYvAkL6PbAI27pg ($17.50 in chips)
Seat 4: 4OO5v3AVduL0tePNx8wk5A ($108.20 in chips)
Seat 5: SJieaES+gCAfonfNNMCP6w ($100 in chips)
DAIgyIWbYvAkL6PbAI27pg: posts small blind $0.50
4OO5v3AVduL0tePNx8wk5A: posts big blind $1
*** HOLE CARDS ***
SJieaES+gCAfonfNNMCP6w: folds
VB7TtBnfmT3JTA/cCL6dJg: folds
14aYclSc98EYd6TrzN2l3Q: calls $1
YfsTQsY/fxb+YqbdclTHuw has returned
DAIgyIWbYvAkL6PbAI27pg: raises $16.50 to $17.50 and is all-in
4OO5v3AVduL0tePNx8wk5A: folds
14aYclSc98EYd6TrzN2l3Q: folds
DAIgyIWbYvAkL6PbAI27pg collected $3 from pot
*** SUMMARY ***
Total pot $3 | Rake $0
Seat 1: VB7TtBnfmT3JTA/cCL6dJg folded before Flop (didn't bet)
Seat 2: 14aYclSc98EYd6TrzN2l3Q (button) folded before Flop
Seat 3: DAIgyIWbYvAkL6PbAI27pg (small blind) collected ($3)
Seat 4: 4OO5v3AVduL0tePNx8wk5A (big blind) folded before Flop
Seat 5: SJieaES+gCAfonfNNMCP6w folded before Flop (didn't bet)



PokerStars Game #59941730982:  Hold'em No Limit ($0.50/$1.00) - 2009/07/01 1:44:22 ET
Table 'rmZfTK+oSebeUPJNbWhdAA' 6-max Seat #6 is the button
Seat 1: xAU6q2/cwmby2sxmA8VcmA ($134.80 in chips)
Seat 2: z7O9PO/WEcqRouIydFhS9Q ($206.95 in chips)
Seat 3: BCEV3COoKY607AzLWayfRA ($209.70 in chips)
Seat 4: 1/mIuXfgx1ZyVkodrmfQDw ($154.85 in chips)
Seat 5: UOHYuj23MyK9R8ciY2t6FA ($100 in chips)
Seat 6: j7NIOHLZk7V2o9fOioO5ug ($100.70 in chips)
xAU6q2/cwmby2sxmA8VcmA: posts small blind $0.50
z7O9PO/WEcqRouIydFhS9Q: posts big blind $1
*** HOLE CARDS ***
BCEV3COoKY607AzLWayfRA: folds
1/mIuXfgx1ZyVkodrmfQDw: folds
UOHYuj23MyK9R8ciY2t6FA: folds
j7NIOHLZk7V2o9fOioO5ug: folds
xAU6q2/cwmby2sxmA8VcmA: folds
z7O9PO/WEcqRouIydFhS9Q collected $1 from pot
z7O9PO/WEcqRouIydFhS9Q: doesn't show hand
*** SUMMARY ***
Total pot $1 | Rake $0
Seat 1: xAU6q2/cwmby2sxmA8VcmA (small blind) folded before Flop
Seat 2: z7O9PO/WEcqRouIydFhS9Q (big blind) collected ($1)
Seat 3: BCEV3COoKY607AzLWayfRA folded before Flop (didn't bet)
Seat 4: 1/mIuXfgx1ZyVkodrmfQDw folded before Flop (didn't bet)
Seat 5: UOHYuj23MyK9R8ciY2t6FA folded before Flop (didn't bet)
Seat 6: j7NIOHLZk7V2o9fOioO5ug (button) folded before Flop (didn't bet)



PokerStars Game #59941731536:  Hold'em No Limit ($0.50/$1.00) - 2009/07/01 1:44:23 ET
Table '6YvsYDPNIDx2v5z3bJnwZQ' 9-max Seat #1 is the button
Seat 1: Ogn4JDV3mp4ZDKO49IFzKA ($19.80 in chips)
Seat 2: TAfo4veNRaRlzDXMMYS3Jg ($17.50 in chips)
Seat 3: K6OJDis3KfxSm/PKlkATUA ($58.05 in chips)
Seat 4: kEr5NYB+JIG5+szcYMr6hA ($70 in chips)
Seat 5: mBRWbnUl8diyBO1qTJaNzw ($134.75 in chips)
Seat 8: PSFxpXgPedVZyHSu2Zhb7Q ($105.25 in chips)
Seat 9: myIxN7otsyr846M539YR8Q ($18.50 in chips)
TAfo4veNRaRlzDXMMYS3Jg: posts small blind $0.50
K6OJDis3KfxSm/PKlkATUA: posts big blind $1
aM6BB+PnB/rDUr2dbRda+A: sits out
*** HOLE CARDS ***
kEr5NYB+JIG5+szcYMr6hA: folds
mBRWbnUl8diyBO1qTJaNzw: raises $3 to $4
PSFxpXgPedVZyHSu2Zhb7Q: folds
myIxN7otsyr846M539YR8Q: folds
Ogn4JDV3mp4ZDKO49IFzKA: folds
TAfo4veNRaRlzDXMMYS3Jg: folds
K6OJDis3KfxSm/PKlkATUA: folds
mBRWbnUl8diyBO1qTJaNzw collected $2.50 from pot
mBRWbnUl8diyBO1qTJaNzw: doesn't show hand
*** SUMMARY ***
Total pot $2.50 | Rake $0
Seat 1: Ogn4JDV3mp4ZDKO49IFzKA (button) folded before Flop (didn't bet)
Seat 2: TAfo4veNRaRlzDXMMYS3Jg (small blind) folded before Flop
Seat 3: K6OJDis3KfxSm/PKlkATUA (big blind) folded before Flop
Seat 4: kEr5NYB+JIG5+szcYMr6hA folded before Flop (didn't bet)
Seat 5: mBRWbnUl8diyBO1qTJaNzw collected ($2.50)
Seat 8: PSFxpXgPedVZyHSu2Zhb7Q folded before Flop (didn't bet)
Seat 9: myIxN7otsyr846M539YR8Q folded before Flop (didn't bet)



PokerStars Game #59941733152:  Hold'em No Limit ($0.50/$1.00) - 2009/07/01 1:44:26 ET
Table 'qj0HBN4HhQKogreu1bg7xg' 2-max Seat #2 is the button
Seat 1: NYi6JFscYNrofSXy4sM+Yw ($145.10 in chips)
Seat 2: qtyl8CSb0/4yWdbuEPJejA ($131.20 in chips)
qtyl8CSb0/4yWdbuEPJejA: posts small blind $0.50
NYi6JFscYNrofSXy4sM+Yw: posts big blind $1
*** HOLE CARDS ***
qtyl8CSb0/4yWdbuEPJejA: raises $2 to $3
NYi6JFscYNrofSXy4sM+Yw: folds
qtyl8CSb0/4yWdbuEPJejA collected $2 from pot
qtyl8CSb0/4yWdbuEPJejA: doesn't show hand
*** SUMMARY ***
Total pot $2 | Rake $0
Seat 1: NYi6JFscYNrofSXy4sM+Yw (big blind) folded before Flop
Seat 2: qtyl8CSb0/4yWdbuEPJejA (button) (small blind) collected ($2)



PokerStars Game #59941734078:  Hold'em No Limit ($0.50/$1.00) - 2009/07/01 1:44:27 ET
Table 'kS0cTQAEi+fdUlJP2gQYvw' 9-max Seat #1 is the button
Seat 1: SqsWPukL8kLqrhq5ZrQdSQ ($172.50 in chips)
Seat 2: +JautI/vSNALzwSvsOqbCQ ($77 in chips)
Seat 3: 2BV+oJIQYr65IO6nEChvbA ($62.55 in chips)
Seat 4: RUhhaALzha3TH1AkdakoGQ ($57.50 in chips)
Seat 5: 997ViqAtWn1FPjJqcffwcA ($100 in chips)
Seat 6: yAbu2QsRPVcjPbqlf/jDxw ($117.15 in chips)
Seat 7: Ffa7Nj4X5fddtROP01hfQg ($8.50 in chips)
Seat 9: OGgaARGdJQT4awWVNQ957w ($108.20 in chips)
+JautI/vSNALzwSvsOqbCQ: posts small blind $0.50
2BV+oJIQYr65IO6nEChvbA: posts big blind $1
V138SURkdX8LdVBPKdJJag: sits out
*** HOLE CARDS ***
RUhhaALzha3TH1AkdakoGQ: raises $2 to $3
997ViqAtWn1FPjJqcffwcA: folds
yAbu2QsRPVcjPbqlf/jDxw: folds
Ffa7Nj4X5fddtROP01hfQg: folds
OGgaARGdJQT4awWVNQ957w: folds
SqsWPukL8kLqrhq5ZrQdSQ: calls $3
+JautI/vSNALzwSvsOqbCQ: calls $2.50
2BV+oJIQYr65IO6nEChvbA: folds
*** FLOP *** [8c Ks Qs]
+JautI/vSNALzwSvsOqbCQ: checks
RUhhaALzha3TH1AkdakoGQ: bets $6
SqsWPukL8kLqrhq5ZrQdSQ: folds
+JautI/vSNALzwSvsOqbCQ: folds
RUhhaALzha3TH1AkdakoGQ collected $9.50 from pot
*** SUMMARY ***
Total pot $10 | Rake $0.50
Board [8c Ks Qs]
Seat 1: SqsWPukL8kLqrhq5ZrQdSQ (button) folded on the Flop
Seat 2: +JautI/vSNALzwSvsOqbCQ (small blind) folded on the Flop
Seat 3: 2BV+oJIQYr65IO6nEChvbA (big blind) folded before Flop
Seat 4: RUhhaALzha3TH1AkdakoGQ collected ($9.50)
Seat 5: 997ViqAtWn1FPjJqcffwcA folded before Flop (didn't bet)
Seat 6: yAbu2QsRPVcjPbqlf/jDxw folded before Flop (didn't bet)
Seat 7: Ffa7Nj4X5fddtROP01hfQg folded before Flop (didn't bet)
Seat 9: OGgaARGdJQT4awWVNQ957w folded before Flop (didn't bet)



PokerStars Game #59941734796:  Hold'em No Limit ($0.50/$1.00) - 2009/07/01 1:44:29 ET
Table '3T4owEKJKyGTMePwrv50FQ' 9-max Seat #9 is the button
Seat 1: OGgaARGdJQT4awWVNQ957w ($100.50 in chips)
Seat 2: t+Id2O6herCLgwnC4m49PA ($35.25 in chips)
Seat 3: DOLzOcBTZYcph5jEfKFWuQ ($106.40 in chips)
Seat 5: mMc/PBpqlN24gdi3C/1tOw ($50.25 in chips)
Seat 6: V138SURkdX8LdVBPKdJJag ($105.50 in chips)
Seat 7: 1862487932 ($104 in chips)
Seat 8: bLbSOSmSOnqE0iTcH/5dxA ($197 in chips)
Seat 9: 61sfw5QTu62YYIt68OsdrA ($83.25 in chips)
OGgaARGdJQT4awWVNQ957w: posts small blind $0.50
t+Id2O6herCLgwnC4m49PA: posts big blind $1
*** HOLE CARDS ***
DOLzOcBTZYcph5jEfKFWuQ: folds
mMc/PBpqlN24gdi3C/1tOw: folds
V138SURkdX8LdVBPKdJJag: folds
1862487932: folds
kiakSwxX0e64PwYGAPQvLw joins the table at seat #4
bLbSOSmSOnqE0iTcH/5dxA: folds
61sfw5QTu62YYIt68OsdrA: folds
OGgaARGdJQT4awWVNQ957w: folds
t+Id2O6herCLgwnC4m49PA collected $1 from pot
*** SUMMARY ***
Total pot $1 | Rake $0
Seat 1: OGgaARGdJQT4awWVNQ957w (small blind) folded before Flop
Seat 2: t+Id2O6herCLgwnC4m49PA (big blind) collected ($1)
Seat 3: DOLzOcBTZYcph5jEfKFWuQ folded before Flop (didn't bet)
Seat 5: mMc/PBpqlN24gdi3C/1tOw folded before Flop (didn't bet)
Seat 6: V138SURkdX8LdVBPKdJJag folded before Flop (didn't bet)
Seat 7: 1862487932 folded before Flop (didn't bet)
Seat 8: bLbSOSmSOnqE0iTcH/5dxA folded before Flop (didn't bet)
Seat 9: 61sfw5QTu62YYIt68OsdrA (button) folded before Flop (didn't bet)



PokerStars Game #59941736404:  Hold'em No Limit ($0.50/$1.00) - 2009/07/01 1:44:32 ET
Table '7O9fB8yx1u7sJveJn8w6jA' 6-max Seat #4 is the button
Seat 1: 841740 ($37.80 in chips)
Seat 2: wx3sQGkVi2x9wJXuWNHPBw ($205.35 in chips)
Seat 3: hpxXcmRkXXI9HE5+5/j/0Q ($145.45 in chips)
Seat 4: b2a+5TkFf4xJN/Ihhma58Q ($25.35 in chips)
Seat 5: BCEV3COoKY607AzLWayfRA ($107.70 in chips)
Seat 6: r4lpoh2BJZ8S6zyQv1JeSw ($107.75 in chips)
BCEV3COoKY607AzLWayfRA: posts small blind $0.50
r4lpoh2BJZ8S6zyQv1JeSw: posts big blind $1
*** HOLE CARDS ***
841740: folds
wx3sQGkVi2x9wJXuWNHPBw: folds
hpxXcmRkXXI9HE5+5/j/0Q: folds
b2a+5TkFf4xJN/Ihhma58Q: raises $2 to $3
BCEV3COoKY607AzLWayfRA: folds
r4lpoh2BJZ8S6zyQv1JeSw: raises $7 to $10
b2a+5TkFf4xJN/Ihhma58Q: folds
r4lpoh2BJZ8S6zyQv1JeSw collected $6.50 from pot
r4lpoh2BJZ8S6zyQv1JeSw: doesn't show hand
*** SUMMARY ***
Total pot $6.50 | Rake $0
Seat 1: 841740 folded before Flop (didn't bet)
Seat 2: wx3sQGkVi2x9wJXuWNHPBw folded before Flop (didn't bet)
Seat 3: hpxXcmRkXXI9HE5+5/j/0Q folded before Flop (didn't bet)
Seat 4: b2a+5TkFf4xJN/Ihhma58Q (button) folded before Flop
Seat 5: BCEV3COoKY607AzLWayfRA (small blind) folded before Flop
Seat 6: r4lpoh2BJZ8S6zyQv1JeSw (big blind) collected ($6.50)



PokerStars Game #59941737298:  Hold'em No Limit ($0.50/$1.00) - 2009/07/01 1:44:33 ET
Table 'Zka9tv1yilg0MvXWPQrShg' 9-max Seat #2 is the button
Seat 1: ZVxIB+9xpB8diS64GK4r1Q ($53.80 in chips)
Seat 2: rALqQhDZz5RDHkTXtYKKiQ ($54 in chips)
Seat 3: gUUvmqdVlmvpal6B8nYrmg ($161.70 in chips)
Seat 4: ri8CLkX3e9JF34dQNbsHGA ($25 in chips)
Seat 5: /zy+DB4S5fUQUSfZWFzYGw ($126.15 in chips)
Seat 6: rY8wPoax1lS+HUY+I0FZDw ($218.85 in chips)
Seat 7: wddetwG1UUDMywszPUtP3A ($65.15 in chips)
Seat 8: mBRWbnUl8diyBO1qTJaNzw ($100 in chips)
Seat 9: bGHJpa8dswKSoojQBgXCgQ ($115.80 in chips)
gUUvmqdVlmvpal6B8nYrmg: posts small blind $0.50
ri8CLkX3e9JF34dQNbsHGA: posts big blind $1
*** HOLE CARDS ***
/zy+DB4S5fUQUSfZWFzYGw: folds
rY8wPoax1lS+HUY+I0FZDw: raises $3 to $4
wddetwG1UUDMywszPUtP3A: folds
mBRWbnUl8diyBO1qTJaNzw: folds
bGHJpa8dswKSoojQBgXCgQ: folds
ZVxIB+9xpB8diS64GK4r1Q: folds
rALqQhDZz5RDHkTXtYKKiQ: folds
gUUvmqdVlmvpal6B8nYrmg: folds
ri8CLkX3e9JF34dQNbsHGA: folds
rY8wPoax1lS+HUY+I0FZDw collected $2.50 from pot
rY8wPoax1lS+HUY+I0FZDw: doesn't show hand
*** SUMMARY ***
Total pot $2.50 | Rake $0
Seat 1: ZVxIB+9xpB8diS64GK4r1Q folded before Flop (didn't bet)
Seat 2: rALqQhDZz5RDHkTXtYKKiQ (button) folded before Flop (didn't bet)
Seat 3: gUUvmqdVlmvpal6B8nYrmg (small blind) folded before Flop
Seat 4: ri8CLkX3e9JF34dQNbsHGA (big blind) folded before Flop
Seat 5: /zy+DB4S5fUQUSfZWFzYGw folded before Flop (didn't bet)
Seat 6: rY8wPoax1lS+HUY+I0FZDw collected ($2.50)
Seat 7: wddetwG1UUDMywszPUtP3A folded before Flop (didn't bet)
Seat 8: mBRWbnUl8diyBO1qTJaNzw folded before Flop (didn't bet)
Seat 9: bGHJpa8dswKSoojQBgXCgQ folded before Flop (didn't bet)



PokerStars Game #59941737934:  Hold'em No Limit ($0.50/$1.00) - 2009/07/01 1:44:34 ET
Table 'QSIig7BLMc9wY/rgBechzw' 6-max Seat #5 is the button
Seat 1: Z2fXsGcjl+Eax+RzOgwOmg ($100 in chips)
Seat 2: w13GSGRwQhbN/aLrrRaMKw ($22 in chips)
Seat 3: 4OO5v3AVduL0tePNx8wk5A ($125.20 in chips)
Seat 4: +uSzP8Jwnw7sKfQ4s66b7w ($74.65 in chips)
Seat 5: lsLuWlcPA3Rh7kJVLzMh0Q ($123 in chips)
rHlMOfR7kpQQxe+PFQz0xQ will be allowed to play after the button
Z2fXsGcjl+Eax+RzOgwOmg: posts small blind $0.50
w13GSGRwQhbN/aLrrRaMKw: posts big blind $1
*** HOLE CARDS ***
4OO5v3AVduL0tePNx8wk5A: raises $3 to $4
+uSzP8Jwnw7sKfQ4s66b7w has timed out
+uSzP8Jwnw7sKfQ4s66b7w: folds
+uSzP8Jwnw7sKfQ4s66b7w is sitting out
lsLuWlcPA3Rh7kJVLzMh0Q: folds
+uSzP8Jwnw7sKfQ4s66b7w has returned
Z2fXsGcjl+Eax+RzOgwOmg: raises $11 to $15
w13GSGRwQhbN/aLrrRaMKw: folds
4OO5v3AVduL0tePNx8wk5A: folds
Z2fXsGcjl+Eax+RzOgwOmg collected $9 from pot
Z2fXsGcjl+Eax+RzOgwOmg: doesn't show hand
*** SUMMARY ***
Total pot $9 | Rake $0
Seat 1: Z2fXsGcjl+Eax+RzOgwOmg (small blind) collected ($9)
Seat 2: w13GSGRwQhbN/aLrrRaMKw (big blind) folded before Flop
Seat 3: 4OO5v3AVduL0tePNx8wk5A folded before Flop
Seat 4: +uSzP8Jwnw7sKfQ4s66b7w folded before Flop (didn't bet)
Seat 5: lsLuWlcPA3Rh7kJVLzMh0Q (button) folded before Flop (didn't bet)



PokerStars Game #59941738374:  Hold'em No Limit ($0.50/$1.00) - 2009/07/01 1:44:35 ET
Table 'qj0HBN4HhQKogreu1bg7xg' 2-max Seat #1 is the button
Seat 1: NYi6JFscYNrofSXy4sM+Yw ($144.10 in chips)
Seat 2: qtyl8CSb0/4yWdbuEPJejA ($132.20 in chips)
NYi6JFscYNrofSXy4sM+Yw: posts small blind $0.50
qtyl8CSb0/4yWdbuEPJejA: posts big blind $1
*** HOLE CARDS ***
NYi6JFscYNrofSXy4sM+Yw: raises $2 to $3
qtyl8CSb0/4yWdbuEPJejA: folds
NYi6JFscYNrofSXy4sM+Yw collected $2 from pot
NYi6JFscYNrofSXy4sM+Yw: doesn't show hand
*** SUMMARY ***
Total pot $2 | Rake $0
Seat 1: NYi6JFscYNrofSXy4sM+Yw (button) (small blind) collected ($2)
Seat 2: qtyl8CSb0/4yWdbuEPJejA (big blind) folded before Flop



PokerStars Game #59941738906:  Hold'em No Limit ($0.50/$1.00) - 2009/07/01 1:44:36 ET
Table 'rmZfTK+oSebeUPJNbWhdAA' 6-max Seat #1 is the button
Seat 1: xAU6q2/cwmby2sxmA8VcmA ($134.30 in chips)
Seat 2: z7O9PO/WEcqRouIydFhS9Q ($207.45 in chips)
Seat 3: BCEV3COoKY607AzLWayfRA ($209.70 in chips)
Seat 4: 1/mIuXfgx1ZyVkodrmfQDw ($154.85 in chips)
Seat 5: UOHYuj23MyK9R8ciY2t6FA ($100 in chips)
Seat 6: j7NIOHLZk7V2o9fOioO5ug ($100.70 in chips)
z7O9PO/WEcqRouIydFhS9Q: posts small blind $0.50
BCEV3COoKY607AzLWayfRA: posts big blind $1
*** HOLE CARDS ***
1/mIuXfgx1ZyVkodrmfQDw: folds
UOHYuj23MyK9R8ciY2t6FA: folds
j7NIOHLZk7V2o9fOioO5ug: folds
xAU6q2/cwmby2sxmA8VcmA: raises $3 to $4
z7O9PO/WEcqRouIydFhS9Q: folds
BCEV3COoKY607AzLWayfRA: folds
xAU6q2/cwmby2sxmA8VcmA collected $2.50 from pot
xAU6q2/cwmby2sxmA8VcmA: doesn't show hand
*** SUMMARY ***
Total pot $2.50 | Rake $0
Seat 1: xAU6q2/cwmby2sxmA8VcmA (button) collected ($2.50)
Seat 2: z7O9PO/WEcqRouIydFhS9Q (small blind) folded before Flop
Seat 3: BCEV3COoKY607AzLWayfRA (big blind) folded before Flop
Seat 4: 1/mIuXfgx1ZyVkodrmfQDw folded before Flop (didn't bet)
Seat 5: UOHYuj23MyK9R8ciY2t6FA folded before Flop (didn't bet)
Seat 6: j7NIOHLZk7V2o9fOioO5ug folded before Flop (didn't bet)



PokerStars Game #59941738826:  Hold'em No Limit ($0.50/$1.00) - 2009/07/01 1:44:36 ET
Table 'O96CPOtvMBWP6kzuYDfdFA' 6-max Seat #6 is the button
Seat 1: 6alLXQIITA2EZ/lBeym8Dw ($142.15 in chips)
Seat 2: 4d1rWhpu8DzLmzMbR3QKyA ($101.50 in chips)
Seat 3: ieBUmHu5QBR86BArTtK4FQ ($19.55 in chips)
Seat 4: /P4w1pHg2zHYg/4ubJ0dPw ($61.95 in chips)
Seat 5: vX+iYAEINFeLxwMla7DY1Q ($87 in chips)
Seat 6: 3syOXva630dm1FTdwnuLpw ($80.10 in chips)
6alLXQIITA2EZ/lBeym8Dw: posts small blind $0.50
4d1rWhpu8DzLmzMbR3QKyA: posts big blind $1
*** HOLE CARDS ***
ieBUmHu5QBR86BArTtK4FQ: calls $1
/P4w1pHg2zHYg/4ubJ0dPw: folds
vX+iYAEINFeLxwMla7DY1Q: folds
3syOXva630dm1FTdwnuLpw: folds
6alLXQIITA2EZ/lBeym8Dw: folds
4d1rWhpu8DzLmzMbR3QKyA: checks
*** FLOP *** [Th 3c 8c]
4d1rWhpu8DzLmzMbR3QKyA: checks
ieBUmHu5QBR86BArTtK4FQ: bets $2
4d1rWhpu8DzLmzMbR3QKyA: folds
ieBUmHu5QBR86BArTtK4FQ collected $2.40 from pot
*** SUMMARY ***
Total pot $2.50 | Rake $0.10
Board [Th 3c 8c]
Seat 1: 6alLXQIITA2EZ/lBeym8Dw (small blind) folded before Flop
Seat 2: 4d1rWhpu8DzLmzMbR3QKyA (big blind) folded on the Flop
Seat 3: ieBUmHu5QBR86BArTtK4FQ collected ($2.40)
Seat 4: /P4w1pHg2zHYg/4ubJ0dPw folded before Flop (didn't bet)
Seat 5: vX+iYAEINFeLxwMla7DY1Q folded before Flop (didn't bet)
Seat 6: 3syOXva630dm1FTdwnuLpw (button) folded before Flop (didn't bet)



PokerStars Game #59941739964:  Hold'em No Limit ($0.50/$1.00) - 2009/07/01 1:44:38 ET
Table 'DvFb+QVx+4Mvu7tghrGtVg' 6-max Seat #2 is the button
Seat 1: 1ifNpObXxyEaiFAVxWBVNQ ($145.20 in chips)
Seat 2: YMJG+F++3Aj6P8dAWda5fw ($101.50 in chips)
Seat 3: TSuRyAHnUPCFjP7Z0rEE0w ($100 in chips)
Seat 4: hpxXcmRkXXI9HE5+5/j/0Q ($105.90 in chips)
Seat 5: V3iZdcw61nXF3g5hD2RrsQ ($110 in chips)
Seat 6: y27w5IK2WXqmYzS8OU0wKA ($187.50 in chips)
TSuRyAHnUPCFjP7Z0rEE0w: posts small blind $0.50
hpxXcmRkXXI9HE5+5/j/0Q: posts big blind $1
*** HOLE CARDS ***
V3iZdcw61nXF3g5hD2RrsQ: raises $2 to $3
y27w5IK2WXqmYzS8OU0wKA: folds
1ifNpObXxyEaiFAVxWBVNQ: folds
YMJG+F++3Aj6P8dAWda5fw: folds
TSuRyAHnUPCFjP7Z0rEE0w: folds
hpxXcmRkXXI9HE5+5/j/0Q: folds
V3iZdcw61nXF3g5hD2RrsQ collected $2.50 from pot
*** SUMMARY ***
Total pot $2.50 | Rake $0
Seat 1: 1ifNpObXxyEaiFAVxWBVNQ folded before Flop (didn't bet)
Seat 2: YMJG+F++3Aj6P8dAWda5fw (button) folded before Flop (didn't bet)
Seat 3: TSuRyAHnUPCFjP7Z0rEE0w (small blind) folded before Flop
Seat 4: hpxXcmRkXXI9HE5+5/j/0Q (big blind) folded before Flop
Seat 5: V3iZdcw61nXF3g5hD2RrsQ collected ($2.50)
Seat 6: y27w5IK2WXqmYzS8OU0wKA folded before Flop (didn't bet)



PokerStars Game #59941740396:  Hold'em No Limit ($0.50/$1.00) - 2009/07/01 1:44:39 ET
Table 'W/wyObTiXZm+Ckkl3YxcSw' 6-max Seat #4 is the button
Seat 1: eUBBn2R56C1IQ6Cs/vitwg ($183.05 in chips)
Seat 2: oDiBRCaF0QVtd3kO6xZIXw ($80.65 in chips)
Seat 3: 4OO5v3AVduL0tePNx8wk5A ($100 in chips)
Seat 4: rHlMOfR7kpQQxe+PFQz0xQ ($96 in chips)
Seat 5: +OrCjyw70oZhJiD22Mn+bg ($199.50 in chips)
Seat 6: b2a+5TkFf4xJN/Ihhma58Q ($32.30 in chips)
+OrCjyw70oZhJiD22Mn+bg: posts small blind $0.50
b2a+5TkFf4xJN/Ihhma58Q: posts big blind $1
*** HOLE CARDS ***
eUBBn2R56C1IQ6Cs/vitwg: folds
oDiBRCaF0QVtd3kO6xZIXw: calls $1
eUBBn2R56C1IQ6Cs/vitwg leaves the table
4OO5v3AVduL0tePNx8wk5A: folds
rHlMOfR7kpQQxe+PFQz0xQ: folds
+OrCjyw70oZhJiD22Mn+bg: folds
b2a+5TkFf4xJN/Ihhma58Q: raises $1 to $2
oDiBRCaF0QVtd3kO6xZIXw: calls $1
*** FLOP *** [7h Jh 5s]
b2a+5TkFf4xJN/Ihhma58Q: checks
oDiBRCaF0QVtd3kO6xZIXw: checks
*** TURN *** [7h Jh 5s] [Kd]
GHv97X0qtwmxPTR3hKuNvg joins the table at seat #1
b2a+5TkFf4xJN/Ihhma58Q: checks
oDiBRCaF0QVtd3kO6xZIXw: checks
*** RIVER *** [7h Jh 5s Kd] [Ac]
b2a+5TkFf4xJN/Ihhma58Q: bets $4
oDiBRCaF0QVtd3kO6xZIXw: folds
b2a+5TkFf4xJN/Ihhma58Q collected $4.30 from pot
*** SUMMARY ***
Total pot $4.50 | Rake $0.20
Board [7h Jh 5s Kd Ac]
Seat 1: eUBBn2R56C1IQ6Cs/vitwg folded before Flop (didn't bet)
Seat 2: oDiBRCaF0QVtd3kO6xZIXw folded on the River
Seat 3: 4OO5v3AVduL0tePNx8wk5A folded before Flop (didn't bet)
Seat 4: rHlMOfR7kpQQxe+PFQz0xQ (button) folded before Flop (didn't bet)
Seat 5: +OrCjyw70oZhJiD22Mn+bg (small blind) folded before Flop
Seat 6: b2a+5TkFf4xJN/Ihhma58Q (big blind) collected ($4.30)



PokerStars Game #59941740814:  Hold'em No Limit ($0.50/$1.00) - 2009/07/01 1:44:40 ET
Table 'blHlQApStil0OPeQxQxPcw' 9-max Seat #6 is the button
Seat 1: Pp/KTcXkfZKKUHkjyaLTdg ($30.60 in chips)
Seat 2: V138SURkdX8LdVBPKdJJag ($121.35 in chips)
Seat 3: OGgaARGdJQT4awWVNQ957w ($101.50 in chips)
Seat 5: uXrDE6JrIi8BZK1L8oQ9bQ ($35.60 in chips)
Seat 6: vljeiOoWscAIXU0fCuiEBw ($44.65 in chips)
Seat 7: VPF+HjszMvUIpy0CHIwH3A ($19 in chips)
Seat 9: 6XkTu4ahxzHnvjjc1R8YjQ ($151.85 in chips)
VPF+HjszMvUIpy0CHIwH3A: posts small blind $0.50
6XkTu4ahxzHnvjjc1R8YjQ: posts big blind $1
myIxN7otsyr846M539YR8Q: sits out
*** HOLE CARDS ***
Pp/KTcXkfZKKUHkjyaLTdg: folds
Pp/KTcXkfZKKUHkjyaLTdg leaves the table
V138SURkdX8LdVBPKdJJag: folds
OGgaARGdJQT4awWVNQ957w: raises $3 to $4
uXrDE6JrIi8BZK1L8oQ9bQ: folds
vljeiOoWscAIXU0fCuiEBw: folds
VPF+HjszMvUIpy0CHIwH3A: folds
UhwCjxJI7sJbMAXzvZYHpA joins the table at seat #1
6XkTu4ahxzHnvjjc1R8YjQ: folds
OGgaARGdJQT4awWVNQ957w collected $2.50 from pot
OGgaARGdJQT4awWVNQ957w: doesn't show hand
*** SUMMARY ***
Total pot $2.50 | Rake $0
Seat 1: Pp/KTcXkfZKKUHkjyaLTdg folded before Flop (didn't bet)
Seat 2: V138SURkdX8LdVBPKdJJag folded before Flop (didn't bet)
Seat 3: OGgaARGdJQT4awWVNQ957w collected ($2.50)
Seat 5: uXrDE6JrIi8BZK1L8oQ9bQ folded before Flop (didn't bet)
Seat 6: vljeiOoWscAIXU0fCuiEBw (button) folded before Flop (didn't bet)
Seat 7: VPF+HjszMvUIpy0CHIwH3A (small blind) folded before Flop
Seat 9: 6XkTu4ahxzHnvjjc1R8YjQ (big blind) folded before Flop



PokerStars Game #59941742018:  Hold'em No Limit ($0.50/$1.00) - 2009/07/01 1:44:42 ET
Table 'b8oW/dOL7fDza5DfZ/dOJQ' 6-max Seat #6 is the button
Seat 1: NakujTNjHFgzceydFf+E2Q ($50.40 in chips)
Seat 2: TSuRyAHnUPCFjP7Z0rEE0w ($117.50 in chips)
Seat 3: d8WX+9nUHoqlrAGagO0Wow ($32.80 in chips)
Seat 4: 8rDbzImSi1zgxtqtF1pSbA ($10 in chips)
Seat 5: sr/OkkgqNbtgwJf1tmnfNg ($62.75 in chips)
Seat 6: PvfYaKbzMpsmUcbOExckbQ ($160.55 in chips)
NakujTNjHFgzceydFf+E2Q: posts small blind $0.50
TSuRyAHnUPCFjP7Z0rEE0w: posts big blind $1
*** HOLE CARDS ***
d8WX+9nUHoqlrAGagO0Wow: folds
8rDbzImSi1zgxtqtF1pSbA: raises $1 to $2
sr/OkkgqNbtgwJf1tmnfNg: calls $2
PvfYaKbzMpsmUcbOExckbQ: folds
NakujTNjHFgzceydFf+E2Q: folds
TSuRyAHnUPCFjP7Z0rEE0w: folds
*** FLOP *** [5h As 7h]
8rDbzImSi1zgxtqtF1pSbA: bets $2
sr/OkkgqNbtgwJf1tmnfNg: raises $5 to $7
8rDbzImSi1zgxtqtF1pSbA: raises $1 to $8 and is all-in
sr/OkkgqNbtgwJf1tmnfNg: calls $1
*** TURN *** [5h As 7h] [2h]
*** RIVER *** [5h As 7h 2h] [3h]
*** SHOW DOWN ***
8rDbzImSi1zgxtqtF1pSbA: shows [Ad 7d] (two pair, Aces and Sevens)
sr/OkkgqNbtgwJf1tmnfNg: shows [4s 8s] (a straight, Ace to Five)
sr/OkkgqNbtgwJf1tmnfNg collected $20.45 from pot
*** SUMMARY ***
Total pot $21.50 | Rake $1.05
Board [5h As 7h 2h 3h]
Seat 1: NakujTNjHFgzceydFf+E2Q (small blind) folded before Flop
Seat 2: TSuRyAHnUPCFjP7Z0rEE0w (big blind) folded before Flop
Seat 3: d8WX+9nUHoqlrAGagO0Wow folded before Flop (didn't bet)
Seat 4: 8rDbzImSi1zgxtqtF1pSbA showed [Ad 7d] and lost with two pair, Aces and Sevens
Seat 5: sr/OkkgqNbtgwJf1tmnfNg showed [4s 8s] and won ($20.45) with a straight, Ace to Five
Seat 6: PvfYaKbzMpsmUcbOExckbQ (button) folded before Flop (didn't bet)



PokerStars Game #59941743776:  Hold'em No Limit ($0.50/$1.00) - 2009/07/01 1:44:46 ET
Table 'qj0HBN4HhQKogreu1bg7xg' 2-max Seat #2 is the button
Seat 1: NYi6JFscYNrofSXy4sM+Yw ($145.10 in chips)
Seat 2: qtyl8CSb0/4yWdbuEPJejA ($131.20 in chips)
qtyl8CSb0/4yWdbuEPJejA: posts small blind $0.50
NYi6JFscYNrofSXy4sM+Yw: posts big blind $1
*** HOLE CARDS ***
qtyl8CSb0/4yWdbuEPJejA: raises $2 to $3
NYi6JFscYNrofSXy4sM+Yw: calls $2
*** FLOP *** [Kh 9c Jc]
NYi6JFscYNrofSXy4sM+Yw: checks
qtyl8CSb0/4yWdbuEPJejA: checks
*** TURN *** [Kh 9c Jc] [6h]
NYi6JFscYNrofSXy4sM+Yw: bets $3
qtyl8CSb0/4yWdbuEPJejA: raises $3 to $6
NYi6JFscYNrofSXy4sM+Yw: calls $3
*** RIVER *** [Kh 9c Jc 6h] [Qd]
NYi6JFscYNrofSXy4sM+Yw: checks
qtyl8CSb0/4yWdbuEPJejA: bets $7
NYi6JFscYNrofSXy4sM+Yw: folds
qtyl8CSb0/4yWdbuEPJejA collected $17.50 from pot
qtyl8CSb0/4yWdbuEPJejA: doesn't show hand
*** SUMMARY ***
Total pot $18 | Rake $0.50
Board [Kh 9c Jc 6h Qd]
Seat 1: NYi6JFscYNrofSXy4sM+Yw (big blind) folded on the River
Seat 2: qtyl8CSb0/4yWdbuEPJejA (button) (small blind) collected ($17.50)



PokerStars Game #59941744478:  Hold'em No Limit ($0.50/$1.00) - 2009/07/01 1:44:47 ET
Table 'pHrhryH8jPNdQfY62f8v+g' 6-max Seat #1 is the button
Seat 1: 4d1rWhpu8DzLmzMbR3QKyA ($143.95 in chips)
Seat 2: JwCcjZl0bjJzG7hmE0dnTA ($123.10 in chips)
Seat 3: 8oS5O7iD/qnFXFXJrGIgNQ ($116.90 in chips)
Seat 4: 1f3beyIML24UqEMTbWy93g ($43.85 in chips)
Seat 5: d8WX+9nUHoqlrAGagO0Wow ($18.50 in chips)
Seat 6: xAU6q2/cwmby2sxmA8VcmA ($197.80 in chips)
JwCcjZl0bjJzG7hmE0dnTA: posts small blind $0.50
8oS5O7iD/qnFXFXJrGIgNQ: posts big blind $1
*** HOLE CARDS ***
1f3beyIML24UqEMTbWy93g: raises $2 to $3
d8WX+9nUHoqlrAGagO0Wow: folds
xAU6q2/cwmby2sxmA8VcmA: raises $8 to $11
4d1rWhpu8DzLmzMbR3QKyA: folds
JwCcjZl0bjJzG7hmE0dnTA: folds
8oS5O7iD/qnFXFXJrGIgNQ: folds
1f3beyIML24UqEMTbWy93g: folds
xAU6q2/cwmby2sxmA8VcmA collected $7.50 from pot
*** SUMMARY ***
Total pot $7.50 | Rake $0
Seat 1: 4d1rWhpu8DzLmzMbR3QKyA (button) folded before Flop (didn't bet)
Seat 2: JwCcjZl0bjJzG7hmE0dnTA (small blind) folded before Flop
Seat 3: 8oS5O7iD/qnFXFXJrGIgNQ (big blind) folded before Flop
Seat 4: 1f3beyIML24UqEMTbWy93g folded before Flop
Seat 5: d8WX+9nUHoqlrAGagO0Wow folded before Flop (didn't bet)
Seat 6: xAU6q2/cwmby2sxmA8VcmA collected ($7.50)



PokerStars Game #59941744896:  Hold'em No Limit ($0.50/$1.00) - 2009/07/01 1:44:48 ET
Table 'ZFWj23PMihdwrNWv41OG/QtyUh+jyNvrceIQdKMJjQ2weat #5 is the button
Seat 1: rHlMOfR7kpQQxe+PFQz0xQ ($50 in chips)
Seat 2: 0smcry9L0OOTCP+KzIS5SA ($92 in chips)
Seat 3: cWwhvq/+r/w8nkhwrJoekQ ($67.20 in chips)
Seat 4: O5ZesE/6mHyuWWbvkiH/Fg ($71.85 in chips)
Seat 5: j7NIOHLZk7V2o9fOioO5ug ($100 in chips)
Seat 6: u23r4AyKPgHioZ6t7z6qrA ($89 in chips)
u23r4AyKPgHioZ6t7z6qrA: posts small blind $0.50
rHlMOfR7kpQQxe+PFQz0xQ: posts big blind $1
*** HOLE CARDS ***
0smcry9L0OOTCP+KzIS5SA: folds
cWwhvq/+r/w8nkhwrJoekQ: folds
O5ZesE/6mHyuWWbvkiH/Fg: raises $2 to $3
j7NIOHLZk7V2o9fOioO5ug: folds
u23r4AyKPgHioZ6t7z6qrA: folds
rHlMOfR7kpQQxe+PFQz0xQ: folds
u23r4AyKPgHioZ6t7z6qrA leaves the table
O5ZesE/6mHyuWWbvkiH/Fg collected $2.50 from pot
O5ZesE/6mHyuWWbvkiH/Fg: doesn't show hand
*** SUMMARY ***
Total pot $2.50 | Rake $0
Seat 1: rHlMOfR7kpQQxe+PFQz0xQ (big blind) folded before Flop
Seat 2: 0smcry9L0OOTCP+KzIS5SA folded before Flop (didn't bet)
Seat 3: cWwhvq/+r/w8nkhwrJoekQ folded before Flop (didn't bet)
Seat 4: O5ZesE/6mHyuWWbvkiH/Fg collected ($2.50)
Seat 5: j7NIOHLZk7V2o9fOioO5ug (button) folded before Flop (didn't bet)
Seat 6: u23r4AyKPgHioZ6t7z6qrA (small blind) folded before Flop



PokerStars Game #59941745164:  Hold'em No Limit ($0.50/$1.00) - 2009/07/01 1:44:48 ET
Table 'GxCPo/gd3OSthkYrAxJngg' 6-max Seat #6 is the button
Seat 1: sH8BpAFP+jGFxCgVpD1Lew ($240.75 in chips)
Seat 2: YExX2paeIHrmfIwV1ivM/w ($61.60 in chips)
Seat 3: idVgoPAdspFPCzee6aF9Pg ($136 in chips)
Seat 4: YMJG+F++3Aj6P8dAWda5fw ($209.75 in chips)
Seat 5: vX+iYAEINFeLxwMla7DY1Q ($98 in chips)
Seat 6: 4d1rWhpu8DzLmzMbR3QKyA ($100 in chips)
sH8BpAFP+jGFxCgVpD1Lew: posts small blind $0.50
YExX2paeIHrmfIwV1ivM/w: posts big blind $1
*** HOLE CARDS ***
idVgoPAdspFPCzee6aF9Pg: raises $2 to $3
YMJG+F++3Aj6P8dAWda5fw: folds
vX+iYAEINFeLxwMla7DY1Q: folds
4d1rWhpu8DzLmzMbR3QKyA: folds
sH8BpAFP+jGFxCgVpD1Lew: folds
YExX2paeIHrmfIwV1ivM/w: folds
idVgoPAdspFPCzee6aF9Pg collected $2.50 from pot
*** SUMMARY ***
Total pot $2.50 | Rake $0
Seat 1: sH8BpAFP+jGFxCgVpD1Lew (small blind) folded before Flop
Seat 2: YExX2paeIHrmfIwV1ivM/w (big blind) folded before Flop
Seat 3: idVgoPAdspFPCzee6aF9Pg collected ($2.50)
Seat 4: YMJG+F++3Aj6P8dAWda5fw folded before Flop (didn't bet)
Seat 5: vX+iYAEINFeLxwMla7DY1Q folded before Flop (didn't bet)
Seat 6: 4d1rWhpu8DzLmzMbR3QKyA (button) folded before Flop (didn't bet)



PokerStars Game #59941744950:  Hold'em No Limit ($0.50/$1.00) - 2009/07/01 1:44:48 ET
Table 'MUPc8FEpe/nR0BKSeReX6Q' 6-max Seat #5 is the button
Seat 1: qhkK6+yCciTRd+rCFEbnEQ ($83.70 in chips)
Seat 2: xAU6q2/cwmby2sxmA8VcmA ($103.70 in chips)
Seat 3: wx3sQGkVi2x9wJXuWNHPBw ($286.15 in chips)
Seat 4: r4lpoh2BJZ8S6zyQv1JeSw ($110 in chips)
Seat 5: y27w5IK2WXqmYzS8OU0wKA ($131.05 in chips)
Seat 6: ene3nLSnQ4N961iBaUsSmA ($100 in chips)
ene3nLSnQ4N961iBaUsSmA: posts small blind $0.50
qhkK6+yCciTRd+rCFEbnEQ: posts big blind $1
*** HOLE CARDS ***
xAU6q2/cwmby2sxmA8VcmA: folds
wx3sQGkVi2x9wJXuWNHPBw: folds
r4lpoh2BJZ8S6zyQv1JeSw: folds
y27w5IK2WXqmYzS8OU0wKA: folds
ene3nLSnQ4N961iBaUsSmA: raises $2 to $3
qhkK6+yCciTRd+rCFEbnEQ: calls $2
*** FLOP *** [Jd Ts 8c]
ene3nLSnQ4N961iBaUsSmA: bets $4
qhkK6+yCciTRd+rCFEbnEQ: calls $4
*** TURN *** [Jd Ts 8c] [Kd]
ene3nLSnQ4N961iBaUsSmA: bets $9
qhkK6+yCciTRd+rCFEbnEQ: folds
ene3nLSnQ4N961iBaUsSmA collected $13.35 from pot
ene3nLSnQ4N961iBaUsSmA: doesn't show hand
*** SUMMARY ***
Total pot $14 | Rake $0.65
Board [Jd Ts 8c Kd]
Seat 1: qhkK6+yCciTRd+rCFEbnEQ (big blind) folded on the Turn
Seat 2: xAU6q2/cwmby2sxmA8VcmA folded before Flop (didn't bet)
Seat 3: wx3sQGkVi2x9wJXuWNHPBw folded before Flop (didn't bet)
Seat 4: r4lpoh2BJZ8S6zyQv1JeSw folded before Flop (didn't bet)
Seat 5: y27w5IK2WXqmYzS8OU0wKA (button) folded before Flop (didn't bet)
Seat 6: ene3nLSnQ4N961iBaUsSmA (small blind) collected ($13.35)



PokerStars Game #59941745166:  Hold'em No Limit ($0.50/$1.00) - 2009/07/01 1:44:48 ET
Table 'fZjVbKj9D8yOB+Rj7NaP/A' 9-max Seat #7 is the button
Seat 2: PTAFYDIUSsG+SArbxNl+Aw ($112 in chips)
Seat 3: yAbu2QsRPVcjPbqlf/jDxw ($100 in chips)
Seat 4: likAqWsWycNGwDQIcHN6GA ($99 in chips)
Seat 5: PkGfq5xrSlNsujKaG/HF4Q ($100 in chips)
Seat 6: OvwYHV65yUbgdBjSmo1+5g ($146.95 in chips)
Seat 7: SyS20PAm3RpT6uLBsGkwOA ($105.20 in chips)
Seat 8: EVvb0huXeMB7dnOAiO4ggA ($46.50 in chips)
Seat 9: qheQay5YvP2DMAb3OUSxtw ($143.60 in chips)
EVvb0huXeMB7dnOAiO4ggA: posts small blind $0.50
qheQay5YvP2DMAb3OUSxtw: posts big blind $1
kiakSwxX0e64PwYGAPQvLw: sits out
*** HOLE CARDS ***
PTAFYDIUSsG+SArbxNl+Aw: folds
yAbu2QsRPVcjPbqlf/jDxw: folds
likAqWsWycNGwDQIcHN6GA: raises $2 to $3
PkGfq5xrSlNsujKaG/HF4Q: folds
OvwYHV65yUbgdBjSmo1+5g: folds
SyS20PAm3RpT6uLBsGkwOA: raises $7 to $10
EVvb0huXeMB7dnOAiO4ggA: folds
qheQay5YvP2DMAb3OUSxtw: folds
likAqWsWycNGwDQIcHN6GA: calls $7
*** FLOP *** [Js Ac 9s]
likAqWsWycNGwDQIcHN6GA: checks
SyS20PAm3RpT6uLBsGkwOA: bets $20
likAqWsWycNGwDQIcHN6GA: folds
SyS20PAm3RpT6uLBsGkwOA collected $20.45 from pot
*** SUMMARY ***
Total pot $21.50 | Rake $1.05
Board [Js Ac 9s]
Seat 2: PTAFYDIUSsG+SArbxNl+Aw folded before Flop (didn't bet)
Seat 3: yAbu2QsRPVcjPbqlf/jDxw folded before Flop (didn't bet)
Seat 4: likAqWsWycNGwDQIcHN6GA folded on the Flop
Seat 5: PkGfq5xrSlNsujKaG/HF4Q folded before Flop (didn't bet)
Seat 6: OvwYHV65yUbgdBjSmo1+5g folded before Flop (didn't bet)
Seat 7: SyS20PAm3RpT6uLBsGkwOA (button) collected ($20.45)
Seat 8: EVvb0huXeMB7dnOAiO4ggA (small blind) folded before Flop
Seat 9: qheQay5YvP2DMAb3OUSxtw (big blind) folded before Flop



PokerStars Game #59941745450:  Hold'em No Limit ($0.50/$1.00) - 2009/07/01 1:44:49 ET
Table '305hiksPPCCdC6V2LNsO5w' 6-max Seat #2 is the button
Seat 2: j7NIOHLZk7V2o9fOioO5ug ($158.70 in chips)
Seat 3: +zIVjZKLpcidfRHgVZW8lA ($36.20 in chips)
Seat 5: +Nt3OPk3XR9SKjZgm2CexQ ($100 in chips)
Seat 6: 9/Tq8dw7kWW68uN8bFupXg ($18.90 in chips)
uJVSceLggtsrJya+WtmUEA has returned
+zIVjZKLpcidfRHgVZW8lA: posts small blind $0.50
+Nt3OPk3XR9SKjZgm2CexQ: posts big blind $1
*** HOLE CARDS ***
9/Tq8dw7kWW68uN8bFupXg: folds
j7NIOHLZk7V2o9fOioO5ug: raises $2 to $3
+zIVjZKLpcidfRHgVZW8lA: folds
+Nt3OPk3XR9SKjZgm2CexQ: folds
j7NIOHLZk7V2o9fOioO5ug collected $2.50 from pot
j7NIOHLZk7V2o9fOioO5ug: doesn't show hand
*** SUMMARY ***
Total pot $2.50 | Rake $0
Seat 2: j7NIOHLZk7V2o9fOioO5ug (button) collected ($2.50)
Seat 3: +zIVjZKLpcidfRHgVZW8lA (small blind) folded before Flop
Seat 5: +Nt3OPk3XR9SKjZgm2CexQ (big blind) folded before Flop
Seat 6: 9/Tq8dw7kWW68uN8bFupXg folded before Flop (didn't bet)



PokerStars Game #59941746234:  Hold'em No Limit ($0.50/$1.00) - 2009/07/01 1:44:50 ET
Table '6YvsYDPNIDx2v5z3bJnwZQ' 9-max Seat #2 is the button
Seat 1: Ogn4JDV3mp4ZDKO49IFzKA ($19.80 in chips)
Seat 2: TAfo4veNRaRlzDXMMYS3Jg ($17 in chips)
Seat 3: K6OJDis3KfxSm/PKlkATUA ($57.05 in chips)
Seat 4: kEr5NYB+JIG5+szcYMr6hA ($70 in chips)
Seat 5: mBRWbnUl8diyBO1qTJaNzw ($136.25 in chips)
Seat 8: PSFxpXgPedVZyHSu2Zhb7Q ($105.25 in chips)
Seat 9: myIxN7otsyr846M539YR8Q ($18.50 in chips)
K6OJDis3KfxSm/PKlkATUA: posts small blind $0.50
kEr5NYB+JIG5+szcYMr6hA: posts big blind $1
aM6BB+PnB/rDUr2dbRda+A: sits out
*** HOLE CARDS ***
mBRWbnUl8diyBO1qTJaNzw: folds
PSFxpXgPedVZyHSu2Zhb7Q: calls $1
myIxN7otsyr846M539YR8Q: folds
Ogn4JDV3mp4ZDKO49IFzKA: folds
TAfo4veNRaRlzDXMMYS3Jg: folds
K6OJDis3KfxSm/PKlkATUA: calls $0.50
kEr5NYB+JIG5+szcYMr6hA: checks
*** FLOP *** [5c 6c Qs]
K6OJDis3KfxSm/PKlkATUA: checks
kEr5NYB+JIG5+szcYMr6hA: checks
PSFxpXgPedVZyHSu2Zhb7Q: checks
*** TURN *** [5c 6c Qs] [3d]
K6OJDis3KfxSm/PKlkATUA: checks
kEr5NYB+JIG5+szcYMr6hA: checks
PSFxpXgPedVZyHSu2Zhb7Q: checks
*** RIVER *** [5c 6c Qs 3d] [2s]
K6OJDis3KfxSm/PKlkATUA: checks
kEr5NYB+JIG5+szcYMr6hA: checks
PSFxpXgPedVZyHSu2Zhb7Q: checks
*** SHOW DOWN ***
K6OJDis3KfxSm/PKlkATUA: shows [Td 7c] (high card Queen)
kEr5NYB+JIG5+szcYMr6hA: shows [Ac 3h] (a pair of Threes)
PSFxpXgPedVZyHSu2Zhb7Q: mucks hand
kEr5NYB+JIG5+szcYMr6hA collected $2.85 from pot
*** SUMMARY ***
Total pot $3 | Rake $0.15
Board [5c 6c Qs 3d 2s]
Seat 1: Ogn4JDV3mp4ZDKO49IFzKA folded before Flop (didn't bet)
Seat 2: TAfo4veNRaRlzDXMMYS3Jg (button) folded before Flop (didn't bet)
Seat 3: K6OJDis3KfxSm/PKlkATUA (small blind) showed [Td 7c] and lost with high card Queen
Seat 4: kEr5NYB+JIG5+szcYMr6hA (big blind) showed [Ac 3h] and won ($2.85) with a pair of Threes
Seat 5: mBRWbnUl8diyBO1qTJaNzw folded before Flop (didn't bet)
Seat 8: PSFxpXgPedVZyHSu2Zhb7Q mucked
Seat 9: myIxN7otsyr846M539YR8Q folded before Flop (didn't bet)



PokerStars Game #59941746032:  Hold'em No Limit ($0.50/$1.00) - 2009/07/01 1:44:50 ET
Table 'hugOjcwJvzEwZbK7tyiWuQ' 9-max Seat #6 is the button
Seat 1: S3Ex8K7v6xm5jqjRM7Fl3w ($21.35 in chips)
Seat 2: r27C1nIV4NS4+qbnrgBQSw ($278.10 in chips)
Seat 3: c/6hFCyfLNRn3VFvCeQ1ng ($31.55 in chips)
Seat 4: UWB3oeddt/GObx2Mix2Anw ($194.75 in chips)
Seat 6: gUUvmqdVlmvpal6B8nYrmg ($102.45 in chips)
Seat 7: FL3MrLspcF23LYvC4ipBOA ($108.80 in chips)
Seat 8: /zy+DB4S5fUQUSfZWFzYGw ($121.55 in chips)
Seat 9: W8P9bUKCs43TO1xHm0dL6w ($105.30 in chips)
FL3MrLspcF23LYvC4ipBOA: posts small blind $0.50
/zy+DB4S5fUQUSfZWFzYGw: posts big blind $1
aM6BB+PnB/rDUr2dbRda+A: sits out
*** HOLE CARDS ***
W8P9bUKCs43TO1xHm0dL6w: folds
W8P9bUKCs43TO1xHm0dL6w leaves the table
S3Ex8K7v6xm5jqjRM7Fl3w: folds
r27C1nIV4NS4+qbnrgBQSw: raises $3 to $4
c/6hFCyfLNRn3VFvCeQ1ng: calls $4
UWB3oeddt/GObx2Mix2Anw: folds
ri8CLkX3e9JF34dQNbsHGA joins the table at seat #9
gUUvmqdVlmvpal6B8nYrmg: folds
FL3MrLspcF23LYvC4ipBOA: folds
/zy+DB4S5fUQUSfZWFzYGw: folds
*** FLOP *** [5d 9c Tc]
r27C1nIV4NS4+qbnrgBQSw: bets $7
c/6hFCyfLNRn3VFvCeQ1ng: folds
r27C1nIV4NS4+qbnrgBQSw collected $9.05 from pot
*** SUMMARY ***
Total pot $9.50 | Rake $0.45
Board [5d 9c Tc]
Seat 1: S3Ex8K7v6xm5jqjRM7Fl3w folded before Flop (didn't bet)
Seat 2: r27C1nIV4NS4+qbnrgBQSw collected ($9.05)
Seat 3: c/6hFCyfLNRn3VFvCeQ1ng folded on the Flop
Seat 4: UWB3oeddt/GObx2Mix2Anw folded before Flop (didn't bet)
Seat 6: gUUvmqdVlmvpal6B8nYrmg (button) folded before Flop (didn't bet)
Seat 7: FL3MrLspcF23LYvC4ipBOA (small blind) folded before Flop
Seat 8: /zy+DB4S5fUQUSfZWFzYGw (big blind) folded before Flop
Seat 9: W8P9bUKCs43TO1xHm0dL6w folded before Flop (didn't bet)



PokerStars Game #59941746858:  Hold'em No Limit ($0.50/$1.00) - 2009/07/01 1:44:52 ET
Table 'fTlPiCj0utgzC/5io+I7ew' 6-max Seat #3 is the button
Seat 1: YMJG+F++3Aj6P8dAWda5fw ($100 in chips)
Seat 2: qVr1nl3dy2xXPqS8UpTDlA ($40.25 in chips)
Seat 3: Z2fXsGcjl+Eax+RzOgwOmg ($130 in chips)
Seat 4: uJVSceLggtsrJya+WtmUEA ($269.85 in chips)
Seat 5: XUk5GQsfNFpHvaToDZ0rZA ($39.05 in chips)
Seat 6: y27w5IK2WXqmYzS8OU0wKA ($100 in chips)
uJVSceLggtsrJya+WtmUEA: posts small blind $0.50
XUk5GQsfNFpHvaToDZ0rZA: posts big blind $1
*** HOLE CARDS ***
uJVSceLggtsrJya+WtmUEA said, "hahahahaha"
y27w5IK2WXqmYzS8OU0wKA: folds
YMJG+F++3Aj6P8dAWda5fw: folds
qVr1nl3dy2xXPqS8UpTDlA: folds
Z2fXsGcjl+Eax+RzOgwOmg: folds
uJVSceLggtsrJya+WtmUEA: folds
XUk5GQsfNFpHvaToDZ0rZA collected $1 from pot
*** SUMMARY ***
Total pot $1 | Rake $0
Seat 1: YMJG+F++3Aj6P8dAWda5fw folded before Flop (didn't bet)
Seat 2: qVr1nl3dy2xXPqS8UpTDlA folded before Flop (didn't bet)
Seat 3: Z2fXsGcjl+Eax+RzOgwOmg (button) folded before Flop (didn't bet)
Seat 4: uJVSceLggtsrJya+WtmUEA (small blind) folded before Flop
Seat 5: XUk5GQsfNFpHvaToDZ0rZA (big blind) collected ($1)
Seat 6: y27w5IK2WXqmYzS8OU0wKA folded before Flop (didn't bet)



PokerStars Game #59941747326:  Hold'em No Limit ($0.50/$1.00) - 2009/07/01 1:44:53 ET
Table 'vs/5jr6ciwjVQ5+Soc+u2A' 6-max Seat #1 is the button
Seat 1: J798qwLuvXyq0BbzsIjOrA ($221.50 in chips)
Seat 2: lXX4W7m3u++JiSOZ46yVMQ ($98 in chips)
Seat 3: Ws/3Uo3rQIk8hLgW0P+2xA ($101.50 in chips)
Seat 4: 0smcry9L0OOTCP+KzIS5SA ($86 in chips)
Seat 5: +Nt3OPk3XR9SKjZgm2CexQ ($131.35 in chips)
Seat 6: Z2fXsGcjl+Eax+RzOgwOmg ($122.50 in chips)
lXX4W7m3u++JiSOZ46yVMQ: posts small blind $0.50
Ws/3Uo3rQIk8hLgW0P+2xA: posts big blind $1
*** HOLE CARDS ***
0smcry9L0OOTCP+KzIS5SA: folds
+Nt3OPk3XR9SKjZgm2CexQ: folds
Z2fXsGcjl+Eax+RzOgwOmg: folds
J798qwLuvXyq0BbzsIjOrA: folds
lXX4W7m3u++JiSOZ46yVMQ: calls $0.50
Ws/3Uo3rQIk8hLgW0P+2xA: checks
*** FLOP *** [Jc 5h 3s]
lXX4W7m3u++JiSOZ46yVMQ: checks
Ws/3Uo3rQIk8hLgW0P+2xA: checks
*** TURN *** [Jc 5h 3s] [As]
lXX4W7m3u++JiSOZ46yVMQ: checks
Ws/3Uo3rQIk8hLgW0P+2xA: bets $2
lXX4W7m3u++JiSOZ46yVMQ: folds
Ws/3Uo3rQIk8hLgW0P+2xA collected $1.90 from pot
*** SUMMARY ***
Total pot $2 | Rake $0.10
Board [Jc 5h 3s As]
Seat 1: J798qwLuvXyq0BbzsIjOrA (button) folded before Flop (didn't bet)
Seat 2: lXX4W7m3u++JiSOZ46yVMQ (small blind) folded on the Turn
Seat 3: Ws/3Uo3rQIk8hLgW0P+2xA (big blind) collected ($1.90)
Seat 4: 0smcry9L0OOTCP+KzIS5SA folded before Flop (didn't bet)
Seat 5: +Nt3OPk3XR9SKjZgm2CexQ folded before Flop (didn't bet)
Seat 6: Z2fXsGcjl+Eax+RzOgwOmg folded before Flop (didn't bet)



PokerStars Game #59941747294:  Hold'em No Limit ($0.50/$1.00) - 2009/07/01 1:44:53 ET
Table 'rmZfTK+oSebeUPJNbWhdAA' 6-max Seat #2 is the button
Seat 1: xAU6q2/cwmby2sxmA8VcmA ($135.80 in chips)
Seat 2: z7O9PO/WEcqRouIydFhS9Q ($206.95 in chips)
Seat 3: BCEV3COoKY607AzLWayfRA ($208.70 in chips)
Seat 4: 1/mIuXfgx1ZyVkodrmfQDw ($154.85 in chips)
Seat 5: UOHYuj23MyK9R8ciY2t6FA ($100 in chips)
Seat 6: j7NIOHLZk7V2o9fOioO5ug ($100.70 in chips)
BCEV3COoKY607AzLWayfRA: posts small blind $0.50
1/mIuXfgx1ZyVkodrmfQDw: posts big blind $1
*** HOLE CARDS ***
UOHYuj23MyK9R8ciY2t6FA: folds
j7NIOHLZk7V2o9fOioO5ug: folds
xAU6q2/cwmby2sxmA8VcmA: folds
z7O9PO/WEcqRouIydFhS9Q: folds
BCEV3COoKY607AzLWayfRA: folds
1/mIuXfgx1ZyVkodrmfQDw collected $1 from pot
1/mIuXfgx1ZyVkodrmfQDw: doesn't show hand
*** SUMMARY ***
Total pot $1 | Rake $0
Seat 1: xAU6q2/cwmby2sxmA8VcmA folded before Flop (didn't bet)
Seat 2: z7O9PO/WEcqRouIydFhS9Q (button) folded before Flop (didn't bet)
Seat 3: BCEV3COoKY607AzLWayfRA (small blind) folded before Flop
Seat 4: 1/mIuXfgx1ZyVkodrmfQDw (big blind) collected ($1)
Seat 5: UOHYuj23MyK9R8ciY2t6FA folded before Flop (didn't bet)
Seat 6: j7NIOHLZk7V2o9fOioO5ug folded before Flop (didn't bet)



PokerStars Game #59941748140:  Hold'em No Limit ($0.50/$1.00) - 2009/07/01 1:44:54 ET
Table 'gxFK0BVUD7cupu2uyRUZJg' 6-max Seat #1 is the button
Seat 1: M+X3uChmP6R63IwijVjgTg ($414.40 in chips)
Seat 2: hpxXcmRkXXI9HE5+5/j/0Q ($100 in chips)
Seat 3: Z2fXsGcjl+Eax+RzOgwOmg ($117.10 in chips)
Seat 4: Hcr4S4Nbkj5idKsvYK/eqQ ($100 in chips)
Seat 5: 0smcry9L0OOTCP+KzIS5SA ($210 in chips)
Seat 6: dYyb6/42PMC8aNFlm/eBeQ ($36.25 in chips)
hpxXcmRkXXI9HE5+5/j/0Q: posts small blind $0.50
Z2fXsGcjl+Eax+RzOgwOmg: posts big blind $1
*** HOLE CARDS ***
Hcr4S4Nbkj5idKsvYK/eqQ: folds
0smcry9L0OOTCP+KzIS5SA: folds
dYyb6/42PMC8aNFlm/eBeQ has timed out
dYyb6/42PMC8aNFlm/eBeQ: folds
dYyb6/42PMC8aNFlm/eBeQ is sitting out
dYyb6/42PMC8aNFlm/eBeQ has returned
M+X3uChmP6R63IwijVjgTg: calls $1
hpxXcmRkXXI9HE5+5/j/0Q: raises $4 to $5
Z2fXsGcjl+Eax+RzOgwOmg: folds
M+X3uChmP6R63IwijVjgTg: calls $4
*** FLOP *** [2s Tc Qh]
hpxXcmRkXXI9HE5+5/j/0Q: bets $8
M+X3uChmP6R63IwijVjgTg: calls $8
*** TURN *** [2s Tc Qh] [3d]
hpxXcmRkXXI9HE5+5/j/0Q: bets $20
M+X3uChmP6R63IwijVjgTg: calls $20
*** RIVER *** [2s Tc Qh 3d] [6c]
hpxXcmRkXXI9HE5+5/j/0Q: checks
M+X3uChmP6R63IwijVjgTg: checks
*** SHOW DOWN ***
hpxXcmRkXXI9HE5+5/j/0Q: shows [As Qc] (a pair of Queens)
M+X3uChmP6R63IwijVjgTg: mucks hand
hpxXcmRkXXI9HE5+5/j/0Q collected $64 from pot
*** SUMMARY ***
Total pot $67 | Rake $3
Board [2s Tc Qh 3d 6c]
Seat 1: M+X3uChmP6R63IwijVjgTg (button) mucked
Seat 2: hpxXcmRkXXI9HE5+5/j/0Q (small blind) showed [As Qc] and won ($64) with a pair of Queens
Seat 3: Z2fXsGcjl+Eax+RzOgwOmg (big blind) folded before Flop
Seat 4: Hcr4S4Nbkj5idKsvYK/eqQ folded before Flop (didn't bet)
Seat 5: 0smcry9L0OOTCP+KzIS5SA folded before Flop (didn't bet)
Seat 6: dYyb6/42PMC8aNFlm/eBeQ folded before Flop (didn't bet)



PokerStars Game #59941748714:  Hold'em No Limit ($0.50/$1.00) - 2009/07/01 1:44:55 ET
Table '3T4owEKJKyGTMePwrv50FQ' 9-max Seat #1 is the button
Seat 1: OGgaARGdJQT4awWVNQ957w ($100 in chips)
Seat 2: t+Id2O6herCLgwnC4m49PA ($35.75 in chips)
Seat 3: DOLzOcBTZYcph5jEfKFWuQ ($106.40 in chips)
Seat 5: mMc/PBpqlN24gdi3C/1tOw ($50.25 in chips)
Seat 6: V138SURkdX8LdVBPKdJJag ($105.50 in chips)
Seat 7: 1862487932 ($104 in chips)
Seat 8: bLbSOSmSOnqE0iTcH/5dxA ($197 in chips)
Seat 9: 61sfw5QTu62YYIt68OsdrA ($83.25 in chips)
t+Id2O6herCLgwnC4m49PA: posts small blind $0.50
DOLzOcBTZYcph5jEfKFWuQ: posts big blind $1
kiakSwxX0e64PwYGAPQvLw: sits out
*** HOLE CARDS ***
mMc/PBpqlN24gdi3C/1tOw: folds
V138SURkdX8LdVBPKdJJag: folds
1862487932: raises $2.50 to $3.50
bLbSOSmSOnqE0iTcH/5dxA: folds
61sfw5QTu62YYIt68OsdrA: folds
OGgaARGdJQT4awWVNQ957w: folds
t+Id2O6herCLgwnC4m49PA: folds
DOLzOcBTZYcph5jEfKFWuQ: folds
1862487932 collected $2.50 from pot
1862487932: doesn't show hand
*** SUMMARY ***
Total pot $2.50 | Rake $0
Seat 1: OGgaARGdJQT4awWVNQ957w (button) folded before Flop (didn't bet)
Seat 2: t+Id2O6herCLgwnC4m49PA (small blind) folded before Flop
Seat 3: DOLzOcBTZYcph5jEfKFWuQ (big blind) folded before Flop
Seat 5: mMc/PBpqlN24gdi3C/1tOw folded before Flop (didn't bet)
Seat 6: V138SURkdX8LdVBPKdJJag folded before Flop (didn't bet)
Seat 7: 1862487932 collected ($2.50)
Seat 8: bLbSOSmSOnqE0iTcH/5dxA folded before Flop (didn't bet)
Seat 9: 61sfw5QTu62YYIt68OsdrA folded before Flop (didn't bet)



PokerStars Game #59941749568:  Hold'em No Limit ($0.50/$1.00) - 2009/07/01 1:44:57 ET
Table 'N2bNCDHL96aCQDvZIh+yQQ' 6-max Seat #1 is the button
Seat 1: Jjgflx10PVjcLkziEmLhSA ($92.25 in chips)
Seat 2: y27w5IK2WXqmYzS8OU0wKA ($129.15 in chips)
Seat 3: VB7TtBnfmT3JTA/cCL6dJg ($100 in chips)
Seat 4: uCqEjnxh2/vFBjKYkfTOkw ($157.80 in chips)
Seat 5: ene3nLSnQ4N961iBaUsSmA ($150.50 in chips)
Seat 6: idVgoPAdspFPCzee6aF9Pg ($100 in chips)
y27w5IK2WXqmYzS8OU0wKA: posts small blind $0.50
VB7TtBnfmT3JTA/cCL6dJg: posts big blind $1
*** HOLE CARDS ***
uCqEjnxh2/vFBjKYkfTOkw: calls $1
ene3nLSnQ4N961iBaUsSmA: folds
idVgoPAdspFPCzee6aF9Pg: folds
Jjgflx10PVjcLkziEmLhSA: folds
y27w5IK2WXqmYzS8OU0wKA: folds
VB7TtBnfmT3JTA/cCL6dJg: checks
*** FLOP *** [Ts 3s Td]
VB7TtBnfmT3JTA/cCL6dJg: checks
uCqEjnxh2/vFBjKYkfTOkw: bets $2
VB7TtBnfmT3JTA/cCL6dJg: folds
uCqEjnxh2/vFBjKYkfTOkw collected $2.40 from pot
uCqEjnxh2/vFBjKYkfTOkw: doesn't show hand
*** SUMMARY ***
Total pot $2.50 | Rake $0.10
Board [Ts 3s Td]
Seat 1: Jjgflx10PVjcLkziEmLhSA (button) folded before Flop (didn't bet)
Seat 2: y27w5IK2WXqmYzS8OU0wKA (small blind) folded before Flop
Seat 3: VB7TtBnfmT3JTA/cCL6dJg (big blind) folded on the Flop
Seat 4: uCqEjnxh2/vFBjKYkfTOkw collected ($2.40)
Seat 5: ene3nLSnQ4N961iBaUsSmA folded before Flop (didn't bet)
Seat 6: idVgoPAdspFPCzee6aF9Pg folded before Flop (didn't bet)



PokerStars Game #59941752276:  Hold'em No Limit ($0.50/$1.00) - 2009/07/01 1:45:02 ET
Table '/RZcOwpZpHQ+OwPwjsbnRw' 6-max Seat #2 is the button
Seat 1: +uSzP8Jwnw7sKfQ4s66b7w ($108.65 in chips)
Seat 2: Z2fXsGcjl+Eax+RzOgwOmg ($102.65 in chips)
Seat 3: LJMw/I77xpnw0R5T4HnMUg ($83.55 in chips)
Seat 4: j7NIOHLZk7V2o9fOioO5ug ($113.20 in chips)
Seat 5: wx3sQGkVi2x9wJXuWNHPBw ($167.25 in chips)
Seat 6: o3YLm/rSY916m/on1VjXPA ($204 in chips)
LJMw/I77xpnw0R5T4HnMUg: posts small blind $0.50
j7NIOHLZk7V2o9fOioO5ug: posts big blind $1
*** HOLE CARDS ***
wx3sQGkVi2x9wJXuWNHPBw: folds
o3YLm/rSY916m/on1VjXPA: raises $2 to $3
+uSzP8Jwnw7sKfQ4s66b7w: folds
Z2fXsGcjl+Eax+RzOgwOmg: folds
LJMw/I77xpnw0R5T4HnMUg: folds
j7NIOHLZk7V2o9fOioO5ug: folds
o3YLm/rSY916m/on1VjXPA collected $2.50 from pot
o3YLm/rSY916m/on1VjXPA: doesn't show hand
*** SUMMARY ***
Total pot $2.50 | Rake $0
Seat 1: +uSzP8Jwnw7sKfQ4s66b7w folded before Flop (didn't bet)
Seat 2: Z2fXsGcjl+Eax+RzOgwOmg (button) folded before Flop (didn't bet)
Seat 3: LJMw/I77xpnw0R5T4HnMUg (small blind) folded before Flop
Seat 4: j7NIOHLZk7V2o9fOioO5ug (big blind) folded before Flop
Seat 5: wx3sQGkVi2x9wJXuWNHPBw folded before Flop (didn't bet)
Seat 6: o3YLm/rSY916m/on1VjXPA collected ($2.50)



PokerStars Game #59941752214:  Hold'em No Limit ($0.50/$1.00) - 2009/07/01 1:45:02 ET
Table 'blHlQApStil0OPeQxQxPcw' 9-max Seat #7 is the button
Seat 1: UhwCjxJI7sJbMAXzvZYHpA ($100 in chips)
Seat 2: V138SURkdX8LdVBPKdJJag ($121.35 in chips)
Seat 3: OGgaARGdJQT4awWVNQ957w ($103 in chips)
Seat 5: uXrDE6JrIi8BZK1L8oQ9bQ ($35.60 in chips)
Seat 6: vljeiOoWscAIXU0fCuiEBw ($44.65 in chips)
Seat 7: VPF+HjszMvUIpy0CHIwH3A ($18.50 in chips)
Seat 9: 6XkTu4ahxzHnvjjc1R8YjQ ($150.85 in chips)
6XkTu4ahxzHnvjjc1R8YjQ: posts small blind $0.50
UhwCjxJI7sJbMAXzvZYHpA: posts big blind $1
myIxN7otsyr846M539YR8Q: sits out
*** HOLE CARDS ***
V138SURkdX8LdVBPKdJJag: folds
OGgaARGdJQT4awWVNQ957w: folds
uXrDE6JrIi8BZK1L8oQ9bQ: folds
vljeiOoWscAIXU0fCuiEBw: folds
VPF+HjszMvUIpy0CHIwH3A: folds
6XkTu4ahxzHnvjjc1R8YjQ: folds
UhwCjxJI7sJbMAXzvZYHpA collected $1 from pot
UhwCjxJI7sJbMAXzvZYHpA: doesn't show hand
*** SUMMARY ***
Total pot $1 | Rake $0
Seat 1: UhwCjxJI7sJbMAXzvZYHpA (big blind) collected ($1)
Seat 2: V138SURkdX8LdVBPKdJJag folded before Flop (didn't bet)
Seat 3: OGgaARGdJQT4awWVNQ957w folded before Flop (didn't bet)
Seat 5: uXrDE6JrIi8BZK1L8oQ9bQ folded before Flop (didn't bet)
Seat 6: vljeiOoWscAIXU0fCuiEBw folded before Flop (didn't bet)
Seat 7: VPF+HjszMvUIpy0CHIwH3A (button) folded before Flop (didn't bet)
Seat 9: 6XkTu4ahxzHnvjjc1R8YjQ (small blind) folded before Flop



PokerStars Game #59941752438:  Hold'em No Limit ($0.50/$1.00) - 2009/07/01 1:45:03 ET
Table 'mmbQQVBTrPdE+wy+s+9VPA' 6-max Seat #1 is the button
Seat 1: zyP4SPoWZnKUfTvIRLCVog ($71.25 in chips)
Seat 2: XK4Qsl+DA8gAJyg85/zBIw ($41.25 in chips)
Seat 3: wx3sQGkVi2x9wJXuWNHPBw ($235.60 in chips)
Seat 4: V3iZdcw61nXF3g5hD2RrsQ ($100 in chips)
Seat 5: YMJG+F++3Aj6P8dAWda5fw ($126.70 in chips)
Seat 6: UOHYuj23MyK9R8ciY2t6FA ($100 in chips)
XK4Qsl+DA8gAJyg85/zBIw: posts small blind $0.50
wx3sQGkVi2x9wJXuWNHPBw: posts big blind $1
*** HOLE CARDS ***
V3iZdcw61nXF3g5hD2RrsQ: raises $2 to $3
YMJG+F++3Aj6P8dAWda5fw: folds
UOHYuj23MyK9R8ciY2t6FA: folds
zyP4SPoWZnKUfTvIRLCVog: raises $4 to $7
XK4Qsl+DA8gAJyg85/zBIw: folds
wx3sQGkVi2x9wJXuWNHPBw: folds
V3iZdcw61nXF3g5hD2RrsQ: calls $4
*** FLOP *** [Jc Qd Jd]
V3iZdcw61nXF3g5hD2RrsQ: checks
zyP4SPoWZnKUfTvIRLCVog: bets $5
V3iZdcw61nXF3g5hD2RrsQ: calls $5
*** TURN *** [Jc Qd Jd] [8h]
V3iZdcw61nXF3g5hD2RrsQ: bets $8
zyP4SPoWZnKUfTvIRLCVog: calls $8
*** RIVER *** [Jc Qd Jd 8h] [5h]
V3iZdcw61nXF3g5hD2RrsQ: bets $8
zyP4SPoWZnKUfTvIRLCVog: calls $8
*** SHOW DOWN ***
V3iZdcw61nXF3g5hD2RrsQ: shows [Kc Qc] (two pair, Queens and Jacks)
zyP4SPoWZnKUfTvIRLCVog: mucks hand
V3iZdcw61nXF3g5hD2RrsQ collected $54.75 from pot
*** SUMMARY ***
Total pot $57.50 | Rake $2.75
Board [Jc Qd Jd 8h 5h]
Seat 1: zyP4SPoWZnKUfTvIRLCVog (button) mucked
Seat 2: XK4Qsl+DA8gAJyg85/zBIw (small blind) folded before Flop
Seat 3: wx3sQGkVi2x9wJXuWNHPBw (big blind) folded before Flop
Seat 4: V3iZdcw61nXF3g5hD2RrsQ showed [Kc Qc] and won ($54.75) with two pair, Queens and Jacks
Seat 5: YMJG+F++3Aj6P8dAWda5fw folded before Flop (didn't bet)
Seat 6: UOHYuj23MyK9R8ciY2t6FA folded before Flop (didn't bet)



PokerStars Game #59941754298:  Hold'em No Limit ($0.50/$1.00) - 2009/07/01 1:45:06 ET
Table '+cA8mcmhaedZ7YcrDdhmeQ' 6-max Seat #3 is the button
Seat 1: VB7TtBnfmT3JTA/cCL6dJg ($100 in chips)
Seat 2: 14aYclSc98EYd6TrzN2l3Q ($87.80 in chips)
Seat 3: DAIgyIWbYvAkL6PbAI27pg ($19.50 in chips)
Seat 4: 4OO5v3AVduL0tePNx8wk5A ($107.20 in chips)
Seat 5: SJieaES+gCAfonfNNMCP6w ($100 in chips)
Seat 6: YfsTQsY/fxb+YqbdclTHuw ($32.15 in chips)
4OO5v3AVduL0tePNx8wk5A: posts small blind $0.50
SJieaES+gCAfonfNNMCP6w: posts big blind $1
*** HOLE CARDS ***
YfsTQsY/fxb+YqbdclTHuw: calls $1
VB7TtBnfmT3JTA/cCL6dJg: raises $4 to $5
14aYclSc98EYd6TrzN2l3Q: folds
DAIgyIWbYvAkL6PbAI27pg: folds
4OO5v3AVduL0tePNx8wk5A: folds
SJieaES+gCAfonfNNMCP6w: folds
YfsTQsY/fxb+YqbdclTHuw: calls $4
*** FLOP *** [7c 3h 4h]
YfsTQsY/fxb+YqbdclTHuw: checks
VB7TtBnfmT3JTA/cCL6dJg: bets $8
YfsTQsY/fxb+YqbdclTHuw: folds
VB7TtBnfmT3JTA/cCL6dJg collected $10.95 from pot
*** SUMMARY ***
Total pot $11.50 | Rake $0.55
Board [7c 3h 4h]
Seat 1: VB7TtBnfmT3JTA/cCL6dJg collected ($10.95)
Seat 2: 14aYclSc98EYd6TrzN2l3Q folded before Flop (didn't bet)
Seat 3: DAIgyIWbYvAkL6PbAI27pg (button) folded before Flop (didn't bet)
Seat 4: 4OO5v3AVduL0tePNx8wk5A (small blind) folded before Flop
Seat 5: SJieaES+gCAfonfNNMCP6w (big blind) folded before Flop
Seat 6: YfsTQsY/fxb+YqbdclTHuw folded on the Flop



PokerStars Game #59941754906:  Hold'em No Limit ($0.50/$1.00) - 2009/07/01 1:45:07 ET
Table 'qj0HBN4HhQKogreu1bg7xg' 2-max Seat #1 is the button
Seat 1: NYi6JFscYNrofSXy4sM+Yw ($136.10 in chips)
Seat 2: qtyl8CSb0/4yWdbuEPJejA ($139.70 in chips)
NYi6JFscYNrofSXy4sM+Yw: posts small blind $0.50
qtyl8CSb0/4yWdbuEPJejA: posts big blind $1
*** HOLE CARDS ***
NYi6JFscYNrofSXy4sM+Yw: raises $2 to $3
qtyl8CSb0/4yWdbuEPJejA: folds
NYi6JFscYNrofSXy4sM+Yw collected $2 from pot
*** SUMMARY ***
Total pot $2 | Rake $0
Seat 1: NYi6JFscYNrofSXy4sM+Yw (button) (small blind) collected ($2)
Seat 2: qtyl8CSb0/4yWdbuEPJejA (big blind) folded before Flop



PokerStars Game #59941754646:  Hold'em No Limit ($0.50/$1.00) - 2009/07/01 1:45:07 ET
Table 'tJq9SfN1ywY0r03VBlWlwQ' 9-max Seat #4 is the button
Seat 1: wZsU+w9r7G66x93UuvBf1Q ($329.10 in chips)
Seat 4: bLbSOSmSOnqE0iTcH/5dxA ($116.70 in chips)
Seat 5: h5ipsNTMyolp7xn/NAvWkA ($96.30 in chips)
Seat 6: gUUvmqdVlmvpal6B8nYrmg ($108.60 in chips)
Seat 7: Ogn4JDV3mp4ZDKO49IFzKA ($18.40 in chips)
Seat 8: G4DEhsZFmznGNVpy2SEocA ($39.30 in chips)
Seat 9: XE5QF1y74bpHog9JxWJMWQ ($100 in chips)
h5ipsNTMyolp7xn/NAvWkA: posts small blind $0.50
gUUvmqdVlmvpal6B8nYrmg: posts big blind $1
myIxN7otsyr846M539YR8Q: sits out
*** HOLE CARDS ***
Ogn4JDV3mp4ZDKO49IFzKA: folds
G4DEhsZFmznGNVpy2SEocA: folds
XE5QF1y74bpHog9JxWJMWQ: folds
wZsU+w9r7G66x93UuvBf1Q: folds
bLbSOSmSOnqE0iTcH/5dxA: folds
h5ipsNTMyolp7xn/NAvWkA: calls $0.50
gUUvmqdVlmvpal6B8nYrmg: checks
*** FLOP *** [Js 7h Kd]
h5ipsNTMyolp7xn/NAvWkA: checks
gUUvmqdVlmvpal6B8nYrmg: checks
*** TURN *** [Js 7h Kd] [7s]
h5ipsNTMyolp7xn/NAvWkA: bets $2
gUUvmqdVlmvpal6B8nYrmg: folds
h5ipsNTMyolp7xn/NAvWkA collected $1.90 from pot
*** SUMMARY ***
Total pot $2 | Rake $0.10
Board [Js 7h Kd 7s]
Seat 1: wZsU+w9r7G66x93UuvBf1Q folded before Flop (didn't bet)
Seat 4: bLbSOSmSOnqE0iTcH/5dxA (button) folded before Flop (didn't bet)
Seat 5: h5ipsNTMyolp7xn/NAvWkA (small blind) collected ($1.90)
Seat 6: gUUvmqdVlmvpal6B8nYrmg (big blind) folded on the Turn
Seat 7: Ogn4JDV3mp4ZDKO49IFzKA folded before Flop (didn't bet)
Seat 8: G4DEhsZFmznGNVpy2SEocA folded before Flop (didn't bet)
Seat 9: XE5QF1y74bpHog9JxWJMWQ folded before Flop (didn't bet)



PokerStars Game #59941755412:  Hold'em No Limit ($0.50/$1.00) - 2009/07/01 1:45:08 ET
Table '305hiksPPCCdC6V2LNsO5w' 6-max Seat #3 is the button
Seat 2: j7NIOHLZk7V2o9fOioO5ug ($160.20 in chips)
Seat 3: +zIVjZKLpcidfRHgVZW8lA ($35.70 in chips)
Seat 5: +Nt3OPk3XR9SKjZgm2CexQ ($100 in chips)
Seat 6: 9/Tq8dw7kWW68uN8bFupXg ($18.90 in chips)
uJVSceLggtsrJya+WtmUEA will be allowed to play after the button
+Nt3OPk3XR9SKjZgm2CexQ: posts small blind $0.50
9/Tq8dw7kWW68uN8bFupXg: posts big blind $1
*** HOLE CARDS ***
j7NIOHLZk7V2o9fOioO5ug: raises $2 to $3
+zIVjZKLpcidfRHgVZW8lA: folds
CqVbWBBIYCppRX6VwuX8fw joins the table at seat #1
+Nt3OPk3XR9SKjZgm2CexQ: raises $8 to $11
9/Tq8dw7kWW68uN8bFupXg: folds
j7NIOHLZk7V2o9fOioO5ug: calls $8
*** FLOP *** [Td 8h 2d]
+Nt3OPk3XR9SKjZgm2CexQ: bets $13.50
j7NIOHLZk7V2o9fOioO5ug: calls $13.50
*** TURN *** [Td 8h 2d] [Ts]
+Nt3OPk3XR9SKjZgm2CexQ: checks
j7NIOHLZk7V2o9fOioO5ug: bets $20
+Nt3OPk3XR9SKjZgm2CexQ: folds
j7NIOHLZk7V2o9fOioO5ug collected $48 from pot
*** SUMMARY ***
Total pot $50 | Rake $2
Board [Td 8h 2d Ts]
Seat 2: j7NIOHLZk7V2o9fOioO5ug collected ($48)
Seat 3: +zIVjZKLpcidfRHgVZW8lA (button) folded before Flop (didn't bet)
Seat 5: +Nt3OPk3XR9SKjZgm2CexQ (small blind) folded on the Turn
Seat 6: 9/Tq8dw7kWW68uN8bFupXg (big blind) folded before Flop



PokerStars Game #59941755122:  Hold'em No Limit ($0.50/$1.00) - 2009/07/01 1:45:08 ET
Table 'Zka9tv1yilg0MvXWPQrShg' 9-max Seat #3 is the button
Seat 1: ZVxIB+9xpB8diS64GK4r1Q ($53.80 in chips)
Seat 2: rALqQhDZz5RDHkTXtYKKiQ ($54 in chips)
Seat 3: gUUvmqdVlmvpal6B8nYrmg ($161.20 in chips)
Seat 4: ri8CLkX3e9JF34dQNbsHGA ($25 in chips)
Seat 5: /zy+DB4S5fUQUSfZWFzYGw ($126.15 in chips)
Seat 6: rY8wPoax1lS+HUY+I0FZDw ($220.35 in chips)
Seat 7: wddetwG1UUDMywszPUtP3A ($65.15 in chips)
Seat 8: mBRWbnUl8diyBO1qTJaNzw ($100 in chips)
Seat 9: bGHJpa8dswKSoojQBgXCgQ ($115.80 in chips)
ri8CLkX3e9JF34dQNbsHGA: posts small blind $0.50
/zy+DB4S5fUQUSfZWFzYGw: posts big blind $1
*** HOLE CARDS ***
rY8wPoax1lS+HUY+I0FZDw: folds
wddetwG1UUDMywszPUtP3A: folds
rY8wPoax1lS+HUY+I0FZDw leaves the table
mBRWbnUl8diyBO1qTJaNzw: folds
bGHJpa8dswKSoojQBgXCgQ: folds
ZVxIB+9xpB8diS64GK4r1Q: folds
rALqQhDZz5RDHkTXtYKKiQ: folds
aM6BB+PnB/rDUr2dbRda+A joins the table at seat #6
gUUvmqdVlmvpal6B8nYrmg: raises $2 to $3
ri8CLkX3e9JF34dQNbsHGA: folds
/zy+DB4S5fUQUSfZWFzYGw: folds
gUUvmqdVlmvpal6B8nYrmg collected $2.50 from pot
gUUvmqdVlmvpal6B8nYrmg: doesn't show hand
*** SUMMARY ***
Total pot $2.50 | Rake $0
Seat 1: ZVxIB+9xpB8diS64GK4r1Q folded before Flop (didn't bet)
Seat 2: rALqQhDZz5RDHkTXtYKKiQ folded before Flop (didn't bet)
Seat 3: gUUvmqdVlmvpal6B8nYrmg (button) collected ($2.50)
Seat 4: ri8CLkX3e9JF34dQNbsHGA (small blind) folded before Flop
Seat 5: /zy+DB4S5fUQUSfZWFzYGw (big blind) folded before Flop
Seat 6: rY8wPoax1lS+HUY+I0FZDw folded before Flop (didn't bet)
Seat 7: wddetwG1UUDMywszPUtP3A folded before Flop (didn't bet)
Seat 8: mBRWbnUl8diyBO1qTJaNzw folded before Flop (didn't bet)
Seat 9: bGHJpa8dswKSoojQBgXCgQ folded before Flop (didn't bet)



PokerStars Game #59941755974:  Hold'em No Limit ($0.50/$1.00) - 2009/07/01 1:45:09 ET
Table '7Nl0ffnjeK44/vmeexh3MQ' 9-max Seat #8 is the button
Seat 1: V138SURkdX8LdVBPKdJJag ($114.55 in chips)
Seat 2: OGgaARGdJQT4awWVNQ957w ($101.50 in chips)
Seat 3: JMmUYT5pIKCKh2pGjCB/4w ($56.90 in chips)
Seat 4: bLbSOSmSOnqE0iTcH/5dxA ($107.55 in chips)
Seat 5: 61sfw5QTu62YYIt68OsdrA ($76.05 in chips)
Seat 6: FVs16t7GgfWgQWt4JxsObQ ($29.95 in chips)
Seat 7: 2fVA6XTmacKkwJ4SpKDAtA ($85.50 in chips)
Seat 8: HRJJZiSxFAehJGaET63dlA ($45.40 in chips)
Seat 9: /JHoNdt0fK6X+isrqRfV3w ($19 in chips)
/JHoNdt0fK6X+isrqRfV3w: posts small blind $0.50
V138SURkdX8LdVBPKdJJag: posts big blind $1
*** HOLE CARDS ***
OGgaARGdJQT4awWVNQ957w: folds
JMmUYT5pIKCKh2pGjCB/4w: raises $2 to $3
bLbSOSmSOnqE0iTcH/5dxA: folds
61sfw5QTu62YYIt68OsdrA: folds
FVs16t7GgfWgQWt4JxsObQ: calls $3
2fVA6XTmacKkwJ4SpKDAtA: folds
HRJJZiSxFAehJGaET63dlA: folds
/JHoNdt0fK6X+isrqRfV3w: folds
V138SURkdX8LdVBPKdJJag: folds
*** FLOP *** [Jh 5s 5c]
JMmUYT5pIKCKh2pGjCB/4w: bets $3
FVs16t7GgfWgQWt4JxsObQ: folds
JMmUYT5pIKCKh2pGjCB/4w collected $7.15 from pot
JMmUYT5pIKCKh2pGjCB/4w: doesn't show hand
*** SUMMARY ***
Total pot $7.50 | Rake $0.35
Board [Jh 5s 5c]
Seat 1: V138SURkdX8LdVBPKdJJag (big blind) folded before Flop
Seat 2: OGgaARGdJQT4awWVNQ957w folded before Flop (didn't bet)
Seat 3: JMmUYT5pIKCKh2pGjCB/4w collected ($7.15)
Seat 4: bLbSOSmSOnqE0iTcH/5dxA folded before Flop (didn't bet)
Seat 5: 61sfw5QTu62YYIt68OsdrA folded before Flop (didn't bet)
Seat 6: FVs16t7GgfWgQWt4JxsObQ folded on the Flop
Seat 7: 2fVA6XTmacKkwJ4SpKDAtA folded before Flop (didn't bet)
Seat 8: HRJJZiSxFAehJGaET63dlA (button) folded before Flop (didn't bet)
Seat 9: /JHoNdt0fK6X+isrqRfV3w (small blind) folded before Flop



PokerStars Game #59941756048:  Hold'em No Limit ($0.50/$1.00) - 2009/07/01 1:45:09 ET
Table 'O96CPOtvMBWP6kzuYDfdFA' 6-max Seat #1 is the button
Seat 1: 6alLXQIITA2EZ/lBeym8Dw ($141.65 in chips)
Seat 2: 4d1rWhpu8DzLmzMbR3QKyA ($100.50 in chips)
Seat 3: ieBUmHu5QBR86BArTtK4FQ ($20.95 in chips)
Seat 4: /P4w1pHg2zHYg/4ubJ0dPw ($61.95 in chips)
Seat 5: vX+iYAEINFeLxwMla7DY1Q ($87 in chips)
Seat 6: 3syOXva630dm1FTdwnuLpw ($80.10 in chips)
4d1rWhpu8DzLmzMbR3QKyA: posts small blind $0.50
ieBUmHu5QBR86BArTtK4FQ: posts big blind $1
*** HOLE CARDS ***
/P4w1pHg2zHYg/4ubJ0dPw: raises $2.50 to $3.50
vX+iYAEINFeLxwMla7DY1Q: folds
3syOXva630dm1FTdwnuLpw: folds
6alLXQIITA2EZ/lBeym8Dw: folds
4d1rWhpu8DzLmzMbR3QKyA: folds
ieBUmHu5QBR86BArTtK4FQ: folds
/P4w1pHg2zHYg/4ubJ0dPw collected $2.50 from pot
*** SUMMARY ***
Total pot $2.50 | Rake $0
Seat 1: 6alLXQIITA2EZ/lBeym8Dw (button) folded before Flop (didn't bet)
Seat 2: 4d1rWhpu8DzLmzMbR3QKyA (small blind) folded before Flop
Seat 3: ieBUmHu5QBR86BArTtK4FQ (big blind) folded before Flop
Seat 4: /P4w1pHg2zHYg/4ubJ0dPw collected ($2.50)
Seat 5: vX+iYAEINFeLxwMla7DY1Q folded before Flop (didn't bet)
Seat 6: 3syOXva630dm1FTdwnuLpw folded before Flop (didn't bet)



PokerStars Game #59941755836:  Hold'em No Limit ($0.50/$1.00) - 2009/07/01 1:45:09 ET
Table 'VOs36P6NW+QyXeQ1B62kmAE9S5sEoK9Q3olj2a53gABASeat #4 is the button
Seat 1: 4h8XtuVJtWh3DJpxGo7k5Q ($25.95 in chips)
Seat 2: y27w5IK2WXqmYzS8OU0wKA ($152.50 in chips)
Seat 3: p00KmyZiD/isPc/lZwNBTg ($8.25 in chips)
Seat 4: ene3nLSnQ4N961iBaUsSmA ($100 in chips)
Seat 5: o3YLm/rSY916m/on1VjXPA ($133.60 in chips)
Seat 6: slVKuQyEz8Qj4E3uLPYNXg ($50.25 in chips)
o3YLm/rSY916m/on1VjXPA: posts small blind $0.50
slVKuQyEz8Qj4E3uLPYNXg: posts big blind $1
*** HOLE CARDS ***
4h8XtuVJtWh3DJpxGo7k5Q: calls $1
y27w5IK2WXqmYzS8OU0wKA: folds
p00KmyZiD/isPc/lZwNBTg: raises $2 to $3
ene3nLSnQ4N961iBaUsSmA: folds
o3YLm/rSY916m/on1VjXPA: folds
slVKuQyEz8Qj4E3uLPYNXg: folds
4h8XtuVJtWh3DJpxGo7k5Q: folds
p00KmyZiD/isPc/lZwNBTg collected $3.50 from pot
*** SUMMARY ***
Total pot $3.50 | Rake $0
Seat 1: 4h8XtuVJtWh3DJpxGo7k5Q folded before Flop
Seat 2: y27w5IK2WXqmYzS8OU0wKA folded before Flop (didn't bet)
Seat 3: p00KmyZiD/isPc/lZwNBTg collected ($3.50)
Seat 4: ene3nLSnQ4N961iBaUsSmA (button) folded before Flop (didn't bet)
Seat 5: o3YLm/rSY916m/on1VjXPA (small blind) folded before Flop
Seat 6: slVKuQyEz8Qj4E3uLPYNXg (big blind) folded before Flop



PokerStars Game #59941756318:  Hold'em No Limit ($0.50/$1.00) - 2009/07/01 1:45:10 ET
Table 'DvFb+QVx+4Mvu7tghrGtVg' 6-max Seat #3 is the button
Seat 1: 1ifNpObXxyEaiFAVxWBVNQ ($145.20 in chips)
Seat 2: YMJG+F++3Aj6P8dAWda5fw ($101.50 in chips)
Seat 3: TSuRyAHnUPCFjP7Z0rEE0w ($100 in chips)
Seat 4: hpxXcmRkXXI9HE5+5/j/0Q ($104.90 in chips)
Seat 5: V3iZdcw61nXF3g5hD2RrsQ ($111.50 in chips)
Seat 6: y27w5IK2WXqmYzS8OU0wKA ($187.50 in chips)
hpxXcmRkXXI9HE5+5/j/0Q: posts small blind $0.50
V3iZdcw61nXF3g5hD2RrsQ: posts big blind $1
*** HOLE CARDS ***
y27w5IK2WXqmYzS8OU0wKA: folds
1ifNpObXxyEaiFAVxWBVNQ: folds
YMJG+F++3Aj6P8dAWda5fw: folds
TSuRyAHnUPCFjP7Z0rEE0w: folds
hpxXcmRkXXI9HE5+5/j/0Q: raises $3 to $4
V3iZdcw61nXF3g5hD2RrsQ: folds
hpxXcmRkXXI9HE5+5/j/0Q collected $2 from pot
*** SUMMARY ***
Total pot $2 | Rake $0
Seat 1: 1ifNpObXxyEaiFAVxWBVNQ folded before Flop (didn't bet)
Seat 2: YMJG+F++3Aj6P8dAWda5fw folded before Flop (didn't bet)
Seat 3: TSuRyAHnUPCFjP7Z0rEE0w (button) folded before Flop (didn't bet)
Seat 4: hpxXcmRkXXI9HE5+5/j/0Q (small blind) collected ($2)
Seat 5: V3iZdcw61nXF3g5hD2RrsQ (big blind) folded before Flop
Seat 6: y27w5IK2WXqmYzS8OU0wKA folded before Flop (didn't bet)



PokerStars Game #59941756256:  Hold'em No Limit ($0.50/$1.00) - 2009/07/01 1:45:10 ET
Table 'ZFWj23PMihdwrNWv41OG/QtyUh+jyNvrceIQdKMJjQ2weat #1 is the button
Seat 1: rHlMOfR7kpQQxe+PFQz0xQ ($49 in chips)
Seat 2: 0smcry9L0OOTCP+KzIS5SA ($92 in chips)
Seat 3: cWwhvq/+r/w8nkhwrJoekQ ($67.20 in chips)
Seat 4: O5ZesE/6mHyuWWbvkiH/Fg ($73.35 in chips)
Seat 5: j7NIOHLZk7V2o9fOioO5ug ($100 in chips)
0smcry9L0OOTCP+KzIS5SA: posts small blind $0.50
cWwhvq/+r/w8nkhwrJoekQ: posts big blind $1
*** HOLE CARDS ***
O5ZesE/6mHyuWWbvkiH/Fg: raises $2 to $3
j7NIOHLZk7V2o9fOioO5ug: folds
rHlMOfR7kpQQxe+PFQz0xQ: folds
0smcry9L0OOTCP+KzIS5SA: folds
cWwhvq/+r/w8nkhwrJoekQ: folds
O5ZesE/6mHyuWWbvkiH/Fg collected $2.50 from pot
O5ZesE/6mHyuWWbvkiH/Fg: doesn't show hand
*** SUMMARY ***
Total pot $2.50 | Rake $0
Seat 1: rHlMOfR7kpQQxe+PFQz0xQ (button) folded before Flop (didn't bet)
Seat 2: 0smcry9L0OOTCP+KzIS5SA (small blind) folded before Flop
Seat 3: cWwhvq/+r/w8nkhwrJoekQ (big blind) folded before Flop
Seat 4: O5ZesE/6mHyuWWbvkiH/Fg collected ($2.50)
Seat 5: j7NIOHLZk7V2o9fOioO5ug folded before Flop (didn't bet)



PokerStars Game #59941757348:  Hold'em No Limit ($0.50/$1.00) - 2009/07/01 1:45:12 ET
Table '7O9fB8yx1u7sJveJn8w6jA' 6-max Seat #5 is the button
Seat 1: 841740 ($37.80 in chips)
Seat 2: wx3sQGkVi2x9wJXuWNHPBw ($205.35 in chips)
Seat 3: hpxXcmRkXXI9HE5+5/j/0Q ($145.45 in chips)
Seat 4: b2a+5TkFf4xJN/Ihhma58Q ($22.35 in chips)
Seat 5: BCEV3COoKY607AzLWayfRA ($107.20 in chips)
Seat 6: r4lpoh2BJZ8S6zyQv1JeSw ($111.25 in chips)
r4lpoh2BJZ8S6zyQv1JeSw: posts small blind $0.50
841740: posts big blind $1
*** HOLE CARDS ***
wx3sQGkVi2x9wJXuWNHPBw: folds
hpxXcmRkXXI9HE5+5/j/0Q: folds
b2a+5TkFf4xJN/Ihhma58Q: raises $1 to $2
BCEV3COoKY607AzLWayfRA: folds
r4lpoh2BJZ8S6zyQv1JeSw: folds
841740: calls $1
*** FLOP *** [8h Js Td]
841740: checks
b2a+5TkFf4xJN/Ihhma58Q: bets $3
841740: folds
b2a+5TkFf4xJN/Ihhma58Q collected $4.30 from pot
*** SUMMARY ***
Total pot $4.50 | Rake $0.20
Board [8h Js Td]
Seat 1: 841740 (big blind) folded on the Flop
Seat 2: wx3sQGkVi2x9wJXuWNHPBw folded before Flop (didn't bet)
Seat 3: hpxXcmRkXXI9HE5+5/j/0Q folded before Flop (didn't bet)
Seat 4: b2a+5TkFf4xJN/Ihhma58Q collected ($4.30)
Seat 5: BCEV3COoKY607AzLWayfRA (button) folded before Flop (didn't bet)
Seat 6: r4lpoh2BJZ8S6zyQv1JeSw (small blind) folded before Flop



PokerStars Game #59941757882:  Hold'em No Limit ($0.50/$1.00) - 2009/07/01 1:45:13 ET
Table 'kS0cTQAEi+fdUlJP2gQYvw' 9-max Seat #2 is the button
Seat 1: SqsWPukL8kLqrhq5ZrQdSQ ($169.50 in chips)
Seat 2: +JautI/vSNALzwSvsOqbCQ ($74 in chips)
Seat 3: 2BV+oJIQYr65IO6nEChvbA ($61.55 in chips)
Seat 4: RUhhaALzha3TH1AkdakoGQ ($64 in chips)
Seat 5: 997ViqAtWn1FPjJqcffwcA ($100 in chips)
Seat 6: yAbu2QsRPVcjPbqlf/jDxw ($117.15 in chips)
Seat 7: Ffa7Nj4X5fddtROP01hfQg ($8.50 in chips)
Seat 9: OGgaARGdJQT4awWVNQ957w ($108.20 in chips)
2BV+oJIQYr65IO6nEChvbA: posts small blind $0.50
RUhhaALzha3TH1AkdakoGQ: posts big blind $1
V138SURkdX8LdVBPKdJJag: sits out
*** HOLE CARDS ***
997ViqAtWn1FPjJqcffwcA: folds
997ViqAtWn1FPjJqcffwcA leaves the table
yAbu2QsRPVcjPbqlf/jDxw: folds
Ffa7Nj4X5fddtROP01hfQg: folds
OGgaARGdJQT4awWVNQ957w: raises $3 to $4
SqsWPukL8kLqrhq5ZrQdSQ: folds
+JautI/vSNALzwSvsOqbCQ: folds
2BV+oJIQYr65IO6nEChvbA: folds
1862487932 joins the table at seat #5
RUhhaALzha3TH1AkdakoGQ: calls $3
*** FLOP *** [Qd 5d 7d]
RUhhaALzha3TH1AkdakoGQ: checks
OGgaARGdJQT4awWVNQ957w: checks
*** TURN *** [Qd 5d 7d] [2c]
RUhhaALzha3TH1AkdakoGQ: bets $5
OGgaARGdJQT4awWVNQ957w: folds
RUhhaALzha3TH1AkdakoGQ collected $8.10 from pot
*** SUMMARY ***
Total pot $8.50 | Rake $0.40
Board [Qd 5d 7d 2c]
Seat 1: SqsWPukL8kLqrhq5ZrQdSQ folded before Flop (didn't bet)
Seat 2: +JautI/vSNALzwSvsOqbCQ (button) folded before Flop (didn't bet)
Seat 3: 2BV+oJIQYr65IO6nEChvbA (small blind) folded before Flop
Seat 4: RUhhaALzha3TH1AkdakoGQ (big blind) collected ($8.10)
Seat 5: 997ViqAtWn1FPjJqcffwcA folded before Flop (didn't bet)
Seat 6: yAbu2QsRPVcjPbqlf/jDxw folded before Flop (didn't bet)
Seat 7: Ffa7Nj4X5fddtROP01hfQg folded before Flop (didn't bet)
Seat 9: OGgaARGdJQT4awWVNQ957w folded on the Turn



PokerStars Game #59941759426:  Hold'em No Limit ($0.50/$1.00) - 2009/07/01 1:45:15 ET
Table 'rmZfTK+oSebeUPJNbWhdAA' 6-max Seat #3 is the button
Seat 1: xAU6q2/cwmby2sxmA8VcmA ($135.80 in chips)
Seat 2: z7O9PO/WEcqRouIydFhS9Q ($206.95 in chips)
Seat 3: BCEV3COoKY607AzLWayfRA ($208.20 in chips)
Seat 4: 1/mIuXfgx1ZyVkodrmfQDw ($155.35 in chips)
Seat 5: UOHYuj23MyK9R8ciY2t6FA ($100 in chips)
Seat 6: j7NIOHLZk7V2o9fOioO5ug ($100.70 in chips)
1/mIuXfgx1ZyVkodrmfQDw: posts small blind $0.50
UOHYuj23MyK9R8ciY2t6FA: posts big blind $1
*** HOLE CARDS ***
j7NIOHLZk7V2o9fOioO5ug: folds
xAU6q2/cwmby2sxmA8VcmA: folds
z7O9PO/WEcqRouIydFhS9Q: raises $2 to $3
BCEV3COoKY607AzLWayfRA: calls $3
1/mIuXfgx1ZyVkodrmfQDw: folds
UOHYuj23MyK9R8ciY2t6FA: folds
*** FLOP *** [2c As Qh]
z7O9PO/WEcqRouIydFhS9Q: checks
BCEV3COoKY607AzLWayfRA: bets $6
z7O9PO/WEcqRouIydFhS9Q: calls $6
*** TURN *** [2c As Qh] [4h]
z7O9PO/WEcqRouIydFhS9Q: checks
BCEV3COoKY607AzLWayfRA: checks
*** RIVER *** [2c As Qh 4h] [Kd]
z7O9PO/WEcqRouIydFhS9Q: checks
BCEV3COoKY607AzLWayfRA: checks
*** SHOW DOWN ***
z7O9PO/WEcqRouIydFhS9Q: shows [Qs Js] (a pair of Queens)
BCEV3COoKY607AzLWayfRA: mucks hand
z7O9PO/WEcqRouIydFhS9Q collected $18.55 from pot
*** SUMMARY ***
Total pot $19.50 | Rake $0.95
Board [2c As Qh 4h Kd]
Seat 1: xAU6q2/cwmby2sxmA8VcmA folded before Flop (didn't bet)
Seat 2: z7O9PO/WEcqRouIydFhS9Q showed [Qs Js] and won ($18.55) with a pair of Queens
Seat 3: BCEV3COoKY607AzLWayfRA (button) mucked
Seat 4: 1/mIuXfgx1ZyVkodrmfQDw (small blind) folded before Flop
Seat 5: UOHYuj23MyK9R8ciY2t6FA (big blind) folded before Flop
Seat 6: j7NIOHLZk7V2o9fOioO5ug folded before Flop (didn't bet)



PokerStars Game #59941759642:  Hold'em No Limit ($0.50/$1.00) - 2009/07/01 1:45:16 ET
Table 'qj0HBN4HhQKogreu1bg7xg' 2-max Seat #2 is the button
Seat 1: NYi6JFscYNrofSXy4sM+Yw ($137.10 in chips)
Seat 2: qtyl8CSb0/4yWdbuEPJejA ($138.70 in chips)
qtyl8CSb0/4yWdbuEPJejA: posts small blind $0.50
NYi6JFscYNrofSXy4sM+Yw: posts big blind $1
*** HOLE CARDS ***
qtyl8CSb0/4yWdbuEPJejA: raises $2 to $3
NYi6JFscYNrofSXy4sM+Yw: folds
qtyl8CSb0/4yWdbuEPJejA collected $2 from pot
qtyl8CSb0/4yWdbuEPJejA: doesn't show hand
*** SUMMARY ***
Total pot $2 | Rake $0
Seat 1: NYi6JFscYNrofSXy4sM+Yw (big blind) folded before Flop
Seat 2: qtyl8CSb0/4yWdbuEPJejA (button) (small blind) collected ($2)



PokerStars Game #59941760068:  Hold'em No Limit ($0.50/$1.00) - 2009/07/01 1:45:17 ET
Table 'b8oW/dOL7fDza5DfZ/dOJQ' 6-max Seat #1 is the button
Seat 1: NakujTNjHFgzceydFf+E2Q ($49.90 in chips)
Seat 2: TSuRyAHnUPCFjP7Z0rEE0w ($116.50 in chips)
Seat 3: d8WX+9nUHoqlrAGagO0Wow ($32.80 in chips)
Seat 5: sr/OkkgqNbtgwJf1tmnfNg ($73.20 in chips)
Seat 6: PvfYaKbzMpsmUcbOExckbQ ($160.55 in chips)
TSuRyAHnUPCFjP7Z0rEE0w: posts small blind $0.50
d8WX+9nUHoqlrAGagO0Wow: posts big blind $1
*** HOLE CARDS ***
sr/OkkgqNbtgwJf1tmnfNg: folds
PvfYaKbzMpsmUcbOExckbQ: folds
NakujTNjHFgzceydFf+E2Q: folds
TSuRyAHnUPCFjP7Z0rEE0w: raises $3 to $4
d8WX+9nUHoqlrAGagO0Wow: folds
TSuRyAHnUPCFjP7Z0rEE0w collected $2 from pot
TSuRyAHnUPCFjP7Z0rEE0w: doesn't show hand
8rDbzImSi1zgxtqtF1pSbA leaves the table
*** SUMMARY ***
Total pot $2 | Rake $0
Seat 1: NakujTNjHFgzceydFf+E2Q (button) folded before Flop (didn't bet)
Seat 2: TSuRyAHnUPCFjP7Z0rEE0w (small blind) collected ($2)
Seat 3: d8WX+9nUHoqlrAGagO0Wow (big blind) folded before Flop
Seat 5: sr/OkkgqNbtgwJf1tmnfNg folded before Flop (didn't bet)
Seat 6: PvfYaKbzMpsmUcbOExckbQ folded before Flop (didn't bet)



PokerStars Game #59941761522:  Hold'em No Limit ($0.50/$1.00) - 2009/07/01 1:45:19 ET
Table 'pHrhryH8jPNdQfY62f8v+g' 6-max Seat #2 is the button
Seat 1: 4d1rWhpu8DzLmzMbR3QKyA ($143.95 in chips)
Seat 2: JwCcjZl0bjJzG7hmE0dnTA ($122.60 in chips)
Seat 3: 8oS5O7iD/qnFXFXJrGIgNQ ($115.90 in chips)
Seat 4: 1f3beyIML24UqEMTbWy93g ($40.85 in chips)
Seat 5: d8WX+9nUHoqlrAGagO0Wow ($18.50 in chips)
Seat 6: xAU6q2/cwmby2sxmA8VcmA ($202.30 in chips)
8oS5O7iD/qnFXFXJrGIgNQ: posts small blind $0.50
1f3beyIML24UqEMTbWy93g: posts big blind $1
*** HOLE CARDS ***
d8WX+9nUHoqlrAGagO0Wow: calls $1
xAU6q2/cwmby2sxmA8VcmA: folds
4d1rWhpu8DzLmzMbR3QKyA: folds
JwCcjZl0bjJzG7hmE0dnTA: raises $2 to $3
8oS5O7iD/qnFXFXJrGIgNQ: folds
1f3beyIML24UqEMTbWy93g: calls $2
d8WX+9nUHoqlrAGagO0Wow: calls $2
*** FLOP *** [8d 9h 6c]
1f3beyIML24UqEMTbWy93g: checks
d8WX+9nUHoqlrAGagO0Wow: checks
JwCcjZl0bjJzG7hmE0dnTA: bets $7
1f3beyIML24UqEMTbWy93g: folds
d8WX+9nUHoqlrAGagO0Wow: folds
JwCcjZl0bjJzG7hmE0dnTA collected $9.05 from pot
*** SUMMARY ***
Total pot $9.50 | Rake $0.45
Board [8d 9h 6c]
Seat 1: 4d1rWhpu8DzLmzMbR3QKyA folded before Flop (didn't bet)
Seat 2: JwCcjZl0bjJzG7hmE0dnTA (button) collected ($9.05)
Seat 3: 8oS5O7iD/qnFXFXJrGIgNQ (small blind) folded before Flop
Seat 4: 1f3beyIML24UqEMTbWy93g (big blind) folded on the Flop
Seat 5: d8WX+9nUHoqlrAGagO0Wow folded on the Flop
Seat 6: xAU6q2/cwmby2sxmA8VcmA folded before Flop (didn't bet)



PokerStars Game #59941761846:  Hold'em No Limit ($0.50/$1.00) - 2009/07/01 1:45:20 ET
Table 'uNlePsyMIqzM691Xkrlk6Q' 9-max Seat #9 is the button
Seat 1: bLbSOSmSOnqE0iTcH/5dxA ($108.90 in chips)
Seat 2: TAfo4veNRaRlzDXMMYS3Jg ($20 in chips)
Seat 3: h7qXkU57Bb8ZuPwMyxR8Ug ($119 in chips)
Seat 4: WRTVKFHeb0vRJnVi5NdJZw ($43.25 in chips)
Seat 5: G9Fo2TZCN7HI43Po4zSN3A ($109.40 in chips)
Seat 6: mMc/PBpqlN24gdi3C/1tOw ($39 in chips)
Seat 7: KNAaBvPYSXyLqb88ypSbuQ ($35.95 in chips)
Seat 8: yWcEtGJ3ijZsF6HqlHqkrg ($115 in chips)
Seat 9: OGgaARGdJQT4awWVNQ957w ($116.50 in chips)
bLbSOSmSOnqE0iTcH/5dxA: posts small blind $0.50
TAfo4veNRaRlzDXMMYS3Jg: posts big blind $1
*** HOLE CARDS ***
h7qXkU57Bb8ZuPwMyxR8Ug: folds
WRTVKFHeb0vRJnVi5NdJZw: folds
G9Fo2TZCN7HI43Po4zSN3A: folds
mMc/PBpqlN24gdi3C/1tOw: folds
KNAaBvPYSXyLqb88ypSbuQ: raises $2 to $3
yWcEtGJ3ijZsF6HqlHqkrg: folds
OGgaARGdJQT4awWVNQ957w: folds
bLbSOSmSOnqE0iTcH/5dxA: folds
TAfo4veNRaRlzDXMMYS3Jg: folds
KNAaBvPYSXyLqb88ypSbuQ collected $2.50 from pot
*** SUMMARY ***
Total pot $2.50 | Rake $0
Seat 1: bLbSOSmSOnqE0iTcH/5dxA (small blind) folded before Flop
Seat 2: TAfo4veNRaRlzDXMMYS3Jg (big blind) folded before Flop
Seat 3: h7qXkU57Bb8ZuPwMyxR8Ug folded before Flop (didn't bet)
Seat 4: WRTVKFHeb0vRJnVi5NdJZw folded before Flop (didn't bet)
Seat 5: G9Fo2TZCN7HI43Po4zSN3A folded before Flop (didn't bet)
Seat 6: mMc/PBpqlN24gdi3C/1tOw folded before Flop (didn't bet)
Seat 7: KNAaBvPYSXyLqb88ypSbuQ collected ($2.50)
Seat 8: yWcEtGJ3ijZsF6HqlHqkrg folded before Flop (didn't bet)
Seat 9: OGgaARGdJQT4awWVNQ957w (button) folded before Flop (didn't bet)



PokerStars Game #59941762812:  Hold'em No Limit ($0.50/$1.00) - 2009/07/01 1:45:22 ET
Table 'QSIig7BLMc9wY/rgBechzw' 6-max Seat #1 is the button
Seat 1: Z2fXsGcjl+Eax+RzOgwOmg ($105 in chips)
Seat 2: w13GSGRwQhbN/aLrrRaMKw ($21 in chips)
Seat 3: 4OO5v3AVduL0tePNx8wk5A ($121.20 in chips)
Seat 4: +uSzP8Jwnw7sKfQ4s66b7w ($74.65 in chips)
Seat 5: lsLuWlcPA3Rh7kJVLzMh0Q ($123 in chips)
w13GSGRwQhbN/aLrrRaMKw: posts small blind $0.50
4OO5v3AVduL0tePNx8wk5A: posts big blind $1
rHlMOfR7kpQQxe+PFQz0xQ: sits out
*** HOLE CARDS ***
+uSzP8Jwnw7sKfQ4s66b7w: folds
lsLuWlcPA3Rh7kJVLzMh0Q: raises $2 to $3
Z2fXsGcjl+Eax+RzOgwOmg: folds
w13GSGRwQhbN/aLrrRaMKw: calls $2.50
4OO5v3AVduL0tePNx8wk5A: raises $10 to $13
lsLuWlcPA3Rh7kJVLzMh0Q: folds
w13GSGRwQhbN/aLrrRaMKw: calls $10
*** FLOP *** [2d Kh 2c]
w13GSGRwQhbN/aLrrRaMKw: bets $8 and is all-in
4OO5v3AVduL0tePNx8wk5A: calls $8
*** TURN *** [2d Kh 2c] [Ts]
*** RIVER *** [2d Kh 2c Ts] [7s]
*** SHOW DOWN ***
w13GSGRwQhbN/aLrrRaMKw: shows [Qc Ks] (two pair, Kings and Deuces)
4OO5v3AVduL0tePNx8wk5A: mucks hand
w13GSGRwQhbN/aLrrRaMKw collected $43 from pot
*** SUMMARY ***
Total pot $45 | Rake $2
Board [2d Kh 2c Ts 7s]
Seat 1: Z2fXsGcjl+Eax+RzOgwOmg (button) folded before Flop (didn't bet)
Seat 2: w13GSGRwQhbN/aLrrRaMKw (small blind) showed [Qc Ks] and won ($43) with two pair, Kings and Deuces
Seat 3: 4OO5v3AVduL0tePNx8wk5A (big blind) mucked
Seat 4: +uSzP8Jwnw7sKfQ4s66b7w folded before Flop (didn't bet)
Seat 5: lsLuWlcPA3Rh7kJVLzMh0Q folded before Flop



PokerStars Game #59941763626:  Hold'em No Limit ($0.50/$1.00) - 2009/07/01 1:45:23 ET
Table 'W/wyObTiXZm+Ckkl3YxcSw' 6-max Seat #5 is the button
Seat 1: GHv97X0qtwmxPTR3hKuNvg ($39.50 in chips)
Seat 2: oDiBRCaF0QVtd3kO6xZIXw ($78.65 in chips)
Seat 3: 4OO5v3AVduL0tePNx8wk5A ($100 in chips)
Seat 4: rHlMOfR7kpQQxe+PFQz0xQ ($96 in chips)
Seat 5: +OrCjyw70oZhJiD22Mn+bg ($199 in chips)
Seat 6: b2a+5TkFf4xJN/Ihhma58Q ($34.60 in chips)
b2a+5TkFf4xJN/Ihhma58Q: posts small blind $0.50
GHv97X0qtwmxPTR3hKuNvg: posts big blind $1
*** HOLE CARDS ***
oDiBRCaF0QVtd3kO6xZIXw: raises $2 to $3
4OO5v3AVduL0tePNx8wk5A: folds
rHlMOfR7kpQQxe+PFQz0xQ: folds
+OrCjyw70oZhJiD22Mn+bg: folds
b2a+5TkFf4xJN/Ihhma58Q: folds
GHv97X0qtwmxPTR3hKuNvg: folds
oDiBRCaF0QVtd3kO6xZIXw collected $2.50 from pot
oDiBRCaF0QVtd3kO6xZIXw: doesn't show hand
*** SUMMARY ***
Total pot $2.50 | Rake $0
Seat 1: GHv97X0qtwmxPTR3hKuNvg (big blind) folded before Flop
Seat 2: oDiBRCaF0QVtd3kO6xZIXw collected ($2.50)
Seat 3: 4OO5v3AVduL0tePNx8wk5A folded before Flop (didn't bet)
Seat 4: rHlMOfR7kpQQxe+PFQz0xQ folded before Flop (didn't bet)
Seat 5: +OrCjyw70oZhJiD22Mn+bg (button) folded before Flop (didn't bet)
Seat 6: b2a+5TkFf4xJN/Ihhma58Q (small blind) folded before Flop



PokerStars Game #59941764634:  Hold'em No Limit ($0.50/$1.00) - 2009/07/01 1:45:25 ET
Table '/RZcOwpZpHQ+OwPwjsbnRw' 6-max Seat #3 is the button
Seat 1: +uSzP8Jwnw7sKfQ4s66b7w ($108.65 in chips)
Seat 2: Z2fXsGcjl+Eax+RzOgwOmg ($102.65 in chips)
Seat 3: LJMw/I77xpnw0R5T4HnMUg ($83.05 in chips)
Seat 4: j7NIOHLZk7V2o9fOioO5ug ($112.20 in chips)
Seat 5: wx3sQGkVi2x9wJXuWNHPBw ($167.25 in chips)
Seat 6: o3YLm/rSY916m/on1VjXPA ($205.50 in chips)
j7NIOHLZk7V2o9fOioO5ug: posts small blind $0.50
wx3sQGkVi2x9wJXuWNHPBw: posts big blind $1
*** HOLE CARDS ***
o3YLm/rSY916m/on1VjXPA: folds
+uSzP8Jwnw7sKfQ4s66b7w: folds
Z2fXsGcjl+Eax+RzOgwOmg: folds
LJMw/I77xpnw0R5T4HnMUg: raises $2 to $3
j7NIOHLZk7V2o9fOioO5ug: folds
wx3sQGkVi2x9wJXuWNHPBw: folds
LJMw/I77xpnw0R5T4HnMUg collected $2.50 from pot
LJMw/I77xpnw0R5T4HnMUg: doesn't show hand
*** SUMMARY ***
Total pot $2.50 | Rake $0
Seat 1: +uSzP8Jwnw7sKfQ4s66b7w folded before Flop (didn't bet)
Seat 2: Z2fXsGcjl+Eax+RzOgwOmg folded before Flop (didn't bet)
Seat 3: LJMw/I77xpnw0R5T4HnMUg (button) collected ($2.50)
Seat 4: j7NIOHLZk7V2o9fOioO5ug (small blind) folded before Flop
Seat 5: wx3sQGkVi2x9wJXuWNHPBw (big blind) folded before Flop
Seat 6: o3YLm/rSY916m/on1VjXPA folded before Flop (didn't bet)



PokerStars Game #59941765178:  Hold'em No Limit ($0.50/$1.00) - 2009/07/01 1:45:26 ET
Table 'vs/5jr6ciwjVQ5+Soc+u2A' 6-max Seat #2 is the button
Seat 1: J798qwLuvXyq0BbzsIjOrA ($221.50 in chips)
Seat 2: lXX4W7m3u++JiSOZ46yVMQ ($97 in chips)
Seat 3: Ws/3Uo3rQIk8hLgW0P+2xA ($102.40 in chips)
Seat 4: 0smcry9L0OOTCP+KzIS5SA ($86 in chips)
Seat 5: +Nt3OPk3XR9SKjZgm2CexQ ($131.35 in chips)
Seat 6: Z2fXsGcjl+Eax+RzOgwOmg ($122.50 in chips)
Ws/3Uo3rQIk8hLgW0P+2xA: posts small blind $0.50
0smcry9L0OOTCP+KzIS5SA: posts big blind $1
*** HOLE CARDS ***
+Nt3OPk3XR9SKjZgm2CexQ: folds
Z2fXsGcjl+Eax+RzOgwOmg: folds
J798qwLuvXyq0BbzsIjOrA: folds
lXX4W7m3u++JiSOZ46yVMQ: folds
Ws/3Uo3rQIk8hLgW0P+2xA: calls $0.50
0smcry9L0OOTCP+KzIS5SA: raises $3 to $4
Ws/3Uo3rQIk8hLgW0P+2xA: calls $3
*** FLOP *** [6s Jh 2c]
Ws/3Uo3rQIk8hLgW0P+2xA: checks
0smcry9L0OOTCP+KzIS5SA: bets $5.50
Ws/3Uo3rQIk8hLgW0P+2xA: folds
0smcry9L0OOTCP+KzIS5SA collected $7.60 from pot
0smcry9L0OOTCP+KzIS5SA: doesn't show hand
*** SUMMARY ***
Total pot $8 | Rake $0.40
Board [6s Jh 2c]
Seat 1: J798qwLuvXyq0BbzsIjOrA folded before Flop (didn't bet)
Seat 2: lXX4W7m3u++JiSOZ46yVMQ (button) folded before Flop (didn't bet)
Seat 3: Ws/3Uo3rQIk8hLgW0P+2xA (small blind) folded on the Flop
Seat 4: 0smcry9L0OOTCP+KzIS5SA (big blind) collected ($7.60)
Seat 5: +Nt3OPk3XR9SKjZgm2CexQ folded before Flop (didn't bet)
Seat 6: Z2fXsGcjl+Eax+RzOgwOmg folded before Flop (didn't bet)



PokerStars Game #59941765218:  Hold'em No Limit ($0.50/$1.00) - 2009/07/01 1:45:26 ET
Table 'ZFWj23PMihdwrNWv41OG/QtyUh+jyNvrceIQdKMJjQ2weat #2 is the button
Seat 1: rHlMOfR7kpQQxe+PFQz0xQ ($49 in chips)
Seat 2: 0smcry9L0OOTCP+KzIS5SA ($91.50 in chips)
Seat 3: cWwhvq/+r/w8nkhwrJoekQ ($66.20 in chips)
Seat 4: O5ZesE/6mHyuWWbvkiH/Fg ($74.85 in chips)
Seat 5: j7NIOHLZk7V2o9fOioO5ug ($100 in chips)
cWwhvq/+r/w8nkhwrJoekQ: posts small blind $0.50
O5ZesE/6mHyuWWbvkiH/Fg: posts big blind $1
*** HOLE CARDS ***
j7NIOHLZk7V2o9fOioO5ug: folds
2pacalyps joins the table at seat #6
rHlMOfR7kpQQxe+PFQz0xQ: folds
0smcry9L0OOTCP+KzIS5SA: folds
cWwhvq/+r/w8nkhwrJoekQ: folds
O5ZesE/6mHyuWWbvkiH/Fg collected $1 from pot
*** SUMMARY ***
Total pot $1 | Rake $0
Seat 1: rHlMOfR7kpQQxe+PFQz0xQ folded before Flop (didn't bet)
Seat 2: 0smcry9L0OOTCP+KzIS5SA (button) folded before Flop (didn't bet)
Seat 3: cWwhvq/+r/w8nkhwrJoekQ (small blind) folded before Flop
Seat 4: O5ZesE/6mHyuWWbvkiH/Fg (big blind) collected ($1)
Seat 5: j7NIOHLZk7V2o9fOioO5ug folded before Flop (didn't bet)



PokerStars Game #59941765626:  Hold'em No Limit ($0.50/$1.00) - 2009/07/01 1:45:27 ET
Table 'blHlQApStil0OPeQxQxPcw' 9-max Seat #9 is the button
Seat 1: UhwCjxJI7sJbMAXzvZYHpA ($100.50 in chips)
Seat 2: V138SURkdX8LdVBPKdJJag ($121.35 in chips)
Seat 3: OGgaARGdJQT4awWVNQ957w ($103 in chips)
Seat 5: uXrDE6JrIi8BZK1L8oQ9bQ ($35.60 in chips)
Seat 6: vljeiOoWscAIXU0fCuiEBw ($44.65 in chips)
Seat 7: VPF+HjszMvUIpy0CHIwH3A ($18.50 in chips)
Seat 9: 6XkTu4ahxzHnvjjc1R8YjQ ($150.35 in chips)
UhwCjxJI7sJbMAXzvZYHpA: posts small blind $0.50
V138SURkdX8LdVBPKdJJag: posts big blind $1
myIxN7otsyr846M539YR8Q: sits out
*** HOLE CARDS ***
OGgaARGdJQT4awWVNQ957w: folds
uXrDE6JrIi8BZK1L8oQ9bQ: folds
vljeiOoWscAIXU0fCuiEBw: folds
VPF+HjszMvUIpy0CHIwH3A: folds
6XkTu4ahxzHnvjjc1R8YjQ: folds
UhwCjxJI7sJbMAXzvZYHpA: raises $3 to $4
V138SURkdX8LdVBPKdJJag: folds
UhwCjxJI7sJbMAXzvZYHpA collected $2 from pot
UhwCjxJI7sJbMAXzvZYHpA: doesn't show hand
*** SUMMARY ***
Total pot $2 | Rake $0
Seat 1: UhwCjxJI7sJbMAXzvZYHpA (small blind) collected ($2)
Seat 2: V138SURkdX8LdVBPKdJJag (big blind) folded before Flop
Seat 3: OGgaARGdJQT4awWVNQ957w folded before Flop (didn't bet)
Seat 5: uXrDE6JrIi8BZK1L8oQ9bQ folded before Flop (didn't bet)
Seat 6: vljeiOoWscAIXU0fCuiEBw folded before Flop (didn't bet)
Seat 7: VPF+HjszMvUIpy0CHIwH3A folded before Flop (didn't bet)
Seat 9: 6XkTu4ahxzHnvjjc1R8YjQ (button) folded before Flop (didn't bet)



PokerStars Game #59941766002:  Hold'em No Limit ($0.50/$1.00) - 2009/07/01 1:45:28 ET
Table 'iSx0wTgVb4o7MyZeOe06ZA' 9-max Seat #4 is the button
Seat 1: VPF+HjszMvUIpy0CHIwH3A ($15.75 in chips)
Seat 2: K6Pl7V7WGoykFCZOT8s6IQ ($100 in chips)
Seat 3: LvVcduCnUGWnxGDVhSrOXw ($100 in chips)
Seat 4: ri8CLkX3e9JF34dQNbsHGA ($32.45 in chips)
Seat 5: Pce2Q8yz4j5M9A62KvvNKw ($64.10 in chips)
Seat 6: Lik6kFnIxdZEESN5kBGZzA ($42.65 in chips)
Seat 7: w4NnqVr/Sfoj65ux/fEUyQ ($71.15 in chips)
Seat 8: gUUvmqdVlmvpal6B8nYrmg ($126.20 in chips)
Seat 9: mQADhUTC1xGjAJkD7PEg6A ($100 in chips)
Pce2Q8yz4j5M9A62KvvNKw: posts small blind $0.50
Lik6kFnIxdZEESN5kBGZzA: posts big blind $1
K6Pl7V7WGoykFCZOT8s6IQ: posts big blind $1
LvVcduCnUGWnxGDVhSrOXw: posts big blind $1
*** HOLE CARDS ***
w4NnqVr/Sfoj65ux/fEUyQ: folds
gUUvmqdVlmvpal6B8nYrmg: folds
mQADhUTC1xGjAJkD7PEg6A: folds
VPF+HjszMvUIpy0CHIwH3A: folds
K6Pl7V7WGoykFCZOT8s6IQ: raises $3 to $4
LvVcduCnUGWnxGDVhSrOXw: folds
ri8CLkX3e9JF34dQNbsHGA: folds
Pce2Q8yz4j5M9A62KvvNKw: calls $3.50
Lik6kFnIxdZEESN5kBGZzA: folds
*** FLOP *** [Jc 6h 8c]
Pce2Q8yz4j5M9A62KvvNKw: bets $3
K6Pl7V7WGoykFCZOT8s6IQ: raises $7 to $10
Pce2Q8yz4j5M9A62KvvNKw: folds
K6Pl7V7WGoykFCZOT8s6IQ collected $15.25 from pot
*** SUMMARY ***
Total pot $16 | Rake $0.75
Board [Jc 6h 8c]
Seat 1: VPF+HjszMvUIpy0CHIwH3A folded before Flop (didn't bet)
Seat 2: K6Pl7V7WGoykFCZOT8s6IQ collected ($15.25)
Seat 3: LvVcduCnUGWnxGDVhSrOXw folded before Flop
Seat 4: ri8CLkX3e9JF34dQNbsHGA (button) folded before Flop (didn't bet)
Seat 5: Pce2Q8yz4j5M9A62KvvNKw (small blind) folded on the Flop
Seat 6: Lik6kFnIxdZEESN5kBGZzA (big blind) folded before Flop
Seat 7: w4NnqVr/Sfoj65ux/fEUyQ folded before Flop (didn't bet)
Seat 8: gUUvmqdVlmvpal6B8nYrmg folded before Flop (didn't bet)
Seat 9: mQADhUTC1xGjAJkD7PEg6A folded before Flop (didn't bet)



PokerStars Game #59941766614:  Hold'em No Limit ($0.50/$1.00) - 2009/07/01 1:45:29 ET
Table 'fTlPiCj0utgzC/5io+I7ew' 6-max Seat #4 is the button
Seat 1: YMJG+F++3Aj6P8dAWda5fw ($100 in chips)
Seat 2: qVr1nl3dy2xXPqS8UpTDlA ($40.25 in chips)
Seat 3: Z2fXsGcjl+Eax+RzOgwOmg ($130 in chips)
Seat 4: uJVSceLggtsrJya+WtmUEA ($269.35 in chips)
Seat 5: XUk5GQsfNFpHvaToDZ0rZA ($39.55 in chips)
Seat 6: y27w5IK2WXqmYzS8OU0wKA ($100 in chips)
XUk5GQsfNFpHvaToDZ0rZA: posts small blind $0.50
y27w5IK2WXqmYzS8OU0wKA: posts big blind $1
*** HOLE CARDS ***
YMJG+F++3Aj6P8dAWda5fw: folds
qVr1nl3dy2xXPqS8UpTDlA: folds
Z2fXsGcjl+Eax+RzOgwOmg: folds
YMJG+F++3Aj6P8dAWda5fw said, "nh"
uJVSceLggtsrJya+WtmUEA: folds
XUk5GQsfNFpHvaToDZ0rZA: raises $2 to $3
y27w5IK2WXqmYzS8OU0wKA: folds
XUk5GQsfNFpHvaToDZ0rZA collected $2 from pot
XUk5GQsfNFpHvaToDZ0rZA: doesn't show hand
*** SUMMARY ***
Total pot $2 | Rake $0
Seat 1: YMJG+F++3Aj6P8dAWda5fw folded before Flop (didn't bet)
Seat 2: qVr1nl3dy2xXPqS8UpTDlA folded before Flop (didn't bet)
Seat 3: Z2fXsGcjl+Eax+RzOgwOmg folded before Flop (didn't bet)
Seat 4: uJVSceLggtsrJya+WtmUEA (button) folded before Flop (didn't bet)
Seat 5: XUk5GQsfNFpHvaToDZ0rZA (small blind) collected ($2)
Seat 6: y27w5IK2WXqmYzS8OU0wKA (big blind) folded before Flop



PokerStars Game #59941767564:  Hold'em No Limit ($0.50/$1.00) - 2009/07/01 1:45:31 ET
Table 'N2bNCDHL96aCQDvZIh+yQQ' 6-max Seat #2 is the button
Seat 1: Jjgflx10PVjcLkziEmLhSA ($92.25 in chips)
Seat 2: y27w5IK2WXqmYzS8OU0wKA ($128.65 in chips)
Seat 3: VB7TtBnfmT3JTA/cCL6dJg ($100 in chips)
Seat 4: uCqEjnxh2/vFBjKYkfTOkw ($159.20 in chips)
Seat 5: ene3nLSnQ4N961iBaUsSmA ($150.50 in chips)
Seat 6: idVgoPAdspFPCzee6aF9Pg ($100 in chips)
VB7TtBnfmT3JTA/cCL6dJg: posts small blind $0.50
uCqEjnxh2/vFBjKYkfTOkw: posts big blind $1
*** HOLE CARDS ***
ene3nLSnQ4N961iBaUsSmA: folds
idVgoPAdspFPCzee6aF9Pg: folds
Jjgflx10PVjcLkziEmLhSA: folds
y27w5IK2WXqmYzS8OU0wKA: folds
VB7TtBnfmT3JTA/cCL6dJg: folds
uCqEjnxh2/vFBjKYkfTOkw collected $1 from pot
uCqEjnxh2/vFBjKYkfTOkw: doesn't show hand
*** SUMMARY ***
Total pot $1 | Rake $0
Seat 1: Jjgflx10PVjcLkziEmLhSA folded before Flop (didn't bet)
Seat 2: y27w5IK2WXqmYzS8OU0wKA (button) folded before Flop (didn't bet)
Seat 3: VB7TtBnfmT3JTA/cCL6dJg (small blind) folded before Flop
Seat 4: uCqEjnxh2/vFBjKYkfTOkw (big blind) collected ($1)
Seat 5: ene3nLSnQ4N961iBaUsSmA folded before Flop (didn't bet)
Seat 6: idVgoPAdspFPCzee6aF9Pg folded before Flop (didn't bet)



PokerStars Game #59941768916:  Hold'em No Limit ($0.50/$1.00) - 2009/07/01 1:45:33 ET
Table 'MUPc8FEpe/nR0BKSeReX6Q' 6-max Seat #6 is the button
Seat 1: qhkK6+yCciTRd+rCFEbnEQ ($76.70 in chips)
Seat 2: xAU6q2/cwmby2sxmA8VcmA ($103.70 in chips)
Seat 3: wx3sQGkVi2x9wJXuWNHPBw ($286.15 in chips)
Seat 4: r4lpoh2BJZ8S6zyQv1JeSw ($110 in chips)
Seat 5: y27w5IK2WXqmYzS8OU0wKA ($131.05 in chips)
Seat 6: ene3nLSnQ4N961iBaUsSmA ($106.35 in chips)
qhkK6+yCciTRd+rCFEbnEQ: posts small blind $0.50
xAU6q2/cwmby2sxmA8VcmA: posts big blind $1
*** HOLE CARDS ***
wx3sQGkVi2x9wJXuWNHPBw: folds
r4lpoh2BJZ8S6zyQv1JeSw: folds
y27w5IK2WXqmYzS8OU0wKA: folds
ene3nLSnQ4N961iBaUsSmA: raises $2 to $3
qhkK6+yCciTRd+rCFEbnEQ: calls $2.50
xAU6q2/cwmby2sxmA8VcmA: folds
*** FLOP *** [2d Jc 4c]
qhkK6+yCciTRd+rCFEbnEQ: checks
ene3nLSnQ4N961iBaUsSmA: bets $5
qhkK6+yCciTRd+rCFEbnEQ: folds
ene3nLSnQ4N961iBaUsSmA collected $6.65 from pot
ene3nLSnQ4N961iBaUsSmA: doesn't show hand
*** SUMMARY ***
Total pot $7 | Rake $0.35
Board [2d Jc 4c]
Seat 1: qhkK6+yCciTRd+rCFEbnEQ (small blind) folded on the Flop
Seat 2: xAU6q2/cwmby2sxmA8VcmA (big blind) folded before Flop
Seat 3: wx3sQGkVi2x9wJXuWNHPBw folded before Flop (didn't bet)
Seat 4: r4lpoh2BJZ8S6zyQv1JeSw folded before Flop (didn't bet)
Seat 5: y27w5IK2WXqmYzS8OU0wKA folded before Flop (didn't bet)
Seat 6: ene3nLSnQ4N961iBaUsSmA (button) collected ($6.65)



PokerStars Game #59941768842:  Hold'em No Limit ($0.50/$1.00) - 2009/07/01 1:45:33 ET
Table '3T4owEKJKyGTMePwrv50FQ' 9-max Seat #2 is the button
Seat 1: OGgaARGdJQT4awWVNQ957w ($100 in chips)
Seat 2: t+Id2O6herCLgwnC4m49PA ($35.25 in chips)
Seat 3: DOLzOcBTZYcph5jEfKFWuQ ($105.40 in chips)
Seat 4: kiakSwxX0e64PwYGAPQvLw ($33.25 in chips)
Seat 5: mMc/PBpqlN24gdi3C/1tOw ($50.25 in chips)
Seat 6: V138SURkdX8LdVBPKdJJag ($105.50 in chips)
Seat 7: 1862487932 ($105.50 in chips)
Seat 8: bLbSOSmSOnqE0iTcH/5dxA ($197 in chips)
Seat 9: 61sfw5QTu62YYIt68OsdrA ($83.25 in chips)
DOLzOcBTZYcph5jEfKFWuQ: posts small blind $0.50
kiakSwxX0e64PwYGAPQvLw: posts big blind $1
*** HOLE CARDS ***
mMc/PBpqlN24gdi3C/1tOw: folds
V138SURkdX8LdVBPKdJJag: folds
1862487932: folds
bLbSOSmSOnqE0iTcH/5dxA: folds
61sfw5QTu62YYIt68OsdrA: folds
OGgaARGdJQT4awWVNQ957w: folds
t+Id2O6herCLgwnC4m49PA: folds
DOLzOcBTZYcph5jEfKFWuQ: raises $2 to $3
kiakSwxX0e64PwYGAPQvLw: calls $2
*** FLOP *** [2c 9s 8d]
DOLzOcBTZYcph5jEfKFWuQ: checks
kiakSwxX0e64PwYGAPQvLw: bets $4
bLbSOSmSOnqE0iTcH/5dxA is sitting out
DOLzOcBTZYcph5jEfKFWuQ has timed out
DOLzOcBTZYcph5jEfKFWuQ: folds
DOLzOcBTZYcph5jEfKFWuQ is sitting out
kiakSwxX0e64PwYGAPQvLw collected $5.70 from pot
*** SUMMARY ***
Total pot $6 | Rake $0.30
Board [2c 9s 8d]
Seat 1: OGgaARGdJQT4awWVNQ957w folded before Flop (didn't bet)
Seat 2: t+Id2O6herCLgwnC4m49PA (button) folded before Flop (didn't bet)
Seat 3: DOLzOcBTZYcph5jEfKFWuQ (small blind) folded on the Flop
Seat 4: kiakSwxX0e64PwYGAPQvLw (big blind) collected ($5.70)
Seat 5: mMc/PBpqlN24gdi3C/1tOw folded before Flop (didn't bet)
Seat 6: V138SURkdX8LdVBPKdJJag folded before Flop (didn't bet)
Seat 7: 1862487932 folded before Flop (didn't bet)
Seat 8: bLbSOSmSOnqE0iTcH/5dxA folded before Flop (didn't bet)
Seat 9: 61sfw5QTu62YYIt68OsdrA folded before Flop (didn't bet)



PokerStars Game #59941769148:  Hold'em No Limit ($0.50/$1.00) - 2009/07/01 1:45:34 ET
Table 'O96CPOtvMBWP6kzuYDfdFA' 6-max Seat #2 is the button
Seat 1: 6alLXQIITA2EZ/lBeym8Dw ($141.65 in chips)
Seat 2: 4d1rWhpu8DzLmzMbR3QKyA ($100 in chips)
Seat 3: ieBUmHu5QBR86BArTtK4FQ ($19.95 in chips)
Seat 4: /P4w1pHg2zHYg/4ubJ0dPw ($63.45 in chips)
Seat 5: vX+iYAEINFeLxwMla7DY1Q ($87 in chips)
Seat 6: 3syOXva630dm1FTdwnuLpw ($80.10 in chips)
ieBUmHu5QBR86BArTtK4FQ: posts small blind $0.50
/P4w1pHg2zHYg/4ubJ0dPw: posts big blind $1
*** HOLE CARDS ***
vX+iYAEINFeLxwMla7DY1Q: folds
3syOXva630dm1FTdwnuLpw: folds
6alLXQIITA2EZ/lBeym8Dw: folds
4d1rWhpu8DzLmzMbR3QKyA: folds
ieBUmHu5QBR86BArTtK4FQ: folds
/P4w1pHg2zHYg/4ubJ0dPw collected $1 from pot
/P4w1pHg2zHYg/4ubJ0dPw: doesn't show hand
*** SUMMARY ***
Total pot $1 | Rake $0
Seat 1: 6alLXQIITA2EZ/lBeym8Dw folded before Flop (didn't bet)
Seat 2: 4d1rWhpu8DzLmzMbR3QKyA (button) folded before Flop (didn't bet)
Seat 3: ieBUmHu5QBR86BArTtK4FQ (small blind) folded before Flop
Seat 4: /P4w1pHg2zHYg/4ubJ0dPw (big blind) collected ($1)
Seat 5: vX+iYAEINFeLxwMla7DY1Q folded before Flop (didn't bet)
Seat 6: 3syOXva630dm1FTdwnuLpw folded before Flop (didn't bet)



PokerStars Game #59941769566:  Hold'em No Limit ($0.50/$1.00) - 2009/07/01 1:45:35 ET
Table 'b8oW/dOL7fDza5DfZ/dOJQ' 6-max Seat #2 is the button
Seat 1: NakujTNjHFgzceydFf+E2Q ($49.90 in chips)
Seat 2: TSuRyAHnUPCFjP7Z0rEE0w ($117.50 in chips)
Seat 3: d8WX+9nUHoqlrAGagO0Wow ($31.80 in chips)
Seat 5: sr/OkkgqNbtgwJf1tmnfNg ($73.20 in chips)
Seat 6: PvfYaKbzMpsmUcbOExckbQ ($160.55 in chips)
d8WX+9nUHoqlrAGagO0Wow: posts small blind $0.50
sr/OkkgqNbtgwJf1tmnfNg: posts big blind $1
*** HOLE CARDS ***
PvfYaKbzMpsmUcbOExckbQ: raises $2.50 to $3.50
NakujTNjHFgzceydFf+E2Q: folds
TSuRyAHnUPCFjP7Z0rEE0w: calls $3.50
d8WX+9nUHoqlrAGagO0Wow: folds
rHlMOfR7kpQQxe+PFQz0xQ joins the table at seat #4
sr/OkkgqNbtgwJf1tmnfNg: calls $2.50
*** FLOP *** [9s 5c Kd]
sr/OkkgqNbtgwJf1tmnfNg: checks
PvfYaKbzMpsmUcbOExckbQ: bets $6
TSuRyAHnUPCFjP7Z0rEE0w: folds
sr/OkkgqNbtgwJf1tmnfNg: folds
PvfYaKbzMpsmUcbOExckbQ collected $10.45 from pot
PvfYaKbzMpsmUcbOExckbQ: doesn't show hand
*** SUMMARY ***
Total pot $11 | Rake $0.55
Board [9s 5c Kd]
Seat 1: NakujTNjHFgzceydFf+E2Q folded before Flop (didn't bet)
Seat 2: TSuRyAHnUPCFjP7Z0rEE0w (button) folded on the Flop
Seat 3: d8WX+9nUHoqlrAGagO0Wow (small blind) folded before Flop
Seat 5: sr/OkkgqNbtgwJf1tmnfNg (big blind) folded on the Flop
Seat 6: PvfYaKbzMpsmUcbOExckbQ collected ($10.45)



PokerStars Game #59941770930:  Hold'em No Limit ($0.50/$1.00) - 2009/07/01 1:45:37 ET
Table 'ZFWj23PMihdwrNWv41OG/QtyUh+jyNvrceIQdKMJjQ2weat #3 is the button
Seat 1: rHlMOfR7kpQQxe+PFQz0xQ ($49 in chips)
Seat 2: 0smcry9L0OOTCP+KzIS5SA ($91.50 in chips)
Seat 3: cWwhvq/+r/w8nkhwrJoekQ ($65.70 in chips)
Seat 4: O5ZesE/6mHyuWWbvkiH/Fg ($75.35 in chips)
Seat 5: j7NIOHLZk7V2o9fOioO5ug ($100 in chips)
O5ZesE/6mHyuWWbvkiH/Fg: posts small blind $0.50
j7NIOHLZk7V2o9fOioO5ug: posts big blind $1
2pacalyps: sits out
*** HOLE CARDS ***
rHlMOfR7kpQQxe+PFQz0xQ: folds
0smcry9L0OOTCP+KzIS5SA: raises $2 to $3
cWwhvq/+r/w8nkhwrJoekQ: folds
O5ZesE/6mHyuWWbvkiH/Fg: calls $2.50
j7NIOHLZk7V2o9fOioO5ug: folds
*** FLOP *** [5h 3d 4c]
O5ZesE/6mHyuWWbvkiH/Fg: checks
0smcry9L0OOTCP+KzIS5SA: bets $4.50
O5ZesE/6mHyuWWbvkiH/Fg: calls $4.50
*** TURN *** [5h 3d 4c] [8s]
O5ZesE/6mHyuWWbvkiH/Fg: checks
0smcry9L0OOTCP+KzIS5SA: checks
*** RIVER *** [5h 3d 4c 8s] [Ks]
O5ZesE/6mHyuWWbvkiH/Fg: bets $10
0smcry9L0OOTCP+KzIS5SA: calls $10
*** SHOW DOWN ***
O5ZesE/6mHyuWWbvkiH/Fg: shows [7d 6d] (a straight, Four to Eight)
0smcry9L0OOTCP+KzIS5SA: mucks hand
O5ZesE/6mHyuWWbvkiH/Fg collected $34.25 from pot
*** SUMMARY ***
Total pot $36 | Rake $1.75
Board [5h 3d 4c 8s Ks]
Seat 1: rHlMOfR7kpQQxe+PFQz0xQ folded before Flop (didn't bet)
Seat 2: 0smcry9L0OOTCP+KzIS5SA mucked
Seat 3: cWwhvq/+r/w8nkhwrJoekQ (button) folded before Flop (didn't bet)
Seat 4: O5ZesE/6mHyuWWbvkiH/Fg (small blind) showed [7d 6d] and won ($34.25) with a straight, Four to Eight
Seat 5: j7NIOHLZk7V2o9fOioO5ug (big blind) folded before Flop



PokerStars Game #59941771160:  Hold'em No Limit ($0.50/$1.00) - 2009/07/01 1:45:38 ET
Table 'GxCPo/gd3OSthkYrAxJngg' 6-max Seat #1 is the button
Seat 1: sH8BpAFP+jGFxCgVpD1Lew ($240.25 in chips)
Seat 2: YExX2paeIHrmfIwV1ivM/w ($60.60 in chips)
Seat 3: idVgoPAdspFPCzee6aF9Pg ($137.50 in chips)
Seat 4: YMJG+F++3Aj6P8dAWda5fw ($209.75 in chips)
Seat 5: vX+iYAEINFeLxwMla7DY1Q ($98 in chips)
Seat 6: 4d1rWhpu8DzLmzMbR3QKyA ($100 in chips)
YExX2paeIHrmfIwV1ivM/w: posts small blind $0.50
idVgoPAdspFPCzee6aF9Pg: posts big blind $1
*** HOLE CARDS ***
YMJG+F++3Aj6P8dAWda5fw: folds
vX+iYAEINFeLxwMla7DY1Q: folds
4d1rWhpu8DzLmzMbR3QKyA: raises $2 to $3
sH8BpAFP+jGFxCgVpD1Lew: folds
YExX2paeIHrmfIwV1ivM/w: folds
idVgoPAdspFPCzee6aF9Pg: folds
4d1rWhpu8DzLmzMbR3QKyA collected $2.50 from pot
*** SUMMARY ***
Total pot $2.50 | Rake $0
Seat 1: sH8BpAFP+jGFxCgVpD1Lew (button) folded before Flop (didn't bet)
Seat 2: YExX2paeIHrmfIwV1ivM/w (small blind) folded before Flop
Seat 3: idVgoPAdspFPCzee6aF9Pg (big blind) folded before Flop
Seat 4: YMJG+F++3Aj6P8dAWda5fw folded before Flop (didn't bet)
Seat 5: vX+iYAEINFeLxwMla7DY1Q folded before Flop (didn't bet)
Seat 6: 4d1rWhpu8DzLmzMbR3QKyA collected ($2.50)



PokerStars Game #59941771174:  Hold'em No Limit ($0.50/$1.00) - 2009/07/01 1:45:38 ET
Table 'DvFb+QVx+4Mvu7tghrGtVg' 6-max Seat #4 is the button
Seat 1: 1ifNpObXxyEaiFAVxWBVNQ ($145.20 in chips)
Seat 2: YMJG+F++3Aj6P8dAWda5fw ($101.50 in chips)
Seat 3: TSuRyAHnUPCFjP7Z0rEE0w ($100 in chips)
Seat 4: hpxXcmRkXXI9HE5+5/j/0Q ($105.90 in chips)
Seat 5: V3iZdcw61nXF3g5hD2RrsQ ($110.50 in chips)
Seat 6: y27w5IK2WXqmYzS8OU0wKA ($187.50 in chips)
V3iZdcw61nXF3g5hD2RrsQ: posts small blind $0.50
y27w5IK2WXqmYzS8OU0wKA: posts big blind $1
*** HOLE CARDS ***
1ifNpObXxyEaiFAVxWBVNQ: calls $1
YMJG+F++3Aj6P8dAWda5fw: folds
TSuRyAHnUPCFjP7Z0rEE0w: raises $3 to $4
hpxXcmRkXXI9HE5+5/j/0Q: calls $4
V3iZdcw61nXF3g5hD2RrsQ: calls $3.50
y27w5IK2WXqmYzS8OU0wKA: calls $3
1ifNpObXxyEaiFAVxWBVNQ: folds
*** FLOP *** [Qh Kc Ac]
V3iZdcw61nXF3g5hD2RrsQ: checks
y27w5IK2WXqmYzS8OU0wKA: bets $1
TSuRyAHnUPCFjP7Z0rEE0w: calls $1
hpxXcmRkXXI9HE5+5/j/0Q: folds
V3iZdcw61nXF3g5hD2RrsQ: calls $1
*** TURN *** [Qh Kc Ac] [8c]
V3iZdcw61nXF3g5hD2RrsQ: checks
y27w5IK2WXqmYzS8OU0wKA: checks
TSuRyAHnUPCFjP7Z0rEE0w: checks
*** RIVER *** [Qh Kc Ac 8c] [7d]
V3iZdcw61nXF3g5hD2RrsQ: checks
y27w5IK2WXqmYzS8OU0wKA: checks
TSuRyAHnUPCFjP7Z0rEE0w: checks
*** SHOW DOWN ***
V3iZdcw61nXF3g5hD2RrsQ: shows [Qd 9d] (a pair of Queens)
y27w5IK2WXqmYzS8OU0wKA: mucks hand
TSuRyAHnUPCFjP7Z0rEE0w: shows [Qs Jd] (a pair of Queens - Ace+King+Jack kicker)
TSuRyAHnUPCFjP7Z0rEE0w collected $19.05 from pot
*** SUMMARY ***
Total pot $20 | Rake $0.95
Board [Qh Kc Ac 8c 7d]
Seat 1: 1ifNpObXxyEaiFAVxWBVNQ folded before Flop
Seat 2: YMJG+F++3Aj6P8dAWda5fw folded before Flop (didn't bet)
Seat 3: TSuRyAHnUPCFjP7Z0rEE0w showed [Qs Jd] and won ($19.05) with a pair of Queens
Seat 4: hpxXcmRkXXI9HE5+5/j/0Q (button) folded on the Flop
Seat 5: V3iZdcw61nXF3g5hD2RrsQ (small blind) showed [Qd 9d] and lost with a pair of Queens
Seat 6: y27w5IK2WXqmYzS8OU0wKA (big blind) mucked



PokerStars Game #59941773068:  Hold'em No Limit ($0.50/$1.00) - 2009/07/01 1:45:41 ET
Table 'W/wyObTiXZm+Ckkl3YxcSw' 6-max Seat #6 is the button
Seat 1: GHv97X0qtwmxPTR3hKuNvg ($38.50 in chips)
Seat 2: oDiBRCaF0QVtd3kO6xZIXw ($80.15 in chips)
Seat 3: 4OO5v3AVduL0tePNx8wk5A ($100 in chips)
Seat 4: rHlMOfR7kpQQxe+PFQz0xQ ($96 in chips)
Seat 5: +OrCjyw70oZhJiD22Mn+bg ($199 in chips)
Seat 6: b2a+5TkFf4xJN/Ihhma58Q ($34.10 in chips)
GHv97X0qtwmxPTR3hKuNvg: posts small blind $0.50
oDiBRCaF0QVtd3kO6xZIXw: posts big blind $1
*** HOLE CARDS ***
4OO5v3AVduL0tePNx8wk5A: folds
rHlMOfR7kpQQxe+PFQz0xQ: folds
+OrCjyw70oZhJiD22Mn+bg: folds
b2a+5TkFf4xJN/Ihhma58Q: folds
GHv97X0qtwmxPTR3hKuNvg: raises $2 to $3
oDiBRCaF0QVtd3kO6xZIXw: calls $2
*** FLOP *** [Jh 8s 6h]
GHv97X0qtwmxPTR3hKuNvg: checks
oDiBRCaF0QVtd3kO6xZIXw: bets $4
GHv97X0qtwmxPTR3hKuNvg: raises $6 to $10
oDiBRCaF0QVtd3kO6xZIXw: raises $20 to $30
GHv97X0qtwmxPTR3hKuNvg: raises $5.50 to $35.50 and is all-in
oDiBRCaF0QVtd3kO6xZIXw: calls $5.50
*** TURN *** [Jh 8s 6h] [As]
*** RIVER *** [Jh 8s 6h As] [5c]
*** SHOW DOWN ***
GHv97X0qtwmxPTR3hKuNvg: shows [4s 6s] (a pair of Sixes)
oDiBRCaF0QVtd3kO6xZIXw: shows [3h 8h] (a pair of Eights)
oDiBRCaF0QVtd3kO6xZIXw collected $74 from pot
*** SUMMARY ***
Total pot $77 | Rake $3
Board [Jh 8s 6h As 5c]
Seat 1: GHv97X0qtwmxPTR3hKuNvg (small blind) showed [4s 6s] and lost with a pair of Sixes
Seat 2: oDiBRCaF0QVtd3kO6xZIXw (big blind) showed [3h 8h] and won ($74) with a pair of Eights
Seat 3: 4OO5v3AVduL0tePNx8wk5A folded before Flop (didn't bet)
Seat 4: rHlMOfR7kpQQxe+PFQz0xQ folded before Flop (didn't bet)
Seat 5: +OrCjyw70oZhJiD22Mn+bg folded before Flop (didn't bet)
Seat 6: b2a+5TkFf4xJN/Ihhma58Q (button) folded before Flop (didn't bet)



PokerStars Game #59941773632:  Hold'em No Limit ($0.50/$1.00) - 2009/07/01 1:45:42 ET
Table '7O9fB8yx1u7sJveJn8w6jA' 6-max Seat #6 is the button
Seat 1: 841740 ($35.80 in chips)
Seat 2: wx3sQGkVi2x9wJXuWNHPBw ($205.35 in chips)
Seat 3: hpxXcmRkXXI9HE5+5/j/0Q ($145.45 in chips)
Seat 4: b2a+5TkFf4xJN/Ihhma58Q ($24.65 in chips)
Seat 5: BCEV3COoKY607AzLWayfRA ($107.20 in chips)
Seat 6: r4lpoh2BJZ8S6zyQv1JeSw ($110.75 in chips)
841740: posts small blind $0.50
wx3sQGkVi2x9wJXuWNHPBw: posts big blind $1
*** HOLE CARDS ***
hpxXcmRkXXI9HE5+5/j/0Q: folds
b2a+5TkFf4xJN/Ihhma58Q: folds
BCEV3COoKY607AzLWayfRA has timed out
BCEV3COoKY607AzLWayfRA: folds
BCEV3COoKY607AzLWayfRA is sitting out
BCEV3COoKY607AzLWayfRA has returned
r4lpoh2BJZ8S6zyQv1JeSw: folds
841740: calls $0.50
wx3sQGkVi2x9wJXuWNHPBw: checks
*** FLOP *** [3h Qc Td]
841740: bets $1
wx3sQGkVi2x9wJXuWNHPBw: folds
841740 collected $1.90 from pot
*** SUMMARY ***
Total pot $2 | Rake $0.10
Board [3h Qc Td]
Seat 1: 841740 (small blind) collected ($1.90)
Seat 2: wx3sQGkVi2x9wJXuWNHPBw (big blind) folded on the Flop
Seat 3: hpxXcmRkXXI9HE5+5/j/0Q folded before Flop (didn't bet)
Seat 4: b2a+5TkFf4xJN/Ihhma58Q folded before Flop (didn't bet)
Seat 5: BCEV3COoKY607AzLWayfRA folded before Flop (didn't bet)
Seat 6: r4lpoh2BJZ8S6zyQv1JeSw (button) folded before Flop (didn't bet)



PokerStars Game #59941776586:  Hold'em No Limit ($0.50/$1.00) - 2009/07/01 1:45:48 ET
Table '7Nl0ffnjeK44/vmeexh3MQ' 9-max Seat #9 is the button
Seat 1: V138SURkdX8LdVBPKdJJag ($113.55 in chips)
Seat 2: OGgaARGdJQT4awWVNQ957w ($101.50 in chips)
Seat 3: JMmUYT5pIKCKh2pGjCB/4w ($61.05 in chips)
Seat 4: bLbSOSmSOnqE0iTcH/5dxA ($107.55 in chips)
Seat 5: 61sfw5QTu62YYIt68OsdrA ($76.05 in chips)
Seat 6: FVs16t7GgfWgQWt4JxsObQ ($26.95 in chips)
Seat 7: 2fVA6XTmacKkwJ4SpKDAtA ($85.50 in chips)
Seat 8: HRJJZiSxFAehJGaET63dlA ($45.40 in chips)
Seat 9: /JHoNdt0fK6X+isrqRfV3w ($18.50 in chips)
V138SURkdX8LdVBPKdJJag: posts small blind $0.50
OGgaARGdJQT4awWVNQ957w: posts big blind $1
*** HOLE CARDS ***
JMmUYT5pIKCKh2pGjCB/4w: folds
bLbSOSmSOnqE0iTcH/5dxA: folds
61sfw5QTu62YYIt68OsdrA: folds
FVs16t7GgfWgQWt4JxsObQ: folds
2fVA6XTmacKkwJ4SpKDAtA: folds
HRJJZiSxFAehJGaET63dlA: raises $2 to $3
/JHoNdt0fK6X+isrqRfV3w: folds
V138SURkdX8LdVBPKdJJag: folds
OGgaARGdJQT4awWVNQ957w: folds
HRJJZiSxFAehJGaET63dlA collected $2.50 from pot
*** SUMMARY ***
Total pot $2.50 | Rake $0
Seat 1: V138SURkdX8LdVBPKdJJag (small blind) folded before Flop
Seat 2: OGgaARGdJQT4awWVNQ957w (big blind) folded before Flop
Seat 3: JMmUYT5pIKCKh2pGjCB/4w folded before Flop (didn't bet)
Seat 4: bLbSOSmSOnqE0iTcH/5dxA folded before Flop (didn't bet)
Seat 5: 61sfw5QTu62YYIt68OsdrA folded before Flop (didn't bet)
Seat 6: FVs16t7GgfWgQWt4JxsObQ folded before Flop (didn't bet)
Seat 7: 2fVA6XTmacKkwJ4SpKDAtA folded before Flop (didn't bet)
Seat 8: HRJJZiSxFAehJGaET63dlA collected ($2.50)
Seat 9: /JHoNdt0fK6X+isrqRfV3w (button) folded before Flop (didn't bet)



PokerStars Game #59941776438:  Hold'em No Limit ($0.50/$1.00) - 2009/07/01 1:45:48 ET
Table 'blHlQApStil0OPeQxQxPcw' 9-max Seat #1 is the button
Seat 1: UhwCjxJI7sJbMAXzvZYHpA ($101.50 in chips)
Seat 2: V138SURkdX8LdVBPKdJJag ($120.35 in chips)
Seat 3: OGgaARGdJQT4awWVNQ957w ($103 in chips)
Seat 5: uXrDE6JrIi8BZK1L8oQ9bQ ($35.60 in chips)
Seat 6: vljeiOoWscAIXU0fCuiEBw ($44.65 in chips)
Seat 7: VPF+HjszMvUIpy0CHIwH3A ($18.50 in chips)
Seat 9: 6XkTu4ahxzHnvjjc1R8YjQ ($150.35 in chips)
V138SURkdX8LdVBPKdJJag: posts small blind $0.50
OGgaARGdJQT4awWVNQ957w: posts big blind $1
myIxN7otsyr846M539YR8Q: sits out
*** HOLE CARDS ***
uXrDE6JrIi8BZK1L8oQ9bQ: calls $1
vljeiOoWscAIXU0fCuiEBw: folds
VPF+HjszMvUIpy0CHIwH3A: folds
6XkTu4ahxzHnvjjc1R8YjQ: folds
UhwCjxJI7sJbMAXzvZYHpA: folds
V138SURkdX8LdVBPKdJJag: folds
OGgaARGdJQT4awWVNQ957w: checks
*** FLOP *** [3s Jh 9d]
OGgaARGdJQT4awWVNQ957w: checks
uXrDE6JrIi8BZK1L8oQ9bQ: bets $5
OGgaARGdJQT4awWVNQ957w: folds
uXrDE6JrIi8BZK1L8oQ9bQ collected $2.40 from pot
*** SUMMARY ***
Total pot $2.50 | Rake $0.10
Board [3s Jh 9d]
Seat 1: UhwCjxJI7sJbMAXzvZYHpA (button) folded before Flop (didn't bet)
Seat 2: V138SURkdX8LdVBPKdJJag (small blind) folded before Flop
Seat 3: OGgaARGdJQT4awWVNQ957w (big blind) folded on the Flop
Seat 5: uXrDE6JrIi8BZK1L8oQ9bQ collected ($2.40)
Seat 6: vljeiOoWscAIXU0fCuiEBw folded before Flop (didn't bet)
Seat 7: VPF+HjszMvUIpy0CHIwH3A folded before Flop (didn't bet)
Seat 9: 6XkTu4ahxzHnvjjc1R8YjQ folded before Flop (didn't bet)



PokerStars Game #59941777764:  Hold'em No Limit ($0.50/$1.00) - 2009/07/01 1:45:50 ET
Table 'hugOjcwJvzEwZbK7tyiWuQ' 9-max Seat #7 is the button
Seat 1: S3Ex8K7v6xm5jqjRM7Fl3w ($21.35 in chips)
Seat 2: r27C1nIV4NS4+qbnrgBQSw ($283.15 in chips)
Seat 3: c/6hFCyfLNRn3VFvCeQ1ng ($27.55 in chips)
Seat 4: UWB3oeddt/GObx2Mix2Anw ($194.75 in chips)
Seat 6: gUUvmqdVlmvpal6B8nYrmg ($102.45 in chips)
Seat 7: FL3MrLspcF23LYvC4ipBOA ($108.30 in chips)
Seat 8: /zy+DB4S5fUQUSfZWFzYGw ($120.55 in chips)
Seat 9: ri8CLkX3e9JF34dQNbsHGA ($25 in chips)
/zy+DB4S5fUQUSfZWFzYGw: posts small blind $0.50
ri8CLkX3e9JF34dQNbsHGA: posts big blind $1
aM6BB+PnB/rDUr2dbRda+A: sits out
*** HOLE CARDS ***
S3Ex8K7v6xm5jqjRM7Fl3w: folds
r27C1nIV4NS4+qbnrgBQSw: folds
c/6hFCyfLNRn3VFvCeQ1ng: raises $1 to $2
UWB3oeddt/GObx2Mix2Anw: folds
gUUvmqdVlmvpal6B8nYrmg: folds
FL3MrLspcF23LYvC4ipBOA: folds
/zy+DB4S5fUQUSfZWFzYGw: calls $1.50
ri8CLkX3e9JF34dQNbsHGA: calls $1
*** FLOP *** [As 2h Kd]
/zy+DB4S5fUQUSfZWFzYGw: checks
ri8CLkX3e9JF34dQNbsHGA: bets $4
c/6hFCyfLNRn3VFvCeQ1ng: calls $4
/zy+DB4S5fUQUSfZWFzYGw: folds
*** TURN *** [As 2h Kd] [Ad]
ri8CLkX3e9JF34dQNbsHGA: checks
c/6hFCyfLNRn3VFvCeQ1ng: checks
*** RIVER *** [As 2h Kd Ad] [9h]
ri8CLkX3e9JF34dQNbsHGA: bets $8
c/6hFCyfLNRn3VFvCeQ1ng: calls $8
*** SHOW DOWN ***
ri8CLkX3e9JF34dQNbsHGA: shows [Jd Ah] (three of a kind, Aces)
c/6hFCyfLNRn3VFvCeQ1ng: mucks hand
ri8CLkX3e9JF34dQNbsHGA collected $28.55 from pot
*** SUMMARY ***
Total pot $30 | Rake $1.45
Board [As 2h Kd Ad 9h]
Seat 1: S3Ex8K7v6xm5jqjRM7Fl3w folded before Flop (didn't bet)
Seat 2: r27C1nIV4NS4+qbnrgBQSw folded before Flop (didn't bet)
Seat 3: c/6hFCyfLNRn3VFvCeQ1ng mucked
Seat 4: UWB3oeddt/GObx2Mix2Anw folded before Flop (didn't bet)
Seat 6: gUUvmqdVlmvpal6B8nYrmg folded before Flop (didn't bet)
Seat 7: FL3MrLspcF23LYvC4ipBOA (button) folded before Flop (didn't bet)
Seat 8: /zy+DB4S5fUQUSfZWFzYGw (small blind) folded on the Flop
Seat 9: ri8CLkX3e9JF34dQNbsHGA (big blind) showed [Jd Ah] and won ($28.55) with three of a kind, Aces



PokerStars Game #59941778142:  Hold'em No Limit ($0.50/$1.00) - 2009/07/01 1:45:51 ET
Table 'VOs36P6NW+QyXeQ1B62kmAE9S5sEoK9Q3olj2a53gABASeat #5 is the button
Seat 1: 4h8XtuVJtWh3DJpxGo7k5Q ($24.95 in chips)
Seat 2: y27w5IK2WXqmYzS8OU0wKA ($152.50 in chips)
Seat 3: p00KmyZiD/isPc/lZwNBTg ($10.75 in chips)
Seat 4: ene3nLSnQ4N961iBaUsSmA ($100 in chips)
Seat 5: o3YLm/rSY916m/on1VjXPA ($133.10 in chips)
Seat 6: slVKuQyEz8Qj4E3uLPYNXg ($49.25 in chips)
slVKuQyEz8Qj4E3uLPYNXg: posts small blind $0.50
4h8XtuVJtWh3DJpxGo7k5Q: posts big blind $1
*** HOLE CARDS ***
y27w5IK2WXqmYzS8OU0wKA: folds
p00KmyZiD/isPc/lZwNBTg: raises $2 to $3
ene3nLSnQ4N961iBaUsSmA: folds
o3YLm/rSY916m/on1VjXPA: raises $4 to $7
slVKuQyEz8Qj4E3uLPYNXg: folds
4h8XtuVJtWh3DJpxGo7k5Q: folds
p00KmyZiD/isPc/lZwNBTg: raises $3.75 to $10.75 and is all-in
o3YLm/rSY916m/on1VjXPA: calls $3.75
*** FLOP *** [Kh 9d Ac]
*** TURN *** [Kh 9d Ac] [5d]
*** RIVER *** [Kh 9d Ac 5d] [3s]
*** SHOW DOWN ***
p00KmyZiD/isPc/lZwNBTg: shows [Tc Kd] (a pair of Kings)
o3YLm/rSY916m/on1VjXPA: shows [Ks Qd] (a pair of Kings - Ace+Queen kicker)
o3YLm/rSY916m/on1VjXPA collected $21.85 from pot
*** SUMMARY ***
Total pot $23 | Rake $1.15
Board [Kh 9d Ac 5d 3s]
Seat 1: 4h8XtuVJtWh3DJpxGo7k5Q (big blind) folded before Flop
Seat 2: y27w5IK2WXqmYzS8OU0wKA folded before Flop (didn't bet)
Seat 3: p00KmyZiD/isPc/lZwNBTg showed [Tc Kd] and lost with a pair of Kings
Seat 4: ene3nLSnQ4N961iBaUsSmA folded before Flop (didn't bet)
Seat 5: o3YLm/rSY916m/on1VjXPA (button) showed [Ks Qd] and won ($21.85) with a pair of Kings
Seat 6: slVKuQyEz8Qj4E3uLPYNXg (small blind) folded before Flop



PokerStars Game #59941779608:  Hold'em No Limit ($0.50/$1.00) - 2009/07/01 1:45:54 ET
Table '/RZcOwpZpHQ+OwPwjsbnRw' 6-max Seat #4 is the button
Seat 1: +uSzP8Jwnw7sKfQ4s66b7w ($108.65 in chips)
Seat 2: Z2fXsGcjl+Eax+RzOgwOmg ($102.65 in chips)
Seat 3: LJMw/I77xpnw0R5T4HnMUg ($84.55 in chips)
Seat 4: j7NIOHLZk7V2o9fOioO5ug ($111.70 in chips)
Seat 5: wx3sQGkVi2x9wJXuWNHPBw ($166.25 in chips)
Seat 6: o3YLm/rSY916m/on1VjXPA ($205.50 in chips)
wx3sQGkVi2x9wJXuWNHPBw: posts small blind $0.50
o3YLm/rSY916m/on1VjXPA: posts big blind $1
*** HOLE CARDS ***
+uSzP8Jwnw7sKfQ4s66b7w: folds
Z2fXsGcjl+Eax+RzOgwOmg: folds
+uSzP8Jwnw7sKfQ4s66b7w leaves the table
LJMw/I77xpnw0R5T4HnMUg: folds
j7NIOHLZk7V2o9fOioO5ug: folds
wx3sQGkVi2x9wJXuWNHPBw: folds
o3YLm/rSY916m/on1VjXPA collected $1 from pot
o3YLm/rSY916m/on1VjXPA: doesn't show hand
*** SUMMARY ***
Total pot $1 | Rake $0
Seat 1: +uSzP8Jwnw7sKfQ4s66b7w folded before Flop (didn't bet)
Seat 2: Z2fXsGcjl+Eax+RzOgwOmg folded before Flop (didn't bet)
Seat 3: LJMw/I77xpnw0R5T4HnMUg folded before Flop (didn't bet)
Seat 4: j7NIOHLZk7V2o9fOioO5ug (button) folded before Flop (didn't bet)
Seat 5: wx3sQGkVi2x9wJXuWNHPBw (small blind) folded before Flop
Seat 6: o3YLm/rSY916m/on1VjXPA (big blind) collected ($1)



PokerStars Game #59941779736:  Hold'em No Limit ($0.50/$1.00) - 2009/07/01 1:45:54 ET
Table '6YvsYDPNIDx2v5z3bJnwZQ' 9-max Seat #3 is the button
Seat 1: Ogn4JDV3mp4ZDKO49IFzKA ($19.80 in chips)
Seat 2: TAfo4veNRaRlzDXMMYS3Jg ($17 in chips)
Seat 3: K6OJDis3KfxSm/PKlkATUA ($56.05 in chips)
Seat 4: kEr5NYB+JIG5+szcYMr6hA ($71.85 in chips)
Seat 5: mBRWbnUl8diyBO1qTJaNzw ($136.25 in chips)
Seat 8: PSFxpXgPedVZyHSu2Zhb7Q ($104.25 in chips)
Seat 9: myIxN7otsyr846M539YR8Q ($18.50 in chips)
kEr5NYB+JIG5+szcYMr6hA: posts small blind $0.50
mBRWbnUl8diyBO1qTJaNzw: posts big blind $1
aM6BB+PnB/rDUr2dbRda+A: sits out
*** HOLE CARDS ***
PSFxpXgPedVZyHSu2Zhb7Q: calls $1
myIxN7otsyr846M539YR8Q: folds
Ogn4JDV3mp4ZDKO49IFzKA: folds
TAfo4veNRaRlzDXMMYS3Jg: folds
K6OJDis3KfxSm/PKlkATUA: folds
kEr5NYB+JIG5+szcYMr6hA: folds
mBRWbnUl8diyBO1qTJaNzw: checks
*** FLOP *** [8d 5d 7c]
mBRWbnUl8diyBO1qTJaNzw: checks
PSFxpXgPedVZyHSu2Zhb7Q: bets $2
mBRWbnUl8diyBO1qTJaNzw: folds
PSFxpXgPedVZyHSu2Zhb7Q collected $2.40 from pot
*** SUMMARY ***
Total pot $2.50 | Rake $0.10
Board [8d 5d 7c]
Seat 1: Ogn4JDV3mp4ZDKO49IFzKA folded before Flop (didn't bet)
Seat 2: TAfo4veNRaRlzDXMMYS3Jg folded before Flop (didn't bet)
Seat 3: K6OJDis3KfxSm/PKlkATUA (button) folded before Flop (didn't bet)
Seat 4: kEr5NYB+JIG5+szcYMr6hA (small blind) folded before Flop
Seat 5: mBRWbnUl8diyBO1qTJaNzw (big blind) folded on the Flop
Seat 8: PSFxpXgPedVZyHSu2Zhb7Q collected ($2.40)
Seat 9: myIxN7otsyr846M539YR8Q folded before Flop (didn't bet)



PokerStars Game #59941779962:  Hold'em No Limit ($0.50/$1.00) - 2009/07/01 1:45:55 ET
Table 'tJq9SfN1ywY0r03VBlWlwQ' 9-max Seat #5 is the button
Seat 1: wZsU+w9r7G66x93UuvBf1Q ($329.10 in chips)
Seat 4: bLbSOSmSOnqE0iTcH/5dxA ($116.70 in chips)
Seat 5: h5ipsNTMyolp7xn/NAvWkA ($97.20 in chips)
Seat 6: gUUvmqdVlmvpal6B8nYrmg ($107.60 in chips)
Seat 7: Ogn4JDV3mp4ZDKO49IFzKA ($18.40 in chips)
Seat 8: G4DEhsZFmznGNVpy2SEocA ($39.30 in chips)
Seat 9: XE5QF1y74bpHog9JxWJMWQ ($100 in chips)
gUUvmqdVlmvpal6B8nYrmg: posts small blind $0.50
Ogn4JDV3mp4ZDKO49IFzKA: posts big blind $1
myIxN7otsyr846M539YR8Q: sits out
*** HOLE CARDS ***
G4DEhsZFmznGNVpy2SEocA: folds
XE5QF1y74bpHog9JxWJMWQ: folds
wZsU+w9r7G66x93UuvBf1Q: folds
bLbSOSmSOnqE0iTcH/5dxA: raises $3 to $4
h5ipsNTMyolp7xn/NAvWkA: calls $4
gUUvmqdVlmvpal6B8nYrmg: folds
Ogn4JDV3mp4ZDKO49IFzKA: folds
*** FLOP *** [Kd 7c 5s]
bLbSOSmSOnqE0iTcH/5dxA: checks
h5ipsNTMyolp7xn/NAvWkA: bets $3
bLbSOSmSOnqE0iTcH/5dxA: folds
bLbSOSmSOnqE0iTcH/5dxA is sitting out
h5ipsNTMyolp7xn/NAvWkA collected $9.05 from pot
*** SUMMARY ***
Total pot $9.50 | Rake $0.45
Board [Kd 7c 5s]
Seat 1: wZsU+w9r7G66x93UuvBf1Q folded before Flop (didn't bet)
Seat 4: bLbSOSmSOnqE0iTcH/5dxA folded on the Flop
Seat 5: h5ipsNTMyolp7xn/NAvWkA (button) collected ($9.05)
Seat 6: gUUvmqdVlmvpal6B8nYrmg (small blind) folded before Flop
Seat 7: Ogn4JDV3mp4ZDKO49IFzKA (big blind) folded before Flop
Seat 8: G4DEhsZFmznGNVpy2SEocA folded before Flop (didn't bet)
Seat 9: XE5QF1y74bpHog9JxWJMWQ folded before Flop (didn't bet)



PokerStars Game #59941781700:  Hold'em No Limit ($0.50/$1.00) - 2009/07/01 1:45:58 ET
Table 'uNlePsyMIqzM691Xkrlk6Q' 9-max Seat #1 is the button
Seat 1: bLbSOSmSOnqE0iTcH/5dxA ($108.40 in chips)
Seat 2: TAfo4veNRaRlzDXMMYS3Jg ($19 in chips)
Seat 3: h7qXkU57Bb8ZuPwMyxR8Ug ($119 in chips)
Seat 4: WRTVKFHeb0vRJnVi5NdJZw ($43.25 in chips)
Seat 5: G9Fo2TZCN7HI43Po4zSN3A ($109.40 in chips)
Seat 6: mMc/PBpqlN24gdi3C/1tOw ($39 in chips)
Seat 7: KNAaBvPYSXyLqb88ypSbuQ ($37.45 in chips)
Seat 8: yWcEtGJ3ijZsF6HqlHqkrg ($115 in chips)
Seat 9: OGgaARGdJQT4awWVNQ957w ($116.50 in chips)
TAfo4veNRaRlzDXMMYS3Jg: posts small blind $0.50
h7qXkU57Bb8ZuPwMyxR8Ug: posts big blind $1
*** HOLE CARDS ***
WRTVKFHeb0vRJnVi5NdJZw: folds
G9Fo2TZCN7HI43Po4zSN3A: folds
mMc/PBpqlN24gdi3C/1tOw: folds
KNAaBvPYSXyLqb88ypSbuQ: calls $1
yWcEtGJ3ijZsF6HqlHqkrg: folds
OGgaARGdJQT4awWVNQ957w: folds
bLbSOSmSOnqE0iTcH/5dxA: folds
TAfo4veNRaRlzDXMMYS3Jg: folds
h7qXkU57Bb8ZuPwMyxR8Ug: checks
*** FLOP *** [Th 7h 5h]
h7qXkU57Bb8ZuPwMyxR8Ug: checks
KNAaBvPYSXyLqb88ypSbuQ: checks
*** TURN *** [Th 7h 5h] [7d]
bLbSOSmSOnqE0iTcH/5dxA is sitting out
h7qXkU57Bb8ZuPwMyxR8Ug: checks
KNAaBvPYSXyLqb88ypSbuQ: checks
*** RIVER *** [Th 7h 5h 7d] [9c]
h7qXkU57Bb8ZuPwMyxR8Ug: checks
KNAaBvPYSXyLqb88ypSbuQ: checks
*** SHOW DOWN ***
h7qXkU57Bb8ZuPwMyxR8Ug: shows [3h Jc] (a pair of Sevens)
KNAaBvPYSXyLqb88ypSbuQ: shows [4c As] (a pair of Sevens - Ace kicker)
KNAaBvPYSXyLqb88ypSbuQ collected $2.40 from pot
*** SUMMARY ***
Total pot $2.50 | Rake $0.10
Board [Th 7h 5h 7d 9c]
Seat 1: bLbSOSmSOnqE0iTcH/5dxA (button) folded before Flop (didn't bet)
Seat 2: TAfo4veNRaRlzDXMMYS3Jg (small blind) folded before Flop
Seat 3: h7qXkU57Bb8ZuPwMyxR8Ug (big blind) showed [3h Jc] and lost with a pair of Sevens
Seat 4: WRTVKFHeb0vRJnVi5NdJZw folded before Flop (didn't bet)
Seat 5: G9Fo2TZCN7HI43Po4zSN3A folded before Flop (didn't bet)
Seat 6: mMc/PBpqlN24gdi3C/1tOw folded before Flop (didn't bet)
Seat 7: KNAaBvPYSXyLqb88ypSbuQ showed [4c As] and won ($2.40) with a pair of Sevens
Seat 8: yWcEtGJ3ijZsF6HqlHqkrg folded before Flop (didn't bet)
Seat 9: OGgaARGdJQT4awWVNQ957w folded before Flop (didn't bet)



PokerStars Game #59941781706:  Hold'em No Limit ($0.50/$1.00) - 2009/07/01 1:45:58 ET
Table 'N2bNCDHL96aCQDvZIh+yQQ' 6-max Seat #3 is the button
Seat 1: Jjgflx10PVjcLkziEmLhSA ($92.25 in chips)
Seat 2: y27w5IK2WXqmYzS8OU0wKA ($128.65 in chips)
Seat 3: VB7TtBnfmT3JTA/cCL6dJg ($100 in chips)
Seat 4: uCqEjnxh2/vFBjKYkfTOkw ($159.70 in chips)
Seat 5: ene3nLSnQ4N961iBaUsSmA ($150.50 in chips)
Seat 6: idVgoPAdspFPCzee6aF9Pg ($100 in chips)
uCqEjnxh2/vFBjKYkfTOkw: posts small blind $0.50
ene3nLSnQ4N961iBaUsSmA: posts big blind $1
*** HOLE CARDS ***
idVgoPAdspFPCzee6aF9Pg: folds
Jjgflx10PVjcLkziEmLhSA: folds
y27w5IK2WXqmYzS8OU0wKA: folds
VB7TtBnfmT3JTA/cCL6dJg: raises $2 to $3
uCqEjnxh2/vFBjKYkfTOkw: folds
ene3nLSnQ4N961iBaUsSmA: folds
VB7TtBnfmT3JTA/cCL6dJg collected $2.50 from pot
VB7TtBnfmT3JTA/cCL6dJg: doesn't show hand
*** SUMMARY ***
Total pot $2.50 | Rake $0
Seat 1: Jjgflx10PVjcLkziEmLhSA folded before Flop (didn't bet)
Seat 2: y27w5IK2WXqmYzS8OU0wKA folded before Flop (didn't bet)
Seat 3: VB7TtBnfmT3JTA/cCL6dJg (button) collected ($2.50)
Seat 4: uCqEjnxh2/vFBjKYkfTOkw (small blind) folded before Flop
Seat 5: ene3nLSnQ4N961iBaUsSmA (big blind) folded before Flop
Seat 6: idVgoPAdspFPCzee6aF9Pg folded before Flop (didn't bet)



PokerStars Game #59941782070:  Hold'em No Limit ($0.50/$1.00) - 2009/07/01 1:45:58 ET
Table 'O96CPOtvMBWP6kzuYDfdFA' 6-max Seat #3 is the button
Seat 1: 6alLXQIITA2EZ/lBeym8Dw ($141.65 in chips)
Seat 2: 4d1rWhpu8DzLmzMbR3QKyA ($100 in chips)
Seat 3: ieBUmHu5QBR86BArTtK4FQ ($19.45 in chips)
Seat 4: /P4w1pHg2zHYg/4ubJ0dPw ($63.95 in chips)
Seat 5: vX+iYAEINFeLxwMla7DY1Q ($87 in chips)
Seat 6: 3syOXva630dm1FTdwnuLpw ($80.10 in chips)
/P4w1pHg2zHYg/4ubJ0dPw: posts small blind $0.50
vX+iYAEINFeLxwMla7DY1Q: posts big blind $1
*** HOLE CARDS ***
3syOXva630dm1FTdwnuLpw: folds
6alLXQIITA2EZ/lBeym8Dw: folds
4d1rWhpu8DzLmzMbR3QKyA: folds
ieBUmHu5QBR86BArTtK4FQ: raises $1 to $2
/P4w1pHg2zHYg/4ubJ0dPw: folds
vX+iYAEINFeLxwMla7DY1Q: calls $1
*** FLOP *** [9s Jh 3s]
vX+iYAEINFeLxwMla7DY1Q: bets $4
ieBUmHu5QBR86BArTtK4FQ: calls $4
*** TURN *** [9s Jh 3s] [Ad]
vX+iYAEINFeLxwMla7DY1Q: bets $7
ieBUmHu5QBR86BArTtK4FQ: folds
vX+iYAEINFeLxwMla7DY1Q collected $11.90 from pot
*** SUMMARY ***
Total pot $12.50 | Rake $0.60
Board [9s Jh 3s Ad]
Seat 1: 6alLXQIITA2EZ/lBeym8Dw folded before Flop (didn't bet)
Seat 2: 4d1rWhpu8DzLmzMbR3QKyA folded before Flop (didn't bet)
Seat 3: ieBUmHu5QBR86BArTtK4FQ (button) folded on the Turn
Seat 4: /P4w1pHg2zHYg/4ubJ0dPw (small blind) folded before Flop
Seat 5: vX+iYAEINFeLxwMla7DY1Q (big blind) collected ($11.90)
Seat 6: 3syOXva630dm1FTdwnuLpw folded before Flop (didn't bet)



PokerStars Game #59941782534:  Hold'em No Limit ($0.50/$1.00) - 2009/07/01 1:45:59 ET
Table 'pHrhryH8jPNdQfY62f8v+g' 6-max Seat #3 is the button
Seat 1: 4d1rWhpu8DzLmzMbR3QKyA ($143.95 in chips)
Seat 2: JwCcjZl0bjJzG7hmE0dnTA ($128.65 in chips)
Seat 3: 8oS5O7iD/qnFXFXJrGIgNQ ($115.40 in chips)
Seat 4: 1f3beyIML24UqEMTbWy93g ($37.85 in chips)
Seat 5: d8WX+9nUHoqlrAGagO0Wow ($15.50 in chips)
Seat 6: xAU6q2/cwmby2sxmA8VcmA ($202.30 in chips)
1f3beyIML24UqEMTbWy93g: posts small blind $0.50
d8WX+9nUHoqlrAGagO0Wow: posts big blind $1
*** HOLE CARDS ***
xAU6q2/cwmby2sxmA8VcmA: folds
4d1rWhpu8DzLmzMbR3QKyA: folds
JwCcjZl0bjJzG7hmE0dnTA: folds
8oS5O7iD/qnFXFXJrGIgNQ: folds
1f3beyIML24UqEMTbWy93g: folds
d8WX+9nUHoqlrAGagO0Wow collected $1 from pot
*** SUMMARY ***
Total pot $1 | Rake $0
Seat 1: 4d1rWhpu8DzLmzMbR3QKyA folded before Flop (didn't bet)
Seat 2: JwCcjZl0bjJzG7hmE0dnTA folded before Flop (didn't bet)
Seat 3: 8oS5O7iD/qnFXFXJrGIgNQ (button) folded before Flop (didn't bet)
Seat 4: 1f3beyIML24UqEMTbWy93g (small blind) folded before Flop
Seat 5: d8WX+9nUHoqlrAGagO0Wow (big blind) collected ($1)
Seat 6: xAU6q2/cwmby2sxmA8VcmA folded before Flop (didn't bet)



PokerStars Game #59941782608:  Hold'em No Limit ($0.50/$1.00) - 2009/07/01 1:45:59 ET
Table '+cA8mcmhaedZ7YcrDdhmeQ' 6-max Seat #4 is the button
Seat 1: VB7TtBnfmT3JTA/cCL6dJg ($105.95 in chips)
Seat 2: 14aYclSc98EYd6TrzN2l3Q ($87.80 in chips)
Seat 3: DAIgyIWbYvAkL6PbAI27pg ($19.50 in chips)
Seat 4: 4OO5v3AVduL0tePNx8wk5A ($106.70 in chips)
Seat 5: SJieaES+gCAfonfNNMCP6w ($100 in chips)
Seat 6: YfsTQsY/fxb+YqbdclTHuw ($27.15 in chips)
SJieaES+gCAfonfNNMCP6w: posts small blind $0.50
YfsTQsY/fxb+YqbdclTHuw: posts big blind $1
*** HOLE CARDS ***
VB7TtBnfmT3JTA/cCL6dJg: folds
14aYclSc98EYd6TrzN2l3Q: calls $1
DAIgyIWbYvAkL6PbAI27pg: folds
4OO5v3AVduL0tePNx8wk5A: raises $4 to $5
SJieaES+gCAfonfNNMCP6w: folds
YfsTQsY/fxb+YqbdclTHuw: folds
14aYclSc98EYd6TrzN2l3Q: calls $4
*** FLOP *** [Td Qd 7c]
14aYclSc98EYd6TrzN2l3Q: bets $15
4OO5v3AVduL0tePNx8wk5A: raises $37 to $52
14aYclSc98EYd6TrzN2l3Q: folds
4OO5v3AVduL0tePNx8wk5A collected $39.50 from pot
*** SUMMARY ***
Total pot $41.50 | Rake $2
Board [Td Qd 7c]
Seat 1: VB7TtBnfmT3JTA/cCL6dJg folded before Flop (didn't bet)
Seat 2: 14aYclSc98EYd6TrzN2l3Q folded on the Flop
Seat 3: DAIgyIWbYvAkL6PbAI27pg folded before Flop (didn't bet)
Seat 4: 4OO5v3AVduL0tePNx8wk5A (button) collected ($39.50)
Seat 5: SJieaES+gCAfonfNNMCP6w (small blind) folded before Flop
Seat 6: YfsTQsY/fxb+YqbdclTHuw (big blind) folded before Flop



PokerStars Game #59941783870:  Hold'em No Limit ($0.50/$1.00) - 2009/07/01 1:46:02 ET
Table 'fTlPiCj0utgzC/5io+I7ew' 6-max Seat #5 is the button
Seat 1: YMJG+F++3Aj6P8dAWda5fw ($100 in chips)
Seat 2: qVr1nl3dy2xXPqS8UpTDlA ($40.25 in chips)
Seat 3: Z2fXsGcjl+Eax+RzOgwOmg ($130 in chips)
Seat 4: uJVSceLggtsrJya+WtmUEA ($269.35 in chips)
Seat 5: XUk5GQsfNFpHvaToDZ0rZA ($40.55 in chips)
Seat 6: y27w5IK2WXqmYzS8OU0wKA ($100 in chips)
y27w5IK2WXqmYzS8OU0wKA: posts small blind $0.50
YMJG+F++3Aj6P8dAWda5fw: posts big blind $1
*** HOLE CARDS ***
qVr1nl3dy2xXPqS8UpTDlA: raises $1 to $2
Z2fXsGcjl+Eax+RzOgwOmg: folds
uJVSceLggtsrJya+WtmUEA: folds
XUk5GQsfNFpHvaToDZ0rZA: folds
y27w5IK2WXqmYzS8OU0wKA: folds
YMJG+F++3Aj6P8dAWda5fw: folds
qVr1nl3dy2xXPqS8UpTDlA collected $2.50 from pot
qVr1nl3dy2xXPqS8UpTDlA: doesn't show hand
*** SUMMARY ***
Total pot $2.50 | Rake $0
Seat 1: YMJG+F++3Aj6P8dAWda5fw (big blind) folded before Flop
Seat 2: qVr1nl3dy2xXPqS8UpTDlA collected ($2.50)
Seat 3: Z2fXsGcjl+Eax+RzOgwOmg folded before Flop (didn't bet)
Seat 4: uJVSceLggtsrJya+WtmUEA folded before Flop (didn't bet)
Seat 5: XUk5GQsfNFpHvaToDZ0rZA (button) folded before Flop (didn't bet)
Seat 6: y27w5IK2WXqmYzS8OU0wKA (small blind) folded before Flop



PokerStars Game #59941784436:  Hold'em No Limit ($0.50/$1.00) - 2009/07/01 1:46:03 ET
Table 'vs/5jr6ciwjVQ5+Soc+u2A' 6-max Seat #3 is the button
Seat 1: J798qwLuvXyq0BbzsIjOrA ($221.50 in chips)
Seat 2: lXX4W7m3u++JiSOZ46yVMQ ($97 in chips)
Seat 3: Ws/3Uo3rQIk8hLgW0P+2xA ($98.40 in chips)
Seat 4: 0smcry9L0OOTCP+KzIS5SA ($89.60 in chips)
Seat 5: +Nt3OPk3XR9SKjZgm2CexQ ($131.35 in chips)
Seat 6: Z2fXsGcjl+Eax+RzOgwOmg ($122.50 in chips)
0smcry9L0OOTCP+KzIS5SA: posts small blind $0.50
+Nt3OPk3XR9SKjZgm2CexQ: posts big blind $1
*** HOLE CARDS ***
Z2fXsGcjl+Eax+RzOgwOmg: folds
J798qwLuvXyq0BbzsIjOrA: folds
lXX4W7m3u++JiSOZ46yVMQ: folds
Ws/3Uo3rQIk8hLgW0P+2xA: folds
0smcry9L0OOTCP+KzIS5SA: raises $2.50 to $3.50
+Nt3OPk3XR9SKjZgm2CexQ has timed out
+Nt3OPk3XR9SKjZgm2CexQ: folds
+Nt3OPk3XR9SKjZgm2CexQ is sitting out
+Nt3OPk3XR9SKjZgm2CexQ has returned
0smcry9L0OOTCP+KzIS5SA collected $2 from pot
0smcry9L0OOTCP+KzIS5SA: doesn't show hand
*** SUMMARY ***
Total pot $2 | Rake $0
Seat 1: J798qwLuvXyq0BbzsIjOrA folded before Flop (didn't bet)
Seat 2: lXX4W7m3u++JiSOZ46yVMQ folded before Flop (didn't bet)
Seat 3: Ws/3Uo3rQIk8hLgW0P+2xA (button) folded before Flop (didn't bet)
Seat 4: 0smcry9L0OOTCP+KzIS5SA (small blind) collected ($2)
Seat 5: +Nt3OPk3XR9SKjZgm2CexQ (big blind) folded before Flop
Seat 6: Z2fXsGcjl+Eax+RzOgwOmg folded before Flop (didn't bet)



PokerStars Game #59941784474:  Hold'em No Limit ($0.50/$1.00) - 2009/07/01 1:46:03 ET
Table 'fZjVbKj9D8yOB+Rj7NaP/A' 9-max Seat #8 is the button
Seat 1: kiakSwxX0e64PwYGAPQvLw ($33.35 in chips)
Seat 2: PTAFYDIUSsG+SArbxNl+Aw ($112 in chips)
Seat 3: yAbu2QsRPVcjPbqlf/jDxw ($100 in chips)
Seat 4: likAqWsWycNGwDQIcHN6GA ($89 in chips)
Seat 5: PkGfq5xrSlNsujKaG/HF4Q ($100 in chips)
Seat 6: OvwYHV65yUbgdBjSmo1+5g ($146.95 in chips)
Seat 7: SyS20PAm3RpT6uLBsGkwOA ($115.65 in chips)
Seat 8: EVvb0huXeMB7dnOAiO4ggA ($46 in chips)
Seat 9: qheQay5YvP2DMAb3OUSxtw ($142.60 in chips)
qheQay5YvP2DMAb3OUSxtw: posts small blind $0.50
kiakSwxX0e64PwYGAPQvLw: posts big blind $1
*** HOLE CARDS ***
PTAFYDIUSsG+SArbxNl+Aw: folds
yAbu2QsRPVcjPbqlf/jDxw: folds
likAqWsWycNGwDQIcHN6GA: raises $2 to $3
PkGfq5xrSlNsujKaG/HF4Q: folds
OvwYHV65yUbgdBjSmo1+5g: folds
SyS20PAm3RpT6uLBsGkwOA: raises $7 to $10
EVvb0huXeMB7dnOAiO4ggA: folds
qheQay5YvP2DMAb3OUSxtw: folds
kiakSwxX0e64PwYGAPQvLw: folds
likAqWsWycNGwDQIcHN6GA said, "d u suk cok or somat"
likAqWsWycNGwDQIcHN6GA: folds
SyS20PAm3RpT6uLBsGkwOA collected $7.50 from pot
*** SUMMARY ***
Total pot $7.50 | Rake $0
Seat 1: kiakSwxX0e64PwYGAPQvLw (big blind) folded before Flop
Seat 2: PTAFYDIUSsG+SArbxNl+Aw folded before Flop (didn't bet)
Seat 3: yAbu2QsRPVcjPbqlf/jDxw folded before Flop (didn't bet)
Seat 4: likAqWsWycNGwDQIcHN6GA folded before Flop
Seat 5: PkGfq5xrSlNsujKaG/HF4Q folded before Flop (didn't bet)
Seat 6: OvwYHV65yUbgdBjSmo1+5g folded before Flop (didn't bet)
Seat 7: SyS20PAm3RpT6uLBsGkwOA collected ($7.50)
Seat 8: EVvb0huXeMB7dnOAiO4ggA (button) folded before Flop (didn't bet)
Seat 9: qheQay5YvP2DMAb3OUSxtw (small blind) folded before Flop



PokerStars Game #59941785610:  Hold'em No Limit ($0.50/$1.00) - 2009/07/01 1:46:05 ET
Table 'kS0cTQAEi+fdUlJP2gQYvw' 9-max Seat #3 is the button
Seat 1: SqsWPukL8kLqrhq5ZrQdSQ ($169.50 in chips)
Seat 2: +JautI/vSNALzwSvsOqbCQ ($74 in chips)
Seat 3: 2BV+oJIQYr65IO6nEChvbA ($61.05 in chips)
Seat 4: RUhhaALzha3TH1AkdakoGQ ($68.10 in chips)
Seat 5: 1862487932 ($100 in chips)
Seat 6: yAbu2QsRPVcjPbqlf/jDxw ($117.15 in chips)
Seat 7: Ffa7Nj4X5fddtROP01hfQg ($8.50 in chips)
Seat 9: OGgaARGdJQT4awWVNQ957w ($104.20 in chips)
RUhhaALzha3TH1AkdakoGQ: posts small blind $0.50
1862487932: posts big blind $1
V138SURkdX8LdVBPKdJJag: sits out
*** HOLE CARDS ***
yAbu2QsRPVcjPbqlf/jDxw: raises $3 to $4
Ffa7Nj4X5fddtROP01hfQg: folds
OGgaARGdJQT4awWVNQ957w: folds
SqsWPukL8kLqrhq5ZrQdSQ: folds
+JautI/vSNALzwSvsOqbCQ: folds
2BV+oJIQYr65IO6nEChvbA: folds
RUhhaALzha3TH1AkdakoGQ: folds
1862487932: folds
yAbu2QsRPVcjPbqlf/jDxw collected $2.50 from pot
yAbu2QsRPVcjPbqlf/jDxw: doesn't show hand
*** SUMMARY ***
Total pot $2.50 | Rake $0
Seat 1: SqsWPukL8kLqrhq5ZrQdSQ folded before Flop (didn't bet)
Seat 2: +JautI/vSNALzwSvsOqbCQ folded before Flop (didn't bet)
Seat 3: 2BV+oJIQYr65IO6nEChvbA (button) folded before Flop (didn't bet)
Seat 4: RUhhaALzha3TH1AkdakoGQ (small blind) folded before Flop
Seat 5: 1862487932 (big blind) folded before Flop
Seat 6: yAbu2QsRPVcjPbqlf/jDxw collected ($2.50)
Seat 7: Ffa7Nj4X5fddtROP01hfQg folded before Flop (didn't bet)
Seat 9: OGgaARGdJQT4awWVNQ957w folded before Flop (didn't bet)



PokerStars Game #59941786944:  Hold'em No Limit ($0.50/$1.00) - 2009/07/01 1:46:08 ET
Table 'GxCPo/gd3OSthkYrAxJngg' 6-max Seat #2 is the button
Seat 1: sH8BpAFP+jGFxCgVpD1Lew ($240.25 in chips)
Seat 2: YExX2paeIHrmfIwV1ivM/w ($60.10 in chips)
Seat 3: idVgoPAdspFPCzee6aF9Pg ($136.50 in chips)
Seat 4: YMJG+F++3Aj6P8dAWda5fw ($209.75 in chips)
Seat 5: vX+iYAEINFeLxwMla7DY1Q ($98 in chips)
Seat 6: 4d1rWhpu8DzLmzMbR3QKyA ($101.50 in chips)
idVgoPAdspFPCzee6aF9Pg: posts small blind $0.50
YMJG+F++3Aj6P8dAWda5fw: posts big blind $1
*** HOLE CARDS ***
vX+iYAEINFeLxwMla7DY1Q: folds
4d1rWhpu8DzLmzMbR3QKyA: raises $2 to $3
sH8BpAFP+jGFxCgVpD1Lew: folds
YExX2paeIHrmfIwV1ivM/w: raises $7 to $10
idVgoPAdspFPCzee6aF9Pg: folds
YMJG+F++3Aj6P8dAWda5fw: folds
4d1rWhpu8DzLmzMbR3QKyA: folds
YExX2paeIHrmfIwV1ivM/w collected $7.50 from pot
*** SUMMARY ***
Total pot $7.50 | Rake $0
Seat 1: sH8BpAFP+jGFxCgVpD1Lew folded before Flop (didn't bet)
Seat 2: YExX2paeIHrmfIwV1ivM/w (button) collected ($7.50)
Seat 3: idVgoPAdspFPCzee6aF9Pg (small blind) folded before Flop
Seat 4: YMJG+F++3Aj6P8dAWda5fw (big blind) folded before Flop
Seat 5: vX+iYAEINFeLxwMla7DY1Q folded before Flop (didn't bet)
Seat 6: 4d1rWhpu8DzLmzMbR3QKyA folded before Flop



PokerStars Game #59941787950:  Hold'em No Limit ($0.50/$1.00) - 2009/07/01 1:46:10 ET
Table 'Zka9tv1yilg0MvXWPQrShg' 9-max Seat #4 is the button
Seat 1: ZVxIB+9xpB8diS64GK4r1Q ($53.80 in chips)
Seat 2: rALqQhDZz5RDHkTXtYKKiQ ($54 in chips)
Seat 3: gUUvmqdVlmvpal6B8nYrmg ($162.70 in chips)
Seat 4: ri8CLkX3e9JF34dQNbsHGA ($25 in chips)
Seat 5: /zy+DB4S5fUQUSfZWFzYGw ($125.15 in chips)
Seat 6: aM6BB+PnB/rDUr2dbRda+A ($100 in chips)
Seat 7: wddetwG1UUDMywszPUtP3A ($65.15 in chips)
Seat 8: mBRWbnUl8diyBO1qTJaNzw ($100 in chips)
Seat 9: bGHJpa8dswKSoojQBgXCgQ ($115.80 in chips)
/zy+DB4S5fUQUSfZWFzYGw: posts small blind $0.50
aM6BB+PnB/rDUr2dbRda+A: posts big blind $1
*** HOLE CARDS ***
wddetwG1UUDMywszPUtP3A: folds
mBRWbnUl8diyBO1qTJaNzw: folds
bGHJpa8dswKSoojQBgXCgQ: folds
ZVxIB+9xpB8diS64GK4r1Q: folds
wddetwG1UUDMywszPUtP3A leaves the table
rALqQhDZz5RDHkTXtYKKiQ: folds
gUUvmqdVlmvpal6B8nYrmg: raises $1 to $2
ri8CLkX3e9JF34dQNbsHGA: folds
1862487932 joins the table at seat #7
/zy+DB4S5fUQUSfZWFzYGw: folds
aM6BB+PnB/rDUr2dbRda+A: raises $6.50 to $8.50
gUUvmqdVlmvpal6B8nYrmg: folds
aM6BB+PnB/rDUr2dbRda+A collected $4.50 from pot
*** SUMMARY ***
Total pot $4.50 | Rake $0
Seat 1: ZVxIB+9xpB8diS64GK4r1Q folded before Flop (didn't bet)
Seat 2: rALqQhDZz5RDHkTXtYKKiQ folded before Flop (didn't bet)
Seat 3: gUUvmqdVlmvpal6B8nYrmg folded before Flop
Seat 4: ri8CLkX3e9JF34dQNbsHGA (button) folded before Flop (didn't bet)
Seat 5: /zy+DB4S5fUQUSfZWFzYGw (small blind) folded before Flop
Seat 6: aM6BB+PnB/rDUr2dbRda+A (big blind) collected ($4.50)
Seat 7: wddetwG1UUDMywszPUtP3A folded before Flop (didn't bet)
Seat 8: mBRWbnUl8diyBO1qTJaNzw folded before Flop (didn't bet)
Seat 9: bGHJpa8dswKSoojQBgXCgQ folded before Flop (didn't bet)



PokerStars Game #59941788868:  Hold'em No Limit ($0.50/$1.00) - 2009/07/01 1:46:11 ET
Table '/RZcOwpZpHQ+OwPwjsbnRw' 6-max Seat #5 is the button
Seat 2: Z2fXsGcjl+Eax+RzOgwOmg ($102.65 in chips)
Seat 3: LJMw/I77xpnw0R5T4HnMUg ($84.55 in chips)
Seat 4: j7NIOHLZk7V2o9fOioO5ug ($111.70 in chips)
Seat 5: wx3sQGkVi2x9wJXuWNHPBw ($165.75 in chips)
Seat 6: o3YLm/rSY916m/on1VjXPA ($206 in chips)
o3YLm/rSY916m/on1VjXPA: posts small blind $0.50
Z2fXsGcjl+Eax+RzOgwOmg: posts big blind $1
*** HOLE CARDS ***
8rDbzImSi1zgxtqtF1pSbA joins the table at seat #1
LJMw/I77xpnw0R5T4HnMUg: folds
8rDbzImSi1zgxtqtF1pSbA leaves the table
j7NIOHLZk7V2o9fOioO5ug: folds
wx3sQGkVi2x9wJXuWNHPBw: raises $2 to $3
o3YLm/rSY916m/on1VjXPA: folds
Z2fXsGcjl+Eax+RzOgwOmg: folds
wx3sQGkVi2x9wJXuWNHPBw collected $2.50 from pot
*** SUMMARY ***
Total pot $2.50 | Rake $0
Seat 2: Z2fXsGcjl+Eax+RzOgwOmg (big blind) folded before Flop
Seat 3: LJMw/I77xpnw0R5T4HnMUg folded before Flop (didn't bet)
Seat 4: j7NIOHLZk7V2o9fOioO5ug folded before Flop (didn't bet)
Seat 5: wx3sQGkVi2x9wJXuWNHPBw (button) collected ($2.50)
Seat 6: o3YLm/rSY916m/on1VjXPA (small blind) folded before Flop



PokerStars Game #59941790264:  Hold'em No Limit ($0.50/$1.00) - 2009/07/01 1:46:14 ET
Table 'MUPc8FEpe/nR0BKSeReX6Q' 6-max Seat #1 is the button
Seat 1: qhkK6+yCciTRd+rCFEbnEQ ($73.70 in chips)
Seat 2: xAU6q2/cwmby2sxmA8VcmA ($102.70 in chips)
Seat 3: wx3sQGkVi2x9wJXuWNHPBw ($286.15 in chips)
Seat 4: r4lpoh2BJZ8S6zyQv1JeSw ($110 in chips)
Seat 5: y27w5IK2WXqmYzS8OU0wKA ($131.05 in chips)
Seat 6: ene3nLSnQ4N961iBaUsSmA ($110 in chips)
xAU6q2/cwmby2sxmA8VcmA: posts small blind $0.50
wx3sQGkVi2x9wJXuWNHPBw: posts big blind $1
*** HOLE CARDS ***
r4lpoh2BJZ8S6zyQv1JeSw: folds
y27w5IK2WXqmYzS8OU0wKA: folds
ene3nLSnQ4N961iBaUsSmA: raises $2 to $3
qhkK6+yCciTRd+rCFEbnEQ: folds
xAU6q2/cwmby2sxmA8VcmA: folds
wx3sQGkVi2x9wJXuWNHPBw: folds
ene3nLSnQ4N961iBaUsSmA collected $2.50 from pot
ene3nLSnQ4N961iBaUsSmA: doesn't show hand
*** SUMMARY ***
Total pot $2.50 | Rake $0
Seat 1: qhkK6+yCciTRd+rCFEbnEQ (button) folded before Flop (didn't bet)
Seat 2: xAU6q2/cwmby2sxmA8VcmA (small blind) folded before Flop
Seat 3: wx3sQGkVi2x9wJXuWNHPBw (big blind) folded before Flop
Seat 4: r4lpoh2BJZ8S6zyQv1JeSw folded before Flop (didn't bet)
Seat 5: y27w5IK2WXqmYzS8OU0wKA folded before Flop (didn't bet)
Seat 6: ene3nLSnQ4N961iBaUsSmA collected ($2.50)



PokerStars Game #59941791066:  Hold'em No Limit ($0.50/$1.00) - 2009/07/01 1:46:15 ET
Table 'gxFK0BVUD7cupu2uyRUZJg' 6-max Seat #2 is the button
Seat 1: M+X3uChmP6R63IwijVjgTg ($381.40 in chips)
Seat 2: hpxXcmRkXXI9HE5+5/j/0Q ($131 in chips)
Seat 3: Z2fXsGcjl+Eax+RzOgwOmg ($116.10 in chips)
Seat 4: Hcr4S4Nbkj5idKsvYK/eqQ ($100 in chips)
Seat 5: 0smcry9L0OOTCP+KzIS5SA ($210 in chips)
Seat 6: dYyb6/42PMC8aNFlm/eBeQ ($36.25 in chips)
Z2fXsGcjl+Eax+RzOgwOmg: posts small blind $0.50
Hcr4S4Nbkj5idKsvYK/eqQ: posts big blind $1
*** HOLE CARDS ***
0smcry9L0OOTCP+KzIS5SA: folds
dYyb6/42PMC8aNFlm/eBeQ: calls $1
M+X3uChmP6R63IwijVjgTg: folds
hpxXcmRkXXI9HE5+5/j/0Q: raises $4 to $5
Z2fXsGcjl+Eax+RzOgwOmg: folds
Hcr4S4Nbkj5idKsvYK/eqQ: folds
dYyb6/42PMC8aNFlm/eBeQ: calls $4
*** FLOP *** [7h Ad 9d]
dYyb6/42PMC8aNFlm/eBeQ: checks
hpxXcmRkXXI9HE5+5/j/0Q: bets $8
dYyb6/42PMC8aNFlm/eBeQ: folds
hpxXcmRkXXI9HE5+5/j/0Q collected $10.95 from pot
hpxXcmRkXXI9HE5+5/j/0Q: doesn't show hand
*** SUMMARY ***
Total pot $11.50 | Rake $0.55
Board [7h Ad 9d]
Seat 1: M+X3uChmP6R63IwijVjgTg folded before Flop (didn't bet)
Seat 2: hpxXcmRkXXI9HE5+5/j/0Q (button) collected ($10.95)
Seat 3: Z2fXsGcjl+Eax+RzOgwOmg (small blind) folded before Flop
Seat 4: Hcr4S4Nbkj5idKsvYK/eqQ (big blind) folded before Flop
Seat 5: 0smcry9L0OOTCP+KzIS5SA folded before Flop (didn't bet)
Seat 6: dYyb6/42PMC8aNFlm/eBeQ folded on the Flop



PokerStars Game #59941791886:  Hold'em No Limit ($0.50/$1.00) - 2009/07/01 1:46:17 ET
Table 'pHrhryH8jPNdQfY62f8v+g' 6-max Seat #4 is the button
Seat 1: 4d1rWhpu8DzLmzMbR3QKyA ($143.95 in chips)
Seat 2: JwCcjZl0bjJzG7hmE0dnTA ($128.65 in chips)
Seat 3: 8oS5O7iD/qnFXFXJrGIgNQ ($115.40 in chips)
Seat 4: 1f3beyIML24UqEMTbWy93g ($37.35 in chips)
Seat 5: d8WX+9nUHoqlrAGagO0Wow ($16 in chips)
Seat 6: xAU6q2/cwmby2sxmA8VcmA ($202.30 in chips)
d8WX+9nUHoqlrAGagO0Wow: posts small blind $0.50
xAU6q2/cwmby2sxmA8VcmA: posts big blind $1
*** HOLE CARDS ***
4d1rWhpu8DzLmzMbR3QKyA: folds
JwCcjZl0bjJzG7hmE0dnTA: raises $2 to $3
8oS5O7iD/qnFXFXJrGIgNQ: folds
1f3beyIML24UqEMTbWy93g: folds
d8WX+9nUHoqlrAGagO0Wow: folds
xAU6q2/cwmby2sxmA8VcmA: folds
JwCcjZl0bjJzG7hmE0dnTA collected $2.50 from pot
*** SUMMARY ***
Total pot $2.50 | Rake $0
Seat 1: 4d1rWhpu8DzLmzMbR3QKyA folded before Flop (didn't bet)
Seat 2: JwCcjZl0bjJzG7hmE0dnTA collected ($2.50)
Seat 3: 8oS5O7iD/qnFXFXJrGIgNQ folded before Flop (didn't bet)
Seat 4: 1f3beyIML24UqEMTbWy93g (button) folded before Flop (didn't bet)
Seat 5: d8WX+9nUHoqlrAGagO0Wow (small blind) folded before Flop
Seat 6: xAU6q2/cwmby2sxmA8VcmA (big blind) folded before Flop



PokerStars Game #59941793484:  Hold'em No Limit ($0.50/$1.00) - 2009/07/01 1:46:20 ET
Table 'rmZfTK+oSebeUPJNbWhdAA' 6-max Seat #4 is the button
Seat 1: xAU6q2/cwmby2sxmA8VcmA ($135.80 in chips)
Seat 2: z7O9PO/WEcqRouIydFhS9Q ($216.50 in chips)
Seat 3: BCEV3COoKY607AzLWayfRA ($199.20 in chips)
Seat 4: 1/mIuXfgx1ZyVkodrmfQDw ($154.85 in chips)
Seat 5: UOHYuj23MyK9R8ciY2t6FA ($100 in chips)
Seat 6: j7NIOHLZk7V2o9fOioO5ug ($100.70 in chips)
UOHYuj23MyK9R8ciY2t6FA: posts small blind $0.50
j7NIOHLZk7V2o9fOioO5ug: posts big blind $1
*** HOLE CARDS ***
xAU6q2/cwmby2sxmA8VcmA: folds
z7O9PO/WEcqRouIydFhS9Q: folds
BCEV3COoKY607AzLWayfRA: folds
1/mIuXfgx1ZyVkodrmfQDw: folds
UOHYuj23MyK9R8ciY2t6FA: raises $2 to $3
j7NIOHLZk7V2o9fOioO5ug: calls $2
*** FLOP *** [2s 7d 5h]
UOHYuj23MyK9R8ciY2t6FA: bets $4
j7NIOHLZk7V2o9fOioO5ug: calls $4
*** TURN *** [2s 7d 5h] [Jc]
UOHYuj23MyK9R8ciY2t6FA: bets $7.50
j7NIOHLZk7V2o9fOioO5ug: calls $7.50
*** RIVER *** [2s 7d 5h Jc] [Tc]
UOHYuj23MyK9R8ciY2t6FA: checks
j7NIOHLZk7V2o9fOioO5ug: bets $13
UOHYuj23MyK9R8ciY2t6FA: folds
j7NIOHLZk7V2o9fOioO5ug collected $27.60 from pot
j7NIOHLZk7V2o9fOioO5ug: doesn't show hand
*** SUMMARY ***
Total pot $29 | Rake $1.40
Board [2s 7d 5h Jc Tc]
Seat 1: xAU6q2/cwmby2sxmA8VcmA folded before Flop (didn't bet)
Seat 2: z7O9PO/WEcqRouIydFhS9Q folded before Flop (didn't bet)
Seat 3: BCEV3COoKY607AzLWayfRA folded before Flop (didn't bet)
Seat 4: 1/mIuXfgx1ZyVkodrmfQDw (button) folded before Flop (didn't bet)
Seat 5: UOHYuj23MyK9R8ciY2t6FA (small blind) folded on the River
Seat 6: j7NIOHLZk7V2o9fOioO5ug (big blind) collected ($27.60)



PokerStars Game #59941793572:  Hold'em No Limit ($0.50/$1.00) - 2009/07/01 1:46:20 ET
Table '7Nl0ffnjeK44/vmeexh3MQ' 9-max Seat #1 is the button
Seat 1: V138SURkdX8LdVBPKdJJag ($113.05 in chips)
Seat 2: OGgaARGdJQT4awWVNQ957w ($100.50 in chips)
Seat 4: bLbSOSmSOnqE0iTcH/5dxA ($107.55 in chips)
Seat 5: 61sfw5QTu62YYIt68OsdrA ($76.05 in chips)
Seat 6: FVs16t7GgfWgQWt4JxsObQ ($26.95 in chips)
Seat 7: 2fVA6XTmacKkwJ4SpKDAtA ($85.50 in chips)
Seat 8: HRJJZiSxFAehJGaET63dlA ($46.90 in chips)
Seat 9: /JHoNdt0fK6X+isrqRfV3w ($18.50 in chips)
OGgaARGdJQT4awWVNQ957w: posts small blind $0.50
JMmUYT5pIKCKh2pGjCB/4w: is sitting out
bLbSOSmSOnqE0iTcH/5dxA: posts big blind $1
*** HOLE CARDS ***
61sfw5QTu62YYIt68OsdrA: folds
FVs16t7GgfWgQWt4JxsObQ: folds
2fVA6XTmacKkwJ4SpKDAtA: folds
HRJJZiSxFAehJGaET63dlA: folds
/JHoNdt0fK6X+isrqRfV3w: folds
V138SURkdX8LdVBPKdJJag: folds
OGgaARGdJQT4awWVNQ957w: raises $3 to $4
bLbSOSmSOnqE0iTcH/5dxA: folds
bLbSOSmSOnqE0iTcH/5dxA is sitting out
OGgaARGdJQT4awWVNQ957w collected $2 from pot
OGgaARGdJQT4awWVNQ957w: doesn't show hand
*** SUMMARY ***
Total pot $2 | Rake $0
Seat 1: V138SURkdX8LdVBPKdJJag (button) folded before Flop (didn't bet)
Seat 2: OGgaARGdJQT4awWVNQ957w (small blind) collected ($2)
Seat 4: bLbSOSmSOnqE0iTcH/5dxA (big blind) folded before Flop
Seat 5: 61sfw5QTu62YYIt68OsdrA folded before Flop (didn't bet)
Seat 6: FVs16t7GgfWgQWt4JxsObQ folded before Flop (didn't bet)
Seat 7: 2fVA6XTmacKkwJ4SpKDAtA folded before Flop (didn't bet)
Seat 8: HRJJZiSxFAehJGaET63dlA folded before Flop (didn't bet)
Seat 9: /JHoNdt0fK6X+isrqRfV3w folded before Flop (didn't bet)



PokerStars Game #59941794546:  Hold'em No Limit ($0.50/$1.00) - 2009/07/01 1:46:22 ET
Table 'N2bNCDHL96aCQDvZIh+yQQ' 6-max Seat #4 is the button
Seat 1: Jjgflx10PVjcLkziEmLhSA ($92.25 in chips)
Seat 2: y27w5IK2WXqmYzS8OU0wKA ($128.65 in chips)
Seat 3: VB7TtBnfmT3JTA/cCL6dJg ($101.50 in chips)
Seat 4: uCqEjnxh2/vFBjKYkfTOkw ($159.20 in chips)
Seat 5: ene3nLSnQ4N961iBaUsSmA ($149.50 in chips)
ene3nLSnQ4N961iBaUsSmA: posts small blind $0.50
idVgoPAdspFPCzee6aF9Pg: is sitting out
Jjgflx10PVjcLkziEmLhSA: posts big blind $1
*** HOLE CARDS ***
y27w5IK2WXqmYzS8OU0wKA: folds
VB7TtBnfmT3JTA/cCL6dJg: folds
uCqEjnxh2/vFBjKYkfTOkw: folds
ene3nLSnQ4N961iBaUsSmA: folds
Jjgflx10PVjcLkziEmLhSA collected $1 from pot
Jjgflx10PVjcLkziEmLhSA: doesn't show hand
*** SUMMARY ***
Total pot $1 | Rake $0
Seat 1: Jjgflx10PVjcLkziEmLhSA (big blind) collected ($1)
Seat 2: y27w5IK2WXqmYzS8OU0wKA folded before Flop (didn't bet)
Seat 3: VB7TtBnfmT3JTA/cCL6dJg folded before Flop (didn't bet)
Seat 4: uCqEjnxh2/vFBjKYkfTOkw (button) folded before Flop (didn't bet)
Seat 5: ene3nLSnQ4N961iBaUsSmA (small blind) folded before Flop



PokerStars Game #59941794300:  Hold'em No Limit ($0.50/$1.00) - 2009/07/01 1:46:22 ET
Table 'mmbQQVBTrPdE+wy+s+9VPA' 6-max Seat #2 is the button
Seat 1: zyP4SPoWZnKUfTvIRLCVog ($43.25 in chips)
Seat 2: XK4Qsl+DA8gAJyg85/zBIw ($40.75 in chips)
Seat 3: wx3sQGkVi2x9wJXuWNHPBw ($234.60 in chips)
Seat 4: V3iZdcw61nXF3g5hD2RrsQ ($126.75 in chips)
Seat 5: YMJG+F++3Aj6P8dAWda5fw ($126.70 in chips)
Seat 6: UOHYuj23MyK9R8ciY2t6FA ($100 in chips)
wx3sQGkVi2x9wJXuWNHPBw: posts small blind $0.50
V3iZdcw61nXF3g5hD2RrsQ: posts big blind $1
*** HOLE CARDS ***
YMJG+F++3Aj6P8dAWda5fw: folds
UOHYuj23MyK9R8ciY2t6FA: folds
zyP4SPoWZnKUfTvIRLCVog: raises $4 to $5
XK4Qsl+DA8gAJyg85/zBIw: folds
wx3sQGkVi2x9wJXuWNHPBw: folds
V3iZdcw61nXF3g5hD2RrsQ: folds
zyP4SPoWZnKUfTvIRLCVog collected $2.50 from pot
zyP4SPoWZnKUfTvIRLCVog: doesn't show hand
*** SUMMARY ***
Total pot $2.50 | Rake $0
Seat 1: zyP4SPoWZnKUfTvIRLCVog collected ($2.50)
Seat 2: XK4Qsl+DA8gAJyg85/zBIw (button) folded before Flop (didn't bet)
Seat 3: wx3sQGkVi2x9wJXuWNHPBw (small blind) folded before Flop
Seat 4: V3iZdcw61nXF3g5hD2RrsQ (big blind) folded before Flop
Seat 5: YMJG+F++3Aj6P8dAWda5fw folded before Flop (didn't bet)
Seat 6: UOHYuj23MyK9R8ciY2t6FA folded before Flop (didn't bet)



PokerStars Game #59941795130:  Hold'em No Limit ($0.50/$1.00) - 2009/07/01 1:46:23 ET
Table 'QSIig7BLMc9wY/rgBechzw' 6-max Seat #2 is the button
Seat 1: Z2fXsGcjl+Eax+RzOgwOmg ($105 in chips)
Seat 2: w13GSGRwQhbN/aLrrRaMKw ($43 in chips)
Seat 3: 4OO5v3AVduL0tePNx8wk5A ($100.20 in chips)
Seat 4: +uSzP8Jwnw7sKfQ4s66b7w ($74.65 in chips)
Seat 5: lsLuWlcPA3Rh7kJVLzMh0Q ($120 in chips)
4OO5v3AVduL0tePNx8wk5A: posts small blind $0.50
+uSzP8Jwnw7sKfQ4s66b7w: posts big blind $1
rHlMOfR7kpQQxe+PFQz0xQ: sits out
*** HOLE CARDS ***
lsLuWlcPA3Rh7kJVLzMh0Q: folds
Z2fXsGcjl+Eax+RzOgwOmg: folds
w13GSGRwQhbN/aLrrRaMKw: calls $1
4OO5v3AVduL0tePNx8wk5A: folds
+uSzP8Jwnw7sKfQ4s66b7w: checks
*** FLOP *** [Qh 9s Kd]
+uSzP8Jwnw7sKfQ4s66b7w: checks
w13GSGRwQhbN/aLrrRaMKw: bets $2
+uSzP8Jwnw7sKfQ4s66b7w: folds
w13GSGRwQhbN/aLrrRaMKw collected $2.40 from pot
*** SUMMARY ***
Total pot $2.50 | Rake $0.10
Board [Qh 9s Kd]
Seat 1: Z2fXsGcjl+Eax+RzOgwOmg folded before Flop (didn't bet)
Seat 2: w13GSGRwQhbN/aLrrRaMKw (button) collected ($2.40)
Seat 3: 4OO5v3AVduL0tePNx8wk5A (small blind) folded before Flop
Seat 4: +uSzP8Jwnw7sKfQ4s66b7w (big blind) folded on the Flop
Seat 5: lsLuWlcPA3Rh7kJVLzMh0Q folded before Flop (didn't bet)



PokerStars Game #59941795722:  Hold'em No Limit ($0.50/$1.00) - 2009/07/01 1:46:24 ET
Table 'W/wyObTiXZm+Ckkl3YxcSw' 6-max Seat #2 is the button
Seat 2: oDiBRCaF0QVtd3kO6xZIXw ($115.65 in chips)
Seat 3: 4OO5v3AVduL0tePNx8wk5A ($100 in chips)
Seat 4: rHlMOfR7kpQQxe+PFQz0xQ ($96 in chips)
Seat 5: +OrCjyw70oZhJiD22Mn+bg ($199 in chips)
Seat 6: b2a+5TkFf4xJN/Ihhma58Q ($34.10 in chips)
4OO5v3AVduL0tePNx8wk5A: posts small blind $0.50
rHlMOfR7kpQQxe+PFQz0xQ: posts big blind $1
*** HOLE CARDS ***
+OrCjyw70oZhJiD22Mn+bg: folds
b2a+5TkFf4xJN/Ihhma58Q: folds
GHv97X0qtwmxPTR3hKuNvg said, "good call preflop"
oDiBRCaF0QVtd3kO6xZIXw said, "ty"
oDiBRCaF0QVtd3kO6xZIXw: raises $2 to $3
GHv97X0qtwmxPTR3hKuNvg said, "fkn donk"
GHv97X0qtwmxPTR3hKuNvg leaves the table
4OO5v3AVduL0tePNx8wk5A: folds
oDiBRCaF0QVtd3kO6xZIXw said, "lol"
rHlMOfR7kpQQxe+PFQz0xQ: folds
oDiBRCaF0QVtd3kO6xZIXw collected $2.50 from pot
oDiBRCaF0QVtd3kO6xZIXw: doesn't show hand
*** SUMMARY ***
Total pot $2.50 | Rake $0
Seat 2: oDiBRCaF0QVtd3kO6xZIXw (button) collected ($2.50)
Seat 3: 4OO5v3AVduL0tePNx8wk5A (small blind) folded before Flop
Seat 4: rHlMOfR7kpQQxe+PFQz0xQ (big blind) folded before Flop
Seat 5: +OrCjyw70oZhJiD22Mn+bg folded before Flop (didn't bet)
Seat 6: b2a+5TkFf4xJN/Ihhma58Q folded before Flop (didn't bet)



PokerStars Game #59941796568:  Hold'em No Limit ($0.50/$1.00) - 2009/07/01 1:46:26 ET
Table '7O9fB8yx1u7sJveJn8w6jA' 6-max Seat #1 is the button
Seat 1: 841740 ($36.70 in chips)
Seat 2: wx3sQGkVi2x9wJXuWNHPBw ($204.35 in chips)
Seat 3: hpxXcmRkXXI9HE5+5/j/0Q ($145.45 in chips)
Seat 4: b2a+5TkFf4xJN/Ihhma58Q ($24.65 in chips)
Seat 5: BCEV3COoKY607AzLWayfRA ($107.20 in chips)
Seat 6: r4lpoh2BJZ8S6zyQv1JeSw ($110.75 in chips)
wx3sQGkVi2x9wJXuWNHPBw: posts small blind $0.50
hpxXcmRkXXI9HE5+5/j/0Q: posts big blind $1
*** HOLE CARDS ***
b2a+5TkFf4xJN/Ihhma58Q: folds
BCEV3COoKY607AzLWayfRA: folds
r4lpoh2BJZ8S6zyQv1JeSw: folds
841740: calls $1
wx3sQGkVi2x9wJXuWNHPBw: calls $0.50
hpxXcmRkXXI9HE5+5/j/0Q: checks
*** FLOP *** [8d Jd 2d]
wx3sQGkVi2x9wJXuWNHPBw: checks
hpxXcmRkXXI9HE5+5/j/0Q: checks
841740: bets $2
wx3sQGkVi2x9wJXuWNHPBw: folds
hpxXcmRkXXI9HE5+5/j/0Q: folds
841740 collected $2.85 from pot
*** SUMMARY ***
Total pot $3 | Rake $0.15
Board [8d Jd 2d]
Seat 1: 841740 (button) collected ($2.85)
Seat 2: wx3sQGkVi2x9wJXuWNHPBw (small blind) folded on the Flop
Seat 3: hpxXcmRkXXI9HE5+5/j/0Q (big blind) folded on the Flop
Seat 4: b2a+5TkFf4xJN/Ihhma58Q folded before Flop (didn't bet)
Seat 5: BCEV3COoKY607AzLWayfRA folded before Flop (didn't bet)
Seat 6: r4lpoh2BJZ8S6zyQv1JeSw folded before Flop (didn't bet)



PokerStars Game #59941796906:  Hold'em No Limit ($0.50/$1.00) - 2009/07/01 1:46:27 ET
Table '305hiksPPCCdC6V2LNsO5w' 6-max Seat #5 is the button
Seat 1: CqVbWBBIYCppRX6VwuX8fw ($32 in chips)
Seat 2: j7NIOHLZk7V2o9fOioO5ug ($183.70 in chips)
Seat 3: +zIVjZKLpcidfRHgVZW8lA ($35.70 in chips)
Seat 4: uJVSceLggtsrJya+WtmUEA ($202.30 in chips)
Seat 5: +Nt3OPk3XR9SKjZgm2CexQ ($100 in chips)
Seat 6: 9/Tq8dw7kWW68uN8bFupXg ($17.90 in chips)
9/Tq8dw7kWW68uN8bFupXg: posts small blind $0.50
CqVbWBBIYCppRX6VwuX8fw: posts big blind $1
uJVSceLggtsrJya+WtmUEA: posts small & big blinds $1.50
*** HOLE CARDS ***
j7NIOHLZk7V2o9fOioO5ug: folds
+zIVjZKLpcidfRHgVZW8lA: folds
uJVSceLggtsrJya+WtmUEA: checks
+Nt3OPk3XR9SKjZgm2CexQ: folds
9/Tq8dw7kWW68uN8bFupXg: raises $3 to $4
CqVbWBBIYCppRX6VwuX8fw: calls $3
uJVSceLggtsrJya+WtmUEA: folds
*** FLOP *** [4h Ts 9s]
9/Tq8dw7kWW68uN8bFupXg: checks
CqVbWBBIYCppRX6VwuX8fw: checks
*** TURN *** [4h Ts 9s] [Qh]
9/Tq8dw7kWW68uN8bFupXg: bets $13.90 and is all-in
CqVbWBBIYCppRX6VwuX8fw: calls $13.90
*** RIVER *** [4h Ts 9s Qh] [7h]
*** SHOW DOWN ***
9/Tq8dw7kWW68uN8bFupXg: shows [7s Qd] (two pair, Queens and Sevens)
CqVbWBBIYCppRX6VwuX8fw: mucks hand
CqVbWBBIYCppRX6VwuX8fw said, "omg"
9/Tq8dw7kWW68uN8bFupXg collected $35.50 from pot
*** SUMMARY ***
Total pot $37.30 | Rake $1.80
Board [4h Ts 9s Qh 7h]
Seat 1: CqVbWBBIYCppRX6VwuX8fw (big blind) mucked
Seat 2: j7NIOHLZk7V2o9fOioO5ug folded before Flop (didn't bet)
Seat 3: +zIVjZKLpcidfRHgVZW8lA folded before Flop (didn't bet)
Seat 4: uJVSceLggtsrJya+WtmUEA folded before Flop
Seat 5: +Nt3OPk3XR9SKjZgm2CexQ (button) folded before Flop (didn't bet)
Seat 6: 9/Tq8dw7kWW68uN8bFupXg (small blind) showed [7s Qd] and won ($35.50) with two pair, Queens and Sevens



PokerStars Game #59941797726:  Hold'em No Limit ($0.50/$1.00) - 2009/07/01 1:46:28 ET
Table 'blHlQApStil0OPeQxQxPcw' 9-max Seat #2 is the button
Seat 1: UhwCjxJI7sJbMAXzvZYHpA ($101.50 in chips)
Seat 2: V138SURkdX8LdVBPKdJJag ($119.85 in chips)
Seat 3: OGgaARGdJQT4awWVNQ957w ($102 in chips)
Seat 4: myIxN7otsyr846M539YR8Q ($20 in chips)
Seat 5: uXrDE6JrIi8BZK1L8oQ9bQ ($37 in chips)
Seat 6: vljeiOoWscAIXU0fCuiEBw ($44.65 in chips)
Seat 7: VPF+HjszMvUIpy0CHIwH3A ($18.50 in chips)
Seat 9: 6XkTu4ahxzHnvjjc1R8YjQ ($150.35 in chips)
OGgaARGdJQT4awWVNQ957w: posts small blind $0.50
myIxN7otsyr846M539YR8Q: posts big blind $1
*** HOLE CARDS ***
uXrDE6JrIi8BZK1L8oQ9bQ: folds
vljeiOoWscAIXU0fCuiEBw: calls $1
VPF+HjszMvUIpy0CHIwH3A: folds
6XkTu4ahxzHnvjjc1R8YjQ: folds
UhwCjxJI7sJbMAXzvZYHpA: folds
V138SURkdX8LdVBPKdJJag: raises $3.75 to $4.75
OGgaARGdJQT4awWVNQ957w: folds
myIxN7otsyr846M539YR8Q: raises $15.25 to $20 and is all-in
vljeiOoWscAIXU0fCuiEBw: folds
V138SURkdX8LdVBPKdJJag: folds
myIxN7otsyr846M539YR8Q collected $11 from pot
myIxN7otsyr846M539YR8Q: doesn't show hand
*** SUMMARY ***
Total pot $11 | Rake $0
Seat 1: UhwCjxJI7sJbMAXzvZYHpA folded before Flop (didn't bet)
Seat 2: V138SURkdX8LdVBPKdJJag (button) folded before Flop
Seat 3: OGgaARGdJQT4awWVNQ957w (small blind) folded before Flop
Seat 4: myIxN7otsyr846M539YR8Q (big blind) collected ($11)
Seat 5: uXrDE6JrIi8BZK1L8oQ9bQ folded before Flop (didn't bet)
Seat 6: vljeiOoWscAIXU0fCuiEBw folded before Flop
Seat 7: VPF+HjszMvUIpy0CHIwH3A folded before Flop (didn't bet)
Seat 9: 6XkTu4ahxzHnvjjc1R8YjQ folded before Flop (didn't bet)



